ecommerce,category,original_id,name,price,original_price,discount,discount_rate
TIKI,dien-thoai-may-tinh-bang,273947792,"Điện thoại AI Samsung Galaxy S24 Ultra 12GB/256GB, Camera 200MP Zoom 100x, S Pen- Tím- Hàng Chính Hãng",28990000,34490000,5500000,16
TIKI,dien-thoai-may-tinh-bang,272909668,"[Mới] Điện thoại vivo V29e 5G (8GB/256GB) - Hàng Chính Hãng - Camera Selfie 50 MP - Vòng Sáng Aura 2.0 - Màn hình AMOLED 6.67",8990000,8990000,0,0
TIKI,dien-thoai-may-tinh-bang,270510406,"Điện thoại Vivo Y36 (8GB/128GB) - Hàng Chính Hãng - Camera 50MP - Sạc Nhanh 44W",5190000,5190000,0,0
TIKI,dien-thoai-may-tinh-bang,217645692,"Combo Máy đọc sách All New Kindle Paperwhite 5 (11th Gen) - 16Gb và Bao da - Hàng nhập khẩu",4090000,4290000,200000,5
TIKI,dien-thoai-may-tinh-bang,184036446,"Apple iPhone 11",9990000,15999000,6009000,38
TIKI,dien-thoai-may-tinh-bang,184059211,"Apple iPhone 13",13490000,24990000,11500000,46
TIKI,dien-thoai-may-tinh-bang,272113804,"[MỚI] Điện thoại vivo Y17s - Hàng chính hãng - Camera 50MP - Pin 5000 mAh - Sạc nhanh- RAM mở rộng đến 8GB",3990000,3990000,0,0
TIKI,dien-thoai-may-tinh-bang,183330021,"Apple iPad 10.2-inch (9th Gen) Wi-Fi 2021",6990000,10990000,4000000,36
TIKI,dien-thoai-may-tinh-bang,125182567,"Máy đọc sách All New Kindle Paperwhite 5 (11th Gen) - Hàng nhập khẩu",3680000,3680000,0,0
TIKI,dien-thoai-may-tinh-bang,273559020,"Máy tính bảng Kindle Fire HD10 2023 13th - 32Gb - Hàng chính hãng",3390000,3390000,0,0
TIKI,dien-thoai-may-tinh-bang,57809866,"Điện thoại Xiaomi Redmi 9A (2GB/32GB)",1690000,2490000,800000,32
TIKI,dien-thoai-may-tinh-bang,217640502,"Máy đọc sách Kindle Scribe - Hàng chính hãng",12590000,12590000,0,0
TIKI,dien-thoai-may-tinh-bang,173387789,"Máy đọc sách All New Kindle Oasis 3 - Hàng nhập khẩu",7200000,7200000,0,0
TIKI,dien-thoai-may-tinh-bang,125182567,"Máy đọc sách All New Kindle Paperwhite 5 (11th Gen) - Hàng nhập khẩu",3680000,3680000,0,0
TIKI,dien-thoai-may-tinh-bang,201067649,"Combo máy đọc sách Kindle Paperwhite 5 (11th gen) tặng kèm bao da ( Cover ) - Hàng nhập khẩu",3849000,4100000,251000,6
TIKI,dien-thoai-may-tinh-bang,163914808,"Điện thoại bàn Panasonic  KX-TS500MX-hàng chính hãng",300000,300000,0,0
TIKI,dien-thoai-may-tinh-bang,184248127,"Apple iPad mini (6th Gen) Wi-Fi 2021",11490000,14990000,3500000,23
TIKI,dien-thoai-may-tinh-bang,120295859,"Điện Thoại Nokia C30 (2GB/32GB) - Hàng Chính Hãng",1590000,1990000,400000,20
TIKI,dien-thoai-may-tinh-bang,252586291,"Máy đọc sách All New Kindle Paperwhite 5 (11th Gen) - Hàng chính hãng",3890600,3890600,0,0
TIKI,dien-thoai-may-tinh-bang,43924153,"Máy đọc sách Kindle Oasis 3 (2019) - Amazon - Hàng nhập khẩu",7166800,7790000,623200,8
TIKI,dien-thoai-may-tinh-bang,123345348,"Apple iPhone 12",12750000,16990000,4240000,25
TIKI,dien-thoai-may-tinh-bang,217706932,"Combo Máy đọc sách All New Kindle Paperwhite 5 (11th Gen) và Bao da - Hàng nhập khẩu",3750000,3750000,0,0
TIKI,dien-thoai-may-tinh-bang,271362153,"Combo Máy đọc sách All New Kindle Paperwhite 5 (11th Gen) và Bao da FOR KIDS (Bản KIDS, Không Quảng Cáo) - Hàng chính hãng",3790000,3790000,0,0
TIKI,dien-thoai-may-tinh-bang,198111545,"Điện Thoại Vivo V25e 2022 (8GB/128GB) - Hàng Chính Hãng",8490000,8490000,0,0
TIKI,dien-thoai-may-tinh-bang,204237269,"Điện Thoại Bàn Panasonic KX-TSC11 - Hàng Chính Hãng - Trắng",600000,600000,0,0
TIKI,dien-thoai-may-tinh-bang,201067649,"Combo máy đọc sách Kindle Paperwhite 5 (11th gen) tặng kèm bao da ( Cover ) - Hàng nhập khẩu",3760000,3990000,230000,6
TIKI,dien-thoai-may-tinh-bang,73842403,"Điện thoại bàn có dây nhỏ gọn màu trắng",250000,250000,0,0
TIKI,dien-thoai-may-tinh-bang,197654695,"Điện thoại Masstel izi 26 4G - Gọi HD Call - Hàng chính hãng",499000,650000,151000,23
TIKI,dien-thoai-may-tinh-bang,173387789,"Máy đọc sách All New Kindle Oasis 3 - Hàng nhập khẩu",5890000,5890000,0,0
TIKI,dien-thoai-may-tinh-bang,121744434,"Điện Thoại Xiaomi Redmi 10 4GB/128GB - Hàng Chính Hãng",2889000,4290000,1401000,33
TIKI,dien-thoai-may-tinh-bang,150724369,"Máy tính bảng Fire HD10 2021 - 11th - (All New Fire HD10 - 2021) - Ram 3/4GB, bộ nhớ 32GB, màn hình 1080 FullHD",3115000,3500000,385000,11
TIKI,dien-thoai-may-tinh-bang,197960169,"Điện thoại Masstel Lux 10 4G - Sang trọng - Gọi HD Call - Hàng chính hãng",549000,700000,151000,22
TIKI,dien-thoai-may-tinh-bang,172329599,"Điện thoại Xiaomi Redmi 9A (2GB/32GB) - Hàng chính hãng",1790000,2199000,409000,19
TIKI,dien-thoai-may-tinh-bang,170165701,"Điện thoại bàn Ktel 645 hàng chính hãng",398000,398000,0,0
TIKI,dien-thoai-may-tinh-bang,270794184,"Máy đọc sách Kobo Clara 2e - Hàng Chính Hãng",2990000,3199000,209000,7
TIKI,dien-thoai-may-tinh-bang,168526284,"Điện thoại Nokia 105 4G - Hàng chính hãng",675000,769000,94000,12
TIKI,dien-thoai-may-tinh-bang,173557858,"Máy tính bảng Kindle File HD 8 (10th generation - 2020) Hàng nhập khẩu",2250000,2250000,0,0
TIKI,dien-thoai-may-tinh-bang,197652030,"Điện thoại Masstel Lux 20 4G - Sang trọng - Gọi HD Call - Hàng chính hãng",579000,800000,221000,28
TIKI,dien-thoai-may-tinh-bang,11415485,"ĐIỆN THOẠI CỐ ĐỊNH PANASONIC KX-TS580MX",940000,940000,0,0
TIKI,dien-thoai-may-tinh-bang,181977398,"Điện thoại bàn Panasonic KX-TS880 hàng chính hãng",1050000,1050000,0,0
TIKI,dien-thoai-may-tinh-bang,31261844,"Điện Thoại Bàn Cố Định Không Dây Lắp Sim",650000,650000,0,0
TIKI,dien-thoai-may-tinh-bang,184578632,"Điện thoại Itel it9010 4G - Hàng chính hãng",399000,399000,0,0
TIKI,dien-thoai-may-tinh-bang,139632023,"Máy đọc sách Kobo Libra 2 - hàng nhập khẩu",5199000,5800000,601000,10
TIKI,dien-thoai-may-tinh-bang,252586291,"Máy đọc sách All New Kindle Paperwhite 5 (11th Gen) - Hàng chính hãng",3890600,3890600,0,0
TIKI,dien-thoai-may-tinh-bang,125590981,"Điện thoại Nokia C30 2GB/32GB - Hàng chính hãng",1550000,1550000,0,0
TIKI,dien-thoai-may-tinh-bang,181266509,"Điện thoại Ulefone Armor 14 pro (chống nước,chống va đập,pin khủng,pin 10.000mAh,Ram 8Gb,Rom 128Gb)- hàng chính hãng",5990000,5990000,0,0
TIKI,dien-thoai-may-tinh-bang,181452535,"Điện thoại Itel it9200 4G - WIFI - Xem YTB , FB - Hàng chính hãng",569000,790000,221000,28
TIKI,dien-thoai-may-tinh-bang,29931445,"Ulefone Armor X 5 ( chống nước,chống va đập,pin 5.000mAh ) hàng chính hãng",3990000,3990000,0,0
TIKI,dien-thoai-may-tinh-bang,195317118," Máy tính bảng Oppo Pad Air (4GB/64GB) - Hàng Chính Hãng",5490000,6999000,1509000,22
TIKI,dien-thoai-may-tinh-bang,217706932,"Combo Máy đọc sách All New Kindle Paperwhite 5 (11th Gen) và Bao da - Hàng nhập khẩu",3750000,3750000,0,0
TIKI,dien-thoai-may-tinh-bang,189466001,"Điện thoại Xiaomi Redmi 10A (2GB/32GB) - Hàng chính hãng",1949000,2890000,941000,33
TIKI,dien-thoai-may-tinh-bang,42333095,"Điện thoại cố định không dây cho người già, màn hình hiển thị đầu số - Hàng chính hãng",490000,490000,0,0
TIKI,dien-thoai-may-tinh-bang,43924153,"Máy đọc sách Kindle Oasis 3 (2019) - Amazon - Hàng nhập khẩu",6043100,6790000,746900,11
TIKI,dien-thoai-may-tinh-bang,167466044,"Điện thoại Masstel FAMI 60 4G Pin 2000 mah - Hàng chính hãng",649000,750000,101000,13
TIKI,dien-thoai-may-tinh-bang,140940220,"Máy đọc sách Kobo Sage - hàng nhập khẩu",7860000,8679000,819000,9
TIKI,dien-thoai-may-tinh-bang,273947792,"Điện thoại AI Samsung Galaxy S24 Ultra 12GB/256GB, Camera 200MP Zoom 100x, S Pen- Tím- Hàng Chính Hãng",28990000,34490000,5500000,16
TIKI,dien-thoai-may-tinh-bang,272909668,"[Mới] Điện thoại vivo V29e 5G (8GB/256GB) - Hàng Chính Hãng - Camera Selfie 50 MP - Vòng Sáng Aura 2.0 - Màn hình AMOLED 6.67",8990000,8990000,0,0
TIKI,dien-thoai-may-tinh-bang,270510406,"Điện thoại Vivo Y36 (8GB/128GB) - Hàng Chính Hãng - Camera 50MP - Sạc Nhanh 44W",5190000,5190000,0,0
TIKI,dien-thoai-may-tinh-bang,125182567,"Máy đọc sách All New Kindle Paperwhite 5 (11th Gen) - Hàng nhập khẩu",3680000,3680000,0,0
TIKI,dien-thoai-may-tinh-bang,217645692,"Combo Máy đọc sách All New Kindle Paperwhite 5 (11th Gen) - 16Gb và Bao da - Hàng nhập khẩu",4090000,4290000,200000,5
TIKI,dien-thoai-may-tinh-bang,74776150,"Máy đọc sách Kobo Libra H20 8GB Trắng/Đen có đèn nền vàng, chống nước - Hàng nhập khẩu",4499000,4499000,0,0
TIKI,dien-thoai-may-tinh-bang,167465704,"Điện thoại Masstel IZI 20 4G , Pin 1700 mAh - Hàng chính hãng",429000,499000,70000,14
TIKI,dien-thoai-may-tinh-bang,217640502,"Máy đọc sách Kindle Scribe - Hàng chính hãng",12590000,12590000,0,0
TIKI,dien-thoai-may-tinh-bang,11251711,"Điện thoại bàn không dây Panasonic KX-TGD312 - Hàng Chính Hãng",2090000,2090000,0,0
TIKI,dien-thoai-may-tinh-bang,197666071,"Điện thoại Masstel Fami 65 4G - Tặng dock sạc - Gọi HD Call - Hàng chính hãng",669000,900000,231000,26
TIKI,dien-thoai-may-tinh-bang,117929342,"Điện thoại Panasonic KX-TSC11MX -Hàng chính hãng",599000,599000,0,0
TIKI,dien-thoai-may-tinh-bang,4048581,"Điện Thoại Bàn Panasonic KX-TSC11",689000,689000,0,0
TIKI,dien-thoai-may-tinh-bang,198111545,"Điện Thoại Vivo V25e 2022 (8GB/128GB) - Hàng Chính Hãng",8490000,8490000,0,0
TIKI,dien-thoai-may-tinh-bang,173387789,"Máy đọc sách All New Kindle Oasis 3 - Hàng nhập khẩu",6190000,6190000,0,0
TIKI,dien-thoai-may-tinh-bang,194498804,"Máy Tính Bảng OPPO Pad Air (4GB/64GB) | Màn Hình 2K 1 tỷ Màu | Chip Snapdragon 680 | Hàng Chính Hãng",4190000,6990000,2800000,40
TIKI,dien-thoai-may-tinh-bang,118486668,"Máy đọc sách Kobo Elipsa - Hàng nhập khẩu",12000000,12000000,0,0
TIKI,dien-thoai-may-tinh-bang,271362153,"Combo Máy đọc sách All New Kindle Paperwhite 5 (11th Gen) và Bao da FOR KIDS (Bản KIDS, Không Quảng Cáo) - Hàng chính hãng",3790000,3790000,0,0
TIKI,dien-thoai-may-tinh-bang,155833852,"Điện Thoại Masstel Hapi 30 3GB/32GB - Hàng Chính Hãng",1879000,2390000,511000,21
TIKI,dien-thoai-may-tinh-bang,197966909,"Điện Thoại Samsung A04s 4GB/64GB - Hàng Chính Hãng",2649000,3990000,1341000,34
TIKI,dien-thoai-may-tinh-bang,23142193,"Điện thoại bàn không dây Panasonic KX-TGC313 - Hàng Chính Hãng",2100000,2100000,0,0
TIKI,dien-thoai-may-tinh-bang,140184098,"Điện Thoại Vsmart Bee Lite 2GB/16GB - Hàng Chính Hãng",999000,1990000,991000,50
TIKI,dien-thoai-may-tinh-bang,144200408,"Điện Thoại Bàn Không Dây Lắp Các Loại Sim Di Động Cố Địnḥ Viettel, Mobiphone, Vinaphone",799000,799000,0,0
TIKI,dien-thoai-may-tinh-bang,272113804,"[MỚI] Điện thoại vivo Y17s - Hàng chính hãng - Camera 50MP - Pin 5000 mAh - Sạc nhanh- RAM mở rộng đến 8GB",3990000,3990000,0,0
TIKI,dien-thoai-may-tinh-bang,176909016,"Máy tính bảng HANET Smart Edu Tablet Model T432 - Hàng Chính Hãng",3300000,3300000,0,0
TIKI,dien-thoai-may-tinh-bang,128895957,"Paperwhite 5 (11th-generation) - 2021 - Hàng Nhập Khẩu",3690000,3800000,110000,3
TIKI,dien-thoai-may-tinh-bang,72290345,"Máy đọc sách Kobo Clara HD 8GB đen, 6 inch, có đèn cam - Hàng nhập khẩu",3099000,3099000,0,0
TIKI,dien-thoai-may-tinh-bang,160450655,"Điện Thoại Masstel Tab 10A 3GB/32GB - Hàng Chính Hãng",2939000,3790000,851000,22
TIKI,dien-thoai-may-tinh-bang,125753416,"Điện thoại Nokia 110 4G - Hàng chính hãng",740000,740000,0,0
TIKI,dien-thoai-may-tinh-bang,170448099,"Điện Thoại Người Già Masstel Fami 60 4G - Loa To, FM Không Dây, Đọc Số Bằng Giọng Nói, SOS, Đèn Pin Kép,... Hàng Chính Hãng",672000,882000,210000,24
TIKI,dien-thoai-may-tinh-bang,192859201,"Điện thoại Oukitel WP19(chống sốc ,chống nước ,Pin 21000mAh ,Ram 8G ,Rom 256G ,Tầm nhìn ban đêm 64MP ,  Máy ảnh 90Hz ,Điện thoại Helio G95 )-hàng chính hãng",9790000,9790000,0,0
TIKI,dien-thoai-may-tinh-bang,143359355,"Điện Thoại Tecno Spark 6 Go 4GB/64GB - Hàng Chính Hãng",2079000,2990000,911000,30
TIKI,dien-thoai-may-tinh-bang,192694043,"Điện thoại để bàn Panasonic KX-TS880 hàng chính hãng",1060000,1060000,0,0
TIKI,dien-thoai-may-tinh-bang,148701811,"Máy đọc sách Kobo Nia - Hàng nhập khẩu",2680000,2680000,0,0
TIKI,dien-thoai-may-tinh-bang,62242668,"Điện Thoại Bàn Homephone lắp sim - Lắp Tất Cả Các Sim Đi Động - Di Chuyển Mang Đi Khắp Nơi - Hàng Chính Hãng",699000,699000,0,0
TIKI,dien-thoai-may-tinh-bang,72310352,"Máy tính bảng Vankyo MatrixPad Z10 - Hàng Chính Hãng",2990000,2990000,0,0
TIKI,dien-thoai-may-tinh-bang,197907038,"Điện thoại di động Vtel E10 4G – Hàng Chính Hãng",377000,399000,22000,6
TIKI,dien-thoai-may-tinh-bang,16521748,"Điện thoại để bàn Panasonic KX-TS880 hàng chính hãng",1150000,1150000,0,0
TIKI,dien-thoai-may-tinh-bang,217706932,"Combo Máy đọc sách All New Kindle Paperwhite 5 (11th Gen) và Bao da - Hàng nhập khẩu",3750000,3750000,0,0
TIKI,dien-thoai-may-tinh-bang,193366048,"Điện thoại OnePlus 10T 5G - Hàng Chính Hãng",15990000,15990000,0,0
TIKI,dien-thoai-may-tinh-bang,140144656,"Điện thoại Realme C25Y (4GB/128GB) - Hàng chính hãng",3599000,4990000,1391000,28
TIKI,dien-thoai-may-tinh-bang,136876846,"Máy Tính Bảng Samsung Galaxy Tab A7 3GB/64GB - Hàng Chính Hãng",4989000,7990000,3001000,38
TIKI,dien-thoai-may-tinh-bang,162866839,"Máy tính bảng VNPT Technology VNT Tab8 Plus 8 Inch Android 11 RAM 4GB - Hàng chính hãng",3146000,3146000,0,0
TIKI,dien-thoai-may-tinh-bang,147969070,"Điện thoại thông minh itel A26 - giá rẻ | 2 Sim 2 Sóng 4G LTE | Màn hình IPS 5.7" HD+ | RAM 2GB + ROM 32 GB (Hỗ trợ thẻ nhớ 32 GB) | Mở khoá bằng Gương Mặt | Chính Hãng bảo hành 12 tháng| 1 đổi 1 trong 30 ngày",2390000,2390000,0,0
TIKI,dien-thoai-may-tinh-bang,273559020,"Máy tính bảng Kindle Fire HD10 2023 13th - 32Gb - Hàng chính hãng",3390000,3390000,0,0
TIKI,dien-thoai-may-tinh-bang,158895857,"Điện thoại Vivo Y33s (8GB/128GB) - Hàng chính hãng",6069000,6069000,0,0
TIKI,dien-thoai-may-tinh-bang,84757299,"Điện thoại Itel it9200 4G - Hàng chính hãng",590000,590000,0,0
TIKI,dien-thoai-may-tinh-bang,72310420,"Máy tính bảng VANKYO MatrixPad S30 - Hàng Chính Hãng",3090000,3090000,0,0
TIKI,dien-thoai-may-tinh-bang,151463645,"Điện thoại Bphone A60 (Ram 6Gb,Rom 128 Gb,màn hình đục lổ FHD 6.7inch , pin 5.000mAh ) - Hàng chính hãng",6490000,6490000,0,0
TIKI,dien-thoai-may-tinh-bang,125753291,"Điện thoại Nokia 105 4G - Hàng chính hãng",629000,629000,0,0
TIKI,dien-thoai-may-tinh-bang,185755283,"Máy đọc sách Onyx Boox Nova Air - Hàng chính hãng",9860000,9860000,0,0
TIKI,dien-thoai-may-tinh-bang,197651936,"Điện thoại Masstel Izi 25 4G Pin siêu khỏe, Gọi HD call- Hàng chính hãng",499000,599000,100000,17
TIKI,dien-thoai-may-tinh-bang,47292697,"Điện thoại bàn cổ điển DT40",2000000,2000000,0,0
TIKI,dien-thoai-may-tinh-bang,31820638,"Điện Thoại Bàn Panasonic KX-TS500MX - Panasonic KX-TS500MX Integrated Telephone System - Hàng chính hãng",299000,299000,0,0
TIKI,dien-thoai-may-tinh-bang,196760330,"Điện Thoại Vivo T1x 4GB/64GB - Hàng Chính Hãng",3299000,4490000,1191000,27
TIKI,dien-thoai-may-tinh-bang,37289936,"Điện thoại Oukitel WP2 chống nước,chống va đập, pin 10.000 mAh - Hàng chính hãng",5490000,5490000,0,0
TIKI,dien-thoai-may-tinh-bang,4048043,"Điện Thoại Bàn Panasonic KX-TS500",339000,369000,30000,8
TIKI,dien-thoai-may-tinh-bang,221518066,"Máy đọc sách Kindle Oasis 3 10th - Hàng nhập khẩu",6042210,6789000,746790,11
TIKI,dien-thoai-may-tinh-bang,273227290,"Combo Máy đọc sách Kindle Scribe kèm bút – thế hệ đầu tiên có thể đọc và viết, màn hình 10,2” 300PPI, đèn vàng warmlight, bộ nhớ 16-64GB, đồng bộ dữ liệu qua Microsoft Word - hàng nhập khẩu",11276100,11390000,113900,1
TIKI,dien-thoai-may-tinh-bang,171852890,"Điện thoại Masstel FAMI 60 4G ,Pin 2000 mah ,cỡ chữ to rõ ràng,âm thanh lớn,màn hình to- Hàng chính hãng",689000,689000,0,0
TIKI,dien-thoai-may-tinh-bang,196176544,"Điện Thoại Cho Người Già Masstel Fami 12 4G-hỗ trợ 4g-chữ to dành cho người già(Hàng Chính Hãng)",630000,630000,0,0
TIKI,dien-thoai-may-tinh-bang,198203859,"Điện Thoại Vivo V25 5G 2022 (8GB/128GB) - Hàng Chính Hãng",7190000,10490000,3300000,31
TIKI,dien-thoai-may-tinh-bang,29440849,"điện thoại  IP622C - hàng chính hãng",1650000,1650000,0,0
TIKI,dien-thoai-may-tinh-bang,198111545,"Điện Thoại Vivo V25e 2022 (8GB/128GB) - Hàng Chính Hãng",8490000,8490000,0,0
TIKI,dien-thoai-may-tinh-bang,188030974,"Máy tính bảng Oukitel RT1 - hàng chính hãng  (chống nước,chống va đập , pin khủng,pin 10.000mAh,màn hình 10,1 inch,Ram 4Gb,Rom 64Gb,tám nhân,học online)",6990000,6990000,0,0
TIKI,dien-thoai-may-tinh-bang,4059671,"Điện Thoại Bàn Panasonic KXTS 520 - Hàng Chính Hãng",469000,489000,20000,4
TIKI,dien-thoai-may-tinh-bang,11110653,"Điện thoại bàn không dây Panasonic KX-TGF320 - Hàng Chính Hãng",2500000,2500000,0,0
TIKI,dien-thoai-may-tinh-bang,181216830,"Điện thoại ZTE Blade V40 Vita (ZTE 8045) - MH giọt nước HD+ 6.75" - Pin 6000 mAh sạc nhanh 22.5W -  Bộ nhớ mở rộng (4+2)GB - Hàng chính hãng",4290000,4290000,0,0
TIKI,dien-thoai-may-tinh-bang,157835051,"Điện Thoại Để Bàn Panasonic KX-TS500MX - Hàng Chính Hãng",380000,380000,0,0
TIKI,dien-thoai-may-tinh-bang,257866809,"Điện thoại để bàn tân cổ điển phím quay DT15",3900000,3900000,0,0
TIKI,dien-thoai-may-tinh-bang,174085242,"Điện Thoại Cho Người Già Masstel Fami 12 4G - Viền Kim Loại, Ăng Ten FM Không Dây - Hàng Chính Hãng",606000,699000,93000,13
TIKI,dien-thoai-may-tinh-bang,11376644,"Điện thoại bàn có dây Panasonic KX-TS560MX",730000,730000,0,0
TIKI,dien-thoai-may-tinh-bang,169651533,"Máy đọc thẻ flashcard Tiếng Anh 224 từ vựng không sóng điện từ",149000,149000,0,0
TIKI,dien-thoai-may-tinh-bang,52326343,"Cisco Unified IP Phone CP-7821-K9 - Hàng chính hãng",2580000,2580000,0,0
TIKI,dien-thoai-may-tinh-bang,215125094,"Điện Thoại Di Động Forme D999 4G - Hàng Chính Hãng",760000,760000,0,0
TIKI,dien-thoai-may-tinh-bang,54989813,"Điện thoại tân cổ điển để bàn mã DT4 màu trắng kết hợp vàng, chuông thanh bàn phím quay, dùng sim di động nghe gọi âm thanh tốt và để trang trí (Điện thoại bàn tân cổ điển)",2320000,2900000,580000,20
TIKI,dien-thoai-may-tinh-bang,55197731,"Điện thoại bàn màu đỏ KXT438",215000,215000,0,0
TIKI,dien-thoai-may-tinh-bang,121154009,"Điện thoại bàn cố định không dây lắp các loại Sim Di động, Cố định (Viettel, Vinaphone, Mobifone...)",650000,650000,0,0
TIKI,dien-thoai-may-tinh-bang,170727305,"Điện thoại bàn Panasonic KX-TS580 hàng chính hãng",999000,999000,0,0
TIKI,dien-thoai-may-tinh-bang,197905982,"Điện thoại di động Vtel E10 4G – Hàng Chính Hãng",379050,399000,19950,5
TIKI,dien-thoai-may-tinh-bang,21317020,"Điện thoại bàn không dây Panasonic KX-TGF310 - Hàng Chính Hãng",2450000,2450000,0,0
TIKI,dien-thoai-may-tinh-bang,54882670,"Điện thoại để bàn tân cổ điển chuông thanh bàn phím quay mã DT10 dùng sim di động hoặc dùng cáp nghe gọi âm thanh rõ ràng và để trang trí (điện thoại bàn tân cổ điển)",2320000,2900000,580000,20
TIKI,dien-thoai-may-tinh-bang,14508445,"Điện thoại Ip phone Cisco CP-7841-K9 chính hãng",4200000,4200000,0,0
TIKI,dien-thoai-may-tinh-bang,140747649,"Điện thoại Realme C11 2021 (4GB/64GB) - Hàng chính hãng",3790000,3790000,0,0
TIKI,dien-thoai-may-tinh-bang,94453667,"Điện thoại VoIP Yealink SIP-T30",1050000,1050000,0,0
TIKI,dien-thoai-may-tinh-bang,156222386,"Điện thoại Panasonic KX-TS520MX -Hàng chính hãng",449000,459000,10000,2
TIKI,dien-thoai-may-tinh-bang,54683561,"ĐIỆN THOẠI TÂN CỔ ĐIỂN DT14 bàn phím quay chuông quả, dùng cáp điện thoại cố định nghe gọi âm thanh rõ ràng (điện thoại bàn tân cổ điển)",3520000,4400000,880000,20
TIKI,dien-thoai-may-tinh-bang,113475741,"Điện thoại Panasonic KX-TS520MX - Trắng - Hàng chính hãng",450000,450000,0,0
TIKI,dien-thoai-may-tinh-bang,91281318,"Máy Đọc Sách Likebook P10 - Hàng chính hãng",9090000,9090000,0,0
TIKI,dien-thoai-may-tinh-bang,15428119,"Điện thoại Ip phone Cisco CP-7945G chính hãng",4500000,4500000,0,0
TIKI,dien-thoai-may-tinh-bang,125171841,"Điện Thoại Bàn Panasonic KX-TSC11 - Hàng Chính Hãng",620000,620000,0,0
TIKI,dien-thoai-may-tinh-bang,117347869,"ĐIỆN THOẠI HỘI NGHỊ YEALINK CP960 -HÀNG CHÍNH HÃNG",15230000,15230000,0,0
TIKI,dien-thoai-may-tinh-bang,16518032,"Điện thoại để bàn Panasonic KX-TS560 hàng chính hãng",730000,730000,0,0
TIKI,dien-thoai-may-tinh-bang,52481412,"Điện thoại bàn cổ điển, điện thoại bàn tân cổ điển, DT122",2200000,2200000,0,0
TIKI,dien-thoai-may-tinh-bang,23865953,"Điện Thoại Để Bàn Panasonic KX-TS500MX - Hàng Chính Hãng",299000,299000,0,0
TIKI,dien-thoai-may-tinh-bang,148696890,"Máy tính bảng Moocis màn hình cong tích cầu hình tốt 2019",3936000,3936000,0,0
TIKI,dien-thoai-may-tinh-bang,182850918,"Máy đọc thẻ flashcard tiếng anh 224 từ",120000,120000,0,0
TIKI,dien-thoai-may-tinh-bang,177212711,"Máy đọc thẻ flashcard tiếng anh hàng loại 1- 8 chip",134599,134599,0,0
TIKI,dien-thoai-may-tinh-bang,274440344,"Điện thoại Xiaomi Redmi Note 13 pro (8GB - 128GB) hàng chính hãng - Bảo hành 18 tháng",6490000,6790000,300000,4
TIKI,dien-thoai-may-tinh-bang,29446449,"Điện thoại không dây IP 622CW ",1850000,1850000,0,0
TIKI,dien-thoai-may-tinh-bang,172537996,"(Hàng chính hãng) Điện thoại bàn hữu tuyến H2P, hiệu Alcatel - Lucent",2220000,2220000,0,0
TIKI,dien-thoai-may-tinh-bang,53380152,"Điện Thoại IP Phone Fanvil X1S - Hàng Chính Hãng",950000,950000,0,0
TIKI,dien-thoai-may-tinh-bang,274639765,"Điện thoại OPPO A2M 5G 6GB/128GB , Dimensity 6020 , Màn 90Hz , Rom tiếng việt - Hàng chính hãng",2990000,3690000,700000,19
TIKI,dien-thoai-may-tinh-bang,160434731,"Máy Tính Bảng Samsung Galaxy Tab A8 4GB/64GB - Hàng Chính Hãng",5856000,5856000,0,0
TIKI,dien-thoai-may-tinh-bang,262589811,"Điện thoại Samsung Galaxy A24 (6GB/128GB) - Hàng chính hãng - ĐÃ KÍCH HOẠT BẢO HÀNH ĐIỆN TỬ",6084000,6084000,0,0
TIKI,dien-thoai-may-tinh-bang,249730344,"Điện thoại Masstel IZI 12 4G LTE - 2 Sim 2 Sóng - Pin 1000 mAh - Loa to - Hàng Chính Hãng - Bảo Hành 12 Tháng",456000,456000,0,0
TIKI,dien-thoai-may-tinh-bang,273388474,"Điện thoại chắc chắn Ulefone Power Armor 18T Ultra (chụp ảnh nhiệt Camera FLIR5G 512GB ROM +24GB RAM)- hàng chính hãng",15990000,15990000,0,0
TIKI,dien-thoai-may-tinh-bang,271822675,"Máy Tính Bảng Samsung Galaxy Tab A8 - Hàng Chính Hãng",5856000,5856000,0,0
TIKI,dien-thoai-may-tinh-bang,255866251,"Điện Thoại Samsung A14 4GB/128GB - Hàng Chính Hãng",3349000,4490000,1141000,25
TIKI,dien-thoai-may-tinh-bang,215097578,"Điện Thoại Di Động Forme D666 4G - Hàng Chính Hãng",650000,650000,0,0
TIKI,dien-thoai-may-tinh-bang,274019932,"Điện thoại Masstel Izi 56 4G (LTE) Gọi HD Call ,Pin khủng ,loa lớn - Hàng Chính Hãng",569000,650000,81000,12
TIKI,dien-thoai-may-tinh-bang,224873580,"Điện thoại Masstel izi 26 - Hàng chính hãng ",600000,600000,0,0
TIKI,dien-thoai-may-tinh-bang,247730209,"Điện thoại Samsung Galaxy A34 5G (8GB/128GB) - Hàng chính hãng",7164000,7164000,0,0
TIKI,dien-thoai-may-tinh-bang,251772653,"Điện thoại Masstel izi 56 4G (pin trâu-loa chữ to rõ) - Hàng Chính Hãng",687000,687000,0,0
TIKI,dien-thoai-may-tinh-bang,262908601,"Máy tính bảng chắc chắn oukitel RT3 (chống nước,chống va đập,Ram 4Gb,Rom 64 Gb,màn hình 8 inch,pin 5150 mAh)- hÀng chính hãng",4990000,4990000,0,0
TIKI,dien-thoai-may-tinh-bang,273373420,"Điện thoại Xiaomi Redmi 13C (4GB/128GB) - Hàng chính hãng - Bảo hành 18 tháng",2890000,2890000,0,0
TIKI,dien-thoai-may-tinh-bang,252884859,"Tay con điện thoại bàn Panasonic TGDA30-hàng chính hãng",990000,990000,0,0
TIKI,dien-thoai-may-tinh-bang,245770363,"Điện thoại Samsung Galaxy A04e (3GB/32GB) - Hàng chính hãng",2325000,2325000,0,0
TIKI,dien-thoai-may-tinh-bang,273360836,"Điện thoại Ulefone armor 22(chống nước,chống va đập, Màn hình giọt nước 6,58 inch, RAM:8GB,Rom 128GB/256GB,Thẻ nhớ microSD Lên đến 512GB, Camera kép 64MP + 64MP)- hàng chính hãng",5990000,5990000,0,0
TIKI,dien-thoai-may-tinh-bang,272555368,"XIAOMI 13T 5G (12GB-256GB) - Hàng chính hãng",11300000,11990000,690000,6
TIKI,dien-thoai-may-tinh-bang,274191773,"Điện thoại ZTE Libero 5G IV - 4GB/128GB Dimensity 700 , Kháng nước IP67 , Sạc nhanh 22,5W - Mới nguyên seal - Hàng nhập khẩu",2399000,2990000,591000,20
TIKI,dien-thoai-may-tinh-bang,153581568,"Điện thoại Masstel IZI 55 4G - Hàng chính hãng",659000,659000,0,0
TIKI,dien-thoai-may-tinh-bang,273366296,"ulefone Armor 24 (TIÊU CHUẨN MIL-STD-810H ,IP69K, chống nước ,chống sốc,pin 22000mah , màn hình6,78 inch, NFC, Ram24GB(12Gb+12Gb),rom 256GB)-hàng chính hãng ",7990000,7990000,0,0
TIKI,dien-thoai-may-tinh-bang,274544634,"Điện thoại Redmi Note 12R 5G 6/128GB Snapdragon 4 Gen 2, Rom Quốc tế có sẳn Tiếng việt - Hàng nhập khẩu",3090000,3590000,500000,14
TIKI,dien-thoai-may-tinh-bang,192348147,"Điện thoại Oppo A57 (4GB/64GB) - Hàng chính hãng",4284000,4284000,0,0
TIKI,dien-thoai-may-tinh-bang,249178196,"Điện thoại Samsung Galaxy A34 5G 8GB/128GB Xanh - Hàng chính hãng",7290000,8490000,1200000,14
TIKI,dien-thoai-may-tinh-bang,252073075,"Điện thoại Masstel IZI11 4G - Hàng Chính Hãng",468000,468000,0,0
TIKI,dien-thoai-may-tinh-bang,249890023,"Điện Thoại Xiaomi Redmi Note 12 Pro 5G 8GB/256GB - Hàng Chính Hãng",9000000,9000000,0,0
TIKI,dien-thoai-may-tinh-bang,273411988,"Điện thoại Xiaomi Redmi 13C (6+128GB) | 6.74" 90Hz| Media Tek Helio G85| 5000mAh - Hàng chính hãng",3090000,3490000,400000,11
TIKI,dien-thoai-may-tinh-bang,204872160,"Điện thoại Oppo A17k (3GB/64GB) - Hàng chính hãng",3290000,3290000,0,0
TIKI,dien-thoai-may-tinh-bang,261965186,"Điện Thoại Xiaomi Redmi Note 12S (8GB/256GB) - Hàng Chính Hãng",6132000,6132000,0,0
TIKI,dien-thoai-may-tinh-bang,197902452,"Điện thoại Masstel Lux 20 4G dành cho người lớn tuổi - Hàng chính hãng, Nguyên Seal",790000,790000,0,0
TIKI,dien-thoai-may-tinh-bang,213931247,"Điện thoại Samsung Galaxy A04 (3GB / 32GB) - Hàng chính hãng - Mới 100% Nguyên Seal - Pin Khủng 5000 mAh - Bảo Hành 12 Tháng",2400000,2400000,0,0
TIKI,dien-thoai-may-tinh-bang,270707514,"Máy Đọc Sách BOOX Tab Mini C - Hàng Chính Hãng",11750000,12990000,1240000,10
TIKI,dien-thoai-may-tinh-bang,270978486,"Điện thoại Samsung Galaxy M14 5G (6GB/128GB) - Đã kích hoạt bảo hành điện tử - Hàng chính hãng",3990000,5690000,1700000,30
TIKI,dien-thoai-may-tinh-bang,273640492,"Điện Thoại Samsung Galaxy A05 (6GB/128GB) - Hàng Chính Hãng",3450000,3450000,0,0
TIKI,dien-thoai-may-tinh-bang,253443894,"Điện Thoại Samsung Galaxy M14 5G (4GB/128GB) - Hàng Chính Hãng",3937000,3937000,0,0
TIKI,dien-thoai-may-tinh-bang,244355503,"Điện thoại Samsung Galaxy A04s (4GB/64BG) - Hàng chính hãng",3990000,3990000,0,0
TIKI,dien-thoai-may-tinh-bang,273244815,"Điện thoại Samsung Galaxy A23 5G 4GB/128GB Đen - Hàng chính hãng",4160000,5990000,1830000,31
TIKI,dien-thoai-may-tinh-bang,273897590,"Điện thoại Tecno SPARK 20c (8+8)GB/128GB - MTK G36 | 5000 mAh | Sạc nhanh 18W | Hàng Chính Hãng",2490000,2690000,200000,7
TIKI,dien-thoai-may-tinh-bang,258330471,"Điện thoại để bàn tân cổ điển phím bấm DT08, Điện thoại nghe gọi được",3500000,3500000,0,0
TIKI,dien-thoai-may-tinh-bang,121059239,"Máy Tính Bảng Samsung Galaxy Tab A7 Lite T225 3GB/32GB - Hàng Chính Hãng",3587000,3587000,0,0
TIKI,dien-thoai-may-tinh-bang,252865847,"Điện thoại di động Forme Q8 (4G) - Hàng chính hãng",499000,599000,100000,17
TIKI,dien-thoai-may-tinh-bang,249168949,"Điện thoại Samsung Galaxy A34 5G 8GB/128GB Bạc - Hàng chính hãng",7290000,8490000,1200000,14
TIKI,dien-thoai-may-tinh-bang,247823537,"Điện thoại Realme C55 (6GB/128GB) - Hàng chính hãng",3790000,4990000,1200000,24
TIKI,dien-thoai-may-tinh-bang,274536294,"Máy đọc sách Kindle Paperwhite 5 (16GB) - Hàng chính hãng",4050000,4990000,940000,19
TIKI,dien-thoai-may-tinh-bang,242434782,"Máy đọc sách New Kindle 11th 2022 (16GB) - Hàng nhập khẩu",3090000,3090000,0,0
TIKI,dien-thoai-may-tinh-bang,273664463,"Điện Thoại Oppo A18 4GB/128GB - Hàng Chính Hãng",3399000,3990000,591000,15
TIKI,dien-thoai-may-tinh-bang,274568845,"Điện thoại Xiaomi 14 5G (12GB/256GB) - Hàng chính hãng",22990000,22990000,0,0
TIKI,dien-thoai-may-tinh-bang,274498287,"Điện Thoại Samsung Galaxy A55 5G (8GB/128GB)- Hàng Chính Hãng",9290000,9990000,700000,7
TIKI,dien-thoai-may-tinh-bang,270074304,"Điện Thoại Xiaomi Redmi Note 12S 8GB/256GB - Hàng Chính Hãng",4719000,6690000,1971000,29
TIKI,dien-thoai-may-tinh-bang,273955111,"Điện Thoại Oppo Reno 10 5G (8GB/128GB) - Hàng Chính Hãng",7490000,8990000,1500000,17
TIKI,dien-thoai-may-tinh-bang,197214029,"Apple iPhone 14",16490000,24990000,8500000,34
TIKI,dien-thoai-may-tinh-bang,204671569,"Điện Thoại Oppo A17k 3GB/64GB - Hàng Chính Hãng",2519000,3290000,771000,23
TIKI,dien-thoai-may-tinh-bang,270510406,"Điện thoại Vivo Y36 (8GB/128GB) - Hàng Chính Hãng - Camera 50MP - Sạc Nhanh 44W",5190000,5190000,0,0
TIKI,dien-thoai-may-tinh-bang,271290719,"Điện Thoại Cho Người Già Masstel Fami 65 - SOS, Loa To, FM Không Dây, Đọc Số Bằng Giọng Nói, Xem Lịch Âm - HÀNG CHÍNH HÃNG",692000,999000,307000,31
TIKI,dien-thoai-may-tinh-bang,257861524,"Điện thoại để bàn tân cổ điển phím quay DT11",3500000,3500000,0,0
TIKI,dien-thoai-may-tinh-bang,274506430,"Điện thoại Xiaomi Redmi A2+ (3GB/64GB) - Hàng chính hãng",2029000,2790000,761000,27
TIKI,dien-thoai-may-tinh-bang,273258830,"Điện thoại Samsung Galaxy A05 (4GB/128GB) - Đã kích hoạt bảo hành điện tử -Hàng chính hãng",2590000,3050000,460000,15
TIKI,dien-thoai-may-tinh-bang,273942001,"Điện thoại Xiaomi Redmi Note 13 (6GB/128GB) - Hàng chính hãng",4090000,4490000,400000,9
TIKI,dien-thoai-may-tinh-bang,273685412,"Điện thoại Samsung Galaxy A25 5G (6GB/128GB) - Hàng chính hãng",5819000,6590000,771000,12
TIKI,dien-thoai-may-tinh-bang,153581522,"Máy đọc sách All new Paperwhite Gen 5 (11th) màn hình 6.8 inch có đèn vàng warmlight",3690000,3800000,110000,3
TIKI,dien-thoai-may-tinh-bang,273127929,"Điện thoại Xiaomi 13T 12GB-256GB - Hàng Chính Hãng",12990000,12990000,0,0
TIKI,dien-thoai-may-tinh-bang,270636882,"Điện Thoại Samsung M14 5G 4GB/64GB - Hàng Chính Hãng",2979000,4990000,2011000,40
TIKI,dien-thoai-may-tinh-bang,273016223,"Điện Thoại Xiaomi Redmi A2 2GB/32GB - Hàng Chính Hãng",1719000,2190000,471000,22
TIKI,dien-thoai-may-tinh-bang,274762212,"Điện thoại Samsung Galaxy A55 5G - Hàng chính hãng",8699000,9900000,1201000,12
TIKI,dien-thoai-may-tinh-bang,168320000,"Điện Thoại Xiaomi Redmi 9A (2GB/32GB)- Đã kích hoạt bảo hành điện tử- Hàng Chính Hãng - Granite Gray",2088000,2088000,0,0
TIKI,dien-thoai-may-tinh-bang,274116886,"Điện Thoại Xiaomi Redmi A2+ 3GB/64GB - Hàng Chính Hãng",1949000,2790000,841000,30
TIKI,dien-thoai-may-tinh-bang,274101262,"Máy Tính Bảng Samsung Galaxy Tab A9 Plus Wifi 4GB/64GB - Hàng Chính Hãng",3950000,5990000,2040000,34
TIKI,dien-thoai-may-tinh-bang,271730109,"Điện thoại chắc chắn Ulefone Armor X13, (Ram 12GB(6Gb+6Gb),Rom 64GB,chống nước,chống va đập IP68/IP69K, Android 13,CPU MediaTek Helio G36 Octa Core,Màn hình 6,52 inch, Mạng: 4G, NFC,OTG)-hàng chính hãng",3990000,3990000,0,0
TIKI,dien-thoai-may-tinh-bang,191689878,"Điện thoại OPPO CPH2387 - A57 Xanh - Hàng Chính Hãng",4632000,4632000,0,0
TIKI,dien-thoai-may-tinh-bang,270832077,"Điện thoại Xiaomi Redmi 12 (4GB-128GB) - Hàng Chính Hãng",3890000,3890000,0,0
TIKI,dien-thoai-may-tinh-bang,249955152,"Điện thoại Xiaomi Redmi Note 12 Pro 5G (8GB/256GB) - Hàng chính hãng",8229000,9490000,1261000,13
TIKI,dien-thoai-may-tinh-bang,164697930,"Máy tính bảng Samsung Galaxy Tab A8  (2022) - Hàng chính hãng - ĐÃ KÍCH HOẠT BẢO HÀNH ĐIỆN TỬ",5856000,5856000,0,0
TIKI,dien-thoai-may-tinh-bang,251275686,"Điện thoại OPPO A57 4GB/128GB Vàng - Hàng chính hãng",4632000,4632000,0,0
TIKI,dien-thoai-may-tinh-bang,247016383,"Điện Thoại Xiaomi Redmi 12C 4GB/64GB - Hàng Chính Hãng",3168000,3168000,0,0
TIKI,dien-thoai-may-tinh-bang,188948039,"Máy tính bảng Samsung Galaxy Tab A8 64GB Xám (2022) - Hàng Chính Hãng",5856000,5856000,0,0
TIKI,dien-thoai-may-tinh-bang,190544267,"Điện Thoại Oppo A57 4GB/64GB - Hàng Chính Hãng",4284000,4284000,0,0
TIKI,dien-thoai-may-tinh-bang,271234577,"Điện Thoại Nokia 105 4G Pro - Hàng Chính Hãng",669000,680000,11000,2
TIKI,dien-thoai-may-tinh-bang,260406257,"Điện thoại oukitel wp23 ( chống nước,chống va đập,pin 10600mAh,Ram 4Gb.Rom 64Gb,màn hình 6.52 inch,mạng 2,3,4G,Android 13 )-hàng chính hãng",3990000,3990000,0,0
TIKI,dien-thoai-may-tinh-bang,273232944,"Máy tính bảng Masstel Tab 10.4 - Hàng chính hãng",4990000,4990000,0,0
TIKI,dien-thoai-may-tinh-bang,262516014,"Điện Thoại Samsung Galaxy A34 5G - Hàng Chính Hãng",7164000,7164000,0,0
TIKI,dien-thoai-may-tinh-bang,273430216,"Điện thoại Ulefone Armor 13 (pin khủng,pin 13.200mAh, Ram 8Gb,Rom 256Gb,chống sốc,chống va đập,nội soi,tia hồng ngoại,tia lade,loa to,học online)- hàng chính hãng",7990000,7990000,0,0
TIKI,dien-thoai-may-tinh-bang,198868735,"Điện thoại IP Grandstream GRP 2601 hàng chính hãng",880000,880000,0,0
TIKI,dien-thoai-may-tinh-bang,220678495,"Điện thoại bàn DECT không dây Yealink W73H có chân đế - Hàng chính hãng",2200000,2200000,0,0
TIKI,dien-thoai-may-tinh-bang,248235765,"Điện Thoại Masstel iZi 26 4G - Hàng Chính Hãng",589000,640000,51000,8
TIKI,dien-thoai-may-tinh-bang,274361820,"Máy Tính Bảng Học Tập Smart Study 1, Hàng Chính Hãng, Cho Trẻ Từ 5-12 Tuổi, 64GB, Tích Hợp Chương Trình Học Tập Toàn Diện",5900000,7900000,2000000,25
TIKI,dien-thoai-may-tinh-bang,248185228,"Điện Thoại Masstel Lux 10 4G - Hàng Chính Hãng",675000,675000,0,0
TIKI,dien-thoai-may-tinh-bang,249730339,"Điện Thoại Masstel IZI 55 4G LTE - 2 Sim 2 Sóng - Pin 1800 mAh - Hàng Chính Hãng - Bảo Hành 12 Tháng",659000,659000,0,0
TIKI,dien-thoai-may-tinh-bang,190701486,"Điện Thoại OPPO A57 (4GB/64GB) - Hàng Chính Hãng",4284000,4284000,0,0
TIKI,dien-thoai-may-tinh-bang,258787119,"Máy tính bảng OUKITEL RT2 chắc chắn (chống nước,chống va đập ,pin xài lâu,Pin  20.000Mah, Màn hình  10,1 inch,Ram 8GB,Rom  128 GB, lõi tám nhân,Máy ảnh 16MP,Android 12,sạc nhanh 33W)- hàng chính hãng",8990000,8990000,0,0
TIKI,dien-thoai-may-tinh-bang,274507025,"Điện thoại Realme V50 5G 6GB/128GB ,CPU Dimensity 6100+ , Màn 120HZ , Rom Quốc tế có tiếng việt - Hàng nhập khẩu",3250000,3990000,740000,19
TIKI,dien-thoai-may-tinh-bang,273359059,"Điện Thoại Chắc Chắn OUKITEL WP23 PRO ( Ram 16Gb(8GB+8Gb),Rom 128GB ,Android13, Pin 10600mAh,Màn hình 6.52 "HD + ,13MP camera Sau,chống nước,chống va đập)-hàng chính hãng",4990000,4990000,0,0
TIKI,dien-thoai-may-tinh-bang,263438199,"Máy tính bảng Edutab 10.1 Pro & Case da tặng Hệ thống quản lý học tập & kiểm soát dành cho Phụ huynh trọn đời",4989000,4989000,0,0
TIKI,dien-thoai-may-tinh-bang,220670303,"Yealink W73P - Điện thoại IP cầm tay không dây DECT - Hàng Chính Hãng - Điện thoại IP mẹ bồng con",2800000,2800000,0,0
TIKI,dien-thoai-may-tinh-bang,207268158,"Điện thoại Samsung Galaxy A04 (3G+32G) SM-A045F Đen - Hàng Chính Hãng (chỉ giao HN và một số khu vực)",2400000,2400000,0,0
TIKI,dien-thoai-may-tinh-bang,271798615,"Điện thoại thông minh siêu bền Oukitel WP28 (màn hình 6.52‘' ,HD+ ,pin 10600mAh ,Ram 15Gb(8GB+7Gb),Rom 256GB ,Android13, camera 48MP)-hàng chính hãng",4990000,4990000,0,0
TIKI,dien-thoai-may-tinh-bang,258667842,"Điện thoại Xiaomi Redmi Note 12 Pro 4G (8GB/256GB) - Hàng chính hãng",6390000,7990000,1600000,20
TIKI,dien-thoai-may-tinh-bang,249156531,"Điện thoại Realme C55 6GB/128GB Vàng nắng mai - Hàng chính hãng",4680000,4990000,310000,6
TIKI,dien-thoai-may-tinh-bang,271982547,"Điện thoại Oukitel  WP12 Pro (chống nước,chống va đập,RAM 8GB(Ram 4GB+ 4Gb),Rom 64 Gb,8 nhân)- hÀng chính hãng",3990000,3990000,0,0
TIKI,dien-thoai-may-tinh-bang,273373436,"Điện thoại Xiaomi Redmi 13C (6GB/128GB) - Hàng chính hãng - Bảo hành 18 tháng",3090000,3490000,400000,11
TIKI,dien-thoai-may-tinh-bang,271494404,"Điện thoại Tecno POVA 5 (8GB+8GB/128GB) RAM mở rộng 16GB | Pin 6000 mAh | Màn 120Hz - Sạc nhanh 45W - Hàng Chính Hãng",3890000,4490000,600000,13
TIKI,dien-thoai-may-tinh-bang,252073056,"Điện thoại Mobell M239 - Hàng chính hãng",404100,404100,0,0
TIKI,dien-thoai-may-tinh-bang,252072952,"Nokia 5710 XpressAudio | Hàng Chính Hãng",1690000,1690000,0,0
TIKI,dien-thoai-may-tinh-bang,274059475,"Điện Thoại Samsung Galaxy S24 Ultra (12GB/256GB) - Hàng Chính Hãng",29990000,33990000,4000000,12
TIKI,dien-thoai-may-tinh-bang,217158870,"Máy tính bảng Samsung Galaxy Tab A8 (4GB/64GB) - Hàng Chính Hãng",5856000,5856000,0,0
TIKI,dien-thoai-may-tinh-bang,198858451,"Điện thoại Samsung Galaxy A04s (4GB/64GB) - Hàng chính hãng",3990000,3990000,0,0
TIKI,dien-thoai-may-tinh-bang,272909668,"[Mới] Điện thoại vivo V29e 5G (8GB/256GB) - Hàng Chính Hãng - Camera Selfie 50 MP - Vòng Sáng Aura 2.0 - Màn hình AMOLED 6.67",8990000,8990000,0,0
TIKI,dien-thoai-may-tinh-bang,65091422,"Điện thoại Oukitel WP6 (Chống va đập,chống nước,Ram 6Gb,Rom 128Gb,pin 8.000mAh) hàng chính hãng",6990000,6990000,0,0
TIKI,dien-thoai-may-tinh-bang,212040689,"Điện Thoại Samsung Galaxy A04 (3GB/32GB) - Hàng Chính Hãng - Đã kích hoạt bảo hành điện tử",2400000,2400000,0,0
TIKI,dien-thoai-may-tinh-bang,272270730,"Điện thoại Samsung Galaxy A05 (4GB/128GB) - Hàng chính hãng",2769000,3099000,330000,11
TIKI,dien-thoai-may-tinh-bang,273774937,"Điện thoại Samsung Galaxy A15 (8GB/128GB) - Hàng chính hãng - Đã kích hoạt bảo hành điện tử",4600000,4990000,390000,8
TIKI,dien-thoai-may-tinh-bang,274639670,"Điện thoại Realme V30 (V30T) 4GB/128GB Dimensity 700 - Rom tiếng việt - Hàng nhập khẩu",2650000,3590000,940000,26
TIKI,dien-thoai-may-tinh-bang,273636845,"Điện Thoại Samsung Galaxy A05 (4GB/64GB) - Hàng Chính Hãng",2587000,2587000,0,0
TIKI,dien-thoai-may-tinh-bang,273438724,"Điện Thoại Samsung A05s 4GB/128GB , Snapdragon 680 , Sạc nhanh 25W - Hàng Chính Hãng",3269000,3990000,721000,18
TIKI,dien-thoai-may-tinh-bang,274516951,"Điện thoại Masstel izi 16 4G(LTE) , Bàn phím nổi, FM không dây - Hàng chính hãng",429000,499000,70000,14
TIKI,dien-thoai-may-tinh-bang,209927605,"Combo máy đọc sách Kindle 2022 (11th) tặng kèm bao da ( Cover ) - Hàng nhập khẩu",3100000,3100000,0,0
TIKI,dien-thoai-may-tinh-bang,212040697,"Điện Thoại Samsung Galaxy A04 (3GB/32GB) - Hàng Chính Hãng - Đã kích hoạt bảo hành điện tử",2250000,2990000,740000,25
TIKI,dien-thoai-may-tinh-bang,263073555,"Điện thoại Tecno CAMON 20 8GB/256GB - Camera 64MP + 32MP | 5000 mAh | Sạc nhanh 33W | 6.7'' FHD AMOLED - BH 13 Tháng - Hàng Chính Hãng",4590000,4990000,400000,8
TIKI,dien-thoai-may-tinh-bang,274179544,"Điện thoại Realme C51 (6GB/256GB) - Hàng Chính Hãng",3090000,4190000,1100000,26
TIKI,dien-thoai-may-tinh-bang,263274580,"Điện thoại Samsung Galaxy M14 5G (4GB/64GB) - Hàng chính hãng - Đã kích hoạt bảo hành điện tử",2799000,3990000,1191000,30
TIKI,dien-thoai-may-tinh-bang,25949745,"Máy Đọc Sách Kindle Oasis (10th Gen) 2019- 8GB - Hàng Chính Hãng",6043100,6790000,746900,11
TIKI,dien-thoai-may-tinh-bang,271134741,"Điện thoại Samsung Galaxy Z Flip5 (8GB/512GB) - Hàng chính hãng",17229000,29990000,12761000,43
TIKI,dien-thoai-may-tinh-bang,274498288,"Điện Thoại Samsung Galaxy A35 5G (8GB/128GB)- Hàng Chính Hãng",7590000,8290000,700000,8
TIKI,dien-thoai-may-tinh-bang,274542883,"Điện Thoại Samsung A35 5G 8GB/128GB - Hàng Chính Hãng",7039000,8290000,1251000,15
TIKI,dien-thoai-may-tinh-bang,273252926,"Điện Thoại Oppo A18 (4GB/128GB) - Hàng Chính Hãng",3250000,3990000,740000,19
TIKI,dien-thoai-may-tinh-bang,270160350,"Điện Thoại Oppo A78 8GB/256GB - Hàng Chính Hãng",6490000,6990000,500000,7
TIKI,dien-thoai-may-tinh-bang,274166857,"Điện thoại Samsung Galaxy S23 FE (8GB/128GB) - Hàng chính hãng",11479000,14890000,3411000,23
TIKI,dien-thoai-may-tinh-bang,257682739,"Điện thoại Samsung Galaxy A04 (3GB/32GB) - Đã kích hoạt bảo hành điện tử -  Hàng chính hãng",1999000,2990000,991000,33
TIKI,dien-thoai-may-tinh-bang,273553649,"Điện thoại Oppo A18 - Hàng chính hãng",3499000,3690000,191000,5
TIKI,dien-thoai-may-tinh-bang,270736028,"Điện thoại Samsung Galaxy Z Fold 5 - Hàng chính hãng",36990000,44990000,8000000,18
TIKI,dien-thoai-may-tinh-bang,271128271,"Điện Thoại Oppo A58 6GB/128GB - Hàng Chính Hãng",4379000,4990000,611000,12
TIKI,dien-thoai-may-tinh-bang,248754839,"Điện Thoại OPPO A17K (3GB/64GB) - Hàng Chính Hãng",3276000,3276000,0,0
TIKI,dien-thoai-may-tinh-bang,272222033,"Máy đọc sách Boox Palma - Hàng Chính Hãng",7200000,8590000,1390000,16
TIKI,dien-thoai-may-tinh-bang,274316885,"Điện Thoại Xiaomi POCO X6 5G 8GB-256GB - Hàng chính hãng",7590000,9990000,2400000,24
TIKI,dien-thoai-may-tinh-bang,212261734,"Điện thoại Masstel Play 10 4G Thiết kế hầm hố,Khung viền kim loại - Hàng chính hãng",579000,799000,220000,28
TIKI,dien-thoai-may-tinh-bang,225960096,"Điện Thoại Samsung Galaxy S23+ 5G - Hàng Chính Hãng",18000000,18000000,0,0
TIKI,dien-thoai-may-tinh-bang,176438864,"Điện thoại Xiaomi REDMI 9A (2+32) Xanh dương - Hàng chính hãng (chỉ giao HN và một số khu vực)",2088000,2088000,0,0
TIKI,dien-thoai-may-tinh-bang,273718967,"Điện Thoại Samsung A15 8GB/128GB - Hàng Chính Hãng",4249000,4990000,741000,15
TIKI,dien-thoai-may-tinh-bang,244303202,"Điện Thoại Samsung A14 4GB/128GB - Hàng Chính Hãng",3339000,3339000,0,0
TIKI,dien-thoai-may-tinh-bang,175851126,"Máy Tính Bảng Galaxy Tab A8 4GB | 64GB - Hàng Chính Hãng",5856000,5856000,0,0
TIKI,dien-thoai-may-tinh-bang,262514707,"Điện thoại Xiaomi Redmi Note 12 Pro (8GB/256GB) - Hàng chính hãng",6749000,7990000,1241000,16
TIKI,dien-thoai-may-tinh-bang,230157205,"Điện thoại Xiaomi Redmi Note 10T 5G 4GB/64GB - Màn 90HZ - Chống Nước IP68 - Hàng Nhập Khẩu - Bản quốc tế",2590000,4190000,1600000,38
TIKI,dien-thoai-may-tinh-bang,272348047,"Điện Thoại Samsung A05s 4GB/128GB - Hàng Chính Hãng",3169000,3990000,821000,21
TIKI,dien-thoai-may-tinh-bang,273958512,"Điện thoại Xiaomi Redmi Note 13 (6GB/128GB) - Hàng chính hãng",4890000,4890000,0,0
TIKI,dien-thoai-may-tinh-bang,244167098,"Điện thoại Xiaomi Redmi 12C (4GB/64GB) - Hàng chính hãng",3168000,3168000,0,0
TIKI,dien-thoai-may-tinh-bang,251930431,"Samsung Galaxy A04e 3G/32G - Hàng Chính Hãng - Đã kích hoạt bảo hành điện tử",2090000,2090000,0,0
TIKI,dien-thoai-may-tinh-bang,205846229,"Điện Thoại Oppo A57 4GB/128GB - Hàng Chính Hãng",4632000,4632000,0,0
TIKI,dien-thoai-may-tinh-bang,274392442,"Điện thoại Oppo A38 - Hàng chính hãng",4490000,4490000,0,0
TIKI,dien-thoai-may-tinh-bang,271966786,"iPhone 15",19290000,22490000,3200000,14
TIKI,dien-thoai-may-tinh-bang,248704404,"Điện Thoại Samsung Galaxy A14 (4GB/128GB) - Hàng Chính Hãng",3625000,3625000,0,0
TIKI,dien-thoai-may-tinh-bang,261946899,"Điện Thoại Samsung Galaxy A14 (6GB/128GB) - Hàng Chính Hãng",4990000,4990000,0,0
TIKI,dien-thoai-may-tinh-bang,270471106,"Điện Thoại Nokia 105 4G Pro TA-1538 - Hàng Chính Hãng",639000,639000,0,0
TIKI,dien-thoai-may-tinh-bang,273595363,"Oukitel wp30 Pro 5g SIÊU BỀN (sạc nhanh 120W ,pin 11000 mAh,màn hình 6.78 inch,Ram 24 GB(12gb + 12GB),Rom 512GB ,120Hz ,Android 13,camera 108mp)- hàng chính hãng",11990000,11990000,0,0
TIKI,dien-thoai-may-tinh-bang,273407277,"Máy tính bảng chắc chắn Oukitel RT7(Chống va đập,Màn hình 10.1" FHD+,Pin 32000mAh ,Ram 24GB,Rom 256GB, Android 13,Camera sau 48MP, tầm nhìn ban đêm 20MP,camera trước 32MP,5G) – hàng chính hãng",13990000,13990000,0,0
TIKI,dien-thoai-may-tinh-bang,249782771,"Máy tính bảng Xelex Gama Tab X8 EDU (Hàng chính hãng)",2890000,2890000,0,0
TIKI,dien-thoai-may-tinh-bang,271801317,"Máy tính bảng siêu bền Oukitel RT6 (chống nước,chống va đập,pin 20000mAh,Ram 16Gb(8GB+8Gb),Rom 256GB,Màn hình 10.1" ,FHD,Android 13,CPU MTK8788 ,Camera 16MP,sạc nhanh 33W)-hàng chính hãng",9990000,9990000,0,0
TIKI,dien-thoai-may-tinh-bang,274065746,"Điện thoại siêu bền Oukitel WP33 Pro 5G (Loa to 136 dB (5W) ,Pin 22000mAh,màn hình 6,6 inch FHD+,Ram 24GB(8+16),Rom 256GB, Camera 64MP,sạc nhanh 33W)- hàng chính hãng",8990000,8990000,0,0
TIKI,dien-thoai-may-tinh-bang,273389282,"Điện Thoại ulefone armor 21(Loa to 122dB Speaker ,pin 9600mAh,sạc nhanh 33W,Màn hình 6.58 in,camera chính 64MP,ban đêm 24MP,Ram 16Gb(8+8),rom 256Gb, điều khiển từ xa đa năng)- hàng chính hãng",6990000,6990000,0,0
TIKI,dien-thoai-may-tinh-bang,273659145,"Máy tính bảng Masstel Kidzone dành cho bé - quản lý thời gian cho bé - bé học tốt, hiệu quả cao - 1 đổi 1 trong 100 ngày - Hàng chính hãng",3990000,3990000,0,0
TIKI,dien-thoai-may-tinh-bang,258766897,"Điện Thoại Masstel iZi 11 4G - Hàng Chính Hãng",468000,468000,0,0
TIKI,dien-thoai-may-tinh-bang,168094334,"Điện thoại Samsung Galaxy S20 FE (8GB/256GB) - Hàng chính hãng",8625000,8625000,0,0
TIKI,dien-thoai-may-tinh-bang,274364026,"Máy tính bảng học tập thông minh Nexta Edutab Pro tối ưu cho trẻ 9-12 tuổi, 64GB, tích hợp ứng dụng học tập - Hàng nhập khẩu",5490000,6490000,1000000,15
TIKI,dien-thoai-may-tinh-bang,263309601,"Điện thoại siêu bền Oukitel K16(mini,Vỏ lưng bằng da,Ram 8Gb,Rom 128Gb,camera 48MP,pin 3.050mAh)- hàng chính hãng",4990000,4990000,0,0
TIKI,dien-thoai-may-tinh-bang,215119245,"Điện Thoại Di Động Forme D888 4G - Hàng Chính Hãng",680000,680000,0,0
TIKI,dien-thoai-may-tinh-bang,200848570,"Điện thoại Mobell M539 4G - Màn hình lớn 2.8 inch - Hàng chính hãng",639000,730000,91000,12
TIKI,dien-thoai-may-tinh-bang,252073013,"Điện thoại hiệu Masstel Fami 60 - Hàng chính hãng - Giá rẻ - hỗ trợ 4G - dành cho người lớn tuổi",730000,730000,0,0
TIKI,dien-thoai-may-tinh-bang,223859345,"Điện thoại Masstel Fami 60 - Hàng chính hãng ",730000,730000,0,0
TIKI,dien-thoai-may-tinh-bang,219400421,"Điện thoại OPPO CPH2471 - A17k Xanh - Hàng Chính Hãng (chỉ giao HN và một số khu vực)",3276000,3276000,0,0
TIKI,dien-thoai-may-tinh-bang,243165179,"Điện thoại OPPO Reno8 T 4G (8GB/256GB) - Hàng Chính Hãng",8136000,8136000,0,0
TIKI,dien-thoai-may-tinh-bang,273231495,"Máy tính bảng Masstel tab 10.1 pro - Hàng chính hãng",4290000,4290000,0,0
TIKI,dien-thoai-may-tinh-bang,249851724,"Điện Thoại 4G Masstel Lux 10 - 2 Sim 2 Sóng - Sóng 4G HD Call - Loa To Rõ - Pin Bền - Hàng Chính Hãng - Bảo Hành 12 Tháng",675000,675000,0,0
TIKI,dien-thoai-may-tinh-bang,52002453,"Cisco Unified IP Phone 7962G - Hàng chính hãng",4900000,4900000,0,0
TIKI,dien-thoai-may-tinh-bang,244332381,"Điện thoại Samsung Galaxy A04 32GB - Hàng chính hãng",2400000,2400000,0,0
TIKI,dien-thoai-may-tinh-bang,262688183,"ĐIỆN THOẠI MASSTEL IZI 30 4G-LTE-HÀNG CHÍNH HÃNG",560000,560000,0,0
TIKI,dien-thoai-may-tinh-bang,136364272,"Máy tính bảng Masstel Tab 10.4" (4GB/64GB) - Hàng chính hãng - ĐÃ KÍCH HOẠT BẢO HÀNH ĐIỆN TỬ",4800000,4800000,0,0
TIKI,dien-thoai-may-tinh-bang,251930414,"Redmi Note 12 Cấu Hình Khủng- hàng chính hãng- Giá rẻ",4490000,4490000,0,0
TIKI,dien-thoai-may-tinh-bang,274560616,"Máy tính bảng học tập giá rẻ Nexta Edutab Kid cho bé từ 5-8 tuổi, màn hình full HD 64GB, bao da, kính dán cường lực, hàng chính hãng",3990000,4990000,1000000,20
TIKI,dien-thoai-may-tinh-bang,249168300,"Điện thoại OPPO A57 4GB/128GB Đen - Hàng chính hãng",4890000,4990000,100000,2
TIKI,dien-thoai-may-tinh-bang,246163082,"Điện Thoại Nokia C30 2GB/32GB - Hàng Chính Hãng",1599000,2290000,691000,30
TIKI,dien-thoai-may-tinh-bang,271362153,"Combo Máy đọc sách All New Kindle Paperwhite 5 (11th Gen) và Bao da FOR KIDS (Bản KIDS, Không Quảng Cáo) - Hàng chính hãng",3790000,3790000,0,0
TIKI,dien-thoai-may-tinh-bang,272234493,"Điện thoại Samsung Galaxy M34 5G (8GB/128GB) - Hàng chính hãng",7990000,7990000,0,0
TIKI,dien-thoai-may-tinh-bang,200819471,"Điện thoại Mobell Rock 4 4G , Pin 3250mah , Loa Siêu lớn - Hàng chính hãng",699000,799000,100000,13
TIKI,dien-thoai-may-tinh-bang,274524033,"Điện thoại người già Masstel Fami 12S 4G(LTE) , Bàn phím chữ số to, Loa lớn , Máy viền thép chắc chắn - Hàng chính hãng",569000,650000,81000,12
TIKI,dien-thoai-may-tinh-bang,200829966,"Điện thoại Mobell M239 4G - 2 SIM - Hàng chính hãng",429000,500000,71000,14
TIKI,dien-thoai-may-tinh-bang,272273169,"Điện thoại Samsung Galaxy M34 5G (8GB/128GB) - Hàng chính hãng",7590000,7990000,400000,5
TIKI,dien-thoai-may-tinh-bang,273438769,"Điện thoại Xiaomi Redmi A2 2GB/32GB MediaTek Helio G36 , Pin 5000 mAh - Hàng chính hãng",1769000,2190000,421000,19
TIKI,dien-thoai-may-tinh-bang,272273680,"Điện thoại Samsung Galaxy A05s (4GB/128GB) - Hàng chính hãng",3269000,4290000,1021000,24
TIKI,dien-thoai-may-tinh-bang,248590019,"Điện thoại Xiaomi Redmi 12C (3GB/32GB) - Hàng chính hãng",2808000,2808000,0,0
TIKI,dien-thoai-may-tinh-bang,273185467,"Điện thoại Samsung A05 4GB - hàng chính hãng",3037000,3037000,0,0
TIKI,dien-thoai-may-tinh-bang,274257669,"Điện thoại Masstel Izi S1 4G (LTE) Gọi HD Call - Hàng chính hãng",429000,499000,70000,14
TIKI,dien-thoai-may-tinh-bang,179547641,"Máy đọc sách Kindle Paperwhite 5 (8GB) - Hàng chính hãng",3790000,3790000,0,0
TIKI,dien-thoai-may-tinh-bang,216934468,"Điện thoại Samsung Galaxy A14 5G (4GB/128GB) - Hàng chính hãng",3725000,3725000,0,0
TIKI,dien-thoai-may-tinh-bang,274611998,"Điện thoại Xiaomi Redmi 12 (4GB/128GB) - Hàng chính hãng",3279000,3790000,511000,13
TIKI,dien-thoai-may-tinh-bang,244308977,"Điện Thoại Xiaomi Redmi 12C 4GB/64GB - Hàng Chính Hãng",3168000,3168000,0,0
TIKI,dien-thoai-may-tinh-bang,274681248,"Điện Thoại Samsung Galaxy A35 5G (8GB/128GB)- Đã Kích Hoạt Điện Tử- Hàng Chính Hãng",6850000,8290000,1440000,17
TIKI,dien-thoai-may-tinh-bang,274638556,"BÚT MÁY ĐỌC SÁCH KINDLE SCRIBE - HÀNG CHÍNH HÃNG",2000000,2000000,0,0
TIKI,dien-thoai-may-tinh-bang,103168071,"Máy tính bảng Samsung Galaxy Tab A7 Lite LTE SM-T225 - Hàng Chính Hãng",3587000,3587000,0,0
TIKI,dien-thoai-may-tinh-bang,273897523,"Điện thoại Tecno SPARK 20 (8+8)GB/128GB - Helio G85 | 5000 mAh | Sạc nhanh 18W | Hàng Chính Hãng",3390000,3490000,100000,3
TIKI,dien-thoai-may-tinh-bang,175967811,"Điện Thoại Samsung Galaxy S20 FE 256GB | 8GB - Hàng Chính Hãng",8625000,8625000,0,0
TIKI,dien-thoai-may-tinh-bang,250109584,"Điện thoại Xiaomi Redmi Note 12 (4GB/128GB) - Hàng chính hãng",3600000,4990000,1390000,28
TIKI,dien-thoai-may-tinh-bang,274164078,"Máy tính bảng Samsung Galaxy Tab A9 WIFI 4GB-64GB- Hàng chính hãng",3350000,3990000,640000,16
TIKI,dien-thoai-may-tinh-bang,273378164,"Điện thoại Xiaomi Redmi 13C (6GB/128GB) - Hàng chính hãng - Đã kích hoạt bảo hành điện tử",2960100,3490000,529900,15
TIKI,dien-thoai-may-tinh-bang,274545326,"Điện thoại OPPO A36 6GB/128GB, Chip Snapdragon 680 , Màn 90Hz , Rom Tiếng việt - Hàng nhập khẩu",3090000,3590000,500000,14
TIKI,dien-thoai-may-tinh-bang,271364652,"Máy tính bảng Xiaomi Pad 6 (8GB/128GB) -  Hàng chính hãng - Đã kích hoạt bảo hành điện tử",8890000,9490000,600000,6
TIKI,dien-thoai-may-tinh-bang,242771940,"Điện Thoại Samsung A04e 3GB/32GB - Hàng Chính Hãng",2099000,2990000,891000,30
TIKI,dien-thoai-may-tinh-bang,191089547,"Điện Thoại Nokia 110 4G - Hàng Chính Hãng",675000,899000,224000,25
TIKI,dien-thoai-may-tinh-bang,274037365,"Điện Thoại POCO C65 (8GB/256GB) - Hàng Chính Hãng",2990000,3590000,600000,17
TIKI,dien-thoai-may-tinh-bang,270975124,"Điện Thoại Oppo A58 6GB/128GB - Hàng Chính Hãng",4290000,4990000,700000,14
TIKI,dien-thoai-may-tinh-bang,230155305,"Điện thoại Xiaomi Redmi Note 10 JE 5G 4GB/64GB - Màn 90HZ - Chống Nước IP68 - Hàng Nhập Khẩu - Bản quốc tế",2390000,3990000,1600000,40
TIKI,dien-thoai-may-tinh-bang,197214015,"Apple iPhone 14 Plus",19490000,27990000,8500000,30
TIKI,dien-thoai-may-tinh-bang,253380146,"Điện thoại di động Forme N82 4G - Hàng chính hãng",499000,590000,91000,15
TIKI,dien-thoai-may-tinh-bang,274542808,"Điện Thoại Samsung A55 5G 8GB/128GB - Hàng Chính Hãng",8449000,9990000,1541000,15
TIKI,dien-thoai-may-tinh-bang,206218031,"Máy tính bảng viết tay Xiaomi Wicue màn hình LCD màu cầu vồng không đèn nền 12inch",450000,768000,318000,41
TIKI,dien-thoai-may-tinh-bang,217640502,"Máy đọc sách Kindle Scribe - Hàng chính hãng",12590000,12590000,0,0
TIKI,dien-thoai-may-tinh-bang,198671718,"Điện Thoại Samsung Galaxy A04s (4GB/64GB) - Hàng Chính Hãng - Đã kích hoạt bảo hành điện tử",2790000,3990000,1200000,30
TIKI,dien-thoai-may-tinh-bang,258668285,"Điện thoại cố định Panasonic KX-TS520MX ( màu đen)-Hàng chính hãng",449000,469000,20000,4
TIKI,dien-thoai-may-tinh-bang,274681250,"Điện Thoại Samsung Galaxy A55 5G (8GB/128GB)- Đã Kích Hoạt Điện Tử- Hàng Chính Hãng",8150000,9990000,1840000,18
TIKI,dien-thoai-may-tinh-bang,198968094,"Điện Thoại Xiaomi Redmi A1 2GB/32GB - Hàng Chính Hãng",1689000,2190000,501000,23
TIKI,dien-thoai-may-tinh-bang,68693081,"Điện Thoại Samsung Galaxy S20 FE (8GB/256GB) - Hàng Chính Hãng",8625000,8625000,0,0
TIKI,dien-thoai-may-tinh-bang,249890677,"Điện Thoại Xiaomi Redmi Note 12 4GB/128GB - Hàng Chính Hãng",3599000,4990000,1391000,28
TIKI,dien-thoai-may-tinh-bang,270164674,"Điện thoại OPPO A78 (8GB/256GB) - Hàng Chính Hãng",6349000,6990000,641000,9
TIKI,dien-thoai-may-tinh-bang,271973414,"iPhone 15 Pro Max 256GB Titan Tự Nhiên",29990000,33990000,4000000,12
TIKI,dien-thoai-may-tinh-bang,251407092,"Điện Thoại Samsung Galaxy A34 5G (8GB/128GB) ĐKH -  Hàng Chính Hãng",7164000,7164000,0,0
TIKI,dien-thoai-may-tinh-bang,274564360,"Điện Thoại Xiaomi Redmi 12 4G (4GB/128GB) - Hàng chính hãng",3190000,4990000,1800000,36
TIKI,dien-thoai-may-tinh-bang,271046571,"Điện thoại Xiaomi Redmi Note 12 (8GB/128GB) - Hàng chính hãng",3790000,4790000,1000000,21
TIKI,dien-thoai-may-tinh-bang,216092766,"Điện Thoại Oppo Reno 8T 4G (8GB/256GB)",8136000,8136000,0,0
TIKI,dien-thoai-may-tinh-bang,202035122,"[HCM]Ốp Lưng IPHONE Cường Lực Trong Suốt Cao Cấp Cho Dòng Iphone 14/14Pro/14Plus/14 Pro Max, Iphone 13Mini/13Pro/13ProMax, Iphone 12/12Pro/12Promax, Iphone 11/11Pro/11ProMax- Hàng nhập khẩu",110000,110000,0,0
TIKI,dien-thoai-may-tinh-bang,230055130,"Điện thoại Oppo Reno8 T (8GB/256GB) - Hàng chính hãng",10392000,10392000,0,0
TIKI,dien-thoai-may-tinh-bang,274375122,"Điện thoại Xiaomi Redmi Note 13 Pro 4G (8GB/128GB) - Hàng chính hãng",6409000,7290000,881000,12
TIKI,dien-thoai-may-tinh-bang,274762125,"Điện thoại Samsung Galaxy A35 5G ( 8GB - 128GB ) - Hàng chính hãng",7190000,8290000,1100000,13
TIKI,dien-thoai-may-tinh-bang,270473116,"Điện thoại Xiaomi Redmi Note 12 (8GB/128GB) - Hàng chính hãng",4159000,5790000,1631000,28
TIKI,dien-thoai-may-tinh-bang,196348143,"Điện Thoại OPPO A57 (4GB/64GB) - Hàng Chính Hãng",4284000,4284000,0,0
TIKI,dien-thoai-may-tinh-bang,244182370,"Điện thoại Samsung Galaxy S23 Ultra 1TB - Hàng chính hãng",44990000,44990000,0,0
TIKI,dien-thoai-may-tinh-bang,242657652,"Điện thoại Samsung Galaxy S23 Plus 256GB - Hàng chính hãng",26990000,26990000,0,0
TIKI,dien-thoai-may-tinh-bang,272200109,"Điện Thoại Samsung Galaxy A04e - Hàng Chính Hãng",2340000,2340000,0,0
TIKI,dien-thoai-may-tinh-bang,168317790,"Điện Thoại Xiaomi Redmi 9A (2GB/32GB)- Đã kích hoạt bảo hành điện tử- Hàng Chính Hãng - Peacock Green",2088000,2088000,0,0
TIKI,dien-thoai-may-tinh-bang,262660017,"Điện Thoại Samsung Galaxy A24 (6GB/128GB) - Hàng Chính Hãng",5800000,5800000,0,0
TIKI,dien-thoai-may-tinh-bang,273366493,"Máy tính bảng chắc chắn Ulefone Armor Pad 2(màn hình 11" ,2K, pin 18600 mAh, IP68/IP69K, Android 13, NFC ,GPS, 4G, Ram 16GB(8gb+8gb),rom 256GB)- hàng chính hãng",7990000,7990000,0,0
TIKI,dien-thoai-may-tinh-bang,273511450,"Điện thoại Xiaomi Redmi 12 8GB/128GB - Hàng Chính Hãng",4390000,4390000,0,0
TIKI,dien-thoai-may-tinh-bang,251514670,"Điện thoại Xiaomi Redmi Note 12 (4GB/128GB) Màn AMOLED 120HZ, Snapdragon 685 , Sạc 33W - Hàng chính hãng",3599000,4990000,1391000,28
TIKI,dien-thoai-may-tinh-bang,207883258,"Điện thoại oukitel  wp21 (Ram 12Gb,Rom 256Gb ,chống sốc,chống nước,pin khủng, pin 9.800mAh) - hàng chính hãng",9970000,9970000,0,0
TIKI,dien-thoai-may-tinh-bang,131028406,"Máy tính bảng Fire HD 10 Plus 2021 thế hệ 11th",3551100,3990000,438900,11
TIKI,dien-thoai-may-tinh-bang,160051501,"Điện thoại Masstel IZI 20 4G - Hàng chính hãng, Nguyên Seal",512000,512000,0,0
TIKI,dien-thoai-may-tinh-bang,102620086,"Điện thoại VoIP Yealink SIP-T30 - Hàng Chính Hãng",1200000,1200000,0,0
TIKI,dien-thoai-may-tinh-bang,181699208,"Máy tỉnh bảng Samsung Galaxy Tab A8 -Hàng chính hãng",5856000,5856000,0,0
TIKI,dien-thoai-may-tinh-bang,245770248,"Điện thoại Xiaomi Redmi 12C (4GB/64GB) - Hàng chính hãng",3168000,3168000,0,0
TIKI,dien-thoai-may-tinh-bang,271341795,"Điện thoại smartphone Masstel Hapi 15 (2GB/16GB) - 2 Sim, Tặng kèm ốp lưng - Hàng chính hãng - Bảo hành chính hãng",1499000,1499000,0,0
TIKI,dien-thoai-may-tinh-bang,201001781,"Điện thoại Masstel Lux 10 4G - Nhiều chức năng - Hàng chính hãng",675000,675000,0,0
TIKI,dien-thoai-may-tinh-bang,271234313,"Điện Thoại Nokia 110 4G Pro - Hàng Chính Hãng",699000,710000,11000,2
TIKI,dien-thoai-may-tinh-bang,21465183,"Điện thoại không dây Panasonic KX-TGC212 - Hàng Chính Hãng",1680000,1680000,0,0
TIKI,dien-thoai-may-tinh-bang,263059025,"Điện thoại di động Samsung M14 5G - Hàng chính hãng - Đã kích hoạt BH điện tử",2990000,2990000,0,0
TIKI,dien-thoai-may-tinh-bang,208171115,"Điện thoại OUKITEL WP18 (Chống nước ,chống va đập, pin khủng 12500mAh, Ram 4GB ,Rom 32GB ,màn hình 5.93 inch,Điện thoại chắc chắn) – HÀNG CHÍNH HÃNG",3990000,3990000,0,0
TIKI,dien-thoai-may-tinh-bang,194462682,"Điện thoại ZTE Blade A52 4GB l 64GB, Pin 5000mAh, Màn hình 6.52", Camera AI Triple - Hàng chính hãng",3490000,3490000,0,0
TIKI,dien-thoai-may-tinh-bang,274383701,"Điện thoại Samsung Galaxy A05s 6GB-128GB - Hàng chính hãng",3390000,3890000,500000,13
TIKI,dien-thoai-may-tinh-bang,273668660,"Điện Thoại Oppo A18 4GB/64GB - Hàng Chính Hãng",3329000,3690000,361000,10
TIKI,dien-thoai-may-tinh-bang,274030201,"Điện thoại TECNO SPARK 10 8GB/128GB - Hàng Chính Hãng",2890000,3590000,700000,19
TIKI,dien-thoai-may-tinh-bang,224186586,"Điện thoại Masstel Izi 20 - Hàng chính hãng ",499000,499000,0,0
TIKI,dien-thoai-may-tinh-bang,249169833,"Điện thoại Samsung Galaxy A34 5G 8GB/128GB Đen - Hàng chính hãng",7164000,7164000,0,0
TIKI,dien-thoai-may-tinh-bang,208193365,"Điện thoại Samsung Galaxy A04 3/32GB - Hàng chính hãng",2400000,2400000,0,0
TIKI,dien-thoai-may-tinh-bang,274019962,"Điện thoại Masstel Fami 8 4G(LTE) Gọi HD call , Bàn phím chữ số lớn,Loa to - Hàng chính hãng",489000,550000,61000,11
TIKI,dien-thoai-may-tinh-bang,272834546,"điện thoại Redmi A2 - Hàng chính hãng",1890000,1890000,0,0
TIKI,dien-thoai-may-tinh-bang,103168844,"Máy tính bảng Samsung Galaxy Tab A7 Lite LTE SM-T225) - ĐÃ KÍCH HOẠT ĐIỆN TỬ - Hàng Chính Hãng",3587000,3587000,0,0
TIKI,dien-thoai-may-tinh-bang,249734070,"Điện Thoại Masstel Fami 12 4G LTE - 2 Sim- Pin 1400 mAh - Đọc số bằng giọng nói - Hàng Chính Hãng - Bảo Hành 12 Tháng",699000,699000,0,0
TIKI,dien-thoai-may-tinh-bang,272113804,"[MỚI] Điện thoại vivo Y17s - Hàng chính hãng - Camera 50MP - Pin 5000 mAh - Sạc nhanh- RAM mở rộng đến 8GB",3790000,3990000,200000,5
TIKI,dien-thoai-may-tinh-bang,273186334,"Điện thoại Samsung Galaxy A05s 4GB/128GB- Hàng Chính hãng",3625000,3625000,0,0
TIKI,dien-thoai-may-tinh-bang,274638430,"Điện thoại Redmi Note 13R 5G 4GB/128GB Dimensity 6100+ , Màn 90Hz , Rom quốc tế có sẳn Tiếng việt - Hàng nhập khẩu",2899000,3590000,691000,19
TIKI,dien-thoai-may-tinh-bang,212329857,"Điện thoại Xiaomi Redmi 9A 2GB/32GB Xám - Hàng chính hãng",2088000,2088000,0,0
TIKI,dien-thoai-may-tinh-bang,250113073,"Điện thoại Xiaomi Redmi Note 12 Pro 5G (8GB/256GB) - Hàng chính hãng",7690000,9490000,1800000,19
TIKI,dien-thoai-may-tinh-bang,217276360,"Điện thoại Mobell F209 4G ,Loa to, Phím lớn - Hàng chính hãng",579000,670000,91000,14
TIKI,dien-thoai-may-tinh-bang,273438458,"Điện thoại Samsung Galaxy A05 (4GB/128GB)- Helio G85 - Sạc nhanh 25W - Hàng chính hãng",2659000,3090000,431000,14
TIKI,dien-thoai-may-tinh-bang,215543460,"Điện Thoại Samsung Galaxy A14 5G (4GB/128GB) - Hàng Chính hãng",3725000,3725000,0,0
TIKI,dien-thoai-may-tinh-bang,191636459,"Điện thoại Masstel IZI 11 4G - Hàng chính hãng",468000,468000,0,0
TIKI,dien-thoai-may-tinh-bang,169651528,"Máy đọc thẻ flashcard Tiếng Anh 224 từ vựng không sóng điện từ",149000,149000,0,0
TIKI,dien-thoai-may-tinh-bang,274365104,"Điện thoại Xiaomi Redmi Note 13 Pro (8GB/128GB) - Hàng Chính Hãng",5990000,7290000,1300000,18
TIKI,dien-thoai-may-tinh-bang,248766283,"Máy đọc sách New Kindle 11th 2022 (Kids) kèm bao da - Hàng Chính Hãng",3060000,3299000,239000,7
TIKI,dien-thoai-may-tinh-bang,274724268,"Điện Thoại Samsung Galaxy S24 Plus (12GB - 256GB) -Hàng chính hãng",26990000,26990000,0,0
TIKI,dien-thoai-may-tinh-bang,274456687,"Điện thoại Samsung Galaxy A55 5G (8GB/128GB) - Hàng chính hãng",9159000,9990000,831000,8
TIKI,dien-thoai-may-tinh-bang,200816374,"Điện Thoại Forme D888 - Hàng Chính Hãng",499000,589000,90000,15
TIKI,dien-thoai-may-tinh-bang,273951550,"Điện Thoại Samsung Galaxy A15 LTE (8GB/128GB)- Đã Kích Hoạt Bảo Hành Điện tử - Hàng Chính Hãng",4190000,4990000,800000,16
TIKI,dien-thoai-may-tinh-bang,270976558,"Điện thoại di động Mobell M331 - Hàng chính hãng",499000,549000,50000,9
TIKI,dien-thoai-may-tinh-bang,215135773,"Điện Thoại Di Động Forme D111 4G - Hàng Chính Hãng",399000,459000,60000,13
TIKI,dien-thoai-may-tinh-bang,273454566,"Điện thoại Xiaomi POCO C65 (6GB/128GB) - Helio G85 - Màn 90HZ - Hàng chính hãng",2689000,2990000,301000,10
TIKI,dien-thoai-may-tinh-bang,273348837,"Điện thoại Xiaomi Redmi 13C (6GB/128GB) - Hàng chính hãng",2890000,3290000,400000,12
TIKI,dien-thoai-may-tinh-bang,258373871,"Điện Thoại Itel S23 128GB/16GB (8GB+8GB) | Pin 5000mAh | 6.6 Inch | Camera 50MP | 90Hz | Face ID - Hàng chính Hãng",2366000,3490000,1124000,32
TIKI,dien-thoai-may-tinh-bang,274393574,"Điện thoại Xiaomi Poco C65 - Hàng chính hãng",2989000,3090000,101000,3
TIKI,dien-thoai-may-tinh-bang,217559440,"Điện thoại Samsung Galaxy A03s (3GB/32GB) - Hàng chính hãng",2990000,2990000,0,0
TIKI,dien-thoai-may-tinh-bang,248762051,"Điện Thoại Samsung A34 5G 8GB/128GB - Hàng Chính Hãng",5929000,8490000,2561000,30
TIKI,dien-thoai-may-tinh-bang,274036896,"Điện thoại Samsung Galaxy S24 Ultra - Hàng chính hãng",33990000,33990000,0,0
TIKI,dien-thoai-may-tinh-bang,209872337,"Máy đọc sách Kindle 2022 (11th) - All new kindle 2022 11th màn hình 6inch 300PPI gấp 2 lần độ sắc nét, 16GB bộ nhớ trong với cổng kết nối USB-C - Hàng nhập khẩu",2300000,2300000,0,0
TIKI,dien-thoai-may-tinh-bang,203278278,"Điện Thoại Samsung A04 3GB/32GB - Hàng Chính Hãng",2109000,2990000,881000,29
TIKI,dien-thoai-may-tinh-bang,226552005,"Điện thoại bàn Panasonic KX-TSC11 hàng chính hãng",600000,600000,0,0
TIKI,dien-thoai-may-tinh-bang,273440662,"Điện thoại Xiaomi Redmi 12 (4GB/128GB) , Helio G88 , Màn 90HZ - Hàng chính hãng",3299000,4290000,991000,23
TIKI,dien-thoai-may-tinh-bang,274316036,"Điện Thoại Samsung Galaxy M34 5G 8GB-128GB - Hàng chính hãng",6390000,7990000,1600000,20
TIKI,dien-thoai-may-tinh-bang,274456447,"Điện thoại Samsung Galaxy A35 5G (8GB/128GB) - Hàng chính hãng",7249000,8290000,1041000,13
TIKI,dien-thoai-may-tinh-bang,271967379,"iPhone 15 Plus",22290000,25990000,3700000,14
TIKI,dien-thoai-may-tinh-bang,274162900,"Điện thoại OPPO A18 4GB-128GB - Hàng chính hãng",3750000,3990000,240000,6
TIKI,dien-thoai-may-tinh-bang,173789184,"Điện thoại bàn treo tường TC990",250000,250000,0,0
TIKI,dien-thoai-may-tinh-bang,273367316,"Điện Thoại Xiaomi Redmi 13C 6GB/128GB - Hàng Chính Hãng",2959000,3490000,531000,15
TIKI,dien-thoai-may-tinh-bang,273165324,"Điện thoại Xiaomi Redmi A2 (2GB/32GB) - Hàng chính hãng",1789000,2190000,401000,18
TIKI,dien-thoai-may-tinh-bang,272151221,"Điện thoại Xiaomi Redmi 10 2022 (4GB/128GB) - Hàng chính hãng",2690000,3990000,1300000,33
TIKI,dien-thoai-may-tinh-bang,270544863,"Điện Thoại Samsung Galaxy A24 (8GB/128GB) - Hàng Chính Hãng",6084000,6084000,0,0
TIKI,dien-thoai-may-tinh-bang,225936344,"Máy tính bảng Samsung Galaxy Tab A8 (4GB/64GB) - Hàng Chính Hãng",5856000,5856000,0,0
TIKI,dien-thoai-may-tinh-bang,253443652,"Điện Thoại Samsung Galaxy M14 5G - Hàng Chính Hãng",3112000,3112000,0,0
TIKI,dien-thoai-may-tinh-bang,273683300,"Điện thoại Samsung Galaxy A15 LTE (8GB/128GB) - Hàng chính hãng",4429000,4990000,561000,11
TIKI,dien-thoai-may-tinh-bang,204802771,"Điện thoại Oppo A57 (4GB/128GB) - Hàng chính hãng",4632000,4632000,0,0
TIKI,dien-thoai-may-tinh-bang,273653444,"Máy tính bảng Kindle Fire Hd 10 2023 13th - Hàng nhập khẩu",3790000,3790000,0,0
TIKI,dien-thoai-may-tinh-bang,273559020,"Máy tính bảng Kindle Fire HD10 2023 13th - 32Gb - Hàng chính hãng",3390000,3390000,0,0
TIKI,dien-thoai-may-tinh-bang,271799133,"Máy tính bảng chắc chắn oukitel RT5 (chống nước,chống va đập,pin 11.000mAh,Màn hình 10.1 inch FHD, Ram 14Gb,Rom 256Gb, CPU : Mediatek 8788,lõi 8, lên đến 2.0 GHz, Camera Trước,sau 16 MP, Android 13)- hàng chính hãng",7490000,7490000,0,0
TIKI,dien-thoai-may-tinh-bang,203853390,"Điện Thoại Oppo A17k (3GB/64GB)",2390000,3290000,900000,27
TIKI,dien-thoai-may-tinh-bang,270814388,"Điện thoại Tecno POVA 5 (8+8)/128GB - MediaTek Helio G99 - Sạc nhanh 45W - 6.8'' FHD+120HZ - Hàng Chính Hãng - BH 13 Tháng",3690000,4490000,800000,18
TIKI,dien-thoai-may-tinh-bang,215746882,"Điện thoại OPPO Reno8T 4G - Hàng chính hãng",8136000,8136000,0,0
TIKI,dien-thoai-may-tinh-bang,272241346,"Điện thoại Samsung Galaxy A05s (4GB/128GB) - Hàng chính hãng",3279000,3990000,711000,18
TIKI,dien-thoai-may-tinh-bang,251448280,"Samsung Galaxy A34 5G A346E (8+128G) Silver Bạc - Hàng Chính Hãng (chỉ giao HN và một số khu vực)",7164000,7164000,0,0
TIKI,dien-thoai-may-tinh-bang,267178005,"Điện thoại Samsung Galaxy A24 - Hàng chính hãng",5808000,5808000,0,0
TIKI,dien-thoai-may-tinh-bang,219392186,"Điện thoại OPPO CPH2471 - A17k Vàng - Hàng Chính Hãng (chỉ giao HN và một số khu vực)",3276000,3276000,0,0
TIKI,dien-thoai-may-tinh-bang,160556149,"Máy tính bảng Samsung Galaxy Tab A8 - Hàng chính hãng",5856000,5856000,0,0
TIKI,dien-thoai-may-tinh-bang,242712931,"Điện thoại Samsung Galaxy S23 Ultra 512GB - Hàng chính hãng",36990000,36990000,0,0
TIKI,dien-thoai-may-tinh-bang,263438008,"Điện thoại Masstel Hapi 30 4G Hàng Chính Hãng",2290000,2290000,0,0
TIKI,dien-thoai-may-tinh-bang,158742790,"Máy tính bảng Samsung Galaxy Tab A8 (4GB/64GB) - Hàng Chính Hãng",5856000,5856000,0,0
TIKI,dien-thoai-may-tinh-bang,273359931,"Điện Thoại Thông Minh siêu bền Oukitel WP27 (Ram 12GB,Rom 256GB,Màn hình 6.78 “FHD + ,pin 8300MAH,NFC, Android 13 ,CPU MTK G99,chống nước,chống sốc) –hàng chính hãng",6990000,6990000,0,0
TIKI,dien-thoai-may-tinh-bang,191764688,"Điện thoại Xiaomi Redmi 10A (2GB/32GB) - Hàng chính hãng",2556000,2556000,0,0
TIKI,dien-thoai-may-tinh-bang,274524742,"Điện thoại Fonrox F2163 4G , Gọi HD Call , Lướt WEB , 2 sim 2 sóng - Hàng chính hãng",339000,399000,60000,15
TIKI,dien-thoai-may-tinh-bang,273684137,"Máy tính bảng quản lý thời gian sử dụng dành cho trẻ em Masstel Kidzone-1 đổi 1 trong vòng 100 ngày",1990000,1990000,0,0
TIKI,dien-thoai-may-tinh-bang,249730336,"Điện Thoại Masstel Fami 60 4G LTE - Pin 2000 mAh - Chức Năng SOS - Hàng Chính Hãng - Bảo Hành 12 tháng",730000,730000,0,0
TIKI,dien-thoai-may-tinh-bang,105830021,"Máy Tính Bảng Samsung Galaxy Tab A7 Lite LTE T225 (3GB/32GB) ĐÃ KÍCH HOẠT BẢO HÀNH ĐIỆN TỬ - Hàng Chính Hãng",3587000,3587000,0,0
TIKI,dien-thoai-may-tinh-bang,273411606,"Điện thoại Samsung Galaxy M14 5G (4GB/128GB) - Hàng chính hãng",3590000,3990000,400000,10
TIKI,dien-thoai-may-tinh-bang,16518729,"Điện thoại để bàn Panasonic KX-TS580 hàng chính hãng",850000,850000,0,0
TIKI,dien-thoai-may-tinh-bang,263060294,"Điện thoại di động Samsung A24 (6G/128G) - Hàng chính hãng - Đã kích hoạt bảo hành điện tử",5808000,5808000,0,0
TIKI,dien-thoai-may-tinh-bang,249730338,"Điện Thoại 4G Masstel Lux 20 - 2 Sim 2 Sóng - Sóng 4G Hd Call - Loa To Rõ - Hàng Chính Hãng - Bảo Hành 12 Tháng",790000,790000,0,0
TIKI,dien-thoai-may-tinh-bang,249153684,"Điện thoại Realme C55 6GB/128GB Đen trời đêm - Hàng chính hãng",4680000,4990000,310000,6
TIKI,dien-thoai-may-tinh-bang,263675862,"Điện thoại OPPO A77 4GB+4GB/128GB - Sạc siêu nhanh 33W - Hàng nhập khẩu nhật - Bản quốc tế",3499000,4990000,1491000,30
TIKI,dien-thoai-may-tinh-bang,219397711,"Điện thoại Samsung Galaxy A14 5G A146P (4+128G) Đen - Hàng Chính Hãng (chỉ giao HN và một số khu vực)",3725000,3725000,0,0
TIKI,dien-thoai-may-tinh-bang,253443788,"Điện Thoại Samsung Galaxy M14 5G (4GB/64GB) - Hàng Chính Hãng",3112000,3112000,0,0
TIKI,dien-thoai-may-tinh-bang,196197701,"Điện thoại Samsung Galaxy Z Fold4 5G (12GB/256GB) - Hàng chính hãng",40990000,40990000,0,0
TIKI,dien-thoai-may-tinh-bang,270814412,"Điện thoại Tecno CAMON 20 Premier 5G - 8GB/512GB | Dimensity 8050| Cụm Camera 108+50+ 2MP | AMOLED - Tần số quét 120Hz - Hàng chính hãng",11190000,11990000,800000,7
TIKI,dien-thoai-may-tinh-bang,263041214,"Điện thoại Gaming Tecno POVA 4 8GB/128GB - Hàng Chính Hãng - MediaTek G99 | 6000mAh - 6.82 inch - Bảo hành 13 Tháng",3649000,4690000,1041000,22
TIKI,dien-thoai-may-tinh-bang,273175604,"Máy đọc sách Boox Note Air 3 C - Hàng Chính Hãng",13900000,15990000,2090000,13
TIKI,dien-thoai-may-tinh-bang,213858174,"Máy tính bảng Samsung Galaxy Tab A7 Lite (3GB/32GB) - Hàng chính hãng - Màn hình 8.7inch TFT LCD, Camera sau 8MP - Bảo Hành 12 Tháng",3587000,3587000,0,0
TIKI,dien-thoai-may-tinh-bang,213587929,"Điện Thoại Samsung Galaxy A04 (3GB/32GB) - Hàng Chính Hãng",2400000,2400000,0,0
TIKI,dien-thoai-may-tinh-bang,271530789,"Combo Máy đọc sách All New Kindle Paperwhite 5 (11th) KIDS EDITTION (KHÔNG QUẢNG CÁO) và Bao da - Hàng chính hãng",4064300,4190000,125700,3
TIKI,dien-thoai-may-tinh-bang,273610105,"Điện Thoại Samsung Galaxy A05 - Hàng Chính Hãng",2587000,2587000,0,0
TIKI,dien-thoai-may-tinh-bang,273029857,"Điện Thoại Samsung Galaxy A05s (4GB/128GB) - Hàng Chính Hãng",3625000,3625000,0,0
TIKI,dien-thoai-may-tinh-bang,197670818,"Điện thoại Samsung Galaxy A04s (4GB/64GB) - Hàng chính hãng",2590000,3990000,1400000,35
TIKI,dien-thoai-may-tinh-bang,160051494,"Điện thoại Masstel FAMI 60 4G - Hàng chính hãng, Nguyên Seal",689000,689000,0,0
TIKI,dien-thoai-may-tinh-bang,250111470,"Điện thoại Xiaomi Redmi Note 12 (8GB/128GB) - Hàng chính hãng",4290000,5790000,1500000,26
TIKI,dien-thoai-may-tinh-bang,274516245,"Điện thoại Masstel Fami 60S 4G(LTE) ,Bàn phím lớn, Khung viền kim loại - Hàng chính hãng",669000,750000,81000,11
TIKI,dien-thoai-may-tinh-bang,248655651,"Điện Thoại Samsung Galaxy A14 5G (4GB/128GB) - Hàng chính hãng - ĐÃ KÍCH HOẠT BẢO HÀNH ĐIỆN TỬ",3725000,3725000,0,0
TIKI,dien-thoai-may-tinh-bang,205750556,"Điện Thoại Oppo A57 4GB/128GB - Hàng Chính Hãng",4632000,4632000,0,0
TIKI,dien-thoai-may-tinh-bang,273411607,"Điện thoại Samsung Galaxy M14 5G (4GB/64GB) - Hàng chính hãng",2799000,3690000,891000,24
TIKI,dien-thoai-may-tinh-bang,252427658,"Điện thoại Tecno SPARK 10 Pro 8GB/128GB - Helio G88 | 5000 mAh | Sạc nhanh 18W | Cảm ứng vân tay - Hàng chính hãng",3679000,3990000,311000,8
TIKI,dien-thoai-may-tinh-bang,167465856,"Điện thoại Masstel IZI 50 4G , Pin 1700 mah - Hàng chính hãng",449000,549000,100000,18
TIKI,dien-thoai-may-tinh-bang,201631518,"Điện thoại Samsung Galaxy A04 (3GB/32GB) - Hàng chính hãng",2400000,2400000,0,0
TIKI,dien-thoai-may-tinh-bang,252073258,"Điện thoại di động ITEL 9210 4G - Hàng Chính Hãng",599000,699000,100000,14
TIKI,dien-thoai-may-tinh-bang,274095168,"Điện thoại Xiaomi Redmi A2+ (3GB/64GB) - Hàng Chính Hãng",1890000,2790000,900000,32
TIKI,dien-thoai-may-tinh-bang,271972435,"iPhone 15 Pro 128GB Titan Đen",24990000,27990000,3000000,11
TIKI,dien-thoai-may-tinh-bang,273498357,"Điện Thoại Itel S23 16GB(8GB+8GB)/256GB | Pin 5000mAh | 6.6 Inch | Camera 50MP | HÀNG CHÍNH HÃNG",2490000,3490000,1000000,29
TIKI,dien-thoai-may-tinh-bang,271389593,"điện thoại Nokia 110 4G Pro -Kiểu dáng bền bỉ - hiển thị rõ nét- Hàng chính hãng",699000,745000,46000,6
TIKI,dien-thoai-may-tinh-bang,272056193,"Điện Thoại Xiaomi Redmi Note 12 8GB/128GB - Hàng Chính Hãng",3989000,5790000,1801000,31
TIKI,dien-thoai-may-tinh-bang,214756058,"Máy đọc sách New Kindle 11th 2022 (16GB) - Hàng chính hãng",3090000,3090000,0,0
TIKI,dien-thoai-may-tinh-bang,263798932,"Máy đọc sách Boox Page - Hàng Chính Hãng",6650000,7990000,1340000,17
TIKI,dien-thoai-may-tinh-bang,273947792,"Điện thoại AI Samsung Galaxy S24 Ultra 12GB/256GB, Camera 200MP Zoom 100x, S Pen- Tím- Hàng Chính Hãng",28990000,34490000,5500000,16
TIKI,dien-thoai-may-tinh-bang,272238679,"Điện thoại Samsung Galaxy A05 (4GB/128GB) - Hàng chính hãng",3037000,3037000,0,0
TIKI,dien-thoai-may-tinh-bang,274101255,"Máy Tính Bảng Samsung Galaxy Tab A9 Wifi 4GB/64GB - Hàng Chính Hãng",2590000,3990000,1400000,35
TIKI,dien-thoai-may-tinh-bang,176438844,"Điện thoại Xiaomi REDMI 9A (2+32) Xanh lá - Hàng chính hãng (chỉ giao HN và một số khu vực)",2088000,2088000,0,0
TIKI,dien-thoai-may-tinh-bang,58146831,"Điện Thoại Cổ Điển DT150 - Bản Dây Line",2500000,2500000,0,0
TIKI,dien-thoai-may-tinh-bang,274542983,"Điện Thoại Samsung A05 6GB/128GB - Hàng Chính Hãng",2999000,3490000,491000,14
TIKI,dien-thoai-may-tinh-bang,181699053,"Điện thoại Xiaomi Redmi 9A - Hàng chính hãng",2088000,2088000,0,0
TIKI,dien-thoai-may-tinh-bang,274380639,"Điện thoại Oppo Reno11 F 5G (8GB/256GB) - Hàng Chính Hãng",8090000,8990000,900000,10
TIKI,dien-thoai-may-tinh-bang,247829297,"Điện thoại Realme C55 (8GB/256GB) - Hàng chính hãng",4400000,5690000,1290000,23
TIKI,dien-thoai-may-tinh-bang,165747145,"Điện thoại Xiaomi Redmi 9A 2GB/32GB - Chip MediaTek Helio G25 8 nhân (12 nm), Màn hình 6.53" HD+, Camera 13MP, Pin 5000 - Hàng Chính Hãng",2160000,2160000,0,0
TIKI,dien-thoai-may-tinh-bang,191689727,"Điện thoại OPPO CPH2387 - A57 Đen - Hàng Chính Hãng",4284000,4284000,0,0
TIKI,dien-thoai-may-tinh-bang,273872197,"Máy Tính Bảng Samsung Galaxy Tab A9 Wifi 4GB/64GB - Hàng Chính Hãng",2669000,3990000,1321000,33
TIKI,dien-thoai-may-tinh-bang,270471101,"Điện Thoại Nokia 110 4G Pro TA-1559 - Hàng Chính Hãng",679000,679000,0,0
TIKI,dien-thoai-may-tinh-bang,272328188,"Điện Thoại Samsung A05 4GB/128GB - Hàng Chính Hãng",2559000,3090000,531000,17
TIKI,dien-thoai-may-tinh-bang,274405521,"Điện Thoại Samsung A05 4GB/64GB - Hàng Chính Hãng",2339000,2990000,651000,22
TIKI,dien-thoai-may-tinh-bang,272392928,"Điện thoại Samsung Galaxy A05 (4GB/128GB) - Hàng chính hãng - ĐÃ KÍCH HOẠT BẢO HÀNH ĐIỆN TỬ",2790000,3090000,300000,10
TIKI,dien-thoai-may-tinh-bang,189658085,"Điện Thoại Oppo A57 (4GB/64GB)",4284000,4284000,0,0
TIKI,dien-thoai-may-tinh-bang,271822725,"Máy Tính Bảng Samsung Galaxy Tab A8 2022 (3GB/32GB) - Hàng Chính Hãng",5856000,5856000,0,0
TIKI,dien-thoai-may-tinh-bang,270447782,"Điện thoại Nokia C32 (4GB/128GB) - Hàng chính hãng",2080000,3290000,1210000,37
TIKI,dien-thoai-may-tinh-bang,172920927,"Điện thoại Masstel izi 12 4G - Hàng chính hãng",10000000,10000000,0,0
TIKI,dien-thoai-may-tinh-bang,115830124,"Điện Thoại Xiaomi Redmi 9A (2GB/32GB)- Đã kích hoạt bảo hành điện tử- Hàng Chính Hãng - Sky Blue",2088000,2088000,0,0
TIKI,dien-thoai-may-tinh-bang,274186881,"Máy tính bảng Samsung Galaxy Tab A9+ Wifi (4GB/64GB) - Hàng chính hãng",5990000,5990000,0,0
TIKI,dien-thoai-may-tinh-bang,254125720,"Điện thoại oukitel WP22 (Loa to,Chống nước ,chống sốc IP68/IP69K,Ram 13Gb(8GB+5Gb mở rộng),Rom 256Gb,Màn hình 6.58 FHD,tầm nhìn ban đêm,Pin 10.000mAh)- Hàng chính hãng",5990000,5990000,0,0
TIKI,dien-thoai-may-tinh-bang,273958619,"Điện Thoại Xiaomi Redmi Note 13 6GB-128GB - Hàng chính hãng",4145000,4890000,745000,15
TIKI,dien-thoai-may-tinh-bang,198868573,"Điện thoại IP Grandstream GRP 2601P hàng chính hãng",1050000,1050000,0,0
TIKI,dien-thoai-may-tinh-bang,192036708,"Điện Thoại OPPO A57 (4GB/128GB) - Hàng Chính Hãng",4632000,4632000,0,0
TIKI,dien-thoai-may-tinh-bang,270714226,"Điện Thoại Itel S23 4GB/128GB | Pin 5000mAh | 6.6 Inch | Camera 50MP | HÀNG CHÍNH HÃNG",2290000,2590000,300000,12
TIKI,dien-thoai-may-tinh-bang,273398391,"Điện thoại Ulefone Armor 18T (Ram 12Gb,Rom 256Gb,Camera 108MP,camera nhiệt FLIR,Pin 9600 mAh,5G,chống nước,chống va đập)-hàng chính hãng",14990000,14990000,0,0
TIKI,dien-thoai-may-tinh-bang,171685825,"Điện thoại Nokia 105 4G -  chính hãng - Đen",690000,690000,0,0
TIKI,dien-thoai-may-tinh-bang,249730334,"Điện Thoại Masstel Izi 20 4G LTE - 2 sim -Pin 1700 mAh - Loa To - Camera 0.08 MP - Hàng Chính Hãng - Bảo Hành 12 Tháng",512000,512000,0,0
TIKI,dien-thoai-may-tinh-bang,225912504,"Điện Thoại Forme D111 - Hàng Chính Hãng",499000,519000,20000,4
TIKI,dien-thoai-may-tinh-bang,205897182,"Máy tính bảng Xiaomi Redmi Pad (3GB/64GB) - Hàng chính hãng",6290000,6290000,0,0
TIKI,dien-thoai-may-tinh-bang,274638822,"Điện thoại Xiaomi Redmi Note 12 Turbo , Snapdragon 7 Gen 2 , Màn OLED 120Hz , Sạc nhanh 67W , Rom tiếng việt  - Hàng nhập khẩu",5999000,7990000,1991000,25
TIKI,dien-thoai-may-tinh-bang,242712374,"Điện thoại Samsung Galaxy S23 Ultra 256GB - Hàng chính hãng",31990000,31990000,0,0
TIKI,dien-thoai-may-tinh-bang,252884932,"Tay con điện thoại bàn Panasonic TGCA30- Hàng chính hãng-Chỉ xài được khi đã có máy mẹ",750000,750000,0,0
TIKI,dien-thoai-may-tinh-bang,271284934,"Máy tính bảng Edutab 10.4 & Case da tặng Quà hot Hệ thống quản lý học tập & kiểm soát dành cho Phụ huynh trọn đời - Hàng Chính Hãng",5769000,5769000,0,0
TIKI,dien-thoai-may-tinh-bang,261962220,"Điện Thoại Samsung Galaxy A24 (6GB/128GB) - Hàng Chính Hãng",5808000,5808000,0,0
TIKI,dien-thoai-may-tinh-bang,271329051,"Máy tính bảng Kindle Fire MAX 11, màn hình 11 inch, RAM 4GB, CPU Octa-core 2.2Ghz, bộ nhớ 64/128GB - Hàng chính hãng",5300000,5500000,200000,4
TIKI,dien-thoai-may-tinh-bang,195177036,"Máy tính bảng Samsung Galaxy Tab A7 Lite LTE SM-T225 - Hàng Chính Hãng",3587000,3587000,0,0
TIKI,dien-thoai-may-tinh-bang,270260682,"Điện thoại Gaming Tecno POVA 4 8GB/128GB - Hàng Chính Hãng - MediaTek G99 | 6000mAh - 6.82 inch - Bảo hành 13 Tháng",3590000,4690000,1100000,23
TIKI,dien-thoai-may-tinh-bang,248005118,"Điện Thoại Samsung Galaxy A34 5G (8GB/128GB) - Hàng Chính Hãng",7164000,7164000,0,0
TIKI,dien-thoai-may-tinh-bang,274524050,"Điện thoại Masstel izi T2 4G(LTE), Màn hình 2.4 inch, Đèn pin siêu sáng, Loa to - Hàng chính hãng",489000,550000,61000,11
TIKI,dien-thoai-may-tinh-bang,195894801,"Masstel izi 26 4G - Chữ to - Loa to - Hàng Chính Hãng",499000,650000,151000,23
TIKI,dien-thoai-may-tinh-bang,274424330,"Điện thoại Người Già Good A60 Pro 4G (LTE) Gọi HD Call , Có SOS , Màn lớn - Phím to - Pin trâu - Sạc Type C - Hàng nhập khẩu",469000,490000,21000,4
TIKI,dien-thoai-may-tinh-bang,274541336,"Điện thoại vivo Y03 (4GB+64GB) - Hàng chính hãng",2990000,2990000,0,0
TIKI,dien-thoai-may-tinh-bang,198648645,"Điện thoại Xiaomi Redmi A1 (2GB/32GB)",1750000,2190000,440000,20
TIKI,dien-thoai-may-tinh-bang,262706645,"Máy đọc sách kindle 2022 11th - hàng chính hãng",3200000,3200000,0,0
TIKI,dien-thoai-may-tinh-bang,273412211,"Điện thoại Xiaomi Redmi 13C (4+128GB) | 6.74" 90Hz| Media Tek Helio G85| 5000mAh - Hàng chính hãng",2890000,3290000,400000,12
TIKI,dien-thoai-may-tinh-bang,252073151,"Điện thoại Nokia 8210 4G - Hàng chính hãng - pin lâu - Bàn phím nút giá rẻ chỉ có tại Long Tâm Store",1415500,1415500,0,0
TIKI,dien-thoai-may-tinh-bang,247925719,"Điện thoại Samsung Galaxy A14  (4GB/128GB) - Hàng Chính Hãng - Đã kích hoạt bảo hành điện tử",3625000,3625000,0,0
TIKI,dien-thoai-may-tinh-bang,204066551,"Điện thoại Samsung Galaxy A04 (3GB/32GB) - Hàng chính hãng",2400000,2400000,0,0
TIKI,dien-thoai-may-tinh-bang,273244775,"Điện thoại Samsung Galaxy A23 5G 4GB/128GB Xanh - Hàng chính hãng",4160000,5990000,1830000,31
TIKI,dien-thoai-may-tinh-bang,248929458,"Điện thoại Samsung Galaxy A34 5G (8GB/128GB) - Hàng chính hãng",7164000,7164000,0,0
TIKI,dien-thoai-may-tinh-bang,274693012,"Điện thoại AI Samsung Galaxy S24 Ultra 12GB/256GB, Camera 200MP Zoom 100x, S Pen - Đã Kích Hoạt Điện Tử - Hàng Chính Hãng",23990000,33990000,10000000,29
TIKI,dien-thoai-may-tinh-bang,264285233,"Điện thoại Xiaomi Redmi Note 12 (4G/128G) - Hàng chính hãng Full Box",4990000,4990000,0,0
TIKI,dien-thoai-may-tinh-bang,245770806,"Điện thoại Samsung Galaxy A14 LTE (4GB/128GB) - Hàng chính hãng",3625000,3625000,0,0
TIKI,dien-thoai-may-tinh-bang,271451188,"Điện thoại Xiaomi Redmi A2| IPS LCD 6.52" HD+| MediaTek Helio G36| 5000 mAh - Hàng chính hãng",1769000,2190000,421000,19
TIKI,dien-thoai-may-tinh-bang,274160702,"Điện thoại Samsung Galaxy S24 Ultra - Hàng chính hãng",28490000,33990000,5500000,16
TIKI,dien-thoai-may-tinh-bang,217548686,"Máy đọc sách Kindle Scribe – thế hệ đầu tiên có thể đọc và viết, màn hình 10,2” 300PPI, đèn vàng warmlight, bộ nhớ 16-64GB, đồng bộ dữ liệu qua Microsoft Word - hàng nhập khẩu",11390000,11390000,0,0
TIKI,dien-thoai-may-tinh-bang,249143473,"Điện thoại Samsung Galaxy A34 5G (8GB/128GB) - Hàng chính hãng - ĐÃ KÍCH HOẠT BẢO HÀNH ĐIỆN TỬ",7164000,7164000,0,0
TIKI,dien-thoai-may-tinh-bang,273650151,"Điện thoại siêu bền Ulefone Power Armor X11(chống nước,chống va đập , Ram8 GB(4gb+4gb),Rom 32 GB, NFC, Helio G25, WiFi 2.4G/5G, Pin 8150 Mah,)-hàng chính hãng",3990000,3990000,0,0
TIKI,dien-thoai-may-tinh-bang,217158529,"Máy tính bảng Samsung Galaxy Tab A7 Lite - Hàng chính hãng",3587000,3587000,0,0
TIKI,dien-thoai-may-tinh-bang,230203067,"Điện thoại OPPO A55s 5G 4GB/64GB - Màn 90hz - Chống nước IP68 - Hàng nhập khẩu - Bản quốc tế",2899000,3699000,800000,22
TIKI,dien-thoai-may-tinh-bang,271954384,"Điện thoại OPPO A58 6GB/128GB , Sạc nhanh 33W - Hàng Chính Hãng",4399000,4990000,591000,12
TIKI,dien-thoai-may-tinh-bang,272397263,"Điện thoại Xiaomi 13T Pro (12GB/512GB) - Hàng chính hãng",15449000,16990000,1541000,9
TIKI,dien-thoai-may-tinh-bang,271368354,"Điện thoại di động Nokia 105 4G Pro - Hàng chính hãng",599000,699000,100000,14
TIKI,dien-thoai-may-tinh-bang,170449059,"Điện Thoại Masstel Izi 20 4G - Loa To, Pin Trâu, 2 Sim 2 Sóng, Hỗ Trợ 4G VoLTE, Đèn Pin Sáng, Giá Rẻ - Hàng Chính Hãng",464550,489000,24450,5
TIKI,dien-thoai-may-tinh-bang,272394241,"Điện thoại Samsung Galaxy A05s (4Gb/128Gb) - Hàng chính hãng - Đã kích hoạt bảo hành điện tử",3390000,3990000,600000,15
TIKI,dien-thoai-may-tinh-bang,274724669,"Điện thoại Xiaomi 14 5G (12GB- 256GB) - Hàng chính hãng",22990000,22990000,0,0
TIKI,dien-thoai-may-tinh-bang,126682340,"Điện thoại Xiaomi Redmi 10 (4GB/128GB) - Hàng chính hãng",4290000,4290000,0,0
TIKI,dien-thoai-may-tinh-bang,272850971,"Điện thoại Libero 5G III - 4/64GB Dimensity 700 ,Màn OLED ,Kháng nước IP57 - Hàng nhập khẩu nhật",2290000,2990000,700000,23
TIKI,dien-thoai-may-tinh-bang,212926651,"Điện Thoại Samsung Galaxy S20 FE 8GB/256GB - Hàng Chính Hãng - Đã Kích Hoạt Bảo Hành Điện Tử",8625000,8625000,0,0
TIKI,dien-thoai-may-tinh-bang,263117493,"Điện thoại di động Masstel Izi 30 (new) - Hàng chính hãng",499000,599000,100000,17
TIKI,dien-thoai-may-tinh-bang,249956458,"Điện thoại Xiaomi Redmi Note 12 (4GB/128GB) - Hàng chính hãng",4990000,4990000,0,0
TIKI,dien-thoai-may-tinh-bang,175845367,"Điện Thoại Samsung Galaxy S20 FE (8GB/256GB) Xanh Thanh Mát - Đã kích hoạt bảo hành điện tử - Hàng Chính Hãng",8625000,8625000,0,0
TIKI,dien-thoai-may-tinh-bang,274172292,"Điện thoại Samsung Galaxy A05 (4GB/64GB) - Hàng chính hãng",2990000,2990000,0,0
TIKI,dien-thoai-may-tinh-bang,273258825,"Điện thoại Samsung Galaxy A05s (4GB/128GB) - Đã kích hoạt bảo hành điện tử - Hàng chính hãng",3150000,3950000,800000,20
TIKI,dien-thoai-may-tinh-bang,274164375,"Máy Tính Bảng Samsung Galaxy Tab A9 Plus WIFI 4GB-64GB - Hàng chính hãng",4390000,5990000,1600000,27
TIKI,dien-thoai-may-tinh-bang,274415640,"Điện Thoại Xiaomi Redmi Note 13 Pro 8GB/128GB - Hàng Chính Hãng",6229000,7290000,1061000,15
TIKI,dien-thoai-may-tinh-bang,273990229,"Điện Thoại Xiaomi Redmi Note 13 6GB/128GB - Hàng Chính Hãng",4239000,4890000,651000,13
TIKI,dien-thoai-may-tinh-bang,214603586,"Điện Thoại Samsung Galaxy A04e (3GB/32GB)- Hàng Chính Hãng",2039000,2690000,651000,24
TIKI,dien-thoai-may-tinh-bang,274663238,"Máy Tính Bảng Samsung Galaxy Tab A9+ Wifi 4GB/64GB - Hàng Chính Hãng",4199000,5990000,1791000,30
TIKI,dien-thoai-may-tinh-bang,273357326,"Điện thoại Xiaomi Redmi 13C (6GB/128GB) - Hàng chính hãng",3490000,3490000,0,0
TIKI,dien-thoai-may-tinh-bang,217505504,"Máy tính bảng Kindle Fire HD8 PLUS 2022 (Fire HD 8 12th) - Màn hình 8inch HD, RAM 3GB, CPU Hexa-core 2.0 GHz, CÀI ĐƯỢC CH PLAY- Hàng nhập khẩu",2790000,2790000,0,0
TIKI,dien-thoai-may-tinh-bang,215617756,"Điện Thoại Samsung A14 5G 4GB/128GB - Hàng Chính Hãng",3389000,5190000,1801000,35
TIKI,dien-thoai-may-tinh-bang,274638659,"Điện Thoại Xiaomi Redmi Note 13 Pro 5G 8GB/128GB Snapdragon 7s Gen 2 , Màn OLED 120Hz, Rom Tiếng việt - Hàng nhập khẩu",5290000,6990000,1700000,24
TIKI,dien-thoai-may-tinh-bang,217505430,"Máy tính bảng Kindle Fire HD8 2022 (Fire HD 8 12th) - Màn hình 8inch HD, RAM 2GB, CPU Hexa-core 2.0 GHz, CÀI ĐƯỢC CH PLAY- Hàng nhập khẩu",2050000,2050000,0,0
TIKI,dien-thoai-may-tinh-bang,217645692,"Combo Máy đọc sách All New Kindle Paperwhite 5 (11th Gen) - 16Gb và Bao da - Hàng nhập khẩu",4090000,4290000,200000,5
TIKI,dien-thoai-may-tinh-bang,270814316,"Điện thoại Tecno POVA 5 (8+8)/256GB - MediaTek Helio G99 - Sạc nhanh 45W - 6.8'' FHD+120HZ - Hàng Chính Hãng -  BH 13 Tháng",4529000,5290000,761000,14
TIKI,dien-thoai-may-tinh-bang,274186112,"Máy tính bảng Samsung Galaxy Tab A9 Wifi (4GB/64GB) - Hàng chính hãng",3990000,3990000,0,0
TIKI,dien-thoai-may-tinh-bang,272323566,"Điện Thoại Samsung M34 5G 8GB/128GB - Hàng Chính Hãng",6159000,7990000,1831000,23
TIKI,lam-dep-suc-khoe,153599393,"Son lì dạng thỏi Flawsome Creamy Lip Stain (2g) Good Times (Màu Cam Hồng Đất)",90000,180000,90000,50
TIKI,lam-dep-suc-khoe,1313871,"Kem chống nắng Sunplay cực mạnh dạng sữa Sunplay Super Block SPF 81, PA++++ 30g",83000,103000,20000,19
TIKI,lam-dep-suc-khoe,121485349,"[Nhập Coupon giảm ngay 50K]Bàn Chải Điện P/S S100 PRO - Công Nghệ Sóng Âm, Chải Sạch Mảng Bám Tới 10X - Trắng Sáng",789000,1276370,487370,38
TIKI,lam-dep-suc-khoe,632680,"Dầu gội Selsun chống gàu, sạch gàu & hết ngứa da đầu Selsun Anti-Dandruff Shampoo 100ml",84000,99000,15000,15
TIKI,lam-dep-suc-khoe,117147635,"Sữa rửa mặt Simple giúp da sạch thoáng & không chứa xà phòng 150ml [CHÍNH HÃNG ĐỘC QUYỀN]",95000,132000,37000,28
TIKI,lam-dep-suc-khoe,5902685,"Sữa rửa mặt vitamin làm sáng da, mờ sẹo thâm dạng kem Acnes Vitamin Cleanser 100g",56000,70000,14000,20
TIKI,lam-dep-suc-khoe,104791199,"Collagen Viên Nhật Bản, Hỗ Trợ Ngăn Ngừa Lão Hóa Da, Giúp Tóc Móng Chắc Khỏe, Hộp 180 Viên",783000,935000,152000,16
TIKI,lam-dep-suc-khoe,273598230,"Máy Tăm Nước Không Dây LocknLock Cordless Oral Irrigator",696000,1263000,567000,45
TIKI,lam-dep-suc-khoe,181097570,"Tinh Chất Dưỡng Sáng Da Laneige Radian-C Vitamin Spot Serum 10g",729000,750000,21000,3
TIKI,lam-dep-suc-khoe,1634981,"Giấy thấm dầu kiểm soát nhờn, ngừa mụn Acnes Oil Remover Paper 100 tờ",33000,33000,0,0
TIKI,lam-dep-suc-khoe,202062554,"Sữa Tắm Lifebuoy Sạch Khuẩn Bảo Vệ Vượt Trội Mạnh Mẽ Chứa Ion Bạc+ Hỗ Trợ Cùng Đề Kháng Da Tự Nhiên Chai 1000G",175000,197000,22000,11
TIKI,lam-dep-suc-khoe,6874429,"Miếng dán mụn giúp giảm mụn sưng viêm Acnes Clear Patch (24 Miếng)",58300,60000,1700,3
TIKI,lam-dep-suc-khoe,116438272,"Kem Dưỡng Cấp Nước Cho Da Hỗn Hợp Neutrogena Hydro Boost Water Gel",93000,110000,17000,15
TIKI,lam-dep-suc-khoe,273952811,"Bộ Đôi Kem Dưỡng Chống Lão Hóa Da Ngày Và Đêm Pond's Age Miracle giúp mờ đốm nâu, nếp nhăn với 50X Hexyl-Retinol 45g x 2",505000,760000,255000,34
TIKI,lam-dep-suc-khoe,210966404,"Combo Sữa dưỡng thể Vaseline Gluta-Hya Dưỡng Da Sáng Mịn Sau 7 Ngày Bảo vệ, dưỡng sáng mịn và Dưỡng sáng chuyên sâu 330 ML",239000,300000,61000,20
TIKI,lam-dep-suc-khoe,191365631,"Combo 2 Sữa dưỡng thể dưỡng sáng da tức thì VASELINE Healthy Bright Instant Radiance 350ML/chai",209000,300000,91000,30
TIKI,lam-dep-suc-khoe,460943,"Bộ Đôi Nước Súc Miệng Hương Bạc Hà Listerine Cool Mint (750ml/ Chai) - 8850007800071",223000,338000,115000,34
TIKI,lam-dep-suc-khoe,87913382,"Tinh Dầu Xông Phòng Nguyên Chất, Tự Chọn Mùi | Chính Hãng, Có Kiểm Định Chất Lượng | Tinh Dầu TIDAMO Xông Thơm Phòng, Khử Khuẩn, Bảo Vệ Sức Khỏe và Đuổi Muỗi",64000,128000,64000,50
TIKI,lam-dep-suc-khoe,74450527,"Máy Xông Tinh Dầu Cao Cấp Tặng 3 Chai Tinh Dầu Sả Chanh + Bạc Hà + Quế. Máy Khuếch Tán Tinh Dầu Có Remote Điều Khiển Từ Xa Chuyên Dụng Xông Tinh Dầu",269000,596000,327000,55
TIKI,lam-dep-suc-khoe,121485349,"[Nhập Coupon giảm ngay 50K]Bàn Chải Điện P/S S100 PRO - Công Nghệ Sóng Âm, Chải Sạch Mảng Bám Tới 10X - Trắng Sáng",789000,1276370,487370,38
TIKI,lam-dep-suc-khoe,193879341,"Gel bôi trơn Feelex Lubricant Cool mát lạnh, gấp đôi độ trơn - Lọ 250ml",102000,119000,17000,14
TIKI,lam-dep-suc-khoe,15795542,"Sữa Tắm Trắng Da Giữ Ẩm Hatomugi Nhật Bản 800ml",95000,119700,24700,21
TIKI,lam-dep-suc-khoe,767101,"Bao cao su Durex Kingtex 12 bao",111000,196000,85000,43
TIKI,lam-dep-suc-khoe,1672157,"Bao cao su Durex Invisible Extra Thin Extra Sensitive 1 Hộp 10 Bao",215000,317000,102000,32
TIKI,lam-dep-suc-khoe,111292323,"Sữa Tắm Lifebuoy Detox Và Sạch Sâu Khỏi Bụi Mịn Pm2.5 Và Vi Khuẩn Tràm Trà Muối Hồng 100% Từ Thiên Nhiên Chai 800G",149000,195000,46000,24
TIKI,lam-dep-suc-khoe,190489303,"Khẩu trang KF94 - 4D trẻ em, từ 3 đến 11 tuổi, nhiều họa tiết, kháng virus dễ thở, không đau tai",8000,8000,0,0
TIKI,lam-dep-suc-khoe,210966405,"Combo 2 Sữa dưỡng thể Vaseline Gluta-Hya Dưỡng Da Sáng Mịn Sau 7 Ngày Dưỡng sáng chuyên sâu 330 ML",239000,300000,61000,20
TIKI,lam-dep-suc-khoe,632681,"Dầu xả Selsun dưỡng tóc dành cho tóc gàu Selsun Anti-Dandruff Conditioner 100ml",51500,58000,6500,11
TIKI,lam-dep-suc-khoe,35761444,"Hộp Khẩu Trang 3D Mask Unicharm Nhật Bản Ngăn Ngừa Khói Bụi Chống Ô Nhiễm (100 miếng)",250000,315000,65000,21
TIKI,lam-dep-suc-khoe,68421547,"Combo 2 Dầu gội Romano hương nước hoa 650g/chai",289000,382000,93000,24
TIKI,lam-dep-suc-khoe,25108217,"Sữa rửa mặt ngăn ngừa mụn Acnes Creamy Wash 100g",56000,70000,14000,20
TIKI,lam-dep-suc-khoe,82721609,"Máy Tăm Nước Không Dây LocknLock Cordless Oral Irrigator ENR156BLU - Màu Xanh Da Trời",679000,1200000,521000,43
TIKI,lam-dep-suc-khoe,169246554,"(Vải tốt) Thùng 300 cái Khẩu Trang KF94 4D SKY MASK Hàn Quốc - Chống Bụi Mịn Và Kháng Khuẩn (Chọn màu)",199000,199000,0,0
TIKI,lam-dep-suc-khoe,57243183,"Máy Tăm Nước Vệ Sinh Răng Miệng Xiaomi Mijia MEO701 - Hàng Nhập Khẩu",559000,889000,330000,37
TIKI,lam-dep-suc-khoe,46179013,"Máy Massage Cầm Tay KINGTECH KH-320 - 6 Cấp Độ, Hỗ Trợ Mát Xa Chuyên Sâu, Giảm Đau Cơ, Cứng Khớp - Quà Tặng Cho Sức Khỏe",550000,950000,400000,42
TIKI,lam-dep-suc-khoe,54640942,"Khẩu Trang Y Tế TDCare 4 Lớp-Màu Trắng-Hộp 50 Cái",30000,48000,18000,38
TIKI,lam-dep-suc-khoe,153597872,"Son thỏi dưỡng môi trang điểm chất son satin Lip On Lip Glowy Satin",133000,166000,33000,20
TIKI,lam-dep-suc-khoe,41228196,"Nhiệt Kế Điện Tử Hồng Ngoại Đo Trán, Đo cơ Thể Cho Bé loại Cao Cấp Có đèn",124195,124195,0,0
TIKI,lam-dep-suc-khoe,171564906,"Dầu gội Selsun chống gàu, sạch gàu & hết ngứa da đầu Selsun Anti-Dandruff Shampoo 250ml",178000,223000,45000,20
TIKI,lam-dep-suc-khoe,78280482,"Bộ 2 Chai Nước Súc Miệng Listerine Giúp Hơi Thở Thơm Mát Cool Mint Zero Alcohol 750mlx2",261000,338000,77000,23
TIKI,lam-dep-suc-khoe,796867,"Bao cao su Durex Invisible Extra Thin Extra Sensitive 1 Hộp 3 Bao",82000,95000,13000,14
TIKI,lam-dep-suc-khoe,2042227,"Bao cao su Durex Invisible Extra Thin Extra Lubricated 1 Hộp 10 Bao",215000,317000,102000,32
TIKI,lam-dep-suc-khoe,630777,"Kem chống nắng Sunplay cực mạnh dạng sữa Sunplay Super Block SPF 81, PA++++ 70g",149000,185000,36000,19
TIKI,lam-dep-suc-khoe,66640235,"Combo Dove Phục Hồi Hư Tổn Dầu Gội 640g + Kem Xả 610g",235000,340000,105000,31
TIKI,lam-dep-suc-khoe,55915384,"Nước hoa hồng không chứa cồn Neutrogena Alcohol Free Toner 150ml ",114000,133000,19000,14
TIKI,lam-dep-suc-khoe,158399593,"[CHÍNH HÃNG] Một thùng 300 CÁI khẩu trang 4 lớp KF94 kháng khuẩn, chống bụi mịn, công nghệ 4D Hàn Quốc",210000,320000,110000,34
TIKI,lam-dep-suc-khoe,217539886,"[Nhập coupon giảm ngay 50K]Bàn Chải Điện P/S S100 PRO - Phiên Bản Ultra Violet Giới Hạn - Sạch chuẩn sóng âm",819000,1276370,457370,36
TIKI,lam-dep-suc-khoe,1313871,"Kem chống nắng Sunplay cực mạnh dạng sữa Sunplay Super Block SPF 81, PA++++ 30g",83000,103000,20000,19
TIKI,lam-dep-suc-khoe,72644676,"Gối Massage Đa Năng KingTech KP-315 - Máy Mát xa Toàn Thân Nhiệt Hồng Ngoại - Chuyên Sâu Cho Cổ, Vai Gáy, Lưng Dưới, Đùi, Chân - Sử Dụng Tại Nhà, Văn Phòng, Trên Ô Tô - Quà Tặng Cho Bạn Bè, Người Thân",780000,1250000,470000,38
TIKI,lam-dep-suc-khoe,1672153,"Bao cao su Durex Performa 12 bao",219000,308000,89000,29
TIKI,lam-dep-suc-khoe,168562118,"Dung Dịch Vệ Sinh Nam X2 Manly - Làm sạch tức thì Lưu hương 24h dung tích 150g Cocayhoala",142000,200000,58000,29
TIKI,lam-dep-suc-khoe,117170051,"Combo 2 Sữa rửa mặt Simple giúp kiềm dầu và ngừa mụn hiệu quả - cho da mụn nhạy cảm 150ml [CHÍNH HÃNG ĐỘC QUYỀN] [DIỆN MẠO MỚI]",198000,264000,66000,25
TIKI,lam-dep-suc-khoe,16625449,"(Mẫu mới) Bộ Đôi Kem Dưỡng Da Ngày Và Đêm Trắng Hồng Rạng Rỡ Pond's White Beauty (45g)",230000,300000,70000,23
TIKI,lam-dep-suc-khoe,118537006,"Bấm Cắt Móng Tay Móng Chân Bằng Thép Cacbon Cường Độ Cao, Lưỡi Bấm Siêu Sắc, Siêu Bền, Kèm Dũa Móng Tay, Thiết Kế Hiện Đại, Thời Trang, Loại Gấp Gọn Dành Cho Người Lớn Và Trẻ Nhỏ",14900,14900,0,0
TIKI,lam-dep-suc-khoe,73638938,"Tinh Dầu Xông Phòng Sả Chanh 100ML Nguyên Chất Nhập Khẩu - Tinh dầu Sả Chanh Giúp Bảo Vệ Sức Khỏe, Kháng Khuẩn, Đuổi Muỗi Và Thư Giãn Tinh Thần",198000,396000,198000,50
TIKI,lam-dep-suc-khoe,153599393,"Son lì dạng thỏi Flawsome Creamy Lip Stain (2g) With me (Màu Cam đất)",90000,180000,90000,50
TIKI,lam-dep-suc-khoe,202062554,"Sữa Tắm Lifebuoy Sạch Khuẩn Bảo Vệ Vượt Trội Mạnh Mẽ Chứa Ion Bạc+ Hỗ Trợ Cùng Đề Kháng Da Tự Nhiên Chai 1000G",175000,197000,22000,11
TIKI,lam-dep-suc-khoe,104791199,"Collagen Viên Nhật Bản, Hỗ Trợ Ngăn Ngừa Lão Hóa Da, Giúp Tóc Móng Chắc Khỏe, Hộp 180 Viên",783000,935000,152000,16
TIKI,lam-dep-suc-khoe,117147635,"Sữa rửa mặt Simple giúp da sạch thoáng & không chứa xà phòng 150ml [CHÍNH HÃNG ĐỘC QUYỀN]",95000,132000,37000,28
TIKI,lam-dep-suc-khoe,191365631,"Combo 2 Sữa dưỡng thể dưỡng sáng da tức thì VASELINE Healthy Bright Instant Radiance 350ML/chai",209000,300000,91000,30
TIKI,lam-dep-suc-khoe,108535196,"Bao cao su Sagami Superthin - Mỏng - Kiểu truyền thống - Hộp 10 chiếc",85000,120000,35000,29
TIKI,lam-dep-suc-khoe,98872338,"Máy Massage Cầm Tay Cao Cấp KINGTECH KH-720 - 20 Cấp Độ, Hỗ Trợ Mát Xa Chuyên Sâu, Giảm Đau Cơ, Cứng Khớp - Chính Hãng",1200000,1850000,650000,35
TIKI,lam-dep-suc-khoe,153597872,"Son thỏi dưỡng môi trang điểm chất son satin Lip On Lip Glowy Satin",133000,166000,33000,20
TIKI,lam-dep-suc-khoe,98605258,"Bao cao su Durex Jeans Hộp 30 bao",269000,490000,221000,45
TIKI,lam-dep-suc-khoe,181097570,"Tinh Chất Dưỡng Sáng Da Laneige Radian-C Vitamin Spot Serum 10g",729000,750000,21000,3
TIKI,lam-dep-suc-khoe,191680827,"Kem chống nắng nâng tông kiềm dầu innisfree Tone Up No Sebum Sunscreen EX SPF 50+ PA++++ 60 mL (New 2023)",403000,450000,47000,10
TIKI,lam-dep-suc-khoe,631034,"Sữa rửa mặt dưỡng ẩm tối ưu Hada Labo Advanced Nourish Cleanser 80g",71000,83000,12000,14
TIKI,lam-dep-suc-khoe,16625449,"(Mẫu mới) Bộ Đôi Kem Dưỡng Da Ngày Và Đêm Trắng Hồng Rạng Rỡ Pond's White Beauty (45g)",230000,300000,70000,23
TIKI,lam-dep-suc-khoe,202062554,"Sữa Tắm Lifebuoy Sạch Khuẩn Bảo Vệ Vượt Trội Mạnh Mẽ Chứa Ion Bạc+ Hỗ Trợ Cùng Đề Kháng Da Tự Nhiên Chai 1000G",175000,197000,22000,11
TIKI,lam-dep-suc-khoe,210966405,"Combo 2 Sữa dưỡng thể Vaseline Gluta-Hya Dưỡng Da Sáng Mịn Sau 7 Ngày Dưỡng sáng chuyên sâu 330 ML",239000,300000,61000,20
TIKI,lam-dep-suc-khoe,179988643,"Combo 2 Nước Rửa Tay Lifebuoy Chăm Sóc Da Giúp Dưỡng ẩm Mềm Mại Và Bảo Vệ Khỏi 99.9% Vi Khuẩn Trên Tay Chai 450G",139000,156000,17000,11
TIKI,lam-dep-suc-khoe,74527291,"Máy Xông Tinh Dầu Tặng 3 Tinh Dầu Sả Chanh + Bạc Hà + Quế. Máy Khuếch Tán Tinh Dầu Có Remote Điều Khiển Từ Xa Chuyên Dụng Xông Tinh Dầu Cho Phòng Lớn",288000,656000,368000,56
TIKI,lam-dep-suc-khoe,121485349,"[Nhập Coupon giảm ngay 50K]Bàn Chải Điện P/S S100 PRO - Công Nghệ Sóng Âm, Chải Sạch Mảng Bám Tới 10X - Trắng Sáng",789000,1276370,487370,38
TIKI,lam-dep-suc-khoe,210966404,"Combo Sữa dưỡng thể Vaseline Gluta-Hya Dưỡng Da Sáng Mịn Sau 7 Ngày Bảo vệ, dưỡng sáng mịn và Dưỡng sáng chuyên sâu 330 ML",239000,300000,61000,20
TIKI,lam-dep-suc-khoe,20541866,"Dầu gội Selsun chống gàu, sạch gàu & hết ngứa da đầu Selsun Anti-Dandruff Shampoo 50ml",52000,59000,7000,12
TIKI,lam-dep-suc-khoe,5560235,"Gel bôi trơn Durex Play Classic 50ml",85000,93000,8000,9
TIKI,lam-dep-suc-khoe,90683425,"Bao Cao Su Durex Jeans",42000,49000,7000,14
TIKI,lam-dep-suc-khoe,117170051,"Combo 2 Sữa rửa mặt Simple giúp kiềm dầu và ngừa mụn hiệu quả - cho da mụn nhạy cảm 150ml [CHÍNH HÃNG ĐỘC QUYỀN] [DIỆN MẠO MỚI]",198000,264000,66000,25
TIKI,lam-dep-suc-khoe,91256307,"Tinh Dầu Xông Phòng Nguyên Chất TIDAMO 50ML, Tự Chọn Mùi | Có Kiểm Định Chất Lượng | Sử Dụng Với Máy Xông Tinh Dầu Giúp Thơm Phòng, Khử Khuẩn, Tốt Cho Sức Khỏe và Làm Đẹp",68000,176000,108000,61
TIKI,lam-dep-suc-khoe,78280123,"Bộ 2 Chai Nước Súc Miệng làm trắng răng LISTERINE HEALTHY BRIGHT 750mlx2 Chai",289000,374000,85000,23
TIKI,lam-dep-suc-khoe,907522,"Viên uống bổ mắt Lutein Rohto V5 ( Hộp 30 viên)",485000,485000,0,0
TIKI,lam-dep-suc-khoe,186434710,"Túi chườm nóng thảo dược giảm đau nhức mỏi mắt dùng lò vi sóng - Hapaku",250000,250000,0,0
TIKI,lam-dep-suc-khoe,134318997,"SET Khẩu Trang KF94 Hàn Quốc, 4 Lớp, 50 Cái",40000,40000,0,0
TIKI,lam-dep-suc-khoe,50699284,"Nước tẩy trang Công Nghệ Micella Bioderma Sensibio H2O",425000,525000,100000,19
TIKI,lam-dep-suc-khoe,58731239,"Combo 2 Nước rửa tay Lifebuoy sữa dưỡng ẩm túi 400g",102000,118000,16000,14
TIKI,lam-dep-suc-khoe,108535197,"Bao cao su Sagami Spearmint - Hương bạc hà - Hộp 10 chiếc",105000,170000,65000,38
TIKI,lam-dep-suc-khoe,116446788,"Sữa Tắm pH 5.5 Johnson’s Adult - Dung Tích 750ml",147000,187000,40000,21
TIKI,lam-dep-suc-khoe,73632586,"Tinh dầu Sả Chanh Thiên Nhiên Cao Cấp 50ML (Lemongrass) - Tinh dầu Sả Chanh Nguyên Chất TIDAMO Giúp Bảo Vệ Sức Khỏe, Kháng Khuẩn, Đuổi Muỗi Và Thư Giãn Tinh Thần",119000,238000,119000,50
TIKI,lam-dep-suc-khoe,36987686,"Dầu gội dược liệu Antisol - Ngăn ngừa nấm da đầu, gàu, ngứa da đầu",283000,320000,37000,12
TIKI,lam-dep-suc-khoe,128912879,"Túi chườm bụng kinh 700ml, túi chườm nóng giảm đau bụng đau lưng nam tặng nữ",169000,169000,0,0
TIKI,lam-dep-suc-khoe,177911621,"Gương trang điểm để bàn có đèn LED Xiaomi Jordan Judy NV026 - Hàng Chính Hãng",179000,249000,70000,28
TIKI,lam-dep-suc-khoe,54058501,"Kem dưỡng trắng Hada Labo Perfect White Tranexamic Acid Cream 50g",192000,240000,48000,20
TIKI,lam-dep-suc-khoe,217539886,"[Nhập coupon giảm ngay 50K]Bàn Chải Điện P/S S100 PRO - Phiên Bản Ultra Violet Giới Hạn - Sạch chuẩn sóng âm",819000,1276370,457370,36
TIKI,lam-dep-suc-khoe,385654,"Bao cao su Durex Performa 3 bao",69000,77000,8000,10
TIKI,lam-dep-suc-khoe,75523405,"Combo 3 Tinh Dầu Sả Chanh + Tinh Dầu Bạc Hà + Tinh Dầu Oải Hương (Lavender) - Tinh Dầu Xông Phòng Nguyên Chất Giúp Thư Giãn, Đuổi Muỗi Và Thơm Phòng (3 chai 10ML)",118000,176000,58000,33
TIKI,lam-dep-suc-khoe,96593702,"Tinh Dầu Nguyên Chất Treo Xe Hơi, Treo Phòng Gia Đình| Tự Chọn Mùi, Có Kiểm Định Chất Lượng| Tinh Dầu TIDAMO Treo Thơm Phòng, Khử Mùi Xe Hơi, Thư Giản và Đuổi Muỗi",24000,108000,84000,78
TIKI,lam-dep-suc-khoe,25074713,"Phấn phủ kiềm dầu dạng bột innisfree No Sebum Mineral Powder 5g",119000,180000,61000,34
TIKI,lam-dep-suc-khoe,273952811,"Bộ Đôi Kem Dưỡng Chống Lão Hóa Da Ngày Và Đêm Pond's Age Miracle giúp mờ đốm nâu, nếp nhăn với 50X Hexyl-Retinol 45g x 2",505000,760000,255000,34
TIKI,lam-dep-suc-khoe,1672211,"Gel bôi trơn Durex Play Warming 100ml",167000,194000,27000,14
TIKI,lam-dep-suc-khoe,35526543,"Sữa Rửa Mặt Neutrogena Làm Sạch Sâu Và Kiểm Soát Nhờn",99000,125000,26000,21
TIKI,lam-dep-suc-khoe,2738497,"Bộ 3 Hộp Silcot Bông Trang Điểm (bông tẩy trang) Nhật Bản Cao Cấp (66 Miếng/Hộp)",110000,141000,31000,22
TIKI,lam-dep-suc-khoe,58731234,"Bộ 3 Kem đánh răng P/S Trà Xanh 230g",99000,129000,30000,23
TIKI,lam-dep-suc-khoe,385574,"Durex Gel Bôi Trơn Play Massage 2 - in- 1 200ml",258000,300000,42000,14
TIKI,lam-dep-suc-khoe,92146086,"Combo Bao cao su Durex Invisible Extra Thin Extra Lubricated 10 Bao và Extra Sensitive 10 Bao",458000,634000,176000,28
TIKI,lam-dep-suc-khoe,36987686,"Dầu gội dược liệu Antisol - Ngăn ngừa nấm da đầu, gàu, ngứa da đầu",283000,320000,37000,12
TIKI,lam-dep-suc-khoe,91565733,"Chỉ nha khoa SGS nhập khẩu Hàn Quốc - 500D hương bạc hà mới",35000,70000,35000,50
TIKI,lam-dep-suc-khoe,56381615,"Nước Tẩy Trang Thanh Lọc Và Làm Sạch Sâu Neutrogena Deep Clean Micellar Purifying Water 400ml",169000,220000,51000,23
TIKI,lam-dep-suc-khoe,260844985,"Kem Làm Mờ Sẹo Thâm, Sẹo Rỗ, Sẹo Lõm Scar Esthetique của Rejuvaskin - thương hiệu hỗ trợ trị sẹo Hoa Kỳ ",320000,400000,80000,20
TIKI,lam-dep-suc-khoe,50736325,"Sáp Vuốt Tóc Apestomen Volcanic Clay V4 + Lược Bán Nguyệt",249000,249000,0,0
TIKI,lam-dep-suc-khoe,118708687,"Máy Đo Nồng Độ Oxy Trong Máu và Nhịp Tim Dạng Kẹp Ngón Tay KINGTECH PULSE SPO2 - Hàng Chuẩn",250000,495000,245000,49
TIKI,lam-dep-suc-khoe,68826659,"Bàn Chải Đánh Răng Điện LocknLock Portable Electric Toothbrush ENR236 (162 x 20 x 20 mm)",175000,337000,162000,48
TIKI,lam-dep-suc-khoe,124480931,"Derma Forte Gel 15g - Adavanced, Giảm Mụn Trứng Cá, Mờ Sẹo, Dưỡng Da",122000,160000,38000,24
TIKI,lam-dep-suc-khoe,13325863,"Kem chống nắng nâng tông Skin Aqua Tone up Lavender cho da tối màu & da vàng, dạng sữa Sunplay Skin Aqua Tone Up UV Milk Lavender SPF 50+ PA++++ 50g",160000,199000,39000,20
TIKI,lam-dep-suc-khoe,426104,"Combo 3 Phim Thấm Dầu Jomi Mayan (70 Tờ) - Xanh",163000,198000,35000,18
TIKI,lam-dep-suc-khoe,108535251,"Bao cao su Sagami 002 - Siêu mỏng - Non Latex - Hộp 6 chiếc",218000,300000,82000,27
TIKI,lam-dep-suc-khoe,8959289,"Kem chống nắng nâng tông Skin Aqua Tone up Lavender cho da tối màu & da vàng, dạng tinh chất Sunplay Skin Aqua Tone Up UV Essence Lavender SPF 50+ PA++++ 50g",160000,199000,39000,20
TIKI,lam-dep-suc-khoe,19640804,"Cân điện tử thông minh Xiaomi Body Composition Scale 2 - Chính hãng",480000,550000,70000,13
TIKI,lam-dep-suc-khoe,42889999,"Tẩy Da Chết Cà phê Đăk Lăk Cocoon 200ml",106250,125000,18750,15
TIKI,lam-dep-suc-khoe,95253531,"Combo Dầu gội, Dầu xả & Kem ủ TRESEMME Keratin Smooth Dưỡng tóc vào nếp suôn mượt vào nếp suôn mượt Công thức chuẩn salon Hydrolyzed Keratin 640g, 620g, 180ml",401000,640000,239000,37
TIKI,lam-dep-suc-khoe,133245970,"Bộ 2 đầu bàn chải điện P/S - Sạch Sâu",175000,245455,70455,29
TIKI,lam-dep-suc-khoe,183076377,"Combo 3 Túi Khẩu Trang Y Tế ANYGUARD SENSE Lọc 99% Vi Khuẩn, Màu Sắc Trendy, An Toàn Da Nhạy Cảm Dành Cho Người Lớn (Túi 10 Chiếc/ Màu Xanh, Tím, Hồng)",71250,75000,3750,5
TIKI,lam-dep-suc-khoe,92702781,"Serum chống nắng cơ thể Vaseline 50x bảo vệ da với SPF 50+ PA++++ giúp da sáng hơn gấp 2X 300ML",151000,190000,39000,21
TIKI,lam-dep-suc-khoe,1672155,"Bao cao su Durex Kingtex 3 bao",42000,49000,7000,14
TIKI,lam-dep-suc-khoe,11949005,"[24 cái] Bộ 2 hộp bao cao su Innova Đen - Kéo dài thời gian | Hộp 12 cái",145000,145000,0,0
TIKI,lam-dep-suc-khoe,56371532,"Kem Chống Nắng Mỏng Nhẹ Neutrogena U.S Dry Touch SPF 50 88ml",229000,400000,171000,43
TIKI,lam-dep-suc-khoe,66469559,"Máy Xông Tinh Dầu Siêu Âm Dung Tích Lớn 500ml Có Điều Khiển Từ Xa",179000,358000,179000,50
TIKI,lam-dep-suc-khoe,174834852,"Sữa Rửa Mặt Dạng Gel Dành Cho Da Nhờn Mụn SVR Sebiaclear Gel Moussant 400ml",388000,555000,167000,30
TIKI,lam-dep-suc-khoe,74163324,"Khẩu Trang Y Tế Kháng Khuẩn Trẻ Em TDCare- Hộp 50 Cái.",25000,49000,24000,49
TIKI,lam-dep-suc-khoe,90218797,"Bộ 2 Chai Nước súc miệng giúp nướu chắc khỏe Listerine Gum Care 750ml/chai 101109930",261000,338000,77000,23
TIKI,lam-dep-suc-khoe,48627056,"Máy Massage Cầm Tay Đa Năng KINGTECH  KT1768 - Mát Xa Chuyên Sâu Cho Cổ, Vai Gáy, Bụng, Lưng, Cánh Tay, Chân - Giảm Đau Mỏi Toàn Thân Cho Dân Văn Phòng, Gymer, Người Già, Người Lao Động Nặng - Món Quà Tuyệt Vời Cho Ông Bà, Bố Mẹ - Hàng Chính Hãng",595000,1050000,455000,43
TIKI,lam-dep-suc-khoe,82403069,"[NEW] Khẩu Trang Anyguard Hàn Quốc 3 Lớp Màu Đen Chính Hãng -  Lọc 99% Vi Khuẩn, UV Protection (Hộp 30 Cái) - Bảo Vệ Hằng Ngày - Tiêu Chuẩn Công Nghệ Hàn Quốc - ISO 9001:2015, ISO 13485:2016, QCVN 01:2017/BTC",65000,69000,4000,6
TIKI,lam-dep-suc-khoe,104397632,"Kem tẩy lông cho da nhạy cảm Veet Silk Fresh 50g",63000,70100,7100,10
TIKI,lam-dep-suc-khoe,568659,"Mặt Nạ Ngủ Cho Môi Laneige Lip Sleeping Mask Berry 8g",195000,220000,25000,11
TIKI,lam-dep-suc-khoe,153599393,"Son lì dạng thỏi Flawsome Creamy Lip Stain (2g) Low Key (Màu Cam cháy)",90000,180000,90000,50
TIKI,lam-dep-suc-khoe,877362,"Combo 3 Bông Tẩy Trang Jomi (80 Miếng / Túi)",68100,90000,21900,24
TIKI,lam-dep-suc-khoe,48677365,"Bộ chiết mỹ phẩm mini 7 món tiện lợi",21990,21990,0,0
TIKI,lam-dep-suc-khoe,252035646,"Dầu Gội Dược Liệu Thái Dương 3 Hương Hoa Lá (500ml)",115000,115000,0,0
TIKI,lam-dep-suc-khoe,52758862,"[MẪU 2020] Lăn khử mùi Etiaxil Detranspirant Traitement Aisselles 15ml",189000,189000,0,0
TIKI,lam-dep-suc-khoe,125608918,"Megaduo Gel 15g - Giảm Mụn Trứng Cá, Ngừa Thâm, Mờ Sẹo, Dưỡng Da - Gam ma",129000,170000,41000,24
TIKI,lam-dep-suc-khoe,190252222,"Khẩu trang KF94 - 4D An Tâm, không xù lông, dễ thở, ko đứt dây, nhiều màu ( 10 cái/túi)",7900,7900,0,0
TIKI,lam-dep-suc-khoe,3265121,"Sữa Dưỡng Thể 350Ml Vaseline Dưỡng Ẩm Sáng Da Instant Radiance Vi Chất Phản Quang Giúp Da Sáng Tức Thì Gấp 4 Lần",117000,150000,33000,22
TIKI,lam-dep-suc-khoe,272362188,"100 Viên Nến Tealight Sáp Cọ 2 giờ Lorganic An Toàn Sức Khỏe, dùng kết hợp với đèn xông và tinh dầu, khử mùi, xua đuổi muỗi và côn trùng hiệu quả, trang trí",95000,140000,45000,32
TIKI,lam-dep-suc-khoe,26339567,"Cân Sức Khỏe Xiaomi Thông Minh Mi Smart Scale 2",300000,300000,0,0
TIKI,lam-dep-suc-khoe,68832828,"Cân Sức Khỏe Điện Tử LocknLock ENC516BLK Dùng Trong Gia Đình - 180kg",631000,702000,71000,10
TIKI,lam-dep-suc-khoe,186253037,"Bao cao su Feelex Superthin siêu mỏng, nhiều gel bôi trơn, hương thơm - Hộp 30bcs",189000,189000,0,0
TIKI,lam-dep-suc-khoe,16625449,"(Mẫu mới) Bộ Đôi Kem Dưỡng Da Ngày Và Đêm Trắng Hồng Rạng Rỡ Pond's White Beauty (45g)",230000,300000,70000,23
TIKI,lam-dep-suc-khoe,137534886,"Túi chườm nóng bụng kinh PUHA quà tặng cho bạn nữ, túi chườm ấm giảm đau bụng kinh tặng kèm túi vải đựng BVS mẫu dễ thương",235000,235000,0,0
TIKI,lam-dep-suc-khoe,45559087,"Bao Cao su Okamoto 0.01 PU Siêu mỏng Truyền Nhiệt Nhanh Hộp 2 Cái ",119000,150000,31000,21
TIKI,lam-dep-suc-khoe,197971015,"Lăn khử mùi Perspirex Original: khử mùi hôi nách và ngăn tiết mồ hôi cho da thường",310000,310000,0,0
TIKI,lam-dep-suc-khoe,385614,"Bao cao su Durex Pleasuremax Hộp 3 Bao",61000,70000,9000,13
TIKI,lam-dep-suc-khoe,132353050,"[HỘP - FAMAPRO 4D KIDS] - Khẩu trang trẻ em kháng khuẩn cao cấp Famapro 4D KIDS tiêu chuẩn KF94 (10 cái/ hộp)",12900,12900,0,0
TIKI,lam-dep-suc-khoe,385615,"Bao cao su Durex Pleasuremax Hộp 12 Bao",192000,280000,88000,31
TIKI,lam-dep-suc-khoe,2042221,"Gel bôi trơn Durex Play Strawberry 100ml",169000,194000,25000,13
TIKI,lam-dep-suc-khoe,90135780,"Tinh Dầu Sả Chanh TOKIMORI Xuất Khẩu Nhật Bản (50ml) 100% Thiên Nhiên, An Toàn Cho Trẻ, Xông Phòng, Khử Mùi, Kháng Khuẩn, Đuổi Muỗi, Giải Cảm",119000,218000,99000,45
TIKI,lam-dep-suc-khoe,1347157,"Combo Sữa Tắm L'amont En Provence Cherry Blossom Shower Gel Hương Hoa Anh Đào + Hoa Hồng (500ml / Chai)",189000,270000,81000,30
TIKI,lam-dep-suc-khoe,116426405,"Bộ 2 Chai Dầu gội đầu và dầu xả OGX - Dung Tích 385ml",449000,590000,141000,24
TIKI,lam-dep-suc-khoe,44107220,"Máy tăm nước cầm tay Panasonic công nghệ siêu âm EW1511 - Hàng Chính Hãng - Trắng",2900000,2900000,0,0
TIKI,lam-dep-suc-khoe,65401394,"Kem Hỗ Trợ Giảm Mụn Mủ Mụn Viêm Mụn Bọc Acnevir Santafa xanh ( Tuýp 10gr )",98000,133000,35000,26
TIKI,lam-dep-suc-khoe,638369,"Kem Chống Nắng Không Màu Kiểm Soát Dầu La Roche-Posay Anthelios XL Dry Touch Gel-Cream SPF 50+ UVB & UVA (50ml)",414000,525000,111000,21
TIKI,lam-dep-suc-khoe,54058503,"Sữa rửa mặt dưỡng trắng Hada Labo Perfect White Tranexamic Acid Cleanser 80g",80000,93000,13000,14
TIKI,lam-dep-suc-khoe,164994316,"Combo 5 chiếc khẩu trang N95 ngăn đến 95% hạt bụi siêu mịn có kích thước từ 0,3 Mircromet #MONA MASK",50000,50000,0,0
TIKI,lam-dep-suc-khoe,78280986,"Bộ 2 Chai Nước súc miệng ngăn ngừa mảng bám Listerine Tartar Protection 750mlx2",289000,374000,85000,23
TIKI,lam-dep-suc-khoe,89441903,"[HỘP - FAMAPRO 4D] - Khẩu trang y tế kháng khuẩn cao cấp Famapro 4D tiêu chuẩn KF94 (10 cái/ hộp)",12900,12900,0,0
TIKI,lam-dep-suc-khoe,152097288,"[Tặng mặt nạ dermal] Combo 5 gói bông tẩy trang Ipek 150 miếng ( 5 x 150 miếng)",139500,217500,78000,36
TIKI,lam-dep-suc-khoe,103341055,"Tinh Dầu Thơm Phòng Đuổi Muỗi 100ML HOMER Sả Chanh/ Quế/ Oải hương/ Bưởi/ Cam/ Hoa Lài/ Quýt/ Tràm Huế/ Hoa Hồng/ Lavender/ Ngọc Lan Tây/ Tràm Trà/ Sả Java/ Trà Xanh/ Cà Phê/ Chanh",149000,149000,0,0
TIKI,lam-dep-suc-khoe,460765,"Sữa Dưỡng Thể 350Ml Vaseline Dưỡng Ẩm Sáng Da Perfect Youth Phức Hợp Pro-Retinol Kích Thích Sản Sinh Collagen Hoạt Chất Aha Cải Thiệt Nếp Nhăn",120000,150000,30000,20
TIKI,lam-dep-suc-khoe,216211166,"Sữa tắm gội hương nước hoa cao cấp Gentleman 3 in 1 NERMAN 350ml",209000,330000,121000,37
TIKI,lam-dep-suc-khoe,11368961,"Bao Cao Su Innova Đen- Gai Lớn - Kéo Dài Thời Gian Cực Đã hộp 12c",85000,85000,0,0
TIKI,lam-dep-suc-khoe,10278713,"Nước uống collagen giúp sáng da, dạ dày khỏe Blossomy lốc 10 chai x 50ml",462000,530000,68000,13
TIKI,lam-dep-suc-khoe,116416531,"Dầu Gội Đầu OGX - Dung Tích 385ml",225000,295000,70000,24
TIKI,lam-dep-suc-khoe,137780195,"Trà giảm mỡ bụng Genpi Orihiro Nhật Bản hỗ trợ giảm mỡ bắp tay, đùi hiệu quả, chống oxy hoá gói 60 túi lọc JN-ORGEN01",111000,182700,71700,39
TIKI,lam-dep-suc-khoe,63524260,"Bàn Chải Điện BOORUI Primus Z2 (TB-018) 3 Chế Độ , Bàn Chải Đánh Răng  Tặng Kèm 3 Đầu Bản Chải - Hàng Chính Hãng , Chống Nước IPX7 , Sạc nhanh USB",148000,212000,64000,30
TIKI,lam-dep-suc-khoe,1687625,"Kem chống muỗi Rohto Metholatum Remos Hương Sả Chanh 70g",25000,27000,2000,7
TIKI,lam-dep-suc-khoe,182457734,"Túi chườm nóng lạnh PUHA 350ml, túi chườm sưởi ấm giảm đau bụng kinh họa tiết dễ thương",105000,105000,0,0
TIKI,lam-dep-suc-khoe,631525,"Sữa rửa mặt chống lão hóa Hada Labo Pro Anti Aging α Lifting Cleanser 80g",76000,89000,13000,15
TIKI,lam-dep-suc-khoe,93840468,"Máy Xông Tinh Dầu Có Pin Tích Điện, Vỏ Kim Loại Nguyên Khối, Nút Cảm Ứng, Tặng Tinh Dầu (Tùy Chọn) - Máy Khuếch Tán Tinh Dầu Trực Tiếp Chuyên Dụng Cho Xe ô tô và Gia Đình",378000,1196000,818000,68
TIKI,lam-dep-suc-khoe,7319063,"Dung Dịch Tẩy Tế Bào Chết Paula's Choice Skin Perfecting 2% BHA Liquid (30ml)",399000,399000,0,0
TIKI,lam-dep-suc-khoe,54896450,"Dung dịch vệ sinh nam dịu nhẹ lành tính thành phần tự nhiên chai nhỏ gọn 80ml - LOLI & THE WOLF",109000,109000,0,0
TIKI,lam-dep-suc-khoe,214230523,"Collagen Mỹ Youtheory (Collagen Type 1-2-3) 390 Viên - QuaTangMe Extaste",757000,1514000,757000,50
TIKI,lam-dep-suc-khoe,171495459,"Serum Hoặc sửa rửa mặt giảm mụn Mugung 7 ngày hiệu quả giảm mụn đầu đen,mụn bọc (Làm xẹp không bong da) Acne Treatment",150000,150000,0,0
TIKI,lam-dep-suc-khoe,195927144,"[148 Mùi Hương] Tinh Dầu Thơm Phòng Trái Cây Thiên Nhiên - Xông Thơm Phòng, Khử Mùi - Tinh Dầu Đào/ Xoài/ Táo Xanh/ Chuối/ Dưa Hấu/ Dưa Lưới/ Me (20ml)",110000,110000,0,0
TIKI,lam-dep-suc-khoe,198560707,"Bao cao su Feelex 3in1 gân gai, nhiều gel bôi trơn, kéo dài thời gian quan hệ",109000,200000,91000,46
TIKI,lam-dep-suc-khoe,56098120,"Bộ 6 kem đánh răng làm trắng sáng Colgate Optic White từ khoáng núi lửa Hàn Quốc 100g",300000,300000,0,0
TIKI,lam-dep-suc-khoe,70661122,"Mặt nạ dưỡng trắng da và ngăn ngừa lão hoá Truesky Integrated Mask chiết xuất hoa hồng đá 25g",30000,30000,0,0
TIKI,lam-dep-suc-khoe,126945340,"Bao cao su LifeStyles Classic thiết kế mỏng ôm sát nhiều gel 12 bao",99000,135000,36000,27
TIKI,lam-dep-suc-khoe,126945321,"Bao Cao Su Kéo Dài Thời Gian LifeStyles Love Time Thiết kế Ôm Sát Nhiều Gel 100% Không Rách Bao - Hộp 3 bao",42000,60000,18000,30
TIKI,lam-dep-suc-khoe,75832520,"Sữa Tắm Chuyên Biệt Cho Mụn Lưng Mông Ngực Acnevir ( Chai 210ml )",120000,159000,39000,25
TIKI,lam-dep-suc-khoe,92159194,"Combo 2 Bao cao su Durex Performa 12 bao ",438000,616000,178000,29
TIKI,lam-dep-suc-khoe,153869040,"Bao cao su LifeStyles Fantasy Gân Ngang, Nhiều Gel Bôi Trơn tăng Khoái Cảm - Hộp 3 bao",29000,39000,10000,26
TIKI,lam-dep-suc-khoe,93457801,"Phấn Nước M.O.I 5M BABY SKIN CUSHION Hồ Ngọc Hà (2021)",391020,399000,7980,2
TIKI,lam-dep-suc-khoe,14617774,"Dưỡng Chất Chuyên Sâu Giúp Hỗ Trợ Quá Trình Tái Tạo Da La Roche-Posay Hyalu B5 Serum 30ml",1045000,1260000,215000,17
TIKI,lam-dep-suc-khoe,5730933,"Thực phẩm chức năng viên uống bổ khớp, hỗ trợ trị đau nhức xương khớp Glucosamine Orihiro 1500mg Nhật bản",480000,800000,320000,40
TIKI,lam-dep-suc-khoe,138218451,"Đai chống gù lưng cao cấp Hachiko dành cho người lớn và trẻ em",698000,950000,252000,27
TIKI,lam-dep-suc-khoe,193583705,"Sữa tắm dưỡng thể Dove Sakura Blossoms Da mềm mịn hương hoa với hương hoa anh đào & muối hồng 900g",169000,226000,57000,25
TIKI,lam-dep-suc-khoe,133245977,"Bộ 2 đầu bàn chải điện P/S - Trắng Răng Tự Nhiên",212000,245455,33455,14
TIKI,lam-dep-suc-khoe,196953338,"Sữa rửa mặt se khít lỗ chân lông innisfree Volcanic Pore BHA Cleansing Foam 150g",195000,260000,65000,25
TIKI,lam-dep-suc-khoe,385582,"Bao cao su Durex Fetherlite Hộp 12 Bao",192000,276000,84000,30
TIKI,lam-dep-suc-khoe,7352431,"Dầu Gội và Xả Thảo Dược Hà Thủ Ô Giảm Rụng Tóc, Bạc Tóc Cocayhoala 300g",220000,300000,80000,27
TIKI,lam-dep-suc-khoe,51571599,"Hộp 1000 Miếng Bông Tẩy Trang ",56000,115000,59000,51
TIKI,lam-dep-suc-khoe,171495457,"Serum giảm mụn Mugung 7 ngày hiệu quả giảm mụn đầu đen,mụn bọc (Làm xẹp không bong da) Acne Treatment 15ml",250000,250000,0,0
TIKI,lam-dep-suc-khoe,58850613,"Bột Than Hoạt Tính Trắng Răng Sạch Mãng Bám Fobe Smile - Hũ 30 gram",99000,170000,71000,42
TIKI,lam-dep-suc-khoe,74212316,"Tinh dầu Cam Ngọt Nguyên Chất 50ML (ORANGE) - Tinh dầu Cam Cao Cấp Giúp Thư Giãn Tinh Thần, Khử Mùi, Xua Đuổi Côn Trùng, Thích Hợp Dùng Với Đèn Xông Và Máy Khuếch Tán Tinh Dầu",98000,196000,98000,50
TIKI,lam-dep-suc-khoe,7548593,"Viên uống tăng chiều cao GH Creation EX Nhật Bản - 270 viên",529000,890000,361000,41
TIKI,lam-dep-suc-khoe,54865932,"Khẩu Trang Y Tế TDCare 4 Lớp",30000,48000,18000,38
TIKI,lam-dep-suc-khoe,73923578,"COMBO CƠ BẢN CHO DA MỤN DECUMAR ADVANCED",154000,154000,0,0
TIKI,lam-dep-suc-khoe,22052317,"Kem Rửa Mặt Tút Sáng Từ Đất Sét Trắng Oxy White Complete (100g)",66000,82000,16000,20
TIKI,lam-dep-suc-khoe,148714567,"Cân Điện Tử thông minh Kachi MK315 - Hàng chính hãng",290000,299000,9000,3
TIKI,lam-dep-suc-khoe,1537315,"Gel bôi trơn Durex K-Y Jelly 50g - KY Jelly",83100,90000,6900,8
TIKI,lam-dep-suc-khoe,631496,"Kem dưỡng ẩm Hada Labo Advanced Nourish Cream 50g",176000,220000,44000,20
TIKI,lam-dep-suc-khoe,58803167,"Bột Than Hoạt Tính trắng răng UMIHA giúp làm trắng răng sạch mảng bám và cao răng hiệu quả |30G",265000,375000,110000,29
TIKI,lam-dep-suc-khoe,273849758,"Bao cao su siêu mỏng, trơn mượt LifeStyles SKYN Elite - Non-latex không mùi cao su - 10 bao",219000,335000,116000,35
TIKI,lam-dep-suc-khoe,117926982,"Tăm nước cầm tay H2ofloss HF-9P. Phiên bản thế hệ thứ 5",428000,839000,411000,49
TIKI,lam-dep-suc-khoe,26113983,"Viên Uống Bổ Sung Vitamin C DHC Vitamin C Hard Capsule Nhật Bản",169000,200000,31000,16
TIKI,lam-dep-suc-khoe,97712326,"Dầu gội đầu Head&Shoulders Clinical Strength Shampoo dry scalp rescue làm sạch gầu 400ml mẫu mới",299000,299000,0,0
TIKI,lam-dep-suc-khoe,68429877,"Combo 2 Tắm gội 2 trong 1 Romano hương nước hoa 650g/chai",293000,382000,89000,23
TIKI,lam-dep-suc-khoe,35031098,"Son thỏi dưỡng môi trang điểm, cho môi căng mọng Lip On Lip Water Color",106000,132000,26000,20
TIKI,lam-dep-suc-khoe,385477,"Bao cao su Durex Fetherlite Ultima Hộp 12 Bao",219000,304000,85000,28
TIKI,lam-dep-suc-khoe,631508,"Sữa rửa mặt ngăn ngừa mụn dạng gel Acnes 25+ Facial Wash 100g",66000,82000,16000,20
TIKI,lam-dep-suc-khoe,72790514,"[CHÍNH HÃNG] TINH DẦU BƯỞI VIJULLY - HAIR LOTION",150000,150000,0,0
TIKI,lam-dep-suc-khoe,54864521,"Khẩu Trang Y Tế TDCare 4 Lớp - Màu Xanh-Hộp 50 Cái",30000,48000,18000,38
TIKI,lam-dep-suc-khoe,25704809,"Kem chống nắng giảm bóng nhờn La Roche Posay Anthelios XL Dry Touch 50ml",420000,560000,140000,25
TIKI,lam-dep-suc-khoe,70550671,"Kem Dưỡng Thể Ngăn Ngừa Viêm Lỗ Chân Lông Weightless Body Treatment 2% BHA 60mL Paula's Choice",349000,349000,0,0
TIKI,lam-dep-suc-khoe,125827955,"Combo 8 Băng Vệ Sinh Kotex Minimeow 8 miếng",176000,176000,0,0
TIKI,lam-dep-suc-khoe,74257575,"Máy Massage Mắt Cao Cấp KINGTECH KY-925 - Mát xa Áp Suất Túi Khí Kèm Nhiệt - Tích Hợp Nghe Nhạc Bluetooth -  Giảm Mỏi, Khô Mắt, Quầng Thâm - Cải Thiện Giấc Ngủ - Hàng Chính Hãng",1680000,2750000,1070000,39
TIKI,lam-dep-suc-khoe,140953992,"Nến thơm tinh dầu thảo mộc thiên nhiên thương hiệu Aurae - cho buổi tối lãng mạng, thư giãn",50000,50000,0,0
TIKI,lam-dep-suc-khoe,33597687,"Son dưỡng môi không màu chuyển kem mịn LipIce Creamy",50000,62500,12500,20
TIKI,lam-dep-suc-khoe,192894194,"Cây massage đầu thư giãn BaoAn chính hãng",19000,25000,6000,24
TIKI,lam-dep-suc-khoe,50699261,"Nước tẩy trang Công Nghệ Micella Bioderma Sebium H2O",425000,525000,100000,19
TIKI,lam-dep-suc-khoe,160147181,"Máy massage ngực thông minh CTFAST WX-006: Mát xa 5 cấp độ rung kết hợp nhiệt ổn định hỗ trợ giảm tình trạng chảy xệ, cải thiện nâng và tăng kích thước vòng 1 đem lại vóc bộ ngực săn chắc quyến rũ - Món quà ý nghĩa dành cho chị em phụ nữ",438000,679000,241000,35
TIKI,lam-dep-suc-khoe,10758843,"Dụng Cụ Cạo Lưỡi Người Lớn Sản Xuất Tại Thụy Sĩ Trisa Double Action",87000,110000,23000,21
TIKI,lam-dep-suc-khoe,118124189,"Viên uống ALIPAS tăng cường sinh lý nam với Eurycoma longifolia, Oyster Meat, Pine Bark Extract (30 viên)",750000,750000,0,0
TIKI,lam-dep-suc-khoe,193583716,"Sữa tắm dưỡng thể Dove Deep Moisture Dưỡng ẩm chuyên sâu với dưỡng chất lợi khuẩn da 900g",169000,226000,57000,25
TIKI,lam-dep-suc-khoe,189337681,"Phấn phủ bạc Mochi Nhật Bản. Phấn che khuyết điểm tóc thưa, phủ tóc bạc chính hãng",199000,199000,0,0
TIKI,lam-dep-suc-khoe,39334371,"Combo tẩy triệt lông Bikini vĩnh viễn UMIHA tại nhà | Mỡ trăn triệt lông vĩnh viễn U Minh Hạ (30ml) & Kem tẩy lông UMIHA (85g) an toàn cho da nhạy cảm",368000,530000,162000,31
TIKI,lam-dep-suc-khoe,90331609,"Đai Chống Gù Lưng Nam Nữ Có Nẹp Dành Cho Dân Văn Phòng miDoctor mi04",147000,147000,0,0
TIKI,lam-dep-suc-khoe,136855407,"Sữa tắm nam hương nước hoa Bergami Savage",165000,165000,0,0
TIKI,lam-dep-suc-khoe,174151623,"[HỘP -D&J] Khẩu Trang Y Tế Kháng Khuẩn 4D D&J/Tiêu Chuẩn KF94/Hộp 10 Cái/Nhiều Họa Tiết",18000,18000,0,0
TIKI,lam-dep-suc-khoe,137860001,"Bông Tẩy Trang Jomi 80 Miếng/Túi",25000,25000,0,0
TIKI,lam-dep-suc-khoe,170491702,"[VIDEO]-Bộ dụng cụ ráy tai/ ngoáy tai cao cấp 6 món kèm bao da kiêm móc khóa- CHỌN MẪU- Dụng cụ ráy tai thông minh cho người lớn và trẻ em",49000,63700,14700,23
TIKI,lam-dep-suc-khoe,580508,"Lăn Khử Mùi Romano Classic 50ml - 1412047",68000,68000,0,0
TIKI,lam-dep-suc-khoe,117170053,"Nước hoa hồng Simple Toner làm dịu và cân bằng độ ẩm cho da - lành tính không chứa cồn 200ml [Chính hãng độc quyền]",114000,160500,46500,29
TIKI,lam-dep-suc-khoe,111615771,"Túi chườm nóng lạnh đa năng, túi chườm bụng kinh nam tặng nữ bigsize",199000,199000,0,0
TIKI,lam-dep-suc-khoe,35031109,"Son lì dưỡng môi siêu mịn Lip On Lip Silky Matte",142000,177000,35000,20
TIKI,lam-dep-suc-khoe,1313873,"Kem chống nắng Sunplay mát lạnh giải nhiệt dạng sữa Sunplay Super Cool SPF 50, PA++++ 30g",78000,97000,19000,20
TIKI,lam-dep-suc-khoe,170820908,"Lược gội đầu Silicon nguyên chất hãng CWELL, lược massage đầu, gỡ rối giảm rụng chăm sóc tóc C04PK",59000,99000,40000,40
TIKI,lam-dep-suc-khoe,45319679,"Bao cao su Durex Naughty Chocolate hộp 3 bao",45000,51000,6000,12
TIKI,lam-dep-suc-khoe,2079711,"Sữa Dưỡng Thể 350Ml Vaseline Dưỡng Ẩm Sáng Da Chống Nắng Spf24Pa++ Sun + Pollution Protection Bảo Vệ Da Tới 4H Với Spf 24 Pa++",121000,150000,29000,19
TIKI,lam-dep-suc-khoe,74167275,"Cà Phê Đắk Lắk Làm Sạch Da Chết Mặt Cocoon 150ml",140250,165000,24750,15
TIKI,lam-dep-suc-khoe,191995136," Tinh dầu treo xe thiên nhiên HOMER / Bạc Hà/ Quế/ Oải hương/ Bưởi/ Cam/ Hoa Lài/ Quýt/ Tràm Huế/ Hoa Hồng/ Lavender/ Ngọc Lan Tây/ Tràm Trà/ Sả Java/ Trà Xanh/ Cà Phê/ Chanh/ Trà xanh/ Trà trắng",39000,39000,0,0
TIKI,lam-dep-suc-khoe,89878475,"Bộ 2 chai Dung Dịch Vệ Sinh Phụ nữ Lactacyd Odor Fresh Ngăn Mùi 24H 250ml/chai",154000,178000,24000,13
TIKI,lam-dep-suc-khoe,25108019,"Gel chấm mụn đầu trắng và đầu đen Acnes Sealing Jell 18g",69000,69000,0,0
TIKI,lam-dep-suc-khoe,43252810,"Sữa Tắm Dạng Gel Neutrogena Rainbath Original Refreshing Shower And Bath Gel 473ml",155000,296000,141000,48
TIKI,lam-dep-suc-khoe,72950323,"Bộ sản phẩm Tsubaki Premium Phục hồi ngăn rụng tóc chuyên sâu (Gội xả 490ml/chai + kem xả 180g + xịt dưỡng 220ml + dầu dưỡng 50ml)",599000,1113000,514000,46
TIKI,lam-dep-suc-khoe,7255881,"Thực phẩm chức năng Tảo xoắn Spirulina nội địa Nhật Bản 2200 viên",322000,453600,131600,29
TIKI,lam-dep-suc-khoe,93047706,"Tinh Dầu Sả Chanh Ấn Homer 100ml - Chính Hãng, Đạt Chuẩn Kiểm Định Cao Cấp - Tinh Dầu Xông Thơm Phòng, Thư Giãn, Khử Mùi hiệu quả",60000,60000,0,0
TIKI,lam-dep-suc-khoe,93016290,"Hộp 30 Chiếc Khẩu Trang 3D MONA MASK N99 Chống Nắng Tia Uv Ngăn Đến 99% Hạt Bụi Siêu Mịn Pm 2.5",600000,600000,0,0
TIKI,lam-dep-suc-khoe,45319677,"Bao cao su Durex Sensual Strawberry hộp 3 bao",45000,51000,6000,12
TIKI,lam-dep-suc-khoe,186288869,"Bộ đai chườm nóng thảo dược giảm đau đầu gối dùng điện - Hapaku",945000,1200000,255000,21
TIKI,lam-dep-suc-khoe,21482823,"Lược thưa chải tóc xoăn - Giao hàng màu ngẫu nhiên",1000,20000,19000,95
TIKI,lam-dep-suc-khoe,15134851,"Sáp vuốt tóc Apestomen Volcanic Clay",240000,240000,0,0
TIKI,lam-dep-suc-khoe,46060478,"Kem tan mỡ bụng Truesky S Body Cream chiết xuất quế gừng an toàn và hiệu quả 100g",180000,180000,0,0
TIKI,lam-dep-suc-khoe,152097293,"Bông tẩy trang ipek thổ nhĩ kì 150 miếng ( 120+30 miếng)",27900,43500,15600,36
TIKI,lam-dep-suc-khoe,151519665,"Bao cao su cao cấp OZO Feelex Invisible Cool - Hộp 10 bcs",89000,89000,0,0
TIKI,lam-dep-suc-khoe,44935549,"Gel Hút Mụn Đầu Đen Than Hoạt Tính - Bùn Khoáng - Tảo Biển - OHIO - 200g",49000,49000,0,0
TIKI,lam-dep-suc-khoe,140537792,"Sữa rửa mặt Hatomugi hạt ý dĩ",53100,54180,1080,2
TIKI,lam-dep-suc-khoe,7727580,"Mặt nạ giấy hàn quốc tinh chất lô hội trắng da DABO HÀN QUỐC ( 22ml/ miếng)",8900,8900,0,0
TIKI,lam-dep-suc-khoe,15823484,"Dung dịch dưỡng ẩm tối ưu Hada Labo Advanced Nourish Lotion dùng cho da dầu 100ml",117000,146000,29000,20
TIKI,lam-dep-suc-khoe,57649867,"Sữa Dưỡng Thể 350Ml Vaseline Dưỡng Ẩm Sáng Da Fresh & Bright 10X Niacinamide Giúp Da Sáng Khỏe Mịn Căng Tinh Chất Menthol Mát Lạnh Như Tuyết Tan Trên Da",99000,150000,51000,34
TIKI,lam-dep-suc-khoe,35526564,"Sữa Rửa Mặt Neutrogena Ngừa Mụn Đầu Đen 100ml",95000,125000,30000,24
TIKI,lam-dep-suc-khoe,77094737,"Viên Uống Thơm Miệng Breath Pearls",119000,230000,111000,48
TIKI,lam-dep-suc-khoe,149460253,"Tinh Dầu Oải Hương Homer 100ML - Tinh Dầu Lavender Thiên Nhiên Nhập Khẩu Nguyên Chất Giúp Giảm Stress, Khử Khuẩn và Xua Đuổi Côn Trùng, Sử Dụng Hiệu Quả với Máy Xông Tinh Dầu",85000,85000,0,0
TIKI,lam-dep-suc-khoe,76178104,"Bàn chải đánh răng điện Colgate Minions dành cho trẻ em",243000,294000,51000,17
TIKI,lam-dep-suc-khoe,166595471,"Set Dưỡng Trắng Da Ốc Sên Cấp Ẩm Se Khít Lỗ Chân Lông Và Chống Lão Hóa Dewytree Ultra Vitalizing Snail 20ml",72000,90000,18000,20
TIKI,lam-dep-suc-khoe,72109547,"Gel ngừa mụn viêm thâm đầu đen  Decumar Advanced 20 gr hoàn toàn mới",77000,77000,0,0
TIKI,lam-dep-suc-khoe,119068215,"Cân sức khỏe Cân gia đình Camry BR202007A cao cấp hoạt động cơ học, trọng tải tối đa 130kg ( bước nhảy +-1kg ) - Hàng nhập khẩu",175000,175000,0,0
TIKI,lam-dep-suc-khoe,47149569,"Gel Vệ Sinh Phụ Nữ Giảm Viêm Ngứa X2 Nano Nghệ Cocayhoala 150ml",199000,330000,131000,40
TIKI,lam-dep-suc-khoe,2609469,"Nước Tẩy Trang Làm Sạch Sâu Cho Da Nhạy Cảm La Roche-Posay Micellar Water Ultra Sensitive Skin 400ml",393000,525000,132000,25
TIKI,lam-dep-suc-khoe,75997194,"Máy Xông Tinh Dầu 2200ML Cho Phòng Rộng + Tinh Dầu Sả Chanh TIDAMO - Máy Khuếch Tán Tinh Dầu Thể Tích Lớn Nhất, Chuyên Dụng Xông Tinh Dầu, Phun Sương Tạo Ẩm Cho Không Gian Lớn",319000,776000,457000,59
TIKI,lam-dep-suc-khoe,76169589,"[HỘP - FAMAPRO VN95] - Khẩu trang y tế kháng khuẩn 4 lớp Famapro VN95 đạt chuẩn N95 (10 cái/ hộp) - COMBO 5 HỘP",57000,85000,28000,33
TIKI,lam-dep-suc-khoe,195937695,"Máy Massage Mắt Cầm Tay Mini Nhiệt Rung Crenot Erie V2 Mát Xa Giảm Thâm Bọng Nhức Mỏi Mờ Nếp Nhăn",725000,1420000,695000,49
TIKI,lam-dep-suc-khoe,197922834,"Tinh dầu Cà Phê Homer 100ml - Tinh Dầu Xông Thơm Phòng, Thư Giãn, Khử Mùi - Tinh dầu Sả Chanh/ Vỏ Quế/ Cam Ngọt/ Oải hương/ Ngọc Lan Tây/ Tràm Trà/ Bưởi Ngọt",65000,65000,0,0
TIKI,lam-dep-suc-khoe,191514845," Máy Rửa Mặt Mini Cầm Tay Crénot Nia P5 Chính Hãng, Sử Dụng Sóng Âm Và Silicone Siêu Mềm Sạch Sâu Bụi Bẩn Trang Điểm Ngừa Mụn - Máy Rửa Mặt Massage Mát xa Matxa Tốt Chăm Sóc Da Dầu Mụn Nhạy Cảm Cho Nam Nữ",580000,1160000,580000,50
TIKI,lam-dep-suc-khoe,76166201,"[HỘP - FAMAPRO MAX] - Khẩu trang y tế kháng khuẩn 4 lớp Famapro Max (40 cái/ hộp) - COMBO 5 HỘP",129000,129000,0,0
TIKI,lam-dep-suc-khoe,195972836,"Máy Triệt Lông Vĩnh Viễn Băng Lạnh Trẻ Hóa Da Mini Cầm Tay Tại Nhà Crénot Graci X3 Dành Cho Nách Vùng Bikini Mặt Chân Toàn Thân Cá Nhân Giảm Mụn IPL Hair Removal Ice Cooling Compress",2090000,2190000,100000,5
TIKI,lam-dep-suc-khoe,197378660,"Phấn Nước Che Khuyết Điểm Nâng Tone Kiềm Dầu Chống Nắng Dưỡng Da Dewytree Urban Shade Cover & Fit Sun Cushion SPF50+ PA++++(14g)",468000,520000,52000,10
TIKI,lam-dep-suc-khoe,37869185,"Máy massage xung điện - bộ 4 miếng dán",85000,85000,0,0
TIKI,lam-dep-suc-khoe,631403,"Nước Súc Miệng Làm Trắng Răng Listerine Healthy Bright (750ml) - 8850007813385",146000,187000,41000,22
TIKI,lam-dep-suc-khoe,147043572,"Xịt Thơm Miệng Befresh Cho Hơi Thở Thơm Mát Chỉ Trong 3 Giây Dung Tích 10ml",75900,75900,0,0
TIKI,lam-dep-suc-khoe,6430923,"Lăn khử mùi chiết xuất thiên nhiên Refre Natural Green Tea Hương Trà Xanh 40ml",61300,65000,3700,6
TIKI,lam-dep-suc-khoe,544425,"Cân Sức Khỏe 120kg Nhơn Hòa (Nhiều màu) - Giao màu ngẫu nhiên - Hàng Chính Hãng",378000,378000,0,0
TIKI,lam-dep-suc-khoe,14423711,"Tấm thảo dược thay thế của đai chườm lưng cắm điện - Hapaku",128000,160000,32000,20
TIKI,lam-dep-suc-khoe,631049,"Dung dịch dưỡng ẩm tối ưu Hada Labo Advanced Nourish Lotion dùng cho da dầu 170ml",167000,208000,41000,20
TIKI,lam-dep-suc-khoe,169778290,"Combo 2 chai Dung Dịch Vệ Sinh Nam X2 Manly - Làm sạch tức thì Lưu hương 24h dung tích 150g Cocayhoala (Combo 2 chai)",285000,399000,114000,29
TIKI,lam-dep-suc-khoe,81304013," Đai Chống Gù Lưng Rung Nhật Bản, dành cho trẻ em, học sinh, trẻ nhỏ",193000,350000,157000,45
TIKI,lam-dep-suc-khoe,106074482,"Viên uống Vitamin C DHC Nhật Bản giúp sáng da mờ thâm thực phẩm chức năng giúp tăng cường sức đề kháng JN-DHC-C",85000,90720,5720,6
TIKI,lam-dep-suc-khoe,72555195,"50 que thử tiểu đường On call plus của hãng ACON/Mỹ, dùng cho máy On call plus và On call EZii",143000,250000,107000,43
TIKI,lam-dep-suc-khoe,43163776,"Nước hoa nam cao cấp chính hãng Jile Guilty 50ml với hương thơm mạnh mẽ, nam tính, lịch lãm, quý phái.",349000,470000,121000,26
TIKI,lam-dep-suc-khoe,435317,"Máy Đo Huyết Áp Bắp Tay Omron - HEM-8712 - 100610698",799000,920000,121000,13
TIKI,lam-dep-suc-khoe,3282871,"Gel rửa mặt tạo bọt làm sạch & giảm nhờn cho da dầu nhạy cảm La Roche-Posay Effaclar Purifying Foaming Gel (400ml)",468000,625000,157000,25
TIKI,lam-dep-suc-khoe,44878245,"Cho máy Braun Oral-B, Bộ 4 đầu bàn chải đánh răng điện - Đánh tan mảng bám- SB-17A",165000,165000,0,0
TIKI,lam-dep-suc-khoe,134592241,"Lăn khử mùi dành cho nữ Aquaselin 50ml (loại mạnh)",290000,290000,0,0
TIKI,lam-dep-suc-khoe,12082922,"Tinh chất hàu Oyster Plus Goodhealth 30v",309000,309000,0,0
TIKI,lam-dep-suc-khoe,106541128,"Tinh chất dưỡng tóc KOKO Cocayhoala - Ngăn rụng tóc - Kích thích mọc tóc - Giúp tóc mềm mượt - 100ml",209000,209000,0,0
TIKI,lam-dep-suc-khoe,108830964,"Bộ 3 Kem đánh răng P/S Than Hoạt Tính 230g",115000,135000,20000,15
TIKI,lam-dep-suc-khoe,96620654,"GINKO 5 HOẠT HUYẾT NĂM CÁNH SEN Giúp Tăng Cường Tuần Hoàn Máu Não, Giảm Nguy Cơ Hình Thành Cục Máu Đông, Mệt Mỏi, Đau Đầu, Mất Ngủ, Hoa Mắt, Chóng Mặt, Nhức Mỏi Vai Gáy",180000,180000,0,0
TIKI,lam-dep-suc-khoe,115660001,"( CHÍNH HÃNG LÀN DA ĐẸP) Megaduo Gel New - Gel Giảm Mụn Và Thâm Mụn",125000,125000,0,0
TIKI,lam-dep-suc-khoe,50618604,"Bao cao su Okamoto 0.01 Hydro Polyurethane (PU). Bao cao su Nhật Bản siêu mỏng chỉ 0.01mm bằng 1/6 độ dày sợi tóc, cho cảm nhận truyền nhiệt nhanh (Hộp 4 Cái) ",149000,149000,0,0
TIKI,lam-dep-suc-khoe,1362445,"Sữa Rửa Mặt Cetaphil Gentle Skin Cleanser (125ml)",137000,140000,3000,2
TIKI,lam-dep-suc-khoe,112728673,"Bọt vệ sinh nam giới Oniiz 100ml",120000,120000,0,0
TIKI,lam-dep-suc-khoe,129868878,"Combo Dầu Gội X-Men Nước hoa Wood 650G và Sữa Tắm X-Men Nước hoa Wood 650G",382000,382000,0,0
TIKI,lam-dep-suc-khoe,107985508,"Bộ ba Tsubaki Premium Phục hồi ngăn rụng tóc & Bảo Vệ Tóc Trước Tác Hại Của Tia UV (Gội Xả 490ml/chai + Dầu dưỡng tóc 50ml)",687000,687000,0,0
TIKI,lam-dep-suc-khoe,35526560,"Nước Rửa Mặt Neutrogena Dịu Nhẹ 100ml",75000,100000,25000,25
TIKI,lam-dep-suc-khoe,173224731,"Máy phun sương mini tạo ẩm CWELL, tích hợp đèn LED đèn ngủ nhiều màu, 3 chế độ phun sương mịn,  dung tích cực lớn 2L",209000,299000,90000,30
TIKI,lam-dep-suc-khoe,55895699,"Bigsize - Kem tan mỡ bụng Truesky S Body Cream chiết xuất quế gừng an toàn và hiệu quả 200g",280000,280000,0,0
TIKI,lam-dep-suc-khoe,192831802,"Tinh dầu nguyên chất Bạc Hà 24Care/ Sả chanh/ Quế/ Oải hương/ Bưởi/ Cam/ Hoa Lài/ Quýt/ Tràm Huế/ Hoa Hồng/ Lavender/ Ngọc Lan Tây/ Tràm Trà/ Sả Java/ Trà Xanh/ Gỗ Hồng/ Hoa Anh Đào",345000,345000,0,0
TIKI,lam-dep-suc-khoe,176756454,"Cân Điện Tử Sức Khoẻ Thông Minh Mặt Vuông Kính Cường Lực Chịu Lực 180Kg Deli - Phù Hợp Gia Đình Trường Học -  Nhiều Màu Sắc - Hàng Chính Hãng - E86120",169000,322200,153200,48
TIKI,lam-dep-suc-khoe,13416097,"Nhuộm Tóc Dược Liệu Thái Dương (5 Gói)",89900,120000,30100,25
TIKI,lam-dep-suc-khoe,116148009,"Dụng Cụ Lấy Ráy Tai, Bộ Ngoáy Tai 6 Chiếc KUNBE, Chất Liệu Inox Cao Cấp Giúp Vệ Sinh Tai An Toàn, Chuyên Nghiệp",32000,32000,0,0
TIKI,lam-dep-suc-khoe,135029845,"Gel Rửa Mặt Dịu Nhẹ Làm Sạch Sâu Neutrogena Hydro Boost Cleanser Water Gel - Dung tích 145ml",265000,350000,85000,24
TIKI,lam-dep-suc-khoe,105621214,"Bộ Bao Cao Su Durex Kingtex 3 Hộp 12 Bao",357000,588000,231000,39
TIKI,lam-dep-suc-khoe,58916736,"Lăn Khử Mùi ETIAXIL Détranspirant Traitement Aisselles Peaux Sensibles 15ml (Dành Cho Da Nhạy Cảm) + Quà Tặng",249000,320000,71000,22
TIKI,lam-dep-suc-khoe,247999867,"Gôm xịt tóc tạo kiểu siêu cứng, giữ nếp lâu Mugens Hair Spray Hàn Quốc 300ml + Móc khóa",121000,155000,34000,22
TIKI,lam-dep-suc-khoe,52280562,"Kem chống nắng nâng tông Skin Aqua Tone up Mint Green cho da trắng có khuyết điểm đỏ, dạng tinh chất Sunplay Skin Aqua Tone Up UV Essence Mint Green SPF 50+ PA++++ 50g",160000,199000,39000,20
TIKI,lam-dep-suc-khoe,470430,"Kem Dưỡng Giảm Mụn, Ngừa Thâm, Thông Thoáng Lỗ Chân Lông La Roche-Posay Effaclar Duo+ 40ml",360000,480000,120000,25
TIKI,lam-dep-suc-khoe,35226725,"Tinh chất ngừa mụn thâm The Ordinary Niacinamide 10% + Zinc 1",228000,265000,37000,14
TIKI,lam-dep-suc-khoe,3179511,"Sữa Tắm White Conc Body Nhật Bản Dưỡng Da Trắng Hồng, 360ml",181000,233100,52100,22
TIKI,lam-dep-suc-khoe,76053234,"Combo 2 Sữa Tắm L'amont En Provence Cherry Blossom (Hoa Anh Đào) Shower Gel 1000ml",480000,480000,0,0
TIKI,lam-dep-suc-khoe,108535259,"Bao cao su Sagami Exceed 2000 - Thiết kế 3D - Một lần thắt - Hộp 12 chiếc",95000,120000,25000,21
TIKI,lam-dep-suc-khoe,11956889,"Kem Nứt Gót Dưỡng Ẩm, Giảm Đau, Làm Lành Nhanh Vùng Nứt Gót Chân Oriss - Dưỡng Ẩm Vượt Trội Suốt 24h - tuýp 30g ",45000,57000,12000,21
TIKI,lam-dep-suc-khoe,134591513,"Lăn khử mùi dành cho nam Aquaselin 50ml",290000,290000,0,0
TIKI,lam-dep-suc-khoe,14694900,"Xà Phòng Cải Thiện Thâm Mông Pelican Hip Care Soap nội địa Nhật",113000,115920,2920,3
TIKI,lam-dep-suc-khoe,74640666,"Dầu Gội Dược Liệu Thái Dương 7Plus (Chai 100ml)",75000,75000,0,0
TIKI,lam-dep-suc-khoe,55615437,"Tẩy Da Chết Tế Bào Gốc Thực Vật Làm Sạch Sâu Dịu Nhẹ Dưỡng Ẩm Trắng Da Chống Nhăn Cho Da Nhạy Cảm Cellkey-Scien White Peeling Gel (80ml)",315000,350000,35000,10
TIKI,lam-dep-suc-khoe,48579668,"Bao cao su Sagami Original 0.02 cao cấp, siêu mỏng (Hộp 12 chiếc)",329000,500000,171000,34
TIKI,lam-dep-suc-khoe,34480145,"Combo 2 Hộp Miếng Dán Mụn Cóc Loại Bỏ Mụn Cóc Tại Nhà An Toàn Hiệu Quả - Hộp 6 miếng",104000,110000,6000,5
TIKI,lam-dep-suc-khoe,56218973,"Bộ 5 kem đánh răng Colgate ngừa sâu răng răng chắc khỏe 225g/tuýp tặng bàn chải đánh răng lông tơ nhập khẩu Thái Lan",176000,210000,34000,16
TIKI,lam-dep-suc-khoe,144228451,"Khẩu Trang 4D Kiếu Dáng Hàn Quốc KF94 (10 Cái / Túi), kháng Khuẩn, Chống Bụi, Màu Trắng - Đạt Các Chứng Chỉ ISO 13485, ISO 9001, CE, FDA, TGA.",15000,15000,0,0
TIKI,lam-dep-suc-khoe,170402456,"Combo 10 Gói Khẩu trang Bông Bạch Tuyết KF94 4 lớp trắng (10 cái/gói)",200000,200000,0,0
TIKI,lam-dep-suc-khoe,149467412,"Tinh Dầu Ngọc Lan Tây Homer 100ML - Tinh Dầu Thiên Nhiên Nhập Khẩu Nguyên Chất Giúp Giảm Stress, Khử Khuẩn và Xua Đuổi Côn Trùng, Sử Dụng Hiệu Quả với Máy Xông Tinh Dầu",85000,85000,0,0
TIKI,lam-dep-suc-khoe,252679985,"Combo lịch lãm Nerman - Sữa tắm gội Gentleman 3in1 hương nước hoa cao cấp 350ml",288000,550000,262000,48
TIKI,lam-dep-suc-khoe,1529993,"Xịt khử mùi dưỡng trắng hương nước hoa Refre Whitening PerfumeSophis Hương Tinh Tế 30ml",58500,62000,3500,6
TIKI,lam-dep-suc-khoe,84875620,"Tinh Dầu Hoa Nhài 30ML Nguyên Chất, Nhập Khẩu - Tinh Dầu Hoa Lài TIDAMO (Jasmine) Có Kiểm Nghiệm, Hương Thơm Dịu Nhẹ Quý Phái - Xông Thơm Phòng, Thư Giãn và Tốt Cho Sức Khỏe",74800,176000,101200,58
TIKI,lam-dep-suc-khoe,179717787,"Toner giảm mụn dịu da Acnes Blemish Control Toner 100ml",77000,85000,8000,9
TIKI,lam-dep-suc-khoe,50331044,"Xà phòng rửa tay diệt khuẩn nano bạc Nano Vio 190ml - ít bọt, không triclosan, hương thơm tinh dầu dịu nhẹ",49000,99000,50000,51
TIKI,lam-dep-suc-khoe,73438399,"Kem chống nắng lâu trôi innisfree Intensive Long Lasting Sunscreen SPF50+ PA++++ 60ml (New 2023)",381000,450000,69000,15
TIKI,lam-dep-suc-khoe,74973204,"Máy Rửa Mặt Mini Massage Tích Hợp Sóng Âm Giúp Làm Sạch Sâu Da, Nâng Cơ Mặt, Sáng Da, Trẻ Hóa Làn Da - Máy Rửa Mặt Chính hãng VinBuy",137000,300000,163000,54
TIKI,lam-dep-suc-khoe,172303081,"Gel lột mụn hút sạch mụn cám, mụn đầu đen YOSHI 200gr",65000,65000,0,0
TIKI,lam-dep-suc-khoe,72924805,"Máy Xông Tinh Dầu Hiệu Ứng Ánh Sáng 3D Cực đẹp, Máy Khuếch Tán Tinh Dầu Chuyên Dụng Xông Tinh Dầu Và Đèn LED 3D Trang Trí Phòng",319000,776000,457000,59
TIKI,lam-dep-suc-khoe,117793839,"Tăm nước cầm tay H2ofloss HF-2 phiên bản nâng cấp được phân phối độc quyền với nút mở bình nước tiện lợi, tặng kèm 7 đầu tăm, củ sạc nguồn thấp",584000,1140000,556000,49
TIKI,lam-dep-suc-khoe,10072103,"Gel Hút Mụn Đầu Đen Than Hoạt Tính - OHIO ỐC SÊN NEW DAY",32000,32000,0,0
TIKI,lam-dep-suc-khoe,580507,"Lăn Khử Mùi Romano Attitude 50ml - 1412046",56000,68000,12000,18
TIKI,lam-dep-suc-khoe,22052325,"Sữa rửa mặt cho nam Oxy sạch sâu mát lạnh dạng kem Oxy Perfect Wash 100g",66000,82000,16000,20
TIKI,lam-dep-suc-khoe,176790842,"Túi chườm nóng lạnh đa năng dung tích 500ml, túi chườm ấm bụng giảm đau bụng kinh nguyệt dành cho bạn nữ",89000,89000,0,0
TIKI,lam-dep-suc-khoe,67555393,"Dung dịch vệ sinh nam dịu nhẹ lành tính thành phần tự nhiên mùi hương nam tính chai vòi nhấn 150ml - LOLI & THE WOLF",149000,149000,0,0
TIKI,lam-dep-suc-khoe,76133761,"[HỘP - FAMAPRO 5D BABY] - khẩu trang y tế trẻ em kháng khuẩn 3 lớp Famapro 5D Baby (10 cái/ hộp) - 1 HỘP",9900,9900,0,0
TIKI,lam-dep-suc-khoe,122092245,"[+Tặng mũ trùm] BỘ DẦU GỘI XẢ PASIORI TM COLLAGEN & BIOTIN TRẮNG PHỤC HỒI, MỀM MƯỢT NGĂN GÃY RỤNG MỌC TÓC ITALY 1000ML*2 [MẪU MỚI]",365000,390000,25000,6
TIKI,lam-dep-suc-khoe,195937919,"[148 Mùi Hương] Tinh Dầu Thơm Phòng Trái Cây Thiên Nhiên Nhiệt Đới - Khử Mùi, Xông Thơm Phòng - Tinh Dầu Đào/ Chuối/ Táo Xanh/ Mơ/ Me/ Xoài/ Dưa Lưới/ Dưa Hấu (100ml)",275000,275000,0,0
TIKI,lam-dep-suc-khoe,12081510,"Kem Thoa Giãn Tĩnh Mạch Hỗ Trợ Giảm Đau, Sưng, Phù Chân Vascovein (tuýp 50g)",167000,201000,34000,17
TIKI,lam-dep-suc-khoe,1600039,"Combo 6 Băng Vệ Sinh Diana Siêu Thấm Siêu Mỏng 0.1 (Gói 8 Miếng)",120000,144000,24000,17
TIKI,lam-dep-suc-khoe,138662376,"Dung dịch vệ sinh Phụ nữ Gel X2 Nano Nghệ Đào Hồng Mềm Mại Lưu Hương 24h Cocayhoala - 150ml",199000,330000,131000,40
TIKI,lam-dep-suc-khoe,77749059,"Tinh Dầu Sả Chanh 50ML + Tinh Dầu Treo xe Treo Phòng Sả Chanh (Lemongrass) - Tinh Dầu Xông Phòng Sả Chanh Nguyên Chất TIDAMO Giúp Bảo Vệ Sức Khỏe, Kháng Khuẩn, Đuổi Muỗi Và Thư Giãn Tinh Thần",128000,256000,128000,50
TIKI,lam-dep-suc-khoe,128125614,"Combo 6 Băng Vệ Sinh Diana Hàng Ngày Compact Gói 20 Miếng",90000,108000,18000,17
TIKI,lam-dep-suc-khoe,12053893,"Lăn Khử Mùi Etiaxil Détranspirant Traitement Aisselles Peaux Sensibles 15ml (Dành cho da hỗn hợp, da nhạy cảm)",195000,320000,125000,39
TIKI,lam-dep-suc-khoe,273952811,"Bộ Đôi Kem Dưỡng Chống Lão Hóa Da Ngày Và Đêm Pond's Age Miracle giúp mờ đốm nâu, nếp nhăn với 50X Hexyl-Retinol 45g x 2",505000,760000,255000,34
TIKI,lam-dep-suc-khoe,74307186,"Serum Tinh Chất Chấm Mụn Lành Tính Nhanh Xẹp Mụn Chống Thâm Và Sẹo Rỗ DewyTree The Clean Lab AC DEW Calamine Blemish Spot 20ml",315000,350000,35000,10
TIKI,lam-dep-suc-khoe,186305097,"Gối Kê Gáy, Cổ Thảo Dược Hapaku - Làm Nóng Bằng Lò Vi Sóng",198000,298000,100000,34
TIKI,lam-dep-suc-khoe,53296092,"Sữa chống nắng Shiseido GSC The Perfect Protector 50ml",1249000,1250000,1000,0
TIKI,lam-dep-suc-khoe,24910578,"Son kem lì Bbia Last Velvet Lip Tint Version 3 5g (5 màu)",150000,290000,140000,48
TIKI,lam-dep-suc-khoe,176812001,"Vitamin Bầu Tổng Hợp Elevit Cho Phụ Nữ Trước, Trong và Sau Thai Kỳ 30 Viên",475000,475000,0,0
TIKI,lam-dep-suc-khoe,20640806,"Lưỡi Lược Thép Lược Bướm Tập Quay",52900,52900,0,0
TIKI,lam-dep-suc-khoe,205080549,"Viên uống tăng cường sinh lý nam giới Powergra (Super Gold Magic) - Vỉ 1 viên",202400,220000,17600,8
TIKI,lam-dep-suc-khoe,174045175,"Kem chống nắng nâng tông Skin Aqua Tone up Latte Beige cho mọi tông da, dạng tinh chất Sunplay Skin Aqua Tone Up UV Essence Latte Beige SPF 50+ PA++++ 50g",160000,199000,39000,20
TIKI,lam-dep-suc-khoe,10053537,"Mỡ trăn triệt lông U Minh Hạ nguyên chất (10/30ml) UMIHA dùng cho vùng Chân, Tay, Nách, Bikini, Body tại nhà hiệu quả an toàn tiết kiệm",265000,265000,0,0
TIKI,lam-dep-suc-khoe,68250779,"Cà Gai Leo Xạ Đen - Viên Uống Bổ Gan, Giải Độc Gan, Tăng Cường Chức Năng Gan (Hộp 60 Viên)",185000,185000,0,0
TIKI,lam-dep-suc-khoe,631959,"Kem mờ sẹo và thâm dạng gel Acnes Scar Care 12g",73900,79000,5100,6
TIKI,lam-dep-suc-khoe,75528793,"Combo 3 Tinh Dầu Sả Chanh + Tinh Dầu Bạc Hà + Tinh Dầu Cam Ngọt - Tinh Dầu Xông Phòng Nguyên Chất Nhập Khẩu Giúp Thư Giãn, Đuổi Muỗi Và Thơm Phòng (3 chai 10ML)",78000,236000,158000,67
TIKI,lam-dep-suc-khoe,1754767,"Combo 2 Gel vệ sinh nam Serenys 100ml - Dung dịch vệ sinh phụ khoa nam giới",249000,249000,0,0
TIKI,lam-dep-suc-khoe,75321691,"Nước Súc Miệng Amfagold Care Gingival",120000,120000,0,0
TIKI,lam-dep-suc-khoe,95175125,"Tinh Dầu Quế Homer 100ml - Chính Hãng, Đạt Chuẩn Kiểm Định Cao Cấp - Tinh Dầu Xông Thơm Phòng, Thư Giãn, Khử Mùi hiệu quả",65000,65000,0,0
TIKI,lam-dep-suc-khoe,262677342,"Hộp 48 cái Bao cao su Tâm Thiện Chí Guardian - Mỏng trơn, Nhiều dầu bôi trơn, Size 52mm",53000,90000,37000,41
TIKI,lam-dep-suc-khoe,131504747,"Dầu gội dược liệu Thái Dương 7 Plus Gold (Chai 250ml/500ml, Hoa phong Ian) - Sao Thái Dương",150000,150000,0,0
TIKI,lam-dep-suc-khoe,146584853,"Bàn chải đánh răng điện FAIRYWILL D7 Công nghệ sóng siêu âm 5 Chế độ làm sạch 3 Đầu thay thế đặc biệt Hàng Chính Hãng",239200,299000,59800,20
TIKI,lam-dep-suc-khoe,70633870,"Khẩu Trang Y Tế Kháng Khuẩn Cao Cấp TDCare 4 Lớp",30000,38000,8000,21
TIKI,lam-dep-suc-khoe,164336224,"Túi chườm nóng lạnh nhung mềm giảm đau bụng kinh, túi chườm giữ ấm hạ sốt 350ml SP004163",25000,25000,0,0
TIKI,lam-dep-suc-khoe,1313887,"Kem chống nắng Skin Aqua dưỡng ẩm, dạng sữa dùng hàng ngày Sunplay Skin UV Moisture SPF 50, PA++++ 30g",88000,109000,21000,19
TIKI,lam-dep-suc-khoe,12624516,"Combo bộ 4 đầu bàn chải đánh răng điện cho máy Oral B xuất xứ Đức",165000,165000,0,0
TIKI,lam-dep-suc-khoe,442858,"Nhiệt Ẩm Kế Beurer HM 16",316000,380000,64000,17
TIKI,lam-dep-suc-khoe,78007672,"Sữa rửa mặt không gây kích ứng cho da nhạy cảm Eucerin pH5 Facial Cleanser 400ml",209000,279000,70000,25
TIKI,lam-dep-suc-khoe,105821846,"Tinh Dầu Treo Xe Homer 7ML - Khử Mùi Xe Hơi, Treo Thơm Phòng, Treo Tủ - Tinh dầu treo Sả chanh/ Bạc Hà/ Quế",8000,8000,0,0
TIKI,lam-dep-suc-khoe,135352499,"Túi chườm nóng đau bụng kinh nguyệt PUHA 700ml, túi chườm ấm bụng giảm đau hiệu quả cho bạn nữ",169000,169000,0,0
TIKI,lam-dep-suc-khoe,102796692," Gối Massage Vai Gáy 8 Bi Hồng Ngoại Công Nghệ Nhật Bản Cao Cấp",145000,145000,0,0
TIKI,lam-dep-suc-khoe,195969972,"Kem đánh răng dạng gel Closeup White Attraction Diamond (100g)",39500,39500,0,0
TIKI,lam-dep-suc-khoe,1911371,"Kem Dưỡng Làm Dịu Kích Ứng Và Phục Hồi Da La Roche-Posay Cicaplast Baume B5 (40ml)",307000,410000,103000,25
TIKI,lam-dep-suc-khoe,105632361,"Bộ 1 hộp bao cao su Durex Performa 12 bao và 1 Durex Fetherlite 12 bao",418000,584000,166000,28
TIKI,lam-dep-suc-khoe,184793101,"Máy Massage Cầm Tay Cao Cấp KINGTECH - Hỗ Trợ Toàn Thân - Chuyên Sâu Cổ, Vai, Gáy, Lưng - Giảm Đau Mỏi Cho Dân Văn Phòng, Gymer, Người Già, Người Lao Động Nặng - Chính Hãng",895000,1750000,855000,49
TIKI,lam-dep-suc-khoe,76776131,"Dầu gội xả 2in1 Palmolive thiên nhiên 600ml",94000,118000,24000,20
TIKI,lam-dep-suc-khoe,68491597,"Dầu gội ngăn rụng tóc 50 Megumi Hair Fall Control Shampoo 400ml",199000,250000,51000,20
TIKI,lam-dep-suc-khoe,12054639,"Lăn khử mùi Etiaxil Détranspirant Traitement Confort+ Aisselles Peaux Sensibles 15ml (Dành cho da siêu nhạy cảm)",208000,320000,112000,35
TIKI,lam-dep-suc-khoe,118896568,"Nến thơm tinh dầu cao cấp không khói an toàn Candle Cup - TWILIGHT/CHẠNG VẠNG - S - 100G (KG NẮP)",120000,120000,0,0
TIKI,lam-dep-suc-khoe,118089852,"Bộ 2 Tuýp Kem Chống Hăm Bepanthen Balm Dạng Kem Mỡ 30G/Tuýp ",191000,191000,0,0
TIKI,lam-dep-suc-khoe,186270829,"Bộ đai chườm nóng thảo dược giảm đau lưng bụng dùng điện - Hapaku",985000,1250000,265000,21
TIKI,lam-dep-suc-khoe,2007545,"Nước Súc Miệng Hương Bạc Hà Listerine Cool Mint (750ml)",169000,169000,0,0
TIKI,lam-dep-suc-khoe,104016707,"Bộ Ba Gội Xả Tsubaki Premium Cool Sạch Dầu Mát Lạnh (490ml/chai) và Mặt Nạ Tóc 180g",499000,713000,214000,30
TIKI,lam-dep-suc-khoe,95127416,"Tinh Dầu Cam Ngọt Homer 100ml - Chính Hãng, Đạt Chuẩn Kiểm Định Cao Cấp - Tinh Dầu Xông Thơm Phòng, Thư Giãn, Khử Mùi hiệu quả",60000,60000,0,0
TIKI,lam-dep-suc-khoe,105626002,"Bộ 4 Bao Cao Su Durex Sensual Strawberry - Hộp 3 Bao",180000,204000,24000,12
TIKI,lam-dep-suc-khoe,80960308,"Gối Massage Hồng Ngoại 8 Bi Đảo Chiều Chính Hãng THAFA -Massage Cổ, Vai, Gáy , Kèm Tẩu Sạc Trên Xe Hơi Vô Cùng Tiện Lợi",215000,325000,110000,34
TIKI,lam-dep-suc-khoe,117147637,"Sữa rửa mặt Simple giúp cấp ẩm, da trông khỏe và mịn màng - cho da khô nhạy cảm 150ml [CHÍNH HÃNG ĐỘC QUYỀN] [MỚI]",109000,132000,23000,17
TIKI,lam-dep-suc-khoe,57519012,"Siro thảo dược hỗ trợ giảm ho, long đờm, nhuận phế EUGICA SYRUP (Hộp 30 gói x 5 ml)",59000,65000,6000,9
TIKI,lam-dep-suc-khoe,877460,"Combo 5 Miếng Dán hỗ trợ điều trị Mụn Mayancare 20 Miếng (0.8cm)",144000,175000,31000,18
TIKI,lam-dep-suc-khoe,630793,"Kem chống nắng Skin Aqua trang điểm tạo nền trắng mịn & đều màu dạng sữa Sunplay Skin Clear White CC Milk SPF 50, PA++++ 25g",116000,145000,29000,20
TIKI,lam-dep-suc-khoe,158762755,"Bọt vệ sinh nam giới Oniiz - Dung dịch vệ sinh nam tạo bọt 100ml",120000,120000,0,0
TIKI,lam-dep-suc-khoe,75523734,"Combo 3 Tinh Dầu Sả Chanh + Tinh Dầu Bạc Hà + Tinh Dầu Vỏ Quế - Tinh Dầu Thiên Nhiên Xông Phòng Cao Cấp Giúp Thư Giãn, Đuổi Muỗi Và Thơm Phòng (3 chai 10ML)",74000,176000,102000,58
TIKI,lam-dep-suc-khoe,22103020,"The Ordinary AHA 30% + BHA 2% Peeling Solution - Giải Pháp Hỗ Trợ Giảm Vết Thâm, Da Sần Mụn, Lỗ Chân Lông 30ml",285000,350000,65000,19
TIKI,lam-dep-suc-khoe,76122941,"Mật ong Rừng Nhiệt Đới chai 1350g",280000,280000,0,0
TIKI,lam-dep-suc-khoe,58536309,"Đai chông gù lưng, áo chống gù lưng chính hãng GoodFit GF713P",499000,599000,100000,17
TIKI,lam-dep-suc-khoe,48291658,"Kem chống nắng body Skin Aqua mát lạnh dùng hàng ngày Sunplay Skin Aqua UV Body Cooling Lotion SPF 50+ PA++++ 150g",207000,219000,12000,5
TIKI,lam-dep-suc-khoe,108535223,"Bao cao su Sagami Green - Có gân gai - Hộp 10 chiếc",95000,120000,25000,21
TIKI,lam-dep-suc-khoe,144191636,"Combo Triệt Lông Vĩnh Viễn An Lành / 1 Wax 350Gr / 1 Sét giấy và que / 1 Mỡ trăn 50ml /1 Tinh Dầu 5ml ",129000,129000,0,0
TIKI,lam-dep-suc-khoe,89794660,"Dung Dịch Vệ Sinh Phụ nữ Lactacyd Soft & Silky Dưỡng Ẩm 250ml",81000,88000,7000,8
TIKI,lam-dep-suc-khoe,150016863,"Set 50 cái khẩu trang y tế KF94 Kháng Khuẩn, Chống Bụi Mịn, Hàng Cao Cấp",48000,80000,32000,40
TIKI,lam-dep-suc-khoe,59085965,"Máy Xông Tinh Dầu Vân Gỗ Cao Cấp Dung Tích 500ML Chuyên Dụng Cho Phòng Lớn",227800,496000,268200,54
TIKI,lam-dep-suc-khoe,53445636,"Nước Rửa Tay Lifebuoy Bảo Vệ Vượt Trội 10 - 4kg",299000,299000,0,0
TIKI,lam-dep-suc-khoe,12084610,"Kem Dưỡng Ẩm Cho Da Khô Và Nhạy Cảm Eucerin Lipo Balance (50ml)",199000,269000,70000,26
TIKI,lam-dep-suc-khoe,70809049,"TINH BỘT NGHỆ NGUYÊN CHẤT 100% ORGANIC TETE 500 gram",155000,155000,0,0
TIKI,lam-dep-suc-khoe,55613571,"Kem Chống Nắng Tế Bào Gốc Kiềm Dầu Chống Nhăn Dưỡng Ẩm Trắng Da Cellkey-Scien Multi Perfect Sun Cream SPF50+PA+++ (50ml)",405000,450000,45000,10
TIKI,lam-dep-suc-khoe,58962618,"Máy Massage Cầm Tay Đa Năng KINGTECH YT-1803 - Mát Xa Không Dây Toàn Thân - Giảm Đau Cơ, Cứng Khớp Cho Cổ, Vai Gáy, Lưng, Chân, Cánh Tay - Hỗ Trợ Giảm Béo Vòng Bụng - Hàng Chính Hãng",650000,1100000,450000,41
TIKI,lam-dep-suc-khoe,181097570,"Tinh Chất Dưỡng Sáng Da Laneige Radian-C Vitamin Spot Serum 10g",729000,750000,21000,3
TIKI,lam-dep-suc-khoe,57898727,"Khẩu Trang Y Tế Than Hoạt Tính TDCare 4 Lớp (40 Cái/Hộp)",39000,55000,16000,29
TIKI,lam-dep-suc-khoe,60684152,"Dầu Gội Hà Thủ Ô 2in1 Dành Riêng Cho TÓC BẠC Và RỤNG TÓC Cocayhoala Chai Lớn 450g Tiết Kiệm Hơn 1,5 lần",270000,450000,180000,40
TIKI,lam-dep-suc-khoe,176672117,"Sữa rửa mặt ngăn ngừa mụn dạng gel Acnes Gentle Wash 100g",56000,70000,14000,20
TIKI,lam-dep-suc-khoe,185260738,"Cây nặn mụn - nặn mụn đầu đen và các loại mụn 2 đầu",12000,19000,7000,37
TIKI,lam-dep-suc-khoe,212981943,"Keo Dán Móng Tay Loại Xịn Chuyên Dùng Cho Tiệm Nail, Dùng Gia Đình Với Chất Lượng Vượt Trội",33000,33000,0,0
TIKI,lam-dep-suc-khoe,70662253,"Kem Chống Nắng Không Màu Kiểm Soát Dầu La Roche-Posay Anthelios XL Dry Touch Gel-Cream SPF 50+ UVB & UVA (50ml)",420000,560000,140000,25
TIKI,lam-dep-suc-khoe,26115522,"Viên uống Bổ Sung Kẽm DHC ZinC Nhật Bản",189000,210000,21000,10
TIKI,lam-dep-suc-khoe,111937524,"Betaclor® Austria Viên đặt phụ khoa, Giải Pháp Toàn Diện Bệnh Phụ Khoa: Viêm Phụ Khoa, Nấm Candida, Tăng Tiết Dịch Nhầy Bôi Trơn. Viên Đặt Se Khít Tái Tạo Phục Hồi Niêm Mạc, Ngừa Teo Hoá, Cân Bằng pH Lợi Khuẩn. Nhập Khẩu Nguyên Hộp Austria Châu Âu",259000,339000,80000,24
TIKI,lam-dep-suc-khoe,56794260,"Bộ 3 kem đánh răng Colgate ngừa sâu răng răng chắc khỏe 225g/ tuýp tặng bàn chải lông tơ cao cấp Thái Lan",173000,173000,0,0
TIKI,lam-dep-suc-khoe,67017650,"Combo 6 Băng vệ sinh Diana Siêu thấm Cool Fresh Siêu mỏng Cánh gói 8 miếng",125000,138000,13000,9
TIKI,lam-dep-suc-khoe,158772428,"Máy massage mini cầm tay CTFAST-720: Mát xa 6 cấp độ, hỗ trợ maassage chuyên sâu, giảm đau cơ, cứng khớp hiệu quả nhanh chóng, đi kèm 4 đầu chuyên dụng - Quà tặng cho sức khỏe",390000,549000,159000,29
TIKI,lam-dep-suc-khoe,53923837,"Tinh chất dưỡng the Ordinary Hyaluronic Acid 2 % + B5",268000,285000,17000,6
TIKI,lam-dep-suc-khoe,52216318,"Combo 3 Kem Đánh Răng Closeup Dạng Gel Trắng Răng Diamond Attraction Ngay Sau 1 Lần Chải 100G/Tuýp",117000,117000,0,0
TIKI,lam-dep-suc-khoe,385568,"Bao cao su Durex Fetherlite Hộp 3 Bao",61000,69000,8000,12
TIKI,lam-dep-suc-khoe,81517203,"Máy Massage Mặt Làm Đẹp Da 5 in 1 Photon Nóng Và Lạnh EMS Giúp Nâng Cơ Mặt, Rửa Sạch Sâu, Tăng Cường Hấp Thụ Và Khóa Giữ Tinh Chất Dưỡng Da Kèm Máy Massage Mắt Loại Quầng Thâm ",1388000,1388000,0,0
TIKI,lam-dep-suc-khoe,63793228,"Máy Khuếch Tán Tinh Dầu Siêu Âm Loại Lớn có Đèn LED đổi màu Và Remote Điều Khiển Cao Cấp",154000,338000,184000,54
TIKI,lam-dep-suc-khoe,93514280,"Máy Massage Cầm Tay Đa Năng Cao Cấp KINGTECH LUX-900 - Mát Xa Toàn Thân, Chuyên Sâu Cho Lưng, Cổ, Vai, Gáy Cánh Tay - Chính Hãng",1100000,1750000,650000,37
TIKI,lam-dep-suc-khoe,183558378,"Xịt Khử Mùi Hôi Nách SAKITO LANCEJ - Khử Mùi Hôi Nách, Hôi Chân, Thâm Nách, Ra Mồ Hôi Nách - Thành Phần Từ Thiên Nhiên | Dung Tích 50ml - HÀNG CHÍNH HÃNG",90000,180000,90000,50
TIKI,lam-dep-suc-khoe,15520057,"Tinh chất chống lão hóa Hada Labo Pro Anti Aging α Lifting Essence 30g",258000,322000,64000,20
TIKI,lam-dep-suc-khoe,1521643,"Xịt Khoáng Avène Thermal Spring Water 100715921 (300ml)",339000,424000,85000,20
TIKI,lam-dep-suc-khoe,44810580,"Bộ Dầu Gội Xả Hỗ Trợ Trị Rụng Tóc Kích Thích Mọc Tóc Weilaiya Tinh Chất Gừng Hà Thủ Ô Cao Cấp Ngăn Ngừa Rụng Tóc Lưu Thông Mạch Máu Hương Thảo Dược (Gội 400ml- Xả:250ml)- Sản Phẩm Chính Hãng",550000,685000,135000,20
TIKI,lam-dep-suc-khoe,78509478,"Combo 3 Tinh Dầu Oải Hương + Tinh Dầu Bạc Hà + Tinh Dầu Vỏ Quế Nguyên Chất - Tinh Dầu TIDAMO Cao Cấp Xông Phòng Giúp Thư Giãn, Thơm Phòng Và Nâng Cao Sức Khỏe (3 chai 10ML)",84000,236000,152000,64
TIKI,lam-dep-suc-khoe,878393,"Tỏi Kim Cương Đông Á túi 500g- Tỏi đen cô đơn SX theo công nghệ Nhật Bản -Kiểm nghiệm chất lượng bởi Bộ Y Tế, Intertek",495000,560000,65000,12
TIKI,lam-dep-suc-khoe,108535216,"Bao cao su Sagami Superthin - Mỏng - Kiểu truyền thống - Hộp 2 chiếc",32000,35000,3000,9
TIKI,lam-dep-suc-khoe,175814174,"Khẩu Trang Y Tế Hàn Quốc KF94 Chính Hãng ANYGUARD, Lọc Bụi Mịn lên tới PM 2.5, 4 Lớp Ngăn 99% Vi Khuẩn, An Toàn Cho Da Nhạy Cảm (Hộp 20 Chiếc), Dành Cho Người Lớn",130000,130000,0,0
TIKI,lam-dep-suc-khoe,33606875,"Sữa rửa mặt trị mụn và se khít lỗ chân lông Paula’s Choice Clear Pore Normalizing Cleanser 177 ml",579000,579000,0,0
TIKI,lam-dep-suc-khoe,11588613,"[HSD 12/2024] Kẹo dẻo Vitamin C vị cam, tăng đề kháng, giảm cảm cúm, sáng da NAT C YUMMY GUMMYZ (Hộp 25 gói x 2 viên) (Hộp 50 viên)",118000,140000,22000,16
TIKI,lam-dep-suc-khoe,92454199,"Máy xông tinh dầu mẫu mới công nghệ hiện đại mã máy DK-BN NEW - Hình Bí ngô viền trắng - Hàng nhập khẩu - chế độ phun mạnh - khuếch tán tinh dầu trong không gian rộng",206000,349000,143000,41
TIKI,lam-dep-suc-khoe,58530142,"Kem Dưỡng Trắng Da Ban Đêm Oribe Dưỡng Ẩm Làm Mờ Thâm Nám Làm Mờ Tàn Nhang 30g",280000,320000,40000,13
TIKI,lam-dep-suc-khoe,170066594,"Combo 3 Hộp Khẩu trang Bông Bạch Tuyết 3 lớp trắng (50 cái/hộp)",177000,177000,0,0
TIKI,lam-dep-suc-khoe,158849015,"Xịt thơm miệng Nerman Cool Smile 2 hương Ice Coffee & Lemon Ice 10ml/chai",169000,210000,41000,20
TIKI,lam-dep-suc-khoe,124229151,"Bao Cao Su LifeStyles Love Time Cao Cấp Kéo Dài Thời Gian Hộp 3 bao",42000,50000,8000,16
TIKI,lam-dep-suc-khoe,68176012,"Khẩu trang than hoạt tính GP Extreme (Mẫu mới, nhiều màu để lựa chọn)",50000,50000,0,0
TIKI,lam-dep-suc-khoe,19901553,"Máy Rửa Mặt Halio Sensitive Facial Device Dành Cho Da Nhạy Cảm - Sóng Âm Sạch Sâu, Kèm Hộp Treo",699000,849000,150000,18
TIKI,lam-dep-suc-khoe,1313881,"Kem chống nắng Skin Aqua dưỡng trắng & dưỡng ẩm, dùng hàng ngày dạng gel Sunplay Skin Aqua Silky White Gel Eco Việt Nam SPF 50, PA++++ 30g",89000,109000,20000,18
TIKI,lam-dep-suc-khoe,21155024,"Dầu hấp ủ tóc siêu mượt Karseell Maca Essence Repair Collagen (dạng túi) 500ml",190000,190000,0,0
TIKI,lam-dep-suc-khoe,7690641,"Thiên Môn Bổ Phổi Bình Đông – Giúp giảm ho, Bổ phổi – Chai 280ml",74000,74000,0,0
TIKI,lam-dep-suc-khoe,94098195,"Khẩu trang 4D kháng khuẩn Hello Mask Fashion - Premium",45900,45900,0,0
TIKI,lam-dep-suc-khoe,141740797,"Kem đánh răng Colgate ngừa sâu răng tối đa 225g tặng bàn chải",58000,58000,0,0
TIKI,lam-dep-suc-khoe,13933311,"Kem Nghệ Dưỡng Da Mụn Thorakao 7g ",31000,31000,0,0
TIKI,lam-dep-suc-khoe,204009169,"Dung dịch vệ sinh nam Bergami for Man - Ngăn mùi suốt 12h",65000,100000,35000,35
TIKI,lam-dep-suc-khoe,12146976,"EUCERIN GEL RỬA MẶT DÀNH CHO DA NHỜN MỤN EUCERIN PROACNE CLEASING 200ML",276000,369000,93000,25
TIKI,lam-dep-suc-khoe,85701615,"KỀM CẮT DA INOX",165000,165000,0,0
TIKI,lam-dep-suc-khoe,195210591,"Tinh dầu Bưởi Ngọt 24Care 100ML - Chiết xuất thiên nhiên, khử mùi, thơm phòng, thư giãn tinh thần",75000,75000,0,0
TIKI,lam-dep-suc-khoe,89128457,"Máy mài gót chân USB kèm đầu mài (giao màu ngẫu nhiên )",74999,74999,0,0
TIKI,lam-dep-suc-khoe,82721610,"Máy Tăm Nước LocknLock Oral Irrigator ENR111BLU - Màu Xanh Dương",939000,1584000,645000,41
TIKI,lam-dep-suc-khoe,116369227,"Khẩu trang 3D mask Long Hưng công nghệ Nhật Bản chống bụi mịn cao cấp hộp đóng 50 cái",48000,65000,17000,26
TIKI,lam-dep-suc-khoe,109691576,"Máy rửa mặt sóng âm Xiaomi inFace MS2000pro (Gen 2) - Hàng chính hãng",349000,349000,0,0
TIKI,lam-dep-suc-khoe,89792676,"Dung Dịch Vệ Sinh Phụ nữ Lactacyd Odor Fresh Ngăn Mùi 24H 250ml",79000,89000,10000,11
TIKI,lam-dep-suc-khoe,201816436,"Bàn Chải Điện Halio Sonic Whitening Toothbrush Pro",1079000,1550000,471000,30
TIKI,lam-dep-suc-khoe,52637902,"Dầu Gội Sạch Gàu Antisol pH6.5 Chiết Xuất Dược Liệu Ngăn Ngừa Gàu, Rụng Tóc, Ngứa Da Đầu Tái Phát - Chai 240ml - Thương Hiệu iCare Pharma",283000,320000,37000,12
TIKI,lam-dep-suc-khoe,158138623,"Khẩu Trang KF94 4D SKY MASK Hàn Quốc - Chống Bụi Mịn Và Kháng Khuẩn (1 gói 10 cái) - Chọn màu",8800,8800,0,0
TIKI,lam-dep-suc-khoe,21024823,"Gel nghệ Nano siêu hấp thu Decumar New (20g) - Ngừa mụn, Giảm thâm sẹo, Kiểm soát nhờn",75000,75000,0,0
TIKI,lam-dep-suc-khoe,91864374,"Set 5 Cây Son Kem Lì VONGEE Mịn Mượt Như Nhung Và Không Khô Môi",59000,95000,36000,38
TIKI,lam-dep-suc-khoe,105618884,"Tinh Dầu Xông Phòng Chai Lớn 100ML, Tự Chọn Mùi | Chính Hãng TIDAMO, Chiết xuất Tự Nhiên, Có Kiểm Nghiệm | Xông Thơm Phòng, Thư Giãn và Bảo Vệ Sức Khỏe",119000,356000,237000,67
TIKI,lam-dep-suc-khoe,140586253,"INFLUPROP Austria, Nasal Spray Dung dịch xịt sương giúp hỗ trợ điều trị viêm xoang, viêm mũi,  phòng ngừa vi khuẩn, virus, tạo màng niêm mạc bảo vệ lành nhanh vết thương, dưỡng ẩm, chống ngạt sổ mũi, ngưng chảy dịch mũi. Nhập khẩu Châu Âu",246050,259000,12950,5
TIKI,lam-dep-suc-khoe,23368395,"Bộ 3 Cây Que Nặn Mụn Bằng Thép Cao Cấp Không Gỉ Gồm 5 Đầu Chuyên Dụng  Có Nhíp Gắp Cực Kì An Toàn (Full Box) - MP041",52600,52600,0,0
TIKI,lam-dep-suc-khoe,164880017,"Viên uống tinh dầu bạc hà, thì là, cải thiện tiêu hóa, giảm đau bụng, khó tiêu, đầy hơi UNOMINT Mega We Care (10 viên)",50000,60000,10000,17
TIKI,lam-dep-suc-khoe,129521118,"Kem Dưỡng Da Mờ Thâm Nám, Tàn Nhang Fixderma Skarfix-TX Cream 15g",220000,275000,55000,20
TIKI,lam-dep-suc-khoe,55108911,"Combo 2 Sữa Tắm Rose 500ml- L'amont En Provence",189000,298000,109000,37
TIKI,lam-dep-suc-khoe,186633014,"Tinh Dầu Sả Chanh Tự Nhiên Nguyên Chất 10ml Hapaku",109000,120000,11000,9
TIKI,lam-dep-suc-khoe,20365497,"Dụng cụ massage Mũi xuất Nhật , nâng mũi tự nhiên, cánh mũi thon gọn SLine hotgirl",9000,9000,0,0
TIKI,lam-dep-suc-khoe,25444067,"Son kem lì Bbia Last Velvet Lip Tint - 25 Final Note 5g (màu cam nâu đất)",150000,290000,140000,48
TIKI,lam-dep-suc-khoe,7331189,"Son Dưỡng Môi DHC Lip Cream 1,5g",182000,199000,17000,9
TIKI,lam-dep-suc-khoe,28517939,"Viên uống Tinh Chất Hàu biển OB - Tăng cường sinh lý nam, Bổ Thận, Tăng Chất Lượng Tinh Trùng, hộp 30v",329000,379000,50000,13
TIKI,lam-dep-suc-khoe,153597872,"Son thỏi dưỡng môi trang điểm chất son satin Lip On Lip Glowy Satin 2.2g",133000,166000,33000,20
TIKI,lam-dep-suc-khoe,57855825,"Kem Nền Che Khuyết Điểm Kiềm Dầu Mịn Nhẹ Chống Nắng DD Cream Oribe 25g",280000,320000,40000,13
TIKI,lam-dep-suc-khoe,50308042,"Goodhealth Oyster Plus Tinh Chất Hàu 60 Viên - Tăng Cường Sinh Lý - Cải Thiện Chất Lượng Tinh Trùng - Hàng Chính Hãng New Zealand",405000,650000,245000,38
TIKI,lam-dep-suc-khoe,48209944,"Bộ sản phẩm tan mỡ bụng an toàn và hiệu quả Truesky gồm 1 kem tan mỡ bụng quế gừng 100g + 1 đại nịt bụng quấn nóng",250000,250000,0,0
TIKI,lam-dep-suc-khoe,157548456,"Viên Uống Xuyên Tâm Liên Bổ Phổi Giảm Ho Đờm Ho Khan Đau Rát Họng Xuyên Tâm Huyền Thảo ( Hộp 30 viên )",89000,163350,74350,46
TIKI,lam-dep-suc-khoe,460386,"Sữa Tắm Lifebuoy Sạch Khuẩn Chăm Sóc Da Ngăn Ngừa Vi Khuẩn Lây Lan Với Ion Bạc+ Hỗ Trợ Cùng Đề Kháng Da Tự Nhiên Túi 800G",119000,119000,0,0
TIKI,lam-dep-suc-khoe,138773725,"￼Bộ 4 lô Cuốn Tóc Xoăn Dính loại lớn, giá tốt - giao màu ngẫu nhiên ",40000,40000,0,0
TIKI,lam-dep-suc-khoe,102751945,"Dầu gội Head&shoulders Clinical Strength Proven Relief 400ml - USA",299000,299000,0,0
TIKI,lam-dep-suc-khoe,74593902,"ComBo 10 Chiếc Khẩu Trang Trẻ Em KF94 - Form 3D Cao Cấp Chống Bụi Siêu Mịn 0.4um Anyguard Hàn Quốc Chính Hãng - 4 Lớp - 베이비 마스크 - Face Mask For Kids-ISO 9001:2015, ISO 13485:2016, QCVN 01:2017/BTC",51000,85000,34000,40
TIKI,lam-dep-suc-khoe,12056666,"Lăn Khử Mùi Etiaxil Detranspirant Traitement Aisselles Peaux Normales 15ml (Dành cho da thường)",195000,350000,155000,44
TIKI,lam-dep-suc-khoe,158091977,"Tinh Dầu Hoa Nhài TIDAMO 100ML Nhập Khẩu, Có Kiểm Nghiệm, Hương Thơm Dịu Nhẹ Quý Phái - Tinh Dầu Hoa Lài (Jasmine) Xông Thơm Phòng, Thư Giãn và Tốt Cho Sức Khỏe",193800,398000,204200,51
TIKI,lam-dep-suc-khoe,2623229,"Sữa Rửa Mặt SVR Sebiaclear Gel Moussant  (50ml)",145000,145000,0,0
TIKI,lam-dep-suc-khoe,184042484,"Combo Sữa Rửa Mặt và Serum Mugung Dưỡng da 24k xóa thâm nám chống lão hóa chứa Vitamin C,E, collagen",400000,400000,0,0
TIKI,lam-dep-suc-khoe,74402547,"ComBo (30 Chiếc) Khẩu Trang 2D Hàn Quốc Anyguard Chính Hãng - Dành Cho Người Lớn (10 gói) - Quai Đeo Siêu Đàn Hồi, 3 Lớp Bảo Vệ Tối Ưu - ISO 9001:2015, ISO 13485:2016, QCVN 01:2017/BTC",100000,100000,0,0
TIKI,lam-dep-suc-khoe,2075159,"Gel hỗ trợ điều trị Mụn Thâm Neocurma (20g)",118000,118000,0,0
TIKI,lam-dep-suc-khoe,177424215,"Cân Điện Tử Sức Khoẻ Thông Minh Mặt Vuông Kính Cường Lực Chịu Lực Màu Đen Sang Trọng 180Kg Deli - Phù Hợp Gia Đình Trường Học - Hàng Chính Hãng - E86120",322200,322200,0,0
TIKI,lam-dep-suc-khoe,49310524,"Combo 2 tuýp  kem ngăn ngừa mụn thiên nhiên yoosun acnes  15g - XẸP MỤN NGAY, BAY THÂM SẸO ",79800,79800,0,0
TIKI,lam-dep-suc-khoe,12114846,"Xịt họng thảo dược giúp giảm ho, đau rát họng EUGICA MOUTH SPRAY (Chai/10ml)",58000,65000,7000,11
TIKI,lam-dep-suc-khoe,36158810,"Bộ tắm trắng toàn thân Truesky gồm 1 kem ủ trắng toàn thân 100g và 1 kem dưỡng trắng toàn thân 100g",320000,320000,0,0
TIKI,lam-dep-suc-khoe,2835905,"MỠ TRĂN NGUYÊN CHẤT 100ml triệt lông, bôi bỏng",88888,99000,10112,10
TIKI,lam-dep-suc-khoe,180236553,"Dung dịch vệ sinh phụ nữ Lagumi chiết xuất trầu không tràm trà giảm viêm, ngứa an toàn cho cả mẹ bầu và sau sinh 100ml",350000,350000,0,0
TIKI,lam-dep-suc-khoe,260847275,"Gel giảm sẹo lồi, phì đại Rejuvasil",615000,650000,35000,5
TIKI,lam-dep-suc-khoe,114467131,"Bộ dụng cụ lấy ráy tai chuyên nghiệp,dụng cụ lấy ráy tai người lớn,dụng cụ lấy ráy tai thông minh cho bé kèm dây đeo BaoAn- Nhiều mẫu lựa chọn -Hàng Chính Hãng - Màu hộp giao ngẫu nhiên",139000,139000,0,0
TIKI,lam-dep-suc-khoe,41523006,"Máy đo huyết áp điện tử bắp tay Sinoheart BA-801 Đức",269000,325000,56000,17
TIKI,lam-dep-suc-khoe,33761260,"Bao Cao Su Kéo Dài Thời Gian Quan Hệ và Có Gai Innova Đen - Hộp 3 Cái",39000,39000,0,0
TIKI,lam-dep-suc-khoe,173401401,"Máy Khuếch Tán Tinh Dầu Có Loa Bluetooth Nghe Nhạc Cực Hay, Máy Xông Tinh Dầu Chuyên Dụng, Có Remote Điều Khiển Và Đèn LED 7 Màu",287300,668000,380700,57
TIKI,lam-dep-suc-khoe,118896592,"Nến thơm tinh dầu cao cấp không khói an toàn Candle Cup - ĐÀ LẠT - S - 100G (KG NẮP)",120000,120000,0,0
TIKI,lam-dep-suc-khoe,190630654,"Sữa Rửa Mặt Dịu Nhẹ Cho Da Khô CeraVe SA Smoothing Cleanser 236ml",313000,330000,17000,5
TIKI,lam-dep-suc-khoe,75639107,"Nước súc miệng hàng ngày chiết xuất thiên nhiên giúp Ngăn ngừa vi khuẩn Ngăn ngừa màng bám Cải thiện viêm nướu, viêm nha chu AMFAGOLD Care DAILY USE 250ml",75000,75000,0,0
TIKI,lam-dep-suc-khoe,654647,"Nước uống giải rượu, thải độc gan Alcofree lốc 3 chai x 50ml",129000,141000,12000,9
TIKI,lam-dep-suc-khoe,7222235,"Kem chống nắng đa năng siêu nhẹ không bết dính Paula’s Choice Resist Super -Light Daily Wrinkle Defense SPF30 60ml",950000,950000,0,0
TIKI,lam-dep-suc-khoe,92159183,"Combo 2 hộp Bao cao su Durex Fetherlite Ultima 12 Bao",438000,608000,170000,28
TIKI,lam-dep-suc-khoe,253178501,"Kem tẩy lông cúc la mã UMIHA 80g dùng cho Bikini, Nách, Chân, Tay, Bụng, Ngực an toàn cho da nhạy cảm",151000,300000,149000,50
TIKI,lam-dep-suc-khoe,186270101,"Bộ đai chườm nóng thảo dược giảm đau vai gáy dùng điện - Hapaku",985000,1300000,315000,24
TIKI,lam-dep-suc-khoe,394686,"Nước Xịt Khoáng Evoluderm 400ml - 7084  ",189000,298000,109000,37
TIKI,lam-dep-suc-khoe,161451877,"Dung dịch vệ sinh mũi Nose Hygiene Spray",85000,85000,0,0
TIKI,lam-dep-suc-khoe,114230314,"Kem hỗ trợ giảm mụn Differin Cream 0.1% Adapalene tuýp 30 gram(Hàng nội địa Pháp)",299000,450000,151000,34
TIKI,lam-dep-suc-khoe,56104679,"Combo 2 Xịt toàn thân Romano Classic cổ điển lịch lãm 150ml",159000,206000,47000,23
TIKI,lam-dep-suc-khoe,132097368,"Nước Súc Miệng Giúp Nướu Chắc Khỏe Listerine Gum Protect Zero Alcohol - Dung Tich 250ml -750ml",71000,71000,0,0
TIKI,lam-dep-suc-khoe,933547,"Bao Cao Su Powermen Longer Plus Cá Ngựa Bạc (Hộp 3 Cái)",40000,50000,10000,20
TIKI,lam-dep-suc-khoe,176571783,"Hoạt huyết dưỡng não - Hộp 100 viên bao đường - tuần hoàn não, Dược Đại Uy, từ đinh lăng, bạch quả",15000,49000,34000,69
TIKI,lam-dep-suc-khoe,34345425,"Combo 10 Mặt nạ dưỡng ẩm trắng da giúp kiềm dầu và mụn Hàn Quốc Lagivado Hydra Calming Facial Mask 23g/miếng",350000,350000,0,0
TIKI,lam-dep-suc-khoe,104791199,"Collagen Viên Nhật Bản, Hỗ Trợ Ngăn Ngừa Lão Hóa Da, Giúp Tóc Móng Chắc Khỏe, Hộp 180 Viên",783000,935000,152000,16
TIKI,lam-dep-suc-khoe,91566964,"Chỉ nha khoa SGS nhập khẩu Hàn Quốc - 840D hương bạc hà",35000,70000,35000,50
TIKI,lam-dep-suc-khoe,977121,"Hộp 7 Nút Bịt Tai Đặc Biệt Blackout® Soft Foam Kèm Hộp Nhôm Mack's #987",239000,239000,0,0
TIKI,lam-dep-suc-khoe,11860156,"Viên uống Ngăn Rụng Tóc, Giúp Tóc Mọc Dày và Nhanh, Làm Đen Tóc Welhair for Women (Hộp 30 viên)",185000,320000,135000,42
TIKI,lam-dep-suc-khoe,166120705,"SPECIAL COMBO làm sạch da chết cơ thể và mặt từ cà phê Đắk Lắk Cocoon (tặng tẩy da chết môi cà phê Đắk Lắk 5g)",290000,290000,0,0
TIKI,lam-dep-suc-khoe,43754492,"Kem bôi da Thuần Mộc Thanh Mộc Hương mẫu mới",105000,105000,0,0
TIKI,lam-dep-suc-khoe,52109447,"Bộ Kềm Cắt Móng 12 Món Tiện Dụng",37999,37999,0,0
TIKI,lam-dep-suc-khoe,69463660,"Máy xông tinh dầu sóng siêu âm cao cấp vân gỗ - Có Remote. Máy khuếch tán tinh dầu giúp tỏa hương, tạo độ ẩm, làm thơm phòng",219000,468000,249000,53
TIKI,lam-dep-suc-khoe,14772735,"Nhiệt kế điện tử hồng ngoại đo trán, đo nhiệt độ phòng và nước  ",749000,749000,0,0
TIKI,lam-dep-suc-khoe,70662873,"Gel rửa mặt tạo bọt làm sạch & giảm nhờn cho da dầu nhạy cảm La Roche-Posay Effaclar Purifying Foaming Gel (200ml)",328000,410000,82000,20
TIKI,lam-dep-suc-khoe,194468327,"Máy khuếch tán/ máy xông tinh dầu Lorganic hình Núi Caro FX2079 + tinh dầu sả chanh 10ml/ Công nghệ hiện đại (tích hợp remote)/ Thích hợp xông  phòng 15-40m2",275000,500000,225000,45
TIKI,lam-dep-suc-khoe,174481487,"[COMBO 2 HỘP KHÔNG ĐƯỜNG] Kẹo ngậm Viacol Vietnat 20 viên - gừng Vietnat 20 viên giảm ho rát họng",63406,64700,1294,2
TIKI,lam-dep-suc-khoe,80932490,"Túi Chườm Nóng Lạnh Đa Năng Hình Con Vật Hoạt Hình Dễ Thương - Chườm Bụng Cho Các Nàng Khi Đau Bụng Kinh Nguyệt 500ml – Tặng Kèm 1 Móc Khóa Hình Vịt Vàng ( Bình Chườm Bên Trong Giao Màu Ngẫu Nhiên)",109000,109000,0,0
TIKI,lam-dep-suc-khoe,56372720,"DAO CẠO RÂU 36 LƯỠI tặng kèm 1 dao cạo + 1 tuýp kem cạo râu",27000,27000,0,0
TIKI,lam-dep-suc-khoe,136049636,"Tinh Dầu Lavender 30ML Nhập Khẩu Cao Cấp - Tinh Dầu Oải Hương TIDAMO Xông Phòng Thư Giãn, Bảo Vệ Sức Khỏe",78000,176000,98000,56
TIKI,lam-dep-suc-khoe,36966404,"Gương Soi Trang Điểm Để Bàn - GU34 (Giao ngẫu nhiên mẫu)",20000,20000,0,0
TIKI,lam-dep-suc-khoe,178559959,"Sữa Rửa Mặt Nghệ Nhân Sâm MELA Dịu Nhẹ Lành Tính, Hỗ Trợ Làm Sáng Da 200ml - ML08",180000,180000,0,0
TIKI,lam-dep-suc-khoe,77156720,"Sữa Tắm Dưỡng Ẩm Trắng Da Hatomugi Xanh 600ml",119000,126000,7000,6
TIKI,lam-dep-suc-khoe,172368164,"Cồn Sát Khuẩn 70 Độ Hoàng Long (Can 3.8L)",160000,160000,0,0
TIKI,lam-dep-suc-khoe,197605473,"Bộ 02 Mặt nạ tóc Tsubaki Phục hồi tóc hư tổn 180G",349000,590000,241000,41
TIKI,lam-dep-suc-khoe,12351495,"Thực Phẩm Chức Năng Nhân Sâm Cá Ngựa 30P - Tăng Cường Sinh Lực, Sinh Lý Nam Giới (Chai 30 viên)",158800,158800,0,0
TIKI,lam-dep-suc-khoe,15063796,"Combo Hộp 50 que thử đường huyết và 50 kim lấy máu cho máy đo đường huyết Sinocare Safe - Accu",160000,160000,0,0
TIKI,lam-dep-suc-khoe,133158593,"Tinh dầu Trà Trắng Oricen 10ml",110000,110000,0,0
TIKI,lam-dep-suc-khoe,139135659,"Kẹo ngậm Viasol húng chanh Vietnat giảm ho ấm họng - hộp 100 viên",49500,49500,0,0
TIKI,lam-dep-suc-khoe,72912939,"Nước dưỡng ẩm & làm sáng da Reihaku Hatomugi Lotion (1000ml)",233100,233100,0,0
TIKI,lam-dep-suc-khoe,10091481,"Túi Chườm nóng lạnh Đa Năng Hướng Dương cỡ lớn (37 x 26 x 7 cm)",123000,123000,0,0
TIKI,lam-dep-suc-khoe,52629204,"Máy rửa mặt làm sạch bụi bẩn, bã nhờn và lớp trang điểm thừa có khả năng massage kích thích tuần hoàn máu - Giao màu ngẫu nhiên",38000,75000,37000,49
TIKI,lam-dep-suc-khoe,75436781,"Son kem lì Bbia Last Velvet Lip Tint Version 8 5g (5 màu)",150000,290000,140000,48
TIKI,lam-dep-suc-khoe,3844939,"Cao Hồng Sâm Sobeak 6 Năm Tuổi Hàn Quốc (240g x 2 hũ)",650000,650000,0,0
TIKI,lam-dep-suc-khoe,58214750,"Khẩu trang y tế 4D 4 lớp cao cấp Hamita - Bịch 1 cái - ISO13485, Dấu CE - Sử dụng giấy kháng khuẩn cao cấp Mealtblown, hiệu quả lọc kháng khuẩn giữ nguyên 99.9% sau 5 lần giặt",9000,9000,0,0
TIKI,lam-dep-suc-khoe,7677552,"Thực phẩm bảo vệ sức khỏe Viên dầu cá Kirkland Signature Fish Oil 1000mg từ Mỹ, bổ sung Omega-3, DHA và EPA - 400 Viên",776000,1552000,776000,50
TIKI,lam-dep-suc-khoe,247965266,"Collagen cho nam Youtheory Mỹ hỗ trợ sức khỏe tổng thể cho:xương khớp, da, móng, gân, dây chằng, cơ bắp, tim mạch và tăng sức đề kháng-Massel Official",618000,1254000,636000,51
TIKI,lam-dep-suc-khoe,24685119,"Que Thử Đường Huyết Safe Accu Sinocare 50 Que + 50 Kim Chích Máu",160000,160000,0,0
TIKI,lam-dep-suc-khoe,174509075,"[COMBO 3 HỘP] Kẹo ngậm Viatux Extra Vietnat giảm ho khàn tiếng - 30 viên/ hộp",90750,90750,0,0
TIKI,lam-dep-suc-khoe,8729465,"Tẩy Tế Bào Da Chết Chiết Xuất Từ Than Hoạt Tính ARRAHAN CHARCOAL PEELING GEL (180ml)",62000,62000,0,0
TIKI,lam-dep-suc-khoe,10278480,"Nước uống collagen giúp sáng da, dạ dày khỏe Blossomy lốc 03 chai x 50ml",164000,165000,1000,1
TIKI,lam-dep-suc-khoe,89204299,"Cao dán hồng sâm Hàn Quốc",49000,80000,31000,39
TIKI,lam-dep-suc-khoe,262899667,"Glucosamine 1500mg Chondroitin 1200mg Kirkland Signature  - Phục hồi sụn khớp, Giảm đau nhức xương khớp và Hỗ trợ sự vận động linh hoạt hiệu quả - QuaTangMe Extaste",655000,1310000,655000,50
TIKI,lam-dep-suc-khoe,112976646,"Tinh Dầu Khuếch Hương DAILY COMMA Crystal Hologram Diffuser 100ML (MẪU MỚI NHẬP KHẨU)",135000,270000,135000,50
TIKI,lam-dep-suc-khoe,55506863,"Hộp 50 cái khẩu trang y tế 4 lớp VN Number One",30000,30000,0,0
TIKI,lam-dep-suc-khoe,911351,"Kem Hỗ Trợ Giảm Mụn Ngừa Thâm Liền Sẹo Ori'be Chiết Xuất Tảo Nâu Từ Pháp Tuýp 20g",66000,80000,14000,18
TIKI,lam-dep-suc-khoe,55108935,"Combo 2 Sữa Tắm Mimosa 500ml - L'amont En Provence",189000,298000,109000,37
TIKI,lam-dep-suc-khoe,128934972,"Nước Đông Trùng Hạ Thảo 60 Gói Deadong Hàn Quốc ",1418000,1500000,82000,5
TIKI,lam-dep-suc-khoe,58880438,"Nhiệt Kế Hồng Ngoại , Đo Không Tiếp Xúc - Cảnh Báo Sốt -- Tặng Kèm 1 Cặp Pin ",173900,173900,0,0
TIKI,lam-dep-suc-khoe,271299398,"Collagen Neocell Types 1 & 3 Mỹ Hỗ trợ cang da, giảm nhăn da, giúp da, tóc, móng tay và khớp khỏe mạnh từ bên trong ra ngoài - Massel Official",681000,1362000,681000,50
TIKI,lam-dep-suc-khoe,22983097,"Sáp tạo kiểu tóc nam cứng mờ Aurane Cool Stylish Clay 80ml",122000,135000,13000,10
TIKI,lam-dep-suc-khoe,74989524,"Máy Xông Tinh Dầu Cao Cấp + Tinh Dầu Sả Chanh Nguyên Chất Nhập Khẩu, Máy Khuếch Tán Tinh Dầu Chuyên Dụng, Họa Tiết Sang Trọng và Đèn LED Biến Đổi Màu Cực Đẹp (họa tiết ngẫu nhiên)",287300,676000,388700,58
TIKI,lam-dep-suc-khoe,127515106,"Hỗ trợ mọc tóc Natrol Biotin Beauty giúp tóc mọc nhanh dài, dày hơn, làn da rạng rỡ và móng tay chắc khỏe - OZ Slim Store",259000,646000,387000,60
TIKI,lam-dep-suc-khoe,108928188,"Bộ Sản Phẩm Dưỡng Tóc và Ngăn Rụng Tóc Thiên Nhiên Hoàn Hảo Từ Thorakao: Combo 2 Chai Dầu Gội và Xả Hoa Bưởi 400ml + 1 Chai Lotion Tinh Dầu Bưởi 150ml ",348800,348800,0,0
TIKI,lam-dep-suc-khoe,116418824,"Gel ngừa mụn Nano THC Decumar 20gr làm sáng da mụn viêm thâm",120000,120000,0,0
TIKI,lam-dep-suc-khoe,58601328,"Viên uống Vitamin tổng hợp cho Nam - One a day Men's Multivitamin 300 viên mẫu mới",630000,630000,0,0
TIKI,lam-dep-suc-khoe,95975019,"Nước Uống Tăng Lực Hồng Sâm Won KGC Cheong Kwan Jang 100ml x 10 Chai",280000,300000,20000,7
TIKI,lam-dep-suc-khoe,195559389,"Kem dưỡng cấp ẩm ban đêm Neutrogena® Hydro Boost Hyaluronic Acid Night Cream 50g",344000,440000,96000,22
TIKI,lam-dep-suc-khoe,176910167,"Bộ 24 móng tay giả cao cấp MJ069 (Kèm keo+ dũa móng tay+ miếng dán móng tay)",25000,25000,0,0
TIKI,lam-dep-suc-khoe,68005401,"Combo 2 Sữa tắm nước hoa dưỡng da Enchanteur Charming 650gr/ Chai",313000,392000,79000,20
TIKI,lam-dep-suc-khoe,188767619,"Dầu gội phủ bạc Mochi Nhật Bản (Lược chải & vòi nhấn). Dầu gội nhuộm tóc thảo dược ngay tại nhà",249000,249000,0,0
TIKI,lam-dep-suc-khoe,152097308,"Bông tẩy trang ipek thỗ nhĩ kì 130 miếng",26900,39800,12900,32
TIKI,lam-dep-suc-khoe,128756250,"MUSK KHẨU TRANG Y TẾ 5 LỚP N95 / FFP2 Nhập Khẩu Châu Âu Turkey, Phòng Tránh Lây Nhiễm Vi Khuẩn, Virus, Bệnh Hô Hấp, Hoá Chất, Phòng Thí Nghiệm, Bệnh Viện, Môi Trường Y Tế, Bụi Khuẩn Độc Hại. LỌC VI KHUẨN, VIRUS 99%. Hộp 10 Chiếc Màu Trắng",98000,160000,62000,39
TIKI,lam-dep-suc-khoe,112998207,"Son Môi M.O.I Nhung Lì Sgirl SUMMER EDITION Hồ Ngọc Hà (2021)",199000,299000,100000,33
TIKI,lam-dep-suc-khoe,4423491,"Thực Phẩm Chức Năng Dầu Cá Omega 3 Orihiro Nhật Bản 180 Viên",324000,352800,28800,8
TIKI,lam-dep-suc-khoe,108535212,"Bao cao su Sagami Miracle - Thiết kế 3D - Ôm khít - Size 49 mm - Hộp 10 chiếc",95000,120000,25000,21
TIKI,lam-dep-suc-khoe,20649902,"Kem Chống Nắng Cho Mọi Loại Da Cell Fusion C Laser Sunscreen 100 SPF 50+/PA+++ (50ml)",345000,450000,105000,23
TIKI,lam-dep-suc-khoe,4613079,"Thực phẩm chức năng Giấm Đen Giảm Cân Orihiro Nhật Bản 216 Viên",164000,189000,25000,13
TIKI,lam-dep-suc-khoe,173744230,"[CHÍNH HÃNG] Một thùng 200 CÁI, màu trắng, khẩu trang 4 lớp KF94 kháng khuẩn, chống bụi mịn, công nghệ 4D Hàn Quốc",156000,215000,59000,27
TIKI,lam-dep-suc-khoe,76110606,"Gương trang điểm để bàn cao cấp gương soi di động bằng gỗ xoay gập tiện lợi phong cách châu Âu - Tặng 1 băng đô trang điểm vải nhung màu ngẫu nhiên",25000,25000,0,0
TIKI,lam-dep-suc-khoe,15149797,"Bàn Lăn Chân Gỗ Massage 6 Hàng ( 31 X 24 X 10 Cm)",178000,178000,0,0
TIKI,lam-dep-suc-khoe,104190749,"Viên uống bổ sung kẽm DHC Nhật Bản thực phẩm chức năng Zinc giúp ăn ngon miệng, dưỡng tóc và móng khỏe, giảm mụn, hỗ trợ sinh lý nam 30 ngày JN-DHC-ZIN30",95000,95000,0,0
TIKI,lam-dep-suc-khoe,59130762,"Lược Tròn Tạo Phồng ,Uốn Cụp Kiểu Hàn Quốc- Đa Năng",23000,30000,7000,23
TIKI,lam-dep-suc-khoe,75617844,"Combo 2 gói dầu gội xả phục hồi tóc hư tổn RRline Macadamia Star 30ml",47500,50000,2500,5
TIKI,lam-dep-suc-khoe,50700390,"Kem Dưỡng Phục Hồi Da Tổn Thương Bioderma Cicabio Crème - 40ml",345000,345000,0,0
TIKI,lam-dep-suc-khoe,12084496,"Gel Rửa Mặt Trị Mụn Loại Bỏ Nhờn Ngừa Mụn Eucerin (200ml)",276000,369000,93000,25
TIKI,lam-dep-suc-khoe,70052293,"Combo máy khuếch tán/ máy xông tinh dầu Lorganic bình hoa FX2057 + tinh dầu bạch đàn chanh Lorganic (10ml) LGN0366",300000,600000,300000,50
TIKI,lam-dep-suc-khoe,559949,"Serum Dew&Dew Vitamin C Treatment Serum - DEW&DEW03 - 50ml",146300,235000,88700,38
TIKI,lam-dep-suc-khoe,140333343,"Serum dưỡng hồng môi và căng mọng Lipstician Lip Serum Youth Booster 9g",320000,399000,79000,20
TIKI,lam-dep-suc-khoe,64994332,"MÁY XÔNG TINH DẦU CAO CẤP CHUYÊN DỤNG CHO PHÒNG LỚN, CÓ ĐIỀU KHIỂN TỪ XA, ĐÈN LED TRANG TRÍ RẤT ĐẸP",184000,398000,214000,54
TIKI,lam-dep-suc-khoe,173989703,"Sáp Tạo Kiểu Nam Gatsby Styling Giữ Nếp Tóc Cá Tính Full Màu - Tặng móc khoá chính hãng",28000,28000,0,0
TIKI,lam-dep-suc-khoe,5136709,"Kem chống nắng Fixderma Shadow SPF 50+ Cream (75g)",190000,190000,0,0
TIKI,lam-dep-suc-khoe,37153816,"Viên Uống Bổ Gan Kanzo Ukon Genki Fami Nhật Bản, Hỗ Trợ Giải Độc, Tăng Cường Chức Năng Gan (90 viên/30 ngày)",766000,830000,64000,8
TIKI,lam-dep-suc-khoe,76134414,"[HỘP - FAMAPRO VN95] - Khẩu trang y tế kháng khuẩn 4 lớp Famapro VN95 đạt chuẩn N95 (10 cái/ hộp)",11500,17000,5500,32
TIKI,lam-dep-suc-khoe,72082648,"Mật ong thiên nhiên nguyên chất Hoa Cà Phê ( MS) - ( 700G)",125000,145000,20000,14
TIKI,lam-dep-suc-khoe,74625269,"Gel chấm mụn, mờ thâm Oxy Anti-Acne Spot Gel 10g",78000,78000,0,0
TIKI,lam-dep-suc-khoe,270548993,"Dầu Cá Omega 3 Kirkland Signature Fish Oil Bổ não, bổ mắt, Hỗ trợ sức khỏe tim mạch, khớp - QuaTangMe Extaste",776000,1552000,776000,50
TIKI,lam-dep-suc-khoe,3415803,"Bông Tăm Kháng Khuẩn Jomi (160 Que)",26000,33000,7000,21
TIKI,lam-dep-suc-khoe,119251217,"Sữa rửa mặt dịu lành cho da nhạy cảm Cetaphil Gentle Skin Cleanser 125ml",154000,162000,8000,5
TIKI,lam-dep-suc-khoe,186309376,"Gối chườm nóng thảo dược đa năng cho vùng cổ, lưng bụng, đầu gối, giảm nhức mỏi, thư giãn, gối ngủ ngon dùng lò vi sóng làm nóng - Hapaku",249000,430000,181000,42
TIKI,lam-dep-suc-khoe,160446272,"Dầu gội khô COLAB hương Extreme Volume 200ml",195000,195000,0,0
TIKI,lam-dep-suc-khoe,73346761,"Sáp vuốt tóc BY VILAIN GOLD DIGGER 65 ml",419000,419000,0,0
TIKI,lam-dep-suc-khoe,196892106,"Máy massage cầm tay Crenot Therap M5 sung matxa thư giãn giảm dau nhức toàn thân với 6 đầu mát xa cao cấp và 20 cấp độ",860000,1080000,220000,20
TIKI,lam-dep-suc-khoe,102739210,"Dầu Gội Nhuộm Tóc Tại Nhà Sin Hair 500ml Mẫu Mới Không Lược - Dầu Gội Nhuộm Tóc Nhân Sâm Nhật Bản Giúp Phủ Bạc Đen Tóc - Nâu Tóc  Tặng Kèm 01 túi Muối Ngâm Chân Thư Giãn",265000,265000,0,0
TIKI,lam-dep-suc-khoe,197575307," Cân điện tử sức khoẻ thông minh Crénot Health GoFit S2 kết nối bluetooth đo phân tích chỉ số cơ thể body fat scale can dien tu suc khoe thong minh Crenot",450000,645000,195000,30
TIKI,lam-dep-suc-khoe,53381306,"Máy đo huyết áp bắp tay điện tử Yamada - trợ lý ảo Assistant+ giọng nói tiếng Việt thông minh, đọc kết quả, cảnh báo nhịp tim Heart Link, đo chính xác, thiết kế cao cấp",599000,599000,0,0
TIKI,lam-dep-suc-khoe,17954885,"Bộ sản phẩm cốc nguyệt san Lincup (34ml) ",380000,380000,0,0
TIKI,lam-dep-suc-khoe,76212747,"Combo 2 Tinh Dầu Sả Chanh (Lemongrass) + Tinh Dầu Oải Hương (Lavender) Cao Cấp Nhập Khẩu - Tinh Dầu TIDAMO Nguyên Chất Xông Phòng Giúp Thư Giãn, Thơm Phòng và Nâng Cao Sức Khỏe (2 chai 10ML) - Thích Hợp Sử Dụng Với Máy Xông Tinh Dầu",64000,156000,92000,59
TIKI,lam-dep-suc-khoe,195981759,"Nước súc miệng P/S Pro Complete (Chai 500ml)",75000,75000,0,0
TIKI,lam-dep-suc-khoe,76775262,"Bộ 2 Dầu gội xả 2in1 Palmolive thiên nhiên 600ml",236000,236000,0,0
TIKI,lam-dep-suc-khoe,1659085,"Combo 10 Gói Mặt Nạ Tái Tạo Da Từ Collagen 3w Clinic Fresh Collagen Mask Sheet 100% Cotton (23ml/Miếng)",56000,56000,0,0
TIKI,lam-dep-suc-khoe,58676808,"Kem chống muỗi đốt cho bé từ 6 tháng tuổi hương khuynh diệp Rohto Mentholatum Remos Baby Cream 70g",50000,55000,5000,9
TIKI,lam-dep-suc-khoe,11183003,"Kem Ủ Tóc Collagen Karseell Maca 500ml (Hủ)",54000,195000,141000,72
TIKI,lam-dep-suc-khoe,117786521,"Dụng cụ xét nghiệm nhanh COVID-19 Humasis chính hãng",35000,35000,0,0
TIKI,lam-dep-suc-khoe,55768758,"Tinh chất The Ordinary Retinol 0.5% In Squalane - 30ml",339000,339000,0,0
TIKI,lam-dep-suc-khoe,52618847,"Hỗ trợ giảm cân Chitosan an toàn, giảm hấp thu chất béo, giảm nguy cơ béo phì, hỗ trợ hạ mỡ máu, ngăn ngừa các bệnh tim mạch, huyết áp (30 viên)",350000,350000,0,0
TIKI,lam-dep-suc-khoe,76551091,"Kem Dưỡng Vùng Mắt AHC Ageless Real Eye Cream For Face mẫu mới 2021(30ml) Tặng kèm kẻ mắt nước",175000,250000,75000,30
TIKI,lam-dep-suc-khoe,271408462,"Nấm Hỗ Trợ Giảm Cân Sbody Green Coffee - 100% Thiên Nhiên (Hộp 12 gói /180G) Đốt Mỡ và Kiểm Soát Cân Nặng - Cà Phê Xanh Hỗ Trợ Giảm Cân AN TOÀN & HIỆU QUẢ",529000,550000,21000,4
TIKI,lam-dep-suc-khoe,112984896,"Omega 3 Úc Healthy Care Fish Oil 1000mg Hỗ trợ sức khỏe não bộ, tim mạch, khớp, bổ mắt và tăng sức khỏe tổng thể - Massel Official - 400viên /hộp",455000,910000,455000,50
TIKI,lam-dep-suc-khoe,197599756,"Dụng cụ vệ sinh răng miệng hỗ trợ niềng răng",5000,10000,5000,50
TIKI,lam-dep-suc-khoe,12084520,"Gel Chống Nắng Cho Da Nhờn Mụn Eucerin Sun Gel-Cream Dry Touch Oil Control SPF50+ (50ml)",384000,549000,165000,30
TIKI,lam-dep-suc-khoe,24312036,"Son Thỏi Siêu Mướt Mềm Mịn Môi Belips Thiên Nhiên Không Chì An Toàn Cho Cả Bà Bầu BST Mới "The Queen" 3,7g",249000,331000,82000,25
TIKI,lam-dep-suc-khoe,1321077,"Viên Uống Đẹp Da Chống Nám Ngăn Ngừa Lão Hóa Oribe (Hộp 30 viên)",286000,286000,0,0
TIKI,lam-dep-suc-khoe,49904088,"Dầu Massage BIYOKEA Body Premium Relaxing B2 - Thư giãn 200ml",351000,387000,36000,9
TIKI,lam-dep-suc-khoe,170425580,"Combo Hoàn Hảo - Sữa tắm gội hương nước hoa 350ml & Gel rửa mặt 60S Fresh 100ml & Dung dịch vệ sinh nam giới 100ml",468000,595000,127000,21
TIKI,lam-dep-suc-khoe,52107862,"Cân Sức Khỏe Xiaomi Thông Minh Mi Smart Scale 2 (NUN4056GL)- Trắng - Hàng chính hãng",320000,350000,30000,9
TIKI,lam-dep-suc-khoe,197960229,"Perspirex for Men Maximum - Lăn khử mùi và ngăn tiết mồ hôi loại mạnh",270000,270000,0,0
TIKI,lam-dep-suc-khoe,108535222,"Bao cao su Sagami 002 - Siêu mỏng - Non Latex - Hộp 2 chiếc",80000,100000,20000,20
TIKI,lam-dep-suc-khoe,149346549,"Viên uống Biotin DHC Nhật Bản kích thích mọc tóc nhanh và dày, dưỡng da, móng khỏe mạnh JN-DHC-B30 (30 ngày)",180000,180000,0,0
TIKI,lam-dep-suc-khoe,55214722,"Lược gội đầu Silicone Nhật Bản - Massage xa da đầu - Giảm rụng tóc - Kích thích mọc tóc",12999,12999,0,0
TIKI,lam-dep-suc-khoe,16620673,"Bàn lăn gỗ massage chân 6 hàng đại",176000,176000,0,0
TIKI,lam-dep-suc-khoe,173469753,"Combo 2 hộp JEX giảm đau, bảo vệ xương khớp 60 viên tặng 1 hộp 15 viên",1260000,1440000,180000,13
TIKI,lam-dep-suc-khoe,73623601,"Sủi Da 2 Đầu Thép Không Gỉ KỀM NGHĨA S.516 Loại Nhỏ (1 đầu nhọn, 1 đầu bầu)",25650,27000,1350,5
TIKI,lam-dep-suc-khoe,77105404,"[HỘP - FAMAPRO 5D MASK] - Khẩu trang y tế kháng khuẩn 3 lớp Famapro 5D Mask (10 cái/ hộp)",10900,10900,0,0
TIKI,lam-dep-suc-khoe,186271109,"Bộ đai chườm nóng thảo dược giảm đau cổ gáy dùng điện - Hapaku",469000,600000,131000,22
TIKI,lam-dep-suc-khoe,130315179,"Dụng cụ cạo lưỡi bằng inox 304 sáng bóng làm sạch bề mặt lưỡi giúp hơi thở thơm mát tặng kèm khăn đa năng 2 mặt BaoAn hàng chính hãng",59000,69000,10000,14
TIKI,lam-dep-suc-khoe,76596657,"Tinh Dầu Xông Phòng TRẦM HƯƠNG TIDAMO Cao Cấp - Tinh Dầu Trầm Hương Từ Thiên Nhiên Giúp Bảo Vệ Sức Khỏe, Thư Giãn Và Tĩnh Lặng Tinh Thần - Kiểm Nghiệm Chất Lượng Tại Trung Tâm Quatest 3",34000,168000,134000,80
TIKI,lam-dep-suc-khoe,31637622,"Viên uống DHC Rau Củ Quả Tổng hợp Premium",425000,520000,95000,18
TIKI,lam-dep-suc-khoe,74540152,"Tinh Dầu BẠC HÀ Cao Cấp 50ML - Tinh Dầu Bạc Hà Thiên Nhiên Nguyên Chất Nhập Khẩu Sử Dụng Với Máy Xông Tinh Dầu Giúp Bảo Vệ Sức Khỏe, Kháng Khuẩn, Thư Giãn Tinh Thần và Xua Đuổi Côn Trùng",78000,236000,158000,67
TIKI,lam-dep-suc-khoe,54682884,"Dầu gội đầu Head&Shoulders Clinical Strength Shampoo",299000,299000,0,0
TIKI,lam-dep-suc-khoe,12218834,"Kem Phục Hồi Da Làm Lành Da, Chống Nhiễm Khuẩn Cicalfate Cream 40ml Avene",347000,424000,77000,18
TIKI,lam-dep-suc-khoe,76777344,"Tinh Dầu Xông Phòng TRẦM HƯƠNG TIDAMO 50ML - Tinh Dầu Trầm Hương Cao Cấp Từ Thiên Nhiên Giúp Bảo Vệ Sức Khỏe, Thư Giãn Và Tĩnh Lặng Tinh Thần - Kiểm Nghiệm Chất Lượng Tại Trung Tâm Quatest 3",98000,276000,178000,64
TIKI,lam-dep-suc-khoe,16928041,"Đai Chống Gù Lưng miDoctor Cho Người Lớn, Trẻ Em - Hàng Chính Hãng",199000,199000,0,0
TIKI,lam-dep-suc-khoe,117927305,"Tăm nước cầm tay H2ofloss HF-6. Tăm nước 5 chế độ, 5 đầu tăm đa chức năng, túi vải đựng máy, pin sử dụng tối đa 21 ngày, tặng kèm củ sạc nguồn thấp",449000,850000,401000,47
TIKI,lam-dep-suc-khoe,3490039,"Tinh Chất Chống Lão Hóa Chứa Vitamin C Paula's Choice Resist C15 Super Booster (20ml)",1365000,1600000,235000,15
TIKI,lam-dep-suc-khoe,70660612,"Combo máy khuếch tán, máy xông tinh dầu + bạch đàn chanh Lorganic (10ml) Thích hợp xông phòng 15-40m2/ NHIỀU MẪU",150000,300000,150000,50
TIKI,lam-dep-suc-khoe,194040985,"Bộ 2 Nước súc miệng cho răng nhạy cảm Listerine Total Care Sensitive Soothing Taste 250ml/chai",127000,164000,37000,23
TIKI,lam-dep-suc-khoe,152097299,"Combo 4 gói bông tẩy trang Ipek 150 miếng ( 4 x 150 miếng)",111600,174000,62400,36
TIKI,lam-dep-suc-khoe,31892171,"Tinh Chất Cấp Nước, Phục Hồi Da The Ordinary Hyaluronic Acid 2% + B5 30ml",268000,350000,82000,23
TIKI,lam-dep-suc-khoe,11980971,"Serum Kích Thích Mọc Tóc Ngăn Rụng Tóc Phục Hồi Tóc Hư Tổn  Welhair 100ml",250000,293000,43000,15
TIKI,lam-dep-suc-khoe,184038082,"Combo ngăn ngừa mụn Mugung gồm Sữa rửa mặt và Serum Acne Treatment không bong da bí quyết sạch bay mụn thâm,mụn bọc,mụn trứng cá, dành cho mọi loại da 15ml và 15gram",400000,400000,0,0
TIKI,lam-dep-suc-khoe,2984029,"Nước Súc Miệng Listerine Zero (750ml) - 8850007813149",130000,169000,39000,23
TIKI,lam-dep-suc-khoe,4494843,"Máy Rửa Mặt Halio Facial Cleansing & Massaging Device Sóng Âm Dành Cho Mọi Loại Da",570000,750000,180000,24
TIKI,lam-dep-suc-khoe,216472834,"Dung dịch vệ sinh nam giới Nerman Elegant Men Nerman hương nước hoa cao cấp 100ml/ chai",109000,130000,21000,16
TIKI,lam-dep-suc-khoe,1831605,"Dung Dịch Vệ Sinh Nam Serenys - 100ml",119000,129000,10000,8
TIKI,lam-dep-suc-khoe,43248066,"Sữa dưỡng thể Aveeno giữ ẩm hàng ngày 354ml",335000,419000,84000,20
TIKI,lam-dep-suc-khoe,63165307,"Kem Hỗ Trợ Làm Mờ Sẹo Dermatix Ultra 15g",370000,370000,0,0
TIKI,lam-dep-suc-khoe,50779213,"Vitamin tổng hợp One A Day Men’s 50+ Multivitamin Healthy Advantage 300 viên Hàng Nhập Mỹ",670000,670000,0,0
TIKI,lam-dep-suc-khoe,2469427,"Bao Cao Su Masculan Das Kondom Long Pleasure (10 Cái/ Hộp)",143000,143000,0,0
TIKI,lam-dep-suc-khoe,132286262,"Dầu gội bưởi Cocoon giúp giảm gãy rụng và làm mềm tóc 310ml",208250,245000,36750,15
TIKI,lam-dep-suc-khoe,92512750,"Set 3 dao cạo lông mày cán ngắn chuyên dụng cho nữ cao cấp",48000,52000,4000,8
TIKI,lam-dep-suc-khoe,72864994,"Máy Xông Tinh Dầu Có Loa Bluetooth Kết Nối Với Điện Thoại Nghe Nhạc Cực Hay, Máy Khuếch Tán Tinh Dầu Cho Phòng Lớn Thể Tích 1000ML, Có Remote Điều Khiển Từ Xa và Đèn LED Biến Đổi Màu Cực Đẹp",368000,788000,420000,53
TIKI,lam-dep-suc-khoe,76158697,"Combo 2 Chai xịt tinh dầu bưởi kích mọc tóc, giảm rụng tóc Pomelo Tabaha 120ml cho tóc dày và dài hơn gấp 2 đến 3 lần",150000,150000,0,0
TIKI,lam-dep-suc-khoe,72341010,"Tinh chất se khít lỗ chân lông tối ưu Paula's Choice Clinical Niacinamide 20% Treatment 20ml mã 8030",1890000,1890000,0,0
TIKI,lam-dep-suc-khoe,59238608,"MÁY XÔNG TINH DẦU CHUYÊN DỤNG DUNG TÍCH 550ML, VÂN GỖ CAO CẤP, TÍCH HỢP ĐIỀU KHIỂN TỪ XA",219000,496000,277000,56
TIKI,lam-dep-suc-khoe,92558840,"Lăn khử mùi dưỡng trắng hương nước hoa Refre Whitening Perfume In Love - Hương Tình Yêu 40ml",58500,62000,3500,6
TIKI,lam-dep-suc-khoe,13423145,"Kem Chống Nắng Dành Cho Da Bóng Dầu, Dễ Nổi Mụn La Roche-Posay Anthelios Anti-Imperfection 50ml",385000,550000,165000,30
TIKI,lam-dep-suc-khoe,69839188,"Dầu gội bưởi VIJULLY kích thích mọc tóc giảm gãy rụng tóc",280000,280000,0,0
TIKI,lam-dep-suc-khoe,167926077,"Đông trùng hạ thảo Kingdom Herb chính hãng loại thượng hạng sấy thăng hoa hộp",439000,869000,430000,49
TIKI,lam-dep-suc-khoe,117057283,"Dán Móng Tay Giả Bằng silicon COMBO 5 MIẾNG x12 Sticker thay thế keo dán tiện lợi sử dụng",20000,20000,0,0
TIKI,lam-dep-suc-khoe,68279712,"Combo 2 Lăn khử mùi Romano kháng khuẩn & khô thoáng cả ngày 50mlx2 Force",136000,136000,0,0
TIKI,lam-dep-suc-khoe,52240184,"Máy Đo Huyết Áp Bắp Tay OMRON HEM-7156- Thế Hệ Mới ( THƯƠNG HIỆU OMRON NHẬT BẢN )",1229000,1550000,321000,21
TIKI,lam-dep-suc-khoe,470626,"Kem Dưỡng Làm Dịu Mát, Phục Hồi Da La Roche-Posay Cicaplast Baume B5 (40ml) - M3232900",307000,410000,103000,25
TIKI,lam-dep-suc-khoe,44138399,"Thảo mộc cải thiện cân nặng Slimming Care hộp 30 viên - giúp lấy lại vóc dáng thon gọn",495000,550000,55000,10
TIKI,lam-dep-suc-khoe,122868597,"Set 2 cái lô dính mái, lô quấn tóc xoăn cỡ đại - giao màu ngẫu nhiên",20000,25000,5000,20
TIKI,lam-dep-suc-khoe,248790766,"Vitamina Tổng hợp Kirkland Daily Multi Vitamins - Mỹ - QuaTangMe Extaste",655000,1310000,655000,50
TIKI,lam-dep-suc-khoe,117570362,"Viên sủi bổ sung Vitamin Berocca Performance Mango",98000,98000,0,0
TIKI,lam-dep-suc-khoe,101552499,"Kem Chống Nắng Cell Fusion C Toning Sunscreen 100 SPF50+/ PA +++ Nâng Tông Sáng Hồng",389000,600000,211000,35
TIKI,lam-dep-suc-khoe,75307295,"[HỘP - FAMAPRO MAX] - Khẩu trang y tế kháng khuẩn 4 lớp Famapro Max (40 cái/ hộp) - 1 HỘP",25900,25900,0,0
TIKI,lam-dep-suc-khoe,80994699,"Gel Chống Nắng Màng Nước Dưỡng Ẩm Bioré UV Aqua Rich Watery SPF50+/PA++++ 90ml",199000,249000,50000,20
TIKI,lam-dep-suc-khoe,74212735,"Tinh dầu Quế Nguyên Chất 50ML. Tinh Dầu Vỏ Quế Cao Cấp Nhập Khẩu Ấn Độ. Tinh Dầu Xông Phòng Kháng Khuẩn, Phòng Tránh Cảm Cúm - Dùng Với Máy Xông Tinh dầu",78000,228000,150000,66
TIKI,lam-dep-suc-khoe,20534750,"Khẩu trang trẻ em Gấu trúc StayDry",35100,39000,3900,10
TIKI,lam-dep-suc-khoe,173854434,"Set 100cái khẩu trang y tế KF94 Kháng Khuẩn, Màu Trắng, Chống Bụi Mịn, Hàng Cao Cấp",82000,120000,38000,32
TIKI,lam-dep-suc-khoe,72117492,"BÌNH RỬA MŨI WATER PULSE TẶNG KÈM 1 CHAI NƯỚC MUỐI SINH LÍ 500ML",144000,144000,0,0
TIKI,lam-dep-suc-khoe,173600339,"Dung dịch xịt họng PlasmaKare H - Spray 30ml, cho trẻ từ 06 tháng, an toàn cho phụ nữ có thai không kháng sinh",170000,170000,0,0
TIKI,lam-dep-suc-khoe,129947293,"Kem dưỡng trắng da mặt Yococi giúp sáng da, ngăn chặn ánh sáng xanh White Perfect Face Cream 20g",163200,320000,156800,49
TIKI,lam-dep-suc-khoe,174829842,"Kem Dưỡng Ẩm Làm Dịu Cho Da Khô, Ngứa, Mẫn Đỏ Latopic Face And Body Cream 75ml",322000,379000,57000,15
TIKI,lam-dep-suc-khoe,166417513,"Khẩu Trang Y tế  KF94 PT Mask Kháng khuẩn, Chống Bụi. Đạt Các Chứng Chỉ ISO 13485, ISO 9001, CE, FDA, TGA",9900,9900,0,0
TIKI,lam-dep-suc-khoe,10734388,"Nước cân bằng giàu khoáng dành cho da dầu La Roche Posay Effaclar Astringent Lotion 200ml ",377000,455000,78000,17
TIKI,lam-dep-suc-khoe,70638800,"Lược cắt tóc 0612",18000,30000,12000,40
TIKI,lam-dep-suc-khoe,58601415,"Viên uống Vitamin tổng hợp cho Nữ - One A Day women Multivitamin 300 viên của Mỹ - mẫu mới",650000,650000,0,0
TIKI,lam-dep-suc-khoe,556237,"Nước Súc Miệng Trà Xanh Listerine Natural Green Tea (750ml)",146000,187000,41000,22
TIKI,lam-dep-suc-khoe,58220974,"Kem Dưỡng Thể 2% BHA Paula’s Choice Resist Weightless Body Treatment With 2% BHA  - M",950000,950000,0,0
TIKI,lam-dep-suc-khoe,13566981,"Kem dưỡng da chống lão hóa Shiseido Benefiance Wrinkle Smoothing Cream 50ml",1849000,1850000,1000,0
TIKI,lam-dep-suc-khoe,94613156,"ĐỆM MASSGE HỒNG NGOẠI TOÀN THÂN CAO CẤP HAKAWA HK-M11 - HÀNG CHÍNH HÃNG",2660000,2940000,280000,10
TIKI,lam-dep-suc-khoe,84283337,"Sáp Wax Lông Nóng Wax Bean 100gr, Dạng Hạt Đậu(Tặng Kèm Que Phết Wax Stick)",13000,23999,10999,46
TIKI,lam-dep-suc-khoe,63511644,"Cân điện tử bluetooth phân tích chỉ số cơ thể Kachi MK223 - Màu đen - Hàng chính hãng",299000,399000,100000,25
TIKI,lam-dep-suc-khoe,101018297,"Miếng Dán Lột Mụn Đầu Đen Vùng Mũi Cằm Trán Từ Tro Núi Lửa Đảo JeJu Dewytree Black Head Out Nose Patch (1 Miếng)",12000,15000,3000,20
TIKI,lam-dep-suc-khoe,173472760,"Combo 2 hộp ANGELA GOLD tăng cường sinh lý nữ 60 viên tặng 1 hộp 15 viên",1440000,1630000,190000,12
TIKI,lam-dep-suc-khoe,5780691,"Son dưỡng có màu chiết xuất trái cây Lipice Sheer Color Fruit Juice Strawberry",82500,103000,20500,20
TIKI,lam-dep-suc-khoe,73631483,"Cân sức khỏe điện tử LAICA PS1036 - Mức cân tối đa 150 Kg - Mặt kính dày 8mm",375000,650000,275000,42
TIKI,lam-dep-suc-khoe,50884640,"Kem Dưỡng Reihaku Hatomugi Cải Thiện Làn Da khô, thâm, mụn 300g",160000,163800,3800,2
TIKI,lam-dep-suc-khoe,25917935,"Gel Chăm Sóc Sẹo Mụn Và Mụn Thâm Hiruscar Post Acne 5G",190000,190000,0,0
TIKI,lam-dep-suc-khoe,7221953,"Sữa Rửa Mặt Cân Bằng Độ Ẩm Và Giảm Dầu Skin Balancing Oil Reducing Cleanser 237ml",699000,699000,0,0
TIKI,lam-dep-suc-khoe,568277,"Lăn Nách Dành Cho Nam Aquaselin Extreme For Men Antiperspirant For Excessive Perspiration 50ml - 3936",290000,362500,72500,20
TIKI,lam-dep-suc-khoe,7615194,"Sữa tắm cá ngựa Algemarin Perfume Shower Gel  300ml",75000,75000,0,0
TIKI,lam-dep-suc-khoe,252063162,"Bổ não Úc Healthy Care Ginkgo Biloba 2000, Giúp tăng tuần hoàn máu não, Cải thiện chức năng nhận thức, Trí nhớ, Giúp an thần và Giảm Stress (100 V/Hộp) - QuaTangMe Extaste",213000,498000,285000,57
TIKI,lam-dep-suc-khoe,208303315,"Combo máy khuếch tán/ máy xông tinh dầu bình hoa + tinh dầu sả chanh + tinh dầu cam Lorganic (10ml x2 chai)",275000,550000,275000,50
TIKI,lam-dep-suc-khoe,149410184,"Bông tẩy trang Tétra Medical Pháp - loại 600 miếng",109000,109000,0,0
TIKI,lam-dep-suc-khoe,83202928,"Bộ 5 Bàn chải đánh răng Colgate than hoạt tính kháng khuẩn SlimSoft Charcoal mềm mảnh",110000,153000,43000,28
TIKI,lam-dep-suc-khoe,42559192,"Eucerin Pro ACNE Solution Cleansing Gel: Gel Rửa Mặt Da Mụn (400 ml)",396000,529000,133000,25
TIKI,lam-dep-suc-khoe,103555074,"Máy Đẩy Tinh Chất Halio Ion Hot & Cool Beauty Device Nâng Cơ Mặt - Màu White",1959000,2500000,541000,22
TIKI,lam-dep-suc-khoe,55891956,"Bigsize - Kem dưỡng trắng da toàn thân Truesky Whitening Body Lotion chiết xuất lựu 200g",250000,250000,0,0
TIKI,lam-dep-suc-khoe,3490333,"Tinh chất chống nám và nếp nhăn độc đáo Paula's Choice Clinical 1% Retinol Treatment 30ml",1650000,1950000,300000,15
TIKI,lam-dep-suc-khoe,48085908,"Phấn Nước M.O.I 5M BABY SKIN CUSHION Hồ Ngọc Hà (Chính Hãng)",391020,399000,7980,2
TIKI,lam-dep-suc-khoe,190254514,"Khẩu trang y tế 6D AN Tâm, kháng khuẩn 4 lớp ,lẻ và sỉ, chống virus Covid-19 và bụi mịn",12000,12000,0,0
TIKI,lam-dep-suc-khoe,103498447,"Kem Tẩy Lông Cho Da Thường Veet Silk Fresh 25G",40000,42200,2200,5
TIKI,lam-dep-suc-khoe,136935260,"[SIZE DU LỊCH] Sữa rửa mặt Sắc Ngọc Khang 30g giúp loại bỏ bụi bẩn và bã nhờn dư thừa, cung cấp các dưỡng chất cho da, giúp da trắng sáng, mịn màng",19000,30000,11000,37
TIKI,lam-dep-suc-khoe,270808576,"Bổ não Úc Healthy Care Ginkgo Biloba 2000, Giúp tăng tuần hoàn máu não, Cải thiện chức năng nhận thức, Trí nhớ, Giúp an thần và Giảm Stress - QuaTangMe Extaste",231000,498000,267000,54
TIKI,lam-dep-suc-khoe,24924199,"Son kem lì Bbia Last Velvet Lip Tint Version 1 5g (5 màu)",150000,290000,140000,48
TIKI,lam-dep-suc-khoe,117170051,"Combo 2 Sữa rửa mặt Simple giúp kiềm dầu và ngừa mụn hiệu quả - cho da mụn nhạy cảm 150ml [CHÍNH HÃNG ĐỘC QUYỀN] [DIỆN MẠO MỚI]",198000,264000,66000,25
TIKI,lam-dep-suc-khoe,72759100,"Bao cao su Ôm sát Siêu mỏng Powermen Kéo dài thời gian quan hệ cho Nam ( Size 49mm)",120000,120000,0,0
TIKI,lam-dep-suc-khoe,56388178,"Bộ 4 Kem đánh răng Colgate bạc hà the mát Maxfresh 230g/tuýp tặng bàn chải đánh răng lông mềm",190000,190000,0,0
TIKI,lam-dep-suc-khoe,88967146,"Bao Cao Su Gai Kéo Dài Thời Gian Của Nhật Bản Sagami Xtreme Feel Long (Hộp 10 Chiếc) Không Mùi Cao Su  - Tặng 1 Chiếc BCS Power Men - Che Tên Sản Phẩm",75000,75000,0,0
TIKI,lam-dep-suc-khoe,88992738,"Combo Mật ong  rừng Phương Nam 100% mật ong chín Honimore 990g",282000,282000,0,0
TIKI,lam-dep-suc-khoe,1601631,"Gel Cho Da Thâm The Body Shop Tea Tree (2.5ml)",179000,250000,71000,28
TIKI,lam-dep-suc-khoe,43108211,"Hấp ủ phục hồi cấp tốc LUJO KERATIN MASK & COLLAGEN cho mái tóc",160000,180000,20000,11
TIKI,lam-dep-suc-khoe,193742017,"Băng vệ sinh AO2 siêu mỏng nhẹ mặt lưới có cánh - Dùng cho ngày (23cm), đêm (28cm) 7 miếng/gói",11875,12500,625,5
TIKI,lam-dep-suc-khoe,117175571,"Máy Massage Lưng Cao Cấp KINGTECH KB-920  - Mát xa Thắt Lưng, Eo, Cột Sống - Hỗ Trợ Điều Trị Thoát Vị Đĩa Đệm, Thoái Hóa, Đau Đốt Sống, Vai Gáy - Tích Hợp Tính Năng Nhiệt Hồng Ngoại 45 - 65 độ - Hàng Chính Hãng",1995000,3350000,1355000,40
TIKI,lam-dep-suc-khoe,25738219,"Floslek Sữa Rửa Mặt Dạng Gel Cho Da Nhờn Mụn Anti Acne Bacterial Face Cleansing Gel 200ml",396000,396000,0,0
TIKI,lam-dep-suc-khoe,55361011," Kem Nền Che Khuyết Điểm Tặng Kèm Bông Đánh VEN ZEN",75000,145000,70000,48
TIKI,lam-dep-suc-khoe,192339772,"Bàn chải đánh răng điện cho bé LocknLock ENR226WHT-5V, 1.5W - Màu trắng",567000,1090000,523000,48
TIKI,lam-dep-suc-khoe,21408570,"Kem Dưỡng Giảm Thâm Quầng Mắt Himalaya 15ml",130000,130000,0,0
TIKI,lam-dep-suc-khoe,75842514,"Hà Thủ Ô Mật Ong Phúc Khang",190000,190000,0,0
TIKI,lam-dep-suc-khoe,217412334,"Bao cao su siêu mỏng, trơn mượt LifeStyles SKYN Elite - Non-latex không mùi cao su - 3 bao",75000,120000,45000,38
TIKI,lam-dep-suc-khoe,58668263,"Combo 2 Sữa tắm hương nước hoa Enchanteur Delightful 650gr/ Chai",313000,392000,79000,20
TIKI,lam-dep-suc-khoe,108535201,"Bao cao su Sagami White box - Có gai - Hộp 10 chiếc",95000,120000,25000,21
TIKI,lam-dep-suc-khoe,67810097,"Bộ Máy Đo Đường Huyết Acon On Call Plus + Tặng hộp 25 que thử",561000,850000,289000,34
TIKI,lam-dep-suc-khoe,20701571,"Tinh dầu dưỡng tóc AURANE Softliss Fantastic Repair hair oil 125ml",122000,130000,8000,6
TIKI,lam-dep-suc-khoe,46643670,"Cho máy Oral-B Braun,  Bộ 4 đầu bàn chải đánh răng điện - Trẻ em, cho mọi loại máy - EB10A",115000,115000,0,0
TIKI,lam-dep-suc-khoe,176048170,"Thực phẩm bảo vệ sức khỏe Thảo mộc cải thiện cân nặng Slimming Care X3 ( số 2) hộp 15 viên - dành cho người béo lâu năm, cơ địa chai lì",495000,550000,55000,10
TIKI,lam-dep-suc-khoe,190641506,"Sữa Rửa Mặt Dịu Nhẹ Cho Da Dầu CeraVe Foaming Cleanser 473ml",386000,455000,69000,15
TIKI,lam-dep-suc-khoe,126795077,"Viên uống JEX giảm đau, bảo vệ xương khớp với Eggshell Membrane, Collagen Peptide, Collagen Type II không biến tính (60 viên)",630000,630000,0,0
TIKI,lam-dep-suc-khoe,176296819,"Nước Cân Bằng Giảm Mụn Và Thông Thoáng Lỗ Chân Lông SVR Sebiaclear Micro - Peel 150ml",312000,390000,78000,20
TIKI,lam-dep-suc-khoe,76564284,"Xịt Họng Keo Ong 3T 25ml Giảm Đau Họng, Ho Khan, Ngứa Rát Họng",49500,99000,49500,50
TIKI,lam-dep-suc-khoe,118090021,"Bộ 2 Hộp Viên Sủi Bổ Sung Vitamin Berocca Performance Mango 10 Viên/Hộp",196000,196000,0,0
TIKI,lam-dep-suc-khoe,192704831,"Kem che khuyết điểm Mochi Nhật Bản",99000,99000,0,0
TIKI,lam-dep-suc-khoe,170066572,"Combo 3 Hộp Khẩu trang Bông Bạch Tuyết than hoạt tính (50 cái/hộp)",234000,234000,0,0
TIKI,lam-dep-suc-khoe,59085169,"Bình (Bộ Dụng Cụ) Rửa Mũi Xoang Người Lớn NeilMed SinusRinse Adult Kit -Xuất Xứ Mỹ(1 bình + 10 gói)",327000,327000,0,0
TIKI,lam-dep-suc-khoe,11874956,"Viên Uống Cân Bằng Nội Tiết Tố, Cải Thiện Sinh Lý Nữ Marilyn (Hộp 30 viên)",198000,198000,0,0
TIKI,lam-dep-suc-khoe,8057340,"Xà Phòng Giảm Mụn Lưng For Back 135g Nội Địa Nhật Bản",96000,98280,2280,2
TIKI,lam-dep-suc-khoe,11118835,"Combo 2 lon Thực Phẩm chức năng Tinh bột nghệ đỏ An Bình",590000,590000,0,0
TIKI,lam-dep-suc-khoe,385469,"Bao cao su Durex Fetherlite Ultima Hộp 3 bao",69000,76000,7000,9
TIKI,lam-dep-suc-khoe,106969437,"Dầu Gội Dược Liệu Nguyên Xuân Bồng Bềnh - Thơm Ngát Hương Hoa Tự Nhiên",78400,78400,0,0
TIKI,lam-dep-suc-khoe,164410334,"Son Môi M.O.I Hồ Ngọc Hà Son Thỏi LOVE BY THUỲ TIÊN 2022 (Bản Giới Hạn)",249000,359000,110000,31
TIKI,lam-dep-suc-khoe,17043131,"Dầu gội TRESEMME Keratin Smooth Cho tóc khô xơ rối Công thức Hydrolyzed Keratin Dưỡng Tóc Vào Nếp Suôn Mượt 850g",169000,169000,0,0
TIKI,lam-dep-suc-khoe,188785183,"Saffron mật ong đông trùng hạ thảo Kingdom Herb chính hãng thượng hạng hộp 312g (tặng bình thuỷ tinh và cây lấy mật)",400000,789000,389000,49
TIKI,lam-dep-suc-khoe,91565658,"Combo 6 Băng Vệ Sinh Quần Peppy Shana Siêu Thấm Free Size (12 miếng)",78550,89000,10450,12
TIKI,lam-dep-suc-khoe,270548759,"Omega 3 Úc Healthy Care Fish Oil giúp bổ mắt, kháng viêm, tốt cho trí não, tim mạch - QuaTangMe Extaste",385000,910000,525000,58
TIKI,lam-dep-suc-khoe,169585264,"Obagi Retinol 1.0 (28g)",1280000,1750000,470000,27
TIKI,lam-dep-suc-khoe,631026,"Dung dịch dưỡng ẩm tối ưu Hada Labo Advanced Nourish Lotion dùng cho da thường và da khô 170ml",167000,208000,41000,20
TIKI,lam-dep-suc-khoe,74192960,"Máy Massage Cổ Vai Gáy Chuyên Sâu 3D KINGTECH KS460 - Hỗ Trợ Mát xa Đùi, Chân, Lưng Dưới - Tích Hợp Nhiệt Hồng Ngoại - Tiện Sử Dụng Tại Nhà, Văn Phòng, Du Lịch - Quà Tặng Tuyệt Vời Dành Cho Người Thân - Chính Hãng",1250000,1750000,500000,29
TIKI,lam-dep-suc-khoe,186272570,"Đôi Giày Chườm Nóng Thảo Dược Giảm Đau Bàn Chân Dùng Điện Phiên Bản Vỏ Đai Bằng Vải Da Lộn - Hapaku",995000,1300000,305000,23
TIKI,lam-dep-suc-khoe,29496992,"FLOSLEK PHARMA GEL RỬA MẶT DIỆT KHUẨN NGỪA MỤN ANTIBACTERIAL FACE CLEANSING GEL 200ML",396000,396000,0,0
TIKI,lam-dep-suc-khoe,8011746,"Tinh Chất Hàu Biển OYSTER MAN Tăng Cường Sinh Lý Nam, Cải Thiện Xuất Tinh Sớm, Yếu Sinh Lý (Hộp 30 Viên)",109500,219000,109500,50
TIKI,lam-dep-suc-khoe,132081941,"Mặt Nạ Ngủ Dưỡng Ẩm Laneige Water Sleeping Mask EX",240000,310000,70000,23
TIKI,lam-dep-suc-khoe,190290564,"Khẩu trang y tế VN95 an tâm, Lẻ 10 cái. sỉ thùng 500 cái, kháng khuẩn chống virus Corona chủng BA5, chuyên dụng cho bệnh viện",7000,7000,0,0
TIKI,lam-dep-suc-khoe,180303300,"Dầu chăm sóc da giúp cải thiện rạn da, mờ sẹo và đều màu da - BIO-OIL SKINCARE OIL (chai 200ml)",435000,460000,25000,5
TIKI,lam-dep-suc-khoe,137253587,"Máng Trainer ( Niềng răng chỉnh nha)|DỤNG CỤ NIỀNG RĂNG",120000,120000,0,0
TIKI,lam-dep-suc-khoe,190119292,"Bấm Móng Tay Thép Carbon Chuyên Dụng KỀM NGHĨA B.939 - Lưỡi Cong (Loại Lớn)",27550,29000,1450,5
TIKI,lam-dep-suc-khoe,144208515,"Dầu gội khô Girlz Only Dry Shampoo 200ml",89000,89000,0,0
TIKI,lam-dep-suc-khoe,118089805,"Kem Chống Hăm Bepanthen Balm Dạng Kem Mỡ 30G/Tuýp",95500,95500,0,0
TIKI,lam-dep-suc-khoe,34315213,"Dao Cạo Râu 2 Lưỡi Dorco TG 710YL-5P (05 Dao Cạo)",28000,28000,0,0
TIKI,lam-dep-suc-khoe,11625471,"Titan Gel Nga - Gel bôi trơn  tăng kích thước 50ml - hàng chuẩn Nga",230000,230000,0,0
TIKI,lam-dep-suc-khoe,181133300,"Sữa Tắm Gội Coast Classic Scent Vòi Dành Cho Nam 946ml - USA",143000,143000,0,0
TIKI,lam-dep-suc-khoe,10639651,"Thực Phẩm Chức Năng Heposal - Phục hồi tổn thương viêm gan xơ gan",350000,360000,10000,3
TIKI,lam-dep-suc-khoe,147420070,"Bộ quà tặng cho nam FULL-HOUSE BOX-Sữa tắm gội hương nước hoa 3in1 350ml & Dung dịch vệ sinh nam giới 50g & Gel rửa mặt Nano Curcumin 100ml",476000,595000,119000,20
TIKI,lam-dep-suc-khoe,126959538,"Serum hôi nách INOD Huyền Phi 5ml tác dụng triệt hôi nách, hôi chân , mồ hôi tay chân vĩnh viên",161400,161400,0,0
TIKI,lam-dep-suc-khoe,76210034,"Combo 2 Tinh Dầu Sả Chanh 50ML (Lemongrass) + Tinh Dầu Oải Hương 50ML (Lavender) - Tinh Dầu TIDAMO Nguyên Chất Xông Phòng Giúp Thư Giãn, Thơm Phòng và Nâng Cao Sức Khỏe - Rất Tốt Khi Sử Dụng Với Máy Xông Tinh Dầu",184000,436000,252000,58
TIKI,lam-dep-suc-khoe,273217865,"Combo Máy khuếch tán/ máy xông tinh dầu Bí Ngô Lorganic FX2027 + tinh dầu sả chanh + tinh dầu cam Lorganic (10ml x2)",285000,400000,115000,29
TIKI,lam-dep-suc-khoe,166369511,"Sữa tắm gội cho nam Romano 2 trong 1 Gentleman 650g",154000,191000,37000,19
TIKI,lam-dep-suc-khoe,2775397,"Bao Cao Su Có Gai Nhật Bản Sagami Extreme White (10 Cái / Hộp)",69000,69000,0,0
TIKI,lam-dep-suc-khoe,2775387,"Bao Cao Su Sagami Xtreme Super Thin (10 Cái / Hộp)",69000,69000,0,0
TIKI,lam-dep-suc-khoe,53410887,"Cân Điện Tử Sức Khỏe Hình Chú Heo Xinh Xắn Dành Cho Gia Đình + Tặng kèm 1 thước dây",60191,60191,0,0
TIKI,lam-dep-suc-khoe,112074140,"Nhiệt Kế Hồng Ngoại Đo Trán Chính Hãng Sinocare",195000,299000,104000,35
TIKI,lam-dep-suc-khoe,57762842,"KEM TẨY LÔNG PERFECT CLEAN HUYỀN PHI TẶNG KÈM BÔNG RỬA MẶT",169000,169000,0,0
TIKI,lam-dep-suc-khoe,74607743,"Tinh Dầu BẠC HÀ Nguyên Chất Nhập Khẩu 100ML - Tinh Dầu Xông Phòng Bạc Hà (Peppermint) Giúp Bảo Vệ Sức Khỏe, Kháng Khuẩn, Thư Giãn Tinh Thần và Xua Đuổi Côn Trùng. Thích Hợp Sử Dụng Với Máy Xông Tinh Dầu",188000,376000,188000,50
TIKI,lam-dep-suc-khoe,56386406,"Bộ đôi nước súc miệng Colgate diệt 99% vi khuẩn Plax bạc hà 500ml/chai",125000,165000,40000,24
TIKI,lam-dep-suc-khoe,132263414,"Combo 6 bàn chải đánh răng Colgate Cushion Clean công nghệ tạo bọt kem siêu mịn",370000,370000,0,0
TIKI,lam-dep-suc-khoe,49294599,"Viên uống chống nắng UV Fine Japan Nhật Bản, chống nắng toàn diện, giảm thâm nám, 30 viên/túi",230000,245700,15700,6
TIKI,lam-dep-suc-khoe,132047096,"Dầu Gội Phủ Bạc Laco Black Hair 200ml giúp tóc đen tự tin sau 9 phút",245000,350000,105000,30
TIKI,lam-dep-suc-khoe,68281314,"Combo 2 Lăn khử mùi Romano kháng khuẩn & khô thoáng cả ngày 50mlx2 Attitude",104000,136000,32000,24
TIKI,lam-dep-suc-khoe,108535228,"Gel bôi trơn Sagami - Cao cấp - Gốc nước - Tuýp 60g",195000,215000,20000,9
TIKI,lam-dep-suc-khoe,59168970,"Gói Hỗn Hợp Muối Rửa Mũi Xoang Người Lớn NeilMed SinusRinse Adult Sachets - Xuất xứ Mỹ (Hộp 120 gói)",662000,662000,0,0
TIKI,lam-dep-suc-khoe,145760855,"Siro Ho Ích Phế Hầu - Hỗ Trợ Giảm Ho, Bổ Phế, Giảm Đờm,Giảm Đau Họng, Nguyên Liệu Nhập Khẩu Từ Pháp",54800,54800,0,0
TIKI,lam-dep-suc-khoe,65100105,"Phấn Nước Mịn Lì 24H Laneige Neo Cushion Matte 15g*2 13N",790000,1000000,210000,21
TIKI,lam-dep-suc-khoe,71999833,"Sữa rửa mặt dạng Gel Decumar Clean Advanced 100gr hoàn toàn mới kiểm soát nhờn mụn",105000,105000,0,0
TIKI,lam-dep-suc-khoe,127891085,"Dầu gội dược liệu Nguyên Xuân có vòi - Cho tóc bết, nhiều gàu, giảm khô xơ, hư tổn, dưỡng và phục hồi sâu từ bên trong",74000,95000,21000,22
TIKI,lam-dep-suc-khoe,33768251,"Máy SPO2 OXY200 chính hãng Microlife Thụy Sĩ dùng để đo nhịp tim và nồng độ oxy trong máu",539000,539000,0,0
TIKI,lam-dep-suc-khoe,76103131,"Siro Zhealth - Hỗ trợ tăng cường sức đề kháng, Hệ miễn dịch, Bổ phế, Giảm ho tức thì, Cải thiện sức khỏe đường hô hấp cho trẻ nhỏ, người già(10ml)",159000,179000,20000,11
TIKI,lam-dep-suc-khoe,273009719,"Hỗ trợ giảm đau nhức xương khớp Schiff Move Free Mỹ nâng cao sức khỏe khớp, sụn và xương, tăng khả năng vận động linh hoạt thoải mái-QuaTangMe Extaste",661000,1570000,909000,58
TIKI,lam-dep-suc-khoe,114128571,"Combo 2 Sáp khử mùi trắng da Enchanteur Charming 40g/chai",155000,184000,29000,16
TIKI,lam-dep-suc-khoe,208311637,"Combo máy khuếch tán/ máy xông tinh dầu núi lửa + tinh dầu sả chanh + tinh dầu cam Lorganic (10ml x 2 chai)",295000,500000,205000,41
TIKI,lam-dep-suc-khoe,185941089,"[Size du lịch] Sữa tắm dưỡng thể Nano Collagen Sắc Ngọc Khang giúp da sạch-căng mịn-trắng sáng (Chai 30ml)",19000,39000,20000,51
TIKI,lam-dep-suc-khoe,108535235,"Bao cao su Sagami 001 - Siêu mỏng - Non Latex - Hộp 5 chiếc",425000,720000,295000,41
TIKI,lam-dep-suc-khoe,70495154,"Son dưỡng môi chuyên biệt dành cho môi khô, nứt nẻ Mentholatum Medi Lip Stick 4.3g",61300,64500,3200,5
TIKI,lam-dep-suc-khoe,109296367,"Bộ 5 sản phẩm Tsubaki Phục hồi ngăn rụng tóc chuyên sâu (Gội Xả 490ml/chai + Kem Xả 180g + Mặt nạ tóc 180g + Dầu dưỡng 50ml)",667000,1219000,552000,45
TIKI,lam-dep-suc-khoe,6761497,"Bộ 4 Bàn Chải Đánh Răng Trisa Fresh",170000,170000,0,0
TIKI,lam-dep-suc-khoe,73925328,"COMBO TOÀN DIỆN CHO DA MỤN DECUMAR ADVANCED",295000,295000,0,0
TIKI,lam-dep-suc-khoe,271334560,"Bao cao su ngón tay Feelex Finger Condom nhiều gel hộp 12 bcs",89000,89000,0,0
TIKI,lam-dep-suc-khoe,107254729,"Viên uống bổ sung Glucosamine ORIHIRO Nhật Bản giảm đau xương khớp 900 viên - 950 viên",360000,600000,240000,40
TIKI,lam-dep-suc-khoe,270548709,"Omega 3 Úc Healthy Care Fish Oil Hỗ trợ sức khỏe não bộ, Tim mạch, Khớp, Bổ mắt, Làm đẹp da, Và tăng sức khỏe tổng thể - QuaTangMe Extaste",369000,910000,541000,59
TIKI,lam-dep-suc-khoe,51288234,"Serum giảm mụn 24h Anti-Acnes 20ml",298000,298000,0,0
TIKI,lam-dep-suc-khoe,173748430,"Thảm massage chân thư giãn trị liệu nhức mỏi chân, mát xa công nghệ xung điện màn hình kỹ thuật số, pin sạc",49966,49966,0,0
TIKI,lam-dep-suc-khoe,49217739,"Kem dánh răng crest 3D white 158g",124000,124000,0,0
TIKI,lam-dep-suc-khoe,96826251,"Băng vệ sinh hàng ngày Laurier Nhật Bản 72 miếng",79000,79000,0,0
TIKI,lam-dep-suc-khoe,105632400,"Bộ 3 Bao Cao Su Durex Jeans - Hộp 3 chiếc",126000,147000,21000,14
TIKI,lam-dep-suc-khoe,2728621,"Dầu dừa ép lạnh tinh khiết Coco-Secret hũ 500 ml",145000,145000,0,0
TIKI,lam-dep-suc-khoe,72710940,"Bao cao su Powermen Ôm sát, 250 Gai nhỏ, Kéo dài thời gian",39000,39000,0,0
TIKI,lam-dep-suc-khoe,104323277,"Tinh Dầu Sả Chanh Treo Xe TOKI MORI Xuất Khẩu Nhật Bản (10ml) 100% Thiên Nhiên, An Toàn Cho Trẻ, Xông Phòng, Khử Mùi, Thơm Xe, Chống Ói, Kháng Khuẩn",59000,99000,40000,40
TIKI,lam-dep-suc-khoe,89245624,"Cao dán hồng sâm Hàn Quốc - loại Power Xanh và Đỏ",49000,80000,31000,39
TIKI,lam-dep-suc-khoe,15654981,"Cây Lấy Khóe Đầu Cong Inox Hỗ Trợ Móc Khóe và Vệ Sinh Khóe KỀM NGHĨA",6650,7000,350,5
TIKI,lam-dep-suc-khoe,79411386,"Kem chống nắng nâng tông Skin Aqua Tone up Rose cho da trắng, khuyết điểm xanh hoặc tái xanh, dạng tinh chất Sunplay Skin Aqua Tone Up UV Essence Happiness Aura (Rose) SPF 50+ PA++++ 50g",160000,199000,39000,20
TIKI,lam-dep-suc-khoe,13824600,"Dầu Gội Và Xả Hoa Bưởi Thorakao 400ml",70800,70800,0,0
TIKI,lam-dep-suc-khoe,96199726,"NAKIZ LIVELY BUTT kem ngừa mụn, mờ thâm Mông bẹn nách Thái Lan 100g",299000,299000,0,0
TIKI,lam-dep-suc-khoe,140107223,"Sữa dưỡng thể Vaseline Healthy White UV Lightening Body Lotion 725ml",150000,150000,0,0
TIKI,lam-dep-suc-khoe,54643914,"Combo 2 Lăn khử mùi Romano Classic kháng khuẩn & khô thoáng cả ngày 50ml*2",104000,136000,32000,24
TIKI,lam-dep-suc-khoe,37974580,"Viên uống Trắng da DHC Adlay Extract Nhật Bản - 60 Ngày (60 viên)",425000,500000,75000,15
TIKI,lam-dep-suc-khoe,25107897,"Sữa rửa mặt tạo bọt ngăn ngừa mụn Acnes Foaming Wash 150ml",63000,79000,16000,20
TIKI,lam-dep-suc-khoe,42260194,"Dầu Dừa Lên Men Tách Lạnh Tinh Khiết VietHealthy 1000ml",389000,389000,0,0
TIKI,lam-dep-suc-khoe,140440052,"Máy Massage Chân VISPO VP-C21G - Máy Massage Lòng Bàn Chân, Mu Bàn Chân Công Nghê Hiện Đại, Xoa Bóp, Trườm Ấm Thư Giãn, giải tỏa Căng Thằng Mệt Mỏi",1699000,2980000,1281000,43
TIKI,lam-dep-suc-khoe,36678762,"Combo 6 gói Băng vệ sinh Diana Siêu thấm siêu mỏng cánh 8 miếng",120000,132000,12000,9
TIKI,lam-dep-suc-khoe,137847856," Nước Hoa Nam Dạng Sáp Khô Cao Cấp Meidian Hương Thơm Cuốn Hút,Nam Tính(Combo 3 mùi)",60000,120000,60000,50
TIKI,lam-dep-suc-khoe,40935834,"Dầu gội Sunsilk Óng Mượt Rạng Ngời 1.4kg dành cho tóc khô xơ với tinh chất Bồ Kết truyền thống",205000,205000,0,0
TIKI,lam-dep-suc-khoe,59236451,"Viên xương khớp Blackmores glucosamine 1500mg chính hãng Úc 180 viên - dùng 6 tháng mẫu mới",635000,793750,158750,20
TIKI,lam-dep-suc-khoe,136816203,"Saffron ngâm mật ong Kingdom Herb chính hãng thượng hạng hộp 311g",305000,599000,294000,49
TIKI,lam-dep-suc-khoe,113500007,"Đai Chống Gù Lưng Có Rung Cảm Biến Ba Chiều Nhắc Nhở Sửa Tư Thế Thông Minh - Nẹp Lưng Chống Gù Cho Trẻ Em, Nam, Nữ",141550,149000,7450,5
TIKI,lam-dep-suc-khoe,212317103,"Vitamin E Mỹ Kirkland Signature E 180mg  – Chống Oxy hóa mạnh, làm chậm quá trình lão, đẹp da, tóc và tốt cho tim mạch - Massel Official - 500 Viên",413000,1002000,589000,59
TIKI,lam-dep-suc-khoe,73322326,"Nước Tẩy Trang Simple Micellar Cleansing Water 200ml",119000,119000,0,0
TIKI,lam-dep-suc-khoe,111874128,"Bộ 4 Kem đánh răng Colgate bạc hà the mát Maxfresh 225g/tuýp tặng bàn chải đánh răng lông mềm",166000,200000,34000,17
TIKI,lam-dep-suc-khoe,28725732,"Máy xông mũi họng OMRON NE-C28",1299000,1495000,196000,13
TIKI,lam-dep-suc-khoe,89139805,"[TÚI - FAMAPRO 4D] - Khẩu trang y tế kháng khuẩn cao cấp Famapro 4D tiêu chuẩn KF94 (5 cái/ túi)",10000,10000,0,0
TIKI,lam-dep-suc-khoe,271473344,"Viên uống bổ não Healthy Care Ginkgo Biloba 100 viên",281000,360000,79000,22
TIKI,lam-dep-suc-khoe,77985921,"COLLAGEN KOHARU 84000mg Collagen Peptide Từ Da Cá Ngừ Đại Dương, Nước Uống Đẹp Da Chống Lão Hóa Đến Từ Nhật Bản 500ml",1300000,1300000,0,0
TIKI,lam-dep-suc-khoe,106503541,"Máy mát xa cổ vai gáy trị liệu cao cấp - Máy matxa cổ",138000,138000,0,0
TIKI,lam-dep-suc-khoe,58053818,"Bấm Móng Tay Chân Thép Không Gỉ KỀM NGHĨA B.904 - Lưỡi Cong (Loại Nhỏ)",38000,40000,2000,5
TIKI,lam-dep-suc-khoe,1313893,"Xịt khử mùi chiết xuất thiên nhiên Refre Natural Rosemary Hương Thảo (30ml)",61300,65000,3700,6
TIKI,lam-dep-suc-khoe,270886117,"Vitamin E Mỹ Kirkland Signature E 180mg (400 IU) – Giúp đẹp da, tóc, làm chậm quá trình lão hóa và tăng sức khỏe tổng thể - QuaTangMe Extaste",459000,1002000,543000,54
TIKI,lam-dep-suc-khoe,32237380,"Kem dưỡng ban đêm Sắc Ngọc Khang dưỡng sáng và mờ thâm nám 30g",279000,300000,21000,7
TIKI,lam-dep-suc-khoe,72634041,"Sữa tắm coast sữa tắm nam 2in1 Coast Hair & Body Wash Classic Scent 532ml Pacific Force  ",129000,129000,0,0
TIKI,lam-dep-suc-khoe,75621730,"Viên Uống Hỗ Trợ Co Thắt Búi Trĩ Trimax Hủ 30 Viên Nguyên Liệu Từ Thiên Nhiên",210000,210000,0,0
TIKI,lam-dep-suc-khoe,77722505,"Cân điện tử thông minh Laica PS7011 - Cân đo 6 chỉ số - Mức cân tối đa 180 kg",550000,750000,200000,27
TIKI,lam-dep-suc-khoe,58451261,"Gói Bột Uống Giảm Nhanh Ợ Nóng Ợ Chua Trào Ngược Dạ Dày Fobe-AD (Hộp 20 gói).",153000,272250,119250,44
TIKI,lam-dep-suc-khoe,1628055,"Lăn Khử Mùi Giúp Khô Thoáng Vùng Da Dưới Cánh Tay 72h Vichy Detransprirant Intensif 72h Transpiration Excessive (50ml)",272000,320000,48000,15
TIKI,lam-dep-suc-khoe,247300543,"Tinh dầu Treo 100% Thiên nhiên - Nhà của Thời Thanh Xuân",132000,132000,0,0
TIKI,lam-dep-suc-khoe,3490281,"Nước Hoa Hồng Cân Bằng Và Điều Chỉnh Lỗ Chân Lông Paula's Choice Skin Balancing Pore Reducing Toner (190ml)",655000,729000,74000,10
TIKI,lam-dep-suc-khoe,46644605,"Cho máy Braun Oral-B, Bộ 4 đầu bàn chải đánh răng điện - Đánh bật cao răng- EB-25A-Cho răng sáng bóng",165000,165000,0,0
TIKI,lam-dep-suc-khoe,217417613,"Bao cao su mỏng khít LifeStyles Zero - Trơn êm -  Hộp 3 bao",75000,75000,0,0
TIKI,lam-dep-suc-khoe,194465122,"Bàn chải đánh răng điện LocknLock Smart oscillating electric toothbrush ENR626BLK - 3 chế độ, đế sạc cảm ứng, chống nước - Màu đen - Hàng Chính Hãng",775000,1490000,715000,48
TIKI,lam-dep-suc-khoe,76053236,"Combo 2 Sữa Tắm L'amont En Provence Rose (Hoa Hồng) Shower Gel 1000ml",329000,500000,171000,34
TIKI,lam-dep-suc-khoe,148895418,"Khẩu trang chống nắng Anti UV Soteria Ebony đạt chuẩn UPF 50+, chống khuẩn chống bụi siêu mịn 0.1 micro - Size S,M,L",171990,171990,0,0
TIKI,lam-dep-suc-khoe,107323260,"Combo 2 Chai Dầu Gội Và Xả Hoa Bưởi Thorakao 400ml",139900,139900,0,0
TIKI,lam-dep-suc-khoe,144191635,"Sáp Wax Lông An Lành / Wax Lông Nách Tay / Chân (Tặng giấy và que )",55000,55000,0,0
TIKI,lam-dep-suc-khoe,2616909,"Nước Tẩy Trang Làm Sạch Sâu & Kiểm Soát Bã Nhờn Cho Da Dầu Nhạy Cảm La Roche-Posay Micellar Water Ultra Oily Skin 400ml",390000,520000,130000,25
TIKI,lam-dep-suc-khoe,51696125,"Combo 2 Xịt toàn thân Romano Force tươi mát năng động 150ml",206000,206000,0,0
TIKI,lam-dep-suc-khoe,152709665,"Máy Tăm Nước Cầm Tay - Tăm Nước Vệ Sinh Răng Miệng Oral Irrigator - Bản Quốc Tế Chuẩn Châu Âu",169000,169000,0,0
TIKI,lam-dep-suc-khoe,117222715,"Máy Triệt Lông Vĩnh Viễn Tại Nhà Halio IPL Hair Removal Device 999999 Xung Ánh Sáng",2759000,3549000,790000,22
TIKI,lam-dep-suc-khoe,59289658,"Miếng Dán Say Tàu Xe Say Sóng Say Tàu Máy Bay ( Hộp 10 miếng )",78000,130350,52350,40
TIKI,lam-dep-suc-khoe,173224715,"Kem đánh răng Colgate thiên nhiên muối hồng Himalaya 180g",55000,55000,0,0
TIKI,lam-dep-suc-khoe,11254937,"Kem dưỡng trắng da ban đêm White Lucent Overnight Cream & Mask 75mL",2299000,2300000,1000,0
TIKI,lam-dep-suc-khoe,136029472,"Combo 30 bàn chải đánh răng Sunree",149000,149000,0,0
TIKI,lam-dep-suc-khoe,158788377,"COMBO 5 GÓI 400 CÂY Tăm chỉ nha khoa ENVIRONTMENT  - Chỉ Đức công nghệ Nhật ENVIRONTMENT",150000,175000,25000,14
TIKI,lam-dep-suc-khoe,106082135,"Viên uống rau củ DHC Nhật Bản bổ sung chất xơ, giảm nổi mụn giảm nóng trong và làm đẹp da JN-DHC-VEG",265000,297330,32330,11
TIKI,lam-dep-suc-khoe,112106515,"Máy tăm nước cầm tay FAIRYWILL FW-5020E máy tăm nước chính hãng Mỹ vệ sinh răng miệng cao cấp Thiết kế nhỏ gọn Sạc bằng USB Dễ mang đi du lịch Hàng Chính Hãng",726750,855000,128250,15
TIKI,lam-dep-suc-khoe,270808580,"Bổ não Úc Healthy Care Ginkgo Biloba 2000, Giúp tăng tuần hoàn máu não, Cải thiện chức năng nhận thức, Trí nhớ, Giúp an thần và Giảm Stress - OZ Slim Store",204000,498000,294000,59
TIKI,lam-dep-suc-khoe,41352350,"Mặt nạ giấy Maycreate HA Mask (hộp 20 miếng)",89000,125000,36000,29
TIKI,lam-dep-suc-khoe,53585343,"Dụng cụ cắt móng tay của nhật - Giao màu ngẫu nhiên",20549,38000,17451,46
TIKI,lam-dep-suc-khoe,84920809,"Dầu gội dược liệu Thái Dương 7 Plus",74800,74800,0,0
TIKI,lam-dep-suc-khoe,59052059,"Viên uống tăng cường nội tiết tố nữ Marilyn Plus 30 viên",215000,229000,14000,6
TIKI,lam-dep-suc-khoe,56648484,"Bigsize - Bộ sản phẩm tan mỡ bụng an toàn và hiệu quả Truesky gồm 1 kem tan mỡ bụng quế gừng 200g + 1 đại nịt bụng quấn nóng",320000,320000,0,0
TIKI,lam-dep-suc-khoe,97435337,"Cho máy Oral B Braun Cross Action EB-50A, Set Bộ 4 đầu bàn chải đánh răng điện đánh tan mảng bám",165000,165000,0,0
TIKI,lam-dep-suc-khoe,14422618,"Gối ngải cứu giảm đau xương khớp dùng lò vi sóng Hapaku",198000,230000,32000,14
TIKI,lam-dep-suc-khoe,1600023,"Combo 6 Băng Vệ Sinh Diana Siêu Thấm Siêu Mỏng Không Cánh (Gói 8 Miếng)",110000,126000,16000,13
TIKI,lam-dep-suc-khoe,35019646,"COMBO 10 MẶT NẠ 3W CLINIC 5 LOẠI DƯỠNG TRẮNG DA 7 NGÀY –CHIẾT XUẤT DƯA LEO, NHAU CỪU, ỐC SÊN , SỮA ONG CHÚA, NIACINAMIDE 3W CLINIC MASK SHEET 23ML/ MIẾNG",53000,53000,0,0
TIKI,lam-dep-suc-khoe,135973753,"Kem Dưỡng Ẩm A-Derma Cho Viêm Da Cơ Địa & Da Khô Exomega Allergo Emollient Cream 200ml",654000,770000,116000,15
TIKI,lam-dep-suc-khoe,251275874,"Gel bôi trơn KLY Gốc nước Thổ Nhĩ Kỳ",50000,55000,5000,9
TIKI,lam-dep-suc-khoe,13722426,"Lọ Tinh Dầu Thơm Phòng (khử mùi)",14000,25999,11999,46
TIKI,lam-dep-suc-khoe,2738479,"Bộ 2 Hộp Silcot Bông Trang Điểm (bông tẩy trang) Nhật Bản Cao Cấp (66 Miếng/Hộp)",72000,94000,22000,23
TIKI,lam-dep-suc-khoe,79411383,"Kem chống nắng Skin Aqua dưỡng da cho mặt khi hoạt động ngoài trời dạng gel Sunplay Skin Aqua Clear White Outdoor+ SPF50+ PA++++ 30g",102000,126000,24000,19
TIKI,lam-dep-suc-khoe,158564552,"Cold Wax - Wax Lông An Lành (Tặng 50 tờ giấy và 2 que wax)",55000,55000,0,0
TIKI,lam-dep-suc-khoe,11255782,"Kem bôi da Thuần Mộc 13g giảm bong tróc, mẩn ngứa, dị ứng da...",109000,109000,0,0
TIKI,lam-dep-suc-khoe,1192875,"Bút Kẻ Mắt Nét Siêu Mảnh Không Trôi Suri Waterproof Eyeliner Pen",74100,78000,3900,5
TIKI,lam-dep-suc-khoe,176554059,"Siro ho bổ phế Đ.Y chai 125ml - Giảm ho, ngứa rát cổ họng, khàn tiếng, bổ phổi từ thảo dược",18000,39000,21000,54
TIKI,lam-dep-suc-khoe,453901,"Nước Súc Miệng Ngăn Ngừa Vôi Răng Listerine Tartar Protection (750ml) - 8850007811695",146000,187000,41000,22
TIKI,lam-dep-suc-khoe,59080318,"Sữa Dưỡng Thể Hatomugi Body Lotion 400ml",104000,144900,40900,28
TIKI,lam-dep-suc-khoe,653804,"Lưỡi Dao Cạo Gillette Vector 4",50000,50000,0,0
TIKI,lam-dep-suc-khoe,130774948,"Kem dưỡng trắng da toàn thân Yococi giúp da trắng mịn, ngăn ngừa lão hoá White Perfect Body Lotion",153000,300000,147000,49
TIKI,lam-dep-suc-khoe,22052319,"Sữa rửa mặt cho nam Oxy sạch sâu giảm mụn kiểm soát nhờn dạng kem Oxy Total Anti Acne 100g",69000,86000,17000,20
TIKI,lam-dep-suc-khoe,1600057,"Combo 6 Băng Vệ Sinh Diana Super Night 35cm (Gói 3 Miếng)",115000,126000,11000,9
TIKI,lam-dep-suc-khoe,142762405,"Sữa dưỡng thể Vaseline dưỡng trắng da 725ml",155000,155000,0,0
TIKI,lam-dep-suc-khoe,108693621,"Gel chống nắng dưỡng ẩm Hada Labo Koi-Gokujyun Perfect Uv Gel (Sunscreen) SPF50+ PA++++ 50g",250000,280000,30000,11
TIKI,lam-dep-suc-khoe,170404655,"Combo 5 Hộp Khẩu trang Bông Bạch Tuyết KF94 4 lớp trắng (10 cái/hộp)",100000,100000,0,0
TIKI,lam-dep-suc-khoe,270879502,"Vitamin B Kirkland Super B-Complex tăng khả năng nấp thụ, chuyển hóa năng lượng, tăng cường hệ miễn dịch, giảm căng thẳng - QuaTangMe Extaste",709000,1418000,709000,50
TIKI,lam-dep-suc-khoe,118536461,"Nước Tẩy Trang Dành Cho Mọi Loại Da Oribe Bi-Phase Makeup Removal 200g",167000,210000,43000,20
TIKI,lam-dep-suc-khoe,270185520,"Tinh Dầu Nguyên Chất 24Care 50ml - Tinh Dầu Xông Thơm Phòng Giúp Giảm Căng Thẳng, Thư giãn, Đuổi Muỗi và Khử Mùi - Tinh dầu Sả Chanh/ Cam Ngọt/ Oải hương/ Ngọc Lan Tây/ Tràm Trà/ Bưởi Ngọt/ Vỏ Quế",215000,215000,0,0
TIKI,lam-dep-suc-khoe,35239920,"Bàn chải điện Xiaomi Shell DR-BEI Sonic BET-C01- Hàng Nhập Khẩu",469000,469000,0,0
TIKI,lam-dep-suc-khoe,63189246,"Combo 2 Xịt khử mùi Charming/Sensation/Magic/Delightful/Romantic 150ml/Chai",176000,220000,44000,20
TIKI,lam-dep-suc-khoe,45150752,"Xịt mũi viêm xoang thảo dược Rohto Nosewash 35ml",58000,58000,0,0
TIKI,lam-dep-suc-khoe,149969411,"Combo Hỗ Trợ Ngăn Ngừa Các Triệu Chứng Của Trĩ Giúp Co Búi Trĩ Dân Khang Trimax ",264000,339000,75000,22
TIKI,lam-dep-suc-khoe,12478871,"Gel Rửa Mặt và Tắm Cho Da Đang Bị Kích Ứng A-Derma Shower Gel Hydra-Protective (200ml)",347000,408000,61000,15
TIKI,lam-dep-suc-khoe,250020365,"Máy xông tinh dầu phòng ngủ tạo ẩm phun sương khuếch tán tinh dầu làm thơm phòng, khử mùi nhà vệ sinh trụ tròn - Hàng chính hãng Vinbuy",225000,450000,225000,50
TIKI,lam-dep-suc-khoe,187597380,"[Combo bộ 2] -  Hỗ Trợ Trị Sẹo Actiscar làm mờ sẹo Lồi, Sẹo Lõm, Sẹo Rỗ, Sẹo Thâm Lâu Năm",610000,799000,189000,24
TIKI,lam-dep-suc-khoe,146643977,"01 Thùng 03 hộp Nước uống đẹp da The Collagen Shiseido (Hộp 10 chai x 50mL)",1467000,1467000,0,0
TIKI,lam-dep-suc-khoe,8211882,"Nhíp Vỉ Giấy N-404 - Kềm Nghĩa",41800,44000,2200,5
TIKI,lam-dep-suc-khoe,43827108,"Trà Orihiro đốt mỡ và kiểm soát cân nặng an toàn (20 gói) Nội địa Nhật Bản",150000,177660,27660,16
TIKI,lam-dep-suc-khoe,251584913,"Túi Chườm Giữ Nhiệt Nóng Mini Họa Tiết Hoạt Hình Giữ Ấm Giảm Đau Nhanh Chóng",19000,20000,1000,5
TIKI,lam-dep-suc-khoe,185077932,"Gôm xịt tóc nam nữ BRITISH M Hard Tailor Spray giữ nếp, dễ dàng đổi kiểu 80ml",167400,180000,12600,7
TIKI,lam-dep-suc-khoe,8142221,"Kềm Cắt Móng Thép Không Gỉ Kềm Nghĩa M-01",175750,185000,9250,5
TIKI,lam-dep-suc-khoe,136855309,"Dầu gội nam Bergami hương nước hoa Shocking Man - Hương nước hoa nam tính - Lịch lãm - Sạch gàu vượt trội",155000,239000,84000,35
TIKI,lam-dep-suc-khoe,215910811,"Kem khử mùi hôi nách , dưỡng da chăm sóc cơ thể loại nhỏ 3ml",1000,1000,0,0
TIKI,lam-dep-suc-khoe,73841542,"Dầu gội giảm gàu, rụng tóc dành cho da dầu Vichy Dercos Anti-Dandruff DS (200mL)",332000,415000,83000,20
TIKI,lam-dep-suc-khoe,190843443,"Máy massage đeo tay Phú Quý (tặng kèm 1 bộ than)",519000,519000,0,0
TIKI,lam-dep-suc-khoe,24405272,"Máy tỉa lông mũi ",30990,30990,0,0
TIKI,lam-dep-suc-khoe,14924192,"Lăn khử mùi giảm tiết mồ hôi Etiaxil Deodorant Anti-transpirant 48H Roll On 50ml ",249000,289000,40000,14
TIKI,lam-dep-suc-khoe,165091719,"Viên Uống DHC Biotin Ngăn Rụng Tóc Sustained Release Biotin 30 Ngày (30 Viên)",140000,160000,20000,13
TIKI,lam-dep-suc-khoe,877332,"Combo 5 Giấy Thấm Dầu Mayan Than Hoạt Tính (100 Tờ)",144000,175000,31000,18
TIKI,lam-dep-suc-khoe,72042163,"Khẩu Trang Y Tế 4 Lớp Nam Anh (Hộp 50 Cái - Màu Đen)",24000,35000,11000,31
TIKI,lam-dep-suc-khoe,67088623,"Máy Xông Tinh Dầu Vân Gỗ 550ML Chuyên Dụng Cho Phòng Lớn Có Remote Điều Khiển Từ Xa Kèm Đèn LED Thay Đổi Màu Cực Đẹp",224000,528000,304000,58
TIKI,lam-dep-suc-khoe,76786308,"Tinh Dầu Xông Phòng HOA HỒNG TIDAMO 50ML - Tinh Dầu Hoa Hồng Cao Cấp Nhập Khẩu Tạo Hương Thơm Thư Giãn, Kích Thích Cảm Giác Lãng Mạn, Giải Tỏa Mệt Mõi",148000,230000,82000,36
TIKI,lam-dep-suc-khoe,121482721,"Combo Dầu gội, Dầu xả, Kem ủ & Serum TRESEMME Keratin Smooth Dưỡng tóc vào nếp suôn mượt với công thức Hydrolyzed Keratin 640g, 620g, 180ml, 97ml",576000,836000,260000,31
TIKI,lam-dep-suc-khoe,194040396,"Bộ 2 Nước súc miệng cho răng nhạy cảm Listerine Total Care Sensitive Soothing Taste 750ml/chai",288000,374000,86000,23
TIKI,lam-dep-suc-khoe,73276050,"Nước Tẩy Trang Bí Đao Cocoon 500ml",250750,295000,44250,15
TIKI,lam-dep-suc-khoe,141556736,"Máy tăm nước Colgate cầm tay IPX7 trắng sáng răng",1590000,1590000,0,0
TIKI,lam-dep-suc-khoe,59599863,"Viên uống bổ mắt, tăng cường thị lực Fons Vision (30 viên)",250000,250000,0,0
TIKI,lam-dep-suc-khoe,172120367,"Thuốc nhỏ mắt Eyemiru 40EX giảm viêm, ngứa mắt (Hộp 1 lọ 15ml)",74000,74000,0,0
TIKI,lam-dep-suc-khoe,85396315,"Thực phẩm chức năng bổ sung cho Xương Khớp. Kirkland Glucosamine HCl 1500mg with MSM (375 Viên) - Mỹ",590000,590000,0,0
TIKI,lam-dep-suc-khoe,104655988,"Combo SÁNG DA - MỜ THÂM DHC Nhật Bản gồm viên uống vitamin C và viên uống trắng da 30 ngày JN-DHC-CB1",340000,381480,41480,11
TIKI,lam-dep-suc-khoe,70771723,"Nhiệt kế điện tử hồng ngoại đo trán không chạm Yamada - đo nhanh 1 giây, cảnh báo sốt, màn hình 3 màu đèn, đo sữa, nước tắm, nhiệt độ phòng",399000,399000,0,0
TIKI,lam-dep-suc-khoe,102018794,"Dầu gội Nguyên Xuân bồng bềnh - Chai 250ml Mẫu mới - Dùng cho tóc bết, xẹp, nhiều dầu - Hoàn toàn từ thảo dược",102000,160000,58000,36
TIKI,lam-dep-suc-khoe,273564866,"Canxi Mỹ Kirkland Signature Calcium Citrate Magnesium And Zinc with Vitamin D3 phát triển hệ thống xương, phòng loãng xương - QuaTangMe Extaste",249000,526000,277000,53
TIKI,lam-dep-suc-khoe,44106900,"Máy tăm nước Panasonic cầm tay dùng pin sạc EW1211 - Hàng Chính Hãng",2200000,2200000,0,0
TIKI,lam-dep-suc-khoe,6398571,"Kem phục hồi dịu da và kháng khuẩn Dermalibour + Repairing Cream A-Derma 50ml",354000,417000,63000,15
TIKI,lam-dep-suc-khoe,108535183,"Bao cao su Sagami Are Are - Có gai - Hộp 10 chiếc",115000,160000,45000,28
TIKI,lam-dep-suc-khoe,75409136,"Tinh Dầu Lavender Nguyên Chất Nhập Khẩu 50ML (Oải Hương), Tinh Dầu Xông Phòng Oải Hương Giúp Thư giản, Khử Trùng Và Bảo Vệ Sức Khỏe, Sử Dụng Với Máy Xông Tinh Dầu Cho Gia Đình Và Văn Phòng",98000,296000,198000,67
TIKI,lam-dep-suc-khoe,74561072,"Tinh dầu Sả Chanh Nguyên Chất Nhập Khẩu 10ML - Tinh dầu Xông Phòng Sả Chanh (Lemongrass) Giúp Bảo Vệ Sức Khỏe, Kháng Khuẩn, Đuổi Muỗi Và Thư Giãn Tinh Thần",38000,76000,38000,50
TIKI,lam-dep-suc-khoe,71200200,"Viên tinh nghệ mật ong (MS) -250g",159000,200000,41000,21
TIKI,lam-dep-suc-khoe,143709242,"Dầu xả Nguyên xuân từ thảo dược - Dưỡng tóc mềm mượt, bồng bềnh, giảm chẻ ngọn, gãy rụng - Tặng thêm 30ml, Tổng 180ml",74000,130000,56000,43
TIKI,lam-dep-suc-khoe,10640154,"Sữa rửa mặt kiểm soát nhờn ngăn ngừa mụn dạng gel Acnes Oil Control Cleanser 100g",56000,70000,14000,20
TIKI,lam-dep-suc-khoe,8211888,"Nhíp Vỉ Giấy N-409 - Kềm Nghĩa",38000,40000,2000,5
TIKI,lam-dep-suc-khoe,73532408,"Gel Bôi Trĩ Giúp Co Búi Trĩ, Hỗ Trợ Giảm Sưng Đỏ Và Ngứa Rát Hậu Môn Do Trĩ Trimaxgel 20g - Nguyên Liệu Nhập Khẩu Từ Châu Âu",115000,129000,14000,11
TIKI,lam-dep-suc-khoe,55614663,"Kem Nền Che Khuyết Điểm Kiềm Dầu Chống Nắng Dưỡng Da Ngăn Ngừa Lão Hóa Công Nghệ Nano Vàng Cellkey-Scien Multi Action BB Cream (30ml)",612000,680000,68000,10
TIKI,lam-dep-suc-khoe,120318503,"Khẩu trang 5d mask Nam Anh (Famapro) - Hộp 10 cái",9900,18000,8100,45
TIKI,lam-dep-suc-khoe,577147,"Dầu Gội Hỗ Trợ Trị Gàu Stanhome Balance Shampoo 200ml - 07482",379000,379000,0,0
TIKI,lam-dep-suc-khoe,125838068,"Combo 8 gói Băng Vệ Sinh Kotex Hằng ngày Kháng khuẩn 20 miếng",120000,120000,0,0
TIKI,lam-dep-suc-khoe,118959851,"Gel rửa mặt tạo bọt cho da hỗn hợp và da dầu Bioderma Sebium Gel Moussant dạng tuýp - 200ml",309000,325000,16000,5
TIKI,lam-dep-suc-khoe,877404,"Combo 5 Giấy Thấm Dầu Mayan  (100 Tờ / Gói)",90100,110000,19900,18
TIKI,lam-dep-suc-khoe,16107344,"BỘ 10 MẶT NẠ LÔ HỘI DABO FIRST SOLUTION MASK PACK ALOEVERA",89000,89000,0,0
TIKI,lam-dep-suc-khoe,24161391,"Dầu gội ngăn ngừa gàu Davines Naturaltech Purifying shampoo 250ml",270750,285000,14250,5
TIKI,lam-dep-suc-khoe,80780129,"Combo 3 Khẩu Trang 3D MONA MASK N99 Chống Nắng Tia Uv Lọc 99% Bụi Mịn Pm 2.5",60000,60000,0,0
TIKI,lam-dep-suc-khoe,108535211,"Bao cao su Sagami Tight Fit - Thiết kế lượn sóng - Hộp 12 chiếc",110000,160000,50000,31
TIKI,lam-dep-suc-khoe,7980446,"Combo kem đánh răng 62g và bột tẩy trắng răng Eucryl 50g (Chính hãng)",109000,109000,0,0
TIKI,lam-dep-suc-khoe,70664831,"Nước Tẩy Trang Làm Sạch Sâu & Kiểm Soát Bã Nhờn Cho Da Dầu Nhạy Cảm La Roche-Posay Micellar Water Ultra Oily Skin 200ml",357000,420000,63000,15
TIKI,lam-dep-suc-khoe,21038056,"Băng Vệ Sinh Diana Băng Đêm Quần Size S-M-1807",31000,31000,0,0
TIKI,lam-dep-suc-khoe,185940709,"[SIZE DU LỊCH] Nước tẩy trang Sắc Ngọc Khang 30ml giúp làm sạch da bụi bẩn, bã nhờn, ngăn ngừa mụn hiệu quả",19000,30000,11000,37
TIKI,lam-dep-suc-khoe,71523904,"KÉO CẮT TÓC 6.0 Inch CHUYÊN NGHIỆP HAND MADE JAPAN (1 Bộ)",185000,189000,4000,2
TIKI,lam-dep-suc-khoe,70661243,"Gel rửa mặt tạo bọt làm sạch & giảm nhờn cho da dầu nhạy cảm La Roche-Posay Effaclar Purifying Foaming Gel (400ml)",468000,625000,157000,25
TIKI,lam-dep-suc-khoe,55622025,"Nước Hoa Hồng Kiềm Dầu Kiểm Soát Bã Nhờn Cân Bằng Độ Ẩm Da Dầu Mụn Nhạy Cảm Dewytree The Clean Lab AC DEW Calamine Toner 200ml",414000,460000,46000,10
TIKI,lam-dep-suc-khoe,44140593,"MẶT NẠ THẢI ĐỘC HỖ TRỢ TRỊ MỤN TẬN GỐC THAN HOẠT TÍNH, BÙN KHOÁNG DOUBLE DETOX MASK (20 GR) LÀM DỊU MỤN ĐỎ, LÀM SẠCH SÂU, THẢI ĐỘC DA, TRẮNG DA, MỜ NÁM.",249000,315000,66000,21
TIKI,lam-dep-suc-khoe,119289800,"Dao Cạo Râu Chuyên Nghiệp NQ88",65550,69000,3450,5
TIKI,lam-dep-suc-khoe,14708536,"Bộ máy đo đường huyết Safe Accu tặng 1 hộp 50 que thử và hộp 50 kim chích máu",245000,299000,54000,18
TIKI,lam-dep-suc-khoe,217174306,"[+Tặng mũ trùm] Kem ủ tóc Collagen Karseell Maca phục hồi siêu mượt 100ml/500ml",64000,64000,0,0
TIKI,lam-dep-suc-khoe,8142287,"Kềm Cắt Da Thép Chuyên Dụng Kềm Nghĩa D-18",76000,80000,4000,5
TIKI,lam-dep-suc-khoe,53061315,"Combo 10 Túi mặt nạ giấy dưỡng trắng da - mặt na dưỡng trắng da chiết xuất Than Hoạt Tính 3w Clinic Hàn Quốc 23ml x 10",56000,56000,0,0
TIKI,lam-dep-suc-khoe,16631908,"Xà Phòng Rửa Mặt Và Giảm Mụn Acne-Aid Bar 100g",79000,96000,17000,18
TIKI,lam-dep-suc-khoe,73351823,"Sáp vuốt tóc BY VILAIN DYNAMITE CLAY 65 ml",419000,419000,0,0
TIKI,lam-dep-suc-khoe,141354715,"Dầu gội gừng Weilaiya cao cấp 400ml - trị rụng tóc, kích thích mọc tóc",275000,345000,70000,20
TIKI,lam-dep-suc-khoe,54157777,"Bộ Chiết Mỹ Phẩm Du Lịch Tiện Dụng 5 in1 P91",36000,36000,0,0
TIKI,lam-dep-suc-khoe,30157357,"Nước bí đao cân bằng da (Winter melon toner) Cocoon 140ml",156000,195000,39000,20
TIKI,lam-dep-suc-khoe,196851276,"Tinh Dầu Khóm Homer 100ml- Tinh Dầu Xông Thơm Phòng, Thư Giãn Khử Mùi- Tinh Dầu Trái Cây Thiên Nhiên",69000,69000,0,0
TIKI,lam-dep-suc-khoe,196855083,"Tinh Dầu Me Homer 100ml - Tinh Dầu Xông Thơm Phòng, Thư Giãn Khử Mùi - Tinh Dầu Trái Cây Thiên Nhiên",69000,69000,0,0
TIKI,lam-dep-suc-khoe,196472716,"Tinh Dầu Dưa Hấu Homer 100ML - Tinh Dầu Xông Thơm Phòng, Thư Giãn Khử Mùi - Tinh Dầu Trái Cây Thiên Nhiên",69000,69000,0,0
TIKI,lam-dep-suc-khoe,196559916,"Tinh Dầu Hoa Bưởi Homer 100ml - Chính Hãng, Đạt Chuẩn Kiểm Định Cao Cấp - Tinh Dầu Xông Thơm Phòng, Thư Giãn, Khử Mùi hiệu quả",149000,149000,0,0
TIKI,lam-dep-suc-khoe,115960176,"Tinh bột nghệ nhiều curcumin  HNT 500g - Đã được kiểm nghiệm an toàn chất lượng thực phẩm- dùng khi, dưỡng da, đau dạ dày",319000,319000,0,0
TIKI,lam-dep-suc-khoe,3490097,"Tinh chất thu nhỏ lỗ chân lông Paula's Choice 10% Niacinamide Booster 20ml",1790000,1790000,0,0
TIKI,lam-dep-suc-khoe,190119235,"Vaseline Gluta-Hya Dưỡng Thể Nâng Tông Tức Thì Gấp 4 Lần 300ML",149000,190000,41000,22
TIKI,lam-dep-suc-khoe,185812640,"Lăn Khử Mùi Perspirex (Strong / Original / Comfort) Roll-On Chính Hãng",270000,270000,0,0
TIKI,lam-dep-suc-khoe,83341326,"Bộ đôi bàn chải Colgate Cushion Clean công nghệ tạo bọt kem siêu mịn",122000,122000,0,0
TIKI,lam-dep-suc-khoe,103376023,"Tinh Dầu Thiên Nhiên Nguyên Chất HOMER Sả Chanh/ Quế/ Oải hương/ Bưởi/ Cam/ Hoa Lài/ Quýt/ Tràm Huế/ Hoa Hồng/ Lavender/ Ngọc Lan Tây/ Tràm Trà/ Sả Java/ Trà Xanh/ Cà Phê/ Chanh (20ml)",66000,66000,0,0
TIKI,lam-dep-suc-khoe,11261516,"Gel Rửa Mặt Tràm Trà, 0.5% BHA COSRX Low pH Good Morning Gel Cleanser 150ml",129000,129000,0,0
TIKI,lam-dep-suc-khoe,191683087,"Son Kem Lì Bbia Last Velvet Lip Tint ASIA EDITION Version 2 (6 Màu) 5g Bbia Official Store",150000,290000,140000,48
TIKI,lam-dep-suc-khoe,169585227,"Serum B5 Basic Hydration DrCeutics Cho Da Dầu Mụn",127400,140000,12600,9
TIKI,lam-dep-suc-khoe,270549484,"Mần đậu nành Healthy Care Super Lecithin Úc Tăng cường chức năng gan khỏe mạnh, nâng cao sức khỏe, sắc đẹp từ bên trong - QuaTangMe Extaste",238000,600000,362000,60
TIKI,lam-dep-suc-khoe,77924648,"Serum (Tinh Chất) Vitamin C Zakka Naturals GlowFruit+ Brightening 20g",490000,490000,0,0
TIKI,lam-dep-suc-khoe,89785222,"Dung Dịch Vệ Sinh Phụ nữ Lactacyd Odor Fresh Ngăn Mùi 24H 150ml",55000,59000,4000,7
TIKI,lam-dep-suc-khoe,114778830,"[Chính Hãng] Combo 2 Bàn Chải Đánh Răng Điện Zenyum Sonic - BxP - Bàn Chải Điện HOT - Công Nghệ Singapore",2029000,2600000,571000,22
TIKI,lam-dep-suc-khoe,176254169,"Nhụy hoa nghệ tây saffron Kingdom Herb chính hãng loại super negin thượng hạng hộp 1 gram (tặng bình thuỷ tinh cao cấp)",275000,539000,264000,49
TIKI,lam-dep-suc-khoe,11254935,"Gel dưỡng trắng da Shiseido White Lucent Brightening Gel Cream 50mL",1849000,1850000,1000,0
TIKI,lam-dep-suc-khoe,161256063,"Sữa tắm cho nam sạch sâu, khử mùi cơ thể Oxy Deep Shower",73700,74000,300,0
TIKI,lam-dep-suc-khoe,73607516,"Sữa Rửa Mặt Dịu Nhẹ Cetaphil Gentle Skin Cleanser 500ml",368000,419000,51000,12
TIKI,lam-dep-suc-khoe,118124169,"Viên uống WIT bổ mắt (30 viên)",330000,330000,0,0
TIKI,lam-dep-suc-khoe,22293001,"Combo sữa rửa mặt kiểm soát bã nhờn chiết xuất từ than hoạt tính , sửa rữa mặt ngăn ngừa mụn, phục hồi da chiết xuất từ trà xanh, sửa rữa mặt làm sáng mịn da chiết xuất từ lúa mạch 3W CLINIC ",75000,75000,0,0
TIKI,lam-dep-suc-khoe,102017943,"Bổ gan cà gai leo - Hộp 60 viên - Hỗ trợ giải độc, bảo vệ gan, thanh nhiệt từ thảo dược",61000,190000,129000,68
TIKI,lam-dep-suc-khoe,39180106,"Tinh chất chống lão hóa da The Ordinary Retinol 1% in Squalane 30ml",349000,349000,0,0
TIKI,lam-dep-suc-khoe,152015621,"Cho máy Oral B Braun Cross Action EB-50A, Set 4 cái/ vỉ, Bộ 4 đầu bàn chải đánh răng điện đánh tan mảng bám. Tặng kèm móc khóa – Minh House",155000,155000,0,0
TIKI,lam-dep-suc-khoe,67242465,"Kem Dưỡng Mắt Tích Hợp Máy Rung Massage JOMTAM Hỗ Trợ Giảm Quầng Thâm Bọng Mắt",65000,95000,30000,32
TIKI,lam-dep-suc-khoe,86539325,"Combo 6 Băng vệ sinh thảo dược Doctor Care, BVS ban ngày 24cm siêu khô thoáng cả ngày dài",177000,198000,21000,11
TIKI,lam-dep-suc-khoe,876442,"Tẩy Trang Bioderma Sensibio H2O (500ml)",525000,525000,0,0
TIKI,lam-dep-suc-khoe,9858922,"Máy khuếch tán tinh dầu giọt nước lớn gỗ nâu Lorganic FX2023 + tinh dầu sả chanh + tinh dầu cam Lorganic (10ml x2)/ Phun sương sóng siêu âm.",300000,550000,250000,45
TIKI,lam-dep-suc-khoe,114458769,"Máy nâng cơ mặt, Giảm nhăn, Tăng sinh collagen, Công nghệ Nhật Bản 2021 Cổ thiên nga",289000,289000,0,0
TIKI,lam-dep-suc-khoe,73341539,"Tinh Dầu BẠC HÀ Cao Cấp TIDAMO 10ML - Tinh Dầu Bạc Hà Nguyên Chất Nhập Khẩu Sử Dụng Với Máy Xông Tinh Dầu Giúp Bảo Vệ Sức Khỏe, Kháng Khuẩn, Thư Giãn Tinh Thần và Xua Đuổi Côn Trùng",29000,76000,47000,62
TIKI,lam-dep-suc-khoe,14773441,"Combo 2 Kem bôi da Thuần Mộc 13g dưỡng ẩm da, giảm bong tróc, mẩn ngứa",211000,211000,0,0
TIKI,lam-dep-suc-khoe,131504691,"Bột nhuộm tóc dược liệu màu đen Sao Thái Dương hộp 5 gói",90000,90000,0,0
TIKI,lam-dep-suc-khoe,77749869,"Tinh Dầu Xông Phòng BẠC HÀ 50ML + Tinh Dầu Treo Phòng Treo Xe ô tô Bạc Hà (Peppermint) - Tinh Dầu Bạc Hà TIDAMO Nguyên Chất Giúp Bảo Vệ Sức Khỏe, Kháng Khuẩn, Thư Giãn Tinh Thần Và Xua Đuổi Côn Trùng",128000,256000,128000,50
TIKI,lam-dep-suc-khoe,12478881,"Dầu Gội hỗ trợ điều trị Gàu Mảng, Vảy Nến Ducray Kertyol P.S.O Shampoo (125ml)",297000,350000,53000,15
TIKI,lam-dep-suc-khoe,131194676,"Son Lì Dưỡng Nhẹ Môi Luxury Mộc An Không Chứa Chì Giúp Dưỡng Hồng Bền Màu 4g",180000,200000,20000,10
TIKI,lam-dep-suc-khoe,155114275,"Lăn Khử Mùi Đá Khoáng Dạng Sáp Cho Mọi Loại Da Deonatulle Soft Stone Double Deodorant 20g",241380,298000,56620,19
TIKI,lam-dep-suc-khoe,88253798,"Set 2 gói băng vệ sinh LAURIER ban đêm 30cm x 9 miếng",83600,88000,4400,5
TIKI,lam-dep-suc-khoe,157525704,"Serum Vitamin C 16% + Tranexamic Acid 3% DrCeutics Ngăn Ngừa Lão Hóa Và Làm Sáng Da",309400,340000,30600,9
TIKI,lam-dep-suc-khoe,83202743,"Kem đánh răng Colgate làm trắng răng khoáng núi lửa 100g",50000,50000,0,0
TIKI,lam-dep-suc-khoe,186291963,"Gối Chườm Nóng Thảo Dược Hapaku - Làm Nóng Bằng Điện",945000,1150000,205000,18
TIKI,lam-dep-suc-khoe,100021983,"Khẩu trang người lớn cao cấp MAYAN PM2.5 3D MASK, gói 5 chiếc",22000,32000,10000,31
TIKI,lam-dep-suc-khoe,210145521,"Bột Diếp Cá nguyên chất UMIHOME 40G bột uống giúp thanh nhiệt giải đọc và đắp mặt nạ ngừa mụn dưỡng da hiệu quả tại nhà",85000,160000,75000,47
TIKI,lam-dep-suc-khoe,145626650,"Bông Tắm",18000,18000,0,0
TIKI,lam-dep-suc-khoe,53983620,"Lược chải tóc con cố định tóc vào nếp",33900,33900,0,0
TIKI,lam-dep-suc-khoe,214604822,"Miếng dán kích mí trong suốt Suri tặng kèm móc khoásuri",41000,45000,4000,9
TIKI,lam-dep-suc-khoe,205073081,"Gel bôi trơn mát lạnh - Shell Cooling - Chai 100ml",220800,240000,19200,8
TIKI,lam-dep-suc-khoe,117336427,"Máy tăm nước cầm tay FAIRYWILL FW-5020E Bản Màu Trắng Thiết kế nhỏ gọn Sạc bằng USB Dễ mang đi du lịch Hàng Chính Hãng",643500,715000,71500,10
TIKI,lam-dep-suc-khoe,91257464,"Combo 6 Băng vệ sinh hàng ngày  thảo dược Doctor Care 16 cm siêu khô thoáng cả ngày dài",150000,168000,18000,11
TIKI,lam-dep-suc-khoe,55891615,"Bigsize - Kem ủ trắng toàn thân Truesky Whitening Body Cream chiết xuất rễ cây cam thảo 200g",250000,250000,0,0
TIKI,lam-dep-suc-khoe,37173216,"Máy Đốt Nốt Ruồi, Mụn Thịt 9 Cấp Độ Cao Cấp-Thế Hệ Mới",265000,265000,0,0
TIKI,lam-dep-suc-khoe,14057131,"Bộ Bấm Cắt Tỉa Cá Nhân 12 Món - Kềm Bấm Móng Tay",30650,30650,0,0
TIKI,lam-dep-suc-khoe,271447973,"Bổ não Úc Healthy Care Ginkgo Biloba Hỗ trợ các vấn đề tuần hoàn não, Cải Thiện Trí Nhớ, lưu thông máu, Tăng khả năng nhận thức - Massel Official",204000,498000,294000,59
TIKI,lam-dep-suc-khoe,161490393,"Dung dịch vệ sinh phụ nữ đũa thần inner OZO Feelex Care",85000,150000,65000,43
TIKI,lam-dep-suc-khoe,196463350,"Tinh Dầu Nho Homer 100ml - Xông Thơm Phòng, Thư Giãn Khử Mùi - Tinh Dầu Trái Cây Thiên Nhiên",45000,45000,0,0
TIKI,lam-dep-suc-khoe,50737117,"Sáp Vuốt Tóc Apestomen Volcanic Clay V4 + Lược Trifecta Comb",249000,249000,0,0
TIKI,lam-dep-suc-khoe,13802592,"Dầu Gội Dược Liêu Nguyên Xuân (Chai 200ml)",64800,64800,0,0
TIKI,lam-dep-suc-khoe,162196430,"Sữa Rữa Mặt Laneige Water Bank Blue HA Cleansing Foam 150g",529000,600000,71000,12
TIKI,lam-dep-suc-khoe,88041250,"Combo 10 Mặt nạ tế bào gốc nhau thai cừu Rwine Beauty Stem Cell Placenta Mask",120000,240000,120000,50
TIKI,lam-dep-suc-khoe,77650571,"MÁY KHUẾCH TÁN TINH DẦU TRỤ TRONG 500 ML - MÁY XÔNG TINH DẦU PHUN SƯƠNG CHÍNH HÃNG KRISHNA - TẶNG KÈM REMOTE - MÁY XÔNG TINH DẦU SIÊU ÂM PHUN SƯƠNG CHUYÊN DỤNG CHO KHÔNG GIAN LỚN - ĐÈN LED 7 MÀU TRANG TRÍ  RẤT ĐẸP",225000,299000,74000,25
TIKI,lam-dep-suc-khoe,13884713,"Dầu Gội Hoa Bưởi Thorakao 500ml",47000,47000,0,0
TIKI,lam-dep-suc-khoe,34151280,"Nhiệt Kế Điện Tử Microlife MT 550",189000,189000,0,0
TIKI,lam-dep-suc-khoe,17595716,"Tinh dầu gỗ thông đen  Lorganic Pine black 10ml/ Hương thơm ấm nồng/ Tinh dầu thiên nhiên nguyên chất xông phòng/ Thư giãn tinh thần/ Thích hợp dùng với đèn xông và máy khuếch tán.",45000,80000,35000,44
TIKI,lam-dep-suc-khoe,164434272,"Kit Test Nhanh Covid 19 Tại Nhà Bằng Nước Bọt hoặc dịch mũi ( 2in1), Bộ Y Tế cấp phép lưu hành",25000,25000,0,0
TIKI,lam-dep-suc-khoe,91753273,"hộp 10 chiếc Bao cao su SuperMen có gai và ngăn ngừa xuất tinh sớm , nhập khẩu , chất bôi trơn tốt ",54150,57000,2850,5
TIKI,lam-dep-suc-khoe,10597698,"Thực Phẩm Chức Năng CumarGold Kare - Hỗ trợ điều trị ung thư",360000,380000,20000,5
TIKI,lam-dep-suc-khoe,58204892,"COMBO 6 LÔ CUỐN TÓC MÚT XỐT SIÊU XIN  - Màu Ngẫu Nhiên",8000,30000,22000,73
TIKI,lam-dep-suc-khoe,188127813,"Nước uống collagen tổ yến giúp đẹp da, tăng cường sức khỏe Blossomy Premium lốc 10 chai x 50ml",750000,945000,195000,21
TIKI,lam-dep-suc-khoe,183737004,"Máy Triệt Lông Băng Lạnh Trẻ Hóa Da Halio IPL Cooling Hair Removal Device 999999 Xung Ánh Sáng",3749000,4450000,701000,16
TIKI,lam-dep-suc-khoe,94146543,"Serum Dưỡng Mày FEG EyeBrow Enhancer 3ml",280000,280000,0,0
TIKI,lam-dep-suc-khoe,102729650,"Gối Massage Toàn Thân Hồng Ngoại VISPO VP-G21D - Gối Mát Xa Cổ, Vai, Lưng Giảm Đau Mỏi Cơ Thể, Phù Hợp Sử Dụng Tại Nhà, Văn Phòng Hay Trên Ô tô",1950000,1950000,0,0
TIKI,lam-dep-suc-khoe,118090131,"Bộ 2 Viên Sủi Bổ Sung Vitamin C, D, Và Kẽm Redoxon Triple Action 10 Viên",170000,170000,0,0
TIKI,lam-dep-suc-khoe,112289302,"Mặt Nạ Ngủ Cho Môi Laneige Lip Sleeping Mask Berry EX 20g",405000,500000,95000,19
TIKI,lam-dep-suc-khoe,75814756,"Đai (Máy) Massage Bụng Nikio NK-169AC - Công Nghệ Rung Lắc Kết Hợp Bi Độ Xoay 360 Dây Ấn Thế Hệ Mới, Mát Xa Thư Giãn, Làm Săn Chắc Cơ Bụng Nhanh - Vỏ Nhựa Bền Bĩ",1416000,1990000,574000,29
TIKI,lam-dep-suc-khoe,117260689,"Bộ 2 dầu gội Palmolive 600ml Nha đam và Keratin kết hợp quả ô liu 600ml",236000,236000,0,0
TIKI,lam-dep-suc-khoe,166764904,"Nước muối sinh lý Vĩnh Phúc Natriclorid 0.9% (500ml)",9500,9500,0,0
TIKI,lam-dep-suc-khoe,176098197,"Sữa tắm mụn lưng ELDAS, sữa tắm giảm viêm nang lông, tinh chất TRÀM TRÀ KHỔ QUA diệt khuẩn ngăn ngừa mụn cơ thể 550ml",123000,189000,66000,35
TIKI,lam-dep-suc-khoe,135282855,"Miếng Dán Hạ Sốt Bye Bye Ferver- Made In Japan - Làm Mát Tức Thì, Dùng Trong Các Trường Hợp Sốt, Say Nắng, Đau Cơ",56800,56800,0,0
TIKI,lam-dep-suc-khoe,113714799,"Viên kẹo ngậm ho bạc hà Eucatana hộp 24 viên, kẹo ngậm bạc hà tiêu đờm, giảm đau họng",39900,39900,0,0
TIKI,lam-dep-suc-khoe,271617029,"Kẽm hỗ trợ trị mụn, làm đẹp da mụn Puritan'S Pride Premium Zinc For Acne Mỹ gồm kẽm và Vitamin C, B-6, A và E - OZ Slim Store",310000,620000,310000,50
TIKI,lam-dep-suc-khoe,7609680,"Kéo Cắt Tỉa Lông Mũi Đầu Tròn Kềm Nghĩa KM 604- Thép Không Gỉ Cao Cấp - Thiết Kế Nhỏ - Gọn - Nhẹ - An toàn",48450,51000,2550,5
TIKI,lam-dep-suc-khoe,43763060,"Kem bôi da Thuần Mộc Thanh Mộc Hương combo 2 Hộp",210000,210000,0,0
TIKI,lam-dep-suc-khoe,55136157,"Sữa Rữa Mặt SIMPLE Kind To Skin Dạng Gel Cho Da Nhạy Cảm UK",89000,89000,0,0
TIKI,lam-dep-suc-khoe,1082080,"Bao Cao Su Sagami Extreme Superthin (10 Chiếc)",60400,60400,0,0
TIKI,lam-dep-suc-khoe,186094161,"Bọt vệ sinh nam giới Oniiz Dung dịch vệ sinh nam tạo bọt Amorous (Hương Đam Mê) 100ml",120000,120000,0,0
TIKI,lam-dep-suc-khoe,126945359,"Bao cao su LifeStyles Fantasy Gân Ngang, Nhiều Gel Bôi Trơn tăng Khoái Cảm - Hộp 12 bao",99000,135000,36000,27
TIKI,lam-dep-suc-khoe,166084645,"KEM BODY COLLAGEN X3 WHITENING BODY CREAM MIX SAFFRON",92000,199000,107000,54
TIKI,lam-dep-suc-khoe,197416463,"Combo Bao cao su Durex Fetherlite Ultima Hộp 12 bao và Hộp 3 bao",288000,380000,92000,24
TIKI,lam-dep-suc-khoe,272043408,"Mầm đậu nành Úc Healthy Care Super Lecithin 1200mg tăng cường chức năng gan khỏe mạnh, nâng cao sức khỏe, sắc đẹp từ bên trong - OZ Slim Store",541000,1116000,575000,52
TIKI,lam-dep-suc-khoe,161029307,"Máy massage đầu gối không dây thông minh CTFAST: Công nghệ mát xa rung kết hợp nhiệt hồng ngoại, hỗ trợ điều trị đau khớp gối, pin sạc 6000mAh, chất liệu dễ dàng vệ sinh",699000,749000,50000,7
TIKI,lam-dep-suc-khoe,43822645,"Tinh Chất Dưỡng Trắng Da Giảm Thâm Nám Eucerin Double Bosster Serum (30ml)",1094000,1459000,365000,25
TIKI,lam-dep-suc-khoe,50326501,"Combo 2 Xịt toàn thân Romano Attitude nồng ấm cá tính 150ml",206000,206000,0,0
TIKI,lam-dep-suc-khoe,1218467,"Thực Phẩm Chức Năng Thuốc hỗ trợ Giảm Cân Học Viện Quân Y Slimtosen Extra (100 Viên)",170000,170000,0,0
TIKI,lam-dep-suc-khoe,58173357,"Kem Body Mềm Dưỡng Trắng Da Acosmetics 250G",110000,175000,65000,37
TIKI,lam-dep-suc-khoe,74492258,"Bộ 2 Diana Sensi Băng quần size M-L (5 miếng/ gói)",139000,139000,0,0
TIKI,lam-dep-suc-khoe,271408234,"Hỗ trợ mọc tóc Natrol Biotin Beauty giúp tóc mọc nhanh dài, dày hơn,   làn da rạng rỡ và móng tay chắc khỏe - Massel Official",323000,646000,323000,50
TIKI,lam-dep-suc-khoe,214661875,"Gel rửa mặt ngăn ngừa mụn Nerman Nano Curcumin 60s Fresh dành riêng cho nam làm sạch sâu, ngăn ngừa vi khuẩn gây mụn (100ml)",99000,178000,79000,44
TIKI,lam-dep-suc-khoe,157271444,"Kem dưỡng trắng da mặt Truesky Whitening Face Cream chiết xuất sữa ong chúa 20g",170000,170000,0,0
TIKI,lam-dep-suc-khoe,1601791,"Tinh Dầu Cho Da Mụn The Body Shop Tea Tree Oil (20ml)",319000,449000,130000,29
TIKI,lam-dep-suc-khoe,57783000,"Natureine AQUA PEEL Moisture Peeling Gel - Gel tẩy tế bào da chết, cấp ẩm Nhật Bản - Chính Hãng",499000,550000,51000,9
TIKI,lam-dep-suc-khoe,411327,"Nước Xịt Khoáng Dưỡng Da Vichy 150ml - 100829485",288000,339000,51000,15
TIKI,lam-dep-suc-khoe,8142225,"Kềm Cắt Móng Thép Chuyên Dụng Kềm Nghĩa M-555",99750,105000,5250,5
TIKI,lam-dep-suc-khoe,694481,"Tinh Dầu Vỏ Quế Nguyên Chất Lorganic (10ml)",40000,80000,40000,50
TIKI,lam-dep-suc-khoe,104799777,"Nhíp Inox Đầu Xéo Nhổ Lông Mày Cao Cấp Kềm Nghĩa N.425",19950,21000,1050,5
TIKI,lam-dep-suc-khoe,16279231,"Dầu gội cao cấp Romano Classic cổ điển lịch lãm tóc chắc khỏe 900gr",185000,234000,49000,21
TIKI,lam-dep-suc-khoe,10117454,"Nước Gội Đầu Bồ Kết Và Vỏ Bưởi Mộc Nhu Hỗ Trợ Trị Rụng Tóc Trị Gàu 300ml",169000,169000,0,0
TIKI,lam-dep-suc-khoe,195669496,"Thanh Lăn Mụn MS Lighting Acne Spot Roller (5ml), Hỗ Trợ Giảm Mụn, Mờ Vết Thâm, Thông Thoáng Lỗ Chân Lông - MỸ PHẨM MS COSMETIC",129000,129000,0,0
TIKI,lam-dep-suc-khoe,123582725,"Serum Dưỡng Ẩm Phục Hồi Da GoodnDoc Hydra B5 - Serum B5 GoodnDoc 30ml",395000,450000,55000,12
TIKI,lam-dep-suc-khoe,50926033,"Nước Hoa Hồng Ý Dĩ HATOMUGI 500ml",113000,240000,127000,53
TIKI,lam-dep-suc-khoe,20470519,"Băng vệ sinh ban ngày Laurier có cánh -Hàng nội địa Nhật nhập khẩu",75000,75000,0,0
TIKI,lam-dep-suc-khoe,75946733,"Combo Cà phê đắk lắk Tẩy da chết Body cocoon 200ml + Tẩy da chết Mặt cocoon 150ml",232000,290000,58000,20
TIKI,lam-dep-suc-khoe,196857071,"Tinh Dầu Táo Xanh Homer 100ml - Tinh Dầu Xông Thơm Phòng, Thư Giãn Khử Mùi - Tinh Dầu Trái Cây Thiên Nhiên",79000,79000,0,0
TIKI,lam-dep-suc-khoe,75409313,"Tinh Dầu Lavender Cao Cấp Nhập Khẩu 10ML, Tinh Dầu Xông Phòng Oải Hương Giúp Thư giản, Khử Trùng Và Bảo Vệ Sức Khỏe, Sử Dụng Với Máy Xông Tinh Dầu Cho Gia Đình Và Văn Phòng",38000,116000,78000,67
TIKI,lam-dep-suc-khoe,103757761,"Khẩu Trang Y Tế Cao Cấp SUN CLOUD - 4 Lớp Kháng Khuẩn / 99% Lọc Khuẩn, Bụi, Virus Tốt Nhất / Người Lớn",29800,29800,0,0
TIKI,lam-dep-suc-khoe,73609586,"Máy xông tinh dầu VINBUY bầu tiên, máy phun sương tạo ẩm, máy xông tinh dầu phòng ngủ, spa, tự động, chuyên dụng phòng lớn led 07 màu - Hàng chính hãng",199000,500000,301000,60
TIKI,lam-dep-suc-khoe,71161537,"[ MUA 1 TẶNG 1] Viên ăn ngon Multi Vitamin Plus hộp 30 viên_ Hỗ trợ cải thiện biếng ăn, cải thiện cân nặng, giúp ăn ngon ngủ ngon, tăng cường sức đề kháng",485000,485000,0,0
TIKI,lam-dep-suc-khoe,101034119,"Dung dịch vệ sinh nam Serenys Optimus làm sạch khử mùi làm sáng phụ khoa nam giới",299000,299000,0,0
TIKI,lam-dep-suc-khoe,33254716,"Kem dưỡng ẩm chống nắng ban ngày Hada Labo Koi-Gokujyun UV White Gel SPF50+ PA++++ 90g",370000,415000,45000,11
TIKI,lam-dep-suc-khoe,273457539,"Đệm Massage Toàn Thân VP-N20D - Máy Massage Chất Liệu Da Cao Cấp, Công Nghệ Massage Hiện Đại 10 Điểm Rung Kết hợp Nhiệt Hồng Ngoại Và Bi Massage Cổ VaI, Gáy",1399000,1699000,300000,18
TIKI,lam-dep-suc-khoe,169812757,"Sữa chống nắng mỏng nhẹ lâu trôi giúp bảo vệ da tối ưu khỏi tia UVA dài La Roche-Posay Anthelios Uvmune 400 Invisible Fluid 50ml",448000,560000,112000,20
TIKI,lam-dep-suc-khoe,82107182,"Bộ Dao Cạo Râu 38 Món",30000,30000,0,0
TIKI,lam-dep-suc-khoe,11861149,"Kem Gót Sen - Phục Hồi Và Tái Tạo Làn Da Nứt Nẻ",28000,28000,0,0
TIKI,lam-dep-suc-khoe,270845561,"Collagen Type 1,2,3 Youtheory Mỹ tăng độ đàn hồi da, đẹp tóc, móng, duy trì sức khỏe sụn, gân, dây chằng, khớp - QuaTangMe Extaste",479000,1074000,595000,55
TIKI,lam-dep-suc-khoe,161234656,"Tinh chất làm mờ thâm nám và đều màu da tối ưu Paula's Choice Clinical Discoloration Repair Serum 30ml 8040",1599000,1599000,0,0
TIKI,lam-dep-suc-khoe,105622045,"Bộ 3 Bao Cao Su Durex Fetherlite – Hộp 12 bao",597000,828000,231000,28
TIKI,lam-dep-suc-khoe,143222291,"Kem Đánh Răng Crest 3D White Advanced 147gr",139000,139000,0,0
TIKI,lam-dep-suc-khoe,196560436,"Tinh Dầu Hoa Mộc Lan Homer 100ml - Chính Hãng, Đạt Chuẩn Kiểm Định Cao Cấp - Tinh Dầu Xông Thơm Phòng, Thư Giãn, Khử Mùi hiệu quả",119000,119000,0,0
TIKI,lam-dep-suc-khoe,73517801,"Kem Dưỡng Trắng Da Chống Nắng Ban Ngày Oribe Chống Lão Hóa Mờ Thâm Nám Dưỡng Ẩm 30g",251000,320000,69000,22
TIKI,lam-dep-suc-khoe,160762447,"Tinh Dầu Oải Hương Treo Phòng, Treo Xe ô tô (Lavender) Chính Hãng TIDAMO Giúp Thơm Thư giản, Kháng Khuẩn Và Bảo Vệ Sức Khỏe",38000,76000,38000,50
TIKI,lam-dep-suc-khoe,214691217,"Nước hoa nam chính hãng Nerman - hương thơm nhẹ nhàng, tinh tế thu hút nữ giới, phù hợp đi hẹn hò, đi chơi, đi làm lưu hương tới 8h 10ml",109000,218000,109000,50
TIKI,lam-dep-suc-khoe,76369248,"Tinh Dầu Ngọc Lan Tây Nguyên Chất 50ML TIDAMO (Ylang Ylang) - Tinh Dầu Cao Cấp Nhập Khẩu Từ Ấn Độ, Xông Hương Thơm Phòng, Thư Giãn, Nâng Cao Sức Khỏe - Kiểm Nghiệm Chất Lượng Tại Trung Tâm Quatest 3",128000,256000,128000,50
TIKI,lam-dep-suc-khoe,196857628,"Tinh Dầu Kiwi Homer 100ml - Tinh Dầu Xông Thơm Phòng, Thư Giãn Khử Mùi - Tinh Dầu Trái Cây Thiên Nhiên",79000,79000,0,0
TIKI,lam-dep-suc-khoe,77543516,"Son lì Bbia Last Powder Lipstick 3.5g ( 6 màu )",160000,290000,130000,45
TIKI,lam-dep-suc-khoe,50017132,"Cây Massage Đầu Thư  Giản Xả Stress - Màu Ngẫu Nhiên",3900,3900,0,0
TIKI,lam-dep-suc-khoe,273010004,"Hỗ trợ giảm đau nhức xương khớp Schiff Move Free Mỹ nâng cao sức khỏe khớp, sụn và xương, tăng khả năng vận động linh hoạt thoải mái-QuaTangMe Extaste",747000,1570000,823000,52
TIKI,lam-dep-suc-khoe,11239286,"Gel tẩy da chết Arrahan Lemon White Peeling Gel (180ml)",61900,61900,0,0
TIKI,lam-dep-suc-khoe,108535195,"Bao cao su Sagami Feel Long - Có gai nhỏ - Hộp 10 chiếc",95000,120000,25000,21
TIKI,lam-dep-suc-khoe,196562071,"Tinh Dầu Linh Lan Homer 100ml - Chính Hãng, Đạt Chuẩn Kiểm Định Cao Cấp - Tinh Dầu Xông Thơm Phòng, Thư Giãn, Khử Mùi hiệu quả",129000,129000,0,0
TIKI,lam-dep-suc-khoe,15456663,"Titan Gel phiên bản Gold giới hạn giúp tăng kích thước, kéo dài thời gian, tăng ham muốn cho nam giới (hàng chuẩn Nga)",290000,290000,0,0
TIKI,lam-dep-suc-khoe,51420955,"Kem chống lão hóa chuyên sâu chứa Retinol và Bakuchiol- 8015",1699000,1699000,0,0
TIKI,lam-dep-suc-khoe,94474520,"Cây Lấy Khóe Đầu Nhọn Inox Hỗ Trợ Móc Khóe và Vệ Sinh Khóe KỀM NGHĨA",7600,8000,400,5
TIKI,lam-dep-suc-khoe,62758138,"Kem dưỡng giúp làm dịu, làm mượt, làm mát & phục hồi da phù hợp cho trẻ em La Roche-Posay Cicaplast Baume B5 100ml",532000,665000,133000,20
TIKI,lam-dep-suc-khoe,55108914,"Combo 2 Sữa Tắm Cherry Blossom 500ml - L'amont En Provence",189000,298000,109000,37
TIKI,lam-dep-suc-khoe,22052322,"Sữa rửa mặt cho nam Oxy sạch sâu giảm nhờn dạng kem có hạt massage Oxy Deep Wash 100g",69000,86000,17000,20
TIKI,lam-dep-suc-khoe,68553320,"Tinh bột nghệ nguyên chất Beemo - Đắp mặt, điều trị dạ dày đau bao tử, làm viên tinh nghệ mật ong",69000,105000,36000,34
TIKI,lam-dep-suc-khoe,12421675,"Son lì lâu trôi không khô môi hàng nội địa Nhật Bản cao cấp Naris Cosmetic Ailus Smooth Lipstick Long Lasting – Hàng Chính Hãng",175000,175000,0,0
TIKI,lam-dep-suc-khoe,190641510,"Sữa Rửa Mặt Dịu Nhẹ Cho Da Dầu CeraVe Foaming Cleanser 236ml",289000,340000,51000,15
TIKI,lam-dep-suc-khoe,66786807,"Trunature Ginkgo Biloba 340 Viên hàng Mỹ - Mẫu 2020",465000,465000,0,0
TIKI,lam-dep-suc-khoe,192325645,"Viên uống WIT bổ mắt (60 viên)",590000,590000,0,0
TIKI,lam-dep-suc-khoe,160534770,"Kem Đa Năng Lucas Papaw Ointment 25g(Hàng nội địa Úc)",128000,185000,57000,31
TIKI,lam-dep-suc-khoe,16994625,"Tinh dầu để thơm phòng hương thơm dễ chịu và rất là thơm khử được mọi loại mùi",24000,24000,0,0
TIKI,lam-dep-suc-khoe,8294948,"Thực phẩm chức năng Viên uống bổ sung Collagen Youtheory (Collagen Type 1-2-3) 390 Viên",549000,549000,0,0
TIKI,lam-dep-suc-khoe,71925436,"Mặt nạ ngủ dạng thạch Collagen nâng cơ chính hãng YANJIAYI (Hộp 20 gói)",48000,95000,47000,49
TIKI,lam-dep-suc-khoe,1951095,"Nước Đông Trùng Hạ Thảo Hàn Quốc",90000,90000,0,0
TIKI,lam-dep-suc-khoe,11954438,"Dung Dịch Vệ Sinh Phụ Nữ Kháng Khuẩn Khử Mùi Oriss Làm Sạch Dịu Nhẹ Chiết Xuất Lá Trầu Không Cân Bằng pH - 150ml",50000,63000,13000,21
TIKI,lam-dep-suc-khoe,107144886,"[CHÍNH HÃNG] Khẩu trang y tế trẻ em quai vải Famapro 5D Mask Kid - Bé Dưới 10 Tuổi [ HỘP",11900,11900,0,0
TIKI,lam-dep-suc-khoe,149425187,"Sữa tắm trắng da cánh hoa hồng Damask Weilaiya Grand Rose Extracts Whitening Shower Gel 450ml",388000,488000,100000,20
TIKI,lam-dep-suc-khoe,96271731,"Máy xông tinh dầu siêu âm công nghệ hiện đại  - Chế độ phun mạnh - Khuếch tán tinh dầu trong không gian rộng - Hoạt động liên tục 18h",216000,360000,144000,40
TIKI,lam-dep-suc-khoe,177897403,"Thạch nghệ Saffron Daily Curcumin 247 Nhật Bản vị chuối tăng cường sức khỏe, làm đẹp da hiệu quả",40000,40000,0,0
TIKI,lam-dep-suc-khoe,56986002,"Dầu Gội Tăng Cường Dưỡng Chất Giúp Giảm Rụng Tóc Vichy Dercos Energising Shampoo Hairloss 200ml ( Mẫu mới)",332000,415000,83000,20
TIKI,lam-dep-suc-khoe,270866437,"DHC rau củ nhật bổ sung chất sơ, vitamin, dưỡng chất từ 32 loại rau+củ+hạt hỗ trợ tăng cường sức khỏe chung - QuaTangMe Extaste",710000,1420000,710000,50
TIKI,lam-dep-suc-khoe,16344389,"Dầu gội tím khử ánh vàng cho tóc trắng bạch kim Elgon Silver Colorcare Silver shampoo Italy 300ml",303000,330000,27000,8
TIKI,lam-dep-suc-khoe,185096114,"Kem Xoá Mờ Sẹo Actiscar, Mờ Sẹo Lồi, Sẹo Lõm, Sẹo Thâm, Sẹo Rỗ lâu năm 20g",358000,499000,141000,28
TIKI,lam-dep-suc-khoe,131504615,"Dầu gội dược liệu Thái Dương 7 200ml / 480ml / 1100ml",100000,100000,0,0
TIKI,lam-dep-suc-khoe,56918293,"Son Dưỡng Dầu Dừa Bến Tre Cocoon ",27200,32000,4800,15
TIKI,lam-dep-suc-khoe,74853177,"Tinh Dầu Xông Phòng Cam Ngọt Cao Cấp (ORANGE) - Tinh dầu Cam Nguyên Chất Sử Dụng Với Máy Khuếch Tán Tinh Dầu Giúp Thư Giãn Tinh Thần, Khử Mùi, Xua Đuổi Côn Trùng",38000,76000,38000,50
TIKI,lam-dep-suc-khoe,104401469,"Combo 2 Kem Tẩy Lông Cho Da Thường Veet Silk Fresh 50G",122000,140200,18200,13
TIKI,lam-dep-suc-khoe,76168193,"[HỘP - FAMAPRO 5D MASK] - Khẩu trang y tế kháng khuẩn 3 lớp Famapro 5D Mask (10 cái/ hộp) - COMBO 5 HỘP",49500,49500,0,0
TIKI,lam-dep-suc-khoe,36385805,"Mỡ Trăn N'store Nguyên Chất Triệt Lông Vĩnh Viễn, Giảm Bỏng Da, Dưỡng Da, Ngăn Ngừa Rạn Nứt Da (1 Chai 100ML)",63000,90000,27000,30
TIKI,lam-dep-suc-khoe,157856445,"Kem Dưỡng Hatomugi Chiết Xuất Ý Dĩ Làm Sáng Da 300g Moisturizing Conditioning The Milky Cream",133000,135000,2000,1
TIKI,lam-dep-suc-khoe,135349213,"Túi trườm nóng bụng kinh nguyệt PUHA 350ml, túi chườm ấm bụng cho bạn nữ giảm đau",149000,149000,0,0
TIKI,lam-dep-suc-khoe,71512916,"Dầu gội thảo dược gừng dừa Cocayhoala hỗ trợ trị gàu, hết ngứa, dung tích 440g-95% thành phần từ gừng tươi hữu cơ còn nguyên xơ gừng, hỗ trợ trị rụng tóc, kích thích mọc tóc vượt trội, an toàn cho mẹ bầu mẹ sau sinh",349000,349000,0,0
TIKI,lam-dep-suc-khoe,68743966,"Nước hoa bỏ túi Romano Vip Vision sang trọng cuốn hút 18ml",48000,54000,6000,11
TIKI,lam-dep-suc-khoe,191319822,"Dầu gội sạch gàu Mochi Medical Nhật Bản. Sạch gàu, sạch ngứa trong 2 tuần",99000,99000,0,0
TIKI,lam-dep-suc-khoe,52853259,"TPBVSK hỗ trợ Tăng Chiều Cao NuBest Tall Cho Độ Tuổi Từ 5-20",1090000,1450000,360000,25
TIKI,lam-dep-suc-khoe,562334,"Xịt Ngăn Mùi Toàn Thân Romano Gentleman 150ml",103000,103000,0,0
TIKI,lam-dep-suc-khoe,178302264,"Sáp tạo kiểu tóc giữ nếp lâu vượt trội Restyleable Clay Wax 68g/hộp",74000,82000,8000,10
TIKI,lam-dep-suc-khoe,140628020,"Xịt Chống Nắng Bảo Vệ Da Tối Ưu Summer SUN Spray SPF 50 PA++++ 100ml",231000,231000,0,0
TIKI,lam-dep-suc-khoe,119706866,"Sữa tắm dưỡng ẩm cho viêm da cơ địa Cetaphil Pro AD Derma Wash 295ml",422000,480000,58000,12
TIKI,lam-dep-suc-khoe,75440616,"Bộ 3 Kem Đánh Răng Colgate Herbal Salt Muối Thảo Dược 225g/tuýp x 3",123000,123000,0,0
TIKI,lam-dep-suc-khoe,257857032,"Đầu Bàn Chải Điện LocknLock ENR546BLK (4pcs) - Màu Đen",131000,252000,121000,48
TIKI,lam-dep-suc-khoe,104288718,"Viên uống trắng da DHC Nhật Bản dưỡng ẩm và làm mịn da thực phẩm chức năng 30 ngày JN-DHC-ADL30",199000,274890,75890,28
TIKI,lam-dep-suc-khoe,186516401,"Gối Chườm Nóng Thảo Mộc Đa Năng Hapaku Giảm Đau Mỏi Cổ Vai Gáy, Lưng Hông, Giúp Ngủ Ngon Hơn, Gối Thảo Mộc Đa Năng - Size Lớn",349000,580000,231000,40
TIKI,lam-dep-suc-khoe,59078477,"Máy Xông Khí Dung Omron NE-C106",680000,1083000,403000,37
TIKI,lam-dep-suc-khoe,2579159,"Máy đo huyết áp tự động bắp tay Omron JPN600",1750000,1750000,0,0
TIKI,lam-dep-suc-khoe,694391,"Tinh Dầu Sả Chanh Lorganic Hương Thơm Thiền Tịnh (50ml)",115000,195000,80000,41
TIKI,lam-dep-suc-khoe,3598571,"Bộ 10 gói mặt nạ dưỡng ẩm da chiết xuất nha đam 3W Clinic Fresh Aloe Mask Sheet 23ml X 10",51000,51000,0,0
TIKI,lam-dep-suc-khoe,185881834,"Serum Mụn Oriskin GenZ White Acne Loại Sạch Mụn Viêm, Trứng Cá Và Mụn Đầu Đen 15ml, Tặng Kèm Vòng Tay May Mắn",249000,249000,0,0
TIKI,lam-dep-suc-khoe,10122631,"Nước Đông Trùng Hạ Thảo Hector Sâm ( Hộp 10 chai ) - Bổ Sung Năng Lượng, Tăng Cường Sinh Lý Và Sinh Lực Cho Người Làm Việc Cường Độ Cao, Chơi Thể Thao",436000,450000,14000,3
TIKI,lam-dep-suc-khoe,272283366,"Glucosamine 1500mg Kirkland Signature Mỹ Giảm đau nhức xương khớp, tạo chất nhầy bôi trơn khớp, hỗ trợ vận động linh hoạt hiệu quả - OZ Slim Store",655000,1310000,655000,50
TIKI,lam-dep-suc-khoe,76169379,"[HỘP - FAMAPRO 5D BABY] - Khẩu trang y tế trẻ em kháng khuẩn 3 lớp Famapro 5D Baby (10 cái/ hộp) - COMBO 3 HỘP",26500,26500,0,0
TIKI,lam-dep-suc-khoe,76217766,"Xịt mọc tóc nhanh tinh dầu vỏ bưởi Tabaha 120ml dành cho Nam giới bị rụng tóc, tóc thưa",80000,80000,0,0
TIKI,lam-dep-suc-khoe,15863570,"Dầu gội kích thích mọc tóc Obsidian Orzen Loss Control shampoo 320ml",295000,315000,20000,6
TIKI,lam-dep-suc-khoe,977113,"Hộp 5 Đôi Nút Bịt Tai Ultra Soft Foam® Mack's #925",129000,129000,0,0
TIKI,lam-dep-suc-khoe,23485049,"Dầu gội ngăn ngừa rụng tóc Davines Naturaltech Energizing shampoo chính hãng Ý 250ml",270750,285000,14250,5
TIKI,lam-dep-suc-khoe,139947502,"[COMBO 3 HỘP - FAMAPRO 4D KIDS] - Khẩu trang trẻ em kháng khuẩn cao cấp Famapro 4D KIDS tiêu chuẩn KF94 (10 cái/ hộp)",32700,45000,12300,27
TIKI,lam-dep-suc-khoe,40888300,"Dầu Gội Cặp Weilaiya Thảo Dược Mọc Tóc Hỗ Trợ Trị Gàu Dưỡng Tóc, Đen Tóc Cho Tóc Nhuộm Tinh Chất Gừng Cao Cấp Chiết Xuất 100% Từ Thiên Nhiên Không Chứa Sunfat Tạo Bọt (Gội: 400ml- Xả: 250ml)- Sản Phẩm Chính Hãng",550000,685000,135000,20
TIKI,lam-dep-suc-khoe,72933632,"Túi Chườm Nóng Lạnh Giữ Nhiệt Đa Năng Chườm Bụng Hiệu Quả 350ml - Dùng Cho Các Bạn Nữ Chườm Đau Bụng Kinh Nguyệt",63000,63000,0,0
TIKI,lam-dep-suc-khoe,105631257,"Bộ 3 Bao Cao Su Durex Sensual Strawberry - Hộp 3 chiếc",135000,153000,18000,12
TIKI,lam-dep-suc-khoe,104558007,"Dầu Dừa Tinh Khiết Vietcoco Dưỡng Mi 10ml",28000,28000,0,0
TIKI,lam-dep-suc-khoe,56217414,"Bộ đôi bàn chải đánh răng Colgate than hoạt tính kháng vi khuẩn SlimSoft Charcoal mềm mảnh",87000,87000,0,0
TIKI,lam-dep-suc-khoe,28342176,"Nhiệt Kế Điện Tử Đo Tai, Trán Beurer Ft65 + Tặng Đèn Soi Tai",749000,1108000,359000,32
TIKI,lam-dep-suc-khoe,116877498,"MÁY SPO2 ĐO NỒNG ĐỘ OXY TRONG MÁU (Sản phẩm đã bao gồm pin)",165000,199000,34000,17
TIKI,lam-dep-suc-khoe,176098213,"Sữa rửa mặt tinh chất TRÀM TRÀ tự nhiên cho da mụn giảm nhờn trắng da 100ml",58000,109000,51000,47
TIKI,lam-dep-suc-khoe,23591172,"KEM ĐÁNH RĂNG SENSIKIN NGĂN NGỪA Ê BUỐT 75ML",152000,152000,0,0
TIKI,lam-dep-suc-khoe,101079933,"Bàn chải điện Colgate Sonic 360 Charcoal với lông chải phủ than kháng khuẩn",325000,441000,116000,26
TIKI,lam-dep-suc-khoe,114778819,"[Chính Hãng] Bộ Bàn Chải Đánh Răng Điện Zenyum Sonic & 3 Đầu Thay Thế - Công Nghệ Singapore - Màu Đen",1649000,1649000,0,0
TIKI,lam-dep-suc-khoe,158856083," Đệm xông chườm ngải cứu đa năng giúp giảm đau mỏi (Tặng 3 điếu ngải)",299500,299500,0,0
TIKI,lam-dep-suc-khoe,158018228,"Tinh Dầu Hoa Nhài TIDAMO 50ML Nhập Khẩu, Có Kiểm Nghiệm, Hương Thơm Dịu Nhẹ Quý Phái - Tinh Dầu Hoa Lài (Jasmine) Xông Thơm Phòng, Thư Giãn và Tốt Cho Sức Khỏe",128000,256000,128000,50
TIKI,lam-dep-suc-khoe,95648746,"Bấm móng tay Victorinox Nail Clipper 8.2050.B1",490000,490000,0,0
TIKI,lam-dep-suc-khoe,11197614,"Tinh chất làm mềm, mượt và sáng da body 10% AHA - Paula's Choice Skin Revealing Body Lotion 10% AHA",950000,950000,0,0
TIKI,lam-dep-suc-khoe,79411382,"Kem chống nắng Skin Aqua cho da nhạy cảm dạng gel dùng hàng ngày Sunplay Skin Aqua Mild Care Gel SPF50+ PA+++ 25g",107000,125000,18000,14
TIKI,lam-dep-suc-khoe,174222507,"Đệm, Ghế Massage Cao Cấp KingTech KC-500s - Máy Mát Xa Lưng Chế Độ 3D Chuyên Sâu, Kết Hợp Tính Năng Nhiệt Hồng Ngoại - Hàng Chính Hãng",1995000,3200000,1205000,38
TIKI,lam-dep-suc-khoe,55086997,"Serum Dưỡng Mi Dài Dày Khỏe FEG Eyelash Enhancer 3ml",219000,219000,0,0
TIKI,lam-dep-suc-khoe,107426808,"Combo 3 Chai Nước Hoa Hồng Thorakao 150ml",188900,188900,0,0
TIKI,lam-dep-suc-khoe,179141545,"Thùng 300 CÁI khẩu trang KF94 kháng khuẩn, chống bụi mịn, công nghệ 4D Hàn Quốc",205000,205000,0,0
TIKI,lam-dep-suc-khoe,37975485,"Tinh Chất cho da nhạy cảm Skin1004 Madagascar Centella Asiatica Ampoule 100ml",309000,500000,191000,38
TIKI,lam-dep-suc-khoe,20832207,"Can Nước rửa tay khử mùi Mr.Fresh 5L Hương Dâu",162000,162000,0,0
TIKI,lam-dep-suc-khoe,109652081,"Bộ 3 Kem đánh răng Colgate thiên nhiên muối hồng Hymalaya 180g",165000,165000,0,0
TIKI,lam-dep-suc-khoe,184444737,"Sữa rửa mặt dịu nhẹ Pharmacity Sensitive Skin Cleanser (500ml)",183400,262000,78600,30
TIKI,lam-dep-suc-khoe,123929183,"[Đo nhanh , Chính Xác Trong 1 Giây] Nhiệt kế hồng ngoại đo trán Microlife FR1MF1 - Thương Hiệu Thụy Sĩ ",799000,799000,0,0
TIKI,lam-dep-suc-khoe,163875673,"[ New Arrival ] - COMBO 3 chiếc khẩu trang N99 ngăn đến 99% hạt bụi siêu mịn có kích thước từ 0,3 Mircromet #MONA MASK",60000,60000,0,0
TIKI,lam-dep-suc-khoe,125582323,"Dầu Gội OGX Chiết Xuất Hoa Anh Đào/ Bạch Đàn Bạc Hà - Dung Tích 385ml",295000,295000,0,0
TIKI,lam-dep-suc-khoe,42785265,"Tinh Chất Dưỡng The Ordinary Hyaluronic Acid 2 % + B5 (60ml)",589000,589000,0,0
TIKI,lam-dep-suc-khoe,907532,"Bộ sản phẩm rửa mũi tiện dụng Rohto NoseWash (1 bình vệ sinh mũi Easy Shower + 1 chai dung dịch 400ml)",95000,95000,0,0
TIKI,lam-dep-suc-khoe,58676878,"Combo 2 Lăn khử mùi trắng da Enchanteur Charming 50ml/ Chai",140000,184000,44000,24
TIKI,lam-dep-suc-khoe,147967099,"DATE XA Sữa Tắm Double Rich hương hoa tự nhiên Hàn Quốc - 800g - Hương Hoa Iris Dreamy Romance",139000,139000,0,0
TIKI,lam-dep-suc-khoe,409945,"Thực Phẩm Chức Năng Viên Uống Sữa Ong Chúa Costar Royal Jelly 1450mg - Hộp 365 Viên",490000,490000,0,0
TIKI,lam-dep-suc-khoe,44303212,"Dầu gội dược liệu Nguyên Xuân nâu 250ml (Dành cho tóc thường)",78600,78600,0,0
TIKI,lam-dep-suc-khoe,172800186,"Máy Massage Cổ SKG G7-PRO",2969000,4590000,1621000,35
TIKI,lam-dep-suc-khoe,77046342,"DẦU DỪA TINH KHIẾT ORGANIC VIETCOCO, PET 1 LIT",185000,185000,0,0
TIKI,lam-dep-suc-khoe,71989770,"Sữa rửa mặt dạng Gel Decumar Clean Advanced 50gr hoàn toàn mới kiểm soát nhờn mụn",77000,77000,0,0
TIKI,lam-dep-suc-khoe,4424813,"Thực Phẩm Chức Năng Tảo Xoắn Spirulina Nhật Bản Hộp 2200 Viên",331000,331000,0,0
TIKI,lam-dep-suc-khoe,117927020,"1 Bộ Kit test nhanh COVID Humasis Covid-19 Ag Test CHÍNH HÃNG",35000,35000,0,0
TIKI,lam-dep-suc-khoe,148812247,"Serum INOD Huyền Phi Khử mùi hôi nách, hôi chân Tặng Kèm Gội (Xả) Mini Weilaiya Ngẫu Nhiên",191000,191000,0,0
TIKI,lam-dep-suc-khoe,270988813,"Vitamin C Puritan's Pride with Bioflavonoids & Rose Hips -1000mg tăng sức đề kháng, làm đẹp da - QuaTangMe Extaste",335000,670000,335000,50
TIKI,lam-dep-suc-khoe,12478857,"Kem Làm Mềm Da, Dịu Kích Ứng A-Derma Cho Da Khô Đến Rất Khô Exomega Control Emollient Cream (50ml)",308000,363000,55000,15
TIKI,lam-dep-suc-khoe,11590559,"Kem dưỡng ẩm, mờ nếp nhăn - Vitamin E, Jojoba, Vitamin A - ENAT NATURAL VITAMIN E Mega We Care (Tuýp 30g)",100000,110000,10000,9
TIKI,lam-dep-suc-khoe,37405722,"Cà Phê Xanh Hỗ Trợ Giảm Cân Thiên Nhiên Việt (Hộp 10 Gói)",130000,130000,0,0
TIKI,lam-dep-suc-khoe,122225120,"DẦU GỘI PASIORI TM COLLAGEN & BIOTIN TRẮNG PHỤC HỒI, MỀM MƯỢT NGĂN GÃY RỤNG TÓC ITALY 1000ML [MẪU MỚI]",182000,195000,13000,7
TIKI,lam-dep-suc-khoe,6759739,"Bộ 3 Kem đánh răng Colgate Sensitive ngăn ê buốt và bảo vệ toàn diện 110g/tuýp",145000,207000,62000,30
TIKI,lam-dep-suc-khoe,172111067,"DẦU GỘI TÍM ELGON COLOR CARE SILVER SHAMPOO KHỬ ÁNH VÀNG CHO TÓC BẠCH KIM",313500,330000,16500,5
TIKI,lam-dep-suc-khoe,119253125,"Sữa dưỡng ẩm cho da nhạy cảm Cetaphil Moisturizing Lotion 200ml",278000,316000,38000,12
TIKI,lam-dep-suc-khoe,35933597,"Sữa Rửa Mặt Làm Sạch Và Giảm Mụn Acne-Aid Liquid Cleanser 100ml",175000,175000,0,0
TIKI,lam-dep-suc-khoe,126945372,"Bao Cao Su LifeStyles Classic Thiết Kế Mỏng, Ôm sát vừa vặn, Nhiều Gel Bôi Trơn - Hộp 3 bao",29000,35000,6000,17
TIKI,lam-dep-suc-khoe,116244839,"Máy Massage Cao Cấp KINGTECH ST-502B - Giúp Tuần Hoàn, Giảm Đau Mỏi - Mát xa Thư Giãn Bàn Và Bắp Chân Tích Hợp Nhiệt Kèm Điều Khiển Cầm Tay - Quà Tặng Ý Nghĩa Cho Người Thân",2300000,3350000,1050000,31
TIKI,lam-dep-suc-khoe,102108970,"Viên Nghệ Mật Ong Cao Cấp HNT 300g – Viên Tinh Bột Nghệ Mật Ong Tự Nhiên – 100% Nguyên Liệu Tụ Nhiên – Hoàn Toàn An Toàn Cho Sức Khỏe -  Sản Phẩm Chính Hãng – Uy Tín",179000,179000,0,0
TIKI,lam-dep-suc-khoe,74763869,"Bao cao su Ritex Longtime - kéo dài thời gian bằng vòng đôi cao su, hộp 3 chiếc",87000,87000,0,0
TIKI,lam-dep-suc-khoe,72556249,"Viên uống DHC Bổ Sung Vitamin E Nhật Bản 20 Ngày",99000,110000,11000,10
TIKI,lam-dep-suc-khoe,113215733,"[5 Trong 1- Mờ Nám- Tàn Nhang, Tăng Vòng 1, Cân Bằng Nội Tiết Tố, Sinh Lý Nữ ]] - Viên Uống Glutathione - Hàng Chính Hãng Dr Lacir",580000,580000,0,0
TIKI,lam-dep-suc-khoe,442980,"Dầu Gội Dove Phục Hồi Hư Tổn (900g) - 21062569",179000,179000,0,0
TIKI,lam-dep-suc-khoe,247955149,"Collagen Cho Nam Youtheory Mỹ Chứa Collagen, Vitamin C, Biotin… Tạo Sức Khỏe Từ Bên Trong Cho Da, Tóc, Móng, Sụn, Gân, Dây Chằng, Khớp, Tim Mạch Và Tăng Hệ Miễn Dịch - QuaTangMe Extaste",608000,1254000,646000,52
TIKI,lam-dep-suc-khoe,105515020,"Gel Bí Đao Rửa Mặt Cocoon 310ml",250750,295000,44250,15
TIKI,lam-dep-suc-khoe,167129299,"Máy đo huyết áp điện tử bắp tay Sinocare BA-801 Đức + Tặng bộ đổi nguồn ( Adapter )",320000,320000,0,0
TIKI,lam-dep-suc-khoe,171873291,"Bộ đôi sản phẩm Siêu Nghệ Decumar Advanced sạch các loại mụn và sáng da sau 2 tuần sử dụng",170000,182000,12000,7
TIKI,lam-dep-suc-khoe,73921463,"Dầu gội tím khử vàng chăm sóc và làm sáng màu tóc RRline Therapy Sliver Shampoo 350ml",205200,270000,64800,24
TIKI,lam-dep-suc-khoe,92159205,"Combo Bao cao su Durex Pleasuremax Hộp 12 Bao và hộp 3 bao",260000,350000,90000,26
TIKI,lam-dep-suc-khoe,4485287,"Vớ y khoa gối Hỗ Trợ Điều Trị suy giãn tĩnh mạch chân JOBST Relief chuẩn áp lực 20-30mmHg (màu da, hở ngón) (tất y khoa) ",650000,700000,50000,7
TIKI,lam-dep-suc-khoe,191726092,"Sữa tắm Bioré Dưỡng Ẩm Đủ Hương 530g",81000,102000,21000,21
TIKI,lam-dep-suc-khoe,71909258,"Nước Hoa Hồng Cho Da Mụn La Roche Posay Effaclar Astringent Lotion 200ml",377000,455000,78000,17
TIKI,lam-dep-suc-khoe,127152384,"Kem đánh răng trắng răng Eucryl Anh Quốc Giúp răng trắng sáng bền lâu , sạch bóng và thơm mát cả nhà - OZ Slim Store - 62g/tuýt",163000,336000,173000,51
TIKI,lam-dep-suc-khoe,8094477,"Túi Chườm Lạnh Greetmed",48000,48000,0,0
TIKI,lam-dep-suc-khoe,195899280,"Bao cao su nam Feelex 2 in 1 gân gai hương dâu nhiều gel bôi trơn",109000,109000,0,0
TIKI,lam-dep-suc-khoe,113407575,"Combo 3 bánh xà phòng gạo trắng da Thái Lan",24000,24000,0,0
TIKI,lam-dep-suc-khoe,1601735,"Sữa Rửa Mặt Tea Tree Skin Clearing Facial Wash (250ml)",249000,349000,100000,29
TIKI,lam-dep-suc-khoe,96709378,"Viên nang mềm Nano curcumin Cumargold new 150 mg cùng gừng chuẩn hóa hỗ trợ cải thiển trào ngược, viêm loét dạ dày tá tràng",275000,275000,0,0
TIKI,lam-dep-suc-khoe,175097284,"Kem đánh răng Sensodyne Rapid Action Whitening 100g",98000,100000,2000,2
TIKI,lam-dep-suc-khoe,58452001,"Viên Sủi FOFLUU Giảm Cảm Lạnh Tăng Sức Đề Kháng Giảm Các Triệu Chứng Ho Sốt Hắt Xì ( Hộp 20 viên sủi vị trái cây )",105000,150000,45000,30
TIKI,lam-dep-suc-khoe,113165937,"Bộ 3 Bàn chải Colgate Slimsoft Between Charcoal lông chải mềm mảnh xen sợi phủ than hoạt tính",76000,76000,0,0
TIKI,lam-dep-suc-khoe,57666220,"Kem Phục Hồi Da, Lành Sẹo, Chống Nhiễm Khuẩn Avène Cicalfate Cream 15ml",212000,249000,37000,15
TIKI,lam-dep-suc-khoe,270881660,"Vitamin C Mỹ Puritan's Pride  500 mg giúp tăng sức đề kháng, tăng sản xuất collagen, nhanh lành bệnh, vết thương - QuaTangMe Extaste",259000,534000,275000,51
TIKI,lam-dep-suc-khoe,52639277,"[Combo 3 Tặng 1 Cho Độ Tuổi Từ 5-20] TPBVSK hỗ trợ Tăng Chiều Cao NuBest Tall",3270000,4350000,1080000,25
TIKI,lam-dep-suc-khoe,107974748,"Glucosamine 1500mg Kirkland Signature Mỹ Giảm đau nhức xương khớp và Hỗ trợ sự vận động linh hoạt hiệu quả - OZ Slim Store 375 Viên/Hộp",655000,1310000,655000,50
TIKI,lam-dep-suc-khoe,15830160,"Máy Tỉa Lông Mũi Xiaomi HN1 - Hàng Nhập Khẩu",262500,262500,0,0
TIKI,lam-dep-suc-khoe,133878592,"Combo 2 Lít Mật Ong Hoa Cà Phê Nguyên Chất DTFood",145000,145000,0,0
TIKI,lam-dep-suc-khoe,74551654,"Cho máy Philips Sonicare, Bộ 4 đầu bàn chải đánh răng điện HX-6014, dòng máy HX3, HX6, HX7, HX8, HX9, R, FlexCare +, FlexCare, HealthyWhite, HydroClean, EasyClean, DiamondClean-Phá tan mảng bám, cho răng sáng bóng",125000,125000,0,0
TIKI,lam-dep-suc-khoe,117928045,"Combo 2 Kit Test Covid 19 Tại Nhà Humasis Hàn Quốc - Hàng Nhập Khẩu chính ngạch",140000,140000,0,0
TIKI,lam-dep-suc-khoe,7727627,"Đắp mặt nạ lô hội DABO Hàn quốc trắng da hỗ trợ điều trị mụn",45000,45000,0,0
TIKI,lam-dep-suc-khoe,149175593,"Combo 3 Băng vệ sinh Diana Sensi Hàng Ngày Kháng Khuẩn 40 + 4 miếng/gói x 3",74000,74000,0,0
TIKI,lam-dep-suc-khoe,94118366,"Combo 6 Băng vệ sinh thảo dược Glamiss Cool BVS ban ngày 24cm siêu khô thoáng cả ngày dài",133000,150000,17000,11
TIKI,lam-dep-suc-khoe,76656992,"Tinh dầu ngủ ngon Vemoda Sleep Easy. Tinh dầu xông phòng giúp thư giãn, làm thơm phòng",249000,249000,0,0
TIKI,lam-dep-suc-khoe,135029881,"Tinh chất dưỡng ẩm Neutrogena Hydro Boost Activating Essence Lotion 150ml",355000,480000,125000,26
TIKI,lam-dep-suc-khoe,172242077,"Tinh dầu thiên nhiên LORITA - Tinh dầu Việt Nam nguyên chất 100% nhiều mùi hương, dung tích - Mùi thơm tự nhiên dễ chịu, giúp tỉnh táo, thoải mái, giảm đau nhức",31000,45000,14000,31
TIKI,lam-dep-suc-khoe,172120332,"Thuốc nhỏ mắt Refresh Tears làm dịu mắt, giảm kích ứng và khô mắt (15ml)",66000,66000,0,0
TIKI,lam-dep-suc-khoe,22493668," La Roche-Posay Tinh Chất Phục Hồi Giúp Da Săn Chắc Hyalu B5 Serum 30ml",795000,795000,0,0
TIKI,lam-dep-suc-khoe,159501937,"Tẩy tế bào chết da mặt Truesky Orange Peeling Gel dạng gel chiết xuất cam 50g",100000,100000,0,0
TIKI,lam-dep-suc-khoe,132366446,"SPECIAL COMBO gội xả bưởi không sulfate giảm gãy rụng tóc Cocoon (tặng 1 nước dưỡng tóc tinh dầu bưởi Cocoon 140ml)",430000,430000,0,0
TIKI,lam-dep-suc-khoe,271474715,"Bổ gan Puritan's Pride Milk Thistle Extract 1000mg Mỹ hỗ trợ giúp gan khỏe hơn, tăng sức đề kháng, hỗ trợ giải độc gan, giảm mụn - Massel Official",437000,938000,501000,53
TIKI,lam-dep-suc-khoe,58654956,"Mật ong nguyên chất Duy Anh Bee 700g",131000,131000,0,0
TIKI,lam-dep-suc-khoe,8142293,"Kềm Cắt Da Thép Chuyên Dụng Kềm Nghĩa D-205",61750,65000,3250,5
TIKI,lam-dep-suc-khoe,8142283,"Kềm Cắt Da Thép Chuyên Dụng Kềm Nghĩa D-555",100000,100000,0,0
TIKI,lam-dep-suc-khoe,176789242,"Máy Massage Mắt Cao Cấp KLC công nghệ nhiệt hồng ngoại, phát nhạc MP3, giúp dễ ngủ giảm stress",3568000,3568000,0,0
TIKI,lam-dep-suc-khoe,58811954,"Nhiệt Kế Điện Tử OMRON MC-343F - Đo Nhiệt Độ Ở Miệng và Nách",198000,198000,0,0
TIKI,lam-dep-suc-khoe,43162128,"Nước hoa nữ cao cấp chính hãng Jile Daisy 50ml (Chance) với hương thơm nồng nàng, quý phái",340000,480000,140000,29
TIKI,lam-dep-suc-khoe,34206620,"HỘP 100 KIM TRÒN LẤY MÁU DÙNG CHO CÁC MÁY ĐO ĐƯỜNG HUYẾT",22000,40000,18000,45
TIKI,lam-dep-suc-khoe,10976986,"Dung dịch vệ sinh Saforelle Gentle Cleansing Care (250ml)",211000,235000,24000,10
TIKI,lam-dep-suc-khoe,100049914,"Cảm biến đo nhịp tim",199000,199000,0,0
TIKI,lam-dep-suc-khoe,173758897,"Dầu Gội Vichy Giảm Tình Trạng Bong Tróc Cho Da Đầu Gàu Và Ngứa Dercos PSOlution Keratoreducing Treatment Shampoo 200ml",312000,390000,78000,20
TIKI,lam-dep-suc-khoe,58976113,"Sữa Rửa Mặt Tạo Bọt Ngừa Mụn Oriss 100g - Chuyên Dành Cho Da Mụn",125000,149000,24000,16
TIKI,lam-dep-suc-khoe,59506958,"Viên uống hỗ trợ mất ngủ, giúp ngủ ngon và sâu giấc Dưỡng Tâm An Lafon (lọ 30 viên)",200000,200000,0,0
TIKI,lam-dep-suc-khoe,118520833,"Bàn chải đánh răng điện Fairywill P11- phiên bản nâng cấp với trục truyền lực bằng thép, 8 đầu bàn chải đi kèm",630000,1200000,570000,48
TIKI,lam-dep-suc-khoe,73117474,"Combo 2 tuýp kem đánh răng Crest 3D White Advanced Triple Whitening Toothpaste 147g",249000,249000,0,0
TIKI,lam-dep-suc-khoe,85779614,"Viên uống hỗ trợ giấc ngủ Nature's Bounty Super Strength Melatonin 5mg 60 viên (Cam Kết Chính Hãng)",157000,175000,18000,10
TIKI,lam-dep-suc-khoe,23447625,"Sáp khử mùi cơ thể Old Spice Pure Sport 63g",115000,115000,0,0
TIKI,lam-dep-suc-khoe,55267101,"Bio - Oil Giảm rạn da và làm mờ sẹo 25ml",95940,117000,21060,18
TIKI,lam-dep-suc-khoe,105738501,"Tinh Dầu Sả Chanh Nguyên Chất TIDAMO, Tự Chọn Dung Tích | Chính Hãng, Có Kiểm Nghiệm | Tinh Dầu Xông Phòng Cao Cấp 100% Thiên Nhiên, An Toàn Cho Trẻ, Khử Mùi, Kháng Khuẩn, Đuổi Muỗi, Giải Cảm",5950,14000,8050,58
TIKI,lam-dep-suc-khoe,94995460,"Dưỡng Kích Màu Môi GABRY CHERRY BLOSSOM ESSENCE  ( Dưỡng Sau Xăm Môi)",68000,135000,67000,50
TIKI,lam-dep-suc-khoe,81897334,"Kem dưỡng giúp sáng da, mờ thâm nám ban đêm Vichy LIFTACTIV COLLAGEN SPECIALIST NIGHT",1048000,1165000,117000,10
TIKI,lam-dep-suc-khoe,119285508,"Gel Bôi Mụn Viên,Mụn Ẩn KLENZIT C Tuýp 15g",165000,185000,20000,11
TIKI,lam-dep-suc-khoe,247998045,"Sữa tắm hương hoa sen Tesori D’ Oriente Lotus Flower 500ml + Móc khóa",213750,225000,11250,5
TIKI,lam-dep-suc-khoe,37141416,"Viên Uống Phòng Ngừa Đột Quỵ, Bổ Não Nattokinase 3000FU Natto Ichou Genki Fami Nhật Bản",766000,830000,64000,8
TIKI,lam-dep-suc-khoe,191365681,"Combo 2 Sữa dưỡng thể chống nắng và dưỡng sáng SPF24 PA++VASELINE Healthy Bright Sun + Pollution Protection 350ML/chai",209000,300000,91000,30
TIKI,lam-dep-suc-khoe,57377257,"Mật ong nguyên chất Beemo, mật ong hoa cà phê từ thiên nhiên - Làm đẹp,hỗ trợ giảm cân, hỗ trợ điều trị ho, gia vị",59000,82000,23000,28
TIKI,lam-dep-suc-khoe,68267208,"Combo 2 Xịt toàn thân Romano ngăn mồ hôi và mùi cơ thể 150ml x 2 Gentleman",206000,206000,0,0
TIKI,lam-dep-suc-khoe,184518312,"Collagen HeiHwa Dạng nước 1.500mg Collagen Tripeptide nhập khẩu từ Hàn Quốc, hấp thu nhanh giúp đẹp - Hộp 5 chai 30ML",450000,450000,0,0
TIKI,lam-dep-suc-khoe,55893367,"Bigsize - Bộ tắm trắng toàn thân Truesky gồm 1 kem ủ trắng toàn thân 200g và 1 kem dưỡng trắng toàn thân 200g",450000,450000,0,0
TIKI,lam-dep-suc-khoe,568256,"Lăn Nách Dành Cho Nữ Aquaselin Insensitive Women Antiperspirant For Increased Perspiration 50ml - 3934",288900,361125,72225,20
TIKI,lam-dep-suc-khoe,155099959,"Serum Mờ Thâm Trắng Da Kiềm Dầu Se Khít Lỗ Chân Lông  Oriskin O’vita Light Serum 30ml",175000,175000,0,0
TIKI,lam-dep-suc-khoe,77150777,"Tinh Dầu Xông Phòng VỎ BƯỞI Nguyên Chất Nhập Khẩu - Tinh dầu Bưởi TIDAMO Giúp Bảo Vệ Sức Khỏe, Kháng Khuẩn,Thư Giãn Tinh Thần và Khử Mùi Hiệu Quả",34000,88000,54000,61
TIKI,lam-dep-suc-khoe,69174556,"Đầu Bàn Chải Điện Portable Electric Toothbrush Heads ENR536WHT (2pcs) - Màu Trắng",46100,84000,37900,45
TIKI,lam-dep-suc-khoe,10678629,"Kem Chống Nắng Da Dầu Bioderma Photoderm AKN Mat SPF 30 (40ml)",461000,485000,24000,5
TIKI,lam-dep-suc-khoe,162978700,"Viên bổ sung vitamin tổng hợp và khoáng chất Berocca Performance (Tuýp 10 viên)",75000,75000,0,0
TIKI,lam-dep-suc-khoe,114778826,"[Chính Hãng] Bộ Bàn Chải Đánh Răng Điện ZenyumSonic T11 & 3 Đầu Thay Thế TB14A - Hồng San Hô - Công Nghệ Singapore",1649000,1649000,0,0
TIKI,lam-dep-suc-khoe,71355851,"Bộ dầu gội thảo dược gừng dừa Cocayhoala hỗ trợ trị gàu, giảm nấm ngứa, dung tích 440g/chai- 95% thành phần từ gừng tươi hữu cơ còn nguyên xơ gừng, hỗ trợ trị rụng tóc, kích thích mọc tóc vượt trội",465000,465000,0,0
TIKI,lam-dep-suc-khoe,72711795,"Kem dưỡng trắng dạng gel Hada Labo Koi-Gokujyun Whitening Perfect Gel 100g",361000,405000,44000,11
TIKI,lam-dep-suc-khoe,7967603,"Dầu Gội Head & Shoulders Ngăn Rụng Tóc (625ml)",149000,149000,0,0
TIKI,lam-dep-suc-khoe,10271325,"Bộ sản phẩm rửa mũi tiện dụng Rohto NoseWash Miniset (1 bình vệ sinh mũi Easy Shower + 1 chai dung dịch 160ml)",45000,45000,0,0
TIKI,lam-dep-suc-khoe,11861302,"Viên Uống Hỗ Trợ Điều Trị Bệnh Suy Giãn Tĩnh Mạch Vascovein (Hộp 30 viên), Chiết Xuất Từ Hạt Dẻ Ngựa - Nguyên Liệu Nhập Khẩu Châu Âu ",212000,215000,3000,1
TIKI,lam-dep-suc-khoe,76357288,"Máy tỉa lông mũi, râu, lông mày đa năng 4 in 1 - Dùng pin sạc tiện lợi – Sắt không gỉ, Chống nước, Cắt tóc, cạo râu, tỉa lông mũi và tỉa lông mày",78000,78000,0,0
TIKI,lam-dep-suc-khoe,94118478,"Combo 6 Băng vệ sinh ban đêm Doctor Care tinh chất thảo dược 33.8cm siêu thấm hút",97000,108000,11000,10
TIKI,lam-dep-suc-khoe,1581117,"Bộ Giác Hơi Không Dùng Lửa Duy Thành YGH05 (6 ống giác)",186000,186000,0,0
TIKI,lam-dep-suc-khoe,190645318,"Sữa Rửa Mặt Dịu Nhẹ Cho Da Khô CeraVe Hydrating Cleanser 88ml",148000,165000,17000,10
TIKI,lam-dep-suc-khoe,184597199,"Gối massage đa năng CTFAST 016: Máy mát xa toàn thân nhiệt hồng ngoại 3D mô phỏng bàn tay con người - Chuyên sâu giảm đau cổ, vai, gáy, lưng..Dễ dàng sử dụng tại nhà, văn phòng, ô tô - Quà tặng ý nghĩa cho người thân",623000,950000,327000,34
TIKI,lam-dep-suc-khoe,68427702,"Kem Nhuộm Dưỡng Tóc Phủ Bạc L'Oreal Paris Excellence Crème 172ml",208050,219000,10950,5
TIKI,lam-dep-suc-khoe,76406994,"Combo 2 Tinh Dầu Sả Chanh 50ML + Tinh Dầu Cam Ngọt 50ML (Lemongrass + Orange) - Tinh Dầu TIDAMO Cao Cấp Nhập Khẩu Giúp Thư Giãn, Đuổi Muỗi Và Thơm Phòng",148000,396000,248000,63
TIKI,lam-dep-suc-khoe,162116326,"Máy tăm nước cầm tay FAIRYWILL F30 siêu phẩm mới ra Dung tích 300ml Sạc nhanh 4 tiếng Thời gian sử dụng lên tới 70 ngày Tặng kèm 6 đầu tăm - Hàng Chính Hãng",764150,899000,134850,15
TIKI,lam-dep-suc-khoe,3818443,"Son dưỡng ẩm không mùi, hỗ trợ trị thâm, lẻ môi DHC Nhật Bản",182000,199000,17000,9
TIKI,lam-dep-suc-khoe,54459799,"Dầu gội thảo dược Hà Thủ Ô Cỏ Cây Hoa Lá chiết xuất 100% từ thiên nhiên giúp làm chậm quá trình bạc tóc, phục hồi tóc hư tổn COCAYHOALA 300g",220000,300000,80000,27
TIKI,lam-dep-suc-khoe,131504643,"Dầu gội dược liệu Thái Dương 3 200ml/480ml",50000,50000,0,0
TIKI,lam-dep-suc-khoe,84225555,"Lăn khử mùi cho nách - chân, mồ hôi tay, thâm nách Kwangdong Sweatclor 30ml",148000,250000,102000,41
TIKI,lam-dep-suc-khoe,20363893,"CÂN SỨC KHỎE NHƠN HÒA CHÍNH HÃNG( ĐƯỢC CHỌN MÀU)",410000,410000,0,0
TIKI,lam-dep-suc-khoe,129438174,"Viên Hồng Sâm Nhung Linh Chi Đông Trùng Hạ Thảo 120 Viên",811000,880000,69000,8
TIKI,lam-dep-suc-khoe,41221033,"Bộ 5 hộp bao cao su Storm hương dâu | Hộp 10 cái",87400,95000,7600,8
TIKI,lam-dep-suc-khoe,192305641,"Đầu tăm nước thay thế và phụ kiện dây sạc cho máy tăm nước h2ofloss",14000,25000,11000,44
TIKI,lam-dep-suc-khoe,195574353,"Bao cao su Feelex Invisible siêu mỏng, nhiều gel bôi trơn, hương thơm nhẹ",39000,39000,0,0
TIKI,lam-dep-suc-khoe,51398122,"Serum Trắng Da Mờ Nám Tàn Nhang Chống Lão Hóa Oribe - Vi Tảo Lục và Tinh Dầu Thông Trắng Nhật Bản (Dạng Viên, Hộp 36 Viên)",330000,380000,50000,13
TIKI,lam-dep-suc-khoe,2036201,"Bột Baking Soda Arm & Hammer Đa Công Dụng, Làm Bánh, Làm Trắng Răng Hiệu Quả, Tẩy Rửa Sạch Nhà Cửa, Giày Dép, Khử Mùi Tanh (454gram/hộp) - Nhập Khẩu Từ Mỹ",26700,33000,6300,19
TIKI,lam-dep-suc-khoe,72133478,"Viên uống DHC Bổ sung Vitamin C Nhật Bản 30 ngày (60 viên/ gói)",85000,105000,20000,19
TIKI,lam-dep-suc-khoe,545471,"Combo 2 Sữa Rửa Mặt Chiết Xuất Từ Trà Xanh 3W Clinic Green Tea Foam Cleansing (100ml)",53200,88000,34800,40
TIKI,lam-dep-suc-khoe,10579630,"Cao Gừng Tan Mỡ Thiên Nhiên Việt  (250g) Tặng Kèm Thước Dây An Nhiên",233000,233000,0,0
TIKI,lam-dep-suc-khoe,2464245,"Bàn chải chà gót chân bằng đá san hô nội địa Nhật Bản",37500,37500,0,0
TIKI,lam-dep-suc-khoe,54415583,"Bột lá nhuộm tóc thiên nhiên OGATIC Màu Nâu- 50g ( Bao Bì Mới)",96000,150000,54000,36
TIKI,lam-dep-suc-khoe,187662120,"Máy Chà Gót Chân Thế Hệ Mới chuyên dụng Mài gót chân nhiều chế độ, hỗ trợ sạc USB bền bỉ hiệu quả",219000,399000,180000,45
TIKI,lam-dep-suc-khoe,24786879,"Tinh Chất Tẩy Da Chết Và Làm Sáng Da The Ordinary Lactic Acid 5% + HA 30ml",319000,319000,0,0
TIKI,lam-dep-suc-khoe,599030,"Sữa Rửa Mặt Tạo Bọt Làm Sạch Giúp Làm Sạch Sâu Và Se Khít Lỗ Chân Lông Không Gây Khô Da La Roche-Posay Effaclar Deep Cleansing Foaming Cream (125ml)",349000,349000,0,0
TIKI,lam-dep-suc-khoe,76121688,"Combo 2 Tinh Dầu Sả Chanh 100ML + Tinh Dầu Vỏ Quế 100ML Nguyên Chất Nhập Khẩu - Tinh Dầu TIDAMO Xông Phòng Giúp Thư Giãn, Thơm Phòng, Bảo Vệ Sức Khỏe và Đuổi Muỗi",238000,656000,418000,64
TIKI,lam-dep-suc-khoe,104468931,"[Combo 5 HỘP - PERFETTA ULTRA] - Khẩu Trang Y Tế Chất Lượng Cao, Kháng Khuẩn, Chống Bụi Mịn PM 2.5, Màu Trắng, 4 Lớp, Bảo Vệ Tối Ưu, Đóng Gói Từng Cái - (35 cái/ hộp)",225000,225000,0,0
TIKI,lam-dep-suc-khoe,3950327,"Kem Chống Nắng Kiểm Soát Nhờn cho Da Dầu Eucerin Sun Gel-Creme Oil Control Dry Touch SPF 50 (50 ml)",439000,439000,0,0
TIKI,lam-dep-suc-khoe,8708414,"Sữa Rửa Mặt Cho Da Dầu, Mụn Uriage Hyseac Cleansing Gel",335750,395000,59250,15
TIKI,lam-dep-suc-khoe,174440849,"Viên giải rượu Nam Dược (VIÊN BYESAY) tăng cường chức năng giải độc bảo vệ gan 5 hộp x 6 viên",105000,105000,0,0
TIKI,lam-dep-suc-khoe,36767757,"[+Tặng mũ trùm] TINH DẦU DƯỠNG TÓC NASHI ARGAN OIL 30ML",270750,285000,14250,5
TIKI,lam-dep-suc-khoe,68491719,"Dầu xả ngăn rụng tóc, dưỡng tóc 50 Megumi Hair Fall Control Conditioner",136000,170000,34000,20
TIKI,lam-dep-suc-khoe,36014642,"Tinh dầu Unique Serum dưỡng tóc khô hư tổn 125ml - Chính hãng",125000,125000,0,0
TIKI,lam-dep-suc-khoe,19735579,"Viên uống hỗ trợ ngủ ngon, giảm căng thẳng, mệt mỏi Doppelherz Aktiv Anti Stress (Hộp 30 viên)",329000,329000,0,0
TIKI,lam-dep-suc-khoe,190323087,"Thảo mộc hỗ trợ giảm cân Slimming care x3 hiệu quả sau 1 liệu trình sử dụng",671000,671000,0,0
TIKI,lam-dep-suc-khoe,131534020,"Túi sưởi chườm nóng lạnh ê buốt đau nhức chân tay",89000,89000,0,0
TIKI,lam-dep-suc-khoe,107301124,"Combo 3 Chai Dầu Gội Bồ Kết Thorakao (750ml)",156800,156800,0,0
TIKI,lam-dep-suc-khoe,191365631,"Combo 2 Sữa dưỡng thể dưỡng sáng da tức thì VASELINE Healthy Bright Instant Radiance 350ML/chai",209000,300000,91000,30
TIKI,lam-dep-suc-khoe,89817284,"Bộ 2 chai Dung Dịch Vệ Sinh Phụ nữ Lactacyd Soft & Silky Dưỡng Ẩm 250ml/chai",163000,176000,13000,7
TIKI,lam-dep-suc-khoe,171564938,"Kem chống nắng vật lý Skin Aqua kiềm dầu, dạng sữa dùng hàng ngày Sunplay Skin Aqua Mineral Defense Oil Clear Milk SPF50+ PA++++ 25g",98000,139000,41000,29
TIKI,lam-dep-suc-khoe,118124183,"Viên uống OTIV bổ não (30 viên)",330000,330000,0,0
TIKI,lam-dep-suc-khoe,180379990,"Thuốc nhỏ mắt V.Rohto Cool làm dịu mắt, giúp giảm mỏi mắt (12ml)",54000,54000,0,0
TIKI,lam-dep-suc-khoe,191365680,"Combo 2 Gel dưỡng thể dưỡng sáng mát lạnh Vaseline Fresh & Bright 350ML/chai",209000,300000,91000,30
TIKI,lam-dep-suc-khoe,49173310,"Dầu hấp ủ tóc Collagen BOSECHER Bamboo Charcoal Treatment (Phủ lụa siêu mượt) 500ml",178600,188000,9400,5
TIKI,lam-dep-suc-khoe,193583708,"Sữa tắm dưỡng thể Dove Invigorating Da bóng mịn thơm mát với dầu bơ và hoa cúc Calendular 900g",183000,226000,43000,19
TIKI,lam-dep-suc-khoe,270698587,"Mầm đậu nành Úc Healthy Care Super Lecithin 1200mg tăng cường chức năng gan khỏe mạnh, nâng cao sức  khỏe, sắc đẹp từ bên trong - Massel Official",238000,600000,362000,60
TIKI,lam-dep-suc-khoe,75483655,"Bảng phấn mắt 9 ô Coco Venus Dikalu kim tuyến lấp lánh",35000,45000,10000,22
TIKI,lam-dep-suc-khoe,161256062,"Dầu gội cho nam sạch sâu giảm ngứa Oxy Deep Shampoo",59500,74000,14500,20
TIKI,lam-dep-suc-khoe,45537667,"Kem Hỗ Trợ Giảm Thâm Da Vùng Nách, Dưới Chân, Đầu Gối, Khuỷu Tay ELAIMEI",65000,95000,30000,32
TIKI,lam-dep-suc-khoe,32028281,"Tinh Chất Dưỡng Trắng Mờ Thâm Nám The Ordinary Alpha Arbutin 2% + HA 30ml",348000,385000,37000,10
TIKI,lam-dep-suc-khoe,248781518,"Vitatree Keo Ong Super Propolis Spray Complex Giúp Tăng Cường Hệ Miễn Dịch Chống Vi Khuẩn, Viêm Họng - Nướu Và Giảm Ho, Cảm Lạnh, Nhanh Lanh Vết Thương - QuaTangMe Extaste",129000,258000,129000,50
TIKI,lam-dep-suc-khoe,20590777,"Tăm Bông Diva Dạng Hộp Tròn - 200 Que",19900,19900,0,0
TIKI,lam-dep-suc-khoe,16375148,"[ Tặng mặt nạ dưỡng da ] Dụng cụ cạo sạch lưỡi PIERROT Tây Ban Nha",40500,45000,4500,10
TIKI,lam-dep-suc-khoe,58245746,"Trà Thảo Mộc Hỗ Trợ Giảm cân Hera Plus (30 viên) Tặng Kèm Thước Dây Đo Vòng Eo",347000,347000,0,0
TIKI,lam-dep-suc-khoe,74559065,"Máy Khuếch Tán Tinh Dầu Cao Cấp Chính Hãng Tặng 3 Chai Tinh Dầu Sả Chanh + Bạc Hà + Quế. Máy Xông Tinh Dầu Chuyên Dụng Có Remote Điều Khiển Từ Xa, Đèn LED Trang Trí, Xông Tinh Dầu và Phun Sương Tạo Ẩm",284000,656000,372000,57
TIKI,lam-dep-suc-khoe,63159336,"Kem Hỗ Trợ Giảm Sẹo Dermatix Ultra 7g",250000,250000,0,0
TIKI,lam-dep-suc-khoe,10404960,"Combo 2 hộp (hộp/1gr) saffron Kingdom Herb, nhụy hoa nghệ tây Iran chính hãng super negin thượng hạng (Tặng táo đỏ Tân Cương 10g và bình nước thủy tinh)",519000,1029000,510000,50
TIKI,lam-dep-suc-khoe,19550931,"Dưỡng chất giúp cải thiện và làm sáng da La Roche Posay Pure Vitamin C10 Serum 30ml",795000,795000,0,0
TIKI,lam-dep-suc-khoe,270105060,"Tinh Dầu Sả Chanh Nguyên Chất 24Care 10ml - Tinh Dầu Xông Thơm Phòng Thư Giãn, Đuổi Muỗi, Khử Mùi - Tinh dầu Bạc Hà/ Cam Ngọt/ Oải hương/ Ngọc Lan Tây/ Tràm Trà/ Bưởi Ngọt/ Vỏ Quế",65000,65000,0,0
TIKI,lam-dep-suc-khoe,101087080,"Bộ 2 Đầu thay bàn chải điện Colgate Sonic 360 Charcoal",249000,249000,0,0
TIKI,lam-dep-suc-khoe,19901331,"Viên uống Vitamin tổng hợp tăng cường sức khỏe đề kháng Doppelherz Aktiv A-Z Depot (Hộp 30 viên)",339000,339000,0,0
TIKI,lam-dep-suc-khoe,130780886,"Viên Serum Dưỡng Tóc Ellips Hair Vitamin Giúp Phục Hồi Tóc, Nuôi Dưỡng Tóc Óng Mượt (Vỉ 6 Viên)",18000,35000,17000,49
TIKI,lam-dep-suc-khoe,140543197,"Serum dưỡng trắng da mặt Yococi giúp phục hồi sáng da, căng bóng ngăn ngừa lão hóa se khít lỗ chân lông White Perfect Face Serum 20ml",178500,350000,171500,49
TIKI,lam-dep-suc-khoe,2336181,"Thực Phẩm Chức Năng  Viên Uống Bổ Gan, Thải Độc Gan Swisse Liver Detox Úc (120 Viên)",455000,568750,113750,20
TIKI,lam-dep-suc-khoe,55840696,"Máy Triệt Lông Vĩnh Viễn Qmele V301-G có màn hình LCD 500.000 Xung",1549000,1549000,0,0
TIKI,lam-dep-suc-khoe,48485617,"Kem Dưỡng Trắng, Tái Tạo Da, Hỗ Trợ Giảm Thâm Mụn, Nám Da Dr.Jart+ V7 Toning Light 50ml ( phiên bản mới)",445000,550000,105000,19
TIKI,lam-dep-suc-khoe,162713234,"Dầu gội sạch gàu, hết ngứa da đầu Selsun",59000,59000,0,0
TIKI,lam-dep-suc-khoe,172906093,"Gel Vệ Sinh Nam X2 Manly Giúp Trẻ Hóa Cậu Nhỏ- Hương Nước Hoa Quyến Rũ Cocayhoala 150g",150000,200000,50000,25
TIKI,lam-dep-suc-khoe,31265214,"Đèn Hồng Ngoại Bayoka - Việt Nam ( Kèm bóng 250W)",390000,390000,0,0
TIKI,lam-dep-suc-khoe,53224806,"Thiên Môn Bổ Phổi Dược Bình Đông – Chai 90ml dành cho Trẻ em – Giảm ho nhanh chóng, Bổ phổi thật hay",44000,44000,0,0
TIKI,lam-dep-suc-khoe,653823,"Bọt Cạo Râu Gillette Hương Bạc Hà (175g)",78900,84000,5100,6
TIKI,lam-dep-suc-khoe,63900730,"Máy Khuếch Tán Tinh Dầu Chuyên Dụng Cho Gia Đình Và Văn Phòng, Máy Phun Sương Siêu Âm Khuếch Tán Tinh Dầu Tích Hợp Đèn Led 7 Màu Trang Trí Phòng Cực Đẹp",154000,356000,202000,57
TIKI,lam-dep-suc-khoe,8142289,"Kềm Cắt Da Thép Chuyên Dụng Kềm Nghĩa D-666",86000,86000,0,0
TIKI,lam-dep-suc-khoe,72016670,"Bộ cọ trang điểm 13 cây ",39000,39000,0,0
TIKI,lam-dep-suc-khoe,2573465,"Dầu dừa ép lạnh tinh khiết Coco-Secret 100 ml",65000,65000,0,0
TIKI,lam-dep-suc-khoe,3598467,"Bộ 10 gói mặt nạ dưỡng da 3W Clinic Fresh Red Ginseng Mask Sheet 23ml X 10",48500,48500,0,0
TIKI,lam-dep-suc-khoe,27656215,"Nhiệt Kế Hồng Ngoại Đo Tai Và Trán Fr1mf1 + Tặng Đèn Soi Tai",799000,1200000,401000,33
TIKI,lam-dep-suc-khoe,3928991,"Tinh Chất Dưỡng Mi DHC Eyelash Tonic (6.5ml)",299000,350000,51000,15
TIKI,lam-dep-suc-khoe,54486828,"Dầu gội phục hồi và giữ màu tóc nhuộm L'oreal Serie Expert Resveratrol  Vitamino color radiance shampoo 500ml [ Mới Chĩnh Hãng ]",393000,420000,27000,6
TIKI,lam-dep-suc-khoe,157084566,"Dụng cụ massage đầu cầm tay, giúp thư giãn, giảm stress, giảm đau đầu - Màu ngẫu nhiên",19000,29000,10000,34
TIKI,lam-dep-suc-khoe,159887686,"Collagen bổ sung Vitamin C ngăn ngừa mụn,mịn da Lá House Pure Amino Collagen C+ (6.5g*30gói)",1350000,1350000,0,0
TIKI,lam-dep-suc-khoe,171124536,"CAO SAO VÀNG (Hộp 20 g) -Dùng khi nhức đầu, sổ mũi, đau bụng, say tàu xe, côn trùng đốt - Hàng chính hãng OPC",44600,44600,0,0
TIKI,lam-dep-suc-khoe,5532635,"Viên uống tăng cường thị lực, chống mỏi mắt Doppelherz Aktiv Eye Vital (Hộp 30 viên)",339000,339000,0,0
TIKI,lam-dep-suc-khoe,171153592,"Sáp Khử Mùi Old Spice Ngăn Tiết Mồ Hôi Nhiều Mùi Hương Bearglove I Wolfthorn I Timber I Fiji 73g Chuẩn Chất Đàn Ông",139000,139000,0,0
TIKI,lam-dep-suc-khoe,51048821,"Tinh chất The Ordinary Retinol 0.2% In Squalane",319000,319000,0,0
TIKI,lam-dep-suc-khoe,105629974,"Bộ 2 gel bôi trơn Durex K-Y Jelly 50g",170000,180000,10000,6
TIKI,lam-dep-suc-khoe,92560200,"Xịt khử mùi dưỡng trắng hương nước hoa Refre Whitening Perfume In Love - Hương Tình Yêu 30ml",58500,62000,3500,6
TIKI,lam-dep-suc-khoe,68617503,"Papulex Sữa Rửa Mặt Papulex Ngăn Ngừa & Giảm Mụn Trứng Cá Moussant Soap Free Cleansing Gel 150ml",380000,380000,0,0
TIKI,lam-dep-suc-khoe,198769926,"[HỘP - FAMAPRO 5D DÂY VẢI] - Khẩu trang y tế kháng khuẩn 3 lớp Famapro 5D Mask dây vải (10 cái/ hộp)",10900,10900,0,0
TIKI,lam-dep-suc-khoe,159264926,"Kem mờ sẹo, liền sẹo chuyên sâu Scarz Intensive Gel 9g ( dạng gel)",149000,150000,1000,1
TIKI,lam-dep-suc-khoe,7280161,"Kềm cắt da thép không gỉ D-03 (14)",175000,175000,0,0
TIKI,lam-dep-suc-khoe,171574158,"Xịt chống muỗi hương cam Soffell (80ml)",36000,36000,0,0
TIKI,lam-dep-suc-khoe,127127300,"Kem Đánh TrắngRăng Eucryl 62g Anh Quốc - Bí Quyết Cho Hàm Răng Sáng Bóng, Thơm Mát",92000,204000,112000,55
TIKI,lam-dep-suc-khoe,210145114,"Tinh Bột Cám Gạo Nguyên Chất UMIHOME 40G Tẩy da chết, dưỡng trắng hồng da hiệu quả",40000,85000,45000,53
TIKI,lam-dep-suc-khoe,116480061,"Viên Giấp Cá Dân Khang Giảm Táo Bón Và Trĩ Nội Trĩ Ngoại Hộp 3 vỉ x 10 viên",68000,86000,18000,21
TIKI,lam-dep-suc-khoe,196869296,"Gối Massage Nhiệt Hồng Ngoại VISPO VP-G23 - 4 Bi Xoay Chuyên Dùng Cho Cổ, Vai, Gáy, Thắt Lưng Sử Dụng Tại Nhà, Văn Phòng Hoặc Trên Ô tô",1290000,1290000,0,0
TIKI,lam-dep-suc-khoe,170330947,"Combo triệt lông vĩnh viễn UMIHA với Mỡ trăn nguyên chất U Minh Hạ và Kem tẩy lông UMIHA 85g an toàn tiết kiệm tại nhà",251750,265000,13250,5
TIKI,lam-dep-suc-khoe,15944204,"Xịt khử mùi nước hoa Enchanteur Charming nồng nàn duyên dáng ngăn mồ hôi & mùi cơ thể 150ml",89000,110000,21000,19
TIKI,lam-dep-suc-khoe,190641512,"Sữa Rửa Mặt Dịu Nhẹ Cho Da Dầu CeraVe Foaming Cleanser 88ml",139000,155000,16000,10
TIKI,lam-dep-suc-khoe,77673975,"Optibac Probiotics for women 90 viên - men vi sinh chính hãng Anh khắc phục hiệu quả viêm nhiễm, nấm ngứa phụ khoa (mẫu mới)",1169000,1461250,292250,20
TIKI,lam-dep-suc-khoe,114276905,"Máy hút ráy tai Nhật Bản - dụng cụ lấy ráy tai an toàn.",56050,59000,2950,5
TIKI,lam-dep-suc-khoe,204340766,"Combo 3 Tinh Dầu LORGANIC / Nhiều Mùi Hương / Xông Phòng Thư Giãn, Đuổi Muỗi 10m / Sả Chanh, Oải Hương Lavender, Ngọc Lan Tây, Hương Thảo, Stress Relief, Quyến Rũ Sensualy (10ml)",115000,195000,80000,41
TIKI,lam-dep-suc-khoe,195821392,"Máy massage cầm tay CameWell, máy massage toàn thân trị liệu cổ vai gáy 4 đầu 5 chế độ, pin 2600 mAh dùng liên tục 4h",1429000,1990000,561000,28
TIKI,lam-dep-suc-khoe,48190464,"VIÊN TINH NGHỆ MẬT ONG SỮA CHÚA HONEYLAND 250G/HŨ",251000,389000,138000,35
TIKI,lam-dep-suc-khoe,203790754,"Combo 3 Tinh Dầu LORGANIC / Nhiều Mùi Hương / Xông Phòng Thư Giãn, Đuổi Muỗi 10m / Sả Chanh, Quế, Bạc Hà, Oải Hương Lavender, Tràm, Ngọc Lan Tây, Hương Thảo, Stress Relief, Sensual, Cam, Vỏ Bưởi, Bạch Đàn Chanh, Bưởi Chùm, Gỗ Thông (10ml)",99000,198000,99000,50
TIKI,lam-dep-suc-khoe,12063335,"Xịt Khử Mùi Hàng Ngày Etiaxil Déodorant Anti-Transpirant 48h Anti-Traces Blanches & Jaunes 100ml",249000,289000,40000,14
TIKI,lam-dep-suc-khoe,271444292,"Sụn vi cá mập Úc Healthy Care Shark Cartilage 750mg tăng sức khỏe xương khớp, cơ bấp, tăng chức năng vận động - Massel Official",414000,828000,414000,50
TIKI,lam-dep-suc-khoe,58669255,"Combo 2 Sữa tắm hương nước hoa Enchanteur Magic 650gr/ Chai",392000,392000,0,0
TIKI,lam-dep-suc-khoe,74547395,"Kem Chống Nắng Không Màu Kiểm Soát Dầu La Roche-Posay Anthelios XL Dry Touch Gel-Cream SPF 50+ UVB & UVA (50ml) - TẶNG MÓC KHÓA",450000,450000,0,0
TIKI,lam-dep-suc-khoe,192418945,"Mặt nạ tay dưỡng da tay Mèo, làm trắng da bổ sung collagen cải thiện nếp nhăn, tẩy tế bào chết",12500,25000,12500,50
TIKI,lam-dep-suc-khoe,57715384,"Nước Hoa MIni VERSACE EROS FOR MEN Phong Độ Nam Giới 5ml Ý",152000,299000,147000,49
TIKI,lam-dep-suc-khoe,101947387,"Cho máy Oral B Braun, bộ 4 Đầu Bàn Chải đánh răng điện thay thế MIHOCO EB18-P New   ,  phá tan mảng bám, cho răng trắng sáng",125000,125000,0,0
TIKI,lam-dep-suc-khoe,190881603,"Khẩu trang y tế 4 lớp, lẻ 10 cái, 1 hộp 50 cái, kháng khuẩn, kháng virus Corona chuyên dụng cho bệnh viện, nhiều màu",6000,6000,0,0
TIKI,lam-dep-suc-khoe,176059943,"Bọt vệ sinh nam ALFASEPT Intimate Wash For Men ICE COOL- Dung dịch tạo bọt chai 100ml",115000,115000,0,0
TIKI,lam-dep-suc-khoe,41090601,"Lăn khử mùi nam Old Spice High Endurance Deodorant Long Lasting Stick Pure Sport 85g  - USA",165000,165000,0,0
TIKI,lam-dep-suc-khoe,23079049,"Combo 3 Hộp Tăm Bông Diva - 200 Que/Hộp",59000,59000,0,0
TIKI,lam-dep-suc-khoe,87446824,"Mặt Nạ Nghệ Hưng Yên Cocoon 30ml",123250,145000,21750,15
TIKI,lam-dep-suc-khoe,118896584,"Nến thơm tinh dầu cao cấp không khói an toàn Candle Cup - WHITE TEA - S - 100G (KG NẮP)",120000,120000,0,0
TIKI,lam-dep-suc-khoe,12107069,"Viên uống giảm mụn, giảm nhờn - Kẽm, Crôm, D.Salina, Vitamin C, Vitamin E - ACNACARE Mega We Care (30 viên)",128000,140000,12000,9
TIKI,lam-dep-suc-khoe,7939532,"Sữa Rửa Nam Ngăn Ngừa Mụn Trắng Da Dabo Black Force (120ml)",105000,105000,0,0
TIKI,lam-dep-suc-khoe,118896560,"Nến thơm tinh dầu cao cấp không khói an toàn Candle Cup - JASMINT/HOA NHÀI - S - 100G (KG NẮP)",120000,120000,0,0
TIKI,lam-dep-suc-khoe,48967686,"Gel tắm dành cho da khô, vảy nến, viêm da cơ địa - Urea Shower Gel 750ml",318000,318000,0,0
TIKI,lam-dep-suc-khoe,162767278,"Hộp 30 Chiếc Bàn Chải Đánh Răng Than Tre Hoạt Tính Hàn Quốc - Hàng Chuẩn Loại 1",94050,99000,4950,5
TIKI,lam-dep-suc-khoe,20115822,"Thực phẩm bảo vệ sức khỏe Viên uống làm đẹp da DHC Collagen Nhật Bản",165000,195000,30000,15
TIKI,lam-dep-suc-khoe,58519309,"Kem bôi da Thuần Mộc Thanh Mộc Hương mẫu mới - Tặng Kèm Cột Tóc Tai Thỏ Màu Ngẫu Nhiên",106000,106000,0,0
TIKI,lam-dep-suc-khoe,41588397,"Đai Chống Gù Lưng Điều Chỉnh Cột Sống Cho Người Lớn Aolikes",145000,145000,0,0
TIKI,lam-dep-suc-khoe,153612336,"Nước hoa nữ Versace Eros Pour Femme Eau De Parfum",409000,409000,0,0
TIKI,lam-dep-suc-khoe,52249427,"Bioré Sữa Chống Nắng Bảo Vệ Hoàn Hảo DƯỠNG ẨM Biore UV SPF50+/PA+++ 25ML",56000,70000,14000,20
TIKI,lam-dep-suc-khoe,195454530,"Khẩu trang trẻ em KF94 4D mask An Tâm cho bé trên 4-10 tuổi 4 lớp kháng khuẩn chống bụi mịn in hình dễ thương túi 10 cái",12000,12000,0,0
TIKI,lam-dep-suc-khoe,76559149,"Que thử đường huyết Glucose dành cho máy đo Facare 5 trong 1 FC-M168 (TD-4216)",225000,225000,0,0
TIKI,lam-dep-suc-khoe,41967584,"Viên uống Sắc Ngọc Khang Vi tảo lục (60 viên) giúp trẻ hóa làn da xua tan vết nám, hỗ trợ cân bằng nội tiết tố, bổ huyết, điều kinh, hỗ trợ giảm các triệu chứng tiền mãn kinh",218000,290000,72000,25
TIKI,lam-dep-suc-khoe,160549677,"Combo 5 Set Minisize Dầu gội xả phục hồi đa tầng Nấm Truffle Weilaiya - Hương nước hoa",150000,200000,50000,25
TIKI,lam-dep-suc-khoe,32495160,"Túi Chườm Gel Nóng Lạnh Giảm Đau,Hạ Sốt R&R Rexi Care Loại Lớn (31 x 17 cm)",179000,179000,0,0
TIKI,lam-dep-suc-khoe,58837639,"DẦU GỘI CHO TÓC DẦU DERCOS OIL CONTROL VICHY 200ml",332000,415000,83000,20
TIKI,lam-dep-suc-khoe,58800808,"Chai Xịt Nóng Hỗ Trợ Giảm Nhanh Đau Nhức Cơ Xương Khớp, Sưng Bong Gân Bầm Tím Bách Linh Diệu - Chai 50 ml",80000,95000,15000,16
TIKI,lam-dep-suc-khoe,205073657,"Gel bôi trơn hậu môn nóng ấm - Shell Supermen Warming - Chai 90ml",349600,380000,30400,8
TIKI,lam-dep-suc-khoe,28117010,"Dụng cụ dũa móng tay 6 mặt",7890,7890,0,0
TIKI,lam-dep-suc-khoe,168953416,"Vớ Bàn Chân - Tất Gót Y Khoa Suy Giãn Tĩnh Mạch Yasee Ngăn Ngừa và Hỗ Trợ Điều Trị (1 chiếc)",150000,150000,0,0
TIKI,lam-dep-suc-khoe,185924212,"Hộp Mặt Nạ Nén Maycreate Silk Mask 100 Miếng",105000,150000,45000,30
TIKI,lam-dep-suc-khoe,23284736,"NƯỚC SÚC MIỆNG DÀNH CHO RĂNG NIỀNG ORTHO KIN 500ML",302000,302000,0,0
TIKI,lam-dep-suc-khoe,159887702,"Collagen ngăn ngừa lão hóa,trắng da,đẹp tóc Lá House Gluta Q10 (6.5g*30gói)",2450000,2450000,0,0
TIKI,lam-dep-suc-khoe,60185869,"Mật ong nguyên chất  (MS ) - (1350g) - Mật ong rừng hoa cà phê",145000,160000,15000,9
TIKI,lam-dep-suc-khoe,109135923,"[Combo 5 - PERFETTA CHILDREN] - Khẩu Trang Y Tế Trẻ Em Chất Lượng Cao, Kháng Khuẩn, Chống Bụi Mịn, Màu",185000,250000,65000,26
TIKI,lam-dep-suc-khoe,8093197,"Nước Xịt Khoáng Dưỡng Da Vichy 50ml M5030803",169000,175000,6000,3
TIKI,lam-dep-suc-khoe,136040847,"COMBO 5 Hộp Khẩu Trang Y Tế Kháng Khuẩn 4D D&J/Tiêu Chuẩn KF94/Hộp 10 Cái",75000,75000,0,0
TIKI,lam-dep-suc-khoe,141678620,"Dầu xả gừng Hà thủ ô Weilaiya 250ml - Nuôi dưỡng và phục hồi hư tổn cho mái tóc ",275000,340000,65000,19
TIKI,lam-dep-suc-khoe,251012688,"Combo 6 lô cuốn tóc xoăn size vừa",19000,29000,10000,34
TIKI,lam-dep-suc-khoe,202483946,"Máy Tăm Nước Halio UltraClean Oral Irrigator 3 Chế Độ Nhỏ Gọn Bỏ Túi",1079000,1650000,571000,35
TIKI,lam-dep-suc-khoe,118896394,"Combo 2 Chai Dầu gội đầu OGX - Dung Tích 385mlx2",449000,590000,141000,24
TIKI,lam-dep-suc-khoe,177317341,"Combo 10 Hộp Khẩu trang Bông Bạch Tuyết KF94 4 lớp - Đen (10 cái/hộp)",200000,200000,0,0
TIKI,lam-dep-suc-khoe,140318094,"Viên uống sáng da glutathione D-na Whitening Supplement (60 Viên)",792000,990000,198000,20
TIKI,lam-dep-suc-khoe,58957414,"Sữa chống nắng dành cho da nhạy cảm Shiseido GSC The Perfect Protector S 50ml",1150000,1150000,0,0
TIKI,lam-dep-suc-khoe,107254773,"Viên uống ORIHIRO BBB Best Beauty Body  300 viên/hộp",440000,750000,310000,41
TIKI,lam-dep-suc-khoe,57031893,"Nồi Đun Sáp Wax Lông Nóng - Pro Wax 100 - Màu Ngẫu Nhiên",90000,149985,59985,40
TIKI,lam-dep-suc-khoe,71712755,"Nước Hoa Mini Nam Versace Pour Homme 5ml",239000,389000,150000,39
TIKI,lam-dep-suc-khoe,189595821,"Ghế massage trị liệu toàn thân KAGAWA K28 PRO [FULL QUÀ TẶNG] công nghệ mát xa nhiệt hồng ngoại tân tiến giúp thư giãn, giảm stress tại nhà",9990000,18500000,8510000,46
TIKI,lam-dep-suc-khoe,122092294,"[+Tặng mũ trùm] BỘ DẦU GỘI XẢ COLLAGEN & BIOTIN TRẮNG PASIORI TM PHỤC HỒI, MỀM MƯỢT, NGĂN GÃY RỤNG, MỌC TÓC ITALY 500ML*2 NEW 2022",230000,268000,38000,14
TIKI,lam-dep-suc-khoe,38246155,"Kem Dưỡng Ẩm Trẻ Hoá Da Hạt Ý Dĩ Hatomugi Naturie Nhật Bản 180g",150000,205758,55758,27
TIKI,lam-dep-suc-khoe,173761453,"Combo dưỡng mi FEG Plus Stem Cells - Phiên bản tế bào gốc, dài mi nhanh, không chứa Prostaglandins gây thâm mắt (5ml/lọ)",600000,600000,0,0
TIKI,lam-dep-suc-khoe,58673652,"Combo 2 Lăn khử mùi nước hoa Enchanteur Charming 50ml/ Chai",137000,174000,37000,21
TIKI,lam-dep-suc-khoe,12084554,"Kem dưỡng trắng da ban đêm Eucerin UltraWHITE+ SPOTLESS Night (50ml)",696000,929000,233000,25
TIKI,lam-dep-suc-khoe,46980003,"Bàn Chải Điện Chải Răng Sử Dụng Sạc Clear Sonic Boorui",148000,189000,41000,22
TIKI,lam-dep-suc-khoe,128569889,"Dung dịch vệ sinh Intima Ziaja 200ml",85000,150000,65000,43
TIKI,lam-dep-suc-khoe,194041238,"Nước súc miệng cho răng nhạy cảm Listerine Total Care Sensitive Soothing Taste - Dung tích 250ml - 750ml",66000,82000,16000,20
TIKI,lam-dep-suc-khoe,143786928,"Combo 2 Tinh Dầu Oải Hương 50ML + Tinh Dầu Bạc Hà 50ML Nguyên Chất Chính Hãng TIDAMO, Xông Thơm Phòng Giúp Thư Giãn và Nâng Cao Sức Khỏe, Rất Tốt Khi Sử Dụng Với Máy Xông Tinh Dầu",158000,436000,278000,64
TIKI,lam-dep-suc-khoe,56389444,"Bộ đôi Nước súc miệng Colgate diệt 99% vi khuẩn Plax trà xanh 500ml/chai",136000,165000,29000,18
TIKI,lam-dep-suc-khoe,131504590,"Kem đánh răng dược liệu Sao Thái Dương 150g",60000,60000,0,0
TIKI,lam-dep-suc-khoe,176043674,"SPECIAL DEAL cà phê Đắk Lắk làm sạch da chết cơ thể Cocoon 600ml (Tặng tẩy da chết môi cà phê Đắk Lắk Cocoon 5g)",325000,325000,0,0
TIKI,lam-dep-suc-khoe,51095498,"Kem mắt chống lão hóa The INKEY List Retinol Eye Cream 15ml",399000,399000,0,0
TIKI,lam-dep-suc-khoe,136690839,"Dầu Gội Head Và Shoulders",213000,239000,26000,11
TIKI,lam-dep-suc-khoe,78957956,"Set Son Kem Lì 4 Cây Daishiao Matte(Tặng 1 hộp phấn mắt xinh xắn tiện lợi)",65000,125000,60000,48
TIKI,lam-dep-suc-khoe,89753515,"DUNG DỊCH VỆ SINH PHỤ NỮ HANA SOFT SILK HANAYUKI",125000,145000,20000,14
TIKI,lam-dep-suc-khoe,15262824,"Tinh dầu dưỡng tóc Nashi Argan Oil - trattamento di bellezza per tutti i tipi di capello 100ml",684000,720000,36000,5
TIKI,lam-dep-suc-khoe,188964498,"SPECIAL COMBO 2 chai Nước Dưỡng Tóc Tinh Dầu Bưởi Cocoon 140ml - tặng Serum Sachi phục hồi tóc Cocoon 70ml",330000,330000,0,0
TIKI,lam-dep-suc-khoe,24828338,"Gel ngừa mụn diệt khuẩn Floslek Pharma Antibacterial Intense Gel 20ml",230000,230000,0,0
TIKI,lam-dep-suc-khoe,116189274,"Kìm cắt móng tay, móng chân, kìm cắt da chết bằng thép không gỉ siêu sắc  tặng kèm thanh nạy móng (mầu sắc ngẫu nhiên)",79000,79000,0,0
TIKI,lam-dep-suc-khoe,241982269,"Máy mát xa cổ cao cấp, có chườm nóng - 4 đầu tiếp xúc, 6 chế độ massage khác nhau, 9 cường độ massage - Màu Trắng",130000,130000,0,0
TIKI,lam-dep-suc-khoe,91752078," BỘ DỤNG CỤ LÀM MÓNG BẤM MÓNG - BỘ KỀM CẮT MÓNG TAY CAO CẤP",62000,85817,23817,28
TIKI,lam-dep-suc-khoe,73772610,"Saffron Kingdom Herb nhụy hoa nghệ tây Iran hộp 0.2 gram, hàng chính hãng super negin thượng hạng (Tặng bình nước thủy tinh)",79000,155000,76000,49
TIKI,lam-dep-suc-khoe,81403593,"Nước uống làm đẹp Collagen Adiva (14 lọ x30ml/ Hộp )",689000,811000,122000,15
TIKI,lam-dep-suc-khoe,134390487,"Đệm Massage Toàn Thân - Máy Massage Kết Hợp Túi Khí Và Gối Massage Nhiệt Hồng Ngoại Giúp Thư Giãn, Giảm Đau Cơ Thể - Nệm Mát Xa Đa Năng Cao Cấp",1999000,2590000,591000,23
TIKI,lam-dep-suc-khoe,24862534,"Tinh Chất Tế Bào Gốc Tái Tạo Phục Hồi Trẻ Hoá Da Cấp Ẩm Dưỡng Trắng Chống Lão Hoá Cellkey-Scien White Serum 30ml",837000,930000,93000,10
TIKI,lam-dep-suc-khoe,2254547,"Viên uống điều hòa nội tiết tố nữ, nuôi dưỡng da Solgar Dầu Anh Thảo Evening Primrose Oil 1300 mg - NHẬP KHẨU USA",765818,981818,216000,22
TIKI,lam-dep-suc-khoe,12084494,"Nước Tẩy Trang Eucerin Hỗ Trợ Trị Mụn Làm Trắng Da (200ml)",261000,349000,88000,25
TIKI,lam-dep-suc-khoe,177516306,"Set 5 Son Kem Lì Thỏ LEADUU lâu trôi mềm mịn",75000,125000,50000,40
TIKI,lam-dep-suc-khoe,119988682,"Uốn mi cong thân nhựa cao cấp KAI màu hồng kèm miếng đệm thay thế",139000,152000,13000,9
TIKI,lam-dep-suc-khoe,21760234,"Sữa rửa mặt Sắc Ngọc Khang 50g giúp loại bỏ bụi bẩn và bã nhờn dư thừa, cung cấp các dưỡng chất cho da, giúp da trắng sáng, mịn màng",39000,50000,11000,22
TIKI,lam-dep-suc-khoe,114467695,"Combo Dầu Gội X-Men Nước hoa Fire 650G và Sữa Tắm X-Men Nước hoa Fire 650G",382000,382000,0,0
TIKI,lam-dep-suc-khoe,38372056,"Viên uống Vitamin C sáng da, tăng cường đề kháng, giảm cảm cúm, cảm lạnh Mega We Care NAT C 1000 (30 viên)",138000,155000,17000,11
TIKI,lam-dep-suc-khoe,166389092,"Sữa tắm gội Romano cho nam 2 trong 1 Gentleman 180g",56000,65000,9000,14
TIKI,lam-dep-suc-khoe,71669650,"Tinh chất kháng mụn mờ thâm The INKEY List Niacinamide 30ml",329000,329000,0,0
TIKI,lam-dep-suc-khoe,76184280,"Bộ bao da dụng cụ 16 món cắt móng",69000,69000,0,0
TIKI,lam-dep-suc-khoe,77339534,"Kem Đánh Răng Colgate Sensitive ngăn ngừa ê buốt toàn diện 110g/tuýp",69000,69000,0,0
TIKI,lam-dep-suc-khoe,10771483,"Kem Dưỡng Ẩm Cho Da Khô Klairs Rich Moist Soothing Cream",450000,450000,0,0
TIKI,lam-dep-suc-khoe,13778270,"Tinh chất kích thích mọc tóc L’Oréal Serioxyl Denser Hair 90ml",931000,980000,49000,5
TIKI,lam-dep-suc-khoe,77655821,"MÁY KHUẾCH TÁN TINH DẦU CỔ CAO MODEL 4G CAO CẤP CHUYÊN DỤNG - MÁY XÔNG TINH DẦU PHUN SƯƠNG, GIÚP TỎA HƯƠNG TINH DẦU, THƯ GIẢN, THÍCH HỢP DÙNG CHO PHÒNG LỚN - TẶNG KÈM REMOTE",286000,286000,0,0
TIKI,lam-dep-suc-khoe,73574991,"Dego Pharma - Dầu gội sạch vảy gàu mảng trắng, hết ngứa chiết xuất thiên nhiên từ vỏ cây Zizyphus, sản xuất theo tiêu chuẩn và dưới sự giám sát của công ty dược phẩm Châu Âu (80ml)",195000,390000,195000,50
TIKI,lam-dep-suc-khoe,50698010,"Serum dưỡng trắng da, mờ đốm nâu, đều màu da - Vitamin C, Vitamin E, Bisabolol - NNO VITE Mega We Care (30 viên)",360000,390000,30000,8
TIKI,lam-dep-suc-khoe,84872693,"Set 6 Lô Cuốn Tóc Nhiều Màu Tiện Dụng Cho Nữ",1000,99000,98000,99
TIKI,lam-dep-suc-khoe,36261358,"Kem tan mỡ Missha Hot Burning Perfect Body Gel Hàn Quốc",145000,159000,14000,9
TIKI,lam-dep-suc-khoe,180236624,"Son không chì chiết xuất từ hạnh nhân cao cấp Lagumi dưỡng môi mềm mại an toàn cho mẹ bầu &amp; sau sinh",249000,249000,0,0
TIKI,lam-dep-suc-khoe,36768495,"Bàn chải thông minh Xiaomi Mijia T100 - Hàng nhập khẩu",208000,208000,0,0
TIKI,lam-dep-suc-khoe,119700381,"Bộ 6 Kem Đánh Răng Colgate Sensitive Pro Relief ngăn ê buốt và bảo vệ toàn diện 110g/hộp",414000,414000,0,0
TIKI,lam-dep-suc-khoe,83344090,"Combo 4 Nước súc miệng Colgate diệt 99% vi khuẩn Plax trà xanh và Plax bạc hà 500ml/chai",416000,416000,0,0
TIKI,lam-dep-suc-khoe,14336296,"Combo 2 hộp nước uống vị hồng sâm Hàn Quốc 10 chai x 100ml",150920,154000,3080,2
TIKI,lam-dep-suc-khoe,271570469,"Canxi cho người lớn Kirkland Calcium thêm: Mange, Kẽm, Vitamin B6, D, B6 giúp giảm đau nhức xương khớp, phòng loãng xương, ngủ ngon - Massel Official",262000,526000,264000,50
TIKI,lam-dep-suc-khoe,77749623,"Tinh Dầu Quế 50ML + Tinh Dầu Quế Treo Xe ô Tô Treo Phòng Gia Đình (Cinnamon) - Tinh Dầu Vỏ Quế Nguyên Chất Xông Phòng Giúp Bảo Vệ Sức Khỏe, Kháng Khuẩn Và Thư Giãn Tinh Thần",88000,256000,168000,66
TIKI,lam-dep-suc-khoe,193916624,"Bộ 4 đầu thay thế máy tăm nước Lock&Lock ENR126WHT_RB - Hàng chính hãng - JoyMall",129000,186000,57000,31
TIKI,lam-dep-suc-khoe,631042,"Miếng làm sạch da mặt ngăn ngừa mụn, tẩy tế bào chết Oxy Perfect Clear Pad 55 miếng",93500,93500,0,0
TIKI,lam-dep-suc-khoe,272918313,"Omega 3-6-9 Úc Healthy Care Ultimate 1000mg Tạo sức khỏe cho tim, não, khớp, mắt và cải thiện da khô - QuaTangMe Extaste",420000,866000,446000,52
TIKI,lam-dep-suc-khoe,45033442,"Máy phun tinh dầu phòng ngủ Thiên Ý Tạo Ẩm Khuếch Tán Tinh Dầu Kèm Đèn Ngủ,  không gây ồn, tặng kèm điều khiển từ xa và tinh dầu sả chanh Kobi",329000,652000,323000,50
TIKI,lam-dep-suc-khoe,94583728,"DỤNG CỤ CẦM TAY LÀM ĐẸP CẮT TỈA LÔNG MŨI CAO CẤP AKMEI",35000,50000,15000,30
TIKI,lam-dep-suc-khoe,31494288,"The Ordinary Caffeine Solution 5% + EGCG - Thần Dược Giải Quyết Mọi Vấn Đề Của Mắt 30ml",339000,339000,0,0
TIKI,lam-dep-suc-khoe,144176873,"Máy xông tinh dầu siêu âm cao cấp 550ml  - Đèn LED 7 màu - Chế độ máy khuếch tán tinh dầu mạnh - Hẹn giờ tự tắt - Xông hơi liên tục 24h - Kèm Remote -  Tặng 1 tinh dầu 10ml",171000,285000,114000,40
TIKI,lam-dep-suc-khoe,26096771,"Thực phẩm bảo vệ sức khỏe Maxxhair New hộp 30 viên- Bổ sung Vitamin và khoáng chất giúp tăng cường sức khỏe của tóc; giúp tóc mọc nhanh, chắc khỏe, suôn mượt và bóng đẹp, ngăn ngừa rụng tóc, đồng thời giúp thải độc do ảnh hưởng của các hóa chất sử dụng ch",226000,226000,0,0
TIKI,lam-dep-suc-khoe,178559962,"Xà Bông Nghệ MELA Thiên Nhiên, Làm Sạch Da Sáng Khoẻ, Tẩy Da Chết Thoáng Lỗ Chân Lông Hỗ Trợ Giảm Mụn Lưng - ML05",80000,80000,0,0
TIKI,lam-dep-suc-khoe,98675681,"Hộp Khẩu Trang 2D Trẻ Em 3 Lớp ANYGUARD Chính Hãng - Lọc 99% Vi Khuẩn - Họa Tiết Cá - Dành Cho Bé Từ 2 Đến 4 tuổi (Hộp 50 cái) - Đạt Tiêu Chuẩn QCVN 01:2017/BTC, ISO 9001:2015, ISO 13485:2016",126000,150000,24000,16
TIKI,lam-dep-suc-khoe,83608793,"Kem đánh răng Colgate Thiên Nhiên 180g",55000,55000,0,0
TIKI,lam-dep-suc-khoe,41263241,"Vitamin tổng hợp cho bà bầu Pregnacare Max 84 viên",425000,531250,106250,20
TIKI,lam-dep-suc-khoe,184767648,"Tinh dầu thiên nhiên treo xe hơi, tủ áo Lorganic, hương thơm thiền tịnh",15000,45000,30000,67
TIKI,lam-dep-suc-khoe,83423219,"Khẩu trang y tế 4 lớp kháng khuẩn May 10 chính hãng",35000,35000,0,0
TIKI,lam-dep-suc-khoe,102007801,"Máy massage cầm tay 5 đầu  Relax & tone masage toàn thân",155000,155000,0,0
TIKI,lam-dep-suc-khoe,12478891,"Gel Rửa Mặt Cho Da Mụn Ducray Keracnyl Gel Innova Myrtacine (200ml)",412000,485000,73000,15
TIKI,lam-dep-suc-khoe,270687455," Dung dịch vệ sinh phụ khoa cao cấp Femfresh giúp làm sạch thơm, kháng viêm, kháng khuẩn, phòng viêm nhiễm cho cả nữ và nam - QuaTangMe Extaste",99000,99000,0,0
TIKI,lam-dep-suc-khoe,68188298,"Khẩu Trang Y Tế 5D Trẻ Em Nam Anh - Hộp 10 cái",9900,18000,8100,45
TIKI,lam-dep-suc-khoe,157208662,"Túi Refill Cà phê Đắk Lắk làm sạch da chết cơ thể Cocoon cho làn da mềm mại & rạng rỡ 600ml",250000,250000,0,0
TIKI,lam-dep-suc-khoe,40769633,"Dầu gội hỗ trợ trị gàu ALCORAL 60ml",57000,68000,11000,16
TIKI,lam-dep-suc-khoe,78021090,"Hộp 10 miếng mặt nạ dưỡng trắng và ngừa lão hoá Truesky Integrated Mask chiết xuất hoa hồng đá 25g/miếng",250000,250000,0,0
TIKI,lam-dep-suc-khoe,2869347,"La Roche-Posay - Gel Rửa Mặt Tạo Bọt Cho Da Dầu Nhạy Cảm Effaclar Purifying Foaming Gel 200ml",340000,410000,70000,17
TIKI,lam-dep-suc-khoe,76120881,"Combo 2 Tinh Dầu Sả Chanh + Tinh Dầu Vỏ Quế TIDAMO Nguyên Chất Nhập Khẩu - Tinh Dầu Xông Phòng Cao Cấp Giúp Thư Giãn, Thơm Phòng, Bảo Vệ Sức Khỏe và Đuổi Muỗi (2 chai 10ML)",66300,118000,51700,44
TIKI,lam-dep-suc-khoe,270885590,"Tinh chất dưỡng Mi DHC Eyelash Tonic giúp dày và dài lông mi, chống gãy rụng lông mi - QuaTangMe Extaste",260000,690000,430000,62
TIKI,lam-dep-suc-khoe,39089019,"Sữa Dưỡng Ẩm Toàn Thân Và Da Mặt Cetaphil Moisturizing Lotion (200ml)",289000,316000,27000,9
TIKI,lam-dep-suc-khoe,173559368,"Sữa tắm Atoskin cấp dưỡng ẩm Da công nghệ Hàn Quốc Enzyme- Bio-Derma 1",110000,120000,10000,8
TIKI,lam-dep-suc-khoe,185817287,"Xịt Thơm Miệng MEXI Quyên Lara - Giúp Hơi Thở Thơm Mát, Hết Hôi Miệng, Giảm Tình Trạng Viêm Lợi, Viêm Chân Răng, Dung Tích 15ml",139000,230000,91000,40
TIKI,lam-dep-suc-khoe,116583499,"Mật Ong Nguyên Chất Hoa Vải Cvdbeheoney loại 90ml(125g) ",15000,15000,0,0
TIKI,lam-dep-suc-khoe,29345245,"Dầu gội Paul Mitchell Tea Tree Special shampoo trà xanh bạc hà ngăn gàu kháng khuẩn Mỹ 300ml",421000,450000,29000,6
TIKI,lam-dep-suc-khoe,541546,"Bao Cao Su Okamoto Skinless Skin Purity (Hộp 10 Gói)",49000,49000,0,0
TIKI,lam-dep-suc-khoe,271441960,"Dung dịch vệ sinh phụ khoa cao cấp Femfresh giúp kháng khuẩn, làm sạch, khử mùi, tạo hương thơm mát cả ngày, cho cả nữ và nam - Massel Official",125000,258000,133000,52
TIKI,lam-dep-suc-khoe,149975014,"Hộp Quà Tặng Tinh Dầu TOKI MORI Cao Cấp, Xuất Khẩu Nhật Bản 6x10ml, Nguyên Chất Thiên Nhiên - Cam Ngọt, Bạc Hà, Sả Chanh, Vỏ Quế, Tràm Gió, Vỏ Bưởi",265000,499000,234000,47
TIKI,lam-dep-suc-khoe,3045839,"Tinh bột nghệ Quê Việt - 100% nghệ đỏ nguyên chất, hàm lượng curmim cao.",259000,395000,136000,34
TIKI,lam-dep-suc-khoe,58105443,"HỘP 30 CHIẾC BÀN CHẢI ĐÁNH RĂNG THAN TRE HOẠT TÍNH",127000,139000,12000,9
TIKI,lam-dep-suc-khoe,63042665,"SERUM NGỪA MỤN THÂM - MỜ SẸO 25ML - MOC",270000,270000,0,0
TIKI,lam-dep-suc-khoe,89839177,"Bộ Dung Dịch Vệ Sinh Phụ Nữ Lactacyd Soft & Silky Dưỡng Ẩm 250ml + Odor Fresh Ngăn Mùi 24H 150ml",137000,147000,10000,7
TIKI,lam-dep-suc-khoe,205014161,"Bao cao su Rocmen Long Shock - Kéo dài thời gian - Hộp 12 cái",55200,60000,4800,8
TIKI,lam-dep-suc-khoe,1751879,"Bộ nẹp gỗ sơ cấp cứu gồm 10 thanh",96000,96000,0,0
TIKI,lam-dep-suc-khoe,68860538,"Bao cao su LifeStyles Zero làm từ cao su thiên nhiên cao cấp siêu mỏng truyền nhiệt tốt cho cảm giác chân thật ( 3 Bao / Hộp ) - Xuất xứ Úc ( Hàng Chính Hãng )",44000,88000,44000,50
TIKI,lam-dep-suc-khoe,105774928,"Hộp 2 nhíp inox cao cấp nhổ tỉa lông mày Kai (1 nhíp đầu to & 1 nhíp đầu nhỏ) tặng thun buộc tóc 10g",109000,119000,10000,8
TIKI,lam-dep-suc-khoe,194946999,"Nhíp Lấy Ráy Tai Chuyên Dụng Có Đèn, Hộp Đựng ( Tặng Kèm Pin) - Chính Hãng GROFA",58905,112200,53295,48
TIKI,lam-dep-suc-khoe,52139397,"Combo 3 Tinh dầu SENSELAB nhập khẩu Ấn Độ: Tinh Dầu Sả Chanh (10ml) + Tinh Dầu Oải Hương (10ml) + Tinh Dầu Bạc Hà (10ml) - Tinh dầu thiên nhiên nguyên chất",150000,150000,0,0
TIKI,lam-dep-suc-khoe,1754691,"Dung dịch vệ sinh khử mùi phụ khoa nam giới SERENYS - 100ml",129000,129000,0,0
TIKI,lam-dep-suc-khoe,53686030,"Gel vệ sinh phụ nữ X2 Nano Nghệ Cocayhoala Giảm Mùi Hôi - Giảm Ngứa - Giảm Khí Hư 150ml",199000,330000,131000,40
TIKI,lam-dep-suc-khoe,33600476,"Máy Tạo Kiểu Râu Philips BT1214	",1098250,1098250,0,0
TIKI,lam-dep-suc-khoe,34315208,"Dao Cạo Râu 4 Lưỡi Dorco Pace 4 FRA 1001-PT",135000,135000,0,0
TIKI,lam-dep-suc-khoe,878391,"Tỏi Đen Kim Cương Đông Á - Tỏi Đen Cô Đơn (Túi 200g)",230000,230000,0,0
TIKI,lam-dep-suc-khoe,74854269,"Tinh Dầu Vỏ Quế Nguyên Chất Nhập Khẩu Ấn Độ 100ML. Tinh Dầu Quế Cao Cấp Để Xông Phòng Kháng Khuẩn, Phòng Tránh Cảm Cúm - Dùng Với Máy Khuếch Tán Tinh Dầu",198000,396000,198000,50
TIKI,lam-dep-suc-khoe,180322040,"Dầu chăm sóc da từ Thiên Nhiên giúp giảm rạn dạ, mờ sẹo cho da nhạy cảm - BIO-OIL SKINCARE OIL (NATURAL) (chai 60ml)",230000,250000,20000,8
TIKI,lam-dep-suc-khoe,119025591,"Bút Tỉa Lông Mày ( Sạc Điện Xịn ) / Bút Máy Tỉa Ria Mép Massage Thẩm Mỹ Loại Cao Cấp Cho Phái Đẹp",50000,50000,0,0
TIKI,lam-dep-suc-khoe,8142295,"Kềm Cắt Da Thép Chuyên Dụng Kềm Nghĩa D-23",57000,60000,3000,5
TIKI,lam-dep-suc-khoe,37880214,"phấn trang điểm trắng da twoway cake",153000,153000,0,0
TIKI,lam-dep-suc-khoe,271613379,"Sbody Green Coffee Hỗ Trợ Giảm Cân  - 100% Thiên Nhiên - Cà Phê Xanh Hỗ Trợ Giảm Cân AN TOÀN & HIỆU QUẢ (Hộp 12 gói /180G)",528000,550000,22000,4
TIKI,lam-dep-suc-khoe,14695045,"Xà Phòng hỗ trợ Trị Thâm Nách Pelican nội địa Nhật Bản",137000,139860,2860,2
TIKI,lam-dep-suc-khoe,148824107,"Serum sâu răng hôi miệng INOD Huyền Phi Tặng Kèm Gội (Xả) Mini Weilaiya Ngẫu Nhiên",182000,182000,0,0
TIKI,lam-dep-suc-khoe,187606879,"Combo Kem Rửa Mặt Tẩy Da Chết Tế Bào Gốc Thực Vật Kiềm Dầu Làm Sạch Sâu Dưỡng Ẩm Da Dầu Mụn Nhạy Cảm Cellkey-Scien 230ml",657000,730000,73000,10
TIKI,lam-dep-suc-khoe,121322953,"Chai xịt diệt khuẩn Nano Bạc AHT - dùng rửa tay, phun khử khuẩn toàn thân",70000,149000,79000,53
TIKI,lam-dep-suc-khoe,35787205,"Combo 6 Băng Vệ Sinh Whisper Ultra Clean Siêu Mỏng Có Cánh Ngày Vừa 24cm (Gói 10 Miếng) ",165000,165000,0,0
TIKI,lam-dep-suc-khoe,8756585,"Combo 5 Bông tẩy trang Ipek 130 miếng (Thổ Nhĩ Kì)",134000,134000,0,0
TIKI,lam-dep-suc-khoe,125722009,"Combo bếp đốt thảo mộc bồ kết + 500gr sả + 10 viên nến",125000,125000,0,0
TIKI,lam-dep-suc-khoe,73180505,"Băng vệ sinh Diana Sensi dạng quần size M-L gói 5 miếng",72000,72000,0,0
TIKI,lam-dep-suc-khoe,14423069,"Tấm thảo dược thay thế của đai chườm vai cắm điện - Hapaku",180000,180000,0,0
TIKI,lam-dep-suc-khoe,160299522,"Tinh chất dưỡng phục hồi da innisfree Retinol Cica Repair Ampoule 30 mL (New2023)",630000,900000,270000,30
TIKI,lam-dep-suc-khoe,147731249,"Hỗ trợ giảm đau nhức xương khớp Move Free Ultra 3xTriple Action Mỹ  phòng loãng xương, tăng trưởng và hồi phục sụn, tăng chất nhầy khớp - Massel Official 75Viên/Hộp",758000,1570000,812000,52
TIKI,lam-dep-suc-khoe,119251241,"Sữa rửa mặt dịu lành cho da nhạy cảm Cetaphil Gentle Skin Cleanser 250ml",248000,276000,28000,10
TIKI,lam-dep-suc-khoe,175654421,"Rutin C Đại Uy - bổ sung vitamin C, giúp tăng cường sức đề kháng, phòng ngừa nhiệt miệng, táo bón - Hộp 100 viên",19000,50000,31000,62
TIKI,lam-dep-suc-khoe,138181029,"Viên nang mềm hồng sâm hàn quốc",488000,488000,0,0
TIKI,lam-dep-suc-khoe,116409375,"Dầu Xả Ogx Biotin & Collagen Conditioner 385ml",186000,295000,109000,37
TIKI,lam-dep-suc-khoe,194487212,"Kem dưỡng ẩm làm sáng chống nắng cho da innisfree Cherry Blossom Glow Skin-Fit Tone-Up Cream SPF 50+PA++++ 50ml",483000,570000,87000,15
TIKI,lam-dep-suc-khoe,159849436,"Tăm bông người lớn Pharmacity",5000,5000,0,0
TIKI,lam-dep-suc-khoe,25442377,"Son kem lì Bbia Last Velvet Lip Tint - 17 More Pleasant 5g (Màu cam san hô)",150000,290000,140000,48
TIKI,lam-dep-suc-khoe,12107911,"Nước Hoa Nữ Versace Bright Crystal - Eau De Toilette (30ml)",989000,1799000,810000,45
TIKI,lam-dep-suc-khoe,24752546,"Sáp Dưỡng Ẩm Vaseline 100% Pure Petroleum Jelly 368g",122000,122000,0,0
TIKI,lam-dep-suc-khoe,140537916,"Kem mụn thịt mụn gạo Tsububoron Nhật Bản/Kem xóa nốt ruồi Tsubuporon 20g - Nhật Bản",329000,450000,121000,27
TIKI,lam-dep-suc-khoe,56404021,"Kem Ngừa Đồi Mồi Và Dưỡng Trắng Da Tay KPEM 50ml NGA",125000,135000,10000,7
TIKI,lam-dep-suc-khoe,173998496,"Lược gội đầu massage MASEKI",230000,230000,0,0
TIKI,lam-dep-suc-khoe,175687094,"Calci B12 hộp 20 ống 10ml - Tăng cường sức khỏe - Bổ sung vitamin, cải thiện tình trạng thiếu hụt canxi",39000,60000,21000,35
TIKI,lam-dep-suc-khoe,50699275,"Kem Se Nhỏ Lỗ Chân Lông Bioderma Sebium Pore Refiner - 30ml",461000,485000,24000,5
TIKI,lam-dep-suc-khoe,270846005,"Canxi 600mg và Vitamin D3 Kirkland cho xương và răng - QuaTangMe Extaste",552000,1104000,552000,50
TIKI,lam-dep-suc-khoe,113737706,"Glucosamine Mỹ Schiff Move Free Joint Health Advanced Glucosamine + Chondroitin - Giảm các triệu chứng đau nhức xương khớp hiệu quả - Massel Official -200 Viên",802000,1762000,960000,54
TIKI,lam-dep-suc-khoe,21741235,"Cân Sức Khỏe Điện Tử Vuông Mặt Kính Cường Lực MJ-25 Tặng Kèm 2 Pin AAA",58000,58000,0,0
TIKI,lam-dep-suc-khoe,26115743,"Viên Uống Hỗ Trợ Giảm Cân Bổ Sung Dầu Dừa DHC FORSKOHLII SOFT CAPSULE",395000,450000,55000,12
TIKI,lam-dep-suc-khoe,26115341,"Viên uống Làm Đẹp Da DHC Collagen Nhật Bản",165000,195000,30000,15
TIKI,lam-dep-suc-khoe,193669272,"Sáp wax lông lạnh UMIHA 135ML dùng cho wax lông Nách, Chân, Tay, Body an toàn hiệu quả",163000,300000,137000,46
TIKI,lam-dep-suc-khoe,162196352,"Kem Dưỡng Ẩm Dành Cho Da Dầu Và Da Hỗn Hợp Laneige Water Bank Blue HA Cream Oily 50ml",843000,1000000,157000,16
TIKI,lam-dep-suc-khoe,171564936,"Gel Chống Nắng Vật Lý Bảo Vệ Da Dưỡng Ẩm Sunplay Skin Aqua Mineral Defense Moisture Gel SPF35+  PA++++ 25g",98000,139000,41000,29
TIKI,lam-dep-suc-khoe,500669,"Mascara Dài Mi Và Tơi Mi Tự Nhiên Maybelline New York Lash Sensational Waterproof Chuốt Mi Không Lem Không Trôi 10ml",149000,149000,0,0
TIKI,lam-dep-suc-khoe,72049088,"Kem chống nắng Decumar Advaced Sunblock hoàn toàn mới 50g",175000,175000,0,0
TIKI,lam-dep-suc-khoe,125874560,"Túi chườm cao su nước NÓNG , LẠNH ĐA NĂNG",54000,69000,15000,22
TIKI,lam-dep-suc-khoe,3613769,"Nước Cân Bằng Shiseido Treatment Softener Enriched (150ml) - 14532",1350000,1350000,0,0
TIKI,lam-dep-suc-khoe,97079398,"Máy Hút Mụn Loại Bụi Bẩn – Bã Nhờn – Làm Sạch Lỗ Chân Lông Ngăn Ngừa Hình Thành Mụn Cám – Đầu Đen – 3 Cấp Độ Lực Hút - 5 Đầu Ống Hút Mini Cầm Tay Tiện Lợi Sử Dụng.",599000,599000,0,0
TIKI,lam-dep-suc-khoe,7721152,"Đai Thắt Lưng Orbe H1 - Xanh Đen",150000,150000,0,0
TIKI,lam-dep-suc-khoe,150285632,"[HỘP - FAMAPRO VN95 KIDS] - Khẩu trang y tế trẻ em kháng khuẩn 4 lớp Famapro VN95 KIDS đạt chuẩn N95 (10 cái/ hộp)",10900,15000,4100,27
TIKI,lam-dep-suc-khoe,14758377,"Thực phẩm bổ sung: KIRKLAND SIGNATURE VITAMIN E 400 I.U",370000,370000,0,0
TIKI,lam-dep-suc-khoe,166766373,"Thuốc nhỏ mắt Pharmacity Eye Drops xuất xứ Anh Quốc (10ml)",49000,49000,0,0
TIKI,lam-dep-suc-khoe,73674536,"Máy Khuếch Tán Tinh Dầu Tặng Kèm Tinh Dầu Sả Chanh Cao Cấp - Máy Xông Tinh Dầu Có Remote Điều Khiển Từ Xa, Dung Tích Lớn Chuyên Dụng Cho Phòng Rộng",270300,598000,327700,55
TIKI,lam-dep-suc-khoe,190472560,"Khẩu trang trẻ em 5D An Tâm, trẻ em 0-10 tuổi, kháng khuẩn, kháng virus, ôm vừa mặt,chứng nhận tiêu chuẩn sản phẩm",6900,6900,0,0
TIKI,lam-dep-suc-khoe,16214309,"Tắm gội 2 trong 1 Romano Force mạnh mẽ tự tin phiên bản Deluxe nhanh chóng tiện dụng 650gr",150000,191000,41000,21
TIKI,lam-dep-suc-khoe,3705851,"Combo 2 Tuýp Kem Đánh Răng Lô Hội Forever Bright Toothgel 130g/tuýp",380000,380000,0,0
TIKI,lam-dep-suc-khoe,105626104,"Bộ 4 Bao Cao Su Durex Jeans - Hộp 3 Bao ",168000,196000,28000,14
TIKI,lam-dep-suc-khoe,178561374,"Muối tẩy tế bào chết làm sạch da đầu Dr.FORHAIR Sea Salt Scaler 50g",96000,178000,82000,46
TIKI,lam-dep-suc-khoe,4423591,"Thực Phẩm Chức Năng Tinh Chất Hàu Tươi Nhật Bản Orihiro 120 Viên",309000,352800,43800,12
TIKI,lam-dep-suc-khoe,35578333,"Cân Sức Khỏe Điện Tử Vuông Mặt Kính Cường Lực MJ-25 Tặng Kèm 2 Pin AAA",66682,70090,3408,5
TIKI,lam-dep-suc-khoe,58667454,"Combo 2 Sữa tắm hương nước hoa Enchanteur Sensation 650gr/ Chai",313000,392000,79000,20
TIKI,lam-dep-suc-khoe,877310,"Combo 5 Miếng Dán hỗ trợ điều trị Mụn Mayancare 12 Miếng (1.0cm)",144000,175000,31000,18
TIKI,lam-dep-suc-khoe,180223850,"Dầu chăm sóc da giúp cải thiện rạn da, mờ sẹo và đều màu da - BIO-OIL SKINCARE OIL (chai 60ml)",195000,205000,10000,5
TIKI,lam-dep-suc-khoe,12084498,"Tẩy Tế Bào Chết Ngăn Ngừa Mụn Eucerin (100ml)",291000,389000,98000,25
TIKI,lam-dep-suc-khoe,192988869,"300 cái khẩu trang KF94 - 4D Hoa Tuyết An Tâm, khẩu trang có giấy phép bộ y tế cấp",8500,8500,0,0
TIKI,lam-dep-suc-khoe,74465822,"	 Nước Hoa Hồng Dr.Pepti+ Dưỡng Da Căng Bóng  Centella Toner (180ml )",315000,350000,35000,10
TIKI,lam-dep-suc-khoe,102576061,"Gối massage hồng ngoại trị liệu 16 bi - Máy massage Cổ, Vai, Gáy, Lưng, Eo",225000,225000,0,0
TIKI,lam-dep-suc-khoe,63690465,"Combo 3 Hộp Bột Lá Nhuộm Tóc Ogatic Màu Nâu",280000,450000,170000,38
TIKI,lam-dep-suc-khoe,126689830,"Viên Uống Phụ Khoa- Men Vi Sinh Vùng Chữ Y LAVIMA BIOTIC",210000,210000,0,0
TIKI,lam-dep-suc-khoe,14245533,"Nước uống Collagen làm trắng da Pure White Nhật Bản ",478000,478000,0,0
TIKI,lam-dep-suc-khoe,116522296,"HÀNG CHÍNH HÃNG- Cân điện tử Camry EB5681, trọng tải tối đa 150kg- Thiết kế sang trọng, hiện đại",179000,179000,0,0
TIKI,lam-dep-suc-khoe,83352993,"Dầu gội có dầu xả Palmolive Naturals suôn mượt và dưỡng ẩm thiên nhiên 180ml",37000,37000,0,0
TIKI,lam-dep-suc-khoe,187845877,"Máy mát xa massage mini đa năng cầm tay 6 chế độ tặng kèm 4 đầu massage",150000,150000,0,0
TIKI,lam-dep-suc-khoe,7541267,"Set 2 Dao Cạo Lông Mày Kai 01-158",39100,52920,13820,26
TIKI,lam-dep-suc-khoe,8142273,"Kềm Cắt Da Thép Không Gỉ Kềm Nghĩa D-04(14)",175000,175000,0,0
TIKI,lam-dep-suc-khoe,16620681,"Bàn lăn gỗ massage chân 5x6",182000,182000,0,0
TIKI,lam-dep-suc-khoe,270549724,"Xịt keo Ong Vitatree Super Propolis Spray Complex tăng sức đề kháng, kháng khuẩn, nấm, giảm viêm họng, ho, nhiệt miệng - QuaTangMe Extaste",125000,258000,133000,52
TIKI,lam-dep-suc-khoe,3928213,"Kềm Cắt Móng Thép Chuyên Dụng M-205 Kềm Nghĩa",72200,76000,3800,5
TIKI,lam-dep-suc-khoe,272283285,"Canxicho người lớn Mỹ Kirkland Signature Calcium Citrate Magnesium And Zinc with Vitamin D3 phát triển hệ thống xương, phòng chống loãng xương - OZ Slim Store",583000,1166000,583000,50
TIKI,lam-dep-suc-khoe,548296,"Xịt Khoáng Giúp Làm Sạch Và Dịu Da La Roche-Posay Serozinc (150ml)",311000,375000,64000,17
TIKI,lam-dep-suc-khoe,76776118,"Nước Hồng Sâm Linh Chi Pocheon Hàn Quốc 6 Năm Tuổi (70ml X 30 Gói)",738000,900000,162000,18
TIKI,lam-dep-suc-khoe,108971623,"Băng quấn cổ chân đàn hồi Dr.MED DR-A135",155000,155000,0,0
TIKI,lam-dep-suc-khoe,911355,"Nước Hoa Hồng Ori'be",74000,80000,6000,8
TIKI,lam-dep-suc-khoe,186271173,"Khẩu trang y tế 4D (KF94) NPCARE Hope Xanh  hy vọng (H/10c)",30000,30000,0,0
TIKI,lam-dep-suc-khoe,1628057,"Lăn khử mùi và giúp khô thoáng vùng da dưới cánh tay 48h Vichy 50ml",272000,320000,48000,15
TIKI,lam-dep-suc-khoe,173564760,"Combo 4 hộp ALIPAS tăng cường sinh lý nam 30 viên tặng 1 hộp 15 viên",3000000,3380000,380000,11
TIKI,lam-dep-suc-khoe,120777637,"Protein Bar đến từ KIND - công ty bánh dinh dưỡng lớn nhất thế giới  : Hộp 12 thanh",435000,435000,0,0
TIKI,lam-dep-suc-khoe,142904041,"Tinh Chất Phục Hồi, Cấp Ẩm Smas Pro Vitamin B5 Hydra Serum 120ml",465000,750000,285000,38
TIKI,lam-dep-suc-khoe,55890380,"Bộ 2 Kem đánh răng trẻ em Colgate Kid Free From 6-9 80g/tuýp",104000,104000,0,0
TIKI,lam-dep-suc-khoe,198324072,"Dầu gội Matrix gội là đen - gội là nâu",27000,27000,0,0
TIKI,lam-dep-suc-khoe,68554897,"Gel Rửa Mặt La Roche-Posay Hỗ Trợ Giảm Mụn Cho Mặt & Toàn Thân Effaclar Micro-Peeling Purifying Gel 50Ml",42500,85000,42500,50
TIKI,lam-dep-suc-khoe,548110,"Sữa Tắm L'amont En Provence Cherry Blossom Shower Gel Hương Hoa Anh Đào Chai 500ml ",89000,149000,60000,40
TIKI,lam-dep-suc-khoe,118124195,"Viên uống RITANA trắng da mờ sạm nám với L-Glutathion, Sakura, Pomegranate, P.Leucotomos, collagen (30 viên)",330000,330000,0,0
TIKI,lam-dep-suc-khoe,100265407,"Cao Gừng Nghệ Đỏ Thanh Lăn Tan Mỡ 180ml",240000,480000,240000,50
TIKI,lam-dep-suc-khoe,58488552,"Tinh Dầu Hoa Anh Thảo Blackmores Evening Primrose Oil 190 viên - mẫu 2020",480000,480000,0,0
TIKI,lam-dep-suc-khoe,83349366,"Sữa tắm Palmolive Naturals chiết xuất 100% thiên nhiên 500g",99000,99000,0,0
TIKI,lam-dep-suc-khoe,198102288,"Lăn khử mùi Perspirex Strong: khử mùi hôi nách và ngăn tiết mồ hôi loại mạnh",290000,290000,0,0
TIKI,lam-dep-suc-khoe,4354111,"Bột lá nhuộm tóc màu Nâu Đỏ Lá Móng Ogatic 50gr thảo dược",96000,150000,54000,36
TIKI,lam-dep-suc-khoe,150718926,"COMBO bộ 9 Dụng Cụ day ấn Huyệt Mát xa toàn thân kiểu Thái (MH849) bằng gỗ Bách Xanh - Chăm sóc sức khỏe gia đình",189050,199000,9950,5
TIKI,lam-dep-suc-khoe,58916813,"Lăn Khử Mùi ETIAXIL Détranspirant Traitement Aisselles Peaux Normales 15ml (Dành Cho Da Thường) + Tặng 1 Móc Khóa Nhựa 2 Mặt",249000,320000,71000,22
TIKI,lam-dep-suc-khoe,59476479,"Bao cao su Liebe kéo dài thời gian, gai nổi lớn - Hộp 12 cái",36800,40000,3200,8
TIKI,lam-dep-suc-khoe,158222388,"Viên uống đẹp da Collagen Sắc Ngọc Khang 120 viên thế hệ mới giúp sáng da, giảm nếp nhăn - đốm nâu, nuôi dưỡng và làm đẹp da , tóc, móng",620000,730000,110000,15
TIKI,lam-dep-suc-khoe,89931480,"Bộ 3 chai Dung Dịch Vệ Sinh Phụ Nữ Lactacyd Odor Fresh Ngăn Mùi 24H 250ml/chai",221000,267000,46000,17
TIKI,lam-dep-suc-khoe,158762711,"Combo hoàn hảo Oniiz - Bọt vệ sinh nam giới dung dịch tạo bọt mịn 100ml & Nước hoa nam giới THE PARIS & THE MIAMI 10ml",299000,299000,0,0
TIKI,lam-dep-suc-khoe,135266767,"Bộ 4 Kem đánh răng Colgate Maxfresh Bamboo Charcoal 225g kèm bàn chải lông tơ phủ than",263000,263000,0,0
TIKI,lam-dep-suc-khoe,10770097,"Gel Dưỡng Da I’m From Vitamin Tree Water Gel",315000,315000,0,0
TIKI,lam-dep-suc-khoe,75425181,"Set miếng dán móng cho bé gái đáng yêu – J007",8000,12000,4000,33
TIKI,lam-dep-suc-khoe,118948435,"Gel Dưỡng Ẩm The Auragins Skin Rescue Brightening Gel Cream 10ml",70000,70000,0,0
TIKI,lam-dep-suc-khoe,10858345,"Tinh bột nghệ vàng An Bình",245000,245000,0,0
TIKI,lam-dep-suc-khoe,87378418,"Kissing Spray Juicy Kiss vị Đào chai 20ml - LOLI & THE WOLF, Tặng Kèm Mút Rửa Mặt",139000,139000,0,0
TIKI,lam-dep-suc-khoe,249029146,"Viên Uống Ăn Ngủ Ngon Dân Khang",105000,155000,50000,32
TIKI,lam-dep-suc-khoe,127153070,"Bột Trắng Răng Eucryl Tooth Powder Nhập Khẩu Anh Quốc (50g) - Massel Official",95000,204000,109000,53
TIKI,lam-dep-suc-khoe,82040987,"Bột tiệt trùng cốc nguyệt san Lincare đánh bay 99,9% vi khuẩn, tẩy ố và khử khuẩn siêu tốc (Hộp 12 gói x 2g)",126000,149000,23000,15
TIKI,lam-dep-suc-khoe,20315732,"Nước súc miệng cai thuốc lá Thanh Nghị - Chai 400ml",225000,400000,175000,44
TIKI,lam-dep-suc-khoe,177518984,"Saffron mật ong Kingdom Herb chính hãng thượng hạng nguyên chất 100% hộp 311g (tặng que lấy mật và bình thuỷ tinh)",319000,629000,310000,49
TIKI,lam-dep-suc-khoe,145177161,"Dầu massage body Sả Gừng giảm cảm giác mệt mỏi vai gáy, lưng, đầu gối Tinh Dầu 100 200ml",190000,190000,0,0
TIKI,lam-dep-suc-khoe,82250462,"Bột Nghệ nguyên chất UMIHOME 40G dùng uống hỗ trợ sức khỏe và đắp mặt nạ dưỡng da hiệu quả",54000,100000,46000,46
TIKI,lam-dep-suc-khoe,66618934,"Natureine AQUA PEEL Moisture Peeling Gel - Chai 30ml - Gel tẩy tế bào da chết, cấp ẩm Nhật Bản - Chính Hãng",99000,120000,21000,18
TIKI,lam-dep-suc-khoe,73207101,"Mật ong nguyên chất - Mật hoa cafe (1L)",109000,115000,6000,5
TIKI,lam-dep-suc-khoe,113083508,"Máy Đo Nhiệt Kế Kachi JXB-315 Cảm Biến Hồng Ngoại có chứng nhận FDA Mỹ",790000,799000,9000,1
TIKI,lam-dep-suc-khoe,73237382,"Dầu gội Head&Shoulders Bạc hà 1800ml",319000,319000,0,0
TIKI,lam-dep-suc-khoe,75551920,"Viên Uống Giữ Ẩm Cấp Nước DHC Hyaluronic Acid",299000,350000,51000,15
TIKI,lam-dep-suc-khoe,74308679,"Máy Đo Đường Huyết Safe Accu Chính Hãng Sinocare Tặng Kèm 50 Que Thử+50 Kim Chích Máu",225000,360000,135000,38
TIKI,lam-dep-suc-khoe,182557965,"Siro ho bổ phế Đ.Y Combo 2 chai 100ml - Giảm ho, ngứa rát cổ họng, khàn tiếng, bổ phổi từ thảo dược",36000,70000,34000,49
TIKI,lam-dep-suc-khoe,113843414,"Máy Cạo Lông / Máy Tẩy Lông Không Dây Đời Mới Pin Lithium Tích Điện - Có Thời Gian Sử Dụng Liên Tục Trong 1 Giờ - Sạc Điện Bằng Cáp USB (Đã Bao Gồm) - Hàng Chính Hãng",182000,219000,37000,17
TIKI,lam-dep-suc-khoe,77014770,"Kem Bôi Trơn Khi Quan Hệ Của Nhật Bản Sagami 60g - Không Mùi Không Vị - Gốc Nước Dễ Rửa Sạch - Tặng Kèm Gel Jex Nhật - Hàng Chính Hãng 100% - Che Tên Sản Phẩm",250000,250000,0,0
TIKI,lam-dep-suc-khoe,270813246,"Vitamin cho bà bầu Prenatal Folic Acid+ DHA Nature Made giúp mẹ khỏe, bé phát triển não bộ, hệ thần kinh và thể lực - QuaTangMe Extaste",807000,1664000,857000,52
TIKI,lam-dep-suc-khoe,54418197,"Bột lá nhuộm tóc OGATIC 50g ( Bao Bì Mới)- Đen tự nhiên",96000,150000,54000,36
TIKI,lam-dep-suc-khoe,9979100,"Combo 10 Gói Mặt Nạ Chiết Xuất Lựu 3W Clinic Fresh Pomeranate Mask Sheet (23ml x 10)",55000,55000,0,0
TIKI,lam-dep-suc-khoe,31292406,"Nhiệt Ẩm Kế Tanita TT-513 đo nhiệt độ phòng, độ ẩm",219000,249000,30000,12
TIKI,lam-dep-suc-khoe,559924,"Tinh Chất Serum Làm Trắng Da Dew&Dew 24k Gold Collagen Serum Whitening - DEW&DEW01 - 50ml",230000,230000,0,0
TIKI,lam-dep-suc-khoe,25202449,"Avène Kem Dưỡng Da Làm Dịu Cơn Ngứa Tức Thời XeraCalm AD Lipid-Replenishing Cream 200ml",591000,739000,148000,20
TIKI,lam-dep-suc-khoe,165988088,"Nước súc miệng Colgate kháng 99% vi khuẩn Plax 500ml/chai",104000,104000,0,0
TIKI,lam-dep-suc-khoe,5744713,"Đèn Hồng Ngoại TNE Lamp",349000,349000,0,0
TIKI,lam-dep-suc-khoe,267098650,"Xịt Chống Nắng Dạng Phun Sương Kiểm Soát Dầu La Roche-Posay Anthelios Invisible Fresh Mist SPF 50+ UVB & UVA (75ml)",475000,575000,100000,17
TIKI,lam-dep-suc-khoe,24503369,"Gậy chống batoong 1 chân xếp gọn Lucass Y597",165000,230000,65000,28
TIKI,lam-dep-suc-khoe,141367783,"Dầu gội gừng hà thủ ô Weilaiya 400ml - Nuôi dưỡng và phục hồi hư tổn cho mái tóc",275000,345000,70000,20
TIKI,lam-dep-suc-khoe,491312,"Bông Tẩy Trang Jomi 80 Miếng/Túi",25000,25000,0,0
TIKI,lam-dep-suc-khoe,6312781,"Nước rửa tay khử mùi Mr.Fresh 5L Hương Táo",162000,162000,0,0
TIKI,lam-dep-suc-khoe,196889653,"Máy Massage Cầm Tay VinBuy - 6 Cấp Độ, Hỗ Trợ Mát Xa Chuyên Sâu, Giảm Đau Cơ, Cứng Khớp - Quà Tặng Cho Sức Khỏe",515000,1000000,485000,49
TIKI,lam-dep-suc-khoe,68819486,"Tinh Dầu Xịt Bưởi Vijully Hỗ Trọ Kích Thích Mọc Tóc Chai 150ml(Mẫu mới)",120000,150000,30000,20
TIKI,lam-dep-suc-khoe,2775371,"Bao Cao Su Sagami Xtreme White (3 Cái / Hộp)",23000,23000,0,0
TIKI,lam-dep-suc-khoe,186267943,"Bộ đai chườm nóng thảo dược giảm đau khuỷu tay dùng điện - Hapaku",499000,650000,151000,23
TIKI,lam-dep-suc-khoe,78498187,"Dụng Cụ Cạo Lưỡi Người Lớn Sản Xuất Tại Thụy Sĩ Trisa Double Action - Hồng",86000,110000,24000,22
TIKI,lam-dep-suc-khoe,118124179,"Viên uống ANGELA GOLD tăng cường sinh lý nữ với Lepidium Meyenii, P.Leucotomos (60 viên)",720000,720000,0,0
TIKI,lam-dep-suc-khoe,5136595,"Sữa rửa mặt Fixderma Non Drying Cleanser (60g)",205000,205000,0,0
TIKI,lam-dep-suc-khoe,179158883,"Máy đo đường huyết OneTouch Select Plus Simple",1000000,1000000,0,0
TIKI,lam-dep-suc-khoe,125818440,"LƯỢC GỘI MASSAGE TẨY TẾ BÀO CHẾT THƯ GIẢN DA ĐẦU HỖ TRỢ KÍCH THÍCH MỌC TÓC",14700,14700,0,0
TIKI,lam-dep-suc-khoe,33229675,"Nẹp ngón tay kín United Medicare (E01)",120000,150000,30000,20
TIKI,lam-dep-suc-khoe,11891804,"Thực phẩm chức năng bảo vệ hệ tiêu hóa - Men vi sinh USANTIBIOPRO FORT MDP dạng nước - Hộp 20 ống x 5ml",150000,150000,0,0
TIKI,lam-dep-suc-khoe,196025286,"Găng Tay Y Tế Latex  I'm gloves Có Bột Màu Trắng Hộp 100 Chiếc",54000,70000,16000,23
TIKI,lam-dep-suc-khoe,204877913,"Cân sức khỏe Life360",179000,290000,111000,38
TIKI,lam-dep-suc-khoe,193603955," Cân Điện Tử, Cân Sức Khỏe Gia Đình Màn Hình LED Hiển Thị Cân Nặng, Nhiệt Độ Hình Con Heo. -JL",75000,75000,0,0
TIKI,lam-dep-suc-khoe,186192786,"Combo Tẩy Da Chết Và Gel Dưỡng Trắng Giảm Thâm Nách, Mông, Bikini Rewhitez Hương Nước Hoa Ngọt Ngào Happiness Tuýp 50g",365000,423000,58000,14
TIKI,lam-dep-suc-khoe,8142305,"Bấm Móng Kềm Nghĩa B-904",53000,53000,0,0
TIKI,lam-dep-suc-khoe,176098208,"Nước tẩy trang da dầu mụn ELDAS, tinh chất TRÀM TRÀ, sạch sâu không cồn thẩm thấu nhanh giảm kích ứng ELDAS 250ml",98000,150000,52000,35
TIKI,lam-dep-suc-khoe,10023457,"Dầu gội nhuộm tóc thảo dược Dexe",220000,220000,0,0
TIKI,lam-dep-suc-khoe,107428139,"Combo 2 Tuýp Sữa Rửa Mặt Hạt Nghệ Ngừa Mụn Thorakao Curcuma Cleansing Milk 100g",103600,103600,0,0
TIKI,lam-dep-suc-khoe,115129321,"SỮA DƯỠNG THỂ CHỐNG NẮNG, DƯỠNG ẨM VÀ LÀM SÁNG DA HATOMUGI SPF50+ PA",115000,115000,0,0
TIKI,lam-dep-suc-khoe,68659707,"KHẨU TRANG Y TẾ KOREA, 04 LỚP",28000,50000,22000,44
TIKI,lam-dep-suc-khoe,164430917,"Cạo lưỡi TONGUE CLEANER Thụy sĩ - sạch khuẩn, hết hôi miệng (Bộ 3 chiếc)",85000,85000,0,0
TIKI,lam-dep-suc-khoe,79316295,"Băng cá nhân MONOPLAST (Hộp 100 miếng)",54000,60000,6000,10
TIKI,lam-dep-suc-khoe,87703885,"Combo 4 gói (360 cây) tăm chỉ nha khoa Okamura (90 cây/gói)",169000,179000,10000,6
TIKI,lam-dep-suc-khoe,96309591,"Dầu gội khô Batiste dry shampoo 200ml TẶNG mặt nạ Sexylook (Nhập khẩu)",138600,198000,59400,30
TIKI,lam-dep-suc-khoe,162844540,"Cao Nám Insam DR CELL 20g",950000,950000,0,0
TIKI,lam-dep-suc-khoe,3074967,"Dầu Gội Bồ Kết Thorakao (750ml)",54000,54000,0,0
TIKI,lam-dep-suc-khoe,442830,"Cân Điện Tử Mặt Kính Beurer GS 14",425000,425000,0,0
TIKI,lam-dep-suc-khoe,192203142,"Máy chống ngáy ngủ bằng xung điện CTFAST, hỗ trợ giảm ngủ ngáy và giúp điều hòa nhịp thở, thiết kế nhỏ gọn phù hợp với mọi người đem lại giấc ngủ trọn vẹn, hiệu quả sau 2 tháng sử dụng",266000,329000,63000,19
TIKI,lam-dep-suc-khoe,15402733,"Gel rửa mặt trắng sáng, trẻ hóa da ISIS Pharma Neotone Gel 150ml",468000,468000,0,0
TIKI,lam-dep-suc-khoe,57656981,"Xịt mũi thảo dược giúp giảm triệu chứng viêm xoang, viêm mũi EUGICA THÔNG XOANG (Chai 15 ml)",50000,60000,10000,17
TIKI,lam-dep-suc-khoe,694387,"Tinh Dầu Bạc Hà Lorganic (10ml)",45000,90000,45000,50
TIKI,lam-dep-suc-khoe,63496813,"Serum hỗ trợ trị mụn Detox Blanc Peel Acnes Blanc 40ml (Serum H cho da nhiều mụn)",190000,190000,0,0
TIKI,lam-dep-suc-khoe,8142267,"Kềm Cắt Da Thép Không Gỉ Kềm Nghĩa D-09(16)",175000,175000,0,0
TIKI,lam-dep-suc-khoe,5136667,"Gel làm mờ sẹo Fixderma Scar gel (15ml)",222000,278000,56000,20
TIKI,lam-dep-suc-khoe,164941170,"Gel Bôi Trơn Sagami Original (60g) - Trong Suốt - Không Màu - Không Mùi - 100% Nhập Khẩu Nhật Bản - Che Tên Sản Phẩm",188900,279000,90100,32
TIKI,lam-dep-suc-khoe,116552538,"Khẩu Trang Y Tế Kháng Khuẩn Famapro 4D Chính Hãng - Hộp 10 cái - 5 màu lựa chọn",12000,12000,0,0
TIKI,lam-dep-suc-khoe,2984005,"Dầu Gội Xả Hoa Bưởi Thorakao (400ml)",69000,69000,0,0
TIKI,lam-dep-suc-khoe,102767167,"Viên uống chống nắng PIOME SUN",800000,800000,0,0
TIKI,lam-dep-suc-khoe,169815915,"Kem chống nắng dạng gel giúp giảm mụn kiểm soát bóng nhờn và thu nhỏ lỗ chân lông La Roche-Posay Anthelios Oil Correct 50ml",385000,550000,165000,30
TIKI,lam-dep-suc-khoe,55461727,"Kem Dưỡng Sáng Da Laneige Radian-C Cream 50ml",1050000,1200000,150000,13
TIKI,lam-dep-suc-khoe,73317762,"Nước xịt dưỡng tóc tinh dầu bưởi pomelo cocoon 140ml + Serum mọc tóc pomelo bồ kết herbario 30ml",350000,350000,0,0
TIKI,lam-dep-suc-khoe,16061455,"Nước tẩy trang Loreal Micellar Water 3-in-1 Refreshing Even For Sensitive Skin",175000,175000,0,0
TIKI,lam-dep-suc-khoe,933535,"Bao Cao Su Tâm Thiện Chí Guardian Gia Đình (Hộp 144 Cái)",127000,150000,23000,15
TIKI,lam-dep-suc-khoe,205080744,"Viên uống tăng cường sinh lý nam giới Powergra (Super Gold Magic) - Vỉ 3 viên",506000,550000,44000,8
TIKI,lam-dep-suc-khoe,522617,"Kem Làm Giảm Mụn Và Loại Bỏ Dầu Cho Da SVR Sebiaclear Active Tuýp 40ml - SAC",380000,475000,95000,20
TIKI,lam-dep-suc-khoe,522736,"Sữa Rửa Mặt Tẩy Tế Bào Chết SVR Sebiaclear Gel Moussant Tuýp 200ml - SGM",245000,350000,105000,30
TIKI,lam-dep-suc-khoe,878387,"Tỏi Kim Cương Đông Á - Tỏi Đen Cô Đơn - Hộp 200g",270000,390000,120000,31
TIKI,lam-dep-suc-khoe,175106243,"Xịt Khử Mùi Nam Body Mist Nam Gatsby Perfume Body Spray - Tặng móc khoá chính hãng",119000,119000,0,0
TIKI,lam-dep-suc-khoe,173463343,"Siêu mặt nạ chăm sóc lỗ chân lông Innisfree Super Volcanic Pore Clay Mask 100ml (New 2023)",286000,360000,74000,21
TIKI,lam-dep-suc-khoe,114778801,"[Chính Hãng] Bàn Chải Đánh Răng Điện Zenyum Sonic T11 - Màu Đen Matte - Công Nghệ Singapore",989000,1300000,311000,24
TIKI,lam-dep-suc-khoe,3950339,"Sữa Dưỡng Thể Cho Da Nhạy Cảm Eucerin pH5 Skin Protection Lotion (250 ml) (Không Mùi)",184000,231000,47000,20
TIKI,lam-dep-suc-khoe,175721249,"Vitamin 3B - Trivitamin B1-B6-B12 Hộp 100 Viên Nén Đ.Y - Bổ Sung Vitamin Nhóm B Giúp Tăng Cường Sức Đề Kháng",19000,35000,16000,46
TIKI,lam-dep-suc-khoe,118528516,"Viên Uống Bổ Sung Vitamin C DHC Vitamin C Hard Capsule Tăng Sức Đề Kháng",105000,105000,0,0
TIKI,lam-dep-suc-khoe,8094768,"Nước Cân Bằng Giàu Khoáng Dành Cho Da Nhạy Cảm La Roche-Posay Soothing Lotion Sensitive Skin - 200ml",419000,505000,86000,17
TIKI,lam-dep-suc-khoe,175779580,"Sữa Chống Nắng Dưỡng Da Shiseido Urban Environment Triple Beauty Suncare EmulsionSPF50+ PA++++ 30ml",1250000,1250000,0,0
TIKI,lam-dep-suc-khoe,63597395,"Kem dưỡng da nhập khẩu ÚC Redwin Cream with Vitamin E 300g",115000,148000,33000,22
TIKI,lam-dep-suc-khoe,113827043,"Bộ lấy ráy tai đa năng 6 món Cao cấp bằng thép không rỉ KitAcoom, hàng nhập khẩu cao cấp có hộp đựng",39999,39999,0,0
TIKI,lam-dep-suc-khoe,158744112,"Tăm bông thân giấy Pharmacity",17000,17000,0,0
TIKI,lam-dep-suc-khoe,96305219,"Máy xông tinh dầu mẫu mới công nghệ hiện đại mã máy DK-LH NEW - Hình Lọ hoa - Kèm remote, nâng cấp chức năng , chế độ phun mạnh, khuếch tán tinh dầu trong không gian rộng",233000,420000,187000,45
TIKI,lam-dep-suc-khoe,36158816,"Kem ủ trắng toàn thân Truesky Whitening Body Cream chiết xuất rễ cây cam thảo 100g",160000,160000,0,0
TIKI,lam-dep-suc-khoe,8211890,"Dũa Móng Giấy DG-402A - Kềm Nghĩa",28500,30000,1500,5
TIKI,lam-dep-suc-khoe,102878262,"Tăm nước vệ sinh răng miệng Xiaomi Soocas W3 Pro - Hàng Nhập Khẩu",775000,796000,21000,3
TIKI,lam-dep-suc-khoe,69064268,"Bồn ngâm chân massage cao cấp USA 6 con lăn tự động, vòi phun massage, Serenelife SLIFTSP12 nhập khẩu ",2198800,3200000,1001200,31
TIKI,lam-dep-suc-khoe,6884515,"Sữa rửa mặt dạng bùn Trà tràm – Naruko Tea Tree Purifying Clay Mask and Cleanser in 1 (120g)",185000,239000,54000,23
TIKI,lam-dep-suc-khoe,55615086,"Kem Dưỡng Ẩm Trắng Da Ban Đêm Tế Bào Gốc Phục Hồi Trẻ Hoá Da Và Chống Lão Hoá Cellkey-Scien White Cream (30g)",882000,980000,98000,10
TIKI,lam-dep-suc-khoe,911335,"Sữa Rửa Mặt Dưỡng Ẩm, Làm Sạch Sâu Chiết Xuất Hoa Cúc - Oribe Facial Cleanser 100g",90000,125000,35000,28
TIKI,lam-dep-suc-khoe,7722302,"Combo 10 đắp mặt nạ hàn quốc trắng da hỗ trợ điều trị mụn BENEW ( 22ml/ gói) MIX VỊ NGẪU NHIÊN",95000,95000,0,0
TIKI,lam-dep-suc-khoe,115698893,"1 Hộp Vitamin E Đỏ Mirrolla 400Mg 30 viên của Nga",92900,150000,57100,38
TIKI,lam-dep-suc-khoe,169956184,"Glutathione 600 - Viên Uống Trắng Da Glutathione Dr.Lacir :Đẹp Da, Mờ Nám, Cân Bằng Nội Tiết Tố (Chính Hãng Dr Lacir)",580000,580000,0,0
TIKI,lam-dep-suc-khoe,5812635,"Phấn chống lão hóa mới màu da Phấn Nụ Hoàng Cung",150000,180000,30000,17
TIKI,lam-dep-suc-khoe,1021887,"Bộ Máy Đo Đường Huyết Accu-Chek Instant mmol/L",1099000,1218000,119000,10
TIKI,lam-dep-suc-khoe,159060347,"[HỘP - D&J] Khẩu Trang Y Tế Kháng Khuẩn 4 Lớp D&J/Tiêu Chuẩn Quốc Tế/Hộp 50 Cái Màu Đen",35000,35000,0,0
TIKI,lam-dep-suc-khoe,82738970,"Gương trang điểm để bàn gương làm đẹp cao cấp gương soi di động bằng gỗ xoay gập tiện lợi phong cách châu Âu 4 mẫu tùy chọn - Tặng 1 băng đô trang điểm vải nhung/lụa màu ngẫu nhiên",65000,65000,0,0
TIKI,lam-dep-suc-khoe,76068336,"Máy đo Đường huyết, Mỡ máu, AxitUric 5 trong 1 Facare FC-M168 (TD-4216) bluetooth",800000,800000,0,0
TIKI,lam-dep-suc-khoe,156193998,"Combo 3 Bộ Kit Test Covid 19 Tại nhà HUMASIS Hàn Quốc (Chính hãng)",210000,210000,0,0
TIKI,lam-dep-suc-khoe,9849188,"Máy xông khí dung Omron NE-C101",790008,1250000,459992,37
TIKI,lam-dep-suc-khoe,1662437,"Hộp 3 Đôi Nút Bịt Tai Chống Ồn Mack's Safe Sound Siêu Mềm, Siêu Chống Ồn #903",79000,79000,0,0
TIKI,lam-dep-suc-khoe,131504789,"Dầu xả dược liệu Thái Dương 3 200ml/ 600ml/ 1100ml",60000,60000,0,0
TIKI,lam-dep-suc-khoe,184773476,"Gối Massage Đa Năng VISPO VP-G22 - Máy Mát xa Toàn Thân Nhiệt Hồng Ngoại - Chuyên Sâu Cho Cổ, Vai Gáy, Lưng Dưới, Đùi, Chân - Sử Dụng Tại Nhà, Văn Phòng, Trên Ô Tô",899000,1050000,151000,14
TIKI,lam-dep-suc-khoe,50326939,"Kem Dưỡng Ngăn Lão Hóa, Sáng Da Vichy Collagen Liftactiv Collagen Specialist Chuyên Biệt (50ml)",1048000,1165000,117000,10
TIKI,lam-dep-suc-khoe,137005295,"Kem Dưỡng Phục Hồi Da Rau Má GoodnDoc Centella Repair Cream 50ml",399000,485000,86000,18
TIKI,lam-dep-suc-khoe,5925677,"Miếng dán tẩy lông Beauty Formulas Wax Strips Legs and Body - hộp 20 miếng",157000,157000,0,0
TIKI,lam-dep-suc-khoe,178560001,"Combo Xà Bông + Sữa Rửa Mặt Nghệ MELA Thiên Nhiên, Làm Sạch Tẩy Da Chết Thoáng Lỗ Chân Lông Giảm Mụn - ML18",260000,260000,0,0
TIKI,lam-dep-suc-khoe,75380136,"Mẫu mới - Tinh chất dưỡng The Ordinary Alpha Arbutin 2% + HA 30ml  ",348000,385000,37000,10
TIKI,lam-dep-suc-khoe,150310982,"Viên Uống Sáng Mắt Flopti Eye Giảm Khô Mắt, Mờ Mắt, Mỏi Mắt Hộp 30 viên",276000,355000,79000,22
TIKI,lam-dep-suc-khoe,150269406,"Bộ Dưỡng Trắng Da Tế Bào Gốc Phục Hồi Trẻ Hoá Da Và Chống Lão Hoá Cellkey-Scien Repair System White Set (60ml)",1674000,1860000,186000,10
TIKI,lam-dep-suc-khoe,167019461,"Kem Face Collagen X3 dưỡng Trắng da - Ngừa mụn - Nám",158000,190000,32000,17
TIKI,lam-dep-suc-khoe,10082226,"Dầu Gội Đen Tóc Thảo Dược LICH 5",215000,215000,0,0
TIKI,lam-dep-suc-khoe,39607755,"Kem ủ phục hồi tóc Olaplex Hair Perfector No.3 chính hãng Mỹ 100ml",560500,590000,29500,5
TIKI,lam-dep-suc-khoe,1860269,"Kem Dưỡng Trắng Da Và Se Khít Lỗ Chân Lông Zoley 10g",79000,150000,71000,47
TIKI,lam-dep-suc-khoe,44073861,"Dầu Gội Tresemmé Keratin Smooth Tinh Dầu Argan Và Keratin Vào Nếp Suôn Mượt (640g)",149000,149000,0,0
TIKI,lam-dep-suc-khoe,76134019,"[HỘP - FAMAPRO MAX KID] - khẩu trang y tế trẻ em kháng khuẩn 3 lớp Famapro Max Kid (50 cái/ hộp) - 1 HỘP",25000,36000,11000,31
TIKI,lam-dep-suc-khoe,114532904,"[FAMAPRO - PREMIUM] Khẩu trang y tế cao cấp 4 lớp kháng khuẩn Famapro Premium (40 cái/ hộp)",26900,26900,0,0
TIKI,lam-dep-suc-khoe,58852974,"Tinh Bột Cám Gạo Nguyên Chất UMIHOME (135g) Dùng cho dưỡng da loại bỏ mụn, tẩy da chết hiệu quả tại nhà",143000,195000,52000,27
TIKI,lam-dep-suc-khoe,164075481,"An Trĩ Vương Hỗ Trợ Cải Thiện Táo Bón Giúp Thanh Nhiệt, Giải Độc Có Thể Sử Dụng Cho Phụ Nữ Có Thai Hộp 30 Viên",185000,185000,0,0
TIKI,lam-dep-suc-khoe,84593352,"Que thử đường huyết On-call plus (25 que/hộp)",154500,230000,75500,33
TIKI,lam-dep-suc-khoe,837895,"Nước Hoa Hồng Sắc Ngọc Khang MNH01 (145ml)",92000,115000,23000,20
TIKI,lam-dep-suc-khoe,4354043,"Bột lá nhuộm tóc màu Đen Ogatic 50gr thảo dược",105000,105000,0,0
TIKI,lam-dep-suc-khoe,58436883,"Túi Chườm Thỏ Bông 350ml - Chườm Đa Năng Nóng Lạnh- Vải Lông Cừu Mềm Mại Ấp Áp- Chườm Bụng Cho Các Nàng Khi Đau Bụng Kinh Nguyệt",59000,59000,0,0
TIKI,lam-dep-suc-khoe,58615306,"Tinh dầu Sả chanh cao cấp 50ML Lemongrass. Tinh dầu xông phòng Vemoda giúp thanh lọc không khí, khử mùi, kháng khuẩn, đuổi muỗi, giải cảm, làm đẹp. Tinh dầu thiên nhiên sả chanh",149000,149000,0,0
TIKI,lam-dep-suc-khoe,210146716,"Bột Trà Xanh nguyên chất UMIHOME 40G bột đắp mặt nạ, tắm trắng, dưỡng ẩm da và ngừa mụn hiệu quả",51000,100000,49000,49
TIKI,lam-dep-suc-khoe,186271043,"Khẩu trang y tế 4D (KF94) NPCARE Dreamy Tím (H/10c)",30000,30000,0,0
TIKI,lam-dep-suc-khoe,104397933,"Combo 2 Kem tẩy lông cho da nhạy cảm Veet Silk Fresh 50g",122000,140200,18200,13
TIKI,lam-dep-suc-khoe,88223765,"Viên uống Collagen Sắc Ngọc Khang thế hệ mớI Hộp 60 viên giúp sáng da, giảm nếp nhăn - đốm nâu, nuôi dưỡng và làm đẹp da , tóc, móng",353000,390000,37000,9
TIKI,lam-dep-suc-khoe,42953037,"Bột Tạo Phồng Apestomen Volcanic Clay Ash 25g",249000,249000,0,0
TIKI,lam-dep-suc-khoe,94474533,"Kềm Cắt Da Thép Chuyên Dụng Mạ Vàng KỀM NGHĨA D.777",90000,90000,0,0
TIKI,lam-dep-suc-khoe,52053647,"Combo 02 Dầu Gội Ngăn Ngừa Gàu Clear Mát Lạnh Bạc Hà",473000,473000,0,0
TIKI,lam-dep-suc-khoe,50700392,"Nước hoa hồng Dưỡng Ẩm Và Làm Dịu Da Bioderma Sensibio Tonique",414000,435000,21000,5
TIKI,lam-dep-suc-khoe,1362447,"Sữa Rửa Mặt Cetaphil Gentle Skin Cleaner (500ml) - 8394107341305,9318637069637",367500,499000,131500,26
TIKI,lam-dep-suc-khoe,120427473,"Vitamin C 250mg Kirkland Adult Gummies tăng sức đề kháng, sáng da, thúc đẩy sản xuất collagen, làm chậm quá trình lão hóa - QuaTangMe Extaste - 1lọ",395000,802000,407000,51
TIKI,lam-dep-suc-khoe,80468377,"Dầu dừa tinh khiết mỹ phẩm Vietcoco 130ml",82000,82000,0,0
TIKI,lam-dep-suc-khoe,4704655,"Vớ/tất y khoa đùi Hỗ Trợ Điều Trị suy giãn tĩnh mạch chân JOBST Relief chuẩn áp lực 20-30mmHg",989000,989000,0,0
TIKI,lam-dep-suc-khoe,70495152,"Son dưỡng môi dạng sáp chuyên biệt dành cho môi khô, nứt nẻ Mentholatum Medi Lip Balm 7g",73900,79000,5100,6
TIKI,lam-dep-suc-khoe,108535241,"Bao cao su Sagami Super Dot 009 - Có gai nhỏ - Dày - Hộp 10 chiếc",95000,120000,25000,21
TIKI,lam-dep-suc-khoe,156957796,"[HCM] Bộ kit FLOWFLEX ACON MỸ test nhanh COVID19 tại nhà, nhập chính hãng được BYT công nhận xuất VAT khi khách yêu cầu",56000,56000,0,0
TIKI,lam-dep-suc-khoe,36664922,"Túi chườm nóng lạnh Thiên Thanh size lớn 28cm x 38cm (Màu sắc ngẫu nhiên)",170000,170000,0,0
TIKI,lam-dep-suc-khoe,162966798,"Sáp wax lông nóng dạng hạt đậu",29000,29000,0,0
TIKI,lam-dep-suc-khoe,56252523,"(Package mới) Kem dưỡng Simple Kind To Skin Hydrating Light Moisturizer - Thường 125ml",159000,159000,0,0
TIKI,lam-dep-suc-khoe,40657228,"Combo 10 dũa móng tay không làm xước da",31000,35000,4000,11
TIKI,lam-dep-suc-khoe,58678128,"Dầu Cá Blackmores Oudourless Fish Oil 1000 Mg Hộp 400 Viên không tanh chính hãng Úc mẫu mới 2020",550000,687500,137500,20
TIKI,lam-dep-suc-khoe,3483365,"Thực Phẩm Chức Năng Green Swan Imunostim Junior - Tăng Cường Chức Năng Hệ Miễn Dịch Cho Trẻ Em",325000,325000,0,0
TIKI,lam-dep-suc-khoe,7240315,"Bộ 10 Gói Mặt Nạ Tuyết Dưỡng Trắng Da 3W Clinic Fresh White Mask Sheet (23ml X 10)",55000,55000,0,0
TIKI,lam-dep-suc-khoe,145839587,"Bàn Chải Đánh Răng Điện sóng âm Kachi Sonic MK309",637000,900000,263000,29
TIKI,lam-dep-suc-khoe,145221424,"Bộ 6 Khẩu trang dành cho bé Unicharm 3D Mask Kid (Ngăn được bụi mịn PM2.5) gói 5 miếng",149000,149000,0,0
TIKI,lam-dep-suc-khoe,270813315,"Vitamin cho bà bầu Prenatal Folic Acid+ DHA Nature Made giúp mẹ khỏe, bé phát triển não bộ, hệ thần kinh và thể lực - QuaTangMe Extaste",832000,1664000,832000,50
TIKI,lam-dep-suc-khoe,104398857,"Kem Tẩy Lông Cho Da Thường Veet Silk Fresh 50G",63000,70100,7100,10
TIKI,lam-dep-suc-khoe,95934490,"Combo 16 gói Băng Vệ Sinh Quần Peppy Shana Siêu Thấm Free Size (32 miếng)",225000,456000,231000,51
TIKI,lam-dep-suc-khoe,37159632,"Bộ dụng cụ nặn mụn lấy ráy tai 4 cây 8 đầu đa năng và tiện dụng",13000,22000,9000,41
TIKI,lam-dep-suc-khoe,10685635,"Cao Gừng Tan Mỡ Thiên Nhiên Việt (200g) Tặng Kèm Đai Nịt Bụng Cao Cấp An Nhiên",299000,299000,0,0
TIKI,lam-dep-suc-khoe,94118574,"Băng vệ sinh ban đêm Doctor Care chiết suất thảo dược 33.8cm the mát sảng khoái",16500,18000,1500,8
TIKI,lam-dep-suc-khoe,96136115,"100 Cái Bao Ngón Tay Cao Su Làm Nail",23399,23399,0,0
TIKI,lam-dep-suc-khoe,12219979,"Tảo Xoắn Spirulina nội địa Nhật Bản (2200 viên)",350000,350000,0,0
TIKI,lam-dep-suc-khoe,112509290,"tinh dầu dạ Thảo liên 20ml",160000,160000,0,0
TIKI,lam-dep-suc-khoe,58407534,"Hộp 50 que thử đường huyết dùng cho máy đo đường huyết OGCare",275000,455000,180000,40
TIKI,lam-dep-suc-khoe,181687259,"Viên Uống DHC Melilot Hỗ Trợ Thon Chân 60 Ngày (120 Viên)",550000,650000,100000,15
TIKI,lam-dep-suc-khoe,270808501,"Xịt họng keo Ong Úc Vitatree Super Propolis Spray Complex with Honey 15+ Giúp bổ sung kháng khuẩn tự nhiê, Giảm đau rát viêm họng, ho, nhiệt lỡ miệng - OZ Slim Store",112000,258000,146000,57
TIKI,lam-dep-suc-khoe,173836553,"Bao cao su Safefit 4in1 hộp 12 cái tặng hộp 3 cái",95000,100000,5000,5
TIKI,lam-dep-suc-khoe,14901584,"Tặng kèm nhiệt kế điện tử - Máy Xông Khí Dung OMRON NE-C803 - Trị Liệu Hô Hấp - Trọng Lượng Nhẹ 180g",1050000,1350000,300000,22
TIKI,lam-dep-suc-khoe,53653425,"Dầu gội thảo dược HÀ THỦ Ô Chiết xuất từ 6 loại thảo dược - Cân Bằng Sắc Tố Melanin Khỏi lo bạc tóc rụng tóc Cocayhoala 300g",220000,300000,80000,27
TIKI,lam-dep-suc-khoe,118090109,"Viên Sủi Bổ Sung Vitamin C, D, Và Kẽm Redoxon Triple Action 10 Viên",85000,85000,0,0
TIKI,lam-dep-suc-khoe,389688,"Gel Bôi Trơn Cao Cấp Sagami Original (60g)",179000,179000,0,0
TIKI,lam-dep-suc-khoe,154262538,"Viên uống chống nắng UV Screen Rejuvicare - hộp 30 viên ",107820,119800,11980,10
TIKI,lam-dep-suc-khoe,186370235,"Kem Body Lục Tảo Luxury Body Cream Dưỡng Trắng Da SOO YOUNG (250g)",110000,210000,100000,48
TIKI,lam-dep-suc-khoe,14132901,"Máy khuếch tán tinh dầu Lanaform Fidji",1000000,1000000,0,0
TIKI,lam-dep-suc-khoe,15931478,"Bộ dụng cụ lấy ráy tai 7 món",49000,49000,0,0
TIKI,lam-dep-suc-khoe,100128908,"Lăn Khử Mùi Ngăn Mồ Hôi Perspi-Guard Maximum Strength Antiperspirant Roll-on 30ml - Giải Pháp Khử Mùi & Ngăn Tiết Mồ Hôi Cơ Thể Đến Từ Anh",165000,165000,0,0
TIKI,lam-dep-suc-khoe,157027735,"Combo 4 Miếng Dán Dùng Cho Máy Massage Xung Điện PEAFLO",33000,49000,16000,33
TIKI,lam-dep-suc-khoe,85660175,"Sữa Rửa Mặt Nghệ Hưng Yên Cocoon 140ml",165750,195000,29250,15
TIKI,lam-dep-suc-khoe,73784845,"Sữa rửa mặt tạo bọt dịu nhẹ, kiềm dầu, cân bằng độ ẩm, ngừa mụn Rainbow L'affair Multi-Care V5 Facial Foaming Cleanser 150ml",175000,350000,175000,50
TIKI,lam-dep-suc-khoe,105042382,"Tinh chất giảm thâm nám và dưỡng sáng da Eucerin Spotless Brightening Booster Serum",1094000,1459000,365000,25
TIKI,lam-dep-suc-khoe,977111,"Hộp 5 Đôi Nút Bịt Tai Đặc Biệt Dreamgirl™ Cho Nữ Mack's #935",129000,129000,0,0
TIKI,lam-dep-suc-khoe,24252400,"Mặt nạ ngủ dưỡng da Dear Klairs Freshly Juiced Vitamin E Mask 90ml",259000,259000,0,0
TIKI,lam-dep-suc-khoe,1601705,"Nước Hoa Hồng Dưỡng Ẩm The Body Shop Vitamin E (250ml)",399000,399000,0,0
TIKI,lam-dep-suc-khoe,78510217,"Combo 3 Tinh Dầu Oải Hương + Tinh Dầu Bạc Hà + Tinh Dầu Cam Ngọt Nguyên Chất - Tinh Dầu TIDAMO Cao Cấp Xông Phòng Giúp Thư Giãn, Thơm Phòng Và Nâng Cao Sức Khỏe (3 chai 10ML)",84000,236000,152000,64
TIKI,lam-dep-suc-khoe,144737655,"Khẩu trang Người lớn, Trẻ em Mayan 3D Mask 5 cái/túi",20000,20000,0,0
TIKI,lam-dep-suc-khoe,128633299,"Phấn Phủ Dạng Nén Kiềm Dầu The Saem Saemmul Perfect Pore Pact (12g)",240000,240000,0,0
TIKI,lam-dep-suc-khoe,73400011,"Bàn chải kẽ răng SGS loại L nhập khẩu Hàn Quốc",50000,100000,50000,50
TIKI,lam-dep-suc-khoe,158100770,"Tinh Dầu Hoa Nhài Treo Phòng, Treo Xe Hơi Tạo Hương Thơm Dịu Nhẹ Quý Phái - Tinh Dầu Hoa Lài TIDAMO (Jasmine) Nhập Khẩu, Có Kiểm Nghiệm Giúp Thơm Phòng, Thư Giãn và Tốt Cho Sức Khỏe",64000,128000,64000,50
TIKI,lam-dep-suc-khoe,54141246,"Tinh dầu hoa Lài (nhài) 100ml Mộc Mây - tinh dầu nguyên chất 100% từ thiên nhiên - chất lượng và mùi hương vượt trội",299000,299000,0,0
TIKI,lam-dep-suc-khoe,163826941,"Một chiếc khẩu trang N99 có Van ngăn đến 99% hạt bụi siêu mịn có kích thước từ 0,3 Mircromet #MONA MASK",30000,30000,0,0
TIKI,lam-dep-suc-khoe,8098630,"Kem Giảm Mụn, Thâm Mụn, Sẹo Mụn White Doctors Acne Pro",285000,380000,95000,25
TIKI,lam-dep-suc-khoe,74215409,"Túi chườm nóng lạnh MOHI - Chính hãng",27550,29000,1450,5
TIKI,lam-dep-suc-khoe,21602792,"Dầu gội suôn mượt cho tóc khô L'oreal Hair Spa Deep Nourishing shampoo 600ml",195000,215000,20000,9
TIKI,lam-dep-suc-khoe,137672666,"Sữa rửa mặt tẩy tế bào da chết ngừa mụn St.Ives Hoa Hồng & Lô Hội 170g",135000,149000,14000,9
TIKI,lam-dep-suc-khoe,54016974,"Combo 20 Bộ 40 Miếng Dán Mồ Hôi Tay Áo Cao Cấp , Thoải Mái Cho Người Dùng, Tiện Lợi Cho Nhân Viên Công Sở, Miếng thấm hút mồ hôi, Miếng dán mồ hôi dưới cánh tay khử mùi",99000,99000,0,0
TIKI,lam-dep-suc-khoe,520953,"Dao Cạo Râu Gillette Super Click",16000,16000,0,0
TIKI,lam-dep-suc-khoe,26350332,"Xịt Khoáng Khử Clo Sau Khi Bơi SwimRinse",160000,160000,0,0
TIKI,lam-dep-suc-khoe,4423229,"Nước rửa tay Premium Hand Soap Mr Fresh Hàn Quốc 5L",162000,162000,0,0
TIKI,lam-dep-suc-khoe,146086160,"Dầu Tắm Gội Dapper Dan Hair & Body Shampoo 300ml",330000,330000,0,0
TIKI,lam-dep-suc-khoe,9800871,"Viên Uống Olympian Labs Green Calcium Bổ Sung Canxi Hữu Cơ Cho Bà Bầu, Trẻ Em, Người Lớn Hộp 100 Viên",510000,510000,0,0
TIKI,lam-dep-suc-khoe,68698970,"Nước Súc Miệng Cai Thuốc Lá Xuân Vinh 400ml - Làm mất cảm giác thèm thuốc, ngăn ngừa các bệnh về răng miệng, thành phần thiên nhiên, an toàn + Tặng kèm móc khoá CLĐ",189000,320000,131000,41
TIKI,lam-dep-suc-khoe,107321782,"Combo 2 Chai Dầu Gội Và Xả Bồ Kết Thorakao 400ml",143800,143800,0,0
TIKI,lam-dep-suc-khoe,95067213,"Chai xịt diệt khuẩn Nano bạc AHT trà trắng dùng rửa tay, xịt màn hình, vệ sinh phòng ngủ",49000,76700,27700,36
TIKI,lam-dep-suc-khoe,7146751,"Combo 5 hộp dầu gội thảo dược đen tóc TOSMEDY – Đen tóc không đen da đầu",119000,119000,0,0
TIKI,lam-dep-suc-khoe,82403186,"Combo 3 lọ Dưỡng Tâm An Lafon - Viên uống hỗ trợ mất ngủ, giúp ngủ ngon và sâu giấc (30 viên/lọ)",500000,500000,0,0
TIKI,lam-dep-suc-khoe,131504612,"Sữa rửa mặt nghệ sạch mụn, ngừa vết thâm Thái Dương 90g",35000,35000,0,0
TIKI,lam-dep-suc-khoe,12063801,"Xịt Khử Mùi Hàng Ngày Etiaxil Déodorant Anti-Transpirant 48h Anti-Traces Blanches & Jaunes 150ml (Dạng Xịt Phun Sương)",237000,237000,0,0
TIKI,lam-dep-suc-khoe,118896544,"Nến thơm tinh dầu cao cấp không khói an toàn Candle Cup - GINGERGRASS/GỪNG SẢ - S - 100G (KG NẮP)",120000,120000,0,0
TIKI,lam-dep-suc-khoe,636922,"Bao Cao Su 4 in 1 Gân, Gai, Mỏng, Kéo Dài Quan Hệ Azodra (12 Gói)",59000,59000,0,0
TIKI,lam-dep-suc-khoe,10131586,"Combo 4 Hộp Viên Uống Đạm Tăng Cân AVITA Dành Cho Người Gầy, Giúp Tăng Cường Sức Đề Kháng, Nâng Cao Thể Trạng, An Toàn Hiệu Quả 60 Viên/Hộp",648000,792000,144000,18
TIKI,lam-dep-suc-khoe,162169413,"Bột nghệ uống liền Set 2 gói 16g Honimore - thơm ngon - đẹp da - tăng cường sức khoẻ",12000,12000,0,0
TIKI,lam-dep-suc-khoe,84596223,"Kim chích máu máy đo đường huyết Acon On-call (100 kim / hộp)",39000,99000,60000,61
TIKI,lam-dep-suc-khoe,11961980,"Sữa rửa mặt nghệ nano NeoCleanser",158000,158000,0,0
TIKI,lam-dep-suc-khoe,15252312,"Trà Thảo mộc Hỗ Trợ Giảm cân Hera Plus (30 viên)",347000,347000,0,0
TIKI,lam-dep-suc-khoe,7805771,"Thực Phẩm Chức Năng Tảo Tăng Chiều Cao Shinshin Kakumei Nhật Bản",375000,520000,145000,28
TIKI,lam-dep-suc-khoe,1022207,"Que Thử Đường Huyết Accu-Chek Instant 25",261000,399000,138000,35
TIKI,lam-dep-suc-khoe,134821636,"Bông phấn,mút phấn trang điểm vuông nhỏ tiện lợi và dễ sử dụng Nhật 727 SDS Sponge",53000,90000,37000,41
TIKI,lam-dep-suc-khoe,176098198,"Combo Sữa tắm mụn lưng ELDAS diệt khuẩn ngừa mụn 24 giờ &amp; Sữa rửa mặt Eldas mờ thâm da sáng mịn đều màu",176000,279000,103000,37
TIKI,lam-dep-suc-khoe,2616297,"Kem hỗ trợ Trị Thâm Và Dưỡng Sáng Vùng Mắt Milky Dress (15ml)",225000,225000,0,0
TIKI,lam-dep-suc-khoe,178297539,"Sáp tạo kiểu tóc giữ nếp tự nhiên Romano Restyleable Matte Wax 68g/hộp ",82000,82000,0,0
TIKI,lam-dep-suc-khoe,191365627,"Combo 2 Sữa dưỡng thể với thành phần ngừa lão hóa dưỡng sáng VASELINE Healthy Bright Perfect Youth 350ML/chai",209000,300000,91000,30
TIKI,lam-dep-suc-khoe,58744960,"Nước tẩy trang L'Oreal Paris 3-in-1 Micellar Water 400ml",189000,189000,0,0
TIKI,lam-dep-suc-khoe,217007520,"Trắng da Glutathione Puritan’s Pride L-Glutathione 500mg Hỗ trợ trắng da, Giảm nám, tàn nhang, Thải độc , Tăng hệ miễn dịch - QuaTangMe Extaste",446000,892000,446000,50
TIKI,lam-dep-suc-khoe,107443285,"Serum Xóa Mụn V9Queen, Giúp Mờ Thâm Nám Dưỡng Trắng Da 20ml",159000,159000,0,0
TIKI,lam-dep-suc-khoe,75933856,"Chì Kẻ Mày 2in1 NoVo Makeup Seduce (Kẻ Mày + Kẻ Mắt)",75000,85000,10000,12
TIKI,lam-dep-suc-khoe,63481337,"Bộ 3 Kem đánh răng Colgate Than tre sạch thuần khiết từ Hàn Quốc 180g/ tuýp",165000,165000,0,0
TIKI,lam-dep-suc-khoe,76182173,"Chống nắng dạng thỏi Shiseido GSC Clear Suncare Stick SPF50+ 20G",779000,780000,1000,0
TIKI,lam-dep-suc-khoe,31894793,"Tinh Chất Hỗ Trợ Giảm Mụn & Giảm Thâm The Ordinary Niacinamide 10% + Zinc 1% 30ml",228000,350000,122000,35
TIKI,lam-dep-suc-khoe,68165960,"Máy tăm nước di động, sạc cảm ứng Golden Care GC-89",999000,999000,0,0
TIKI,lam-dep-suc-khoe,26710011,"Combo 10 Túi mặt nạ giấy dưỡng ẩm -Mặt nạ dưỡng da chiết xuất từ lô hội 3W Clinic Hàn Quốc 23mlx10",52000,52000,0,0
TIKI,lam-dep-suc-khoe,33605570,"Kem Chống nắng cho da mụn, bị mụn trứng cá Eucerin Sun Gel-Creme oil control Dry Touch SPF50+ 50ml + tặng máy massage mặt ion",466650,549000,82350,15
TIKI,lam-dep-suc-khoe,67195678,"Trà Genpi Orihiro 60 gói/túi",153000,300000,147000,49
TIKI,lam-dep-suc-khoe,126102307,"Viên Uống Rau Củ DHC Perfect Vegetable Premium Giúp Tiêu Hoá Tốt, Nâng Cao Sức Khoẻ Gói 60 Viên/120 Viên/360 Viên",155000,155000,0,0
TIKI,lam-dep-suc-khoe,155286036,"Son Dưỡng Môi Hồng Xinh Vaseline Lip Therapy Rosy Lip (7g)",59000,59000,0,0
TIKI,lam-dep-suc-khoe,104745477,"Tăng Cường Sinh Lý Nam Supo Maca Genki Fami Nhật Bản, Chiết Xuất Nhân Sâm, Baba, Hàu Biển - Hộp 90 viên",766000,830000,64000,8
TIKI,lam-dep-suc-khoe,25440933,"Kẻ mắt nước Bbia Last Pen Eyeliner 0.6g (5 màu)",120000,200000,80000,40
TIKI,lam-dep-suc-khoe,68494645,"Son dưỡng có màu tự nhiên LipIce Sheer Color Q Mojito Mint 2.4g (Hồng Tự Nhiên) 2.4g",66000,82500,16500,20
TIKI,lam-dep-suc-khoe,33606827,"Kem giảm thiểu tế bào chết Paula’s Choice Skin Perfecting 2% BHA Gel Exfoliant 100ml",949000,949000,0,0
TIKI,lam-dep-suc-khoe,132081621,"Mặt Nạ Ngủ Phục Hồi Laneige Cica Sleeping Mask EX",650000,750000,100000,13
TIKI,lam-dep-suc-khoe,179980123,"Sữa Tắm Lifebuoy Detox Sạch Sâu Bảo Vệ Khỏi Vi Khuẩn Gây Mùi Cơ Thể Than Hoạt Tính & Cám gạo Chiết Xuất Thiên Nhiên Chai 800G",156000,195000,39000,20
TIKI,lam-dep-suc-khoe,179792021,"Dầu chăm sóc da giúp cải thiện rạn da, mờ sẹo và đều màu da - BIO-OIL SKINCARE OIL (chai 25ml)",98000,110000,12000,11
TIKI,lam-dep-suc-khoe,59148842,"Gói Hỗn Hợp Muối Rửa Mũi Xoang Người Lớn- NeilMed SinusRinse Adult 50 Sachets  - Xuất xứ Mỹ.( Hộp 50 gói)",296000,296000,0,0
TIKI,lam-dep-suc-khoe,32518505,"Gel Bí Đao Rửa Mặt Cocoon (140ml)",165750,195000,29250,15
TIKI,lam-dep-suc-khoe,94087656,"Sâm Nhung Bổ Thận TW2 - Không Lo Thận Yếu, Đau Lưng, Tiểu Đêm - Giúp Bổ Thận Tráng Dương - Tăng Cường Sinh Lực - Bổ Thận TW3 Lọ 30 Viên ",103000,110000,7000,6
TIKI,lam-dep-suc-khoe,13769238,"Combo 2 Hộp Tảo Xoắn Spirulina Nội Địa Nhật Bản 2200 Viên",715000,715000,0,0
TIKI,lam-dep-suc-khoe,84783740,"BÌNH RỬA MŨI WATER PULSE TẶNG KÈM 30 GÓI MUỐI SEAKIT",155000,155000,0,0
TIKI,lam-dep-suc-khoe,195822471,"Tăng cân AVITA Medivistar Pharma (Liệu Trình 3 Hộp) cho người gầy yếu, không tích nước, hộp 60 viên",188000,198000,10000,5
TIKI,lam-dep-suc-khoe,188783854,"Dụng cụ cắt tỉa lông mũi Máy cắt tỉa lông mũi bằng thép không gỉ lưỡi sắc bén kèm hộp cao cấp",33999,33999,0,0
TIKI,lam-dep-suc-khoe,248788942,"Vitamin tổng hợp cho người dưới 50 tuổi Kirkland Multivitamin tăng cường sức đề kháng, tăng sức khỏe tổng thể, giảm mệt mỏi - Massel Official",650000,1310000,660000,50
TIKI,lam-dep-suc-khoe,270794747,"Collagen +C nước lựu Mỹ Neocell tạo sức khỏe và vẻ đẹp từ bên trong cho da, tóc, móng, xương khớp, tim mạch và tăng hệ miễn dịch - QuaTangMe Extaste",737000,1748000,1011000,58
TIKI,lam-dep-suc-khoe,102520945,"Omega 3-6-9 Healthy Care Ultimate 1000mg Hỗ Trợ Sức Khỏe Tim  Mạch Tăng Cường Trí Nhớ, Giảm Nhức Xương Khớp, Tăng Đề Kháng, Tăng Khả Năng Tập Trung, Hỗ Trợ Phụ Nữ Tiền Mãn Kinh",356000,445000,89000,20
TIKI,lam-dep-suc-khoe,24989322,"Mỡ Trăn N'store Triệt Lông, Trị Bỏng, Làm Mờ Rạn Da, Trị Mụn - Se Khít Lỗ Chân Lông, Lành Sẹo, Nhả Nắng, Nhanh Lành Các vết Dị Ứng(hũ 75gr)",63000,90000,27000,30
TIKI,lam-dep-suc-khoe,115196180,"️MỚI️ (Chính hãng Làn Da Đẹp) MEGADUO Gel PLUS - Gel giảm mụn và thâm",135000,135000,0,0
TIKI,lam-dep-suc-khoe,84603716,"Viên uống hỗ trợ tăng chiều cao từ Tảo Biển NK Vương Quốc Anh, bổ sung Canxi và Vitamin D3 giảm nguy cơ loãng xương Canxi Laf (60 viên/hộp)",300000,300000,0,0
TIKI,lam-dep-suc-khoe,114465611,"Máy Massage Tay Cao Cấp KingTech -  Mát xa Trị Liệu Không Dây Tích Hợp Nhiệt, Lực Nén Túi Khí 6 Cấp Độ - Giúp Thư Giãn, Giảm Mỏi Khớp Ngón, Lòng Bàn Tay, - Quà Tặng Cho Người Thân",1450000,2200000,750000,34
TIKI,lam-dep-suc-khoe,173551202,"Hoat Huyết Dưỡng Não - Đại Uy (Hộp 5 vỉ x 20 Viên)",26000,26000,0,0
TIKI,lam-dep-suc-khoe,77323883,"Kẻ mắt Never Die Brush Eyeliner 0.4g ( 2 màu)",150000,290000,140000,48
TIKI,lam-dep-suc-khoe,129727672,"Collagen nước lựa đỏ Neocell Collagen +C Mỹ Tạo sức khỏe cùng đẹp  từ  bên  trong  cho  da,  tóc,  móng,  xương  khớp - Massel Official – 473ml/chai",787000,1748000,961000,55
TIKI,lam-dep-suc-khoe,142782013,"Mặt Nạ Dưỡng Ẩm Da Chân Hương Bơ Cao Cấp - Hãng Bioaqua - Dưỡng Ẩm, Phục Hồi Da Chân",12000,15000,3000,20
TIKI,lam-dep-suc-khoe,45900941,"Sữa rửa mặt không có xà phòng và hỗ trợ giảm thiểu tế bào chết SEBIACLEAR Gel Moussant SVR 400ml",388000,555000,167000,30
TIKI,lam-dep-suc-khoe,106503532,"Đai lưng cột sống trị thoát vị đĩa đệm dạng lưới cao cấp- Đại định hình cột sống chống cong vẹo lưng",250000,250000,0,0
TIKI,lam-dep-suc-khoe,73603441,"Gói Hỗ Trợ Giảm Đau Dạ Dày Tức Thì, Cải Thiện Tình Trạng Đầy Hơi Ợ Chua, Đau Rát Bao Tử Novagel Hộp 20 gói - Nguyên Liệu Nhập Khẩu Châu Âu",109500,150000,40500,27
TIKI,lam-dep-suc-khoe,76369278,"Hộp Đá Muối Himalaya Massage Chân (Mặt Đá Cong 2 Viên)",444000,659000,215000,33
TIKI,lam-dep-suc-khoe,159017142,"Băng cá nhân Pharmacity Plaster 72x18mm (Hộp 10 miếng)",8000,10000,2000,20
TIKI,lam-dep-suc-khoe,177347452,"Viên uống Vitamin C DHC - Bổ sung Vitamin C sáng mịn da từ bên trong cho nam nữ dậy thì",85000,170000,85000,50
TIKI,lam-dep-suc-khoe,270864189,"DHC rau củ nhật bổ sung chất sơ, vitamin, dưỡng chất từ 32 loại rau + củ + hạt hỗ trợ tăng cường sức khỏe chung - QuaTangMe Extaste",299000,598000,299000,50
TIKI,lam-dep-suc-khoe,73860924,"GINKGO BILOBA - Viên uống hỗ trợ chức năng não bộ, Giúp tăng cường lưu thông máu não, Giúp an thần, hỗ trợ điều trị rối loạn giấc ngủ (Hộp 100 viên)",150000,150000,0,0
TIKI,lam-dep-suc-khoe,36158812,"Kem dưỡng trắng da toàn thân Truesky Whitening Body Lotion chiết xuất lựu 100g",170000,170000,0,0
TIKI,lam-dep-suc-khoe,32236260,"Kem dưỡng ban đêm Sắc Ngọc Khang dưỡng sáng và mờ thâm nám 10g",99000,149000,50000,34
TIKI,lam-dep-suc-khoe,145626897,"Cốc tạo bọt sữa rửa mặt, sữa tắm nhỏ gọn thời trang tiện lợi",35000,35000,0,0
TIKI,lam-dep-suc-khoe,92559229,"Lăn khử mùi chiết xuất thiên nhiên Refre Natural Woody – Hương Gỗ 40ml",61300,65000,3700,6
TIKI,lam-dep-suc-khoe,396697,"Mascara Dài Mi và Cong Mi Maybelline New York Hyper Curl Waterproof Chuốt Mi Đen Không Lem Không Trôi 9.2ml",105000,105000,0,0
TIKI,lam-dep-suc-khoe,175193742,"Súng massage Booster M2 cảm ứng thông minh 6 đầu cắm",2000000,2000000,0,0
TIKI,lam-dep-suc-khoe,77779979,"Cốc nguyệt san BeUcup siêu mềm - xóa tan nỗi lo ngày "đèn đỏ"",399000,699000,300000,43
TIKI,lam-dep-suc-khoe,73247612,"Máy Khuếch Tán Tinh Dầu Và Tinh Dầu Sả Chanh TIDAMO Cao Cấp - Máy Xông Tinh Dầu Chuyên Dụng Cho Phòng Lớn, Có Remote Điều Khiển Từ Xa và Đèn LED Biến Đổi Màu Cực Đẹp",253300,548000,294700,54
TIKI,lam-dep-suc-khoe,171548995,"Kem Đánh Răng Colgate Optic White O2 làm trắng răng đột phá với Oxy Hoạt Tính 85g/ tuýp",164000,164000,0,0
TIKI,lam-dep-suc-khoe,112102855,"Bàn chải đánh răng điện FAIRYWILL E11 chính hãng Mỹ Công nghệ làm sạch bằng sóng siêu âm 8 đầu thay thế Hàng Chính Hãng",663000,780000,117000,15
TIKI,lam-dep-suc-khoe,10966796,"Dung dịch vệ sinh Saforelle Gentle Cleansing Care (100ml)",118000,132000,14000,11
TIKI,lam-dep-suc-khoe,50491088,"Sữa rửa tay dưỡng ẩm an toàn cho da thương hiệu Mr Fresh Hàn Quốc - Can 5 lít Hương Táo",169000,169000,0,0
TIKI,lam-dep-suc-khoe,194103280,"Ghế massage toàn thân Cao Cấp con lăn 4D di chuyển Toshiko T9, dòng ghế điều khiển bằng giọng nói, bảng điều khiển tiếng Việt, đa dạng các bài massage từng vùng, con lăn 4D di chuyển theo chiều dài cơ thể",19990000,35000000,15010000,43
TIKI,lam-dep-suc-khoe,22022565,"Kẹp bấm mi màu đen ",35680,44600,8920,20
TIKI,lam-dep-suc-khoe,12205956,"Đèn xông tinh dầu đuổi muỗi, côn trùng",55000,55000,0,0
TIKI,lam-dep-suc-khoe,163877023,"[ New Arrival ] - Hộp 30 chiếc Khẩu Trang N99 ngăn đến 99% hạt bụi siêu mịn có kích thước từ 0,3 Mircromet #MONA MASK",379000,379000,0,0
TIKI,lam-dep-suc-khoe,77745077,"COMBO 3 Chai Sữa Tắm Dê ASOHA",90000,150000,60000,40
TIKI,lam-dep-suc-khoe,73953901,"Viên Uống Hương Hoa Hồng DHC Bulgarian Rose Capsule 20 Ngày",405000,475000,70000,15
TIKI,lam-dep-suc-khoe,188728812,"Bút kẻ mắt dạng lỏng không lem không trôi NOVO thiết kế vân kim cương",75000,125000,50000,40
TIKI,lam-dep-suc-khoe,146728847,"Nước Hoa Hồng chiết xuất tía tô Perrila Natural Skin Lotion Nhật Bản ( chai 500ml)",98000,145000,47000,32
TIKI,lam-dep-suc-khoe,1815277,"Máy tăm nước du lịch Procare KHD13",1600000,1600000,0,0
TIKI,lam-dep-suc-khoe,132837279,"Dermarium Rescuer - Kem dưỡng phục hồi 50ml",380000,380000,0,0
TIKI,lam-dep-suc-khoe,193736472,"Máy tăm nước cầm tay Enpis SS66 vệ sinh răng miệng chống nước cao cấp 3 chế độ bảo vệ nướu - Hàng Chính Hãng",209000,299000,90000,30
TIKI,lam-dep-suc-khoe,90143270,"Tinh Dầu Hoa Lài Nguyên Chất TIDAMO, Tự Chọn Dung Tích | Có Kiểm Nghiệm Chất Lượng | Sử Dụng Với Máy Xông Tinh Dầu Xông Thơm Phòng Giúp Bảo Vệ Sức Khỏe Và Thư Giãn Tinh Thần",57800,98000,40200,41
TIKI,lam-dep-suc-khoe,11212468,"Mật ong Viethoney Can 5kg",540000,540000,0,0
TIKI,lam-dep-suc-khoe,140934746,"1 thùng 300 cái khẩu trang kf94 chuẩn Hàn quốc",111000,111000,0,0
TIKI,lam-dep-suc-khoe,155061543,"Tinh chất dưỡng trắng và ngăn ngừa lão hoá da mặt Truesky Whitening Face Serum chiết xuất quả lựu 20ml",250000,250000,0,0
TIKI,lam-dep-suc-khoe,19896312,"Kem ủ tóc siêu mượt Collagen DIVA Cosmetics Double Treatment 500ml",169100,178000,8900,5
TIKI,lam-dep-suc-khoe,14926439,"Xịt Khử Mùi Etiaxil Déodorant Anti-Transpirant 48h Anti-Traces Blanches & Jaunes 100ml",249000,289000,40000,14
TIKI,lam-dep-suc-khoe,159786756,"Combo 03 hộp Nước uống đẹp da The Collagen Shiseido EXR (Hộp 10 chai x 50mL)",2067000,2067000,0,0
TIKI,lam-dep-suc-khoe,94118705,"Combo 6 Băng vệ sinh ban đêm Glamiss Cool thảo dược  33.8cm siêu mát siêu khô thoáng",85000,96000,11000,11
TIKI,lam-dep-suc-khoe,162979447,"Sữa rửa mặt dịu nhẹ cho mọi loại da Cetaphil Gentle Skin Cleanser",331010,419000,87990,21
TIKI,lam-dep-suc-khoe,24045188,"Máy Cắt Tỉa Lông Mũi TẶNG kèm dụng cụ lấy ráy tai",35999,35999,0,0
TIKI,lam-dep-suc-khoe,171787350,"Bộ 24 Móng Tay Giả Đáng Yêu Nhiều Màu Chống Nước Kèm Keo Dán Móng",25000,25000,0,0
TIKI,lam-dep-suc-khoe,6522947,"Mật Ong Hoa Nhãn hũ 480g",139000,139000,0,0
TIKI,lam-dep-suc-khoe,170066578,"Combo 3 Hộp Tăm bông Bông Bạch Tuyết (200 que/hộp tròn)",69000,69000,0,0
TIKI,lam-dep-suc-khoe,40871895,"Kem hỗ trợ giảm gân tay chống lão hoá da tay - Kem trẻ hoá hết nhăn da tay KPEM 100ml",165000,185000,20000,11
TIKI,lam-dep-suc-khoe,1321075,"Hoạt huyết Minh Não Khang (Hộp 3 vỉ x 10 viên)",74900,75000,100,0
TIKI,lam-dep-suc-khoe,77118796,"Tinh chất (Serum) B3 Zakka Naturals Revival Ampoule Anti Blemish 10% Niacinamide + NAG 30ml",650000,650000,0,0
TIKI,lam-dep-suc-khoe,49548212,"Thực phẩm bảo vệ sức khỏe Nattokinase Jintan Nhật Bản, hỗ trợ điều trị đột quỵ, tai biến, hộp 60 gói",1368000,1847000,479000,26
TIKI,lam-dep-suc-khoe,50699277,"Kem Dưỡng Ẩm Giảm Bọng Mắt Bioderma Sensibio Eye - 15ml",328000,365000,37000,10
TIKI,lam-dep-suc-khoe,270988940,"Nước hoa hồng Dear Klairs Supple Preparation Facial Toner  - QuaTangMe Extaste",332000,684000,352000,51
TIKI,lam-dep-suc-khoe,72078387,"Viên Uống Cân Bằng Nội Tiết Tố Nữ Zlove - Se Khít Cô Bé Hiệu Quả, Hết Khô Hạn, Tăng Ham Muốn",780000,969000,189000,20
TIKI,lam-dep-suc-khoe,10131464,"Combo 3 Hộp Viên Uống Tăng Cân AVITA Dành Cho Người Gầy Giúp Nâng Cao Thể Trạng, Tăng Cường Sức Khỏe, Bồi Bổ Cơ Thể 60 Viên/Hộp",488000,594000,106000,18
TIKI,lam-dep-suc-khoe,19803125,"Máy Đo Huyết Áp OMRON JPN500 - Công Nghệ IntelliSense - Sản Xuất Tại Nhật Bản",2125000,2500000,375000,15
TIKI,lam-dep-suc-khoe,73210835,"Hà thủ ô đỏ lâu năm, Viên Hoàn mềm hỗ trợ giảm tóc bạc, giảm rụng tóc, kích thích mọc tóc, tăng cường sức khoẻ - Hộp 60 viên",1500000,1500000,0,0
TIKI,lam-dep-suc-khoe,12084506,"Tinh Chất Hỗ Trợ Trị Mụn, Mờ Vết Thâm, Tái Tạo Da, Ngăn Ngừa Mụn Eucerin (40ml)",367000,490000,123000,25
TIKI,lam-dep-suc-khoe,16893598,"Combo 10 Bộ 20 Miếng Dán Dưới Cánh Tay Thấm Hút Mồ Hôi Nhật Bản",52000,65000,13000,20
TIKI,lam-dep-suc-khoe,157198774,"Kem Che Khuyết Điểm Lâu Trôi the SAEM Cover Perfection Fixealer 6.5g",130000,130000,0,0
TIKI,lam-dep-suc-khoe,911333,"Sữa Rửa Mặt Dưỡng Ẩm, Làm Sạch Sâu Chiết Xuất Hoa Cúc - Oribe Facial Cleanser 50g",49000,75000,26000,35
TIKI,lam-dep-suc-khoe,67110418,"Thực phẩm bổ sung Tăng cường tuần hoàn não Trunature Ginkgo Biloba 340 Viên (Mẫu mới) - Nhập khẩu Mỹ",469000,469000,0,0
TIKI,lam-dep-suc-khoe,116189210,"Kìm cắt móng tay, móng chân, kìm cắt da chết bằng thép không gỉ siêu sắc  Tặng Kèm Thanh Nạy Móng ( giao mầu ngẫu nhiên)",79000,79000,0,0
TIKI,lam-dep-suc-khoe,34315218,"Dao Cạo Râu 6 Lưỡi Dorco Pace 6 Plus SXA 5001-PT (6 Lưỡi + Đầu Cắt Tóc Mai)",198000,198000,0,0
TIKI,lam-dep-suc-khoe,14694443,"Sáp vuốt tóc nam Tigi Bed Head Matte Separation Workable Wax",395000,395000,0,0
TIKI,lam-dep-suc-khoe,32724902,"Combo Viên uống DHC Trị mụn - Mờ thâm (Kẽm ZinC+VitaminC)",358000,410000,52000,13
TIKI,lam-dep-suc-khoe,174878178,"Bộ chăm sóc cá nhân bọt vệ sinh phụ nữ Betadine Foam Daily Use Moisturising Calendula & Gentle Protection Immortelle 100ml",195000,300000,105000,35
TIKI,lam-dep-suc-khoe,389659,"Bao Cao Su Sagami Xtreme Feel Long (Hộp 10 Cái)",54000,54000,0,0
TIKI,lam-dep-suc-khoe,123202562,"Bút Kẻ Mày Phẩy Sợi VACOSI - REALBROW TATTOO PEN",112000,112000,0,0
TIKI,lam-dep-suc-khoe,72040789,"Serum Nghệ Đỏ Nano ABERA - Đánh bật mọi loại thâm",259000,279000,20000,7
TIKI,lam-dep-suc-khoe,168953380,"Vớ Đầu Gối - Tất Y Khoa Suy Giãn Tĩnh Mạch Yasee Ngăn Ngừa và Hỗ Trợ Điều Trị (1 chiếc)",187000,187000,0,0
TIKI,lam-dep-suc-khoe,155832705,"[Hộp 5 cái] Bao cao su OLO 0.01 Trắng có Bi - Siêu mỏng, bi tăng kích thước 1.5cm",73600,80000,6400,8
TIKI,lam-dep-suc-khoe,178725018,"Đai Lưng Olumba Orbe Cao Cấp Hỗ Trợ Cột Sống, Thoát Vị Đĩa Đệm",342000,342000,0,0
TIKI,lam-dep-suc-khoe,162196432,"Sữa Dưỡng Dành Cho Da Dầu Và Da Hỗn Hợp Laneige Water Bank Blue HA Emulsion Oily 120ml",730000,820000,90000,11
TIKI,lam-dep-suc-khoe,81419552,"Combo 2 Hộp Nước Uống Làm Đẹp Collagen ADIVA Tem Trắng (14Chai/ Hộp)- Giúp Làn Da Săn Chắc, Ảm Mịn Và Căng Bóng",1459000,1622000,163000,10
TIKI,lam-dep-suc-khoe,270990158,"Đai chống gù United Medicare (C15)",590000,700000,110000,16
TIKI,lam-dep-suc-khoe,73547434,"Thực phẩm bảo vệ sức khỏe INNERB AQUA RICH DOUBLEUP (giúp giữ ẩm da sáng mịn từ Axit Hyaluronic) lọ 56 viên",945000,945000,0,0
TIKI,lam-dep-suc-khoe,52347336,"Mặt nạ bí đao Cocoon 30ml",123250,145000,21750,15
TIKI,lam-dep-suc-khoe,70738568,"Gel rửa mặt và tắm Effaclar Micro -Peeling Purifying La Roche Posay 400ml",531000,640000,109000,17
TIKI,lam-dep-suc-khoe,43184504,"KEM ĐÁNH RĂNG WHITE & WHITE LION NHẬT BẢN",60000,95000,35000,37
TIKI,lam-dep-suc-khoe,20717124,"Set 10 bàn chải đánh răng than tre hoạt tính siêu mềm",25000,39000,14000,36
TIKI,lam-dep-suc-khoe,174848651,"Ghế massage toàn thân Kagawa K16 đa chức năng, công nghệ quét AI thông minh, tự động dò tìm huyệt đạo",17990000,27000000,9010000,33
TIKI,lam-dep-suc-khoe,135649448,"Glucosamine Úc Healthy Care HCL 1500mg Hỗ trợ giảm đau nhức xương khớp, tăng trưởng và hồi phục sụn, sản xuất chất nhầy cho khớp - Massel Official - 400Viên/Hộp",655000,1416000,761000,54
TIKI,lam-dep-suc-khoe,67195661,"Viên uống dầu gan cá mập 360 viên",470000,900000,430000,48
TIKI,lam-dep-suc-khoe,8211858,"Sủi Da S-506 - Kềm Nghĩa",61750,65000,3250,5
TIKI,lam-dep-suc-khoe,6293541,"Thực Phẩm Bảo Vệ Sức Khỏe Diệp lục Collagen (Green Collagen Powder)",249000,249000,0,0
TIKI,o-to-xe-may-xe-dap,49451282,"Máy lọc không khí ô tô Airshot Road | Sản phẩm chính hãng Hàn Quốc | Sử dụng công nghệ đèn LED UV khử trùng mạnh mẽ",1399000,1700000,301000,18
TIKI,o-to-xe-may-xe-dap,142235049,"Thảm lót cốp xe ô tô Vinfast Lux SA 2019-đến nay nhãn hiệu Macsim chất liệu TPV cao cấp mầu be",1900000,1900000,0,0
TIKI,o-to-xe-may-xe-dap,181997844,"Hộp đựng đồ xếp gọn 2 ngăn 50L.50cm x 34cm x 31cm-nhãn hiệu Macsim màu xanh lá,xanh dương,vàng",1400000,1400000,0,0
TIKI,o-to-xe-may-xe-dap,95020761,"Thảm lót cốp xe ô tô BMW New X3 nhãn hiệu Macsim 3W chất liệu TPE cao cấp màu đen",2800000,2800000,0,0
TIKI,o-to-xe-may-xe-dap,105328503,"Mũ Bảo Hiểm 1/2 Chita CT31 - Nhiều màu",260000,260000,0,0
TIKI,o-to-xe-may-xe-dap,271517434,"Thảm lót sàn xe ô tô Hyundai Santafe 2019- đến nay Nhãn hiệu Macsim chất liệu nhựa TPE cao cấp  - màu đen 3 hàng ghế",1990000,1990000,0,0
TIKI,o-to-xe-may-xe-dap,102387065,"Đèn xe đạp thể thao KIOTOOL siêu sáng có còi pin sạc usb led T6 chống nước - Đèn còi xe đạp có 3 chế độ sáng còi to",84000,84000,0,0
TIKI,o-to-xe-may-xe-dap,181996931,"Hộp đựng đồ xếp gọn có bánh, tay kéo 51cm x 55cm x 40cm - nhãn hiệu Macsim màu đen,màu đỏ",2000000,2000000,0,0
TIKI,o-to-xe-may-xe-dap,72637459,"Bơm xe máy - Bơm xe đạp chân - Bơm đạp chân 2 ống đa năng - Bơm hơi đạp chân mini Xe Đạp, Xe Máy, Xe Ô tô, Xe Hơi Đa Năng Dễ Dàng Xếp Gọn thân hợp kim siêu bền, hỗ trợ cả van Mỹ và van Pháp Thương hiệu KIOTOOL",225000,225000,0,0
TIKI,o-to-xe-may-xe-dap,50819880,"Bơm xe đạp, xe máy xách tay siêu nhẹ, áp suất 120 PSI, thân hợp kim siêu bền, hỗ trợ cả van Mỹ và van Pháp, bơm được cho tất cả các loại xe đạp bao gồm xe đua, xe địa hình, xe đạp đường trường, thương hiệu Wheel Up - Hàng chính hãng ",99000,99000,0,0
TIKI,o-to-xe-may-xe-dap,253195827,"CERATO/ K3- Thảm lót sàn xe ô tô KIA CERATO/ K3 (2019-nay) chất liệu TPE thương hiệu Macsim màu đen hàng loại 2",1650000,1650000,0,0
TIKI,o-to-xe-may-xe-dap,247853609,"Thảm lót cốp xe ô tô Nissan X trail 2014-2017 nhãn hiệu Macsim chất liệu TPV màu đen hàng loại 2",990000,990000,0,0
TIKI,o-to-xe-may-xe-dap,96616121,"Tinh Dầu Treo Xe Hơi, Treo Phòng Gia Đình| Tự Chọn Mùi, Nguyên Chất,Có Kiểm Định Chất Lượng| Tinh Dầu TIDAMO Khử Mùi Xe Hơi, Thơm Phòng, Thư Giản Tinh Thần",24000,96000,72000,75
TIKI,o-to-xe-may-xe-dap,247844145,"Thảm lót cốp xe ô tô Lexus NX 2022+ (sd) nhãn hiệu Macsim chất liệu TPE hàng loại 2 màu đen",990000,990000,0,0
TIKI,o-to-xe-may-xe-dap,242410735,"Thảm lót sàn xe ô tô VinFast Fadil Nhãn hiệu Macsim chất liệu nhựa TPE cao cấp màu đen",1871000,1871000,0,0
TIKI,o-to-xe-may-xe-dap,52601387,"Bộ 3 khăn lau xe ô tô cao cấp siêu thấm, siêu hút",19999,19999,0,0
TIKI,o-to-xe-may-xe-dap,219138799,"Ô che nắng ô tô gấp gọn, tấm che nắng kính lái ô tô xe hơi chống nóng kính trước chống tia cực tím UPF 50+ TÂM LUÂN Chổi lau tẩm dầu - Hàng chính hãng",209000,300000,91000,30
TIKI,o-to-xe-may-xe-dap,28035643,"Bạt Phủ Ô Tô Tráng Nhôm Phủ Nano Chống Nắng, Bạt Trùm Xe Hơi Cách Nhiệt Cao Cấp, Hàng Chính Hãng",354000,520000,166000,32
TIKI,o-to-xe-may-xe-dap,1254583,"Dung Dịch Chống Bám Nước Trên Kính Xe 3M Glass Coat Windshield 3M 08889 (200ml)",179000,179000,0,0
TIKI,o-to-xe-may-xe-dap,253195877,"Yaris-Thảm lót sàn xe ô tô Toyota Yaris 2014-2020 Nhãn hiệu Macsim chất liệu nhựa TPE màu đen hàng loại 2",1650000,1650000,0,0
TIKI,o-to-xe-may-xe-dap,2250775,"Bộ Combo Vệ Sinh Dưỡng Sên Xe Máy Thunder (Giao màu ngẫu nhiên)",112000,112000,0,0
TIKI,o-to-xe-may-xe-dap,156224243,"Tấm Lưới Đệm Tựa Lưng, Đệm Ghế Ô Tô, Ghế Văn Phòng - Matxa Thư Giãn Cột Sống Chống Mỏi Lưng - Hangf Loại 1 Chính Hãng MINIIN",37000,59000,22000,37
TIKI,o-to-xe-may-xe-dap,189928661,"Bạt phủ ô tô Mazda MX-5 nhãn hiệu Macsim sử dụng trong nhà chất liệu vải thun - màu xanh phối trắng",8000000,8000000,0,0
TIKI,o-to-xe-may-xe-dap,77280988,"Tinh Dầu Vỏ Quế Nguyên Chất Treo Xe Ô Tô, Treo Tủ Quần Áo, Treo Phòng Gia Đình - Tinh Dầu Quế TIDAMO (Cinnamon) Cao Cấp Nhập Khẩu Giúp Khử Mùi, Kháng Khuẩn Và Thư Giãn Tinh Thần",58000,116000,58000,50
TIKI,o-to-xe-may-xe-dap,247853632,"Thảm lót cốp xe ô tô Kia Sonet 2022 - hàng loại 2",990000,990000,0,0
TIKI,o-to-xe-may-xe-dap,247853595,"Thảm lót cốp xe ô tô TOYOTA LAND CRUISER 2022 màu đen - hàng loại 2",990000,990000,0,0
TIKI,o-to-xe-may-xe-dap,130211300,"Đèn Pha Led Xe Đạp Thể Thao San01 Siêu Sáng Gắn Ghi Đông Siêu Sáng Có Sạc Điện",75050,79000,3950,5
TIKI,o-to-xe-may-xe-dap,48122001,"Túi treo đầu xe máy mẫu đứng vải bố, túi ghi đông treo đầu xe máy cho Grap,Goviet, bê",77000,77000,0,0
TIKI,o-to-xe-may-xe-dap,107234723,"Mũ bảo hiểm xe đạp trẻ em Protec SMILE W024, nón bảo hiểm siêu nhẹ tiêu chuẩn Châu Âu, có đèn hậu an toàn, họa tiết đẹp, ấn tượng cho cả bé trai và bé gái",338000,438000,100000,23
TIKI,o-to-xe-may-xe-dap,892527,"Dung Dịch Tẩy Keo, Nhựa Đường 3M 08987 (425 g)",160000,169000,9000,5
TIKI,o-to-xe-may-xe-dap,44613386,"Khóa Xe Đạp Xe Máy 4 Số Chống Trộm Bọc Cáp (Đen)",47998,47998,0,0
TIKI,o-to-xe-may-xe-dap,107458574,"Khăn Lau Xe Hơi Ô Tô Cao Cấp Gia Dụng Đa Năng Siêu Thấm Microfiber, Không rụng lông",1000,7999,6999,87
TIKI,o-to-xe-may-xe-dap,187642488,"Mũ bảo hiểm nửa đầu có họa tiết SRT ASA 05 kèm kính phi công, kính UV thời trang, cá tính- Hàng chính hãng",145000,260000,115000,44
TIKI,o-to-xe-may-xe-dap,171125391,"Combo 2 Móc Dán Treo Đồ Xe Hơi, Ô Tô - Dính Siêu Chắc - Nhựa ABS Siêu Bền - Treo Cáp Sạc, Chìa Khóa, Túi Xách",24700,26000,1300,5
TIKI,o-to-xe-may-xe-dap,142671571,"Túi Treo Xe Đạp Thể Thao Cảm Ứng Điện Thoại 6,4 inch (Vừa Iphone Pro) - Túi Đựng Đồ Xe Đạp Địa Hình Vải Bố The K Chính Hãng",99000,122000,23000,19
TIKI,o-to-xe-may-xe-dap,110646106,"Bơm xe đạp xe máy Kiotool chuyên dụng ống to nhanh đầy hơi bơm nhẹ  có đầy đủ phụ kiện bơm bóng đá thú nhún bơm phao bơi",125000,125000,0,0
TIKI,o-to-xe-may-xe-dap,142268971,"Máy Bơm Bánh Xe , Bơm Xe Đạp , Bơm Xe Máy Nhỏ Gọn Mini XT01 - Xách Tay Siêu Nhẹ, Áp Suất 120 PSI Hỗ Trợ Cả Van Mỹ và Van Pháp - Hàng Chính Hãng",64600,68000,3400,5
TIKI,o-to-xe-may-xe-dap,77281216,"Tinh Dầu Trầm Hương Cao Cấp Treo Xe Ô Tô, Treo Tủ Quần Áo, Treo Phòng Gia Đình - Tinh Dầu Trầm Hương TIDAMO (Agarwood) Giúp Khử Mùi, Kháng Khuẩn Và Thư Giãn Tinh Thần",44000,116000,72000,62
TIKI,o-to-xe-may-xe-dap,111589434,"Mũ Bảo Hiểm Trẻ Em 1/2 Đầu Có Kính  Protec Kitty, họa tiết nữ hoàng băng giá Frozen thời trang, an toàn, chất lượng",369000,449000,80000,18
TIKI,o-to-xe-may-xe-dap,247844137,"Thảm lót cốp xe ô tô Kia K5 nhãn hiệu Macsim hàng loại 2",990000,990000,0,0
TIKI,o-to-xe-may-xe-dap,225171842,"Máy Bơm Ô tô, Xe hơi Đa Năng Michelin 12266 - Hàng Chính Hãng",981000,981000,0,0
TIKI,o-to-xe-may-xe-dap,892525,"Chai Xịt Chăm Sóc Và Bảo Vệ Nội Thất Ô Tô 3M 39040 (473ml)",285000,290000,5000,2
TIKI,o-to-xe-may-xe-dap,73091423,"Gối Tựa Lưng Bằng Cao Su Non Vải Lưới Thoáng Mát Có Đai Cài (KT 34x32x12cm)",175000,220000,45000,20
TIKI,o-to-xe-may-xe-dap,130315614,"Bọc yên xe đạp thể thao loại GEL cao cấp, êm ái thoáng khí Tặng kèm Áo mưa chống thấm nước cho yên",88350,93000,4650,5
TIKI,o-to-xe-may-xe-dap,270483515,"Bộ 2 Gương cầu lồi ô tô Hàng Xuất Khẩu Mỹ, tráng bạc dày công nghệ gương Bỉ TÂM LUÂN Chổi lau tẩm dầu - Hàng chính hãng",69000,100000,31000,31
TIKI,o-to-xe-may-xe-dap,3665433,"Dung dịch chống bám nước kính xe 3M Glass Coat Windshield 3M 08889 LT 200ml",170000,180000,10000,6
TIKI,o-to-xe-may-xe-dap,163715837,"Khóa Xe Đạp Khóa Mật Khẩu Xe Đạp Chống Trộm Khóa Dây Mũ Bảo Hiểm Ba Lô Dây Xích Khóa Xe Đạp, Phụ Kiện Xe Đạp",125000,135000,10000,7
TIKI,o-to-xe-may-xe-dap,42758063,"Bộ 4 Tấm Chắn Nắng Ô Tô Xe Hơi Phản Quang, Tấm Che Nắng Ô Tô Cách Nhiệt Chống Thấm, Kích Thước Tiêu Chuẩn Phù Hợp Với Tất Cả Các Loại Kính Xe",32000,43000,11000,26
TIKI,o-to-xe-may-xe-dap,147969040,"[VIDEO]- Tấm lưới đệm ghế cho văn phòng, học sinh 40x40cm- Đệm tựa lưng ghế cho xe ôtô, tàu",89700,89700,0,0
TIKI,o-to-xe-may-xe-dap,3642617,"Khăn lau xe đa năng 3M 50400VL",79000,85000,6000,7
TIKI,o-to-xe-may-xe-dap,84132267,"Thùng rác mini có nắp, hộp đựng rác có chốt cài treo thành cửa treo lưng ghế ô tô, xe hơi- Hàng chính hãng",87000,87000,0,0
TIKI,o-to-xe-may-xe-dap,140859956,"Đệm Yên Xe Đạp Êm - Đệm Bọc Yên Xe Đạp Thể Thao Giant, Trek, Jett - Đệm Gel 3D Không Xẹp Lún -  Phụ Kiện Xe Đạp Hàng Chính Hãng",37050,39000,1950,5
TIKI,o-to-xe-may-xe-dap,167209871,"Tấm che nắng kính lái xe hơi, bạt chắn nắng cách nhiệt cho ô tô - Hàng Chính Hãng",104500,110000,5500,5
TIKI,o-to-xe-may-xe-dap,72557905,"Bơm Đạp Chân  Xe Đạp, Xe Máy, Xe Ô tô, Xe Hơi Đa Năng Dễ Dàng Xếp Gọn Và Sử Dụng Kèm 3 Chốt Chân Lỗ bơm bóng và thú nhún  thương hiệu bơm xe KIOTOOL",195000,195000,0,0
TIKI,o-to-xe-may-xe-dap,194033373,"Mũ bảo hiểm nửa đầu NON CAMRY CR04 thời trang, nhiều màu sắc trẻ trung, lưỡi trai mềm cá tính- Hàng chính hãng",155000,205000,50000,24
TIKI,o-to-xe-may-xe-dap,49451282,"Máy lọc không khí ô tô Airshot Road | Sản phẩm chính hãng Hàn Quốc | Sử dụng công nghệ đèn LED UV khử trùng mạnh mẽ",1399000,1700000,301000,18
TIKI,o-to-xe-may-xe-dap,184476149,"Chai xịt diệt khuẩn khử mùi ô tô xe khách bằng nano bạc Nano Reiwa 430ml hương bạc hà dịu nhẹ, được chứng nhận viện Pasteur an toàn cho trẻ em - Hàng chính hãng",80000,105600,25600,24
TIKI,o-to-xe-may-xe-dap,95020761,"Thảm lót cốp xe ô tô BMW New X3 nhãn hiệu Macsim 3W chất liệu TPE cao cấp màu đen",2800000,2800000,0,0
TIKI,o-to-xe-may-xe-dap,94715515,"Máy Xông Tinh Dầu Xe Hơi | Có Pin Tích Điện, Vỏ Kim Loại Nguyên Khối, Nút Cảm Ứng, Phun Tinh Dầu Trực Tiếp | Kèm Tinh Dầu (Tùy Chọn)",498000,1296000,798000,62
TIKI,o-to-xe-may-xe-dap,142235049,"Thảm lót cốp xe ô tô Vinfast Lux SA 2019-đến nay nhãn hiệu Macsim chất liệu TPV cao cấp mầu be",1900000,1900000,0,0
TIKI,o-to-xe-may-xe-dap,109580095,"Nước rửa kính lái chuyên dụng ô tô [5 Lít]",199000,235000,36000,15
TIKI,o-to-xe-may-xe-dap,7101469,"Mũ bảo hiểm 1/2 CHITA CT30",300000,300000,0,0
TIKI,o-to-xe-may-xe-dap,76474280,"Tinh Dầu CAM NGỌT Treo Xe Ô Tô, Treo Tủ Quần Áo, Treo Phòng Gia Đình - Tinh Dầu Cam Nguyên Chất TIDAMO Giúp Khử Mùi, Kháng Khuẩn Và Thư Giãn Tinh Thần",28000,96000,68000,71
TIKI,o-to-xe-may-xe-dap,10002284,"Nước rửa xe bọt tuyết chuyên dụng Car Shampoo 5L cho ô tô xe máy ",129000,129000,0,0
TIKI,o-to-xe-may-xe-dap,242410735,"Thảm lót sàn xe ô tô VinFast Fadil Nhãn hiệu Macsim chất liệu nhựa TPE cao cấp màu đen",1871000,1871000,0,0
TIKI,o-to-xe-may-xe-dap,134505835,"Can Phun Khói Nano Bạc Diệt Khuẩn Khử Mùi Ô TÔ, Nhà Cửa Nano Reiwa (Hàng chính hãng)",352000,759000,407000,54
TIKI,o-to-xe-may-xe-dap,128858051,"Giá Đỡ Bình Nước Dành Cho Xe Đạp Thể Thao - Nhôm Siêu Nhẹ - Dễ Dàng Điều Chỉnh Độ Rộng - Lắp Đặt Đơn Giản",36100,38000,1900,5
TIKI,o-to-xe-may-xe-dap,272050443,"Thảm lót sàn xe ô tô Vinfast VF9 (3 hàng ghế) (6 chỗ) Nhãn hiệu Macsim chất liệu nhựa TPE cao cấp màu đen",3300000,3300000,0,0
TIKI,o-to-xe-may-xe-dap,271517434,"Thảm lót sàn xe ô tô Hyundai Santafe 2019- đến nay Nhãn hiệu Macsim chất liệu nhựa TPE cao cấp  - màu đen 3 hàng ghế",1990000,1990000,0,0
TIKI,o-to-xe-may-xe-dap,76474213,"Tinh Dầu Sả Chanh Treo Xe Ô Tô, Treo Tủ Quần Áo, Treo Phòng Gia Đình - Tinh Dầu Sả Chanh Nguyên Chất TIDAMO Giúp Khử Mùi, Kháng Khuẩn Và Thư Giãn Tinh Thần",54000,108000,54000,50
TIKI,o-to-xe-may-xe-dap,247853527,"Thảm lót cốp Mercedes GLC 2016-2022 (qd) nhãn hiệu Macsim chất liệu tpv cao cấp màu đen hàng loại 2",990000,990000,0,0
TIKI,o-to-xe-may-xe-dap,253195827,"CERATO/ K3- Thảm lót sàn xe ô tô KIA CERATO/ K3 (2019-nay) chất liệu TPE thương hiệu Macsim màu đen hàng loại 2",1650000,1650000,0,0
TIKI,o-to-xe-may-xe-dap,154856554,"Đèn xe đạp - Đèn Pha xe đạp sử dụng pin AAA - Còi To - Chống Nước - Dễ dàng thay pin không cần chờ sạc - Pin Xanh Dương",58000,65000,7000,11
TIKI,o-to-xe-may-xe-dap,68758301,"Bơm hợp kim nhôm loại đạp chân dùng cho xe đạp, xe máy, ô tô, có đồng hồ báo áp suất nhỏ gọn vừa cốp xe thương hiệu Kiotool hàng chính hãng",135000,135000,0,0
TIKI,o-to-xe-may-xe-dap,181996931,"Hộp đựng đồ xếp gọn có bánh, tay kéo 51cm x 55cm x 40cm - nhãn hiệu Macsim màu đen,màu đỏ",2000000,2000000,0,0
TIKI,o-to-xe-may-xe-dap,81578941,"Chai xịt Blues Nano Polish Cream Korea, chuyên phục hồi làm bóng nhựa xe - Nhựa nhám, ghế da, balo da,...",129000,129000,0,0
TIKI,o-to-xe-may-xe-dap,184476149,"Chai xịt diệt khuẩn khử mùi ô tô xe khách bằng nano bạc Nano Reiwa 430ml hương bạc hà dịu nhẹ, được chứng nhận viện Pasteur an toàn cho trẻ em - Hàng chính hãng",80000,105600,25600,24
TIKI,o-to-xe-may-xe-dap,251253645,"Thảm lót sàn xe ô tô VinFast Fadil Nhãn hiệu Macsim chất liệu nhựa TPE cao cấp màu đen",1871000,1871000,0,0
TIKI,o-to-xe-may-xe-dap,144751545,"Thảm đỡ điện thoại gắn taplo ô tô chống trượt đa năng loại tốt hàng cao cấp",58000,58000,0,0
TIKI,o-to-xe-may-xe-dap,181997844,"Hộp đựng đồ xếp gọn 2 ngăn 50L.50cm x 34cm x 31cm-nhãn hiệu Macsim màu xanh lá,xanh dương,vàng",1400000,1400000,0,0
TIKI,o-to-xe-may-xe-dap,271616970,"Thảm lót sàn xe ô tô Isuzu MUX 2015- 2020 (sd) Nhãn hiệu Macsim chất liệu nhựa TPE cao cấp màu đen",1990000,1990000,0,0
TIKI,o-to-xe-may-xe-dap,21600343,"Gối Tựa Đầu Gắn Dây An Toàn Chống Mỏi Đau Cổ Trên Xe Hơi Ô tô - Màu Ngẫu NHiên",29000,29000,0,0
TIKI,o-to-xe-may-xe-dap,164320898,"Băng keo cường lực 2 mặt siêu dính VHB 3M 5952",16000,16000,0,0
TIKI,o-to-xe-may-xe-dap,19749769,"Bộ 4 miếng dán chống đọng nước kính hông và gương chiếu hậu ô tô",45900,45900,0,0
TIKI,o-to-xe-may-xe-dap,189928661,"Bạt phủ ô tô Mazda MX-5 nhãn hiệu Macsim sử dụng trong nhà chất liệu vải thun - màu xanh phối trắng",8000000,8000000,0,0
TIKI,o-to-xe-may-xe-dap,74448331,"Bạt Xe Máy KhoNCC Vải Dù",139000,188000,49000,26
TIKI,o-to-xe-may-xe-dap,6866413,"Keo dán đa năng siêu dính Scotch-Weld 20g 3M PR100",125000,130000,5000,4
TIKI,o-to-xe-may-xe-dap,106919267,"Giá đỡ, Kẹp Điện Thoại Gắn Trên Bảng Taplo Xe Ô Tô, Hàng Nhập Khẩu",90000,90000,0,0
TIKI,o-to-xe-may-xe-dap,272128944,"Kem đánh bóng sơn xe ô tô (Car Cream) Karshine 110g KA-CC110",37000,37000,0,0
TIKI,o-to-xe-may-xe-dap,51511284,"Nước Châm Kính Ô Tô OUFU AF-1205 2l",58000,69000,11000,16
TIKI,o-to-xe-may-xe-dap,94715515,"Máy Xông Tinh Dầu Xe Hơi | Có Pin Tích Điện, Vỏ Kim Loại Nguyên Khối, Nút Cảm Ứng, Phun Tinh Dầu Trực Tiếp | Kèm Tinh Dầu (Tùy Chọn)",388000,1196000,808000,68
TIKI,o-to-xe-may-xe-dap,48894428,"Bạt trùm xe máy vải dù loại siêu dày chất lượng cao, chống mưa chống nắng xe máy, có túi đựng bạt  trùm, hàng Việt Nam , đa dạng màu sắc,có lựa chọn màu (Phụ Kiện Ô Tô)",51000,51000,0,0
TIKI,o-to-xe-may-xe-dap,115651541,"Túi thơm cà phê TTAUTO 100% hạt nguyên chất khử mùi trên ô tô, tủ đồ, văn phòng",29000,50000,21000,42
TIKI,o-to-xe-may-xe-dap,32701624,"BỘ CHUYỂN ĐỔI NGUỒN ĐIỆN 220V SANG 12V ĐẦU TẨU THUỐC",81000,81000,0,0
TIKI,o-to-xe-may-xe-dap,186495714,"[Chính hãng] yên xe đạp thể thao êm ái thoáng khí dễ lắp đặt - Đệm Yên xe địa hình thể thao chuyên dụng Thương hiệu DoDoDios",108000,108000,0,0
TIKI,o-to-xe-may-xe-dap,122437266,"Đệm lót yên sau xe đạp Kiotool êm ái  bền đẹp không thấm nước",44000,44000,0,0
TIKI,o-to-xe-may-xe-dap,75337304,"Yên xe đạp thể thao , Carbon siêu êm , Chính hãng Shengxin , da PU cao cấp - Tặng kèm chuông",109000,109000,0,0
TIKI,o-to-xe-may-xe-dap,50392581,"Mũ Bảo Hiểm Royal M139 Kính Âm",550000,560000,10000,2
TIKI,o-to-xe-may-xe-dap,71537490,"Máy Khuếch Tán Tinh Dầu Xe Hơi Cao Cấp và Chuyên Dụng, Máy Xông Tinh Dầu Dùng Điện USB Trên Xe ô tô, Đèn LED Cực Đẹp, Không Dùng Lõi Bông",198000,456000,258000,57
TIKI,o-to-xe-may-xe-dap,22434683,"Áo trùm xe máy chống thấm cực tốt, màu ngẫu nhiên",49800,49800,0,0
TIKI,o-to-xe-may-xe-dap,69139354,"Phủ nano kính xe ô tô 3M 200Ml (Tặng kèm khăn + găng tay Nilong)",180000,180000,0,0
TIKI,o-to-xe-may-xe-dap,77917419,"Bơm xe máy KIO-02 Phiên bản Xanh - Bơm xe đạp chân - Bơm đạp chân 2 ống đa năng - Bơm hơi đạp chân mini Xe Đạp, Xe Máy, Xe Ô tô, Xe Hơi Đa Năng Dễ Dàng Xếp Gọn thân hợp kim siêu bền, hỗ trợ cả van Mỹ và van Pháp Thương hiệu KIOTOOL",225000,225000,0,0
TIKI,o-to-xe-may-xe-dap,72103308,"Đệm Yên Xe Đạp Thể Thao Đàn Hồi Mềm Dày Thoáng Khí Cao Cấp Giúp Êm Mông Thoải Mái (Bản Nâng Cấp) Chống Trượt, Siêu Êm Có Lỗ Rãnh Thoát (Thân Rộng) Mai Lee",107000,119000,12000,10
TIKI,o-to-xe-may-xe-dap,9953493,"Bộ Chuyển Đổi Nguồn 220V sang 12V Trên Ô Tô",71000,71000,0,0
TIKI,o-to-xe-may-xe-dap,102787832,"1 Cặp Gương Chiếu Hậu Xoay 360 Độ Gắn Tay Lái Cho Xe Đạp Tiện Dụng",62000,62000,0,0
TIKI,o-to-xe-may-xe-dap,21076785,"Bảng số điện thoại gắn taplo ô tô, xe hơi",9000,40500,31500,78
TIKI,o-to-xe-may-xe-dap,158716928,"Mũ bảo hiểm GRO 3/4 đầu ST06 (T818) hai mẫu kính, thiết kế phong cách trẻ trung, nhiều màu, thời trang cho nam và nữ- Hàng chính hãng",269000,480000,211000,44
TIKI,o-to-xe-may-xe-dap,99659311,"Gối tựa lưng văn phòng cao su non EMA chống đau mỏi thắt lưng cho dân văn phòng, lái xe - Giữ tư thế ngồi thẳng, giảm đau mỏi khi phải ngồi lâu - Đen lưới (không có gel lạnh)",150000,300000,150000,50
TIKI,o-to-xe-may-xe-dap,109123711,"Bạt Phủ Áo Trùm Xe Máy Vải Dù Che Mưa Nắng Thời Tiết Khắc Nghiệt Loại Lớn Cho Dòng Xe Tay Ga - Xe Số Thông Dụng",135000,160000,25000,16
TIKI,o-to-xe-may-xe-dap,3668317,"Dung dịch dưỡng da, nội thất 3M 39040LT",162000,165000,3000,2
TIKI,o-to-xe-may-xe-dap,79410919,"Yên xe đạp thể thao , Yên xe đạp siêu êm , Chính hãng Sengxin , da PU cao cấp - Tặng kèm chuông 04",189000,189000,0,0
TIKI,o-to-xe-may-xe-dap,49472693,"Nón bảo hiểm 3/4 kính âm Royal M139 Đen nhám cao cấp Lót tháo rời, che hết mặt",529000,700000,171000,24
TIKI,o-to-xe-may-xe-dap,32833612,"Mũ Bảo Hiểm GRS A737K",279000,279000,0,0
TIKI,o-to-xe-may-xe-dap,174217849,"Nano chống tụ nước kính ô tô senfineco 9945",200000,200000,0,0
TIKI,o-to-xe-may-xe-dap,165996775,"Mũ bảo hiểm nửa đầu SRT ASA-05, nón bảo hiểm 1/2 đầu cao cấp kèm kính UV, phi công freesize 55-61cm, nhiều màu, cá tính - Hàng Chính Hãng",159000,230000,71000,31
TIKI,o-to-xe-may-xe-dap,184987595,"[An Toàn] Lót Bọc Chân Chống Xe Máy KhoNCC Hàng Chính Hãng - Cao Su Chống Trầy Nền Nhà - Kèm 2 Dây Rút - Chất Liệu Dày Dặn Bền Đẹp - KK-BCCXM",6000,6000,0,0
TIKI,o-to-xe-may-xe-dap,184591748,"Túi xe đạp Kiotool treo gắn sườn xe chống nước cao cấp",115000,115000,0,0
TIKI,o-to-xe-may-xe-dap,65475914,"NƯỚC RỬA XE KHÔNG CHẠM KC06 [5 Lít]",329000,349000,20000,6
TIKI,o-to-xe-may-xe-dap,179808916,"Nệm/đệm Ngồi Xe Máy Em Bé cho Xe AB, PCX , Yên Nệm, Không Tựa,Có Gác Chân,An Toàn Cho Bé",90000,90000,0,0
TIKI,o-to-xe-may-xe-dap,58244258,"Bơm lốp ô tô xiaomi 70mai midrive TP03 , Bơm lốp đa năng  , Bơm lốp mini - Hàng nhập khẩu",589000,625000,36000,6
TIKI,o-to-xe-may-xe-dap,196009852,"Băng keo cường lực 3M 5952 dài 4.5m",65000,65000,0,0
TIKI,o-to-xe-may-xe-dap,1389309,"Máy Bơm Ô tô, Xe hơi Đa Năng Michelin 12266 - Hàng Chính Hãng",1049000,1049000,0,0
TIKI,o-to-xe-may-xe-dap,3770565,"Chai xịt bôi trơn bảo dưỡng sên/ xích xe máy Thunder Chain Lube 400ml",53000,53000,0,0
TIKI,o-to-xe-may-xe-dap,3217923,"Mũ bảo hiểm nửa đầu GRS A33k",275000,275000,0,0
TIKI,o-to-xe-may-xe-dap,20586643,"Chai Xịt Chống Chuột - Đuổi Chuột Cho Xe Ô tô - Xe máy Liqui Moly Marten Spray 1515 (200ml)",143000,159000,16000,10
TIKI,o-to-xe-may-xe-dap,144223197,"1 LỌ KEM CHUYÊN ĐÁNH BÓNG CÁC LOẠI KIM LOẠI TẨY BÓNG NHƯ MỚI LOẠI TỐT",59000,59000,0,0
TIKI,o-to-xe-may-xe-dap,140575066,"Đèn Xe Đạp Năng Lượng Mặt Trời | Đèn Hậu Xe Đạp Giant , Xe Đạp Thể Thao , Xe Đạp MTB | Đèn Solar Energy Hàng Chính Hãng",50350,53000,2650,5
TIKI,o-to-xe-may-xe-dap,31513611," Kem đánh bóng kim loại đa dụng inox, đồng, .... Autosol Metal Polish 75ml",80000,80000,0,0
TIKI,o-to-xe-may-xe-dap,69107170,"Tẩy ố kính ô tô 3M -  Khôi phục độ sạch-sáng-bóng cho bề mặt kính xế yêu.",125000,125000,0,0
TIKI,o-to-xe-may-xe-dap,134841871,"Đệm cao su giảm chấn cửa cốp capo ô tô xe hơi - Núm cao su giảm lực đóng chống sốc bảo vệ cửa cốp mui xe ô tô",3000,3000,0,0
TIKI,o-to-xe-may-xe-dap,193062656,"Phục hồi vết rạn nứt kính ô tô với keo gắn kính xe hơi chuyên dụng bóng đẹp như mới loại tốt",129000,129000,0,0
TIKI,o-to-xe-may-xe-dap,157332833,"Găng Tay Cắt Ngón Bigbull HW nhiều màu Gym Thời Trang | Găng Tay Đi Phượt, Bao Tay Chạy Xe Máy, Xe Đạp | Bao Tay Cắt Ngón Bảo Vệ Bàn Tay Đa Năng - Sử dụng điện thoại thông minh dễ dàng",58900,62000,3100,5
TIKI,o-to-xe-may-xe-dap,51511276,"Chai Xịt Tẩy Keo Dầu Mỡ OUFU AF-1109 450ml",56050,59000,2950,5
TIKI,o-to-xe-may-xe-dap,157414875,"Găng Tay Cắt Ngón Bigbull Dòng Sản Phẩm Sport nhiều màu Gym Thời Trang | Găng Tay Đi Phượt, Bao Tay Chạy Xe Máy, Xe Đạp | Bao Tay Cắt Ngón Bảo Vệ Bàn Tay Đa Năng - Sử dụng điện thoại thông minh dễ dàng",57000,62000,5000,8
TIKI,o-to-xe-may-xe-dap,42347550,"Bộ 4 miếng dán chống đọng nước kính hông và gương chiếu hậu ô tô, xe hơi cao cấp DC150",45000,45000,0,0
TIKI,o-to-xe-may-xe-dap,115599472,"Mũ Bảo Hiểm Nửa Đầu Protec Rosa RLW Đơn Màu - Size L",245000,318000,73000,23
TIKI,o-to-xe-may-xe-dap,174215183,"YÊN ĐI XE AIRBLADE CHO BÉ",105000,105000,0,0
TIKI,o-to-xe-may-xe-dap,177301568,"Viên sủi rửa kính ô tô xe hơi tiện dụng (1 viên 4 lít nước)",2000,2000,0,0
TIKI,o-to-xe-may-xe-dap,193567295,"Bơm xe máy xe đạp nhỏ gọn Kiotool đầu van đa năng",75000,75000,0,0
TIKI,o-to-xe-may-xe-dap,1219669,"Dung Dịch Chống Bám Nước Trên Kính Xe 3M (200ml)",189000,189000,0,0
TIKI,o-to-xe-may-xe-dap,129727713,"Đèn Pha Xe Đạp Có Còi/Kèn - Pin Mạnh 1200mAh - Sáng Tới 5 Giờ Liên Tục - 3 Chế Độ Sáng - Còi To - Chống Nước",69350,73000,3650,5
TIKI,o-to-xe-may-xe-dap,193579409,"Dầu nhớt tra xích xe đạp Kiotool 60 ml",25000,25000,0,0
TIKI,o-to-xe-may-xe-dap,142656978,"Đèn Hậu Xe Đạp | Đèn Xe Đạp Báo Xi Nhan Rẽ Trái Phải Gắn Đuôi Cho Xe Đạp Với LED SMD Cao Cấp Và Remote Điều Khiển Từ Xa Không Dây Sạc USB Chống Nước - Hàng Chính Hãng",183350,193000,9650,5
TIKI,o-to-xe-may-xe-dap,92982475,"Khăn Lau Oto Cao Cấp Dày Siêu Thấm Vàng, Khăn Chùi Vệ Sinh Xe ô tô, Xe Hơi Chuyên Dụng",6299,6299,0,0
TIKI,o-to-xe-may-xe-dap,270677877,"Khăn lau ô tô đa năng microfiber xám không để lại bụi vải, không để lại vệt nước, khổ to, không phai màu TÂM LUÂN Chổi lau tẩm dầu - Hàng chính hãng",39000,50000,11000,22
TIKI,o-to-xe-may-xe-dap,182580168,"Bộ 16 nút giảm chấn cửa ô tô , đệm cao su giảm lực đóng cửa oto , đệm núm giảm chấn chống ồn bảo vệ cánh cửa",19000,19000,0,0
TIKI,o-to-xe-may-xe-dap,107458507,"Bạt phủ xe ô tô cao cấp, cho xe ôtô 4 chỗ đến 7 chỗ, phản quang,chống nóng, chống nước, có khóa kéo cánh cửa",223000,254000,31000,12
TIKI,o-to-xe-may-xe-dap,2872041,"Đồng hồ đo áp suất lốp xe bằng cơ cho ô tô xe máy",36000,36000,0,0
TIKI,o-to-xe-may-xe-dap,109000240,"Ốp mặt đồng hồ carbon Honda dành cho xe Winner",90000,90000,0,0
TIKI,o-to-xe-may-xe-dap,22974266,"Bộ 4 chai keo dán đa năng siêu dính nhanh khô - loại no run gel (không chảy) dạng sệt 3M Scotch Super Glue AD113 2g",99000,110000,11000,10
TIKI,o-to-xe-may-xe-dap,82103333,"Băng Keo Dán 2 Mặt Trong Suốt Siêu Dính 12mm x 3m",12000,15000,3000,20
TIKI,o-to-xe-may-xe-dap,160907624,"[An Tâm] Khóa Đĩa Chống Trộm KhoNCC Hàng Chính Hãng Cho Xe Máy, Xe Đạp - Cốt Thép Không Gỉ Chống Trộm Cắt - KPD-KX-JinKu-3875 (Màu ngẫu nhiên)",79000,118000,39000,33
TIKI,o-to-xe-may-xe-dap,177479009,"Bơm Xe Đạp Xe Máy Đạp Chân Áp Suất Cao XTBB, Bơm Máy Bơm Hơi Di Động Chân Đế Chống Trượt - Bơm Siêu Nhẹ Dễ Di Chuyển",71250,75000,3750,5
TIKI,o-to-xe-may-xe-dap,48884880,"Chân Đế Gắn Đèn Pin Vào Xe Đạp Xoay 360 Độ Gắn Đầu Phía Trước Ghi Đông Xe Đạp Cao Cấp Mai Lee (Không Kèm Đèn Pin)",84550,89000,4450,5
TIKI,o-to-xe-may-xe-dap,44259453,"Khăn lau ô tô chuyên dụng Microfiber 3M 36x36cm - màu vàng",24000,25000,1000,4
TIKI,o-to-xe-may-xe-dap,145466956,"Nón bảo hiểm xe đạp thể thao siêu nhẹ thoáng khí CXD-D12 - giao màu ngẫu nhiên",264000,264000,0,0
TIKI,o-to-xe-may-xe-dap,164554380,"Giá để chân sau xe đạp Kiotool chịu tải gấp gọn bộ 2 chiếc",35000,35000,0,0
TIKI,o-to-xe-may-xe-dap,140533304,"Dụng Cụ Sửa Xe Đạp 16 trong 1 - Bộ Tua Vít Đa Năng Mini - Cờ Lê Đa Năng/ Tô Vít Đa Năng - Phụ Kiện Xe Đạp - Hàng Chính Hãng",37050,39000,1950,5
TIKI,o-to-xe-may-xe-dap,38357272,"Nước Rửa Xe Không Chạm Ekokemika Italy Bio 45 - (1l) - Hàng Chính Hãng",198000,229000,31000,14
TIKI,o-to-xe-may-xe-dap,164554217,"Kệ Yên Sau Gác Ba Ga  Kiotool Gắn Thêm Phía Sau Cho Xe Đạp Vào Cốt Yên cho xe đạp địa hình và leo núi",245000,245000,0,0
TIKI,o-to-xe-may-xe-dap,178114569,"Đèn Led hậu xe đạp - Sạc USB - Chống nước - Đèn hậu xe đạp giant, xe đạp thể thao, xe đạp MTB",71250,75000,3750,5
TIKI,o-to-xe-may-xe-dap,176733663,"Xe máy điện VinFast Klara S (2022)",35000000,35000000,0,0
TIKI,o-to-xe-may-xe-dap,48905197,"Máy sạc bình ắc quy cho ô tô xe máy Bosch C7 - Hàng chính hãng",2509000,4181000,1672000,40
TIKI,o-to-xe-may-xe-dap,28108147,"Băng keo cường lực dán đồ chơi xe hơi 3M 4229P 20mmx10m (Đỏ)",132000,135000,3000,2
TIKI,o-to-xe-may-xe-dap,3262161,"Mũ Bảo Hiểm GRS A966 kính giấu, tháo lót",369000,369000,0,0
TIKI,o-to-xe-may-xe-dap,36273203,"NƯỚc RỬa KÍnh Ô TÔ TẠo HiỆu Ứng Nano XuẤt XỨ ChÂu Âu, HƯƠng Hoa OẢi HƯƠng Xglass Lavanda (3.2l) - Hàng Chính Hãng",145000,145000,0,0
TIKI,o-to-xe-may-xe-dap,109889040,"Bộ vá xăm xe đạp tiện dụng",25000,25000,0,0
TIKI,o-to-xe-may-xe-dap,178082163,"Chai xịt phục hồi nhựa nhám, nhựa đen, dưỡng đen dàn nhám Sprayking Plastic Shine 400ml, dàn áo phai màu",50000,50000,0,0
TIKI,o-to-xe-may-xe-dap,48905443,"Máy sạc bình ắc quy cho ô tô xe máy Bosch C3 - Hàng chính hãng",1595000,2658000,1063000,40
TIKI,o-to-xe-may-xe-dap,137001339,"[Tặng Chuông Xe Đạp Bọ Rùa Ngộ Nghĩnh] Mũ Bảo Hiểm Xe Đạp Trẻ Em, Nón Bảo Hiểm Chơi Thể Thao, Trượt Patin Cao Cấp Protec Smile W024 - Hàng Chính Hãng",338000,438000,100000,23
TIKI,o-to-xe-may-xe-dap,76379559,"[Loại Lớn - Dày] Xe Tay Ga Lớn - SH150i <2m05 - Xanh Đen",159000,248000,89000,36
TIKI,o-to-xe-may-xe-dap,51511288,"Chai Xịt Vệ Sinh Ghế Da Nội Thất Ô Tô OUFU AF-1101 720ml",40850,43000,2150,5
TIKI,o-to-xe-may-xe-dap,63818025,"Chai xịt chống chuột, đuổi chuột chuyên dụng 3M 3M-RRC tặng kèm 1 lá thơm mùi ngẫu nhiên",229000,230000,1000,0
TIKI,o-to-xe-may-xe-dap,56318825,"Mũ bảo hiểm Chita 1/2 - CT6B1 Nón cặp Tem chìa khóa",260000,260000,0,0
TIKI,o-to-xe-may-xe-dap,135344289,"NƯỚC HOA XE HƠI, Ô TÔ NHẬP KHẨU CAO CẤP | NƯỚC HOA KHỬ MÙI LÀM THƠM XE HƠI",160000,160000,0,0
TIKI,o-to-xe-may-xe-dap,58618778,"Bình Xịt Vệ Sinh Ghế Da Ô Tô - Đồ Da Flamingo",38000,46800,8800,19
TIKI,o-to-xe-may-xe-dap,122392994,"Mũ Bảo Hiểm Nửa Đầu Cao Cấp SUNDA HALYA HRA - Ghi Nhám - Kèm Kính",350000,350000,0,0
TIKI,o-to-xe-may-xe-dap,128935254,"Mũ Bảo Hiểm Nửa Đầu Kính Ẩn ANDES 181 - Nhiều Màu - Cao Cấp",389000,389000,0,0
TIKI,o-to-xe-may-xe-dap,46825423,"Chổi Đa Năng Lau Bụi, Kiêm Rửa Xe Ô Tô Cao Cấp",49000,54480,5480,10
TIKI,o-to-xe-may-xe-dap,183562223,"Mũ Bảo Hiểm Xe Đạp Sợi Cacbon Siêu Nhẹ Chống Va Đập Điều Chỉnh Kích Thước Đại Nam Sport",199000,300000,101000,34
TIKI,o-to-xe-may-xe-dap,125889433,"Combo 2 chai nước rửa kính ô tô Cá Voi 2 Lít, đổ trực tiếp phù hợp với mọi loại xe hơi, dễ dàng thay tại nhà",100000,100000,0,0
TIKI,o-to-xe-may-xe-dap,105829392,"Máy sạc bình ắc quy 12V 24V 200AH sạc cho ắc quy ô tô ắc quy xe máy các loại bình khô và nước thông minh tự ngắt khi đầy chống ngược cực",255000,255000,0,0
TIKI,o-to-xe-may-xe-dap,192117424,"Xà bông rửa xe siêu bọt 3M Car Wash With Wax PN39000W- 1Lít",199000,205000,6000,3
TIKI,o-to-xe-may-xe-dap,178832716,"Bơm xe đạp cầm tay mini treo xe LC - Hợp kim nhôm - Xách tay siêu nhẹ - hỗ trợ van Mỹ và van Pháp",141550,149000,7450,5
TIKI,o-to-xe-may-xe-dap,152856446,"Bạt xe máy Bạt trùm xe máy SH tráng nhôm cách nhiệt chống mưa nắng vừa tất cả các loại xe",111900,111900,0,0
TIKI,o-to-xe-may-xe-dap,98029897,"Tẩu Sạc, Dây Sạc 3 Đầu PUGAN, Sạc Nhanh Điện Thoại Và Thiết Bị Điện Tử Trên Ô Tô - Bộ Sạc 3 Trong 1 Cao Cấp",139997,139997,0,0
TIKI,o-to-xe-may-xe-dap,129228638,"Bơm xe máy đạp chân Kiotool KP02 Bassic loại 2 xi lanh - Đồ bơm xe máy xe đạp ô tô nhỏ gọn áp lực lớn 8 bar có thể  đút cốp xe máy",224000,224000,0,0
TIKI,o-to-xe-may-xe-dap,21731409,"Chổi Rửa Xe Ô Tô Cao Cấp Siêu Mềm ( Màu Xanh)",53000,62000,9000,15
TIKI,o-to-xe-may-xe-dap,56197070,"Bảng Ghi Số Điện Thoại Ô Tô, Thẻ Đỗ Xe Hiển Thị Số Điện Thoại Gắn Taplo Xe Hơi,Ô Tô Tiện Lợi",9000,9000,0,0
TIKI,o-to-xe-may-xe-dap,147080186,"Miếng mút rửa xe bọt biển tạo bọt, siêu mịn  3M",60000,65000,5000,8
TIKI,o-to-xe-may-xe-dap,116768956,"Chai xịt tẩy nội thất ghế da, nỉ ô tô - văn phòng FOAM CLEANER",55100,58000,2900,5
TIKI,o-to-xe-may-xe-dap,73521963,"Bộ Gối Tựa Đầu, Lưng Ô Tô 100% Cao Su Non Đặc Biệt Bọc Da Cao Cấp XG-NNSM01",277000,324000,47000,15
TIKI,o-to-xe-may-xe-dap,156632384,"Bộ 4 nắp chụp van vòi lốp xe ô tô,xe máy",22986,26900,3914,15
TIKI,o-to-xe-may-xe-dap,173671769,"Mũ Bảo Hiểm 3/4 HPro HP04 - Giao Nhanh - Hàng Chính Hãng",279000,320000,41000,13
TIKI,o-to-xe-may-xe-dap,102445056,"Túi da đựng đồ sau ghế  ô tô có bàn gập  loại cao cấp",169000,169000,0,0
TIKI,o-to-xe-may-xe-dap,106225531,"Khăn Lau Xe Rửa Xe OTO Xe Máy Siêu Thấm Đa Năng, Khăn Lau Nội Thất Xe Hơi Xe Máy Sợi Siêu Mịn",35000,55000,20000,36
TIKI,o-to-xe-may-xe-dap,56104928,"Giá Đỡ Điện Thoại Có Đế Hút Cao Su Để Trên Ô Tô ",79000,79000,0,0
TIKI,o-to-xe-may-xe-dap,144197271,"BÌNH XỊT RP7MIỄN PHÍ VẬN CHUYỂNCHAI XỊT CHỐNG RỈ SÉT RP7 150G CHỐNG RỈ BÔI TRƠN TIỆN DỤNG",33700,33700,0,0
TIKI,o-to-xe-may-xe-dap,193568479,"Đèn xe đạp Kiotool thế hệ mới nhiều chế độ sáng chống nước",125000,125000,0,0
TIKI,o-to-xe-may-xe-dap,10152416,"Giá Đỡ Điện Thoại Gắn Trên Cửa Gió Điều Hòa Ô Tô Baseus SUYL-D01",249499,249499,0,0
TIKI,o-to-xe-may-xe-dap,177517963,"Bọc Chìa Khóa Smartkey Airblade SH Vision Lead 2021 - 2022 Chất Liệu Nhựa TPU Đàn Hồi Chống Va Đập",134000,134000,0,0
TIKI,o-to-xe-may-xe-dap,204280857,"Dây treo xe ô tô tượng Phật Quan Âm bằng gỗ cao cấp của nhà HÀ XÁ",350000,700000,350000,50
TIKI,o-to-xe-may-xe-dap,28467118,"NƯỚC RỬA XE BỌT TUYẾT ĐẬM ĐẶC - PH CÂN BẰNG - NHIỀU BỌT 3M CAR WASH SHAMPOO 1 LIT 305860",205000,210000,5000,2
TIKI,o-to-xe-may-xe-dap,168194160,"Chất tăng cường độ dính cho băng Keo 3M Primer 94",35000,35000,0,0
TIKI,o-to-xe-may-xe-dap,196923505,"Yên xe đạp . yên béo cực êm , chính hãng ShengXin 02",199000,199000,0,0
TIKI,o-to-xe-may-xe-dap,165707326,"Chai xịt phủ nano chống nước kính ô tô, phủ bóng sơn xe hơi - Chống nước bề mặt kính cận, mũ bảo hiểm 100ML",59000,59000,0,0
TIKI,o-to-xe-may-xe-dap,19748905,"Bộ 2 đèn LED gắn van bánh xe đạp, xe máy, ô tô",16700,16700,0,0
TIKI,o-to-xe-may-xe-dap,92982560,"Nệm giường hơi cho xe ô tô, xe hơi 5, 7 chỗ cao cấp, tiện dụng có thành chắn an toàn cho trẻ nhỏ kèm theo bơm điện 12V",590000,590000,0,0
TIKI,o-to-xe-may-xe-dap,10713805,"Bảng Số Điện Thoại Trên Ô Tô Baseus ACNUM-01",268499,268499,0,0
TIKI,o-to-xe-may-xe-dap,72109275,"Kem Đánh Bóng Xóa Trầy Xước Sơn Ô tô - Xe Máy Cana Car Cream 100g - đánh bóng bề mặt kim lọai, đồ gỗ, mặt đá",42000,42000,0,0
TIKI,o-to-xe-may-xe-dap,78017031,"Máy sạc bình ắc quy 12V có chức năng khử sunfat sạc từ 4-100Ah TIANYE thông minh tự ngắt khi đầy dòng sạc 6A sạc bình ắc quy 12V sạc bình ắc quy ô tô sạc bình ắc quy xe máy(Vàng)",175000,175000,0,0
TIKI,o-to-xe-may-xe-dap,75337440,"Yên xe đạp thể thao , Carbon siêu êm , Chính hãng Sengxin , da PU cao cấp - Tặng kèm chuông 02",199000,199000,0,0
TIKI,o-to-xe-may-xe-dap,2850247,"Bơm hơi đạp chân ô tô xe máy loại 1pitton (Thiết kế chuẩn)",72000,110000,38000,35
TIKI,o-to-xe-may-xe-dap,10794376,"Máy Bơm Xe Đạp, Xe Honda, Xe Hơi Đạp Chân",78000,119000,41000,34
TIKI,o-to-xe-may-xe-dap,115521323,"Lưới ràng buộc đồ xe máy và hành lý xe mô tô (40x40cm)",45000,45000,0,0
TIKI,o-to-xe-may-xe-dap,16287857,"Dung DỊch Rửa Xe Không Chạm Bio 30 - (1l) - Hàng Chính Hãng",126000,150000,24000,16
TIKI,o-to-xe-may-xe-dap,147349342,"Bộ 5 Khăn Lau Xe Ô Tô Chuyên Dụng Kích Thước 30cm x 50cm Chất Liệu Vải Microfiber Siêu Mềm Và Thấm Hút Tốt, Dùng Được Trong Gia Đình Không Để Lại Vệt",99000,99000,0,0
TIKI,o-to-xe-may-xe-dap,142403160,"Cuộn băng keo phản quang 8 MÉT dán trang trí xe đạp, xe máy, xe ô tô - Băng dính/ miếng dán decal phản quang cảnh báo an toàn ban đêm",25650,27000,1350,5
TIKI,o-to-xe-may-xe-dap,125889440,"Nước rửa kính ô tô Cá Voi 2L đổ trực tiếp phù hợp với mọi loại xe hơi, nói không với viên sủi gây tắc bình chứa nước của xe",50000,50000,0,0
TIKI,o-to-xe-may-xe-dap,108695117,"DUNG DỊCH RỬA XE BỌT TUYẾT [5 Lít]",199000,249000,50000,20
TIKI,o-to-xe-may-xe-dap,41098208,"Bạt che nắng kính lái xe ô tô - dày 3 lớp, tráng nhôm.",50500,50500,0,0
TIKI,o-to-xe-may-xe-dap,52696657,"Bộ 4 miếng nẹp bước chân chống trơn trượt, trày xước xe ô tô, xe hơi cao cấp",43000,43000,0,0
TIKI,o-to-xe-may-xe-dap,263416079,"XE ĐẠP TRẺ EM KIỂU DÁNG THỂ THAO CỠ 20 INCH cho bé 7 tuổi - 11 TUỔI + Tặng kèm giỏ xe, gácbaga, túi, bình nước",1069000,1069000,0,0
TIKI,o-to-xe-may-xe-dap,57837428,"Móc Treo, Giá Đỡ Treo Xe Đạp Dựng Đứng Lên Tường, Vách Tường Siêu Chắc Xoay 180 Độ Cho Xe Đạp Đua, Xe Đạp Địa Hình Leo Núi Mai Lee",77000,99000,22000,22
TIKI,o-to-xe-may-xe-dap,38903048,"Bộ 2 Đèn LED Van Xe Đạp. Xe Máy, Moto ( Màu Giao Ngẫu Nhiên )",22000,22000,0,0
TIKI,o-to-xe-may-xe-dap,58570850,"Yên xe đạp - Chất liệu cao cấp - Siêu bền - Tặng kèm chuông YX 09",169000,169000,0,0
TIKI,o-to-xe-may-xe-dap,117029672,"Bao Da dành cho chìa Khóa Smartkey Yamaha NVX, Janus, Nozza Grande, FreeGo, Latte, Exciter 155 VVA handmade da thật",100000,100000,0,0
TIKI,o-to-xe-may-xe-dap,196923892,"Yên xe đạp , yên xe đạp thể thao XD10",129000,129000,0,0
TIKI,o-to-xe-may-xe-dap,35292967,"Combo 10 giá móc treo đa năng gắn tựa đầu treo đồ vật sau ghế ô tô, xe hơi ",63000,63000,0,0
TIKI,o-to-xe-may-xe-dap,214608081,"Dụng cụ bơm hơi bánh xe đạp chân đa năng mini dùng cho xe đạp, xe máy",155000,180000,25000,14
TIKI,o-to-xe-may-xe-dap,48890257,"Thanh Gạt mưa Bosch Aerotwin - Hàng chính hãng",385000,618000,233000,38
TIKI,o-to-xe-may-xe-dap,36644725,"Nước rửa xe bọt tuyết Car Shampoo 5L cho ô tô xe máy AUTOPRO",129000,129000,0,0
TIKI,o-to-xe-may-xe-dap,7124931,"Chai xịt tăng độ bóng sơn ô tô 3M 39034 (Hàng Mỹ)",285000,295000,10000,3
TIKI,o-to-xe-may-xe-dap,23479190,"Bộ Đèn Pin Gắn Xe Đạp Và Đèn Chiếu Hậu 5 LED WJ-101 Giúp Đạp Xe An Toàn Trong Đêm",37800,99944,62144,62
TIKI,o-to-xe-may-xe-dap,127349688,"Kích chữ a , kích thay lốp 3 tấn có đòn bẩy nâng gầm dễ dàng model 2021 tiết kiệm công sức",289000,289000,0,0
TIKI,o-to-xe-may-xe-dap,15343372,"Ví Da Đựng Giấy Tờ Ô Tô Theo Hãng Xe",21000,21000,0,0
TIKI,o-to-xe-may-xe-dap,124926007,"[Bóng lốp] Dung dịch phục hồi làm bóng lốp, chăm sóc lốp, phục hồi nhựa nhám lốp ô tô, xe máy Nanoka 3,6L",219000,219000,0,0
TIKI,o-to-xe-may-xe-dap,1254573,"Nước Rửa Kính Và Vệ Sinh Kính Xe Hơi 3M 08888",101000,125000,24000,19
TIKI,o-to-xe-may-xe-dap,132352080,"Decal Gấu Trúc Panda dán xe ô tô, sticker dán cửa kính, xe tải",55000,75000,20000,27
TIKI,o-to-xe-may-xe-dap,7255931,"Mũ bảo hiểm nửa đầu lưỡi trai GRS A760",265000,265000,0,0
TIKI,o-to-xe-may-xe-dap,3522761," Sáp thơm ô tô hương cà phê AREON Ken Coffee - NHẬP KHẨU BULGARIA",265000,265000,0,0
TIKI,o-to-xe-may-xe-dap,100263960,"Dây Thun Hành Lý Xe Đạp Leo Núi 3 Dây Cố Định Buộc Hàng Co Giãn 68cm Trang Trí Xe Đạp",44000,47000,3000,6
TIKI,o-to-xe-may-xe-dap,25154631,"Bảng ghi số điện thoại, biển số xe gắn trên ô tô Ugreen 50722 chính hãng",236000,236000,0,0
TIKI,o-to-xe-may-xe-dap,109189280,"Sáp Xóa Vết Trầy Xước Và Đánh Bóng Sơn Cho Xe Hơi 100ml",99000,99000,0,0
TIKI,o-to-xe-may-xe-dap,21744637,"DƯỠNG SÊN/XÍCH MOTUL MC CARE C4 CHAIN LUBE FACTORY LINE",269000,269000,0,0
TIKI,o-to-xe-may-xe-dap,122437009,"Chuông xe đạp la bàn Kiotool nhôm hợp kim chắc chắn tiếng to",25000,25000,0,0
TIKI,o-to-xe-may-xe-dap,132352478,"Decal dán trang trí nắp bình đổ xăng sticker decan tạo phong cách vui nhộn cho xe hơi,ô tô",14000,15000,1000,7
TIKI,o-to-xe-may-xe-dap,56733989,"Mũ Bảo Hiểm Xe Đạp Người Lớn, Nón Bảo Hiểm Xe Đạp Tiêu Chuẩn Châu Âu, Thời Trang, An toàn, Năng Động Protec Win 002 - Hàng Chính Hãng",389000,478000,89000,19
TIKI,o-to-xe-may-xe-dap,84870118,"Chai xịt dưỡng bóng sơn và bóng da, làm đen nhựa nhám Pallas Wax 120ml tăng độ bóng, nổi bật màu sắc, chống bám bụi",35000,35000,0,0
TIKI,o-to-xe-may-xe-dap,47460958," Nhớt Xe Đạp Muc-Off Bio Dry Lube 50ml",175000,175000,0,0
TIKI,o-to-xe-may-xe-dap,190707557,"Bộ 3 Cây Móc Lốp Xe Đạp, Nạy Vỏ Xe Đạp Bằng Kim Loại Cao Cấp Nhỏ Gọn",17000,18000,1000,6
TIKI,o-to-xe-may-xe-dap,3261211,"Mũ bảo hiểm nửa đầu GRS A737K",279000,279000,0,0
TIKI,o-to-xe-may-xe-dap,184886363,"Đèn led hậu xe đạp có Laser cảnh báo 2 bên - Pin AAA | Đèn LED cường độ cao dành cho xe đạp",52250,55000,2750,5
TIKI,o-to-xe-may-xe-dap,16279248,"Dung DỊch Rửa Xe Không Chạm Bio 20 - (1l) - Hàng Chính Hãng",99000,115000,16000,14
TIKI,o-to-xe-may-xe-dap,131177383,"Bộ kích điện sạc bình ắc quy 12V cứu hộ ô tô xe máy công suất lớn kiêm sạc dự phòng TM15",799000,799000,0,0
TIKI,o-to-xe-may-xe-dap,34156069,"Bộ 2 Đèn Hậu LED Cảnh Báo Gắn Phía Sau Xe Đạp Giúp Đạp Xe An Toàn Ban Đêm 4 chế độ sáng (Đèn Đỏ và Xanh) Mai Lee - Hàng chính hãng",59000,69990,10990,16
TIKI,o-to-xe-may-xe-dap,11262800,"Bộ Cọ Rửa Chăm Sóc Bánh Xe Ô tô",52000,52000,0,0
TIKI,o-to-xe-may-xe-dap,96908815,"Thùng Rác Mini Để Trên Xe Ô Tô, Hộp chứa Rác Đa Năng Văn Phòng tiện dụng đơn giản gọn nhẹ chất liệu bền bỉ dày dặn",56041,58990,2949,5
TIKI,o-to-xe-may-xe-dap,5483493,"Dung dịch vệ sinh nội thất xe Sonax 321200 500ml",172000,172000,0,0
TIKI,o-to-xe-may-xe-dap,85804967,"Bọc vô lăng cho mọi dòng xe - bọc vô lăng xe ô tô siêu khít",80000,98000,18000,18
TIKI,o-to-xe-may-xe-dap,180867688,"Bộ 4 Móc Dán Treo Đồ Nội Thất Hatsu - Treo Cáp Sạc, Chìa Khóa, Túi Xách Xe Hơi, Ô Tô Cao Cấp - Chịu Lực Mạnh Mẽ - Nhựa ABS  - Còn Có Thể Dùng Cho Treo Vật Dụng Trong Nhà",64600,68000,3400,5
TIKI,o-to-xe-may-xe-dap,73715841,"Mũ Bảo Hiểm Nửa Đầu RONA Haly Luxury",150000,250000,100000,40
TIKI,o-to-xe-may-xe-dap,68888307,"Chuông Xe Đạp Thể Thao Địa Hình Mini Bằng Đồng Âm Thanh Vang 90-100dB Gắn Ghi Đông Xe Đạp Mai Lee (Loại Cơ Bản)",31000,39000,8000,21
TIKI,o-to-xe-may-xe-dap,23298449,"DƯỠNG SÊN/XÍCH MOTUL MC CARE C2 CHAIN LUBE ROAD - Hàng Chính Hãng",150000,150000,0,0
TIKI,o-to-xe-may-xe-dap,101497305,"Giỏ Xe Đạp Gắn Trước Có Thể Gập Gọn Chất Liệu Kim Loại Kích Thước 33x20x20cm Mai Lee",158000,179000,21000,12
TIKI,o-to-xe-may-xe-dap,173754583,"Giá chở hàng, baga xe máy đa năng có thể mở cốp đổ xăng không cần tháo, có thêm 2 cánh sườn kèm chân chống",459000,459000,0,0
TIKI,o-to-xe-may-xe-dap,19943711,"Chai xịt tẩy rửa nội thất ô tô - Bình xịt rửa nội thất FOAM",53960,56800,2840,5
TIKI,o-to-xe-may-xe-dap,273829007,"Khăn lau ô tô chuyên dụng đa năng microfiber, siêu thấm, khổ to, không để lại bụi vải TÂM LUÂN Chổi lau tẩm dầu - Hàng chính hãng",29000,40000,11000,28
TIKI,o-to-xe-may-xe-dap,176734572,"Xe máy điện VinFast Vento S",50000000,50000000,0,0
TIKI,o-to-xe-may-xe-dap,44128872,"Bộ Đèn Pha Trước Xe Đạp Có Sạc USB Siêu Sáng Cao Cấp Chống Nước và Đèn Hậu Phía Sau Dành Cho Xe Đạp Địa Hình, Xe Đạp Thể Thao Giúp Đạp Xe An Toàn Ban Đêm - Hàng Chính Hãng",379000,379000,0,0
TIKI,o-to-xe-may-xe-dap,105183976,"Gương cầu lồi xe máy - lắp mọi loại xe, quan sát rộng ( một cái)",31200,31200,0,0
TIKI,o-to-xe-may-xe-dap,54675275,"Máy lọc không khí và khử mùi xe hơi Michelin ML-19 - Hàng chính hãng",1199000,1199000,0,0
TIKI,o-to-xe-may-xe-dap,68480273," Chai xịt bảo dưỡng sên Megacools Chain Lube 300ml - dưỡng sên xích, sên trần, sên phốt cao su xe máy",75000,75000,0,0
TIKI,o-to-xe-may-xe-dap,179952882,"Bộ 2 Miếng Lót Nón Bảo Hiểm Màu Đen",30000,30000,0,0
TIKI,o-to-xe-may-xe-dap,56514552,"Xwash For Car - Vệ sinh không hóa chất - Bảo vệ nội thất ô tô - Không gây mùi độc hại",219000,219000,0,0
TIKI,o-to-xe-may-xe-dap,115707565,"Gác chân xe đạp, gác để chân sau xe đạp",29000,39000,10000,26
TIKI,o-to-xe-may-xe-dap,73519339,"Nhớt Xe Tay Ga Mobil Super Moto Scooter 10W-40 Tiêu Chuẩn JASO MB API SL (0.8L) - Hàng Chính Hãng",99000,99000,0,0
TIKI,o-to-xe-may-xe-dap,177310118,"Bông tiêu âm, tấm cách âm chống ồn cho ô tô sàn xe thùng loa phòng karaoke studio kích thước 50x80cm",71000,71000,0,0
TIKI,o-to-xe-may-xe-dap,44876415,"Bộ Dụng Cụ Đánh Bóng Chăm Sóc Xe Ô Tô 7 chi tiết",147999,147999,0,0
TIKI,o-to-xe-may-xe-dap,152789102,"Ắc Quy Xe Đạp Điện YMT-12-15 PLUS 12V-15AH, acquy dùng cho Loa Kéo, Năng Lượng Mặt Trời",431000,431000,0,0
TIKI,o-to-xe-may-xe-dap,141955901,"Chốt dây an toàn ô tô các hãng bằng hợp kim mạ inox,Chốt cài dây an toàn ô tô các hãng xe,Chốt cửa an toàn ô tô hữu ích",32000,32000,0,0
TIKI,o-to-xe-may-xe-dap,158451310,"Decal phản quang mũi tên dán xe ô tô-cuộn dài 3m",38526,39900,1374,3
TIKI,o-to-xe-may-xe-dap,177163430,"1 Đôi ốc chân gương hình mặt cười gắn xe máy - TKB06",9000,27840,18840,68
TIKI,o-to-xe-may-xe-dap,53308205,"Hộp Túi Treo Khung Gắn Sườn Trước Xe Đạp Có Giá Đỡ Đựng Điện Thoại Màn Hình Cảm Ứng Dưới 6.5 Inch Chống Thấm Nước Mai Lee Cycling - Hàng Chính Hãng",189000,209000,20000,10
TIKI,o-to-xe-may-xe-dap,52757816,"Bơm đạp chân đa năng 2 xi lanh ROCKBROS dùng cho ô tô, xe máy, xe đạp dế dàng sử dụng",239000,239000,0,0
TIKI,o-to-xe-may-xe-dap,35878236,"Nước Rửa Xe Sumo 1000 ml Mới Chai Vuông Rửa Xe Chuyên Dụng Bảo Vệ Màu Sơn Chăm Sóc Xe Ô tô Mô tô Tay Ga Gắn Máy Bóng Loáng Như Mới Chống Gỉ Sét Hàng Việt Nam Chất Lượng Cao",54900,54900,0,0
TIKI,o-to-xe-may-xe-dap,19477513,"Gác baga xe đạp thể thao cao cấp",243998,243998,0,0
TIKI,o-to-xe-may-xe-dap,11507629,"Ổ khoá đĩa xe máy chống cắt cao cấp",92899,92899,0,0
TIKI,o-to-xe-may-xe-dap,147885000,"Dầu tra sên xích xe đạp, chống rỉ, chống mài mòn",19000,25000,6000,24
TIKI,o-to-xe-may-xe-dap,52248720,"Bộ đèn LED 4 thanh các màu cao cấp đặt gầm xe hơi, ô tô RGB-5050 tích hợp remote điều khiển bật tắt chỉnh chế độ đèn, tự động thay đổi màu sắc êm dịu theo tiếng nhạc",70000,70000,0,0
TIKI,o-to-xe-may-xe-dap,65815214,"COMBO Đèn Còi Xe Đạp 7588 Và Đèn Hậu Sạc USB BS216",119900,119900,0,0
TIKI,o-to-xe-may-xe-dap,21569960,"Bộ 2 Tấm Che Chắn Nắng Ô Tô Cao Cấp",19000,19000,0,0
TIKI,o-to-xe-may-xe-dap,121174287,"Bộ dán phản quang trang trí vành xe máy, xe đạp, ô tô",23641,42984,19343,45
TIKI,o-to-xe-may-xe-dap,51267437,"Bộ chia tẩu sạc dùng cho ô tô, xe hơi nhãn hiệu Hoco Z28 với 2 lỗ tẩu sạc kết hợp  2 cổng USB, Đầu vào: DC12 - 24V, Tổng đầu ra 2 cổng USB: DV5V/3.1A Max, Đầu ra 2 lỗ tẩu sạc: 80W Max",179000,179000,0,0
TIKI,o-to-xe-may-xe-dap,97003049,"Khóa chống trộm cho xe máy Caps lock",122280,122280,0,0
TIKI,o-to-xe-may-xe-dap,14815042,"Bộ chia tẩu cắm sạc trên ô tô V3",49000,49000,0,0
TIKI,o-to-xe-may-xe-dap,84324506,"Găng tay rửa xe mẫu 2 cho ô tô + Kèm 01 khăn lau xe chuyên dụng",25000,38900,13900,36
TIKI,o-to-xe-may-xe-dap,43719788,"Miếng Tựa Lưng Ghế Hạt Gỗ - Miếng Tựa Lưng Ghế Ô Tô, Xe Hơi - Hàng Chính Hãng miDoctor - Màu Gỗ Ngẫu Nhiên",93000,93000,0,0
TIKI,o-to-xe-may-xe-dap,99834121,"VÍ DA ĐỰNG ĐĂNG KIỂM, GIẤY TỜ Ô TÔ XE HƠI CAO CẤP - LOGO VIP",20000,20000,0,0
TIKI,o-to-xe-may-xe-dap,90640997,"IC ĐIỀU TỐC XE MÁY ĐIỆN 500W SỬ DỤNG 12 SÒ MOSTFET",310700,310700,0,0
TIKI,o-to-xe-may-xe-dap,35390547,"Bảng Số Điện Thoại, Kiêm Giá Đỡ Điện Thoại Trên Taplo Xe Hơi, Ô Tô  BSDT-Z1",17990,17990,0,0
TIKI,o-to-xe-may-xe-dap,89213214,"Máy bơm lốp xe ô tô điện tử thông minh tự ngắt Car365 cao cấp màn LCD hiển thị áp suất - Vật liệu cao cấp - Bơm nhanh - Thiết kế nhỏ gọn - CAR44",379000,379000,0,0
TIKI,o-to-xe-may-xe-dap,68480340,"Bộ 3 sp Chai xịt vệ sinh sên xe máy TS-40 450ml, chai xịt dưỡng sên Thunder Chain Lube 400ml và bàn chải vệ sinh sên",125000,125000,0,0
TIKI,o-to-xe-may-xe-dap,131337645,"Găng tay phượt Mfact cao cấp dài tay, găng đi xe máy tập gym hoạt động ngoài trời",47000,47000,0,0
TIKI,o-to-xe-may-xe-dap,142321640,"Máy Bơm Bánh Xe , Bơm Xe Đạp , Bơm Xe Máy Nhỏ Gọn Có Đồng Hồ Áp Suất ZF01 - Xách Tay Siêu Nhẹ, Áp Suất 160 PSI Hỗ Trợ Cả Van Mỹ và Van Pháp - Hàng Chính Hãng",118000,118000,0,0
TIKI,o-to-xe-may-xe-dap,77711451,"Bơm đạp chân đa năng 2 piston - Bơm hơi dùng cho ô tô, xe máy, bơm phao, bóng",225000,225000,0,0
TIKI,o-to-xe-may-xe-dap,116691630,"Đèn Xi Nhan Xe Đạp Điều Khiển Từ Xa Có Còi 120db Cao Cấp",225000,225000,0,0
TIKI,o-to-xe-may-xe-dap,49304330,"rổ lưới thái V5 dành cho xe wave nhỏ,wave lớn",159000,159000,0,0
TIKI,o-to-xe-may-xe-dap,117598706,"Nước làm mát động cơ xe ô tô (màu xanh) Maxcool Standard 4L, 1L, 0,5 lít",22000,22000,0,0
TIKI,o-to-xe-may-xe-dap,103631155,"Gối Tựa Đầu Tựa Lưng Cao Su Non Cao Cấp Siêu Đàn Hồi",99000,99000,0,0
TIKI,o-to-xe-may-xe-dap,8438370,"Nón bảo hiểm nửa đầu có kính Sunda 136A mẫu mới",275000,275000,0,0
TIKI,o-to-xe-may-xe-dap,143921021,"Giá kẹp điện thoại gắn gương chiếu hậu trong ô tô, xe hơi",41000,57502,16502,29
TIKI,o-to-xe-may-xe-dap,74858683,"Mũ Bảo Hiểm 1/2 Đầu Napoli Haley N120 Nhiều Màu - Freesize 54cm – 58cm",178000,178000,0,0
TIKI,o-to-xe-may-xe-dap,138158664,"Còi Tìm Xe Trong Bãi 2 Kiểu Chuông, Chống Trộm",155000,155000,0,0
TIKI,o-to-xe-may-xe-dap,152556216,"Đèn xe đạp siêu sáng cảm biến thông minh, chống nước Rhino L101 tự động điều chỉnh độ sáng theo môi trường, pin sạc, 4 chế độ sáng, pin từ 4-8 tiếng - Hàng chính hãng",183000,225000,42000,19
TIKI,o-to-xe-may-xe-dap,127785019,"Chổi lau xe ô tô có tẩm dầu chuyên dụng quét bụi, bảo vệ sơn xe TÂM LUÂN Chổi lau tẩm dầu - Hàng chính hãng",329000,400000,71000,18
TIKI,o-to-xe-may-xe-dap,132012434,"Dây ràng hàng xe máy, dây buộc ràng đồ đạc chiều dài 45cm - 210cm",19000,19000,0,0
TIKI,o-to-xe-may-xe-dap,133774793,"Bơm lốp ô tô điện tử tự ngắt 12v công suất 120w đồng hồ điện tử bơm nhanh khỏe trong 60s",299000,299000,0,0
TIKI,o-to-xe-may-xe-dap,116016110,"Bộ 10 chi tiết Miếng dán Silicon chống xước hõm xe và tay nắm cửa ô tô - full logo hãng xe",65000,65000,0,0
TIKI,o-to-xe-may-xe-dap,44254985,"Dung dịch chống bám nước trên kính xe Karshine KA-RO150",99000,99000,0,0
TIKI,o-to-xe-may-xe-dap,168800870,"Bộ 6 miếng vá xe đạp không cần dán keo (vá lạnh)",20000,25000,5000,20
TIKI,o-to-xe-may-xe-dap,52418021,"Máy sạc bình ắc quy 12V 100Ah thông minh tự ngắt khi đầy có chức năng khử sunfat bảo dưỡng phục hồi ắc quy có quạt tản nhiệt",155000,155000,0,0
TIKI,o-to-xe-may-xe-dap,133783245,"Đèn Mini cảnh bảo an toàn - Thiết Kế Nhỏ Gọn Tiện Dụng - Đèn Cảnh Báo Gắn Đuôi Xe Đạp, Phụ kiện bánh xe đạp ",36100,38000,1900,5
TIKI,o-to-xe-may-xe-dap,120226267,"Chai xịt chống kẹt kính cửa sổ ô tô bảo dưỡng phục hồi chi tiết nhựa gioăng cao su 268ml",79000,79000,0,0
TIKI,o-to-xe-may-xe-dap,102409936,"Combo 4 tấm che nắng cửa bên ô tô, che nắng bạc phản quang - núm hút chân không",37050,39000,1950,5
TIKI,o-to-xe-may-xe-dap,174022003,"bao da chìa khoá Hyundai Creta 2022, Hyundai Stargazer 2022 2023 4 nút handmade da thật 008b",200000,200000,0,0
TIKI,o-to-xe-may-xe-dap,95470617,"Ví đựng giấy tờ xe ô tô dành cho hãng xe Toyota",32000,37000,5000,14
TIKI,o-to-xe-may-xe-dap,120803119,"Giá kẹp điện thoại dán taplo trên Ô tô chắc chắn sang trong trọng HN699 Tặng bút cảm ứng ĐT",38000,52778,14778,28
TIKI,o-to-xe-may-xe-dap,13326068,"Bộ 2 Gối Tựa Đầu Ô Tô - Gối Chống Mỏi Cổ Trên Xe Hơi AZONE",110000,110000,0,0
TIKI,o-to-xe-may-xe-dap,23835075,"Bộ 2 miếng che nắng cho ô tô Michelin MI-CWS (36 x 45cm)",57000,65000,8000,12
TIKI,o-to-xe-may-xe-dap,120293072,"Bộ 4 miếng dán chống trầy xước hõm cửa ô tô có LOGO hãng xe",45000,45000,0,0
TIKI,o-to-xe-may-xe-dap,25680386,"Tem dán capo xe ô tô TX100",59000,59000,0,0
TIKI,o-to-xe-may-xe-dap,117598115,"Bình xịt vệ sinh pét xăng, chế hòa khí {bình xăng con} Botny Carburetor Cleaner 450g",59000,59000,0,0
TIKI,o-to-xe-may-xe-dap,36406160,"Búa Thoát Hiểm Ô Tô Bằng Thép Không Gỉ Siêu Chắc Chắn",155000,155000,0,0
TIKI,o-to-xe-may-xe-dap,35170392,"KHÓA ĐĨA BÁO ĐỘNG CHỐNG TRỘM DÀNH CHO XE MÁY - KDCT",212500,212500,0,0
TIKI,o-to-xe-may-xe-dap,4405897,"Ruột xe đạp Schwalbe 700c SV15 (40mm)",130000,130000,0,0
TIKI,o-to-xe-may-xe-dap,208211928,"Mũ bảo hiểm lỗ thông gió chính hãng NÓN SƠN TG-ĐN052",325000,650000,325000,50
TIKI,o-to-xe-may-xe-dap,125425768,"Mũ Bảo Hiểm Nửa Đầu Kính Ẩn ANDES 139 - Nhiều Màu",348000,440000,92000,21
TIKI,o-to-xe-may-xe-dap,101985288,"Đèn led siêu sáng, đèn pha led cho xe máy, đèn pha xe máy có 4 mặt led, đèn pha bi 4 mặt cho xe máy-D4MB",69000,69000,0,0
TIKI,o-to-xe-may-xe-dap,25208495,"Máy bơm lốp ô tô 2 xilanh Air Compressor, Đèn LED, Có hộp đựng, bộ dụng cụ",456220,456220,0,0
TIKI,o-to-xe-may-xe-dap,127238506,"Thùng rác trên xe ô tô, loại nhỏ gắn cửa xe, gắn ghế sau",57950,61000,3050,5
TIKI,o-to-xe-may-xe-dap,49537959,"Bơm hợp kim nhôm loại đạp chân dùng cho xe đạp, xe máy, ô tô, tặng kèm kim bơm banh và bơm thú hơi - Màu giao ngẫu nhiên",99000,99000,0,0
TIKI,o-to-xe-may-xe-dap,33544494,"Bộ 4 miếng dán chống đọng nước kính hông và gương chiếu hậu ô tô, xe hơi",58400,58400,0,0
TIKI,o-to-xe-may-xe-dap,1254625,"Chai Xịt Đánh Bóng Nhanh 3M Gloss Enhancer 39034LT (400ml)",160000,170000,10000,6
TIKI,o-to-xe-may-xe-dap,13644131,"Nước hoa sáp thơm kèm đèn led nháy, khử mùi hôi trong xe hơi,ô tô, phòng ngủ, phòng làm việc",36000,36000,0,0
TIKI,o-to-xe-may-xe-dap,22293088,"Găng Tay Xe Máy Oakley Có Gù Ngón Cụt - Xanh",65000,65000,0,0
TIKI,o-to-xe-may-xe-dap,131402469,"ĐÈN TRỢ SÁNG L4 ngắn 3 chế độ lắp cho xe máy xe đạp điện",79000,79000,0,0
TIKI,o-to-xe-may-xe-dap,162227264,"Ắc quy khô miễn bảo dưỡng Đồng Nai PTZ5L | 12V - 4Ah",241000,241000,0,0
TIKI,o-to-xe-may-xe-dap,75447187,"Mũ bảo hiểm nửa đầu LS2 HH590 Rebellion",1500000,1500000,0,0
TIKI,o-to-xe-may-xe-dap,50731632,"Thùng đựng đồ ở giữa dành cho xe Winner 150.",188000,188000,0,0
TIKI,o-to-xe-may-xe-dap,3665771,"Dầu bôi trơn chống rỉ sét đa năng 3M 5-W",79000,79000,0,0
TIKI,o-to-xe-may-xe-dap,82473496,"Bộ gối tựa đầu và dựa lưng cao su non cao cấp siêu đàn hồi",135000,135000,0,0
TIKI,o-to-xe-may-xe-dap,32146027,"Máy sạc bình ắc quy 12V 5A FOXSUR 4-100Ah có khử sunfat phục hồi ắc quy",160000,160000,0,0
TIKI,o-to-xe-may-xe-dap,131531524,"Bọc yên xe đạp thể thao HT-SPORTS bọc silicone dày êm thoáng khí, có phản quang đi đêm tặng kèm bọc mưa",109000,109000,0,0
TIKI,o-to-xe-may-xe-dap,62905859,"Máy Bơm Lốp Ô Tô, Xe Hơi Điện Tử Thông Minh YD787 tích hợp đèn pin",395000,395000,0,0
TIKI,o-to-xe-may-xe-dap,96910002," 2 miếng dán chống bám nước mưa trên kính hậu xe ô tô - hình bầu dục",23900,23900,0,0
TIKI,o-to-xe-may-xe-dap,120562215,"Khóa Xe Máy Caps Lock Khóa Tay Ga Tay Phanh KH78 Shalla Tặng móc khóa hình búa",121109,121109,0,0
TIKI,o-to-xe-may-xe-dap,126960923,"Bao Da Chìa Khóa Honda SH 2021, SH 2022, SH 350i (loại 2 nút bấm) handmade da thật",100000,100000,0,0
TIKI,o-to-xe-may-xe-dap,169885717,"[Vải Dù Dày Nặng 1kg3]Bạt Phủ - Áo Trùm Xe Máy Cao Cấp Vải Dù 2 Mặt Che Nắng, Mưa Giữ Xe Luôn Như Mới Vừa Tất Cả Loại Xe",135000,135000,0,0
TIKI,o-to-xe-may-xe-dap,7982124,"Bộ 4 Tấm Che Nắng Ô Tô",32000,38000,6000,16
TIKI,o-to-xe-may-xe-dap,117201628,"Bộ nâng cổ xe đạp thể thao ",150000,150000,0,0
TIKI,o-to-xe-may-xe-dap,189632921,"Băng Keo 2 Mặt Dán Phụ Kiện Oto Xe Máy - Keo Nano Đỏ Siêu Dính",30000,30000,0,0
TIKI,o-to-xe-may-xe-dap,529456,"Xi Đánh Bóng Cana 100G",37000,37000,0,0
TIKI,o-to-xe-may-xe-dap,87393586,"Túi xe đạp cao cấp,túi treo sườn xe đạp chống nước bọc cảm ứng phù hợp với mọi dòng xe - Thương Hiệu KIOTOOL",75000,75000,0,0
TIKI,o-to-xe-may-xe-dap,4698547,"Bọc chân chống xe máy",5900,5900,0,0
TIKI,o-to-xe-may-xe-dap,75490727,"Đèn LED Xi Nhan Không Dây Rẽ Trái Phải Gắn Đuôi Xe Đạp Điều Khiển Không Dây Từ Xa Sạc Điện USB Mai Lee",215000,249000,34000,14
TIKI,o-to-xe-may-xe-dap,68480807,"Sáp thơm trang trí táp lô xe hơi, ô tô chạy bằng năng lượng mặt trời mô hình trực thăng",190000,259000,69000,27
TIKI,o-to-xe-may-xe-dap,34585636,"Cặp Đèn Xinhan Led L14 Gắn Vario , WINNER X và mọi loại xe máy BẢO LONG RACING",55000,55000,0,0
TIKI,o-to-xe-may-xe-dap,53328659,"Bơm lốp ô tô xe máy xe đạp đạp chân ROCK",225000,225000,0,0
TIKI,o-to-xe-may-xe-dap,110483410,"Combo 3 Khăn lau xe ô tô Muses (33x70cm) - Màu ngẫu nhiên",74100,78000,3900,5
TIKI,o-to-xe-may-xe-dap,105185009,"Khung biển số xe máy - viền trơn trắng, inox, meca chống nước",35000,35000,0,0
TIKI,o-to-xe-may-xe-dap,68480278,"[Mẫu Mới] Motul Scooter 10W40 800ml tặng Motul Gear Oil 80W90 120ml nhớt hợp số nhớt máy xe tay ga",149000,149000,0,0
TIKI,o-to-xe-may-xe-dap,73364277,"1 Tấm Bạt Đệm Miếng Phủ Trùm Lót Che Yên Xe Máy SIZE LỚN Chống Nóng Nắng Mưa 3 Lớp Cao Cấp",58000,58000,0,0
TIKI,o-to-xe-may-xe-dap,107522197,"Bạt Phủ Toàn Xe 3 Lớp Chống Xước, Chống Nắng, Chống Cháy Cho Ô Tô",249999,249999,0,0
TIKI,o-to-xe-may-xe-dap,2788431,"Bọt biển rửa xe ô tô chuyên dụng (Màu ngẫu nhiên)",23000,28000,5000,18
TIKI,o-to-xe-may-xe-dap,142783294,"Đèn Hậu Xe Đạp - Đèn Led Nháy Tín Hiệu Gắn Xe Đạp Giant Xe Đạp Thể Thao MTB Địa Hình Cảnh Báo An Toàn Trong Đêm Với 3 Chế Độ Sáng",57950,61000,3050,5
TIKI,o-to-xe-may-xe-dap,122437189,"Chân Chống Xe Đạp Thể Thao Kiotool Thay đổi kích thước phù hợp với mọi dòng xe đạp địa hình",65000,65000,0,0
TIKI,o-to-xe-may-xe-dap,20918089,"Bộ Combo Dưỡng sên Thunder Chain Lube 400ml, Vệ sinh sên MC-40 400ml tặng bàn chải chà sên 3D",112000,112000,0,0
TIKI,o-to-xe-may-xe-dap,44884682,"Gối Tựa Đầu Cao Su Non Cho Mọi Loại Xe Ô tô",120000,120000,0,0
TIKI,o-to-xe-may-xe-dap,77580607,"Bọc vô lăng da vân carbon cao cấp TTAUTO cho xe ô tô 4 đến 7 chỗ (Đen)",159000,250000,91000,36
TIKI,o-to-xe-may-xe-dap,11715049,"Nước hoa kẹp cửa gió điều hòa Areon Platinum Car Lux",315000,315000,0,0
TIKI,o-to-xe-may-xe-dap,186743659,"[1 chiếc] Gương Xe Đạp Chiếu Hậu Giá rẻ 8 cm Cho Xe Đạp Thể Thao Địa Hình 360 Độ Giúp Đạp Xe An Toàn Mai Lee",26000,29000,3000,10
TIKI,o-to-xe-may-xe-dap,186124514,"Mũ bảo hiểm Fullface 2 kính GRO ST11 thời trang, cá tính- Hàng chính hãng",369000,369000,0,0
TIKI,o-to-xe-may-xe-dap,35810240," Túi thơm cà phê Việt Nam treo xe ô tô -Robusta Đaklak -100G",39000,39000,0,0
TIKI,o-to-xe-may-xe-dap,157150852,"Chuông Xe Đạp Retro Thể Thao Nhỏ Gọn - Làm Bằng Hợp Kim Nhôm - Âm Thanh Vang 90 - 100dB Gắn Tay Lái (Ghi Đông) - Bigbull Retro Phụ Kiện Xe Đạp Chính Hãng",42750,45000,2250,5
TIKI,o-to-xe-may-xe-dap,49195399,"Bộ 2 Chai Dung Dịch Tẩy Keo, Nhựa Đường 3M 08987 (425 g)",280000,280000,0,0
TIKI,o-to-xe-may-xe-dap,172167246,"Nước rửa kính đậm đặc Senfineco Windschield Cleaner 9964",48000,48000,0,0
TIKI,o-to-xe-may-xe-dap,68611487,"Túi Tam Giác Treo Sườn Xe Đạp Chống Nước Treo Khung Xe Đa Năng Chứa Đồ Cá Nhân Mai Lee",113000,139000,26000,19
TIKI,o-to-xe-may-xe-dap,104469261,"Đèn Pha Trước Xe Đạp NX3 Có Sạc USB Siêu Sáng Cao Cấp Chống Nước Dành Cho Xe Đạp Địa Hình, Xe Đạp Thể Thao Giúp Đạp Xe An Toàn Ban Đêm",254000,279000,25000,9
TIKI,o-to-xe-may-xe-dap,82378075,"Lót (bọc) chân chống xe máy kèm thắt cổ dê - chống trầy nền nhà, Chống lún cát khi dựng xe - NKLUBE",19000,19000,0,0
TIKI,o-to-xe-may-xe-dap,110171383,"Sạc bình acquy 12V/6A 4Ah-100Ah tự ngắt khi đầy chức năng bảo dưỡng phục hồi ắc quy bằng khử sunfat chống ngược cực",175000,175000,0,0
TIKI,o-to-xe-may-xe-dap,43741683,"Bao Tay, Găng Tay Xe Đạp Và Thể Thao Mùa Hè Hở Ngón",35000,35000,0,0
TIKI,o-to-xe-may-xe-dap,69360356,"Đèn Pha Xe Đạp Chiếu Sáng Cao Cấp Chống Nước Gắn Ghi-Đông Siêu Sáng Sạc Điện Type-C Có Đồng Hồ Hiển Thị Thời Gian Lượng Pin Có Hỗ trợ Sạc Khẩn Cấp C30ML Mai Lee - Combo A",359000,359000,0,0
TIKI,o-to-xe-may-xe-dap,100414919,"Cảm biến áp suất lốp ô tô xe hơi gắn ngoài cao cấp Car365 Cảnh báo tiếng Việt độc quyền - Pin mặt trời, Màn LCD",199000,199000,0,0
TIKI,o-to-xe-may-xe-dap,74441824,"Bộ Dụng Cụ Vá Săm Lốp Xe Đạp Có Săm 11 Miếng Du Lịch Tiện Dụng Sử Dụng Khẩn Cấp Cho Xe Đạp Mai Lee",51000,59000,8000,14
TIKI,o-to-xe-may-xe-dap,11781042,"Khóa đĩa xe máy zcon",110000,110000,0,0
TIKI,o-to-xe-may-xe-dap,131337978,"Túi treo hành lý đằng sau chống nước-Túi đôi phía sau yên xe Đồ dùng và thiết bị đi xe đạp Màu Đỏ",135000,135000,0,0
TIKI,o-to-xe-may-xe-dap,53629453,"DUNG DỊCH RỬA KHOANG MÁY VÀ VỎ XE KHÔNG CHẠM EKOKEMIKA BIO 35 - 1L",157500,175000,17500,10
TIKI,o-to-xe-may-xe-dap,143779186,"Sticker Baby In Car dán xe ô tô",11825,12500,675,5
TIKI,o-to-xe-may-xe-dap,155245390,"Bao Da Chìa Khoá KIA Carnival 2021, 2022 handmade Da Thật 013",200000,200000,0,0
TIKI,o-to-xe-may-xe-dap,96910845,"Gương cầu lồi xoay 360 độ có viền và không viền HT-1003 gắn gương chiếu hậu xe hơi ô tô xe máy loại cao cấp",18000,29000,11000,38
TIKI,o-to-xe-may-xe-dap,212465816,"Mũ bảo hiểm bảo vệ đầu trẻ em có kính chống bụi cho bé Pikachu có tai siêu dễ thương",219000,219000,0,0
TIKI,o-to-xe-may-xe-dap,190516568,"Thùng Rác Mini Đa Năng Dùng Trên Xe Ô Tô, Bàn Học, Bàn Làm Việc, Hình Ngộ Nghĩnh Đáng Yêu",75000,75000,0,0
TIKI,o-to-xe-may-xe-dap,52337956,"Bộ kích điện xe ô tô khẩn cấp Xiaomi , Tích hợp pin dự phòng 11100 mAh - 70Mai Midrive PS01 - Hàng Nhập Khẩu",1189000,1189000,0,0
TIKI,o-to-xe-may-xe-dap,37498512,"ĐÈN XI NHAN XE MÁY BÓNG LED L17 CHẠY HIỆU ỨNG AUDI SIÊU ĐẸP (MÀU VÀNG) DXNL17",65550,69000,3450,5
TIKI,o-to-xe-may-xe-dap,184226973,"Nút Dán Giảm Lực Đóng Cửa Xe Ô Tô Chất Liệu Silicone Cao Cấp, Chống Sốc Bảo Vệ Cửa Xe Ô Tô",5400,5400,0,0
TIKI,o-to-xe-may-xe-dap,166549606,"Gương Cầu Lồi Có Viền Xoay 360 ,Gương Cầu Lồi Ô Tô Xóa Tan Mọi Điểm Mù",19000,19000,0,0
TIKI,o-to-xe-may-xe-dap,31705542,"Búa Thoát Hiểm Cho Xe Ô Tô, Xe Hơi R7116",155000,155000,0,0
TIKI,o-to-xe-may-xe-dap,20798577,"Combo 3 khăn lau xe chuyên dụng Microfiber siêu hút nước",19999,19999,0,0
TIKI,o-to-xe-may-xe-dap,85752639,"Đèn Báo Xi Nhan Rẽ Trái Phải Gắn Đuôi Cho Xe Đạp Với LED SMD Cao Cấp Và Remote Điều Khiển Từ Xa Không Dây Sạc USB Chống Nước Mai Lee",208000,229000,21000,9
TIKI,o-to-xe-may-xe-dap,146903570,"Sạc điện thoại xe máy 2 cổng USB 12-24V",95040,95040,0,0
TIKI,o-to-xe-may-xe-dap,189866686,"Combo đèn trước và Đèn led sau xe đạp, tiện lợi, loại tốt",79000,120000,41000,34
TIKI,o-to-xe-may-xe-dap,11959155,"Bảng số điện thoại trên ô tô nhãn hiệu Baseus ACNUM-01",181499,181499,0,0
TIKI,o-to-xe-may-xe-dap,107360982,"Khay Đựng Đồ Đa Năng Cắm Khe Ghế Ô Tô, Hộc Để Đồ Cao Cấp Trên Xe Hơi",99000,99000,0,0
TIKI,o-to-xe-may-xe-dap,183110799,"CAO SU BỌC TAY CẦM, TAY THẮNG XE MÁY MỘT BỘ",49000,49000,0,0
TIKI,o-to-xe-may-xe-dap,105184333,"Gương xe máy thời trang, thể thao cho SH, Exciter, Vario, CBR300, winner X",166500,166500,0,0
TIKI,o-to-xe-may-xe-dap,142419138,"Cặp dây quấn ghi đông xe đạp thể thao 2 mét/cuộn + 2 nút chặn - Dây quấn tay cầm xe đạp địa hình - Handle Bar Tape Chính Hãng",46550,49000,2450,5
TIKI,o-to-xe-may-xe-dap,57759195,"Tấm bạt che nắng oto, chống chói oto, chống hâm nóng xe khi đậu dưới trời nắng, hàng Việt Nam chất lượng cao, có sự lựa chọn mẫu",155000,155000,0,0
TIKI,o-to-xe-may-xe-dap,53978583,"Bọc Yên Xe Đạp Thể Thao Êm Giảm Trượt",75000,75000,0,0
TIKI,o-to-xe-may-xe-dap,38148090,"Bộ 4 Miếng Dán Gương Kính Bên Ô Tô Chống Nước Chống Lóa Gồm 2 Miếng Elip 150x100mm Và 2 Miếng Chữ Nhật 200x160mm",48000,48000,0,0
TIKI,o-to-xe-may-xe-dap,91648881,"Đèn Led Gắn Tăm Căm Xe Đạp Trang Trí Đẹp Mắt Với Pin Cr2032 (bên trong) MaiLee",26000,29000,3000,10
TIKI,o-to-xe-may-xe-dap,43838038,"Cảm biến áp suất lốp xe ô tô TPMS thông minh màn hình LCD màu, chạy bằng năng lượng mặt trời lắp van ngoài T3 ",372000,372000,0,0
TIKI,o-to-xe-may-xe-dap,105184045,"Combo Móc và Bao da khóa Yamaha Smartkey Grande, NVX, Janus, Nozza, Exciter 155",90250,90250,0,0
TIKI,o-to-xe-may-xe-dap,136009206,"Cảm biến áp suất lốp van ngoài ô tô xe hơi, Pin năng lượng mặt trời, Màn hình LCD màu hiển thị thông số",440000,440000,0,0
TIKI,o-to-xe-may-xe-dap,6974859,"Nước Rửa Xe Không Chạm Ekokemika Bio 25 (5L) - Hàng Chính Hãng",550000,550000,0,0
TIKI,o-to-xe-may-xe-dap,71100674,"Hộp để đồ đa năng gấp gọn để cốp sau ô tô, xe hơi cao cấp dung tích 30 lít",180000,180000,0,0
TIKI,o-to-xe-may-xe-dap,59557653,"Khăn lau ô tô chuyên dụng chống trầy xước Microfiber 3M 30x30cm Nhiều màu sắc",22000,22000,0,0
TIKI,o-to-xe-may-xe-dap,23010613,"Bảng Số Kiêm Giá Đỡ Điện Thoại Trên Taplo Xe Hơi",29999,29999,0,0
TIKI,o-to-xe-may-xe-dap,128957380,"Bộ Dụng Cụ 2 Bàn Chải Vệ Sinh Sên / Xích / Líp Xe Đạp Tiện Dụng",39000,45000,6000,13
TIKI,o-to-xe-may-xe-dap,174549619,"Mũ Bảo Hiểm Nửa Đầu Thời Trang SUNDY HP-01, Nón Bảo Hiểm Tem Bò Sữa Cute Nhiều Màu, An Toàn, Chất Lượng - Hàng Chính Hãng",105000,180000,75000,42
TIKI,o-to-xe-may-xe-dap,189535971,"Miếng dán PPF TPU hõm cửa xe ô tô chống xước tự hồi phục",110000,110000,0,0
TIKI,o-to-xe-may-xe-dap,2900861,"Bộ 2 găng tay lau rửa xe siêu mềm thấm hút tốt chuyên dụng cho ô tô xe máy (Màu ngẫu nhiên)",19000,19000,0,0
TIKI,o-to-xe-may-xe-dap,131337644,"Mẫu Túi Hành Lý Sau Xe Đạp - Túi Đôi Đựng Sau Xe Đựng Đồ dùng,Thiết Bị, hàng hóa(lựa mẫu)",125000,125000,0,0
TIKI,o-to-xe-may-xe-dap,111223259,"Máy Hút Bụi Xe Hơi Mini Cao Cao Cấp AIKESI 8001",322000,322000,0,0
TIKI,o-to-xe-may-xe-dap,10697900,"Búa Thoát Hiểm Cho Ô Tô",49000,49000,0,0
TIKI,o-to-xe-may-xe-dap,3162815,"Áo trùm xe máy họa tiết cao cấp",39000,39000,0,0
TIKI,o-to-xe-may-xe-dap,95306035,"Xe đạp địa hình Thống Nhất MTB 26-07 (Tặng kèm chắn bùn trước và sau) - Hàng chính hãng",3449000,3449000,0,0
TIKI,o-to-xe-may-xe-dap,117722638,"Khăn lau ô tô xe hơi 3M chất vải Microfiber màu vàng 2 lớp cao cấp siêu mịn siêu sạch siêu thấm hút",6000,19000,13000,68
TIKI,o-to-xe-may-xe-dap,20722132,"CẶP GƯƠNG CHIẾU HẬU GÙ TRÒN CÁN XOAY CRG GẮN NHIỀU LOẠI XE MÁY SIÊU ĐẸP - MÀU ĐEN ( 1 CHIẾC BÊN TRÁI ) LOẠI 1",90250,95000,4750,5
TIKI,o-to-xe-may-xe-dap,75705805,"Combo bảo dưỡng sên Megacools rửa sên 500ML+dưỡng sên 300ml  tặng bàn chải vệ sinh sên",165000,165000,0,0
TIKI,o-to-xe-may-xe-dap,53708717,"Combo Đèn Pha Xe Đạp LED Q5 Gắn Phía Trước Có Sạc USB Chống Nước Mini Siêu Sáng (Kèm Chân Đế Gắn Đèn Pin) Và Đèn LED Cảnh Báo Sau Xe Đạp 4 chế độ Mai Lee - Đèn Q5+ Led Xanh",104000,119000,15000,13
TIKI,o-to-xe-may-xe-dap,50573598,"Ghế Xe Đạp, Xe Điện cho Trẻ Em - màu ngẫu nhiên",132000,132000,0,0
TIKI,o-to-xe-may-xe-dap,274597343,"Bơm Hơi Hợp Kim Dùng Chân Cho Xe Máy , Xe Đạp NHONOR - Hàng Chính Hãng ( Tặng Kèm Kim Bơm Banh Và Bơm Thú Hơi )",164000,242000,78000,32
TIKI,o-to-xe-may-xe-dap,54021554,"Giá Đỡ Điện Thoại Trên Ô Tô, Kẹp điện thoại trên xe hơi, Kẹp giữ điện thoại trên xe hơi, giá đỡ ô tô, đế điện thoại xe hơi, giá treo điện thoại trên ô tô, phụ kiện di động trên xe hơi ( Màu Đỏ)",65000,65000,0,0
TIKI,o-to-xe-may-xe-dap,136596751,"Chống nghiêng inox 304 đặc cho Dream, Wave, Ex150, Sirius, AB 2010 và các loại xe - MSP:7474PO-TO-TJ",125000,125000,0,0
TIKI,o-to-xe-may-xe-dap,48141839,"Dụng cụ bơm hơi bánh xe đạp chân đa năng mini tiện dụng dùng cho xe đạp, xe máy - màu giao ngẫu nhiên",79000,79000,0,0
TIKI,o-to-xe-may-xe-dap,94725255,"Bộ camera căn lề không khoan gương + Màn hình LCD 4.3 inch cắm nguồn tẩu, tự lắp đặt trong vòng 5 phút",699000,699000,0,0
TIKI,o-to-xe-may-xe-dap,172067622,"Dung dịch NANO phục hồi nhựa nhám xe máy ô tô đẹp như mới siêu đậm đặc loại tốt",77000,85000,8000,9
TIKI,o-to-xe-may-xe-dap,136265463,"Nhớt Xe Số Motul 3000 Plus 4t 20w50 20x0.8l",105000,105000,0,0
TIKI,o-to-xe-may-xe-dap,84543545,"Tấm Phản Quang Gắn Baga Sau Xe đạp",19000,25000,6000,24
TIKI,o-to-xe-may-xe-dap,2050479,"Băng keo cường lực siêu dính 3M  4229P-20 20mm x10m",159000,159000,0,0
TIKI,o-to-xe-may-xe-dap,36601741,"Chai xịt tẩy rửa, bôi trơn và chống rỉ sét 310g 3M 5W",83000,83000,0,0
TIKI,o-to-xe-may-xe-dap,58911643,"2 túi thơm cà phê khử mùi, treo xe hơi (130gram x 2)",53000,53000,0,0
TIKI,o-to-xe-may-xe-dap,1219871,"Nhớt Ô Tô Cao Cấp Mobil Super 5000 5W30 SN  (5L)",550000,550000,0,0
TIKI,o-to-xe-may-xe-dap,191755621,"Chai phục hồi nhựa đen cho xe ô tô, dung dịch làm mới nhựa nhám thật hiệu quả, cho xế yêu của bạn luôn đen bóng như mới.",120000,120000,0,0
TIKI,o-to-xe-may-xe-dap,38510294,"Bộ 2 Gương Chiếu Hậu Tròn Lớn Cho Xe Đạp Thể Thao Địa Hình Xoay 360 Độ Giúp Đạp Xe An Toàn - Hàng Chính Hãng",79000,89000,10000,11
TIKI,o-to-xe-may-xe-dap,1254631,"Chai Vệ Sinh Động Cơ Và Hệ Thống Phun Xăng Cao Cấp Bluechem Fuel System Cleaner (250ml)",265000,265000,0,0
TIKI,o-to-xe-may-xe-dap,2646875,"Nước Rửa Xe Mẫu Mới Sumo Wash & Wax (1L)",69000,69000,0,0
TIKI,o-to-xe-may-xe-dap,163023757,"ỐP KHOÁ TOYOTA CAMRY  - CROSS -ALTIS",379000,379000,0,0
TIKI,o-to-xe-may-xe-dap,141513879,"Bộ Đổi Điện Sóng Sin Chuẩn, Bộ Kích Điện 12V Lên 220V Chuẩn Như Điện Lưới, inverter 12v 220v công suất 1000W 2000W 3000W",999000,999000,0,0
TIKI,o-to-xe-may-xe-dap,85801194,"túi hồ sơ xe - ví đựng giấy tờ xe ô tô mazda ",24800,24800,0,0
TIKI,o-to-xe-may-xe-dap,56031086,"Mũ Bảo Hiểm Fullface Bulldog Torii cổ điển",1500000,1500000,0,0
TIKI,o-to-xe-may-xe-dap,118297639,"Nâng cổ xe đạp địa hình bằng hợp kim nhôm",149000,149000,0,0
TIKI,o-to-xe-may-xe-dap,41502149,"Chai xịt chăm sóc và bảo dưỡng nội thất ô tô 3M 39040LT tặng khăn lau ô tô chuyên dụng 3M màu ngẫu nhiên",225000,225000,0,0
TIKI,o-to-xe-may-xe-dap,97829174,"Khóa xe máy chữ U inox chống trộm size nhỏ - Bảo vệ xe an toàn",89000,89000,0,0
TIKI,o-to-xe-may-xe-dap,21766582,"Bộ Gương Chiếu Hậu Rizoma 5 cạnh",134000,145000,11000,8
TIKI,o-to-xe-may-xe-dap,150494412,"Dung dịch đánh bóng phục hồi nhựa nhám xe máy ô tô như mới hàng cao cấp siệu đậm đặc",68000,68000,0,0
TIKI,o-to-xe-may-xe-dap,91173044,"Bộ chia tẩu sạc ô tô QC3.0 chia 4 cổng USB tẩu sạc ô tô",85000,85000,0,0
TIKI,o-to-xe-may-xe-dap,166208742,"Máy thiết bị quét đọc xóa lỗi xe hơi OBD2 ô tô wifi tex nhanh bản cao cấp , cách khắc phục đèn báo lỗi trên ô tô",269000,269000,0,0
TIKI,o-to-xe-may-xe-dap,3654231,"Đèn LED Trợ Sáng L5 Cho Xe Máy",52000,59000,7000,12
TIKI,o-to-xe-may-xe-dap,3871403,"Băng keo cường lực 3M 5952-5 size 12mmx5m",75000,75000,0,0
TIKI,o-to-xe-may-xe-dap,7816027,"Còi hú 3 chế độ cho xe máy oto",66000,75000,9000,12
TIKI,o-to-xe-may-xe-dap,131590590,"Miếng Dán Bảo Vệ Sườn Xe Đạp - Khung Xe Đạp - Chống Trầy Xước -  Chống Thấm Nước",25650,27000,1350,5
TIKI,o-to-xe-may-xe-dap,105742301,"Bộ sạc ắc quy 12v/24v 3AH - 200ah máy sạc bình xe máy ôtô xe tải thông minh tự động ngắt khi đầy",255000,255000,0,0
TIKI,o-to-xe-may-xe-dap,249418419," Bộ 2 đèn LED van bánh xe đạp, xe máy, ô tô ( Xanh Dương )",18600,18600,0,0
TIKI,o-to-xe-may-xe-dap,158774476,"Còi Điện Xe Đạp - Còi Điện Tử Gắn Tay Lái Chống Mưa Gắn Tay Lái Xe Đạp tặng kèm chuông xe đạp",95000,95000,0,0
TIKI,o-to-xe-may-xe-dap,253212043,"Khóa dây xe đạp 4 số chống trộm dài 1m5 tặng túi đựng treo xe - Khoá đa năng",75000,75000,0,0
TIKI,o-to-xe-may-xe-dap,58877049,"Bình Xịt Dưỡng Bóng Lốp Ô Tô Flamingo (500ml)",76000,84900,8900,10
TIKI,o-to-xe-may-xe-dap,107337725,"Nước Hoa Ô Tô Chính Hãng Nhập Khẩu Khử Mùi Xe Hơi Cao Cấp ETONNER E1701D (60ml)",1200000,1200000,0,0
TIKI,o-to-xe-may-xe-dap,71149087,"Miếng Đệm Lót Bao Yên Xe Đạp Rộng Cao Cấp Với Mút Mềm Foam Đàn Hồi, Bao Yên Silicon Gel Cho Xe Đạp Thể Thao Địa Hình MTB, Xe Đạp Leo Núi",170050,179000,8950,5
TIKI,o-to-xe-may-xe-dap,87534113,"Bộ Dụng Cụ Sửa Chữa Xe Đạp Di Động Bơm Lốp Đa Năng Mini Và Vá Săm Xe Đạp Gắn Sườn Xe (Dạng Bình Nước) MaiLee",299000,319000,20000,6
TIKI,o-to-xe-may-xe-dap,165675797,"Khăn Lau Đa Năng Khăn Lau Xe Ô Tô, Khăn Lau Tay, Khăn Lau Bếp Nhiều Size,  Nhiều Màu Ngẫu Nhiên",19000,19000,0,0
TIKI,o-to-xe-may-xe-dap,115478739,"Dung Dịch Phục Hồi Nhựa Nhám Plastic Remover 10ml Tặng Kèm Xốp - MSN388401",57900,57900,0,0
TIKI,o-to-xe-may-xe-dap,14381819,"Đèn led trang trí gầm đổi màu cho xe ô tô xe hơi - đèn led đổi nhạc",87000,87000,0,0
TIKI,o-to-xe-may-xe-dap,53626220,"Miếng Đệm Trợ Lực Tay Ga Chống Mỏi Cổ Tay",25000,25000,0,0
TIKI,o-to-xe-may-xe-dap,2589483,"Chai Xịt Rửa Sên Xe Máy Thunder MC-40 (400ml)",53000,53000,0,0
TIKI,o-to-xe-may-xe-dap,4893545,"Máy bơm lốp xe hơi, ô tô, xe máy đạp chân",69900,69900,0,0
TIKI,o-to-xe-may-xe-dap,63860106,"Khánh Liên Hoa Trang Trí Xe Hơi , Dây Treo Sen Gỗ Hoàng Dương Trang Trí Ô Tô",215000,215000,0,0
TIKI,o-to-xe-may-xe-dap,54046823,"Set 2 Khăn Lau Xe Hơi, Xe Ô Tô, Xe Máy Đa Năng, Kích Thước 30x60cm và 30x30cm, Thấm Hút Tốt Màu Sắc Ngẫu Nhiên",35000,35000,0,0
TIKI,o-to-xe-may-xe-dap,146577316," Cốc sạc ô tô, Tẩu sạc nhanh điện thoại tự ngắt thông minh Qualcom 3.0 4 cổng USB 12v-24v mẫu mới cho các xe",69000,69000,0,0
TIKI,o-to-xe-may-xe-dap,25914840,"Ví đựng giấy tờ ô tô có logo theo xe,logo hyundai",23000,23000,0,0
TIKI,o-to-xe-may-xe-dap,34701184,"Chai xịt vệ sinh máy điều hòa (máy lạnh) Sandokkaebi 330ml nhập khẩu trực tiếp từ Hàn Quốc",99000,99000,0,0
TIKI,o-to-xe-may-xe-dap,192807451,"Dụng cụ vệ sinh sên / xích xe đạp cao cấp Hatsu FL14- Kiêm Dụng Cụ Tra Nhớt Sên/Xích - dòng cao cấp - hàng chính hãng",125400,132000,6600,5
TIKI,o-to-xe-may-xe-dap,91630190,"Gối Tựa Lưng Ghế Văn Phòng Ghế Ô Tô Vỏ Bằng Vải Lưới Có Đai Cài Và Viền Sang Trọng Backrest Pillow",318250,335000,16750,5
TIKI,o-to-xe-may-xe-dap,196177019,"Ốp Chìa Khóa Xe KIA K3 2021 - 2022 K5 Sportage 22 Sorento Cerato Hợp Kim Kẽm",209000,219000,10000,5
TIKI,o-to-xe-may-xe-dap,88053584,"Matít (bột trét) Morolac Polyester Putty 1Kg",95000,95000,0,0
TIKI,o-to-xe-may-xe-dap,171502562,"Combo 2 Móc Treo Đồ Chữ S Gắn Sau Ghế Ô Tô Xe Hơi Tiện Lợi - Chịu Lức Đến 20 KG",30400,32000,1600,5
TIKI,o-to-xe-may-xe-dap,162217847,"Ắc quy khô miễn bảo dưỡng Đồng Nai PTX5L | 12V - 3,5Ah",227000,227000,0,0
TIKI,o-to-xe-may-xe-dap,82458195,"Flash Sale Khay Để Đồ Chèn Khe Ghế Ô Tô, Giá Để Đồ Chèn Khe Ghế, Hộp Đựng Đồ Xe Ô Tô, Bọc Da PU Cao Cấp",125000,125000,0,0
TIKI,o-to-xe-may-xe-dap,72050492,"Bộ 2 Gương Lồi Car365 Xoay 360 độ Gắn Cho Kính Gương Chiếu Hậu Tránh Điểm Mù Cho Xe Hơi, Xe Ô tô - Hàng Chính Hãng",39000,39000,0,0
TIKI,o-to-xe-may-xe-dap,116853216,"Bộ sạc điện thoại gắn trên Mô tô, xe máy, xe đạp điện 2.1A 206668 F ",44900,44900,0,0
TIKI,o-to-xe-may-xe-dap,31847215,"Dầu Bôi Trơn Chống Rỉ Sét Làm Sạch Thẩm Thấu Chống Ẩm Bảo Vệ WD-40 (412ml)",130000,130000,0,0
TIKI,o-to-xe-may-xe-dap,77967952,"Keo dán xe máy, 5 Mét keo trong dán xe, dán điện thoại, keo siêu dính, bền bỉ, , có độ dẻo dai và đàn hồi",105000,105000,0,0
TIKI,o-to-xe-may-xe-dap,16868657,"Tem Decal Phản Quang Dán Dè Chắn Bùn Xe Máy Thể Thao Cao Cấp AZONE",32000,35000,3000,9
TIKI,o-to-xe-may-xe-dap,87830999,"Máy Hút Bụi Và Bơm Lốp Ô Tô - Công Suất 120W 4 in 1 Bơm/Hút/Đèn Chiếu Sáng/Đồng Hồ Đo Áp Suất Lốp - K1014",265850,265850,0,0
TIKI,o-to-xe-may-xe-dap,150494169,"Sáp dung dịch đánh bóng vết xước ô tô xe máy như mới loại tốt",99000,99000,0,0
TIKI,o-to-xe-may-xe-dap,80624267,"Pedal bàn đạp xe đạp có thể xếp gọn",120000,120000,0,0
TIKI,o-to-xe-may-xe-dap,107075129,"Ống Nâng Tay Lái Xe Đạp Bằng Nhôm Cao 12cm Phù hợp Ống trong phi 28,6mm Điều Chỉnh Độ Cao Ghi Đông Xe Đạp MaiLee",149000,169000,20000,12
TIKI,o-to-xe-may-xe-dap,80877051,"Sú.ng xịt rửa cao áp kiểu dài 86cm cho máy rửa xe Bos.ch, Bos.ch- AQT(HÀNG OEM)",295000,295000,0,0
TIKI,o-to-xe-may-xe-dap,74429077,"[Tặng Bộ Đồ Bảo Hộ 6 Món Cho Bé] Mũ Bảo Hiểm Xe Đạp Trẻ Em, Nón Bảo Hiểm Chơi Thể Thao, Trượt Patin Cao Cấp Protec Smile W024 - Hàng Chính Hãng",338000,438000,100000,23
TIKI,o-to-xe-may-xe-dap,25191981,"Súc béc xăng vệ sinh ô tô 300ml",160000,160000,0,0
TIKI,o-to-xe-may-xe-dap,32428499,"Găng tay sợi mịn lau, rửa xe cao cấp",16000,16000,0,0
TIKI,o-to-xe-may-xe-dap,96704994,"Vòi bơm hơi thay thế bơm đạp chân Honor và BMB [AMT]",38000,38000,0,0
TIKI,o-to-xe-may-xe-dap,68524327,"Chân đế kẹp đèn pin, đèn pha gắn ghi đông cho Xe Đạp (chất liệu Nhựa ABS, không kèm đèn pin) chắc chắn, xoay 360 độ dễ dàng lắp đặt Mai Lee",8550,9000,450,5
TIKI,o-to-xe-may-xe-dap,162530446,"Combo 2 Chiếc Dụng Cụ Kéo Sửa Vết Lõm Xe Ô Tô Dụng Cụ Hút Tháo Bảng Điều Khiển Thân Xe, Dụng Cụ Loại Bỏ Vết Lõm Sửa Chữa",85000,85000,0,0
TIKI,o-to-xe-may-xe-dap,21598538,"Relay Còi Ô Tô 12V 4 Chân Nhật Xịn",49000,49000,0,0
TIKI,o-to-xe-may-xe-dap,11741161,"Chổi Lau Xe  Ô Tô Sợi Dầu,  Điều Chỉnh Được Độ Dài - Tròn ( Có Túi Đựng )",49000,52000,3000,6
TIKI,o-to-xe-may-xe-dap,64043014,"NƯỚC RỬA XE KHÔNG CHẠM CHUYÊN DỤNG  [1 Lít] ",99000,109000,10000,9
TIKI,o-to-xe-may-xe-dap,19737606,"Túi tam giác gắn sườn xe đạp (size L gắn được bình nước)",125000,125000,0,0
TIKI,o-to-xe-may-xe-dap,16094270,"Bộ vá lụi (vá ngoài) dùng cho lốp không xăm xe hơi và xe máy",18090,18090,0,0
TIKI,o-to-xe-may-xe-dap,23228335,"Combo 2 Túi than hoạt tính khử mùi trong ô tô, phòng ngủ, nhà bếp",35000,35000,0,0
TIKI,o-to-xe-may-xe-dap,90640998,"Bộ sạc xe đạp điện 48V 12AH",162500,162500,0,0
TIKI,o-to-xe-may-xe-dap,92154112,"Cáp Sạc, Dây Nguồn Camera Hành Trình Mini USB Dài 3.5m",99000,99000,0,0
TIKI,o-to-xe-may-xe-dap,146663540,"Thảm taplo da vân cacbon cho xe Honda City 2016-2020",185250,195000,9750,5
TIKI,o-to-xe-may-xe-dap,125818443,"Bộ vào xéc măng piston",271000,400000,129000,32
TIKI,o-to-xe-may-xe-dap,74598199,"BÌNH XỊT PHỦ BÓNG SƠN XE G-20  [511ml]",119000,129000,10000,8
TIKI,o-to-xe-may-xe-dap,14656137,"Nhớt Xe Số Motul H-Tech 100 4T 10W40 12x1l Vn (1L)",209000,209000,0,0
TIKI,o-to-xe-may-xe-dap,108937941,"Nón bảo hiểm Royal M139 Kính Âm Trơn Sành Điệu, Trẻ Trung, Thời Thượng",700000,700000,0,0
TIKI,o-to-xe-may-xe-dap,128123890,"Bộ 2 Vè che mưa gương chiếu hậu ô tô hạn chế nước mưa đọng vào gương, gia tăng tầm nhìn TÂM LUÂN Chổi lau tẩm dầu - Hàng chính hãng",30000,50000,20000,40
TIKI,o-to-xe-may-xe-dap,13611860,"Thảm cao su lót chân xe cho xe Vision",28000,28000,0,0
TIKI,o-to-xe-may-xe-dap,163842715,"Bạt Trùm Xe Máy Vải Dù Chống Thấm Siêu Bền, Trùm Được Tất Cả Các Đời Xe Máy - Áo trùm xe (Nhiều màu)",105000,105000,0,0
TIKI,o-to-xe-may-xe-dap,74385617,"Cây chống nâng yên xe máy tự động",46500,46500,0,0
TIKI,o-to-xe-may-xe-dap,58706399,"Cảm Biến Áp Suất Lốp  Ô Tô Van Ngoài CAR365TMS01 Chính Hãng",329000,329000,0,0
TIKI,o-to-xe-may-xe-dap,53708171,"Đèn Pha Gắn Phía Trước Xe Đạp Siêu Sáng Sạc Điện USB Chống Nước (Bản Nâng Cấp Kèm Chân Đế Trượt) Mai Lee",120000,149000,29000,19
TIKI,o-to-xe-may-xe-dap,55129703,"Mũ Bảo hiểm nửa đầu Bulldog Pug đủ màu",679000,679000,0,0
TIKI,o-to-xe-may-xe-dap,126707966,"Dung dịch phun khói khử mùi ô tô xe hơi Nano Xclean For Horeca 5 Lít Dùng Cho Máy Phun Khói Khử Khuẩn-Diệt Khuẩn Khử Mùi Nhà Hàng, khách sạn, karaoke, ô tô, Bếp-Nano Bạc AHTC",475200,792000,316800,40
TIKI,o-to-xe-may-xe-dap,113966974,"COMBO 3 Túi thơm hạt cà phê treo xe ô tô, tủ quần áo, phòng khách, phòng bếp khử mùi ẩm mốc",57999,57999,0,0
TIKI,o-to-xe-may-xe-dap,48898243,"Đèn Trợ Sáng Dành Cho Xe Máy LeD BulB L4 - CYT (Có Pát, Ốc Vít Và Công Tắc) ",49000,49000,0,0
TIKI,o-to-xe-may-xe-dap,90326089,"Ba lô Treo Trước Xe Đạp Gắn Ghi Đông Xe Đạp Cho Du Lịch Đạp Xe Cất Trữ Phụ Kiện MaiLee ",217550,229000,11450,5
TIKI,o-to-xe-may-xe-dap,150954569,"Nút cao su giảm chấn cánh cửa ô tô ,có dạ quang phát sáng đệm silicon chống va đập giảm tiếng ồn bảo vệ cửa, capo, cốp xe",9000,9000,0,0
TIKI,o-to-xe-may-xe-dap,70815706,"Lót ghế và tựa lưng hạt gỗ ô tô văn phòng massage cao cấp chống nóng hiệu quả",330600,348000,17400,5
TIKI,o-to-xe-may-xe-dap,113404575,"Bộ 04 Chắn Bùn Cho Xe Ô Tô Toyota Vios",132000,132000,0,0
TIKI,o-to-xe-may-xe-dap,21903345,"Combo 3 Khăn Rửa Xe Siêu Dầy 70x30 - 80g",50200,50200,0,0
TIKI,o-to-xe-may-xe-dap,16147531,"Mũ Bảo Hiểm Nửa Đầu Có Kính SUNDA 136A",265000,265000,0,0
TIKI,o-to-xe-may-xe-dap,83347203,"Nón bảo hiểm ANDES 109 có kính đi xe máy chính hãng",422000,500000,78000,16
TIKI,o-to-xe-may-xe-dap,53550107,"Đèn Pin Gắn Phía Trước Cho Xe Đạp Siêu Sáng Q5 Phóng Zoom To, Nhỏ Có Sạc Điện USB Chống Nước (kèm Chân Đế Gắn Đèn Pha) Giúp Đạp Xe Ban Đêm Mai Lee",94050,99000,4950,5
TIKI,o-to-xe-may-xe-dap,73515888,"Hộp đựng khăn giấy hình thú nhồi bông dễ thương , hộp đựng khăn giấy sáng tạo trên ô tô",189050,199000,9950,5
TIKI,o-to-xe-may-xe-dap,45354917,"Dây cáp khóa xe máy, xe đạp bọc nhựa chắc chắn tiện lợi",32975,32975,0,0
TIKI,o-to-xe-may-xe-dap,132352332,"Decan sticker chữ Diesel Only 12x12cm",18000,20000,2000,10
TIKI,o-to-xe-may-xe-dap,83347589,"Lót nón bảo hiểm 3/4 Royal M139 gồm 1 lót và 2 ốp tai phiên bản mới",116000,150000,34000,23
TIKI,o-to-xe-may-xe-dap,34845206,"Nước rửa xe bọt tuyết Car Shampoo 5 lít cho ô tô xe máy ",135000,135000,0,0
TIKI,o-to-xe-may-xe-dap,170075709,"Bao da dành cho chìa khoá Toyota Veloz 2022, AVANZA 2022 handmade da thật 011",200000,200000,0,0
TIKI,o-to-xe-may-xe-dap,112363205,"Sạc Điện Thoại Trên Xe Máy",43400,43400,0,0
TIKI,o-to-xe-may-xe-dap,50255242,"Nón bảo hiểm 3/4 kính âm Royal M139 Vàng Cam Nhám tem V7 Cafe Racer cao cấp Lót tháo rời, che hết mặt",525000,525000,0,0
TIKI,o-to-xe-may-xe-dap,115622558,"Cuộn nẹp mạ Chrome dán trang trí viền chân kính ô tô xe hơi dài 15M",53910,53910,0,0
TIKI,o-to-xe-may-xe-dap,118089405,"Bộ 2 đèn led gắn van bánh xe đạp, xe máy",24200,24200,0,0
TIKI,o-to-xe-may-xe-dap,32979033,"Bình dầu tay thắng BẢO LONG RACING",45000,45000,0,0
TIKI,o-to-xe-may-xe-dap,126960262,"1 Đèn USB Nội Thất Xe Hơi Ô tô mini - Đèn LED USB Trang Trí Xe hơi  Ô tô (Size: 2x15x08cm)",35000,35000,0,0
TIKI,o-to-xe-may-xe-dap,5348189,"Baga sau ngắn dành cho xe wave 110 ",104000,104000,0,0
TIKI,o-to-xe-may-xe-dap,20723261,"CẶP GƯƠNG CHIẾU HẬU GÙ TRÒN CÁN XOAY CRG GẮN NHIỀU LOẠI XE MÁY SIÊU ĐẸP - MÀU VÀNG ĐEN ĐEN ( 1 CHIẾC BÊN TRÁI ) LOẠI 1",80750,85000,4250,5
TIKI,o-to-xe-may-xe-dap,84883244,"Nón Bảo Hiểm Xe Đạp Thể Thao Hiện Đại, Siêu Phẩm Mũ Bảo Hiểm Xe Đạp Sang Trọng Protec Win 069, Size L Cho Vòng Đầu Từ 58 - 61cm - Hàng Chính Hãng",599000,780000,181000,23
TIKI,o-to-xe-may-xe-dap,119962942,"Bình đun nước trên ô tô nguồn 12V và 24V inox thép không gỉ",210000,210000,0,0
TIKI,o-to-xe-may-xe-dap,147855004,"Chổi Lau Xe Ô Tô, Xe Tải Xe Khách Làm Bằng Sợi Quang Dầu, Điều Chỉnh Được Độ Dài – Bộ Chổi Lau Bụi Xe Ô Tô Kèm Túi Đựng Cao Cấp Chính Hãng Dododios",69000,69000,0,0
TIKI,o-to-xe-may-xe-dap,44072283,"Củ sạc nhanh QC3.0 dành cho ô tô 4 cổng sạc",109000,109000,0,0
TIKI,o-to-xe-may-xe-dap,12252211,"Bơm lốp đạp chân xe máy xe đạp và cả ô tô",220000,220000,0,0
TIKI,o-to-xe-may-xe-dap,10116626,"Chai xịt vệ sinh hệ thống điều hòa ô tô 3M 3M-ACC (250ml)",170000,175000,5000,3
TIKI,o-to-xe-may-xe-dap,8090579,"Nước Rửa Kính FOCAR Screen Wash 2.75L",97000,119000,22000,18
TIKI,o-to-xe-may-xe-dap,50739908,"Bộ nhông sên dĩa xe Honda Wave RS / Wave A / Wave RSX / Wave S / Future Neo / Blade",290000,290000,0,0
TIKI,o-to-xe-may-xe-dap,105328552,"Combo 2 can Nước rửa xe bọt tuyết chuyên dụng Car Shampoo 5L cho ô tô xe máy",255000,255000,0,0
TIKI,o-to-xe-may-xe-dap,173691197,"Combo Che Pô Xe WINNER V1 + Đít pô / Đuôi pô",80000,80000,0,0
TIKI,o-to-xe-may-xe-dap,87706942,"Thùng nhựa đựng đồ cho cốp xe ô tô có thể gấp xếp gọn có chốt gài | 30L + 55L + túi chống nước",175000,175000,0,0
TIKI,o-to-xe-may-xe-dap,176450514,"Chai xịt dạng bọt làm sạch bảo vệ khoang máy động cơ ô tô chuyên dụng Liqui Moly 21277 - Chống oxy hóa và ăn mòn, chống tĩnh điện, dùng được nhiều bề mặt, không để lại vết ố",158000,158000,0,0
TIKI,o-to-xe-may-xe-dap,57647330,"Kính chiếu hậu TRÒN xe tay ga kiểu ves-pa - 1 bên trái ",99000,99000,0,0
TIKI,o-to-xe-may-xe-dap,83347915,"Nón bảo hiểm nửa đầu ANDES có kính 126K chính hãng",424000,450000,26000,6
TIKI,o-to-xe-may-xe-dap,87961245,"Tấm chắn che nắng Ô TÔ Xe Hơi - Phụ kiện chắn tia UV bảo vệ xe - Dù che nắng - Tấm hắt nắng chụp hình",129000,250000,121000,48
TIKI,o-to-xe-may-xe-dap,186621755,"Vietmap AP1 Máy lọc Không khí ô tô - Khử mùi iON -Diệt khuẩn- Lọc bụi PM2.5 - Tận hưởng cuộc sống xanh - Hàng Chính Hãng",1660000,1660000,0,0
TIKI,o-to-xe-may-xe-dap,22258742,"Phụ kiện đựng chai nước trên xe hơi",38934,72000,33066,46
TIKI,o-to-xe-may-xe-dap,32135232,"Sạc bình ắc quy 12V 2A tự ngắt khi đầy 4-20Ah (Đen)",59000,59000,0,0
TIKI,o-to-xe-may-xe-dap,50386528,"Bộ 2 phụ gia xăng 33017 và nhớt 33027 cao cấp cho xe máy Bluechem - 33017_33027",149000,149000,0,0
TIKI,o-to-xe-may-xe-dap,95071251,"Kẹp Gắn Đèn Pin ML10 Xe Đạp Gắn Ghi Đông Tay Lái Xoay 360 Độ Chắc Chắn Mai Lee (không kèm đèn pin)",56050,59000,2950,5
TIKI,o-to-xe-may-xe-dap,75622991,"Bút xóa vết trầy xước sơn ô tô xe máy",17000,17000,0,0
TIKI,o-to-xe-may-xe-dap,74912599,"Megacools Ultra Lube MOLY WAX 300ml - Xịt bảo dưỡng sên siêu cao cấp, chống vắng, chống rít,chống kêu sên",80000,80000,0,0
TIKI,o-to-xe-may-xe-dap,55193006,"Mũ bảo hiểm 3/4 Bulldog POM",1099000,1099000,0,0
TIKI,o-to-xe-may-xe-dap,14656147,"Nhớt Xe Tay Ga Motul Scooter Power Le 4t 5w40 20x0.8l Vn (800ml)",165000,165000,0,0
TIKI,o-to-xe-may-xe-dap,54902025,"Mũ Bảo Hiểm Xe Đạp Thời Trang, Nón Bảo Hiểm Xe Đạp Thể Thao Cao Cấp Protec Win 037 Thiết Kế Thông Minh, An Toàn, Siêu Nhẹ - Hàng Chính Hãng",389000,498000,109000,22
TIKI,o-to-xe-may-xe-dap,59355732,"Máy lọc không khí thông minh dùng trên xe hơi FujiE AP100",850000,1700000,850000,50
TIKI,o-to-xe-may-xe-dap,2220389,"Ghế ngồi oto cho bé, ghế giữ bé trên ô tô, ghế ngồi ô tô màu ngẫu nhiên",135000,135000,0,0
TIKI,o-to-xe-may-xe-dap,67632864,"Màn rèm che nắng hít nam châm dán cửa ô tô xe hơi, rèm vải dầy 2 lớp cản sáng mẫu hoạt hình dễ thương - Hàng chính hãng",128000,128000,0,0
TIKI,o-to-xe-may-xe-dap,55981934,"Hộp Đựng Khăn Giấy Da Cao Cấp Trên Xe Ô Tô",179000,179000,0,0
TIKI,o-to-xe-may-xe-dap,53706056,"Ổ Khóa 8 Cạnh Dành Cho Xe Dream 50cc 100cc Các Đời (Bộ Có Khóa Yên)",151050,159000,7950,5
TIKI,o-to-xe-may-xe-dap,20845674,"Khóa dây Master Lock 8143",125000,125000,0,0
TIKI,o-to-xe-may-xe-dap,51697825,"Lọ Xịt Khử Mùi Nội Thất Ô Tô Hương Cà Phê Hàn Quốc",59850,63000,3150,5
TIKI,o-to-xe-may-xe-dap,58407886,"Bộ Chuyển Nguồn 12V ra 220V Dùng Trên Ô Tô Công Suất 150W với 2 Cổng Sạc USB 1A và 2.1A AnZ",436050,459000,22950,5
TIKI,o-to-xe-may-xe-dap,97763540,"Bạt phủ che nóc xe ô tô, xe hơi, 3 lớp tráng nhôm cách nhiệt, chống nắng, chống xước, chống cháy",189999,189999,0,0
TIKI,o-to-xe-may-xe-dap,24792574,"Găng Tay Xe Máy Oakley Dài Ngón",92000,92000,0,0
TIKI,o-to-xe-may-xe-dap,146256721,"SIÊU SÁNG VỚI 1 BÓNG ĐÈN PHA LED 3 TIM KIỂU ĐUÔI CÔNG LẮP XE MÁY XE HƠI ÔTÔ HÀNG CHUẨN SÁNG",179000,179000,0,0
TIKI,o-to-xe-may-xe-dap,22670599,"Đèn led xe đạp chống nước- Hati1",29000,29000,0,0
TIKI,o-to-xe-may-xe-dap,21612450,"Bugi Sấy 12V GM4(Dài)-9.5cm",19000,19000,0,0
TIKI,o-to-xe-may-xe-dap,20006398,"Chong chóng doremon gắn mũ bảo hiểm siêu cute",9000,9000,0,0
TIKI,o-to-xe-may-xe-dap,10784564,"Đồng hồ đo áp suất lốp ô tô xe máy điện tử R6802",88000,88000,0,0
TIKI,o-to-xe-may-xe-dap,68837160,"Gối Tựa Lưng Ghế Văn Phòng, Ghế Ô Tô Bằng Cao Su Non Giảm Đau Mỏi Lưng Mẫu Mới",413250,435000,21750,5
TIKI,o-to-xe-may-xe-dap,172842689,"Đệm điều chỉnh dây đai an toàn cho trẻ trên ô tô",25000,25000,0,0
TIKI,o-to-xe-may-xe-dap,21921069,"Khóa đĩa có báo động chống trộm Alarm Disc Lock NC303",213000,213000,0,0
TIKI,o-to-xe-may-xe-dap,4136669,"Túi đựng đồ treo sau ghế xe ô tô",215000,215000,0,0
TIKI,o-to-xe-may-xe-dap,22477937,"Bộ Chia tẩu sạc, Adapter Sạc Huyndai HY - I0 Cao cấp",115000,115000,0,0
TIKI,o-to-xe-may-xe-dap,114695617,"Thùng đựng đồ ô tô - gấp gọn đa năng 56 lít cao cấp",280000,280000,0,0
TIKI,o-to-xe-may-xe-dap,169098710,"Mũ Bảo Hiểm Nửa Đầu Kính Âm SRT - Nón Bảo Hiểm Chính Hãng Cao Cấp",249000,249000,0,0
TIKI,o-to-xe-may-xe-dap,20146496,"Găng tay xe máy, xe đạp có đệm bảo vệ tay Xanh Trắng",99000,99000,0,0
TIKI,o-to-xe-may-xe-dap,87457129,"Giá Treo Bình Nước Xe Đạp Có Điều Chỉnh Tiện Lợi Cho Xe Đạp Thể Thao, MTB (Không kèm ốc vít) MaiLee",46000,59000,13000,22
TIKI,o-to-xe-may-xe-dap,115935630,"Bộ 2 Ty Gác Chân Sau Xe Đạp Chất Liệu Nhôm (đường kính lỗ 1cm) cho xe đạp MTB, xe địa hình chống trượt, chắc chắn Mai Lee",75000,79000,4000,5
TIKI,o-to-xe-may-xe-dap,114685134,"Màn hình hắt kính HUD M8 hiển thị tốc độ và cảnh báo ô tô xe hơi cắm cổng OBD2",410000,415000,5000,1
TIKI,o-to-xe-may-xe-dap,141582530,"Máy hút bụi cao cấp cho ô tô nguồn 12v Michelin ML204 - độ ồn thấp, máy gọn nhẹ, nhiều đầu hút, công xuất cao",759050,799000,39950,5
TIKI,o-to-xe-may-xe-dap,159394883,"Bộ chụp ốc ( 58 - 60 con ) gắn cho các loại xe máy , xe điện",33000,33000,0,0
TIKI,o-to-xe-may-xe-dap,35965768,"Giá đỡ bình nước xe đạp Jett",90000,90000,0,0
TIKI,o-to-xe-may-xe-dap,22084392,"CHAI XỊT DƯỠNG LÀM BÓNG VÀ BẢO VỆ BỀ MẶT GỖ, NHỰA, CAO SU, DA NỘI THẤT XE SONAX 380041 300ML",210000,210000,0,0
TIKI,o-to-xe-may-xe-dap,97822196,"Ô che nắng, kiêm chắn nắng kính lái ô tô đa năng 2 trong 1. Chống nắng nóng và tia UV MÃ ZYS",80000,96000,16000,17
TIKI,o-to-xe-may-xe-dap,53351883,"Kính mũ bảo hiểm SUNDA CA-110 loại dài gắn cho các mũ có 3 khuy bấm trên đầu",129000,129000,0,0
TIKI,o-to-xe-may-xe-dap,64266130,"Bộ 2 thanh gạt nước mưa ô tô Nano xương mềm cao cấp hãng xe Chevrolet, Daewoo",127000,127000,0,0
TIKI,o-to-xe-may-xe-dap,54680124,"Hộp tỳ tay theo xe dành cho xe Mitsubishi Xpander",359000,378000,19000,5
TIKI,o-to-xe-may-xe-dap,119719201,"Ắc Quy LONG WP5-6 6V-5AH Bình ắc quy khô 6V cho xe điện trẻ em ,đèn khẩn cấp,quạt sạc",130000,130000,0,0
TIKI,o-to-xe-may-xe-dap,15292948,"Bao Da Chìa Khóa Ô Tô Hyundai Grand I10 Da Bò Dạng Hộp",241530,249000,7470,3
TIKI,o-to-xe-may-xe-dap,76204670,"Tinh dầu thơm pha nhớt xe 2 thì - Phụ gia pha nhớt xe Yazz , Xipo , Novaa Green Networks Group",139000,139000,0,0
TIKI,o-to-xe-may-xe-dap,56629175,"Máy Đo Chất Lượng Pin - Ác Quy - YR1035+ Nguồn 0-100V Kiểm Tra Dòng Xả Pin Ác Quy Chính Xác 99.9%",949000,949000,0,0
TIKI,o-to-xe-may-xe-dap,52980205,"Bình xịt vệ sinh máy điều hòa Mr Mckenic Air-Conditioner Cleaner",179000,190000,11000,6
TIKI,o-to-xe-may-xe-dap,101778165,"Đế cao su bọc chân chống cổ dê loại tốt, đế dày, nhựa siêu bền",12000,12000,0,0
TIKI,o-to-xe-may-xe-dap,42662455,"Bảng Hiện Số Điện Thoại Khi Đỗ Xe Ôtô",25000,25000,0,0
TIKI,o-to-xe-may-xe-dap,28468463,"CHAI XỊT VỆ SINH KÍNH Ô TÔ, KÍNH XE ĐA DỤNG 3M GLASS CLEANER 500ML 305921",119000,119000,0,0
TIKI,o-to-xe-may-xe-dap,85170993,"Nhớt xe số cao cấp Repsol Moto MXR 7 4T 10W40 1L (Mẫu Mới}",119000,119000,0,0
TIKI,o-to-xe-may-xe-dap,55459653,"Bọc vô lăng ô tô Sparco cao cấp - SPC103RDS",399000,399000,0,0
TIKI,o-to-xe-may-xe-dap,22887539,"Dè cater chắn bùn dành cho xe Winner ",98934,98934,0,0
TIKI,o-to-xe-may-xe-dap,48595001,"Túi Than Hoạt Tính Lọc Không Khí Diệt Khuẩn Khử Mùi Giảm Sóng Điện Từ Cho Ô Tô",179000,179000,0,0
TIKI,o-to-xe-may-xe-dap,214608000,"Bơm hơi đạp chân xe máy ô tô đa năng 2 pitton",226000,250000,24000,10
TIKI,o-to-xe-may-xe-dap,102654782,"Ô Che Nắng Kính Lái Xe Ô Tô Cao Cấp – Bảo Vệ Nội Thất Ô Tô – Dù Che Nắng Kính Lái Xe Hơi – Chống Tia UV",82000,118000,36000,31
TIKI,o-to-xe-may-xe-dap,151685056,"Bạt trùm che phủ xe ô tô Honda CITY chuẩn 3 Lớp Cao Cấp Chống Nắng Nóng Nước Mưa Cháy Chống Bụi",261000,308000,47000,15
TIKI,o-to-xe-may-xe-dap,74568066,"Dây Quấn Ghi Đông Xe Đạp Cuộc (2 Cuộn/ bộ) Giả Vân Carbon Chống Nước Mai Lee",99000,119000,20000,17
TIKI,o-to-xe-may-xe-dap,15261794,"Bao Da Chìa Khóa Ô Tô Mitsubishi Outlander 3 Nút Da Bò Dạng Hộp",234000,249000,15000,6
TIKI,o-to-xe-may-xe-dap,52488148,"thùng giữa dành cho xe winner 150",188000,188000,0,0
TIKI,o-to-xe-may-xe-dap,58801113,"Tem dán cửa xe ô tô WRC",79000,79000,0,0
TIKI,o-to-xe-may-xe-dap,37874082,"Bộ dây câu bình ắc quy ô tô, xe hơi dài 4m dòng 2000A (2000AMP)",99000,99000,0,0
TIKI,o-to-xe-may-xe-dap,155100353,"Mũ Bảo Hiểm B'color Nửa Đầu Màu Đen Có Chữ Noise Loại Nửa Đầu Kèm Kính Thời Trang",280000,280000,0,0
TIKI,o-to-xe-may-xe-dap,119308981,"Sáp thơm khử mùi giảm SAY XE ô tô Hando 230g",49000,49000,0,0
TIKI,o-to-xe-may-xe-dap,22754498,"Bộ 2 Lò Xo Hỗ Trợ Nâng Cốp Cho Xe Ô Tô Sedan - Giao Màu Ngẫu Nhiên",49000,49000,0,0
TIKI,o-to-xe-may-xe-dap,160289549,"Gối Tựa Đầu Vải Da Gài Cổ Ghế Ô Tô",38000,38000,0,0
TIKI,o-to-xe-may-xe-dap,193564860,"Nút PVC hút chân không gắn cửa kính xe hơi để gắn miếng che nắng NQC01",18000,25000,7000,28
TIKI,o-to-xe-may-xe-dap,58969670,"Bao Da Chìa Khóa Ô Tô Handmade dành cho Vinfast LUX A2.0 / SA2.0 Da Bò",290030,299000,8970,3
TIKI,o-to-xe-may-xe-dap,80850635,"Dây treo xe ô tô phật Quan Âm phong thủy may mắn bình an, mặt đá thủy tinh, dây obsidian",283100,298000,14900,5
TIKI,o-to-xe-may-xe-dap,11709658,"Combo 2 Chai Nước Rửa Ô Tô Xe Máy Bọt Tuyết 1L",79000,79000,0,0
TIKI,o-to-xe-may-xe-dap,56003258,"Khóa Xe Đạp, Xe Máy Chống Trộm - Khóa Dây 5 Mã Bảo Mật",53788,53788,0,0
TIKI,o-to-xe-may-xe-dap,131338743,"Túi treo đằng trước chống nước ghi đông xe đạp-Màu Đen",55000,55000,0,0
TIKI,o-to-xe-may-xe-dap,175215137,"Pas sắt bảng tên Raider Satria",55000,55000,0,0
TIKI,o-to-xe-may-xe-dap,787926,"Mũ Bảo Hiểm GRS A102K - Xanh Nhám Line Xanh",279000,279000,0,0
TIKI,o-to-xe-may-xe-dap,189556560,"Nước rửa kính ô tô siêu sạch đậm đặc INOCY bình 2L",39000,39000,0,0
TIKI,o-to-xe-may-xe-dap,132886969,"Đèn LED lùi xe hơi T15 chip 2835 Canbus T152835-15",35000,35000,0,0
TIKI,o-to-xe-may-xe-dap,32161648,"Sạc bình ắc quy 12V 24V 4-150Ah có chức năng khử sunfat phục hồi bảo dưỡng ắc quy",265000,265000,0,0
TIKI,o-to-xe-may-xe-dap,154135319,"Bao Da dành cho Chìa Khoá KIA Seltos 2021 2022, Sonet luxury, Premium logo KIA mới 006 B",199000,199000,0,0
TIKI,o-to-xe-may-xe-dap,56255757,"Quạt Sắt 4 Cánh Mini Có Kẹp Treo Xe Ô Tô Siêu Chắc Chắn SDLG",249000,249000,0,0
TIKI,o-to-xe-may-xe-dap,84870178,"Kem phủ bóng PALLAS NANO Polish Cream 250g - dùng đánh bóng xe máy, ô tô, bóng nhựa, da, simili, hạn chế bám bụi",49000,49000,0,0
TIKI,o-to-xe-may-xe-dap,170679511,"Bao Da Chìa Khóa dành cho xe ô tô TOYOTA ( Chìa gấp altis 14-18, Innova 17-20, Fortuner )Da Thật",170000,170000,0,0
TIKI,o-to-xe-may-xe-dap,11500846,"Giá đỡ, kẹp điện thoại cài khe cửa gió điều hòa xe hơi, ô tô",53000,59000,6000,10
TIKI,o-to-xe-may-xe-dap,70934701,"Nắp Két Nước Làm Mát Động Cơ Ô Tô",69000,69000,0,0
TIKI,o-to-xe-may-xe-dap,74911710," Túi Treo Đầu Ghi Đông Xe Máy Chiều Dọc Xem Google Map, Chứa Đồ, Chạy Grab, Nowship, GoJet",82000,82000,0,0
TIKI,o-to-xe-may-xe-dap,14350394,"Túi treo ghế ô tô",85000,188000,103000,55
TIKI,o-to-xe-may-xe-dap,91390896," Bình xịt vệ sinh nội thất ô tô dưỡng bóng ghế da, taplo, cao su, nhựa sần",210000,210000,0,0
TIKI,o-to-xe-may-xe-dap,3856963,"Kính Bulldog Eagle",179000,179000,0,0
TIKI,o-to-xe-may-xe-dap,135642277,"Ví đựng giấy tờ ô tô Honda Da Cao Cấp, Ví da đựng giấy tờ xe ô tô",55000,55000,0,0
TIKI,o-to-xe-may-xe-dap,32371106,"Công Tắc Mở Cốp Hậu Dành Cho Huyndai I10 Grand - Kia Morning",69000,69000,0,0
TIKI,o-to-xe-may-xe-dap,172167236,"vệ sinh kim phun dầu diesel Senfineco 9985",190000,190000,0,0
TIKI,o-to-xe-may-xe-dap,192340025,"gương cầu lồi cho xe ô tô, Bộ 2 Gương Cầu Lồi Tràn Viền Xoay 360 độ Gắn Cho Kính Gương Chiếu Hậu Tránh Điểm Mù Cho Xe Hơi, Xe Ô tô - Hàng Chính Hãng dododios",29000,29000,0,0
TIKI,o-to-xe-may-xe-dap,45950561,"Ghế ngồi cho bế gắn xe đạp, xe đạp điện đa năng",229000,229000,0,0
TIKI,o-to-xe-may-xe-dap,192514345,"BAGA GIỮA ( KẸP MẠNH ) DÙNG CHO ĐỜI XE AB 2020 2021 VÀ AB 2022 2023 2024 - AB 125 150 160cc BAGA ĐEN",180000,180000,0,0
TIKI,o-to-xe-may-xe-dap,198119464,"Máy hút bụi, bơm lốp, đo áp suất lốp ô tô xe hơi cao cấp công suất 120W có đèn led chiếu sáng",429000,429000,0,0
TIKI,o-to-xe-may-xe-dap,48563549,"Bộ Chốt Khóa Dây An Toàn 4S dành cho ô tô Logo theo xe",50999,50999,0,0
TIKI,o-to-xe-may-xe-dap,74363092,"Găng tay bảo hộ xe máy OAKLEY",68000,68000,0,0
TIKI,o-to-xe-may-xe-dap,53505348,"BAO DA CHÌA KHOÁ FORD EXPLORER - CHÍNH HÃNG KHẮC TÊN",400000,400000,0,0
TIKI,o-to-xe-may-xe-dap,192738336,"Thảm Taplo Da Cacbon XPANDER đời 2019-2022 cao cấp, chống nóng chống trơn trượt",197600,208000,10400,5
TIKI,o-to-xe-may-xe-dap,21050937,"Bộ Tự Vá Lốp Không Săm Cao Cấp Cho Ô Tô Xe Máy",85000,85000,0,0
TIKI,o-to-xe-may-xe-dap,22322969,"BỘ VÁ LỤI XE MÁY, Ô TÔ ",19400,19400,0,0
TIKI,o-to-xe-may-xe-dap,56372404,"Bộ 02 Gương Cầu Nồi Gương Chiếu Hậu Khắc Phục Điểm Mù Ô Tô Xe Hơi ",29000,29000,0,0
TIKI,o-to-xe-may-xe-dap,54566453,"Dung Dịch Xông Khử Mùi Ô Tô 100ml",17000,17000,0,0
TIKI,o-to-xe-may-xe-dap,93884213,"Túi Xe Đạp Treo Sườn Xe Dài 1 Ngăn ML02 Chống Nước Vải Oxford Chống Mài Mòn MaiLee",104000,119000,15000,13
TIKI,o-to-xe-may-xe-dap,4405991,"Ruột xe đạp Schwalbe 26” SV13 (40mm)",130000,130000,0,0
TIKI,o-to-xe-may-xe-dap,229793267,"BỌC VÔ LĂNG THƯƠNG HIỆU FASTERMO, CHẤT DA Ô TÔ CAO CẤP, ĐỦ KÍCH CỞ, FORM ÔM KÍNH THEO XE",179000,179000,0,0
TIKI,o-to-xe-may-xe-dap,97541467," Khóa xe máy chữ U, khóa chống trộm chữ U an toàn LK605",249000,249000,0,0
TIKI,o-to-xe-may-xe-dap,89940920,"Đèn Led Vây Cá Mập Trang Trí Xe Hơi - Dùng Năng Lượng Mặt Trời 206019",61100,73000,11900,16
TIKI,o-to-xe-may-xe-dap,73519197,"Nhớt Xe Số 4T Mobil Super Moto 20W-50 Tiêu Chuẩn JASO MA2 API SL (0.8L) - Hàng Chính Hãng",85000,85000,0,0
TIKI,o-to-xe-may-xe-dap,139445465,"Đèn trợ sáng xe máy ô tô L2 mắt cú siêu sáng mẫu mới chống nước loại tốt vỏ hợp kim",167990,167990,0,0
TIKI,o-to-xe-may-xe-dap,5471023,"Bộ gác chân sau màu titan dành cho xe máy",65000,65000,0,0
TIKI,o-to-xe-may-xe-dap,143053995,"Bảng số điện thoại gắn taplo ô tô hỗ trợ đỗ xe",24999,24999,0,0
TIKI,o-to-xe-may-xe-dap,104812371,"Khóa bánh xe chống trộm ô tô",342000,360000,18000,5
TIKI,o-to-xe-may-xe-dap,100279543,"Thanh gạt mưa Bosch Aerotwin Plus - Hàng Chính Hãng",460000,686000,226000,33
TIKI,o-to-xe-may-xe-dap,59132691,"Ví simili đựng giấy tờ xe ô tô V06Si",38000,38000,0,0
TIKI,o-to-xe-may-xe-dap,38649410,"Thảm sàn, lót sàn cao su không mùi Cao cấp dành cho xe Hyundai Grand i10",501600,528000,26400,5
TIKI,o-to-xe-may-xe-dap,801350,"Máy Lọc Không Khí Cho Xe Hơi Sharp IG-GC2E-N - Vàng - Hàng Chính Hãng",2100000,2100000,0,0
TIKI,o-to-xe-may-xe-dap,111411789,"Băng keo 2 mặt cường lực 3M 4229P dài 10M băng keo siêu dính chịu nước, nhiệt dán được trên nhiều loại chất liệu - XSAFE",90000,90000,0,0
TIKI,o-to-xe-may-xe-dap,181772892,"Bạt Phủ Xe Ô Tô Mazda 2, Mazda 3, Mazda 6, CX5, CX8, CX9, BT50, Chất Liệu Bạt Tráng Nhôm 3 lớp",121600,128000,6400,5
TIKI,o-to-xe-may-xe-dap,100989205,"Bộ 5 Tem Cảnh Báo Dán Xe Máy, Sticker Dán Nón Bảo Hiểm Chống Thấm Nước Green Networks Group",12000,12000,0,0
TIKI,o-to-xe-may-xe-dap,139062246,"Combo 08 Núm Cao su giảm chấn , chống va đập cửa xe Ô tô theo Logo Xe ( 9 Logo )",39000,39000,0,0
TIKI,o-to-xe-may-xe-dap,138776632,"Thang dẫn xe máy lên xe tải, bán tải",2250000,2250000,0,0
TIKI,o-to-xe-may-xe-dap,1237331,"Chai Xịt Bóng Da, Bóng Gỗ Toyo (500ml)",60000,69000,9000,13
TIKI,o-to-xe-may-xe-dap,66682012,"Bộ dụng cụ sửa chữa xe đạp - Dụng cụ tháo trục giữa, cắt sên, tháo líp xe đạp ( 4 chi tiết)",120000,120000,0,0
TIKI,o-to-xe-may-xe-dap,1378109,"Dung Dịch Tẩy Và Làm Sạch Đánh Bóng Inox 3M Stainless Steel Cleaner & Polish 126080 (600g)",270000,270000,0,0
TIKI,o-to-xe-may-xe-dap,74689554,"24 Miếng Vá Săm Lốp Xe Đạp Dự Phòng Tự Vá Tại Nhà (Gồm Keo) Mai Lee",34000,38000,4000,11
TIKI,o-to-xe-may-xe-dap,186269678,"Bộ kích điện ắc quy 12V lên 220V 500W INVERTER",269000,269000,0,0
TIKI,o-to-xe-may-xe-dap,122436826,"Chắn bùn xe đạp thể thao Kiotool trước sau đầy đủ phụ kiện chắc chắn",75000,75000,0,0
TIKI,o-to-xe-may-xe-dap,87392058,"Túi xe đạp cao cấp,túi treo sườn xe đạp chống nước bọc cảm ứng phù hợp với mọi dòng xe Thương hiệu KIOTOOL",65000,65000,0,0
TIKI,o-to-xe-may-xe-dap,171651830,"Máy bơm lốp mini đa năng tự ngắt Michelin 3321 - Bơm xe đạp, xe máy, ô tô, bóng, xe hơi 4 bánh, có đèn LED, nhỏ gọn, thông minh, sạc Micro USB",835000,835000,0,0
TIKI,o-to-xe-may-xe-dap,197218624,"Củ cùi đề xe đạp sang líp sau TX-35 6/7/8 speed",135000,135000,0,0
TIKI,o-to-xe-may-xe-dap,150493324,"Chíp nhại còi xe máy loại tốt chống nước kích âm còi to rõ láy tiếng cực hay",66000,66000,0,0
TIKI,o-to-xe-may-xe-dap,136191275,"Nhớt Xe Tay Ga Motul Scooter Le 4t 10w40 20x",109000,109000,0,0
TIKI,o-to-xe-may-xe-dap,25708089,"Chai vệ sinh làm sạch ghế da, vải nỉ ô tô Gold Class 650ml",80000,80000,0,0
TIKI,o-to-xe-may-xe-dap,141772466,"Máy bơm lốp xe hơi kỹ thuật số thông minh Baseus Mini Air Compressor 12V 150PSI (hàng chính hãng)",491899,491899,0,0
TIKI,o-to-xe-may-xe-dap,102144190,"Cần số Titan dành cho xe Sirius",89000,89000,0,0
TIKI,o-to-xe-may-xe-dap,147084619,"Bình xịt vệ sinh ghế nỉ  ô tô, vệ sinh sofa nỉ",43000,68000,25000,37
TIKI,o-to-xe-may-xe-dap,75331538,"Phuộc Sau Gắn CLICK, VARIO, VISION 330mm 01M0169Y, 01M0169R, 01M0169B Hiệu RCB",1300000,1300000,0,0
TIKI,o-to-xe-may-xe-dap,21928435,"Mũ Bảo Hiểm Fullface Royal M136",359000,359000,0,0
TIKI,o-to-xe-may-xe-dap,57842174,"Ốp Nắp Bình Xăng Mạ Crom Chống Xước Trang Trí Bảo Vệ Ô Tô - Kia Carens",129000,129000,0,0
TIKI,o-to-xe-may-xe-dap,19272818,"Bạt phủ xe máy - Bạt 3D che nắng cao cấp",70990,70990,0,0
TIKI,o-to-xe-may-xe-dap,50348260,"Mũ bảo hiểm Chita 3/4 - CT1 Nón cặp size M",420000,420000,0,0
TIKI,o-to-xe-may-xe-dap,57454794,"Bình Xịt Dung Dịch Phủ Bóng Sơn Xe Ô Tô Chống Thấm Nước 500ml",63000,63000,0,0
TIKI,o-to-xe-may-xe-dap,183268561,"Xe Đạp Điện DK Sparta",15400000,15400000,0,0
TIKI,o-to-xe-may-xe-dap,115599656,"Nón Bảo Hiểm 1/2 Đầu Có Kính Protec VIC, Size Lớn, Độ Che Phủ Sâu Hơn",398000,398000,0,0
TIKI,o-to-xe-may-xe-dap,62874426,"NƯỚC RỬA KÍNH Ô TÔ CHUYÊN DỤNG [5 Lít] ",209000,229000,20000,9
TIKI,o-to-xe-may-xe-dap,185710604,"Gương gắn xe máy Honda,Yamaha",81000,81000,0,0
TIKI,o-to-xe-may-xe-dap,45653568,"Áo ghế ô tô, Áo ghế xe hơi, bọc da ghế xe 3D TD01",650000,650000,0,0
TIKI,o-to-xe-may-xe-dap,72642551,"Bơm xe máy  - Bơm xe đạp chân - Bơm đạp chân 2 ống đa năng - Bơm hơi đạp chân mini cho ô tô, xe máy, xe đạp, bơm bóng, phao bơi",225000,225000,0,0
TIKI,o-to-xe-may-xe-dap,24453956,"Bảng số điện thoại gắn táp lô ô tô kiêm giá để điện thoại (Màu ngẫu nhiên)",17000,17000,0,0
TIKI,o-to-xe-may-xe-dap,190754301,"Nâng ghế lái Xpander ( i10) và nhiều dòng xe Loại 5cm _ Bộ 4 cái",250000,250000,0,0
TIKI,o-to-xe-may-xe-dap,74987084,"Bộ 08 Miếng Dán Chống Xước Cao Cấp Bảo Vệ Tay Nắm Và Hõm Cửa Xe Ô Tô",59000,59000,0,0
TIKI,o-to-xe-may-xe-dap,1254635,"Dung Dịch Vệ Sinh Hệ Thống Xăng Cho Mô Tô Xe Máy Bluechem Fuel Sysem Cleaner (50ml)",85000,85000,0,0
TIKI,o-to-xe-may-xe-dap,74172634,"Đèn trợ sáng xe máy L4 L4X L6 L6X L9X Cr.ee(1 Đèn ) Green Networks Group",79000,79000,0,0
TIKI,o-to-xe-may-xe-dap,145016692,"Mũ Bảo Hiểm Nửa Đầu Màu Đen Họa Tiết Cặp Đôi Kèm Kính Thời Trang Chính Hãng B'COLOR Combo 2 Mũ",560000,560000,0,0
TIKI,o-to-xe-may-xe-dap,8047878,"Gương chiếu hậu 5 cạnh có chân gập",71000,135000,64000,47
TIKI,o-to-xe-may-xe-dap,155245299,"Bao Da Chìa Khoá New KIA K3 2021 Luxury, Premium, K5, New Sportage 2022, Sorento, cerato logo mới handmade Da Thật 010",199000,199000,0,0
TIKI,o-to-xe-may-xe-dap,120214757,"Đầu chốt cài khóa dây an toàn trên ô tô có khe cắm chồng-1 Chiếc",59000,59000,0,0
TIKI,o-to-xe-may-xe-dap,68169482,"Bảng số điện thoại cao cấp trên ô tô DK-GD211",149000,149000,0,0
TIKI,o-to-xe-may-xe-dap,53640184,"Tấm lót và ghế tựa lưng hạt gỗ có chống trựơt  xe ô tô ",303000,347000,44000,13
TIKI,o-to-xe-may-xe-dap,104191669,"Đèn Đuôi Xe Đạp Cảnh Báo Phía Sau Cho Xe đạp Sạc Điện USB Chống Nước Trang Trí",91000,119000,28000,24
TIKI,o-to-xe-may-xe-dap,46235477,"Giá đỡ gối đệm kê ngủ tựa đầu 2 bên gắn xe hơi, ô tô, giá có thể điều chỉnh độ cao thấp phù hợp cho người lớn và trẻ em",429000,429000,0,0
TIKI,o-to-xe-may-xe-dap,158021789,"Bộ 2 gương lồi tràn viền xoay 360 độ gắn cho kính gương chiếu hậu tránh điểm mù cho xe Hơi, Xe Ô tô - Hàng nhập khẩu",89000,89000,0,0
TIKI,o-to-xe-may-xe-dap,30986829,"Máy Hút Bụi Cầm Tay Xe Hơi Và Gia Đình ",299000,299000,0,0
TIKI,o-to-xe-may-xe-dap,168562527,"Đệm Lót Yên Xe Máy 3D Chống Ê Mong, Làm Mát Chống Hầm,Êm Chảo, Chất Liệu Mút Xốp Cao Cấp Chuyên Dụng SIGATO3079",249000,249000,0,0
TIKI,o-to-xe-may-xe-dap,56650569,"Mũ Bảo Hiểm ¾ Napoli Sh2 Ruby Thời Thượng Nhiều Màu Cá Tính",247500,247500,0,0
TIKI,o-to-xe-may-xe-dap,38716521,"Thảm sàn, lót sàn cao su không mùi Cao cấp dành cho xe KIA Morning 2012-2019",435100,458000,22900,5
TIKI,o-to-xe-may-xe-dap,5077223,"Bộ tự vá lốp không săm cao cấp chuyên dụng cho xe máy, ô tô",78000,78000,0,0
TIKI,o-to-xe-may-xe-dap,94702864,"Khử mùi xe ô tô, khử mùi xe hơi nano bạc Nano Xclean For Car 500ML AHT Corp - chai xịt diệt khuẩn khử mùi ô tô, mùi hải sản, mùi ẩm mốc, mùi hôi khó chịu không gian nội thất xe ô tô - công nghệ nano an toàn, thân thiện",99000,165000,66000,40
TIKI,o-to-xe-may-xe-dap,8277466,"Bọc vô lăng Sparco - SPC1113BK",399000,399000,0,0
TIKI,o-to-xe-may-xe-dap,119927716,"Bộ 2 móc treo đồ INOX sau ghế xe hơi ô tô",29000,29000,0,0
TIKI,o-to-xe-may-xe-dap,53265128,"Bảng số điện thoại dạ quang trên ô tô, xe hơi nhãn hiệu Baseus cao cấp ACNUM-B0S",113999,113999,0,0
TIKI,o-to-xe-may-xe-dap,50185672,"full bộ đĩa trước cho xe sirius tặng bao tay trợ lực ga",1139000,1139000,0,0
TIKI,o-to-xe-may-xe-dap,91471480," Túi đeo hông chống nước đi xe máy GIVI RWB04",448000,448000,0,0
TIKI,o-to-xe-may-xe-dap,31613796,"KHÓA ĐĨA CAO CẤP HÚ BÁO ĐỘNG CHỐNG TRỘM DÀNH CHO XE MÁY",216999,216999,0,0
TIKI,o-to-xe-may-xe-dap,116767231,"Líp vặn SHIMENG 7 Speed",105000,105000,0,0
TIKI,o-to-xe-may-xe-dap,26460661,"Đèn led hậu chớp gắn cho xe máy ",28000,28000,0,0
TIKI,o-to-xe-may-xe-dap,192738375,"Thảm taplo da HYUNDAI I10 đời 2017 - 2020 cao cấp, Form màn hình thấp, chống nóng chống trơn trượt",199000,199000,0,0
TIKI,o-to-xe-may-xe-dap,7125675,"Chai xịt bảo dưỡng lốp ô tô 3M 39042 (Hàng Mỹ)",295000,305000,10000,3
TIKI,o-to-xe-may-xe-dap,150493655,"Đèn bi cầu 2 màu cốt vàng pha trắng F20xp 60w siêu sáng chống nước dành cho khách vip",439000,439000,0,0
TIKI,o-to-xe-may-xe-dap,56362505,"Máy lọc không khí ô tô Dr.Ozone IA 560 tạo ion âm khử mùi ô tô kiêm 2 cổng sạc USB - Hàng Chính Hãng",560000,560000,0,0
TIKI,o-to-xe-may-xe-dap,125138775,"Giá kẹp đỡ điện thoại xoay 360 độ chống rung gắn taplo tấm chắn nắng gương chiếu hậu xe ô tô, xe hơi",60001,60001,0,0
TIKI,o-to-xe-may-xe-dap,49543124,"Dung Dịch Tẩy Ố, Tẩy Nano Kính Ô Tô Glaco Compound Roll On G-47T Soft99 Japan 100ml",320000,320000,0,0
TIKI,o-to-xe-may-xe-dap,45818076,"Tấm Lưới Tựa Lưng Ô Tô Văn Phòng Siêu Hot TL01",24000,24000,0,0
TIKI,o-to-xe-may-xe-dap,163023746,"ỐP KHOÁ SMART MERCEDES 2024",399000,399000,0,0
TIKI,o-to-xe-may-xe-dap,102722437,"Gối Tựa Lưng Ghế Văn Phòng Ghế Ô Tô Bằng Cao Su Non Có Đai Cài Vỏ Hoạt Hình Xinh Xắn",329000,329000,0,0
TIKI,o-to-xe-may-xe-dap,74492106,"BỘ KÍCH NỔ ẮC QUY KIÊM SẠC DỰ PHÒNG HIGHPOWER CHO XE Ô TÔ",850000,850000,0,0
TIKI,o-to-xe-may-xe-dap,52322221,"Thiết Bị Định Vị GPS GF-09 Dành Cho Xe Hơi Người Cao Tuổi Trẻ Nhỏ Tự Động Gửi Báo Động Cho Bạn",385000,385000,0,0
TIKI,o-to-xe-may-xe-dap,10120303,"Nước hoa kẹp cửa gió điều hòa ô tô AREON VANI (NEW) - NHẬP KHẨU BULGARIA",315000,315000,0,0
TIKI,o-to-xe-may-xe-dap,56048436,"Mũ Bảo Hiểm 3/4 Zeus 205",1300000,1300000,0,0
TIKI,o-to-xe-may-xe-dap,72189654,"Bảng số điện thoại dùng trên xe hơi Baseus All Metal Temporary Parking Number Plate Series 2 (Dual-number Version) - Hàng chính hãng",249899,249899,0,0
TIKI,o-to-xe-may-xe-dap,118297928,"Đèn pin xe đạp siêu sáng X1T6, Độ sáng 1800 Lumen (Bộ Pin 8.4V+ Sạc + Đèn X1T6)",250000,250000,0,0
TIKI,o-to-xe-may-xe-dap,150491098,"MIẾNG THẢM TAPLO CHỐNG TRƯỢT KIÊM ĐỠ ĐIỆN THOẠI VÀ PHỤ KIỆN TIỆN DỤNG TRÊN XE HƠI ÔTÔ HÀNG CHUẨN ĐẸP",75000,75000,0,0
TIKI,o-to-xe-may-xe-dap,6703871,"Bình Ắc Quy Siêu Nhỏ 12V - 1.3Ah",149899,149899,0,0
TIKI,o-to-xe-may-xe-dap,54160152,"Giường đệm, nệm hơi thông minh du lịch cho ôtô, xe hơi + Kèm bơm điện, vòi bơm đa năng",299996,299996,0,0
TIKI,o-to-xe-may-xe-dap,58362173,"Đèn hậu nhấp nháy phanh chớp liên tục gắn cho mọi loại xe ( Đầu Trong ) Green Networks Group",69000,69000,0,0
TIKI,o-to-xe-may-xe-dap,138341114,"Gối Tựa Lưng Ô Tô Cao Su Non Bọc Da Cao Cấp , Gối Tựa Đầu Dùng Cho Xe Ô Tô, Ghế Văn Phòng",115000,115000,0,0
TIKI,o-to-xe-may-xe-dap,47271718,"Đệm Giường Hơi Ô Tô Cao Cấp, Đệm hơi xe SUV M168 7 chỗ 175x130CM phủ 2 hàng ghế tạo giường rộng rãi",790000,790000,0,0
TIKI,o-to-xe-may-xe-dap,31140597,"Gạt mưa Bosch Advantage Honda City 26" 14" (Đen)",269000,269000,0,0
TIKI,o-to-xe-may-xe-dap,142871457,"Dây ràng D-Ring buộc đồ đi phượt trên xe máy",80000,80000,0,0
TIKI,o-to-xe-may-xe-dap,184414971,"Túi Smilebox đựng thẻ, tiền, mắt kính, giấy tờ xe treo tấm chắn nắng của ô tô, xe hơi nhiều ngăn",159000,159000,0,0
TIKI,o-to-xe-may-xe-dap,53470955,"Gắp nhôm cho xe wave drem sirius DBS tặng bao tay xe máy",480000,480000,0,0
TIKI,o-to-xe-may-xe-dap,107353581,"[CHÍNH HÃNG] 2 CHAI 500ML: XWash - Xịt tẩy rửa, khử mùi nội thất ô tô KHÔNG HÓA CHẤT - Tặng khăn lông cừu cao cấp",799000,799000,0,0
TIKI,o-to-xe-may-xe-dap,110885061,"Miếng Dán Chống Trầy Xước Hõm Cửa Xe Hơi/Tay Nắm Cửa Xe Hơi/Gương Chiếu Hậu Xe Hơi Cho Logo Nhiều Hãng Xe [Hàng Loại Tốt",54000,54000,0,0
TIKI,o-to-xe-may-xe-dap,150494511,"Sạc điện thoại trên xe máy 3in1 kèm đồng hồ báo vôn- báo nhiệt độ đa năng loại tốt màn hình led",169000,169000,0,0
TIKI,o-to-xe-may-xe-dap,174450787,"Máy Lọc Không Khí Xe Hơi Tạo Plasmacluster ion Sharp IG-GC2E-B - Màu Đen - Hàng chính hãng",2300000,2300000,0,0
TIKI,o-to-xe-may-xe-dap,157146259,"Bộ 4 Miếng Dán Nano Chống Đọng Nước Gương, Kính Ô Tô (Loại 1)",25000,25000,0,0
TIKI,o-to-xe-may-xe-dap,92084838,"Led Đuôi Sau Xe Đạp BK820 100Lumens Led COB 4 Chế Độ Có Đèn Phanh Cảm Biến Thông Minh Gia Tốc Sạc USB Chống Nước và Bụi Bẩn Cho Xe Đạp Thể Thao MaiLee",227050,239000,11950,5
TIKI,o-to-xe-may-xe-dap,48248987,"Ghế ngồi trước em bé xe Wave Greennetwoks",180000,180000,0,0
TIKI,o-to-xe-may-xe-dap,83347621,"Nón bảo hiểm 3/4 ROYAL M139 có kính âm V5 ĐEN",552000,730000,178000,24
TIKI,o-to-xe-may-xe-dap,15413517,"Đĩa thắng xe máy Future 1",118000,118000,0,0
TIKI,o-to-xe-may-xe-dap,13384939,"Cốc Đun Nước Bằng Tẩu Sạc Trên Ô Tô AZONE",137750,145000,7250,5
TIKI,o-to-xe-may-xe-dap,41296396,"Bình chữa cháy Mini cho ô tô FMS-25 1000ml",121600,128000,6400,5
TIKI,o-to-xe-may-xe-dap,13293809,"Bộ 2 Tấm Chắn Bùn Xe Đạp Thể Thao Cao Cấp AZONE",44500,89000,44500,50
TIKI,o-to-xe-may-xe-dap,193643505,"Bộ 9 miếng dán bậc cửa trong ngoài và Cốp Sau Ô tô Chống trầy bằng Sợi Carbon ( chọn mẫu)",119000,119000,0,0
TIKI,o-to-xe-may-xe-dap,14975706,"Bạt phủ chống nắng kính lái loại lớn dùng cho mọi loại xe ô tô",190000,190000,0,0
TIKI,o-to-xe-may-xe-dap,23442303,"Phụ Kiện Tay Cầm Đa Năng Ghế Sau Ô Tô Móc Treo Đồ Đa Năng Xe Hơi Tay Nắm An Toàn Cho Người Già, Trẻ Em",89000,89000,0,0
TIKI,o-to-xe-may-xe-dap,35129432,"Thảm Nhựa Lót Cốp Sau Dành Cho Xe Ô Tô Honda City",286900,302000,15100,5
TIKI,o-to-xe-may-xe-dap,116409215,"Bao da dành cho chìa khoá Mercedes phom cũ handmade da thật 001",199000,199000,0,0
TIKI,o-to-xe-may-xe-dap,184410429,"Ốp Khóa, Ốp Chìa Khóa, Ốp Bảo Vệ Khóa Xe Vinfast Fadil, Vinfast Lux Hợp Kim Kẽm",209000,279000,70000,25
TIKI,o-to-xe-may-xe-dap,92154071,"Chân Đế Xoay 360 Gắn Camera Hành Trình Ô Tô, Go Pro, Ezviz Sports, SJ Cam 6mm Loại To",80000,80000,0,0
TIKI,o-to-xe-may-xe-dap,157146609,"Ốp Bảo Vệ Chìa Khóa Dành Cho Xe Honda Civic, City, CRV, HRV, Brio, Accord Hợp Kim Kẽm Cao Cấp",209000,219000,10000,5
TIKI,o-to-xe-may-xe-dap,142870880,"Cao su bọc cần số xe máy để không bị hư giày khi móc côn",15000,15000,0,0
TIKI,o-to-xe-may-xe-dap,118299663,"Gương chiếu hậu xe đạp DX-002 - GƯƠNG CẦU LỒI XE ĐẠP 360 ĐỘ (chiếc)",50652,50652,0,0
TIKI,o-to-xe-may-xe-dap,78290547,"Cục nhôm đôn nâng phuộc sau xe máy Green Networks Group ( 1 Cặp )",59000,59000,0,0
TIKI,o-to-xe-may-xe-dap,89951675,"Combo 5 Cái Khăn lau chuyên dụng siêu mềm thấm hút tốt, lau rửa xe ô tô, dùng trong spa..",74700,74700,0,0
TIKI,o-to-xe-may-xe-dap,151615669,"Ốp dè chắn bùn ex 155 -150 titan bản đặc biệt siêu dày chắc chắn hàng cao câp chống rung lắc",178000,178000,0,0
TIKI,o-to-xe-may-xe-dap,194788781,"Bộ kích điện xe ô tô khẩn cấp Xiaomi 70Mai 11100 mAh- kích điện oto-Cứu hộ xe hơi Car Jump Starter",1800000,1800000,0,0
TIKI,o-to-xe-may-xe-dap,114984646,"Mũ bảo hiểm xe đạp người lớn, nón bảo hiểm xe đạp Protec Win 002 tiêu chuẩn Châu Âu, thời trang, cá tính, an toàn- Hàng Chính Hãng",389000,479000,90000,19
TIKI,o-to-xe-may-xe-dap,41592916,"Bộ Máy Bơm Lốp Ô Tô, Xe Hơi Kèm Phụ Kiệm Ứng Cứu Sửa Chữa Cao Cấp BL-01",498000,498000,0,0
TIKI,o-to-xe-may-xe-dap,12595457,"Mũ bảo hiểm fullface AGU Tem 46 - Tặng túi đựng nón thương hiệu",469000,469000,0,0
TIKI,o-to-xe-may-xe-dap,50116790,"Tẩu Nghe Nhạc MP3  Bluetooth X8 Trên Xe Hơi Cao Cấp Kèm Sạc Nhanh 3.1A",145000,145000,0,0
TIKI,o-to-xe-may-xe-dap,1565453,"Chai xịt tăng độ bóng sơn ô tô 3M 39034 LT 3M Gloss Enhancer 400ml",169000,169000,0,0
TIKI,o-to-xe-may-xe-dap,115622402,"Tấm cách âm 3M ACOUSTIC 3 lớp màu đen và 2 lớp màu vàng siêu chống ồn hàng nhập",105000,105000,0,0
TIKI,o-to-xe-may-xe-dap,5816457,"Nước Hoa Xe Hơi Ô Tô",160000,160000,0,0
TIKI,o-to-xe-may-xe-dap,121329682,"Đèn LED chạy bằng năng lượng gió cao cấp 8 bóng led cực sáng dành cho xe hơi và xe môtô",38000,38000,0,0
TIKI,o-to-xe-may-xe-dap,17039165,"Lá Thơm Xe AREON BLUE CRYSTAL - Pha Lê Xanh (Nam tính)",75000,75000,0,0
TIKI,o-to-xe-may-xe-dap,119624961,"Chốt cài khóa dây an toàn trên ô tô bằng thép có thương hiệu xe 1 chiếc",38950,41000,2050,5
TIKI,o-to-xe-may-xe-dap,47255368,"đĩa thắng cho xe hayate tặng bao tay xe máy",139000,139000,0,0
TIKI,o-to-xe-may-xe-dap,12097467,"Bộ 4 rèm che nắng kính bên ô tô",187066,187066,0,0
TIKI,o-to-xe-may-xe-dap,41934078,"Máy lọc không khí ô tô iMediCare iAP-3A",3350000,3350000,0,0
TIKI,o-to-xe-may-xe-dap,138154651,"Tấm Đệm Tựa Lưng Ghế Văn Phòng , Ghê Ô Tô, Tựa lưng",37325,37325,0,0
TIKI,o-to-xe-may-xe-dap,138892730,"Vỏ Lốp Camel cho xe Vario-Vision-AB-Noja-14 in Không Ruột-gai 635",348000,348000,0,0
TIKI,o-to-xe-may-xe-dap,105185333,"Bọc silicon khóa Smartkey Honda SH, AB, vario, Lead, Sh Mode",22000,22000,0,0
TIKI,o-to-xe-may-xe-dap,121978642,"Khoá dây chống trộm, xe đạp, xe máy, nhà cửa màu ngẫu nhiên",100000,100000,0,0
TIKI,o-to-xe-may-xe-dap,41598599,"Nước hoa trang trí tạo hương thơm tự nhiên trên ô tô, xe hơi CAR-01",161998,161998,0,0
TIKI,o-to-xe-may-xe-dap,73873352,"Dụng Cụ Bảo Dưỡng Kiểm Tra Sên Xích Xe Đạp, Đo Độ Mòn Xích, Vam Sên Cắt Tháo Mắt Sên Và Kềm Cắt Dây Xích Chuyên Dụng Cho Xe Đạp Mai Lee (3 món)",189050,199000,9950,5
TIKI,o-to-xe-may-xe-dap,130470617,"Gạt mưa Silicone xương cứng Kia Cerato 2017-",222000,222000,0,0
TIKI,o-to-xe-may-xe-dap,1254727,"Dung Dịch Vệ Sinh Máy Carbon Cleaner Liqui Moly 4T Additive Shooter 7916 (80ml)",85000,85000,0,0
TIKI,o-to-xe-may-xe-dap,121978347,"Keo tự vá săm lốp xe máy Huy Đức 700ml, 500ml, 350ml",35000,35000,0,0
TIKI,o-to-xe-may-xe-dap,73939371,"Khóa dây mật khẩu báo động chống trộm đa năng 120cm ( Khóa xe đạp, xe máy, nhà cửa ... )",55182,55182,0,0
TIKI,o-to-xe-may-xe-dap,156813020,"Bao da chìa khóa xe máy Air blade dạng hộp da bò thật",183330,189000,5670,3
TIKI,o-to-xe-may-xe-dap,147975283,"VÍ DA Ô TÔ ĐỰNG ĐĂNG KIỂM, GIẤY TỜ Ô TÔ CAO CẤP - BÓP ĐỰNG GIẤY TỜ XE HƠI",20000,20000,0,0
TIKI,o-to-xe-may-xe-dap,97446123,"Nước Rửa Xe Sáng Bóng 3M 10 Lít",579000,579000,0,0
TIKI,o-to-xe-may-xe-dap,4451239,"Dụng Cụ Đánh Bóng Xe Hơi ( Giao Màu Ngâu Nhiên )",390000,390000,0,0
TIKI,o-to-xe-may-xe-dap,155761314,"Gối Tựa Đầu Xe Hơi, Ô Tô Cao Cấp Chất Liệu 100% Cao Su Non - 6 màu - Mã: DC-TC01",109000,109000,0,0
TIKI,o-to-xe-may-xe-dap,45555300,"Bộ 2 Sáp Thơm Cà Phê Mocha Grasse L'Esterel Bullsone HQST17CA (130g)",180000,180000,0,0
TIKI,o-to-xe-may-xe-dap,15790258,"Bộ 2 Gương Cầu Lồi 360 Độ Gắn Gương Chiếu Hậu Ô Tô ACP-001",20000,49984,29984,60
TIKI,o-to-xe-may-xe-dap,49324632,"Nón bảo hiểm 3/4 Royal M139 Design V10 Đen Bóng",533000,730000,197000,27
TIKI,o-to-xe-may-xe-dap,155753486,"Nước Rửa Kính Đậm Đặc Liqui Moly 250ml Tỉ Lệ 1:100 Dùng Cho Ô Tô",148000,148000,0,0
TIKI,o-to-xe-may-xe-dap,48910299,"Khóa Xe máy chữ U - siêu chống trộm",105000,105000,0,0
TIKI,o-to-xe-may-xe-dap,116191892,"Bao da dành cho chìa khoá Hyundai Accent 2021 4 nút bấm handmade da thật 009",199000,199000,0,0
TIKI,o-to-xe-may-xe-dap,113403862,"Ốp Chụp Mâm (Lazang ) Xe Ô Tô Logo Hình Ngôi Sao ( 01 chiếc)",175120,175120,0,0
TIKI,o-to-xe-may-xe-dap,76029583,"Mũ Bảo Hiểm 1/2 Bulldog Pug - Hàng Chính Hãng",679000,679000,0,0
TIKI,o-to-xe-may-xe-dap,69191447,"Bộ Vè Chắn Bùn Leo Núi Thể Thao Siêu Dẻo Mềm Chống Gãy 2 in 1 (Trước Và Sau) Cho Xe Đạp Địa Hình, MTB Tích Hợp Đèn Led Đuôi Cảnh Báo Phía Sau Màu Đỏ Mai Lee",123000,149000,26000,17
TIKI,o-to-xe-may-xe-dap,68662662,"Cây Thông Thơm Treo Xe Little Trees Mùi Vanillaroma - Black Ice - Lavender Cho Hương Thơm Nhẹ Nhàng",40000,40000,0,0
TIKI,o-to-xe-may-xe-dap,49548335,"Sáp Vệ Sinh Và Phủ Bóng Sơn Xe Ô Tô Màu Trắng White SOFT99 Wax W-3",390000,390000,0,0
TIKI,o-to-xe-may-xe-dap,184518858,"Decal dán bình dầu, xăng, diesel phân biệt tránh nhầm lẫn",18000,18000,0,0
TIKI,o-to-xe-may-xe-dap,139289852,"Lốp(vỏ) DPLUS 80/90-16 Dành cho Trước SH Mode, Sau NouvoLX, Sirius...CÔNG NGHỆ NHÂTJIS",380000,380000,0,0
TIKI,o-to-xe-may-xe-dap,129986618,"Khóa Cốt Yên Xe Đạp - Dụng Cụ Tăng Giảm Độ Cao Yên Xe - Loại 28,6mm - 31,8mm",43700,46000,2300,5
TIKI,o-to-xe-may-xe-dap,122831451,"Vè che mưa đen dày dành cho Xpander 2019-2020-2021",310650,327000,16350,5
TIKI,o-to-xe-may-xe-dap,156403858,"Bạt Phủ Áo Trùm Xe Máy Vải Dù Che Mưa Nắng Thời Tiết Khắc Nghiệt Loại Lớn Cho Dòng Xe Tay Ga - Xe Số Thông Dụng MINIIN",121000,139000,18000,13
TIKI,o-to-xe-may-xe-dap,102446048,"Ví đựng giấy tờ xe in logo dành cho oto",22800,24000,1200,5
TIKI,o-to-xe-may-xe-dap,45400251,"Dầu Động Cơ CASTROL MAGNATEC 5W30 API SP, can 4 LÍT",690000,690000,0,0
TIKI,o-to-xe-may-xe-dap,56094824,"Găng tay EGO dài ngón bảo hộ cho người đi xe motô, xe gắn máy, đi phượt",170000,170000,0,0
TIKI,o-to-xe-may-xe-dap,99888847,"Rổ Hông Xe Máy Tròn, Vuông Lắp Được Cho Tất Cả Các Dòng Xe",48000,48000,0,0
TIKI,o-to-xe-may-xe-dap,38482476,"Mũ Bảo Hiểm Xe Đạp Trẻ Em Protec SMILE Họa Tiết CapTain America Có Vòng Điều Chỉnh Đầu, Có Đèn Chiếu Hậu An Toàn Phía Sau",338000,438000,100000,23
TIKI,o-to-xe-may-xe-dap,49659573,"Vè Che Mưa Chỉ Mạ Cho Xe Kia Soluto",306755,322900,16145,5
TIKI,o-to-xe-may-xe-dap,146904148,"Đai ghế giữ an toàn cho bé trên xe ô tô - địu gắn ghế cho bé",139000,139000,0,0
TIKI,o-to-xe-may-xe-dap,101995996,"Đèn Đuôi Led Xe Đạp BK880 Chống Nước Siêu Sáng Nhiều Chế Độ Sáng Sạc Điện USB (Bản Nâng Cấp) 2 Phiên Bản MaiLee",217550,229000,11450,5
TIKI,o-to-xe-may-xe-dap,164430657,"Mỡ bôi trơn dạng xịt Grease Spray Bosny",95000,120000,25000,21
TIKI,o-to-xe-may-xe-dap,74217215,"Chai Xịt Dưỡng Sên/ Xích Ipone X-trem Chain Off-Road (250ml) - Hàng Chính Hãng",190000,190000,0,0
TIKI,o-to-xe-may-xe-dap,50710153,"Bạt Phủ Ô Tô 4 Chỗ - 7 Chỗ - Bán Tải - Bạt Phủ Trùm Xe Ô Tô + Quà Tặng Túi Thơm Hình Cây Thông Treo Xe",226000,295000,69000,23
TIKI,o-to-xe-may-xe-dap,124385359,"Bệ Tỳ Tay Xpander Và Xpander Cross Mẫu Bệ Thấp Tiện Lợi Loại I",311600,328000,16400,5
TIKI,o-to-xe-may-xe-dap,119719045,"Máy Sạc Bình Ắc Quy Foxsur 12V 12A - 24V 6A, Sạc Pin Lithium, Khử Sunfat, Sạc Ắc Quy Xe Máy Ô Tô, MẪU MỚI 2021",388000,388000,0,0
TIKI,o-to-xe-may-xe-dap,31594509,"Ống hơi  9m ( Cuộn dây hơi xoắn dẫn khí nén )",69000,69000,0,0
TIKI,o-to-xe-may-xe-dap,22373460,"Bộ chia Tẩu sạc ô tô, Xe hơi cao cấp Đa năng Huyndai HY - I6",123000,123000,0,0
TIKI,o-to-xe-may-xe-dap,56046034,"Kính mũ bảo hiểm Fullface EGO E-7",180000,180000,0,0
TIKI,o-to-xe-may-xe-dap,122412513,"Móc treo áo trên xe ô tô cao cấp  JT-G03",623000,623000,0,0
TIKI,o-to-xe-may-xe-dap,33227275,"Băng keo 2 mặt chịu nhiệt dán linh kiện điện tử 3M khổ 6mm x 50m 9448A",89000,89000,0,0
TIKI,o-to-xe-may-xe-dap,180985971,"Máy bơm lốp xe máy, ô tô- siêu tốc tự ngắt Michelin 12314 -12V- 360W",1699000,1699000,0,0
TIKI,o-to-xe-may-xe-dap,55502522,"Bao tay, Găng tay Xe đạp, Xe máy, Câu cá, Du lịch, Leo núi, Ngoài trời Hở Ngón GT-005",90000,135000,45000,33
TIKI,o-to-xe-may-xe-dap,83618256,"Bộ đế gắn + lông cừu + xốp đánh bóng 5 inches 3 món đánh bóng ô tô",99999,99999,0,0
TIKI,o-to-xe-may-xe-dap,139444390,"Mạch stop chớp nháy đèn hậu Ex 150 - Winner X siêu đẹp chống nước sẵn giắc cắm loại tốt không cần độ chế",99000,99000,0,0
TIKI,o-to-xe-may-xe-dap,113355572,"Tấm miếng đệm lót ghế xe ô tô, xe hơi, ghế văn phòng hạt gỗ tròn hương cao cấp 45x45",243000,500000,257000,51
TIKI,o-to-xe-may-xe-dap,2872303,"Bộ 2 găng tay lau rửa xe chuyên dụng siêu mềm thấm hút tốt (Màu ngẫu nhiên)",13000,24800,11800,48
TIKI,o-to-xe-may-xe-dap,135464990,"Combo 3 chai Sprayking Dưỡng nhám,Rửa sên và dưỡng sên 400ML",139000,139000,0,0
TIKI,o-to-xe-may-xe-dap,71694022,"Dây Treo Xe Ô Tô Phong Thủy Cá Chép Ngậm Đồng Tiền Tài Lộc May Mắn",125000,125000,0,0
TIKI,o-to-xe-may-xe-dap,97427510,"Cản sau - tay dắt xe Winner X nhôm nguyên khối sơn tĩnh điện",365000,365000,0,0
TIKI,o-to-xe-may-xe-dap,96046576,"Túi Treo Sườn Xe Đạp Thể Thao Cảm Ứng Chống Nước Tặng Kèm Trùm Đi Mưa",69000,69000,0,0
TIKI,o-to-xe-may-xe-dap,56650976,"Đầu khóa chốt cắm móc đai dây an toàn ô tô cao cấp HC-888 Chất liệu Hợp kim inox cao cấp dùng cho các loại xe",90000,90000,0,0
TIKI,o-to-xe-may-xe-dap,152875193,"SIÊU SÁNG VỚI 1 BÓNG ĐÈN PHA LED 6TIM LẮP XE MÁY XE HƠI ÔTÔ SÁNG CỰC CHUẨN HÀNG CHUẨN CHẤT LƯỢNG",229000,229000,0,0
TIKI,o-to-xe-may-xe-dap,91925236,"Bộ đo áp suất buồng đốt động cơ xăng ô tô, xe máy 8PC- 300 PSI - Đồng hồ đo áp suất buồng đốt ô tô",295000,295000,0,0
TIKI,o-to-xe-may-xe-dap,50415606,"Hộp tỳ tay ô tô dành cho Mitsubishi Xpander tích hợp 7 cổng USB ( DUSB-EXPD )",359000,378000,19000,5
TIKI,o-to-xe-may-xe-dap,159957290,"CON ĐỘI THỦY LỰC 2 TẤN | kích ô tô | kích thủy lực",259000,259000,0,0
TIKI,o-to-xe-may-xe-dap,141490275,"NƯỚC HOA XE HƠI NHẬP KHẨU DÀNH CHO XẾ XỊN - NƯỚC HOA TRANG TRÍ TAPLO, LÀM THƠM KHỬ MÙI Ô TÔ HIỆU QUẢ",152000,152000,0,0
TIKI,o-to-xe-may-xe-dap,94584853,"Bình tạo bọt tuyết vệ sinh xe ô tô gắn máy dung tích 1L - HanruiOffical",158000,158000,0,0
TIKI,o-to-xe-may-xe-dap,111198562,"Túi Treo Xe Đạp 2 Ngăn Chống Nước Có Mặt Để Điện Thoại",69000,69000,0,0
TIKI,o-to-xe-may-xe-dap,9820675,"Sáp thơm ô tô hương cà phê AREON Ken Coffee - NHẬP KHẨU BULGARIA",270000,270000,0,0
TIKI,o-to-xe-may-xe-dap,75637147,"SẠC CHUYÊN DỤNG DÀNH CHO XE ĐẠP ĐIỆN M133 - SIÊU BỀN - SẠC DÒNG ĐIỆN CHUẨN - NGẮT ĐIỆN TUYỆT ĐỐI - BẢO VỆ XE - KÉO DÀI TUỔI THỌ ẮC QUY - LOẠI 48V-12AH CHÂN ĐẶC HOẶC CHÂN CHỤP (RỖNG)",200000,200000,0,0
TIKI,o-to-xe-may-xe-dap,112084875,"Hộp xích dành cho xe Wave RSX - S110 màu Bạc - TKB8510",159536,270400,110864,41
TIKI,o-to-xe-may-xe-dap,11533657,"Đèn led trần xe ô tô - đèn cốp xe ô tô",150000,150000,0,0
TIKI,o-to-xe-may-xe-dap,52150469,"Ổ Khóa 8 Cạnh Dành Cho Xe Máy Future",175750,185000,9250,5
TIKI,o-to-xe-may-xe-dap,85368098,"Nệm Giường hơi để xe ô tô- nệm hơi xe hơi-Đệm xe hơi vải nhung",348000,348000,0,0
TIKI,o-to-xe-may-xe-dap,56109845,"Giá Đỡ Điện Thoại Chân Gắn Và Hút Chân Không Trên Xe Ô Tô ",79000,79000,0,0
TIKI,o-to-xe-may-xe-dap,8512185,"Mũ 3/4 Bulldog Heli Carbon",2600000,2600000,0,0
TIKI,o-to-xe-may-xe-dap,108968070,"Xịt dưỡng cao su, gioăng cửa ô tô Silicone Spray Senfineco 9990",210000,210000,0,0
TIKI,o-to-xe-may-xe-dap,147931967,"Phôi chìa khóa xe mô tô Yamaha FZ150i",70000,70000,0,0
TIKI,o-to-xe-may-xe-dap,173342081,"Mũ Bảo Hiểm Xe Đạp Cho Bé Từ 4 - 10 Tuổi Free size",192500,350000,157500,45
TIKI,o-to-xe-may-xe-dap,57036504,"Cặp Kính chiếu hậu Dành cho xe Wave RS có thể điều chỉnh ",45000,45000,0,0
TIKI,o-to-xe-may-xe-dap,10681029,"Pin Camera Hành Trình Xe Máy 900mAh",70000,70000,0,0
TIKI,o-to-xe-may-xe-dap,53803359,"Đèn Xe Đạp Thể Thao Chính Hãng | Đèn Led Sạc USB Chống Nước | Pin Polymer | Đèn Siêu Sáng | Phụ Kiện Đèn Xe Đạp Đa Chức Năng Kết Hợp Còi Và Đồng Hồ Đo Tốc Độ  - 10. Đèn Pha Machfally - Đen",141550,149000,7450,5
TIKI,o-to-xe-may-xe-dap,92515054,"Bánh phụ xe đạp trẻ em 12, 16inh- 18, 20inh <1đôi",59000,80000,21000,26
TIKI,o-to-xe-may-xe-dap,53390147,"Tem dán kính lái chống nắng ô tô Value",89000,89000,0,0
TIKI,o-to-xe-may-xe-dap,54476107,"Nón bảo hiểm 3/4 kính âm Royal M139 Đỏ Đô Nhám cao cấp Lót tháo rời, che hết mặt",499000,499000,0,0
TIKI,o-to-xe-may-xe-dap,153937726,"COMBO Nẹp bước chân và ốp chống trầy cốp Honda CRV, CR-V vân Carbon",1411700,1486000,74300,5
TIKI,o-to-xe-may-xe-dap,84446103,"Kính Phi Công Chống Nắng Chống Bụi Chống Tia UV",59000,59000,0,0
TIKI,o-to-xe-may-xe-dap,10099198,"Ổ khóa phanh đĩa chống trộm cho xe máy, xe đạp thể thao (Giao màu ngẫu nhiên)",28500,30000,1500,5
TIKI,o-to-xe-may-xe-dap,165635891,"Hộp bộ dụng cụ siết ốc vít, bugi cơ khí sửa chữa ô tô ( oto) xe máy 40 món chi tiết GD640",75000,75000,0,0
TIKI,o-to-xe-may-xe-dap,9834560,"Dầu nhớt tổng hợp dành cho xe côn Liqui Moly Synth Street  Race10W40 ",330000,330000,0,0
TIKI,o-to-xe-may-xe-dap,56329666,"Nẹp Chữ U Mạ Crom Trang Trí Và Chống Xước Viền Ô Tô",68997,68997,0,0
TIKI,o-to-xe-may-xe-dap,132899137,"Bóng đèn LED 12V T10 COB T10C-1",4000,4000,0,0
TIKI,o-to-xe-may-xe-dap,121978568,"Dầu ENEOS 20W-40 cho xe Ga - Hàng chính hãng",85000,85000,0,0
TIKI,o-to-xe-may-xe-dap,131192953,"Dè nối 2 râu dành cho ex 150 & 155",65000,65000,0,0
TIKI,o-to-xe-may-xe-dap,1254699,"Chai Xịt Phủ Gầm Đen Liqui Moly Stoneguard Black 6113 (500ml)",229000,229000,0,0
TIKI,o-to-xe-may-xe-dap,1254567,"Chất Tấy Rửa, Bôi Trơn, Chống Rỉ Sét 3M 5 Way (400ml)",70000,70000,0,0
TIKI,o-to-xe-may-xe-dap,1378139,"Paste Đánh Bóng 1 Bước Nhanh Chóng 3M Polish Finishing Material 81235 (1L)",620000,620000,0,0
TIKI,o-to-xe-may-xe-dap,136187475,"RÈM CHE NẮNG NAM CHÂM CHO XE TOYOTA FORTUNER 2008-2015",235600,248000,12400,5
TIKI,o-to-xe-may-xe-dap,117469914,"Cặp bao tay dành cho xe máy RCB gù nhôm CNC",115000,115000,0,0
TIKI,o-to-xe-may-xe-dap,37466648,"Hộp đựng khăn giấy hình chú khỉ siêu dể thương treo xe hơi ,bàn làm việc phòng ăn. Shop giao mầu ngẫu  nhiên",88683,164000,75317,46
TIKI,o-to-xe-may-xe-dap,97427098,"(HÀNG CHÍNH HÃNG) Kem đánh bóng kim loại Autosol Metal Polish 75ml - - ",59000,59000,0,0
TIKI,o-to-xe-may-xe-dap,38354744,"NƯỚc RỬa Xe KhÔng ChẠm VÀ RỬa Khoang ĐỘng CƠ Ekokemika Italy Bio 45 - (5l) - Hàng Chính Hãng",1050000,1050000,0,0
TIKI,o-to-xe-may-xe-dap,161527916," Kem tẩy gương, kính chiếu hậu ô tô TOKO 60 M - Tẩy ố gương, tẩy cặn canxi, ố mốc kính, đảm bảo an toàn gương có lớp chống chóa | Lựa chọn hàng đầu của GARAGE, Chăm sóc xe",199000,362000,163000,45
TIKI,o-to-xe-may-xe-dap,68521434,"Dụng Cụ Móc Lốp Xe, Lấy Đinh Gảy Đinh, Loại Bỏ Đá Trên Lốp 2 in 1 Với Cây Tua Vít Giúp Lấy Cạy Đinh, Loại Bỏ Đá Dăm/ Cát Lốp Xe Hơi Bảo Vệ Lốp Xe Hơi, Ô tô, Xe Tải",26899,26899,0,0
TIKI,o-to-xe-may-xe-dap,144097800,"Phuộc Sau - Vision ",265000,265000,0,0
TIKI,o-to-xe-may-xe-dap,189175790,"FULL ỐP PHỤ KIỆN TRANG TRÍ DÙNG CHO ĐỜI XE AB 2022 2023 2024 - 125 160cc CACBON",44200,44200,0,0
TIKI,o-to-xe-may-xe-dap,81794754,"Sơn Xịt Phủ Gầm Chống Ồn Chống Rỉ Sét Flamingo F021 500ml - Hãng Phân Phối Chính Thức",113041,118990,5949,5
TIKI,o-to-xe-may-xe-dap,153941749,"Thảm sàn, lót sàn cao su 3D cho Toyota Innova 2016-2019",813200,856000,42800,5
TIKI,o-to-xe-may-xe-dap,50584349,"Pô lon 4road inox dành cho xe vario / shvn / air blade 125",1979100,2199000,219900,10
TIKI,o-to-xe-may-xe-dap,5554157,"Bộ Đèn Led Xi Nhan 2 tầng Siêu Sáng Đẹp cho xe máy Exciter",45000,45000,0,0
TIKI,o-to-xe-may-xe-dap,98030779,"Bạt Phủ Xe Máy Chống Mưa, Nắng, Bụi Bẩn Chất Lượng Cao Chống Thấm Tuyệt Đối, Bao Trùm Cả Xe",47788,47788,0,0
TIKI,o-to-xe-may-xe-dap,152833353,"Kem xóa vết xước, đánh bóng ô tô xe máy",18900,18900,0,0
TIKI,o-to-xe-may-xe-dap,22828165,"Cần Số 2 Chiều Sơn Tỉnh Điện Cho Xe Exciter 150 MS1565 - Tặng Thêm 1 Pin AAA Maxell",78000,78000,0,0
TIKI,o-to-xe-may-xe-dap,87159024,"Chân chống cạnh - chống nghiêng dành cho xe Sirius, Jupiter (dễ dàng lắp đặt tại nhà ) - TA2425 ",194000,340480,146480,43
TIKI,o-to-xe-may-xe-dap,52236917,"Khay để đồ cài khe ghế ô tô cao cấp GK21",107998,107998,0,0
TIKI,o-to-xe-may-xe-dap,3148327,"Túi Treo Sườn Xe Đạp",35000,35000,0,0
TIKI,o-to-xe-may-xe-dap,155225591,"Bao Da Ép Phom dành cho Chìa Khoá Mercedes, Mec đời 2019 trở lên màu nâu 002e",399000,399000,0,0
TIKI,o-to-xe-may-xe-dap,38164829,"Kem Đánh Bóng Và Bảo Vệ Sơn Xe Màu Đen Sonax Polish & Wax Color Black 296141 250ml",180000,180000,0,0
TIKI,o-to-xe-may-xe-dap,53450914,"Bảng số điện thoại dạ quang ACNUM-B0S gắn taplo ô tô, xe hơi nhãn hiệu Baseus - Hàng Nhập Khẩu",113999,113999,0,0
TIKI,o-to-xe-may-xe-dap,97431774,"Chai xịt làm bóng da, dưỡng nhựa Telox Wax 500ml",45000,45000,0,0
TIKI,o-to-xe-may-xe-dap,13389629,"Bộ Sửa Chữa Vá Xăm Xe Đạp, Xe Máy Tiện Dụng",33000,33000,0,0
TIKI,o-to-xe-may-xe-dap,72592679,"Mobin dành cho xe SH Việt - 2848",187856,318400,130544,41
TIKI,o-to-xe-may-xe-dap,127546179,"Nút dán giảm lực đóng bảo vệ cửa xe ô tô, miếng dán Silicon bảo vệ cửa ô tô có logo các hãng",4000,4000,0,0
TIKI,o-to-xe-may-xe-dap,173447770,"Bộ dụng cụ kiểm tra áp bơm nhiên liệu xăng",193000,250000,57000,23
TIKI,o-to-xe-may-xe-dap,124274270,"Bọc Chân Thắng Cao Su Dùng Cho Xe Máy",9000,10000,1000,10
TIKI,o-to-xe-may-xe-dap,138043464,"(Chọn mẫu) Decal dán nắp capo xe ô tô chữ ký Sport mind, decan trang trí xe hơi, sticker Sport mind các đời xe,màu xe",30000,60000,30000,50
TIKI,o-to-xe-may-xe-dap,74238245,"Đệm hạt gỗ tựa lưng massage lót ghế ô tô, xe hơi làm từ 100% gỗ Hương Đỏ tự nhiên cao cấp (HD-D)",241000,339000,98000,29
TIKI,o-to-xe-may-xe-dap,41862396,"Lót Cốp Nhựa TPO Cao Cấp Dành Cho Hyundai Accent 2018/2020",334400,352000,17600,5
TIKI,o-to-xe-may-xe-dap,115623326,"Gioăng cao su chống ồn chữ B cho ô tô | Cuộn Ron cao su chữ B dài 10 mét cách âm chống ồn cho xe hơi",109000,109000,0,0
TIKI,o-to-xe-may-xe-dap,95937734,"Chốt cốp chữ T dành cho xe Honda -Dream -TKAs.505",64000,112320,48320,43
TIKI,o-to-xe-may-xe-dap,14867643,"Đèn Trợ Sáng Led Power 20W Dành Cho Xe Máy - SIÊU SÁNG - TIẾT KIỆM - Loại 1",72000,81949,9949,12
TIKI,o-to-xe-may-xe-dap,3259639,"Chân chống xe đạp 2 điểm pat cực chắc chắn",128000,128000,0,0
TIKI,o-to-xe-may-xe-dap,116105880,"Bao da dành cho chìa khoá gập Ford Focus, Ecosport, Fiesta, Ranger handmade da thật 002",199000,199000,0,0
TIKI,o-to-xe-may-xe-dap,35736205,"NANO SEALANT DẠNG XỊT BẢO VỆ LÀM MỚI SƠN MỜ CHEMICAL GUYS METICULOUS MATTE DETAILER 16OZ",650000,650000,0,0
TIKI,o-to-xe-may-xe-dap,49941007,"Bộ Gối Tựa Đầu Và Tựa Lưng Xe Hơi, Chất Liệu Cao Su Non Cao Cấp",270000,270000,0,0
TIKI,o-to-xe-may-xe-dap,48303526,"Chổi Lông Rửa Xe Cao Cấp Tiện Dụng",30000,30000,0,0
TIKI,o-to-xe-may-xe-dap,47255806,"heo dầu trước cho xe hayate tặng bao tay xe máy",195000,195000,0,0
TIKI,o-to-xe-may-xe-dap,92983558," ️Túi treo để đồ lưng ghế bằng da cao cấp, thiết kế thông minh có kèm bàn ăn gắp gọn cho xe ô tô️",240900,240900,0,0
TIKI,o-to-xe-may-xe-dap,138617419,"ống bơm bánh xe đạp và xe máy",35000,35000,0,0
TIKI,o-to-xe-may-xe-dap,176236651,"Cặp đèn xi nhan độ cho xe classic cafe",56000,56000,0,0
TIKI,o-to-xe-may-xe-dap,197926157,"Khóa Xe Đạp Khóa Mật Khẩu Xe Đạp Chống Trộm - Khóa dây 4 số bảo mật - Dây Xích Khóa Xe Đạp, Phụ Kiện Xe Đạp",52250,55000,2750,5
TIKI,o-to-xe-may-xe-dap,22230660,"DUNG DỊCH BẢO VỆ VÀ TĂNG CƯỜNG ĐỘ BÓNG  Sealing Wax Protection",859000,859000,0,0
TIKI,o-to-xe-may-xe-dap,92133107,"Ví đựng giấy tờ xe ô tô Mazda Da Cao Cấp, Ví da đựng giấy tờ xe ô tô - OTOALO",48000,62000,14000,23
TIKI,o-to-xe-may-xe-dap,100418392,"Ốc dàn áo dành cho xe exciter 150",159990,159990,0,0
TIKI,o-to-xe-may-xe-dap,7005929,"Bộ 3 sản phẩm xịt bảo dưỡng nội thất 39040, bảo dưỡng lốp 39042 và tăng độ bóng sơn 39034 3M COMBO-3DD-USA",854050,899000,44950,5
TIKI,o-to-xe-may-xe-dap,141799019,"Tem rời Exciter 2006-2010 Vàng đen (i)",189000,189000,0,0
TIKI,o-to-xe-may-xe-dap,196586398,"Dè chắn bùn xe đạp thể thao MTB leo núi, vè trước sau full hộp",120000,120000,0,0
TIKI,o-to-xe-may-xe-dap,127363851,"Hạn chế cửa (Dẫn hướng cửa ) dành cho Kia K3, Cerato 2012-2018",165000,165000,0,0
TIKI,o-to-xe-may-xe-dap,74895570,"YÊN GHẾ DÀNH CHO CÁC LOẠI XE TAY GA VÀ XE SỐ ( YÊN RỜI )",65000,65000,0,0
TIKI,o-to-xe-may-xe-dap,169929622,"Còi Chip 5V - Loại 9,5x12mm",5000,5000,0,0
TIKI,o-to-xe-may-xe-dap,181565325,"Thùng giữa givi G12N kèm bát gắn cho xe Jupiter RC",750000,750000,0,0
TIKI,o-to-xe-may-xe-dap,116965760,"Bao Da dành cho Chìa Khóa dày Vespa, Piaggio handmade da thật",100000,100000,0,0
TIKI,o-to-xe-may-xe-dap,26017460,"Bộ 2 ốp gương theo xe Vios 2019",230850,243000,12150,5
TIKI,o-to-xe-may-xe-dap,105184591,"Tem vành phản quang xe máy",61750,61750,0,0
TIKI,o-to-xe-may-xe-dap,95222640,"LÓT CỐP NHỰA DÀNH CHO XE KIA RIO SEDAN 2014-2019",328000,328000,0,0
TIKI,o-to-xe-may-xe-dap,21088438,"Bình 1L tạo bọt tuyết sử dụng cho máy cao áp",268880,336100,67220,20
TIKI,o-to-xe-may-xe-dap,25564858,"Thẻ Ghi Số Điện Thoại Kiêm Giá Để Điện Thoại Trên Taplo Ô Tô",60000,60000,0,0
TIKI,o-to-xe-may-xe-dap,52110029,"Phụ gia xúc béc dầu cao cấp Liqui Moly 1806 - Tặng kèm 1 khăn lau chuyên dụng 3M",209000,209000,0,0
TIKI,o-to-xe-may-xe-dap,120453354,"Sạc bình ắc quy 2A  6V 12V 4Ah - 40Ah tự ngắt khi đầy phục hồi ắc quy khử sunfat chống ngược cực",150000,150000,0,0
TIKI,o-to-xe-may-xe-dap,113230601,"GĂNG TAY RỬA XE SIÊU MỀM MÀU XANH SỢI MICROFIBER GIỮ BỌT MAXSHINE CRAZY MICRO-CHENILLE WASH MITT 24X17CM 1120003G",179000,179000,0,0
TIKI,o-to-xe-may-xe-dap,99275571,"Tấm Chắn Nắng, Chống Nóng Ngoài Kính Lái Ô Tô 3 Lớp, Tráng Bạc Cỡ Lớn 118cm x 148cm, Có Trùm Gương - Hàng chính hãng",119000,180000,61000,34
TIKI,o-to-xe-may-xe-dap,34961418,"Thảm Nhựa Lót Cốp Sau Dành Cho Xe Ô Tô Xpander",233000,268000,35000,13
TIKI,o-to-xe-may-xe-dap,36068156,"Vè Che Mưa Dành Cho Xe Ô Tô Innova 2018",287500,287500,0,0
TIKI,o-to-xe-may-xe-dap,131254067,"Lọc gió động cơ ô tô MAZDA 3 - 3S 2004-2013",90000,90000,0,0
TIKI,o-to-xe-may-xe-dap,35736730,"NƯỚC RỬA CHUYÊN CHO XE SƠN ĐẶC BIỆT CHEMICAL GUYS METICULOUS MATTE AUTO WASH FOR SATIN FINISH (16 OZ)",550000,550000,0,0
TIKI,o-to-xe-may-xe-dap,84870095,"Dung Dịch Rửa Lốc Máy Siêu Mạnh, Tẩy Khoang Máy, Đầu Bò PALLAS 500ml",39000,39000,0,0
TIKI,o-to-xe-may-xe-dap,40745733,"Bình xăng con OKO ga dẹp PWK 32 ",459000,459000,0,0
TIKI,o-to-xe-may-xe-dap,11221458,"Lốp Xe Piago Vespa LX DPLUS",450000,450000,0,0
TIKI,o-to-xe-may-xe-dap,36160831,"Combo 02 Chai xịt vệ sinh máy điều hòa (máy lạnh) Sandokkaebi 330ml nhập khẩu trực tiếp từ Hàn Quốc",189000,189000,0,0
TIKI,o-to-xe-may-xe-dap,72880242,"Tẩu sạc ô tô nhãn hiệu Hyundai HY-10 công suất 80W, một đầu chia tẩu và 3 cổng usb - Hàng nhập khẩu",105000,124000,19000,15
TIKI,o-to-xe-may-xe-dap,53979730,"Bộ Lục Giác Lắp Giáp, Sửa Chữa Xe Đạp",39000,39000,0,0
TIKI,o-to-xe-may-xe-dap,66205480,"NƯỚC RỬA XE BỌT TUYẾT CHUYÊN DỤNG BT01 [1Lít]",89000,99000,10000,10
TIKI,o-to-xe-may-xe-dap,9802835,"Bộ 4 ốp tay cửa chống xước và trang trí xe Mazda 2, Mazda 3, Mazda 6 và CX-5",179075,188500,9425,5
TIKI,o-to-xe-may-xe-dap,177300390,"Bộ ty thủy lực chống cốp sau Ford Escape mở cốp tự động",265050,265050,0,0
TIKI,o-to-xe-may-xe-dap,169343320,"Bộ 2 Chốt ngắt tiếng kêu, chốt cài dây an toàn Ô tô Mazda",70000,70000,0,0
TIKI,o-to-xe-may-xe-dap,6349635,"Mũ Bảo Hiểm 3/4 M139 - Cam Tem (Size",549000,549000,0,0
TIKI,o-to-xe-may-xe-dap,50703279,"Bao Da Chìa Khóa dành cho Ô Tô Mitsubishi outlander 3 Nút Da Bò Dạng Hộp",234000,249000,15000,6
TIKI,o-to-xe-may-xe-dap,166208963,"Đèn trợ sáng L4 moto hàng loại tốt siêu sáng chống nước tặng phụ kiện",256000,256000,0,0
TIKI,o-to-xe-may-xe-dap,154127086,"Bộ dụng cụ 12 món tháo mở nội ngoại thất xe ô tô",139286,149000,9714,7
TIKI,o-to-xe-may-xe-dap,11487635,"Tinh dầu treo xe hơi hương dưa hấu – Areon Fresco Watermelon (Dịu nhẹ)",250000,250000,0,0
TIKI,o-to-xe-may-xe-dap,105185322,"Ốp pô Winner X- vân cacbon, màu",114000,114000,0,0
TIKI,o-to-xe-may-xe-dap,120999272,"ic công suất LA4440",16990,16990,0,0
TIKI,o-to-xe-may-xe-dap,169099437,"Combo 5 bóng đèn sợi đôt BA15D 24V 25W (2 tim)",80000,80000,0,0
TIKI,o-to-xe-may-xe-dap,32901910,"Củ sạc điện thoại trên ô tô 2USB QC3.0 - Hàng nhập khẩu",150000,150000,0,0
TIKI,o-to-xe-may-xe-dap,28948798,"Túi đựng đồ cao cấp treo sau ghế ô tô - Hàng nhập khẩu",147250,155000,7750,5
TIKI,o-to-xe-may-xe-dap,14654930,"Decal Logo 3D Chữ Nổi AMG Dán Đuôi Xe Ô Tô",109000,109000,0,0
TIKI,o-to-xe-may-xe-dap,190109836,"Tấm đệm hạt gỗ Trắc 100% tự nhiên massage lót ghế làm việc, ghế sofa, ghế ô tô, yên xe máy",571000,571000,0,0
TIKI,o-to-xe-may-xe-dap,110146534,"Biển Cảnh Báo Nguy Hiểm Tam Giác Phản Quang Cho Xe Hơi (loại tốt)",61000,99000,38000,38
TIKI,o-to-xe-may-xe-dap,35603061," Đèn Pin Gắn Xe Đạp 5 Led Và Đèn Hậu Sau Xe",37800,200250,162450,81
TIKI,o-to-xe-may-xe-dap,192124544,"Găng Tay Sport BeastFashion - Găng tay tập GYM - Đen",55000,55000,0,0
TIKI,o-to-xe-may-xe-dap,111361008,"Nẹp Chân Kính Inox Dành Cho Xe VIOS 2019 2020 2021 - chất liệu inox - 6 chi tiết",198550,209000,10450,5
TIKI,o-to-xe-may-xe-dap,137954202,"Lọc xăng có nam châm lớn giữ cặn bẩn trong xăng",6000,6000,0,0
TIKI,o-to-xe-may-xe-dap,157146564,"Bao Da Chìa Khóa Dành Cho Xe Ford Ecosport, Focus, Fiesta Da Thật Mẫu Chìa Thông Minh",119000,128000,9000,7
TIKI,o-to-xe-may-xe-dap,186161140,"Bộ ốp nẹp sườn Xpander 2018-2019-2020-2021-2022 mạ crom trang trí làm đẹp xe",449000,449000,0,0
TIKI,o-to-xe-may-xe-dap,117597712,"COMBO 2 Bình xịt dưỡng bóng lốp xe ô tô, xe máy Flamingo Tire Shine 500ml",172000,193000,21000,11
TIKI,o-to-xe-may-xe-dap,122411885,"Hộp tỳ tay xe hơi Hyundai Accent 2014 - 2016 tích hợp 6 cổng USB, chất liệu nhựa ABS và da PU cao cấp",521000,521000,0,0
TIKI,o-to-xe-may-xe-dap,14643363,"Rèm che nắng ô tô 6 tấm cao cấp gấp gọn tiện lợi",93100,98000,4900,5
TIKI,o-to-xe-may-xe-dap,165145585,"Đèn led mini DJ cảm ứng nháy theo nhạc trang trí ô tô, quả cầu ma thuật",199000,199000,0,0
TIKI,o-to-xe-may-xe-dap,33175224,"Logo Cánh Chim Ưng 3D Dán Cho Các Loại Xe Ô Tô Màu Vàng",32000,32000,0,0
TIKI,o-to-xe-may-xe-dap,196586384,"Tay đề xe đạp bấm xả 3x7. kèm tay thắng full nhôm có dây đề đi kèm bọ tay trái tay phải",150000,150000,0,0
TIKI,o-to-xe-may-xe-dap,49055424,"bộ chụp xi nhan cho xe DYLAN tặng bao tay xe máy",139000,139000,0,0
TIKI,o-to-xe-may-xe-dap,68442066,"bố thắng trước wave s110 recto",78000,78000,0,0
TIKI,o-to-xe-may-xe-dap,511348,"Che Chống Nắng Phản Quang Tròn Hando",62000,62000,0,0
TIKI,o-to-xe-may-xe-dap,1254641,"Dung Dịch Tăng Chỉ Số Octan Cho Xăng Bluechem Octane Booster (250ml)",250000,250000,0,0
TIKI,o-to-xe-may-xe-dap,83809831,"Bao da chìa khóa Ducati Diavel 1260S - CHÍNH HÃNG KHACTEN.COM",400000,400000,0,0
TIKI,o-to-xe-may-xe-dap,118235411,"Bố Thắng Trước Ford Transit (2000-2006) - Bosch BP 4047",254000,254000,0,0
TIKI,o-to-xe-may-xe-dap,160749647,"Hộp đựng khăn giấy ô tô xe hơi chất liệu da cao cấp có đồng hồ và bảng số điện thoại",202000,202000,0,0
TIKI,o-to-xe-may-xe-dap,169343286,"Bộ 2 Chốt ngắt tiếng kêu, chốt cài dây an toàn Ô tô Honda",67998,67998,0,0
TIKI,o-to-xe-may-xe-dap,138387794,"Đồng hồ đo áp suất động cơ dầu, dụng cụ đo áp suất động cơ diesel TU -15B",641000,641000,0,0
TIKI,o-to-xe-may-xe-dap,97979747," Gioăng B zoăng B CUỘN 5m giảm chấn chống ồn cửa xe nắp capo nắp cốp ô tô xe hơi",56580,61500,4920,8
TIKI,o-to-xe-may-xe-dap,123434088,"{Giá sỉ} Vòng bi, bạc đạn 606,607,608, RBI mới 100%, -Giadung24h",9450,9450,0,0
TIKI,o-to-xe-may-xe-dap,114994813,"Tay mở cửa trong Mitsubishi Jolie",200000,200000,0,0
TIKI,o-to-xe-may-xe-dap,177309832,"Ốp viền đèn gầm trước xe Innova 2013-2014-2015-2016 mạ Crom chống trầy trang trí làm đẹp xe",195000,195000,0,0
TIKI,o-to-xe-may-xe-dap,188705625,"Sơn xịt phủ gầm xe hơi ô tô chống rỉ mọt bảo vệ gầm xe, flamingo rubberized undercoat F021 hàng chính hãng",117600,117600,0,0
TIKI,o-to-xe-may-xe-dap,89951217,"Túi đựng đồ treo thành ghế ô tô 3P Auto 206142",31100,69000,37900,55
TIKI,o-to-xe-may-xe-dap,11499357,"Khóa chống trộm có còi báo động",74700,74700,0,0
TIKI,o-to-xe-may-xe-dap,118085211,"Bố Thắng (Bố Càng Sau) Ford Transit (-2006) - Bosch BP 1542",637000,637000,0,0
TIKI,o-to-xe-may-xe-dap,92132737,"Bọc Vô Lăng Da dành cho Xe Nissan XTrail Lót Cao Su Non Cao Cấp Chống Trượt Tay",249339,249339,0,0
TIKI,o-to-xe-may-xe-dap,5032663,"Combo 1 túi thơm cafe Hàn Quốc kèm chai xịt tinh dầu Korea và Bộ 2 gel thơm cà phê Status cho ô tô",239000,239000,0,0
TIKI,o-to-xe-may-xe-dap,140217822,"Đệm hơi ô tô tiện dụng phiên bản mới cao cấp từ 4 đến 7 chỗ - nệm hơi, giường hơi xe hơi",394250,415000,20750,5
TIKI,o-to-xe-may-xe-dap,34556159,"Bọc vô lăng tay lái ô tô da vân Carbon 4S logo HONDA cao cấp",145000,250000,105000,42
TIKI,o-to-xe-may-xe-dap,132820357,"Dù Che Kính Lái Ô Tô- Chống Nắng, Bảo Vệ Nội Thất Xe Hơi",73981,73981,0,0
TIKI,o-to-xe-may-xe-dap,139444501,"Bộ dè chắn bùn xe máy siêu cấp XP2 mẫu mới siêu ngầu loại dày đẹp hàng cao cấp chống rung",196000,196000,0,0
TIKI,o-to-xe-may-xe-dap,121330050,"Đèn led chợ sáng cao cấp L5-9 mắt chống nước tuyệt đối cho xe máy xe điện",59000,59000,0,0
TIKI,o-to-xe-may-xe-dap,186161147,"Bộ ốp tapli CR-V, CRV 2018-2019-2020-2021-2022 vân Titan chống xước va đập khi mở cửa và làm đẹp xe",479000,479000,0,0
TIKI,o-to-xe-may-xe-dap,32166615,"Sạc ắc quy 12V-2A ô tô xe máy thông minh tự ngắt khi đầy chống ngược cực có màn hình hiển thị (Vàng)",64000,64000,0,0
TIKI,o-to-xe-may-xe-dap,23944229,"Decal Tem Chữ Discovery 3D Kim Loại Dán Trang Trí Ô Tô - màu Crom",59000,59000,0,0
TIKI,o-to-xe-may-xe-dap,41293830,"Bộ ốp tay nắm hõm cửa VINFAST FADIL 2019/2020",129960,136800,6840,5
TIKI,o-to-xe-may-xe-dap,20542142,"Tem Logo Nổi Chữ 3D Dán Trang Trí Ô Tô Xe Máy SPORT AZONE",50000,69000,19000,28
TIKI,o-to-xe-may-xe-dap,54476251,"Nón bảo hiểm 3/4 kính âm Royal M139 Vàng Cam cao cấp Lót tháo rời, che hết mặt",499000,499000,0,0
TIKI,o-to-xe-may-xe-dap,92316799,"Bình chữa cháy mini Foam 500ml 1000ml dùng cho xe hơi",39000,39000,0,0
TIKI,o-to-xe-may-xe-dap,144324725,"(HÀNG ĐẸP) Dù Che Nắng Ô Tô Cao Cấp, Dù Che Kính Lái Xe Hơi (Tặng BAO DA) - Chống Nắng, Bảo Vệ Nội Thất",98978,98978,0,0
TIKI,o-to-xe-may-xe-dap,136187554,"RÈM CHE NẮNG NAM CHÂM CHO XE KIA SOLUTO",226100,238000,11900,5
TIKI,o-to-xe-may-xe-dap,54779162,"Chai xịt làm bóng và bảo dưỡng lốp xe ô tô Sonax 235300 dung tích 400 ml",442000,442000,0,0
TIKI,o-to-xe-may-xe-dap,117598485,"COMBO 2 chiếc Lọc gió điều hòa Chevrolet Colorado, Trailblazer than hoạt tính",299000,299000,0,0
TIKI,o-to-xe-may-xe-dap,80696783,"Dàn áo dành cho Honda Wave nhỏ loại 1 màu Xanh Nhớt",950000,950000,0,0
TIKI,o-to-xe-may-xe-dap,108246627,"Sáp thơm xe Yankee Candle - Beach Walk",199000,279000,80000,29
TIKI,o-to-xe-may-xe-dap,9883125,"Túi yên xe đạp Lezyne Energy Caddy",450000,450000,0,0
TIKI,o-to-xe-may-xe-dap,7398805,"Camera Lùi Cho Xe Hơi 8 Led",139000,139000,0,0
TIKI,o-to-xe-may-xe-dap,54749509,"Bọc vô lăng ô tô Tặng Bảng Số Điện Thoại - Bọc vô lăng Xe Hơi",74000,78000,4000,5
TIKI,o-to-xe-may-xe-dap,244290102,"Gạt mưa ô tô xe Toyota Vios  2020",130000,130000,0,0
TIKI,o-to-xe-may-xe-dap,42504433,"Dầu hộp số tự động Trợ lực tay lái Kixx ATF DX VI 1L",145000,145000,0,0
TIKI,o-to-xe-may-xe-dap,7798220," Combo Dây Xịt Rửa Xe Áp Lực (15m) Và Súng",219000,219000,0,0
TIKI,o-to-xe-may-xe-dap,196028399,"Bình phun tạo bọt tuyết rửa xe ô tô , xe máy cầm tay 2000ML tiện dụng",159000,159000,0,0
TIKI,o-to-xe-may-xe-dap,150929607,"Xe đạp Thống Nhất mini New 26-Hàng chính hãng",2348000,2348000,0,0
TIKI,o-to-xe-may-xe-dap,173463497,"Móc treo xe đạp lên tường MTR02, giá treo xe đạp 2 móc đỏ siêu chắc chắn  (kèm ốc vít) Mai Lee ",119000,159000,40000,25
TIKI,o-to-xe-may-xe-dap,12207786,"Mũ bảo hiểm 3/4 Asia M115 kính gương",296000,296000,0,0
TIKI,o-to-xe-may-xe-dap,136879029,"Máy bơm lốp xe ô tô di động A03 đồng hồ điện tử ( KIÊM ĐO ÁP SUẤT LỐP, ĐÈN PIN, SẠC DỰ PHÒNG )",1650000,1650000,0,0
TIKI,o-to-xe-may-xe-dap,41379540,"Cảm Biến Áp Suất Lốp Ô Tô steelmate  E3 Van Trong - Van Ngoài",1085000,1085000,0,0
TIKI,o-to-xe-may-xe-dap,49451282,"Máy lọc không khí ô tô Airshot Road | Sản phẩm chính hãng Hàn Quốc | Sử dụng công nghệ đèn LED UV khử trùng mạnh mẽ",1399000,1700000,301000,18
TIKI,o-to-xe-may-xe-dap,119719099,"Ắc quy GS khô GTZ6V PCX Vision Lead125, Sh Việt Airblade 125 Winner Grande STD acquy shvn vn Air Blade ab 125 MF 5A 5ah",380000,380000,0,0
TIKI,o-to-xe-may-xe-dap,131337458,"Găng tay phượt Sports cao cấp, găng đi xe máy có gù bảo vệ",45000,45000,0,0
TIKI,o-to-xe-may-xe-dap,72575483,"[Mẫu Mới] Nhớt cao cấp cho xe tay ga đời mới Motul Scooter Power LE 5W40 800ml tặng nhớt hộp số Motul Gear 80W90 120ml",209000,209000,0,0
TIKI,o-to-xe-may-xe-dap,24004833,"Túi Da Xịn Đựng Đăng Kiểm, Giấy Tờ Cho Ô tô logo Toyota",27000,27000,0,0
TIKI,o-to-xe-may-xe-dap,5034929,"Đèn LED Gắn Trần Nội Thất Xe Ô Tô (2 Cái)",78000,78000,0,0
TIKI,o-to-xe-may-xe-dap,53247443,"Máy bơm lốp ô tô, xe hơi tự ngắt Michelin 4398ML (12266) động cơ mạnh mẽ 180W cho áp suất tối đa 150PSI, tốc độ bơm nhanh 35l/phút",1025000,1025000,0,0
TIKI,o-to-xe-may-xe-dap,72957962,"Thùng đựng đồ đa năng cốp sau ô tô bọc da cao cấp , có nắp gấp, gọn gàng , ngăn nắp chứa được nhiều đồ size lớn nhất 70x32x30",483000,499000,16000,3
TIKI,o-to-xe-may-xe-dap,892513,"Chai Xịt Bảo Dưỡng Lốp Xe Ô Tô 3M 39042 LT 3M Tire Dressing (400ml)",175000,182000,7000,4
TIKI,o-to-xe-may-xe-dap,65465000,"DUNG DỊCH PHỤC HỒI LỐP XE ĐEN BÓNG [Bình xịt 511ml]",119000,129000,10000,8
TIKI,o-to-xe-may-xe-dap,47353118,"Đèn Led Gắn Van Xe Đạp,Xe Máy,Ô Tô Kiểu 5 BÓNG LED",39900,39900,0,0
TIKI,o-to-xe-may-xe-dap,38151399,"KHÓA DÂY XE ĐẠP MASTERLOCK 8126EURD",150000,150000,0,0
TIKI,o-to-xe-may-xe-dap,172948758,"BAO DA MÓC CHÌA KHÓA",107018,107018,0,0
TIKI,o-to-xe-may-xe-dap,11238036,"Bộ đèn pin gắn xe đạp và đèn chiếu hậu 5 LED WJ-101",32200,64889,32689,50
TIKI,o-to-xe-may-xe-dap,162766172,"Máy đo áp suất lốp ô tô, đồng hồ đo áp suất lốp, đo áp suất không khí chính xác dành cho xe hơi",32000,32000,0,0
TIKI,o-to-xe-may-xe-dap,73795218,"Tay Càng Chống Mỏi, Tay Nghỉ Gắn Ghi Đông Xe Đạp Thể Thao Đua Hợp Kim Nhôm Trọng Lượng Nhẹ (Dài 34cm) Mai Lee",225000,269000,44000,16
TIKI,o-to-xe-may-xe-dap,118102135,"Bộ chắn bùn xe đạp thể thao trước và sau CBXT01",68000,68000,0,0
TIKI,o-to-xe-may-xe-dap,56270270,"Miếng Dán Chống Trượt Điện Thoại Trên Ô Tô, Xe Hơi ",12900,12900,0,0
TIKI,o-to-xe-may-xe-dap,58705244,"Bạt trùm xe máy, áo trùm xe vải dù cao cấp 220cm x 115cm che vừa vặn tất cả các loại xe máy - giao màu ngẫu nhiên",99000,99000,0,0
TIKI,o-to-xe-may-xe-dap,178058023,"Bơm xe đạp bơm xe máy XT02 - ống bơm đa năng gia dụng dài đến 58cm áp suất 150PSI - Hỗ trợ van Mỹ và van Pháp",99000,118000,19000,16
TIKI,o-to-xe-may-xe-dap,57060019,"Cuộn Nẹp Cacbon Chống Xước Bậc Cửa Xe Cho Xe Ô Tô, Xe Hơi",30000,30000,0,0
TIKI,o-to-xe-may-xe-dap,56021137,"Bộ 5 Tấm Chắn Nắng Cách Nhiệt Cho Ô Tô Đế Hút Chân Không ",79000,79000,0,0
TIKI,o-to-xe-may-xe-dap,179561742,"Bọc chìa khóa Smartkey Honda mẫu mới 2 nút nhựa TPU kèm móc khóa thời trang, sang trọng",125000,125000,0,0
TIKI,o-to-xe-may-xe-dap,88003230,"Bơm mini đạp chân - Bơm đa năng - Bơm được xe đạp, xe máy, các loại bóng, phao",99000,99000,0,0
TIKI,o-to-xe-may-xe-dap,35507865,"Bơm lốp ô tô, xe hơi điện tử thông minh AIKESI, cài đặt số cân & tự ngắt",304995,304995,0,0
TIKI,o-to-xe-may-xe-dap,31897046,"KEM XÓA XƯỚC CHO BỀ MẶT SƠN, NHỰA, KÍNH AUTOSOL SCRATCH REMOVER #1300 75ML",179000,179000,0,0
TIKI,o-to-xe-may-xe-dap,88921228,"Decal phản quang 3M serie 983 (1 mét lẻ) - Phản quang cho xe ô tô",60000,60000,0,0
TIKI,o-to-xe-may-xe-dap,173853680,"Keo Xịt Đa Năng 3M Super 77 - 375g",160000,165000,5000,3
TIKI,o-to-xe-may-xe-dap,107799046,"Dụng Cụ Rửa Xe Hơi Ô Tô Tự Xoay 360 Độ, Rửa Xe Hơi Kết Hợp Bàn Chải Cọ Tự Động, Xoay Tròn 360, Tháo Lắp Dễ Dàng",300000,300000,0,0
TIKI,o-to-xe-may-xe-dap,84552254,"BÌNH CHỮA CHÁY BỘT MFZ1 BC 1KG",145000,160000,15000,9
TIKI,o-to-xe-may-xe-dap,96989743,"Ô che nắng, chắn tia UV kính lái ô tô đa năng - Chất liệu: (vải dù) keo bạc titan - Kích thước: 80x145cm",71000,94000,23000,24
TIKI,o-to-xe-may-xe-dap,53650151,"Đèn pha led xe máy 2 chân siêu sáng cho xe đời cũ",89990,89990,0,0
TIKI,o-to-xe-may-xe-dap,145656762,"Decor bộ mèo thần tài, trang trí taplo ô tô vô cùng đáng yêu , phụ kiện xe hơi sáng tạo, hoặc để bàn làm việc",189050,199000,9950,5
TIKI,o-to-xe-may-xe-dap,134235156,"Khóa dây cáp chống cắt trộm nhà cửa xe đạp xe máy",31000,31000,0,0
TIKI,o-to-xe-may-xe-dap,134739159,"[COMBO]Gối tựa đầu tựa lưng dùng trên ô tô xe hơi, văn phòng cao su non bọc nỉ siêu đàn hồi",270000,270000,0,0
TIKI,o-to-xe-may-xe-dap,29322703,"Gel Silicone Làm Sạch Bụi Bẩn Ô Tô Bàn Phím Máy Tính",5900,5900,0,0
TIKI,o-to-xe-may-xe-dap,192890966,"CỤM GIÁ ĐỂ HÀNG JUPITER FINN",199000,199000,0,0
TIKI,o-to-xe-may-xe-dap,1176187,"Vệ Sinh Thắng Đĩa, Máy, Sên Không Phốt Liqui Moly 3318 (500ml)",109250,115000,5750,5
TIKI,o-to-xe-may-xe-dap,137016772,"Bao Tay Xe Máy Găng Tay Hở Ngón Cực Ngầu Dành Cho Các Phượt Thủ, Biker, Cần Thủ, Người Đi Xe Máy",25000,25000,0,0
TIKI,o-to-xe-may-xe-dap,115623175,"Dung Dịch Dưỡng, Phục Hồi Nhựa Nhám, Làm Đen nhựa nhám, Làm Mới Ghế Da DASHBOARD WAXING 450ml",199000,199000,0,0
TIKI,o-to-xe-may-xe-dap,126509905,"Bộ 2 bánh phụ xe đạp trẻ em có đèn LED",75000,75000,0,0
TIKI,o-to-xe-may-xe-dap,44957436,"Nón Bảo Hiểm Trẻ Em 1/2 Đầu Có Kính Protec Kitty, Họa Tiết Captain American - Hàng Chính Hãng",368000,442000,74000,17
TIKI,o-to-xe-may-xe-dap,107980194,"Đèn led trần, led cốp, đèn đọc sách cho xe hơi ô tô Green Networks Group ( 1 Đèn )",29000,29000,0,0
TIKI,o-to-xe-may-xe-dap,136598239,"DÈ CHẮN BÙN BỌC SÊN EXCITER 155 VÀ 150 BÁNH LỚN, DÙNG ĐẾN BÁNH SIZE140 KÈM PAS CHẾ INOX KHÔNG HÍCH CNC VÀ ỐC",99000,99000,0,0
TIKI,o-to-xe-may-xe-dap,117598477,"Nước làm mát động cơ xe ô tô màu xanh Esna Coolant",19000,19000,0,0
TIKI,o-to-xe-may-xe-dap,194453368,"Bình phun tạo bọt tuyết rửa xe ô tô , xe máy cầm tay 2000ML tiện dụng",151000,238000,87000,37
TIKI,o-to-xe-may-xe-dap,98029901,"Tấm Chắn Nắng Ô Tô - Tấm Che Nắng Ô Tô Xốp Bạc Dày Dặn",30000,32000,2000,6
TIKI,o-to-xe-may-xe-dap,107124574,"Hộc đựng đồ đa năng trong xe ô tô",350000,350000,0,0
TIKI,o-to-xe-may-xe-dap,75400735,"Sạc bình ắc quy 12V 24V 6-150Ah sạc pin lithium thông minh tự ngắt khi đầy có chức năng khử sunfat phục hồi ắc quy sạc bình ắc quy ô tô",255000,255000,0,0
TIKI,o-to-xe-may-xe-dap,139062651,"Combo 4 Núm Cao su giảm chấn , chống va đập cửa xe Ô tô theo Logo Xe ( 9 Logo )",31000,31000,0,0
TIKI,o-to-xe-may-xe-dap,25603097,"Khăn Lau Xe Ô Tô Đa Năng Siêu Thấm. Kích Thước 30cm x 30cm",6999,6999,0,0
TIKI,o-to-xe-may-xe-dap,126223621,"NƯỚC LÀM MÁT KHOANG MÁY Ô TÔ [ 5 Lít ]",199000,239000,40000,17
TIKI,o-to-xe-may-xe-dap,120789319,"GIÁ SỈ  Đèn xi nhan xe đạp điều khiển từ xa không dây có loa FY-1820",160000,160000,0,0
TIKI,o-to-xe-may-xe-dap,71945862,"Nước rửa khoang máy, gầm xe, mâm xe ô tô, mô tô, xe máy [Bình xịt 511ml]",99000,129000,30000,23
TIKI,o-to-xe-may-xe-dap,101411966,"Bàn chải vệ sinh sên xe máy cao cấp 3D",15000,15000,0,0
TIKI,o-to-xe-may-xe-dap,63249958,"Tẩu sạc ô tô cao cấp 2 cổng USB",43000,43000,0,0
TIKI,o-to-xe-may-xe-dap,271370123,"Xe đạp địa hình Thống Nhất MTB26-05 đen mờ - Hàng chính hãng",3390000,3390000,0,0
TIKI,o-to-xe-may-xe-dap,19482155,"Đồng Hồ Đo Tốc Độ Chống Nước Cho Xe Đạp Thể Thao",65000,65000,0,0
TIKI,o-to-xe-may-xe-dap,110987613,"Miếng Lót Chân Chống Xe Máy Tránh Gây Tổn Thương Chân",5900,5900,0,0
TIKI,o-to-xe-may-xe-dap,208206856,"Mũ bảo hiểm lỗ thông gió chính hãng NÓN SƠN TG-XM151",325000,650000,325000,50
TIKI,o-to-xe-may-xe-dap,2799693,"Giá Đỡ Điện Thoại Trên Ô TÔ One -  Touch",30999,30999,0,0
TIKI,o-to-xe-may-xe-dap,72796216,"Dầu Bôi Trơn Tra Sên Xích Xe Đạp Cho Xe Đạp Leo Núi, Xe Đạp Thể Thao Giúp Làm Sạch Xích, Chống Ăn Mòn, Bám Bụi, An Toàn Môi Trường 60ml",99000,99000,0,0
TIKI,o-to-xe-may-xe-dap,80782846,"Chân chống xe đạp trẻ em",39000,50000,11000,22
TIKI,o-to-xe-may-xe-dap,141258388,"Nước làm mát động cơ ô tô màu đỏ chuyên dụng [5 Lít] ",199000,239000,40000,17
TIKI,o-to-xe-may-xe-dap,87848828,"Đệm Hơi ô tô,Nệm hơi xe ô tô Cao Cấp Chất Liệu Vải Nhung",313000,555000,242000,44
TIKI,o-to-xe-may-xe-dap,35930998,"Khung Gắn Biển Số ( Khung, Viền, Kính, Ốc Gắn ) Cho Tất Cả Loại Xe STĐA Hoàng Long - Hàng Cao Cấp",36000,36000,0,0
TIKI,o-to-xe-may-xe-dap,186242651,"Móc Treo Đồ Gắn Ghế Xe Hơi Tiện Dụng",7900,7900,0,0
TIKI,o-to-xe-may-xe-dap,68564784,"Bộ 2 Gương xe đạp, xe đạp điện cao cấp (kèm chốt gắn ghi-đông lỗ 8mm) xoay 360 độ chắc chắn, gương phẳng, góc lớn giúp đạp xe an toàn Mai Lee",136000,159000,23000,14
TIKI,o-to-xe-may-xe-dap,139445958,"Móc Treo Đồ Xe Máy -2 Móc Xoay 180 độ mẫu mới loại dày đẹp hàng cao cấp lắp cho các xe máy xe điện",69000,69000,0,0
TIKI,o-to-xe-may-xe-dap,47990530,"Ví đựng giấy tờ xe hơi, ô tô cao cấp VD-01",19000,34500,15500,45
TIKI,o-to-xe-may-xe-dap,14289778,"Cần số Titan dành cho xe Wave",75000,75000,0,0
TIKI,o-to-xe-may-xe-dap,83429308,"Bộ 2 gương cầu lồi gắn kính chiếu hậu xe hơi và xe máy",28000,28000,0,0
TIKI,o-to-xe-may-xe-dap,91973091,"Gối tựa cổ cao su non trên ô tô bảo vệ cổ, lưng, cột sống khi lái xe -Gối tựa cổ cao su non trên ô tô bảo vệ cổ, lưng",180000,180000,0,0
TIKI,o-to-xe-may-xe-dap,95548243,"Tẩu sạc nhanh ô tô QC 3.0 chia 2 nguồn sạc usb 5V/6.2A nguồn DC 12V/24V sử dụng cho tất cả các dòng xe ô tô",88000,88000,0,0
TIKI,o-to-xe-may-xe-dap,97972878,"Thùng Rác Oto Mini, Hộp chứa Rác Xe Hơi Dễ Thương màu đen",75000,75000,0,0
TIKI,o-to-xe-may-xe-dap,127198691,"MIẾNG DECAL CÓ LOGO DÁN BẢO VỆ BẬC CHÂN XE Ô TÔ , MIẾNG DÁN CHỐNG TRẦY XƯỚC BẬC CHÂN XE ÔTÔ CÓ LOGO Theo Xe",90000,90000,0,0
TIKI,o-to-xe-may-xe-dap,182456852,"Túi than hoạt tính TTAUTO 100% từ gáo dừa Bến Tre khử mùi diệt khuẩn trên ô tô, tủ đồ, phòng tắm - Túi 150 Gram",33000,65000,32000,49
TIKI,o-to-xe-may-xe-dap,89942977,"Dụng cụ vệ sinh bàn chải chổi cọ vành lốp xe ô tô xe máy sợi cước cao cấp 206158",22200,50000,27800,56
TIKI,o-to-xe-may-xe-dap,72333316,"Máy Khuếch Tán Tinh Dầu Xe Hơi Cao Cấp và Chuyên Dụng, Máy Xông Tinh Dầu Dùng Điện USB Trên Xe ô tô, Đèn LED Cực Đẹp, Không Dùng Lõi Bông",198000,556000,358000,64
TIKI,o-to-xe-may-xe-dap,189946571,"Tấm tựa lưng ghế ô tô, tấm tựa lưng đa năng cho ghế ô tô hoặc ghế văn phòng - Hàng chính hãng ",43000,120000,77000,64
TIKI,o-to-xe-may-xe-dap,181908818,"Xe đạp Thống Nhất thể thao M26-01 - Hàng chính hãng",3549000,3549000,0,0
TIKI,o-to-xe-may-xe-dap,128710056,"Combo 2 Đèn LED Gắn Van Bánh Xe Đạp, Xe Máy, Ô Tô",26499,26499,0,0
TIKI,o-to-xe-may-xe-dap,53626686,"Ghế Ngồi Gắn Xe Đạp An Toàn Cho Bé Song Long",127000,175000,48000,27
TIKI,o-to-xe-may-xe-dap,118298811,"Giỏ xe đạp Khung thép",250000,250000,0,0
TIKI,o-to-xe-may-xe-dap,44000599,"Sạc điện thoại trên xe máy thông qua bình xe",69000,69000,0,0
TIKI,o-to-xe-may-xe-dap,177830682,"Chắn bùn xe đạp Kiotool Touring, Fixed, 700c",65000,65000,0,0
TIKI,o-to-xe-may-xe-dap,71918313,"Bộ 12 miếng decal phản quang dán ô tô, xe máy",19000,19000,0,0
TIKI,o-to-xe-may-xe-dap,13239149,"Đệm ngồi lót ghế ô tô cao su thoáng khí hỗ trợ tuần hoàn máu E3-L206",74794,74794,0,0
TIKI,o-to-xe-may-xe-dap,130168640,"Đèn Led Xe Đạp nhấp nháy gắn đuôi xe đạp, tay lái, nón bảo hiểm, báng xe - siêu sáng, tuổi thọ dài, chống nước, tăng độ an toàn khi đạp xe ban đêm",23750,25000,1250,5
TIKI,o-to-xe-may-xe-dap,18288302,"Ghế Xe Đạp Trẻ Em Song Long - Màu Ngẫu Nhiên",126000,126000,0,0
TIKI,o-to-xe-may-xe-dap,11204849,"Túi treo đầu xe máy mẫu mới siêu bền",189000,189000,0,0
TIKI,o-to-xe-may-xe-dap,35911745,"Bộ 4 Khăn lau xe hơi, ô tô, xe máy đa năng chuyên dụng cao cấp siêu thấm hút nước mạnh giúp vệ sinh chăm sóc ô tô/ xe máy sạch sẽ - Hàng chính hãng",84550,89000,4450,5
TIKI,o-to-xe-may-xe-dap,75548106,"Tẩu sạc nhanh ô tô cao cấp tự điều chỉnh độ dài dây sạc usb",199000,199000,0,0
TIKI,o-to-xe-may-xe-dap,22027685,"Gương Cầu Lồi Đa cực 360 Độ Gắn Gương Chiếu Hậu Ô Tô",10000,10000,0,0
TIKI,o-to-xe-may-xe-dap,82459827,"Đèn Hậu Xe Đạp 3 Bóng Đèn Sau Xe Đạp Giúp Cảnh Báo Đạp Xe/Chạy Bộ Ban Đêm Sạc USB Mai Lee",94000,99000,5000,5
TIKI,o-to-xe-may-xe-dap,143292192,"Túi Treo Xe Đạp Thể Thao B-Soul01 40cm - Túi Đeo Xe Đạp Địa Hình Chống Nước - Phụ Kiện Xe Đạp Chính Hãng",106400,112000,5600,5
TIKI,o-to-xe-may-xe-dap,134230819,"Giá chở hàng đa năng- Baga- Cáng chở hàng dành cho các loại xe máy, mở cốp tiện lợi 60x70cm",289000,289000,0,0
TIKI,o-to-xe-may-xe-dap,25454895,"Bộ 2 miếng dán chống nước gương chiếu hậu xe hơi",37000,37000,0,0
TIKI,o-to-xe-may-xe-dap,1254773,"Kem Xóa Vết Xước Sơn Xe Hơi Liqui Moly Kratzer Stop 2320 (200ml)",170050,179000,8950,5
TIKI,o-to-xe-may-xe-dap,146240539,"1 ĐÈN PHA LED 6 TIM SIÊU SÁNG XE MÁY XE HƠI ÔTÔ MẪU MỚI LOẠI TỐT",199000,199000,0,0
TIKI,o-to-xe-may-xe-dap,48887218,"Combo Xịt Dưỡng sên Thunder Chain Lube 400ml, Vệ sinh sên MC-40 400ml tặng bàn chải chà sên 3D",117000,117000,0,0
TIKI,o-to-xe-may-xe-dap,1254663,"Dung Dịch Vệ Sinh Ghế Da Ghế Nỉ Liqui Moly 1539 (300ml)",166250,175000,8750,5
TIKI,o-to-xe-may-xe-dap,45228856,"gương chiếu hậu 744 dành cho các loại xe máy",189000,189000,0,0
TIKI,o-to-xe-may-xe-dap,176419459,"BẠT TRÙM / TẤM PHỦ TẤT CẢ CÁC LOẠI XE MÁY KÍCH THƯỚC 220x115cm, LÀM TỪ VẢI DÙ 2 DA CAO CẤP ,BỀN ĐẸP, CHỐNG MƯA NẮNG",140000,140000,0,0
TIKI,o-to-xe-may-xe-dap,118298081,"Đệm lót baga sau xe đạp bọc da Kích thước 32x16x5cm",99000,99000,0,0
TIKI,o-to-xe-may-xe-dap,95548201,"Rèm che nắng cửa xe ô tô xe hơi rèm lụa hít nam châm mẫu mới cao cấp",131000,157000,26000,17
TIKI,o-to-xe-may-xe-dap,94421463,"Máy phun sương tạo ẩm, xông tinh dầu trên xe ô tô, xe hơi nhãn hiệu Baseus DHSG-OG Công suất: 5W - Hàng nhập khẩu",330899,330899,0,0
TIKI,o-to-xe-may-xe-dap,142430480,"Xi nhan led kiểu ( cho xe vario, click, ex, winnerx...) ( 1 cặp)",60000,60000,0,0
TIKI,o-to-xe-may-xe-dap,147587752,"Trang trí cửa gió điều hòa, màn hình DVD Oto Set tình nhân vô cùng dễ thương",75050,79000,3950,5
TIKI,o-to-xe-may-xe-dap,89399623,"Dụng cụ đa năng Lezyne RAP II Tool",650000,650000,0,0
TIKI,o-to-xe-may-xe-dap,129224172,"Gương chiếu hậu 5 cạnh dành cho xe máy.lẻ 1 cái trái",89500,89500,0,0
TIKI,o-to-xe-may-xe-dap,127171843,"Chai xịt làm đen bóng lốp Cá Voi 500ml phù hợp với mọi loại lốp cao su ô tô, xe máy, xe đạp điện",70000,70000,0,0
TIKI,o-to-xe-may-xe-dap,55776431,"Miếng Lót Ghế Tản Nhiệt",257000,318000,61000,19
TIKI,o-to-xe-may-xe-dap,140747833,"Găng tay đa năng rửa xe ô tô và lau dọn nội thất",15000,15000,0,0
TIKI,o-to-xe-may-xe-dap,74418639,"Bộ Móc Treo Xe Đạp Giúp Nâng Xe Đạp/ Vật Dụng Treo Lên Trần Nhà Gọn Gàng Với Móc Dây Ròng Rọc Polly Mai Lee",192000,209000,17000,8
TIKI,o-to-xe-may-xe-dap,143427270,"XE ĐẠP THỂ THAO CỠ 20 INCH cho bé 7 tuổi - 11 TUỔI + Tặng kèm giỏ xe, gácbaga, túi, bình nước",1159000,1159000,0,0
TIKI,o-to-xe-may-xe-dap,131337378,"Túi Hành Lý Sau Xe Đạp - Túi Đôi Đựng Gác ba Ga Xe Đạp Loại Tốt",199000,199000,0,0
TIKI,o-to-xe-may-xe-dap,113404939,"Kính Chắn Gió Xe Máy Cao Cấp, kính chắn bụi chắn gió xe máy",175000,175000,0,0
TIKI,o-to-xe-may-xe-dap,150494298,"Bộ sạc điện thoại trên xe máy kèm đồng hồ báo vôn ắc quy 2in1 gắn chân gương mẫu mới loại tốt lắp các xe",177000,177000,0,0
TIKI,o-to-xe-may-xe-dap,142858485,"DẦU ĐÁNH BÓNG ĐÁ HOA CƯƠNG, DẦU ĐÁNH BÓNG ĐÁ SELF",280000,382500,102500,27
TIKI,o-to-xe-may-xe-dap,31417953,"Bộ 4 Miếng Decal Phản Quang Dán Cánh Cửa Ô Tô OPEN Cao Cấp AZONE",13000,13000,0,0
TIKI,o-to-xe-may-xe-dap,36132352,"Đồng Hồ Đo Áp Suất Lốp Chuyên Dụng Cho Ô Tô, Xe Máy",96000,96000,0,0
TIKI,o-to-xe-may-xe-dap,134663622,"[4 CHỨC NĂNG]Máy hút bụi kiêm bơm lốp ô tô xe hơi đồng hồ điện tử ngắt tự động công suất 120W-6000MPA",449995,449995,0,0
TIKI,o-to-xe-may-xe-dap,58400468,"Kính thay cho nón bảo hiểm kính âm Royal M139 - Chỉ có kính",120000,150000,30000,20
TIKI,o-to-xe-may-xe-dap,33388584,"Cặp Phuộc kiểu Lò Xo Màu dành cho Wave,Dream BẢO LONG RACING",365000,365000,0,0
TIKI,o-to-xe-may-xe-dap,3151283,"Nước Rửa Kính Ô Tô Focar Screen Wash (2.75L)",98000,119000,21000,18
TIKI,o-to-xe-may-xe-dap,182830496,"Thảm taplo xe ô tô da carbon Tâm Luân chống nắng và chống nóng không thấm nước (26 dòng xe - đời xe)",199000,300000,101000,34
TIKI,o-to-xe-may-xe-dap,88993365,"Bơm Xe Đạp Mini 100Psi Kèm Khung Gắn Sườn Xe Nhiều Đầu Bơm Tiện Lợi, Lõi Khung Nhôm Kim Loại Trọng Lượng Nhẹ MaiLee",132000,139000,7000,5
TIKI,o-to-xe-may-xe-dap,35966309,"Túi Ghi Đông Treo Đầu Xe Máy_ xem điện thoại, chứa đồ. Đi phượt, chạy Grab 4.7",75000,75000,0,0
TIKI,o-to-xe-may-xe-dap,113406436,"Đệm yên sau xe đạp có tựa lưng",114400,114400,0,0
TIKI,o-to-xe-may-xe-dap,53468704,"Xi cana đánh bóng vết xước xe máy, ô tô",44460,46800,2340,5
TIKI,o-to-xe-may-xe-dap,122392993,"Mũ Bảo Hiểm Nửa Đầu Cao Cấp SUNDA HALYA HRA - Đen Nhám - Kèm Kính",350000,350000,0,0
TIKI,o-to-xe-may-xe-dap,96036139,"Bộ Sửa Xe Đạp Đa Năng SAHOO Kèm Bơm Và Miếng Vá",239000,239000,0,0
TIKI,o-to-xe-may-xe-dap,21031001,"KÍNH CHIẾU HẬU YAZ ( YAZ ) DÀNH CHO CÁC DÒNG XE YA - LOẠI 1",47000,47000,0,0
TIKI,o-to-xe-may-xe-dap,34155820,"Đèn 5 LED Cảnh báo sau Xe Đạp giúp đạp xe an toàn ban đêm 4 chế độ sáng (Đèn Đỏ) Mai Lee - Hàng chính Hãng",27550,29000,1450,5
TIKI,o-to-xe-may-xe-dap,15464116,"Đèn 5 LED Cảnh báo sau Xe Đạp giúp đạp xe an toàn ban đêm 4 chế độ sáng (Đèn Xanh)",24800,24800,0,0
TIKI,o-to-xe-may-xe-dap,18003080,"Kính rời mũ bảo hiểm GRS",119000,119000,0,0
TIKI,o-to-xe-may-xe-dap,272129048,"Kem đánh bóng sơn xe ô tô (Car Cream) Karshine 250g KA-CC250",79000,79000,0,0
TIKI,o-to-xe-may-xe-dap,68442580,"Nệm hơi xe ô tô Nhà của Mẹ cao cấp chất liệu vải nhung kích thước 140 x 90 x 50 cm tặng kèm bơm điện - Màu sắc giao ngẫu nhiên",393000,420000,27000,6
TIKI,o-to-xe-may-xe-dap,72555849,"Cuộn Đề Can (Decal) Phản Quang Dán Trang Trí Viền Thân Xe Đạp, Xe Máy, Ô tô An Toàn Ban Đêm Nổi Bật (8 mét) Mai Lee",23000,27000,4000,15
TIKI,o-to-xe-may-xe-dap,125137815,"Chai Xịt Tẩy Ố Mốc Kính Lái, Bề Mặt Sơn, Các Chi Tiết Trang Trí Inox Xe Hơi Ô Tô WURTH",250000,250000,0,0
TIKI,o-to-xe-may-xe-dap,102654330,"VÍ DA ĐỰNG ĐĂNG KIỂM, GIẤY TỜ Ô TÔ CAO CẤP",20000,20000,0,0
TIKI,o-to-xe-may-xe-dap,38078759,"Bộ Đổi Nguồn Từ 220V Sang Ổ Cắm Ô Tô 12V, Bộ chuyển đổi có giắc cắm tẩu chuyên dụng giống hệt với giắc cắm trên xe",68000,68000,0,0
TIKI,o-to-xe-may-xe-dap,111589429,"Nón bảo hiểm trẻ em 1/2 đầu Protec Kitty, họa tiết siêu anh hùng Captain American",305000,358000,53000,15
TIKI,o-to-xe-may-xe-dap,25969322,"Mũ bảo hiểm nửa đầu Bulldog Gang",598000,598000,0,0
TIKI,o-to-xe-may-xe-dap,273320873,"Đồng hồ trang trí xe hơi đủ logo các hãng xe (dán táp lô hoặc gắn cửa gió) - Tặng thêm 1 pin",98000,129000,31000,24
TIKI,o-to-xe-may-xe-dap,190468714,"gác để chân sau xe đạp loại cao cấp, bắt thẳng vào sườn xe (nhắn shop để được tư vấn)",39000,50000,11000,22
TIKI,o-to-xe-may-xe-dap,74083498,"Cảo Xích Xe Đạp Giúp Tháo Mở Cảo Cắt Mắt Dây Sên Xe Đạp Nhỏ Gọn, Tiện Lợi Mai Lee",88000,99000,11000,11
TIKI,o-to-xe-may-xe-dap,139949826,"Nước hoa ô tô xe hơi cao cấp đặt taplo ô tô khử mùi chống say xe chiết xuất hoàn toàn từ thiên",220000,220000,0,0
TIKI,o-to-xe-may-xe-dap,80850302,"Gối tựa đầu cao xu non sử dụng cho ô tô , xe hơi hàng cao cấp , tựa đầu chống mỏi cổ gáy, thoải mái lái xe",120000,120000,0,0
TIKI,o-to-xe-may-xe-dap,71542488,"Máy xông tinh dầu xe ô tô vân gỗ cao cấp chuyên dụng, Máy khuếch tán tinh dầu xe hơi lan tỏa hương thơm, khử mùi và trang trí cho xe",198000,556000,358000,64
TIKI,o-to-xe-may-xe-dap,105525660,"Nón bảo hiểm xe đạp có kính Protec Win 018, nón bảo hiểm chơi thể thao ngoài trời tiêu chuẩn châu âu, kính mát, chống tia UV",505000,568000,63000,11
TIKI,o-to-xe-may-xe-dap,94725525,"Màn hình Ôtô xe hơi đặt táp lô, hút kính 5 inch độ phân giải cao 800*480p LCD dùng cho camera lùi, camera căn lề",399000,399000,0,0
TIKI,o-to-xe-may-xe-dap,230247648,"Máy bơm lốp ô tô, xe hơi tự ngắt Michelin 4398ML (12266) động cơ mạnh mẽ 180W cho áp suất tối đa 150PSI, tốc độ bơm nhanh 35l/phút",1034000,1034000,0,0
TIKI,o-to-xe-may-xe-dap,68877509,"Dụng Cụ Kìm (Kềm) Cắt Mở Đóng Dây Sên Xích Xe Đạp Thể Thao Mini Tiện Lợi Nhanh Chóng Mai Lee",46550,49000,2450,5
TIKI,o-to-xe-may-xe-dap,85117078,"Nón Bảo Hiểm Xe Đạp Cao Cấp Protec Win 066, Siêu Phẩm Phượng Hoàng Lửa, Mạnh Mẽ, Cá Tính - Hàng Chính Hãng",469000,569000,100000,18
TIKI,o-to-xe-may-xe-dap,50512779,"Nón bảo hiểm 3/4 kính âm Royal M139 Xanh Mực Nhám cao cấp Lót tháo rời, che hết mặt",499000,499000,0,0
TIKI,o-to-xe-may-xe-dap,85236398,"khung biển số dài cho ô tô kích thước mới đế nhựa viền thép",160000,160000,0,0
TIKI,o-to-xe-may-xe-dap,34531222,"Bộ Hộp Dụng Cụ Vá Lốp Xe Lốp Không Săm Vá Lụi (vá ngoài) Bằng Thép Không Gỉ Cho Xe Oto, Xe Hơi Và Xe Máy Mai Lee - Hàng Chính Hãng",126000,139000,13000,9
TIKI,o-to-xe-may-xe-dap,25968384,"ĐÈN HẬU NHÁY XE MÁY 33 TIM (CHIẾC)",27000,28999,1999,7
TIKI,o-to-xe-may-xe-dap,137555914,"Sạc bình acquy 12V tự động ngắt khi đầy-đen",60800,64000,3200,5
TIKI,o-to-xe-may-xe-dap,119285142,"Bộ 2 tấm che nắng miếng chống nắng trên ô tô",69000,69000,0,0
TIKI,o-to-xe-may-xe-dap,75554546,"Kẹp Đèn Pin Xe Đạp, Kẹp Giữ Đèn Pin Gắn Ghi Đông Cho Xe Đạp Thể Thaom Leo Núi Lắp Đặt Dễ Dàng Mai Lee",46550,49000,2450,5
TIKI,o-to-xe-may-xe-dap,74552910,"Bóng led H4 tích hợp bi cầu mini có COS - PHA",55000,55000,0,0
TIKI,o-to-xe-may-xe-dap,13379450,"Đồng Hồ Đo Áp Suất Lốp Xe AZONE",69000,69000,0,0
TIKI,o-to-xe-may-xe-dap,71075907,"Bộ Dụng Cụ Chùi Chải Vệ Sinh Sên Xích Nhông Đĩa Cho Xe Đạp Thể Thao, Địa Hình (Kèm nước rửa tẩy rửa vệ sinh sên xích) Vệ Sinh Xích Líp Mai Lee",142000,159000,17000,11
TIKI,o-to-xe-may-xe-dap,139001015,"Gạt mưa Silicone UP nhiều SIZE cho các dòng xe phổ biến tại Việt Nam",88000,88000,0,0
TIKI,o-to-xe-may-xe-dap,10085871,"Tem dán sườn xe ô tô phong cách thể thao TS02",239000,239000,0,0
TIKI,o-to-xe-may-xe-dap,25973334,"Sạc Điện Thoại Trên Xe Máy ",33000,33000,0,0
TIKI,o-to-xe-may-xe-dap,172948856,"BỘ CHẮN BÙN SAU XE NVX 155",199000,199000,0,0
TIKI,o-to-xe-may-xe-dap,121978628,"Gương Tròn Cho Nhiều Dòng Xe Máy",30000,30000,0,0
TIKI,o-to-xe-may-xe-dap,130861049,"[BỘ 8 MIẾNG 4 CỬA] Miếng dán chống trầy xước bậc cửa xe hơi ô tô sợi carbon bền đẹp có in logo hãng",169000,169000,0,0
TIKI,o-to-xe-may-xe-dap,56842434,"Thiết bị tiện ích cho ô tô đế hút nam châm giữ điện thoại thiết kế thông minh trên vô lăng hoặc tất cả vị trí trên ô tô dễ dàng lắp đặt",89000,89000,0,0
TIKI,o-to-xe-may-xe-dap,102445310,"Hộp đựng khăn giấy chất liệu da trên ô tô và bàn làm việc,kèm bảng số điện thoại",139990,139990,0,0
TIKI,o-to-xe-may-xe-dap,95548246,"Thùng đựng đồ cốp sau ô tô 56 lít, tặng kèm túi lót chứa nước bên trong",144000,144000,0,0
TIKI,o-to-xe-may-xe-dap,92133666,"Ví đựng giấy tờ xe ô tô Hyundai Da Cao Cấp, Ví da đựng giấy tờ xe ô tô - OTOALO",30000,30000,0,0
TIKI,o-to-xe-may-xe-dap,10397229,"Dung Dịch Rửa Xe Không Chạm Ekokemika Bio 35 (5L) - Hàng Chính Hãng",855000,855000,0,0
TIKI,o-to-xe-may-xe-dap,16201969,"Túi treo đầu ghi đông xe máy xem điện thoại, chứa đồ",77000,77000,0,0
TIKI,o-to-xe-may-xe-dap,20131181,"Miếng Che Yên Xe Máy",11500,11500,0,0
TIKI,o-to-xe-may-xe-dap,52179904,"máy sạc bình ắc quy 12v 2a từ 4-20ah sạc bình ắc quy xe máy sạc bình ắc quy 12V(Đen)",47000,47000,0,0
TIKI,o-to-xe-may-xe-dap,153770768,"Túi để đồ đa năng gắn ghế sau xe hơi chống nước, có thể xếp gọn",139000,139000,0,0
TIKI,o-to-xe-may-xe-dap,31437572,"Bộ Dụng Cụ Chăm Sóc Vệ Sinh Cọ Rửa Bánh Xe Ô Tô Đa Năng",46000,46000,0,0
TIKI,o-to-xe-may-xe-dap,51062644,"Bộ 2 Gương Cầu Lồi Góc Rộng 360 Độ Cho Xe Ô Tô",75000,75000,0,0
TIKI,o-to-xe-may-xe-dap,59441423,"Kính rời dành cho Mũ bảo hiểm 3/4 - CHITA",150000,150000,0,0
TIKI,o-to-xe-may-xe-dap,89052647,"kem xóa vết xước ô tô xe máy",22000,22000,0,0
TIKI,o-to-xe-may-xe-dap,174121364,"Chai xịt khử mùi - diệt khuẩn 3M Air Freshener Spray 38660 200ml",225000,230000,5000,2
TIKI,o-to-xe-may-xe-dap,130552330,"Gạt mưa kính hậu xe KIA MORNING 2012-2019",87000,87000,0,0
TIKI,o-to-xe-may-xe-dap,1254601,"Khăn Lau Xe Hơi 3M Perfect-It Super Soft Microfiber PN05400 (32 x 36 cm)",59000,59000,0,0
TIKI,o-to-xe-may-xe-dap,59548941,"Phủ kính nano chống bám nước gương kính ô tô Nhật Bản",210000,210000,0,0
TIKI,o-to-xe-may-xe-dap,190539219,"[HOT 2022] NƯỚC HOA XE HƠI, NƯỚC HOA OTO CAO CẤP THƠM MÁT SANG TRỌNG",150000,150000,0,0
TIKI,o-to-xe-may-xe-dap,33545274,"Bơm xe đạp, xe máy cầm tay nhỏ gọn",39000,50000,11000,22
TIKI,o-to-xe-may-xe-dap,162587064,"Xwash For Car chai nhỏ 100ml giúp vệ sinh ô tô dễ dàng tại nhà Tặng Kèm Khăn Lau Xe",249000,249000,0,0
TIKI,o-to-xe-may-xe-dap,25933443,"Bộ 2 Gối Tựa Đầu Ô Tô - Gối Chống Mỏi Cổ Trên Xe Hơi AZONE - Màu Chỉ Đỏ",114000,114000,0,0
TIKI,o-to-xe-may-xe-dap,34513035,"Đèn LED Cảnh báo sau Xe Đạp giúp đạp xe an toàn ban đêm 4 chế độ sáng (Đèn Xanh) Mai Lee - Hàng chính hãng",19000,19000,0,0
TIKI,o-to-xe-may-xe-dap,184599329,"KEO XỬ LÝ CÁC VẾT RẠN NỨT VỠ NHẸ Ở KÍNH CHẮN GIÓ XE HƠI ÔTÔ MẪU MỚI HÀNG CAO CẤP",138000,138000,0,0
TIKI,o-to-xe-may-xe-dap,184332961,"Gờ cao su chặn lùi xe ô tô, cố định bánh xe",189000,189000,0,0
TIKI,o-to-xe-may-xe-dap,131192931,"Baga Jupiter FI 10ly titan, đen, inox siêu chất",95000,95000,0,0
TIKI,o-to-xe-may-xe-dap,52432561,"Bơm lốp xe đạp xe máy chính hãng CMART l0005",175000,175000,0,0
TIKI,o-to-xe-may-xe-dap,157118111,"Bao da chìa khoá Toyota Raize 2021 2022 handmade da thật 011",200000,200000,0,0
TIKI,o-to-xe-may-xe-dap,175414765,"Dây bơm xe đạp xe máy, dây thay thế cho bơm tay, bơm chân",14000,14000,0,0
TIKI,o-to-xe-may-xe-dap,171871414,"Nón bảo hiểm xe đạp trẻ em Protec SMILE cho bé trai từ 1-12 tuổi, họa tiết mạnh mẽ, năng động, có đèn hậu an toàn- Hàng chính hãng",338000,438000,100000,23
TIKI,o-to-xe-may-xe-dap,145398874,"Găng Tay Cụt Ngón Chạy Xe Đạp, Xe Máy MCFK 0101 | Bao Tay Cụt Ngón Thể Thao | Găng Tay Phượt Nam/Nữ - Theyanch Half-Finger Gloves",91000,99000,8000,8
TIKI,o-to-xe-may-xe-dap,63861428,"Khánh Phật Tọa Liên Hoa Trang Trí Xe Hơi , Dây Treo Phật Sen Gỗ Hoàng Dương Trang Trí Ô Tô",215000,215000,0,0
TIKI,o-to-xe-may-xe-dap,36213946,"Bộ 2 dây cáp 2.5m 1800A câu điện bình ắc quy ô tô 4-8 chỗ kích nổ acquy xe hơi ô tô có bảo vệ",149000,149000,0,0
TIKI,o-to-xe-may-xe-dap,107798998,"Vam tháo nắp bình xăng ô tô 2 chân",118000,125000,7000,6
TIKI,o-to-xe-may-xe-dap,41195385,"Xịt khử mùi hôi Tinh dầu xá xị 100ml",104500,110000,5500,5
TIKI,o-to-xe-may-xe-dap,113406380,"Chốt Khóa Dây An Toàn Cho Xe Ô Tô - TB",30800,30800,0,0
TIKI,o-to-xe-may-xe-dap,33438072,"Bộ gối tựa đầu và tựa lưng xe hơi chất liệu cao su non cao cấp Lucky Bobi",249000,249000,0,0
TIKI,o-to-xe-may-xe-dap,117202092,"Ốc lục giác Inox chuyên dùng cho xe đạp thể thao",32000,32000,0,0
TIKI,o-to-xe-may-xe-dap,10796772,"Khăn lau xe hơi oto 3M Microfiber (4 khăn).",39000,39000,0,0
TIKI,o-to-xe-may-xe-dap,37874087,"Cần số Xi 7 Màu Titan cho Exciter 150 Cao Cấp Siêu Thị Đức Anh",68000,68000,0,0
TIKI,o-to-xe-may-xe-dap,68850833,"Chổi Lau Rửa Xe Ô Tô 360 Độ Sợi Siêu Mịn Có Thể Điều Chỉnh Chiều Dài",64000,72000,8000,11
TIKI,o-to-xe-may-xe-dap,58545007,"Combo rửa sên WillF1 Chain Cleaner 500ml, Dưỡng sên WillF1 Chain Lube 400ml Tặng kèm bàn chải vệ sinh sên 3D",119000,119000,0,0
TIKI,o-to-xe-may-xe-dap,145658918,"Nón bảo hiểm 3/4 Royal M125K thiết kế nhỏ gọn, nhiều màu sắc, phù hợp mọi độ tuổi, hàng chính hãng - M",490000,490000,0,0
TIKI,o-to-xe-may-xe-dap,59436625,"Đèn Đuôi LED Xe Đạp Thông Minh Cảnh Báo Ban Đêm Có Cảm Biến Chuyển Động Và Báo Đèn Khi Phanh Xe Chống Nước Sạc Điện USB MAILEE - Hàng Chính Hãng",246050,259000,12950,5
TIKI,o-to-xe-may-xe-dap,147975649,"Bảng Số Điện Thoại Ô Tô - Bảng Số Điện Thoại Trên Ô Tô - Đặt Trên Taplo",14000,14000,0,0
TIKI,o-to-xe-may-xe-dap,106680580,"Đèn Hậu Phía Sau Cảnh báo an toàn Đuôi Xe Đạp DC918 Sạc USB Có Thể Sạc Lại MaiLee",33000,37000,4000,11
TIKI,o-to-xe-may-xe-dap,68455523,"VÒNG XOAY VÔ CỰC - SÁP THƠM GALAXY KIM LOẠI GẮN TAPLO TỰ QUAY BẰNG NĂNG LƯỢNG MẶT TRỜI",110000,110000,0,0
TIKI,o-to-xe-may-xe-dap,987019,"Dầu Bôi Trơn Chống Rỉ Sét WD-40 840531 (300ml)",104000,104000,0,0
TIKI,o-to-xe-may-xe-dap,159880336,"Bàn ăn trên ô tô, Bàn làm việc đa năng gấp gọn trên ô tô xe hơi",289000,329000,40000,12
TIKI,o-to-xe-may-xe-dap,92153825,"Nguồn camera hành trình chuyển 12-36V xuống 5V 3.5A dây dài 3m5 kèm 2 cổng USB sạc điện thoại",128700,128700,0,0
TIKI,o-to-xe-may-xe-dap,107369450,"Chốt Khóa Dây Đai An Toàn Theo Logo Các Hãng Xe CKAT",39000,39000,0,0
TIKI,o-to-xe-may-xe-dap,88027315,"Giá điện thoại trên ô tô",37000,51278,14278,28
TIKI,o-to-xe-may-xe-dap,111362293,"Thảm lót sàn cao su không mùi dành cho Kia Cerato 2019 2020",463600,488000,24400,5
TIKI,o-to-xe-may-xe-dap,72722988,"Dụng Cụ Vệ Sinh Lau Chùi Bảo Dưỡng Xe Đạp Gồm Chổi Lau Sên Xích, Chổi Cọ Lốp, Găng Tay Vải (Nhiều Món) Giúp Lau Chùi Vệ Sinh Nhanh Chóng",141550,149000,7450,5
TIKI,o-to-xe-may-xe-dap,193136739,"Tinh dầu thơm trang trí táp lô xe hơi, ô tô mô hình máy bay chiến đấu chạy bằng năng lượng mặt trời",154000,299000,145000,48
TIKI,o-to-xe-may-xe-dap,57808776,"Combo 5 khăn lau xe hơi chuyên dụng , thấm hút tốt , rửa xe, lau khô, lau sáp đánh bóng, vệ sinh các vết bẩn",40000,40000,0,0
TIKI,o-to-xe-may-xe-dap,99463625,"Ô Che Nắng Kính Lái Xe Ô tô - Bảo vệ nội thất ô tô - Dù che nắng kính lái xe hơi - chống tia UV",93100,98000,4900,5
TIKI,o-to-xe-may-xe-dap,131183383,"Lọc gió điều hòa ô tô HONDA CITY 1.5L 2013-",91000,91000,0,0
TIKI,o-to-xe-may-xe-dap,114744981,"Combo 2 Lưỡi Gạt Mưa Loại A VIAIR R15 (24 Inch/600 mm)",86000,101000,15000,15
TIKI,o-to-xe-may-xe-dap,85804367," nước hoa đầu chó Pitbull 15ml",235600,248000,12400,5
TIKI,o-to-xe-may-xe-dap,71150931,"Chổi Quét Bụi Ô TÔ Đa Năng NB 64cm",179000,179000,0,0
TIKI,o-to-xe-may-xe-dap,52318177,"Bảng số điện thoại trên ô tô nhãn hiệu Baseus ACNUM - Hàng nhập khẩu",266000,280000,14000,5
TIKI,o-to-xe-may-xe-dap,69691769,"Khóa dây số đường kính 15mm",78999,78999,0,0
TIKI,o-to-xe-may-xe-dap,11251519,"Combo 2 Lót Chân Chống Xe Máy",14000,14000,0,0
TIKI,o-to-xe-may-xe-dap,118180539,"Khóa Dây Xe Đạp 5 Số Mật Mã Dây Cáp Lõi Sợi Thép Bọc PVC Dài 120cm (kèm pát đế gắn cốt yên) (mật khẩu mặc định 00000) Mai Lee",132050,139000,6950,5
TIKI,o-to-xe-may-xe-dap,50462792,"Bộ chuyển nguồn 220V ra 12V tẩu sạc ô tô",75000,75000,0,0
TIKI,o-to-xe-may-xe-dap,11503718,"CHAI XỊT BỌT TUYẾT VỆ SINH NÓN BẢO HIỂM, YÊN, RỬA XE KHÔ NHANH CHÓNG LUBE71 WELL FOAM SPRAY 600ML",230000,230000,0,0
TIKI,o-to-xe-may-xe-dap,11203861,"Combo 2 Gối Tựa Đầu Xe Hơi",76995,76995,0,0
TIKI,o-to-xe-may-xe-dap,22035789," Bộ 2 Móc Treo Đồ Sau Ghế Ô Tô",28000,28000,0,0
TIKI,o-to-xe-may-xe-dap,22761385,"Tấm lưới tựa lưng ghế ô tô, hạn chế tối đa sự chịu lực của cột sống",24700,24700,0,0
TIKI,o-to-xe-may-xe-dap,7371421,"Cặp 2 cái ruột xe đạp 24 X 1.75/2.125 AV35mm",120000,120000,0,0
TIKI,o-to-xe-may-xe-dap,4776047,"Móc treo đồ sau ghế chuyên dụng cho xe hơi",30000,30000,0,0
TIKI,o-to-xe-may-xe-dap,43952392,"XI NHAN WINNER X KIỂU MAI RÙA, (1 ĐÔI)",50000,55000,5000,9
TIKI,o-to-xe-may-xe-dap,33784257,"GƯƠNG CẦU LỒI 360 CAO CẤP GẮN XE Ô TÔ HỖ TRỢ ĐIỂM MÙ",19000,19000,0,0
TIKI,o-to-xe-may-xe-dap,167153607,"Khay đựng đồ ghế sau ô tô gấp gọn - Hàng Kpro chất lượng cao",125000,125000,0,0
TIKI,o-to-xe-may-xe-dap,176969649,"Vỏ chai đựng tinh dầu lục lăng TTAUTO 8ml treo xe ô tô, phòng ngủ, tủ quần áo, nhà vệ sinh",18000,18000,0,0
TIKI,o-to-xe-may-xe-dap,89580999,"Đèn Xe Đạp Đuôi Led Nhấp Nháy Chớp Vuông Gắn Sau Xe Đạp, Gắn Mũ Bảo Hiểm MaiLee",113050,119000,5950,5
TIKI,o-to-xe-may-xe-dap,116455573,"Bao Da Chìa Khoá Mitsubishi Xpander, Outlander, Triton, Attrage, Pajero Sport handmade Da Thật 003",199000,199000,0,0
TIKI,o-to-xe-may-xe-dap,176147612,"Túi than hoạt tính TTAUTO 100% từ gáo dừa Bến Tre khử mùi diệt khuẩn trên ô tô, tủ đồ, phòng tắm - Túi 100 Gram",25000,50000,25000,50
TIKI,o-to-xe-may-xe-dap,85399844,"Túi thơm ô tô Greenleaf - Lưu hương 6 tháng-Khử sạch hiệu quả mùi hôi trên ô tô, tủ quần áo, phòng làm việc",129000,129000,0,0
TIKI,o-to-xe-may-xe-dap,198126634,"Xe máy điện VinFast EVO 200",18000000,18000000,0,0
TIKI,o-to-xe-may-xe-dap,176825442,"Xe máy điện VinFast Theon S",63000000,63000000,0,0
TIKI,o-to-xe-may-xe-dap,129746674,"Xe đạp Thống Nhất mini New 24 inch",2248000,2248000,0,0
TIKI,o-to-xe-may-xe-dap,71105002,"Thanh Mở Rộng Gắn Ghi Đông Xe Đạp Thể Thao Địa Hình Đa Chức Năng Dùng Gắn Cho Phụ Kiện Đồ Chơi Xe Đạp (Loại dài 2 nhánh đỡ chắc chắn) Mai Lee",99750,107100,7350,7
TIKI,o-to-xe-may-xe-dap,16366954,"Đèn Led L4X 40W Trợ sáng xe máy Tặng 5 món phụ kiện",273000,299000,26000,9
TIKI,o-to-xe-may-xe-dap,57450089,"Bạt trùm xe máy vải dù loại dày che mưa nắng nhiều màu lựa chọn",105000,105000,0,0
TIKI,o-to-xe-may-xe-dap,153468318,"Xe đạp gấp 20 icnh, chính hãng Phượng Hoàng",3550000,3550000,0,0
TIKI,o-to-xe-may-xe-dap,58066078,"Đèn Pha LED Bi Cầu Mini Y6D 36W Chống Chói Mắt Green Networks Group ( 1 Bóng )",349000,349000,0,0
TIKI,o-to-xe-may-xe-dap,119718975,"Bình Ắc Quy Khô LONG 12V-9AH WP1236W dùng cho ups, lưu điện cửa cuốn, lưu điện máy tính, loa kéo",319000,319000,0,0
TIKI,o-to-xe-may-xe-dap,1378161,"Mỡ Bò Nước Dạng Xịt Bôi Trơn Chịu Nhiệt Wurth Hhs 2000 (500ml)",175000,175000,0,0
TIKI,o-to-xe-may-xe-dap,44137803,"CHÂN CHỐNG CẠNH XE MÁY, CÓ THỂ TĂNG CHỈNH ĐỘ DÀI",103550,109000,5450,5
TIKI,o-to-xe-may-xe-dap,143427476,"XE ĐẠP TRẺ EM CỠ 24 INCH cho bé 9 tuổi - 15 TUỔI + Tặng kèm giỏ xe, gácbaga, túi, bình nước",1399000,1399000,0,0
TIKI,o-to-xe-may-xe-dap,146370121,"Bọc Chìa Khoa Smartkey Xe SH , Sh Mode , Vision 2021 Bọc Smartkey mẫu Mới 2022",169000,169000,0,0
TIKI,o-to-xe-may-xe-dap,14656151,"Nhớt Xe Tay Ga Motul Scooter Expert Le 10w40 20x0.8l Vn (800ml)",119000,119000,0,0
TIKI,o-to-xe-may-xe-dap,48216836,"Bộ 5 tấm miếng che nắng ô tô",65000,65000,0,0
TIKI,o-to-xe-may-xe-dap,49262400,"Nón bảo hiểm nguyên đầu (Fullface) Royal M136",295000,295000,0,0
TIKI,o-to-xe-may-xe-dap,189588928,"Tủ lạnh ô tô Kemin K9A - 9L Chính Hãng- Dùng ở nhà và ô tô - Hai chiều nóng lạnh",1003000,1350000,347000,26
TIKI,o-to-xe-may-xe-dap,171125271,"Mũ Bảo Hiểm 3/4 Đầu Royal M139 Kính Âm Thời Thượng Tiện Nghi",700000,700000,0,0
TIKI,o-to-xe-may-xe-dap,53296107,"Bảng Hiển Thị Số Điện Thoại Gắn Trên Taplo Xe Ô TÔ  Giúp Người Đi Đường Dễ Dàng Liên Hệ Với Bạn Khi Cần Thiết",10000,10000,0,0
TIKI,o-to-xe-may-xe-dap,91474483,"Rổ hông xe Winner Exciter 135 150 155 Wave Sirius Jupiter Fi RSX Blade Green Networks Group ( 1 cái )",39000,39000,0,0
TIKI,o-to-xe-may-xe-dap,123561575,"Màn Hình Android Oled C2 chip TS18 chia đôi màn hình",2250000,2250000,0,0
TIKI,o-to-xe-may-xe-dap,5755547,"Móc treo đồ titan dành cho xe máy",9000,9000,0,0
TIKI,o-to-xe-may-xe-dap,105525662,"Mũ bảo hiểm xe đạp thể thao Protec Win 037, tiêu chuẩn Châu Âu, an toàn, mạnh mẽ, vòng đầu từ 57-62cm",389000,459000,70000,15
TIKI,o-to-xe-may-xe-dap,23182365,"Bộ 2 Túi Đựng Đồ Lưng Ghế Ô Tô Da Cao Cấp YE-136",169000,169000,0,0
TIKI,o-to-xe-may-xe-dap,52152796,"Bộ Chuyển Đổi Điện 12V Sang 220V cho ô tô",321000,399000,78000,20
TIKI,o-to-xe-may-xe-dap,87789165,"Đệm Ghế Yên Sau Gắn Baga Xe Đạp Có Tựa Lưng An Toàn Cho Trẻ Em/ Trẻ Nhỏ MaiLee",142000,189000,47000,25
TIKI,o-to-xe-may-xe-dap,84870183,"Combo chai vệ sinh sên Megacools 500ml và xịt bảo dưỡng sên Megacools 300ml tặng bàn chải 3D cao cấp",165000,165000,0,0
TIKI,o-to-xe-may-xe-dap,51009122,"Nón bảo hiểm Royal kính âm M139 xanh lính",550000,700000,150000,21
TIKI,o-to-xe-may-xe-dap,57520399,"Bộ kích bình ắc quy dùng cho xe ô tô Baseus Super Energy Car Jump Starter",1500000,1500000,0,0
TIKI,o-to-xe-may-xe-dap,31984811,"Cây Thông Tạo Mùi Thơm Treo Trên Ô Tô",11000,11000,0,0
TIKI,o-to-xe-may-xe-dap,127792464,"Bộ 4 Decal phản quang OPEN dán cửa oto cảnh báo an toàn, chống va chạm TÂM LUÂN Chổi lau tẩm dầu - Hàng chính hãng",19000,30000,11000,37
TIKI,o-to-xe-may-xe-dap,50451856,"Bạt Phủ Xe 3D Chống Nắng Xe Máy Tay Ga",98997,98997,0,0
TIKI,o-to-xe-may-xe-dap,114671566,"Tem rời Air Blade ",149000,149000,0,0
TIKI,o-to-xe-may-xe-dap,84543438,"Dè Chắn Bùn bản nhỏ có phản quang cho xe đạp City/Touring/ thể thao.",39000,55000,16000,29
TIKI,o-to-xe-may-xe-dap,20721745,"CẶP GƯƠNG CHIẾU HẬU GÙ TRÒN CÁN XOAY CRG GẮN NHIỀU LOẠI XE MÁY SIÊU ĐẸP - MÀU XANH ĐEN ( 1 CHIẾC BÊN TRÁI ) LOẠI 1",79000,89000,10000,11
TIKI,o-to-xe-may-xe-dap,87861406,"Chân chống titan cho Wave Dream Future Blade Cub Sirius Chân chống độ - Chất liệu inox dày",74000,74000,0,0
TIKI,o-to-xe-may-xe-dap,12064795,"Miếng tựa lưng ghế hạt gỗ massage cao cấp",99000,99000,0,0
TIKI,o-to-xe-may-xe-dap,143170837,"Sáp Thơm Cafe Khử Mùi ô tô - Sáp Thơm Cốc Cà Phê Mocha Hàn Quốc",42000,42000,0,0
TIKI,o-to-xe-may-xe-dap,117202358,"Bọc yên xe đạp Gel cao cấp siêu êm",129000,129000,0,0
TIKI,o-to-xe-may-xe-dap,80695685,"Bộ ốc dàn áo xe máy (Sirius,Wave Alpha,Wave A/Rs/S 100)",45000,45000,0,0
TIKI,o-to-xe-may-xe-dap,208206909,"Mũ bảo hiểm lỗ thông gió chính hãng NÓN SƠN TG-HG359",325000,650000,325000,50
TIKI,o-to-xe-may-xe-dap,66740494,"DUNG DỊCH RỬA KHOANG MÁY, MÂM XE, KHUNG GẦM Ô TÔ KM20  [5 Lit]",322000,349000,27000,8
TIKI,o-to-xe-may-xe-dap,132351873,"(Nhiều Kích Thước )Decan dán xe chuột mickey dán trang trí bàn học, xe 4 chỗ, 7 chỗ, xe khách, xe tải, decal xe sắc nét",13000,13000,0,0
TIKI,o-to-xe-may-xe-dap,68229894,"Máy phun sương tạo ẩm, xông tinh dầu mini dùng cho xe hơi Baseus Time Aromatherapy Humidifier (75ml , Alloy Air Humidifier Aroma for Car) - Hàng chính hãng",368000,389500,21500,6
TIKI,o-to-xe-may-xe-dap,12277440,"Tấm da treo ghế để giấy ăn, chai lọ tiện lợi giúp nội thất xe gọn gàng - màu ngẫu nhiên ",99000,99000,0,0
TIKI,o-to-xe-may-xe-dap,132026986,"COMBO 2 chai xịt bọt tẩy vệ sinh nội thất xe ô tô đa năng Flamingo 650ml",119000,119000,0,0
TIKI,o-to-xe-may-xe-dap,150493215,"Đèn trợ sáng xe máy ô tô bi cầu XP60 cốt vàng pha trắng 2 màu mini siêu sáng tặng công tắc loại tốt",199000,199000,0,0
TIKI,o-to-xe-may-xe-dap,145780366,"Bơm xe đạp xe máy xe hơi đạp chân di động có đồng hồ đo áp suất",129000,129000,0,0
TIKI,o-to-xe-may-xe-dap,22152720,"BỘ VÁ XE ĐẠP, XE MÁY ",88000,100000,12000,12
TIKI,o-to-xe-may-xe-dap,35236544,"KHÓA CHỐNG TRỘM XE MÁY CAO CẤP 2 KHIỂN",217550,229000,11450,5
TIKI,o-to-xe-may-xe-dap,100256806,"Xe đạp Thống Nhất GN 06-24 - Hàng chính hãng",2130000,2130000,0,0
TIKI,o-to-xe-may-xe-dap,143225953,"Bơm hợp kim nhôm loại đạp chân dùng cho xe đạp, xe máy, ô tô tặng kèm kim bơm banh và bơm thú hơi - Bơm đa năng",139000,139000,0,0
TIKI,o-to-xe-may-xe-dap,105183798,"Gương gù bắt chân gương - thời trang nhỏ gọn cho xe máy SH, Vision, AB, Wave, Vario, Exciter",118750,118750,0,0
TIKI,o-to-xe-may-xe-dap,19699766,"Chong Chóng Mèo Doreamon Gắn Mũ Bảo Hiểm - Nhiều Màu",9000,9000,0,0
TIKI,o-to-xe-may-xe-dap,56206948,"Đồng Hồ Thương Hiệu Trang Trí Ô Tô Xe Hơi Sang Trọng",79000,79000,0,0
TIKI,o-to-xe-may-xe-dap,10704407,"Bộ Combo bảo dưỡng sên Thunder 400ml, rửa sên TS-40 450ml tặng kèm bản chải chà sên",119000,119000,0,0
TIKI,o-to-xe-may-xe-dap,105184009,"Gương xe máy tròn phẳng kiểu Vespa - cho tất cả xe máy",65550,65550,0,0
TIKI,o-to-xe-may-xe-dap,189574286,"Đèn LED hậu chớp nháy liên tục gắn cho mọi loại xe ô tô xe gắn máy",15000,15000,0,0
TIKI,o-to-xe-may-xe-dap,50701326,"Ghế ngồi cho trẻ dành cho xe Wave ",169000,169000,0,0
TIKI,o-to-xe-may-xe-dap,85804860," Bộ tựa đầu tựa lưng cao su non nguyên khối - bộ gối đầu tựa lưng trên ô tô",99000,99000,0,0
TIKI,o-to-xe-may-xe-dap,56046755,"Tấm Chắn Nắng Kính Lái Xe Ô Tô, Xe Hơi Chất Liệu Xốp Phủ Bạc",43000,43000,0,0
TIKI,o-to-xe-may-xe-dap,167981636,"Gói 100 viên bi sắt đủ kích cỡ",15000,15000,0,0
TIKI,o-to-xe-may-xe-dap,139948369,"Khoá dây xe đạp xe máy 4 số chống trộm",50000,50000,0,0
TIKI,o-to-xe-may-xe-dap,1237293,"Chai Xịt Chống Rỉ, Chống Ẩm Bảo Dưỡng WD-40 (191ml)",85000,85000,0,0
TIKI,o-to-xe-may-xe-dap,84447296,"Túi Treo Sườn Xe Đạp",35000,35000,0,0
TIKI,o-to-xe-may-xe-dap,2430315,"Súc Rửa Động Cơ Xe Máy Liqui Moly 7901 (80ml)",75000,79000,4000,5
TIKI,o-to-xe-may-xe-dap,5314233,"Bộ túi thơm cà phê khử mùi treo xe ô tô kèm chai xịt tinh dầu Hàn Quốc",40000,62000,22000,35
TIKI,o-to-xe-may-xe-dap,22474176,"Decal 3D Cacbon màu đen trang trí cho xe hơi, xe máy, điện thoại, máy tính ( 40 x 120 cm)",44000,44000,0,0
TIKI,o-to-xe-may-xe-dap,117213359,"Chăm sóc bảo dưỡng da nội thất ô tô Wurth",525000,525000,0,0
TIKI,o-to-xe-may-xe-dap,110146659,"Bộ Adapter Chuyển Đổi Điện AC 220V Sang DC 12V Dùng Cho Máy Bơm Máy Hút Bụi Ô Tô Xe Hơi 60W 100W",75999,75999,0,0
TIKI,o-to-xe-may-xe-dap,81508747,"Ống bơm hơi điện tử mini YANTU A05 không dây dành cho ô tô xe máy xe đạp Hàng chính hãng",636650,749000,112350,15
TIKI,o-to-xe-may-xe-dap,76106000,"SPRAYKING combo vệ sinh sên , dưỡng sên , dưỡng nhám",139000,139000,0,0
TIKI,o-to-xe-may-xe-dap,115622064,"Keo Dán Cường Lực 2 Mặt 3M VHB 4229P (nhiều size - cuộn dài 1.5 mét)",36000,36000,0,0
TIKI,o-to-xe-may-xe-dap,118297778,"Bọc yên xe đạp GIANT loại dầy (Chính Hãng)",352800,352800,0,0
TIKI,o-to-xe-may-xe-dap,120220101,"Bộ 4 viên pin đồng xu CR1632-3V pin cảm biến áp suất lốp pin chìa khóa ô tô",25000,25000,0,0
TIKI,o-to-xe-may-xe-dap,11053096,"Tẩu sạc ô tô kiêm nghe nhạc MP3, kết nối điện thoại qua bluetooth, kết nối dàn âm thanh trên xe qua sóng FM",62000,84999,22999,27
TIKI,o-to-xe-may-xe-dap,32593431,"Lưới ràng buộc hàng đồ xe máy và hành lý xe máy, xe mô tô 40x40cm Mai Lee - Hàng chính hãng",45600,48000,2400,5
TIKI,o-to-xe-may-xe-dap,147975139,"Móc Treo Đồ Gài Sau Ghế Ô Tô, Móc Treo Đồ Tiện Dụng Sau Lưng Ghế Ô Tô, Xe Hơi",24900,24900,0,0
TIKI,o-to-xe-may-xe-dap,89402958,"Xích xe đạp - sên xe đạp - Chất liệu cao cấp",79000,79000,0,0
TIKI,o-to-xe-may-xe-dap,59548143,"Bơm lốp Ô tô Baseus Inflator Pump Energy Source ( phiên bản mới 2020 ) Baseus CRCQB02",866000,929000,63000,7
TIKI,o-to-xe-may-xe-dap,51330433,"Bình cứu hỏa, chữa cháy cho ô tô nhiều dung tích",43800,43800,0,0
TIKI,o-to-xe-may-xe-dap,80850054,"Combo 2 Khăn lau xe chuyên dụng Microfiber siêu thấm không bị sơ, rối sử dụng cho ô tô - xe hơi kích thước 30x60",25900,25900,0,0
TIKI,o-to-xe-may-xe-dap,58523167,"Bình Xịt Vệ Sinh Điều Hòa Ô Tô - Flamingo",102000,112000,10000,9
TIKI,o-to-xe-may-xe-dap,5757605,"Mũ bảo Hiểm Royal M139 Kính Âm",550000,700000,150000,21
TIKI,o-to-xe-may-xe-dap,192628519,"Bao da Chìa Khóa ô tô kèm móc khóa Xe Suzuki XL7 - Mẫu Chìa Thông Minh",95000,95000,0,0
TIKI,o-to-xe-may-xe-dap,162592103,"Ắc quy Đèn sạc JP PA 6-4.5 | 6V - 4,5Ah",113000,113000,0,0
TIKI,o-to-xe-may-xe-dap,129224303,"Trợ sáng bi cầu mini cos vàng-pha trăng..nguồn nhôm dành cho xe máy",199000,199000,0,0
TIKI,o-to-xe-may-xe-dap,23881791,"Tem xe ô tô thể thao TS027",239000,239000,0,0
TIKI,o-to-xe-may-xe-dap,63706090,"Cờ Lê Lắp Chéo, Chữ T dùng Tháo Lốp Ô Tô, Xe Hơi",240000,240000,0,0
TIKI,o-to-xe-may-xe-dap,149238728,"Găng tay phượt, găng tay đi xe máy - Hàng chính hãng",57000,60000,3000,5
TIKI,o-to-xe-may-xe-dap,5182479,"Combo 10 viên sủi nước rửa kính xe hơi",8999,8999,0,0
TIKI,o-to-xe-may-xe-dap,97890211,"Phễu Thay Nhớt Xe Máy",15000,15000,0,0
TIKI,o-to-xe-may-xe-dap,51299173,"Sạc Điện Thoại 3 trong 1 Gắn Các Dòng Xe ",142000,142000,0,0
TIKI,o-to-xe-may-xe-dap,3004439,"Đèn LED Trợ Sáng Xe Máy L4X (40W)",165000,165000,0,0
TIKI,o-to-xe-may-xe-dap,4697159,"Máy Lọc Không Khí Ô TÔ BONECO P50 màu Trắng Khử mùi thuốc lá hiệu quả - Hàng Nhập Khẩu",2860000,2860000,0,0
TIKI,o-to-xe-may-xe-dap,90836292,"Nón bảo hiểm 3/4 Royal XH 01 cao cấp Lót tháo rời, che hết mặt",389000,389000,0,0
TIKI,o-to-xe-may-xe-dap,129147873,"Miếng Phản Quang Cảnh Báo Dành Cho Xe Đạp - Xe Đạp Spoke Plsatic Ống Kính Phản Quang Bánh Xe - Vành Phản Xạ Cảnh Báo An Toàn ",14250,15000,750,5
TIKI,o-to-xe-may-xe-dap,109015505,"Nón bảo hiểm fullface M138B Thời Trang, Cá tính",499000,499000,0,0
TIKI,o-to-xe-may-xe-dap,58444444,"Bộ Chuyển Đổi Nguồn Điện DC 12V Sang AC 220V 150W Cho Xe Ô Tô Cao Cấp",236550,249000,12450,5
TIKI,o-to-xe-may-xe-dap,54013356,"bao tay daytuna dành cho xe máy",30000,30000,0,0
TIKI,o-to-xe-may-xe-dap,124113000,"Biển số titan 7 màu kèm ốp inox và mica Hàng Loại 1 Dày Dặn Dành Cho Xe Máy",58000,58000,0,0
TIKI,o-to-xe-may-xe-dap,143225978,"Giá Đỡ Bình Nước Xe Đạp, Lồng Đựng Chai Nước Gắn Khung Xe Đạp Thể Thao Chắc Chắn",25000,25000,0,0
TIKI,o-to-xe-may-xe-dap,55362664,"Túi treo đầu xe máy vải bố mẫu đứng, túi ghi đông treo đầu xe máy chuyên dụng cho Grap,Goviet, bee anh em xe ôm công nghệ",85000,85000,0,0
TIKI,o-to-xe-may-xe-dap,11506461,"Bơm MICHELIN 4398ml 12266 bơm ô tô, xe hơi mini tự ngắt",1049000,1049000,0,0
TIKI,o-to-xe-may-xe-dap,4312357,"Búa Thoát Hiểm Đa Năng",79000,79000,0,0
TIKI,o-to-xe-may-xe-dap,121397854,"Găng tay rửa xe ô tô san hô siêu mềm mịn tiện dụng",15000,15000,0,0
TIKI,o-to-xe-may-xe-dap,121978862,"Săm lốp xe đạp trẻ em đủ kích cỡ 12 14 16 18 20 ( Vỏ ruột) xe đạp",32000,32000,0,0
TIKI,o-to-xe-may-xe-dap,42738449," Thùng Rác Gấp Gọn Trên Xe Hơi Tiện Dụng",29000,29000,0,0
TIKI,o-to-xe-may-xe-dap,34623929,"Kính chiếu hậu Ya Z dành cho các loại xe máy (gương Yaz) BẢO LONG RACING",46000,46000,0,0
TIKI,o-to-xe-may-xe-dap,186092078,"Bạt Phủ Nửa Xe Ô Tô Che Cả Nắp Capo, Bạt Che Nóc Xe Hơi Chống Nắng, Chống Xước Cho Các Dòng Xe",196995,196995,0,0
TIKI,o-to-xe-may-xe-dap,139578655,"Nước rửa kính và vệ sinh kính xe ô tô đa năng TH CLEAN can 2.5 Lít",44000,48990,4990,10
TIKI,o-to-xe-may-xe-dap,35841278,"Mũ bảo hiểm nửa đầu SUNDA 135D kính râm nhẹ có thể giấu vào trong thân mũ, tác dụng chống tia uv, chống chói, lớp lót mũ tháo giặt, có 4 lỗ thông gió trên mũ, kiểu dáng gọn nhẹ thời trang - hàng chính hãng SUNDA",365000,365000,0,0
TIKI,o-to-xe-may-xe-dap,130172028,"Chuông Xe Đạp Thể Thao Nhỏ Gọn - Làm Bằng Hợp Kim Kẽm - Âm Thanh Vang 90 - 100dB Gắn Tay Lái (Ghi Đông)",18000,19000,1000,5
TIKI,o-to-xe-may-xe-dap,56720792,"Combo 2 Bóng Đèn Halogen Tăng Sáng 150% OSRAM Night Breaker Laser H4 12V 60/55W",823000,968000,145000,15
TIKI,o-to-xe-may-xe-dap,111198553,"Yên Xe Đạp, Đệm Yên Xe Đạp Thể Thao Siêu Êm, Chống Nước Cao Cấp",97988,97988,0,0
TIKI,o-to-xe-may-xe-dap,26074025,"Kẹp Điện Thoại Gấp Gọn Trên Ô Tô",199000,199000,0,0
TIKI,o-to-xe-may-xe-dap,119420828,"Đai ghế ngồi trên ô tô cho bé (Dành cho bé dưới 20kg)",175000,175000,0,0
TIKI,o-to-xe-may-xe-dap,3935969,"Bọc khóa Smartkey Honda Lead, Airblade (Màu đen)",19000,19000,0,0
TIKI,o-to-xe-may-xe-dap,49892094,"Mũ bảo hiểm trẻ em bảo vệ đầu cho bé có kính chắn bụi, chống chói hình pikachu siêu ciu xanh dương đậm",219000,219000,0,0
TIKI,o-to-xe-may-xe-dap,105085632,"Bóng Đèn Pha Bi Cầu Mini Chân H4 Siêu Sáng , 2 Chế Độ Vàng Và Trắng",91000,91000,0,0
TIKI,o-to-xe-may-xe-dap,35895193,"Thảm Lót Sàn Cao Su Theo Dành Cho Ô Tô Toyota Fortuner",748600,788000,39400,5
TIKI,o-to-xe-may-xe-dap,127677589,"Đèn led cảnh báo mở cửa ô tô chống va chạm, gắn cửa xe TÂM LUÂN Chổi lau tẩm dầu - Hàng chính hãng",69000,100000,31000,31
TIKI,o-to-xe-may-xe-dap,33279105,"Bao da chìa khóa cao cấp dành cho xe Mitsu Xpander kèm móc khóa mẫu RO",130625,137500,6875,5
TIKI,o-to-xe-may-xe-dap,31609929,"Máy khử mùi, lọc không khí trên xe ô tô cao cấp Philips GP7101 - Hàng chính hãng",4090000,4090000,0,0
TIKI,o-to-xe-may-xe-dap,134362466,"Đèn đuôi nhấp nháy đèn cảnh báo sau cho xe đạp thể thao siêu sáng, chống nước",29000,29000,0,0
TIKI,o-to-xe-may-xe-dap,181623378,"(LOẠI TỐT) Hộp 2 bóng đèn pha Xenon ô tô siêu sáng H4 100W HOD 6000K dành cho xe hơi sáng trắng mẫu mới, đồ chơi ô tô",198000,198000,0,0
TIKI,o-to-xe-may-xe-dap,190516458,"Bình Xịt phủ Nano Chống Nước  Ceramic Wax - Phủ Nano Chống Nước Kính Ô tô - Phủ Bóng Xe Hơi Xe Máy(200ml)",88000,88000,0,0
TIKI,o-to-xe-may-xe-dap,116828251,"Khóa Số Xe Đạp 4 Số Mật Mã Vỏ PVC Bọc Lõi Thép (dạng tròn cứng) (mật khẩu mặc định 0000) Mai Lee",65550,69000,3450,5
TIKI,o-to-xe-may-xe-dap,11949113,"Bọc vô lăng cao cấp ô tô mẫu VL011",83600,88000,4400,5
TIKI,o-to-xe-may-xe-dap,54675045,"Dung Dịch Làm Sạch & Bảo Dưỡng Da  Michelin Leather Cleaner 32187-250Ml Hàng Chính Hãng",120000,170000,50000,29
TIKI,o-to-xe-may-xe-dap,149919468,"Dè con nối dài 2 râu (kiểu mơi) chăn bùn dành cho xe ex 150 ex 155 exciter 150 exciter 155 (CHỮ NGẪU NHIÊN)",70000,70000,0,0
TIKI,o-to-xe-may-xe-dap,122951942,"Combo vệ sinh nội thất dạng bọt + dưỡng da cao cấp chính hãng Wurth",720000,720000,0,0
TIKI,o-to-xe-may-xe-dap,154273998,"Đèn led pha siêu sáng chân hs5 dành cho xe airblade, lead, pcx",212000,212000,0,0
TIKI,o-to-xe-may-xe-dap,105184008,"Bọc chìa khóa Smartkey Honda Air Blade, Vision, Lead, Vario- 2 nút silicon ( mẫu cũ to)",18050,18050,0,0
TIKI,o-to-xe-may-xe-dap,20357325,"Biển Cảnh Báo Nguy Hiểm - Biển Tam Giác cảnh báo cho xe hơi Phản quang kích cỡ 43Cm",49000,49000,0,0
TIKI,o-to-xe-may-xe-dap,119109734,"Bộ 4 tấm che chắn nắng cho cửa sổ ô tô (2 tròn + 2 lá)",149000,149000,0,0
TIKI,o-to-xe-may-xe-dap,90439133,"Khoá Chống Trộm Chữ U Cho Xe Máy Kèm 2 Chìa Tiện Lợi",66000,66000,0,0
TIKI,o-to-xe-may-xe-dap,35582464,"Dụng cụ đi tiểu khi đi ô tô / dã ngoại hoặc cho người bệnh",58000,58000,0,0
TIKI,o-to-xe-may-xe-dap,23380848,"Giá kẹp điện thoại chống trộm, chống rung lắc cho xe máy",37550,37550,0,0
TIKI,o-to-xe-may-xe-dap,54719657,"Mũ Bảo Hiểm Trẻ Em 1/2 Đầu Có Kính Họa Tiết Siêu Anh Hùng Marvel CapTain American, An Toàn, Thời Trang, Nhẹ Nhàng, Chắc Chắn Protec Kitty - Hàng Chính Hãng",368000,442000,74000,17
TIKI,o-to-xe-may-xe-dap,112866031,"Đèn Xe Đạp Có Còi T6 350lumens (nút chạm cảm ứng) Pin 2000mAh Còi âm thanh lớn 140dB MaiLee",193000,209000,16000,8
TIKI,o-to-xe-may-xe-dap,42283206,"Khăn lau ô tô chuyên dụng Microfiber 3M 36x36cm",39000,39000,0,0
TIKI,o-to-xe-may-xe-dap,184518754,"Sticker dán nắp xăng dầu, trang trí ô tô, xe tải",18000,18000,0,0
TIKI,o-to-xe-may-xe-dap,153941683,"Túi da đựng đồ đa năng treo sau ghế Ô tô, Xe hơi – Tích hợp bàn ăn tiện lợi",252000,296000,44000,15
TIKI,o-to-xe-may-xe-dap,14756331,"Bọc vô lăng ô tô - Bọc vô lăng cao cấp - Bọc vô lăng",64000,71000,7000,10
TIKI,o-to-xe-may-xe-dap,50561795,"HỘC ĐỰNG ĐỒ CHO XE AIRBLADE 2020",33000,33000,0,0
TIKI,o-to-xe-may-xe-dap,116016828,"(hàng mới về) Bình xịt tạo bọt tuyết rửa xe ô tô cầm tay 1.8 lít tiện dụng",235600,248000,12400,5
TIKI,o-to-xe-may-xe-dap,69218770,"Bọc Vô Lăng Ô Tô Size 38 Bằng Da PU Cao Cấp VERSION 1",90000,95000,5000,5
TIKI,o-to-xe-may-xe-dap,14506990,"Máy bơm lốp  ô tô, xe hơi STEEL MATE cài đặt được thông số bơm, tự ngắt khi đủ áp - Hàng nhập khẩu",435000,435000,0,0
TIKI,o-to-xe-may-xe-dap,86613770,"Bộ 2 Gù tay Lái INOX gắn mọi loại xe máy",72000,72000,0,0
TIKI,o-to-xe-may-xe-dap,132351949,"(Chọn màu) Tem ĐÔI MẮT xe tải,trang trí dán xe tải, nắp capo, gương chiếu hậu, độc lạ, decal ô tô chất lượng cao",25000,35000,10000,29
TIKI,o-to-xe-may-xe-dap,195621917,"ỐP KHOÁ TOYOTA Camry - Cross - Altis 2022",399000,399000,0,0
TIKI,o-to-xe-may-xe-dap,121978445,"Dầu Nhớt ENEOS CHO XE SỐ SJ40 - HÀNG CHÍNH HÃNG",72000,72000,0,0
TIKI,o-to-xe-may-xe-dap,45188578,"Đèn Led Xe Đạp, Đèn Hậu Cảnh Báo Xe Đạp Gắn Phía Sau Siêu Sáng Có Sạc Điện USB Chống Nước Giúp Đạp Xe An Toàn Ban Đêm 3 Màu Nhiều Chế Độ - Hàng Chính Hãng",113050,119000,5950,5
TIKI,o-to-xe-may-xe-dap,22373404,"Combo đèn pin + đèn chiếu hậu xe đạp tặng đèn led van xe",48264,48264,0,0
TIKI,o-to-xe-may-xe-dap,134230810,"Giá chở hàng - Baga xe máy đa năng dành cho các loại xe mở cốp không cần tháo",248000,248000,0,0
TIKI,o-to-xe-may-xe-dap,40567862,"Thảm sàn, lót sàn cao su không mùi Cao cấp dành cho xe Toyota Vios 2014-2019",435100,458000,22900,5
TIKI,o-to-xe-may-xe-dap,82473369,"GỐI TỰA ĐẦU, TỰA LƯNG 3D CHẤT LIỆU CAO SU NON BỌC  DA TRÊN XE Ô TÔ - NHIỀU MÀU",125000,125000,0,0
TIKI,o-to-xe-may-xe-dap,176417606,"[Vải Dù Dày Nặng 1kg]Bạt Phủ - Áo Trùm Xe Máy Cao Cấp Vải Dù 2 Mặt Che Nắng, Mưa Giữ Xe Luôn Như Mới Vừa Tất Cả Loại Xe",140000,140000,0,0
TIKI,o-to-xe-may-xe-dap,162528707,"Combo 8 Miếng Đệm Giảm Xóc Cách âm, Giảm lực đóng bảo vệ Ô Tô",39000,39000,0,0
TIKI,o-to-xe-may-xe-dap,72640260,"Mắt Kính Xe Đạp Thể Thao Phân Cực Chống Ánh Nắng (5 Mắt Kính) Chống Tia UV Cực Tím Ánh Nắng UV400 (Kèm hộp và phụ kiện, gọng phụ cho kính cận) Đạp Xe, Thể Thao Ngoài Trời, Câu Cá Mai Lee",189000,199000,10000,5
TIKI,o-to-xe-may-xe-dap,58206719,"Chai vá lốp xe khẩn cấp Michelin 92423 / W32699 tặng kèm 1 móc khóa",329000,329000,0,0
TIKI,o-to-xe-may-xe-dap,68005711,"Nước rửa xe đậm đặc BZ Gloss Shampoo 1000ml",95000,95000,0,0
TIKI,o-to-xe-may-xe-dap,73398588,"Nhớt động có Total Quartz 5000 10W40 (4 lít) - Dầu nhớt Total",379000,379000,0,0
TIKI,o-to-xe-may-xe-dap,75831153,"Phục hồi nhựa nhám SPRAYKING - Chất lượng cao",50000,50000,0,0
TIKI,o-to-xe-may-xe-dap,111589469,"Nón Bảo Hiểm Trẻ Em Nửa Đầu Protec KITTY, Họa Tiết Nữ Hoàng Băng Giá Elsa xinh xắn, Siêu Thoáng Khí",305000,358000,53000,15
TIKI,o-to-xe-may-xe-dap,150494093,"Đèn trợ sáng ô tô xe máy 16 tim led siêu sáng loại tốt",95000,95000,0,0
TIKI,o-to-xe-may-xe-dap,178089164,"Chai xịt tẩy rửa hợp kim nhôm, tẩy lốc máy, đầu bò, dàn chân xe máy, xịt sên SprayKing REPAIR 1000ml",65000,65000,0,0
TIKI,o-to-xe-may-xe-dap,131337900,"Găng Tay Sport Cụt Ngón, Đi Xe Máy Đi Phượt",45000,45000,0,0
TIKI,o-to-xe-may-xe-dap,11787164,"Bọc vô lăng cao cấp ô tô mẫu VL012",90250,95000,4750,5
TIKI,o-to-xe-may-xe-dap,72623540,"Nón bảo hiểm 3/4 kính âm Royal M139 Đen vân carbon cao cấp Lót tháo rời, che hết mặt",499000,499000,0,0
TIKI,o-to-xe-may-xe-dap,24865306,"Mũ bảo hiểm GRS A368K",369000,369000,0,0
TIKI,o-to-xe-may-xe-dap,139289469,"Đầu bơm hơi lốp ô tô xe máy đa năng",34000,34000,0,0
TIKI,o-to-xe-may-xe-dap,158492480,"Nón bảo hiểm nửa đầu Gro ST04 phong cách, màu sắc trẻ trung cho nam nữ,  hai mẫu kính an toàn, thời trang- Hàng chính hãng",245000,335000,90000,27
TIKI,o-to-xe-may-xe-dap,178531102,"[Giá 1 đôi]Ốc chân gương hình mặt cười, ốc chân kính cho xe máy nhiều màu lựa chọn-OCG",11400,12000,600,5
TIKI,o-to-xe-may-xe-dap,55459659,"Bọc vô lăng ô tô Sparco chính hãng - SPC102BLS",399000,399000,0,0
TIKI,o-to-xe-may-xe-dap,110821447,"Bút thử điện ô tô 6V - 12V - 24V bóng led",38000,55000,17000,31
TIKI,o-to-xe-may-xe-dap,119719081,"Ắc quy khô GS GTZ5S 3,5Ah Wave RS Rsx Rsv S, Nouvo456, Airblade110, Hayate X-Bike SKY Exciter Luvias Cub acquy Yuasa",320000,320000,0,0
TIKI,o-to-xe-may-xe-dap,35915397,"Chổi Lau Xe Rửa Vệ Sinh Ô Tô Điều Chỉnh Được Độ Dài Cao Cấp",54150,57000,2850,5
TIKI,o-to-xe-may-xe-dap,115478671,"Nước Rửa Xe Sonax Gloss Shampoo 1000ml Chính Hãng Nhập Đức",139000,170000,31000,18
TIKI,o-to-xe-may-xe-dap,46578885,"Nước Rửa Xe Không Chạm Đặc Biệt T-rex 80 Ekokemika - (1l) - Hàng Chính Hãng",181000,208000,27000,13
TIKI,o-to-xe-may-xe-dap,73802977,"Giá Bình Nước Xe Đạp Siêu Nhẹ Gắn Khung Cho Xe Đạp Leo Núi, Thể Thao Giá Rẻ Bằng Nhựa Chất Lượng Cao Mai Lee",43000,69000,26000,38
TIKI,o-to-xe-may-xe-dap,72537637,"Tẩu Chuyển Đổi Dòng Điện 12V sang 220V Trong Xe Ô Tô ",223250,235000,11750,5
TIKI,o-to-xe-may-xe-dap,83348129,"Nón bảo hiểm 3/4 ROYAL M139 có kính âm V5 TRẮNG",552000,730000,178000,24
TIKI,o-to-xe-may-xe-dap,10711088,"Giá Đỡ Điện Thoại Xe Ô Tô Thông Minh Longneck",37000,51278,14278,28
TIKI,o-to-xe-may-xe-dap,170484247,"CẢNG SAU,BAGA SAU,NHÔM ĐÚC NGUYÊN KHỐI CHO WINNERX,WINNER EX150 EX155 EXCITER 150 EXCITER 155 SIÊU ĐẸP MALAY",179000,179000,0,0
TIKI,o-to-xe-may-xe-dap,101425351,"[CHÍNH HÃNG] XWash - Xịt tẩy rửa, khử mùi nội thất ô tô KHÔNG HÓA CHẤT  - Tặng khăn lông cừu cao cấp",599000,599000,0,0
TIKI,o-to-xe-may-xe-dap,57625930,"Bộ Khung Biển Số Trước & Sau Xe Ô tô Lá Cờ Inox 304 + Tặng 01 Móc Gắng Chìa Khóa Xe Ngẫu Nhiên",250000,250000,0,0
TIKI,o-to-xe-may-xe-dap,105525678,"Nón bảo hiểm xe đạp thể thao Protec Win 069 (WT 069), mũ bảo hiểm xe đạp sang trọng, Size L cho vòng đầu từ 58 đến 61cm",599000,750000,151000,20
TIKI,o-to-xe-may-xe-dap,37862107,"Bộ Tem Hợp Kim Nhôm Cao Cấp Trang Trí Ô Tô, Xe Máy  - Cờ Đức",28000,45000,17000,38
TIKI,o-to-xe-may-xe-dap,90463152,"Cặp Đèn xi nhan mini 3 led sáng vàng dành cho các dòng xe winner X, ex 150, NVX, MSX, CBR",83990,83990,0,0
TIKI,o-to-xe-may-xe-dap,7465245,"Bộ ổ khóa đĩa xe máy",35900,35900,0,0
TIKI,o-to-xe-may-xe-dap,142442642,"Bộ Dụng Cụ Sữa Chữa Xe Đạp Chuyên Dụng - Dụng Cụ Mở Xích Xe Đạp , Mở Căm Xe Đạp Chuyên Dụng Tiện Dụng 6 món",234650,247000,12350,5
TIKI,o-to-xe-may-xe-dap,1237305,"Chai Xịt Dưỡng Sên Thunder Chain Lube (400ml)",55000,55000,0,0
TIKI,o-to-xe-may-xe-dap,168563284,"Túi treo điện thoại đúng Sunha gắn đầu xe máy bằng chất liệu vải bố chuyên dụng Sunha SIGATO SGT 3679",74000,74000,0,0
TIKI,o-to-xe-may-xe-dap,54566742,"Chân chỗng xe đạp - Tặng kèm chuông CC01",64900,64900,0,0
TIKI,o-to-xe-may-xe-dap,206623766,"Thảm lót sàn ô tô KATA cho xe Hyundai Creta (2022-2023) - Khít với sàn xe, Chống trơn, Không mùi, Không ẩm mốc",1990000,1990000,0,0
TIKI,o-to-xe-may-xe-dap,48248904,"TẤM LƯỚI TỰA LƯNG GHẾ Ô TÔ HẠT GỖ MẪU 1",74000,114000,40000,35
TIKI,o-to-xe-may-xe-dap,184593239,"1 CHAI KEO CHUYÊN XỬ LÝ CÁC VẾT NỨT VỠ KÍNH CHẮN GIÓ XE HƠI ÔTÔ CHUYÊN NGHIỆP LÀM LÀNH NHƯ MỚI HÀNG CAO CẤP",128000,128000,0,0
TIKI,o-to-xe-may-xe-dap,1176295,"Chai Phục Hồi, Làm Mới Nhựa Ngoài Liqui Moly 1552 (250ml)",205000,219000,14000,6
TIKI,o-to-xe-may-xe-dap,135111875,"Bảng ghi số trên ô tô tự động phát sáng khi trời tối, miếng hít dính chắc chắn TÂM LUÂN Chổi lau tẩm dầu - Hàng chính hãng",19000,30000,11000,37
TIKI,o-to-xe-may-xe-dap,16991782,"Bình xịt tạo bọt tuyết rửa xe",300000,300000,0,0
TIKI,o-to-xe-may-xe-dap,119695037,"Nút dán giảm lực đóng bảo vệ cửa xe ô tô, miếng dán Silicon bảo vệ cửa ô tô",4000,4000,0,0
TIKI,o-to-xe-may-xe-dap,48246569,"Búa Thoát Hiểm Thông Minh Chuyên Dụng Cho Ô Tô",105000,105000,0,0
TIKI,o-to-xe-may-xe-dap,137523906,"Thùng Xăng Dự Phòng An Toàn Mastersea Úc. Dung Tích 5 Lít. Chống Va Đập, Chống Bay Hơi Xăng. Siêu an toàn",550000,550000,0,0
TIKI,o-to-xe-may-xe-dap,1378123,"Găng Tay Chống Cắt 3M Cấp Độ 5 Cut Resistant Gloves",120000,126000,6000,5
TIKI,o-to-xe-may-xe-dap,85805399,"Thảm lót sàn ô tô - thảm sàn xe 4-5 chỗ cao su loại 1",263000,263000,0,0
TIKI,o-to-xe-may-xe-dap,50456405,"Bảng Số Điện Thoại Gắn Taplo Ô Tô Đa Năng ",24000,30890,6890,22
TIKI,o-to-xe-may-xe-dap,55480529,"Dụng cụ móc đá lốp xe đa năng 5 trong 1",38899,38899,0,0
TIKI,o-to-xe-may-xe-dap,52504811,"Cuộn cacbon dán cốp, dán bước chân chống xước xe hơi, ô tô",134000,134000,0,0
TIKI,o-to-xe-may-xe-dap,72909593,"Găng tay phượt Blackhawk dài ngón găng tay bảo hộ xe máy",115000,115000,0,0
TIKI,o-to-xe-may-xe-dap,108925554,"Nón bảo hiểm 3/4 cao cấp Royal M20C Thời trang, Cá tính, Bảo hành chính hãng 12 tháng",550000,550000,0,0
TIKI,o-to-xe-may-xe-dap,108198041,"[TẶNG ỐC CHÂN KÍNH] Gương chiếu hậu Rizoma 5 cạnh nhôm CNC  Màu Đỏ dành cho các loại xe máy siêu chất - TKA-DG66do",106704,187200,80496,43
TIKI,o-to-xe-may-xe-dap,53772645,"Nẹp U Lõi Thép Gioăng Cao Su CHữ U Lõi Thép - Nẹp U Viền Cửa Xe Chống Va Đập Cuộn 15m",109000,115000,6000,5
TIKI,o-to-xe-may-xe-dap,192715269,"Đệm Ngồi 3D Nệm Lót Ghế Gel Silicon Tổ Ong Cao Cấp Thoáng Khí Chống Đau Mỏi 220",87998,87998,0,0
TIKI,o-to-xe-may-xe-dap,46555782,"Đầu vòi bơm oto xe máy - Kiêm đồng hồ đo áp suất lốp - Hàng nhập khẩu",108000,108000,0,0
TIKI,o-to-xe-may-xe-dap,52114119,"Bạt Phủ Xe Ô tô 7 chỗ Innova, Bạt Che Xe, Trùm Xe Hơi ",307800,324000,16200,5
TIKI,o-to-xe-may-xe-dap,161524240,"Tẩy ố kính ô tô TOKO 60, không cháy kính, làm sạch ố mốc kính, ố 7 màu, cặn canxi | Lựa chọn hàng đầu của GARAGE, Chăm sóc xe",149000,270000,121000,45
TIKI,o-to-xe-may-xe-dap,52481364,"nhông sên đĩa vàng dành cho xe exciter 150",253000,253000,0,0
TIKI,o-to-xe-may-xe-dap,44973674,"tiu tiện giảm thanh mẫu pô leovince hình tròn",47000,47000,0,0
TIKI,o-to-xe-may-xe-dap,78895833,"Đệm lót ghế ô tô hạt gỗ Pơ Mu 100% tự nhiên tựa lưng massage trên ô tô - Dạng Cài Đàn - Kích thước: 1,25x0,46m - Trọng lượng: 2,7Kg - Mã: PM-D",237405,249900,12495,5
TIKI,o-to-xe-may-xe-dap,130287501,"Chống Xe Đạp Thể Thao - Xe Đạp Đường Phố Soldier - Chất Liệu Nhôm Chắc Chắn - Kiểu Dáng Hiện Đại (tặng kèm lục giác để lắp sản phẩm)",74100,78000,3900,5
TIKI,o-to-xe-may-xe-dap,111463541,"BAO CHÌA KHÓA CACBON XE MAZDA CX5, MAZDA 3, MAZDA 6",185250,195000,9750,5
TIKI,o-to-xe-may-xe-dap,6940529,"Bộ 2 gù chống đổ sau dành cho xe máy ( màu đỏ )",45000,45000,0,0
TIKI,o-to-xe-may-xe-dap,185923587,"Ổ cắm tẩu sạc đầu cái trên Oto ổ thêm tẩu cho camera hành trình 12V-24V 10A",29999,29999,0,0
TIKI,o-to-xe-may-xe-dap,58566956,"Bộ bao tay xe máy kiểu Exciter Green Networks Group",55000,55000,0,0
TIKI,o-to-xe-may-xe-dap,1176327,"Dầu Bôi Trơn Đa Năng Liqui Moly 3305 (500ml)",120650,127000,6350,5
TIKI,o-to-xe-may-xe-dap,52026570,"Bút Cảm Ứng Che Mờ Vết Xước Sơn Xe Ô Tô Xe Máy Theo Màu Sơn",49000,49000,0,0
TIKI,o-to-xe-may-xe-dap,208195485,"Mũ bảo hiểm có kính NÓN SƠN chính hãng KP-TR083",582000,1000000,418000,42
TIKI,o-to-xe-may-xe-dap,20531183,"Bọc vô lăng ô tô - Bọc vô lăng ",63000,67000,4000,6
TIKI,o-to-xe-may-xe-dap,172068633,"Đèn pha led xe máy mẫu mới xài trực tiếp điện máy không bị chớp ga loại xịn lắp không cần độ chế",188100,198000,9900,5
TIKI,o-to-xe-may-xe-dap,74769626,"1 cặp ốc kiểu vặn gấp tăng sên xe máy xe đạp xe điện lổ 6li nhôm CNC tặng bao tay kiểu dáng ngẫu nhiên",26150,26150,0,0
TIKI,o-to-xe-may-xe-dap,153469257,"Bộ sửa chữa vết nứt kính chắn gió",234000,234000,0,0
TIKI,o-to-xe-may-xe-dap,117597788,"Lọc gió máy lạnh than hoạt tính Kia Carens, Forte, Rio, Sportage, Soluto, Accent",89000,89000,0,0
TIKI,o-to-xe-may-xe-dap,147975332,"TỰA LƯNG LÓT GHẾ Ô TÔ, XE HƠI HẠT GỖ CHỐNG NÓNG, TRƯỢT VÀ MASSAGE CAO CẤP",254000,284000,30000,11
TIKI,o-to-xe-may-xe-dap,72954635,"Thùng đựng đồ đa năng cốp sau ô tô bọc da cao cấp , có nắp gấp, gọn gàng , ngăn nắp chứa được nhiều đồ size 50x32x30",426550,429000,2450,1
TIKI,o-to-xe-may-xe-dap,13310533,"Bơm ô tô xe máy đạp chân đa năng",70977,70977,0,0
TIKI,o-to-xe-may-xe-dap,105184439,"Khung viền biển số titan xe máy - 7 màu",31500,31500,0,0
TIKI,o-to-xe-may-xe-dap,88801541,"Khóa chữ U chống trộm chịu lực tốt cho xe máy - Khóa chữ U báo động âm thanh chống trộm LK605",246000,246000,0,0
TIKI,o-to-xe-may-xe-dap,92154102,"Đèn Chớp Cảnh Sát 16 Bóng Xanh Đỏ Nguồn Tẩu - Đèn LED Police Cho Xe Chuyên Dụng",499000,499000,0,0
TIKI,o-to-xe-may-xe-dap,15202177,"Kính chiếu hậu Dream Thái",65000,65000,0,0
TIKI,o-to-xe-may-xe-dap,80697192,"Rổ lưới và bát gắn cho các dòng xe Wave, Sirius",180000,180000,0,0
TIKI,o-to-xe-may-xe-dap,25409933,"Vòi bơm bánh xe có đồng hồ ",124000,124000,0,0
TIKI,o-to-xe-may-xe-dap,126725195,"Combo 2 chai xịt diệt khuẩn khử mùi ô tô, xe hơi Nano Xclean For Car 500ml-Khử mùi Hải Sản, ẩm mốc-Vệ sinh, khử mùi nội thất-Nano Bạc AHT Corp",181500,330000,148500,45
TIKI,o-to-xe-may-xe-dap,13850031,"Thùng Đựng Đồ Co Giãn 40L Cho Ô Tô - Thùng đựng đồ co giãn cho xe ô tô",214000,318000,104000,33
TIKI,o-to-xe-may-xe-dap,208212997,"Mũ bảo hiểm lỗ thông gió NÓN SƠN chính hãng TG-XM151",325000,650000,325000,50
TIKI,o-to-xe-may-xe-dap,188964502,"Chai xịt diệt khuẩn khử mùi ô tô xe khách bằng nano bạc Nano Reiwa 100ml được chứng nhận viện Pasteur an toàn cho trẻ em - Hàng chính hãng",41000,70400,29400,42
TIKI,o-to-xe-may-xe-dap,20877173,"Gối Tựa Đầu Ô Tô Cao Su Non Cao Cấp Lucky Bobi AZONE",75000,75000,0,0
TIKI,o-to-xe-may-xe-dap,159395137,"Kính chiếu hậu USB cho các loại xe máy",160000,160000,0,0
TIKI,o-to-xe-may-xe-dap,92515320,"YÊN XE ĐẠP TRẺ EM - TTH257",63000,63000,0,0
TIKI,o-to-xe-may-xe-dap,26425278,"Mỡ bò xịt khô Wurth HHS Drylube 400ml 08931066 Adhesive Lubricant HHS Drylube",291000,291000,0,0
TIKI,o-to-xe-may-xe-dap,2185043,"Nón Bảo Hiểm Giro Isode",1100000,1100000,0,0
TIKI,o-to-xe-may-xe-dap,6942675,"Bộ 2 Gù chống đổ sau dành cho các dòng xe máy ( màu bạc )",45000,45000,0,0
TIKI,o-to-xe-may-xe-dap,53838863,"Dây câu bình ắc quy ô tô dài 4m dòng 2500A",195000,195000,0,0
TIKI,o-to-xe-may-xe-dap,10152418,"Giá Đỡ Điện Thoại Gắn Trên Cửa Gió Điều Hòa Ô Tô Baseus SUYL-01",160000,160000,0,0
TIKI,o-to-xe-may-xe-dap,54056877,"Nón bảo hiểm 3/4 Bulldog Perro 4U cao cấp Chính hãng, Lót tháo rời, Tặng khóa số chống trộm, túi xách và balo rút Bulldog",899000,899000,0,0
TIKI,o-to-xe-may-xe-dap,131253973,"Lọc gió động cơ ô tô HONDA CITY 2013-2018",120000,120000,0,0
TIKI,o-to-xe-may-xe-dap,8266088,"Rổ xe máy WAVE A INOX RXM0018 10mm",99000,99000,0,0
TIKI,o-to-xe-may-xe-dap,1176233,"Bình Súc Béc Xăng Liqui Moly 1803 (300ml)",165000,165000,0,0
TIKI,o-to-xe-may-xe-dap,67893019,"Túi treo đồ có khay bàn ăn xếp gọn móc sau ghế ô tô, xe hơi kiểu mẫu hoạt hình dễ thương cho trẻ em- Hàng chính hãng",295000,295000,0,0
TIKI,o-to-xe-may-xe-dap,8075340,"Kính Chiếu Hậu Tròn Gắn Các Loại Xe Máy",45000,45000,0,0
TIKI,o-to-xe-may-xe-dap,56066025,"Nẹp carbon chống xước bậc lên xuống cửa xe ô tô loại 7cm x 250cm",70000,74000,4000,5
TIKI,o-to-xe-may-xe-dap,139718328,"Bạt che phủ bảo vệ ô tô xe hơi 4 chỗ, 5 chỗ, 7 chỗ vải Dù cao cấp siêu bền chống xước, chống nắng nóng, chống cháy, chống mưa, chống bụi bẩn",430000,430000,0,0
TIKI,o-to-xe-may-xe-dap,137164644,"chân chống đứng chân chống sau xe đạp mini các cỡ 20/24/26",83000,83000,0,0
TIKI,o-to-xe-may-xe-dap,514210,"Nước Rửa Kính Chống Bám Nước FORMULA 1 - TRF1615807 - 710Ml",175750,185000,9250,5
TIKI,o-to-xe-may-xe-dap,49983451,"cảng sau kiểu MiO dùng cho xe sirius màu đen",114000,114000,0,0
TIKI,o-to-xe-may-xe-dap,68448439,"Tinh dầu thơm xe hơi mô hình máy bay chiến đấu chạy bằng năng lượng mặt trời",154000,189000,35000,19
TIKI,o-to-xe-may-xe-dap,96615231,"Bơm xe đạp xe máy 180psi/12kg GIYO 2730 thân thép đồng hồ siêu to",440000,440000,0,0
TIKI,o-to-xe-may-xe-dap,52110803,"Phụ gia nhớt súc rửa động cơ cao cấp Liqui Moly 2427 - Tặng kèm 1 khăn lau chuyên dụng 3M",239000,239000,0,0
TIKI,o-to-xe-may-xe-dap,133431341,"Thùng đựng đồ gấp gọn để đồ trên ô tô, xe hơi, văn phòng, gia đình 45L và 75L có nhiều ngăn đựng riêng bi",368000,400000,32000,8
TIKI,o-to-xe-may-xe-dap,271997504,"Yên Xe Đạp Phoenix Êm Ái Chống Nước Phù Hợp Với Mọi Dòng Xe Đạp Thể Thao Địa Hình",250000,250000,0,0
TIKI,o-to-xe-may-xe-dap,54626236,"Dầu nhớt Mobil 5W30 EP 946ml - Chính hãng Mobil nhập khẩu từ Mỹ",295000,295000,0,0
TIKI,o-to-xe-may-xe-dap,184518746,"Miếng dán decal nắp bình xăng dầu cho xe oto Oil-8",19000,19000,0,0
TIKI,o-to-xe-may-xe-dap,125536186,"Nút Cao Su giảm chấn cửa ô tô Núm cao su chống sốc bảo vệ cửa xe ô tô,Đệm giảm chấn lực đóng cửa ô tô",5500,5500,0,0
TIKI,o-to-xe-may-xe-dap,1663701,"Khóa Chìa Xe Đạp Thể Thao Tonyon",74159,74159,0,0
TIKI,o-to-xe-may-xe-dap,138387597,"Bộ vam tháo vòng bi 2 đĩa chặn, bộ cảo bi kiểu bán nguyệt",750000,750000,0,0
TIKI,o-to-xe-may-xe-dap,21798216,"Găng Tay Xe Máy",85000,85000,0,0
TIKI,o-to-xe-may-xe-dap,5434623,"Baga trước dành cho xe Exciter 150 dày 10 ly",110000,110000,0,0
TIKI,o-to-xe-may-xe-dap,154173062,"Lót cốp dành cho xe Honda City 2021 không mùi, chất liệu TPO cao cấp",299250,315000,15750,5
TIKI,o-to-xe-may-xe-dap,26080515,"Chổi lau ô tô - Rửa xe ô tô lụa mềm cao cấp đa chức năng -  điểu chỉnh được độ dài LT132",63000,67000,4000,6
TIKI,o-to-xe-may-xe-dap,96911021,"Bộ 4 ốc - nắp chụp chân van, đầu vòi xe hơi, xe máy, ô tô chất lượng cao chống rỉ nhiều màu",10000,17500,7500,43
TIKI,o-to-xe-may-xe-dap,14563208,"Nón bảo hiểm ¾ GRS A318K kính dài",580000,580000,0,0
TIKI,o-to-xe-may-xe-dap,83347244,"Nón bảo hiểm 3/4 ROYAL M139 có kính âm màu ĐỎ ĐÔ",534000,700000,166000,24
TIKI,o-to-xe-may-xe-dap,115707800,"Bao tay nắm chống mỏi xe đạp siêu êm",36000,39000,3000,8
TIKI,o-to-xe-may-xe-dap,172842303,"Tẩu đực cắm lỗ sạc trên ô tô (Không cầu chì)",33000,33000,0,0
TIKI,o-to-xe-may-xe-dap,104799820,"Chai xịt bảo dưỡng cao su, ron cửa và lốp xe ô tô nhãn hiệu Sonax 340200 dung tích 300 ml - Hàng Chính Hãng",274000,274000,0,0
TIKI,o-to-xe-may-xe-dap,75982771,"Bộ gù chống đổ Trước Sau xe máy - Combo Gù chống đổ Trước và Gù chống đổ Sau Green Networks Group",159000,159000,0,0
TIKI,o-to-xe-may-xe-dap,178089418,"Sprayking Super Wash 1L nước rửa xe tạo bọt tuyết, xà phòng rửa xe siêu sáng bóng ",69000,69000,0,0
TIKI,o-to-xe-may-xe-dap,119719000,"Sạc Ắc Quy Tự Động AST 10A 12V, Bộ sạc bình ắc quy từ 3ah - 200ah, sạc bình ắc quy cho xe máy đến ô tô",1181000,1181000,0,0
TIKI,o-to-xe-may-xe-dap,29568534,"Cần số 2 chiều gắn xe Winner X BẢO LONG RACING",75000,75000,0,0
TIKI,o-to-xe-may-xe-dap,56657785,"Bình Ăc Quy Vuông Dùng Cho Xe Điện Trẻ Em 6V 4.5Ah",119000,119000,0,0
TIKI,o-to-xe-may-xe-dap,135344276,"NƯỚC HOA XE HƠI NHẬP KHẨU CAO CẤP TRANG TRÍ, KHỬ MÙI, LÀM THƠM XE HƠI | CỬA HÀNG NƯỚC HOA Ô TÔ LEVISTORE",416000,650000,234000,36
TIKI,o-to-xe-may-xe-dap,84882531,"Nón Bảo Hiểm Xe Đạp Có Kính Protec Win 018, Mũ Bảo Hiểm Xe Đạp Tiêu Chuẩn Châu Âu, Kính Mát, Chống Nắng, Chống Tia UV - Hàng Chính Hãng",499000,568000,69000,12
TIKI,o-to-xe-may-xe-dap,116396323,"Quạt đôi ô tô công suất lớn xoay 360 độ 3 tốc độ gió chân cắm usb dùng cho ô tô ,bàn làm việc máy tính F303",189000,189000,0,0
TIKI,o-to-xe-may-xe-dap,22753760,"Bộ 5 Tấm Lưới Chắn Nắng Chống Nóng Ô Tô - Chắn Nắng Hiệu Quả",69000,69000,0,0
TIKI,o-to-xe-may-xe-dap,116014096,"Combo 4 miếng dán gương ôtô(chống bám nước)",45000,45000,0,0
TIKI,o-to-xe-may-xe-dap,131192839,"Cảng Vision SH 300i nhôm đúc đời 2014-2020",329000,329000,0,0
TIKI,o-to-xe-may-xe-dap,801326,"Máy Lọc Không Khí Cho Xe Hơi Sharp IG-GC2E-B - Đen - Hàng chính hãng",2190000,2190000,0,0
TIKI,o-to-xe-may-xe-dap,4405975,"Ruột xe đạp Impac 26’’ AV (40mm)",69000,69000,0,0
TIKI,o-to-xe-may-xe-dap,31843672,"Dầu Bôi Trơn Chống Rỉ Sét Làm Sạch Thẩm Thấu Chống Ẩm Bảo Vệ WD-40 (300ml)",100000,100000,0,0
TIKI,o-to-xe-may-xe-dap,108204619,"{TẶNG ỐC CHÂN GƯƠNG} Gương (kính) chiếu hậu Rizoma 5 cạnh nhôm CNC cao cấp  Màu xanh dành cho các dòng xe máy - TKA-DG66xanh",100320,176000,75680,43
TIKI,o-to-xe-may-xe-dap,114935699,"Bao Da Chìa Khóa xe ô tô MAZDA 3 allnew, Mazda 2, Mazda Cx8, Mazda CX5 khoá cạnh hình chữ nhật",170000,170000,0,0
TIKI,o-to-xe-may-xe-dap,141917212,"Băng dính 3m 2 mặt trong suốt Acrylic Foam Tapes AFT - Băng keo 3m chuyên dụng ô tô siêu chắc",17100,18000,900,5
TIKI,o-to-xe-may-xe-dap,18003631,"Thùng, hộp đựng đồ co giãn trên Ô tô, Xe hơi - thể tích 40L",224000,224000,0,0
TIKI,o-to-xe-may-xe-dap,10713827,"Túi Đựng Đồ Cốp Sau Ô Tô DC-TDD – Hàng Nhập Khẩu",125000,125000,0,0
TIKI,o-to-xe-may-xe-dap,111000260,"Bao tay rửa xe 2 mặt chuyên dụng Găng Tay Rửa Xe loại dày",15000,16000,1000,6
TIKI,o-to-xe-may-xe-dap,176681268,"Ốp Bảo Vệ Chìa Khóa Xe Toyota Cross Hợp Kim Kẽm",190000,190000,0,0
TIKI,o-to-xe-may-xe-dap,88821558,"Miếng lót đệm bọc yên xe đạp (Màu đỏ) chất liệu bọt biển siêu êm giảm trượt thiết kế thoáng khí thoát mồ hôi tặng kèm chuông kiêm la bàn dành cho xe đạp (Màu Ngẫu Nhiên)",35400,35400,0,0
TIKI,o-to-xe-may-xe-dap,119252927,"Bơm lốp KO DÂY Suitu, bơm ô tô, bơm xe máy, bơm xe đạp Suitu, pin sạc siêu khỏe 6000Mah,- SẠC USB tiện lợi",465000,465000,0,0
TIKI,o-to-xe-may-xe-dap,162247197,"Bạt Phủ Xe Máy, Áo Trùm Xe Vải Dù Che Mưa, Che Nắng, Bảo Vệ Xe _ Vừa Với Tất Cả Các Loại Xe Máy AM14",105000,105000,0,0
TIKI,o-to-xe-may-xe-dap,49976893,"cặp túi treo bênh hông cho xe moto tặng bao tay xe máy",179000,179000,0,0
TIKI,o-to-xe-may-xe-dap,97875662,"Tấm chắn che nắng Ô TÔ Xe Hơi - Phụ kiện chắn tia UV bảo vệ xe - Dù che nắng - Tấm hắt nắng chụp hình Mẫu mới 2024",129000,199000,70000,35
TIKI,o-to-xe-may-xe-dap,139444838,"Sạc độ xe máy HSB -Shilan cực mạnh thông minh tự ngắt khi đầy điều chỉnh dòng sạc loại tốt",149000,149000,0,0
TIKI,o-to-xe-may-xe-dap,102057427,"Bọc vô lăng TTAUTO cho xe ô tô từ 4 đến 7 chỗ chất liệu da vân carbon cao cấp có logo MITSUBISHI (Đen)",159000,250000,91000,36
TIKI,o-to-xe-may-xe-dap,16202304,"GĂNG TAY CHIẾN THUẬT BLACKHAWK CỤT NGÓN",85000,85000,0,0
TIKI,o-to-xe-may-xe-dap,163710187,"Dung dịch đánh bóng nhựa nhám xe máy ô tô phục hồi màu như mới loại tốt siêu đậm dặc",116000,116000,0,0
TIKI,o-to-xe-may-xe-dap,59340645,"Đôi Gối Da Tựa Đầu Xe Hơi Ô Tô Chống Mỏi Cổ Siêu Bền",69000,69000,0,0
TIKI,o-to-xe-may-xe-dap,14957941,"Hộp tỳ tay ô tô cho mọi loại xe tặng tẩu sạc 2 cổng usb",318762,318762,0,0
TIKI,o-to-xe-may-xe-dap,93027827,"Nước làm mát Prestone Honda AF6300 - Nước làm mát Prestone nhập khẩu từ Mỹ",459000,459000,0,0
TIKI,o-to-xe-may-xe-dap,10685866,"Tấm bạt phủ xe máy",39000,39000,0,0
TIKI,o-to-xe-may-xe-dap,190463822,"Săm Ruột Xe Đạp 20x1.75 (47 - 406) CASUMINA",59000,59000,0,0
TIKI,o-to-xe-may-xe-dap,20519923,"Kính chiếu hậu tai mèo chân 10 ly dành cho xe máy ",28000,28000,0,0
TIKI,o-to-xe-may-xe-dap,55665855,"Mũ Bảo Hiểm 3/4 Bulldog Perro 4U 2020 đủ màu",900000,900000,0,0
TIKI,o-to-xe-may-xe-dap,50226569,"Dung dịch nano bảo vệ động cơ xe máy BLUECHEM BC33047",99000,99000,0,0
TIKI,o-to-xe-may-xe-dap,34584716,"Nhớt xe tay ga Repsol Moto Scooter 5w40 1L",171000,171000,0,0
TIKI,o-to-xe-may-xe-dap,113967039,"Búa đập kính thoát hiểm ô tô 7 trong 1 cao cấp kèm túi đựng",145000,145000,0,0
TIKI,o-to-xe-may-xe-dap,195249283,"Meguiar's Xịt khử mùi, diệt khuẩn nội thất xe hơi Mùi hương nam tính - Air Refesher - Black Chrome Scent - G181302, 57 g",350000,410000,60000,15
TIKI,o-to-xe-may-xe-dap,41230340,"RÈM CHE NẮNG KÍNH LÁI XE Ô TÔ TỰ CUỐN CAO CẤP",121000,121000,0,0
TIKI,o-to-xe-may-xe-dap,119085509,"Lọc gió trụ K3 gắn thông dụng các dòng xe",98990,98990,0,0
TIKI,o-to-xe-may-xe-dap,46307104,"Khung kẹp xoay dọc ngang kẹp điện thoại, ipad treo thanh tựa đầu sau ghế xe hơi, ô tô và điều chỉnh máy theo góc nhìn",185000,185000,0,0
TIKI,o-to-xe-may-xe-dap,50822791,"Áo trùm xe máy, bạt trùm xe máy, xe đạp chống mưa 210 x 100 cm+ Tặng quà hình dán ngẫu nhiên",45000,45000,0,0
TIKI,o-to-xe-may-xe-dap,92552880,"Phụ Gia Dầu VOLTRONIC D12 DIESEL MULTIREINIGER (300ml) - Hàng Chính Hãng",333000,333000,0,0
TIKI,o-to-xe-may-xe-dap,153814119,"Cặp Chống đổ sau cho Winner, Exciter",91000,91000,0,0
TIKI,o-to-xe-may-xe-dap,115622643,"Chổi lau ô tô - Rửa xe ô tô lụa mềm cao cấp đa chức năng - điểu chỉnh được độ dài siêu thấm hút 125 CM",79800,84000,4200,5
TIKI,o-to-xe-may-xe-dap,97979802,"Bọc da vô lăng ô tô thể thao loại tốt bám tay thiết kế đẹp mắt phù hợp các loại xe phổ thông",107000,126990,19990,16
TIKI,o-to-xe-may-xe-dap,71090915,"Bọc Vô Lăng Sparco SPC100RD - Hàng Chính Hãng",399000,399000,0,0
TIKI,o-to-xe-may-xe-dap,89301516,"GIÁ ĐỠ ĐIỆN THOẠI KẸP KHE GIÓ ĐIỀU HOÀ Ô TÔ (MẪU 5)",45000,45000,0,0
TIKI,o-to-xe-may-xe-dap,174185898,"Cảng sau nhôm WINNER X Kiểu V1 ko cần chế / tay dắt / baga sau",165000,165000,0,0
TIKI,o-to-xe-may-xe-dap,83346764,"Nón bảo hiểm 3/4 ROYAL M139 có kính âm V10 TRẮNG",552000,730000,178000,24
TIKI,o-to-xe-may-xe-dap,529457,"Xi Đánh Bóng Cana 220G",54000,78000,24000,31
TIKI,o-to-xe-may-xe-dap,151683748,"Ví đựng giấy tờ ô tô Toyota Da Cao Cấp, Ví da đựng giấy tờ xe ô tô",45000,45000,0,0
TIKI,o-to-xe-may-xe-dap,115079434,"Lót cốp dành cho xe  Mazda CX-5 2018-2021 không mùi, chất liệu TPO cao cấp",293000,334000,41000,12
TIKI,o-to-xe-may-xe-dap,96910538," MÓC TREO ĐỒ TRÊN Ô TÔ",12512,13600,1088,8
TIKI,o-to-xe-may-xe-dap,150493582,"Thiết bị đồng hồ đo áp suất lốp ô tô xe máy mini treo móc khóa đa năng tiện dụng màn hình led mẫu mới loại tốt",136000,136000,0,0
TIKI,o-to-xe-may-xe-dap,21726245,"Công tắc hazar chớp nháy 4 bóng xi nhan",29000,35000,6000,17
TIKI,o-to-xe-may-xe-dap,62747178,"Mũ Bảo Hiểm Nửa Đầu Có Kính Cao Cấp Protec Hiway Họa Tiết Đen Xanh Tem Hình COOL Ngầu (Mẫu Mới) - Hàng Chính Hãng",389000,498000,109000,22
TIKI,o-to-xe-may-xe-dap,108998777,"Cụm vào xéc măng piston xe con, xe du lịch , xe tải",141000,160000,19000,12
TIKI,o-to-xe-may-xe-dap,6941827,"Bộ 2 Gù chống đổ sau cho xe máy ( xanh dương )",45000,45000,0,0
TIKI,o-to-xe-may-xe-dap,1176131,"Nhớt Xe Máy 4T Synth 10W50 Race Liqui Moly 1502 (1L)",330000,330000,0,0
TIKI,o-to-xe-may-xe-dap,85804603,"Bạt Che Phủ Xe Ô Tô Cao Cấp 3 Lớp Chống Nắng Nóng Chống Nước Chống xước",272000,286675,14675,5
TIKI,o-to-xe-may-xe-dap,15285822,"Bộ 4 nắp chụp chân van, đầu vòi xe hơi, xe máy, ô tô",9800,9800,0,0
TIKI,o-to-xe-may-xe-dap,44874923,"Gối Tựa Đầu AM01 Trên Xe Hơi - NHIỀU MÀU",94997,94997,0,0
TIKI,o-to-xe-may-xe-dap,48332376,"DUNG DỊCH VỆ SINH BUỒNG ĐỐT ICHINEN NX5000 240ml (JAPAN) - 1 chai",175000,175000,0,0
TIKI,o-to-xe-may-xe-dap,30150394,"Tem xe ô tô thể thao Transformer",229000,229000,0,0
TIKI,o-to-xe-may-xe-dap,52614788,"Khóa u siêu chống cắt chính hãng ABUS - CHLB Đức tặng khóa tủ cá nhân",540000,540000,0,0
TIKI,o-to-xe-may-xe-dap,31962521,"Thảm sàn, lót sàn cao su 3D không mùi Cao cấp dành cho xe Ford Everest 2016-2019",650750,685000,34250,5
TIKI,o-to-xe-may-xe-dap,116875498,"Còi Điện Xe Đạp 120dB Chống Mưa Gắn Tay Lái Xe Đạp",95000,95000,0,0
TIKI,o-to-xe-may-xe-dap,142904077,"DUNG DỊCH VỆ SINH NỘI THẤT Ô TÔ H25 (5 Lit)",369000,379000,10000,3
TIKI,o-to-xe-may-xe-dap,49543118,"Phủ Nano Kính Ô Tô Đa Năng Glaco Blave G-100 Soft99 Japan",239000,239000,0,0
TIKI,o-to-xe-may-xe-dap,117598652,"Mỡ sâu, mỡ bò bôi trơn đóng chai dạng con sâu Grease Lithium Crystal NLGI3 - 400g",29000,29000,0,0
TIKI,o-to-xe-may-xe-dap,182139552,"Đồ Trang Trí Xe Hơi Chú Chó Lắc Đầu Đáng Yêu",61000,65000,4000,6
TIKI,o-to-xe-may-xe-dap,3308227,"Combo 2 Chai Xịt Thơm Phòng Khử Mùi Hàn Quốc Hương Cafe Hazelnut 370ml cho xe hơi (Nâu)",105000,105000,0,0
TIKI,o-to-xe-may-xe-dap,27851066,"Máy Hút Bụi Xe Hơi, Gia Đình Cầm Tay",309000,309000,0,0
TIKI,o-to-xe-may-xe-dap,51909068,"KẸP ẮC QUY CHUYỂN ĐỔI SANG TẨU 12V TRÊN Ô TÔ",25000,25000,0,0
TIKI,o-to-xe-may-xe-dap,136597891,"BỘ GÁC CHÂN TRƯỚC SAU CAO SU ĐEN WAVE S110 CHẾ CHO NHIỀU LOẠI XE",68000,68000,0,0
TIKI,o-to-xe-may-xe-dap,140009099,"Bộ Hộp Dụng Cụ Vá Lốp Xe Lốp Không Săm Vá Lụi (vá ngoài) Bằng Thép Không Gỉ Cho Xe Oto, Xe Hơi Và Xe Máy",175600,175600,0,0
TIKI,o-to-xe-may-xe-dap,49892166,"Tấm, miếng lót massage ghế xe ô tô,xe hơi, ghế văn phòng hạt gỗ tròn hương cao cấp 45x45 tạo cảm giác thoải mái khi ngồi chống mệt mỏi-DL01",69000,125000,56000,45
TIKI,o-to-xe-may-xe-dap,172842609,"Tay quay TRỢ LỰC VÔ LĂNG ô tô",89000,89000,0,0
TIKI,o-to-xe-may-xe-dap,153941018,"Thảm sàn, lót sàn cao su 3D cho Hyundai Santafe 2019",653600,688000,34400,5
TIKI,o-to-xe-may-xe-dap,77015395,"Gương cầu lồi 360 độ cao cấp dành cho ô tô ACP-035",19000,19000,0,0
TIKI,o-to-xe-may-xe-dap,154234342,"Thanh gạt mưa 3 khúc UP Hybrid Luxury dùng cho xe cần gạt tay móc chữ U",184000,184000,0,0
TIKI,o-to-xe-may-xe-dap,1237155,"Nhớt Hộp Số Liqui Moly 80W90 (150ml)",126000,145000,19000,13
TIKI,o-to-xe-may-xe-dap,4077875,"Bơm Đạp Chân Đa Năng 2 Xilanh",220000,220000,0,0
TIKI,o-to-xe-may-xe-dap,28410817,"Combo 2/3/4 cái giá móc treo đa năng gắn tựa đầu treo đồ vật sau ghế ô tô, xe hơi chịu tải đến 5kg",3999,3999,0,0
TIKI,o-to-xe-may-xe-dap,171468901,"(Đèn 3 IN 1) Đèn xe đạp siêu sáng đa năng có Đồng hồ đo tốc độ và Còi cao cấp",299000,299000,0,0
TIKI,o-to-xe-may-xe-dap,6501581,"Bạt phủ ô tô cách nhiệt cao cấp, bạt trùm xe hơi, chống nóng, chống nước vân 3D",179000,250000,71000,28
TIKI,o-to-xe-may-xe-dap,147371419,"Bạt Phủ Ô Tô - Bạt Trùm Xe Ô Tô 3 Lớp Vải Dù Cao Cấp Chống Mưa, Chống Nắng, Chống Cháy",257600,280000,22400,8
TIKI,o-to-xe-may-xe-dap,52341415,"Vỏ Lốp Trước Casumina 2.50 - 17 - 8 Lớp Bố Gai Tải CA102A, Chuyên Dùng Chở Nặng, Địa Hình Xấu, Chịu Lực Tải Trọng Lớn",220000,220000,0,0
TIKI,o-to-xe-may-xe-dap,1254755,"Chai Xịt Tẩy Gỉ Sét, Bôi Trơn Đa Năng Liqui Moly Multi-Spray Plus 7 3305 (500ml)",147250,155000,7750,5
TIKI,o-to-xe-may-xe-dap,55323617,"Mũ Bảo Hiểm Trẻ Em 1/2 Đầu Có Kính Protec Kitty Họa Tiết Nữ Hoàng Băng Giá Frozen Thời Trang, An Toàn, Chất Lượng - Hàng Chính Hãng - Màu Xanh",368000,442000,74000,17
TIKI,o-to-xe-may-xe-dap,109023254,"Đệm Gel Lót Ghế Văn Phòng, Lót yên xe máy xe ô tô Thoáng Khí Siêu mềm",96000,96000,0,0
TIKI,o-to-xe-may-xe-dap,115707491,"Cặp 2 gương xe đạp chiếu hậu tròn",80000,80000,0,0
TIKI,o-to-xe-may-xe-dap,126097513,"Lót cốp nhựa ô tô cho dòng xe mazda 3D CX5 2019+",304950,321000,16050,5
TIKI,o-to-xe-may-xe-dap,41507312,"Chai xịt bảo dưỡng lốp ô tô 3M 39042LT tăng khăn lau ô tô chuyên dụng 3M màu ngẫu nhiên",219000,219000,0,0
TIKI,o-to-xe-may-xe-dap,113234019,"[Màu nâu bò] Bao Da Chìa Khóa Honda Air Blade 150, Vario 150, Airblade 2020, Lead 2020 handmade da thật",100000,100000,0,0
TIKI,o-to-xe-may-xe-dap,92131546,"Ví đựng giấy tờ xe ô tô Ford Da Cao Cấp, Ví da đựng giấy tờ xe ô tô - OTOALO",22990,22990,0,0
TIKI,o-to-xe-may-xe-dap,36278697,"Nước Rửa Kính ô Tô Xuất Xứ Châu Âu Xglass Hương Bạc Hà (3.2l) - Hàng Chính Hãng",145000,145000,0,0
TIKI,o-to-xe-may-xe-dap,57109174,"Mỡ cao cấp Mobilgrease XHP 222 - nhập khẩu từ Mỹ",139000,139000,0,0
TIKI,o-to-xe-may-xe-dap,157146707,"Băng Keo Nano Vân Carbon Bóng Phủ Acrylic Chống Trầy Xước Xe",55200,60000,4800,8
TIKI,o-to-xe-may-xe-dap,65466769,"Gía đỡ điện thoại gắn taplo hoặc kính lái ô tô nhãn hiệu Baseus SUYL-JY01 - Khóa, mở tự động",325000,325000,0,0
TIKI,o-to-xe-may-xe-dap,101826179,"Bộ vam đĩa chặn, tháo vòng bi, bạc đạn - Bộ Vam đĩa, Cảo mặt trăng 14 chi tiết",657000,657000,0,0
TIKI,o-to-xe-may-xe-dap,32834656,"Bạt phủ xe máy loại dày che nắng mưa bụi bẩn - ghi",50138,50138,0,0
TIKI,o-to-xe-may-xe-dap,137548049,"Dung Dịch Nước Tẩy Rửa Dầu Nhớt",220000,220000,0,0
TIKI,o-to-xe-may-xe-dap,31139580,"Gạt mưa Bosch Advantage Chevrolet Cruze 24" - 18" (Đen)",251000,251000,0,0
TIKI,o-to-xe-may-xe-dap,159881199,"Bàn Đa Năng Treo Lưng Ghế, Vô Lăng Trên Xe Ô Tô, Bàn ăn gấp gọn trên ô tô",303000,329000,26000,8
TIKI,o-to-xe-may-xe-dap,32322882,"Bộ chia tẩu sạc ô tô USB Huyndai HY36 loại tốt - Hàng nhập khẩu",71000,81000,10000,12
TIKI,o-to-xe-may-xe-dap,41970060,"Khóa Xe Đạp, Xe Máy 5 Số, Siêu Bền, Khó Cắt - Giao Màu Ngẫu Nhiên",49596,49596,0,0
TIKI,o-to-xe-may-xe-dap,49968115,"Đệm lưới tựa lưng ghế ô tô",30300,30300,0,0
TIKI,o-to-xe-may-xe-dap,21679101,"Tem Dán 3D Trang Trí Xe Ô Tô Chữ LIMITED ",79986,85000,5014,6
TIKI,o-to-xe-may-xe-dap,102410326,"Bộ gối tựa đầu và tựa lưng ô tô 3D cao su non Cao cấp",109995,109995,0,0
TIKI,o-to-xe-may-xe-dap,26099433,"Bạt Phủ Chống Mưa - Nắng Bảo Vệ Xe Máy, Xe Đạp Có In Hình",32997,32997,0,0
TIKI,o-to-xe-may-xe-dap,150494364,"ĐỒNG HỒ GẮN Ô TÔ XE MÁY LOẠI TỐT SIÊU ĐẸP , ĐỒNG HỒ XE MÁY SIÊU HÓT",159000,159000,0,0
TIKI,o-to-xe-may-xe-dap,114744998,"Combo 2 Lưỡi Gạt Mưa Loại A VIAIR R15 (22 Inch/550 mm)",71000,83000,12000,14
TIKI,o-to-xe-may-xe-dap,84592882,"Bộ cọ tròn rửa xe đa năng",65000,65000,0,0
TIKI,o-to-xe-may-xe-dap,35372429,"Cảng sau civi cho Wave A 100,WAVE A 110,WINNER,EXCITER 135,EXCITER 150,AXELO,WAVE BLADE,WAVE S110,SIRIUS BẢO LONG RACING",105000,105000,0,0
TIKI,o-to-xe-may-xe-dap,69611729,"Cuộn Phản Quang 2 Màu Đỏ Trắng Bóc Dán Cho Xe Tải, Xe Container, Xe Hơi, Xe Ô tô Dài 45 Mét/ Cuộn Giúp An Toàn Ban Đêm Mai Lee",149000,179000,30000,17
TIKI,o-to-xe-may-xe-dap,70838439,"Combo đèn led trước sau cho xe đạp Jett Blazers",199000,199000,0,0
TIKI,o-to-xe-may-xe-dap,119642121,"Cao su non dẻo làm sạch hút bụi nội thất ô tô vật dụng",32000,32000,0,0
TIKI,o-to-xe-may-xe-dap,55063136,"Bộ 2 miếng dán chống bám nước kính xe ô tô",52000,52000,0,0
TIKI,o-to-xe-may-xe-dap,182404309,"Nước hoa ô tô hương cafe cao cấp Buckingham nhập khẩu Hàn Quốc",149000,149000,0,0
TIKI,o-to-xe-may-xe-dap,25271628,"Tẩu cấp nguồn cho camera hành trình, kèm 02 cổng USB sạc điện thoại",75000,75000,0,0
TIKI,o-to-xe-may-xe-dap,24085827,"Túi Da Xịn Đựng Đăng Kiểm, Giấy Tờ Cho Ô tô logo Hyundai",22000,22000,0,0
TIKI,o-to-xe-may-xe-dap,12289770,"Bộ chia tẩu sạc Huyndai HY-29",155000,155000,0,0
TIKI,o-to-xe-may-xe-dap,119718972,"Máy Sạc Ắc Quy 12V 5A Kèm Phục Hồi Bình, Bộ Sạc Bình Acquy Tự Ngắt Khi Đầy, Khử Sunfat",156000,166000,10000,6
TIKI,o-to-xe-may-xe-dap,110199193,"Bộ đồng hồ đo áp suất dầu nhớt hộp số động cơ",448000,550000,102000,19
TIKI,o-to-xe-may-xe-dap,155005380,"Gối tựa đầu cao cấp chống mỏi cổ khi ngủ trên xe hơi, ô tô",460000,499000,39000,8
TIKI,o-to-xe-may-xe-dap,23354943,"ĐÁNH BÓNG BƯỚC 3 CAO CẤP 3M 06068 PERFECT-IT EX ULTRAFINE MACHINE POLISH, 1 QUART (946ML)",620000,620000,0,0
TIKI,o-to-xe-may-xe-dap,122830493,"Bộ 4 miếng cao su dán cánh cửa xe Chống va đập Logo SPORT",75050,79000,3950,5
TIKI,o-to-xe-may-xe-dap,34341611,"Bình chữa cháy/ cứu hỏa mini 500ml dành cho xe hơi ( HSD dùng 2023)",45000,45000,0,0
TIKI,o-to-xe-may-xe-dap,4280917,"Bàn chải vệ sinh sên xe máy Cao cấp 3D",25000,25000,0,0
TIKI,o-to-xe-may-xe-dap,52214298,"Bộ Gác Chân Trước Sau Cao Su Nhựa Màu cho xe Dream Wave Greennetwokrs",83000,83000,0,0
TIKI,o-to-xe-may-xe-dap,151681304,"Bạt trùm che phủ xe ô tô Toyota Corolla Cross Cao Cấp 3 Lớp Chống Nắng Nóng Chống Nước Chống xước",242250,255000,12750,5
TIKI,o-to-xe-may-xe-dap,109191096,"Ốp, bọc bảo vệ chìa khóa cho xe Mercedes-Benz GLC-Class 2020-2021, E-Class 2020-2021, C-Class 2020-2021",178600,188000,9400,5
TIKI,o-to-xe-may-xe-dap,192812313,"Combo 2 Miếng Dán Chống Trượt Thảm Ô Tô Miếng Lót Chân Miếng Kẹp Thảm Sàn Phụ Kiện Miếng Dán Cố Định Nội Thất Ô Tô",35000,35000,0,0
TIKI,o-to-xe-may-xe-dap,44350491,"Bạt Phủ Xe Máy Xe Đạp Che Mưa Nắng Cao Cấp KH06",34998,34998,0,0
TIKI,o-to-xe-may-xe-dap,170280815,"Đèn ưu tiên 12 bóng led xanh đỏ gắn kính lái ô tô",250000,250000,0,0
TIKI,o-to-xe-may-xe-dap,118299546,"Đầu bịt chân van xe đạp cao cấp",9800,9800,0,0
TIKI,o-to-xe-may-xe-dap,51574367,"Keo vá lốp (Super Valkarn) thương hiệu Maruni - Nhật Bản (lọ 200cc)",200000,200000,0,0
TIKI,o-to-xe-may-xe-dap,172068762,"Thảm taplo ô tô để đồ đa năng chống trượt kiêm giá đỡ và bảng ghi số điện thoại mẫu mới loại tốt siêu đẹp",58000,58000,0,0
TIKI,o-to-xe-may-xe-dap,177299335,"Ty hãm cốp thuỷ lực cho xe bán tải Ford Ranger",350000,350000,0,0
TIKI,o-to-xe-may-xe-dap,174303241,"YÊN ĐI XE SỐ DREAM - WAVE - SIRIUS CHO BÉ",115000,115000,0,0
TIKI,o-to-xe-may-xe-dap,195540764,"Đệm Tỳ Tay ô Tô",69000,69000,0,0
TIKI,o-to-xe-may-xe-dap,83366581,"pô cup DD Cao cấp dành cho xe cup DD 50 70 81 82 84 86 90",764550,849500,84950,10
TIKI,o-to-xe-may-xe-dap,22536664,"Bơm hút tự động nước, rượu, xăng dầu, chất lỏng, hóa chất đủ loại - loại mini chạy pin tự động chỉ 1 nút bấm",68799,68799,0,0
TIKI,o-to-xe-may-xe-dap,38993920,"Thảm lót sàn ô tô T25.3 50x150 cm, Thảm Lót Cốp Ô Tô",127000,134000,7000,5
TIKI,o-to-xe-may-xe-dap,128543422,"Giá Đỡ Bình Nước Xe Đạp Siêu Bền",19000,19000,0,0
TIKI,o-to-xe-may-xe-dap,10007167,"Chai dưỡng sên, xịt sên Liqui Moly 1508 250ml",212000,212000,0,0
TIKI,o-to-xe-may-xe-dap,117927078,"BIOION AIR SANITIZER AEROSOL REFILL - Bình Xịt Khử Khuẩn, Khử Mùi (Dùng cho máy xịt tự động RX900) 250ML",125000,125000,0,0
TIKI,o-to-xe-may-xe-dap,21311957,"Kem xoá vết xước ô tô, xe máy F1-CC",19000,19000,0,0
TIKI,o-to-xe-may-xe-dap,124385409,"Vè Che Mưa Ô Tô SUZUKI XL7 Ertiga Chỉ Inox ",348650,367000,18350,5
TIKI,o-to-xe-may-xe-dap,124479782,"Bình chữa cháy mini 500ml cần thiết cho mọi nhà, xe oto rất tiện dụng và dễ sử dụng, gọn nhẹ tiện ích",38000,38000,0,0
TIKI,o-to-xe-may-xe-dap,19662320,"Hộp tỳ tay ô tô dành cho xe Mitsubishi Attrage và Mirage tích hợp 7 cổng USB (DUSB-ATG)",384995,384995,0,0
TIKI,o-to-xe-may-xe-dap,75709451,"Dưỡng bóng dàn áo ,kim loại MEGACOOLS SiO2 Slick WAX 250ml, dễ sử dụng, an toàn, hiệu quả cao",104000,104000,0,0
TIKI,o-to-xe-may-xe-dap,157146235,"Bao Da Chìa Khóa Cho Xe Ford Ecosport, Everest, Ranger, Explorer (Da Thật)",117000,138000,21000,15
TIKI,o-to-xe-may-xe-dap,90574279,"Bảng Số Điện Thoại Kiêm Giá Điện Thoại Đa Năng Để Taplo Ô Tô Kim Loại Cao Cấp",65000,65000,0,0
TIKI,o-to-xe-may-xe-dap,113674535,"Combo Nhớt Liqui Moly 10W-40 Scooter MB Formula 800ML+ Hộp số liqui 150ML  dành cho xe ga",345000,345000,0,0
TIKI,o-to-xe-may-xe-dap,169343364,"Bộ 2 Chốt ngắt tiếng kêu, chốt cài dây an toàn Ô tô Toyota",70000,70000,0,0
TIKI,o-to-xe-may-xe-dap,19899873,"Bộ Rèm Chắn Nắng Nam Châm dành cho xe KIA Morning 2012-2019",246715,259700,12985,5
TIKI,o-to-xe-may-xe-dap,13306810,"Combo Đệm Tựa Lưng Massage Và Gối Tựa Đầu",268000,268000,0,0
TIKI,o-to-xe-may-xe-dap,113352117,"Nước Hoa Ô Tô Cao Cấp Etonner E1801D 60ml thiết kế để taplo xe sang trọng, phù hợp với nhiều dòng xe.",980000,980000,0,0
TIKI,o-to-xe-may-xe-dap,136597893,"BAGA BỬNG INOX CHALY",107000,107000,0,0
TIKI,o-to-xe-may-xe-dap,53900678,"Sạc Pin Dành Cho Xe Ô Tô & Xe Máy Điện Trẻ Em 12V Có Đèn Báo Pin",91000,91000,0,0
TIKI,o-to-xe-may-xe-dap,116057963,"Thảm Taplo Da Carbon xe Mitsu Xpander 2018 2019 2020 cao cấp",254600,268000,13400,5
TIKI,o-to-xe-may-xe-dap,139445907,"Sạc điện thoại xe máy kèm đồng hồ báo vôn ắc quy 2in1 mẫu mới lắp các loai xe siêu tiện loại tốt",169000,169000,0,0
TIKI,o-to-xe-may-xe-dap,48110441,"ghi đông cho xe 68 72 tặng bao tay xe máy",169000,169000,0,0
TIKI,o-to-xe-may-xe-dap,189941368,"Tấm che nắng kính lái ô tô 5 lớp tráng bạc phản quang chống nóng tia UV",79000,79000,0,0
TIKI,o-to-xe-may-xe-dap,54141077,"Bộ 2 Gương Chiếu Hậu Cho Xe Đạp Thể Thao Địa Hình Xoay 360 Độ Giúp Lái Xe An Toàn",68200,68200,0,0
TIKI,o-to-xe-may-xe-dap,72026298,"Hộp đựng khăn giấy kiêm bảng số điện thoại và đồng hồ cao cấp đặt taplo ô tô, xe hơi TB-6137",188000,205000,17000,8
TIKI,o-to-xe-may-xe-dap,146904119,"Logo Vương Miện Đính Đá Gắn Trang Trí Xe Ô Tô",95060,95060,0,0
TIKI,o-to-xe-may-xe-dap,15832262,"Dây An Toàn Dùng Cho Ô Tô Tiện Lợi ( rộng 5 cm ) - Ghi",95000,95000,0,0
TIKI,o-to-xe-may-xe-dap,105184892,"Pat gắn đèn trợ sáng - lắp chân gương chữ L",18000,18000,0,0
TIKI,o-to-xe-may-xe-dap,177301126,"Nẹp bước chân trong TITAN ô tô Vinfast Lux A 2.0 2020-2021-2022 chống trầy bảo vệ trang trí xe",288000,288000,0,0
TIKI,o-to-xe-may-xe-dap,5524557,"Đèn LED trợ sáng C6 cho xe máy ",49000,49000,0,0
TIKI,o-to-xe-may-xe-dap,23291784,"Súng bơm lốp xe ô tô dùng khí Total TAT11601",186000,186000,0,0
TIKI,o-to-xe-may-xe-dap,141917127,"Bạt che / Bạt phủ ô tô. chống nắng-mưa, cách nhiệt bảo vệ xe hơi 5D tráng nhôm cao cấP. (CHE NỬA)",180995,180995,0,0
TIKI,o-to-xe-may-xe-dap,102511519,"Giá đỡ điện thoại hút chân không gắn kính hoặc táp lô ô tô Baseus SUYL-TK01 Tank gravity car mount holder with suction base - Hàng chính hãng",342000,360000,18000,5
TIKI,o-to-xe-may-xe-dap,54157945,"Bộ 4 decal phản quang dán tay nắm cửa xe ô tô",89000,89000,0,0
TIKI,o-to-xe-may-xe-dap,119356183,"Tẩu chia sạc 12V-24V trên ô tô thành 2 cổng và 2 chân USB",129000,129000,0,0
TIKI,o-to-xe-may-xe-dap,130470626,"Gạt mưa Silicone xương cứng Mazda 3 -2018",231000,231000,0,0
TIKI,o-to-xe-may-xe-dap,36689130,"ĐÈN XI NHAN  WINNER X , BỘ ĐÈN XI NHAN TAM GIÁC CHO XE WINNER X ĐẸP QUÊN LỐI VỀ - MÀU VÀNG-XNTG",52000,52000,0,0
TIKI,o-to-xe-may-xe-dap,27883304,"Quạt Đôi Mini 12V Xoay 360 Dành Cho Xe Ô Tô",118000,118000,0,0
TIKI,o-to-xe-may-xe-dap,49408703,"Khóa số Xe đạp, xe máy Chống Trộm có mã 5 số bảo mật cao Tặng bộ vá xe đạp",98900,98900,0,0
TIKI,o-to-xe-may-xe-dap,74214137,"Gối tựa đầu ô tô và gối tựa lưng ô tô cao su non đúc nguyên khối,đàn hồi cực tốt,bọc da cao cấp-SIÊU ÊM-SIÊU BỀN-KHÔNG NỔ DA",307797,307797,0,0
TIKI,o-to-xe-may-xe-dap,274608436,"Miếng Đệm Hạt Gỗ PaKaSa Massage Ghế Ô TÔ , Xe Hơi , Ghế Văn Phòng KT 45 x 45 cm - Chính Hãng",145000,210000,65000,31
TIKI,o-to-xe-may-xe-dap,131183458,"Lọc gió điều hòa ô tô HONDA CIVIC 1.8/2.0L 2007-2017",103000,103000,0,0
TIKI,o-to-xe-may-xe-dap,130173588,"Tẩu sạc nhanh dùng trên ô tô xe hơi có đèn led báo điện áp Ác Quy",137750,145000,7250,5
TIKI,o-to-xe-may-xe-dap,179948270,"Búa Cứu Hộ Xe Hơi Đa Năng 7 Trong 1 Cao Cấp",93000,99000,6000,6
TIKI,o-to-xe-may-xe-dap,25555995,"Gối tựa đầu xe hơi, ô tô  chất liệu cao su non cao cấp V2",84997,84997,0,0
TIKI,o-to-xe-may-xe-dap,105043763,"Bảng Hiển Thị Số Điện Thoại Gắn Trên Taplo Xe Ô TÔ + Tặng 1 móc khóa xinh xắn",27000,27000,0,0
TIKI,o-to-xe-may-xe-dap,186162539,"Thảm taplo cho Transit 2014-2015-2016-2017-2018-2019-2020-2021-2022 chống nắng nóng làm mát xe mở rộng tầm nhìn",195000,195000,0,0
TIKI,o-to-xe-may-xe-dap,184124859,"Đèn LED bi cầu mini Y6D 72W 6000K model 2022 chân H4 cho ô tô, xe máy(giá 1 cái)",450000,450000,0,0
TIKI,o-to-xe-may-xe-dap,273238535,"xe đạp thể thao tuaring Thống Nhất MTB 26-05 - Hightway  ( mẫu cải tiến mới 2023 ) - HÀNG CHÍNH HÃNG ( TẶNG THÊM 1 BƠM XE + KHÓA DÂY MÃ SỐ )",3840000,4800000,960000,20
TIKI,o-to-xe-may-xe-dap,117213332,"Khử mùi nội thất ô tô Wurth Deodoriser 500ml",375000,375000,0,0
TIKI,o-to-xe-may-xe-dap,75793488,"Đèn hậu xe máy, đèn hậu xe máy nhiều màu, đèn nhiều màu dành cho hậu xe máy, đèn LED xe máy 12V, dùng điện bình ác quy, công suất nhỏ, đèn phụ tùng xe máy hậu nhiều led - DHNDM",35131,36980,1849,5
TIKI,o-to-xe-may-xe-dap,49241132,"Bảng để lại số điện thoại trên ô tô khi đỗ xe",9000,9000,0,0
TIKI,o-to-xe-may-xe-dap,47136035,"Gương cầu lồi 2 mặt xóa điểm mù quan sát 2 bánh xe trước sau, gương xoay 360 độ, dán lên gương kính chiếu hậu chính cho xe hơi, ô tô",49000,49000,0,0
TIKI,o-to-xe-may-xe-dap,174134202,"Xe đạp địa hình Thống Nhất SLX 27,05-1 - Hàng chính Hãng (Kèm khóa dây mã số và chắn bùn trước sau)",6750000,6750000,0,0
TIKI,o-to-xe-may-xe-dap,43177224,"Xe Đạp Điện Osakar Star",13500000,13500000,0,0
TIKI,o-to-xe-may-xe-dap,168956190,"Sạc bình ắc quy 12V 6Ah - 150Ah/24V 6Ah - 100Ah Tianye tự ngắt khi đầy chức năng bảo dưỡng phục hồi ắc quy bằng khử sunfat",275000,275000,0,0
TIKI,o-to-xe-may-xe-dap,86284720,"Xe đạp thể thao khung nhôm 27,5" 21 speed",3695500,3890000,194500,5
TIKI,o-to-xe-may-xe-dap,113125263,"Xe đạp thể thao Thống Nhất MTB24-03 (Phù hợp với người cao từ 1m40 đến 1m55)",2490000,2490000,0,0
TIKI,o-to-xe-may-xe-dap,121978319,"Dầu Nhớt Xe Máy Eneos Nhật Bản - Hàng Chính Hãng",85000,85000,0,0
TIKI,o-to-xe-may-xe-dap,163869971,"Đèn pha LED S11 100W 20000LM chip LED LASER 3570 6 NHÂN hiệu suất cao cho ô tô(giá 1 bóng)",700000,700000,0,0
TIKI,o-to-xe-may-xe-dap,157936018,"XE ĐẠP THỂ THAO FORNIX FR307",3490000,3490000,0,0
TIKI,o-to-xe-may-xe-dap,191356034,"Xe Đạp Thể Thao Gấp Gọn FS Bike NS-001 Vành 26inch 24 Tốc Độ Nhập Khẩu Đại Nam Sport + Tặng Mũ Bảo Hiểm,Khóa Chống Trộm Và Chắn Bùn",5000000,5000000,0,0
TIKI,o-to-xe-may-xe-dap,95306007,"Xe đạp địa hình Thống Nhất MTB 24-04 - Hàng chính hãng - Màu",3250000,3250000,0,0
TIKI,o-to-xe-may-xe-dap,96325586,"Bóng Đèn Led gầm xe hơi Demi Đờ mi chân H8 H9 H11 cho xe hơi ô tô siêu tiết kiệm Toyota Innova Vios Honda City Sương mù",79000,79000,0,0
TIKI,o-to-xe-may-xe-dap,52987923,"Bộ 2 Bọc Cầm Tay Lái Xe Đạp Cao Su Chống Trơn Trượt (phi 2.2 cm) Dễ Dàng Lắp Đặt Cho Xe Đạp Địa Hình Mai Lee",107000,119000,12000,10
TIKI,o-to-xe-may-xe-dap,140919290,"xe đạp nữ mini Thống Nhất New 24 inch - hàng chính hãng",2312000,2890000,578000,20
TIKI,o-to-xe-may-xe-dap,59210353,"Bộ 4 móc treo đồ tiện dụng trên xe OTOS-4C",32000,32000,0,0
TIKI,o-to-xe-may-xe-dap,118298199,"Xe đạp đường phố Giant Ineed Latte 2021",10300000,10300000,0,0
TIKI,o-to-xe-may-xe-dap,274362517,"Bình Ắc quy khô GS GTZ5S E 3,5Ah, GTZ5S-H 4AH Wave RS Rsx Rsv S, Nouvo456, Airblade110, Hayate X-Bike SKY Exciter Luvias Cub",290000,290000,0,0
TIKI,o-to-xe-may-xe-dap,43378362,"Bộ 2 Phuộc Sau DBS Giảm Xóc Gắn Cho Sirius ",290000,290000,0,0
TIKI,o-to-xe-may-xe-dap,135156169,"XE ĐẠP THỂ THAO SIZE 20 INCH dành cho bé 7 tuổi - 11 TUỔI + Tặng kèm giỏ xe, gácbaga, túi, bình nước",1159000,1159000,0,0
TIKI,o-to-xe-may-xe-dap,173539685,"Xe Ga 50CC Roma SX",22500000,22500000,0,0
TIKI,o-to-xe-may-xe-dap,182848858,"XE ĐẠP TRẺ EM DÁNG THỂ THAO CHO BÉ 3-10 TUỔI - XE ĐẠP THỂ THAO - XE ĐẠP ĐỊA HÌNH TRẺ EM",749000,749000,0,0
TIKI,o-to-xe-may-xe-dap,183313404,"Xe Ga 50cc DK Roma SX",23900000,23900000,0,0
TIKI,o-to-xe-may-xe-dap,162581887,"Máy bơm lốp ô tô Tâm Luân động cơ DÂY ĐỒNG, chip chống quả tải và ngắn mạch, máy bơm lốp xe ô tô công suất 120w, máy bơm ô tô 12V",199000,350000,151000,43
TIKI,o-to-xe-may-xe-dap,7923502,"Lốp Xe Máy 80/90-17 Không Ruột",360000,360000,0,0
TIKI,o-to-xe-may-xe-dap,1254595,"Chai Xịt Chăm Sóc Da, Nội Thất Ô Tô- 3M Leather & Vinyl Restorer PN39040 (473ml) - Đen",310000,310000,0,0
TIKI,o-to-xe-may-xe-dap,51918522,"Bộ kích gầm ô tô và máy tháo lốp dùng điện 12V",1699000,1699000,0,0
TIKI,o-to-xe-may-xe-dap,121978173,"Săm (ruột) Xe Đạp Sao Vàng các cỡ 600-660-700 ( 24-26-27) - Hàng Chính Hãng",34000,34000,0,0
TIKI,o-to-xe-may-xe-dap,157146868,"Ốp Bảo Vệ Chìa Khóa Xe Chevrolet Cruze, Colorado Hợp Kim Cao Cấp",209000,279000,70000,25
TIKI,o-to-xe-may-xe-dap,174490313,"￼Đệm Lót Yên Xe Máy Siêu Êm, Độ Đàn Hồi Cao, Lắp Được Cho Mọi Loại Xe Máy",89000,89000,0,0
TIKI,o-to-xe-may-xe-dap,162590572,"Ắc quy khô miễn bảo dưỡng Đồng Nai PTZ6HL | 12V - 6Ah",254000,254000,0,0
TIKI,o-to-xe-may-xe-dap,270543566,"XE ĐẠP TRẺ EM THỂ THAO BÁNH 12-20 INCH CHO BÉ TRAI 3-10 TUỔI - tặng kèm giỏ + Gacbaga",749000,749000,0,0
TIKI,o-to-xe-may-xe-dap,90852651,"Xe Đạp Thể Thao Địa Hình Kèm Giỏ, Garbaga, Bình Nước Bánh To Kèm Ảnh Thật",1100000,1100000,0,0
TIKI,o-to-xe-may-xe-dap,136191331,"Nhớt Xe Số Motul 3100 Gold 4t 10w40 20x0.8l Vn",119000,119000,0,0
TIKI,o-to-xe-may-xe-dap,49302134,"Kệ Yên Sau Gác Ba Ga Gắn Thêm Phía Sau Cho Xe Đạp Vào Cốt Yên (Tích Hợp Kèm Chắn Bùn) Đa Năng Điều Chỉnh Hợp Kim Nhôm Cao Cấp Cho Xe Đạp Leo Núi Địa Hình Mai Lee",316000,379000,63000,17
TIKI,o-to-xe-may-xe-dap,23599590,"Bộ 02 Gương Cầu Lồi Đa Cực 360 Độ Gắn Gương Chiếu Hậu Ô Tô, Xe Máy Cao Cấp AZONE",19000,19000,0,0
TIKI,o-to-xe-may-xe-dap,55709275,"Kính chắn gió mũ bảo hiểm Sunda",89000,89000,0,0
TIKI,o-to-xe-may-xe-dap,56221826,"Bảng Ghi Số Điện Thoại Có Giá Đỡ Điện Thoại Trên Xe Ô Tô Xe Hơi",31500,45000,13500,30
TIKI,o-to-xe-may-xe-dap,107457947,"Bộ gối ghế tựa lưng và đầu xe hơi,ô tô chất liệu cao su non cao cấp",120000,120000,0,0
TIKI,o-to-xe-may-xe-dap,128817788,"[TẶNG LƯỠI CHAI] Mũ Bảo Hiểm 3/4 Cao Cấp ZEUS 613B Đen Nhám – 2 Kính",1500000,1500000,0,0
TIKI,o-to-xe-may-xe-dap,117221161,"Xe đạp Thống Nhất GN06-26 - Hàng chính hãng",2190000,2190000,0,0
TIKI,o-to-xe-may-xe-dap,172068042,"ĐÈN HẬU LED STOP CHỚP NHÁY F1 - ĐÈN HẬU XE MÁY - Ô TÔ",39000,39000,0,0
TIKI,o-to-xe-may-xe-dap,8315863,"Mũ Bảo Hiểm Nửa Đầu GRS A760K",359000,359000,0,0
TIKI,o-to-xe-may-xe-dap,3668285,"Dung dịch chống bán nước kính lái 3M 08889LT",179000,179000,0,0
TIKI,o-to-xe-may-xe-dap,186288625,"Sạc bình xe điện 48V- 12AH hoặc 20AH phích cái 3 chấu có quạt",108900,108900,0,0
TIKI,o-to-xe-may-xe-dap,83347924,"Kính thẳng gắn nón bảo hiểm 3/4 Royal có 3 nút bấm",130000,130000,0,0
TIKI,o-to-xe-may-xe-dap,1510677,"Chai Vá Lốp Xe Khẩn Cấp Michelin 92423 (500ml)",259000,259000,0,0
TIKI,o-to-xe-may-xe-dap,98030784,"Bình Xịt Dưỡng Bóng Vỏ Lốp Oto – Phục Hồi Nhựa Đen FLAMINGO 500Ml",72000,78000,6000,8
TIKI,o-to-xe-may-xe-dap,121978595,"Săm Lốp( vỏ ruột) xe đạp trẻ em, xe đạp Kenda đủ kích cỡ 12, 14, 16, 18, 20, 22, 24, 26 - Hàng chính hãng",50000,50000,0,0
TIKI,o-to-xe-may-xe-dap,28390801,"Bộ gối tựa đầu và tựa lưng xe hơi, xe ô tô V2 chất liệu cao su non cao cấp màu be",270000,270000,0,0
TIKI,o-to-xe-may-xe-dap,85236295,"COMBO 5 Lá thơm treo gương xe hơi.miếng thơm treo ô tô hương vani",85000,85000,0,0
TIKI,o-to-xe-may-xe-dap,136597305,"GÙ WAVE INOX 304 ĐẶC NGUYÊN KHỐI, CHÂN DÀI DÙNG CHO NHIỀU LOẠI XE",72000,72000,0,0
TIKI,o-to-xe-may-xe-dap,74643387,"Đèn led Bi cầu H4 Mini siêu sáng cos vàng pha trắng (loại rẻ , không BH ) Green Networks Group",89000,89000,0,0
TIKI,o-to-xe-may-xe-dap,91297584,"Bộ dụng cụ sửa xe đạp mini đa dụng Crankbrothers M17 multi-tools",799000,799000,0,0
TIKI,o-to-xe-may-xe-dap,168067539,"Mũ bảo hiểm nửa đầu RONA hali viền bạc chính hãng, nón bảo hiểm freesize cho nam và nữ",130000,200000,70000,35
TIKI,o-to-xe-may-xe-dap,117798789,"MŨ BẢO HIỂM 1/2 ĐEN THỜI TRANG, AN TOÀN, PHONG CÁCH B'COLOR KÍNH PHI CÔNG",300000,300000,0,0
TIKI,o-to-xe-may-xe-dap,97979641,"Bộ 2 Miếng dán Công nghệ NANO chống lóa- bám -đọng - tụ hơi nước mờ gương xe ô tô xe hơi loại một| Xe hơi cá tính",22816,24800,1984,8
TIKI,o-to-xe-may-xe-dap,126037294,"Cây Thông Thơm - Lá Thông Thơm Little Trees - Cao Cấp, Treo Xe, Khử Mùi Trên Xe Ô Tô",15000,15000,0,0
TIKI,o-to-xe-may-xe-dap,13380326,"Đèn Pin LED Trên Xe Đạp Kèm Đế Kẹp Hiện Đại - Giao Màu Ngẫu Nhiên",89000,115000,26000,23
TIKI,o-to-xe-may-xe-dap,98678475,"Xe đạp địa hình Thống Nhất trẻ em MTB 20-04 (Dành cho bé từ 5 đến 10 tuổi) - Hàng chính hãng",2599000,2599000,0,0
TIKI,o-to-xe-may-xe-dap,47301111,"BÌNH TẠO BỌT TUYẾT CẦM TAY EPOCA TEC TWO 2000ml  MADE IN ITALY",579000,579000,0,0
TIKI,o-to-xe-may-xe-dap,102012041,"Đèn xi nhan led, đèn led xi nhan cho xe máy, đèn xi nhan hình cúc áo-DXNCA",37050,39000,1950,5
TIKI,o-to-xe-may-xe-dap,89877588,"Bộ 2 Thanh Nạy Móc Lốp Xe Đạp Giúp Vá Lốp Săm Xe Đạp Chất Liệu Thép Không Gỉ (dài 12cm) MaiLee",25650,27000,1350,5
TIKI,o-to-xe-may-xe-dap,69657128,"Bộ 2 Dung dịch chống bám nước trên kính xe 3M 08889LT và dung dịch rửa kính ô tô 3M 08888",280000,299000,19000,6
TIKI,o-to-xe-may-xe-dap,108883595,"Đèn xi nhan LED T10 đúc sứ - xi nhan demi cho xe máy T10 6 Led ( 6smd 3030 ) DC 12V Green Networks Group ( 1 Đèn )",25000,25000,0,0
TIKI,o-to-xe-may-xe-dap,195959595,"Loại tốt) Đèn Hậu Led Nháy Xe Máy Stop F1 30 Tim Chạy Đuổi Audi Bản Cao Cấp Mẫu Mới",68000,68000,0,0
TIKI,o-to-xe-may-xe-dap,147763773,"Tay nắm xe đạp thể thao Kiotool có sừng chống mỏi , trơn tay",75000,75000,0,0
TIKI,o-to-xe-may-xe-dap,137672159,"Keo dán đa năng Scotch 3M siêu dính, siêu bền, keo trong suốt tính thẩm mỹ cao, keo loãng mau khô, dễ sử dụng AD113",35000,35000,0,0
TIKI,o-to-xe-may-xe-dap,89300422," COMBO 10 KHĂN LAU XE SIÊU THẤM CHUYÊN DỤNG 2 MẶT 30 x 60CM",128000,138000,10000,7
TIKI,o-to-xe-may-xe-dap,105183996,"Gương xe máy - Gương gù chân gương cho mọi xe máy",90000,90000,0,0
TIKI,o-to-xe-may-xe-dap,68119570,"XE ĐẠP THỂ THAO CHO NAM TỪ 6 TUỔI ĐẾN 15 TUỔI TẶNG GIỎ VÀ GÁCBAGA HÀNG CHUẨN",1299000,1299000,0,0
TIKI,o-to-xe-may-xe-dap,121978323,"Săm 700 x 23/25c xe đạp đua thể thao kenda",62000,62000,0,0
TIKI,o-to-xe-may-xe-dap,172167206,"vệ sinh kim phun xăng Senfineco 9986",190000,190000,0,0
TIKI,o-to-xe-may-xe-dap,12491810,"Ghế ngồi trên ô tô cho bé, giữ bé trên ô tô cao cấp",1599000,1599000,0,0
TIKI,o-to-xe-may-xe-dap,197264187,"Gạt mưa ô tô silicon Tâm Luân, KHÔNG XƯƠNG - Thân mềm, gạt sạch - không tiếng ồn - độ bền cao - không bị oxi hoá, độ bền lên đến 10 năm",79000,100000,21000,21
TIKI,o-to-xe-may-xe-dap,87094424,"Quạt ô tô 12v /24v loại lớn sải cánh 18cm, lồng quạt inox chống gỉ",189000,189000,0,0
TIKI,o-to-xe-may-xe-dap,174131359,"Bộ nhựa dàn áo nhựa ABS cao cấp Màu Đỏ dành cho xe FUTURE NEO - TKA-564",1219782,2139968,920186,43
TIKI,o-to-xe-may-xe-dap,119719101,"Ắc quy khô GLOBE WP5-6 6V-5AH Bình ắc quy khô 6v cho xe điện trẻ em ,đèn khẩn cấp,quạt sạc",140000,140000,0,0
TIKI,o-to-xe-may-xe-dap,118297628,"Xe đạp thể thao nữ GIANT LIV ALIGHT 2 2021",10050000,10050000,0,0
TIKI,o-to-xe-may-xe-dap,131337686,"Găng Tay Xe Máy, Đi Phượt Cụt Ngón Blackhawk",83000,83000,0,0
TIKI,o-to-xe-may-xe-dap,142477859,"Thiết Bị Theo Dõi Ắc Quy Fides FBM100 Dùng Cho Ắc Quy Ô Tô, Xe Máy, Xe Tải. Kết Nối Ứng Dụng Bằng Bluetooth iOS Android",570000,570000,0,0
TIKI,o-to-xe-may-xe-dap,23485532,"Mũ bảo hiểm nam nữ nửa đầu Sunda 136 cao cấp có kính âm nhiều màu",275000,275000,0,0
TIKI,o-to-xe-may-xe-dap,48139870," Bộ 2 Bao Tay, Găng Tay Rửa Xe, Lau Xe Ô tô, Xe Máy Cao Cấp LX-001",75000,105000,30000,29
TIKI,o-to-xe-may-xe-dap,33392037,"Phuộc BULL FIRE 2 lò xo dành cho Wave,Dream BẢO LONG RACING",365000,365000,0,0
TIKI,o-to-xe-may-xe-dap,136598056,"DÈ CHẮN BÙN SAU WINNER X 2019 Có Bọc Sên Rời DÙNG ĐƯỢC CHO XE LÊN BÁNH",69000,69000,0,0
TIKI,o-to-xe-may-xe-dap,8148607,"Quần đệm đạp xe Jett UnderAlls",525000,525000,0,0
TIKI,o-to-xe-may-xe-dap,180016581,"RE0533 Gối tựa đầu ô tô cao su non 30cm - Gối tựa gáy trên ô tô",184000,184000,0,0
TIKI,o-to-xe-may-xe-dap,52229792,"Khay để đồ khe ghế đa năng trên ô tô",79000,79000,0,0
TIKI,o-to-xe-may-xe-dap,1378101,"Chai Xịt Bọt Rửa Xe Không Cần Nước Và Làm Bóng Nhanh 3M Waterless Wash & Wax 39110 (453g)",154000,169000,15000,9
TIKI,o-to-xe-may-xe-dap,142871128,"Bộ vá xe bằng tay nhanh cho vỏ không ruột STOP&GO 1000 nhập khẩu Mỹ",900000,900000,0,0
TIKI,o-to-xe-may-xe-dap,13331760,"Thanh ghi số điện thoại trên kính ô tô có dạ quang",12900,12900,0,0
TIKI,o-to-xe-may-xe-dap,766711,"Chai xịt phủ bóng nhanh, chống bám nước sơn xe ô tô Luxury Gloss W-207 500ml Soft99",260000,260000,0,0
TIKI,o-to-xe-may-xe-dap,3261751,"Mũ bảo hiểm nửa đầu GRS A966K - 2 Lớp kính - Tháo được lót",459000,459000,0,0
TIKI,o-to-xe-may-xe-dap,13294488,"Bô 2 Tấm Chắn Bùn Xe Đạp Thể Thao Cao Cấp AZOE",55000,80000,25000,31
TIKI,o-to-xe-may-xe-dap,36300673,"Túi treo đồ trên ô tô kiêm giá để đồ bằng da",265000,265000,0,0
TIKI,o-to-xe-may-xe-dap,102490509,"Đèn Xi Nhan Gương Vios Camry Altis 2014-2022",80000,80000,0,0
TIKI,o-to-xe-may-xe-dap,270539232,"XE ĐẠP TRẺ EM ĐỊA HÌNH CỠ 20/22/24INCH dành cho 7 - 15 TUỔI  có đề + Tặng kèm giỏ xe, gácbaga, túi, bình nước",1099000,1099000,0,0
TIKI,o-to-xe-may-xe-dap,270543520,"XE ĐẠP TRẺ EM THỂ THAO CHO BÉ 3-10 TUỔI - tặng kèm giỏ + Gacbaga",749000,749000,0,0
TIKI,o-to-xe-may-xe-dap,10007194,"Chai dưỡng sên, xịt sên liqui 1591 400mL",275000,275000,0,0
TIKI,o-to-xe-may-xe-dap,98738578," Bộ 2 Đèn LED Bar Pha siêu sáng cho ô tô Bán Tải tiêu chuẩn CE, RoHS, IP67",414000,414000,0,0
TIKI,o-to-xe-may-xe-dap,80489923,"Bơm điện 2 chiều bơm và hút chân không",75000,75000,0,0
TIKI,o-to-xe-may-xe-dap,72749902,"Kính chiếu hậu dành cho dòng xe Air Blade 2016-2019 Green Networks Group ( 1 Cặp )",99000,99000,0,0
TIKI,o-to-xe-may-xe-dap,5432257,"Chống đổ trước dành cho xe exciter và winner",48000,48000,0,0
TIKI,o-to-xe-may-xe-dap,80413027,"Tem dán xe máy king drag",18000,18000,0,0
TIKI,o-to-xe-may-xe-dap,53498362,"bao tay cho xe máy daytona tặng bao tay xe máy",26000,26000,0,0
TIKI,o-to-xe-may-xe-dap,194372826,"THANH GIỮ ỐNG PHANH",109963,109963,0,0
TIKI,o-to-xe-may-xe-dap,120069787,"Tẩu đực cắm lỗ sạc trên ô tô (Không cầu chì)",33000,33000,0,0
TIKI,o-to-xe-may-xe-dap,7543321,"Mũ Bảo Hiểm 3/4 Đầu Royal M139 Design",533000,730000,197000,27
TIKI,o-to-xe-may-xe-dap,72959609,"Cặp Đèn Led Xi Nhan 7 Màu Nhấp Nháy - DXN7M",14250,15000,750,5
TIKI,o-to-xe-may-xe-dap,109310799,"Đèn xi nhan demi thủy tinh T10 12V ô tô xe máy Green Networks Group ( 1 Cái )",15000,15000,0,0
TIKI,o-to-xe-may-xe-dap,1229357,"Mũ Bảo Hiểm Phong Cách Thể Thao Kính Gương Asia M115 KK",304000,320000,16000,5
TIKI,o-to-xe-may-xe-dap,14340750,"Bộ 2 gương chiếu hậu toàn cảnh cho ô tô Baseus Full-Vision Blind-Spot Car Miror - Hàng nhập khẩu.",84524,84524,0,0
TIKI,o-to-xe-may-xe-dap,48039658,"CHÚ CHÓ ĐEN TRẮNG THAN HOẠT TÍNH KHỬ MÙI & TRANG TRÍ TAPLO Ô TÔ LOẠI LỚN 28CM X 21CM",99000,99000,0,0
TIKI,o-to-xe-may-xe-dap,172948836,"BỘ CHẮN BÙN SAU EXCITER 155",199000,199000,0,0
TIKI,o-to-xe-may-xe-dap,195845757,"Tai Mèo Gắn Nón Bảo Hiểm",15000,15000,0,0
TIKI,o-to-xe-may-xe-dap,157117905,"Ví đựng giấy tờ xe, đăng kiểm da bò thật handmade Mẫu 02",350000,350000,0,0
TIKI,o-to-xe-may-xe-dap,188687979,"Decal dán đèn pha ô tô nhiều màu đỏ,xanh, vàng, đen thể thao và thời trang",60000,60000,0,0
TIKI,o-to-xe-may-xe-dap,68565448,"Đèn đuôi nhấp nháy đèn cảnh báo sau cho xe đạp thể thao màu đỏ A02 siêu sáng, chống nước, thời gian sáng lên đến 200h Mai Lee",132000,159000,27000,17
TIKI,o-to-xe-may-xe-dap,68230952,"Phễu thay nhớt cán dài Thái Lan Loại Tốt( Giao Màu Ngẫu Nhiên )",19000,19000,0,0
TIKI,o-to-xe-may-xe-dap,202329754,"Bình Ắc Quy Khô WTZ5S 12V,4.2Ah/WTD 4V,3.5Ah hiệu GLOBE Cho Xe WAVE RS100/ WAVE RS 110/ AIRBLADE/ EXCITER 135",250000,250000,0,0
TIKI,o-to-xe-may-xe-dap,153814001,"CHỤP ỐC TITAN 7 MÀU - 30 CON - LÀM ĐẸP XE",39800,39800,0,0
TIKI,o-to-xe-may-xe-dap,57485566,"Đèn Pha Led Bi Cầu 2 Màu Cos Vàng Pha Trắng ",119002,119002,0,0
TIKI,o-to-xe-may-xe-dap,114745004,"Combo 2 Lưỡi Gạt Mưa Loại A VIAIR R15 (16 Inch/400 mm)",56000,66000,10000,15
TIKI,o-to-xe-may-xe-dap,25092849,"Cần trợ lực tay lái, vô lăng cao cấp BAUHAUS (có vòng bi)",182000,182000,0,0
TIKI,o-to-xe-may-xe-dap,153814040,"Bộ gác chân trước và sau kiểu WAVE S màu đen gắn cho các loại xe số",65000,65000,0,0
TIKI,o-to-xe-may-xe-dap,192398261,"Gương cầu lồi ô tô dán trên gương chiếu hậu tăng góc nhìn chống nước - Gương mini chống điểm mù oto xe hơi, Gương Cầu Lồi Ô Tô Xe Hơi Chiếu Hậu Chống Điểm Mù Cho Xe",35000,35000,0,0
TIKI,o-to-xe-may-xe-dap,150493967,"Đèn hậu led stop chớp nháy F1 lắp các loại xe máy siêu đẹp",49000,49000,0,0
TIKI,o-to-xe-may-xe-dap,168160387,"Thảm lót sàn KARDO cho Toyota Cross",1890000,1890000,0,0
TIKI,o-to-xe-may-xe-dap,49083192,"Set 4 khăn lau rửa xe chuyên dụng Microfiber-Caro,màu ngẫu nhiên",149000,149000,0,0
TIKI,o-to-xe-may-xe-dap,136187531,"RÈM CHE NẮNG NAM CHÂM CHO XE TOYOTA CROSS.",235600,248000,12400,5
TIKI,o-to-xe-may-xe-dap,153812734,"LỌC GIÓ PÔ E TĂNG TỐC WAVE,DREAM,SI,CUB,ELEGANT HỌNG 35 mm",45000,45000,0,0
TIKI,o-to-xe-may-xe-dap,130470706,"Gạt mưa Silicone xương cứng Misubishi Xpander",231000,231000,0,0
TIKI,o-to-xe-may-xe-dap,153078292,"Biển Tam Giác Phản Quang Cảnh Báo nguy Hiểm Led Nháy Sáng Cho Ô tô Loại To Sử Dụng Năng Lượng Mặt Trời",179000,179000,0,0
TIKI,o-to-xe-may-xe-dap,106586221,"Kính Rizoma Elisse Hàng loại 1",239000,239000,0,0
TIKI,o-to-xe-may-xe-dap,1254639,"Dung Dịch Súc Rửa Động Cơ Cho Mô Tô Xe Máy Bluechem Oil System Cleaner (50ml)",79000,79000,0,0
TIKI,o-to-xe-may-xe-dap,191444540,"Xe đạp thời trang nữ Giant Momentum Ineed Latte 24/26 2023",10950000,10950000,0,0
TIKI,o-to-xe-may-xe-dap,15476774,"Nắp van xe",18865,22000,3135,14
TIKI,o-to-xe-may-xe-dap,128710000,"Chuông Xe Đạp Kim Loại Âm Thanh Lớn Lắp Mọi Dòng Xe",59000,59000,0,0
TIKI,o-to-xe-may-xe-dap,46653898,"Dầu chống rỉ sét và bôi trơn thiết bị động cơ RX9 300g",101270,106600,5330,5
TIKI,o-to-xe-may-xe-dap,97979866,"Bộ 2 Gương Cầu Lồi Xóa Điểm Mù Gương Chiếu Hậu Xe Hơi, Xe Máy, gương xoay 360 độ sẵn 3m bóc dính",17980,29000,11020,38
TIKI,o-to-xe-may-xe-dap,31436523,"Bộ 2 Miếng Dán Kính Ô Tô Chống Nước Chống Lóa Hình Chữ Nhật 20x17.5cm",47000,47000,0,0
TIKI,o-to-xe-may-xe-dap,91589775,"Tấm miếng đệm lót yên xe máy bằng hạt gỗ cho xe số",99995,99995,0,0
TIKI,o-to-xe-may-xe-dap,5172187,"Dung dịch vệ sinh và làm trong kính lái Sonax Xtreme Clear View 1:100 NanoPro 271141 250ml",220000,220000,0,0
TIKI,o-to-xe-may-xe-dap,2453873,"Chai xịt dưỡng sên/xích Repsol 400ml",138000,138000,0,0
TIKI,o-to-xe-may-xe-dap,119719091,"Bình ắc quy khô cho xe máy Dream, Wave, Future, Sirius, Jupiter, Taurus, Mio GS GT6A (12V - 6AH)",330000,330000,0,0
TIKI,o-to-xe-may-xe-dap,42459109,"Đèn LED Gắn Trần Nội Thất Xe Ô Tô ( 2 cái )",72000,72000,0,0
TIKI,o-to-xe-may-xe-dap,138387695,"Bộ dụng cụ tháo nội thất ô tô đầy đủ chi tiết, bộ cậy taplo, nạy nhựa ô tô",130000,130000,0,0
TIKI,o-to-xe-may-xe-dap,55059741,"Ắc quy Vision CP1270 12V 7Ah",339200,339200,0,0
TIKI,o-to-xe-may-xe-dap,75575928,"Cảm biến áp suất lốp van trong không dây STEELMATE Chính Hãng",1399000,1399000,0,0
TIKI,o-to-xe-may-xe-dap,78971181,"Combo dưỡng sên chống văng Megacools Chain Lube Ultra MOLY WAX 300ml +vệ sinh sên 500ml Penetrate tặng bàn chải chải",169000,169000,0,0
TIKI,o-to-xe-may-xe-dap,7644433,"Rổ/giỏ xe máy WAVE 110 lắp hông RXM0036 ",29000,29000,0,0
TIKI,o-to-xe-may-xe-dap,122412711,"Đầu khóa chốt cắm móc đai dây an toàn ô tô dạng cắm nối tiếp chống kêu HC-999: Dòng sản phẩm cao cấp",212000,212000,0,0
TIKI,o-to-xe-may-xe-dap,89945283,"Đèn Led Gắn  Xe Đạp Siêu Sáng Kèm Gía Kẹp 206212",32200,65000,32800,50
TIKI,o-to-xe-may-xe-dap,46409039,"cặp kiếng hậu cho xe win 100 tặng bao tay xe máy",139000,139000,0,0
TIKI,o-to-xe-may-xe-dap,270539307,"XE ĐẠP TRẺ EM THỂ THAO CỠ 20/22/24INCH dành cho bé 7 - 15 TUỔI  có đề + Tặng kèm giỏ xe, gácbaga, túi, bình nước",1099000,1099000,0,0
TIKI,o-to-xe-may-xe-dap,23427653,"Dây Câu Bình Ắc Quy Ô Tô 2000A Dài 4M",125000,125000,0,0
TIKI,o-to-xe-may-xe-dap,71963359,"Tẩy ố mốc kính xe hơi Hg X1 250ml",250000,250000,0,0
TIKI,o-to-xe-may-xe-dap,54814572,"Móc treo đồ đa năng, giá đỡ điện thoại gắn lưng ghế ô tô",45000,45000,0,0
TIKI,o-to-xe-may-xe-dap,195918317,"Xịt Rửa Sên Voltronic IX69 800ML",210000,210000,0,0
TIKI,o-to-xe-may-xe-dap,37513973,"Quạt Ô Tô Có Lồng Sắt Bảo Vệ 12V Mini Có Kẹp Treo Xe Cao Cấp",158000,158000,0,0
TIKI,o-to-xe-may-xe-dap,36213935,"Lọc Động Cơ Dành Cho Xe Ô Tô Honda City 2015-2018, HRV 2016-2018 Lọc sạch bụi bẩn, Bảo vệ tuổi thọ động cơ",126700,126700,0,0
TIKI,o-to-xe-may-xe-dap,45376591,"Bộ 2 tem dán gương chiếu hậu ô tô Performance 02",49000,49000,0,0
TIKI,o-to-xe-may-xe-dap,58213358,"CẦN GẠT MƯA 3 KHÚC Ô TÔ CAO CẤP DENSO JANPAN",256000,256000,0,0
TIKI,o-to-xe-may-xe-dap,196350797,"Bộ phanh thắng đùm xe đạp bánh sau",80000,80000,0,0
TIKI,o-to-xe-may-xe-dap,181772426,"Bạt Phủ Xe Ô Tô Chevrolet Spark, Colorado, Trailblazer, Aveo, Cruze - Chất Liệu Bạt Tráng Nhôm 3 Lớp",285000,285000,0,0
TIKI,o-to-xe-may-xe-dap,118299286,"Xe đạp GIANT ESCAPE 1 2022",13150000,13150000,0,0
TIKI,o-to-xe-may-xe-dap,52957945,"Đèn led usb led cắm vào xe oto",35000,35000,0,0
TIKI,o-to-xe-may-xe-dap,136104158,"Ghế Ngồi Gắn Xe Đạp An Toàn Cho Bé ( tặng hộp đựng mini )",132000,132000,0,0
TIKI,o-to-xe-may-xe-dap,136187606,"RÈM CHE NẮNG NAM CHÂM CHO XE FORD LASER",290000,290000,0,0
TIKI,o-to-xe-may-xe-dap,113404847,"Bộ 02 Tay Nắm Xe Đạp Cao Cấp Có Tay Nghỉ TN02",87120,87120,0,0
TIKI,o-to-xe-may-xe-dap,22210236,"Bộ dụng cụ sửa chữa xe đạp mini 15 in 1 đa năng tiện lợi Mai Lee - Hàng chính hãng",44000,59000,15000,25
TIKI,o-to-xe-may-xe-dap,20206548,"Đế cao su bọc chân chống cho xe máy",4900,4900,0,0
TIKI,o-to-xe-may-xe-dap,15533487,"Bộ 2 mang cá giả hốc gió dán xe ô tô MC012",125000,125000,0,0
TIKI,o-to-xe-may-xe-dap,186534300,"Xe Scooter điện người lớn - Xe Scooter xếp gọn cao cấp Phiên Bản Giới Hạn ",4199000,4199000,0,0
TIKI,o-to-xe-may-xe-dap,138181738,"CẶP MÂM-VÀNH ĐÚC 5 CÂY 2 THẮNG ĐÙM( PHANH CƠ) GẮN CHO XE  YAMAHA SIRIUS,JUPITER, TAURUS...",1388450,1388450,0,0
TIKI,o-to-xe-may-xe-dap,34321151,"Pô ahm 7 Màu + Cổ lon gắn Sirius, wave, dream BẢO LONG RACING",205000,205000,0,0
TIKI,o-to-xe-may-xe-dap,109377151,"Dàn áo dành cho Sirius loại 1 màu Đỏ Đen kiểu Zin",990000,990000,0,0
TIKI,o-to-xe-may-xe-dap,108313277,"GƯƠNG 5 CẠNH XE MÁY LOẠI ĐẸP (GIÁ 1 CHIẾC TRÁI)",89000,89000,0,0
TIKI,o-to-xe-may-xe-dap,184829920,"Xe đạp trẻ em các cỡ cho bé 7 đến 15 tuổi - xe đạp trẻ em thể thao có đề - xe đạp địa hình",1069000,1069000,0,0
TIKI,o-to-xe-may-xe-dap,162250600,"Ắc quy khô miễn bảo dưỡng Đồng Nai PTZ6L ISS dành cho xe có Idling Stop | 12V - 6Ah",295000,295000,0,0
TIKI,o-to-xe-may-xe-dap,28418822,"Thiết bị chuyển nguồn 220v sang điện 12V Trắng - Hàng Nhập Khẩu",194000,194000,0,0
TIKI,o-to-xe-may-xe-dap,57045320,"Mũ bảo hiểm 3/4 LS2 OF570 VERSO 2020",2500000,2500000,0,0
TIKI,o-to-xe-may-xe-dap,72841292,"Bộ tay thắng tay côn 6 số kèm bao tay xe máy gù pha lê cho xe Winner 150 Green Networks Group",199000,199000,0,0
TIKI,o-to-xe-may-xe-dap,42644230,"Bình phun rửa xe tự tạo bọt tuyết Dung tích 1L 2020",168000,168000,0,0
TIKI,o-to-xe-may-xe-dap,69246611,"Bơm Xe Đạp Mini Treo Xe Gắn Khung Sườn Có Đế Gắn Sử Dụng Khẩn Cấp 120Psi 8 Bar Siêu Nhẹ Xy Lanh Lõi Nhôm (Kèm 2 Đầu Bơm) Mai Lee",94000,99000,5000,5
TIKI,o-to-xe-may-xe-dap,103121485,"LED T10 SMD 4014LED cao cấp Ô tô xe máy",26000,26000,0,0
TIKI,o-to-xe-may-xe-dap,170065040,"Nón Thể Thao POC 01 FREESIZE Đủ Màu",749000,749000,0,0
TIKI,o-to-xe-may-xe-dap,135572233,"Máy khử mùi, lọc không khí dạng cốc trên xe ô tô Philips GP3601 công nghê SaniFiler Plus - HÀNG NHẬP KHẨU",2079000,2079000,0,0
TIKI,o-to-xe-may-xe-dap,53218129,"cặp phuộc sau cho wave nice tặng bao tay xe máy",308000,308000,0,0
TIKI,o-to-xe-may-xe-dap,11423248,"Bao da chìa khóa xe Hyundai Tucson, Elantra, I10 bản chìa thông minh - kèm móc khóa",112100,118000,5900,5
TIKI,o-to-xe-may-xe-dap,134527132,"Chai xịt Khử mùi ô tô Clean Shu! Shu! 500mL nước ion kiềm tẩy rửa, diệt khuẩn từ Nhật Bản",295000,295000,0,0
TIKI,o-to-xe-may-xe-dap,55638163,"Combo Đèn Pha Trước Cho Xe Đạp Siêu Sáng Sạc Được USB Chống Nước (Kèm Chân Đế Trượt) Và Đèn Hậu Cảnh Báo (Màu Đỏ) Xe Đạp Led Gắn Đuôi Phía Sau Mai Lee",179000,179000,0,0
TIKI,o-to-xe-may-xe-dap,172949797,"MŨ BH 1/2 KIỂU 2 FREE SIZE",507600,507600,0,0
TIKI,o-to-xe-may-xe-dap,10640589,"Đồng hồ đo tốc độ xe đạp không dây 548C",150000,150000,0,0
TIKI,o-to-xe-may-xe-dap,136597442,"CHÂN CHÔI NGHIÊN EXCITER Inox ĐẶT 304 XI TITAN",160000,160000,0,0
TIKI,o-to-xe-may-xe-dap,119719097,"Bình Ắc Quy Khô Xe Máy GLOBE WTZ6V 12V6AH dùng cho NOZZA, AirBlade, SH MODE, SH Việt Nam",340000,340000,0,0
TIKI,o-to-xe-may-xe-dap,193098592,"(Loại tốt) Đèn F22X Pro 80W trợ sáng xe máy ô tô siêu sáng cốt vàng pha trắng 2 chế độ cho khách víp",399000,399000,0,0
TIKI,o-to-xe-may-xe-dap,2050471,"Băng keo cường lực 3M siêu dính 4229P-12 12mm x10m",95000,95000,0,0
TIKI,o-to-xe-may-xe-dap,105184559,"Gương chiếu hậu xe máy, mặt trắng, thời trang, nhỏ gọn",165000,165000,0,0
TIKI,o-to-xe-may-xe-dap,90955420,"Móc Treo Đồ loại Dày Nam Phát cho xe máy Inox, Titan, 7 Màu cho mọi loại xe",11700,11700,0,0
TIKI,o-to-xe-may-xe-dap,13645371,"Mũ bảo hiểm nửa đầu Protec Rosa không kính RLW - Hàng Chính Hãng",245000,245000,0,0
TIKI,o-to-xe-may-xe-dap,49011800,"Nhông sên dĩa dành cho Exciter 150 44T đề 3 cực nhanh mẫu vàng xéo",450000,450000,0,0
TIKI,o-to-xe-may-xe-dap,12042205,"Máy khử mùi, lọc không khí trên xe ô tô Philips GP3201 - Hàng Nhập Khẩu",1917000,1917000,0,0
TIKI,o-to-xe-may-xe-dap,146903991,"Đèn led gầm xe ô tô 8 bóng led 12V",135000,135000,0,0
TIKI,o-to-xe-may-xe-dap,105184789,"Ốp xi nhan cam wave 2017-2021 trước sau (một cặp)",42750,42750,0,0
TIKI,o-to-xe-may-xe-dap,143170760,"Bộ 2 Loa Cánh Cửa Công Suất 400W Dành Cho Ô Tô Xe Hơi ",459000,459000,0,0
TIKI,o-to-xe-may-xe-dap,70844929,"Bộ 2 đèn led trợ sáng cầu lồi mini gắn chân gương xe máy",45000,45000,0,0
TIKI,o-to-xe-may-xe-dap,1565461,"Bộ 3 Sản Phẩm Chăm Sóc Xe Hơi Chuyên Dụng 3M: Chai Xịt Bảo Dưỡng Lốp Xe LT 39042 - Dung Dịch Chống Bám Nước Trên Kính Xe 3M Glass Coat Windshield LT 08889 - Khăn Lau Xe Hơi 3M Perfect-It Super Soft Microfiber PN05400 (32 x 36 cm)",403750,425000,21250,5
TIKI,o-to-xe-may-xe-dap,232014,"Mũ Bảo Hiểm Nửa Đầu Có Kính GRS A737K Nhám",279000,279000,0,0
TIKI,o-to-xe-may-xe-dap,89652524,"Xe đạp nữ Xaming cao cấp 18, 20inch dành  cho bé gái 7-10 tuổi",1090000,1090000,0,0
TIKI,o-to-xe-may-xe-dap,136714171,"ĐÈN PHA BI CẦU COS VÀNG ĐÈN PHA LED XE MÁY, DẢI SÁNG GOM DÙNG ĐIỆN BÌNH - DPBV",76290,76290,0,0
TIKI,o-to-xe-may-xe-dap,31522404,"Nhớt Tổng Hợp Cao Cấp Cho Ô Tô Kixx G1 5W-30 API SN/GF-5/RC/SF Thùng Thiếc 4 Lít",500000,500000,0,0
TIKI,o-to-xe-may-xe-dap,52123157,"Chai xịt chống chuột, đuổi chuột Liqui Moly 1515 - Tặng kèm 1 khăn lau chuyên dụng 3M (màu ngẫu nhiên)",189000,189000,0,0
TIKI,o-to-xe-may-xe-dap,7139355,"Máy Lọc Không Khí Ô TÔ Cao Cấp BONECO P50 Ion âm lớn, Khuếch Tán/ Xông Tinh Dầu, Dùng Cho Xe Hơi/Xe Đẩy Em Bé/Bàn Làm Việc - Hàng Nhập Khẩu",2860000,2860000,0,0
TIKI,o-to-xe-may-xe-dap,5902329,"Móc treo đồ xe máy (2 móc xoay 180*)",35000,35000,0,0
TIKI,o-to-xe-may-xe-dap,139444210,"Đèn trợ sáng xe máy ô tô bi cầu F20XP 2 màu cốt vàng pha trắng 60w siêu sáng dành cho khách víp",456000,456000,0,0
TIKI,o-to-xe-may-xe-dap,99350747,"Bộ kích nô acquy kiêm sạc dự phòng 12000mAh Baseus CRJS03-01 - HÀNG CHÍNH HÃNG ",1509499,1509499,0,0
TIKI,o-to-xe-may-xe-dap,95509657,"Ty Kẹp Trục, Khóa Mở Nhanh Trục Xiên Bánh Xe Đạp (2 Cái) Mai Lee",46550,49000,2450,5
TIKI,o-to-xe-may-xe-dap,52472103,"Dây Curoa Tổng Ford Transit (2001-2006) - Bosch 7PK2875",372000,372000,0,0
TIKI,o-to-xe-may-xe-dap,129568672,"Lưới chống chuột dành cho ô tô VinFast Fadil.",62000,62000,0,0
TIKI,o-to-xe-may-xe-dap,31269193,"BỘ ĐÈN XI NHAN MŨI TÊN (ĐÔI)",58500,65000,6500,10
TIKI,o-to-xe-may-xe-dap,85376328,"Bộ Điều Khiển Cửa Ô Tô Đóng Mở Tự Động",209000,209000,0,0
TIKI,o-to-xe-may-xe-dap,99891432,"Cục Nhại Còi Xe Máy Gắn Nhiều Loại Xe",33990,33990,0,0
TIKI,o-to-xe-may-xe-dap,107458302,"Bộ Áo Ghế Hạt Gỗ Massage Cao Cấp- Chống Nóng, Trượt Dùng Cho Ô tô, Xe hơi, Văn phòng",369541,388990,19449,5
TIKI,o-to-xe-may-xe-dap,2089717,"Mũ Bảo Hiểm Royal Fullface M136 - Đen Nhám (Size",359000,359000,0,0
TIKI,o-to-xe-may-xe-dap,98030266,"Bình Xịt Bọt Vệ Sinh Khử Mùi Hôi Điều Hòa Ô Tô Flamingo F020 500ml – Hàng Chính Hãng",94050,99000,4950,5
TIKI,o-to-xe-may-xe-dap,158886987,"[Loại To - Tốt] Áo Bạt Phủ Trùm Xe Máy Cỡ Lớn KhoNCC Hàng Chính Hãng - To Dày Bền Mát - Dòng Xe Vario, Exciter, SH Mode các loại - KQL-C3-VRO (Nhiều Màu)",169000,238000,69000,29
TIKI,o-to-xe-may-xe-dap,121398781,"Film cách nhiệt 3M chính hãng",350000,350000,0,0
TIKI,o-to-xe-may-xe-dap,77718739,"TAY NẮM XE ĐẠP - BỌC TAY NẮM XE ĐẠP - Tay cầm ghi đông xe đạp thể thao bằng cao su cao cấp cực chắc và êm  TL 01",29000,29000,0,0
TIKI,o-to-xe-may-xe-dap,43433800," Gối Tựa Đầu Ô Tô Chống Mỏi Cổ",35000,35000,0,0
TIKI,laptop-may-vi-tinh-linh-kien,274643985,"Máy vi tính Laptop Asus ExpertBook B1400 (Chip Intel Core i5-1235U | RAM 16GB | SSD 512GB NVMe | 14' Full HD | Bảo mật vân tay | Bảo mật TPM 2.0 | Độ bền chuẩn quân đội US) - Hàng Chính Hãng",17190000,22100000,4910000,22
TIKI,laptop-may-vi-tinh-linh-kien,271770232,"Máy Chiếu Mini BEECUBE X1 Gen 2 2023 Android TV - Auto Keystone - Kết nối nhiều thiết bị - Bảo Hành 12 Tháng - Hàng Chính Hãng",1990000,2600000,610000,23
TIKI,laptop-may-vi-tinh-linh-kien,106318753,"Máy tính xách tay Laptop Dell Latitude 3420 (Intel Core i5-1135G7 | 14 Inch | RAM 8GB | 256GB SSD NVMe | Intel Iris Xe Graphics | Fedora Os) - Hàng chính hãng",14590000,19900000,5310000,27
TIKI,laptop-may-vi-tinh-linh-kien,187770519,"Máy Tính Siêu Nhỏ Ultra Mini Morefine ZX01 Plus - Intel thế hệ 12 Alder Lake N100 - Hỗ Trợ Xuất Hình 4K 60hz",5275000,5275000,0,0
TIKI,laptop-may-vi-tinh-linh-kien,274032002,"Máy Chiếu Mini BEECUBE X2 MAX GEN 4 2024 - Hàng Chính Hãng",3790000,5000000,1210000,24
TIKI,laptop-may-vi-tinh-linh-kien,17967481,"Bộ Kích Sóng Wifi Xiaomi Repeater Pro - Hàng Nhập Khẩu",249000,299000,50000,17
TIKI,laptop-may-vi-tinh-linh-kien,138481685,"Phần mềm Microsoft 365 Family English APAC EM Subscr 1YR Medialess P8 (6GQ-01555) / P10 (6GQ-01896) - Hàng Chính Hãng",1290000,1490000,200000,13
TIKI,laptop-may-vi-tinh-linh-kien,273949286,"Laptop Asus Expertbook B1502 - B1502CV (Intel Core i5-1335U | RAM 8GB | 512GB SSD | Intel UHD Graphics | 15.6 inch Full HD | Win 11 bản quyền) - Hàng Chính Hãng",16490000,22900000,6410000,28
TIKI,laptop-may-vi-tinh-linh-kien,618526,"Ổ Cứng SSD Kingston A400 (240GB) - Hàng Chính Hãng",799000,799000,0,0
TIKI,laptop-may-vi-tinh-linh-kien,16667097,"Hộp mực dành cho máy in canon Lbp 6030/ 6030w",116500,116500,0,0
TIKI,laptop-may-vi-tinh-linh-kien,197190455,"Bộ phát Wifi di động PROLiNK DL7203E, SIM 4G LTE 150Mbps, pin 5200mAH, màn hình 1.44", cổng RJ45, USB 2.0, microSD - Hàng chính hãng",1650000,1999000,349000,17
TIKI,laptop-may-vi-tinh-linh-kien,273716533,"Laptop Asus Expertbook B1502CBA B1502 (Intel Core i5-1235U | RAM 8GB | 512GB SSD | Intel UHD Graphics | 15.6 inch Full HD | Win 11 bản quyền) - Hàng Chính Hãng",14490000,18890000,4400000,23
TIKI,laptop-may-vi-tinh-linh-kien,203211116,"(Giá Hủy Diệt) Ổ cứng gắn trong HDD Western Digital Ultrastar 3.5 inch Sata 3 cho Serve dòng Enterprise - Hàng Nhập Khẩu",4510000,5740000,1230000,21
TIKI,laptop-may-vi-tinh-linh-kien,74561661,"Bộ Chuyển Đổi USB Wifi TP-Link TL-WN727N Chuẩn N 150Mbps - Hàng Chính Hãng",139000,229000,90000,39
TIKI,laptop-may-vi-tinh-linh-kien,270443386,"Laptop Asus ExpertBook B1500 (Chip Intel Core i5-1235U | RAM 16GB | SSD 512GB NVMe | 15.6' Full HD | Bảo mật vân tay | Bảo mật TPM 2.0 | Độ bền chuẩn quân đội US) - Hàng Chính Hãng",16999000,22150000,5151000,23
TIKI,laptop-may-vi-tinh-linh-kien,38323087,"(Giá Hủy Diệt) Ổ Cứng Di Động HDD WD My Passport 1TB / 2TB / 4TB / 5TB Model 2019 - Hàng Nhập Khẩu",1705000,2050000,345000,17
TIKI,laptop-may-vi-tinh-linh-kien,53704413,"Hộp mực Dành Cho máy in Canon LBP 2900, 3000",110000,110000,0,0
TIKI,laptop-may-vi-tinh-linh-kien,54439144,"Bộ Chuyển Đổi USB Wifi TP-Link Archer T2U Plus Công Suất Cao AC600 - Hàng Chính Hãng",259000,349000,90000,26
TIKI,laptop-may-vi-tinh-linh-kien,167932609,"Màn hình MSI PRO MP241X 23.8 inch FHD/VA 75Hz - Hàng Chính Hãng",1920000,3742200,1822200,49
TIKI,laptop-may-vi-tinh-linh-kien,44012580,"RAM Laptop Samsung 8GB DDR4 Bus 3200 - Hàng Nhập Khẩu",517000,672000,155000,23
TIKI,laptop-may-vi-tinh-linh-kien,52373199,"Hộp mực in 337 dùng cho máy in Canon MF211, MF221D, LBP252DW, MF215, MF241D,... - CRG 337",117500,117500,0,0
TIKI,laptop-may-vi-tinh-linh-kien,74547151,"Bộ Phát Wifi TP-Link Archer C24 Băng Tần Kép AC750 - Hàng Chính Hãng",699000,699000,0,0
TIKI,laptop-may-vi-tinh-linh-kien,247241481,"Phần Mềm Diệt Virus BKAV Profressional 1 PC 12 Tháng - Hàng Chính Hãng",184000,184000,0,0
TIKI,laptop-may-vi-tinh-linh-kien,134561311,"USB 3.0 SanDisk Ultra Flair CZ73 - Hàng Nhập Khẩu",129000,129000,0,0
TIKI,laptop-may-vi-tinh-linh-kien,3054369,"Phần Mềm Diệt Virus BKAV Profressional 1 PC 12 Tháng - Hàng Chính Hãng",225000,225000,0,0
TIKI,laptop-may-vi-tinh-linh-kien,87036279,"Hộp mực 337/ 83a CÓ LỔ ĐỔ MỰC, XẢ THẢI BÊN NGOÀI dùng cho máy in Canon 221D, 151DW, 249DW, MF 241d - HP M127FN, M125, M126, M201, M225MFP...",117500,117500,0,0
TIKI,laptop-may-vi-tinh-linh-kien,53080935,"Phần mềm Microsoft 365 Personal English APAC EM Subscr 1YR Medialess P8 (QQ2-01398) / P10 (QQ2-01896) - Hàng Chính Hãng",890000,1290000,400000,31
TIKI,laptop-may-vi-tinh-linh-kien,17620717,"Hộp mực Dành Cho máy in Canon LBP 2900, 3000 siêu nét",115500,115500,0,0
TIKI,laptop-may-vi-tinh-linh-kien,74559331,"Bộ Mở Rộng Sóng Wifi TP-Link TL-WA850RE Chuẩn N 300Mbps - Hàng Chính Hãng",239000,399000,160000,40
TIKI,laptop-may-vi-tinh-linh-kien,247719163,"Laptop Asus ExpertBook B1400 (Chip Intel Core i5-1235U | RAM 8GB | SSD 512GB NVMe | 14' Full HD | Bảo mật vân tay | Bảo mật TPM 2.0 | Độ bền chuẩn quân đội US) - Hàng Chính Hãng",15190000,19999000,4809000,24
TIKI,laptop-may-vi-tinh-linh-kien,77516386,"Hộp mực máy in Canon LBP 6230DN, 6230DW, 6200D, MF4410 có lỗ nạp mực",118000,118000,0,0
TIKI,laptop-may-vi-tinh-linh-kien,44012580,"RAM Laptop Samsung 8GB DDR4 Bus 3200 - Hàng Nhập Khẩu",517000,672000,155000,23
TIKI,laptop-may-vi-tinh-linh-kien,146012358,"Ổ cứng di động External SSD Sandisk Extreme V2 E61 New 2021 - 1TB Hàng Nhập Khẩu",2490000,2490000,0,0
TIKI,laptop-may-vi-tinh-linh-kien,93166195,"Bộ lưu điện UPS PROLiNK PRO2000SFCU (2000VA) công suất 1200W, tích hợp bộ AVR, sạc siêu nhanh, dùng cho PC, Camera, Wifi - Hàng chính hãng",3929000,4499000,570000,13
TIKI,laptop-may-vi-tinh-linh-kien,7460207," Hộp mực máy in Canon LBP 2900, 3000",116500,116500,0,0
TIKI,laptop-may-vi-tinh-linh-kien,456510,"TP-Link TL-SF1008D - Bộ Chia Tín Hiệu Để Bàn 8 cổng 10/100Mbps - Hàng Chính Hãng",169000,289000,120000,42
TIKI,laptop-may-vi-tinh-linh-kien,56248606,"USB Thu WIFI TP-Link TL-WN725N (Đen) - Hàng Chính Hãng",119000,123800,4800,4
TIKI,laptop-may-vi-tinh-linh-kien,169695798,"Keo Tản Nhiệt Cooler Master Mastergel Pro V2 - Hàng Chính Hãng",99000,99000,0,0
TIKI,laptop-may-vi-tinh-linh-kien,14518091,"Đầu bấm mạng RJ45 loại xịn AMP (Hộp 100 hạt)",45000,45000,0,0
TIKI,laptop-may-vi-tinh-linh-kien,8608925,"Hộp mực dành cho máy in Laser Brother HL-L2321D.",110000,110000,0,0
TIKI,laptop-may-vi-tinh-linh-kien,416613,"TP-Link  TL-WR841N - Router Wifi Chuẩn N Tốc Độ 300Mbps - Hàng Chính Hãng",289000,549000,260000,47
TIKI,laptop-may-vi-tinh-linh-kien,8315202,"Dây Mạng Bấm Sẵn 2 Đầu CAT5  20 Mét (màu ngẫu nhiên)",26900,26900,0,0
TIKI,laptop-may-vi-tinh-linh-kien,708026,"Bộ Phát Wifi TP-Link Archer C50 Băng Tần Kép AC1200 - Hàng Chính Hãng",479000,898000,419000,47
TIKI,laptop-may-vi-tinh-linh-kien,271455574,"Máy Tính Siêu Nhỏ Ultra Mini T9 PLUS - Intel thế hệ 12 Alder Lake N100 - Hỗ Trợ Xuất Hình 4K 60hz",5429250,5715000,285750,5
TIKI,laptop-may-vi-tinh-linh-kien,87034145,"Hộp mực dùng cho máy in Canon 6030, 6030W CÓ LỔ NẠP MỰC-XẢ THẢI NGOÀI - MÃ 35A/85A/325",116500,116500,0,0
TIKI,laptop-may-vi-tinh-linh-kien,48607335,"Bộ sạc pin Surface 65W dành cho các dòng Surface Book, SurfacePro 3,4,5,6,7",591000,940000,349000,37
TIKI,laptop-may-vi-tinh-linh-kien,2121583,"Sạc Dành Cho Laptop DELL 19.5V - 4.62A (90W)",184995,250000,65005,26
TIKI,laptop-may-vi-tinh-linh-kien,16572969,"Hộp mực máy in 12A Dành Cho máy in Canon 2900 3000 HP 1010 1020",110000,110000,0,0
TIKI,laptop-may-vi-tinh-linh-kien,76054860,"Ổ Cứng Di Động HDD WD Black P10 2.5 inch USB 3.2 - Hàng Nhập Khẩu",4235000,5390000,1155000,21
TIKI,laptop-may-vi-tinh-linh-kien,74975883,"Bộ Phát Wifi TP-Link Archer C54 Băng Tần Kép Chuẩn AC1200 - Hàng Chính Hãng",409000,778000,369000,47
TIKI,laptop-may-vi-tinh-linh-kien,124742926,"Apple Macbook Air 2020 13 inch (Apple M1 - 8GB/ 256GB) - MGN93SA/A",18690000,24990000,6300000,25
TIKI,laptop-may-vi-tinh-linh-kien,143105681,"Hộp Mực In Cartridge 12A Cho Máy Canon LBP 2900 3000 Q2612A FX9 FX10 103 303 703 104 304 Có Lỗ Nạp Mực - Hàng Chính Hãng",115300,115300,0,0
TIKI,laptop-may-vi-tinh-linh-kien,43973407,"Hộp mực TN 2385 cho máy in Brother 2321D 2361DN 2366Dw 2520D 2701D 2701Dw",110000,110000,0,0
TIKI,laptop-may-vi-tinh-linh-kien,102156839,"RAM Laptop DDR4 Samsung 4GB Bus 3200 - Hàng Nhập Khẩu",242000,308000,66000,21
TIKI,laptop-may-vi-tinh-linh-kien,58257520,"Màn Hình Gaming LG 27QN600-B 27 inch QHD (2560x1440) 75Hz / HDR / IPS / AMD FreeSync - Hàng Chính Hãng",5630000,7890000,2260000,29
TIKI,laptop-may-vi-tinh-linh-kien,274643985,"Máy vi tính Laptop Asus ExpertBook B1400 (Chip Intel Core i5-1235U | RAM 16GB | SSD 512GB NVMe | 14' Full HD | Bảo mật vân tay | Bảo mật TPM 2.0 | Độ bền chuẩn quân đội US) - Hàng Chính Hãng",17190000,22100000,4910000,22
TIKI,laptop-may-vi-tinh-linh-kien,271770232,"Máy Chiếu Mini BEECUBE X1 Gen 2 2023 Android TV - Auto Keystone - Kết nối nhiều thiết bị - Bảo Hành 12 Tháng - Hàng Chính Hãng",1990000,2600000,610000,23
TIKI,laptop-may-vi-tinh-linh-kien,106318753,"Máy tính xách tay Laptop Dell Latitude 3420 (Intel Core i5-1135G7 | 14 Inch | RAM 8GB | 256GB SSD NVMe | Intel Iris Xe Graphics | Fedora Os) - Hàng chính hãng",14590000,19900000,5310000,27
TIKI,laptop-may-vi-tinh-linh-kien,17904749,"Hộp mực 12a dùng cho máy in HP 1020 ,3050, 3055, 1319,1010 ,1018 Canon 2900",114900,114900,0,0
TIKI,laptop-may-vi-tinh-linh-kien,187770519,"Máy Tính Siêu Nhỏ Ultra Mini Morefine ZX01 Plus - Intel thế hệ 12 Alder Lake N100 - Hỗ Trợ Xuất Hình 4K 60hz",5275000,5275000,0,0
TIKI,laptop-may-vi-tinh-linh-kien,274032002,"Máy Chiếu Mini BEECUBE X2 MAX GEN 4 2024 - Hàng Chính Hãng",3790000,5000000,1210000,24
TIKI,laptop-may-vi-tinh-linh-kien,197241284,"Hôp mực in 107A CÓ CHÍP dùng cho máy in HP 107a/MFP 135a/137fnw (W1107A)",254500,254500,0,0
TIKI,laptop-may-vi-tinh-linh-kien,459201,"Máy In Laser Đen Trắng Đơn Năng Brother HL-L2321D Duplex - Hàng Chính Hãng",3069000,3069000,0,0
TIKI,laptop-may-vi-tinh-linh-kien,10001351,"RAM Laptop Samsung 8GB DDR4 2400MHz SODIMM - Hàng Nhập Khẩu",495000,630000,135000,21
TIKI,laptop-may-vi-tinh-linh-kien,10001369,"RAM Laptop Samsung 8GB DDR4 2666MHz SODIMM - Hàng Nhập Khẩu",517000,658000,141000,21
TIKI,laptop-may-vi-tinh-linh-kien,10001373,"RAM Laptop Samsung 16GB DDR4 2666MHz SODIMM - Hàng Nhập Khẩu",935000,1148000,213000,19
TIKI,laptop-may-vi-tinh-linh-kien,456506,"TP-Link TL-SF1005D - Bộ Chia Tín Hiệu Để Bàn 5 cổng 10/100Mbps - Hàng Chính Hãng",149000,259000,110000,42
TIKI,laptop-may-vi-tinh-linh-kien,17611318,"Sạc dành cho Laptop Acer 19V - 3.42A,65W Đầu Nhỏ Xíu, Size 3.0mmX1.1mm",238995,290000,51005,18
TIKI,laptop-may-vi-tinh-linh-kien,247241493,"Phần Mềm Diệt Virus BKAV Profressional Internet Security (1 năm) - Hàng Chính Hãng",184000,184000,0,0
TIKI,laptop-may-vi-tinh-linh-kien,25208975,"Sạc dành cho Laptop Dell 19.5V - 3.34A (65W) Chân Kim Nhỏ kích thước 4.5mm x 3.0mm - Hàng Nhập Khẩu",269995,269995,0,0
TIKI,laptop-may-vi-tinh-linh-kien,273949286,"Laptop Asus Expertbook B1502 - B1502CV (Intel Core i5-1335U | RAM 8GB | 512GB SSD | Intel UHD Graphics | 15.6 inch Full HD | Win 11 bản quyền) - Hàng Chính Hãng",16490000,22900000,6410000,28
TIKI,laptop-may-vi-tinh-linh-kien,54839622,"Hộp mực in HP 85A / Canon 325 cho máy Canon 6030 / 6030w / HP 1102 / 1102w / 1132 / 1212nf /...",118500,118500,0,0
TIKI,laptop-may-vi-tinh-linh-kien,106375760,"Màn hình Dell Ultrasharp U2422H 23.8 inch Full HD 60Hz - Hàng Chính Hãng",6510000,6790000,280000,4
TIKI,laptop-may-vi-tinh-linh-kien,197190455,"Bộ phát Wifi di động PROLiNK DL7203E, SIM 4G LTE 150Mbps, pin 5200mAH, màn hình 1.44", cổng RJ45, USB 2.0, microSD - Hàng chính hãng",1650000,1999000,349000,17
TIKI,laptop-may-vi-tinh-linh-kien,9979633,"Sạc dành cho Laptop Dell chân kim nhỏ 19.5V - 4.62A- 90w",220000,220000,0,0
TIKI,laptop-may-vi-tinh-linh-kien,459733,"Brother TN-2385 Toner Mực Cho Máy In HL-L2321D, HL-2361DN, HL-2366DW, MFC-L2701D, MFC-L2701DW - Hàng Chính Hãng",550000,550000,0,0
TIKI,laptop-may-vi-tinh-linh-kien,75990687,"Hôp mực in 107A CÓ CHÍP dùng cho máy in HP 107a/MFP 135a/137fnw (W1107A)",285000,285000,0,0
TIKI,laptop-may-vi-tinh-linh-kien,10001382,"RAM Laptop Samsung 4GB DDR3L bus 1600 - Hàng Nhập Khẩu",198000,252000,54000,21
TIKI,laptop-may-vi-tinh-linh-kien,51845073,"Máy In Laser Đa Năng HP LaserJet Pro MFP 135W (4ZB83A) - Hàng Chính Hãng",3360000,4190000,830000,20
TIKI,laptop-may-vi-tinh-linh-kien,618461,"Ổ Cứng SSD Kingston A400 (120GB) - Hàng Chính Hãng",379000,399000,20000,5
TIKI,laptop-may-vi-tinh-linh-kien,10001357,"RAM Laptop Hynix 8GB DDR4 2400MHz SODIMM - Hàng Nhập Khẩu",484000,588000,104000,18
TIKI,laptop-may-vi-tinh-linh-kien,15333970,"Hộp mực in 2385 cho máy in Brother HL- L2361DN, L2366DW, HL- L2321D.",109900,109900,0,0
TIKI,laptop-may-vi-tinh-linh-kien,112131582,"Sạc Dành Cho Laptop Asus 19V-2.37A, 45W Đầu nhỏ Size (4.0mmx1.35mm)",174888,174888,0,0
TIKI,laptop-may-vi-tinh-linh-kien,754249,"Bộ Kích Sóng Wifi Repeater Mercusys MW300RE 300Mbps - Hàng Chính Hãng",239000,299000,60000,20
TIKI,laptop-may-vi-tinh-linh-kien,273716533,"Laptop Asus Expertbook B1502CBA B1502 (Intel Core i5-1235U | RAM 8GB | 512GB SSD | Intel UHD Graphics | 15.6 inch Full HD | Win 11 bản quyền) - Hàng Chính Hãng",14490000,18890000,4400000,23
TIKI,laptop-may-vi-tinh-linh-kien,10001384,"RAM Laptop Samsung 8GB DDR3L bus 1600 - Hàng Nhập Khẩu",407000,518000,111000,21
TIKI,laptop-may-vi-tinh-linh-kien,191629807,"Quạt Tản Nhiệt Điện Thoại Huqu HQ.P9- 3 Tốc Độ Gió -Hàng Chính Hãng",142500,150000,7500,5
TIKI,laptop-may-vi-tinh-linh-kien,10001326,"RAM Laptop Samsung 8GB DDR4 2133MHz SODIMM - Hàng Nhập Khẩu",495000,630000,135000,21
TIKI,laptop-may-vi-tinh-linh-kien,419322,"Máy In Laser Đơn Năng Canon LBP 6030W Wifi - Hàng chính hãng",3200000,4400000,1200000,27
TIKI,laptop-may-vi-tinh-linh-kien,15348322,"Hộp mực in 326 cho máy in Canon LBP6230DN / LBP6200D",117500,117500,0,0
TIKI,laptop-may-vi-tinh-linh-kien,10001373,"RAM Laptop Samsung 16GB DDR4 2666MHz SODIMM - Hàng Nhập Khẩu",935000,1148000,213000,19
TIKI,laptop-may-vi-tinh-linh-kien,53254176,"Mực in Dành Cho Máy Canon 2900 - Hộp mực 12A",110000,110000,0,0
TIKI,laptop-may-vi-tinh-linh-kien,16217273,"USB nhận Wifi NS 4840",41500,41500,0,0
TIKI,laptop-may-vi-tinh-linh-kien,93166195,"Bộ lưu điện UPS PROLiNK PRO2000SFCU (2000VA) công suất 1200W, tích hợp bộ AVR, sạc siêu nhanh, dùng cho PC, Camera, Wifi - Hàng chính hãng",3929000,4499000,570000,13
TIKI,laptop-may-vi-tinh-linh-kien,10001369,"RAM Laptop Samsung 8GB DDR4 2666MHz SODIMM - Hàng Nhập Khẩu",517000,658000,141000,21
TIKI,laptop-may-vi-tinh-linh-kien,85444689,"Bộ Phát Wifi 6 TP-Link Archer AX73 Gigabit Băng Tần Kép AX5400 - Hàng Chính Hãng",2399000,4778000,2379000,50
TIKI,laptop-may-vi-tinh-linh-kien,456497,"TP-Link  TL-SG1005D - Switch 5 Cổng Gigabit Desktop - Hàng Chính Hãng",309000,449000,140000,31
TIKI,laptop-may-vi-tinh-linh-kien,137805214,"Bộ Phát Wifi TP-Link Archer C64 Băng Tần Kép Chuẩn AC1200 - Hàng Chính Hãng",648000,679000,31000,5
TIKI,laptop-may-vi-tinh-linh-kien,52192246,"Hộp mực máy in Laser Brother HL-L2321D - TN 2385",109900,109900,0,0
TIKI,laptop-may-vi-tinh-linh-kien,13335150,"Bộ Chuyển Đổi Mạng USB 3.0 Sang Ethernet Gigabit kèm 3 cổng USB 3.0 TP-Link UE330 - Hàng Chính Hãng",400000,400000,0,0
TIKI,laptop-may-vi-tinh-linh-kien,10001357,"RAM Laptop Hynix 8GB DDR4 2400MHz SODIMM - Hàng Nhập Khẩu",484000,588000,104000,18
TIKI,laptop-may-vi-tinh-linh-kien,41446843,"Bộ Dụng Cụ Thi Công Mạng (Kìm Mạng + Bộ Test Mạng + 100 Hạt mạng RJ45)",99000,106100,7100,7
TIKI,laptop-may-vi-tinh-linh-kien,57666163,"N160USM - USB Wi-Fi siêu nhỏ chuẩn N 150Mbps",125000,125000,0,0
TIKI,laptop-may-vi-tinh-linh-kien,16305404,"Hộp mực 35A cho máy in HP LaserJet P1006, P1005",116500,116500,0,0
TIKI,laptop-may-vi-tinh-linh-kien,9979633,"Sạc dành cho Laptop Dell chân kim nhỏ 19.5V - 4.62A- 90w",188195,376390,188195,50
TIKI,laptop-may-vi-tinh-linh-kien,416978,"Bộ Chuyển Đổi USB Wifi Nano TP-Link TL-WN725N Chuẩn N 150Mbps - Hàng Chính Hãng",138000,138000,0,0
TIKI,laptop-may-vi-tinh-linh-kien,10001351,"RAM Laptop Samsung 8GB DDR4 2400MHz SODIMM - Hàng Nhập Khẩu",495000,630000,135000,21
TIKI,laptop-may-vi-tinh-linh-kien,2903577,"Máy In Phun Màu Đa Năng Canon Pixma G3010 - Hàng Chính Hãng",4900000,5490000,590000,11
TIKI,laptop-may-vi-tinh-linh-kien,203211116,"(Giá Hủy Diệt) Ổ cứng gắn trong HDD Western Digital Ultrastar 3.5 inch Sata 3 cho Serve dòng Enterprise - Hàng Nhập Khẩu",4510000,5740000,1230000,21
TIKI,laptop-may-vi-tinh-linh-kien,174593821,"Kích Sóng Wifi Tốc Độ Cao 4 Râu 300M PIX-LINK LV-WR09 Thiết Bị Mở Rộng Sóng Bao Phủ Căn Nhà, Văn Phòng - Hàng Chính Hãng",294500,589000,294500,50
TIKI,laptop-may-vi-tinh-linh-kien,566867,"TotoLink N200RE-V3 - Bộ Phát Wifi Chuẩn N Tốc Độ 300Mbps - Hàng Chính Hãng",249000,249000,0,0
TIKI,laptop-may-vi-tinh-linh-kien,7490967," Hộp Mực 85A dùng cho máy in hp P1102 - 1102W - 1212NF",118000,118000,0,0
TIKI,laptop-may-vi-tinh-linh-kien,11252598,"Bộ phát Wifi TP-LINK TL-WR845N 300 Mbps, 3 ăng ten rời - Hàng Chính Hãng",339000,599000,260000,43
TIKI,laptop-may-vi-tinh-linh-kien,67911084,"10 cuộn giấy nhiệt in bill, in hóa đơn (thermal paper) TOPCASH khổ K57mm x 38mm dùng cho máy cà thẻ ngân hàng, máy in cầm tay, máy tính tiền POS cầm tay Now Delivery / Grab / Gojek - Hàng chính hãng",52000,65000,13000,20
TIKI,laptop-may-vi-tinh-linh-kien,45048475,"DÂY NGUỒN SỐ 8 ",7990,7990,0,0
TIKI,laptop-may-vi-tinh-linh-kien,76283023,"(Giá Hủy Diệt) Ổ Cứng gắn trong SSD Samsung 870 EVO 2.5 inch sata III - Hàng Nhập Khẩu",2585000,3290000,705000,21
TIKI,laptop-may-vi-tinh-linh-kien,52368889,"Hộp mực 83A cho máy in HP Pro M125, M126, M127, M225, M201n, M201dw - CF283A",115500,115500,0,0
TIKI,laptop-may-vi-tinh-linh-kien,100625195,"Bộ kích sóng Wifi Tenda A9 Chuẩn N 300Mbps - Hàng Chính Hãng",218900,218900,0,0
TIKI,laptop-may-vi-tinh-linh-kien,8428670,"Combo dung dịch nano lau chùi vệ sinh màn hình, bàn phím cho máy tính, laptop, macbook - Hàng Chính Hãng",114000,114000,0,0
TIKI,laptop-may-vi-tinh-linh-kien,15337513,"Hộp mực in 85A cho máy in HP P1102, HP M1132 MFP, HP M1212NFA",116500,116500,0,0
TIKI,laptop-may-vi-tinh-linh-kien,14370763,"Ổ Đĩa Quang DVD Gắn Ngoài ASUS 8x USB 2.0 - Hàng Chính Hãng",839000,849000,10000,1
TIKI,laptop-may-vi-tinh-linh-kien,88265782,"Máy in phun màu đa năng Brother DCP-T420W",4275000,4275000,0,0
TIKI,laptop-may-vi-tinh-linh-kien,140107134,"Ổ Cứng Di Động SSD Sandisk E30 - Hành Nhập Khẩu",3381000,3450000,69000,2
TIKI,laptop-may-vi-tinh-linh-kien,73312665,"(Giá Hủy Diệt) Ổ cứng di động External SSD SanDisk Extreme E61 Portable USB Type C 3.2 Gen 2 - Hàng Nhập Khẩu",2145000,2646000,501000,19
TIKI,laptop-may-vi-tinh-linh-kien,7668907,"Mực In Brother BTD60BK - Hàng Chính Hãng",220000,220000,0,0
TIKI,laptop-may-vi-tinh-linh-kien,173977172,"Ổ cứng Silicon Power 2.5 inch SATA SSD A56 128GB - Hàng chính hãng",408000,408000,0,0
TIKI,laptop-may-vi-tinh-linh-kien,74561265,"Hộp Đựng Ổ Cứng  Di Động HDD Box 2.5 VINETTEAM USB 3.0 Nhựa Trong Suốt Tốc Độ 5gbs-3297-Hàng Chính Hãng",115000,127990,12990,10
TIKI,laptop-may-vi-tinh-linh-kien,70944880,"Ổ Cứng SSD Samsung 980 Pro M2 PCIe 4.0 - Hàng Nhập Khẩu",2915000,3766000,851000,23
TIKI,laptop-may-vi-tinh-linh-kien,143741572,"Ổ cứng di động External SSD Sandisk Extreme V2 E61 New 2021 - 500GB Hàng Nhập Khẩu",1890000,1890000,0,0
TIKI,laptop-may-vi-tinh-linh-kien,136032169,"[Wifi thế hệ mới] Bộ Phát Router Wifi TP-Link Archer AX23 Wifi 6 Chuẩn AX1800 - Hàng Chính Hãng",1998000,1998000,0,0
TIKI,laptop-may-vi-tinh-linh-kien,59251056,"USB 16GB/32GB - Hàng Chính Hãng - VIVAN VF316/VF332",149000,165000,16000,10
TIKI,laptop-may-vi-tinh-linh-kien,86123397,"(Giá Hủy Diệt) Ổ Cứng gắn trong SSD Samsung 980 M2 2280 PCIe - Hàng Nhập Khẩu",2365000,3010000,645000,21
TIKI,laptop-may-vi-tinh-linh-kien,77605790,"Bộ Phát Wifi Mercusys AC10 Băng Tần Kép AC1200 - Hàng Chính Hãng",339000,559000,220000,39
TIKI,laptop-may-vi-tinh-linh-kien,22883541,"Đầu Nối Dây Mạng RJ45 chia 1 ra 2",9700,9700,0,0
TIKI,laptop-may-vi-tinh-linh-kien,73666130,"Hộp mực Canon 325 cho máy in Canon LBP 6030, 6030w, 6000, MF3010",119500,119500,0,0
TIKI,laptop-may-vi-tinh-linh-kien,93294232,"Bộ card WIFI Intel WIFI 6E AX210 cho máy bàn dùng cổng PCIe hỗ trợ 2.4Ghz 5Ghz và 6Ghz - Bluetooth 5.3 - Hàng nhập khẩu",530000,530000,0,0
TIKI,laptop-may-vi-tinh-linh-kien,67480516,"Phần mềm diệt Virus Bkav Pro - Hàng chính hãng",184000,184000,0,0
TIKI,laptop-may-vi-tinh-linh-kien,192206541,"Ổ Cứng Di Động WD My Passport SSD Hàng Chính Hãng",2145000,3090000,945000,31
TIKI,laptop-may-vi-tinh-linh-kien,192208694,"Ổ Cứng Di Động WD My Passport Hàng Chính Hãng",1623000,2490000,867000,35
TIKI,laptop-may-vi-tinh-linh-kien,74547194,"Bộ Phát Wifi Di Động 3G/4G TP-Link M7000 - Hàng Chính Hãng",1399000,1399000,0,0
TIKI,laptop-may-vi-tinh-linh-kien,15356062,"Hộp mực in 05A cho máy in  HP LaserJet P2035; P2055d; P2055x;  P2035n.",159000,159000,0,0
TIKI,laptop-may-vi-tinh-linh-kien,51970596,"Cụm Drum (khay trống) cho máy In Brother HL-L2321D/ 2361DN/ 2366DW/ DCP-L2520D/ MFC-L2701D/ MFC-L2701DW - Mã DR-2385 ",188000,188000,0,0
TIKI,laptop-may-vi-tinh-linh-kien,20907214,"RAM Laptop Samsung 4GB DDR3 (PC3) Bus 1333   - Hàng Nhập Khẩu",209000,266000,57000,21
TIKI,laptop-may-vi-tinh-linh-kien,53056161,"Phần mềm Microsoft 365 Family | 6 Users | 1TB/User | 365 ngày – Hàng chính hãng",1390000,1990000,600000,30
TIKI,laptop-may-vi-tinh-linh-kien,6910261,"Phần Mềm Diệt Virus Trend Micro Internet Security Bản Quyền 1 PC 12 Tháng - Hàng chính hãng",108000,108000,0,0
TIKI,laptop-may-vi-tinh-linh-kien,107360880,"Bộ Mở Rộng Sóng Wifi Mesh TP-Link RE315 Chuẩn AC 1200Mbps - Hàng Chính Hãng",899000,899000,0,0
TIKI,laptop-may-vi-tinh-linh-kien,53181542,"Hộp mực 326, 328 dùng cho máy in Canon LBP 6200, 6200d, 6230dn, MF 4820d, 4412, 4450, 4720w, 4870, mf4750, mf4700, D500, D520, L170,...",118000,118000,0,0
TIKI,laptop-may-vi-tinh-linh-kien,109347126,"[CÓ SẴN CHIP] Hộp mực 107A dùng cho máy in HP 107A/ 107w/ 135A/ M135w/ 137fnw",265000,265000,0,0
TIKI,laptop-may-vi-tinh-linh-kien,2130041,"Bộ Phát Wifi Di Động TP-Link M7350 3G/4G LTE 150Mbps - Hàng Chính Hãng",1999000,1999000,0,0
TIKI,laptop-may-vi-tinh-linh-kien,32246331,"Hộp mực TN 2385, TN 2325 dùng cho máy in Brother HL-L2321D, HL-2361DN, HL-2366DW, MFC-L2701D, MFC-L2701DW (hàng nhập khẩu 100%)",110000,110000,0,0
TIKI,laptop-may-vi-tinh-linh-kien,14469139,"Hộp mực 12A hộp mực Dành Cho máy in Canon 2900 HPQ2612A 1020 M1005 M1010 1018",110000,110000,0,0
TIKI,laptop-may-vi-tinh-linh-kien,7458771,"Hộp mực dùng cho máy in HP 1102 ( 85A)",110000,110000,0,0
TIKI,laptop-may-vi-tinh-linh-kien,173977896,"Ổ cứng Silicon Power 2.5 inch SATA SSD A56 256GB - Hàng chính hãng",655000,655000,0,0
TIKI,laptop-may-vi-tinh-linh-kien,214875385,"Bộ Phát Wifi 3G 4G OLAX WD680 Tốc Độ 150Mb Dùng Sim Tất Cả Nhà Mạng, Nhỏ Gọn Tiện Lợi - Hàng Chính hãng",495000,990000,495000,50
TIKI,laptop-may-vi-tinh-linh-kien,416990,"TP-Link  TL-WN722N - USB Wifi (high gain) tốc độ 150Mbps - Hàng Chính Hãng",165000,165000,0,0
TIKI,laptop-may-vi-tinh-linh-kien,58116278,"RAM Laptop DDR4 Hynix 8GB Bus 3200 - Hàng Nhập Khẩu",495000,616000,121000,20
TIKI,laptop-may-vi-tinh-linh-kien,173164642,"Dây cáp mạng LAN bấm sẵn 2 đầu Cat6 UTP Kingmaster - Hàng chính hãng",65000,65000,0,0
TIKI,laptop-may-vi-tinh-linh-kien,25962819,"Hộp mực 17A (có CHIP) cho máy in HP M102w, M102a, MFP M130fn, MFP M130fw, MFP M130a, MFP M130w ",142000,142000,0,0
TIKI,laptop-may-vi-tinh-linh-kien,419320,"Máy In Laser Đơn Năng Canon LBP 6030 - Hàng chính hãng",2990000,4490000,1500000,33
TIKI,laptop-may-vi-tinh-linh-kien,107058325,"Máy chấm công quét vân tay Deli – màu đen - E3960",799000,1438200,639200,44
TIKI,laptop-may-vi-tinh-linh-kien,6711831,"Hộp mực máy in canon Lbp 6030/ 6030w",116900,116900,0,0
TIKI,laptop-may-vi-tinh-linh-kien,12071716,"Mực In Cho Máy HL-B series Brother TN-B022 Toner - Hàng Chính Hãng",485000,485000,0,0
TIKI,laptop-may-vi-tinh-linh-kien,12404603,"Bộ Phát Wifi Mesh TP-Link Deco M4 AC1200 MU-MIMO (1-pack) - Hàng Chính Hãng",899000,1789000,890000,50
TIKI,laptop-may-vi-tinh-linh-kien,12404568,"Bộ Phát Wifi TP-Link TL-WR820N Chuẩn N 300Mbps - Hàng Chính Hãng",229000,299000,70000,23
TIKI,laptop-may-vi-tinh-linh-kien,8114283,"Máy Scan Canon Lide 400 - Hàng Chính Hãng",3100000,3490000,390000,11
TIKI,laptop-may-vi-tinh-linh-kien,20637413,"Hộp mực máy in 2900, 303 in đẹp, nhập khẩu mới. Là Cartridge, catrich, toner dùng cho máy in Canon LBP 2900, 3000",109000,109000,0,0
TIKI,laptop-may-vi-tinh-linh-kien,575388,"Hộp Đựng Ổ Cứng Di Động HDD Box 2.5 ORICO 2139U3 USB3.0/2.5 Nhựa Trong Suốt - Hàng Chính Hãng",137900,137900,0,0
TIKI,laptop-may-vi-tinh-linh-kien,110055062,"Dây cáp sata 3 dành cho ổ cứng HDD, SSD",10000,10000,0,0
TIKI,laptop-may-vi-tinh-linh-kien,26029837,"Hộp Đựng Ổ Cứng (HDD Box) 2.5" Orico USB 3.0 Nhựa Trong Suốt cho Ổ HDD và SDD - Hàng Chính Hãng",128800,185000,56200,30
TIKI,laptop-may-vi-tinh-linh-kien,171869909,"Dây mạng bấm sẵn chuẩn Cat7 Kingmaster - Hàng chính hãng",100000,100000,0,0
TIKI,laptop-may-vi-tinh-linh-kien,53257028,"Màn Hình Cong Samsung LC27R500FHEXXV 27 inch Full HD (1920x1080) 4ms 60Hz VA - Hàng Chính Hãng",2990000,4590000,1600000,35
TIKI,laptop-may-vi-tinh-linh-kien,66930382,"TOTOLINK - A720R - Router băng tần kép AC1200 - Hàng chính hãng",369000,369000,0,0
TIKI,laptop-may-vi-tinh-linh-kien,79316248,"Ổ Cứng Di Động Gắn Ngoài HDD Seagate ONE TOUCH 2.5 inch USB 3.0 - Hàng Nhập Khẩu",4785000,6090000,1305000,21
TIKI,laptop-may-vi-tinh-linh-kien,11407472,"Bộ Phát Wifi Mesh TP-Link Deco M4 (2-pack)  Băng Tần Kép MU-MIMO AC1200 - Hàng Chính Hãng",1799000,3398000,1599000,47
TIKI,laptop-may-vi-tinh-linh-kien,8095982,"Adapter nguồn đa năng điện áp ra từ 12V-24V",120000,120000,0,0
TIKI,laptop-may-vi-tinh-linh-kien,455445,"Bộ Kích Sóng Wifi Repeater 300Mbps TP-Link TL-WA850RE - Hàng Chính Hãng",239000,239000,0,0
TIKI,laptop-may-vi-tinh-linh-kien,561924,"Kaspersky Internet Security Cho 3 Máy Tính - KIS3U - Hàng Chính Hãng",690000,690000,0,0
TIKI,laptop-may-vi-tinh-linh-kien,187392403,"(Giá Hủy Diệt) Ổ Cứng Di Động SSD Samsung T7 Shield USB 3.2 Gen 2 - Hàng Nhập Khẩu",3135000,3990000,855000,21
TIKI,laptop-may-vi-tinh-linh-kien,47514139,"Cáp mạng Cat6 UTP đúc sẵn 2 đầu dài 1m đến 10m Vention - Hàng chính hãng",29000,55000,26000,47
TIKI,laptop-may-vi-tinh-linh-kien,43932082,"Hộp mực 35A/85A cho HP LaserJet P1005 P1006, Canon 3050, Có lỗ đổ mực, mực thải",119500,119500,0,0
TIKI,laptop-may-vi-tinh-linh-kien,29837913,"Máy In Lazer Đa Năng Trắng Đen Brother DCP-B7535DW (Print, Copy, Scan, Duplex) - Hàng Chính Hãng",5568000,5568000,0,0
TIKI,laptop-may-vi-tinh-linh-kien,72680847,"Bộ mực in phun Brother (BT-D60BK + BT5000C/M/Y)",700000,700000,0,0
TIKI,laptop-may-vi-tinh-linh-kien,190315447,"Phần Mềm Diệt Virus BKAV Pro Internet Security AI (1 năm) - Hàng Chính Hãng",184000,184000,0,0
TIKI,laptop-may-vi-tinh-linh-kien,21237758,"Bộ Phát Wifi Mesh TP-Link Deco M5 AC1300 (3 pack) - Hàng Chính Hãng",3199000,5998000,2799000,47
TIKI,laptop-may-vi-tinh-linh-kien,85682080,"Hộp mực in dùng cho máy HP MFP 1000A/ 1000W, HP 1200A/ 1200W ( W1103A/103A) 103A Black Neverstop Laser Toner - tương thích",99500,99500,0,0
TIKI,laptop-may-vi-tinh-linh-kien,46757834,"Đèn treo màn hình máy tính laptop hiệu Baseus - DGIWK-01 - Hàng nhập khẩu ",467622,467622,0,0
TIKI,laptop-may-vi-tinh-linh-kien,157504855,"Bộ Phát Wifi TP-Link Archer AX53 Chuẩn Wifi 6 Tốc Độ 3000Mbps - Hàng Chính Hãng",1366000,2732000,1366000,50
TIKI,laptop-may-vi-tinh-linh-kien,110948705,"[CÓ SẴN] USB WIFI 5G, tốc độ cao 600Mbps, thu sóng WIFI chuẩn AC cho máy bàn pc laptop - HÀNG NHẬP KHẨU",139000,139000,0,0
TIKI,laptop-may-vi-tinh-linh-kien,12404622,"Bộ Phát Wifi Mesh TP-Link Deco M5 (2-pack)  Băng Tần Kép MU-MIMO AC1300 - Hàng Chính Hãng",2399000,4398000,1999000,45
TIKI,laptop-may-vi-tinh-linh-kien,16308170,"Hộp mực 48A cho máy in HP LaserJet Pro M15a, M28a, M28w",153000,153000,0,0
TIKI,laptop-may-vi-tinh-linh-kien,3831591,"Hộp đựng ổ cứng 2.5" SSD/HDD Orico 2577U3 chuẩn sata 3 cổng USB 3.0 - Hàng Chính Hãng",114000,114000,0,0
TIKI,laptop-may-vi-tinh-linh-kien,77915998,"Ngăn kéo đựng tiền thu ngân RC 407",670000,950000,280000,29
TIKI,laptop-may-vi-tinh-linh-kien,143714177,"USB 128GB Kingston DTX- Hàng chính hãng",342000,342000,0,0
TIKI,laptop-may-vi-tinh-linh-kien,161538112,"Box Ổ Cứng  2.5 Inch Hộp Đựng Ổ Cứng Di Động HDD VINETTEAM USB 3.0 Nhựa Trong Suốt Tốc Độ 5gbs - Hàng Chính Hãng",84000,89000,5000,6
TIKI,laptop-may-vi-tinh-linh-kien,15270539,"Bộ Thu Wifi TP-Link Archer T3U AC1300Mbps - Hàng Chính Hãng",299000,578000,279000,48
TIKI,laptop-may-vi-tinh-linh-kien,29455014,"Bộ 10 Đầu Nối Dây Mạng 1-1",14500,14500,0,0
TIKI,laptop-may-vi-tinh-linh-kien,15352821,"Hộp mực in 80A cho máy in HP LaserJet Pro 400 M401/ MFP M425",168000,168000,0,0
TIKI,laptop-may-vi-tinh-linh-kien,40547505,"Combo Kìm Bấm Hạt Mạng(RJ45+RJ11) + 100 Hạt mạng RJ45 + 100 đầu chụp hạt mạng + Hộp Test mạng",128900,128900,0,0
TIKI,laptop-may-vi-tinh-linh-kien,10001324,"RAM Laptop Samsung 4GB DDR4 2133MHz SODIMM - Hàng Nhập Khẩu",264000,336000,72000,21
TIKI,laptop-may-vi-tinh-linh-kien,764198,"Máy In Laser Đa Năng Brother DCP-L2520D - Hàng Chính Hãng",4600000,4600000,0,0
TIKI,laptop-may-vi-tinh-linh-kien,74311543,"Bộ Phát Wifi Mesh TP-Link Deco E4 (3-pack) Băng Tần Kép MU-MIMO AC1200 - Hàng Chính Hãng",1899000,3499000,1600000,46
TIKI,laptop-may-vi-tinh-linh-kien,51352620,"Bộ thu phát không dây Usb bluetooth 5.0 dùng cho máy tính laptop  D558",36280,36280,0,0
TIKI,laptop-may-vi-tinh-linh-kien,15351084,"Hộp mực in 79A cho máy in HP LaserJet Pro M12a/ M12w/ M26a/ M26nw",118000,118000,0,0
TIKI,laptop-may-vi-tinh-linh-kien,15215426,"Dây nguồn máy tính, dây nguồn PC dài 1.5-2m, dây nguồn lõi đồng tương thích với đồ gia dụng",12000,12000,0,0
TIKI,laptop-may-vi-tinh-linh-kien,121063802,"Bộ Chia Tín Hiệu 5 Cổng Mercusys MS105 (10/100Mbps) - Hàng Chính Hãng",129000,149000,20000,13
TIKI,laptop-may-vi-tinh-linh-kien,182308659,"USB Hikvision M200 8G - Hàng chính hãng",79000,79000,0,0
TIKI,laptop-may-vi-tinh-linh-kien,21056582,"Hạt mạng RJ45 Golden Japan (100 hạt chân đồng) - Hàng Nhập Khẩu",71900,71900,0,0
TIKI,laptop-may-vi-tinh-linh-kien,16138710,"Đầu bấm mạng RJ45 loại thường (Bịch 100 hạt mạng )",21000,28000,7000,25
TIKI,laptop-may-vi-tinh-linh-kien,42126872,"Combo 50 cuộn giấy in hóa đơn, giấy in nhiệt, in bill K80, phi 45",258000,264500,6500,2
TIKI,laptop-may-vi-tinh-linh-kien,15668735,"Ổ đĩa dvd rời cho laptop, desktop, máy tính bàn, ổ đĩa quang dvd rw gắn ngoài qua cổng USB hỗ trợ đọc, ghi đĩa dvd, cd không kén đĩa.",275000,320000,45000,14
TIKI,laptop-may-vi-tinh-linh-kien,12404601,"Bộ Phát Wifi Mesh TP-Link Deco M4 (3-pack)  Băng Tần Kép MU-MIMO AC1200 - Hàng Chính Hãng",2899000,4998000,2099000,42
TIKI,laptop-may-vi-tinh-linh-kien,63140411,"Ổ Cứng Di Động SSD Samsung T7 NON Touch USB Type C - Hàng Nhập Khẩu - 500GB",2145000,2730000,585000,21
TIKI,laptop-may-vi-tinh-linh-kien,58677681,"N200RE_V5 - Mini Router Wi-Fi chuẩn N 300Mbps",220000,220000,0,0
TIKI,laptop-may-vi-tinh-linh-kien,9845151,"Hộp mực máy in HP 85a (Cartridge, catrich, toner 85a, 1102, 1212, 1132)",116500,116500,0,0
TIKI,laptop-may-vi-tinh-linh-kien,8114282,"Máy Scan Canon Lide 300 - Hàng Chính Hãng",1990000,2490000,500000,20
TIKI,laptop-may-vi-tinh-linh-kien,25206026,"Bộ Phát Wifi Mesh TP-Link Deco E4 (2-pack) Băng Tần Kép MU-MIMO AC1200 - Hàng Chính Hãng",1299000,1999000,700000,35
TIKI,laptop-may-vi-tinh-linh-kien,26315122,"Ổ Cứng Di Động HDD WD My Passport Ultra 2TB - Hàng Nhập Khẩu",2739000,3486000,747000,21
TIKI,laptop-may-vi-tinh-linh-kien,58667989,"Giấy in nhiệt K80 x 45mm thùng 100 cuộn",390000,390000,0,0
TIKI,laptop-may-vi-tinh-linh-kien,165588636,"Bộ lưu điện UPS CyberPower BU1000EA 1000VA / 630W - Tích hợp công nghệ ổn áp AVR, Công nghệ tiết kiện điện GreenPower, công nghệ Line Interactive - Hàng chính hãng",1799000,2250000,451000,20
TIKI,laptop-may-vi-tinh-linh-kien,459739,"Brother BT5000Y Ink Cho DCP-T300/T700W/MFC-T800W (Vàng) - Hàng Chính Hãng",146000,146000,0,0
TIKI,laptop-may-vi-tinh-linh-kien,26274900,"Màn Chiếu 3 Chân Apollo 100 inch - Hàng chính hãng",710000,710000,0,0
TIKI,laptop-may-vi-tinh-linh-kien,143211193,"Drum Brother DR-B022 dùng cho máy B-Series  - Hàng Chính Hãng",635000,635000,0,0
TIKI,laptop-may-vi-tinh-linh-kien,21337589,"Bộ chia 4 cổng USB 3.0 dạng kẹp vỏ nhôm MH4PU",254900,254900,0,0
TIKI,laptop-may-vi-tinh-linh-kien,46634155,"Dây Cáp Mạng Cat6 Bấm Sẵn 2 đầu",17000,19750,2750,14
TIKI,laptop-may-vi-tinh-linh-kien,110736166,"Dây cáp mạng đúc sẵn 2 đầu Cat 7 Vention dạng dẹt dài 1m - 10m hỗ trợ tốc độ 10Gbps/s",90000,145000,55000,38
TIKI,laptop-may-vi-tinh-linh-kien,7857797,"Khay Ổ Cứng Caddy Bay 9.5mm Siêu Mỏng (Gắn Ổ Cứng Thay Ổ Quang Laptop)",28650,28650,0,0
TIKI,laptop-may-vi-tinh-linh-kien,456521,"TP-Link  Archer C20 - Router Băng Tần Kép Không Dây AC750 - Hàng Chính Hãng",450000,450000,0,0
TIKI,laptop-may-vi-tinh-linh-kien,24366737,"Ổ cứng HDD 500G Seagate SATA - Hàng nhập khẩu - Tặng cáp dữ liệu SATA 3.0",349000,349000,0,0
TIKI,laptop-may-vi-tinh-linh-kien,174029994,"USB Kingston 64GB DataTraveler Exodia(DTX/64GB) - Hàng chính hãng",199000,199000,0,0
TIKI,laptop-may-vi-tinh-linh-kien,263580244,"Màn hình máy tính AOC 27B1H2 (27"/FHD/IPS/100Hz/4ms/ AOC 27B1H -2) - Hàng chính hãng",2899000,2899000,0,0
TIKI,laptop-may-vi-tinh-linh-kien,1582161,"Bộ Phát Wifi Di Động 4G LTE TP-Link M7200 150Mbps - Hàng Chính Hãng",1599000,1599000,0,0
TIKI,laptop-may-vi-tinh-linh-kien,55576273,"Dây cáp mạng Ethernet Cat6 Vention, dạng dẹt - hai đầu đúc sẵn UTP, dài 1m đến 15m - Hàng chính hãng",35000,44000,9000,20
TIKI,laptop-may-vi-tinh-linh-kien,95064608,"Box 2020U3 dùng cho ổ cứng 2.5" hàng nhập khẩu",145000,145000,0,0
TIKI,laptop-may-vi-tinh-linh-kien,10001349,"RAM Laptop Samsung 4GB DDR4 2400MHz SODIMM - Hàng Nhập Khẩu",264000,336000,72000,21
TIKI,laptop-may-vi-tinh-linh-kien,16387290,"RAM PC DDR3L Samsung 8GB Bus 1600 - Hàng Nhập Khẩu",418000,600000,182000,30
TIKI,laptop-may-vi-tinh-linh-kien,67619329,"KEO Tản Nhiệt Cooler Master Mastergel Pro V2 - Hàng Chính Hãng",89000,99000,10000,10
TIKI,laptop-may-vi-tinh-linh-kien,134607384,"USB 3.0 Sandisk CZ600 Cruzer Glide - Hàng Nhập Khẩu",230000,230000,0,0
TIKI,laptop-may-vi-tinh-linh-kien,7130317,"Card mạng USB Wireless mini 150Mbps TENDA 311MI - Hàng Chính Hãng",115000,115000,0,0
TIKI,laptop-may-vi-tinh-linh-kien,120462061,"Bộ Test Cáp Mạng (tặng kèm pin) - Hộp Kiểm Tra Dây Mạng - RJ45",42900,42900,0,0
TIKI,laptop-may-vi-tinh-linh-kien,153547112,"Bộ Phát Wifi TP-Link Archer AX55 Chuẩn Wi-Fi 6 AX3000 - Hàng Chính Hãng",1499000,2932000,1433000,49
TIKI,laptop-may-vi-tinh-linh-kien,34979704,"Màn chiếu treo tường Apollo – Hàng chính hãng",520000,520000,0,0
TIKI,laptop-may-vi-tinh-linh-kien,14606621,"Keo Tản Nhiệt ARCTIC MX4 - 4g  (2020) - Hàng Chính Hãng",69000,69000,0,0
TIKI,laptop-may-vi-tinh-linh-kien,121064379,"Bộ Chia Tín Hiệu Switch Để Bàn Mercusys MS105G 5 Cổng 10/100/1000 Mbps - Hàng Chính Hãng",239000,439000,200000,46
TIKI,laptop-may-vi-tinh-linh-kien,142782679,"Kaspersky Antivirus 1 year 1 PC - Hàng chính hãng",190000,190000,0,0
TIKI,laptop-may-vi-tinh-linh-kien,76198752," Router Wifi Chuẩn N 300Mbps TP-Link TL-WR844N  - Hàng Chính Hãng",269000,498000,229000,46
TIKI,laptop-may-vi-tinh-linh-kien,20580167,"Hộp mực TN 2380, 2385 mới dùng cho máy in Brother HL L2320D, 2321D, 2340DW,...",115000,115000,0,0
TIKI,laptop-may-vi-tinh-linh-kien,188947985,"Hộp mực cho máy in HP 135a / 135w (có chip) hàng nhập khẩu - Dành cho máy in HP Laser MFP 135a  / 135w - Cartridge 107A / W1107A mới 100% [Full Box]",180000,180000,0,0
TIKI,laptop-may-vi-tinh-linh-kien,113331097,"Bộ mực in phun Brother BT5000C/Y/M - Hàng chính hãng",480000,480000,0,0
TIKI,laptop-may-vi-tinh-linh-kien,56305761,"Router Wi-Fi TP-LINK Băng tần kép, Tốc độ cao TP-LINK Archer C50 - Hàng chính hãng ",480000,480000,0,0
TIKI,laptop-may-vi-tinh-linh-kien,67235516,"Hộp Đựng Ổ Cứng ORICO 2526C3-BK (Đen) 2.5"" SSD/HDD SATA 3 USB 3.1 Type-C Hàng Chính Hãng",235000,235000,0,0
TIKI,laptop-may-vi-tinh-linh-kien,134559638,"USB SanDisk CZ73 Ultra Flair - USB 3.0 - Hàng Chính Hãng",149000,149000,0,0
TIKI,laptop-may-vi-tinh-linh-kien,27579312,"Hộp mực dùng cho máy in canon MF3010, LBP 6030/ 6030w",116500,116500,0,0
TIKI,laptop-may-vi-tinh-linh-kien,9344705,"Miếng dán bàn phím tiếng Hàn Quốc",24300,39000,14700,38
TIKI,laptop-may-vi-tinh-linh-kien,50231082,"Hộp mực cho Brother TN B022, B020, DCP-B7535dw, HL B2080dw, B2000d, B7715dw. In đậm, đẹp, là toner cho máy in laser trắng đen",109000,109000,0,0
TIKI,laptop-may-vi-tinh-linh-kien,16293310,"Hộp mực 17A cho máy in HP M102w, MFP M130fn, MFP M130fw",142000,142000,0,0
TIKI,laptop-may-vi-tinh-linh-kien,16605218,"Hộp mực in laser dành cho canon 2900 ( có lỗ đổ mực ) ",115500,115500,0,0
TIKI,laptop-may-vi-tinh-linh-kien,35603100,"Ổ Cứng SSD Samsung 970 EVO PLUS 2TB M2 2280 PCIe NVMe - Hàng Nhập Khẩu",4169000,5446000,1277000,23
TIKI,laptop-may-vi-tinh-linh-kien,107579921,"Sạc laptop Dành Cho Dell chân kim to 19.5V - 4.62A - 90W kèm dây nguồn",159000,159000,0,0
TIKI,laptop-may-vi-tinh-linh-kien,16106838,"Set 20 cuộn Giấy in nhiệt, in hóa đơn, in bill K57 phi 45 (hàng nhập khẩu)",82000,84000,2000,2
TIKI,laptop-may-vi-tinh-linh-kien,184126135,"Box gắn HDD Unitek S112ABK Chuẩn Sata 2.5 - Usb 3.0 - Hàng chính hãng",199000,199000,0,0
TIKI,laptop-may-vi-tinh-linh-kien,171233466,"Mực nạp dành cho máy in - Brother 2240/2270 (80g)",29000,29000,0,0
TIKI,laptop-may-vi-tinh-linh-kien,22555481,"Box ổ cứng 2.5 inch SATA USB 3.0 2577U3",114000,114000,0,0
TIKI,laptop-may-vi-tinh-linh-kien,97829401," Ổ Cứng Di Động WD Elements SE 2TB 2.5 USB 3.0 - Hàng Chính Hãng",2290000,2790000,500000,18
TIKI,laptop-may-vi-tinh-linh-kien,20858273,"Sạc dành cho laptop DELL 19.5V - 3.34A, 65W, Chân Kim To",178995,178995,0,0
TIKI,laptop-may-vi-tinh-linh-kien,207253074,"Màn hình VSP - Màu trắng - Full viền - Chất lượng cao - Hàng chính hãng",1795500,1890000,94500,5
TIKI,laptop-may-vi-tinh-linh-kien,465219,"Thiết Bị Phát Wifi Di Động 4G LTE-Advanced TP-Link M7350 150Mbps - Hàng Chính Hãng",1550000,1550000,0,0
TIKI,laptop-may-vi-tinh-linh-kien,20393324,"Đầu Nối Dây Mạng RJ45 ( 5 Cái )",8500,8500,0,0
TIKI,laptop-may-vi-tinh-linh-kien,63183906,"Ổ Cứng Di Động HDD WD My Passport Ultra 5TB - Hàng Nhập Khẩu",4389000,5586000,1197000,21
TIKI,laptop-may-vi-tinh-linh-kien,86297296," Đế giá đỡ quạt tản hút nhiệt laptop máy tính bền tốt - quạt tản nhiệt to chạy êm làm mát cực nhanh",111500,111500,0,0
TIKI,laptop-may-vi-tinh-linh-kien,51987865,"Hộp mực 48A cho máy in HP M15a, M15w, M28a, M28w,...CF 248A",153000,153000,0,0
TIKI,laptop-may-vi-tinh-linh-kien,171233483,"Khay giấy vào dành cho Canon 2900 - 3000",48000,48000,0,0
TIKI,laptop-may-vi-tinh-linh-kien,46178917,"USB mạng Wi-Fi băng tần kép - Archer T2U Nano - TP-Link T2U Nano - Bộ chuyển đổi USB Wi-Fi Nano AC600 - Hàng Chính Hãng",237000,237000,0,0
TIKI,laptop-may-vi-tinh-linh-kien,32118160,"USB Thu Wifi 150Mbps Chuẩn 802.11n Cho Máy Tính Có Anten - Hàng Chính Hãng",56399,56399,0,0
TIKI,laptop-may-vi-tinh-linh-kien,185174097,"Màn hình Cong Provision / K-VISION 27 inch - Tấm nền PLS - độ phân giải FUll HD 1920x1080 - Chống Lóa - Tần số 75Hz - Hàng Chính Hãng",2175500,2290000,114500,5
TIKI,laptop-may-vi-tinh-linh-kien,33164951,"Ổ Cứng Di Động HDD WD My Passport Ultra 4TB USB Type C Màu Bạc - Hàng Nhập Khẩu",3839000,4886000,1047000,21
TIKI,laptop-may-vi-tinh-linh-kien,35920722,"Bộ Phát Wifi Mesh Băng Tần Kép TP-Link Deco E4 AC1200 MU-MIMO (3-pack) - Hàng Chính Hãng",1980000,1980000,0,0
TIKI,laptop-may-vi-tinh-linh-kien,97991447,"Mực nạp Brother hàng chính hãng Alphacartridge dành cho hộp mực TN 2280 2385 1010 Máy in HL1111/1511/2321/2340/2360/2361/2240/2280/2380 MFC1601/2701/2720/2740/7060/7360",32800,32800,0,0
TIKI,laptop-may-vi-tinh-linh-kien,140834291,"Windows 10 Pro 64-bit Eng Intl 1pk DSP OEI DVD - Hàng Chính Hãng",2750000,2950000,200000,7
TIKI,laptop-may-vi-tinh-linh-kien,149485922,"Hệ Thống Wifi Mesh Mercusys Halo H50G Dành Cho Gia Đình Chuẩn AC1900 - Hàng Chính Hãng",1499000,1999000,500000,25
TIKI,laptop-may-vi-tinh-linh-kien,456500,"TP-Link  TL-SG1008D - Switch Để Bàn 8 Cổng  - Hàng Chính Hãng",466000,599000,133000,22
TIKI,laptop-may-vi-tinh-linh-kien,49275935,"Máy in nhiệt mini TMĐT Shoptida in không cần mực, in đơn vận chuyển, bill thanh toán, in tem nhãn, mini code, bar code, mã vạch tốc độ in 1s/đơn, in xong có thể dán đơn ngay - Hàng chính hãng",1479000,1650000,171000,10
TIKI,laptop-may-vi-tinh-linh-kien,14380739,"Hộp mực Samsung MLTD101, Samsung ML-2160/2161/2164/2165/2165W; SCX-3401/3450FW/3406 - Hàng nhập khẩu",215000,215000,0,0
TIKI,laptop-may-vi-tinh-linh-kien,91258445,"Máy in phun màu đa năng Brother DCP-T720DW - Hàng chính hãng",5900000,5900000,0,0
TIKI,laptop-may-vi-tinh-linh-kien,52105812,"Cụm trống (Drum) Brother DR-2385 - Dùng cho các dòng máy in Brother HL(L2321D;L2361DN;L2366DW); MFC(L2520D;L2701D;L2701DW)",177000,177000,0,0
TIKI,laptop-may-vi-tinh-linh-kien,14235571,"Cáp mạng đúc sẵn Cat5 UTP hàng chính hãng Vention VAP-A10",29000,50000,21000,42
TIKI,laptop-may-vi-tinh-linh-kien,66779679,"10 cuộn giấy in nhiệt, in bill, in hóa đơn (thermal paper) TOPCASH K80mm phi 45mm dùng cho máy in nhiệt in hóa đơn, máy tính tiền. Hàng chính hãng",72000,80000,8000,10
TIKI,laptop-may-vi-tinh-linh-kien,21446830,"Sạc dành cho Laptop ACER 19V - 3.42A-65W",145500,165000,19500,12
TIKI,laptop-may-vi-tinh-linh-kien,40925775,"Combo 3 xilanh keo tản nhiệt loại to",29900,29900,0,0
TIKI,laptop-may-vi-tinh-linh-kien,71062970,"Màn hình Dell S2421HN 23.8 inch IPS 75Hz - Hàng Chính hãng",3300000,3300000,0,0
TIKI,laptop-may-vi-tinh-linh-kien,17904891,"Hộp mực TN 2385 dùng cho máy in Brother HL-L2320D/ 2321D/ 2340DW",115000,115000,0,0
TIKI,laptop-may-vi-tinh-linh-kien,75995177,"TP-Link M7000 | Bộ Phát Wi-Fi Di Động 4G LTE 150Mbps | Chính Hãng",980000,980000,0,0
TIKI,laptop-may-vi-tinh-linh-kien,25975534,"Keo Tản Nhiệt Làm Mát CPU - Dạng  Xilanh Nhỏ",4000,7000,3000,43
TIKI,laptop-may-vi-tinh-linh-kien,491431,"Mực In Canon PG-47 Cho Máy In Canon Pixma E400, E410, E460, E480 - Hàng Chính Hãng",290000,290000,0,0
TIKI,laptop-may-vi-tinh-linh-kien,103791477,"Màn hình LG 27UP850-W 27 Inch UHD 4K IPS/ HDR/USB Type-C - Hàng chính hãng",9590000,11990000,2400000,20
TIKI,laptop-may-vi-tinh-linh-kien,10566733,"Combo DVD Gắn Ngoài (Gồm Box + DVD) To USB 2.0 (Đọc, Ghi CD - DVD) – Hàng Nhập Khẩu",265000,320000,55000,17
TIKI,laptop-may-vi-tinh-linh-kien,491362,"Bộ Phát Wifi 4G LTE TP-Link TL-MR6400 Chuẩn N 300Mbps - Hàng Chính Hãng",1334000,1399000,65000,5
TIKI,laptop-may-vi-tinh-linh-kien,6539103,"Router Wifi Băng Tần Kép TP-Link Archer C6 Gigabit AC1200 MU-MIMO - Hàng Chính Hãng",589000,629000,40000,6
TIKI,laptop-may-vi-tinh-linh-kien,44012841,"RAM Laptop Samsung 16GB DDR4 Bus 3200 - Hàng Nhập Khẩu",1045000,1344000,299000,22
TIKI,laptop-may-vi-tinh-linh-kien,120533324,"Máy Quét Mã Vạch Deli Chính Hãng - Kết Nối Bluetooth, Độ Phân Giải Cao - Phù Hợp Cho Bán Hàng E14953W / E14953 / E14952",1025000,1962000,937000,48
TIKI,laptop-may-vi-tinh-linh-kien,763594,"Máy In Laser Đơn Năng Brother HL-L2361DN - Hàng Chính Hãng",3700000,3700000,0,0
TIKI,laptop-may-vi-tinh-linh-kien,8398179,"Khay Ổ Cứng Caddy Bay SATA 12.7mm Dày (Gắn Thêm Ổ Cứng Cho Laptop)",31440,31440,0,0
TIKI,laptop-may-vi-tinh-linh-kien,96707403,"Hộp mực 12A Canon 2900 Hộp mực dành cho máy in Canon 2900/3000 HP  Laser Jet 1010/1015/1020/3015/3020/3030/3050",114500,114500,0,0
TIKI,laptop-may-vi-tinh-linh-kien,98232983,"Hộp mực in laser CF230A dùng cho máy in HP M203dn/ M203dw/ M227fdw/ M227sdn/M227fdn Canon LBP 160 Series, 161DN, 162dw, MF266DN, MF269DW",142000,142000,0,0
TIKI,laptop-may-vi-tinh-linh-kien,138315900,"Giấy In Bill K80 - Giấy In Nhiệt K80 Đường Kính 80mm - Pos Ocha",14400,14400,0,0
TIKI,laptop-may-vi-tinh-linh-kien,456503,"TP-Link  TL-SG1016D - Switch Lắp Tủ/Để bàn 16 Cổng Tốc Độ Gigabit - Hàng Chính Hãng",1250000,1250000,0,0
TIKI,laptop-may-vi-tinh-linh-kien,58056491,"Sạc dành cho laptop Lenovo 20V-3.25A Adapter Lenovo (Chuẩn USB)",217000,270000,53000,20
TIKI,laptop-may-vi-tinh-linh-kien,58669073,"Hộp mực Brother TN2385 dùng cho máy in HL-L2321D, HL-2361DN, HL-2366DW, DCP-L2520D, MFC-L2701D, MFC-L2701DW - Hàng Chính Hãng",480000,480000,0,0
TIKI,laptop-may-vi-tinh-linh-kien,74775970,"Giá đỡ Coolmoon chống xệ cong chân VGA cho máy tính - hàng nhập khẩu",95000,95000,0,0
TIKI,laptop-may-vi-tinh-linh-kien,78971647,"Hộp mực HP 76A (CF276A) KHÔNG CHIP cho máy in HP Pro M404dn / M404DW / M428dnw",178500,178500,0,0
TIKI,laptop-may-vi-tinh-linh-kien,165667261,"Bộ lưu điện UPS CyberPower BU600E - 600VA / 360W -  Tích hợp công nghệ ổn áp AVR, Công nghệ tiết kiện điện GreenPower, công nghệ Line Interactive - Hàng chính hãng",819000,1050000,231000,22
TIKI,laptop-may-vi-tinh-linh-kien,174056847,"Combo 03 ống mực 103A dùng cho máy in HP Neverstop MFP 1200w/ 1200A/ 1000W/ 1000A",295000,295000,0,0
TIKI,laptop-may-vi-tinh-linh-kien,141356532,"Dock Ổ Cứng 3.5 / 2.5 USB 3.0 - Biến HDD Thường Thành HDD Di Động - Dock Nguồn Cáp",120000,120000,0,0
TIKI,laptop-may-vi-tinh-linh-kien,10387236,"Máy in nhãn cầm tay Brother PT-E110, máy in nhãn cáp, nhãn dây điện, mạng - Hàng chính hãng",845000,845000,0,0
TIKI,laptop-may-vi-tinh-linh-kien,68828151,"Bộ Phát Sóng WiFi Xiaomi Router 4A Siêu Mạnh 2 Băng Tần 2.4G 5G AC1200 - Hàng Chính Hãng",420000,490000,70000,14
TIKI,laptop-may-vi-tinh-linh-kien,56986166,"Dây cáp mạng CAT7 AMPCOM 2 đầu bấm sẵn, dạng dẹt, vỏ bện dù, dài 1m-15m - Hàng chính hãng",99000,159000,60000,38
TIKI,laptop-may-vi-tinh-linh-kien,171796455,"Ram máy tính Gskill Aegis DDR4 8GB 2666 - Hàng chính hãng",471000,471000,0,0
TIKI,laptop-may-vi-tinh-linh-kien,21477056,"Hộp đựng ổ cứng 2,5" SSD/HDD SATA 3 Orico (HDD Box 2,5" USB 3.0) - Hàng Nhập Khẩu",124000,124000,0,0
TIKI,laptop-may-vi-tinh-linh-kien,25763044,"Hộp Đựng Ổ Cứng HDD 5 Khay Orico 3.5'' USB 3.0 DS500U3 - Hàng Chính Hãng",3107000,3107000,0,0
TIKI,laptop-may-vi-tinh-linh-kien,15673876,"Ổ đĩa dvd rw gắn ngoài qua cổng usb 3.0 dùng cho laptop, desktop, máy tính bàn hỗ trợ đọc ghi đĩa dvd, cd tốc độ cao không kén đĩa.",350000,350000,0,0
TIKI,laptop-may-vi-tinh-linh-kien,16397909,"RAM PC DDR4 Samsung 8GB Bus 2400 - Hàng Nhập Khẩu",484000,616000,132000,21
TIKI,laptop-may-vi-tinh-linh-kien,117200363,"Đèn treo màn hình máy tính bảo vệ mắt Baseus i-work Series (Fighting) Pro - Hàng chính hãng",559021,559021,0,0
TIKI,laptop-may-vi-tinh-linh-kien,82938550,"Pin TBL-71A2000 Thay Thế Cho Các Bộ Phát Wifi TP-Link M5250, M5350, M7350 (V5 trở lên), M7300, M7000, M7200",269000,279000,10000,4
TIKI,laptop-may-vi-tinh-linh-kien,509716,"Brother DR-2385 Drum Cho Máy In HL-L2321D, HL-2361DN, HL-2366DW, MFC-L2701D, MFC-L2701DW - Hàng Chính Hãng",700000,700000,0,0
TIKI,laptop-may-vi-tinh-linh-kien,21089128,"Bộ Thu Wifi USB TP-Link TL-WN722N Chuẩn N 150Mbps - Hàng Chính Hãng",159000,279000,120000,43
TIKI,laptop-may-vi-tinh-linh-kien,78965941,"Card WIFI Intel WIFI 6E AX210 sử dụng cho laptop hỗ trợ 3 băng tần tích hợp Bluetooth 5.2 - Hàng nhập khẩu",480000,480000,0,0
TIKI,laptop-may-vi-tinh-linh-kien,54754719,"Mực in HP 107A Black Original Laser Toner Crtg (Máy in HP 107w/135w)_ W1107A – Hàng Chính Hãng",1384000,1384000,0,0
TIKI,laptop-may-vi-tinh-linh-kien,74857633,"Bộ Mở Rộng Sóng Wifi TP-Link RE205 Băng Tần Kép AC750 - Hàng Chính Hãng",529000,529000,0,0
TIKI,laptop-may-vi-tinh-linh-kien,273395255,"Avast Premium Security (For 1 PC – 1 year)- Hàng chính hãng",155000,155000,0,0
TIKI,laptop-may-vi-tinh-linh-kien,112331214,"Dây cáp mạng Internet, dây lan bấm sẵn 2 đầu dài 1.5m, 3m, 5m Chất Lượng Tốt",6960,6960,0,0
TIKI,laptop-may-vi-tinh-linh-kien,10001367,"RAM Laptop Samsung 4GB DDR4 2666MHz SODIMM - Hàng Nhập Khẩu",275000,350000,75000,21
TIKI,laptop-may-vi-tinh-linh-kien,15335893,"Hộp mực in 2280 cho máy in Brother 2240D, 2250DN, 2270DW, 7050, 7060D, 7360, 7470DN, 7860DW.",115000,115000,0,0
TIKI,laptop-may-vi-tinh-linh-kien,171233775,"Mực đổ dành cho máy in - Loại in đậm và siêu nét canon 2900,3300,3050....Hp 400,2035,2055,402",25000,25000,0,0
TIKI,laptop-may-vi-tinh-linh-kien,7735717,"Adapter Nguồn Màn Hình Máy Tính Samsung 14V - 3A - Kèm Dây Nguồn",112000,112000,0,0
TIKI,laptop-may-vi-tinh-linh-kien,42561598,"Hộp Mực Premium TN-1010 Cho Máy In Brother HL-1111/ DCP1511/ MFC1811 - Hàng Nhập Khẩu",109000,109000,0,0
TIKI,laptop-may-vi-tinh-linh-kien,170338346,"Màn hình máy tính Dell UltraSharp U2723QE ( 27 inch IPS Black (3840 x 2160) 60Hz / 8ms / DP 1.4 / HDMI 2.2 / USB-C 3.2 Gen 2 / Jack Audio / Network ) - Hàng Chính Hãng",14390000,14390000,0,0
TIKI,laptop-may-vi-tinh-linh-kien,91191518,"Đầu bấm mạng Cat 6 trong suốt UGREEN NW120 - Hàng Chính Hãng",168000,168000,0,0
TIKI,laptop-may-vi-tinh-linh-kien,34159103,"Bàn Phím Bluetooth cho điện thoại, máy tính bảng, iphone, ipad thông minh",124400,124400,0,0
TIKI,laptop-may-vi-tinh-linh-kien,1823413,"Khay Ổ Cứng Máy Bàn Caddy Bay Orico 1106SS Sata III - Hàng Chính Hãng",265000,265000,0,0
TIKI,laptop-may-vi-tinh-linh-kien,55662979,"Giấy in nhiệt K80 x 80mm thùng 50 cuộn",985000,985000,0,0
TIKI,laptop-may-vi-tinh-linh-kien,110958103,"Đầu nối dây mạng lan RJ45",3800,3800,0,0
TIKI,laptop-may-vi-tinh-linh-kien,101901207,"TOTOLINK A650USM - USB Wi-Fi mini băng tần kép AC650 Hàng chính hãng",219000,245000,26000,11
TIKI,laptop-may-vi-tinh-linh-kien,13644564,"Hộp mực 49A dùng  cho Canon LBP 3300",197000,197000,0,0
TIKI,laptop-may-vi-tinh-linh-kien,8089082,"Cáp Chuyển Đổi Kết Nối Ổ Cứng HDD Từ USB 3.0 Sang Sata 22 Pin 2.5 Inch",75800,75800,0,0
TIKI,laptop-may-vi-tinh-linh-kien,52054902,"Hộp mực 26A - Hộp mực HP M402d, M402n, M402dn, M426dw, M426dw,...CF 226A ",169000,169000,0,0
TIKI,laptop-may-vi-tinh-linh-kien,113395502,"SẠC DÀNH CHO LAPTOP HP ĐẦU KIM NHỎ (vòng tròn xanh) SIZE 4.5 mm * 3.0 mm for Hp Envy.",173000,173000,0,0
TIKI,laptop-may-vi-tinh-linh-kien,8637995,"Màng ép dẻo khổ Bằng Lái (50 tờ/ xấp)",210000,210000,0,0
TIKI,laptop-may-vi-tinh-linh-kien,77105849,"SSD Samsung PM9A1 M2 PCIe 4.0 - Hàng Nhập Khẩu",2519000,3206000,687000,21
TIKI,laptop-may-vi-tinh-linh-kien,16079316,"[Set 20 cuộn] Giấy nhiệt in bill K80 phi 80 - Hàng nhập khẩu",358900,358900,0,0
TIKI,laptop-may-vi-tinh-linh-kien,195656317,"Mực in 4 màu 003 cho máy in Epson L1110/ L3110/ L3150/ L4150/ L1110 Hàng nhập khẩu",80000,80000,0,0
TIKI,laptop-may-vi-tinh-linh-kien,556922,"Màn Hình Cong SamSung LC24F390FHEXXV 24inch FullHD 4ms 60Hz FreeSync VA - Hàng Chính Hãng",2390000,2390000,0,0
TIKI,laptop-may-vi-tinh-linh-kien,129710044,"Máy in Laser Brother HL-L2366DW (kết nối Wifi)- Hàng chính hãng",3790000,3790000,0,0
TIKI,laptop-may-vi-tinh-linh-kien,76030024,"Bộ Chuyển Đổi USB Wifi TP-Link Archer T2U Nano Băng Tần Kép AC600 - Hàng Chính Hãng",225000,225000,0,0
TIKI,laptop-may-vi-tinh-linh-kien,17611683,"KÌM MẠNG ĐA NĂNG HT-022 TÍCH HỢP BẤM+TEST RJ11-RJ12-RJ45 TOOL TEST",488300,514000,25700,5
TIKI,laptop-may-vi-tinh-linh-kien,700901,"Phần Mềm Diệt Virus Bitdefender Internet Security BIS - Hàng Chính Hãng",174000,290000,116000,40
TIKI,laptop-may-vi-tinh-linh-kien,11194805,"Ổ Cứ́ng SSD Samsung 970 EVO PLUS 1TB M2 2280 PCIe NVMe MZ- V7S1T0BW - Hàng Nhập Khẩu",2805000,3570000,765000,21
TIKI,laptop-may-vi-tinh-linh-kien,156450117,"Ổ Cứng SSD WD Black SN750 NVME M.2 2280 - Hàng Nhập Khẩu - SE",1309000,1380000,71000,5
TIKI,laptop-may-vi-tinh-linh-kien,575519,"HDD Box ORICO USB3.0/3.5/2.5 6228US3-C Hàng Chính Hãng",629000,629000,0,0
TIKI,laptop-may-vi-tinh-linh-kien,2302081,"USB 3.1 SanDisk CZ430 Ultra Fit 32GB 130MB/s - Hàng Chính Hãng",179000,179000,0,0
TIKI,laptop-may-vi-tinh-linh-kien,50772516,"Dây cáp mạng dẹt Ethernet/RJ45/LAN Vention Cat 8 FTP đúc sẵn 2 đầu, dài 1m đến 5m - Hàng chính hãng",110000,150000,40000,27
TIKI,laptop-may-vi-tinh-linh-kien,2902221,"Máy In Phun Màu Canon Pixma G2010 - Hàng Chính Hãng",3590000,4290000,700000,16
TIKI,laptop-may-vi-tinh-linh-kien,82842188,"Combo Cụm drum DR2385 và Hộp mực TN2385 cho máy in Brother MFC L2701D, L2701DW, HL L2321D, L2361DN, L2366DW, DCP L2520D chất lượng",357000,357000,0,0
TIKI,laptop-may-vi-tinh-linh-kien,32308294,"Keo tản nhiệt CPU hình ống chích (1 ống )",11200,11200,0,0
TIKI,laptop-may-vi-tinh-linh-kien,203213313,"(Giá Hủy Diệt) Ổ Cứng gắn trong HDD Western Digital Ultrastar 20TB / 22TB SATA iii 3.5 inch cho Serve dòng Enterprise - Hàng Nhập Khẩu",5665000,7210000,1545000,21
TIKI,laptop-may-vi-tinh-linh-kien,6909331,"Bộ Kích Sóng Wifi Repeater Băng Tần Kép AC750 TP-Link RE200 - Hàng Chính Hãng",420000,420000,0,0
TIKI,laptop-may-vi-tinh-linh-kien,67991056,"Bộ Phát Wifi 4G LTE Tenda 4G03 Chuẩn N300 Có Cổng Lan Băng Thông Mạnh Tặng Cáp Mạng - Hàng Chính Hãng",950000,950000,0,0
TIKI,laptop-may-vi-tinh-linh-kien,192010844,"Mực Chai 107A Dùng nạp cho Hộp mực máy in HP 107a/ 107w/ 135a/ 135w",30000,30000,0,0
TIKI,laptop-may-vi-tinh-linh-kien,191689321,"Ổ cứng di động SSD Samsung T7 Shield 1TB | 2TB USB Type C 3.2 Gen 2 kháng nước chống bụi - Hàng chính hãng",3990000,5900000,1910000,32
TIKI,laptop-may-vi-tinh-linh-kien,82842177," Combo Hộp mực 12A Có lỗ đổ mực, Chai mực nạp, phễu tiện lợi, tiết kiệm dùng cho máy in Canon 2900, Hp 1020",178100,178100,0,0
TIKI,laptop-may-vi-tinh-linh-kien,97092868,"Trống Drum Brother 2280 2385 2361 2255 2250 2325 2360 2260 dành cho Máy in HL 2130/2240 MFC 7060/7360/7860",56300,56300,0,0
TIKI,laptop-may-vi-tinh-linh-kien,76558697,"Máy quét mã vạch 1D 2D cầm tay Bluetooth S20-2DWGB",679000,739000,60000,8
TIKI,laptop-may-vi-tinh-linh-kien,181361806,"Bộ Chuyển Đổi Mạng USB 3.0 Sang Ethernet TP-Link UE306 Tốc Độ Gigabit 1000Mbps - Hàng Chính Hãng",229000,399000,170000,43
TIKI,laptop-may-vi-tinh-linh-kien,459629,"Mực In Brother BT5000C Ink Cho DCP-T300/T700W/MFC-T800W (Xanh lục) - Hàng Chính Hãng",148000,148000,0,0
TIKI,laptop-may-vi-tinh-linh-kien,416911,"TP-Link  TL-WN823N - USB Wifi chuẩn N tốc độ 300Mbps - Hàng Chính Hãng",149000,259000,110000,42
TIKI,laptop-may-vi-tinh-linh-kien,26218947,"Dây mạng bấm sẵn 2 đầu cat5e 5M (màu ngẫu nhiên)",17900,17900,0,0
TIKI,laptop-may-vi-tinh-linh-kien,104108938,"Đầu cắm nguồn dành cho sạc Macbook, Macbook Air, Macbook Pro (dạng 2 chấu chân dẹt)",29000,29000,0,0
TIKI,laptop-may-vi-tinh-linh-kien,10827914,"Cuộn Dây Cáp Mạng Cat6e LBLink - 305m - Hàng chính hãng",570000,570000,0,0
TIKI,laptop-may-vi-tinh-linh-kien,150672784,"Hộp mực dùng cho máy in HP 107a/ 107w/ 135a/ 135w / 137a / 137w ( Mã mực W1107A )",259000,259000,0,0
TIKI,laptop-may-vi-tinh-linh-kien,74547151,"Bộ Phát Wifi TP-Link Archer C24 Băng Tần Kép AC750 - Hàng Chính Hãng",414000,414000,0,0
TIKI,laptop-may-vi-tinh-linh-kien,544992,"D-Link DWA-131 - USB Wifi chuẩn N 300Mbps - Hàng Chính Hãng",169000,169000,0,0
TIKI,laptop-may-vi-tinh-linh-kien,62635676,"Cáp mạng Cat5e Commscope UTP - Hàng Chính hãng",2398000,2398000,0,0
TIKI,laptop-may-vi-tinh-linh-kien,51729979,"Máy in Laser trắng đen HP 107w (4ZB78A) - Hàng Chính Hãng",3190000,3190000,0,0
TIKI,laptop-may-vi-tinh-linh-kien,25184004,"Kìm Bấm Mạng Đa Năng (màu xanh) - Thuộc Sản Phẩm Thiết Bị Mạng",42900,42900,0,0
TIKI,laptop-may-vi-tinh-linh-kien,95564265,"Hộp mực 17A dành cho máy in HP LaserJet Pro M102a,M102w,M130a,M130nw,M130Fn,M130fw",139700,139700,0,0
TIKI,laptop-may-vi-tinh-linh-kien,67861239,"Sạc dành cho laptop Asus 19V-3.42A - Vuông - Chân nhỏ 65W",209000,209000,0,0
TIKI,laptop-may-vi-tinh-linh-kien,11094090,"Keo MX-4 - Làm Mát Cho Chipset (CPU) Máy Tính",48000,48000,0,0
TIKI,laptop-may-vi-tinh-linh-kien,173986098,"SSD Silicon Power M.2 2280 SATA A55 128GB - Hàng chính hãng",459000,459000,0,0
TIKI,laptop-may-vi-tinh-linh-kien,121065787,"Bộ Chuyển Đổi USB Wifi MERCUSYS MU6H Băng Tần Kép Độ Lợi Cao AC650 - Hàng Chính Hãng",229000,369000,140000,38
TIKI,laptop-may-vi-tinh-linh-kien,193247921,"Dây Cáp Mạng Kèm Nguồn Cat5e FTP + 2C Golden Japan Bọc Bạc Chống Nhiễu - Hàng Chính Hãng (Bán Lẻ Mét)",85000,85000,0,0
TIKI,laptop-may-vi-tinh-linh-kien,53086261,"Hộp mực 30A (CÓ CHÍP) là Cartridge cho máy in HP Pro MFP M227fdn, M203dw, M203dn,..",139500,139500,0,0
TIKI,laptop-may-vi-tinh-linh-kien,14524994,"Hộp Test cáp  mạng + Pin",46300,46300,0,0
TIKI,laptop-may-vi-tinh-linh-kien,15676007,"Cụm drum (trống mực) DR 1010 cho máy in Brother HL- 1111, DCP – 1511, MFC- 1901",168000,168000,0,0
TIKI,laptop-may-vi-tinh-linh-kien,582268,"Totolink N600R - Router Wifi Chuẩn N 600Mbps - Hàng Chính Hãng",450000,450000,0,0
TIKI,laptop-may-vi-tinh-linh-kien,24896690,"Hộp mực Brother TN 2280. Là Toner cho máy in Brother HL 2130, 2240, 2250, 2270, 7060, 7360, 7860",118000,118000,0,0
TIKI,laptop-may-vi-tinh-linh-kien,188954263,"Mực nạp máy in HP 107A hàng nhập khẩu (tặng kèm phễu) -  Dùng cho hộp mực máy in HP 107a, 107w, 135a, 135w, 137fnw - Cartridge 107A - w1107a",27000,27000,0,0
TIKI,laptop-may-vi-tinh-linh-kien,124895610,"Vỏ Hộp đựng ổ cứng 2,5 inch USB 3.0 vỏ nhựa ABS cao cấp (dây liền) UGREEN US221 30847- Chính hãng",199000,215000,16000,7
TIKI,laptop-may-vi-tinh-linh-kien,491455,"Mực In Canon CL-99 Cho Máy In Canon Pixma E560 - Hàng Chính Hãng",510000,510000,0,0
TIKI,laptop-may-vi-tinh-linh-kien,162617728,"Đầu Mạng VP-Link CAT5E Xuyên Thấu RJ45 (100pcs) - Hàng chính hãng",75000,79150,4150,5
TIKI,laptop-may-vi-tinh-linh-kien,205741562,"[CÓ SẴN CHIP] Hộp mực 107A dùng cho máy in HP 107A/ 107w/ 135A/ M135w/ 137fnw",240000,240000,0,0
TIKI,laptop-may-vi-tinh-linh-kien,55658260,"Máy Quét Mã Vạch 1 Tia SMQ-9100 Có Dây",319000,519000,200000,39
TIKI,laptop-may-vi-tinh-linh-kien,75649461,"Hộp mực 79A - cho máy in HP LaserJet Pro M12w / M12a / M26a / M26nw /... - CF279A",123000,123000,0,0
TIKI,laptop-may-vi-tinh-linh-kien,26708071,"Hộp mực dùng cho máy in Canon LBP 161DN/162DW | Mực in CRG051 hàng nhập khẩu chất lượng đã có chíp",145000,145000,0,0
TIKI,laptop-may-vi-tinh-linh-kien,173969491,"Combo 02 ống mực 103A dùng cho máy in HP Neverstop MFP 1200w/ 1200A/ 1000W/ 1000A - Laser torner",199000,199000,0,0
TIKI,laptop-may-vi-tinh-linh-kien,42561568,"Hộp Mực In Premium 26A (HP CF226A)/ Cartridge 052 - Hàng Nhập Khẩu",175000,175000,0,0
TIKI,laptop-may-vi-tinh-linh-kien,19589179,"HỘP MỰC 12A ",115500,115500,0,0
TIKI,laptop-may-vi-tinh-linh-kien,14188608,"Giấy In Ảnh Một Mặt Khổ A3",94000,94000,0,0
TIKI,laptop-may-vi-tinh-linh-kien,10000124,"Mực in Laser đen trắng HP 83A (CF283A) - Dùng cho máy HP M127nf/ M225DW M125/ 125FW/ 125A/ M126/ M127/ M127FN/ M201/ M225MFP",118000,118000,0,0
TIKI,laptop-may-vi-tinh-linh-kien,16078955,"[ Set 40 cuộn] Giấy nhiệt in bill K80 phi 45 - Hàng nhập khẩu",189000,189000,0,0
TIKI,laptop-may-vi-tinh-linh-kien,185944336,"Màn hình Gaming GALAX Vivance VI-01 27″ QHD IPS 165Hz 1ms HDR G-Sync - Hàng Chính Hãng",5790000,7999000,2209000,28
TIKI,laptop-may-vi-tinh-linh-kien,704169,"Màn Hình LG 24MP88HV-S 24inch FullHD 5ms 60Hz IPS Speaker - Hàng Chính Hãng",3850000,3850000,0,0
TIKI,laptop-may-vi-tinh-linh-kien,419310,"Máy In Laser Đơn Năng Canon LBP 2900 - Hàng chính hãng",4060000,5830000,1770000,30
TIKI,laptop-may-vi-tinh-linh-kien,110990926,"USB Nâng cấp WiFi 5G dễ dàng với USB 3.0, WIFI siêu tốc 1200Mbps, hai băng tần, có 5GHz cho máy bàn PC - Hàng nhập khẩu",139000,139000,0,0
TIKI,laptop-may-vi-tinh-linh-kien,63080281,"Ổ Cứng gắn trong SSD Samsung 870 QVO 2.5 inch SATA III - Hàng Nhập Khẩu - 1TB",2190000,2190000,0,0
TIKI,laptop-may-vi-tinh-linh-kien,15475469," Keo Tản Nhiệt ARCTIC MX4 - 4g (2019) - Hàng Chính Hãng",68502,74900,6398,9
TIKI,laptop-may-vi-tinh-linh-kien,10732310,"USB Sound - Card Âm Thanh 7.1",22500,22500,0,0
TIKI,laptop-may-vi-tinh-linh-kien,186391678,"Phần mềm diệt virus Bitdefender Antivirus Plus 2022 - Hàng chính hãng",99000,190000,91000,48
TIKI,laptop-may-vi-tinh-linh-kien,57140400,"Đầu nối mạng chống sét chuẩn Cat6 RJ45 Ampcom AMCAT6BKL02 - Hàng chính hãng",99000,185000,86000,46
TIKI,laptop-may-vi-tinh-linh-kien,179509249,"Đèn treo màn hình Yeelight LED Screen Light Bar Pro Flagship Edition (Limited)- Dùng được màn hình monitor cong/phẳng - Hàng Chính Hãng",1590000,1590000,0,0
TIKI,laptop-may-vi-tinh-linh-kien,459842,"Bộ Chuyển Đổi USB Wifi TP-Link Archer T2U Băng Tần Kép AC600 - Hàng Chính Hãng",249000,369000,120000,33
TIKI,laptop-may-vi-tinh-linh-kien,53522863,"Hộp Mực in TN-2385/2325 cho các dòng máy in Brother HL(L2321D; L2361DN; L2366DW); MFC(L2520D;L2701D;L2701DW)",115000,115000,0,0
TIKI,laptop-may-vi-tinh-linh-kien,16303736,"Hộp mực 30A cho máy in HP M203d, M203dw, MFP M227fdw",139500,139500,0,0
TIKI,laptop-may-vi-tinh-linh-kien,132837677,"10 Rệp Quang L925BP Nối Điểm Đứt Cáp Quang GPON",150000,150000,0,0
TIKI,laptop-may-vi-tinh-linh-kien,49226647,"Thiết bị chống sét APC PNET1GB - APC PNET1GB",520000,520000,0,0
TIKI,laptop-may-vi-tinh-linh-kien,53838728,"Card WIFI Bluetooth cho PC sử dụng chip Intel WIFI 6 AX200 khe PCI cho tích hợp Bluetooth 5.2  tốc độ 2400M có tản nhiệt",510000,510000,0,0
TIKI,laptop-may-vi-tinh-linh-kien,8240482,"Pin Bộ Phát Wifi 4G TP-Link M7200 - Hàng chính hãng",249000,249000,0,0
TIKI,laptop-may-vi-tinh-linh-kien,10001359,"RAM Laptop Hynix 16GB DDR4 2400MHz SODIMM - Hàng Nhập Khẩu",869000,1050000,181000,17
TIKI,laptop-may-vi-tinh-linh-kien,159887307,"Màn hình máy tính Dell E2222H 21.5inch FullHD 10ms 60Hz VA - Hàng Chính Hãng",2300000,2300000,0,0
TIKI,laptop-may-vi-tinh-linh-kien,511960,"Bộ Kích Sóng Wifi Repeater 300Mbps TP-Link TL-WA855RE -  Hàng Chính Hãng",254000,399000,145000,36
TIKI,laptop-may-vi-tinh-linh-kien,196057971,"Ổ đĩa quang CD/DVD-RW cắm ngoài USB 3.0, Type-C cho PC, Macbook, Laptop, Đọc tốc độ Cao",350000,350000,0,0
TIKI,laptop-may-vi-tinh-linh-kien,52053395,"  USB Dcom 3G Huawei Emobile D41HW 42Mb Hàng Nhật Bản Chạy Đa Mạng, Hỗ Trợ Đổi IP - Hàng Chính Hãng",196000,249000,53000,21
TIKI,laptop-may-vi-tinh-linh-kien,72042710,"(BỘ 4/6 MÀU) Mực in phun Thuận Phong TP50 (100ml) dùng cho máy in phun Epson, HP, Canon - Hàng Chính Hãng",129000,129000,0,0
TIKI,laptop-may-vi-tinh-linh-kien,179539838,"HDD Box chuẩn M2 NVME sang Type-C tốc độ 10GBS ORICO - M2PV-C3 – Hàng Chính Hãng",423000,423000,0,0
TIKI,laptop-may-vi-tinh-linh-kien,34156401,"Card Wifi Intel-6 AX200 khe M2 có Bluetooth  - Hàng nhập khẩu",430000,430000,0,0
TIKI,laptop-may-vi-tinh-linh-kien,1402715,"Máy In Nhãn Đơn Năng Brother PT-E110 - Hàng Chính Hãng",839000,839000,0,0
TIKI,laptop-may-vi-tinh-linh-kien,16610279,"RAM PC DDR4 Samsung 8GB Bus 2666 - Hàng Nhập Khẩu",517000,658000,141000,21
TIKI,laptop-may-vi-tinh-linh-kien,120484511,"Card mở rộng ổ cứng SSD M.2 qua khe Pci-E 3.0 X4 Orico PDM2 - Hàng chính hãng",194000,209000,15000,7
TIKI,laptop-may-vi-tinh-linh-kien,59502158,"Máy in laser đen trắng đa chức năng HP 137fnw - 4ZB84A - Hàng Chính Hãng",3990000,3990000,0,0
TIKI,laptop-may-vi-tinh-linh-kien,70689205,"Dây mạng bấm sẵn 2 đầu Cat6 UTP Patch Cords VENTION dài 1.5m đến 5m - Hàng chính hãng",30000,46000,16000,35
TIKI,laptop-may-vi-tinh-linh-kien,14996837,"Máy In Phun Canon TS707 - Hàng Chính Hãng",3490000,3490000,0,0
TIKI,laptop-may-vi-tinh-linh-kien,68600962,"Hộp đựng ổ cứng HDD/SSD 2.5" QGeeM Gen2|cổng USB C/3.1, Type C to SATA|SATA I II III, PS4 hỗ trợ UASP tốc độ cao 6Gbps kèm cáp Type C to USB A-Hàng Chính Hãng",216000,237000,21000,9
TIKI,laptop-may-vi-tinh-linh-kien,120553752,"Giấy In Nhiệt K57 phi 30 6m /K57 phi 50 17 m Deli - 3 Lớp Dẻo Dai - In Hóa Đơn Máy Tính Tiền Siêu Thị, Cửa Hàng Tiện Lợi, Mã Vạch, Logo, Báo Giá Không Phai Mực - Hàng Chính Hãng - 11760 / 11761",5000,8730,3730,43
TIKI,laptop-may-vi-tinh-linh-kien,709035,"Bộ Chia Mạng 8 Cổng Mercusys MS108 (10/100Mbps) - Hàng Chính Hãng",199000,199000,0,0
TIKI,laptop-may-vi-tinh-linh-kien,173153435,"Fan Tản Nhiệt CPU  Led RGB 16 - Tự Động Đổi Màu Không Cần Hub",112800,112800,0,0
TIKI,laptop-may-vi-tinh-linh-kien,561957,"Kaspersky Anti Virus Cho 1 Máy Tính - KAV1U - Hàng chính hãng",180000,180000,0,0
TIKI,laptop-may-vi-tinh-linh-kien,24880266,"Hộp mực cho Brother TN 2385 nhập khẩu. Là Toner, Cartridge cho máy in Brother HL 2300, 2320, 2321, 2340, 2361, 2365, 2366, 2380, MFC 2700, 2702, 2703, 2720, 2740",109900,109900,0,0
TIKI,laptop-may-vi-tinh-linh-kien,171653285,"Sạc dành cho Laptop MSI Modern 14 A10M, 14 A10RB, 14 A10RAS",330000,330000,0,0
TIKI,laptop-may-vi-tinh-linh-kien,8545472,"Hạt mạng xuyên thấu RJ45 - Hộp 50 hạt và 100 hạt",38544,38544,0,0
TIKI,laptop-may-vi-tinh-linh-kien,71893664,"Bộ hai lọ mực HA140g - Nạp ( đổ )  cho máy in Canon 2900, 3000, 3300, 3500, 4122, 4150, 4350, 4320, 4680 / HP 1010, 1019, 1012, 1015, 1018, 1020, 1022, 1319, 3030 ,3050, 3055 /5200",70000,70000,0,0
TIKI,laptop-may-vi-tinh-linh-kien,174257120,"Switch TP-Link TL-SG108 Gigabit Hàng Chính Hãng - 8 cổng RJ45 10/100/1000Mbps, Vỏ Kim Loại",694000,694000,0,0
TIKI,laptop-may-vi-tinh-linh-kien,23012379,"Khung treo máy chiếu 0.6 – 1.2m",259000,259000,0,0
TIKI,laptop-may-vi-tinh-linh-kien,92365580," Nguồn adapter 12V 5A; 3A; 2A hàng nặng tay",60000,60000,0,0
TIKI,laptop-may-vi-tinh-linh-kien,17473989,"Cáp Mạng Lan Bấm Sẵn 2 Đầu Dài 10m",16900,16900,0,0
TIKI,laptop-may-vi-tinh-linh-kien,491442,"Mực In Canon PG-89 Cho Máy In Canon Pixma E560 - Hàng Chính Hãng",410000,410000,0,0
TIKI,laptop-may-vi-tinh-linh-kien,12108488,"Ổ cứng SSD Kingston A400 SATA III 480GB SA400S37/480G - Hàng Chính Hãng",999000,999000,0,0
TIKI,laptop-may-vi-tinh-linh-kien,20704481,"Hộp mực máy in 326, 328 in đẹp, nhập khẩu mới, dùng chung với 78a. Là Cartridge, catrich, toner dùng cho máy in Canon LBP 6200, 6230, MF 4820d, 4412, 4450, 4720w, 4870, mf4750, mf4700, D500, D520, L170",116500,116500,0,0
TIKI,laptop-may-vi-tinh-linh-kien,54549994,"Mực cho máy in HP LaserJet - P1005, P1006 (HKC-35A)",116500,116500,0,0
TIKI,laptop-may-vi-tinh-linh-kien,55843196,"Khay Ổ cứng Laptop (Caddy Bay) mỏng 9,5mm Orico M95SS - Hàng Chính Hãng",153000,153000,0,0
TIKI,laptop-may-vi-tinh-linh-kien,59204350,"Hộp mực in SAHA TN-2385 cho máy in Brother HL - L2321D / L2361DN / L2366DW, MFC - L2701D/DW, CPL2520D - Hàng chính hãng",143000,143000,0,0
TIKI,laptop-may-vi-tinh-linh-kien,154431235,"Bộ chuyển đổi khe cắm PCIE sang khe cắm M.2 WIFI Key E có hỗ trợ Bluetooth",150000,150000,0,0
TIKI,laptop-may-vi-tinh-linh-kien,171233670,"Mica khay đỡ giấy dành cho máy in Canon 2900",30000,30000,0,0
TIKI,laptop-may-vi-tinh-linh-kien,171233554,"BO NGANG ECU DÀNH CHO MÁY IN CANON 2900",180000,180000,0,0
TIKI,laptop-may-vi-tinh-linh-kien,169695504,"TOTOLINK EX1200L - Thiết Bị Mở Rộng Sóng Wi-Fi Băng Tần Kép AC1200 - Hàng Chính Hãng",580000,580000,0,0
TIKI,laptop-may-vi-tinh-linh-kien,41218099,"Bộ lưu điện APC: EASY UPS BV 1000VA, AVR, Universal Outlet, 230V - BV1000I-MS - Chính Hãng",2149000,2185000,36000,2
TIKI,laptop-may-vi-tinh-linh-kien,136796434,"Máy đo công suất quang TriBrer APM50NT - Soi VFL -Test LAN",555000,555000,0,0
TIKI,laptop-may-vi-tinh-linh-kien,26061584,"Mực nước Inktec dùng cho máy in phun màu Epson -  Loại 1 lít (1.000ml) - Hàng chính hãng",200000,200000,0,0
TIKI,laptop-may-vi-tinh-linh-kien,2086087,"Máy Quét Mã Vạch Datalogic QW2100 - Hàng chính hãng",1050000,1700000,650000,38
TIKI,laptop-may-vi-tinh-linh-kien,123498423,"Ổ CỨNG 500G SEAGATE CHUYÊN DÀNH CHO CAMERA ",349000,349000,0,0
TIKI,laptop-may-vi-tinh-linh-kien,82842691," Mực Nạp Hp M102A | Mực nạp 17A, 30A, Canon 051, 047 Dùng cho hộp mực loại II và chính hãng",23900,23900,0,0
TIKI,laptop-may-vi-tinh-linh-kien,16215426,"Bộ 50 đĩa trắng CD RISHENG AUDIO ",175322,199000,23678,12
TIKI,laptop-may-vi-tinh-linh-kien,125786972,"Sạc Dành Cho laptop LG Gram 19v 2.1a, 40w - Size (3.0mm * 1.0mm)",390000,390000,0,0
TIKI,laptop-may-vi-tinh-linh-kien,12527803,"USB Thu Wifi Mini 802.11 Không Anten",39138,39138,0,0
TIKI,laptop-may-vi-tinh-linh-kien,416601,"TP-Link  TL-WR940N - Router Wifi Chuẩn N Tốc Độ 450Mbps - Hàng Chính Hãng",449000,449000,0,0
TIKI,laptop-may-vi-tinh-linh-kien,262459595,"Hộp mực in 337 dùng cho máy in Canon LBP151dw/MF 237W/ 247DW/ MF211/ MF212W/ MF221D/ MF241D/ MF215/ MF217W/ MF226DN/ MF229DW/ MF 241D/ MF 236N/ MF244DW - CRG 337",145000,145000,0,0
TIKI,laptop-may-vi-tinh-linh-kien,44248667,"Bàn phím kiêm chuột không dây mini cho tivi box, smart tivi UKB-500RF có đèn led (màu ngẫu nhiên)",81400,81400,0,0
TIKI,laptop-may-vi-tinh-linh-kien,42561594,"Hộp Mực Premium TN2385/ TN2325 Cho Máy In Brother HL-2360/2361 - Hàng Nhập Khẩu",115000,115000,0,0
TIKI,laptop-may-vi-tinh-linh-kien,191829340,"Bộ Chia Tín Hiệu Switch TP-Link LS1008G Để Bàn 8 Cổng 10/100/1000Mbps - Hàng Chính Hãng",439000,539000,100000,19
TIKI,laptop-may-vi-tinh-linh-kien,95564246,"Hộp mực TN 1010 dành cho máy in Brother HL 1111-1201-1211 DCP 1511-1610-1616 MFC 1811-1901-1916",102800,102800,0,0
TIKI,laptop-may-vi-tinh-linh-kien,3556013,"(Bộ 10 chai) Mực đổ Thuận Phong TP03 dùng cho máy in HP / Canon - Hàng Chính Hãng",285000,285000,0,0
TIKI,laptop-may-vi-tinh-linh-kien,23285128,"Pin cho Laptop Dell Latitude E7420 E7440 E7450",641900,641900,0,0
TIKI,laptop-may-vi-tinh-linh-kien,122267913,"Mực nạp premium dành cho máy in Canon 2900/Canon 3300/ HP 1010/HP 2035/HP 2055- siêu đậm đẹp",22000,22000,0,0
TIKI,laptop-may-vi-tinh-linh-kien,81087635,"Hộp mực 30A - CRG 051 tương thích máy in HP - Canon như Pro M203dn / HP Pro M203dw / HP MFP M227fdw / HP MFP M227sdn Canon LBP 161dn / 162dw - torner cartridge nhập khẩu, hàng thay thế",139800,139800,0,0
TIKI,laptop-may-vi-tinh-linh-kien,52335359,"Bàn phím dành cho laptop Dell Inspiron 3441 3442 3443 3445 3446 3447 3448 3450 3451 3452 3458 3459 3460 3470",149000,149000,0,0
TIKI,laptop-may-vi-tinh-linh-kien,51615378,"Hộp mực 48A cho máy in HP M15a, M16a, M28a, M28w, M29a...CF248A",153000,153000,0,0
TIKI,laptop-may-vi-tinh-linh-kien,10368701,"Khay Caddy Bay Đựng HDD, SSD 12,7mm - Phụ Kiện Cho Laptop ",28850,28850,0,0
TIKI,laptop-may-vi-tinh-linh-kien,10021395,"Hộp mực Canon 325 cho máy in Canon LBP 6000, 6030, MF3010",119000,119000,0,0
TIKI,laptop-may-vi-tinh-linh-kien,173996535,"Ổ cứng Silicon Power M.2 2280 PCIe SSD A60 256GB - Hàng chính hãng",725000,725000,0,0
TIKI,laptop-may-vi-tinh-linh-kien,137169714,"Bàn phím dành cho laptop Lenovo G480 G480A G485 G485A - Hàng Nhập Khẩu mới 100%",228900,248900,20000,8
TIKI,laptop-may-vi-tinh-linh-kien,74381449,"Sạc Dành Cho Laptop Lenovo 20V - 4.5A, 90W, Đầu Sạc USB",187883,350000,162117,46
TIKI,laptop-may-vi-tinh-linh-kien,18012009,"Hộp mực dành cho máy in canon LBP 3300 ( 308) ( Hàng nhập Khẩu )",189900,189900,0,0
TIKI,laptop-may-vi-tinh-linh-kien,194102606,"Hộp mực máy in HP M130a / M130fn / M130fw / M130nw (hàng nhập khẩu) - Cartridge CF217A - 17A mới 100% [Full Box]",135000,135000,0,0
TIKI,laptop-may-vi-tinh-linh-kien,20614006,"Hộp mực máy in mã 83A Viet Toner - Hàng chính hãng",145000,145000,0,0
TIKI,laptop-may-vi-tinh-linh-kien,43959855," Hộp mực 49A cho máy in Canon 3300 3360, HP 1160 1320 3390 3392",194000,194000,0,0
TIKI,laptop-may-vi-tinh-linh-kien,173982699,"Ổ cứng Silicon Power M.2 2280 PCIe SSD A60 128GB - Hàng chính hãng",489000,489000,0,0
TIKI,laptop-may-vi-tinh-linh-kien,52240825,"Cáp máy in nhiệt  RS232 to DB25 ( 25 chân dương)",150000,150000,0,0
TIKI,laptop-may-vi-tinh-linh-kien,74883580,"Dây cáp mạng hai đầu đúc sẵn CAT8 SSTP VENTION tròn, dài 1m đến 20m IKAB - Hàng chính hãng",89000,155000,66000,43
TIKI,laptop-may-vi-tinh-linh-kien,56251562,"Man Hình ViewSonic VA2432-H - Hàng Chính Hãng",2680000,2680000,0,0
TIKI,laptop-may-vi-tinh-linh-kien,141774444,"Màn hình vi tính Xiaomi Mi Desktop Monitor 23.8 inch 1C BHR4510GL RMMNT238NF - Hàng chính hãng",2119000,3490000,1371000,39
TIKI,laptop-may-vi-tinh-linh-kien,16603745,"Hộp mực Dành Cho máy in Canon LBP 2900, 3000",115000,115000,0,0
TIKI,laptop-may-vi-tinh-linh-kien,262456634,"Hộp mực in laser dành cho canon 2900 ( có lỗ đổ mực )",139000,139000,0,0
TIKI,laptop-may-vi-tinh-linh-kien,88790505,"Máy In Đơn Hàng Khổ A6/A7 Hóa Đơn Chuyên Dùng Tmđt Deli -1 Đơn Mỗi Giây - Phụ Kiện Máy In - DL760 DL770 - Hàng Chính Hãng",1529000,2878200,1349200,47
TIKI,laptop-may-vi-tinh-linh-kien,1403987,"Nhãn In Tiêu Chuẩn TZE Brother Tze-231 Chữ Đen Trên Nền Trắng (12mm) - Hàng chính hãng",393000,393000,0,0
TIKI,laptop-may-vi-tinh-linh-kien,2901371,"Máy In Phun Màu Canon Pixma G1010 - Hàng Chính Hãng",2990000,3520000,530000,15
TIKI,laptop-may-vi-tinh-linh-kien,12477248,"Dây cáp mạng bấm sẵn đầu (tặng đầu nối mạng)",19900,19900,0,0
TIKI,laptop-may-vi-tinh-linh-kien,102104910,"Quạt Tản Nhiệt Sunon 6x6x1.5Cm 5V 0.9W",19990,19990,0,0
TIKI,laptop-may-vi-tinh-linh-kien,172960109,"Ổ Cứng Di Động HDD Seagate One Touch 1TB 2.5" USB 3.0 + Phục Hồi Dữ Liệu Rescue_Hàng chính hãng",1790000,1790000,0,0
TIKI,laptop-may-vi-tinh-linh-kien,14980524,"Máy Test Mạng Đa Năng RJ45 Và Cáp Đồng Trục BNC ",114000,120000,6000,5
TIKI,laptop-may-vi-tinh-linh-kien,191653714,"Quạt Tản Nhiệt Game Thủ Huqu Công Suất Lớn ,Làm Mát Bán Dẫn HQ-P20-Hàng Chính Hãng",332500,350000,17500,5
TIKI,laptop-may-vi-tinh-linh-kien,4953361,"USB SanDisk CZ50 16GB – USB 2.0 – Hàng Chính Hãng",119000,129000,10000,8
TIKI,laptop-may-vi-tinh-linh-kien,26299887,"Bộ chia sẻ máy in 1 ra 2 cổng USB chính hãng MT-VIKI MT-1A2B-CF",53380,53380,0,0
TIKI,laptop-may-vi-tinh-linh-kien,134641513,"USB SanDisk CZ600 - USB 3.0 - Hàng Chính Hãng",139000,149000,10000,7
TIKI,laptop-may-vi-tinh-linh-kien,164250802,"Ổ cứng SSD KingSpec M2 PCIe NVMe | NE - Hàng Chính Hãng",598000,598000,0,0
TIKI,laptop-may-vi-tinh-linh-kien,554426,"Bộ Kích Sóng Wifi Repeater 300Mbps Tenda A9 - Hàng Chính Hãng",198900,198900,0,0
TIKI,laptop-may-vi-tinh-linh-kien,68499401,"Màn hình Bảo Vệ Mắt ASUS VA24DQLB 23.8 inch Full HD (1920x1080) 75Hz IPS Adaptive-Sync - Hàng Chính Hãng",3920000,5498900,1578900,29
TIKI,laptop-may-vi-tinh-linh-kien,24633993,"Bộ Chia Tín Hiệu TP-Link LS105G Switch Để Bàn 5 Cổng 10/100/1000Mbps - Hàng Chính Hãng",389000,599000,210000,35
TIKI,laptop-may-vi-tinh-linh-kien,79267421,"Ổ cứng SSD Samsung 980 Pro PCIe Gen 4.0 x4 NVMe V-NAND M.2 2280 500GB - Hàng Nhập Khẩu",2150000,2150000,0,0
TIKI,laptop-may-vi-tinh-linh-kien,26314426,"Dây Cáp Mạng Cat6 Bấm Sẵn 2 đầu",25000,25000,0,0
TIKI,laptop-may-vi-tinh-linh-kien,13862477,"Máy in hóa đơn, in bill Xprinter XP-58U ( khổ 58mm) - Nhập khẩu",545000,660000,115000,17
TIKI,laptop-may-vi-tinh-linh-kien,71062304,"Bộ sản phẩm 5 lọ mực nạp ( mực đổ ) thương hiệu HA dùng cho hộp mực máy in Canon 2900/ 3300/ 251/ 251, 252, 253, 411, 5870, 5980, 6300, 6650, 6670, 6680/ HP 1010/1020/ HP 400, 401, 425, 2035, 2050, 2055, - Hàng nhập khẩu",175000,175000,0,0
TIKI,laptop-may-vi-tinh-linh-kien,142370216,"Máy in hóa đơn bill MP bluetooth mini cầm tay khổ 58mm dùng cho điện thoại - tặng 5 cuộn giấy",720000,720000,0,0
TIKI,laptop-may-vi-tinh-linh-kien,208120467,"MÀN CHIẾU ĐIỆN TREO TƯỜNG TỰ ĐỘNG CÓ REMOTE 120 INCH - 2,13MX2,13M - P84ES HÀNG NHẬP KHẨU",1260000,1260000,0,0
TIKI,laptop-may-vi-tinh-linh-kien,49311265,"Giấy in đơn hàng TMĐT 100x150mm in decal nhiệt bill hóa đơn cỡ A6 tự dán không cần băng dính",68000,68000,0,0
TIKI,laptop-may-vi-tinh-linh-kien,125290986,"Hộp mực máy in 12A - 303 Dành Cho máy in Canon 2900, 3000",116600,116600,0,0
TIKI,laptop-may-vi-tinh-linh-kien,76186679,"Router Totolink Wi-Fi 6 băng tần kép Gigabit AX1800 - X5000R - Hàng Chính hãng",880000,880000,0,0
TIKI,laptop-may-vi-tinh-linh-kien,491434,"Mực In Canon CL-57 Cho Máy In Canon Pixma E400, E410, E460, E480 - Hàng Chính Hãng",450000,450000,0,0
TIKI,laptop-may-vi-tinh-linh-kien,196988056,"Ổ Cứng gắn trong SSD Samsung 980 PCIe NVMe V-NAND M.2 2280 500GB MZ-V8V500BW  Hàng Nhập Khẩu",1690000,1690000,0,0
TIKI,laptop-may-vi-tinh-linh-kien,36198753,"Mực in Phun HP GT52 Yellow Original Ink Bottle Vàng ( Máy in HP DeskJet GT 5810 All-in-One/5820/5811/5821/HP Ink Tank Wireless 415 All-in-One/418/419/319/410 HP Ink Tank 315 All-in-One/318/310/M0H56AA) - Hàng Chính Hãng",239000,239000,0,0
TIKI,laptop-may-vi-tinh-linh-kien,57357726,"Nguồn máy tính VSP 750W (4+4pin)  cung cấp cho chiếc máy tính của bạn nguồn năng lượng ổn định, không bị quá tải, sai dòng hay vượt công suất",234090,234090,0,0
TIKI,laptop-may-vi-tinh-linh-kien,127322940,"Router Wifi 6 TP-Link Archer AX6000 - Hàng Chính Hãng",6989000,6989000,0,0
TIKI,laptop-may-vi-tinh-linh-kien,74309855,"Bộ loa hội nghị Jabra Speak 410 - Hàng Chính Hãng",2398000,2398000,0,0
TIKI,laptop-may-vi-tinh-linh-kien,12106824,"Bộ Chuyển Đổi Wifi Không Dây TP-Link TL-WN781ND PCI Express 150Mbps - Hàng Chính Hãng",179000,239000,60000,25
TIKI,laptop-may-vi-tinh-linh-kien,273538085,"Bộ Phát Wifi Mesh Băng Tần Kép TP-Link Deco E4 AC1200 MU-MIMO (3-pack) - Hàng Chính Hãng",790000,790000,0,0
TIKI,laptop-may-vi-tinh-linh-kien,20600759,"Hộp mực 85a, 325 in đẹp, nhập khẩu mới. Là Cartridge, catrich, toner dùng cho máy in HP p1102, 1102w, p1132, m1212nf, Canon LBP 6000, MF3010, 6018, 6020, 6030, 6030w",119000,119000,0,0
TIKI,laptop-may-vi-tinh-linh-kien,32108134," Trống (phấn) 12A cho máy Canon 2900 3000 HP 1010 1020",17800,17800,0,0
TIKI,laptop-may-vi-tinh-linh-kien,42594236,"Mạch sạc bảo vệ pin 1A 18650",3000,3000,0,0
TIKI,laptop-may-vi-tinh-linh-kien,31949590,"Ổ Cứng HDD Western Digital Purple 6TB 3.5 inch Sata 3 - Hàng Nhập Khẩu",3949000,5026000,1077000,21
TIKI,laptop-may-vi-tinh-linh-kien,1059436,"Giấy In Nhãn Dán (Decal) Media 1 Mặt Bóng A4 135gsm 50 Tờ - Hàng chính hãng",98100,109000,10900,10
TIKI,laptop-may-vi-tinh-linh-kien,44022092,"RAM Laptop Samsung 32GB DDR4 Bus 3200 - Hàng Nhập Khẩu",2189000,2786000,597000,21
TIKI,laptop-may-vi-tinh-linh-kien,81205762,"Bộ Phát Wifi 3G Huawei 303Hw – 43,2Mb -kết nối 10 user – Hàng Nội Địa Nhật - hàng chính hãng",499000,499000,0,0
TIKI,laptop-may-vi-tinh-linh-kien,12637818,"Bộ sản phẩm thi công hệ thống mạng Kìm bấm mạng xuyên thấu + Tool nhấn mạng âm tường + 100 Hạt mạng xuyên thấu RJ45 + Hộp test mạng",385000,385000,0,0
TIKI,laptop-may-vi-tinh-linh-kien,176926831,"Màn Hình Máy Tính Philips 243V7QDSB/74 23.8" (1920x1080/IPS/60Hz/5ms) - Hàng Chính Hãng",2980000,2980000,0,0
TIKI,laptop-may-vi-tinh-linh-kien,97990990,"Mực nạp 12A hàng chính hãng Alphacartridge dành cho hộp mực 26A 05A 49A FX9  máy in Canon 2900 3000 3300 6300 251dw 252dw HP 1010 1020 2055 Pro 400 m402 m402nw 1230 ",30000,30000,0,0
TIKI,laptop-may-vi-tinh-linh-kien,201099327,"Kìm Bấm Dây Mạng Đa Năng ( RJ45 + RJ11 ) AMPCOM AM-568R, Kèm tool tuốt dây và lưỡi dao - Hàng chính hãng",250000,359000,109000,30
TIKI,laptop-may-vi-tinh-linh-kien,127668958,"Bộ Chia Tín Hiệu Switch Để Bàn TP-Link LS1005G 5 Cổng 10/100/1000Mbps - Hàng Chính Hãng",220000,220000,0,0
TIKI,laptop-may-vi-tinh-linh-kien,100596171,"Máy scan Brother DS-740D - Hàng chính hãng",6175000,6175000,0,0
TIKI,laptop-may-vi-tinh-linh-kien,108924121,"Laptop Dell Latitude 3520 70251603 (Core i3-1115G4/ 4 GB/ 256GB SSD/ 15.6HD/ Fedora) - Hàng Chính Hãng",10150000,10150000,0,0
TIKI,laptop-may-vi-tinh-linh-kien,6499021,"Nguồn dự phòng UPSS mini 12V-1A",320000,320000,0,0
TIKI,laptop-may-vi-tinh-linh-kien,203211116,"(Giá Hủy Diệt) Ổ cứng gắn trong HDD Western Digital Ultrastar 3.5 inch Sata 3 cho Serve dòng Enterprise - Hàng Nhập Khẩu",3685000,4690000,1005000,21
TIKI,laptop-may-vi-tinh-linh-kien,2050777,"USB 4G Huawei E3372 | Dcom 4G cho tốc độ lướt web chóng mặt 150Mbps – USB 4G - Hàng chính hãng",984000,1090000,106000,10
TIKI,laptop-may-vi-tinh-linh-kien,67983184,"Combo 5 lọ mực đổ Brother Xppro ( Hàng nhập khẩu ) dùng cho máy in laser Brother TN:8000/8050/8220/8820... HL2130/21470/2240/2250/2321/2361/2840/2701/5140/5240....",195000,195000,0,0
TIKI,laptop-may-vi-tinh-linh-kien,195656641,"Mực in 664 4 màu Xanh/đỏ/vàng/đen cho Epson L300 / L310 / L350 / L360 / L1300 / L100 / L120 / L200 / L210 / L565 Hàng nhập khẩu",80000,80000,0,0
TIKI,laptop-may-vi-tinh-linh-kien,13525399,"Hộp Mực 85A/ 325/ 326 Dành Cho Máy In HP P1102, M1212 Canon MF3010/ LBP 6000/ 6200D",119000,119000,0,0
TIKI,laptop-may-vi-tinh-linh-kien,44063806,"Máy quét mã vạch / barcode 1D YHD - 8200 - quét được trên cả màn hình điện thoại, máy tính - giúp seller dễ dàng quản lý tồn kho, kiểm tra và lưu trữ đơn hàng - kèm chân gác",449000,449000,0,0
TIKI,laptop-may-vi-tinh-linh-kien,140820764,"Bộ chuyển đổi game MIX SE thiết bị chuyển đổi phím chuột kết nối điện thoại chơi PUBG Mobile Free Fire COD dành cho điện thoại Android IOS – Hàng Chính Hãng",196000,300000,104000,35
TIKI,laptop-may-vi-tinh-linh-kien,1822173,"Dây Cáp Mạng Orico PUG-C6-30 CAT6 3m - Hàng Chính Hãng",42880,55000,12120,22
TIKI,laptop-may-vi-tinh-linh-kien,52269671,"BỘ PHÁT WIFI 4G ZTE MF253S - TẶNG KÈM 2 ANGTEN WIFI - HÀNG CHÍNH HÃNG",859000,859000,0,0
TIKI,laptop-may-vi-tinh-linh-kien,156218939,"Mực in phun Brother TN-B022 - Hàng chính hãng",522500,550000,27500,5
TIKI,laptop-may-vi-tinh-linh-kien,20642034,"Thiết bị thu phát wifi D-link DIR-880L - Hàng chính hãng",600000,600000,0,0
TIKI,laptop-may-vi-tinh-linh-kien,14966614,"Kìm Bấm Dây Mạng Đa Năng ( J45 + J11 ) - Tặng 10 Hạt Mạng",93000,93000,0,0
TIKI,laptop-may-vi-tinh-linh-kien,82842034," Bộ Mực máy in dành cho máy in Hp M177, M176 | Mực in 130A CF350A, CF351A, CF352A, CF353A tương thích",1200000,1200000,0,0
TIKI,laptop-may-vi-tinh-linh-kien,108857181,"Cụm trống Drum DR-2280 dùng cho máy in Brother HL-2130, 2240, 2240D, 2250, 2250DN, 2270, 2270DW, 2250DN, 2270DW, FAX-2840, MFC 7360, 7460DN, 7860DW, 7060D, 7065DN, DCP 2240D, 2270DW, 2280DW",196000,196000,0,0
TIKI,laptop-may-vi-tinh-linh-kien,98570036,"Màn hình Samsung LC27G55TQWEXXV (27inch/WQHD/VA/144Hz/1ms/250nits/HDMI+DP/FreeSync) - Hàng Chính Hãng ",4750000,4750000,0,0
TIKI,laptop-may-vi-tinh-linh-kien,38210847,"Sạc Dành Cho Laptop Dell Chân Kim To 19.5V - 3.34A, 65W Hàng Nhập Khẩu",178995,178995,0,0
TIKI,laptop-may-vi-tinh-linh-kien,91161487,"USB wifi -usb thu sóng wifi cực mạnh tốc độ 300Mbps cho máy tính, laptop (Không râu)",60000,60000,0,0
TIKI,laptop-may-vi-tinh-linh-kien,7597707,"Hộp mực máy in Canon LBP 6000, 6030, MF3010 (CRG325/35A)",122000,122000,0,0
TIKI,laptop-may-vi-tinh-linh-kien,38106909,"Bộ thiết bị quản lý shop thời trang: Máy in tem mã, máy in hóa đơn, máy quét mã vạch",2790000,3550000,760000,21
TIKI,laptop-may-vi-tinh-linh-kien,10050407,"Hộp mực in ACO CF217A/17A - Hàng chính hãng",220000,220000,0,0
TIKI,laptop-may-vi-tinh-linh-kien,149557662,"Giấy In Nhiệt Đơn Hàng , In Vận Đơn 100x150 x 350 Tem",58000,58000,0,0
TIKI,laptop-may-vi-tinh-linh-kien,98233872,"Hộp mực in 35A/36A/85A - No box - Hộp mực dùng cho máy in HP: LaserJet P 1005, 1006, 1102, 1212NF, 1505, 1515 / M 1120, 1130, 1132MF, 1210, 1319, 1522. HP: LaserJet P 1005, 1006, 1102, 1212NF, 1505, 1515 / M 1120, 1130, 1132MF, 1210, 1319, 1522.",110000,110000,0,0
TIKI,laptop-may-vi-tinh-linh-kien,452576,"USB Transcend JetFlash 700 TS32GJF700 32GB - USB 3.1 - Hàng Chính Hãng",179000,189000,10000,5
TIKI,laptop-may-vi-tinh-linh-kien,73666134,"Hộp mực in 052 – Cho máy Canon LBP 212dw/ 214dw/ MF421dw/ MF424dw/ MF426dw/429dw...",184500,184500,0,0
TIKI,laptop-may-vi-tinh-linh-kien,10074513,"Khay Ổ Cứng Caddy Bay 9.5mm (Gắn Ổ Cứng Thay Ổ Quang Laptop)",84000,84000,0,0
TIKI,laptop-may-vi-tinh-linh-kien,1821405,"Dây Cáp Mạng Orico PUG-C6-20 CAT6 2m - Hàng Chính Hãng",39000,39000,0,0
TIKI,laptop-may-vi-tinh-linh-kien,82176545,"Pin dành cho Laptop Dell Inspiron 14 3468, Vostro 14 3468 - M5Y1K",365000,365000,0,0
TIKI,laptop-may-vi-tinh-linh-kien,19879930,"Quạt Tản Nhiệt Bếp Hồng Ngoại 18VDC",21000,21000,0,0
TIKI,laptop-may-vi-tinh-linh-kien,115678018,"Mực Nạp 17A/30A Dùng Cho Máy In HP laserjet Pro M102, M102a, M102w, M130a, M130fn, M130, HP 227FDW Siêu Nét",20000,20000,0,0
TIKI,laptop-may-vi-tinh-linh-kien,153999564,"Khay Chuyển Đổi Ổ Cứng (Caddy bay) Orico AC325-1S-V1-SV-BP Từ 2.5" sang 3.5" (Caddy Tray Adapter) - Hàng Chính Hãng",74000,74000,0,0
TIKI,laptop-may-vi-tinh-linh-kien,416625,"Router Wifi Chuẩn N 300Mbps TP-Link TL-WR840N - Hàng Chính Hãng",269000,518000,249000,48
TIKI,laptop-may-vi-tinh-linh-kien,142370101,"Máy in hóa đơn bluetooth Acebe MPT-II (DM01) in bill từ ứng dụng bán hàng Viettelpay pro, KiotViet",664000,664000,0,0
TIKI,laptop-may-vi-tinh-linh-kien,43662776,"USB Thu Wifi cho PC - Laptop LB-Link BL-WN155A - Hàng Chính Hãng",119000,119000,0,0
TIKI,laptop-may-vi-tinh-linh-kien,21266694,"Cuộn dây cáp mạng LB-LINK Cat6 UTP CCA 305m dây màu trắng - Hàng nhập khẩu",540000,540000,0,0
TIKI,laptop-may-vi-tinh-linh-kien,10716888,"USB Thu Bluetooth 4.0 Cao Cấp Ugreen 30524 - Hàng Chính Hãng",145000,169000,24000,14
TIKI,laptop-may-vi-tinh-linh-kien,22414760,"Giá treo máy chiếu đa năng  áp trần 20cm ( Hàng nhập khầu)",169000,169000,0,0
TIKI,laptop-may-vi-tinh-linh-kien,34317808,"5 cuộn giấy decal in tem nhãn nhiệt 35x22 mm ",134000,134000,0,0
TIKI,laptop-may-vi-tinh-linh-kien,67827661,"USB Verbatim OTG Type C USB 3.0 32GB - Hàng chính hãng",290000,290000,0,0
TIKI,laptop-may-vi-tinh-linh-kien,13325938,"Hộp mực 83A/ 337 dành cho máy in HP LaserJet m125/ m127/ m201 - Canon MF 151/ 215/ 217",117500,117500,0,0
TIKI,laptop-may-vi-tinh-linh-kien,63163309,"Ổ Cứng Di Động WD My Book 12TB 3.5 USB 3.0 - Hàng Nhập Khẩu",9735000,12390000,2655000,21
TIKI,laptop-may-vi-tinh-linh-kien,154448087,"Router Wifi Wifi 6 TP-Link Archer AX73 - Hàng Chính Hãng",2490000,2490000,0,0
TIKI,laptop-may-vi-tinh-linh-kien,124330976,"Ổ cứng SSD KingSpec 256GB / NE - 256G , M2 PCIe NVMe - Hàng Chính Hãng",938000,938000,0,0
TIKI,laptop-may-vi-tinh-linh-kien,100376507,"Bàn phím dành cho Laptop HP Mini 110 1101 110c-1000 US Layout Black",250000,250000,0,0
TIKI,laptop-may-vi-tinh-linh-kien,9842331,"Bút Trình Chiếu Laser Vesine VP-101 - Hàng Nhập Khẩu",109250,115000,5750,5
TIKI,laptop-may-vi-tinh-linh-kien,73801568,"Sạc cho laptop Dell Latitude E7240, Latitude E7440 Adapter 19.5V-3.34A, 19.5V-4.62A  ",254995,350000,95005,27
TIKI,laptop-may-vi-tinh-linh-kien,85816998,"Mực máy in date dập tay DY",40000,40000,0,0
TIKI,laptop-may-vi-tinh-linh-kien,49956976,"Mực in 103A / W1103A dùng cho máy in HP 1000A/1000W, HP 1200A/1200W",112000,112000,0,0
TIKI,laptop-may-vi-tinh-linh-kien,192074708,"Mực chai nạp 26a/76a dùng cho hộp mực hãng",38000,38000,0,0
TIKI,laptop-may-vi-tinh-linh-kien,169271164,"USB 3.2 Gen 1 Kioxia TransMemory U365 64GB - Hàng Nhập Khẩu",180000,180000,0,0
TIKI,laptop-may-vi-tinh-linh-kien,709013,"USB Wifi Mini Chuẩn N Mercusys MW300UM (300Mbps) - Hàng Chính Hãng",134000,134000,0,0
TIKI,laptop-may-vi-tinh-linh-kien,10001375,"RAM Laptop Hynix 4GB DDR4 2666MHz SODIMM - Hàng Nhập Khẩu",264000,336000,72000,21
TIKI,laptop-may-vi-tinh-linh-kien,112331487,"Sạc Đa Năng Laptop Tiện Lợi, Đa Dạng Chân Sạc Thích Hợp Tất Cả Các Hãng Laptop - HomeComputer",129000,129000,0,0
TIKI,laptop-may-vi-tinh-linh-kien,270140834,"Ổ Cứng HDD Video Seagate SkyHawk 1TB ( ST1000VX005 ) - Hàng chính hãng",1400000,1400000,0,0
TIKI,laptop-may-vi-tinh-linh-kien,58675684,"Pin chất lượng cao dành cho Laptop Dell Vostro 15 3568",549995,549995,0,0
TIKI,laptop-may-vi-tinh-linh-kien,35944794,"Giá treo máy chiếu đa năng sắt 60cm - Hàng chính hãng",169000,169000,0,0
TIKI,laptop-may-vi-tinh-linh-kien,56513606,"Pin dành cho Laptop HP probook 4440s, 4540s",289000,289000,0,0
TIKI,laptop-may-vi-tinh-linh-kien,26107549,"Miếng dán bàn phím tiếng Thái Lan (Thai Keyboard Stickers)",38000,38000,0,0
TIKI,laptop-may-vi-tinh-linh-kien,13302265,"Bộ lưu điện UPS CyberPower BU600E chuẩn ổ cắm AS - 600VA/360W - Hàng chính hãng",820000,820000,0,0
TIKI,laptop-may-vi-tinh-linh-kien,20581199,"Hộp mực 49A, 53A mới dùng cho Canon 3300, HP LaserJet 1160, 1320, ...",195000,195000,0,0
TIKI,laptop-may-vi-tinh-linh-kien,102121468,"Sạc dành cho Laptop Dell Vostro 15 3000 series ",254995,254995,0,0
TIKI,laptop-may-vi-tinh-linh-kien,37453774,"Tủ Mạng, Tủ Rack 20U Khung Rời Mẫu C- TMC RACK 19",3700000,3700000,0,0
TIKI,laptop-may-vi-tinh-linh-kien,36014978,"Hộp cụm drum CF219A / 19A (có Chip) dùng cho máy in HP Pro M102a, 129, 130a, 130fn, 132, 133, 134",169900,169900,0,0
TIKI,laptop-may-vi-tinh-linh-kien,1713119,"Bàn Phím Dành Cho Laptop Dell Inspiron 3421 14R 5421 Vostro 2421 - Hàng Nhập Khẩu",98000,235000,137000,58
TIKI,laptop-may-vi-tinh-linh-kien,99659829,"Sạc dành cho Laptop Lenovo Ideapad (Các model) 45W 20V 2.25A chuẩn 4.0 x 1.7mm",318995,318995,0,0
TIKI,laptop-may-vi-tinh-linh-kien,137170494,"Bàn phím dành cho Dell Inspiron 5468 - Hàng Nhập Khẩu",308900,328900,20000,6
TIKI,laptop-may-vi-tinh-linh-kien,101825531,"Sạc dành cho Laptop Dell Latitude E7270 E7470",234995,234995,0,0
TIKI,laptop-may-vi-tinh-linh-kien,71518127,"Lô ép dùng cho máy photocopy Toshiba E 205/205L/206L/255/256/305/306/355/356/455/456/257/307/357/457/507",285000,285000,0,0
TIKI,laptop-may-vi-tinh-linh-kien,109064229,"Sạc dành cho Laptop Lenovo IdeaPad 330 330S Series 330-14AST 330-14IKB  330-14IKBR 330-15IKB 330-15IKBR  330S-14IKBR  330S-15IKBR",298995,298995,0,0
TIKI,laptop-may-vi-tinh-linh-kien,562485,"Linksys LGS124 - Unmanaged Switch - Hàng Chính Hãng",3089000,3089000,0,0
TIKI,laptop-may-vi-tinh-linh-kien,57693956,"Sạc dành cho laptop Acer Aspire E5-573, E5-573G",214995,214995,0,0
TIKI,laptop-may-vi-tinh-linh-kien,113232533,"Bộ cò tách giấy dùng cho máy photocopy toshiba 355/356/357/455/456/457",192000,192000,0,0
TIKI,laptop-may-vi-tinh-linh-kien,52152951,"Sạc Laptop Acer 19v-2.37A  Chân mini siêu nhỏ",234995,234995,0,0
TIKI,laptop-may-vi-tinh-linh-kien,165177374,"Hộp mực in 107A/W1107A (full chip) hàng chính hãng Viettoner dùng cho máy in HP LaserJet 107a, 107w, 135a, 135w, 137a, 137w - Cartridge 107A/W1107A mới 100% [Fullbox]",349000,349000,0,0
TIKI,laptop-may-vi-tinh-linh-kien,56186177,"Sạc cho laptop Dell Vostro 3450, 3460 Adapter 19.5V-2.31A, 19.5V-3.34A",250000,250000,0,0
TIKI,laptop-may-vi-tinh-linh-kien,179749812,"Sạc dành cho Laptop Asus 15 A512 F512 X512 A512FA A512FL A512FA A512FA F512DA X512FA F524UA",329995,329995,0,0
TIKI,laptop-may-vi-tinh-linh-kien,69247933,"Bộ ( 6 màu/ 6 chai 500ml ) mực in phun màu dùng cho máy in phun Epson T50/T60/1390/1430? L1800....",960000,960000,0,0
TIKI,laptop-may-vi-tinh-linh-kien,29653642,"USB ra Sound 5.1 âm thanh 3D (Giao Màu Ngẫu Nhiên)",40000,40000,0,0
TIKI,laptop-may-vi-tinh-linh-kien,32909950,"Decal in nhiệt, tem nhãn, 2 tem 35x22mm, 2500 tem/ cuộn",32000,32000,0,0
TIKI,laptop-may-vi-tinh-linh-kien,72094081,"Card test Mainboard 4 số dùng cho main có khe cắm PCI Đỏ",78000,78000,0,0
TIKI,laptop-may-vi-tinh-linh-kien,59392915,"Hộp mực in SAHA 83X/337 cho máy in HP, Canon - Hàng chính hãng",110000,110000,0,0
TIKI,laptop-may-vi-tinh-linh-kien,14991077,"Máy chấm công Ronald Jack RJ500 - Hàng chính hãng",1850000,1850000,0,0
TIKI,laptop-may-vi-tinh-linh-kien,12739397,"Đế Tản Nhiệt Cooler Master I100 - HÀNG CHÍNH HÃNG",251655,264900,13245,5
TIKI,laptop-may-vi-tinh-linh-kien,15353548,"Hộp mực in 53A cho máy in HP LaserJet M2727, P2015",195000,195000,0,0
TIKI,laptop-may-vi-tinh-linh-kien,5412087,"Kềm bấm mạng đa năng  ",42900,42900,0,0
TIKI,laptop-may-vi-tinh-linh-kien,112076888,"Card Chuyển Đổi Pci-E Sang Sata 3.0 8 Cổng Sata cho SSD ,HDD",1330000,1330000,0,0
TIKI,laptop-may-vi-tinh-linh-kien,66674117,"20 cuộn Giấy in nhiệt, in bill, in hóa đơn TOPCASH khổ K80mm x 45mm dùng cho máy in nhiệt in hóa đơn – Hàng chính hãng.",139000,160000,21000,13
TIKI,laptop-may-vi-tinh-linh-kien,184904857,"Máy quét mã vạch cầm tay có dây YHD 1100D 2D dùng dây trực tiếp cắm cổng USB Máy tính, Laptop - Hàng nhập khẩu",749000,1123500,374500,33
TIKI,laptop-may-vi-tinh-linh-kien,26218949,"Dây mạng bấm sẵn 2 đầu cat5e 20M (màu ngẫu nhiên)",36000,38800,2800,7
TIKI,laptop-may-vi-tinh-linh-kien,36940811," Tủ Mạng, Tủ Rack 9UD450 Treo Tường - TMC Rack  19",1400000,1400000,0,0
TIKI,laptop-may-vi-tinh-linh-kien,141260215,"Màn Hình máy tính Acer 19.5" K202HQL (1600x900/TN/60Hz/5ms) hàng chính hãng",2400000,2400000,0,0
TIKI,laptop-may-vi-tinh-linh-kien,117093775,"Pin dành cho Laptop Dell Inspiron 15R N5110 - Hàng Nhập Khẩu ",324000,374000,50000,13
TIKI,laptop-may-vi-tinh-linh-kien,49377238,"Bàn Phím Dành Cho Laptop Toshiba Satellite C850 C850D C855 C855D L850 L850D L855 L870 L870D L875 L875D P850 P850D P855 P855D P870 P870D P875 (Đen)",99000,260000,161000,62
TIKI,laptop-may-vi-tinh-linh-kien,179991682,"Sạc dành cho Laptop ASUS ZENBOOK Duo UX481 UX481FA UX481FL-BM048T UX481FL-BM049T - Hàng Nhập Khẩu ",450000,500000,50000,10
TIKI,laptop-may-vi-tinh-linh-kien,194087087,"Trống drum 107A dùng cho máy in Hp M135a, M137fdn, M135w, M107w (W1107A)",45000,45000,0,0
TIKI,laptop-may-vi-tinh-linh-kien,82842058,"Combo Drum + chip + Trục sạc + Gạt lớn dành cho máy in Hp CP1025 Hp M177, M176",270000,270000,0,0
TIKI,laptop-may-vi-tinh-linh-kien,117095563,"Pin dành cho Laptop Asus A32 A8 F8 F80 N80 N81 Z99 X80 X83 - Hàng Nhập Khẩu",355000,375000,20000,5
TIKI,laptop-may-vi-tinh-linh-kien,56416097,"Pin thay thế dành cho laptop Asus K551L, K551LN",749995,749995,0,0
TIKI,laptop-may-vi-tinh-linh-kien,196200927,"[Bộ Drum DR2255 + Mực TN2280] dùng cho máy in Brother HL 2240D, 2250DN, 2270DW, MFC 7360, 7860DW, DCP 7050, 7060D",415000,415000,0,0
TIKI,laptop-may-vi-tinh-linh-kien,21196892,"Pin dành cho laptop HP Probook 430 g3",348995,495000,146005,29
TIKI,laptop-may-vi-tinh-linh-kien,117815212,"Cụm trống Topjet 32A - CF232A/  dùng cho Canon 05-HP Laser M203a/M206/ 227dw/M230 Canon LBP 160, LBP 161dn, LBP 162dw, MF269DW (Có chíp) - Hàng Chính Hãng ",269500,269500,0,0
TIKI,laptop-may-vi-tinh-linh-kien,68610813,"Giá đỡ ống mực dùng cho Ricoh MP 1027, 2580, 2851, 2852, 3351, 3352, 3390",460000,460000,0,0
TIKI,laptop-may-vi-tinh-linh-kien,56750662,"Pin dành cho laptop Acer Aspire E1-470",281000,281000,0,0
TIKI,laptop-may-vi-tinh-linh-kien,198085707,"Mực in 003 dùng cho máy in Epson L3110, L1110, L3150",55000,55000,0,0
TIKI,laptop-may-vi-tinh-linh-kien,77015658,"Cáp nối USB 3.0 cho ổ cứng di động box HDD SSD WD",29925,31500,1575,5
TIKI,laptop-may-vi-tinh-linh-kien,17474656,"Cáp Mạng Lan Bấm Sẵn 2 Đầu Dài 15m",21820,21820,0,0
TIKI,laptop-may-vi-tinh-linh-kien,106423548,"Case Arduino Mega2560",37000,37000,0,0
TIKI,laptop-may-vi-tinh-linh-kien,8060644,"Hộp mực máy in 12A Dành Cho máy in Canon 2900 3000 HP 1010 1020",112000,112000,0,0
TIKI,laptop-may-vi-tinh-linh-kien,271488996,"Bo Mạch Chủ (Mainboard) GIGABYTE Z370 HD3 (HÀNG CHÍNH HÃNG)",2250000,2250000,0,0
TIKI,laptop-may-vi-tinh-linh-kien,50874090,"Cáp quang 1FO bấm sẵn 2 đầu SC",200000,200000,0,0
TIKI,laptop-may-vi-tinh-linh-kien,32204893,"Bộ 10 Chiếc Vòng Đánh Số Dây Mạng Cao Cấp AZONE",72000,77000,5000,6
TIKI,laptop-may-vi-tinh-linh-kien,54624822,"Vòng đánh dấu dây mạng - cao su 1000 số",89000,89000,0,0
TIKI,laptop-may-vi-tinh-linh-kien,59203466,"Hộp mực in SAHA 35A/36A/85A cho máy in HP, Canon - Hàng chính hãng",143000,143000,0,0
TIKI,laptop-may-vi-tinh-linh-kien,117094215,"Pin dành cho Laptop Lenovo Thinkpad L14 L15 L480 L490 L580 L590 01AV463 - Hàng Nhập Khẩu ",789000,839000,50000,6
TIKI,laptop-may-vi-tinh-linh-kien,73333451,"Mực in SAHA 26A sử dụng cho máy in HP M402 / 426 - Hàng chính hãng",198000,198000,0,0
TIKI,laptop-may-vi-tinh-linh-kien,98870800,"Bộ chia mạng Switch Tenda SG108 8 cổng Ethernet 1000Mbps - Hàng Chính Hãng",417000,417000,0,0
TIKI,laptop-may-vi-tinh-linh-kien,115097025,"Giấy in nhiệt A7 70x100mm in đơn , tem, mã vạch, phiếu gửi hàng, decal, dán,cho máy in bill và máy in nhiệt Khổ K80",28800,28800,0,0
TIKI,laptop-may-vi-tinh-linh-kien,59392986,"Hộp mực in SAHA 12A/FX9 cho máy in Laser HP. Canon - Hàng chính hãng",143000,143000,0,0
TIKI,laptop-may-vi-tinh-linh-kien,187623109,"Pin dành cho MacBook Pro 15 inch Battery A1990 2018 2019 (Genuine) A1953",2190000,2190000,0,0
TIKI,laptop-may-vi-tinh-linh-kien,67419385,"Hộp mực Thuận Phong TN118 dùng cho máy photocopy Konica Minolta bizhub 195 / 206 / 215 / 235 / 226 / 266 / 306 - Hàng Chính Hãng",450000,450000,0,0
TIKI,laptop-may-vi-tinh-linh-kien,36390829,"Đầu Đọc Mã Vạch Honeywell 1250G - Hàng Nhập Khẩu",1550000,1550000,0,0
TIKI,laptop-may-vi-tinh-linh-kien,74173005,"Sạc dành cho laptop Dell Vostro 14 3468 V3468, Inspiron 14 3467 N3467 Adapter 19.5V-2.31A, 19.5V-3.34A ",189000,189000,0,0
TIKI,laptop-may-vi-tinh-linh-kien,104851006,"Mực photocopy Thuận Phong (CHẤT LƯỢNG CAO) dùng cho máy Toshiba E550/ 650/ 810/ 520/ 600/ 720/ 850/ 523/ 603/ 723/ 853/ 556/ 656/ 756/ 856/ 557/ 657/ 757/ 857 - Hàng Chính Hãng",235000,235000,0,0
TIKI,laptop-may-vi-tinh-linh-kien,191950013,"Quạt Tản Nhiệt Công Suất Lớn Huqu ,Làm Mát Bán Dẫn Chuyên Dành Cho Game Thủ HQ-DL01-Hàng Chính Hãng ",494000,520000,26000,5
TIKI,laptop-may-vi-tinh-linh-kien,49729824,"Màn Hình Samsung LU28R550UQEXXV 28'' UHD 4K (3840×2160) 4ms 60Hz IPS AMD FreeSync - Hàng Chính Hãng",5990000,8190000,2200000,27
TIKI,laptop-may-vi-tinh-linh-kien,91251969,"Máy in phun màu đa năng Brother DCP-T220 - Hàng chính hãng",2990000,2990000,0,0
TIKI,laptop-may-vi-tinh-linh-kien,190726158,"Máy In Nhiệt Deli - In Đơn Hàng TMĐT, Hóa Đơn Vận Chuyển, Tem Nhãn Mã Vạch, Phiếu Gửi, Logo Không Cần Mực, Bill Thanh Toán, Mini Code, Bar Code - Tốc Độ 1s/đơn, Có Thể Dán Ngay - Kết Nối USB - Hàng Chính Hãng",934000,1744200,810200,46
TIKI,laptop-may-vi-tinh-linh-kien,19740582,"Rệp nối cáp mạng, rệp nối cáp thoại (100 hạt/hộp)",49800,49800,0,0
TIKI,laptop-may-vi-tinh-linh-kien,52664742,"Cáp mạng CAT7  đúc sẵn tốc độ 10Gbps/600MHz - Hàng chính hãng",110000,150000,40000,27
TIKI,laptop-may-vi-tinh-linh-kien,136978841,"USB 3.2 Gen 1 Kioxia U301 32GB - Hàng Nhập Khẩu",105000,105000,0,0
TIKI,laptop-may-vi-tinh-linh-kien,16392587,"RAM PC DDR4 Samsung 8GB Bus 2133 - Hàng Nhập Khẩu",484000,616000,132000,21
TIKI,laptop-may-vi-tinh-linh-kien,51424090,"Màn hình Cong Samsung LC32R500FHEXXV 31.5 inch FHD 75Hz - Hàng Chính Hãng",4090000,4090000,0,0
TIKI,laptop-may-vi-tinh-linh-kien,151967582,"Kích sóng wifi Xiaomi AC1200 RA75 Mi Wifi Range Extender - Hàng chính hãng",439000,439000,0,0
TIKI,laptop-may-vi-tinh-linh-kien,94768471,"Giấy in tem trà sữa , decal nhiệt 50x30",20800,20800,0,0
TIKI,laptop-may-vi-tinh-linh-kien,273048129,"Máy Chấm Công Quét Vân Tay Và Nhận Dạng Khuôn Mặt Deli – Hàng Chính Hãng - Màu Đen Phù Hợp Văn Phòng- Liên Kết File Excel Nhanh Chóng - E3765",1890000,3582000,1692000,47
TIKI,laptop-may-vi-tinh-linh-kien,96366264,"Bộ 4 Màu_Mực nước máy in màu, Chai 1L_cho máy Canon ix6770 /ix6860/ ix6820/ix6560 /G1000/G2000/G3000/G1010/G2010/G3010",620000,620000,0,0
TIKI,laptop-may-vi-tinh-linh-kien,459600,"Brother TN-1010 Toner Mực Cho Máy In DCP-1511, DCP-1514, DCP-1616NW, HL-1111, HL-1201, HL-1211W, MFC-1811 - Hàng Chính Hãng",330000,330000,0,0
TIKI,laptop-may-vi-tinh-linh-kien,72462227,"Dây cáp mạng Cat 8 tốc độ truyền dữ liệu 2000MHZ và 25Gbps UGREEN NW121 - Hàng chính hãng",200000,240000,40000,17
TIKI,laptop-may-vi-tinh-linh-kien,171233573,"Hộp mực 76A (CF276A) 057 dành cho máy in HP M404n, M428DW Canon LBP 223dw/ 226dw",169900,169900,0,0
TIKI,laptop-may-vi-tinh-linh-kien,95650953,"Mực in laser trắng đen Brother TN-B022 cho máy in HL-B series - Hàng chính hãng",550000,550000,0,0
TIKI,laptop-may-vi-tinh-linh-kien,72689407,"Phần mềm bảo vệ điện thoại Bkav Pro Mobile - Hàng chính hãng",70000,76000,6000,8
TIKI,laptop-may-vi-tinh-linh-kien,10001353,"RAM Laptop Samsung 16GB DDR4 2400MHz SODIMM - Hàng Nhập Khẩu",924000,1078000,154000,14
TIKI,laptop-may-vi-tinh-linh-kien,44345960,"10 cuộn giấy nhiệt in bill, in hóa đơn (thermal paper) TOPCASH K57mm phi 45mm dùng cho máy in nhiệt in hóa đơn, máy tính tiền. Hàng chính hãng",75000,75000,0,0
TIKI,laptop-may-vi-tinh-linh-kien,130805710,"Cục phát wifi 3G 4G lắp SIM tiết kiệm hơn internet cố định - MO818 ",860000,860000,0,0
TIKI,laptop-may-vi-tinh-linh-kien,49366640,"Combo 5 Đầu Nối Mạng 1 Ra 1- Đầu Mạng RJ45",16000,16000,0,0
TIKI,laptop-may-vi-tinh-linh-kien,77876730,"Ram PC Corsair Vengeance LPX 8GB 3200MHz DDR4 (1x8GB) CMK8GX4M1E3200C16 - Hàng Chính Hãng",549000,549000,0,0
TIKI,laptop-may-vi-tinh-linh-kien,163733255,"Cặp Loa máy tính xách tay loa laptop 1W 8 ohm 2512 25x12MM 8 ohm 8R 1W",52000,52000,0,0
TIKI,laptop-may-vi-tinh-linh-kien,763675,"Máy In Laser Đơn Năng Brother HL-L2366DW - Hàng Chính Hãng",3800000,4490000,690000,15
TIKI,laptop-may-vi-tinh-linh-kien,192156146,"Cáp Mạng Ngoài Trời HIDEKI Cat5e 8 Lõi Đồng, Có Sợi Thép Chịu Lực, Vỏ HDPE Siêu Bền -Hàng Chính Hãng",95000,95000,0,0
TIKI,laptop-may-vi-tinh-linh-kien,110938221,"[Có sẵn] Nâng cấp WiFi 5G dễ dàng với USB WIFI, card mạng usb, 600Mbps hai băng tầng 2.4 / 5GHz,cho máy bàn PC và laptop - Hàng nhập khẩu",139000,139000,0,0
TIKI,laptop-may-vi-tinh-linh-kien,16396285,"RAM PC DDR4 Samsung 4GB Bus 2400 - Hàng Nhập Khẩu",275000,350000,75000,21
TIKI,laptop-may-vi-tinh-linh-kien,192210428,"Ổ Cứng Di Động WD My Passport Ultra Hàng Chính Hãng",2730000,3890000,1160000,30
TIKI,laptop-may-vi-tinh-linh-kien,169479395,"Màn Hình Cong Gaming Samsung LC34G55TWWEXXV ( 34 Inch WQHD VA (3,440 x 1,440) 165Hz / 1ms / DP 1.4 / HDMI / Jack Audio 3.5 / Freesync ) - Hàng Chính Hãng",8490000,8490000,0,0
TIKI,laptop-may-vi-tinh-linh-kien,6452105,"Dây cáp mạng nối dài CAT6 UTP RJ45 dài 3M UGREEN NW112 11282  - Hàng chính hãng",119000,128000,9000,7
TIKI,laptop-may-vi-tinh-linh-kien,114441345,"Ổ Cứng Di Động HDD Seagate One Touch 2.5" USB 3.0 - Hàng Chính Hãng",1999000,1999000,0,0
TIKI,laptop-may-vi-tinh-linh-kien,19701154,"USB THU WIFI CHO MÁY TÍNH",42650,42650,0,0
TIKI,laptop-may-vi-tinh-linh-kien,10769836,"Ổ Cứng SSD Samsung 970 Evo Plus NVMe M.2 2280 (500GB) - Hàng Nhập Khẩu",2068000,2632000,564000,21
TIKI,laptop-may-vi-tinh-linh-kien,456525,"Bộ Chuyển Đổi USB Wifi TP-Link Archer T4U Băng Tần Kép MU-MIMO AC1300 - Hàng Chính Hãng",409000,409000,0,0
TIKI,laptop-may-vi-tinh-linh-kien,67179382,"Hộp Đựng Ổ Cứng ORICO 2020U3-BK 2.5"" SSD/HDD SATA 3 USB 3.0 Hàng Chính Hãng",126000,149000,23000,15
TIKI,laptop-may-vi-tinh-linh-kien,100405097,"Tem nhiệt tự dính VAYO 50x30mm, cuộn 30m |  tem trà sữa, decal nhiệt",31000,48000,17000,35
TIKI,laptop-may-vi-tinh-linh-kien,2388119,"Màn Hình Philips 243V7QDSB/74 23.8 Inch Full HD 5MS 60Hz IPS - Hàng Chính Hãng",2190000,2190000,0,0
TIKI,laptop-may-vi-tinh-linh-kien,459843,"Bộ Chuyển Đổi Không Dây TP-Link TL-WN881ND PCI Express Chuẩn N 300Mbps - Hàng Chính Hãng",249000,249000,0,0
TIKI,laptop-may-vi-tinh-linh-kien,80802851,"Ổ Cứng SSD Samsung 870 Evo 1TB 2.5-Inch SATA III - Hàng Nhập Khẩu (Box Anh)",2590000,2590000,0,0
TIKI,laptop-may-vi-tinh-linh-kien,170154615,"USB 3.2 GEN 1 KIOXIA U366 64GB - Hàng Nhập Khẩu",190000,190000,0,0
TIKI,laptop-may-vi-tinh-linh-kien,202805207,"Đèn treo màn hình máy tính Yeelight LED Screen Light Bar Monitor Pro, hắt sáng 16 triệu màu, tăng giảm cường độ ánh sáng chống mỏi mắt và bảo vệ mắt khỏi ánh sáng xanh - Hàng Chính Hãng",617000,650000,33000,5
TIKI,laptop-may-vi-tinh-linh-kien,49078809,"1 Xấp thẻ chấm công dùng cho máy chấm công giấy - Hàng nhập khẩu",99000,99000,0,0
TIKI,laptop-may-vi-tinh-linh-kien,145290700,"Bàn phim cơ có dây K80 LED RGB TKL 87 phím, Bàn phím chuyên game . máy tính văn phòng LED RGB siêu đẹp",352687,371249,18562,5
TIKI,laptop-may-vi-tinh-linh-kien,193570107,"Giấy Decal Nhiệt In Nhãn Minicode Đơn Hàng TMĐT Deli - Tệp 500 Tờ 12x8cm - Dùng Cho Bill, Mã Vạch, Hóa Đơn, Livestream, Kinh Doanh Online - Không Phai Mực - Hàng Chính Hãng - CP001",72000,135000,63000,47
TIKI,laptop-may-vi-tinh-linh-kien,4981861,"USB SanDisk CZ430 Ultra Fit 128GB - USB 3.1 - Hàng Chính Hãng",250000,330000,80000,24
TIKI,laptop-may-vi-tinh-linh-kien,74162456,"Bộ Phát Wifi TP-Link Archer C80 Băng Tần Kép MU-MIMO AC1900 - Hàng Chính Hãng",1798000,1798000,0,0
TIKI,laptop-may-vi-tinh-linh-kien,15129417,"USB Bluetooth cho PC , Laptop 4.0  - Tạo kết nối không dây cho PC , Laptop",22000,22000,0,0
TIKI,laptop-may-vi-tinh-linh-kien,128272421,"Ổ Cứng HDD WD Red Plus 4TB 3.5 inch SATA iii - Hàng Nhập Khẩu",3245000,3540000,295000,8
TIKI,laptop-may-vi-tinh-linh-kien,120491328,"Card mở rộng ổ cứng SSD M.2 qua khe PCI-E 3.0 X16 Orico PSM2-X16 - Hàng chính hãng",139000,150000,11000,7
TIKI,laptop-may-vi-tinh-linh-kien,10868001,"Sạc Laptop Đa Năng 8 Đầu - Sạc Đa Năng",96000,96000,0,0
TIKI,laptop-may-vi-tinh-linh-kien,575505,"HDD Box ORICO USB3.0/3.5/2.5 - 3588US3 - Hàng Chính Hãng",429000,429000,0,0
TIKI,laptop-may-vi-tinh-linh-kien,49994696,"Bộ chuyển đổi quang điện 10/100M Single Fiber Netlink HTB-3100A\B (1 Sợi quang) - Hàng Nhập Khẩu",299000,311500,12500,4
TIKI,laptop-may-vi-tinh-linh-kien,562293,"Linksys LGS105 - Unmanaged Switch - Hàng Chính Hãng",890000,890000,0,0
TIKI,laptop-may-vi-tinh-linh-kien,14381105,"Hộp mực Samsung MLT D111S, Samsung LS-M2020/2020W/M2022/M2022W/M2070/M2070F - Hàng nhập khẩu",350000,350000,0,0
TIKI,laptop-may-vi-tinh-linh-kien,45806716,"COMBO 2 ĐẦU NỐI MẠNG LAN",6900,6900,0,0
TIKI,laptop-may-vi-tinh-linh-kien,15647704,"Hộp mực in 325 dùng cho máy in Canon MF3010, LBP 6030, LBP 6000",119000,119000,0,0
TIKI,laptop-may-vi-tinh-linh-kien,108845575,"Nguồn adapter 9V 1A 2A 3A",35000,35000,0,0
TIKI,laptop-may-vi-tinh-linh-kien,58583531,"Quạt tản nhiệt, Fan case coolmoon V2.2 Led RGB 2 vòng ring - Hàng chính hãng",69000,69000,0,0
TIKI,laptop-may-vi-tinh-linh-kien,21301334,"Dây Cáp Mạng Orico PUG-C6B- CAT6 (Đen) Hàng Chính Hãng",59000,59000,0,0
TIKI,laptop-may-vi-tinh-linh-kien,21948650,"Caddy bay chuẩn SATA 9.5mm 12.7mm nhôm sần cao cấp, tặng tovit",28000,28000,0,0
TIKI,laptop-may-vi-tinh-linh-kien,113567242,"Router Wifi cho gia đình Ruijie Reyee RG-EW1200G Pro, Hàng Chính Hãng.",740000,740000,0,0
TIKI,laptop-may-vi-tinh-linh-kien,20692185,"Hộp mực 35a, 312 in đẹp, nhập khẩu mới. Là Cartridge, catrich, toner dùng cho máy in HP P1005, 1006, 1007, 1008, Canon LBP 3050, 3010, 3100, 3108, 3118, 3150 ",110000,110000,0,0
TIKI,laptop-may-vi-tinh-linh-kien,16079268,"[ Set 10 cuộn] Giấy nhiệt in bill K80 phi 80 - Hàng nhập khẩu",177900,177900,0,0
TIKI,laptop-may-vi-tinh-linh-kien,68544588,"Cáp mạng APTek CAT.6 FTP 305m ( 630-2104-1) - Hàng Chính Hãng",1639230,1639230,0,0
TIKI,laptop-may-vi-tinh-linh-kien,56442086,"Pin dành cho Laptop Dell Vostro 14 3468",444000,444000,0,0
TIKI,laptop-may-vi-tinh-linh-kien,6081021,"Bộ 5 chai Mực đổ Thuận Phong TP01 dùng cho máy in HP / Canon - Hàng Chính Hãng",120000,120000,0,0
TIKI,laptop-may-vi-tinh-linh-kien,12332218,"Sạc dành cho laptop Dell 19.5v-3.34a đầu kim nhỏ",187995,187995,0,0
TIKI,laptop-may-vi-tinh-linh-kien,456516,"TP-Link  TL-SF1016D - Switch Chia Tín Hiệu Để Bàn 16 Cổng 10/100Mbps - Hàng Chính Hãng",489000,599000,110000,18
TIKI,laptop-may-vi-tinh-linh-kien,27933205,"Bộ mở rộng sóng Wi-Fi TP-Link RE305 (Trắng) - Hàng chính hãng",899000,899000,0,0
TIKI,laptop-may-vi-tinh-linh-kien,22100084,"Sạc cho Laptop Sony Vaio 19.5v-4.7a",176000,245000,69000,28
TIKI,laptop-may-vi-tinh-linh-kien,20610537,"Hộp mực máy in 26a in đẹp, có sẵn chíp, nhập khẩu mới. Gọi là Cartridge, catrich, toner dùng cho máy in HP Pro M402, m402d, m402n, m402dn, m402dw, M426, m426fn, m426dfn",185000,185000,0,0
TIKI,laptop-may-vi-tinh-linh-kien,73687094,"Sạc Dành Cho Laptop Dell Vostro 5460, 5470, 5560, 5570, Inspiron 5439, 20, 3043 - Đầu Nhỏ Size 4.0mm×1.7mm",187000,285000,98000,34
TIKI,laptop-may-vi-tinh-linh-kien,53134055,"Miếng Dán Bảo Vệ Màn Hình Laptop 14 inch",49500,85000,35500,42
TIKI,laptop-may-vi-tinh-linh-kien,19844684,"HỘP MỰC 12A H-Q2612A",118900,118900,0,0
TIKI,laptop-may-vi-tinh-linh-kien,32330182,"Hộp mực TN-2260, TN-2280 dùng cho máy in Brother HL-2240,  2250, 2270, DCP-7060,  MFC 7360, 7470, 7860 - Hàng nhập khẩu 100%",118000,118000,0,0
TIKI,laptop-may-vi-tinh-linh-kien,58807632,"Sạc dành cho Laptop HP Pavilion 15-BS767TX Adapter 19.5V-3.33A",174000,174000,0,0
TIKI,laptop-may-vi-tinh-linh-kien,100405873,"Remote thay thế cho các dòng máy chiếu Epson",155000,155000,0,0
TIKI,laptop-may-vi-tinh-linh-kien,70833324,"Máy in nhiệt in hóa đơn in bill khổ K80 Xprinter XP-N160ii cổng USB + Bluetooth ( Hàng chính hãng)",1588000,1588000,0,0
TIKI,laptop-may-vi-tinh-linh-kien,21933814,"Bàn phím cho Laptop Dell 3521 3537 5521 2521",145000,145000,0,0
TIKI,laptop-may-vi-tinh-linh-kien,56380242,"Giấy in nhiệt K57x38mm thùng 100 cuộn",395000,395000,0,0
TIKI,laptop-may-vi-tinh-linh-kien,16301033,"Hộp mực 26A cho máy in HP MFP M426fdn, M402dw, M402n",169500,169500,0,0
TIKI,laptop-may-vi-tinh-linh-kien,121063550,"Bộ Chia Mạng Mercusys MS108G 8 Cổng 10/100/1000 Mbps - Hàng Chính Hãng",320000,320000,0,0
TIKI,laptop-may-vi-tinh-linh-kien,97815365,"Bộ lưu điện UPS PROLiNK PRO851SFCU (850VA) công suất 480W, tích hợp bộ AVR, sạc siêu nhanh, dùng cho PC, Camera, Wifi - Hàng chính hãng",1369000,2499000,1130000,45
TIKI,laptop-may-vi-tinh-linh-kien,75590201,"Router Wifi 6 băng tần 2,4/5Ghz TP-Link Archer AX10 - Hàng Chính Hãng",959000,959000,0,0
TIKI,laptop-may-vi-tinh-linh-kien,67224380,"Màn hình LCD Philips 23.8" 241V8 (1920 x 1080/IPS/75Hz/4 ms -Hàng Chính Hãng",2390000,2390000,0,0
TIKI,laptop-may-vi-tinh-linh-kien,3148515,"Nguồn Adaptor Sony (12V - 5A)",90000,90000,0,0
TIKI,laptop-may-vi-tinh-linh-kien,128134223,"Ổ Cứng Di Động SSD WD My Passport USB Type C 3.2 Gen 2 - Hàng Nhập Khẩu",4235000,5110000,875000,17
TIKI,laptop-may-vi-tinh-linh-kien,10001377,"RAM Laptop Hynix 8GB DDR4 2666MHz SODIMM - Hàng Nhập Khẩu",484000,588000,104000,18
TIKI,laptop-may-vi-tinh-linh-kien,68250770,"Đèn bàn treo màn hình máy tính Baseus 3 chế độ sáng,tăng giảm cường độ ánh sáng chống mỏi mắt và bảo vệ mắt khỏi ánh sáng xanh - Hàng nhập khẩu",470499,470499,0,0
TIKI,laptop-may-vi-tinh-linh-kien,21222577,"BÀN PHÍM CƠ GAME THỦ K28 (CK87) CÓ ĐÈN LED NHIỀU MÀU",464900,464900,0,0
TIKI,laptop-may-vi-tinh-linh-kien,405252,"USB Kingston DT100G3 - 64GB - USB 3.0 - Hàng Chính Hãng",249000,249000,0,0
TIKI,laptop-may-vi-tinh-linh-kien,91626162,"Cục phát wifi mạnh 4G siêu chất lượng, sóng cực khỏe, cực nhanh, tốc độc cực cao - Bộ phát wifi từ sim 3G 4G tốc độ cao",640000,640000,0,0
TIKI,laptop-may-vi-tinh-linh-kien,191004752,"Sound card âm thanh V8S+ nâng cấp sử dụng với mọi thiết bị",198000,198000,0,0
TIKI,laptop-may-vi-tinh-linh-kien,51510178,"Bộ Phát WIFI Từ SIM 3G/4G LTE 4G – CPE A – 300MBPS – 3 Cổng Lan - Router WIfi ( Không Kèm Sim )",799000,799000,0,0
TIKI,laptop-may-vi-tinh-linh-kien,137741171,"Ổ Cứng Di Động HDD WD My Book 3.5 USB 3.0 - Hàng Nhập Khẩu",3905000,4970000,1065000,21
TIKI,laptop-may-vi-tinh-linh-kien,94060544,"Bộ đổi điện 12v thành 220v 1200W",349000,349000,0,0
TIKI,laptop-may-vi-tinh-linh-kien,194134411,"Cục PhátWifi 4 Râu PIX-LINK LV-WR08Q, Modem Wifi 300Mbps Cường Độ Sóng Khỏe, Phủ Sóng Rộng - Hàng chính hãng",299000,598000,299000,50
TIKI,laptop-may-vi-tinh-linh-kien,1605999,"Máy In Ảnh Canon SELPHY CP1300 Wifi",3350000,3790000,440000,12
TIKI,laptop-may-vi-tinh-linh-kien,575516,"Khay Đựng Ổ Cứng Docking ORICO USB3.0/3.5/2.5 - 6218US3 - Hàng Chính Hãng",415000,450000,35000,8
TIKI,laptop-may-vi-tinh-linh-kien,82842068,"Hộp mực TN263 BK/C/Y/M dành cho máy in Brother HL 3230CDN, 3270CDW, DCP 3551CDW, MFC-3770CDW, 3750CDW",550000,550000,0,0
TIKI,laptop-may-vi-tinh-linh-kien,120562531,"Giấy Decal Nhiệt In Nhãn, Minicode, Đơn Hàng TMĐT Deli -  Cuộn 325 Tờ 10x15cm - Dùng Cho Bill, Mã Vạch, Hóa Đơn, Livestream, Kinh Doanh Online - Không Phai Mực - Hàng Chính Hãng - 12308",27000,52200,25200,48
TIKI,laptop-may-vi-tinh-linh-kien,23171782,"Bộ phát sóng Wifi Tenda 4 anten 300Mps F6 - Hàng Chính Hãng",275000,275000,0,0
TIKI,laptop-may-vi-tinh-linh-kien,111852215,"Ổ Cứng Di Động WD Elements Portable 750GB 2.5 USB 3.0 - WDBUZG7500ABK-WESN - Hàng Chính Hãng",1290000,1590000,300000,19
TIKI,laptop-may-vi-tinh-linh-kien,76664325,"Nguồn máy tính GIGABYTE GP-P750GM 750W 80 PLUS  - Hàng Chính Hãng",1790000,1790000,0,0
TIKI,laptop-may-vi-tinh-linh-kien,171233751,"Mực đổ máy in - loại in đậm dành cho canon 2900, 3300, 3050....Hp 400, 2035, 2055, 402, 1020",25000,25000,0,0
TIKI,laptop-may-vi-tinh-linh-kien,1822397,"Dây Cáp Mạng Orico PUG-C6-50 CAT6 5m - Hàng Chính Hãng",69000,69000,0,0
TIKI,laptop-may-vi-tinh-linh-kien,190794920,"Ổ Cứng Di Động Toshiba Canvio Ready Hàng Chính Hãng",2150000,2150000,0,0
TIKI,laptop-may-vi-tinh-linh-kien,29406210,"Usb 3.0 Ra Lan Dây | USB 3.0 To Lan 10-100-1000 Mbps Gigabit - USB Sang Lan",96000,96000,0,0
TIKI,laptop-may-vi-tinh-linh-kien,119326682,"Ổ cứng SSD KingSpec P4 120GB - MỚI [Hàng Chính Hãng",438000,438000,0,0
TIKI,laptop-may-vi-tinh-linh-kien,183580155,"Bàn phím cơ máy tính - Bàn phím cơ gaming Crack K2 PRO, LED RGB 10 chế độ nháy khác nhau dành cho máy tính, laptop",350455,368900,18445,5
TIKI,laptop-may-vi-tinh-linh-kien,124483882,"RAM Máy bàn PC DDR4 Samsung 8GB Bus 3200 - Hàng Nhập Khẩu",528000,630000,102000,16
TIKI,laptop-may-vi-tinh-linh-kien,15644245,"Hộp mực in 328 cho máy in Canon LBP6200D/ LBP6230DN",118500,118500,0,0
TIKI,laptop-may-vi-tinh-linh-kien,178554411,"Màn Chiếu 3 Chân Apollo 120 inch - Hàng Chính Hãng",990000,990000,0,0
TIKI,laptop-may-vi-tinh-linh-kien,115651566,"Giá treo màn hình máy tính Human Motion T6 - Hàng Chính Hãng",629000,690000,61000,9
TIKI,laptop-may-vi-tinh-linh-kien,57740632,"Hộp mực in 30A dùng cho máy in Hp LaserJet HP Pro M203dn / HP Pro M203dw / HP MFP M227fdw / HP MFP M227sdn",139000,139000,0,0
TIKI,laptop-may-vi-tinh-linh-kien,52712262,"Máy chiếu mini nhỏ gọn KH-03",792000,1079000,287000,27
TIKI,laptop-may-vi-tinh-linh-kien,107278170,"Bộ Phát Wifi Xiaomi Router 4A Gigabit Hàng chính hãng",690000,690000,0,0
TIKI,laptop-may-vi-tinh-linh-kien,139268973,"Bộ vỏ dựng lại cho máy in Canon 2900 - Hàng mới, gồm 07 món full",390000,390000,0,0
TIKI,laptop-may-vi-tinh-linh-kien,37891357,"Màn hình AOC  27B1H/74 27 inches FHD IPS - Hàng chính hãng",2950000,2950000,0,0
TIKI,laptop-may-vi-tinh-linh-kien,96070783,"Pin dành cho Laptop DELL Inspiron 15-3000 - M5Y1K 40Wh ",550000,550000,0,0
TIKI,laptop-may-vi-tinh-linh-kien,63562014,"Máy in màu HP Color Laser 150a,1Y WTY_4ZB94A – Hàng chính hãng",6190000,6190000,0,0
TIKI,laptop-may-vi-tinh-linh-kien,41619877,"Bàn phím giả cơ FREE WOLF K15 chơi game - hàng nhập khẩu",146300,146300,0,0
TIKI,laptop-may-vi-tinh-linh-kien,11255377,"Sạc Dành Cho Laptop Asus 19V - 2.37A Chân Thường (hình vuông)",285000,285000,0,0
TIKI,laptop-may-vi-tinh-linh-kien,208120240,"Màn Chiếu Treo Tường Dalite 136 Inch - Hàng Chính Hãng",1150000,1150000,0,0
TIKI,laptop-may-vi-tinh-linh-kien,22365510,"Ổ Cứng Di Động SSD Transcend ESD240C 120GB 2.5" USB Type C - TS120GESD240C - Hàng Chính Hãng",899000,959000,60000,6
TIKI,laptop-may-vi-tinh-linh-kien,190863875,"Ổ cứng di động Toshiba Canvio Advance Hàng Chính Hãng",1290000,2450000,1160000,47
TIKI,laptop-may-vi-tinh-linh-kien,193777936,"Băng mực in ống lồng cho Brother TR-100BK - Hàng nhập khẩu",180000,180000,0,0
TIKI,laptop-may-vi-tinh-linh-kien,12071752,"Drum Cho Máy HL-B-series Brother DR-B022 - Hàng Chính Hãng",700000,700000,0,0
TIKI,laptop-may-vi-tinh-linh-kien,708883,"Bộ Phát Wifi Mercusys MW305R Chuẩn N 300Mbps - Hàng Chính Hãng",299000,349000,50000,14
TIKI,laptop-may-vi-tinh-linh-kien,79451459,"Bộ card WIFI Bluetooth Intel WIFI 6E AX210 5Ghz tốc độ 2400M và Bluetooth 5.2 cho máy bàn - Hàng nhập khẩu",510000,510000,0,0
TIKI,laptop-may-vi-tinh-linh-kien,6997381,"Mực in Brother TN 2385 Black Toner Cartridge (TN 2385)",480000,480000,0,0
TIKI,laptop-may-vi-tinh-linh-kien,29463821,"Máy Scan cầm tay Procam 900DPI Cao Cấp AZONE - Hàng Nhập Khẩu",935000,999000,64000,6
TIKI,laptop-may-vi-tinh-linh-kien,16613522,"RAM PC DDR4 Samsung 16GB Bus 2666 - Hàng Nhập Khẩu",935000,1148000,213000,19
TIKI,laptop-may-vi-tinh-linh-kien,67106618,"Mực HA Brother nạp ( đổ ) cho máy in Brother Dùng cho máy: HL1111, 1010, 1110, , 1510, 1511, 1610, 1616, 1810, 1811, 1815  HL 1200, 1201/ HL 1211W/ DCP 1510/ DCP 1601/ DCP 1616NW/ MFC 1811/ MFC 1901/ MFC 1916NW, Xerox P115/ HL 2030, 2040, 2050, 2070, 2820",45000,45000,0,0
TIKI,laptop-may-vi-tinh-linh-kien,66481239,"Bộ nhớ ngoài Sandisk CZ33-64GB Cruzer Fit - Hàng Chính Hãng",120000,120000,0,0
TIKI,laptop-may-vi-tinh-linh-kien,10001330,"RAM Laptop Samsung 16GB DDR4 2133MHz SODIMM - Hàng Nhập Khẩu",935000,1106000,171000,15
TIKI,laptop-may-vi-tinh-linh-kien,196389904,"Ổ cứng Silicon Power 2.5 inch SATA SSD A56 512GB - Hàng chính hãng",1187000,1187000,0,0
TIKI,laptop-may-vi-tinh-linh-kien,185591895,"Cục Phát Wifi 4G Huawei B535 Công Nghệ 4G LTE CAT7 - Tốc độ 300Mb, 2 Băng Tần đồng thời, 4 cổng LAN , Tặng Kèm 2 Ăng Ten Hàng Chính Hãng",1768000,1768000,0,0
TIKI,laptop-may-vi-tinh-linh-kien,141366135,"Dock Ổ Cứng 3.5 / 2.5 USB 3.0 - Biến HDD Thường Thành HDD Di Động - Dock Cáp",90000,90000,0,0
TIKI,laptop-may-vi-tinh-linh-kien,205031081,"Hộp mực cho máy in canon 223DW /226DW/MF 440/MF445DW/MF 449x",250000,250000,0,0
TIKI,laptop-may-vi-tinh-linh-kien,17614393,"KÌM MẠNG SK-868 BẤM RJ45/11/12",129000,129000,0,0
TIKI,laptop-may-vi-tinh-linh-kien,92559172,"Dây mạng bấm sẵn 2 đâu đúc 1,5M - Dây bấm sẵn 1,5 đầu RJ45 - bsjr45 - rj45 2m",11800,11800,0,0
TIKI,laptop-may-vi-tinh-linh-kien,8018484,"Bộ Kích Sóng Wifi Tenda A9 2.4GHz 300Mbps - Hàng Nhập Khẩu",219000,219000,0,0
TIKI,laptop-may-vi-tinh-linh-kien,22411528,"Giá treo máy chiếu đa năng  60cm ( Hàng nhập khầu)",150000,150000,0,0
TIKI,laptop-may-vi-tinh-linh-kien,161298085,"Usb Phát Wifi Từ Sim 4G OLAX U90 Tốc Độ 150Mb Hỗ Trợ 10 Kết Nối, Sử Dụng Nguồn Điện Usb 5v Hoạt Động Liên Tục , Kèm Sim 4G Mobifone - Hàng Chính hãng",629000,629000,0,0
TIKI,laptop-may-vi-tinh-linh-kien,53320921,"Hộp mực máy in canon Lbp 6030 / máy in HP 1102 ",117900,117900,0,0
TIKI,laptop-may-vi-tinh-linh-kien,72214499,"Mực in chính hãng Epson 003 (dùng cho máy L1110/L3110/L3150/L5190)-HÀNG CHÍNH HÃNG",234500,234500,0,0
TIKI,laptop-may-vi-tinh-linh-kien,15680869,"Cụm drum (trống mực) DR 2385 cho máy in Brother HL- L2361DN, L2366DW, L2321D. DCP- L2520D. MFC- L2701DW",179000,179000,0,0
TIKI,laptop-may-vi-tinh-linh-kien,24635552,"Dây mạng bấm sẵn cat5 30m",36000,64900,28900,45
TIKI,laptop-may-vi-tinh-linh-kien,10001355,"RAM Laptop Hynix 4GB DDR4 2400MHz SODIMM - Hàng Nhập Khẩu",264000,336000,72000,21
TIKI,laptop-may-vi-tinh-linh-kien,120463372,"USB Wifi không dây 802.11N - Thu sóng wifi cho máy tính pc, laptop, usb mini không dây loại tốt có tặng kèm đĩa cài",38000,41900,3900,9
TIKI,laptop-may-vi-tinh-linh-kien,183377486,"Ổ cứng SSD Dahua C800A 120GB SATA 6Gb/s - Hàng Chính Hãng",325000,325000,0,0
TIKI,laptop-may-vi-tinh-linh-kien,416701,"D-Link DIR-612 - Bộ phát Wifi chuẩn N 300Mbps Mở rộng sóng - Hàng Chính Hãng",240000,240000,0,0
TIKI,laptop-may-vi-tinh-linh-kien,107125562,"Combo 5 chai Mực nạp 35A 85A 78A 79A 83A 48A LBP 337 312 313 325 326 328",105000,105000,0,0
TIKI,laptop-may-vi-tinh-linh-kien,21479828,"Hộp mực 12A hộp mực Dành Cho máy in Canon 2900 HPQ2612A 1020 M1005 M1010 1018",114900,114900,0,0
TIKI,laptop-may-vi-tinh-linh-kien,416985,"TP-Link  TL-WN822N - USB Wifi (high gain) chuẩn N tốc độ 300Mbps - Hàng Chính Hãng",259000,379000,120000,32
TIKI,laptop-may-vi-tinh-linh-kien,31889294,"Keo Tản Nhiệt Noctua NT-H1 (10g) - Hàng Chính Hãng",379000,379000,0,0
TIKI,laptop-may-vi-tinh-linh-kien,31262507,"USB Thu Wifi cho PC - Laptop LB-Link - Hàng Chính Hãng",69000,69000,0,0
TIKI,laptop-may-vi-tinh-linh-kien,178313937,"Đèn máy tính Xiaomi Mijia Display Hanging - Hàng nhập khẩu",990000,990000,0,0
TIKI,laptop-may-vi-tinh-linh-kien,80980996,"USB Thu Wifi Chuẩn N Tốc Độ Cao 150Mbps Tăng Khả Phạm Vi Thu Phát Sóng Wifi Cho Máy Tính Xách Tay, Máy Tính Để Bàn, Thiết Bị Thu Nhận Ngoại Vi ",175000,175000,0,0
TIKI,laptop-may-vi-tinh-linh-kien,56190273,"Máy In Laser Đen Trắng HP 107A (4ZB77A) – Hàng Chính Hãng",2690000,2690000,0,0
TIKI,laptop-may-vi-tinh-linh-kien,6816557,"Vỏ Hộp đựng ổ cứng 3.5 inch Sata/USB 3.0 hỗ trợ 10TB UGREEN 50422 - Hàng Chính Hãng",450000,590000,140000,24
TIKI,laptop-may-vi-tinh-linh-kien,68269617,"Quả đào kéo giấy cho máy in Canon 2900, 3000, 4122, 4150, 4350, 4320, 4680, HP  1010, 1019, 1012, 1015, 1018, 1020, 1022, 3030 ,3050, 3055, ",16500,16500,0,0
TIKI,laptop-may-vi-tinh-linh-kien,101423565,"Box HDD 2.5 USB 3.0",105000,105000,0,0
TIKI,laptop-may-vi-tinh-linh-kien,73636116,"Sạc dành cho laptop Acer Aspire E5-575, E5-575G",124000,124000,0,0
TIKI,laptop-may-vi-tinh-linh-kien,67179748,"Hộp Đựng Ổ Cứng ORICO 2521U3 (Đen) 2.5" SSD/HDD SATA 3 USB 3.0 - Hàng Chính Hãng",125000,125000,0,0
TIKI,laptop-may-vi-tinh-linh-kien,3717809,"Bộ 4 Màu Mực in phun Thuận Phong TP50 (500ml) dùng cho máy in phun Epson, HP, Canon - Hàng Chính Hãng",420000,420000,0,0
TIKI,laptop-may-vi-tinh-linh-kien,181358603,"Video Capture Card 4K HDMI USB 3.0 Vinetteam Full HD 1080p 60fps Video Capture Game Livestream Dành Cho PS4, Nintendo, Xbox, Camcorder - Hàng Chính Hãng",599000,650000,51000,8
TIKI,laptop-may-vi-tinh-linh-kien,14242308,"Bộ chia HDMI 1 ra 4 loại mạch ngắn",109578,109578,0,0
TIKI,laptop-may-vi-tinh-linh-kien,192549132,"Ổ Cứng Transcend SSD 220S 2.5inch Hàng Chính Hãng",600000,600000,0,0
TIKI,laptop-may-vi-tinh-linh-kien,13678777,"Bộ 3 tuýp keo tản nhiệt xám to",24900,24900,0,0
TIKI,laptop-may-vi-tinh-linh-kien,6069755,"(Bộ 5 chai) Mực đổ Thuận Phong TP03 dùng cho máy in HP / Canon – Hàng Chính Hãng",150000,150000,0,0
TIKI,laptop-may-vi-tinh-linh-kien,58587212,"Nguồn 5V 2A Chuyên Dụng Converter Cáp Quang 2 Loại Lớn/Nhỏ",39600,39600,0,0
TIKI,laptop-may-vi-tinh-linh-kien,196425212,"Đĩa trắng CD Maxell (Hộp 50c) - JL - HÀNG CHÍNH HÃNG",245000,245000,0,0
TIKI,laptop-may-vi-tinh-linh-kien,171233497,"Cụm Drum 32A – Cụm Drum Trống 30A (Có chip) – Drum Unit CF232A",168000,168000,0,0
TIKI,laptop-may-vi-tinh-linh-kien,130168842,"Máy đếm tiền OUDIS  3700C - Hàng chính hãng",2590000,2590000,0,0
TIKI,laptop-may-vi-tinh-linh-kien,25905129,"Decal in tem nhãn, mã vạch 25x15 mm, 4 tem/ hàng, khổ 110mm, cuộn dài 50m",56000,56000,0,0
TIKI,laptop-may-vi-tinh-linh-kien,962903,"Bo Mạch Chủ Mainboard GIGABYTE H81M-DS2(V3.0) (SK1150) - Hàng Chính Hãng",1290000,1290000,0,0
TIKI,laptop-may-vi-tinh-linh-kien,112934207,"Chíp Mực Dùng Cho Máy photocopy Sharp MX237 AT - Dùng cho máy photo Sharp AR-6020D/6023D Hàng Chất Lượng Ổn Định",60000,60000,0,0
TIKI,laptop-may-vi-tinh-linh-kien,53812814,"Card WIFI Bluetooth cho PC sử dụng chip Intel AC 8260 khe PCI cho  tích hợp Bluetooth 4.2 tốc độ 867M có tản nhiệt",290000,290000,0,0
TIKI,laptop-may-vi-tinh-linh-kien,262455703,"Hộp mực máy in 12A Dành Cho máy in Canon 2900 3000 HP 1010 1020",120000,120000,0,0
TIKI,laptop-may-vi-tinh-linh-kien,35446107,"màn chiếu điện apollo - Hàng chính hãng",1150000,1150000,0,0
TIKI,laptop-may-vi-tinh-linh-kien,56308598,"Pin dành cho HP Mã KI04, Pin Laptop HP (Model KI04) ",282900,282900,0,0
TIKI,laptop-may-vi-tinh-linh-kien,20225198,"Hộp mực máy in 12a in đẹp, nhập khẩu mới. Gọi là Cartridge, catrich, toner Dành Cho máy in HP 1020, 1010, 1012, 1015, 1018, 1022, 1319f",110000,110000,0,0
TIKI,laptop-may-vi-tinh-linh-kien,164304313,"Hộp mực sử dụng cho máy in Canon MF241d, 244dw, 211, 221d, LBP 151dw/ HP LaserJet M127, M126, 125 (83A/337 (Cartridge)",119000,119000,0,0
TIKI,laptop-may-vi-tinh-linh-kien,105249931,"Bút trình chiếu đèn lazer màu xanh cho màn hình TV, máy chiếu dùng pin sạc",200000,200000,0,0
TIKI,laptop-may-vi-tinh-linh-kien,43928782,"Hộp mực 12A Dành Cho Canon LBP 2900 3000, HP 1010 1015, Có lỗ đổ mực, mực thải",116500,116500,0,0
TIKI,laptop-may-vi-tinh-linh-kien,186876422,"RAM Laptop Kingmax 8GB 3200 DDR4 - Hàng Chính Hãng",690000,690000,0,0
TIKI,laptop-may-vi-tinh-linh-kien,206944800,"Màn hình đồ họa Samsung ViewFinity S8 UHD LS32B800PXEXXV( 32 inch ( 3,840 x 2,160 ) IPS / 60Hz / 5ms / Display Port / HDMI / USB Hub / USB - C Charging 90W ) - Hàng Chính Hãng",9350000,9350000,0,0
TIKI,laptop-may-vi-tinh-linh-kien,15163759,"Dây nguồn PC, Máy in, Máy Chiếu, dây nguồn máy tính dài 1.5-2m, dây nguồn lõi đồng tương thích với đồ gia dụng chất lượng cao ",15000,15000,0,0
TIKI,laptop-may-vi-tinh-linh-kien,105175709,"Két đựng tiền thu ngân, Ngăn kéo đựng tiền dùng cho Thu ngân CASH DRAWER TOPCADH JJ-330EG có 9 ngăn – Hàng cao cấp chính hãng",655000,780000,125000,16
TIKI,laptop-may-vi-tinh-linh-kien,67202201,"[20 CUỘN] Giấy in nhiệt Giấy in bill VAYO Khổ 80 x 45 mm - In rõ nét - Lõi siêu nhỏ - Hàng chính hãng - 65gsm",136000,150000,14000,9
TIKI,laptop-may-vi-tinh-linh-kien,169183222,"USB 3.2 Gen 1 Kioxia TransMemory U365 32GB - Hàng Nhập Khẩu",140000,140000,0,0
TIKI,laptop-may-vi-tinh-linh-kien,57017920,"Hộp mực 052, cho Canon LBP 212DW, 214dw, 215dw, 421DW, MF424dw, 429dw. In đẹp, mới 100%, có sẵn chíp. Là Cartridge, catrich, toner máy in",189000,189000,0,0
TIKI,laptop-may-vi-tinh-linh-kien,1986201,"Sạc Dành Cho Laptop HP 18.5V - 3.5A, 65W, Đầu Kim ",147111,147111,0,0
TIKI,laptop-may-vi-tinh-linh-kien,539070,"Ổ Cứng SSD Apacer AS340 240GB - Hàng Chính Hãng",580000,580000,0,0
TIKI,laptop-may-vi-tinh-linh-kien,24387155,"Hộp mực cho Fuji Xerox 115w in đẹp. Là Cartridge, catrich, toner dùng cho máy in Fuji Xerox Docuprint M115w, F115w, P115w, cp115w laser trắng đen",127000,127000,0,0
TIKI,laptop-may-vi-tinh-linh-kien,11121806,"Hộp mực 05A/80A, hộp mực cho Canon LBP 6300DN, HP 2035 2055, Có lỗ đổ mực, mực thải",169000,169000,0,0
TIKI,laptop-may-vi-tinh-linh-kien,17901332,"Hộp mực cho máy in Xerox DocuPrint P225d, P225db, M225dw, M225z, M265z, P265dw",129000,129000,0,0
TIKI,laptop-may-vi-tinh-linh-kien,23284720,"Pin cho Laptop DELL Inspiron 15 - 5568 7560 5567 / 13 - 5378 5379 7368",579998,579998,0,0
TIKI,laptop-may-vi-tinh-linh-kien,72193684,"Cáp mạng APTEK Cable CAT 6 UTP 305m (630-1102-1) 1Gbps - Hàng Chính Hãng",1436000,1436000,0,0
TIKI,laptop-may-vi-tinh-linh-kien,13764503,"Bộ khuếch đại HDMI qua RJ45 ( cáp mạng ) kéo dài 30m  ( HDMI to lan )",69000,69000,0,0
TIKI,laptop-may-vi-tinh-linh-kien,95564310,"Trục cao su Trục sạc 12A dành cho hộp mực 05A 49A 53A 80A CANON 2900 3300 6300 319 308 315",13000,13000,0,0
TIKI,laptop-may-vi-tinh-linh-kien,52590926,"Tem chia liều dùng cho nhà thuốc",38000,38000,0,0
TIKI,laptop-may-vi-tinh-linh-kien,138158335,"Thùng cáp mạng CAT 6 UTP,PVC, 305m, 24AWG Corning - Hàng nhập khẩu",3350000,3350000,0,0
TIKI,laptop-may-vi-tinh-linh-kien,171233615," Trống ES 12A dành cho Canon 2900-3000-Mf 4320-Hp 1010-1018-1020",22000,22000,0,0
TIKI,laptop-may-vi-tinh-linh-kien,12607712,"Bộ Phát Wifi Mercusys MW325R Chuẩn N 300Mbps - Hàng Chính Hãng",239000,449000,210000,47
TIKI,laptop-may-vi-tinh-linh-kien,129650198,"Đĩa DVD trắng Maxell (Hộp 50c) - Hàng Chính Hãng ",227262,252500,25238,10
TIKI,laptop-may-vi-tinh-linh-kien,96711435,"Hộp mực 85A 35A hàng nhập khẩu dành cho máy in Canon LBP 6000 6030 6030w HP  P1102/P1212/P1102W/1136/1216/1130 - LBP 3010/3050/3020",116500,116500,0,0
TIKI,laptop-may-vi-tinh-linh-kien,121242419,"Đầu nối mạng RJ45 Ugreen 20311-Hàng chính hãng",67000,67000,0,0
TIKI,laptop-may-vi-tinh-linh-kien,22616559,"Caddy Bay 9.5 mm / 9.5mm gắn thêm ổ cứng cho Laptop",26090,26090,0,0
TIKI,laptop-may-vi-tinh-linh-kien,113409528,"Trống (Drum) Dùng Cho Máy In Brother HL 1110, 1111, 1200, 1201, 1211W Hàng Chất Lượng Cao",48000,48000,0,0
TIKI,laptop-may-vi-tinh-linh-kien,55882244,"Pin Laptop Sony Vaio SVE15 Series",496795,630000,133205,21
TIKI,laptop-may-vi-tinh-linh-kien,14379221,"[Bộ 5 cái] Trống máy in HP 1010/1020/Canon 2900/3000 (12A/FX9) - Hàng nhập khẩu",96900,96900,0,0
TIKI,laptop-may-vi-tinh-linh-kien,82842686,"quả đào kéo giấy dành cho máy in Hp P1102, P1006, P1005, M12A, Canon 6030, 6000, 3050, 3010",13900,13900,0,0
TIKI,laptop-may-vi-tinh-linh-kien,91009944,"Cuộn 900 tem trà sữa 50x30 - Tem nhiệt in tem nhãn, in mã vạch, in tem phụ 50x30mm - 5x3cm",20800,20800,0,0
TIKI,laptop-may-vi-tinh-linh-kien,26218961,"Dây mạng bấm sẵn 2 đầu cat5e 50M (màu ngẫu nhiên)",61250,61250,0,0
TIKI,laptop-may-vi-tinh-linh-kien,53830735,"Bộ Chia Mạng Mercusys MS108G 8 Cổng 10/100/1000 Mbps - Hàng Chính Hãng",410000,410000,0,0
TIKI,laptop-may-vi-tinh-linh-kien,122222084,"Hộp mực in màu xanh 119A C/W2091A (không chip) cho máy in HP Color Laser 150a, HP Color Laser 150nw, HP Color Laser MFP 178nw, HP Color Laser MFP 179fnw - hàng nhập khẩu",189000,189000,0,0
TIKI,laptop-may-vi-tinh-linh-kien,4604385,"Đầu Chia Jack 3.5 Chuẩn Từ 1 Cổng Ra 2 Cổng",7900,7900,0,0
TIKI,laptop-may-vi-tinh-linh-kien,11200914,"Hộp mực 26A, hộp mực HP LaserJet M402n M402d M402dn M402dw M426",179000,179000,0,0
TIKI,laptop-may-vi-tinh-linh-kien,7941044,"Sạc Dành Cho Laptop Sony 19.5V - 4.7A, 90W - Hàng nhập khẩu F1",187000,230000,43000,19
TIKI,laptop-may-vi-tinh-linh-kien,20612430,"[ Set 10 cuộn] Giấy decal nhiệt in tem trà sữa 50x30mm ( Hàng nhập khẩu)",240000,240000,0,0
TIKI,laptop-may-vi-tinh-linh-kien,38139341,"Bàn Phím thay thế cho máy tính Dell N5110",282998,282998,0,0
TIKI,laptop-may-vi-tinh-linh-kien,78971690,"Hộp mực 35A 36A 78A 85A cho máy in HP P1002/P1003/P1004/P1005/P1006/P1009/P1100/P1102/P1102W/M1132/M1212F",116500,116500,0,0
TIKI,laptop-may-vi-tinh-linh-kien,20734457,"Sạc cho Laptop Lenovo 20V - 3.25A Đầu kim",177000,230000,53000,23
TIKI,laptop-may-vi-tinh-linh-kien,73632920,"Pin dành cho Laptop Dell Vostro 5568",569000,569000,0,0
TIKI,laptop-may-vi-tinh-linh-kien,6506591,"Sạc Dành Cho Laptop Samsung Ultrabook, Notebook, Đầu Nhỏ (3 x 1.1 mm) - Hàng Nhập Khẩu",234995,300000,65005,22
TIKI,laptop-may-vi-tinh-linh-kien,14188602,"Giấy In Ảnh Hai Mặt Khổ A3",115000,115000,0,0
TIKI,laptop-may-vi-tinh-linh-kien,32369706,"Bộ 4 hủ Mỡ bôi trơn bao lụa, film sấy, lô sấy, lô ép máy in, tải nhiệt dùng cho máy in",120000,120000,0,0
TIKI,laptop-may-vi-tinh-linh-kien,160049574,"MÁY IN NHÃN CẦM TAY E1000 PRO BẢN TIẾNG VIỆT (CÓ ADAPTER) - CHÍNH HÃNG",1200000,1200000,0,0
TIKI,laptop-may-vi-tinh-linh-kien,74818016,"Hộp mực in 48A - Cartridge 48A Viettoner (Chính hãng) - HP Pro M15A, M15W, M28A, M28W - CF248A",165000,165000,0,0
TIKI,laptop-may-vi-tinh-linh-kien,181472348,"Bộ Chia Mạng 16 Cổng D-Link DES-1016A 10/100 Mbps - Switch 16 Port Hàng Chính Hãng",515000,515000,0,0
TIKI,laptop-may-vi-tinh-linh-kien,1366463,"Ổ Cứng SSD Sata III 2.5 Inch 120GB Apacer AS340 - Hàng Chính Hãng",330000,330000,0,0
TIKI,laptop-may-vi-tinh-linh-kien,751218,"Thiết Bị Phát Sóng Wifi Chuẩn N Tenda N301 (300Mbps) - Trắng - Hàng Chính Hãng",219000,219000,0,0
TIKI,laptop-may-vi-tinh-linh-kien,146688114,"USB thu wifi LB-LINK BL-WN151 Nano - Hàng chính hãng",70000,70000,0,0
TIKI,laptop-may-vi-tinh-linh-kien,82093172,"COMBO 5 BÌNH- Mực nạp/ đổ InkMAX IM37 chuyên nạp các dòng HP 35A, 36A, 78A, 83A, 85A, 88A. – Canon LBP CRG 312, 325, 328, 327, 26a, 48a, 79a, 76a, 337-HÀNG CHÍNH HÃNG",145000,145000,0,0
TIKI,laptop-may-vi-tinh-linh-kien,9837192,"Pin Dành Cho Laptop Dell Lattitude E6400, E6410, E6500, E6510, Precision M6400, M2400, M4400, M4500 - Hàng Nhập Khẩu",288840,288840,0,0
TIKI,laptop-may-vi-tinh-linh-kien,3767931,"USB Wifi Totolink N150UA 150Mbps (Trắng) - Hàng Chính Hãng",139000,139000,0,0
TIKI,laptop-may-vi-tinh-linh-kien,151425767,"Mực dùng cho máy photocopy Ricoh MP 2014_2014/2014 AD/ MP 2700_MP 2701/2702",180000,180000,0,0
TIKI,laptop-may-vi-tinh-linh-kien,3556747,"(BỘ 10 CHAI) Mực đổ Thuận Phong TP05 dùng cho máy in HP P1005 / 1006 - Hàng Chính Hãng",245000,245000,0,0
TIKI,laptop-may-vi-tinh-linh-kien,7940196,"Sạc Dành Cho Laptop DELL 19.5V - 4.62A (90W) - Hàng nhập khẩu F1",184995,184995,0,0
TIKI,laptop-may-vi-tinh-linh-kien,17910028,"Hộp Mực In TN-2385 Hàng nhập khẩu  (dùng cho máy in HL-2321D, HL-L2361DN, HL-2366DW, DCP-2520D, MFC-2701D, MFC-2701DW) Hàng nhập khẩu )",115000,115000,0,0
TIKI,laptop-may-vi-tinh-linh-kien,94104762,"Card Fomater 2900 - Dùng cho máy in Canon 2900/3000",800000,800000,0,0
TIKI,laptop-may-vi-tinh-linh-kien,191721164,"Ổ cứng gắn trong SSD Samsung 980 250GB | 500GB | 1TB M2 NVMe 1.4 PCIe 3.0 - Hàng chính hãng",1120000,2020000,900000,45
TIKI,laptop-may-vi-tinh-linh-kien,115020880,"Máy Chiếu mini BEECUBE X2 MAX - Hệ Điều Hành Android - Kết nối Điện thoại - FullHD 1080",3950000,3950000,0,0
TIKI,laptop-may-vi-tinh-linh-kien,57306695,"Sạc dành cho Laptop Lenovo S410 Adapter",224883,320000,95117,30
TIKI,laptop-may-vi-tinh-linh-kien,145309902,"Sạc nhanh đa năng 65W Baseus GaN3 Pro Desktop Powerstrip- hàng chính hãng",689000,899000,210000,23
TIKI,laptop-may-vi-tinh-linh-kien,4981859,"USB SanDisk CZ430 Ultra Fit 64GB - USB 3.1 - Hàng Chính Hãng",215000,229000,14000,6
TIKI,laptop-may-vi-tinh-linh-kien,194033679,"Dây Mạng Ngoài Trời 8 Lõi Golden Japan Cat5e Có Sợi Thép Chịu Lực, Bọc Bạc, Phủ Dầu Chống Ẩm - Hàng Chính Hãng",85000,85000,0,0
TIKI,laptop-may-vi-tinh-linh-kien,41551915,"Kìm Bấm Mạng Xuyên Thấu + 100 Hạt Mạng Xuyên Thấu",228000,228000,0,0
TIKI,laptop-may-vi-tinh-linh-kien,20585127,"Router Wi-Fi Di Động Chuẩn N 3G/4G TL-MR3020 - Hàng chính hãng",399000,399000,0,0
TIKI,laptop-may-vi-tinh-linh-kien,73112907,"Focusrite Scarlett 2i2 Studio Gen 3 Sound Card Âm Thanh Hàng Chính Hãng - Focus USB Audio Interface SoundCard (3rd Gen3) - Kèm Móng Gẩy DreamMaker",6199000,6199000,0,0
TIKI,laptop-may-vi-tinh-linh-kien,12404609,"Bộ Phát Wifi Mesh TP-Link Deco M5 AC1300 MU-MIMO (1-pack) - Hàng Chính Hãng",1399000,2399000,1000000,42
TIKI,laptop-may-vi-tinh-linh-kien,73256086,"Hộp Đựng Ổ Cứng M2PV-C3-BK (Màu Đen) SSD ORICO NVME M.2 Tốc độ 10Gbps - Hàng Chính Hãng",434000,434000,0,0
TIKI,laptop-may-vi-tinh-linh-kien,122095199,"Bộ Mic Hát Livestream Soundcard XOX K10 2020 & Mic ISK AT100 Chất Lượng Cao, Âm Thanh Cực Kỳ Sống Động - Hàng Chính Hãng",1569000,1569000,0,0
TIKI,laptop-may-vi-tinh-linh-kien,196157745,"Bộ lưu điện UPS PROLINK PRO1201SFCU (1200VA) công suất 600W, tích hợp bộ AVR, sạc siêu nhanh, dùng cho PC, Camera, Wifi - Hàng chính hãng",1825000,1999000,174000,9
TIKI,laptop-may-vi-tinh-linh-kien,107058293,"Máy in nhiệt Bluetooth Deli DL-581PWS in hóa đơn dùng giấy in nhiệt K58mm",1258200,1258200,0,0
TIKI,laptop-may-vi-tinh-linh-kien,511996,"Bộ Phát Wifi Router 4G LTE Băng Tần Kép AC750 TP-Link Archer MR200 - Hàng Chính Hãng",1590000,1590000,0,0
TIKI,laptop-may-vi-tinh-linh-kien,68391902,"Tản Nhiệt  Led RGB Coolmoon CM-M73S cho ổ cứng SSD M2 2280 - hàngnhập khẩu",110000,110000,0,0
TIKI,laptop-may-vi-tinh-linh-kien,191651969,"Ổ cứng di động SSD Samsung T7 Portable USB Type C 3.2 Gen 2- Hàng Chính Hãng",1580000,3030000,1450000,48
TIKI,laptop-may-vi-tinh-linh-kien,50085665,"Màn Hình Gaming Samsung LS22R350FHEXXV 22'' FullHD (1920x1080) 5ms 75Hz IPS AMD Radeon FreeSync - Hàng Chính Hãng",3090000,3090000,0,0
TIKI,laptop-may-vi-tinh-linh-kien,8315046,"Dây Mạng Bấm Sẵn 2 Đầu CAT5 3m (Màu ngẫu nhiên)",8000,10920,2920,27
TIKI,laptop-may-vi-tinh-linh-kien,192935935,"Màn Hình Gaming Samsung Odyssey G3 LS32AG320NEXXV 32 Inch (FHD/VA/165Hz/1ms/Free Sync) - Hàng chính hãng",5050000,5050000,0,0
TIKI,laptop-may-vi-tinh-linh-kien,50608552,"Màn Hình Máy Tính LG 22MN430 22'' Full HD (1920x1080) 5ms 75Hz IPS FreeSync - Hàng Chính Hãng",2550000,2550000,0,0
TIKI,laptop-may-vi-tinh-linh-kien,481625,"Máy In Đa Năng Canon MF3010 Scan Copy - Hàng chính hãng",4850000,5790000,940000,16
TIKI,laptop-may-vi-tinh-linh-kien,115627208,"Màn hình LG 24MP400-B 23.8Inch  IPS Hàng Chính Hãng",2650000,2650000,0,0
TIKI,laptop-may-vi-tinh-linh-kien,12071724,"Mực In Cho Máy DCP-L3551CDW, MFC-L3750CDW Brother TN-263BK Toner - Hàng Chính Hãng",1400000,1400000,0,0
TIKI,laptop-may-vi-tinh-linh-kien,11199995,"Ổ Cứng HDD Seagate BarraCuda 2TB ST2000DM008 - Hàng Chính Hãng",1650000,1650000,0,0
TIKI,laptop-may-vi-tinh-linh-kien,514323,"TP-Link  TL-SG108 - Switch Để Bàn 8 Cổng Gigabit - Hàng Chính Hãng",529000,579000,50000,9
TIKI,laptop-may-vi-tinh-linh-kien,191659040,"Laptop Lenovo ThinkBook 13s G3 ACN (20YA0039VN) | AMD Ryzen 7 5800U | 8GB | 512GB SSD | 13.3 inch IPS | Win 11 | Hàng chính hãng",15150000,15150000,0,0
TIKI,laptop-may-vi-tinh-linh-kien,82842689," Mực đổ dành cho hộp mực TN 2385, TN 2280, TN2260, TN1010, Xerox P225, P265, P115 series",30000,30000,0,0
TIKI,laptop-may-vi-tinh-linh-kien,139611013,"Ổ Cứng Di Động WD Elements SE 4TB USB 3.0 - WDBJRT0040BBK-WESN - Hàng Chính Hãng",3290000,4390000,1100000,25
TIKI,laptop-may-vi-tinh-linh-kien,197190455,"Bộ phát Wifi di động PROLiNK DL7203E, SIM 4G LTE 150Mbps, pin 5200mAH, màn hình 1.44", cổng RJ45, USB 2.0, microSD - Hàng chính hãng",1650000,1999000,349000,17
TIKI,laptop-may-vi-tinh-linh-kien,169268508,"Máy in phun Epson EcoTank L3210  - Hàng chính hãng",4250000,4250000,0,0
TIKI,laptop-may-vi-tinh-linh-kien,176000646,"Router Wifi không dây 4G LTE D-Link DWR-M920 - Hàng Chính Hãng",1349000,1349000,0,0
TIKI,laptop-may-vi-tinh-linh-kien,53708750,"Bộ card WIFI Bluetooth Intel WIFI 6 AX200  5Ghz tốc độ 2400M và Bluetooth 5.1 cho máy bàn - Công nghệ MU MIMO",600000,600000,0,0
TIKI,laptop-may-vi-tinh-linh-kien,99667879,"Sạc dành cho Laptop Lenovo Ideapad (Các model) 65W 20V 3.25A chuẩn chân nhỏ 4.0 x 1.7mm",349000,349000,0,0
TIKI,laptop-may-vi-tinh-linh-kien,118989088,"Baseus HDMI hai chiều - Bộ chuyển đổi bộ chia HDMI 2x 4K / 30 Hz màu xám (CAHUB-BC0G) - hàng chính hãng",280000,280000,0,0
TIKI,laptop-may-vi-tinh-linh-kien,186136339,"Laptop HP Victus 16-e0177AX (4R0U9PA) R5-5600H | 8GB | 512GB | GTX 1650 4GB Hàng chính hãng",26436000,26436000,0,0
TIKI,laptop-may-vi-tinh-linh-kien,10194812,"Bộ Lưu Điện UPS Santak TG500 500VA 300W - Hàng Chính Hãng",1299000,1299000,0,0
TIKI,laptop-may-vi-tinh-linh-kien,37722619,"BÀN PHÍM  DÀNH CHO LAPTOP ASUS X541 X541S X541SA X541SC X541U X541UA X541UV - HÀNG NHẬP KHẨU",199000,290000,91000,31
TIKI,laptop-may-vi-tinh-linh-kien,459628,"Brother BT6000BK Ink Cho DCP-T300/T700W/MFC-T800W (Đen) - Hàng Chính Hãng",195000,195000,0,0
TIKI,laptop-may-vi-tinh-linh-kien,184908012,"Máy quét mã vạch không dây YHD 1100DW 2D đọc mã vạch Barcode(1D), Qrcode(2D) kết nối đầu thu USB dùng trên Máy tính, Laptop - Hàng Nhập Khẩu",899000,1348500,449500,33
TIKI,laptop-may-vi-tinh-linh-kien,136796494,"Bộ chuyển đổi quang điện HTB GS03 1Gbps 1 cặp AB - Converter quang 1G",325000,325000,0,0
TIKI,laptop-may-vi-tinh-linh-kien,56857641,"Bộ Chia Cổng Mạng LAN RJ45 1 Sang 2 Cổng AZONE",99750,105000,5250,5
TIKI,laptop-may-vi-tinh-linh-kien,13932703,"Đầu đọc ổ cứng 2.5 và 3.5 inch, thẻ nhớ tất cả trong một - kèm nguồn 12v",429000,429000,0,0
TIKI,laptop-may-vi-tinh-linh-kien,183743642,"Lenovo ThinkPad L460 (Intel Core i5 6300 , RAM 8.0GB, 1x180GB SSD SATA III, Intel HD 520, MÀN HÌNH 14 INCH Tặng cặp + chuột không dây + bàn di chuột - HÀNG CHÍNH HÃNG",4249000,6250000,2001000,32
TIKI,laptop-may-vi-tinh-linh-kien,58691582,"Cuộn Giấy in mã vạch decal nhiệt nhãn tem khổ 100x150 mm",58000,58000,0,0
TIKI,laptop-may-vi-tinh-linh-kien,14706973,"Kaspersky Internet Security - 5pc - Sản phẩm chính hãng",900000,900000,0,0
TIKI,laptop-may-vi-tinh-linh-kien,84136920,"Sạc dành cho Laptop Asus TUF Gaming FX505 FX505D FX505DU FX505DT AC Adapter - 150W ",689995,689995,0,0
TIKI,laptop-may-vi-tinh-linh-kien,82101951,"COMBO 5 BÌNH-Mực nạp Brother TN 2280/2385/2325/2240 HL1111/1511/2321/2340/2360/2361/2240/2280/2380/MFC1601/2701/2720/2740/7060/7360-InkMAX IM 2385-HÀNG CHÍNH HÃNG",200000,200000,0,0
TIKI,laptop-may-vi-tinh-linh-kien,144582226,"Màn hình Viewsonic VX2480-2K-SHD ( 23.8inch/QHD/IPS/75Hz/4ms/250nits/HDMI+DP) - Hàng Chính Hãng",4690000,4690000,0,0
TIKI,laptop-may-vi-tinh-linh-kien,20859223,"Vòng đánh dấu dây mạng số Cat6 bằng cao su (0-9) 1 vỉ 10 hộp: 5000 số",89000,89000,0,0
TIKI,laptop-may-vi-tinh-linh-kien,155005388,"RAM Laptop KingSpec 8GB DDR4 3200MHz / NB 8G - Hàng Chính Hãng",998000,998000,0,0
TIKI,laptop-may-vi-tinh-linh-kien,127282139,"USB WIFI 3.0 AC 1200Mbps giúp Nâng cấp thu wifi 5G Gigabit -  cho máy bàn và laptop- BẢO HÀNH 3 THÁNG - Hàng nhập khẩu",129000,129000,0,0
TIKI,laptop-may-vi-tinh-linh-kien,186078128,"Máy in Laser Trắng Đen HP 107w WiFi (4ZB78A)- Hàng chính hãng",2390000,2390000,0,0
TIKI,laptop-may-vi-tinh-linh-kien,71673585,"Lá lúa dán hộp từ, cụm bell, cụm trống dùng cho máy photocopy Toshiba E 550, 650, 520, 720, 850, 555, 655, 755, 556, 656, 756, 657, 857",22000,22000,0,0
TIKI,laptop-may-vi-tinh-linh-kien,76297472,"Ổ cứng SSD Samsung 870 EVO SATA III 2.5" SSD 500GB ( MZ-77E500BW ) - Hàng Chính Hãng",1759000,1759000,0,0
TIKI,laptop-may-vi-tinh-linh-kien,155553528,"Ram Adata 8GB (1X8GB) DDR4 3200Mhz Xpg Gammix D10 Red - Hàng Chính Hãng",790000,790000,0,0
TIKI,laptop-may-vi-tinh-linh-kien,67179448,"Hộp Đựng Ổ Cứng ORICO 2520U3-BK ( Đen) 2.5" SSD/HDD SATA 3 USB 3.0 - Hàng Chính Hãng",120000,120000,0,0
TIKI,laptop-may-vi-tinh-linh-kien,7458641,"Hộp mực cho máy in HP laser 1005",116500,116500,0,0
TIKI,laptop-may-vi-tinh-linh-kien,145232831,"Cục Phát Wifi 4G Netgear Jetpack MiFi 8800L - Tốc độ 4G lên tới 12Gbps - Hàng nhập khẩu",1990000,1990000,0,0
TIKI,laptop-may-vi-tinh-linh-kien,125433259,"Sạc cho laptop Dell Inspiron 15 7537 N7537 Adapter 19.5V-4.62A - Kèm Dây nguồn - Hàng Nhập Khẩu",239000,289000,50000,17
TIKI,laptop-may-vi-tinh-linh-kien,174467646,"Máy chiếu mini ViewSonic M2 -hàng chính hãng",21500000,21500000,0,0
TIKI,laptop-may-vi-tinh-linh-kien,754246,"Bộ Chuyển Đổi Wifi Mercusys MW150US USB Wifi Nano N150 - Hàng Chính Hãng",99000,99000,0,0
TIKI,laptop-may-vi-tinh-linh-kien,121242845,"Hộp ổ cứng M.2 SSD USB 3.1 Gen 1 ORICO M2PF-C3-BK - Đen - Hàng chính hãng",252000,252000,0,0
TIKI,laptop-may-vi-tinh-linh-kien,82842101," Hộp mực SP200 dùng cho máy in Ricoh Sp 200, Sp210, Sp212 chất lượng, đậm đẹp in được 1500 trang",368000,368000,0,0
TIKI,laptop-may-vi-tinh-linh-kien,109390724,"Màn hình Viewsonic VX2480-SHDJ (24inch/FHD/IPS/75Hz/4ms/250nits/HDMI+DP+VGA+Audio) - Hàng Chính Hãng",3650000,3650000,0,0
TIKI,laptop-may-vi-tinh-linh-kien,311788,"HDD Box ORICO USB3.0/2.5 - 2588US3 Màu",162000,172000,10000,6
TIKI,laptop-may-vi-tinh-linh-kien,142782780,"Phần mềm diệt Virus Eset Nod32 Antivirus 3 User - Hàng Chính Hãng",303000,440000,137000,31
TIKI,laptop-may-vi-tinh-linh-kien,71673152,"Cuộn dây cao áp dùng cho máy photocopy Toshiba E 550, 650, 520, 720, 850, 555, 655, 755, 556, 656, 756, 657, 857",110000,110000,0,0
TIKI,laptop-may-vi-tinh-linh-kien,78971701,"Hộp mực 12A/303 Dành Cho Máy In HP LaserJet 1010/ 1015/ 1018/ 1020/ 3020/ 3030/ M1319f MFP và Dành Cho Máy In Canon LBP 2900/ 3000",116900,116900,0,0
TIKI,laptop-may-vi-tinh-linh-kien,90474865,"Soundcard XOX K10 10th Jubilee phiên bản tiếng Anh 2021 chuyên hát Thu âm, Livestream Bigo, Facebook",799000,799000,0,0
TIKI,laptop-may-vi-tinh-linh-kien,192216306,"Ổ Cứng Di Động WD WD Elements Portable 2.5 Hàng Chính Hãng",1533000,2390000,857000,36
TIKI,laptop-may-vi-tinh-linh-kien,11295357,"Bộ Sạc Đa Năng 8 Đầu Dành Cho Laptop (từ 12V - 24V )",138000,138000,0,0
TIKI,laptop-may-vi-tinh-linh-kien,153995703,"Hộp Đựng Ổ Cứng SSD ORICO M.2 SATA Type C Orico PVM2F-C3-GY-BP - Hàng Chính Hãng",315700,315700,0,0
TIKI,laptop-may-vi-tinh-linh-kien,113000316,"Chai Mực nạp cho máy in Brother trắng đen",35000,35000,0,0
TIKI,laptop-may-vi-tinh-linh-kien,56506529,"Pin dành cho Laptop Dell Inspiron 15 3542",374000,374000,0,0
TIKI,laptop-may-vi-tinh-linh-kien,101138422,"Màn hình MSI Pro MP242 (23.8inch/FHD/IPS/75Hz/5ms/250nits/HDMI+Dsub+Audio)",2830000,2830000,0,0
TIKI,laptop-may-vi-tinh-linh-kien,93842708,"Quạt Led 12cm cắm nguồn trực tiếp cho máy tính",60000,60000,0,0
TIKI,laptop-may-vi-tinh-linh-kien,13104961,"Giá đỡ máy chiếu 3 chân W615",900000,900000,0,0
TIKI,laptop-may-vi-tinh-linh-kien,106276495,"Máy Chiếu Mini Siêu Nét Kết Nối Bluetooth Wifi Chạy Hệ Điều Hành Android W2S Cao Cấp",2991550,3149000,157450,5
TIKI,laptop-may-vi-tinh-linh-kien,119111881,"Màn hình Viewsonic VA2932-MHD ( 29"/WFHD/21:9/IPS/75hz/4ms/250nits/loa kép/HDMI+DP) - Hàng Chính Hãng",5399000,5399000,0,0
TIKI,laptop-may-vi-tinh-linh-kien,23608266,"Vỏ thùng máy tính Jetek G9015 ( Case Game- Cube)- Hàng chính hãng",990000,990000,0,0
TIKI,laptop-may-vi-tinh-linh-kien,142370103,"Giấy in nhiệt dành cho dòng máy Mini Printer con mèo",3300,3300,0,0
TIKI,laptop-may-vi-tinh-linh-kien,127776665,"Máy in mã vạch Xprinter XP-420B - Hàng Nhập Khẩu",1348900,1348900,0,0
TIKI,laptop-may-vi-tinh-linh-kien,161952132,"Giá treo màn hình máy tính Human Motion T6 - Hàng Chính Hãng",599000,599000,0,0
TIKI,laptop-may-vi-tinh-linh-kien,184668991,"Hệ thống WiFi Mesh VNPT Technology iGate EW12ST (1-pack) chuẩn AC tốc độ cao hàng chính hãng",780000,780000,0,0
TIKI,laptop-may-vi-tinh-linh-kien,190725476,"Laptop HP Pavilion 15 eg2066TU i7 1260P/16GB/512GB/15.6"F/Win11/(6K7E2PA)/Vàng - Hàng chính hãng",28747200,28747200,0,0
TIKI,laptop-may-vi-tinh-linh-kien,179750204,"{XẢ KHO} Màn hình Provision 22 INCH- Độ phân giải Full HD  Hình ảnh đẹp sắc nét - HÀNG CHÍNH HÃNG ",1394000,1490000,96000,6
TIKI,laptop-may-vi-tinh-linh-kien,208438905,"Hộp mực Brother TN 2385 dùng cho máy in Brother HL-L2361DN/HL-2321D/MFC-L2701DW/HL-L2366DW/L2701D/ 2320/ 2321/ 2340/ 2360/ 2361/ 2365/ 2366/ 2700/ 2701/ 2701/ 2720/ 2740 (Black)",160000,160000,0,0
TIKI,laptop-may-vi-tinh-linh-kien,6841341,"USB Sound Card - Cáp chuyển từ cổng USB ra audio 3.5mm hỗ trợ Mic và Tai Nghe Ugreen 30712 - Hàng Chính Hãng",235000,250000,15000,6
TIKI,laptop-may-vi-tinh-linh-kien,46156090,"VINETTEAM USB Bluetooth 5.0 cho PC -USB Bluetooth Máy tính kết nối 20m - Hàng Nhập Khẩu",46550,49000,2450,5
TIKI,laptop-may-vi-tinh-linh-kien,125582349,"Máy in Laser Trắng Đen HP 107A - Hàng chính hãng",2190000,2190000,0,0
TIKI,laptop-may-vi-tinh-linh-kien,174540948,"USB thu wifi LOẠI TỐT có ăng ten dành cho máy tính để bàn, Laptop – usb thu wifi tốc độ cao phục vụ học online, xem phim, chơi game kết nối mạnh mẽ, ổn định",199000,199000,0,0
TIKI,laptop-may-vi-tinh-linh-kien,150656174,"Ổ cứng di động SSD Sandisk Extreme Pro V2 E81 1TB / 2TB Gen 2x2 USB 3.0 - Hàng Nhập Khẩu",3949000,5026000,1077000,21
TIKI,laptop-may-vi-tinh-linh-kien,20441353,"Cây Đỡ Chống Xệ Card VGA Jonsbo VC-2 - Hàng nhập khẩu",179000,179000,0,0
TIKI,laptop-may-vi-tinh-linh-kien,176240897,"Bộ máy tính để bàn VLimited cao cấp i5 3330/8G/ SSD/HDD/ Văn Phòng, GAME sản phẩm trọn bộ - Hàng chính hãng",3990000,3990000,0,0
TIKI,laptop-may-vi-tinh-linh-kien,134583939,"USB 3.1 SanDisk Ultra Luxe CZ74 150MB/s (Bạc) - Hàng Chính Hãng",159000,159000,0,0
TIKI,laptop-may-vi-tinh-linh-kien,174257275,"Switch TP-Link TL-SG1016D 16 Port Gigabit Hàng Chính Hãng",1430000,1430000,0,0
TIKI,laptop-may-vi-tinh-linh-kien,68003409,"Gạt mực ( gạt trống ) 12A ( dùng cho hộp mực máy in Canon 2900/ 3300/ HP 1010/ 1020",6900,6900,0,0
TIKI,laptop-may-vi-tinh-linh-kien,96425948,"Bộ chia mạng 8 cổng Gigabit RJ45 Acorid LS8GT Ethernet Network - Hàng chính hãng",610000,610000,0,0
TIKI,laptop-may-vi-tinh-linh-kien,188832513,"Cáp Thunderbolt 4 C to C Hagibis 4K/5K 60Hz 100W 2m,1m2",600000,600000,0,0
TIKI,laptop-may-vi-tinh-linh-kien,93883893,"Thanh Led Chắn độ trang trí cho case máy tính cắm trực tiếp nguồn 4pin molex AORUS ROG - hàng nhập khẩu",115000,115000,0,0
TIKI,laptop-may-vi-tinh-linh-kien,7067793,"RAM Laptop Kingmax 8GB 2400 DDR4 - Hàng Chính Hãng",540000,540000,0,0
TIKI,laptop-may-vi-tinh-linh-kien,356371,"Ổ Cứng Di Động Transcend StoreJet M3S 1TB USB 3.0/3.1 - TS1TSJ25M3S - Hàng Chính Hãng",1959000,1959000,0,0
TIKI,laptop-may-vi-tinh-linh-kien,110317258,"Phát wifi từ sim 4G MIXIE LTE4G hỗ trợ 32 user phát sóng cực xa - nguồn trực tiếp 12V (Đen) HÀNG NHẬP KHẨU",750000,750000,0,0
TIKI,laptop-may-vi-tinh-linh-kien,112228080,"Giá Treo Hai Màn Hình Máy Tính North Bayou H180 Lắp Cho Màn Hình Từ 22 inch - 32 inch Nhập Khẩu",598900,598900,0,0
TIKI,laptop-may-vi-tinh-linh-kien,157161265,"Dây cáp mạng Lan CAT6 Dẹt - Tròn 10m 15m RJ45 Gigabit tốc độ cao VENTION - Hàng chính hãng",89000,140000,51000,36
TIKI,laptop-may-vi-tinh-linh-kien,52850326,"Bộ máy tính để bàn Viettech chuyên Văn phòng, Học tập Core i5 3470 siêu mạnh, ổ cứng SSD điện tử siêu nhanh, màn 20 inch MỚI FULL HỘP - Hàng nhập khẩu",3600500,3790000,189500,5
TIKI,laptop-may-vi-tinh-linh-kien,8315170,"Dây Mạng Bấm Sẵn 2 Đầu CAT5  15 Mét (màu ngẫu nhiên)",20120,20120,0,0
TIKI,laptop-may-vi-tinh-linh-kien,575562,"HDD Box ORICO USB3.0/3.5/2.5 6648US3-C Hàng Chính Hãng",2250000,2500000,250000,10
TIKI,laptop-may-vi-tinh-linh-kien,229695678,"Màn Chiếu Treo Tường Apollo 120 inch - Hàng Chính Hãng",799000,799000,0,0
TIKI,laptop-may-vi-tinh-linh-kien,95564376,"Gạt nhỏ Gạt từ 12A dành cho hộp mực 05A 49A 53A 80A 26A máy in Canon 2900 3300 6300 HP 1010 1020 2055 2035 402DN",9000,9000,0,0
TIKI,laptop-may-vi-tinh-linh-kien,186634758,"Bộ Phát Wifi 6 TP-Link Archer AX72 Gigabit Băng Tần Kép AX5400 - Hàng Chính Hãng",2265000,2265000,0,0
TIKI,laptop-may-vi-tinh-linh-kien,75814702,"Switch poe 8 port Acorid LS1708P2E, 8 cổng POE+ 30W FE 10/100Mbps , 2 cổng Uplink, tổng công suất 96W, Có đèn hiển thị công suất, AI reboot thiết bị – Hàng chính hãng",890000,890000,0,0
TIKI,laptop-may-vi-tinh-linh-kien,93166195,"Bộ lưu điện UPS PROLiNK PRO2000SFCU (2000VA) công suất 1200W, tích hợp bộ AVR, sạc siêu nhanh, dùng cho PC, Camera, Wifi - Hàng chính hãng",3929000,4499000,570000,13
TIKI,laptop-may-vi-tinh-linh-kien,104070236,"Kìm mạng BOSI/Kìm Bấm Hạt Xuyên Thấu  - Hàng chính hãng",76000,76000,0,0
TIKI,laptop-may-vi-tinh-linh-kien,3149149,"Thiết Bị Phát Wifi Ốp Trần TotoLink CA1200 Băng Tần Kép AC1200 - Hàng Chính Hãng",1200000,1200000,0,0
TIKI,laptop-may-vi-tinh-linh-kien,182095566,"Màn Hình Không Viền HIKVISION DS-D5022FN-C 21.5" FHD 60Hz - Hàng Chính Hãng",1690000,1690000,0,0
TIKI,laptop-may-vi-tinh-linh-kien,2691283,"Máy In Ảnh Đa năng Canon MG3670",2800000,2800000,0,0
TIKI,laptop-may-vi-tinh-linh-kien,10706084,"Ổ Cứng Di Động WD My Passport Ultra 1TB WDBC3C0010BSL-WESN",2150000,2150000,0,0
TIKI,laptop-may-vi-tinh-linh-kien,117572921,"Màn Hình Dell S2721QS 27 inch 4K IPS 60Hz - Hàng Chính Hãng",9190000,9190000,0,0
TIKI,laptop-may-vi-tinh-linh-kien,57003673,"Bộ Chuyển Đổi Wifi Không Dây TP-Link Archer T4E PCI Express AC1200 - Hàng Chính Hãng",549000,549000,0,0
TIKI,laptop-may-vi-tinh-linh-kien,1036160,"Hộp Đựng Ổ Cứng Di Động HDD Box 3.5 Inch Orico 3139U3 - Hàng Chính Hãng",405000,650000,245000,38
TIKI,laptop-may-vi-tinh-linh-kien,76440603,"RAM Laptop DDR4 Hynix 4GB Bus 3200 SODIMM - Hàng Nhập Khẩu",242000,308000,66000,21
TIKI,laptop-may-vi-tinh-linh-kien,311745,"Hộp Đựng Ổ Cứng Di Động HDD Box ORICO USB3.0/2.5 - 2569S3-V1 Màu",179000,179000,0,0
TIKI,laptop-may-vi-tinh-linh-kien,164593527,"MAIN Gigabyte H510M H – Socket 1200_HÀNG CHÍNH HÃNG",1749000,1749000,0,0
TIKI,laptop-may-vi-tinh-linh-kien,6817797,"Vỏ hộp đựng ổ cứng SATA 2.0/3.0 2.5 và SSD vỏ nhựa ABS cao cấp (dây dời) UGREEN US221 30848 - Hàng Chính Hãng",204000,230000,26000,11
TIKI,laptop-may-vi-tinh-linh-kien,25006660,"Hộp Đựng Ổ Cứng Di Động HDD Box ORICO 2739U3 ( Màu xanh) USB3.0/2.5 Nhựa ABS+Silica gel - Hàng Chính Hãng",380000,380000,0,0
TIKI,laptop-may-vi-tinh-linh-kien,26691653,"USB SanDisk Ultra Luxe USB 3.1 Flash Drive | SDCZ74-032G-G46 | USB3.1 | Hàng Chính Hãng",219000,239000,20000,8
TIKI,laptop-may-vi-tinh-linh-kien,22030673,"Phần Mềm diệt Virut của Người Việt BKAV Pro Internet Security 1PC/1 năm - Hàng Chính Hãng (Tặng kèm bộ vệ sinh máy tính)",240000,240000,0,0
TIKI,laptop-may-vi-tinh-linh-kien,113099332,"USB Bluetooth Dongle 5.0 giúp Laptop PC thu phát sóng bluetooth",36760,36760,0,0
TIKI,laptop-may-vi-tinh-linh-kien,96357743,"Gạt mực 12A dành cho máy Canon 2900, HP1010, HP 1020",7000,7000,0,0
TIKI,laptop-may-vi-tinh-linh-kien,146563301,"LapTop Lenovo V14 IIL (82C400W0VN) | Intel Core i3 _ 1005G1 | 4GB | 256GB SSD PCIe | Win 10 | 14 inch HD | Hàng Chính Hãng",7650000,7650000,0,0
TIKI,laptop-may-vi-tinh-linh-kien,186078120,"Máy in màu Laser HP 150nw/Wifi (4ZB95A)- Hàng chính hãng",6890000,6890000,0,0
TIKI,laptop-may-vi-tinh-linh-kien,72752336,"Dây Nguồn PC - Cắm PC - Màn Hình Máy Tính - Nồi Cơm Điện",32000,32000,0,0
TIKI,laptop-may-vi-tinh-linh-kien,50231135,"Hộp drum cho Brother DR B022, DCP-B7535dw, HL B2080dw, B2000d, B7715dw, In đẹp, là cụm khay trống cho máy in laser trắng đen",465000,465000,0,0
TIKI,laptop-may-vi-tinh-linh-kien,1822419,"Dây Cáp Mạng Orico PUG-C6-100 CAT6 10m - Hàng Chính Hãng",103000,117000,14000,12
TIKI,laptop-may-vi-tinh-linh-kien,107362077,"Bộ Chuyển Đổi Card Mạng Wifi TP-Link Archer T2E PCIe Băng Tần Kép AC600 - Hàng Chính Hãng",399000,699000,300000,43
TIKI,laptop-may-vi-tinh-linh-kien,85754942,"Bộ Phát Wifi TP-Link Archer MR400 Băng Tần Kép 4G LTE AC1200 - Hàng Chính Hãng",2799000,2799000,0,0
TIKI,laptop-may-vi-tinh-linh-kien,184300350,"Bộ Vi Xử Lý CPU AMD Ryzen Processors 7 5700X - Hàng Chính Hãng",5150000,5150000,0,0
TIKI,laptop-may-vi-tinh-linh-kien,764581,"Máy In Laser Đa Năng Brother MFC-L2701DW - Hàng Chính Hãng",6050000,6490000,440000,7
TIKI,laptop-may-vi-tinh-linh-kien,7736571,"Adapter Nguồn 9V - 0.6A TP-LINK - Hàng Nhập Khẩu",55000,55000,0,0
TIKI,laptop-may-vi-tinh-linh-kien,65079109,"Mực in Brother bộ 4 màu dùng cho máy in DCP-T310, DCP-T510W, DCP-T710W, MFC-T810W, MFC-T910DW - Hàng Chính Hãng",660000,660000,0,0
TIKI,laptop-may-vi-tinh-linh-kien,12204837,"Bàn phím kiêm chuột không dây mini UKB 500 Mini Keyboard",67700,67700,0,0
TIKI,laptop-may-vi-tinh-linh-kien,10156759,"Hộp mực máy in Canon Laser đa chức năng MF241d ",119000,119000,0,0
TIKI,laptop-may-vi-tinh-linh-kien,66566653,"Mực nạp ( mực đổ ) cho hộp mực 12A/ 49A/ 05A Canon 2900/ 3300/ HP 1010/1020...",35000,35000,0,0
TIKI,laptop-may-vi-tinh-linh-kien,10001334,"RAM Laptop Hynix 8GB DDR4 2133MHz SODIMM - Hàng Nhập Khẩu",484000,616000,132000,21
TIKI,laptop-may-vi-tinh-linh-kien,964243,"Ổ Cứng SSD WD Green 240GB 3D NAND - WDS240G2G0A - Hàng Chính Hãng",690000,690000,0,0
TIKI,laptop-may-vi-tinh-linh-kien,95564285,"Drum Trống in 12A hàng chính hãng Alphacartridge Loại tốt LongLife dành cho hộp mực Canon 2900 3000 FX9 303 HP 1010 1020 1015 1018 1022 3050",23800,23800,0,0
TIKI,laptop-may-vi-tinh-linh-kien,73937067,"Card Mạng Không Dây Wifi Asus PCE-AX3000 (Tray Không Hộp)  WiFi 6 (802.11ax) Băng Tần Kép Bluetooth 5.0 Bảo Mật Mạng WPA3 OFDMA MU-MIMO - Hàng Chính Hãng",629000,629000,0,0
TIKI,laptop-may-vi-tinh-linh-kien,67449297,"Màn hình máy tính Samsung LF24T450FQEXXV (24″/FHD/IPS/75Hz) - Hàng Chính Hãng",2760000,2760000,0,0
TIKI,laptop-may-vi-tinh-linh-kien,130048917,"Màn hình Dell P2722H 27 inch Full HD IPS 60Hz - Hàng Chính Hãng",6190000,6190000,0,0
TIKI,laptop-may-vi-tinh-linh-kien,151994589,"USB 3G Dcom 3G Vodafone MS2131 Chạy App Quản Lý Huawei.Mobile-Partner Tốc Độ 21,6Mb Đa Mạng- Hỗ Trợ Đổi IP, Đổi Địa Chỉ MAC Siêu Nhanh, Hàng Nhập Khẩu",339000,339000,0,0
TIKI,laptop-may-vi-tinh-linh-kien,119445257,"Hộp mực cho máy in canon 223DW /226DW/MF 440/MF445DW/MF 449x",184500,184500,0,0
TIKI,laptop-may-vi-tinh-linh-kien,83492704,"(Bộ 4 màu) Mực nước máy in Epson T664 L300 / L310 / L350 / L360 / L1300 / L100 / L120 / L200 / L210 / L565 ... - HÀNG NHẬP KHẨU",180000,180000,0,0
TIKI,laptop-may-vi-tinh-linh-kien,10683352,"USB Kingston DT100G3 128GB chính hãng",350000,350000,0,0
TIKI,laptop-may-vi-tinh-linh-kien,54768201,"Hộp mực máy in HP LaserJet Pro M12A, M12W (HKC-79A)",123000,123000,0,0
TIKI,laptop-may-vi-tinh-linh-kien,46106855,"VINETTEAM Bộ Chuyển Đổi HDMI 4K 3 Đầu HDMI Vào Và 1 Đầu HDMI Ra Với Điều Khiển Từ Xa-Hàng Nhập Khẩu",189050,199000,9950,5
TIKI,laptop-may-vi-tinh-linh-kien,188008846,"Cap Mạng VP-Link VSP-0907 Cat 6E UTP 100M/305M Lõi Chữ Thập Dây Cáp Xanh - Hàng Chính Hãng",350000,350000,0,0
TIKI,laptop-may-vi-tinh-linh-kien,78913140,"Router DrayTek Vigor2927 - Hàng chính hãng",3700000,3700000,0,0
TIKI,laptop-may-vi-tinh-linh-kien,55998202,"Quạt  tản nhiệt, Fan Case Led RGB Coolmoon K2 - Hàng Chính Hãng",69000,69000,0,0
TIKI,laptop-may-vi-tinh-linh-kien,20637588,"Hộp mực máy in 337, 773 in đẹp, nhập khẩu mới. Là Cartridge, catrich, toner dùng cho máy in Canon i-Sensys mf220, mf211d, m212, mf215, 151dw, 216, 217, 221, 226, 229, mf 241d",118000,118000,0,0
TIKI,laptop-may-vi-tinh-linh-kien,15507113,"Main Asus H110M-K Hàng Chính Hãng",1720000,1720000,0,0
TIKI,laptop-may-vi-tinh-linh-kien,5207481,"Đế Tản Nhiệt Laptop 5 Quạt Tốc Độ Lớn C5",213750,225000,11250,5
TIKI,laptop-may-vi-tinh-linh-kien,14293641,"Dây Mạng Lan 30 MÉT Đúc Sẵn 2 Đầu Hạt Mạng",40000,42800,2800,7
TIKI,laptop-may-vi-tinh-linh-kien,142782737,"Phần Mềm Diệt Virus BKAV Profressional 1 PC 12 Tháng - Hàng Chính Hãng",184000,184000,0,0
TIKI,laptop-may-vi-tinh-linh-kien,2045801,"Đầu Nối Dây Mạng Ugreen RJ45",63900,70000,6100,9
TIKI,laptop-may-vi-tinh-linh-kien,172960162,"Ổ cứng Seagate One Touch HDD 5TB 2.5" USB 3.0 + Giải cứu Dữ liệu miễn phí_Hàng chính hãng",5390000,5390000,0,0
TIKI,laptop-may-vi-tinh-linh-kien,2045615,"Hộp 100 Cái Đầu Bấm Mạng Ugreen RJ45 CAT5 50246 - Hàng Chính Hãng",212000,229000,17000,7
TIKI,laptop-may-vi-tinh-linh-kien,62639751,"Cáp mạng Cat6 Commscope UTP - Hàng chính hãng",3178000,3178000,0,0
TIKI,laptop-may-vi-tinh-linh-kien,135831988,"Router wifi Tenda AC5 AC1200 - Hàng Chính Hãng",389000,389000,0,0
TIKI,laptop-may-vi-tinh-linh-kien,28241326,"Nguồn VSP 650W Full Box - Kèm Dây Nguồn - Hàng Chính Hãng",203000,219900,16900,8
TIKI,laptop-may-vi-tinh-linh-kien,52756745,"Bộ Phát Sóng Wifi 4G Dlink DWR-920 - Hàng Chính Hãng",1170000,1170000,0,0
TIKI,laptop-may-vi-tinh-linh-kien,162616628,"Giấy in nhiệt , decal dán tự dính dành cho dòng máy in Mini Printer con mèo, Peripage, Paperang, Aibecy MP,  MTP-II, PT210",7000,7000,0,0
TIKI,laptop-may-vi-tinh-linh-kien,416914,"TP-Link  TL-WN821N - USB Wifi Chuẩn N Tốc Độ 300Mbps - Hàng Chính Hãng",184000,184000,0,0
TIKI,laptop-may-vi-tinh-linh-kien,51501467,"Nguồn Corsair CV550 - 80 Plus Bronze (CP-9020210-NA) Hàng Chính Hãng ",1120000,1120000,0,0
TIKI,laptop-may-vi-tinh-linh-kien,84875763,"Nguồn Máy Tính Cooler Master MWE White V2-230V ( 650W-700W-750W ) - Hàng Chính Hãng",1350000,1350000,0,0
TIKI,laptop-may-vi-tinh-linh-kien,138463774,"Combo 5 - Bộ 5 lọ mực nạp máy in Brother - Hàng nhập khẩu",220000,220000,0,0
TIKI,laptop-may-vi-tinh-linh-kien,109555719," Đầu hạt bấm mạng RJ45 UTP Tenda CAT 5E TEH5E010 mạ vàng 24K - Hàng Chính Hãng ",108500,108500,0,0
TIKI,laptop-may-vi-tinh-linh-kien,82842065," Hộp mực 107A dành cho máy in HP 107A / 107w / 135A / 135w/ 137fnw Không chip",185000,185000,0,0
TIKI,laptop-may-vi-tinh-linh-kien,174253009,"KỆ ĐỂ MÁY CHIẾU 3 CHÂN ĐA NĂNG DI ĐỘNG",446000,446000,0,0
TIKI,laptop-may-vi-tinh-linh-kien,22118421,"Ổ DVD-RW gắn ngoài USB2.0",275000,320000,45000,14
TIKI,laptop-may-vi-tinh-linh-kien,91272591,"Giá Treo Màn Hình Máy Tính North Bayou H100 Lắp Cho Màn Hình Từ 22 inch - 35 inch Nhập Khẩu",349000,349000,0,0
TIKI,laptop-may-vi-tinh-linh-kien,10001380,"RAM Laptop Hynix 16GB DDR4 2666MHz SODIMM - Hàng Nhập Khẩu",913000,1092000,179000,16
TIKI,laptop-may-vi-tinh-linh-kien,21478765,"Hộp Đựng Ổ Cứng HDD 2 Khay Orico 3.5'' USB 3.0 DS200U3  - Hàng Chính Hãng",1550000,1550000,0,0
TIKI,laptop-may-vi-tinh-linh-kien,132837642,"Máy đo công suất quang MT-7615 - 4in1 - soi 15KM",665000,665000,0,0
TIKI,laptop-may-vi-tinh-linh-kien,48431310,"Nguồn Máy Tính 230W Công Suất Thực Xigmatek X-350 - Hàng Chính Hãng",385000,385000,0,0
TIKI,laptop-may-vi-tinh-linh-kien,12481715,"Ổ Cứng SSD Gigabyte 120Gb (2.5" Sata iii 6Gb/S) - Hàng Chính Hãng",485000,485000,0,0
TIKI,laptop-may-vi-tinh-linh-kien,157161281,"Dây Cáp Cat6 Cáp Mạng Lan 0,5m 1m 1,5m 2m 5m đúc sẵn tốc độ cao UTP CAT 6 RJ45",59000,90000,31000,34
TIKI,laptop-may-vi-tinh-linh-kien,459632,"Mực In Brother BT5000M Ink Cho DCP-T300/T700W/MFC-T800W (Đỏ) - Hàng Chính Hãng",160000,160000,0,0
TIKI,laptop-may-vi-tinh-linh-kien,179795350,"Dây Cáp Mạng Ngoài Trời HIDEKI Cat5e Dropwire 4 Lõi Đồng Nguyên Chất, Có Sợi Thép Chịu Lực, Vỏ HDPE Siêu Bền - Hàng Chính Hãng",59000,59000,0,0
TIKI,laptop-may-vi-tinh-linh-kien,187587200,"[HÀNG CHÍNH HÃNG] Combo Máy in phun màu đa năng Brother DCP-T520W và Bộ mực in phun Brother (BT-D60BK + BT5000C/M/Y)",5800000,5800000,0,0
TIKI,laptop-may-vi-tinh-linh-kien,157071048,"Anten GSM 2G 3G 4G Wifi WLAN hình chóp nấm đa hướng dùng phát sóng cho các bộ Wifi, sóng GSM",150000,150000,0,0
TIKI,laptop-may-vi-tinh-linh-kien,124897242,"Combo : kìm bấm dây mạng + test mạng + 50 hạt bấm dây mạng COB",105100,105100,0,0
TIKI,laptop-may-vi-tinh-linh-kien,16880726,"RAM Laptop Kingston 8GB DDR4 (PC4) 2666MHz KVR26S19S8/8 - Hàng Chính Hãng",820000,820000,0,0
TIKI,laptop-may-vi-tinh-linh-kien,262463411,"Hộp mực 35A cho máy in HP LaserJet P1006, P1005",145000,145000,0,0
TIKI,laptop-may-vi-tinh-linh-kien,13615460,"Bộ Chia 4 Usb Cổng 3.0 Phát Triển Chia Nhiều Cổng Chuyền Đổi Tốc Độ Cao Type-c Điện Thoại Máy Tính Bảng 1 Chia 4 Chức Năng Sạc Nhanh (Đen)",45172,45172,0,0
TIKI,laptop-may-vi-tinh-linh-kien,173380884,"Hộp mực in HP 103A/W1103A hàng chính hãng Viettoner dùng cho máy in HP Neverstop Laser 1000A, 1000W, 1200A, 1200W mới 100% [Fullbox]",109000,109000,0,0
TIKI,laptop-may-vi-tinh-linh-kien,7431349,"Router Wi-Fi Công suất cao tốc độ 300Mbps chuẩn N TL-WR841HP - Hàng Chính Hãng",699000,1299000,600000,46
TIKI,laptop-may-vi-tinh-linh-kien,447634,"USB SanDisk 3.0 Ultra CZ48 32GB - Hàng Chính Hãng",169000,179000,10000,6
TIKI,laptop-may-vi-tinh-linh-kien,448550,"Ổ Cứng HDD Camera WD Purple™ 6TB/64MB/3.5 IntelliPower - WD60PURZ - Hàng Chính Hãng",3990000,3990000,0,0
TIKI,laptop-may-vi-tinh-linh-kien,68027300,"Tenda Bộ phát Wifi di động 4G LTE 4G03 - Hàng Chính Hãng",950000,950000,0,0
TIKI,laptop-may-vi-tinh-linh-kien,48485601,"Khay Trượt SlideTray Cho Tủ Rack, Tủ Mạng - TMC RACK 19 Inh",330000,330000,0,0
TIKI,laptop-may-vi-tinh-linh-kien,190792429,"Ổ cứng Nas Toshiba N300 Hàng Chính Hãng",6400000,6400000,0,0
TIKI,laptop-may-vi-tinh-linh-kien,197652831,"Bộ máy tính để bàn Vlimited chuyên Game cấu hình cao vga rời sản phẩm trọn bộ - Hàng chính hãng",5330000,5330000,0,0
TIKI,laptop-may-vi-tinh-linh-kien,6410735,"Cáp mạng đúc sẵn 2 đầu Cat 5 dài 2M Ugreen NW103 11231 - Hàng chính hãng",40000,52000,12000,23
TIKI,laptop-may-vi-tinh-linh-kien,37402099,"Tủ Mạng, Tủ Rack  2U Sâu D370 Dùng Cho Đầu Ghi Camera",190000,190000,0,0
TIKI,laptop-may-vi-tinh-linh-kien,6093713,"Cáp mạng Cat6 UTP 24AWG đầu bọc kim loại dài 1m UGREEN NW101 - Hàng chính hãng",50000,65000,15000,23
TIKI,laptop-may-vi-tinh-linh-kien,69839236,"Router Draytek Vigor 2926 - Hàng Chính Hãng",3541155,3541155,0,0
TIKI,laptop-may-vi-tinh-linh-kien,67254115,"Thiết bị mạng DrayTek Vigor3220 - Hàng Chính Hãng",10626000,10626000,0,0
TIKI,laptop-may-vi-tinh-linh-kien,171233663," Gạt mực 12A (gạt nhỏ)",5000,5000,0,0
TIKI,laptop-may-vi-tinh-linh-kien,132167314,"Ổ cứng SSD KingSpec P4 120GB / sản phẩm MỚI - Hàng Chính Hãng",438000,438000,0,0
TIKI,laptop-may-vi-tinh-linh-kien,110459131,"Cáp kết nối KVM Aten 2L-5202U Chuẩn USB/ 1.8 mét - Hàng chính hãng",380000,380000,0,0
TIKI,laptop-may-vi-tinh-linh-kien,56588897,"Khung Treo Máy Chiếu Điện 1,5M Điều Khiển - ECM15 DALITE - HÀNG CHÍNH HÃNG",4000000,4000000,0,0
TIKI,laptop-may-vi-tinh-linh-kien,20111924,"Bộ Phát Sóng Wifi 300Mbps 2 Ăng-Ten TPLink 820N- Hàng Chính Hãng",250000,250000,0,0
TIKI,laptop-may-vi-tinh-linh-kien,8314996,"Dây Mạng Bấm Sẵn 2 Đầu CAT5 UTP Dài 1.5m (Màu ngẫu nhiên)",8898,8898,0,0
TIKI,laptop-may-vi-tinh-linh-kien,48542297,"Ổ Cứng SSD 120GB Kingmax SMV32 SATA III - Hàng Chính Hãng",390000,390000,0,0
TIKI,laptop-may-vi-tinh-linh-kien,25814302,"Bộ Phát Wifi Tenda F6 - Hàng Nhập Khẩu",275000,275000,0,0
TIKI,laptop-may-vi-tinh-linh-kien,56682282,"Hộp mực CF 226A/ 26A dùng cho máy in HP MFP M426fdn, M402dw, M402n (mã HKC-CF 226A)",198000,198000,0,0
TIKI,laptop-may-vi-tinh-linh-kien,24494305,"Card PCI Express ra 2 cổng COM RS232",235000,235000,0,0
TIKI,laptop-may-vi-tinh-linh-kien,109714759,"Vỏ Case Gaming VSP KING ARMS KA-260 - Hàng Chính Hãng",599000,599000,0,0
TIKI,laptop-may-vi-tinh-linh-kien,22384010," Tem Nhãn Ngành  Sử dụng máy in tem trang sức - tem in mã vạch - kích thước định sẵn  21X10mm _KIOJ",120000,120000,0,0
TIKI,laptop-may-vi-tinh-linh-kien,208120552,"MÀN CHIẾU TREO TƯỜNG 100 INCH - 70X70 - 1,78MX1,78M P70WS DALITE - Hàng nhập khẩu",520000,520000,0,0
TIKI,laptop-may-vi-tinh-linh-kien,95564250,"Gạt lớn Gạt Drum 12A hàng chính hãng Alphacartridge dành cho hộp mực Canon 2900 3300 6300 HP 05A 49A 53A 80A ",10000,10000,0,0
TIKI,laptop-may-vi-tinh-linh-kien,31521631,"Hộp Bảo về Ổ Cứng - Túi Chống Sốc Ổ Cứng 2,5" Orico PHB - Hàng Chính Hãng",60000,60000,0,0
TIKI,laptop-may-vi-tinh-linh-kien,16208533,"Máy in tem nhãn và in hóa đơn Xprinter XP-350BM- Hàng Nhập Khẩu",1599000,2009000,410000,20
TIKI,laptop-may-vi-tinh-linh-kien,8011164,"Bộ Chia Mạng 8 Cổng TP-Link TL-SG108E - Hàng chính hãng",839000,839000,0,0
TIKI,laptop-may-vi-tinh-linh-kien,25191433,"Sạc dành cho Laptop Asus 19V 3.42A (65W)  chân thường kích thước 5.5mm * 2.5mm - Hàng Nhập Khẩu",172000,235000,63000,27
TIKI,laptop-may-vi-tinh-linh-kien,206244271,"Hộp mực 30A cho máy in HP M203d, M203dw, MFP M227fdw",155000,155000,0,0
TIKI,laptop-may-vi-tinh-linh-kien,20419056,"Kìm Bấm Hạt Mạng Xuyên Thấu",184000,184000,0,0
TIKI,laptop-may-vi-tinh-linh-kien,17586666,"Pin cho Macbook Air 13 inch A1466 2013 – 2014 – 2015",1283963,1283963,0,0
TIKI,laptop-may-vi-tinh-linh-kien,23290826,"Pin cho Laptop Dell Inspiron 3521 3421 5437 5521 3737",391995,610000,218005,36
TIKI,laptop-may-vi-tinh-linh-kien,51569284,"USB Thu Wifi Mini 802.11n 150Mbps Không Anten  D00-235",59770,59770,0,0
TIKI,laptop-may-vi-tinh-linh-kien,125433917,"Sạc Dành Cho Laptop Dell Chân Kim To 19.5V 4.62A - 19.5V 3.34A - Kèm Dây nguồn - Hàng Nhập Khẩu",210000,260000,50000,19
TIKI,laptop-may-vi-tinh-linh-kien,82842166," Drum Mitsu 12A Trống dùng cho máy in Canon 2900, Hp 1020 hàng xịn",48100,48100,0,0
TIKI,laptop-may-vi-tinh-linh-kien,2045611,"Đầu Nối Dây Mạng Ugreen RJ45 20391 - Hàng Chính Hãng",93000,93000,0,0
TIKI,laptop-may-vi-tinh-linh-kien,20791809,"Sạc cho Laptop ASUS 19V - 2.37A Hình vuông chân mini",377888,377888,0,0
TIKI,laptop-may-vi-tinh-linh-kien,125936383,"Bao lụa (lô sấy) dành cho máy in HP, Canon 2900, 3300",28900,28900,0,0
TIKI,laptop-may-vi-tinh-linh-kien,84130697," Bàn phím kèm chuột máy tính Giả Cơ Con Báo G21/G21B PRO 2019 Có LED 7 Màu Ấn Tượng",98705,103900,5195,5
TIKI,laptop-may-vi-tinh-linh-kien,134578048,"USB 3.0 SanDisk Ultra Flair CZ73 SDCZ73-G46 - Hàng Chính Hãng",619000,659000,40000,6
TIKI,laptop-may-vi-tinh-linh-kien,6403989,"Dây mạng bấm sẵn 2 đầu Cat6 UTP Patch Cords dài 10M UGREEN NW102 11205 - Hàng chính hãng",94900,109000,14100,13
TIKI,laptop-may-vi-tinh-linh-kien,14188623,"Giấy In Ảnh Một Mặt Khổ A4",46000,46000,0,0
TIKI,laptop-may-vi-tinh-linh-kien,30676879,"10 cuộn Giấy decal nhiệt, in tem mã vạch 2 tem, 35x22mm, dài 30m",290000,290000,0,0
TIKI,laptop-may-vi-tinh-linh-kien,43865791,"Máy chấm công thẻ giấy Okyo A08 - Hàng nhập khẩu",2150000,2150000,0,0
TIKI,laptop-may-vi-tinh-linh-kien,193925997,"Màn hình Dell SE2723DS 27 inch 2K IPS 75Hz - Hàng Chính Hãng",6250000,6250000,0,0
TIKI,laptop-may-vi-tinh-linh-kien,14233958,"Dây Mạng Lan 25 MÉT Đúc Sẵn 2 Đầu Hạt Mạng",32000,32000,0,0
TIKI,laptop-may-vi-tinh-linh-kien,62738191,"Combo 5 lọ mực đổ máy in Hp, Canon Xppro  NPG-6 (HP 35A/36A/05A/83A/78A/85A/44A/76A/79A/237A/281A ) Hàng Nhập Khẩu",150000,150000,0,0
TIKI,laptop-may-vi-tinh-linh-kien,185910888,"Bộ 10 đầu adapter quang SC/APC - Coupler SC/APC",17900,17900,0,0
TIKI,laptop-may-vi-tinh-linh-kien,1822445,"Dây Cáp Mạng Orico PUG-C6-200 CAT6 20m - Hàng Chính Hãng",188000,188000,0,0
TIKI,laptop-may-vi-tinh-linh-kien,21021502,"Phần Mềm Diệt Virus Kaspersky Internet Security (KIS) (3 User) - Hàng chính hãng",675000,675000,0,0
TIKI,laptop-may-vi-tinh-linh-kien,169928292,"Cổng Micro USB 5 Pin",1960,1960,0,0
TIKI,laptop-may-vi-tinh-linh-kien,128645811,"Bộ Phát Wifi 4G LTE Di Động Cao Cấp Mixie - Hàng Nhập Khẩu Thái Lan - Tốc Độ Cao - Sử Dụng Di Động phát wifi oto, xe khách 32 uers",750000,750000,0,0
TIKI,laptop-may-vi-tinh-linh-kien,83209673,"Thiết Bị Ghi Hình Dựng Phim Avermedia C039 - Hàng Chính Hãng",1756550,1849000,92450,5
TIKI,laptop-may-vi-tinh-linh-kien,165998092,"Hộp mực Canon CRG 051 hàng chính hãng Viettoner dùng cho máy in Canon LBP 161dn, LBP 162dw, MF266dn, MF261d, MF264dw, MF269dw - Cartridge CRG 051 - 30A mới 100% [Fullbox]",144900,144900,0,0
TIKI,laptop-may-vi-tinh-linh-kien,33197221,"Bộ Phát Mesh Router Wifi TOTOLINK T6 AC1200 (2 pack) - Hàng Chính Hãng",890000,890000,0,0
TIKI,laptop-may-vi-tinh-linh-kien,108242720,"Giắc chuyển từ cổng Type-C sang USB giành cho macbook, máy tính bảng, điện thoại (Mã: PKL02)",25000,25000,0,0
TIKI,laptop-may-vi-tinh-linh-kien,159432828,"SSD Gigabyte 120GB SATA 2,5 inch GP-GSTFS31120GNTD - Hàng Chính Hãng",470000,470000,0,0
TIKI,laptop-may-vi-tinh-linh-kien,183057938,"Bộ Lưu Điện SUNTEK SPK-02 sạc bằng năng lượng mặt trời - Hàng chính hãng",1190000,1190000,0,0
TIKI,laptop-may-vi-tinh-linh-kien,186000515,"Bàn Phím dành cho laptop Dell LATITUDE E7250 E5250 - Hàng Nhập Khẩu",257000,307000,50000,16
TIKI,laptop-may-vi-tinh-linh-kien,99277176,"Sạc dành cho Laptop Dell Inspiron 14 3000 Series 19.5V 2.31A 45W chân kim nhỏ 4.5*3.0mm",198995,198995,0,0
TIKI,laptop-may-vi-tinh-linh-kien,188551117,"Bàn Kê Máy Chiếu Di Động Tumeisi 3H max 1,8m",615000,615000,0,0
TIKI,laptop-may-vi-tinh-linh-kien,56309545,"Đầu nối quang nhanh fast connector FC ( Vỉ 10 chiếc)",218900,218900,0,0
TIKI,laptop-may-vi-tinh-linh-kien,49996199,"Bộ kéo dài HDMI-J45 qua dây mạng lan  50M-Cat5e/60M-Cat6",430000,430000,0,0
TIKI,laptop-may-vi-tinh-linh-kien,171233502,"Quả đào dành cho máy in canon 2900",11900,11900,0,0
TIKI,laptop-may-vi-tinh-linh-kien,41200676,"Sound card (card âm thanh) SC2 gắn cổng USB",164900,164900,0,0
TIKI,laptop-may-vi-tinh-linh-kien,187188428," Laptop HP ProBook 430 G8(614K6PA)(i3-1115G4|4GB|256GB|Intel UHD Graphics|13.3' HD|)Hàng chính hãng",21396000,21396000,0,0
TIKI,laptop-may-vi-tinh-linh-kien,571874,"Ổ Cứng HDD Seagate BarraCuda 1TB/64MB/3.5 - ST1000DM010 - Hàng chính hãng",1290000,1290000,0,0
TIKI,laptop-may-vi-tinh-linh-kien,56244897,"Sạc cho laptop Dell Gaming Inspiron 15 7559 Adapter 19.5V-6.7A",374000,420000,46000,11
TIKI,laptop-may-vi-tinh-linh-kien,24825966,"Box ổ cứng 3.5 inch SATA USB3.0 3588US3",339900,339900,0,0
TIKI,laptop-may-vi-tinh-linh-kien,32848278,"Tool nhấn mạng KRONE LSA-Plus ADC chính hãng",297000,297000,0,0
TIKI,laptop-may-vi-tinh-linh-kien,75702719,"Sạc dành cho Laptop Lenovo Yoga 520-14IKB",256994,450000,193006,43
TIKI,laptop-may-vi-tinh-linh-kien,21579559,"Pin cho Laptop HP ProBook 4430S 4530S 4540S 4330S 4331S  4431S 4435S  4535S",298090,298090,0,0
TIKI,laptop-may-vi-tinh-linh-kien,119271551,"Sạc dành cho Laptop HP 19.5V 10.3A 200W chân kim nhỏ 4.5mm*3.0mm",1290000,1290000,0,0
TIKI,laptop-may-vi-tinh-linh-kien,114970177,"Jack cắm nguồn C13 Cái (Female) dùng để cắm nồi cơm điện, cắm nguồn máy tính",29000,29000,0,0
TIKI,laptop-may-vi-tinh-linh-kien,742841,"Access Point Gắn Trần Tp-Link EAP115 300Mbps - Hàng Chính Hãng",690000,690000,0,0
TIKI,laptop-may-vi-tinh-linh-kien,457264,"TP-Link  TG-3468 - Card Mạng Gigabit - Hàng Chính Hãng",219000,219000,0,0
TIKI,laptop-may-vi-tinh-linh-kien,193412982,"SSD Silicon Power M.2 2280 SATA A55 256GB - Hàng chính hãng",689000,689000,0,0
TIKI,laptop-may-vi-tinh-linh-kien,16972868,"Quạt Tản Nhiệt 6X6X1.5cm 12VDC",18990,18990,0,0
TIKI,laptop-may-vi-tinh-linh-kien,67832475,"USB Verbatim ToughMAX USB 2.0 32 GB - Hàng chính hãng",135000,135000,0,0
TIKI,laptop-may-vi-tinh-linh-kien,125433901,"Sạc dành cho Microsoft Surface Pro 7 - Kèm Dây nguồn - Hàng Nhập Khẩu",889000,939000,50000,5
TIKI,laptop-may-vi-tinh-linh-kien,23620451,"Ram Laptop Hynix 4GB DDR3 1600MHz PC3L-12800 1.35v - Hàng chính hãng",275000,445000,170000,38
TIKI,laptop-may-vi-tinh-linh-kien,122234248,"Hộp mực in màu đỏ 119A M/W2092A (không chip) cho máy in HP Color Laser 150a, HP Color Laser 150nw, HP Color Laser MFP 178nw, HP Color Laser MFP 179fnw - hàng nhập khẩu",189000,189000,0,0
TIKI,laptop-may-vi-tinh-linh-kien,109889064,"USB thu Wifi 300Mbps cho Máy tính - card mạng wifi 300M",80000,80000,0,0
TIKI,laptop-may-vi-tinh-linh-kien,168779128,"Pin dành cho Laptop HP 15s-du 15s-fq Series - HT03XL",699000,699000,0,0
TIKI,laptop-may-vi-tinh-linh-kien,13644506,"Hộp mực 337 dùng cho máy in Canon  MF211/212W/215/216N/217W/221D/223D/226DN/227DW/229DW siêu mịn- siêu nét",116300,116300,0,0
TIKI,laptop-may-vi-tinh-linh-kien,71303993,"Lô sấy dùng cho máy photocopy Toshiba E 205/205L/206L/255/256/305/306/ 355/356/455/456/257/307/357/457/507",135000,135000,0,0
TIKI,laptop-may-vi-tinh-linh-kien,99240292,"Sạc dành cho Laptop HP (các loại) 19.5V 2.31A 45W chân kim nhỏ 4.5*3.0mm",195000,195000,0,0
TIKI,laptop-may-vi-tinh-linh-kien,181214897,"Bộ phát wifi Ruijie 4 râu RG-EW300 Pro - Hàng chính hãng",389000,389000,0,0
TIKI,laptop-may-vi-tinh-linh-kien,25007161,"Hộp Đựng Ổ Cứng Di Động HDD Box 2.5 ORICO 2139C3-G2 USB3.1 Gen2 Type-C/2.5 Nhựa Trong Suốt - Hàng Chính Hãng",303000,303000,0,0
TIKI,laptop-may-vi-tinh-linh-kien,95564252,"Drum Trống in 35A LongLife loại tốt dành cho hộp mực HP 85A 78A 79A 83A 36A Canon 312 313 325 326 328 337 6230dn 6030w 6200 151dw 3050 mf235",23800,23800,0,0
TIKI,laptop-may-vi-tinh-linh-kien,108844933,"Nguồn Adapter 15V 1A 2A Nguồn Loa kẹo kéo",55000,55000,0,0
TIKI,laptop-may-vi-tinh-linh-kien,71896487,"Combo 5 lọ mực HA1005 - Nạp ( đổ ) cho hộp mực 35A/36A/78A/83A/85A của các mã máy in HP 1005, 1006, Canon 3010/ 3050 / 3100/ HP 1505, M1120, M 1512, 1520, 1522 - Canon 3250/HP 1530, 1536, 1566, 1606, Canon 6200, 6230, 4400, 4410, 4430, 4450, 4550, 4580, 4",140000,140000,0,0
TIKI,laptop-may-vi-tinh-linh-kien,185239061,"Máy quét mã vạch có dây YHD 1200C 1D đọc mã vạch Barcode(1D) dùng dây trực tiếp cắm cổng USB Máy tính, Laptop - Hàng Nhập Khẩu",569000,853500,284500,33
TIKI,laptop-may-vi-tinh-linh-kien,59072144,"Máy in bill nhiệt Xprinter XP-A160H - Hàng chính hãng",1009000,1009000,0,0
TIKI,laptop-may-vi-tinh-linh-kien,132025162,"Kaspersky Internet Security 1 PC - Hàng chính hãng",285000,330000,45000,14
TIKI,laptop-may-vi-tinh-linh-kien,34688302,"Soundcard Hát Karaoke Online, Auto Tune, 48V, Takstar SC-M1 - Hàng Chính Hãng",1672000,1672000,0,0
TIKI,laptop-may-vi-tinh-linh-kien,136594014,"Bàn phím dành cho Laptop HP 14-bf series - Hàng Nhập Khẩu",371000,421000,50000,12
TIKI,laptop-may-vi-tinh-linh-kien,243093254,"Sạc dành cho MacBook Pro 13" 2020 Adapter Charger A1947 A2338 A2251 A1534 A2289 Type-C 87W",850000,850000,0,0
TIKI,laptop-may-vi-tinh-linh-kien,53184762,"Tản nhiệt khí CPU RGB Jonsbo CR-1000 - Hàng Chính hãng",363000,363000,0,0
TIKI,laptop-may-vi-tinh-linh-kien,169778653,"Sạc dành cho Laptop MSI GF63 Thin 10SCSR /GTX1650 Ti A17-120P2A",599000,599000,0,0
TIKI,laptop-may-vi-tinh-linh-kien,17383981,"Phần mềm Kaspersky Total Security chính hãng",391000,391000,0,0
TIKI,laptop-may-vi-tinh-linh-kien,10152542,"Card Mạng TP-LINK TG-3468 Gigabit PCI Express - Hàng Chính Hãng",189000,189000,0,0
TIKI,laptop-may-vi-tinh-linh-kien,74342340,"Hộp mực in laser CF276A (không chip) dùng cho máy in HP LaserJet Pro M404DW/M404DN/M404N/HP LaserJet Pro MFP M428FDW/M428DW/M428FDN - Hàng nhập khẩu",209000,209000,0,0
TIKI,laptop-may-vi-tinh-linh-kien,69196844,"Khóa Xác Thực Mạnh VinCSS FIDO2 Touch 1 (Kết Nối USB Type-A) - Hỗ Trợ Xác Thực An Toàn Không Mật Khẩu, Chuẩn UAF/U2F/FIDO2 - Hàng Chính Hãng",768900,768900,0,0
TIKI,laptop-may-vi-tinh-linh-kien,187622547,"Máy quét mã vạch không dây mẫu mới YHD 1200DW đọc mã vạch Barcode 1D Qrcode 2D kết nối USB dùng trên Máy tính, Laptop - Hàng Nhập Khẩu",1250000,1500000,250000,17
TIKI,laptop-may-vi-tinh-linh-kien,491079,"Mực In Canon Cartridge 326 Cho Máy In Canon LBP 6230DN - Hàng Chính Hãng",1600000,1600000,0,0
TIKI,laptop-may-vi-tinh-linh-kien,26176822,"Quạt Tản Nhiệt Coolmoon V2 RGB - Hàng nhập khẩu",83000,83000,0,0
TIKI,laptop-may-vi-tinh-linh-kien,575389,"Hộp Đựng Ổ Cứng Di Động HDD Box ORICO 2189U3 USB3.0/2.5 Nhựa Cứng - Hàng Chính Hãng",169000,169000,0,0
TIKI,laptop-may-vi-tinh-linh-kien,190782369,"Ổ cứng Camera Toshiba S300 Hàng Chính Hãng",1010000,2020000,1010000,50
TIKI,laptop-may-vi-tinh-linh-kien,575590,"Khay Ổ Cứng Laptop (Caddy Bay) ORICO L127SS (12.7mm) - Hàng Chính Hãng",183000,183000,0,0
TIKI,laptop-may-vi-tinh-linh-kien,119484946,"Sạc dành cho Laptop Lenovo Legion 5 15" 15IMH05 15ARH05 AC Charger Adapter 170w Slim",634995,950000,315005,33
TIKI,laptop-may-vi-tinh-linh-kien,185131861,"Sound card K500 chuyên thu âm, livestream, karaoke online",449000,449000,0,0
TIKI,laptop-may-vi-tinh-linh-kien,8464203,"Tool nhấn mạng âm tường (Màu Ngẫu Nhiên)",79000,79000,0,0
TIKI,laptop-may-vi-tinh-linh-kien,71070845,"Bộ 3 lọ mực HA1005  nạp cho máy in HP1005/1006/ Canon 3010/ 3050 / 3100/ HP 1530, 1536, 1566, 1606, Canon 6200, 6230, 4400, 4410, 4430, 4450, 4550, 4580, 4570,, 4452, 4450, 4450, F4420, 4412, 4410, 500, 520, 550, 4700, 4750, 4800, 4820, 4870 - Hàng nhập k",105000,105000,0,0
TIKI,laptop-may-vi-tinh-linh-kien,56371397,"Pin thay thế dành cho Laptop Dell Inspiron 15 3567, N3567",386500,386500,0,0
TIKI,laptop-may-vi-tinh-linh-kien,133811069,"Hộp mực 55A dùng cho máy in HP3010/ HP3015/ HP3015D/ HP 3015DN -(CE255A) (Black)",369000,369000,0,0
TIKI,laptop-may-vi-tinh-linh-kien,26455563,"Hộp cụm drum máy in cho HP 19A có chíp, là khay trống dùng cho máy in HP Pro M102a, 129, 130a, 130fn, 132, 133, 134",165500,165500,0,0
TIKI,laptop-may-vi-tinh-linh-kien,491069,"Mực In Canon Cartridge 325 Cho Máy Canon LBP 6030, LBP 6030W, MF 3010 - Hàng Chính Hãng",1660000,1660000,0,0
TIKI,laptop-may-vi-tinh-linh-kien,114671591,"Tem rời NVX 155 in ép nhiệt UV",179000,179000,0,0
TIKI,laptop-may-vi-tinh-linh-kien,100381938,"Cuộn giấy in nhiệt giấy in bill VAYO 75x100mm - loại 30m, tự dính,chống nước, dành cho TMĐT",42000,65000,23000,35
TIKI,laptop-may-vi-tinh-linh-kien,196675260,"Màn hình máy tính ViewSonic VA2415-H 24 inch/ Full HD/ VA/ 75Hz/ 100% sRGB - Hàng Chính Hãng",2690000,2690000,0,0
TIKI,laptop-may-vi-tinh-linh-kien,52276039,"Anten 15dBi băng tần 700-2600Mhz hỗ trợ GSM-GPRS, 3G-4G Chuẩn SMA/M - Hàng nhập khẩu",157999,157999,0,0
TIKI,laptop-may-vi-tinh-linh-kien,126010145,"DÂY CÁP MẠNG BẤM SẴN LXF 5M/ 10M/ 15M",25000,25000,0,0
TIKI,laptop-may-vi-tinh-linh-kien,194140862,"Sạc dành cho Laptop Gaming MSI GF63 10SC 10SC-014VN/VGA GTX1650 20V 6A",599000,599000,0,0
TIKI,laptop-may-vi-tinh-linh-kien,165024103,"Máy Đếm Tiền Dùng Cho Văn Phòng Oudis 5200B - Hàng Chính Hãng",2800000,2800000,0,0
TIKI,laptop-may-vi-tinh-linh-kien,177976493,"MAINBOARD GIGABYTE B660M DS3H AX DDR4 ( WI-FI 6 / LGA1700 / M-ATX / 4XDDR4 ) - Hàng Chính Hãng",3540000,3540000,0,0
TIKI,laptop-may-vi-tinh-linh-kien,73390576,"Lọ Keo Tản Nhiệt Làm Mát CPU HY410",6713,13058,6345,49
TIKI,laptop-may-vi-tinh-linh-kien,117094494,"Pin dùng cho Laptop Sony vaio SVT-13 - Battery Sony Vaio SVT-13 - Hàng Nhập Khẩu ",1144950,1164950,20000,2
TIKI,laptop-may-vi-tinh-linh-kien,126821411,"ROGTZ Máy Chiếu Vật Thể Scan Màu Di Động Thông Minh Lấy Nét Tự Động Scan Tài Liệu K1002 - Hàng Nhập Khẩu",1762250,1855000,92750,5
TIKI,laptop-may-vi-tinh-linh-kien,69355415,"Pin dành cho Laptop Dell Vostro 5468, Vostro 5368",589000,589000,0,0
TIKI,laptop-may-vi-tinh-linh-kien,28253302,"Card Màn Hình VGA ASUS DUAL-GTX1650-4G GDDR5 4GB 128-bit - Hàng Chính Hãng",5150000,5150000,0,0
TIKI,laptop-may-vi-tinh-linh-kien,188700458,"Bao bảo vệ ổ cứng 2.5", ORICO PHD-25 - Hàng Chính Hãng",54000,54000,0,0
TIKI,laptop-may-vi-tinh-linh-kien,136594199,"Bàn Phím Dành Cho Laptop DELL LATITUDE 12 E7240 E7440 Latitude 12 14 7000 E7420 E7240 E7440 - Hàng Nhập Khẩu mới 100%",292000,342000,50000,15
TIKI,laptop-may-vi-tinh-linh-kien,26664592,"Hộp cụm drum cho máy in HP 32A có chíp, nhập khẩu mới, là cụm khay trống dùng cho máy in HP Pro M102a, 102w, 129, 130a, 130fn, 132, 133, 134",175000,175000,0,0
TIKI,laptop-may-vi-tinh-linh-kien,53627858,"Hộp mực 78A dành cho máy in HP MF 1536DNF/ P1566/ P1606D/ P1560/ P1600 - CE278A",116500,116500,0,0
TIKI,laptop-may-vi-tinh-linh-kien,66389658,"Crimping tool Pass Through ezi-PLUG  - kèm bấm mạng cho đầu RJ45 xuyên thấu - Hàng chính hãng Dintek",1160000,1160000,0,0
TIKI,laptop-may-vi-tinh-linh-kien,212356638,"Hộp mực CF 226A/ 26A dùng cho máy in HP MFP M426fdn, M402dw, M402n (mã HKC-CF 226A)",202700,202700,0,0
TIKI,laptop-may-vi-tinh-linh-kien,17627199,"Bộ 6 Quạt + Khiển Coolmoon RGB V2 - Hàng nhập khẩu",539000,539000,0,0
TIKI,laptop-may-vi-tinh-linh-kien,107989969,"Sạc cho Laptop Gaming MSI GS63 Stealth 8RD 150W",690000,690000,0,0
TIKI,laptop-may-vi-tinh-linh-kien,122234261,"Hộp mực in màu vàng 119A Y/W2093A (không chip) cho máy in HP Color Laser 150a, HP Color Laser 150nw, HP Color Laser MFP 178nw, HP Color Laser MFP 179fnw - hàng nhập khẩu",189000,189000,0,0
TIKI,laptop-may-vi-tinh-linh-kien,169705253,"Ổ Cứng SSD Gigabyte 120Gb (2.5" Sata iii 6Gb/S) - Hàng Chính Hãng",460000,460000,0,0
TIKI,laptop-may-vi-tinh-linh-kien,161228949,"Sạc dành cho Laptop Dell Inspiron G5 15 5587, G7 15 7588, Inspiron 15 7577 180W ",789995,789995,0,0
TIKI,laptop-may-vi-tinh-linh-kien,101255515,"USB typec 3.1 gen2 ra 2.5inch 6G hộp đựng ổ cứng kèm 1 sợi cáp 2 trong 1 Type C ra A + C Ugreen 221UBC60735US Hàng Chính Hãng",379000,399000,20000,5
TIKI,laptop-may-vi-tinh-linh-kien,177054878,"CPU máy tính Intel Core I3 10105F, 3.7Ghz 6MB, Socket LGA 1200 - Hàng chính hãng",1920000,1920000,0,0
TIKI,laptop-may-vi-tinh-linh-kien,76569044,"Sạc dành cho Laptop Acer Predator Helios 300 G3-571 G3-572 PH317-51 PH315-51 180W ",594995,594995,0,0
TIKI,laptop-may-vi-tinh-linh-kien,22021194,"Sạc dành cho Laptop Asus 19v-3.42a",129000,129000,0,0
TIKI,laptop-may-vi-tinh-linh-kien,125432770,"Sạc dành cho Laptop Asus X541U X541UA Adapter 19V-2.37A - Hàng Nhập khẩu",264000,314000,50000,16
TIKI,laptop-may-vi-tinh-linh-kien,56195676,"Máy in đa năng trắng đen (In, sao chép, quét) HP LaserJet MFP 135a_4ZB82A – Hàng chính hãng",3790000,3790000,0,0
TIKI,laptop-may-vi-tinh-linh-kien,159439257,"CPU Intel Core i3-12100F (3.3GHz turbo up to 4.3GHz, 4 nhân 8 luồng, 12MB Cache, 58W)- Socket Intel LGA 1700) - Hàng Chính Hãng",2590000,2590000,0,0
TIKI,laptop-may-vi-tinh-linh-kien,171233591,"Hộp mực 35A  - 85A dành cho máy in HP 1005 1006... Nobox",115500,115500,0,0
TIKI,laptop-may-vi-tinh-linh-kien,56433502,"Pin dành cho Laptop Dell Latitude E6440",425995,750000,324005,43
TIKI,laptop-may-vi-tinh-linh-kien,120524379,"Máy Hủy Tài Liệu, Thẻ Đĩa Cao Cấp Deli - Phù Hợp Bảo Mật Giấy Tờ Trong Doanh Nghiệp, Văn Phòng, Nhà Trường - Hàng chính hãng - E9921-EU",3199000,5398200,2199200,41
TIKI,laptop-may-vi-tinh-linh-kien,9966450,"Hộp mực 12A cho máy in 2900 3000 HP. 1010 1020 - Q2612A",117500,117500,0,0
TIKI,laptop-may-vi-tinh-linh-kien,15335280,"Hộp mực in 1010 cho máy in Brother HL- 1111, 1201, 1611, 1616NW.",109000,109000,0,0
TIKI,laptop-may-vi-tinh-linh-kien,125432526,"Sạc dành cho Laptop MSI GL62M 7RDX - 120W - Kèm Dây nguồn - Hàng Nhập Khẩu",589000,639000,50000,8
TIKI,laptop-may-vi-tinh-linh-kien,109890035,"Kìm bấm mạng Talon 500R + Hộp 100 đầu mạng RJ45",279300,294000,14700,5
TIKI,laptop-may-vi-tinh-linh-kien,19992606,"Sạc 20V-3.25A đầu USB kim cho laptop Lenovo",215000,215000,0,0
TIKI,laptop-may-vi-tinh-linh-kien,71206779,"Gạt bell (gạt băng tải) dùng cho máy photocopy Toshiba E 550, 650, 520, 720, 850, 523, 603, 723, 555, 655, 755, 556, 656, 756, 657, 857",60000,60000,0,0
TIKI,laptop-may-vi-tinh-linh-kien,48493342,"Tủ Mạng, Tu Rack 6U Ngoài Trời Outdoor Rack",1300000,1300000,0,0
TIKI,laptop-may-vi-tinh-linh-kien,15854585,"Dây Cáp Mạng Orico PUG-C6-300 CAT6 30m - Hàng Chính Hãng",229000,229000,0,0
TIKI,laptop-may-vi-tinh-linh-kien,137171247,"Bàn phím dành cho Laptop Asus X454L X454LA - Hàng Nhập Khẩu",218000,268000,50000,19
TIKI,laptop-may-vi-tinh-linh-kien,24255305,"Dây Cáp Mạng Bấm Sẵn 2 đầu CAT5",19000,21700,2700,12
TIKI,laptop-may-vi-tinh-linh-kien,194478375,"Màn Hình LG UltraGear 24GQ50F-B (24"/VA/165Hz/FHD/FreeSync) (LG 24GQ50F) - Hàng Chính Hãng",3390000,3390000,0,0
TIKI,laptop-may-vi-tinh-linh-kien,125432690,"Sạc dành cho Laptop Toshiba Satellite L640 L645 L645D Adapter 19V-3.42A - Kèm Dây nguồn - Hàng Nhập Khẩu",229000,279000,50000,18
TIKI,laptop-may-vi-tinh-linh-kien,135420078,"Máy in nhiệt IDPRT SP410 in đơn hàng, phiếu gửi, minicode, nhãn tự dán, hàng nhập khẩu bảo hành 12 tháng",1550000,1550000,0,0
TIKI,laptop-may-vi-tinh-linh-kien,107212631,"Rắc chuyển đổi vừa sạc vừa nghe tai nghe chân 3.5",35850,35850,0,0
TIKI,laptop-may-vi-tinh-linh-kien,212269153,"Hộp mực 17A (có CHIP) cho máy in HP M102w, M102a, MFP M130fn, MFP M130fw, MFP M130a, MFP M130w",195000,195000,0,0
TIKI,laptop-may-vi-tinh-linh-kien,26314030,"Phần mềm diệt Virus KASPERSKY ANTIVIRUS cho 1PC/Năm - Phân phối Chính hãng",185000,185000,0,0
TIKI,laptop-may-vi-tinh-linh-kien,51582965,"Đầu chụp mạng RJ45 Cat5/Cat6 bịch 100PSC màu ngẫu nhiên - Hàng nhập khẩu",29900,29900,0,0
TIKI,laptop-may-vi-tinh-linh-kien,52577055,"Cụm Trống Máy In Brother HL-L2321D, HL-L2361DN, HL-L2366DW, DCP-L2520D, MFC-L2701D, MFC-L2701DW - Mã Cụm Drum DR-2385/2380/2360/2361/2325",177000,177000,0,0
TIKI,laptop-may-vi-tinh-linh-kien,51733508,"Cụm trống /cụm drum CF232A (32A) dùng cho máy in HP LaserJet Pro M203dn (G3Q46A), M203dw (G3Q47A), MFP M227fdn (G3Q79A), MFP M227fdw (G3Q75A), MFP M227sdn (G3Q74A), MFP M206, MFP M230",154900,154900,0,0
TIKI,laptop-may-vi-tinh-linh-kien,52789693,"Bộ Phát Wifi Xiaomi Router 4C Bản Tiếng Anh Quốc Tế - Hàng Nhập Khẩu",289000,289000,0,0
TIKI,laptop-may-vi-tinh-linh-kien,158459835,"Thiết bị cân bằng tải Router wifi hAp AC lite TC Mikrotik RB952Ui-5ac2nD-TC - Hàng chính hãng",1871500,1871500,0,0
TIKI,laptop-may-vi-tinh-linh-kien,13455142,"Đế cắm ổ cứng đôi (2 khe cắm) kết nối chuẩn 3.0 Orico 6228US3 - Dock ổ cứng 2,5" và 3,5" HDD/SSD - Hàng Nhập Khẩu",545000,545000,0,0
TIKI,laptop-may-vi-tinh-linh-kien,959553,"Bo Mạch Chủ ASUS H81 M-K - Hàng Chính Hãng",1490000,1490000,0,0
TIKI,laptop-may-vi-tinh-linh-kien,155827302,"Switch Ruijie Reyee RG-ES08 8-Port 10/100 Mbps - Hàng Chính Hãng ",210000,210000,0,0
TIKI,laptop-may-vi-tinh-linh-kien,51500453,"Module quang SFP 1 sợi quang 1.25G, LC, DDM 1550/1310 20km chính hãng",385000,385000,0,0
TIKI,laptop-may-vi-tinh-linh-kien,102105775,"Combo Tản Nhiệt Sò Nóng Lạnh Bằng Dung Dịch 1 Sò",125000,125000,0,0
TIKI,laptop-may-vi-tinh-linh-kien,464565,"Linksys E1700 - Router Wifi Chuẩn N 300Mbps - Hàng Chính Hãng",459000,459000,0,0
TIKI,laptop-may-vi-tinh-linh-kien,23066996,"Hộp đựng ổ cứng 2.5 SSD/HDD SATA 3 USB 3.0 Orico 2577u3 ( vỏ nhựa đen - Hàng Nhập Khẩu",125000,125000,0,0
TIKI,laptop-may-vi-tinh-linh-kien,10001341,"RAM Laptop Hynix 16GB DDR4 2133MHz SODIMM - Hàng Nhập Khẩu",924000,1176000,252000,21
TIKI,laptop-may-vi-tinh-linh-kien,148613983,"Pin dành cho Laptop DELL Inspiron 14 3480 3481 ",689995,689995,0,0
TIKI,laptop-may-vi-tinh-linh-kien,34691697,"Màn Chiếu 3 Chân Apollo (Chân sất tròn)- Hàng chính hãng",710000,710000,0,0
TIKI,laptop-may-vi-tinh-linh-kien,153654799,"Bộ Chia Mạng 5 Cổng D-Link DES-1005C - Switch Chia Mạng - Hàng Chính Hãng",155000,155000,0,0
TIKI,laptop-may-vi-tinh-linh-kien,136684737,"Cáp nối mạng Lan Ugreen 80429 1M ,80430 1,5m , 80431 2m , 80432 3m , 80433 5m CAT8 - Hàng chính hãng",115000,115000,0,0
TIKI,laptop-may-vi-tinh-linh-kien,15680089,"Cụm drum (trống mực) DR 2255 cho máy in Brother HL- 2250DN, 2840, 2280. Brother MFC 7860, DCP-7055",179900,179900,0,0
TIKI,laptop-may-vi-tinh-linh-kien,114907316," Nguồn Tổ Ong, nguồn camera,Nguồn 12V-5A,10A,15A,20A,30A. (Ảnh thật)",64500,64500,0,0
TIKI,laptop-may-vi-tinh-linh-kien,56510630,"Pin dành cho laptop HP mã pin: HS04 ",293900,293900,0,0
TIKI,laptop-may-vi-tinh-linh-kien,52190201,"[10 cuộn] Giấy in nhiệt Giấy in bill VAYO Khổ 80 x 80 mm - định lượng 65gsm - In rõ nét  - Lõi siêu nhỏ - Hàng chính hãng, bán chạy số #1 tại Thái Lan",205000,239000,34000,14
TIKI,laptop-may-vi-tinh-linh-kien,96347665,"Giá đỡ laptop macbook, đế tản nhiệt laptop để bàn gấp gọn dễ dàng điều chỉnh độ cao hỗ trợ tản nhiệt",79000,79000,0,0
TIKI,laptop-may-vi-tinh-linh-kien,112331758,"Dây cáp mạng internet bấm sẵn 2 đầu dài 10m, 15m, 20m,25m, 30m",20940,20940,0,0
TIKI,laptop-may-vi-tinh-linh-kien,93936463,"HUB Aura Sync P-ARGB V2.0 Coolmoon cho Fan Led RGB và đèn Led RGB đồng bộ Mainboard máy tính - hàng nhập khẩu",195000,195000,0,0
TIKI,laptop-may-vi-tinh-linh-kien,171233567,"5 Lò xo dành cho hộp mực 12A - canon 2900, Hp 1020, 3000...",20000,20000,0,0
TIKI,laptop-may-vi-tinh-linh-kien,102107211,"Keo tản nhiệt cách điện TM60",22990,22990,0,0
TIKI,laptop-may-vi-tinh-linh-kien,6404169,"Dây mạng bấm sẵn 2 đầu Cat6 UTP Patch Cords dài 20M UGREEN NW102 11206 - Hàng chính hãng",167000,179000,12000,7
TIKI,laptop-may-vi-tinh-linh-kien,192924115,"Dock Cắm Ổ Cứng 2.5 Inch, Chuẩn Sata - Cáp chuyển Sata sang USB 3.0 dùng HDD Laptop, SSD",60000,60000,0,0
TIKI,laptop-may-vi-tinh-linh-kien,171233589,"Mực đổ dành cho hộp mực 17A dùng cho máy in HP LJ MFP M130fn M102w M130fw",19000,19000,0,0
TIKI,laptop-may-vi-tinh-linh-kien,72901476,"box ổ cứng cổng Type C gắn pc cổng Usb 3.1 Gen2 Ugreen 301GB70501CM 2.5 3.5 Inch 6Gb hàng chính hãng",882000,882000,0,0
TIKI,laptop-may-vi-tinh-linh-kien,105768569,"WI-FI 6 TOTOLINK X5000R - Easy Mesh Router Wi-Fi  băng tần kép Gigabit AX1800 - Hàng chính hãng",819000,819000,0,0
TIKI,laptop-may-vi-tinh-linh-kien,148750752,"Thiết bị phát wifi không dây 4 râu chuẩn 300Mbps kích sóng repeater Wireless Router F6 Tenda hàng chính hãng",284000,284000,0,0
TIKI,laptop-may-vi-tinh-linh-kien,146205701,"Cụm Drum DR-2385 - SAHA - Hộp mực dùng cho máy in Brother: HL – L2321D, L2361DN, L2366DW / MFC – L2701D/DW, DCP – L2520D.",330000,330000,0,0
TIKI,laptop-may-vi-tinh-linh-kien,48449680,"Pin cho Laptop Dell Inspiron 3458 5451 5559 5558 3451 3558",373900,373900,0,0
TIKI,laptop-may-vi-tinh-linh-kien,113099318,"Usb Bluetooth 5.0 DONGLE YPF-05",43000,49000,6000,12
TIKI,laptop-may-vi-tinh-linh-kien,7940215,"Sạc Dành Cho Laptop Acer 19v-3,42a 65W - Hàng nhập khẩu F1",172000,235000,63000,27
TIKI,laptop-may-vi-tinh-linh-kien,196154096,"Drum trống in 26A 76A CRG 052 057 Cho Máy in HP M402d M402n M420dw M426 M404n M404d M428dw LBP 214dw 215d MF426dw 429dw 223dw 226dw",27500,27500,0,0
TIKI,laptop-may-vi-tinh-linh-kien,62735389,"Combo 5 lọ mực đổ máy in Hp, Canon Xppro 160g  (HP12A/ 35A/78A/79A/05A/83A/85A/76A/79A/226A/16A)",185000,185000,0,0
TIKI,laptop-may-vi-tinh-linh-kien,123482029,"Mực nạp/mực đổ chuyên dụng dùng cho hộp mực 12A/ 49A/ 05A, máy in laser Canon 2900/ 3300, HP 1010/1020... HÀNG CHÍNH HÃNG-COMBO 5 BÌNH",140000,140000,0,0
TIKI,laptop-may-vi-tinh-linh-kien,15163840,"Dây nguồn PC, dây nguồn máy tính dài 1.5-2m, dây nguồn lõi đồng",15000,15000,0,0
TIKI,laptop-may-vi-tinh-linh-kien,56632269,"Quạt Tản Nhiệt 12V Tốc Độ Cao 4x4x1cm 0,1A",14000,14000,0,0
TIKI,laptop-may-vi-tinh-linh-kien,192339434,"Bàn phím dành cho Laptop DELL Inspiron 15-3000 3551 3552 3541 3543 3542 3559 3565 3567 3558 Keyboard",254995,254995,0,0
TIKI,laptop-may-vi-tinh-linh-kien,108844482,"QUẠT TẢN NHIỆT 40x40x10mm 50x50x10mm 70x70x15mm 80x80x20mm 90x90x25mm 120x120x25mm",20000,20000,0,0
TIKI,laptop-may-vi-tinh-linh-kien,56857266,"Pin dành cho Laptop Acer Aspire 4750, 4750Z, 4751, 4751G",349000,349000,0,0
TIKI,laptop-may-vi-tinh-linh-kien,171089505,"Nhãn In đa lớp Tz2-231 - Đen nền trắng 12mm x 8m - Hàng nhập khẩu",128800,140000,11200,8
TIKI,laptop-may-vi-tinh-linh-kien,708812,"Router Wifi Chuẩn N Mercusys MW325R (300Mbps)  - Hàng Chính Hãng",265000,265000,0,0
TIKI,laptop-may-vi-tinh-linh-kien,56316601,"Pin thay thế dành cho Laptop Dell Vostro 2420",374995,374995,0,0
TIKI,laptop-may-vi-tinh-linh-kien,14536076,"Ổ cứng di động Transcend StoreJet 25H3P 4TB USB 3.0/3.1 - Hàng Chính Hãng",3990000,3990000,0,0
TIKI,laptop-may-vi-tinh-linh-kien,81509771," Mực nạp/ bơm mực dùng cho máy in laser HP, Samsung, Xerox, Panasonic- INKMAX- HÀNG CHÍNH HÃNG - 80 gram",32000,32000,0,0
TIKI,laptop-may-vi-tinh-linh-kien,126702244,"Remote Điều khiển từ xa máy chiếu dành cho Vivitek",150000,220000,70000,32
TIKI,laptop-may-vi-tinh-linh-kien,188585572,"Cáp Ổ Cứng HDD USB 3.0 Di Động Truyền Dữ Liệu Tốc Độ Cao Dây Cáp USB Dùng Cho Ổ Cứng Rời Di Động Dài 2m",58000,58000,0,0
TIKI,laptop-may-vi-tinh-linh-kien,17808066,"Quạt Tản Nhiệt 8x8x2.5cm 12VDC-0.19A",26000,26000,0,0
TIKI,laptop-may-vi-tinh-linh-kien,6506579,"Bàn Phím Dành Cho Laptop Dell Inspiron 15R, N5110, M5110, M5010, M501Z, M511R - Hàng Nhập Khẩu",99000,250000,151000,60
TIKI,laptop-may-vi-tinh-linh-kien,117093010,"Pin cho Laptop HP 240 245 246 250 256 G4 HS03 HS04 - Hàng Nhập Khẩu ",355000,375000,20000,5
TIKI,laptop-may-vi-tinh-linh-kien,22099454,"Sạc cho Laptop HP 18.5v-3.5a đầu kim",188995,188995,0,0
TIKI,laptop-may-vi-tinh-linh-kien,152400119,"Thùng 100 Cuộn Giấy In Hóa Đơn K57/K58 Phi 38 Cho Máy POS cầm tay ",330000,330000,0,0
TIKI,laptop-may-vi-tinh-linh-kien,188948103,"Hộp mực máy in HP 137fnw (có chip) hàng nhập khẩu - Dùng cho máy in HP Laser MFP 137fnw - Cartridge 107A / W1107A mới 100% [Full Box]",239000,239000,0,0
TIKI,laptop-may-vi-tinh-linh-kien,15350656,"100 Cuộn Giấy In Hóa Đơn K57 Phi 38 Cho Máy In Nhiệt",360000,360000,0,0
TIKI,laptop-may-vi-tinh-linh-kien,124897486,"Dây mạng cat5e dài 20M 25M 30M 40M 50M 60M chuẩn đúc sẵn 2 đầu bấm-dây mạng lan internet tốt xịn cao cấp",9000,9000,0,0
TIKI,laptop-may-vi-tinh-linh-kien,23302345,"Pin cho Laptop Dell Inspiron N4010 N4110 N5010 N5050 N5110 N7010 N7110",328000,328000,0,0
TIKI,laptop-may-vi-tinh-linh-kien,49502410,"Keo Tản Nhiệt Tuýp  To HY510 ( keo tản nhiệt làm mát CPU)",10850,10850,0,0
TIKI,laptop-may-vi-tinh-linh-kien,27733605,"Bàn Phím Dùng Cho Laptop Sony Vaio SVE14, SVE141 Series Keyboard",350000,350000,0,0
TIKI,laptop-may-vi-tinh-linh-kien,54616069,"USB SanDisk Cruzer Blade CZ50 USB2.0- 64GB - Hàng nhập khẩu",159000,169000,10000,6
TIKI,laptop-may-vi-tinh-linh-kien,99232907,"Hộp mực máy in 12A/303 Dành Cho Canon 2900/3000 Hp 1010/1020 Có NÚT NẠP MỰC và NÚT XẢ MỰC THẢI",125000,125000,0,0
TIKI,laptop-may-vi-tinh-linh-kien,113709448,"Sạc dành cho Laptop ASUS ZENBOOK  UX391UA, UX391UA-EG030T, UX391UA-ET081T",520000,520000,0,0
TIKI,laptop-may-vi-tinh-linh-kien,120463101,"Keo tản nhiệt ống chích lớn xám xịn (xi lanh)- Keo Tản Nhiệt Mini Làm Mát CPU",13020,13020,0,0
TIKI,laptop-may-vi-tinh-linh-kien,105183726,"Két đựng tiền thu ngân, Ngăn kéo đựng tiền CASH DRAWER TOPCASH JJ-330G có 9 ngăn – Hàng cao cấp chính hãng",660000,770000,110000,14
TIKI,laptop-may-vi-tinh-linh-kien,104909318,"DrayTek Vigor2962 - Hàng Chính Hãng",8899000,9850000,951000,10
TIKI,laptop-may-vi-tinh-linh-kien,59421267,"Pin dành cho laptop Dell XPS 15 9550, 9560, Precision 5510- 4GVGH 84Wh",1289995,1289995,0,0
TIKI,laptop-may-vi-tinh-linh-kien,38035787,"Bàn Phím Thay Thế Cho Máy Tính Lenovo G40-70 G40-30",169000,169000,0,0
TIKI,laptop-may-vi-tinh-linh-kien,56498527,"Pin dành cho Laptop Dell Inspiron 15 5559",549995,549995,0,0
TIKI,laptop-may-vi-tinh-linh-kien,187652485,"Mực in dùng cho máy Canon MF217w/ MF226dn/ MF232w/ MF246dn/ MF249dw/ MF244dw/ MF241d/ MF237w/ MF235/ LBP 151dw - hộp mực 337 tương thích mới 100%, hoàn thiện 100%, chất lượng tốt, giá như nạp mực",129000,129000,0,0
TIKI,laptop-may-vi-tinh-linh-kien,2249745,"Ổ Cứng Di Động Transcend M3G 1TB Slim USB 3.0/3.1 TS1TSJ25M3G - Hàng Chính Hãng",1959000,1959000,0,0
TIKI,laptop-may-vi-tinh-linh-kien,57971298,"Hộp mực 35A/36A/85A cho các dòng máy in HP 1005,1006,p1102,P1102w,1120,1522,1505,M1212NF,M1132/ Canon LBP - 6030,6230,..",119000,119000,0,0
TIKI,laptop-may-vi-tinh-linh-kien,12274956,"Thiết bị thu phát sóng vô tuyến USB wifi Totolink A650UA - Hàng chính hãng",249000,249000,0,0
TIKI,laptop-may-vi-tinh-linh-kien,14294260,"Dây Mạng Lan 40 MÉT Đúc Sẵn 2 Đầu Hạt Mạng",50990,50990,0,0
TIKI,laptop-may-vi-tinh-linh-kien,135753125,"Ugreen 70657 9.5mm caddy bay khay đựng ổ cứng và ssd 2.5inch sata mỏng gắn vào khe cd - dvd của laptop CM322 - Hàng chính hãng",169000,169000,0,0
TIKI,laptop-may-vi-tinh-linh-kien,137169879,"Bàn phím dành cho Laptop Lenovo IBM Thinkpad T430 T430s - Hàng Nhập Khẩu",589000,639000,50000,8
TIKI,laptop-may-vi-tinh-linh-kien,65361341,"Bàn phím dành cho Laptop Lenovo Ideapad 320-15ISK",285000,285000,0,0
TIKI,laptop-may-vi-tinh-linh-kien,575502,"HDD Box ORICO USBTypeC/3.5/2.5 - 3588C3 - Hàng Chính Hãng",479000,479000,0,0
TIKI,laptop-may-vi-tinh-linh-kien,68545181,"Router Draytek Vigor 2915ac - Hàng Chính Hãng",3277700,3277700,0,0
TIKI,laptop-may-vi-tinh-linh-kien,50743513,"Bộ Lưu Điện HYUNDAI Offline 1500VA - Hàng Chính Hãng",2699000,2699000,0,0
TIKI,laptop-may-vi-tinh-linh-kien,20589395,"Hộp mực máy in mã 12A Viet Toner - Hàng chính hãng",144000,144000,0,0
TIKI,laptop-may-vi-tinh-linh-kien,193439213,"Ổ cứng Silicon Power M.2 2280 PCIe SSD A60 512GB - Hàng chính hãng",1275000,1275000,0,0
TIKI,laptop-may-vi-tinh-linh-kien,145301940,"Baseus USB Bluetooth Dongle Adaptador 5.0 Adapter cho máy tính / Laptop Windows ( hàng chính hãng)",122524,122524,0,0
TIKI,laptop-may-vi-tinh-linh-kien,181461065,"Máy chiếu mini Wanbo X1 Pro-Android 9.0 hỗ trợ điện thoại di động và máy chiếu 4k xem phim đồng thời (kết nối WiFi) - Hàng chính hãng",3050000,3050000,0,0
TIKI,laptop-may-vi-tinh-linh-kien,9363519,"Đầu nối cáp mạng LAN RJ45 chính hãng Ugreen 20311 - Hàng Chính Hãng",65000,65000,0,0
TIKI,laptop-may-vi-tinh-linh-kien,11417001,"Máy chấm công vân tay Hitech X628-C - Hàng nhập khẩu",2750000,2750000,0,0
TIKI,laptop-may-vi-tinh-linh-kien,185999081,"Bàn Phím dành cho laptop Asus X540 X540L X540LA X540LJ X540S X540SA X540SC X540S X540Y X540YA - Hàng Nhập Khẩu  - MÀU ĐEN - TÔT - MÀU ĐEN",242000,292000,50000,17
TIKI,laptop-may-vi-tinh-linh-kien,117807228,"Pin dành cho Mac.Book Pro Retina 15" Mã Máy A1398 NĂM 2015 Mã Pin A1618-Hàng mới 100%",1277998,1277998,0,0
TIKI,laptop-may-vi-tinh-linh-kien,544884,"D-Link DWA-525 - Card Mạng Wireless PCI - Hàng Chính Hãng",250000,250000,0,0
TIKI,laptop-may-vi-tinh-linh-kien,95564239,"Hộp mực 12A Canon 2900 hàng nhập khẩu Hộp mực dành cho máy in Canon LBP 2900/3000 HP Laser Jet 1010/1015/1020/3015/3020/3030/3050",116300,116300,0,0
TIKI,laptop-may-vi-tinh-linh-kien,174610302,"Máy In Mã Vạch Đơn Hàng TMĐT Xprinter XP-490B USB TẶNG 1 Cuộn Giấy A6-HÀNG CHÍNH HÃNG",2500000,2500000,0,0
TIKI,laptop-may-vi-tinh-linh-kien,55709852,"Nguồn Máy Tính Cooler Master Elite V3 PC500 - Hàng Chính Hãng",789000,789000,0,0
TIKI,laptop-may-vi-tinh-linh-kien,189463943,"Máy in hoá đơn không dây kết nối Wifi Xprinter XP_Q200F (USB+WIFI) ( hàng chính hãng )",1590000,1590000,0,0
TIKI,laptop-may-vi-tinh-linh-kien,514319,"TP-Link  TL-SG105 - Switch Để Bàn 5 Cổng Gigabit - Hàng Chính Hãng",352000,352000,0,0
TIKI,laptop-may-vi-tinh-linh-kien,82842242,"Cụm drum DR B022 dùng cho máy in Brother HL-B2000D, HL-B2080DW, DCP-B7535DW, MFC-B7715DW nhập khẩu giá rẻ",429000,429000,0,0
TIKI,laptop-may-vi-tinh-linh-kien,217489124,"Sạc dành cho Laptop MSI Modern 14 B11ML B11MU B11 MOU, Modern 14 B5M B5M-027, Modern 15 A11M",350000,350000,0,0
TIKI,laptop-may-vi-tinh-linh-kien,171233623,"Cụm Drum dành cho máy in - DR-2255 Brother HL-2240/ 2250DN/ MFC7360 (DR2255) 10K",165000,165000,0,0
TIKI,laptop-may-vi-tinh-linh-kien,125433185,"Sạc dành cho Laptop MSI Prestige PS42 8M PS42 8M 288VN - Kèm Dây nguồn - Hàng Nhập Khẩu",349700,369700,20000,5
TIKI,laptop-may-vi-tinh-linh-kien,792570,"Bộ Chia Mạng Switch 16 Cổng 10/100/1000M D-Link DGS-1016C - Hàng Chính Hãng",1239000,1269000,30000,2
TIKI,laptop-may-vi-tinh-linh-kien,60875322,"Dây cáp mạng 2 đầu đúc sẵn Cat6 UTP UGREEN NW102 20164 dài 10M - Hàng chính hãng",109000,120000,11000,9
TIKI,laptop-may-vi-tinh-linh-kien,88971513,"Bộ Phát Wifi 3G Huawei 303Hw – 43,2Mb -kết nối 10 user – Hàng Nội Địa Nhật -màu đỏ - hàng chính hãng",499000,499000,0,0
TIKI,laptop-may-vi-tinh-linh-kien,21935365,"Bàn phím cho Laptop Dell Inspiron 3541 3542 3543 3551",189000,189000,0,0
TIKI,laptop-may-vi-tinh-linh-kien,113716881,"Sạc cho Laptop ASUS ZENBOOK 14 UX433 UX433F UX433FA UX433FN",319995,319995,0,0
TIKI,laptop-may-vi-tinh-linh-kien,195666396,"️Mực in màu đen (BK) 003 cho máy in Epson L1110/ L3110/ L3150/ L4150/ L1110 (Đen)",80000,80000,0,0
TIKI,laptop-may-vi-tinh-linh-kien,17593675,"CÁP MẠNG LAN BẤM SẴN 2 ĐẦU dài 30m",36000,38500,2500,6
TIKI,laptop-may-vi-tinh-linh-kien,109890181,"Dao phập phiến Krone, tool nhấn mạng cao cấp",100000,100000,0,0
TIKI,laptop-may-vi-tinh-linh-kien,21574865,"Pin cho Laptop Asus K43E X53S K53S X54C K54C X44H",358995,358995,0,0
TIKI,laptop-may-vi-tinh-linh-kien,35292952,"KỆ ĐỂ MÁY CHIẾU ĐA NĂNG  ( Hàng nhập khẩu )",685000,685000,0,0
TIKI,laptop-may-vi-tinh-linh-kien,22772342,"Quạt Tản Nhiệt CPU Cooler Master T400i - Hàng Nhập Khẩu",348000,348000,0,0
TIKI,laptop-may-vi-tinh-linh-kien,85311072,"Máy In Hóa Đơn WIFI Xprinter XP- N200L Dùng Cho Điện Thoại ( Hàng chính hãng)",1525000,2097000,572000,27
TIKI,laptop-may-vi-tinh-linh-kien,11200966,"Hộp mực 49A, hộp mực cho Canon 3300 3360, HP 1160 1320 3390 3392",179900,179900,0,0
TIKI,laptop-may-vi-tinh-linh-kien,73369540,"Dây Cáp Mạng LAN Bấm Sẵn RJ45 Bọc Dù 2 Mét / 3 Mét Cao Cấp",19000,19000,0,0
TIKI,laptop-may-vi-tinh-linh-kien,165219355,"Giấy decal nhiệt in tem nhãn kích thước 50x70 mm cuộn dài 30 m",65000,65000,0,0
TIKI,laptop-may-vi-tinh-linh-kien,1286855,"USB Wifi Vision 150Mbps Chuẩn 802.11 B/G/N Có Anten - Hàng Chính Hãng",40000,44700,4700,11
TIKI,laptop-may-vi-tinh-linh-kien,174003815,"Bộ 4 hộp mực in laser màu 054 (đen, vàng, xanh, hồng) cho máy in Canon imageCLASS MF642Cdw/MF641CW/MF643/MF644/MF645/ Canon LBP622cdw/LBP621CW/LBP623CDW, HP Color M254nw/ M254dw/ M280nw/ M281fdn/ M281fdw - Hàng nhập khẩu",1080000,1080000,0,0
TIKI,laptop-may-vi-tinh-linh-kien,144699604,"MÁY ĐẾM TIỀN OUDIS -9191A HÀNG CHÍNH HÃNG ",7000000,7000000,0,0
TIKI,laptop-may-vi-tinh-linh-kien,262454759,"Mực in Dành Cho Máy Canon 2900 - Hộp mực 12A",139000,139000,0,0
TIKI,laptop-may-vi-tinh-linh-kien,187188635,"Usb wifi Mercusys 300Mbps tốc độ cao - Usb thu sóng wifi cho laptop PC máy bàn - Mercusys  - Hàng chính hãng",119000,119000,0,0
TIKI,laptop-may-vi-tinh-linh-kien,135657208,"Ugreen 30847 50CM màu Đen Hộp đựng ổ cứng 2.5 chuẩn SATA US221 - Hàng chính hãng",175000,175000,0,0
TIKI,laptop-may-vi-tinh-linh-kien,91566324,"Pin dành cho Laptop Dell XPS 15 9570 Precision 5520 5530 6GTPY 97Wh ",1078995,1500000,421005,28
TIKI,laptop-may-vi-tinh-linh-kien,153911821,"Hộp mực 83A / Cartridge 137 / 337 Legend nhập khẩu - HP Pro M127FN, M125A - Canon MF211, MF212W, MF221D, MF215, MF217W, 151DW, MF240, MF241D, MF226DN",118500,118500,0,0
TIKI,laptop-may-vi-tinh-linh-kien,67151046,"[50 CUỘN] Giấy in nhiệt Giấy in bill VAYO Khổ 80 x 45 mm - In rõ nét - Lõi siêu nhỏ - Hàng chính hãng - 65gsm",354000,375000,21000,6
TIKI,laptop-may-vi-tinh-linh-kien,20677584,"Quạt Tản Nhiệt 9x9x2.5Cm 12VDC - 2.6W",22000,22000,0,0
TIKI,laptop-may-vi-tinh-linh-kien,459007,"Tenda TEG1024D - Bộ Chia Tín Hiệu Để Bàn 24 cổng 10/100/1000Mbps - Hàng Chính Hãng",1342000,1342000,0,0
TIKI,laptop-may-vi-tinh-linh-kien,10404352,"Bàn Phím Dành Cho Laptop Toshiba Satellite L800, L805, L830, L840, L845, L840D, L845D, C800, C800D - Hàng Nhập Khẩu",99000,235000,136000,58
TIKI,laptop-may-vi-tinh-linh-kien,100390432,"Cuộn giấy in nhiệt giấy in bill VAYO 100x150mm (giấy A6), tự dính,chống nước, dành cho thương mại điện tử",95000,150000,55000,37
TIKI,laptop-may-vi-tinh-linh-kien,23302207,"Pin cho Laptop Dell Latitude E6420 E5420 E5430 E5520 E5530 E6430 E6520 E6530",402000,402000,0,0
TIKI,laptop-may-vi-tinh-linh-kien,19554563,"Giấy In Hóa Đơn Nhiệt, In Bill K80 Phi 80",14200,14200,0,0
TIKI,laptop-may-vi-tinh-linh-kien,56029875,"Sạc cho laptop Dell Vostro 3558, V3559, V3559B Adapter 19.5V-2.31A, 19.5V-3.34A",186888,186888,0,0
TIKI,laptop-may-vi-tinh-linh-kien,186984673,"Laptop HP ProBook 430 G8 614K7PA)(i3-1115G4|8GB |256GB|Intel UHD Graphics|13.3' HD) Hàng chính hãng",23844000,23844000,0,0
TIKI,laptop-may-vi-tinh-linh-kien,24005291,"Hộp mực 49A dành cho  máy in HP 1160/1320/3300 - HÀNG NHẬP KHẨU",195000,195000,0,0
TIKI,laptop-may-vi-tinh-linh-kien,117095527,"Pin dành cho Laptop Dell Vostro 3559 - Hàng Nhập Khẩu ",470000,520000,50000,10
TIKI,laptop-may-vi-tinh-linh-kien,179540186,"Box Ổ Cứng SSD &amp; HDD 2.5" ORICO 2521U3 - Hàng Chính Hãng",118000,118000,0,0
TIKI,laptop-may-vi-tinh-linh-kien,181910651,"Pin dành cho Laptop Dell Inspiron 15 7590 7591 56Wh - H5H20 ",949995,1089990,139995,13
TIKI,laptop-may-vi-tinh-linh-kien,21923334,"Pin cho Laptop Acer Aspire 4736 4710 4930 4740",293790,293790,0,0
TIKI,laptop-may-vi-tinh-linh-kien,146365385,"USB thu wifi 1 râu LB-LINK 155 - Hàng Chính Hãng",98000,98000,0,0
TIKI,laptop-may-vi-tinh-linh-kien,82842695,"Mực in phun dùng cho máy in Canon và HP estar 100ml giá rẻ",27500,27500,0,0
TIKI,laptop-may-vi-tinh-linh-kien,7008679,"Hộp mực cho máy in Samsung ML1640",279000,279000,0,0
TIKI,laptop-may-vi-tinh-linh-kien,20043752,"Sạc cho laptop Toshiba 15V-5A đầu 6.3*3.0mm",174995,349990,174995,50
TIKI,laptop-may-vi-tinh-linh-kien,11049543,"Hộp mực 12A, hộp mực Dành Cho Canon LBP 2900 3000, HP 1010 1015, Có lỗ đổ mực, mực thải",116500,116500,0,0
TIKI,laptop-may-vi-tinh-linh-kien,31543796,"Sound Card V8 có AutonTone Chất Lượng Cao",180500,190000,9500,5
TIKI,laptop-may-vi-tinh-linh-kien,16604634,"Đĩa DVD-R 4.7GB Maxell - Hàng chính hãng (Hộp 10 đĩa - 10 vỏ đựng)",220000,220000,0,0
TIKI,laptop-may-vi-tinh-linh-kien,56697873,"Pin dành cho laptop Asus X556UA, X556UR",749995,749995,0,0
TIKI,laptop-may-vi-tinh-linh-kien,15562445,"Đầu Đọc Thẻ Từ  HP-01",900000,900000,0,0
TIKI,laptop-may-vi-tinh-linh-kien,63891466,"Bàn phím dành cho Laptop HP Elitebook 840 G1, 840 G2",274000,429000,155000,36
TIKI,laptop-may-vi-tinh-linh-kien,44603310,"Sạc cho Laptop HP Elitebook 8440p 8440w 8460p 8460w 2530p",169000,190000,21000,11
TIKI,laptop-may-vi-tinh-linh-kien,96868844,"Quả Đào 12A  Bánh Xe Cuốn Giấy dành cho máy in HP 1010-1020 Canon 2900 3000 FX9",10000,10000,0,0
TIKI,laptop-may-vi-tinh-linh-kien,44180345,"Quạt CPU Led lõi đồng Coolmoon 11X for Intell - hàng nhập khẩu",166250,175000,8750,5
TIKI,laptop-may-vi-tinh-linh-kien,11122882,"Hộp mực 337A, hộp mực cho Canon MF211 MF249DW MF266DN, Có lỗ đổ mực, mực thải tiện dụng",123000,123000,0,0
TIKI,laptop-may-vi-tinh-linh-kien,11251987,"Hộp mực thay thế 12a(H-q2612a)",117900,117900,0,0
TIKI,laptop-may-vi-tinh-linh-kien,28915940,"MÁY CHẤM CÔNG RONALD JACK RJ2400 - HÀNG CHÍNH HÃNG",1850000,1850000,0,0
TIKI,laptop-may-vi-tinh-linh-kien,117095751,"Pin dành cho Laptop Dell Vostro 3400 - Hàng Nhập Khẩu",325000,375000,50000,13
TIKI,laptop-may-vi-tinh-linh-kien,122292178,"Tệp 500 tờ giấy A6 in đơn hàng tem vận chuyển sàn TMĐT và web vận chuyển 100x150mm 10x15cm - Hành Chính Hãng",100000,100000,0,0
TIKI,laptop-may-vi-tinh-linh-kien,27881377,"Hộp mực máy in Hp CP1025 | Mực in laser màu 126A CE310, CE311, CE312, CE313",228000,228000,0,0
TIKI,laptop-may-vi-tinh-linh-kien,37714712,"Ổ Cứng SSD Gigabyte 480Gb (SATA 6.0Gb/s) - Hàng Chính Hãng",820000,820000,0,0
TIKI,laptop-may-vi-tinh-linh-kien,73256007,"Hộp Đựng Ổ Cứng M2 chuẩn SATA (NGFF) ORICO M2PF-C3-BK Hàng Chính Hãng",246880,285000,38120,13
TIKI,laptop-may-vi-tinh-linh-kien,188844743,"Máy Chiếu Mini Android LED Y9 CP350 Smart Projector",4140000,4140000,0,0
TIKI,laptop-may-vi-tinh-linh-kien,170943364,"Nhãn In đa lớp Tz2-221 - Đen nền trắng 9mm x 8m- hàng chính hãng",128800,140000,11200,8
TIKI,laptop-may-vi-tinh-linh-kien,189389648,"Đĩa trắng, Đĩa CD trắng Risheng hộp 50 cái dung lượng 700mb - HÀNG CHÍNH HÃNG",197000,197000,0,0
TIKI,laptop-may-vi-tinh-linh-kien,192133236,"Máy hủy giấy GBC ShredMaster S206 - Hàng chính hãng",1500000,1500000,0,0
TIKI,laptop-may-vi-tinh-linh-kien,88270314,"Bộ Kéo Dài Tín Hiệu HDMI Qua Lan RJ45 120m KVM Có 2 Cổng USB Hỗ Trợ 4K",1880000,1880000,0,0
TIKI,laptop-may-vi-tinh-linh-kien,8818541,"Kìm bấm mạng xuyên thấu ( RJ45 và RJ11) - Tặng kèm 10 hạt RJ45 xuyên thấu",214789,214789,0,0
TIKI,laptop-may-vi-tinh-linh-kien,68723033,"Lô sấy máy photocopy dùng cho Ricoh 2060, 2075, 5500, 6500, 7500, 8000. 6001, 7001, 9001, 6002, 7502, 7503",240000,240000,0,0
TIKI,laptop-may-vi-tinh-linh-kien,59584702,"Bộ sạc chân dẹt dành cho Microsoft Surface Go",390000,390000,0,0
TIKI,laptop-may-vi-tinh-linh-kien,36326675,"Nguồn máy tính Cooler Master  MWE 650 BRONZE V2 - 80 Plus BRONZE - Hàng chính hãng",1830000,1830000,0,0
TIKI,laptop-may-vi-tinh-linh-kien,188008991," Cap Mạng TP-Link VSP-L502F Cat 5E UTP 100m/305M Dây Cáp Cam - Hàng Chính Hãng",290000,290000,0,0
TIKI,laptop-may-vi-tinh-linh-kien,16770500,"Đĩa DVD Maxell( lốc 50 chiếc) Hàng nhập khẩu",335500,335500,0,0
TIKI,laptop-may-vi-tinh-linh-kien,117094412,"Pin dành cho Laptop Dell Vostro 15 3568 - Hàng Nhập Khẩu ",650000,700000,50000,7
TIKI,laptop-may-vi-tinh-linh-kien,15338785,"Cuộn Giấy In Hóa Đơn Cho Máy In Nhiệt Khổ K80 Phi 80 Cuộn Lớn",14400,14400,0,0
TIKI,laptop-may-vi-tinh-linh-kien,28077522,"Miếng Phủ Bàn Phím Laptop 13 - 14 inch Silicon Chống Nước, Chống Bụi Bẩn",30000,30000,0,0
TIKI,laptop-may-vi-tinh-linh-kien,12121958,"RAM Laptop Kingmax 8GB Bus 2666 DDR4 - Hàng Chính Hãng",530000,530000,0,0
TIKI,laptop-may-vi-tinh-linh-kien,57522011,"Sạc dành cho Laptop Dell Latitude 13 7370 Adapter 20V-2.25A Type-C",464789,464789,0,0
TIKI,laptop-may-vi-tinh-linh-kien,21345412,"Pin Laptop  dành cho DELL Latitude E7240 zin",800000,800000,0,0
TIKI,laptop-may-vi-tinh-linh-kien,173640721,"Kềm bấm mạng RJ45 / RJ11 Ugreen 70683 6P / 8P Màu Xanh Đen NW136 Hàng chính hãng",219000,219000,0,0
TIKI,laptop-may-vi-tinh-linh-kien,109890006,"Nguồn 12V-2A Dùng Cho TVBox, Camera, Router, Modem chất lượng cao",60000,60000,0,0
TIKI,laptop-may-vi-tinh-linh-kien,104466258,"Hộp mực 85a , 35a có lỗ đổ mực và mực thải",116500,116500,0,0
TIKI,laptop-may-vi-tinh-linh-kien,74573466,"Hộp mực in HP 05A, 80A, Canon 319 máy in Hp: P2035/P2055/Pro 400 Printer M401/M425, Canon: 6300DN/6650DN/6750...",175000,175000,0,0
TIKI,laptop-may-vi-tinh-linh-kien,185998140,"Bàn Phím dành cho laptop Dell Latitude 3340 3350 E5450 E5470 E5490 E7450 E7470 E7480 - Hàng Nhập Khẩu CÓ ĐÈN - CHUỘT - THƯỜNG - MỚI 100% -  - CÓ ĐÈN - CHUỘT",257000,307000,50000,16
TIKI,laptop-may-vi-tinh-linh-kien,121330751,"Dây nguồn DC đầu jack Đực, Cái DC 5.5x2.1mm đúc sẵn (lõi đồng nguyên chất)",5000,5000,0,0
TIKI,laptop-may-vi-tinh-linh-kien,6094265," Cáp mạng Cat6 UTP 24AWG đầu bọc kim loại dài 3m UGREEN NW101 - Hàng chính hãng",80000,104000,24000,23
TIKI,laptop-may-vi-tinh-linh-kien,57061399,"Sạc dành cho Laptop Asus K46, K46C, K46CA Adapter 19V-3.42A",229000,229000,0,0
TIKI,laptop-may-vi-tinh-linh-kien,11119385,"Hộp mực 35A/85A, hộp mực HP LaserJet P1005 P1006 Canon 3050, Có lỗ đổ mực, mực thải",116500,116500,0,0
TIKI,laptop-may-vi-tinh-linh-kien,751229,"Bộ Phát Wifi Di Động 4G LTE N 300Mbps Tenda 4G185 - Hàng Chính Hãng",989000,989000,0,0
TIKI,laptop-may-vi-tinh-linh-kien,92441510,"Máy in mã vạch nhiệt Xprinter XP 420B - Kết nối USB+LAN - ứng dụng thương mại điện tử, in tem, nhãn siêu thị, tạp hóa - Hàng chính hãng",1629000,1790000,161000,9
TIKI,laptop-may-vi-tinh-linh-kien,158774098,"Bánh Răng Sắt Đầu Rulo Sấy (Trục Sấy) Dùng Cho Máy Photocopy Toshiba E355/356/357/455/456/457/...Hàng Chất Lượng Cao, Giá Cạnh Tranh",85000,85000,0,0
TIKI,laptop-may-vi-tinh-linh-kien,80994611,"Mực nạp/mực đổ dùng cho hộp mực HP 17A / HP 18A / HP 30A / HP 33A - Mực nạp hp M102a, M104a, M130a....HÀNG CHÍNH HÃNG",130000,130000,0,0
TIKI,laptop-may-vi-tinh-linh-kien,42561588,"Hộp Mực Premium TN-2280 Cho Máy In Brother HL 2240/ DCP-7060D/ MFC-7360N - Hàng Nhập Khẩu",118000,118000,0,0
TIKI,laptop-may-vi-tinh-linh-kien,571764,"Ổ Cứng HDD Video Seagate SkyHawk 1TB ( ST1000VX005 ) - Hàng chính hãng",1550000,1550000,0,0
TIKI,laptop-may-vi-tinh-linh-kien,144916531,"ĐÈN SOI TIỀN OUDIS 09 hàng chính hãng ",650000,650000,0,0
TIKI,laptop-may-vi-tinh-linh-kien,114365955,"Sạc cho Laptop MSI PS42 8RA",284995,284995,0,0
TIKI,laptop-may-vi-tinh-linh-kien,49346224,"Bàn Phím Dành Cho Laptop Lenovo IdeaPad Z450 Z460 Z460A Z460G",99000,230000,131000,57
TIKI,laptop-may-vi-tinh-linh-kien,136594496,"Bàn phím dành cho Laptop Dell Latitude E6410 - Hàng Nhập Khẩu",386000,436000,50000,11
TIKI,laptop-may-vi-tinh-linh-kien,117094248,"Pin thay thế dành cho Laptop Dell Latitude E6520 - Hàng Nhập Khẩu ",431000,481000,50000,10
TIKI,laptop-may-vi-tinh-linh-kien,84107318," CÁP NGUỒN SỐ 8 1.5M",15000,15000,0,0
TIKI,laptop-may-vi-tinh-linh-kien,56365522,"Pin thay thế dành cho laptop Dell Vostro 1450",359995,359995,0,0
TIKI,laptop-may-vi-tinh-linh-kien,112251523,"Bộ chuyển đổi nguồn 220V sang 12V-5A(DC) (Đen)",143000,143000,0,0
TIKI,laptop-may-vi-tinh-linh-kien,171145631,"Tz2-631 Nhãn in đa lớp 12mm x 8m - Đen nền vàng - Hàng nhập khẩu",128800,140000,11200,8
TIKI,laptop-may-vi-tinh-linh-kien,21868175,"Pin cho Laptop HP Pavilion 14-ab000 15-ab000 17-g000 Series KI04",293690,293690,0,0
TIKI,laptop-may-vi-tinh-linh-kien,136796451,"100 Đầu Fast Connect SC/APC suy hao <0,3dB",699000,699000,0,0
TIKI,laptop-may-vi-tinh-linh-kien,181681006,"Máy Đếm Tiền Oudis 6900B Nhỏ Gọn Dùng Cho Cửa Hàng - Hàng Chính Hãng",2800000,2800000,0,0
TIKI,laptop-may-vi-tinh-linh-kien,20680434,"Hộp mực máy in 05a in đẹp, nhập khẩu mới. Là Cartridge, catrich, toner dùng cho máy in HP p2035, p2055dn, p2035n, 2055d, p2055d",168000,168000,0,0
TIKI,laptop-may-vi-tinh-linh-kien,52627478,"Hộp mực 17A (có CHIP) cho máy in HP M102w, M102a, MFP M130fn, MFP M130fw, M130a, M130w - CF 217A",139900,139900,0,0
TIKI,laptop-may-vi-tinh-linh-kien,8607956,"Hộp mực dùng cho Canon LBP 1210 (Catridge 15A - EP25 / Đen)",230000,230000,0,0
TIKI,laptop-may-vi-tinh-linh-kien,10585231,"USB Bluetooth 4.0 dùng cho máy tính Laptop, PC",22000,22000,0,0
TIKI,laptop-may-vi-tinh-linh-kien,17389586,"Phần mềm Kaspersky Anti Virus cho 3 máy tính (KAV 3U) Chính hãng",350000,350000,0,0
TIKI,laptop-may-vi-tinh-linh-kien,115960201,"Hộp mục in 107a",295000,295000,0,0
TIKI,laptop-may-vi-tinh-linh-kien,137170604,"Bàn phím dành cho Laptop Lenovo IBM Thinkpad X230 - Hàng Nhập Khẩu ",576000,626000,50000,8
TIKI,laptop-may-vi-tinh-linh-kien,68174369,"Lô ép máy in Canon 2900 Dũng cho máy in Canon 2900... HP 1010/1020",79900,79900,0,0
TIKI,laptop-may-vi-tinh-linh-kien,142370142,"Giấy in nhiệt, in hóa đơn dành cho máy in  pt-210",3800,3800,0,0
TIKI,laptop-may-vi-tinh-linh-kien,100579984,"Giấy In Nhiệt, Giấy In Hóa Đơn K57X38 (57mm)",5500,5500,0,0
TIKI,laptop-may-vi-tinh-linh-kien,125433413,"Sạc dành cho Laptop HP Probook 440-G3 - Kèm Dây nguồn - Hàng Nhập Khẩu",204000,254000,50000,20
TIKI,laptop-may-vi-tinh-linh-kien,192863109,"Màn Chiếu 3 Chân Apollo 135 inch - Hàng Chính Hãng",1590000,1590000,0,0
TIKI,laptop-may-vi-tinh-linh-kien,12538750,"Vệ sinh 4 món",14600,14600,0,0
TIKI,laptop-may-vi-tinh-linh-kien,168155405,"Hộp đựng Ổ Cứng 2’5 màu trắng trong ORICO 2139US3 - Hàng Chính Hãng",118000,118000,0,0
TIKI,laptop-may-vi-tinh-linh-kien,109839102,"Bàn phím dành cho HP Probook 450 G5 ",349995,349995,0,0
TIKI,laptop-may-vi-tinh-linh-kien,103827377,"Sạc dành cho Laptop Lenovo ThinkPad X1 Carbon (6th Gen)",499000,499000,0,0
TIKI,laptop-may-vi-tinh-linh-kien,117094714,"Pin dành cho Laptop Dell Inspiron 15 3542 - Hàng Nhập Khẩu ",535000,585000,50000,9
TIKI,laptop-may-vi-tinh-linh-kien,18005791,"Hộp Đựng Ổ Cứng Gắn Ngoài HDD Box 3.0 SSK HE-G3000 3.5 Sata AZONE - Hàng Nhập Khẩu",317000,381000,64000,17
TIKI,laptop-may-vi-tinh-linh-kien,35353454,"Máy Chấm Công Vân Tay Và Thẻ Ronald Jack RJ800 - Hàng Nhập Khẩu",1790000,1790000,0,0
TIKI,laptop-may-vi-tinh-linh-kien,73333731,"Mực in SAHA 78A/328 ( Có Chip ) - Hàng chính hãng",143000,143000,0,0
TIKI,laptop-may-vi-tinh-linh-kien,197648114,"Bo Mạch Chủ Main Gigabyte H510M-H socket LGA1200 - Hàng Chính Hãng ",1690000,1690000,0,0
TIKI,laptop-may-vi-tinh-linh-kien,52489145,"MÁY CHẤM CÔNG THẺ GIẤY RONALD JACK RJ2300-CHẤM CÔNG 3 CA- HÀNG NHẬP KHẨU",2250000,2250000,0,0
TIKI,laptop-may-vi-tinh-linh-kien,187311429,"Cáp Mạng Golden Link Platinum CAT6E SFTP 100m/305M (Màu XANH LÁ) - Hàng Chính Hãng",1090000,1090000,0,0
TIKI,laptop-may-vi-tinh-linh-kien,172941895,"Hộp 50 chiếc hạt mạng RJ45 Ugreen 20331 chuẩn CAT5 chính hãng - Hàng Chính Hãng",135000,135000,0,0
TIKI,laptop-may-vi-tinh-linh-kien,82842584,"Bao Lụa máy in Canon 2900, 3300,6030,6000, 214DW, Hp 1320, P2035, P1102, M127 chất lượng, giá rẻ",27300,27300,0,0
TIKI,laptop-may-vi-tinh-linh-kien,50014254,"Ruy băng, ribbon mực máy in kim Epson LQ310, LX310",55000,55000,0,0
TIKI,laptop-may-vi-tinh-linh-kien,109889897,"Bộ chia máy in tự động 1 ra 4 MT Viki SW241",270750,285000,14250,5
TIKI,laptop-may-vi-tinh-linh-kien,149045485,"Giấy In Nhiệt Đơn Hàng TMĐT 100x150 x 350 Tem",85000,85000,0,0
TIKI,laptop-may-vi-tinh-linh-kien,56575933,"Sạc dành cho Laptop HP Pavilion DV2000 Adapter 18.5V-3.5A, 19V-4.74A",189995,189995,0,0
TIKI,laptop-may-vi-tinh-linh-kien,87393353,"Hộp mực in SAHA 05A/80A (Có chíp) Dùng cho Canon, HP - Chính Hãng SAHA (BOX)",176000,176000,0,0
TIKI,laptop-may-vi-tinh-linh-kien,117093940,"Pin dành cho Laptop Dell Latitude E6430 - Hàng Nhập Khẩu ",496000,546000,50000,9
TIKI,laptop-may-vi-tinh-linh-kien,262462969,"Hộp mực in 80A cho máy in HP LaserJet Pro 400 M401/ MFP M425",187000,187000,0,0
TIKI,laptop-may-vi-tinh-linh-kien,763153,"Dây Mạng Bấm Sẵn 2 Đầu CAT6 UTP Patch Cords NW102 11203 (3m) - Xanh - Hàng Chính Hãng",58000,75000,17000,23
TIKI,laptop-may-vi-tinh-linh-kien,77874548,"Hộp mực in CF256A dùng cho máy In HP LaserJet MFP M436nda, M436n, M436dn, M433A - Laser torner cartrdge tương thích - hàng thay thế 56A",330000,330000,0,0
TIKI,laptop-may-vi-tinh-linh-kien,11982098,"Miếng dán bàn phím tiếng Pháp (French Keyboard Sticker)",24300,39000,14700,38
TIKI,laptop-may-vi-tinh-linh-kien,208401582,"Hộp mực máy in Canon 3300, 308 in đẹp, nhập khẩu mới, giá rẻ. Là Cartridge, catrich, toner dùng cho máy in LBP 3300, 3360, 3390, 3392, 331, 3370, HP 1160, 1320, 2014, 2015",249000,249000,0,0
TIKI,laptop-may-vi-tinh-linh-kien,110152167,"Sạc dành cho Laptop Dell Inspiron 14 5481 5482",186777,186777,0,0
TIKI,laptop-may-vi-tinh-linh-kien,42561574,"Hộp Mực In Premium 48A (CF248A) - Hàng Nhập Khẩu",153000,153000,0,0
TIKI,laptop-may-vi-tinh-linh-kien,57035172,"Sạc dành cho Laptop Asus ROG GL553VE, GL553VD Adapter 19.5V-6.32A",459000,459000,0,0
TIKI,laptop-may-vi-tinh-linh-kien,37973738,"Bàn Phím Thay Thế Cho Máy Tính Dell Vostro 5460 5470",189000,189000,0,0
TIKI,laptop-may-vi-tinh-linh-kien,39312455,"Cảo 2 chấu ingco HGP08023",194000,194000,0,0
TIKI,laptop-may-vi-tinh-linh-kien,26476035,"Bộ Phát Sóng WiFi Xiaomi Router 4A_Hàng Nhập Khẩu",425000,425000,0,0
TIKI,laptop-may-vi-tinh-linh-kien,57499504,"Sạc dành cho laptop ACER Aspire E5-576 series, E5-576G-57Y2, Model No: N16Q2",214995,214995,0,0
TIKI,laptop-may-vi-tinh-linh-kien,117093340,"Pin cho Laptop Dell Latitude E5450 E5550 Type G5M10 - Hàng Nhập Khẩu ",852000,902000,50000,6
TIKI,laptop-may-vi-tinh-linh-kien,109889703,"Card USB to Sound 5.1",75000,75000,0,0
TIKI,laptop-may-vi-tinh-linh-kien,14188639,"Giấy In Chouche Mờ Hai Mặt Khổ A4",63000,63000,0,0
TIKI,laptop-may-vi-tinh-linh-kien,136025224,"Nguồn máy tính MSI MPG A750GF 750W (80 Plus Gold/Full Modular/Màu Đen) - Hàng Chính hãng ",3346000,3346000,0,0
TIKI,laptop-may-vi-tinh-linh-kien,15295300,"[ Set 10 thẻ] Thẻ từ máy chấm công tần số 125Khz - loại mỏng 0.8mm",53000,53000,0,0
TIKI,laptop-may-vi-tinh-linh-kien,416620,"TP-Link  TL-WR841HP (Anten 9dbi *2) - Router Wifi chuẩn N 300Mbps công suất cao - Hàng Chính Hãng",688000,688000,0,0
TIKI,laptop-may-vi-tinh-linh-kien,125433073,"Sạc dành cho Laptop Dell Inspiron 14 5447 N5447 - Kèm Dây nguồn - Hàng Nhập Khẩu",280000,300000,20000,7
TIKI,laptop-may-vi-tinh-linh-kien,33106164,"Bộ 4 trống drum drum cho Canon 2900, 303. Là trống hình hộp mực máy in cho Canon LBP 3000",82000,82000,0,0
TIKI,laptop-may-vi-tinh-linh-kien,79778529,"Pin dành cho Laptop Dell Vostro 14 5459-D2VF9",736995,1290000,553005,43
TIKI,laptop-may-vi-tinh-linh-kien,1830519,"Thiết bị mạng Linksys E1700 - Hàng Chính Hãng",581000,581000,0,0
TIKI,laptop-may-vi-tinh-linh-kien,56381155,"Giấy in nhiệt K57 x 30mm không lõi - thùng 200 cuộn",568000,568000,0,0
TIKI,laptop-may-vi-tinh-linh-kien,56728920,"Pin dành cho Laptop Acer Aspire V3-471, V3-471G",294800,294800,0,0
TIKI,laptop-may-vi-tinh-linh-kien,42958479,"Pin cho MacBook Pro 15 inch Retina A1398 A1417 Mid 2012 Early 2013",1289998,1289998,0,0
TIKI,laptop-may-vi-tinh-linh-kien,2086083,"Máy Quét Mã Vạch Symbol LS2208 - Hàng Chính Hãng",1540000,1540000,0,0
TIKI,laptop-may-vi-tinh-linh-kien,171233544,"Lô sấy dành cho máy in canon 2900 3000 1020",80000,80000,0,0
TIKI,laptop-may-vi-tinh-linh-kien,151594148,"Đầu DB9 (RS232) female HD-Link, đầu nối DB9 âm (đầu cái) bắt vít tự làm dây RS232, thay đầu cáp RS232",110000,110000,0,0
TIKI,laptop-may-vi-tinh-linh-kien,162215803,"1 thùng 50 cuộn giấy in nhiệt, tem dán K57 kích thước 50x50 mm dành cho dòng máy in mini, máy in bluetooth Peripage, Paperang",380000,380000,0,0
TIKI,laptop-may-vi-tinh-linh-kien,163022273,"Bộ Mở Rộng POE 1-2",519200,519200,0,0
TIKI,laptop-may-vi-tinh-linh-kien,184495872,"Bút soi quang 20km Noyafa NF-904W, công suất 20mW soi 20Km - Hàng chính hãng",1092000,1200000,108000,9
TIKI,laptop-may-vi-tinh-linh-kien,144448677,"Giấy in tem trà sữa 50×30 Sử dụng trên phần mềm bán trà sữa -800 tem 1 cuộn",17800,17800,0,0
TIKI,laptop-may-vi-tinh-linh-kien,125432164,"Sạc dành cho Laptop MSI GP72 7REX Leopard Pro - Kèm Dây nguồn - Hàng Nhập Khẩu",749000,799000,50000,6
TIKI,laptop-may-vi-tinh-linh-kien,73642836,"Pin dành cho Laptop Dell Vostro 5468",589000,589000,0,0
TIKI,laptop-may-vi-tinh-linh-kien,70163693,"Quả đào kéo giấy dùng cho máy in HP 1005/1006/ HP 1102, 1132, 1202, 1212 nf, Canon 6000, 520, 3100, 3010, , 6030 ",25000,25000,0,0
TIKI,laptop-may-vi-tinh-linh-kien,6403893,"Dây mạng bấm sẵn 2 đầu Cat6 UTP Patch Cords dài 5M UGREEN NW102 11204 - Hàng chính hãng",68000,75000,7000,9
TIKI,laptop-may-vi-tinh-linh-kien,32205842,"Tool Nhấn Mạng Cao Cấp AZONE",75000,75000,0,0
TIKI,laptop-may-vi-tinh-linh-kien,151988873,"Giấy in tem nhiệt,  100x150mm (350 tờ)",68000,68000,0,0
TIKI,laptop-may-vi-tinh-linh-kien,113482402,"Đầu bấm mạng RJ45 AMP cat5e ( 100 CÁI )",41900,41900,0,0
TIKI,laptop-may-vi-tinh-linh-kien,125432558,"Sạc dành cho Laptop Dell Inspiron 5547 Adapter 19.5V-3.34A 19.5V-4.62A - Kèm Dây nguồn - Hàng Nhập Khẩu",264900,284900,20000,7
TIKI,laptop-may-vi-tinh-linh-kien,125432207,"Sạc cho Laptop Asus TUF Gaming A15 FA506II-AL016t - 150W 20V 7.5A - Kèm Dây nguồn - Hàng Nhập Khẩu",749000,799000,50000,6
TIKI,laptop-may-vi-tinh-linh-kien,6448007,"Cáp mạng 2 đầu đúc bọc hợp kim Cat7 STP Dài 10M UGREEN NW107 11273 - Hàng Chính Hãng",259000,289000,30000,10
TIKI,laptop-may-vi-tinh-linh-kien,113711549,"Sạc dành cho Laptop ASUS ZENBOOK 13 UX333F UX333FA UX333FN",245883,450000,204117,45
TIKI,laptop-may-vi-tinh-linh-kien,102050685,"Hộp mực in màu (CF 410A) máy in HP M477fdn, M477fdw, M477fnw, M337dw, M452DN, M452DW, M452NW - Color LaserJet Pro MFP - cartridge nhập khẩu tương thích",440000,440000,0,0
TIKI,laptop-may-vi-tinh-linh-kien,71206274,"Gạt mực (gạt Drum) dùng cho máy photocopy Toshiba E 550, 650, 520, 720, 523, 603, 723, 850, 555, 655, 755, 556, 656, 756, 657, 857",55000,55000,0,0
TIKI,laptop-may-vi-tinh-linh-kien,37011458,"Pin Cho Laptop ASUS A32 K43 K43E K43S X44H K53 K53E X54C X53S X53 K53S X53E - Hàng Nhập Khẩu",339000,339000,0,0
TIKI,laptop-may-vi-tinh-linh-kien,117093368,"Pin dành cho Laptop Acer Aspire E5-473 - Hàng Nhập Khẩu ",639000,689000,50000,7
TIKI,laptop-may-vi-tinh-linh-kien,121330797,"Dây nguồn DC đầu jack Đực, Cái DC 5.5x2.1mm đúc sẵn (lõi đồng nguyên chất)",5000,5000,0,0
TIKI,laptop-may-vi-tinh-linh-kien,184134633,"Thùng giấy in hoá đơn chính hãng Hatami k80x45 thùng 100 cuộn",620000,620000,0,0
TIKI,laptop-may-vi-tinh-linh-kien,117807280,"Pin dành cho Laptop Dell Vostro 2420 2520 3420 3520 - Hàng mới 100%",462324,462324,0,0
TIKI,laptop-may-vi-tinh-linh-kien,23816091,"GIẤY IN TEM DECAL Khổ 40x30mm ( Set 10 cuộn ) ",240000,240000,0,0
TIKI,laptop-may-vi-tinh-linh-kien,117095067,"Pin thay thế cho laptop Dell E7440 - Hàng Nhập Khẩu ",888000,938000,50000,5
TIKI,laptop-may-vi-tinh-linh-kien,69466343,"Trống 12A ( Drum ) Dùng cho máy in Canon 2900, 3000, 4122, 4150, 4350, 4320, 4680, HP 1010, 1019, 1012, 1015, 1018, 1020, 1022, 1319, 3030 ,3050, 3055 ( trống phấn )",17000,17000,0,0
TIKI,laptop-may-vi-tinh-linh-kien,1991139,"Hộp Mực In 17A HM247 Dùng Cho Máy In HP M102A/M130/M102W - Hàng Nhập Khẩu",215000,215000,0,0
TIKI,laptop-may-vi-tinh-linh-kien,24012824,"Hộp mực  78A dành cho máy in HP 1536DNF/P1566/1606.......- HÀNG NHẬP KHẨU",123000,123000,0,0
TIKI,laptop-may-vi-tinh-linh-kien,44113877,"Dây nhảy quang Single Mode SC-SC 3m",23900,23900,0,0
TIKI,laptop-may-vi-tinh-linh-kien,125433362,"Sạc cho Laptop Hp Folio 9470m 9480m - Kèm Dây nguồn - Hàng Nhập Khẩu",235000,285000,50000,18
TIKI,laptop-may-vi-tinh-linh-kien,109890112,"Rệp Nối Cáp Mạng, Rệp Nối Cáp Thoại bộ 200 cái",90155,94900,4745,5
TIKI,laptop-may-vi-tinh-linh-kien,82068342,"Pin dành cho Laptop Dell Inspiron 5379 - WDX0R",698995,698995,0,0
TIKI,laptop-may-vi-tinh-linh-kien,11666127,"Khay Caddy Bay HDD SSD SATA 3 9.5mm - Khay ổ đĩa cứng thay thế ổ DVD",30100,30100,0,0
TIKI,laptop-may-vi-tinh-linh-kien,2045617,"Hộp 50 Cái Đầu Bấm Mạng Ugreen RJ45 CAT6 50247 - Hàng Chính Hãng",250000,325000,75000,23
TIKI,laptop-may-vi-tinh-linh-kien,56308602,"Pin thay thế dành cho Laptop Dell Inspiron 3520",368995,368995,0,0
TIKI,laptop-may-vi-tinh-linh-kien,103168330,"Sạc dành cho Laptop HP envy 13-ah Series 13-ah0025TU 13-ah0026TU 13-ah0027TU",294995,294995,0,0
TIKI,laptop-may-vi-tinh-linh-kien,102104176,"Nguồn Adapter 9V-2A 5.5*2.1mm",47000,47000,0,0
TIKI,laptop-may-vi-tinh-linh-kien,117726779,"Màn Hình Hội Nghị Truyền Hình Dell C2422HE 24inch FullHD 5ms 60Hz IPS - Hàng Chính Hãng",4990000,9606500,4616500,48
TIKI,laptop-may-vi-tinh-linh-kien,20616291,"Hộp mực máy in mã 85A Viet Toner - chính hãng",125000,125000,0,0
TIKI,laptop-may-vi-tinh-linh-kien,74494438,"Hộp mực in laser màu vàng CRG 054Y dùng cho máy in HP Color M254nw/ M254dw/ M280nw/ M281fdn/ M281fdw (CF542A - 203A) Canon imageCLASS MF642Cdw/MF641CW/MF643/MF644/MF645/ Canon LBP622cdw/LBP621CW/LBP623CDW - Hàng nhập khẩu ",270000,270000,0,0
TIKI,laptop-may-vi-tinh-linh-kien,12037628,"Cáp chia nguồn SATA 1 ra 2",25000,25000,0,0
TIKI,laptop-may-vi-tinh-linh-kien,77249896,"Hộp mực in laser màu CRG-046 BK / 046 C / CRG-046 Y / CRG-046 M hàng thay thế dùng cho máy in Canon LBP 651C/652C/654C/ MF731Cdw/ MF733Cdw/ MF735Cd",270000,270000,0,0
TIKI,laptop-may-vi-tinh-linh-kien,179991743,"Pin Laptop DÀNH CHO HP PROBOOK 640 G1 - ProBook 640 G1 645 G1 650 G1 655 G1 - Hàng Nhập Khẩu ",444000,494000,50000,10
TIKI,laptop-may-vi-tinh-linh-kien,66338091,"Đầu RJ45 Cat.5e/Cat.6 dạng xuyên thấu Dintek - Hàng chính hãng - (100 đầu/1 Bịch )",665000,665000,0,0
TIKI,laptop-may-vi-tinh-linh-kien,137170670,"Bàn phím dành cho laptop Lenovo G400S - Hàng Nhập Khẩu mới 100%",196000,246000,50000,20
TIKI,laptop-may-vi-tinh-linh-kien,147964677,"Vỉ 20 Nẹp Dán Tường Giữ Cố Định Dây Điện, Dây Mạng, Dây Máy Tính - Tiện Dụng Gia Đình - Văn Phòng- Hàng nhập khẩu. TakyHome 5733",25000,25000,0,0
TIKI,laptop-may-vi-tinh-linh-kien,102104842,"Đế Cầu Chì Ống",3871,3871,0,0
TIKI,laptop-may-vi-tinh-linh-kien,117094477,"Pin dành cho Laptop HP probook 4430s 4530s - Hàng Nhập Khẩu ",354900,374900,20000,5
TIKI,laptop-may-vi-tinh-linh-kien,99238083,"Sạc dành cho Laptop HP (các loại) 19.5V 3.33A 65W chuẩn cắm 4.5*3.0mm",254995,254995,0,0
TIKI,laptop-may-vi-tinh-linh-kien,117094036,"Pin Dành Cho Laptop Acer Aspire One D255 D257 D260 - Hàng nhập khẩu",354900,374900,20000,5
TIKI,laptop-may-vi-tinh-linh-kien,137170020,"Bàn Phím Thay Thế Cho Laptop Asus K45A  - Hàng Nhập Khẩu",198000,248000,50000,20
TIKI,laptop-may-vi-tinh-linh-kien,21922099,"Pin cho Laptop Lenovo ThinkPad T410 T420 T510 T520",294290,294290,0,0
TIKI,laptop-may-vi-tinh-linh-kien,10043621,"Quạt Tản Nhiệt Fan Case Led Đỏ (12 cm x 12 cm)",61000,61000,0,0
TIKI,laptop-may-vi-tinh-linh-kien,2045593,"Dây Cáp Mạng Ugreen CAT7 11270 (3m) - Hàng Chính Hãng",125000,137000,12000,9
TIKI,laptop-may-vi-tinh-linh-kien,35617584,"Cáp nối Com to Com DB9 to DB9 RS232 to RS232 2 đầu cái - Hàng nhập khẩu",37000,37000,0,0
TIKI,laptop-may-vi-tinh-linh-kien,117094810,"Pin cho Laptop Toshiba Satellite C640 L640 C650 L645 L750 L635 L650 L730 L740 - Hàng Nhập Khẩu ",354900,374900,20000,5
TIKI,laptop-may-vi-tinh-linh-kien,137171512,"Bàn phím dành cho Laptop Dell Inspiron 3420 - Hàng Nhập Khẩu",233000,283000,50000,18
TIKI,laptop-may-vi-tinh-linh-kien,179991748,"Sạc dành cho Laptop Asus TP410UF TP410UA TP412UA - Hàng Nhập Khẩu ",380000,430000,50000,12
TIKI,laptop-may-vi-tinh-linh-kien,136796407,"Bộ chia quang PLC 1x8 SC/APC",119000,119000,0,0
TIKI,laptop-may-vi-tinh-linh-kien,171233705,"Trục từ dành cho Hộp mực 2240",35000,35000,0,0
TIKI,laptop-may-vi-tinh-linh-kien,137171376,"Bàn Phím Dành Cho Laptop Lenovo IdeaPad G400S G400AS G400AT G400AM G405S Z410 S410P Keyboard - Hàng Nhập Khẩu",229000,249000,20000,8
TIKI,laptop-may-vi-tinh-linh-kien,125788154,"Bộ Phát Sóng Wifi Router Chuẩn AC1200 Totolink A720R Đen - Hàng chính hãng",389000,389000,0,0
TIKI,laptop-may-vi-tinh-linh-kien,107666457,"Giấy in tem mã vạch, decal nhiệt khổ 58x40 (tem cân, tem trà sữa, tem trà tranh)",25800,25800,0,0
TIKI,laptop-may-vi-tinh-linh-kien,35360575,"Máy chấm công vân tay và thẻ RONALD JACK T8 PLUS - Hàng nhập khẩu",2149000,2149000,0,0
TIKI,laptop-may-vi-tinh-linh-kien,162563077,"Sạc dành cho Laptop Dell Inspiron 15 5510 Gen 11th Model 2021",314995,314995,0,0
TIKI,laptop-may-vi-tinh-linh-kien,117093466,"Pin dành cho Laptop Dell Latitude E7440 E7450 - Hàng Nhập Khẩu ",925900,945900,20000,2
TIKI,laptop-may-vi-tinh-linh-kien,75761598,"Hộp mực in HP 76A KHÔNG CHÍP-dùng cho máy HP Pro M404dn/ M428dnw-cartridge CF276A-CF259A tương thích",191000,191000,0,0
TIKI,laptop-may-vi-tinh-linh-kien,59401904,"Hộp mực in SAHA 05A/80A cho máy in HP, Canon - Hàng chính hãng",176000,176000,0,0
TIKI,laptop-may-vi-tinh-linh-kien,69672546,"Trống ( Drm ) 35A phấn - Dùng cho hộp mực 36/36/78/83/337 của máy in Canon 3010/ 3050 / 3100/ 6200, 6230, 4400, 4410, 4430, 4450, 4550, 4580, 4570,, 4452, 4450, 4450, F4420, 4412, 4410, 500, 520, 550, 4700, 4750, 4800, 4820, 4870 / HP P1005/1006/ P1505/M1",22000,22000,0,0
TIKI,laptop-may-vi-tinh-linh-kien,185998199,"Bàn Phím dành cho laptop Lenovo IBM Thinkpad E460 E465 W450 E450 E450C E455 - Hàng Nhập Khẩu",358000,408000,50000,12
TIKI,laptop-may-vi-tinh-linh-kien,8149692,"Hạt mạng xuyên thấu RJ45 (100 hạt)",61900,61900,0,0
TIKI,laptop-may-vi-tinh-linh-kien,22019765,"Pin Dành cho Laptop Lenovo  G460, G470 B470, B570 G570 G560 g770 g475 g575 g465 g565 g460 z570 z465 z470 z460 z370 z560 z580 v360 v370 v470 z565 v570 (Tặng kèm bộ vệ sinh Laptop)",305840,305840,0,0
TIKI,laptop-may-vi-tinh-linh-kien,21198769,"Pin dành cho laptop HP Probook 4410",369840,369840,0,0
TIKI,laptop-may-vi-tinh-linh-kien,491380,"TP-Link  TL-SF1024D - Bộ Chia Mạng 24 Cổng - Hàng Chính Hãng",1399000,1799000,400000,22
TIKI,laptop-may-vi-tinh-linh-kien,108954644,"Bộ Thu Sóng Wifi USB - không ăn ten",39298,46900,7602,16
TIKI,laptop-may-vi-tinh-linh-kien,3587095,"Tape nhãn in tương thích CPT-621 dùng cho máy in nhãn Brother P-Touch (chữ đen nền vàng, 9mm)",249000,249000,0,0
TIKI,laptop-may-vi-tinh-linh-kien,20992417,"Pin Laptop Acer ASPIRE E5-571 - Hàng nhập khẩu",499000,499000,0,0
TIKI,laptop-may-vi-tinh-linh-kien,93042827,"Pin dành cho Laptop ASUS K401L A401L K401LB K401LB5010 K401LB5200 A400U K401U K401UB K401LB Series NEW - B31N1424",698995,698995,0,0
TIKI,laptop-may-vi-tinh-linh-kien,26742356,"Cáp chuyển nguồn SATA ra cổng 4 pin",18000,18000,0,0
TIKI,laptop-may-vi-tinh-linh-kien,179990965,"Bàn phím thay thế dành cho laptop toshiba Portege M900 - Hàng Nhập Khẩu ",323000,373000,50000,13
TIKI,laptop-may-vi-tinh-linh-kien,49652597,"Pin Dành Cho Laptop HP  ProBook 4410s 4411s 4412s 4413s 4415s 4416s 4418s HSTNN-DB90 HSTNN-OB90",315000,380000,65000,17
TIKI,laptop-may-vi-tinh-linh-kien,20542517,"GIẤY IN  Bill  (100 cuộn / thùng) K80X80",1870000,1870000,0,0
TIKI,laptop-may-vi-tinh-linh-kien,43075634,"Quạt Tản Nhiệt CPU BOX Intel Socket 1156/1155/1150 - Hàng chính hãng",76000,76000,0,0
TIKI,laptop-may-vi-tinh-linh-kien,171233471," Gạt mực dành cho máy in Ricoh MP-4000/5000/ MP4002/5002",45000,45000,0,0
TIKI,laptop-may-vi-tinh-linh-kien,142370220,"50 cuộn giấy in bill dành cho máy in hóa đơn bluetooth mini pt-210",230000,230000,0,0
TIKI,laptop-may-vi-tinh-linh-kien,123238812,"Combo 1 vỉ 50 Adapter SC/APC, Single mode, simplex. Hàng chính hãng",115000,115000,0,0
TIKI,laptop-may-vi-tinh-linh-kien,91011199,"Hộp mực in HP 87A (CF 287A) dùng cho máy in HP Laserjet Pro M506dn, M506n, M506x, MFP M527dn, M527f, M527z, M501f",269000,269000,0,0
TIKI,laptop-may-vi-tinh-linh-kien,72923233,"Mặt B vỏ laptop dùng cho laptop Dell Latitude E7440 - Viền màn hình dùng cho Dell Latitude E7440",325000,355000,30000,8
TIKI,laptop-may-vi-tinh-linh-kien,74493670,"Pin dành cho Laptop HP 255 G6 250 G6 - JC03 JC04",348995,348995,0,0
TIKI,laptop-may-vi-tinh-linh-kien,171937365,"Sạc dành cho Laptop Lenovo Legion Y540-15IRH",650000,650000,0,0
TIKI,laptop-may-vi-tinh-linh-kien,117094134,"Pin cho Laptop Dell Latitude E5440 - Hàng Nhập Khẩu ",525900,545900,20000,4
TIKI,laptop-may-vi-tinh-linh-kien,97269137,"Hộp mực 78A Canon 326 328 hàng nhập khẩu dành cho máy in Canon LBP 6200d 6230dn HP P1560/1536/P1566/1600/P1606DN  MF4410/4570/4580dn/4780w",116500,116500,0,0
TIKI,laptop-may-vi-tinh-linh-kien,77747811,"Pin dành cho Laptop Dell Latitude 12 7000, E7240, E7250",849995,849995,0,0
TIKI,laptop-may-vi-tinh-linh-kien,17620827,"Hộp mực in 12A dùng cho cho máy in Canon 2900,3000 siêu nét",114500,114500,0,0
TIKI,laptop-may-vi-tinh-linh-kien,29470362,"Bộ 10 Đầu Nối Dây Mạng 1 Ra 2",39900,49000,9100,19
TIKI,laptop-may-vi-tinh-linh-kien,63969224,"Bàn phím dành cho Asus A540L | Key laptop Asus A540U, K540",249995,249995,0,0
TIKI,laptop-may-vi-tinh-linh-kien,86562706,"Bàn phím dành cho Laptop Acer ES1-572-32GZ",254995,254995,0,0
TIKI,laptop-may-vi-tinh-linh-kien,20883167,"Card mạng USB (USB LAN)",45400,45400,0,0
TIKI,laptop-may-vi-tinh-linh-kien,178338826,"Nhãn In đa lớp Tz2-431 - Đen nền đỏ 12mm x 8m - Hàng nhập khẩu",140000,140000,0,0
TIKI,laptop-may-vi-tinh-linh-kien,10224162,"Switch Tenda S105 5 cổng 10/100Mbps - Hàng Chính Hãng",180000,180000,0,0
TIKI,laptop-may-vi-tinh-linh-kien,763161,"Cáp Mạng Đúc Sẵn 2 Đầu CAT5E UTP Ugreen NW103 11233 (5m) - Vàng - Hàng Chính Hãng",64000,64000,0,0
TIKI,laptop-may-vi-tinh-linh-kien,35921896,"Giấy in tem vàng bạc trang sức 42*10mm",140000,140000,0,0
TIKI,laptop-may-vi-tinh-linh-kien,117095192,"Pin dành cho laptop HP Probook 430 G3 - Hàng Nhập Khẩu ",325000,375000,50000,13
TIKI,laptop-may-vi-tinh-linh-kien,104944495,"USB 8Gb Kết Nối Nhanh Tốc Độ Ghi Đọc Nhanh Siêu Nhẹ Chống Bụi",132050,139000,6950,5
TIKI,laptop-may-vi-tinh-linh-kien,86572903,"Pin dành cho Laptop Acer Aspire ES1-572-32GZ",789995,789995,0,0
TIKI,laptop-may-vi-tinh-linh-kien,56639029,"Sạc dành cho Laptop HP Pavilion 14 AL117TU, 14 AL116TU Adapter 19.5V-3.33A",188995,188995,0,0
TIKI,laptop-may-vi-tinh-linh-kien,91479723,"Pin dành cho Laptop Dell Latitude E7490 ",795995,1250000,454005,36
TIKI,laptop-may-vi-tinh-linh-kien,186000694,"Bàn Phím dành cho laptop Dell Inspiron 1320 1440 1445 Bàn Phím dành cho Dell INSPIRON 1440 1320 1445 1450 mã PP42L P04S - Hàng Nhập Khẩu ",302000,352000,50000,14
TIKI,laptop-may-vi-tinh-linh-kien,3628289,"Hộp mực Thuận Phong DCS1810 dùng cho máy photocopy Xerox DC S1810/ S2010/ S2220/ S2420/ S2011/ S2320/ S2520 - Hàng Chính Hãng",245000,245000,0,0
TIKI,laptop-may-vi-tinh-linh-kien,31949588,"MÁY CHẤM CÔNG KIỂM SOÁT CỬA VÂN TAY & THẺ TỪ WISE EYE WSE-269 ( Hàng nhập khẩu)",2180000,2180000,0,0
TIKI,laptop-may-vi-tinh-linh-kien,169922418,"Cổng USB mini 5P chân cắm/chân dán",1940,1940,0,0
TIKI,laptop-may-vi-tinh-linh-kien,125434070,"Sạc dành cho laptop Acer aspire 4750 4750Z 4750G 4750ZG- Kèm Dây nguồn - Hàng Nhập Khẩu",276900,296900,20000,7
TIKI,laptop-may-vi-tinh-linh-kien,545441,"D-Link DGS-1024A - Switch 24 Cổng 10/100/1000M - Hàng Chính Hãng",1050000,1050000,0,0
TIKI,laptop-may-vi-tinh-linh-kien,26218957,"Dây mạng bấm sẵn 2 đầu cat5e 30M (màu ngẫu nhiên)",39000,39000,0,0
TIKI,laptop-may-vi-tinh-linh-kien,137171129,"Bàn Phím Thay Thế Cho Máy Tính Lenovo G40-70 G40-30  - Hàng Nhập Khẩu",292500,312500,20000,6
TIKI,laptop-may-vi-tinh-linh-kien,182994088,"Bàn phím dành cho Laptop ASUS Vivobook S14 X430 X430FA X430FN X430UA S430FA - Màu đen (Black)",449995,449995,0,0
TIKI,laptop-may-vi-tinh-linh-kien,70841912,"Máy in bill, hóa đơn nhiệt khổ 80mm K80 kết nối Bluetooth Xprinter XP-N160B( USB+Bluetooth) - Hàng chính hãng",1580000,1580000,0,0
TIKI,laptop-may-vi-tinh-linh-kien,52089472,"Hộp mực PT 326/328 ( Hàng nhập khẩu )",120000,120000,0,0
TIKI,laptop-may-vi-tinh-linh-kien,16306088,"Hộp mực 36A cho máy in HP M1522n, M1120n, P1505",138000,138000,0,0
TIKI,laptop-may-vi-tinh-linh-kien,121978377,"Líp Xe Đạp ( Líp Ấn) 16 răng cho xe cào cào mini, xe phổ thông",45000,45000,0,0
TIKI,laptop-may-vi-tinh-linh-kien,58081896,"Sạc dùng cho Laptop Lenovo IdeaPad 100, 100-15, 100-15IBY",298995,298995,0,0
TIKI,laptop-may-vi-tinh-linh-kien,130432651,"Băng nhãn Brother Nhãn in Hze-221 ( Tze-221, Tz2- 2211), 9mm*8m, chữ đen nền trắng, Black on White",155000,155000,0,0
TIKI,laptop-may-vi-tinh-linh-kien,55638918,"USB To Com RS232 CH340",47000,47000,0,0
TIKI,laptop-may-vi-tinh-linh-kien,179735149,"Ắc quy ECOTEK, ECT-RA127R2VA1,12V7.2AH - Dùng cho Bộ Lưu Điện - Hàng chính hãng",500000,500000,0,0
TIKI,laptop-may-vi-tinh-linh-kien,171233498,"Mực in màu nước UV DYE REFILL INK 100ml - loại không phai",28000,28000,0,0
TIKI,laptop-may-vi-tinh-linh-kien,68753198,"Lô sấy máy photocopy dùng cho Ricoh 1060, 1075, 9001, 9002",380000,380000,0,0
TIKI,laptop-may-vi-tinh-linh-kien,43138427,"Pin cho Laptop HP Pavilion 15-au Type BP02XL",839996,839996,0,0
TIKI,laptop-may-vi-tinh-linh-kien,187838308,"Giấy decal Tomy nhiều khổ (Hộp)",130000,130000,0,0
TIKI,laptop-may-vi-tinh-linh-kien,200028940,"Bàn phím dùng cho Laptop Dell Latitude 5490 5491 5495 7490  - Hàng Nhập Khẩu New Seal",572280,572280,0,0
TIKI,laptop-may-vi-tinh-linh-kien,182550448,"Switch TP-Link TL-SG1016 (16 Cổng RJ45 10/100/1000Mbps) - Hàng Chính Hãng",1530000,1530000,0,0
TIKI,laptop-may-vi-tinh-linh-kien,105953997,"Bàn phím dành cho Laptop Dell Latitude E5530",398995,398995,0,0
TIKI,laptop-may-vi-tinh-linh-kien,37942035,"Bàn phím laptop dành cho Dell Inspiron N4050 N4110 N4120 N4410 M4040 M4110 N5040 N5050",199000,200000,1000,1
TIKI,laptop-may-vi-tinh-linh-kien,171233630,"Trống 05A dành cho hộp mực 05.",22000,22000,0,0
TIKI,laptop-may-vi-tinh-linh-kien,185999209,"Bàn Phím dành cho laptop Dell Inspiron 15 15R M5010 N5010 - Hàng Nhập Khẩu",242000,292000,50000,17
TIKI,laptop-may-vi-tinh-linh-kien,76421216,"Combo 12 sợi  nối quang Pigtail SC/APC Single mode, Simplex,1.5M, 0.9mm. Hàng nhập khẩu ",100000,100000,0,0
TIKI,laptop-may-vi-tinh-linh-kien,117094357,"Pin dành cho Laptop Dell Latitude E6440 - Hàng Nhập Khẩu ",495000,545000,50000,9
TIKI,laptop-may-vi-tinh-linh-kien,171145577,"Tz2-621 Nhãn in đa lớp 9mm x 8m - Đen nền vàng - Hàng nhập khẩu",128800,140000,11200,8
TIKI,laptop-may-vi-tinh-linh-kien,125432326,"Sạc dành cho laptop IBM - Lenovo thinkpad T440S - Kèm Dây nguồn - Hàng Nhập Khẩu",256000,306000,50000,16
TIKI,laptop-may-vi-tinh-linh-kien,38992360,"Set 10 cuộn giấy decal mã vạch thường khổ 3 tem 35*22mm - 50m",589900,589900,0,0
TIKI,laptop-may-vi-tinh-linh-kien,6410691,"Cáp mạng đúc sẵn 2 đầu Ugreen 11232 - Hàng chính hãng",45000,58000,13000,22
TIKI,laptop-may-vi-tinh-linh-kien,4328049,"Dây cáp mạng đúc sẵn 2 đầu cao cấp - 2m (Giao Màu Ngẫu Nhiên)",12000,17200,5200,30
TIKI,laptop-may-vi-tinh-linh-kien,32412918,"Bộ 2 Trống drum cho HP 49a, 53a, Canon 308. Trống hình hộp mực máy in cho HP 1160, 1320, p2014, p2015, Canon LBP 3300",45000,45000,0,0
TIKI,laptop-may-vi-tinh-linh-kien,117093932,"Pin thay thế dùng cho Laptop Toshiba PA3634U-1BAS - Hàng Nhập Khẩu ",324000,374000,50000,13
TIKI,laptop-may-vi-tinh-linh-kien,48145794,"Bàn phím dành cho laptop Asus A450 F401 K450 X401 X450 X452",199000,200000,1000,1
TIKI,laptop-may-vi-tinh-linh-kien,117093277,"Pin dành cho Laptop HP Elitebook X360 1030 G2 - 11.55V 57WHR - Hàng Nhập Khẩu ",986000,1036000,50000,5
TIKI,laptop-may-vi-tinh-linh-kien,26218953,"Dây mạng bấm sẵn 2 đầu cat5e 10M (màu ngẫu nhiên)",16000,26900,10900,41
TIKI,laptop-may-vi-tinh-linh-kien,117336159,"Pin Laptop DÀNH CHO LENOVO 100-14IBD L15S4A01 - 4 CELL - Ideapad 100-14IBD, 110-14IBD, 100-15IBD, 110-15IBD, 300-14IBD, 300",923998,923998,0,0
TIKI,laptop-may-vi-tinh-linh-kien,49079738,"2 xấp thẻ giấy chấm công chất lượng cao - Hàng nhập khẩu",195000,195000,0,0
TIKI,laptop-may-vi-tinh-linh-kien,77013436,"Hộp mực máy in 78A/326/328 Viettoner (Chính hãng)  - Canon 6230dn, 6200, MF4410, 4420, 4430, 4450, MF4550, 4470, 4480, D520 - HP P1566, P1606, P1606d, M1536 - Cartridge 326",124000,124000,0,0
TIKI,laptop-may-vi-tinh-linh-kien,117094898,"Pin Dành Cho Laptop Toshiba L635 L640 L645 L650 L655 L670 L675 L750 L755 L770 L730 L735 L740 L745 L775 - Hàng Nhập Khẩu ",379000,399000,20000,5
TIKI,laptop-may-vi-tinh-linh-kien,137171169,"Bàn phím thay thế dành cho laptop Dell XPS 13 9360 có đèn nền - Hàng Nhập Khẩu",377000,397000,20000,5
TIKI,laptop-may-vi-tinh-linh-kien,171233571,"GẠT THIẾC DÀNH CHO BROTHER HL 2240 ....",18000,18000,0,0
TIKI,laptop-may-vi-tinh-linh-kien,125433923,"Sạc cho laptop Dell Inspiron 3421 5421 3521 3537 Adapter Dell 19.5V-3.34A 19.5V-4.62A - Kèm Dây nguồn - Hàng Nhập Khẩu",219000,269000,50000,19
TIKI,laptop-may-vi-tinh-linh-kien,56698231,"Sạc dành cho Laptop HP Pavilion DV6 Adapter 18.5V-3.5A, 19V-4.74A",189995,189995,0,0
TIKI,laptop-may-vi-tinh-linh-kien,57485748,"Sạc dành cho Laptop Acer E5-571-3747, E5-571",133000,133000,0,0
TIKI,laptop-may-vi-tinh-linh-kien,161368406,"Bàn phím dành cho Laptop Dell Vostro 3480",349995,349995,0,0
TIKI,laptop-may-vi-tinh-linh-kien,102446014," USB DTSE9 16G - 8G chống nước, chất liệu kim loại",62230,62230,0,0
TIKI,laptop-may-vi-tinh-linh-kien,16598957,"Keo tản nhiệt dạng xi lanh to (xám) Hàng nhập khẩu",11000,11950,950,8
TIKI,laptop-may-vi-tinh-linh-kien,134863297,"Giấy in nhiệt 35×22 cho máy in mã vạch",68000,68000,0,0
TIKI,laptop-may-vi-tinh-linh-kien,49652338,"Pin Dành Cho Laptop Dell Vostro 3558 3458 Inspiron 3552 3558 5451 5459 5755 3451 3458 5455 5458 3551 3558 5551 5558 5559",378895,550000,171105,31
TIKI,laptop-may-vi-tinh-linh-kien,83397665,"Bàn phím dành cho Laptop HP Pavilion X360 11-ad026tu",349995,349995,0,0
TIKI,laptop-may-vi-tinh-linh-kien,186000532,"Bàn Phím dành cho laptop HP 14BA 14-BA 14BS 14-BS 14BF 14-BF 14CM 14 -CM 240 G7 245 G7 348 G5 - Hàng Nhập Khẩu",266000,316000,50000,16
TIKI,laptop-may-vi-tinh-linh-kien,83491573,"Mực nước máy in Epson T664 L300 / L310 / L350 / L360 / L1300 / L100 / L120 / L200 / L210 / L565 ... -70ML-HÀNG NHẬP KHẨU",50000,50000,0,0
TIKI,laptop-may-vi-tinh-linh-kien,179992221,"Bàn phím dành cho Laptop HP Elitebook 840 G3 G4 - Hàng Nhập Khẩu ",550000,600000,50000,8
TIKI,laptop-may-vi-tinh-linh-kien,58070021,"Thiết Bị Test Nguồn ATX Máy Tính Hiển Thị Màn Hình LCD AZONE",196000,218000,22000,10
TIKI,laptop-may-vi-tinh-linh-kien,117095107,"Pin dành cho Laptop Dell Inspiron 15 5558 N5558 - Hàng Nhập Khẩu ",467000,517000,50000,10
TIKI,laptop-may-vi-tinh-linh-kien,69466090,"Bột từ Type 21 dùng cho Ricoh MP 1060, 1075, 2060, 2075, 5500, 6500, 7500, 6000, 7000 8000, 6001, 7001, 8001, 9001, 6002, 6502, 7502, 7503",770000,770000,0,0
TIKI,laptop-may-vi-tinh-linh-kien,72456773,"Tenda Thiết bị phát Wifi AC5 Chuẩn AC 1200Mbps - Hàng Chính Hãng",388000,388000,0,0
TIKI,laptop-may-vi-tinh-linh-kien,2063235,"Đầu đọc vân tay U.Are U4500 Digital Persona - Hàng Chính Hãng",2350000,2350000,0,0
TIKI,laptop-may-vi-tinh-linh-kien,31375366,"[Sét 10 cuộn] Giấy in nhiệt K80x80",144000,144000,0,0
TIKI,laptop-may-vi-tinh-linh-kien,11509782,"USB Lan Dây 10/100/1000 - Hàng Nhập Khẩu",108000,108000,0,0
TIKI,laptop-may-vi-tinh-linh-kien,56712140,"Máy in nhiệt chuyên dùng in số thứ tự EPSON T81III (Hàng chính hãng)",2200000,2200000,0,0
TIKI,laptop-may-vi-tinh-linh-kien,14204003,"Sạc dành cho Laptop Asus 19v-2.37a vuông (Chân nhỏ - Cỡ chân sạc: 4,0 x 1,35 mm)- Hàng Nhập Khẩu",239995,239995,0,0
TIKI,laptop-may-vi-tinh-linh-kien,48553267,"FAN CASE TẢN NHIỆT DÙNG CHO CPU",35000,35000,0,0
TIKI,laptop-may-vi-tinh-linh-kien,71886389,"Hộp mực ( Tone Cartridge - G59 )  dùng cho máy Photocopy Canon IR 2002, 2004, 2202, 2204",220000,220000,0,0
TIKI,laptop-may-vi-tinh-linh-kien,170434678,"Kềm bấm mạng 6p - 8p rj45 rj11 có trợ lực NW168 Ugreen 10952 Hàng chính hãng",444000,444000,0,0
TIKI,laptop-may-vi-tinh-linh-kien,24897946,"Hộp drum Brother DR 2255, là cụm khay trống drum cho máy in Brother HL 2130, 2240, 2250, 2270, 7060, 7360, 7860, DCP 7055",198000,198000,0,0
TIKI,laptop-may-vi-tinh-linh-kien,137170700,"Bàn phím thay thế dành cho laptop Dell Inspiron 5447 5448 có đèn nền - Hàng Nhập Khẩu mới 100%",378950,398950,20000,5
TIKI,laptop-may-vi-tinh-linh-kien,26299974,"Đầu bấm DB9 (RS232) Male HD-Link",110000,110000,0,0
TIKI,laptop-may-vi-tinh-linh-kien,200029678,"Bàn Phím dùng cho laptop Lg R580 R590 R560 R570 MÀU TRẮNG - Hàng Nhập Khẩu New Seal",835200,835200,0,0
TIKI,laptop-may-vi-tinh-linh-kien,20992070,"Pin dành cho Laptop Dell Inspiron 3521",359995,500000,140005,28
TIKI,laptop-may-vi-tinh-linh-kien,32744214,"Kìm mạng RJ45, RJ11, RJ12 TL-315",99000,99000,0,0
TIKI,laptop-may-vi-tinh-linh-kien,14847176,"USB Bluetooth 4.0 dùng cho PC, Laptop Orico - Hàng Nhập Khẩu",99000,99000,0,0
TIKI,laptop-may-vi-tinh-linh-kien,191652329,"Sạc dành cho LAPTOP HP Probook 450 G8",289995,289995,0,0
TIKI,laptop-may-vi-tinh-linh-kien,253284288,"USB 3.2 SanDisk Extreme Pro CZ880 256GB - Hàng Nhập Khẩu",1350000,1350000,0,0
TIKI,laptop-may-vi-tinh-linh-kien,163714073,"Sạc dành cho Laptop Gaming Asus R.O.G Zephyrus G GA502 GA502DU GX502GW GU502GU",850000,850000,0,0
TIKI,laptop-may-vi-tinh-linh-kien,103707687,"Pin dành cho HP Laptop 15-BS000 15-bs0xx Series 15-bs553TU 15-bs557TU 15-bs667TX  15-bs768TX",398995,398995,0,0
TIKI,laptop-may-vi-tinh-linh-kien,459731,"Brother LC-563C Ink Cho MFC-J2310/J2510/J3520/J3720 (Xanh lục) - Hàng Chính Hãng",220000,220000,0,0
TIKI,laptop-may-vi-tinh-linh-kien,192564394,"Ổ cứng SSD 512 - TEAMGROUP - Tốc độ cao - Vỏ Nhôm - Sịn- Hàng Chính Hãng",375250,395000,19750,5
TIKI,laptop-may-vi-tinh-linh-kien,185999265,"Bàn Phím dành cho laptop Lenovo Ideapad 100 14 100-14IBY - Hàng Nhập Khẩu",266000,316000,50000,16
TIKI,laptop-may-vi-tinh-linh-kien,30034270,"Hộp mực Thuận Phong MLT-D116S dùng cho máy in Samsung Xpress M2625/ M2626/ M2825/ M2826/ M2835/ M2675/ M2676/ M2875/ M2876/ M2885 - Hàng Chính Hãng",490000,490000,0,0
TIKI,laptop-may-vi-tinh-linh-kien,58080950,"Sạc dùng cho Laptop Lenovo IdeaPad 100S-11IBY",429998,429998,0,0
TIKI,laptop-may-vi-tinh-linh-kien,57047512,"Sạc dành cho Laptop Asus S46, S46C, S46CA Adapter 19V-3.42A",214995,214995,0,0
TIKI,laptop-may-vi-tinh-linh-kien,178602114,"Dây Mạng Liền Nguồn Golden Japan Cat5e FTP CCA 4P 24AWG Bọc Bạc Chống Nhiễu + Kèm 2 Sợi Dây Điện 2C - Hàng Chính Hãng",85000,85000,0,0
TIKI,laptop-may-vi-tinh-linh-kien,127377025,"Laptop HP 15s-du1105TU 2Z6L3PA i3-10110U/4GB/256GB SSD/15.6''HD/Win 11/Silver - Hàng Chính Hãng",10945200,10945200,0,0
TIKI,laptop-may-vi-tinh-linh-kien,17901246,"Hộp mực cho máy in Xerox DocuPrint P115w, M115b, M115fw, M115w",128000,128000,0,0
TIKI,laptop-may-vi-tinh-linh-kien,214085231,"BỘ ĐIỀU KHIỂN DÙNG CHO MÀN CHIẾU",600000,600000,0,0
TIKI,laptop-may-vi-tinh-linh-kien,52255003,"[100 cuộn] Giấy in nhiệt Giấy in bill VAYO Khổ 57 x 45 mm - In rõ nét - Lõi siêu nhỏ - Hàng chính hãng",611000,700000,89000,13
TIKI,laptop-may-vi-tinh-linh-kien,2015907,"COMBO Hộp mực Thuận Phong 78A (TỰ NẠP) + 2 lọ mực đổ TP01 dùng cho máy in HP LJ P1566/ P1606/ M1536/ Canon LBP 6200D/ 6230DN/ MF 4400/ 4430/ 4580 - Hàng Chính Hãng",460000,460000,0,0
TIKI,laptop-may-vi-tinh-linh-kien,72512923,"Vỏ Case Golden Field N27W kèm 01 fan tản nhiệt 120mm (Led) - Hàng chính hãng",650000,650000,0,0
TIKI,laptop-may-vi-tinh-linh-kien,56198267,"Máy in đa chức năng (In, copy, scan, fax, wifi) đen trắng HP LaserJet MFP 137fnw_4ZB84A – Hàng chính hãng",4790000,4790000,0,0
TIKI,laptop-may-vi-tinh-linh-kien,49993490,"Bộ nguồn cho máy in hóa đơn 24V chân 3 pin",230000,230000,0,0
TIKI,laptop-may-vi-tinh-linh-kien,155530449,"Laptop HP Envy x360 Convert 13 ay1057AU R5 5600U/8GB/256GB/13.3"F/Touch/Pen/Win11/(601Q9PA)/Đen - Hàng chính hãng",36204000,36204000,0,0
TIKI,laptop-may-vi-tinh-linh-kien,114140604,"Sạc cho Laptop Acer Swift 3 SF314-53 SF314-54 SF314-55",234900,234900,0,0
TIKI,laptop-may-vi-tinh-linh-kien,191695540,"Ổ cứng gắn trong SSD Samsung 980 Pro 250GB | 500GB | 1TB | 2TB PCIe 4.0 x4 NVMe1.3c M2 2280 V-NAN - Hàng chính hãng",1950000,3230000,1280000,40
TIKI,laptop-may-vi-tinh-linh-kien,186636378,"Card màn hình Zotac Gaming GeForce RTX 2060 Twin Fan (ZT-T20600F-10M)-- Hàng Chính Hãng",7900000,7900000,0,0
TIKI,laptop-may-vi-tinh-linh-kien,3556877,"(BỘ 10 CHAI) Mực đổ Thuận Phong TP06 dùng cho máy in Brother - Hàng Chính Hãng",295000,295000,0,0
TIKI,laptop-may-vi-tinh-linh-kien,17954263,"Màn hình máy tính AOC 24V2Q 24 inches IPS FHD 75Hz (Đen) - Hàng chính hãng",2980000,2980000,0,0
TIKI,laptop-may-vi-tinh-linh-kien,39854315,"GAMING PC - BN 1050Ti - G5400/ H310/ 8GB/ 120GB/ GTX 1050Ti/ 450W + MÀN HÌNH CONG 24 INCH CHUYÊN GAME CHO KHỞI ĐẦU HOÀN HẢO",8132000,8560000,428000,5
TIKI,laptop-may-vi-tinh-linh-kien,151765074,"Mực dùng cho máy  photocopy Ricoh MP 2352/2550/2851/2852/3351/3352/3353/3053/3030/3391 - Mã mực: Ricoh 2220D/ 2320D",150000,150000,0,0
TIKI,laptop-may-vi-tinh-linh-kien,111630913,"Pin dành cho Laptop HP Pavilion X360 11-AD 11-ad104TU 11-AD010CA 11-AD051NR - KN02XL",749995,749995,0,0
TIKI,laptop-may-vi-tinh-linh-kien,177145547,"[Hàng chính hãng] Máy in nhãn Brother PT-P300BT",1353370,1353370,0,0
TIKI,laptop-may-vi-tinh-linh-kien,130048539,"Màn hình máy tính Dell P2422H 24inch FullHD 5ms 60Hz IPS - Hàng Chính Hãng",5190000,5190000,0,0
TIKI,laptop-may-vi-tinh-linh-kien,99983818,"Màn hình máy tính LG QHD 23.8'' IPS HDR10 chân đế linh hoạt 24QP550-B Hàng Chính Hãng",4390000,6290000,1900000,30
TIKI,laptop-may-vi-tinh-linh-kien,109567587,"Máy chiếu mini Q2 LCD PROJECTOR hỗ trợ giảng dạy giải trí độ phân giải 1080P",1380000,1380000,0,0
TIKI,laptop-may-vi-tinh-linh-kien,109889756,"Đầu đọc ổ cứng HDD 2.5 và 3.5 inch tất cả trong 1 - Dock HDD All in one",440000,440000,0,0
TIKI,laptop-may-vi-tinh-linh-kien,514911,"Bộ Chuyển Đổi Wifi TP-Link Archer T6E Băng Tần Kép PCI Express AC1300 - Hàng Chính Hãng",899000,1099000,200000,18
TIKI,laptop-may-vi-tinh-linh-kien,167686057,"Sạc dành cho Laptop Asus Gaming ROG X571 F571 X571GD  F571GD-BQ319T F571GT-BQ266T",650000,650000,0,0
TIKI,laptop-may-vi-tinh-linh-kien,192203264,"Ổ Cứng Di Động WD Elements SE SSD Hàng Chính Hãng",9550000,9550000,0,0
TIKI,laptop-may-vi-tinh-linh-kien,94173532,"Màn hình LCD LG 24QP500-B 23.8 inch IPS 2K QHD - Hàng Chính Hãng",4790000,4790000,0,0
TIKI,laptop-may-vi-tinh-linh-kien,108590741,"Máy in Brother HL-L2321D- hàng chính hãng",2780000,2780000,0,0
TIKI,laptop-may-vi-tinh-linh-kien,171606540,"Màn hình Gaming LG 24GN650-B 24'' UltraGear FHD IPS 1ms 144Hz HDR Monitor with FreeSync - Hàng chính hãng",4490000,4490000,0,0
TIKI,laptop-may-vi-tinh-linh-kien,180396187,"Laptop HP Envy 13 ba1537TU i5 1135G7/8GB/256GB/13.3"F/Win11/(4U6P0PA)/Vàng - Hàng chính hãng",24000000,24000000,0,0
TIKI,laptop-may-vi-tinh-linh-kien,100031927,"Màn hình LG 32UN500-W 31.5 Inch UHD 4K HDR - Hàng chính hãng",7900000,7900000,0,0
TIKI,laptop-may-vi-tinh-linh-kien,126864503,"Màn hình máy tính LG 24MP500-B 24 inch IPS 75Hz - Hàng Chính Hãng",2490000,3590000,1100000,31
TIKI,laptop-may-vi-tinh-linh-kien,7491203," Hộp mực 12A cho Hp 1010/1020/Canon 2900/MF4350D ",124000,124000,0,0
TIKI,laptop-may-vi-tinh-linh-kien,87000048,"Màn hình LCD GIGABYTE G27FC-EK (1920 x 1080/VA/165Hz/1 ms/FreeSync, G-Sync compatible) - Hàng Chính Hãng",4950000,4950000,0,0
TIKI,laptop-may-vi-tinh-linh-kien,125432462,"Sạc dành cho Laptop HP Probook 430 G1 Adapter 18.5V-3.5A 19V-4.74A - Kèm Dây nguồn - Hàng Nhập Khẩu",228900,248900,20000,8
TIKI,laptop-may-vi-tinh-linh-kien,128778031,"Màn Hình Samsung UHD 4K 32 Inch Không Viền  LS32A700 - Hàng chính hãng",7800000,7800000,0,0
TIKI,laptop-may-vi-tinh-linh-kien,50604092,"Màn Hình Máy Tính AOC 27V2Q 27'' FHD (1920x1082) 5ms 75Hz IPS AMD FreeSync - Hàng Chính Hãng",3500000,3500000,0,0
TIKI,laptop-may-vi-tinh-linh-kien,163871476,"Laptop HP Envy 13 ba1536TU i5 1135G7/8GB/512GB/13.3"F/Win11/(4U6M5PA)/Vàng - Hàng chính hãng",32772000,32772000,0,0
TIKI,laptop-may-vi-tinh-linh-kien,174363824,"Bo Mạch Chủ Mainboard Main Gigabyte B660M AORUS PRO DDR4 Socket 1700 - Hàng Chính Hãng",4290000,4290000,0,0
TIKI,laptop-may-vi-tinh-linh-kien,97338981,"Màn hình Msi Optix G241V E2 - Hàng Chính Hãng",3250000,3250000,0,0
TIKI,laptop-may-vi-tinh-linh-kien,101152159,"Màn hình máy tính Samsung LC32G55TQWEXXV 32″ (QHD/VA/144Hz/1ms) - Hàng Chính hãng",6990000,6990000,0,0
TIKI,laptop-may-vi-tinh-linh-kien,197693790,"Máy tính mini PC BOX Mini Dual HDMI CPU J4125 Ram8G + 128Gb (tích hợp win 11Pro)",6420000,6420000,0,0
TIKI,laptop-may-vi-tinh-linh-kien,135268243,"Laptop HP 340s G7 36A43PA (Core i5-1035G1/ 8GB/ 256GB/ 14 FHD/ Win10) - Hàng Chính Hãng",22800000,22800000,0,0
TIKI,laptop-may-vi-tinh-linh-kien,180396111,"Laptop HP 340s G7 i5 1035G1/8GB/512GB/14"F/Win10/(36A35PA)/Xám - Hàng chính hãng",16190000,16190000,0,0
TIKI,laptop-may-vi-tinh-linh-kien,121243273,"Màn hình LCD 7inch HDMI (H) (with case), 1024x600, Công nghệ IPS, Cảm ứng điện dung Waveshare - Hàng Chính Hãng",2150000,2150000,0,0
TIKI,laptop-may-vi-tinh-linh-kien,93239845,"Card Màn Hình MSI Geforce GT 1030 2GD4 LP OC - Hàng Chính Hãng ",2250000,2250000,0,0
TIKI,laptop-may-vi-tinh-linh-kien,23197333,"Card Màn Hình VGA ASUS ROG STRIX GTX1650 O4G GAMING GDDR5 4GB 128-bit - Hàng Chính Hãng",5900000,5900000,0,0
TIKI,laptop-may-vi-tinh-linh-kien,99998451,"Màn hình máy tính LG UHD 4K 27'' IPS VESA DisplayHDR 400 27UP600-W - Hàng chính hãng",6690000,6690000,0,0
TIKI,laptop-may-vi-tinh-linh-kien,151839086,"Laptop HP Envy 13 ba1535TU i7 1165G7/8GB/512GB/13.3"F/Win11/(4U6M4PA)/Vàng - Hàng chính hãng",40020000,40020000,0,0
TIKI,laptop-may-vi-tinh-linh-kien,109581548,"Bộ Phát Wifi Mesh TP-Link Deco X60 AX3000 MU-MIMO Hàng Chính Hãng",6399000,9999000,3600000,36
TIKI,laptop-may-vi-tinh-linh-kien,108381675,"Máy chiếu Mini Doanh nhân i-Projector Taxes Instrument Android cảm ứng bỏ túi - Độ nét cực cao",8000000,8000000,0,0
TIKI,laptop-may-vi-tinh-linh-kien,115746278,"Màn Hình ViewSonic VX3276 2K MHD 32"/IPS/75Hz/HDR10 (2021) - Hàng Chính Hãng",6290000,6290000,0,0
TIKI,laptop-may-vi-tinh-linh-kien,96195866,"Máy chiếu mini YG-310 Full HD 1080p",1189000,1189000,0,0
TIKI,laptop-may-vi-tinh-linh-kien,142369983,"Máy in bill hóa đơn, máy in mini cầm tay bluetooth bỏ túi hỗ trợ trên điện thoại android ios - tặng 5 cuộn giấy in",520000,520000,0,0
TIKI,laptop-may-vi-tinh-linh-kien,55162363,"Màn hình máy tính ViewSonic VX2776-SH 27 inch FHD 75Hz - Hàng Chính Hãng",3700000,3700000,0,0
TIKI,laptop-may-vi-tinh-linh-kien,168372008,"VGA Gigabyte GT 730 2G GDDR5 (GV-N730D5-2GL) - Hàng Chính Hãng",1360000,1360000,0,0
TIKI,laptop-may-vi-tinh-linh-kien,230251719,"Màn Hình AOC CQ27G2 27" VA 2k 144Hz 1Ms Gsync Compatible Chuyên Gaming- Hàng Chính Hãng",5380000,7990000,2610000,33
TIKI,laptop-may-vi-tinh-linh-kien,198081548,"Ổ CỨNG SSD 128/256GB EEKOO - 2.5INCH - SATA3 6GB/S Hàng chính hãng",295000,295000,0,0
TIKI,laptop-may-vi-tinh-linh-kien,115746027,"VGA MSI RTX 3070Ti GAMING X TRIO 8GB GDDR6X- Hàng Chính Hãng",24346000,24346000,0,0
TIKI,laptop-may-vi-tinh-linh-kien,159445256,"CPU Intel Core i9-12900K (3.9GHz turbo up to 5.2Ghz, 16 nhân 24 luồng, 30MB Cache, 125W) - Socket Intel LGA 1700/Alder Lake) - Hàng Chính Hãng",15950000,15950000,0,0
TIKI,laptop-may-vi-tinh-linh-kien,163927793,"Bo Mạch Chủ Mainboard MSI MAG B660M MORTAR WIFI DDR4 - Hàng Chính Hãng",6846000,6846000,0,0
TIKI,laptop-may-vi-tinh-linh-kien,53052440,"Máy tính để bàn chơi GAME Viettech Core i5 3470, Ram 16gb,- SSD 120GB- màn 22 inch full hd- Có kết nối wifi không dây - chuyên dùng cho văn phòng - học sinh - sinh viên - giải trí game Hàng Nhập Khẩu",4390000,4390000,0,0
TIKI,laptop-may-vi-tinh-linh-kien,32946244,"Ổ Cứng SSD Lexar NM100 M.2 2280 SATA 6Gb/s 128GB - Hàng Chính Hãng",460000,460000,0,0
TIKI,laptop-may-vi-tinh-linh-kien,66792707,"MÁY IN HÓA ĐƠN KHÔNG DÂY XPRINTER 58IIH-KẾT NỐI BLUETOOTH VỚI ĐIỆN THOẠI+MÁY TÍNH ( SẢN PHẨM NHẬP KHẨU)",719000,719000,0,0
TIKI,laptop-may-vi-tinh-linh-kien,72082905,"Hệ Thống MESH WI-FI 6 ASUS XT8 (W-1-PK) ZenWiFi Chuẩn AX6600 3 Băng Tần- Hàng Chính Hãng",7590000,7590000,0,0
TIKI,laptop-may-vi-tinh-linh-kien,91767773,"Dây nhảy quang SC SC Duplex - Sợi đôi",75000,75000,0,0
TIKI,laptop-may-vi-tinh-linh-kien,58277586,"Màn Hình LG 32UN880-B 32'' UHD 4K Ergo (3840x2160) 5ms / 60Hz / IPS / USB Type-C / AMD FreeSync / Maxx Audio (5W) - Hàng Chính Hãng",14490000,14490000,0,0
TIKI,laptop-may-vi-tinh-linh-kien,186206860,"[Hàng chính hãng] Combo Máy in laser đơn sắc Brother HL-L2321D và Mực in laser trắng đen Brother TN-2385",3650000,3650000,0,0
TIKI,laptop-may-vi-tinh-linh-kien,34680673,"Card màn hình GIGABYTE GeForce GTX 1650 4GB GDDR5 OC (GV-N1650OC-4GD)-Hàng Chính Hãng",4590000,4590000,0,0
TIKI,laptop-may-vi-tinh-linh-kien,22642197,"Đĩa CD trắng Maxell - Cọc 50 đĩa - Hàng nhập khẩu",301000,301000,0,0
TIKI,laptop-may-vi-tinh-linh-kien,50693254,"BỘ PHÁT WIFI 4G ZTE CP101 - CHÍNH HÃNG",958000,958000,0,0
TIKI,laptop-may-vi-tinh-linh-kien,149519742,"Hộp ổ cứng Orico 9558U3-BK 3.5" 5 khe cắm SATA 3 USB 3.0 Type B - Hàng Chính Hãng",3328000,3328000,0,0
TIKI,laptop-may-vi-tinh-linh-kien,35048099,"MÀN CHIẾU DI ĐỘNG  - 85 Inch (152cm x 152cm, Tỷ lệ: 1:1)",710000,710000,0,0
TIKI,laptop-may-vi-tinh-linh-kien,2045621,"Hộp 10 Cái Đầu Bấm Mạng Ugreen RJ45 CAT6 20333 - Hàng Chính Hãng",60000,65000,5000,8
TIKI,laptop-may-vi-tinh-linh-kien,97851120,"Màn hình Samsung Odyssey G5 LC34G55TWWEXXV 34Inch 165Hz 1Ms Curved VA - Hàng Chính Hãng",8890000,8890000,0,0
TIKI,laptop-may-vi-tinh-linh-kien,145826490,"Máy chiếu XGIMI Halo Plus - bản quốc tế/ Hàng chính hãng",24990000,24990000,0,0
TIKI,laptop-may-vi-tinh-linh-kien,89783330,"Ngăn kéo đựng tiền thu ngân RC 330",520000,850000,330000,39
TIKI,laptop-may-vi-tinh-linh-kien,12378079,"Ổ cứng di động Seagate Expansion Desktop Drive 4Tb 3.5Inch - Hàng chính hãng",2900000,3300000,400000,12
TIKI,laptop-may-vi-tinh-linh-kien,273553239,"[Tặng Cable, BH 3 Năm] Focusrite 4i4 Gen 3, Gen 4 Sound Card Âm Thanh Scarlett - Focus USB Audio SoundCard Gen3 - Gen4 Hàng Chính Hãng",5699000,5699000,0,0
TIKI,laptop-may-vi-tinh-linh-kien,57051581,"Hộp mưc in 12A có lổ đổ/nạp mực cho máy in Canon 2900 3000 HP 1010 1020 (Mã HKC-12A-R)",115500,115500,0,0
TIKI,laptop-may-vi-tinh-linh-kien,356387,"Ổ Cứng Di Động WD Elements 1TB 2.5 USB 3.0 - WDBUZG0010BBK - Hàng Chính Hãng",1759000,1759000,0,0
TIKI,laptop-may-vi-tinh-linh-kien,77117709,"Laptop Lenovo Ideapad Slim 5 15ITL05 (82FG001PVN). Intel Core I5 1135G7 - Hàng Chính hãng",15290000,15290000,0,0
TIKI,laptop-may-vi-tinh-linh-kien,135496562,"Đầu chia LAN RJ45 UGREEN CM210 50923 - 1 cổng ra 2 cổng - hàng chính hãng",162000,162000,0,0
TIKI,laptop-may-vi-tinh-linh-kien,14379439,"Trống máy in Brother HL-2385/L2320D/2321D/2340DW/2360DN/2361dn/2365DW - Hàng nhập khẩu",59000,59000,0,0
TIKI,laptop-may-vi-tinh-linh-kien,23015340,"Khay Đựng Ổ Cứng Docking ORICO USB3.0/3.5/2.5 - 6228US3 - Hàng Chính Hãng",499000,750000,251000,33
TIKI,laptop-may-vi-tinh-linh-kien,159440750,"Màn Hình AOC CQ27G2 27" IPS 2k 144Hz 1Ms Gsync Compatible Chuyên Gaming- Hàng Chính Hãng",6590000,6590000,0,0
TIKI,laptop-may-vi-tinh-linh-kien,46913805,"Tản Nhiệt Nước CPU ID-COOLING AURAFLOW X 240 - Hàng Chính Hãng",1490000,1490000,0,0
TIKI,laptop-may-vi-tinh-linh-kien,197105471,"️ FREESHIP ️ Máy chiếu mini Q2 LCD PROJECTOR 1080P",1404000,1404000,0,0
TIKI,laptop-may-vi-tinh-linh-kien,165941799,"Màn hình Samsung LS19A330NHEXXV 19 Inch 1366 x 768 60Hz - Hàng Chính Hãng",1790000,1790000,0,0
TIKI,laptop-may-vi-tinh-linh-kien,30040551,"Bộ lưu trữ mạng NAS TerraMaster F4-210 Quad-core CPU, 2GB RAM, 4 khay ổ cứng RAID 0,1,5,6,10,JBOD,Single - Hàng chính hãng",6690000,6690000,0,0
TIKI,laptop-may-vi-tinh-linh-kien,70692002,"Laptop Dell Vostro 3405 V4R53500U003W (AMD R5-3500U/ 8GB (1x8GB) DDR4 2400Mhz/ 512SSD M2 PCIe NVMe/ 14 FHD/ Win10) - Hàng Chính Hãng",11550000,11550000,0,0
TIKI,laptop-may-vi-tinh-linh-kien,160305537,"Surface Laptop Go Core i5 / RAM 8GB / SSD 128GB / 12.4 inch / 1.1kg / Win 10 - Hàng Nhập Khẩu Mỹ (Open Box)",12700000,12700000,0,0
TIKI,laptop-may-vi-tinh-linh-kien,1563581,"Card Màn Hình VGA MSI GT1030 AERO ITX 2G OC 64BIT 1 Fan HDMI DVI - Hàng Chính Hãng",2090000,2090000,0,0
TIKI,laptop-may-vi-tinh-linh-kien,22385913,"Huawei E8377 | Bộ phát wifi 4G tốc đô phát sóng lên đến 150mbps, lướt web mượt mà không giật lag - Hàng nhập khẩu",689000,750000,61000,8
TIKI,laptop-may-vi-tinh-linh-kien,615976,"Bộ Chia Mạng 5 Cổng Gigabit Totolink S505G – Hàng Chính Hãng",230000,230000,0,0
TIKI,laptop-may-vi-tinh-linh-kien,20015889,"Màn Hinh BenQ GW2283 22 Inch Full HD (1920 x 1080) 5ms 60Hz IPS Speaker 1W x 2 - Hàng Chính Hãng",2850000,2850000,0,0
TIKI,laptop-may-vi-tinh-linh-kien,8319455,"Máy in Laser đa chức năng Ricoh SP 230SFNw  - Hàng Chính Hãng",6850000,6850000,0,0
TIKI,laptop-may-vi-tinh-linh-kien,159058916,"Màn Hình Gaming Edra EGM24F1 (23.8inch/FHD/IPS/144Hz/1ms) - Hàng Chính hãng",3690000,3690000,0,0
TIKI,laptop-may-vi-tinh-linh-kien,137822315,"Vỏ Case Máy Tính Mini Orient T03 - Hàng Chính Hãng",259000,259000,0,0
TIKI,laptop-may-vi-tinh-linh-kien,114789092,"Màn hình ViewSonic VX2719 PC - MHD 27inch 240Hz Hàng chính hãng",4390000,4390000,0,0
TIKI,laptop-may-vi-tinh-linh-kien,35339655,"Màn Hình Samsung LS24R350FZEXXV 24inch FullHD 5ms 75Hz AMD FreeSync - Hàng Chính Hãng",2690000,2690000,0,0
TIKI,laptop-may-vi-tinh-linh-kien,21391584,"Quạt Tản Nhiệt 4x4x1Cm 5V 0.6W",14900,14900,0,0
TIKI,laptop-may-vi-tinh-linh-kien,159909050,"Laptop Acer Nitro 5 Tiger AN515-58-52SP (Core i5-12500H/ 8GB/ 512GB SSD/ RTX 3050/ 15.6 FHD IPS, 144Hz/ Win11) - Hàng Chính Hãng",24000000,24000000,0,0
TIKI,laptop-may-vi-tinh-linh-kien,47073364,"COMBO 4 LỌ KEO TẢN NHIỆT MÁY TÍNH XÁM",15190,15190,0,0
TIKI,laptop-may-vi-tinh-linh-kien,179234803,"Ổ cứng SSD Kingston A400 120Gb/240Gb/480Gb sata 3 2.5''- Hàng chính hãng",940500,990000,49500,5
TIKI,laptop-may-vi-tinh-linh-kien,9857574,"Ổ Cứng HDD Western Digital 8TB 3.5 Sata 3 128MP WD81PURZ - Hàng Chính Hãng",6566000,6566000,0,0
TIKI,laptop-may-vi-tinh-linh-kien,21585289,"Pin Thay Thế cho Pin Laptop Asus X550, K550, X450, X550C, X550CA, X550CC, A41-X550A, X550D, X550A, K550C...(Tặng bộ về sinh laptop)",320000,320000,0,0
TIKI,laptop-may-vi-tinh-linh-kien,48923082,"Phần mềm Norton Security - 1 year 1 user - chính hãng ",299000,350000,51000,15
TIKI,laptop-may-vi-tinh-linh-kien,11340356,"Mực in phun Canon PG740 - Hàng Chính Hãng",480000,480000,0,0
TIKI,laptop-may-vi-tinh-linh-kien,9850897,"USB Phát Wifi 4G LTE từ Sim điện thoại (Dcom 4G - Router - APN)",270000,270000,0,0
TIKI,laptop-may-vi-tinh-linh-kien,172493235,"Màn Hình LCD Philips 221V8 (1920x1080/VA/75Hz/4ms) - Hàng Chính Hãng",1730000,1730000,0,0
TIKI,laptop-may-vi-tinh-linh-kien,69904929,"Router Wifi ASUS RT-AX86U Hai Băng Tần Chuẩn AX5700 (Chuyên Cho Game Di Động)- Hàng Chính Hãng",5900000,5900000,0,0
TIKI,laptop-may-vi-tinh-linh-kien,78971544,"Hộp mực Brother TN 2385 dùng cho máy in Brother HL-L2361DN/HL-2321D/MFC-L2701DW/HL-L2366DW/L2701D/ 2320/ 2321/ 2340/ 2360/ 2361/ 2365/ 2366/ 2700/ 2701/ 2701/ 2720/ 2740 (Black)",116500,116500,0,0
TIKI,laptop-may-vi-tinh-linh-kien,186495684,"ROGTZ Máy Test Mạng NOYAFA NF-858C - Hàng Nhập Khẩu",1702400,1792000,89600,5
TIKI,laptop-may-vi-tinh-linh-kien,23172957,"USB Transcend JetFlash 700 TS32GJF700 128GB - USB 3.1 - Hàng Chính Hãng",309000,339000,30000,9
TIKI,laptop-may-vi-tinh-linh-kien,181475022,"Laptop Gaming Acer Nitro 5 Tiger AN515-58-52SP  i5-12500H/RAM 8GB/512GB SSD/3050 4GB Hàng Chính Hãng",24000000,24000000,0,0
TIKI,laptop-may-vi-tinh-linh-kien,545215,"D-Link DES-1024A - Switch 24 Cổng 10/100M  - Hàng Chính Hãng",660000,660000,0,0
TIKI,laptop-may-vi-tinh-linh-kien,150776876,"Giấy in hóa đơn, giấy in bill nhiệt K80 bọc bạc (100 cuộn)",557000,557000,0,0
TIKI,laptop-may-vi-tinh-linh-kien,82740870,"VGA MSI GeForce RTX 3060 GAMING X 12G - Hàng Chính Hãng",19460000,19460000,0,0
TIKI,laptop-may-vi-tinh-linh-kien,117094550,"Pin dành cho Laptop Dell Inspiron 14 5468 - Hàng Nhập Khẩu ",431900,451900,20000,4
TIKI,laptop-may-vi-tinh-linh-kien,107471624,"Máy in Laser đơn năng Brother HL-L2321D in 2 mặt tự động - Hàng Chính Hãng",2890000,2890000,0,0
TIKI,laptop-may-vi-tinh-linh-kien,561990,"Kaspersky Small Office Security (1server + 5PC) - KSOS 5 - Hàng chính hãng",3105000,3105000,0,0
TIKI,laptop-may-vi-tinh-linh-kien,14380807,"Hộp mực Samsung MLT1043S/104, Samsung ML-1666/1665/1660/1661/3201/1860 - Hàng nhập khẩu",275000,275000,0,0
TIKI,laptop-may-vi-tinh-linh-kien,173875500,"Router Draytek 2927 Chính Hãng - Chịu tải lên đến +150 user.",4449000,4449000,0,0
TIKI,laptop-may-vi-tinh-linh-kien,66618283,"Màn hình Samsung LF22T350FHEXXV - Hàng Chính Hãng",2780000,2780000,0,0
TIKI,laptop-may-vi-tinh-linh-kien,51055877,"Bộ Vi Xử Lý CPU AMD Ryzen 5 3500 Processors - Hàng Chính Hãng",3990000,3990000,0,0
TIKI,laptop-may-vi-tinh-linh-kien,1403213,"Máy In Nhãn Đơn Năng Brother PT-D210 - Hàng Chính Hãng",1600000,1600000,0,0
TIKI,laptop-may-vi-tinh-linh-kien,25185524,"Box ổ cứng 2.5 inch chuẩn SATA trong suốt USB3.0 2129U3",183900,183900,0,0
TIKI,laptop-may-vi-tinh-linh-kien,177054801,"CPU máy tính Intel Core I5 10400F 2.9Ghz, 12MB Cache, Socket LGA1200 - Hàng chính hãng",2790000,2790000,0,0
TIKI,laptop-may-vi-tinh-linh-kien,142369941,"Giấy in nhiệt dán k80 in đơn hàng sàn thương mại điện tử cho các máy in bill có khổ giấy 80mm",65000,65000,0,0
TIKI,laptop-may-vi-tinh-linh-kien,269955838,"MSI Laptop Văn phòng Modern 15 B7M-238VN|R7 7730U|Radeon|DDR4 16GB|512GB SSD|15.6" FHD, 60Hz [Hàng chính hãng]",16990000,16990000,0,0
TIKI,laptop-may-vi-tinh-linh-kien,113490241,"hộp mực 12a có lỗ đổ mực và lỗ đổ mực thảiDùng chung cho máy in 3000- 2900 và một số dòng 12A/ 303/ Fx9",115900,115900,0,0
TIKI,laptop-may-vi-tinh-linh-kien,116962250,"Bút Laser trình chiếu Baseus Orange Dot Wireless Presenter cho Laptop/ Macbook (100m. 2.4Ghz USB/Type C Receiver) -Hàng Chính Hãng",299899,299899,0,0
TIKI,laptop-may-vi-tinh-linh-kien,125361899,"Rode AI-1 - Sound Card Thu Âm 48V Cao Cấp, Nhỏ Gọn Cho Studio, Karaoke Trực Tuyến, Broadcast - Hàng Chính Hãng",3867000,3867000,0,0
TIKI,laptop-may-vi-tinh-linh-kien,171233559,"Chip sử dụng cho máy in Canon 251DW - 252DW",25000,25000,0,0
TIKI,laptop-may-vi-tinh-linh-kien,177639585,"Laptop CHUWI HeroBook Pro Intel Gemini Lake N4020 Intel UHD Graphics 600  8GB 256GB SSD 128GB TF Card - Hàng Chính Hãng",10390000,10390000,0,0
TIKI,laptop-may-vi-tinh-linh-kien,117095170,"Pin cho Laptop Asus X550 K550 X450 X550C X550CA X550CC A41-X550A X550D X550A K550C - Hàng Nhập Khẩu ",325000,375000,50000,13
TIKI,laptop-may-vi-tinh-linh-kien,123602656,"bo chính dành cho 43UH610",686000,686000,0,0
TIKI,laptop-may-vi-tinh-linh-kien,124486000,"Màn hình Gaming Gigabyte G24F-EK (23.8inch/FHD/IPS/165Hz/1ms) - Hàng Chính Hãng",3690000,3690000,0,0
TIKI,laptop-may-vi-tinh-linh-kien,192295553,"Ổ cứng di động WD Black P50 Game Drive SSD Hàng Chính Hãng",5390000,5390000,0,0
TIKI,laptop-may-vi-tinh-linh-kien,186139798,"Laptop HP Victus 16-d0293TX 5Z9R4PA (i5-11400H|512GB|3050Ti 4GB|16.1' FHD 144Hz) Hàng chính hãng",27990000,27990000,0,0
TIKI,laptop-may-vi-tinh-linh-kien,12222090,"Mực in phun Thuận Phong TP50 (1L) dùng cho tất cả các dòng máy in phun Epson, HP, Canon",190000,190000,0,0
TIKI,laptop-may-vi-tinh-linh-kien,10697849,"TotoLink N150UA - USB Wi-Fi Chuẩn N 150Mbps - Hàng Chính Hãng",136000,136000,0,0
TIKI,laptop-may-vi-tinh-linh-kien,512710,"Bộ Chia Mạng Switch 5-Cổng 10/100Mbps Với 4 Cổng PoE Tenda TEF1105P - Hàng Chính Hãng",540000,540000,0,0
TIKI,laptop-may-vi-tinh-linh-kien,117334362,"Pin Laptop  DÀNH CHO LENOVO G480 - 6 CELL - IdeaPad B430 B480 B485 B580 B585 G400 G410 G480 G485 G505 G510 G580 G585 V480 IdeaPad",364998,364998,0,0
TIKI,laptop-may-vi-tinh-linh-kien,217767128,"Hộp mực máy in Brother HL L2321D (hàng nhập khẩu) dùng cho máy HL L2366DW, L2320D, L2520D, L2701dw, L2360 - TN2325 - TN2385",130000,130000,0,0
TIKI,laptop-may-vi-tinh-linh-kien,57268501,"Màn Hình Chuyên Đồ Họa Asus ProArt PA248QV 24.1inch WUXGA 5ms 75Hz IPS - Hàng Chính Hãng",5380000,5380000,0,0
TIKI,laptop-may-vi-tinh-linh-kien,170132361,"Pin dành cho Laptop HP Pavilion 15-cs Series 15-cs2060TX 15-cs3116TX 15-cs3119TX 15-cs3061TX 15-cs3060TX 15-cs3063TX",699000,699000,0,0
TIKI,laptop-may-vi-tinh-linh-kien,56315831,"Pin thay thế dành cho Laptop Dell Inspiron N4110",649995,649995,0,0
TIKI,laptop-may-vi-tinh-linh-kien,177455788,"Laptop Lenovo ThinkPad E14 Gen 2 20TA00JJVN (Core i5-1135G7/ 8 GB, DDR4, 3200 MHz/ 512GB SSD/ 14 FHD IPS/ Win11) - Hàng Chính Hãng",19990000,19990000,0,0
TIKI,laptop-may-vi-tinh-linh-kien,117094609,"Pin dành cho Laptop HP Pavilion 14-ce1008TU 14-ce1009TU - HT03XL - Hàng Nhập Khẩu ",789000,839000,50000,6
TIKI,laptop-may-vi-tinh-linh-kien,71210326,"Gạt mực (gạt Drum) dùng cho máy photocopy Toshiba E 163, 303, 230, 280, 283, 255, 355, 455, 456, 456, 357, 457",60000,60000,0,0
TIKI,laptop-may-vi-tinh-linh-kien,91256590,"Máy in phun màu đa năng Brother DCP-T520W - Hàng chính hãng",5100000,5100000,0,0
TIKI,laptop-may-vi-tinh-linh-kien,185999717,"Bàn Phím dành cho HP EliteBook Folio 9470M 9470 9480 9480M - Hàng Nhập Khẩu CÓ ĐÈN - THƯỜNG - MỚI 100% -  - CÓ ĐÈN",257000,307000,50000,16
TIKI,laptop-may-vi-tinh-linh-kien,3045259,"Cuộn dây cáp mạng LB-LINK Cat6 UTP CCA 305m dây màu trắng - Hàng Chính Hãng",570000,570000,0,0
TIKI,laptop-may-vi-tinh-linh-kien,247839969,"Ram DDR4 Laptop GSkill 8G/3200 Không Tản Nhiệt (F4-3200C22S-8GRS)-- Hàng Chính Hãng",790000,790000,0,0
TIKI,laptop-may-vi-tinh-linh-kien,20121691,"RAM Laptop G.Skill 8GB (8GBx1) DDR4 F4-2400C16S-8GRS - Hàng Chính Hãng",690000,690000,0,0
TIKI,laptop-may-vi-tinh-linh-kien,19392563,"Modul ổ cắm mạng LAN Cat5 (lắp ổ cắm âm sàn, âm tường)",45000,45000,0,0
TIKI,laptop-may-vi-tinh-linh-kien,155696116,"Giáy in nhiệt màu cho tất cả dòng máy in minii",18000,18000,0,0
TIKI,laptop-may-vi-tinh-linh-kien,125432684,"Sạc Dành Cho Microsoft Surface Pro 3 4 5 6 7 model sạc 1625 1724 1796 1800 1706 1736 - Kèm Dây nguồn - Hàng Nhập Khẩu",889000,939000,50000,5
TIKI,laptop-may-vi-tinh-linh-kien,124478227,"Bàn phím dành cho Laptop Asus K43 K43E K43S, K43SJ, K43SD, K43SV",224995,224995,0,0
TIKI,laptop-may-vi-tinh-linh-kien,79709165,"Sạc dành cho Laptop HP Spectre X360 13-ac Series - USB-C Type-C",549995,549995,0,0
TIKI,laptop-may-vi-tinh-linh-kien,125433025,"Sạc cho Laptop Fujitsu Lifebook U747 U748 U749 U757 U758 U759 U772 U904 U937 U938 - Kèm Dây nguồn - Hàng Nhập Khẩu",324900,344900,20000,6
TIKI,laptop-may-vi-tinh-linh-kien,117094963,"Pin dành cho Laptop Sony Vaio SVF14 Series - Hàng Nhập Khẩu ",340000,390000,50000,13
TIKI,laptop-may-vi-tinh-linh-kien,170144055,"Sạc dành cho Laptop Gaming MSI GL65 9SDK-254VN, 9SDK-054VN, 9SD-027, GL65 9SDK-025, GL65 9SDK-026, GL65 9SDK-034",850000,850000,0,0
TIKI,laptop-may-vi-tinh-linh-kien,37408608," Tủ Mạng, Tủ Rack 15U Để Đất Mẫu C– TMC RACK 19",2350000,2350000,0,0
TIKI,laptop-may-vi-tinh-linh-kien,188045300,"Quạt tản nhiệt Flydigi B5  - Thiết bị hạ nhiệt dành cho điện thoại với công nghệ ép xung FlyOC hiện đại - Hàng nhập khẩu",549000,658900,109900,17
TIKI,laptop-may-vi-tinh-linh-kien,185998782,"Bàn Phím dành cho Laptop Lenovo Thinkpad X200 X200S X201 X201i X201S - Hàng Nhập Khẩu",660000,710000,50000,7
TIKI,laptop-may-vi-tinh-linh-kien,2045595,"Dây Cáp Mạng Ugreen CAT7 11271 (5m) - Hàng Chính Hãng",150000,150000,0,0
TIKI,laptop-may-vi-tinh-linh-kien,8010259,"Đầu đọc mã vạch Honeywell HH360 (1D, đọc mã vạch trên màn hình)- Hàng Nhập khẩu",1520000,1520000,0,0
TIKI,laptop-may-vi-tinh-linh-kien,179991779,"Bàn phím dành cho Laptop Asus K43 K43E K43S K43SJ K43SD K43SV - Hàng Nhập Khẩu ",400000,450000,50000,11
TIKI,laptop-may-vi-tinh-linh-kien,205837796,"Dây Mạng Cat6 SFTP Bọc Bạc Chống Nhiễu Golden Japan - Hàng Chính Hãng",85000,85000,0,0
TIKI,laptop-may-vi-tinh-linh-kien,13336446,"Keo Tản Nhiệt Hủ Xám ( Hủ Nhỏ)",5000,5400,400,7
TIKI,laptop-may-vi-tinh-linh-kien,56831652,"Pin dành cho Laptop Acer Travel Mate P643, P643-M, P643-V",339000,390000,51000,13
TIKI,laptop-may-vi-tinh-linh-kien,117095169,"Pin dành cho Laptop Asus X450CC X450LC - Hàng Nhập Khẩu ",355000,375000,20000,5
TIKI,laptop-may-vi-tinh-linh-kien,52089460,"Hộp mực PT 93A ( Hàng nhập khẩu )",480000,480000,0,0
TIKI,laptop-may-vi-tinh-linh-kien,125433225,"Sạc dành cho Laptop Toshiba Satellite L840 L845 L845D Adapter 19V-3.42A - Kèm Dây nguồn - Hàng Nhập Khẩu",186000,236000,50000,21
TIKI,laptop-may-vi-tinh-linh-kien,120463547,"USB Wifi có Anten tốc độ 150MBPS 802.11",44400,44400,0,0
TIKI,laptop-may-vi-tinh-linh-kien,222529881,"Laptop Asus ExpertBook B1400 - B1400CEAE-EK3724 (Chip Intel Core i5-1135G7 | RAM 8GB | SSD 256GB NVMe | 14' Full HD | Bảo mật vân tay | Bảo mật TPM 2.0 | Độ bền chuẩn quân đội US) - Hàng Chính Hãng",14590000,19500000,4910000,25
TIKI,laptop-may-vi-tinh-linh-kien,112056739,"Màn hình ViewSonic VX2780-2K-SHDJ 27inch 2K IPS - Hàng Chính Hãng",5650000,5650000,0,0
TIKI,laptop-may-vi-tinh-linh-kien,191691771,"Ổ cứng gắn trong SSD Samsung 970 Evo Plus PCIe Gen3 x4 NVMe M2 2280 - Hàng Chính Hãng",1990000,2280000,290000,13
TIKI,laptop-may-vi-tinh-linh-kien,189466548,"Laptop HP 15s-fq2663TU 6K796PA (i3-1115G4/4GB/256GB SSD/15.6/ VGA ON/ Win11/ Silver)-Hàng Chính Hãng",10200000,10200000,0,0
TIKI,laptop-may-vi-tinh-linh-kien,177631977,"Laptop LarkBook Intel Gemini-Lake N4120 Intel UHD Graphics 600 13.3 inch  8GB 256GB SSD 1*extra SS Up to 1T SSD - Hàng Chính Hãng",10590000,10590000,0,0
TIKI,laptop-may-vi-tinh-linh-kien,177614108,"Laptop GemiBook Pro Intel Celeron Processor N5100  Intel UHD Graphics 600 14.0 inch 8GB 256GB SSD Max 1TB SSD  - Hàng chính hãng",10990000,10990000,0,0
TIKI,laptop-may-vi-tinh-linh-kien,137153723,"Infinity Revenge Pro – Workstation Silent Chassis _ HÀNG CHÍNH HÃNG",1660000,1660000,0,0
TIKI,laptop-may-vi-tinh-linh-kien,56635879,"Quạt Tản Nhiệt Brushless 12V Tốc Độ Cao 9x9x2.5cm 0.3A",25000,25000,0,0
TIKI,laptop-may-vi-tinh-linh-kien,38220591,"CPU Intel Core i7-9700 (8C/8T, 3.00 GHz up to 4.70 GHz, 12MB) - 1151-V2 - Hàng chính hãng",6300000,6300000,0,0
TIKI,laptop-may-vi-tinh-linh-kien,1406949,"Ổ Đĩa Rời Đọc Và Ghi CD/DVD Transcend TS8X DVDS-K - Hàng Chính Hãng",899000,939000,40000,4
TIKI,laptop-may-vi-tinh-linh-kien,108423866,"Màn hình Asus ProArt PA247CV (23.8inch/FHD/IPS/75Hz/5ms) - Hàng Chính Hãng",5990000,5990000,0,0
TIKI,laptop-may-vi-tinh-linh-kien,67709452,"Bộ dụng cụ làm mạng đa năng AMPCOM  AM-5688A ( 14 in 1) - Hàng chính hãng",999000,1410000,411000,29
TIKI,laptop-may-vi-tinh-linh-kien,184627417,"Máy tính xách tay Lenovo IdeaPad Gaming 3 R5-5600H | 8GB | 512GB | RTX 3050 - Hàng chính hãng",18490000,18490000,0,0
TIKI,laptop-may-vi-tinh-linh-kien,74686383,"Bộ vi xử lý AMD Ryzen 9 5950X Desktop Processors - Hàng Chính Hãng",21686000,21686000,0,0
TIKI,laptop-may-vi-tinh-linh-kien,174012259,"Router MikroTik RB750Gr3 Hàng Chính Hãng - Cân bằng tải 100 thiết bị",1649000,1820000,171000,9
TIKI,laptop-may-vi-tinh-linh-kien,87942548,"Màn Hình MSI PRO MP242 23.8"/FHD/IPS/75Hz/5ms/Loa 2x2W - Hàng Chính Hãng",3990000,3990000,0,0
TIKI,laptop-may-vi-tinh-linh-kien,113634242,"Màn hình Samsung LS27A700NWEXXV UHD 4k  (3840 x 2160) HDR10 /60HZ - Hàng chính hãng",7800000,7800000,0,0
TIKI,laptop-may-vi-tinh-linh-kien,273355824,"Quạt CPU Led lõi đồng Coolmoon 11X for Intell - hàng nhập khẩu",166250,175000,8750,5
TIKI,laptop-may-vi-tinh-linh-kien,179539764,"Hộp đựng ổ cứng 3.5" ORICO 3588US3- Hàng chính hãng",450000,450000,0,0
TIKI,laptop-may-vi-tinh-linh-kien,158844110,"Card màn hình MSI RX 6600 XT MECH 2X 8G OC/OCV1 - Hàng Chính Hãng",9086000,9086000,0,0
TIKI,laptop-may-vi-tinh-linh-kien,26053906,"Bộ Vi Xử Lý CPU AMD Ryzen Processors 3 3200G - Hàng Chính Hãng",2890000,2890000,0,0
TIKI,laptop-may-vi-tinh-linh-kien,67982880,"LapTop Lenovo V14 IIL - 82C400W3VN | Intel Core i5 _ 1035G1 | 4GB | 256GB SSD PCIe | VGA INTEL  | 14 inch HD | FreeDos | Hàng Chính Hãng",9850000,9850000,0,0
TIKI,laptop-may-vi-tinh-linh-kien,155255883,"Ổ Cứng HDD WD Red Plus 6TB 3.5 inch SATA iii - Hàng Nhập Khẩu",4829000,6146000,1317000,21
TIKI,laptop-may-vi-tinh-linh-kien,23701634,"Quạt Tản Nhiệt Coolmoon V2 RGB - Hàng nhập khẩu",81000,81000,0,0
TIKI,laptop-may-vi-tinh-linh-kien,34673793,"Quạt tản nhiệt CPU Coolmoon UFO - Hàng nhập khẩu",165000,165000,0,0
TIKI,laptop-may-vi-tinh-linh-kien,87007373,"Màn Hình MSI Optix G241V 75Hz (24 inch, 1920 x 1080, 75Hz, IPS, 4ms) - Hàng Chính Hãng",3950000,3950000,0,0
TIKI,laptop-may-vi-tinh-linh-kien,61027361,"Máy chiếu Projector mini đa năng (Độ nét cao) phù hợp phòng ánh sáng yếu - Thunder",2900000,2900000,0,0
TIKI,laptop-may-vi-tinh-linh-kien,59502552,"Máy in laser đen trắng đa chức năng HP 135A - 4ZB82A - Hàng Chính Hãng",3390000,3390000,0,0
TIKI,laptop-may-vi-tinh-linh-kien,60715918,"Dây cáp mạng 2 đầu đúc sẵn Cat6 UTP UGREEN NW102 - Hàng chính hãng",70000,70000,0,0
TIKI,laptop-may-vi-tinh-linh-kien,56719923,"Quạt tản nhiệt, Fan Case Led RGB Coolmoon V5 - Hàng Chính Hãng",85000,85000,0,0
TIKI,laptop-may-vi-tinh-linh-kien,161225920,"Laptop HP 14s-cf2527TU 4K4A1PA (Core i3-10110U/ 4GB/ 256GB/ 14 HD/ Win11) - Hàng Chính Hãng",11196000,11196000,0,0
TIKI,laptop-may-vi-tinh-linh-kien,88050388,"Thanh Led RGB Aorus Rog đồng bộ Hub , Dùng độ trang trí cho VGA máy tính - hàng nhập khẩu",120000,120000,0,0
TIKI,laptop-may-vi-tinh-linh-kien,102641852,"Màn Hình Dell 27" S2721HN - Hàng Chính Hãng",4550000,4550000,0,0
TIKI,laptop-may-vi-tinh-linh-kien,185024003,"Card màn hình VGA MSI GeForce GT730 2GB 64bit DDR3 LPV1  - Hàng Chính Hãng",1550000,1550000,0,0
TIKI,laptop-may-vi-tinh-linh-kien,79768612,"Ổ Cứng gắn trong SSD Samsung 980 Pro 2TB M2 PCIe 4.0 - Hàng Nhập Khẩu",4455000,5810000,1355000,23
TIKI,laptop-may-vi-tinh-linh-kien,561879,"Kaspersky Internet Security Cho 1 Máy Tính - KIS1U - Hàng chính hãng",279000,279000,0,0
TIKI,laptop-may-vi-tinh-linh-kien,114211157,"Máy In Laser Màu Đơn Năng BROTHER HL-L8360CDW - Hàng Chính Hãng",10450000,10450000,0,0
TIKI,laptop-may-vi-tinh-linh-kien,53057754,"Máy tính để bàn Viettech đáp ứng tốt nhất cho Văn phòng và Học tập - Hàng nhập khẩu",2190000,2190000,0,0
TIKI,laptop-may-vi-tinh-linh-kien,134947044,"Laptop Dell Vostro 3400 70253900 (Core i5-1135G7/ 8GB/ 256GB SSD/ 14 FHD/ Win 11 + Office) - Hàng Chính Hãng",13850000,13850000,0,0
TIKI,laptop-may-vi-tinh-linh-kien,459248,"Máy In Laser Đa Năng Brother MFC-L2701D - Hàng chính hãng",5700000,5700000,0,0
TIKI,laptop-may-vi-tinh-linh-kien,28057130,"Card màn hình ZOTAC GAMING GeForce GTX 1650 AMP - HÀNG CHÍNH HÃNG",4970000,4970000,0,0
TIKI,laptop-may-vi-tinh-linh-kien,9794165,"Máy In Canon Selphy CP1300 (Trắng) - Hàng Chính Hãng",3680000,3680000,0,0
TIKI,laptop-may-vi-tinh-linh-kien,193549202,"máy in bluetooth A4-A5 cầm tay kết nối được tất cả các dòng điện thoại-latop-pc-máy tính bảng androi và ios pin lithium 30000 mah cổng sạc typec tốc độ in nhanh 20 tờ/1p nhỏ gọn tiện lợi dễ dàng mang đi sử dụng không cần đến nguồn điện 220v mực lưu 10 năm",1176000,2400000,1224000,51
TIKI,laptop-may-vi-tinh-linh-kien,197192611,"Màn hình Samsung LS34J550WQEXXV 34 inch/ 2K/ VA/ 75Hz/ 4ms/ 300 nits/ HDMI+DP/ FreeSync - Hàng Chính Hãng",8250000,8250000,0,0
TIKI,laptop-may-vi-tinh-linh-kien,11864859," Máy Chiếu Mini YG-300 Smart LED Độ Phân Giải 1920×1080",783750,825000,41250,5
TIKI,laptop-may-vi-tinh-linh-kien,156188433,"Bộ máy tính để bàn Vlimited chơi game trọn độ đầy đủ  Case/8G/SSD/HDD/Vga rời/Màn hình - Hàng chính hãng",4450000,4450000,0,0
TIKI,laptop-may-vi-tinh-linh-kien,183262949,"Máy Chủ Server - Hàng nhập khẩu",3500000,3500000,0,0
TIKI,laptop-may-vi-tinh-linh-kien,51521510,"DrayTek Vigor2926 Hàng Chính Hãng",3720000,3720000,0,0
TIKI,laptop-may-vi-tinh-linh-kien,46183198,"Máy chiếu i-Projector chất lượng 1080P độ nét cao - Hàng nhập khẩu",4500000,4500000,0,0
TIKI,laptop-may-vi-tinh-linh-kien,188007796,"[HÀNG CHÍNH HÃNG] Combo Máy in laser đơn sắc Brother HL-L2321D và 2 Mực in laser trắng đen Brother TN-2385",4144000,4144000,0,0
TIKI,laptop-may-vi-tinh-linh-kien,112499909,"Máy in laser đen trắng Brother HL-B2080DW - Hàng chính hãng",4850000,4850000,0,0
TIKI,laptop-may-vi-tinh-linh-kien,452118,"Ổ cứng Di Động Transcend StoreJet H3B 1TB USB 3.0/3.1 - TS1TSJ25H3B - Hàng Chính Hãng",1959000,1959000,0,0
TIKI,laptop-may-vi-tinh-linh-kien,13758732,"Bàn Vẽ Màn Hình Tinh Thể Lỏng Kĩ Thuật Số Gaomon GM185 - Hàng nhập khẩu",6700000,6700000,0,0
TIKI,laptop-may-vi-tinh-linh-kien,44003475,"Quạt tản nhiệt CPU Jonsbo CR1200 - Hàng nhập khẩu",230000,230000,0,0
TIKI,laptop-may-vi-tinh-linh-kien,3920565,"Ổ cứng SSD Western Digital Blue 3D-NAND M.2 2280 SATA III 500GB WDS500G2B0B - Hàng Chính Hãng",1650000,1650000,0,0
TIKI,laptop-may-vi-tinh-linh-kien,102901250,"Sạc dành cho Laptop Dell (Các loại) 19.5V 3.34A 65W - chân kim nhỏ ",189000,189000,0,0
TIKI,laptop-may-vi-tinh-linh-kien,50086320,"Màn Hình Gaming Samsung LS27R350FHEXXV 27 inch FullHD 5ms 75Hz IPS - Hàng Chính Hãng",3490000,3490000,0,0
TIKI,laptop-may-vi-tinh-linh-kien,169039064,"Router Wifi 6 Asus RT-AX1800HP MU-MIMO AiMesh AX1800Mbps (Xuyên tường) - Hàng Chính Hãng",1450000,1450000,0,0
TIKI,laptop-may-vi-tinh-linh-kien,157078205,"Màn hình LG 27MP400-B (27inch/FHD/IPS/75hz/5ms/250nits/HDMI+Dsub/Freesync) -Hàng Chính Hãng",3190000,3190000,0,0
TIKI,laptop-may-vi-tinh-linh-kien,179539811,"Card mở rộng ổ cứng SSD M.2 qua khe PCI-E 3.0 X16 Orico PSM2-X16 - Hàng chính hãng",133000,133000,0,0
TIKI,laptop-may-vi-tinh-linh-kien,80983401,"Két nước tản nhiệt 8cm kèm quạt gió 12V",195000,195000,0,0
TIKI,laptop-may-vi-tinh-linh-kien,142656943,"Card màn hình VGA Asus GT730-SL-2GD5 BRK - Hàng Chính Hãng",1490000,1490000,0,0
TIKI,laptop-may-vi-tinh-linh-kien,87959768,"USB Phát Wifi 4G LTE U80 – Tốc Độ 150Mb – Kết Nối 10 User",519000,519000,0,0
TIKI,laptop-may-vi-tinh-linh-kien,81222214,"Bộ phát Wifi 4G Netgear Aircard AC800S - Cat9 - tốc độ 450Mbps - Phiên Bản Quốc Tế - hàng chính hãng",1980000,1980000,0,0
TIKI,laptop-may-vi-tinh-linh-kien,101778693,"Màn hình LCD LG 27MP60G-B.ATV 27inch FullHD 5ms 75Hz IPS - Hàng Chính Hãng",3645000,3645000,0,0
TIKI,laptop-may-vi-tinh-linh-kien,161266256,"Nhân mạng, hạt ổ cắm cat5 cat6 âm tường lắp mặt âm tường chuẩn WIDE (hạt to) dành cho mặt Panasonic",66000,66000,0,0
TIKI,laptop-may-vi-tinh-linh-kien,164494570,"Ram máy tính ddr4 Asgard V5 8gb Bus 3200 RGB Sync- Hàng chính hãng",1000000,1000000,0,0
TIKI,laptop-may-vi-tinh-linh-kien,125893668,"Gaming Router Wifi Băng Tần Kép ASUS RT-AX53U AX1800 MU-MIMO AiProtection- Hàng Chính Hãng",1320000,1320000,0,0
TIKI,laptop-may-vi-tinh-linh-kien,108843366,"Tp-Link MR100 | Router Wi-Fi 4G LTE Chuẩn N Tốc Độ 300 Mbps | Hàng Chính Hãng",1005000,1005000,0,0
TIKI,laptop-may-vi-tinh-linh-kien,126091177,"Anten thu sóng 3g/4g của thiết bị Netgear- Hàng Chính Hãng ",99000,99000,0,0
TIKI,laptop-may-vi-tinh-linh-kien,34497832,"Máy in nhiệt - in hóa đơn ( bill) Xprinter -N160I LAN - Hàng chính hãng",1089000,1089000,0,0
TIKI,laptop-may-vi-tinh-linh-kien,171729035,"Màn hình Dell P2423D 23.8 inch 2K IPS 60Hz - Hàng Chính Hãng",6490000,6490000,0,0
TIKI,laptop-may-vi-tinh-linh-kien,78629390,"Quạt tản nhiệt Case Xigmatek X20F (EN45457) - Led RGB CIRCLE - Hàng chính hãng",99000,99000,0,0
TIKI,laptop-may-vi-tinh-linh-kien,189941565,"PC All In One MCC 4541P19 CPU G4560, 4GB DDR4, 120GB SSD, 19" HD+, WIFI, BLUETOOTH, MIC, CAMERA 3.1Mpx - Hàng chính hãng",9900000,9900000,0,0
TIKI,laptop-may-vi-tinh-linh-kien,195687591,"Ổ ĐĨA DVD RW CẮM NGOÀI CHO LATOP DESTOP OS  ĐỜI MỚI 3.0 Hỗ trợ cổng Type C",350000,350000,0,0
TIKI,laptop-may-vi-tinh-linh-kien,194479968,"Màn Hình LG UltraGear 27GQ50F-B 27 inch FullHD 1ms 165Hz VA - Hàng Chính Hãng",3800000,4990000,1190000,24
TIKI,laptop-may-vi-tinh-linh-kien,3044703,"Màn Hình BenQ Zowie XL2411P 24inch Full HD 1ms 144Hz TN - Hàng Chính Hãng",7546000,7546000,0,0
TIKI,laptop-may-vi-tinh-linh-kien,178713835,"Card mạng PCIe WiFi 6 ASUS PCE-AX3000 Chuẩn AX3000 (No Box) - Hàng chính hãng",698000,698000,0,0
TIKI,laptop-may-vi-tinh-linh-kien,22050384,"Bo Mạch Chủ Mainboard ASUS PRIME H310M-K Intel LGA-1151 mATX DDR4 2666MHz - Hàng Chính Hãng",1590000,1590000,0,0
TIKI,laptop-may-vi-tinh-linh-kien,7239205,"Bộ lưu điện UPS CyberPower BU600 600VA/360W - Hàng Chính Hãng",750000,750000,0,0
TIKI,laptop-may-vi-tinh-linh-kien,52161959,"Màn Hình Viewsonic VA2223-H 22 inch Full HD - Hàng Chính Hãng",2150000,2150000,0,0
TIKI,laptop-may-vi-tinh-linh-kien,208120476,"MÀN CHIẾU ĐIỆN TỬ TREO TƯỜNG TỰ ĐỘNG 136 INCH - 2,44M X 2,44M - P96ES HÀNG NHẬP KHẨU",1550000,1550000,0,0
TIKI,laptop-may-vi-tinh-linh-kien,98051315,"Máy POS cầm tay SP01 - Hàng nhập khẩu ",2700000,2700000,0,0
TIKI,laptop-may-vi-tinh-linh-kien,106318753,"Máy tính xách tay Laptop Dell Latitude 3420 (Intel Core i5-1135G7 | 14 Inch | RAM 8GB | 256GB SSD NVMe | Intel Iris Xe Graphics | Fedora Os) - Hàng chính hãng",14590000,19900000,5310000,27
TIKI,laptop-may-vi-tinh-linh-kien,132893952,"Máy chiếu thông minh XGIMI Horizon (Bản Quốc Tế) - Hàng chính hãng",30999000,30999000,0,0
TIKI,laptop-may-vi-tinh-linh-kien,192295100,"Ổ cứng di động WD Black D10 12TB Game Drive For Xbox (Desktop) Hàng Chính Hãng",15000000,15000000,0,0
TIKI,laptop-may-vi-tinh-linh-kien,70985791,"Card màn hình MSI GeForce GTX 1650 D6 VENTUS XS OC 4GB GDDR6 - Hàng Chính Hãng",5810000,5810000,0,0
TIKI,laptop-may-vi-tinh-linh-kien,186755051,"Bộ Chuyển Đổi Quang Điện 3100 AB 25KM - Converter Quang",171000,180000,9000,5
TIKI,laptop-may-vi-tinh-linh-kien,129937282,"Hệ Thống MESH WI-FI 6 ASUS XT8 (W-2-PK) ZenWiFi Chuẩn AX6600 3 Băng Tần- Hàng Chính Hãng",11500000,11500000,0,0
TIKI,laptop-may-vi-tinh-linh-kien,53048871,"Máy tính để bàn chuyên GAME Viettech Core i5 4570, Ram 8gb, SSD 120+ HDD 500gb - Hàng Nhập Khẩu",2950000,2950000,0,0
TIKI,laptop-may-vi-tinh-linh-kien,192199747,"Thiết bị lưu trữ mạng WD My Cloud PR2100 Hàng Chính Hãng",16680000,16680000,0,0
TIKI,laptop-may-vi-tinh-linh-kien,161165433,"Laptop HP Victus 16-d0199TX 4R0U1PA (Core i7-11800H/ 8GB/ 512GB + 32GB/ RTX 3050/ 16.1 FHD, 144Hz/ Win10) - Hàng Chính Hãng",41772000,41772000,0,0
TIKI,laptop-may-vi-tinh-linh-kien,22403604,"Card chuyển đổi PCI-Express 7 Port USB 3.0 cho máy tính bàn ORICO PVU3-502I (Đen)- Hàng nhập khẩu",699000,750000,51000,7
TIKI,laptop-may-vi-tinh-linh-kien,185654769,"Bộ PC All In One MCC 3341P19 CPU Core i3 Processor, 4GB, 120GB SSD, WIFI, 19" - Hàng chính hãng",7900000,7900000,0,0
TIKI,laptop-may-vi-tinh-linh-kien,178100133,"Cáp quang treo 1FO( cuộn 1000m) giá chưa vat",700000,700000,0,0
TIKI,laptop-may-vi-tinh-linh-kien,136676515,"Máy in HP LaserJet M211d (9YF82A) - Hàng Chính Hãng",3090000,3090000,0,0
TIKI,laptop-may-vi-tinh-linh-kien,31129176,"Máy Tính Dell Optiplex 9020, Hàng Nhập Khẩu",1990000,1990000,0,0
TIKI,laptop-may-vi-tinh-linh-kien,55472283,"Quạt tản nhiệt điện thoại FL01",109000,129000,20000,0
TIKI,laptop-may-vi-tinh-linh-kien,72758004,"CPU AMD Ryzen 7 5800X (8C/16T, 3.80 GHz - 4.70 GHz, 32MB) - AM4 - Hàng Chính Hãng",9660000,9660000,0,0
TIKI,laptop-may-vi-tinh-linh-kien,91272143,"Máy in phun màu đa năng Brother DCP-T820DW - Hàng chính hãng",6500000,6500000,0,0
TIKI,laptop-may-vi-tinh-linh-kien,117196258,"Đèn treo màn hình bảo vệ mắt Baseus i-Work Series (3 Light Mode, Anti Bluelight, USB Stepless Dimming Screen Hanging Light, New Model) - Hàng chính hãng - Đen",525000,539000,14000,3
TIKI,laptop-may-vi-tinh-linh-kien,167150431,"Ổ cứng HDD Seagate IronWolf 2TB ST2000VN004 3.5 inch, 5900RPM, SATA, 64MB Cache - Hàng chính hãng",2990000,2990000,0,0
TIKI,laptop-may-vi-tinh-linh-kien,172827045,"Bo Mạch Chủ Mainboard ASRock B660 Steel Legend - Hàng Chính Hãng",6090000,6090000,0,0
TIKI,laptop-may-vi-tinh-linh-kien,931617,"Bộ Phát Wifi Di Động 4G LTE 150Mbps Tenda 4G180 - Hàng Chính Hãng",980000,980000,0,0
TIKI,laptop-may-vi-tinh-linh-kien,155879762,"VỎ CASE Infinity Raven – Mid Tower Case_ HÀNG CHÍNH HÃNG",440000,440000,0,0
TIKI,laptop-may-vi-tinh-linh-kien,196410736,"[HÀNG CHÍNH HÃNG] Máy in phun màu đa năng Brother DCP-T426W",4275000,4275000,0,0
TIKI,laptop-may-vi-tinh-linh-kien,13365882,"MÁY IN LASER MÀU ĐA NĂNG KHÔNG FAX SILICOM DCP-L3551CDW - Hàng chính hãng",10000000,10000000,0,0
TIKI,laptop-may-vi-tinh-linh-kien,130861299,"( Sản phẩm mới ) Sound Card V8S Có Bluetooth, Pin Sạc – Thu Âm Hát Livestream Karaoke - Tăng độ nhạy của Micro Không có",197000,197000,0,0
TIKI,laptop-may-vi-tinh-linh-kien,30008379,"Bo Mạch Chủ Mainboard ASUS Prime A320M-K - Hàng Chính Hãng",1550000,1550000,0,0
TIKI,laptop-may-vi-tinh-linh-kien,191426395,"Màn hình Dahua DHI-LM22-B200 (22 inch/FHD/IPS/60Hz/6ms/200nits/HDMI+VGA+Audio)- Hàng chính hãng",2200000,2200000,0,0
TIKI,laptop-may-vi-tinh-linh-kien,173712052,"Màn hình LCD Dell Ultrasharp U2422H 23.8 inch FHD chuyên đồ họa - Hàng Chính Hãng",7050000,7050000,0,0
TIKI,laptop-may-vi-tinh-linh-kien,90522993,"Vỏ Case Máy Tính Golden Field N27W (RGB, Vách Mica) - Hàng Chính Hãng ",650000,650000,0,0
TIKI,laptop-may-vi-tinh-linh-kien,26687072,"Máy Quét Tài Liệu iScan Mini Cầm Tay Định Dạng JPG Và PDF",967100,1018000,50900,5
TIKI,laptop-may-vi-tinh-linh-kien,102106715,"Quạt Tản Nhiệt Sunon 9X9X2.5CM 12VDC - 2.6W",28000,28000,0,0
TIKI,laptop-may-vi-tinh-linh-kien,29172843,"Box Chuyển SSD M2 Sata Sang Ổ Cứng Di Động SSK SHE-C320 Chuẩn 3.0 Hỗ Trợ Đến 5Gbps  - Hàng Nhập Khẩu",239000,239000,0,0
TIKI,laptop-may-vi-tinh-linh-kien,28054671,"Card Màn Hình VGA ASUS DUAL-RTX2060-O6G-EVO GDDR6 6GB 192-bit - Hàng Chính Hãng",8946000,8946000,0,0
TIKI,laptop-may-vi-tinh-linh-kien,13566317,"Máy in nhãn để bàn Brother PT-D450  - Hàng chính hãng",3200000,3200000,0,0
TIKI,laptop-may-vi-tinh-linh-kien,33743308,"Máy in di động APOS P100 - Hàng chính hãng",1350000,1350000,0,0
TIKI,laptop-may-vi-tinh-linh-kien,464218,"Máy In Phun Màu Canon PIXMA IX6770 Chính Hãng Lê Bảo Minh",5880000,5880000,0,0
TIKI,laptop-may-vi-tinh-linh-kien,79679876,"Màn chiếu xem phim Luxury 3 size - Best Seller Tony",350000,350000,0,0
TIKI,giay-dep-nam,134652690,"Giày da nam, giày oxford công sở Bụi Leather G101 - Da bò Nappa cao cấp - Bảo hành 12 tháng",515000,840000,325000,39
TIKI,giay-dep-nam,274046223,"Giày thể thao nam / nữ phong cách mới – G1004A",420000,840000,420000,50
TIKI,giay-dep-nam,134708659,"Giày da nam, giày oxford công sở Bụi Leather G102 - Da bò Nappa cao cấp - Bảo hành 12 tháng",515000,650000,135000,21
TIKI,giay-dep-nam,257326416,"Keo Dán Giày Nhiệt XIMO Trong Suốt Siêu Dính Dùng Không Tổn Thương Da XKDG06",27000,35000,8000,23
TIKI,giay-dep-nam,136541078,"MUỖNG XỎ GIÀY PCASHL 001",99000,99000,0,0
TIKI,giay-dep-nam,134773001,"Giày lười da nam công sở Bụi Leather G107 - Da bò Nappa cao cấp",515000,827000,312000,38
TIKI,giay-dep-nam,248935826,"Giày thể thao nam - nữ phong cách dễ thương – GNU1018",450000,900000,450000,50
TIKI,giay-dep-nam,228132185,"Dép Nam Quai Ngang HÀ NAM Da Bò Thật Cao Cấp DNA2210",450000,450000,0,0
TIKI,giay-dep-nam,66619316,"Giày Thể Thao Nam Màu Đen, Sneaker Nam Màu Đen,  Đế Êm, Nhẹ Thoáng Khí S355",359000,450000,91000,20
TIKI,giay-dep-nam,67400635,"Dép bít mũi nam Trường Hải da bò cao cấp đế cao su màu nâu bò BM217",286000,329000,43000,13
TIKI,giay-dep-nam,44969160,"01 cặp lót giày thể thao 4D có gờ chống sốc giảm mỏi gang bàn chân - buybox - BBPK36",36000,70000,34000,49
TIKI,giay-dep-nam,14885304,"Tẩy trắng giày dép, túi xách - Đánh giày dép - Dung dịch đánh giày - Rửa giày dép - Chất tẩy đa năng",9399,9399,0,0
TIKI,giay-dep-nam,134739207,"Giày da nam, giày oxford công sở G103 - Da bò Nappa cao cấp",515000,841000,326000,39
TIKI,giay-dep-nam,43035743,"Lót giày tổ ong độn đế tăng chiều cao buybox BBPK57",72500,145000,72500,50
TIKI,giay-dep-nam,45224922,"Lót giày thể thao EVA êm chân có cấu trúc tổ ong thoáng khí buybox BBPK25",42500,85000,42500,50
TIKI,giay-dep-nam,186677573,"Dép Quai Ngang Nam Đúc Liền Quick Cao Cấp DP15",298000,298000,0,0
TIKI,giay-dep-nam,174385257,"GIÀY LƯỜI DA BÒ NAM CAO CẤP VATIS VA2022",359000,559000,200000,36
TIKI,giay-dep-nam,19677660,"Dép quai ngang nam da bò cao cấp Trường Hải QN075",306000,349000,43000,12
TIKI,giay-dep-nam,248092649,"Giày nam công sở da bò mũi nhọn Trường Hải đế cao su có hai màu đen , nâu GT445Đ",488000,550000,62000,11
TIKI,giay-dep-nam,49278142,"Xịt khử mùi giày ngăn ngừa vi khuẩn và ngăn mùi hôi, mùi khắm giày - buybox - PKBB61",86000,86000,0,0
TIKI,giay-dep-nam,13744574,"Combo 3 Lọ Nước Lau Giày, Tẩy Trắng Plac NT001.3",18000,24000,6000,25
TIKI,giay-dep-nam,143421590,"Giày nam sneaker thể thao cao cấp mẫu mới hot trend 2021(2 mầu)",60000,70000,10000,14
TIKI,giay-dep-nam,42920863,"Lót giày thể thao EVA biết thở có rãnh chịu lực và gel chống thốn gót buybox BBPK26",50000,85000,35000,41
TIKI,giay-dep-nam,72570436,"Dép Nam Quai Ngang Kẻ SUPERSTAR DP65",258000,258000,0,0
TIKI,giay-dep-nam,59056036,"Dép xỏ ngón nam nữ DUWA T405KG - Hàng chính hãng",64500,129000,64500,50
TIKI,giay-dep-nam,168953188,"Giày Lười Vải Cao Cấp Peace PO1228",269000,429000,160000,37
TIKI,giay-dep-nam,13098768,"Dép nam  quai ngang da bò bản lớn màu nâu Trường Hải DN046",280000,319000,39000,12
TIKI,giay-dep-nam,179497658,"Dép quai ngang nam thời trang,may full quai chắc chắn DONAVYPUMA",169000,300000,131000,44
TIKI,giay-dep-nam,174448862,"Giày Nam Pierre Cardin Loafer - PCMFWLF 516",2990000,2990000,0,0
TIKI,giay-dep-nam,107801997,"Lót Giày Thể Thao XIMO Siêu Êm Chân Thế Hế Mới LGTT24",25000,50000,25000,50
TIKI,giay-dep-nam,214504425,"Chai Xịt Tạo Bọt Vệ Sinh Giày XIMO Cao Cấp 300ml XVSG02",75000,110000,35000,32
TIKI,giay-dep-nam,72047658,"Giấy lau giày sneaker",46000,46000,0,0
TIKI,giay-dep-nam,85315634,"Dép Nam Quai Ngang, Dép nam Dòng OEKRB Laceva DP66",129000,129000,0,0
TIKI,giay-dep-nam,73842197,"Giày Tây Nam Công Sở Da Mềm, Đế Khâu, Cao 3.5cm Lê Sang",250000,250000,0,0
TIKI,giay-dep-nam,158693555,"Giày Nam Pierre Cardin - PCMFWLF 747",2990000,2990000,0,0
TIKI,giay-dep-nam,73746789,"Giày thể thao sneaker nam màu trắng bằng da không tróc thương hiệu ZAVAS - S387",349000,450000,101000,22
TIKI,giay-dep-nam,65778681,"Lót giày thể thao tổ ong EVA loại cao cấp đế dày 1.8cm đàn hồi cực êm chân, thoáng khí - buybox - BBPK128 - Đế vàng mặt đen - Size nam",29000,45000,16000,36
TIKI,giay-dep-nam,73628519,"Giày thể thao nam đế êm nhẹ thương hiệu ZAVAS thoáng khí đế cao su đúc, chống trơn trượt hạn chế mòn S390 - Hàng chính hãng",349000,450000,101000,22
TIKI,giay-dep-nam,134773001,"Giày lười da nam công sở Bụi Leather G107 - Da bò Nappa cao cấp",515000,827000,312000,38
TIKI,giay-dep-nam,95011333,"Dép Nam Nữ Quai Dù Thời Trang, Dép Đôi Quai Ngang  Chống Trơn DP69",119000,119000,0,0
TIKI,giay-dep-nam,191684851,"Giày nam công sở da bò nappa cao cấp, giày lười G114- Bụi leather- hộp sang trọng",599000,989000,390000,39
TIKI,giay-dep-nam,134775147,"Giày lười da nam công sở Bụi Leather G109 - Da bò Nappa cao cấp - Bảo hành 12 tháng - Màu đen + Bộ vệ sinh",595000,970000,375000,39
TIKI,giay-dep-nam,107801586,"Cặp Cây Giữ Form Giày XIMO CGFG01 Shoe Tree Tùy Chỉnh Size",20000,30000,10000,33
TIKI,giay-dep-nam,107801401,"Bàn chải đánh giày lông heo, lông ngựa & lông nhựa PP XIMO phiên bản cho giày vải sneaker (XBCDG17)",30000,60000,30000,50
TIKI,giay-dep-nam,46756039,"Giày thể thao nam lót thoáng khí đế cao su nguyên khôi, giày đi bộ, đi chơi, thể thao, gym G86",50400,90000,39600,44
TIKI,giay-dep-nam,13614868,"Chai xịt trắng giày plac kèm đầu cọ 100ml",6000,9000,3000,33
TIKI,giay-dep-nam,66620209,"Giày Thể Thao Nam, Giày Sneaker Nam Màu Trắng Đế Êm Nhẹ Thoáng Khí S361",229000,450000,221000,49
TIKI,giay-dep-nam,49077109,"Bộ dụng cụ đánh giày, bộ xi đánh giày 7 món tiện lợi",79000,79000,0,0
TIKI,giay-dep-nam,72842338,"Lót giày thể thao EVA có 6 đệm chống sốc êm chân và rãnh chịu lực - buybox - BBPK154",49400,52000,2600,5
TIKI,giay-dep-nam,73546672,"Lót giày thể thao EVA biết thở và có 2 đệm chịu lực hỗ trợ vận động thể thao - Đen phối xanh - buybox - BBPK155",47500,50000,2500,5
TIKI,giay-dep-nam,107801417,"Xi Kem Đánh Giày Chuyên Sửa Chữa Vết Bong Tróc Và Đánh Bóng Giày Da, Túi Ví, Áo, Ghế Da Ximo Leather Cream (50ml)",75000,110000,35000,32
TIKI,giay-dep-nam,125876830,"Chai Dung Dịch Vệ Sinh Giày Làm Sạch Chuyên Sâu Sneaker Prenium XIMO XI05",99000,150000,51000,34
TIKI,giay-dep-nam,111231648,"Giày sandal nam 3 quai. Quai hậu rời biến thành dép lê trong 1 nốt nhạc. Size từ 35 đến 43. Bốn màu sắc tha hồ lựa chọn",159000,159000,0,0
TIKI,giay-dep-nam,134739207,"Giày da nam, giày oxford công sở G103 - Da bò Nappa cao cấp",515000,841000,326000,39
TIKI,giay-dep-nam,76193509,"Giày Thể Thao Full Đen Tăng Chiều Cao Nam",223500,223500,0,0
TIKI,giay-dep-nam,134652690,"Giày da nam, giày oxford công sở Bụi Leather G101 - Da bò Nappa cao cấp - Bảo hành 12 tháng",515000,840000,325000,39
TIKI,giay-dep-nam,274046223,"Giày thể thao nam / nữ phong cách mới – G1004A",420000,840000,420000,50
TIKI,giay-dep-nam,134708659,"Giày da nam, giày oxford công sở Bụi Leather G102 - Da bò Nappa cao cấp - Bảo hành 12 tháng",515000,650000,135000,21
TIKI,giay-dep-nam,248935826,"Giày thể thao nam - nữ phong cách dễ thương – GNU1018",450000,900000,450000,50
TIKI,giay-dep-nam,13098768,"Dép nam  quai ngang da bò bản lớn màu nâu Trường Hải DN046",280000,319000,39000,12
TIKI,giay-dep-nam,115779836,"Xi kem đánh giày XIMO dưỡng và bổ sung màu cho da giày, túi ví, áo, ghế sofa XI02",72000,110000,38000,35
TIKI,giay-dep-nam,167653057,"Keo dán đa năng Super Glue Ximo S3000 dán vật liệu gỗ, sắt, gốm, sành, sứ, sắt, inbox an toàn da tay",50000,80000,30000,38
TIKI,giay-dep-nam,45474719,"Giày Tây Lười Nam Da Đẹp Công Sở Cao Cấp BT18",159000,159000,0,0
TIKI,giay-dep-nam,11507760,"Bộ Dây Giày Cao Su V-Laces Thế Hệ 2",23000,23000,0,0
TIKI,giay-dep-nam,73661201,"Giày thể thao nam đế êm nhẹ thương hiệu ZAVAS thoáng khí đế cao su đúc, chống trơn trượt hạn chế mòn S391 - Hàng chính hãng",349000,450000,101000,22
TIKI,giay-dep-nam,67400635,"Dép bít mũi nam Trường Hải da bò cao cấp đế cao su màu nâu bò BM217",286000,329000,43000,13
TIKI,giay-dep-nam,228132185,"Dép Nam Quai Ngang HÀ NAM Da Bò Thật Cao Cấp DNA2210",450000,450000,0,0
TIKI,giay-dep-nam,134775147,"Giày lười da nam công sở Bụi Leather G109 - Da bò Nappa cao cấp - Bảo hành 12 tháng - Màu đen + Bộ vệ sinh",595000,970000,375000,39
TIKI,giay-dep-nam,19677660,"Dép quai ngang nam da bò cao cấp Trường Hải QN075",306000,349000,43000,12
TIKI,giay-dep-nam,134739207,"Giày da nam, giày oxford công sở G103 - Da bò Nappa cao cấp",515000,841000,326000,39
TIKI,giay-dep-nam,159887971,"Giày đi biển bơi lội unisex Zoggs Walk Man and Lady - 466000",119000,169000,50000,30
TIKI,giay-dep-nam,81085626,"Giày Tây Nam Da Cao Cấp Sang Trọng",223500,223500,0,0
TIKI,giay-dep-nam,168789100,"Giày Bảo Hộ Lao Động 2TH Kiểu Dáng Thể Thao Mũi Thép, Đế Lót Thép BD0064- Chống Đinh/Trơn Trượt -Giày Công Trình",330000,500000,170000,34
TIKI,giay-dep-nam,180572538,"Túi Đựng Giày The Travel Star Shoes Bag Thương Hiệu Kakashi",109000,149000,40000,27
TIKI,giay-dep-nam,178999343,"Dép Bánh Mì Nam , Dép Bánh Mì Nữ , Dép Quai Ngang Nữ , Dép Nữ Thời Trang, Dép Nam quai ngang",66000,80000,14000,18
TIKI,giay-dep-nam,134773001,"Giày lười da nam công sở Bụi Leather G107 - Da bò Nappa cao cấp",515000,827000,312000,38
TIKI,giay-dep-nam,174385257,"GIÀY LƯỜI DA BÒ NAM CAO CẤP VATIS VA2022",359000,559000,200000,36
TIKI,giay-dep-nam,248092649,"Giày nam công sở da bò mũi nhọn Trường Hải đế cao su có hai màu đen , nâu GT445Đ",488000,550000,62000,11
TIKI,giay-dep-nam,51430313,"Giày Thể Thao Nam Có Đệm Khí Trợ Lực Êm Chân, Thoáng Khí - GN92",165000,165000,0,0
TIKI,giay-dep-nam,168953188,"Giày Lười Vải Cao Cấp Peace PO1228",269000,429000,160000,37
TIKI,giay-dep-nam,174468189,"Giày Nam Pierre Cardin Horsebit Loafer - PCMFWLF 517",2990000,2990000,0,0
TIKI,giay-dep-nam,127379903,"Giày Sneaker Da Nam DINCOX C13 Cách Điệu Sáng Tạo White/Black",530000,530000,0,0
TIKI,giay-dep-nam,138747323,"Khăn Giấy Ướt Lau Giày Sneaker Wipes Clean thần thánh(gói 30 miếng)",10000,25500,15500,61
TIKI,giay-dep-nam,73478101,"Giày sneaker thể thao nam buộc dây siêu nhẹ V266",69000,69000,0,0
TIKI,giay-dep-nam,73247696,"Giày lười nam Pierre Cardin PCMFWLE 706BLK",2490000,2490000,0,0
TIKI,giay-dep-nam,26666649,"Dép Nam BIGGBEN Da Bò Thật Cao Cấp DN196",299000,400000,101000,25
TIKI,giay-dep-nam,73750157,"Giày thể thao sneaker nam màu trắng bằng da không tróc thương hiệu ZAVAS - S387 - Hàng chính hãng",349000,450000,101000,22
TIKI,giay-dep-nam,170728587,"Chai xịt khử mùi giày dép công thức Nano Bạc khử hôi giày hiệu quả công nghệ Nhật Bản",12000,23473,11473,49
TIKI,giay-dep-nam,253059954,"Khăn lau giày tiện lợi chuyên dụng XIMO siêu mềm mại (KDGG01)",20000,20000,0,0
TIKI,giay-dep-nam,51477254,"Bộ 4 miếng lót độn đế silicone tổ ong tăng 3.5cm chiều cao - buybox - BBPK43",37500,75000,37500,50
TIKI,giay-dep-nam,197529507,"CHAI XỊT HÔI CHÂN NHẬT BÌNH XỊT HÔI CHÂN KHỬ MÙI GIÀY CÔNG NGHỆ NANO BẠC MÙI DỊU NHẸ 260ml  ĐÁNH BAY MÙI HÔI GIÀY DÉP",12000,19000,7000,37
TIKI,giay-dep-nam,45968195,"Lót giày mặt vân massage lòng bàn chân buybox BBPK06",45500,65000,19500,30
TIKI,giay-dep-nam,181237205,"Dép tổ ông nhiều màu(ghi chú size lại giúp shop)",39000,39000,0,0
TIKI,giay-dep-nam,74858728,"Giày Nam Sapo Pierre Cardin PCMFWLE707BRW",1990000,1990000,0,0
TIKI,giay-dep-nam,180227933,"Chai Dung Dịch Tẩy Trắng Vệ Sinh Và Tẩy Vết Ố Cho Giày, Vết Bẩn Eykosi VSG19",20000,30000,10000,33
TIKI,giay-dep-nam,50713232,"Hai viên khử mùi hôi giày và ngăn ngừa vi khuẩn gây ẩm mốc - buybox - BBPK64",54000,90000,36000,40
TIKI,giay-dep-nam,115872494,"Mink oil mỡ chồn XIMO chuyên bảo dưỡng chăm sóc đồ da, làm mới, phục hồi giày da, túi xách, áo da, ví da, ghế sofa XI01",100000,200000,100000,50
TIKI,giay-dep-nam,104438584,"Giày Lười Vải Nam Phong Cách Hàn Quốc - GN04",123000,123000,0,0
TIKI,giay-dep-nam,176037613,"Dép Nam Cao Cấp Hai Quai Thời Trang KEEDO KD0505",480000,480000,0,0
TIKI,giay-dep-nam,107801396,"Bàn chải đánh giày làm từ lông ngựa Horsehair cao cấp XIMO cỡ vừa (XBCDG01)",55000,90000,35000,39
TIKI,giay-dep-nam,187347941,"Lót giày độn đế cao su non, nhựa EVA, tăng chiều cao, êm chân, chống thốn - buybox - BBPK209",53200,70000,16800,24
TIKI,giay-dep-nam,191684851,"Giày nam công sở da bò nappa cao cấp, giày lười G114- Bụi leather- hộp sang trọng",599000,989000,390000,39
TIKI,giay-dep-nam,174437687,"Dép nhựa Bitis nam",90000,90000,0,0
TIKI,giay-dep-nam,82443736,"Chai dung dịch tẩy trắng giày túi PLAC đánh sạch giày tiện lợi nhỏ gọn",6000,7190,1190,17
TIKI,giay-dep-nam,48630889,"Dép Kẹp Da Nam Lê Sang Mẫu Đẹp",99000,99000,0,0
TIKI,giay-dep-nam,31649352,"2 cặp miếng lót mũi giày nam cao su non đệm êm ngón chân - buybox - BBPK50",50000,100000,50000,50
TIKI,giay-dep-nam,144041034,"Giày bata nam trắng đen mẫu mới 2022, đế cao su da mềm",178500,178500,0,0
TIKI,giay-dep-nam,145454918,"Giày Thể Thao Nam, Giày Sneaker Nam New 2022",199000,199000,0,0
TIKI,giay-dep-nam,7386965,"Bộ Vệ Sinh Giày Dép Crep Protect Cure Kit (100ml)",470000,470000,0,0
TIKI,giay-dep-nam,161393066,"Xi Đánh Giày KIWI Cao Cấp Nhập Khẩu Chính Hãng",34000,50000,16000,32
TIKI,giay-dep-nam,107801904,"Cây giữ form giày bảo vệ giày cao cấp bằng gỗ XIMO Shoe Tree (XCGFG03)",249000,420000,171000,41
TIKI,giay-dep-nam,27769016,"Dép Nam BIGGBEN Da Bò Thật Cao Cấp DN208",299000,400000,101000,25
TIKI,giay-dep-nam,126257712,"Đón gót giày cho mọi tư thế gỗ tự nhiên nguyên khối - Dài 55cm (DGH907) Cho giày Nam & Nữ",42000,45000,3000,7
TIKI,giay-dep-nam,107801490,"Cặp Lót Gót Giày XIMO XLGCGC12 Bảo Vệ Gót Sau Và Chống Trầy Chân",12000,14400,2400,17
TIKI,giay-dep-nam,125874036,"Lót Giày Thể Thao Y Khoa Tốt Cho Gan Bàn Chân LGF03",247000,350000,103000,29
TIKI,giay-dep-nam,41077713,"Lót giày vải cotton viền đen Hương Quế CI-13 làm từ vải cotton - bột quế giúp hút ẩm - khử mùi - phòng cảm cúm và cải thiện sức khoẻ",25000,25000,0,0
TIKI,giay-dep-nam,183895879,"Bình xịt lưu hương chống thối chân, khử mùi giày XIMO, kháng khuẩn, công nghệ Bạc ion (VSG08-1)",85000,150000,65000,43
TIKI,giay-dep-nam,27769036,"Dép Nam BIGGBEN Da Bò Thật Cao Cấp DN209",299000,350000,51000,15
TIKI,giay-dep-nam,6579831,"Dép Nam Bảng Ngang BIGGBEN Da Bò Thật DN61",319000,350000,31000,9
TIKI,giay-dep-nam,168303230,"Cặp lót giày thể thao êm chân, hai lớp thấm hút mồ hôi, chống hôi chân_LGTT05_LOTGIAY XIMO",30000,50000,20000,40
TIKI,giay-dep-nam,75031062,"Giày da nam Pierre Cardin PCMFWL 702 - màu đen",2990000,2990000,0,0
TIKI,giay-dep-nam,8193848,"Lót Giày Thể Thao Nam Yellow Sport - Size L",39865,39865,0,0
TIKI,giay-dep-nam,167889817,"Giày thể thao trung cấp Bitis nam",365000,365000,0,0
TIKI,giay-dep-nam,12122426,"Chai tẩy trắng giày dép, túi xách - 100ml",5800,5800,0,0
TIKI,giay-dep-nam,168953188,"Giày Lười Vải Cao Cấp Peace PO1228",269000,429000,160000,37
TIKI,giay-dep-nam,10099614,"Dụng Cụ Đón Gót Giày Inox",41500,41500,0,0
TIKI,giay-dep-nam,8123461,"Lót Giày Tăng Chiều Cao 5cm Có Đệm Khí",45000,45000,0,0
TIKI,giay-dep-nam,161490177,"Giày lội nước , đi mưa nam - Giày lười vải lưới nam thoáng khí mùa hè",228000,228000,0,0
TIKI,giay-dep-nam,134744983,"Giày da nam, giày oxford công sở Bụi Leather G104 - Da bò Nappa cao cấp - Bảo hành 12 tháng",515000,840000,325000,39
TIKI,giay-dep-nam,111719679,"Lót Quế Puno Lót Khử Mùi Hương Quế - Lót Giày NamChống Hôi Chân",14000,14000,0,0
TIKI,giay-dep-nam,169313309,"Giày Bảo Hộ Lao Động Nam Thể Thao JB539 - Chống Đinh Chống Cắt - Chống Tĩnh Điện - Tặng Kèm Bó Chân",420000,420000,0,0
TIKI,giay-dep-nam,173347724,"Bàn Chải Đành Giày Lông Heo Tay Cầm Linh Hoạt BCDG24",36000,70000,34000,49
TIKI,giay-dep-nam,186756284,"Giày đốc mũi trơn nam da mềm, đế cao khâu đế thanh lịch",350000,350000,0,0
TIKI,giay-dep-nam,158640993,"Giày Nam Pierre Cardin - PCMFWLF 738",2990000,2990000,0,0
TIKI,giay-dep-nam,156216385,"DÉP NAM QUAI NGANG DA BÒ THỜI TRANG CAO CẤP",317334,317334,0,0
TIKI,giay-dep-nam,158810802,"Giày Nam Pierre Cardin - PCMFWLF 752",1245000,2490000,1245000,50
TIKI,giay-dep-nam,85969100,"Xi Đánh Bóng Giày Dép Dạng Nước Chất Lượng - KD1011",34000,55000,21000,38
TIKI,giay-dep-nam,55487851,"Bình Xịt Bọt Tuyết Nhật Vệ Sinh Giày Khô Siêu Sạch Sneaker Tiện Lợi Dùng Được Nhiều Lần - PK042",35000,35000,0,0
TIKI,giay-dep-nam,133868348,"Giày bata nam trắng đen mẫu mới 2022, đế cao su da mềm",178500,178500,0,0
TIKI,giay-dep-nam,176037199,"Dép Quai Ngang Nam Cao Cấp KEEDO-KD0604",480000,480000,0,0
TIKI,giay-dep-nam,76827077,"Giày Công Sở Đi Mưa Thời Trang Nam Cao Cấp",119000,119000,0,0
TIKI,giay-dep-nam,191363362,"Giày da nam, giày đốc nam trẻ trung nam Bụi Leather G122 - Da bò thật Nappa cao cấp - Bảo hành 12 tháng",585000,969000,384000,40
TIKI,giay-dep-nam,183275875,"Dép Nam Pierre Cardin - PCMFWS 151",1290000,1290000,0,0
TIKI,giay-dep-nam,191684851,"Giày nam công sở da bò nappa cao cấp, giày lười G114- Bụi leather- hộp sang trọng",520000,840000,320000,38
TIKI,giay-dep-nam,191650844,"Dép nam quai ngang da bò Nappa cao cấp Bụi Leather E102, đế đúc nguyên khối khâu viền thủ công đi êm chân",268000,450000,182000,40
TIKI,giay-dep-nam,164073814,"Chai Xịt Hôi Chân Nhật Bình Sịt Hôi Chân Khử Mùi Giày Công Nghệ Nano Bạc Mùi Dịu Nhẹ 260ml Đánh Bay Mùi Hôi Giày Dép",11000,16999,5999,35
TIKI,giay-dep-nam,2747873,"Combo 4 cặp Lót giày êm chân Size Nam - Màu ngẫu nhiên size",64000,71000,7000,10
TIKI,giay-dep-nam,124274788,"Keo Dán Giày Dép 901 Siêu Chắc Chắn",13300,14000,700,5
TIKI,giay-dep-nam,191592683,"Giày da thể thao da bò LC2101 White, da bò trắng Lucas Shoes (LC2101 trắng)",585000,585000,0,0
TIKI,giay-dep-nam,155701266,"Giày Thể Thao Nam SA31 Leo Núi,Phượt 2 Màu Đế Tăng Cương Ma Sát Bền Đẹp",175000,250000,75000,30
TIKI,giay-dep-nam,107801744,"Bàn chải lông ngựa đánh giày, vệ sinh giày Horsehair cao cấp cỡ lớn XIMO (XBCDG02)",144000,144000,0,0
TIKI,giay-dep-nam,168213506," Lót giày thể thao,giày tây chất liệu cao su non cao cấp",45000,45000,0,0
TIKI,giay-dep-nam,143935440,"Giày tây nam công sở tăng chiều cao bí mật 7cm, da cao cấp nguyên tấm, đế cao su mang êm chân, size từ 38 đến 43",189000,189000,0,0
TIKI,giay-dep-nam,109064375,"Lót giày thể thao EVA 4D ốp mút PU cứng giảm chấn vòm ngang và chống thốn gót - buybox - BBPK180",65000,82000,17000,21
TIKI,giay-dep-nam,53454698,"Dung dịch tẩy ố đế giày và các chi tiết bằng chất liệu cao su - buybox - BBPK73 - 100ml",95000,110000,15000,14
TIKI,giay-dep-nam,166494943,"1 Đôi  Lót Giầy Hương Quế - Lót Quế Khử Mùi Hôi Hiệu Quả",6500,6500,0,0
TIKI,giay-dep-nam,141315541,"Sandal PU Nam Biti's DPM031600DEN",343200,390000,46800,12
TIKI,giay-dep-nam,136117893,"Chai xịt tẩy trắng giày dép túi xách Plac - Chai xịt tẩy trắng",6000,12990,6990,54
TIKI,giay-dep-nam,98297314,"GIÀY THỂ THAO NAM Sneakers mẫu đep mới nhất",169990,169990,0,0
TIKI,giay-dep-nam,136393568,"Giày bata nam trắng đen trơn mẫu mới 2022, đế cao su da mềm",177000,177000,0,0
TIKI,giay-dep-nam,191693335,"Giày lười da nam công sợ Bụi Leather G121 - Da bò Nappa cao cấp",479000,840000,361000,43
TIKI,giay-dep-nam,179060048,"Dép sục cross literide màu navy blu êm mềm nam nữ hàng xuất xịn, mẫu mới, full box",349000,349000,0,0
TIKI,giay-dep-nam,167002852,"Giày Nam Chất Liệu Vải polyester (gió) chống thấm, Đế Cao Su Mềm , Không Phai Màu NEW 2022",169000,169000,0,0
TIKI,giay-dep-nam,150339814,"Chai Xịt Tạo Bọt Vệ Sinh Giày Sneaker Cao Cấp 300ml",45000,45000,0,0
TIKI,giay-dep-nam,110696274,"Giày Cao Cổ Nam U559 Kiểu Dáng Giày Chiến Thuật Boot Nam Chuyên Phượt, Giày Swat Lính -HÀNG CHÍNH HÃNG",434000,899000,465000,52
TIKI,giay-dep-nam,48226182,"GIày Sandal Nam Da Bò BIGGBEN Cao Cấp SD96",369000,500000,131000,26
TIKI,giay-dep-nam,48491216,"Chai Xịt Chống Thấm Nano Crep Protect Spay 200ml",450000,450000,0,0
TIKI,giay-dep-nam,101265416,"Sandal Nam Biti's Hunter Orange Tonic DEMH00400CAM (Cam)",457000,457000,0,0
TIKI,giay-dep-nam,160263018,"Dép Nam Pierre Cardin - PCMFWLF 150",1790000,1790000,0,0
TIKI,giay-dep-nam,66621360,"Giày Thể Thao Nam Màu Đen, Sneaker Nam Màu Đen,  Đế Êm, Nhẹ Thoáng Khí S362",229000,450000,221000,49
TIKI,giay-dep-nam,191717216,"Giày nàm đế cao cao cấp G124 - Da bò Nappa cao cấp - Phong cách trẻ trung năng động, chính hãng",599000,910000,311000,34
TIKI,giay-dep-nam,101655676,"Giày tăng chiều cao nam 6cm Sans141 giầy tây độn đế lười da bóng mũi tròn đen nâu size nhỏ 37 công sở đàn ông người lớn",399000,399000,0,0
TIKI,giay-dep-nam,177962520,"Giày Da Nam Driving Pierre Cardin - PCMFWLF 714",2490000,2490000,0,0
TIKI,giay-dep-nam,110793009,"Dép quai ngang Bitis nam",200000,200000,0,0
TIKI,giay-dep-nam,133234738,"Dép nhựa đúc nam quai ngang Thái Lan Adda 5TD12",160000,160000,0,0
TIKI,giay-dep-nam,169573532,"Giày Sneaker Nam, Giày Da Nam Cao Cấp Phong Cách Hàn Quốc New 2022",169000,169000,0,0
TIKI,giay-dep-nam,91860503,"Giày lười da bò nam",169000,169000,0,0
TIKI,giay-dep-nam,168789250,"Giày Bảo Hộ Lao Động 2TH Kiểu Dáng Thể Thao Mũi Thép, Đế Lót Thép BD0064- Chống Đinh/Trơn Trượt -Giày Công Trình",349000,590000,241000,41
TIKI,giay-dep-nam,115869286,"Kem dưỡng đồ da chuyên sâu XIMO, giúp tái tạo độ đàn hồi cho da giày, dưỡng áo da, túi ví, 80ml XI04",100000,130000,30000,23
TIKI,giay-dep-nam,88821159,"Giày Da nam xả kho giá gốc -giày lười da nam- giày lười nam mã l180",210000,210000,0,0
TIKI,giay-dep-nam,6187285,"Dép Nam BIGGBEN May Đế  Da Bò Thật DN40",339000,400000,61000,15
TIKI,giay-dep-nam,49523954,"Giấy lau giầy Sneaker 30 tờ, Dung dịch chuyên lau giày thấm sẵn trong khăn tiện dụng GD269-KGLaugiay",20897,20897,0,0
TIKI,giay-dep-nam,132372134,"GIÀY NHỰA LỖ URBAN-UB01",135000,135000,0,0
TIKI,giay-dep-nam,102796764," Giày Sneaker Nam, Giày Nam Cao Cấp Đế Sóng Phong Cách HQ HOT TREND",179000,179000,0,0
TIKI,giay-dep-nam,59434082,"Sandal nam cao cấp Pierre Cardin - PCMFWL 127 màu đen",1890000,1890000,0,0
TIKI,giay-dep-nam,145236714,"Giày Lười Nhựa nam Cao Cấp Siêu Êm GIAY-018",520000,520000,0,0
TIKI,giay-dep-nam,73364613,"Sandal nam cao cấp Pierre Cardin PCMFWLE136BLK",1990000,1990000,0,0
TIKI,giay-dep-nam,194121829,"Dép nam  nữ quai ngang đi trong nhà đế cao su siêu êm hoat hinh  khủng long đủ màu Form nhỏ tăng 1-2 size",49000,100000,51000,51
TIKI,giay-dep-nam,157416584,"Giày thể thao, Giày Sneaker Nam Da Kiểu Dáng Đẹp GPI042",90000,90000,0,0
TIKI,giay-dep-nam,107801954,"Cặp Sneaker Shield Bảo Vệ Mũi Giày XIMO Chống Nhăn Gãy Nứt XCGFG08",21000,42000,21000,50
TIKI,giay-dep-nam,186756265,"Giày đốc nam cổ cao da mềm, đế cao khâu đế thanh lịch, giày boots da nam",350000,350000,0,0
TIKI,giay-dep-nam,168799755,"Đón gót giày nhựa ABS bóng treo chìa khóa (XDGG08-A22)",15000,30000,15000,50
TIKI,giay-dep-nam,92137013,"Dép nam DUWA siêu nhẹ - Hàng chính hãng - Quai ngang caro DH9014",88500,159000,70500,44
TIKI,giay-dep-nam,125781244,"Dép nhựa quai ngang nam",98500,98500,0,0
TIKI,giay-dep-nam,126257972,"Đón gót giày cho mọi tư thế gỗ tự nhiên nguyên khối - Dài 70cm (DGH908) Cho giày Nam & Nữ",56050,59000,2950,5
TIKI,giay-dep-nam,164209222,"Dép Nam đúc nguyên khối, quai ngang Thái Lan Kito AH91 , siêu nhẹ, siêu bền, không thấm nước",150000,150000,0,0
TIKI,giay-dep-nam,125874421,"Chai Dung Dịch Tẩy Ố Vàng Đế Giày XIMO Sole Bright cho chất liệu Icy, Cao Su, Nhựa, Boost XI07",89000,150000,61000,41
TIKI,giay-dep-nam,22956625,"Dép Nam BIGGBEN Da Bò Thật Cao Cấp DN182",299000,400000,101000,25
TIKI,giay-dep-nam,11740403,"Dụng cụ đón gót giày inox của Nhật Bản dài 15.6cm",41500,41500,0,0
TIKI,giay-dep-nam,144588177,"Dép kẹp nam cao cấp KEEDO TNG-D25",280000,280000,0,0
TIKI,giay-dep-nam,207380100,"Giày Sục Nam da BÓNG đơn giản Mã G25 NEW 2023",160000,160000,0,0
TIKI,giay-dep-nam,191592567,"Giày da nam Boat Shoes Đen da bò đen cao cấp Hanmade, Lucas Shoes",659000,659000,0,0
TIKI,giay-dep-nam,113215403,"Lót giày vải lưới Hương Quế, quế thật, quế thơm, tốt cho sức khỏe",38860,58000,19140,33
TIKI,giay-dep-nam,21792670,"Combo 2 cặp lót giày nam đệm êm ngón chân chất liệu cao su non PK50A",50000,50000,0,0
TIKI,giay-dep-nam,168796212,"Đón gót giày nhựa ABS (XDGG10-A22)",15000,30000,15000,50
TIKI,giay-dep-nam,96313719,"Giày Domba Germany Trainer Trắng-Xám nhạt (White - Light Grey) GT-8123",1290000,1290000,0,0
TIKI,giay-dep-nam,159314323,"Giày Sneaker Nam, Giày Da Nam Thấp Cổ Da Lộn NEW 2022",199000,199000,0,0
TIKI,giay-dep-nam,171536034,"Dép quai ngang nam nữ M Masler-MT màu đen sọc trắng với lớp đế chống trượt, chống nước và quai êm chân DT1",139000,139000,0,0
TIKI,giay-dep-nam,133867407,"Giày bata nam da mềm, đế cao su, phối trắng đỏ thời trang",250000,250000,0,0
TIKI,giay-dep-nam,173432175,"Giày lười clog unisex Crocs Literide 360 - 206708-0DD",1327000,1895000,568000,30
TIKI,giay-dep-nam,179911873,"Dây Giày Thông Minh Silicon Siêu Bền Tiết Kiệm Thời Gian Bộ 12 Chiếc Thời Trang HOT 2022 DG01",13000,13000,0,0
TIKI,giay-dep-nam,76383441,"Giày boots nam da láng, giày bốt nam phong cách lính SM024",179000,199000,20000,10
TIKI,giay-dep-nam,105121088,"Giày Sneaker Thể Thao Thời Trang Nam ( Xám Sọc Đen )",223500,223500,0,0
TIKI,giay-dep-nam,6137325,"Dép Da Nam BIGBEN May Đế Da Bò Thật DN38",339000,500000,161000,32
TIKI,giay-dep-nam,57512036,"Giày Sneaker thể thao nam - Nâng chiều cao",119000,119000,0,0
TIKI,giay-dep-nam,161393183,"Xi Đánh Giày Cao Cấp Hàn Quốc Aromax (đủ các màu)",42000,42000,0,0
TIKI,giay-dep-nam,101291470,"Giày lười nam - Slip on nam vải - Mã LY69X",350000,350000,0,0
TIKI,giay-dep-nam,80950221,"Giày da giày da nam cao cấp giày da nam đẹp giày nam cao cấp sang trọng giày tây nam không dây giày da nam công sở giày lười mã 36633.LK",529000,999000,470000,47
TIKI,giay-dep-nam,154134667,"Giày sục Nam Da Bò cao cấp sapo nam trẻ trung năng động,Giày hở gót-S77 Giày SAGO’S",495000,495000,0,0
TIKI,giay-dep-nam,152387452,"Sơn giày 56 màu nước sửa chữa vết bong tróc giầy dép ghế ví túi da mầu đen trắng be vàng nâu bạc repaint customs Sans950",69999,69999,0,0
TIKI,giay-dep-nam,191757320,"Sandal PU Nam Biti's DPM032400DEN (Đen)",347000,395000,48000,12
TIKI,giay-dep-nam,196336942,"Giày thể thao nam siêu nhẹ, siêu ôm chân (vải Trico thô bảo vệ môi trường, thoáng khí) đế cao su Lava siêu nhẹ. Thiết kế và hoàn thiện thủ công tại xưởng",224500,449000,224500,50
TIKI,giay-dep-nam,179445693,"Dép tổ ong nhập loại 1 xịn dày",65000,65000,0,0
TIKI,giay-dep-nam,73354133,"Sandal nam cao cấp Pierre Cardin PCMFWL 137 - màu đen",1990000,1990000,0,0
TIKI,giay-dep-nam,7349821,"Dép Nam Doctor BIGGBEN Da Bò Thật Cao Cấp DN95",339000,400000,61000,15
TIKI,giay-dep-nam,156300137,"MLB - Giày sneaker Chunky Jogger Seamball 3ASXXB21N",3190000,3190000,0,0
TIKI,giay-dep-nam,130594481,"Dép Nam PEAK TAICHI VOID SANDALS E12005L",990000,990000,0,0
TIKI,giay-dep-nam,161393133,"Bút sơn giày Toyo SA101, Repaint giày, làm mới phục hồi giày, siêu tốc, bám chắc, chống nước tốt",18000,18000,0,0
TIKI,giay-dep-nam,148677121,"[Cao Cấp] Giày Sneaker Thể Thao Nam GNS068 Đế Tăng Ma Sat ,Leo Núi ,Phượt Bền Đẹp",182500,250000,67500,27
TIKI,giay-dep-nam,8128209,"Lót giày tăng chiều cao không khí nguyên bàn 2 lớp cao 5 cm - Đen",39498,39498,0,0
TIKI,giay-dep-nam,82647253,"Giấy ướt lau tẩy ố trên giày trắng SNEAKER",10000,25000,15000,60
TIKI,giay-dep-nam,173609650,"DÉP DA BÒ CAO CẤP VATIS VA2012",209000,379000,170000,45
TIKI,giay-dep-nam,48319377,"Dép Nam Da Bò BIGGBEN Cao Cấp DN225",309000,400000,91000,23
TIKI,giay-dep-nam,48316320,"Giày Mọi Nam BIGGBEN Da Bò Thật GM223",590000,650000,60000,9
TIKI,giay-dep-nam,59451920,"Viên Khử Mùi Giày Crep Protect Pill",320000,320000,0,0
TIKI,giay-dep-nam,177921108,"Giày Boot Nam Cổ Lửng Tăng Chiều Cao Mandoo Da Bò Thật NB3",1150000,1150000,0,0
TIKI,giay-dep-nam,171196824,"DÉP KẸP DA BÒ CAO CẤP VA2006",189000,349000,160000,46
TIKI,giay-dep-nam,53305817,"Dép Xỏ Ngón Nam Da Bò Thật BIGGBEN DK61",299000,350000,51000,15
TIKI,giay-dep-nam,170741559,"Khăn giấy ướt lau giầy thần thánh sneaker quick wipes gói 30 miếng siêu sạch, siêu trắng- khăn giấy ướt vệ sinh giầy.",10000,25000,15000,60
TIKI,giay-dep-nam,88817997,"Giày Lười Nam Da Lì Đế Cao Su Đúc Mã L182 Màu Đen",210000,210000,0,0
TIKI,giay-dep-nam,153793126,"Đón gót giày gỗ 70cm",55000,59000,4000,7
TIKI,giay-dep-nam,83925994,"Giày nam da lộn AK 5851",220000,220000,0,0
TIKI,giay-dep-nam,88818002,"() GIÀY LƯỜI NAM - CHẤT DA BÒ, ĐẾ KHÂU CHẮC CHẮN - MÃ X083 MÀU ĐEN, CÓ CHUÔNG",210000,210000,0,0
TIKI,giay-dep-nam,116819208,"dép quai hậu nam nữ A 87 đen sandal đồng nai size từ 35 nữ đến 42 nam",82999,82999,0,0
TIKI,giay-dep-nam,8176505,"Bộ 1 Cặp Lót Giày Tăng Chiều Cao Đệm Khí 1 lớp 3cm",35799,35799,0,0
TIKI,giay-dep-nam,167489058,"Cặp dây cột giày dây giày màu đen trắng sợi tròn dẹt 70cm 80cm",23500,23500,0,0
TIKI,giay-dep-nam,76466969,"Giày nam da thật, giày công sở, giày tây giày doanh nhân giày giám đốc da thật phong cách Hàn Quốc  năm 2021 Mã 31527",519000,999000,480000,48
TIKI,giay-dep-nam,74683108,"Dép sandals cho nam bằng da thật thiết kế đế mềm kiểu dáng mới mã DQH10321",499000,499000,0,0
TIKI,giay-dep-nam,5207281,"Dép Nam BIGGBEN Da Bò Thật Cao Cấp DN31",279000,279000,0,0
TIKI,giay-dep-nam,7977159,"Giày Tây Nam Da Bò Sunpolo SUMU234N",750000,750000,0,0
TIKI,giay-dep-nam,66510946,"Dép Nam Da Bò BIGGBEN Cao Cấp DN262",359000,400000,41000,10
TIKI,giay-dep-nam,47141598,"Chai Dung Dịch Vệ Sinh Giày Crep Protect Cure Refill ",350000,350000,0,0
TIKI,giay-dep-nam,161393064,"Xịt khử mùi giày dịu nhẹ hương Flona CHONGIAY tại Hà Nội",83000,83000,0,0
TIKI,giay-dep-nam,134708659,"Giày da nam, giày oxford công sở Bụi Leather G102 - Da bò Nappa cao cấp - Bảo hành 12 tháng",515000,650000,135000,21
TIKI,giay-dep-nam,20238342,"Lót Giày Tăng Chiều Cao Silicon (4.2 Cm)",36000,36000,0,0
TIKI,giay-dep-nam,55750878,"Lót giày lưới 1 lớp Hương Quế CI-05 làm từ vải lưới 1 lớp - vải cotton - bột quế giúp êm chân - ấm chân - phòng cảm cúm và cải thiên sức khỏe",40000,40000,0,0
TIKI,giay-dep-nam,7975961,"Dép Nam Quai Ngang Da Bò Sunpolo SUA5N - Nâu (Size",550000,550000,0,0
TIKI,giay-dep-nam,17047309,"Lót giày bằng da Woly Comfort - NK Đức",99000,99000,0,0
TIKI,giay-dep-nam,15427693,"Khăn cotton đánh giày Saphir Chamoisine MDO",95000,95000,0,0
TIKI,giay-dep-nam,55715962,"Lót giày lưới 2 lớp Hương Quế CI-06 làm từ vải lưới 2 lớp - vải cotton - bột quế giúp êm chân - ấm chân - phòng cảm cúm",40000,40000,0,0
TIKI,giay-dep-nam,38759307,"Giày Tây Nam Da Cao Cấp Công Sở Thanh Lịch - S18",208500,208500,0,0
TIKI,giay-dep-nam,129653671,"Xịt khử mùi giày nam Zelenaya Apteka Effective 150ml",190000,190000,0,0
TIKI,giay-dep-nam,186909238,"Giày Lười Nam Da Lì Đế Cao Su Đúc Mã L1 Màu Đen",155000,155000,0,0
TIKI,giay-dep-nam,51627332,"Dép Nam Quai Ngang Da Bò Thật Cao Cấp DNA53",299000,299000,0,0
TIKI,giay-dep-nam,171422657,"Xi đánh giày cao cấp Sans905 màu đen nâu đỏ trắng dành cho đồ da túi ví xách",59999,59999,0,0
TIKI,giay-dep-nam,133236001,"Dép kẹp Nam, Dép xỏ ngón Thái Lan Kito EM 4815",262000,262000,0,0
TIKI,giay-dep-nam,6137251,"Dép Nam Bảng Ngang BIGGBEN Da Bò Thật DN37",329000,400000,71000,18
TIKI,giay-dep-nam,186877104,"Giày sục nam da Pu siêu đẹp giá siêu tốt S002",160000,160000,0,0
TIKI,giay-dep-nam,58893780,"Giày Tây Nam Giả Dây Lịch Lãm",210000,210000,0,0
TIKI,giay-dep-nam,75620024,"Khăn đánh bóng giày chuyên dụng & Các phụ kiện bằng da hoặc giả da - Lamosi Shoe Pad 5M",48000,48000,0,0
TIKI,giay-dep-nam,107802114,"Bàn chải đánh giày XIMO làm từ lông ngựa linh hoạt giúp không bị bẩn tay (XBCDG18)",75000,120000,45000,38
TIKI,giay-dep-nam,158972054,"Giày Nam Pierre Cardin - PCMFWL 748",2990000,2990000,0,0
TIKI,giay-dep-nam,143232640,"Giày tây nam da cao cấp, tăng chiều cao 6-7cm, đế cao su nguyên tấm chống trơn",189000,189000,0,0
TIKI,giay-dep-nam,88821317,"Giày Da nam cực chất xả kho giá gốc- giày lười nam-mã l184",210000,210000,0,0
TIKI,giay-dep-nam,190703011,"Giày nhựa nam đi mưa - Giày lao động",99000,99000,0,0
TIKI,giay-dep-nam,185340016,"Xi nước đánh giày da, đồ da bổ sung màu và độ bóng Ximo Polish XI31",35000,70000,35000,50
TIKI,giay-dep-nam,107561105,"Lót giày thể thao 4D ốp nhựa trợ lực gan bàn chân dùng mang giày đá bóng, bóng chuyền, bóng rổ - buybox - BBPK179",61000,70000,9000,13
TIKI,giay-dep-nam,150789018,"Quế Lót giày nam khử mùi,lót giày hương quế giúp giảm size ôm chân khi giày giãn rộng combo 5 đôi",65000,65000,0,0
TIKI,giay-dep-nam,42377073,"Dép nam quai chéo GIAVY - TL345",195000,195000,0,0
TIKI,giay-dep-nam,76058847,"Giày Tây Nam Da Mềm, Đế Cao, Khâu Đế",163500,163500,0,0
TIKI,giay-dep-nam,88821299,"Giày Da nam cực chất xả kho giá gốc mã - giày lười nam MÃ l190",198000,198000,0,0
TIKI,giay-dep-nam,107801509,"Cặp Lót Giày Cao Gót XIMO XLGCGC10 Đệm Êm Ngón Chân, Giảm Size Cho Giày Bị Rộng",12000,15000,3000,20
TIKI,giay-dep-nam,8176039,"Lót Giày Tăng Chiều Cao Đệm khí",33399,33399,0,0
TIKI,giay-dep-nam,49082456,"Bọt vệ sinh giày và giặt giày (150ml) - buybox - BBPK60",110000,170000,60000,35
TIKI,giay-dep-nam,19773325,"Dép Xăng Đan Nam Nam Quai Hậu Teramo TRM15 Xám",119000,119000,0,0
TIKI,giay-dep-nam,134652690,"Giày da nam, giày oxford công sở Bụi Leather G101 - Da bò Nappa cao cấp - Bảo hành 12 tháng",515000,840000,325000,39
TIKI,giay-dep-nam,102798110," Giày Nam, giày Sneaker Nam Cao Cấp, Kiểu Dáng Hàn Quốc New 2",99000,99000,0,0
TIKI,giay-dep-nam,71948369,"Giày Unisex Crocs Clog - Bayaband 205089-126 Màu",1196000,1495000,299000,20
TIKI,giay-dep-nam,77750031,"GIÀY TÂY NAM CÔNG SỞ ĐAI NGANG",115000,115000,0,0
TIKI,giay-dep-nam,73180722,"Giày Nam Sapo Pierre Cardin PCMFWLE707BLK",1990000,1990000,0,0
TIKI,giay-dep-nam,107253279,"Dép Nam, Dép Quai Ngang Nam Đế Hổng Cực Êm, Chống Trơn Mẫu Mới Mã DP70",129000,129000,0,0
TIKI,giay-dep-nam,168800081,"Đón gót giày thép bóng không gỉ treo chìa khóa (XDGG07)",15000,30000,15000,50
TIKI,giay-dep-nam,28739841,"Giày Sneaker thể thao nam - Nâng chiều cao",109000,200000,91000,46
TIKI,giay-dep-nam,79713735,"Dép sục siêu nhẹ nam nữ thời trang, dép đi mưa siêu bền",89000,89000,0,0
TIKI,giay-dep-nam,191649163,"Dép nam quai ngang da bò Nappa cao cấp Bụi Leather E101 - Đế cao su đúc nguyên khối, chống trơn trượt",290000,450000,160000,36
TIKI,giay-dep-nam,168946336,"Giày Lười Vải Cao Cấp Peace PO1227",269000,429000,160000,37
TIKI,giay-dep-nam,89591885,"Dép Sandal Nam 3 Quai, Dép Xăng Đan Học Sinh Quai Dù Chắc Chắn DP23",378000,378000,0,0
TIKI,giay-dep-nam,25662103,"Giày Tây Nam Da Bò Mã BH-2",390000,780000,390000,50
TIKI,giay-dep-nam,57731985,"Dép sục nam siêu nhẹ",99000,99000,0,0
TIKI,giay-dep-nam,168789113,"Giày Bảo Hộ Lao Động AQX BD_0059 Mũi Thép, Để Lót Thép Chống Đinh,Chống Trơn, Chống Dập Ngón-Giày Công Trình",389000,590000,201000,34
TIKI,giay-dep-nam,179060465,"Dép sục cross literide màu ghi xám êm mềm nam nữ hàng xuất xịn, mẫu mới, full box",349000,349000,0,0
TIKI,giay-dep-nam,107801406,"Bàn chải đánh giày làm bằng lông ngựa đánh kẽ chi tiết nhỏ XIMO (XBCDG15)",60000,60000,0,0
TIKI,giay-dep-nam,168789067,"[Mẫu HOT] Giày Bảo Hộ Lao Động 2TH Kiểu Thể Thao Mũi Thép, Đế Lót Thép BD0053-Chống Đinh/Trơn Trượt Giày Công Trình",379000,590000,211000,36
TIKI,giay-dep-nam,144183418,"Giày Thể Thao Nam Đế Cao TT01 Trắng",209000,209000,0,0
TIKI,giay-dep-nam,171535414,"Dép quai ngang nam nữ M Masler-MT màu xám với lớp đế êm chân khử mùi và chống trơn trượt XT1",290000,290000,0,0
TIKI,giay-dep-nam,189683567,"Giày Bảo Hộ Lao Động Nam Da Bò Thời Trang Thể Thao Nhẹ Bền Đẹp Mũi Sắt Chống Đinh Va Đập Trơn Trượt",389000,750000,361000,48
TIKI,giay-dep-nam,179060748,"Dép sục cross literide màu đen đỏ êm mềm nam nữ hàng xuất xịn, mẫu mới, full box",349000,349000,0,0
TIKI,giay-dep-nam,151952919,"Dép nam da bò cao cấp. Sản phẩm được bảo hành",239000,239000,0,0
TIKI,giay-dep-nam,21681400,"Giày Sneaker Nam GN331",118500,150000,31500,21
TIKI,giay-dep-nam,177827466,"Dép quai ngang nam nữ M Masler MT màu navy trắng thể thao với lớp đế êm chân chống trượt và khử mùi NV1",298000,298000,0,0
TIKI,giay-dep-nam,27769078,"Dép Nam BIGGBEN Da Bò Thật Cao Cấp DN210",299000,400000,101000,25
TIKI,giay-dep-nam,55745928,"Giày tây nam công sở Trường Hải mũi tròn màu đen da bò thật mềm mại không bong tróc đế cao su chống mòn không trơn GT0231",429000,485000,56000,12
TIKI,giay-dep-nam,96052064,"Giày Lười Nam, Giày Vải Nam Phong Cách, Kiểu Dáng Đơn Giản Dễ Phối Đồ - GN04",129000,129000,0,0
TIKI,giay-dep-nam,153257960,"xăng đan nam - Dép quai hậu học sinh Fashion 2 quai siêu đẹp đen và ghi",129000,129000,0,0
TIKI,giay-dep-nam,53380039,"Dép Xỏ Ngón Nam BIGGBEN Da Bò Thật DK63",299000,400000,101000,25
TIKI,giay-dep-nam,101292327,"Giày lười nam - Slip on nam vải - Mã A1696",350000,350000,0,0
TIKI,giay-dep-nam,73254944,"Dép Quai Ngang Chất Cao Su Siêu Bền Không Thấm Nước-4",118500,118500,0,0
TIKI,giay-dep-nam,107801648,"Cây giữ form giày chất liệu gỗ tuyết tùng cao cấp XIMO (XCGFG05)",320000,468000,148000,32
TIKI,giay-dep-nam,150881574,"Khăn Giấy Ướt Lau Giày Sneaker Wipes Clean thần thánh(gói 30 miếng)",10000,25500,15500,61
TIKI,giay-dep-nam,75666708,"Lót Giày Nam Nữ Phù Hợp Với Tất Cả Loại Giày 6 Màu Lựa chọn",12000,20000,8000,40
TIKI,giay-dep-nam,43924408,"Giày Tây Nam Đế Cao Phối Da Bóng Lịch Lãm",223500,223500,0,0
TIKI,giay-dep-nam,104616397,"Giày thể thao nam leo lúi màu xám đen phong cách trẻ trung năng động",168260,168260,0,0
TIKI,giay-dep-nam,107801412,"Đón gót giày hình sư tử vàng dáng vẻ sang trọng quý tộc XIMO (XDGG01)",350000,500000,150000,30
TIKI,giay-dep-nam,161393162,"Lót Giày Thể Thao Cao Cấp EQT Boost Siêu Nhẹ, Giảm Sóc, Khử Mùi, Thoáng Khí, Thấm Mồ Hôi",60000,60000,0,0
TIKI,giay-dep-nam,67293999,"Đế trong lót giày kháng khuẩn khử mùi thoáng khí chất liệu da kích cỡ 35-46",18000,18000,0,0
TIKI,giay-dep-nam,76266916,"Dép quai ngang Unisex Crocs Bayaband - 205392-126 màu",956000,995000,39000,4
TIKI,giay-dep-nam,73324895,"Giày da nam Pierre Cardin PCMFWL 714 - vàng gold",2490000,2490000,0,0
TIKI,giay-dep-nam,168800335,"Đón gót giày gỗ treo móc chìa khóa (XDGG04-A22)",60000,60000,0,0
TIKI,giay-dep-nam,183525013,"Giày Thể Thao Nam Sneaker - Giày Vải Nam Cao Cấp Nhẹ Bền Êm Chân",179000,179000,0,0
TIKI,giay-dep-nam,49551859,"Dụng cụ bảo quản giày chống xẹp móp mũi giày, chống gãy da giày và giúp giữ dáng giày chuẩn thiết kế - buybox - PKBB45",55000,100000,45000,45
TIKI,giay-dep-nam,22929950,"Dép Nam BIGGBEN Da Bò Thật Cao Cấp DN176",339000,450000,111000,25
TIKI,giay-dep-nam,101301227,"Sandal Nam Biti's Hunter Americano DEMH00400DEN (Đen)",457000,457000,0,0
TIKI,giay-dep-nam,68078130,"DÉP SỤC CÁ SẤU, DÉP BÍT ĐẦU NAM NỮ (tặng kèm 6 sticker)",85000,85000,0,0
TIKI,giay-dep-nam,38393285,"Bộ Dụng Cụ Đánh Giày 7 Món Kèm Si Đánh Bóng Tiện Lợi",71680,71680,0,0
TIKI,giay-dep-nam,167012865,"Giày Thể Thao Nam Màu Đen, Sneaker Nam Màu Đen, Đế Êm, Nhẹ Thoáng Khí S101",182500,250000,67500,27
TIKI,giay-dep-nam,49165075,"Dép nam chống trơn trượt hở mũi",119000,119000,0,0
TIKI,giay-dep-nam,101655614,"Lót giày tăng chiều cao 3cm 5cm 7cm 9cm Sans920 miếng lót giầy độn đế nâng gót đệm khí nguyên nửa bàn 3P 5P 7P 9P",49999,49999,0,0
TIKI,giay-dep-nam,38410780,"Chai Xịt Đánh Giày Enito Foam Cleaner 200ml -  Chuyên Dùng Để Làm Sạch, Vệ Sinh Giày Sneaker",270000,270000,0,0
TIKI,giay-dep-nam,143363032,"Dép kẹp cao su nam/dép xỏ ngón",70000,70000,0,0
TIKI,giay-dep-nam,75448966,"Giày thể thao nam - giày sneaker nam mầu trắng phong cách ST009W",171000,330000,159000,48
TIKI,giay-dep-nam,134757898,"Giày da nam, giày oxford công sở Bụi Leather G106 - Da bò Nappa cao cấp - Bảo hành 12 tháng",515000,810000,295000,36
TIKI,giay-dep-nam,101656447," Bộ Làm Sạch Giày Da Bộ Đánh Giầy Da Sans931",102000,102000,0,0
TIKI,giay-dep-nam,71646697,"Giày sandal nam quai dán siêu nhẹ siêu êm SM030",142000,142000,0,0
TIKI,giay-dep-nam,151952867,"Si đánh giày kèm bàn chải",49000,49000,0,0
TIKI,giay-dep-nam,131032038,"Giày bảo hộ lao động ABC/XP - chống đinh, trọng lượng nhẹ, giá rẻ",99000,99000,0,0
TIKI,giay-dep-nam,174515933,"Giày sneaker da bò trắng LC2101 White Lucas Shoes",649000,649000,0,0
TIKI,giay-dep-nam,40779227,"Dép Xăng Đan Nam Quai Hậu Nam Nữ Cao Cấp Quai Dù, Dép Sandal Học Sinh TRM01",119000,119000,0,0
TIKI,giay-dep-nam,49165215,"Dép nam đi mưa đế chống trơn trượt bít mũi",119000,119000,0,0
TIKI,giay-dep-nam,180380358,"Combo lót giày nam giảm size chống rộng và rớt gót chống đau chân hiệu quả dùng được nhiều loại giày rất tiện dụng",39500,79000,39500,50
TIKI,giay-dep-nam,178010970,"GIÀY LƯỜI DA BÒ NAM CAO CẤP VATIS VA2032",359000,549000,190000,35
TIKI,giay-dep-nam,158744944,"Giày Nam Pierre Cardin - PCMFWLF 746",2990000,2990000,0,0
TIKI,giay-dep-nam,58894777,"Dép PEAK Taichi Slippers E92037L",449000,550000,101000,18
TIKI,giay-dep-nam,47141251,"Bộ Vệ Sinh Giày Dép Crep Protect Cure Kit (gồm bàn chải, khăn lau, chai dung dịch vệ sinh 100ml và sách hướng dẫn) ",470000,470000,0,0
TIKI,giay-dep-nam,171535210,"Dép quai ngang nam nữ M Masler-MT màu đen trắng thiết kế chống trơn trượt và lớp lớp quai êm chân chống nước TD2",278000,278000,0,0
TIKI,giay-dep-nam,73101711,"Dép Sục Nhựa Dẻo Lỗ Tổ Ong ĐI Mưa Bít Mũi Nam Nữ (Màu Ngẫu Nhiên) - SL1102",59000,59000,0,0
TIKI,giay-dep-nam,91379871,"Giày lười vải nam, giày lười dáng thể thao, vải lưới thoáng mát, đế cao su nguyên khối êm, bền, ma sát cao G146",149000,219000,70000,32
TIKI,giay-dep-nam,179061202,"Dép sục cross nam nữ oflaod màu nâu đi mưa, thoáng, bền, hàng xịn, full box",379000,379000,0,0
TIKI,giay-dep-nam,26666303,"Dép Nam BIGGBEN Da Bò Thật Cao Cấp DN195",299000,370000,71000,19
TIKI,giay-dep-nam,107802097,"Găng tay đánh bóng vệ sinh và làm sạch giày XIMO (XGTDG01)",18000,18000,0,0
TIKI,giay-dep-nam,8407712,"Giày Sandal Nam BIGGBEN Da Bò Thật SD68",339000,400000,61000,15
TIKI,giay-dep-nam,110993474,"Giày thể thao nam, Giày độn full trắng CK2025",245000,245000,0,0
TIKI,giay-dep-nam,111000550,"Giày Thể Thao Nam S08 Thoáng Khí Đế Cao Su Tăng Chiều Cao",175000,250000,75000,30
TIKI,giay-dep-nam,74465943,"Dép nam Pierre Cardin PCMFWLE 142bBLK",1790000,1790000,0,0
TIKI,giay-dep-nam,144179403,"Dép lào Thái xịn loại 1 chính hãng nhập Thái đủ màu dép tông lào thái dép xỏ ngón thái dép kẹp thái lan xỏ ngón nam",59999,59999,0,0
TIKI,giay-dep-nam,69690193,"Giày sneaker cao cổ nam, họa tiết, style Korea",190000,190000,0,0
TIKI,giay-dep-nam,122711907,"Giày Lười Sục Nam Da Bò Chuẩn, Có bảo hành nổ da, bong keo , gãy đế, phom dáng siêu đẹp GD18",279000,430000,151000,35
TIKI,giay-dep-nam,77135977,"Dây Giày Sneaker Tròn Màu Trắng",15000,15000,0,0
TIKI,giay-dep-nam,182317373,"Giày Lười Nam Lỗ Thoáng Khí  K207 Đi 4 Mùa (có 2 màu)",103530,178500,74970,42
TIKI,giay-dep-nam,24840960,"Dây giày cao su siêu thông minh SENT CHARM – Bộ 16 dây",60000,60000,0,0
TIKI,giay-dep-nam,5469215,"Sandal Nam BIGGBEN Da Bò Thật SD12",349000,400000,51000,13
TIKI,giay-dep-nam,173347767,"Bàn Chải Đánh Bóng Giày Lông Heo BCDG27",35000,70000,35000,50
TIKI,giay-dep-nam,125158874,"Giầy tây giày lười nam hàn quốc da bóng đai én",198000,198000,0,0
TIKI,giay-dep-nam,193054945,"Giày thể thao nam, giày nam vải sợi thể thao cao cấp c80",200000,200000,0,0
TIKI,giay-dep-nam,171193582,"DÉP NAM QUAI NGANG DA BÒ CAO CẤP VA2004",199000,349000,150000,43
TIKI,giay-dep-nam,47908667,"Dây Giày Dẹt Đầu Bọc Nhựa",38000,38000,0,0
TIKI,giay-dep-nam,107801612,"Cặp Lót Giày Đệm Khí Tăng Chiều Cao XIMO XL10 Êm Chân và Thoáng Khí",45000,84000,39000,46
TIKI,giay-dep-nam,47896033,"Giày thể thao nam sneaker nam mẫu mới nhất V212",59000,59000,0,0
TIKI,giay-dep-nam,71896029,"Giày cao cổ nam G277",250000,250000,0,0
TIKI,giay-dep-nam,6132855,"Dép Nam BIGGBEN Da Bò Thật DN35",339000,400000,61000,15
TIKI,giay-dep-nam,167934910,"Chai Dung Dịch Vệ Sinh Giày Sneaker Prenium Shoe Cleaner XIMO 120ml Làm Sạch Chuyên Sâu XXI05",109000,180000,71000,39
TIKI,giay-dep-nam,126028887,"Dép Da Nam, Dép Quai Ngang Da Bò SUNPOLO AQN027 (Đen)",550000,550000,0,0
TIKI,giay-dep-nam,125732767,"Xi đánh giày dạng sáp Star Wax Shoe, làm mềm, làm bóng, bảo vệ và gìn giữ da (48ml)-Nhập khẩu chính hãng Yuppies",30000,40000,10000,25
TIKI,giay-dep-nam,54991869,"Bình Xịt Vệ Sinh Giày Cao Cấp TP",50000,50000,0,0
TIKI,giay-dep-nam,161979489,"Giày Nhựa Dẻo Lỗ Tổ Ong Đi Mưa Bít Mũi Nam, Nữ (Xanh/ Xám)",58000,58000,0,0
TIKI,giay-dep-nam,101655800,"Giày tây nam công sở Sans137 chất vải canvas êm chân mũi nhọn đen size nhỏ 37 bigsize 44 45 46 47 48 hàn quốc trẻ trung",359000,359000,0,0
TIKI,giay-dep-nam,3239231,"Dép nhựa nam nữ 2 quai ngang 2 khóa SM046",68000,75000,7000,9
TIKI,giay-dep-nam,125874349,"Kem Bả Ma Tít Heavy Filler Vá Sửa Chữa Vết Rách, Vết Rạn, Nứt, Bong Tróc Trên Da Giày, Ghế, Túi Ví XIMO XI09",75000,100000,25000,25
TIKI,giay-dep-nam,179912209,"Dây Giày Thể Thao Bản Dẹt Nhiều Kích Thước Loại Đẹp Nhiều Màu Phù Hợp 99% Các Loại Giày DG03",8000,8000,0,0
TIKI,giay-dep-nam,172581808,"Bình xịt nano chống thấm nước, chất bẩn, không độc hại XIMO PROTECT XI22",74000,120000,46000,38
TIKI,giay-dep-nam,101657341,"Bộ Đánh Giày Đẹp-Sang-Gọn Sans931. Sans Shop",108000,108000,0,0
TIKI,giay-dep-nam,161496880,"Giày lười vải nam thoáng khí cho bố - Giày thể thao nam trung niên cao cấp RICKYMEN M8B",245000,245000,0,0
TIKI,giay-dep-nam,38410801,"Bộ Vệ Sinh Giày Enito Total Cleaner Kit - Chuyên Dùng Để Vệ Sinh Giày Sneaker",280000,280000,0,0
TIKI,giay-dep-nam,107801536,"Bàn chải lông ngựa quẹt xi đánh giày chuyên dụng XIMO (XBCDG08)",54000,54000,0,0
TIKI,giay-dep-nam,250335110,"Giày Mọi Nam BiGGBEN Da Bò Thật Cao Cấp GM206",699000,720000,21000,3
TIKI,giay-dep-nam,186434946,"Túi than hoạt tính khử mùi giày - 100% từ gáo dừa Bến Tre (Hộp 2 túi) - Hapaku",119000,150000,31000,21
TIKI,giay-dep-nam,119720901,"Giày nam thể thao, giầy sneaker nam da lì chất siêu đẹp, giày bảo hộ AVI - 381",99000,99000,0,0
TIKI,giay-dep-nam,169865725,"Lót Giày Da Bò Thật-L06 (Combo 2Đôi) Tấm Lót Giày Giúp Ôm Chân Khi Giày Dãng Rộng,Thấm Hút Mồ Hôi Khử Mùi Hiệu Quả -Giày SAGO’S",70000,70000,0,0
TIKI,giay-dep-nam,126303957,"Đón gót giày gỗ muồng VIP - hàng xuất khẩu - được sơn mài cầm chắc tay - Đón giày mọi tư thế cho Nam & Nữ",84550,89000,4450,5
TIKI,giay-dep-nam,172457050,"Giày Sandal Nam The Bily 3 Quai Ngang - Màu Đen BL04",349000,349000,0,0
TIKI,giay-dep-nam,161393149,"Bàn Chải Đánh Giày Da, Lông Ngựa 100%, Vệ Sinh Giày, Đánh Bóng Giày Da, Đồ Da, Ghế Da",132000,132000,0,0
TIKI,giay-dep-nam,105523135,"Giày lười sục nam da bò mùa hè mềm mại ôm chân chỉ khâu mạnh mẽ nam tính GD16",249000,249000,0,0
TIKI,giay-dep-nam,195283840,"Giày dép Sandal Vento VEGA II Nam Nữ đi chơi đi học đi làm NB10602",345000,345000,0,0
TIKI,giay-dep-nam,105378132,"Dép Nam Chất Cao Su Hở Mũi Độc LẠ",148500,148500,0,0
TIKI,giay-dep-nam,177662569,"Dép Nam Quai Ngang Da Bò Thật BIGGBEN Cao Cấp DN306",289000,350000,61000,17
TIKI,giay-dep-nam,58704904,"DÉP NAM QUAI NGANG GIA VY TL346",195000,195000,0,0
TIKI,giay-dep-nam,110353954,"Giày tây nam công sở _màu đen ̣( buột dây) - sản phẩm hót nhất hiện nay",149000,149000,0,0
TIKI,giay-dep-nam,171009850,"Dép tổ ong XÁM vật liệu EVA siêu bền, siêu nhẹ, chống trơn trượt, Form SIZE LỚN CHÂU ÂU",63000,85000,22000,26
TIKI,giay-dep-nam,7303617,"Dép Nam BIGGBEN Da Bò Thật Cao Cấp DN80",339000,450000,111000,25
TIKI,giay-dep-nam,186619864,"Dép sục nhựa PUD siêu nhẹ siêu bền xịn",109000,109000,0,0
TIKI,giay-dep-nam,75329130,"Giày da nam thật, giày trung niên, chống trơn trượt ôm chân phong cách sang trọng mã 36274",399000,759000,360000,47
TIKI,giay-dep-nam,55032368,"Dép sandal nam Trường Hải da bò cao cấp mềm mại không bong tróc màu đen đế PU siêu nhẹ cao 5cm SDN001",292000,319000,27000,8
TIKI,giay-dep-nam,14397310,"Túi đựng giày du lịch tiện lợi",48000,48000,0,0
TIKI,giay-dep-nam,7997300,"Giày Converse Chuck Taylor All Star 1970s Hi Top - 162050V",2000000,2000000,0,0
TIKI,giay-dep-nam,137822550,"Dép Xỏ Ngón Nam HÀ NAM Da Bò Thật Cao Cấp DNA2143",360000,360000,0,0
TIKI,giay-dep-nam,115852451,"Chai vệ sinh giày đồ da, túi ví, áo, ghế da giúp làm sạch, dưỡng ẩm chống mốc XIMO XI03",58000,65000,7000,11
TIKI,giay-dep-nam,14235967,"Dụng cụ xỏ giày cao cấp - Hàng nội địa Nhật",52000,52000,0,0
TIKI,giay-dep-nam,142349843,"Giày Lười Da Bò Nam Cao Cấp, Da Chuẩn, Kiểu Dáng Sang Trọng Quý Ông GD20",349000,450000,101000,22
TIKI,giay-dep-nam,7997237,"Giày Converse Chuck Taylor All Star 1970s Low Top - 162058V",1900000,1900000,0,0
TIKI,giay-dep-nam,105523603,"Giày lười sục nam da bò mềm mại mùa hè ôm chân phong cách hiện đại GD17",249000,249000,0,0
TIKI,giay-dep-nam,92480080,"MLB - Giày mule Playball Origin 32SHS1111-50W",1690000,1690000,0,0
TIKI,giay-dep-nam,155694547,"Sandal VENTO Nam Quai Ngang NB18",345000,345000,0,0
TIKI,giay-dep-nam,8512482,"Túi hút ẩm, khử mùi hôi, nấm mốc, kháng khuẩn cho giày Enito Freshener",90000,90000,0,0
TIKI,giay-dep-nam,74621200,"Giày Tây Nam Phối Da Bóng Xếp Ngấn, Đế Cao, Đã Khâu",238500,238500,0,0
TIKI,giay-dep-nam,101291459,"Giày lười nam - Slip on nam vải - Mã A7522",350000,350000,0,0
TIKI,giay-dep-nam,169865129,"Lót Giày Da Bò Thật-L05 Tấm Lót Giày Giúp Ôm Chân Khi Giày Dãng Rộng,Thấm Hút Mồ Hôi Khử Mùi Hiệu Quả -Giày SAGO’S",43000,43000,0,0
TIKI,giay-dep-nam,129351813,"Giày Sandal Vento Nam Quai Ngang dạo phố đi chơi đi học NV5616",270000,270000,0,0
TIKI,giay-dep-nam,171535303,"Dép quai ngang nam nữ M Masler-MT màu đỏ 4 sọc trắng với lớp quai êm chân và đế chống nước DT4",310000,310000,0,0
TIKI,giay-dep-nam,9809445,"Giày Sneaker Unisex Old Skool Vans - VN000D3HY28",1850000,1850000,0,0
TIKI,giay-dep-nam,134754200,"Giày da nam, giày oxford công sở Bụi Leather G105 - Da bò Nappa cao cấp",515000,865000,350000,40
TIKI,giay-dep-nam,105779273,"Giày Thể Thao Nam S31 Leo Núi Màu Xanh Rêu Tăng Cương Ma Sát",175000,250000,75000,30
TIKI,giay-dep-nam,138184305,"Giày Nam Công Sở không dây Pierre Cardin da bò PCMFWL730",3490000,3490000,0,0
TIKI,giay-dep-nam,7995643,"Giày Converse Chuck Taylor All Star Classic Low Top - 121178",1450000,1450000,0,0
TIKI,giay-dep-nam,177164344,"Giày Lười Unisex NATIVE Ad Jefferson Shell White",1400000,1400000,0,0
TIKI,giay-dep-nam,170125513,"MLB - Giày thể thao Bigball Chunky Monogram 3ASHCM11N",3490000,3490000,0,0
TIKI,giay-dep-nam,179505528,"Giày Lười Unisex NATIVE Jefferson",1400000,1400000,0,0
TIKI,giay-dep-nam,168789208,"Giày Bảo Hộ Lao Động  AOX BD_0078 Da Lộn Mũi Thép, Đế Lót Thép Chống Đinh Chống Trơn Giày Công Trình Siêu Bền",319000,490000,171000,35
TIKI,giay-dep-nam,173253051,"Giày thể thao nam Vải phong cách Hàn Quốc 21094",143900,143900,0,0
TIKI,giay-dep-nam,177845164,"Giày Nam, Giày Sneaker Nam, Chất Liệu Vải polyester (gió) chống thấm, Không Phai Màu NEW 2022",169000,169000,0,0
TIKI,giay-dep-nam,129352203,"Giày Sandals Vento Nam Nữ Quai Ngang dạo phố/đi chơi/đi học/đi làm NV9801",365000,365000,0,0
TIKI,giay-dep-nam,82494072,"Dép da nam DUWA TNT012S - Hàng chính hãng - Quai ngang đế đúc",145000,289000,144000,50
TIKI,giay-dep-nam,144512424,"Giày Lười Nam Da Nubuck Tomoyo TMN08001",948000,2890000,1942000,67
TIKI,giay-dep-nam,192138446,"Dép Nam Da Bò Thật BIGGBEN Cao Cấp DN317",349000,400000,51000,13
TIKI,giay-dep-nam,15316856,"Kem chăm sóc da giày Saphir Creme Surfine 50ml",250000,250000,0,0
TIKI,giay-dep-nam,158777211,"Giày Nam Pierre Cardin - PCMFWLF 753",990000,2490000,1500000,60
TIKI,giay-dep-nam,151749073,"Dép nam quai ngang da bò thật BIGGBEN cao cấp DN300",299000,400000,101000,25
TIKI,giay-dep-nam,174385257,"GIÀY LƯỜI DA BÒ NAM CAO CẤP VATIS VA2022",359000,559000,200000,36
TIKI,giay-dep-nam,76164066,"HAVAIANAS - Dép unisex Top 4000029",499000,499000,0,0
TIKI,giay-dep-nam,73359677,"Giày Thể Thao Nam Nâng Chiều Cao - Đế Cao Su Siêu Mềm - Chất Liệu Vải Cao Cấp, Bền Màu - Full Size - GTTN-47",99750,105000,5250,5
TIKI,giay-dep-nam,103808027,"Giày Nam, Giày Thể Thao Nam xuyên không A1968 - DF02",230000,230000,0,0
TIKI,giay-dep-nam,46116246,"Giày Tây Nam Công Sở Da Cao Cấp Sang Trọng Tăng 3.5cm CTGD0001",129000,129000,0,0
TIKI,giay-dep-nam,191657189,"Giày nam Derby công sở da bò nappa cao cấp G113- Bụi leather- hộp sang trọng - Bảo hành 12 tháng",515000,840000,325000,39
TIKI,giay-dep-nam,190321339,"Dép Nam Quai Ngang Đúc Liền Hot Trend DP14",79000,79000,0,0
TIKI,giay-dep-nam,76418296,"Sneaker DX2 - Giày Thể Thao Nam",94050,99000,4950,5
TIKI,giay-dep-nam,191690638,"Giày lười da nam công sở Bụi Leather G120 - Da bò Nappa cao cấp - Bảo hành 12 tháng",499000,840000,341000,41
TIKI,giay-dep-nam,136433773,"Giày thể thao nam nữ chạy bộ, tập gym, đi chơi size từ 35 đến 44",250000,250000,0,0
TIKI,giay-dep-nam,104367403,"Giày thể thao nam, Giày sneaker đế trong - Q01",220000,220000,0,0
TIKI,giay-dep-nam,68135683,"  Giày thể thao nam, Giày nam tăng chiều cao 5cm Phản Quang WATAHHH cực chất CK01",175000,175000,0,0
TIKI,giay-dep-nam,176692133,"Dép Nam Chữ H Cao Cấp Mẫu Hot KEEDO KD822",560000,560000,0,0
TIKI,giay-dep-nam,192986021,"Giày Thể Thao Pierre Cardin - PCMFWMG 903",2490000,2490000,0,0
TIKI,giay-dep-nam,59206687,"GIày Sandal Nam Da Bò BIGGBEN Cao Cấp SD105",349000,450000,101000,22
TIKI,giay-dep-nam,134775147,"Giày lười da nam công sở Bụi Leather G109 - Da bò Nappa cao cấp - Bảo hành 12 tháng",515000,840000,325000,39
TIKI,giay-dep-nam,196873069,"[Phiên Bản Kỷ Niệm 40 Năm] Giày Thể Thao Nam Hunter X DSMH09700DEN (Đen)",1068000,1187000,119000,10
TIKI,giay-dep-nam,192889133,"Sticker nhựa jibbitz unisex Crocs Star Wars Character",795000,795000,0,0
TIKI,giay-dep-nam,147272300,"Giày thể thao Bitis nam",695000,695000,0,0
TIKI,giay-dep-nam,155595033,"Giày nam buộc dây thời trang trẻ trung hiện đại phong cách Hàn Quốc mã 5560",409000,799000,390000,49
TIKI,giay-dep-nam,175877407,"GIÀY LƯỜI DA BÒ NAM CAO CẤP VATIS VA2027",349000,559000,210000,38
TIKI,giay-dep-nam,177164749,"Giày Lười Unisex NATIVE Ad Jefferson",1400000,1400000,0,0
TIKI,giay-dep-nam,89506697,"Giày Nam Sapo Pierre Cardin PCMFWLE707GLD",1990000,1990000,0,0
TIKI,giay-dep-nam,76119429,"Giày cao cổ nam G527",230000,230000,0,0
TIKI,giay-dep-nam,122473637,"Giày Tây Nam không dây Pierre Cardin da bò PCMFWL 730 - Xanh Navy",3490000,3490000,0,0
TIKI,giay-dep-nam,66134336,"Dép quai hậu nam 6000 kiểu dáng phong cách Hàn Quốc hiện đại",229000,399000,170000,43
TIKI,giay-dep-nam,102796795,"Dép Cao Su Nam Nữ Độn Đế 3cm Cực ( Cực Phẩm New 2021 )",29000,29000,0,0
TIKI,giay-dep-nam,167488528,"Dép kẹp nam dép tông lào mang đi biển dép mang nhà tắm dép lào thái mang trong nhà siêu bền nhẹ dép tông nam tông lào nam",67500,67500,0,0
TIKI,giay-dep-nam,105695828,"Giày Thể Thao Nam S09 Màu Đen  Thoáng Khí Sang Trọng",119000,119000,0,0
TIKI,giay-dep-nam,65068840,"Dép chữ h nam D26 - Dép nam quai ngang cực đẹp",159000,298000,139000,47
TIKI,giay-dep-nam,98297666,"(SIÊU RẺ ĐẸP)GIÀY THỂ THAO NAM Sneakes hd1",71250,75000,3750,5
TIKI,giay-dep-nam,102796851,"Giày Nam Cao Cổ, Giày Sneaker Thể Thao Nam Phong Cách Hàn Quốc - 8876",99000,99000,0,0
TIKI,giay-dep-nam,97585552,"Giày tây nam da nhám, Da mềm cao cấp, Đế cao 3cm, Có khâu đế chắc chắn, Mã X084 màu đen, Hàng Việt",210000,210000,0,0
TIKI,giay-dep-nam,216868045,"Xi Nước Đánh  Giày Dép Túi xách Da Màu Đen,Màu Nâu Xi KiWi Làm Mới Đồ Da Tiện Lợi Nhanh Chống Dễ Dàng Sử Dụng-XN09",78000,78000,0,0
TIKI,giay-dep-nam,46175669,"Giày Tây Nam Da Bóng Lê Sang Khóa Vàng Lịch Lãm",223500,223500,0,0
TIKI,giay-dep-nam,153546170,"Lót khử mùi than hoạt tính",30000,30000,0,0
TIKI,giay-dep-nam,20297082,"dép cao su nam nữ 2 quai ngang",300000,300000,0,0
TIKI,giay-dep-nam,158774734,"Giày Nam Pierre Cardin - PCMFWLF 751",2990000,2990000,0,0
TIKI,giay-dep-nam,134776866,"Giày lười da nam công sở Bụi Leather G110 - Da bò Nappa cao cấp - Bảo hành 12 tháng",515000,810000,295000,36
TIKI,giay-dep-nam,150762145,"Giày Sandal Nam The Bily Quai Chéo Đôi - Màu Đen BL02D",329000,329000,0,0
TIKI,giay-dep-nam,186071797,"Giày đốc nam da mềm, đế cao khâu đế thanh lịch",350000,350000,0,0
TIKI,giay-dep-nam,112190019,"Giày Thể Thao Nam SSN33 chất liệu thoáng khí khử mùi hôi chân,đi chơi,tập gym thể thao",169100,178000,8900,5
TIKI,giay-dep-nam,42377512,"Dép quai ngang nam GIAVY - TL484",195000,195000,0,0
TIKI,giay-dep-nam,131473035,"Giày tây nam da mềm, tăng bí mật 6-7cm, đế cao su khâu sẵng, size 39 đến 43",350000,350000,0,0
TIKI,giay-dep-nam,101656782,"Giày Tăng Chiều Cao 5cm Giầy Công Sở Da Bò Sans114",99999,99999,0,0
TIKI,giay-dep-nam,73864652,"Giày Tây Lê Sang Nam Da Mềm, Đế Khâu, Cao 3.5cm",250000,250000,0,0
TIKI,giay-dep-nam,73989385,"Sandal nam cao cấp Pierre Cardin PCMFWLE137BRW",1990000,1990000,0,0
TIKI,giay-dep-nam,101291390,"Giày lười nam - Slip on nam vải - Mã A7200",350000,350000,0,0
TIKI,giay-dep-nam,145236329,"GIÀY ĐI MƯA, ĐI BIỂN, DU LỊCH GIAY-030A-01",339000,339000,0,0
TIKI,giay-dep-nam,180364270,"Dép Thái Lan Nam Xỏ Ngón Gambol 11267",220000,220000,0,0
TIKI,giay-dep-nam,105680769,"Giày tây nam cao cấp GT01, Giày da nam đơn giản lịch lãm, Tặng kèm 2 đôi tất xanh",185000,185000,0,0
TIKI,giay-dep-nam,150788748,"Giày Sandal Nam The Bily Quai Chéo - Màu Đen BL01D",319000,319000,0,0
TIKI,giay-dep-nam,80960314,"Dép lưới siêu nhẹ quai ngang nam nữ, dép đôi unisex",89000,89000,0,0
TIKI,giay-dep-nam,26329545,"Giày Tây Nam Da Bò Mã CS-03",450000,900000,450000,50
TIKI,giay-dep-nam,82959273,"Combo 2 đón gót giày siêu xinh- DG0022",30000,30000,0,0
TIKI,giay-dep-nam,51370895,"Dép Nam Quai Ngang Da Bò Thật Cao Cấp DNA30",400000,400000,0,0
TIKI,giay-dep-nam,179808008,"Giày Snea.ker Nam, Giày Nam Cao Cấp Mới Nhất 2022",169000,169000,0,0
TIKI,giay-dep-nam,168789037,"Giày Bảo Hộ Lao Động Kiểu Thể Thao 2TH BD_0056 Mũi Thép, Đế Lót Thép CHỐNG ĐINH/CHỐNG TRƠN GIÀY CÔNG TRÌNH SIÊU BỀN",359000,590000,231000,39
TIKI,giay-dep-nam,57813185,"Giày tây nam Trường Hải da bò thật không bong tróc đế cao su không trơn màu nâu GTN05982",467000,499000,32000,6
TIKI,giay-dep-nam,57325782,"Giày Bata Học Thể Dục Nam Nữ Cao Cấp",250000,250000,0,0
TIKI,giay-dep-nam,73389831,"Cao lau đa năng, sáp lau đa năng tinh dầu,Sáp lau túi xách , giày dép , bàn ghế da 206740-2 (trắng)",13000,19800,6800,34
TIKI,giay-dep-nam,108382637,"Bàn Chải Đánh Giày Tròn Nhựa Vân Gỗ Cao Cấp Đánh Bóng Giày Và Vệ Sinh Đồ Da",25000,45000,20000,44
TIKI,giay-dep-nam,102796857,"Giày Nam, Giày Sneaker Thể Thao Nam Mới 2021",79000,79000,0,0
TIKI,giay-dep-nam,97585571,"{ĐẾ KHÂU CỰC BỀN} Giày lười da nam -  Giày da nam công sở dập vân cá sấu - Đế cao su non cao 3cm, Mã x091, Hàng Việt",210000,210000,0,0
TIKI,giay-dep-nam,105684590,"Xi đánh giày cao cấp giúp đôi giày sáng bóng tức khắc",120000,120000,0,0
TIKI,giay-dep-nam,76196742,"Giày Sneaker Nam, Vải Mềm Ôm Chân Họa Tiết Cực Ngầu, Đế Cao Su Đi Siêu Êm G174",59000,90000,31000,34
TIKI,giay-dep-nam,168789212,"Lót Giày Hương Quế Khử Mùi Hôi Hiệu Quả",15000,15000,0,0
TIKI,giay-dep-nam,171185004,"GIÀY SỤC NAM DA BÒ CAO CẤP VA2003",249000,459000,210000,46
TIKI,giay-dep-nam,170771081,"Xi kem đánh giày chuyên bổ sung màu và dưỡng cho da Cream Surfine Saphir 50ml (XDG07)",250000,420000,170000,40
TIKI,giay-dep-nam,40246743,"Dép bít mũi nam da bò cao cấp Trường Hải BM215",403000,459000,56000,12
TIKI,giay-dep-nam,177913884,"Giày Da Nam Công Sở Tăng Chiều Cao Mandoo Da Bò Thật Cao Cấp NB6",1350000,1350000,0,0
TIKI,giay-dep-nam,88821171,"Giày Da nam cực chất xả kho giá gốc - giày lười nam x076",210000,210000,0,0
TIKI,giay-dep-nam,204131582,"CONVERSE - Giày sneakers cổ thấp unisex Chuck Taylor All Star Specialty 1U647-AV30_WHITE",1450000,1450000,0,0
TIKI,giay-dep-nam,76196647,"Giày Sneaker Nam, Giày Vải Nam Buộc Dây , Đế Cao Su Kiểu Dáng Độc Lạ G176",59000,90000,31000,34
TIKI,giay-dep-nam,98610966,"Giày Sneaker Thể Thao Nam HiNiTi T008 Dáng Đẹp- Năng Động Tặng Tất",99000,99000,0,0
TIKI,giay-dep-nam,50240762,"Lót độn mũi giày chống nứt da, chống gãy mũi, chống xẹp mũi và giữ dáng mũi giày căng phồng PK58",30000,60000,30000,50
TIKI,giay-dep-nam,88821204,"Giày Da nam cực chất xả kho giá gốc mã - giày lười nam -MÃ L119",210000,210000,0,0
TIKI,giay-dep-nam,75990362,"Dép quai ngang nam da bò chính hãng Trường Hải đế cao 3.5cm màu nâu may viền chắc chắn DN152",315000,359000,44000,12
TIKI,giay-dep-nam,97950748,"GIÀY NHỰA NAM FITTOP GIAY-030A-01",297700,297700,0,0
TIKI,giay-dep-nam,90351916,"Giày Lười... Nam Da Bò Cao Cấp Da Thật Đế Cao Su Siiêu nhự Cực Bền Hàng Việt Nam",338000,338000,0,0
TIKI,giay-dep-nam,101292107," Giày lười nam - Slip on nam da - Mã S232",350000,350000,0,0
TIKI,giay-dep-nam,113767080,"Giày Thể Thao Nam Abu SSN5 chất liệu vải lỗ thoáng khí-mỏng nhẹ-đế đúc cao su nguyên khối (2 mầu giá rẻ)",103550,109000,5450,5
TIKI,giay-dep-nam,196344660,"Giày nam da bò thật nguyên tấm màu ghi đậm",780000,780000,0,0
TIKI,giay-dep-nam,133039068,"Dép Nam Bít Mũi Da Bò SUNPOLO ABI019 (Đen, Nâu)",580000,580000,0,0
TIKI,giay-dep-nam,207508136,"Giày da nam trung niên, Giày tá GT01",159000,159000,0,0
TIKI,giay-dep-nam,141232483,"Giày mọi rọ nam da bò thật BIGGBEN cao cấp GM263",649000,760000,111000,15
TIKI,giay-dep-nam,46689688,"Xi Đánh Bóng Giày Da, Ghế Sofa, Áo Khoác Da, Túi Xách Và Các Loại Đồ Da Manco 40g Cao Cấp",35000,35000,0,0
TIKI,giay-dep-nam,133235615,"Dép Thái Lan Nam Cao Su Thời trang KARDAS - Street 3.1",210000,210000,0,0
TIKI,giay-dep-nam,115690938,"Giày Sục Nam Bảo Hân Da Bò Mặt Nhung Mã GMS-01",450000,900000,450000,50
TIKI,giay-dep-nam,189326595,"Dép Đế Trấu Quai Ngang Nam 2 Khóa The BiLy Da PU Đen - BL01T",249000,249000,0,0
TIKI,giay-dep-nam,6136987,"Dép Xỏ Ngón Nam BIGGBEN Da Bò Thật DK05",249000,400000,151000,38
TIKI,giay-dep-nam,90726651,"Giày tây nam tăng chiều cao da bò thật GC02",590000,1180000,590000,50
TIKI,giay-dep-nam,68770423,"Giày DINCOX Sneaker Nam/Nữ D34 White",530000,530000,0,0
TIKI,giay-dep-nam,4167621,"Giày lười vải nam - GV010",99000,99000,0,0
TIKI,giay-dep-nam,101869422,"DÉP QUAI NGANG NAM DA CAO CẤP, MAY QUAI CHẮC CHẮN BAO ĐI MỌI ĐỊA HÌNH",49000,70000,21000,30
TIKI,giay-dep-nam,129351725,"Dép Kẹp Nam Hiệu Vento Big Size dạo phố/đi chơi/du lịch CL01",235000,235000,0,0
TIKI,giay-dep-nam,168072838,"Giày thể thao sneaker nam Sans202 trắng sọc bạc",50000,50000,0,0
TIKI,giay-dep-nam,195519967,"Giày Nam Thể Thao, Giày Sneaker Cao Cấp Mới Nhất - Fullbox",179000,179000,0,0
TIKI,giay-dep-nam,115840284,"Giày tây nam da thật đế khâu siêu bền",160000,160000,0,0
TIKI,giay-dep-nam,71893039,"Chai xịt bọt tuyết vệ sinh giày dép tẩy trắng cao cấp SNOKERGNG",33999,33999,0,0
TIKI,giay-dep-nam,74295718,"Giày Sandal Cao Su Chống Nước Thời Trang Unisex",99000,99000,0,0
TIKI,giay-dep-nam,67182493,"Giày nam sneaker thể thao - Giày tăng chiều cao mẫu mới hot trend hàn quốc QA364",128000,128000,0,0
TIKI,giay-dep-nam,163725221,"Dép Đôi Dép Nam Nữ Quai Ngang SUPERSTAR",89000,89000,0,0
TIKI,giay-dep-nam,100770794,"Giày Sneaker Nam Buộc Dây Cao Cấp Da Thật Xuất Khẩu VN Da Bò Đế Mềm",450000,900000,450000,50
TIKI,giay-dep-nam,88821224,"Giày Da nam cực chất xả kho giá gốc - giày lười nam G012 CHUÔNG",210000,210000,0,0
TIKI,giay-dep-nam,156215483,"GIÀY LƯỜI GIÀY SỤC NAM DA BÒ THẬT 100",500000,500000,0,0
TIKI,giay-dep-nam,177190483,"Dép Nam quai ngang nam nữ Thái Lan  AH81 , siêu nhẹ, siêu bền",190000,190000,0,0
TIKI,giay-dep-nam,190511573,"Dép nam đế may sẵn da bò quai ngang cao cấp KEEDO TN-NB701",920000,920000,0,0
TIKI,giay-dep-nam,147206921,"Giày Sandal Nam The Bily Quai Chéo Đôi - Xám Thổ Cẩm BL02XTC",329000,329000,0,0
TIKI,giay-dep-nam,144179447,"Dép lào xốp VAC nữ dép xỏ ngón dép tông lào siêu nhẹ siêu bền mang trong nhà đủ màu sắc",49500,49500,0,0
TIKI,giay-dep-nam,79730828,"GIÀY LƯỜI NAM DA BÒ 100%, HÀNG CAO CẤP, ĐI RẤT ÊM CHÂN, KHÔNG HÔI",449000,600000,151000,25
TIKI,giay-dep-nam,108382638,"Giày Thể Thao Nam Sneaker Tập Gym Thể Dục Dã Ngoại Đi Làm Đi Học Êm Chân Mềm Giá Rẻ Thoáng Chân G184",62000,62000,0,0
TIKI,giay-dep-nam,107801685,"Bàn chải đánh giày phiên bản hình bầu dục XIMO (XBCDG05)",39000,50000,11000,22
TIKI,giay-dep-nam,68395396," Xịt thần thánh làm bóng da .dưỡng da, Nước xịt lau sạch mốc tạo bóng đồ da. Xi dưỡng đồ da cao cấp.",57000,57000,0,0
TIKI,giay-dep-nam,76109447,"Giày Sneaker Đế Cao Nam Nữ ( Xám Sọc Đen )",223500,223500,0,0
TIKI,giay-dep-nam,42375448,"Dép kẹp nam GIAVY - TL329",195000,195000,0,0
TIKI,giay-dep-nam,107801451,"Đế, lót giày tăng chiều cao Silicon êm chân tích hợp keo bám L12 XIMO chính hãng",40000,70000,30000,43
TIKI,giay-dep-nam,68368093,"Dép bít mũi nam da bò thật HÀ NAM cao cấp GSB2043",420000,420000,0,0
TIKI,giay-dep-nam,182301240,"Giaỳ lười nam,giày chất liệu lưới vải thoáng khí đế kếp siêu nhẹ đi êm (2 mầu)",88000,88000,0,0
TIKI,giay-dep-nam,150760547,"Giày Sandal Nam The Bily Quai Ngang - Màu Xám BL03X",339000,339000,0,0
TIKI,giay-dep-nam,161393154,"Keo Dán Giày Dép Chuyên Dụng SEAGLUE, Không Màu, Chịu Lực, Chịu Nước tốt",72000,72000,0,0
TIKI,giay-dep-nam,175885112,"GIÀY LƯỜI DA BÒ NAM CAO CẤP VATIS VA2028",349000,559000,210000,38
TIKI,giay-dep-nam,89401444,"Crep Sneaker Shield - Bảo Vệ Mũi Giày",320000,320000,0,0
TIKI,giay-dep-nam,171535266,"Dép quai ngang nam nữ M Masler-MT màu sắc trời hè với lớp đế bền bỉ, chống nước và quai êm chân BTH",298000,298000,0,0
TIKI,giay-dep-nam,101291706,"Giày lười nam - Slip on nam da - Mã A5192",350000,350000,0,0
TIKI,giay-dep-nam,37947630,"Giày Tây Đông Hải - G0132",1350000,1350000,0,0
TIKI,giay-dep-nam,49680706,"Dép Nam đi mưa chống trơn - T0165",250000,250000,0,0
TIKI,giay-dep-nam,174399492,"Giày da nam độn đế 10cm Sans117 da bò thật giầy tây công sở tăng chiều cao 8cm không lộ âu đi làm size cỡ nhỏ 37 cao cấp",899000,899000,0,0
TIKI,giay-dep-nam,163884917,"Giày lười nam Đông Hải da bò cao cấp  với độ sần tự nhiên tăng vẻ nam tính -   G0344",1490000,1490000,0,0
TIKI,giay-dep-nam,158999649,"Giày Nam - PCMFWLF 512",2990000,2990000,0,0
TIKI,giay-dep-nam,189557811,"Dây giày tròn to 9mm Sans947 140cm 160cm 180cm thể thao sneaker sports shoelaces đen nâu trắng be xanh đỏ",29999,29999,0,0
TIKI,giay-dep-nam,163550697,"BÌNH XỊT KHỬ MÙI GIÀY, CHỐNG HÔI CHÂN NCE SIÊU KHÔ THOÁNG",25000,25000,0,0
TIKI,giay-dep-nam,190792898,"Giày sandal nam da bò thật BIGGBEN cao cấp SD123",329000,400000,71000,18
TIKI,giay-dep-nam,171535329,"Dép quai ngang nam nữ M Masler-MT Phản Quang với chất liệu đế đi êm chân và chống trượt an toàn PQ1",290000,290000,0,0
TIKI,giay-dep-nam,145236198,"Giày Nhựa Cột Dây Cao Cấp Siêu Êm, Giày Nhựa Đẹp GIAY-003-3",529000,529000,0,0
TIKI,giay-dep-nam,55063108,"Giày Sandal Nam Da Bò BIGGBEN Cao Cấp SD102",329000,450000,121000,27
TIKI,giay-dep-nam,41657082,"Cây xở giầy gỗ",153000,153000,0,0
TIKI,giay-dep-nam,171535511,"Dép quai ngang nam nữ M Masler-MT màu sắc biển cả với lớp đế chống trơn và quai êm chân MBC",298000,298000,0,0
TIKI,giay-dep-nam,32592367,"Bộ dụng cụ đánh giày 7 món si đen tặng kèm dụng cụ ngoáy tai có đèn tiện lợi",82000,82000,0,0
TIKI,giay-dep-nam,171536291,"Dép quai ngang nam nữ M Masler-MT màu đỏ sọc trắng với lớp quai chắc chắn, thoáng khí và đế chống nước DST",298000,298000,0,0
TIKI,giay-dep-nam,101656501,"Xi Đánh Bóng Giầy Sáp Đánh Bóng Đồ Da Sans901 Sans Shop",48000,48000,0,0
TIKI,giay-dep-nam,194067155,"Sandal xốp Bitis nam mẫu 2022",295000,295000,0,0
TIKI,giay-dep-nam,20476399,"Giày Lười Nam Da Bò Thật Happsyshoes HS20",350000,350000,0,0
TIKI,giay-dep-nam,125779590,"Giày nhựa siêu nhẹ nam nữ",75000,75000,0,0
TIKI,giay-dep-nam,58951379,"Giầy tây nam cao cấp",210000,210000,0,0
TIKI,giay-dep-nam,184617305,"Giày thể thao nam, giày sneakers nam Vir - R001",220000,220000,0,0
TIKI,giay-dep-nam,8003458,"Dép Nam BIGGBEN Da Bò Thật Cao Cấp DN125",339000,450000,111000,25
TIKI,giay-dep-nam,49884241,"Dây Giày Cao Su Thông Minh Tự Ôm Sát Chân , Chống Nhấc Gót , Chông Tuột Chuyên Dụng Cho Tập Thể Thao , Gym  , Đi Bộ Cả Nam Và Nữ Bộ 14 Dây  DG004",45000,45000,0,0
TIKI,giay-dep-nam,129350781,"Dép Vento Hybrid Nam Xỏ Ngón dạo phố/đi chơi/du lịch HY11",255000,255000,0,0
TIKI,giay-dep-nam,115263896,"Dép Xỏ Ngón Thái Lan Unisex Nam nữ RUBBER SOUL – Balance siêu êm, siêu nhẹ",160000,160000,0,0
TIKI,giay-dep-nam,53118547,"Dép Kẹp Nam Xỏ Ngón Da Bò Thật Cao Cấp DK09",400000,400000,0,0
TIKI,giay-dep-nam,34493966,"Lót Giày Nam tăng lực chạy Run Sport chính hãng sunzin  - Loại chuyên dùng cho vận động viên thể thao",65000,65000,0,0
TIKI,giay-dep-nam,141247622,"Dép Da Nam Cao Cấp Việt Hưng-Da Bò Thât 100%-VH2063",300000,300000,0,0
TIKI,giay-dep-nam,72215181,"Giày Tây Nam Tăng Chiều Cao Da Bò BIGGBEN Cao Cấp GT204",899000,1100000,201000,18
TIKI,giay-dep-nam,125159556,"Giày Sục Nam Da Mềm, Mặt Giày Da Lộn, Đai Vàng Mạ Chống Gỉ- Đế Cao Su Non - Màu Đen - Mã L194 - Hàng Việt Nam",198000,198000,0,0
TIKI,giay-dep-nam,141011740,"( XẢ RẺ) Giay lười vải nhung lì chất liệu đế kếp 2 mầu rẻ-đẹp-chất lượng hd205",66000,78000,12000,15
TIKI,giay-dep-nam,161405521,"Dép xăng đan nam nữ đế trắng quai trắng phối dù size từ 34 nữ đến 43 nam",82999,82999,0,0
TIKI,giay-dep-nam,119245002,"Dép Bít Mũi Nam TiTi ĐÔ Da Bò Thật Cao Cấp GSB2072A",450000,450000,0,0
TIKI,giay-dep-nam,101656266,"Xi Đánh Bóng Giầy Sáp Đánh Bóng Đồ Da Sans901 Sans Shop",50000,50000,0,0
TIKI,giay-dep-nam,50616604,"Combo 2 Chai Xịt có đầu cọ Tẩy Giầy Dép Túi Xách siêu trắng -  100ml",12000,16899,4899,29
TIKI,giay-dep-nam,91564281,"Chai vệ sinh giày thể thao - Chai tẩy trắng giày thể thao - chai tẩy giày Plac",18500,18500,0,0
TIKI,giay-dep-nam,77445959," Giày Nam Giày Tây Nam Công Sở Phong Cách Lịch Lãm (GNA-012) Tăng Chiều Cao [HÀNG ĐẸP",199000,199000,0,0
TIKI,giay-dep-nam,171535804,"Dép quai ngang nam nữ M Masler-MT đan mạch xanh dương với lớp đế chống nước và quai êm chân DMXD",458000,458000,0,0
TIKI,giay-dep-nam,102797401,"Giày nam giày sneaker lưới thoáng khí chống hôi chân, fullsize, 3 màu - #K86",79000,79000,0,0
TIKI,giay-dep-nam,129351461,"Dép Vento Nam Quai Ngang dạo phố/đi chơi/du lịch VT4910",245000,245000,0,0
TIKI,giay-dep-nam,132098603,"Giày Rọ Nam Da Bò SUNPOLO STA681 (Đen, Nâu)",610000,610000,0,0
TIKI,giay-dep-nam,101291537,"Giày lười nam - Slip on nam da - Mã S193",350000,350000,0,0
TIKI,giay-dep-nam,105680731,"Giày Tây Nam Cao Cấp GT01, Giày Da Nam Đơn Giản Lịch Lãm, Tặng Kèm 2 Đôi Tất Xanh",195000,195000,0,0
TIKI,giay-dep-nam,101292367,"Giày lười nam - Slip on nam vải - Mã S697",350000,350000,0,0
TIKI,giay-dep-nam,101292060," Giày lười nam - Slip on nam vải - Mã S186",350000,350000,0,0
TIKI,giay-dep-nam,117042505,"Huy hiệu (Jibbitz) Crocs Mommy Shark 10007936 - 1 cái",215000,215000,0,0
TIKI,giay-dep-nam,55457290,"Dép nam bít mũi Trường Hải màu VÀNG da bò thật đế cao su may chắc chắn thời trang cao cấp êm ái BM077",384000,419000,35000,8
TIKI,giay-dep-nam,115225725,"Dép Nam Quai Ngang HÀ NAM Da Bò Thật Cao Cấp DNA2124",396000,396000,0,0
TIKI,giay-dep-nam,21156291,"Giày da nam cao cấp Lexshoes- LX02",350000,350000,0,0
TIKI,giay-dep-nam,167683260,"Chai Xịt Da Lộn Renovator XIMO 230ml Chuyên Dưỡng Và Bổ Sung, Phục Hồi Màu XI12",122000,150000,28000,19
TIKI,giay-dep-nam,179523076,"Túi đựng giày K2 ,túi để giày dép du lịch ,thể thao đá bóng chống nước nhỏ gọn là phụ kiện tiện ích dễ dàng mang theo",73000,79000,6000,8
TIKI,giay-dep-nam,161393050,"Bình xịt tạo bọt vệ sinh giày Sneaker cao cấp, Làm sạch nhanh, Dễ sử dụng Không có đánh giá",37000,37000,0,0
TIKI,giay-dep-nam,153257484,"Có 2 Màu) Giày lười vải nam Sport Shoes thoáng khí(B)",97000,97000,0,0
TIKI,giay-dep-nam,187558929,"Giày Lười Vải Nam Đế Cao su non A60 Lỗ Thoáng Khí Màu Đen",94000,94000,0,0
TIKI,giay-dep-nam,6815151,"Giày thể thao da lộn Giay VO.VP07.1071",250000,480000,230000,48
TIKI,giay-dep-nam,191633099,"Dép nam quai ngang da bò Nappa cao cấp Bụi Learher E111, đế cao su non đi em chân",292000,450000,158000,35
TIKI,giay-dep-nam,192888820,"Sticker nhựa jibbitz unisex Crocs Clover",145000,145000,0,0
TIKI,giay-dep-nam,189676441,"Đón Gót Giày/ Dụng Cụ Mang Giày/ Móc Chìa Khoá Chất Liệu Da Thật Lõi Thép - TMG1000101 [ Chọn Mẫu Ngẫu Nhiên Khi Giao ]",49000,89000,40000,45
TIKI,giay-dep-nam,126051686,"Giày Mọi Nam Da Bò SUNPOLO SU5055 Đế may khâu bền bỉ (Đen)",750000,750000,0,0
TIKI,giay-dep-nam,183727417,"Dép quai ngang nam da bò Đông Hải đế cao su dập vân chống trượt chắc chắn - D3220",690000,690000,0,0
TIKI,giay-dep-nam,84197047,"Giày Sandals Vento Nam Quai Chéo đi học đi chơi đi làm NV65 - NV117",260000,260000,0,0
TIKI,giay-dep-nam,86328492," Dép tổ ong nam nữ nhiều màu đi trong nhà, đi mưa (9 màu) IDEP - DL015",26000,26000,0,0
TIKI,giay-dep-nam,27768984,"Dép Nam BIGGBEN Da Bò Thật Cao Cấp DN207",299000,400000,101000,25
TIKI,giay-dep-nam,56123928,"Dép sục nhựa nam thời trang dép đi mưa QA-SHOES",85000,85000,0,0
TIKI,giay-dep-nam,74541439,"Giày Thể Thao Sneaker Cho Nam, Giày Chạy, Buộc Dây, Kiểu Dáng Đơn Giản, Nhẹ, Mặt Lưới, Lót Thoáng Khí G161",129000,210000,81000,39
TIKI,giay-dep-nam,190509261,"Dép quai ngang hàng hiệu da bò thật KEEDO TN-9021 Full hộp",920000,920000,0,0
TIKI,giay-dep-nam,74343963,"Giày da nam giám đốc, giày doanh nhân, giày nam cổ điển mũi tròn - Mã 36578",489000,899000,410000,46
TIKI,giay-dep-nam,54224475,"Bình xịt giầy nano chống thấm nước -  Bình xịt chống thấm,khử mùi giày dép",90000,90000,0,0
TIKI,giay-dep-nam,73834830,"Giày lười nam da thật đẳng cấp thời trang mẫu cực đẹp - 11658",529000,899000,370000,41
TIKI,giay-dep-nam,39851792,"giày tây nam da bò dập vân cá sấu cao cấp Trường  Hải GT210",483000,550000,67000,12
TIKI,giay-dep-nam,190510884,"Giày thể thao nam, giày nam vải sợi thể thao cao cấp kem phối sọc GT01",200000,200000,0,0
TIKI,giay-dep-nam,76828220,"Giày Thể Thao Nam Nữ Cao Cổ Classic",145000,145000,0,0
TIKI,giay-dep-nam,189940233,"Dép kẹp nam Đông Hải chất da bò cao cấp thiết kế tối giản đế cao su chống trượt - D3221",690000,690000,0,0
TIKI,giay-dep-nam,13356120,"Dép Nam Da Bò, Sandal Nam",295000,590000,295000,50
TIKI,giay-dep-nam,168793893,"Đón gót giày cho mọi tư thế gỗ Hương nguyên khối đủ Size - Cho giày Nam & Nữ - XIMO XDGG03",35000,70000,35000,50
TIKI,giay-dep-nam,75332427,"Giày da nam, giày da đậu Hà Lan , chống trơn, chống mài mòn, giày cho bố, giày trung niên - Mã 26775",429000,839000,410000,49
TIKI,giay-dep-nam,193735723,"Giày Thể Thao Nam Giày Sneaker Nam GSPI09  Fuill Đen Vải Lưới Thoáng Khí",150000,250000,100000,40
TIKI,giay-dep-nam,8109695,"Miếng Lót Giày Tăng Chiều Cao Đệm Khí 2 lớp 5cm",38999,38999,0,0
TIKI,giay-dep-nam,2710151,"Lót giày công sở giảm đau mỏi chân Spenco Total Support Thin 46-696",895000,895000,0,0
TIKI,giay-dep-nam,122712194,"Giày Lười Da Bò Nam, Kiểu Dáng Bắt Mắt, Thiết Kế Giữ Phong Dáng, Đế Cao Su, Da Chuẩn GD19",229000,229000,0,0
TIKI,giay-dep-nam,100869452,"Dép Da Nam Quai Hậu Da Bò Cao Cấp Mã DE01",300000,600000,300000,50
TIKI,giay-dep-nam,215224455,"Dép nam hai quai chính hãng cao cấp KD912 đế cao su, chống trơn trượt",480000,480000,0,0
TIKI,giay-dep-nam,193638088,"Giày dép Sandals Vento ALPHA II Teen/Trẻ em màu Tro đi học/đi dã ngoại/đi chơi SD08002",365000,365000,0,0
TIKI,giay-dep-nam,52172450,"Dép tông hươu 3 lớp",80000,80000,0,0
TIKI,giay-dep-nam,193760519,"Giày thể thao nam -Giày sneaker nam -Giày nam đi chơi- Giày Đen Full đế cao su đúc Bền Dáng Đẹp SN0025",175000,250000,75000,30
TIKI,giay-dep-nam,13287746,"Dép bít mũi nam nâu da bò cao cấp SP039",289000,329000,40000,12
TIKI,giay-dep-nam,20837731,"Dép giải phóng quân",300000,300000,0,0
TIKI,giay-dep-nam,21057273,"Dép nhựa nam 3 quai 3 khóa",83000,92000,9000,10
TIKI,giay-dep-nam,73821380,"Giày Sneaker Nam Hot Trend - Giày Nam Đi Học Đi Làm Chạy Bộ G167",99000,180000,81000,45
TIKI,giay-dep-nam,172938198,"Giày lười nam , Giày da nam Beck Be GD01",260000,260000,0,0
TIKI,giay-dep-nam,14448652,"Giày lười dáng hè - LEX211c",520000,520000,0,0
TIKI,giay-dep-nam,98296541,"Giày Thể Thao Nam Hàn Quốc bluman/009",208050,219000,10950,5
TIKI,giay-dep-nam,171627351,"Combo 5Đôi Lót Giày Thể Thao Êm Chân Thoáng Khí Chống Hôi Chân Khi Sử Dụng Giày Thường Xuyên -LG03",65000,65000,0,0
TIKI,giay-dep-nam,77924748,"Dép lê quai ngang hình con Ong cho Nam - Mã Dep01",159000,298000,139000,47
TIKI,giay-dep-nam,86256521,"Giày thể thao nam , giày nam da lộn AK 5851",220000,220000,0,0
TIKI,giay-dep-nam,161393247,"Đón Gót Giày VIP Hàng Xuất Khẩu Bằng Gỗ Muồng Nguyên Khối Cao Cấp - Cho giày Nam & Nữ",90000,90000,0,0
TIKI,giay-dep-nam,145399495,"Giày sandal nam da bò thật BIGGBEN cao cấp SD121",349000,400000,51000,13
TIKI,giay-dep-nam,176470981,"Sơn, vẽ, custom cho giày, túi, ví áo, giày dép da cao cấp Ximo Custom Leather Paint 30ml XI18",110000,200000,90000,45
TIKI,giay-dep-nam,98039830,"Giày Lười Vải Đen Có Lỗ Thoáng Khí Đế Cao Ms60",103550,109000,5450,5
TIKI,giay-dep-nam,87294311,"Lót giày quế khử mùi hôi chân, phòng cảm cúm tốt cho sức khỏe (Giao Màu Ngẫu Nhiên)",27000,27000,0,0
TIKI,giay-dep-nam,188714127,"Dép nam quai ngang Thái Lan Aerosoft 0336 , dép đi mưa không hôi chân",250000,250000,0,0
TIKI,giay-dep-nam,179901570,"Dép lào thái dép tông thái xỏ ngón siêu bền loại 1",93500,93500,0,0
TIKI,giay-dep-nam,76479050,"Giày Tây Nam Cột Dây, Đế Cao, Đã Khâu Đế Lịch Lãm",238500,238500,0,0
TIKI,giay-dep-nam,76368202,"Dép nam da bò BIGGBEN cao cấp DN272",349000,450000,101000,22
TIKI,giay-dep-nam,92375767,"Giày Lười Tomoyo  Da Bò Đế Khắc Rãnh Giảm Chấn - Lót Da Cừu Cao Cấp TMN60103",1290000,2890000,1600000,55
TIKI,giay-dep-nam,184617161,"Giày thể thao nam, giày sneaker nam 2 màu xám và kem - H02",230000,230000,0,0
TIKI,giay-dep-nam,82844364,"Khăn giấy ướt lau giày tiện lợi",10000,25000,15000,60
TIKI,giay-dep-nam,74795739,"Dép kẹp bịt mũi quai da đế gai",350000,350000,0,0
TIKI,giay-dep-nam,173635485,"Giày Lười Nam Tăng Chiều Cao Da Bò Thật BIGGBEN Cao Cấp GM270",899000,1500000,601000,40
TIKI,giay-dep-nam,156215373,"DÉP NAM HAI QUAI NGANG DA BÒ THẬT 100",251451,251451,0,0
TIKI,giay-dep-nam,36618050,"Giày Tây Công Sở Nam Không Dây Siêu Chất GL33 Cao Cấp",118000,118000,0,0
TIKI,giay-dep-nam,78047827,"Bộ Vệ Sinh Giày Tuyệt Đỉnh Crep Protect The Ultimate Box Pack (1000g)",1350000,1350000,0,0
TIKI,giay-dep-nam,178958214,"Dép quai ngang đế cao nam và nữ, quai ngang đế cao chất liệu eva chống thấm 2022",99000,99000,0,0
TIKI,giay-dep-nam,27691824,"Dép quai ngang nam da bò cao cấp TH_QN044",245000,279000,34000,12
TIKI,giay-dep-nam,73330956,"Giày Thể Thao Nam Ngắn Cổ - Thiết Kế Đế Nén Khí Êm Chân, Tăng Chiều Cao - Lót Giày Bằng Lưới Thoáng Khí Giúp Chân Luôn Khô Thoáng - Full Màu, Full Size - GTTN-61",170000,250000,80000,32
TIKI,giay-dep-nam,100464983,"Keo dán đa năng Super glue siêu dính , lên mọi chất liệu gỗ, nhựa, đồ gốm, kim loại, da , móng tay an toàn khi sử dụng",5000,8000,3000,38
TIKI,giay-dep-nam,14053836,"Bộ Vệ Sinh Giày Tuyệt Đỉnh Crep Protect The Ultimate Box Pack (1000g)",1300000,1300000,0,0
TIKI,giay-dep-nam,149932258,"Giày Thể Thao Nam Vải Thoáng Khí Đế Đúc Êm Chân S96 Có 2 Màu (Size39-43)",68000,68000,0,0
TIKI,giay-dep-nam,84198686,"Dép Vento Nam xỏ ngón dạo phố đi chơi du lịch VT1189",230000,230000,0,0
TIKI,giay-dep-nam,133235324,"Dép Nam quai ngang Thái Lan Kito UM 7014",210000,210000,0,0
TIKI,giay-dep-nam,58837457,"DÉP NAM QUAI NGANG GIA VY TL504",210000,210000,0,0
TIKI,giay-dep-nam,105037422,"Giày Tây nam giày công sở nam da bò cao cấp màu trắng-TR61 siêu mềm êm chân",628000,628000,0,0
TIKI,giay-dep-nam,163550695,"BÌNH XỊT KHỬ MÙI GIÀY, CHỐNG HÔI CHÂN NCE SIÊU KHÔ THOÁNG",25000,25000,0,0
TIKI,giay-dep-nam,115767457,"Sục da nam,giày da nam hở gót xả kho giá gốc",199000,199000,0,0
TIKI,giay-dep-nam,176067632,"Dép nhựa quai kẹp Bitis nam",195000,195000,0,0
TIKI,giay-dep-nam,183554496,"Dép đế may sẵn quai ngang cao cấp KEEDO KD2906 Full hộp",960000,960000,0,0
TIKI,giay-dep-nam,66619273,"Giày da bò nam công sở mã 8867",319000,499000,180000,36
TIKI,giay-dep-nam,8863183,"Miếng lót giày thể thao thoáng khí (Size giày nam, từ 40-46)",79000,79000,0,0
TIKI,giay-dep-nam,169756074,"Bộ xi đánh giày kèm phụ kiện XIMO tiện dụng (XXDG151)",99000,180000,81000,45
TIKI,giay-dep-nam,192910228,"Giày Tây Da Cao Cấp ChristinA-Q GNA411",919200,1149000,229800,20
TIKI,giay-dep-nam,82959171,"Combo 5 cặp dây giày công sở nam dạng tròn nhiều kích thước",33000,33000,0,0
TIKI,giay-dep-nam,111524746,"Giày thể thao nam SSN8 giày cao 4cm đi lại nhẹ nhàng-chất liệu vải thoáng khí-thấm hút tốt(2 MẦU)",99750,105000,5250,5
TIKI,giay-dep-nam,187482141,"Dép nam quai 2 dây ngang TL547",195000,195000,0,0
TIKI,giay-dep-nam,38301675,"Giày nam da thật ELLY HOMME – EGTM2",2399000,2399000,0,0
TIKI,giay-dep-nam,176472467,"Dung môi vệ sinh làm sạch bề mặt da Ximo LeatherPreparer &amp; Deglazer Premium XI17",130000,150000,20000,13
TIKI,giay-dep-nam,164483934,"Giày nam thể thao, giầy sneaker nam da lì chất siêu đẹpS042 , có 2 màu",50000,100000,50000,50
TIKI,giay-dep-nam,101292329,"Giày lười nam - Slip on nam vải - Mã LY69",350000,350000,0,0
TIKI,giay-dep-nam,103917241,"Dép quai ngang thời trang nam năng động kiểu dáng Nhật Bản ôm chân thoáng khí thân thiện với môi trường",159000,309000,150000,49
TIKI,giay-dep-nam,101655632,"Đón Gót Giày Đót Giầy Sans974 Sans Shop",9900,9900,0,0
TIKI,giay-dep-nam,74285550,"Giày Tây Nam Da Bóng Đế Cao Phong Cách Hàn Lịch Lãm",253500,253500,0,0
TIKI,giay-dep-nam,50261195,"Găng Tay Lau Chùi Giày Có Thể Sử Dụng Để Đánh Giày Da Với Xi (Giao Màu Ngẫu Nhiên)",16223,30000,13777,46
TIKI,giay-dep-nam,103467604,"Giày Tây Nam Không Dây Da Bò Thật Màu Vàng Chính Hãng Trường Hải GT280  Đế Cao Su Không Trơn",514000,549000,35000,6
TIKI,giay-dep-nam,138193990,"Dép Xỏ Ngón Nam HÀ NAM Da Bò Thật Cao Cấp DNA2144",325000,325000,0,0
TIKI,giay-dep-nam,12676321,"Dép bít mũi da bò vàng cao cấp Trường Hải  TH033",289000,329000,40000,12
TIKI,giay-dep-nam,51148182,"Giày nam, chất thoáng mát, mẫu bán chạy, phù hợp cho mùa thu G35",115875,115875,0,0
TIKI,giay-dep-nam,70796867,"Giày nam thể thao sneaker vải dệt cao cấp thoáng khi bền đẹp SP-371",169100,178000,8900,5
TIKI,giay-dep-nam,153258290,"Dép lỗ táo đi trong nhà, nhà tắm siêu mềm (size 39-44)",18600,18600,0,0
TIKI,giay-dep-nam,26691723,"Dép Nam BIGGBEN Da Bò Thật Cao Cấp DN201",319000,380000,61000,16
TIKI,giay-dep-nam,55141466,"Combo 3 đôi lót giày Hương Quế (CI-03, CI-13, CI-14) giúp khử mùi hôi chân - phòng cảm cúm - hút ẩm êm chân - tốt cho sức khỏe",75000,75000,0,0
TIKI,giay-dep-nam,10099420,"Lót Giày Da - Nội Địa Nhật Bản",46000,46000,0,0
TIKI,giay-dep-nam,119244798,"Dép Bít Mũi Nam TiTi ĐÔ Da Bò Thật Cao Cấp GSB2076a",480000,480000,0,0
TIKI,giay-dep-nam,195013905,"Dép da nam đế cao 3.5cm may viền Trường Hải da bò thật màu vàng thời trang nam cao cấp DN156",266000,450000,184000,41
TIKI,giay-dep-nam,3985369," Giày ông già da bò thật VO KK 445",480000,650000,170000,26
TIKI,giay-dep-nam,72597290,"Dép Đi Trong Nhà, Văn Phòng, Nhà Tắm Chống Trơn Trượt mềm êm chân Unisex Nam Nữ đều dùng được T0084M",73000,73000,0,0
TIKI,giay-dep-nam,182144405,"Dép nam xỏ ngón da bò màu đen may viền chính hãng Trường Hải XN159",293000,379000,86000,23
TIKI,giay-dep-nam,153416263,"Giày Tây Nam Giày Công Sở Nam Da Bò Cao Cấp Màu Nâu-P26 Giày Đánh Patina Thủ Công Sang Trọng Lịch Lãm ,Giày SAGO’S",890000,890000,0,0
TIKI,giay-dep-nam,91271840,"Khăn Giấy Lau Giày Siêu Sạch SNEAKER Hộp 30 Tờ Siêu Hot Không Hoá Chất Làm Hại Vải hàng đẹp",23616,23616,0,0
TIKI,giay-dep-nam,177674636,"Dép Nam Quai Ngang Da Bò Thật BIGGBEN Cao Cấp DN310",289000,380000,91000,24
TIKI,giay-dep-nam,45281426,"Dép quai ngang nam GIAVY - T483",195000,195000,0,0
TIKI,giay-dep-nam,127934628,"[Hương Bạc Hà Trà Xanh] Nước Hoa Xịt Khử mùi Giày Cao Cấp MIS PIES - 20ml - Công Nghệ Nano Bạc Khử Mùi - Khử mùi hôi chân hiệu quả",199000,199000,0,0
TIKI,giay-dep-nam,68136317," Dép tông nam, dép kẹp nam quai da đế vân nổi 3D - DT12",70000,70000,0,0
TIKI,giay-dep-nam,48813671,"Cây xỏ giầy gỗ khảm trai hoa văn- dây giưa 70cm",128000,128000,0,0
TIKI,giay-dep-nam,37496496,"Giầy thể thao nam_0006",95325,95325,0,0
TIKI,giay-dep-nam,15320462,"Dây giày Saphir Pháp",65000,65000,0,0
TIKI,giay-dep-nam,156214753,"GIÀY LƯỜI GIÀY SỤC NAM KHÂU ĐẾ CHẮC CHẮN BAO ĐI MƯA",251451,251451,0,0
TIKI,giay-dep-nam,124244266,"Dép Massage khảm đá Bấm huyệt bàn chân trên gỗ tự nhiên, Bấm Huyệt chân Giảm căng thẳng mệt mỏi cao câpz",179000,179000,0,0
TIKI,giay-dep-nam,37833006,"Dép cao su Nam  Nữ 3 quai có hậu bhh",300000,300000,0,0
TIKI,giay-dep-nam,85368003,"Dép nam xỏ ngón đen may viền  chính hãng Trường Hải da bò đen  XN1003",219000,249000,30000,12
TIKI,giay-dep-nam,68985578,"Dép Nam thời trang  trẻ trung năng động Hàn Quốcmã 2072",119000,229000,110000,48
TIKI,giay-dep-nam,38387762,"Chai tạo bọt làm sạch giày Sneakers",99000,99000,0,0
TIKI,giay-dep-nam,72759162,"Giày Tây Oxford Banuli Nam Công Sở Da Bê Italian Dây Buộc H1PO1M0 (Da Mềm Dẻo, Đế Siêu nhẹ, Bảo Hành Trọn Đời)",1700000,1700000,0,0
TIKI,giay-dep-nam,196319310,"Giày Sneaker Da Nam DINCOX E11 Sang Trọng Lịch Thiệp Black",620000,620000,0,0
TIKI,giay-dep-nam,190468358,"Giày Thể Thao Nam Tăng Chiều Cao Phong Cách Cá Tính",178000,178000,0,0
TIKI,giay-dep-nam,130439692,"Giày Nam Da Bò SUNPOLO CS4060 Trẻ trung, thanh lịch (Nâu đỏ)",780000,780000,0,0
TIKI,giay-dep-nam,38410837,"Bộ Vệ Sinh Giày Dạng Xịt Bọt Enito Foam Cleaner Kit - Chuyên Dùng Để Vệ Sinh Giày Sneaker",420000,420000,0,0
TIKI,giay-dep-nam,15932470,"Kem phục hồi màu đồ da Saphir JUVACUIR 75ml",415000,415000,0,0
TIKI,giay-dep-nam,147694523,"Dép nam dép quai ngang nam kiểu Hàn Quốc mã DEP09LE",159000,289000,130000,45
TIKI,giay-dep-nam,180607737,"Tất độn gót chân tăng chiều cao tàng hình lên 3cm (đôi gồm 2 chiếc) chất liệu silicon mềm siêu dai co giãn đa chiều, phù hợp cho cả nam và nữ",69869,69869,0,0
TIKI,giay-dep-nam,101656593,"Giày tây nam công sở derby Sans115 giầy da bò thật cao cấp đen nâu da bóng buộc dây bigsize cỡ to lớn 43 44 45 46 47 48",590000,590000,0,0
TIKI,giay-dep-nam,189635020,"Giày Sandal Vento Nam 2 Quai Ngang dạo phố  đi học du lịch Big Size NV3610",345000,345000,0,0
TIKI,giay-dep-nam,171009922,"Dép tổ ong KEM vật liệu EVA siêu bền, siêu nhẹ, chống trơn trượt, Form SIZE LỚN CHÂU ÂU",63000,85000,22000,26
TIKI,giay-dep-nam,75338208,"Dép quai ngang nam nhiều màu đế đúc cực êm, chống nước T895",68000,68000,0,0
TIKI,giay-dep-nam,102799432," giày nam, giày sneaker nam cao cấp mới nhất 2021",199000,199000,0,0
TIKI,giay-dep-nam,197540447,"Hai Cây xỏ giầy gỗ muồng đen dài 70cm -khảm trai hoa văn",260930,269000,8070,3
TIKI,giay-dep-nam,83169842,"Dép 3 quai chéo lốp máy bay thủ công",637000,637000,0,0
TIKI,giay-dep-nam,170131990,"Dép tông nam, dép kẹp nam siêu nhẹ D720",100000,100000,0,0
TIKI,giay-dep-nam,127878365,"Giày Sandal Nam Da Bò Bít Mũi Cao Cấp SUNPOLO SDA011 (Nâu, Đen)",610000,610000,0,0
TIKI,giay-dep-nam,181500386,"Dép nam quai ngang da bò màu nâu đế cao 3.5cm chính hãng Trường Hải may chắc chắn QN179",283000,379000,96000,25
TIKI,giay-dep-nam,178608406,"Giày Sandal Nam VENTO Xuất Khẩu Quai Ngang VT4906",250000,250000,0,0
TIKI,giay-dep-nam,67333221,"Giày Sandalnam thời trang Nhật Bản đế mềm chất liệu da bò thật mã 12129",219500,439000,219500,50
TIKI,giay-dep-nam,115830964,"Giày tây nam cao cấp dập ô vuông gea giày da nam trẻ trung màu đen tăng chiều cao da thật đẹp giá rẻ - Mã GEADL002",199000,199000,0,0
TIKI,giay-dep-nam,163875026,"Đón giày Gỗ Hương/Gõ đỏ vân gỗ đẹp, có thể bỏ túi tiện dụng (DGH905) hàng xuất khẩu, kiểu dáng nhỏ gọn - HAHANCO",47500,50000,2500,5
TIKI,giay-dep-nam,45272479,"Dép kẹp nam GIAVY - TL500",210000,210000,0,0
TIKI,giay-dep-nam,162841600,"Dép Nam, Dép Bít Mũi Nam Da Bò SUNPOLO SUA011 (Đen, Nâu)",580000,580000,0,0
TIKI,giay-dep-nam,2597577,"Giày Sandal Nam Da Bò Cao Cấp SUNPOLO SUSDA1D",580000,580000,0,0
TIKI,giay-dep-nam,179882869,"Giày Mọi Nam HÀ NAM Da Bò Thật Cao Cấp GM2060c",760000,760000,0,0
TIKI,giay-dep-nam,96301892,"Sục Nam Bảo Hân Da Bò Mặt Nhung Mã GS-01",390000,780000,390000,50
TIKI,giay-dep-nam,104615833,"Giày Thể Thao Nam Tăng Chiều Cao Spiso S58 Màu Xám",170000,250000,80000,32
TIKI,giay-dep-nam,191732448,"Giày Sandal Nam The Bily Quai Chéo - Đế Trắng Lót Đen Màu Trắng BLDTMD01",319000,319000,0,0
TIKI,giay-dep-nam,43205141,"Giày Mọi Nam Da Thật VO Shoes VO Luxury Fashion _ VO9905",395000,695000,300000,43
TIKI,giay-dep-nam,201809562,"Giày lười nam da bò thật, hàng vxnk-TL01",450000,450000,0,0
TIKI,giay-dep-nam,115726044,"Giày Sục Da Nam Dập Vân Cá Sấu - Đế Cao Su non 2,5cm - Mã L195 Màu Đen - Hàng Việt Nam",199000,199000,0,0
TIKI,giay-dep-nam,76104817,"Giày Lười Vải, Hình Thêu, Đế Chống Trơn Trượt - LV03",223500,223500,0,0
TIKI,giay-dep-nam,136187278,"Dép Sục, Dép Sapo Nam Da Bò SUNPOLO SUT327 (Đen, Nâu)",520000,520000,0,0
TIKI,giay-dep-nam,829630,"Lót Giày Silicon Total Support Gel Spenco 46-300 - Đế lót gel giảm đau gót chân, gai gót",695000,695000,0,0
TIKI,giay-dep-nam,156212202,"Giày thể thao nam , giày dệt kim, giày thể thao thời trang , giày đi chơi, đi làm mã J11",199500,399000,199500,50
TIKI,giay-dep-nam,98611666,"Giày Sneaker Thể Thao Nam HiNiTi T006 Dáng Đẹp- Năng Động Tặng Tất",122000,122000,0,0
TIKI,giay-dep-nam,149689318,"Giày Nam Buộc Dây Da Bò SUNPOLO XIPO01 (Đen, Nâu)",850000,850000,0,0
TIKI,giay-dep-nam,177164342,"Giày Lười Trẻ Em Unisex NATIVE J Jefferson Bling Junior",1500000,1500000,0,0
TIKI,giay-dep-nam,75632053,"Miếng Lót Giầy Nam Gel Crep Protect Ultimate Gel Insole",700000,700000,0,0
TIKI,giay-dep-nam,205526467,"Sục da nam- giày nam da hở gót chất liệu da Pu dập vân đế cao su- mã s002",150000,150000,0,0
TIKI,giay-dep-nam,205525275,"Giày sục nam giá rẻ - chất liệu nhung cao cấp - mặt trên thêu họa tiết đính kèm đai kim loại màu vàng - mã L169",160000,160000,0,0
TIKI,giay-dep-nam,49090172,"Giày Tây Derby Banuli Nam Công Sở Da Bê Italian Dây Buộc H1CD1M0 (Da Mềm Dẻo, Đế Siêu nhẹ, Bảo Hành Trọn Đời)",1700000,1700000,0,0
TIKI,giay-dep-nam,6398613,"Giày Tây Nam BIGGBEN Da Bò Thật Cao Cấp GT23",500000,500000,0,0
TIKI,giay-dep-nam,172316103,"Dép Nam Quai Ngang TiTi ĐÔ Da Bò Thật Cao Cấp DN2074c",389000,389000,0,0
TIKI,giay-dep-nam,179918869,"Giày Sneaker Thể Thao Nam Kene 2021 cực hót",74100,78000,3900,5
TIKI,giay-dep-nam,192196939,"Dép Thái Lan nam quai Da dây chéo KITO A02M , Dép sandan quai da dành cho nam",295000,295000,0,0
TIKI,giay-dep-nam,174109557,"Dây Giày Thể Thao Sneaker EXTRIM Bản Dẹt Siêu Bền Màu Trơn 120cm",45000,45000,0,0
TIKI,giay-dep-nam,114448367,"Dép Rọ Nam Da Bò Đế Khâu Mềm Mã SD01)",350000,700000,350000,50
TIKI,giay-dep-nam,77989663,"Bộ Vệ Sinh Giày  Enito Foam Cleaner Kit 200ml - Chuyên Dùng Để Vệ Sinh Giày Sneaker",420000,420000,0,0
TIKI,giay-dep-nam,12119213,"Dép bít mũi nam da bò đen cao cấp TH011",280000,319000,39000,12
TIKI,giay-dep-nam,49320645,"Giày Tây Nam Trơn Lịch Lãm",223500,223500,0,0
TIKI,giay-dep-nam,156215140,"GIÀY THỂ THAO NAM DA BÒ THẬT 100% CAO CẤP HÀNG CÔNG TY XNK",955883,955883,0,0
TIKI,giay-dep-nam,69177937,"Dép nam xỏ ngón HÀ NAM da bò thật cao cấp DXN2035",450000,450000,0,0
TIKI,giay-dep-nam,96846714,"Lót giày tăng chiều cao, độn giày nửa bàn êm chân",15000,15000,0,0
TIKI,giay-dep-nam,14816328,"GIÀY DA BÒ CAO CẤP - LEX23",590000,590000,0,0
TIKI,giay-dep-nam,179879904,"Dép Xỏ Ngón Nam HÀ NAM Da Bò Thật Cao Cấp DXN2063c",390000,390000,0,0
TIKI,giay-dep-nam,58893939,"Giày tây nam đế cao",210000,210000,0,0
TIKI,giay-dep-nam,101656937,"Bàn Chải Đánh Giày Đồ Da 2 Mặt Lông Ngựa Sans908 Sans Shop",44000,44000,0,0
TIKI,giay-dep-nam,53313944,"Dép nam xỏ ngón Trường Hải da bò thật cao cấp mềm mại đế âm mặt đế cao su không trơn  THXN074",320000,369000,49000,13
TIKI,giay-dep-nam,38410792,"Túi Hút Ẩm - Khử Mùi Hôi - Khử Nấm Mốc - Kháng Khuẩn - Dành Cho Giày Sneaker Bằng Than Tre Hoạt Tính  - Enito Freshener - Hàng Chính Hãng ",90000,90000,0,0
TIKI,giay-dep-nam,105698535,"Combo 5 đón gót giày siêu xinh- DG003",23000,23000,0,0
TIKI,giay-dep-nam,126258408,"Đón gót giày cho mọi tư thế gỗ tự nhiên nguyên khối (Đủ độ dài) Cho giày Nam & Nữ",31350,33000,1650,5
TIKI,giay-dep-nam,161393205,"Gel vệ sinh giày Sneaker, Đậm đặc, Siêu Sạch, Thơm Mát, Dễ sử dụng CHONGIAY",83000,83000,0,0
TIKI,giay-dep-nam,156217059,"DÉP NAM QUAI NGANG DA BÒ KHÂU ĐẾ CHẮC CHẮN",317334,317334,0,0
TIKI,giay-dep-nam,126516907,"Tẩy trắng giày dép, túi xách - Đánh giày dép - Dung dịch đánh giày - Rửa giày dép - Chất tẩy đa năng - 1 lọ - GDHN Loại Tốt",10999,10999,0,0
TIKI,giay-dep-nam,17970850,"Lót giày bằng Gel êm chân Woly Gel Ultraflat - NK Đức",99000,99000,0,0
TIKI,giay-dep-nam,161393115,"Keo Dán Giày Dép Chuyên Dụng SEAGLUE, Không Màu, Chịu Lực, Chịu Nước tốt",131000,131000,0,0
TIKI,giay-dep-nam,179411890,"Dép kẹp nam da bò thật 100% DONAVY cao cấp kiểu 3 tam giác cách  điệu may full quai và đế rất chắc chắn DK3G",169000,290000,121000,42
TIKI,giay-dep-nam,181485400,"Dép nam quai ngang một bản cao 3.5cm chính hãng Trường Hải da bò thật màu đen QN178",285000,379000,94000,25
TIKI,giay-dep-nam,120657027,"HC9131 - Xi nước đánh bóng Huy Hoàng màu vàng bò",99000,99000,0,0
TIKI,giay-dep-nam,72339739,"Màu Nhuộm Da Lộn Enito Suede Dye 120ml - Chuyên Dùng Để Dưỡng Lại Màu, Phục Hồi Màu Cho Da Lộn",190000,190000,0,0
TIKI,giay-dep-nam,21730413,"Miếng lót giày đủ size Uncle Bills AG0016",69000,69000,0,0
TIKI,giay-dep-nam,125615989,"Dép xỏ ngón nam da bò cao cấp HKT169",279000,279000,0,0
TIKI,giay-dep-nam,80798404,"Giày tây nam, giày công sở da thật cao cấp thời trang mới nhất PABNO - PN137",950000,950000,0,0
TIKI,giay-dep-nam,160686509,"Dép Quai Ngang WAA. - Gô Sandals - Màu Nâu",590000,590000,0,0
TIKI,giay-dep-nam,208387272,"Giày đá cầu mỏ vịt",549000,549000,0,0
TIKI,giay-dep-nam,179497830,"Dép kẹp nam Đông Hải chất da bò cao cấp thiết kế tối giản đế cao su chống trượt - D3221",690000,690000,0,0
TIKI,giay-dep-nam,110993105,"Giày thể thao nam, giày nam thời trang da cá sấu đế khí DQ05",220000,220000,0,0
TIKI,giay-dep-nam,73721553,"Dép quai ngang nam Trường Hải da bò cao cấp mềm mại không bong tróc màu đen đế PU siêu nhẹ cao 5cm QN025",254000,289000,35000,12
TIKI,giay-dep-nam,162507471,"Dép Nam Quai Ngang, Dép nam Chống Trơn Trượt SD66",69000,69000,0,0
TIKI,giay-dep-nam,141388938,"Giày Rọ Nam Da Bò SUNPOLO STA682 (Nâu)",690000,690000,0,0
TIKI,giay-dep-nam,41342414,"Giày Tây Da Nam Germano Bellesi Italia GB 804",8480000,8480000,0,0
TIKI,giay-dep-nam,113022420,"[SIÊU NHẸ_CHẤT LƯỢNG] Dép nhựa nam quai kẹp chất lượng, đúc nguyên chiếc, đi mưa, không thấm nước SM006",59000,65000,6000,9
TIKI,giay-dep-nam,207383539,"Giày lười nam, giày sục nam đẹp giá rẻ phông cách trẻ trung lăng động L204",160000,160000,0,0
TIKI,giay-dep-nam,171009847,"Dép tổ ong ĐEN vật liệu EVA siêu bền, siêu nhẹ, chống trơn trượt, Form SIZE LỚN CHÂU ÂU",63000,85000,22000,26
TIKI,giay-dep-nam,186909676,"Giày sục nam, sục nam Da bóng Moca - Da Pu Bảo hành 12 tháng ( Mã SN010 - Có hộp )",159000,159000,0,0
TIKI,giay-dep-nam,179555780," GIÀY DA LƯỜI NAM ĐẾ  CAO 3CM DONAVY CAO CẤP MAY FULL QUAI VÀ ĐẾ RẤT CHẮC CHẮN DGKM",169000,280000,111000,40
TIKI,giay-dep-nam,115831164,"GIÀY LƯỜI NAM CÔNG SỞ - GIÀY DA NAM THỜI TRANG, CHẤT LIỆU DA PU MỀM 100%, ĐẾ CAO SU ĐÚC - MÃ L192 ĐEN",199000,199000,0,0
TIKI,giay-dep-nam,147265032,"Dép Nam POLITE-ART chữ H biểu thượng thời trang, năng động màu đen DEP04LE",199000,299000,100000,33
TIKI,giay-dep-nam,181362510,"Cây Giữ Form Giày Shoe Tree Nhựa PE Loại 1 Tự Nhiên Cao Cấp Không Mùi Hút Ẩm Hiệu Quả Chống Hôi Chân - B21 Shoemaker",36000,36000,0,0
TIKI,giay-dep-nam,75637226,"Crep Protect Ultimate Shoes Gift Box - Bộ Vệ Sinh Chăm Sóc Giầy Dép",1250000,1250000,0,0
TIKI,giay-dep-nam,83170012,"Dép cao su 2 quai",300000,300000,0,0
TIKI,giay-dep-nam,108142084,"Giày lười da nam, Da mềm cao cấp không bóng, Có chuông, Đế cao su non cao 3cm, Khâu đế, Màu đen, Mã l192, Hàng Việt Nam",198000,198000,0,0
TIKI,giay-dep-nam,160686493,"Dép quai ngang Unisex Basic Sandals WAA.- DA THẬT 100% - Sản phẩm thiết kế - Màu đen",590000,590000,0,0
TIKI,giay-dep-nam,194445817,"Dép sục nam.. da mềm.. màu nâu..đế khâu sẵn rất chắc chắn.. mã SP19",145000,145000,0,0
TIKI,giay-dep-nam,35245252,"Giày Tây Nam Công Sở Da PU",108000,108000,0,0
TIKI,giay-dep-nam,170125203,"MLB - Giày thể thao Big Ball Chunky A 3ASHC101N",2490000,2490000,0,0
TIKI,giay-dep-nam,51233107,"Dép cao su 3 quai chéo đế dày",800000,800000,0,0
TIKI,giay-dep-nam,5887283,"Combo 3 đôi Vớ nam mang giày lười, giày bệt Màu ngẫu nhiên A177",49000,49000,0,0
TIKI,giay-dep-nam,115831227,"Giày Lười Nam - Dép Hở Gót ,Sục Nam chất liệu da pu đế cao su mã sản phẩm l195",160000,160000,0,0
TIKI,giay-dep-nam,8407912,"Sandal Doctor Nam BIGGBEN Da Bò Thật SD70",329000,500000,171000,34
TIKI,giay-dep-nam,192890340,"MLB - Giày sneaker Bigball Chunky Mesh 3ASHCE12N",2590000,2590000,0,0
TIKI,giay-dep-nam,74988388,"Giày da nam Pierre Cardin PCMFWL 702 - màu nâu",2990000,2990000,0,0
TIKI,giay-dep-nam,206713180,"Giày lười nam da Pu - mã NA25",159000,159000,0,0
TIKI,giay-dep-nam,84552064,"Dép dọ bộ đội , dép dọ nam",45500,45500,0,0
TIKI,giay-dep-nam,170125122,"MLB - Giày thể thao Big Ball Chunky A 3ASHC101N-50BGS",2490000,2490000,0,0
TIKI,giay-dep-nam,91281178,"Giày Unisex Crocs - CLASSIC 10001-001",1495000,1495000,0,0
TIKI,giay-dep-nam,76164156,"HAVAIANAS - Dép unisex Brasil Logo 4110850",749000,749000,0,0
TIKI,giay-dep-nam,66505395,"Dép Nam Da Bò BIGGBEN Cao Cấp DN259",299000,450000,151000,34
TIKI,giay-dep-nam,196874210,"[Phiên Bản Kỷ Niệm 40 Năm] Giày Thể Thao Nam Hunter X DSMH09700DOO (Đỏ)",1068000,1187000,119000,10
TIKI,giay-dep-nam,168944874,"Giày Lười Vải Cao Cấp Peace PO1226",269000,429000,160000,37
TIKI,giay-dep-nam,117717569,"Giày Thể Thao Sneaker Nam Da Lì Trơn Phong Cách Hàn Quốc AVI - 381",99000,99000,0,0
TIKI,giay-dep-nam,167013211,"Giày Thể Thao Nam Màu Đen, Sneaker Nam Màu Đen, Đế Êm, Nhẹ Thoáng Khí SGN5010",175000,250000,75000,30
TIKI,giay-dep-nam,36955095,"Dép cao su nam nữa 3 quai ngang",400000,400000,0,0
TIKI,giay-dep-nam,22663140,"Giày Sneaker Unisex Vans Old Skool 36 DX VN0A38G2PXC",2200000,2200000,0,0
TIKI,giay-dep-nam,10063550,"Giày Sandal Bít Mũi  Nam BIGGBEN Da Bò Thật SD78",349000,500000,151000,30
TIKI,giay-dep-nam,44935336,"Giày tây nam Trường Hải da bò cao cấp GTN0596",468000,539000,71000,13
TIKI,giay-dep-nam,14326747,"Giày mọi nam vàng  trơn da bò cao cấp đế cao su GM025",465000,529000,64000,12
TIKI,giay-dep-nam,145650235,"Bình Xịt Nano Khử Mùi Hôi Giày Dép Hiệu Quả - Có Thể Sử Dụng Nhiều Lần.",11000,18999,7999,42
TIKI,giay-dep-nam,9839769,"Giày sneaker TOMOYO TMN10901",630000,1400000,770000,55
TIKI,giay-dep-nam,196869322,"[Phiên Bản Kỷ Niệm 40 Năm] Giày Thể Thao Nam Hunter X DSMH09700TRG (Trắng)",1092000,1187000,95000,8
TIKI,giay-dep-nam,83191375,"Dép quai ngang nam ALDO DINMORE",1150000,1150000,0,0
TIKI,giay-dep-nam,107804180,"Giày Thể Thao Nam_Giày Sneakes cao 4cm mang đi nhẹ thoáng khí s65",65550,69000,3450,5
TIKI,giay-dep-nam,119288017,"Dép Nam Quai Ngang TiTi ĐÔ Da Bò Thật Cao Cấp DN2074a",420000,420000,0,0
TIKI,giay-dep-nam,182605387,"Giày Thể Thao Sneaker Nam - Giầy Nam Đế Êm Chân, Da Lì S102 Có 2 màu",189000,189000,0,0
TIKI,giay-dep-nam,10054396,"Giày Sandal Bít Mũi Nam BIGGBEN Da Bò Thật SD77",349000,500000,151000,30
TIKI,giay-dep-nam,73325521,"Giày da nam Pierre Cardin PCMFWLE 714 - màu nâu",2490000,2490000,0,0
TIKI,giay-dep-nam,171183715,"GIÀY TÂY DA BÒ CAO CẤP VA2002",399000,399000,0,0
TIKI,giay-dep-nam,10063962,"Dép Nam Bít Mũi BIGGBEN Da Bò ThậtDN146",349000,500000,151000,30
TIKI,giay-dep-nam,177560263,"Giày thể thao nam Giày Vải phong cách Hàn Quốc giày Sinh Viên 21094",85000,193755,108755,56
TIKI,giay-dep-nam,8059116,"Dép Nam BIGGBEN Da Bò Thật Cao Cấp DN131",339000,360000,21000,6
TIKI,giay-dep-nam,179523966,"Giày lười nam Đông Hải thiết kế Horsebit Loafer đính kim loại ngang mũi giày tăng  vẻ thanh lịch - G2283",1450000,1450000,0,0
TIKI,giay-dep-nam,67626523,"HAVAIANAS - Dép unisex Top 4000029-0727-378",499000,499000,0,0
TIKI,giay-dep-nam,159314261,"Giày Sneaker Nam, Giày Nam Da Thật Hàng Cao Cấp NEW 2022",199000,199000,0,0
TIKI,giay-dep-nam,76164173,"HAVAIANAS - Dép unisex Top 4000029",549000,549000,0,0
TIKI,giay-dep-nam,67626652,"HAVAIANAS - Dép unisex Top 4000029-0555",499000,499000,0,0
TIKI,giay-dep-nam,50107109,"Giày Tây công sở Nam Da Thật Cao Cấp Peace PO1027",159000,280000,121000,43
TIKI,giay-dep-nam,191653859,"Dép nam quai ngang da bò Nappa cao cấp Bụi Leather E103, đế đúc nguyên khối khâu viền thủ công đi êm chân, Bảo hành 12 Tháng",290000,450000,160000,36
TIKI,giay-dep-nam,9810452,"Giày Sneaker Unisex Authentic Vans VN000EE3BLK - Black (Size",1450000,1450000,0,0
TIKI,giay-dep-nam,175469846,"Giày chạy bộ nam Under Armour Flow Velociti SE - 3024016",2467000,3795000,1328000,35
TIKI,giay-dep-nam,190540817,"Giày thể thao nam Aldo COURTSPEC",2150000,2150000,0,0
TIKI,giay-dep-nam,134777245,"Giày lười da tăng chiều cao nam Bụi Leather G111 - Da bò Nappa cao cấp - Bảo hành 12 tháng",515000,840000,325000,39
TIKI,giay-dep-nam,177635194,"Dép Nam Bít Mũi Da Bò Thật BIGGBEN Cao Cấp DN303",339000,390000,51000,13
TIKI,giay-dep-nam,171177150,"GIÀY LƯỜI DA BÒ CAO CẤP VA2001",359000,549000,190000,35
TIKI,giay-dep-nam,92480272,"MLB - Giày sneakers Chunky Low 32SHU2111",2590000,2590000,0,0
TIKI,giay-dep-nam,158811742,"Giày Nam Pierre Cardin - PCMFWLF 515",2490000,2490000,0,0
TIKI,giay-dep-nam,10590252,"Giày Tây Nam Giả Dây Lịch Lãm",223500,223500,0,0
TIKI,giay-dep-nam,171535250,"Dép quai ngang nam nữ M Masler-MT màu trắng sọc đen tinh tế với lớp đế dễ vệ sinh, chống nước và quai êm chân TD1",278000,278000,0,0
TIKI,giay-dep-nam,7995150,"Giày Converse Chuck Taylor All Star 1970s Low Top - 162065V",1900000,1900000,0,0
TIKI,giay-dep-nam,72508500,"Giày mọi nam cột dây Trường Hải màu đen bò da bò thật cao cấp không bong tróc đế cao su chống mòn không trơn GMTH01276",579000,659000,80000,12
TIKI,giay-dep-nam,169325607,"Giày Mọi Nam Màu Trắng Giày Lười  Nam Da Bò Cao Cấp Mềm Êm Chân -M04 Giày SAGO’S Bảo Hành 12 tháng (tặng vớ khử mùi)",650000,650000,0,0
TIKI,giay-dep-nam,57722527,"Giày nam, giày sneaker thể thao nam tăng chiều cao lót thông hơi cao cấp mẫu mới nhất SP-A344",119000,119000,0,0
TIKI,giay-dep-nam,179060493,"Dép sục cross literide màu đen tuyền êm mềm nam nữa hàng xuất xịn, mẫu mới, full box",349000,349000,0,0
TIKI,giay-dep-nam,7995370,"Giày Converse Chuck Taylor All Star Classic Hi Top - 121186",1550000,1550000,0,0
TIKI,giay-dep-nam,7995659,"Giày Converse Chuck Taylor All Star Classic Low Top - 121176",1450000,1450000,0,0
TIKI,giay-dep-nam,84936254,"Giày thể thao nam buộc dây sneaker nam mẫu mới vải dệt cao cấp G179",149000,250000,101000,40
TIKI,giay-dep-nam,191694860,"Giày da nam công sở đế cao Bụi Leather G123 - Da bò Nappa cao cấp - Phong cách trẻ trung năng động - Bảo hành 12 tháng",599000,925000,326000,35
TIKI,giay-dep-nam,72513787,"Giày mọi nam cột dây Trường Hải màu đen bò da bò thật cao cấp không bong tróc đế cao su chống mòn không trơn GMTH01277",579000,659000,80000,12
TIKI,giay-dep-nam,175470163,"Giày chạy bộ nam Under Armour Flow Velociti Wind Prizm - 3024896-100",2857000,4395000,1538000,35
TIKI,giay-dep-nam,67626473,"HAVAIANAS - Dép unisex Top 4000029-0001-356",499000,499000,0,0
TIKI,giay-dep-nam,194961161,"Giày lười da nam Trường Hải màu đen da bò cao cấp  đế cao 2.5cm GM0302",607000,699000,92000,13
TIKI,giay-dep-nam,98611409,"GIÀY THỂ THAO NAM Sneakes S24",50000,50000,0,0
TIKI,giay-dep-nam,106188535,"Giày Thể Thao Nam S33  Thời Trang Full Đen",175000,250000,75000,30
TIKI,giay-dep-nam,38410915,"Dây giày Enito dành cho giày Super Star, Stan Smith, Campus - 140cm",140000,140000,0,0
TIKI,giay-dep-nam,39357560,"Giày Tây Nam Da Bò Mã BH04",450000,900000,450000,50
TIKI,giay-dep-nam,107801690,"Xi Kem Đánh Giày Tarrago Shoe Cream Chuyên Đánh Bóng Da, Bổ Sung Màu, Dưỡng Giày, Túi, Áo Da Cao Cấp XVSG70",126000,252000,126000,50
TIKI,giay-dep-nam,190099603,"Giày Lười Nam Da Nubuck Tomoyo TMN22701",1290000,2890000,1600000,55
TIKI,giay-dep-nam,98610988,"GIÀY THỂ THAO NAM/MẦU BỘ ĐỘI,GIAIÀY ĐI PHƯỢT,ĐI LAM S68",162000,162000,0,0
TIKI,giay-dep-nam,75990118,"Dép nam đế cao 3.5cm da bò thật may viền thủ công chắc chắn thời trang cao cấp chính hãng Trường Hải DC150",315000,359000,44000,12
TIKI,giay-dep-nam,175567700,"Dép quai ngang nữ và nam độn đế Ulzang, dép bánh mỳ siêu bền, k ngấm nước",30000,30000,0,0
TIKI,giay-dep-nam,175967798,"Dép Quai Ngang Nam Mẫu Đẹp KEEDO-KD1603 Full hộp - Đen",520000,520000,0,0
TIKI,giay-dep-nam,134363209,"Giày Sneaker Unisex Đi Êm Chân",150000,150000,0,0
TIKI,giay-dep-nam,109244535,"Giày thể thao nam, giày sneaker nam đế trong trẻ trung năng động Q03",220000,220000,0,0
TIKI,giay-dep-nam,170768872,"Xi đánh bóng giày Saphir Pate De Luxe BDC Pháp 50ml (XDG04)",190000,270000,80000,30
TIKI,giay-dep-nam,36382149,"Combo 3 đôi lót giày vải cotton Hương Quế (CI-14, viền đen CI-13, CI-02) giúp khử hôi chân - phòng cảm cúm tốt cho sức khỏe - Màu khác nhau",75000,75000,0,0
TIKI,giay-dep-nam,91865532,"HAVAIANAS - Dép nam Top Logomania 4144264",699000,699000,0,0
TIKI,giay-dep-nam,191739529,"Giày Sandal Nam The Bily Quai Chéo Đôi -  Đế Trắng Lót Đen Màu Đen BLDTMD02",329000,329000,0,0
TIKI,giay-dep-nam,72006736,"Giày mọi nam Trường Hải màu xanh lam bò da bò thật cao cấp không bong tróc đế cao su chống mòn không trơn GMTH098",561000,639000,78000,12
TIKI,giay-dep-nam,180318887,"MLB - Giày mule thời trang Playball Monogram 3AMUM212N",2090000,2090000,0,0
TIKI,giay-dep-nam,193720562,"Giày Martin Boot Nam Cổ Cao Collection của Anh (đế cao 7cm.)",1500000,1500000,0,0
TIKI,giay-dep-nam,107801851,"Bàn chải đánh giày tiện dụng đa năng XIMO (BCDG06)",35000,60000,25000,42
TIKI,giay-dep-nam,58451856,"Xịt bọt làm sạch giày Sneaker",50000,50000,0,0
TIKI,giay-dep-nam,95253772,"Dép quai kẹp Bitis xốp nam",180000,180000,0,0
TIKI,giay-dep-nam,129942076,"Giày Sneaker Unisex Vans  đi học chính hãng Sk8 Hi All White - VN000D5IW00",1665000,1850000,185000,10
TIKI,giay-dep-nam,167011051,"MLB - Giày thể thao Bigball Chunky Monogram 3ASHCM11N",3490000,3490000,0,0
TIKI,giay-dep-nam,110183814,"Giày Thể Thao Nam Spiso S42 Màu Đen Chũ X",170000,250000,80000,32
TIKI,giay-dep-nam,182139464,"Giày Thể Thao Sneaker Nam - Giầy Nam Đế Êm Chân, Da Lì S102 Có 2 màu",182500,250000,67500,27
TIKI,giay-dep-nam,42850070,"Xi đánh giày đen YUPPIES Glo King Liquid Sheo Polish 75ml-Back (Malaysia)",65000,65000,0,0
TIKI,giay-dep-nam,114647933,"Giày Thể Thao Nam SSN65 MẦU ĐEN chất liệu vải dệt  thoáng khí khử mùi hôi chân,đi chơi,tập gym thể thao",62700,66000,3300,5
TIKI,giay-dep-nam,83169638,"Dép cao su 3 quai ngang",338000,338000,0,0
TIKI,giay-dep-nam,165595275,"Giày Tây Nam Da Bò Thật BIGGBEN Cao Cấp GT217",749000,800000,51000,6
TIKI,giay-dep-nam,168878290,"Chai Xịt Khử Mùi Giày Dép, Chống Hôi Chân, Diệt Khuẩn Hiệu Quả Đến 24h Dung Tích 260ml",17000,17000,0,0
TIKI,giay-dep-nam,174505058,"Giày nam họa tiết phong cách hiện đại Đồ Da Thành Long 20370",200000,200000,0,0
TIKI,giay-dep-nam,16109067,"Dép tổ ong",60000,60000,0,0
TIKI,giay-dep-nam,188686784,"Lót Giày Thể Thao Chất Liệu Cao Su Non Mềm Êm LGN2024a",45000,45000,0,0
TIKI,giay-dep-nam,2738963,"Giày sandal nam Teramo TRM10",119000,119000,0,0
TIKI,giay-dep-nam,195865797,"PUMA - Giày thể thao nam Suede Classic XXI 374915",2499000,2499000,0,0
TIKI,giay-dep-nam,44939991,"Giày da nam màu trắng da bò thật  Trường Hải đế cao su GTN0597",503000,549000,46000,8
TIKI,giay-dep-nam,20298474,"Dép cao su nam nữ 1 quai ngang",300000,300000,0,0
TIKI,giay-dep-nam,109879019,"Đón Gót Giày Nhựa Màu Đen Giúp Dễ Dàng Khi Mang Giày",12000,12000,0,0
TIKI,giay-dep-nam,117043561,"Jibbitz Crocs JB Junk Foodie 5 Pcs - 10008713",595000,595000,0,0
TIKI,giay-dep-nam,215201148,"Dép hai quai ngang nam KEEDO KD0505 Full hộp",480000,480000,0,0
TIKI,giay-dep-nam,115841999,"Giầy sục da nam nót vàng sục xích trơn kèm video",199000,199000,0,0
TIKI,giay-dep-nam,57155828,"Giày Sneaker nam, Giày thể thao nam, giày da, 2 màu đen - trắng, đế cao su nguyên khối, đế nén khí êm, bền, khâu đế chắc chắn G145",149000,265000,116000,44
TIKI,giay-dep-nam,143363034,"Dép quai ngang nam Pu Buta/dép nam",90000,90000,0,0
TIKI,giay-dep-nam,72099855,"Giày thông hơi Urban Footpritn EVA fylon D2001 thời trang-OB001",139000,139000,0,0
TIKI,giay-dep-nam,202330673,"Giầy da Nam cao cấp giày buộc dây chuẩn giày nam đẹp kiểu giày tây công sở HS78 chuẩn hàng Việt Nam xuất xịn",800000,800000,0,0
TIKI,giay-dep-nam,1589773,"Giày Tây Nam Da Bò SUNPOLO SU3020N - Nâu",890000,890000,0,0
TIKI,giay-dep-nam,116982222,"Dung Dịch Tẩy Trắng Giày Plac, Chai Tẩy Giày Đánh Bay Mọi Vết Bẩn",16788,16788,0,0
TIKI,giay-dep-nam,14764093,"Giày rọ nam nâu da bò cao cấp GM031",342000,389000,47000,12
TIKI,giay-dep-nam,183539977,"Giày Lười Nam Da Nubuck Tomoyo TMN22901",1290000,2890000,1600000,55
TIKI,giay-dep-nam,106320873,"Giày Lười Vải Nam S90 Full Đen",50000,50000,0,0
TIKI,giay-dep-nam,101657284,"Bàn Chải Đánh Giày Da Lộn Dụng Cụ Vệ Sinh Giày Sans907",50000,50000,0,0
TIKI,giay-dep-nam,137253918,"Cục tẩy cho giày da lộn đánh bay vết bẩn cứng đầu",78000,78000,0,0
TIKI,giay-dep-nam,12053734,"Giày Lười Nam Tomoyo Penny Loafer George TMN06103",1290000,2890000,1600000,55
TIKI,giay-dep-nam,40971744,"Giày sneakers nam, Gnnew03 chất vải siêu nhẹ, đế casu, dáng thể thao, phong cách trẻ",50000,50000,0,0
TIKI,giay-dep-nam,100468475,"Giày lười da bò nam đế khâu thời trang, da thật, mềm mịn, đế cao su GD12",279000,390000,111000,28
TIKI,giay-dep-nam,114008697,"Huy hiệu (jibbitz) unisex Crocs Disney - 10006828",215000,215000,0,0
TIKI,giay-dep-nam,107801698,"Bàn chải gỗ đánh giày lông heo thật XIMO (XBCDG04)",55000,90000,35000,39
TIKI,giay-dep-nam,191636295,"Dép nam quai ngang da bò Nappa cao cấp Bụi Leather E110, phù hợp cho người cao tuổi, đế cao su non đi êm chân",320000,480000,160000,33
TIKI,giay-dep-nam,66624035,"Giày Thể Thao Nam, Giày Sneaker Nam Màu Đỏ Đế Êm Nhẹ S360",229000,450000,221000,49
TIKI,giay-dep-nam,55061399,"Giày Sneaker Thể Thao Nam Thời Trang Năng Động Mẫu Mới GN97",175000,250000,75000,30
TIKI,giay-dep-nam,177638102,"Dép Nam Bít Mũi Da Bò Thật BIGGBEN Cao Cấp DN304",339000,390000,51000,13
TIKI,giay-dep-nam,186275462,"Dép Nam thủ công da bò cao cấp TOMOYO TMD80402",540000,1200000,660000,55
TIKI,giay-dep-nam,195866241,"PUMA - Dép quai ngang bản lớn Leadcat FTR Comfort 380673",1199000,1199000,0,0
TIKI,giay-dep-nam,75331264,"Giày lười da thật nam phong cách Hàn Quốc đẹp cá tính mạnh mẽ - Mã 22977",299000,559000,260000,47
TIKI,giay-dep-nam,35374153,"Giày Nam Cao Cổ Da - Boot Nam Cao Cổ Da Bò Thật Đế Cao Su Đúc",448000,448000,0,0
TIKI,giay-dep-nam,176049488,"Dép Quai Ngang Nam Dán Xé Cao Cấp Da Bò Thật KEEDO-KD5515 Full box",750000,750000,0,0
TIKI,giay-dep-nam,115264010,"Dép Nam Quai Ngang Thái Lan o43106",190000,190000,0,0
TIKI,giay-dep-nam,76005615,"Dép nam quai ngang đế cao 3.5cm da bò thật chính hãng Trường Hải thời trang cao cấp DN0156",315000,359000,44000,12
TIKI,giay-dep-nam,68135899,"Giày thể thao nam, giày nam da siêu mềm K05",150000,150000,0,0
TIKI,giay-dep-nam,125244291,"Giày da nam cao cấp SALE Giày tây nam tăng chiều cao trẻ trung chất liệu da in vân đẹp bảo hành 12 tháng - Mã GEA11",210000,210000,0,0
TIKI,giay-dep-nam,84209998,"Giày Da Nam Bit Loafer Tomoyo TMN06901",1290000,2890000,1600000,55
TIKI,giay-dep-nam,150368917,"Dép nam quai chéo cao cấp KEEDO BH00202 hàng chuẩn màu đen",650000,650000,0,0
TIKI,giay-dep-nam,195865104,"PUMA - Giày thể thao nam Basket Classic XXI 374923",2299000,2299000,0,0
TIKI,giay-dep-nam,189179764,"Giày sneaker tăng chiều cao thời trang nam - 977",420000,420000,0,0
TIKI,giay-dep-nam,59481641,"Sandal nam Pierre Cardin PCMFWLE132BRW",1890000,1890000,0,0
TIKI,giay-dep-nam,56100515,"Giày Sneaker nam Trắng Tomoyo TMN21507",486000,1400000,914000,65
TIKI,giay-dep-nam,101291456,"Giày lười nam - Slip on nam vải - Mã S200",350000,350000,0,0
TIKI,giay-dep-nam,134362533,"Giày lười nam đi mưa đi biển đi dạo phố siêu êm siêu mềm không thấm nước",129000,129000,0,0
TIKI,giay-dep-nam,100202270,"Giày Lười Nam Da Bò Cao Cấp Trường Hải GM290 Đục Lỗ Thoáng Khí Màu Vàng  Đế Cao Su Êm Ái May Viền Chắc Chắn Tỉ Mỉ",394000,449000,55000,12
TIKI,giay-dep-nam,44066381,"Dép Thời Trang Nam Cao Cấp",43500,43500,0,0
TIKI,giay-dep-nam,98675051,"Giày Tây Nam Da Mềm, Đế Cao, Đã May Sẵng Cao Cấp",253500,253500,0,0
TIKI,giay-dep-nam,13030187,"Giày thể thao độn đế tăng chiều cao 5cm cực chất - Lex02",590000,590000,0,0
TIKI,giay-dep-nam,125270249,"Giầy sục nam da bò cực êm mềm Tomshoes, cam kết da thật 100",379000,379000,0,0
TIKI,giay-dep-nam,193667085,"Dép Sandal nam Bitas SPS.105",270000,270000,0,0
TIKI,giay-dep-nam,5518577,"Sandal Nam BIGGBEN Da Bò Thật Cao Cấp SD26",329000,400000,71000,18
TIKI,giay-dep-nam,68627892,"GIÀY TÂY NAM LỊCH LÃM DA BÓNG ĐẾ ĐEN DÂY XANH - ĐEN GC XANH",148000,148000,0,0
TIKI,giay-dep-nam,76226905,"Sandal nam cao cấp Pierre Cardin PCMFWL 135 - màu đen",1990000,1990000,0,0
TIKI,giay-dep-nam,98610856,"Giày thể thao nam giá rẻ đế êm đi thoáng khí",58900,62000,3100,5
TIKI,giay-dep-nam,89948464,"Giầy da cao cấp nam 20396",849000,978300,129300,13
TIKI,giay-dep-nam,7412129,"Viên Hút Ẩm Khử Mùi Giày Dép Crep Protect Pill (170g)",320000,320000,0,0
TIKI,giay-dep-nam,21479764,"Giày Sneaker Kid Converse Chuck Taylor All Star Classic Hi - Navy",850000,850000,0,0
TIKI,giay-dep-nam,150781018,"Giày Sandal Nam The Bily Quai Chéo - Màu Xám BL01X",319000,319000,0,0
TIKI,giay-dep-nam,183029254,"Giày Sandals Vento Nam Bít Mũi Dã Ngoại Trekking SD7606",345000,345000,0,0
TIKI,giay-dep-nam,11980491,"Giày Lười Nam Penny Loafer Tomoyo TMN08101",1290000,2890000,1600000,55
TIKI,giay-dep-nam,52181044,"Dép Xỏ Ngón Nam BIGGBEN Da Bò Thật DK56",299000,400000,101000,25
TIKI,giay-dep-nam,194131743,"Dép đúc quai ngang nam, nữ siêu nhẹ DUWA - Hàng chính hãng - TK193",89500,179000,89500,50
TIKI,giay-dep-nam,55747001,"Giày tây nam Trường Hải da bò thật mềm mại không bong tróc không dây mũi tròn màu nâu đế cao su không trơn GT0423",454000,485000,31000,6
TIKI,giay-dep-nam,194075303,"Giày Thể Thao Nam Hunter Core DSMH09400XNH",794000,794000,0,0
TIKI,giay-dep-nam,175469959,"Giày chạy bộ nam Under Armour HOVR Machina 2 Colorshift - 3024740",2857000,4395000,1538000,35
TIKI,giay-dep-nam,132080401,"Giày Bốt Nam Cổ Cao Giả Da Lộn BCC001 Nâu",269000,269000,0,0
TIKI,giay-dep-nam,74361944,"Giày tây nam kiểu quân đội da bò cao cấp BIGGBEN Cao Cấp GT205",579000,700000,121000,17
TIKI,giay-dep-nam,73821253,"Giày Thể Thao Nam Sneaker Cao Cấp - Kiểu Dáng Giày Cực Ngầu , Trẻ Trung, Siêu Êm Chân G168",129000,225000,96000,43
TIKI,giay-dep-nam,92480786,"MLB - Giày sneakers Chunky Low 32SHU2111",2590000,2590000,0,0
TIKI,giay-dep-nam,132204091,"Giày Cổ Cao Nam Timberland EarthKeepers Màu Nâu Đậm TB01555120",5516000,6490000,974000,15
TIKI,giay-dep-nam,173218485,"Dép nam da quai ngang mẫu mới nhất năm 2022",239000,239000,0,0
TIKI,giay-dep-nam,133236291,"Dép Nam xỏ ngón Thái Lan Adda 5TD20, Dép đúc nguyên khối siêu bền",160000,160000,0,0
TIKI,giay-dep-nam,13731376,"Giày Chelsea boot nam màu đen da trơn Revision 2 TFBKU8826 - Size",1190000,1190000,0,0
TIKI,giay-dep-nam,170889712,"Bút Repaint giày tẩy trắng, làm mới phục hồi giày, siêu tốc (Chính hãng TOYO) BVSG01",15000,30000,15000,50
TIKI,giay-dep-nam,79471458,"Giày da cao cấp Pierre Cardin PCMFWL 503 - màu đen",3490000,3490000,0,0
TIKI,giay-dep-nam,4418081,"Giày Chelsea Boot Tathanium Nam Màu Đen Da Mặt TFBKU8812",750000,750000,0,0
TIKI,giay-dep-nam,23922871,"Dép nam xỏ ngón đỏ da bò cao cấp TH - XN288",201000,229000,28000,12
TIKI,giay-dep-nam,12054360,"Giày Lười Nam Tomoyo Penny Loafer George TMN06101",1290000,2890000,1600000,55
TIKI,giay-dep-nam,125240791,"Giày Lười Nam - Dép Hở Gót ,Sục Nam chất liệu da pu đế cao su mã sản phẩm l195",210000,210000,0,0
TIKI,giay-dep-nam,181136632,"Giày tây nam big size Sans122 giầy da công sở cao cấp buộc dây da bóng 44 45 46 47 48 đen nâu đẹp mũi nhọn hàn quốc",349999,349999,0,0
TIKI,giay-dep-nam,74012396,"Sandal nam cao cấp Pierre Cardin PCMFWLE136BRW",1990000,1990000,0,0
TIKI,giay-dep-nam,171194922,"DÉP NAM QUAI NGANG DA BÒ CAO CẤP VA2005",159000,299000,140000,47
TIKI,giay-dep-nam,179060291,"Dép sục cross nam nữ oflaod màu kaki vàng đi mưa, thoáng, bền, hàng xịn, full box",379000,379000,0,0
TIKI,giay-dep-nam,75355152,"Giày Thể Thao Vải Nam Sneaker Sợi Dệt Cao Cấp Kiểu Dáng Mạnh Mẽ G172",135000,240000,105000,44
TIKI,giay-dep-nam,170522100,"Giày Sandal Nam thủ công da bò cao cấp TOMOYO TMS80101",540000,1200000,660000,55
TIKI,giay-dep-nam,163546136,"Giày Boots Combat Boot Doc.058 Full Black Da bò sáp Lucas Shoes",769000,769000,0,0
TIKI,giay-dep-nam,141111509,"Dép Da Nam Cao Cấp Việt Hưng-Da Bò Thât 100%-VH2040",250000,250000,0,0
TIKI,giay-dep-nam,22473943,"Dép Nam BIGGBEN Da Bò Thật Cao Cấp DN171",339000,450000,111000,25
TIKI,giay-dep-nam,107801743,"Xi kem chuyên sửa chữa đồ da bị vết trầy xước, bong tróc và đánh bóng giày, túi ví, áo, ghế da EIDECHSE (50ml) (XDG08)",75000,144000,69000,48
TIKI,giay-dep-nam,125777824,"Giày mọi bằng nhựa siêu mềm êm chân",79900,79900,0,0
TIKI,giay-dep-nam,2731793,"Giày sandal nam Teramo TRM03",119000,119000,0,0
TIKI,giay-dep-nam,119288296,"Giày Sandal Nam TiTi ĐÔ Da Bò Thật Cao Cấp DNA2066a",420000,420000,0,0
TIKI,giay-dep-nam,68564272," [Sạch giày nhanh] Chai xịt bọt làm sạch giày dép SNEAKER 300ml siêu sạch",52000,52000,0,0
TIKI,giay-dep-nam,184059068,"Giày nam, giày sneakers nam tăng chiều cao 2022",179000,179000,0,0
TIKI,giay-dep-nam,164041145,"Giày Da Cao Cấp, Giày Boot Nam Da Bò Cao Cổ Đẹp chất, giày bốt nam cổ cao",610000,610000,0,0
TIKI,giay-dep-nam,132982941,"Giày Sandal Nam Da Bò SUNPOLO SDA023 (Đen, Nâu)",580000,580000,0,0
TIKI,giay-dep-nam,161402818,"Dép quai hậu nam và nữ ( đế đen quai trắng ) size từ 34 nữ đến 43 nam",82999,82999,0,0
TIKI,giay-dep-nam,49276907,"Giày Tây Nam Cao Cấp Cao Cấp - Giày Tây Nam Da Bò Thật 100% - Màu Nâu Mã BH022",450000,900000,450000,50
TIKI,giay-dep-nam,170768487,"Dung dịch làm sạch giày da lộn, nubuck Omnidaim Saphir (XDG20)",395000,500000,105000,21
TIKI,giay-dep-nam,101292445,"Giày lười nam - Slip on nam vải - Mã LY112",350000,350000,0,0
TIKI,giay-dep-nam,76064693,"Giày mọi giày lười nam da bò 100% màu trắng-T040",650000,650000,0,0
TIKI,giay-dep-nam,179060733,"Dép sục cross literide màu navy hồng êm mềm nam nữ hàng xuất xịn, mẫu mới, full box",349000,349000,0,0
TIKI,giay-dep-nam,144179867,"Dép nhựa nam tổ ong dép nam lao động dép đệm dép đệm vàng loại 1 mũ vàng óng dẻo dép tổ ong vàng dép nhựa vàng",49500,49500,0,0
TIKI,giay-dep-nam,179547004,"Giày Nam Cổ Lửng Đen Da Bò, Kiểu Chukka Mã CK02",550000,1100000,550000,50
TIKI,giay-dep-nam,38004432,"Giày Vải Sneaker Nam Nữ Thể Thao CV9",199000,199000,0,0
TIKI,giay-dep-nam,101292156,"Giày lười nam - Slip on nam vải - Mã LY69",350000,350000,0,0
TIKI,giay-dep-nam,81572257,"Giày da nam giày da bò nam giày nam giày cho bố giày trung niên cao cấp thời trang phong cách Hàn Quốc mã T26555 tặng kèm 1 chiếc vòng đeo tay gỗ quý ngẫu nhiên",406980,798000,391020,49
TIKI,giay-dep-nam,7995403,"Giày Converse Chuck Taylor All Star Classic Hi Top - 121184",1550000,1550000,0,0
TIKI,giay-dep-nam,158813587,"Giày Nam Pierre Cardin - PCMFWLF 513",2990000,2990000,0,0
TIKI,giay-dep-nam,71957827,"Giày mọi nam Trường Hải màu xanh lam bò da bò thật cao cấp không bong tróc đế cao su chống mòn không trơn GMTH097",561000,639000,78000,12
TIKI,giay-dep-nam,193629653,"Giày dép Sandals Vento ALPHA I Teen/Trẻ em màu Đen đi học/đi dã ngoại/đi chơi SD08001",365000,365000,0,0
TIKI,giay-dep-nam,175107684,"GIÀY SỤC NAM DA BÒ CAO CẤP VATIS VA2026",249000,459000,210000,46
TIKI,giay-dep-nam,177164354,"Giày Lười Unisex NATIVE Ad Jefferson",1400000,1400000,0,0
TIKI,giay-dep-nam,88821249,"Giày Da nam cực chất xả kho giá gốc- giày lười nam-mã L143",210000,210000,0,0
TIKI,giay-dep-nam,174469157,"Giày Nam Pierre Cardin Tassel Loafer - PCMFWLF 347",4990000,4990000,0,0
TIKI,giay-dep-nam,179881617,"Giày Tây Nam Công Sở HÀ NAM Da Bò Thật Cao Cấp GT2025c",720000,720000,0,0
TIKI,giay-dep-nam,59566521,"Giày Nam Sneaker TOMOYO TMN21501",545000,1400000,855000,61
TIKI,giay-dep-nam,105127015,"Sandal nam Pierre Cardin PCMFWL 148 - Màu nâu",945000,1890000,945000,50
TIKI,giay-dep-nam,10063653,"Dép Nam Bít Mũi BIGGBEN Da Bò ThậtDN145",349000,500000,151000,30
TIKI,giay-dep-nam,26668251,"Dép Nam BIGGBEN Da Bò Thật Cao Cấp DN198",299000,370000,71000,19
TIKI,giay-dep-nam,161490202,"Giày lười vải nam thoáng khí tuổi trung niên - Dây giày co giãn thông minh không cần buộc",135000,135000,0,0
TIKI,giay-dep-nam,108001009,"Combo Bàn Chải Đánh Giày + Xi Kiwi, Aromax, Starwax Nhập Khẩu Thái Lan, Hàn Quốc, Malaysia",48000,55000,7000,13
TIKI,giay-dep-nam,120169480,"Dụng cụ Đón gót giày bằng sừng nguyên chiếc (Dài 32-37cm) DGH901-35 - Đón gót giày mọi tư thế cho cả nam và nữ",94050,99000,4950,5
TIKI,giay-dep-nam,153570444,"Giày Sục Đạp Gót Mules Vải Sneaker Unisex Tăng Chiều Cao 4cm DINCOX E10 Off/white",520000,520000,0,0
TIKI,giay-dep-nam,193629662,"Giày dép Sandal Nam VENTO VEGA III Nam màu Ghi đi học/đi làm NB10605",395000,395000,0,0
TIKI,giay-dep-nam,12077288,"Crep Protect Travel Kit -Bộ Vệ Sinh Giày Crep Protect Du Lịch",580000,650000,70000,11
TIKI,giay-dep-nam,101656114,"Giày da nam cao cấp Sans121 giầy tây không dây đen nâu trắng bigsize size lớn 43 44 45 46 47 48 cỡ nhỏ 37 38 39 40 41",329000,329000,0,0
TIKI,giay-dep-nam,24999282,"Giày mọi nam khóa trắng da bò cao cấp TH - GMN02",456000,519000,63000,12
TIKI,giay-dep-nam,190754904,"Dép Nam Da Bò Thật May Đế BIGGBEN Cao Cấp DN315",369000,450000,81000,18
TIKI,giay-dep-nam,44459456,"Lót đế giày đa năng silicon êm chân, thoáng khí, lót giày thể thao cao cấp chống sốc, tiện dụng - mã LG07",79000,79000,0,0
TIKI,giay-dep-nam,100223824,"Giày Mọi Nam Trường Hải Da Bò Thật Cao Cấp Đục Lỗ Thoáng Khí , Giày Rọ Nam Thời Trang Mùa Hè",394000,449000,55000,12
TIKI,giay-dep-nam,150780873,"Giày Sandal Nam The Bily Quai Chéo - Màu Trắng BL01T",319000,319000,0,0
TIKI,giay-dep-nam,183376055,"Dép Quai Ngang Nam Mẫu Mới KEEDO-KD0404",480000,480000,0,0
TIKI,giay-dep-nam,38142632,"Giày Tây Nam Cao Đông Hải - G2515",1190000,1190000,0,0
TIKI,giay-dep-nam,7350639,"Sandal Nam Doctor BIGGBEN Da Bò Thật Cao Cấp SD62",339000,450000,111000,25
TIKI,giay-dep-nam,2879683,"Giày Lười Da Nam PU - Đen (Size",85000,85000,0,0
TIKI,giay-dep-nam,192642401,"Giày Thể Thao Nam Biti's Hunter X LITEPLEX DSMH09800",1010000,1010000,0,0
TIKI,giay-dep-nam,124275963,"Khăn Lau Giày Sneaker Siêu Sạch Gói 12 Miếng",25000,27000,2000,7
TIKI,giay-dep-nam,150759459,"Giày Sandal Nam The Bily Quai Ngang - Màu Đen BL03D",339000,339000,0,0
TIKI,giay-dep-nam,93244265,"Giày sandal nam /dép quai hậu nam công sở da thật mã 692.LK",294500,589000,294500,50
TIKI,giay-dep-nam,186875003,"giày da nam công sở không dây lịch lãm 2022",160000,160000,0,0
TIKI,giay-dep-nam,100870352,"Giày Tây Nam Tăng Cao, Cổ Lửng, Da Bò, Mã CK02",650000,1300000,650000,50
TIKI,giay-dep-nam,119288190,"Giày Sandal Nam TiTi ĐÔ Da Bò Thật Cao Cấp DNA2137a",460000,460000,0,0
TIKI,giay-dep-nam,188206556,"Giày da nam big size Sans144 giầy tây bigsize 44 45 46 47 48 49 50 to cỡ lớn công sở cao cấp lười không dây da bóng",399000,399000,0,0
TIKI,giay-dep-nam,169313383,"Giày Bảo Hộ Lao Động Nam Thể Thao Sneaker JB792 - Cao Su Chống Cháy - Chống Tĩnh Điện - Tặng Kèm Bó Chân",428000,428000,0,0
TIKI,giay-dep-nam,20008606,"Giày Converse Chuck Taylor All Star 1970s Sunflower Hi Top - 162054C",2000000,2000000,0,0
TIKI,giay-dep-nam,186272420,"Giày Tây Nam Công Sở Oxford Tomoyo Da Bò Nhập Khẩu Cao Cấp TMN22502",1290000,2890000,1600000,55
TIKI,giay-dep-nam,88821201,"Giày Da nam cực chất xả kho giá gốc- giày lười nam-mã G004",210000,210000,0,0
TIKI,giay-dep-nam,111231565,"Giày sandal nam 3 quai trơn LAHSTORE",89000,89000,0,0
TIKI,giay-dep-nam,12879035,"Dép kẹp nam đen Trường Hải da bò cao cấp  TH041",254000,289000,35000,12
TIKI,giay-dep-nam,133868746,"Giày lười nam da mềm, phối 3D lạ mắt, đế cao su êm chân",109000,109000,0,0
TIKI,giay-dep-nam,127379344,"Giày Sneaker Da Unisex DINCOX D20 Năng Động Cá Tính White/Black",550000,550000,0,0
TIKI,giay-dep-nam,101291412,"Giày lười nam - Slip on nam da - Mã A2195",350000,350000,0,0
TIKI,giay-dep-nam,107367614,"Dép Nam Da Bò BIGGBEN Cao Cấp DN277",329000,400000,71000,18
TIKI,giay-dep-nam,133235261,"Dép nam Xỏ ngón, Dép kẹp Nam Thái Lan Kito AA64M",230000,230000,0,0
TIKI,giay-dep-nam,44928495,"Giày nam da bò đế doctor Trường hải da bò cao cấp mêm mại GN045",521000,600000,79000,13
TIKI,giay-dep-nam,181786022,"Giày ghệt rằn ri mẫu mới năm 2020",410000,410000,0,0
TIKI,giay-dep-nam,19677660,"Dép quai ngang nam da bò cao cấp Trường Hải QN075",306000,349000,43000,12
TIKI,giay-dep-nam,6277221,"Dép Nam Bít Mũi BIGGBEN Da Bò Thật DN51",399000,550000,151000,27
TIKI,giay-dep-nam,114021232,"Huy hiệu (jibbitz) unisex Crocs Black Panther Charm - 10007316",215000,215000,0,0
TIKI,giay-dep-nam,184603176,"Giày thể thao nam, giày sneaker nam 2 màu xám và kem - H02",220000,220000,0,0
TIKI,giay-dep-nam,97585643,"Giày Lười Nam Da Bóng Giá Rẻ - Đế Cao 3cm - Mã L157 Màu Đen - Hàng VN",210000,210000,0,0
TIKI,giay-dep-nam,116143857,"Lót giày thể thao Arch Support Sport Focare êm chân tốt cho gan bàn chân LGF01",225000,350000,125000,36
TIKI,giay-dep-nam,127581070,"Giày Da Thể Thao LC2101X da bò sáp",650000,650000,0,0
TIKI,giay-dep-nam,175869304,"Giày thể thao Bitis nam",725000,725000,0,0
TIKI,giay-dep-nam,161966841,"Giày thể thao nam full trắng đen Sans207 sneakers basic đơn giản buộc dây sport đế bằng thời trang trẻ trung cá tính",50000,50000,0,0
TIKI,giay-dep-nam,170079091,"Giày Sandal Nam thủ công da bò cao cấp TOMOYO TMS80201",540000,1200000,660000,55
TIKI,giay-dep-nam,82496714,"Combo Xi và Bàn Chải Đánh Bóng Giày - TC0701",65550,69000,3450,5
TIKI,giay-dep-nam,44069928,"Giày Tây Lê Sang Nam Phối Khóa Lịch Lãm QN",223500,223500,0,0
TIKI,giay-dep-nam,66575431,"Dép bít mũi nam da bò thật HÀ NAM cao cấp GSB2039",420000,420000,0,0
TIKI,giay-dep-nam,110183305,"Giày Thể Thao Nam Cổ Cao Runner MS028 Đen",55300,79000,23700,30
TIKI,giay-dep-nam,103754523,"Dép nam 2 quai da bò 100%, hàng cao cấp, may handmade full quai và đế chắc chắn, đi rất êm chân",329000,500000,171000,34
TIKI,giay-dep-nam,68971142,"Dép thời trang nam 2020 Nhật Bản sừng hươu",129000,199000,70000,35
TIKI,giay-dep-nam,181786302,"Giày vải bảo hộ lao động cao cổ đế cao su",120000,120000,0,0
TIKI,giay-dep-nam,179912077,"Dép Nam Quai Ngang Thời Trang Kiểu Hàn Quốc Cá Tính Và Năng Động D03",45000,45000,0,0
TIKI,giay-dep-nam,97946795,"GIÀY NHỰA NAM CAO CẤP FITTOP GIAY-003-2",527800,527800,0,0
TIKI,giay-dep-nam,171535953,"Dép quai ngang nam nữ M Masler-MT Italy có lớp đế nhẹ chân chống trượt và dễ vệ sinh ITA",290000,290000,0,0
TIKI,giay-dep-nam,10037609,"Giày Mọi Đế âm Nam BIGGBEN Da Bò Thật  GM140",600000,600000,0,0
TIKI,giay-dep-nam,183076321,"Dép kẹp nam quai dù cao cấp KEEDO KD00103 Full Box",480000,480000,0,0
TIKI,giay-dep-nam,179510756," Dép da nam cao cấp, may quai chắc chắn bao đi mưa, donavynike",169000,300000,131000,44
TIKI,giay-dep-nam,170964317,"Giày Mọi Nam Da Bò Thật-Giày Lười Da Cao Cấp Màu Đen-M04 Giày SAGO’S (tặng 1 vớ khử mùi)",790000,790000,0,0
TIKI,giay-dep-nam,37865549,"Giày Tây Đông Hải - G2510",1090000,1090000,0,0
TIKI,giay-dep-nam,195950012,"Giày Sneaker Da Nam DINCOX E11 Sang Trọng Lịch Thiệp Tan",527000,527000,0,0
TIKI,giay-dep-nam,98254555,"Giày Da Nam Bảo Hân Đế Khâu- Da Bò Mã D65",420000,840000,420000,50
TIKI,giay-dep-nam,196856291,"Giày tây nam Pierre Cardin - PCMFWLG 760",2990000,2990000,0,0
TIKI,giay-dep-nam,195865364,"PUMA - Dép quai ngang bản lớn Leadcat 2.0 384139",899000,899000,0,0
TIKI,giay-dep-nam,23961004,"Dép quai ngang nam da bò cao cấp QN013",311000,339000,28000,8
TIKI,giay-dep-nam,98675727,"Giày Sneaker Nam Tomoyo "Siêu Êm" TMN21008",1290000,2890000,1600000,55
TIKI,giay-dep-nam,176759298,"Dép Quai Ngang Nam Nữ Siêu Nhẹ Tăng Chiều Cao Chống Trơn Đế 4CM",57000,69000,12000,17
TIKI,giay-dep-nam,179060224,"Dép sục cross literide màu kem cam êm mềm nam nữ hàng xuất xịn, mẫu mới, full box",339000,339000,0,0
TIKI,giay-dep-nam,56109882,"Giày Tây Nam Saddel Da Tomoyo TMN11602",1290000,2890000,1600000,55
TIKI,giay-dep-nam,86966889,"GIày Sandal Nam Da Bò BIGGBEN Cao Cấp SD113",339000,400000,61000,15
TIKI,giay-dep-nam,170571314,"Xi đánh giày, đánh bóng đồ da cao cấp D4",38000,38000,0,0
TIKI,giay-dep-nam,197865599,"Dép Nam Quai Ngang Hàng Cao Cấp BEE GEE DNA1013- Màu Đen",220000,440000,220000,50
TIKI,giay-dep-nam,139192019,"Khăn giấy ướt lau giày sneaker , Khăn giấy ướt vệ sinh giày thể thao chuyên dụng",10000,25000,15000,60
TIKI,giay-dep-nam,87120671,"Giày Sneaker Nam Tomoyo TMN05402",471000,1400000,929000,66
TIKI,giay-dep-nam,138481508,"Giày lười nam Đông Hải da bò cao cấp lộ rõ vân tăng vẻ  nam tính cùng thiết kế tinh xảo dễ phối đồ - G2279",1390000,1390000,0,0
TIKI,giay-dep-nam,215260573,"Dép nam hai quai cao cấp KD1703 siêu bền full hộp, đế cao su chống trơn trượt",480000,480000,0,0
TIKI,giay-dep-nam,45285600,"Dép quai ngang nam GIA VY - TL377",195000,195000,0,0
TIKI,giay-dep-nam,56510051,"Giày Sneaker Unisex Vans UA Bold NI Distort White VN0A3WLPWP3",1700000,1700000,0,0
TIKI,giay-dep-nam,6394535,"Dép Nam BIGGBEN Da Bò Thật DN54",349000,500000,151000,30
TIKI,giay-dep-nam,7997276,"Giày Sneaker Unisex Converse Chuck Taylor All Star 1970s All Hi 2018 - White (Size",2000000,2000000,0,0
TIKI,giay-dep-nam,5517433,"Sandal Bít Mũi BIGGBEN Da Bò Thật Cao Cấp SD24",419000,500000,81000,16
TIKI,giay-dep-nam,7995447,"Giày Converse Chuck Taylor All Star Classic Low Top - M5039V",1450000,1450000,0,0
TIKI,giay-dep-nam,63229031,"GIÀY SANDAL NAM GIAVY SL377",200000,200000,0,0
TIKI,giay-dep-nam,175453407,"Giày sandal nam Teva Hurricane Xlt2 - 1019234",1495000,1495000,0,0
TIKI,giay-dep-nam,184600520,"Giày thể thao nam, giày sneakers nam Vir - R001",220000,220000,0,0
TIKI,giay-dep-nam,92344130,"Giày Lười Tomoyo  Da Bò Đế Khắc Rãnh Giảm Chấn - Lót Da Cừu Cao Cấp TMN60101",1290000,2890000,1600000,55
TIKI,giay-dep-nam,173609087,"DÉP DA BÒ CAO CẤP VATIS VA2011",209000,379000,170000,45
TIKI,giay-dep-nam,7976051,"Giày Mọi Nam Da Bò Sunpolo SUMU1732DN",900000,900000,0,0
TIKI,giay-dep-nam,171535424,"Dép quai ngang nam nữ M Masler-MT màu xanh dương quai trắng với lớp đế êm chân chống trượt XDT",278000,278000,0,0
TIKI,giay-dep-nam,98296618,"Giày Sneaker Thể Thao Nam HiNiTi T006 Dáng Đẹp- Năng Động Tặng Tất Khử Mùi",96900,102000,5100,5
TIKI,giay-dep-nam,7674867,"Giày sneaker TOMOYO TMN10902",630000,1400000,770000,55
TIKI,giay-dep-nam,172950119,"Giày lười nam , Giày da  Beck Be GD01",260000,260000,0,0
TIKI,giay-dep-nam,7412195,"Cục Tẩy Vết Bẩn Crep Protect Eraser (110g)",250000,250000,0,0
TIKI,giay-dep-nam,2879043,"Giày Sneaker Nam Siêu Nhẹ Gnnew03",50000,50000,0,0
TIKI,giay-dep-nam,75028302,"Giày da bò nam thật phong cách Hàn Quốc ,năng động cá tính thời trang dành cho nam - mã T79711",899000,1599000,700000,44
TIKI,giay-dep-nam,157763659,"Bộ Vệ Sinh Giày Crep Protect X DJ Khaled Box Set",990000,990000,0,0
TIKI,giay-dep-nam,177165698,"Giày Lười Unisex NATIVE Jefferson Print - Celtuse Green/ Shell White/ Memento Floral - 34.5",1650000,1650000,0,0
TIKI,giay-dep-nam,46205844,"Giầy boots nam da thật cao cổ, kéo khóa 5SMN033",595000,595000,0,0
TIKI,giay-dep-nam,73815916,"Giày mọi nam cột dây Trường Hải màu đen bò da bò thật cao cấp không bong tróc đế cao su chống mòn không trơn GMTH01278",488000,659000,171000,26
TIKI,giay-dep-nam,2829851,"Giày da bò thể thao VO VP09_3660",215000,430000,215000,50
TIKI,giay-dep-nam,180576369,"Giày Nam Cổ Lửng Chukka Đen Da Bò, Mã MCK02",650000,1300000,650000,50
TIKI,giay-dep-nam,64373752,"Combo 5 đế lót giày mùi quế",75000,75000,0,0
TIKI,giay-dep-nam,101657125,"Lót Giày Thoáng Mát Lót Giầy Khử Mùi Sans911",44000,44000,0,0
TIKI,giay-dep-nam,110993072,"[BestSeller] Giày thể thao nam, giày sneaker độn đế nam đế loang cam nổi bật JT001",200000,200000,0,0
TIKI,giay-dep-nam,191592564,"Giày da nam Combat Boots Iron 01 (Iron01), da bò sáp đen, đế cao su đúc CNM, Lucas Shoes bảo hành 1 năm",869000,869000,0,0
TIKI,giay-dep-nam,193629588,"Giày dép Sandal Nam VENTO VEGA III Nam màu Đen đi học/đi làm NB10605",395000,395000,0,0
TIKI,giay-dep-nam,26667448,"Dép Nam BIGGBEN Da Bò Thật Cao Cấp DN197",299000,350000,51000,15
TIKI,giay-dep-nam,134777591,"Giày lười da tăng chiều cao nam Bụi Leather G112 - Da bò Nappa cao cấp - Bảo hành 12 tháng",515000,840000,325000,39
TIKI,giay-dep-nam,114626043,"Giày lười đi làm đi lao động mầu đen kiểu dáng ôm chân loại đẹp vải dày SSN(ẢNH THẬT)",84550,89000,4450,5
TIKI,giay-dep-nam,50446501,"Sandal Nam- Dép Sandal Nam Da Bò- Mã DE02",200000,400000,200000,50
TIKI,giay-dep-nam,125568058,"Dép Quai Ngang Nam Da Bò SUNPOLO SNA102 Trẻ trung, Năng động (Đen, Nâu bò)",420000,420000,0,0
TIKI,giay-dep-nam,7977235,"Giày Mọi Nam Da Bò Sunpolo SUS505N",650000,650000,0,0
TIKI,giay-dep-nam,169249535,"Giấy ướt lau giầy, có sẵn nước tẩy lau giày, giữ cho giày luôn sạch bóng 30 tờ/túi",27658,27658,0,0
TIKI,giay-dep-nam,174385282,"GIÀY SỤC DA BÒ NAM CAO CẤP VATIS VA2023",249000,459000,210000,46
TIKI,giay-dep-nam,87130224,"Giày Sneaker Nam "Siêu Êm" Tomoyo TMN20801",1290000,2890000,1600000,55
TIKI,giay-dep-nam,186907758,"Giày Nam Công Sở Lịch Lãm Kiểu Dáng Giả Dây Cột Phù Hợp Mọi Lứa Tuổi size 39 đến 43",160000,160000,0,0
TIKI,giay-dep-nam,183525153,"Giày Nam Chất Liệu Vải polyester (gió) chống thấm, Đế Cao Su Mềm NEW 2022",169000,169000,0,0
TIKI,giay-dep-nam,125536821,"Dép Nam Quai Chéo Da Bò Cao Cấp SUNPOLO AQC026 (Đen)",550000,550000,0,0
TIKI,giay-dep-nam,37913003,"Dép Nam Đông Hải D1809",590000,590000,0,0
TIKI,giay-dep-nam,112188948,"Dép Nam Quai Ngang HÀ NAM Da Bò Thật Cao Cấp DNA2074",299000,299000,0,0
TIKI,giay-dep-nam,127380321,"Giày Sneaker Vải Unisex DINCOX D27 Đơn Giản Hiện Đại Chocolate",470000,470000,0,0
TIKI,giay-dep-nam,161405550,"Dép quai hậu nam và nữ ( đế đen quai đen ) size từ 35 đến 42 nam",82888,82888,0,0
TIKI,giay-dep-nam,71972788,"Giày sneakers vải nam cổ lửng, chất vải bố đế casu bền chắc, thời trang thu đông 2020",120000,120000,0,0
TIKI,giay-dep-nam,253043474,"Giày lười nam công sở, dự tiệc cao cấp thiết kế sang trọng nhẹ nhàng",600000,600000,0,0
TIKI,giay-dep-nam,164295730,"Giày sneaker unisex Fila Filargb Fuse - 1RM01259D",1197000,1995000,798000,40
TIKI,giay-dep-nam,91743207,"Chai nước rửa giày, dung dịch vệ sinh túi xách, Nước Lau Giày, Túi Xách Plac Thần Thánh - Đầu Cọ",19000,19000,0,0
TIKI,giay-dep-nam,88821121,"Giày Da nam cực chất xả kho giá gốc - giày lười nam L179",210000,210000,0,0
TIKI,giay-dep-nam,180391044,"Dép nam xỏ ngón Trường Hải da bò thật màu nâu mặt đúc chịu nước XN151",255000,339000,84000,25
TIKI,giay-dep-nam,169828312,"Giày Tây Nam Tăng Chiều Cao Da Bò Mã GK 02 , Tăng Cao 6.5 Cm",810000,810000,0,0
TIKI,giay-dep-nam,109878998,"Giày Thể Thao Nam Sneaker Tập Gym Thể Dục Dã Ngoại Đi Làm Đi Học Êm Chân Mềm Giá Rẻ Thoáng Chân G184",68000,68000,0,0
TIKI,giay-dep-nam,170571764,"Giày lười da bò nam cao cấp, đế cao su đúc - 3 màu đen, nâu, vàng - giày đi ôm, êm, nhẹ - G116",249000,400000,151000,38
TIKI,giay-dep-nam,17960399,"Giày mọi nam da bò màu đen Trường Hải da mềm mại",465000,529000,64000,12
TIKI,giay-dep-nam,170337857,"Dép quai ngang nam đế đúc siêu nhẹ DUWA",85000,85000,0,0
TIKI,giay-dep-nam,146955421,"Giày Sandal Nam The Bily  Quai Chéo - Xám Thổ Cẩm BL01XTC",319000,319000,0,0
TIKI,giay-dep-nam,170599782,"Giầy Lười Da Bò Cao Cấp,  Đế Cao Su, Da Thật, Vân hạt, ôm chân cực bền GD08",299000,400000,101000,25
TIKI,giay-dep-nam,188429321,"Dép quai kẹp Bitis nam",190000,190000,0,0
TIKI,giay-dep-nam,95289298,"Dép Nam Quai Ngang  Da Bò Chính Hãng Trường Hải Màu Đen DN166  Thời Trang Cao Cấp Trẻ Trung",306000,349000,43000,12
TIKI,giay-dep-nam,7975986,"Giày Mọi Nam Da Bò Sunpolo SUMU05DN",900000,900000,0,0
TIKI,giay-dep-nam,175470012,"Giày chạy bộ nam Under Armour HOVR Machina 2 SE - 3024738-002",2857000,4395000,1538000,35
TIKI,giay-dep-nam,17610477,"Giày Penny Loafer George Tomoyo Da Bò đế âm TMN06104",1290000,2890000,1600000,55
TIKI,giay-dep-nam,110220065,"[SIÊU NHẸ_SIÊU BỀN] Dép nhựa nam quai ngang chất lượng, êm chân SM004",68000,75000,7000,9
TIKI,giay-dep-nam,133236297,"Dép Nam Xỏ ngón Thái Lan ADDA 22G11",210000,210000,0,0
TIKI,giay-dep-nam,117042388,"Huy hiệu (Jibbitz) Crocs Baby Shark 10007934 - 1 cái",215000,215000,0,0
TIKI,giay-dep-nam,101655797,"Giày tây nam cao cấp Sans183 derby giầy da bò đế trơn bóng buộc dây âu văn phòng classic mặc vest chú rể đám cưới",99999,99999,0,0
TIKI,giay-dep-nam,56049736,"Giày đi bộ Nam KTP Teanex",399000,399000,0,0
TIKI,giay-dep-nam,109090904,"Giày Da Trung Niên, Giày Tây Nam Cao Cấp, Tặng Kèm 2 Đôi Tất Xanh",249000,249000,0,0
TIKI,giay-dep-nam,68026895,"  Giày thể thao nam, Giày nam tăng chiều cao 5cm Phản Quang WATAHHH cực chất CK01",300000,300000,0,0
TIKI,giay-dep-nam,126155424,"Đón gót giày bằng sừng liền khối (DGH904) Cứng chắc/ bền/ bóng đẹp /màu sắc tự nhiên - Cho giày Nam & Nữ ",65550,69000,3450,5
TIKI,giay-dep-nam,98297068,"Giày Thể Thao Nam Sport Abu Mạnh Mẽ- Màu Ghi008",94050,99000,4950,5
TIKI,giay-dep-nam,200618355,"Giày nam cao cổ khóa kéo Sans106 da bò thật bigsize lớn 48 47 46 45 44 43 giầy boot tăng chiều cao bốt độn đế 6cm",519999,519999,0,0
TIKI,giay-dep-nam,69691237,"Giày bốt cao cổ nam da bóng",350000,350000,0,0
TIKI,giay-dep-nam,53245551,"Giày mọi nam Trường Hải màu nâu da bò thật cao cấp không bong tróc đế cao su chống mòn không trơn GMTH092",433000,499000,66000,13
TIKI,giay-dep-nam,76124790,"Giày Lười, Mọi Da Nam, Da Bò Mã GL-005",450000,900000,450000,50
TIKI,giay-dep-nam,73389715,"Cao lau đa năng, sáp lau đa năng tinh dầu,Sáp lau túi xách , làm trắng giày dép 206740",13000,14799,1799,12
TIKI,giay-dep-nam,7995270,"Giày Converse Chuck Taylor All Star Classic Hi Top - M3310V",1550000,1550000,0,0
TIKI,giay-dep-nam,191740391,"Giày Sandal Nam The Bily Quai Chéo Đôi -  Đế Trắng Lót Đen Màu Trắng BLDTMD02",329000,329000,0,0
TIKI,giay-dep-nam,101656494,"Bàn Chải Đánh Giày Lông Ngựa Sans909",55000,55000,0,0
TIKI,giay-dep-nam,129351856,"Giày Sandals VENTO DAVION Nam Quai Ngang dạo phố đi chơi đi học du lịch NB147",365000,365000,0,0
TIKI,giay-dep-nam,112245480,"Dép xỏ ngón, dép kẹp, dép tông nam da bò cao cấp mã T56941",268000,499000,231000,46
TIKI,giay-dep-nam,179060937,"Dép lê nhựa Cross band baya màu ghi nam nữ, bền, chắc, k trơn trượt",359000,359000,0,0
TIKI,giay-dep-nam,51063282,"Giày Mọi Nam Da Bò Thật Cao Cấp GM03",549000,549000,0,0
TIKI,giay-dep-nam,79730992,"DÉP NAM DA BÒ THẬT 100%, HÀNG CÔNG TY XUẤT KHẨU",269000,500000,231000,46
TIKI,giay-dep-nam,173218655,"Dép nam quai ngang",272000,272000,0,0
TIKI,giay-dep-nam,6811197,"Giày tây nam ,da bò, tăng chiều cao VO – VP09-3651-1",540000,580000,40000,7
TIKI,giay-dep-nam,50351462,"Giày sục nam da bò mũi nhọn Trường Hải đế cao 3.5cm phong cách lịch sự BM0455",329000,379000,50000,13
TIKI,giay-dep-nam,155438708,"Giầy cổ bạt ALTAMA - USA",1099000,1099000,0,0
TIKI,giay-dep-nam,183524070,"Giày thể thao nam, giày nam sợi vải thể thao cao cấp 2022",129000,129000,0,0
TIKI,giay-dep-nam,169862449,"Lót Giày Da Bò Thật-L04 Tấm Lót Giày Giúp Ôm Chân Khi Giày Dãng Rộng,Thấm Hút Mồ Hôi Khử Mùi Hiệu Quả -Giày SAGO’S",43000,43000,0,0
TIKI,giay-dep-nam,13120569,"Dép xỏ ngón nam da bò Trường Hải nâu TH047",254000,289000,35000,12
TIKI,giay-dep-nam,172316684,"Dép Nam Quai Ngang TiTi ĐÔ Da Bò Thật Cao Cấp DN2076c",389000,389000,0,0
TIKI,giay-dep-nam,151952885,"Xi Đánh Giày Nước Kleen Làm Sạch, Làm Bóng Và Dưỡng Nhiều Màu",49000,49000,0,0
TIKI,giay-dep-nam,176896681,"Giày da nam dây buộc - Giày tây nam công sở da bò thật - Bảo hành 12 tháng - GT 107 Manzo store",90000,90000,0,0
TIKI,giay-dep-nam,115768485,"Giày Da nam cực chất xả kho giá gốc mã L157",160000,160000,0,0
TIKI,giay-dep-nam,154852782,"Giày Lười, Giày Mọi Nam Da Bò SUNPOLO SU5052 (Đen, Nâu)",750000,750000,0,0
TIKI,giay-dep-nam,215730464,"Miếng lót gót giày chống rộng êm chân Sans929 cho giày sneaker thể thao giầy da tây công sở",19999,19999,0,0
TIKI,giay-dep-nam,161405062,"xăng đan nam nữ đế đen quai sọc ca rô vàng lót đen size từ 35 nữ đến 42 nam",82999,82999,0,0
TIKI,giay-dep-nam,55364136,"Dép Nam Quai Ngang Da Bò Thật HÀ NAM Cao Cấp DN266",368000,368000,0,0
TIKI,giay-dep-nam,71962033,"Giày mọi nam đế âm HÀ NAM da bò thật cao cấp GDA2021",692000,692000,0,0
TIKI,giay-dep-nam,107801661,"Mỡ chồn bảo dưỡng, chăm sóc và làm bóng cho đồ da, giày da, túi xách da, áo da Mink Oil Eidechse XDG67",60000,60000,0,0
TIKI,giay-dep-nam,110483322,"Giày Boots Nam Da Sáp Crary Horse",869000,869000,0,0
TIKI,giay-dep-nam,168587565,"Giày Thể Thao Nam, Giày Sneaker Nam New 2022.tăng ciều cao 4-5cm(2 mầu)k8",80000,80000,0,0
TIKI,giay-dep-nam,128812081,"Giày quai nang nam, dép quai hậu nam đẹp phong cách thời trang Hàn Quốc mã DEP10LE",169500,339000,169500,50
TIKI,giay-dep-nam,39131125,"Xi mút đánh giày, mút lau sạch bóng giày dép, túi xách đa năng, chuyên đánh bóng đồ da tiện lợi an toàn và dễ dàng sử dụng GD238-XiMutDG",15000,15000,0,0
TIKI,giay-dep-nam,94230311,"Giày Lười Nam Phối Khóa Kim Loại Đế Cao Lịch Lãm",149000,149000,0,0
TIKI,giay-dep-nam,10579539,"Bút Repaint Midsole Giày Crep Protect Mark On Pen (100g) - Trắng",450000,450000,0,0
TIKI,giay-dep-nam,98296288,"Giày Sneaker Thể Thao Nam HiNiTi T008 Dáng Đẹp- Năng Động Tặng Tất Khử Mùi",94050,99000,4950,5
TIKI,giay-dep-nam,19681749,"Dép sandal nam da bò cao cấp Trường Hải SD077",306000,349000,43000,12
TIKI,giay-dep-nam,106361646,"Dép Nam Quai Ngang HÀ NAM Da Bò Thật Cao Cấp DN2074",430000,430000,0,0
TIKI,giay-dep-nam,193629642,"Giày dép Sandals Vento ALPHA II Teen/Trẻ em màu Đen Ghi đi học/đi dã ngoại/đi chơi SD08002",365000,365000,0,0
TIKI,giay-dep-nam,2597759,"Dép Nam Quai Ngang Da Bò Cao Cấp SUNPOLO SUA5D - Đen (Size",550000,550000,0,0
TIKI,giay-dep-nam,155794833,"Giày lười nam Đông Hải da bò cao cấp  thiết kế tối giản với chỉ may nổi ấn tượng  đế cao su 3cm chắc chắn - G0343",1490000,1490000,0,0
TIKI,giay-dep-nam,160797806,"Giày da nam cao cấp, giày lười nam RJ-30022",247000,570000,323000,57
TIKI,giay-dep-nam,143638161,"Giày Lười Da Bò Nam Cao Cấp, Da Chuẩn, Kiểu Dáng Sang Trọng Quý Ông GD20",299000,299000,0,0
TIKI,giay-dep-nam,180590598,"Dép da nam quai ngang 2 dây Trường Hải màu nâu da bò mặt đúc chịu nước QN153",255000,339000,84000,25
TIKI,giay-dep-nam,169109284,"Dép Quai Hậu Nam Loại Bền Đẹp ( Mã DEP01)",300000,600000,300000,50
TIKI,giay-dep-nam,77926010,"Dép quai ngang chữ M hình nhân vật cho nam - Mã Dep03",159000,298000,139000,47
TIKI,giay-dep-nam,23021195,"Giày Mọi Nam BiGGBEN Da Bò Thật Cao Cấp GM176",649000,700000,51000,7
TIKI,giay-dep-nam,189136565,"Giày sneaker thể thao nam màu xanh ngọc",599000,599000,0,0
TIKI,giay-dep-nam,94583342,"Máy giặt giày cỡ lớn cho gia đình đảo chiều tự động công nghệ mới Dual Brush 260w",2925000,2925000,0,0
TIKI,giay-dep-nam,248884527,"Giày nam nhựa thời trang cao cấp hàng Việt Nam chất lượng cao, giày siêu nhẹ",60000,60000,0,0
TIKI,giay-dep-nam,168271050,"Lót giày da bò cao cấp êm chân khử mùi tốt sức khỏe- Tăng 1Size (LGD06)",145000,250000,105000,42
TIKI,giay-dep-nam,76163287,"HAVAIANAS - Dép unisex Brasil Logo 4110850",749000,749000,0,0
TIKI,giay-dep-nam,143786897,"Dép nam xỏ ngón màu nâu Trường Hải quai dép da bò thật đế cao 2.5cm  thời trang nam cao cấp D135N",212000,259000,47000,18
TIKI,giay-dep-nam,73406535,"Giày Lười Nam Da Mềm Phối Khóa Kim Loại",193500,193500,0,0
TIKI,giay-dep-nam,184617549,"Giày thể thao nam, giày nam Trắng pha xám G802",230000,230000,0,0
TIKI,giay-dep-nam,115011763,"Giày Đốc Da Bò Crazzy Horse",769000,769000,0,0
TIKI,giay-dep-nam,15769259,"Nước dưỡng da bóng Patent VERNIS RIFE LIQUIDE 100ml",360000,360000,0,0
TIKI,giay-dep-nam,42579011,"Dép quai ngang nam GIAVY - TL411",210000,210000,0,0
TIKI,giay-dep-nam,129010963,"Chai tẩy trắng giày hiệu quả và an toàn (có cọ chải)",13999,13999,0,0
TIKI,giay-dep-nam,188684626,"Lót Giày Nam Chất Liệu Cao Su Non Mềm Êm LGN2022a",38000,38000,0,0
TIKI,giay-dep-nam,178954514,"GIẦY TÂY GIÀY LƯỜI NAM HÀN QUỐC VÂN CÁ SẤU ĐAI ÉN LỊCH LÃM 2020",200000,200000,0,0
TIKI,giay-dep-nam,48357210,"GIày thể thao nam cao cấp có đệm khí trợ lực đế đi rất êm GN27",119691,125990,6299,5
TIKI,giay-dep-nam,101656110,"Giày big size nam Sans132 giầy tây công sở derby đen cỡ to bigsize lớn số 43 44 45 46 47 48 âu trơn đẹp cao cấp buộc dây",399000,399000,0,0
TIKI,giay-dep-nam,127380104,"Giày Sneaker Da Unisex DINCOX D20 Năng Động Cá Tính Black",550000,550000,0,0
TIKI,giay-dep-nam,114207259,"Giày lười vải nam thời trang - GV010",99000,99000,0,0
TIKI,giay-dep-nam,151952991,"Dép nam da quai ngang cao cấp. Dép được may chắc chắn, SẢN PHẨM được bảo hành. Sỉ giá tốt",239000,239000,0,0
TIKI,giay-dep-nam,72849628,"Giày cao cổ nam G255",595000,595000,0,0
TIKI,giay-dep-nam,87120615,"Giày Sneaker Nam Tomoyo TMN05401",630000,1400000,770000,55
TIKI,giay-dep-nam,122711981,"Giày Thể Thao Nam Sneaker, Hot Trend, Đế Đen, Đi Rất Bền Mẫu G186",49000,90000,41000,46
TIKI,giay-dep-nam,197617617,"Giày Sneaker Nam Vải Canvas DINCOX E06 Off White Đơn Giản Tinh Tế Sang Trọng",520000,520000,0,0
TIKI,giay-dep-nam,120827679," Xi mút đánh bóng giày dép da,túi xách,ví …Xi không màu dùng được cho tất cả các màu da, giúp da bóng đẹp nhanh chóng,dễ dàng sử dụng-XM09",40000,40000,0,0
TIKI,giay-dep-nam,125237126,"Giày lười nam Chất liệu da mềm 100%-đế cao su đúc_mãX091",210000,210000,0,0
TIKI,giay-dep-nam,169346119,"Giày Mọi Nam Màu Trắng Giày Lười  Nam Da Bò Cao Cấp Mềm Êm Chân -M03 Giày SAGO’S Bảo Hành 12 tháng (tặng vớ khử mùi)",650000,650000,0,0
TIKI,giay-dep-nam,171536007,"Dép bánh mì thời trang nam nữ Hy Lạp dép quai ngang M Masler MT bản chống trượt và khô thoáng thoải mái",378000,378000,0,0
TIKI,giay-dep-nam,98297497,"Giày Thể Thao Nam Mankablack SU894 Đen",165000,165000,0,0
TIKI,giay-dep-nam,207381123,"Giày Sục Nam da lì đơn giản Mã L205",160000,160000,0,0
TIKI,giay-dep-nam,41684771,"Đón gót giầy bằng gỗ muồng",149000,149000,0,0
TIKI,giay-dep-nam,35242845,"Giày Tây Nam Da Bò 100% Cao Cấp",1900000,1900000,0,0
TIKI,giay-dep-nam,100869774,"Giày Lười Nam Có Dây Buộc Da Bò Mã BH02",500000,1000000,500000,50
TIKI,giay-dep-nam,153260034,"(Có 2 Màu) Dép quai ngang nam nữ unisex inviti Fashion quai dán(t)",84000,84000,0,0
TIKI,giay-dep-nam,186741467,"Giày Mọi Nam Da Bò Thật BIGGBEN Cao Cấp GM274",649000,800000,151000,19
TIKI,giay-dep-nam,50741893,"Dép Lê bé trai 3D",85000,85000,0,0
TIKI,giay-dep-nam,14901629,"Dép xỏ ngón nam da bò cao cấp nâu bò  XN005",271000,309000,38000,12
TIKI,giay-dep-nam,112780972,"Giày Thể Thao Nam Spiso S901 Đen",105000,210000,105000,50
TIKI,giay-dep-nam,52718173,"Giày tây công sở happyshoes, giày lười da bò thật, giày mọi da, giày nam da bò, giày tây nam, giày da nam HSM53",648000,648000,0,0
TIKI,giay-dep-nam,87452189,"Giày Converse Chuck Taylor 1970s ​Archive Paint Splatter 170801C",2000000,2000000,0,0
TIKI,giay-dep-nam,196147384,"Giày Thể Thao Nam Sneaker Nam Vải Thoáng Khí Đế Cao Su Họa Tiết Nổi Bật G189",59000,100000,41000,41
TIKI,giay-dep-nam,48328634,"GIày Sandal Nam Da Bò BIGGBEN Cao Cấp SD99",289000,450000,161000,36
TIKI,giay-dep-nam,101291936,"Giày lười nam - Slip on nam vải - Mã A2122",350000,350000,0,0
TIKI,giay-dep-nam,57811840,"Giày tây nam Trường Hải da bò thật không bong tróc đế cao su không trơn màu",459000,529000,70000,13
TIKI,giay-dep-nam,83168986,"Dép 5 quai Giải Phóng máy bay vải mài thủ công",1430000,1430000,0,0
TIKI,giay-dep-nam,94485030,"Đông Hải - Giày Tây Nam G0135 màu đen",1350000,1350000,0,0
TIKI,giay-dep-nam,147801851,"Dép Nam quai ngang, kiểu dán Kito Thái Lan AH168 , siêu nhẹ, siêu bền",190000,190000,0,0
TIKI,giay-dep-nam,39288379,"Giày nam da thật ELLY HOMME – EGTM4",1679300,2399000,719700,30
TIKI,giay-dep-nam,188200353,"Giày boot nam martin boots Sans105 da bò thật big size 48 47 46 45 44 43 giầy cổ cao đen nâu đẹp bốt độn đế 6cm",549000,549000,0,0
TIKI,giay-dep-nam,13337710,"Dép nhựa nam 3 quai 3 khóa SM077",83000,92000,9000,10
TIKI,giay-dep-nam,132079831,"Giày Bốt Nam Cổ Cao Giả Da Lộn BCC001 Đen",258240,322800,64560,20
TIKI,giay-dep-nam,133864953,"Giày Sneakers Unisex Converse Chuck Taylor All Star Classic Low Top - 121176",1305000,1450000,145000,10
TIKI,giay-dep-nam,174378726,"Lót giày da bò cao cấp Tomshoes, cam kết da bò thật, khử mùi mồ hôi chân",30000,30000,0,0
TIKI,giay-dep-nam,161404719,"xăng đan nam và nữ ( đế đen quai đen phối dù ) size từ 34 nữ đến 43 nam",82999,82999,0,0
TIKI,giay-dep-nam,32753038,"Dép lỗ siêu nhẹ quai ngang thời trang LF9889",169000,169000,0,0
TIKI,giay-dep-nam,48274097,"Giày SaBo Nam Da Bò BIGGBEN SB80",459000,500000,41000,8
TIKI,giay-dep-nam,129943954,"Giày sneaker Vans Unisex phối caro cổ điển - Vans Classic Slip - On Checkerboard - VN000EYEBWW",1305000,1450000,145000,10
TIKI,giay-dep-nam,76230717,"Giày nam da bò",760000,760000,0,0
TIKI,giay-dep-nam,180326683,"Giày Sneaker Nam, Giày Nam Da Thật Hàng Cao Cấp Mới Nhất 2022",179000,179000,0,0
TIKI,giay-dep-nam,11726861,"Lót giày tăng chiều cao nửa bàn 2 lớp cao 5cm Nemo",44499,44499,0,0
TIKI,giay-dep-nam,37947523,"Giày Tây Đông Hải - Gkx0061",1190000,1190000,0,0
TIKI,giay-dep-nam,7412173,"Hộp Khăn Ướt Vệ Sinh Giày Crep Protect Wipes (12 miếng/190g)",320000,320000,0,0
TIKI,giay-dep-nam,115768030,"Giày Lười Nam Đơn Giản Da LÌ - Mã L192",199000,199000,0,0
TIKI,giay-dep-nam,78032197,"Bàn chải đánh bóng giày da ENITO Grand Brush",300000,300000,0,0
TIKI,giay-dep-nam,171124567,"Dép Tông Nam Xỏ Ngón EVABU siêu nhẹ, êm chân, có vân bám chống trơn trượt",90000,99000,9000,9
TIKI,giay-dep-nam,84936293,"Giày thể thao sneaker nam đế nhẹ vải sợi dệt cao cấp mạnh mẽ nam tính G181",129000,245000,116000,47
TIKI,giay-dep-nam,48319162,"Dép Nam Da Bò BIGGBEN Cao Cấp DN224",339000,400000,61000,15
TIKI,giay-dep-nam,108314683,"Dép cao su 4 quai khe sanh đế dày mài",1550000,1550000,0,0
TIKI,giay-dep-nam,179882264,"Giày Rọ Nam Da Bò Thời Trang HÀ NAM Cao Cấp GSB20107c",720000,720000,0,0
TIKI,giay-dep-nam,197030743,"Boot nam martin Sans104 giầy cao cổ boost vàng đen nâu bigsize to 43 44 45 46 độn đế 6cm big size đẹp hàn quốc cao cấp",349999,349999,0,0
TIKI,giay-dep-nam,214160075,"Giày thể thao nam Warrior, giày sneaker nam warrior. Mã W02",420000,420000,0,0
TIKI,giay-dep-nam,124915998,"Giày Da Nam - Giày Lười Nam Sinh Viên - Đế Cao Su - Đế Khâu - Mã G02 Màu Đen",199000,199000,0,0
TIKI,giay-dep-nam,23017650,"Giày Mọi Nam BiGGBEN Da Bò Thật Cao Cấp GM170",599000,700000,101000,14
TIKI,giay-dep-nam,157046419,"Dép khách sạn cao cấp Hương Quế có lớp chiếu mềm, tự nhiên tiếp xúc trực tiếp với da bàn chân",70000,70000,0,0
TIKI,giay-dep-nam,112641767,"Dép Nam Quai Ngang HÀ NAM Da Bò Thật Cao Cấp DNA2084",360000,360000,0,0
TIKI,giay-dep-nam,153520013,"Dép chiếu đi trong nhà Hương Quế DCQ-53 thích hợp mang trong nhà, trong văn phòng",68000,68000,0,0
TIKI,giay-dep-nam,177165722,"Giày Lười Trẻ Em NATIVE Miles Print Junior - Shell White/ Shell White/ Itty Bitty Blue Scribble - 32.5",1500000,1500000,0,0
TIKI,giay-dep-nam,107801680,"Lót Giày Massage Bàn Chân XIMO XLGEC02 Màu Đen Cao Cấp",120000,240000,120000,50
TIKI,giay-dep-nam,129734328,"HJ7103-08 - Giày tây nam Huy Hoàng cột dây màu đen, nâu",909000,909000,0,0
TIKI,giay-dep-nam,40364987,"Lót giày quế vải cotton CI-03 hút ẩm, khử mùi hôi chân, cải thiện sức khỏe",25000,25000,0,0
TIKI,giay-dep-nam,125271484,"Giày Da nam cực chất xả kho giá gốc- giày lười nam-mã l184",210000,210000,0,0
TIKI,giay-dep-nam,186909966,"giày da nam công sở không dây lịch lãm 2022",160000,160000,0,0
TIKI,giay-dep-nam,109787817,"Lót đế giày Silicone trong suốt dính chống trượt nửa trước giày 21646a",11000,24000,13000,54
TIKI,giay-dep-nam,115769150,"Giày Lười Nam Đang Được Yêu Thích Nhất - Dập Vân Cá Sấu kết hợp Chuông Vàng - Mã L184",199000,199000,0,0
TIKI,giay-dep-nam,17971673,"Hộp 6 đôi lót giày siêu mỏng Woly Pure Fresh - NK Đức",69000,69000,0,0
TIKI,giay-dep-nam,37111974," Dép da đế đúc cao su thời trang",99000,99000,0,0
TIKI,giay-dep-nam,153522071,"Dép chiếu văn phòng Hương Quế DCQ-55 bền và hợp thời trang",68000,68000,0,0
TIKI,giay-dep-nam,52104902,"Dép Nam BIGGBEN Da Bò Thật Cao Cấp DN228",339000,360000,21000,6
TIKI,giay-dep-nam,168069397,"Giày thể thao sneaker nam Sans202 đen sọc trắng",50000,50000,0,0
TIKI,giay-dep-nam,177918198,"Giày Lười Nam Da Bò Cao Cấp Mandoo Tăng Chiều Cao NB5",1150000,1150000,0,0
TIKI,giay-dep-nam,186907224,"Giày Lười Nam Dập Vân | SALE SIÊU RẺ | Giày được in vân nổi đính chuông kim loại",160000,160000,0,0
TIKI,giay-dep-nam,68082426,"Dép quai hậu nam da bò thật phong cách thời trang đế mềm kiểu dáng mới nhất phiên bản Hàn Quốc mã 692",359000,499000,140000,28
TIKI,giay-dep-nam,85380226,"Giày Mọi Nam Da Bò BIGGBEN Cao Cấp GM248",599000,700000,101000,14
TIKI,giay-dep-nam,6622437,"Dép SaBo Nam BIGGBEN Da Bò Thật SB31",379000,500000,121000,24
TIKI,giay-dep-nam,117219158,"Giấy Lau giày SNEAKER - Tẩy Trắng giày - Tẩy Mọi Vết Ố Bẩn Trên Giày Dép ( hộp 30 tờ )",34500,34500,0,0
TIKI,giay-dep-nam,115523861,"BẢO HÀNH 1 NĂM Máy Sấy Giày, Máy Làm Khô Giày, Khử Mùi Hôi, Diệt Vi Khuẩn Cho Dày Của Bạn, Siêu Nhanh Khô, Tiện Dụng",170990,170990,0,0
TIKI,giay-dep-nam,7976948,"Giày Mọi Nam Da Bò Sunpolo SU011N",990000,990000,0,0
TIKI,giay-dep-nam,78613917,"Dép xỏ ngón nam da bò thật tông nam da bò thật -TONG.167",189000,359000,170000,47
TIKI,giay-dep-nam,38149518,"Giày Thể Thao Nam Off  White Siêu Êm Phong Cách Hot Hit OF01",110600,110600,0,0
TIKI,giay-dep-nam,180978608,"Giày nam siêu hot tăng chiều cao",240000,240000,0,0
TIKI,giay-dep-nam,172995945,"Lót đế giày Silicone trong suốt dính chống trượt nửa trước giày 21646a",7000,7000,0,0
TIKI,giay-dep-nam,95213196,"GD380 Xịt khử mùi giầy dép , mũ bảo hiểm , xịt khử khuẩn giày",11000,18998,7998,42
TIKI,giay-dep-nam,81572518,"Giày nam cao cấp giày da bò giày nam da thật giày nam thời trang giày nam kiểu dáng hiện đại mã T36123 tặng một chiếc vòng đeo tay gỗ quý ngẫu nhiên",559000,899000,340000,38
TIKI,giay-dep-nam,3837347,"Combo miếng lót giầy da và dụng cụ đón gót giày inox nội địa Nhật Bản",79500,79500,0,0
TIKI,giay-dep-nam,129944449,"Giày Sneaker Unisex Vans Era Classic Black / White - VN000EWZBLK",1305000,1450000,145000,10
TIKI,giay-dep-nam,6137977,"Dép Da Nam BIGBEN May Đế Da Bò Thật DN39",339000,450000,111000,25
TIKI,giay-dep-nam,21477660,"Giày Sneaker Kid Converse Chuck Taylor All Star Classic Low - Red",800000,800000,0,0
TIKI,giay-dep-nam,59171675,"Dép Nam Bít Đầu Da Bò BIGGBEN Cao Cấp DN255",429000,550000,121000,22
TIKI,giay-dep-nam,98039734,"Giày Thể Thao Nam Cao Cấp  màu đen G951",89000,169990,80990,48
TIKI,giay-dep-nam,111152032,"Giày thể thao nam SSN8 giày cao 4cm đi lại nhẹ nhàng-chất liệu vải thoáng khí-thấm hút tốt( 2 mầu)",94050,99000,4950,5
TIKI,giay-dep-nam,50242250,"Giày Tây Nam  - Giày Tây Nam Da Bò Thật 100% - Mã BH0222",450000,900000,450000,50
TIKI,giay-dep-nam,176896301,"Giày tây nam da bò dành cho dân công sở, bảo hành 18 tháng - Manzo GT 110",180000,180000,0,0
TIKI,giay-dep-nam,193629700,"Giày dép Sandals Vento ALPHA II Teen/Trẻ em màu Xanh da trời đi học/đi dã ngoại/đi chơi SD08002",365000,365000,0,0
TIKI,giay-dep-nam,183081577,"Dép xỏ ngón nam da bò thật KEEDO KD2202",280000,280000,0,0
TIKI,giay-dep-nam,21979444,"Giày nam Huy Hoàng da bò màu nâu đỏ-HP7112",909000,909000,0,0
TIKI,giay-dep-nam,167657317,"Lót giày tăng chiều cao TPE cao cấp êm chân L17 XIMO",170000,170000,0,0
TIKI,giay-dep-nam,101291609,"Giày lười nam - Slip on nam vải - Mã A2270X",350000,350000,0,0
TIKI,giay-dep-nam,113639741,"Dép Bít Mũi Nam HÀ NAM Da Bò Thật Cao Cấp GSB2086",390000,390000,0,0
TIKI,giay-dep-nam,48565043,"Dép Sục Nam Đen Phối Đỏ Kèm 6Jibbitz/Sticker",78000,78000,0,0
TIKI,giay-dep-nam,169281460,"Dép sục cross nam yukon sport  màu kaki hàng xịn, full box",380000,380000,0,0
TIKI,giay-dep-nam,2597807,"Dép Nam Quai Ngang Da Bò Cao Cấp SUNPOLO SUA15D - Đen (Size",550000,550000,0,0
TIKI,giay-dep-nam,103463862,"Giày Tây Nam Không Dây Chính Hãng Trường Hải Da Bò Thật Cao Cấp  Màu Đen",505000,539000,34000,6
TIKI,giay-dep-nam,181786281,"Giày vải bảo hộ lao động thấp cổ đế cao su",100000,100000,0,0
TIKI,giay-dep-nam,101656265,"Giày Da Nam Giày Tây Nam Công Sở Sans Shop Sans140",199000,199000,0,0
TIKI,giay-dep-nam,167549377,"Dung dịch làm sạch giày da Renomat Saphir 100ml (XDG05)",365000,550000,185000,34
TIKI,giay-dep-nam,173443157,"iày Mọi Nam Da Bò Thật-Giày Lười Da Cao Cấp Màu Trắng Kem-M08 Giày SAGO’S Bảo Hành 12 tháng",695000,695000,0,0
TIKI,giay-dep-nam,160748263,"Giày tăng chiều cao nam da bò Sans119 độn đế 8cm công sở cao cấp buộc dây tây đen chú rể mặc vest size nhỏ 37 38 mũi tròn",849000,849000,0,0
TIKI,giay-dep-nam,194464712,"Giày sneaker nam trắng Sans200 giầy thể thao sneakers fullbox sport fashion basic đẹp năng động trẻ trung hàn quốc",99999,99999,0,0
TIKI,giay-dep-nam,189172626,"Giày Lười Nam GEOX U Ascanio A",4400000,4400000,0,0
TIKI,giay-dep-nam,100466271,"Giày lười sục nam da bò mùa hè mềm mại ôm chân chỉ khâu mạnh mẽ nam tính GD16",249000,350000,101000,29
TIKI,giay-dep-nam,19414099,"Dép Nam BIGGBEN Da Bò Thật Cao Cấp DN164",349000,400000,51000,13
TIKI,giay-dep-nam,71973540,"Giày cao cổ nam G3a",199000,199000,0,0
TIKI,giay-dep-nam,48319992,"Dép Nam Da Bò BIGGBEN Cao Cấp DN226",299000,400000,101000,25
TIKI,giay-dep-nam,165989862,"Giày sandal nam da bò thật BIGGBEN cao cấp SD122",359000,500000,141000,28
TIKI,giay-dep-nam,156214551,"DÉP QUAI NGANG NAM DA BÒ KHÂU VIỀN BAO CHẮC CHẮN ÊM CHÂN BAO ĐI MƯA",323530,323530,0,0
TIKI,giay-dep-nam,51095942,"Keo Dán Giày Dép Túi Xách Ví Da NIANBA Nhập Khẩu Dính Siêu Chắc Chắn Bền Bỉ Hàng Loại Tốt GD013",18000,18000,0,0
TIKI,giay-dep-nam,66620504,"Giày tây da bò thật nam phong cách quý ông mã 8865 - Đen - 40",299000,499000,200000,40
TIKI,giay-dep-nam,131417359,"Giày tây nam da thật, tăng chiều cao bí mật 7cm, đế cao su đã khâu chắc chắn, size từ 39 đến 43",298500,298500,0,0
TIKI,giay-dep-nam,171535218,"Dép quai ngang nam nữ M Masler-MT đan mạch xanh lá với lớp đế chống nước và êm chân, quai bền bỉ DML",458000,458000,0,0
TIKI,giay-dep-nam,110859727,"Giày lười vải nam thời trang - GN08",105000,105000,0,0
TIKI,giay-dep-nam,31135723,"Dép massage chân khảm đá cho nam",125000,125000,0,0
TIKI,giay-dep-nam,68026620,"Giày thể thao nam, giày nam da siêu mềm K05",159000,159000,0,0
TIKI,giay-dep-nam,91210262,"Giày tây nam công sở da bò BIGGBEN cao cấp GT207",599000,800000,201000,25
TIKI,giay-dep-nam,129942237,"Giày Sneaker Converse Classic Đỏ thấp cổ hàng chính hãng - 127442",725000,1450000,725000,50
TIKI,giay-dep-nam,48720087,"Giày da-Valentino Creations-VAB-284-DBN",5590000,5590000,0,0
TIKI,giay-dep-nam,48661332,"Giày Sneaker Unisex Converse Chuck Taylor All Star Love Fearlessly Platform - 567312C",1600000,1600000,0,0
TIKI,giay-dep-nam,196856729,"Giày tây nam Pierre Cardin - PCMFWLG 761",1190000,2990000,1800000,60
TIKI,giay-dep-nam,126711692,"Giày Tây Nam Da Bò Thủ Công Cao Cấp SUNPOLO MU0038 (Đen, Nâu, Đỏ)",1250000,1250000,0,0
TIKI,giay-dep-nam,176472579,"Dung môi tạo độ bóng và cung cấp độ ẩm cho đồ da Ximo Bright Smooth Leather Surface Premium XI20",150000,260000,110000,42
TIKI,giay-dep-nam,45287355,"Giầy boot nam da thật cao cổ, kéo khóa viền mũi",595000,595000,0,0
TIKI,giay-dep-nam,94485564,"Đông Hải - Giày Tây Nam G0139",1350000,1350000,0,0
TIKI,giay-dep-nam,22426702,"Dép Nam BIGGBEN Da Bò Thật Cao Cấp DN165",399000,550000,151000,27
TIKI,giay-dep-nam,101292226,"Giày lười nam - Slip on nam vải - Mã A7513",350000,350000,0,0
TIKI,giay-dep-nam,192896478,"Giày Tây Da Cao Cấp ChristinA-Q GNA413",919200,1149000,229800,20
TIKI,giay-dep-nam,179060513,"Sục nhựa cross yukon sport màu đen dành cho nam",380000,380000,0,0
TIKI,giay-dep-nam,9809783,"Giày Sneaker Unisex Old Skool Vans - VN000D3HNVY",1750000,1750000,0,0
TIKI,giay-dep-nam,174121388,"Dây Giày Tây EXTRIM Dây Sáp Tròn Không Thấm Nước",60000,60000,0,0
TIKI,giay-dep-nam,94485373,"Đông Hải - Giày Tây Nam G2271 màu đen",1190000,1190000,0,0
TIKI,giay-dep-nam,96301779,"Dép Bít Mũi Nam HÀ NAM Da Bò Thật Cao Cấp GSB2068",468000,468000,0,0
TIKI,giay-dep-nam,101656491,"Giày Lười Da Bò Giày Tăng Chiều Cao 6cm Giầy Da Dập Vân Cá Sấu Sans181",199000,199000,0,0
TIKI,giay-dep-nam,161894582,"Sandal đế bằng nam - SPS.133",290000,592000,302000,51
TIKI,giay-dep-nam,84198459,"Giày Sandals Vento Nam Nữ Quai Ngang dạo phố/đi chơi/đi học NB03",385000,385000,0,0
TIKI,giay-dep-nam,190790874,"Giày Mọi Rọ Nam Da Bò Thật BIGGBEN Cao Cấp GM278",659000,800000,141000,18
TIKI,giay-dep-nam,178779577,"Giày thể thao trẻ trung phong cách PH5485",370000,480000,110000,23
TIKI,giay-dep-nam,84936275,"Giày thể thao nam sneaker nam đi chơi đi học bao ngầu G180",119000,220000,101000,46
TIKI,giay-dep-nam,91036409,"Giày Boots Nam Cổ Cao CC678",680000,680000,0,0
TIKI,giay-dep-nam,162058079,"Dép quai ngang nam KEEDO-A7621 mẫu mới cao cấp",480000,480000,0,0
TIKI,giay-dep-nam,195715501,"Dép Eva Phun Nam Biti's",195000,195000,0,0
TIKI,giay-dep-nam,161393292,"Lót giày tăng chiều cao có đệm khí cả bàn cao cấp",60000,60000,0,0
TIKI,giay-dep-nam,192137737,"Dép Nam Da Bò Thật BIGGBEN Cao Cấp DN316",339000,400000,61000,15
TIKI,giay-dep-nam,168271747,"Lót giày y khoa silicon thể thao cao cấp hỗ trợ đệm vòm chân chống bàn chân bẹt (LGYK06)",156000,250000,94000,38
TIKI,giay-dep-nam,162053191,"Dép nam hai quai ngang KEEDO-KD7722 mẫu mới cao cấp full hộp",480000,480000,0,0
TIKI,giay-dep-nam,177643036,"Dép Xỏ Ngón Nam Da Bò Thật BIGGBEN DK91",289000,380000,91000,24
TIKI,giay-dep-nam,157078827,"Giày lười nỉ nam chất liệu đế kết đi ôm chân vải mềm phù hợp mọi tuổi k206",74100,78000,3900,5
TIKI,giay-dep-nam,198121909,"Giày Boot Nam Timberland 6 inch Basic Alburn Boot WP Wheat Nubuck TB03757824",6090000,6090000,0,0
TIKI,giay-dep-nam,70671464,"Giày Sandal Si PU Nam Biti's DPM029100REU",294800,335000,40200,12
TIKI,giay-dep-nam,71974000,"DÉP QUAI NGANG NAM DA BÒ THẬT 100%, HÀNG CAO CẤP, DA BÒ NAPPA RẤT MỀM MẠI",229000,390000,161000,41
TIKI,giay-dep-nam,156216152,"DÉP NAM QUAI NGANG DA BÒ THẬT 100% QUAI KHÂU ĐẾ BAO CHẮC CHẮN",350000,350000,0,0
TIKI,giay-dep-nam,100184282,"Giày Tây nam màu trắng giày công sở nam da bò cao cấp-TT05 Bảo hành 12 tháng",650000,650000,0,0
TIKI,giay-dep-nam,101655997,"Giày tây nam công sở derby Sans115 giầy da bò thật cao cấp đen nâu da bóng buộc dây bigsize cỡ to lớn 43 44 45 46 47 48",590000,590000,0,0
TIKI,giay-dep-nam,112019828,"Lót giày 4D đệm êm vòm ngang lòng bàn chân và các ngón chân, chống trượt bàn chân về phía trước - buybox - BBPK181",22000,35000,13000,37
TIKI,giay-dep-nam,96777829,"Dép quai ngang nam Đông Hải - D1810",650000,650000,0,0
TIKI,giay-dep-nam,127379613,"Giày Sneaker Da Unisex DINCOX D20 Năng Động Cá Tính White",550000,550000,0,0
TIKI,giay-dep-nam,189634324,"Giày Lười Da Bò Nam Cao Cấp, Chất Da Ý Mềm,Chất Lượng Hàng Việt, Đế Cao Su, Thiết Kế Giữ Dáng GD21",299000,450000,151000,34
TIKI,giay-dep-nam,125270133,"Giầy rọ nam, giầy hè nam đục lỗ Tomshoes da bò thật 100",339000,339000,0,0
TIKI,giay-dep-nam,183070424,"Dép xỏ ngón nam hàng hiệu KEEDO TN6121",480000,480000,0,0
TIKI,giay-dep-nam,197618446,"Giày Sneaker Nam Vải Canvas DINCOX E06 Yellow Sand Đơn Giản Tinh Tế Sang Trọng",520000,520000,0,0
TIKI,giay-dep-nam,56100050,"Dép Nam Da Bò Thật Tomoyo TMD10101",540000,1200000,660000,55
TIKI,giay-dep-nam,174423363,"Sandal Biti's nam",445000,445000,0,0
TIKI,giay-dep-nam,145236180,"Giày Nhựa Đi Mưa, Đi Biển, Du Lịch Thời Trang GIAY-030A",339000,339000,0,0
TIKI,giay-dep-nam,98675507,"Giày Sneaker Nam "Siêu Êm" Tomoyo TMN21001",1290000,2890000,1600000,55
TIKI,giay-dep-nam,88818319,"Giày lười nam da dập vân sang trọng và lịch lãm kết hợp chuông",210000,210000,0,0
TIKI,giay-dep-nam,129353287,"Sandals Vento Nam Quai Chéo Xuất Khẩu dạo phố/đi chơi/đi làm NV25",260000,260000,0,0
TIKI,giay-dep-nam,11502031,"Giày Lười Vải Nam CV007",89000,89000,0,0
TIKI,giay-dep-nam,146399286,"Dép da nam dép lê quai ngang, quai chéo phiên bản Hàn Quốc mã DEP10LE",199200,269000,69800,26
TIKI,giay-dep-nam,140643435,"Dép Quai Ngang Da Bò SUNPOLO SQND31 (Đen, Nâu)",490000,490000,0,0
TIKI,giay-dep-nam,75355184,"Giày Thể Thao Nam Sneaker Da Cao Cấp Phong Cách Hàn Quốc Kiểu Dáng Thời Trang G171",125000,195000,70000,36
TIKI,giay-dep-nam,168789115,"{SIÊU BỀN} Giày Bảo Hộ Da Bò AQX- BD_0088 Chống Nước, Chống Đinh, Chống Trơn- Giày Công Trình",329000,490000,161000,33
TIKI,giay-dep-nam,153580992,"Giày Sneaker Vải Canvas Unisex Chính Hãng DINCOX C20 Snow White Sang Trọng Tinh Tế Đơn Giản",470000,470000,0,0
TIKI,giay-dep-nam,130784814,"Giày Mọi Nam Đế Âm HÀ NAM Da Bò Thật Cao Cấp GM2070",692000,692000,0,0
TIKI,giay-dep-nam,35304312,"Lót giày thể thao nam phòng tránh chấn thương Spenco Gel Comfort",495000,495000,0,0
TIKI,giay-dep-nam,25954534,"Dép nam đen đế trắng",310000,310000,0,0
TIKI,giay-dep-nam,94486117,"Đông Hải - Giày Tây Nam G0609",1350000,1350000,0,0
TIKI,giay-dep-nam,15932753,"Cây giữ form giày gỗ tuyết tùng - Saphir Cedar Shoetree",1480000,1480000,0,0
TIKI,giay-dep-nam,76367313,"Dép nam da bò BIGGBEN cao cấp DN271",349000,450000,101000,22
TIKI,giay-dep-nam,164041595,"GIÀY... TÂY CÔNG SỞ NAM BUỘC DÂY PHONG CÁCH CÔNG SỞ LỊCH LÃM SANG TRỌNG BẢO HÀNH 12 THÁNG",420000,420000,0,0
TIKI,giay-dep-nam,144353469,"Giày tây nam BIGSIZE Trường Hải mũi nhọn da bò thật Màu đen đế cao su không trơn may chắc chắn GT146",504000,550000,46000,8
TIKI,giay-dep-nam,207866396,"Giày Tây Nam Oxford Công Sở Da Lộn Đế Mỏng Thanh Lịch Cao Cấp DUCA DI MORRONE Nhập Khẩu Từ Ý - Made In Italy",2530000,2530000,0,0
TIKI,giay-dep-nam,94485868,"Đông Hải - Giày Tây Nam G0122 3cm",850000,850000,0,0
TIKI,giay-dep-nam,105522370,"Giày thể thao nam da chống thấm nước G147-02",149000,149000,0,0
TIKI,giay-dep-nam,6588299,"Giày nam vân cá sấu - Da bò thật HS09",450000,450000,0,0
TIKI,giay-dep-nam,35880895,"Giày tây công sở nam PU4",150000,150000,0,0
TIKI,giay-dep-nam,75049792,"Giày mùa đông ấm áp giày lông cừu thật giày đi tuyết nam giới - mã 87810",999000,1599000,600000,38
TIKI,giay-dep-nam,127567927,"Giày Boots Moctoe da bò nâu sáp mộc",1150000,1150000,0,0
TIKI,giay-dep-nam,94486819,"Đông Hải - Giày Lười Nam G0310",1190000,1190000,0,0
TIKI,giay-dep-nam,172001981," Giày tăng chiều cao nam Giày Công Sở Nam tăng cao 6,5cm Da Bò Cao Cấp màu đen-TC08 Giày Đánh Patina Thủ Công Sang Trọng Lịch Lãm ,Giày SAGO’S",950000,950000,0,0
TIKI,giay-dep-nam,141217638,"Giày mọi rọ nam da bò thật BIGGBEN cao cấp GM262",649000,760000,111000,15
TIKI,giay-dep-nam,186272709,"Giày Tây Nam Công Sở Oxford Tomoyo Da Bò Nhập Khẩu Cao Cấp TMN22501",1290000,2890000,1600000,55
TIKI,giay-dep-nam,151953091,"Dép nam mẫu mới nhất 2022. Chất liệu đã bò cao cấp",239000,239000,0,0
TIKI,giay-dep-nam,91281207,"Huy hiệu (Jibbitz) Crocs  Scooter 1 cái",145000,145000,0,0
TIKI,giay-dep-nam,101656509,"Đón Gót Hỗ Trợ Đi Giày Sans975 Sans Shop",49000,49000,0,0
TIKI,giay-dep-nam,37910782,"Dép Sapo Nam Đông Hải G1019",980000,980000,0,0
TIKI,giay-dep-nam,40818399,"Dép Xăng Đan Nam Nữ Quai Hậu Cao Cấp TRM03 Đen 2Q",119000,119000,0,0
TIKI,giay-dep-nam,190510429,"Dép nam đế may sẵn quai ngang cao cấp KEEDO TN-NB54",920000,920000,0,0
TIKI,giay-dep-nam,43388701,"Dép quai ngang nam GIAVY - TL336",195000,195000,0,0
TIKI,giay-dep-nam,115831139,"Giày lười nam cao cấp giá rẻ chất liệu da bò đế cao su",160000,160000,0,0
TIKI,giay-dep-nam,132230478,"Giày Lười Nam Da Bò SUNPOLO CS5054 Trẻ trung, thanh lịch (Đen, Nâu)",750000,750000,0,0
TIKI,giay-dep-nam,73821401,"Giày Thể Thao Nam Sợi Dệt Cao Cấp Vải Thoáng Khí G158",129000,240000,111000,46
TIKI,giay-dep-nam,173237471,"️ Giầy nam công sở da bóng đen 20393",375000,573200,198200,35
TIKI,giay-dep-nam,127380362,"Giày Lười Sneaker Da Nam DINCOX C38 Đơn Giản, Lịch Lãm Black",520000,520000,0,0
TIKI,giay-dep-nam,187558308,"Giày Sneakers Thời Trang T52 Tăng Chiều Cao",169000,169000,0,0
TIKI,giay-dep-nam,16422668,"Máy Đánh Giày , Máy Đánh Giày Cầm Tay",427500,450000,22500,5
TIKI,giay-dep-nam,204413847," Giày NB 330 chữ N , Giày thể thao nam nữ Full Box",669000,669000,0,0
TIKI,giay-dep-nam,40073181,"Dép bít mũi nam da bò cao cấp Trường Hải BM214",350000,399000,49000,12
TIKI,giay-dep-nam,2001361,"Giày Nam Thời Trang Huy Hoàng HT7160 - Đen (Size",909000,909000,0,0
TIKI,giay-dep-nam,144180724,"Dép tổ ong xịn màu xám siêu bền dép nhựa nam chống trơn trượt dép nam quai nganh dép nhựa mang lao động dép đi biển",57500,57500,0,0
TIKI,giay-dep-nam,153259212,"Giày lười vải nam lỗ thoáng khí màu đen",99000,99000,0,0
TIKI,giay-dep-nam,58028021,"Giày mọi nam Trường Hải màu vàng bò da bò thật cao cấp không bong tróc đế cao su chống mòn không trơn GMTH095",520000,599000,79000,13
TIKI,giay-dep-nam,119288386,"Giày Sandal Nam TiTi ĐÔ Da Bò Thật Cao Cấp DNA2136a",380000,380000,0,0
TIKI,giay-dep-nam,143363216,"Dép quai ngang nam nữ Duwa siêu nhẹ/dép thời trang nam nữ",60000,60000,0,0
TIKI,giay-dep-nam,170132288,"Giày thể thao nam, giày sneakers nam 4 sọc - G2208",200000,200000,0,0
TIKI,giay-dep-nam,107491717,"Dép Nam Quai Ngang Da Bò BIGGBEN Cao Cấp DN282",319000,400000,81000,20
TIKI,giay-dep-nam,91866367,"HAVAIANAS - Dép nam thời trang Tradi Zori 4145718",2119000,2119000,0,0
TIKI,giay-dep-nam,192451071,"GIÀY BOOTS COLE HAAN NAM ZERØGRAND OMNI CITY BOOT WP C34239",2745000,5490000,2745000,50
TIKI,giay-dep-nam,167489253,"Dép tổ ong xịn màu xanh rêu siêu bền dép nhựa nam chống trơn trượt dép nam quai nganh dép nhựa mang lao động dép đi biển",59500,59500,0,0
TIKI,giay-dep-nam,82384405,"Dép da nam DUWA TNT011S - Hàng chính hãng - Đế đúc xỏ ngón",145000,289000,144000,50
TIKI,giay-dep-nam,100465451,"Giày lười sục nam da bò mềm mại mùa hè ôm chân phong cách hiện đại GD17",205000,400000,195000,49
TIKI,giay-dep-nam,172318714,"Giày Sandal Nam TiTi ĐÔ Da Bò Thật Cao Cấp DNA2137a",414000,414000,0,0
TIKI,giay-dep-nam,101657325,"Giày oxford nam da bò thật cao cấp Sans113 giầy tây công sở đen mũi tròn âu buộc dây chú rể cưới brogue derby wingtip",299999,299999,0,0
TIKI,giay-dep-nam,109862337,"Giày sandal, dép sandal nam Teramo đế cao su nguyên chất, siêu nhẹ, quai dù chắc chắn, đế có rãnh chống trượt an toàn, TRM HỌA TIẾT",230000,230000,0,0
TIKI,giay-dep-nam,153038813,"Giày thể thao nam dệt kim nhẹ nhàng trẻ trung kiểu dáng Châu Âu - 68911",999000,1299900,300900,23
TIKI,giay-dep-nam,7977025,"Giày Mọi Nam Da Bò Sunpolo SU015D",990000,990000,0,0
TIKI,giay-dep-nam,177165326,"Giày Lười Unisex NATIVE Jefferson Print - Shell White/ Shell White/ Multi Doodle - 42.5",1650000,1650000,0,0
TIKI,giay-dep-nam,248399980,"Giày sĩ quan công ty 32 cấp tướng, giày da nam Aseco 32 mã 714 đế vàng",740000,740000,0,0
TIKI,giay-dep-nam,164041835,"giày boot nam cổ cao da bò nguyên tấm đế cao su cao cấp, bốt nam cổ cao Da Bò",610000,610000,0,0
TIKI,giay-dep-nam,68136020," Dép quai ngang đúc chống trơn trượt",60000,60000,0,0
TIKI,giay-dep-nam,43205268,"Giày Sabo Nam Da Bò VO ShoesVO Luxury Fashion _ VO202",350000,580000,230000,40
TIKI,giay-dep-nam,51440069,"Giày sneakers nam thêu cúc họa mi, thời trang trẻ, phong cách Hàn Quốc",99000,99000,0,0
TIKI,giay-dep-nam,58614590,"Giày Converse Chuck Taylor All Star 1970S Signature Hi Top 167696C",2000000,2000000,0,0
TIKI,giay-dep-nam,102797868," Giày Nam, Giày Sneaker Nam Đế Khí A.I.R New 2021 - Fullbo",129000,129000,0,0
TIKI,giay-dep-nam,6526453,"Dép Quai Hậu - Giày Sandal Nam Cao Cấp TRM29",199000,199000,0,0
TIKI,giay-dep-nam,125781626,"Giày bít nam nữ",59000,59000,0,0
TIKI,giay-dep-nam,242711541,"Giày thể thao nam thoáng khí đế cao su êm chân giày chạy bộ",169000,210000,41000,20
TIKI,giay-dep-nam,89947772,"Giầy da cao cấp nam 20395",660000,760900,100900,13
TIKI,giay-dep-nam,55484461,"GIÀY TĂNG CHIỀU CAO - GIÀY CAO DÀNH CHO NAM GIỚI T&TRA T08 DÂY CỘT - CAO 6CM GIÀY ĐỘN NAM CAO VƯỢT TRỘI",750000,750000,0,0
TIKI,giay-dep-nam,183315273,"Dép nam Đông Hải da bò cao cấp thiết kế quai ngang khóa điều chỉnh tiện lợi  đế cao su chắc chắn - D3219",750000,750000,0,0
TIKI,giay-dep-nam,2793429,"Giày Mọi Nam Da Bò SUNPOLO SU3028D",699000,699000,0,0
TIKI,giay-dep-nam,193736041,"Giày Lười Vải Nam Đế Cao su non A60 Lỗ Thoáng Khí Màu Đen",111300,159000,47700,30
TIKI,giay-dep-nam,34340306,"Dép bít mũi nam da bò cao cấp Trường Hải BM057",324000,369000,45000,12
TIKI,giay-dep-nam,46621924,"Giày Sneakers Nam PPA Phong Cách Thể Thao Hàn Quốc Siêu Được Bạn Trẻ Ưa Chuộng",79000,79000,0,0
TIKI,giay-dep-nam,129812768,"HJ7130-59 - Giày nam vân cá sấu Huy Hoàng màu vàng, đen",1119000,1119000,0,0
TIKI,giay-dep-nam,177165683,"Giày Lười Unisex NATIVE Jefferson Bling",1650000,1650000,0,0
TIKI,giay-dep-nam,172318066,"Giày Sandal Nam TiTi ĐÔ Da Bò Thật Cao Cấp DNA2136c",365000,365000,0,0
TIKI,giay-dep-nam,51504705,"Lót giày tăng chiều cao nửa bàn silicon 2cm, phụ kiện tăng chiều cao dành cho cả nam và nữ",88000,88000,0,0
TIKI,giay-dep-nam,194462767,"Giày thể thao nam sneaker Sans209 giầy sport trắng cổ thấp đế bệt sọc đen đỏ vàng bền đẹp thời trang hàn quốc trẻ trung",99999,99999,0,0
TIKI,giay-dep-nam,179547506,"GIÀY LƯỜI NAM DA BÒ THẬT TỰ NHIÊN 100% DONAVY, ĐẾ CAO SU CAO CẤP THIẾT KẾ KHÂU VIỀN THỜI TRANG DGLK",449000,850000,401000,47
TIKI,giay-dep-nam,29375320,"Giầy tây nam da bò cao cấp",1999000,1999000,0,0
TIKI,giay-dep-nam,83169656,"Dép cao su kiểu tông quai núm",300000,300000,0,0
TIKI,giay-dep-nam,14990190,"Dép nam xỏ ngón - Dép kẹp nam da bò cao cấp Trường Hải XN0012",201000,229000,28000,12
TIKI,giay-dep-nam,151953097,"Si đánh giày KiWi",39000,39000,0,0
TIKI,giay-dep-nam,128514324,"Giày Mọi Nam Giày Lười Da Bò Thật Nguyên Tấm Mềm Êm Chân Màu Nâu -M10",690000,690000,0,0
TIKI,giay-dep-nam,177777856,"Dép Quai Ngang Nam SLEDGERS Rohan",2100000,2100000,0,0
TIKI,giay-dep-nam,42157769,"Giày Da Nam Cao Cấp Italia Germano Bellesi GB 218",10850000,10850000,0,0
TIKI,giay-dep-nam,43097237,"Giày Tây Nam Da Bò Thật Vo Luxury Fashion Shoes-9931",430000,600000,170000,28
TIKI,giay-dep-nam,186874706,"Giày sục nam, sục nam Da bóng Moca - Da Pu Bảo hành 12 tháng ( Mã SN010 - Có hộp )",160000,160000,0,0
TIKI,giay-dep-nam,93218965,"Dép nam quai ngang da bò cao cấp HKT94",400000,400000,0,0
TIKI,giay-dep-nam,187558881,"Giày nam GIÀY LEO NÚI ,GIÀY LAO ĐỘNG S031, ,tăng cường ma sát, bền đẹp có 2 màu",179000,179000,0,0
TIKI,giay-dep-nam,71520440,"DÉP QUAI NGANG NAM DA BÒ 100%, QUAI CÁ SẤU SẮC NÉT",229000,390000,161000,41
TIKI,giay-dep-nam,126091279,"Giày Mọi, Giày Lười Nam Da Bò SUNPOLO SU5059 Hiện đại (Đen)",750000,750000,0,0
TIKI,giay-dep-nam,129351658,"Dép VENTO Nam Nữ Quai Ngang AD19",215000,215000,0,0
TIKI,giay-dep-nam,202708853,"Giày thể thao nam cổ cao GNC-T22-W, giày thể thao thoáng khí phong cách hàn quốc",299000,299000,0,0
TIKI,giay-dep-nam,153469262,"Giày Tây Nam Giày Công Sở Nam Da Bò Cao Cấp -P30 Giày Đánh Patina Thủ Công Sang Trọng Lịch Lãm ,Giày SAGO’S",890000,890000,0,0
TIKI,giay-dep-nam,40930342,"Giày Lười Nam Công Sở Happyshoes Da Bò Thật  - HS300",799000,799000,0,0
TIKI,giay-dep-nam,98712452,"Giày Lười Driving Shoe Nam Đông Hải - G2282",1390000,1390000,0,0
TIKI,giay-dep-nam,217494666,"Combo lót giày nam giảm size 2 chi tiết hiệu quả chống rộng chống đau chân phù hợp nhiều kiểu giày",34500,69000,34500,50
TIKI,giay-dep-nam,66507793,"Dép Nam Da Bò BIGGBEN Cao Cấp DN260",339000,400000,61000,15
TIKI,giay-dep-nam,95856838,"Giày da quý ông phog cách sang trọng - 4001.DA",299000,499000,200000,40
TIKI,giay-dep-nam,120049622,"HP7128-29-59-95 - Giày nam vân cá sấu Huy Hoàng màu đen, nâu",799000,799000,0,0
TIKI,giay-dep-nam,144537256,"GIÀY DA CAO CẤP NHẤT 2021 - GIÀY DA BẢO HÀNH 12 THÁNG VIP005",329000,329000,0,0
TIKI,giay-dep-nam,20331179,"Tông kẹp cao su",300000,300000,0,0
TIKI,giay-dep-nam,242491508,"Giày Tây Nam Hiện Đại - Derby Modern Man 02 Black - Thời Trang, Lịch Lãm, Phong Cách - BRC092202",1200000,1200000,0,0
TIKI,giay-dep-nam,20007807,"Giày Sneaker Unisex Converse Chuck Taylor All Star 1970s Sunflower Low Top 162063C",1900000,1900000,0,0
TIKI,giay-dep-nam,125147556,"Giày da nam trơn bóng mặt vàng trẻ trung ️ Dày nam công sở chất cực thích, ĐẾ CAO SU",198000,198000,0,0
TIKI,giay-dep-nam,84132153,"Combo 5 chai xịt tẩy trắng giày dép PLAC có đầu bàn chải",99999,99999,0,0
TIKI,giay-dep-nam,115958681,"Giày Sandal Nam HÀ NAM Da Bò Thật Cao Cấp DNA2137",496000,496000,0,0
TIKI,giay-dep-nam,94485837,"Đông Hải - Giày Tây Nam G0133",1350000,1350000,0,0
TIKI,giay-dep-nam,142444095,"Dép Vento Hybrid Nam Nữ Quai Ngang AD33",215000,215000,0,0
TIKI,giay-dep-nam,55516215,"GIÀY TĂNG CHIỀU CAO  GIÀY CAO DÀNH CHO NAM GIỚI T&TRA T20 ĐEN TRƠN  -  CAO 8CM GIÀY ĐỘN NAM CAO VƯỢT TRỘI",950000,950000,0,0
TIKI,giay-dep-nam,45405131,"Giày thể thao VNXK da lộn màu đen - L31",498000,498000,0,0
TIKI,giay-dep-nam,101291818," Giày lười nam - Slip on nam da - Mã S233",350000,350000,0,0
TIKI,giay-dep-nam,71969152,"Giày sneaker vải nam cơ bản, thời trang trẻ, phong cách Hàn",120000,120000,0,0
TIKI,giay-dep-nam,14113358,"Giày sneaker Tomoyo TMN05403",630000,1400000,770000,55
TIKI,giay-dep-nam,159015474,"Dép nhựa siêu nhẹ Bitis nam",93000,93000,0,0
TIKI,giay-dep-nam,195430227,"Dép Nam Da Bò Thật BIGGBEN Cao Cấp DN319",379000,450000,71000,16
TIKI,giay-dep-nam,249218358,"Giày đốc nam buộc dây da bò cao cấp, đế cao su khâu chắc chắn bền bỉ",439000,439000,0,0
TIKI,giay-dep-nam,262983906,"Dép nam đế may sẵn quai ngang cao cấp KEEDO KD0606",480000,480000,0,0
TIKI,giay-dep-nam,203150672,"Giày Vans Classic Slip-On Eco Theory Checkerboard VN0A5JMH705",1550000,1550000,0,0
TIKI,giay-dep-nam,41342304,"Giày Da Nam Germano Bellesi Italia GB 229",11500000,11500000,0,0
TIKI,giay-dep-nam,55291953,"GIÀY CAO NAM T03 TRƠN CAO 5CM",790000,790000,0,0
TIKI,giay-dep-nam,172316861,"Giày Mọi Nam Đế Âm TiTi ĐÔ Da Bò Thật Cao Cấp GM2069c",743000,743000,0,0
TIKI,giay-dep-nam,59177312,"Giày Tây Nam Tăng Chiều Cao Da Bò BIGGBEN Cao Cấp GT191",849000,1000000,151000,15
TIKI,giay-dep-nam,196470589,"Dép Nam Bít Mũi Da Bò Thật Cao Cấp HKT307",450000,450000,0,0
TIKI,giay-dep-nam,179567891," DÉP QUAI NGANG DA NAM 2022 MAY FULL QUAI VÀ ĐẾ RẤT CHẮC CHẮN DONAVYOG",49000,70000,21000,30
TIKI,giay-dep-nam,2546571,"Giày Tây Nam Da Bò SUNPOLO SUKT0540N",750000,750000,0,0
TIKI,giay-dep-nam,149532281,"Dép quai ngang nam",262000,262000,0,0
TIKI,giay-dep-nam,55504193,"GIÀY TĂNG CHIỀU CAO  GIÀY CAO DÀNH CHO NAM GIỚI T&TRA T20 TRẮNG  -  CAO 8CM GIÀY ĐỘN NAM CAO VƯỢT TRỘI",950000,950000,0,0
TIKI,giay-dep-nam,202332608,"Giầy da Nam cao cấp giày buộc dây chuẩn giày nam đẹp kiểu giày tây công sở - HS78",798000,798000,0,0
TIKI,giay-dep-nam,164041783,"Giày nam cao cổ, giày bốt nam hàng full box mẫu mới cực chất, giày boot kiểu dáng cực chất, phong cách",610000,610000,0,0
TIKI,giay-dep-nam,207509888,"Giày lười, Moca da Pu, giày mọi nam cao cấp",159000,159000,0,0
TIKI,giay-dep-nam,2639047,"Dép nhựa quai ngang sọc trắng S013 - Đen",69000,69000,0,0
TIKI,giay-dep-nam,76121146,"Dép kẹp nam da bò thật-D040",450000,450000,0,0
TIKI,giay-dep-nam,140836685,"Giày Lười Nam Da Bò SUNPOLO MU2588 (Xanh Navy)",790000,790000,0,0
TIKI,giay-dep-nam,42642195,"Máy làm sạch đánh bóng giày dép quần áo túi xách ",399000,399000,0,0
TIKI,giay-dep-nam,168092978,"Giày nam nhựa mềm",57000,57000,0,0
TIKI,giay-dep-nam,207510992,"Giày sục nam CAO CẤP BTAHOME LX 280-3 size 38-45, DA Pu VÂN CÁ SẤU",155000,155000,0,0
TIKI,giay-dep-nam,60793208,"Xi vệ sinh giày sneaker Hando 100ml",44000,44000,0,0
TIKI,giay-dep-nam,109787048,"Giày nam da bò công sở 20505 - màu",268000,453300,185300,41
TIKI,giay-dep-nam,12005079,"Giày Lười Nam Penny Loafer Tomoyo TMN08108",1290000,2890000,1600000,55
TIKI,giay-dep-nam,207865926,"Giày Tây Derby Nam Công Sở Da Lộn Cao Cấp DUCA DI MORRONE Nhập Khẩu Từ Ý - Made In Italy – 605_CAMOSCIO",1948100,1948100,0,0
TIKI,giay-dep-nam,82858419,"Giày Tây Nam Công Sở Happyshoes Da Bò Thật Vân Cá Sấu HS19",650000,650000,0,0
TIKI,giay-dep-nam,207510922,"Giày hở gót nam cao cấp giá đẹp thị trường S001",159000,159000,0,0
TIKI,giay-dep-nam,135852529,"Giày lười nam da bóng chuông màu đen tăng chiều cao 3cm gea giày tây nam trẻ trung cao cấp da thật - Mã GEADLM01",199000,199000,0,0
TIKI,giay-dep-nam,161404101,"Dép kẹp nam và nữ đế trắng quai trắng phối màu",82999,82999,0,0
TIKI,giay-dep-nam,168955221,"Dép Da Nam Thời Trang Đế Cao Su Đúc Nguyên Khối Cao Cấp-DDTT",109000,109000,0,0
TIKI,giay-dep-nam,88818771,"Giày lười giày mọi nam da bóng kiểu dáng hàn quốc đai én",210000,210000,0,0
TIKI,giay-dep-nam,33053104,"Giày lười nam",1700000,1700000,0,0
TIKI,giay-dep-nam,41335268,"Giày Da Nam Cao Cấp Germano Bellesi Italia_GB 1317",8880000,8880000,0,0
TIKI,giay-dep-nam,57890643,"Giày mọi nam Trường Hải màu đen bò da bò thật cao cấp không bong tróc đế cao su chống mòn không trơn GMTH096",520000,599000,79000,13
TIKI,giay-dep-nam,176896414,"Giày tây nam công sở cao cấp GT111 Manzo store",180000,180000,0,0
TIKI,giay-dep-nam,125271467,"Giày Da nam cực chất xả kho giá gốc - giày lười nam x076",210000,210000,0,0
TIKI,giay-dep-nam,19750669,"Giày Lười Vải Nam Happyshoes HPS001",150000,150000,0,0
TIKI,giay-dep-nam,176896373,"Giày Oxford nam cao cấp - Giày công sở da bò sang trọng - MANZO LUX 104 - Manzo Store",180000,180000,0,0
TIKI,giay-dep-nam,149410045,"Giày lười công sở da cao cấp ChristinA-Q GNA368",1199000,1199000,0,0
TIKI,giay-dep-nam,207508680,"Giày hở gót nam da Pu phong cách trẻ trung lịch lãm mã S002",159000,159000,0,0
TIKI,giay-dep-nam,115576332,"Giày Da Nam Buộc Dây, Da Bò Bảo Hành 12 Tháng Mã MBH02",500000,1000000,500000,50
TIKI,giay-dep-nam,59395267,"Giày 101 thể thao nam phong cách mạnh mẽ trẻ trung năng động",199000,369000,170000,46
TIKI,giay-dep-nam,119287919,"Dép Nam Quai Ngang TiTi ĐÔ Da Bò Thật Cao Cấp DNA2118a",380000,380000,0,0
TIKI,giay-dep-nam,66628606,"Giày lười da bò thật nam cao cấp trang trọng, lịch lãm mã 8836",599000,799000,200000,25
TIKI,giay-dep-nam,129942758,"Giày nam nữ Converse cổ cao màu trắng cổ điển Chuck Taylor All Star Classic - 121184C / M7650C",1395000,1550000,155000,10
TIKI,giay-dep-nam,113779677,"Dép Bít Mũi Nam HÀ NAM Da Bò Thật Cao Cấp GSB2089",460000,460000,0,0
TIKI,giay-dep-nam,20507532,"Bộ 3 dụng cụ xỏ giày cao cấp - Hàng nội địa Nhật",127000,127000,0,0
TIKI,giay-dep-nam,187558383,"Giày nam  extra  Giày Thể Thao Nam Tăng Chiều Cao S42 màu Ghi",155000,155000,0,0
TIKI,giay-dep-nam,109787786,"Giày tây nam da bóng Đồ Da Thành Long 20393",469000,469000,0,0
TIKI,giay-dep-nam,10047160,"Dép Xỏ Ngón Nam BIGGBEN Da Bò Thật DK30",400000,400000,0,0
TIKI,giay-dep-nam,129352209,"Dép Vento Quai Ngang Thời Trang AD22",205000,205000,0,0
TIKI,giay-dep-nam,55457002,"Giày tây nam Trường Hải không dây da bò  thật màu đen mềm mại đế cao su không trơn may chắc chắn GT810",447000,515000,68000,13
TIKI,giay-dep-nam,249719045,"Giày Tây Nam Cao Cấp Kiểu Dáng Oxford Brogues Đế Phíp, Da Bò Thật, Thiết Kế Họa Tiết Sang Trọng SCC-03",892000,892000,0,0
TIKI,giay-dep-nam,8127628,"Lót giày tăng chiều cao không khí nguyên bàn 1 lớp cao 3 cm (Màu Đen)",45000,45000,0,0
TIKI,giay-dep-nam,49614118,"Giày Da Nam Công Sở Da Bò Thật Vân Cá Sấu - HS52",648000,648000,0,0
TIKI,giay-dep-nam,76479014,"Giày Lười Da Cara Phối Khóa Lịch Lãm",193500,193500,0,0
TIKI,giay-dep-nam,167931335,"Giày Lười Nam Công Sở Da Bóng Cao Cấp Quai Vàng dập vân, Giày Nam giá Rẻ,đê khâu - Giảm 5",160000,160000,0,0
TIKI,giay-dep-nam,175886036,"Dép Quai Ngang Nam Mẫu Mới KEEDO-KD2809 - Đen",480000,480000,0,0
TIKI,giay-dep-nam,100869043,"Giày Da Nam Buộc Dây Da Bò Đế Khâu Mã BH-730",650000,1300000,650000,50
TIKI,giay-dep-nam,115680579,"Giày Lười Nam Da Bò Đế Khâu, Kiểu Giày Mọi Mã MGL66-L",450000,900000,450000,50
TIKI,giay-dep-nam,164042031,"giày da nam cổ cao... đế cao su chất liệu da bò nguyên tấm Giày, bốt nam cổ cao Da Bò",610000,610000,0,0
TIKI,giay-dep-nam,271520629," Giày Mọi Màu Trắng Da Thật MR08 Giày Lười Trắng Mềm Êm Chân Giày SAGO’S Bảo hành 12 tháng",691000,691000,0,0
TIKI,giay-dep-nam,127580930,"Giày Doc.588 lửng da bò nguyên tấm",669000,669000,0,0
TIKI,giay-dep-nam,180228967,"Máy sấy giày đa năng bằng tia cực tím cao cấp MSG01",389000,600000,211000,35
TIKI,giay-dep-nam,39997426,"Dép bít mũi nam da bò cao cấp Trường Hải BM213",350000,399000,49000,12
TIKI,giay-dep-nam,20639773,"Chai vệ sinh giày dép, túi xách - 100ml",9599,9599,0,0
TIKI,giay-dep-nam,155008229,"Dép 2 Quai Ngang cao cấp KEEDO BH00505 da bò thật siêu bền",960000,960000,0,0
TIKI,giay-dep-nam,67367689,"Dép quai hậu nam công sở da bò thật giản dị đế mềm êm thoáng khí kiểu dáng Hàn Quốc mã 50335",359000,689000,330000,48
TIKI,giay-dep-nam,55107216,"Giày Tây Nam Da Bò BIGGBEN Cao Cấp GT172",599000,730000,131000,18
TIKI,giay-dep-nam,50390802,"Lót độn đế silicon nguyên khối trong suốt tăng 3cm chiều cao - buybox - BBPK47",72000,120000,48000,40
TIKI,giay-dep-nam,189372265,"Giày Sneaker Da Nam DINCOX C13 Cách Điệu Sáng Tạo Charcoal",530000,530000,0,0
TIKI,giay-dep-nam,196849302,"Giày tây nam Pierre Cardin - PCMFWLG 758",2990000,2990000,0,0
TIKI,giay-dep-nam,158159119,"Giày tây nam da mềm, đế cao, phong cách chuẩn châu âu, size từ 39 đến 43 - Khóa bạc",295000,295000,0,0
TIKI,giay-dep-nam,190537769,"Dép quai kẹp xốp Bitis nam",90000,90000,0,0
TIKI,giay-dep-nam,146491340,"Giày Thể Thao Nam, Giày Nam Sneaker Màu Trắng, Màu Đen Bằng da Mềm Mịn Form Gọn Ôm Chân Tặng Kèm Đồng Hồ Nam",179000,179000,0,0
TIKI,giay-dep-nam,196215025,"Giày/dép Sandal Vento DARIUS Nam màu Tro đi học/đi làm SD-NB10607",395000,395000,0,0
TIKI,giay-dep-nam,125740274,"Giày Tây Nam Da Bò SUNPOLO MU6673 (Đen, Nâu)",950000,950000,0,0
TIKI,giay-dep-nam,162994213,"Dép quai ngang Lihsing nam",429000,429000,0,0
TIKI,giay-dep-nam,71693900,"Giày Tây Nam Cao Cấp Mã  BH73",550000,1100000,550000,50
TIKI,giay-dep-nam,179060663,"Dép sục cross nam nữ oflaod màu đen đi mưa, thoáng, bền, hàng xịn, full box",405000,405000,0,0
TIKI,giay-dep-nam,109885929,"Dép quai ngang nam Đông Hải da bò cao cấp thiết kế quai bản to dễ phối đồ - D1811",590000,590000,0,0
TIKI,giay-dep-nam,74291635,"Giày Da Màu Nâu Đế Khâu, Mang Êm Chân",253500,253500,0,0
TIKI,giay-dep-nam,14380825,"Dép nam saldalda bò cao cấp Trường hải SD038",298000,339000,41000,12
TIKI,giay-dep-nam,156216262,"GIÀY LƯỜI NAM KHÂU VIỀN DA BÒ THẬT 100",750000,750000,0,0
TIKI,giay-dep-nam,122712021,"Giày Lười Da Bò Nam, Kiểu Dáng Bắt Mắt, Thiết Kế Giữ Phong Dáng, Đế Cao Su, Da Chuẩn GD19",229000,430000,201000,47
TIKI,giay-dep-nam,164491354,"(Kèm Video )Giày Thể Thao Nam MS042 Tăng Chiều Cao Phong Cách  Thời Trang Trẻ Trung có 2 màu",99000,99000,0,0
TIKI,giay-dep-nam,183110561,"Giày Thể Thao Nam Đế Em SK012 Thoáng Khí- Có 2 Màu",54000,54000,0,0
TIKI,giay-dep-nam,145455290,"Giày nam, giày sneaker nam cao cấp mới nhất CỰC HOT",229000,229000,0,0
TIKI,giay-dep-nam,55085257,"Giày sandal nam Trường Hải da bò thật mềm mại màu nâu đế PU nhẹ nhàng không trơn hình ảnh thật SD0474",292000,319000,27000,8
TIKI,giay-dep-nam,184068704,"HAVAIANAS - Dép nam Brasil Logo 4110850",749000,749000,0,0
TIKI,giay-dep-nam,4418135,"Giày Chelsea Boot Tathanium Nam Màu Đen Da Lộn TFBKS8812",750000,750000,0,0
TIKI,giay-dep-nam,149552726,"Giày Sandal Bít Mũi Nam Da Bò SUNPOLO SDA007 (Đen, Nâu)",610000,610000,0,0
TIKI,giay-dep-nam,9810961,"Giày Slip On Unisex Vans - VN000EYEBWW",1450000,1450000,0,0
TIKI,giay-dep-nam,116819962,"Dép sandal nam và nữ đế đen quai bố đen",82500,82500,0,0
TIKI,giay-dep-nam,85386059,"GIày Sandal Nam Da Bò BIGGBEN Cao Cấp SD112",339000,450000,111000,25
TIKI,giay-dep-nam,161496598,"Giày lười vải nam trung niên cao cấp form dáng đẹp - giày lười vải nam thoáng khí",155000,155000,0,0
TIKI,giay-dep-nam,59436595,"Sandal  nam cao cấp Pierre Cardin PCMFWL 127 - màu nâu",1890000,1890000,0,0
TIKI,giay-dep-nam,115768012,"Giày Sục Nam Da Bóng Có Đai Vàng Kết Hợp Da Lộn Mã L194 Màu Đen",199000,199000,0,0
TIKI,giay-dep-nam,31208721,"Dép nam bít mũi da bò cao cấp TH_QN054",288000,339000,51000,15
TIKI,giay-dep-nam,20333597,"Dép cao su 5 quai ngang",300000,300000,0,0
TIKI,giay-dep-nam,6396781,"Sandal Nam Bít Mũi BIGGBEN Da Bò Thật SD44",419000,470000,51000,11
TIKI,giay-dep-nam,96242641,"Sandal Bitis nam",325000,325000,0,0
TIKI,giay-dep-nam,38410774,"Bút Làm Trắng Đế Giày - Bút Repaint Giày Chuyên Dùng - Enito Sneaker Pen - 10ml - Hàng Chính Hãng",350000,350000,0,0
TIKI,giay-dep-nam,176896324,"Giày Chelsea Boots cổ cao cho nam - Da bò thật 100% bảo hành 12 tháng - MANZO CHEL 101 - Manzo Store",120000,120000,0,0
TIKI,giay-dep-nam,155221895,"Giày đốc nam da bò cao cấp Giày gồ cột dây đế nâu cá tính- G88 Giày SAGO’S",650000,650000,0,0
TIKI,giay-dep-nam,70373722,"Dép sức khỏe nam Spenco Kholo Black Carbon 450",1695000,1695000,0,0
TIKI,giay-dep-nam,107016933,"Dép Xỏ Ngón Nam Da Bò BIGGBEN DK82",299000,450000,151000,34
TIKI,giay-dep-nam,206266313,"Giày Nam Doctor Matin - Giày đốc trơn da mềm sang trọng phong cách Hàn Quốc Da trơn",199000,199000,0,0
TIKI,giay-dep-nam,117492220,"Chai xịt giày Aht Nano Bạc khữ mùi diệt khuẩn, chống thối chân hôi giày - XITGIAY-AHT",49000,69000,20000,29
TIKI,giay-dep-nam,168273906,"Lót giày thể thao êm chân tăng 0,5 Size Thoáng khí XLGTT01",30000,50000,20000,40
TIKI,giay-dep-nam,8421386,"Dép Nam Bảng Ngang BIGGBEN Da Bò Thật DN137",319000,400000,81000,20
TIKI,giay-dep-nam,129352307,"Giày Sandal Nam Vento Quai Chéo Xuất Khẩu NV4538",320000,320000,0,0
TIKI,giay-dep-nam,59168538,"Dép Xỏ Ngón Nam Da Bò BIGGBEN DK68",319000,400000,81000,20
TIKI,giay-dep-nam,173234115,"Giày nam Da bò Giày Thời Trang cỡ lớn giày nam công sở sang trọng 20893",423900,423900,0,0
TIKI,giay-dep-nam,55954576,"Giày tây nam Trường Hải da bò cao cấp GTN0123",416000,479000,63000,13
TIKI,giay-dep-nam,69535199,"Lót giày độn đế Silicon tăng chiều cao, chống đau chân ( Bộ chuẩn 10 miếng lắp ghép 1 đôi giày) ",39000,39000,0,0
TIKI,giay-dep-nam,105522183,"Giày Sneaker nam, Giày thể thao da nam, ba màu đen - xanh - trắng, đế cao su nguyên khối, đế nén khí đàn hồi G147",149000,149000,0,0
TIKI,giay-dep-nam,81735107,"Giày Tây Da Cao Cấp Thanh Lịch",250000,250000,0,0
TIKI,giay-dep-nam,186072035,"Giày da nam trung niên mũi tròn, đế khâu thời thượng - 6N",250000,250000,0,0
TIKI,giay-dep-nam,63238091,"GIÀY SANDAL NAM GIAVY QUAI NGANG SL474",200000,200000,0,0
TIKI,giay-dep-nam,6605805,"Dép SaBo Nam BIGGBEN Da Bò Thật Cao Cấp SB26",339000,450000,111000,25
TIKI,giay-dep-nam,104616280,"Giày thể thao nam thoáng khi phong cách hàn quốc ts03",50000,50000,0,0
TIKI,giay-dep-nam,143221499,"Giày thể thao nam Sneaker03, đế casu chống trơn trượt, thời trang phong cách trẻ - Trắng",50000,50000,0,0
TIKI,giay-dep-nam,15638856,"Giày Lười Nam Tomoyo da đế âm TMN05601",890000,2490000,1600000,64
TIKI,giay-dep-nam,125782082,"Dép lào thái",59999,59999,0,0
TIKI,giay-dep-nam,22917827,"Dép Nam BIGGBEN Da Bò Thật Cao Cấp DN175",309000,400000,91000,23
TIKI,giay-dep-nam,87108557,"Giày Sneaker Nam Da Bê Siêu Nhẹ TOMOYO TMN60701",1290000,2890000,1600000,55
TIKI,giay-dep-nam,97585553,"Giày Lười Da Nam Cao Cấp - Chất Liệu Da Mềm 100% - Đế Cao Su CAO 3CM - Mã G004 Màu Đen",210000,210000,0,0
TIKI,giay-dep-nam,178608393,"SandaI Vento Bít Bũi Dã Ngoại NV7604",330000,330000,0,0
TIKI,giay-dep-nam,6012203,"Dép Nam Quai Ngang",169000,169000,0,0
TIKI,giay-dep-nam,177772830,"Dép Nam Xỏ ngón Thái Lan Quai Kẹp GM 11401",240000,240000,0,0
TIKI,giay-dep-nam,153257924,"Giầy Sandal Nam Đế Chữ - quai hậu nam học sinh quai ngang Đế Chữ",138000,138000,0,0
TIKI,giay-dep-nam,184418758,"Giày tây nam cổ thấp da bò Lucas Derby Black 01",720000,720000,0,0
TIKI,giay-dep-nam,99944957," Giày thể thao nam, giày sneaker nam Trắng xám off dream k553",250000,250000,0,0
TIKI,giay-dep-nam,191908085,"GIÀY SỤC VẢI CROSS LITERIDE MESH MULE MÀU NAVY dành CHO NAM",450000,450000,0,0
TIKI,giay-dep-nam,180365695,"Giày Sneaker Nam, Giày Nam Da Thật Hàng Cao Cấp Kiểu Mới 2022",189000,189000,0,0
TIKI,giay-dep-nam,13365811,"Giày Lười Nam Da Bò Cao Cấp D006",210000,210000,0,0
TIKI,giay-dep-nam,115958499,"Giày Sandal Nam HÀ NAM Da Bò Thật Cao Cấp DNA2136",496000,496000,0,0
TIKI,giay-dep-nam,169100704,"Dép Nam Quai Da Bò Loại Bền Đẹp Đây ( Mã DE01)",300000,600000,300000,50
TIKI,giay-dep-nam,167011221,"MLB - Giày mule thời trang Playball Origin 3AMUUA11N",1690000,1690000,0,0
TIKI,giay-dep-nam,189172796,"Giày Sneakers Nam GEOX U Kennet A",4100000,4100000,0,0
TIKI,giay-dep-nam,100128769,"Sandal nam quai ngang da bò Đông Hải - S3216",790000,790000,0,0
TIKI,giay-dep-nam,8189688,"Lót Giày Nam Cao Cấp Run Sport - Lót Giầy Thể Thao Chuyên Dụng",45000,45000,0,0
TIKI,giay-dep-nam,90883247," Giày thể thao nam, giày sneaker nam Trắng xám off dream k553",250000,250000,0,0
TIKI,giay-dep-nam,171536365,"Dép quai ngang nam nữ M Masler-MT đan mạch vàng với lớp đế chống nước, chống trượt và quai êm chân DMV",458000,458000,0,0
TIKI,giay-dep-nam,84761452,"GIÀY TÂY DA NHÁM NAM",148000,148000,0,0
TIKI,giay-dep-nam,84936233,"Giày thể thao nam sneaker đế 2 lớp nam tính G183",55000,90000,35000,39
TIKI,giay-dep-nam,144347672,"Giày nam mũi tròn bigsize da bò cao cấp Trường Hải đế cao su may chắc chắn không trơn",451000,550000,99000,18
TIKI,giay-dep-nam,143948995,"Giày tây nam da mềm, đế khâu, size từ 38 đến 43 thời thượng",193500,193500,0,0
TIKI,giay-dep-nam,144181471,"Dép tổ ong xịn màu đen siêu bền dép nhựa nam chống trơn trượt dép nam quai nganh dép nhựa mang lao động dép đi biển",59500,59500,0,0
TIKI,giay-dep-nam,180364178,"Dép tông lào, Dép kẹp nam Thái Lan siêu nhẹ Mixstar - (MV 2012 - 2111 - 2059)",60000,60000,0,0
TIKI,giay-dep-nam,96308272,"Giày sục nam da bò cao cấp,sapo nam trẻ trung năng động khoá chống rỉ sét màu đen-S051 Bảo hành 12 tháng",493000,493000,0,0
TIKI,giay-dep-nam,107801745,"Cây giữ form giày bằng gỗ nguyên bản bền bỉ cho nam nữ XIMO Hemu (XCGFG10)",149000,288000,139000,48
TIKI,giay-dep-nam,144916491," Giày nam trẻ trung hiện đại phong cách Hàn Quốc - 5560",429000,799000,370000,46
TIKI,giay-dep-nam,41863795,"Giày Da Nam Cao Cấp Phong Cách Trẻ Trung Năng Động Lịch lãm, Giày Tây Nam Da Bò HS08",350000,350000,0,0
TIKI,giay-dep-nam,183068284,"Dép kẹp nam quai dù siêu bền KEEDO KD1396",280000,280000,0,0
TIKI,giay-dep-nam,171535712,"Dép quai ngang nam nữ M Masler-MT màu xanh dương 4 sọc xám với lớp đế êm chân và chống trượt XD4X",298000,298000,0,0
TIKI,giay-dep-nam,116631768,"Giày Boots Chelsea zip Boot Black da bò",720000,720000,0,0
TIKI,giay-dep-nam,175567406,"(5 Màu) Dép nữ nam độn đế 2 Ulzang Gấu XX, chất liệu eva siêu bền không ngấm nước( xả hàng)",43000,43000,0,0
TIKI,giay-dep-nam,96305940,"Giày sục nam da bò cao cấp,sapo nam trẻ trung năng động khoá chống rỉ sét màu đen dập vân cá sấu-S05 Bảo hành 12 tháng",483000,483000,0,0
TIKI,giay-dep-nam,113304468,"CHAI NƯỚC ĐÁNH GIÀY THẦN THÁNH ",18050,19000,950,5
TIKI,giay-dep-nam,129354450,"Sandal Vento Nam Nữ Quai Ngang Xuất Khẩu  NB02",385000,385000,0,0
TIKI,giay-dep-nam,72595725,"Giày mọi nam đế âm HÀ NAM da bò thật cao cấp GDA2026",692000,692000,0,0
TIKI,giay-dep-nam,127388483,"Giày nam cao cổ da thật cao cấp giày nam thời trang kiểu dáng Hàn Quốc mã 78788",999000,1690000,691000,41
TIKI,giay-dep-nam,196200363,"Giày Thể Thao Nam Sneaker Vải Lưới Thoáng Khí Mát Chân Không Mùi, Đế Cao Su Non G190",59000,100000,41000,41
TIKI,giay-dep-nam,35880826,"Giày tây công sở nam PU3",150000,150000,0,0
TIKI,giay-dep-nam,181922052,"Dép nam Đông Hải quai ngang da bò cao cấp thiết kế  quai dán thời trang đế cao su chắc chắn - D3218",690000,690000,0,0
TIKI,giay-dep-nam,21981293,"Giày rọ nam Huy Hoàng da bò màu nâu HT7787",909000,909000,0,0
TIKI,giay-dep-nam,67291183,"LÓT GIÀY BẰNG DA BÒ MIẾNG",31000,31000,0,0
TIKI,giay-dep-nam,14241563,"Dép bít mũi nam da bò cao cấp đen",298000,339000,41000,12
TIKI,giay-dep-nam,172472575,"Giày Sandal Nam The Bily 3 Quai Ngang - Màu Xám BL04",349000,349000,0,0
TIKI,giay-dep-nam,58134837,"GIẦY THỂ THAO NAM SIÊU NHẸ KIỂU DÁNG CAO CẤP",150000,150000,0,0
TIKI,giay-dep-nam,172472682,"Giày Sandal Nam The Bily 3 Quai Ngang - Màu Xám Thổ Cẩm BL04",349000,349000,0,0
TIKI,giay-dep-nam,171733897,"HAVAIANAS - Dép nam Top Fortnite 4146366",749000,749000,0,0
TIKI,giay-dep-nam,98355398,"Dép quai ngang thời trang nam siêu bền đẹp",139000,275000,136000,49
TIKI,giay-dep-nam,145236482,"Giày Nhựa Nam Cột Dây Cao Cấp Siêu Êm GIAY-003-2",527000,527000,0,0
TIKI,giay-dep-nam,56921537,"Dép kẹp Crocs Crocband  UNISEX 11033",767000,1095000,328000,30
TIKI,giay-dep-nam,5435571,"Dép bít đầu- dép sục da bò thật VO Shoes_KK42",400000,450000,50000,11
TIKI,giay-dep-nam,49322855,"Giày Tây Nam Da Bóng Đế Đen Phối Khóa",223500,223500,0,0
TIKI,giay-dep-nam,167501148,"Giày Da Nam Mã CK02 Loại Cổ Lửng, Da Bò",550000,1100000,550000,50
TIKI,giay-dep-nam,108432652,"GIày Sandal Nam Da Bò BIGGBEN Cao Cấp SD115",369000,450000,81000,18
TIKI,giay-dep-nam,105524091,"Lót Giày Vải Quế Thơm Nam Thấm Hút Mồ Hôi Êm Chân Rất Bền L07",10000,10000,0,0
TIKI,giay-dep-nam,110992969,"Giày thể thao nam, giày sneaker nam Trắng xám off dream k553",250000,250000,0,0
TIKI,giay-dep-nam,106305229,"Giày Nam S69 Kiểu Dáng Thể Thao Màu Đen Năng Động",80000,80000,0,0
TIKI,giay-dep-nam,76171558,"DÉP DA BÒ NAM 100%, QUAI LƯNG CÁ SẤU",229000,370000,141000,38
TIKI,giay-dep-nam,89933080,"Giầy tây nam công sở 20498",505000,582100,77100,13
TIKI,giay-dep-nam,171202931,"Giày sandal 4 dây quai ngang phối chéo Giavy SL524",198000,198000,0,0
TIKI,giay-dep-nam,97546164,"Giày Tây Nam Buộc Dây Bảo Hân Mã CS89",295000,590000,295000,50
TIKI,giay-dep-nam,177748957,"Giày Lười Nam Cao Da Bò Thật BIGGBEN Tăng Chiều Chiều Cao Thêm 6cm GM272",899000,1200000,301000,25
TIKI,giay-dep-nam,141237392,"Giày Tây nam tăng chiều cao Đông Hải kiểu dáng Derby  thanh lịch da cao cấp đế 6cm cải thiện chiều cao - G0615",1980000,1980000,0,0
TIKI,giay-dep-nam,50694122,"Bọt vệ sinh giày đa năng, sneaker + tặng kèm  bản chải đánh giày",120000,120000,0,0
TIKI,giay-dep-nam,111092834,"Chai xịt khử mùi hôi giày PenGuin; Nhập khẩu Malaysia, diệt vi khuẩn và nấm mốc trong giày",54400,68000,13600,20
TIKI,giay-dep-nam,192889107,"Sticker nhựa jibbitz unisex Crocs Beer",145000,145000,0,0
TIKI,giay-dep-nam,135370236,"Chai Làm Sạch Giày Dép Túi Xách, Lọ Xịt Chà Trắng Giày Dép",9998,9998,0,0
TIKI,giay-dep-nam,74292108,"Giày Lười Nam Da Mềm, Khâu Đế Sang Trọng",253500,253500,0,0
TIKI,giay-dep-nam,139078021,"Chai xịt tẩy trắng giày dép túi xách Plac - Chai xịt tẩy trắng ",7000,15000,8000,53
TIKI,giay-dep-nam,13883504,"Giày sneaker TMN05404",630000,1400000,770000,55
TIKI,giay-dep-nam,146414112,"Giày quai nang nam, dép quai hậu nam đẹp phong cách thời trang Hàn Quốc mã DEP11LE",159000,299000,140000,47
TIKI,giay-dep-nam,193054679,"Giày thể thao nam, giày sneakers nam kẻ bo chun 2 màu C80",200000,200000,0,0
TIKI,giay-dep-nam,13980705,"Giày Mọi Nam BIGGBEN Da Bò Thật Cao Cấp GM159",549000,720000,171000,24
TIKI,giay-dep-nam,141245183,"Dép bít mũi nam da bò thật BIGGBEN cao cấp SB108",459000,600000,141000,24
TIKI,giay-dep-nam,17970831,"Lót giày da mộc êm chân hình chữ T Woly Galant - NK Đức",69000,69000,0,0
TIKI,giay-dep-nam,183544565,"Giày Lười Nam Penny Loafer George TMN22801",1290000,2890000,1600000,55
TIKI,giay-dep-nam,179546441," GIÀY TÂY NAM DA BÒ THẬT 100%, DONAVY GTN, HÀNG CÔNG TY CAO CẤP DOGTN",449000,850000,401000,47
TIKI,giay-dep-nam,13360653,"Giày Da Nam BH002",450000,900000,450000,50
TIKI,giay-dep-nam,202708835,"Giày thể thao nam cổ cao GNC-T22-BL, giày thể thao thoáng khí phong cách hàn quốc",299000,299000,0,0
TIKI,giay-dep-nam,178958545,"Giày Sneaker nam da thật màu trắng cao cấp NEW 2022",189000,189000,0,0
TIKI,giay-dep-nam,135852613,"Giày tây lười nam cao cấp, Giày lười da pu in vân nổi bật trẻ trung tăng chiều cao đế cao su đúc - Mã DR01",199000,199000,0,0
TIKI,giay-dep-nam,191592535,"Giày da nam Boat Shoes Xám da bò sáp cao cấp Hanmade, Lucas Shoes, Bảo hành 1 năm",659000,659000,0,0
TIKI,giay-dep-nam,72770419,"Giày cao cổ nam g12",650000,650000,0,0
TIKI,giay-dep-nam,88081802," Giày thể thao nam, giày nam da lộn 2801",200000,200000,0,0
TIKI,giay-dep-nam,125244241,"Giày nam công sở phong cách lịch lãm, Giày da nam cao cấp chất liệu da bò pu in vân nổi bật đế cao su đúc - Mã GEA01",210000,210000,0,0
TIKI,giay-dep-nam,191592703,"Dép da bò đế trấu, Sandal da bò sáp, may thủ công Lucas Shoes, bảo hành 6 tháng",375000,375000,0,0
TIKI,giay-dep-nam,98039876,"Giày Thể Thao Nam Màu Đen Đế Cao Su Non Đúc",161491,169990,8499,5
TIKI,giay-dep-nam,272384051,"Giày Sục Nam S92 Da Bò Thật Sục nam trẻ trung năng động Màu Đen Giày hở gót da mềm mại Bảo Hành 12 Tháng",392000,392000,0,0
TIKI,giay-dep-nam,102796815," Giày thể thao nam, giày sneaker nam độn đế mới nhất HOT 2021",169000,169000,0,0
TIKI,giay-dep-nam,148717398,"Máy đánh bóng giày dép công suất cao Bóng Đẹp Như Mới",222000,222000,0,0
TIKI,giay-dep-nam,189216576,"Giày tây tăng bí mật 6-7cm phối dây da mềm, đế khâu thời thượng - cột tăng cao",350000,350000,0,0
TIKI,giay-dep-nam,73820375,"Giày Sneaker thể thao nam buộc dây, đế cao su nguyên khối, đế nén khí đàn hồi G147",176000,176000,0,0
TIKI,giay-dep-nam,186232739,"Dép xỏ ngón nam da cá sấu màu đen chính hãng Trường Hải may viền chắc chắn DCS255",607000,699000,92000,13
TIKI,giay-dep-nam,197618496,"Giày Sneaker Nam Vải Canvas DINCOX E06 Blue Đơn Giản Tinh Tế Sang Trọng",442000,442000,0,0
TIKI,giay-dep-nam,168587075,"Giày thể thao sneaker nam cổ thấp, giày đế tăng chiều cao mẫu mới k1",155000,155000,0,0
TIKI,giay-dep-nam,13586787,"Lót giày tăng chiều cao eva nguyên bàn cao 3 cm (Màu Xám)",67000,67000,0,0
TIKI,giay-dep-nam,67251045,"Giày Tây Derby Banuli Nam Cổ Điển Da Bò Nappa Dây Buộc B2PD1C0 (Da Mềm Dẻo, Đế Kháng Trượt, Bảo Hành Trọn Đời)",1450000,1450000,0,0
TIKI,giay-dep-nam,156216180,"GIÀY LƯỜI NAM DA BÒ THẬT 100% KHÂU ĐẾ CHẮC CHẮN BAO ĐI NƯỚC",500000,500000,0,0
TIKI,giay-dep-nam,192450907,"GIÀY BOOTS COLE HAAN NAM ZERØGRAND OMNI CITY BOOT WP C34238",2190000,5490000,3300000,60
TIKI,giay-dep-nam,57441310,"Dép nam quai ngang Popular hai màu quai đúc siêu êm, siêu bền",139000,275000,136000,49
TIKI,giay-dep-nam,246161335,"[Mẫu HOT] Giày Bảo Hộ Lao Động 2 TH Kiểu Thể Thao Mũi Thép, Đế Lót Thép BD0089-Chống Đinh/Trơn Trượt Giày Công Trình",349000,590000,241000,41
TIKI,giay-dep-nam,160686580,"Dép Xỏ Ngón Đế Dày Unisex Waa. - DÀY FLIP-FLOPS - Đen",790000,790000,0,0
TIKI,giay-dep-nam,177750271,"Dép bít mũi nam da bò thật BIGGBEN cao cấp SB112",449000,500000,51000,10
TIKI,giay-dep-nam,174426170,"Dép quai kẹp Bitis nam",195000,195000,0,0
TIKI,giay-dep-nam,169281047,"Dép sục cross nam yukon sport màu đen hàng xịn, full box",380000,380000,0,0
TIKI,giay-dep-nam,11615728,"Giày Tây Nam Lê Sang Cao Cấp",225000,225000,0,0
TIKI,giay-dep-nam,188658205,"Lót Giày Nam Chất Liệu Cao Su Non Mềm Êm LGN2022b",38000,38000,0,0
TIKI,giay-dep-nam,186743859,"Giày Tây Nam Da Bò Thật BIGGBEN Cao Cấp GT224",649000,800000,151000,19
TIKI,giay-dep-nam,172474462,"Giày Sandal Nam The Bily 3 Quai Ngang - Màu Trắng BL04",349000,349000,0,0
TIKI,giay-dep-nam,163572617,"Giày tây nam da mềm, tăng chiều cao 7cm bí mật, đế đã khâu chắc chắn - GD126",350000,350000,0,0
TIKI,giay-dep-nam,158212727,"Giày Lười Da Bò Nhập Khẩu Kiểu Đục Lỗ LX93 – Xưởng Da Bò Chu Hải Nam - Đồ Da Duvis",599000,599000,0,0
TIKI,giay-dep-nam,54632538,"Lót giày Crep (COMFORT INSOLE)",450000,450000,0,0
TIKI,giay-dep-nam,171535273,"Dép quai ngang nam nữ M Masler-MT màu đỏ 4 sọc trắng với lớp quai êm chân và đế chống nước DT4",338000,338000,0,0
TIKI,giay-dep-nam,71925406,"Dép nhựa nam, dép rọ đi mưa nam  hàng chất lượng SM032",68000,75000,7000,9
TIKI,giay-dep-nam,132230449,"Giày Tây Nam Công Sở Oxford Tomoyo TMN22201",1290000,2890000,1600000,55
TIKI,giay-dep-nam,7331115,"Chai Xịt Chống Thấm Crep Protect Spray 200ml",465000,465000,0,0
TIKI,giay-dep-nam,36493130,"Combo 3 đôi lót giày Hương Quế (CI-01, CI-03, CI-04) giúp khử hôi chân - phòng cảm cúm tốt cho sức khỏe",75000,75000,0,0
TIKI,giay-dep-nam,139680849,"Giày Cổ Cao Nam Timberland Waterproof Chukka Màu Bò TB02306124",4666000,5490000,824000,15
TIKI,giay-dep-nam,189233352,"Dép Hai Quai Ngang Nam KEEDO-KD1705 Full hộp siêu bền",480000,480000,0,0
TIKI,giay-dep-nam,138381582,"Dép Nam Bít Mũi TiTi ĐÔ Da Bò Thật Cao Cấp GSB2106a",460000,460000,0,0
TIKI,giay-dep-nam,125244034,"Giày Lười Nam - Dio Da Cá Sấu Tam Giác",210000,210000,0,0
TIKI,giay-dep-nam,37664448,"Giày Nam Da Bò Thật Vân Cá Sấu Cao Cấp  SM28",650000,650000,0,0
TIKI,giay-dep-nam,2597791,"Dép Nam Quai Ngang Da Bò Cao Cấp SUNPOLO SUA12D - Đen (Size",550000,550000,0,0
TIKI,giay-dep-nam,125285193,"Giày Tây Nam Da Bò Pull-up Cao Cấp SUNPOLO MU8003 (Đen, Nâu, Đỏ)",1250000,1250000,0,0
TIKI,giay-dep-nam,19850609,"Dép bít mũi nam da bò cao cấp BM080",333000,379000,46000,12
TIKI,giay-dep-nam,164270669,"Sandal nam đi học mềm êm chống trơn có quai hậu size to phù hợp cho trẻ em học sinh 10 đến 18 tuổi chân ngoại cỡ LIMIBABY ST64",199000,199000,0,0
TIKI,giay-dep-nam,161407136,"Xăng đan nam và nữ ( đế đen quai đen phối trắng ) size từ 34 nữ đến 43 nam",82999,82999,0,0
TIKI,giay-dep-nam,113451077,"Giày lười vải nam thời trang - GN05",98000,98000,0,0
TIKI,giay-dep-nam,20477328,"Giày Lười Nam Da Bò Thật Happyshoes HS21",350000,350000,0,0
TIKI,giay-dep-nam,177772759,"Dép Nam Quai Ngang Thái Lan GB 43114",190000,190000,0,0
TIKI,giay-dep-nam,195243464,"Dép nam quai ngang, nhựa mềm đi mưa Thái Lan Adda 34G10",150000,150000,0,0
TIKI,giay-dep-nam,129351632,"Giày Sandals Vento Nam Nữ Quai Ngang dạo phố/đi chơi/đi học SD1019",375000,375000,0,0
TIKI,giay-dep-nam,192880343,"Máy sấy và khử trùng giày Sothing LOOP có thể kéo dài dùng cho cả nam và nữ",289000,289000,0,0
TIKI,giay-dep-nam,6396849,"Sandal Nam Bít Mũi BIGGBEN Da Bò Thật SD45",419000,500000,81000,16
TIKI,giay-dep-nam,175901710,"Dép nam đẹp hai quai cao cấp KEEDO KD2803 Full Box",480000,480000,0,0
TIKI,giay-dep-nam,7350393,"Sandal Nam Doctor BIGGBEN Da Bò Thật SD61",339000,500000,161000,32
TIKI,giay-dep-nam,15932351,"Lót giày da đệm vỏ gỗ sồi (cork) SAPHIR",285000,285000,0,0
TIKI,giay-dep-nam,215257762,"Dép nam quai ngang KEEDO KD2636 cao cấp đế cao su chống trơn trượt",480000,480000,0,0
TIKI,giay-dep-nam,180577337,"Dép kẹp ngón Vento ARROW Nam đi biển/đi chơi NB0501",265000,265000,0,0
TIKI,giay-dep-nam,73215208,"Giày Da Nam Mã CS003",450000,900000,450000,50
TIKI,giay-dep-nam,173609788,"DÉP KẸP DA BÒ CAO CẤP VATIS VA2013",209000,379000,170000,45
TIKI,giay-dep-nam,179912274,"Giày Thể Thao Nam Sneaker Kiểu Hàn Quốc Mẫu Mới 2022 Êm Chân Thoáng Khí Cổ Vừa Trẻ Trung Năng Động GNA05",169000,169000,0,0
TIKI,giay-dep-nam,42899678,"Giày Sneaker thể thao nam cổ cao trắng đen phố họa tiết ST018",249000,411000,162000,39
TIKI,giay-dep-nam,190541766,"Dép quai kẹp đế cao su Bitis nam",280000,280000,0,0
TIKI,giay-dep-nam,105521937,"Lót giày trơn, lót giày nam nữ cực êm, không bong màu đen",9000,9000,0,0
TIKI,giay-dep-nam,193735877,"Giày Lười Nam Màu Ghi s046 Đế bệt",105000,150000,45000,30
TIKI,giay-dep-nam,119288071,"Dép Nam Quai Ngang TiTi ĐÔ Da Bò Thật Cao Cấp DNA2132a",420000,420000,0,0
TIKI,giay-dep-nam,170384383,"Dép Nam Quai Ngang TiTi ĐÔ Da Bò Thật Cao Cấp DNA2175c",389000,389000,0,0
TIKI,giay-dep-nam,101655661,"Giày Tây Tăng Chiều Cao 6cm Đệm Khí Giầy Da Tăng Chiều Cao Sans111",369000,369000,0,0
TIKI,giay-dep-nam,96180083,"Đông Hải - Giày Tây Nam G01A4",1690000,1690000,0,0
TIKI,giay-dep-nam,55106110,"Giày Tây Nam Da Bò BIGGBEN Cao Cấp GT170",599000,600000,1000,0
TIKI,giay-dep-nam,248400066,"Giày sĩ quan công ty 32 cấp tướng, giày da nam Aseco 32 mã 729 đế hơi",1180000,1180000,0,0
TIKI,giay-dep-nam,153995579,"Giày lười nam da thật đẳng cấp  thời trang-26134",529000,899000,370000,41
TIKI,giay-dep-nam,175969848,"Dép Quai Ngang Nam Cao Cấp Da Bò Thật KEEDO-KD3304 - Đen",340000,340000,0,0
TIKI,giay-dep-nam,87142469,"Giày Lười Nam Penny Loafer Tomoyo TMN07401",1290000,2890000,1600000,55
TIKI,giay-dep-nam,50242384,"Combo 2 chai tẩy trắng vệ sinh giày dép đánh bóng túi xách có đầu chà màu ngẫu nhiên",24000,24000,0,0
TIKI,giay-dep-nam,156214474,"GIÀY LƯỜI ĐÍNH KHUY NAM DA BÒ THẬT 100% CAO CẤP",750000,750000,0,0
TIKI,giay-dep-nam,147217894,"Giày Sandal Nam The Bily Quai Ngang - Màu Trắng BL03T",339000,339000,0,0
TIKI,giay-dep-nam,36340934,"Giày tây nam Da Cao Cấp công sở trơn GT3",196500,196500,0,0
TIKI,giay-dep-nam,57381733,"Giày Thể Thao Sneaker Nam Pettino GT03T (Trắng - Đen)",109000,200000,91000,46
TIKI,giay-dep-nam,15333267,"Sandal Nam Bít Đầu BIGGBEN Da Bò Thật SD85",449000,550000,101000,18
TIKI,giay-dep-nam,55062727,"Dép Nam Da Bò BIGGBEN Cao Cấp DN251",349000,400000,51000,13
TIKI,giay-dep-nam,74615576,"Giày Tây Nam Mũi Vuông Phối Quai Da Mềm, Đế Cao Khâu Sẵng",238500,238500,0,0
TIKI,giay-dep-nam,110448724,"Giày lười vải nam thời trang - GN07",99000,99000,0,0
TIKI,giay-dep-nam,51626599,"Dép Nam Hai Quai Ngang Da Bò Thật Cao Cấp DNA49",400000,400000,0,0
TIKI,giay-dep-nam,171535923,"Dép quai ngang nam nữ M Masler-MT đan mạch xám với lớp đế chống nước bền bỉ và quai êm chân DMX",458000,458000,0,0
TIKI,giay-dep-nam,58837555,"DÉP NAM QUAI KẸP GIA VY TA121",195000,195000,0,0
TIKI,giay-dep-nam,135898801,"Giày Tây Nam Trung Niên Giả Dây",199000,199000,0,0
TIKI,giay-dep-nam,11502185,"Giày Sneaker Nam GV008",99000,99000,0,0
TIKI,giay-dep-nam,151952872,"Dép nam quai ngang da bò cao cấp",239000,239000,0,0
TIKI,giay-dep-nam,177665631,"Dép Nam Quai Ngang Da Bò Thật BIGGBEN Cao Cấp DN307",289000,400000,111000,28
TIKI,giay-dep-nam,14272935,"Dép bít mũi rọ đen nam trường hải da bò cao cấp BM033",280000,319000,39000,12
TIKI,giay-dep-nam,97754334,"Giày Sandal phong cách thời trang  Nhật Bản đế mềm chất liệu da bò thật phù hợp với các mùa trong năm mã 12129",219000,429000,210000,49
TIKI,giay-dep-nam,127580599,"Giày Boots Doc.058 Crazy Horse da bò sáp ngựa",769000,769000,0,0
TIKI,giay-dep-nam,180574439,"Dép xỏ ngón Vento ARROW Nữ đi biển/đi chơi NB0508",245000,245000,0,0
TIKI,giay-dep-nam,132372006,"Giày lười nam - Slip on nam da - Mã S193",350000,350000,0,0
TIKI,giay-dep-nam,68155550,"Giày da cao cổ nam và nữ phong cách Hàn Quốc mã 8634-5",859000,1590000,731000,46
TIKI,giay-dep-nam,9999100,"Giày tây nam Oxford Tomoyo đen bóng TMN92101",999999,2890000,1890001,65
TIKI,giay-dep-nam,71961824,"Giày mọi nam đế âm HÀ NAM da bò thật cao cấp GDA2020",692000,692000,0,0
TIKI,giay-dep-nam,74541407,"Giày Thể Thao Nam Sneaker Cổ Thấp Fom chuẩn Ôm chân G169",99000,180000,81000,45
TIKI,giay-dep-nam,43350108,"Giày Da Nam Cao Cấp Phong Cách Trẻ Trung Năng Động Lịch lãm, Giày Tây Nam HS22",649000,649000,0,0
TIKI,giay-dep-nam,272839167,"Giày Da Nam Trẻ Trung, Thời Trang, Cao Cấp, Mũi Tròn, Derby MD6 GR - TG0923005",599000,599000,0,0
TIKI,giay-dep-nam,137752762,"Giày Lười Vải Nam - Phong Cách Thể Thao TT2001",169000,169000,0,0
TIKI,giay-dep-nam,130412234,"Giày nam, giày thể thao nam G fashion - Z888",200000,200000,0,0
TIKI,giay-dep-nam,141741278,"Xả Kho Giày Lười Da Bò Thật , Đế Cao Su Khâu Cực Bền , Bảo Hành Da, Đổi Size, Hot Trend",229000,350000,121000,35
TIKI,giay-dep-nam,51009821,"Dép sục nhựa quai hậu thời trang đen phối đỏ - SN930",85000,85000,0,0
TIKI,giay-dep-nam,57080245,"Giày rọ _ Giày đục lỗ da bò thật cổ điển VO Shoes_PH998",390000,490000,100000,20
TIKI,giay-dep-nam,186877299,"Giày tây lười nam cao cấp, Giày lười da bò pu in vân nổi bật trẻ trung tăng chiều cao đế cao su đúc - Mã DR01",160000,160000,0,0
TIKI,giay-dep-nam,163827033,"Xăng Đan Quai Ngang, Giày Sandal Nam Da Bò SUNPOLO SDA006 (Đen)",580000,580000,0,0
TIKI,giay-dep-nam,73738400,"Xi Dưỡng Cao Cấp Đánh Bóng Làm Mới Giày, Túi, Áo da, Đồ Da",69000,69000,0,0
TIKI,giay-dep-nam,176501918,"Dép bé trai quai ngang siêu nhân người nhện 3D Thái Lan 31R2V",160000,160000,0,0
TIKI,giay-dep-nam,163894759,"Dép Da Nam, Dép Nam Quai Ngang Da Bò SUNPOLO SQND36 (Nâu)",490000,490000,0,0
TIKI,giay-dep-nam,92441319,"Dép xỏ ngón nam da bò cao cấp HKT56",400000,400000,0,0
TIKI,giay-dep-nam,88813692,"Giày tây Giày lười nam hàn quốc đai kim loại vàng lịch lãm",222000,222000,0,0
TIKI,giay-dep-nam,111231917,"Dép lê nam đi biển đế xốp LAHstore",138600,138600,0,0
TIKI,giay-dep-nam,32863969,"Giày Lười Nam Công Sở Happyshoes Da Bò Thật  - HS390",550000,550000,0,0
TIKI,giay-dep-nam,107058711,"Dép nam sức khoẻ Spenco Yumi Black Carbon 447 - Dép kẹp nam nâng vòm giảm đau chân",1695000,1695000,0,0
TIKI,giay-dep-nam,7977133,"Giày Tây Nam Da Bò Sunpolo SUMU07N",680000,680000,0,0
TIKI,giay-dep-nam,43352682,"Giày Da Nam Cao Cấp Phong Cách Trẻ Trung Năng Động Lịch lãm, Giày Tây Nam HS25",350000,350000,0,0
TIKI,giay-dep-nam,63205098,"GIÀY SANDAL NAM GIAVY  QUAI DÂY NGANG S340",210000,210000,0,0
TIKI,giay-dep-nam,170957632,"[CHẤT LƯỢNG] Giày boot chelsea nam da trơn cao cấp êm chân cá tính SM089CHEL - Đen",195000,195000,0,0
TIKI,giay-dep-nam,63191184,"GIÀY SANDAL NAM GIAVY  2 DÂY NGANG - SL411",225000,225000,0,0
TIKI,giay-dep-nam,69691320,"Giày sneaker cao cổ nam có xích",250000,250000,0,0
TIKI,giay-dep-nam,186392335,"GIÀY TÂY NAM GN683",490000,490000,0,0
TIKI,giay-dep-nam,160686512,"Dép Xỏ Ngón Unisex Waa. - KẸP FLIP-FLOPS",590000,590000,0,0
TIKI,giay-dep-nam,125261582,"Giày Sục Nam Cực Đẹp Đang Được Yêu Thích Nhất Hè 2021 - Mã l194",210000,210000,0,0
TIKI,giay-dep-nam,88917307,"Giày Converse Chuck Taylor 1970s ​Archive Paint Splatter 170804C",1900000,1900000,0,0
TIKI,giay-dep-nam,55953905,"Giày tây tăng chiều cao Trường Hải da bò cao cấp cao 6.5 cm trường Hải GTN0125",560000,645000,85000,13
TIKI,giay-dep-nam,133235025,"Dép Nam Xỏ ngón Thái Lan Quai Kẹp Gambol 41127",230000,230000,0,0
TIKI,giay-dep-nam,133236076,"Dép kẹp Nam Xỏ ngón Deblu Thái Lan M 7826",220000,220000,0,0
TIKI,giay-dep-nam,186149136,"Dép da cá sấu nam màu đen chính hãng Trường Hải may viền chắc chắn DN255",607000,699000,92000,13
TIKI,giay-dep-nam,183069382,"Dép xỏ ngón nam quai dù cao cấp KEEDO KD1808",390000,390000,0,0
TIKI,giay-dep-nam,136816245,"Giày Boot nam Doc.022 da bò Lucas Shoes",719000,719000,0,0
TIKI,giay-dep-nam,38410794,"Dây giày phản quang tròn Enito",100000,100000,0,0
TIKI,giay-dep-nam,69178650,"XI ĐÁNH BÓNG CÁC LOẠI GIẦY, DƯỠNG ÁO DA , SALONG DA",65000,65000,0,0
TIKI,giay-dep-nam,192725949,"Giày Nam 2022 Mẫu Mới, Giày Sneaker Nam Trắng Cam, Phong Cách Trẻ Trung Năng Động",1279000,1279000,0,0
TIKI,giay-dep-nam,81136033,"Giày Lười Nam TOMOYO Penny Loafer Star TMN05703",890000,2490000,1600000,64
TIKI,giay-dep-nam,167433371,"Dép nam cao su Thái Lan quai chữ H - Street 4.1",210000,210000,0,0
TIKI,giay-dep-nam,193642113,"Dép lê nam Loufu 6176, mềm, êm, bền, không sợ nước, size 40-44",123250,145000,21750,15
TIKI,giay-dep-nam,7976103,"Giày Mọi Nam Da Bò Sunpolo SU007DN",990000,990000,0,0
TIKI,giay-dep-nam,75284577,"Giày Lười Da Caro Phối Chuông Phong Cách Hàn",238500,238500,0,0
TIKI,giay-dep-nam,156215596,"DÉP NAM HAI QUAI NAM DA BÒ THẬT ĐÍNH KHUY CAO CẤP",500000,500000,0,0
TIKI,giay-dep-nam,12608305,"Siêu phẩm giày quý ông cao cấp - lex211",520000,520000,0,0
TIKI,giay-dep-nam,52886010,"Lót giày tăng chiều cao cho giày tây giày sneaker nửa bàn - Cao 2cm",88000,88000,0,0
TIKI,giay-dep-nam,7658306,"Giày Mọi Nam Da Bò FT8899",335352,335352,0,0
TIKI,giay-dep-nam,100869959,"Giày da sneaker cổ thấp da bò",500000,1000000,500000,50
TIKI,giay-dep-nam,12244913,"Khóa giày nam châm buộc giày tiện lợi thay thế dây cột",33000,33000,0,0
TIKI,giay-dep-nam,43865571,"Giày Da Nam Cao Cấp Phong Cách Trẻ Trung Năng Động Lịch lãm, Giày Tây Nam HS31",799000,799000,0,0
TIKI,giay-dep-nam,250135109,"Dép quai ngang đế cao nam và nữ chất liệu EVA chống thấm SIÊU HOT",139000,139000,0,0
TIKI,giay-dep-nam,14816261,"GIÀY DA BÒ CAO CẤP - LEX02",590000,590000,0,0
TIKI,giay-dep-nam,167939874,"Giày Sục Nam Da Bóng Đơn Giản  Mã L196",160000,160000,0,0
TIKI,giay-dep-nam,38147536,"Giày Tây Nam Da Bóng 20393",669000,669000,0,0
TIKI,giay-dep-nam,76274731,"Giày da nam, loại buộc dây mã BH-004",450000,900000,450000,50
TIKI,giay-dep-nam,108833595,"Độn đế tăng chiều cao 2cm một miếng dành cho nam",25000,25000,0,0
TIKI,giay-dep-nam,87120433,"Giày Sneaker Nam Tomoyo TMN05007",630000,1400000,770000,55
TIKI,giay-dep-nam,129350887,"Giày Sandal Vento Nam Quai Ngang dạo phố đi chơi đi học du lịch NB38",435000,435000,0,0
TIKI,giay-dep-nam,188687459,"Lót Giày Thể Thao Chất Liệu Cao Su Non Mềm Êm LGN2024b",45000,45000,0,0
TIKI,giay-dep-nam,196877315,"Giày cao cổ nam Sans100 giầy bốt vải fullbox độn đế cao tăng 6cm boot buộc dây học sinh viên thời trang trắng đen xanh",249999,249999,0,0
TIKI,giay-dep-nam,37832710,"Dép cao su Nam Nữ 4 quai chéo kiểu khe sanh",300000,300000,0,0
TIKI,giay-dep-nam,42849866,"Xi đánh giày YUPPIES Star Wax Shoe Polish khô 48ml - Neutral (Malaysia)",45000,45000,0,0
TIKI,giay-dep-nam,15519786,"Lót Quế Cho Giày Nam",27000,27000,0,0
TIKI,giay-dep-nam,196410076,"Dép tổ ong [Size 35-43] vật liệu EVA cao cấp siêu bền, siêu nhẹ, chống trơn trượt, FORM LỚN (Nên Lùi 1-2 Size)",63000,85000,22000,26
TIKI,giay-dep-nam,159881117,"Giày tây nam Derby Đông Hải da bò cao  cấp thiết kế cột dây thanh lịch đế cao su  3cm chắc chắn - G01A7",1590000,1590000,0,0
TIKI,giay-dep-nam,6278021,"Dép Sục Nam BIGGBEN Da Bò Thật Cao Cấp SB18",439000,500000,61000,12
TIKI,giay-dep-nam,177197091,"Dép thời trang phiên bản mới đế dày chống trơn trượt, dép đi trong nhà các cặp đôi mùa hè mã 095",95000,179000,84000,47
TIKI,giay-dep-nam,11656803,"Giày Tây Nam 007",405000,405000,0,0
TIKI,giay-dep-nam,52180308,"Dép Xỏ Ngón Nam BIGGBEN Da Bò Thật DK55",299000,400000,101000,25
TIKI,giay-dep-nam,166495968,"Dép Thái Lan quai xỏ ngón AG30",120000,120000,0,0
TIKI,giay-dep-nam,196215076,"Giày dép Sandals Vento ALPHA I Teen/Trẻ em màu Đỏ Rượu đi học/đi dã ngoại/đi chơi SD08001",365000,365000,0,0
TIKI,giay-dep-nam,13733812,"Giày Chelsea boot nam màu đen da lộn Revision 2 TFBKS8826 - Size",900000,900000,0,0
TIKI,giay-dep-nam,149532939,"Dép nam quai ngang da bò thật",239000,239000,0,0
TIKI,giay-dep-nam,44588788,"Dép tông nam_130240-đen",120000,120000,0,0
TIKI,giay-dep-nam,15186659,"Lót cho giày công sở tránh đau chân Spenco Arch Cushion Full M045",695000,695000,0,0
TIKI,giay-dep-nam,129944665,"Giày Sneaker Unisex Vans Classic Slip-On All Black - VN000EYEBKA",1450000,1450000,0,0
TIKI,giay-dep-nam,125244179,"Giày Lười Nam vân cá sấu chuông ️ Giày tây nam cao cấp ĐẾ CAO SU, BỀN ️ TẶNG LÓT GIÀY TĂNG CHIỀU CAO",210000,210000,0,0
TIKI,giay-dep-nam,184124070,"Dép Bít Mũi Nam HÀ NAM Da Bò Thật Cao Cấp GSB20134",498000,498000,0,0
TIKI,giay-dep-nam,133235415,"Dép nam quai ngang Thái Lan Adda 34G03",170000,170000,0,0
TIKI,giay-dep-nam,181562858,"Sandal Vento Quai Ngang Thời Trang NB37",325000,325000,0,0
TIKI,giay-dep-nam,105524408,"Giày Thể Thao Nam Sneaker Da Cao Cấp Phong Cách Hàn Quốc Kiểu Dáng Thời Trang G171",129000,129000,0,0
TIKI,giay-dep-nam,32933008,"Giày Lười Nam Công Sở Happyshoes Vân Cá Sấu  - HS470",450000,450000,0,0
TIKI,giay-dep-nam,9810794,"Giày Slip On Unisex Vans - VN000EYEBLK",1450000,1450000,0,0
TIKI,giay-dep-nam,101655684,"Giày da nam cao cấp buộc dây Sans136 giầy tây công sở đẹp size nhỏ 37 38 39 40 41 42 bigsize cỡ lớn 43 44 45 46 47 48",329000,329000,0,0
TIKI,giay-dep-nam,168069382,"Giày Sneaker nam phong cách New 2023",221000,245000,24000,10
TIKI,giay-dep-nam,171202816,"Dép kẹp nam Giavy đế cao KT8",310000,310000,0,0
TIKI,giay-dep-nam,35144640,"Máy sấy khô giày nhanh chóng, khử mùi hôi cao cấp",160208,160208,0,0
TIKI,giay-dep-nam,173239848,"️ Sandal quai hậu nam cho bé phong cách thời trang 20787",54000,114800,60800,53
TIKI,giay-dep-nam,4418185,"Giày Chelsea Boot Tathanium Nam Màu Vàng Nghệ Da Nubuck TFTNN8812",750000,750000,0,0
TIKI,giay-dep-nam,175797906,"Giày tây Giày lười Da Nam Bóng Đai Kim Loại Chống Gỉ Đế Cao Su Non Mã L195 Hàng Việt Nam ( Đen )",160000,160000,0,0
TIKI,giay-dep-nam,98039776,"Giày Thể Thao Nam Màu Ghi G23",94050,99000,4950,5
TIKI,giay-dep-nam,47541007,"Dây Giày Dẹt Đầu Bọc Nhựa Màu",75000,75000,0,0
TIKI,giay-dep-nam,171644838,"Lót Giày Thể Thao Êm Chân Thoáng Khí Chống Hôi Chân Khi Sử Dụng Giày Thường Xuyên -LG03",18000,18000,0,0
TIKI,giay-dep-nam,57935703,"Dép nam xỏ ngón - Dép kẹp nam da bò cao cấp mềm mại trường hải XN01235",208000,239000,31000,13
TIKI,giay-dep-nam,178010488,"Dép xỏ ngón bít mũi da bò 5TEN",400000,400000,0,0
TIKI,giay-dep-nam,15636841,"Giày Lười Nam Tomoyo da đế âm TMN05501",890000,2490000,1600000,64
TIKI,giay-dep-nam,186909262,"Giày sục nam, sục nam chữ H - Da Pu 100%, fulbox ( Mã Mã SN0101 - Ảnh và video chi tiết )",155000,155000,0,0
TIKI,giay-dep-nam,57484631,"Giày Lười Nam Vải Cao Cấp Lỗ Thoáng Khí Đế Cao Su NCL01",99000,99000,0,0
TIKI,giay-dep-nam,125780394,"Dép ông quai chéo",53500,53500,0,0
TIKI,giay-dep-nam,5207489,"Dép Nam BIGGBEN Da Bò Thật Cao Cấp DN33",279000,279000,0,0
TIKI,giay-dep-nam,191907702,"Giày lười nam - Slip on nam vải - A6256",350000,350000,0,0
TIKI,giay-dep-nam,4452745,"Giày sneaker thời trang - GN01",105000,105000,0,0
TIKI,giay-dep-nam,50588865,"Dép Nam Quai Ngang Da Bò Thật Cao Cấp DNA17",400000,400000,0,0
TIKI,giay-dep-nam,174506414,"Giày cổ cao nam 5 phân phong cách Hàn Quốc 20375",250000,250000,0,0
TIKI,giay-dep-nam,184697598,"Giày sneaker đế cao phối màu thời trang nam - LS145",350000,350000,0,0
TIKI,giay-dep-nam,55482698,"GIÀY TĂNG CHIỀU CAO - GIÀY CAO DÀNH CHO NAM GIỚI T&TRA T05 ĐEN TRƠN - CAO 6CM GIÀY ĐỘN NAM CAO VƯỢT TRỘI",750000,750000,0,0
TIKI,giay-dep-nam,174627998,"DÉP QUAI NGANG NAM THỜI TRANG - TRẺ TRUNG",169000,300000,131000,44
TIKI,giay-dep-nam,125342199,"Dép Sục, Dép Sapo Nam Da Bò SUNPOLO SPO293 Bền đẹp (Đen, Nâu)",490000,490000,0,0
TIKI,giay-dep-nam,15267929,"Giày Tây Nam Cột Dây  BiGGBEN Da Bò Thật GT120",499000,499000,0,0
TIKI,giay-dep-nam,6394619,"Dép Nam BIGGBEN Da Bò Thật DN55",349000,420000,71000,17
TIKI,giay-dep-nam,3647289,"Giày Lười Vải Nam - cv07",89000,89000,0,0
TIKI,giay-dep-nam,172628596,"Giày Bata Nam Nữ Chơi Thể Thao,Học Thể Dục Màu Rêu Quân Đội Mới",174000,190000,16000,8
TIKI,giay-dep-nam,43837112,"Xi đánh giày da lộn YUPPIES Newbuck Suede Renewer 75ml - Neutral (Malaysia)",70000,70000,0,0
TIKI,giay-dep-nam,194025841,"Dép da cá sấu có móng siêu đẹp",900000,1550000,650000,42
TIKI,giay-dep-nam,163567961,"COMBO Bọt vệ sinh giày đa năng, sneaker + tặng kèm bản chải đánh giày",120000,120000,0,0
TIKI,giay-dep-nam,179060030,"Sandal nhựa cross nam exprestion quai dán màu nâu êm, nhẹ, thoáng, hàng xịn, full box",409000,409000,0,0
TIKI,giay-dep-nam,74346405,"12689 Giày martin da thật nam phong cách Châu Âu - Mã 12689",859000,1599000,740000,46
TIKI,giay-dep-nam,124328790,"HP9129-30-31-32-33 - Xi nước đánh bóng Huy Hoàng màu đen, nâu, vàng bò, trắng, không màu",99000,99000,0,0
TIKI,giay-dep-nam,96596898," TẤT VỚ DORAEMON DORAEMON HOUSE",30000,30000,0,0
TIKI,giay-dep-nam,66988964,"Dép nam thời trang 2020 in hình tam giác",199000,299000,100000,33
TIKI,giay-dep-nam,113045759,"Giày Lười Vải Nam CV07",89000,89000,0,0
TIKI,giay-dep-nam,137695901,"Dép Xỏ Ngón Nam TiTi ĐÔ Da Bò Thật Cao Cấp DNA2142a",380000,380000,0,0
TIKI,giay-dep-nam,212967073,"Dép nam Aldo POOLSLIDE",1450000,1450000,0,0
TIKI,giay-dep-nam,222677087,"CONVERSE - Giày sneakers cổ thấp unisex Run Star Motion 172896C",2600000,2600000,0,0
TIKI,giay-dep-nam,107151129,"Dép quai ngang nam năng động hình chữ H siêu bền đẹp mã DEP06LE",159000,299000,140000,47
TIKI,giay-dep-nam,185146153,"Giày lười vải lưới nam thoáng khí mùa hè - Giày lười vải nam trung niên",245000,245000,0,0
TIKI,giay-dep-nam,55503251,"GIÀY TĂNG CHIỀU CAO  GIÀY CAO DÀNH CHO NAM GIỚI T&TRA T63 MỌI-  CAO 5CM GIÀY ĐỘN NAM CAO VƯỢT TRỘI",750000,750000,0,0
TIKI,giay-dep-nam,126257693,"Đón gót giày gỗ tự nhiên nguyên khối - Dài 22cm (DGH906) Cho giày Nam & Nữ",31350,33000,1650,5
TIKI,giay-dep-nam,115769177,"Giày Lười Nam Công Sở Cao Cấp - Da LÌ - Đế Khâu Chắc Chắn - Mã X084",199000,199000,0,0
TIKI,giay-dep-nam,181785682,"GIÀY DA NAM X26 MÃ G20-07",480000,480000,0,0
TIKI,giay-dep-nam,67110433,"Giày lười nam da bò thật Happyshoes, đế khâu chất liệu cao su ép nhiệt chắc chắn có rãnh chống trượt an toàn -HS66",350000,350000,0,0
TIKI,giay-dep-nam,37497055,"Giầy thể thao nam_0014",95125,95125,0,0
TIKI,giay-dep-nam,49103569,"Giày da-Valentino Creations-VAB-302-COF",6190000,6190000,0,0
TIKI,giay-dep-nam,38410829,"Bình xịt nano chống nước, chống bụi bẩn Enito Nano Repellent 250ml",390000,390000,0,0
TIKI,giay-dep-nam,22169041,"Dép nam da bò quai đan ngang Trường Hải màu đen thời trang cao cấp QN165",229000,299000,70000,23
TIKI,giay-dep-nam,164321515,"Dép nam hai quai ngang cao cấp KEEDO BH00404 da bò thật",750000,750000,0,0
TIKI,giay-dep-nam,6277121,"Dép Nam Bít Mũi  BIGGBEN Da Bò Thật DN49",399000,450000,51000,11
TIKI,giay-dep-nam,49103889,"Dép da-Valentino Creations-VAB-300-BN",3790000,3790000,0,0
TIKI,giay-dep-nam,42157746,"Giày Da Nam Cao Cấp Italia Germano Bellesi GB 220",10550000,10550000,0,0
TIKI,giay-dep-nam,27769106,"Dép Nam BIGGBEN Da Bò Thật Cao Cấp DN211",299000,400000,101000,25
TIKI,giay-dep-nam,14272046,"Sục nam da bò Trường Hải màu nâu may đế chắc chắn S132",289000,329000,40000,12
TIKI,giay-dep-nam,122712308,"Giày Lười Sục Nam Da Bò Chuẩn, Có bảo hành nổ da, bong keo , gãy đế, phom dáng siêu đẹp GD18",299000,299000,0,0
TIKI,giay-dep-nam,34612145,"Combo 10 cặp lót giày êm chân size nam - Trắng",25000,25000,0,0
TIKI,giay-dep-nam,15319346,"Sáp làm mềm và chống thấm nước - Saphir Dubbin Grease BDC 100ml",295000,295000,0,0
TIKI,giay-dep-nam,95854971,"Giày thời trang nam- Mã GIAY.VUAONG",299000,489000,190000,39
TIKI,giay-dep-nam,72557976,"Miếng Lót Giày Êm Chân Thể Thao Thoáng Khí Thấm Hút Mồ Hôi Size Nam 41-45",128000,128000,0,0
TIKI,giay-dep-nam,113293693,"Dép Nam Xỏ Ngón HÀ NAM Da Bò Thật Cao Cấp DNA2099",378000,378000,0,0
TIKI,giay-dep-nam,262984097,"Dép nam đế may sẵn quai ngang cao cấp KEEDO KD0607",480000,480000,0,0
TIKI,giay-dep-nam,50139122,"Giày Sandal Nam thủ công da bò cao cấp TOMOYO TMS09402",540000,1200000,660000,55
TIKI,giay-dep-nam,2618687,"Dép Rọ Nam Da Bò Cao Cấp SUNPOLO SUA20D",580000,580000,0,0
TIKI,giay-dep-nam,119718716,"Giày Tây Nam Công Sở TiTi ĐÔ Da Bò Thật Cao Cấp GT2025a",550000,550000,0,0
TIKI,giay-dep-nam,76108478,"Giày cao cổ vải nam G505",120000,120000,0,0
TIKI,giay-dep-nam,68663120,"Dép sục nam da bò  Trường Hải màu đen đế cao su không trơn hàng may chắc chắn thời trang cao cấp BMN0201",329000,379000,50000,13
TIKI,giay-dep-nam,9810665,"Giày Sneaker Unisex Authentic Vans - VN000EE3RED",1450000,1450000,0,0
TIKI,giay-dep-nam,164041369,"giày chealse boot nam cao cổ - giày bốt nam cổ cao da lộn - Chealsea Boot Da Lộn Cao Cổ Chất Đẹp",450000,450000,0,0
TIKI,giay-dep-nam,21929073,"Dép Kẹp Nam Hè",150000,150000,0,0
TIKI,may-anh,242618146,"Camera IMOU wifi A22EP 1080P 2M xoay 360 độ đàm thoại 2 chiều - Hàng chính hãng",599000,900000,301000,33
TIKI,may-anh,187623126,"Combo Camera WiFi TP-Link Tapo C200 2MP và Thẻ Nhớ MicroSD Kioxia/Dahua/Lexar 32Gb/64Gb/128Gb - Hàng Chính Hãng",1199000,1199000,0,0
TIKI,may-anh,74500335,"Camera IP Wifi TP-Link Tapo C200 Full HD 1080P Giám sát An Ninh - Hàng Chính Hãng",878000,878000,0,0
TIKI,may-anh,106641569,"Camera Wifi Trong Nhà Yoosee 3.0 Full HD, 3 Râu, Xoay 360 độ , Đàm Thoại 2 Chiều, Cảm Biến Báo Động – Hàng nhập khẩu",300000,399000,99000,25
TIKI,may-anh,74500335,"Camera IP Wifi TP-Link Tapo C200 Full HD 1080P Giám sát An Ninh - Hàng Chính Hãng",419000,419000,0,0
TIKI,may-anh,174896487,"Camera WiFi Ngoài Trời TP-Link Tapo C320WS Độ Phân Giải 2K QHD - Hàng Chính Hãng",999000,1899000,900000,47
TIKI,may-anh,41319582,"Camera IP Wifi Trong Nhà EZVIZ C6N 1080p - Hàng Chính Hãng",405000,959000,554000,58
TIKI,may-anh,173570812,"Camera WiFi Thông Minh TP-Link Tapo C100 An Ninh Cho Gia Đình - Hàng Chính Hãng",439000,790000,351000,44
TIKI,may-anh,225272503,"Máy dò camera loại cao cấp chính xác 100%. Bảo hành 12 tháng",150000,150000,0,0
TIKI,may-anh,84866683,"Camera IP Wifi Trong Nhà Ezviz Mini CS-C1C-B 1080p - Hàng Chính Hãng",415000,990000,575000,58
TIKI,may-anh,23839834," Kính hiển vi  bỏ túi đa năng MICROBRITE PLUS MM-300 (Phóng đại 60-120x) - Hàng chính hãng",544000,544000,0,0
TIKI,may-anh,187637105,"Combo Camera WiFi Ngoài Trời TP-Link Tapo C310 3MP và Thẻ Nhớ MicroSD Kioxia/ Dahua/ Lexar 32Gb/64Gb/128Gb/256Gb - Hàng Chính Hãng",959000,1679000,720000,43
TIKI,may-anh,270214258,"Camera Thông Minh Xiaomi C200 / C300 / C400 / AW200 / AW300 Bản Quốc Tế - Hàng Chính Hãng FPT",532000,702900,170900,24
TIKI,may-anh,381162,"Film Instax Mini - Giấy in ảnh Fujifilm cho máy chụp ảnh lấy liền Instax Mini - Hộp 20 tấm - Hàng Chính Hãng",390000,480000,90000,19
TIKI,may-anh,107356974,"Camera Wifi TP-Link Tapo C210 Độ Phân Giải 3MP Lưu trữ 256GB Giám Sát An Ninh - Hàng Chính Hãng",589000,1118000,529000,47
TIKI,may-anh,46462092,"Camera IP Wifi Trong Nhà EZVIZ C6N 1080p (CS-C6N) - Hàng Chính Hãng",405000,891000,486000,55
TIKI,may-anh,23838887," Kính hiển vi bỏ túi cao cấp Carson MicroFlip MP-250 (Phóng đại 100x -250x) có đèn tia cực tím UV kiểm tra tiền - Hàng chính hãng",900000,900000,0,0
TIKI,may-anh,5899427,"Tủ Chống Ẩm Andbon AB-30C (30 lít) - Hàng Nhập Khẩu",1074999,1074999,0,0
TIKI,may-anh,193717163,"Thẻ nhớ SDXC SanDisk Extreme Pro SDSDXXU-064G U3 V30 64GB 200MB/s New 2022 - Hàng Nhập Khẩu",294000,299000,5000,2
TIKI,may-anh,58405493,"Kính hiển vi sinh học soi tinh trùng, ấu trùng, tế bào Barska AY13286 (40x-640x) - Hàng chính hãng",3619000,3619000,0,0
TIKI,may-anh,7546725,"Dây cáp kết nối máy ảnh Canon với máy tính",49000,49000,0,0
TIKI,may-anh,187623126,"Combo Camera WiFi TP-Link Tapo C200 2MP và Thẻ Nhớ MicroSD Kioxia/Dahua/Lexar 32Gb/64Gb/128Gb - Hàng Chính Hãng",1178000,1178000,0,0
TIKI,may-anh,75664666,"Camera Xiaomi 360 Imilab Home Security Chất Lượng Cao 1296x2304, Đàm Thoại 2 Chiều, Chế Độ Hồng Ngoài Ban Đêm, Chế Độ Chống Trộm - Hàng chính hãng",799000,899000,100000,11
TIKI,may-anh,187642259,"Combo Camera WiFi Ngoài Trời TP-Link Tapo C320WS 4MP và Thẻ Nhớ MicroSD Kioxia/Lexar 32Gb/64Gb/128Gb - Hàng Chính Hãng",1099000,1978000,879000,44
TIKI,may-anh,74610299,"Chân Đế Camera Xoay 360 độ, chuyên dùng cho Camera Ezviz C6N Camera Imou A22Ep Camera Kbone H21PW",6600,6600,0,0
TIKI,may-anh,242618146,"Camera IMOU wifi A22EP 1080P 2M xoay 360 độ đàm thoại 2 chiều - Hàng chính hãng",475000,475000,0,0
TIKI,may-anh,114964724,"Bộ dụng cụ khám phá kính hiển vi Barska AY12938 (dành cho trẻ em) - Hàng chính hãng",1887000,1887000,0,0
TIKI,may-anh,72556060,"Camera IP Wifi Ngoài Trời Imou F22P Bullet 2C Full HD 1080P Tặng Phíc Cắm Âm - Hàng Chính Hãng",599500,599500,0,0
TIKI,may-anh,106641569,"Camera Wifi Trong Nhà Yoosee 3.0 Full HD, 3 Râu, Xoay 360 độ , Đàm Thoại 2 Chiều, Cảm Biến Báo Động – Hàng nhập khẩu",240000,240000,0,0
TIKI,may-anh,23838438," Kính hiển vi bỏ túi Carson MicroMini MM-280B 20x (có đèn LED, đèn tia cực tím UV kiểm tra tiền) - Hàng chính hãng",714000,714000,0,0
TIKI,may-anh,26434415,"Camera IP WIFI IMOU RANGER 2 IPC - A22EP Full HD 1080P - Hàng Chính Hãng",520000,665000,145000,22
TIKI,may-anh,24766023,"Bộ Sạc Pin AA AAA + 4 Pin AA 1200mAh Doublepow (Hàng nhập khẩu)",79800,79800,0,0
TIKI,may-anh,127834480,"Camera Wifi trong nhà EZVIZ C6N 4MP, Hàng Chính Hãng",649000,649000,0,0
TIKI,may-anh,142796515,"Camera IMOU Ranger 2, Camera Xoay 360, AI Phát hiện người, màng trập riêng tư 2MP/4MP - Hàng Chính Hãng",450000,450000,0,0
TIKI,may-anh,32923633,"Vỉ 5 Viên Pin CR2032 Panasonic ( CR-2032/5BE x 1 Vỉ ) Lithium 3 V",100000,100000,0,0
TIKI,may-anh,47868431,"Camera Wi-Fi TP-Link Tapo C200 1080P (2MP) An Ninh Gia Đình Có Thể Điều Chỉnh Hướng - Hàng Chính Hãng",595000,595000,0,0
TIKI,may-anh,103995541,"Combo Camera IP Wifi EZVIZ C6N 2MP (1080P) và Thẻ Nhớ 32GB - Hàng Chính Hãng",399000,399000,0,0
TIKI,may-anh,194140440,"Thẻ nhớ SDXC SanDisk Extreme Pro SDSDXXD-128G U3 V30 128GB 200MB/s New 2022 - Hàng Nhập Khẩu",505000,505000,0,0
TIKI,may-anh,56021195,"Pin CR2 Panasonic Lithium Photo Power 3V chính hãng vỉ 1 viên",109000,109000,0,0
TIKI,may-anh,85764360,"Camera Wifi TP-Link Tapo C310 3MP An Ninh Ngoài Trời - Hàng Chính Hãng",859000,1499000,640000,43
TIKI,may-anh,162227436,"Camera IP Wifi Deli Full HD 1080P 360 Độ Đàm Thoại 2 Chiều - An Ninh Gia Đình, Văn Phòng - Hàng Chính Hãng - ES102",898200,898200,0,0
TIKI,may-anh,102125538,"Camera IP Wifi Tenda CP3 1080P 360°-Có Báo Động - Hàng Chính Hãng",370000,370000,0,0
TIKI,may-anh,174896487,"Camera WiFi Ngoài Trời TP-Link Tapo C320WS Độ Phân Giải 2K QHD - Hàng Chính Hãng",999000,1899000,900000,47
TIKI,may-anh,111466126,"Thẻ nhớ 64gb camera Hikvision-Hàng Chính Hãng",99000,99000,0,0
TIKI,may-anh,153998709,"Thẻ nhớ IMOU chuyên dụng cho Camera 95 MB/s Class 10 32GB/64GB - Hàng Chính Hãng",125000,125000,0,0
TIKI,may-anh,195863820,"Thẻ nhớ SDXC SanDisk Extreme U3 V30 64GB 170MB/s SDSDXV2-064G (New 2022) - Hàng Nhập Khẩu",255000,255000,0,0
TIKI,may-anh,5452277,"Bộ giá đỡ điện thoại, máy ảnh 3 chân tripod",46998,46998,0,0
TIKI,may-anh,263987622,"Camera Wifi TP-Link Tapo C200 / C210 Smart IR Full HD 1080P - Hàng Chính Hãng",445000,445000,0,0
TIKI,may-anh,106661426,"Camera wifi gia đình IMOU Ranger 2 A42P 4MP chính hãng xoay 360 độ , đàm thoại hai chiều , nhận thông báo khi phát hiện chuyển động và tiếng động lạ - Hàng Chính Hãng",589900,589900,0,0
TIKI,may-anh,183689560,"Camera IP Wifi Deli 360 Độ Full HD 1080P Đàm Thoại 2 Chiều Hồng Ngoại Đêm - An Ninh Gia Đình, Văn Phòng - Hàng Chính Hãng",898200,898200,0,0
TIKI,may-anh,112287864,"Chân đế treo tường, hộp kỹ thuật Cho Camera Dome, Camera Ezviz C6N, Camera C6CN, Camera C4W, Nhựa Tốt",7300,7300,0,0
TIKI,may-anh,154259057,"Camera IP WIFI IMOU RANGER A2 (A22EP-D-V3) Full HD 1080P, phiên bản 2022- Hàng Chính Hãng",450000,450000,0,0
TIKI,may-anh,116903572,"Camera Wifi Yoosee 4.0 Mpx Full HD, Dòng Ngoài Trời Xoay 360° 4 râu C12 Xem Đêm Có Màu-Đàm Thoại 2 Chiều-Phát Hiện Chuyển Động Chống Trộm-Hàng Nhập Khẩu",411000,629000,218000,35
TIKI,may-anh,101760232,"Pin dùng cho máy ảnh Canon, Hàng nhập khẩu",128999,128999,0,0
TIKI,may-anh,134840290," Dây Đeo Ngực Cho Điện Thoại Làm Camera Hành Trình Để Quay Phim",29200,29200,0,0
TIKI,may-anh,187623126,"Combo Camera WiFi TP-Link Tapo C200 2MP và Thẻ Nhớ MicroSD Kioxia/Dahua/Lexar 32Gb/64Gb/128Gb - Hàng Chính Hãng",1199000,1199000,0,0
TIKI,may-anh,74245919,"Kính hiển vi soi tinh trùng Carson MS-040 (40-400x) - Hàng chính hãng",4550000,4550000,0,0
TIKI,may-anh,74500335,"Camera IP Wifi TP-Link Tapo C200 Full HD 1080P Giám sát An Ninh - Hàng Chính Hãng",878000,878000,0,0
TIKI,may-anh,50569192,"Gói hút ẩm Silicagel loại 5gram (1kg có 200 gói nhỏ kích thước 5x5,5cm)",99000,99000,0,0
TIKI,may-anh,23838438," Kính hiển vi bỏ túi Carson MicroMini MM-280B 20x (có đèn LED, đèn tia cực tím UV kiểm tra tiền) - Hàng chính hãng",714000,714000,0,0
TIKI,may-anh,18005129,"Bộ Phụ Kiện 50 in 1 cho GOPRO Hộp Đựng Cao Cấp Tặng Kèm Phao Nổi - Black",339000,339000,0,0
TIKI,may-anh,125161875,"Gói hút ẩm 1000 Gram  hạt hút ẩm Silica gel quy cách 10/20/50/100/200/500/1000 Gram hút ẩm cho Thưc phẩm Quần áo Giày dép Máy ảnh Hoa Khô",69000,69000,0,0
TIKI,may-anh,122576548,"Gói Hút Ẩm 500G quy cách 10/20/50/100/200/500gram Silicagel - hạt hút ẩm quần áo giày dép máy ảnh",22000,22000,0,0
TIKI,may-anh,71043508,"Vỏ Chống Nước Telesin Cho GoPro Hero 9  - Case  Action Camera Bảo Vệ Máy Quay Hành Trình GoPro (Hàng Chính Hãng)",312000,390000,78000,20
TIKI,may-anh,242618146,"Camera IMOU wifi A22EP 1080P 2M xoay 360 độ đàm thoại 2 chiều - Hàng chính hãng",599000,900000,301000,33
TIKI,may-anh,97681606,"Ống nhòm Fomei 10x50 ZCF BEATER FMC(chống nước, chống sương mù) - Hàng chính hãng",6160000,6160000,0,0
TIKI,may-anh,111483922,"Chân Đế Dome cho camera Ezviz, Imou, Yoosee - Hàng Chính Hãng",7900,7900,0,0
TIKI,may-anh,24210643,"Ống nhòm ngày cao cấp Carson RD-826 (chống nước) - Hàng chính hãng",4390000,4390000,0,0
TIKI,may-anh,68460397," Ống nhòm 4x30 cho bé - màu ngẫu nhiên",42000,42000,0,0
TIKI,may-anh,7527307,"Ống Nhòm Quân Sự Barska Deep Sea 7x50 (chống nước,  mờ sương, có la bàn,vạch ly giác) - Hàng chính hãng",8690000,8690000,0,0
TIKI,may-anh,7017509,"Gói Hút Ẩm (Silica Gel Desiccant) 10 Gram/túi (1kg/bọc) ",99000,99000,0,0
TIKI,may-anh,251943522,"Kính hiển vi cao cấp soi kim cương Terino DIA-1000XHD (50X-1000X) - Hàng chính hãng",8360000,8360000,0,0
TIKI,may-anh,7389203,"Ống Nhòm Barska Lucid 8x21mm - Hàng chính hãng",858000,858000,0,0
TIKI,may-anh,10725778,"Sạc Pin Máy Ảnh Canon LP-E6 LPE6, Sạc Pin Máy Ảnh Canon 5D Mark II III IV 70D 5Ds 6D 5Ds 80D 7D 60D 5Ds R",99000,99000,0,0
TIKI,may-anh,242618399,"Camera không dây EZVIZ TY1 siêu nét chống ngược sáng - Hàng chính hãng",485000,860000,375000,44
TIKI,may-anh,167333992,"Gimbal chống rung Moza Nano SE - Tay cầm dành cho điện thoại nhỏ gọn, siêu nhẹ chống rung trục cuộn ổn định - Hàng nhập khẩu",809000,900000,91000,10
TIKI,may-anh,135319386,"Combo Camera Wi-Fi EZVIZ TY1 FHD 1080p, Trong Nhà, Kèm Thẻ Nhớ  32GB/64GB - Hàng Chính Hãng",599000,700000,101000,14
TIKI,may-anh,46729607,"Tủ chống ẩm AB-30C",1049999,1049999,0,0
TIKI,may-anh,74381816,"Dock Sạc 3 Pin Cho GoPro 9 - Bộ Sạc Máy Quay GoPro Hero 9 Có Nắp Đậy (Hàng Chính Hãng)",280000,350000,70000,20
TIKI,may-anh,177770713,"Camera EZVIZ C8PF 2MP, WI-FI , Ngoài Trời 360 Độ, Đàm Thoại Hai Chiều, AI - Hàng Chính Hãng",1420000,1420000,0,0
TIKI,may-anh,50569192,"Gói hút ẩm Silicagel loại 5gram (1kg có 200 gói nhỏ kích thước 5x5,5cm)",89000,89000,0,0
TIKI,may-anh,49227944,"Bộ Sạc PIN ENELOOP AA/AAA Kèm 4 Pin Sạc Made In Japan ( Kèm Hộp Đựng Pin Sạc ) - Hàng Chính Hãng",620000,620000,0,0
TIKI,may-anh,7253209,"Lens cap 77mm nắp đậy bảo vệ ống kính máy ảnh phi 77mm",59000,59000,0,0
TIKI,may-anh,57315763,"Ống nhòm một mắt chống nước Carson WM-025 BLACKWAVE - Hàng chính hãng",1630000,1630000,0,0
TIKI,may-anh,26305965,"Camera IP Wifi IMOU IPC C22EP FullHD 1080P - Hàng Chính Hãng",397800,397800,0,0
TIKI,may-anh,145180531,"Camera IMOU Bullet 2/2C/2E 2MP ( IPC-F22P), Camera Ngoài Trời, Chống nước IP67, Chuẩn nén H265, Theo dõi chuyển động, Quay Màu ban đêm - Hãng Chính Hãng",598000,598000,0,0
TIKI,may-anh,73312877,"Vỏ Chống Nước Cho Máy Gopro Hero 9 Black",399000,399000,0,0
TIKI,may-anh,15266469,"Combo hộp chống ẩm máy ảnh và ẩm kế điện tử, 100gram hạt hút ẩm xanh - dung tích 4 lít (tặng mút xốp lót hộp)",150000,150000,0,0
TIKI,may-anh,7586151,"Kính Thiên Văn Barska Starwatcher 300 Power - Hàng chính hãng",4114000,4114000,0,0
TIKI,may-anh,109088187,"Nguồn adapter 12V 2A Actiontec",39000,39000,0,0
TIKI,may-anh,181976961,"Camera wifi Yoosee 4 Râu 17 Led FULL HD 6.0Mpx, Xoay 360° Chuyên Dụng Ngoài Trời - Hàng Nhập Khẩu",429000,680000,251000,37
TIKI,may-anh,242618602,"Camera wifi Ezviz C6N không dây xoay 360 độ đàm thoại 2 chiều - Hàng chính hãng",430000,430000,0,0
TIKI,may-anh,132783163,"Camera Wifi Yoosee 4.0 Mpx Full HD, Dòng Ngoài Trời Xoay 360° 4 râu C12 Xem Đêm Có Màu-Đàm Thoại 2 Chiều-Phát Hiện Chuyển Động Chống Trộm-Hàng Nhập Khẩu",530000,620000,90000,15
TIKI,may-anh,198696909,"Camera Wifi không dây SHUJI UH620D - Camera bóng đèn - Ban đêm có màu - Báo động khi có trộm đột nhập - 4.0MP cho hình ảnh đẹp gấp đôi Full HD1080 - Hàng chính hãng",520000,520000,0,0
TIKI,may-anh,14144756,"Gói hạt hút ẩm clays sử dụng đa năng (có dây treo) 1kg ",44000,44000,0,0
TIKI,may-anh,107611553,"Sạc thay thế dành cho sạc máy ảnh Canon",129999,129999,0,0
TIKI,may-anh,28326998,"Bộ Sạc Nhanh Panasonic  BQ CC55 (Smart Quick Charger ) Kèm 4 Pin Eneloop AA BK3MCCE 2000 mah Hàng Chính Hãng",800000,800000,0,0
TIKI,may-anh,100103994,"VIETMAP C61 PRO - Camera hành trình 4K Cảnh Báo Giao Thông Giọng Nói - Nâng cấp âm thanh - HÀNG CHÍNH HÃNG",3440000,3440000,0,0
TIKI,may-anh,116987925,"Camera ip Yoosee Wifi 3 Râu 8 Led Có Màu Ban Đêm, xoay 360 độ, Bản Chuẩn 1080Pixel - Hàng Nhập Khẩu",230000,230000,0,0
TIKI,may-anh,122569956,"Hạt hút ẩm 100/200/500GR Silicagel xanh gói hút ẩm Máy ảnh linh kiện điện  Phòng Ngủ  Quần áo Giày dép",13000,13000,0,0
TIKI,may-anh,159482551,"Pin sạc Kingma Ver 2 cho Sony NP-FZ100, Hàng chính hãng",269999,269999,0,0
TIKI,may-anh,13406602,"Dây đeo máy ảnh chống mỏi canvas cho máy ảnh - Q00311",55000,55000,0,0
TIKI,may-anh,142217257,"Camera Imou C22SP - Chip Hình Ảnh Thế Hệ Mới 2022 - Đàm Thoại 2 Chiều - Full HD 1080 - Góc Siêu Rộng - Hàng Chính Hãng",405000,405000,0,0
TIKI,may-anh,121080291,"Gói hút ẩm đa năng 300 Gram hạt hút ẩm cho Thực phẩm Quần áo Giày dép Điện thoại Máy ảnh NU DRY",22000,22000,0,0
TIKI,may-anh,194140778,"Thẻ nhớ SDXC SanDisk Extreme Pro SDSDXXD-256G U3 V30 256GB 200MB/s New 2022 - Hàng Nhập Khẩu",1127000,1150000,23000,2
TIKI,may-anh,6479301,"Ống Nhòm Ngày Fomei 8-24x50 ZCF New - Hàng chính hãng",4199000,4199000,0,0
TIKI,may-anh,251931788,"Kính hiển vi phân tích, soi mạch máu cao cấp Terino TX-10 (10X-800X) - Hàng chính hãng",13860000,13860000,0,0
TIKI,may-anh,114861437,"Camera ip wifi xoay 360 độ Orikon - Hàng chính hãng",390000,390000,0,0
TIKI,may-anh,90835786,"Tủ đựng đầu ghi camera, các bộ switch nhà mạng, các bo mạch điện, điện tử...",179000,179000,0,0
TIKI,may-anh,2566029,"Hắt Sáng 5 Trong 1 Hongkong Electronic 110cm (Trắng) - Hàng Nhập Khẩu",207000,207000,0,0
TIKI,may-anh,199631218,"Túi đựng máy ảnh dây rút nhỏ gọn chống thấm nước có dây đeo chéo",200000,200000,0,0
TIKI,may-anh,110255755,"Chân máy quay Weifeng WF-717, Hàng chính hãng",2249999,2249999,0,0
TIKI,may-anh,242644479,"Camera WIFI ngoài trời IMOU S21FP, S41FP có màu ban đêm, xoay 360 độ - Hàng chính hãng",875000,875000,0,0
TIKI,may-anh,173570812,"Camera WiFi Thông Minh TP-Link Tapo C100 An Ninh Cho Gia Đình - Hàng Chính Hãng",439000,790000,351000,44
TIKI,may-anh,12321426,"khăn da cừu lau ống kính máy ảnh",45000,45000,0,0
TIKI,may-anh,461038,"Thẻ Nhớ SD SanDisk Ultra Class 10 32GB - 48MB/s - Hàng Chính Hãng",169000,189000,20000,11
TIKI,may-anh,171320328,"Camera Wifi Ngoài trời EZVIZ C8W 4MP - Hàng Chính Hãng",1199000,2500000,1301000,52
TIKI,may-anh,19583872,"Tripod giá đỡ 3 chân mini đa năng hỗ trợ tay cầm, để bàn cho điện thoại, gopro",55000,55000,0,0
TIKI,may-anh,2419567,"Tản sáng Omni bounce cho flash speedlite ",49999,49999,0,0
TIKI,may-anh,153860641,"Camera IMOU Ranger 2C, Camera Xoay 360, AI Phát hiện người, màng trập riêng tư 2MP/4MP - Hàng Chính Hãng",450000,450000,0,0
TIKI,may-anh,194139957,"Thẻ nhớ SDHC SanDisk Extreme Pro SDSDXXO-032G U3 V30 32GB 100MB/s New 2022 - Hàng Nhập Khẩu",241000,245000,4000,2
TIKI,may-anh,44801520,"Tủ Chống Ẩm Andbon AB-21C (20 Lít) - Hàng Chính Hãng",949999,949999,0,0
TIKI,may-anh,56416440,"Hộp Sạc Pin Telesin Cho GoPro Hero 5 6 7 8 / Dock Sạc Pin Cho GoPro - Hàng Nhập Khẩu",371040,463800,92760,20
TIKI,may-anh,13335028,"Ống nhòm đôi cao cấp 3D 30x60 (màu đen)",88000,88000,0,0
TIKI,may-anh,242643936,"Camera wifi IP 2M IMOU C22EP chống trộm, chống ngược sáng - Hàng chính hãng",489000,700000,211000,30
TIKI,may-anh,50014370,"Ống nhòm một mắt zoom 7x - 21x Carson ZM-721 - Hàng chính hãng",1890000,1890000,0,0
TIKI,may-anh,13407305,"Dây đeo  chống mỏi thổ cẩm cho máy ảnh - Q00121",79000,79000,0,0
TIKI,may-anh,7176411,"Chân máy ảnh Tripod 3110 tặng Giá kẹp điện thoại, Remote bluetooth và Túi đựng",61900,61900,0,0
TIKI,may-anh,2596899,"Túi Máy Ảnh Canvas Photoman For Mirroless Sony Nex, Sony A7, Fujifilm",134999,134999,0,0
TIKI,may-anh,20712070,"Pin CR123A Panasonic_Hàng Chính Hãng",100000,100000,0,0
TIKI,may-anh,99428673,"Ống Nhòm Đo Khoảng Cách, Tốc Độ Bằng Laser Từ Xa Chống Nước IP54 SNDWAY SW-1000A - Hàng Chính Hãng",2215000,2215000,0,0
TIKI,may-anh,4755347,"Ẩm Kế Điện Tử Mini - Hàng Nhập Khẩu",30000,30000,0,0
TIKI,may-anh,101305713,"Hạt hút ẩm xanh 100g (túi vải)",13400,13400,0,0
TIKI,may-anh,148713428,"Camera Yoosee Trong Nhà Thế Hệ Mới Ban Đêm Có Màu, Đàm Thoại Hai Chiều Full HD 1080P-Hàng Nhập Khẩu",219000,219000,0,0
TIKI,may-anh,82983828,"Filter Kính lọc UV Marumi 37-82cm, Chính hãng",239999,239999,0,0
TIKI,may-anh,10086966,"Hộp studio chụp sản phẩm 40cm tích hợp đèn Led",196000,245000,49000,20
TIKI,may-anh,180239300,"Ống Nhòm 1 Mắt 10-30x25mm Chuyên Nghiệp",261250,275000,13750,5
TIKI,may-anh,50570089,"Gói hút ẩm Silicagel loại 10 gram (1kg có 100 gói nhỏ kích thước 5x6,5cm)",89000,89000,0,0
TIKI,may-anh,5849439,"Chân Máy Ảnh Tripod Yunteng VCT - 668 - Hàng Nhập Khẩu",399999,399999,0,0
TIKI,may-anh,104070115,"Đầu đọc thẻ nhớ SSK cho máy ảnh - Hàng chính hãng",155000,155000,0,0
TIKI,may-anh,40757037,"Pin LP-E8 dùng cho máy ảnh Canon 550D 600D 650D 700D - Hàng nhập khẩu",199999,199999,0,0
TIKI,may-anh,2566045,"Dây Đeo Ngực Cho Gopro Yicamera SJcam (Đen) - Hàng Nhập Khẩu",84900,84900,0,0
TIKI,may-anh,4688897,"Chân Máy Ảnh Tripod Weifeng 3520 - Hàng Nhập Khẩu",224999,224999,0,0
TIKI,may-anh,54478250,"Camera Wifi thông minh EZVIZ C6N 1080P (CS-C6N-A0-1C2WFR) - TẶNG KÈM THẺ 32GB - HÀNG CHÍNH HÃNG",487000,487000,0,0
TIKI,may-anh,193509839,"Film Instax Mini - Giấy in ảnh cho máy chụp ảnh lấy liền Instax Mini - Hàng Chính Hãng",390000,525000,135000,26
TIKI,may-anh,53089354,"Bộ 10 Adapter - Nguồn - 12V-2A Actiontec",345000,345000,0,0
TIKI,may-anh,196288508,"Camera Wifi không dây SHUJI UH612D - Xoay 360 độ - Báo động khi có trộm - Độ phân giải 4.0mp cho hình ảnh nét đẹp gấp đôi Full HD 1080- Hàng chính hãng",500000,500000,0,0
TIKI,may-anh,117076592,"Camera IP Wifi Trong Nhà EZVIZ C6N 4MP 2K - Hàng Chính Hãng",690000,839000,149000,18
TIKI,may-anh,179965482,"Tủ chống ẩm máy ảnh 50 Lít ANDBON AD-50S , 3 ngăn chống xước, cài đặt được % độ ẩm - Hàng chính hãng",2090000,2550000,460000,18
TIKI,may-anh,217720306,"Ulanzi BG-4 / Ulanzi BG-3  Tripod Tích Hợp Pin Sạc Dự Phòng 5000mAh Cho Điện Thoại, Gopro, Máy Ảnh DSLR - Hàng Chính Hãng",550000,550000,0,0
TIKI,may-anh,113500071,"Tủ chống ẩm Dry Cabi AD-050, 50 Lít Hàng nhập khẩu",1499999,1499999,0,0
TIKI,may-anh,4708511,"Dây Đeo Đầu Cho Gopro Yicamera (Đen) -  Hàng Nhập Khẩu",79000,79000,0,0
TIKI,may-anh,173856725,"Camera WiFi Thông Minh TP-Link Tapo C110 Độ Phân Giải 3MP An Ninh Gia Đình - Hàng Chính Hãng",499000,958000,459000,48
TIKI,may-anh,9799302,"Gói hút ẩm silica gel 100 gram (10 túi/ bịch) - Hàng chính hãng",99000,99000,0,0
TIKI,may-anh,16645022,"Combo Phụ Kiện cho GoPro SJcam ",209000,209000,0,0
TIKI,may-anh,14072222,"1kg gói hạt hút ẩm loại 5gram (200 gói 5gram)",99000,99000,0,0
TIKI,may-anh,32836957,"Pin LP-E6 Cho Canon 60D, 70D, 6D, 7D, 5D MARK II, 5D MARK III, 7D II",196999,196999,0,0
TIKI,may-anh,21477656,"Củ Nguồn dành cho Camera 12VDC-2A",41500,41500,0,0
TIKI,may-anh,75640644,"(Chuyên Nghiệp) Tay Cầm Chống Rung Cơ Học KhoNCC Hàng Chính Hãng - Gimbal Stabilizer Steadicam Cho Máy ảnh, Điện Thoại, GoPro - KDHS-4594-SDC",289000,422000,133000,32
TIKI,may-anh,4727509,"Máy Hút Ẩm Eirmai (Size To) - Hàng Nhập Khẩu",189000,189000,0,0
TIKI,may-anh,186103396,"Camera IMOU Cue 2, Camera Wifi độ phân giải 2 megapixel, đàm thoại 2 chiều, phát hiện người bằng AI thông minh - Hàng Chính Hãng",545000,545000,0,0
TIKI,may-anh,184649752,"CAMERA PTZ YOOSEE 5.0 MPX 14 LED SIÊU SẮC NÉT, ĐÀM THOẠI 2 CHIỀU, ĐÊM CÓ MÀU, XEM ĐÊM NÉT - HÀNG NHẬP KHẨU",379000,449000,70000,16
TIKI,may-anh,23308727,"Ống nhòm 1 ống hàng chất lượng - Siêu nét",93000,93000,0,0
TIKI,may-anh,13670608,"Hộp Chụp Sản Phẩm Có Đèn LED (40x40cm)",191000,245000,54000,22
TIKI,may-anh,197627906,"Máy Bay Điều Khiển Từ Xa Vinetteam I3 PRO Camera Kép Quadcopter UAV Với Bản Nâng Cấp 720P / 1080P / 4K HD Cảm Biến Chướng Ngại Vật Có Thể Điều Chỉnh Camera - Hàng Nhập Khẩu",1099000,1200000,101000,8
TIKI,may-anh,15851215,"Hộp Chụp Sản Phẩm Có Đèn LED 60x60cm",1014999,1014999,0,0
TIKI,may-anh,15851205,"Bàn Xoay Chụp Sản Phẩm 360 Độ Đường Kính 60cm - Hàng Chính Hãng",3186000,3186000,0,0
TIKI,may-anh,165947248,"Pin Flycam SJRC F11S 4K Pro 2021( bản bay 3KM) - Phụ kiện flycam tăng thêm thời gian bay có dung lượng 2500mAh - Hàng nhập khẩu",850000,935000,85000,9
TIKI,may-anh,34718232,"Bộ 2 Pin Và Sạc Kép RAVPower Cho Nikon EN-EL15 D7XXX D8XX D7XX D6XX D5XX - Hàng Nhập Khẩu",799999,799999,0,0
TIKI,may-anh,55960558,"Phông vải key hình, phông nền studio màu xanh lá",330000,330000,0,0
TIKI,may-anh,1206859,"Tủ Chống Ẩm Nikatei NC-50S",3237000,3790000,553000,15
TIKI,may-anh,16258285,"Pin Cho Máy Ảnh Cho  Canon LP-E6 ",194999,194999,0,0
TIKI,may-anh,7252601,"Lens cap 55mm nắp đậy bảo vệ ống kính máy ảnh phi 55mm",59000,59000,0,0
TIKI,may-anh,129078637,"Combo Camera Wi-fi Trong Nhà EZVIZ C1C-B 2MP Kèm Thẻ Nhớ  32GB/64G - Hàng Chính Hãng",579000,700000,121000,17
TIKI,may-anh,79911353,"Camera năng lượng mặt trời thông minh",900000,900000,0,0
TIKI,may-anh,133233964,"Hộp kỹ thuật điện bảo vệ nguồn camera loại tốt",10000,10000,0,0
TIKI,may-anh,72844272,"Ống nhòm 20x50 UW101 ( LẤY NÉT NHANH, TRƯỜNG ẢNH RỘNG, NHÌN XA HÀNG KILOMET ) - HÀNG NHẬP KHẨU",690000,690000,0,0
TIKI,may-anh,2566013,"Tripod Chân Nhện 22cm - Hàng Nhập Khẩu",58000,58000,0,0
TIKI,may-anh,13149286,"Preampli FX Audio TUBE-03 6J1 Preamplifier Đèn, Chỉnh Bass-Treble AZONE",703000,703000,0,0
TIKI,may-anh,23838887," Kính hiển vi bỏ túi cao cấp Carson MicroFlip MP-250 (Phóng đại 100x -250x) có đèn tia cực tím UV kiểm tra tiền - Hàng chính hãng",900000,900000,0,0
TIKI,may-anh,25761647,"Hộp Đựng Phụ Kiện cho GOPRO Camera Hành Trình Chống Sốc",129000,129000,0,0
TIKI,may-anh,158477449,"Chân Đế Dome cho camera IMOU - Hàng Chính Hãng",7500,7500,0,0
TIKI,may-anh,12362456,"Pin Panasonic CR  2025 - Hàng chính hãng",25000,25000,0,0
TIKI,may-anh,21190495,"Túi chống sốc Body và ống kính máy ảnh",159000,159000,0,0
TIKI,may-anh,122520891,"Gói Hút Ẩm 5 Gram đóng gói  500Gram Silicagel - hạt hút ẩm thực phẩm quần áo giày dép máy ảnh hoa khô",14000,14000,0,0
TIKI,may-anh,97589228,"Camera Xiaomi Mi 360 độ Home Security 2K - Hàng chính hãng",899000,1690000,791000,47
TIKI,may-anh,4688947,"Remote Bluetooth Cho Điện Thoại iOs, Android (Màu Ngẫu Nhiên) - Hàng Nhập Khẩu",28800,28800,0,0
TIKI,may-anh,121329289,"Nguồn 12V 2A cho đèn led và camera hàng cao cấp",44650,47000,2350,5
TIKI,may-anh,145304628,"Camera IMOU Cruiser 2MP/4MP, Camera ngoài trời, xoay 360, chống nước IP66, đàm thoại hai chiều, tích hợp còi và đèn chiếu sáng - Hàng Chính Hãng",1450000,1650000,200000,12
TIKI,may-anh,135839773,"Thẻ nhớ 32/64/128/256gb MIXIE  MicroSD  Class10 U3. Hàng Chính Hãng",69000,69000,0,0
TIKI,may-anh,7389203,"Ống Nhòm Barska Lucid 8x21mm - Hàng chính hãng",858000,858000,0,0
TIKI,may-anh,56451960,"Pin D Carbon Panasonic R20UT/2S chính hãng",30000,30000,0,0
TIKI,may-anh,67827497,"Camera Wi-Fi TP-Link Tapo C200 1080P (2MP) + Thẻ nhớ Adata 32gb - Hàng Chính Hãng",599000,599000,0,0
TIKI,may-anh,110846231,"Chân Đế Camera Ezviz C6N Camera Imou A22Ep Camera Kbone và sử dụng cho một số mẫu camera tương tự, HÀNG NHƯ HÌNH",7500,7500,0,0
TIKI,may-anh,44911333,"Combo 10 hộp kỹ thuật cho Camera kích thước 11*11*5cm",51900,51900,0,0
TIKI,may-anh,22093519,"Camera Hành Trình Mini DV SQ11 Full HD 1080P Hỗ Trợ Ban Đêm Cao Cấp AZONE",88900,88900,0,0
TIKI,may-anh,5849615,"Combo Chân Máy Dùng Cho Điện Thoại Tripod Yunteng VCT-5208 - Hàng Nhập Khẩu",172000,172000,0,0
TIKI,may-anh,15212692,"Đui đèn 4 bóng và Softbox 50x70cm",399000,399000,0,0
TIKI,may-anh,134958321,"Lẻ dây đeo ngực Gopro cho camera hành trình hỗ trợ quay hành trình",29500,29500,0,0
TIKI,may-anh,194130039,"Camera IP Wifi Ngoài Trời EZVIZ H3 5MP Độ Phân Giải 3K Siêu Nét Tích Hợp AI Nhận Diện Vẫy Tay Chào - Có Màu Ban Đêm - Đàm Thoại 2 Chiều - Hàng Chính Hãng",1190000,1190000,0,0
TIKI,may-anh,22360529,"Camera IP Ngoài Trời Yoosee X2000 - Xoay 360 - Hồng Ngoại Quay Đêm - Hàng Chính Hãng",420000,420000,0,0
TIKI,may-anh,129519025,"Sạc pin NP-FW50 AJ-1 dành cho máy ảnh A6000/ A6300/A6400/NEX-5/A7",237500,237500,0,0
TIKI,may-anh,9986769,"Mount chuyển ngàm GoPro Hero sang chuẩn mount chân máy ảnh tripod 1/4 Đực",57000,57000,0,0
TIKI,may-anh,96805675,"Tủ Điện Kỹ Thuật Kích Thước 45*38*12cm Chất Liệu Tôn Cao Cấp - Tủ Đầu Ghi Camera",194000,194000,0,0
TIKI,may-anh,14585382,"Gói hút ẩm Secco - Hàng chính hãng",22000,22000,0,0
TIKI,may-anh,155997522,"Chân máy ảnh và điện thoại Yunteng VCT-5208RM - Hàng Chính Hãng",275555,275555,0,0
TIKI,may-anh,21329314," CAMERA HÀNH TRÌNH CAO CẤP SIÊU NÉT X002",399000,399000,0,0
TIKI,may-anh,15380161,"Giá đỡ điện thoại cao cấp Tripod Support - Hàng nhập khẩu",29900,29900,0,0
TIKI,may-anh,19931032,"Sạc Xe Hơi Cho Camera Hành Trình SJCAM SJ4000 & SJ5000 & M10",109000,109000,0,0
TIKI,may-anh,28240413,"Chân giá đỡ Tripod 3366 cao 150cm kèm Remote chụp ảnh - Hàng nhập khẩu",148000,148000,0,0
TIKI,may-anh,57269609,"Kính hiển vi bỏ túi kèm kẹp điện thoại Carson MM-380 (20x, có đèn Led, đèn UV soi tiền) - Hàng chính hãng",948000,948000,0,0
TIKI,may-anh,197120194,"Tủ chống ẩm máy ảnh 50 lít Andbon, Tủ hút ẩm đựng máy ảnh 50l ba ngăn công nghệ Nhật Bản tiết kiệm điện dung tích lớn dry cabinet - Hàng Nhập Khẩu",1826000,1826000,0,0
TIKI,may-anh,101305931,"Combo Hộp chống ẩm 4 lít + ẩm kế + 200g hạt hút ẩm xanh (Có tùy chọn máy hút ẩm) cho máy ảnh (tặng mút xốp)",79000,79000,0,0
TIKI,may-anh,130785879,"Hạt hút ẩm xanh cao cấp 1kg (Combo 10 gói)",119000,119000,0,0
TIKI,may-anh,109034736,"Pin Kingma cho Panasonic DMW-BLJ31, Hàng chính hãng",399999,399999,0,0
TIKI,may-anh,50391461,"Camera giám sát Blurams Home 1080P - Hàng Chính Hãng",590000,590000,0,0
TIKI,may-anh,24998517,"Ruột Chống Sốc Máy Ảnh DSRL Loại To",225000,225000,0,0
TIKI,may-anh,110564348,"[Chính hãng] Camera mini A9S siêu nhỏ wifi không dây fullHD kết nối với điện thoại, quay ban đêm có pin, HDwificam Pro",64498,64498,0,0
TIKI,may-anh,113427448,"bộ chuyển nguồn poe 48v-12v dùng cho camera, Hàng Chính Hãng",49000,49000,0,0
TIKI,may-anh,4727109,"Bóng Đèn Ánh Sáng Liên Tục 200W 5500K - Hàng Nhập Khẩu",219000,219000,0,0
TIKI,may-anh,50437680,"Bộ khuếch đại chống nhiễu camera ahd/ hd-tvi/ hd-cvi/ analog YJS-203A (2 thiết bị)",550000,550000,0,0
TIKI,may-anh,208555439,"Camera Xiaomi Mi 360° Home 2K BHR4193GL Pro - hàng chính hãng",1290000,1290000,0,0
TIKI,may-anh,154490322,"Benro T980EX - Chân Đế Cho Máy Ảnh, Máy Quay, Smartphone, Tải Trọng 5kg, Chiều Cao 1.62m, Tặng Kèm Kẹp Điện Thoại - Hàng Chính Hãng",999999,999999,0,0
TIKI,may-anh,4739281,"Nắp Ống Kính Nikon 52mm - Hàng Nhập Khẩu",39999,39999,0,0
TIKI,may-anh,13755844,"Chân máy chụp hình yunteng yt-228 (Màu Đen)",29000,29000,0,0
TIKI,may-anh,108216240,"Pin Kingma for Olympus BLN-1 - Hàng chính hãng",299999,299999,0,0
TIKI,may-anh,151500674,"MVN Studio - Gói 100g và 200g hạt chống ẩm, hạt hút ẩm màu xanh cho máy ảnh",15000,15000,0,0
TIKI,may-anh,167425569,"Dây đeo cổ máy ảnh Canon - Đeo cổ",60000,60000,0,0
TIKI,may-anh,179072413,"1KG Gói hút ẩm loại gói 10gr",85000,85000,0,0
TIKI,may-anh,193102256,"Camera Có Màu Ban Đêm IP hồng ngoại không dây 2.0 3.0 Megapixel EZVIZ C3TN  - Hàng Chính Hãng",660000,660000,0,0
TIKI,may-anh,10144230,"Dock Sạc Pin Đơn Cho Camera Hành Trình SJCAM - Hàng chính hãng ",70000,70000,0,0
TIKI,may-anh,7237635,"Lens cap 40.5mm nắp đậy bảo vệ ống kính máy ảnh phi 40.5mm",45888,45888,0,0
TIKI,may-anh,26091489,"Bộ nắp body và nắp đuôi lens cho Canon ngàm EOS M- Hàng nhập khẩu",55000,55000,0,0
TIKI,may-anh,4754819,"High Quality Mini Ball Head - Hàng Nhập Khẩu",99000,99000,0,0
TIKI,may-anh,4738203,"Chân Xoắn Size S + Kẹp Điện Thoại - Hàng Nhập Khẩu",93955,98900,4945,5
TIKI,may-anh,125935587,"Jack nguồn camera, Nối đầu dây cáp đồng trục",2900,2900,0,0
TIKI,may-anh,134409547,"Nguồn Camera 5V 2A Chui Nhỏ",39000,39000,0,0
TIKI,may-anh,155996927,"Túi máy ảnh tam giác Caden D1, màu đen - Hàng chính hãng",225555,225555,0,0
TIKI,may-anh,847472,"Tấm Hắt Sáng 2 Trong 1 Cho Studio Reflector Disc 110 - Hàng nhập khẩu",177000,177000,0,0
TIKI,may-anh,15669028,"Micro Thu Âm Cài Áo Boya BY-M1 - Hàng Chính Hãng",247000,247000,0,0
TIKI,may-anh,54023404,"Camera IP Wifi Ezviz C6N CS-CV246 + Thẻ nhớ Ezviz 32GB - Hàng Chính Hãng",448000,448000,0,0
TIKI,may-anh,19920071,"Pin cho Canon LP-E12  cho Canon M10 100D Rebel S1 M M2 M50 M100",157999,157999,0,0
TIKI,may-anh,186209400,"Tủ chống ẩm Andbon AB-50C, 50 lít - Hàng chính hãng",1549999,1549999,0,0
TIKI,may-anh,138480404,"Flycam SJRC F11s 4K Pro 3Km 2021 – Gimbal chống rung 2 trục và chống rung điện tử EIS - thời gian bay 30 phút - Hàng Nhập Khẩu",3899000,4453900,554900,12
TIKI,may-anh,110050409,"hộp kỹ thuật cho Camera kích thước 11*11*5cm HÀNG NHƯ HÌNH",7900,7900,0,0
TIKI,may-anh,72821133,"Camera wifi trong nhà Yoosee  Z02T 2.0 Full HD, 3 râu, xoay 360 độ , tương tác 2 chiều, hỗ trợ thẻ nhớ lên đến 128G, cảnh báo chuyển động – Hàng nhập khẩu",250000,379000,129000,34
TIKI,may-anh,162386652,"Bộ Nắp Cao Su Thay Thế Chống Bụi Bảo Vệ Cổng Usb Hdmi Cho Dành Cho Máy Ảnh Canon EOS 40D, 50D, 60D, 70D, 550D, 600D, 650D/700D, 6D, 7D, 5D, 5D Mark ii, 5D Mark iii",229000,229000,0,0
TIKI,may-anh,4713035,"Chân Máy Ảnh Chuyên Nghiệp Tripod Beike Q999S - Hàng Nhập Khẩu",949999,949999,0,0
TIKI,may-anh,261942905,"Camera IP Wifi quay quét EZVIZ C8W 4MP - Ngoài Trời - Hàng Chính Hãng",1350000,1350000,0,0
TIKI,may-anh,166503275,"Camera hành trình Xiaomi 70mai M500. Bản quốc tế, kết nối Wifi - HÀNG NHẬP KHẨU",2771000,2771000,0,0
TIKI,may-anh,72802363,"Camera Lùi Xe Tải 24 Đèn Led Chiều Dài Dây Từ 10m Đến 20m",319000,319000,0,0
TIKI,may-anh,3307279,"Túi chống sock cho đèn flash (Đen)",95000,95000,0,0
TIKI,may-anh,1751291,"CHÂN MÁY ẢNH BENRO T560 - Hàng Chính hãng",389999,389999,0,0
TIKI,may-anh,71907846,"Pin Dành Cho Máy Ảnh Nikon EN-EL14",208999,208999,0,0
TIKI,may-anh,14072065,"1kg gói hạt hút ẩm loại 2gram dùng bảo quản thực phẩm (500 gói 2gram)",99000,99000,0,0
TIKI,may-anh,212083871,"Túi máy ảnh đeo chéo vai đa năng",285000,285000,0,0
TIKI,may-anh,147469295,"Bộ sạc Nhanh BQ CC55C kèm 4 Pin AAA Eneloop Pro 950 mAh , Chân Gập - Hàng Nhập Khẩu",900000,900000,0,0
TIKI,may-anh,39325978,"Pin Cho Máy Quay Phim Sony NP-F970 NP-F960 7800mAh Cao Cấp AZONE",242999,242999,0,0
TIKI,may-anh,184126296,"Camer hành trình ô tô 2K Vehicle Blackbox DVR A68 ghi hình trước, sau, bên trong xe, độ phân giải 2K",750000,750000,0,0
TIKI,may-anh,159271060,"Pin sạc Kingma Ver 2 cho Canon LP-E17, Hàng chính hãng",219999,219999,0,0
TIKI,may-anh,143181730,"Camera IMOU Bullet 2/2C/2E (IPC-F42) Camera Ngoài Trời, Chống nước IP67, Chuẩn nén H265, Theo dõi chuyển động, Quay Màu ban đêm",970000,1300000,330000,25
TIKI,may-anh,73554242,"Phông nền nhựa PVC trơn kích thước 70x140cm treo giá khung chụp ảnh sản phẩm đủ màu sắc",67000,67000,0,0
TIKI,may-anh,124963960,"Camera mini wifi X6 fullHD 1080p giám sát, an ninh, hồng ngoại quay ban đêm, pin 3 giờ, siêu nhỏ không dây",480000,480000,0,0
TIKI,may-anh,190708716,"Camera hành trình ô tô L170S Dual, ghi hình trước, sau Full HD 1080p kèm camera lùi cho xe ô tô",549000,549000,0,0
TIKI,may-anh,170267665,"Camera IMOU wifi A22EP 1080P 2M xoay 360 độ đàm thoại 2 chiều - Hàng chính hãng",417700,417700,0,0
TIKI,may-anh,94688168,"Thẻ Nhớ MicroSD MIXIE 32G Class10 Mixie Box 95Mb/s (tặng kèm đầu đọc thẻ nhớ cao cấp) - hàng nhập khẩu (TẶNG KÈM ĐẦU ĐỌC THẺ NHỚ)",89000,89000,0,0
TIKI,may-anh,140465983,"Kính hiển vi sinh học dành cho học sinh BG001 phóng đại lên 1200X",430000,430000,0,0
TIKI,may-anh,37944329,"Kẹp điện thoại đa năng vào thân tripod / giá đỡ 3 chân, hoặc vào bàn ghế, cửa kính hỗ trợ livestream, chụp ảnh, quay video nhiều máy",70000,70000,0,0
TIKI,may-anh,81209881,"Camera Eufy Security Indoor Cam 2K Công nghệ AI Xoay 360 độ Đàm thoại 2 chiều - Hàng Chính Hãng",920000,925000,5000,1
TIKI,may-anh,13984365,"Chân Máy Ảnh Tripod WEIFENG WT-3520 - Hàng nhập khẩu",224999,224999,0,0
TIKI,may-anh,68769369,"Chân Đế Camera Xoay 360 Bộ 2 Cái Phù Hợp Với Camera Ezviz C6N Camera Imou A22Ep Camera Kbone H21PW",12000,12000,0,0
TIKI,may-anh,247421211,"Camera IP WIFI IMOU RANGER 2 IPC - A22EP Full HD 1080P - Hàng Chính Hãng",424000,424000,0,0
TIKI,may-anh,75514029,"Balo máy ảnh cao cấp chống thấm nước - BL015",1150000,1150000,0,0
TIKI,may-anh,197548082,"Camera Wi-fi EZVIZ C6N 2MP Trong Nhà, FHD 1080P, Quay Quét 360 Độ, Đàm Thoại Hai Chiều - Hàng Chính Hãng",550000,999000,449000,45
TIKI,may-anh,272038478,"Camera IP Wifi Yoosee HWK-205 2.0MPX - Hàng chính hãng",220000,220000,0,0
TIKI,may-anh,120053370,"Camera năng lượng mặt trời WIFI tặng kèm tặng thẻ 32G",1100000,1100000,0,0
TIKI,may-anh,7783307,"Bộ 2 pin và sạc đôi RavPower NP-FW50 cho Sony A6000, A6300, A6500, A7, A7 II, A7R, A7S... - Hàng chính hãng",649999,649999,0,0
TIKI,may-anh,7634857,"Combo hộp chống ẩm và ẩm kế, 100gram hạt hút ẩm xanh cho máy ảnh, máy quay phim - dung tích 5 lít (tặng mút xốp lót hộp)",169000,169000,0,0
TIKI,may-anh,13697766,"Camera Nội Soi Chống Nước Cho Điện Thoại OTG Wifi Dài 1M AZONE",323000,437000,114000,26
TIKI,may-anh,56714697,"Hộp Chụp Hình Sản Phẩm Có  Đèn Led 40*40*40cm - Light Box",177000,259000,82000,32
TIKI,may-anh,14578165,"Bộ 2 Pin + Sạc Đôi RAVPower Fujifilm NP-W126S Cho Fujifilm X-T20, X-T10, X-T100, X100F, X-H1, X-T3, X-T2, X-T1, X-A5, X-A3, X-A1, X-E1, X-E2,... (Hàng Chính Hãng)",648999,648999,0,0
TIKI,may-anh,4707531,"Dây Đeo Máy Ảnh Cổ Tay Quick Release - Hàng Nhập Khẩu",89000,89000,0,0
TIKI,may-anh,194040477,"Camera Wifi Yoosee 5.0 Mpx Full HD, Dòng Ngoài Trời Xoay 360°,C12 Xem Đêm Có Màu-Đàm Thoại 2 Chiều-Phát Hiện Chuyển Động Chống Trộm-Hàng Nhập Khẩu",530000,659000,129000,20
TIKI,may-anh,14536798,"Bộ 2 pin và đế sạc kép RAVPower RP-BC023 tương thích Fujifilm NP-W126S, FinePix X-A5,...  - Hàng Chính Hãng",615999,615999,0,0
TIKI,may-anh,247419129,"Camera IMOU wifi A22EP 1080P 2M xoay 360 độ đàm thoại 2 chiều - Hàng chính hãng",425000,425000,0,0
TIKI,may-anh,4707761,"Bộ Vệ Sinh 3 In 1 JJC CL-3D - Hàng Nhập Khẩu",159000,159000,0,0
TIKI,may-anh,19986634,"Cáp Camera Jack BNC liền nguồn 20m",114900,114900,0,0
TIKI,may-anh,50779427,"Combo 2 pin 1 sạc đôi cho Gopro Hero 5 6 7 8",379000,379000,0,0
TIKI,may-anh,97534824,"Bộ KIT chống trộm thông minh MKS",900000,900000,0,0
TIKI,may-anh,57652540,"Chân 3 Tripod YT228 Dùng Cho Điện Thoại, Máy Quay, Máy Ảnh, Gopro , Nối dài cho gimbal",32633,34350,1717,5
TIKI,may-anh,176227854,"Camera IP wifi ngoài trời IMOU Cruiser SE 2MP/4MP - Hàng Chính Hãng",990000,1040000,50000,5
TIKI,may-anh,5899501,"Tủ Chống Ẩm Andbon AD-30S (30 lít) - Hàng Nhập Khẩu",1374999,1374999,0,0
TIKI,may-anh,107182831,"Camera IP WIFI IMOU RANGER 2 IPC - A22EP Full HD 1080P ,KÈM THẺ NHỚ 64G - Hàng Chính Hãng",522000,522000,0,0
TIKI,may-anh,75660376,"Dây cấp nguồn cho camera hành trình chân cắm USB đầu cắm miniUSB hoặc microUSB",33000,33000,0,0
TIKI,may-anh,270266974,"Chân đế treo tường, hộp kỹ thuật Cho Camera Dome, Camera Ezviz C6N, Camera C6CN, Camera C4W, Nhựa Tốt",7350,7350,0,0
TIKI,may-anh,169502518,"Camera wifi trong nhà Ezviz C1C-B 2MP đàm thoại 2 chiều - Hàng chính hãng",460000,460000,0,0
TIKI,may-anh,57624790,"Dây đeo máy ảnh cổ tay Cammix - Wrist Strap Dây Dù Paracord - Dây đeo cổ tay dành cho máy ảnh Fujifilm, Sony, Canon, Nikon... - Hàng chính hãng",169000,169000,0,0
TIKI,may-anh,103996506,"CAMERA EZVIZ IP WIFI C6N 2.0 MPX ,KÈM THẺ NHỚ 64G HÀNG CHÍNH HÃNG.",520000,520000,0,0
TIKI,may-anh,196265020,"Máy ảnh chụp lấy liền dùng thẻ nhớ Fujifilm Instax Mini Evo - Hàng chính hãng",5850000,7500000,1650000,22
TIKI,may-anh,26062659,"Camera IP Wifi Imou IPC-C22EP-Imou 2Mpx 1080P Full HD - Hàng Chính Hãng",420000,420000,0,0
TIKI,may-anh,252065908,"Camera IP wifi xoay 360 độ ngoài trời Ezviz C8W -  Hàng chính hãng",1240000,1900000,660000,35
TIKI,may-anh,88861668,"Chân Máy Ảnh Manfrotto Pixi Mini - Chính hãng",720000,720000,0,0
TIKI,may-anh,197719893,"Camera IP Wifi Trong Nhà EZVIZ C6N 1080p - Hàng Chính Hãng",450000,450000,0,0
TIKI,may-anh,4713289,"Pin Máy Ảnh Nikon EN-EL3e - Hàng Nhập Khẩu",205999,205999,0,0
TIKI,may-anh,20053400,"Lens Hood Cho ống Kính Canon 18-55mm STM (Loa che nắng EW-63C)",49000,49000,0,0
TIKI,may-anh,195864060,"Tủ chống ẩm máy ảnh  30 Lít nhập khẩu Andbon, Tủ hút ẩm 30L., 2 ngăn, màn lLCD  cài đặt % độ ẩm, tiết kiệm điện - Hàng Chính hãng",1149999,1149999,0,0
TIKI,may-anh,20260205,"Pin cho Nikon EN-EL15 2550mAh cho Nikon D500 D600 D750 D800 D800E D7000 D7100 D810 D7200E",246999,246999,0,0
TIKI,may-anh,21921714,"Camera wifi Yoosee chuẩn 3 râu 11 LED Full HD - hàng chính hãng",250000,250000,0,0
TIKI,may-anh,75696942,"Camera IP Wifi PTZ Ngoài Trời Ezviz C8C Full Color Hồng Ngoại 30 Mét Có Dây Nối Nguồn Dài 1,5M - Hàng Chính Hãng",1050000,1050000,0,0
TIKI,may-anh,140901324,"Tay cầm chống rung Gimbal 3 Axis Handheld - Gậy gimbal đa năng cho điện thoại adroid, IOS - 3 trục xoay, kết nối bluetooth, zoom xa gần ngay trên gậy - Tích hợp cổng USB sạc pin cho điện thoại - Hàng nhập khẩu",1290000,1290000,0,0
TIKI,may-anh,415071,"Chân Máy Ảnh Benro T660 EX (Tripod) - Hàng Chính Hãng",574999,574999,0,0
TIKI,may-anh,4688759,"Túi Đựng Máy Ảnh Canvas MC1 Size S - Hàng Nhập Khẩu",399000,399000,0,0
TIKI,may-anh,37293702,"Ống nhòm 10X22 mini siêu nét ( Dùng được cho cả người lớn và trẻ nhỏ ) - Hàng nhập khẩu",360000,360000,0,0
TIKI,may-anh,15827657,"Túi máy ảnh BX 53 - Hàng nhập khẩu",319999,319999,0,0
TIKI,may-anh,124966122,"Combo 50 Gram gói hút ẩm silica gel quy cách 1/2/3/5/10/50 Gram hút ẩm cho Thưc phẩm Quần áo Giày dép Máy ảnh Phòng Ngủ hoa khô",10500,10500,0,0
TIKI,may-anh,32593849,"Chân đế quay phim chụp ảnh cho điện thoại kiêm gậy tự sướng bluetooth Yunteng VCT 1688 - Hàng nhập khẩu",450000,450000,0,0
TIKI,may-anh,158496289,"Camera IMOU Cue 2E, Camera IP độ phân giải 2 megapixel, phát hiện người bằng AI thông minh - Hàng Chính Hãng",450000,450000,0,0
TIKI,may-anh,80932486,"Dây cáp đồng trục liền nguồn cho camera 100M, hiệu UNISAT HÀNG CHÍNH HÃNG.",668000,668000,0,0
TIKI,may-anh,4707653,"Tripod Bexin Ultra Compact Tripod MS-6 - Hàng Nhập Khẩu",399000,399000,0,0
TIKI,may-anh,188111182,"Thẻ nhớ MIXIE 32GB, 64GB hàng chính hãng",57000,82000,25000,30
TIKI,may-anh,108055235,"Filter Kính lọc B+W XS-Pro Digital 010 UV-Haze MRC Nano, Hàng chính hãng",799999,799999,0,0
TIKI,may-anh,6568615,"Đế chân máy ảnh Benro T600/T660/T800/T880 (Quick release plate tripod)",79000,79000,0,0
TIKI,may-anh,72638706,"CAMERA WIFI YOOSEE D16A 16 LED MÁI VÒM PTZ MINI CHỐNG NƯỚC NGOÀI TRỜI - HÀNG NHẬP KHẨU ",380000,380000,0,0
TIKI,may-anh,35795143,"Chân đế Tripod cho điện thoại và máy ảnh 3366 cao cấp - Tặng kèm remote Bluetooth  - Hàng nhập khẩu",137697,137697,0,0
TIKI,may-anh,2533165,"Lens Hood ES-68 For Canon EF 50mm F / 1.8 STM (Đen)",62000,62000,0,0
TIKI,may-anh,21369758,"Túi chống sốc máy ảnh tam giác DSLR Hàng Nhập Khẩu",159000,159000,0,0
TIKI,may-anh,68541040,"Đèn led video Ulanzi VIJIM VL120 RGB hàng chính hãng",559000,559000,0,0
TIKI,may-anh,13583766,"Thẻ Nhớ SDXC SanDisk Extreme Pro U3 V30 1133X 64GB 170MB/s - Hàng Chính Hãng",459000,479000,20000,4
TIKI,may-anh,17926831,"Bộ Pin Sạc cho máy ảnh Sony NP-BX1",174999,174999,0,0
TIKI,may-anh,4707367,"Monopod DV Weifeng 3958M - Hàng Nhập Khẩu",678999,678999,0,0
TIKI,may-anh,6478415,"Mic Thu Âm Cho Điện Thoại Và Máy Ảnh BOYA BY-M1 - Hàng Chính Hãng",248000,248000,0,0
TIKI,may-anh,58978540,"THẺ NHỚ SDHC UHS-I EXCERIA KIOXIA 32GB - HÀNG NHẬP KHẨU",135000,135000,0,0
TIKI,may-anh,17912455,"Pin máy ảnh EN-EL14 cho Nikon D3100 D3200 D5100 D5200 P7000 P7100 D5300",219999,219999,0,0
TIKI,may-anh,104100268,"Ulanzi MT-09 - Tripod Tích Hợp Gậy Selfie Cho GoPro Và Action Camera - Hàng chính hãng",230000,230000,0,0
TIKI,may-anh,14142567,"1kg gói hạt hút ẩm loại 50gram sử dụng đa năng (20 gói 50gram)",89000,89000,0,0
TIKI,may-anh,137938921,"Ulanzi Giá Đỡ Ba Chân Ulanzi MT-34 Di Động Xoay 360 Độ Với Ốc Vít 1 / 4 Inch Cho Máy Ảnh - Hàng nhập khẩu",260000,260000,0,0
TIKI,may-anh,25648528,"Camera Dahua IP Wifi  Imou IPC-C22EP-imou - Hàng chính hãng",398900,398900,0,0
TIKI,may-anh,188174593,"Hộp Nhựa Kỹ Thuật Lắp Camera Chuyên Dụng Chống Nước Nhựa Dày Siêu Bền",8600,8600,0,0
TIKI,may-anh,108255418,"Sạc thay thế sạc máy ảnh Sony (nhiều loại), Hàng nhập khẩu",139999,139999,0,0
TIKI,may-anh,108243589,"Combo 2 pin 1 sạc ba Kingma for Sony NP-BX1 - Hàng chính hãng",499999,499999,0,0
TIKI,may-anh,155997744,"Tủ Chống Ẩm Andbon 20-50 Lít - Hàng chính hãng",150555,150555,0,0
TIKI,may-anh,7327987,"Lens cap 52mm nắp đậy bảo vệ ống kính máy ảnh phi 52mm",49000,49000,0,0
TIKI,may-anh,17594807,"Camera nội soi cắm qua điện thoại hoặc USB máy tính dài 1m",248000,248000,0,0
TIKI,may-anh,4820975,"Camera IP Wifi Ezviz CS-CV246 - Hàng Chính Hãng",395000,395000,0,0
TIKI,may-anh,188927018,"CAMERA WIFI YOOSEE 4 RÂU 36 LED 5.0 MPX XOAY 180  - BẢO HÀNH 12 THÁNG CẢ THẺ NHỚ- HÀNG CHÍNH HÃNG",525000,525000,0,0
TIKI,may-anh,50586067,"Gói hút ẩm Silicagel loại 100gram (1kg có 10 gói nhỏ kích thước 10x14cm)",89000,89000,0,0
TIKI,may-anh,96753197,"Tripod Chân đế bạch tuộc dùng cho máy ảnh, điện thoại đặt trên mọi địa hình Ulanzi MT-33 - Hàng nhập khẩu",330000,330000,0,0
TIKI,may-anh,40774656,"Pin LP-E10 dùng cho máy ảnh Canon EOS Rebel T3 T5 T6 Kiss X50 X70 1100D 1200D 1300D - Hàng nhập khẩu",189999,189999,0,0
TIKI,may-anh,32649468,"Pin Dành Cho Máy Ảnh Canon LP-E12 1250mAh Cao Cấp AZONE",139999,139999,0,0
TIKI,may-anh,32189703,"CAMERA YOOSEE PTZ ngoài trời xoay 360 độ- Full HD 10ban đêm có màu-chạy thẻ nhớ-bắt wifi- ghi âm đàm thoại- hàng chính hãng",660000,660000,0,0
TIKI,may-anh,58002233,"Tripod Ulanzi MT-08 cho máy ảnh, điện thoại hàng chính hãng.",248000,248000,0,0
TIKI,may-anh,187485525,"Camera IP Wifi 2MP có đàm thoại DAHUA DH-IPC-HFW1230DT-STW hàng chính hãng",580000,580000,0,0
TIKI,may-anh,183031980,"Giá đỡ tripod chân 3 trục cho gimbal chống rung",42900,47190,4290,9
TIKI,may-anh,49557238,"Bộ Sạc Pin AA/AAA Eneloop BQ CC51 Và 4 Pin ( 2 Pin AA và 2 Pin AAA ) Made In Japan  Kèm Hộp Đựng Pin - Hàng Chính Hãng",620000,620000,0,0
TIKI,may-anh,171238992,"Phông nền màu xanh lá key tách nền hỗ trợ chụp hình studio, livestream",395000,395000,0,0
TIKI,may-anh,19986509,"Cáp Camera Jack BNC liền nguồn 15m",99900,99900,0,0
TIKI,may-anh,210762212,"CÁP USB MÁY CHỤP HÌNH CHO DIGITAL CAMERA-SONY CYBER-SHOT DSC-W230 W230 W270 W290",76000,76000,0,0
TIKI,may-anh,10002068,"Tản sáng Softbox mini cho đèn flash rời",49000,49000,0,0
TIKI,may-anh,7252155,"Vòng chuyển Step up ring",70000,70000,0,0
TIKI,may-anh,14116498,"Chân máy Tripod Yunteng VCT 691 / Hàng Chính Hãng",599999,599999,0,0
TIKI,may-anh,116882227,"CAMERA WiFi Yoosee 360 Siêu Nét 3.0Mpx Cao Cấp FullHD 1920 x 1080 Sắc Nét Hỗ Trợ Wifi IP Từ Xa Hàng Nhập Khẩu",360000,360000,0,0
TIKI,may-anh,10806848,"Sạc pin đôi nhanh KingMa cho Sony NP-FW50 A6000 A6300 A6500 - Hàng chính hãng",155999,155999,0,0
TIKI,may-anh,80414389,"Tủ chống ẩm 120 lít Andbon DS-125, Hàng chính hãng",5249999,5249999,0,0
TIKI,may-anh,193213654,"Hộp kỹ thuật cho camera bằng nhựa ABS chống cháy, bảo vệ nguồn mỹ thuật, đầy đủ ốc vít. Dùng cho camera hikvision, ezviz",9500,9500,0,0
TIKI,may-anh,54346139,"Phông nền nhựa PVC chụp ảnh sản phẩm màu xám",62000,62000,0,0
TIKI,may-anh,189476700,"Chân máy ảnh Benro T890 + Remote máy ảnh, Hàng chính hãng",689999,689999,0,0
TIKI,may-anh,57049049,"Pin sạc cho máy quay NP-FV100",299999,299999,0,0
TIKI,may-anh,50565962,"Gói hút ẩm Silicagel loại 3gram (1kg có 330 gói nhỏ kích thước 3,5x5cm)",89000,89000,0,0
TIKI,may-anh,8715424,"Túi đựng ống kính lens máy ảnh chống sốc cao tối đa 20cm",79999,79999,0,0
TIKI,may-anh,117347971,"Chân máy Tripod  cao cấp Benro T980EX - Hàng Chính Hãng",1149999,1149999,0,0
TIKI,may-anh,32841604,"Dây Đeo Máy Ảnh Thổ Cẩm Bản Vừa Everboards LYN-01 - Hàng Nhập Khẩu",69000,69000,0,0
TIKI,may-anh,114447811,"Camera IP Wifi Imou Ranger A42EP Quad HD (2K ) A22EP Full HD 1080P xoay 360 - Hàng chính hãng",438900,438900,0,0
TIKI,may-anh,127463373,"Chân đế Tripod cho điện thoại và máy ảnh 3366 cao cấp - Tặng kèm remote Bluetooth (Giao màu ngẫu nhiên)",170050,179000,8950,5
TIKI,may-anh,12331769,"Hộp Kỹ Thuật Camera",6399,6399,0,0
TIKI,may-anh,1760987,"Máy Ảnh Canon EOS 3000D + Lens EF-S 18 - 55mm III - Hàng Chính hãng",13350000,13990000,640000,5
TIKI,may-anh,154139553,"Dây cáp kết nối máy ảnh Canon với máy tính PC và Laptop loại tốt dùng CANON 60D, 70D, 6D, 7D, 5D MARK II, 5D MARK III, 700D,...",51000,54000,3000,6
TIKI,may-anh,21022062,"Máy Ảnh Canon EOS 3000D + Lens EF-S 18 - 55mm III - Hàng Chính Hãng (Tặng Kèm Thẻ Nhờ Và Túi Đựng Máy Ảnh)",13490000,13490000,0,0
TIKI,may-anh,3307353,"Dây đeo máy ảnh Photogear AC-21",99000,99000,0,0
TIKI,may-anh,140646244,"Gói hút ẩm 100gr",9500,9500,0,0
TIKI,may-anh,24443877," Ống nhòm một mắt Carson CF-618 - Hàng chính hãng",950000,950000,0,0
TIKI,may-anh,116913177,"Camera Wifi Yoosee 3.0 Mpx Full HD, Dòng Ngoài Trời Xoay 360° 4 râu 20 LED Xem Đêm Có Màu-Đàm Thoại 2 Chiều-Phát Hiện Chuyển Động Chống Trộm-Hàng Nhập Khẩu",750000,750000,0,0
TIKI,may-anh,2570683,"Gá Dù 2 Đèn - Hàng Nhập Khẩu",189000,189000,0,0
TIKI,may-anh,64672917,"Pin Panasonic CR 1632 -Hàng chính hãng",40000,40000,0,0
TIKI,may-anh,191891454,"Máy Bay Điều Khiển Từ Xa Flycam P8 PRO Camera Kép Quadcopter UAV Với Bản Nâng Cấp 720P / 1080P / 4K HD FPV GPS WiFi Cảm Biến Chướng Ngại Vật - Hàng Nhập Khẩu",650000,650000,0,0
TIKI,may-anh,185717414,"Camera IMOU S21FP S41FP tích hợp mic, phát hiện chuyển động, chống nước IP66 - Hàng chính hãng",898900,898900,0,0
TIKI,may-anh,95064547,"Camera thân to HDCVI 2MP FullColor DAHUA DH-HAC-HFW1239TLMP-LED nhìn đêm có màu hàng chính hãng DSS Việt Nam",520000,520000,0,0
TIKI,may-anh,117486463,"Camera hành trình ô tô 70MAI Pro Plus A500S tích hợp sẵn GPS - Hàng Chính Hãng",1648000,1648000,0,0
TIKI,may-anh,146592424,"Camera imou Bullet IPC-F42FEP 4.0 Megapixel, Fullcolor có màu ban đêm, có đàm thoại 2 chiều, báo động - hàng chính hãng",1088000,1088000,0,0
TIKI,may-anh,45839546,"Ống nhòm một mắt bỏ túi, phóng đại gấp 10 lần ON3",139000,139000,0,0
TIKI,may-anh,182565450,"Đầu Ghi Hình IP Wifi 8 Kênh IMOU NVR1108HS-W-S2 Hàng chính hãng",1224000,1224000,0,0
TIKI,may-anh,5950575,"Bộ Sạc Pin Cho Pin Tiều Sạc AA và AAA Doublepow Cao Cấp DP-B02 - Hàng nhập khẩu",49000,49000,0,0
TIKI,may-anh,177767447,"Thẻ nhớ Mico SD Imou 32GB/64GB cho Camera/ Điện thoại/ Máy tính- Hàng chính hãng",90000,90000,0,0
TIKI,may-anh,66117818,"Tủ chống ẩm Huitong S32, 32 Lít, hàng chính hãng",1074999,1074999,0,0
TIKI,may-anh,151492634,"Camera EZVIZ C3TN 3MP, WI-FI, Ngoài Trời, Đàm Thoại 2 Chiều, Ghi Gình Màu Ban Đêm, Cảnh Báo Bằng Còi Và Đèn, Tích Hợp AI Phát Hiện Người, Chuẩn Nén Video H.265, IP67 Chống Nước--Hàng Chính Hãng",1339000,2120000,781000,37
TIKI,may-anh,19990101,"Combo Pin Sạc Máy Ảnh Cho Sony NP-BN1",299999,299999,0,0
TIKI,may-anh,15927484,"Chân Máy Ảnh Yunteng VCT- 668 - Hàng Chính Hãng",399999,399999,0,0
TIKI,may-anh,181502353,"CAMERA WIFI NGOÀI TRỜI IMOU CRUISER SE IPC S21FP - HÀNG CHÍNH HÃNG",858900,858900,0,0
TIKI,may-anh,186137676,"Camera IP Wifi Tenda CP6 Full HD 2K 360° - Hàng chính hãng",495000,495000,0,0
TIKI,may-anh,461040,"Thẻ Nhớ SD SanDisk Ultra Class 10 16GB - 48MB/s - Hàng Chính Hãng",149000,168000,19000,11
TIKI,may-anh,124936068,"Camera mini wifi W18 fullHD 1080p giám sát, an ninh, hồng ngoại quay ban đêm, pin 4-6 giờ, siêu nhỏ không dây",700000,700000,0,0
TIKI,may-anh,253632196,"Bộ KIT Studio Chụp Ảnh Sản Phẩm Chân Đèn 2m Kèm Softbox 50x70 cm Hỗ Trợ Sáng(Không bóng đèn)",255000,255000,0,0
TIKI,may-anh,4032669,"Chân máy ảnh Tripod kèm giá đỡ điện thoại và túi đựng",49850,49850,0,0
TIKI,may-anh,4688965,"Dock Sạc Pin Máy Ảnh Cr2 - Hàng Nhập Khẩu",189000,189000,0,0
TIKI,may-anh,4713089,"Bàn Xoay Chụp Sản Phẩm 360 Độ (Đường Kính 25cm) - Hàng Nhập Khẩu",799000,799000,0,0
TIKI,may-anh,50360052,"Gói hút ẩm Silicagel loại 1gram dùng đa năng (1kg có 1000 gói nhỏ kích thước 3x3,5cm)",99000,99000,0,0
TIKI,may-anh,71051342,"Đế xoay 360 trưng bày sản phẩm quay video, chụp hình DX001 - Giao Màu Ngẫu Nhiên",245650,289000,43350,15
TIKI,may-anh,106598819,"Camera IP Wifi Ngoài Trời Imou F22FP Bullet 2E Full HD 1080P CÓ MÀU BAN ĐÊM ,KÈM PHÍCH CẮM ÂM- Hàng Chính Hãng",839000,839000,0,0
TIKI,may-anh,22169086,"Camera mini wifi HDQ15 1080P Hồng Ngoại quay đêm cục nét",519000,750000,231000,31
TIKI,may-anh,5899509,"Tủ Chống Ẩm Andbon AD-50C (50 lít) - Hàng Nhập Khẩu",2000000,3000000,1000000,33
TIKI,may-anh,86661367,"Camera IP AVTECH 2MP DGM2203 - Hàng Nhập Khẩu",1550000,1550000,0,0
TIKI,may-anh,108365202,"Bóng thổi bụi vệ sinh máy ảnh, Laptop, điện thoại, Bình xịt thổi bụi sen đá ",13000,18000,5000,28
TIKI,may-anh,96804322,"Camera IP Wifi Tenda CP3 Full HD 1080P 360° - Hàng Chính Hãng",370000,370000,0,0
TIKI,may-anh,180574240,"Đầu ghi hình 08 kênh HIKVISION DS-7208HGHI-K1 Turbo HD 4.0 DVR vỏ sắt - Hàng chính hãng",1090000,1400000,310000,22
TIKI,may-anh,2546983,"Dù Phản Bạc 85cm JYC (Đen)",99000,99000,0,0
TIKI,may-anh,120789183,"Dây đeo đầu quay phim cho điện thoại camera youtuber streamer quay vlogs",38800,38800,0,0
TIKI,may-anh,23410417,"Ba Lô Máy Ảnh Cỡ Lớn, Dã Ngoại, Chống Nước, Bền Bỉ",1048999,1048999,0,0
TIKI,may-anh,10001012,"Camera IP Wifi Ngoài Trời Ezviz CS-CV310 720P - Hàng Chính Hãng",859000,859000,0,0
TIKI,may-anh,141896340,"Camera Wifi Ngoài Trời Tenda CT6 Độ Phân Giải 2K - Hàng Chính Hãng",696000,696000,0,0
TIKI,may-anh,57270254,"Ống nhòm mini bỏ túi Carson JD-718 MiniScout - Hàng chính hãng",1060000,1060000,0,0
TIKI,may-anh,5859123,"Combo Chân Máy Ảnh Beike System Go 999H - Hàng Nhập Khẩu",1274999,1274999,0,0
TIKI,may-anh,10138000,"Dây Đeo Máy Ảnh cổ tay Thao Tác Nhanh",80000,80000,0,0
TIKI,may-anh,102471240,"500g hạt hút ẩm gồm 50 túi hạt 10g dùng để bảo quản máy ảnh và thực phẩm khô, thuốc, chống ẩm giày, quần áo",58000,58000,0,0
TIKI,may-anh,196305305,"Camera Wifi không dây SHUJI UH625D - Xoay 360 độ - Báo động khi có trộm - Độ phân giải 4.0mp cho hình ảnh nét đẹp gấp đôi Full HD 1080- Hàng chính hãng",450000,520000,70000,13
TIKI,may-anh,20423403,"Phông nền chụp ảnh 3D size lớn 100cm x 150cm",125000,125000,0,0
TIKI,may-anh,167421724,"Túi đựng máy ảnh Crumpler Jackpack 4000 - Hàng Chính Hãng",285000,285000,0,0
TIKI,may-anh,74539515,"Camera IP WIFI ngoài trời IPC-F22P-IMOU 2.0MP FullHD - Hàng Chính Hãng",629500,629500,0,0
TIKI,may-anh,23839834," Kính hiển vi  bỏ túi đa năng MICROBRITE PLUS MM-300 (Phóng đại 60-120x) - Hàng chính hãng",544000,544000,0,0
TIKI,may-anh,55349072,"CAMERA WIFI, CAMERA QUAN SÁT IP WIFI QIHOO 360 AC1C - 1080P (PHIÊN BẢN QUỐC TẾ 2020)  – HÀNG CHÍNH HÃNG",579000,579000,0,0
TIKI,may-anh,72693508,"Kính thiên văn C2130 đồ chơi cho trẻ em D00-740",289000,289000,0,0
TIKI,may-anh,50875970,"Túi Máy Ảnh Case Logic SRLC 205 Black",479000,479000,0,0
TIKI,may-anh,152861797,"Tay cầm chống rung điện thoại Gimbal Zhiyun Smooth Q3 -  Gimbal 3 trục, thời lượng pin 10 giờ - Hàng chính hãng",1749000,2024000,275000,14
TIKI,may-anh,169920876,"Jack DC Nối Nguồn Đực/Cái 5.5x2.1mm - Jack Nối Nguồn Camera",2940,2940,0,0
TIKI,may-anh,10026885,"Camera Hành Trình SJCAM SJ4000 AIR - Hàng Chính Hãng",1133000,1168500,35500,3
TIKI,may-anh,4712527,"Dù Xuyên (85cm) - Hàng Nhập Khẩu",75000,75000,0,0
TIKI,may-anh,73338561,"Vỉ 2 viên Pin tiểu sạc AA 1.5V 3500mWh cao cấp sạc nhanh trực tiếp bằng cổng micro USB không cần bộ sạc kèm cáp sạc 2 đầu",215000,215000,0,0
TIKI,may-anh,7471247,"Loa che nắng EW-83F lens hood ống kính Canon 24-70 f2.8L USM",159000,159000,0,0
TIKI,may-anh,7615150,"Đế thao tác nhanh P200 Quick Release Plate",199000,199000,0,0
TIKI,may-anh,14844357,"Bộ 2 pin sạc và đốc sạc đôi KingMa NP-FZ100 cho Sony A9 A7III A7RIII - Hàng chính hãng",1049999,1049999,0,0
TIKI,may-anh,8194256,"Gậy nhôm cho Gopro 01",119000,119000,0,0
TIKI,may-anh,121414132,"Thẻ nhớ Micro SDHC 32GB/ 64GB/ 128GB Tốc Độ Cao Chuyện Dụng Cho Camera IP WiFi Camera Hành Trình",85000,85000,0,0
TIKI,may-anh,7388523,"Ống Nhòm Barska Lucid 10x42mm - Hàng chính hãng",1770000,1770000,0,0
TIKI,may-anh,20425151,"Combo hộp chống ẩm mini, ẩm kế điện tử, 200gram hạt hút ẩm xanh, mút xốp, khăn lau lens cho máy ảnh, máy quay phim - dung tích 4 lít - Hàng chính hãng",159000,159000,0,0
TIKI,may-anh,53410215,"Ống nhòm Barska Lucid View 10x42mm New - Hàng chính hãng",2430000,2430000,0,0
TIKI,may-anh,68454398,"Bóng thổi VSGO D-10318, Vệ sinh máy ảnh, ống kính, Hàng nhập khẩu",129999,129999,0,0
TIKI,may-anh,14104450,"Hạt Hút Ẩm Xanh Cho Máy Ảnh 200g Kèm Túi Đựng (Silica Gel) - Hàng Nhập Khẩu",32000,32000,0,0
TIKI,may-anh,4727085,"Bộ Chân Đèn Softbox Chụp Sản Phẩm E27 50x70cm - Hàng Nhập Khẩu",449000,449000,0,0
TIKI,may-anh,191684922,"Máy quay Insta360 ONE RS 1-Inch 360 Edition - Hàng Chính Hãng",20490000,20490000,0,0
TIKI,may-anh,166065434,"Camera Mini S12 Dùng Sim 4G Quay Video 4K FullHD 1080P Siêu Nét - Quan Sát Báo Động Chống Trộm Hồng Ngoại Đen -Hàng Cao Cấp",1250000,1250000,0,0
TIKI,may-anh,27147619,"Camera hành trình Full HD cho phượt thủ Sport Cam A9",189000,189000,0,0
TIKI,may-anh,31263500," Balun PV - Thiết Bị Video Balun Chuyển Đổi Cáp Đồng Trục Sang Cáp Mạng RJ45",45000,45000,0,0
TIKI,may-anh,24155057,"Remote Điều Khiển Từ Xa Cho Máy Ảnh Canon",44999,44999,0,0
TIKI,may-anh,108545320,"Sạc thay thế dành cho Sạc máy ảnh Panasonic (nhiều loại Sạc)",159999,159999,0,0
TIKI,may-anh,118089824,"Camera không dây wifi Imou C22EP độ nét Full HD quay quét, đàm thoại hai chiều - HÀNG CHÍNH HÃNG",441000,441000,0,0
TIKI,may-anh,7144625,"Túi đựng máy ảnh vải Caravan da chống thấm nước DG079",899000,899000,0,0
TIKI,may-anh,159482808,"Pin sạc Kingma Ver 3 cho Sony NP-FZ100 (Sạc Type C siêu nhanh), Hàng chính hãng",249999,249999,0,0
TIKI,may-anh,10334523,"Đế hít kính xoay 360 độ gắn GoPro Hero lên kính xe hơi",146000,146000,0,0
TIKI,may-anh,5849483,"Combo Chân Máy Ảnh Tripod Yunteng VCT-691 + Remote Cho Máy Ảnh (Giao Ngẫu Nhiên) - Hàng Nhập Khẩu",549999,549999,0,0
TIKI,may-anh,15261505,"Tấm tản sáng 50x70cm",78000,78000,0,0
TIKI,may-anh,111850128,"Chân Đế Camera Xoay 360 độ,Hàng Như Hình",15700,15700,0,0
TIKI,may-anh,52689273,"CAMERA APP YOOSEE WIFI NGOÀI TRỜI 3.0 SIÊU NÉT CHỐNG NƯỚC, HỖ TRỢ ĐÈN FLASH QUAY ĐÊM CÓ MÀU",420000,420000,0,0
TIKI,may-anh,14270619,"Chân máy ảnh/ Gậy chụp hình 3 chân dùng livestream - Tripod 3110, Tripod 3120 + Remote điều khiển",61560,64800,3240,5
TIKI,may-anh,109999894,"Vali kéo Safrotto M-19N, Hàng chính hãng",3149999,3149999,0,0
TIKI,may-anh,5524549,"Camera Hành Trình FULL HD 2590 Màn Hình 4.0 Elitek - Hàng Nhập Khẩu",529000,590000,61000,10
TIKI,may-anh,48445420,"CHÂN MÁY VCT-999 YUNTENG HỖ TRỢ CHỤP ẢNH hàng chính hãng",1299999,1299999,0,0
TIKI,may-anh,15396824,"Đèn Flash Godox TT600 for Canon - Hàng chính hãng",1499999,1499999,0,0
TIKI,may-anh,83744298,"Camera nội soi tai mũi họng - Camera Nội Soi Siêu Nhỏ, Siêu Nét, Tặng Kèm Bộ Lấy Ráy Tai",159000,159000,0,0
TIKI,may-anh,128871329,"Combo Camera Wi-fi EZVIZ C8C 2MP Ngoài Trời Kèm Thẻ Nhớ  32GB/64GB - Hàng Chính Hãng",1128900,1128900,0,0
TIKI,may-anh,4727887,"Remote Chụp Ảnh Bluetooth Cho Điện Thoại - Hàng Nhập Khẩu",18700,18700,0,0
TIKI,may-anh,1206291,"Tủ Chống Ẩm Nikatei NC-20C",1360000,1990000,630000,32
TIKI,may-anh,11370580,"Combo Giá đỡ chụp hình Tripod 3120 dành cho điện thoại, máy ảnh, tặng kẹp điện thoại",54100,54100,0,0
TIKI,may-anh,41819516,"Bộ Sản Phẩm Camera IP Dahua Imou A22EP 2.0mp và Thẻ Nhớ Sandisk 32Gb - Hàng Chính Hãng",498900,498900,0,0
TIKI,may-anh,199730658,"Camera Wifi không dây SHUJI UH715D -Lắp ngoài trời- Ban đêm có màu - Báo động hụ còi bật đèn khi có trộm đột nhập - Độ phân giải 4.0MP cho hình ảnh đẹp gấp đôi Full HD1080 - Hàng chính hãng",950000,950000,0,0
TIKI,may-anh,58984014,"THẺ NHỚ SDHC UHS-I EXCERIA KIOXIA 64GB - HÀNG NHẬP KHẨU",215000,215000,0,0
TIKI,may-anh,19986875,"Lens hood cho ống kính Canon 50mm F1.8  (Loa che nắng ES-68 II)",49000,49000,0,0
TIKI,may-anh,68242940,"  CAMERA WI-FI QUAN SÁT HỒNG NGOẠI EZVIZ C6N Full HD 1080p, chính hãng thương hiệu MỸ.",450000,450000,0,0
TIKI,may-anh,195881741,"Thẻ nhớ SDXC SanDisk Extreme U3 V30 256GB 180MB/s SDSDXVV-256G (New 2022) - Hàng Nhập Khẩu",785000,785000,0,0
TIKI,may-anh,44875056,"Remote Bluetooth Điều khiển Chụp hình từ xa cho Điện thoại (Mẫu Mới)",39000,39000,0,0
TIKI,may-anh,124274185,"Cục Nguồn Có Móc Treo 12V 2A Chống Nước",35000,35000,0,0
TIKI,may-anh,415086,"Chân Máy Ảnh Benro T880 EX (Tripod) - Hàng Chính Hãng",574999,574999,0,0
TIKI,may-anh,56936788,"Đế chân máy ảnh Benro T800/T880",69000,69000,0,0
TIKI,may-anh,166413465,"Chân Benro T890 kèm kẹp điện thoại và remote chân chính hãng",689999,689999,0,0
TIKI,may-anh,20410431,"Đầu Kết Nối Camera Jack BNC + Đuôi F5 Chất Lượng Cao Giá Rẻ + Bộ 10 Cái",38900,38900,0,0
TIKI,may-anh,9996258,"Kẹp ba lô gắn GoPro Hero xoay 360 độ",59000,59000,0,0
TIKI,may-anh,14261761,"Micro Thu Âm Wireliess UHF Boya BY-WM8 PRO-K2 (Bộ Thu 2 Micro) - Hàng Nhập Khẩu",3099000,3099000,0,0
TIKI,may-anh,101305869,"Combo hộp chống ẩm máy ảnh 3 lít (ẩm kế + hạt hút ẩm hoặc tùy chọn máy hút ẩm + mút xốp) - Hàng chính hãng",78000,78000,0,0
TIKI,may-anh,155996226,"Túi máy ảnh đeo chéo Artisan UX-1038",890555,890555,0,0
TIKI,may-anh,121327531,"Kính Hiển Vi Điện Tử Màn Hình Lớn 4.3inch",1888600,1988000,99400,5
TIKI,may-anh,19583159,"Tripod giá đỡ 3 chân mini để bàn cho điện thoại, gopro",75000,75000,0,0
TIKI,may-anh,22030633,"Camera IP Giám sát Trong Nhà Vitacam C1080 2.0mpx - Hàng Chính Hãng",380000,380000,0,0
TIKI,may-anh,192933630,"Film Instax Square Viền Trắng - Giấy in ảnh vuông cho máy chụp lấy liền Instax Square - Hàng Chính Hãng",580000,600000,20000,3
TIKI,may-anh,168571675,"Túi máy ảnh Peak Design Everyday Sling 6L Black Ver 2, Hàng chính hãng",3249999,3249999,0,0
TIKI,may-anh,175646985,"Camera Hành Động Thể Thao SJCAM Full HD 1080P Hàng Chính Hãng",1699000,2690000,991000,37
TIKI,may-anh,51295998,"Túi đeo máy ảnh Peak Design Everyday Sling v2 10L - Màu Đen - Hàng nhập khẩu",4249999,4249999,0,0
TIKI,may-anh,22635666,"Chân Đế Bluetooth Cho Điện Thoại, Máy Ảnh YunTeng VCT-5208RM - Hàng Nhập Khẩu - Tặng túi đựng tiện lợi qafa",279999,279999,0,0
TIKI,may-anh,160830444,"Ống nhòm du lịch, thể thao ngày và đêm 12,5 x 11 (cm)",79000,79000,0,0
TIKI,may-anh,4754651,"LED Yongnuo YN-1200 Pro - Hàng Nhập Khẩu",3719999,3719999,0,0
TIKI,may-anh,14241256,"Sạc Pin En-El3/El3E Cho Máy Ảnh Nikon D70/D50/D90/D80/D200/D300/D700 - Hàng Nhập Khẩu",119000,119000,0,0
TIKI,may-anh,36999883,"Ống nhòm 10X50 cao cấp ( Khoảng cách nhìn tốt nhất 10 - 1000m ) - Hàng nhập khẩu",380000,380000,0,0
TIKI,may-anh,175821489,"Micro thu âm không dây Boya BY-XM6-S2 - Hàng chính hãng",3180000,3650000,470000,13
TIKI,may-anh,49729246,"Pin CR2 ( Pin Panasonic CR-2W ) 3V Lithium 2 Viên - Hàng Chính Hãng",210000,210000,0,0
TIKI,may-anh,184883730,"CAMERA WIFI "YOOSEE" 4 râu 14 LED 5.0 MPX CỰC SÁNG. CẢNH BÁO CHỐNG TRỘM - Hàng chính hãng",550000,550000,0,0
TIKI,may-anh,4708403,"Bộ 4 Tấm Dính Và Gài Gopro - Hàng Nhập Khẩu",49000,49000,0,0
TIKI,may-anh,173860428,"Pin for BP-511A dung lượng cao 2500mAh dành cho máy ảnh Canon 10D, 20D, 30D, 40D, 50D, 5D, 300D",319000,319000,0,0
TIKI,may-anh,51297533,"Túi đeo máy ảnh Peak Design Everyday Sling v2 6L - Midnight - Hàng nhập khẩu",3999999,3999999,0,0
TIKI,may-anh,5403959,"Đầu kẹp 2 in 1 cho máy tính bảng và điện thoại vào chân máy ảnh ",59000,59000,0,0
TIKI,may-anh,15079790,"Sạc pin đôi NP-FW50 cho máy ảnh Sony Alpha A5000 A5100 A6000 A6300 A6500 A6400 A55 A33 Nex",159999,159999,0,0
TIKI,may-anh,92807565,"Kẹp gắn ống nhòm đa năng chuyên nghiệp",149000,149000,0,0
TIKI,may-anh,11233096,"Camera hành trình ",240000,240000,0,0
TIKI,may-anh,121331147,"sét 10mét Dây quai dệt, Bản 4cm dây đeo máy ảnh, cặp túi (hàng đẹp)",14000,14000,0,0
TIKI,may-anh,9982809,"Mount chuyển đổi ngàm GoPro Hero sang chuẩn ốc chân máy ảnh tripod 1/4 cái",29000,29000,0,0
TIKI,may-anh,53683384,"Tripod bạch tuột 3 chân MT35 xoay 360 độ siêu chắc cho máy ảnh, điện thoại - Chân đế uốn dẻo có thước đo cân bằng tích hợp sẵn giá đỡ điện thoại AnZ",224999,224999,0,0
TIKI,may-anh,114447618,"Camera IP Wifi Ezviz C6N 1080p-Hàng Chính Hãng",480000,480000,0,0
TIKI,may-anh,45075149," Tủ chống ẩm Andbon AD-30S (30 Lít) - Hàng Chính Hãng",1374999,1374999,0,0
TIKI,may-anh,270854138,"Hộp chống ẩm máy ảnh chuyên dụng Uteki dung tích 4.5 lít (cả ẩm kế + hạt hút ẩm)",220000,220000,0,0
TIKI,may-anh,73641065,"Camera IP Wifi IPC-A22EP-IMOU Chuẩn 1080P Tặng Thẻ nhớ Adata 32gb - Chính Hãng",599000,599000,0,0
TIKI,may-anh,40823013,"Dây cáp kết nối máy ảnh Canon với máy tính cho Canon 5D2 5D3 6D 6D2 760D 77D 7D 800D 80D D60 70D 600D 650D 700D 750D 1100D 1200D",51300,54000,2700,5
TIKI,may-anh,109628885,"Combo hộp chống ẩm máy ảnh10L rộng 37cm (tùy chọn hạt hút ẩm hoặc máy hút ẩm) - Hàng chính hãng",229000,229000,0,0
TIKI,may-anh,180536363,"Đầu Ghi Hình Hikvision 4 Kênh DS-7204HGHI-K1 Turbo HD 4.0 DVR Vỏ Sắt - Hàng chính hãng",865000,1200000,335000,28
TIKI,may-anh,155762494,"Bộ Camera hành trình (trước và sau) ô tô Xiaomi 70mai, bản Quốc Tế cao cấp A500S - Hàng Nhập Khẩu",3198000,3198000,0,0
TIKI,may-anh,22756323,"Gậy Tự Chụp Tay Cầm Chống Trượt cho Gopro Sjcam dài 49cm",75000,75000,0,0
TIKI,may-anh,109018502,"Bộ 2 pin 1 sạc Kingma cho Fujifilm NP-T125, Hàng chính hãng",2249999,2249999,0,0
TIKI,may-anh,7240827,"Chân Đèn Inox 280cm QIHE J288S",649000,649000,0,0
TIKI,may-anh,15271601,"1 Kg chống ẩm hạt xanh đậm tặng kèm 10 túi vải - Hàng chính hãng",99000,99000,0,0
TIKI,may-anh,173399655,"Chân đế dome gắn tường lắp cho các loại camera Ezviz , Imou, ONVIZCAM",9500,9500,0,0
TIKI,may-anh,14688674,"Chân Floor Dolly Yuntng VCT 900 \ Hàng Chính Hãng",849999,849999,0,0
TIKI,may-anh,714317,"Chân Máy Ảnh Benro TSL08AN00 - Hàng Chính hãng",1549999,1549999,0,0
TIKI,may-anh,7776627,"Mắt ngắm Eyecup Canon EG",79000,79000,0,0
TIKI,may-anh,191921264,"Giá đỡ điện thoại-kèm kẹp điện thoại 3 chân-điều khiển remote tương thích với nhiều dòng máy -Tripod TF 3120",30000,30000,0,0
TIKI,may-anh,146492088,"Nguồn Camera 5V 2A Chui Nhỏ",46500,46500,0,0
TIKI,may-anh,7775408,"Bộ vệ sinh máy ảnh đa năng-DKL-6 - Hàng Nhập Khẩu",293999,293999,0,0
TIKI,may-anh,109346768,"Dụng cụ vệ sinh, bộ vệ sinh máy ảnh VSGO (nhiều loại), Hàng chính hãng",99999,99999,0,0
TIKI,may-anh,56859238,"Túi đựng chân đèn",297000,297000,0,0
TIKI,may-anh,2533161,"Mắt Ngắm Canon JYC Eyecup EB (Đen)",49000,49000,0,0
TIKI,may-anh,28079545,"Camera Hành Trình Mắt To G30 1080P Full HD",198000,198000,0,0
TIKI,may-anh,3237829,"Chân Máy Ảnh Benro T880EX – Hàng Nhập Khẩu",599999,599999,0,0
TIKI,may-anh,68540931,"Đèn led video Ulanzi VIJIM VL196 RGB hàng chính hãng.",1040250,1095000,54750,5
TIKI,may-anh,6934987,"Godox Mini Camera Flash TT350S - Hàng Chính Hãng",1575999,1575999,0,0
TIKI,may-anh,25746302," Sạc Pin Máy Ảnh For Nikon EN-EL15",108999,108999,0,0
TIKI,may-anh,116790980,"Camera TP-Link Tapo C310 Wi-Fi An Ninh Ngoài Trời 3MP - Hàng Chính Hãng",750000,750000,0,0
TIKI,may-anh,13461376,"Dây cáp kết nối máy ảnh Canon với máy tính cho EOS M Nikon D3400",79000,79000,0,0
TIKI,may-anh,16206077," Gậy Chụp Ảnh 3 Khúc cho GoPro",79000,79000,0,0
TIKI,may-anh,4713155,"Nguồn POWER ADAPTER Cho LED Video Light YN-600, YN300-III, YN168, YN216, YN1410, YN300air, YN160III, YN360 - Hàng Nhập Khẩu",224999,224999,0,0
TIKI,may-anh,11858913,"Combo Bộ Giá đỡ chụp hình cho điện thoại, máy ảnh Tripod 3120 và Remote bluetooth",66000,66000,0,0
TIKI,may-anh,8275325,"Kẹp chuẩn ốc 1/4 gắn máy ảnh lên ghi đông xe",79000,79000,0,0
TIKI,may-anh,40758541,"Pin PB-511A cho máy ảnh Canon 30D , 40D , 50D , 5D - hàng nhập khẩu",214999,214999,0,0
TIKI,may-anh,118123982,"Linh Kiện Dây Mắt Ống Kính Camera 24 Chân Cho Camera Sử Dụng App Hdminicam / Lookcam / Lookcam pro 24 Chân",230000,230000,0,0
TIKI,may-anh,191437201,"Bộ Chia Nguồn Điện 8 Cổng Dc 12v Cho Camera An Ninh CCTV",30000,45000,15000,33
TIKI,may-anh,148908030,"Bóng đèn LED NẤM 155w có kèm Remote chỉnh sáng chuyên dụng cho các phòng Studio chụp ảnh, quay video, livestream",351000,351000,0,0
TIKI,may-anh,100050235,"Filter Kính lọc Hoya UV UX 40.5-82mm, Chính hãng",249999,249999,0,0
TIKI,may-anh,96437668,"Camera HDTVI 5MP có mic HIKVISION DS-2CE76H0T-ITPFS hàng chính hãng",680000,680000,0,0
TIKI,may-anh,8715377,"Túi đựng ống kính lens máy ảnh chống sốc cao tối đa 16cm",69999,69999,0,0
TIKI,may-anh,4707243,"Đầu Tripod Mini Ball Head - Hàng Nhập Khẩu",109000,109000,0,0
TIKI,may-anh,113823672,"Ống kính Zoom 12x Mobile Telephoto Lens cho điện thoại",175000,175000,0,0
TIKI,may-anh,159501797,"Pin sạc Kingma Ver 2 cho Fujifilm NP-W235, Hàng chính hãng",249999,249999,0,0
TIKI,may-anh,158886134,"Củ dầu/ Đầu ball quay Beike Q-08S có tay cầm dài, Hàng nhập khẩu",499999,499999,0,0
TIKI,may-anh,4754787,"Kẹp Điện Thoại 2 Lỗ Ốc 1/4 - Hàng Nhập Khẩu",39999,39999,0,0
TIKI,may-anh,16205976,"Pin Cho GoPro Hero AHDBT-401 1600mAh",99000,99000,0,0
TIKI,may-anh,26488114,"Dây Đeo Máy Ảnh Cổ Tay kiểu Paracord",80000,80000,0,0
TIKI,may-anh,188928154,"CAMERA WIFI "YOOSEE" 4 RÂU 17 ĐÈN 6.0 MPX. Xoay 360 độ - HÀNG CHÍNH HÃNG",550000,550000,0,0
TIKI,may-anh,74880794,"Hộp chống ẩm máy ảnh giá rẻ (nhiều loại)",159000,159000,0,0
TIKI,may-anh,135389902,"Jack POE Cấp Nguồn Camera Cặp 2 Cái",23999,23999,0,0
TIKI,may-anh,123547929,"Hộp kỹ thuật điện bảo vệ nguồn camera",8400,8400,0,0
TIKI,may-anh,82473707," Giá Treo Camera Hành Trình",35000,35000,0,0
TIKI,may-anh,3972601,"Chân đế mini- thiết bị ổn định cầm tay cho máy ảnh và điện thoại",99000,99000,0,0
TIKI,may-anh,10379586,"Magic arm tay nối đa năng dài 28cm và kẹp càng ghi đông kim loại nhôm",399000,399000,0,0
TIKI,may-anh,22362609,"Camera Giám Sát Ngoài Trời Yoosee X6100 - Mắt Camera 2.0Mpx - Hàng Chính Hãng",420000,420000,0,0
TIKI,may-anh,4738207,"Đầu Đọc Thẻ Nhớ SSK All In One III (Đen) - Hàng Nhập Khẩu",185000,185000,0,0
TIKI,may-anh,43714556,"Softbox tổ ong 60x90cm dành cho Godox ",902000,902000,0,0
TIKI,may-anh,111484952,"Hộp Kỹ Thuật Cho Camera 11cm x 11cm x 5cm",8900,8900,0,0
TIKI,may-anh,10735813,"Bao silicon bảo vệ Gopro 5, 6, 7",39000,39000,0,0
TIKI,may-anh,101305649,"Ốc chuyển đổi vít từ 1/4 sang 3/8 inch cho chân máy ảnh",20000,20000,0,0
TIKI,may-anh,48430140,"MIC THU ÂM CÀI ÁO CHO ĐIỆN THOẠI, MÁY ẢNH DSLR, MÁY QUAY BOYA BY-M1 hàng chính hãng",248000,248000,0,0
TIKI,may-anh,2343087,"Bộ pin sạc PanaSonic Eneloop 2550 Mah (Made in Japan) - Hàng chính hãng",420000,420000,0,0
TIKI,may-anh,108197896,"Chân máy quay Benro (nhiêu model), Hàng chính hãng",2949999,2949999,0,0
TIKI,may-anh,20866520,"Tripod TF 3110 kèm kẹp điện thoại - Hàng nhập khẩu",56000,62470,6470,10
TIKI,may-anh,7253235,"Lens cap 67mm nắp đậy bảo vệ ống kính máy ảnh phi 67mm",54900,54900,0,0
TIKI,may-anh,15853270,"Bàn Chụp Sản Phẩm 60x100cm",789000,789000,0,0
TIKI,may-anh,55406079,"Ống Nhòm Cao Cấp 10X42 Siêu Nét ( CHỐNG NƯỚC TỐT ) - Hàng Nhập Khẩu",899000,899000,0,0
TIKI,may-anh,20506397,"Tủ đựng đầu ghi camera giám sát kích thước 45*38*12",161000,161000,0,0
TIKI,may-anh,57720164,"Tripod Ulanzi MT-09 cho Gopro hàng chính hãng",230000,230000,0,0
TIKI,may-anh,162480743,"Hộp đựng thẻ nhớ CF, SD trong suốt",35000,35000,0,0
TIKI,may-anh,8582544,"Túi đựng ống kính lens máy ảnh chống sốc cao tối đa 8cm",43999,43999,0,0
TIKI,may-anh,159515133,"Pin sạc Kingma Ver 3 cho Fujifilm NP-W235 (Sạc Type C siêu nhanh), Hàng chính hãng",299999,299999,0,0
TIKI,may-anh,9992091,"Mount gắn GoPro Hero lên chân hot shoe máy ảnh",98000,98000,0,0
TIKI,may-anh,22172292,"Đầu Ghi Hình Camera IP Wifi Không Dây 4 Kênh NVR  - Hikvision DS-7104NI-Q1/M - Hàng chính hãng",1080000,1080000,0,0
TIKI,may-anh,415060,"Chân Máy Ảnh Benro T800 EX (Tripod) - Hàng Chính hãng",599999,599999,0,0
TIKI,may-anh,52355000,"Mount gắn phụ kiện đa năng PT-3 Ulanzi cho máy ảnh, máy quay hàng chính hãng",139000,139000,0,0
TIKI,may-anh,11856185,"Thẻ Nhớ Camera Yoosee 64GB, Tốc Độ Đọc Class 10 - Hàng Chính Hãng",170000,170000,0,0
TIKI,may-anh,104106318,"Ulanzi U-Vlog Lite - Tripod Cho Máy Ảnh, Có Cold Shoe Gắn Phụ Kiện, Tải Trọng 2kg - Hàng chính hãng",390000,390000,0,0
TIKI,may-anh,14815404,"Ống nhòm 2 mắt 3D siêu nét 30 X 60 dành cho đi phượt",88000,88000,0,0
TIKI,may-anh,17915655,"Pin máy ảnh cho Sony NP-BX1 1350mAh",121999,121999,0,0
TIKI,may-anh,71170013,"Đầu dầu tripod Beike Q-08 cho chân máy ảnh - hàng nhập khẩu",449999,449999,0,0
TIKI,may-anh,91632339,"Pin Cho Máy Ảnh Sony Li-ion 7.2V 2280mAh 16.4Wh NP-FZ100",331550,349000,17450,5
TIKI,may-anh,5895529,"Kính Lọc Filter Marumi Fit & Slim Lens Protect 43mm - Hàng Nhập Khẩu",264999,264999,0,0
TIKI,may-anh,14789413,"Kẹp cỡ lớn + Khớp nối xoay đa chiều Magic Arm 11″",263000,263000,0,0
TIKI,may-anh,56695614,"Kính thiên văn- Kính Viễn vọng VV01",349000,349000,0,0
TIKI,may-anh,142871700,"Mount đế chính gắn phụ kiện cho camera hành trình",20000,20000,0,0
TIKI,may-anh,120789125,"FULL BỘ SOFTBOX BÓNG ĐÈN BÚP NHÔM 50W,CHÂN ĐỨNG 2M , STUDIO, LIVESTREAM,CHỤP HÌNH QUAY PHIM",315000,315000,0,0
TIKI,may-anh,14143237,"1kg gói hạt hút ẩm loại 250gram sử dụng đa năng (1 dây 4 gói 250gram dạng treo)",99000,99000,0,0
TIKI,may-anh,58617330,"Hộp đựng thẻ nhớ SD CF XD XQD TF Kingma hàng chính hãng.",199999,199999,0,0
TIKI,may-anh,5899117,"Sạc Máy Ảnh Nikon MH-65 (Cho Pin EN-EL12) - Hàng Nhập Khẩu",164999,164999,0,0
TIKI,may-anh,48607273,"Chân Đế Dùng Cho Máy Ảnh Điện Thoại Kiểu Mới Tripod TTX--6218 - Hàng Nhập Khẩu - Tặng kèm remote và túi đựng tiện lợi",259999,259999,0,0
TIKI,may-anh,162480871,"Nắp cao su bảo vệ USB Canon 5D mark 2, Canon 5D mark 3",150000,150000,0,0
TIKI,may-anh,120789268,"Bộ đèn studio kèm softbox 50x70 có chân đèn, hỗ trợ hắt sáng chụp ảnh sản phẩm (Không bóng đèn)",255000,255000,0,0
TIKI,may-anh,71106062,"Camera không dây IMOU IPC-F22P 2.0Megapixels Full HD 1080P, 2 Anten, Chống nước IP67, hỗ trợ P2P, chuẩn tương thích ONVIF, góc nhìn rộng, tích hợp mic và loa",720000,720000,0,0
TIKI,may-anh,68446044,"BỘ VỆ SINH VSGO DKL-6-Hàng Nhập Khẩu",319999,319999,0,0
TIKI,may-anh,24343930,"Camera IP Wifi IPC-A22EP-IMOU Chuẩn 1080P- Chính Hãng",489000,489000,0,0
TIKI,may-anh,22023133,"Máy Hút Ẩm HC-63C Dùng Cho Máy Ảnh",194999,194999,0,0
TIKI,may-anh,134615561,"Bộ KIT Studio Chụp Ảnh Sản Phẩm Chân Đèn 2m Kèm Softbox 50x70 cm Hỗ Trợ Sáng(Không bóng đèn)",255000,255000,0,0
TIKI,may-anh,9442791,"Pin sạc đèn led NP-F770 dung lượng 4800mAh cho led Yongnou YN600",299999,299999,0,0
TIKI,may-anh,5895673,"Pin Máy Ảnh Nikon EN-EL12 - Hàng Nhập Khẩu",174999,174999,0,0
TIKI,may-anh,43717119,"Softbox tổ ong 22x90cm dành cho Godox ",735000,735000,0,0
TIKI,may-anh,8819557,"Bóng thổi bụi cho máy ảnh",79000,79000,0,0
TIKI,may-anh,2570645,"Kẹp Đa Năng For Gopro Sjcam - Hàng Nhập Khẩu",64999,64999,0,0
TIKI,may-anh,114208994,"Bộ 2 Pin + Dock sạc dành cho máy ảnh Sony A6000 - A6300 - A6500 - T098",650000,650000,0,0
TIKI,may-anh,5866409,"Tủ Chống Ẩm Andbon AD-80S (80 Lít) - Hàng Nhập Khẩu",2999999,2999999,0,0
TIKI,may-anh,147100090,"Tay cầm chống rung khi quay Camera tặng kèm giá đỡ điện thoại",250000,250000,0,0
TIKI,may-anh,120788940,"Ốc Vít Dài Gắn Phụ Kiện Camera Hành Trình Go Pro, SJCam",9780,9780,0,0
TIKI,may-anh,108991652,"Pin Kingma cho Sony BP-U60, Hàng chính hãng",1499999,1499999,0,0
TIKI,may-anh,9951164,"Đầu Ghi Hình HD 5MP 8 Kênh Chuẩn H.265 Pro+ HIKVISION DS-7208HUHI-K1 - Hàng chính hãng",3580000,3580000,0,0
TIKI,may-anh,54345278,"Phông nền nhựa PVC chụp ảnh sản phẩm màu đen",62000,62000,0,0
TIKI,may-anh,152297602,"Camera Dòng LITE 2MP FULL COLOR DH-HAC-HFW1239TLMP-A-LED Hàng chính hãng",750000,750000,0,0
TIKI,may-anh,956859,"Gậy 3 Chân Chụp Hình Tripod K3110",49300,49300,0,0
TIKI,may-anh,51296638,"Túi đeo máy ảnh Peak Design Everyday Sling v2 10L - màu ASH - Hàng nhập khẩu",4249999,4249999,0,0
TIKI,may-anh,8877900,"Miếng Dán Bảo Vệ Màn Hình Dành Cho Máy Ảnh Sony A6000/6300",46000,46000,0,0
TIKI,may-anh,247451087,"Camera IP Wifi Ngoài Trời Imou F22P Bullet 2C Full HD 1080P Tặng Phíc Cắm Âm - Hàng Chính Hãng",695000,695000,0,0
TIKI,may-anh,184758582,"TẶNG THẺ XỊN 64GB -CAMERA YOOSEE 5.0 MPX SIÊU SẮC NÉT, XEM ĐÊM FULL MÀU, CHỐNG NƯỚC TUYỆT ĐỐI, ĐÀM THOẠI 2 CHIỀU -HÀNG NHẬP KHẨU",428000,428000,0,0
TIKI,may-anh,2566021,"Hood ET-63 For Canon 55-250 STM - Hàng Nhập Khẩu",79000,79000,0,0
TIKI,may-anh,109596965,"Đầu quay Ball head Coman Q5S (có tay quay), Hàng chính hãng",1699999,1699999,0,0
TIKI,may-anh,19989121,"Pin máy ảnh cho Sony NP-BN1 1000mAh",189999,189999,0,0
TIKI,may-anh,16258412,"Bộ Sạc cho Pin  Fuji NP-W126",114999,114999,0,0
TIKI,may-anh,4707433,"Đèn LED Yongnuo 600 Air Bicolor - Hàng Nhập Khẩu",1524999,1524999,0,0
TIKI,may-anh,10369580,"Mũ nón lưỡi trai gắn GoPro Hero Action Cam",139000,139000,0,0
TIKI,may-anh,9961902,"Kẹp ghi đông kim loại siêu cứng gắn cho GoPro Hero nối dài",79000,79000,0,0
TIKI,may-anh,14053437,"Lens Hood Kim Loại Size 67mm - Hàng Nhập Khẩu",99000,99000,0,0
TIKI,may-anh,25501830,"Miếng Dán Màn Hình Cường Lực Cho Máy Ảnh Fujifilm XT1 XT2 XT3 XA10 XA3 XA5 XT10 XT20 X100T",59000,59000,0,0
TIKI,may-anh,57045100,"Pin sạc cho máy quay NP-FV50",219999,219999,0,0
TIKI,may-anh,25309442,"2 Pin + 1 Đốc sạc đôi Sony NP-FW50 - Chính hãng KingMa",147999,147999,0,0
TIKI,may-anh,4738361,"Lens Hood Có Ren Vặn Phi 67mm - Hàng Nhập Khẩu",79000,79000,0,0
TIKI,may-anh,15132981,"Gậy dùng livestream 3 chân - Tripod 3110",54958,58900,3942,7
TIKI,may-anh,155998235,"Tủ chống ẩm Andbon AB-30C (30 lít), Hàng chính hãng",1145555,1145555,0,0
TIKI,may-anh,125498960,"Camera Mini A9 Pro Hành Trình IP Camera FullHD 1080P WiFi Không Dây HD Quan Sát Ban Đêm IR Camera An Ninh Gia Đình Quan Sát Từ Xa",180000,180000,0,0
TIKI,may-anh,120788788,"Softbox Studio Chụp Ảnh Sản Phẩm 50cm * 70cm Hỗ Trợ Sáng đui 1",195000,195000,0,0
TIKI,may-anh,199996911,"Tấm hắt sáng tản sáng A4 để bàn đạo cụ hỗ trợ chụp sản phẩm",139000,139000,0,0
TIKI,may-anh,19992253,"Sạc pin máy ảnh Canon LP-E8 LPE8 sạc pin máy ảnh canon 550D 600D 650D 700D",144999,144999,0,0
TIKI,may-anh,58450646,"Tay boom đèn Inox MK MF-01 236cm có túi tải trọng.",1599000,1599000,0,0
TIKI,may-anh,19984497,"Cáp Camera Jack BNC liền nguồn 10m",91900,91900,0,0
TIKI,may-anh,151420605,"Đầu kẹp gắn tấm hắt ánh sáng phản quang hỗ trợ chụp ảnh studio",45000,45000,0,0
TIKI,may-anh,155996470,"Chân máy ảnh YUNTENG VCT-668 - Hàng Chính Hãng",439555,439555,0,0
TIKI,may-anh,35171810,"Chân giá đỡ Tripod Studio 2 Mét - Hàng nhập khẩu",82000,82000,0,0
TIKI,may-anh,34574906,"Camera lùi ô tô chất lượng 1080P",136000,145000,9000,6
TIKI,may-anh,159444424,"Pin sạc Kingma Ver 2 cho Sony NP-FW50, Hàng chính hãng",219999,219999,0,0
TIKI,may-anh,14071985,"1kg gói hạt hút ẩm loại 1gram dùng bảo quản thực phẩm (1000 gói 1gram)",89000,89000,0,0
TIKI,may-anh,52861988,"DÂY MÁY ẢNH ĐEO TAY  - CHÍNH HÃNG KHẮC TÊN",400000,400000,0,0
TIKI,may-anh,2545823,"Mắt Ngắm Dành Cho Nikon JYC Eyecup DK-25 (Đen) - Hàng Nhập Khẩu",59000,59000,0,0
TIKI,may-anh,144095252,"Dù tản sáng giá rẻ uy tín hỗ trợ làm dịu ánh sáng cho đèn flash phụ kiện studio",59000,59000,0,0
TIKI,may-anh,3307247,"Bàn xoay chụp sản phẩm 360 độ (25cm)",899000,1000000,101000,10
TIKI,may-anh,14088950,"Bộ Vệ Sinh Máy Ảnh 4 In 1",79000,79000,0,0
TIKI,may-anh,4727347,"Chân Máy Ảnh Benro T880 EX Và Kẹp Điện Thoại - Hàng Nhập Khẩu",609999,609999,0,0
TIKI,may-anh,153921048,"Camera IMOU Rex, Camera Xoay 360, AI Phát hiện người, đàm thoại 2 chiều, có màu ban đêm 2MP/4MP - Hàng Chính Hãng",850000,850000,0,0
TIKI,may-anh,71368081,"Tủ chống ẩm Huitong AD-120, 120 lit, Hàng nhập khẩu",4499999,4499999,0,0
TIKI,may-anh,50586365,"Gói hút ẩm Silicagel loại 200gram (1kg có 5 gói, kích thước 11x18cm)",99000,99000,0,0
TIKI,may-anh,45123323,"Bộ sạc pin đa năng Jiabao A-612, sạc pin AA, AAA,pin vuông 9V",70965,74700,3735,5
TIKI,may-anh,73476077,"Camera IP Wifi IMOU IPC A22EP chuẩn 1080P Xoay 360 độ -  hàng chính hãng",489000,489000,0,0
TIKI,may-anh,163577746,"Kính lọc B+W XS-Pro Digital 010 UV-Haze MRC nano - Hàng chính hãng",900555,900555,0,0
TIKI,may-anh,2533217,"Dây Đeo Máy Ảnh Bản Nhỏ SILK 2cm For Mirroless - Màu Ngẫu Nhiên",120000,120000,0,0
TIKI,may-anh,3482321," Túi Đựng Filter 6 Cái",79000,79000,0,0
TIKI,may-anh,42631737,"Trọn bộ tripod giá đỡ 3 chân 1.4m cao cấp kèm phụ kiện kẹp điện thoại hỗ trợ livestream 4 máy cùng lúc",580000,580000,0,0
TIKI,may-anh,55410457,"Ống Nhòm 20x50 Siêu Nét ( TẦM NHÌN XA HÀNG Kilomet ) - HÀNG NHẬP KHẨU",850000,850000,0,0
TIKI,may-anh,149765864,"Micro thu âm Boya BY-MM1, Hàng chính hãng",529999,529999,0,0
TIKI,may-anh,14104442,"Đế Chân Vịt Giữ Đèn Flash - Hàng Nhập Khẩu",59000,59000,0,0
TIKI,may-anh,71347321,"Tủ chống ẩm Huitong AD-040, 40 lit, Hàng nhập khẩu",1549999,1549999,0,0
TIKI,may-anh,5876305,"Kính lọc Filter Hoya HMC UV 82mm - Hàng nhập khẩu",699999,699999,0,0
TIKI,may-anh,195721927,"Dây đeo cổ dành cho máy ảnh mirrorless màu đỏ cam - 003",79000,79000,0,0
TIKI,may-anh,10111358,"Camera Hikvision DS-2CE16D0T-IRP-Hàng Chính Hãng",438000,438000,0,0
TIKI,may-anh,178594259,"Camera IP Wifi 2.0MP Full HD GLOBAL IOT 07, Xoay 360, Đàm thoại 2 chiều, Theo dõi chuyển động - Hàng chính hãng",490000,490000,0,0
TIKI,may-anh,6911309,"Pin sạc Li-ion Godox VB-18 cho Flash Godox V850 V860II - Hàng chính hãng",620000,620000,0,0
TIKI,may-anh,7093365,"Loa che nắng hood EW-53 Canon M10 ống kính 15-45 STM",49000,49000,0,0
TIKI,may-anh,108079641,"Combo Pin sạc Kingma for Nikon EN-EL15, Hàng chính hãng",169999,169999,0,0
TIKI,may-anh,21126896,"Softbox Godox (60 x 90 cm) - Hàng nhập khẩu",484000,484000,0,0
TIKI,may-anh,14241263,"Tản Sáng Cho Đèn Flash 5 In 1 (Đen Trắng) - Hàng Nhập Khẩu",179000,179000,0,0
TIKI,may-anh,50774028,"Sạc pin đôi LCD NP-FZ100 ",219999,219999,0,0
TIKI,may-anh,11054167,"Mount gắn cùng lúc 2 thiết bị dùng cho Gopro, Sjcam",89000,89000,0,0
TIKI,may-anh,21754137,"Sạc Pin NP-FZ100 cho Sony A9/A7RIII/A7III",119000,119000,0,0
TIKI,may-anh,8144699,"Hand strap đơn dây đeo tay máy ảnh thao tác nhanh",59000,59000,0,0
TIKI,may-anh,108982669,"Sạc Kingma BM048 cho Sony NP-F970, Hàng chính hãng",299999,299999,0,0
TIKI,may-anh,4755375,"Cap Che Bảo Vệ Gopro 5 - Hàng Nhập Khẩu",39000,39000,0,0
TIKI,may-anh,193764243,"Bộ camera lùi, camera lề xe tải và màn hình AHD 7inch siêu nét cả ngày và đêm",1500000,1500000,0,0
TIKI,may-anh,109020482,"Pin Kingma cho Fujifilm NP-T125, Hàng chính hãng",799999,799999,0,0
TIKI,may-anh,2570657,"Chân Đèn Victory Lớn Cao (250cm) - Hàng Nhập Khẩu",309000,309000,0,0
TIKI,may-anh,26086590,"KÍNH LỌC HOYA UX UV SIZE 55MM - Hàng Chính Hãng",369999,369999,0,0
TIKI,may-anh,8332561,"Tản sáng softbox đèn Flash kích thước 20cm x 30cm - Có túi đựng",90000,90000,0,0
TIKI,may-anh,271453857,"Thẻ nhớ Pháp micro",60000,60000,0,0
TIKI,may-anh,175196303,"Tripod Celestron 1m25  Hàng chính hãng màu đen, nhỏ gọn dễ mang theo di chuyển có túi đi kèm",770000,770000,0,0
TIKI,may-anh,244169117,"Camera  Wifi EZVIZ C3TN 1080P-hàng chính hãng",785000,785000,0,0
TIKI,may-anh,4738357,"Lens Hood Có Ren Vặn Phi 72mm - Hàng Nhập Khẩu",69000,69000,0,0
TIKI,may-anh,193878065,"MÓC KHOÁ DÂY ĐEO THAO TÁC NHANH PEAK DESIGN ANCHOR LINKS V2 - Hàng chính hãng",345000,345000,0,0
TIKI,may-anh,141606165,"Sạc pin AA 40 viên màn hình LCD DoublePow DP-K50",10459000,10459000,0,0
TIKI,may-anh,4689001,"Softbox Bát Giác (30cm) - Hàng Nhập Khẩu",199000,199000,0,0
TIKI,may-anh,4712953,"Phòng Thay Đồ Di Động Lớn Tráng Bạc, Chống Nhìn Xuyên - Hàng Nhập Khẩu",539000,539000,0,0
TIKI,may-anh,4727827,"Nước Lau Lens Và Sensor Máy Ảnh JJC - Hàng Nhập Khẩu",159000,159000,0,0
TIKI,may-anh,15257931,"Hắt sáng 2 in1 đường kính 110cm",196668,196668,0,0
TIKI,may-anh,108344935,"Pin Kingma for Canon LP-E17 - Hàng chính hãng",299999,299999,0,0
TIKI,may-anh,120462989,"Gậy 3 Chân Livestream Có Thế Kẹp Được 3 Điện Thoại Cùng Lúc",75050,79000,3950,5
TIKI,may-anh,34509537,"Dây đeo máy ảnh thao tác nhanh bản 2.5cm",180000,180000,0,0
TIKI,may-anh,15669226,"Micro Thu Âm Cài Áo Rode Smartlav Plus - Hàng Chính Hãng",1640000,1640000,0,0
TIKI,may-anh,7471335,"Loa che nắng HB-32 cho ống kính Nikon 18-140mm f:3.5-5.6G ED VR",79000,79000,0,0
TIKI,may-anh,71687519,"Tủ chống ẩm Dry Cabi DHC-40, 40 Lít, Hàng nhập khẩu",1799999,1799999,0,0
TIKI,may-anh,20706890,"Nắp Đậy Ống Kính Phi cho  Sony 40.5mm",39000,39000,0,0
TIKI,may-anh,6886367,"Gray Card - Thẻ cân bằng trắng 3in1 có dây đeo cổ",49000,49000,0,0
TIKI,may-anh,4707329,"Dù Xuyên Trắng (85cm) - Hàng Nhập Khẩu",129000,129000,0,0
TIKI,may-anh,204643466,"Khung L Plate thanh bảo vệ máy ảnh dành cho Sony A7III/ARIII/A9",299000,299000,0,0
TIKI,may-anh,14241266,"Tấm Hắt Sáng Hình Tròn 5 In 1 (80cm) - Hàng Nhập Khẩu",182666,182666,0,0
TIKI,may-anh,159434173,"Pin sạc Kingma Ver 3 cho Nikon EN-EL25 (Sạc Type C siêu nhanh), Hàng chính hãng",299999,299999,0,0
TIKI,may-anh,54348747,"Phông nền nhựa PVC chụp ảnh sản phẩm màu đỏ",261000,261000,0,0
TIKI,may-anh,7405399,"Loa che nắng hood ET-54B Canon M10 ống kính EF-M 55-200mm STM",69000,69000,0,0
TIKI,may-anh,197856870,"Flycam Mini Giá Rẻ Drone M1S Cải Tiến Với 3 Mắt Camera 4K có cảm biến tránh va chạm, động cơ không chổi than siêu bền bỉ, chuyền hình ảnh trực tiếp về điện thoại - Hàng Chính hãng Asport",716000,1500000,784000,52
TIKI,may-anh,112331456,"Pin 9V POWER dùng cho bộ test mạng, mic hát...cực bền,giá rẻ - Home Computer",13000,13000,0,0
TIKI,may-anh,59288875,"Trọn Bộ Camera IP Imou IPC-A22EP 2.0mp và Thẻ Nhớ DSS 32Gb - Hàng Chính Hãng",550000,550000,0,0
TIKI,may-anh,2416085,"Ba lô chuyên dụng đựng máy ảnh DSLR- JL45",399000,399000,0,0
TIKI,may-anh,64434112,"Chân Máy Quay Phim, Chụp Ảnh, Livestream Tripod LT02 - Hàng Nhập Khẩu",284050,299000,14950,5
TIKI,may-anh,139934201,"Lưới ba lớp then 2 cao 80cm dài 70m ",162900,162900,0,0
TIKI,may-anh,7325021,"Lens cap 58mm nắp đậy bảo vệ ống kính máy ảnh phi 58mm",33900,33900,0,0
TIKI,may-anh,195881651,"Thẻ nhớ SDXC SanDisk Extreme U3 V30 128GB 180MB/s SDSDXVA-128G (New 2022) - Hàng Nhập Khẩu",410000,410000,0,0
TIKI,may-anh,4713017,"Chân Máy Ảnh Chuyên Nghiệp Tripod Beike Q308 - Hàng Nhập Khẩu",699999,699999,0,0
TIKI,may-anh,59271667,"Camera Mini IP Vstarcam CB73 2.0 WiFi 1080P Giám Sát Hành Trình Ô Tô, Nhỏ Gọn, Dễ Dàng Cài Đặt, Bảo Mật Cao, Chống Chộm, Xem Trực Tiếp Từ Xa Bằng Điện Thoại, PC, iPad - Hàng Chính Hãng",549000,549000,0,0
TIKI,may-anh,196374620,"Camera quan sát Eufy Indoor 2K Pan and Tilt T8410 - Hàng chính hãng",1149000,1190000,41000,3
TIKI,may-anh,196373083,"Tay cầm gimbal S5B chống rung 3 trục cho điện thoại đa chế độ quay phim, chụp ảnh tự động cân chỉnh, xoay 360 độ",1455000,3000000,1545000,52
TIKI,may-anh,197663342,"Máy Bay Điều Khiển Từ Xa Vinetteam Flycam P5 PRO Camera Kép Quadcopter UAV Với Bản Nâng Cấp 720P / 1080P / 4K HD FPV E88 Pro GPS WiFi Cảm Biến Chướng Ngại Vật - Hàng Nhập Khẩu",499000,650000,151000,23
TIKI,may-anh,10758508,"Máy Ảnh Sony Alpha A6400 - Hàng Chính Hãng - Body + Kit 16-55mm",21990000,21990000,0,0
TIKI,may-anh,56939825,"Máy Ảnh Sony ZV-1 - Chính Hãng",16990000,16990000,0,0
TIKI,may-anh,33078123,"Camera IP Wifi Dahua Imou IPC-A22EP 2.0mpx Full HD - Hàng Chính hãng",489000,489000,0,0
TIKI,may-anh,159444568,"Pin sạc Kingma Ver 3 cho Sony NP-FW50 (Sạc Type C siêu nhanh), Hàng chính hãng",249999,249999,0,0
TIKI,may-anh,166477553,"Camera hành trình ô tô Xiaomi 70mai M500 kết nối Wifi - Hàng Nhập Khẩu",2771000,2771000,0,0
TIKI,may-anh,194134059,"Camera Wifi PTZ Ngoài Trời EZVIZ C8PF 2MP 1080P Zoom 8x Quay Quét 355 độ Tích Hợp Ai - Đàm Thoại 2 Chiều - Hàng Chính Hãng",1450000,1450000,0,0
TIKI,may-anh,141788623,"Camera mini wifi an ninh HDQ15 kết nối từ xa qua điện thoại từ xa, có hồng ngoại quay đêm 10m, có pin, không dây",342000,700000,358000,51
TIKI,may-anh,70773631,"Kính thiên văn BARSKA Starwatcher  30070 - 225 Power  - Hàng chính hãng",3256000,3256000,0,0
TIKI,may-anh,247774893,"1kg Gói hút ẩm sililcagel đủ size",19000,19000,0,0
TIKI,may-anh,15927481,"Micro Thu Âm Đa Năng BOYA BY-MM1 - Hàng Chính Hãng",428000,428000,0,0
TIKI,may-anh,54096839,"Đèn Led Trợ Sáng Cho Máy Ảnh, Điện thoại Ulanzi VL49 - Hàng Nhập khẩu",270000,270000,0,0
TIKI,may-anh,73987786,"Balo máy ảnh Lowepro Protactic 350 AW II, Hàng chính hãng",4074999,4074999,0,0
TIKI,may-anh,96650312,"Gimbal Zhiyun Smooth Q3 chống rung cho điện thoại - Hàng chính hãng",1749000,2024000,275000,14
TIKI,may-anh,7530741,"Ống Kính Viễn Vọng Chống Nước Barska Blackhawk 20-60x60mm WP - Hàng chính hãng",7843000,7843000,0,0
TIKI,may-anh,155997313,"Ba lô máy ảnh Benro RANGER 500N - Hàng Chính Hãng",3350555,3350555,0,0
TIKI,may-anh,32454377,"Chân Máy Ảnh Tripod Yunteng VCT-5208 - Hàng Nhập Khẩu",264999,264999,0,0
TIKI,may-anh,197100688,"Tủ chống ẩm máy ảnh 30 lít điện tử Andbon, Tủ hút ẩm đựng máy ảnh 30l hai ngăn có xốp chống nước tiết kiệm điện dry cabinet - Hàng Nhập Khẩu",1418000,1418000,0,0
TIKI,may-anh,44014086,"Sạc pin đôi NP-W126 /NP-W126S cho máy ảnh Fujifilm X-A3 X-A10 X-A5 X-E X-T10 X-T20",164999,164999,0,0
TIKI,may-anh,23413669," Kính thiên văn cao cấp Carson AIM MTEL-50 - Hàng chính hãng",3100000,3100000,0,0
TIKI,may-anh,195741924,"Máy ảnh kỹ thuật số ZV-1 | Hàng Chính Hãng",18990000,18990000,0,0
TIKI,may-anh,12391035,"Camera Hành Trình Xe Ô Tô WDR X600 FULL HD 1080P AZONE",399000,399000,0,0
TIKI,may-anh,193922240,"Kính hiển vi kỹ thuật số soi nổi TERINO 1000X-WFHD (Phóng đại 1000X, WiFi) - Hàng Chính Hãng",2915000,2915000,0,0
TIKI,may-anh,275122,"Balo Máy Ảnh Benro Traveler 100 (2 Quai)",1599999,1599999,0,0
TIKI,may-anh,20996983,"Nguồn 12v 1A",30000,30000,0,0
TIKI,may-anh,153281315,"Kính hiển vi kỹ thuật số có màn hình 600X HD lens ",1980000,1980000,0,0
TIKI,may-anh,16717623,"Chân máy ảnh Tripod 3120 tặng Giá kẹp điện thoại, Remote và Túi đựng",74000,74000,0,0
TIKI,may-anh,195745395,"Máy Ảnh Sony Alpha 7 Mark IV Body - A7M4 | Hàng Chính Hãng",61990000,61990000,0,0
TIKI,may-anh,155885698,"Combo Mount chuyển ngàm gopro sang vít 1/4 inch và gá kẹp ipad, điện thoại",129000,129000,0,0
TIKI,may-anh,193516638,"Kính hiển vi 3 mắt công nghiệp Terino SMD-11HT (Phóng đại 7x-45X, hỗ trợ đèn cực tím UV/Led trắng) - Hàng Chính Hãng",9350000,9350000,0,0
TIKI,may-anh,107182555,"Camera IP WIFI IMOU RANGER 2 IPC - A22EP Full HD 1080P ,KÈM THẺ NHỚ 32G - Hàng Chính Hãng",651000,651000,0,0
TIKI,may-anh,252726824,"Camera V13 WiFi FullHD 1080P Siêu Nét - Quan Sát Báo Động Chống Trộm, Model Mới Theo Dõi Từ Xa Trên Điện Thoại Mọi Lúc Mọi Nơi",795000,795000,0,0
TIKI,may-anh,101305701,"Khăn lau máy ảnh, camera, ống kính",25000,25000,0,0
TIKI,may-anh,15971921,"Giá đỡ 3 chân Selfie Tripod 3110 Cho điện thoại và máy ảnh tặng kèm túi cải cá tính",49099,49099,0,0
TIKI,may-anh,140917011,"Camera IP Wifi Imou IPC-C22SP-imou - Hàng chính hãng",418900,418900,0,0
TIKI,may-anh,135389860,"50 Jack DC Nối Nguồn Camera - Đầu nguồn DC camera đỏ đen",90000,90000,0,0
TIKI,may-anh,100031979,"Chân máy ảnh Beike QZSD-111/Q111, Hàng nhập khẩu",499999,499999,0,0
TIKI,may-anh,58405493,"Kính hiển vi sinh học soi tinh trùng, ấu trùng, tế bào Barska AY13286 (40x-640x) - Hàng chính hãng",3619000,3619000,0,0
TIKI,may-anh,51844900,"Camera Hành Trình Wifi 1080p Full HD Dành Cho Ô Tô FC106T PD",439000,439000,0,0
TIKI,may-anh,43110502,"Go Motion 360 Time Lapse Adapter For Camera",199000,199000,0,0
TIKI,may-anh,109089988,"Pin Kingma cho Fujifilm NP-W235, Hàng chính hãng",449999,449999,0,0
TIKI,may-anh,201176482,"Vải phông nền chụp ảnh, Vải chụp ảnh - Chất đũi Camcamvintage",69000,69000,0,0
TIKI,may-anh,197723947,"Máy Bay Điều Khiển Từ Xa Vinetteam Flycam K101 Max Camera Kép Quadcopter UAV Với Bản Nâng Cấp 720P/1080P/4K HD FPV GPS WiFi Cảm Biến Chướng Ngại Vật Chất Hơn F11 Pro 4k, Mavic 2 Pro, l900 Pro - Hàng Chính Hãng",1099000,1200000,101000,8
TIKI,may-anh,125286110,"Máy Quay DJI Mini SE Basic/Combo - Hàng Nhập Khẩu",9945000,9945000,0,0
TIKI,may-anh,252272278,"Camera IP wifi không dây IMOU F42P, F42FP, F42FEP siêu nét đàm thoại 2 chiều - Hàng chính hãng",779000,1300000,521000,40
TIKI,may-anh,7145663,"Túi đựng máy ảnh vải Caravan da chống thấm nước DG068",799000,799000,0,0
TIKI,may-anh,22561927,"Camera IP Wifi Ngoài Trời NetCAM NTL 2.0 Full HD 1080P - Hàng Chính Hãng",569000,569000,0,0
TIKI,may-anh,28079324,"Camera Hành Trình Hai Camera Kép Xoay 180 Độ Góc Siêu Rộng X8000 Kèm Định vị GPS",890000,890000,0,0
TIKI,may-anh,415050,"Chân Máy Ảnh Benro T600 EX (Tripod) - Hàng Chính Hãng",489999,489999,0,0
TIKI,may-anh,193702946,"GẬY 3 CHÂN BẠCH TUỘC SIÊU DẺO - TRIPOD 3 CHÂN - JL",20000,20000,0,0
TIKI,may-anh,103662425,"Camera Ngoài Trời Imou Bulet 2C 4MP, Chống nước IP67, Chuẩn nén H265, Theo dõi chuyển động, Quay Màu ban đêm - Hàng chính hãng",998000,998000,0,0
TIKI,may-anh,142238733,"Tay cầm chống rung cho điện thoại Gimbal Zhiyun Smooth 5 - Hàng Chính Hãng",3090000,3090000,0,0
TIKI,may-anh,195867388,"Camera hành trình xe tải Wintosee H5- Không GPS - dây cam sau 15m",1389000,1389000,0,0
TIKI,may-anh,15669129,"Micro Thu Âm Gắn Máy Rode Videomic Pro+ - Hàng Chính Hãng",7860000,7860000,0,0
TIKI,may-anh,168042646,"Flycam ZLRC SG108 Pro, Động cơ không chổi than, Gimbal chống rung 2 trục - Hàng nhập khẩu",2349000,2349000,0,0
TIKI,may-anh,24442797," Ống nhòm cao cấp Carson Tracker TZ-821 - Hàng chính hãng",1510000,1510000,0,0
TIKI,may-anh,10756629,"Máy Ảnh Sony Alpha A6400 - Hàng Chính Hãng - Body",19390000,19390000,0,0
TIKI,may-anh,108092399,"Sạc đôi Kingma for Canon NB-13L - Hàng chính hãng",249999,249999,0,0
TIKI,may-anh,72040737,"Camera Hành Trình Dành Cho Xe Máy Kèm 2 Camera Sau Chống Nước Cao Cấp MT208",741000,780000,39000,5
TIKI,may-anh,148898200,"Máy ảnh Sony A7IV Body (ILCE-7M4) - Hàng Chính Hãng	",56990000,56990000,0,0
TIKI,may-anh,20244830,"Máy Ảnh Mini Cho Bé Kèm Thẻ Nhớ 32G - Máy Chụp Hình Mini (Giao Mẫu Ngẫu Nhiên)",499000,499000,0,0
TIKI,may-anh,177463953,"Flycam DJI Mavic Air 2S Combo - Hàng chính hãng",31690000,31690000,0,0
TIKI,may-anh,7886763,"Ống nhòm một mắt Konus Small 2 7-17x30 - Hàng chính hãng",1500000,1500000,0,0
TIKI,may-anh,168501634,"12 inch Màn hình cảm ứng IPS chiếu hậu ô tô máy ảnh ghi hình với thẻ nhớ MICRO SD 64G (4K) WIFI 2160P + 1080P",2992000,2992000,0,0
TIKI,may-anh,127120714,"máy chụp hình của bé màu xanh ngọc - tặng thẻ nhớ 32G",290000,290000,0,0
TIKI,may-anh,43107996,"Ống Nhòm Một Mắt Tầm Nhìn 8000m - Hàng Nhập Khẩu",88000,88000,0,0
TIKI,may-anh,195867355,"Tặng thẻ xịn 32CAMERA HÀNH TRÌNH 4K WINTOSEE V8 HÌNH ẢNH SIÊU NÉT, CẢNH BÁO THÔNG MINH ADAS CÓ GPS",1489000,1489000,0,0
TIKI,may-anh,5899493,"Tủ Chống Ẩm Andbon AD-30C(30 lít) - Hàng Nhập Khẩu",1349999,1349999,0,0
TIKI,may-anh,31246395,"Camera Hành Trình Wifi 1080p Full HD Dành Cho Ô Tô FC106T  Cao Cấp AZONE",529000,565000,36000,6
TIKI,may-anh,25625706,"Camera Hành Trình Dành Cho Xe Máy Kèm 2 Camera Sau Chống Nước Cao Cấp MT208 AZONE",730000,780000,50000,6
TIKI,may-anh,205476178,"Camera Wifi Ezviz C1C CS-C1C-E0-1E2WF 1080P - Hàng Chính Hãng",590000,590000,0,0
TIKI,may-anh,58729250,"Ống Kính Viltrox 23mm F1.4 Auto Focus cho Fujifilm Hàng nhập khẩu ",6299000,6299000,0,0
TIKI,may-anh,97379586,"Gimbal chống rung Zhiyun Smooth Q3 - Hàng Nhập Khẩu",1799000,1799000,0,0
TIKI,may-anh,109545963,"Chân máy ảnh Monopod Coman DK327AQ5S, Hàng chính hãng",2649999,2649999,0,0
TIKI,may-anh,19890061,"Dây đeo ngực cho camera hành trình, camera hành động",69000,69000,0,0
TIKI,may-anh,40024125,"THẺ NHỚ SONY 64GB SDXC UHS-II 277MB/S (SF-M64/T2) | Hàng Chính Hãng",1600000,1600000,0,0
TIKI,may-anh,81206309,"Camera Eufy Security Indoor Cam 2K Công nghệ AI Âm thanh 2 chiều - Hàng Chính Hãng",800000,930000,130000,14
TIKI,may-anh,175814384,"Camera IP wifi trong nhà Imou Ranger 2C - IPC-TA22CP-D - Hàng chính hãng",464000,464000,0,0
TIKI,may-anh,191437162,"Trọn bộ 8 Camera + Đầu ghi hình Hikvision, có sẵn phụ kiện, cắm điện là chạy - Hàng chính hãng",4950000,4950000,0,0
TIKI,may-anh,124276374,"Camera Hành Trình Xe Máy Chống Nước FULL HD 1080P A9",188000,188000,0,0
TIKI,may-anh,135812254,"Thẻ nhớ 64gb MIXIE  MicroSD  Class10 U3. Hàng Chính Hãng",86000,86000,0,0
TIKI,may-anh,57315763,"Ống nhòm một mắt chống nước Carson WM-025 BLACKWAVE - Hàng chính hãng",1630000,1630000,0,0
TIKI,may-anh,4688661,"Chân Máy Tripod Benro Ismart IS05 - Hàng Nhập Khẩu",1264000,1264000,0,0
TIKI,may-anh,141606175,"Sạc pin Doublepow DP-UK83 tự ngắt, chuyên dụng sạc pin AA/AAA, 4 khe sạc được 4 viên pin AA hoặc AAA hàng chính hãng",1089000,1089000,0,0
TIKI,may-anh,212236083,"Camera Wifi Ezviz C3X 2MP 1080P Ngoài Trời Bản Mắt Kép, Có Màu Ban Đêm, AI Thông Minh - Hàng Chính Hãng",1799000,2900000,1101000,38
TIKI,may-anh,133436638,"Ống kính Sigma 18-50mm F/2.8 DC DN (C) Sony E- mount Hàng chính hãng	",11990000,11990000,0,0
TIKI,may-anh,48428913,"TRIPOD MÁY ẢNH, MÁY QUAY CHUYÊN NGHIỆP CAO 1.65M YUNTENG VCT-690 hàng chính hãng",499999,499999,0,0
TIKI,may-anh,55617977,"Pin Máy Ảnh Sony Np Fz100 Ravpower - Chính hãng",599999,599999,0,0
TIKI,may-anh,70824025,"Kính viễn vọng  Carson RP-200SP zoom 25-56x80mm đi kèm với một bộ điều hợp điện thoại thông minh - Hàng chính hãng",11800000,11800000,0,0
TIKI,may-anh,109879080,"Túi máy ảnh Safrotto SF002, Hàng chính hãng",1049999,1049999,0,0
TIKI,may-anh,23838438," Kính hiển vi bỏ túi Carson MicroMini MM-280B 20x (có đèn LED, đèn tia cực tím UV kiểm tra tiền) - Hàng chính hãng",714000,714000,0,0
TIKI,may-anh,201891429,"Tay cầm gimbal DJI Osmo Mobile SE - Gimbal chống rung điện thoại ổn định mượt mà với 3 trục, tính năng active track phiên bản nâng cấp - Hàng chính hãng",2288000,2500000,212000,8
TIKI,may-anh,109885923,"Túi máy ảnh Safrotto SF003, Hàng chính hãng",1099999,1099999,0,0
TIKI,may-anh,23478407,"Camera hành trình SJCAM A10 - Hàng Nhập Khẩu",2386000,2479000,93000,4
TIKI,may-anh,160357978,"Camera S12 Dùng Sim 4G Quay 4K FullHD 1080P Siêu Nét - PIN 2-3 Ngày Quan Sát Báo Động Chống Trộm Chế Độ PIR Hồng Ngoại Đen",1250000,1250000,0,0
TIKI,may-anh,5849307,"Chân Máy Ảnh Monopod Weifeng WT-1003 - Hàng Nhập Khẩu",271999,271999,0,0
TIKI,may-anh,24200491," Ống nhòm đêm cao cấp có quay phim, chụp ảnh kỹ thuật số Carson NV-250 Aura Plus - Hàng chính hãng",13400000,13400000,0,0
TIKI,may-anh,194133335,"Camera Wifi Trong Nhà Ngoài Trời PTZ EZVIZ C8W 4MP 2K+ Quay Quét 355 độ Tích Hợp Ai - Đàm Thoại 2 Chiều - Có Màu Ban Đêm - Hàng Chính Hãng",1350000,1350000,0,0
TIKI,may-anh,178077780,"Camera Wi-Fi EZVIZ BC2 Không Dây, FHD 1080P, Pin Sạc 2000 mAh, Đàm Thoại 2 Chiều - Hàng Chính Hãng",1599000,2200000,601000,27
TIKI,may-anh,5849599,"Chân Máy Ảnh Tripod/ Monopod Q-999 - Hàng Nhập Khẩu",1049999,1049999,0,0
TIKI,may-anh,24409730,"Ống kính Yongnuo 50mm F1.8 II for Canon kèm lens hood và gói hút ẩm- Hàng nhập khẩu",1990000,1990000,0,0
TIKI,may-anh,195948474,"Camera Hành Trình Ô Tô DDPAI Z40 Dash Cam Plus Camera Sau Độ Phân Giải 2K Ultra HD, Công Nghệ Thực Tế Ảo, Giám Sát 24 Giờ, Định Vị GPS, Hỗ Trợ Bộ Nhớ 128GB - Hàng Chính Hãng",2099000,4189000,2090000,50
TIKI,may-anh,921244,"Đèn Flash Godox TT600 Cho Canon, Nikon, Sony, Pentax (Tặng Kèm Tản Sáng Bounce) - Hàng nhập khẩu",1520000,1520000,0,0
TIKI,may-anh,194083692,"CAMERA WIFI EZVIZ C6 4MP 2K - HỖ TRỢ 5G - XOAY 360 ĐỘ - ĐÀM THOẠI 2 CHIỀU - ĐIỀU KHIỂN VÀ NHẬN DẠNG HÀNH ĐỘNG VẪY TAY",1090000,1090000,0,0
TIKI,may-anh,147860314,"Gậy chống Rung Gimbal Stabilizer L08 Tay Cầm Chống Cho Điện thoại Gimbal L08 Có Bluetooth Tiện Dụng",400000,400000,0,0
TIKI,may-anh,114964724,"Bộ dụng cụ khám phá kính hiển vi Barska AY12938 (dành cho trẻ em) - Hàng chính hãng",1887000,1887000,0,0
TIKI,may-anh,108844840,"Kit RF Thu Phát Wifi BLE ESP32 Camera ESP32-CAM",187000,187000,0,0
TIKI,may-anh,32528851," Kính thiên văn cao cấp kiểu cổ điển Barska Anchormaster 6x30mm - Hàng chính hãng",4257000,4257000,0,0
TIKI,may-anh,193778046,"Camera 360° Xiaomi - Hàng chính hãng - Camera quan sát Mi 360° 1080P Mi Home Security có đèn hồng ngoại, kết nối wifi",689000,689000,0,0
TIKI,may-anh,4740349,"Balo Đựng Máy Ảnh Benro Ranger Pro 500N (Đen) - Hàng Công Ty",3349999,3349999,0,0
TIKI,may-anh,189694785,"Gimbal Zhiyun Smooth Q4 - Tay cầm chống rung 3 trục có thể gấp gọn dành cho điện thoại, tích hợp gậy selfie kéo dài 21cm - Hàng nhập khẩu",2149000,2814900,665900,24
TIKI,may-anh,20425156,"Balo Máy Ảnh  NG 5070 ",849999,849999,0,0
TIKI,may-anh,154234487,"Flycam SJRC F11S 4K Pro 2021 phiên bản 3km - Phương tiện bay khả năng quay hình 4K, gimbal chống rung 2 trục - Hàng nhập khẩu",3899000,3899000,0,0
TIKI,may-anh,169128158,"[ Giám sát 24H ] Mini Camera Hành Trình  4 Inch Ô Tô Màn Hình Gương Tràn Viền (Wifi+GPS) - Thẻ 64GB",2409472,2409472,0,0
TIKI,may-anh,274179339,"Pin sạc Panasonic Eneloop AA 2550mah BK-3HCCE4BT3 (Vỉ 4 viên) (Đen) - Hàng chính hãng",499000,499000,0,0
TIKI,may-anh,191437403,"Trọn Bộ Camera 4 Mắt Hikvision 2.0MP Full HD - Hàng Chính Hãng",2350000,2750000,400000,15
TIKI,may-anh,171222217,"Balo máy ảnh Peak Design Everyday Backpack 20L Ver 2 - Hàng Chính Hãng",6499999,6499999,0,0
TIKI,may-anh,106585620,"Camera IP Wifi Ngoài Trời Imou F22FP Bullet 2E Full HD 1080P CÓ MÀU BAN ĐÊM, KÈM THẺ NHỚ 64G - Hàng Chính Hãng",838000,838000,0,0
TIKI,may-anh,7521387,"Ống Nhòm Barska Escape 7x50 - Hàng chính hãng",2020000,2020000,0,0
TIKI,may-anh,141606020,"bộ sạc pin aa panasonic CC55C sạc nhanh hàng chính hãng",1750000,1750000,0,0
TIKI,may-anh,186094681,"Đầu ghi hình Camera IMOU IP Wifi 4 kênh/8 kênh IMOU - Hàng Chính Hãng",1350000,1350000,0,0
TIKI,may-anh,50873236,"Ống nhòm du lịch một mắt Konusmall - 3 8-24x40,Thiết kế nhỏ gọn,tính năng ưu việt phù hợp dã ngoại ngắm cảnh - Hàng nhập khẩu Italia",2430000,2430000,0,0
TIKI,may-anh,114929017,"Kính thiên văn khúc xạ ngắm sao Barska Starwatcher 600 - Hàng chính hãng",6770000,6770000,0,0
TIKI,may-anh,502097,"Thẻ Nhớ SD Ultra Sandisk 64GB Class 10 - 48MB/s - Hàng Chính Hãng",229000,249000,20000,8
TIKI,may-anh,67179275,"Camera Mini IP Vstarcam CB72 1080P 2.0 Sim 4G LTE Giám Sát Hành Trình Ô Tô, Xem Trực Tiếp Từ Xa Bằng Điện Thoại, PC - Hàng Chính Hãng",1980000,1980000,0,0
TIKI,may-anh,31867852,"Ống Kính Lấy Nét Tự Động Viltrox C-AF 2XII AF Hàng Nhập khẩu",2099000,2099000,0,0
TIKI,may-anh,20028905,"Camera Hikvision DS-2CD2121G1-IDW1 Hàng Chính Hãng",1490000,1490000,0,0
TIKI,may-anh,2547015,"Hộp Chống Ẩm Wonderful 12 Lít",699000,699000,0,0
TIKI,may-anh,165046251,"Phim Instax Mini Dành Cho Máy Ảnh Mini 8, 9, 11, 40, 70, 90, Mini Link, Mini Liplay (Trắng) - Hàng Chính Hãng",500000,500000,0,0
TIKI,may-anh,97631649,"Chân đế cao cấp cho máy ảnh, ống nhòm Carson Rock TR-100 - Hàng chính hãng",1320000,1320000,0,0
TIKI,may-anh,272037973,"CAMERA WIFI YOOSEE NGOÀI TRỜI C12 14 LED -HÀNG NHẬP KHẨU",400000,799000,399000,50
TIKI,may-anh,170340161,"Camera IP wifi không dây IMOU F42P, F42FP, F42FEP siêu nét đàm thoại 2 chiều - Hàng chính hãng",758000,758000,0,0
TIKI,may-anh,64280200,"Kính Hiển Vi 1000X Kết Nối Wifi W04 ( NHỎ GỌN, CHẤT LƯỢNG ẢNH HD, KẾT NỐI KHÔNG CẦN DÂY CÁP) - Hàng Nhập Khẩu",750000,750000,0,0
TIKI,may-anh,64450001,"Gậy quay phim chống rung Gimbal siêu xịn dành cho Funsnap C2",1920000,1920000,0,0
TIKI,may-anh,54769146,"Micro thu âm Boya BY-BM3011 - Hàng Chính Hãng",530000,530000,0,0
TIKI,may-anh,55585425,"Bộ tripod chân chụp ảnh 3120 giá đỡ điện thoại - giá đỡ 3 Chân Tripod 3110 105cm Chuyên Chụp Hình Live Stream - giá đỡ điện thoại 3 chân máy ảnh gậy tự sướng ( MẦU ĐEN )",53866,53866,0,0
TIKI,may-anh,273984419,"Dây đeo máy ảnh kiểu peak design bản nhỏ dành cho máy ảnh mirrorless",100000,100000,0,0
TIKI,may-anh,65104045,"Chân Máy Chụp Ảnh, Quay Phim, Livestream Kẹp Ipad, Điện Thoại LT04 - Có Điều Khiển Từ Xa - Hàng Nhập Khẩu",160550,169000,8450,5
TIKI,may-anh,6885293,"Camera IP Wifi ngoài trời EZVIZ C3W 1080P (CS-CV310) + Tặng thẻ nhớ EZVIZ 32GB - Hàng Chính Hãng",1039000,1039000,0,0
TIKI,may-anh,72799732,"Ngàm chuyển  ống kính lấy nét tự động Viltrox NF-M1 cho Nikon F-Mount đến máy ảnh M 4/3 Hàng Nhập Khẩu",2899000,2899000,0,0
TIKI,may-anh,24969443,"Camera hành trình xe máy Sport Bike chuyên nghiệp SE300 Full HD",725000,725000,0,0
TIKI,may-anh,102583300,"Tủ chống ẩm 50 lít Andbon AD-50C, AD-50S, Hàng chính hãng",1649999,1649999,0,0
TIKI,may-anh,72825259,"Ống nhòm USCAMEL 10x42 UW079 nhìn xa, chống nước - HÀNG NHẬP KHẨU",1399000,1399000,0,0
TIKI,may-anh,161978478,"Camera IP Wifi Ngoài trời Full HD 1080P IMOU F22FP Bullet 2E, Có màu ban đêm - Hàng chính hãng",849900,849900,0,0
TIKI,may-anh,56026810,"Máy quay phim JVC JY-HM90 - Hàng Chính Hãng",14990000,14990000,0,0
TIKI,may-anh,112241267,"Camera mini A9S pro siêu nhỏ không dây kết nối với điện thoại qua wifi, có pin, có QR Code, HDwificam Pro, quay ban đêm",250000,250000,0,0
TIKI,may-anh,249772271,"Camera ngoài trời IMOU F22P, F22FP chống nước, phát hiện chuyển động - Hàng chính hãng",689000,1000000,311000,31
TIKI,may-anh,149502749,"Camera YOOSEE 3.0 Megapixel IP wifi ngoài trời PTZ  FHD1080P  siêu nét - Soi đêm có màu xoay 360 độ",705000,705000,0,0
TIKI,may-anh,14791361,"Dây đeo máy ảnh Mirroless",180000,180000,0,0
TIKI,may-anh,111176685,"Bộ Sạc Pin Tiểu  Doublepow K02 Dòng Sạc Nhanh - Tự ngắt  - An Toàn - Sạc các loại Pin AAA, AA Sạc Pin Micro Không Dây - Sạc Pin Đồ Chơi Điện Tử - Sạc Pin Tiểu Dung Lượng Cao Hàng Chính Hãng",1230000,1230000,0,0
TIKI,may-anh,133233960,"Chân đế dome gắn tường lắp cho các loại camera Ezviz C6n, Onviz V5",7400,7400,0,0
TIKI,may-anh,9488961,"Giá đỡ điện thoại, máy ảnh 3 chân Tripod 3110 ",52854,52854,0,0
TIKI,may-anh,189694704,"Gimbal Zhiyun Smooth Q4 - Hàng nhập khẩu",2149000,2149000,0,0
TIKI,may-anh,8095360,"Balo Peak Design Everyday (20L) - Black - Hàng Chính Hãng",5999999,5999999,0,0
TIKI,may-anh,77495869,"Bộ 02 Viên Pin Tiểu Sạc AA Cao Cấp 1200mAh Doublepow - Hàng nhập khẩu",24800,24800,0,0
TIKI,may-anh,55934345,"Giá đỡ 3 Chân Tripod 3110 G1 105cm Chuyên Chụp Hình Live Stream - giá đỡ điện thoại 3 chân - giá đỡ máy ảnh - gậy tự sướng selfie ( mầu bạc )",48484,48484,0,0
TIKI,may-anh,118375873,"Camera Hành Trình SJCAM THUMB CAMERA C100 ( Màu Trắng )- Hàng Nhập Khẩu",1125000,1468000,343000,23
TIKI,may-anh,94341857,"Combo Bộ Sạc nhanh Tự ngắt Tốc Độ Cao Màn Hình LCD Tặng 4 Pin AA 3000mAh Doublepow",1185000,1185000,0,0
TIKI,may-anh,134361229,"Phông nền chụp ảnh Studio Size lớn 2M . 3M chất liệu vải cotton",195000,195000,0,0
TIKI,may-anh,64325731,"Bộ Sạc Pin Doublepow DP-K06 Kèm 02 Pin Sạc DP-CR123A 650mAh Cao Cấp - Hàng Chính Hãng",261250,275000,13750,5
TIKI,may-anh,174609268,"Gimbal chống rung 3 trục DJI RSC 2 - Tay cầm Ronin SC 2- Hàng nhập khẩu ",8180000,8380000,200000,2
TIKI,may-anh,5866369,"Tủ Chống Ẩm Andbon AD-50S (50 Lít) - Hàng Nhập Khẩu",1974999,1974999,0,0
TIKI,may-anh,197141914,"Tủ chống ẩm máy ảnh 50 lít điện tử Andbon, Tủ hút ẩm đựng máy ảnh 50l ba ngăn tiết kiệm điện công nghệ Nhật Bản dung tích lớn dry cabinet - Hàng Nhập Khẩu",2030000,2030000,0,0
TIKI,may-anh,163865039,"Tay Cầm Chống Rung Điện Tử Gimbal L08 Có Bluetooth Có Chân Đỡ Tự Đứng",400000,400000,0,0
TIKI,may-anh,6479625,"Ống Nhòm Một Mắt Fomei 10x25 MONO BEATER - Hàng chính hãng",2899000,2899000,0,0
TIKI,may-anh,136583753,"Khung Treo Phông Nền BackDrop Studio Easy Xếp Gọn 2,6x3m",1380000,1380000,0,0
TIKI,may-anh,43876423,"Balo máy ảnh Benro Incognito B100 - Hàng chính hãng",1299999,1299999,0,0
TIKI,may-anh,193441075,"Ống nhòm chống nước kèm bộ chuyển đổi điện thoại thông minh Carson MonoPix MP-842IS - Hàng Chính Hãng",3980000,3980000,0,0
TIKI,may-anh,17919303,"Pin NP-W126 cho máy ảnh Fujifilm",194999,194999,0,0
TIKI,may-anh,566581,"Dây Đeo Trước Ngực (GP26P) - Hàng Chính Hãng",119999,119999,0,0
TIKI,may-anh,20857697,"Micro Tụ Điện Cổng USB Boya BY-PM700 - Hàng Chính Hãng",2100000,2100000,0,0
TIKI,may-anh,14260356,"Chân Máy Ảnh Benro FSL09AN00 - Hàng Chính Hãng",1649999,1649999,0,0
TIKI,may-anh,44820374,"Camera IP EZVIZ C6N 2MP 1080p Smart Night Vision - Tặng Thẻ Nhớ NETAC 32GB - Hàng Chính Hãng",505000,505000,0,0
TIKI,may-anh,43665335,"Camera IP EZVIZ C6N 2MP 1080p Smart Night Vision (Tặng Thẻ Nhớ Hikvision 32Gb) - Hàng Chính Hãng",454000,454000,0,0
TIKI,may-anh,70823292,"Ống nhòm cao cấp Carson RD-050 (10x50) - (Chống nước, sương mù) - Hàng chính hãng",7500000,7500000,0,0
TIKI,may-anh,25231861,"Chân máy ảnh Tripod 3120 tặng Giá kẹp điện thoại, Remote - Hàng Nhập Khẩu",68600,68600,0,0
TIKI,may-anh,74238684,"Ống nhòm chống nước BARSKA Blackhawk 12x42mm WP - Hàng chính hãng",5082000,5082000,0,0
TIKI,may-anh,125498910,"Camera A9 Pro Mini IP FullHD 1080P WiFi Không Dây HD Quan Sát Ban Đêm IR Camera An Ninh Gia Đình Quan Sát Từ Xa Trên Điện Thoại",210000,210000,0,0
TIKI,may-anh,155760651,"Camera Hành Trình Trước Ô Tô Xiaomi 70mai A800S - Phiên Bản Quốc Tế - HÀNG NHẬP KHẨU",3887000,3887000,0,0
TIKI,may-anh,2237821,"Camera Hikvision DS-2CE16D0T-IR - Hàng Chính Hãng",450000,450000,0,0
TIKI,may-anh,23415553," Kính thiên văn cao cấp Carson SkySeeker JC-200 - Hàng chính hãng",4390000,4390000,0,0
TIKI,may-anh,97650599,"Chân đế cao cấp Carson The Rock Monopod TR-500 - Hàng chính hãng",2280000,2280000,0,0
TIKI,may-anh,32526794," Ống nhòm quân sự vỏ kim loại Barska X-Trail 8x30mm - Hàng chính hãng",3432000,3432000,0,0
TIKI,may-anh,5899419,"Tủ Chống Ẩm Andbon AB-21C (20 Lít) - Hàng Nhập Khẩu",949999,949999,0,0
TIKI,may-anh,195740667,"Máy Ảnh Sony Alpha 6400 - Cảm biến APS-C | Hàng Chính Hãng",21990000,21990000,0,0
TIKI,may-anh,32809813,"Hạt Hút Ẩm Xanh Cho Máy Ảnh Kèm Túi Đựng (Silica Gel)",29000,29000,0,0
TIKI,may-anh,270917932,"Túi Da Bò Đừng Máy Ảnh Chuyên Dụng Marrant - BHL840",1250000,1250000,0,0
TIKI,may-anh,5850113,"Combo Đèn LED Yongnuo YN-300 II + Bộ 01 Viên Pin F970 & 01 Sạc V615 - Hàng Nhập Khẩu",1399999,1399999,0,0
TIKI,may-anh,29254537,"Bảng clapper board quay phim - Loại nhỏ",115000,115000,0,0
TIKI,may-anh,174640490,"Camera IMOU Bullet 2S, Camera Ngoài Trời, Khẩu độ lớn F1.0, Chống nước IP67, Chuẩn nén H265, Theo dõi chuyển động, Quay Màu ban đêm - Hãng Chính Hãng",1090000,1750000,660000,38
TIKI,may-anh,109877195,"Túi máy ảnh Safrotto SF001, Hàng chính hãng",999999,999999,0,0
TIKI,may-anh,197598293,"Bộ Pin NP-FW50 2000mAh + Sạc Beston Dùng Cho Máy Ảnh Sony a6100 a6300 a6500 a7m2 r2 s2 a5100 NEX-C3 NEX-C7 a33 a37 a55 - Hàng nhập khẩu",175000,175000,0,0
TIKI,may-anh,21442742,"Camera hành trình ô tô A19",549000,549000,0,0
TIKI,may-anh,58462929,"Ống nhòm ngày quan sát tầm xa chống nước Barska 20x80mm Cosmos (ngắm cảnh vật, thiên văn) - Hàng chính hãng",18920000,18920000,0,0
TIKI,may-anh,42299204," Bùi nhùi thép Steel Wool 1 mét",29999,29999,0,0
TIKI,may-anh,10373372,"Chân Máy Ảnh Benro T880EX - Hàng Chính Hãng",614999,614999,0,0
TIKI,may-anh,82529007,"Camera trong nhà Eufy Security Indoor Cam 2K, tích hợp còi báo động - Hàng chính hãng",935000,935000,0,0
TIKI,may-anh,44213819,"Camera Hành Trình ô tô, xe máy chất lượng 1080 Sports chống nước tuyệt đối đầy đủ phụ kiện gắn mũ bảo hiểm hoặc tay xe",199000,199000,0,0
TIKI,may-anh,55984779,"Filter màu lọc ánh sáng 80x100cm",140000,140000,0,0
TIKI,may-anh,262762204,"Hohem Isteady X2 - Gimbal | Tay cầm chống rung có remote điều khiển từ xa dùng cho smartphone - Hàng Chính Hãng",1599000,1599000,0,0
TIKI,may-anh,197540226,"Camera Hub Aqara G2H Pro 1080p Bản Quốc Tế CH-C01 Tương thích HomeKit - Tầm nhìn ban đêm, Âm thanh hai chiều - Hàng Chính Hãng",1390000,1410000,20000,1
TIKI,may-anh,13593871,"Ống nhòm Barska Lucid 12x25mm - Hàng chính hãng",1200000,1200000,0,0
TIKI,may-anh,100920384,"Camera Hành Trình Xe Hơi Hỗ Trợ Ghi Hình Ban Đêm 1080P_u2",299000,299000,0,0
TIKI,may-anh,169534343,"LENS HOOD REN VẶN DÀNH CHO SONY DC-52",80000,80000,0,0
TIKI,may-anh,194139462,"Camera IP Wifi Ngoài Trời EZVIZ CB8 3MP 2K Tặng Kèm Tắm Pin Năng Lượng - Có Màu Ban Đêm - Đàm Thoại 2 Chiều - Hàng Chính Hãng",2490000,2490000,0,0
TIKI,may-anh,9797918,"Bộ 2 pin và sạc đôi RavPower LP-E17 cho Canon 77D, 750D, 760D, 800D, M6 - Hàng chính hãng",668999,668999,0,0
TIKI,may-anh,9990028,"Túi đựng máy chụp hình microless BBK",220000,220000,0,0
TIKI,may-anh,7586151,"Kính Thiên Văn Barska Starwatcher 300 Power - Hàng chính hãng",4114000,4114000,0,0
TIKI,may-anh,13892182,"Ống nhòm 1 mắt Halebor",89000,89000,0,0
TIKI,may-anh,174416971,"Máy ảnh Sony ILCE-7RM4A Body - Hàng Chính Hãng",74990000,74990000,0,0
TIKI,may-anh,22419539,"Chân Máy Ảnh Benro T880 EX (Tripod) - Hàng nhập khẩu",572999,572999,0,0
TIKI,may-anh,27946536,"Bộ Sạc Pin Cho Sony NP-FV50 NP-FV70 NP-FV100 FH60 FH100",99999,99999,0,0
TIKI,may-anh,47030777,"[Chân chụp ảnh] Chân đế Tripod Bluetooth cho điện thoại và máy ảnh TTX - 6218 (Kèm túi đựng và remote bluetooth) - Hàng nhập khẩu",259999,259999,0,0
TIKI,may-anh,108342016,"Combo 1 pin 1 sạc đôi Kingma for Canon LP-E17 - Hàng chính hãng",429999,429999,0,0
TIKI,may-anh,177196776,"Gimbal chống rung cho điện thoại Vimble 3 - Hàng Chính Hãng",2090000,2090000,0,0
TIKI,may-anh,144615912,"Chân Đế Camera IP Wifi Giá Rẻ -  Đa Năng Lắp Được Camera Xoay Ezviz, Imou, Kbone, Vitacam c1280 .....",9000,9000,0,0
TIKI,may-anh,20425053,"Combo hộp chống ẩm, ẩm kế điện tử, 200gram hạt hút ẩm xanh, mút xốp, khăn lau lens cho máy ảnh, máy quay phim - dung tích 5 lít - Hàng chính hãng",179000,179000,0,0
TIKI,may-anh,6933381,"Balo Máy Ảnh Vanguard Alta Sky 51D (56.51 x 37.14 cm) - Hàng Chính Hãng",5399999,5399999,0,0
TIKI,may-anh,144455283,"Ống nhòm cho trẻ con Binoculars mẫu mới 2020",44000,44000,0,0
TIKI,may-anh,80955507,"Các loại Tủ chống ẩm 30 Lít Andbon, Hàng chính hãng",1074999,1074999,0,0
TIKI,may-anh,109776908,"Túi máy ảnh đeo chéo Safrotto SP-003, Hàng chính hãng",1049999,1049999,0,0
TIKI,may-anh,17142465,"Phông nền chụp ảnh 3D 80cm x 125cm",79000,79000,0,0
TIKI,may-anh,23852057,"Sạc pin đôi LP-E17 cho máy ảnh Canon 750D 760D 800D 200D 77D M3 M5 M6",159999,159999,0,0
TIKI,may-anh,96308413,"Chân máy quay Benro KH25P Video Tripod Kit - Hàng chính hãng",2999999,2999999,0,0
TIKI,may-anh,55985257,"Filter màu lọc ánh sáng 80x50cm",99000,99000,0,0
TIKI,may-anh,263058011,"Camera IP Wifi Hikvision an ninh trong nhà Q21 1080p - Hàng chính hãng",849000,1200000,351000,29
TIKI,may-anh,195948271,"Camera Hành Trình Ô Tô DDPAI Z40 Dash Cam Độ Phân Giải 2K Ultra HD Công Nghệ Thực Tế Ảo, Giám Sát 24 Giờ, Định Vị GPS, Hỗ Trợ Bộ Nhớ 128GB - Hàng Chính Hãng",1899000,3699000,1800000,49
TIKI,may-anh,495179,"Ống Kính Sony E PZ 18-105mm F4 G OSS - Hàng Chính Hãng",10990000,10990000,0,0
TIKI,may-anh,167319094,"Gimbal chống rung Moza Nano SE - Tay cầm dành cho điện thoại nhỏ gọn, siêu nhẹ - Hàng nhập khẩu",799000,799000,0,0
TIKI,may-anh,10762080,"500g hạt hút ẩm Xanh Silicagel Blue và 5 túi vải  - Hạt chuyển màu khi no ẩm",67000,67000,0,0
TIKI,may-anh,106336184,"Camera V100Plus hồng ngoại đen nhìn đêm hộp nhựa tản nhiệt - Camera WiFi 4K FullHD giám sát từ xa qua điện thoại 3G",678300,714000,35700,5
TIKI,may-anh,194821708,"Gimble chống rung quay video cho youtube vlog tiktok",1300000,1300000,0,0
TIKI,may-anh,71209699,"Flycam SJRC F11 4K PRO ( F11S ), Camera 4K, Chống rung 2 trục, Thời gian bay lên tới 25 phút - Hàng chính hãng",3899000,5000000,1101000,22
TIKI,may-anh,61818978,"Bộ đèn studio chụp ảnh sản phẩm, quay phim, livestream chuyên nghiệp, bộ gồm chân đèn 2m kèm softbox 50x70cm, tay treo 138 cm",243000,243000,0,0
TIKI,may-anh,50549583,"Bộ thu phát không dây cho camera IP dùng trong thang máy và ngoài trời Mercury MWB201 - Hàng Nhập Khẩu",889900,889900,0,0
TIKI,may-anh,155997208,"Đèn Flash Godox V1, V860, TT685, TT350",1595555,1595555,0,0
TIKI,may-anh,4688845,"Túi Đựng Chân Đèn Strobist Đa Năng 72X25X25Cm - Hàng Nhập Khẩu",559000,559000,0,0
TIKI,may-anh,20586805,"Pin sạp AA niken-hydro dung lượng lớn 1200 mAh",55000,55000,0,0
TIKI,may-anh,178262311,"Camera IP Wifi hồng ngoại EZVIZ C3TN 2MP H256 - Hàng chính hãng",678900,678900,0,0
TIKI,may-anh,194070191,"CAMERA WIFI TRONG NHÀ EZVIZ TY1 4MP 2K QUAY QUÉT 360 ĐỘ - ĐÀM THOẠI 2 CHIỀU - HÀNG CHÍNH HÃNG",650000,650000,0,0
TIKI,may-anh,247723223,"Phông chụp ảnh 3x6m",319000,319000,0,0
TIKI,may-anh,102081875,"Camera Ezviz IP Wifi  C8C Full HD 1080p Hàng Chính Hãng",1310000,1310000,0,0
TIKI,may-anh,109688459,"Túi máy ảnh Safrotto SP-001, Hàng chính hãng",899999,899999,0,0
TIKI,may-anh,23302926,"MÀN HÌNH FEELWORLD F6 PLUS 5.5 INCH 3D LUT TOUCH SCREEN IPS FHD1920X1080 SUPPORT 4K - Hàng Nhập Khẩu",3990000,3990000,0,0
TIKI,may-anh,102099842,"Kính hiển vi sinh học 400X UX001 ( Phục vụ nghiên cứu, học tập, giải trí ) - Hàng nhập khẩu",2950000,2950000,0,0
TIKI,may-anh,109925317,"Balo máy ảnh Safrotto SM3030, thao tác nhanh - Hàng chính hãng",1799999,1799999,0,0
TIKI,may-anh,103511944,"Zhiyun Smooth-Q3 - Gimbal Chống Rung Cho Smartphone Thế Hệ Mới Có Đèn Led Trợ Sáng - Hàng chính hãng",1809000,1809000,0,0
TIKI,may-anh,153139914,"Camera wifi không dây tích hợp AI Ezviz C8PF 2MP, ống kính kép, ghi âm, xoay 360 độ (hàng chính hãng)",1458000,1458000,0,0
TIKI,may-anh,12565816,"Đầu Ghi Hình Hikvision HD-TVI 8 Kênh DS-7108HGHI-F1/N - Hàng chính hãng",1124000,1124000,0,0
TIKI,may-anh,30987623,"Túi máy ảnh đeo chéo Caden K11 Size XL - Hàng chính hãng",699999,699999,0,0
TIKI,may-anh,14081108,"Camera Quan Sát AVTECH HDCCTV DGC1105YFTP - Hàng Nhập Khẩu",530000,530000,0,0
TIKI,may-anh,142238759,"Tay cầm chống rung cho điện thoại Gimbal Zhiyun Smooth 5 - Hàng Nhập Khẩu",3090000,3090000,0,0
TIKI,may-anh,263454463,"Camera Wifi Ngoài Trời IMOU F22P, F22FP 2MP Chống Nước, Có Mic Thu Âm - Hàng chính hãng",650000,650000,0,0
TIKI,may-anh,53832851,"Camera Nội Soi Tai Mũi Họng HD Đường Kính 3.9mm Dùng Cho PC, Laptop, Android Cao Cấp AZONE",257000,279000,22000,8
TIKI,may-anh,185760627,"Ống Kính Sigma 56mm F1.4 DC DN - Hàng Chính Hãng",9790000,9790000,0,0
TIKI,may-anh,251465386,"Balo chuyên dụng đựng máy ảnh - BL014",480000,480000,0,0
TIKI,may-anh,4738525,"Dây Đeo Máy Ảnh Thao Tác Nhanh Focus F1 - Hàng Nhập Khẩu",74999,74999,0,0
TIKI,may-anh,8490477,"Bộ 2 Pin + Sạc Đôi RAVPower EN-EL15 Cho Nikon D7200, D800, D800E, D810, D850... (Hàng Chính Hãng)",799999,799999,0,0
TIKI,may-anh,170400691,"Camera wifi Ezviz C6N không dây xoay 360 độ đàm thoại 2 chiều - Hàng chính hãng",374900,374900,0,0
TIKI,may-anh,41499593,"Miếng dán màn hình cường lực cho máy ảnh Fujifilm XA5/XA3/XA10/XA20/XT1/XT2",69000,69000,0,0
TIKI,may-anh,54631360,"Kính hiển vi Carson MS-040SP (40-400x) gắn điện thoại - Hàng chính hãng",6500000,6500000,0,0
TIKI,may-anh,19852928,"MOUNT VILTROX EF-M2 II FOR M4/3 FOCAL REDUCER SPEED BOOSTER - HÀNG CHÍNH HÃNG",2990000,2990000,0,0
TIKI,may-anh,158461072,"Bộ Camera WIFI EZVIZ TY1 4MP, Độ Phân Giải 2K Và Thẻ Nhớ 32GB Chuyên Cho Camera - Hàng Chính Hãng",790000,790000,0,0
TIKI,may-anh,154446006,"Hohem iSteady Pro 4 - Gimbal Thiết Kế Dành Cho GoPro Hero 12/11/10/9 Và Các Dòng Camera Action, Chuẩn Chống Nước IPX4,  Hoạt Động 14 Giờ - Hàng Chính Hãng",2150000,2150000,0,0
TIKI,may-anh,123547663,"Nguồn Camera 12V 2A Chống Nhiễu Có Đèn Báo",45000,45000,0,0
TIKI,may-anh,273546454,"Tủ Chống Ẩm Andbon AD-30S(30 lít) - Hàng Nhập Khẩu",1590000,1590000,0,0
TIKI,may-anh,72722935,"Ống nhòm hàng hiệu Swarovski CL Pocket 10x25 ( Màu xanh) - Hàng chính hãng",22550000,22550000,0,0
TIKI,may-anh,100265784,"Chân máy ảnh kết hợp chân đơn giá dưới 2 triệu, Hàng nhập khẩu",849999,849999,0,0
TIKI,may-anh,86124066,"HANET A.i Camera  Nhận Diện Khuôn Mặt, Chấm công,lưu trữ dữ liệu trên cloud - Hàng Chính hãng",3350000,3350000,0,0
TIKI,may-anh,120357009,"Micro TNVI V3 pro kèm 2 mic không dây cài áo siêu nhỏ gọn cho điện thoại máy quay máy ảnh",3500000,3500000,0,0
TIKI,may-anh,159496924,"Pin sạc Kingma Ver 2 cho Fujifilm NP-W126, Hàng chính hãng",199999,199999,0,0
TIKI,may-anh,158886642,"Chân lùn Beike QZSD-166A, Hàng nhập khẩu",899999,899999,0,0
TIKI,may-anh,261979531,"Camera Quay quét Wi-Fi pin sạc EZVIZ CB8 2K kèm tấm pin sạc năng lượng mặt trời - Hàng Chính Hãng",2910000,2910000,0,0
TIKI,may-anh,193708888,"Kính hiển vi công nghiệp cao cấp Terino 10A-14MPHD (Phóng đại 7x-180X, Camera HD 14MP HDMI/USB) - Hàng Chính Hãng",10835000,10835000,0,0
TIKI,may-anh,165070620,"[Quốc Tế] Camera thông minh Aqara G3 CH-H03 Indoor 2K AI Tracking - Hàng Chính Hãng",2050000,2090000,40000,2
TIKI,may-anh,155167184,"Phông chụp ảnh 2x3m",269000,269000,0,0
TIKI,may-anh,109764354,"Chân Đế Camera chuyên dùng cho Camera Ezviz C6N Camera Imou A22Ep Camera Kbone  VÀ MỘT SỐ MẪU TƯƠNG TỰ HÀNG NHƯ HÌNH.",9900,9900,0,0
TIKI,may-anh,32346702,"MICRO THU ÂM WIRELESS UHF BOYA BY-WM4 PRO-K1 (BỘ 1 PHÁT, 1 THU) | Hàng Chính Hãng",1899000,1899000,0,0
TIKI,may-anh,138395318,"Camera Hành Trình Ô Tô 3 Ống Kính WDR Full HD 1080 Tặng Kèm Camera Lùi 4LED chống nước Cao Cấp",668000,668000,0,0
TIKI,may-anh,58614859,"Combo 2 pin 1 sạc đôi Kingma NP-FZ100 hàng chính hãng.",1049999,1049999,0,0
TIKI,may-anh,108916678,"Pin Kingma cho Nikon EN-EL18, Hàng chính hãng",949999,949999,0,0
TIKI,may-anh,139742301,"Gậy chụp ảnh 3 chân tripod tf - 3120 ,gắn máy ảnh, điện thoại chụp hình tự sướng selfie",145990,145990,0,0
TIKI,may-anh,32022924,"Túi máy ảnh thời trang CA201",199000,199000,0,0
TIKI,may-anh,159049975,"Pin ảo/ giả pin/ pin giả/ Pin Dummy Kingma for Sony NP-FZ100",349999,349999,0,0
TIKI,may-anh,10772578,"Đầu Ghi Hình Camera IP Wifi Không Dây 8 Kênh NVR - Hikvision DS-7108NI-Q1/M - Hàng Chính Hãng",1279789,1279789,0,0
TIKI,may-anh,57044115,"Pin sạc cho máy quay NP-FV50/FV70/FV100/F770/F750",308000,308000,0,0
TIKI,may-anh,4707757,"Bóng Đèn Ánh Sáng Liên Tục 500K (150W) - Hàng Nhập Khẩu",199000,199000,0,0
TIKI,may-anh,155998023,"Chân máy ảnh tripod Beike Q-202F, Thanh ngang - Hàng chính hãng",875555,875555,0,0
TIKI,may-anh,115020835,"Chân máy ảnh, chân máy chiếu, chân livestream",99000,99000,0,0
TIKI,may-anh,272209314,"Camera Wifi IPC360 Home Dual Lens PJ-09, 2 ống kính 1080P (FHD) , màn hình ultra wide siêu rộng 180 (Hàng nhập khẩu)",850000,850000,0,0
TIKI,may-anh,8082324,"Chân Video Monopod Benro A48FDS4 - Hàng Chính hãng",3599999,3599999,0,0
TIKI,may-anh,6843741,"Đèn Godox V860II-N 2.4G GN60 TTL HSS 1/8000s Li-on Battery for Nikon Camera - Hàng Chính Hãng",3110000,3110000,0,0
TIKI,may-anh,94725171,"Camera căn lề, cạp lề xoay 360 độ cho ô tô xe hơi",239000,239000,0,0
TIKI,may-anh,80439308,"Combo hộp chống ẩm máy ảnh 10 lít (ẩm kế điện tử, 200g hạt hút ẩm xanh, tặng mút xốp) - Hàng chính hãng",199000,199000,0,0
TIKI,may-anh,5849607,"Chân Máy Ảnh Tripod/ Monopod Q-999S - Hàng Nhập Khẩu",949999,949999,0,0
TIKI,may-anh,111484602,"Video Balun lõi đồng 2MP/ 5MP/ 8MP loại tốt chống nhiễu cực xa",26000,26000,0,0
TIKI,may-anh,32547238,"Hộp chụp sản phẩm 40x40 khóa bấm cố định tích hợp 70 bóng đèn Led",323000,340000,17000,5
TIKI,may-anh,122755017,"Giá 3 chân quay phim, livestrem Tripod điện thoại, máy ảnh 3120 sơn đen",74700,74700,0,0
TIKI,may-anh,193762947,"Đầu ghi IP 8 kênh KBVISION KX-A8128N2 - Hàng Chính Hãng",940000,940000,0,0
TIKI,may-anh,70130149,"Ống Nhòm Đồ Chơi Cho Bé Học Hỏi Khám Phá Thế Giới Bên Ngoài tặng bé 1 bút bi hình viên thuốc mặt cười (giao màu ngẫu nhiên)",46000,46000,0,0
TIKI,may-anh,54294752,"Phông nền nhựa PVC chụp ảnh sản phẩm màu trắng",62000,62000,0,0
TIKI,may-anh,107893845,"Kính viễn vọng đi du lịch ngắm cảnh đêm phóng đại 16x-40x siêu nét, chụp ảnh quay video bằng điện thoại chất lượng cao",3385800,3564000,178200,5
TIKI,may-anh,58614222,"Combo 2 pin 1 sạc đôi Kingma LP-E17 hàng chính hãng.",549999,549999,0,0
TIKI,may-anh,20584741,"Sạp Pin BST-C807B cho AA - AAA dung lượng lớn",85000,85000,0,0
TIKI,may-anh,7017323,"Đèn Flash Godox V860II TTL For Nikon - Hàng nhập khẩu",3110000,3110000,0,0
TIKI,may-anh,4688933,"Chân Máy Ảnh Tripod Chân Nhện Cao 16cm - Hàng Nhập Khẩu",84999,84999,0,0
TIKI,may-anh,106590682,"Camera IP Wifi Ngoài Trời Imou F22FP Bullet 2E Full HD 1080P CÓ MÀU BAN ĐÊM, KÈM THẺ NHỚ 128G - Hàng Chính Hãng",1140000,1140000,0,0
TIKI,may-anh,6945773,"Ống Kính Sony FE 16-35mm f2.8 GM - Hàng Chính Hãng",53990000,53990000,0,0
TIKI,may-anh,104416721,"Camera IP wifi Tenda CP3 dùng cho gia đình - hàng chính hãng ( rõ hơn Ezviz C6N và Imou A22 )",370000,370000,0,0
TIKI,may-anh,950452,"Bộ Phụ Kiện Miếng Dán 3M, Đế Mount, Mount Cong",32000,32000,0,0
TIKI,may-anh,15849363,"Túi đựng máy ảnh microless nhỏ",170000,170000,0,0
TIKI,may-anh,74880871,"Ẩm kế điện tử đo ẩm, nhiệt độ tủ chống ẩm (kèm pin) - PHUKIEN2T_Q01103",60000,60000,0,0
TIKI,may-anh,4740345,"Nắp Ống Kính Nikon 72mm (Đen) - Hàng Nhập Khẩu",38999,38999,0,0
TIKI,may-anh,22599415,"Đèn Led quay phim GODOX LED500LR-C ( Hàng Cty ) - Hàng Nhập Khẩu",2500000,2500000,0,0
TIKI,may-anh,100261517,"Chân máy ảnh Kết hợp chân đơn Beike Q999 New, Hàng Nhập khẩu",1049999,1049999,0,0
TIKI,may-anh,21221639,"Gậy Chụp Hình, Chụp ảnh 3 chân Tripod 312O Cao cấp - Tặng Kẹp Smartphone",60000,65020,5020,8
TIKI,may-anh,110367842,"Camera IP WIFI IMOU 4.0 MPX XOAY 355 ĐỘ TRONG NHÀ - Hàng Chính Hãng",608900,608900,0,0
TIKI,may-anh,155772887,"Sạc for cho pin máy ảnh Canon (Nhiều loại), Hàng nhập khẩu",149999,149999,0,0
TIKI,may-anh,4707965,"Ba Lô Máy Ảnh Chuyên Dụng Lowepro Protactic 450 AW (34.8 x 48.8 cm) - Đen - Hàng Nhập Khẩu",4999999,4999999,0,0
TIKI,may-anh,55650311,"Đèn Led Video Lights 96 bóng Ulanzi (FUDB1) - Hàng chính hãng",270000,270000,0,0
TIKI,may-anh,21065586,"Pin Wasabi LP-E17 Canon EOS 750D,760D,8000D, M3 - Hàng nhập khẩu",251750,265000,13250,5
TIKI,may-anh,66375684,"Gimbal AI kiêm giá đỡ điện thoại cảm biến thông minh quay phim chụp hình xoay 360 độ nhận diện khuôn mặt - Auto Smart Following cameraman  ( Giao màu ngẫu nhiên)",298000,469000,171000,36
TIKI,may-anh,15669023,"Micro Thu Âm Boya BY-PM700 - Hàng Chính Hãng",2100000,2100000,0,0
TIKI,may-anh,53447078,"Ba Lô Lowepro Protactic 450II AW - Hàng Chính Hãng",5074999,5074999,0,0
TIKI,may-anh,51419584,"Camera giám sát ngoài trời Blurams Outdoor Pro A21C - Hàng chính hãng",1390000,1390000,0,0
TIKI,may-anh,109544298,"Chân máy ảnh Monopod Coman DX327CQ5S Carbon, Hàng chính hãng",3499999,3499999,0,0
TIKI,may-anh,15927443,"Đèn LED Quay Phim Yongnuo YN300-II - Hàng Chính Hãng",1019999,1019999,0,0
TIKI,may-anh,19649147,"Chân Máy Ảnh Tripod Grip - Hàng Nhập Khẩu",79000,79000,0,0
TIKI,may-anh,57665704,"KÍNH THIÊN VĂN - KÍNH VIỄN VỌNG",355000,355000,0,0
TIKI,may-anh,27793913,"Ống Nhòm Một Mắt Siêu Nét Monocular 16x52 - Hàng Nhập Khẩu",115000,115000,0,0
TIKI,may-anh,186252758,"Camera IP WiFi Fullcolor quay quét ngoài trời Imou Cruiser SE 4MP IPC-S41FP hàng chính hãng",895000,895000,0,0
TIKI,may-anh,54023400,"Camera Ezviz C6N (CV246 1080P) + Tặng thẻ nhớ Hikvision 64GB và chân đế - Hàng Chính Hãng",550000,550000,0,0
TIKI,may-anh,112888691,"Camera Trí Tuệ Nhân Tạo HANET Ai HA1000 Chấm Công, Báo Động An Ninh Bằng Nhận Diện Khuôn Mặt, Camera IP Wifi Thông Minh - Hàng chính hãng",3930000,3930000,0,0
TIKI,may-anh,7387065,"Ống Nhòm Barska Lucid 16x32mm - Hàng chính hãng",1452000,1452000,0,0
TIKI,may-anh,52865765,"DÂY DA SEN ĐEO MÁY ẢNH  - CHÍNH HÃNG KHẮC TÊN",1229000,1229000,0,0
TIKI,may-anh,161683242,"Tay cầm chống rung Gimbal Zhiyun Smooth 5 cho điện thoại - Hàng nhập khẩu",3090000,3090000,0,0
TIKI,may-anh,5849479,"Chân Máy Ảnh Tripod Yunteng VCT-691 - Hàng Nhập Khẩu",524999,524999,0,0
TIKI,may-anh,97599424,"Ống Kính Sony FE 50mm F1.2 GM - Hàng Chính Hãng",47990000,47990000,0,0
TIKI,may-anh,77332174,"Camera hành trình 360 độ 3D cao cấp chuẩn AHD độ phân giải 1080P HD366",10042000,10042000,0,0
TIKI,may-anh,106997616,"Tàu ngầm điều khiển từ xa Chasing Dory ( Chính Hãng ) - Theo dõi quan sát Hải Sản, Chụp hình, Quay phim dưới nước",12900000,12900000,0,0
TIKI,may-anh,197685600,"dây đeo máy cắt cỏ loại tốt",30000,30000,0,0
TIKI,may-anh,109957482,"Balo máy ảnh Safrotto SM3032, thao tác nhanh - Hàng chính hãng",1999999,1999999,0,0
TIKI,may-anh,63162584,"Ống nhòm chống thấm nước Carson RD-042MO (10x42) (tìm ong rừng, ngắm chim) - Hàng chính hãng",7250000,7250000,0,0
TIKI,may-anh,194082865,"Camera Wifi Trong Nhà EZVIZ C6W 4MP 2K Quay Quét 355 độ Tích Hợp AI- Đàm thoại 2 chiều - Hàng Chính Hãng",1150000,1150000,0,0
TIKI,may-anh,109310320,"Dây đeo máy ảnh Peak Design (nhiều loại), Hàng chính hãng",449999,449999,0,0
TIKI,may-anh,169446610,"Dây đeo dành cho máy ảnh - Sợi tròn cứng",170000,170000,0,0
TIKI,may-anh,26429203,"10 Jack Nối dùng cho Camera giám sát",55000,55000,0,0
TIKI,may-anh,195523175,"Camera Di Động Kèm Màn Hình chăm sóc bé từ xa đo Nhiệt Độ - Báo khóc thông minh",2580000,2580000,0,0
TIKI,may-anh,5876257,"Kính lọc Filter Hoya HMC PL-Cir 77mm - Hàng nhập khẩu",999999,999999,0,0
TIKI,may-anh,197421523,"Camera quan sát Eufy Indoor 2K T8400 - Hàng chính hãng",979000,1190000,211000,18
TIKI,may-anh,113627915,"Đầu ghi hình camera 4 kênh 2MP H.265+ AI-Coding Dahua DH-XVR1B04-I hàng chính hãng DSS Việt Nam",690000,690000,0,0
TIKI,may-anh,8729404,"Combo Chân Máy Ảnh Tripod Yunteng VCT-668 + Remote Cho Máy Ảnh - Hàng Nhập Khẩu",469999,469999,0,0
TIKI,may-anh,160290342,"Tủ chống ẩm 100 lít Andbon AD-100S, Hàng chính hãng",3899999,3899999,0,0
TIKI,may-anh,109862511,"Hộp chụp ảnh sản phẩm, lồng chụp ảnh (nhiều loại), Hàng nhập khẩu",1049999,1049999,0,0
TIKI,may-anh,74240825,"Ống nhòm một mắt chống nước, chống sương mù Barska Blackhawk 10x40 WP - Hàng chính hãng",2420000,2420000,0,0
TIKI,may-anh,25621506,"[Tặng remote chụp hình] Gậy Chụp hình Tripod 3110",67750,67750,0,0
TIKI,may-anh,120444794,"Gậy Chống Rung Gimbal Stabilizer L08 - Có 3 Chân Đỡ - Nút Bấm Bluetooh Hàng Cao Cấp - Hàng Nhập Khẩu",399999,650000,250001,38
TIKI,may-anh,4727681,"Bộ Kích Đèn Trigger Yongnuo YN603 II Lẻ 1 Cục - Hàng Nhập Khẩu",344999,344999,0,0
TIKI,may-anh,7263277,"Đèn Godox AD200 Pocket Fash TTL - Hàng nhập khẩu",5700000,5700000,0,0
TIKI,may-anh,159244041,"Pin giả/ pin ảo/ pin Dummy Kingma for Canon LP-E6",349999,349999,0,0
TIKI,may-anh,155764379,"Camera IP 2mp có màu ban đêm Hikvision mã DS-2CD1027G0-L - Hàng Chính Hãng",1190000,1190000,0,0
TIKI,may-anh,10240573,"Mount thao tác nhanh gắn GoPro Hero xoay 360 độ",69000,69000,0,0
TIKI,may-anh,191475533,"Dây máy ảnh Peak Design Slide Lite Midnight (màu xanh tím than), Hàng chính hãng",1849999,1849999,0,0
TIKI,may-anh,25919457,"(TẶNG KÈM THẺ NHỚ 16GB)CAMERA HÀNH TRÌNH FULL BỘ 3 MẮT",890000,890000,0,0
TIKI,may-anh,56365724,"Túi đựng đèn kit",583000,583000,0,0
TIKI,may-anh,177614676,"Thẻ nhớ Mirco SD HIKVISION 64GB - 92MB/s Class 10 chuyên dùng ghi hình cho các dòng camera IP, điện thoại, máy ảnh, máy tính bản - hàng chính hãng",95000,95000,0,0
TIKI,may-anh,91729501,"Pin Cho Máy Ảnh Nikon Li-ion 7.4V 2200mAh EN-EL3E",184999,184999,0,0
TIKI,may-anh,126097755,"Camera Wifi PROLiNK PIC3003WP thông minh giá rẻ, siêu nét Full HD 1080P, góc nhìn rộng, âm thanh 2 chiều - Hàng chính hãng",599000,999000,400000,40
TIKI,may-anh,47878241,"Kính Lọc Filter Hoya UX UV 67mm - Hàng Chính Hãng",441999,441999,0,0
TIKI,may-anh,165189326,"Kính hiển vi 7 chức năng cho trẻ em khám phá Carson CP-11 X-Scope - Hàng chính hãng",759000,759000,0,0
TIKI,may-anh,113359107,"Ống nhòm cao cấp Swarovski Habicht 10 x 40W - Hàng chính hãng",31125000,31125000,0,0
TIKI,may-anh,4688909,"Chân Máy Ảnh Tripod Mefoto A0350Q0 - Hàng Nhập Khẩu",1974999,1974999,0,0
TIKI,may-anh,206144224,"Camera PTZ Wifi 5MP DAHUA DH-SD2A500-GN-AW-PV- Hàng Chính Hãng",1696000,1696000,0,0
TIKI,may-anh,194123786,"Camera IP Wifi Ngoài Trời EZVIZ BC1C 2MP Tặng Kèm Tắm Pin Năng Lượng Tích Hợp Bộ Nhớ Trong 32G - Có Màu Ban Đêm - Đàm Thoại 2 Chiều - Hàng Chính Hãng",2390000,2390000,0,0
TIKI,may-anh,109487629,"Chân máy ảnh kết hợp gậy chụp ảnh tự sướng Coman MT55, Hàng chính hãng",999999,999999,0,0
TIKI,may-anh,158890697,"Chân đèn Ciya Inox IN-210, 210cm - Hàng nhập khẩu",379999,379999,0,0
TIKI,may-anh,3597911,"Bộ Chân Máy Ảnh Bạch Tuộc Lớn Và Đầu Bi Chân Máy Ảnh Thân Kim Loại Q00160",159000,159000,0,0
TIKI,may-anh,180992296,"Camera sau trên gương chiếu hậu Full 2K với màn hình cảm ứng 12 inch IPS Gương Dash Cam",2485000,2485000,0,0
TIKI,may-anh,107711395,"Astra - Camera 3D Orbbec - Hàng chính Hãng",7740900,7740900,0,0
TIKI,may-anh,101305987," Combo Soft box 70 x 50cm và chân đèn cao cho studio (có nhiều tùy chọn combo và tách lẻ)",89000,89000,0,0
TIKI,may-anh,77872136,"Túi máy ảnh vải bố kết hợp với da imax-V4321",749999,749999,0,0
TIKI,may-anh,22194656,"Tủ Đựng Đầu Ghi Camera Cao Cấp",203000,203000,0,0
TIKI,may-anh,23417162," Kính thiên văn cao cấp Carson SkySeeker JC-1000 - Hàng chính hãng",5400000,5400000,0,0
TIKI,may-anh,108089799,"Chân máy ảnh Benro dòng FIF28, Hàng chính hãng",2699999,2699999,0,0
TIKI,may-anh,91815728,"Pin Cho Máy Ảnh Canon Li-ion 3.6V 680mAh 2.4Wh NB-11L",119999,119999,0,0
TIKI,may-anh,184771570,"Giá đở Camera hành trình và camera thể thao gắn trên kính xe hơi",69000,69000,0,0
TIKI,may-anh,153037267,"Camera IP POE Thân 2.0MP DAHUA DS2230SFIP-S2 hàng chính hãng DSS Việt Nam",721500,721500,0,0
TIKI,may-anh,108087879,"Camera giám sát IMOU Ranger 2C 2MP, 1080P IPC-TA22CP-B - Hàng Chính Hãng",510000,569000,59000,10
TIKI,may-anh,91648636,"Pin Cho Camera Action Gopro Hero 5/6/7 Li-ion 1250mAh AHDBT-501",156750,165000,8250,5
TIKI,may-anh,10120870,"Camera IP Wifi Ngoài Trời EZVIZ CS-CV310 (1080P) - Hàng Chính Hãng",949000,949000,0,0
TIKI,may-anh,52324969,"Camera Kim Loại SQ8 HD Camera Thể Thao DV Ngoài Trời SQ8",130000,199000,69000,35
TIKI,may-anh,92165099,"Camera Dahua 2 Mp DH HAC B1A21P 1080P - Thân Trụ Ngoài Trời - Hàng chính hãng",313000,313000,0,0
TIKI,may-anh,93741171,"Bóng Thổi Bụi Cho Máy Ảnh",99000,99000,0,0
TIKI,may-anh,95526954,"Camera IP Wifi ngoài trời PTZ SriHome SP028 2.0MP FullHD 1080P, Xoay 355 độ, chống nước IP66 (Trắng) HÀNG CHÍNH HÃNG",539000,539000,0,0
TIKI,may-anh,142872424,"Mount nối gắn camera",100000,100000,0,0
TIKI,may-anh,155997739,"Filter Kính lọc Hoya UV UX 62mm - Hàng Chính Hãng",409555,409555,0,0
TIKI,may-anh,9423471,"Kẹp Jaws Flex Clamp cho Gopro",269000,269000,0,0
TIKI,may-anh,47570169,"Phông 3D chụp ảnh sản phẩm – mã MB51",160000,160000,0,0
TIKI,may-anh,269899146,"Kính Hiển Vi Điện Tử Đa Năng 3 trong 1 50x -1000x",590000,590000,0,0
TIKI,may-anh,152647094,"Camera IP POE Dome 2.0MP DAHUA DS2230TDIP-S2 hàng chính hãng DSS Việt Nam",721500,721500,0,0
TIKI,may-anh,10979816,"Sạc đôi kèm cáp sạc và 2 pin sạc KingMa LP-E17 cho Canon EOS M3 M5 M6 760D 800D - Hàng chính hãng",649999,649999,0,0
TIKI,may-anh,2564513,"Bộ Kéo Phông 3 Trục Và Khung Treo",1199000,1199000,0,0
TIKI,may-anh,71690345,"Tủ chống ẩm Dry Cabi DHC-80 II Tủ ngang, 80 Lít, Hàng nhập khẩu",3249999,3249999,0,0
TIKI,may-anh,84566847,"Camera IP Wifi Không Dây Xoay Thông Minh Kawasan IPC02 Full HD1080P - Hàng Chính Hãng",1000000,1000000,0,0
TIKI,may-anh,4708387,"Bộ 8 Dụng Cụ Mount Dán Gopro (Đen Đỏ) - Hàng Nhập Khẩu",59999,59999,0,0
TIKI,may-anh,200657326,"[ tặng thẻ nhớ 64G] Camera Hành Trình Cho Xe Hơi/Ô Tô Màn Hình Cảm Ứng 12 Inch Ips Bên Trước Và Sau 2K/Full HD1080P, Buletooth, Có Wifi Quay Video Vòng Lặp",4404884,4404884,0,0
TIKI,may-anh,174811081,"Camera Hành Trình Vietmap C61 Pro cảnh báo giọng nói kèm thẻ nhớ 32 GB - Hàng chính hãng",3275000,3275000,0,0
TIKI,may-anh,125010502,"Combo 200 Gram hạt hút ẩm  Silicagel chỉ thị màu hút ẩm Máy ảnh linh kiện điện tử Phòng Ngủ Quần áo Giày dép Hoa Khô",20000,20000,0,0
TIKI,may-anh,155997868,"Giấy lau, bóng thổi, bút lau VSGO -Hàng Chính Hãng",75555,75555,0,0
TIKI,may-anh,107184715,"Camera IP WIFI IMOU RANGER 2 IPC - A22EP Full HD 1080P ,KÈM THẺ NHỚ 128G - Hàng Chính Hãng",749000,749000,0,0
TIKI,may-anh,158889876,"Chân đèn Beike AR-189, Hàng nhập khẩu",349999,349999,0,0
TIKI,may-anh,101639481,"Camera mô hình robot đàm thoại 2 chiều 1080p",1035000,1035000,0,0
TIKI,may-anh,16458389,"Nguồn Camera 12V - 2A",34000,34000,0,0
TIKI,may-anh,188907056,"CAMERA YOOSEE WIFI 4 RÂU 20 LED XOAY 180 ĐỘ 5.0 MPX CẢNH BÁO CHỐNG TRỘM KÈM THẺ 32-HÀNG CHÍNH HÃNG",545000,545000,0,0
TIKI,may-anh,270812879,"Camera WIFI FullColor 4MP có đàm thoại 2 chiều IMOU BULLET 2 IPC-F42FEP hàng chính hãng",1045000,1045000,0,0
TIKI,may-anh,19992185,"Pin cho máy ảnh Canon LP-E8 LPE8 pin máy ảnh Canon 550D 600D 650D 700D",184999,184999,0,0
TIKI,may-anh,157425728,"Camera IP Wifi Yoosee 3 Râu - hàng chính hãng",550000,550000,0,0
TIKI,may-anh,97095566,"PHÔNG NỀN CHỤP ẢNH 3D (80cm x 125cm)",150000,150000,0,0
TIKI,may-anh,230082338," 200 Gói chống ẩm 1,2,5,10 gram đóng túi 200 gram",27000,27000,0,0
TIKI,may-anh,54478379,"Micro thu âm Saramonic Blink 500 B6 - Hàng Chính Hãng",6178000,6178000,0,0
TIKI,may-anh,170498694,"Lens hood cho ống kính Nikon HB-47 AF-S 50mm 1.8G 1.4G YN-50mm f/1.8 (Loa che nắng HB-47) - Hàng Nhập Khẩu",80000,80000,0,0
TIKI,may-anh,169343191,"Chân Máy Ảnh Tripod YungFeng 3388, Giá Đỡ Kèm nút bấm Bluetooth Cao Cấp Chuyên Dùng ChO Điện Thoại Camera Model 2020",239000,239000,0,0
TIKI,may-anh,189494360,"Camera IP POE 2.0MP DAHUA DH-IPC-HFW1230SP-S4 hàng chính hãng",720000,720000,0,0
TIKI,may-anh,100113411,"ROGTZ Đèn Led Sunset Quay Tiktok Siêu Hot, Đèn Chiếu Màu Hoàng Hôn Chụp Ảnh, Quay Video Decor Ảo Diệu - Hàng Chính Hãng",75050,79000,3950,5
TIKI,may-anh,5876301,"Kính lọc Filter Hoya HMC UV 77mm - Hàng nhập khẩu",545999,545999,0,0
TIKI,may-anh,107350585,"Camera IP Colorvu Lite 2MP Thân Tích Hợp Mic HIKVISION DS-2CD1027G0-LU - Hàng Chính Hãng ",1150000,1150000,0,0
TIKI,may-anh,171071894,"Trọn Bộ Camera 6 Mắt Hikvision 2.0MP Full HD 1080P đầy đủ phụ kiện lắp đặt - Hàng chính hãng",8400000,8400000,0,0
TIKI,may-anh,105630691,"Chân máy ảnh Benro dòng T (T560, T600EX, T660EX, T699N, T800EX, T880EX, T899N, T980EX)",389999,389999,0,0
TIKI,may-anh,173359661,"Camera Wifi IMOU Ranger 2 robot thông minh - TA22CP 2MP , kèm chân đế  đa năng, Chính Hãng",500000,500000,0,0
TIKI,may-anh,174036008,"Camera Wifi EZVIZ C3TN 3MP đàm thoại 2 chiều - Hàng chính hãng",775000,1180000,405000,34
TIKI,may-anh,107980235,"Camera IP Wifi trong nhà EZVIZ C1C-B 2MP, thông minh hàng chính hãng Nhà An Toàn",400000,400000,0,0
TIKI,may-anh,4755077,"Dây Đeo Vai Xoay 360 Độ Cho Gopro Và SJCAM GP95C - Hàng Nhập Khẩu",49000,49000,0,0
TIKI,may-anh,2227391,"Tủ Chống Ẩm Nikatei NC-30C (30L) - Bạc - Hàng Chính Hãng",1789999,1789999,0,0
TIKI,may-anh,6485301,"Ống nhòm nhìn xa chống nước Fomei 20-60x60 LEADER A/S (có thể gắn Camera) - Hàng chính hãng",15199000,15199000,0,0
TIKI,may-anh,184759018,"Camera IMOU S21FP S41FP tích hợp mic, phát hiện chuyển động, chống nước IP66 - Hàng chính hãng",950000,950000,0,0
TIKI,may-anh,195919359,"Camera hành trình 70Mai M500 ( bản quôc tế ) - Hàng chính hãng",2305000,2375000,70000,3
TIKI,may-anh,70774508,"Kính hiển vi bỏ túi Carson PocketMicro MM-450 (20x-60x) - Hàng chính hãng",970000,970000,0,0
TIKI,may-anh,260443037,"Flycam Syma X8 Pro GPS 720P- Drone cao cấp bảo hành 12 tháng",2990000,2990000,0,0
TIKI,may-anh,160408689,"Phông acrylic chụp ảnh sản phẩm 3D",120000,120000,0,0
TIKI,may-anh,49866934,"Túi Máy Ảnh Peak Design Cube Large - Hàng Nhập Khẩu",2749999,2749999,0,0
TIKI,may-anh,22471862,"Boya M1 (Tặng kèm dây sạc điện thoại 3m ), Mic thu âm cài áo cho điện thoại, máy ảnh - Hàng chính hãng",399000,399000,0,0
TIKI,may-anh,50550437,"Bộ thu phát không dây cho camera IP dùng trong thang máy và ngoài trời  Mercury MWB505 tốc độ ( 5.8Ghz, 867Mb ) sóng 0 đến 5km  - Hàng nhập khẩu",2299000,2349900,50900,2
TIKI,may-anh,35843267,"DDPai MINI Camera hành trình độ nét cao, tích hợp kết nối Wifi không dây Full HD. Hàng nhập khẩu",750000,750000,0,0
TIKI,may-anh,100626283,"Camera wifi quay quét 360 FULL HD EZVIZ CS-C6N  - Hàng chính hãng",404000,404000,0,0
TIKI,may-anh,138544340,"Đèn Chụp Ảnh Sản Phẩm Softbox Led360 20W/40W/60W Nhiệt Màu 5500K, Thiết bị Quay Phim Chụp Ảnh Studio Hàng Chính Hãng",755000,755000,0,0
TIKI,may-anh,111942475,"Camera Wi-Fi An Ninh Ngoài Trời Tp-link Tapo C310 | Hàng Chính Hãng ",799000,799000,0,0
TIKI,may-anh,275145,"Balo Máy Ảnh Benro Traveler 200 (2 Quai)",1749999,1749999,0,0
TIKI,may-anh,74893380,"Camera IP Wifi Imou IPC-F22FP-IMOU Full HD 1080P,lắp ngoài trời - Hàng Chính Hãng",749000,749000,0,0
TIKI,may-anh,171224777,"Balo máy ảnh Peak Design Everyday Backpack 30L Ver 2 - Hàng Chính Hãng",7499999,7499999,0,0
TIKI,may-anh,172247191,"Bộ sạc pin Doublepow DP-K66 + 6 pin tiểu sạc AA 3000mAh Hàng Chính Hãng",2690000,2690000,0,0
TIKI,may-anh,197598458,"Bộ Pin LP-E6 2000mAh + Sạc Beston Dùng Cho Máy Ảnh Canon EOS 60D 70D 80D 90D 6D 7D 5D Mark IV 5DSR - Hàng nhập khẩu",175000,175000,0,0
TIKI,may-anh,121341624,"Bộ Kit camera Wifi HIKVISION NK42W0H(D) (4 CAMERA + 1 Đầu ghi ) - Hàng chính hãng",4280000,4280000,0,0
TIKI,may-anh,191474619," Balo máy ảnh Peak Design Totepack Black - Hàng chính hãng",5749000,5749000,0,0
TIKI,may-anh,66898616,"Tay cầm nối dài cho gimbal Agimbalgear hàng chính hãng.",357000,357000,0,0
TIKI,may-anh,160759305,"Camera WiFi S900 không dây PIN khủng 24 giờ ,nhỏ gọn, Siêu nét chuẩn video 4K FullHd 1080p Kết nối trục tiếp điện thoại xem từ xa",1350000,1350000,0,0
TIKI,may-anh,185668602,"Combo Pin giả/pin ảo NP-FZ100 + Pin F980D+Sạc - Hàng chính hãng",2099999,2099999,0,0
TIKI,may-anh,13749584,"Sạc đôi dành cho GoPro 5 6 7",99000,99000,0,0
TIKI,may-anh,6487277,"Ống Nhòm Nhìn Xa Fomei 20-60X60 Zoom Spoting - Hàng chính hãng",8199000,8199000,0,0
TIKI,may-anh,109321550,"Đèn Led Ulanzi VL49 RGB Fill Light, Đổi Được Nhiều Tone Màu Quay Phim & Chụp Ảnh, Tích Hợp Pin Sạc Đa Năng - Hàng Chính Hãng",340000,340000,0,0
TIKI,may-anh,114989106,"Ống nhòm kính ED Fomei 20-60x80 FOREMAN ED (chống nước) - Hàng chính hãng",20460000,20460000,0,0
TIKI,may-anh,146494297,"Camera imou Bullet 2E IPC-F22FP Fullcolor 2.0 Megapixel có màu ban đêm - hàng chính hãng",839900,839900,0,0
TIKI,may-anh,49150076,"CAMERA QUAN SÁT TRONG XE Ô TÔ- NAVICOM I20-HÀNG CHÍNH HÃNG",1100000,1100000,0,0
TIKI,may-anh,16988898,"Bộ Filter vuông ND 2-4-8-16 - hàng nhập khẩu",469000,469000,0,0
TIKI,may-anh,108591207,"Pin Kingma for Canon LP-E6, Hàng chính hãng",349999,349999,0,0
TIKI,may-anh,155998242,"Túi máy ảnh Safrotto SF001",900555,900555,0,0
TIKI,may-anh,195948753,"Camera Hành Trình Ô Tô DDPAI Mini 5 Có Định Vị GPS Kết Nối WIFI Camera AI Thông Minh Độ Phân Giải 4K, Cảnh Báo Làn Đường, Giám Sát 24 Giờ, Hiển Thị Tốc Độ - Hàng Chính Hãng",2799000,5579000,2780000,50
TIKI,may-anh,194069934,"Camera Wifi Trong Nhà EZVIZ C6N 4MP 2K Quay Quét 355 độ - Đàm thoại 2 chiều - Hàng Chính Hãng",670000,670000,0,0
TIKI,may-anh,950416,"Bộ Dây Đeo Camera Trước Ngực DJI",78000,78000,0,0
TIKI,may-anh,10771705,"Camera Thân Chữ Nhật Hikvision HD-TVI 2MP DS-2CC12D9T - Hàng Chính Hãng",3250000,3250000,0,0
TIKI,may-anh,179921012,"Kính hiển vi dành cho học sinh, Kính hiển vi sinh học C2170 cao cấp độ phóng đại lên 1200X",475000,475000,0,0
TIKI,may-anh,16626395,"Bộ sạc và pin máy ảnh cho Canon LP-E17 LPE17 EOS M3 M5 M6 Rebel SL2 T6i T6s T7i 200D 77D 760D 750D 8000D 800D KISS X8i",239999,239999,0,0
TIKI,may-anh,3428603,"Dây Đeo Thao Tác Nhanh Quick Strap K",99000,99000,0,0
TIKI,may-anh,177488244,"Camera wifi không dây Imou C22 đàm thoại/ hồng ngoại/ cảnh báo chuyển động- Hàng chính hãng",495500,890000,394500,44
TIKI,may-anh,77242660,"Camera yoosee xem đêm có màu , camera wifi 3 râu chuẩn 2.0 Full HD 1080P , đàm thoại 2 chiều - Hàng Nhập Khẩu",348000,348000,0,0
TIKI,may-anh,22427331,"Chân Máy Ảnh Benro T660 EX (Tripod) - Hàng Nhập khẩu",590000,590000,0,0
TIKI,may-anh,104070021,"Đầu ghi 16 kênh HDTVI H.265+ Hikvision DS-7216HQHI-K1 vỏ sắt - Hàng chính hãng",3430000,3430000,0,0
TIKI,may-anh,120384763,"Ống nhòm cao cấp nhìn xa 2-5km 10-80x100 siêu nét",643426,643426,0,0
TIKI,may-anh,195668579,"Camera WIFI ngoài trời EZVIZ CB8 3MP 2K năng lượng mặt trời, có màu ban đêm - Hàng chính hãng",2250000,3500000,1250000,36
TIKI,may-anh,8090713,"Thẻ Nhớ Micro SD Netac U3 Class 10 64GB – Hàng Chính Hãng",149000,149000,0,0
TIKI,may-anh,13176003,"Hạt hút ẩm màu xanh nhạt đóng gói 1kg",95000,95000,0,0
TIKI,may-anh,52251276,"Bộ kính hiển vi cho trẻ Science Microscope",194000,194000,0,0
TIKI,may-anh,38364371,"Đèn LED Trợ Sáng 96 Bóng Ulanzi FUDB1, Hỗ Trợ Quay Phim Công Suất Sáng Cực Mạnh, Có 2 Loại Nguồn Sạc Cực Kì Tiện Lợi, 2 Nguồn Sáng, Trắng Sáng Chói Hỗ Trợ Quay Trong Trường Hợp Thiếu Ánh Sáng, Trắng Sáng Mờ, Bảo Vệ Mắt Của Bạn Khi Tiếp Cận Với Ánh Đèn - H",200000,200000,0,0
TIKI,may-anh,56589563,"Softbox Godox 50x130cm - Hàng chính hãng",683000,683000,0,0
TIKI,may-anh,65442449,"Camera IP Wifi quay quét EZVIZ C6N 2MP chính hãng (Tặng thẻ nhớ 32GB)",510000,510000,0,0
TIKI,may-anh,28364394,"VIETMAP C65 - Camera Hành Trình Cảm Ứng Ghi Hình Trước Sau + Cảnh báo bằng giọng nói + Wifi + Thẻ nhớ 32GB - Hàng Chính Hãng",4200000,4200000,0,0
TIKI,may-anh,10118152,"Camera Hikvision DS-2CE16D0T-IT5 - Hàng chính hãng ",728000,728000,0,0
TIKI,may-anh,113967701,"Kính Thiên Văn Khúc Xạ F36050",387000,387000,0,0
TIKI,may-anh,24605730,"Sạc pin NP-FH50 cho máy ảnh, máy quay Sony- Hàng nhập khẩu",109000,109000,0,0
TIKI,may-anh,2545863,"Bộ Đèn Chụp Sản Phẩm Softbox (150W) - Hàng Nhập Khẩu",599000,599000,0,0
TIKI,may-anh,121332180,"Cell pin dung lượng 2600 chuẩn dung lượng",26000,26000,0,0
TIKI,may-anh,120110838,"Camera wifi yoosee ngoài trời 20 LED 4 râu thân xoay Full HD 1080P Quay đêm có màu tặng thẻ 32g, Chống Nước đàm thoại 2 chiều , App ngôn ngữ tiếng Việt - Hàng Nhập Khẩu - Chỉ Camera",510000,510000,0,0
TIKI,may-anh,34719990,"Bộ 2 Pin Và Sạc Kép RAVPower Cho Sony FZ100 A9 A7III A7RIII A6600 - Hàng Nhập Khẩu",1299999,1299999,0,0
TIKI,may-anh,54654279,"HỘP CHỤP SẢN PHẨM CÓ LED 40X40CM",191000,245000,54000,22
TIKI,may-anh,28745899,"Túi đựng máy ảnh vải gai cổ điển M80",224900,224900,0,0
TIKI,may-anh,109853501,"jack DC nguồn 12v Vặn Vít - jack cái 12v - jack nguồn camera âm",4990,4990,0,0
TIKI,may-anh,51470490,"Camera IP Wifi Xoay Theo Chuyển Động Đàm Thoại 2 Chiều Imou A22EP+ Thẻ Netac 32G - Hàng Chính Hãng",590000,590000,0,0
TIKI,may-anh,44841778,"Mắt Camera ngoài trời Hikvision DS-2CE16D0T-IR 2MP - Hàng chính hãng",389000,389000,0,0
TIKI,may-anh,94596171,"Camera wifi yoosee ngoài trời 20 LED 4 râu thân xoay Full HD 1080P Quay đêm có màu, Chống Nước đàm thoại 2 chiều , App ngôn ngữ tiếng Việt - Hàng Nhập Khẩu",479000,479000,0,0
TIKI,may-anh,67720636,"Kính Hiển Vi 1000X Hd X4s-1000 ( ỐNG KÍNH NHẬP FULL HD, CHÂN ĐẾ CHẮC CHẮN CHỐNG RUNG TỐT ) - HÀNG NHẬP KHẨU",649000,649000,0,0
TIKI,may-anh,147969828,"Bộ đèn 2 chảo chụp ảnh trong nhà TIANRUI",630000,630000,0,0
TIKI,may-anh,2227437,"Tủ Chống Ẩm Nikatei NC-30C (30L) - Vàng - Hàng Chính Hãng",1700000,2550000,850000,33
TIKI,may-anh,69861503,"Dây máy ảnh đeo cổ tay kiểu sợi bện",135000,135000,0,0
TIKI,may-anh,98738720," MÁY ẢNH KỸ THUẬT DSRL MINI CHO BÉ + tặng thẻ 16GB",637000,637000,0,0
TIKI,may-anh,6476249,"Ống Nhòm Chống Nước, Chống Mờ Sương Fomei 10x42 DCF BEATER - Hàng chính hãng",5499000,5499000,0,0
TIKI,may-anh,81135664,"Camera nội soi lấy ráy tai cho Bé tặng kèm đầu lấy ráy tai, camera nội soi tai mũi họng chuyên nghiệp",105000,105000,0,0
TIKI,may-anh,5849423,"Chân Máy Ảnh Tripod Weifeng WT-3540 - Hàng Nhập Khẩu",349999,349999,0,0
TIKI,may-anh,155996459,"Chân máy ảnh Benro FIF19AIB0 - Hàng Chính Hãng",2050555,2050555,0,0
TIKI,may-anh,4707973,"Tản Sáng Cho Đèn Flash 5 In 1 - Hàng Nhập Khẩu",169000,169000,0,0
TIKI,may-anh,14258479,"Dây đeo máy ảnh Peak Design Slide Lite Camera Strap SLL-BK-3 (Black) - Hàng Chính Hãng",1749999,1749999,0,0
TIKI,may-anh,149346772,"Camera wifi ngoài trời độ phân giải 2K CT6 3MB Tenda hàng chính hãng",750000,750000,0,0
TIKI,may-anh,15851211,"Bàn Xoay Chụp Sản Phẩm 360 Độ Đường Kính 35cm - Hàng Chính Hãng",1590000,1590000,0,0
TIKI,may-anh,108092312,"Pin Kingma for Canon NB-13L - Hàng chính hãng",499999,499999,0,0
TIKI,may-anh,108091586,"Combo pin sạc Kingma for Canon NB-13L - Hàng chính hãng",249999,249999,0,0
TIKI,may-anh,6934901,"Ống Kính Sigma 30mm f/1.4 DC DN For Sony E Mount - Hàng Chính Hãng",6790000,6790000,0,0
TIKI,may-anh,40496377,"TÚI MÁY ẢNH MANFROTTO MESSENGER BEFREE MÀU XÁM | Hàng Chính Hãng",2022999,2022999,0,0
TIKI,may-anh,173474960,"Ba lô máy ảnh Lowepro Flipside 300 AW III, Hàng chính hãng",3149999,3149999,0,0
TIKI,may-anh,195749500,"Túi chống sốc cho máy ảnh Microless",185000,185000,0,0
TIKI,may-anh,137249480,"Gậy gấp 3 khúc 3-Way thiết kế tiện lợi có thể gấp gọn làm tay cầm, làm tripod dành cho máy quay GoPro và máy quay hành trình ",299000,299000,0,0
TIKI,may-anh,191490324,"Dây đeo máy ảnh Peak Design (Nhiều màu, nhiều size), Hàng chính hãng",950555,950555,0,0
TIKI,may-anh,155552172,"Camera Wifi trong nhà EZVIZ C6N 4MP FULL 1080P, Hàng Chính Hãng",687000,687000,0,0
TIKI,may-anh,261942353,"Camera WiFi Quay Quét, Ống kính kép EZVIZ C8PF 2MP - Hàng Chính Hãng",1530000,1530000,0,0
TIKI,may-anh,20076325,"Gậy selfire cho camera thể thao, camera hành trình",89000,89000,0,0
TIKI,may-anh,230203212,"Camera WiFi Năng Lượng Mặt Trời NetCAM SL90, Góc Quan Sát 89º, Độ phân giải 3.0MP - Hàng chính hãng",979000,979000,0,0
TIKI,may-anh,43388600,"Pin Máy Ảnh Kingma EN-EL15 dùng cho máy ảnh Nikon D7000/D7100/D7200/D600/D610/D800/D810 - hàng chính hãng ",399999,399999,0,0
TIKI,may-anh,8826583,"Túi đựng máy ảnh CANDEN K11 - Hàng Nhập Khẩu",649999,649999,0,0
TIKI,may-anh,74238311,"Ống nhòm Outland X 8*42, ống nhòm ngày đêm, ống nhòm chống nước, Celestron Mỹ chính hãng",2500000,2500000,0,0
TIKI,may-anh,6688403,"Bộ vệ sinh máy ảnh 8 in 1 (Đỏ)",114999,114999,0,0
TIKI,may-anh,84437141,"Tủ đựng đầu ghi camera, các bộ switch nhà mạng, các bo mạch điện, điện tử",204000,204000,0,0
TIKI,may-anh,118372633,"Camera hành trình SJCAM SJ8 Air - Hàng Nhập Khẩu",2259000,2289000,30000,1
TIKI,may-anh,58452881,"Đèn Flash studio Godox DP300II hàng chính hãng.",2486000,2486000,0,0
TIKI,may-anh,174609388,"Ống kính Tamron 28-75mm F/2.8 Di III VXD G2 Sony FE - Hàng Chính hãng",19190000,19190000,0,0
TIKI,may-anh,108412730,"Combo 2 pin 1 sạc Kingma for Sony NP-FZ100 - Hàng chính hãng",1049999,1049999,0,0
TIKI,may-anh,155996416,"Ba lô máy ảnh Vanguard Vesta Aspire 41",1175555,1175555,0,0
TIKI,may-anh,146176780,"Chân đế Camera, Để gắn Camera, Phụ kiện Camera gắn tường, Đế Camera Wifi",17000,17000,0,0
TIKI,may-anh,13685025,"Micro thu âm wireless UHF Boya BY-WM8 PRO-K1 - Hàng Chính Hãng",2199000,2199000,0,0
TIKI,may-anh,116195175,"CHÂN MÁY ẢNH TRIPOD BEIKE Q-202F",849999,849999,0,0
TIKI,may-anh,84934453,"Balo Máy Ảnh Lowepro Protactic BP 300 AW II (LP37265) - Chính Hãng",3349999,3349999,0,0
TIKI,may-anh,39655788,"Camera IP HIKVISION DS-2CD2T55FWD-I8 5MP Thân Trụ - Hàng Chính Hãng",5643000,5643000,0,0
TIKI,may-anh,186590666,"Ulanzi U-SELECT FT-01 - Tripod Bạch Tuộc Xoay 360° Cho Smartphone, Gopro, Máy Ảnh, Tải Trọng 2 Kg - Hàng Chính Hãng",370000,370000,0,0
TIKI,may-anh,191437737,"Dây Camera Cáp Đồng Trục Liền Nguồn RG59+2C Đồng Nguyên Chất - Đã Bấm Sẵn 2 Đầu",85000,150000,65000,43
TIKI,may-anh,25363335,"Kính Lọc Concept Filter UV Digital Hd 58mm nhập khẩu",199000,199000,0,0
TIKI,may-anh,106109200,"Bộ 1-4 camera có màu ban đêm 2MP Hikvision - Hàng chính hãng",1762000,1762000,0,0
TIKI,may-anh,171116779,"Trọn Bộ 9 Camera Đầy Đủ Phụ Kiện Hikvision 2.0MP Full HD - Hàng Chính Hãng",9500000,9500000,0,0
TIKI,may-anh,192134355,"Camera hành trình SJCAM SJ10 Pro Dual Screen - Máy quay hành động màn hình kép chống rung 6 trục đỉnh cao - Hàng chính hãng",4449000,4449000,0,0
TIKI,may-anh,185239090,"Balo CaseLogic 206 dành cho máy ảnh",780000,780000,0,0
TIKI,may-anh,191920895,"Gậy đỡ điện thoại chụp ảnh ba chân - giá đỡ ba chân 1,2m - giá tripod 3120",30000,30000,0,0
TIKI,may-anh,176694691,"Thẻ nhớ 32GB/64GB MIXIE Hàng chính hãng",79000,79000,0,0
TIKI,may-anh,194140881,"Thẻ nhớ SDXC SanDisk Extreme Pro SDSDXXD-512G U3 V30 512GB 200MB/s New 2022 - Hàng Nhập Khẩu",2050000,2050000,0,0
TIKI,may-anh,4755383,"Cap Bấm Hình Cartoon (Size 40.5) - Hàng Nhập Khẩu (Giao Màu Ngẫu Nhiên)",69000,69000,0,0
TIKI,may-anh,198425914,"Camera thông minh Aqara G2H pro AI Full HD 1080p - Bản Quốc Tế - Hàng Chính Hãng",1320000,1320000,0,0
TIKI,may-anh,825520,"Ống Kính Yongnuo YN AF-S 50mm F/1.8 Cho Nikon - Hàng nhập khẩu",1990000,1990000,0,0
TIKI,may-anh,88482985,"Camera Wifi - Camera Ip Trong Nhà EZVIZ C6N 1080P - Đàm Thoại 2 Chiều - Xoay 360 Độ Theo Chuyển Động - Hàng nhập khẩu",383900,383900,0,0
TIKI,may-anh,6921779,"Micro thu âm đa năng Boya BY-MM1 - Hàng nhập khẩu",430000,430000,0,0
TIKI,may-anh,88861632,"Chân máy ảnh MANFROTTO 190XPRO ALU 3-Section - Chính hãng",4899999,4899999,0,0
TIKI,may-anh,191509288,"Pin Flycam ZLRC SG108 Pro - Phụ kiện hỗ trợ tăng thêm thời gian bay - Hàng nhập khẩu",450000,500000,50000,10
TIKI,may-anh,105652903,"Chân máy ảnh dòng FSL09, Hàng chính hãng",1649999,1649999,0,0
TIKI,may-anh,34575579,"Máy Ảnh Mini Chụp Hình Cho Bé Loại Cao Cấp 2019",495000,495000,0,0
TIKI,may-anh,7464485,"Loa che nắng hood ET-65III ống kính Canon EF 85mm f1.8 USM ",67000,67000,0,0
TIKI,may-anh,57641967,"Camera IP WIFI trong nhà YooSee 2.0 ( 3 anten, 11 led HD) + Thẻ nhớ 32G -  Hàng Nhấp Khẩu",350000,350000,0,0
TIKI,may-anh,59381719,"dây đeo máy ảnh thao tác nhanh Quick Release XJ",280000,280000,0,0
TIKI,may-anh,108968436,"Pin Kingma cho Panasonic DMW-BLC12, Hàng chính hãng",399999,399999,0,0
TIKI,may-anh,46822268,"Bộ Camera Hành Trình Trước Và Sau U5 Dùng Cho Ô Tô, Xe Hơi Sử Dụng Màn Hình DVD Android",1245000,1245000,0,0
TIKI,may-anh,171124803,"Trọn Bộ 10 Camera Đầy Đủ Phụ Kiện Hikvision 2.0MP Full HD - Hàng chính hãng",10300000,10300000,0,0
TIKI,may-anh,91189681,"Đầu đọc thẻ USB 3.0 Card Reader Hỗ trợ thẻ TF và SD UGREEN 20203- Hàng chính hãng",220000,250000,30000,12
TIKI,may-anh,51699597,"NGÀM CHUYỂN AF VILTROX CANON EF-FX2 (0.71X) FOR FUJIFILM Hàng Nhập Khẩu",3999000,3999000,0,0
TIKI,may-anh,9804983,"Camera Hành Trình Sjcam SJ8 Pro 4K Wifi - Hàng Chính Hãng",3739000,3939000,200000,5
TIKI,may-anh,170498126,"Lens hood cho ống kính Nikon AF-S 70-200mm F/2.8g ED II (Loa che nắng HB-48) - Hàng Nhập Khẩu",150000,150000,0,0
TIKI,may-anh,56682381,"Trọn Bộ 4 Camera IP PoE Hikvision 2.0MP Tầm Xa Hồng Ngoại 30M Chức Năng Cấp Nguồn Qua Mạng PoE - Hàng Chính Hãng",11954000,11954000,0,0
TIKI,may-anh,22365770,"Thẻ nhớ JVJ Micro SDHC Pro 32G C10 – thẻ nhớ chuyên dụng cho camera - Hàng chính hãng",180000,180000,0,0
TIKI,may-anh,107047614,"Camera IP Wifi VNPT Technology ONE HOME HVIP01 xoay 360 quan sát rõ ngày và đêm kèm thẻ nhớ hàng Việt Nam",840000,840000,0,0
TIKI,may-anh,6911647,"Dây Đeo Máy Ảnh Peak Design Slide Lite (Black) - Hàng Chính Hãng",1699999,1699999,0,0
TIKI,may-anh,173479725,"Balo máy ảnh Lowepro Flipside 400 AW III, Hàng chính hãng",3649999,3649999,0,0
TIKI,may-anh,74347298,"Camera Ip Wifi Imou F22FP Hình Ảnh Đầy Màu Sắc Ngay Cả Vào Ban Đêm Full HD 1080P Bullet 2E Tặng Kèm Dây Nối Nguồn 20M - Hàng Chính Hãng",885000,885000,0,0
TIKI,may-anh,197154629,"Camera ngoài trời eufy Outdoor Cam Pro 2K E220 chống nước IP67 có đèn chiếu đêm - Hàng Chính Hãng",1650000,1790000,140000,8
TIKI,may-anh,204643382,"Khung L Plate thanh bảo vệ máy ảnh dành cho Sony A7II A7R2 A7S2",299000,299000,0,0
TIKI,may-anh,6903641,"Kính lọc Benro Master ND256 (8-Stops) hệ 100mm- Hàng Chính Hãng",1599999,1599999,0,0
TIKI,may-anh,149509501,"Camera an ninh wifi 2 râu (Sóng khỏe Hình nét)",499000,499000,0,0
TIKI,may-anh,184876859,"Camera Wifi Yoosee 3 râu 11 led - Xoay 360 độ, cảnh báo chống trộm - Hàng chính hãng",299000,299000,0,0
TIKI,may-anh,143809133,"Camera nội soi 7mm dùng cho điện thoại Android",289350,289350,0,0
TIKI,may-anh,114973774," Ống nhòm viễn vọng chống nước Barska 20-60x80 WP Level  (màu đen) - Hàng chính hãng",15125000,15125000,0,0
TIKI,may-anh,208129810,"Túi chống sốc máy ảnh và lens vải bố canvas cao cấp",180000,180000,0,0
TIKI,may-anh,108968206,"Combo pin sạc Kingma cho Panasonic DMW-BLC12, Hàng chính hãng",199999,199999,0,0
TIKI,may-anh,2547051,"Bộ Ống Nối Tăng Độ Phóng Đại Cho Máy Canon (Đen)",159000,159000,0,0
TIKI,may-anh,9975567,"Camera HD-TVI Trụ Hồng Ngoại 5MP HIKVISION DS-2CE16H0T-ITPF - Hàng chính hãng",728000,728000,0,0
TIKI,may-anh,129249761,"Camera hành trình cao cấp Navicom J247 Pro - Hàng chính hãng",4990000,4990000,0,0
TIKI,may-anh,274152455,"Đèn Led Quay Phim Zifon T4, Công Suất 10.5w, Nhiệt Màu 3200k - 5600k",825000,825000,0,0
TIKI,may-anh,126022024,"Bộ Kit camera Wifi HIKVISION NK42W0H(D) (4 CAMERA + 1 Đầu ghi  + 1 Ổ cứng 1.000 GB) - Hàng chính hãng",5298000,5298000,0,0
TIKI,may-anh,74880889,"Remote MC-30 / MC-DC2 cho máy ảnh Nikon",75000,75000,0,0
TIKI,may-anh,20418626,"Đèn LED quay phim  YN360 RGB",2168000,2168000,0,0
TIKI,may-anh,152546691,"Camera Vietmap VM350 - Giám sát và định vị từ xa - Ghi hình trước và trong xe hành trình ô tô - Hàng chính hãng",4790000,4790000,0,0
TIKI,may-anh,552421,"Đầu Ghi Hình Dahua IP - DVR 16 Kênh NVR4216 - Hàng Chính Hãng",3160000,3160000,0,0
TIKI,may-anh,182981101,"Đèn led Tube Ulanzi VL110 RGB hàng chính hãng",1100000,1100000,0,0
TIKI,may-anh,5876281,"Kính lọc Filter Hoya HMC UV 55mm - Hàng nhập khẩu",329999,329999,0,0
TIKI,may-anh,24437557,"Camera công nghiệp nội soi wifi có tay cầm 31501WF",4100000,4100000,0,0
TIKI,may-anh,108974355,"Pin Kingma cho Sony NP-F970, Hàng chính hãng",499999,499999,0,0
TIKI,may-anh,80236568,"Camera wifi Yoosee 3 Râu xoay 360 trong nhà FullHD 1080 - Hàng Chính Hãng",389000,389000,0,0
TIKI,may-anh,181747823,"Camera WI-FI EZVIZ C3TN 2MP, Ngoài Trời, Không/Có Màu Ban Đêm, IP67 Chống Nước--Hàng Chính Hãng",709000,709000,0,0
TIKI,may-anh,180961149,"BỘ GIẢ PIN/ PIN ẢO DUMMY BATTERY SONY DR-FZ100 VÀ ĐẾ PIN KINGMA BM-F980D -Hàng chính hãng",1094999,1094999,0,0
TIKI,may-anh,4754755,"Tripod Smart Mini With Monopod Mefoto MK10 Benro - Hàng Nhập Khẩu",359999,359999,0,0
TIKI,may-anh,139012656,"Đèn Softbox Led360 5500K 60W HL Lighting Chụp Ảnh Quay Video Phòng Studio, Thiết Bị Ảnh Hàng Chính Hãng",989000,989000,0,0
TIKI,may-anh,271160214,"Camera WiFi Năng Lượng Mặt Trời NetCAM SL140, Góc Quan Sát 160º, Độ phân giải 3.0MP - Hàng Chính Hãng",1069000,1069000,0,0
TIKI,may-anh,37935420,"Bộ 4 cái chân đế treo tường cho camera Dome, camera hình cầu hoặc bán cầu - hàng nhập khẩu",27699,27699,0,0
TIKI,may-anh,15851220,"Hộp Chụp Sản Phẩm Vuông 40x40cm",349900,349900,0,0
TIKI,may-anh,20583823,"Sạp Pin BST-C9001 cho AA - AAA dung lượng lớn có màn hình LCD hiển thị sạc nhanh",179000,179000,0,0
TIKI,may-anh,4708417,"Kẹp Gopro (Đen) -  Hàng Nhập Khẩu",69000,69000,0,0
TIKI,may-anh,115819661,"Giá đỡ 3 chân, gậy chụp ảnh 3, chân máy chụp ảnh Tripod TF-3110 + Miếng kẹp điện thoại",50450,50450,0,0
TIKI,may-anh,191437490,"Trọn bộ 3 Camera 2MP DS-2CE16D0T-IR(C) + Đầu ghi hình Hikvision, có sẵn phụ kiện, cắm điện là chạy - Hàng chính hãng",2750000,3300000,550000,17
TIKI,may-anh,67730372,"Kính Hiển Vi 1600X Cắm Cổng USB ( KẾT NỐI DỄ DÀNG, ĐỘ PHÂN GIẢI ẢNH CAO ) - Hàng nhập khẩu",650000,650000,0,0
TIKI,may-anh,2545859,"Mount Dành Cho Canon EOS-FX - Hàng Nhập Khẩu",259000,259000,0,0
TIKI,may-anh,21196890,"ĐẦU GHI HIKVISION HD-TVI 3MP/5MP 08 KÊNH DS-7208HUHI-K1 (HÀNG CHÍNH HÃNG)",3280000,3280000,0,0
TIKI,may-anh,7263595,"Bàn Xoay Chụp Sản Phẩm 360 độ 25 cm",890000,890000,0,0
TIKI,may-anh,195720578,"ĐÈN LED QUAY PHIM YONGNUO YN660LED RGB Hàng Nhập khẩu",4190000,4190000,0,0
TIKI,may-anh,3039847,"Dây Máy Ảnh Peak Design Leash (Xám) - Size Nhỏ - Hàng Chính Hãng",1299999,1299999,0,0
TIKI,may-anh,158717693,"Camera AI thông minh SC-D3, xoay (Pan&Tilt), tự động phát hiện, lọc và theo dõi người",1100000,1100000,0,0
TIKI,may-anh,169987006,"LENS HOOD EW-83L - CHO ỐNG KÍNH Canonn 24-70F4L USM",150000,150000,0,0
TIKI,may-anh,159633320,"Bóng thổi VSGO Imp air Blower B013E, Gray - Hàng chính hãng",349999,349999,0,0
TIKI,may-anh,162154648,"Camera IP Wifi Ngoài trời 3.0MP VITACAM DZ3000 Pro, PTZ Xoay 355 - Hàng chính hãng",558000,558000,0,0
TIKI,may-anh,16915299,"Micro không dây cho máy ảnh, máy quay Comica CVM-WM200 (A/C) - Hàng chính hãng",6850000,6850000,0,0
TIKI,may-anh,92165299,"Camera Dahua Có Mic 4 Mp DH-HAC-HFW1400TLP-A-S2 1080P - Hồng ngoại 80m - Hàng chính hãng",1272700,1272700,0,0
TIKI,may-anh,187291480,"Ống kính Sigma 16-28mm f/2.8 DG DN for Sony - Hàng Chính hãng",21490000,21490000,0,0
TIKI,may-anh,124274648,"Thẻ Nhớ Điện Thoại Micro SD 8GB",58702,65450,6748,10
TIKI,may-anh,143613567,"Thẻ nhớ Lexar 64G Class10 hàng chính hãng",195000,195000,0,0
TIKI,may-anh,24166638,"Đầu Ghi Camera HD-TVI HIKVISION DS-7104HGHI-F1 - Hàng Chính Hãng",890000,890000,0,0
TIKI,may-anh,247420614,"Camera IP Wifi Dahua Imou IPC-A22EP 2.0mpx Full HD - Hàng Chính hãng",525000,525000,0,0
TIKI,may-anh,34700443,"Bộ 2 Pin Và Sạc Kép RAVPower Cho Canon LP-E6 5D IV 5DS 5DR 6DII 70D 80D 90D - Hàng Nhập Khẩu",774999,774999,0,0
TIKI,may-anh,201176852,"Tấm hắt sáng hỗ trợ chụp ảnh sản phẩm Camcamvintage",70000,70000,0,0
TIKI,may-anh,108651630,"Bộ 2 pin 1 sạc Kingma cho Canon NB-12L, Hàng chính hãng",999999,999999,0,0
TIKI,may-anh,71935259,"Camera IP hồng ngoại 2.0 Megapixel HIKVISION DS-2CD1023G0E-I(L) - HÀNG CHÍNH HÃNG",760000,760000,0,0
TIKI,may-anh,60028898,"Camera Nội Soi Chống Nước Cho Máy Tính Và Điện Thoại",158000,158000,0,0
TIKI,may-anh,109483877,"Chân máy ảnh Coman MT50, Hàng chính hãng",599999,599999,0,0
TIKI,may-anh,14967120,"Chân máy quay JY-0508B 1.85m",3100000,3100000,0,0
TIKI,may-anh,35585960,"KN-H21PW",1300002,1300002,0,0
TIKI,may-anh,163271087,"Gói hút ẩm tủ quần áo hạt hút ấm thực phẩm máy ảnh cho giày túi xách Silica Gel các loại gói 500 gr",55900,55900,0,0
TIKI,may-anh,155880977,"Combo Mount chuyển ngàm gopro sang vít 1/4 inch và gá kẹp điện thoại Yunteng VCT-Pat 018-Hàng chính hãng",119000,119000,0,0
TIKI,may-anh,6909825,"Tản sáng Godox Reflector ngàm Bowens  - Hàng nhập khẩu",250000,250000,0,0
TIKI,may-anh,15271640," 10 gói hạt hút ẩm xanh cho máy ảnh, máy quay phim (1gói /100gram) tặng 10 túi zip  - Hàng chính hãng",99000,99000,0,0
TIKI,may-anh,67457497,"Camera Ip Wifi Ngoài Trời Vitacam DZ3000  3.0MP Độ Phân Giải 1296P Ultra HD - Hàng Chính Hãng",560000,560000,0,0
TIKI,may-anh,59288795,"Đèn led video mini VIJIM VL81 Ulanzi hàng chính hãng.",450000,450000,0,0
TIKI,may-anh,45641220,"Tủ chống ẩm  AD-100S",3899999,3899999,0,0
TIKI,may-anh,101305785," Remote MC-30 / MC-DC2 cho máy ảnh Nikon",75000,75000,0,0
TIKI,may-anh,191474633," Balo máy ảnh Peak Design Totepack - Hàng chính hãng",5749000,5749000,0,0
TIKI,may-anh,50433508,"Thiết bị chống sét lan truyền mạng lan rj45 cho camera IP LKD105F4H-E100",315000,315000,0,0
TIKI,may-anh,191629444,"Dây Đeo Gắn Cằm Nón Bảo Hiểm Fullface cho  GOPRO Quay Phim, Chụp Ảnh Chất Lượng Cao Điều Chỉnh",49000,49000,0,0
TIKI,may-anh,109812827,"Balo máy ảnh Safrotto SM300, Hàng chính hãng",1949999,1949999,0,0
TIKI,may-anh,116793013,"Camera Gương ô tô, Camera Cạp Lề Sử Dụng Hiển Thị Điểm Mù Xe Hơi.",419000,419000,0,0
TIKI,may-anh,124658327,"Pin sạc lithium 3,7V 3500mAh chuyên dùng cho camera mini siêu nhỏ",50000,50000,0,0
TIKI,may-anh,551651,"Camera IP Wifi Dahua 1.3Mp IPC-HFW1120SP-W-Hàng Chính Hãng",1000000,1000000,0,0
TIKI,may-anh,15258381,"Hắt sáng 5 in 1 bầu dục kích thước 100x150cm",499000,499000,0,0
TIKI,may-anh,16379032,"Camera speed dome HIKVISION DS-2AE4223TI-D 2.0 Megapixel – Hàng Nhập Khẩu",8794000,8794000,0,0
TIKI,may-anh,193442641,"Ống nhòm nhìn ngày, đêm BARSKA NVX-700 (Phóng đại 9x) - Hàng Chính Hãng",9900000,9900000,0,0
TIKI,may-anh,171554130,"ĐÈN LIVESTREAM SIZE45CM - Chụp Hình - Make up -Kèm Chân đèn - Hàng Chính Hãng",999000,999000,0,0
TIKI,may-anh,197887844,"Camera wifi có màu ban đêm Imou f22fp - Hàng Chính Hãng",920000,920000,0,0
TIKI,may-anh,22634255,"Sạc Godox VC-18 sử dụng cho pin sạc Li-ion Godox VB-18 - Hàng Nhập Khẩu",344999,344999,0,0
TIKI,may-anh,155997730,"Tủ chống ẩm Nikatei NC-30C- Silver  (Dung tích 30 lít)-China . Tặng 01 bộ vệ sinh máy ảnh 8 in 1",1775555,1775555,0,0
TIKI,may-anh,160406276,"Công tắc cảm biến chuyển động hồng ngoại P002 gắn tường 1200W-220V có thể xoay 180 độ",176000,176000,0,0
TIKI,may-anh,15267069,"Bóng thổi bụi máy ảnh",89000,89000,0,0
TIKI,may-anh,194115568,"CAMERA WIFI NGOÀI TRỜI EZVIZ C3X 2M BẢN MẮT KÉP TÍCH HỢP AI, ĐÀM THOẠI 2 CHIỀU, BAN ĐÊM CÓ MÀU - HÀNG CHÍNH HÃNG",1390000,1390000,0,0
TIKI,may-anh,96406674,"Camera Hành Trình Để Taplo Kết Hợp Camera Lùi, 4G",5460000,5460000,0,0
TIKI,may-anh,20872841,"Micro Video Mini Saramonic Vmic Mini Cho Máy Ảnh DSLR Và Điện Thoại - Hàng Chính Hãng",1350000,1350000,0,0
TIKI,may-anh,45805979,"Camera Giám Sát IP Siêu Nhỏ Gọn EZVIZ Mini C1C 2MP Full HD 1080P (CS-C1C-1D2WFR) - Thẻ nhớ NETAC 32GB - Hàng Chính Hãng",580000,580000,0,0
TIKI,may-anh,198463697,"Gimbal DJI Osmo Mobile SE (OM SE) - Hàng Chính Hãng",2288000,2288000,0,0
TIKI,may-anh,3231241,"Chân Máy Ảnh Benro TSL08AN00 - Hàng Nhập Khẩu",1499999,1499999,0,0
TIKI,may-anh,176095808,"Chân máy ảnh tripod bạch tuộc hợp kim siêu bền đầu khớp xoay 360 độ",95000,95000,0,0
TIKI,may-anh,11631975,"Hộp Chụp Sản Phẩm Led 60x60",1249999,1249999,0,0
TIKI,may-anh,168960431,"Tủ Chống Ẩm Cao Cấp Nikatei NC-30S Viền Nhôm - Hàng Chính Hãng Bảo Hành 5 Năm",2150000,2150000,0,0
TIKI,may-anh,169245022,"Nước Rửa Mắt Kính Lens ASIA, Nước Vệ Sinh Máy Ảnh, Màn Hình Điện Thoại , Laptop Siêu Sạch",6900,6900,0,0
TIKI,may-anh,46689242," Bộ Pin và Sạc SONY NP-F970 Ravpower 7800 MAH - Hàng Chính Hãng",749999,749999,0,0
TIKI,may-anh,106584149,"Camera IP 2MPX  Wifi Ngoài Trời Imou F22FP Bullet 2E Full HD 1080P  CÓ MÀU BAN ĐÊM, KÈM THẺ NHỚ 32G - Hàng Chính Hãng",887000,887000,0,0
TIKI,may-anh,159276826,"Pin sạc Kingma Ver 3 cho Canon LP-E17 (Sạc Type C siêu nhanh), Hàng chính hãng",219999,219999,0,0
TIKI,may-anh,11187933,"Ống kính Yongnuo 50mm F1.8 Mark II for Canon - Hàng nhập khẩu",1999000,1999000,0,0
TIKI,may-anh,111850437,"Camera hành trình SJCAM SJ8 Pro Wifi 4K - Chống rung Gyro 6 trục, thời gian sử dụng 110 phút -Hàng Chính Hãng",3739000,3939000,200000,5
TIKI,may-anh,47277282,"Màn Hình Hỗ Trợ Quay Monitor Feelworld 7inch HD IPS Có Peaking Focus FW759 - Hàng Nhập Khẩu",2905000,2905000,0,0
TIKI,may-anh,4688899,"Chân Máy Ảnh Tripod Weifeng 6662A - Hàng Nhập Khẩu",629999,629999,0,0
TIKI,may-anh,120789075,"Kết nối chân máy bi cầu kim loại Q29 khớp nối kẹp điện thoại máy ảnh gopro ren 1/4",35000,35000,0,0
TIKI,may-anh,165707302,"Camera Aqara G3, QHD 2K,AI Tracking, hỗ trợ Apple HomeKit, tích hợp Hub Zigbee - Hàng Chính Hãng",2050000,2890000,840000,29
TIKI,may-anh,74245919,"Kính hiển vi soi tinh trùng Carson MS-040 (40-400x) - Hàng chính hãng",4550000,4550000,0,0
TIKI,may-anh,102603530,"Ba lô máy ảnh Lowepro Protactic BP300 AW II, Hàng chính hãng",3349999,3349999,0,0
TIKI,may-anh,160563261,"Đèn Flash Godox V860III cho máy ảnh Canon Hàng Chính Hãng",3549999,3549999,0,0
TIKI,may-anh,77712990,"Camera hành trình ô tô Xiaomi 70mai cao cấp A800S chất lượng hình ảnh 4K, tích hợp Wifi (Bộ tích hợp Camera trước + Sau) -  Bản Quốc Tế - Hàng Nhập Khẩu",4477000,4477000,0,0
TIKI,may-anh,15096383,"Chân máy ảnh/ Gậy chụp hình 3 chân dùng livestream - Tripod TF3110",47967,47967,0,0
TIKI,may-anh,55390064,"Kính thiên văn Celestron 70400 ( THỎA MÃN ĐAM MÊ THIÊN VĂN HỌC ) - HÀNG NHẬP KHẨU",3200000,3200000,0,0
TIKI,may-anh,45351133,"CHÂN MÁY ẢNH MANFROTTO PIXI EVO MINI (Đen) - Hàng Chính Hãng",1190000,1190000,0,0
TIKI,may-anh,80641635,"Máy ảnh chụp được dưới nước (ko kèm film kodak200 36exp). Máy ảnh chụp film lomo có thể chụp dưới nước (tối đa 3m), máy không cần pin lắp vào chụp luôn",169000,169000,0,0
TIKI,may-anh,115325415,"Chân đế Tripod Bluetooth cho điện thoại và máy ảnh TTX - 6218 (Kèm túi đựng và remote bluetooth)",290000,450000,160000,36
TIKI,may-anh,89689513,"Camera IP Wifi PTZ EZVIZ C8C FHD 1080P - Xoay 355 độ, tích hợp AI nhận diện con người - ban đêm có màu - hổ trợ thẻ nhớ lên đến 256G - hàng nhập khẩu",1198900,1198900,0,0
TIKI,may-anh,117059970,"Đèn chụp ảnh sản phẩm đèn softbox bộ đèn studio quay phim livestream chuyên nghiệp",243000,243000,0,0
TIKI,may-anh,261942173,"Camera IP Wifi 4MP EZVIZ C6W quay quét 360 độ - Hàng Chính Hãng",1160000,1160000,0,0
TIKI,may-anh,108215883,"Chân máy ảnh Benro SystemGo trục giữa xoay đứng - ngang, Hàng chính hãng",1949999,1949999,0,0
TIKI,may-anh,151500452,"Gói 500g hạt chống ẩm, hạt hút ẩm màu xanh cho máy ảnh tặng kèm 5 túi giấy vải đựng hạt",70000,70000,0,0
TIKI,may-anh,102905148,"Đầu ball Benro Video Head S6 Pro - Hàng Chính Hãng",3599999,3599999,0,0
TIKI,may-anh,79675307,"Hộp chụp sản phẩm Studio Box 80x80cm size lớn",2340000,2340000,0,0
TIKI,may-anh,88797887,"Balun 8mp A3 cho camera quan sát dùng được 720P/960P/1080P/3MP/4MP/5MP/8MP",27900,27900,0,0
TIKI,may-anh,188111220,"Camera IP Wifi Hikvision Ezviz C6N 2.0MP - Hàng chính hãng được bảo trì và PP tại Điện Tử Siêu Nhỏ",365000,365000,0,0
TIKI,may-anh,57003675,"Pin Dành Cho Máy Ảnh, Máy Quay Phim Sony NP-FV70 7.2V 2600mAh Cao Cấp AZONE",174999,174999,0,0
TIKI,may-anh,271289304,"Camera WiFi hành trình ô tô Gương chiếu hậu 9.66 inch Full gương -Màn hình cảm ứng -Kết nối điện thoại video 2K sắc nét - Camera kép trước và sau",915000,915000,0,0
TIKI,may-anh,77767028,"Thẻ nhớ SDHC Sony 32GB 90Mb/70Mb/s (SF-32UY3) - Chính Hãng",350000,350000,0,0
TIKI,may-anh,108586916,"Cáp đồng trục kèm dây nguồn RG59+2C Superlink cuộn 305m- Hàng chính hãng",1650000,1650000,0,0
TIKI,may-anh,174036090,"Bộ Kit camera IP Wifi HILOOK IK-4042BH-MH/W(B) - Hàng chính hãng",2750000,3280000,530000,16
TIKI,may-anh,7017765,"Đèn Flash Godox V860II TTL For Sony - Hàng nhập khẩu",2990000,2990000,0,0
TIKI,may-anh,25107816,"Dây máy ảnh bản nhỏ",120000,120000,0,0
TIKI,may-anh,139812717,"Ống nhòm một mắt chống nước BARSKA 10-30x50mm - Hàng chính hãng",3135000,3135000,0,0
TIKI,may-anh,68293626,"Balo máy ảnh Benro Incongito B200 - hàng nhập khẩu",1499999,1499999,0,0
TIKI,may-anh,19987491,"Miếng dán màn hình cường lực cho máy ảnh Sony A7/A7S/A7R",59000,59000,0,0
TIKI,may-anh,15851291,"Bộ Kit Studio 3 Đèn LED360 60W 5500K",2299900,2299900,0,0
TIKI,may-anh,58805539,"Đầu đọc thẻ nhớ USB 3.0 Kingma kèm hộp đựng hàng chính hãng.",249999,249999,0,0
TIKI,may-anh,20737732,"Túi máy ảnh Mirrorless cho các dòng máy Sony , Canon , Nikon , Pentax , Fuji - hàng nhập khẩu",159000,159000,0,0
TIKI,may-anh,24210643,"Ống nhòm ngày cao cấp Carson RD-826 (chống nước) - Hàng chính hãng",4390000,4390000,0,0
TIKI,may-anh,84426330,"Ống nhòm một mắt đo khoảng cách Bushnell Prime 1300 - Một sản phẩm chính hãng đến từ Bushnell USA ",6600000,6600000,0,0
TIKI,may-anh,151986433,"Dây máy ảnh đeo cổ tay",120000,120000,0,0
TIKI,may-anh,134354992,"Hộp Hút Ẩm 450ml Hàng Nhật",39500,39500,0,0
TIKI,may-anh,6911105,"Sạc Godox VC-18 sử dụng cho pin sạc Li-ion Godox VB-18 - Hàng Chính Hãng",344999,344999,0,0
TIKI,may-anh,96438054,"Gimbal Tay cầm chống rung tích hợp micro không dây cho smartphone cao cấp Hohem ISteady X Vlogger Kit - Hàng nhập khẩu",3168000,3168000,0,0
TIKI,may-anh,135237041,"Combo Camera Wi-fi Trong Nhà EZVIZ C3W-PRO 2MP/4MP Kèm Thẻ Nhớ  32GB/64GB - Hàng Chính Hãng",1100000,1100000,0,0
TIKI,may-anh,12318323,"Pin Kingma LP-E17 - Hàng Chính Hãng",294999,294999,0,0
TIKI,may-anh,7531507,"Ống Kính Viễn Vọng Barska Benchmark 8-24x58mm WP - Hàng chính hãng",4235000,4235000,0,0
TIKI,may-anh,46698686,"Camera IP Thông Minh Hình Robot 1.3",1032000,1032000,0,0
TIKI,may-anh,2020929,"Chân chụp tự sướng Mefoto MK10 - Hàng chính hãng",359999,359999,0,0
TIKI,may-anh,4712555,"Hộp Chống Ẩm "Wonderful" DB-3820N (12 Lít) - Hàng Nhập Khẩu",719000,719000,0,0
TIKI,may-anh,104069621,"Đầu ghi 16 kênh HDTVI H.265+ Hikvision DS-7216HQHI-K1 vỏ sắt - Hàng chính hãng",3850000,3850000,0,0
TIKI,may-anh,59508642,"Chân máy Joby GorillaPod 3K Kit - Chính Hãng",1579999,1579999,0,0
TIKI,may-anh,216907765,"KÍNH LỌC K&F CONCEPT HD SLIM MC UV GERMAN OPTICS Hàng Nhập Khẩu",250000,250000,0,0
TIKI,may-anh,155997083,"Túi đeo chéo PeakDeasign Everyday Sling 10L - Hàng Chính Hãng",3950000,3950000,0,0
TIKI,may-anh,54023423,"Camera IP wifi Ezviz CS-CV246 (C6CN 1080P) Kèm thẻ nhớ Sandisk 32GB - Hàng chính hãng",565000,565000,0,0
TIKI,may-anh,7589206,"Ball head mini xoay 360 độ gắn chân hot shoe máy ảnh ",99000,99000,0,0
TIKI,may-anh,208537325,"Camera Xiaomi 2K Magnetic Mount MJSXJ03HL - Hàng Chính Hãng",690000,690000,0,0
TIKI,may-anh,15851178,"Thẻ Nhớ 256GB SDXC Sandisk Extreme Pro 95MB/s - Hàng Chính Hãng",3245000,3245000,0,0
TIKI,may-anh,271871464,"Đầu đọc thẻ USB Lighting cho thẻ nhớ SD",125000,125000,0,0
TIKI,may-anh,48723392,"Bảng Đèn LED Di Động Viltrox RB10 Hàng Nhập Khẩu",1399000,1399000,0,0
TIKI,may-anh,78989278,"Camera Cập Lề USB Kết Nối Màn Hình Android,Độ Phân Giải AHD 1080P",559000,559000,0,0
TIKI,may-anh,197854688,"Camera WIFI EZVIZ TY1 4MP, Độ Phân Giải 2K, Đàm Thoại 2 Chiều, Hồng Ngoại Đêm 10m, Xoay Dọc 55 Độ Xay Ngang 360 Độ - Hàng Chính Hãng",630000,630000,0,0
TIKI,may-anh,23419898," Ống nhòm nhìn đêm một mắt  cao cấp Carson Mini Aura  NV-200 - Hàng chính hãng",5500000,5500000,0,0
TIKI,may-anh,130388439,"Camera ip Imou Ranger A22 (Mẫu 2021) - Chip Hình Ảnh Thế Hệ Mới - Full Hd 1080 - Hàng Chính Hãng",79000,79000,0,0
TIKI,may-anh,51001855,"Hộp đựng thẻ nhớ SD CF XD XQD TF ",199999,199999,0,0
TIKI,may-anh,177614722,"Thẻ nhớ Mirco SD HIKVISION 32GB - 92MB/s Class 10 chuyên dùng ghi hình cho các dòng camera IP, điện thoại, máy ảnh, máy tính bản - hàng chính hãng",81000,81000,0,0
TIKI,may-anh,14271032,"Áo mưa bảo vệ chống thấm cao cấp cho máy ảnh DSLR ZX-03, hàng chính hãng",179000,179000,0,0
TIKI,may-anh,28527933,"Camera Wifi Yoosee PTZ Full HD 1080 Quay Quét 360 Độ - Hàng Nhập Khẩu",410000,410000,0,0
TIKI,may-anh,10751487,"Bộ giá đỡ điện thoại, máy ảnh 3 chân tripod",54050,54050,0,0
TIKI,may-anh,195949057,"Camera Hành Trình Ô Tô DDPAI N3 Pro GPS Camera Trước Sau Độ Phân Giải 2K, Cảnh Báo Làn Đường, Giám Sát 24 Giờ, Định Vị GPS, Hiển Thị Tốc Độ, Hỗ Trợ Bộ Nhớ 128GB - Hàng Chính Hãng",2499000,4979000,2480000,50
TIKI,may-anh,3039837,"Bộ Phụ Kiện Peak Design Anchor Links - Hàng Chính Hãng",449999,449999,0,0
TIKI,may-anh,15927453,"Đèn LED Video Zifon ZF-3000 - Hàng Chính Hãng",1049999,1049999,0,0
TIKI,may-anh,15447191,"Máy Quay Phim Sony HDR-CX405 - Hàng Chính Hãng",6660000,6660000,0,0
TIKI,may-anh,4689015,"Smart Slider V2-500 - Hàng Nhập Khẩu",1990000,1990000,0,0
TIKI,may-anh,97708106,"Ống nhòm zoom Barska 7-15x35 Level - Hàng chính hãng",4598000,4598000,0,0
TIKI,may-anh,7362171,"Lens cap 49mm nắp đậy bảo vệ ống kính máy ảnh phi 49mm",59000,59000,0,0
TIKI,may-anh,191437399,"Camera HD-TVI DS-2CE16D0T-ITFS Tích Hợp Mic - Hàng Chính Hãng",585000,685000,100000,15
TIKI,may-anh,103504726,"Tủ chống ẩm máy ảnh Andbon AD-50C - Hàng chính hãng ",1749999,1749999,0,0
TIKI,may-anh,38440074,"Camera Dahua IP Wifi Imou IPC-C22EP-imou. Tặng thẻ nhớ 32g - Hàng chính hãng",505000,505000,0,0
TIKI,may-anh,57029872,"Camera Hành Trình xe hơi  X003 Tiếng Việt ( Trước + Sau) - Màn hình 4 inch - hàng nhập khẩu",529000,585000,56000,10
TIKI,may-anh,99350426,"Camera IP WiFi EZVIZ CS - C3N (A0-3H2WFRL) - Hàng Chính Hãng",1015000,1015000,0,0
TIKI,may-anh,194122771,"Camera IP Wifi Ngoài Trời EZVIZ C3TN 2MP 1080P Color Night Tích Hợp Mic Thu Âm - Có Màu Ban Đêm - Hỗ Trợ Thẻ Nhớ Lên 256G - Hàng Chính Hãng",820000,820000,0,0
TIKI,may-anh,23462917,"Đèn Flash Godox V1 For Sony - Hàng chính hãng",4099999,4099999,0,0
TIKI,may-anh,2533209,"Dây Đeo Máy Ảnh Photogear AC-16",99000,99000,0,0
TIKI,may-anh,107648558,"Camera IP Wifi Ngoài Trời IMOU IPC-F22P 1080P - Hàng Chính Hãng",725000,725000,0,0
TIKI,may-anh,177933143,"Camera IP WiFi Fullcolor quay quét ngoài trời Imou Cruiser SE 2MP IPC-S21FP hàng chính hãng",800000,800000,0,0
TIKI,may-anh,7711619,"Loa che nắng Metal cho ống kính Tele",99000,99000,0,0
TIKI,may-anh,78951808,"Túi đựng máy ảnh du lịch Hakuba Pix Gear 2",350000,350000,0,0
TIKI,may-anh,24843260,"Phông vải đơn sắc trắng",359000,359000,0,0
TIKI,may-anh,80332965,"Túi máy ảnh Soudelor mã 883",270000,270000,0,0
TIKI,may-anh,155527905,"Camera quan sát Qihoo 360 C211 2K 1296P, Xoay 360 độ, H264+ Smart AI App Botslab - Hàng chính hãng",699000,699000,0,0
TIKI,may-anh,2533205,"Dây Đeo Máy Ảnh Photogear AC-13",99000,99000,0,0
TIKI,may-anh,4727059,"Dây Đeo Máy Ảnh Ở Cổ Dạng Bện Sợi Tròn (Màu Ngẫu Nhiên) - Hàng Nhập Khẩu",79000,79000,0,0
TIKI,may-anh,116887465,"Camera hành trình ô tô, xe hơi, full HD 1080p, tích hợp màn hình Android - cổng USB",439000,439000,0,0
TIKI,may-anh,16460956,"Nguồn Camera IP 5V - 2A chân nhỏ",38000,38000,0,0
TIKI,may-anh,5849965,"Combo Đèn LED Video Zifon ZF-3000 Version II (New) + Bộ 01  Pin Và 01  Sạc F570 - Hàng Nhập Khẩu",1349999,1349999,0,0
TIKI,may-anh,6906625,"Mắt ngắm Eyecup FDA-EP10 cho máy ảnh Sony A6300 A6000",47000,47000,0,0
TIKI,may-anh,148926743,"chân đèn, chân máy ảnh Linco Zenith 8806 - Chân tripod cao cấp dành cho đèn livestream, máy ảnh, đèn studio ... - Cao tối đa 2m1 ",246600,246600,0,0
TIKI,may-anh,194122868,"Camera IP Wifi Ngoài Trời EZVIZ C3TN 2MP Full HD 1080P Tích Hợp Mic Thu Âm - Chống Ngược Sáng - Hàng Chính Hãng",750000,750000,0,0
TIKI,may-anh,48844715,"Camera hành trình ô tô, xe hơi Phisung K10 tích hợp camera sau Wifi GPS",1975000,1975000,0,0
TIKI,may-anh,5849471,"Chân Máy Ảnh Tripod Yunteng VCT-690RM - Hàng Nhập Khẩu",499999,499999,0,0
TIKI,may-anh,73954326,"Vali Lowepro Hardside 400 chống nước, chống va đập (Hàng chính hãng)",3199999,3199999,0,0
TIKI,may-anh,55985660,"Filter màu lọc ánh sáng 40x50cm",62000,62000,0,0
TIKI,may-anh,4755095,"Dù Xuyên Sáng (85cm) - Hàng Nhập Khẩu",79000,79000,0,0
TIKI,may-anh,85084712,"Camera wifi Ezviz C1C-B 2MP Full HD nhận diện con người thông minh chuẩn H.265 mới 2021 Đàm thoại 2 chiều",472000,472000,0,0
TIKI,may-anh,167045177,"Giá đỡ điện thoại dạng tripod 3 chân bạch tuộc uốn dẻo kèm remote bluetooth PK-BT-K2C-RM",109000,109000,0,0
TIKI,may-anh,247348434,"CAMERA WIFI 8.0MP VANTECH AI-V2033D-hàng chính hãng",871000,871000,0,0
TIKI,may-anh,104070046,"Adapter 12v 1,5A tuyệt vời cho camera",55000,55000,0,0
TIKI,may-anh,79117208,"Túi máy ảnh HAKUBA Digital Camera Pouch L",390000,390000,0,0
TIKI,may-anh,159725485,"Bộ vệ sinh máy ảnh di động VSGO VS-A8E, Hàng chính hãng",599999,599999,0,0
TIKI,may-anh,57437928,"Kính hiển vi điện tử cắm cổng USB kết nối với PC độ phóng đại 1000 lần có giá đỡ",406000,580000,174000,30
TIKI,may-anh,22761390,"Chân Floor Dolly Yunteng VCT 900 hàng nhập khẩu",849999,849999,0,0
TIKI,may-anh,108598660,"Combo Đèn led quay phim Zifon ZF-3000 New (Nhiều lựa chọn), Hàng nhập khẩu",169999,169999,0,0
TIKI,may-anh,270906792,"Camera Wifi TP-Link Tapo C220 Độ Phân Giải 2K QHD Quay/Quét 360 Độ Giám Sát An Ninh - Hàng Chính Hãng",699000,1338000,639000,48
TIKI,may-anh,57319053,"Camera nội soi chống nước kết nối điện thoại Android - máy tính qua cáp USB",299000,299000,0,0
TIKI,may-anh,76657556,"Kính hiển vi kỹ thuật số Carson MM-940 zPix 300 (86x-457x) - Hàng chính hãng",5100000,5100000,0,0
TIKI,may-anh,50395368,"Jack Balun video  kèm Power BL,AC  (2 chiếc ) dành cho camera",45000,45000,0,0
TIKI,may-anh,155996624,"Chân máy ảnh BEIKE Q-999 pro (NEW2021), Hàng chính hãng",1100555,1100555,0,0
TIKI,may-anh,21482306,"CAMERA HÀNH TRÌNH ÔTÔ Full Hd 1080P - Hàng nhập khẩu",299000,450000,151000,34
TIKI,may-anh,71172200,"Chân đỡ mono pod Beike Q166E - hàng nhập khẩu",222999,222999,0,0
TIKI,may-anh,53315699,"Camera Lùi Blaupunkt BC TY 1.0 Nhỏ Gọn, Được Giấu Kín, Tính Thẩm Mỹ Cao",2299000,2299000,0,0
TIKI,may-anh,197419292,"Bộ Pin LP-E8 1800mAh + Sạc Beston Dùng Cho Máy Ảnh Canon EOS 550D 600D 650D 700D Kiss X4 X5 X6i - Hàng nhập khẩu",155000,155000,0,0
TIKI,may-anh,173057262,"Máy Sạc Pin Fujitsu - FCT 344CEFX(CL) - 2hr - 4xAA 2000mAh - Hàng Nhập Khẩu ",899000,899000,0,0
TIKI,may-anh,188919540,"CAMERA YOOSEE WIFI 4 RÂU 32 LED 5.0 mpx. CỐ ĐỊNH -BẢO HÀNH 12 THÁNG CẢ THẺ NHỚ- HÀNG CHÍNH HÃNG",475000,475000,0,0
TIKI,may-anh,87730135,"Balun 8MP cho camera quan sát HD/CVI/TVI/AHD",38000,38000,0,0
TIKI,may-anh,86148559,"Chân máy ảnh Benro C2980T có đầu bi Ball head Highlightss E3-H2 - Chính Hãng",5699999,5699999,0,0
TIKI,may-anh,56627924,"Vali đựng đèn và phụ kiện studio",2290000,2290000,0,0
TIKI,may-anh,7527151,"Ống Nhòm Barska Porro 12x50 - Hàng chính hãng",2156000,2156000,0,0
TIKI,may-anh,10136067,"Dây máy ảnh đeo cổ  thao tác nhanh Quick Release bản 2cm",179000,179000,0,0
TIKI,may-anh,193601341,"Camera 4 in 1 hồng ngoại 5.0 Megapixel HIKVISION DS-2CE16H0T-ITPF - Hàng Chính Hãng",625000,625000,0,0
TIKI,may-anh,40429496,"1 PIN 1 SẠC MÁY ẢNH CANON LP-E6, LP-E6N CHÍNH HÃNG RAVPOWER RP-BC003",549999,549999,0,0
TIKI,may-anh,57509877,"Ống nhòm 15x50 ( ỐNG NHÒM SIÊU NÉT, NHÌN SIÊU XA, CÓ THƯỚC ĐO ) - HÀNG NHẬP KHẨU",4500000,4500000,0,0
TIKI,may-anh,3307269,"Tản sáng Lambency 2 màu",139000,139000,0,0
TIKI,may-anh,103998078,"CAMERA EZVIZ IP WIFI C6N 2.0MPX ,KÈM THẺ NHỚ 128G HÀNG CHÍNH HÃNG.",650000,650000,0,0
TIKI,may-anh,49994410,"Áo Nhiếp Ảnh Lowepro S&F Technical Vest (S/M) | Chính Hãng",1249999,1249999,0,0
TIKI,may-anh,101305870,"Combo hộp chống ẩm máy ảnh giá siêu rẻ 10 lít, 6 lít, 3 lít (tùy chọn hạt hoặc máy hút ẩm) - Hàng nhập khẩu",78000,78000,0,0
TIKI,may-anh,2563917,"Kẹp C Clamp With 1/4" Screw",129000,129000,0,0
TIKI,may-anh,73532511,"Micro thu âm không dây Saramonic Blink 500 Pro B2 (TX+TX+RX) - Hàng Chính Hãng",6485000,6485000,0,0
TIKI,may-anh,69861071," Dây máy ảnh đeo cổ tay hand strap",99000,99000,0,0
TIKI,may-anh,84086662,"Mic thu âm BOYA BY-WM3U cho điện thoại Type-C hàng chính hãng.",2499000,2499000,0,0
TIKI,may-anh,4713507,"Ống Kính Yongnuo 50mm F1.8 Cho Nikon - Tặng Kèm Loa Che Nắng HB-47 - Hàng Nhập Khẩu",1999000,1999000,0,0
TIKI,may-anh,14258461,"Dây đeo máy ảnh Peak Design Slide Camera Strap SL-BK-3 (Black) - Hàng Chính Hãng",1899999,1899999,0,0
TIKI,may-anh,109581686,"Chân máy quay Coman DF26Q7, Hàng chính hãng",6749999,6749999,0,0
TIKI,may-anh,16057149,"Bộ KIT 4 Camera UNV 2MP Full HD 1080P - Hàng chính hãng",5450000,5450000,0,0
TIKI,may-anh,5524529,"Camera Hành Trình 2570 Góc Rộng 8X Chất Lượng Cao Elitek - Hàng Nhập Khẩu",524900,524900,0,0
TIKI,may-anh,58984214,"THẺ NHỚ SDHC UHS-I EXCERIA KIOXIA 128GB - HÀNG NHẬP KHẨU",402000,402000,0,0
TIKI,may-anh,195948769,"Camera Hành Trình Ô Tô DDPAI N3 Độ Phân Giải 2K Cảnh Báo Làn Đường Giám Sát 24 Giờ, Định Vị GPS Hiển Thị Tốc Độ, Hỗ Trợ Bộ Nhớ Lên Tới 128GB - Hàng Chính Hãng",1899000,3789000,1890000,50
TIKI,may-anh,15851907,"Pin NP-F750/ F770 Cho Đèn LED",294999,294999,0,0
TIKI,may-anh,94582860,"CAMERA MINI CẦM TAY FULL HD CHO BÉ YÊU VUI CHƠI",580000,580000,0,0
TIKI,may-anh,10023288,"Chân máy (Tripod) máy ảnh, điện thoại Weifeng WT-3642B - Hàng Nhập Khẩu",599000,599000,0,0
TIKI,may-anh,4712469,"Tripod Benro Mefoto A1350Q1 - Hàng Nhập Khẩu",2749999,2749999,0,0
TIKI,may-anh,135389705,"Combo 5 Cáp POE Camera Loại Tốt - Chuyển Nguồn Camera Bằng dây lan POE",87789,87789,0,0
TIKI,may-anh,106306392,"Filter Kính lọc vuông Benro Hệ 100,  Hàng chính hãng",174999,174999,0,0
TIKI,may-anh,96869342,"Camera Wifi TP-Link Tapo C310 3MP An Ninh Ngoài Trời Tặng Thẻ nhớ 32GB - Hàng Chính Hãng",990000,990000,0,0
TIKI,may-anh,110692872,"Camera wifi ngoài trời DAHUA IMOU Bullet 2 4MP IPC-F42FEP hàng chính hãng",1009900,1009900,0,0
TIKI,may-anh,15927494,"Chân Máy Quay Jieyang JY-0508AD 1.72m - Hàng Chính Hãng",2790000,2790000,0,0
TIKI,may-anh,25498823,"Hộp chụp sản phẩm Puluz 20x20 có 40 bóng led siêu sáng (Tặng kèm đế đèn led)",199000,250000,51000,20
TIKI,may-anh,4712497,"Adapter Chuyển Chân Flash Thành Chân Ốc Tripod - Hàng Nhập Khẩu",89000,89000,0,0
TIKI,may-anh,22857246,"Gimbal VLOG Pocket chống rung cho Smartphone",1830000,1830000,0,0
TIKI,may-anh,4688979,"Shoot 360 Panoramic Gimbal Head For Tripod - Hàng Nhập Khẩu",999999,999999,0,0
TIKI,may-anh,14901551,"02 Kẹp phông nền Background studio 6 inch siêu cứng - Hàng nhập khẩu",79000,79000,0,0
TIKI,may-anh,68641829,"Hộp studio chụp sản phẩm tích hợp đèn Led KK1B",299000,388900,89900,23
TIKI,may-anh,14268248,"Đèn Flash Godox TT350F Cho Fujifilm - Hàng Chính Hãng",1599999,1599999,0,0
TIKI,may-anh,7617196,"Đế thao tác nhanh L Plate Nikon D750",399000,399000,0,0
TIKI,may-anh,193605662,"Đầu ghi hình 4 kênh 5 in 1 KBVISION KX-7104Ai - 7108Ai - Hàng Chính Hãng",710000,710000,0,0
TIKI,may-anh,16877159,"Kính thiên văn cao cấp",317000,317000,0,0
TIKI,may-anh,155225859,"(Freeship) Camera Hành Trình X-003 Kèm Camera Lùi 12 Megapixcel Hàng Nhập Khẩu Cao Cấp FHD 1080P Sắc Nét",470000,470000,0,0
TIKI,may-anh,173039847,"Máy Sạc Pin Fujitsu - FCT345CEFXL(B) - 3hr - 2xAA 1000mAh - Hàng Nhập Khẩu",459000,459000,0,0
TIKI,may-anh,10228343,"Dây đeo máy ảnh thao tác nhanh peak leash quick release",160000,160000,0,0
TIKI,may-anh,191021943,"Micro Không Dây LensGo LWM 348C Double dành cho Điện thoại / Máy ảnh / Máy quay - Hàng Chính Hãng",4990000,4990000,0,0
TIKI,may-anh,33145506,"Monitor HD 1280×800 IPS 7 inch FW759 ",3150000,3150000,0,0
TIKI,may-anh,71099442,"Jack BNC Lò Xo  Kết Nối Camera Chiết Liệu Tốt Lõ Đồng 10 Chiếc ",31000,31000,0,0
TIKI,may-anh,45830277,"Adaptor - Nguồn 12V-2A cho camera quan sát",34000,34000,0,0
TIKI,may-anh,3154579,"Ống nhòm Italia siêu cao cấp Konus Emperor 12x50 W.A màu xanh rêu - Hàng chính hãng",7990000,7990000,0,0
TIKI,may-anh,817884,"Ống Nhòm 1 Mắt Chuyên Nghiệp 3025",216000,216000,0,0
TIKI,may-anh,14952985,"Camera Mini Wifi HDQ15 Hồng Ngoại Kết Nối Không Dây Với Điện Thoại",588050,619000,30950,5
TIKI,may-anh,105106563,"Kính hiển vi kỹ thuật số màn hình lớn HD phóng đại 50-1000 lần zoom mẫu vật siêu nét có giá đỡ đa năng cao cấp (Tặng nút kẹp cao su giữ dây điện-giao ngẫu nhiên)",2042500,2150000,107500,5
TIKI,may-anh,15927437,"Đèn LED Quay Phim Yongnuo YN600L - Hàng Chính Hãng",2099999,2099999,0,0
TIKI,may-anh,8490373,"Bộ 2 Pin + 1 Sạc đôi Ravpower LP-E6 Cho Canon 5D Mark IV / 5D Mark III / 5DS / 5DS R / 5D Mark II / 6D Mark II / 7D Mark II / 7D / 80D / 70D / 60D (Chính Hãng Ravpower)",774999,774999,0,0
TIKI,may-anh,73318912,"Ống Kính Fujinon XF 16-55mm F2.8 WR OIS - Chinh Hang",28490000,28490000,0,0
TIKI,may-anh,194075173,"Camera Wifi Trong Nhà EZVIZ TY1 Full HD 1080P Quay Quét 355 độ - Đàm Thoại 2 Chiều - Hàng Chính Hãng",550000,550000,0,0
TIKI,may-anh,199996969,"Tấm hắt sáng để bàn đạo cụ hỗ trợ chụp sản phẩm kích thước A3",219000,219000,0,0
TIKI,may-anh,121335082,"Kính hiển vi 1 mắt soi tinh heo L400A",1700000,1700000,0,0
TIKI,may-anh,19911464,"Camera IP Wifi Imou -Ranger  Pr0 IPC- A26HP- Chuẩn 1080P- Chính Hãng",1350000,1350000,0,0
TIKI,may-anh,13586637,"Ống nhòm hàng hải Barska Deep Sea 7x50 WP (chống nước, có la bàn,vạch ly giác) - Hàng chính hãng",8635000,8635000,0,0
TIKI,may-anh,50744362,"Ống nhòm đêm một mắt Konuspy-12,thiết bị quan sát đêm chính hãng đến từ Italia",9500000,9500000,0,0
TIKI,may-anh,62333164,"Đèn Flash Godox V860II cho máy ảnh Canon hàng chính hãng.",3135000,3135000,0,0
TIKI,may-anh,190203831,"Benro Tourist 200 - Balo Máy Ảnh Cao Cấp Cho Du Lịch, Dã Ngoại, Chống Nước, Siêu Bền - Hàng Chính Hãng",1049999,1049999,0,0
TIKI,may-anh,22370544,"Chân máy ảnh monopod Yunteng YT 218 - Hàng Nhập Khẩu",179000,179000,0,0
TIKI,may-anh,53978130,"Camera giám sát ảnh nhiệt HIKVISION – Hàng chính hãng 100% – Mã HIKVISION DS-2TD2617B-3/PAB-SDSSET Cực nhanh – An toàn – Chính xác – Dễ truy vết",165550000,165550000,0,0
TIKI,may-anh,4739239,"Đèn LED Camera Yongnuo YN300-III (Đen) - Hàng Nhập Khẩu",1199999,1199999,0,0
TIKI,may-anh,170120618,"Lens hood cho ống kính Canon EF 135mm F2.0 (Loa che nắng ET-78II) - Hàng Nhập Khẩu",150000,150000,0,0
TIKI,may-anh,164286484,"Dây Cáp Kết Nối Máy Ảnh Canon Với Điện Thoại Chân Micro Loại Tốt Dành Cho CANON 60D, 70D, 6D, 7D, 5D MARK II, 5D MARK III, 700D",119000,119000,0,0
TIKI,may-anh,14258475,"Dây đeo tay Peak Design Cuff Camera Wrist Strap (Charcoal) - Hàng Chính Hãng",949999,949999,0,0
TIKI,may-anh,167428624,"Bộ nắp đậy máy ảnh & Ống Kính Dành cho Canon",45000,45000,0,0
TIKI,may-anh,191509286,"Pin Flycam ZLRC SG108 Pro - Hàng nhập khẩu",450000,450000,0,0
TIKI,may-anh,7443395,"Khung ngắm phóng đại 2.8x màn hình LCD V3",179000,179000,0,0
TIKI,may-anh,2546999,"Miếng Dán Màn Hình Cường Lực Cho Máy Ảnh Nikon D7100/D7200",59000,59000,0,0
TIKI,may-anh,159394352,"Pin sạc Ver 3 Kingma cho Nikon EN-EL3E (Sạc Type C siêu nhanh), Hàng chính hãng",249999,249999,0,0
TIKI,may-anh,165189043,"Kính hiển vi dạng bút Carson LED MicroPen MP-300 (24x-53x) - Hàng chính hãng",948000,948000,0,0
TIKI,may-anh,186636993,"Gimbal Chống Rung Feiyu Scorp C Cho Máy Ảnh DSLR và Mirrorless - Hàng Chính Hãng",6400000,6400000,0,0
TIKI,may-anh,4713505,"Ống Kính Yongnuo 50mm F1.8 Cho Nikon - Tặng Kèm Filter 58mm - Hàng Nhập Khẩu",1999000,1999000,0,0
TIKI,may-anh,58621697,"Sạc pin đôi LCD LP-E17 Kingma hàng chính hãng.",194999,194999,0,0
TIKI,may-anh,109522000,"Chân máy quay Coman DX16LQ5S, Hàng chính hãng",2799999,2799999,0,0
TIKI,may-anh,55638298,"Phông nền nhựa PVC chụp ảnh sản phẩm màu xanh lá",62000,62000,0,0
TIKI,may-anh,4738345,"Lens Hood Có Ren Vặn Phi 58mm (Đen) - Hàng Nhập Khẩu",59000,59000,0,0
TIKI,may-anh,147234108,"Tủ chống ẩm 100 lít Andbon DS-105S - Hàng chính hãng",4249999,4249999,0,0
TIKI,may-anh,155760537,"Camera hành trình ô tô cao cấp Phisung tích hợp camera sau Wifi GPS - Mã K10 - Hàng Nhập Khẩu",1975000,1975000,0,0
TIKI,may-anh,20263296,"Túi đựng máy ảnh Caden K11 - hàng chính hãng",649999,649999,0,0
TIKI,may-anh,147064695,"Tủ chống ẩm 300 lít Andbon AD-300S - Hàng chính hãng",11549999,11549999,0,0
TIKI,may-anh,46182841,"Sạc Pin Đôi LP-E12 Cho Máy Ảnh Canon M10 100D EOS Rebel S1 M M2 M50 M100 M200",159999,159999,0,0
TIKI,may-anh,33264002,"Pin Dành Cho Máy Ảnh Nikon EN-EL15 2800mAh Cao Cấp AZONE",212999,212999,0,0
TIKI,may-anh,4754861,"Hot Shoe 1/4 Double Screw - Hàng Nhập Khẩu",79000,79000,0,0
TIKI,may-anh,52274772,"Kính hiển vi mini MicroFlip MP-250",726000,889000,163000,18
TIKI,may-anh,108003774,"Camera IP Wifi Ezviz - C6N độ phân giải 2MP, quay quét thông minh hàng chính hãng Nhà An Toàn",375000,375000,0,0
TIKI,may-anh,99698637,"Ống Kính Sony  FE 55mm F1.8 (SEL55F18Z) - Hàng Chính Hãng",20990000,20990000,0,0
TIKI,may-anh,32031589,"Pin Dành Cho Máy Ảnh Canon LP-E8 1800mAh Cao Cấp AZONE",177999,177999,0,0
TIKI,may-anh,27670802,"Phụ kiện Chụp ảnh - Viên đá Chụp ảnh mẫu 8cm",95000,95000,0,0
TIKI,may-anh,96437714,"Camera HDTVI 5MP có mic HIKVISION DS-2CE78H0T-IT3FS Hàng Chính Hãng",890000,890000,0,0
TIKI,may-anh,109518183,"Chân máy ảnh Coman Monopod DT-287C Carbon, Hàng chính hãng",1349999,1349999,0,0
TIKI,may-anh,10772572,"Đầu Ghi Hình Camera IP Wifi Không Dây 8 Kênh NVR - Hikvision DS-7108NI-Q1/8P-Hàng Chính Hãng",2650000,2650000,0,0
TIKI,may-anh,40780363,"Cân màu cảm biến máy ảnh/máy quay Datacolor SpyderCHECKR - Hàng Chính Hãng",3740000,3740000,0,0
TIKI,may-anh,101305960,"Dây đeo máy ảnh chống mỏi thổ cẩm - Q00121",80000,80000,0,0
TIKI,may-anh,73828346,"Pin Dành Cho Máy Ảnh Canon LP-E8 1800mAh",233000,255000,22000,9
TIKI,may-anh,195845750,"Chân Đế Gắn Tường - Trần Nhà Dùng Cho Camera IP Xoay 360 Vitacam, Yoosee, Vimtag, Ebitcam",39000,39000,0,0
TIKI,may-anh,20869583,"Micro Cài Áo Boya BY-M4OD - Hàng Chính Hãng",300000,300000,0,0
TIKI,may-anh,40489611,"TÚI MÁY ẢNH MANFROTTO LIFESTYLE WINDSOR MESSENGER S | Hàng Chính Hãng",3189999,3189999,0,0
TIKI,may-anh,10160661,"Sạc pin máy ảnh Canon LP-E17",100999,100999,0,0
TIKI,may-anh,5866499,"Tủ Chống Ẩm Nikatei NC-20 - Gold (20 Lít) - Hàng Nhập Khẩu",1360000,1990000,630000,32
TIKI,may-anh,105645696,"Chân máy ảnh Benro dòng FIF19, Hàng chính hãng",2149999,2149999,0,0
TIKI,may-anh,195702265,"Camera HDCVI 2MP FullColor tích hợp mic DAHUA DH-HAC-HFW1239CP-A-LED hàng chính hãng",480000,480000,0,0
TIKI,may-anh,56251340,"Kính Hiển Vi Trẻ Em 400x-1200x Kèm Bộ 12 Tiểu Mẫu Động Thực Vật Cao Cấp AZONE ",474050,499000,24950,5
TIKI,may-anh,113364697,"Ống nhòm hàng hiệu Swarovski CL Pocket 10x25 ( Màu đen ) - Hàng chính hãng",22600000,22600000,0,0
TIKI,may-anh,15797692,"Bao Silicon Bảo Vệ Máy Ảnh cover  Cho Canon 6D đen",299000,299000,0,0
TIKI,may-anh,8095358,"Balo Peak Design Everyday - Ash (20L) - Hàng Chính Hãng",5999999,5999999,0,0
TIKI,may-anh,31186265,"Trọn bộ 4 Camera giám sát Dahua HD CVI 2 Megapixel HAC-HFW1200SP-S3 FULL 1080 - Hàng chính hãng",3820000,3820000,0,0
TIKI,may-anh,33498449,"Dây cáp HDMI to Mini HDMI dạng lò xo xoắn",190000,190000,0,0
TIKI,may-anh,134504137,"Camera IP hồng ngoại 2MP tích hợp Mic Hikvision DS-2CD1323G0-IUF - Hàng chính hãng",790000,790000,0,0
TIKI,may-anh,14089035,"Dây Bấm Mềm MC-DC2 For Nikon D750/D600/D7100/D7000/D90/D3200/D5200",79000,79000,0,0
TIKI,may-anh,69863175," Half case - Bao da máy ảnh Sony A6000/ A6300/ A6500",225000,225000,0,0
TIKI,may-anh,54628428,"Kính hiển vi Carson MS-100SP (100-1000X) tích hợp gắn điện thoại - Hàng chính hãng",10400000,10400000,0,0
TIKI,may-anh,198413180,"Camera Wifi EZVIZ C6, Camera xoay 360 Độ Phân Giải 2K+, Hỗ trợ băng tần kép, Đàm Thoại 2 Chiều, Tự Động Thu Phóng Chuyển Động, Điều khiển và nhận dạng bằng hành động vẫy tay - Hàng Chính Hãng",1050000,1050000,0,0
TIKI,may-anh,59241921,"Micro thu âm cài áo BOYA BY-M3 Type C - Chính hãng",689000,689000,0,0
TIKI,may-anh,169517340,"Camera IP wifi xoay 360 độ ngoài trời Ezviz C8C C8W C8PF -  Hàng chính hãng",1040000,1040000,0,0
TIKI,may-anh,207389957,"Vỏ Chống Nước dành cho GoPro 12 - Case Bảo Vệ dành cho GoPro 12 10 11",299000,299000,0,0
TIKI,may-anh,10144802,"Dock Sạc Pin Đôi Kèm Cáp Cho Camera Hành Trình Sjcam SJ4000 & SJ5000 & M10 - Hàng Chính Hãng",129000,129000,0,0
TIKI,may-anh,169447669,"Dây đeo cổ tay dành cho máy ảnh - sợi tròn",135000,135000,0,0
TIKI,may-anh,108917856,"Sạc đôi Kingma MH-26 dùng chung cho pin EN-EL18, LP-E4, LP-E19, Hàng chính hãng",1749999,1749999,0,0
TIKI,may-anh,742005,"Chân Máy Ảnh Benro TSL08CN00 (Tripod) - Hàng Chính hãng",2399999,2399999,0,0
TIKI,may-anh,16257969,"Bao Silicon Bảo Vệ Máy Ảnh  Cover Cho Nikon D750 Đen",320000,320000,0,0
TIKI,may-anh,21163516,"Chân chụp ảnh dùng cho điện thoại Yunteng VCT 5208 - Hàng nhập khẩu",259999,259999,0,0
TIKI,may-anh,167422519,"Túi máy ảnh Crumpler Jackpack 4000",285000,285000,0,0
TIKI,may-anh,15411544,"Camera IP Hdparagon HDS-2021IRP/D 2.0 Megapixel - Hàng Nhập Khẩu",1110000,1110000,0,0
TIKI,may-anh,4712921,"Vali Đựng Đèn Và Phụ Kiện - Bag B - Hàng Nhập Khẩu",2890000,2890000,0,0
TIKI,may-anh,52627677,"Phông Nền Chụp Hình Sản Phẩm - Đạo Cụ Chụp Ảnh",78000,78000,0,0
TIKI,may-anh,148985046,"Gậy chống rung GIMBAL STABILIZER L08",400000,400000,0,0
TIKI,may-anh,14432477,"Đầu ghi hình Camera 16 kênh HIKVISION chuẩn H265 DS-7216HGHI-K2 - Hàng chính hãng",1990000,1990000,0,0
TIKI,may-anh,50011409," Kính hiển vi Carson MM-840 eFlex (75x-300x) - Hàng chính hãng",4390000,4390000,0,0
TIKI,may-anh,44309246,"Sạc pin đôi LP-E8 cho máy ảnh Canon 550D 600D 650D 700D",169999,169999,0,0
TIKI,may-anh,109860447,"Ba lô kéo máy ảnh Safrotto M20N, Hàng chính hãng",3299999,3299999,0,0
TIKI,may-anh,16463296,"Nguồn Camera 12V - 1A",28000,28000,0,0
TIKI,may-anh,113250891,"Camera Hikvision DS-2CE16D0T-IR , camera ds 2ce16d0t ir - Hàng chính hãng",395000,395000,0,0
TIKI,may-anh,147294850,"Camera Wifi Quan Sát X6 FULLHD 1080P - Hỗ Trợ Hồng Ngoại Quay Ban Đêm, Hình Ảnh Sắc Nét Cả Ngày Và Đêm, Pin Sạc, Siêu Bền- Kết Nối Wifi Qua Điện Thoại Xem Từ Xa",399000,399000,0,0
TIKI,may-anh,195998922,"Đầu ghi camera 8 kênh turbo 1080P H.265 Hikvision DS-7208HGHI-K1(S) hàng chính hãng",1040000,1040000,0,0
TIKI,may-anh,50395372,"Jack Balun chuyển đổi POE cho Camera IP VBC_01 ( 2 chiếc )",25000,25000,0,0
TIKI,may-anh,96113823,"Dây Deo Tay Peak Design Cuff Wrist Strap  Ash - Hàng Chính Hãng",1090000,1090000,0,0
TIKI,may-anh,109764110,"Đế treo tường Camera @Yoosee , VÀ MỘT SỐ CAMERA TƯƠNG TỰ HÀNG NHƯ HÌNH.",19000,19000,0,0
TIKI,may-anh,49758145,"Pin Cho Máy Quay Phim Sony NP-F970 NP-F960 PD 7.2v 7800mAh Black",316999,316999,0,0
TIKI,may-anh,4713319,"Chân Đèn Nhỏ (80cm) - Hàng Nhập Khẩu",168000,168000,0,0
TIKI,may-anh,106906155,"Kính hiển vi sinh học một mắt phóng đại 640 lần chuyên dụng dùng cho phòng thí nghiệm khoa học giáo dục cao cấp (Tặng miếng thép để ví 11in1)",1282500,1350000,67500,5
TIKI,may-anh,66898383,"Chân bạch tuộc Ulanzi 30cm MT-11 hàng chính hãng.",249000,249000,0,0
TIKI,may-anh,192134359,"Camera hành trình SJCAM SJ10 Pro Dual Screen - Máy quay hành động màn hình kép chống rung 6 trục đỉnh cao - Hàng chính hãng",4449000,5000000,551000,11
TIKI,may-anh,4739307,"Lens Hood Nikon HB-23 (Đen) - Hàng Nhập Khẩu",129999,129999,0,0
TIKI,may-anh,155997860,"Chân máy ảnh Beike System Go 999H, Hàng chính hãng",1250555,1250555,0,0
TIKI,may-anh,32362602,"Camera lùi độ phân giải AHD 1080P góc quay 170 độ dùng cho màn hình android",199000,199000,0,0
TIKI,may-anh,15668655,"Hộp Đựng Thẻ Nhớ Backpacker KH5 – Hàng Nhập Khẩu",139000,139000,0,0
TIKI,may-anh,4707471,"Bộ Monopod Weifeng 3978M - Hàng Nhập Khẩu",974999,974999,0,0
TIKI,may-anh,170815916,"Trọn Bộ Camera Quan Sát 2 Mắt Hikvision 2.0MP Full HD - Hàng chính hãng",3700000,3700000,0,0
TIKI,may-anh,140964753,"Kính hiển vi sinh dành cho học sinh Mcroscope - C2170 độ phóng đại lên 1200X",450000,450000,0,0
TIKI,may-anh,95064538,"Camera thân HDCVI Dahua DH-HAC-HFW1200TP-S5 2MP 1080P hồng ngoại 30m hàng chính hãng DSS Việt Nam",360000,360000,0,0
TIKI,may-anh,11340644,"Camera hành trình mô tô - xe máy hồng ngoại HD 720P bộ 2 camera MT-18",688750,725000,36250,5
TIKI,may-anh,53252640,"Camera Hành Trình Trước Sau Blaupunkt BP 9.0A Có GPS",9713000,9713000,0,0
TIKI,may-anh,6991111,"Túi đựng máy ảnh DSLR Canon, Nikon, Sony (Xám)",250000,250000,0,0
TIKI,may-anh,31545580,"Dù xuyên phản sáng hai lớp 110cm",265000,265000,0,0
TIKI,may-anh,4755167,"Eyecup DK-21 Dành Cho Nikon - Hàng Nhập Khẩu",58000,58000,0,0
TIKI,may-anh,6554835,"Chân máy Benro Slim Tripod TSL08CN00 - Hàng Chính Hãng",2399999,2399999,0,0
TIKI,may-anh,155997015,"Túi máy ảnh Safrotto SF003",1000555,1000555,0,0
TIKI,may-anh,168571747,"Túi máy ảnh Peak Design Everyday Sling 6L Ask Ver 2, Hàng chính hãng",3249999,3249999,0,0
TIKI,may-anh,825454,"Đèn Led Yongnuo YN - 300 III - Hàng Nhập Khẩu",1299999,1299999,0,0
TIKI,may-anh,39175889,"Pin Kingma PB-511A cho máy ảnh Canon 30D , 40D , 50D , 5D  - hàng chính hãng ",299999,299999,0,0
TIKI,may-anh,168617067,"Dây máy ảnh thao tác nhanh Quick Release",135000,135000,0,0
TIKI,may-anh,4755381,"Bracket Đuôi Gắn Đèn Chụp Sản Phẩm - Hàng Nhập Khẩu",119000,119000,0,0
TIKI,may-anh,4754655,"LED Yongnuo YN-300 III Thế Hệ Mới Nhất - Hàng Nhập Khẩu",1299999,1299999,0,0
TIKI,may-anh,95064620,"Camera IP Wifi PTZ Imou IPC-S22FP 2MP FullColor ngoài trời hàng chính hãng",1450000,1560000,110000,7
TIKI,may-anh,154240729,"Thẻ nhớ Sony 64GB SF-E64 270-70 MB/s U3 4K (SF-E64T1) - Hàng Chính hãng",900000,900000,0,0
TIKI,may-anh,56995621,"Pin Dành Cho Máy Ảnh Sony NP-FV100 7.2V 4200mAh Cao Cấp AZONE",213750,225000,11250,5
TIKI,may-anh,127076515,"Sạc pin for Canon LP-E6 tự ngắt dành cho máy ảnh Canon 5DII , 5DIII , 6D , 7D, 70D, canon 60D",259000,259000,0,0
TIKI,may-anh,3597917,"Bộ 3 Đinh Ốc 3/8 Inch Gắn Chân Máy Ảnh - Tripod Địa Hình Q00803",144999,144999,0,0
TIKI,may-anh,49410516,"Bao bảo vệ silicon cho Gopro 8 Black",59000,59000,0,0
TIKI,may-anh,175544983,"Camera IP WIFI Imou A22EP IPC-A22EP-D-V3 2M FHD 1080P - Hàng Chính Hãng",498000,498000,0,0
TIKI,may-anh,56017934,"Kẹp cầm tay SmileBox kiêm tripod mini để bàn hỗ trợ quay video, livestream cho điện thoại, gopro, máy ảnh chuẩn đinh ốc 1/4",69000,69000,0,0
TIKI,may-anh,5875967,"Đèn LED Yongnuo YN-600L II - Hàng nhập khẩu",2399999,2399999,0,0
TIKI,may-anh,50383572,"Combo jack nối cáp đồng trục BNC 2 đầu âm loại tốt ( 10 chiếc )",44900,44900,0,0
TIKI,may-anh,17923513,"Sạc pin NP-BN1 cho máy ảnh Sony",95000,95000,0,0
TIKI,may-anh,114211345,"DS-2CD1327G0-L CAMERA IP HIKVISION COLORVU LITE CÓ MÀU 24/7 - Hàng chính hãng",1190000,1190000,0,0
TIKI,may-anh,102044535,"Kính hiển vi sinh học 40X - 640X 88-56000 - Hàng nhập khẩu",1200000,1200000,0,0
TIKI,may-anh,124935051,"Camera mini wifi 360 hình cú 1080p giám sát an ninh, đàm thoại 2 chiều, quay ban đêm, pin 3 giờ, zoom 4X",850000,850000,0,0
TIKI,may-anh,42288524,"Gimbal Chống Rung Zhiyun Weebill S - Hàng Chính hãng",6540000,6540000,0,0
TIKI,may-anh,14957929,"Chân Máy Ảnh Joby Gorillapod 3K - Hàng Chính Hãng",899999,899999,0,0
TIKI,may-anh,3597901,"Chân Máy Ảnh Tripod Bạch Tuộc Loại Lớn Q00151",99000,99000,0,0
TIKI,may-anh,2547021,"Giá Đỡ Gopro Hero Lên Xe Đạp Handlebar Bar Mount Holder (Đen)",64999,64999,0,0
TIKI,may-anh,46780284,"Túi Đựng Gimbal Zhiyun Smooth Q2 - Hàng Nhập Khẩu",149000,149000,0,0
TIKI,may-anh,208113451,"Tấm hắt sáng hỗ trợ chụp ảnh sản phẩm",65000,65000,0,0
TIKI,may-anh,46134868,"SIGMA 24-70MM F2.8 DG DN ART FOR SONY E (CHÍNH HÃNG)",24990000,24990000,0,0
TIKI,may-anh,24987722,"Trọn bộ 4 camera Hikvision 2.0 Megapixel - Hàng chính hãng",3250000,3250000,0,0
TIKI,may-anh,169514642,"Dây đeo thao tác nhanh dành cho máy ảnh - Kquick strap",140000,140000,0,0
TIKI,may-anh,193887385,"Nguồn cho Camera 12V-1A Hikvision - Hàng Chính Hãng",59000,59000,0,0
TIKI,may-anh,7615973,"Đế gắn dù và 2 flash chuyên nghiệp",199000,199000,0,0
TIKI,may-anh,6921775,"Micro Lavalier cài áo Boya BY-M1 - Hàng nhập khẩu",247000,247000,0,0
TIKI,may-anh,108430780,"Combo 1 pin 1 sạc đôi Kingma for Sony NP-FZ100 - Hàng chính hãng",649999,649999,0,0
TIKI,may-anh,120788130,"Phụ Kiện Chân Cài Cao J Cho Go Pro, Sjcam, Yi Action, Osmo Action",9790,9790,0,0
TIKI,may-anh,15214329,"Đui đèn đôi có lỗ gài ô E27",210000,210000,0,0
TIKI,may-anh,185232675,"Balo đeo chéo CaseLogic 308 dành cho máy ảnh",580000,580000,0,0
TIKI,may-anh,14144660,"1kg gói hạt hút ẩm clays loại 250gram sử dụng đa năng (1 dây 4 gói 250gram dạng treo)",59000,59000,0,0
TIKI,may-anh,155996043,"Chân máy ảnh Benro FSL09AN00 - Hàng Chính Hãng",1650555,1650555,0,0
TIKI,may-anh,76797768,"Túi đựng chân máy ảnh Travel Tripod",450000,450000,0,0
TIKI,may-anh,8095367,"Balo Peak Design Everyday- Charcoal (20L) - Hàng Chính Hãng",5999999,5999999,0,0
TIKI,may-anh,109506587,"Chân đơn Monopod COMAN DT327C Carbon, Hàng chính hãng",1749999,1749999,0,0
TIKI,may-anh,169416163,"Filter Kenko UV - Hàng Chính Hãng full size",90000,90000,0,0
TIKI,may-anh,189641651,"Chân máy quay Beike Q880A, Hàng nhập khẩu",2500555,2500555,0,0
TIKI,may-anh,15851166,"Pin NP-F550/ F570 Cho Đèn LED",224999,224999,0,0
TIKI,may-anh,4754697,"Lens Yongnuo Af-S 50F1.8 Dành Cho Nikon - Hàng Nhập Khẩu",1999000,1999000,0,0
TIKI,may-anh,14867785,"Cáp USB kết nối máy ảnh Canon với máy tính Puluz - Hàng chính hãng",89999,89999,0,0
TIKI,may-anh,124273897,"Camera Mô Hình Chống Trộm Security Camera",26000,28000,2000,7
TIKI,may-anh,39321068,"Pin Dành Cho Máy Ảnh Sony NP-FW50 1080mAh Cao Cấp AZONE",206999,206999,0,0
TIKI,may-anh,101346967,"Chân máy quay Benro KH26P, Hàng chính hãng",3999999,3999999,0,0
TIKI,may-anh,46183656,"Bộ 2 Pin + Sạc Đôi RAVPower RP-BC029 Canon LP-E12 Cho Canon EOS M10, EOS M6, EOS M50, EOS M100, EOS M200, EOS 100D, EOS 200D, EOS 250D (Hàng Chính Hãng)",498999,498999,0,0
TIKI,may-anh,155996946,"Túi máy ảnh Benro Smart II 30 - Hàng Chính Hãng",1000555,1000555,0,0
TIKI,may-anh,3307255,"Tripod adapter cho Gopro (Đen)",49000,49000,0,0
TIKI,may-anh,7989161,"Gá gắn dù đèn Flash có ball head điều chỉnh 360 độ",129000,129000,0,0
TIKI,may-anh,2629943,"Bộ sạc pin máy ảnh đa năng PhotoCam Vario ANSMANN - Hàng Nhập Khẩu",374999,374999,0,0
TIKI,may-anh,247722545,"Phông chụp ảnh 3x6m",369000,369000,0,0
TIKI,may-anh,121331339,"Dây đeo túi Laptop , máy ảnh có thể điều chỉnh tiện dụng",29000,29000,0,0
TIKI,may-anh,109876352,"Vali kéo máy ảnh Safrotto TT100S, Hàng chính hãng",3149999,3149999,0,0
TIKI,may-anh,84085305,"10 con rắc F5 (vặn vào dây GR6) và 10 con rắc camera (PNC ) HÀNG NHƯ HÌNH",52000,52000,0,0
TIKI,may-anh,7533005,"Lens hood Loa che nắng hoa sen vặn ren ống kính máy ảnh Phi 49mm",79000,79000,0,0
TIKI,may-anh,16378757,"CAMERA HÀNH TRÌNH X002 tiếng việt",483000,483000,0,0
TIKI,may-anh,15669042,"Micro Thu Âm Đa Năng Boya BY-MM1 - Hàng Chính Hãng",415000,415000,0,0
TIKI,may-anh,22166673,"Đầu Ghi Camera  Turbo HD 3.0 DVR 16 Kênh Hikvision DS-7216HGHI-F1/N - Hàng chính hãng",2650000,2650000,0,0
TIKI,may-anh,7708906,"Nắp đậy ống kính cho Sony",39000,39000,0,0
TIKI,may-anh,26087099,"KÍNH LỌC HOYA UX UV SIZE 49MM - Hàng Chính Hãng",289999,289999,0,0
TIKI,may-anh,26086163,"KÍNH LỌC HOYA UX UV SIZE 82MM - HÀNG CHÍNH HÃNG",749999,749999,0,0
TIKI,may-anh,33495948,"Dây cáp HDMI to Micro HDMI dạng lò xo xoắn",190000,190000,0,0
TIKI,may-anh,230207801,"Camera IP Ngoài Trời Ezviz H3 2K 3MP - Phát hiện chuyển động thông minh, độ sắc nét cao, có màu ban đêm, vỏ hợp kim nhôm chống chịu thời tiết, chống nước IP 67 - Hàng chính hãng ",1270000,1270000,0,0
TIKI,may-anh,83387613,"Hộp gồm 5 gói hút ẩm Hando",55000,55000,0,0
TIKI,may-anh,47485037,"Kính Lọc Filter B+W XS-Pro Digital 007 MRC Nano 82mm - Hàng Chính Hãng",1874999,1874999,0,0
TIKI,may-anh,168610019,"Bộ nắp lens & body Canon",40000,40000,0,0
TIKI,may-anh,8144029,"Tản sáng gom sáng đa chiều FLash Bender KB-23",199000,199000,0,0
TIKI,may-anh,6999839,"Đầu ball head gimbal tripod head BK-45 ống kính nặng",848999,848999,0,0
TIKI,may-anh,2567015,"Mắt Ngắm Nikon Eyecup DK-23",59000,59000,0,0
TIKI,may-anh,50383580,"Combo jack nối cáp đồng trục BNC 2 đầu âm loại tốt ( 100 chiếc )",350000,350000,0,0
TIKI,may-anh,14120075,"Miếng Dán Màn Hình Cường Lực Cho Máy Ảnh Olympus Em5/Em1/Em10",59000,59000,0,0
TIKI,may-anh,4739053,"Điều Khiển Chụp Ảnh Cho Máy Nikon JYC ML3 (Đen) - Hàng Nhập Khẩu",54999,54999,0,0
TIKI,may-anh,10055673,"Túi đựng ống kính lens máy ảnh chống sốc cao tối đa 24 cm",79999,79999,0,0
TIKI,may-anh,14034628,"Tay quay phim chống rung cho máy ảnh và điện thoại SLR GOPRO (Tặng 01 gá kẹp điện thoại)",199000,199000,0,0
TIKI,may-anh,158125552,"Hộp khuyếch tán ánh sáng đèn flash gấp gọn Puluz PU5120, hàng chính hãng",149000,149000,0,0
TIKI,may-anh,8581733,"Tay boom đèn khớp khủy ngàm chữ U túi vải đối trọng chân đèn 2m",608000,608000,0,0
TIKI,may-anh,147476872,"Balun camera 5MP AHD/CVI/TVI chống nhiễu - giành cho camera CCTV analog - loại tốt",33000,33000,0,0
TIKI,may-anh,119537990,"Giá Đỡ Mở Rộng Cho Gimbal và Tay Cầm Chống Rung",189000,189000,0,0
TIKI,may-anh,192398256,"Tủ đựng đầu ghi camera giám sát kích thước 45*38*12 (Có chìa khóa)",227000,227000,0,0
TIKI,may-anh,4727759,"Túi Đựng Chân Đèn Tripod - Hàng Nhập Khẩu",259000,259000,0,0
TIKI,may-anh,6955129,"Khung rig vác vai kim loại quay phim DSLR shoulder rig Movie RL01",426550,449000,22450,5
TIKI,may-anh,270925434,"Camera WiFi quay quét 3MP IMOU RC IPC-GK2CP-3C0WR hàng chính hãng",555000,555000,0,0
TIKI,may-anh,15669062,"Micro Thu Âm Saramonic SR-M3 - Hàng Chính Hãng",1199000,1199000,0,0
TIKI,may-anh,3428585,"Hộp Chụp Sản Phẩm Có Đèn LED (40 x 40 cm)",359000,359000,0,0
TIKI,may-anh,20872392,"Micro Cài Áo Saramonic LavMicro - Hàng Chính Hãng",1275000,1275000,0,0
TIKI,may-anh,36463373,"Đèn Flash Godox TT350S Cho Sony - Kèm Pin Và Sạc - Hàng Nhập Khẩu",1899999,1899999,0,0
TIKI,may-anh,55961093,"Phông vải key hình, phông nền studio xanh dương",330000,330000,0,0
TIKI,may-anh,4707929,"Bộ Vệ Sinh Dành Cho Máy Ảnh DSLR Nikon (Đen) - Hàng Nhập Khẩu",89999,89999,0,0
TIKI,may-anh,95991896,"Rode Wireless GO II - Micro Thu Âm Không Dây Cao Cấp Cho Máy Ảnh, Tự Động Lưu Bản Ghi, Hoạt Động 7 Giờ (2 phát 1 thu) - Hàng nhập khẩu",7770000,7770000,0,0
TIKI,may-anh,4713061,"Tripod Weifeng 6663A - Hàng Nhập Khẩu",914999,914999,0,0
TIKI,may-anh,150939646,"Camera IP Wifi FullColor 1080P lắp ngoài trời Imou IPC-F22FP hàng chính hãng DSS Việt Nam",670000,670000,0,0
TIKI,may-anh,72802036,"Đèn Flash Yongnuo 14EX II TTL Macro Ring Flash Kit for Canon Hàng nhập khẩu",2999000,2999000,0,0
TIKI,may-anh,174416981,"Ống nhòm Bushnell LEGEND 12x50 - thiết kế mới với hình thái công thái học mang lại cảm giác cầm nắm tự tin - Hàng chính hãng",6990000,6990000,0,0
TIKI,may-anh,37487298,"Camera Yoosee 3.0MPX - Thế hệ mới",350000,350000,0,0
TIKI,may-anh,155996091,"Chân máy ảnh Benro TSL08CN00, Carbon - Hàng Chính Hãng",2225555,2225555,0,0
TIKI,may-anh,188701430,"Ba lô máy ảnh Lowepro StreetLine BP 250 - Hàng chính hãng",1449999,1449999,0,0
TIKI,may-anh,24245389,"Ống nhòm ngày chống nước cao cấp Carson JR-042 (10x42) - Hàng chính hãng",6800000,6800000,0,0
TIKI,may-anh,75183489,"Ống nhòm Celestron chính hãng Mỹ với độ phóng đại 20 lần, ống kính mục tiêu 50mm,  dạng Porro chống sốc và trơn trượt ",1050000,1050000,0,0
TIKI,may-anh,113391694,"Bộ kết nối điện thoại thông minh đa năng, cao cấp HookUpz 2.0, IS-200 - Hàng chính hãng",2080000,2080000,0,0
TIKI,may-anh,19988259,"Miếng dán màn hình cường lực cho máy ảnh Canon 5D3/5D4/5DR/5DS/1DX",59000,59000,0,0
TIKI,may-anh,155997584,"Kính lọc Filter B+W F-Pro 010 UV-Haze E 62mm - Hàng Chính Hãng",849555,849555,0,0
TIKI,may-anh,155997928,"Tủ chống ẩm di động Andbon B10 ( có chống va đập ), Hàng chính hãng",689555,689555,0,0
TIKI,may-anh,105212342,"Sigma 35mm F1.4 DG DN (ART) ngàm Sony E-Mount - Hàng Chính hãng",20990000,20990000,0,0
TIKI,may-anh,49115547,"Chân tripod mini, giá đỡ điện thoại mini DF228",41890,41890,0,0
TIKI,may-anh,73669362,"Ống nhòm cao cấp 20-50 - Tặng 2 la bàn mini du lịch",712500,750000,37500,5
TIKI,may-anh,42435298,"Camera Hành Trình Ghi Lại 3 Chiều Phía Trước Phía Sau Gương Chiếu Hậu",429000,429000,0,0
TIKI,may-anh,6990697,"Tấm đế Plate P200 gắn glidecam thanh trượt dolly slider",199000,199000,0,0
TIKI,may-anh,196189335,"Gimbal Zhiyun WEEBILL 3 - Tay cầm chống rung dành cho máy ảnh - Hàng chính hãng",10290000,10290000,0,0
TIKI,may-anh,160559988,"Gimbal chống rung Zhiyun Weebill 2 Hàng Chính Hãng",12990000,12990000,0,0
TIKI,may-anh,101628379,"Camera Giám Sát Thông Minh Xiaomi PTZ Phiên Bản 2K. Hồng Ngoại Nhìn Ban Đêm Độ Nét Cực Cao - Bản Quốc Tế - Hàng chính hãng",1290000,1290000,0,0
TIKI,may-anh,82392842,"Kính Thiên Văn - 20-40X - LS10",448000,553000,105000,19
TIKI,may-anh,35178687,"Bộ 2 Pin Và Sạc Kép RAVPower Cho FujiFilm NP-W126S X-A X-E X-H X-T X-M X-Pro Series - Hàng Nhập Khẩu",625999,625999,0,0
TIKI,may-anh,15806201,"Bao Silicon Bảo Vệ Máy Ảnh Cover Cho Canon 6D Vàng",320000,320000,0,0
TIKI,may-anh,106887316,"ĐẦU ĐỌC THẺ NHỚ LOẠI ĐA NĂNG CHẤT LIỆU NHÔM LOẠI 1",35000,35000,0,0
TIKI,may-anh,106888042,"Adapter chuyển đổi thẻ nhớ - áo thẻ",15000,15000,0,0
TIKI,may-anh,72531988,"Thẻ nhớ 32Gb chính hãng DSS",86000,86000,0,0
TIKI,may-anh,918308,"Camera Thể Thao SJCAM SJ5000X",2399000,3500000,1101000,31
TIKI,may-anh,191437423,"Hộp kỹ thuật đựng nguồn camera chống nước",9000,9000,0,0
TIKI,may-anh,14596529,"Bộ 2 Pin + Sạc Đôi RAVPower Canon LP-E8 Cho Canon 550D, 600D, 650D, 700D (Hàng Chính Hãng)",649999,649999,0,0
TIKI,may-anh,33233535,"Bộ pin sạc  EN-EL15 cho máy ảnh Nikon",849999,849999,0,0
TIKI,may-anh,6933039,"Chân Nhện Joby 3K + Joby X - Hàng Chính Hãng",1899999,1899999,0,0
TIKI,may-anh,188897625,"Đèn Tiktok Hoàng Hôn Chuyển Đổi 16 Màu Đặt Biệt Đều Khiển Remot - HÀNG LOẠI 1- HÀNG CHÍNH HÃNG MINIIN",79000,89000,10000,11
TIKI,may-anh,4755397,"Bracket Đuôi Gắn 2 Đèn Chụp Sản Phẩm - Hàng Nhập Khẩu",199000,199000,0,0
TIKI,may-anh,94341802,"Camera nội soi siêu rẻ 7mm - Chống nước IP67 (Đen)",269900,269900,0,0
TIKI,may-anh,46564115,"Camera an ninh ngoài trời chống nước - Camhi HD 720P Bền Tốt - Có âm thanh và màu sắc ban đêm",680000,680000,0,0
TIKI,may-anh,73316920,"Dây đeo vai máy ảnh chống mỏi - MA001",180000,180000,0,0
TIKI,may-anh,98736495," Hộp chụp ảnh sản phẩm Studio box 80 x 80cm",2340000,2340000,0,0
TIKI,may-anh,4713075,"Túi Đựng Phụ Kiện (110cm) - Hàng Nhập Khẩu",500000,500000,0,0
TIKI,may-anh,20530080,"Balo Canvas chống nước nắp da bò Pretty boy backpack size ",989999,989999,0,0
TIKI,may-anh,110098054,"Túi máy ảnh Safrotto SF005, Hàng chính hãng ",799999,799999,0,0
TIKI,may-anh,6707371,"Vòng cao su lấy nét follow focus ống kính máy ảnh quay phim",79000,79000,0,0
TIKI,may-anh,4707693,"Bộ Giá Treo Phông Di Động (2 x 2 m) - Hàng Nhập Khẩu",799000,799000,0,0
TIKI,may-anh,155998251,"Chân máy ảnh Benro FIF28AIB2 - Hàng Chính Hãng",2675555,2675555,0,0
TIKI,may-anh,111484778,"Nguồn Chuyên Dụng cho Camera 12V-2A có Móc Treo",44000,55000,11000,20
TIKI,may-anh,15448846,"Trọn bộ 4 camera chính hãng Dahua HD1080",2350000,2350000,0,0
TIKI,may-anh,160110919,"Hắt sáng tròn 2 in 1, 5 in 1 kích thước 60, 80, 110cm",169999,169999,0,0
TIKI,may-anh,22169476,"Hộp Chụp Ảnh  studio Light Room Mini Có Đèn LED 20 đèn (Loại nhỏ 23cm x24cm)",153900,162000,8100,5
TIKI,may-anh,20583267,"Combo hộp chống ẩm mini cao cấp, ẩm kế điện tử, 200gram hạt hút ẩm xanh, mút xốp, khăn lau lens cho máy ảnh, máy quay phim - dung tích 3,6 lít ",159000,159000,0,0
TIKI,may-anh,155996022,"Tủ chống ẩm 300 lít Andbon AD-300S-(New model 2022), Hàng chính hãng",10750555,10750555,0,0
TIKI,may-anh,4689179,"Ốc Chuyển Đổi Male 1/4 Sang Male 3/8 - Hàng Nhập Khẩu",54999,54999,0,0
TIKI,may-anh,193317470,"Camera IP Starlight 2.0MP DAHUA DH-IPC-HFW2230SP-S-S2 - Hàng Chính Hãng",1100000,1100000,0,0
TIKI,may-anh,151500579,"Phông nền trơn hai mặt đạo chụp ảnh có nhiều màu",47000,47000,0,0
TIKI,may-anh,102608284,"Túi máy ảnh Lowepro Protactic MG 160 AW II, Hàng chính hãng",2649999,2649999,0,0
TIKI,may-anh,14266076,"Bút Lau Lens VSGO DDL-1 - Hàng Chính Hãng",116999,116999,0,0
TIKI,may-anh,191282401,"Camera YooSee 3 Anten Có Cổng LAN - Hàng Nhập Khẩu - NTH",335000,335000,0,0
TIKI,may-anh,5895769,"Pin Máy Ảnh Wasabi For Canon LP-E17 - Hàng Nhập Khẩu",374999,374999,0,0
TIKI,may-anh,189476431,"Chân máy ảnh Benro T890, Hàng nhập khẩu",624999,624999,0,0
TIKI,may-anh,110096849,"Túi máy ảnh Safrotto SF004, Hàng chính hãng",749999,749999,0,0
TIKI,may-anh,43184690,"Tản sáng đèn flash cóc mảy ảnh DSLR",39000,39000,0,0
TIKI,may-anh,15267455,"Bút lau lens - Bộ vệ sinh máy ảnh",53900,53900,0,0
TIKI,may-anh,191437518,"Camera wifi ezviz, camera C1C không dây quan sát ngoài trời, trong nhà, chống trộm - Hàng chính hãng",465000,539000,74000,14
TIKI,may-anh,173285934,"Bộ đèn 2 chảo 4 đui chụp ảnh studio",829000,829000,0,0
TIKI,may-anh,5876253,"Kính lọc Filter Hoya HMC PL-Cir 72mm - Hàng nhập khẩu",839999,839999,0,0
TIKI,may-anh,10771950,"Đầu Ghi HD-TVI 5MP 8 Kênh TURBO 4.0 Hikvision DS-7208HUHI-K2 -Hàng Chính Hãng",3520000,3520000,0,0
TIKI,may-anh,74239470,"Bộ 3 camera tiến và cạp lề tích hợp vào màn hình SYNC cho các dòng xe Ford-Ranger, Ford-Everest, Ford-Focus, Ford-Focus, Ford-Ecosport,...",6159000,6159000,0,0
TIKI,may-anh,69862555,"Dây máy ảnh Hand Strap kiểu Paracord nhiều màu",80000,80000,0,0
TIKI,may-anh,39174055,"Sạc đôi Kingma cho pin PB - 511A - hành chính hãng",144999,144999,0,0
TIKI,may-anh,120789070,"Chuôi Gắn Đèn Flash E27 Trơn Dành Cho Các Studio Chụp Hình Điều Chỉnh Góc Có Công Tắc",95000,95000,0,0
TIKI,may-anh,56992408,"Pin Dành Cho Máy Ảnh Sony NP-FV50 7.2V 1150mAh Cao Cấp AZONE",217550,229000,11450,5
TIKI,may-anh,5866401,"Tủ Chống Ẩm Andbon AD-80HS (80 Lít) - Hàng Nhập Khẩu",3099999,3099999,0,0
TIKI,may-anh,16180016,"Áo Mưa Vỏ Áo Chống Nước Che Mưa Máy Ảnh Và Ống Kính Máy Ảnh Chuyên Nghiệp DSLR",79000,79000,0,0
TIKI,may-anh,137013243,"Đèn chụp ảnh Mi cao cấp , đèn chụp 3 chế độ sáng",205000,205000,0,0
TIKI,may-anh,16257941,"Bao Silicon Bảo Vệ Máy Ảnh  Cover Cho Nikon D750 Xanh",320000,320000,0,0
TIKI,may-anh,120789416,"Phụ kiện chuyển chân Flash máy ảnh sang chân Tripod 1/4"",25000,25000,0,0
TIKI,may-anh,120788859,"Nguồn Điện Sạc Adapter 12V 3A jack DC 5.5 * 2.5 mm - nguồn camera ĐÈN LED livestream live makeup trang điểm.",45000,45000,0,0
TIKI,may-anh,23462755,"Đèn Flash Godox V1 For Canon - Hàng chính hãng",3999999,3999999,0,0
TIKI,may-anh,133259435,"túi hút ẩm 200g -500g -1kg",20000,20000,0,0
TIKI,may-anh,5895607,"Máy Hút Ẩm Wonderful 16 Lít - Hàng Nhập Khẩu",239000,239000,0,0
TIKI,may-anh,109018061,"Combo pin sạc Kingma cho Fujifilm NP-T125, Hàng chính hãng",699999,699999,0,0
TIKI,may-anh,3428567,"Thiết Bị Tản Sáng Cho Đèn Flash Rời (Đen)",99999,99999,0,0
TIKI,may-anh,17616497,"Nắp Che Bụi Chân Đèn Flash Hotshoe Có Hạt Nước Cân Bằng Cho Máy Ảnh DSLR",12000,12000,0,0
TIKI,may-anh,116970061,"Camera IP Dome hồng ngoại 2.0 Megapixel HIKVISION DS-2CD1323G0E-I(L) - HÀNG CHÍNH HÃNG",790000,790000,0,0
TIKI,may-anh,92945135,"Túi Đựng Máy Ảnh Mirrorless Đeo Chéo, Nhỏ Gọn, Thời Trang GN2005 Chống Trộm, Thích Hợp Với Dòng Máy Ảnh Nikon Sony Canon",150000,150000,0,0
TIKI,may-anh,106738644,"Cao cấp. Free phụ kiện. bộ 11 khung kính tặng đinh treo",158000,158000,0,0
TIKI,may-anh,161256625,"Tủ chống ẩm 30 lít Andbon AB-30C, Hàng nhập khẩu",1145555,1145555,0,0
TIKI,may-anh,58406105,"Micro thu âm Saramonic Blink 500 B6 hàng chính hãng.",5280000,5280000,0,0
TIKI,may-anh,159439211,"Pin sạc Kingma Ver 3 cho Canon LP-E6 (Sạc Type C siêu nhanh), Hàng chính hãng",249999,249999,0,0
TIKI,may-anh,4727701,"Xịt Bụi Blue Booster High Quality - Hàng Nhập Khẩu",35000,35000,0,0
TIKI,may-anh,109954678,"Balo máy ảnh Safrotto SM3031, thao tác nhanh - Hàng chính hãng",1899999,1899999,0,0
TIKI,may-anh,7955531,"Vít ren 1/4 "- 1/4"",64999,64999,0,0
TIKI,may-anh,130175167,"Camera Lùi AHD720P Dùng Cho Màn Hình Android Hoặc Màn Hình Hỗ Trợ AHD Vỏ Kim Loại Mạ Crom",229000,229000,0,0
TIKI,may-anh,87393663,"GLOBAL IOT03 - camera wifi trong nhà chất lượng cao, tích hợp báo động vào điện thoại khi có chuyển động HÀNG CHÍNH HÃNG",884000,884000,0,0
TIKI,may-anh,101920892,"QNO-6012R/VAP CAMERA TRÂN TRỤ HỒNG NGOẠI 2MP",4212000,4212000,0,0
TIKI,may-anh,15401794,"Đèn Flash Godox TT350  for Fujifilm - Hàng chính hãng",1599999,1599999,0,0
TIKI,may-anh,29164514,"Camera IP Giám Sát HIKVISION DS-2CD2T21G0-IS - Hàng Chính Hãng",2280000,2280000,0,0
TIKI,may-anh,155997485,"Tủ chống ẩm Andbon AD-80S (dung tích 80 lít )-Taiwan, Hàng chính hãng",3100555,3100555,0,0
TIKI,may-anh,45651308,"Tủ chống ẩm AB-21C",949999,949999,0,0
TIKI,may-anh,120789238,"CHUÔI ĐÈN E27 TRƠN VÀ CHÂN ĐỨNG 2M DÙNG CHO STUDIO ,CHỤP HÌNH HỖ TRỢ ÁNH SÁNG",186000,186000,0,0
TIKI,may-anh,43379955,"Sạc Kingma cho pin NP-BX1 và NB-BY1 dùng cho Sony RX100 AS30V AS100VR HX400 WX300 - Hàng chính hãng ",169999,169999,0,0
TIKI,may-anh,5849431,"Chân Máy Ảnh Tripod Weifeng WT-3730 - Hàng Nhập Khẩu",374999,374999,0,0
TIKI,may-anh,129766232,"Nguồn adapter12V-1A thích hợp cho camera giám sát",25000,25000,0,0
TIKI,may-anh,15669032,"Micro Thu Âm Cài Áo Không Dây Boya BY-WM8 Pro-K2 - Hàng Chính Hãng",3299000,3299000,0,0
TIKI,may-anh,7234003,"Lens cap 43mm nắp đậy bảo vệ ống kính máy ảnh phi 43mm",49999,49999,0,0
TIKI,may-anh,170619892,"Đèn Flash hỗ trợ chụp ảnh trên điện thoại",95000,95000,0,0
TIKI,may-anh,54391137,"Micro thu âm Saramonic Blink 500 B1 - Hàng Chính Hãng",3799000,3799000,0,0
TIKI,may-anh,95064600,"Camera HDCVI thân Dahua DH-HAC-HFW1200DP-S4 2MP 1080P hồng ngoại 80m hàng chính hãng DSS Việt Nam",525000,525000,0,0
TIKI,may-anh,14120055,"Miếng Dán Màn Hình Cường Lực Cho Máy Ảnh Nikon 1 J2/J3",49000,49000,0,0
TIKI,may-anh,14088948,"Dây Bấm Mềm RS-60E3 For Canon Eos 700D/550D/60D/70D/100D",59000,59000,0,0
TIKI,may-anh,101358280,"Nguồn camera 12v-2a ",44000,44000,0,0
TIKI,may-anh,16533926,"Camera hành trình Vietmap C61 Ultra HD 4K - Hàng nhập khẩu",3200000,3200000,0,0
TIKI,may-anh,13730775,"2 Softbox đuôi sứ 4 chuôi 50x70cm - 8 đèn Led 360 độ 480W - 2 chân đèn 2m",2899000,2899000,0,0
TIKI,may-anh,114447609,"Camera IP Wifi ngoài trời VITACAM DZ3000 PTZ xoay 355 độ, 3.0Mpx 1296P hình ảnh ULTRA HD siêu nét - hàng chính hãng",636900,636900,0,0
TIKI,may-anh,111850972,"Kẹp ghi đông dành cho xe đạp, xe máy Gopro, SJCAM, Yi Xiaomi",80000,88000,8000,9
TIKI,may-anh,194083877,"Camera Wifi Trong Nhà EZVIZ BC2 2MP Tích Hợp Pin Sạc 2.000mAh - Đàm Thoại 2 Chiều - Hàng Chính Hãng",1250000,1250000,0,0
TIKI,may-anh,7885994,"Ống nhòm du lịch 2 mắt bỏ túi Konus Next 10x25 - Hàng chính hãng",1390000,1390000,0,0
TIKI,may-anh,915488,"Phông Nền PVC",249000,249000,0,0
TIKI,may-anh,169979320,"LENS HOOD ET 83C - DÀNH CHO ỐNG KÍNH CANONN EF 100-400MM F/4.5-5.6L IS USM",240000,240000,0,0
TIKI,may-anh,176812334,"Chân máy ảnh Tripod Benro T691 - Hàng chính hãng",574999,574999,0,0
TIKI,may-anh,7252927,"Lens cap 82mm nắp đậy bảo vệ ống kính máy ảnh phi 82mm",59999,59999,0,0
TIKI,may-anh,193321787,"Camera IP Full Color 4MP DAHUA DH-IPC-HFW2439MP-AS-LED-B-S2 - Hàng Chính Hãng",1520000,1520000,0,0
TIKI,may-anh,126041770,"Camera I Imou hình cầu Ranger 2 4M IPC-A42P-B, 360- Smart track - 2-way talk - Siren- IR10m, 2Y WTY - Trắng- HÀNG CHÍNH HÃNG",747000,747000,0,0
TIKI,may-anh,105638114,"Chân máy ảnh Benro dòng TSL08, Hàng chính hãng",1499999,1499999,0,0
TIKI,may-anh,25775028,"2 pin và Đốc sạc đôi Kingma NP-BX1 cho Sony RX100,RX1,H400 - Hàng chính hãng",169999,169999,0,0
TIKI,may-anh,5895559,"Kính Lọc Filter Marumi Fit & Slim Lens Protect 58mm - Hàng Nhập Khẩu",259999,259999,0,0
TIKI,may-anh,155997027,"Chân máy ảnh Tripod Beike Q-666, Hàng chính hãng",1275555,1275555,0,0
TIKI,may-anh,14038703,"Chân máy ảnh/ Gậy chụp hình 3 chân dùng livestream - Tripod 3110",54398,54398,0,0
TIKI,may-anh,108905178,"Pin Kingma cho Nikon EN-EL3E. Hàng chính hãng",279999,279999,0,0
TIKI,may-anh,155996488,"Gậy điện thoại, Gậy Gopro Carbon Benro SC1",775555,775555,0,0
TIKI,may-anh,95304844,"Đèn studio A111 - Hỗ trợ chụp ảnh chuyên nghiệp - Photography light - Đèn hỗ trợ livestream, chụp ảnh, quay phim 3 chế độ sáng ( 3600K - 6000K) - Công suất 100W - Có remote ",1430000,1430000,0,0
TIKI,may-anh,149764134,"Micro thu âm đa năng Boya BY-M1, Hàng chính hãng",349999,349999,0,0
TIKI,may-anh,6710017,"Lens hood Loa che nắng cho Sony 16-50 Sony A6000 A6300 A6500",68000,68000,0,0
TIKI,may-anh,54024076,"Camera Ezviz C6N CS-CV246 (Ez360 1080P) - Hàng Chính Hãng",450000,450000,0,0
TIKI,may-anh,193925754,"Thiết Bị Chuyển Đổi HDMI sang USB 3.0 Chuyên Dùng Cho Ghi Hình, Livestream từ Máy Ảnh/PS4/X-Box/DVD Chất Lượng Hình Ảnh Lên Tới 4K Ultra HD",379000,379000,0,0
TIKI,may-anh,9862136,"Đế hít kính cực đại đường kính chân 9cm và mount vít vặn cho GoPro Hero",79000,79000,0,0
TIKI,may-anh,84102725,"Mic thu âm BOYA BY-WM3D cho điện thoại iPhone hàng chính hãng.",2390000,2390000,0,0
TIKI,may-anh,17589287,"Giá đỡ tripod 3 chân xoay ngang dọc hỗ trợ chụp ảnh, livestream nhẹ gọn tặng kèm đầu kẹp điện thoại 2 lỗ chắc chắn",56000,60400,4400,7
TIKI,may-anh,72849098,"Gimbal chống rung 3 trục nhỏ, nhẹ Hohem iSteady Mobile plus, hàng chính hãng",1590000,1590000,0,0
TIKI,may-anh,21051335,"Dây đeo ngực camera hành trình phản quang",148500,148500,0,0
TIKI,may-anh,106056468,"ĐẦU GHI HÌNH IP AVTECH 4 KÊNH ( có PoE) - Hàng Nhập Khẩu",3500000,3500000,0,0
TIKI,may-anh,120788210,"Gậy Gopro Tam khúc đa năng, gọn, tiện lợi",134600,134600,0,0
TIKI,may-anh,95064537,"Thẻ nhớ Micro SD Hikvision/HS-TF-C1 dung lượng 64G Class 10  hàng chính hãng Nhà An Toàn",88000,88000,0,0
TIKI,may-anh,15799644,"Bao Silicon Bảo Vệ Máy Ảnh Easy Cover Cho Canon 6D xanh",399000,399000,0,0
TIKI,may-anh,13405210,"Dây đeo leash bản nhỏ dành cho máy ảnh mirrorless - P011",90000,90000,0,0
TIKI,may-anh,5849367,"Chân Máy Ảnh Tripod Beike Q-308 - Hàng Nhập Khẩu",699999,699999,0,0
TIKI,may-anh,263513334,"Camera WIFI GK2DP-3C0W Độ Phân Giải Cao Cảm Biến Tốt, Hỗ Trợ Đàm Thoại 2 Chiều",770000,770000,0,0
TIKI,may-anh,165211169,"Tripod Gậy 3 chân chụp hình máy ảnh, điện thoại Tripod TF - 3120 loại tốt (MSP TP54)",145990,145990,0,0
TIKI,may-anh,13406090,"Dây đeo cổ tay leash cho máy ảnh  - P012",90000,90000,0,0
TIKI,may-anh,4708525,"Pin Wasabi EN-El15 Cho Nikon D610 D810 D7000 D7100 (Đen) -  Hàng Nhập Khẩu",669999,669999,0,0
TIKI,may-anh,121332444,"10 jack DC camera loại Vặn Vít, jack nguồn camera",19999,19999,0,0
TIKI,may-anh,80260990,"Túi máy ảnh thời trang EOS màu xám",215100,215100,0,0
TIKI,may-anh,159397417,"Pin sạc Kingma Ver 2 cho Nikon EN-EL15, Hàng chính hãng",219999,219999,0,0
TIKI,may-anh,100260991,"Camera ip wifi xoay 360 độ Orikon gầu trúc - Hàng chính hãng",637000,650000,13000,2
TIKI,may-anh,92496723,"Gậy chụp ảnh 3 chân Tripod  TF 3110",57000,60225,3225,5
TIKI,may-anh,68501214,"Túi máy ảnh Herringbone Canvas Satchel Medium - Brown color",2500000,2500000,0,0
TIKI,may-anh,21469620," Pin Máy Ảnh cho  Nikon EN-EL15 - Hàng Nhập Khẩu",248999,248999,0,0
TIKI,may-anh,35231762,"Đế treo tường Camera Yoosee - CamHi",15000,15000,0,0
TIKI,may-anh,77678200,"Camera hành trình ô tô, xe hơi nhãn hiệu Xiaomi 70mai cao cấp A500S độ phân giải FullHD 1080p (Bộ gồm Camera trước + sau) - Bản Quốc Tế - Hàng Nhập Khẩu",3198000,3198000,0,0
TIKI,may-anh,161497792,"Camera Hành Trình Elitek EJV T666G - HÀNG NHẬP KHẨU",1200000,1200000,0,0
TIKI,may-anh,171055509,"Trọn Bộ 4 Camera Quan Sát Trong Nhà, Ngoài Trời Hikvision 2.0MP Full HD 1080P - Hàng Chính Hãng",6000000,6000000,0,0
TIKI,may-anh,4739273,"Lens Hood HB-35 (Đen) - Hàng Nhập Khẩu",89000,89000,0,0
TIKI,may-anh,15851204,"Bàn Xoay Chụp Sản Phẩm 360 Độ Đường Kính 45cm - Hàng Chính Hãng",2468000,2468000,0,0
TIKI,may-anh,69861349,"Dây máy ảnh hand strap Miniway- dây đeo cổ tay",59000,59000,0,0
TIKI,may-anh,269900405,"Kính Hiển Vi Điện Tử WIFI W04 1000x",750000,750000,0,0
TIKI,may-anh,9974013,"Đầu Ghi Hình HD 4MP 4 Kênh Chuẩn H.265 Pro+ HIKVISION DS-7204HQHI-K1 - Hàng chính hãng",1240000,1240000,0,0
TIKI,may-anh,9806421,"Camera Hành Trình SJCAM SJ8 Pro 4K Wifi - Hàng chính hãng",4095000,4095000,0,0
TIKI,may-anh,12389711,"Camera hành động Waterproof Sports Cam 1080 Full HD Chống Nước",249000,249000,0,0
TIKI,may-anh,84076569,"10 con rắc CAMERA (RẮC PNC) hàng chất lượng NHƯ HÌNH",33000,33000,0,0
TIKI,may-anh,15792599,"Phông vân gỗ chụp ảnh sản phẩm - Hàng chính hãng",109400,109400,0,0
TIKI,may-anh,56047002,"Bộ Kính Hiển Vi Kỹ Thuật Số Digital Microscope 1000X Hỗ Trợ Kết Nối OTG Với Điện Thoại Android Cao Cấp AZONE",315000,379000,64000,17
TIKI,may-anh,7152321,"Chân chụp ảnh dùng cho điện thoại Yunteng VCT 5208 - Hàng chính hãng",168000,168000,0,0
TIKI,may-anh,196562264,"Camera wifi Yoosee 4 Râu 17 Led FULL HD 5.0Mpx, Xoay 360°, Đàm Thoại Hai Chiều, Báo Động Chống Trộm, Chuyên Dụng Ngoài Trời - Hàng Nhập Khẩu",450000,700000,250000,36
TIKI,may-anh,11508815,"Video Balun Chuyên Dùng Camera AHD - CVI- TVI 2MP-Hàng chính hãng",25000,25000,0,0
TIKI,may-anh,58614371,"Combo 2 pin 1 sạc đôi Kingma LP-E6 hàng chính hãng.",724999,724999,0,0
TIKI,may-anh,53660250,"Túi đựng máy ảnh thời trang K883",270000,270000,0,0
TIKI,may-anh,216908031,"Kính lọc K&F CONCEPT ND2-400 Fader Variable ND Filter 37mm 40.5mm 43mm 46mm 49mm 52mm 55mm 58mm 62mm 67mm 72mm 77mm 82mm",749000,749000,0,0
TIKI,may-anh,91369845,"Kính Xem Phim  3D",84500,84500,0,0
TIKI,may-anh,197855367,"Ống kính Sony FE 24-70mm F2.8 GM II - Hàng chính hãng",49990000,49990000,0,0
TIKI,may-anh,192292298,"Camera IP Wifi ốp trần không dây V380 Pro Full HD Góc Quay Siêu Rộng 180° hình ảnh chân thực siêu nét",284050,299000,14950,5
TIKI,may-anh,74243537,"Ống nhòm quân sự Barska 8x30 WP Battalion (có vạch ly giác) - Hàng chính hãng",9800000,9800000,0,0
TIKI,may-anh,109586850,"Chân máy quay Coman DF06Q5Plus, Hàng chính hãng",2449999,2449999,0,0
TIKI,may-anh,170513444,"Tripod Yunteng VCT 860 - chân đế dành cho máy ảnh (Hàng Chính Hãng)",919999,919999,0,0
TIKI,may-anh,193155101,"Dây Đeo Gắn Cằm Nón Bảo Hiểm Fullface Dành Cho Go-pro Điện Thoại ,Quay Phim, Chụp Ảnh Chất Lượng Cao Điều Chỉnh",49000,49000,0,0
TIKI,may-anh,102913207,"Camera nội soi lấy ráy tai có đèn LED hỗ trợ kết nối USB với điện thoại thông minh .",185000,185000,0,0
TIKI,may-anh,4708407,"Kẹp Ghi Đông Xe Máy Loại Lớn Gắn Gopro Sjcam Xiaoyi (Đen) - Hàng Nhập Khẩu",59000,59000,0,0
TIKI,may-anh,4727345,"Dây Đeo Cổ Tay Leather Style C - Hàng Nhập Khẩu",59000,59000,0,0
TIKI,may-anh,97684079,"Ống nhòm Fomei 10x32 DCF - Hàng chính hãng",3080000,3080000,0,0
TIKI,may-anh,44841823,"Mắt Camera ngoài trời Hikvision DS-2CE16D0T-IRP 2MP - Hàng chính hãng",438000,438000,0,0
TIKI,may-anh,62661853,"Pin Sạc Cổng Micro USB 3.7V 650mAh 16340 Doublepow DP-CR123A - Hàng Chính Hãng",109250,115000,5750,5
TIKI,may-anh,179555815,"Camera Ngoài Trời YOOSEE 516-4R 5.0MP 4 râu Xoay ngoài trời 36 LED siêu nét - HÀNG CHÍNH HÃNG",525000,525000,0,0
TIKI,may-anh,66824886,"Dây đeo máy ảnh cổ tay da",84000,84000,0,0
TIKI,may-anh,7250287,"Ngàm đảo đầu ống kính chụp Macro Canon EOS",79000,79000,0,0
TIKI,may-anh,218756111,"Camera Lùi 5 Chân Hồng Ngoại Kết Nối Camera Hành Trình Gương Bằng Jack 2.5mm",289000,289000,0,0
TIKI,may-anh,140120490,"Camera HDCVI ngoài trời có mic 2MP DAHUA DH-HAC-HFW1200TLP-A-S5 hàng chính hãng DSS Việt Nam",650000,650000,0,0
TIKI,may-anh,10375024,"Hít kính 3 chân đế mini gắn GoPro Hero lên kính xe hơi",59000,59000,0,0
TIKI,may-anh,50598485,"Camera IP Ngoài trời Yoosee PTZ 2 Râu FullHD 1080P 6 LED trợ sáng, 4 LED hồng ngoại, đàm thoại 2 chiều, hỗ trợ xoay 360 (trắng) Hàng Nhập Khẩu",660000,660000,0,0
TIKI,may-anh,134958087,"Dây đeo ngực + Đế chữ J + Ốc vít Kết Nối Khớp Với Gopro Camera Hành Trình",115000,115000,0,0
TIKI,may-anh,163023310,"Chân Đế Camera Nhôm",42600,42600,0,0
TIKI,may-anh,72182554,"Chân máy ảnh Tripod Beike Q-160S",749999,749999,0,0
TIKI,may-anh,114731369,"Chân máy quay Benro KH26 Video Tripod Kit	- Hàng Chính Hãng",3949999,3949999,0,0
TIKI,may-anh,99350400,"Camera DAHUA Dome HAC-T1A21P - Hàng Chính Hãng",320000,320000,0,0
TIKI,may-anh,14119360,"Chân máy Tripod Yunteng VCT 5208 - Hàng Chính Hãng",189611,199590,9979,5
TIKI,may-anh,214756796,"Camera quan sát từ xa qua điện thoại, tự động quay lưu",750000,750000,0,0
TIKI,may-anh,22492463,"Tay cầm GoPro và Action Cam tích hợp Pin Kingma - Hàng Nhập Khẩu",469999,469999,0,0
TIKI,may-anh,93021143,"Bộ Thu Phát Không Dây 2 In 1 Bluetooth 5.0 Màn Hình LCD T-013",153900,162000,8100,5
TIKI,may-anh,52336847,"Kính hiển vi STV-120M cầm tay",481000,585000,104000,18
TIKI,may-anh,109580308,"Chân máy quay Coman DF-06, Hàng chính hãng",2349999,2349999,0,0
TIKI,may-anh,102516193,"Kính hiển vi mini kẹp điện thoại phóng đại 60 lần siêu nét V2 (Tặng móc khóa tô vít đa năng 3in1 cao cấp)",179550,189000,9450,5
TIKI,may-anh,66385255,"Gậy,cây,chân đế TC-88 chuyên dành cho quay video,chụp ảnh [ TITOK,LIVETREAM,VIDEO,CHỤP HÌNH ]",249000,279000,30000,11
TIKI,may-anh,186208864,"Tủ chống ẩm Andbon AB-50C, 50 lít - Hàng chính hãng",1549999,1549999,0,0
TIKI,may-anh,154590799,"Camera Wifi Ngoài Trời EZVIZ C3W Color Night Pro 4Mp, Đèn Và Còi Báo Động, Tính Năng AI - Hàng chính hãng",1950000,1950000,0,0
TIKI,may-anh,2570631,"Bộ Đèn Chụp Sản Phẩm (600W) - Hàng Nhập Khẩu",1399000,1399000,0,0
TIKI,may-anh,7306517,"Ngàm chuyển lens M42 - Canon EOS Camera ( Black )",79000,79000,0,0
TIKI,may-anh,104070232,"Đầu ghi 8 kênh Dahua DH-XVR1A08 - Đâu ghi hình camera 1080P - Hàng chính hãng",1350000,1350000,0,0
TIKI,may-anh,127187953,"Combo Camera Wi-fi Trong Nhà EZVIZ C6N 2MP và Thẻ Nhớ 32GB/64GB - Hàng Chính Hãng",450000,450000,0,0
TIKI,may-anh,37155769,"Đèn Flash Godox TT600 Tặng Kèm Bộ Pin Sạc - Hàng Nhập Khẩu",1799999,1799999,0,0
TIKI,may-anh,108341744,"Combo 2 pin 1 sạc đôi Kingma for Canon LP-E17 - Hàng chính hãng",549999,549999,0,0
TIKI,may-anh,3597899,"Bộ Chân Máy Ảnh Bạch Tuộc Lớn Và Đầu Bi Chân Máy Ảnh Thân Kim Loại Q00159",159000,159000,0,0
TIKI,may-anh,34477918,"Camera lùi ô tô siêu nét full HD chống nước",155000,168000,13000,8
TIKI,may-anh,74536460,"Kính thiên văn PowerSeeker 50AZ 450x, hiệu Celestron chính hãng Mỹ, kính phủ FMC chống lóa",1620000,1620000,0,0
TIKI,may-anh,50325159,"Ống nhòm hải tặc một mắt 25x30 - Thiết kế theo khuôn mẫu phục cổ với độ phóng đại cao cùng hình ảnh sắc nét trong một hình hài nhỏ gọn",700000,700000,0,0
TIKI,may-anh,4712551,"Túi Chống Sốc Đựng Chân Đèn Size L - Hàng Nhập Khẩu",499000,499000,0,0
TIKI,may-anh,4755099,"Dụng Cụ Tháo Mở Lens Chuyên Nghiệp - Hàng Nhập Khẩu",399000,399000,0,0
TIKI,may-anh,28736848,"Combo Tản sáng Godox AK-R1 và ngàm Godox S-R1",1049999,1049999,0,0
TIKI,may-anh,109992240,"Túi máy ảnh Safrotto H1-S, Hàng chính hãng",499999,499999,0,0
TIKI,may-anh,52188469,"Phông vải key hình 2 mặt di động chuyên nghiệp (1.5 x 2m)",1050000,1050000,0,0
TIKI,may-anh,15927483,"Chân Máy Ảnh Tripod Beike Q999 - Hàng Chính Hãng",1074999,1074999,0,0
TIKI,may-anh,4712733,"Tạo Hiệu Ứng - Spot (M-Optical Snoot) - Hàng Nhập Khẩu",2099000,2099000,0,0
TIKI,may-anh,76514892,"Intel RealSense Depth Camera D455 - Hàng Chính Hãng",16924400,16924400,0,0
TIKI,may-anh,19565935,"Phụ kiện thanh nối đa năng gắn đến 4 điện thoại lên tripod hỗ trợ livestream, quay video nhiều điện thoại cùng lúc",275000,275000,0,0
TIKI,may-anh,124254502,"Ống nhòm 2 Mắt Thiết Kế Chắc Chắn Độ Phóng Đại 10X SA60X90",655500,690000,34500,5
TIKI,may-anh,14534576,"Bộ 2 pin và đế sạc kép RAVPower RP-BC014 tương thích Canon LP-E10 - Hàng Chính Hãng",649999,649999,0,0
TIKI,may-anh,97649318,"Chân đế cao cấp cho máy ảnh, ống nhòm Carson Rock TR-300 - Hàng chính hãng",3050000,3050000,0,0
TIKI,may-anh,162480864,"Nút chế độ dành cho Canon 6D, Canon 5D3",150000,150000,0,0
TIKI,may-anh,194822975,"Camera IP Robot Wifi 2Mp UNIARCH T1L-2WT - Hàng Chính Hãng",595000,595000,0,0
TIKI,may-anh,4707917,"Đèn LED Yongnuo 600 (Đen) - Hàng Nhập Khẩu",1949999,1949999,0,0
TIKI,may-anh,97651658,"Chân đế cao cấp cho máy ảnh, ống nhòm Carson Rock TR-200 - Hàng chính hãng",2780000,2780000,0,0
TIKI,may-anh,109504357,"Chân máy ảnh Monopod Coman DT286C Carbon, Hàng chính hãng",1249999,1249999,0,0
TIKI,may-anh,103555494,"Đèn Flash Godox TT600 dùng cho Canon, Nikon, Sony- Hàng chính hãng ",1499999,1499999,0,0
TIKI,may-anh,2533237,"Bộ Gel 12 Màu For Flash Speedlite",79000,79000,0,0
TIKI,may-anh,125499125,"Camera WiFi V380 Mini Hành Trình 1080P WiFi Không Dây HD Quan Sát Ban Đêm IR Camera An Ninh Gia Đình Quan Sát Từ Xa Trên Điện Thoại-Tặng kèm cục nguồn sạc 5V-1A",260000,260000,0,0
TIKI,may-anh,197718299,"Camera IP hồng ngoại không dây 2.0 Megapixel EZVIZ C8PF - Hàng chính hãng",1500000,1500000,0,0
TIKI,may-anh,72740809,"Thiết Bị Blackmagic ATEM Mini  | Chính hãng",5200000,5200000,0,0
TIKI,may-anh,2546991,"Dây Bấm Mềm Shoot RR-90 For Fujifilm X-T1 X-T10 X-E2 X-M1 X-A2 X-A1 X100T (Đen)",159000,159000,0,0
TIKI,may-anh,206335803,"Túi máy ảnh nhỏ gọn D26",270000,270000,0,0
TIKI,may-anh,19578553,"DDPai MINI 2 Camera hành trình độ nét cao, tích hợp kết nối Wifi không dây. Độ phân giải 2K Ultra HD. Hàng nhập khẩu",1150000,1150000,0,0
TIKI,may-anh,26086283,"KÍNH LỌC HOYA UX UV SIZE 77MM - Hàng Chính Hãng",599999,599999,0,0
TIKI,may-anh,11891323,"Đầu Ghi Hình Dahua NVR2108HS-4KS2-Hàng Chính Hãng",1850000,1850000,0,0
TIKI,may-anh,109083771,"Combo pin sạc Kingma cho Fujifilm NP-W235, Hàng chính hãng",249999,249999,0,0
TIKI,may-anh,50600150,"Kingma 2 Pin + 1 Sạc 3 Pin Cho Gopro Hero 5/6/7/8 - Hàng nhập khẩu",529999,529999,0,0
TIKI,may-anh,271365847,"Quả cầu gương Disco bạc trang trí, chụp ảnh studio",380000,380000,0,0
TIKI,may-anh,55483212,"Thiết bị quay phim slider Zeapon Easylock2 Kit - Hàng Chính Hãng",2190000,2190000,0,0
TIKI,may-anh,3109087,"Ống nhòm hàng hải Steiner Commander 7x50 C - Hàng chính hãng",47300000,47300000,0,0
TIKI,may-anh,192124206,"Dây Đeo Máy Ảnh Cổ Tay ",99000,99000,0,0
TIKI,tui-vi-nu,193044379,"Túi xách nữ thời trang công sở cao cấp phong cách mới",477000,530000,53000,10
TIKI,tui-vi-nu,207927121,"Túi xách nữ thời trang công sở cao cấp phong cách mới",405000,450000,45000,10
TIKI,tui-vi-nu,185964455,"Túi xách nữ vải canvas thời trang cao cấp phong cách cá tính mới",315000,350000,35000,10
TIKI,tui-vi-nu,271371365,"Túi xách túi đeo vai nữ thời trang cao cấp phong cách âu mỹ",405000,450000,45000,10
TIKI,tui-vi-nu,193650197,"Ví nữ mini Yuumy YV40 màu ngẫu nhiên",59000,150000,91000,61
TIKI,tui-vi-nu,191373346,"[QUÀ TẶNG ĐỘC QUYỀN]  Ví da y tế cao cấp đa năng, đựng thuốc, đựng máy đo đường huyết, nhiệt kế, điện thoại, ví tiền, bền đẹp và tiện lợi, hạn chế va đập, tiện lợi cả ở nhà và đi du lịch",199000,199000,0,0
TIKI,tui-vi-nu,177060582,"Túi xách nữ thời trang cao cấp",441000,490000,49000,10
TIKI,tui-vi-nu,190355521,"Túi xách nữ da thật thời trang cao cấp phong cách mới",621000,690000,69000,10
TIKI,tui-vi-nu,199041028,"Túi xách nữ thời trang công sở cao cấp phong cách mới",387000,430000,43000,10
TIKI,tui-vi-nu,274507003,"Túi xách balo nữ 2 trong 1 thông minh đa chức năng thời trang cao cấp phong cách mới",441000,490000,49000,10
TIKI,tui-vi-nu,192126231,"[CÓ NẮP] Combo 10 cái bao bằng lái dạng PET, căn cước công dân, thẻ giữ xe, thẻ ATM...dẻo trong bamarau (loại có nắp đậy)",9999,9999,0,0
TIKI,tui-vi-nu,192579893,"Túi xách nữ thời trang công sở cao cấp phong cách mới",387000,430000,43000,10
TIKI,tui-vi-nu,73384998,"COMBO 20 BAO ĐỰNG THẺ CĂN CƯỚC CMND - ATM - NHÂN VIÊN - SINH VIÊN - BẰNG LÁI XE HIỆU HIER",22500,22500,0,0
TIKI,tui-vi-nu,155287323,"Túi xách nữ công sở cỡ lớn YUUMY YTX20",225000,520000,295000,57
TIKI,tui-vi-nu,177158869,"Túi xách nữ 2 trong 1 thời trang cao cấp",387000,430000,43000,10
TIKI,tui-vi-nu,89428878," Túi cói Merci đi du lịch đi chơi thời trang TX02",34998,34998,0,0
TIKI,tui-vi-nu,190582559,"Ví nữ cầm tay khóa cài YUUMY Seasand YV70",85000,190000,105000,55
TIKI,tui-vi-nu,127553838,"Túi đeo chéo Basic chống nước, tích hợp dây sạc USB unisex nam nữ phong cách thời trang",125000,250000,125000,50
TIKI,tui-vi-nu,116388009,"Túi Tote Nữ Grepaco Xách Vải Bố Canvas Cao Cấp In Chữ Đẹp Đeo Chéo Vai Có Khóa Kéo Nhiều Ngăn Dùng Đi Học, Làm Công Sở, Du Lịch Phong Cách Thời Trang Hàn Quốc - Tặng Túi Đựng Mỹ Phẩm",119000,119000,0,0
TIKI,tui-vi-nu,177169142,"Túi xách nữ thời trang cao cấp",405000,450000,45000,10
TIKI,tui-vi-nu,167647747,"Túi nữ mini da mềm YUUMY YN119",165000,290000,125000,43
TIKI,tui-vi-nu,159946692,"Túi xách nữ công sở đựng laptop dáng đứng tote thời trang Yuumy YTX18",225000,520000,295000,57
TIKI,tui-vi-nu,89773490,"TÚI CÓI MERCI SIZE TO ĐI BIỂN PHONG CÁCH HQC 487",69000,79000,10000,13
TIKI,tui-vi-nu,105660567,"Túi đeo chéo nam nữ mini đựng điện thoại phong cách thời trang Hàn Quốc - Túi xách chống nước đi du lịch, đi chơi",59000,59000,0,0
TIKI,tui-vi-nu,167650547,"Túi đeo chéo nữ mini đựng điện thoại YUUMY YN120",145000,270000,125000,46
TIKI,tui-vi-nu,142112282,"Túi Ví Đựng Bảo Vệ Chống Xướt Thẻ ATM, CCCD, Card Visa, Bằng Lái Xe, Vỏ bọc thẻ atm, bao túi đựng thẻ sinh viên, nhân viên, học sinh, name card, căn cước công dân",1000,1000,0,0
TIKI,tui-vi-nu,71178009,"Túi Đeo Chéo Canvas Messenger Ipad Oxford Cao Cấp Màu Đen Có Dây Kéo Và Ngăn Phụ Trong Ngoài Thời Trang Cá Tính",99000,99000,0,0
TIKI,tui-vi-nu,193289594,"Túi Đeo Chéo Nam Nữ Cao Cấp Vải Nylon Nhiều Ngăn Chống Thấm Nước, Túi Đeo Vai Phong Cách Thời Trang Hàn Quốc, Túi Đựng Điện Thoại Đa Năng",130000,130000,0,0
TIKI,tui-vi-nu,116726545,"Túi Đeo Chéo Grepaco Nam Nữ Unisex Vải Bố Canvas Tote Chống Nước Dạng Dây Đeo Vai Xách Đa Năng Đựng Điện Thoại Tiền Đi Học Du Lịch Thể Thao Size Mini Phong Cách Thời Trang Hàn Quốc",99000,99000,0,0
TIKI,tui-vi-nu,119790772,"Set 10 Vỏ Bọc Thẻ Trong Suốt, Túi Đựng Thẻ Căn Cước Công Dân, Bằng Lái Xe, Thẻ Ngân Hàng, Bao Bọc Thẻ Đa Năng",1000,1000,0,0
TIKI,tui-vi-nu,189170539,"Ví cầm tay nữ nhiều ngăn Lata VN64",290000,290000,0,0
TIKI,tui-vi-nu,170493623,"Ví cầm tay nữ mini cute BST The Button Wallet V5 chính hãng NATLOLI nhỏ gọn kháng nước nhiều ngăn cao cấp",179000,256000,77000,30
TIKI,tui-vi-nu,107615691,"Túi vải bố, Túi vải Canvas trơn màu Đen không khóa kéo",19000,19000,0,0
TIKI,tui-vi-nu,120464074,"TÚI CÓI VINTAGE, TÚI CÓI ĐI BIỂN XINH XẮN, TÚI CÓI ĐA NĂNG QUAI VẢI BỐ",38000,45000,7000,16
TIKI,tui-vi-nu,164061785,"Túi Vỏ Bao Đựng Bọc Thẻ Căn Cước Công Dân, Bằng Lái Xe, Thẻ Ngân Hàng, Thẻ Sinh Viên, Thẻ Nhân Viên",1000,1000,0,0
TIKI,tui-vi-nu,176835648,"Túi xách nữ thời trang công sở cao cấp phong cách mới",387000,430000,43000,10
TIKI,tui-vi-nu,177822630,"VÍ SEN 4 - CHÍNH HÃNG KHACTEN.COM",600000,600000,0,0
TIKI,tui-vi-nu,58706264,"Túi Tote Thời Trang Nữ Vải Bố Canvas Cao Cấp Có Khóa Kéo Và Ngăn Phụ Trong Ngoài – Sản Phẩm Hot 2020",150000,150000,0,0
TIKI,tui-vi-nu,116778345,"Combo 10 Túi đựng thẻ căn cước công dân, bằng lái xe, ATM, Card visit, CMND",9999,9999,0,0
TIKI,tui-vi-nu,68522324,"Cặp công sở đa năng TRITA TCA10 nhiều màu",349000,660000,311000,47
TIKI,tui-vi-nu,80976372,"Ví Da Đa Năng Đựng Tiền Và Thẻ Cho Cả Nam Và Nữ - Tặng Kèm 1 Móc Khóa Hình Vịt Vàng",79000,79000,0,0
TIKI,tui-vi-nu,162024663,"Túi xách nữ thời trang công sở cao cấp phong cách mới",404000,448200,44200,10
TIKI,tui-vi-nu,184476501,"Túi tote unisex Elegant Chicbag chính hãng NATOLI chất vải canvas có khóa kéo chống nước nhiều ngăn",250000,358000,108000,30
TIKI,tui-vi-nu,186650070,"Túi xách nữ thời trang cong sở cao cấp",387000,430000,43000,10
TIKI,tui-vi-nu,75392240,"Túi xách tote vải Túi Tote Túi Vải Nữ Túi Đeo Chéo Hàn Quốc  cúc - MunNiNi",66900,66900,0,0
TIKI,tui-vi-nu,95289176,"Túi tote HAFELE",50000,50000,0,0
TIKI,tui-vi-nu,155636624,"Túi Xách Nữ Đeo Chéo Đựng Điện Thoại Cá Tính Đi Chơi Phong Cách Hàn Quốc -lD006",57888,57888,0,0
TIKI,tui-vi-nu,167647747,"Túi nữ mini da mềm YUUMY YN119",165000,290000,125000,43
TIKI,tui-vi-nu,92984529,"Ví Nữ Cầm Tay Gấp Gọn Để Tiền Thẻ Galaxy Store GVNUB04 - Hàng Chính Hãng",37000,198000,161000,81
TIKI,tui-vi-nu,126131179,"Combo Vỏ bọc thẻ căn cước, thẻ tín dụng, bằng lái xe ATM DE88 Shalla",12870,17589,4719,27
TIKI,tui-vi-nu,10239742,"Combo 5 bao  passport trong suốt đựng hộ chiếu loại dày 3 ngăn",14999,14999,0,0
TIKI,tui-vi-nu,77937135,"Túi Tote Nữ Thời Trang Hàn Quốc Vải Bố Canvas Màu Đen Dạng Đeo Vai Có Khóa Kéo Nhiều Ngăn Phụ Trong Ngoài Đựng Macbook, Laptop. Phụ Kiện Chống Sốc",99000,99000,0,0
TIKI,tui-vi-nu,52519107,"Ví nữ dài cầm tay hai khóa kéo thời trang PC13",76000,100000,24000,24
TIKI,tui-vi-nu,137153961,"Túi Tote Canvas Đeo Chéo Nữ Đi Học Stand By Me Phong Cách Hàn Quốc",59000,59000,0,0
TIKI,tui-vi-nu,198224201,"Túi Đeo Chéo Grepaco Nam Nữ Unisex Vải Bố Canvas Thời Trang Hàn Quốc Đa Năng Đựng Điện Thoại Máy Tính Bảng Mini Chống Thấm Xước Nhiều Ngăn Khóa Kéo YKK, Phù Hợp Nhiều Kiểu Xách Đeo Khác Nhau - Hàng Chính Hãng",99000,99000,0,0
TIKI,tui-vi-nu,193044379,"Túi xách nữ thời trang công sở cao cấp phong cách mới",477000,530000,53000,10
TIKI,tui-vi-nu,207927121,"Túi xách nữ thời trang công sở cao cấp phong cách mới",405000,450000,45000,10
TIKI,tui-vi-nu,177169142,"Túi xách nữ thời trang cao cấp",405000,450000,45000,10
TIKI,tui-vi-nu,185964455,"Túi xách nữ vải canvas thời trang cao cấp phong cách cá tính mới",315000,350000,35000,10
TIKI,tui-vi-nu,271371365,"Túi xách túi đeo vai nữ thời trang cao cấp phong cách âu mỹ",405000,450000,45000,10
TIKI,tui-vi-nu,38448729,"Ví nữ da bò mini Marrant - BHM8608 Vi đựng thẻ. hàng chính hãng",299000,299000,0,0
TIKI,tui-vi-nu,192339670,"Túi mini thời trang túi xách nữ đeo chéo vai phong cách hàn quốc họa tiết nổi bật K-911-2",165000,165000,0,0
TIKI,tui-vi-nu,176147572,"Túi Đeo Chéo Nam Thể Thao Chống Nước, Chống Xước, Chống Bám Bụi,chất Liệu Vải Oxford Thiết Kế Thông Minh, Phong Cách Hiện Đại Thời Trang Cao Cấp Besti Y03- Hàng Chính Hãng",250000,250000,0,0
TIKI,tui-vi-nu,177060582,"Túi xách nữ thời trang cao cấp",441000,490000,49000,10
TIKI,tui-vi-nu,190355521,"Túi xách nữ da thật thời trang cao cấp phong cách mới",621000,690000,69000,10
TIKI,tui-vi-nu,274507003,"Túi xách balo nữ 2 trong 1 thông minh đa chức năng thời trang cao cấp phong cách mới",441000,490000,49000,10
TIKI,tui-vi-nu,193614786,"Túi Xách Nữ Đeo Vai Chéo Thời Trang Cao Cấp, Nhiều Ngăn Kéo Đựng Đồ Tiện Lợi, Nhiều Màu Sắc Lựa Chọn Cá Tính",120000,120000,0,0
TIKI,tui-vi-nu,76066141,"Combo 10 Túi Ví Đựng Bảo Vệ Chống Xước Thẻ ATM, CCCD , Card Visit, Driver License Bằng Lái Xe Trong Suốt",5800,5800,0,0
TIKI,tui-vi-nu,199041028,"Túi xách nữ thời trang công sở cao cấp phong cách mới",387000,430000,43000,10
TIKI,tui-vi-nu,191314086,"Túi đeo chéo nữ vải dù chống trượt nước thời trang hàn quốc kiểu hộp ngang đáng yêu 3073",145000,145000,0,0
TIKI,tui-vi-nu,177158869,"Túi xách nữ 2 trong 1 thời trang cao cấp",387000,430000,43000,10
TIKI,tui-vi-nu,162024663,"Túi xách nữ thời trang công sở cao cấp phong cách mới",404000,448200,44200,10
TIKI,tui-vi-nu,174661875,"Túi Đeo Chéo Ngực Cho Nam Chống Nước, Chống Xước, Chống Bám Bẩn, Nhiều Ngăn Phong Cách Thời Trang Cao Cấp Besti Y02- Hàng Chính Hãng",190000,190000,0,0
TIKI,tui-vi-nu,192579893,"Túi xách nữ thời trang công sở cao cấp phong cách mới",387000,430000,43000,10
TIKI,tui-vi-nu,170984404,"Túi Đựng Thẻ Căn Cước Công Dân, Bao Bì Bọc Gói Bảo Quản Bằng Lái Xe Thẻ ATM Card visit Phụ Kiện Túi ví Nam Nữ",1499,1499,0,0
TIKI,tui-vi-nu,71965924,"Túi xách vải bố canvas, thiết kế thời trang in hình họa tiết, đựng được giấy tờ A4 (Nhiều mẫu mã để lựa)",140000,200000,60000,30
TIKI,tui-vi-nu,95861610," Túi Vải Canvas Đeo Vai Phong Cách Hàn Quốc Dành Cho Nam Nữ - Túi Tote Đeo Chéo Unisex",59000,59000,0,0
TIKI,tui-vi-nu,4207965,"Túi đựng ipad Simplecarry LC Ipad",390000,390000,0,0
TIKI,tui-vi-nu,85081131,"Túi đeo chéo nữ túi xách bò sữa ulzzang đi học đi chơi",69000,69000,0,0
TIKI,tui-vi-nu,186650070,"Túi xách nữ thời trang cong sở cao cấp",387000,430000,43000,10
TIKI,tui-vi-nu,186483412,"Túi xách nam công sở cao cấp phong cách mới",450000,499000,49000,10
TIKI,tui-vi-nu,102809098,"Ví dài cầm tay thời trang  YUUMY YV31",159000,290000,131000,45
TIKI,tui-vi-nu,137150221,"Túi đeo chéo nữ vải dù nhiều ngăn chống nước phong cách Hàn Quốc Size 25cm TUI-048",109000,109000,0,0
TIKI,tui-vi-nu,197142476,"Túi xách đeo vai kẹp nách nữ Lata HN102",195000,390000,195000,50
TIKI,tui-vi-nu,77243464,"VÍ KHÓA KÉO Nhỏ Gọn Tiện Lợi Mini ZIP Da Saffiano Nhập Khẩu Cao Cấp Chống Thấm Nước Nam Nữ",218000,218000,0,0
TIKI,tui-vi-nu,157254410,"Túi Bao Tử SAIGON SWAGGER SGS Belt Bumbag-Nhiều Ngăn, Chống Thấm",300000,300000,0,0
TIKI,tui-vi-nu,34624077,"Ví Dài Cầm Tay Nữ GM002",98000,98000,0,0
TIKI,tui-vi-nu,179532969,"Túi đeo chéo nữ dáng tròn họa tiết dập chỉ LATA Mellow HN95",195000,390000,195000,50
TIKI,tui-vi-nu,97327143,"Combo 10 vỏ bọc thẻ căn cước, thẻ tín dụng, bằng lái xe ATM trong suốt mặt nhám, vỏ bọc thẻ chất liệu PVC mềm dẻo, không thấm nước-VBT",5890,5890,0,0
TIKI,tui-vi-nu,137940592,"Ví nữ dài cầm tay thời trang YUUMY YV48",59000,180000,121000,67
TIKI,tui-vi-nu,58478574,"Túi đeo chéo nam thời trang TRITA RTN3",205000,420000,215000,51
TIKI,tui-vi-nu,25022006,"Túi Cói Merci Phong Cách Vintage",41800,41800,0,0
TIKI,tui-vi-nu,176835648,"Túi xách nữ thời trang công sở cao cấp phong cách mới",387000,430000,43000,10
TIKI,tui-vi-nu,176579419,"Móc khóa thời trang YUUMY YMK10 tiện lợi đựng tiền đựng thẻ",25000,50000,25000,50
TIKI,tui-vi-nu,52652672,"Bóp Ví Nữ Cầm Tay SVT-Vinu20 Phong Cách Châu Âu",189000,189000,0,0
TIKI,tui-vi-nu,177169142,"Túi xách nữ thời trang cao cấp",405000,450000,45000,10
TIKI,tui-vi-nu,72869810,"Túi Đeo Chéo Chống Nước FALDO 02",350000,350000,0,0
TIKI,tui-vi-nu,97093919,"Ví Mini Đựng Thẻ Cardholder Da Thật Cao Cấp Saffiano - Genuine Leather Chống Thấm Nước Unisex Nam Nữ Nhiều Màu AaaJeans",189000,189000,0,0
TIKI,tui-vi-nu,147942984,"Túi Đeo Chéo Nữ Đựng Điện Thoại FOREVER YOUNG Da Mềm Nhiều Ngăn Tiện Dụng Chất Cực Đẹp FY02 - Tukado",159000,159000,0,0
TIKI,tui-vi-nu,160224067,"Túi đeo chéo da nữ mini YUUMY YN118",155000,290000,135000,47
TIKI,tui-vi-nu,54459985,"Ví Nữ Ví Da Cầm Tay Mini Nữ FOREVER YOUNG - VI82",25000,30000,5000,17
TIKI,tui-vi-nu,51545193,"Túi xách nữ đeo chéo nhỏ xinh da mềm phong cách hàn quốc Mstaly TX15",50129,52767,2638,5
TIKI,tui-vi-nu,195664425,"Túi Xách Nữ Đeo Chéo, Túi Vải Canvas Đeo Chéo Chất Siêu Đẹp, Túi Vải Đeo Chéo Xách Tay Thời Trang, Túi Tote Đeo Chéo Vải Canvas Thời Trang Phong Cách Hàn Quốc - Ope Store",350000,350000,0,0
TIKI,tui-vi-nu,135321546,"Túi đeo chéo da nữ Yuumy Seasand YN110",145000,290000,145000,50
TIKI,tui-vi-nu,137941843,"Ví cầm tay nữ mini YUUMY YV49",69000,150000,81000,54
TIKI,tui-vi-nu,118103888,"Ví nữ mini YUUMY YV41",59000,150000,91000,61
TIKI,tui-vi-nu,194420293,"[CÓ NẮP] COMBO SỈ 100 túi đựng bằng lái dạng PET, căn cước công dân, thẻ giữ xe, thẻ ATM...dẻo trong hiệu bamarau",99999,99999,0,0
TIKI,tui-vi-nu,37740023,"Túi đeo chéo bao tử nam nữ Sport thời trang  ngang hông  bụng đa năng 4 ngăn",37000,52767,15767,30
TIKI,tui-vi-nu,191314086,"Túi đeo chéo nữ vải dù chống trượt nước thời trang hàn quốc kiểu hộp ngang đáng yêu 3073",145000,145000,0,0
TIKI,tui-vi-nu,191775130,"Túi Xách Nữ Kẹp Nách Chính Hãng MICOCAH Dáng Công Sở Thời Trang Đeo Vai Đeo Chéo Da Cao Cấp Cực Đẹp MC131 - Micocah Mall",469000,469000,0,0
TIKI,tui-vi-nu,51104925,"Ví bóp cầm tay da nữ mini đẹp VN22",25000,30000,5000,17
TIKI,tui-vi-nu,114759867,"Ví nữ ngắn - Ví bóp nữ mini ngắn FOREVER YOUNG THỎ CÀ RỐT",20000,20000,0,0
TIKI,tui-vi-nu,81585797,"Túi Xách Nữ Đeo Chéo Ô Trám Nắp Gập HAPAS - TDC20138",469000,469000,0,0
TIKI,tui-vi-nu,118119519,"Ví nữ cầm tay Yuumy YV39",79000,220000,141000,64
TIKI,tui-vi-nu,86561382,"Ví bóp nữ    Ví nữ cầm tay mini bỏ túi nhiều ngăn dễ thương V061114",27000,30250,3250,11
TIKI,tui-vi-nu,109231955,"10 Vỏ bọc bảo quản thẻ cccd atm, thẻ sinh viên... nhựa dẻo trong suốt",7000,7580,580,8
TIKI,tui-vi-nu,188587637,"Túi Đeo Chéo Nữ Messenger Chất Liệu Polyester Hàng Nhập Khẩu Dùng Tiện Lợi 8847",195000,195000,0,0
TIKI,tui-vi-nu,152944434,"Bóp ví nữ cầm tay mini V0529 Hey Thỏ nhiều ngăn nhỏ gọn phong cách đơn giản, thời trang, dễ thương",25000,50000,25000,50
TIKI,tui-vi-nu,190575852,"Ví dài nữ cầm tay khoá kéo YUUMY Seasand YV60",175000,350000,175000,50
TIKI,tui-vi-nu,151923565,"Túi xách,Túi đeo vai công sở đựng vừa A4 dành cho nữ",125000,125000,0,0
TIKI,tui-vi-nu,188453054,"Set 10 bao đựng thẻ ngân hàng ATM Túi đựng thẻ căn cước công dân bằng lái xe chống chày xước",9999,9999,0,0
TIKI,tui-vi-nu,19841870,"Túi xách tote vải canvas Toto ( hộp )",65000,65000,0,0
TIKI,tui-vi-nu,111868843,"Túi đeo chéo, đeo hông nam Arctic Hunter K00092 chất liệu Oxford chống thấm nước, thiết kế nhiều ngăn tiện dụng",369000,585000,216000,37
TIKI,tui-vi-nu,68105801,"Túi Xách Nữ Thời Trang Cao Cấp Sang Trọng Có Thể Xách Tay  hay Đeo Chéo MS -440",99000,99000,0,0
TIKI,tui-vi-nu,74946016,"Balo Thời Trang Túi Tote Mèo Mắt Long Lanh Mèo Cute Balo Nữ Đi học Balo Ulzzang",94000,94000,0,0
TIKI,tui-vi-nu,44324918,"Túi xách da bò công sở cao cấp phong cách châu âu TX7602",900000,999000,99000,10
TIKI,tui-vi-nu,176835648,"Túi xách nữ thời trang công sở cao cấp phong cách mới",387000,430000,43000,10
TIKI,tui-vi-nu,84263039,"Túi xách nữ túi công sở nữ đính đá thanh lịch sang trọng phong cách Hàn Quốc TN82",299000,299000,0,0
TIKI,tui-vi-nu,86561273,"  50K Túi đeo chéo nữ dây pha xích mini",55000,55000,0,0
TIKI,tui-vi-nu,173556714,"Túi Cói, Túi Cói Đi Biển Vintage, Túi Lục Bình Đi Biển, Túi Xách Đi Làm, Giỏ Du Lịch Chuẩn Đẹp",299000,299000,0,0
TIKI,tui-vi-nu,186133201,"Túi Vải Đeo Chéo Mini Style Nhật Bản Mẫu Mới 2022, Túi Đeo Vai Nữ Dễ Thương Nhiều Màu Sắc",55000,55000,0,0
TIKI,tui-vi-nu,176825223,"Ví đựng thẻ tín dụng ATM nhiều ngăn ví mini kháng nước nhỏ gọn 20 ngăn xinh xắn giá tốt",26000,26000,0,0
TIKI,tui-vi-nu,196341307,"Tấm Lót Chống Thấm Cho Bé Sơ Sinh 5 Lớp Chần Bông Thấm Hút Nhanh An Toàn Tiện Lợi - 231",115000,115000,0,0
TIKI,tui-vi-nu,86561609," Túi Cói    Túi Xách Nữ Phong cách Vintage TV12",39805,41900,2095,5
TIKI,tui-vi-nu,76102979,"Túi Xách Nữ, Túi Đeo Vai Nữ Phong Cách Vintage In Họa Tiết Siêu Dễ Thương",28499,29999,1500,5
TIKI,tui-vi-nu,197321592,"Túi Tote Chần Bông SAIGON SWAGGER NOIR PUFFER TOTE BAG",590000,590000,0,0
TIKI,tui-vi-nu,137952085,"Túi Giỏ Xách Đan Tay Xéo Quai Gỗ Hàng Xuất Khẩu Thủ Công Sang Chảnh Đi Chơi Đi Biển Chụp Hình - Doni House",126000,126000,0,0
TIKI,tui-vi-nu,160314514,"Ví Ngắn Nữ Mini Cầm Tay Thời Trang TAILIAN Đựng Tiền Phong Cách Hàn Quốc Sang Trọng Da Cao Cấp Cực Đẹp TL36 - Micocah",109000,109000,0,0
TIKI,tui-vi-nu,70937309,"Ví nữ cầm tay thời trang cao cấp ELLY – EV69",799000,799000,0,0
TIKI,tui-vi-nu,93831393," Túi đeo chéo trong suốt | Mini Bag Unisex",123500,123500,0,0
TIKI,tui-vi-nu,105655289,"Túi xách túi đeo chéo nữ kiểu dáng công sở kèm dây nơ xinh xắn",99000,99000,0,0
TIKI,tui-vi-nu,193715750,"Túi Xách Nữ, Túi Đeo Chéo Nữ Đẹp Trẻ Trung Hàn Quốc",130000,130000,0,0
TIKI,tui-vi-nu,108155133,"Balo thời trang, balo đi học, đựng laptop Túi Tote Mèo Mắt Long Lanh Mèo Cute balo nữ vải",93000,93000,0,0
TIKI,tui-vi-nu,142211339,"Túi Đeo Chéo Chống Thám, Kháng Khuẩn Stargo Retro - Hàng Chính Hãng",219000,219000,0,0
TIKI,tui-vi-nu,108154925,"Túi tote vải Túi Tote Túi Vải Nữ Túi túi xách Túi Tote Sinh Viên Chú Gà Sweet balo nữ vải",63000,63000,0,0
TIKI,tui-vi-nu,155169078,"Túi giỏ xách nữ đeo chéo cao cấp thời trang Hàn Quốc sang chảnh chất liệu da mềm mịn, kiểu dáng sang trọng,lịch sự TX048",219000,219000,0,0
TIKI,tui-vi-nu,185468208,"bóp ví nữ cầm tay hoặc đeo chéo hàng hiệu có nhiều ngăn dáng nằm với 2 ngăn kéo tiện dụng - N0109",158000,249000,91000,37
TIKI,tui-vi-nu,53979971,"Ví nữ cầm tay cao cấp 2 ngăn kéo sang trọng, thiết kế nhiều ngăn tiện dụng TK0047 - ĐEN",76000,100000,24000,24
TIKI,tui-vi-nu,13419271,"Ví Mini Cầm Tay Họa Tiết Kim Loại Hn001",62000,62000,0,0
TIKI,tui-vi-nu,191309841,"Marhen.J - Dây đeo túi xách bản rộng Node Strap MJ21ANDFST-SI",990000,990000,0,0
TIKI,tui-vi-nu,272429248,"Túi xách nữ vải dù siêu bền không thấm nước kiểu dáng Hàn Quốc size 21cm",119000,119000,0,0
TIKI,tui-vi-nu,91430164,"Ví card holder",127000,127000,0,0
TIKI,tui-vi-nu,88813417,"Túi xách Pierre Loues dáng túi trống đeo vai với 2 đầu gút thắt cách điệu thời trang dạo phố - PL514",257000,298000,41000,14
TIKI,tui-vi-nu,68773394,"Túi Kẹp Nách Nữ Thời Trang Hot Trend Cá Tính TEB409",55000,55000,0,0
TIKI,tui-vi-nu,182712650,"Ví nữ Monogram canvas ELLY – EVH90",599400,999000,399600,40
TIKI,tui-vi-nu,190744476,"Túi Đeo Chéo Nam Nữ Vải Bố Túi Đeo Vai Nam Chất Liệu Kaki Chống Nước Size 24cm TUI-36",109000,109000,0,0
TIKI,tui-vi-nu,118036773,"Đãi túi cho phật tử và thầy, túi kaki đeo vai",72000,72000,0,0
TIKI,tui-vi-nu,104091538,"Ví nữ cầm tay dáng dài YUUMY Seasand YUUMY YV47 phong cách hiện đại nhiều ngăn đựng tiền, thẻ card",85000,220000,135000,61
TIKI,tui-vi-nu,68626519,"Ví da nữ mini nhỏ gọn đựng tiền đựng thẻ YUUMY YV29 nhiều màu",59000,110000,51000,46
TIKI,tui-vi-nu,5003079,"Túi Xách Nữ Thời Trang Cao Cấp Elly EL95 Đen",1199000,1199000,0,0
TIKI,tui-vi-nu,93151621,"Túi Đeo Chéo Nam Thời Trang Vải Bố Canvas Cao Cấp Dạng Hộp Chống Thấm Nước, Du Lịch, Đi Học, Đi Chơi",69000,69000,0,0
TIKI,tui-vi-nu,79965375,"Túi đeo chéo nữ thời trang kiểu dáng Hàn Quốc chất vải mềm mại chống nước TN131",99000,99000,0,0
TIKI,tui-vi-nu,160648292,"Túi xách nữ công sở dáng ngang cao cấp YUUMY YTX21",195000,420000,225000,54
TIKI,tui-vi-nu,79270437,"Túi đeo chéo nữ thời trang cao cấp Hàn Quốc TN116",99000,99000,0,0
TIKI,tui-vi-nu,114119695,"Túi Đeo Chéo Mickey Dáng Vuông",189000,189000,0,0
TIKI,tui-vi-nu,177238136,"Túi xách nữ thời trang công sở cao cấp phong cách mới",423000,470000,47000,10
TIKI,tui-vi-nu,206955191,"Túi xách, Husband & Wife, Best Friends for Life, mã G142. Có khóa kéo. Quà tặng cao cấp cho vợ chồng",109000,109000,0,0
TIKI,tui-vi-nu,186606688,"Túi Vải Canvas Cao cấp - Độc quyền HeydayCacao",79000,79000,0,0
TIKI,tui-vi-nu,149449476,"Túi xách nữ công sở - hàng quảng châu cao cấp (HOTTREND )",258000,258000,0,0
TIKI,tui-vi-nu,160314200,"Ví Ngắn Nữ Mini Cầm Tay Thời Trang TAILIAN Nhiều Ngăn Đựng Tiền Phối Vân Da Rắn Cao Cấp Siêu Đẹp Giá Rẻ TL34 - Micocah",119000,119000,0,0
TIKI,tui-vi-nu,114119999,"Ví nữ mini hoạt hình cao cấp ngắn cute nhỏ gọn đựng tiền thẻ căn cước bỏ túi thời trang tiện lợi giá rẻ",76000,76000,0,0
TIKI,tui-vi-nu,76448408,"Túi xách nam công sở cao cấp phong cách mới",423000,470000,47000,10
TIKI,tui-vi-nu,187328731,"Bao bọc thẻ căn cước, thẻ ATM, thẻ PET - Loại dày, trắng trong, có nắp",1499,1499,0,0
TIKI,tui-vi-nu,136940059,"TÚI THỔ CẨM ĐEO CHÉO ĐỰNG ĐIỆN THOẠI",15000,15000,0,0
TIKI,tui-vi-nu,109242515,"Túi đeo chéo thời trang Unisex Zakomi vải cao cấp chống thấm nước ZTDC001 - Bảo hành 12 tháng",199000,199000,0,0
TIKI,tui-vi-nu,72958731,"Túi đeo chéo nữ đựng điện thoại 2 mặt có cảm ứng Shalla MN2 Tặng móc khóa cá heo",43856,46164,2308,5
TIKI,tui-vi-nu,5003107,"Túi Xách Nữ Thời Trang Cao Cấp Elly EL85",1049300,1499000,449700,30
TIKI,tui-vi-nu,135095916,"Túi tote đeo vai, đeo chéo vải bố canvas T046 nữ 2 dây đựng đồ đi học, đi chơi mềm đẹp",70000,140000,70000,50
TIKI,tui-vi-nu,45871746,"quai đeo túi xách dạng dây da và xích kim loại túi cnk 110cm",90000,90000,0,0
TIKI,tui-vi-nu,174469000,"Ví Nữ Mini Cầm Tay PERFECT FOR YOU Dáng Ngắn Nhiều Ngăn Tiện Dụng Chất Da Xước Cao Cấp Cực Đẹp PFY04",149000,149000,0,0
TIKI,tui-vi-nu,58563589,"Cặp Công Sở Đa Năng TRITA TCA6",329000,660000,331000,50
TIKI,tui-vi-nu,186650070,"Túi xách nữ thời trang cong sở cao cấp",387000,430000,43000,10
TIKI,tui-vi-nu,67070321,"Túi xách đeo chéo nữ vải dù chống nước cao cấp",109000,109000,0,0
TIKI,tui-vi-nu,144515523,"Túi xách da nữ đa năng LATA TX10",490000,490000,0,0
TIKI,tui-vi-nu,85137894," MERCI Túi cói thời trang Merci chuẩn loại 1",39000,54900,15900,29
TIKI,tui-vi-nu,172377943,"Ví nữ mini nắp cách điệu YUUMY Seasand YV59",65000,150000,85000,57
TIKI,tui-vi-nu,12453280,"Ví da cầm tay cao cấp dùng đựng điện thoại, thẻ và giấy tờ cho nữ AV002 (Hot Model 2019)",159000,159000,0,0
TIKI,tui-vi-nu,114644919,"Túi cói Merci, túi cói du lịch phong cách Vintage có đệm đáy giữ form túi, có ngăn nhỏ kéo khóa Lisa, M44",46522,48970,2448,5
TIKI,tui-vi-nu,93878483,"Túi đeo chéo thông minh Divoom Pixoo Slingbag hiển thị màn hình Led, tích hợp app Divoom",1950000,1950000,0,0
TIKI,tui-vi-nu,145494864,"Túi Đeo Chéo Unisex Sắc Màu Thời Trang Peozi SM06 Unisex Sport Mini Bag | Túi Mini Đa Năng Vừa Là Túi Bao Tử + Túi Đựng Điện Thoại Chạy Bộ, Đạp Xe",54150,57000,2850,5
TIKI,tui-vi-nu,68349508,"Ví cầm tay thời trang đa năng YUUMY YMK2 nhiều màu",25000,50000,25000,50
TIKI,tui-vi-nu,89135102,"túi xách ,túi đeo vai, đeo chéo nữ vải canvas cao cấp phong cách mới",269000,298000,29000,10
TIKI,tui-vi-nu,162029783,"Túi xách nữ thời trang công sở cao cấp phong cách mới",468000,520000,52000,10
TIKI,tui-vi-nu,58470994,"Túi xách đựng được giấy A4, túi xách laptop, máy tính bảng form rộng cực đẹp (Nhiều mẫu mã để chọn)",270000,450000,180000,40
TIKI,tui-vi-nu,118119353,"Ví nữ mini Yuumy YV40",59000,150000,91000,61
TIKI,tui-vi-nu,174468915,"Ví Nữ Mini Cầm Tay PERFECT FOR YOU Dáng Vuông Xinh Xắn Chất Cực Đẹp PFY01",99000,99000,0,0
TIKI,tui-vi-nu,138569315,"Túi đeo chéo da nam TRITA RTN5",209000,420000,211000,50
TIKI,tui-vi-nu,81783337,"Túi Xách Nữ Khóa Gài Da Rắn Mới HAPAS - TDC18149",469000,469000,0,0
TIKI,tui-vi-nu,135309816,"Túi đeo chéo vải bố canvas T0588 nữ trơn thêu chữ mềm, đẹp phong cách trẻ trung, cá tính",54000,108000,54000,50
TIKI,tui-vi-nu,110723636," VÍ DA CẦM TAY NỮ VÍ DA CẦM TAY NAM",118000,169000,51000,30
TIKI,tui-vi-nu,190355521,"Túi xách nữ da thật thời trang cao cấp phong cách mới",621000,690000,69000,10
TIKI,tui-vi-nu,81322798,"Túi đeo chéo nữ  túi xách nữ công sở thêu hoa thời trang sang trọng phong cách Hàn Quốc TN125",219000,219000,0,0
TIKI,tui-vi-nu,155610646,"Túi xách đeo chéo nữ giá rẻ đẹp đi chơi phong cách thời trang hàn quốc dễ thương cute DC297 - DC297 TRẮNG",64000,64000,0,0
TIKI,tui-vi-nu,192689048,"Túi xách nữ thời trang công sở cao cấp phong cách mới",351000,390000,39000,10
TIKI,tui-vi-nu,174468945,"Ví Nữ Ngắn Mini Cầm Tay Chính Hãng TAILIAN Đựng Tiền Đựng Thẻ Kẻ Caro Xinh Xắn Da Cao Cấp TL12",119000,119000,0,0
TIKI,tui-vi-nu,76181891,"Ví nữ cầm tay 2 ngăn kéo cao cấp, thiết kế độc đáo đẹp mắt, nhiều ngăn tiện dụng TK0073",69000,100000,31000,31
TIKI,tui-vi-nu,16882460,"Vỏ Bọc Hộ Chiếu Có Khe Nhét Thẻ Tiện Dụng",2999,2999,0,0
TIKI,tui-vi-nu,152446331,"Túi xách nữ đeo chéo da mềm thời trang phong cách Hàn Quốc",99000,99000,0,0
TIKI,tui-vi-nu,160314876,"Túi Xách Đeo Chéo Nữ Kẹp Nách Chính Hãng MICOCAH Dáng Công Sở Thời Trang Da Cao Cấp Cực Đẹp MC63",369000,369000,0,0
TIKI,tui-vi-nu,189832277,"Túi xách túi đeo vai nữ mini , có quai cầm ngọc  trai ,da bóng đẹp  xinh xắn đáng yêu cho phái nữ dạo phố",39000,39000,0,0
TIKI,tui-vi-nu,137154030,"Túi Tote Canvas Đeo Chéo Nữ Đi Học Mèo My World Phong Cách Ulzzang",59000,59000,0,0
TIKI,tui-vi-nu,84229853,"Túi xách nữ thêu hoa túi xách công sở thanh lịch sang trọng phong cách Hàn Quốc",219000,219000,0,0
TIKI,tui-vi-nu,197162288,"Túi đeo chéo khóa xoay Yuumy Seasand YN142",335000,650000,315000,48
TIKI,tui-vi-nu,177060582,"Túi xách nữ thời trang cao cấp",441000,490000,49000,10
TIKI,tui-vi-nu,56531143,"Ví nữ cầm tay gấp đôi nhỏ gọn, phối màu dễ thương TK0052",35000,70000,35000,50
TIKI,tui-vi-nu,58230324,"Túi bao tử nữ đeo chéo trước ngực, đeo hông",52000,73062,21062,29
TIKI,tui-vi-nu,57049668,"Túi clutch nữ thời trang cao cấp ELLY – ECH17",629300,899000,269700,30
TIKI,tui-vi-nu,159725474,"Túi xách đa năng May 10 (giao màu ngẫu nhiên)",35000,35000,0,0
TIKI,tui-vi-nu,172366798,"Ví da nữ cầm tay nhỏ gọn YUUMY Seasand YV58",65000,150000,85000,57
TIKI,tui-vi-nu,72210939,"Móc khóa thời trang YUUMY YMK5 - Màu sắc trẻ trung - Thiết kế hiện đại - Đa chức năng sử dụng - Đựng thẻ ngân hàng, thẻ xe, chìa khóa xe - Tiên dụng mang theo bên người (Dài 7cm x Cao 10.5cm)",25000,50000,25000,50
TIKI,tui-vi-nu,89480630,"Túi Bao Tử Màu Đen Chất Bố Chống Nước Nhập Khẩu Hàng Quốc Nhỏ Gọn Nhẹ Tiện Lợi",99000,320000,221000,69
TIKI,tui-vi-nu,162373758,"Túi Vải Bố Canvas Tote Trơn Grepaco Không In Màu Trắng Dạng Quai Xách Đeo Vai Có Ngăn Phụ Bên Trong Dùng Đi Học Dạy Vẻ Cho Sinh Viên Học Sinh",49000,49000,0,0
TIKI,tui-vi-nu,8259548,"Túi đeo chéo nam TROY classic V2",129000,129000,0,0
TIKI,tui-vi-nu,148850128,"Ví đựng thẻ Arctic Hunter Q00012 thiết kế nhiều ngăn, đựng tiền giấy thời trang cho nam và nữ",175000,299000,124000,41
TIKI,tui-vi-nu,66654552,"dây xích kim loại, quai túi xách, dây túi 2 loại ngắn40cm và dài 120cm",33000,33000,0,0
TIKI,tui-vi-nu,54430952,"Túi xách nữ cao cấp phong cách châu âu hiện đại mới",275000,275000,0,0
TIKI,tui-vi-nu,173167924,"Túi vải bố, Túi vải Canvas trơn Màu Trắng - Màu Đen không khóa kéo",19000,19000,0,0
TIKI,tui-vi-nu,42729783,"Túi clutch nữ thời trang cao cấp ELLY – ECH31",999000,999000,0,0
TIKI,tui-vi-nu,68527197,"Túi xách tote vải Túi Tote Túi Vải Nữ Túi Đeo Chéo Hàn Quốc ",51300,51300,0,0
TIKI,tui-vi-nu,135545812,"Túi đeo chéo mini Fimax vài cao cấp chống thấm nước - túi đeo nữ thời trang vải cao cấp phong cách Hàn Quốc",119000,119000,0,0
TIKI,tui-vi-nu,188503686,"Túi đeo chéo nữ vải dù trần trám, nhiều ngăn chống nước, phong cách Hàn Quốc Size 22cm TUI-58",139000,139000,0,0
TIKI,tui-vi-nu,45268061,"Dây Túi đeo chéo da pu kết hợp với dây vải xì teen, dây đeo vai có thể điều chỉnh  có thể điều chỉnh",120000,120000,0,0
TIKI,tui-vi-nu,107614755,"Túi vải bố, Túi vải Canvas trơn Màu Trắng - Màu Đen không khóa kéo",19000,19000,0,0
TIKI,tui-vi-nu,96311978,"Túi Cói Xách Tay Thời Trang Đi Biển 2 Lớp Quai Vải Phong Cách Vintage - Mã XT026",46000,59000,13000,22
TIKI,tui-vi-nu,172977144,"Túi vải bố, Túi vải Canvas trơn Màu Be - Màu Đen không khóa kéo",19000,19000,0,0
TIKI,tui-vi-nu,55022823,"Túi xách nữ đeo chéo hàn quốc đẹp cao cấp Vimona TX20 in vân chìm sang chảnh",128000,128000,0,0
TIKI,tui-vi-nu,150147404,"Dầu Bôi Ấm Ngực Vicks Baby Balsam Chống Cảm Cho Bé",175000,250000,75000,30
TIKI,tui-vi-nu,114568388,"Túi cói Merci thời trang đi biển - dạo phố - đi làm",41890,41890,0,0
TIKI,tui-vi-nu,102399926,"Túi xách đeo chéo nữ nhỏ dạo phố xinh xắn MN105",99000,99000,0,0
TIKI,tui-vi-nu,89221457,"Túi đeo chéo Sakos Juvanis",1280000,1280000,0,0
TIKI,tui-vi-nu,117084931,"Túi xách đeo chéo nữ tặng dây chuyền ngọc trai dạo phố",159000,159000,0,0
TIKI,tui-vi-nu,86560842,"Ví bóp nữ   Ví nữ cầm tay ngắn mini cao cấp nhiều ngăn giá rẻ V042301",32000,32000,0,0
TIKI,tui-vi-nu,158815530,"Ví cầm tay nữ nắp gập cách điệu YUUMY Seasand YV55",155000,330000,175000,53
TIKI,tui-vi-nu,90113077,"Túi Cói Merci Siêu Tiện Dụng Siêu HÓT HÍT Túi đi biển",54999,54999,0,0
TIKI,tui-vi-nu,162024663,"Túi xách nữ thời trang công sở cao cấp phong cách mới",404000,448200,44200,10
TIKI,tui-vi-nu,134947145,"Túi Xách Cói Dây Da Đi Biển YUUMY YTX16",145000,290000,145000,50
TIKI,tui-vi-nu,73340768,"TÚI ĐEO CHÉO Mini Tiện Lợi BUMBAG Vải Canvas Cao Cấp Chống Thấm Nước Unisex Nam Nữ Chuẩn Dim DOLANTO",180000,180000,0,0
TIKI,tui-vi-nu,132053956,"Túi xách nữ sang chảnh 4 màu hộp vuông túi nữ có dây đeo chéo dáng hàn quốc size 20",125000,125000,0,0
TIKI,tui-vi-nu,146414142,"Túi xách nữ đeo chéo đựng điện thoại dáng dọc phối hoa văn nhiều ngăn tiện dụng thời trang Hàn Quốc",139000,139000,0,0
TIKI,tui-vi-nu,130856262,"Túi Đeo Chéo Vải Bố Phong Cách Hàn Quốc Xinh Xắn Dành Cho Nữ",46700,46700,0,0
TIKI,tui-vi-nu,58563135,"Cặp Công Sở Đa Năng TRITA TCA5",349000,650000,301000,46
TIKI,tui-vi-nu,109631859,"Ví dự tiệc cưới, sự kiện, kiểu dáng trong suốt, có nút gài kim loại, ví dự tiệc sang trọng, đẳng cấp",270000,450000,180000,40
TIKI,tui-vi-nu,73716485,"Túi tote vải Túi Tote Túi Vải Nữ Túi Đeo Chéo Hàn Quốc",55900,55900,0,0
TIKI,tui-vi-nu,153262523,"Combo 5 Túi Ví Đựng Bảo Vệ Chống Xước Thẻ ATM, Card Visit, CMND, Driver License Bằng Lái Xe Trong Suốt - Loại 1 Chính Hãng MINIIN",1805,1900,95,5
TIKI,tui-vi-nu,75600848,"Túi đeo chéo ,đeo ngực nam phong cách mới",405000,450000,45000,10
TIKI,tui-vi-nu,8280980,"Túi Vải Canvas - Pink",124000,169000,45000,27
TIKI,tui-vi-nu,114411570,"Móc khóa thời trang LATA MK6",85000,150000,65000,43
TIKI,tui-vi-nu,144492638,"Túi đeo chéo nữ nắp gập khóa vàng YUUMY Seasand YN109",319000,660000,341000,52
TIKI,tui-vi-nu,192033898,"Túi peekoo xanh tiện lợi",49000,49000,0,0
TIKI,tui-vi-nu,83479525,"Ví dài cầm tay nữ phong cách dễ thương trẻ trung YUUMY YV35",165000,320000,155000,48
TIKI,tui-vi-nu,46687882,"Ví nữ ngắn mini cầm tay kiểu dáng Hàn Quốc",23760,34320,10560,31
TIKI,tui-vi-nu,83609298,"Ví dài nữ nhiều ngăn cầm tay LATA VN54",350000,350000,0,0
TIKI,tui-vi-nu,196603272,"Túi đeo chéo da nữ khóa xoay LATA HN104",325000,650000,325000,50
TIKI,tui-vi-nu,173983400,"Phụ Kiện Túi Vải YUUMY Cỡ Trung YBVLT",15000,15000,0,0
TIKI,tui-vi-nu,196409306,"Túi đeo chéo nữ khóa nhấn LATA HN96",590000,590000,0,0
TIKI,tui-vi-nu,176267743,"Túi đeo chéo nữ nắp phong thư Yuumy seasand YN97",289000,570000,281000,49
TIKI,tui-vi-nu,167599223,"Túi xách nữ thời trang cao cấp",315000,350000,35000,10
TIKI,tui-vi-nu,193613838,"Túi Cói Hình Gấu Bông Loại 1 Siêu Xinh, Dày Dặn - JL",38000,38000,0,0
TIKI,tui-vi-nu,112936486,"Ví Bóp Nữ Cầm Tay Dáng Dài Đựng Tiền Điện Thoại Thời Trang",99000,99000,0,0
TIKI,tui-vi-nu,58216140,"Cặp công sở TRITA TCA2",329000,600000,271000,45
TIKI,tui-vi-nu,90375417,"Ví nữ mini đựng tiền dễ thương hình gấu có thể làm móc khóa siêu đáng yêu da mềm giá rẻ V12",120000,120000,0,0
TIKI,tui-vi-nu,193005196,"Túi đeo chéo nam da bò Staurn Bụi Leather DC111 - Da bò thật cao cấp - Bảo hành 12 tháng",479000,679000,200000,29
TIKI,tui-vi-nu,12206257,"Túi clutch nữ cao cấp da thật ELLY EC18",659400,1099000,439600,40
TIKI,tui-vi-nu,193715166,"Túi Xách Nữ, Túi Đeo Chéo Nữ Đeo Vai Kẹp Nách Đi Chơi Phong Cách Hàn Quốc",125000,125000,0,0
TIKI,tui-vi-nu,174942884,"Túi Xách Nữ Đeo Chéo Siêu Hot, Phối Dây Xích Khuy Cài Chữ H TR68",99000,99000,0,0
TIKI,tui-vi-nu,57879427,"Túi bao tử liên kết, đeo chéo nữ, chất đẹp, màu sắc đơn giản",55000,55000,0,0
TIKI,tui-vi-nu,68238372,"Bóp ví nữ dài cầm tay kiểu dáng thanh lịch, thời trang, đựng vừa điện thoại màn hình lớn, thêm chức năng chống quét thẻ cực đặc biệt",269000,269000,0,0
TIKI,tui-vi-nu,189688895,"Ví nữ cầm tay dáng đứng YUUMY Liberal YV71",85000,190000,105000,55
TIKI,tui-vi-nu,193004984,"Túi đeo chéo nam Jupiter Bụi Leather DC110 - Da bò thật cao cấp - Bảo hành 12 tháng",499000,705000,206000,29
TIKI,tui-vi-nu,72626877,"Túi Tote nữ túi đeo vai túi xách tote túi đeo chéo Hàn Quốc túi vải đeo vai kẹp nách",40980,40980,0,0
TIKI,tui-vi-nu,86561256," Túi đeo chéo nữ    Túi xách hàng Quảng Châu Siêu SANG CHẢNH TD16",90000,90000,0,0
TIKI,tui-vi-nu,73726268,"Túi Xách Đeo Chéo Vải Dù Chống Nước, Chống Xước Cao Cấp",29000,29000,0,0
TIKI,tui-vi-nu,16259917,"Túi xách thời trang nữ đeo chéo da mềm 3 ngăn",75000,75000,0,0
TIKI,tui-vi-nu,68219008,"Túi xách thời trang nữ kiểu dáng công sở KQ09",162000,162000,0,0
TIKI,tui-vi-nu,46643459,"Túi xách nữ thời trang công sở Châu âu",179000,179000,0,0
TIKI,tui-vi-nu,73341200,"VÍ MINI ĐỰNG THẺ Bóp Cardholder ZERO Da Saffiano Nhập Khẩu Cao Cấp Chống Thấm Nước Unisex Nam Nữ Chuẩn Nome DOLANTO",150000,150000,0,0
TIKI,tui-vi-nu,177063088,"Túi xách nữ 2 trong 1 thời trang cao cấp phong cách mới",387000,430000,43000,10
TIKI,tui-vi-nu,100129513,"[VOUCHER 30K] Túi đeo chéo nữ thời trang LATA HN92 mang phong cách thanh lịch, sang trọng",520000,520000,0,0
TIKI,tui-vi-nu,142435344,"Túi xách nữ công sở túi đeo vai đựng vừa A4 thời trang phong cách Hàn Quốc",139000,139000,0,0
TIKI,tui-vi-nu,190337006,"Túi xách nữ công sở đựng laptop dáng đứng tote thời trang Yuumy YTX18",225000,520000,295000,57
TIKI,tui-vi-nu,190320302,"Túi xách túi đeo vai nữ thời trang cao cấp phong cách mới",351000,390000,39000,10
TIKI,tui-vi-nu,44155709,"Ví nữ cầm tay thời trang YUUMY YV18",149000,270000,121000,45
TIKI,tui-vi-nu,87100103,"Balo thời trang, balo đi học, đựng laptop Túi Tote Thời Trang Cúc Hoạ Mi Best Of Me balo nữ vải",75000,75000,0,0
TIKI,tui-vi-nu,87389694,"TÚI XÁCH NỮ, TÚI ĐEO CHÉO TRẦN TRÁM KHÓA GẬP GR 454",92000,92000,0,0
TIKI,tui-vi-nu,129863919,"Túi vải tote, túi vải canvas trơn nhiều màu",28000,28000,0,0
TIKI,tui-vi-nu,144630552,"Túi xách , Túi đeo vai nữ thời trang Hàn Quốc trẻ trung KN289",125000,125000,0,0
TIKI,tui-vi-nu,193384569,"Ví Nữ Thời Trang cao cấp phong cách mới – VNU1002",165000,330000,165000,50
TIKI,tui-vi-nu,143292607,"Túi xách đeo chéo nữ tặng dây chuyền ngọc trai dạo phố thời trang phong cách Hàn Quốc",159000,159000,0,0
TIKI,tui-vi-nu,83941262,"Ví da Mini đựng card Visit - Ví đựng thẻ kiểu dáng nhỏ gọn - Ví da thật handmade - Đồ da thủ công cao cấp",399000,399000,0,0
TIKI,tui-vi-nu,5003285,"Túi Xách Nữ Cao Cấp Da Thật Elly ET61",1319400,2199000,879600,40
TIKI,tui-vi-nu,193004204,"Túi đeo chéo da bò thật Venus Bụi Leather DC108 - Da bò Nappa cao cấp - Bảo hành 12 tháng",349000,495000,146000,29
TIKI,tui-vi-nu,183250364,"Túi Tote Đeo Vai Vải Canvas Siêu Dễ Thương Phong Cách Hàn Quốc - Con Vật Nhiều Mẫu M3",58000,58000,0,0
TIKI,tui-vi-nu,86561480,"Túi đeo chéo   Túi vải Tote vải Canvas Phong Cách Hàn Quốc TV18",25000,25000,0,0
TIKI,tui-vi-nu,148850131,"Túi đeo chéo, đeo ngực nam Arctic Hunter YB00047 chất liệu Oxford chống thấm nước, thiết kế nhiều ngăn tiện dụng",299000,550000,251000,46
TIKI,tui-vi-nu,107276170,"Túi Vải Canvas Đeo Chéo Phong Cách Harajuku Nhật Bản Cho Nữ",81900,81900,0,0
TIKI,tui-vi-nu,262692471,"Túi Xách Nữ Thời Trang Cao Cấp Elly EL2",899400,1499000,599600,40
TIKI,tui-vi-nu,147346886,"Vỏ bọc thẻ căn cước công dân,thẻ ngân hàng,chứng minh thư,thẻ tín dụng,bằng lái xe - K39",1499,1499,0,0
TIKI,tui-vi-nu,8280862,"Túi Vải Canvas - Collect Moments",124000,169000,45000,27
TIKI,tui-vi-nu,193241728,"Túi Đeo Chéo Nam Vải Nylon Cao Cấp Nhiều Ngăn Chống Thấm Nước, Túi Đeo Vai Phong Cách Thời Trang Hàn Quốc Dành Cho Người Đi Làm, Học Sinh, Sinh Viên,Người Đi Chơi, Đi Du Lịch",115000,115000,0,0
TIKI,tui-vi-nu,72032534,"Túi xách nữ thời trang cao cấp ELLY- EL137",899000,899000,0,0
TIKI,tui-vi-nu,74255457,"Túi xách tote vải Túi Tote Túi Vải Nữ Túi Đeo Chéo Hàn Quốc Mèo lười",45400,45400,0,0
TIKI,tui-vi-nu,70491099,"Túi đeo chéo vai thời trang nam chống thấm nước phản quang cao cấp sang trọng đi học đi phượt",159000,159000,0,0
TIKI,tui-vi-nu,195160576,"Túi Đeo Chéo Nam Nữ Size Lớn Chất Vải Polysster Cao Cấp Chống Thấm Nước 2087 End&Start  BL003",288000,320000,32000,10
TIKI,tui-vi-nu,193202414,"Túi Da Đeo Chéo Nhỏ, Túi Đeo Chéo Da Nam Nữ Phong Cách Thời Trang Hàn Quốc",120000,120000,0,0
TIKI,tui-vi-nu,136940062,"TÚI THỔ CẨM ĐEO CHÉO ĐỰNG ĐIỆN THOẠI",15000,15000,0,0
TIKI,tui-vi-nu,44153043,"Túi bao tử nữ đeo chéo trước ngực, đeo hông cá tính TX00279",99000,99000,0,0
TIKI,tui-vi-nu,73218453,"TÚI ĐEO CHÉO Mini Tiện Lợi RUSH BAG Nhỏ Gọn Vải Canvas Cao Cấp Chống Thấm Nước Unisex Nam Nữ Chuẩn Leonardo DOLANTO",209000,209000,0,0
TIKI,tui-vi-nu,43543689,"Ví bóp cầm tay da nữ mini đẹp LATIA VD220",31000,31000,0,0
TIKI,tui-vi-nu,83673067,"Túi đeo chéo nữ Lata HN86",469000,520000,51000,10
TIKI,tui-vi-nu,219457402,"dây da phối xích co giãn tốt, tự điều chỉnh độ dài theo ý, dây túi đeo vai túi xách quai túi hoặc xích không kèm da",100000,100000,0,0
TIKI,tui-vi-nu,160314703,"Túi Xách Nữ Kẹp Nách Đeo Vai Đeo Chéo MICOCAH Dáng Công Sở Thời Trang Ulzzang Da Cao Cấp Siêu Đẹp Giá Rẻ MC75 - Micocah",439000,439000,0,0
TIKI,tui-vi-nu,160314028,"Túi Xách Nữ Đeo Vai Kẹp Nách Chính Hãng MICOCAH Dáng Công Sở Thời Trang Size Lớn Tiện Dụng Da Cao Cấp Cực Đẹp MC58",449000,449000,0,0
TIKI,tui-vi-nu,82921698,"Túi xách túi đeo vai nam 100% da bò cao cấp phong cách châu âu",711000,790000,79000,10
TIKI,tui-vi-nu,88798763,"Túi vải canvas đeo chéo phong cách thời trang hàn quốc, túi đeo cho nữ nhỏ xinh với 2 ngăn đựng đồ tiện lợi-TẶNG KÈM GẤU BÔNG CỰC MINI DỄ THƯƠNG",125000,125000,0,0
TIKI,tui-vi-nu,136940154,"TÚI VÍ THỔ CẨM ĐỰNG TIỀN",15000,15000,0,0
TIKI,tui-vi-nu,90531483,"Túi xách nữ thời trang cao cấp",327000,362700,35700,10
TIKI,tui-vi-nu,193051834,"Ví Cầm Tay Nữ Dài Đeo Chéo Cao Cấp Sang Trọng Phong Cách Hàn Quốc TVNN262",259000,259000,0,0
TIKI,tui-vi-nu,73755073,"Túi xách đeo vai phiên bản Hàn Quốc  họa tiết hoạt hình cực kỳ dễ thương cho các teen girl - SB120 (Giao mẫu ngẫu nhiên)",68899,68899,0,0
TIKI,tui-vi-nu,263961192,"Túi xách nam công sở da bò thật cao cấp phong cách mới",794000,882000,88000,10
TIKI,tui-vi-nu,193044379,"Túi xách nữ thời trang công sở cao cấp phong cách mới",477000,530000,53000,10
TIKI,tui-vi-nu,182713607,"Ví Nữ Monogram Canvas ELLY – EV88",999000,999000,0,0
TIKI,tui-vi-nu,37939795,"Túi Da Đeo Chéo P074",254000,359000,105000,29
TIKI,tui-vi-nu,188566537,"Túi Đeo Chéo Nam Oxford Cao Cấp Nhiều Ngăn Chống Thấm Nước, Túi Đeo Vai Phong Cách Thời Trang Hàn Quốc Dành Cho Người Đi Làm, Học Sinh, Sinh Viên,Người Đi Chơi, Đi Du Lịch",135000,135000,0,0
TIKI,tui-vi-nu,111868698,"Túi đeo chéo du lịch nam Arctic Hunter K00096 chất liệu Oxford chống thấm nước, đựng ipad, thiết kế nhiều ngăn tiện dụng",379000,650000,271000,42
TIKI,tui-vi-nu,75389928,"Ví dự tiệc cưới sang trọng, kèm dây xích sang trọng, đẳng cấp (Nhiều mẫu để chọn)",240000,400000,160000,40
TIKI,tui-vi-nu,174469052,"Ví Nữ Ngắn Mini Cầm Tay BATSIOE Nhỏ Gọn Nhiều Ngăn Đựng Tiền Đựng Thẻ Chất Da Cao Cấp Giá Rẻ BS03",129000,129000,0,0
TIKI,tui-vi-nu,115520033,"Cặp da công sở tay rút nắp can VINADA ",269000,269000,0,0
TIKI,tui-vi-nu,119329300,"Túi Đeo Chéo Nữ Dáng Vuông FOREVER YOUNG Nhiều Ngăn Đựng Điện Thoại, Đựng Tiền Siêu Tiện Dụng",239000,239000,0,0
TIKI,tui-vi-nu,191775112,"Túi Xách Nữ Kẹp Nách Chính Hãng MICOCAH Dáng Công Sở Thời Trang Sang Trọng Phối Vân Da Rắn Cao Cấp Cực Đẹp MC130 - Micocah",539000,539000,0,0
TIKI,tui-vi-nu,52671241,"Bóp Ví Nữ Cầm Tay Ngắn SVT-Vinu20 Phong Cách Châu Âu",89000,89000,0,0
TIKI,tui-vi-nu,183248987,"Túi Tote Đeo Vai Vải Canvas Siêu Dễ Thương Phong Cách Hàn Quốc - Ly Nước Nhiều Mẫu M2",58000,58000,0,0
TIKI,tui-vi-nu,175195781,"Ví nữ dài cầm tay nhiều ngăn LOVE đẹp thời trang TK007",59000,118000,59000,50
TIKI,tui-vi-nu,53934661,"Túi xách nữ đeo chéo phong cách châu âu hiện đại",225000,250000,25000,10
TIKI,tui-vi-nu,107962222,"Ví nữ đựng tiền kiểu dáng mini nhỏ gọn sang chảnh",159000,159000,0,0
TIKI,tui-vi-nu,195971769,"Túi xách nữ cao cấp da thật ELLY – ET142",2999000,2999000,0,0
TIKI,tui-vi-nu,71096052,"TÚI  ĐEO CHÉO NỮ MÀU XANH",69000,69000,0,0
TIKI,tui-vi-nu,24733708,"Ví Bóp Cầm Tay Nữ Ngắn Thời Trang GD Khóa Bấm Đính Con Ong Nhiều Ngăn Tiện Dụng",49000,49000,0,0
TIKI,tui-vi-nu,136940089,"Bóp thổ cẩm đựng tiền (cb)",12000,12000,0,0
TIKI,tui-vi-nu,187156659,"Túi đeo chéo NASI T1037 phong cách hàn quốc túi xách nữ đeo vai thời trang dạo phố dễ thương vải đẹp",59000,59000,0,0
TIKI,tui-vi-nu,147832125,"Túi xách nữ công sở đeo vai kiểu dáng đơn giản, thanh lịch phong cách Hàn Quốc",199000,199000,0,0
TIKI,tui-vi-nu,55456785,"VÍ NỮ MINI GẬP GỌN SIÊU XINH V07",125000,250000,125000,50
TIKI,tui-vi-nu,160315096,"Ví Nữ Ngắn Mini Cầm Tay Chính Hãng TAILIAN Gấp 2 Nhỏ Gọn Da Cao Cấp Cực Đẹp Giá Rẻ TL09 - Micocah Mall",99000,99000,0,0
TIKI,tui-vi-nu,184914089,"Túi xách nữ thời trang công sở cao cấp phong cách mới – TN1007",280000,560000,280000,50
TIKI,tui-vi-nu,53026962,"Túi đeo chéo bao tử da cao cấp loại 1 dạo phố  SK 25 Shalla",94333,136259,41926,31
TIKI,tui-vi-nu,195279709,"Túi Giỏ Xách Đan Tay Xéo Lớn Quai Gỗ Vintage Hàng Xuất Khẩu Đi Chơi Đi Biển Chụp Hình Quà Tặng",179000,179000,0,0
TIKI,tui-vi-nu,149184236,"TÚI CÓI SIZE TO IN HÌNH NỮ HOÀNG TNX 502",55765,58700,2935,5
TIKI,tui-vi-nu,170125120,"MLB - Túi bao tử thời trang Monogram 3AHSM012N",2590000,2590000,0,0
TIKI,tui-vi-nu,81363674,"Túi đeo chéo nữ thời trang cao cấp Hàn Quốc TN120",99000,99000,0,0
TIKI,tui-vi-nu,19729892,"Túi đeo chéo vải bố nam TX0003",327600,455000,127400,28
TIKI,tui-vi-nu,113499862,"Túi Cói Merci Đi Biển Cao Cấp Có Lớp Lót Và Đế",65980,65980,0,0
TIKI,tui-vi-nu,173989729,"Phụ kiện túi vải Yuumy cỡ lớn YBVLL",20000,20000,0,0
TIKI,tui-vi-nu,157479001,"Túi Ví Nữ Đeo Chéo Nhiều Ngăn Với Ngăn Đựng Điện Thoại Trong Suốt Túi Để Chơi Tết - N8621",197000,249000,52000,21
TIKI,tui-vi-nu,158597094,"VÍ NỮ CẦM TAY NHỎ GỌN RẤT NHIỀU NGĂN TIỆN DỤNG KIỂU DÁNG SÀNH ĐIỆU NEW-0037 CHẤT LIỆU DA BỀN ĐẸP",32999,32999,0,0
TIKI,tui-vi-nu,37938772,"Cặp Xách Da Công Sở P073",289000,395000,106000,27
TIKI,tui-vi-nu,177736657,"Ví dài nữ cầm tay chính hãng TOMICMIC đựng tiền nhiều ngăn phong cách Hàn Quốc da cao cấp TL39",139000,139000,0,0
TIKI,tui-vi-nu,38050388,"Túi Đeo Chéo Phản Quang Phát Sáng Thời Trang Hàn Quốc FALDO",219000,219000,0,0
TIKI,tui-vi-nu,47215591,"Túi xách nữ cao cấp da thật ELLY – ET87",2999000,2999000,0,0
TIKI,tui-vi-nu,196552250,"Túi vải dây rút thời trang iBasic TUIVAI002",69000,69000,0,0
TIKI,tui-vi-nu,195279744,"Túi Giỏ Xách Đan Tay Quai Gỗ Vintage Hàng Xuất Khẩu Thủ Công Đi Chơi Đi Biển Chụp Hình Làm Quà Tặng GX02",145000,145000,0,0
TIKI,tui-vi-nu,74887030,"Ví Cầm Tay Unisex Thời Trang LATA VN44 Nhiều Màu (Dài 22cmxRộng 3cmxCao 12cm)",420000,420000,0,0
TIKI,tui-vi-nu,12482159,"Túi xách nữ thời trang cao cấp ELLY EL129",1499000,1499000,0,0
TIKI,tui-vi-nu,73286081,"Túi vải Tote đeo vai nữ - phong cách Hàn Quốc dễ thương",40000,40000,0,0
TIKI,tui-vi-nu,88826253,"TÚI ĐEO CHÉO NỮ MINI ĐÁNG YÊU FALDO PHONG CÁCH HÀN QUỐC",69000,69000,0,0
TIKI,tui-vi-nu,193978950,"Túi Xách Nhựa Trong Suốt In Hình Chuột Dễ Thương Dành Cho Nữ - JL",79000,79000,0,0
TIKI,tui-vi-nu,170463614,"Túi Xách Nữ Đẹp Đeo Chéo Thời Trang BEE GEE TN1002",230000,460000,230000,50
TIKI,tui-vi-nu,48583096,"Túi Tote Vải Đeo Chéo, Túi Đeo Vai Hàn Quốc Hình PIGGY Siêu Đáng Yêu, Túi Xách Nữ Đeo Nhiều Kiểu Đi Học, Đi Chơi Tiện Dụng - OTV135 - Ope Store",82000,82000,0,0
TIKI,tui-vi-nu,173682708,"Vỏ Bọc Hộ Chiếu (Passport) Trong Suốt Có Khe Kẹp Vé Thẻ ATM Bền Bỉ Tiện Dụng",2999,2999,0,0
TIKI,tui-vi-nu,75315857,"Ví thời trang tiện ích HARAS HR274",65000,65000,0,0
TIKI,tui-vi-nu,164961811,"Túi đeo chéo, đeo vai nữ mini da cao cấp T0131 Basic chống thấm nước, bền bỉ phong cách thời trang Hàn",180000,360000,180000,50
TIKI,tui-vi-nu,58988607,"Ví Da Thật 100% Đựng Thẻ, Name Card Tiện Dụng - Hàng Chính Hãng",54000,54000,0,0
TIKI,tui-vi-nu,134754462,"Túi tote đeo vai vải bố canvas trơn T014 nữ logo hình lá đựng đồ đi học, đi chơi mềm đẹp",48000,96000,48000,50
TIKI,tui-vi-nu,56323008,"TÚI ĐEO CHÉO NỮ CÔNG SỞ THỜI TRANG MADT113",69000,69000,0,0
TIKI,tui-vi-nu,152015309,"Túi Tote Túi Vải Trơn Chất Canvas Dày Dặn",155000,155000,0,0
TIKI,tui-vi-nu,151898395,"Túi Tote Vải Canvas Nữ Ulzzang Hot Trend Kita Unisex - Mẫu Smilei - Ảnh thật",38900,38900,0,0
TIKI,tui-vi-nu,68109855,"Ví nữ cầm tay nhiều ngăn tiện dụng, họa tiết hình chiếc lá sang trọng TK0058",59000,100000,41000,41
TIKI,tui-vi-nu,193201445,"Túi Đeo Vai, Túi Đeo Chéo Da PU, Túi Đeo Hông Cao Cấp Nhiều Ngăn Tiện Lợi Thời Trang Nam Phong Cách Hàn Quốc",95000,95000,0,0
TIKI,tui-vi-nu,157551295,"Bóp ví nữ cầm tay mini V038 trơn nhiều ngăn nhỏ gọn phong cách đơn giản, thời trang, dễ thương",45000,90000,45000,50
TIKI,tui-vi-nu,43694794,"Túi xách nữ thời trang cao cấp Đồ Da Thành Long TLG 208218",213000,213000,0,0
TIKI,tui-vi-nu,24988605,"Ví cầm tay nữ cao cấp",262000,262000,0,0
TIKI,tui-vi-nu,186120429,"Túi Đeo Chéo Mini Cho Nữ Dễ Thương Phong Cách Nhật Bản, Túi Xách Nữ Cute Nhiều Màu Sắc",55000,55000,0,0
TIKI,tui-vi-nu,100479434,"Túi Xách Nữ Đeo Chéo 2 dây đeo vai tiện lợi Dáng Túi Công Sở Da Mềm 2 Qoai Thay Đổi - SIÊU HOT 2021",99000,99000,0,0
TIKI,tui-vi-nu,137154462,"Túi Vải Đeo Chéo Canvas In Hình Just Be YourSelf Phong Cách Ulzzang",59000,59000,0,0
TIKI,tui-vi-nu,160314787,"Túi xách kẹp nách nữ đeo chéo đeo vai chính hãng MICOCAH dáng công sở thời trang da cao cấp cực đẹp giá rẻ MC08",399000,399000,0,0
TIKI,tui-vi-nu,174469089,"Ví Nữ Mini Cầm Tay Chính TAILIAN Gấp 2 Nhỏ Gọn Nhiều Ngăn Tiện Dụng Da Cao Cấp Cực Đẹp Giá Rẻ TL04",99000,99000,0,0
TIKI,tui-vi-nu,32977400,"Túi đựng điện thoại - túi đeo chéo mini bag hình chú mèo đáng yêu",41000,58179,17179,30
TIKI,tui-vi-nu,44078807,"Túi đeo chéo nữ đầm tròn quả cầu C40 Shalla",56000,79827,23827,30
TIKI,tui-vi-nu,174445621,"Ví Nữ Ngắn Mini Cầm Tay Chính hãng TAILIAN Thời Trang Đựng Tiền Da Mềm Cao Cấp Cực Đẹp Giá Rẻ TL36",109000,109000,0,0
TIKI,tui-vi-nu,157254213,"Túi Mini SAIGON SWAGGER SGS Mini Bag",200000,200000,0,0
TIKI,tui-vi-nu,161386286,"Ví Nữ Cầm Tay Thời Trang JUNO Da Trơn Khóa Trang Trí VI168",544000,544000,0,0
TIKI,tui-vi-nu,148850144,"Túi đeo chéo, đeo hông nam Arctic Hunter YB00046 chất liệu Oxford chống thấm nước, thiết kế nhiều ngăn tiện dụng Túi đeo chéo, đeo hông nam Arctic Hunter YB00046 chất liệu Oxford chống thấm nước, thiết kế nhiều ngăn tiện dụng",499000,850000,351000,41
TIKI,tui-vi-nu,126882301,"Vỏ bọc thẻ ATM, CCCD, CMND (5 cái)",6998,6998,0,0
TIKI,tui-vi-nu,48102759,"Túi tote , túi đeo chéo, túi đeo vai thời trang nữ túi hộp sweet YNTT08",115000,115000,0,0
TIKI,tui-vi-nu,79228194,"Dây Túi đeo chéo da pu, dây đeo vai có thể điều chỉnh  có thể điều chỉnh",100000,100000,0,0
TIKI,tui-vi-nu,187746443,"Túi xách nữ dễ thương NASI T1041 túi cói cầm tay đẹp có dây kéo thời trang cho nữ công sở, học sinh",29000,29000,0,0
TIKI,tui-vi-nu,173167109,"Túi vải bố, Túi vải Canvas trơn Màu Be Size 36cm x 31cm",29000,29000,0,0
TIKI,tui-vi-nu,115660965,"Túi Cói Dễ Thương Xách Tay Hai Màu Quai Đen, Trắng",48900,48900,0,0
TIKI,tui-vi-nu,192064368,"Ví dài nữ cầm tay thời trang PERFECT FOR YOU đựng tiền điện thoại da xước cao cấp cực đẹp giá rẻ PFY31 - Tukado",169000,169000,0,0
TIKI,tui-vi-nu,181673752,"Túi sách tay có quai sách cối, đi biển, đi làm, đi chơi",95000,95000,0,0
TIKI,tui-vi-nu,36398423," Túi bao tử, đeo bụng da cao cấp cực chất G705",55000,55000,0,0
TIKI,tui-vi-nu,118029771,"Túi Đi Chùa Thêu Thư Pháp # Túi Nam Nữ # Bị # Túi Đi Chùa",54000,54000,0,0
TIKI,tui-vi-nu,131139676,"Túi xách nữ thiết kế nhỏ gọn phối dây xích thời trang hàn quốc cao cấp cho nữ SIÊU HOT",99000,99000,0,0
TIKI,tui-vi-nu,115440606,"Ví Nữ Dài Cầm Tay,BÓP VÍ CLUTCH,BÓP VÍ,BÓP VÍ NAM NỮ,BÓP VÍ ĐẸP,BÓP VÍ CẦM TAY,BÓP VÍ NAM ĐẸP,BÓP VÍ HOT,BÓP VÍ RẺ",178000,178000,0,0
TIKI,tui-vi-nu,108253560,"Túi Đeo Chéo Da Mềm Nhiều Ngăn Điểm Sợi Tết",145000,145000,0,0
TIKI,tui-vi-nu,85564320,"Túi đeo vai nữ thời trang cao cấp khóa cài phong cách Âu Mỹ siêu cấp Vip Pro 2021 VTX025",160000,160000,0,0
TIKI,tui-vi-nu,129382325,"Túi Đeo Chéo Pop It Nhiều Màu (Giao màu ngẫu nhiên)",44600,44600,0,0
TIKI,tui-vi-nu,56438178,"Túi Vải Tote Cao Cấp, Dày Dặn Chất Liệu Canvas Hình Mèo, Dễ Phối Đồ",50000,50000,0,0
TIKI,tui-vi-nu,191469031,"Ví điện thoại cầm tay nữ da bò Ý có ngăn đựng điện thoại",970000,970000,0,0
TIKI,tui-vi-nu,146948864,"Túi vải canvas nữ đẹp đi chơi giá rẻ phong cách Hàn Quốc STIC TV10",79000,79000,0,0
TIKI,tui-vi-nu,69470436,"Túi Đeo Chéo Nữ Đi Học, Đi Chơi, Túi Vải Canvas Cho Học Sinh, Sinh Viên, Túi Vải Đeo Chéo Thời Trang Hàn Quốc - OTV035 - Ope Store",160000,160000,0,0
TIKI,tui-vi-nu,186235915,"Túi đeo chéo unisex Lfc Liverpool Fc - A15706",354000,590000,236000,40
TIKI,tui-vi-nu,181102322,"Túi xách nữ MONOGRAM CANVAS ELLY – EL200",1499000,1499000,0,0
TIKI,tui-vi-nu,118403624,"Túi Cói Đi BiểnTúi Cói Merci SIÊU HÓT HÍT 2021(video tự quay, hàng chất lừ) Đi Biển, Đi Chơi, Đi Du Lịch, đi làm, đi học",77000,77000,0,0
TIKI,tui-vi-nu,74760101,"Túi đeo chéo nam vải oxford chống nước phong cách classic TDC002 ",194400,270000,75600,28
TIKI,tui-vi-nu,157075185,"Túi Xách Cầm Tay Cặp Da Nam Công Sở GENCE CTS11 Da Bò Khóa Số Cao Cấp Màu Nâu Đậm",3200000,3200000,0,0
TIKI,tui-vi-nu,196760059,"Dây Đeo Chéo Túi Xách MICOCAH Chất Liệu Hợp Kim Sang Trọng Bền Bỉ MC149 - Micocah Mall",69000,69000,0,0
TIKI,tui-vi-nu,21050203,"Túi đeo chéo, túi đeo vai nữ vải canvas TV11",50000,50000,0,0
TIKI,tui-vi-nu,157254387,"Túi Bao Tử Da Cao Cấp SAIGON SWAGGER SGS Anthem Leather Bumbag",550000,550000,0,0
TIKI,tui-vi-nu,93937065,"Ví Đựng Thẻ Da Thật Cao Cấp Saffiano Aaa Jeans",299000,299000,0,0
TIKI,tui-vi-nu,44580696,"Túi xách tay đeo vai nữ Hàn Quốc size lớn size 32x29x12cm",125000,125000,0,0
TIKI,tui-vi-nu,242946979,"Ví Cầm Tay Nữ - 8 ngăn, 2 khóa tiện lợi - Cao Cấp Sang Trọng Phong Cách Hàn Quốc",75000,75000,0,0
TIKI,tui-vi-nu,158126738,"Túi xách nữ/Túi đeo chéo đeo vai nữ thời trang cao cấp thiết kế kẻ trung cá tính_ Mã MK198",99000,99000,0,0
TIKI,tui-vi-nu,201182542,"Túi cói form to tha hồ đựng đồ, tha hồ sống ảo luôn nè",250000,250000,0,0
TIKI,tui-vi-nu,173649871,"Túi Cói Đi Du Lịch Merci Sang Chảnh,Túi Cói Đi Biển Siêu Hot",59888,59888,0,0
TIKI,tui-vi-nu,157548783,"Bóp ví nữ cầm tay mini V0204 da cao cấp nhiều ngăn nhỏ gọn phong cách đơn giản, thời trang, dễ thương",35000,70000,35000,50
TIKI,tui-vi-nu,146636285,"Túi Tote Canvas in hình Cún LiVing NeSa Shop, túi đeo chéo nữ, chất liệu vải canvas, phong cách trẻ trung",41900,41900,0,0
TIKI,tui-vi-nu,174468852,"Ví Nữ Mini Cầm Tay    Gấp 3 Nhỏ Gọn Nhiều Ngăn Tiện Dụng Da Cực Đẹp PFY11",129000,129000,0,0
TIKI,tui-vi-nu,99293451,"Ví nữ dài cầm tay 2 ngăn kéo sang trọng nhiều ngăn tiện dụng TK0044",76000,100000,24000,24
TIKI,tui-vi-nu,108254582,"Túi Thỏ Đeo Chéo Kiêm Balo Được Yêu Thích Nhất",85000,85000,0,0
TIKI,tui-vi-nu,86561667,"Túi vải   Túi Đeo Chéo Canvas Cỡ Lớn Unisex Thời Trang Hàn Quốc Học Sinh Sinh Viên TV19",27900,27900,0,0
TIKI,tui-vi-nu,116369289,"Quai túi xách gỗ làm túi Macrame",35200,35200,0,0
TIKI,tui-vi-nu,51281307,"[Kèm ảnh thật]Túi đeo chéo khoá chữ B da vân rắn thời trang-túi đeo chéo nữ, túi xách nữ, túi đeo chéo thời trang-da pu vân rắn cực đẹp,móc khoá chữ B cách điệu, có quai xách  - đỏ",99000,99000,0,0
TIKI,tui-vi-nu,199554068,"Túi Vải Canvas Ông Bầu ",63000,63000,0,0
TIKI,tui-vi-nu,2009411,"Túi Vải Tote Đeo Chéo Đeo Vai Đen XinhStore",50000,50000,0,0
TIKI,tui-vi-nu,195329997,"Túi xách du lịch gấp gọn 2 tầng size đại nới đáy chất vải dù chống nước tiện lợi bền đẹp quai đeo chắc chắn đa năng - NGẨU NHIÊN",125000,125000,0,0
TIKI,tui-vi-nu,103459863,"Ví We Bare Bears",88000,88000,0,0
TIKI,tui-vi-nu,136759598,"Túi tote nữ, túi vải cá tính đừng vừa A4 - DAI MENG",56900,56900,0,0
TIKI,tui-vi-nu,251274972,"Túi cói nơ ren trắng đeo vai xinh xỉu",135000,135000,0,0
TIKI,tui-vi-nu,252090516,"Túi Xách Nữ Đeo Chéo Da PU Siêu Sang, Túi Xách Nữ Thời Trang Form Cứng, Túi Đeo Chéo Nữ Hàn Quốc, Túi Xách Tay Có Kèm Dây Đeo Chéo - OTV229 - Ope Store",335000,335000,0,0
TIKI,tui-vi-nu,183336599,"Vỏ Bọc Passport, Hộ Chiếu Chống Thấm Nước G381-BOCPP",2999,2999,0,0
TIKI,tui-vi-nu,143487928,"TÚI ĐEO CHÉO POP IT BONG BÓNG GIẢI TRÍ HỖ TRỢ GIẢM CĂNG THẲNG NHIỀU MẪU ( GIAO MÀU NGẪU NHIÊN )",77000,77000,0,0
TIKI,tui-vi-nu,177557630,"Túi xách nữ da thật cao cấp 8225 TU",118000,910880,792880,87
TIKI,tui-vi-nu,68891749,"Ví dài cầm tay thời trang nữ YUUMY YV28 nhiều màu",89000,180000,91000,51
TIKI,tui-vi-nu,149241417,"Túi Hộp Đeo Chéo Đính Ong TBL15",198000,198000,0,0
TIKI,tui-vi-nu,105618769,"Túi đeo chéo đeo ngực nam cao cấp phong cách mới",603000,670000,67000,10
TIKI,tui-vi-nu,5003163,"Túi Xách Nữ Thời Trang Cao Cấp Elly EL21",979300,1399000,419700,30
TIKI,tui-vi-nu,48089749,"Bóp ví cầm tay nữ Da  bò đẹp cao cấp ",229000,429000,200000,47
TIKI,tui-vi-nu,177727143,"Ví nữ gấp nhiều ngăn da bò thật vân hạt",650000,650000,0,0
TIKI,tui-vi-nu,97313622," Túi da đeo chéo MSTALLY đón trend 2021",44344,46678,2334,5
TIKI,tui-vi-nu,178783614,"Túi xách nữ công sở chất da pu đeo vai size lớn đi làm  thời trang hàn quốc cao cấp TX04",129000,129000,0,0
TIKI,tui-vi-nu,219461707,"Túi xách nữ màu đỏ đô da mềm",85000,85000,0,0
TIKI,tui-vi-nu,132078385,"Túi Đeo Chéo T19 Mẫu Mới Khóa Trái Tim- Vàng Nhạt",145000,198000,53000,27
TIKI,tui-vi-nu,32023338,"Túi Vải Đeo Vai Tote Bag 2 Thời Trang",45000,45000,0,0
TIKI,tui-vi-nu,133781795,"Túi đeo chéo ngang một bên vai. Túi đeo chéo nữ Forever Young Tua Rua Khuy Vuông, đựng điện thoại, tiền., nhỏ gọn, tiện dụng. Phong cách thời trang Hàn Quốc, sang chảnh, cá tính",149000,149000,0,0
TIKI,tui-vi-nu,103660156,"Túi xách nữ thời trang cao cấp phong cách châu âu",351000,390000,39000,10
TIKI,tui-vi-nu,102809986,"Ví nữ cầm tay thời trang YUUMY YV22",169000,330000,161000,49
TIKI,tui-vi-nu,141788350,"Túi Xách Nữ Đeo Chéo Quai Xách Cao Cấp NUTUSHOP - NT39",199000,199000,0,0
TIKI,tui-vi-nu,145593359,"Ví da cầm tay nhỏ gọn YUUMY Seasand YV42",69000,150000,81000,54
TIKI,tui-vi-nu,134666856,"Túi đeo chéo da nữ khóa nhấn Yuumy Seasand YN99",299000,550000,251000,46
TIKI,tui-vi-nu,192881403,"Ví nữ cầm tay dáng đứng YUUMY Ripple YV75 - ngẫu nhiên",85000,190000,105000,55
TIKI,tui-vi-nu,40750699,"Túi xách nữ công sở A4 phong cách Châu Âu",199000,199000,0,0
TIKI,tui-vi-nu,191287987,"Ví nữ cầm tay dáng đứng YUUMY Ripple YV75",85000,190000,105000,55
TIKI,tui-vi-nu,47992489,"Túi bao tử đeo hông nhiều ngăn TROY MS1",139000,139000,0,0
TIKI,tui-vi-nu,48506730,"Túi xách tay nữ thời trang đa năng LATA TX08 Nhiều màu",690000,690000,0,0
TIKI,tui-vi-nu,106948689,"Túi xách  túi đeo vai nữ thời trang cao cấp phong cách mới",315000,350000,35000,10
TIKI,tui-vi-nu,48136526,"Ví nữ cầm tay dáng dài since 1988 chất da mịn",49000,49000,0,0
TIKI,tui-vi-nu,214588850,"Túi da nữ Louis Fontaine Eze màu đen size L",4600000,4600000,0,0
TIKI,tui-vi-nu,191309750,"Marhen.J - Túi xách nữ phom chữ nhật Rhonda Mini MJ21BRNDMN-OG",3590000,3590000,0,0
TIKI,tui-vi-nu,149449416,"Túi xách đeo chéo mới CeeKay (Fullbox) - Túi xách nữ hàng cao cấp chính hãng",450000,450000,0,0
TIKI,tui-vi-nu,102810102," Ví nữ cầm tay thời trang YUUMY YV12 nhiều màu",49000,80000,31000,39
TIKI,tui-vi-nu,17003410,"Túi Xách Nữ Thời Trang Cao Cấp EL95 đỏ",719400,1199000,479600,40
TIKI,tui-vi-nu,160315073,"Ví Nữ Dài Cầm Tay FOREVER YOUNG Đựng Tiền Phong Cách Hàn Quốc Siêu Đẹp VD07 - Micocah Mall",119000,119000,0,0
TIKI,tui-vi-nu,95394051," Túi Xách Nữ Thời Trang Đeo Chéo Chất Da Xịn Lên Dáng Chuẩn Form Xinh Lắm Lắm Luôn",68000,68000,0,0
TIKI,tui-vi-nu,86561430,"Ví bóp nữ    Ví nữ cao cấp cầm tay mini thời trang nhỏ gọn nhiều ngăn đẹp giá rẻ Micloset - V05311",16000,16000,0,0
TIKI,tui-vi-nu,109479028,"Túi đeo chéo nam cao cấp phong cách mới",359000,398000,39000,10
TIKI,tui-vi-nu,83471905,"Ví cầm tay nữ Yuumy YV32",165000,320000,155000,48
TIKI,tui-vi-nu,191297058,"Ví cầm tay nữ gấp 3 da bò thật Jeny",650000,650000,0,0
TIKI,tui-vi-nu,186128722,"Túi Đeo Chéo Vải Cavas Siêu Dễ Thương Cho Nữ Đựng Đồ Đi Chơi Dạo Phố, Túi Xách Nữ Thời Trang Nhật Bản",55000,55000,0,0
TIKI,tui-vi-nu,9803160,"Túi đeo chéo TROY YM01",150000,150000,0,0
TIKI,tui-vi-nu,35573460,"Túi đeo chéo nam nữ - túi bao tử thời trang BEE GEE 028 ( Trơn ) vải dù",40000,80000,40000,50
TIKI,tui-vi-nu,46166280,"Túi xách nữ thời trang kiểu dáng công sở Châu Âu",189000,189000,0,0
TIKI,tui-vi-nu,48461717,"Ví nữ dáng dài cầm tay Since kiểu dáng Hàn Quốc",48000,48000,0,0
TIKI,tui-vi-nu,163719940,"Túi Xách Nữ Đeo Chéo Đeo Vai Kẹp Nách Crescent-Moon Hobo GIPSY",690000,690000,0,0
TIKI,tui-vi-nu,116594664,"Túi Xách Nữ -Túi vải CANVAS đeo chéo nữ dây YXY TOLIVE TV02",40000,40000,0,0
TIKI,tui-vi-nu,82485562,"VÍ NÚT BẤM ĐỰNG THẺ ATM, CARD VISIT (24 NGĂN)",15000,15000,0,0
TIKI,tui-vi-nu,93291134,"Marhen.J - Túi đeo vai chữ nhật Ludy MJ20DLUDYB-PK",3890000,3890000,0,0
TIKI,tui-vi-nu,187843426,"Túi xách nữ dễ thương NASI T1044 vải cói pu cầm tay đẹp túi tote đeo vai có dây kéo thời trang cho nữ công sở, học sinh",69000,69000,0,0
TIKI,tui-vi-nu,136940214,"Túi đựng điện thoại thêu 3 cô gái Việt Nam",25000,25000,0,0
TIKI,tui-vi-nu,131337770,"Túi vải bố, Túi vải Canvas trơn màu kem không khóa kéo",19000,19000,0,0
TIKI,tui-vi-nu,5003395,"Túi Xách Nữ Cao Cấp Da Thật Elly ET37",2499000,2499000,0,0
TIKI,tui-vi-nu,36827817,"Ví Nữ Mini Ngắn Cầm Tay Cao Cấp Sang Trọng Phong Cách Hàn Quốc, Nhiều Ngăn Tiện Lợi V07",125000,250000,125000,50
TIKI,tui-vi-nu,74854470,"Túi xách nam da thật cao cấp phong cách mới",441000,490000,49000,10
TIKI,tui-vi-nu,77649350,"Túi đeo mini unisex cá tính Fimax cho nam nữ, túi đeo chéo nhỏ gọn với kích thước 17x15x5cm làm từ vải chống nước dùng đựng điện thoại và phụ kiện cá nhân khi đi chơi dự tiệc",199000,199000,0,0
TIKI,tui-vi-nu,145555826,"Túi xách nữ thời trang LATA TX09",490000,490000,0,0
TIKI,tui-vi-nu,196675540,"Túi Cói, Túi Xách Cỏ Bàng Vẽ Hoa Hướng Dương Cao Cấp Chuẩn Đẹp-Giỏ Xách Cỏ Bàng Mỹ Nghệ TXCBVHHDLTK15",339000,339000,0,0
TIKI,tui-vi-nu,160314958,"Ví Nữ Dài Cầm Tay Chính Hãng FOREVER YOUNG Đựng Tiền Đựng Thẻ Da Mềm Khóa Đồng Xu Siêu Đẹp FY01 - Micocah Mall",119000,119000,0,0
TIKI,tui-vi-nu,174468730,"Ví Nữ Dài Cầm Tay PERFECT FOR YOU Chất Da Cao Cấp Cực Đẹp Nhiều Ngăn Tiện Dụng PFY02",129000,129000,0,0
TIKI,tui-vi-nu,173986171,"Phụ kiện túi vải Yuumy cỡ lớn YBVLL",20000,20000,0,0
TIKI,tui-vi-nu,42134677,"TÚI ĐEO NỮ NHỎ XINH NHIỀU MÀU - H0011",49000,75000,26000,35
TIKI,tui-vi-nu,69192511,"Túi Xách Nữ Đeo Vai 2 Dây Đeo Size To Nhiều Ngăn Tiện Dụng Chất Da Đẹp SK912",55000,55000,0,0
TIKI,tui-vi-nu,81736110,"Ví da đựng thẻ ATM 24 ngăn – Bóp da 24 ngăn đựng giấy tờ nữ ( đọc kỹ hdsd) F329SP1",15000,15000,0,0
TIKI,tui-vi-nu,252597316,"[Da thật] Ví mini nam nữ da bò thật MN114ALS (Đen/Nâu/Xanh Navy) - 100% da bò thật, BH 3 năm",149000,149000,0,0
TIKI,tui-vi-nu,191309685,"Marhen.J - Túi đeo vai nữ chữ nhật Milly Nano MJ21AMLYNA-KH",2890000,2890000,0,0
TIKI,tui-vi-nu,119410137,"Túi đeo chéo nữ trong suốt thời trang dạo phố XX25 Tặng bút cảm ứng ĐT",66000,91530,25530,28
TIKI,tui-vi-nu,200016854,"Túi Cói Xinh Xắn Nữ Tính Đi Biển Đi Chơi Hình Dáng Vỏ Ốc Cách Điệu Độc Đáo Thủ Công Thân Thiện Môi Trường",320000,320000,0,0
TIKI,tui-vi-nu,67087965,"Túi xách nữ GGTT -67",129000,129000,0,0
TIKI,tui-vi-nu,95063187," Túi đeo chéo nữ vải canvas nút bấm hình com bướm đựng vừa a4 - 2 màu",89900,89900,0,0
TIKI,tui-vi-nu,193007974,"Túi đựng tiền, túi thời trang phong cách Châu Âu mã 6077",219000,399000,180000,45
TIKI,tui-vi-nu,52539642,"Túi xách nữ đeo chéo vân cá sấu",99000,99000,0,0
TIKI,tui-vi-nu,131338262,"Túi vải bố, Túi vải Canvas trơn Màu Trắng",29000,29000,0,0
TIKI,tui-vi-nu,161864224,"Túi xách nữ công sở đeo chéo hoạ tiết kẻ sọc sang trọng",75000,75000,0,0
TIKI,tui-vi-nu,73260559,"Ví tay Nữ mini sang trọng siêu năng kẹp nút Bi Tròn LL4 Tặng móc khóa cá heo",114000,161007,47007,29
TIKI,tui-vi-nu,248991514,"XI MÚT ĐÁNH BÓNG GOLDCARE",70000,70000,0,0
TIKI,tui-vi-nu,139468542,"Túi xách đeo vai túi xách tay công sở size lớn chất đẹp NK14",96000,96000,0,0
TIKI,tui-vi-nu,146223397,"Túi đeo chéo nam Da bò thật Bụi Leather DC106 - Nhiều ngăn tiện dụng, Unisex - Bảo hành 12 tháng",469000,530000,61000,12
TIKI,tui-vi-nu,184223381,"Túi xách túi đeo vai nữ vải canvas thời trang cao cấp phong cách mới",333000,370000,37000,10
TIKI,tui-vi-nu,98151817,"Túi đeo chéo, túi xách nữ công sở nữ họa tiết phong cách Hàn Quốc TN200",132000,132000,0,0
TIKI,tui-vi-nu,248991490,"XI SÁP GOLDCARE - GC5003",55000,55000,0,0
TIKI,tui-vi-nu,102143682,"Túi đeo chéo/ Túi xách nữ thời trang phong cách Hàn Quốc",119000,219000,100000,46
TIKI,tui-vi-nu,185964455,"Túi xách nữ vải canvas thời trang cao cấp phong cách cá tính mới",315000,350000,35000,10
TIKI,tui-vi-nu,117294385,"Túi cói size lớn đi Tết đi chơi phối dây thổ cẩm 3 màu cực sang (hàng có sẵn)",93000,93000,0,0
TIKI,tui-vi-nu,86561593,"Túi đeo chéo nữ    Túi xách nữ mini phối màu Fashion & Bag TD13",48000,48000,0,0
TIKI,tui-vi-nu,72863522,"Túi vải tote nữ Canvas trơn trắng Gady",34000,34000,0,0
TIKI,tui-vi-nu,194461788,"Ví nhỏ cầm tay nữ da thật 9x17 VN111",247000,247000,0,0
TIKI,tui-vi-nu,56093264,"Túi Xách Nữ Đeo Chéo Mẫu Mới Nhất (Size 23)",75000,75000,0,0
TIKI,tui-vi-nu,113404169,"Túi Ngang Đeo Hông, Đeo Chéo Spost",48400,48400,0,0
TIKI,tui-vi-nu,262800445,"Túi Xách Nữ Thời Trang Cao Cấp Elly EL124",1399000,1399000,0,0
TIKI,tui-vi-nu,72025526,"Túi Xách Nữ V20",129000,129000,0,0
TIKI,tui-vi-nu,5003685,"Ví Nữ Cầm Tay Thời Trang Cao Cấp Elly EV49",799000,799000,0,0
TIKI,tui-vi-nu,177254516,"Túi xách nữ thời trang công sở cao cấp phong cách mới",351000,390000,39000,10
TIKI,tui-vi-nu,159787715,"Hộp Tre Xinh - Cơi Tre Bông Có Nắp 10 * 12cm",126000,242200,116200,48
TIKI,tui-vi-nu,172801348,"Ví da nữ cầm tay nắp gập YUUMY Seasand YV61",149000,330000,181000,55
TIKI,tui-vi-nu,193186934,"Ví Nữ Thời Trang cao cấp phong cách mới – VNU1001",200000,400000,200000,50
TIKI,tui-vi-nu,145978003,"Túi đeo chéo nam, túi xách tay da bò thật Bụi Leather DC104 - Da bò Mill cao cấp, Unisex - Bảo Hành 12 tháng",525000,850000,325000,38
TIKI,tui-vi-nu,89261198,"Túi đeo chéo mini nữ Fimax FTDCMINI vải Oxford chống nước, túi nhỏ đeo chéo giá rẻ đựng điện phụ kiện đi dạo phố siêu cute  – BH 12 tháng",155000,155000,0,0
TIKI,tui-vi-nu,86134461,"Túi xách nữ da dù chống nước túi xách công sở túi đeo vai thời trang phong cách Hàn Quốc TN67",139000,139000,0,0
TIKI,tui-vi-nu,47965302,"Túi xách đựng A4, chất liệu vải bố, thấm nước, kết hợp dây đeo là dây thừng, không đau vai (Nhiều phiên bản để chọn)",79000,130000,51000,39
TIKI,tui-vi-nu,86561568,"Túi Xách Nữ /  50K - TÚI ĐEO CHÉO NỮ MINI HOA CÚC SIÊU XINH HOT TREND TV03",51000,51000,0,0
TIKI,tui-vi-nu,44580877,"Ví cầm tay nữ cao cấp 2 ngăn khóa BA04",196983,207350,10367,5
TIKI,tui-vi-nu,165760938,"Túi Xách Nữ Đeo Chéo Quai Lụa Cao Cấp NUTUSHOP - NT45",289000,289000,0,0
TIKI,tui-vi-nu,185079603,"Túi xách nữ Oscar - OCWHBSG 058",1890000,1890000,0,0
TIKI,tui-vi-nu,86560832,"Ví nữ    Ví cầm tay nữ mini cao cấp ngắn cute nhỏ gọn bỏ túi thời trang giá rẻ V091111",16900,16900,0,0
TIKI,tui-vi-nu,31885528,"Túi Xách Nữ 3 Ngăn 30x25x13cm DM267",299000,299000,0,0
TIKI,tui-vi-nu,108253891,"Túi Đeo Chéo Nữ Hình Sao Biển Dễ Thương Lông Mềm Mịn",55000,55000,0,0
TIKI,tui-vi-nu,108830940,"VÍ MINI ĐỰNG THẺ NỮ Bóp Nhỏ Gọn Cardholder LUCY Da Saffiano Nhập Khẩu Cao Cấp Chống Thấm Nước",180000,180000,0,0
TIKI,tui-vi-nu,154881116,"(Ảnh thật)Túi Cói Merci Loại 1 Màu Sáng, Có Đệm Đáy Giữ Form Túi, Có Lót, Túi Du Lịch",54900,54900,0,0
TIKI,tui-vi-nu,190170113,"Túi đeo chéo nữ thời trang công sở phong cách mới – DCNU1004",320000,640000,320000,50
TIKI,tui-vi-nu,155776132,"Túi đeo chéo nam nữ unisex phong cách ulzzang sợi polyesster cao cấp chống thấm nước Haoshuai S2",145000,145000,0,0
TIKI,tui-vi-nu,149400848,"TÚI VẢI NHUNG ĐEO VAI HÌNH GẤU XINH XẮN ĐI HỌC ĐI CHƠI TOTE CÓ TÚI CON DV10",75900,75900,0,0
TIKI,tui-vi-nu,160314806,"Túi Xách Nữ Đeo Chéo Chính Hãng FORERVER YOUNG Dáng Công Sở Thời Trang Da Sần Cao Cấp Nhiều Ngăn Tiện Dụng FY24",489000,489000,0,0
TIKI,tui-vi-nu,189953379,"Túi Xách _Túi Đeo Vai Nữ CNK Mini Khóa Gập Da Trần Siêu Xinh Size 18 cm",129000,129000,0,0
TIKI,tui-vi-nu,56993030,"Túi đeo chéo nữ Hàn Quốc cao cấp họa tiết kẻ caro",149000,149000,0,0
TIKI,tui-vi-nu,160058433,"Túi tote thời trang May 10",189000,189000,0,0
TIKI,tui-vi-nu,188940966,"Túi xách túi đeo vai nữ thời trang cao cấp phong cách mới",477000,530000,53000,10
TIKI,tui-vi-nu,178007821,"Túi Tote Xách Vải Bố Canvas Grepaco Thời Trang Nữ Đeo Vai Màu Đen Size To (Lớn) In Chữ Có Ngăn Phụ Bên Trong, Dành Cho Công Sở Đi Làm, Sinh Viên Đi Học, Chơi Du Lịch, Picnic, Gym, Shopping - Hàng Chính Hãng",79000,79000,0,0
TIKI,tui-vi-nu,97875867,"Ví đựng thẻ, đựng giấy tờ, thẻ ATM loại đẹp TK0087",15000,30000,15000,50
TIKI,tui-vi-nu,146945565,"Túi xách đeo chéo nữ đẹp đi chơi phong cách thời trang hàn quốc giá rẻ dễ thương cute DC257",60870,60870,0,0
TIKI,tui-vi-nu,82880369,"TÚI VÍ  NỮ DA PHONG CÁCH HÀN QUỐC ĐỂ ĐIỆN THOẠI – SIÊU XINH – NĂNG ĐỘNG VÀ TIỆN ÍCH",53000,53000,0,0
TIKI,tui-vi-nu,69470828,"Túi Xách Nữ Đẹp Đeo Chéo Kiểu Dáng Đơn Giản Basic, Túi Vải Canvas Đeo Chéo Kích Thước Lớn Tiện Dụng - OTV064 - Ope Store",144000,144000,0,0
TIKI,tui-vi-nu,4982335,"Túi Đeo Chéo Nữ Ulzzang Trong Suốt Kèm Ví Nhỏ",57420,82940,25520,31
TIKI,tui-vi-nu,90529784,"Túi xách nữ thời trang cao cấp",423000,470000,47000,10
TIKI,tui-vi-nu,7939593,"Túi đựng điện thoại đeo chéo nữ thời trang mini bag",76000,108104,32104,30
TIKI,tui-vi-nu,184954202,"[GDSG170][Chắc chắn] Ví cầm tay mini - Ví nữ cầm tay thời trang nhiều màu sắc - Fashion",44400,44400,0,0
TIKI,tui-vi-nu,185955256,"Túi xách nữ vải canvas thời trang cao cấp phong cách cá tính mới",288000,320000,32000,10
TIKI,tui-vi-nu,126512059,"Túi đeo chéo nữ LATA HN88",450000,450000,0,0
TIKI,tui-vi-nu,86560855,"Túi xách nữ    Túi Retro sang chảnh TD10",135000,135000,0,0
TIKI,tui-vi-nu,177187685,"Túi xách nữ thời trang công sở cao cấp phong cách mới",441000,490000,49000,10
TIKI,tui-vi-nu,117579068,"Túi xách đeo chéo nữ đẹp-CD08",68000,68000,0,0
TIKI,tui-vi-nu,87100259,"Balo thời trang, balo đi học, đựng laptop Túi Tote Mèo Mắt Long Lanh Mèo Cute balo nữ vải",68100,68100,0,0
TIKI,tui-vi-nu,191775236,"Túi Xách Nữ Kẹp Nách Chính Hãng MICOCAH Dáng Công Sở Thời Trang Chất Da Lộn Cao Cấp Phối Màu Vintage Sang Trọng MC141 - Micocah",449000,449000,0,0
TIKI,tui-vi-nu,186860436,"Ví Đựng Hộ Chiếu Passport Nam Nữ Cao Cấp, Da Bò PULL-UP Mềm Mại, Thiết Kế Hiện Đại - Đa Năng, Đựng Được Nhiều Loại Hộ Chiếu, Nhiều Ngăn Thẻ ATM, Đựng Tiền, Vé Máy Bay, Tiện Dụng Khi Đi Du Lịch, Công Tác - Hàng Chính Hãng SAIGIO",1181000,1199000,18000,2
TIKI,tui-vi-nu,125757916,"Túi xách nữ kẹp nách khoá vuông phối vải kẻ sọc️freeship️",55000,55000,0,0
TIKI,tui-vi-nu,53026947,"Túi đeo chéo bụng bao tử da loại 1 thời trang dạo phố  SKT20 Shalla",94333,136259,41926,31
TIKI,tui-vi-nu,172374525,"Ví nữ mini nắp cách điệu YUUMY Seasand YV59",65000,150000,85000,57
TIKI,tui-vi-nu,167682901,"Túi đeo chéo nữ mini đựng điện thoại YUUMY YN120",145000,270000,125000,46
TIKI,tui-vi-nu,193568721,"Túi Xách Nữ Đeo Chéo Đeo Vai Cao Cấp NUTUSHOP - NT88",299000,299000,0,0
TIKI,tui-vi-nu,97707630,"Túi xách nữ thời trang công sở cao cấp phong cách mới",441000,490000,49000,10
TIKI,tui-vi-nu,44010126,"Túi dự tiệc cưới, túi cầm tay nữ nhỏ, hoa tiết nhỏ nhắn, sang trọng (Nhiều mẫu mã để chọn)",175000,250000,75000,30
TIKI,tui-vi-nu,144637552,"Túi xách , túi đeo vai nữ CG219 thời trang Hàn Quốc trẻ trung",129000,129000,0,0
TIKI,tui-vi-nu,191309776,"Marhen.J - Túi đeo vai nữ chữ nhật Milly Nano MJ21AMLYNA-BK",2890000,2890000,0,0
TIKI,tui-vi-nu,86560930," Túi đeo chéo nữ    Túi xách nữ mini dây xích SANG CHẢNH TD18",65000,65000,0,0
TIKI,tui-vi-nu,5003323,"Túi Xách Nữ Cao Cấp Da Thật Elly ET54",2499000,2499000,0,0
TIKI,tui-vi-nu,93291302,"Marhen.J - Túi đeo vai chữ nhật vải bố Rico Mini MJ19BRCOMN-WI",2290000,2290000,0,0
TIKI,tui-vi-nu,169600256,"Túi Xách Nam, Nữ, Túi Đeo Chéo Unisex Dành Cho Nam Nữ, Túi Vải Canvas Đeo Chéo Phong Cách Cá Tính - OTV120 - Ope Store",160000,160000,0,0
TIKI,tui-vi-nu,93291088,"Marhen.J - Túi đeo vai chữ nhật vải bố Rico Mini MJ19BRCOMN-BE",2290000,2290000,0,0
TIKI,tui-vi-nu,145221832,"Túi xách nữ công sở _Túi xách thời trang Châu Âu",165000,165000,0,0
TIKI,tui-vi-nu,177158869,"Túi xách nữ 2 trong 1 thời trang cao cấp",387000,430000,43000,10
TIKI,tui-vi-nu,145918249,"Túi đeo chéo nam da bò Mill cao cấp Bụi Leather DC103 - Nhiều ngăn, tiện lợi - Bảo hành 12 tháng",579000,971000,392000,40
TIKI,tui-vi-nu,160314545,"Túi Xách Nữ Đeo Chéo Chính Hãng MICOCAH Dáng Công Sở Thời Trang Chất Da Cao Cấp Cực Đẹp MC79 - Micocah Mall",429000,429000,0,0
TIKI,tui-vi-nu,67451622,"Túi đeo chéo nữ cúc họa mi nhỏ xinh TX38",60000,60000,0,0
TIKI,tui-vi-nu,89119829,"Túi đeo chéo đeo vai nữ cao cấp phong cách mới",269000,298000,29000,10
TIKI,tui-vi-nu,66483145,"Túi  xách tay nữ công sở bản to có dây đeo",65000,65000,0,0
TIKI,tui-vi-nu,190489681,"Túi Xách Nữ Da Thật, Túi Công Sở Cầm Tay Sang Trọng, Cao Cấp HADATI - Màu Xanh Dương, Size 25cm  -Túi xách nữ đeo chéo, túi xách da, khí chất thời trang mới, túi xách nữ, túi đeo vai nữ da phối màu hợp thời trang",869000,869000,0,0
TIKI,tui-vi-nu,185073370,"Túi xách nữ Oscar - OCWHBSG 055",2490000,2490000,0,0
TIKI,tui-vi-nu,42240080,"Túi đeo chéo đeo vai nữ đựng điện thoại dọc nắp Trơn ép chữ K9 Shalla",82000,116358,34358,30
TIKI,tui-vi-nu,263696207,"Túi da nữ đeo vai basic Lata HN108",590000,590000,0,0
TIKI,tui-vi-nu,47215277,"Túi xách nữ cao cấp da thật ELLY – ET82",1019400,1699000,679600,40
TIKI,tui-vi-nu,5003133,"Túi Xách Nữ Thời Trang Cao Cấp Elly EL65",899400,1499000,599600,40
TIKI,tui-vi-nu,189337493,"Túi đeo chéo nữ nam thời trang cao cấp chính hãng YVan C69",599000,599000,0,0
TIKI,tui-vi-nu,11720488,"Cặp đeo chéo TROY phối nắp khóa cài và dây kéo xéo",199000,199000,0,0
TIKI,tui-vi-nu,98978186,"Túi Xách Da PU Mềm 2 Màu Đen, Trắng Phong Cách Sang Chảnh",99000,99000,0,0
TIKI,tui-vi-nu,186639332,"Túi Xách Nữ Công Sở Chất Da Pu Đeo Vai Sze Lớn Đi Làm Thời Trang Hàn Quốc Cao Cấp KN09",89000,89000,0,0
TIKI,tui-vi-nu,87050052,"Túi xách nữ pha màu, túi xách công sở thời trang phong cách Hàn Quốc",259000,259000,0,0
TIKI,tui-vi-nu,46224953,"Túi xách nữ XN005",299000,299000,0,0
TIKI,tui-vi-nu,164961283,"Túi đeo chéo, đeo vai da cao cấp T0031 Basic chống thấm nước, bền bỉ unisex nam nữ phong cách thời trang Hàn",190000,380000,190000,50
TIKI,tui-vi-nu,72033614,"Túi xách nữ thời trang cao cấp ELLY – EL136",899000,899000,0,0
TIKI,tui-vi-nu,144570962,"Túi xách nữ/ Túi đeo chéo, túi đeo vai nữ da bò nguyên miếng siêu cao cấp, đơn giản và thời thượng",850000,850000,0,0
TIKI,tui-vi-nu,108635756,"Túi xách nam công sở 100% da bò thật cao cấp phong cách mới",702000,780000,78000,10
TIKI,tui-vi-nu,86562068,"Túi đeo chéo nữ    Túi xách nữ mini dây da pha xích Ulzzang siêu dễ thương TD14",59000,59000,0,0
TIKI,tui-vi-nu,160315233,"Túi Xách Nữ Kẹp Nách Chính Hãng MICOCAH Dáng Công Sở Thời Trang Nhiều Ngăn Tiện Dụng Chất Cực Đẹp MC21 - Micocah Mall",389000,389000,0,0
TIKI,tui-vi-nu,4941579,"Túi xách tay nữ size lớn 32x29x12cm",219000,219000,0,0
TIKI,tui-vi-nu,51637673,"Túi Xách Đeo Chéo Nữ Mini Đẹp Năng Động CF11",45360,56700,11340,20
TIKI,tui-vi-nu,169594412,"Combo Túi Xách Nữ Kèm Túi Nhỏ, Túi Vải Canvas Cỡ Lớn Đựng Nhiều Đồ, Túi Tote Đeo Vai Phong Cách Hàn Quốc Cỡ Lớn (Kèm Thêm Túi Nhỏ) - OTV115 - Ope Store",172000,172000,0,0
TIKI,tui-vi-nu,174293719,"Túi xách nam  nữ vải dù Oxford thời trang cao cấp giá rẻ đeo chéo đa năng nhiều ngăn chống thấm nước",167000,167000,0,0
TIKI,tui-vi-nu,112218056,"Túi đeo chéo nam đa năng cao cấp phong cách mới",269000,298000,29000,10
TIKI,tui-vi-nu,48655157,"Túi Đeo Chéo Nữ 2 Ngăn Đựng  Được Điện Thoại  Có Móc Gấu SK11810",75000,75000,0,0
TIKI,tui-vi-nu,137164986,"Khoen chữ D khoen túi phụ kiện túi (10 chiếc)",20000,20000,0,0
TIKI,tui-vi-nu,58702162,"Túi xách nữ",95000,95000,0,0
TIKI,tui-vi-nu,81608563,"Túi xách nữ đeo chéo pha màu kiểu dáng Hàn Quốc sang trọng, thanh lịch TN160",119000,119000,0,0
TIKI,tui-vi-nu,195971660,"Túi cách nữ cao cấp da thật ELLY – ET141",2799000,2799000,0,0
TIKI,tui-vi-nu,176652201,"Túi đeo chéo nữ thời trang YUUMY YN91 nhiều màu",315000,490000,175000,36
TIKI,tui-vi-nu,138543600,"Cặp da nam công sở TRITA TCA17",259000,440000,181000,41
TIKI,tui-vi-nu,137951969,"Túi Giỏ Xách Đan Tay Quai Gỗ Hàng Xuất Khẩu Thủ Công Sang Chảnh Đi Chơi Đi Biển Chụp Hình - Doni House",100000,100000,0,0
TIKI,tui-vi-nu,6352849,"Ví Da Nữ Nhỏ Gọn Bỏ Túi Nhiều Ngăn",320000,320000,0,0
TIKI,tui-vi-nu,73748499,"Túi xách nữ thời trang cao cấp ELLY – EL157 Đen Nude",1399000,1399000,0,0
TIKI,tui-vi-nu,177092421,"Túi xách nữ 2 trong 1 thời trang cao cấp phong cách mới",387000,430000,43000,10
TIKI,tui-vi-nu,81224272,"Túi Đeo Chéo Bao Tử Chống Nước FALDO",166000,166000,0,0
TIKI,tui-vi-nu,37705615,"Túi xách nữ quai xích thời trang",145000,145000,0,0
TIKI,tui-vi-nu,189457910,"Túi xách thời trang nữ cao cấp Allwellshop - Túi cầm tay  da bò 2 lớp font đẹp, sang trọng sử dụng đa phong cách",745000,745000,0,0
TIKI,tui-vi-nu,134754496,"Túi tote đeo vai vải bố canvas T052 nữ in chữ by merciparis có khóa kéo, mềm, đẹp phong cách Hàn",76000,152000,76000,50
TIKI,tui-vi-nu,147942468,"Ví Nữ Mini Cầm Tay Chính Hãng MICOCAH Vân Da Rắn Cao Cấp Nhỏ Gọn Nhiều Ngăn Tiện Dụng Siêu Đẹp Giá Rẻ MC49 - Tukado",159000,159000,0,0
TIKI,tui-vi-nu,118553670,"2 Túi Nhựa Bảo Vệ Thẻ, Căn Cước Công Dân, Thẻ ATM, Bằng Lái, Thẻ Sinh Viên, Card Visit",2999,2999,0,0
TIKI,tui-vi-nu,101831134,"Túi Kẹp Nách, Túi Xách Nữ, Túi Đeo Chéo Hàn Quốc TDC045",75000,75000,0,0
TIKI,tui-vi-nu,105701133,"Túi tote thời trang đi học sinh viên học sinh - HỘP GÀI",81000,81000,0,0
TIKI,tui-vi-nu,135053359,"Túi đeo chéo đeo vai thời trang nam vải canvas hiệu Moyyi TDC005",324000,450000,126000,28
TIKI,tui-vi-nu,90912147,"Túi bao tử nữ đeo chéo trước ngực, đeo hông cá tính TX00306",199000,199000,0,0
TIKI,tui-vi-nu,77746334,"VÍ DA NỮ THỜI TRANG CAO CẤP ELLY – EV70",699000,699000,0,0
TIKI,tui-vi-nu,174468691,"Ví Nữ Ngắn Mini Cầm Tay Perfect For You Nhỏ Gọn Đựng Tiền Vân Ra Rắn Cao Cấp Cực Đẹp Giá Rẻ PFY26",99000,99000,0,0
TIKI,tui-vi-nu,157822906,"Túi đeo chéo nam nữ unisex phong cách ulzzang chất da Pu cao cấp, chống thấm nước S19",143312,207006,63694,31
TIKI,tui-vi-nu,83921150,"Túi Đeo Chéo Nữ ️️ Túi Xách Nữ Bản To Đựng Laptop Chống Nước Phong Cách Hàn Quốc SPB136",125000,125000,0,0
TIKI,tui-vi-nu,191412775," Túi vải tote ENZYCO đeo vai nhiều mẫu vải cotton cao cấp",50000,50000,0,0
TIKI,tui-vi-nu,157254208,"Túi Tote Chất Liệu Da Cao Cấp SAIGON SWAGGER Eclipse Leather Tote Bag",550000,550000,0,0
TIKI,tui-vi-nu,164197015,"Ví cầm tay nữ dáng ngang nắp gập LATA VN56",350000,350000,0,0
TIKI,tui-vi-nu,173856862,"Túi tote đeo chéo đeo đi học đi làm đi chơi",46900,46900,0,0
TIKI,tui-vi-nu,154179005,"Túi đeo chéo vải canvas hình ngộ nghĩnh",99000,99000,0,0
TIKI,tui-vi-nu,111868791,"Túi đeo chéo, đeo hông Arctic Hunter chất liệu Oxford chống nước - Y00020",335000,635000,300000,47
TIKI,tui-vi-nu,81312126,"Túi xách nữ công sở HOTTREND  Túi xách nữ kẻ caro Hàn Quốc  Deli TN47",199000,199000,0,0
TIKI,tui-vi-nu,102130055," Ví Nữ ◈◈ Ví Nữ Cầm Tay Mini Ngắn Nhỏ Gọn Bỏ Túi Siêu Xinh L01",100000,100000,0,0
TIKI,tui-vi-nu,31877168,"Túi đeo chéo xách tay thời trang nữ da PU bóng trơn mềm LH088",427000,427000,0,0
TIKI,tui-vi-nu,35217332,"Túi nữ đeo chéo mini DYC trẻ trung  năng động thanh lịch phong cách Hàn quốc",90000,90000,0,0
TIKI,tui-vi-nu,147942365,"Ví Bóp Nữ Mini Cầm Tay FOREVER YOUNG Đựng Tiền Nhiều Ngăn Tiện Dụng Chất Da Xước Cực Đẹp FY49 - Tukado",149000,149000,0,0
TIKI,tui-vi-nu,76748874,"Cặp Sakos Phối Da Legend 04",4600000,4600000,0,0
TIKI,tui-vi-nu,121234495,"Túi công sở da hai ly dầy đẹp -túi xách CHERRY",129000,129000,0,0
TIKI,tui-vi-nu,131405286,"Túi xách đeo chéo công sở da trần trám đẹp sang chảnh BK17",75000,75000,0,0
TIKI,tui-vi-nu,90469917,"Túi xách nam công sở da bò thật cao cấp ",900000,999000,99000,10
TIKI,tui-vi-nu,86561206," Túi xách nữ    Túi đeo chéo mini hàng quảng châu siêu hot TD17",63000,63000,0,0
TIKI,tui-vi-nu,186530758,"Túi xách nữ da tự nhiên thời trang công sở cao cấp phong cách mới",531000,590000,59000,10
TIKI,tui-vi-nu,117672638,"Túi cói đi biển hai màu mẫu mới phong cách hàn quốc",38000,44500,6500,15
TIKI,tui-vi-nu,71594388,"Ví nữ cầm tay thời trang cao cấp ELLY – EVH68",799000,799000,0,0
TIKI,tui-vi-nu,91147067,"Túi bao tử nữ đeo chéo trước ngực, đeo hông cá tính KN9068",29000,29000,0,0
TIKI,tui-vi-nu,185674646,"Túi đeo chéo nam tích hợp khóa chống trộm chống nước cao cấp phong cách mới",333000,370000,37000,10
TIKI,tui-vi-nu,192074280,"Túi đeo chéo Nữ đựng điện thoại 2 ngăn kéo - VN005",90000,90000,0,0
TIKI,tui-vi-nu,192559833,"Túi xách nữ thời trang công sở cao cấp phong cách mới",387000,430000,43000,10
TIKI,tui-vi-nu,54895172,"Túi xách tay nữ siêu sang dáng vuông charles da chần",75000,75000,0,0
TIKI,tui-vi-nu,86560732," Túi Cói    Túi Xách Nữ Mini Phong cách Vintage TV12",25000,25000,0,0
TIKI,tui-vi-nu,45353404,"Túi xách đeo chéo hàn quốc nữ đẹp toza TX06",98000,98000,0,0
TIKI,tui-vi-nu,111868993,"Túi đeo chéo, đeo hông nam Arctic Hunter K00096 chất liệu Oxford chống thấm nước, thiết kế nhiều ngăn tiện dụng",379000,650000,271000,42
TIKI,tui-vi-nu,71512972,"Túi xách nữ thời trang cao cấp ELLY – EL152",839400,1399000,559600,40
TIKI,tui-vi-nu,31911289,"Ví cầm tay thời trang Unisex LATA VN34",299000,380000,81000,21
TIKI,tui-vi-nu,115438873,"Ví cốp cầm tay, ví nữ, ví uzzlang ví cầm tay, ví nữ thời trang , ví passport",167000,167000,0,0
TIKI,tui-vi-nu,104958894,"TÚI XÁCH NỮ TÚI ĐEO VAI TÚI BAO TỬ ĐEO CHÉO SÀNH ĐIỆU",90000,90000,0,0
TIKI,tui-vi-nu,176842819,"Túi xách nữ thời trang cao cấp phong cách châu âu",405000,450000,45000,10
TIKI,tui-vi-nu,72093847,"Túi xách da bò nam công sở cao cấp phong cách châu âu (15,6")",585000,649000,64000,10
TIKI,tui-vi-nu,190828821,"Túi đeo chéo NASI T1033 phong cách hàn quốc túi xách nữ đeo vai thời trang dạo phố dễ thương vải đẹp",59000,59000,0,0
TIKI,tui-vi-nu,72032149,"Túi xách nữ thời trang cao cấp ELLY- EL140",974350,1499000,524650,35
TIKI,tui-vi-nu,109958963,"Túi đeo chéo vải Canvas thời trang, túi xách phong cách Hàn Quốc, phù hợp đi chơi, đi tiệc",125000,125000,0,0
TIKI,tui-vi-nu,160315333,"Ví Ngắn Nữ Mini Cầm Tay FOREVER YOUNG Gấp 3 Nhỏ Gọn Nhiều Ngăn Tiện Dụng VD12 - Micocah Mall",25000,25000,0,0
TIKI,tui-vi-nu,28912611,"Túi đeo chéo đựng điện thoại 2 ngăn",100000,100000,0,0
TIKI,tui-vi-nu,104361510,"3 Bóp ( Ví ) đựng thẻ ngân hàng",17999,17999,0,0
TIKI,tui-vi-nu,191291926,"Ví nữ cầm tay dáng đứng YUUMY Ripple YV75",85000,190000,105000,55
TIKI,tui-vi-nu,248878233,"Túi xách nam da bò công sở cao cấp 15,6",702000,780000,78000,10
TIKI,tui-vi-nu,188042221,"Túi xách nữ thời trang cao cấp ELLY – EL208",979300,1399000,419700,30
TIKI,tui-vi-nu,67097402,"Túi đeo chéo thêu thời trang nữ - Nụ tầm xuân",250000,250000,0,0
TIKI,tui-vi-nu,119405441,"Túi cói thời trang Merci cao cấp SO57 Tặng móc khóa gấu treo",53999,53999,0,0
TIKI,tui-vi-nu,151778332,"Túi xách nữ da mềm họa tiết độc đáo thời trang phong cách Hàn Quốc",89000,89000,0,0
TIKI,tui-vi-nu,149449626,"Túi xách nữ hai khóa cốp tròn siêu xinh - kiểu dáng độc đáo",259000,259000,0,0
TIKI,tui-vi-nu,98577141,"Túi xách đeo chéo nữ vải dù chống thấm nước cao cấp",109000,109000,0,0
TIKI,tui-vi-nu,55023269,"Túi xách nữ đeo chéo nhỏ xinh mini cực đẹp TX20 dập vân Vimona",125000,125000,0,0
TIKI,tui-vi-nu,109874262,"Ví FEASTY Da Sáp Nhập Khẩu Bóp Gập Form Chuẩn Cao Cấp Chống Thấm Nước Unisex Nam Nữ DOLANTO",168000,168000,0,0
TIKI,tui-vi-nu,137951985,"Túi Giỏ Xách Đan Tay Quai Gỗ Lớn Nhiều Màu Hàng Xuất Khẩu Thủ Công Sang Chảnh Đi Chơi Đi Biển Chụp Hình",140000,140000,0,0
TIKI,tui-vi-nu,75381841,"Dây Túi Đeo Đùi SWAT",250000,250000,0,0
TIKI,tui-vi-nu,186814372,"Ví Đựng Passport Hộ Chiếu Nam Nữ, Da Bò NAPA Láng Mịn Cao Cấp, Thiết Kế Hiện Đại - Mỏng Nhẹ - Đa Năng, Đựng Được Nhiều Loại Hộ Chiếu, Nhiều Ngăn Thẻ ATM, Đựng Tiền, Vé Máy Bay, Tiện Dụng Khi Đi Du Lịch, Công Tác - Hàng Chính Hãng SAIGIO",1283000,1299000,16000,1
TIKI,tui-vi-nu,71731737,"Túi clutch nữ thời trang cao cấp ELLY – ECH50",659450,1199000,539550,45
TIKI,tui-vi-nu,160314770,"Ví Nữ Mini Cầm Tay PERFECT FOR YOU Đựng Tiền Gập 3 Nhỏ Gọn Nhiều Ngăn Tiện Dụng Da Xước Cực Đẹp PFY04 - Micocah Mall",149000,149000,0,0
TIKI,tui-vi-nu,73218361,"TÚI ĐEO CHÉO Mini Nhỏ Gọn Tiện Lợi MEDIUM BAG Vải Canvas Cao Cấp Chống Thấm Nước Unisex Nam Nữ Chuẩn Dim DOLANTO",98000,98000,0,0
TIKI,tui-vi-nu,125099876,"Ví Đựng Passport Điện Thoại Nhiều Ngăn",75000,75000,0,0
TIKI,tui-vi-nu,27561803,"Túi xách nữ thời trang cao cấp ELLY- EL129",1499000,1499000,0,0
TIKI,tui-vi-nu,147941995,"Túi Xách Nữ Đeo Chéo Chính Hãng FOREVER YOUNG Dáng Công Sở Thời Trang Da Cao Cấp Cực Đẹp FY13 - TUKADO",239000,239000,0,0
TIKI,tui-vi-nu,88027584,"Túi đeo chéo nữ đựng điện thoại thời trang đi chơi dạo phố TK0079",29000,35000,6000,17
TIKI,tui-vi-nu,68104299,"Túi Xách Nữ Thời Trang Cao Cấp Sang Trọng Có Thể Xách Tay  hay Đeo Chéo MS -426",125000,125000,0,0
TIKI,tui-vi-nu,193620925,"Túi Xách Nữ Đeo Chéo, Túi Xách Công Sở Nữ Nhiều Ngăn Tiện Dụng, Nhiều Màu Sắc Lựa Chọn",140000,140000,0,0
TIKI,tui-vi-nu,104668293,"Túi bao tử nữ , túi đeo bụng chất da xịn xò hottrend MN40 - túi đeo vai , đeo ngực",75000,75000,0,0
TIKI,tui-vi-nu,195971972,"Túi xách nữ cao cấp da thật ELLY – ET143",2499000,2499000,0,0
TIKI,tui-vi-nu,173443869,"Ví bóp nữ nhiều ngăn đựng thẻ đựng tiền đa năng size 11cm",69000,69000,0,0
TIKI,tui-vi-nu,1940585,"Cặp Công Sở Yuumy Cayuumy 03 Nâu",225000,315000,90000,29
TIKI,tui-vi-nu,134820500,"Túi xách nữ thời trang công sở _ Minh Quân Shop",125000,125000,0,0
TIKI,tui-vi-nu,191309614,"Marhen.J - Túi rút dây nữ Charron MJ21BCHARN-IP",2290000,2290000,0,0
TIKI,tui-vi-nu,190755891,"Ví da nữ cầm tay dáng ngang Lata VN57",390000,390000,0,0
TIKI,tui-vi-nu,193978990,"Túi Xách Nhựa Trong Suốt In Hình Chuột Mickey Dễ Thương Dành Cho Nữ - HT",95000,95000,0,0
TIKI,tui-vi-nu,257532638,"Túi xách nữ công sở màu đỏ và hồng",220000,220000,0,0
TIKI,tui-vi-nu,137942499,"Túi xách nữ công sở phong cách Hàn Quốc  phù hợp đi chơi,đi làm...Mẫu mới 2022",129000,129000,0,0
TIKI,tui-vi-nu,71587063,"Ví nữ cầm tay thời trang cao cấp ELLY – EV67",519350,799000,279650,35
TIKI,tui-vi-nu,149449289,"Túi xách nữ mini đeo chéo cao cấp thời trang giá rẻ dễ thương cá tính GL39",233000,233000,0,0
TIKI,tui-vi-nu,193548578,"Ví Nữ Thời Trang cao cấp phong cách mới – VNU1004",150000,300000,150000,50
TIKI,tui-vi-nu,193153848,"Túi Xách Nữ Đeo Chéo Đeo Vai Cao Cấp NUTUSHOP - NT64",199000,199000,0,0
TIKI,tui-vi-nu,195775282,"Túi xách nữ đeo chéo công sở sang trọng phong cách Hàn Quốc",299000,299000,0,0
TIKI,tui-vi-nu,135319490,"Túi bao tử, túi đeo ngực dây bản to phối ngọc",99000,99000,0,0
TIKI,tui-vi-nu,79326366,"[ Hàng cao cấp]- Túi  đeo vai chất liệu cói túi đeo chéo đi dạo phố",280000,280000,0,0
TIKI,tui-vi-nu,79434847,"Túi Xách Nữ ️Túi Đeo Chéo Vuông Thời Trang SP130",55000,55000,0,0
TIKI,tui-vi-nu,148932197,"Túi Đeo Chéo Nữ Đeo Vai Vải Canvas Mini Thời Trang Có Gấu Dễ Thương Kiểu Hàn Quốc TCNU01 SUNO store",43000,43000,0,0
TIKI,tui-vi-nu,77857670,"Túi Đeo Chéo Bao Tử Nhỏ Gọn Tiện Lợi ZUMBA Vải Canvas Cao Cấp Chống Thấm Nước Unisex Nam Nữ",78000,78000,0,0
TIKI,tui-vi-nu,160314871,"Túi Xách Nữ Kẹp Nách Chính Hãng MICOCAH Dáng Công Sở Thời Trang Da Cao Cấp Cực Siêu Đẹp Giá Rẻ MC02",369000,369000,0,0
TIKI,tui-vi-nu,146391723,"Túi xách nữ đeo chéo đựng điện thoại dáng dọc phối hoa văn nhiều ngăn tiện dụng thời trang Hàn Quốc",139000,139000,0,0
TIKI,tui-vi-nu,189906862,"Túi đeo dưới cánh tay ,da PU họa tiết  da cá sấu,phong cách thời trang sôi động trẻ trung cho phái nữ",95000,129000,34000,26
TIKI,tui-vi-nu,97551097,"Túi xách nam da bò thật cao cấp phong cách mới 15,6",900000,999000,99000,10
TIKI,tui-vi-nu,86561304,"Túi xách nữ    Túi đeo chéo mini hàng quảng châu siêu hot TD09",69000,69000,0,0
TIKI,tui-vi-nu,209414475,"Clutch dự tiệc đính đá cực sang trọng thiết kế kiểu dáng túi xác",541000,541000,0,0
TIKI,tui-vi-nu,48482622,"Túi Đeo chéo nữ gấu thời trang cho bé hình chuột CHIOTT44  Shalla",56000,79827,23827,30
TIKI,tui-vi-nu,164316884,"TÚI MINI HÌNH TRỤ ĐỰNG SON CÓ MÓC TREO CHÌA KHÓA HOA VĂN SANG CHẢNH",35000,35000,0,0
TIKI,tui-vi-nu,157254291,"Ví Gập Đôi Nữ Da In SAIGON SWAGGER Eclipse Fold Wallet",450000,450000,0,0
TIKI,tui-vi-nu,92493773,"Balo thời trang, balo đi học, đựng laptop Túi Tote Mèo Cony balo nữ vải",92000,92000,0,0
TIKI,tui-vi-nu,22631123,"Túi đeo chéo đeo vai nữ ATĐ44 Shalla",134640,194480,59840,31
TIKI,tui-vi-nu,186470489,"Túi Xách Nữ 2 mặt, 2 kiểu dây Với đa Phong Cách vừa  xách tay  Đeo vai, Đeo chéo Với  Da Cao Cấp - Màu xanh dương Và Màu Xám Size 21cm [Bao đổi trả].",805000,805000,0,0
TIKI,tui-vi-nu,172905215,"TÚI ĐEO CHÉO ĐỰNG ĐIỆN THOẠI CON ONG MIN I NHỎ GỌN MỚI NHẤT 2022 HUONGLANSHOP",55000,55000,0,0
TIKI,tui-vi-nu,128568924,"TÚI CLUTCH NỮ CAO CẤP DA THẬT ELLY – EC58",2199000,2199000,0,0
TIKI,tui-vi-nu,137153917,"Túi Tote Đeo Chéo Vải Canvas Bò Sữa Phong Cách Ulzzang",59000,59000,0,0
TIKI,tui-vi-nu,71733648,"Túi clutch nữ thời trang cao cấp ELLY – ECH52",1199000,1199000,0,0
TIKI,tui-vi-nu,122483939,"Túi Xách Nữ Công Sở Da PU Trang Trí Xách Tay Hìng Trái Tim MS002",299000,299000,0,0
TIKI,tui-vi-nu,195561149,"Túi Xách Nữ Thời Trang JUNO Cỡ Nhỏ Nắp Gập Gắn Khoá Trang Trí TXN598",682000,682000,0,0
TIKI,tui-vi-nu,75597664,"Túi đeo chéo nữ đựng điện thoại tiện dụng, móc khóa bông dễ thương TK0072",39000,70000,31000,44
TIKI,tui-vi-nu,197535501,"Ví đựng namecard Trita Liberal RVN11- Ngẫu nhiên",55000,150000,95000,63
TIKI,tui-vi-nu,184069140,"HAVAIANAS - Ví cầm tay phom chữ nhật phối zip thời trang 4146866",399000,399000,0,0
TIKI,tui-vi-nu,108849248,"Túi xách nữ da bò DH50Hàng Chuẩn Auth (vthm9)",950000,950000,0,0
TIKI,tui-vi-nu,197775473,"Ví da y tế cao cấp đa năng, bền đẹp, tiện lợi cả ở nhà và đi du lịch - đựng máy đo đường huyết, điện thoại, đựng thuốc, ví tiền, nhiệt kế,...",199000,199000,0,0
TIKI,tui-vi-nu,191354706,"Túi xách nữ đính hoa đá đi tiệc hình bầu trống- túi xách hoa đá đi tiệc trung niên sang trọng, nổi bật",429000,429000,0,0
TIKI,tui-vi-nu,181096984,"Túi xách nữ MONOGRAM CANVAS ELLY – EL203",749500,1499000,749500,50
TIKI,tui-vi-nu,171621137,"Túi Xách Nữ Đẹp Thời Trang Đi Học, Đi Chơi, Túi Vải Canvas Đeo Chéo Trẻ Trung, Năng Động Dành Cho Nữ - OTV116 - Ope Store",157000,157000,0,0
TIKI,tui-vi-nu,157823444,"Túi Xách Nữ Công Sở Túi Xách Đeo Chéo Bản To Da Mềm Thời Trang  MQ191",125000,125000,0,0
TIKI,tui-vi-nu,110193396,"Ví nữ dài cầm tay khoá kéo sang trọng ngăn đựng thẻ tiện dụng TK0097",35000,70000,35000,50
TIKI,tui-vi-nu,136940037,"Túi đeo chéo thổ cẩm khoá bóp kim loại",100000,100000,0,0
TIKI,tui-vi-nu,160314996,"Ví Nữ Mini Cầm Tay TAILIAN Nhỏ Gọn Phối Da Lộn Thời Trang Nhiều Ngăn Da Cao Cấp Cực Đẹp Giá Rẻ TL01 - Micocah Mall",99000,99000,0,0
TIKI,tui-vi-nu,86562035," Túi đeo chéo    Túi xách nữ vải Canvas siêu xinh TV06",16900,16900,0,0
TIKI,tui-vi-nu,173000283,"Ví đựng hộ chiếu Passport giấy tờ xe, thẻ thời trang chất liệu da bò cao cấp 40596",127000,214000,87000,41
TIKI,tui-vi-nu,58046040,"Túi Đeo Chéo Bao Tử Da Hàn Quốc Nữ Thêu Chỉ Nổi Hình Quả Trám Đen",63200,79000,15800,20
TIKI,tui-vi-nu,136095594,"Túi Xách Đựng Laptop Cặp Da Nam GENCE CDT04 Chất Liệu Da Bò Cao Cấp Màu Đen",1800000,1800000,0,0
TIKI,tui-vi-nu,250000957,"Túi Đeo Chéo Hình Gấu Dâu",120000,120000,0,0
TIKI,tui-vi-nu,149133390,"Túi đeo chéo nam, túi đeo vai nam đa chức năng chất liệu vải oxford chống thấm nước, phong cách thời trang năng động",234800,234800,0,0
TIKI,tui-vi-nu,130856288,"Túi tote vải mini đeo chéo canvas mềm đẹp vanvas giá rẻ đeo chéo",81000,81000,0,0
TIKI,tui-vi-nu,54159716,"Túi đeo chéo Unisex chống nước Cleacco cho nam nữ",119000,149000,30000,20
TIKI,tui-vi-nu,160314785,"Túi Xách Nữ Kẹp Nách MICOCAH Đeo Chéo Đeo Vai Dáng Công Sở Thời Trang Phong Cách Hàn Quốc Da Cao Cấp Cực Đẹp MC37",369000,369000,0,0
TIKI,tui-vi-nu,82430280,"Ví Da Nữ Cầm Tay Jimmi",83160,120120,36960,31
TIKI,tui-vi-nu,160314183,"Túi Đeo Chéo Nữ FOREVER YOUNG Đựng Tiền Điện Thoại Kiểu Dáng Basic Thời Trang Da Cao Cấp Cực Đẹp FY02 - Micocah Mall",159000,159000,0,0
TIKI,tui-vi-nu,209414248,"Túi đựng điện thoại đeo chéo thời trang TDT149 khóa bấm",72000,72000,0,0
TIKI,tui-vi-nu,72457254,"Ví sen 3, da bò thật, ví mini cầm tay cho nam và nữ đựng tiền và thẻ, bh 24 tháng 1 đổi 1, VSN19",210000,210000,0,0
TIKI,tui-vi-nu,186133963,"Túi xách nữ túi đeo chéo nữ thời trang công sở cao cấp phong cách mới",423000,470000,47000,10
TIKI,tui-vi-nu,106791435,"Túi Xách Nữ Thời Trang Da Trơn Phong Cách Hàn Quốc, Túi xách công sở + Tặng 1 đôi bông tai hợp kim thời trang",279000,279000,0,0
TIKI,tui-vi-nu,160314294,"Ví Nữ Ngắn Mini Cầm Tay TAILIAN Đựng Tiền Dáng Vuông Nhỏ Gọn Da Cao Cấp Cực Đẹp Giá Rẻ TL32 - Micocah Mall",99000,99000,0,0
TIKI,tui-vi-nu,59101410,"Túi trong suốt đeo chéo TROY 02 ngăn viền gân phản quang in họa tiết logo nổi bật",139000,139000,0,0
TIKI,tui-vi-nu,54599202,"Túi xách nữ nhỏ xinh thời trang tiện dụng hottrend 2020 VTX006",49000,49000,0,0
TIKI,tui-vi-nu,189337696,"Túi đeo chéo nữ thời trang unisex nhiều ngăn tiện dụng chính hãng YVan C80-6",235000,235000,0,0
TIKI,tui-vi-nu,194790827,"Móc Khoá Móc Cặp Hình Mèo Đeo Khăn Nhiều Màu",69000,69000,0,0
TIKI,tui-vi-nu,4070267,"Túi Đeo Chéo - Balo Chéo Hàn Quốc",69000,96333,27333,28
TIKI,tui-vi-nu,5003273,"Túi Xách Nữ Cao Cấp Da Thật Elly ET63",1199400,1999000,799600,40
TIKI,tui-vi-nu,74255688,"Túi xách tote vải Túi Tote Túi Vải Nữ Túi Đeo Chéo Đeo Vai Hàn Quốc  Đáng Yêu Tiện Lợi Đi Học Đi Chơi Hàn Quốc Sweet Gà con - Munnini",59900,59900,0,0
TIKI,tui-vi-nu,130856584,"Túi tote đeo chéo in hinh bướm butterfly unisex nam nữ Hàn Quốc",63900,63900,0,0
TIKI,tui-vi-nu,55481753,"Túi đeo chéo nam nữ unisex thời trang BEE GEE 088 chống thấm nước để điện thoại ipad mini",59500,119000,59500,50
TIKI,tui-vi-nu,181113387,"Cluth nữ MONOGRAM CANVAS ELLY – ECH62",699500,1399000,699500,50
TIKI,tui-vi-nu,1940599,"Cặp Công Sở Yuumy Cayuumy 03 Bò",225000,315000,90000,29
TIKI,tui-vi-nu,195949466,"Túi Xách Nữ Sang Trọng Túi Đeo Chéo Đeo Vai Túi Xách Quảng Châu Có Thể Sử Dụng Như Thắt Lưng Jess40",50000,50000,0,0
TIKI,tui-vi-nu,188997786,"Túi Đeo Chéo Nam Nữ Cao Cấp Nhiều Ngăn Chống Thấm Nước, Túi Đeo Vai Phong Cách Thời Trang Hàn Quốc, Túi Đựng Ipad Điện Thoại Đa Năng",130000,130000,0,0
TIKI,tui-vi-nu,67418853,"Túi đeo chéo nữ thời trang Hàn Quốc dây xích sang trọng phù hợp đi chơi đi tiệc",99000,99000,0,0
TIKI,tui-vi-nu,72789860,"Túi xách nữ, túi kẹp nách nữ đeo chéo da vân cá sấu dây xích cực đẹp TX41 với thiết kế hiện đại",39000,39000,0,0
TIKI,tui-vi-nu,171545510,"Túi Tote Vải Canvas Cỡ Lớn, Túi Xách Đeo Vai Merci Đựng Đồ Cho Nữ - OTV103 - Ope Store",164000,164000,0,0
TIKI,tui-vi-nu,186124018,"Túi Vải Mini Đeo Chéo Cho Nữ Siêu Cute, Túi Đeo Vai Nữ Thời Trang Phong Cách Nhật Bản, Nhiều Màu Sắc Cá Tính",60000,60000,0,0
TIKI,tui-vi-nu,148677771,"Túi tote vải canvas đeo vai đi học đi chơi phong cách uzzang giá rẻ",69000,69000,0,0
TIKI,tui-vi-nu,53979967,"Ví nữ cầm tay cao cấp 2 ngăn kéo sang trọng, thiết kế nhiều ngăn tiện dụng TK0047 - ĐỎ ",76000,100000,24000,24
TIKI,tui-vi-nu,186136281,"Túi xách nữ thời trang công sở cao cấp phong cách mới",441000,490000,49000,10
TIKI,tui-vi-nu,1940551,"Cặp công sở Yuumy Cayyumy01 - Màu Bò",245000,315000,70000,22
TIKI,tui-vi-nu,160315147,"Túi Xách Nữ Đeo Chéo Chính Hãng FOREVER YOUNG Dáng Công Sở Thời Trang Phong Cách Ulzzang Da Cao Cấp Cực Đẹp FY13",239000,239000,0,0
TIKI,tui-vi-nu,81208972,"Túi Vải Đeo Chéo Nữ Nhiều Họa Tiết 461",59000,59000,0,0
TIKI,tui-vi-nu,196855134,"Ví đựng thẻ card Mundo da bò vân hạt",370000,370000,0,0
TIKI,tui-vi-nu,97069588,"Túi xách đựng giấy A4, laptop, thiết kế đơn giản, thông dụng, chuyên nghiệp, kèm dây thừng đeo vai không đau, chất liệu vải bố (Nhiều mẫu để lựa)",84000,140000,56000,40
TIKI,tui-vi-nu,202042624,"Túi đeo chéo nữ vải dù gai 5 ngăn chống nước, phong cách Hàn Quốc Size 20cm TUI-49",189000,189000,0,0
TIKI,tui-vi-nu,179438184,"Túi đeo chéo Vải Canvas nam nữ học sinh sinh viên đi học đi chơi thời trang Hàn Quốc",139000,139000,0,0
TIKI,tui-vi-nu,207357235,"Túi Canvas Nữ Thời Trang Hàn Quốc, Túi Vải Canvas Đeo Chéo Đơn Giản Siêu Xinh, Túi Tote Đeo Chéo Vải Canvas Đựng Đồ - OTV210 - Ope Store",210000,210000,0,0
TIKI,tui-vi-nu,150991722,"Bóp ví nữ cầm tay mini V0516 Bò sữa bỏ túi nhiều ngăn nhỏ gọn phong cách đơn giản, thời trang, dễ thương",25000,50000,25000,50
TIKI,tui-vi-nu,71565914,"Túi xách nữ thời trang cao cấp ELLY- EL145",909350,1399000,489650,35
TIKI,tui-vi-nu,171182240,"Túi đeo chéo 2 ngăn đựng điện thoại cao cấp thời trang",199000,199000,0,0
TIKI,tui-vi-nu,91421847,"Túi tote It's OK",117000,117000,0,0
TIKI,tui-vi-nu,205527662,"Ví nữ đính đá bà sui sang trọng- túi xách đính đá V đi tiệc trung niên thanh lịch,túi diện áo dài đứng sui sang trọng",439000,439000,0,0
TIKI,tui-vi-nu,89113017,"Túi Xách Nữ Thời Trang Kèm Dây Đeo Chéo Chất Da Rắn Bền Đẹp Thiết Kế Trẻ Trung Size 20 Nhỏ Xinh",76000,76000,0,0
TIKI,tui-vi-nu,193051691,"Túi Xách Nữ Đeo Vai Cao Cấp Phong Cách Hiện Đại Âu Mỹ TVNN365",659000,659000,0,0
TIKI,tui-vi-nu,195126785,"Túi da chéo CROS HAVIAS",544000,680000,136000,20
TIKI,tui-vi-nu,77680537,"Túi xách nữ thời trang cao cấp ELLY- EL168",839400,1399000,559600,40
TIKI,tui-vi-nu,96013853,"Ví Cầm Tay Nữ ESME Thời Trang ES0345 Chất Liệu Da Mềm Mại",789000,789000,0,0
TIKI,tui-vi-nu,20542076,"Ví Da Bò Thật Đựng Thẻ Atm Name Card",179000,179000,0,0
TIKI,tui-vi-nu,136940097,"Túi thổ cẩm đựng tiền (cb)",15000,15000,0,0
TIKI,tui-vi-nu,53347936,"Túi Bao Tử Đeo Chéo Cao Cấp Nam Nữ Thời Trang Đa Năng Galaxy Store GTBT01 (28x17.5cm) - Hàng Chính Hãng",242000,450000,208000,46
TIKI,tui-vi-nu,115440149,"Bóp cầm tay, ví cầm tay,bóp tiền, ví nữ, bóp nữ, bóp da, bóp đẹp, ví nữ giá rẻ, bóp cầm tay 2 ngăn, ví cầm tay 2 ngăn",120000,120000,0,0
TIKI,tui-vi-nu,176218004,"Túi Tote Đeo Chéo Thời Trang ULZZANG BASIC Cho Nam Nữ Đi Học Đi Chơi – Vải Dệt Canvas",99000,99000,0,0
TIKI,tui-vi-nu,157084663,"Bóp ví nữ cầm tay mini V092 khóa tròn nhiều ngăn nhỏ gọn phong cách đơn giản, thời trang, dễ thương",25000,50000,25000,50
TIKI,tui-vi-nu,185468261,"túi ví đeo chéo nữ thời trang đựng vừa điện thoại 6.5" với khe thẻ bên ngoài - N8612",178000,259000,81000,31
TIKI,tui-vi-nu,71176855,"Túi xách nữ thời trang cao cấp ELLY – EL156",1399000,1399000,0,0
TIKI,tui-vi-nu,86561309,"Túi Xách Nữ  50K - TÚI ĐEO CHÉO DÂY PHA XÍCH ULZZANG CÁ TÍNH KT 12CM TD04",55000,55000,0,0
TIKI,tui-vi-nu,194025664,"Túi đeo nữ da cá sấu nguyên tấm màu đen dễ phối đồ!",3090000,5200000,2110000,41
TIKI,tui-vi-nu,167948453,"Set 3 túi trong suốt đựng đồ, mỹ phẩm du lịch thời trang",60700,60700,0,0
TIKI,tui-vi-nu,136940007,"TÚI ĐEO CHÉO THỔ CẨM ĐỰNG ĐIỆN THOẠI",15000,15000,0,0
TIKI,tui-vi-nu,175656160,"Túi đeo chéo nữ ,Túi xách nữ da trơn nắp khóa cài 1 ngăn thời trang Hàn QuốC LK193",99000,99000,0,0
TIKI,tui-vi-nu,182756912,"Túi Tomtoc LADY FASHION ACCESSORIES - Hàng chính hãng",1049000,1049000,0,0
TIKI,tui-vi-nu,173029565,"Túi Nữ túi xách tay Kẻ Sọc Thời Trang Phong Cách Cá Tính 205970",44000,62000,18000,29
TIKI,tui-vi-nu,193111995,"Ví cầm tay nữ có dây đeo chéo nhiều ngăn đựng tiền,đựng thẻ ATM và điện thoại phong cách Hàn Quốc X001",1165000,1165000,0,0
TIKI,tui-vi-nu,172369648,"Ví da nữ cầm tay nhỏ gọn YUUMY Seasand YV58",65000,150000,85000,57
TIKI,tui-vi-nu,67936753,"KHĂN LỤA BUỘC TÚI- KHĂN QUẤN TÚI NHIỀU HỌA TIẾT",16000,16000,0,0
TIKI,tui-vi-nu,15592049,"Túi đeo chéo nữ- túi xách đeo chéo nữ cá tính",55000,55000,0,0
TIKI,tui-vi-nu,183343138,"Túi đeo chéo unisex Street Crossbag chính hãng NATOLI chất vải canvas đi học đi chơi nhiều ngăn cá tính đơn giản nhỏ gọn",249000,357000,108000,30
TIKI,tui-vi-nu,182720797,"Cluth nữ Monogram Canvas ELLY – ECH64",779400,1299000,519600,40
TIKI,tui-vi-nu,147202890,"Túi Hậu Môn Nhân Tạo 2 Mảnh- Hollister (Trong, Lọc Khí, Khóa Cuốn), 18192 / 18193 / 18194 -VT0738",567000,567000,0,0
TIKI,tui-vi-nu,127635141,"Vỏ Bọc Thẻ Trong Suốt, Túi Đựng Thẻ Căn Cước Công Dân, Thẻ ATM, Thẻ Ngân Hàng, Bằng Lái Xe( set 10c)",14999,14999,0,0
TIKI,tui-vi-nu,176453895,"Túi Xách Nữ Đeo Chéo Pop Pop Đẹp Mini Thiết Kế Độc Đáo Cao Cấp Cho Nhân Viên Văn Phòng Làm Công Sở Sinh Viên Trường Học",45000,45000,0,0
TIKI,tui-vi-nu,134851879,"MÓC KHÓA MÈO MAY MẮN Y HÌNH",29900,29900,0,0
TIKI,tui-vi-nu,11468597,"Ví / bóp nữ mini cao cấp (ví gập)",139000,139000,0,0
TIKI,tui-vi-nu,87137041,"Túi Da Công Sở P076 - Màu Đen – Form Chuẩn – Sang Trọng – Đẳng Cấp.",455000,455000,0,0
TIKI,tui-vi-nu,149179597,"T43 TÚI ĐEO CHÉO XÁCH TAY THỜI TRANG NỮ CAO CẤP 5 MÀU DÂY DA PHỤ KIỆN THỜI TRANG",614400,614400,0,0
TIKI,tui-vi-nu,92083889,"Bộ 20 Nút Hít Túi Xách Loại 14x3mm Màu Bạc Lực Hít Mạnh",99000,99000,0,0
TIKI,tui-vi-nu,25273292,"Túi xách nữ thời trang da PU cao cấp",215000,215000,0,0
TIKI,tui-vi-nu,176165140,"Túi Đeo Chéo Nữ Tote Công Sở Đi Chơi Đi Làm Hàng Hiệu Cao Cấp - TDC204",97995,97995,0,0
TIKI,tui-vi-nu,209414146,"Túi cói đựng đồ phong cách thời trang Merci",55000,55000,0,0
TIKI,tui-vi-nu,81499508,"Ví cầm tay nữ thời trang LATA VN52",269000,350000,81000,23
TIKI,tui-vi-nu,131337899,"Túi vải bố, Túi vải Canvas trơn Màu Trắng - Màu Đen Màu Be Size 36cm x 31cm",27000,27000,0,0
TIKI,tui-vi-nu,117294323,"Túi cói đi chơi đi biển hình hoa hướng dương dáng ly dài nhiều màu cực xinh",135000,135000,0,0
TIKI,tui-vi-nu,74637171,"Túi đựng điện thoại di động Chụp ảnh in hình Kỳ diệu DF556 Tặng móc khóa cá heo",71000,100122,29122,29
TIKI,tui-vi-nu,146513491,"Túi đeo chéo ba ngăn khóa tiện lợi_Túi thời trang Hàn Quốc",55000,55000,0,0
TIKI,tui-vi-nu,204615439,"Túi xách nữ đeo chéo cầm tay nữ sang chảnh da bò cao cấp hàng hiệu MX",1200000,1200000,0,0
TIKI,tui-vi-nu,71637263,"Ví nữ cầm tay dự tiệc/Clutch nữ cao cấp thiết kế hiện đại, sang trọng, thời thượng",470000,470000,0,0
TIKI,tui-vi-nu,263046025,"Túi Xách Tay Hình Gấu Bông Pompompurin Vàng, Túi Gấu Bông Gòn Dễ Thương",75000,75000,0,0
TIKI,tui-vi-nu,154858344,"Túi cói đi biển hình cây vintage - Túi đi dạo phố",195000,195000,0,0
TIKI,tui-vi-nu,174626748,"Túi đeo chéo nữ nhỏ gọn BHM7674 Da bò dập nổi họa tiết nhiều màu",550000,550000,0,0
TIKI,tui-vi-nu,129246978,"túi thời trang nữ, túi đeo vai, túi đeo chéo kèm miếng dán sticker ngộ nghĩnh",83254,118935,35681,30
TIKI,tui-vi-nu,69470437,"Túi Xách Nữ Đeo Chéo Hình Snoopy, Túi Đeo Chéo Nữ Đi Học, Đi Chơi, Túi Xách Đeo Chéo Nữ Dễ Thương - OTV006 - Ope Store",275000,275000,0,0
TIKI,tui-vi-nu,154698727,"Bóp ví nữ cầm tay mini V0525 C0RGI nhiều ngăn nhỏ gọn phong cách đơn giản, thời trang, dễ thương",25000,50000,25000,50
TIKI,tui-vi-nu,187642699,"Túi Cói Merci Siêu Hot Hit ! đi biển,đi chợ,đi chơi",38000,38000,0,0
TIKI,tui-vi-nu,147942793,"Ví Nữ Dài Cầm Tay FOREVER YOUNG Da Mềm Khóa Đồng Xu Độc Đáo Nhiều Ngăn Tiện Dụng Chất Cực Đẹp FY01 - Tukado",119000,119000,0,0
TIKI,tui-vi-nu,44573057,"Túi đeo da đà điểu Huy Hoàng da bụng màu nâu đất HT6424",2499000,2499000,0,0
TIKI,tui-vi-nu,67937211,"Dây lụa buộc túi - dây quấn quai túi họa tiết nhiều mẫu (p2)",16000,16000,0,0
TIKI,tui-vi-nu,43694334,"Túi đeo chéo da thật cao cấp Đồ Da Thành Long TLG 208241",185000,347000,162000,47
TIKI,tui-vi-nu,157254280,"Túi Đeo Chéo Nam, Nữ SAIGON SWAGGER SGS Cross Body Bag",400000,400000,0,0
TIKI,tui-vi-nu,263795862,"[Da thật] Túi golf khóa số cầm tay kết hợp đeo chéo da bò thật CL153 (Đen) - 100% da thật",879000,879000,0,0
TIKI,tui-vi-nu,140879599,"Túi cói dây rút hoa cúc quá trời cưng luôn",135000,135000,0,0
TIKI,tui-vi-nu,155169033,"Ví dài cầm tay nam nữ thời trang Hàn Quốc có nhiều ngăn chất liệu da tổng hợp cao cấp phù hợp với cả nam và nữ VN009",159000,159000,0,0
TIKI,tui-vi-nu,86561407,"Túi Xách Nữ -  50K - TÚI ĐEO CHÉO DÂY PHA XÍCH ULZZANG CÁ TÍNH KT 18cm TD03",75000,75000,0,0
TIKI,tui-vi-nu,99248043,"Túi đeo chéo nữ kèm phụ kiện gấu bông",99000,99000,0,0
TIKI,tui-vi-nu,192693260,"VÍ THẺ CẦM TAY 12 NGĂN HÌNH DOREMON SIÊU YÊU",39000,39000,0,0
TIKI,tui-vi-nu,172191324,"Túi đeo chéo phong cách Hàn Quốc Đồ Da Thành Long TLG 208097 1(đen)",30000,30000,0,0
TIKI,tui-vi-nu,131337323,"Có Khóa Kéo Túi vải bố, Túi vải Canvas trơn Màu Trắng - Màu Be",39000,39000,0,0
TIKI,tui-vi-nu,172191774,"Túi đeo chéo trước ngực phong cách vải bố 208031",33000,62000,29000,47
TIKI,tui-vi-nu,36266064,"Túi đeo chéo vải canvas, túi vải nữ TV08, phong cách Hàn Quốc, thời trang trẻ",50000,50000,0,0
TIKI,tui-vi-nu,56735214,"Ví nữ da bò Marrant BHM4202 Ví gập ba, dập nổi họa tiết 3D, ví đựng thẻ card. Hàng chính hãng",398520,398520,0,0
TIKI,tui-vi-nu,24794459,"Ví , bóp nữ cao cấp có hộp và túi đựng Loai 1",129000,129000,0,0
TIKI,tui-vi-nu,116594673,"Túi xách nữ - Túi dây pha xích phong cách Hàn Quốc cá tính TD12 - Mincloset",83000,83000,0,0
TIKI,tui-vi-nu,115495737,"Túi Xách nữ  Túi Cói Merci Đi Biển, Đi Du lịch, Đi chơi Siêu HOT HIT",77000,77000,0,0
TIKI,tui-vi-nu,69470438,"TÚI VẢI TOTE VẢI CANVAS DÀY, DÁNG KHOẺ, TRẺ TRUNG, BỀN BỈ - A012",35000,35000,0,0
TIKI,tui-vi-nu,174445639,"Ví Nữ Ngắn Mini Cầm Tay Chính Hãng TAILIAN Thời Trang Nhiều Ngăn Đựng Tiền Vân Da Rắn Cao Cấp  TL34",119000,119000,0,0
TIKI,tui-vi-nu,177477874,"MLB - Túi đeo vai chữ nhật Monogram Jacquard Hobo 3ABQS012N",2590000,2590000,0,0
TIKI,tui-vi-nu,128857481,"TÚI XÁCH NỮ CAO CẤP DA THẬT ELLY – ET118",1379400,2299000,919600,40
TIKI,tui-vi-nu,45468600,"Túi Xách Nữ - Thời Trang Công Sở",305000,305000,0,0
TIKI,tui-vi-nu,153987209,"Bóp Ví Nữ Bì Thư Siêu Hot Dễ Thương Phong Cách Hàn Quốc Ảnh Thật Shop Chụp",40500,40500,0,0
TIKI,tui-vi-nu,192641866,"Túi đeo chéo đeo ngực nam cao cấp phong cách mới",675000,750000,75000,10
TIKI,tui-vi-nu,167607312,"Bóp ví nữ dài cầm tay V0124 Kẻ vân chỉ nhiều ngăn tiện lợi, phong cách thời trang, cá tính",70000,140000,70000,50
TIKI,tui-vi-nu,253189209,"Túi xách da bò nam công sở cao cấp phong cách châu âu",783000,870000,87000,10
TIKI,tui-vi-nu,11212216,"Túi Tròn Thổ Cẩm Tua Rua NEVENKA N9106",148000,148000,0,0
TIKI,tui-vi-nu,265177848,"Túi xách nữ đeo chéo xách tay kẹp nách túi chơi đi làm bag đi tiệc Full Hộp DEVIN",300000,300000,0,0
TIKI,tui-vi-nu,74026612,"Túi Đeo Chéo Nữ Cao Cấp - SADDLE BAG - HGcork Corkor CK246 - Vật liệu da cork thực vật thuần chay - Sản phẩm Handmade, Sản xuất tại Bồ Đào Nha",2659050,2799000,139950,5
TIKI,tui-vi-nu,89217785,"Túi Xách Nữ    Túi Đeo Chéo Khóa Trái Tim Siêu Đẹp Phong Cách Trẻ Trung",65000,65000,0,0
TIKI,tui-vi-nu,192579893,"Túi xách nữ thời trang công sở cao cấp phong cách mới",387000,430000,43000,10
TIKI,tui-vi-nu,136940063,"Túi/ ví thổ cẩm combo 3 món",40000,40000,0,0
TIKI,tui-vi-nu,106588168,"Bóp Dài Cầm Tay DEVON Da Thật Saffiano Khóa Kéo Sang Trọng Unisex Dành Cho Nam Nữ DOLANTO",350000,350000,0,0
TIKI,tui-vi-nu,104304339,"Túi tote vải đeo chéo, túi canvas bag đi học 2021",112000,112000,0,0
TIKI,tui-vi-nu,147941971,"Túi Xách Nữ Kẹp Nách Đeo Chéo Chính Hãng MICOCAH Dáng Công Sở Thời Trang Da Cao Cấp Cực Đẹp Giá Rẻ MC63 - TUKADO",389000,389000,0,0
TIKI,tui-vi-nu,53537582,"Túi xách nữ khóa chữ nhật dây đeo chéo (đeo vai)",69000,69000,0,0
TIKI,tui-vi-nu,170771059,"Túi xách nữ vải dù Oxford thời trang cao cấp đeo chéo đa năng nhiều ngăn chứa đồ chống thấm nước size 29cm",215000,215000,0,0
TIKI,tui-vi-nu,13670372,"Túi vải bố trơn | túi tote trơn | túi canvas trơn",24900,24900,0,0
TIKI,tui-vi-nu,155530131,"Cặp da công sở da bò Mill cao cấp B102 Bụi Leather - Bảo hành 12 tháng",1200000,1798000,598000,33
TIKI,tui-vi-nu,51299189,"Túi xách da bò nam công sở cao cấp phong cách châu âu",801000,890000,89000,10
TIKI,tui-vi-nu,45066961,"túi xách nữ da cá sấu",2000000,2000000,0,0
TIKI,tui-vi-nu,174469112,"Túi Xách Đeo Chéo Nữ Đeo Vai Kẹp Nách MICOCAH Kiểu Dáng Công Sở Thời Trang Da Cao Cấp Cực Đẹp MC46",389000,389000,0,0
TIKI,tui-vi-nu,155307943,"Túi Cói SUMMER Đi Du Lịch Loại 1 Túi Xách Nữ Phong Cách Hàn Quốc Đi Biển Mẫu Mới",128000,128000,0,0
TIKI,tui-vi-nu,136939957,"Túi thổ cẩm đeo vuông",42000,42000,0,0
TIKI,tui-vi-nu,42129001,"TÚI ĐEO VAI NỮ DỄ THƯƠNG - H0028",45000,75000,30000,40
TIKI,tui-vi-nu,151757252,"Túi đeo chéo nữ thời trang cao cấp phong cách Hàn Quốc",99000,99000,0,0
TIKI,tui-vi-nu,149449620,"CEEKAY- Túi đeo chéo cao cấp Fullbox",450000,450000,0,0
TIKI,tui-vi-nu,87100226,"Balo thời trang, balo đi học, đựng laptop Túi Tote Mèo Cony balo nữ vải",69900,69900,0,0
TIKI,tui-vi-nu,73486209,"Túi xách túi đeo vai nữ mini quoai ngọc da bóng cực xinh cho mẹ và bé",38000,38000,0,0
TIKI,tui-vi-nu,209414066,"Túi kiêm ví đeo chéo đựng điện thoại dáng dọc trần trám siêu chất Cobala1688",142000,142000,0,0
TIKI,tui-vi-nu,70937670,"Túi cói thắt nơ",99000,99000,0,0
TIKI,tui-vi-nu,170916262,"Túi Vỏ Bao Đựng Bọc Thẻ Căn Cước Công Dân, Bằng Lái Xe, Thẻ Ngân Hàng, Thẻ Sinh Viên, Thẻ Nhân Viên",1499,1499,0,0
TIKI,tui-vi-nu,184859332,"Túi xách nữ thời trang cao cấp thời trang – BEE GEE TN1006",180000,360000,180000,50
TIKI,tui-vi-nu,58325944,"Túi đeo chéo, túi xách trong suốt",57420,82940,25520,31
TIKI,tui-vi-nu,197822738,"Túi Tote thời trang Big size phối dây trắng Hibi Sports A012, chất liệu Canvas cao cấp phù hợp đi chơi, đi tập",299000,420000,121000,29
TIKI,tui-vi-nu,67666778,"Túi đeo chéo đeo bụng hiện đại thời trang siêu đẹp Tặng móc khóa nam cao cấp",120000,170478,50478,30
TIKI,tui-vi-nu,181096611,"Túi xách nữ MONOGRAM CANVAS ELLY – EL205",1044450,1899000,854550,45
TIKI,tui-vi-nu,149179446,"TÚI ĐEO CHÉO THỜI TRANG NỮ DÂY ĐEO DA PHỤ KIỆN THỜI TRANG",520800,520800,0,0
TIKI,tui-vi-nu,180225512,"Túi Ví Nữ Cầm Tay Thời Trang Mini Cao Cấp Sang Trọng Lịch Sự Đựng Chìa Khóa, Son Môi - M1",65000,80000,15000,19
TIKI,tui-vi-nu,53598383,"Cặp Xách , Túi Xách Công Sở Thời Trang Nam P099",289000,375000,86000,23
TIKI,tui-vi-nu,157199182,"Túi vải bố cao cấp LMCATION",36000,39000,3000,8
TIKI,tui-vi-nu,192031857,"Ví Nữ Mini Cầm Tay Chính Hãng MICOCAH Bóp Nữ Mini Phối Vân Da Rắn Nhỏ Gọn Nhiều Ngăn Tiện Dụng Da Cao Cấp Cực Đẹp Giá Rẻ MC49 - Micocah Mall",169000,169000,0,0
TIKI,tui-vi-nu,77445531,"TÚI XÁCH NỮ ĐEO CHÉO (TX-093-1)",69000,69000,0,0
TIKI,tui-vi-nu,55409165,"Túi xách đeo vai nữ thời trang, sang trọng 0962",165000,165000,0,0
TIKI,tui-vi-nu,189897281,"Đeo chéo nữ Thời Trang công sở cao cấp – DCNU1001",200000,400000,200000,50
TIKI,tui-vi-nu,72701832,"móc khóa móc phụ kiện túi xách 1 cặp",29000,29000,0,0
TIKI,tui-vi-nu,186350260,"Túi xách nam công sở da tự nhiên cao cấp phong cách mới",711000,790000,79000,10
TIKI,tui-vi-nu,2020651,"Ví Nữ Da Đà Điểu 1 Khóa Huy Hoàng HT3423 (19 x 10.5 cm) - Đen",1499000,1499000,0,0
TIKI,tui-vi-nu,106657155,"Túi clucth cầm tay, clutch Quảng Châu, ví dài, ví da, ví da cao cấp, ví nữ, clutch dự tiệc, túi công sở",286000,286000,0,0
TIKI,tui-vi-nu,108696893,"Ví ngắn cầm tay Prettyzys/Pritti 2021 thiết kế in hoa đơn giản (PTZ95)",210000,210000,0,0
TIKI,tui-vi-nu,143282150,"HJ6201-02-03-04 - Túi xách nữ Huy Hoàng da cá sấu hộp vuông nhiều màu",10499000,10499000,0,0
TIKI,tui-vi-nu,175542103,"Túi da bò",999000,999000,0,0
TIKI,tui-vi-nu,11886861,"Túi mây tre đan trơn mấn góc - Nhỏ 18cm",199000,219000,20000,9
TIKI,tui-vi-nu,125100755,"Bộ 2 Ví đựng hộ chiếu giấy tờ và thẻ 12 ngăn (hồng , xanh nhạt)",69000,69000,0,0
TIKI,tui-vi-nu,209414568,"Ví nữ dài 2 ngăn 2 khóa tiện dụng cực chất Q",113000,113000,0,0
TIKI,tui-vi-nu,13215443,"Túi nữ cao cấp da thật ELLY- ET92",1949350,2999000,1049650,35
TIKI,tui-vi-nu,201697057,"Túi xách nữ tuổi trung niên mần sui- túi đi tiệc trung niên đính đá form da mềm sang trọng(túi tặng mẹ,bà)",299000,299000,0,0
TIKI,tui-vi-nu,42240058,"Túi đựng điện thoại đeo chéo thời trang dọc nắp Trơn ép chữ N7 Shalla",83160,120120,36960,31
TIKI,tui-vi-nu,174567090,"Túi dựng điện thoại đeo chéo đeo vai dáng balo mini nữ rẻ đẹp LH -009",88000,88000,0,0
TIKI,tui-vi-nu,26191856,"Túi đeo chéo mini cho nữ chất liệu vài poly",77468,81545,4077,5
TIKI,tui-vi-nu,54053319,"Túi đeo chéo Nữ đựng điện thoại - C02A",150000,150000,0,0
TIKI,tui-vi-nu,184069057,"HAVAIANAS - Túi đeo chéo mini hình thang hiện đại Bucket 4146864",450000,450000,0,0
TIKI,tui-vi-nu,188057302,"Túi đeo chéo họa tết vải dù chống thấm nước cao cấp size 20cm TUI-14",99000,99000,0,0
TIKI,tui-vi-nu,109089147,"Ví nữ mini họa tiết mèo dễ thương, ví vải chống nước cao cấp, tặng kèm dây đeo năng động",200000,200000,0,0
TIKI,tui-vi-nu,198129408,"Túi Cói Đi Biển Vintage, Giỏ Xách Cỏ Bàng Vẽ Hoa Cúc Cao Cấp, Chuẩn Đẹp TXCBVHCLTK18",339000,339000,0,0
TIKI,tui-vi-nu,187805326,"Túi xách nữ dễ thương NASI T1042 túi vải bố canvas cầm tay đẹp đeo vai thời trang hàn quốc",79000,79000,0,0
TIKI,tui-vi-nu,55057031,"Túi tote vải canvas đi học,đi chơi phon cách Hàn Quốc siêu hot",54900,54900,0,0
TIKI,tui-vi-nu,187828611,"Túi đeo chéo nữ vải dù trần trám 4 ngăn chống nước, phong cách Hàn Quốc Size 22cm",129000,129000,0,0
TIKI,tui-vi-nu,10014247,"Túi đeo chéo TROY YM in logo Chelsea",199000,199000,0,0
TIKI,tui-vi-nu,36285599,"TÚI ĐEO CHÉO ĐỰNG ĐIỆN THOẠI HÌNH GẤU",110000,122000,12000,10
TIKI,tui-vi-nu,147197355,"Túi Hậu Môn Nhân Tạo 2 Mảnh- Hollister (Trong, Sử Dụng Kẹp), 18102 / 18103 / 18104 -VT0737",454000,454000,0,0
TIKI,tui-vi-nu,180226070,"Túi Ví Nữ Cầm Tay Thời Trang Mini Cao Cấp Sang Trọng Lịch Sự Đựng Chìa Khóa, Son Môi - M2",75000,85000,10000,12
TIKI,tui-vi-nu,53501336,"Túi đeo chéo nữ Hàn Quốc",68000,68000,0,0
TIKI,tui-vi-nu,149764208,"Túi xách nữ đeo chéo họa tiết hoa văn độc đáo thời trang cao cấp phong cách Hàn Quốc",139000,139000,0,0
TIKI,tui-vi-nu,58394274,"Túi Xách Nữ Thời Trang Cao Cấp Phong Cách Hàn Quốc N0210",395000,395000,0,0
TIKI,tui-vi-nu,35326773,"Túi xách nam da thật ELLY HOMME – ETM4",3199000,3199000,0,0
TIKI,tui-vi-nu,35857223,"Túi Xách Nữ Đeo Chéo Phong Cách Ngọc Trinh BT19",55000,55000,0,0
TIKI,tui-vi-nu,71930976,"Túi đeo chéo/Túi bao tử nữ thời trang cao cấp, thiết kế độc, lạ, cá tính hot trend 2020-2021",85000,85000,0,0
TIKI,tui-vi-nu,72032325,"Túi xách nữ thời trang cao cấp ELLY- EL139",899400,1499000,599600,40
TIKI,tui-vi-nu,53769045,"Túi đeo chéo nam nữ thời trang Hàn quốc BEE GEE 085 chống thấm nước",55000,110000,55000,50
TIKI,tui-vi-nu,160314695,"Ví Nữ Dài Cầm Tay Chính Hãng TAILIAN Thời Trang Đựng Tiền Da Cao Cấp Cực Đẹp Giá Rẻ TL08 - Micocah Mall",119000,119000,0,0
TIKI,tui-vi-nu,59288059,"Balo đeo chéo LATA BALC26",360000,360000,0,0
TIKI,tui-vi-nu,52758151,"Túi TOTE Thiết Kế Thời Trang Hàn Quốc",89000,89000,0,0
TIKI,tui-vi-nu,112049090,"Túi đeo chéo thời trang nữ mini đi chơi dự tiệc cao cấp, Túi xách nữ đẹp HT21",55000,55000,0,0
TIKI,tui-vi-nu,209414471,"Túi đựng điện thoại kiêm ví đeo chéo hoa cúc TXNHC149",142000,142000,0,0
TIKI,tui-vi-nu,180720785,"Túi Xách Thời Trang Nữ Da Thật Cao Cấp Gence TX09",1600000,1600000,0,0
TIKI,tui-vi-nu,186204178,"Túi Xách Nữ Thời Trang Cao Cấp Elly EL128",979300,1399000,419700,30
TIKI,tui-vi-nu,152015159,"Túi Tote Túi Vải Canvas",99000,99000,0,0
TIKI,tui-vi-nu,157253905,"Móc Khóa Dọc In Báo SAIGON SWAGGER Journal Card Keychain",150000,150000,0,0
TIKI,tui-vi-nu,73613463,"Túi Vải Đeo Chéo Gấu Bông Hàn Quốc",31000,43296,12296,28
TIKI,tui-vi-nu,67211257,"Túi đeo chéo nữ để điện thoại TCHE1 phong cách trẻ trung, năng động tặng kèm 2 nút bảo vệ đầu sạc điện thoại",56000,79827,23827,30
TIKI,tui-vi-nu,184071608,"Túi xách nữ 1992 s t u d i o / LILY BAG /  màu đen kẹp nách",199000,199000,0,0
TIKI,tui-vi-nu,32859275,"Cặp da công sở cao cấp chính hãng Mandino M383 màu đen",3600000,3600000,0,0
TIKI,tui-vi-nu,157254411,"Túi Đeo Chéo Nam Nữ Ngang In Họa Tiết Báo SAIGON SWAGGER SGS Journal Cross Body Bag",420000,420000,0,0
TIKI,tui-vi-nu,52658437,"Túi xách đeo vai nữ combo 2 thời trang KDR20",86000,121770,35770,29
TIKI,tui-vi-nu,4353437,"Túi đựng ipad Simplecarry LC Ipad3",390000,390000,0,0
TIKI,tui-vi-nu,121977360,"Túi đeo mini dạo phố ",198000,198000,0,0
TIKI,tui-vi-nu,147942526,"Túi Xách Nữ Đeo Chéo MICOCAH Dáng Công Sở Thời Trang Vân Quả Trám Sang Trọng Thanh Lịch Da Cao Cấp Cực Đẹp MC61 - Tukado",429000,429000,0,0
TIKI,tui-vi-nu,108254287,"Ví Dài Nam Nữ, Ví Cầm Tay Da mềm Cao Cấp",190000,190000,0,0
TIKI,tui-vi-nu,51288506,"Túi xách nữ công sở bản to",245000,245000,0,0
TIKI,tui-vi-nu,157254029,"Túi Đeo Chéo Nam, Nữ 1 Khóa SAIGON SWAGGER SGS Cross Bag",330000,330000,0,0
TIKI,tui-vi-nu,79411724,"Túi đeo đựng điện thoại thời trang - màu ngẫu nhiên ( tặng móc khoa đa năng )",44344,46678,2334,5
TIKI,tui-vi-nu,175464629,"Túi Xách Kẹp Nách Đeo Vai Nữ Đẹp Đi Chơi Phong Cách Thời Trang Hàn Quốc Dễ Thương",120000,120000,0,0
TIKI,tui-vi-nu,77200181,"[VOUCHER 30K] Ví cầm tay nữ thời trang LATA VN51",269000,350000,81000,23
TIKI,tui-vi-nu,160314132,"Ví Nữ Dài Cầm Tay Chính Hãng FOREVER YOUNG Thanh Lịch Sang Trọng Nhiều Ngăn Tiện Dụng FY10 - Micocah Mall",159000,159000,0,0
TIKI,tui-vi-nu,195511701,"MLB - Túi bucket đeo chéo Basic Big Logo 3ABMS072N",3290000,3290000,0,0
TIKI,tui-vi-nu,199520547,"Túi xách nữ silicon lụa phong cách Hàn Quốc",149000,149000,0,0
TIKI,tui-vi-nu,31711116,"Túi đeo chéo đựng điện thoại thời trang + tặng vòng đeo tay",90000,90000,0,0
TIKI,tui-vi-nu,193762964,"Túi Đeo Chéo Nam Nữ  SAIGON SWAGGER SGS Double Zip Bag",350000,350000,0,0
TIKI,tui-vi-nu,186636029,"Túi Cói, Túi Xách Cỏ Bàng Vẽ Hoa Mỹ Nghệ Cao Cấp, Chuẩn Đẹp-TXCBVHGLTK05",329000,329000,0,0
TIKI,tui-vi-nu,32860122,"Túi Đeo Chéo Thời Trang Họa Tiết Sọc",271000,271000,0,0
TIKI,tui-vi-nu,176681270,"Túi xách nữ bản to _ Túi nữ thời trang công sở đựng vừa A4",125000,125000,0,0
TIKI,tui-vi-nu,194414981,"Túi Xách Lục Bình Thêu Hoa Sang Trọng Chuẩn Đẹp, Giỏ Cói Đi Biển, Túi Du Lịch TXLBTHDSLLTK02",419000,419000,0,0
TIKI,tui-vi-nu,90432070," TÚI CÓI ĐI BIỂN MERCI SANG CHẢNH PHONG CÁCH HÀN QUỐC",39971,39971,0,0
TIKI,tui-vi-nu,106867104,"Combo Túi Đựng Thẻ Trong Suốt Nhựa Dẻo Đa Năng",14000,18942,4942,26
TIKI,tui-vi-nu,71516745,"Túi xách nữ thời trang cao cấp ELLY – EL146",1399000,1399000,0,0
TIKI,tui-vi-nu,248990332,"Dây kéo 2 chiều răng 5 (không kèm đầu khóa)",62000,62000,0,0
TIKI,tui-vi-nu,198511611,"Túi đeo chéo da bò Mercury Bụi Leather - DC107 Da bò Nappa cao cấp, bảo hành 12 tháng",460000,715000,255000,36
TIKI,tui-vi-nu,174518731,"Ví đựng hộ chiếu Passport giấy tờ xe, thẻ thời trang chất liệu da bò cao cấp 40596",150000,150000,0,0
TIKI,tui-vi-nu,77445984,"Túi Xách Nữ - Túi Cầm Tay Nữ - Clutch Dự Tiệc (TX-074)",359000,359000,0,0
TIKI,tui-vi-nu,174468742,"Ví Nữ Ngắn Mini Cầm Tay TAILIAN Dáng Gập Nhỏ Gọn Nhiều Ngăn Tiện Dụng Da Đẹp Giá Rẻ TL01",99000,99000,0,0
TIKI,tui-vi-nu,153411140,"Túi Đeo Chéo Mini Cho Bé POP IT Phiên Bản Gỉai Tỏa Căng Thẳng Nhiều Màu",39000,65000,26000,40
TIKI,tui-vi-nu,250692203,"Túi Tote Vải Canvas Có Khóa Phong Cách Hàn Quốc",90160,90160,0,0
TIKI,tui-vi-nu,54029584,"Ví cầm tay nữ 2 ngăn kéo sang trọng , thiết kế nhiều ngăn tiện dụng TK0048",76000,100000,24000,24
TIKI,tui-vi-nu,182805698,"Túi xách nữ Monogram Canvas ELLY – EL198",1799000,1799000,0,0
TIKI,tui-vi-nu,177579514,"Ví nữ dài cầm tay chính hãng TAILIAN thời trang đựng tiền da cao cấp nhiều ngăn tiện dụng TL39",139000,139000,0,0
TIKI,tui-vi-nu,42125853,"Túi đeo nữ mini H0001",39000,70000,31000,44
TIKI,tui-vi-nu,151901545,"Túi Tote Vải Canvas Nữ Có Khóa Ulzzang Hot Trend Kita Unisex - Mẫu MÈO CUTE - Ảnh thật",69000,69000,0,0
TIKI,tui-vi-nu,209414547,"Ví nữ dài cầm tay hai ngăn phối màu VND100 tam thể hai khóa",112000,112000,0,0
TIKI,tui-vi-nu,128291458,"Phụ kiện hoạt hình gắn túi , balo",6000,6000,0,0
TIKI,tui-vi-nu,78959563,"TÚI DA BÒ HANDMADE",669000,669000,0,0
TIKI,tui-vi-nu,90163531,"Túi Vải Canvas Đeo Chéo Nhật Bản ️ HOTTREND ️ Túi đeo chéo kẻ caro mini nữ thời trang tặng sticker TN76",69000,69000,0,0
TIKI,tui-vi-nu,209414012,"Túi xách nữ thời trang hottrend siêu xinh đeo chéo ngang nhiều màu tôn dáng giá rẻ",181000,181000,0,0
TIKI,tui-vi-nu,136060606,"Túi Xách Cặp Da Nam Công Sở GENCE CGL08 Chất Liệu Da Bò Khóa Số Cao Cấp Màu Đen",3200000,3200000,0,0
TIKI,tui-vi-nu,77444976,"Túi Xách Nữ - Túi Cầm Tay Nữ - Clutch Dự Tiệc (TX-113)",359000,359000,0,0
TIKI,tui-vi-nu,165627374,"Túi đeo chéo nữ mini đựng điện thoại phong cách Hàn Quốc",99000,99000,0,0
TIKI,tui-vi-nu,158720856,"Túi đeo chéo da nữ thời trang Hàn Quốc DT135TI",99000,99000,0,0
TIKI,tui-vi-nu,184918441,"Túi xách nữ thời trang công sở cao cấp phong cách mới – TN1008",210000,420000,210000,50
TIKI,tui-vi-nu,252721792,"Túi Clutch dự tiệc sang chảnh quý phái tôn dáng nổi bật VDT02",250000,250000,0,0
TIKI,tui-vi-nu,157254351,"Ví Đựng Thẻ Card Holder SAIGON SWAGGER Journal Zip Card Case",230000,230000,0,0
TIKI,tui-vi-nu,31622709,"Túi đeo chéo 2 ngăn đựng điện thoại",150000,150000,0,0
TIKI,tui-vi-nu,37652811,"Túi vải đay HELLO WEEKEND",269000,269000,0,0
TIKI,tui-vi-nu,195566885,"Túi vải balo đeo vai E&S Messenger Unisex chống thấm nước , nhiều ngăn túi du lịch, công sở ,học sinh, sinh viên BL009",238000,280000,42000,15
TIKI,tui-vi-nu,57100783,"Túi xách nữ kiểu dáng trẻ trung SW48",149000,149000,0,0
TIKI,tui-vi-nu,194456982,"Túi đựng tiền, túi đựng đồ mini phong cách Châu Âu mã 1042 - ĐEN	Túi đựng tiền, túi đựng đồ mini phong cách Châu Âu mã 1042",179000,329000,150000,46
TIKI,tui-vi-nu,70906430,"Túi cói xách tay kiểu dáng vintage",189000,189000,0,0
TIKI,tui-vi-nu,86560782,"Túi đeo chéo    Túi vải mini tai thỏ siêu dễ thương thiết kế Hàn Quốc TV05",52000,52000,0,0
TIKI,tui-vi-nu,77548527,"Túi Đeo chéo nữ gấu thời trang cho bé hình chuột GG01 Tặng móc khóa thỏ trắng",58410,79827,21417,27
TIKI,tui-vi-nu,8114416,"Túi Xách Nữ Cao Cấp Da Thật Elly ET79",1689350,2599000,909650,35
TIKI,tui-vi-nu,13090538,"Túi đựng điện thoại 2 dây đeo đẹp cho bạn gái",59000,59000,0,0
TIKI,tui-vi-nu,104944481,"Túi đeo chéo đi học, đi làm, đi chơi thời trang dành cho nữ TUI005",119000,119000,0,0
TIKI,tui-vi-nu,74463160,"Ví Đựng Thời Trang Tiện Ich HARAS V268",35000,35000,0,0
TIKI,tui-vi-nu,157254320,"Túi Đeo Chéo Nam,Nữ SAIGON SWAGGER Cross Body Mini Bag",390000,390000,0,0
TIKI,tui-vi-nu,107962577,"Ví Đựng Thẻ/ Ví Da Mini Handmade Đựng Tiền Sành Điệu Sang Chảnh",99000,99000,0,0
TIKI,tui-vi-nu,177594039,"Ví đựng hộ chiếu Passport giấy tờ xe, thẻ thời trang chất liệu da bò cao cấp 40596",177651,177651,0,0
TIKI,tui-vi-nu,157479189,"ví bóp nữ cầm tay nhiều ngăn dáng dài sang trọng đi tiệc cưới - PL9283",138000,259000,121000,47
TIKI,tui-vi-nu,209414357,"Ví bóp nữ cầm tay da trơn mềm xinh xắn dễ phối đồ cobala ví túi xinh",141000,141000,0,0
TIKI,tui-vi-nu,191995263,"Vỏ bao hộ chiếu (passport) dẻo trong có khe đựng vé máy bay và các thoại thẻ hiệu bamarau B132",2999,2999,0,0
TIKI,tui-vi-nu,113039984,"Túi đeo chéo nữ công sở dạo phố thời trang cao cấp",99000,99000,0,0
TIKI,tui-vi-nu,169354370,"Clutch nhung đính đá tua rua cao cấp-túi nhung đá đi tiệc siêu sang",320000,320000,0,0
TIKI,tui-vi-nu,114358110,"Túi xách túi đeo chéo nữ khóa dây da dây xích phối đẹp mắt",75000,75000,0,0
TIKI,tui-vi-nu,112210007,"Túi đeo chéo nữ công sở cao cấp họa tiết sang trọng nhiều ngăn tặng kèm móc gấu",159000,159000,0,0
TIKI,tui-vi-nu,77445862,"Túi Xách Nữ - Túi Cầm Tay Nữ - Clutch Dự Tiệc (TX-110)",359000,359000,0,0
TIKI,tui-vi-nu,52890054,"Ví Nữ Ngắn Thời Trang Cao Cấp HNN20-Tặng Kèm 01 Sản Phẩm Ngẫu Nhiên",99000,99000,0,0
TIKI,tui-vi-nu,109343837,"Ví thời trang Teen ZAKOMI hình mèo vải cao cấp chống nước ZVIMEO - Bảo hành 12 tháng",200000,200000,0,0
TIKI,tui-vi-nu,11186154,"Túi đeo vai ANELLO đeo 2 kiểu vải polyester chịu nhiệt cỡ nhỏ AT-C1839 - Màu",1840000,1840000,0,0
TIKI,tui-vi-nu,44148141,"Túi Vải Tote Canvas Cao Cấp, Dày Dặn Hình Hoa Cúc Họa Mi, Phong Cách Basic",88900,88900,0,0
TIKI,tui-vi-nu,125100701,"Ví Cầm Tay Kim Tuyến Đi Tiệc chodeal24h.com (Vàng gold)",59000,59000,0,0
TIKI,tui-vi-nu,188385295,"Túi xách nữ Da Bò 100% Cao Câp  Vừa Túi đeo chéo, Cầm Tay - Thời trang Nhật Bản và Hàn Quốc kết hợp sản xuất ",756000,756000,0,0
TIKI,tui-vi-nu,247745940,"Túi Xách Nữ ️️ Túi Nữ Da Mềm Luxury thời trang, phong cách trẻ trung mã số LXRBB0012",79000,79000,0,0
TIKI,tui-vi-nu,248990778,"Dây kéo 1 chiều răng 5 (không kèm đầu khóa)",40000,40000,0,0
TIKI,tui-vi-nu,120524879,"Ví nữ da đà điểu Huy Hoàng 1 khóa thụt màu đen HC3462",2199000,2199000,0,0
TIKI,tui-vi-nu,183243463,"Túi Tote canvas - Hoa ghi - thêu tay thủ công, nữ tính, gọn nhẹ",325000,325000,0,0
TIKI,tui-vi-nu,196544947,"Túi tote, túi đeo chéo bằng vải canvas cao cấp",89000,89000,0,0
TIKI,tui-vi-nu,136313446,"Cặp Da Công Sở Túi Xách Nam GENCE GCE14 Chất Liệu Da Bò Cao Cấp Màu Đen Có Dây Đeo Vai",2400000,2400000,0,0
TIKI,tui-vi-nu,149179245,"Túi xách công sở POLO da bò cao cấp, đựng vừa laptop 14 inch",950000,950000,0,0
TIKI,tui-vi-nu,152951458,"Túi Cói, Túi Trụ Hoa và Túi Trụ Lủng Lẳng",265000,265000,0,0
TIKI,tui-vi-nu,12302486,"Cặp đeo chéo in logo MU",250000,250000,0,0
TIKI,tui-vi-nu,174399995,"Túi Đeo Chéo Nữ Đựng Điện Thọai FOREVER YOUNG Dáng Vuông Nhiều Ngăn Đựng Chất Bền Đẹp FY15",249000,249000,0,0
TIKI,tui-vi-nu,107037353,"Túi Đi Chùa # Đãi Nhỏ Lớn Đủ Size, Đủ Màu",84000,84000,0,0
TIKI,tui-vi-nu,194026277,"Clutch nam cầm tay ",2850000,5000000,2150000,43
TIKI,tui-vi-nu,187143312,"Túi đeo chéo NASI T1031 phong cách hàn quốc túi xách nữ đeo vai thời trang dạo phố dễ thương vải đẹp",49000,49000,0,0
TIKI,tui-vi-nu,168356847,"Ví cầm tay nữ nam nhỏ gọn bỏ túi nhiều ngăn da thật cao cấp thời trang PANDAGO Pandora 02 đáng đứng",430000,430000,0,0
TIKI,tui-vi-nu,180991605,"Túi Cói, Túi Xách Cỏ Bàng Vẽ Hoa Tú Cầu Cao Cấp, Chuẩn Đẹp",329000,329000,0,0
TIKI,tui-vi-nu,157146729,"(Chất Đẹp) Ví Da Đựng Giấy Tờ Theo Hãng Xe",30000,30000,0,0
TIKI,tui-vi-nu,120524458,"HC3759 - Ví nữ da cá sấu Huy Hoàng ngăn thụt cầm tay màu đen",2999000,2999000,0,0
TIKI,tui-vi-nu,86561948," Túi vải    Túi Đeo Chéo Vải Bố Phong Cách Hàn Quốc Xinh Xắn Dành Cho Nữ TV09",69500,69500,0,0
TIKI,tui-vi-nu,149919285,"Túi xách kẹp nách đeo vai nữ đẹp giá rẻ đi chơi phong cách thời trang hàn quốc dễ thương cute DC280",75000,75000,0,0
TIKI,tui-vi-nu,72098593,"Ví nữ cầm tay thời trang cao cấp ELLY – EV72",699000,699000,0,0
TIKI,tui-vi-nu,128490251,"Túi tote vải đeo vai nhung tăm hình gấu thêu 3 nút bấm form túi cứng cáp sang xịn mịn mã TP1 | tiemtuitotebypat",77900,77900,0,0
TIKI,tui-vi-nu,188902643,"Túi đeo vai Petit (Túi đeo vai vải linen vintage) - May's Tote Bag",190000,190000,0,0
TIKI,tui-vi-nu,136940022,"Túi thổ cẩm quai gỗ 7002",50000,50000,0,0
TIKI,tui-vi-nu,190732039,"Túi tote túi vải canvas quai da bò.",150000,150000,0,0
TIKI,tui-vi-nu,270272499,"Ví đựng thẻ card Chico có khóa kéo da bò thật - Pink Ohara Leather",270000,270000,0,0
TIKI,tui-vi-nu,74775955,"Ví cầm tay thêu thời trang nữ - V Clutch 08",270000,270000,0,0
TIKI,tui-vi-nu,155609024,"Ví nữ HANHSON da đà điểu màu xanh",1050000,1050000,0,0
TIKI,tui-vi-nu,194026682,"Túi  Đeo Chéo Nữ Mini  Đựng Điện Thoại, Đồ Trang Điểm Đi Làm, Đi Chơi, Đi Học  Phong Cách Hàn Quốc ",100000,100000,0,0
TIKI,tui-vi-nu,148697671,"Ví đựng passport đựng thẻ và vật dụng du lịch P-Travel Design - D375",246000,246000,0,0
TIKI,tui-vi-nu,143112660,"Ví Vải Modern Fabric Vertical Wallet HAVIAS",280000,350000,70000,20
TIKI,tui-vi-nu,67107403,"Túi đeo chéo thêu thời trang nữ - Hai bông hoa",250000,250000,0,0
TIKI,tui-vi-nu,55456820,"VÍ NỮ MINI GẬP GỌN SIÊU XINH V07",125000,250000,125000,50
TIKI,tui-vi-nu,196966150,"Túi Cói, Túi Xách Cỏ Bàng Vẽ Hoa Sen Đẹp Tinh Tế, Sang Trọng-TXCBVHSHLTK06",339000,339000,0,0
TIKI,tui-vi-nu,128857429,"HJ3101-02-03-04 - Bóp nữ da thật vân cá sấu Huy Hoàng 2 gấp vân nhỏ màu da, đen, nâu, vàng bò",839000,839000,0,0
TIKI,tui-vi-nu,72035248,"Ví nữ cầm tay thời trang cao cấp ELLY – EV74",699000,699000,0,0
TIKI,tui-vi-nu,157479174,"[FREESHIP]bóp ví nữ Pierre Loues đựng vừa điện thoại 6.2", để thẳng tiền, thắt nơ cách điệu - PL6818",229000,229000,0,0
TIKI,tui-vi-nu,197890368,"Túi đeo chéo đựng điện thoại hoạ tiết gấu dễ thương ngăn sau trong suốt cảm ứng tiện lợi TK003",49000,98000,49000,50
TIKI,tui-vi-nu,136940234,"TÚI THỔ CẨM ĐEO CHÉO LOẠI BÓP ĐẦM",35000,35000,0,0
TIKI,tui-vi-nu,205081399,"Túi xách nữ công sở đeo chéo kẹp nách đeo vai tote da thời trang cao cấp MX078",789000,789000,0,0
TIKI,tui-vi-nu,136940008,"Túi thổ cẩm quai gỗ 7001",50000,50000,0,0
TIKI,tui-vi-nu,198577449,"Túi Xách Nữ Kẹp Nách Chần Trám Dây Xích To Alva Bag Thương Hiệu GIPSY",780000,780000,0,0
TIKI,tui-vi-nu,77233305,"Túi Xách Tole Nữ dạo phố kèm Gấu giấu trong đáng yêu FR11 Tặng móc khóa cá heo",68000,96063,28063,29
TIKI,tui-vi-nu,200671780,"TÚI XÁCH DA NỮ ĐEO VAI KHÓA KÉO LIBERAL YLYN134",200000,200000,0,0
TIKI,tui-vi-nu,58416552,"Túi Xách Tay Và Đeo Chéo Kẻ Ô Kèm Phụ Kiện Hoa Hồng",100000,100000,0,0
TIKI,tui-vi-nu,193720405,"VÍ CẦM TAY NAM HỌA TIẾT DA CÁ SẤU",450000,450000,0,0
TIKI,tui-vi-nu,57173375,"Ví đựng thẻ thời trang cao cấp CL-022",99000,99000,0,0
TIKI,tui-vi-nu,100000538,"Túi xách nữ da mểm cao cấp",380000,380000,0,0
TIKI,tui-vi-nu,249457427,"Túi Xách Nữ Đựng Vừa A4 Thanh Lịch Sang Trọng ZTX04",169000,315000,146000,46
TIKI,tui-vi-nu,177859868,"túi đeo chéo nữ,túi đeo vai thời trang phong cách đơn giản dễ phối đồ phù hợp với mọi lứa tuổi (hình ảnh shop tự chụp cam kết 100%)",167000,167000,0,0
TIKI,tui-vi-nu,206651826,"Ví Đựng Thẻ Card Holder Nam Nữ Songhan Leather WL01.Ví MiNi Da Bò Thật Cao Cấp Nhỏ Gọn Gập Đôi Nhiều Ngăn Thời Trang",259000,259000,0,0
TIKI,tui-vi-nu,248990159,"Móc càng cua màu đen",24000,24000,0,0
TIKI,tui-vi-nu,203913255,"Túi Xách Nữ Đeo Chéo Đeo Vai Quảng Châu Cao Cấp Đi Học Đi Chơi Siêu Xinh TUVIDA_VN TX18 Túi Tote",183750,183750,0,0
TIKI,tui-vi-nu,22363108,"Túi cói đan móc vintage",99000,99000,0,0
TIKI,tui-vi-nu,35346241,"Clutch tiệc cầm tay phong cách sao Hàn",230000,230000,0,0
TIKI,tui-vi-nu,127645703,"Túi cói merci loại 1 màu sáng, có đệm đáy",40988,40988,0,0
TIKI,tui-vi-nu,164961179,"Túi đeo chéo, đeo vai nữ mini da cao cấp T0229 Khóa gài chống thấm nước, bền bỉ phong cách thời trang Hàn",130000,260000,130000,50
TIKI,tui-vi-nu,16018257,"Ví da bò Vinalea VUN0006E",155000,155000,0,0
TIKI,tui-vi-nu,144613795,"Túi đeo chéo nữ -túi đeo chéo đựng điện thoại khoá sập 20",120000,120000,0,0
TIKI,tui-vi-nu,173169248,"Túi Cói, Túi Cói Đi Biển, Giỏ Cói, Giỏ Lục Bình Quai Mây Sang Trọng-Thủ Công Mỹ Nghệ Cao Cấp",295000,295000,0,0
TIKI,tui-vi-nu,160314163,"Ví Nữ Mini Cầm Tay PERFECT FOR YOU Gấp 3 Nhỏ Gọn Nhiều Ngăn Tiện Dụng Chất Da Cao Cấp Cực Đẹp PFY11 - Micocah Mall",129000,129000,0,0
TIKI,tui-vi-nu,1940615,"Cặp Công Sở Yuumy Cayuumy 03 Đen",225000,315000,90000,29
TIKI,tui-vi-nu,82874016,"Túi xách nam công sở cao cấp phong cách mới",423000,470000,47000,10
TIKI,tui-vi-nu,117294101,"Túi xách,đeo vai bằng vải viền da phong cách Ulzzang 2 trong 1 có 3 màu xinh yêu ( hàng có sẵn)",115000,115000,0,0
TIKI,tui-vi-nu,22670247," Túi móc treo",369000,369000,0,0
TIKI,tui-vi-nu,118026376,"TÚI ĐI CHÙA # Giỏ Xách Adi # Bị # Túi Vải",30000,30000,0,0
TIKI,tui-vi-nu,193720488,"VÍ CẦM TAY THIẾT KẾ SANG TRỌNG",350000,350000,0,0
TIKI,tui-vi-nu,56402731,"túi chim cánh cụt",110000,110000,0,0
TIKI,tui-vi-nu,67096510,"Túi đeo chéo thêu thời trang nữ - Hoa Cúc",250000,250000,0,0
TIKI,tui-vi-nu,183736392,"1.	Túi xách nữ đẹp FA FTX1",550000,550000,0,0
TIKI,tui-vi-nu,172977126,"Túi vải bố, Túi vải Canvas trơn Màu Trắng - Màu Đen Màu Be Size 36cm x 31cm",25000,25000,0,0
TIKI,tui-vi-nu,150992317,"Bóp ví nữ cầm tay mini V0514 Hi Cow bỏ túi nhiều ngăn nhỏ gọn phong cách đơn giản, thời trang, dễ thương",25000,50000,25000,50
TIKI,tui-vi-nu,88085617,"Túi xách nữ ,Túi đeo vai nữ da vân cao cấp khóa cúc nổi bật sang trọng và thời thượng",75000,75000,0,0
TIKI,tui-vi-nu,16052918,"Ví da bò Unisex Vinalea VUN0003E",155000,155000,0,0
TIKI,tui-vi-nu,149449628,"Túi đeo chéo - Túi xách nữ kiểu dáng yên ngựa chất mềm hai dây đeo bản to thời trang",243000,243000,0,0
TIKI,tui-vi-nu,71486903,"Túi kẹp nách nữ thời trang sọc Caro trẻ trung, hợp xu hướng TK0062",50000,100000,50000,50
TIKI,tui-vi-nu,101861404,"Túi Cói Đi Biển, Túi Xách Cấm Tay Đi Chơi, Đi Picnic Xinh Xắn - Mã TUI27",49000,49000,0,0
TIKI,tui-vi-nu,157253910,"Ví Nắp Da In SAIGON SWAGGER Eclipse Short Flap Wallet",480000,480000,0,0
TIKI,tui-vi-nu,187852573,"Túi xách nữ dễ thương NASI T1045 vải cói pu cầm tay đẹp túi tote đeo vai có nút bấm thời trang cho nữ công sở, học sinh",38000,44900,6900,15
TIKI,tui-vi-nu,56992965,"Túi xách nữ thời trang công sở cao cấp kiểu dáng đơn giản",199000,199000,0,0
TIKI,tui-vi-nu,112096703,"cặp da công sở P075 - Nâu 2 ngăn",425000,425000,0,0
TIKI,tui-vi-nu,180720756,"Túi Xách Thời Trang Nữ Da Thật Cao Cấp Gence TX08",1600000,1600000,0,0
TIKI,tui-vi-nu,185927313,"[ Hàng cao cấp]- Túi cói đeo vai túi tote cói phong cách vintage",280000,280000,0,0
TIKI,tui-vi-nu,74901478,"Túi xách da bò nam cao cấp phong cách mới 15.6"",882000,980000,98000,10
TIKI,tui-vi-nu,160314370,"Túi Xách Đeo Chéo Nữ Kẹp Nách MICOCAH Kiểu Dáng Công Sở Thời Trang Da Cao Cấp Cực Đẹp Mẫu Mới 2020 MC57",389000,389000,0,0
TIKI,tui-vi-nu,147943148,"Túi Xách Nữ Đeo Chéo Kẹp Nách Chính Hãng MICOCAH Dáng Công Sở Thời Trang Thanh Lịch Sang Trọng MC37 - Tukado",389000,389000,0,0
TIKI,tui-vi-nu,58009772,"Túi Xách Nữ Da PU Thời Trang 9126",215000,215000,0,0
TIKI,tui-vi-nu,49196427,"Túi đeo chéo Forever Love nhiều ngăn dây bản to thời trang",55000,55000,0,0
TIKI,tui-vi-nu,157944278,"Ví dài cầm tay nữ phong cách dễ thương trẻ trung YUUMY YV35 - Màu Đen trơn",165000,320000,155000,48
TIKI,tui-vi-nu,73341059,"TÚI NHỎ ĐEO CHÉO Mini Tiện Lợi SQUARE Vải Canvas Cao Cấp Chống Thấm Nước Unisex Nam Nữ Chuẩn Nome DOLANTO",98000,98000,0,0
TIKI,tui-vi-nu,199681840,"Money Clip Wallet - Ví kẹp tiền da nam đựng thẻ Carbon RFID tối đa đến 15 thẻ",290000,290000,0,0
TIKI,tui-vi-nu,73261538,"Ví cầm tay bảng to sang trọng siêu năng kẹp nút Bi Tròn Tặng móc khóa cá heo",114000,161007,47007,29
TIKI,tui-vi-nu,157254041,"Túi Đeo Chéo Nam,Nữ SAIGON SWAGGER Dynamic Bag-Phối Lưới Đen",350000,350000,0,0
TIKI,tui-vi-nu,58796191,"Ví đựng tiền xu mini cho bé hình thú - Giao hình ngẫu nhiên",90000,90000,0,0
TIKI,tui-vi-nu,89220547,"Ví nữ nhỏ nhiều ngăn cầm tay mini gấp 3 thời trang cute dễ thương giá rẻ LUKAMO VD70",31000,31000,0,0
TIKI,tui-vi-nu,193051873,"Ví Nữ Mini Ngắn Cầm Tay Cao Cấp Sang Trọng Phong Cách Hàn Quốc TVNN135",250000,250000,0,0
TIKI,tui-vi-nu,125100629,"Ví cầm tay ngắn Sang trọng CDVN01 (đen)",189000,189000,0,0
TIKI,tui-vi-nu,186232554,"Túi xách nữ Pu Cao Cấp Handle Bag kiểu dáng cổ điển đơn giản thời trang có thể đeo chéo hoặc xách tayTúi đeo vai - Bảo hành 1 năm",456000,456000,0,0
TIKI,tui-vi-nu,21337606,"Túi đeo bao tử - Túi đeo chéo nam nữ - Túi đeo bụng - Túi đeo ngang hông",65000,65000,0,0
TIKI,tui-vi-nu,173168307,"Túi vải bố, Túi vải Canvas trơn màu Đen không khóa kéo",23000,23000,0,0
TIKI,tui-vi-nu,37748075,"Túi tote/ Túi vải đeo vai hoa tiết quả cam nổi bật LA714",73900,73900,0,0
TIKI,tui-vi-nu,80856579,"Túi đeo chéo thời trang đi học Bin Original kèm ví nhỏ unisex hot trend",99900,99900,0,0
TIKI,tui-vi-nu,148810225,"Túi xách nữ đeo chéo kẻ caro thời trang thanh lịch phong cách Hàn Quốc",127990,127990,0,0
TIKI,tui-vi-nu,173166900,"Có Khóa Kéo Túi vải bố, Túi vải Canvas trơn Màu Trắng - Màu Be",35000,35000,0,0
TIKI,tui-vi-nu,190582814,"Ví dài nữ cầm tay khoá kéo YUUMY Seasand YV60",175000,350000,175000,50
TIKI,tui-vi-nu,193386654,"Ví Nữ Thời Trang cao cấp phong cách mới – VNU1003",155000,310000,155000,50
TIKI,tui-vi-nu,13687378,"Túi Đeo Chéo In Hình Cô Bé & Cậu Bé Cá Tính BT22",106000,106000,0,0
TIKI,tui-vi-nu,177945799,"túi đeo chéo nữ, đeo vai nữa 2 màu trắng đen  nhỏ gọn nhiều ngăn tiện lợi cho các chị em,from dáng thời trang D1122",150000,150000,0,0
TIKI,tui-vi-nu,174468832,"Ví Nữ Dài Cầm Tay Chính Hãng TAILIAN Dáng Basic Sang Trọng Thanh Lịch Da Cao Cấp Cực Đẹp Giá Rẻ TL08",119000,119000,0,0
TIKI,tui-vi-nu,186669118,"Túi đeo chéo Huazhi Yu NASI T1022 phong cách hàn quốc túi đeo vai nữ thời trang dạo phố dễ thương vải đẹp",59000,59000,0,0
TIKI,tui-vi-nu,187588694,"Túi tote đựng đồ tập thời trang nam nữ Hibi Sports A004, chất liệu Canvas cao cấp, có khóa kéo và túi trong",199000,290000,91000,31
TIKI,tui-vi-nu,121332212,"Túi tote vải bố đựng đồ canvas phong cách Hàn Quốc",55000,55000,0,0
TIKI,tui-vi-nu,53979966,"Ví nữ cầm tay cao cấp 2 ngăn kéo sang trọng, thiết kế nhiều ngăn tiện dụng TK0047",76000,100000,24000,24
TIKI,tui-vi-nu,36292879,"Túi đeo chéo vải canvas, túi vải nữ TV014, phong cách Hàn Quốc, thời trang trẻ",50000,50000,0,0
TIKI,tui-vi-nu,145412827,"Túi nhỏ vải Canvas Nhật Bản",55000,55000,0,0
TIKI,tui-vi-nu,174468953,"Ví Nữ Dài Cầm Tay Chính Hãng TAILIAN Đựng Tiền Điện Thoại Nhiều Ngăn Da Cao Cấp Cực Đẹp TL16",129000,129000,0,0
TIKI,tui-vi-nu,45350251,"Túi xách nữ thời trang công sở siêu xinh TSC258",55000,55000,0,0
TIKI,tui-vi-nu,5003423,"Túi Clutch Nữ Cao Cấp Da Thật Elly EC4",1319400,2199000,879600,40
TIKI,tui-vi-nu,176824670,"Ví Khóa Kéo Nữ mini hoạt hình cute nhỏ gọn bỏ túi thời trang tiện lợi giá rẻ nhiều ngăn VN02",80000,80000,0,0
TIKI,tui-vi-nu,43446950,"Ví da cầm tay hàng hiệu cao cấp Làng Da Việt có nhiều màu cho cả nam và nữ",395000,395000,0,0
TIKI,tui-vi-nu,72468203,"dây da phối xích, dây xích kim loại đeo vai túi xách quai túi",80000,80000,0,0
TIKI,tui-vi-nu,195318980,"Túi Đeo Chéo Nữ Màu Trơn Mini Thời Trang Túi Đựng Điện Thoại UV9-13",165000,165000,0,0
TIKI,tui-vi-nu,74892467,"[VOUCHER 30K] Ví Cầm Tay Unisex Thời Trang LATA VN48 nhiều màu (Dài 25cm x Rộng 10cm x Cao 5cm)",229000,290000,61000,21
TIKI,tui-vi-nu,225194846,"Túi xách cho nữ xinh xắn",10000,10000,0,0
TIKI,tui-vi-nu,203204738,"Túi MK Mercer Medium Logo and Leather Accordion Crossbody Bag",3840000,3840000,0,0
TIKI,tui-vi-nu,174468582,"Ví Nữ Dài Cầm Tay Chính Hãng TAILIAN Đựng Tiền Điện Thoại Da Cao Cấp Nhiều Ngăn Giá Cực Rẻ TL07",139000,139000,0,0
TIKI,tui-vi-nu,174300080,"Ví Nữ Cầm Tay Nữ 3 Ngăn Chất Liệu vải Dù Chống Thấm Nước Siêu Bền Vi-08",95000,95000,0,0
TIKI,tui-vi-nu,185992792,"Túi đeo chéo Chong ya NASI T1014 phong cách hàn quốc túi đeo nữ thời trang dễ thương vải đẹp",49000,49000,0,0
TIKI,tui-vi-nu,69470518,"Túi Xách Nữ Dáng Basic Dễ Phối Đồ, Túi Vải Canvas, Túi Vải Đeo Chéo Phong Cách Unisex Ngăn Rộng Nhiều Màu - OTV023 - Ope Store",178000,178000,0,0
TIKI,tui-vi-nu,106654179,"Ví cầm tay nữ dáng dài sang trọng, Ví nữ đựng tiền, ví bóp nữ giá rẻ, ví nữ dài cầm tay nhiều ngăn, Ví nữ cao cấp",132000,132000,0,0
TIKI,tui-vi-nu,97821264,"Combo 5 Túi Ví Đựng Bảo Vệ Chống Xước Thẻ ATM, Card Visit, CMND, Driver License Bằng Lái Xe Trong Suốt",4999,4999,0,0
TIKI,tui-vi-nu,135094940,"Túi đeo chéo Ulzzang vải bố canvas T003 nữ tai thỏ mềm, đẹp phong cách trẻ trung, cá tính",26000,52000,26000,50
TIKI,tui-vi-nu,134025673,"Ví nữ, Ví cầm tay nữ, ví nữ thời trang, ví đựng tiền, ví nữ sang trọng, Ví nữ dài cầm tay",145000,145000,0,0
TIKI,tui-vi-nu,5003059,"Túi Xách Nữ Thời Trang Cao Cấp Elly EL98",1299000,1299000,0,0
TIKI,tui-vi-nu,115495534,"Túi xách nữ  Túi đeo chéo da sần hàng quảng châu siêu hot TD20",82000,82000,0,0
TIKI,tui-vi-nu,138334086,"JUNO Ví VI162",544000,544000,0,0
TIKI,tui-vi-nu,99514361,"Ví bóp nữ mini cầm tay hình bò sữa , chất liệu da cao cấp",55000,55000,0,0
TIKI,tui-vi-nu,137155169,"Túi Tote Canvas Quai Tròn Vải Mềm Roro",59000,59000,0,0
TIKI,tui-vi-nu,67086904,"Túi xách hình vỏ sò sang trọng - giao màu ngẫu nhiên",160000,160000,0,0
TIKI,tui-vi-nu,73100759,"dây xích kim loại đeo vai túi xách quai túi loại xích tròn",90000,90000,0,0
TIKI,tui-vi-nu,71514893,"Túi xách nữ thời trang cao cấp ELLY- EL147",1119200,1399000,279800,20
TIKI,tui-vi-nu,197654021,"Túi đeo chéo ngực nam nữ trong suốt thời trang unisex túi việt kiều bumbag đeo vai VK011",145000,145000,0,0
TIKI,tui-vi-nu,196596639,"Túi giỏ xách đeo chéo, đeo vai, xách tay hình tròn thời trang nữ chất liệu da PU siêu đẹp phù hợp đi làm, đi tiệc TX057",229000,229000,0,0
TIKI,tui-vi-nu,54840715,"Túi đeo chéo nam nữ để điện thoại thời trang Hàn quốc chống thấm nước BEE GEE 084 chống thấm nước",40000,80000,40000,50
TIKI,tui-vi-nu,87939602,"Túi Đeo Chéo Nữ, Túi Chất Liệu Da Mềm Cao Cấp, Dây Đeo Chéo TC021",139000,139000,0,0
TIKI,tui-vi-nu,149449471,"Túi đeo chéo cao cấp - CEEKAY túi xách tay",499000,499000,0,0
TIKI,tui-vi-nu,71730288,"Túi clutch nữ thời trang cao cấp ELLY – ECH49",1199000,1199000,0,0
TIKI,tui-vi-nu,75448071,"TÚI ĐEO ĐA NĂNG TOMTOC (USA) CROSSBODY FOR TECH ACCESSORIES AND IPAD 10.5/PRO 11INCH/TABLET/NOTEBOOK 11INCH GRAY H02-A01G - Hàng Chính Hãng",1359000,1359000,0,0
TIKI,tui-vi-nu,153382569,"Túi đeo chéo bò sửa trong suốt không kèm phụ kiện HS1P",58000,58000,0,0
TIKI,tui-vi-nu,173748832,"Túi Xách Nữ Đeo Chéo Đơn Giản Basic, Túi Vải Canvas Nữ Đeo Chéo Cỡ Lớn - OTV148 - Ope Store",140000,140000,0,0
TIKI,tui-vi-nu,22631064,"Túi đeo vai nữ cổ điển TĐ44 Shalla",134640,194480,59840,31
TIKI,tui-vi-nu,186632836,"Túi đeo chéo Hello Girl NASI T1020 phong cách hàn quốc túi đeo vai nữ thời trang dạo phố dễ thương vải đẹp",49000,49000,0,0
TIKI,tui-vi-nu,73339899,"TÚI ĐEO CHÉO Mini Tiện Lợi DISCOVERY Vải Canvas Cao Cấp Chống Thấm Nước Unisex Nam Nữ Chuẩn Nome DOLANTO",180000,180000,0,0
TIKI,tui-vi-nu,68553531,"Ví Cầm Tay Thời Trang FALDO Chống Thấm Nước",51000,51000,0,0
TIKI,tui-vi-nu,193447892,"Túi Xách Nữ Da Thật, Túi Công Sở Cầm Tay Sang Trọng, Cao Cấp  -Túi xách nữ đeo chéo, túi xách da Thời Trang",869000,869000,0,0
TIKI,tui-vi-nu,167658366,"Túi nữ mini da mềm YUUMY YN119",165000,290000,125000,43
TIKI,tui-vi-nu,152923488,"Bóp ví nữ cầm tay mini V0490 Meow meow bỏ túi nhiều ngăn nhỏ gọn phong cách đơn giản, thời trang, dễ thương",25000,50000,25000,50
TIKI,tui-vi-nu,73362075,"VÍ NGẮN GẬP DA Bóp BASIC Da Saffiano Nhập Khẩu Cao Cấp Chống Thấm Nước Unisex Nam Nữ Chuẩn Nome DOLANTO",220000,220000,0,0
TIKI,tui-vi-nu,149970234,"Túi đựng điện thoại DT1121",86000,86000,0,0
TIKI,tui-vi-nu,190547235,"Túi hạt chuỗi",315000,315000,0,0
TIKI,tui-vi-nu,78623517,"Túi Tote NICE - VN208 ( có khóa kéo, dây đeo )",99000,99000,0,0
TIKI,tui-vi-nu,164960415,"Túi đeo chéo, đeo vai da cao cấp T0128 Ulzzang chống thấm nước, bền bỉ unisex nam nữ phong cách thời trang, cá tính Hàn",170000,340000,170000,50
TIKI,tui-vi-nu,44433176,"Túi Xách Nữ Có Dây Đeo Phối Charm Sang Trọng",275000,275000,0,0
TIKI,tui-vi-nu,172998464,"Túi Nữ Kẻ Sọc Thời Trang Phong Cách Cá Tính 205970",44000,70000,26000,37
TIKI,tui-vi-nu,183349761,"Set 4 hộp đựng khẩu trang + stickers",280000,280000,0,0
TIKI,tui-vi-nu,71176787,"Túi xách nữ thời trang cao cấp ELLY – EL157",1399000,1399000,0,0
TIKI,tui-vi-nu,185902139,"Túi xách nữ cao cấp da thật ELLY – ET132",1689350,2599000,909650,35
TIKI,tui-vi-nu,63172383,"Túi Đeo Chéo Gắn Họa Tiết Con Ong Đẹp TX20",146000,146000,0,0
TIKI,tui-vi-nu,157254128,"Móc Khóa Horshy Keychain SAIGON SWAGGER SGS Horshy Keychain",69000,69000,0,0
TIKI,tui-vi-nu,147479420,"Túi TOTE vải bố dung tích lớn vô cùng lắm chức năng, tiện dụng",79000,79000,0,0
TIKI,tui-vi-nu,125100800,"Túi Đeo Chéo Đựng Điện Thoại Thời Trang CDTX34",49000,49000,0,0
TIKI,tui-vi-nu,147942898,"Túi Đeo Chéo Nữ Chính Hãng FOREVER YOUNG Dáng Vuông Nhiều Ngăn Đựng Điện Thoại Đựng Tiền Siêu Tiện Dụng FY15 - Tukado",269000,269000,0,0
TIKI,tui-vi-nu,67490763," Túi đeo chéo nữ mini hoa cúc cực đẹp siêu tiện dụng TX38",59000,59000,0,0
TIKI,tui-vi-nu,210414307,"Túi Xách Đeo Chéo Nữ Thời Trang Cao Cấp Đường May Đẹp LH115",799000,799000,0,0
TIKI,tui-vi-nu,160313976,"Ví Nữ Ngắn Mini Cầm Tay Perfect For You Thời Trang Đựng Tiền Nhỏ Gọn Dễ Thương Da Cao Cấp Cực Đẹp Giá Rẻ PFY26",109000,109000,0,0
TIKI,tui-vi-nu,45302861,"Túi xách nữ cao cấp da thật ELLY – ET94",2399000,2399000,0,0
TIKI,tui-vi-nu,145467655,"JF F400 Túi pop it đeo chéo Hot hit dành cho bé phiên bản mới nhất hình kỳ lân - thỏ xinh - noel - dâu - dứa - kỳ lân sắc màu",50000,50000,0,0
TIKI,tui-vi-nu,151924341,"Túi đeo chéo đựng điện thoại cho các bạn nữ_ Mã KN125",86000,86000,0,0
TIKI,tui-vi-nu,136940137,"TÚI THỔ CẨM ĐEO CHÉO ĐỰNG ĐIỆN THOẠI",15000,15000,0,0
TIKI,tui-vi-nu,160314487,"Balo Nữ Mini Thời Trang MICOCAH Đi Học Đi Chơi Phối Màu Vintage Da Cao Cấp Cực Đẹp MC43 - Micocah Mall",389000,389000,0,0
TIKI,tui-vi-nu,24628570,"Ví Nữ Cầm Tay Da Pu Mềm Mịn Cao Cấp Dáng Ngắn Khóa Trái Tim Cực Xinh Xắn",25000,30000,5000,17
TIKI,tui-vi-nu,190216206,"Ví đựng hộ chiếu Passport giấy tờ xe, thẻ thời trang chất liệu da bò cao cấp 40596",125000,177651,52651,30
TIKI,tui-vi-nu,34232518,"Túi xách nữ CNT TX29 cao cấp",219000,219000,0,0
TIKI,tui-vi-nu,34345463,"TÚI MINI ĐEO CHÉO NỮ SOUDELOR HÌNH BAO TỬ VẢI CHỐNG NƯỚC MÀU HỒNG",87800,87800,0,0
TIKI,tui-vi-nu,16562974,"Túi Vải Tote Living Loại 1 Ulzzang Hàn Quốc BT17",98000,98000,0,0
TIKI,tui-vi-nu,101790184,"Bộ NÓN + TÚI N.Y Đeo Chéo Nam nữ phong cách Hàn Quốc  TX361",185000,185000,0,0
TIKI,tui-vi-nu,199557161,"Túi đeo chéo da nữ dáng cổ điển nắp gập Lata HN94",590000,590000,0,0
TIKI,tui-vi-nu,99962041,"Túi đeo chéo nữ đựng điện thoại dây kiểu xịn sò điều chỉnh ngắn dài thời trang cao cấp giá rẻ",89500,89500,0,0
TIKI,tui-vi-nu,163833463,"Túi Nam Đeo Chéo Da Thật SUNPOLO STU109 (Nâu)",750000,750000,0,0
TIKI,tui-vi-nu,249699807,"Túi Xách Nữ Hàn Quốc Đeo Vai, Túi Ví Nữ Dáng Vuông Da Cá Sấu Thời Trang Cao Cấp, Nhiều Màu Sắc Lựa Chọn Cá Tính",85000,85000,0,0
TIKI,tui-vi-nu,209414590,"Túi dự tiệc Clutch thiết kế hiện đại trẻ trung năng động rộng đựng thoải mái điện thoại VDT09",321000,321000,0,0
TIKI,tui-vi-nu,180997122,"Túi đeo chéo hình thú dễ thương cá tính BEE GEE TTE1002",230000,460000,230000,50
TIKI,tui-vi-nu,91431247,"Túi tote Other",158000,158000,0,0
TIKI,tui-vi-nu,186605861,"Túi đeo chéo Hazalin NASI T1019 phong cách hàn quốc túi đeo vai nữ thời trang dạo phố dễ thương vải đẹp",59000,59000,0,0
TIKI,tui-vi-nu,107962052,"Ví Nữ Mini Ngắn Cầm Tay Phong Cách Hàn Quốc",99000,99000,0,0
TIKI,tui-vi-nu,171057876,"Túi tote da đeo chéo nữ công sở kiểu dáng thời trang hàn quốc sang chảnh DC163",125000,125000,0,0
TIKI,tui-vi-nu,74892729,"[VOUCHER 30K] Ví Cầm Tay Unisex Thời Trang LATA VN49 nhiề màu (Dài 21cm x Rộng 3.5cm x Cao 10.5cm)",229000,290000,61000,21
TIKI,tui-vi-nu,196343183,"Túi giỏ xách đeo chéo kẹp nách nữ thời trang Hàn Quốc sang chảnh size 24cm phù hợp đi làm, đi chơi, dạo phố TX055",89000,89000,0,0
TIKI,tui-vi-nu,172191763,"Túi Nữ Đeo Chéo Phong Cách Đồ Da Thành Long TLG 208148 (trắng)",22000,50000,28000,56
TIKI,tui-vi-nu,56421113,"Túi đeo chéo đeo vai nữ TaoGbao thời trang cao cấp SKN9",53000,74685,21685,29
TIKI,tui-vi-nu,95020623,"Túi Hộp Vuông Khoá Vuông Madchenhaus, Túi Xách Nữ Công Sở Sang Trọng",55000,55000,0,0
TIKI,tui-vi-nu,187157535,"Túi xách nữ dễ thương NASI T1038 túi tote vải đào thời trang hàn quốc mẫu mới đẹp giỏ xách cầm tay mini đựng đồ tiện dụng",29000,29000,0,0
TIKI,tui-vi-nu,185206163,"￼Túi đeo vai đi làm, đi học đẹp giá rẻ, form to, 2 lớp, vải canvas -có khoá kéo+túi trong",85000,85000,0,0
TIKI,tui-vi-nu,188374876,"Túi đeo chéo 5 ngăn vải dù oxford chống nước chống xước siêu bền size 25cm TUI-20",159000,159000,0,0
TIKI,tui-vi-nu,44011247,"Cặp Da Công Sở LATA CA22",720000,720000,0,0
TIKI,tui-vi-nu,71178456,"Túi đeo chéo nam nữ unisex chống shock để ipad và điện thoại chống thấm nước thời trang Hàn quốc BEE GEE 094",98000,196000,98000,50
TIKI,tui-vi-nu,169271201,"Túi xách đeo chéo nữ vải dù oxford chống nước phong cách Hàn Quốc siêu bền đẹp size 22cm",191000,191000,0,0
TIKI,tui-vi-nu,163887746,"VÍ MINI BỎ TÚI Ví Vải Canvas Cầm Tay Có Khóa Kéo, Họa Tiết Đáng Yêu Tiện Dụng",15000,15000,0,0
TIKI,tui-vi-nu,16259736,"Túi xách thời trang ữ cao cấp da mềm  bảng to",175000,175000,0,0
TIKI,tui-vi-nu,217339743,"Túi đeo chéo da nữ form hộp Lata HN101",590000,590000,0,0
TIKI,tui-vi-nu,19548082,"Túi đeo chéo vải bố nam TX0009",230400,320000,89600,28
TIKI,tui-vi-nu,73497459,"Túi xách tote túi vải nữ đeo chéo tote- MunNiNi",66900,66900,0,0
TIKI,tui-vi-nu,197498856,"Túi xách nữ thời trang công sở cao cấp phong cách mới",432000,480000,48000,10
TIKI,tui-vi-nu,193447855,"Ví Nữ Đẹp Dáng Dài Dự Tiệc Thời Trang Cao Cấp Nhiều Ngăn Cầm Tay Giá Rẻ S02",136000,136000,0,0
TIKI,tui-vi-nu,72031845,"Túi xách nữ thời trang cao cấp ELLY – EL141",1299000,1299000,0,0
TIKI,tui-vi-nu,164551638,"Túi Giỏ Xách Đan Tay Quai Da Vintage Hàng Xuất Khẩu Thủ Công Đi Chơi Đi Biển Chụp Hình Làm Quà Tặng",189000,189000,0,0
TIKI,tui-vi-nu,57983619,"Cặp da công sở LATA CA16",499000,650000,151000,23
TIKI,tui-vi-nu,137983524,"Ví nữ W01 100% da bò thật cao cấp siêu bền đẹp BH 1 năm + hộp sang trọng | Thương hiệu BALZIO",189000,220000,31000,14
TIKI,tui-vi-nu,2749765,"Túi Xách Nữ CNT Công Sở Cao Cấp TX18",259000,259000,0,0
TIKI,tui-vi-nu,157254318,"Túi Đeo Chéo Nam, Nữ Họa tiết Checkerboard SAIGON SWAGGER SGSxClownZ Joke Bag",449000,449000,0,0
TIKI,tui-vi-nu,182739526,"Túi xách nữ Monogram Canvas ELLY – EL207",1899000,1899000,0,0
TIKI,tui-vi-nu,53280099,"Túi xách da nam công sở cao cấp phong cách hiện đại trẻ trung",423000,470000,47000,10
TIKI,tui-vi-nu,158740947,"TÚI XÁCH VẢI NỮ HỌA TIẾT GẤU SIÊU ĐÁNG YÊU TRẺ TRUNG DT138TI",68900,68900,0,0
TIKI,tui-vi-nu,135299009,"Túi tote đeo vai, đeo chéo vải bố canvas T0623 nữ trơn 2 dây đựng đồ đi học, đi chơi mềm đẹp",79000,158000,79000,50
TIKI,tui-vi-nu,10773176,"Túi Xách Nữ Đeo Vai Dây Xích Da",155000,155000,0,0
TIKI,tui-vi-nu,43112097,"Túi Da Thật Kat – Jane",2060000,2060000,0,0
TIKI,tui-vi-nu,4216983,"Bóp ví nữ cầm tay Timall TM-Vinu03 phong cách châu Âu",98000,98000,0,0
TIKI,tui-vi-nu,95993549,"Túi xách nữ công sở Gianni conti Italy 493204",5900000,5900000,0,0
TIKI,tui-vi-nu,187843405,"Túi Xách Nữ Đa Phong Cách Vừa Cầm Tay, Đeo chéo Da Cao Cấp - Túi Đi Gọn, Nhẹ Đi Tiệc, Đi Du Lịch, Cafe, Đi Làm Vừa Đẹp, Sang, Xinh [Size 28cmx11x21]",798000,798000,0,0
TIKI,tui-vi-nu,188321409,"Túi xách đeo chéo nữ vải dù chống nước cao cấp size 24cm TUI-49",139000,139000,0,0
TIKI,tui-vi-nu,174145938,"Túi Cói, Túi Lục Bình Đính Hoa Cúc Chuẩn Đẹp, Túi Xách Dự Tiệc, Giỏ Đi Làm",289000,289000,0,0
TIKI,tui-vi-nu,104636640,"clutch nhung đá- túi xách cầm tay nhung đá tròn form hình thang cao cấp( video ảnh thât)",360000,360000,0,0
TIKI,tui-vi-nu,248639526,"Túi Xách Nữ Đeo Chéo Telfar Có Hộp Hàng Đẹp Chuẩn Cao Cấp Nhiều Màu",530375,530375,0,0
TIKI,tui-vi-nu,193395522,"Túi Xách Nữ Đeo Vai, Cầm Tay Da Bò Thật, Túi mới hợp thời trang, Phong Cách túi thời trang phù hợp với tất Phong Cách SangTrọng Tiện dụng đựng nhiều đồ  Túi đeo chéo Size 27cmX12.5cmX20cm",879000,879000,0,0
TIKI,tui-vi-nu,149449578,"Túi Xách Nữ Trần Trám Dây Chuông Chất Đẹp - Túi Đeo Chéo Cầm Tay , Có Quai Xách Khóa Xoay - Hàng Quảng Châu Siêu Hót",509000,509000,0,0
TIKI,tui-vi-nu,32862548,"Túi Xô, Túi Đeo Chéo Nữ Thời Trang Màu Trơn HN022",285000,285000,0,0
TIKI,tui-vi-nu,179438382,"Túi Đeo Chéo Vải Canvas Cỡ Lớn Thời Trang Nam Nữ Đi Học Đi Chơi – Túi Tote Phong Cách ULZZANG Đựng Đồ Du Lịch",139000,139000,0,0
TIKI,tui-vi-nu,143321669,"HJ6457-58-59-60 - Túi hộp đeo chéo nữ da đà điểu màu đen, nâu đất, vàng bò, nâu đỏ",6299000,6299000,0,0
TIKI,tui-vi-nu,57811376,"Túi xách nữ đẹp sang trọng, chất da vân cao cấp ",99000,99000,0,0
TIKI,tui-vi-nu,24838211,"Túi đeo vai nữ cổ điển  TĐ404 Shalla",134640,194480,59840,31
TIKI,tui-vi-nu,1995337,"Túi Xách Da Trăn Huy Hoàng HT6301 (20 x 37 cm)",4999000,4999000,0,0
TIKI,tui-vi-nu,115495554,"Túi đeo chéo nữ  Túi xách nữ Da Trơn Quảng Châu sang chảnh Siêu HOT T22",62000,62000,0,0
TIKI,tui-vi-nu,146944704,"Túi tote vải canvas nữ đẹp đeo chéo đi học nhỏ gọn cute dễ thương giá rẻ TV08",74700,74700,0,0
TIKI,tui-vi-nu,108239781,"Ví Da Nam Nữ Đựng Thẻ Handmade Lealux Holder Handmade 1",539000,539000,0,0
TIKI,tui-vi-nu,72623990,"Túi cói đi biển, túi đeo chéo nữ, túi cói có tay vuông nhỏ xinh 03",220000,220000,0,0
TIKI,tui-vi-nu,147941796,"Túi Xách Đeo Chéo Nữ Kẹp Nách Chính Hãng MICOCAH Dáng Công Sở Thời Trang Đi Làm Đi Chơi Da Cao Cấp Cực Đẹp MC21 - Tukado",389000,389000,0,0
TIKI,tui-vi-nu,91138583,"JUNO Túi Xách Nhỏ TXN472",682000,682000,0,0
TIKI,tui-vi-nu,136940166,"Ví vải hoa chống nước 3 khoá 7 màu( được chọn màu )",50000,50000,0,0
TIKI,tui-vi-nu,134254908,"Túi xách vải dù chống nước Oxford nhiều ngăn đi chợ du lịch đa năng",200000,200000,0,0
TIKI,tui-vi-nu,14867339,"Ví Cầm Tay Nữ Cao Cấp VCT305",159000,159000,0,0
TIKI,tui-vi-nu,134749328,"Túi tote đeo vai vải bố canvas trơn T036 nữ đựng đồ đi học, đi chơi mềm đẹp",49000,98000,49000,50
TIKI,tui-vi-nu,21943619,"Túi Tote Túi Vải Nữ Túi Đeo Chéo Nữ Hàn Quốc Bằng Vải Dù Nhiều Màu",58000,58000,0,0
TIKI,tui-vi-nu,53393516,"Túi đeo chéo Thỏ dễ thương",140000,140000,0,0
TIKI,tui-vi-nu,8280638,"Túi Vải Canvas - Save Water Drink Wine",124000,169000,45000,27
TIKI,tui-vi-nu,157479120,"[FREESHIP]bóp ví đeo chéo nữ ngăn đựng điện thoại trong suốt cắm sạc được, không cần lấy ra - N5015",157000,229000,72000,31
TIKI,tui-vi-nu,181097679,"Túi cách nữ MONOGRAM CANVAS ELLY – EL202",799500,1599000,799500,50
TIKI,tui-vi-nu,147477859,"Túi TOTE chuột đáng yêu dung tích lớn đa chức năng dùng để đi học, đi chơi",85000,85000,0,0
TIKI,tui-vi-nu,149449401,"TÚI ĐEO CHÉO NỮ HM - Hàng Quảng Châu cao cấp Hot Trend 2021",296000,296000,0,0
TIKI,tui-vi-nu,58439803,"Túi Đeo Chéo Da Nam LATA BALC23",360000,360000,0,0
TIKI,tui-vi-nu,8280243,"Túi Vải Canvas - Một Ngày Không Sun Sea",124000,169000,45000,27
TIKI,tui-vi-nu,206715482,"Túi xách tote, HAWAII, mã G65. Quà tặng cao cấp cho gia đình, nam nữ cặp đôi, hội nhóm, doanh nghiệp",109000,109000,0,0
TIKI,tui-vi-nu,185468121,"bóp ví nữ mini cầm tay hàng hiệu Baellerry gập hai họa tiết caro đựng giấy tờ, thẻ - NR085",128000,219000,91000,42
TIKI,tui-vi-nu,71509879,"Túi xách nữ thời trang cao cấp ELLY- EL154",1399000,1399000,0,0
TIKI,tui-vi-nu,184933525,"Dây xích túi xách phụ kiện dây đeo chéo túi xách cho bạn nữa",28000,28000,0,0
TIKI,tui-vi-nu,197163833,"Túi đeo chéo khóa xoay Yuumy Seasand YN142",335000,650000,315000,48
TIKI,tui-vi-nu,121332099,"Dây đai dệt trắng, dây quai túi xách 2.5 cm/ cuộn 10 mét",20000,20000,0,0
TIKI,tui-vi-nu,96670026,"   Túi đựng điện thoại đeo chéo handmade - thời trang, trẻ trung  ",175500,175500,0,0
TIKI,tui-vi-nu,180994096,"Túi xách vải Túi Vải Nữ Túi Đeo Chéo Hàn Quốc Gấu bông dễ thương",160000,320000,160000,50
TIKI,tui-vi-nu,93950153,"Ví Đựng Thẻ Card Holder Da Thật Genuine Leather Kiểu Dáng Thanh Lịch Aaa Jeans",189000,189000,0,0
TIKI,tui-vi-nu,203995260,"Túi Xách Nữ, Túi Đeo Chéo Nữ Cao Cấp Da Thêu Một Mảnh Đi Chơi, Đi Tiệc Phong Cách Hàn Quốc",90000,90000,0,0
TIKI,tui-vi-nu,107962694,"Ví Da Nữ Mini Handmade Tuyệt Phẩm Quý Cô Sành Điệu",276000,276000,0,0
TIKI,tui-vi-nu,11249058,"Ví đựng thẻ ví ngắn nữ chữ H",83000,83000,0,0
TIKI,tui-vi-nu,100298409,"Ví mini cầm tay dành cho nam nữ unisex nhiều ngăn nhỏ gọn da pu",40000,40000,0,0
TIKI,tui-vi-nu,72863370,"Túi Vải Trơn Tote Canvas Dùng Đi Chợ Gady's Shop",25000,25000,0,0
TIKI,tui-vi-nu,184097588,"Túi nữ  vải cao cấp chuẩn xin, túi xách đeo vai thời trang Hàn quốc hottrend 2022 SP347",99000,99000,0,0
TIKI,tui-vi-nu,2406109,"Ví Nhỏ Xinh Xắn Hựu Tâm Shop VNXXTI (11 x 9 cm)",80000,80000,0,0
TIKI,tui-vi-nu,157253957,"Móc Khóa Ngựa Horshy SAIGON SWAGGER SGS Horshy Keyring",49000,49000,0,0
TIKI,tui-vi-nu,86561986," Ví Nữ Mini Cầm Tay FOREVER YOUNG Phong Cách Hàn Quốc Siêu Đẹp, Giá Rẻ V02835",31000,31000,0,0
TIKI,tui-vi-nu,196423976,"Túi cói form to đơn giản",159000,159000,0,0
TIKI,tui-vi-nu,109631958,"Ví dự tiệc cưới, kiểu ví họa tiết hoa lá, thường thấy ở tiệc cưới, sự kiện, có nút gài kim loại, hàng hiệu, sang trọng, đẳng cấp",330000,550000,220000,40
TIKI,tui-vi-nu,11506821,"Ví Da Mini Cầm Tay TM-Purse H86 (KT: 12x10x4 cm) Cá Tính Nữ",159000,159000,0,0
TIKI,tui-vi-nu,76108598,"Ví nữ cầm tay HANHSON SP000705 Đen logo vàng",1050000,1050000,0,0
TIKI,tui-vi-nu,186710618,"Túi đeo chéo Peach Juice NASI T1024 phong cách hàn quốc túi đeo vai nữ thời trang dạo phố dễ thương vải đẹp",39000,39000,0,0
TIKI,tui-vi-nu,93291190,"Marhen.J - Dây đeo túi xách bản rộng Signature F MJ20DSSTFW-IV",990000,990000,0,0
TIKI,tui-vi-nu,12129349,"Túi đeo chéo nữ",120000,120000,0,0
TIKI,tui-vi-nu,72069933,"Túi xách nữ thời trang da bò nguyên miếng cao cấp xách tay hoặc đeo vai phong cách châu Âu- Phiên bản giới hạn HGG002",1450000,1450000,0,0
TIKI,tui-vi-nu,270141474,"Túi Gấu Bông Gòn Xách Tay Đeo Chéo, Túi Xách Đeo Chéo Gấu Nhồi Bông Hoạt Hình",69000,69000,0,0
TIKI,tui-vi-nu,157479000,"ví bóp nữ cầm tay Forever Young có nhiều ngăn hàng hiệu da cao cấp, đựng vừa điện thoại - PL82561",99000,189000,90000,48
TIKI,tui-vi-nu,102109461,"Túi xách nữ - Túi nữ cầm tay có quai đeo MS002",284050,299000,14950,5
TIKI,tui-vi-nu,32223565,"Túi Vải Canvas Mắt Biếc",63000,70000,7000,10
TIKI,tui-vi-nu,91421816,"Ví We Bare Bears",127000,127000,0,0
TIKI,tui-vi-nu,191492782,"Túi đeo chéo nữ phong cách dễ thương – DCNU1006",130000,260000,130000,50
TIKI,tui-vi-nu,75183422,"Túi Xách Nữ Kẹp Nách Hàn Quốc Vân Cá Sấu Xinh Xắn Đi Chơi Dạo Phố D169",55000,55000,0,0
TIKI,tui-vi-nu,189648753,"Túi xách nữ da bò công sở Gence TX08 màu đen",1760000,1760000,0,0
TIKI,tui-vi-nu,185849277,"Túi Xách Nữ Đeo Chéo và Đeo Vai Màu Vàng Bò CRESCENT MOON HOBO BAG GIPSY",690000,690000,0,0
TIKI,tui-vi-nu,136940240,"Bóp đựng tiền 4 ngăn ( hình chụp 2 mặt trước sau )",15000,15000,0,0
TIKI,tui-vi-nu,147197949,"Túi Hậu Môn Nhân Tạo 2 Mảnh- Hollister (Trong, Sử Dụng Kẹp), 18102 / 18103 / 18104 -VT0435",46000,46000,0,0
TIKI,tui-vi-nu,128869210,"TÚI XÁCH NỮ CAO CẤP DA THẬT ELLY – ET122",1624350,2499000,874650,35
TIKI,tui-vi-nu,99280866,"Ví nữ dài cầm tay cao cấp dây đeo chéo thời trang đi chơi dạo phố TK0085",59000,118000,59000,50
TIKI,tui-vi-nu,180720932,"Túi Xách Thời Trang Nữ Da Thật Cao Cấp Gence TX012",1600000,1600000,0,0
TIKI,tui-vi-nu,169851433,"Bộ 8 vỏ bọc thẻ căn cước bằng lái thẻ tín dụng trong suốt",11994,11994,0,0
TIKI,tui-vi-nu,106975120,"Bộ đôi túi canvas phối da Đồ Da Thành Long TLG cho nàng và chàng 208089 (Xanh-)",66000,84100,18100,22
TIKI,tui-vi-nu,174531663,"Túi xách nữ Efora Sofia 3831-BR túi da thật cao cấp, xách tay, túi đeo chéo, khoác vai đi chơi đi làm",4380000,4380000,0,0
TIKI,tui-vi-nu,150991651,"Bóp ví nữ cầm tay mini V0435 Carrot bỏ túi nhiều ngăn nhỏ gọn phong cách đơn giản, thời trang, dễ thương",25000,50000,25000,50
TIKI,tui-vi-nu,51235402,"Túi đeo chéo Nữ thời trang",75000,75000,0,0
TIKI,tui-vi-nu,45324029,"Túi xách nữ cao cấp da thật ELLY – ET97",2999000,2999000,0,0
TIKI,tui-vi-nu,20849294,"Túi hộp đeo chéo nữ phong cách Vintage nhiều ngăn",55000,55000,0,0
TIKI,tui-vi-nu,188376754,"Túi Đeo Vai Nữ Ô Vuông Kẻ Ka Rô Sang Trọng Phong Cách Hàn Quốc",99000,99000,0,0
TIKI,tui-vi-nu,75953993,"Túi đeo chéo nữ thời trang Hàn quốc chống thấm nước dạng trống tròn T1 BEE GEE",75000,150000,75000,50
TIKI,tui-vi-nu,187103343,"Túi đeo chéo NASI T1030 phong cách hàn quốc túi xách nữ đeo vai thời trang dạo phố dễ thương vải đẹp",45000,45000,0,0
TIKI,tui-vi-nu,184071734,"Túi xách nữ/ 1992 s t u d i o/ FREYA BAG/ túi xách nữ công sở/ túi đi học/ túi đựng laptop/ họa tiết houndstooth",179000,179000,0,0
TIKI,tui-vi-nu,44079056,"Túi đeo chéo nữ đi tiệc đầm tròn quả cầu A09 Shalla",43000,60885,17885,29
TIKI,tui-vi-nu,170506246,"Ví dài cầm tay nữ The Zipper Wallet chính hãng NATOLI đựng thẻ điện thoại nhiều ngăn cao cấp",489000,698000,209000,30
TIKI,tui-vi-nu,190809034,"Túi đeo chéo NASI T1032 phong cách hàn quốc túi xách nữ đeo vai thời trang dạo phố dễ thương vải đẹp",65000,65000,0,0
TIKI,tui-vi-nu,195331694,"Túi xách du lịch gấp gọn 2 tầng size đại nới đáy chất vải dù chống nước tiện lợi bền đẹp quai đeo chắc chắn đa năng - NGẨU NHIÊN",125000,125000,0,0
TIKI,tui-vi-nu,130856637,"Túi tote vải canvas đeo vai cho nữ,đi học,đi làm túi quả cam quả đào",67000,67000,0,0
TIKI,tui-vi-nu,185736127,"Túi xách Túi đeo vai nữ khóa đầu rồng size 18 cm cực xinh_Túi đẹp MQ189",99000,99000,0,0
TIKI,tui-vi-nu,111868827,"Túi đeo chéo nam Arctic Hunter K00096 chất liệu Oxford chống thấm nước, đựng ipad, thiết kế nhiều ngăn tiện dụng",379000,650000,271000,42
TIKI,tui-vi-nu,76109672,"Ví nữ cầm tay HANHSON SP000701 màu Hồng nhạt",980000,980000,0,0
TIKI,tui-vi-nu,103461410,"Túi tote trong suốt hình gấu",50000,50000,0,0
TIKI,tui-vi-nu,172191753,"Túi đeo chéo phong cách Hàn Quốc Đồ Da Thành Long TLG 208093 2(nâu sậm)",40000,40000,0,0
TIKI,tui-vi-nu,197951883,"TÚI CLUTCH NỮ CẦM TAY THỜI TRANG DA PU CAO CẤP MÀU ĐEN TRƠN DẬP VÂN NỔI Y2883",385000,385000,0,0
TIKI,tui-vi-nu,172191801,"Túi xách nữ, túi đeo chéo đeo vai nữ da thật 208227  (xanh)",387000,766000,379000,49
TIKI,tui-vi-nu,178778056,"Túi đeo chéo nữ kiêm ví đựng điện thoại đẹp thời trang FOREVER BAELLERRY sang chảnh chất liệu da PU siêu mềm mịn VN010",129000,129000,0,0
TIKI,tui-vi-nu,48612751,"Túi xách nữ thời trang CNT'S TX38 + Tặng kèm ví (30 x 10 x 20 cm)",269000,269000,0,0
TIKI,tui-vi-nu,190155455,"Túi Cói, Túi Tote Vẽ Mỹ Nghệ Xinh Xắn-Giỏ Xách Cỏ Bàng TXCBVBXLTK01 Chuẩn Đẹp",339000,339000,0,0
TIKI,tui-vi-nu,90163542,"Túi xách nữ công sở HOTTREND  Túi đeo chéo nữ Hàn Quốc  Deli TN46",219000,219000,0,0
TIKI,tui-vi-nu,76109831,"Ví nữ cầm tay HANHSON SP000702 màu Xanh Emerald",980000,980000,0,0
TIKI,tui-vi-nu,198321262,"Túi đeo chéo hoặc đeo vai thời trang",246400,246400,0,0
TIKI,tui-vi-nu,31197688,"Combo Túi Xách Tay Da Nữ Có Dây Đeo Chéo và Ví Cầm Tay DM-5079 Da Mềm Bền Chắc",365000,365000,0,0
TIKI,tui-vi-nu,43694647,"Túi nữ thời trang phong cách Hàn Quốc Đồ Da Thành Long TLG 208098",43000,87000,44000,51
TIKI,tui-vi-nu,57946797,"Ví nữ cầm tay mini thời trang Phong cách Hàn  nhiều ngăn tiện dụng",99000,99000,0,0
TIKI,tui-vi-nu,249296464,"Túi Xách Nữ Thời Trang Đa Năng Thanh Lịch Sang Trọng ZTX02",195000,350000,155000,44
TIKI,tui-vi-nu,77673726,"Túi xách nữ thời trang cao cấp ELLY- EL161",899400,1499000,599600,40
TIKI,tui-vi-nu,21160441,"Túi vải bố trơn có khóa kéo",45000,45000,0,0
TIKI,tui-vi-nu,89261210,"Túi đeo chéo trước ngực unisex nam nữ Z_TDC_ADIDA màu đen, túi bao tử phong cách thời trang hàn quốc cực xinh đựng điện thoại và phụ kiện cá nhân  khi đeo đi dạo phố dự tiệc ",88900,88900,0,0
TIKI,tui-vi-nu,34680863,"Túi clutch nam da thật ELLY HOMME – ECM6",2599000,2599000,0,0
TIKI,tui-vi-nu,119329128,"Túi đeo chéo nữ, túi đựng điện thoại mini dáng dọc thời trang. Phong cách Hàn Quốc trẻ trung, năng động",149000,149000,0,0
TIKI,tui-vi-nu,209414093,"Túi đựng điện thoại mặt cảm ứng trong suốt tiện dụng đeo chéo dáng dọc thời trang Cobala mẫu mới",182000,182000,0,0
TIKI,tui-vi-nu,190858886,"Túi Đeo Chéo Thời Trang Năng Động STARGO RETRO",119000,219000,100000,46
TIKI,tui-vi-nu,129011339,"HJ3141-42-43-44 - Bóp nữ Huy Hoàng cao cấp 1 khóa màu da, đen, nâu, đỏ",839000,839000,0,0
TIKI,tui-vi-nu,163582757,"Túi Đựng Đồ Trang Điểm, Make Up, Mỹ Phẩm Nhiều Ngăn Tiện Lợi, Có Móc Treo [FT1",159000,159000,0,0
TIKI,tui-vi-nu,147943335,"Túi Xách Nữ Kẹp Nách Chính Hãng MICOCAH Dáng Công Sở Đeo Chéo Đeo Vai Phong Cách Ulzzang Siêu Đẹp MC02 - Tukado",389000,389000,0,0
TIKI,tui-vi-nu,136940056,"TÚI ĐEO CHÉO THỔ CẨM LOẠI ĐEO VUÔNG TRUNG",40000,40000,0,0
TIKI,tui-vi-nu,8173385,"Ví bóp tiền nữ Nút bấm hoa nhiều cánh phong cách cổ kính",155000,155000,0,0
TIKI,tui-vi-nu,147264971,"Ví Đựng Thẻ ATM Cao Cấp Slim CITIZEN, Da Bò Tự Nhiên Cao Cấp, Da Thuộc Thảo Mộc, Nhập Khẩu Từ Châu Âu, Nhỏ Gọn - Hiện Đại - Chuyên Nghiệp, Đựng Tiền, Thẻ Ngân Hàng, Card Danh Thiếp - Hàng Chính Hãng SAIGIO",2079000,2099000,20000,1
TIKI,tui-vi-nu,109710949,"Túi cói merci loại 1 màu sáng, có đệm đáy giữ form túi, có lót",49324,51920,2596,5
TIKI,tui-vi-nu,35327082,"Túi xách nam da thật ELLY HOMME – ETM5",2999000,2999000,0,0
TIKI,tui-vi-nu,136940067,"Túi thổ cẩm 1 quai",90000,90000,0,0
TIKI,tui-vi-nu,120538387,"HC6255-56-57-58 - Túi đeo nữ da cá sấu Huy Hoàng màu đen, nâu đỏ, vàng bò, nâu đất",3499000,3499000,0,0
TIKI,tui-vi-nu,249914629,"Ví cầm tay nữ gấp nhiều ngăn da bò Epsom nhập khẩu, vừa GPLX cũ, thẻ BHYT - Pink Ohara",650000,650000,0,0
TIKI,tui-vi-nu,74180929,"Túi xách laptop, túi xách công sở nam vải canvas TX001",403200,560000,156800,28
TIKI,tui-vi-nu,148967272,"Túi cói Merci sang chảnh",39499,39499,0,0
TIKI,tui-vi-nu,25110038,"Vỏ Bọc Hộ Chiếu Du Lịch Có Khe Nhét Thẻ Tiện Dụng",2999,2999,0,0
TIKI,tui-vi-nu,160315109,"Ví Bóp Nữ Dài Cầm Tay FOREVER YOUNG Phong Cách Hàn Quốc Siêu Đẹp Nhiều Ngăn Tiện Dụng FY54 - Micocah Mall",149000,149000,0,0
TIKI,tui-vi-nu,171648720,"Túi Xách Nữ Đeo Chéo Hình Gấu Dễ Thương, Túi Đeo Vai Nữ Học Sinh Đi Học, Đi Chơi Nhiều Màu - OTV118 - Ope Store",193000,193000,0,0
TIKI,tui-vi-nu,132078384,"Túi Đeo Chéo Khóa Gài T22 Caro Trắng",145000,195600,50600,26
TIKI,tui-vi-nu,102576041,"Túi Đeo Chéo Thời Trang Hàn Quốc HARAS HR281",100000,100000,0,0
TIKI,tui-vi-nu,32454277,"Túi bao tử đeo chéo hip hop, sành điệu cao cấp cho bạn nam và nữ",120000,120000,0,0
TIKI,tui-vi-nu,161964666,"Túi đeo nữ thời trang cao cấp",225000,225000,0,0
TIKI,tui-vi-nu,176453886,"Túi xách đính đá thời trang nữ",329000,329000,0,0
TIKI,tui-vi-nu,137154005,"Túi Tote Vải Canvas Stay At Home Có Khóa Miệng Túi",35000,35000,0,0
TIKI,tui-vi-nu,200016856,"Ví vải thổ cẩm/vải thêu dây cầm gắn hạt xinh xắn (ảnh thật)",20000,20000,0,0
TIKI,tui-vi-nu,68793036,"Túi đeo chéo cho bé Hình Ong chấm bi LT4 Tặng combo 4 món",53000,74415,21415,29
TIKI,tui-vi-nu,160314498,"Ví Nữ Mini Cầm Tay Hàng Hiệu TAILIAN Đựng Tiền Đựng Thẻ Da Cao Cấp Nhiều Ngăn Tiện Dụng Đẹp Giá Rẻ TL04 - Micocah Mall",99000,99000,0,0
TIKI,tui-vi-nu,176661865,"Túi xách đính đá thời trang nữ",439000,439000,0,0
TIKI,tui-vi-nu,160314394,"Ví Bóp Nữ Mini Cầm Tay FOREVER YOUNG Đựng Tiền Nhiều Ngăn Tiện Dụng Chất Da Xước Cao Cấp Cực Đẹp FY49 - Micocah Mall",149000,149000,0,0
TIKI,tui-vi-nu,51299303,"Túi xách da bò nam công sở cao cấp phong cách châu âu",882000,980000,98000,10
TIKI,tui-vi-nu,144065762,"túi xách nhung hộp mần xui cao cấp- túi cầm tay nhung hộp đính hoa đá đi tiệc cao cấp( ảnh thật )",399000,399000,0,0
TIKI,tui-vi-nu,114119921,"Túi Xách Nữ Công Sở thời trang hàn quốc 2021 - TÚI TOTE - TÚI A4 -TÚI BIGSIZE",199500,199500,0,0
TIKI,tui-vi-nu,181096767,"Túi xách nữ MONOGRAM CANVAS ELLY – EL204",999500,1999000,999500,50
TIKI,tui-vi-nu,184071726,"Túi xách nữ/ 1992 s t u d i o / DEXA BAG / Màu đen",199000,199000,0,0
TIKI,tui-vi-nu,248715249,"Túi đeo chéo mini nữ trẻ trung thời trang phong cách Hàn Quốc",119000,119000,0,0
TIKI,tui-vi-nu,56421161,"Túi đeo chéo vai nữ nhiều mẫu hình thời trang cao cấp KS51",52000,73062,21062,29
TIKI,tui-vi-nu,200651557,"Túi đeo chéo da nữ khóa nhấn hình thoi Lata HN97",590000,590000,0,0
TIKI,tui-vi-nu,149449531,"Túi CEEKAY 2021 - Túi xách nữ cao cấp hàng chính hãng Fullbox",546000,546000,0,0
TIKI,tui-vi-nu,149449660,"( MỚI) Túi xách nữ đeo chéo ô Trám khóa xoay - Hàng cao cấp da sịn",464000,464000,0,0
TIKI,tui-vi-nu,182713289,"Ví nữ Monogram Canvas ELLY – EV89",599400,999000,399600,40
TIKI,tui-vi-nu,34943636,"Túi vải Bơ đi mà sống",140000,140000,0,0
TIKI,tui-vi-nu,172192207,"Túi nữ thời trang phong cách Hàn Quốc Thành Long TLG  208111 3(xám)  Tặng túi đựng bút tiện lợi",30000,30000,0,0
TIKI,tui-vi-nu,53782142,"Túi đeo chéo chống shock để ipad nam nữ unisex Hàn quốc thời trang BEE GEE 078 hot trend 2020",45000,90000,45000,50
TIKI,tui-vi-nu,13407051,"Túi Bao Tử Đeo Chéo Apehlic Phong Cách Hàn P948 Parisa",77000,77000,0,0
TIKI,tui-vi-nu,197538668,"Túi xách nam Oscar - OCMHBLG040",7900000,7900000,0,0
TIKI,tui-vi-nu,13419358,"Ví Nữ Thời Trang Khóa Kim Loại Hình Chữ V-HN002",62000,62000,0,0
TIKI,tui-vi-nu,43662703,"Ví Da Mini Card Holder Nhỏ Gọn WMV2",226000,226000,0,0
TIKI,tui-vi-nu,118036758,"Túi xách đi chùa _ phụ kiện có video",54000,54000,0,0
TIKI,tui-vi-nu,157254226,"Túi Hộp Bút Vuông SAIGON SWAGGER SGS Square Pencil Case-Vừa Máy Tính Casio",99000,99000,0,0
TIKI,tui-vi-nu,169354383,"Clutch đi tiệc nhung đính đá cao cấp, sang trọng( kéo xem ảnh thật)",360000,360000,0,0
TIKI,tui-vi-nu,1593273,"Túi Xách Phối Sọc U & YABY 023/2 (32cm) - Hồng Đen",177000,177000,0,0
TIKI,tui-vi-nu,53300717,"Túi bao tử đeo bụng chất vải siêu hot LA812",99750,99750,0,0
TIKI,tui-vi-nu,195096554,"Móc khóa hình gấu đính đá xinh xắn - JL",20000,20000,0,0
TIKI,tui-vi-nu,77446157,"TÚI XÁCH NỮ ĐEO CHÉO (TX-081-1)",69000,69000,0,0
TIKI,tui-vi-nu,273205303,"Vascara Túi Tote Minimalism Nhấn Quai Bản Dài - TOT 0146",1026000,1026000,0,0
TIKI,tui-vi-nu,136940016,"Túi thổ cẩm đeo chéo tua rua",60000,60000,0,0
TIKI,tui-vi-nu,152015208,"Túi Đeo Chéo Canvas 2 Lớp Lót Vải Dù Bên Trong",85000,85000,0,0
TIKI,tui-vi-nu,95395129,"Túi nữ thời trang phong cách Hàn quốc 205954",33000,38000,5000,13
TIKI,tui-vi-nu,221240424,"TÚI LƯỚI ĐỰNG ĐIỆN THOẠI KHÔNG KÈM PHỤ KIỆN MÓC KHÓA ĐEO CHÉO ĐI BIỂN ĐI CHƠI DẠO PHỐ NỮ NAM UNISEX / NO.4 PHONE BAG",160000,160000,0,0
TIKI,tui-vi-nu,26329162,"Túi Vải Tote Đeo Chéo Balo Hình Chó Con Hàng Quảng Châu Cực Tốt",79000,79000,0,0
TIKI,tui-vi-nu,149179149,"Ví cầm tay nữ thời trang Y10 họa tiết 2 màu quai đỏ, đen",55000,55000,0,0
TIKI,tui-vi-nu,193056817,"TÚI XÁCH TAY PEEKOO SIÊU TO MÀU XANH HOT TREND CỰC ĐẸP",39000,39000,0,0
TIKI,tui-vi-nu,136940208,"TÚI ĐEO CHÉO THỔ CẨM LOẠI CÓ CHUÔNG SV",70000,70000,0,0
TIKI,tui-vi-nu,182098002,"Ví dài nữ khoá kéo L - da bò nhập Ý mềm mại",680000,680000,0,0
TIKI,tui-vi-nu,131338439,"Túi vải bố, Túi vải Canvas trơn màu Đen không khóa kéo",22000,22000,0,0
TIKI,tui-vi-nu,136940047,"Ví lụa thêu cô gái Việt Nam",30000,30000,0,0
TIKI,tui-vi-nu,131405315,"Túi xách nữ công sở da mềm phong cách Hàn Quốc da mềm",199000,199000,0,0
TIKI,tui-vi-nu,133933630,"Túi đeo chéo mini dễ thương ️ Hot trend ️ Túi đeo chéo nữ mini thời trang TN78",99000,99000,0,0
TIKI,tui-vi-nu,87100289,"Balo thời trang, balo đi học, đựng laptop Túi Tote Sinh Viên Chú Gà Sweet balo nữ vải",78000,78000,0,0
TIKI,tui-vi-nu,106045483,"Túi đeo chéo nữ thời trang đựng điện thoại nhiều ngăn tiện dụng TK0094",69000,100000,31000,31
TIKI,tui-vi-nu,191775113,"Túi Đeo Chéo Nữ Mini Thời Trang MICOCAH Nhỏ Gọn Dễ Thương Da Cao Cấp Cực Đẹp Đi Chơi Dự Tiệc Sang Trọng MC128 - Micocah",389000,389000,0,0
TIKI,tui-vi-nu,44146712,"Túi xách da bò công sở cao cấp phong cách châu âu TX DA BÒ 7618",882000,980000,98000,10
TIKI,tui-vi-nu,185674814,"Túi xách vuông đựng đồ trang điểm, lòng túi rộng sức chứa lớn đựng được cả nước hoa, skincare",360000,360000,0,0
TIKI,tui-vi-nu,157253972,"Ví Nắp Ngắn In Báo SAIGON SWAGGER Journal Short Flap Wallet",390000,390000,0,0
TIKI,tui-vi-nu,140879453,"Giỏ mây đan ren nơ cao cấp cực sang chảnh",350000,350000,0,0
TIKI,tui-vi-nu,53028909,"Túi đeo chéo cao cấp N9 bóng chống nước đa năng KS03 Shalla",85000,120417,35417,29
TIKI,tui-vi-nu,108697252,"Túi xách cầm tay nữ Micocah 2020 size trung, có dây đeo chéo tiện dụng (FSE440) (M364)",420000,420000,0,0
TIKI,tui-vi-nu,79228358,"Giỏ xách thời trang, túi xách nữ phong cách vintage",250000,250000,0,0
TIKI,tui-vi-nu,171653891,"Hộp Đựng Thuốc Siêu Tiện Lợi Mang Đi Du Lịch Hoặc Công Tác",20000,30000,10000,33
TIKI,tui-vi-nu,35845564,"Túi Vải Tote XinhStore Hình Mèo",102000,102000,0,0
TIKI,tui-vi-nu,147942962,"Ví Nữ Mini Cầm Tay FOREVER YOUNG Dáng Vuông Xinh Xắn Cực Sang Chảnh Da Cao Cấp Cực Đẹp Giá Rẻ FY29 - Tukado",99000,99000,0,0
TIKI,tui-vi-nu,86561311," Túi xách nữ    Túi đeo chéo mini dây xích SANG CHẢNH TD18",78000,78000,0,0
TIKI,tui-vi-nu,249671073,"Túi Xách Nữ Cao Cấp Dáng Vuông Họa Tiết Da Cá Sấu Thời Trang Hàn Quốc Dự Tiệc, Đi Làm Sang Chảnh",90000,90000,0,0
TIKI,tui-vi-nu,25407676,"Túi Đeo Chéo Da Cao Cấp Weixier B0833",185000,185000,0,0
TIKI,tui-vi-nu,95394365," Túi xách nữ thời trang phong cách hàn quốc đẹp nhất 208169",31000,40000,9000,23
TIKI,tui-vi-nu,54480694,"Túi Grand Mini Oxford HAVIAS",280000,350000,70000,20
TIKI,tui-vi-nu,185468231,"túi ví đeo chéo nữ với 2 dây đeo họa tiết thổ cẩm dáng đứng đựng vừa điện thoại - N8605",198000,269000,71000,26
TIKI,tui-vi-nu,186229908,"Túi xách nữ Pu Cao Cấp Handle Bag chính VÀ kiểu dáng cổ điển đơn giản thời trang có thể đeo chéo hoặc xách tayTúi đeo vai - Bảo hành 1 năm",592800,592800,0,0
TIKI,tui-vi-nu,136940145,"Ví tiền vải canvas mini xinh xắn cho nữ",15000,15000,0,0
TIKI,tui-vi-nu,196573813,"Ví nữ cầm tay  Hàn Quốc nhiều ngăn nhỏ gọn , đáng yêu( shop giao ngẫu nhiên)",19800,22000,2200,10
TIKI,tui-vi-nu,172977342,"Túi vải bố, Túi vải Canvas trơn Màu Trắng",25000,25000,0,0
TIKI,tui-vi-nu,161524403,"Bóp ví nữ dài cầm tay V0510 LIVE nhiều ngăn tiện lợi, phong cách thời trang, cá tính",36000,72000,36000,50
TIKI,tui-vi-nu,38464989,"Móc treo túi xách hình cỏ 4 lá may mắn",199000,199000,0,0
TIKI,tui-vi-nu,248990474,"KHÓA SẬP MỎ VỊT 2-3CM",42000,42000,0,0
TIKI,tui-vi-nu,147480557,"Túi đeo chéo, Túi đeo vai, túi xách thời trang hình chữ nhật Bò sữa, Ngựa Vằn siêu hot mới",18000,18000,0,0
TIKI,tui-vi-nu,15237390,"Túi đeo điện thoại M001",119000,119000,0,0
TIKI,tui-vi-nu,160315171,"Ví Nữ Mini Cầm Tay PERFECT FOR YOU Đựng Tiền Dáng Vuông Xinh Xắn Da Cao Cấp Cực Đẹp PFY01 - Micocah Mall",99000,99000,0,0
TIKI,tui-vi-nu,8237398,"Ví cầm tay thời trang cho nữ TM-VinuCK63 kiểu dáng sang trọng",209000,209000,0,0
TIKI,tui-vi-nu,125100953,"Túi cầm tay Kim Sa",59000,59000,0,0
TIKI,tui-vi-nu,84103250,"túi ngọc trai mini thời trang dành cho nữ",169000,169000,0,0
TIKI,tui-vi-nu,46782207,"Túi đeo chéo mini nữ thời trang dễ thương cho các bạn nữ hình cute màu hồng",76000,76000,0,0
TIKI,tui-vi-nu,117208903,"Ví dài cầm tay nữ phong cách hàn Quốc, mãi mãi trẻ trung, cá tính, ví dài cầm tay nhiều ngăn siêu tiện dụng, phù hợp cho mọi lứa tuổi. Màu Đỏ đô",159000,159000,0,0
TIKI,tui-vi-nu,59264752,"Ví tiền mini hình chữ vuông nhiều màu siêu dễ thương - Đựng tiền xu, tai nghe tiện lợi - Mẫu ngẫu nhiên",13500,13500,0,0
TIKI,tui-vi-nu,209414557,"Ví túi dự tiệc cầm tay dạ hội sinh nhật khai trương lễ cưới sang trọng VDT10",341000,341000,0,0
TIKI,tui-vi-nu,206661343,"Túi xách TOKYO JAPAN, mã G34. Quà tặng cao cấp cho gia đình, nam nữ cặp đôi, hội nhóm, doanh nghiệp",109000,109000,0,0
TIKI,tui-vi-nu,185849411,"Túi Xách Nữ Thời Trang Dây Đeo Chéo Đeo Vai Kẹp Nách CRESCENT MOON HOBO BAG GIPSY",690000,690000,0,0
TIKI,tui-vi-nu,173856972,"Túi đeo vai đi làm, đi học đẹp giá rẻ, form to, 2 lớp, vải canvas - CON CÁ Heo",69000,69000,0,0
TIKI,tui-vi-nu,209414504,"Ví nữ cầm tay , dự tiệc phong cách hàn quốc hót nhất 2022",282000,282000,0,0
TIKI,tui-vi-nu,192064404,"Túi Xách Nữ Kẹp Nách Chính Hãng MICOCAH Dáng Công Sở Thời Trang Sang Trọng Đeo Vai Đeo Chéo Da Cao Cấp Cực Đẹp MC131 - Tukado",469000,469000,0,0
TIKI,tui-vi-nu,192584343,"Túi Xách Đeo Chéo - Túi Kẹp Nách Nữ Đẹp Đi Chơi Phong Cách Thời Trang Hàn Quốc Dễ Thương Thanh Lịch",130000,130000,0,0
TIKI,tui-vi-nu,133775928,"Túi đeo chéo nữ, túi đựng điện thoại mini dáng dọc thời trang. Phong cách thiếu nữ Hàn Quốc trẻ trung, năng động. Sang chảnh, cá tính- Màu Hồng nhạt",129000,129000,0,0
TIKI,tui-vi-nu,172192141,"Túi Nữ Thời Trang Phong Cách Hàn Quốc Đồ Da Thành Long TLG 208169",30000,30000,0,0
TIKI,tui-vi-nu,157254165,"Ví Nam, Nữ Ngắn Logo SAIGON SWAGGER Nhiều Ngăn, Chống Thấm",280000,280000,0,0
TIKI,tui-vi-nu,13633710,"Túi Vải Tote Cực Xinh G015",69000,69000,0,0
TIKI,tui-vi-nu,132079713,"Túi Chuồn Chuồn Màu Đen",240000,240000,0,0
TIKI,tui-vi-nu,147489111,"Túi kẹp nách, Túi đeo vai, Túi cầm tay bằng da PU trơn kiểu dáng đơn giản hợp thời trang, rộng rãi",99000,99000,0,0
TIKI,tui-vi-nu,206662997,"Túi xách tote RUN, mã G26. Quà tặng cao cấp cho gia đình, nam nữ cặp đôi, hội nhóm, doanh nghiệp",109000,109000,0,0
TIKI,tui-vi-nu,157210295,"Túi tote - Combo Daisy ",364000,364000,0,0
TIKI,tui-vi-nu,171214627,"Túi ví mèo thần tài (màu xanh lá số 11)",45000,45000,0,0
TIKI,tui-vi-nu,25293202,"Túi đeo chéo hình chú chuột Hamster siêu đáng yêu",61000,85239,24239,28
TIKI,tui-vi-nu,74603963,"Túi đeo chéo in hình vui nhộn Mstaly Tặng móc khóa cá heo",50129,52767,2638,5
TIKI,tui-vi-nu,159854395,"SALE OFF- VÍ CẦM TAY CAO CẤP",141428,141428,0,0
TIKI,tui-vi-nu,75414164,"Ví nữ cầm tay 2 ngăn kéo họa tiết hoa văn sang trọng, thiết kế nhiều ngăn tiện dụng TK0070",76000,150000,74000,49
TIKI,tui-vi-nu,107982318,"Túi kẹp nách nữ phối dây xích thời trang nhỏ gọn tiện dụng da mềm đẹp TK0095",49000,90000,41000,46
TIKI,tui-vi-nu,43694766,"Túi nữ thời trang phong cách Hàn Quốc Đồ Da Thành Long TLG 208098",43000,87000,44000,51
TIKI,tui-vi-nu,71725974,"Túi clutch nữ thời trang cao cấp ELLY – ECH46",559300,799000,239700,30
TIKI,tui-vi-nu,176051064,"LỐ 10 TÚI RÚT NHUNG FORM BẦU MÀU XÁM",45000,45000,0,0
TIKI,tui-vi-nu,149449322,"TÚI KẸP NÁCH 2 DÂY- TÚI ĐEO CHÉO TAY KHÓA HÌNH CHỮ D 3 MÀU ĐEN TRẮNG BE SIÊU ĐẸP 2021",145000,145000,0,0
TIKI,tui-vi-nu,187697389,"Túi xách nữ dễ thương NASI T1039 túi cói cầm tay đẹp có nút gài thời trang cho nữ công sở, học sinh",29000,29000,0,0
TIKI,tui-vi-nu,90326354,"Túi đeo thời trang nữ bằng da nhiều màu",71000,71000,0,0
TIKI,tui-vi-nu,188059099,"Túi Đeo Chéo Dạo Phố Dành Cho Nam Nữ (Tặng Kèm Móc Khóa)",419000,419000,0,0
TIKI,tui-vi-nu,44140062,"Túi xách da bò công sở cao cấp phong cách châu âu",801000,890000,89000,10
TIKI,tui-vi-nu,173028224,"Túi ví phong bì da cừu Đồ Da Thành Long TLG 208236 + móc khóa la bàn cao cấp - không thể rẻ hơn",44000,50000,6000,12
TIKI,tui-vi-nu,80020422," Túi Xách Đeo Chéo Hình Vịt Dễ Thương - ahosml - Mã XT017",29000,29000,0,0
TIKI,tui-vi-nu,149449389,"Túi đeo chéo nữ đẹp da cao cấp",101000,101000,0,0
TIKI,tui-vi-nu,182148174,"Túi Tote Da Vừa A4 Dây Đeo Có Nấc Tuỳ Chỉnh Hàng Da Dày Dặn",155000,155000,0,0
TIKI,tui-vi-nu,97904974,"TÚI CÓI NES QUAI DA - MAIHOME MH00",490000,490000,0,0
TIKI,tui-vi-nu,174531702,"Túi xách nữ Efora Sofia 3831-BL túi da thật cao cấp, xách tay, túi đeo chéo, khoác vai đi chơi đi làm",4380000,4380000,0,0
TIKI,tui-vi-nu,172191291,"Túi nữ thời trang phong cách Hàn Quốc Đồ Da Thành Long TLG 208098 3(đỏ)",40000,40000,0,0
TIKI,tui-vi-nu,96987940,"Đeo chéo da Bóp đầm da dạ hội trơn Aly CS35 Tặng móc khóa cá heo",81000,115048,34048,30
TIKI,tui-vi-nu,173265310,"Túi nữ thời trang phong cách sang trọng 208093",43000,72500,29500,41
TIKI,tui-vi-nu,11776283,"Túi xách da công sở Nam nữ cao cấp",99000,99000,0,0
TIKI,tui-vi-nu,56345302,"Túi xách da nam cao cấp phong cách hiện đại mới",329000,599000,270000,45
TIKI,tui-vi-nu,8281119,"Túi Vải Canvas - But First Coffee",124000,169000,45000,27
TIKI,tui-vi-nu,114119939,"túi đeo chéo nữ đẹp - Túi đeo chéo da Hàn Quốc",209000,209000,0,0
TIKI,tui-vi-nu,2020657,"Ví Nữ Da Đà Điểu 1 Khóa Vip Huy Hoàng HT3429 (19 x 10.5 cm) - Đen",1399000,1399000,0,0
TIKI,tui-vi-nu,95394320,"Túi đeo chéo da thật cao cấp 208235",199000,225000,26000,12
TIKI,tui-vi-nu,193748267,"Túi xách thời trang nữ CK23705",530000,530000,0,0
TIKI,tui-vi-nu,180720275,"Túi Xách Thời Trang Nữ Da Thật Cao Cấp Gence TX05 Vàng",1650000,1650000,0,0
TIKI,tui-vi-nu,160346007,"túi xách chấm bi C30019-0148",899000,899000,0,0
TIKI,tui-vi-nu,109286610,"Ví Nữ Ngắn Khóa Trái tim Siêu Xinh VN03",31000,31000,0,0
TIKI,tui-vi-nu,149449354,"(NEW) Túi Vải/ Tote Đeo Chéo - Đeo Vai - Đi Học Cho Sinh Viên Ullzang Chất Vải Dày Dặn Tặng Kèm Gấu NEVA869",243000,243000,0,0
TIKI,tui-vi-nu,180046006,"Túi đeo chéo nữ thời trang cao cấp phong cách mới",171000,190000,19000,10
TIKI,tui-vi-nu,149245843,"Túi thời trang nữ da bò thật",5000000,5000000,0,0
TIKI,tui-vi-nu,174531649,"Túi xách nữ Efora Viola 3609-WHI túi da thật cao cấp, xách tay, túi đeo chéo, khoác vai đi chơi đi làm",4380000,4380000,0,0
TIKI,tui-vi-nu,25135379,"Túi Vải Canvas PINK Đeo Vai Siêu Hot ",97000,97000,0,0
TIKI,tui-vi-nu,58808054,"Túi Đeo Chéo Con Vịt - Giao màu ngẫu nhiên",25000,25000,0,0
TIKI,tui-vi-nu,45412206,"TÚI XÁCH DÁNG HỘP KHÓA CHỮ NHẬT TX002",1500000,1500000,0,0
TIKI,tui-vi-nu,210414149,"Túi Xách Đeo Chéo Nữ Công Sở Đi Tiệc Dạo Phố Cao Cấp Đường May Đẹp LH118",835000,835000,0,0
TIKI,tui-vi-nu,174511265,"Túi nữ thời trang phong cách Hàn quốc 205954 1 (Đen)",30000,30000,0,0
TIKI,tui-vi-nu,115439236,"VÍ DA NAM NỮ CẦM TAY",167000,167000,0,0
TIKI,tui-vi-nu,156729826,"Ví nhỏ cầm tay nữ da thật 9x13 VN07",157500,157500,0,0
TIKI,tui-vi-nu,137154135,"Móc Khóa Cừu Trang Trí Túi Vải, Balo Chất Liệu Bông Trắng Siêu Dễ Thương",32000,32000,0,0
TIKI,tui-vi-nu,124182419,"Túi xách nữ cao cấp da thật ELLY – ET123",2999000,2999000,0,0
TIKI,tui-vi-nu,103459752,"Túi đeo chéo Bubble",105000,105000,0,0
TIKI,tui-vi-nu,161560563,"Túi xách nữ thời trang phong cách Thành Long TLG 208094 Tặng túi đựng mỹ phẩm tiện lợi",54000,75000,21000,28
TIKI,tui-vi-nu,43694670,"Túi nữ thời trang phong cách Hàn Quốc Đồ Da Thành Long 208169 ZZ",34000,46400,12400,27
TIKI,tui-vi-nu,26428131,"Túi đeo chéo Nữ đính kim tuyến sang trọng + Tặng vòng đeo tay",59000,59000,0,0
TIKI,tui-vi-nu,173281123,"Túi Nữ Đeo Chéo Thời Trang Hàn Quốc 208063 - vàng",32000,46600,14600,31
TIKI,tui-vi-nu,217564195,"Túi đeo chéo Pop-it nhỏ xinh cho các bé. hình xinh xắn ,dây đeo màu sắc",59000,59000,0,0
TIKI,tui-vi-nu,71355445,"Túi kẹp nách nữ da vân cá sấu, có dây đeo thời trang phối dây xích siêu hót TK0061 - Nâu",50000,100000,50000,50
TIKI,tui-vi-nu,82916516,"Túi Xách Nữ Đeo Chéo Vân Da Sần Khóa Bấm Vuông 2 Dây Đeo Thời Trang Dạo Phố  Không kèm Cục Bông D189",76000,76000,0,0
TIKI,tui-vi-nu,173254727,"Ví nữ da thật vân cá sấu 204405",144000,144000,0,0
TIKI,tui-vi-nu,148850130,"Túi đeo hông, đeo ngực Arctic Hunter YB00043 chất liệu Oxford chống thấm nước, nhiều ngăn đa năng, phù hợp chạy bộ",369000,715000,346000,48
TIKI,tui-vi-nu,51718050,"Túi Đeo Chéo Thời Trang Nữ Cao Cấp SV002(Tặng Kèm 1 Kẹp Tóc Xinh Xắn Màu Ngẫu Nhiên)",259000,259000,0,0
TIKI,tui-vi-nu,132079038,"Túi Đeo Chéo Caro Size Lớn T20 Màu Đen",145000,198000,53000,27
TIKI,tui-vi-nu,76393715,"Ví đựng thẻ HANHSON SP000652 da bò nâu vàng ",750000,750000,0,0
TIKI,tui-vi-nu,247348218,"Túi Xách Đeo Chéo Nữ LEO Thời Trang Sang Trọng Da Cao Cấp Cực Đẹp TX16",129000,129000,0,0
TIKI,tui-vi-nu,173253219,"Ví nữ thời trang da mềm 204410",38000,69600,31600,45
TIKI,tui-vi-nu,152015296,"Túi Vải Canvas No Mask Not Going Out",150000,150000,0,0
TIKI,tui-vi-nu,17522341,"Túi đeo chéo nữ",55000,55000,0,0
TIKI,tui-vi-nu,172191730,"Túi Đeo Chéo Nữ Cao Cấp - Có Lỗ Kéo Dây Tai Nghe - Hàng Nhập - Mẫu Hàn Quốc 208152",30000,30000,0,0
TIKI,tui-vi-nu,11195006,"Túi xách công sở nam TROY phối nắp dây nịt gài MS03",400000,400000,0,0
TIKI,tui-vi-nu,7261987,"Ví nữ cầm tay da mềm cao cấp nhiều ngăn For Young",53999,53999,0,0
TIKI,tui-vi-nu,166068512,"Túi đeo vai cao cấp hình lưỡi",857000,857000,0,0
TIKI,tui-vi-nu,173276635,"Túi xách da thật Đồ Da Thành Long  205774 (Nâu)",499000,604000,105000,17
TIKI,tui-vi-nu,132079653,"Túi Đeo Chéo Caro Size Lớn T20 Màu Hồng Đỏ",158400,198000,39600,20
TIKI,tui-vi-nu,111868921,"Balo một dây đeo chéo Arctic Hunter XB00081 chất liệu Oxford chống thấm nước, unisex nam nữ,trang bị cổng sạc USB",369000,635000,266000,42
TIKI,tui-vi-nu,41099714,"Ví bóp nữ cầm tay đựng tiền nhỏ mini siêu đẹp manoto VN16",37000,37000,0,0
TIKI,tui-vi-nu,143300787,"HJ6401-02-03-04 - Túi xách da đà điểu Huy Hoàng màu đen, nâu đỏ, vàng bò, nâu đất",12599000,12599000,0,0
TIKI,tui-vi-nu,167057537,"VÍ SEN HOA EDITION  - CHÍNH HÃNG KHACTEN.COM",2100000,2100000,0,0
TIKI,tui-vi-nu,153979014,"Túi xách Nữ 15.6 inch Solo Varsity Lead - Mã VAR101-4 - Màu đen - Chất liệu nylon kháng nước - Bảo hành chính hãng 5 năm",1265000,1265000,0,0
TIKI,tui-vi-nu,147942454,"Túi Xách Nữ Đeo Chéo Chính Hãng FOREVER YOUNG Dáng Công Sở Thời Trang Da Cao Cấp Siêu Đẹp FY24 - Tukado",489000,489000,0,0
TIKI,tui-vi-nu,76246070,"Túi xách nữ đeo chéo kiểu dáng trong suốt hai lớp, có thể tháo rời, phong cách cá tính, thời thượng",115000,115000,0,0
TIKI,tui-vi-nu,56431998,"Ví dài nữ cầm tay thời trang Hàn Quôc",35000,35000,0,0
TIKI,tui-vi-nu,193202467,"Túi Da Đeo Chéo Nam Nữ Mini Chống Nước, Sang Trọng, Nhiều Ngăn Mẫu Túi Hiện Đại",125000,125000,0,0
TIKI,tui-vi-nu,169733293,"Ví Nữ Đựng Thẻ LISA Đẹp Da Saffiano Cầm Tay Mini Nhiều Ngăn Card Holder Cao Cấp Chống Thấm Bò Thật Nam Nút Bấm DOLANTO",238000,238000,0,0
TIKI,tui-vi-nu,204987540,"Túi Tote size khổng lồ; chất liệu vải không dệt, hàng dầy chịu tải 40kg, in hình  hồng hạc vintage T588",15000,15000,0,0
TIKI,tui-vi-nu,209414305,"Ví bóp nữ cầm tay hai dây kéo hai khóa họa tiết quả trám giá rẻ cầm mềm tay VT200",113000,113000,0,0
TIKI,tui-vi-nu,208615901,"Ví da nữ cầm tay thời trang Lata VN70",430000,430000,0,0
TIKI,tui-vi-nu,5003429,"Túi Clutch Nữ Cao Cấp Da Thật Elly EC3",1680000,1680000,0,0
TIKI,tui-vi-nu,119329927,"Túi đeo chéo nữ, túi đựng điện thoại cao cấp, túi đi chơi mini nhỏ gọn đẹp giá rẻ, phong cách thiếu nữ Hàn Quốc, sang chảnh, cá tính",149000,149000,0,0
TIKI,tui-vi-nu,198227962,"Tú xách nữ cao cấp da thật ELLY – ET144",1699000,1699000,0,0
TIKI,tui-vi-nu,74630124,"Túi đeo chéo nữ đựng điện thoại di động Chụp ảnh in hình Kỳ diệu X32 Tặng móc khóa cá heo",66000,93492,27492,29
TIKI,tui-vi-nu,118840891,"Túi cói mềm có khóa kéo form sịn sò",170000,170000,0,0
TIKI,tui-vi-nu,191717415,"TÚI ĐEO CHÉO NỮ THỜI TRANG 3 NGĂN CAO CẤP PHONG CÁCH HÀN QUỐC TRẺ TRUNG",99000,99000,0,0
TIKI,tui-vi-nu,154857519,"Túi cói đi biển Sunday - Túi cói Vintage",160000,160000,0,0
TIKI,tui-vi-nu,155608690,"Ví nữ HANHSON màu nâu vàng",680000,680000,0,0
TIKI,tui-vi-nu,202626740,"Ví nữ gấp mini da bò trơn Pink Ohara",550000,550000,0,0
TIKI,tui-vi-nu,68211226,"Túi xách tay nữ cao cấp hàng xuất châu Âu",370000,370000,0,0
TIKI,tui-vi-nu,73930235,"TÚI DA ĐEO CHÉO NỮ DÂY ĐAN TẶNG KÈM VÍ TTS 470",55000,55000,0,0
TIKI,tui-vi-nu,188033664,"Túi Xách Nữ Cầm Tay, Đeo chéo Da Cao Cấp Hiệu HADATI - Túi Đi Gọn, Nhẹ Đi Tiệc, Đi Du Lịch, Cafe, Đi Làm Vừa Đẹp, Sang, Xinh [Size 28cmx11x21] AllWELLSHOP",599000,599000,0,0
TIKI,tui-vi-nu,149449518,"Túi xách nữ đeo chéo cao cấp dáng tròn size 18",294000,294000,0,0
TIKI,tui-vi-nu,31878057,"Combo Túi Xách Tay Công Sở Nữ Có Dây Đeo Chéo và Ví Cầm Tay LH04 - Đen",319000,319000,0,0
TIKI,tui-vi-nu,174400013,"Túi Xách Nữ Đeo Chéo MICOCAH Dáng Công Sở Thời Trang Vân Quả Trám Sang Trọng Thanh Lịch Da Cao Cấp Cực Đẹp MC61",429000,429000,0,0
TIKI,tui-vi-nu,120068208,"Túi xách nữ đeo chéo đẹp thời trang da bò Kalanos KTNU2020-Trang, Túi xách nữ nhỏ gọn đa năng đựng vừa điện thoại màu tr",599000,599000,0,0
TIKI,tui-vi-nu,137164580,"Khóa tăng giảm phụ kiện túi phụ kiện may mặc (10 chiếc)",33000,33000,0,0
TIKI,tui-vi-nu,193549792,"Ví Nữ Thời Trang cao cấp phong cách mới – VNU1005",135000,270000,135000,50
TIKI,tui-vi-nu,7947415,"Túi Tote Vải Canvas "No Thank You" T026-B",49000,49000,0,0
TIKI,tui-vi-nu,176002011,"Ví da nữ cầm tay nắp gập YUUMY Seasand YV61",149000,330000,181000,55
TIKI,tui-vi-nu,55234019,"Túi Vải Bố Thời Trang",280000,280000,0,0
TIKI,tui-vi-nu,149148535,"Tẩy tế bào chết toàn thân L-Glutathione Body Exfoliating Cream Whitening Hàn Quốc",60000,100000,40000,40
TIKI,tui-vi-nu,160314401,"Ví Nữ Dài Cầm Tay TAILIAN Da Vân Cá Sấu Thời Trang Nhiều Ngăn Đựng Tiền Điện Thoại Da Cao Cấp Cực Đẹp Giá Rẻ TL26",129000,129000,0,0
TIKI,tui-vi-nu,195971835,"Túi xách nữ cao cấp da thật ELLY – ET146",2599000,2599000,0,0
TIKI,tui-vi-nu,45305132,"Túi xách nữ đeo chéo nhỏ xinh mini cực đẹp Linoza TX09",45000,45000,0,0
TIKI,tui-vi-nu,93291043,"Marhen.J - Túi đeo vai chữ nhật nắp gập vải bố Roy Mini MJ19AROYMN-IV",3390000,3390000,0,0
TIKI,tui-vi-nu,190888530,"Túi đeo chéo NASI T1036 phong cách hàn quốc túi xách nữ đeo vai thời trang dạo phố dễ thương vải đẹp",49000,49000,0,0
TIKI,tui-vi-nu,200679200,"NHÀ MỊ - Túi Xách handmade Len Đan Móc Thủ Công - Floral Handmade Bag",760000,760000,0,0
TIKI,tui-vi-nu,169706264,"Túi Xách Nữ Đeo Chéo Hình Hộp Nhiều Màu, Túi Tote Vải Hình Hộp Siêu Xinh - OTV145 - Ope Store",125000,125000,0,0
TIKI,tui-vi-nu,113498879,"Túi Cói Merci",54900,54900,0,0
TIKI,tui-vi-nu,128861996,"HJ3111-12-13-14-15 - Bóp nữ da thật cao cấp Huy Hoàng 3 gấp màu da, đen, đỏ, hồng, nâu",839000,839000,0,0
TIKI,tui-vi-nu,77445949,"TÚI XÁCH NỮ ĐEO CHÉO (TX-081-2)",69000,69000,0,0
TIKI,tui-vi-nu,173168419,"Túi vải bố, Túi vải Canvas trơn Màu Trắng - Màu Đen Màu Be Size 36cm x 31cm",35000,35000,0,0
TIKI,tui-vi-nu,184414218,"Túi đeo chéo thời trang chính hãng NATOLI  BST mini Daily Crossbag chất vải canvas kháng nước cao cấp",139000,199000,60000,30
TIKI,tui-vi-nu,147202616,"Túi Hậu Môn Nhân Tạo 2 Mảnh- Hollister (Trong, Lọc Khí, Khóa Cuốn), 18192 / 18193 / 18194 -VT0738",567000,567000,0,0
TIKI,tui-vi-nu,203913270,"Túi Xách Nữ Đeo Chéo Đeo Vai Quảng Châu Cao Cấp Đi Học Đi Chơi Siêu Xinh TUVIDA_VN TX12",183750,183750,0,0
TIKI,tui-vi-nu,171626300,"Túi Xách Nữ Thời Trang Ulzzang Đi Học, Đi Chơi, Túi Đeo Chéo Nhiều Màu Đựng Đồ Cỡ Lớn Nhiều Ngăn - OTV117 - Ope Store",179000,179000,0,0
TIKI,tui-vi-nu,170583283,"Túi đeo hông thể thao unisex New Balance Core Perf - LAB13150 (21x40x11cm)",447000,595000,148000,25
TIKI,tui-vi-nu,155609841,"Ví nữ HANHSON da đà điểu màu hồng",1050000,1050000,0,0
TIKI,tui-vi-nu,69509321,"Ví nữ cầm tay có khóa kéo sang trọng, nhiều ngăn tiện dụng TK0060",59000,100000,41000,41
TIKI,tui-vi-nu,109767833,"Túi Đựng Điện Thoại Đeo Chéo Cao Cấp, Ví Đựng Tiền Tiện Lợi",68000,68000,0,0
TIKI,tui-vi-nu,48509489,"Túi Xách Vải Nữ Hàn Quốc Đeo Vai , Đeo Chéo Birming Ham Tiện Lợi TH022",93000,93000,0,0
TIKI,tui-vi-nu,188713897,"Ví cầm tay nữ PANDAGO Selina 01 nhiều ngăn cao cấp cute dễ thương nhỏ gọn da thật thời trang",400000,400000,0,0
TIKI,tui-vi-nu,31877259,"Túi xách công sở nữ có dây đeo chéo da mềm mịn, chống nươc, chống trầy xước LT02 - Vàng",299000,299000,0,0
TIKI,tui-vi-nu,190540438,"Túi đeo chéo nữ Aldo UNILA",1650000,1650000,0,0
TIKI,tui-vi-nu,160314387,"Ví Nữ Dài Cầm Tay Chính Hãng TAILIAN Dáng Basic Sang Trọng Thanh Lịch Da Cao Cấp Nhiều Ngăn Tiện Dụng TL07",139000,139000,0,0
TIKI,tui-vi-nu,113500282,"Túi Đựng Điện Thoại Phong Cách Hàn Quốc Trẻ Trung Cho Nữ",149000,149000,0,0
TIKI,tui-vi-nu,169423006,"Túi Tote Vải Canvas Nữ Ulzzang Hot Trend Kita Unisex - Mẫu 3 Chú Gà - Ảnh thật ( Có khóa)",39000,70000,31000,44
TIKI,tui-vi-nu,41355724,"Ví bóp da nữ mini cầm tay nhỏ gọn Minoxi siêu hot VN17",63000,63000,0,0
TIKI,tui-vi-nu,176470921,"Túi xách đính đá thời trang nữ",359000,359000,0,0
TIKI,tui-vi-nu,113496493,"Túi Cói Merci Đi Biển Cao Cấp",65990,65990,0,0
TIKI,tui-vi-nu,173996525,"Phụ Kiện Túi Vải YUUMY Cỡ Nhỏ YBVLN",10000,10000,0,0
TIKI,tui-vi-nu,86561978,"Túi xách nữ - Túi đeo chéo mini nữ hàng quảng châu siêu đẹp - siêu hot TD17",141700,141700,0,0
TIKI,tui-vi-nu,15467577,"Ví đựng thẻ ATM",9000,9000,0,0
TIKI,tui-vi-nu,162406968,"Ví - bóp mini tiện ích đựng thẻ ngân hàng, card visit, thẻ ATM siêu dễ thương nhỏ gọn",9000,9000,0,0
TIKI,tui-vi-nu,74622871,"Túi đeo chéo cầm tay Dự tiệc ép chữ mẫu mới  XC22 Tặng móc khóa cá heo",82000,116358,34358,30
TIKI,tui-vi-nu,149449217,"Túi xách nữ phối nơ - dây đeo chéo , kẹp nách chất liệu da PU cao cấp dáng vuông cho các cô nàng tiểu thư",118000,118000,0,0
TIKI,tui-vi-nu,173782267,"Túi Lục Bình Đi Biển Cao Cấp, Túi Xách Thời Trang, Túi Dạo Phố Mua Sắm",329000,329000,0,0
TIKI,tui-vi-nu,189552204,"Túi Xách Nữ Da Bò Cao Cấp Có 2 Kiểu Dây Đeo Phong Cách Công Sở TXD037 - Màu Xanh Dương, Size 28cm",890000,890000,0,0
TIKI,tui-vi-nu,115988863,"Túi đi biển Macrame Handmade",324500,324500,0,0
TIKI,tui-vi-nu,21979764,"Ví nữ da bò vân cá sấu nhỏ 2 gấp Huy Hoàng",599000,599000,0,0
TIKI,tui-vi-nu,186711474,"Túi xách nữ dễ thương NASI T1025 túi cói hình gấu cầm tay đẹp có dây kéo hoặc gài nút thời trang cho nữ công sở, học sinh",29000,29000,0,0
TIKI,tui-vi-nu,186261781,"Túi tote cói túi đeo vai phong cách vintage, phụ kiện đi biển không thể thiếu",205000,300000,95000,32
TIKI,tui-vi-nu,188043212,"Túi xách thời trang nữ cao cấp  ELLY – EL211",1299000,1299000,0,0
TIKI,tui-vi-nu,159004219,"Túi Vải Canvas UAG - Hàng Chính Hãng",200000,200000,0,0
TIKI,tui-vi-nu,160314489,"Ví Nữ Ngắn Mini Cầm Tay Đựng Tiền Chính Hãng TAILIAN Thời Trang Kẻ Caro Xinh Xắn Da Cao Cấp Cực Đẹp TL12 - Micocah Mall",119000,119000,0,0
TIKI,tui-vi-nu,160315146,"Ví nữ ngắn mini cầm tay BATSIOE nhỏ gọn nhiều ngăn đựng tiền dễ thương da cao cấp cực đẹp giá rẻ BS03 - Micocah Mall",129000,129000,0,0
TIKI,tui-vi-nu,136940149,"Ví tiền thổ cẩm có dây đeo chéo ( cực hot)",15000,15000,0,0
TIKI,tui-vi-nu,118852192,"túi xách nữ công sở có thế đeo chéo phong cách",99000,99000,0,0
TIKI,tui-vi-nu,151923639,"Túi xách nữ bản to _Túi công sở đựng vừa A4",175000,175000,0,0
TIKI,tui-vi-nu,106311943,"Túi xách Clutch cầm tay và đeo chéo da cao cấp san trọng TX-005",190000,190000,0,0
TIKI,tui-vi-nu,45200839,"Túi đeo chéo nữ thời trang Châu Âu",359000,359000,0,0
TIKI,tui-vi-nu,91127952,"Túi đeo chéo thế hệ mới Mark Ryden – TECNOLOGIA",1105000,1105000,0,0
TIKI,tui-vi-nu,157213359,"Túi Đựng Phụ Kiện RINGKE Pouch - Hàng Chính Hãng",204000,250000,46000,18
TIKI,tui-vi-nu,153460092,"Ví Zip Mini Cho Nữ Có Dây Đeo Tay GIPSY",350000,350000,0,0
TIKI,tui-vi-nu,6772451,"Ví Passport Hand made",450000,450000,0,0
TIKI,tui-vi-nu,190574784,"Túi xách nữ thời trang cao cấp ELLY – EL218",779400,1299000,519600,40
TIKI,tui-vi-nu,11760475,"Cặp Công Sở Laptop Màu Đen",4500000,4500000,0,0
TIKI,tui-vi-nu,79414523,"Ví Da SAVER Đẹp Cầm Tay Da Nappa Cao Cấp Nhập Khẩu Khóa Kéo Tiện Lợi Thông Dụng DOLANTO",188000,188000,0,0
TIKI,tui-vi-nu,196791610,"Túi da đeo chéo nhiều ngăn tiện dụng",150000,150000,0,0
TIKI,tui-vi-nu,126705832,"Túi xách nữ da bò thật cao cấp FREYA 24.5",3490000,3490000,0,0
TIKI,tui-vi-nu,186743246,"Túi xách nữ dễ thương NASI T1026 túi cói cầm tay đẹp có dây kéo thời trang cho nữ công sở, học sinh",29000,29000,0,0
TIKI,tui-vi-nu,191502908,"Túi xách tay nữ Aldo AREAWIEL",1650000,1650000,0,0
TIKI,tui-vi-nu,71934929,"Túi xách nữ/Túi đeo chéo đeo vai nữ thời trang cao cấp thiết kế mới nhất mùa thời trang 2020-2021",340000,340000,0,0
TIKI,tui-vi-nu,117294770,"Túi cói tròn đeo chéo hình Lá và Dứa (hàng có sẵn)",89000,89000,0,0
TIKI,tui-vi-nu,186568770,"Túi đeo chéo PopEye NASI T1017 phong cách hàn quốc túi đeo vai nữ thời trang dạo phố dễ thương vải đẹp",49000,49000,0,0
TIKI,tui-vi-nu,72040184,"Túi Xách Nữ Thời Trang Cao Cấp",65000,65000,0,0
TIKI,tui-vi-nu,177185356,"Túi Xách Lục Bình Đính Hoa Cúc Cao Cấp, Chuẩn Đẹp, Túi Cói, Giỏ Xách Dự Tiệc, Dạo Phố, Đi Làm Đẹp",309000,309000,0,0
TIKI,tui-vi-nu,179776541,"Túi Cói, Túi Xách Cỏ Bàng Vẽ Hồng Hạc Đẹp Lạ",339000,339000,0,0
TIKI,tui-vi-nu,192725936,"Túi Xách Nữ Quai Lụa Da Mịn, Túi Mini Nữ đẹp Cá Tính Sang Chảnh PT087045",980000,980000,0,0
TIKI,tui-vi-nu,36273950,"Túi đeo chéo vải canvas, túi vải nữ TV05, phong cách Hàn Quốc, thời trang trẻ",50000,50000,0,0
TIKI,tui-vi-nu,73994855,"Túi Đeo Chéo Nữ Cao Cấp Phối Khóa - SMALL CROSSBODY PURSE - HGcork Corkor CK159 - Vật liệu da cork thực vật thuần chay - Sản phẩm Handmade, Sản xuất tại Bồ Đào Nha",1709050,1799000,89950,5
TIKI,tui-vi-nu,76827288,"DKMV Ví ngắn vải canvas in logo con cá - DKMV Wallet Label",170000,170000,0,0
TIKI,tui-vi-nu,34231736,"Túi xách CNT nữ TX25 cao cấp",295000,295000,0,0
TIKI,tui-vi-nu,176127217,"Vỏ Bọc Hộ Chiếu (Passport) Trong Suốt Có Khe Kẹp Vé Thẻ ATM Bền Bỉ Tiện Dụng",2999,2999,0,0
TIKI,tui-vi-nu,37495739,"Ví  Bóp Ngang Nữ Mini Cầm Tay Vuông Forever Da Pu Cao Cấp Khóa Kéo Chắc Chắn (4 màu:hồng,đen,xám,xanh dương)",25000,30000,5000,17
TIKI,tui-vi-nu,217519097,"Túi , Ví đeo chéo cho bé , hình xinh yêu ,Làm bằng cao su non ,mềm mại và an toàn",89000,89000,0,0
TIKI,tui-vi-nu,134025588,"Ví cầm tay nam nữ, ví dài sang trọng, Ví da cao cấp, ví nam Quảng Châu, ví nữ thời trang, ví da bò",170500,170500,0,0
TIKI,tui-vi-nu,77446713," Túi Đeo Chéo Nữ Phong Cách Sang Trọng - Túi Xách Nữ (TX-080) - [Hàng Chất Lượng",49000,49000,0,0
TIKI,tui-vi-nu,73502223,"Túi Đeo Chéo Nữ Dáng Hộp Nắp Gập Style Sang Chảnh Đi Làm, Đi Chơi, Dự Tiệc Đều Đẹp (21x14cm)",169000,169000,0,0
TIKI,tui-vi-nu,107962515,"Ví Da Mini Unisex - Ví Nữ Mini Handmade Da Bò Thật",139000,139000,0,0
TIKI,tui-vi-nu,185468019,"ví mini nữ đựng thẻ hàng hiệu nhỏ xinh mỏng nhẹ chứa thẻ xe, thẻ ngân hàng - NR073",88000,159000,71000,45
TIKI,tui-vi-nu,149402837,"TÚI TOTE ĐEO CHÉO BƯỚM",87000,87000,0,0
TIKI,tui-vi-nu,116639051,"Túi thổ cẩm đeo chéo",25000,25000,0,0
TIKI,tui-vi-nu,187725651,"Túi xách nữ dễ thương NASI T1040 túi cói cầm tay đẹp có dây kéo hoặc gài nút thời trang cho nữ công sở, học sinh",29000,29000,0,0
TIKI,tui-vi-nu,10717329,"Túi cói túi tote đi biển đan tay phong cách tối giản kiểu hàn quốc see thru crotched straw bag",200000,200000,0,0
TIKI,tui-vi-nu,88051137,"Túi xách đeo chéo nữ thời trang cao cấp HuongTra99-5566a",1199000,1199000,0,0
TIKI,tui-vi-nu,20447897,"Túi Vải Tote Đeo Chéo Balo Mẫu Ghép Hàng Quảng Châu Cực Tốt",106000,106000,0,0
TIKI,tui-vi-nu,103458507,"Túi tote Snoppy chất vải mềm mịn thời trang - Tặng dây buộc tóc hoa quả",110000,110000,0,0
TIKI,tui-vi-nu,71624227,"Ví nữ thời trang cao cấp cầm tay dự tiệc sang trọng và thời thượng",490000,490000,0,0
TIKI,tui-vi-nu,42735009,"Ví cầm tay nữ kiêm túi đeo chéo nữ da nắp đường tròn có khóa gài lớn, kiểu dáng sang trọng, lịch lãm",146000,146000,0,0
TIKI,tui-vi-nu,271924712,"Túi đeo chéo da nữ dáng hộp LATA HN109",590000,590000,0,0
TIKI,tui-vi-nu,176897259,"Clutch nữ cầm tay da bò thật mềm mại - Pink Ohara",590000,590000,0,0
TIKI,tui-vi-nu,191775162,"Túi Xách Nữ Kẹp Nách Chính Hãng MICOCAH Dáng Công Sở Thời Trang Đeo Vai Đeo Chéo Tiện Dụng Da Cao Cấp Cực Đẹp MC135",479000,479000,0,0
TIKI,tui-vi-nu,49956510,"Túi đeo nữ thời trang  dây xích, nhỏ xinh, chất liệu PU bền đẹp TK0040",45000,78000,33000,42
TIKI,tui-vi-nu,193720448,"TÚI ĐEO CHÉO UNISEX ĐỰNG ĐIỆN THOẠI CHẤT LIỆU DA CAO CẤP CHỐNG NƯỚC",330000,330000,0,0
TIKI,tui-vi-nu,178313019,"Túi Cói, Túi Xách Cỏ Bàng Vẽ Đẹp Lạ, Giỏ Xách Du Lịch, Túi Đựng Đồ Đa Năng",359000,359000,0,0
TIKI,tui-vi-nu,188750895,"Túi Xách Nam Da Bò Có Quai Đeo Cao Cấp Màu Nâu WT Leather HORNS",6500000,6500000,0,0
TIKI,tui-vi-nu,172993694,"Túi Đeo Quân Đội Thời Trang 208128",90000,90000,0,0
TIKI,tui-vi-nu,196373076,"Túi xách nữ da cá sấu BẠCH TẠNG hàng hiếm!",3400000,5500000,2100000,38
TIKI,tui-vi-nu,98632063,"Ví ngắn nữ cầm tay mini nhiều ngăn đựng thẻ",99000,99000,0,0
TIKI,tui-vi-nu,248990754,"Nút chén (nút 4 thành phần)",45000,45000,0,0
TIKI,tui-vi-nu,5977577,"Túi Đeo Simplecarry Sling Big (40 x 25cm) - Black",540000,540000,0,0
TIKI,tui-vi-nu,51296455,"Túi Vải nữ Tote Đeo Vai Hàn Quốc",75900,75900,0,0
TIKI,tui-vi-nu,193002777,"Túi Xách Nữ Kẹp Nách Chính Hãng MICOCAH Dáng Công Sở Thời Trang Đeo Vai Đeo Chéo Tiện Dụng Da Cao Cấp Cực Đẹp MC135 - Tukado",489000,489000,0,0
TIKI,tui-vi-nu,12218126,"Túi Bao Tử Đeo Chéo Da PU Quai Sọc 3 Màu Trẻ Trung Parisa",34000,48708,14708,30
TIKI,tui-vi-nu,67484516,"túi xách nam da bò thật -túi xách nam da bò cao cấp",719000,798000,79000,10
TIKI,tui-vi-nu,248978905,"Túi đi học thêm",90000,90000,0,0
TIKI,tui-vi-nu,108254100,"Túi Đeo Chéo Nữ Dáng Cốp Mini Siêu Cá Tính Mẫu Mới Nhất",89000,89000,0,0
TIKI,tui-vi-nu,210414187,"Túi xách nữ đẹp giá rẻ công sở thời trang đi làm dự tiệc cao cấp LH114",1375000,1375000,0,0
TIKI,tui-vi-nu,96445933,"Túi xách nữ đeo chéo vân da cá sấu cao cấp TX15 túi xách đeo vai",249000,249000,0,0
TIKI,tui-vi-nu,186749652,"Túi xách nữ dễ thương NASI T1027 túi cói gắn gấu bông cầm tay đẹp có dây kéo thời trang cho nữ công sở, học sinh",39000,39000,0,0
TIKI,tui-vi-nu,39363937,"Túi đeo chéo mini Chaomfirfn phong cách Hàn Quốc",107000,107000,0,0
TIKI,tui-vi-nu,107962706,"Ví da mini nữ handmade sành điệu cá tính dành cho cô nàng sang chảnh",199000,199000,0,0
TIKI,tui-vi-nu,75801866,"Túi xách, túi đeo vai nữ cổ điển TĐ44 thời trang cao cấp tặng móc khóa cá heo",134640,194480,59840,31
TIKI,tui-vi-nu,141935291,"Túi xách nữ - túi quảng châu hai quai đeo dùng làm túi kẹp nách bản da rắn nhiều màu",249000,249000,0,0
TIKI,tui-vi-nu,251384693,"Túi đeo chéo gấu dâu đáng yêu",65000,65000,0,0
TIKI,tui-vi-nu,187061154,"HỘP GIẢ GỖ LÓT VẢI VÀNG ĐỰNG VÒNG TAY , CHUỖI PHONG THỦY",45000,45000,0,0
TIKI,tui-vi-nu,71095889,"TÚI ĐEO CHÉO CHO NỮ MÀU HỒNG",69000,69000,0,0
TIKI,tui-vi-nu,187642886,"Túi Cói Merci - 4 mẫu siêu hot",54900,54900,0,0
TIKI,tui-vi-nu,76541991,"Túi Vải, Túi Tote Vải Canvas Bag Siêu Xinh",109000,109000,0,0
TIKI,tui-vi-nu,116862979,"Túi đeo chéo da thật cao cấp 208235",199000,225000,26000,12
TIKI,tui-vi-nu,36524890,"Ví đựng passport cao cấp",50000,50000,0,0
TIKI,tui-vi-nu,72938961,"Ví cầm tay unisex da bò nhập khẩu R01",280000,620000,340000,55
TIKI,tui-vi-nu,156271733,"Ví nhỏ cầm tay nữ da thật 9x13 VN06",148500,148500,0,0
TIKI,tui-vi-nu,72640552,"Túi cói đi biển túi tote phong các Vintage boho, có tua rua đen",240000,240000,0,0
TIKI,tui-vi-nu,106654834,"Ví nữ dài cầm tay, ví nữ đẹp, ví nữ thời trang, ví nữ đựng điện thoại, ví nữ cầm tay thời trang, ví nữ đựng tiền, bóp nữ",89000,89000,0,0
TIKI,tui-vi-nu,35936786,"Bộ balo túi xách nữ 3 món thời trang",79000,79000,0,0
TIKI,tui-vi-nu,78512627,"Đeo chéo đeo đeo vai cho bé và người lớn Hình Nơ hello ngây ngô đa sắc Dt54 Tặng móc khóa độc quyền",43000,60614,17614,29
TIKI,tui-vi-nu,248684511,"Túi sách nữ khóa vuông ô thời trang cá tính sang trọng ",130000,130000,0,0
TIKI,tui-vi-nu,163792870,"TÚI ĐEO CHÉO. TÚI XÁCH NỮ DA MỀM NỮ MÀU ĐEN",200000,200000,0,0
TIKI,tui-vi-nu,164430160,"Ví dài nữ da bò cao cấp MARRANT BHM8303N mẫu mới, nhiều màu",450000,450000,0,0
TIKI,tui-vi-nu,109449937,"Ví Nữ Mini Ngắn Cầm Tay Dễ Thương Nữ Tính Phong Cách Hàn Quốc CTVI107",31000,31000,0,0
TIKI,tui-vi-nu,43348955,"Túi xách tay nữ",120000,120000,0,0
TIKI,tui-vi-nu,77444506," Ví Cầm Tay Nữ - Bóp Cầm Tay Nữ - Ví Dự Tiệc - Bóp Dự Tiệc - Clutch (VI-NU-059) MUA NHIỀU GIẢM GIÁ ",359000,359000,0,0
TIKI,tui-vi-nu,196203264,"Túi Xách Lục Bình Bán Nguyệt Quai Gỗ Chuẩn Đẹp-Giỏ Lục Bình Sang Trọng TXLBBNQGLTK02",289000,289000,0,0
TIKI,tui-vi-nu,107962435,"Ví mini nữ đựng thẻ vô cùng nhỏ gọn, nhiều ngăn phù hợp đựng tiền, các loại thẻ",89000,89000,0,0
TIKI,tui-vi-nu,207837405,"Túi Tote Vải Đi Học Kẻ Ô Siêu Xinh, Túi Xách Nữ Vải Canvas Thời Trang Đi Chơi, Đựng Đồ - OTV216 - Ope Store",200000,200000,0,0
TIKI,tui-vi-nu,137529159,"Túi ví đeo chéo, cầm tay mini 2 trong 1 vân chỉ có dây phong cách sang, xịn, mịn",69000,138000,69000,50
TIKI,tui-vi-nu,58742659,"Túi Đeo Chéo Nữ Cao Cấp Crossbody - HGcork Corkor CK249 – Xách tay, Đeo vai tiện dụng - Hàng Chính Hãng, Sản Xuất Tại Bồ Đào Nha",2849050,2999000,149950,5
TIKI,tui-vi-nu,182714111,"Ví Nữ Monogram Canvas ELLY – EV87",449500,899000,449500,50
TIKI,tui-vi-nu,107962377,"Ví da nữ mini thời trang đựng thẻ, tiền gấp đôi sang chảnh",99000,99000,0,0
TIKI,tui-vi-nu,262078803,"Túi xách nữ công sở màu đỏ và đen",220000,220000,0,0
TIKI,tui-vi-nu,6201827,"Ví cầm tay clucth nữ CN026",390000,390000,0,0
TIKI,tui-vi-nu,6639487,"Túi Mây Tre Tròn Màu Nâu",230000,230000,0,0
TIKI,tui-vi-nu,191755617,"Túi Cói, Túi Tote Cỏ Bàng Vẽ Hoa Tú Cầu Cao Cấp, Chuẩn Đẹp-Giỏ Xách Cỏ Bàng TXCBVHTCLTK03",329000,329000,0,0
TIKI,tui-vi-nu,252091008,"Túi Đeo Vai Nữ Dây Xích, Túi Xách Nữ Kẹp Nách Phong Cách Cá Tính, Túi Kẹp Nách Nữ Sang Chảnh Đi Chơi, Đi Tiệc - OTV239 - Ope Store",280000,280000,0,0
TIKI,tui-vi-nu,54562860,"Túi xách nữ đeo vai dễ thương thời trang  Hàn Quốc VTX016",50000,50000,0,0
TIKI,tui-vi-nu,194025657,"Túi đeo nữ da cá sấu ",2300000,3500000,1200000,34
TIKI,tui-vi-nu,148850135,"Túi đeo chéo, đeo hông nam Arctic Hunter K00152 chất liệu Oxford chống thấm nước, thiết kế nhiều ngăn tiện dụng",489000,850000,361000,42
TIKI,tui-vi-nu,92155250,"Túi Xách Nữ Kẹp Nách Form Lớn Vải Lông Phong Cách Hàn Quốc - Mã TUI10",215000,215000,0,0
TIKI,tui-vi-nu,157402656,"Classy Bao lì xì Tết 10C/ SET 2024, chất liệu dày dặn, mẫu mã đa dạng Q1476",10000,10000,0,0
TIKI,tui-vi-nu,154858347,"Túi vải bố thô - không dây rút",30000,30000,0,0
TIKI,tui-vi-nu,140132030,"Ví - bóp mini tiện ích đựng thẻ ngân hàng, card visit, thẻ ATM siêu dễ thương nhỏ gọn TN10",9000,9000,0,0
TIKI,tui-vi-nu,140208585,"Túi Đeo Chéo Tigernu T-S8135 Làm Bằng Tpu Nhỏ Không Thấm Nước",405000,405000,0,0
TIKI,tui-vi-nu,68154602,"Túi xách nữ thời trang cao cấp ELLY- EL133",1199000,1199000,0,0
TIKI,tui-vi-nu,4108275,"Túi Đeo Chéo Ulzzang Trong Suốt Kèm Ví Nhỏ Parisa",57420,82940,25520,31
TIKI,tui-vi-nu,11730891,"Túi đeo chéo hot trend 2019 cô gái rừng xanh",98000,98000,0,0
TIKI,tui-vi-nu,148715447,"Túi đeo chéo 3 chiều Mark Ryden – AUTUNNO",864000,864000,0,0
TIKI,tui-vi-nu,201978497,"túi xách thời trang - XANH",590000,590000,0,0
TIKI,tui-vi-nu,173265564,"Túi Nữ Kẻ Sọc túi xách tay Thời Trang Phong Cách Cá Tính 205970",43000,57900,14900,26
TIKI,tui-vi-nu,207008611,"Túi Đeo Vai Nữ Túi Xách Tay Phong Cách Châu Âu Trẻ Trung Hiện Đại",1100000,1100000,0,0
TIKI,tui-vi-nu,180303958,"Túi Cói, Túi Tote Cỏ Bàng Xinh Xắn, Giỏ Xách Thời Trang",259000,259000,0,0
TIKI,tui-vi-nu,188902688,"Túi vải Buzzi tote - May’s Tote Bag",240000,240000,0,0
TIKI,tui-vi-nu,10013701,"Túi đeo chéo TROY YM in logo Barcelona",199000,199000,0,0
TIKI,tui-vi-nu,173276199,"Túi xách nữ thời trang cao cấp 208010 (đỏ)",109000,135900,26900,20
TIKI,tui-vi-nu,206109220,"(Có video HD) Túi handmade tự làm DIY Sanrio My Melody Kuromi đáng yêu dễ thương quà tặng cho người yêu bạn gái",159000,159000,0,0
TIKI,tui-vi-nu,172977615,"Túi vải bố, Túi vải Canvas trơn màu kem không khóa kéo",19000,19000,0,0
TIKI,tui-vi-nu,148715226,"Thương hiệu - Túi đeo chéo Mark Ryden cao cấp ",1008000,1008000,0,0
TIKI,tui-vi-nu,142996532,"TÚI XÁCH NỮ CAO CẤP DA THẬT ELLY – ET137",3799000,3799000,0,0
TIKI,tui-vi-nu,96446040,"Túi xách nữ túi đeo chéo ô trám nắp xoay da PU cao cấp thời trang Hàn Quốc TX21",216000,216000,0,0
TIKI,tui-vi-nu,113256150,"TÚI VẢI MINI PHONG CÁCH HÀN XẺNG",65000,65000,0,0
TIKI,tui-vi-nu,19474073,"Ví cầm tay nam nữ",104000,104000,0,0
TIKI,tui-vi-nu,210414231,"Túi xách da công sở nữ thời trang đẹp nhiều ngăn cao cấp LH108",1375000,1375000,0,0
TIKI,tui-vi-nu,270808159,"Ví nữ dài thiết kế đơn giản - phong cách BSB1174",2500000,2500000,0,0
TIKI,tui-vi-nu,42618054,"Túi đeo điện thoại đeo chéo thời trang dọc nắp hình 2 nhóc TY6 Shalla",53000,74415,21415,29
TIKI,tui-vi-nu,121330456,"combo 5 bộ khuy hít nam châm cho balo túi xách cao cấp",10000,10000,0,0
TIKI,tui-vi-nu,183243433,"Túi đựng điện thoại vải sợi tự nhiên cao cấp Premium Linen - Chuyện của Nhà",250000,250000,0,0
TIKI,tui-vi-nu,56438186,"Túi Vải Tote Cao Cấp, Dày Dặn Chất Liệu Canvas Hình Catcus, Basic Dễ Phối Đồ",50000,50000,0,0
TIKI,tui-vi-nu,103461024,"Túi đeo chéo The City",99000,99000,0,0
TIKI,tui-vi-nu,120575345,"Túi tote bag vải canvas túi a4 đeo chéo đeo vai dùng đi học đi chơi TX94",84000,84000,0,0
TIKI,tui-vi-nu,121329455,"Sét 5 Cục hít nam châm làm túi xách, phụ kiện, đồ dùng",5000,5000,0,0
TIKI,tui-vi-nu,54616537,"Túi xách nữ đeo vai dễ thương thời trang Hàn Quốc VTX0011",30000,30000,0,0
TIKI,tui-vi-nu,176147957,"Túi Xách Nữ Gence Da Bò Cao Cấp TX03",1980000,1980000,0,0
TIKI,tui-vi-nu,130439357,"HJ6423-24-25-26 - Túi đeo da đà điểu Huy Hoàng da bụng màu đen, nâu đất, vàng bò, nâu đỏ",3499000,3499000,0,0
TIKI,tui-vi-nu,95051462,"Túi xách đi làm Bộ Combo 4 túi đồng màu da pu gồm 7 màu dễ lựa chọn phối đồ nữ hợp phong thủy làm việc",205000,205000,0,0
TIKI,tui-vi-nu,120524741,"HT3725-26-27-28 - Bóp nữ da cá sấu Huy Hoàng nhiều ngăn đầu cá sấu màu đen, nâu đất, vàng bò, nâu đỏ",2999000,2999000,0,0
TIKI,tui-vi-nu,194025855,"Ví nữ mini cầm tay ",900000,1800000,900000,50
TIKI,tui-vi-nu,68345768,"Túi Đeo Chéo IBag Thời Trang Cao Cấp SAKOS FOCUS",749000,749000,0,0
TIKI,tui-vi-nu,136939979,"TÚI ĐEO CHÉO THỔ CẨM LOẠI ĐEO VUÔNG TUNG",40000,40000,0,0
TIKI,tui-vi-nu,95394468,"Túi canvas phối da phong cách Hàn Quốc 208089",54000,75000,21000,28
TIKI,tui-vi-nu,161561239,"Túi đeo chéo da thật cao cấp kiểu Hàn Quốc",268000,341000,73000,21
TIKI,tui-vi-nu,200016858,"Ví Nữ Vuông Thổ Cẩm Thêu Băc Hà Nhỏ Nhắn Đáng Yêu Đựng TIền Và Phụ Kiện Nữ Trang",10000,10000,0,0
TIKI,tui-vi-nu,136940216,"TÚI ĐEO CHÉO THỔ CẨM",60000,60000,0,0
TIKI,tui-vi-nu,128291761,"Túi đeo chéo vịt vàng",127000,127000,0,0
TIKI,tui-vi-nu,10278537,"Ví Cầm Tay Nữ Thời Trang Flamingo",131000,131000,0,0
TIKI,tui-vi-nu,181784438,"Túi Cói, Túi Xách Cỏ Bàng Vẽ Hoa Cúc Chuẩn Đẹp",329000,329000,0,0
TIKI,tui-vi-nu,155608823,"Ví nữ HANHSON da đà điểu màu trắng",1050000,1050000,0,0
TIKI,tui-vi-nu,196573873,"Túi xách Peekoo xanh lá hottrend lắm nè",129000,129000,0,0
TIKI,tui-vi-nu,21019965,"Túi đeo chéo, túi đeo vai nữ vải Canvas TV07",59000,59000,0,0
TIKI,tui-vi-nu,107181944,"Túi Xách Hàng Xưởng KiểuTrơn Khóa Gập Dây Kim Loại Mang Đi Tiệc Dạo Phố Đi Chơi Chất Lượng Cao Giá Tốt",128000,128000,0,0
TIKI,tui-vi-nu,48696258,"Túi Đeo Chéo Nữ Thời Trang 2 Ngăn Dáng Hộp hình Chữ Nhật D11811",75000,75000,0,0
TIKI,tui-vi-nu,114697216,"Túi đeo chéo nữ cao cấp, đựng điện thoại tiện dụng, túi đeo chéo nữ mini 2 ngăn nhỏ gọn đẹp, thời trang, cá tính giá rẻ",159000,159000,0,0
TIKI,tui-vi-nu,137164690,"Khoen chữ nhật khoen túi phụ kiện túi quần áo (10 chiếc)",25000,25000,0,0
TIKI,tui-vi-nu,46748324,"Túi xách da cao cấp TD8667-001",599000,599000,0,0
TIKI,tui-vi-nu,157253939,"Túi Đeo Chéo Nam, Nữ SAIGON SWAGGER SGS Flexible Bag",390000,390000,0,0
TIKI,tui-vi-nu,173552151,"Thẻ Bọc Căn Cước Công Dân-Thẻ ATM-Bao Bì Bọc Thẻ Căn Cước,Thẻ ATM.",1000,1000,0,0
TIKI,tui-vi-nu,71677784,"Ví đựng thẻ",290000,290000,0,0
TIKI,tui-vi-nu,86561442," Túi đeo chéo   Túi vải Canvas Phong Cách Hàn Quốc TV17",27000,27000,0,0
TIKI,tui-vi-nu,194025900,"Túi nữ da cá sấu đeo chéo có khuy cài!",2900000,5000000,2100000,42
TIKI,tui-vi-nu,147484984,"Túi TOTE vải in hoạt hình dễ thương để đi học dung tích lớn tiện lợi",87000,87000,0,0
TIKI,tui-vi-nu,165650794,"Túi đeo chéo nữ mini dây xích to phong cách Hàn Quốc",129000,129000,0,0
TIKI,tui-vi-nu,157402296,"Phụ kiện treo trang trí cây thông giáng sinh nhiều hình xinh xắn bằng vải không dệt Q1772",18000,18000,0,0
TIKI,tui-vi-nu,160314058,"Túi Xách Nữ Đeo Chéo Đeo Vai MICOCAH Dáng Công Sở Thời Trang Phong Cách Hàn Quốc Da Cao Cấp Cực Đẹp MC107 - Micocah Mall",439000,439000,0,0
TIKI,tui-vi-nu,194026122,"Túi nữ đeo chéo da bụng cá sấu bạch tạng hiếm có!",3300000,5500000,2200000,40
TIKI,tui-vi-nu,188742578,"Túi Cói, Túi Xách Lục Bình Quai Mây Cao Cấp, Chuẩn Đẹp-Giỏ Lục Bình TXLBQMLTK02",329000,329000,0,0
TIKI,tui-vi-nu,14704300,"Túi tote túi vải phong cách hàn quốc",120000,120000,0,0
TIKI,tui-vi-nu,74603843,"Túi đeo chéo Hoạt Hình Vui Nhộn Mstaly ngẫu nhiên Tặng móc khóa cá heo",50129,52767,2638,5
TIKI,tui-vi-nu,46647025,"Túi clutch nữ cao cấp da thật ELLY – EC38 màu đen ",2499000,2499000,0,0
TIKI,tui-vi-nu,62997685,"Ví Kéo Dài Mặt Mèo Nhiều Ngăn",30000,30000,0,0
TIKI,tui-vi-nu,2009135,"Ví Nữ Huy Hoàng HT3158 (9.5 x 19 cm) - Xanh Dương",599000,599000,0,0
TIKI,tui-vi-nu,184602751,"Ví card Sophia da bò thật Pink Ohara",370000,370000,0,0
TIKI,tui-vi-nu,51065034,"Túi Nữ Đeo Chéo Mini, Hình thú vui nhộn, Vải Canvas siêu bền ( Mẫu Vịt)",120000,120000,0,0
TIKI,tui-vi-nu,196233239,"Túi đeo chéo nữ phong cách dễ thương – DCNU1013",135000,270000,135000,50
TIKI,tui-vi-nu,176150164,"Túi Xách Nữ Gence Da Bò Cao Cấp TX08",1890000,1890000,0,0
TIKI,tui-vi-nu,183343470,"Túi Xách Nam BRIC’S Life Pelle Briefcase - Nâu BPL15133.098 cặp xách nam, túi đựng laptop, da thật, sang trọng",19800000,19800000,0,0
TIKI,tui-vi-nu,79449697,"[ Hàng cao cấp]-Túi cói đi biển dạo phố phong cách vintage, túi hình thang",205000,400000,195000,49
TIKI,tui-vi-nu,157402119,"[Thiệp xinh] chúc mừng 20-11, Sinh Nhật, Lễ lạt, Cảm Ơn , Tình Yêu in hình sắc nét",2000,2000,0,0
TIKI,tui-vi-nu,192029000,"Túi Kẹp Nách Nữ Chính Hãng MICOCAH Túi Đeo Chéo Nữ Đeo Vai Dáng Công Sở Thời Trang Chất Da Cao Cấp Cực Đẹp MC46 - Micocah",389000,389000,0,0
TIKI,tui-vi-nu,43694796,"Túi Nữ Đeo Chéo Bì Thư Đồ Da Thành Long TLG 208063",32000,46600,14600,31
TIKI,tui-vi-nu,77748084,"Túi đeo chéo mini đựng điện thoại đeo chéo thời trang dọc nắp hình ngôi sao MM247 Tặng móc khóa cá heo",32000,44649,12649,28
TIKI,tui-vi-nu,43694942,"Túi Xách Nữ, Túi Xách Thời Trang 208082",64000,101400,37400,37
TIKI,tui-vi-nu,88050928,"Túi xách nữ thời trang cao cấp HuongTra99-C31018-180",899000,899000,0,0
TIKI,tui-vi-nu,185774953,"Túi Xách Thời Trang Nữ",189000,189000,0,0
TIKI,tui-vi-nu,177889621,"Túi Cói Đi Biển, Túi Xách Lục Bình Oval Thời Trang Chuẩn Đẹp",289000,289000,0,0
TIKI,tui-vi-nu,194025812,"Túi nữ cá sấu ",2300000,3500000,1200000,34
TIKI,tui-vi-nu,55476748,"Túi Đeo Vai Nữ Kẹp Nách Sang Trọng BO820",55000,55000,0,0
TIKI,tui-vi-nu,191958650,"túi đeo chéo nữ hàng hiệu Pierre Loues có quai cầm thời trang Hàn Quốc - PL51439",339000,339000,0,0
TIKI,tui-vi-nu,111548702,"(NEW) Túi Vải/ Tote Sinh Viên Ullzang Chất Vải Dày Dặn",52900,52900,0,0
TIKI,tui-vi-nu,129247161,"túi nữ Tote Hàn Quốc vải Canvas dày ngăn chứa lớn kèm bé gấu dễ thương để được sách đồ",135000,135000,0,0
TIKI,tui-vi-nu,21176453,"Túi đeo chéo nam nữ Detek B3 - Hàng nhập khẩu",95000,95000,0,0
TIKI,tui-vi-nu,72641688,"Túi cói đi biển phối da sành điệu, hàng cao cấp",300000,300000,0,0
TIKI,tui-vi-nu,173652293,"Ví Cầm Tay Nữ Da Bò Thật BIGGBEN Cao Cấp VCT25",1600000,1600000,0,0
TIKI,tui-vi-nu,91421869,"Ví con vật",127000,127000,0,0
TIKI,tui-vi-nu,54983118,"Túi nữ cao cấp da thật ELLY- ET116 đen",2499000,2499000,0,0
TIKI,tui-vi-nu,185926908,"Túi cói đeo vai túi tote cói phong cách vintage [ Hàng cao cấp",280000,280000,0,0
TIKI,tui-vi-nu,136940151,"TÚI THỔ CẨM ĐEO CHÉO LOẠI BÓP ĐẦM",40000,40000,0,0
TIKI,tui-vi-nu,89248485,"Túi xách nữ đeo chéo thời trang cao cấp đi chơi dạo phố TK0078",79000,79000,0,0
TIKI,tui-vi-nu,152548181,"Túi Tote Túi Vải Nữ đeo vai Nhung Gấu Trắng phong cách Hàn Quốc hàng hai lớp có ngăn phụ và nút bấm",69000,69000,0,0
TIKI,tui-vi-nu,165623178,"Túi đeo chéo khoá chữ B da vân rắn thời trang-túi đeo chéo nữ, túi xách nữ, túi đeo chéo thời trang-da pu vân rắn cực đẹp,móc khoá chữ B cách điệu, có quai xách - đen",99000,99000,0,0
TIKI,tui-vi-nu,55242998,"Túi đeo chéo da nữ dạo phố dễ thương MADT111",300000,300000,0,0
TIKI,tui-vi-nu,173264985,"Túi Nữ Kẻ Sọc Thời Trang Phong Cách Cá Tính - Túi Xách Nữ, Túi Xách Thời Trang  -205970-1 Ư -VICTORIA",44000,57900,13900,24
TIKI,tui-vi-nu,147468642,"Túi đeo chéo Bò Sữa phong cách Hàn Quốc Không bao gồm gấu bông",79000,79000,0,0
TIKI,tui-vi-nu,50385904,"Túi cói thời trang màu đỏ NORD111",2625015,2625015,0,0
TIKI,tui-vi-nu,116355881,"Túi Xách Nữ Thời Trang Đẹp, Sang Chảnh MS-11",289000,289000,0,0
TIKI,tui-vi-nu,85562188,"Túi đeo chéo nữ thời trang cao cấp  Hàn Quốc siêu đẹp khóa cài chéo VTX024",170000,170000,0,0
TIKI,tui-vi-nu,194026494,"Túi đeo chéo nữ da cá sấu màu hường dễ thương!",3090000,5200000,2110000,41
TIKI,tui-vi-nu,191449857,"TÚI XÁCH NỮ , TÚI XÁCH VẢI DÙ CHỐNG THẤM NƯỚC TUYỆT ĐỐI",89000,89000,0,0
TIKI,tui-vi-nu,31499623,"Ví Da Đựng Namecard, ATM, CMT 10 ngăn",109000,109000,0,0
TIKI,tui-vi-nu,90985953," Ví da nam mini nhỏ gọn dành cho cả nam & nữ",90000,90000,0,0
TIKI,tui-vi-nu,115157196,"Túi tote kèm ví keychain xuất Âu",450000,450000,0,0
TIKI,tui-vi-nu,186753051,"Túi đeo chéo NASI T1029 phong cách hàn quốc túi xách nữ đeo vai thời trang dạo phố dễ thương vải đẹp",45000,45000,0,0
TIKI,tui-vi-nu,171214872,"Túi ví mèo thần tài (màu xanh dương số 9)",45000,45000,0,0
TIKI,tui-vi-nu,188375067,"Ví nhỏ cầm tay nữ da thật 9x15 VN1700",171000,171000,0,0
TIKI,tui-vi-nu,53979969,"Ví nữ cầm tay cao cấp 2 ngăn kéo sang trọng, thiết kế nhiều ngăn tiện dụng TK0047 - XANH",76000,100000,24000,24
TIKI,tui-vi-nu,73267362,"Túi Đeo chéo Gấu giấu trong đáng yêu nhiều màu SS4  Tặng móc khóa cá heo",59000,83480,24480,29
TIKI,tui-vi-nu,75954702,"Túi đeo chéo nữ dạo phô sunisex thời trang Hàn quốc chống thấm nước BEE GEE T2",75000,150000,75000,50
TIKI,tui-vi-nu,173276476,"Ví bóp nữ dáng dài da thật 40498",457000,507000,50000,10
TIKI,tui-vi-nu,89867311,"Túi đeo chéo mini con bò sữa có ngăn trong suốt không kèm móc khóa",82000,82000,0,0
TIKI,tui-vi-nu,93291264,"Marhen.J - Túi xách tay nữ chữ nhật Rico Comfort MJ20DRCOCF-BE",3590000,3590000,0,0
TIKI,tui-vi-nu,173253930,"Ví Nữ Cầm Tay Da Cao Cấp - Ví Cầm Tay - Ví Đựng Tiền 204446",38000,69600,31600,45
TIKI,tui-vi-nu,173265012,"Túi ví phong bì da cừu Đồ Da Thành Long TLG 208236 + móc khóa la bàn cao cấp - không thể rẻ hơn",44000,57900,13900,24
TIKI,tui-vi-nu,67621651,"Túi xách nữ thời trang cao cấp",340000,340000,0,0
TIKI,tui-vi-nu,109092368,"Túi xách nữ đeo vai cao cấp đẹp giá rẻ thời trang",69000,69000,0,0
TIKI,tui-vi-nu,105672243,"Giỏ xách, túi xách cầm tay phụ kiện du lịch chụp ảnh, thời trang cá tính",205000,300000,95000,32
TIKI,tui-vi-nu,188903502,"Túi vải Creamy Bag - May’s Tote Bag",260000,260000,0,0
TIKI,tui-vi-nu,270501664,"Ví mini đựng thẻ, ví đựng tiền xu Sora khóa kéo L - Pink Ohara Leather",470000,470000,0,0
TIKI,tui-vi-nu,145787059,"TÚI CÓI ĐI BIỂN, TÚI CÓI MERCI TÚI HOT TREND ĐI CHƠI, ĐI BIỂN, ĐI LÀM.........",36490,36490,0,0
TIKI,tui-vi-nu,136355257,"Ví mini mèo xinh vải canvas đẹp bền",35000,35000,0,0
TIKI,tui-vi-nu,110943984,"Túi cói Merci phong cách Vintage, Túi cói Merci đi du lịch siêu sang hàng loại 1- MIN24",43998,43998,0,0
TIKI,tui-vi-nu,149449271,"Túi xách nữ - túi đeo chéo cầm tay da PU da mềm , kiểu dáng Hàn Quốc nhỏ gọn giá rẻ",195000,195000,0,0
TIKI,tui-vi-nu,144709062,"JF F400 Túi pop it đeo chéo Hot hit dành cho bé phiên bản mới nhất hình kỳ lân - thỏ xinh - noel - dâu - dứa",68000,68000,0,0
TIKI,tui-vi-nu,174468911,"Ví Nữ Ngắn Mini Cầm Tay Chính Hãng TAILIAN Gấp 2 Nhỏ Gọn Phong Cách Hàn Quốc Da Cao Cấp Giá Rẻ TL09",99000,99000,0,0
TIKI,tui-vi-nu,77446127,"Túi Xách Nữ - Túi Cầm Tay Nữ - Clutch Dự Tiệc (TX-129)",359000,359000,0,0
TIKI,tui-vi-nu,40913478,"Ví nữ đựng card da bò cao cấp Gianni Conti VP0154ARA",550000,550000,0,0
TIKI,tui-vi-nu,120035293,"Cặp táp nam da đà điểu Huy Hoàng màu vàng bò HP6449",10999000,10999000,0,0
TIKI,tui-vi-nu,84448218,"Túi Tote basic Túi vải bố vải canvas xinh đẹp sử dụng để đồ cá nhân, quảng cáo,in LOGO quà tặng",25000,25000,0,0
TIKI,tui-vi-nu,107526256,"Túi vải tặng",99000,99000,0,0
TIKI,tui-vi-nu,98868697,"10 túi ví mini kiêm móc khoá da đẹp đủ màu",50000,50000,0,0
TIKI,tui-vi-nu,209414522,"Ví mini nữ nhỏ da mềm cầm tay đựng thẻ tiền tiện dụng xinh xắn",72000,72000,0,0
TIKI,tui-vi-nu,248990307,"Dây kéo YKK Thái 1 chiều răng 3",52000,52000,0,0
TIKI,tui-vi-nu,136940086,"TÚI VẢI THỔ CẨM ( CON CÚ ĐỎ )",40000,40000,0,0
TIKI,tui-vi-nu,75299455,"Túi da nhỏ chần chéo",559000,559000,0,0
TIKI,tui-vi-nu,143321975,"HJ6463-64-65-66 - Túi xách nữ da đà điểu cỡ nhỏ màu đen, nâu đất, vàng bò, nâu đỏ",4899000,4899000,0,0
TIKI,tui-vi-nu,91196032,"TÚI CHÉO ULZZANG GẤU HOT",145000,145000,0,0
TIKI,tui-vi-nu,161533284,"Túi xách đeo chéo mini nữ khoá bấm mạ vàng sang trọng GOMIA TDC168",99000,99000,0,0
TIKI,tui-vi-nu,91421012,"Ví ngắn corgi",127000,127000,0,0
TIKI,tui-vi-nu,152015148,"Túi Vải Túi Đeo Chéo Dây Thổ Cẩm",75000,75000,0,0
TIKI,tui-vi-nu,172191595,"XẢ HÀNG GIÁ SỐC - Túi đeo chéo phong cách Hàn Quốc Đồ Da Thành Long TLG 208093-1(nâu nhạt)",40000,40000,0,0
TIKI,tui-vi-nu,210414112,"Túi xách nữ đẹp giá rẻ công sở thời trang cao cấp LH47",1750000,1750000,0,0
TIKI,tui-vi-nu,109092312,"Túi xách nữ da mềm  Túi đeo chéo mini hàng quảng châu siêu hot QC007",129000,129000,0,0
TIKI,tui-vi-nu,272362754,"ảnh video thật️ Túi xách nữ mèo mun đáng yêu BC515",499000,499000,0,0
TIKI,tui-vi-nu,183041977,"Ví cầm tay da Nam nữ Thời Trang",89000,89000,0,0
TIKI,tui-vi-nu,72785498,"Túi kẹp nách nữ dây xích, túi đeo chéo nữ da vân cá sấu TX41 trẻ trung hiện đại",55000,55000,0,0
TIKI,tui-vi-nu,160907349,"Túi Xách Nữ Thời Trang Công Sở Có Dây Đeo Chéo MQ129",75000,75000,0,0
TIKI,tui-vi-nu,158851978,"Túi đeo chéo, Đeo vai nữ thời trang Boss cực xinh",69000,69000,0,0
TIKI,tui-vi-nu,108075826,"Túi đeo chéo nam , đựng điện thoại ví...",300000,300000,0,0
TIKI,tui-vi-nu,178592711,"Túi Cói, Túi Xách Lá Buông Đan Thủ Công Mỹ Nghệ Cao Cấp, Chuẩn Đẹp",289000,289000,0,0
TIKI,tui-vi-nu,196009391,"Túi Cói, Túi Xách Cỏ Bàng Vẽ Mỹ Nghệ Cao Cấp, Chuẩn Đẹp-Túi Tote TXCBVXDLTK04",329000,329000,0,0
TIKI,tui-vi-nu,196409539,"Túi Xách Nữ Kẹp Nách Dây Xích Dây Da Đeo Chéo FLORA BAG Thương Hiệu GIPSY",695000,695000,0,0
TIKI,tui-vi-nu,149432555,"Túi xách, túi đeo chéo nữ thời trang T20",140000,140000,0,0
TIKI,tui-vi-nu,193605847,"Túi vải quai đeo cá tính PVN2622",286000,286000,0,0
TIKI,tui-vi-nu,48101012,"TÚI TOTE, TÚI ĐEO CHÉO, BALO THỜI TRANG HỌA TIẾT CHỮ  PHỐI MÁU ( SẢN PHẨM KHÔNG KÈM MÓC KHÓA) YNTT02",128000,128000,0,0
TIKI,tui-vi-nu,53558979,"Túi đeo chéo phong cách tua rua",55000,55000,0,0
TIKI,tui-vi-nu,23736606,"Túi bao tử đeo chéo nữ bằng da kim tuyến 2 ngăn (tặng kèm 1 sản phẩm ngẫu nhiên)",93000,93000,0,0
TIKI,tui-vi-nu,108254508,"Túi đeo chéo da mềm 3 ngăn siêu tiện dụng mã T972",130000,130000,0,0
TIKI,tui-vi-nu,142898094,"HJ3440-41-42-43 - Bóp da đà điểu 2 khóa đen, nâu đỏ, vàng bò, nâu đất",2239000,2239000,0,0
TIKI,tui-vi-nu,31685627,"TÚI TOTE ĐEO CHÉO 3 CHÚ VỊT CON DỄ THƯƠNG BTTT23",65000,65000,0,0
TIKI,tui-vi-nu,110102553,"Túi Xách Nữ Thời Trang - Túi Tote - Túi Đeo Chéo - Túi Đeo Vai -  Kiểu Dáng Độc Đáo - Cá Tính - Bền Đẹp - MS32",120000,120000,0,0
TIKI,tui-vi-nu,44573051,"Túi xách nữ da đà điểu Huy Hoàng đeo chéo màu xanh lá HT6435",2999000,2999000,0,0
TIKI,tui-vi-nu,157478987,"túi ví đeo chéo nữ Forever Young mẫu đứng hình gấu tách rời được, vừa điện thoại smartphone phù hợp đi chơi - FY85015",158000,249000,91000,37
TIKI,tui-vi-nu,76391329,"Ví đựng thẻ HANHSON SP000648 da bò đen tay khóa vàng giọt nước",750000,750000,0,0
TIKI,tui-vi-nu,92640268,"TÚI NỮ RAM - DA BÒ ĐEN BÓNG (DA BÒ THẬT) .",414000,414000,0,0
TIKI,tui-vi-nu,44573106,"Túi xách nữ da đà điểu Huy Hoàng đeo chéo màu nâu đất HT6433",2999000,2999000,0,0
TIKI,tui-vi-nu,6410093,"Ví Nữ Dài Cầm Tay",950000,950000,0,0
TIKI,tui-vi-nu,84776189,"Túi đeo vai vải tone trẻ trung mẫu 05, thời trang phong cách trẻ",50000,50000,0,0
TIKI,tui-vi-nu,34232509,"Túi xách nữ CNT TX26 cao cấp",285000,285000,0,0
TIKI,tui-vi-nu,168667882,"TÚI XÁCH ĐEO CHÉO NỮ VÂN CÁ SẤU SANG CHẢNH",319000,319000,0,0
TIKI,tui-vi-nu,120033543,"Ví nữ da đà điểu Huy Hoàng 1 khóa vip màu nâu đất HP3432",1399000,1399000,0,0
TIKI,tui-vi-nu,137830279,"Set 10 túi đựng thẻ căn cước",14999,14999,0,0
TIKI,tui-vi-nu,12400068,"Cặp đeo chéo TROY in logo đội bóng Chelsea",250000,250000,0,0
TIKI,tui-vi-nu,52263088,"Ví nữ dạng mỏng Slim Wallet gập bấm cúc - HGcork Corkor  CK274 - Nhiều màu - Vật liệu 100% da cork thực vật thuần chay từ vỏ cây sồi Bồ Đào Nha, Siêu bền, Chống cháy, Chống mốc, Chống thấm nước, Thân thiện với môi trường – Hàng chính hãng, Sản xuất Handma",1139050,1199000,59950,5
TIKI,tui-vi-nu,172191840,"Túi Nữ Kẻ Sọc Thời Trang Phong Cách Cá Tính Đồ Da Thành Long TLG 205970 2(đen) tặng móc khóa da thật cao cấp K 550",52000,125000,73000,58
TIKI,tui-vi-nu,43694474,"Túi xách thời trang cá tính Đồ Da Thành Long TLG Z 208102",88000,112100,24100,21
TIKI,tui-vi-nu,153415566,"[GRMN59] Túi tote Vải canvas mềm Đẹp Cực Hot đựng vừa a4 [SIÊU XINH] Túi vải xinh nhiều hình",62000,62000,0,0
TIKI,tui-vi-nu,4318257,"Ví cầm tay nữ họa tiết hình chiếc lá trẻ trung",61999,61999,0,0
TIKI,tui-vi-nu,132079139,"Túi Đeo Chéo Caro T18 Mẫu Mới Khuyên Tròn- Hồng Phấn",145000,198000,53000,27
TIKI,tui-vi-nu,72453392,"[HOT TREND 2020] BALO TRAI TIM THỦY TIÊN NỮ SỌC V NỔI THỜI TRANG, CHẤT LIỆU DA MỀM MẠI PHOM CỨNG",86000,86000,0,0
TIKI,tui-vi-nu,125100431,"Bóp nữ da trơn size lớn ( xanh dương)",129000,129000,0,0
TIKI,tui-vi-nu,113498881,"Túi Xách Đeo Chéo Da Trơn Cá Tính MS06 - Màu",103550,109000,5450,5
TIKI,tui-vi-nu,6077843,"Túi Xách Thời Trang - Xanh",1238000,1350000,112000,8
TIKI,tui-vi-nu,171171697,"Túi cói Merci phong cách Vintage",46550,49000,2450,5
TIKI,tui-vi-nu,34362685,"Túi Vải Đeo Chéo Nữ AHOSM Hình Thú Mỏ Vịt Ngộ Nghĩnh",29000,29000,0,0
TIKI,tui-vi-nu,252721927,"Túi dự tiệc Clutch lấp lánh sang trọng tôn vẻ đẹp quý phái nổi bật VDT05",399000,399000,0,0
TIKI,tui-vi-nu,136939955,"túi đeo chéo thổ cẩm 4 ngăn",35000,35000,0,0
TIKI,tui-vi-nu,247666687,"Túi Phao Chần Bông 2 Lớp Có Nắp - Hàng Cao Cấp, Chất Lượng, Chống Thấm",320000,320000,0,0
TIKI,tui-vi-nu,102499907," ~Túi Tote Đen Xương Rồng",129000,129000,0,0
TIKI,tui-vi-nu,149459257,"Túi Đeo Vai Hình Trụ Phối Dây Xích Thiết Kế Mới 2021 Dành Cho Nữ",132000,132000,0,0
TIKI,tui-vi-nu,188902890,"Huy hiệu cài túi - May’s Tote Bag",30000,30000,0,0
TIKI,tui-vi-nu,252006020,"Túi trống tròn màu đen da đẹp",195000,195000,0,0
TIKI,tui-vi-nu,188902715,"Túi vải 2in1 2 Túi (S) - May’s Tote Bag",150000,150000,0,0
TIKI,tui-vi-nu,147474165,"Túi TOTE vải mèo phong cách giản dị dễ thương phong cách tiện sử dụng",80850,80850,0,0
TIKI,tui-vi-nu,36453226,"TÚI TOTE- ĐEO CHÉO 2IN1 GẤU B184 CÓ TAI SIÊU DỄ THƯƠNG",49000,49000,0,0
TIKI,tui-vi-nu,104636755,"Cốp cầu đá đi tiệc siêu xinh, nổi bật hàng cao cấp giá siêu mềm",299000,299000,0,0
TIKI,tui-vi-nu,207002628,"Túi tote tranh Đông Hồ Việt Nam, Hứng dừa, mã VN7. Quà tặng cao cấp cho gia đình, nam nữ cặp đôi, hội nhóm, người nước ngoài, doanh nghiệp",109000,109000,0,0
TIKI,tui-vi-nu,185882538,"Túi Xách Nữ Túi Xách Hàn Quốc ZL105 Da Thật Cao Cấp FullBox Size 28.5cm (BH 12 tháng) Thích Hợp Làm Quà Tặng, Sinh Nhật",2900000,2900000,0,0
TIKI,tui-vi-nu,174121474,"Túi xách đeo chéo nữ, túi kẹp nách, đeo vai nữ thời trang Hàn Quốc với thiết kế dây đeo đan chéo dễ thương TX052",129000,129000,0,0
TIKI,tui-vi-nu,252640931,"Túi Xách Nữ Công Sở Pha Da Cao Cấp Dáng Công Sở, Túi Đeo Vai Nữ Vải Canvas Thời Trang Sang Trọng Đi Làm, Đi Chơi - OTV236 - Ope Store",340000,340000,0,0
TIKI,tui-vi-nu,128292640,"Ví cầm tay hình con vật",102000,102000,0,0
TIKI,tui-vi-nu,10251402,"Túi đeo vai Sailor Moon GU Nhật Bản",350000,350000,0,0
TIKI,tui-vi-nu,12135715,"Túi đeo chéo ANELLO unisex vải polyester cỡ nhỏ AT-N0661 - Màu",1180000,1180000,0,0
TIKI,tui-vi-nu,43179400,"Túi xách nữ đeo vai thời trang",89000,89000,0,0
TIKI,tui-vi-nu,184997925,"Túi xách nữ thời trang cao cấp ELLY – EL141",1499000,1499000,0,0
TIKI,tui-vi-nu,57156779,"TÚI XÁCH GẤU TRÚC PANDA",85500,85500,0,0
TIKI,tui-vi-nu,196478866,"Ví Nữ Ngắn Gập Cầm Tay Da Bò Thật Thương Hiệu GIPSY",550000,550000,0,0
TIKI,tui-vi-nu,130328059,"HJ6246-47-48-49 - Túi xách nữ da cá sấu Huy Hoàng đeo chéo 2 gai màu đen, nâu đỏ, vàng bò, nâu đất",4899000,4899000,0,0
TIKI,tui-vi-nu,147871381,"Ví tiền vải fairy style sang trọng có quai đeo",649000,649000,0,0
TIKI,tui-vi-nu,75447858,"TÚI TOTE THỜI TRANG ĐEO VAI VÀ ĐEO CHÉO ĐI HỌC - VỊT DONAL XINH XẮN",107000,107000,0,0
TIKI,tui-vi-nu,121106509,"Ví tiền TFBOYS/ bóp tiền TFBOYS",55000,55000,0,0
TIKI,tui-vi-nu,120035580,"Túi hộp đeo chéo nữ Huy Hoàng da đà điểu màu nâu đất HP6458",4499000,4499000,0,0
TIKI,tui-vi-nu,164430267,"Túi nữ pha dạ kẻ, túi đeo chéo 2 màu xinh xắn",55000,55000,0,0
TIKI,tui-vi-nu,102115869,"Túi đeo chéo nữ công sở phong cách Hàn Quốc sang trọng và thanh lịch TN173",129000,129000,0,0
TIKI,tui-vi-nu,198365331," Ví nữ da bò màu đen HJ93106-12-16-20-26",499000,499000,0,0
TIKI,tui-vi-nu,103459101,"Túi đeo chéo cún vàng tặng kèm 1 móc khóa Gấu",110000,110000,0,0
TIKI,tui-vi-nu,40192403,"Túi xách công sở form lớn",299000,299000,0,0
TIKI,tui-vi-nu,176150006,"Túi Xách Nữ Gence Da Bò Cao Cấp TX05",1980000,1980000,0,0
TIKI,tui-vi-nu,71178537,"Túi đeo chéo nữ để diện thoại thời trang họa tiết dễ thương BEE GEE 096",75000,150000,75000,50
TIKI,tui-vi-nu,1995287,"Túi Đeo Chéo 2 Gai Nữ Da Cá Sấu Huy Hoàng HT6246 (14.5 x 24.5 cm) - Đen",3499000,3499000,0,0
TIKI,tui-vi-nu,120525319,"Bóp da đà điểu Huy Hoàng nhiều ngăn màu xanh lá HC3427",2749000,2749000,0,0
TIKI,tui-vi-nu,136095559,"Túi Xách Nam Cặp Da Công Sở GENCE GCE04 Da Bò Mềm Cao Cấp Màu Nâu Có Dây Đeo Vai",2500000,2500000,0,0
TIKI,tui-vi-nu,77446539," Ví Nữ Nam Unisex Bóp Nữ Nam Unisex Cao Cấp (VI-NU-034) - Bóp Cầm Tay - Ví Cầm Tay",99000,99000,0,0
TIKI,tui-vi-nu,260804853,"Dây kéo 1 chiều răng 3(không kèm đầu khóa)",37000,37000,0,0
TIKI,tui-vi-nu,198075906,"Túi xách nữ thời trang cao cấp ELLY – EL217",844350,1299000,454650,35
TIKI,tui-vi-nu,173028766,"Túi Nữ Kẻ Sọc Thời Trang Phong Cách Cá Tính 205970",44000,70000,26000,37
TIKI,tui-vi-nu,116852451,"Túi đeo chéo da thật cao cấp 208241",161000,494000,333000,67
TIKI,tui-vi-nu,143112703,"Túi Grand Mini Oxford HAVIAS_Túi vải đeo chéo Đen",280000,350000,70000,20
TIKI,tui-vi-nu,89949853,"Túi đeo chéo nam thời trang phong cách Hàn Quốc Z 208188   Khuyến mại túi xách",48000,61100,13100,21
TIKI,tui-vi-nu,188903518,"Túi vải Grocery - May’s Tote Bag",200000,200000,0,0
TIKI,tui-vi-nu,147486282,"Túi TOTE tai thỏ phong cách Hàn Quốc dung tích lớn tiện dụng",84500,84500,0,0
TIKI,tui-vi-nu,81645600,"TÚI TOTE VẢI TÚI TOTE TRẮNG NGÀ VINTAGE CHỮ ĐỎ DEMAIN",75000,75000,0,0
TIKI,tui-vi-nu,21243111,"Túi thời trang cực xinh phong cách Hàn Quốc HQC332",249000,249000,0,0
TIKI,tui-vi-nu,193765298,"Túi Cói, Túi Tote Vẽ Mỹ Nghệ Sang Trọng, Chuẩn Đẹp-Túi Xách Cỏ Bàng TXCBQHVCLLTK05",309000,309000,0,0
TIKI,tui-vi-nu,194025709,"Túi xách nữ Gù gai cá sấu cao cấp ",3500000,5500000,2000000,36
TIKI,tui-vi-nu,144044711,"Túi đeo chéo bông chó Corgi size 35cm",160000,160000,0,0
TIKI,tui-vi-nu,82865716,"TÚI NỮ DA PHONG CÁCH HÀN QUỐC ĐỂ ĐIỆN THOẠI – SIÊU XINH – NĂNG ĐỘNG VÀ TIỆN ÍCH",110000,110000,0,0
TIKI,tui-vi-nu,173856821,"Túi đeo chéo thời trang dây xích kèm túi con đi làm vải canvas",89000,89000,0,0
TIKI,tui-vi-nu,97018360,"Hình Thật-FREESHIP Túi Đeo Chéo Nữ Vải Chống Nước Hàng Xịn Quảng Châu Kẹp Nách Xách Vai Tote Unisex Mini Thời Trang",189000,189000,0,0
TIKI,tui-vi-nu,96670376,"Túi điện thoại đeo chéo thời trang nữ - túi handmade",175500,175500,0,0
TIKI,tui-vi-nu,2008981,"Ví Nữ Huy Hoàng HT3103 (9 x 18.5 cm) - Nâu",599000,599000,0,0
TIKI,tui-vi-nu,172191747,"Túi nữ thời trang Đồ Da Thành Long TLG 208153 3(xanh) tặng túi đựng bút tiện lợi",44690,44690,0,0
TIKI,tui-vi-nu,45875814,"Túi Xách Nữ Có Quai Đeo Chéo Sang Trọng - Nâu",1899000,1899000,0,0
TIKI,tui-vi-nu,176217546,"Túi Vải Họa Tiết Ca Rô Siêu Hot - Túi Vải Túi Tote Dành Cho Nữ Siêu Đẹp - Túi Vải Đi Chơi Cho Nữ",70000,70000,0,0
TIKI,tui-vi-nu,120524902,"HT3738-39-40-41 - Bóp nữ da cá sấu Huy Hoàng nhiều ngăn gai cầm tay màu đen, nâu đỏ, vàng bò, nâu đất",2499000,2499000,0,0
TIKI,tui-vi-nu,148715003,"New - Ví kẹp tiền thẻ atm cao cấp phong cách doanh nhân thành đạt 2019 ",285600,285600,0,0
TIKI,tui-vi-nu,108253653,"Túi Đeo Chéo Da Mềm Nhỏ Xinh Khóa Tròn Mẫu Mới",107000,107000,0,0
TIKI,tui-vi-nu,151233487,"Túi xách da",160000,160000,0,0
TIKI,tui-vi-nu,132079535,"Túi Đeo Vai V - Màu Đồng [T07]",119000,194400,75400,39
TIKI,tui-vi-nu,177123789,"Túi đeo chéo dạo phố BUCGET MINI Thời trang sành điệu nữ giới kích thước 19cm x 16cm x 9cm",185000,185000,0,0
TIKI,tui-vi-nu,117294382,"Túi đeo chéo hình xe hơi, ô tô cho cả mẹ và bé siêu xinh",89000,89000,0,0
TIKI,tui-vi-nu,120068199,"Bóp Ví nữ cầm tay da bò cao cấp màu đen sang trọng Kalanos KBNU910-Den, Ví dài nữ rẻ đẹp có khóa kéo",459000,459000,0,0
TIKI,tui-vi-nu,103458980,"Túi đeo chéo Kakao",110000,110000,0,0
TIKI,tui-vi-nu,10094193,"Ví Cầm Tay Hình Mèo - Nội Địa Nhật Bản",39000,39000,0,0
TIKI,tui-vi-nu,2009231,"Ví Nữ Huy Hoàng HT3259 (10.5 x 19 cm) - Xanh Lá",1999000,1999000,0,0
TIKI,tui-vi-nu,852565,"Ví Cầm Tay Đa Năng Da Bò Hity ACC001 (21 x 13 cm)",799000,799000,0,0
TIKI,tui-vi-nu,89937487,"Túi Đeo Chéo Phong Cách Hàn Quốc Z 208152   KHUYẾN MẠI TÚI XÁCH",34300,60000,25700,43
TIKI,tui-vi-nu,71178658,"Túi đeo chéo nam nữ unisex thời trang Hàn quốc để điện thoại chống thấm nước BEE GEE 099",49000,98000,49000,50
TIKI,tui-vi-nu,192725934,"Túi xách nữ phong cách phương tây 2022",1295000,1295000,0,0
TIKI,tui-vi-nu,35524804,"Ví Forever Young Phong Cách Hàn Quốc VD23",75000,75000,0,0
TIKI,tui-vi-nu,2009003,"Ví Nữ Huy Hoàng HT3114 (9.5 x 19 cm) - Hồng",599000,599000,0,0
TIKI,tui-vi-nu,120036392,"Túi đeo trước nam da đà điểu Huy Hoàng màu nâu đất HP6444",5999000,5999000,0,0
TIKI,tui-vi-nu,206980692,"Túi xách tặng bố, My Friend, My Hero, My Dad, mã G175. Có khóa kéo. Quà tặng cao cấp cho cha",109000,109000,0,0
TIKI,tui-vi-nu,193772250,"Túi Đeo Ngực Nam Thời Trang Teement, Chống Thấm Nước, Chống Xước, Chất Liệu Vải Oxford Cao Cấp, Thích Hợp Đi Chơi, Du Lịch - Hàng Chính Hãng",180000,180000,0,0
TIKI,tui-thoi-trang-nam,124966188,"Ví nam, bóp nam da bò sáp Mexico Bụi Leather V102 - Bảo hành 12 tháng",200000,370000,170000,46
TIKI,tui-thoi-trang-nam,126039327,"Bóp Đựng Thẻ ATM Nhỏ Gọn SUPPLE, Da Bò SMALL PEBBLE Mềm Mại - Bền Bỉ, Chống Xước - Chống Nhăn Tốt, Thiết Kế Hiện Đại, Ngăn Súp Lê Rộng, Đựng Được Nhiều Thẻ Ngân Hàng, Card Danh Thiếp, Căn Cước Công Dân, Dáng Đứng - Gập 2 – Hàng Chính Hãng SAIGIO",683000,699000,16000,2
TIKI,tui-thoi-trang-nam,244316262,"Ví nam đựng tiền đựng chìa khóa đựng thẻ đa năng 100% da bò thật cao cấp phong cách mới",333000,370000,37000,10
TIKI,tui-thoi-trang-nam,253171976,"Ví nam 100% da thật thông minh siêu mỏng thời trang cao cấp phong cách cá tính",351000,390000,39000,10
TIKI,tui-thoi-trang-nam,125290044,"Ví nam, bóp nam da bò Saffiano Bụi Leather V141 - Bảo hành 12 tháng",219000,435000,216000,50
TIKI,tui-thoi-trang-nam,253172056,"Ví nam 100% da thật thông minh đa năng thời trang cao cấp phong cách mới",423000,470000,47000,10
TIKI,tui-thoi-trang-nam,75554891,"Túi xách nam da thật cao cấp phong cách mới",423000,470000,47000,10
TIKI,tui-thoi-trang-nam,174022359,"Ví Bóp Vải Canvas JOHZEON Kiểu Dáng Hàn Quốc Nhiều Ngăn Bền Bỉ Tiện Lợi DV100",68000,80000,12000,15
TIKI,tui-thoi-trang-nam,194859087,"ví nam Cef03, bóp nam cefiro logo tộc trưởng da bò cao cấp, ví da nam ví đứng thiết kế nhiều ngăn đựng tiền đựng thẻ, bảo hành da 6 tháng - Adonis",169000,269000,100000,37
TIKI,tui-thoi-trang-nam,169277360,"ví nam AD12, bóp nam da bò saffiano cao cấp, ví da nam ví ngang thiết kế nhiều ngăn nhỏ gọn thời trang, bảo hành da 6 tháng - Adonis Store",185000,289000,104000,36
TIKI,tui-thoi-trang-nam,120469617,"Ví Nam Da Bò NAPA Mềm Mại - Vân Tự Nhiên, Size Lớn, Thiết Kế Cổ Điển, Đơn Giản - Mỏng Nhẹ, Dáng Đứng - Gập 2, Ngăn Đựng Tiền Có Khóa Kéo, Nhiều Ngăn Để Giấy Tờ Tiện Dụng - Hàng Chính Hãng SAIGIO",899000,899000,0,0
TIKI,tui-thoi-trang-nam,176939287,"Ví nam 100% da bò thật cao cấp phong cách mới",387000,430000,43000,10
TIKI,tui-thoi-trang-nam,197879894,"Bóp Đứng Nam Nhỏ Gọn, Chất Liệu Da Bò PULL-UP Mềm Mại, Mỏng Nhẹ, Phong Cách Hiện Đại - Cá Tính, Size Trung, Dáng Đứng - Gập 2, Nhiều Ngăn Để Tiền Và Giấy Tờ Tiện Dụng",982000,999000,17000,2
TIKI,tui-thoi-trang-nam,190860890,"Ví nam da bò cao cấp phong cách mới",270000,299000,29000,10
TIKI,tui-thoi-trang-nam,710785,"Túi Đeo Chéo Nam HARAS HRTK083 (26 x 16.5 cm) - Đen",100000,100000,0,0
TIKI,tui-thoi-trang-nam,71023609,"Ví Da Nam, Bóp Da Nam Đựng Tiền Nhiều Ngăn Tiện Lợi - Mẫu Mới Dòng Cao Cấp Bogesi - Ví Nam Ngang - Kích Thước 10 x 1.5  x 12 cm",79000,79000,0,0
TIKI,tui-thoi-trang-nam,81112510,"Túi đeo hông, đeo bụng nam, nữ chạy bộ thể thao",32670,47190,14520,31
TIKI,tui-thoi-trang-nam,161954337,"Ví nam JOHZEON kiểu dáng hàn quốc nhiều ngăn có ngăn khoá kéo",72500,72500,0,0
TIKI,tui-thoi-trang-nam,131337754,"Túi đeo chéo phiên bản Hàn Quốc đeo chéo một vai đeo ngực, cưỡi ngựa leo núi ngoài trời",42417,44649,2232,5
TIKI,tui-thoi-trang-nam,127551391,"Túi đeo chéo Black Rice vải canvas bền bỉ phong cách thòi trang unisex nam nữ Hàn",105000,210000,105000,50
TIKI,tui-thoi-trang-nam,82372883,"Túi đeo chéo nam cao cấp phong cách mới",297000,330000,33000,10
TIKI,tui-thoi-trang-nam,188997932,"Túi Đeo Chéo Nhiều Ngăn Chứa Cho Nam Nữ Cao Cấp Đi Chơi Chống Nước, Túi Đựng Điện Thoại Ipad, Túi Đeo Vai Thời Trang Sang Trọng Thời Thượng",135000,135000,0,0
TIKI,tui-thoi-trang-nam,76152029,"Ví Nam, Nữ Cầm Tay Cao Cấp VinBuy – Bóp Nam, Nữ Kiểu Dáng Sang Trọng Cao Cấp Dành Cho Doanh Nhân – Hàng Chính Hãng VinBuy",121000,250000,129000,52
TIKI,tui-thoi-trang-nam,272199968,"Ví dài nam thời trang cao cấp phong cách âu mỹ",441000,490000,49000,10
TIKI,tui-thoi-trang-nam,130439350,"Ví nam mini AD08, bóp nam nhỏ gọn, ví da nam thủ công làm từ da bò  nguyên tấm, bóp da dáng ngang siêu đẹp nhiều ngăn tiện lợi",179000,279000,100000,36
TIKI,tui-thoi-trang-nam,169279392,"ví nam AD14, ví sen mini cao cấp, bóp nam da bò thật nguyên tấm , ví da nam nhỏ gọn thiết kế đơn giản tiện dụng, bảo hành da 06 tháng - Adonis Store",159000,269000,110000,41
TIKI,tui-thoi-trang-nam,49076743,"[ KEIO NIPPON ] Ví Đứng Nam Nữ Da Bò Cao Cấp",239000,239000,0,0
TIKI,tui-thoi-trang-nam,77746659,"Túi đeo chéo nam vải canvas cao cấp phong cách mới",359000,398000,39000,10
TIKI,tui-thoi-trang-nam,77741254,"Túi Đeo Hông Thời Trang Nam Nữ Cá Tính Túi Bao Tử Vải Dù Cao Cấp Đeo Chéo Nam Nữ Nhỏ Gọn Tiện Dụng TU17",38610,52767,14157,27
TIKI,tui-thoi-trang-nam,191820415,"Túi Đeo Chéo Nam Thể Thao US ARMY, Túi Đeo Bao Tử  Đeo Bụng Lính Mỹ Phong Cách Chất Vải Kaki Cao Cấp Chồng Nước Nhẹ - HÀNG CHÍNH HÃNG",259000,259000,0,0
TIKI,tui-thoi-trang-nam,141474172,"Túi đeo chéo, đeo vai nhiều ngăn vải Oxford cao cấp chống thấm nước, bền bỉ unisex nam nữ phong cách thời trang, cá tính",180000,180000,0,0
TIKI,tui-thoi-trang-nam,110182282,"Túi Đeo Chéo Nam Phong Cách Lính U448 US ARMY Vải Dệt Cao Cấp -Hàng Chính Hãng",111000,290000,179000,62
TIKI,tui-thoi-trang-nam,31509751,"Ví Da Nam Cầm Tay Cao Cấp Leinasen A80 Dạng Dài",196983,207350,10367,5
TIKI,tui-thoi-trang-nam,75417728,"Bóp Ví Dài Nam Nữ KEIO NIPPON Da Bò Mill Cao Cấp Nhập Khẩu, Đựng Điện Thoại, Hộ Chiếu Kích Thước 20x11x2.5 cm VID0003",469000,469000,0,0
TIKI,tui-thoi-trang-nam,72769110,"Ví Da Bò Nam KEIO NIPPON Cao Cấp Nhập Khẩu Italia, Khóa Kéo, Kích Thước 12x9,5cm DBNKK12",229000,229000,0,0
TIKI,tui-thoi-trang-nam,115712587,"Túi Đeo Chéo Nam Cao Cấp Phong Cách Châu Âu Với Thiết Kế Kinh Điển Không Bao Giờ Lỗi Mốt, Chất Liệu Vải Oxford Chống Nhăn, Chống Nước, Chống Bám Bụi Bẩn,Túi Đeo Vai Phong Cách Thể Thao Đường Phố",219000,219000,0,0
TIKI,tui-thoi-trang-nam,185991219,"Túi đeo chéo nam đa năng cao cấp phong cách mới",333000,370000,37000,10
TIKI,tui-thoi-trang-nam,134040370,"Túi đeo chéo nam nữ thời trang BEE GEE 0127 để điện thoại ipad chống thấm nước đẹp chất lượng tốt",69000,138000,69000,50
TIKI,tui-thoi-trang-nam,106699231,"Túi Đeo Chéo Nam Cao Cấp Chất Liệu Vải Dù Chống Thấm Nước,Túi Đeo Vai Phong Cách Thời Trang Hàn Quốc Dành Cho Người Đi Làm, Học Sinh, Sinh Viên,Người Đi Chơi, Đi Du Lịch",295000,295000,0,0
TIKI,tui-thoi-trang-nam,124966188,"Ví nam, bóp nam da bò sáp Mexico Bụi Leather V102 - Bảo hành 12 tháng",200000,370000,170000,46
TIKI,tui-thoi-trang-nam,189539055,"Túi đeo chéo vải Canvas T0166 unisex nam nữ phong cách trẻ trung Hàn",60000,120000,60000,50
TIKI,tui-thoi-trang-nam,153912766,"Túi Đeo Chéo Nam Nữ U968 US ARMY, Túi Đeo Hông Tiện Dụng Chống Nước Vải Canvas Cao Cấp Phong Cách Lính -HÀNG CHÍNH HÃNG",79000,199000,120000,60
TIKI,tui-thoi-trang-nam,125290044,"Ví nam, bóp nam da bò Saffiano Bụi Leather V141 - Bảo hành 12 tháng",225000,435000,210000,48
TIKI,tui-thoi-trang-nam,72724925,"Ví Nam Vân Cá Sấu KEIO NIPPON Da Bò Nhập Khẩu Italia, Kích thước 12x9.5 cm, Khóa Kéo DBVCS12",249000,249000,0,0
TIKI,tui-thoi-trang-nam,56691974,"Ví nam da bò cao cấp phong cách mới",387000,430000,43000,10
TIKI,tui-thoi-trang-nam,195153629,"Túi Đeo Chéo Vải Canvas Bền Bỉ Phong Cách Thời Trang Unisex Nam Nữ Hàn  BL002",112500,150000,37500,25
TIKI,tui-thoi-trang-nam,115663661,"Ví nam AD04, bóp nam da thật, ví da nam ví đứng 18 ngăn đựng tiền đựng thẻ, chất",299000,419000,120000,29
TIKI,tui-thoi-trang-nam,21602898,"Ví Nam, Bóp Nam [Dáng Đứng] Da Bò Thật Cao Cấp - Thời Trang",99000,99000,0,0
TIKI,tui-thoi-trang-nam,19711675,"Ví da nam/ nữ cầm tay cao cấp phong cách Hàn Quốc VD090 - Ví da nam kẻ caro đen dáng dài cầm tay có khóa kéo, có ngăn đựng thẻ/ card chống thấm nước",59000,59000,0,0
TIKI,tui-thoi-trang-nam,191820415,"Túi Đeo Chéo Nam Thể Thao US ARMY, Túi Đeo Bao Tử  Đeo Bụng Lính Mỹ Phong Cách Chất Vải Kaki Cao Cấp Chồng Nước Nhẹ - HÀNG CHÍNH HÃNG",259000,259000,0,0
TIKI,tui-thoi-trang-nam,153264933,"Túi đeo chéo nam nữ 4 ngăn cao cấp D77 Shalla",37000,52767,15767,30
TIKI,tui-thoi-trang-nam,48256263,"Ví Nam Da Bò KEIO NIPPON Cao Cấp Kiểu Ngang | Bóp Da Bò Nam Ngang Cánh Lật",249000,249000,0,0
TIKI,tui-thoi-trang-nam,115500712,"Ví nam AD01, bóp nam da thật, ví da nam ví đứng nhiều ngăn đựng tiền đựng thẻ tiện dụng chất",145000,145000,0,0
TIKI,tui-thoi-trang-nam,140308913,"Túi đeo bụng, đeo chéo nhiều ngăn đa năng chống thấm nước cho nam, nữ hàng cao cấp size 22cm",70000,98430,28430,29
TIKI,tui-thoi-trang-nam,20834169,"Ví Nam Dài Cầm Tay Nam Thời Trang Hàn Quốc",129000,182655,53655,29
TIKI,tui-thoi-trang-nam,126039327,"Bóp Đựng Thẻ ATM Nhỏ Gọn SUPPLE, Da Bò SMALL PEBBLE Mềm Mại - Bền Bỉ, Chống Xước - Chống Nhăn Tốt, Thiết Kế Hiện Đại, Ngăn Súp Lê Rộng, Đựng Được Nhiều Thẻ Ngân Hàng, Card Danh Thiếp, Căn Cước Công Dân, Dáng Đứng - Gập 2 – Hàng Chính Hãng SAIGIO",683000,699000,16000,2
TIKI,tui-thoi-trang-nam,253171976,"Ví nam 100% da thật thông minh siêu mỏng thời trang cao cấp phong cách cá tính",351000,390000,39000,10
TIKI,tui-thoi-trang-nam,244316262,"Ví nam đựng tiền đựng chìa khóa đựng thẻ đa năng 100% da bò thật cao cấp phong cách mới",333000,370000,37000,10
TIKI,tui-thoi-trang-nam,253172056,"Ví nam 100% da thật thông minh đa năng thời trang cao cấp phong cách mới",423000,470000,47000,10
TIKI,tui-thoi-trang-nam,74926237,"Túi Bao Tử Đeo Chéo Cao Cấp Đơn Giản Nhỏ Gọn Nam Nữ Để Điện Thoại Ví Galaxy Store GTBT02 - Hàng Chính Hãng",68000,350000,282000,81
TIKI,tui-thoi-trang-nam,191820415,"Túi Đeo Chéo Nam Thể Thao US ARMY, Túi Đeo Bao Tử  Đeo Bụng Lính Mỹ Phong Cách Chất Vải Kaki Cao Cấp Chồng Nước Nhẹ - HÀNG CHÍNH HÃNG",259000,259000,0,0
TIKI,tui-thoi-trang-nam,22012658,"Bóp Ví Da Sang Trọng Thương Hiệu Baellery Mã BLR1152 Bóp Ví Da Nam Cao Cấp",89000,89000,0,0
TIKI,tui-thoi-trang-nam,126765353,"Túi bao tử - đeo chéo unisex nam nữ vải chống nước phong cách Hàn",74000,104181,30181,29
TIKI,tui-thoi-trang-nam,167468890,"Ví nam, bop nam, ví nam mini, bóp da nam, ví da nam đẹp, vi da nam, ví da nam P015 kiểu dáng thanh lịch, phong cách Hàn Quốc",59000,59000,0,0
TIKI,tui-thoi-trang-nam,197879894,"Bóp Đứng Nam Nhỏ Gọn, Chất Liệu Da Bò PULL-UP Mềm Mại, Mỏng Nhẹ, Phong Cách Hiện Đại - Cá Tính, Size Trung, Dáng Đứng - Gập 2, Nhiều Ngăn Để Tiền Và Giấy Tờ Tiện Dụng",982000,999000,17000,2
TIKI,tui-thoi-trang-nam,184491427,"Túi đeo chéo nam 100% da bò thật cao cấp phong cách mới",477000,530000,53000,10
TIKI,tui-thoi-trang-nam,75554891,"Túi xách nam da thật cao cấp phong cách mới",423000,470000,47000,10
TIKI,tui-thoi-trang-nam,155495937,"Ví namecard da bò V131, ví đựng thẻ card holder da thật nhỏ gọn, thương hiệu Bụi leather chuyên đồ da thật",49000,84000,35000,42
TIKI,tui-thoi-trang-nam,79467350,"Túi đeo chéo UAG Hip Pack thời trang, chống nước - Hàng Chính Hãng",975000,1300000,325000,25
TIKI,tui-thoi-trang-nam,185995682,"Túi đeo chéo đeo ngực nam đa năng cao cấp phong cách mới",270000,299000,29000,10
TIKI,tui-thoi-trang-nam,53459983,"[ KEIO NIPPON ] Ví Nam Da Bò Saffiano Cao Cấp Nhập Khẩu | Bóp Nam Kiểu Ngang",249000,249000,0,0
TIKI,tui-thoi-trang-nam,117401394,"Ví Đựng Thẻ ATM Mini, Da Bò Mềm Mại GENTLE, Da Thật 100%, Thiết Kế Hiện Đại, Nhiều Ngăn Tiện Dụng, Đựng Thẻ Ngân Hàng, Danh Thiếp, Căn Cước, Hình Lưu Niệm, Dáng Đứng - Gập 2 - Hàng Chính Hãng SAIGIO",629000,649000,20000,3
TIKI,tui-thoi-trang-nam,272199968,"Ví dài nam thời trang cao cấp phong cách âu mỹ",441000,490000,49000,10
TIKI,tui-thoi-trang-nam,163281652,"Túi đeo chéo đeo ngực nam cao cấp phong cách châu âu",711000,790000,79000,10
TIKI,tui-thoi-trang-nam,148935680,"Túi đeo chéo nam nữ unisex phong cách ulzzang sợi polyesster cao cấp chống thấm nước Haoshuai G2 – Golovejoy",99000,99000,0,0
TIKI,tui-thoi-trang-nam,120469617,"Ví Nam Da Bò NAPA Mềm Mại - Vân Tự Nhiên, Size Lớn, Thiết Kế Cổ Điển, Đơn Giản - Mỏng Nhẹ, Dáng Đứng - Gập 2, Ngăn Đựng Tiền Có Khóa Kéo, Nhiều Ngăn Để Giấy Tờ Tiện Dụng - Hàng Chính Hãng SAIGIO",899000,899000,0,0
TIKI,tui-thoi-trang-nam,75645911,"Túi đeo chéo nam phong cách mới tích hợp khóa chống trộm và chống thấm nước cao cấp",370000,370000,0,0
TIKI,tui-thoi-trang-nam,40721387,"Ví Da Nam Cao Cấp Basic One Caramel Bỏ Vừa BLX Cũ",199000,199000,0,0
TIKI,tui-thoi-trang-nam,147694482,"Túi Xách Công Sở Nam P117 – Cặp Da Thời Trang Thiết Kế Sang Trọng – Lịch lãm",455000,455000,0,0
TIKI,tui-thoi-trang-nam,106693981,"Túi Đeo Chéo Nam Vải Dù Cao Cấp, Phong Cách Thời Trang Châu Âu, Túi Đeo Vai Chống Thấm Nước Tốt, Vải Mềm Chống Nhăn, Đường Chỉ May Chắc Chắn, Khóa Kéo Bền Đẹp, Túi Dành Cho Học Sinh, Sinh Viên, Người Đi Làm",219000,219000,0,0
TIKI,tui-thoi-trang-nam,72605942,"Túi Đeo Chéo Túi Đeo Ngực Nam Nữ Chống Nước Thể Thao",160000,160000,0,0
TIKI,tui-thoi-trang-nam,183531122,"Túi đeo chéo da nam dáng ngang phối ngăn đôi TRITA RTN6",299000,520000,221000,43
TIKI,tui-thoi-trang-nam,7763050,"Cặp nam đeo chéo TROY phối nắp",129000,129000,0,0
TIKI,tui-thoi-trang-nam,58423244,"Ví Nam Cao Cấp KEIO NIPPON | Da Bò Nhập Khẩu Ý | Size 12 x 9,5 cm | Đựng CMND, GPLX, Cà Vẹt Xe - Màu",269000,269000,0,0
TIKI,tui-thoi-trang-nam,105695598,"Ví nam cầm tay cao cấp - Clutch Cầm Tay chất lượng cao phong cách mới",359000,398000,39000,10
TIKI,tui-thoi-trang-nam,92911132,"[Da thật] Ví nam da bò vân da voi, Ví đứng nam da thật WS114 (Đen/Nâu) - 100% da bò thật, BH 3 năm",99000,99000,0,0
TIKI,tui-thoi-trang-nam,82372883,"Túi đeo chéo nam cao cấp phong cách mới",297000,330000,33000,10
TIKI,tui-thoi-trang-nam,190860890,"Ví nam da bò cao cấp phong cách mới",270000,299000,29000,10
TIKI,tui-thoi-trang-nam,83677957,"Balo đeo chéo nam thời trang Yuumy RBAC01",179000,390000,211000,54
TIKI,tui-thoi-trang-nam,13436994,"Túi đeo chéo thời trang BEE GEE 037",65000,130000,65000,50
TIKI,tui-thoi-trang-nam,75418303,"Bóp Ví Dài Nam Nữ KEIO NIPPON Da Bò Mill Cao Cấp Nhập Khẩu, Kích Thước 18x9x2cm VID-GAP001",349000,349000,0,0
TIKI,tui-thoi-trang-nam,89786167,"Túi đeo chéo nam nữ vải dù chống nước phong cách Hàn Quốc - Túi bao tử nam TC83",74000,104181,30181,29
TIKI,tui-thoi-trang-nam,73502969,"Túi bao tử cao cấp đeo hông đeo ngực tiện lợi MIBAG37",74000,104181,30181,29
TIKI,tui-thoi-trang-nam,48108583,"Ví Nam Đứng , Bóp Nam Dáng Đứng Nhỏ Gọn Sang Trọng, Da Bò Thật 100%",410000,410000,0,0
TIKI,tui-thoi-trang-nam,8564318,"VÍ NAM DA THẬT LATA LVN006",259000,350000,91000,26
TIKI,tui-thoi-trang-nam,109483831,"Túi đeo chéo nam thời trang cao cấp ",450000,499000,49000,10
TIKI,tui-thoi-trang-nam,75728670,"Túi đeo chéo nam tích hợp khóa chống trộm chống nước cao cấp phong cách mới",297000,330000,33000,10
TIKI,tui-thoi-trang-nam,56029758,"VÍ SEN 1 - CHÍNH HÃNG KHẮC TÊN",300000,300000,0,0
TIKI,tui-thoi-trang-nam,138556972,"Cặp da nam công sở TRITA TCA16",259000,460000,201000,44
TIKI,tui-thoi-trang-nam,176939287,"Ví nam 100% da bò thật cao cấp phong cách mới",387000,430000,43000,10
TIKI,tui-thoi-trang-nam,102012630,"Ví nam đựng thẻ ATM mini bằng hợp kim nhôm MB25",238000,238000,0,0
TIKI,tui-thoi-trang-nam,155776133,"Túi đeo chéo nam nữ unisex phong cách ulzzang sợi polyesster cao cấp chống thấm nước Haoshuai S12",125000,125000,0,0
TIKI,tui-thoi-trang-nam,20882002,"Ví Nam Dài Cầm Tay - Ví Bóp Cầm Tay Dài Nam Thời Trang",90090,123123,33033,27
TIKI,tui-thoi-trang-nam,125290044,"Ví nam, bóp nam da bò Saffiano Bụi Leather V141 - Bảo hành 12 tháng",225000,435000,210000,48
TIKI,tui-thoi-trang-nam,165699417,"Túi đeo chéo da nam thể du đựng ipad Sport Caro xanh Nền Tối Shalla",48000,67717,19717,29
TIKI,tui-thoi-trang-nam,66629126,"Ví Nam KEIO NIPPON Da Bò Cao Cấp Xuất Khẩu Hàn Quốc, Ví Da Nam Mỏng Ngang Korea",179000,179000,0,0
TIKI,tui-thoi-trang-nam,56691974,"Ví nam da bò cao cấp phong cách mới",387000,430000,43000,10
TIKI,tui-thoi-trang-nam,95446218,"Túi xách nam công sở cao cấp siêu bền đẹp",423000,470000,47000,10
TIKI,tui-thoi-trang-nam,191490265,"Túi đeo chéo nam nữ cao cấp vải chống thấm nước BEE GEE DCN9031B",335000,670000,335000,50
TIKI,tui-thoi-trang-nam,184415074,"Ví Da Nam Cao Cấp VD04 Kiểu Đứng Nhỏ Gọn Thời Trang",38000,50000,12000,24
TIKI,tui-thoi-trang-nam,191606872,"Ví Nam Trơn Da Pu Nhiều Ngăn Có Khóa Nhỏ Gọn Tiện Lợi Cho Phái Nam D&D Fashion",50000,95000,45000,47
TIKI,tui-thoi-trang-nam,72673634,"TÚI ĐEO CHÉO TOMTOC (USA) LIGHTWEIGHT CODURA SLING BAG BLACK (H02-A04D) - HÀNG CHÍNH HÃNG",950000,950000,0,0
TIKI,tui-thoi-trang-nam,190860890,"Ví nam da bò cao cấp phong cách mới",270000,299000,29000,10
TIKI,tui-thoi-trang-nam,910662,"Ví Nam HARAS V05 (12 x 2 cm) - Đen",90000,90000,0,0
TIKI,tui-thoi-trang-nam,108311444,"Túi xách túi đeo chéo nam 100% da bò thật cao cấp phong cách mới",513000,570000,57000,10
TIKI,tui-thoi-trang-nam,115659840,"Ví nam mini AD02, bóp nam da thật, ví da nam ví đứng nhiều ngăn kích thước nhỏ gọn đựng tiền đựng thẻ tiện dụng, chất",99000,99000,0,0
TIKI,tui-thoi-trang-nam,57916893,"Túi da bao tử nam Dza, chất Pu cao cấp, thiết kế gọn gàng tinh tế, màu sắc thanh lịch",94333,136259,41926,31
TIKI,tui-thoi-trang-nam,25407742,"Túi Đeo Chéo Da Nam Cao Cấp Túi Nắp Weixier B0834 – Túi Đeo Chéo Da Thời Trang",257000,257000,0,0
TIKI,tui-thoi-trang-nam,82372883,"Túi đeo chéo nam cao cấp phong cách mới",297000,330000,33000,10
TIKI,tui-thoi-trang-nam,77033102,"Túi Đeo Chéo Nam Nữ Chống Nước Thời Trang Kabek TD23 Túi Bao Tử Unisex Dệt Trơn Trượt Nước Đeo Hông Lưng Bụng Màu Đen Phù Hợp Nam Nữ Thời Trang Phong Cách Nhật Bản Thiết Kế Basic Hiện Đại Đơn Giản",83548,87945,4397,5
TIKI,tui-thoi-trang-nam,193724249,"Túi Bao Tử Nam Nữ Đeo Chéo Du Lịch Tiện Ích, Vải Cao Cấp Chống Thấm, Nhiều Ngăn Đựng",65000,65000,0,0
TIKI,tui-thoi-trang-nam,57242919,"Túi đeo hông đeo bụng cao cấp thể thao du lịch sport KSD22",51000,71709,20709,29
TIKI,tui-thoi-trang-nam,44044629,"Cặp công sở thời trang CAYUUMY07",225000,390000,165000,42
TIKI,tui-thoi-trang-nam,111868735,"Túi đeo chéo, đeo hông Arctic Hunter K00093 chất liệu Oxford chống thấm nước, thiết kế nhiều ngăn tiện dụng",399000,635000,236000,37
TIKI,tui-thoi-trang-nam,115642332,"Ví nam dài D066 cầm tay thời trang sang trọng",63000,69000,6000,9
TIKI,tui-thoi-trang-nam,186270968,"Túi xách da nam công sở TRITA RTN8",305000,550000,245000,45
TIKI,tui-thoi-trang-nam,192128365,"Túi xách da nam công sở da PU cao cấp hàng hiệu chính hãng YVan F80166-5",650000,650000,0,0
TIKI,tui-thoi-trang-nam,153471499,"Cặp da bò dập vân CÁ SẤU - BEEGEE 5509",1100000,2200000,1100000,50
TIKI,tui-thoi-trang-nam,51147505,"Túi đeo ngực,đeo chéo nam đã tích hợp công nghệ 4.0",529000,799000,270000,34
TIKI,tui-thoi-trang-nam,133900168," Ví nam da bò thật VO 031005",165000,320000,155000,48
TIKI,tui-thoi-trang-nam,183530414,"Túi bao tử - đeo chéo mini vải Canvas Unisex nam nữ phong cách trẻ trung, đường phố",47000,94000,47000,50
TIKI,tui-thoi-trang-nam,2000411,"Ví Nam Bấm Nút Huy Hoàng HT2142 (12.5 x 10 cm) - Đen",529000,529000,0,0
TIKI,tui-thoi-trang-nam,2210041,"Ví đứng da bò nam cao cấp AT Leather 062 (12 x 9.5 cm) - Nâu",259000,305000,46000,15
TIKI,tui-thoi-trang-nam,189337217,"Túi đeo chéo nam nữ đa năng vải cao cấp chính hãng YVan 8882",325000,325000,0,0
TIKI,tui-thoi-trang-nam,14062664,"Cặp Da Nam Công Sở KG001",299500,599000,299500,50
TIKI,tui-thoi-trang-nam,10583890,"Túi Đeo Chéo Nam Chống Trộm",111000,111000,0,0
TIKI,tui-thoi-trang-nam,88999791,"Bóp Ví Nam Da Bò Thật Dáng Ngang MEDYN Chính Hãng - May Tay Chắc Chắn, Ke Viền Nổi Bật - Da Sáp Cực Bền Và Đẹp Theo Thời Gian Không Bị Bong Tróc, Phai Màu",99000,99000,0,0
TIKI,tui-thoi-trang-nam,87858835,"Túi đeo chéo nam nữ siêu đẹp siêu sang - Mã 8596",289000,499000,210000,42
TIKI,tui-thoi-trang-nam,193310417,"Ví da thời trang ngang nam loại gập cầm tay nhiều ngăn D3088",47500,50000,2500,5
TIKI,tui-thoi-trang-nam,15816508,"Ví Móc Chìa Khóa K0006 Màu Xanh Đen",95000,95000,0,0
TIKI,tui-thoi-trang-nam,19707078,"Túi đeo hông nam du lịch, phượt",157500,157500,0,0
TIKI,tui-thoi-trang-nam,97644482,"Túi đeo chéo nam VPC kiểu ngang bóng trơn VF47 Tặng móc khóa hình khiên",79000,112158,33158,30
TIKI,tui-thoi-trang-nam,188997575,"Bao da dành cho Chìa Khóa Smartkey Yamaha NVX, Janus, Nozza Grande, FreeGo, Latte, Exciter 155 VVA handmade da thật",99000,99000,0,0
TIKI,tui-thoi-trang-nam,59166368,"Túi đeo chéo cặp da công sở đựng laptop dáng túi ngang T74 33x25x7cm",329000,329000,0,0
TIKI,tui-thoi-trang-nam,193044239,"Túi xách nam công sở da bò thật tích hợp khóa chống trộm cao cấp",882000,980000,98000,10
TIKI,tui-thoi-trang-nam,44336401,"Túi đeo chéo nam nữ unisex du lịch thời trang Hàn quốc BEE GEE cao cấp đẹp giá rẻ - XAM",50000,100000,50000,50
TIKI,tui-thoi-trang-nam,125289842,"Ví nam, bóp nam da bò Saffiano Bụi Leather V140 - Bảo hành 12 tháng",215000,412000,197000,48
TIKI,tui-thoi-trang-nam,137499373,"Bóp Ví Nam Da Bò Cao Cấp Vân Cá Sấu Gù Nguyên Con Ví Đứng màu đen,màu nâu Viền khâu thủ công sang Trọng Bảo Hành 12 TH",175000,175000,0,0
TIKI,tui-thoi-trang-nam,102012371,"Túi đeo chéo nam nữ chất liệu vải chống thấm nước phong cách Hàn Quốc - Túi bao tử Unisex TC06",74000,104181,30181,29
TIKI,tui-thoi-trang-nam,164338907,"Túi đeo chéo đeo ngực nam cao cấp phong cách châu âu",603000,670000,67000,10
TIKI,tui-thoi-trang-nam,155339338,"Ví đựng thẻ da bò sáp ngựa điên Crazyhorse V117 cao cấp, card holder da thật, đường chỉ may tinh tế, ví mini nam nhỏ gọn, đựng thẻ tiện lợi, fullbox, thương hiệu Bụi leather chuyên đồ da thật",130000,205000,75000,37
TIKI,tui-thoi-trang-nam,169278770,"ví nam AD009, bóp nam da bò nappa cao cấp, ví da nam ví ngang thiết kế nhiều ngăn đựng tiền đựng thẻ, bảo hành da 6 tháng - Adonis Store",169000,269000,100000,37
TIKI,tui-thoi-trang-nam,170498952,"Bóp đựng tiền nhiều ngăn Simple Vertical Wallet V3 chính hãng NATOLI cầm tay kháng nước cao cấp",179000,256000,77000,30
TIKI,tui-thoi-trang-nam,75616814,"Túi đeo chéo nam tích hợp khóa chống trộm và chống thấm nước cao cấp phong cách mới",423000,470000,47000,10
TIKI,tui-thoi-trang-nam,167443834,"Túi đeo chéo nam 100% da bò thật cao cấp phong cách mới",477000,530000,53000,10
TIKI,tui-thoi-trang-nam,117401394,"Ví Đựng Thẻ ATM Mini, Da Bò Mềm Mại GENTLE, Da Thật 100%, Thiết Kế Hiện Đại, Nhiều Ngăn Tiện Dụng, Đựng Thẻ Ngân Hàng, Danh Thiếp, Căn Cước, Hình Lưu Niệm, Dáng Đứng - Gập 2 - Hàng Chính Hãng SAIGIO",629000,649000,20000,3
TIKI,tui-thoi-trang-nam,109389766,"Túi xách nam công sở da tự nhiên cao cấp phong cách mới",423000,470000,47000,10
TIKI,tui-thoi-trang-nam,148935724,"Túi đeo chéo nam nữ unisex phong cách ulzzang sợi polyesster cao cấp chống thấm nước Haoshuai G12 - Golovejoy",125000,125000,0,0
TIKI,tui-thoi-trang-nam,67299408,"Túi đeo chéo nam da bò cao cấp YILIDAISHU T32 27x25x6cm(Nâu - Đen)",299000,299000,0,0
TIKI,tui-thoi-trang-nam,129575356,"ví nam ví nam clutch cầm tay cao cấp",297000,330000,33000,10
TIKI,tui-thoi-trang-nam,51060914,"VÍ SEN 3 - CHÍNH HÃNG KHẮC TÊN",500000,500000,0,0
TIKI,tui-thoi-trang-nam,155339755,"Ví sen 3 PLUS da bò Pullup V123, bóp mini nam nhỏ gọn hai màu đen và nâu, đường chỉ may tinh tế, đựng thẻ kẹp tiền tiện lợi, fullbox, thương hiệu Bụi leather chuyên đồ da thật",160000,278000,118000,42
TIKI,tui-thoi-trang-nam,164554647,"Túi Đeo Chéo Nam, Túi Chéo Nam Đi Chơi Chất Đẹp, Túi Xách Nam, Túi Đeo Chéo Nhiều Màu, Thời Trang Siêu Chất - OTV164 - Ope Store",250000,250000,0,0
TIKI,tui-thoi-trang-nam,183742082,"Túi đeo chéo Nam kết hợp Ví cầm tay vải Oxford cao cấp chống nước, chống bám bụi - Túi Ví Nam sang trọng",349000,349000,0,0
TIKI,tui-thoi-trang-nam,125037676,"Ví nam, bóp nam da bò Nappa Bụi Leather V104 - Bảo hành 12 tháng",209000,370000,161000,44
TIKI,tui-thoi-trang-nam,149753175,"TÚI ĐEO CHÉO HAVIN MỚI NHẤT 2021 SÀN PHẨM CHẤT LƯỢNG ĐƯỢC LÀM BẰNG VẢI DÙ TỐT NHẤT",99000,135000,36000,27
TIKI,tui-thoi-trang-nam,107366288,"Túi đeo chéo nam thời trang cao cấp",351000,390000,39000,10
TIKI,tui-thoi-trang-nam,120469617,"Ví Nam Da Bò NAPA Mềm Mại - Vân Tự Nhiên, Size Lớn, Thiết Kế Cổ Điển, Đơn Giản - Mỏng Nhẹ, Dáng Đứng - Gập 2, Ngăn Đựng Tiền Có Khóa Kéo, Nhiều Ngăn Để Giấy Tờ Tiện Dụng - Hàng Chính Hãng SAIGIO",899000,899000,0,0
TIKI,tui-thoi-trang-nam,173343742,"Ví Nam Ngang Cao Cấp Sang Trọng, Chất Liệu Bền Đẹp, Ví Da Nam, Ví Nam Cầm Tay Nhiều Ngăn Tiện Lợi - Hàng chính hãng",37000,70000,33000,47
TIKI,tui-thoi-trang-nam,155330335,"Ví da nam, bóp da nam mini Bụi Leather V115 - Da bò Nappa cao cấp - Bảo hành 12 tháng",180000,278000,98000,35
TIKI,tui-thoi-trang-nam,184123552,"Túi xách nam thời trang công sở chống thấm nước cao cấp",450000,499000,49000,10
TIKI,tui-thoi-trang-nam,77747266,"Túi đeo chéo vải canvas cao cấp phong cách mới",269000,298000,29000,10
TIKI,tui-thoi-trang-nam,196881208,"Ví nam da bò cao cấp phong cách mới",225000,250000,25000,10
TIKI,tui-thoi-trang-nam,85047463,"Túi da cao cấp đeo chéo nam Kangaroo",265000,265000,0,0
TIKI,tui-thoi-trang-nam,148966755,"Bóp Da Nam, Ví Da Nam Đựng Tiền Nhiều Ngăn Tiện Lợi - Dòng Cao Cấp 2 Kiểu Dáng Ngang Và Đứng",85000,85000,0,0
TIKI,tui-thoi-trang-nam,184517203,"Túi đeo chéo nam cao cấp phong cách mới",288000,320000,32000,10
TIKI,tui-thoi-trang-nam,13853043,"Ví Bóp Nam Nữ Nhỏ Gọn Thời Trang Độc Đáo Da Bò Handmade Galaxy Store GVU01 (11x8cm)",179000,300000,121000,40
TIKI,tui-thoi-trang-nam,122234659,"Túi Bao Tử Nam Thời Trang Đeo Chéo Màu Nâu Đựng Được Nhiều Đồ",180000,360000,180000,50
TIKI,tui-thoi-trang-nam,187860014,"Bóp Nam Da Bò Mềm Mại STRIPE, Size Lớn, 10 Ngăn Để Thẻ, 3 Ngăn Đựng Tiền, Dáng Ngang - Gập 2, Có Khóa Kéo, Để Vừa Các Giấy Tờ Chuyên Dụng Như Giấy Tờ Xe Máy, Bảo Hiểm",783000,799000,16000,2
TIKI,tui-thoi-trang-nam,193611368,"Túi đeo chéo nam đa năng cao cấp phong cách mới",207000,230000,23000,10
TIKI,tui-thoi-trang-nam,44044210,"Cặp công sở thời trang CAYUUMY06",225000,390000,165000,42
TIKI,tui-thoi-trang-nam,58421960,"Ví Nam Cao Cấp KEIO NIPPON Da Bò Mill Nhập Khẩu Ý  | Size Lớn 12 x 9,5 cm | Đựng CMND, Bằng Lái Xe, CàVẹt Xe",289000,289000,0,0
TIKI,tui-thoi-trang-nam,122391985,"Bóp Nam Mini Nhỏ Gọn, Da Bò NAPA Mềm Mại - Vân Tự Nhiên, Thiết Kế Cổ Điển, Đơn Giản - Mỏng Nhẹ, Dáng Ngang - Gập 2, Đựng Tiền và Thẻ ATM Tiện Dụng - Hàng Chính Hãng SAIGIO",781000,799000,18000,2
TIKI,tui-thoi-trang-nam,102012570,"Túi đeo chéo nam mini vải canvas bền bỉ phong cách unisex Hàn Quốc TC02",198000,198000,0,0
TIKI,tui-thoi-trang-nam,193395348,"Túi Đeo Chéo Vải OxFord Trung Niên Nhiều Ngăn Chứa Cho Nam Nữ Cao Cấp Đi Chơi Chống Nước, Túi Đựng Điện Thoại Ipad, Túi Đeo Vai Thời Trang Sang Trọng Thời Thượng",150000,150000,0,0
TIKI,tui-thoi-trang-nam,130440816,"Ví nam AD09, ví da nam gấp 3 nhỏ gọn, bóp nam da bò thật nhiều ngăn đựng tiền đựng thẻ, bóp da nam cao cấp bảo hàng 12 tháng",185000,289000,104000,36
TIKI,tui-thoi-trang-nam,74896948,"Ví Nam Thời Trang Da Bò Thật TRITA RVN05 nhiều màu",189000,380000,191000,50
TIKI,tui-thoi-trang-nam,213585423," Ví da nam D730 và D738 kiểu đứng và ngang bóp nam mini màu đen cao cấp lịch lãm",110000,220000,110000,50
TIKI,tui-thoi-trang-nam,99078225,"Túi đeo chéo nam đa năng cao cấp phong cách mới",261000,290000,29000,10
TIKI,tui-thoi-trang-nam,176749882,"Ví Nam Cao Cấp, Da Bò NAPA Láng Mịn In Caro, Mỏng Nhẹ, Size Lớn, Thiết Kế Đơn Giản - Sang Trọng, Dáng Ngang - Gập 2, Ngăn Đựng Tiền Có Khóa Kéo, Nhiều Ngăn Để Giấy Tờ Tiện Dụng - Hàng Chính Hãng SAIGIO",1181000,1199000,18000,2
TIKI,tui-thoi-trang-nam,22012309,"Ví Da Nam Bóp Da Ngắn Baellerry Thời Trang Dành Cho Nam Giới",75000,75000,0,0
TIKI,tui-thoi-trang-nam,75554891,"Túi xách nam da thật cao cấp phong cách mới",423000,470000,47000,10
TIKI,tui-thoi-trang-nam,118124155,"Ví Nam Da Bò NAPA Mềm Mại - Vân Tự Nhiên, Size Lớn, Thiết Kế Cổ Điển, Đơn Giản - Mỏng Nhẹ, Dáng Ngang - Gập 2, Ngăn Đựng Tiền Có Khóa Kéo, Nhiều Ngăn Để Giấy Tờ Tiện Dụng - Hàng Chính Hãng SAIGIO",879000,899000,20000,2
TIKI,tui-thoi-trang-nam,66828628,"Túi đựng điện thoại đeo thắt lưng Chiến thuật",90000,90000,0,0
TIKI,tui-thoi-trang-nam,28445522,"Túi đeo hông lính",62000,87945,25945,30
TIKI,tui-thoi-trang-nam,195695187,"Túi Đeo Vai Nhỏ Unisex E&S Đựng Phụ Kiện, Điện Thoại , Thiết Bị Cá Nhân Tiện Lợi Nhỏ Gọn Bền Bỉ  BL012",130000,130000,0,0
TIKI,tui-thoi-trang-nam,7713520,"Túi Đeo Chéo Cao Cấp 4 Ngăn (Xám)",97000,150000,53000,35
TIKI,tui-thoi-trang-nam,35330048,"Túi Đeo Hông Da Bò",97000,134632,37632,28
TIKI,tui-thoi-trang-nam,6114005,"Ví Nam Da Thật Lata LVN25",259000,350000,91000,26
TIKI,tui-thoi-trang-nam,195986500,"Túi đeo chéo Messenger vải Oxford cao cấp chống thấm nước, bền bỉ unisex nam nữ phong cách thời trang, cá tính",70000,140000,70000,50
TIKI,tui-thoi-trang-nam,32081248,"Ví Kẹp Tiền Da Thật",109000,109000,0,0
TIKI,tui-thoi-trang-nam,48173197,"Ví Nam Đứng , Bóp Nam Dáng Đứng Nhỏ Gọn Màu Đen, Da Bò Thật 100%",99000,99000,0,0
TIKI,tui-thoi-trang-nam,116959595,"(Xịn Sò) Túi chống nước, Túi đeo chéo_Steel Rose tiện dụng, sang trọng_Túi đeo vai, Túi vải_đeo hông",189000,189000,0,0
TIKI,tui-thoi-trang-nam,186580955,"Túi đeo chéo nam vải cavans cao cấp phong cách mới",315000,350000,35000,10
TIKI,tui-thoi-trang-nam,42420417,"Ví Da Nam Cầm Tay - Bóp Da Thời Trang Cao Cấp Có Khóa Số Thông Minh - KAW21 - Nâu",230000,230000,0,0
TIKI,tui-thoi-trang-nam,189281858,"Túi đeo chéo nam nữ nhiều ngăn tiện lợi vải cao cấp chính hãng YVan 1202-1",325000,325000,0,0
TIKI,tui-thoi-trang-nam,70680920,"Túi Đeo Chéo Nam Unisex Thời Trang Chống Nước Yourwish TD23 Túi Bao Tử Dệt Trơn Trượt Nước Đeo Hông Lưng Bụng Màu",76000,87945,11945,14
TIKI,tui-thoi-trang-nam,77743002,"Túi Đeo Bụng Thể Thao Nam Nữ Đeo Hông Đeo Chéo Vải Dù Thời Trang Túi Bao Tử Nhỏ Gọn Tiện Dụng Chắc Chắn Bền Đẹp TU18",37000,52767,15767,30
TIKI,tui-thoi-trang-nam,146987080,"Ví Da Nam VD05 Kiểu Ngang Chính Hãng Siêu Xịn Siêu Đẳng Cấp",38000,50000,12000,24
TIKI,tui-thoi-trang-nam,67896332,"Túi đeo chéo nam nữ unisex chống thấm nước đi học đi chơi",220000,220000,0,0
TIKI,tui-thoi-trang-nam,7804629,"Túi Đeo Chéo Ipad Unisex Fortune Mouse C860 (20 x 24 cm)",39000,39000,0,0
TIKI,tui-thoi-trang-nam,89786838,"Túi đeo chéo nam, túi bao tử vải dù cao cấp chống nước",147510,213070,65560,31
TIKI,tui-thoi-trang-nam,188897177,"Túi Đeo Chéo Nam Nữ Thời Trang Trẻ Trung, Túi Đựng Ipad, Túi Đeo Vai Nhiều Ngăn Kéo Đựng Đồ Rất Tiện Lợi, Vải Oxford Chống Thấm Nước",140000,140000,0,0
TIKI,tui-thoi-trang-nam,89176321,"Túi xách túi đeo chéo nam vải canvas cao cấp phong cách mới",351000,390000,39000,10
TIKI,tui-thoi-trang-nam,58215166,"Cặp công sở TRITA TCA1",329000,600000,271000,45
TIKI,tui-thoi-trang-nam,33120359,"Túi đeo chéo và bao tử da thời trang nhất",63000,89162,26162,29
TIKI,tui-thoi-trang-nam,45018395,"Túi đeo chéo nam nữ unisex thời trang BEE GEE 063",69000,138000,69000,50
TIKI,tui-thoi-trang-nam,11801361,"Túi đeo chéo nam hàn quốc HR227",650000,650000,0,0
TIKI,tui-thoi-trang-nam,191376138,"Bao da dành cho chìa khoá Honda HRV 2022 2023, HR-V all new L, RS handmade da thật 006",200000,200000,0,0
TIKI,tui-thoi-trang-nam,183558250,"Túi đeo chéo nam thời trang cao cấp chống thấm nước",351000,390000,39000,10
TIKI,tui-thoi-trang-nam,73775533,"Ví nam 100% da bò thật cao cấp phong cách mới",405000,450000,45000,10
TIKI,tui-thoi-trang-nam,96032651,"Ví Da Nam, Ví Dài Nam Cầm Tay Cao Cấp Jeep Kèm Dây Kéo Thời Trang",67082,96896,29814,31
TIKI,tui-thoi-trang-nam,58416419,"Ví Nam Cao Cấp KEIO NIPPON | Da Bò Nhập Khẩu Ý | Kích Thước 12 x 9,5 cm | Đựng GPLX Các Loại Cũ Mới, CMND , Cà Vẹt Xe",279000,279000,0,0
TIKI,tui-thoi-trang-nam,76687028,"Ví nam da bò cao cấp phong cách mới",359000,398000,39000,10
TIKI,tui-thoi-trang-nam,147423638,"Bao Bọc Hộ Chiếu - Passport Dẻo Trong Suốt",2999,2999,0,0
TIKI,tui-thoi-trang-nam,95004244,"Túi đeo chéo nam vải canvas cao cấp phong cách mới",269000,298000,29000,10
TIKI,tui-thoi-trang-nam,116724768,"Ví Nam Mini Nhỏ Gọn, Da Bò Mềm Mại GENTLE, Thiết Kế Hiện Đại, Nhiều Ngăn Đựng Tiền và Thẻ Tiện Dụng, Dáng Ngang - Gập 2 - Hàng Chính Hãng SAIGIO",783000,799000,16000,2
TIKI,tui-thoi-trang-nam,120469883,"Ví Nam Đứng, Da Bò Mềm Mại GENTLE, Size Lớn, Thiết Kế Cổ Điển Đơn Giản - Đẹp Mắt, Dáng Đứng - Gập 2, Ngăn Đựng Tiền Có Khóa Kéo, Nhiều Ngăn Để Giấy Tờ Tiện Dụng - Hàng Chính Hãng SAIGIO",781000,799000,18000,2
TIKI,tui-thoi-trang-nam,149521455,"{DA CÁ SẤU THẬT} Bóp Da Cá Sấu Nam Màu Nâu Da Bụng - Ví Nam Da Cá Sấu Có Khoá Kéo Cao Cấp Dáng Ngang Thời Trang",445000,890000,445000,50
TIKI,tui-thoi-trang-nam,181523715,"Ví Nam Cao Cấp, Da Bò NAPA Láng Mịn, Mỏng Nhẹ, Size Trung, Kiểu Cổ Điển Tinh Tế - Sang Trọng, Dáng Ngang - Gập 2, Nhiều Ngăn Để Tiền Và Giấy Tờ Tiện Dụng - Hàng Chính Hãng SAIGIO",1182000,1199000,17000,1
TIKI,tui-thoi-trang-nam,19670696,"Ví Da Nam Bản To - Clutch Cầm Tay Nam",150000,150000,0,0
TIKI,tui-thoi-trang-nam,88925675,"Túi xách nam công sở cao cấp",423000,470000,47000,10
TIKI,tui-thoi-trang-nam,145748036,"Ví Nam Da Bò Mềm Mại ONE LINE, Size Lớn, Thiết Kế Nhiều Ngăn Để Giấy Tờ, Có Khóa Kéo, Đựng Tiền và Thẻ Tiện Dụng, Dáng Ngang - Gập 2 - Hàng Chính Hãng SAIGIO",782000,799000,17000,2
TIKI,tui-thoi-trang-nam,117036103,"Ví Nam Cao Cấp, Da Bò NAPA Láng Mịn, Mỏng Nhẹ, Size Lớn, Kiểu Cổ Điển Tinh Tế - Sang Trọng, Dáng Ngang - Gập 2, Ngăn Đựng Tiền Có Khóa Kéo, Nhiều Ngăn Để Giấy Tờ Tiện Dụng - Hàng Chính Hãng SAIGIO",1179000,1199000,20000,2
TIKI,tui-thoi-trang-nam,52179955,"Ví nam da bò AT Leather - R02",209000,290000,81000,28
TIKI,tui-thoi-trang-nam,59103121,"Túi đeo chéo nam da bò cao cấp T08 26x23x7cm",275000,275000,0,0
TIKI,tui-thoi-trang-nam,162051575,"ví nam ví nam clutch cầm tay cao cấp",441000,490000,49000,10
TIKI,tui-thoi-trang-nam,193723534,"Túi Đeo Chéo, Túi Bao Tử Đa Năng, Mẫu Thể Thao Năng Động Chống Thấm Nước, Có 4 Ngăn Đựng Đồ Tiện Dụng",60000,60000,0,0
TIKI,tui-thoi-trang-nam,148801985,"Ví dài cầm tay da bò sáp ngựa điên Crazyhorse cao cấp C102 Bụi Leather - Bảo hành 12 tháng",259000,514000,255000,50
TIKI,tui-thoi-trang-nam,67175802,"Cặp da công sở đựng Laptop 14 inch da vân kèm 2 ngăn kép",275000,275000,0,0
TIKI,tui-thoi-trang-nam,192566295,"Bóp ví da nam cầm tay Classic vải Canvas trơn đựng thẻ nhỏ gọn phong cách đơn giản, thời trang",48000,96000,48000,50
TIKI,tui-thoi-trang-nam,96580691,"Túi đeo chéo nam da bò JEEP BULUO 26x21x6cm-EVA.STORES",179000,179000,0,0
TIKI,tui-thoi-trang-nam,148811049,"Ví dài cầm tay da bò Mill cao cấp Bụi Leather C107 - Bảo hành 12 tháng",490000,778000,288000,37
TIKI,tui-thoi-trang-nam,18003535,"Bóp ví nam đứng da bò thật V087K1 - Đen",125000,125000,0,0
TIKI,tui-thoi-trang-nam,59107698,"Túi đeo chéo nam da bò cao cấp T09 27x24x5cm",265000,265000,0,0
TIKI,tui-thoi-trang-nam,126765488,"Túi đeo chéo Fashion vải Canvas unisex nam nữ phong cách trẻ trung Hàn",55000,110000,55000,50
TIKI,tui-thoi-trang-nam,150873006,"Clutch, Ví Cầm Tay Thời Trang Nam Da Bò Khóa Vân Tay Cao Cấp RB06",2500000,2500000,0,0
TIKI,tui-thoi-trang-nam,125256490,"Ví nam, bóp nam da bò Saffiano Bụi Leather V126 - Bảo hành 12 tháng",229000,375000,146000,39
TIKI,tui-thoi-trang-nam,165699459,"Túi đeo chéo nam Vải canvas chỉ 2 chấm siêu nhẹ NH78 Shalla tặng bút cảm ứng",38599,40630,2031,5
TIKI,tui-thoi-trang-nam,148808284,"Ví dài cầm tay da bò Mill cao cấp Bụi Leather C104 - Bảo hành 12 tháng",450000,665000,215000,32
TIKI,tui-thoi-trang-nam,40514514,"Ví Da Nam Cầm Tay - Bóp Da Nam Cầm Tay Thời Trang Cao Cấp, Da Mền Có Khóa Số Thông Minh - KAW21 - Đen",230000,230000,0,0
TIKI,tui-thoi-trang-nam,125136680,"Ví nam, bóp nam da bò sáp Bụi Leather V106 - Bảo hành 12 tháng",209000,370000,161000,44
TIKI,tui-thoi-trang-nam,170501923,"Ví cầm tay dài nam  BST The Long Wallet chính hãng NATOLI nhiều ngăn chống nước sang trọng thời trang",469000,666000,197000,30
TIKI,tui-thoi-trang-nam,91447829,"Cặp Túi Da Nam C92",810000,810000,0,0
TIKI,tui-thoi-trang-nam,162100442,"Ví nam DEABOLAR phiên bản cao cấp nhiều ngăn tiện lợi",120500,120500,0,0
TIKI,tui-thoi-trang-nam,148850126,"Ví nam cầm tay Arctic Hunter Q00010 dáng dài dập vân có nút bấm",215000,350000,135000,39
TIKI,tui-thoi-trang-nam,27531795,"Túi Đeo Thắt Lưng Du Lịch Phong Cách Quân Đội",62000,87945,25945,30
TIKI,tui-thoi-trang-nam,108850224,"Ví nam thời trang da bò thật LATA LVN84",490000,490000,0,0
TIKI,tui-thoi-trang-nam,58734251,"Ví Nam Da Bò Cao Cấp SAM Leather- Bóp Da Saffiano SAM102",389000,389000,0,0
TIKI,tui-thoi-trang-nam,103047087,"Ví Đựng Thẻ Nam Nữ Da Epsom Handmade Lealux Mini Epsom Wallet 1",599000,599000,0,0
TIKI,tui-thoi-trang-nam,116497949,"[Da thật] Ví nam da bò thật 18 ngăn; Ví đứng nam da thật WS101LEA (Đen/Vàng bò) - 100% da bò thật",99000,99000,0,0
TIKI,tui-thoi-trang-nam,162584139,"Túi đeo ngực, đeo chéo nam đã tích hợp công nghệ 4.0 mã BG-7221",399000,699000,300000,43
TIKI,tui-thoi-trang-nam,924544,"Túi Đeo Chéo Nam HARAS HRTK147 (26 x 17 cm) - Đen",65000,65000,0,0
TIKI,tui-thoi-trang-nam,12038935,"Túi Đeo Chéo Nam Nữ 17x23x8cm",43999,43999,0,0
TIKI,tui-thoi-trang-nam,178313418,"Cặp Nam LATA CA09",650000,650000,0,0
TIKI,tui-thoi-trang-nam,43673298,"Ví cầm tay nam da cao cấp Dạng hộp bản to hình chuột túi trơn SD13 Shalla",142000,201597,59597,30
TIKI,tui-thoi-trang-nam,111868972,"Balo một dây đeo chéo Arctic Hunter XB00116 chất liệu Oxford chống thấm nước, unisex nam nữ,trang bị cổng sạc USB",515000,849000,334000,39
TIKI,tui-thoi-trang-nam,148850138,"Ví nam cầm tay Arctic Hunter Q00011 dáng dài, dập vân khóa kéo zip YKK sang trọng",230000,415000,185000,45
TIKI,tui-thoi-trang-nam,149179571,"Túi đeo chéo nam da bò cao cấp YILIDAISHU T33 27x24x6cm(Nâu - Đen) D.HSTORE",750000,750000,0,0
TIKI,tui-thoi-trang-nam,134222430,"Túi đeo chéo nam nữ thời trang BEE GEE 0129 để điện thoại ipad chống thấm nước đẹp chất lượng tốt",69000,138000,69000,50
TIKI,tui-thoi-trang-nam,38504524,"Túi Phụ Kiện  Đeo Hông ,Đựng Điện Thoại ,  LT01",62000,87945,25945,30
TIKI,tui-thoi-trang-nam,143100393,"Ví nam da bò Anh Tho Leather 065",355000,420000,65000,15
TIKI,tui-thoi-trang-nam,77703745,"Túi Đeo bao tử, nịt bụng đeo chéo đa năng ngang kéo tian l21 Tăng móc khóa nam cao cấp",75000,106887,31887,30
TIKI,tui-thoi-trang-nam,183377459,"Túi xách nam công sở, cặp da nam đựng laptop và tài liệu cao cấp GCE12",2750000,2750000,0,0
TIKI,tui-thoi-trang-nam,96010866,"Ví Dài Cầm Tay Nam Nữ Thời Trang Baellerry (2 khóa )",129000,129000,0,0
TIKI,tui-thoi-trang-nam,213568504,"Ví nam mini kiểu đứng bóp nam đựng tiền 3 màu thời trang nhỏ gọn DN9150",125000,250000,125000,50
TIKI,tui-thoi-trang-nam,4699077,"Cặp đa năng văn phòng chỉ xéo",178000,251624,73624,29
TIKI,tui-thoi-trang-nam,141009896,"Túi đeo chéo nam cao cấp, vải Oxford chống nhăn,chống thấm nước,chống bám bụi, túi đeo vai phong cách thời trang Châu Âu",399000,399000,0,0
TIKI,tui-thoi-trang-nam,78950876,"Túi xách nam công sở 100% da bò thật cao cấp phong cách mới",899000,998000,99000,10
TIKI,tui-thoi-trang-nam,94038063,"Túi đeo hông nam nữ Túi đeo chéo chạy bộ Túi thể thao dã ngoại Sport TTC1 kích thước 31 x11 x 19 cm",34303,49549,15246,31
TIKI,tui-thoi-trang-nam,56512790,"Ví nam cầm tay cao cấp",129000,129000,0,0
TIKI,tui-thoi-trang-nam,3282989,"Túi đeo chéo da nam [HÀNG NHẬP] DTN12-2TI",76000,76000,0,0
TIKI,tui-thoi-trang-nam,75319988,"Túi đeo chéo unisex thời trang HARAS HR276",80000,80000,0,0
TIKI,tui-thoi-trang-nam,68658966,"Túi đeo chéo vải bố thời trang 2001",170000,170000,0,0
TIKI,tui-thoi-trang-nam,186210607,"Túi xách nam công sở, cặp da nam đựng laptop và tài liệu cao cấp CGL10",3400000,3400000,0,0
TIKI,tui-thoi-trang-nam,125097857,"Ví nam, bóp nam da bò sáp Bụi Leather V105 - Bảo hành 12 tháng",209000,370000,161000,44
TIKI,tui-thoi-trang-nam,89837896,"Ví nam cầm tay da bò Gianni Conti VP0169DBR",4100000,4100000,0,0
TIKI,tui-thoi-trang-nam,138802053,"Túi bao tử nam đeo chéo nam nữ du lịch tiện ích unisex thời trang Bee Gee 130 siêu đẹp chống thấm nước",70000,140000,70000,50
TIKI,tui-thoi-trang-nam,54001669,"Đeo chéo hông bụng nam nữTĐ 5528 dạng lớn hàn quốc HGF01",114000,161345,47345,29
TIKI,tui-thoi-trang-nam,51662045,"Túi Đeo Chéo Nam Da Cá Sấu CS1",219000,219000,0,0
TIKI,tui-thoi-trang-nam,771415,"Túi Đeo Chéo Nam Haras HRTK083 (26 x 17 cm) - Xanh",65000,65000,0,0
TIKI,tui-thoi-trang-nam,125280023,"Ví nam, bóp nam da bò Saffiano Bụi Leather V128 - Bảo hành 12 tháng",229000,412000,183000,44
TIKI,tui-thoi-trang-nam,103887358,"Bóp Da Cá Sấu Ví Nam Cá Sấu Phần Bụng Cao Cấp Giá Rẻ Màu Nâu ST04 Tặng Kèm Hộp Tặng Móc Khóa Cá Sấu",750000,750000,0,0
TIKI,tui-thoi-trang-nam,83830072,"Túi xách nam 100% da bò thật cao cấp phong cách mới 15.6inh",621000,690000,69000,10
TIKI,tui-thoi-trang-nam,190514895,"Túi đeo chéo nam nữ thể thao chạy bộ Haosua cao cấp Shalla",128828,186085,57257,31
TIKI,tui-thoi-trang-nam,176130327,"Bóp ví nam có khóa kéo thời trang tiện lợi kiểu dáng hàn quốc ví nam cầm tay cao cấp Mã: MB21",178000,178000,0,0
TIKI,tui-thoi-trang-nam,70846687,"Túi đeo chéo nam nữ unisex thời trang Hàn quốc BEE GEE 098 để được laptop và áo quần",99500,199000,99500,50
TIKI,tui-thoi-trang-nam,190514977,"Túi đeo chéo Chống nước PVC cao cấp đường xéo góc HÀNG NHẬP VB67",175735,184984,9249,5
TIKI,tui-thoi-trang-nam,130070341," Túi đeo chéo nam nữ phong cách lính",137000,137000,0,0
TIKI,tui-thoi-trang-nam,147799009,"Ví Da Nam Bò Sáp Nhiều Ngăn Tiện Dụng Kiểu Dáng Sang Trọng Nam Tính",168000,336000,168000,50
TIKI,tui-thoi-trang-nam,111869000,"Túi đeo chéo Arctic Hunter XB00105 chất liệu Oxford chống thấm nước, unisex nam nữ,trang bị cổng sạc USB tiện dụng",359000,635000,276000,43
TIKI,tui-thoi-trang-nam,160406240,"Ví da nam da bò thật 100% loại nhỏ có khe để thẻ phía ngoài",149000,149000,0,0
TIKI,tui-thoi-trang-nam,189491562,"Túi đeo chéo nam DA THẬT cao cấp phong cách mới – BEE GEE DCN9071",1250000,2500000,1250000,50
TIKI,tui-thoi-trang-nam,68887596,"Túi đeo chéo nam vải Oxford chống thấm",699000,699000,0,0
TIKI,tui-thoi-trang-nam,107962047,"Ví Nam Da Bò Thật Dáng Đứng Đẳng Cấp Quý Ông",259000,259000,0,0
TIKI,tui-thoi-trang-nam,13565884,"Túi bao tử đeo chéo nam",180000,180000,0,0
TIKI,tui-thoi-trang-nam,164338780,"Bóp Nam, Ví Nam P016 – Thiết Kế Độc Đáo – Sang trọng – Tiện Dụng",58000,58000,0,0
TIKI,tui-thoi-trang-nam,28730009,"Ví nam dài cầm tay  Lesin N1 Shalla Tặng móc khóa cao cấp",188288,198198,9910,5
TIKI,tui-thoi-trang-nam,146987945," Ví Da Nam Nhiều Ngăn VD04 Kiểu Đứng Đơn Giản Cá Tính",38000,50000,12000,24
TIKI,tui-thoi-trang-nam,179013848,"Ví nam da cầm tay cao cấp bản to siêu mỏng Dạng hộp kẹp jeeps DTI21",59001,85224,26223,31
TIKI,tui-thoi-trang-nam,175573951,"Túi đeo chéo tiện dụng, sang trọng phong cách trẻ trung Hàn Quốc– DCN9048",360000,720000,360000,50
TIKI,tui-thoi-trang-nam,213580713,"Ví nam mini bỏ túi nhiều ngăn da PU cao cấp 2 màu đen nâu lịch lãm D622",110000,220000,110000,50
TIKI,tui-thoi-trang-nam,73274050,"Ví nam da bò AT Leather 046",360000,425000,65000,15
TIKI,tui-thoi-trang-nam,61305963,"Ví Nam Cầm Tay SAM Leather – Ví Dài Nam Da Saffiano cao cấp SAM202",1890000,1890000,0,0
TIKI,tui-thoi-trang-nam,168227846,"Túi Đeo Chéo Nam Da Bò Jeep (26 x 23 cm) kèm ảnh thật 100",195000,195000,0,0
TIKI,tui-thoi-trang-nam,146979783,"Ví Da Nam Cao Cấp VD04 Kiểu Đứng Quý Ông Lịch Lãm",38000,50000,12000,24
TIKI,tui-thoi-trang-nam,196187235,"Ví Da Nam VD06 Kiểu Đứng Nhỏ Gọn 2 Màu Nâu, Đen",38000,50000,12000,24
TIKI,tui-thoi-trang-nam,68969225,"Túi Đeo Chéo Nam P107 -Năng Động – Phong Cách – Thời Trang",192000,299000,107000,36
TIKI,tui-thoi-trang-nam,56345077,"Túi đeo ngực,đeo chéo nam phong cách hiện đại mới",405000,450000,45000,10
TIKI,tui-thoi-trang-nam,17715721,"Túi đựng điện thoại da PU đeo ngang hông kiểu dọc T8 gài nút giữa",44000,62779,18779,30
TIKI,tui-thoi-trang-nam,146989075,"Ví Da Nam VD05 Dáng Ngang Sang Trọng Hiện Đại",38000,50000,12000,24
TIKI,tui-thoi-trang-nam,168227038,"Ví Da Nam Cầm Tay, Bóp Da Nam Cầm Tay Thời Trang Cao Cấp, Da Mền Có Khóa Số Thông Minh TẶNG KÈM TAI NGHE",260000,260000,0,0
TIKI,tui-thoi-trang-nam,137500213,"Túi Đeo Chéo Túi Bao Tử Đẹp Bằng Da Bò Thật Cao Cấp Bảo Hành Ba Năm CB303-07",199000,199000,0,0
TIKI,tui-thoi-trang-nam,5762417,"Túi đeo ipad thời trang HARAS HRLT226",150000,150000,0,0
TIKI,tui-thoi-trang-nam,25747229,"Ví Da Bò giả vân cá sấu, Đựng Chìa Khóa ô tô, Xe Máy",180000,180000,0,0
TIKI,tui-thoi-trang-nam,127551467,"Túi đeo chéo da cao cấp tích hợp dây sạc USB, 4 ngăn unisex nam nữ chống nước thời trang hot trend",80000,160000,80000,50
TIKI,tui-thoi-trang-nam,48514463,"Túi đeo ngực nam A.17x23x8 cm",49000,49000,0,0
TIKI,tui-thoi-trang-nam,213675004,"Ví nam mini Bóp da nam kiểu đứng có ngăn khóa tiện lợi D208",110000,220000,110000,50
TIKI,tui-thoi-trang-nam,32801506,"Túi xách công sở nam dọc cao cấp chống thấm nước DH8817 + Tặng 1 ví da cao cấp",315000,315000,0,0
TIKI,tui-thoi-trang-nam,193720407,"TÚI ĐEO CHÉO THÊU HOA VĂN THƯƠNG HIỆU CAO CÁP",400000,400000,0,0
TIKI,tui-thoi-trang-nam,196332946,"Ví Da Nam Cao Cấp VD07 Ví Cầm Tay Tinh Tế Thể Hiện Phong Cách Thời Trang Sang Trọng",48000,60000,12000,20
TIKI,tui-thoi-trang-nam,31933788,"Túi Đeo Hông Rằn Ri Phong Cách Quân Đội ARMY",50000,70356,20356,29
TIKI,tui-thoi-trang-nam,32842786,"Túi xách da nam công sở cao cấp DS1801",199000,199000,0,0
TIKI,tui-thoi-trang-nam,10383586,"Ví Đựng Card",76500,76500,0,0
TIKI,tui-thoi-trang-nam,141656949,"Ví Da Cá Sấu Da Bụng, Màu Đen | Ví Da Cá Sấu 2 Mặt | Đẳng Cấp Phái Mạnh",695000,695000,0,0
TIKI,tui-thoi-trang-nam,143061372,"Ví nam da bò Anh Tho Leather 080",246000,290000,44000,15
TIKI,tui-thoi-trang-nam,148000042,"Ví Da Nam Cao Cấp VD05 Dáng Ngang Kiểu Dáng Thời Thượng",38000,50000,12000,24
TIKI,tui-thoi-trang-nam,28707675,"Túi đeo chéo nam Taluhu Jingpinbag Đen Xám - Hàng nhập khẩu",150000,150000,0,0
TIKI,tui-thoi-trang-nam,32607157,"Clutch cầm tay da bò  thô nguyên tấm đa năng - BHAP01Túi đéo chéo nam. Hàng chính hãng.",850000,850000,0,0
TIKI,tui-thoi-trang-nam,69139562,"Ví Nam Da Bò Cao Cấp Mang May Mắn Tài Lộc Cho Chủ Sở Hữu",99000,99000,0,0
TIKI,tui-thoi-trang-nam,67017829,"Cặp da công sở đựng Laptop 14 inch kèm ngăn phụ ngang cao cấp",325000,325000,0,0
TIKI,tui-thoi-trang-nam,109888828,"Bóp Ví Ngắn Gập Ba TRI-FOLD Da Nhập Khẩu Cao Cấp Chống Thấm Nước Unisex Nam Nữ DOLANTO",258000,258000,0,0
TIKI,tui-thoi-trang-nam,17614864,"Cặp Xách Công Sở Unisex CNT'S CA17",272000,272000,0,0
TIKI,tui-thoi-trang-nam,206250322,"Ví cầm tay nam - ví nam cao cấp Full hộp WilliamPOLO -  V29",655000,655000,0,0
TIKI,tui-thoi-trang-nam,144193746,"Ví Da Nam VD03 Kiểu Ngang Thiết Kế Thời Trang Đẳng Cấp",75000,150000,75000,50
TIKI,tui-thoi-trang-nam,77038094,"Ví dài Venuta2 Handcrafted Wallet HAVIAS",476000,595000,119000,20
TIKI,tui-thoi-trang-nam,99629176,"Túi đeo chéo/đeo vai công sở nam phong cách Hàn Quốc",255000,255000,0,0
TIKI,tui-thoi-trang-nam,125396531,"Túi Đeo Chéo Nam Mini BT06 Hiện Đại Ngăn To Ngăn Vừa Ngăn Bé Đựng Được Nhiều Đồ",235000,450000,215000,48
TIKI,tui-thoi-trang-nam,110098827,"Ví nam Đông Hải da bò cao cấp thiết kế dạng gập nhỏ gọn - KT06",590000,590000,0,0
TIKI,tui-thoi-trang-nam,116877991,"Ví Cá Sấu Gù To 2 Mặt, Ví Nam Cá Sấu Dáng Ngang, Màu Đen, Nâu Cafe",650000,650000,0,0
TIKI,tui-thoi-trang-nam,153265039,"Túi đeo chéo Vui Nhộn Hoạt Hình Mstaly-MBCR Mẫu mới Shalla",50129,52767,2638,5
TIKI,tui-thoi-trang-nam,149180017,"Túi xách da công sở cao cấp JEEP BULUO T05-2 (KT 39x29x8cm)",666000,666000,0,0
TIKI,tui-thoi-trang-nam,147993769,"Ví Da Nam VD02 Kiểu Ngang Trẻ Trung Phong Cách",168000,336000,168000,50
TIKI,tui-thoi-trang-nam,102498855,"Bóp ví Alan Walker cầm tay đựng đồ nhỏ gọn, nhiều ngăn thời trang cá tính trẻ trung",109000,109000,0,0
TIKI,tui-thoi-trang-nam,97729163," Ví nam PIDENGBAO tiện ích nhỏ gọn",137800,137800,0,0
TIKI,tui-thoi-trang-nam,19707058,"Túi đeo hông, túi đeo bụng nam nữ",65000,65000,0,0
TIKI,tui-thoi-trang-nam,72888449,"Ví bọc hộ chiếu Passport chất liệu da cover hoạt hình "I Love You"",60000,75000,15000,20
TIKI,tui-thoi-trang-nam,84774464,"Túi bao tử - túi đeo chéo - túi đeo bụng nam nữ da bò thật SEAGLE SGB01",424000,424000,0,0
TIKI,tui-thoi-trang-nam,25042474,"Ví đứng nam da bò Marrant - BHL188",222000,222000,0,0
TIKI,tui-thoi-trang-nam,35572627,"Ví Da Bò T078",219000,219000,0,0
TIKI,tui-thoi-trang-nam,75832656,"Ví dài cầm tay mẫu mới nam nữ Lesin cao cấp N56 Tặng móc khóa hình búa siêu ngầu",191706,201796,10090,5
TIKI,tui-thoi-trang-nam,54749745,"Ví nam da bò nhập khẩu H01",179000,380000,201000,53
TIKI,tui-thoi-trang-nam,193607571,"Túi đeo chéo nam đa năng cao cấp phong cách mới",180000,199000,19000,10
TIKI,tui-thoi-trang-nam,193104706,"Ví nam đứng da bò cao cấp TRITA RVN18",189000,390000,201000,52
TIKI,tui-thoi-trang-nam,111537503,"Ví nam da bò cao cấp phong cách mới",351000,390000,39000,10
TIKI,tui-thoi-trang-nam,49549841,"Ví nam thời trang da thật LATA LVN58",289000,360000,71000,20
TIKI,tui-thoi-trang-nam,111126449,"[Da thật] Ví nam da bò thật; Ví nam ngang da sáp phối màu (Nâu Grey)- 100% da bò thật",155000,155000,0,0
TIKI,tui-thoi-trang-nam,121334938,"Ví da namecard LATA Luxdeli LVN102",180000,180000,0,0
TIKI,tui-thoi-trang-nam,108850884,"Ví nam da bò thật cao cấp TRITA RVN08 ví ngang đựng tiền và thẻ card",189000,380000,191000,50
TIKI,tui-thoi-trang-nam,75478590,"Túi Đeo Chéo Nam Nữ Chất Da Pu Cao Cấp Phong Cách Cá Tính Năng Động, Cá Tính",117000,163713,46713,29
TIKI,tui-thoi-trang-nam,22145346,"Túi hộp đeo chéo nam vải dù chống thấm nước T1084",169000,169000,0,0
TIKI,tui-thoi-trang-nam,58255618,"Ví nam da thật TRITA RVN04",189000,380000,191000,50
TIKI,tui-thoi-trang-nam,177017362,"Túi đeo chéo đeo vai nam vải canvas cao cấp phong cách mới",387000,430000,43000,10
TIKI,tui-thoi-trang-nam,130471908,"Túi Đeo Chéo Nam Vải CanVas Chống Thấm Nước, Nhiều Ngăn Chứa Đồ, Túi Đeo Vai Nam Vải Bố Bền Đẹp_Túi Đi Chơi, Đi Làm Phong Cách Thời Trang Hiện Đại",325000,325000,0,0
TIKI,tui-thoi-trang-nam,158610488,"CITIZEN Business Card Holder, Ví Đựng Thẻ ATM Cao Cấp, Dành Cho Doanh Nhân, Thiết Kế Hiện Đại - Sang Trọng, Chất Liệu Da Bò Vachetta Thuộc Thảo Mộc, Nhập Khẩu Từ Châu Âu, Hoàn Thiện Tỉ Mỉ - Tinh Tế Từng Chi Tiết - Hàng Chính Hãng SAIGIO ",2479000,2499000,20000,1
TIKI,tui-thoi-trang-nam,90519788,"Túi đeo chéo đeo ngực nam cao cấp phong cách châu âu",585000,650000,65000,10
TIKI,tui-thoi-trang-nam,146618296,"Bóp Da Đựng Thẻ ATM Nhỏ Gọn, Chất Da Pull-Up Mềm Mại, Trẻ Trung - Cá Tính, Thiết Kế Hiện Đại, Nhiều Ngăn Tiện Dụng, Đựng Thẻ Ngân Hàng, Card Danh Thiếp, Căn Cước Công Dân, Hình Lưu Niệm, Dáng Đứng - Gập 2 - Hàng Chính Hãng SAIGIO",779000,799000,20000,3
TIKI,tui-thoi-trang-nam,107962265,"Ví Nam Mini Da Bò SÁP Dáng Đứng SVN Leather Fullbox",189000,189000,0,0
TIKI,tui-thoi-trang-nam,50491493,"Túi đeo ngực,đeo chéo nam đã tích hợp công nghệ 4.0",621000,690000,69000,10
TIKI,tui-thoi-trang-nam,711036,"Túi Đeo Chéo Nam HARAS HRTK105 (27 x 17 cm) - Đen",65000,65000,0,0
TIKI,tui-thoi-trang-nam,59234311,"Ví nam vuông cao cấp hình mắt cú thời thời trang",72301,76106,3805,5
TIKI,tui-thoi-trang-nam,46789932,"Bóp Ví Da Nam In Nổi Chữ B-Thiết Kế Trẻ Trung Lịch Lãm HN020",156000,156000,0,0
TIKI,tui-thoi-trang-nam,93712433,"ví nam - ví nam cầm tay cao cấp",269000,298000,29000,10
TIKI,tui-thoi-trang-nam,191376194,"Bao da dành cho Chìa Khóa Honda Lead 2022, AirBlade 2023, Winner X 2022, PCX 160, Vario 160, AB 125, AB 160 2023 handmade da thật",99000,99000,0,0
TIKI,tui-thoi-trang-nam,83691185,"Túi xách cặp da đựng laptop công sở",365000,365000,0,0
TIKI,tui-thoi-trang-nam,149765324,"Túi Xách, Cặp Da Thời Trang Công Sở Nam Cao Cấp Khóa Số CGL07",3200000,3200000,0,0
TIKI,tui-thoi-trang-nam,109103074,"Túi đeo chéo bao tử thời trang nam chống thấm nước cao cấp",71000,100122,29122,29
TIKI,tui-thoi-trang-nam,59282088,"Túi đeo chéo đa năng LATA TN16",450000,450000,0,0
TIKI,tui-thoi-trang-nam,252795368,"[Da thật] Clutch cầm tay nam da bò thật CL126LS (Đen/Nâu sáng/Nâu sẫm) - 100% da bò thật, BH 3 năm",539000,539000,0,0
TIKI,tui-thoi-trang-nam,52789068,"[ KEIO NIPPON ] Bóp Ví Đứng Da Bò Thật Cao Cấp | Ví Nam Mỏng ",159000,159000,0,0
TIKI,tui-thoi-trang-nam,151460338,"[Da thật] Túi đeo chéo nam da bò thật TD115LEA (Đen/ Vàng bò) - 100% da thật",390000,390000,0,0
TIKI,tui-thoi-trang-nam,186243889,"Túi đeo chéo nam vải canvas cao cấp phong cách mới",333000,370000,37000,10
TIKI,tui-thoi-trang-nam,96243197,"Túi xách cặp da công sở vân cá sấu đựng laptop 14inch T80 35x29x6cm(Nâu-Đen)",329000,329000,0,0
TIKI,tui-thoi-trang-nam,188997107,"Bao da dành cho chìa khoá toyota Camry, Fortuner, Land Cruiser, Hilux handmade da thật 009",200000,200000,0,0
TIKI,tui-thoi-trang-nam,205232933,"Bao da dành cho bọc ốp chìa khoá xe ô tô Toyota Camry 2019 2022 da bò nhiều màu khâu thủ công To28CR",170000,170000,0,0
TIKI,tui-thoi-trang-nam,93843376,"Túi đeo chéo đeo ngực nam cao cấp phong cách châu âu",783000,870000,87000,10
TIKI,tui-thoi-trang-nam,271887160,"Clutch da bò cao cấp MARRANT - BHM8986 Ví da cầm tay cao cấp. Hàng chính hãng",899000,899000,0,0
TIKI,tui-thoi-trang-nam,185946011,"Túi đeo chéo nam đa chức năng cao cấp phong cách cá tính mới",621000,690000,69000,10
TIKI,tui-thoi-trang-nam,143384978,"Ví Nam Cao Cấp, Da Bò PEBBLE Mềm Mại - Bền Bỉ, Size Lớn, Chống Xước - Chống Nhăn Tốt,  Thiết Kế Cổ Điển, Dáng Ngang - Gập 2, Ngăn Đựng Tiền Có Khóa Kéo, Nhiều Ngăn Để Giấy Tờ Tiện Dụng - Hàng Chính Hãng SAIGIO",1132000,1149000,17000,1
TIKI,tui-thoi-trang-nam,113760273,"Ví nam da bò cao cấp phong cách mới",387000,430000,43000,10
TIKI,tui-thoi-trang-nam,183330035,"Túi đeo chéo đeo vai nam 100% da bò  thật cao cấp phong cách châu âu",675000,750000,75000,10
TIKI,tui-thoi-trang-nam,2000483,"Ví Nam Da Cá Sấu Nguyên Con Nhỏ Huy Hoàng HT2225 (12.5 x 10 cm) - Đen",1299000,1299000,0,0
TIKI,tui-thoi-trang-nam,8456938,"Ví đứng nam da bò gấp 3 V8105",155000,155000,0,0
TIKI,tui-thoi-trang-nam,191044555,"ví nam ví nam clutch cầm tay cao cấp",288000,320000,32000,10
TIKI,tui-thoi-trang-nam,56398310,"Ví nam da bò cao cấp phong cách mới hiện đại",359000,398000,39000,10
TIKI,tui-thoi-trang-nam,47477869,"Túi xách đeo chéo nam nữ phản quang phong cách Hàn Quốc Mituza TX36",32000,44649,12649,28
TIKI,tui-thoi-trang-nam,193308675,"Túi Đeo Chéo Vải Nylon Nhiều Ngăn Chứa Cho Nam Nữ Cao Cấp Đi Chơi Chống Nước, Túi Đựng Điện Thoại, Túi Đeo Vai Thời Trang Sang Trọng Thời Thượng",125000,125000,0,0
TIKI,tui-thoi-trang-nam,78946196,"Ví nam cầm tay 100% da bò thật cao cấp phong cách mới",513000,570000,57000,10
TIKI,tui-thoi-trang-nam,159631049,"Túi đeo chéo DIVOOM Pixoo Slingbag-V hiển thị màn hình LED, có thể đựng Laptop/iPad 11 inch - Hàng chính hãng",2300000,2300000,0,0
TIKI,tui-thoi-trang-nam,106053325,"Bóp da nam, ví nam, ví da bò thật 100%, chuẩn đẹp xịn xò A142V",125000,125000,0,0
TIKI,tui-thoi-trang-nam,73361438,"VÍ NGẮN GẬP DA Bóp COSMOS Da Saffiano Nhập Khẩu Cao Cấp Chống Thấm Nước Unisex Nam Nữ Chuẩn Leonardo DOLANTO",220000,220000,0,0
TIKI,tui-thoi-trang-nam,197879894,"Bóp Đứng Nam Nhỏ Gọn, Chất Liệu Da Bò PULL-UP Mềm Mại, Mỏng Nhẹ, Phong Cách Hiện Đại - Cá Tính, Size Trung, Dáng Đứng - Gập 2, Nhiều Ngăn Để Tiền Và Giấy Tờ Tiện Dụng",982000,999000,17000,2
TIKI,tui-thoi-trang-nam,58223048,"Ví nam da thật TRTA RVN001",189000,380000,191000,50
TIKI,tui-thoi-trang-nam,59086244,"Túi xách cặp da đựng laptop da bò công sở T03 38x28x6cm",199000,199000,0,0
TIKI,tui-thoi-trang-nam,183046677,"Ví nam 100% da bò thật  cao cấp phong cách mới",171000,190000,19000,10
TIKI,tui-thoi-trang-nam,100320879,"Ví Handmade Nam KEIO NIPPON Da Bò Epsom Cao Cấp / Bóp Nam Da Bò May Thủ Công",249000,249000,0,0
TIKI,tui-thoi-trang-nam,54420877,"Túi đeo chéo,đeo ngực nam đã tích hợp công nghệ 4.0",621000,690000,69000,10
TIKI,tui-thoi-trang-nam,193004750,"Túi đeo chéo nam, túi bao tử nam Mars Bụi Leather DC109 - Da bò thật cao cấp - Bảo hành 12 tháng",429000,605000,176000,29
TIKI,tui-thoi-trang-nam,711402,"Túi Đeo Chéo Nam HARAS HRTK127 (32 x 18 cm) - Đen",150000,150000,0,0
TIKI,tui-thoi-trang-nam,155340658,"Ví mini nam da bò sáp ngựa điện Crazyhorse V125 cao cấp, bóp đựng thẻ da thật, đường chỉ tinh tế, ví nam nhỏ gọn dáng đứng, fullbox, thương hiệu Bụi leather chuyên đồ da thật",180000,200000,20000,10
TIKI,tui-thoi-trang-nam,41664315,"Cặp công sở thời trang YUUMY CAYUUMY 11",245000,490000,245000,50
TIKI,tui-thoi-trang-nam,179207900,"Túi Đeo Chéo Nam TK07 - Túi Đeo Chéo Hàn Quốc - Túi Đeo Trước Ngực - Túi Bao Tử",99000,99000,0,0
TIKI,tui-thoi-trang-nam,11586535,"Túi Đeo Chéo, Túi Đeo Chéo Nam Da Bò Jeep (26 x  23 cm)",152000,152000,0,0
TIKI,tui-thoi-trang-nam,49689354,"Ví Da Cầm Tay Sang Trọng Tinh Tế Cả Nam Và Nữ - Bóp Da Nam Đựng Tiền Đẹp Siêu Mỏng Nhiều Ngăn - DK08",99000,99000,0,0
TIKI,tui-thoi-trang-nam,52585327,"[ KEIO NIPPON ] Ví Nam Da Bò Saffiano Cao Cấp Nhập Khẩu | Bóp Ví Đứng Nam Nữ",249000,249000,0,0
TIKI,tui-thoi-trang-nam,213580920,"Ví da nam kiểu đứng bóp nam mini cao cấp lịch lãm BOSUMY-730",110000,220000,110000,50
TIKI,tui-thoi-trang-nam,58227879,"Ví nam da thật TRITA RVN002",189000,380000,191000,50
TIKI,tui-thoi-trang-nam,119132514,"Ví đựng namecard Trita Liberal RVN11",55000,150000,95000,63
TIKI,tui-thoi-trang-nam,161954755,"Túi Xách Nam Công Sở Gence Da Bò Cao Cấp CTS12 Khóa Số",3200000,3200000,0,0
TIKI,tui-thoi-trang-nam,145413858,"Túi đeo chéo da nam đa năng LATA TN21",369000,390000,21000,5
TIKI,tui-thoi-trang-nam,187621731,"Ví Passport Da Bò PEBBLE Mềm Mại - Bền Bỉ, Chống Xước - Chống Nhăn Tốt, Thiết Kế Hiện Đại - Đa Năng, Đựng Được Nhiều Loại Hộ Chiếu, Nhiều Ngăn Thẻ ATM, Đựng Tiền, Vé Máy Bay, Tiện Dụng Khi Đi Du Lịch, Công Tác - Hàng Chính Hãng SAIGIO",1229000,1249000,20000,2
TIKI,tui-thoi-trang-nam,121173964,"Bóp Nam Da Bò VINTAGE Hoài Cổ, Chất Da Mềm Mại - Vân Tự Nhiên, Size Lớn, Thiết Kế Cổ Điển, Đơn Giản - Mỏng Nhẹ, Dáng Ngang - Gập 2, Ngăn Đựng Tiền Có Khóa Kéo, Nhiều Ngăn Để Giấy Tờ Tiện Dụng - Hàng Chính Hãng SAIGIO",879000,899000,20000,2
TIKI,tui-thoi-trang-nam,82984240,"Ví Da Nam Cầm Tay Sang Trọng - Phong Cách - Đẳng Cấp",196983,207350,10367,5
TIKI,tui-thoi-trang-nam,52528468,"Túi đeo chéo nam phong cách châu âu",225000,250000,25000,10
TIKI,tui-thoi-trang-nam,173542482,"Ví Da Bò Nam Bóp Da Nam Cao Cấp Hàng Hiệu POLO MEISDO (Da Thật 100%) Full Hộp Phù Hợp Làm Quà Biếu Tặng Sinh Nhật",1300000,1300000,0,0
TIKI,tui-thoi-trang-nam,189703069,"Túi đeo chéo nam thời trang chính hãng YVan 1503",385000,385000,0,0
TIKI,tui-thoi-trang-nam,5077161,"Ví nam cầm tay Timall BLR23 phong cách châu Âu",99000,99000,0,0
TIKI,tui-thoi-trang-nam,93842772,"Túi đeo chéo đeo ngực nam cao cấp phong cách mới",621000,690000,69000,10
TIKI,tui-thoi-trang-nam,77741652,"Túi đeo chéo cao cấp phong cách châu âu",585000,650000,65000,10
TIKI,tui-thoi-trang-nam,594977,"Ví Dài Nam Baellerry Sang Trọng Đẳng Cấp GL WL1006",87000,123123,36123,29
TIKI,tui-thoi-trang-nam,166227487,"[VOUCHER 30K] Túi da nam đeo chéo dáng ngang LATA TN27",620000,620000,0,0
TIKI,tui-thoi-trang-nam,184316710,"Túi đeo chéo nam vải canvas cao cấp phong cách mới",360000,399000,39000,10
TIKI,tui-thoi-trang-nam,161538053,"Ví Cầm Tay Nam Gence Da Bò Cao Cấp RB06 Khóa Vân Tay",2750000,2750000,0,0
TIKI,tui-thoi-trang-nam,43872903,"Cặp da công sở LATA CA27",569000,690000,121000,18
TIKI,tui-thoi-trang-nam,49517956,"Ví nam thời trang da thật LATA LVN53",290000,580000,290000,50
TIKI,tui-thoi-trang-nam,193614818,"Túi đeo chéo nam đa năng cao cấp phong cách mới",207000,230000,23000,10
TIKI,tui-thoi-trang-nam,70882597,"Bóp Nam Ví Nam Cao Cấp Đa Năng (VI-009)",109500,109500,0,0
TIKI,tui-thoi-trang-nam,43395324,"Túi Đeo Chéo Nam Bằng Da Cao Cấp Retro (27 x 15cm) _ Tặng Kèm Móc Khóa Dây da",55000,55000,0,0
TIKI,tui-thoi-trang-nam,170523409,"Ví dài cầm tay nam The Zipper Wallet chính hãng NATOLI đựng thẻ điện thoại nhiều ngăn cao cấp",489000,698000,209000,30
TIKI,tui-thoi-trang-nam,176939287,"Ví nam 100% da bò thật cao cấp phong cách mới",387000,430000,43000,10
TIKI,tui-thoi-trang-nam,192398346,"Túi đeo chéo đeo trước ngực nam đa năng cao cấp phong cách mới",297000,330000,33000,10
TIKI,tui-thoi-trang-nam,192129582,"Túi xách nam công sở da PU màu trơn thanh lịch có khóa số chính hãng YVan F80175-5",620000,620000,0,0
TIKI,tui-thoi-trang-nam,190109508,"Ví Nam Mini Nhỏ Gọn Cao Cấp, Da Bò SMALL PEBBLE Mềm Mại - Bền Bỉ, Chống Xước - Chống Nhăn Tốt, Thiết Kế Đơn Giản, Dáng Ngang - Gập 2, Đựng Tiền và Thẻ ATM Tiện Dụng",882000,899000,17000,2
TIKI,tui-thoi-trang-nam,181561656,"Bóp Nam Cao Cấp, Chất Liệu Da Bò PULL-UP Mềm Mại, Mỏng Nhẹ, Phong Cách Hiện Đại - Cá Tính, Size Trung, Dáng Ngang - Gập 2, Nhiều Ngăn Để Tiền Và Giấy Tờ Tiện Dụng - Hàng Chính Hãng SAIGIO",981000,999000,18000,2
TIKI,tui-thoi-trang-nam,44085748,"Túi Đeo bao tử, nịt bụng đeo chéo đa năng ngang kéo tian l21",75000,106887,31887,30
TIKI,tui-thoi-trang-nam,193106908,"Ví nam da bò thật dáng ngang cao cấp TRITA RVN21",189000,390000,201000,52
TIKI,tui-thoi-trang-nam,13642459,"Túi đeo vai nam BEE GEE 06 XAM",79000,158000,79000,50
TIKI,tui-thoi-trang-nam,215531382,"Túi Đeo Chéo Chần Bông SAIGON SWAGGER NOIR PUFFER BAG",490000,490000,0,0
TIKI,tui-thoi-trang-nam,128315948,"Túi bao tử nam BHL032 Túi đeo chéo. Da bò nguyên tấm",680000,680000,0,0
TIKI,tui-thoi-trang-nam,47464761,"Ví Nam Da Bò Cao Cấp Size Lớn  Bỏ Vừa BLX Cũ Màu Nâu Đen",299000,299000,0,0
TIKI,tui-thoi-trang-nam,49503373,"Ví nam thời trang da thật LATA LVN52",139000,580000,441000,76
TIKI,tui-thoi-trang-nam,53771061,"Túi đeo chéo nam nữ thời trang Hàn quốc BEE GEE 082 chống thấm nước hot trend 2020",70000,140000,70000,50
TIKI,tui-thoi-trang-nam,158154241,"Clutch Cầm Tay Nam Cao Cấp Gence CK15 Khóa Số",1980000,1980000,0,0
TIKI,tui-thoi-trang-nam,116785351,"Ví Da Nam Mềm Mại GENTLE, Size Lớn, Da Bò 100%, Thiết Kế Nhiều Ngăn, Đựng Giấy Tờ Xe, Đựng Tiền và Thẻ Tiện Dụng, Dáng Ngang - Gập 2 - Hàng Chính Hãng SAIGIO",782000,799000,17000,2
TIKI,tui-thoi-trang-nam,161368355,"Clutch, Ví Cầm Tay Thời Trang Nam Khóa Số Da Bò Cao Cấp CK15",1800000,1800000,0,0
TIKI,tui-thoi-trang-nam,40720190,"Ví Da Nam Cao Cấp Size Lớn Bỏ Vừa BLX cũ Có Ngăn Dây Kéo",99000,320000,221000,69
TIKI,tui-thoi-trang-nam,68244501,"Túi Đeo Chéo Nam Da Cá Sấu SPot1",175000,175000,0,0
TIKI,tui-thoi-trang-nam,924532,"Túi Đeo Chéo Nam HARAS HRTK147VN (26 x 17 cm) - Xám",65000,65000,0,0
TIKI,tui-thoi-trang-nam,74864406,"Ví Nam Cao Cấp Da Bò Thật LATA LVN71 Nhiều Màu (Gấp lại: Dài 11cm x Cao 8cm)",309000,420000,111000,26
TIKI,tui-thoi-trang-nam,193395604,"Clutch, Ví Cầm Tay Thời Trang Nam Da Bò Epsom Cao Cấp HT19",1490000,1490000,0,0
TIKI,tui-thoi-trang-nam,195767534,"Ví Đứng Nam Size Lớn, Da Bò PEBBLE Mềm Mại - Bền Bỉ, Chống Xước - Chống Nhăn Tốt, Thiết Kế Cổ Điển, Dáng Đứng - Gập 2, Ngăn Đựng Tiền Có Khóa Kéo, Nhiều Ngăn Để Giấy Tờ Tiện Dụng",1133000,1149000,16000,1
TIKI,tui-thoi-trang-nam,154207423,"Cặp Xách Nam Công Sở Gence Da Bò Thật CDT04",2000000,2000000,0,0
TIKI,tui-thoi-trang-nam,56404583,"Túi đeo chéo nam đa năng phong cách châu âu",159000,159000,0,0
TIKI,tui-thoi-trang-nam,56959406,"Túi da đeo chéo kẻ caro cực chất cho nam - Hàng cao cấp",105000,145869,40869,28
TIKI,tui-thoi-trang-nam,50260943,"Túi đeo ngực,đeo chéo nam phong cách châu âu hiện đại tích hợp sẵn công nghệ 4.0",531000,590000,59000,10
TIKI,tui-thoi-trang-nam,57924770,"Ví đứng da bò pull-up AT Leather 063D",275000,325000,50000,15
TIKI,tui-thoi-trang-nam,44014184,"Cặp Da Công Sở LATA CA21",690000,690000,0,0
TIKI,tui-thoi-trang-nam,155339575,"Ví sen 3 da bò Pullup V122, bóp mini nam nhỏ gọn hai màu đen và nâu, đường chỉ may tinh tế, đựng thẻ kẹp tiền tiện lợi,fullbox, thương hiệu Bụi leather chuyên đồ da thật",140000,227000,87000,38
TIKI,tui-thoi-trang-nam,89786100,"Túi đeo chéo túi bao tử Sport Canvas unisex nhỏ gọn tiện dụng - Túi chéo TC70-D",55000,77218,22218,29
TIKI,tui-thoi-trang-nam,197864356,"Ví Đứng Nam Nhỏ Gọn, Da Bò SMALL PEBBLE Mềm Mại - Bền Bỉ, Size Trung, Chống Xước - Chống Nhăn Tốt, Thiết Kế Đơn Giản, Dáng Đứng - Gập 2, 3 Ngăn Lớn Đựng Tiền Và 8 Ngăn Nhỏ Để Thẻ ATM, Giấy Tờ Tùy Thân - Hàng Chính Hãng SAIGIO",983000,999000,16000,2
TIKI,tui-thoi-trang-nam,57939413,"Cặp da công sở LATA CA31",750000,750000,0,0
TIKI,tui-thoi-trang-nam,78954023,"Túi xách nam công sở 100% da bò thật cao cấp phong cách mới",900000,999000,99000,10
TIKI,tui-thoi-trang-nam,50709932,"Cặp Da Công Sở Nam  P077",325000,325000,0,0
TIKI,tui-thoi-trang-nam,146366136,"Ví nam ngang mini BHM816 Mỏng gọn, Da bò thật, chống quét RFID",279720,279720,0,0
TIKI,tui-thoi-trang-nam,126765534,"Túi đeo chéo da cao cấp unisex nam nữ chống nước thời trang hot trend",57500,115000,57500,50
TIKI,tui-thoi-trang-nam,58472895,"Túi đeo chéo da nam LATA BALC24",360000,360000,0,0
TIKI,tui-thoi-trang-nam,126973701,"Túi đeo chéo nam BHL144 Da bò thật dập nổi vân da cá sấu",650000,650000,0,0
TIKI,tui-thoi-trang-nam,149179118,"Túi đeo chéo nam da bò thật T44 27x22x7.5cm đựng ipad (Nâu đậm-Nâu-Nâu sáng) - DH STORE",1250000,1250000,0,0
TIKI,tui-thoi-trang-nam,193389984,"Túi Đeo Chéo Nam Nữ Thời Trang Trẻ Trung, Túi Đựng Ipad, Túi Đeo Vai Có Túi Bố Nhiều Ngăn Kéo Đựng Đồ Rất Tiện Lợi, Vải Oxford Chống Thấm Nước",135000,135000,0,0
TIKI,tui-thoi-trang-nam,149179677,"Ví cầm tay, bóp cầm tay, ví đựng thẻ card nam nữ thời trang da bò cao cấp 2 ngăn khóa BA04 KT:21x13x4cm (Nâu - Đen)",196983,207350,10367,5
TIKI,tui-thoi-trang-nam,50422433,"Túi Đeo Chéo Nam Phong Cách Lịch Lãm P088",245000,245000,0,0
TIKI,tui-thoi-trang-nam,150877234,"Clutch, Ví Cầm Tay Thời Trang Nam Khóa Số Da Bò Mill Cao Cấp RB07 Đen, Nâu",1300000,1300000,0,0
TIKI,tui-thoi-trang-nam,56398019,"Ví nam ví cầm tay nam nữ 100% da bò thật cao cấp phong cách mới hiện đại",513000,570000,57000,10
TIKI,tui-thoi-trang-nam,11725276,"Ví kẹp tiền nam vân sợi carbon kim loại cao cấp B11-L239",310000,310000,0,0
TIKI,tui-thoi-trang-nam,105628957,"Túi xách nam công sở da thật chất lượng cao cấp phong cách mới",351000,390000,39000,10
TIKI,tui-thoi-trang-nam,157254039,"Túi Bao Tử Flexible SAIGON SWAGGER SGS Flexible Bumbag",360000,360000,0,0
TIKI,tui-thoi-trang-nam,66912745,"Cặp da công sở đựng Laptop 14 inch họa tiết ông già cao cấp",325000,325000,0,0
TIKI,tui-thoi-trang-nam,153021062,"Túi đeo chéo nam cao cấp phong cách HÀN QUỐC BEE GEE DCN9018A (Tặng quà tặng ngẫu nhiên trong BEEGEE GILF COLLECTION)",240000,480000,240000,50
TIKI,tui-thoi-trang-nam,93145566,"Ví kẹp tiền cho nam leather carbon",585000,585000,0,0
TIKI,tui-thoi-trang-nam,125181251,"Ví da nam, bóp da nam Bụi Leather V110 - Da bò Pullup cao cấp - Bảo hành 12 tháng",209000,370000,161000,44
TIKI,tui-thoi-trang-nam,32172674,"Túi xách da công sở nam có dây đeo chéo cao cấp chống thấm nước DH1803 - Nâu",199000,199000,0,0
TIKI,tui-thoi-trang-nam,163574482,"Ví nam cao cấp CaecnKoen- Ví ngắn -Full hộp đựng cao cấp",650000,1300000,650000,50
TIKI,tui-thoi-trang-nam,58842555,"Túi Đeo Chéo, Đeo Ngang Dành Cho Nam Chất Da PU Cao Cấp Thời Trang Phong Cách",66330,95810,29480,31
TIKI,tui-thoi-trang-nam,125149562,"Ví nam, bóp nam da bò sáp Bụi Leather V108 - Bảo hành 12 tháng",209000,370000,161000,44
TIKI,tui-thoi-trang-nam,149521232,"{DA CÁ SẤU THẬT} Bóp Da Cá Sấu Nam Màu Đen Da Bụng - Ví Nam Da Cá Sấu Có Khoá Kéo Cao Cấp Dáng Ngang Thời Trang",445000,890000,445000,50
TIKI,tui-thoi-trang-nam,153495928,"Cặp Xách Nam Gence Da Bò Cao Cấp CGL07 Khóa Số",3520000,3520000,0,0
TIKI,tui-thoi-trang-nam,50490304,"Túi đeo ngực,đeo chéo nam đã tích hợp công nghệ 4.0",711000,790000,79000,10
TIKI,tui-thoi-trang-nam,143789937,"Combo ví Nam Thương hiệu Oscar - Muỗng xỏ giày Pierre",1690000,1690000,0,0
TIKI,tui-thoi-trang-nam,73165278,"Túi Đeo Chéo Fashion Thời Trang, Túi Đeo Chéo Nam Nữ Tiện Lợi",42174,44394,2220,5
TIKI,tui-thoi-trang-nam,148811481,"Clutch nam da bò Mill cao cấp M101 Bụi Leather - Bảo hành 12 tháng",650000,1064000,414000,39
TIKI,tui-thoi-trang-nam,148810221,"Ví dài cầm tay da bò Mill cao cấp Bụi Leather C105 - Bảo hành 12 tháng",355000,564000,209000,37
TIKI,tui-thoi-trang-nam,51064454,"VÍ SEN TO - CHÍNH HÃNG KHẮC TÊN",950000,950000,0,0
TIKI,tui-thoi-trang-nam,6887853,"Túi Đeo Chéo Nam DXYZ Chống Trộm",111000,111000,0,0
TIKI,tui-thoi-trang-nam,50263298,"Túi đeo ngực đeo chéo nam phong cách mới",423000,470000,47000,10
TIKI,tui-thoi-trang-nam,25892672,"Túi Đeo Chéo Nam Simple Fashion",49000,49000,0,0
TIKI,tui-thoi-trang-nam,196789928,"Túi đeo chéo nam phong cách mới  - BEE GEE DCN9078",485000,970000,485000,50
TIKI,tui-thoi-trang-nam,171254639,"Ví Money Clip Bóp Da Nam Kẹp Tiền Mini",290000,290000,0,0
TIKI,tui-thoi-trang-nam,189268061,"Túi xách nam da PU thời trang công sở cao cấp thanh lịch YVan 6616-5",650000,650000,0,0
TIKI,tui-thoi-trang-nam,108850202,"Ví nam thời trang da bò thật LATA LVN94",450000,450000,0,0
TIKI,tui-thoi-trang-nam,124965903,"Ví nam, bóp nam da bò sáp Mexico Bụi Leather V102 - Bảo hành 12 tháng",209000,370000,161000,44
TIKI,tui-thoi-trang-nam,124246193,"Túi Đeo Chéo Bụng Da Bò Thật Cao Cấp Cá Tính, Túi Bao Tử Da Nam TẶNG KÈM TAI NGHE 70K",315000,315000,0,0
TIKI,tui-thoi-trang-nam,15259662,"Túi đeo hông, đeo bụng  có ngăn chứa nước (đen)",187950,187950,0,0
TIKI,tui-thoi-trang-nam,141953788,"Ví da nam cầm tay Tigernu bằng da bò sang trọng cá tính T-S8003",999000,999000,0,0
TIKI,tui-thoi-trang-nam,35588581,"Túi đeo chéo nam nữ unisex thời trang BEE GEE 060",60000,120000,60000,50
TIKI,tui-thoi-trang-nam,184126336,"Ví nam cầm tay cao cấp - Clutch Cầm Tay chất lượng cao phong cách mới",351000,390000,39000,10
TIKI,tui-thoi-trang-nam,178950304,"túi xách nam 100% da bò thật hàng siêu cao cấp 15,6",1125000,1250000,125000,10
TIKI,tui-thoi-trang-nam,193106491,"Ví da nam dáng ngang sọc chéo TRITA RVN19",189000,390000,201000,52
TIKI,tui-thoi-trang-nam,54095567,"Túi đeo chéo_ Tặng ví da cao cấp",179000,179000,0,0
TIKI,tui-thoi-trang-nam,10231449,"Ví Nam Da Bò Slim nhỏ gọn màu đen",350000,350000,0,0
TIKI,tui-thoi-trang-nam,58935735,"Ví Nam Da Bò Cao Cấp - Bóp Da Nam Thời Trang Da Bò Thật",389000,389000,0,0
TIKI,tui-thoi-trang-nam,141955540,"Túi đeo chéo nam nữ chống nước Tigernu có dây đeo siêu nhẹ T-S8121",262800,365000,102200,28
TIKI,tui-thoi-trang-nam,55702248,"Túi nam đeo chéo BHM1050 Màu Nâu. Da bò sáp thô nguyên tấm, bền bỉ với thời gian, vừa tài liệu A4, nhiều phụ kiện",1370000,1370000,0,0
TIKI,tui-thoi-trang-nam,32369595,"Ví Da Nam Bản To - Clutch Cầm Tay Cao Cấp Chống Thấm Nước và Trầy Xước A716",245000,245000,0,0
TIKI,tui-thoi-trang-nam,54463093,"Túi Đeo Chéo Da Cao Cấp Thời Trang Tiện Lợi KN01",103950,150150,46200,31
TIKI,tui-thoi-trang-nam,191039766,"Ví Nam Gấp Đôi Dáng Ngang Da Vân Chất Liệu Da Cao Cấp MB-022 Chống Nước .Menbense, Ví Nam 3 Lớp Có Ngăn Khóa Và Ngăn Thẻ",65000,65000,0,0
TIKI,tui-thoi-trang-nam,93797425,"Túi đeo chéo nam phong cách  thể thao mới tích hợp khóa chống trộm và chống thấm nước cao cấp",379000,469000,90000,19
TIKI,tui-thoi-trang-nam,49542819,"Ví nam - nữ thời trang da thật LATA LVN56",299000,390000,91000,23
TIKI,tui-thoi-trang-nam,149179510,"Túi đeo chéo nam da bò MAIKEJUESHI (KT 26x22x8)",1140000,1140000,0,0
TIKI,tui-thoi-trang-nam,136060242,"Cặp Da Nam Công Sở Túi Xách GENCE CTS08 Da Bò Cao Cấp Màu Nâu Có Dây Đeo Vai",3000000,3000000,0,0
TIKI,tui-thoi-trang-nam,52664226,"[ KEIO NIPPON ] Ví Đứng Da Bò Pullup | Ví Nam Nữ Da Bò Thật Nhập Khẩu",159000,159000,0,0
TIKI,tui-thoi-trang-nam,193413395,"Bóp Nam Da Bò SÁP - Vân Tự Nhiên, Size Lớn, Thiết Kế Cổ Điển, Đơn Giản - Mỏng Nhẹ, Dáng Ngang - Gập 2, Ngăn Đựng Tiền Có Khóa Kéo, Nhiều Ngăn Để Giấy Tờ Tiện Dụng",883000,899000,16000,2
TIKI,tui-thoi-trang-nam,193546215,"Bóp Nam Da Bò SÁP Họa Tiết Caro, Size Lớn, Thiết Kế Cổ Điển, Đơn Giản - Mỏng Nhẹ, Dáng Ngang - Gập 2, Ngăn Đựng Tiền Có Khóa Kéo, Nhiều Ngăn Để Giấy Tờ Tiện Dụng",880000,899000,19000,2
TIKI,tui-thoi-trang-nam,52877236,"VÍ SEN 2 - CHÍNH HÃNG KHẮC TÊN",300000,300000,0,0
TIKI,tui-thoi-trang-nam,208395919,"Túi xách da bò nam công sở cao cấp phong cách châu âu",675000,750000,75000,10
TIKI,tui-thoi-trang-nam,67546405,"Cặp da công sở đựng Laptop 14 inch quai cầm nối dài mới lạ",199000,199000,0,0
TIKI,tui-thoi-trang-nam,121965394,"Ví Nam Da Bò Sáp Dáng Đứng Nhiều Ngăn Siêu Bền Đẹp",168000,336000,168000,50
TIKI,tui-thoi-trang-nam,26165185,"Túi Xách Bao Tử Đeo Hông vải bố thời trang",179000,179000,0,0
TIKI,tui-thoi-trang-nam,96027060,"Ví nam Đông Hải - KT05",340000,340000,0,0
TIKI,tui-thoi-trang-nam,19730058,"Túi đeo chéo vải bố nam TX0010",259200,360000,100800,28
TIKI,tui-thoi-trang-nam,115643255,"Ví Nam Mini Nhỏ Gọn Cao Cấp, Da Bò NAPA Láng Mịn, Thiết Kế Cổ Điển, Tinh Tế - Sang Trọng, Dáng Ngang - Gập 2, Đựng Tiền và Thẻ ATM Tiện Dụng - Hàng Chính Hãng SAIGIO",959000,999000,40000,4
TIKI,tui-thoi-trang-nam,710997,"Túi Đeo Chéo Nam HARAS HRTK118 (27 x 17 cm) - Xám",90000,90000,0,0
TIKI,tui-thoi-trang-nam,43813150,"Túi đeo bụng, túi đeo vai, túi đeo chéo  tiện dụng MG8009",35000,50061,15061,30
TIKI,tui-thoi-trang-nam,74862821,"Ví nam da bò dáng ngang thời trang LATA LVN69 , 9 ngăn, đựng vừa tiền, CMND và 5 thẻ namecard, phù hợp đi chơi, đi làm, sử dụng hằng ngày, da bò thật 100%, không bong tróc, độ bền cao (Dài 13cm x Cao 10cm)",380000,380000,0,0
TIKI,tui-thoi-trang-nam,183503748,"Túi Đeo Dọc WIWU PIONEER 12.9 Inch Dành Cho Ipad Làm Bằng Polyester Chống Thấm Nước, Bền, Dễ Làm Sạch - Hàng Chính Hãng",499000,499000,0,0
TIKI,tui-thoi-trang-nam,70627845,"Túi bao tử_túi đeo chéo da nam_nữ SEAGLE ST02",199000,199000,0,0
TIKI,tui-thoi-trang-nam,37474374,"Túi đeo chéo P080",236550,249000,12450,5
TIKI,tui-thoi-trang-nam,149179544,"Túi đeo chéo nam da bò 100% cao cấp T14 túi đựng ipad (KT :30.5x26x6cm)",1260000,1260000,0,0
TIKI,tui-thoi-trang-nam,170497250,"Ví ngang nam Simple Horizontal Wallet chính hãng NATOLI đựng tiền, thẻ nhiều ngăn nhỏ gọn cao cấp",179000,256000,77000,30
TIKI,tui-thoi-trang-nam,67017467,"Ví Nam Da Bò SAM Leather – Bóp/Ví Nam Da Bò Cao Cấp",599000,599000,0,0
TIKI,tui-thoi-trang-nam,127210944,"Túi đeo chéo nam da bò thật BIGBEN cao cấp TXBB02",499000,499000,0,0
TIKI,tui-thoi-trang-nam,188018042,"Clutch, Ví Cầm Tay Thời Trang Nam Da Bò Alran Cao Cấp HT15 Đen",1500000,1500000,0,0
TIKI,tui-thoi-trang-nam,98074341,"Ví nam bảng dài cầm tay  bấm góc bản châu âu B11 Tặng móc khóa nam cao cấp",108000,152313,44313,29
TIKI,tui-thoi-trang-nam,188993783,"Ví Sen To handmade da thật",550000,550000,0,0
TIKI,tui-thoi-trang-nam,73730912,"Túi đeo chéo da nam nữ cao cấp da bền MIBAG70",185000,185000,0,0
TIKI,tui-thoi-trang-nam,137796500,"Ví nam da bò thật VO 051005",165000,320000,155000,48
TIKI,tui-thoi-trang-nam,36755317,"Bóp Ví Nam Da Cao Cấp PORADO BDX95V",129000,129000,0,0
TIKI,tui-thoi-trang-nam,68554912,"Cặp Xách Công Sở Nam Da Bò Cao Cấp CTS08",3000000,3000000,0,0
TIKI,tui-thoi-trang-nam,89588637,"[Da thật} Ví nam da thật, Ví đứng da sáp WS101B (Nâu sẫm) - 100% da bò thật, BH 3 năm",50000,50000,0,0
TIKI,tui-thoi-trang-nam,100846209,"Túi đeo chéo nam thời trang chống nước MOYYI TDC004",180000,250000,70000,28
TIKI,tui-thoi-trang-nam,92564158," Túi đeo chéo nam Kangaroo da cao cấp",289000,289000,0,0
TIKI,tui-thoi-trang-nam,146955416,"Ví Da Nam VD05 Dáng Ngang Cá Tính Thời Thượng",38000,50000,12000,24
TIKI,tui-thoi-trang-nam,91447707,"Cặp Túi Da Nam C48",1188000,1188000,0,0
TIKI,tui-thoi-trang-nam,4353345,"Túi đựng ipad Simplecarry LC Ipad2",390000,390000,0,0
TIKI,tui-thoi-trang-nam,25182819,"Túi đeo hông nam, túi đeo bụng da nam 6 ngăn",94333,136259,41926,31
TIKI,tui-thoi-trang-nam,38655549,"Túi Đeo Chéo - Đeo Hông Da 2 Ngăn Thời Trang",50000,70694,20694,0
TIKI,tui-thoi-trang-nam,161879213,"Túi đeo chéo kết hợp đeo hông nam da bò thật TD107VB (Vàng bò) - 100% da bò thật, BH 3 năm",350000,350000,0,0
TIKI,tui-thoi-trang-nam,176130369,"Túi đeo chéo nam vải canvas, thiết kế 3 ngăn để đồ, phong cách thời trang Hàn Quốc TC03",110000,110000,0,0
TIKI,tui-thoi-trang-nam,169127759,"Ví Da Nam Da Bò Thật Nhỏ Gọn",290000,290000,0,0
TIKI,tui-thoi-trang-nam,68303251,"Cặp công sở laptop nam nữ 4 kiểu phong cách mới CV4 Tặng móc khóa nam cao cấp",123000,174537,51537,30
TIKI,tui-thoi-trang-nam,89113490,"Ví Dài Nam Hai Ngăn Có Ngăn Kéo Khóa Hàng Full Box Chất Da Trơn Chuẩn Đẹp",246000,246000,0,0
TIKI,tui-thoi-trang-nam,187586720,"Ví nam cầm tay cao cấp - Clutch Cầm Tay chất lượng cao phong cách mới",243000,270000,27000,10
TIKI,tui-thoi-trang-nam,74863205,"Ví nam da bò dáng ngang thời trang LATA LVN70 , 11 ngăn, đựng vừa tiền, CMND và 7 thẻ namecard, phù hợp đi chơi, đi làm, sử dụng hằng ngày, da bò thật 100%, không bong tróc, độ bền cao (Dài 12.5cm x Cao 10cm)",380000,380000,0,0
TIKI,tui-thoi-trang-nam,179013218,"Ví nam vuông cầm tay mắt cú siêu ngầu thời trang Shalla",56955,59953,2998,5
TIKI,tui-thoi-trang-nam,193638928,"Túi đeo chéo nam nữ thời trang đa năng cao cấp phong cách mới",261000,290000,29000,10
TIKI,tui-thoi-trang-nam,190722535,"Cặp da công sở cao cấp SHINKOZI CS05",1990000,1990000,0,0
TIKI,tui-thoi-trang-nam,108197950,"Túi xách nam 100% da bò thật công sở cao cấp phong cách mới",702000,780000,78000,10
TIKI,tui-thoi-trang-nam,176130340,"Hộp đựng ví nam sang trọng đựng kèm quà tặng ví mua kèm ví nam được giảm giá - MB32",16000,16000,0,0
TIKI,tui-thoi-trang-nam,154190285,"Clutch Cầm Tay Nam Gence Da Bò Saffiano CK11",1400000,1400000,0,0
TIKI,tui-thoi-trang-nam,94586618,"TÚI ĐEO CHÉO THỜI TRANG MARK RYDEN – BANDOLERA thế hệ mới chống nước hiệu quả",1014000,1014000,0,0
TIKI,tui-thoi-trang-nam,181785469,"Túi chiến thuật rằn ri đi hành quân, dã ngoại, thao trường cho bộ đội mẫu mới 2020",80000,80000,0,0
TIKI,tui-thoi-trang-nam,49233464,"Ba Lô Đeo Chéo Nam LATA - Thời Trang Đa Năng - Da Tổng hợp, chất da bền bỉ, không bong tróc, không thấm nước - LATA BALC22 Nhiều Màu ( dài 17 x rộng 6 x cao 26 cm ) - Hàng Chính Hãng",360000,360000,0,0
TIKI,tui-thoi-trang-nam,191925864,"Túi đeo chéo nam hàng hiệu Shinkozi MN01 Da Bò Thật 100%",1190000,1190000,0,0
TIKI,tui-thoi-trang-nam,44325811,"Túi xách da bò công sở cao cấp phong cách châu âu TX DA BÒ 044",504000,560000,56000,10
TIKI,tui-thoi-trang-nam,196758904,"Túi Cầm Tay Đeo Chéo Nam Gence Da Bò Togo TC01",1800000,1800000,0,0
TIKI,tui-thoi-trang-nam,119385004,"Túi đeo hông nam, túi bao tử da bò thật Crazy horse TD106LEA- 100% da bò thật",390000,390000,0,0
TIKI,tui-thoi-trang-nam,58810783,"Ví Sen Đà Điểu - CHÍNH HÃNG KHACTEN.COM",1500000,1500000,0,0
TIKI,tui-thoi-trang-nam,193601758,"Túi đeo chéo nam chống nước, khóa số chống trộm cao cấp BG-7082",600000,600000,0,0
TIKI,tui-thoi-trang-nam,157254216,"Túi Đeo Chéo Nam, Nữ Họa Tiết Sọc SAIGON SWAGGER SGS Icon Tartan Bag",450000,450000,0,0
TIKI,tui-thoi-trang-nam,188491306,"Túi nam | 1992 s t u d i o | ZANE BAG RẰN RI | Túi bao tử | chất liệu oxford",399000,399000,0,0
TIKI,tui-thoi-trang-nam,191925614,"Cặp Da Nam Công Sở- Cặp Da Thật - Cặp Đựng Laptop Shinkozi CS011",2590000,2590000,0,0
TIKI,tui-thoi-trang-nam,125354950,"Ví Cầm Tay Nam Da Bò Dập Vân Cá Sấu 1 Ngăn Nam Tính",92000,180000,88000,49
TIKI,tui-thoi-trang-nam,149179578,"Túi đeo chéo nam, túi đựng ipad hồ sơ tài liệu da bò thật cao cấp  (KT27x24x5) ĐEN - NÂU - BẢO HÀNH DA 12 THÁNG",650000,650000,0,0
TIKI,tui-thoi-trang-nam,34546844,"Ví nam cầm tay da thật ELLY HOMME – EVM3",899000,899000,0,0
TIKI,tui-thoi-trang-nam,88929109,"Túi xách nam công sở cao cấp",405000,450000,45000,10
TIKI,tui-thoi-trang-nam,126682296,"Cặp công sở nam cao cấp BHL1038 Vừa laptop 15inch. Da bò thô nguyên tấm",1755000,1755000,0,0
TIKI,tui-thoi-trang-nam,171776243,"cặp da công sở nam",827000,827000,0,0
TIKI,tui-thoi-trang-nam,108855728,"Ví nam thời trang da bò thật TRITA RVN07 phong cách cá tính, đựng tiền và thẻ card 14:46 17:45 25/06/2021",195000,410000,215000,52
TIKI,tui-thoi-trang-nam,193723918,"Túi Đeo Chéo Nam Nữ  Vải Chống Thấm Nước Phong Cách Hàn Quốc, Túi Bao Tử Thể Thao",59000,59000,0,0
TIKI,tui-thoi-trang-nam,140097078,"Cặp Da Nam Cao Cấp Khóa Số Gence CTS10",3200000,3200000,0,0
TIKI,tui-thoi-trang-nam,150148744,"Cặp da bò sáp xách tay vừa laptop 13inch BHL2808 Túi công sở nam",1450000,1450000,0,0
TIKI,tui-thoi-trang-nam,96027817,"Ví đứng nam Đông Hải - AV007",490000,490000,0,0
TIKI,tui-thoi-trang-nam,149179182,"Túi đeo chéo nam da bò ZHIZUNCANGAROO T46 28x23x7cm (Đen - Nâu) - DH STORE",648000,648000,0,0
TIKI,tui-thoi-trang-nam,151491295,"Túi đeo chéo nam nữ sành điệu nhỏ gọn tiện lợi giá rẻ bền đẹp đi chơi picnic chất vải Canvas GOMIA DC1903",47775,47775,0,0
TIKI,tui-thoi-trang-nam,7233617,"Túi đẻo bụng thể thao tặng khóa",75000,106887,31887,30
TIKI,tui-thoi-trang-nam,179758621,"CẶP DA KHÓA SỐ DOANH NHÂN",1250000,1250000,0,0
TIKI,tui-thoi-trang-nam,193104461,"Ví nam da bò dáng ngang họa tiết sọc chéo TRITA RVN17",185000,390000,205000,53
TIKI,tui-thoi-trang-nam,58248292,"Ví nam da thật TRITA RVN03",189000,350000,161000,46
TIKI,tui-thoi-trang-nam,59407404,"Ví Nam YORN Da Thật 100% Siêu Bền Phối Màu Tinh Tế - Hàng Chính Hãng",176000,176000,0,0
TIKI,tui-thoi-trang-nam,146952369,"Ví Da Nam Nhiều Ngăn VD04 Kiểu Đứng Nhỏ Gọn Chất Lượng",38000,50000,12000,24
TIKI,tui-thoi-trang-nam,2000679,"Ví Nam Da Trăn Nguyên Thủy Kiểu Đứng Huy Hoàng HT2306 (12.5 x 10 cm) - Da Nguyên Thủy",599000,599000,0,0
TIKI,tui-thoi-trang-nam,107962004,"(ẢNH THẬT -CAO CẤP) Ví Nam Handmade Phong Cách Màu Cafe,Ví Da Nam Thời Thượng - Ví Tiền VIP02",339000,339000,0,0
TIKI,tui-thoi-trang-nam,179013334,"Ví kẹp bảng dài nam nữ hình mắt cú thời trang siêu đẹp Shalla",60221,86986,26765,31
TIKI,tui-thoi-trang-nam,67235358,"TÚI ĐEO CHÉO TOMTOC (USA) URBAN CODURA SHOULDER BAGS FOR ULTRABOOK 13″ BLACK – H14-C01D",1789000,1789000,0,0
TIKI,tui-thoi-trang-nam,155495502,"Ví namecard da bò V130, ví đựng thẻ da thật, khâu tay thủ công, ví mini nam đường chỉ tinh tế, thương hiệu Bụi leather chuyên đồ da thật",135000,170000,35000,21
TIKI,tui-thoi-trang-nam,149179363,"Túi đeo chéo nam da bò POLO cao cấp T66 KT 19x22x4cm (Nâu Đậm - Nâu Nhạt) - DH STORE",478800,478800,0,0
TIKI,tui-thoi-trang-nam,161368235,"Clutch, Ví Cầm Tay Thời Trang Nam Khóa Số Da Bò Cao Cấp CK14",1800000,1800000,0,0
TIKI,tui-thoi-trang-nam,179718829,"Ví tròn đựng tiền, trang sức, chìa khóa, tai phone ( mẫu ngẫu nhiên)",17000,17000,0,0
TIKI,tui-thoi-trang-nam,177012500,"Túi xách nam công sở da tự nhiên cao cấp phong cách mới",441000,490000,49000,10
TIKI,tui-thoi-trang-nam,145394214,"Túi đeo chéo nam ngăn đôi dáng ngang lịch lãm LATA TN20",339000,400000,61000,15
TIKI,tui-thoi-trang-nam,161879095,"Túi đeo chéo, túi bao tử da bò thật TD106VB (Nâu sáp/Vàng bò) - 100% da bò thật, bảo hành 3 năm",358000,358000,0,0
TIKI,tui-thoi-trang-nam,99336014,"[Da thật] Túi đeo ngực kết hợp đeo hông nam da bò thật TD107 (Vàng bò) - 100% da bò thật",250000,250000,0,0
TIKI,tui-thoi-trang-nam,45842879,"Ví da cầm tay nam nữ cao cấp  - Nâu",112000,155595,43595,28
TIKI,tui-thoi-trang-nam,68845268,"Ví nam chống RFID BHM7777 Da bò thật, siêu mỏng gọn",387720,387720,0,0
TIKI,tui-thoi-trang-nam,103886512,"Túi Đeo Chéo Da Bò Thật Bảo Hành Ba Năm CB03",750000,750000,0,0
TIKI,tui-thoi-trang-nam,153264863,"Túi đeo chéo vải bố kẻo chỉ đỏ cao cấp B77 Shalla",41131,43296,2165,5
TIKI,tui-thoi-trang-nam,41427549,"Cặp công sở laptop đeo chéo mẫu mới ngang đỏ trên P2 Shalla",158888,167250,8362,5
TIKI,tui-thoi-trang-nam,116971464,"Ví nam da bò cao cấp Gianni Conti Italy 587620BLA - màu đen ",1400000,1400000,0,0
TIKI,tui-thoi-trang-nam,50419585,"Túi đeo ngực,đeo chéo nam đã tích hợp sẵn công nghệ 4.0",621000,690000,69000,10
TIKI,tui-thoi-trang-nam,55461600,"Ví/ Bóp Nam Dáng Đứng Màu Nâu Dành cho Nam Da Bò Cao Cấp, Thiết Kế Tinh Tế, Thời Trang 2020 - ORCO (Kích thước 12 cm x 9 cm)",99000,99000,0,0
TIKI,tui-thoi-trang-nam,70090549,"Túi bao tử đeo chéo đeo bụng đa năng",190000,190000,0,0
TIKI,tui-thoi-trang-nam,175425259,"Túi Đeo Chéo IBag Thời Trang Cao Cấp SAKOS CENTERA",890000,890000,0,0
TIKI,tui-thoi-trang-nam,172191930,"Túi đeo chéo nam phong cách Hàn Quốc chống nước, có cổng USB xạc tiện dụng – bảo hành 3 tháng.208204",58000,67600,9600,14
TIKI,tui-thoi-trang-nam,113168460,"Ví nam cầm tay Gianni Conti Italy VP0176BLA - màu đen",3300000,3300000,0,0
TIKI,tui-thoi-trang-nam,126039327,"Bóp Đựng Thẻ ATM Nhỏ Gọn SUPPLE, Da Bò SMALL PEBBLE Mềm Mại - Bền Bỉ, Chống Xước - Chống Nhăn Tốt, Thiết Kế Hiện Đại, Ngăn Súp Lê Rộng, Đựng Được Nhiều Thẻ Ngân Hàng, Card Danh Thiếp, Căn Cước Công Dân, Dáng Đứng - Gập 2 – Hàng Chính Hãng SAIGIO",683000,699000,16000,2
TIKI,tui-thoi-trang-nam,195559178,"Ví nam họa tiết rằn ri",99000,99000,0,0
TIKI,tui-thoi-trang-nam,177561265,"Túi đeo chéo nam cao cấp tích hợp cổng sạc USB ngoài 208211",67000,78785,11785,15
TIKI,tui-thoi-trang-nam,47464262,"Ví Nam Dài Cầm Tay Cap Cấp Đường May Chắc Chắn Tôn Lên Vẻ Sang Trọng Kiểu Dáng Mỏng Kích Thước 21x11x3 2 Màu Lựa Chọn Đen Nâu  Có 11 Ngăn Đựng Thẻ 1 Ngăn Đựng Hình 3 Ngăn Lớn",179000,179000,0,0
TIKI,tui-thoi-trang-nam,75998917,"Túi bao tử nam nữ có lỗ tai nghe chống nước chống bụi MIBAG38",96439,101515,5076,5
TIKI,tui-thoi-trang-nam,196320293,"Ví Da Nam VD07 Ví Cầm Tay Nam Cao Cấp Sang Trọng Lịch Lãm",48000,80000,32000,40
TIKI,tui-thoi-trang-nam,197459903,"ví nam ví nam clutch cầm tay cao cấp",270000,299000,29000,10
TIKI,tui-thoi-trang-nam,49100365,"Ví ngang nam da bò KTP Cao cấp",479800,479800,0,0
TIKI,tui-thoi-trang-nam,85092653,"Ví cầm tay nam da thời trang dạo phố dạng hộp bảng lớn caro Màu Trơn NKN Tặng móc khóa nam A2",127000,179949,52949,29
TIKI,tui-thoi-trang-nam,172532744,"Ví ngang Cefiro da sáp phối màu WS108 Ví da JTOM - Bảo hành 3 năm",155000,155000,0,0
TIKI,tui-thoi-trang-nam,180000878,"Túi Đeo Chéo Nam Mini BT06 Da Bò Tiện Dụng Phù Hợp Đi Chơi Đi Làm Đầy Cá Tính",235000,450000,215000,48
TIKI,tui-thoi-trang-nam,25687456,"Ví Nam Da Bò – Ví Ngang SAM Leather SAM005",649000,649000,0,0
TIKI,tui-thoi-trang-nam,206249762,"Ví da nam . ví nam cao cấp Full hộp WilliamPOLO -  V26",545000,545000,0,0
TIKI,tui-thoi-trang-nam,19742944,"Túi xách da nam công sở",315000,315000,0,0
TIKI,tui-thoi-trang-nam,177145864,"Ví Da Nam Bóp Da Nam Cao Cấp EINHORN EI04B",195000,330000,135000,41
TIKI,tui-thoi-trang-nam,14702745,"Bóp ví nam nữ dáng dài VD09_2",150000,150000,0,0
TIKI,tui-thoi-trang-nam,117393261,"Túi đeo chéo nam nữ da Pu cao cấp TC08",105000,145869,40869,28
TIKI,tui-thoi-trang-nam,21980324,"Ví nam da bò sang trọng Huy Hoàng",559000,559000,0,0
TIKI,tui-thoi-trang-nam,37398852,"Ví Nam Da Bò Cao Cấp PORADO BDN100",129000,129000,0,0
TIKI,tui-thoi-trang-nam,49208826,"Túi Đeo Chéo Nam Da Bò Sunpolo STU102",990000,990000,0,0
TIKI,tui-thoi-trang-nam,10385567,"Ví Nam SAM Leather HNK01",550000,550000,0,0
TIKI,tui-thoi-trang-nam,25748224,"Ví Da sọc Caro, Đựng Chìa Khóa ô tô, Xe Máy",180000,180000,0,0
TIKI,tui-thoi-trang-nam,196156253,"Ví Da Nam VD06 Kiểu Đứng Nhỏ Gọn Cao Cấp",38000,50000,12000,24
TIKI,tui-thoi-trang-nam,173542370,"Ví Cầm Tay Nam Da Bò Hàng Hiệu POLO MEISDO Sang Trọng Lịch Lãm PL 06",1800000,1800000,0,0
TIKI,tui-thoi-trang-nam,188750941,"Túi Xách Nam Da Bò Cao Cấp Có Quai Đeo Màu Đen, Màu Nâu Đỏ WT Leather WINE",6500000,6500000,0,0
TIKI,tui-thoi-trang-nam,58173294,"Ví Nam Da Cá Sấu. Ví 2 Mặt Đan Viền Thủ Công - Dáng Ngang Dễ Sử Dụng",868000,1291000,423000,33
TIKI,tui-thoi-trang-nam,174589603,"Ví nam cầm tay da thật HOMME – EVM18",1099000,1099000,0,0
TIKI,tui-thoi-trang-nam,135815742,"Túi đeo chéo nam nam nữ unisex thời trang BEEGEE 068 - tui deo cheo nam - tui deo cheo nu",75000,150000,75000,50
TIKI,tui-thoi-trang-nam,51832104,"Túi xách da bò nam công sở cao cấp",333000,369000,36000,10
TIKI,tui-thoi-trang-nam,44094771,"Ví Nam Da Cá Sấu Thật 100%",99000,99000,0,0
TIKI,tui-thoi-trang-nam,68303291,"Cặp văn phòng laptop đeo chéo đeo vai 4 kiểu phong cách mới MN4 Tặng móc khóa nam cao cấp",123000,174537,51537,30
TIKI,tui-thoi-trang-nam,107962615,"Bóp ví nam da thời trang đa năng nhiều ngăn tiện dụng đầy nam tính kiểu ngang đen",39000,39000,0,0
TIKI,tui-thoi-trang-nam,14279871,"Túi Đeo Chéo Nam Thời Trang",275000,275000,0,0
TIKI,tui-thoi-trang-nam,481722,"Túi Đeo Chéo Ipad Mikkor Betty Tablet BT004 - Xám Nhạt",249000,249000,0,0
TIKI,tui-thoi-trang-nam,149179058,"Túi đeo chéo nam da bò cao cấp YILIDAISHU T32 27x25x6cm(Nâu - Đen)",792000,792000,0,0
TIKI,tui-thoi-trang-nam,122230271,"Ví Da Nam Cao Cấp Chuẩn Da Bò Sáp Thể Hiện Đẳng Cấp",168000,336000,168000,50
TIKI,tui-thoi-trang-nam,94347674," Túi đeo chéo nam da cao cấp Kangaroo - RiBi shop",255000,255000,0,0
TIKI,tui-thoi-trang-nam,109126639,"Ví nam da bò chân kim da bò thật, Bóp ngang nam da bò chân kim",99000,99000,0,0
TIKI,tui-thoi-trang-nam,149180039,"Túi đeo chéo nam công sở BAODIDAISHU kiểu túi ngang thời trang đựng vừa A4, Ipad da bò cao cấp T74 KT 33x25x7cm",900000,900000,0,0
TIKI,tui-thoi-trang-nam,143038636,"Ví dài da bò Anh Tho Leather - BD19",459000,525000,66000,13
TIKI,tui-thoi-trang-nam,89179125,"Túi đeo chéo messenger FTDCIPAD- túi đeo công sở cao cấp cho nam nữ có nhiều ngăn đựng ipad mini sổ sách a4 điện thoại, làm từ vải oxford chống nước- BH 12 THÁNG",365000,365000,0,0
TIKI,tui-thoi-trang-nam,74886398,"Ví da thật phom ngang đựng name card LATA LVN76 nhiều màu (DàI 8cm x Rộng 0.5cm x Cao 11.5cm)",210000,210000,0,0
TIKI,tui-thoi-trang-nam,28250965,"Ví nam kiểu dài cầm tay da trơn đơn giản",175000,175000,0,0
TIKI,tui-thoi-trang-nam,56812802,"Ví nam da bò cao cấp phong cách mới hiện đại",423000,470000,47000,10
TIKI,tui-thoi-trang-nam,176686195,"Túi đeo chéo nam vải dù Oxford chống nước cao cấp size 27cm",99000,99000,0,0
TIKI,tui-thoi-trang-nam,32370253,"Ví Cầm Tay Nam Da PU Cao Cấp Chống Nước Bản To A716 - Đen",255000,255000,0,0
TIKI,tui-thoi-trang-nam,176753345,"Ví Da Nam Bóp Da Nam Cao Cấp EINHORN EI03",190000,200000,10000,5
TIKI,tui-thoi-trang-nam,106659595,"TÚI ĐEO CHÉO NAM DA (ĐEN) NU3 KDR-TDC288",121000,169125,48125,28
TIKI,tui-thoi-trang-nam,20881753,"Ví Nam Dài Cầm Tay - Ví Cầm Tay Dài Nam Thời Trang",165000,165000,0,0
TIKI,tui-thoi-trang-nam,74550219,"Túi đeo chéo nam chất da Pu cao cấp cực đẹp KN1006",185000,185000,0,0
TIKI,tui-thoi-trang-nam,177145223,"Ví Da Nam Bóp Da Cao Cấp Sang Trọng EINHORN EI05B",195000,330000,135000,41
TIKI,tui-thoi-trang-nam,9821513,"Ví bóp Nam phong cách",143550,207350,63800,31
TIKI,tui-thoi-trang-nam,197540212,"Túi xách nam Oscar - OCMHBLG042",7900000,7900000,0,0
TIKI,tui-thoi-trang-nam,61292751,"Ví Nam Da Bò SAM Leather – Bóp Da Nam cao cấp SAM018",650000,650000,0,0
TIKI,tui-thoi-trang-nam,21560454,"Túi Xách Công Sở NamMikkor The Ralph Briefcase",690000,690000,0,0
TIKI,tui-thoi-trang-nam,66791433,"Túi đeo chéo nam nữ chống thấm nước đi học đi chơi đựng vừa laptop 15.6 ich",240000,240000,0,0
TIKI,tui-thoi-trang-nam,126901993,"Túi Đeo Chéo Nam Da Thật Cao Cấp SUNPOLO STU102 (Đen, Nâu, Nâu Bò)",990000,990000,0,0
TIKI,tui-thoi-trang-nam,248546613,"Ví nam khắc tên da bò thật Taiga cao cấp LIDAN, bóp dáng ngang có hộp vintage kèm thiệp đẹp làm quà tặng LD17",469000,469000,0,0
TIKI,tui-thoi-trang-nam,158385592,"Cặp Xách Nam Gence Da Bò Cao Cấp CTS11 Khóa Số",3520000,3520000,0,0
TIKI,tui-thoi-trang-nam,149179264,"Túi xách cặp da bò đựng laptop 14 inch công sở T13 40x30x9cm (Nâu)",900000,900000,0,0
TIKI,tui-thoi-trang-nam,107962057,"Ví nam da thật thời trang cao cấp cho giới trẻ S39-2",15000,15000,0,0
TIKI,tui-thoi-trang-nam,67536791,"Túi Bao Tử Đeo Chéo Thể Thao",37000,52767,15767,30
TIKI,tui-thoi-trang-nam,481730,"Túi Đeo Chéo Ipad Mikkor Betty Tablet BT005 - Camo ",203000,203000,0,0
TIKI,tui-thoi-trang-nam,148850139,"Ví nam đựng thẻ Arctic Hunter Q00013 thiết kế nhiều ngăn, chống nước, chống xước",99000,185000,86000,46
TIKI,tui-thoi-trang-nam,170181753,"Ví nam, bóp nam dài cầm tay da thật, mềm, mỏng, cao cấp kiểu dáng đẹp, phong cách thời trang đang được ưa chuộng",189000,189000,0,0
TIKI,tui-thoi-trang-nam,106655788,"Ví nam, ví da, ví cầm tay, ví đa năng, ví dài, ví đựng tiền, ví mắt, ví đôi mắt, ví mắt nam, ví nữ, ví nam thời trang",165000,165000,0,0
TIKI,tui-thoi-trang-nam,126797662,"Ví Nam Dáng Đứng Gập 3 Da Bò Cao Cấp Nhiều Ngăn Tiện Lợi Bóp Nam Công Sở Phong Cách Sang Trọng Full Box -B21 Shoemaker",199000,199000,0,0
TIKI,tui-thoi-trang-nam,149179303,"Túi đeo chéo nam da bò cao cấp, túi đựng ipad, hồ sơ tài liệu BAODIDAISHU MS01 (ĐEN-NÂU) KT 26x23x7 - 32x25x8cm",900000,900000,0,0
TIKI,tui-thoi-trang-nam,24410193,"Ví Da Bò Cao Cấp Nam Dòng Sản Phẩm Cho Quý Ông Lịch Lảm BA0005",99000,99000,0,0
TIKI,tui-thoi-trang-nam,76657266,"Túi messenger ipad cao cấp Fimax, túi đéo chéo nam đựng ipad chất liệu vải oxford chống thấm với có nhiều ngăn đựng đồ tiện lợi dùng để đeo đi làm đi học đi chơi",349000,349000,0,0
TIKI,tui-thoi-trang-nam,137238525,"Túi đeo chéo chống thấm nước 5 ngăn cao cấp size 24cm",99000,99000,0,0
TIKI,tui-thoi-trang-nam,173542396,"Ví Da Bò Nam Cao Cấp Hàng Hiệu POLO MEISDO Sang Trọng ( Da Bò Thật 100%)",1200000,1200000,0,0
TIKI,tui-thoi-trang-nam,96067481,"Túi đeo hông đeo bụng chống thấm nước tiện dụng cho nam nữ",37000,52767,15767,30
TIKI,tui-thoi-trang-nam,113168817,"Ví cầm tay nam Gianni Conti Italy VP0176DBR - màu nâu",3300000,3300000,0,0
TIKI,tui-thoi-trang-nam,53282253,"BAO DA HỘ CHIẾU (Passport) - CHÍNH HÃNG KHẮC TÊN",500000,500000,0,0
TIKI,tui-thoi-trang-nam,213676659,"Ví nam mini kiểu đứng nhiều ngăn bỏ túi nhỏ gọn K9101",105000,210000,105000,50
TIKI,tui-thoi-trang-nam,185994646,"Túi xách túi đeo chéo nam công sở da bò thật cao cấp phong cách cá tính mới",765000,850000,85000,10
TIKI,tui-thoi-trang-nam,192034009,"Túi Nam đeo chéo đeo vai vải chống thấm - T0302",320000,320000,0,0
TIKI,tui-thoi-trang-nam,230079477,"Bóp ví nam nữ đựng thẻ ATM, Card Visit nhỏ gọn AUKULASIC chống trộm thông minh mẫu VBD36",278000,278000,0,0
TIKI,tui-thoi-trang-nam,271086705,"[VOUCHER 30K] Cặp da nam công sở phối ngăn LATA CA38",890000,890000,0,0
TIKI,tui-thoi-trang-nam,153011026,"Túi đeo chéo nam cao cấp phong cách HÀN QUỐC BEE GEE DCN9019",210000,420000,210000,50
TIKI,tui-thoi-trang-nam,114125242,"Ví nam da thật Lata LVN98",480000,480000,0,0
TIKI,tui-thoi-trang-nam,66704444,"Clutch Cầm Tay Nam Nữ P101 Dập Hoa Văn Cực Đẹp",267000,267000,0,0
TIKI,tui-thoi-trang-nam,4170175,"Túi Đeo Chéo Một Quai In Hình Music",62500,62500,0,0
TIKI,tui-thoi-trang-nam,193546263,"Bóp Nam Da Bò SÁP Họa Tiết Polka Dot, Size Lớn, Thiết Kế Cổ Điển, Đơn Giản - Mỏng Nhẹ, Dáng Ngang - Gập 2, Ngăn Đựng Tiền Có Khóa Kéo, Nhiều Ngăn Để Giấy Tờ Tiện Dụng",879000,899000,20000,2
TIKI,tui-thoi-trang-nam,4816673,"Túi đựng Ipad Hasun HS-620",209000,241000,32000,13
TIKI,tui-thoi-trang-nam,66823954,"Ví đựng thẻ , card nhiều ngăn",42000,42000,0,0
TIKI,tui-thoi-trang-nam,7998643,"Cặp xách da nam - Túi xách nam công sở 6115 tặng kèm ví da",199000,199000,0,0
TIKI,tui-thoi-trang-nam,72907789,"Túi Đeo thắt lưng mini soldier KI053 Tặng móc khóa cá heo",62000,87945,25945,30
TIKI,tui-thoi-trang-nam,52195323,"Túi xách nam da bò công sở cao cấp",659000,950000,291000,31
TIKI,tui-thoi-trang-nam,76156635," capdakhoaso1 - D1: 39 x 29 x 10 Cm",827000,827000,0,0
TIKI,tui-thoi-trang-nam,68378363,"Ví Nam Dài Cầm Tay - Ví Bóp Cầm Tay Dài Nam Thời Trang tiện lợi",195000,195000,0,0
TIKI,tui-thoi-trang-nam,41413478,"Cặp công sở aptop đeo chéo mẫu mới ngang đỏ trên MK2 Shalla",156813,165066,8253,5
TIKI,tui-thoi-trang-nam,179986618,"Ví Da Nam Cầm Tay 1 Ngăn Sang Chảnh",82000,160000,78000,49
TIKI,tui-thoi-trang-nam,187831174,"Túi đeo chéo nam vải cao cấp chống bán bẩn bán bụi, bền đẹp không phai màu TUI-55",179000,179000,0,0
TIKI,tui-thoi-trang-nam,192563908,"Túi Da Bò Đeo Chéo - Túi Da Đeo Chéo  Shinkozi TDC10 Da Bò Thật 100%",1390000,1390000,0,0
TIKI,tui-thoi-trang-nam,91344083,"Cặp công sở nam nữ - Cặp văn phòng, xách tay đi làm, nhẹ-bền-nhiều ngăn C31053[Miti]",384230,499000,114770,23
TIKI,tui-thoi-trang-nam,36999790,"Túi đeo chéo nam nữ thể thao chạy bộ Haosua cao cấp Shalla",147510,213070,65560,31
TIKI,tui-thoi-trang-nam,141236997,"Ví cầm tay nam da cao cấp dạng hộp bảng lớn vân tròn KC54 Shalla Tặng bút cảm ứng ĐT",128700,185900,57200,31
TIKI,tui-thoi-trang-nam,90431424,"VÍ NAM CẦM TAY NHIỀU NGĂN TIỆN LỢI",58393,61466,3073,5
TIKI,tui-thoi-trang-nam,186209241,"COHIBA QU8 - Bao Da Cigar Cao Cấp Sang Trọng, Hộp Đựng Nhiều Ngăn, Túi Da Đựng Bảo Quản Giữ Ẩm",385000,385000,0,0
TIKI,tui-thoi-trang-nam,162575288,"Clutch Nam Cầm Tay Gence Cao Cấp, Ví Cầm Tay Nam Da Bò RB06 Khóa Vân Tay",2500000,2500000,0,0
TIKI,tui-thoi-trang-nam,51690048,"Túi xách da nam công sở chất lượng cao",299000,299000,0,0
TIKI,tui-thoi-trang-nam,206250139,"Ví da nam . ví nam cao cấp Full hộp WilliamPOLO -  V36",505000,505000,0,0
TIKI,tui-thoi-trang-nam,197883132,"Ví Nam Đứng Nhỏ Gọn, Da Bò SÁP - Vân Tự Nhiên, Size Trung, Thiết Kế Cổ Điển, Đơn Giản - Mỏng Nhẹ, Dáng Đứng - Gập 2, Ngăn Đựng Tiền Có Khóa Kéo, Nhiều Ngăn Để Giấy Tờ Tiện Dụng",880000,899000,19000,2
TIKI,tui-thoi-trang-nam,58911180,"Cặp Nam Công Sở Gianni Conti Italy 58126NAV",7500000,7500000,0,0
TIKI,tui-thoi-trang-nam,125423455,"Túi chéo da bò Biker nâu đen - Manuk Leather Design - Da sáp ngựa điên",950000,950000,0,0
TIKI,tui-thoi-trang-nam,45571304,"Túi đeo chéo nam DN009",279000,279000,0,0
TIKI,tui-thoi-trang-nam,6072307,"Túi đeo chéo caro nam nữ tiện ích - xám",23750,25000,1250,5
TIKI,tui-thoi-trang-nam,193394079,"Túi Đeo Chéo Nam Nữ Vải OxFord Túi Bố Cao Cấp Nhiều Ngăn Chống Thấm Nước, Túi Đeo Vai Phong Cách Thời Trang Hàn Quốc, Túi Đựng Ipad Điện Thoại Đa Năng",145000,145000,0,0
TIKI,tui-thoi-trang-nam,186208860,"Túi xách nam công sở, cặp da nam đựng laptop và tài liệu cao cấp GCE23",2800000,2800000,0,0
TIKI,tui-thoi-trang-nam,119976867,"Cặp Xách Nam Khóa Số Da Bò CTS07",3850000,3850000,0,0
TIKI,tui-thoi-trang-nam,52608879,"Ví Da Havias đứng Gen8 Handcrafted Wallet",364000,455000,91000,20
TIKI,tui-thoi-trang-nam,158383428,"Cặp Xách Da Nam Công Sở Gence Khóa Số Cao Cấp CTS09",4620000,4620000,0,0
TIKI,tui-thoi-trang-nam,193201326,"Túi Da Đeo Chéo Nam Cao Cấp Nhiều Ngăn Chống Thấm Nước, Túi Đeo Vai Phong Cách Thời Trang Hàn Quốc Dành Cho Người Đi Làm, Học Sinh, Sinh Viên,Người Đi Chơi, Đi Du Lịch",95000,95000,0,0
TIKI,tui-thoi-trang-nam,66721950,"Ví Nam Da Bò SAM Leather - Ví Ngang Nam Nữ Da Bò Cao Cấp",389000,389000,0,0
TIKI,tui-thoi-trang-nam,53104227,"Combo 3 Túi Đeo Chéo Nam HARAS CBHR83VN (26 x 17 cm)",300000,300000,0,0
TIKI,tui-thoi-trang-nam,152868978,"Clutch Nam Ví Da Cầm Tay Thời Thượng GENCE HT02 Da Bò Cao Cấp Màu Đen",1600000,1600000,0,0
TIKI,tui-thoi-trang-nam,193720540,"TÚI ĐEO CHÉO ĐỰNG IPAD ĐA CHỨC NĂNG",450000,450000,0,0
TIKI,tui-thoi-trang-nam,116184832,"Bao Da giữ ẩm tiện ích đa năng sang trọng Bao Da cao cấp Giữ ẩm bền đẹp DH-DGT2010",1199000,1199000,0,0
TIKI,tui-thoi-trang-nam,80879071,"Túi đeo chéo _ túi bao tử da nam _ nữ SEAGLE SGB02",420000,420000,0,0
TIKI,tui-thoi-trang-nam,181794255,"Cặp da nam công sở cao cấp _ Cặp đựng laptop T19 38x27x6cm",315000,315000,0,0
TIKI,tui-thoi-trang-nam,186254687,"Túi đeo chéo Thời Trang cao cấp – 1400",140000,280000,140000,50
TIKI,tui-thoi-trang-nam,173542322,"Ví Da Bò Nam Cao Cấp Hàng Hiệu POLO MEISDO (Da Thật 100%) Full Hộp Phù Hợp Làm Quà Biếu Tặng Sinh Nhật Bảo Hành 24 Tháng",1200000,1200000,0,0
TIKI,tui-thoi-trang-nam,16170021,"Ví da bò đựng Name Card Vinalea NCA0006G",98000,98000,0,0
TIKI,tui-thoi-trang-nam,13334786,"Ví cầm tay nam Sang Trọng – cỡ lớn đựng được nhiều đồ",225000,225000,0,0
TIKI,tui-thoi-trang-nam,91447658,"Cặp Túi Da Nam C70",1404000,1404000,0,0
TIKI,tui-thoi-trang-nam,173542432,"Ví Da Bò Nam Cao Cấp Hàng Hiệu POLO MEISDO Sang Trọng ( Da Bò Thật 100%) Làm Quà Biếu Tặng Sinh Nhật BH 2 Năm",1000000,1000000,0,0
TIKI,tui-thoi-trang-nam,76157012," capdakhoaso1 - Nhận hàng sau 9 ngày",970000,970000,0,0
TIKI,tui-thoi-trang-nam,111868700,"Túi đeo chéo,đeo ngực du lịch Arctic Hunter XB00116 chất liệu Oxford chống thấm nước thiết kế nhiều ngăn tiện dụng",515000,849000,334000,39
TIKI,tui-thoi-trang-nam,847441,"Túi Đeo Chéo Nam Chống Trộm HARAS HRTK196 (31 x 18 cm) - Đen",170000,170000,0,0
TIKI,tui-thoi-trang-nam,59044393,"Ví nam kẹp bảng dài thời trang hình mắt cú cao cấp",58505,84507,26002,31
TIKI,tui-thoi-trang-nam,188996094,"Bao da dành cho Chìa Khóa Honda SH 2021 (2 nút bấm), SH 2022, SH 350i, SH Mode, Lead, Cub, Winner X, AB 2022, PCX 160, Vario 160",130000,130000,0,0
TIKI,tui-thoi-trang-nam,28022147,"Ví tiền nam dáng đứng nam tính",100000,100000,0,0
TIKI,tui-thoi-trang-nam,184787634,"Túi da bò đựng laptop cao cấp",2490000,2490000,0,0
TIKI,tui-thoi-trang-nam,95394027,"Túi đeo chéo Army cao cấp (kèm hình thật kế bên) 208128",92000,113000,21000,19
TIKI,tui-thoi-trang-nam,35396256,"Túi đeo hông kiểu lính kèm dây đeo chéo",141750,141750,0,0
TIKI,tui-thoi-trang-nam,184300240,"Túi Nam Đeo Chéo Đeo Hông Da Bò BT04 Cực Hot",259000,518000,259000,50
TIKI,tui-thoi-trang-nam,147921525,"Túi Đeo Chéo Nam BT05 Kiểu Dáng Bao Tử Trẻ Trung Hiện Đại",259000,480000,221000,46
TIKI,tui-thoi-trang-nam,56657787,"Túi đeo chéo JUNIOR COMPANY",319000,319000,0,0
TIKI,tui-thoi-trang-nam,77703757,"Túi Đeo bao tử, nịt bụng đeo chéo đa năng cao cấp ngang kéo Tian GG032 Tăng móc khóa nam cao cấp",75000,106887,31887,30
TIKI,tui-thoi-trang-nam,52608908,"Ví Da Havias Gapple2 Handcrafted Mini Wallet",280000,350000,70000,20
TIKI,tui-thoi-trang-nam,89786103,"Túi Đeo Chéo Nam Khóa Phản Quang Phong Cách Streetwear, Túi Bao Tử Nam Kháng Nước TC98",72000,101475,29475,29
TIKI,tui-thoi-trang-nam,74775350," Bóp Ngang Gai Lưng Cá Sấu 2 Mặt Đan Viền Rất Đẹp VS2V01",818000,1291000,473000,37
TIKI,tui-thoi-trang-nam,13564408,"Cặp công sở nam da bò BHM9005",1450000,1450000,0,0
TIKI,tui-thoi-trang-nam,183088964,"Túi xách tay da bò sáp crazy horse- Cặp đựng Laptop, túi xách công sở",850000,850000,0,0
TIKI,tui-thoi-trang-nam,71902643,"Bộ Đôi Ví Couple Gerbera & Venuta Black Da Thật_HAVIAS",756000,945000,189000,20
TIKI,tui-thoi-trang-nam,16169505,"Ví đứng Nam da bò may thủ công handmade cực sắc xảo Vinalea VND0006D",155000,155000,0,0
TIKI,tui-thoi-trang-nam,173542535,"Ví Cầm Tay Da Bò Cao Cấp Hàng Hiệu POLO MEISDO Da Bò Thật 100%",1800000,1800000,0,0
TIKI,tui-thoi-trang-nam,13645245,"Túi đeo chéo nam nữ unisex thời trang Bee Gee 02 - ĐEN",65000,130000,65000,50
TIKI,tui-thoi-trang-nam,68309814,"ví nam - ví nam cầm tay cao cấp",269000,298000,29000,10
TIKI,tui-thoi-trang-nam,120033038,"Bóp da cá sấu Huy Hoàng nhiều ngăn nguyên con nhiều màu HP3212-13-14-70",2999000,2999000,0,0
TIKI,tui-thoi-trang-nam,179941566,"Túi Đeo Chéo Bao Tử Nam Da Bò Thời Trang Hiện Đại Cực Đẹp",180000,360000,180000,50
TIKI,tui-thoi-trang-nam,157147498,"Bộ khăn Ascot Cổ Điển kèm khăn cài túi - Khăn Quàng Trong Áo Sơ Mi",320000,320000,0,0
TIKI,tui-thoi-trang-nam,205232972,"Bao da dành cho bọc ốp chìa khoá xe ô tô KIA Cerato 2019 2021 da bò nhiều màu khâu thủ công KIA12",170000,170000,0,0
TIKI,tui-thoi-trang-nam,52333333,"Túi Đeo Chéo Thời Trang Hàn Quốc HARAS HR264",150000,150000,0,0
TIKI,tui-thoi-trang-nam,16278504,"Bóp Ví Nam Da Bò Thật",159000,159000,0,0
TIKI,tui-thoi-trang-nam,5918881,"Combo 2 Túi May Đeo Chéo Thể Thao",109000,109000,0,0
TIKI,tui-thoi-trang-nam,141304874,"1 TÚI ĐEO NGANG HÔNG CÓ NHIỀU NGĂN ĐỰNG PHỤ KIỆN TIỆN DỤNG HÀNG CAO CẤP LOẠI TỐT",168000,168000,0,0
TIKI,tui-thoi-trang-nam,84892610,"Túi đeo chéo Clownz",249000,249000,0,0
TIKI,tui-thoi-trang-nam,186209258,"Túi xách nam công sở, cặp da nam đựng laptop và tài liệu cao cấp GCE24",2800000,2800000,0,0
TIKI,tui-thoi-trang-nam,149179734,"Túi xách cặp da đựng laptop da bò cao cấp T36 38x27.5x7cm (Nâu đậm - Nâu sáng - Đen) D.HSTORE",1020000,1020000,0,0
TIKI,tui-thoi-trang-nam,180730225,"Ví Da Cầm Tay Nam 1 Ngăn Siêu Đẹp Siêu Nam Tính",82000,160000,78000,49
TIKI,tui-thoi-trang-nam,15735433,"Ví da bò đựng Name Card  Vinalea NCA0001F - Nâu đỏ",98000,98000,0,0
TIKI,tui-thoi-trang-nam,40056994,"Ví Da Bò Nam Nữ Khâu Viền Khắc Hình Luffy ( One Piece )",290000,290000,0,0
TIKI,tui-thoi-trang-nam,248546677,"Ví nam da bò thật Nappa cao cấp LIDAN, bóp dáng ngang có hộp vintage kèm thiệp đẹp làm quà tặng LD20",459000,459000,0,0
TIKI,tui-thoi-trang-nam,80946593,"[Da thật] Túi đeo hông, túi bao tử da bò thật Crazy horse TD106 - 100% da bò thật, BH 3 năm",390000,390000,0,0
TIKI,tui-thoi-trang-nam,54828790,"Ví nam cao cấp da thật ELLY- EVM10 đen",799000,799000,0,0
TIKI,tui-thoi-trang-nam,59116682,"Túi Đeo Chéo Chống Nước Mềm Mại Thể Thao SPO1 - Màu Xanh",58000,81211,23211,29
TIKI,tui-thoi-trang-nam,189267895,"Túi xách nam da PU cao cấp thời trang công sở YVan 2050-5",650000,650000,0,0
TIKI,tui-thoi-trang-nam,84331166,"Ví Nam Đứng Da Cá Sấu Thật CW01-02L",1100000,1100000,0,0
TIKI,tui-thoi-trang-nam,99667516,"Xả hàng COMBO VÍ + THẮT LƯNG có TÚI HỘP ĐỰNG Y HÌNH",99000,99000,0,0
TIKI,tui-thoi-trang-nam,193720588,"TÚI ĐEO CHÉO BAO TỬ CARO THỜI TRANG",350000,350000,0,0
TIKI,tui-thoi-trang-nam,58210087,"Cặp nam công sở cao cấp BHM7355 Da bò nguyên tấm. Túi xách công sở nam. Vừa laptop 14inch,phom cứng. Sang trọng, lịch lãm",1999999,1999999,0,0
TIKI,tui-thoi-trang-nam,36628186,"VÍ NAM CAO CẤP DA ĐÀ ĐIỂU SP-01",395000,395000,0,0
TIKI,tui-thoi-trang-nam,54645206,"Cặp công sở nam MARRANT BHM2099 Da bò thật, vừa laptop 14inch, có khe cài vali, chính hãng.",799000,799000,0,0
TIKI,tui-thoi-trang-nam,249743040,"Ví Cầm Tay Nam Da Bò Thật CT01 Cao Cấp Sang Trọng Nhiều Ngăn Đựng Điện Thoại Bóp Dài Nam Kiểu Dáng Hàn Quốc",250000,250000,0,0
TIKI,tui-thoi-trang-nam,140511608,"Ví Da Nam TRAZ Cực Chất, Bóp Nam Cầm Tay Thời Trang Hàn Quốc",99000,99000,0,0
TIKI,tui-thoi-trang-nam,188994200,"Bao da dành cho Chìa Khoá Ép Phom Lexus handmade da thật (Lexus RX, GX, LX, ES...) 001e",350000,350000,0,0
TIKI,tui-thoi-trang-nam,95394269," Túi đeo chéo nam nữ phong cách quân đội Army 208128",111800,111800,0,0
TIKI,tui-thoi-trang-nam,52876113,"VÍ SEN ÔTÔ - CHÍNH HÃNG KHẮC TÊN",750000,750000,0,0
TIKI,tui-thoi-trang-nam,21024849,"Ví Da Nam cầm tay Gianni Conti Italy 912132DBR - Nâu",4200000,4200000,0,0
TIKI,tui-thoi-trang-nam,155040273,"Combo Cặp công sở DA CÁ SẤU và ví nam BÀN TAY CÁ SẤU VN1602",1250000,2500000,1250000,50
TIKI,tui-thoi-trang-nam,197046803,"Ví da nam cao cấp hiệu Việt Tiến - Bóp nam dáng ngang khóa kéo da thật Viettien",750000,750000,0,0
TIKI,tui-thoi-trang-nam,69862059,"Túi để điện thoại đeo thắt lưng phong cách phái mạnh",99000,99000,0,0
TIKI,tui-thoi-trang-nam,44000845,"Cặp Da Công Sở LATA CA25",720000,720000,0,0
TIKI,tui-thoi-trang-nam,90502326,"Túi đeo chéo nam vải Oxford chống thấm nước",672100,672100,0,0
TIKI,tui-thoi-trang-nam,73535303,"Túi đeo chéo Fashion thời trang nam nữ, túi đeo ngực vải Canvas nhiều ngăn tiện ích",55000,55000,0,0
TIKI,tui-thoi-trang-nam,54000399,"Túi đeo vai chéo đeo bụng TĐ 5520 dạng lớn thời trang K06",114000,161345,47345,29
TIKI,tui-thoi-trang-nam,188017981,"Clutch, Ví Cầm Tay Thời Trang Nam Da Bò Alran Cao Cấp HT17 Xanh",1600000,1600000,0,0
TIKI,tui-thoi-trang-nam,192122688,"VÍ NAM CẦM TAY VALENTINO CREATIONS-LPF-210216SL-DBN - 1",10990000,10990000,0,0
TIKI,tui-thoi-trang-nam,19922173,"Ví Da Nam SAM Leather SAM002",650000,650000,0,0
TIKI,tui-thoi-trang-nam,173542363,"Ví Cầm Tay Da Thật Nam Nữ Cao Cấp Hàng Hiệu POLO MEISDO Bóp Ví Dài Cầm Tay Nam Nữ Sang Trọng Full Hộp",1400000,1400000,0,0
TIKI,tui-thoi-trang-nam,92922351,"Kẹp tiền từ tính đựng thẻ đa năng BlackMan Money Clip RFID",290000,290000,0,0
TIKI,tui-thoi-trang-nam,96032741,"Túi đeo chéo nam nữ phong cách quân đội Army",150000,150000,0,0
TIKI,tui-thoi-trang-nam,146449276,"Ví da nam cầm tay họa tiết đan , clutch nam cầm tay , bóp nam cầm tay",350000,350000,0,0
TIKI,tui-thoi-trang-nam,20115926,"Ví đựng name card Slim",160000,160000,0,0
TIKI,tui-thoi-trang-nam,143112607,"Túi Crossbody Oxford HAVIAS_Túi Bao Tử Đen (Black)",280000,350000,70000,20
TIKI,tui-thoi-trang-nam,72566191,"Túi Đeo Vai - Túi Đeo Chéo Da Cá Sấu Thanh Lịch SPC1",220000,220000,0,0
TIKI,tui-thoi-trang-nam,149179843,"Túi đeo chéo nam da cá sấu cao cấp T48 (KT:26.5x17x7cm) Bảo hành da 12 tháng (Nâu đậm-Nâu sáng)",1260000,1260000,0,0
TIKI,tui-thoi-trang-nam,73493109,"[Da thật} Túi đeo chéo mini kết hợp đeo hông da bò thật TD103 - 100% da bò thật, BH 3 năm",199000,199000,0,0
TIKI,tui-thoi-trang-nam,185468175,"bóp ví nam ngắn cầm tay nhiều ngăn chất da cao cấp thời trang châu Âu sành điệu - D3216",148000,219000,71000,32
TIKI,tui-thoi-trang-nam,149970506,"Ví Da Cá Sấu Nam Màu Nâu {DA CÁ SẤU THẬT} - Ví Nam Da Cá Sấu Có Khoá Kéo Cao Cấp Dáng Ngang Thời Trang",445000,890000,445000,50
TIKI,tui-thoi-trang-nam,102905124,"ví da name card",329000,329000,0,0
TIKI,tui-thoi-trang-nam,81116907," Túi xách da đựng laptop, cặp sách công sở",927000,927000,0,0
TIKI,tui-thoi-trang-nam,109949772,"Ví Unisex THE MAIL WALLET Da Thật Vân Saffiano Thương Hiệu DOLANTO",208000,208000,0,0
TIKI,tui-thoi-trang-nam,136816225,"Túi chéo nam da thật cao cấp BEE GEE BLCC ĐỎ",450000,900000,450000,50
TIKI,tui-thoi-trang-nam,83940625,"VÍ DA NAM MINI - ĐỒ DA THỦ CÔNG- DA BÒ NHẬP KHẨU",399000,399000,0,0
TIKI,tui-thoi-trang-nam,103886545,"Ví Nam Bóp Da Cá Sấu Thật Màu Nâu Đất ST06 BH 24 Tháng Tặng Kèm Lót Nhung Cao Cấp",850000,850000,0,0
TIKI,tui-thoi-trang-nam,32843502,"Túi xách công sở nam chất liệu da PU cao cấp DH1801",199000,199000,0,0
TIKI,tui-thoi-trang-nam,169296950,"Ví da nam mini kẹp tiền bỏ túi D10 – Money clip wallet",385000,385000,0,0
TIKI,tui-thoi-trang-nam,213677466,"Ví nam mini kiểu đứng thời trang nam tính B9158",110000,220000,110000,50
TIKI,tui-thoi-trang-nam,89786109,"Túi Đeo Chéo Nam Khóa Phản Quang Phong Cách Streetwear, Túi Bao Tử Nam Kháng Nước TC98 - Đen",96401,101475,5074,5
TIKI,tui-thoi-trang-nam,125182848,"Túi Đeo Chéo Bao Tử Nam Da Bò Trẻ Trung Sành Điệu ",180000,360000,180000,50
TIKI,tui-thoi-trang-nam,66722001,"Ví Nam Da Bò SAM Leather - Ví Đứng Nam Nữ Da Bò Cao Cấp",599000,599000,0,0
TIKI,tui-thoi-trang-nam,171772156,"túi da nam , cặp đựng laptop thời trang B2",827000,827000,0,0
TIKI,tui-thoi-trang-nam,72207505,"Túi Đeo bao tử, nịt bụng đeo chéo đa năng ngang kéo tian TL14 Tặng móc khóa nam",78210,106887,28677,27
TIKI,tui-thoi-trang-nam,53030801,"túi xách nam phong cách lịch lãm D0443 - cặp xách da nam công sở cao cấp",325000,325000,0,0
TIKI,tui-thoi-trang-nam,157254118,"Ví Nam, Nữ Gập Da SAIGON SWAGGER SGS Anthem Leather Fold-Nhiều Ngăn, Đựng Thẻ",490000,490000,0,0
TIKI,tui-thoi-trang-nam,193723764,"Túi Đeo Chéo Nam, Túi Bao Tử Đeo Hông Đeo Ngực Sang Trọng Chống Nước, Chống Xước Nhiều Ngăn Xịn Xò",55000,55000,0,0
TIKI,tui-thoi-trang-nam,193395346,"Clutch, Ví Cầm Tay Thời Trang Nam Da Bò Epsom Cao Cấp HT18 Đen",1490000,1490000,0,0
TIKI,tui-thoi-trang-nam,87354662,"Túi xách laptop, công sở vải canvas MOYYI TXMY004",349200,485000,135800,28
TIKI,tui-thoi-trang-nam,195757042,"Bộ combo ví MoonFest  - CHÍNH HÃNG KHACTEN.COM",2100000,2100000,0,0
TIKI,tui-thoi-trang-nam,95856860,"Cặp Da Nam Công Sở P112 – Phong Cách Hàn Quốc – Trẻ Trung – Thanh Lịch",329000,329000,0,0
TIKI,tui-thoi-trang-nam,192834131,"Túi Đeo Chéo Local Brand Streetwear Unisex Thời Trang Cho Nam và Nữ",179000,179000,0,0
TIKI,tui-thoi-trang-nam,185990735,"Túi đeo chéo nam đa chức năng thời trang cao cấp phong cách mới",261000,290000,29000,10
TIKI,tui-thoi-trang-nam,2132789,"Túi Đeo Ipad Thời Trang Praza DC108 (29 x 18 cm) - Xanh",103000,103000,0,0
TIKI,tui-thoi-trang-nam,180987710,"Ví thời trang da nam cầm tay ngang D06 trẻ trung sang trọng",46000,59000,13000,22
TIKI,tui-thoi-trang-nam,125078612,"Túi đeo hông Marshall Underground Belt Bag - Hàng Chính Hãng",890000,890000,0,0
TIKI,tui-thoi-trang-nam,51299063,"Túi xách da bò nam công sở cao cấp phong cách châu âu",855000,950000,95000,10
TIKI,tui-thoi-trang-nam,7483959,"Túi đeo chéo nam da bò BHM1121",735000,735000,0,0
TIKI,tui-thoi-trang-nam,1689019,"Ví Nam At Leather AT040-N (11.5 x 10 cm) - Nâu",275000,325000,50000,15
TIKI,tui-thoi-trang-nam,137944866,"Ví card da bò thật SEAGLE nhỏ gọn SMV119",169000,169000,0,0
TIKI,tui-thoi-trang-nam,197150834,"Ví nam da bò Nappa hạt phối da Saffiano V111 - Bụi leather - Bảo hành 12 tháng",253000,410000,157000,38
TIKI,tui-thoi-trang-nam,10132275,"Ví nam da bò cao cấp AT Leather 063 - Da bò thuộc Highlight",275000,325000,50000,15
TIKI,tui-thoi-trang-nam,136940004,"Túi đeo chéo thổ cẩm 5 ngăn nam nữ",100000,100000,0,0
TIKI,tui-thoi-trang-nam,149179099,"HOT DEAL - Túi xách cặp da giáo viên đựng laptop 14 inch da bò công sở T23 khóa số (Nâu-Đen) (KT 39x30x10cm.)",1050000,1050000,0,0
TIKI,tui-thoi-trang-nam,23433592,"Túi Đeo Chéo Thời Trang HARAS HR253",79000,79000,0,0
TIKI,tui-thoi-trang-nam,59358594,"Ví nam da bò cao cấp phong cách mới",359000,398000,39000,10
TIKI,tui-thoi-trang-nam,56683624,"Túi đeo chéo nữ nam unisex chống thấm nước dạng rút Hàn quốc BEE GEE 091 du lịch thời trang",55000,110000,55000,50
TIKI,tui-thoi-trang-nam,108254144,"Túi Da Nam Đeo Chéo Mẫu Mới Siêu Bền Đẹp Chống Thấm Nước Phon Dáng Chuẩn Đẳng Cấp Phái Mạnh",179000,179000,0,0
TIKI,tui-thoi-trang-nam,103079576,"Ví Da Epsom Dáng Đứng Handmade Lealux Epsom Wallet 3",689000,689000,0,0
TIKI,tui-thoi-trang-nam,270694206,"Cặp da nam công sở basic LATA CA41",830000,830000,0,0
TIKI,tui-thoi-trang-nam,161954571,"Túi Xách Công Sở Nam Gence Da Bò Saffiano CDX11",3080000,3080000,0,0
TIKI,tui-thoi-trang-nam,43740661,"Ví Da Nam Cao Cấp Basic OneCF",296000,296000,0,0
TIKI,tui-thoi-trang-nam,182850614,"TÚI ĐEO CHÉO NAM CÔNG SỞ THƯƠNG HIỆU K2 BRAND VẢI CANVAS THỦ CÔNG CAO CẤP NHIỀU NGĂN ĐA NĂNG",479000,479000,0,0
TIKI,tui-thoi-trang-nam,136462840,"Ví dài cầm tay cao cấp",99900,99900,0,0
TIKI,tui-thoi-trang-nam,110818090,"️ Ví đựng chìa khóa, ví đựng thẻ 40508",231000,231000,0,0
TIKI,tui-thoi-trang-nam,51566434,"Cặp công sở đa năng LATA CA30 nhiều màu",599000,750000,151000,20
TIKI,tui-thoi-trang-nam,49516673,"Ví Dáng Dai Gấp 2 Cao Cấp Unisex ",850000,850000,0,0
TIKI,tui-thoi-trang-nam,168955216,"Ví nam đứng da bò cao cấp LuxWear bảo hành 15 tháng VD01",89000,89000,0,0
TIKI,tui-thoi-trang-nam,68397713,"Túi đeo chéo đeo bụng nam thời trang",199500,199500,0,0
TIKI,tui-thoi-trang-nam,107962695,"Ví Da Nam Cầm Tay Đẳng Cấp Doanh Nhân",339000,339000,0,0
TIKI,tui-thoi-trang-nam,176130462,"Ví nam đựng thẻ ATM mini bằng hợp kim nhôm MB25",178000,178000,0,0
TIKI,tui-thoi-trang-nam,54902648,"Ví Nam Da Cá Sấu Thật  BIGGBEN Cao Cấp BG6",999000,999000,0,0
TIKI,tui-thoi-trang-nam,165605112,"Cặp Xách Nam Công Sở Gence Da Bò Mill Mềm, Túi Xách Nam Da Bò Khóa Số Cao Cấp CTS13 Màu Nâu | Hàng Chính Hãng",2800000,2800000,0,0
TIKI,tui-thoi-trang-nam,122314866,"Túi Đeo Chéo Nam Mini BT06 Da Đơn Giản Tiện Dụng Đi Học Đi Chơi 2 Màu Nâu Đen",234000,450000,216000,48
TIKI,tui-thoi-trang-nam,146494344,"Bóp ví nam da bò thật SEAGLE dáng ngang cổ điển, sang trọng S1V01",195000,195000,0,0
TIKI,tui-thoi-trang-nam,79583286,"Cặp nam văn phòng da bò thật Marrant BHM17631 Màu Đen Túi xách công sở nam. Vừa laptop 14inch. Hàng chính hãng",1400000,1400000,0,0
TIKI,tui-thoi-trang-nam,188997373,"Bao da dành cho Chìa Khoá New KIA K3 2021 Luxury, Premium, K5, New Sportage 2022, Sorento, cerato logo mới handmade Da Thật 010",200000,200000,0,0
TIKI,tui-thoi-trang-nam,103886721,"Ví Nam Da Cá Sấu Ví Đứng VS02",393000,460000,67000,15
TIKI,tui-thoi-trang-nam,72907861,"Túi Đeo Hông thể thao mini soldier HL10 Tặng móc khóa cá heo",64350,92950,28600,31
TIKI,tui-thoi-trang-nam,50415159,"Túi Đeo Chéo Đứng Vừa Ipad-Màu Ngẫu Nhiên",79000,79000,0,0
TIKI,tui-thoi-trang-nam,186209971,"Túi xách nam công sở, cặp da nam đựng laptop và tài liệu cao cấp GCE26",2800000,2800000,0,0
TIKI,tui-thoi-trang-nam,72946828,"Ví da nam , bóp da nam, ví ngang nam P059",109000,109000,0,0
TIKI,tui-thoi-trang-nam,46695692,"Ví nam Da bò sáp (bóp ví da nam) dáng ngang - Thiết kế và sản xuất bởi La Pelle tại Việt Nam - Màu sắc vàng bò cháy phiên bản 2020",99000,99000,0,0
TIKI,tui-thoi-trang-nam,58964590,"Bóp ví nam và nữ cầm tay da mềm",25000,25000,0,0
TIKI,tui-thoi-trang-nam,177925191,"Túi đeo chéo nam cao cấp phong cách mới BEE GEE – DCN9058",270000,540000,270000,50
TIKI,tui-thoi-trang-nam,158818774,"TÚI XÁCH NAM RETRO MÀU NÂU DA BÒ",299000,299000,0,0
TIKI,tui-thoi-trang-nam,87822175,"Ví Da Bò Pullup wax WS107 Xanh Navy - Kích thước (cm): 12x10x2 cm",250000,250000,0,0
TIKI,tui-thoi-trang-nam,143063283,"Ví nam da bò Anh Tho Leather MIN-03 Cánh lật",395000,460000,65000,14
TIKI,tui-thoi-trang-nam,149567703,"Túi Đeo Chéo Nam Gioi Thương Hiệu Mark Ryden_Anh Quốc, Túi Đeo Chéo 3 Chiều",499000,499000,0,0
TIKI,tui-thoi-trang-nam,138157630,"VÍ ĐỰNG THẺ THÔNG MINH VBA",350000,350000,0,0
TIKI,tui-thoi-trang-nam,194025954,"Túi đeo ngực da cá sấu",3550000,6000000,2450000,41
TIKI,tui-thoi-trang-nam,90113768,"Túi xách da nam cao cấp phong cách hiện đại mới - 9910",349000,599000,250000,42
TIKI,tui-thoi-trang-nam,187512515,"Túi Xách, Cặp Công Sở Thời Trang Nam Da Bò Swift Cao Cấp 2 Khoá GCE23 Nâu",2600000,2600000,0,0
TIKI,tui-thoi-trang-nam,73599730,"Túi bao tử nam BHLX007 Túi đeo bụng, đeo ngực da bò thật, không bong nổ",650000,650000,0,0
TIKI,tui-thoi-trang-nam,192130009,"Túi đeo chéo nam da PU thời trang cao cấp hàng chính hãng YVan",385000,385000,0,0
TIKI,tui-thoi-trang-nam,157254083,"Ví Nam, Nữ Nút Ngắn Da Cao Cấp SAIGON SWAGGER SGS Anthem Leather Short Flap Wallet",450000,450000,0,0
TIKI,tui-thoi-trang-nam,14289211,"Túi Bao Tử Túi Đeo Chéo Nam Da Pu Thời Trang Phái Mạnh 2019 - LKS445",199000,199000,0,0
TIKI,tui-thoi-trang-nam,2750635,"Cặp Xách Da Nam Thời Trang Cao Cấp CNT CA14 Bò Lợt",263000,263000,0,0
TIKI,tui-thoi-trang-nam,203199337,"Túi đeo chéo nam phong cách châu âu",675000,750000,75000,10
TIKI,tui-thoi-trang-nam,191925622,"Túi công sở cao cấp da thật Shinkozi CS08 Da Bò Thật 100%",1900000,1900000,0,0
TIKI,tui-thoi-trang-nam,179013823,"Túi đeo bụng đeo chéoTĐ 520 đa năng cao cấp KT30",95134,137416,42282,31
TIKI,tui-thoi-trang-nam,53289766,"Túi đeo chéo nam nữ ngang ngực - đeo hong V9 thời trang PK010",137750,145000,7250,5
TIKI,tui-thoi-trang-nam,171056563,"Túi đeo chéo nam nữ, túi bao tử, túi đeo ngực, túi đeo bụng da bò thật thương hiệu SEAGLE SB02",450000,450000,0,0
TIKI,tui-thoi-trang-nam,70051251,"túi xách nam da bò thật - túi xách nam da bò thật cao cấp",899000,998000,99000,10
TIKI,tui-thoi-trang-nam,2000349,"Ví Nam Da Bò Cao Cấp Huy Hoàng HT2113 (12.5 x 10 cm) - Da Bò",489000,489000,0,0
TIKI,tui-thoi-trang-nam,198145047,"Túi đeo chéo Nam da bò thật cao cấp - B016A",650000,650000,0,0
TIKI,tui-thoi-trang-nam,81116791,"Túi xách công sở nam",857000,857000,0,0
TIKI,tui-thoi-trang-nam,168227938,"Túi Đeo Chéo Bụng Da Bò Thật Cao Cấp Cá Tính, Túi Bao Tử Da Nam",315000,315000,0,0
TIKI,tui-thoi-trang-nam,34543975,"Ví nam cầm tay da thật ELLY HOMME – EVM2",899000,899000,0,0
TIKI,tui-thoi-trang-nam,136787286,"Ví Cầm Tay Nam Gence Da Bò Cao Cấp Khóa Số  RB07",1300000,1300000,0,0
TIKI,tui-thoi-trang-nam,66825039,"Tuid phụ kiện móc balo hoặc cài thắt lưng",58000,82302,24302,30
TIKI,tui-thoi-trang-nam,49494526,"Ví da bò nam AT Leather H71",355000,420000,65000,15
TIKI,tui-thoi-trang-nam,161560873,"Túi Đeo Chéo Nam Đẹp, Tiện Nghi, Thời Trang Màu Đen 208031",33000,38000,5000,13
TIKI,tui-thoi-trang-nam,2000321,"Ví Nam Huy Hoàng HT2105 (12.5 x 10 cm) - Đen",559000,559000,0,0
TIKI,tui-thoi-trang-nam,167473583,"Ví Nam, Bóp Nam Thời Trang Da Bò EPSOM Cao Cấp Gence HM07",1100000,1100000,0,0
TIKI,tui-thoi-trang-nam,106244993,"Ví Da Bò Sáp Nam Siêu Chất Full Da Bò Xịn",168000,336000,168000,50
TIKI,tui-thoi-trang-nam,167432346,"Túi Xách, Cặp Thời Trang Công Sở Nam Khóa Số Da Bò Cao Cấp CTS13 Nâu",2800000,2800000,0,0
TIKI,tui-thoi-trang-nam,70524026,"Túi bao tử_túi đeo chéo da nam_nữ SEAGLE ST01",330000,330000,0,0
TIKI,tui-thoi-trang-nam,193233694,"Túi Đeo Vai, Túi Đeo Chéo Vải Nylon Cao Cấp Chống Thấm, Túi Đeo Hông Cao Cấp Nhiều Ngăn Tiện Lợi Thời Trang Nam Phong Cách Hàn Quốc",110000,110000,0,0
TIKI,tui-thoi-trang-nam,106244852,"Túi Đeo Chéo Bao Tử Nam Da Bò Cực Đẹp , Siêu Xịn",180000,360000,180000,50
TIKI,tui-thoi-trang-nam,4442449,"Ví Da Nam Mỏng Mền Dẽo Dễ Bỏ Túi  Handmade  màu nâu",299000,299000,0,0
TIKI,tui-thoi-trang-nam,243146016,"Túi phụ kiện da bò thật, túi đeo ngực nam, túi đeo bụng, túi bao tử, túi đeo vai màu đen BEE GEE DCN9022",665000,1330000,665000,50
TIKI,tui-thoi-trang-nam,48219622,"Túi đeo chéo da bò phong cách châu âu",275000,275000,0,0
TIKI,tui-thoi-trang-nam,143063148,"Ví nam da bò Anh Tho Leather MIN-02",395000,460000,65000,14
TIKI,tui-thoi-trang-nam,147896872,"Ví Da Nam Cầm Tay 1 Ngăn Cao Cấp",82000,160000,78000,49
TIKI,tui-thoi-trang-nam,73341295,"BÓP NGẮN GẬP DA SÁP Ví VINTAGE Da Sáp Nhập Khẩu Cao Cấp Chống Thấm Nước Unisex Nam Nữ Chuẩn Leonardo DOLANTO",178000,178000,0,0
TIKI,tui-thoi-trang-nam,183718980,"Túi Nam Đeo Chéo DC01 Chất Liệu Da Cao Cấp Đi Làm Đi Chơi Tiện Lợi Và Gọn Nhẹ",199000,380000,181000,48
TIKI,tui-thoi-trang-nam,6769311,"Ví Card Holder Ví Card Mini Hand Made",280000,280000,0,0
TIKI,tui-thoi-trang-nam,53999685,"Túi đeo bụng đeo chéoTĐ 520 đa năng cao cấp KSX80",114000,161345,47345,29
TIKI,tui-thoi-trang-nam,111869039,"Túi đeo chéo chống trộm Arctic Hunter XB00081 chất liệu Oxford chống thấm nước ,đựng ipad có cổng sạc USB, nhiều ngăn",369000,635000,266000,42
TIKI,tui-thoi-trang-nam,107961978,"Ví Nam Mini Da Bò Sáp Nhập Khẩu - Full Box",179000,179000,0,0
TIKI,tui-thoi-trang-nam,133565700,"Ví Da Bò Thật Nam Cao Cấp Ví Dài V21",540000,540000,0,0
TIKI,tui-thoi-trang-nam,252860101,"[Da thật] Clutch nam da bò thật; Túi cầm tay nam da sáp CL145LS (nâu) - 100% da bò thật",639000,639000,0,0
TIKI,tui-thoi-trang-nam,52602200,"Túi xách nam công sở cao cấp phong cách châu âu",199000,199000,0,0
TIKI,tui-thoi-trang-nam,193970402,"Ví Nam Thời Trang cao cấp – VN1011",500000,1000000,500000,50
TIKI,tui-thoi-trang-nam,69691715,"VÍ XUKA - CHÍNH HÃNG KHACTEN.COM",650000,650000,0,0
TIKI,tui-thoi-trang-nam,481737,"Túi Đeo Chéo Ipad Mikkor Betty Tablet BT006 - Nâu ",203000,203000,0,0
TIKI,tui-thoi-trang-nam,34537526,"Ví nam cầm tay da thật ELLY HOMME – EVM1",999000,999000,0,0
TIKI,tui-thoi-trang-nam,119385359,"Ví nam ngắn 18 ngăn gập 3 WS102LEA - 100% da bò thật",99000,99000,0,0
TIKI,tui-thoi-trang-nam,190184659,"Túi bao tử - đeo chéo unisex nam nữ vải chống nước phong cách Hàn",166250,175000,8750,5
TIKI,tui-thoi-trang-nam,119616519,"Đeo chéo vải bố cao cấp kéo đứng Tặng bút cảm ứng ĐT",38000,54120,16120,30
TIKI,tui-thoi-trang-nam,117393212,"Túi đeo chéo nam nữ da Pu cao cấp  TC09",96000,133608,37608,28
TIKI,tui-thoi-trang-nam,72467878,"Balo Đeo Chéo Da Cao Cấp Nấp Gập Thời Trang Kiểu Dáng Đơn Giản BL-D01",98010,141570,43560,31
TIKI,tui-thoi-trang-nam,79675197,"Túi đeo chéo nam đựng ipad 9.7 vải Oxford chống thấm nước ",463500,463500,0,0
TIKI,tui-thoi-trang-nam,149179742,"Túi đeo chéo nam da bò YUEKANGAROOS T53 (KT:27x23x7cm) Bảo hành da 12 tháng (Nâu-Đen)",660000,660000,0,0
TIKI,tui-thoi-trang-nam,148545259,"Ví da nam dọc D730 cầm tay thời trang cao cấp",64000,69000,5000,7
TIKI,tui-thoi-trang-nam,186254950,"Túi đeo chéo nam cao cấp phong cách HÀN QUỐC BEE GEE– 01390",129000,258000,129000,50
TIKI,tui-thoi-trang-nam,173654411,"Ví Nam Da Cá Sấu Thật BIGGBEN Cao Cấp BG10",1000000,1000000,0,0
TIKI,tui-thoi-trang-nam,133810118,"Túi đeo chéo nam cao cấp BHM8710 Da bò nguyên tấm. Hàng chính hãng.",1199000,1199000,0,0
TIKI,tui-thoi-trang-nam,187512564,"Túi Xách, Cặp Công Sở Thời Trang Nam Da Bò Swift Cao Cấp GCE24 Đen",2600000,2600000,0,0
TIKI,tui-thoi-trang-nam,103886747,"Bóp Cá Sấu Tuấn Minh Ví Nam Da Cá Sấu Gai Lưng Cao Cấp Màu Nâu Cà Phê ST01 Tặng kèm Hộp",750000,750000,0,0
TIKI,tui-thoi-trang-nam,185781988,"Ví Da Bò Nam Cao Cấp Bóp Da Nam POLO MEISDO Full Hộp Phù Hợp Làm Quà Biếu Tặng Sinh Nhật PL31",1500000,1500000,0,0
TIKI,tui-thoi-trang-nam,200853184,"Ví Nam Da Cá Sấu 2 Mặt, Ví  Dáng Đứng Da Cá Sấu Thật Songhan Leather WM01 Làm Từ Da Bụng, Bảo Hành 12 Tháng",1000000,1000000,0,0
TIKI,tui-thoi-trang-nam,174382609,"Túi xách nam công sở da bò cao cấp BEEGEE CCS5511",525000,1050000,525000,50
TIKI,tui-thoi-trang-nam,169653644,"Cặp học sinh đa năng cao cấp Dù Xốp Thái viền chỉ xéo đôi siêu bền thời trang GSR1 Shalla",142560,205920,63360,31
TIKI,tui-thoi-trang-nam,75801365,"Túi đeo bụng, đeo hông buôn bán mẫu mới 8616 Tặng móc khóa A7",109000,153666,44666,29
TIKI,tui-thoi-trang-nam,159891200,"Túi xách da nam cao cấp phong cách hiện đại mới Mã TDC.9910",599000,599000,0,0
TIKI,tui-thoi-trang-nam,123607188,"Ví cầm tay ví nam bóp nam da cao cấp",159000,159000,0,0
TIKI,tui-thoi-trang-nam,11718960,"Túi đeo hông, Túi đeo bụng nam nữ đa năng du lịch phượt wanfuniao",50000,50000,0,0
TIKI,tui-thoi-trang-nam,45019445,"Túi đeo chéo nam nữ unisex BEE GEE 070",69000,138000,69000,50
TIKI,tui-thoi-trang-nam,40722292,"Cặp da công sở LATA CA29",720000,720000,0,0
TIKI,tui-thoi-trang-nam,73361687,"VÍ NGẮN GẬP DA Bóp CLASSY Da CrossGrain Nhập Khẩu Cao Cấp Chống Thấm Nước Unisex Nam Nữ Chuẩn Leonardo DOLANTO",208000,208000,0,0
TIKI,tui-thoi-trang-nam,86310816," Túi đeo chéo nam nữ vải bố thời trang nhỏ gọn tiện lợi",120000,120000,0,0
TIKI,tui-thoi-trang-nam,4331091,"Balo một quai Simplecarry Sling Big",540000,540000,0,0
TIKI,tui-thoi-trang-nam,3275963,"Ví Dài Nam Bụi Bặm",75000,75000,0,0
TIKI,tui-thoi-trang-nam,180235658,"Ví Da Nam VD05 Kiểu Ngang Hiện Đại Trẻ Trung Cá Tính",38000,50000,12000,24
TIKI,tui-thoi-trang-nam,137520251,"Ví Cầm Tay Clutch Nam GENCE CK11 Da Bò Khóa Số Cao Cấp Màu Nâu Phụ Kiện Vàng Hoặc Bạc",1400000,1400000,0,0
TIKI,tui-thoi-trang-nam,192530273,"Ví cẩm tay nam caro cao cấp đựng ipad điện thoại - T038",450000,450000,0,0
TIKI,tui-thoi-trang-nam,148748877,"túi xách nam công sở cao cấp phong cách châu âu",559000,799000,240000,30
TIKI,tui-thoi-trang-nam,38086342,"Túi đeo chéo nam vải canvas - TN001",37000,52767,15767,30
TIKI,tui-thoi-trang-nam,35608327,"Túi đeo chéo - túi bao tử nam nữ du lịch thời trang BEE GEE 044",70000,140000,70000,50
TIKI,tui-thoi-trang-nam,192377588,"Túi Xách Nam Công Sở Gence Da Bò Taiga CDX13",3500000,3500000,0,0
TIKI,tui-thoi-trang-nam,187070734,"Túi Xách Nam Gence Da Bò Swift GCE24",3150000,3150000,0,0
TIKI,tui-thoi-trang-nam,13645401,"Túi đeo chéo nam nữ unisex thời trang Bee Gee 03",65000,130000,65000,50
TIKI,tui-thoi-trang-nam,121974619,"Túi Đeo Chéo Bao Tử Nam Da Bò Phong Cách Thể Thao Hiện Đại",180000,360000,180000,50
TIKI,tui-thoi-trang-nam,193891511,"Ví Nam Thời Trang cao cấp – VN1010",430000,860000,430000,50
TIKI,tui-thoi-trang-nam,96042251,"Túi đeo chéo nam nữ phong cách quân đội",145000,145000,0,0
TIKI,tui-thoi-trang-nam,165586359,"Cặp Công Sở Nam Lata CA14",499000,595000,96000,16
TIKI,tui-thoi-trang-nam,52352846,"Túi Đeo Chéo Phản Quang Mini Bag Colkids Club Unisex SS3 - Đen",69900,69900,0,0
TIKI,tui-thoi-trang-nam,149179358,"Túi xách tay đeo chéo nam da bò cao cấp ZHIZUNCANGUROOS T52 KT: 33x25x8cm (Nâu-Đen)",1140000,1140000,0,0
TIKI,tui-thoi-trang-nam,3937509,"Ví Dài Nam Aligro ALGVD15 Màu Nâu (19 x 2cm)",907500,907500,0,0
TIKI,tui-thoi-trang-nam,72970813,"Túi nam ngang da bò thật BHM1050 Thô nguyên tấm, vừa A4, vừa laptop 13inch",1370000,1370000,0,0
TIKI,tui-thoi-trang-nam,149797920,"Túi Xách, Cặp Da Công Sở Thời Trang Nam Da Alran Cao Cấp GCE04",2500000,2500000,0,0
TIKI,tui-thoi-trang-nam,122314685,"Túi Nam Đeo Chéo Đeo Hông Da Bò BT04 Thời Trang Tiện Ích",259000,518000,259000,50
TIKI,tui-thoi-trang-nam,136939961,"Túi đeo chéo 5 ngăn chống thấm",52500,52500,0,0
TIKI,tui-thoi-trang-nam,133775941,"Ví Nam Đứng Gấp 3 Da Bò Cao Cấp SUNPOLO WSTF51 (Đen, Nâu Đỏ, Xanh)",490000,490000,0,0
TIKI,tui-thoi-trang-nam,15226964,"Ví Nam Da Đà ĐIểu BIGGBEN BG1",999000,999000,0,0
TIKI,tui-thoi-trang-nam,188906958,"Bao da dành cho dành cho Chìa Khóa Honda Lead 2022, AirBlade 2023, Winner X 2022, PCX 160, Vario 160, AB 125, AB 160 2023 handmade da thật",99000,99000,0,0
TIKI,tui-thoi-trang-nam,116727679,"Túi Nam Đeo Chéo Đeo Hông Da Bò BT04 Thông Dụng",259000,518000,259000,50
TIKI,tui-thoi-trang-nam,91126883,"Túi Canvas Da PU chống thấm - SUPER STORE",806000,806000,0,0
TIKI,tui-thoi-trang-nam,189671749,"EuroQuality Túi đeo chéo nam đựng ipad 9.7 vải Oxford chống thấm nước",549000,549000,0,0
TIKI,tui-thoi-trang-nam,107611618,"Ví Da Nam Cầm Tay Cao Cấp Dạng Dài, Bóp Da Nam Dáng Dài Cầm Tay Sang Trọng, Phong Cách Qúy Ông Hiện Đại",195000,195000,0,0
TIKI,tui-thoi-trang-nam,15183866,"Ví đựng thẻ card với nút bấm tự động Marrant BHM8602",280000,280000,0,0
TIKI,tui-thoi-trang-nam,172538374,"Cặp tài liệu có khoá",95000,95000,0,0
TIKI,tui-thoi-trang-nam,6490269,"Ví Da Nam Cầm Tay Phong Cách Hàn Quốc (Fullbox) - Dozado 021",114000,175000,61000,35
TIKI,tui-thoi-trang-nam,189684205,"Túi Đeo Chéo Nam chống va đập XProtect Men",1140000,1140000,0,0
TIKI,tui-thoi-trang-nam,139451370,"Túi đeo chéo chống nước cao cấp - Túi đeo vải thời trang, năng động",195000,195000,0,0
TIKI,tui-thoi-trang-nam,57694363,"Cặp nam công sở da bò thật Marrant BHM2019 Vừa laptop đến 15inch. Túi xách nam. Cặp văn phòng",750000,750000,0,0
TIKI,tui-thoi-trang-nam,142458366,"Bóp ví da nam cầm tay dáng ngang nhiều ngăn đựng thẻ phong cách đơn giản,  thời trang",40000,80000,40000,50
TIKI,tui-thoi-trang-nam,171774843,"Túi xách da đựng laptop công sở",857000,857000,0,0
TIKI,tui-thoi-trang-nam,173652490,"Ví Nam Da Cá Sấu Thật BIGGBEN Cao Cấp BG8",1000000,1000000,0,0
TIKI,tui-thoi-trang-nam,41258265,"Cặp công sở văn phòng kép đỏ kẹp vào vali HD12 Shalla",130536,178400,47864,27
TIKI,tui-thoi-trang-nam,148801978,"Ví Nam Đứng Cao Cấp,Ví Da Nam Dáng Dứng Đựng Tiền Và Thẻ Mini Nhỏ Gọn Da Lộn",118000,118000,0,0
TIKI,tui-thoi-trang-nam,55601522,"Túi đeo chéo nam nữ du lịch thời trang Hàn quốc có kết nối cổng sạc USB và tai nghe ngoài đa năng DQTC002",199000,199000,0,0
TIKI,tui-thoi-trang-nam,188995854,"Bao da dành cho Chìa Khoá Hyundai Sonata, Tucson, Santafe, Genesis, i30, Elantra, Veloster Handmade Da Thật 004",200000,200000,0,0
TIKI,tui-thoi-trang-nam,107962441,"Ví Da Nam Handmade Phong Cách Thời Trang Hàng Hiệu Cho Quý Ông SVN Luxury",99000,99000,0,0
TIKI,tui-thoi-trang-nam,61389248,"Clutch da bò nguyên tấm BHM2753 Ví cầm tay nam",1050000,1050000,0,0
TIKI,tui-thoi-trang-nam,143463346,"Combo Túi đeo chéo, ba lô Nam Nữ thời trang UNISEX BEE GEE 5104 tặng túi bao tử BEE GEE 130",220000,440000,220000,50
TIKI,tui-thoi-trang-nam,98242857,"Ví Nam Da Cá Sấu Cao Cấp Khôi Nguyên Đan Viền Nguyên Con CS1-VI0BB4 - Tặng Kèm Móc Khóa Da Cá Sấu, Hộp Và Túi Giấy Đựng Quà Sang Trọng",620000,620000,0,0
TIKI,tui-thoi-trang-nam,173660344,"Ví Nam Da Bò Thật BIGGBEN Cao Cấp BG17",320000,320000,0,0
TIKI,tui-thoi-trang-nam,133000673,"Cặp da nam, đeo chéo da bò cao cấp sang trọng lịch lãm - C25",1188000,1188000,0,0
TIKI,tui-thoi-trang-nam,91447975,"Ví Da Nam Cao Cấp V68",432000,432000,0,0
TIKI,tui-thoi-trang-nam,161266624,"Ví đứng Cosver2 HAVIAS Handcrafted Wallet",479200,599000,119800,20
TIKI,tui-thoi-trang-nam,125182559,"Ví Nam Da Bò Kiểu Ví Đứng Nhỏ Gọn Tiện Lợi",99000,99000,0,0
TIKI,tui-thoi-trang-nam,165967068,"Túi đeo vai nam thời trang trẻ trung họa tiết caro chất da Pu mềm mịn cao cấp chất lương",99000,99000,0,0
TIKI,tui-thoi-trang-nam,54901081,"Ví Nam Da Cá Sấu BIGGBEN Cao Cấp BG5",999000,999000,0,0
TIKI,tui-thoi-trang-nam,31840629,"Túi đeo chéo 2 khóa kéo",59000,59000,0,0
TIKI,tui-thoi-trang-nam,43977825,"Túi Đeo Chéo Nam Chất Vải Bố Dày Dặn, Túi Du Lịch Vải bố (24X33CM)",179000,179000,0,0
TIKI,tui-thoi-trang-nam,176896293,"Ví nam đẹp da thật cao cấp dáng đứng MANZO VID-02 bảo hành 18 tháng",250000,250000,0,0
TIKI,tui-thoi-trang-nam,52478995,"Túi xách đeo chéo nam nữ unisex thời trang Hàn quốc BEE GEE 077 siêu nhẹ chống thấm cực kỳ cá tính",69000,138000,69000,50
TIKI,tui-thoi-trang-nam,124244917,"Ví Da Nam Cầm Tay, Bóp Da Nam Cầm Tay Thời Trang Cao Cấp, Da Mền Có Khóa Số Thông Minh TẶNG KÈM TAI NGHE",320000,320000,0,0
TIKI,tui-thoi-trang-nam,192378540,"Túi Xách Nam Công Sở Gence Da bò Espom Cao Cấp CDX15",3800000,3800000,0,0
TIKI,tui-thoi-trang-nam,119989967,"HP2431 - Bóp nam Huy Hoàng da đà điểu da bụng kiểu đứng màu xanh đậm",799000,799000,0,0
TIKI,tui-thoi-trang-nam,83939773,"VÍ DA NAM THỜI TRANG, ĐỒ DA HANDMADE CAO CẤP",359000,359000,0,0
TIKI,tui-thoi-trang-nam,152803631,"Ví Da Nam Clutch Cầm Tay GENCE HT05 Chất Liệu Da Bò Cao Cấp Hai Màu Nâu Và Đen",910000,1300000,390000,30
TIKI,tui-thoi-trang-nam,206250434,"Ví cầm tay nam - ví nam cao cấp Full hộp WilliamPOLO -  V31",655000,655000,0,0
TIKI,tui-thoi-trang-nam,252857989,"[Da thật] Clutch cầm tay nam da bò thật; Ví dài nam CL141LS (Cafe) - 100% da bò thật, BH 3 năm",559000,559000,0,0
TIKI,tui-thoi-trang-nam,180734561,"Ví Da Nam VD04 Kiểu Đứng Cá Tính Mạnh Mẽ",38000,50000,12000,24
TIKI,tui-thoi-trang-nam,133574478,"Ví Da Bò Thật Nam Cao Cấp Ví Dài Nam V79",540000,540000,0,0
TIKI,tui-thoi-trang-nam,74793666,"Ví Nam Da Bò Pullup Thật Bóp Ngang Cao Cấp Màu Đỏ Tặng Kèm Hộp DCE721",150000,150000,0,0
TIKI,tui-thoi-trang-nam,122437194,"Túi Đeo Chéo Túi Xách Nam BT08 Kiểu Dáng Công Sở Trẻ Trung ",195000,380000,185000,49
TIKI,tui-thoi-trang-nam,119989713,"HP2449 - Bóp nam Huy Hoàng da đà điểu da trơn đan viền kiểu đứng màu nâu đỏ",999000,999000,0,0
TIKI,tui-thoi-trang-nam,54902408,"Ví Nam Da Cá Sấu Thật BIGGBEN Cao Cấp BG6",999000,999000,0,0
TIKI,tui-thoi-trang-nam,20452909,"[ Ví Da Thật 100% ] Ví Dài Thời Trang Cao Cấp Nhiều Ngăn thương hiệu Mandino MD629 / Màu coffee",690000,690000,0,0
TIKI,tui-thoi-trang-nam,119989838,"HP2448 - Bóp nam Huy Hoàng da đà điểu da trơn đan viền kiểu đứng màu nâu đất",999000,999000,0,0
TIKI,tui-thoi-trang-nam,49004687,"Túi đeo bụng đeo chéo nam thể thao",110000,110000,0,0
TIKI,tui-thoi-trang-nam,107885079,"Ví nam cầm tay Gianni Conti Italy 492019BLA CK",3500000,3500000,0,0
TIKI,tui-thoi-trang-nam,102012311," Ví nam siêu rẻ da PU kiểu dáng đơn giản chống nước đựng tiền đựng thẻ mini dáng ngang bền đẹp - MB09",110000,110000,0,0
TIKI,tui-thoi-trang-nam,143091556,"Ví nam da bò Anh Tho Leather MIN-06",477000,550000,73000,13
TIKI,tui-thoi-trang-nam,26023612,"Ví cầm tay, clutch nam cao cấp da bò thật - CT002A",350000,350000,0,0
TIKI,tui-thoi-trang-nam,188997220,"Bao da dành cho chìa khoá Toyota Corolla Cross handmade da thật, Corola Cross 010",200000,200000,0,0
TIKI,tui-thoi-trang-nam,191376441,"Bao da dành cho dành cho Honda Civic 2022 , 2023, Accord, The NEW Civic 2022 E, G, RS handmade da thật 006",200000,200000,0,0
TIKI,tui-thoi-trang-nam,194026186,"Bóp Nam Da Bụng Cá Sấu 2 Mặt Đan Viền Rất Mềm Và Bền VS2V14N",868000,1128000,260000,23
TIKI,tui-thoi-trang-nam,2000383,"Ví Nam Viền Chỉ Huy Hoàng HT2128 (12.5 x 10 cm) - Da Bò",529000,529000,0,0
TIKI,tui-thoi-trang-nam,116203470,"Túi Đeo Chéo Nam Unisex Thời Trang Chống Nước - Túi Bao Tử Dệt Trơn Trượt Nước Đeo Hông Lưng Bụng - BOSSMAN",53000,74415,21415,29
TIKI,tui-thoi-trang-nam,176130535,"Ví nam mini , ví nam chất đẹp da PU nhỏ gọn thời trang, nhiều ngăn tiện dụng - Bóp nam MB29",78000,78000,0,0
TIKI,tui-thoi-trang-nam,194025814,"Túi đeo chéo nam DA CÁ SẤU SANG TRỌNG",3790000,6500000,2710000,42
TIKI,tui-thoi-trang-nam,69861790,"Túi y tế đeo thắt lưng thời trang EDC",84000,84000,0,0
TIKI,tui-thoi-trang-nam,96988041,"Túi đeo chéo VPC  kiểu ngang bóng trơn VF4 Tặng móc kháo hình khiên",84000,119064,35064,29
TIKI,tui-thoi-trang-nam,193570136,"Ví nam cầm tay Gianni Conti Italy 2212BLA - Đen ",2900000,2900000,0,0
TIKI,tui-thoi-trang-nam,148769955,"Ví Da Nam VD04 Kiểu Đứng Thời Trang Phá Cách",38000,50000,12000,24
TIKI,tui-thoi-trang-nam,107962138,"Ví mini để thẻ, card, chứng minh thư và tiền mặt VMN7, phong cách thời trang công sở, unisex, màu sắc đa dạng",159000,159000,0,0
TIKI,tui-thoi-trang-nam,186319276,"TÚI ĐEO VAI DA NAM NỮ UNISEX CAO CẤP",280000,280000,0,0
TIKI,tui-thoi-trang-nam,137445928,"Túi đeo bụng nam, nữ chất liệu vải kaki siêu bền, có nhiều ngăn tiện dụng size 31cm",79000,79000,0,0
TIKI,tui-thoi-trang-nam,179013455,"Đeo bao tử, nịt bụng đa năng.(đen,xanh)",93952,135709,41757,31
TIKI,tui-thoi-trang-nam,193916171,"Money Clip Wallet - Ví kẹp tiền da nam đựng thẻ Carbon RFID tối đa đến 15 thẻ",540000,540000,0,0
TIKI,tui-thoi-trang-nam,40722255,"Ví Da Nam Cao Cấp Basic One Blue",290000,290000,0,0
TIKI,tui-thoi-trang-nam,77937086,"BÓP NGẮN GẬP DA SÁP Ví MORI Da Sáp Nhập Khẩu Cao Cấp Chống Thấm Nước Unisex Nam Nữ",200000,200000,0,0
TIKI,tui-thoi-trang-nam,174398203,"Túi đeo bụng, đeo chéo, đeo hông thời trang nam nữ chất liệu vải Canvas size 32cm với nhiều màu sắc lựa chọn TUI11",59000,59000,0,0
TIKI,tui-thoi-trang-nam,167470261,"Ví Nam, Bóp Nam Thời Trang Da Bò EPSOM Cao Cấp Gence HM05",1150000,1150000,0,0
TIKI,tui-thoi-trang-nam,14416438,"Túi Đeo Chéo Nam Vài Bố Canvas Thời Trang Phái Mạnh - LKS447",263000,263000,0,0
TIKI,tui-thoi-trang-nam,184071809,"Túi xách unisex nam nữ 1992 s t u d i o / WINI BAG / túi hộp đeo chéo màu đen cá tính",650000,650000,0,0
TIKI,tui-thoi-trang-nam,119989698,"HP2313-14-16 - Ví nam Huy Hoàng da trăn đan viền màu đen, nâu, trắng",699000,699000,0,0
TIKI,tui-thoi-trang-nam,66661856,"Ví đựng Cardvist bằng da cao cấp",154000,154000,0,0
TIKI,tui-thoi-trang-nam,149179295,"Túi đeo chéo nam da bò khóa số T76 BOLINDAISHU 28x23x6,5cm bảo hàng 12 tháng (Nâu-Đen)",1152000,1152000,0,0
TIKI,tui-thoi-trang-nam,116727691,"Túi Đeo Chéo Nam BT06 Chất Liệu Da Ngăn Thấm Nước Không Bong Tróc",235000,450000,215000,48
TIKI,tui-thoi-trang-nam,97644551,"Túi đeo chéo đeo hông loan màu vuông Sale sốc E1",33349,48171,14822,31
TIKI,tui-thoi-trang-nam,55094710,"Ví bóp tiền logo đội bóng cực đẹp tiện dụng Real Madrid",150000,150000,0,0
TIKI,tui-thoi-trang-nam,91131071,"Túi Canvas Phối Da Bò",765700,765700,0,0
TIKI,tui-thoi-trang-nam,188993756,"Bao da dành cho chìa khóa Chevrolet Trailblazer, Colorado handmade da thật (chìa gập) 002",200000,200000,0,0
TIKI,tui-thoi-trang-nam,131882844,"HJ2301-02-03 - Ví nam Huy Hoàng da trăn màu da nguyên thủy, đen, nâu",839000,839000,0,0
TIKI,tui-thoi-trang-nam,96988272,"Túi đeo chéo hông nam nữ N9 bóng VPC C47 Tặng móc khóa hình búa",85000,120417,35417,29
TIKI,tui-thoi-trang-nam,125138773,"Ví nam, bóp nam da bò Pullup cao cấp Bụi Leather V107 - Bảo hành 12 tháng",209000,370000,161000,44
TIKI,tui-thoi-trang-nam,162387877,"Túi đeo ngực, đeo chéo nam đã tích hợp công nghệ 4.0 Mã BG-7079",529000,799000,270000,34
TIKI,tui-thoi-trang-nam,188997010,"Bao da dành cho Chìa Khóa Smartkey Suzuki GSX R150 handmade da thật",99000,99000,0,0
TIKI,tui-thoi-trang-nam,73587257,"Túi Đeo Ngực Thể Thao Dã Ngoại Phối Da 208071",41000,50000,9000,18
TIKI,tui-thoi-trang-nam,84381430,"VÍ NAM DA BÒ PHỐI MÀU",504400,504400,0,0
TIKI,tui-thoi-trang-nam,93268074,"Ví tầm tay caro mềm mỏng cho Nam và Nữ - T054",132000,132000,0,0
TIKI,tui-thoi-trang-nam,45528375,"Ví Da Nam Dập Vân Cá Sấu Nâu Kiểu Đứng Chất Liệu Da Bò Thật 100% ",234000,234000,0,0
TIKI,tui-thoi-trang-nam,89786392,"Túi đeo chéo nam vải phong cách thời trang Hàn Quốc TC91",53020,55811,2791,5
TIKI,tui-thoi-trang-nam,57391453,"Ví Da Bò T171 – Kiểu Dáng Tinh Tế – Thiết Kế Sang Trọng",175000,175000,0,0
TIKI,tui-thoi-trang-nam,143893477,"HD2248 - Bóp nam Huy Hoàng da cá sấu kiểu đứng màu nâu đất",1539000,1539000,0,0
TIKI,tui-thoi-trang-nam,97644327,"Ví dài cầm tay nam bấm góc bản châu âu FB11 Tặng móc khóa nam",108000,152313,44313,29
TIKI,tui-thoi-trang-nam,74742338,"Ví Da Cá Sấu 2 Mặt Đan Viền [GÙ CÁ SẤU RẤT ĐẸP",818000,1291000,473000,37
TIKI,tui-thoi-trang-nam,120500186,"Ví nam Huy Hoàng da đà điểu màu vàng bò, đen, nâu đất, nâu đỏ HC2401-02-03-04",899000,899000,0,0
TIKI,tui-thoi-trang-nam,68190438,"TÚI ĐEO CHÉO NAM PHONG CÁCH HÀN QUỐC + TẶNG KÈM DÂY SẠC USB",138000,138000,0,0
TIKI,tui-thoi-trang-nam,99845786,"[Da thật] Ví nam gập 3 da bò sáp WS102A (Nâu sáp) - 100% da bò thật, BH 3 năm",125000,125000,0,0
TIKI,tui-thoi-trang-nam,10385556,"Ví Nam SAM Leather MXK01",650000,650000,0,0
TIKI,tui-thoi-trang-nam,96987910,"Túi đeo chéo VPC kiểu ngang bóng trơn S48 Tặng móc khóa hình khiên",84000,119064,35064,29
TIKI,tui-thoi-trang-nam,4699485,"Túi đeo chéo nam phong cách BHM8951ND",850000,850000,0,0
TIKI,tui-thoi-trang-nam,148932270,"Túi đeo chéo nam nữ Unisex thời trang siêu nhẹ chống nước TCN04",58000,82533,24533,30
TIKI,tui-thoi-trang-nam,37399722,"Ví Nam Da Bò Cao Cấp PORADO BVN100",129000,129000,0,0
TIKI,tui-thoi-trang-nam,125355345,"Ví Da Nam Cầm Tay 1 Ngăn Khóa Nam Tính",82000,160000,78000,49
TIKI,tui-thoi-trang-nam,61286068,"Ví Nam Da Bò SAM Leather – Bóp Da Nam cao cấp SAM017",599000,599000,0,0
TIKI,tui-thoi-trang-nam,195507454,"Túi đeo chéo da PU cao cấp",249000,249000,0,0
TIKI,tui-thoi-trang-nam,188018018,"Clutch, Ví Cầm Tay Thời Trang Nam Da Bò Alran Cao Cấp HT16 Nâu",1600000,1600000,0,0
TIKI,tui-thoi-trang-nam,202963717,"Túi kẹp nách nam , ví nam cầm tay cao cấp full hộp WilliamPOLO - V37",905000,905000,0,0
TIKI,tui-thoi-trang-nam,58124720,"Bóp Da Cá Sấu 2 Mặt [ĐUÔI CÁ NHỎ SIÊU ĐẸP",768000,1212000,444000,37
TIKI,tui-thoi-trang-nam,111868739,"Túi đeo chéo,đeo ngực du lịch Arctic Hunter XB00081 chất liệu Oxford chống thấm nước thiết kế nhiều ngăn tiện dụng",369000,635000,266000,42
TIKI,tui-thoi-trang-nam,15699261,"Túi xách tay nam",315000,315000,0,0
TIKI,tui-thoi-trang-nam,213678780,"Ví nam kiểu đứng K3214 da PU cao cấp thiết kế thời trang lịch lãm",80000,160000,80000,50
TIKI,tui-thoi-trang-nam,193720408,"TÚI ĐEO CHÉO HỌA TIẾT KẺ SỌC NÂU ĐƠN GIẢN",380000,380000,0,0
TIKI,tui-thoi-trang-nam,172191484,"Ví nam da thật dáng dài - ví da nam,bop ví nam đẹp - 204426",100000,100000,0,0
TIKI,tui-thoi-trang-nam,111869050,"Túi đeo chéo du lịch mini Arctic Hunter XB00116 chất liệu Oxford chống thấm nước ,unisex nam nữ, thiết kế nhiều ngăn",515000,849000,334000,39
TIKI,tui-thoi-trang-nam,198467551,"Ví nam da bò cao cấp phong cách mới",288000,320000,32000,10
TIKI,tui-thoi-trang-nam,193389878,"Túi Đeo Chéo Nam Oxford Túi Bố Cao Cấp Nhiều Ngăn Chống Thấm Nước, Túi Đeo Vai Phong Cách Thời Trang Hàn Quốc Dành Cho Người Đi Làm, Học Sinh, Sinh Viên,Người Đi Chơi, Đi Du Lịch",130000,130000,0,0
TIKI,tui-thoi-trang-nam,119989961,"Ví nam da cá sấu đan viền nhiều màu Huy Hoàng HP2254-2711-2712-2713",1299000,1299000,0,0
TIKI,tui-thoi-trang-nam,173878953,"Ví nam cầm tay cao cấp Gianni Conti Italy 1245724BLACK - Màu đen",4000000,4000000,0,0
TIKI,tui-thoi-trang-nam,3937511,"Ví Dài Nam Aligro ALGVD14 Màu Xám (18.5 x 2cm)",907500,907500,0,0
TIKI,tui-thoi-trang-nam,149179394,"Túi xách cặp da đựng laptop da bò công sở JEEP BULUO T25 (Nâu đậm-Nâu sáng-Đen) KT 38-27-6CM",648000,648000,0,0
TIKI,tui-thoi-trang-nam,25892647,"Bộ Túi Kèm Ví Ipad Nam",79000,79000,0,0
TIKI,tui-thoi-trang-nam,149179237,"Túi đeo chéo nam da bò ZHIZUNCANGAROO T47 26x23x7cm (Đen - Nâu)",648000,648000,0,0
TIKI,tui-thoi-trang-nam,198474607,"Ví nam 100% da bò thật cao cấp phong cách mới",288000,320000,32000,10
TIKI,tui-thoi-trang-nam,53791119,"Túi đeo chéo nam nữ thời trang Hàn quốc BEE GEE 075 chống thấm nước để ipad Hot trend 2020",75000,150000,75000,50
TIKI,tui-thoi-trang-nam,108850213,"Ví nam thời trang da bò thật LATA LVN92",450000,450000,0,0
TIKI,tui-thoi-trang-nam,170994209,"Túi đeo chéo nam thời trang Hàn quốc BEE GEE 0125A",210000,420000,210000,50
TIKI,tui-thoi-trang-nam,193143209,"Ví nam dáng đứng da bò thật TRITA RVN20",189000,390000,201000,52
TIKI,tui-thoi-trang-nam,157254030,"Ví Gập Đôi Nam Da In SAIGON SWAGGER Eclipse Bi-Fold Wallet",450000,450000,0,0
TIKI,tui-thoi-trang-nam,143709548,"Túi đeo chéo Jeep Buluo Chất Da Cao Cấp chống chày xước chống nước đựng ipad điện thoại đi làm đi chơi Túi da nam",215000,215000,0,0
TIKI,tui-thoi-trang-nam,198296523,"Túi đeo chéo - đeo ngực Ulzzang T0175 chống thấm nước unisex nam nữ phong cách thời trang cá tính",105000,210000,105000,50
TIKI,tui-thoi-trang-nam,198129421,"Túi xách công sở Nam da bò cao cấp - VP01A",850000,850000,0,0
TIKI,tui-thoi-trang-nam,44012728,"Cặp Da Công Sở LATA CA23",599000,720000,121000,17
TIKI,tui-thoi-trang-nam,21124785,"Ví Da Nam Gianni Conti Italy 907349BRO - Nâu",1250000,1250000,0,0
TIKI,tui-thoi-trang-nam,32841654,"Ví card da bò Handmade AT Leather - MSC-01",229000,280000,51000,18
TIKI,tui-thoi-trang-nam,148803064,"Ví Ngang Nam Cầm Tay Cao Cấp Chất Liệu Da Simili Nhỏ Gọn, Tiện Lợi Kích Thước 10.7cm x 9.7cm x 1.5cm",85000,85000,0,0
TIKI,tui-thoi-trang-nam,4595661,"Ví Nam da Bò Thật Mỏng Nhỏ Gọn Mềm Vâng Da Độc Lạ",320000,320000,0,0
TIKI,tui-thoi-trang-nam,95125535," Túi đeo chéo da ipad kiểu đứng caro xanh CR31 Tặng móc khóa hình khiên",87000,121891,34891,29
TIKI,tui-thoi-trang-nam,107961982,"Ví mini phong cách xứ Hàn thời trang 2020",239000,239000,0,0
TIKI,tui-thoi-trang-nam,148985331,"Ví Nam Da, Bóp Nam Da Đựng Tiền Mẫu Mới Cao Cấp 2 Kiểu Dáng - Ví Nam Ngang, Đứng Kích Thước 10 x 1.5 x 12 cm",85000,85000,0,0
TIKI,tui-thoi-trang-nam,182296108,"Túi Đeo Chéo Nam DC04 Nhỏ Gọn Siêu Bền Sang Trọng Siêu Tiện Lợi",265000,530000,265000,50
TIKI,tui-thoi-trang-nam,193433908,"Ví Kẹp Tiền Clip Money RFID Wallet Men Slim (Black Carbon)",540000,540000,0,0
TIKI,tui-thoi-trang-nam,136939985,"Túi đeo chéo thổ cẩm 3 ngăn cho cả nam và nữ",65000,65000,0,0
TIKI,tui-thoi-trang-nam,137941710,"Ví da cầm tay nam công sở khóa số RB07",1430000,1430000,0,0
TIKI,tui-thoi-trang-nam,53776954,"Túi đeo chéo nam nữ unisex Hàn quốc thời trang BEE GEE 080 hot trend 2020 chống thấm nước",80000,160000,80000,50
TIKI,tui-thoi-trang-nam,77560504,"Túi Đeo Chéo Classic Black VNS VN8005, Túi đeo chéo cao cấp chống thấm nước (24.5cm x 9cm x 14cm) - Classic Crossbody Bag",345000,390000,45000,12
TIKI,tui-thoi-trang-nam,8662119,"Túi Đeo Chéo Unisex",42000,58179,16179,28
TIKI,tui-thoi-trang-nam,108455389,"Ví sen, ví da bò thật 100%, bóp mini cầm taycho nam và nữ đựng tiền và thẻ, màu Xanh Navy",190000,190000,0,0
TIKI,tui-thoi-trang-nam,118582635,"Túi Đeo Chéo Nam Độc Lạ Thời Trang Hàn Quốc Da PU Cao Cấp",175000,175000,0,0
TIKI,tui-thoi-trang-nam,51334896,"Túi Đeo Chéo Unisex Haras HRTK183VN (17 x 26 cm)",99000,99000,0,0
TIKI,tui-thoi-trang-nam,99714086," Túi đeo chéo nam phong cách Hàn Quốc - Túi bao tử nam chống nước, chống bám bụi (kèm video ảnh thật)",74000,104181,30181,29
TIKI,tui-thoi-trang-nam,177092441,"Design 2023 - Quà tặng cho nam giới - Quà tặng sinh nhật - Quà lưu niệm cho bạn trai - Ví da nam Cao cấp _ full Túi hộp quà tặng y hình",149000,149000,0,0
TIKI,tui-thoi-trang-nam,13642424,"Túi đeo chéo nam công sở thời trang 06 XAMDEN",79000,158000,79000,50
TIKI,tui-thoi-trang-nam,96075524,"Ví Da Nam, Ví Dài Nam Cầm Tay Cao Cấp Jeep Kèm Dây Kéo Thời Trang",67082,96896,29814,31
TIKI,tui-thoi-trang-nam,203842539,"Ví nam cao cấp CoilenKlaon- Ví đứng cầm tay -Full hộp đựng cao cấp",800000,1600000,800000,50
TIKI,tui-thoi-trang-nam,87705625,"Túi Bao Tử, Túi Đeo Chéo Da Bò Thật CB04",455000,455000,0,0
TIKI,tui-thoi-trang-nam,174315938,"Túi đeo chéo nam nữ usisex Hàn quốc BEE GEE - 0137",180000,360000,180000,50
TIKI,tui-thoi-trang-nam,153539449,"Clutch, Ví Cầm Tay Thời Trang Nam Da Bò Cao Cấp HT05 Đen, Nâu",1430000,1430000,0,0
TIKI,tui-thoi-trang-nam,94583354,"TÚI ĐEO VAI MARK RYDEN THE MESSENGER MR-5900",1183000,1183000,0,0
TIKI,tui-thoi-trang-nam,17953122,"Túi Xách Công Sở Nam Marrant BHM8572 Cặp laptop 14inch. Da bò thật",750000,750000,0,0
TIKI,tui-thoi-trang-nam,188714006,"Ví da nam PANDAGO Maximus mini cao cấp làm thủ công da thật nhỏ gọn bỏ túi thời trang",301000,301000,0,0
TIKI,tui-thoi-trang-nam,193512494,"Kẹp tiền đựng thẻ công nghệ 5.0 Clip Money RFID Wallet Men Slim (Black Carbon)",290000,290000,0,0
TIKI,tui-thoi-trang-nam,107962446,"Ví Nam Kiểu Ngang Da Bò Thật Khâu Tay Thủ Công SVN",276000,276000,0,0
TIKI,tui-thoi-trang-nam,179013357,"Túi đeo hông đeo bụng cao cấp thể thao du lịch tập gym CITI GT2",30492,44044,13552,31
TIKI,tui-thoi-trang-nam,60136422,"Clutch Nam, Ví Cầm Tay Nam Có Quai Cầm Da Bò Cao Cấp WT Leather 070061401, 070061402",3250000,3250000,0,0
TIKI,tui-thoi-trang-nam,208213663,"Túi đeo chéo Nam cao cấp vải canvas chống thấm - L022",110000,110000,0,0
TIKI,tui-thoi-trang-nam,248546714,"Ví mini nam nữ bóp da bò thật cao cấp LIDAN, dáng gập nhỏ gọn nhiều ngăn đựng tiền đựng thẻ LD26",469000,469000,0,0
TIKI,tui-thoi-trang-nam,76157596," capdakhoaso1 - Phong cách xám,15,6 inh",199000,199000,0,0
TIKI,tui-thoi-trang-nam,112976854,"Túi đeo bụng,túi bao tử dành cho nam nhiều ngăn khóa tiện lợi",125000,125000,0,0
TIKI,tui-thoi-trang-nam,104438786,"Ví Dài Nam, Nữ Cầm Tay Cao Cấp 2 khoá",121000,121000,0,0
TIKI,tui-thoi-trang-nam,23171666,"Ví Nam Da Bò Sáp Cao Cấp Kiểu Dáng Sang Trọng MỚI 2019",145000,145000,0,0
TIKI,tui-thoi-trang-nam,72302902,"Túi đeo hông, túi đeo bụng, túi phản quang chống nước thời trang",62000,87945,25945,30
TIKI,tui-thoi-trang-nam,56691974,"Ví nam da bò cao cấp phong cách mới",387000,430000,43000,10
TIKI,tui-thoi-trang-nam,193720416,"TÚI ĐEO CHÉO NAM ĐỰNG IPAD CHẤT LIỆU DA CAO CẤP",350000,350000,0,0
TIKI,tui-thoi-trang-nam,47687678,"Bóp, Ví Da Nam Sang Trọng Gập 2 Cổ Điển Nhưng độc Lạ Phong Cách ",490000,490000,0,0
TIKI,tui-thoi-trang-nam,176130306,"Ví nam da cá sấu nằm ngang thời trang nhỏ gọn dáng đẹp có video ví mini đựng tiền đựng thẻ - Mã: MB10",138000,138000,0,0
TIKI,tui-thoi-trang-nam,147832557,"Túi Đeo Chéo Nam Da Bò Hiện Đại Trẻ Trung",180000,360000,180000,50
TIKI,tui-thoi-trang-nam,135309347,"Túi Đeo Chéo Tomtoc (USA) Lightweight Cordura Sling Bag H02 (Trắng) - Hàng Chính Hãng",855000,855000,0,0
TIKI,tui-thoi-trang-nam,107962170,"Ví Da Nam Handmade Thời Tranh Đẳng Cấp Dành Cho Quý Ông VHM1",279000,279000,0,0
TIKI,tui-thoi-trang-nam,193006640,"Túi Xách Nam Công Sở Cao Cấp Da Bò Epsom CDX16",3050000,3050000,0,0
TIKI,tui-thoi-trang-nam,109229975,"Túi Đeo Chéo TĐC01 2 trong 1 vừa là túi đeo chéo vừa là balo",144000,144000,0,0
TIKI,tui-thoi-trang-nam,248546621,"Ví nam da bò thật Nappa cao cấp LIDAN, bóp dáng ngang có hộp vintage kèm thiệp đẹp làm quà tặng LD15",429000,429000,0,0
TIKI,tui-thoi-trang-nam,94486810,"Ví nam Đông Hải -AV005",550000,550000,0,0
TIKI,tui-thoi-trang-nam,85352655,"Túi đeo bụng chạy bộ tập gym CITI AZ35 Tặng móc cá heo",32670,47190,14520,31
TIKI,tui-thoi-trang-nam,160686492,"Ví đựng thẻ Basic Card Holder Unisex WAA.- DA THẬT 100% - Màu đen - Sản phẩm thiết kế - Kèm dustbag",290000,290000,0,0
TIKI,tui-thoi-trang-nam,80249951,"Túi bao tử đeo bụng đeo chéo BL",170100,170100,0,0
TIKI,tui-thoi-trang-nam,119989841,"HP2457 - Bóp nam Huy Hoàng da đà điểu da chân 2 mặt da kiểu đứng màu nâu đỏ",1449000,1449000,0,0
TIKI,tui-thoi-trang-nam,149179759,"Túi xách cặp công sở đựng laptop 17inch YAJIE T07 mã 3248 - DH STORE",600000,600000,0,0
TIKI,tui-thoi-trang-nam,11266184,"Túi đeo chéo unisex",54000,77121,23121,30
TIKI,tui-thoi-trang-nam,126989693,"Ví nam đứng BHLD194 Da bò thật",299000,299000,0,0
TIKI,tui-thoi-trang-nam,144870086,"Ví nam thời trang da cao cấp 204439 Ví nam thời trang da cao cấp 204439",33000,38000,5000,13
TIKI,tui-thoi-trang-nam,197517860,"Ví Dài Gấp Đôi Nam Nữ Handmade - Leather Check Book Wallet",499000,499000,0,0
TIKI,tui-thoi-trang-nam,133569145,"Ví Da Bò Thật Nam Cao Cấp Ví Dài V28",540000,540000,0,0
TIKI,tui-thoi-trang-nam,44179671,"Ví đựng thẻ card với nút bấm tự động Marrant BHM8602 Màu Đỏ. Da bò thật, chống RFID",291600,291600,0,0
TIKI,tui-thoi-trang-nam,149179062,"Túi đeo chéo nam da bò cao cấp LEINASEN KT:29x25x8cm tặng ví dài (Nâu đậm-Nâu sáng-Đen)",1198800,1198800,0,0
TIKI,tui-thoi-trang-nam,133000578,"Ví nam da bò cao cấp với thiết kế sáng trọng mạnh mẽ - V87",540000,540000,0,0
TIKI,tui-thoi-trang-nam,180995355,"Túi Xách, Cặp Thời Trang Công Sở Nam Da Bò Swift Cao Cấp GCE17 Nâu",2800000,2800000,0,0
TIKI,tui-thoi-trang-nam,137464174,"Túi đeo chéo chống thấm nước, chống xước 4 ngăn hàng cao cấp - Cam kết chất lượng",99000,99000,0,0
TIKI,tui-thoi-trang-nam,33397851,"Ví Da Thật Đựng Namecard 12 ngăn",199000,199000,0,0
TIKI,tui-thoi-trang-nam,188750948,"Túi Xách Nam Da Bò Cao Cấp Có Quai Đeo Kèm Bao Đựng Mắt Kính, Tai Nghe Màu Nâu WT Leather 090051201,010251201, 010261201",6500000,6500000,0,0
TIKI,tui-thoi-trang-nam,175576211,"Túi đeo chéo tiện dụng, sang trọng phong cách trẻ trung Hàn Quốc– DCN9049",660000,660000,0,0
TIKI,tui-thoi-trang-nam,120777698,"Túi Đeo Chéo, Túi Bao Tử CB04 Chất Da Bò Thật Bền Bỉ Không Bong Tét Siêu bền Đủ Màu Đen Nâu Vàng Bò Xanh Navy Phù Hợp Cho Nam Nữ Năng Động, Đựng Đồ Tiện Dụng Khi Đi Làm Hoặc Đi Du Lịch",680000,680000,0,0
TIKI,tui-thoi-trang-nam,75948807,"Túi đeo chéo mini nam nữ thời trang Hàn quốc dạng trông suốt phản quang K01 BEE GEE đi chơi tết 2021",75000,150000,75000,50
TIKI,tui-thoi-trang-nam,98074551,"Túi đeo chéo da ipad kiểu ngang caro xanh M14 Tặng móc khóa nam A3",62000,86470,24470,28
TIKI,tui-thoi-trang-nam,107962520,"Ví Da Mini Đựng Name Card - Ví Da Bò Sáp Handmade SVN9-1",199000,199000,0,0
TIKI,tui-thoi-trang-nam,44349514,"Túi đeo chéo nam nữ unisex du lịch thời trang Hàn quốc BEE GEE 061 cao cấp đẹp giá rẻ",75000,150000,75000,50
TIKI,tui-thoi-trang-nam,6775757,"Ví Nam Kiểu Dáng Độc Lạ",330000,330000,0,0
TIKI,tui-thoi-trang-nam,143844185,"Bóp nam Huy Hoàng vân cá sấu màu nâu đỏ HJ2148",489000,489000,0,0
TIKI,tui-thoi-trang-nam,11684621,"Túi Đeo Chéo Bee Gee 023",50000,100000,50000,50
TIKI,tui-thoi-trang-nam,102012651," Túi đeo chéo nam vải canvas chống nước 3 ngăn phong cách Hàn Quốc",138000,138000,0,0
TIKI,tui-thoi-trang-nam,144193618,"Ví Nam Da Bò Sáp VD02 Kiểu Ngang Cao Cấp Trẻ Trung",168000,336000,168000,50
TIKI,tui-thoi-trang-nam,25688534,"Ví Nam Da Bò – Ví Ngang SAM Leather SAM007",649000,649000,0,0
TIKI,tui-thoi-trang-nam,189601089,"Túi Xách Nam Công Sở Da Bò Epsom CDX15",3820000,3820000,0,0
TIKI,tui-thoi-trang-nam,193568965,"Ví Nam cầm tay Gianni Conti Italy 2213BLA - Đen ",2500000,2500000,0,0
TIKI,tui-thoi-trang-nam,96987902,"Ví dài cầm tay nam nữ bấm góc cao cấp châu âu FB102 Tặng móc khóa nam",108000,152313,44313,29
TIKI,tui-thoi-trang-nam,137501241,"Ví Cá Sấu Cao CấpBóp Nam Da Cá Sấu Thật Mặt Ngoài da lưng Kiểu Dáng Ngang màu nâu coffee sang trọng - BH 24 tháng",499000,499000,0,0
TIKI,tui-thoi-trang-nam,67538997,"Túi Bao Tử Đeo Chéo Apehlic",69000,69000,0,0
TIKI,tui-thoi-trang-nam,144225073,"Ví nam mini đựng thẻ atm phong cách mới nhỏ gọn thanh lịch",99000,99000,0,0
TIKI,tui-thoi-trang-nam,163866534,"Ví Nam Cầm Tay Cao Cấp Tigernu Đựng Thẻ Có Khóa Kéo Không Thấm Nước T-S8081",557000,557000,0,0
TIKI,tui-thoi-trang-nam,115819092,"Ví ngang nam | Ví nam da đà điểu thật wax cao cấp | Bóp nam da đà điểu thật",1050000,1050000,0,0
TIKI,tui-thoi-trang-nam,139490700,"Túi bao tử nam đeo chéo nam nữ du lịch tiện ích unisex thời trang Bee Gee 121 A siêu đẹp chống thấm nước",34500,69000,34500,50
TIKI,tui-thoi-trang-nam,34555462,"Ví nam cầm tay da thật ELLY HOMME – EVM5",999000,999000,0,0
TIKI,tui-thoi-trang-nam,2000351,"Ví Nam Da Bò Cao Cấp Huy Hoàng HT2114 (12.5 x 10 cm) - Đen",199000,199000,0,0
TIKI,tui-thoi-trang-nam,48661422,"Mẫu ví da nam đẹp, phong cách đơn giản và siêu nhẹ - Hàng nhập khẩu",249000,249000,0,0
TIKI,tui-thoi-trang-nam,185468038,"Bóp Ví Nam Mẫu Dài Cầm Tay Với Chất Da Cao Cấp Khóa Bấm Tinh Tế - S6703",178000,269000,91000,34
TIKI,tui-thoi-trang-nam,54735099,"Ví đa năng tiện dụng đựng Passport, giấy tờ khi đi du lịch",760000,760000,0,0
TIKI,tui-thoi-trang-nam,155145256,"Túi đeo chéo nam vải canvas chống thấm nước - BEEGEE 0134 (Tặng quà tặng ngẫu nhiên trong BEEGEE GILF COLLECTION) ",187000,374000,187000,50
TIKI,tui-thoi-trang-nam,37000165,"Túi đeo chéo nam chạy bộ thể thao Haosua M21 cao cấp Shalla",147510,213070,65560,31
TIKI,tui-thoi-trang-nam,185843862,"Ví Da Bò Nam Cao Cấp POLO MEISDO Sang Trọng ( Da Bò Thật 100%) Làm Quà Biếu Tặng Sinh Nhật BH 2 Năm",1000000,1000000,0,0
TIKI,tui-thoi-trang-nam,82403061,"Ví Da Nam Cầm Tay Sang Trọng - Phong Cách - Đẳng Cấp",196983,207350,10367,5
TIKI,tui-thoi-trang-nam,53791864,"Túi đeo chéo nam nữ thời trang Hàn quốc BEE GEE 076 chống thấm nước cực kỳ cá tính HOT TREND 2020",60000,120000,60000,50
TIKI,tui-thoi-trang-nam,120035672,"Ví đựng passport da bò Huy Hoàng màu da-HP9104",559000,559000,0,0
TIKI,tui-thoi-trang-nam,168232208,"TÚI ĐEO CHÉO , ĐEO HÔNG , ĐEO BỤNG NHIỀU NGĂN CAO CẤP",107000,107000,0,0
TIKI,tui-thoi-trang-nam,176130252,"Bóp ví nam có khóa kéo thời trang tiện lợi kiểu dáng hàn quốc ví nam cầm tay cao cấp Mã: MB22",158000,158000,0,0
TIKI,tui-thoi-trang-nam,73811604,"Ví da bò nam Handmade AT leather WEN-02",499000,590000,91000,15
TIKI,tui-thoi-trang-nam,73631287,"Túi mini đeo chéo nam nữ thời trang phong cách hàn quốc - Munnini",61800,61800,0,0
TIKI,tui-thoi-trang-nam,21979554,"Ví nam da bò vân cá sấu lớn Huy Hoàng",489000,489000,0,0
TIKI,tui-thoi-trang-nam,149179098,"Túi bao tử đeo chéo, đeo thắt lưng vải canvas 5 ngăn thời trang nam T68 23x25x12cm và 21x13x10cm (NÂU - XANH RÊU - ĐEN)",252000,252000,0,0
TIKI,tui-thoi-trang-nam,188731205,"Túi đeo chéo bao tử Sport, Túi đeo hông - đeo bụng vải dù chống thấm nước kiểu dáng thể thao nhiều ngăn size 30cm",65000,65000,0,0
TIKI,tui-thoi-trang-nam,193395247,"Túi Xách, Cặp Công Sở Thời Trang Nam Da Bò Epsom Cao Cấp CDX16 Xanh",3050000,3050000,0,0
TIKI,tui-thoi-trang-nam,476571,"Túi Đeo Chéo Ipad Mikkor Roady Sling RS 010 - Xanh Rêu",249000,249000,0,0
TIKI,tui-thoi-trang-nam,148932522,"Túi đeo chéo nam vải canvas chống nước 3 ngăn phong cách Hàn Quốc TCN02",39000,39000,0,0
TIKI,tui-thoi-trang-nam,141491146,"TÚI ĐEO CHÉO NAM MESSBAG DA PU (ĐEN) NU3 Kodoros - KDR-TDC288- BẢO HÀNH 1 NĂM",121000,169125,48125,28
TIKI,tui-thoi-trang-nam,182461440,"Bóp nam đựng danh thiếp, thẻ atm, cccd, hộp thẻ có lẫy tự động tích hợp công nghệ chống trộm thông minh RFID",278000,278000,0,0
TIKI,tui-thoi-trang-nam,10694406,"Clutch cầm tay da bò nguyên tấm BHM2753",1050000,1050000,0,0
TIKI,tui-thoi-trang-nam,143063632,"Ví nam da bò Anh Tho Leather MIN-05",477000,550000,73000,13
TIKI,tui-thoi-trang-nam,17587644,"Ví Đựng Hộ Chiếu Passport Bảo Quản Thẻ Chống Thấm",48000,48000,0,0
TIKI,tui-thoi-trang-nam,93240037,"Túi đeo chéo nam cỡ nhỏ da bò 100% cao cấp - mã 701",419000,799020,380020,48
TIKI,tui-thoi-trang-nam,54825071,"Ví nam cao cấp da thật ELLY- EVM11 đen",699300,999000,299700,30
TIKI,tui-thoi-trang-nam,112554152,"Ví da nam Gianni Conti Italy 1607220BRO",1600000,1600000,0,0
TIKI,tui-thoi-trang-nam,3942461,"Túi Đeo Hông Cho Nam",65000,65000,0,0
TIKI,tui-thoi-trang-nam,17614881,"Cặp Xách Da Đựng Laptop CNT'S HQ10",365000,365000,0,0
TIKI,tui-thoi-trang-nam,143062288,"Ví da bò nam Anh Tho Leather 042",292000,345000,53000,15
TIKI,tui-thoi-trang-nam,169534135,"Ví đứng nam Cefiro da bò thật WS224 (Black) ",99000,99000,0,0
TIKI,tui-thoi-trang-nam,188995636,"Ví Sen DA BÒ THẬT handmade",200000,200000,0,0
TIKI,tui-thoi-trang-nam,185843672,"Ví Da Bò Nam Cao Cấp POLO MEISDO Sang Trọng ( Da Bò Thật 100%) Bảo Hành 24 Tháng",1000000,1000000,0,0
TIKI,tui-thoi-trang-nam,169006665,"Clutch Da Hàng Hiệu Ví Nam Cầm Tay Công Sở GENCE HT11 Da Bò Cao Cấp Màu Đen",1400000,1400000,0,0
TIKI,tui-thoi-trang-nam,193720550,"TÚI ĐEO CHÉO DÂY THỔ CẨM CHẤT LIỆU DA CAO CẤP",250000,250000,0,0
TIKI,tui-thoi-trang-nam,188997873,"Bao da dành cho Chìa Khóa Vespa, remote tìm xe handmade da thật",99000,99000,0,0
TIKI,tui-thoi-trang-nam,79937920," Túi xách đeo chéo nam nữ unisex thời trang Hàn quốc BEE GEE 086",125000,250000,125000,50
TIKI,tui-thoi-trang-nam,127604927,"HJ2113-14-15 - Bóp nam Huy Hoàng da bò cao cấp màu da, đen, nâu",489000,489000,0,0
TIKI,tui-thoi-trang-nam,80855497,"Túi đeo chéo thời trang đi học viền phản quang unisex",133000,133000,0,0
TIKI,tui-thoi-trang-nam,248546583,"Ví nam khắc tên da bò thật Nappa cao cấp LIDAN, bóp dáng ngang có hộp vintage kèm thiệp đẹp làm quà tặng LD3",469000,469000,0,0
TIKI,tui-thoi-trang-nam,174531721,"Ví cầm tay Efora 6042A-BL clutch nam khoá số , clutch nam hàng hiệu, da thật, ví bao nam cao cấp thời trang",5680000,5680000,0,0
TIKI,tui-thoi-trang-nam,48054040,"Ví Nam Da Bò Thật 100% May Tay Thủ Công Siêu Bền",179000,179000,0,0
TIKI,tui-thoi-trang-nam,17974529,"Bóp ví nam cầm tay bản to VT04",225000,225000,0,0
TIKI,tui-thoi-trang-nam,173660573,"Ví Nam Da Bò Thật BIGGBEN Cao Cấp BG18",339000,390000,51000,13
TIKI,tui-thoi-trang-nam,188996010,"Bao da dành cho chìa khoá Xe điện Vinfast Klara A2 a2, Feliz , Klara S 2022, Remote tìm xe chống trộm, VF Felix handmade da thật",130000,130000,0,0
TIKI,tui-thoi-trang-nam,82008382,"Túi đeo chéo nam Army chéo kiểu quân đội đi chơi và đi phượt",98000,130000,32000,25
TIKI,tui-thoi-trang-nam,76738381,"Túi đeo chéo _ túi bao tử da nam _ nữ SGB02 đen_nâu đen",325000,325000,0,0
TIKI,tui-thoi-trang-nam,181785828,"Túi chiến thuật rằn ri đi hành quân, dã ngoại, thao trường cho bộ đôi mẫu mới 2020 (1 cóc)",80000,80000,0,0
TIKI,tui-thoi-trang-nam,83677556,"Túi đeo chéo Reeyee RY2020",715000,715000,0,0
TIKI,tui-thoi-trang-nam,171771644,"Cặp khóa số , cặp da khóa số cao cấp A1",857000,857000,0,0
TIKI,tui-thoi-trang-nam,149179537,"Ví nam, bóp nam da bò thật 100% định vị từ xa kết nối Blutool với Smartphone chống thất lạc - Bảo hành 12 tháng",936000,936000,0,0
TIKI,tui-thoi-trang-nam,122590244,"Túi Đeo Chéo Nam BT08 Có Quai Xách Thiết Kế Tiện Lợi",185000,370000,185000,50
TIKI,tui-thoi-trang-nam,137499350,"Bóp Ví Nam da bò NAPPA cao cấp LV168,Ví đứng da thật 100% leather BH-24TH hàng xịn da đẹp/làm quà tặng sang trọng",125000,125000,0,0
TIKI,tui-thoi-trang-nam,165961866,"Túi đeo chéo Mikkor The Gibson Sling",990000,990000,0,0
TIKI,tui-thoi-trang-nam,25075240,"Ví Da Nam Cao Cấp Gập 2 Màu Bò",380000,380000,0,0
TIKI,tui-thoi-trang-nam,171775541,"cặp laptop 14inch , túi da công sở khóa số cao cấp D3",827000,827000,0,0
TIKI,tui-thoi-trang-nam,54581710,"Ví nam da bò nhập khẩu W04",169000,380000,211000,56
TIKI,tui-thoi-trang-nam,76076076,"Túi đeo chéo nam nữ unisex hot trend 2021 để điẹn thoại ipad hoạ tiết TRÂU may mắn K02 BEE GEE",75000,150000,75000,50
TIKI,tui-thoi-trang-nam,120657405,"Ví đựng passport da bò Huy Hoàng màu da HC9104",399000,399000,0,0
TIKI,tui-thoi-trang-nam,72758226,"Cặp nam công sở cao cấp BHM8988 Da bò cao cấp nguyên tấm và sử dụng lớp da đầu tiên. Vừa laptop 16inch. Túi xách nam",2150000,2150000,0,0
TIKI,tui-thoi-trang-nam,12134191,"Túi đeo chéo ANELLO vải polyester chống thấm nước AT-B1717 - Màu",1520000,1520000,0,0
TIKI,tui-thoi-trang-nam,146362124,"Ví nam đứng da bò thật BHLD128",289000,289000,0,0
TIKI,tui-thoi-trang-nam,149179912,"Túi nam đeo trước ngực hàng mới siêu đẹp HAODIER",576000,576000,0,0
TIKI,tui-thoi-trang-nam,82489616,"Túi Nam Đeo Chéo Bao Tử Da Bò Sáp BT02 Trẻ Chung Tiện Lợi",295000,590000,295000,50
TIKI,tui-thoi-trang-nam,190171393,"Túi đeo ngực nam BHM8123 Da bò thật, tích hợp dây sạc dài",750000,750000,0,0
TIKI,tui-thoi-trang-nam,13423484,"Túi đeo chéo nam nữ Hàn quốc Bee Gee 046 xanhs",65000,130000,65000,50
TIKI,tui-thoi-trang-nam,77040654,"Ví vải Modern Fabric Wallet HAVIAS",319200,399000,79800,20
TIKI,tui-thoi-trang-nam,2000489,"Ví Nam Da Cá Sấu Kiểu Đứng Huy Hoàng HT2228 (12.5 x 10 cm) - Đen",1099000,1099000,0,0
TIKI,tui-thoi-trang-nam,17116140,"Túi bao tử đeo chéo đa năng CK117",208950,208950,0,0
TIKI,tui-thoi-trang-nam,80959178," Túi da nam đeo chéo cao cấp",228000,228000,0,0
TIKI,tui-thoi-trang-nam,82121962,"Túi Đeo Dã Ngoại Hi Buddy",89000,89000,0,0
TIKI,tui-thoi-trang-nam,70666746,"Ví Dài 5THEWAY Tím aka 5THEWAY /solid/ LONG WALLET in BURGUNDY",350000,350000,0,0
TIKI,tui-thoi-trang-nam,6634863,"Ví Đứng Handmade",380000,380000,0,0
TIKI,tui-thoi-trang-nam,173542332,"Ví Da Bò Nam Cao Cấp Hàng Hiệu POLO MEISDO Sang Trọng ( Da Bò Thật 100%)Phù Hợp Làm Quà Biếu Tặng Sinh Nhật",1200000,1200000,0,0
TIKI,tui-thoi-trang-nam,153006331,"Ví mini da bò Anh Tho Leather AT057",299000,355000,56000,16
TIKI,tui-thoi-trang-nam,153265081,"Túi đeo chéo nam nữ vải bố chỉ 2 chấm đứng mẫu mới BC17 Shalla tặng thẻ căn cước",41452,43634,2182,5
TIKI,tui-thoi-trang-nam,103071806,"Ví Nam Da Epsom Dáng Ngang Handmade Lealux Epsom Wallet 2",689000,689000,0,0
TIKI,tui-thoi-trang-nam,6893091,"Ví nam da bò AT Leather 041",269000,325000,56000,17
TIKI,tui-thoi-trang-nam,72204498,"Ví nam vuông cao cấp hình mắt cú thời cá tính LA10 Tặng móc khóa nam",74250,101475,27225,27
TIKI,tui-thoi-trang-nam,10013084,"Cặp Nam Công Sở Da Thật CDT04 (38 x 27 x 8 cm)",2050000,2050000,0,0
TIKI,tui-thoi-trang-nam,136596019,"Túi đeo chéo nam da Pu dập Vân Da Cá Sấu Siêu bền đẹp Chống Nước",272000,272000,0,0
TIKI,tui-thoi-trang-nam,74892478,"Ví Nam Da Bò Thật Bóp Đứng Mini Nhỏ Gọn Cao Cấp Màu Kaki Đen Tặng Kèm Hộp DCE734",99000,99000,0,0
TIKI,tui-thoi-trang-nam,74383930,"Khay kẹp tài liệu A4 đa chức năng",627000,627000,0,0
TIKI,tui-thoi-trang-nam,141009952,"Túi đeo chéo nam, túi đeo chéo vải dù cao cấp dành cho người đi làm, học sinh, sinh viên,phong cách thời trang hiện đại",465000,465000,0,0
TIKI,tui-thoi-trang-nam,149179492,"Ví cầm tay nam nữ OULUBOLO mã BA05 thời trang da bò size lớn có xỏ ngón và dây đeo cổ tay",540000,540000,0,0
TIKI,tui-thoi-trang-nam,148695047,"Túi da bò thật  đựng iPad, Macbook Vintage may thủ công",1176000,1176000,0,0
TIKI,tui-thoi-trang-nam,182994614,"Ví nam da đà điểu, chất liệu da chân da đà điểu thật cao cấp",748000,748000,0,0
TIKI,tui-thoi-trang-nam,170131428,"Túi đeo chéo nam nữ, túi bao tử, túi đeo ngực, túi đeo bụng da bò thật thương hiệu SEAGLE S1B01",379000,379000,0,0
TIKI,tui-thoi-trang-nam,193720444,"TÚI ĐEO CHÉO THỜI TRANG PHONG CÁCH CHÂU ÂU",380000,380000,0,0
TIKI,tui-thoi-trang-nam,196840198,"Bóp Nam da bò thật nhiều ngăn đựng - B001A",350000,350000,0,0
TIKI,tui-thoi-trang-nam,120068107,"Ví card mini da bò đẹp cao cấp Kalanos KBN570-Nau, ví mini nam nữ đựng thẻ màu nâu",290000,290000,0,0
TIKI,tui-thoi-trang-nam,55484831,"Túi đeo chéo thời trang nam nữ unisex chống thấm nước BEE GEE 090",55000,110000,55000,50
TIKI,tui-thoi-trang-nam,193720543,"TÚI BAO TỬ NAM HỌA TIẾT SANG TRỌNG",370000,370000,0,0
TIKI,tui-thoi-trang-nam,97644367,"Túi đeo chéo da ipad kiểu ngang caro xanh C1 Tặng móc khóa nam A3",62000,86470,24470,28
TIKI,tui-thoi-trang-nam,36377440,"Ví Nam Da Bò SAM Leather SAM015",649000,649000,0,0
TIKI,tui-thoi-trang-nam,191714000,"Túi đeo chéo nam vải bố size lớn thời trang Hàn Quốc Túi đeo chéo nữ canvas TUI-56",179000,179000,0,0
TIKI,tui-thoi-trang-nam,54581723,"Ví nam da bò nhập khẩu H04",155000,350000,195000,56
TIKI,tui-thoi-trang-nam,96356392,"Ví da nam nhỏ gọn dáng đứng màu nâu",350000,350000,0,0
TIKI,tui-thoi-trang-nam,2000589,"Ví Nam Da Cá Sấu Gai Đuôi Kiểu Đứng Huy Hoàng HT2258 (12.5 x 10 cm) - Đen",1149000,1149000,0,0
TIKI,tui-thoi-trang-nam,120500011,"Ví nam Huy Hoàng vân cá sấu màu vàng, đen, nâu HC2116-17-18",349000,349000,0,0
TIKI,tui-thoi-trang-nam,164697641,"VÍ SEN CỌP Edition - CHÍNH HÃNG KHACTEN.COM",350000,350000,0,0
TIKI,tui-thoi-trang-nam,190722541,"Cặp Da doanh nhân Shinkozi CS011 Da Bò Thật 100% kích thước  44 x 32 x11(cm)",2590000,2590000,0,0
TIKI,tui-thoi-trang-nam,248546660,"Ví nam da bò Nappa thật cao cấp LIDAN, bóp sọc dáng ngang có hộp vintage kèm thiệp đẹp làm quà tặng LD14",429000,429000,0,0
TIKI,tui-thoi-trang-nam,11360209,"Ví nam da bò AT Leather B41",233000,275000,42000,15
TIKI,tui-thoi-trang-nam,184591078,"Túi Nam Đeo Chéo Bao Tử Da Bò Sáp BT02 Nhỏ Gọn Tiện Lợi",295000,590000,295000,50
TIKI,tui-thoi-trang-nam,165699422,"Túi đeo chéo đeo hong đeo bao tử, nịt bụng đa năng ngang kéo tian đa năng Shalla",57961,83722,25761,31
TIKI,tui-thoi-trang-nam,103887361,"Bóp Da Cá Sấu Ví Nam Cá Sấu Phần Bụng Cao Cấp Giá Rẻ Màu Nâu Đỏ ST14 Full Hộp",750000,750000,0,0
TIKI,tui-thoi-trang-nam,104438583,"Ví nam da đẹp chất, kiểu dáng thời trang hàn quốc",125000,125000,0,0
TIKI,tui-thoi-trang-nam,21979368,"Ví nam Huy Hoàng da cá sấu kiểu đứng gù đầu màu",1199000,1199000,0,0
TIKI,tui-thoi-trang-nam,8133771,"Combo Cặp xách da nam - 8339 +  kèm ví da",199000,199000,0,0
TIKI,tui-thoi-trang-nam,149179610,"Túi đeo chéo nam da bò T42 24x20x6cm bảo hành 12 tháng (Nâu đậm) D.HSTORE",720000,720000,0,0
TIKI,tui-thoi-trang-nam,107962202,"Ví da mini thời trang hàng hiệu da bò thật nhập khẩu italy",199000,199000,0,0
TIKI,tui-thoi-trang-nam,205232741,"Bao da dành cho bọc ốp chìa khoá xe ô tô KIA Sonet, Seltos 4 nút bấm da bò nhiều màu khâu thủ công KIA14",170000,170000,0,0
TIKI,tui-thoi-trang-nam,3887599,"Túi Đeo Da Thời Trang HARAS HRTK054  - Đen",320000,320000,0,0
TIKI,tui-thoi-trang-nam,205988965,"Túi Đeo Chéo Tomtoc (USA) Lightweight Cordura Sling Bag H02 (Trắng) - Hàng Chính Hãng",1199000,1199000,0,0
TIKI,tui-thoi-trang-nam,31501182,"Ví Da Nam Gianni Conti Italy 2157655GREY",1200000,1200000,0,0
TIKI,tui-thoi-trang-nam,94486114,"Ví nam Đông Hải - KT05_Màu nâu",290000,290000,0,0
TIKI,tui-thoi-trang-nam,2000319,"Ví Nam Huy Hoàng HT2104 (12.5 x 10 cm) - Da",559000,559000,0,0
TIKI,tui-thoi-trang-nam,195567261,"Bao da dành cho Chìa Khoá Ép Phom Hyundai Stargazer, Creta 2022 allnew 4 nút Handmade Da Thật 008e",400000,400000,0,0
TIKI,tui-thoi-trang-nam,15659332,"Ví Nam, Bóp Nam [Dáng Đứng] Da Bò Thậ Cao Cấp",99000,99000,0,0
TIKI,tui-thoi-trang-nam,199545004,"Ví Bóp Nam Da Bò Nappa Khâu Thủ Công Handmade Mandino Kích Thước Nhỏ Gọn Màu Xanh Navi, Màu Nâu, Màu Đen TN421",489000,489000,0,0
TIKI,tui-thoi-trang-nam,181562213,"Ví nam ADO03, ví da nam gấp 3 nhỏ gọn, bóp nam da bò thật nhiều ngăn đựng tiền đựng thẻ, bóp da nam cao cấp bảo hàng 06 tháng - Ado Leather",179000,179000,0,0
TIKI,tui-thoi-trang-nam,127551491,"Túi bao tử - đeo chéo khóa phản quang unisex nam nữ vải chống nước phong cách",68000,96063,28063,29
TIKI,tui-thoi-trang-nam,102693061,"Bóp da nam, ví da nam, da bò thật 100%, chuẩn đẹp xịn xò A160V",125000,125000,0,0
TIKI,tui-thoi-trang-nam,193060218,"Ví nam đựng thẻ từ tính Carbon Leather RFID Money Clip",199000,199000,0,0
TIKI,tui-thoi-trang-nam,198482275,"Ví nam 100% da bò thật cao cấp phong cách mới",270000,299000,29000,10
TIKI,tui-thoi-trang-nam,137500762,"Ví nam da bò thật vân cá sấu VB25 tặng kèm hộp,Bóp nam cá sấu sang trọng kiểu ngang màu đen vân bụng cá sấu BH-24TH",190000,190000,0,0
TIKI,tui-thoi-trang-nam,195557107,"Túi xách nam Hàn Quốc túi xách thời trang giản dị",259000,259000,0,0
TIKI,tui-thoi-trang-nam,242746163,"Ví mini bóp nam nữ đựng tiền, đựng thẻ atm, visa chất liệu canvas kháng nước",90500,90500,0,0
TIKI,tui-thoi-trang-nam,143809443,"Ví da nam da bò thật 100% loại nhỏ có khe để thẻ phía ngoài",158450,158450,0,0
TIKI,tui-thoi-trang-nam,66814789,"Ví Nam Da Bò Thật Giá Rẻ VB29 Bảo Hành 12 Tháng",99000,99000,0,0
TIKI,tui-thoi-trang-nam,195552639,"TÚI ĐEO CHÉO THỜI TRANG UNISEX",259000,259000,0,0
TIKI,tui-thoi-trang-nam,97256828,"Ví nam da bò vân cá sấu Đồ Da Thành Long TLG 204460",195286,195286,0,0
TIKI,tui-thoi-trang-nam,150956755,"Ví Da Cá Sấu Nam Da Cá Sấu Thật 100% Có Nguyên Bàn Tay Móng Đẹp Màu Đen Bền Đẹp Sang Chảnh BEE GEE VN1602",470000,940000,470000,50
TIKI,tui-thoi-trang-nam,49897246,"Ví Nam Da Bò Cao Cấp PORADO",129000,129000,0,0
TIKI,tui-thoi-trang-nam,32973268,"VÍ DA NAM HANDMADE DA BÒ THẬT CAO CẤP 1",115000,115000,0,0
TIKI,tui-thoi-trang-nam,176218203,"Túi vải Túi đeo chéo Canvas nam nữ học sinh sinh viên đi học đi chơi thời trang Hàn Quốc",139000,139000,0,0
TIKI,tui-thoi-trang-nam,106244453,"Ví Cầm Tay Nam Da Bò Dập Vân Cá Sấu Thể Hiện Đẳng Cấp",92000,180000,88000,49
TIKI,tui-thoi-trang-nam,58221701,"Bóp Nam Da Cá Sấu Nguyên Con 2 Mặt. THIẾT KẾ VÍ DÁNG ĐỨNG SANG TRỌNG",868000,1291000,423000,33
TIKI,tui-thoi-trang-nam,21980303,"Túi unisex da bò Huy Hoàng 3 gấp loại nhỏ màu",419000,419000,0,0
TIKI,tui-thoi-trang-nam,146952376,"SIÊU GIÁ VỚI 1 TÚI ĐEO NGANG HÔNG NHIỀU NGĂN ĐỰNG PHỤ KIỆN TIỆN DỤNG HÀNG CAO CẤP",199000,199000,0,0
TIKI,tui-thoi-trang-nam,2000467,"Ví Nam Da Cá Sấu Nút Bấm Huy Hoàng HT2217 (12.5 x 10 cm) - Nâu Đỏ",1049000,1049000,0,0
TIKI,tui-thoi-trang-nam,119385053,"Ví nam ngang da bò thật, da Pull Wax WS107A (Nâu) - 100% da bò thật",150000,150000,0,0
TIKI,tui-thoi-trang-nam,70667421,"Ví Ngắn 5THEWAY Tím aka 5THEWAY /solid/ SQUARE WALLET in BURGUNDY",310000,310000,0,0
TIKI,tui-thoi-trang-nam,84381443,"Túi Đeo Chéo Sành Điệu",351000,351000,0,0
TIKI,tui-thoi-trang-nam,197553973,"Túi Cầm Tay Nam Gence Đeo Chéo Da Bò Vân Togo TC01",1800000,1800000,0,0
TIKI,tui-thoi-trang-nam,33597222,"Clutch Cầm Tay Da Bò Cao Cấp - BHM31121",1239000,1239000,0,0
TIKI,tui-thoi-trang-nam,137500307,"Bóp ví nam da bò thật vân cá sấu VB25-0,dáng ngang 2 mặt da thật vân lưng cá sấu gù nguyên con sang trọng màu đen BH-24T",190000,190000,0,0
TIKI,tui-thoi-trang-nam,16266325,"Ví da đựng card BD206 (Màu Nâu)",150000,150000,0,0
TIKI,tui-thoi-trang-nam,145112738,"Ví Nam Thời Trang Da Cao Câp 204439-7(đen)",30000,38000,8000,21
TIKI,tui-thoi-trang-nam,4594703,"Ví Da gấp 3 ",155000,155000,0,0
TIKI,tui-thoi-trang-nam,137501125,"Ví Da Bò Nappa cao cấp Bóp nam da thật dáng ngang sang trọng sành điệu bảo hành hai năm tặng hộp đựng",220000,220000,0,0
TIKI,tui-thoi-trang-nam,116878047,"Ví Cá Sấu Đan Viền, Gù To | Ví Da Cá Sấu Thủ Công 2 Mặt, Màu Đen | Dáng Ngang",890000,890000,0,0
TIKI,tui-thoi-trang-nam,205228601,"Bao da dành cho chìa khoá Vinfast Fadil - Đã độ đề nổ - Da bò thật - Khâu thủ công",170000,170000,0,0
TIKI,tui-thoi-trang-nam,249201555,"Ví đứng, bóp nam nữ mini da bò sáp, ví da thật gập đôi phong cách vintage",199000,199000,0,0
TIKI,tui-thoi-trang-nam,147805918,"Ví Da Nam Da Bò Cao Cấp Màu Nâu, Màu Đen, Màu Xanh Navy WT Leather 010110001, 010110002, 010110007",750000,750000,0,0
TIKI,tui-thoi-trang-nam,188996484,"Bao da dành cho chìa khoá Xe điện Vinfast Klara, Remote tìm xe chống trộm handmade da thật",100000,100000,0,0
TIKI,tui-thoi-trang-nam,74917655,"Túi xách công sở nam da bò cao cấp GCE12 đen",2500000,2500000,0,0
TIKI,tui-thoi-trang-nam,25892523,"Túi ipad Nam Cao Cấp",99000,99000,0,0
TIKI,tui-thoi-trang-nam,91447834,"Ví Da Nam Cao Cấp V14",400000,400000,0,0
TIKI,tui-thoi-trang-nam,25892508,"Túi Đeo Chéo Nam oween3",79000,79000,0,0
TIKI,tui-thoi-trang-nam,40727992,"Túi đeo chéo nam VA-1675-23a",410000,410000,0,0
TIKI,tui-thoi-trang-nam,188714003,"Ví nam gập đôi PANDAGO Mini 06 da thật dáng đứng nhỏ gọn bỏ túi nhiều ngăn",245000,245000,0,0
TIKI,tui-thoi-trang-nam,4902061,"Túi Đeo Chéo Dạ Quang Phát Sáng + Ví - T017 ",124000,124000,0,0
TIKI,tui-thoi-trang-nam,179794434,"Túi Điên Thoại Nam Vải Bố Cao Câp",89000,150000,61000,41
TIKI,tui-thoi-trang-nam,122576561,"Ví Da Nam Cầm Tay 1 Ngăn Phong Cách Thời Trang",82000,160000,78000,49
TIKI,tui-thoi-trang-nam,143779693,"HJ2141 - Bóp nam Huy Hoàng bấm nút màu da",529000,529000,0,0
TIKI,tui-thoi-trang-nam,2000497,"Ví Nam Da Cá Sấu Gù Chân Huy Hoàng HT2232 (12.5 x 10 cm) - Đen",1399000,1399000,0,0
TIKI,tui-thoi-trang-nam,10230755,"Túi Đeo Chéo anello Cỡ Nhỏ Unisex AU-A0131",900000,900000,0,0
TIKI,tui-thoi-trang-nam,196203740,"Ví Da Nam VD06 Kiểu Dáng Đứng Lịch Lãm Thể Hiện Đẳng Cấp",38000,50000,12000,24
TIKI,tui-thoi-trang-nam,173001935,"Ví nam da thật dáng dài cao cấp 204456",384000,384000,0,0
TIKI,tui-thoi-trang-nam,10776068,"Ví da nam thời trang có túi hộp trắng theo kèm làm quà tặng",139000,139000,0,0
TIKI,tui-thoi-trang-nam,109129299,"Ví nam da bò chân kim da bò thật, Bóp ngang nam da bò chân kim trơn cao cấp màu nâu",99000,99000,0,0
TIKI,tui-thoi-trang-nam,252812512,"[Da thật] Clutch cầm tay nam kết hợp túi đeo chéo da bò thật CL134LS (Đen/Nâu/Nâu sáp) - 100% da bò thật, BH 3 năm",629000,629000,0,0
TIKI,tui-thoi-trang-nam,34531125,"Túi đeo chéo da nam, nữ TẶNG MÓC ĐEO CHÌA KHÓA",109000,109000,0,0
TIKI,tui-thoi-trang-nam,91447950,"Ví da nam cầm tay",432000,432000,0,0
TIKI,tui-thoi-trang-nam,119410135,"Đeo chéo nam nữ đi chơi, du lịch Trong Suốt cao cấp NH58 Tặng bút cảm ứng ĐT",52250,55000,2750,5
TIKI,tui-thoi-trang-nam,162105999,"Túi đeo chéo da thời trang nam cao cấp",215000,215000,0,0
TIKI,tui-thoi-trang-nam,173805916,"Túi đeo chéo nam da cá sấu cao cấp BEE GEE – DCN9042	",450000,900000,450000,50
TIKI,tui-thoi-trang-nam,143112445,"Ví gấp 2 Mini PLUX HAVIAS",308000,385000,77000,20
TIKI,tui-thoi-trang-nam,169734524,"VÍ ĐỰNG THẺ MINI Cardholder FEATHERS Da Thật Nhập Khẩu Cao Cấp Unisex Thương Hiệu DOLANTO",100000,100000,0,0
TIKI,tui-thoi-trang-nam,165959573,"TÚI ĐEO CHÉO DA PU NAM NỮ PHỐI DÂY THỔ CẨM CÁ TÍNH PHONG CÁCH UNISEX DẠNG TRỐNG",312000,312000,0,0
TIKI,tui-thoi-trang-nam,149179211,"Túi đeo chéo nam, túi đựng ipad da bò thật dập vân cá sấu sang trọng lịch lãm đẳng cấp ( Đen - Nâu Đậm - Nâu Sáng)",1080000,1080000,0,0
TIKI,tui-thoi-trang-nam,72908528,"Túi đeo chéo nam nữ da siêu dày chống nước kiểu trơn 2 pát hít LKI612 tặng móc khóa cao cấp",98010,141570,43560,31
TIKI,tui-thoi-trang-nam,135626167," Ví nam da bò thật VO 041005 ví đứng",145000,198000,53000,27
TIKI,tui-thoi-trang-nam,248546636,"Ví nam da bò thật Nappa cao cấp LIDAN, bóp dáng ngang có hộp vintage kèm thiệp đẹp làm quà tặng LD18",459000,459000,0,0
TIKI,tui-thoi-trang-nam,188996695,"Bao da dành cho Chìa Khóa Honda Air Blade 150, Vario 150, Airblade 2020, Lead 2020, Scoopy 2022, Click handmade da thật (NẮP GẬP)",129000,129000,0,0
TIKI,tui-thoi-trang-nam,59133609,"Ví Nam Da Sáp Ướt Cá Tính, Cổ Điển YORN - Hàng Chính Hãng",248000,248000,0,0
TIKI,tui-thoi-trang-nam,22068600,"Túi đeo chéo nam thời trang T551",99000,99000,0,0
TIKI,tui-thoi-trang-nam,196338502,"Ví Da Nam Cầm Tay VD07 Kiểu Dáng Thời Trang Sang Trọng",48000,80000,32000,40
TIKI,tui-thoi-trang-nam,179437617,"Túi Đeo Chéo Nam Nữ Da Chống Nước Chống Trầy Cao Cấp – Túi Da Caro 02",139000,139000,0,0
TIKI,tui-thoi-trang-nam,197421275,"Ví Đựng Thẻ Da Bò Handmade - Leather Cards holder",199000,199000,0,0
TIKI,tui-thoi-trang-nam,54858786,"cặp da công sở dành cho nam TCS-4520 cán simili",599000,599000,0,0
TIKI,tui-thoi-trang-nam,184591813,"Túi Đeo Chéo Nam Mini BT06 Da Đơn Giản Trẻ Trung Và Thể Thao Nhiều Ngăn Đựng Nhiều Đồ",235000,450000,215000,48
TIKI,tui-thoi-trang-nam,111868872,"Túi du lịch đeo chéo Arctic Hunter XB00081 chất liệu Oxford chống thấm nước thiết kế nhiều ngăn tiện dụng, kết nối USB",369000,635000,266000,42
TIKI,tui-thoi-trang-nam,25746161,"Ví Da Bò 2 ngăn kéo Đựng Chìa Khóa",180000,180000,0,0
TIKI,tui-thoi-trang-nam,145184035,"[Da thật] Ví mini nam da bò thật vân cá sấu MN123LEA (Đứng/ Ngang) - 100% da bò thật",155000,155000,0,0
TIKI,tui-thoi-trang-nam,182123343,"Ví Nam Mini Gence Da Bò Swift Trơn Mềm C07 Màu Đen | Hàng Chính Hãng",520000,520000,0,0
TIKI,tui-thoi-trang-nam,143063357,"Ví nam da bò Anh Tho Leather MIN-04",395000,460000,65000,14
TIKI,tui-thoi-trang-nam,196906740,"Ví da nam mini thông minh da bò thật MN122 - đẳng cấp thượng lưu",300000,300000,0,0
TIKI,tui-thoi-trang-nam,96356418,"Ví Nhỏ Gọn Ví Mini Dáng Ngang Da Bò Thật V4BA016D0",290000,290000,0,0
TIKI,tui-thoi-trang-nam,137942330,"Clutch cầm tay nam khóa vân tay da bò RB06 cao cấp",2750000,2750000,0,0
TIKI,tui-thoi-trang-nam,193340934,"Ví Nhiều Ngăn Đựng Thẻ Tiện Lợi",6500,13000,6500,50
TIKI,tui-thoi-trang-nam,174516833,"Ví nam da thật dáng dài - ví da nam,bop ví nam đẹp - 204426",100000,100000,0,0
TIKI,tui-thoi-trang-nam,2000527,"Ví Nam Da Cá Sấu Kiểu Đứng Huy Hoàng HT2248 (12.5 x 10 cm) - Nâu Đất",1099000,1099000,0,0
TIKI,tui-thoi-trang-nam,175422831,"Túi Xách Nam Gence Da Bò Swift GCE17",2800000,2800000,0,0
TIKI,tui-thoi-trang-nam,95855784,"Túi Đeo Chéo Da Bò T162- Nâu- Thời Trang- Phong Cách- Cá Tính.",339000,339000,0,0
TIKI,tui-thoi-trang-nam,107763705,"Bảo hành 2 năm Ví nam da bò trơn, Bóp nam da bò đen trơn chất liệu da bò miêu hạt mềm cao cấp",325000,325000,0,0
TIKI,tui-thoi-trang-nam,58478752,"Cặp Túi Da Nam Công Sở BSS – D2925",351000,351000,0,0
TIKI,tui-thoi-trang-nam,171308378,"Túi nam đeo chéo vải bố thời trang V287",430500,430500,0,0
TIKI,tui-thoi-trang-nam,196758967,"Clutch Cầm Tay Nam Gence Khóa Số Da Bò Box Cao Cấp CK16",1950000,1950000,0,0
TIKI,tui-thoi-trang-nam,133573869,"Ví Da Bò Thật Nam Cao Cấp Ví Dài V32",534000,534000,0,0
TIKI,tui-thoi-trang-nam,10230671,"Túi Đeo Chéo anello Unisex Vải Polyester Chống Thấm Nước AT-B1717",1520000,1520000,0,0
TIKI,tui-thoi-trang-nam,169330278,"[Da thật] Túi đeo chéo, túi đeo vai nam da bò thật cao cấp NAFA TD115 mềm mại bền bỉ - BH 3 năm",467500,467500,0,0
TIKI,tui-thoi-trang-nam,183375762,"Túi công sở xám Sofia T21",285000,285000,0,0
TIKI,tui-thoi-trang-nam,183719087,"Túi Đeo Chéo DC02 Cao Cấp Dáng Tròn Thời Trang Nam Siêu Bền Siêu Tiện Dụng",265000,530000,265000,50
TIKI,tui-thoi-trang-nam,17029468,"Túi đeo chéo nam nữ unisex du lịch thời trang Hàn quốc Bee Gee 050 cao cấp đẹp giá rẻ",74000,148000,74000,50
TIKI,tui-thoi-trang-nam,248546668,"Ví nam da bò thật Nappa cao cấp LIDAN, bóp dáng ngang có hộp vintage kèm thiệp đẹp làm quà tặng LD9",469000,469000,0,0
TIKI,tui-thoi-trang-nam,136059131,"Clutch Nam Ví Cầm Tay GENCE RB07 Da Bò Khóa Số Cao Cấp Hai Màu Nâu Và Đen",1300000,1300000,0,0
TIKI,tui-thoi-trang-nam,143845813,"HJ2207 - Bóp nam Huy Hoàng da cá sấu gai đuôi màu đen",1469000,1469000,0,0
TIKI,tui-thoi-trang-nam,192784451,"Túi đen đa năng , túi đeo chéo đựng độ cao cấp",120000,120000,0,0
TIKI,tui-thoi-trang-nam,4699781,"Ví Da Nam Nhỏ Gọn Da Bò Thật Cao Cấp",99000,99000,0,0
TIKI,tui-thoi-trang-nam,196338595,"Ví Nam Dài Cầm Tay VD07 Bóp Da Nam Sang Trọng Đẳng Cấp",48000,80000,32000,40
TIKI,tui-thoi-trang-nam,50514468,"Ví Da Nam Gianni Conti Italy 587144 - 02LEA - Màu Nâu ",1600000,1600000,0,0
TIKI,tui-thoi-trang-nam,161956140,"Ví Nam Da Bò Cao Cấp Màu Đen, Nâu MILLIMAL WT Leather 010121102, 010121101",750000,750000,0,0
TIKI,tui-thoi-trang-nam,175213803,"Túi Đeo Chéo Phản-Dạ Quang Phát Sáng Nam Nữ Thời Trang Đẹp Đi Học ĐC DQ T,DG 01 tặngmóckhóa+giấythơm",245000,245000,0,0
TIKI,tui-thoi-trang-nam,186638645,"Túi Đeo Chéo Nam ,Túi  Đeo Ngực Thời Trang Thể Thao Spot Cực Đẹp",215000,215000,0,0
TIKI,tui-thoi-trang-nam,3977991,"Ví cầm tay unisex da bò Pháp BALZIO UWCOW H01-BR",245000,890000,645000,72
TIKI,tui-thoi-trang-nam,58029307,"Ví Da Cá Sấu Gai Lưng Rất Đẹp. Da Thật Rất Bền Và Sang Trọng. Thiết Kế Dáng Ngang Dễ Sử Dụng",439000,849000,410000,48
TIKI,tui-thoi-trang-nam,255758637,"Ví da - Ví cầm tay da cao cấp Macsim mã MSTH13",800000,800000,0,0
TIKI,tui-thoi-trang-nam,89785991,"Túi đeo chéo nam nữ, túi bao tử unisex chất liệu da cao cấp phong cách đường phố cá tính TC112-D",78406,82533,4127,5
TIKI,tui-thoi-trang-nam,28605691,"Bóp Ví Da Nam Sang Trọng Cao Cấp NL02",380000,380000,0,0
TIKI,tui-thoi-trang-nam,46205801,"Túi bao tử nam thể thao chống thấm nước",32000,44797,12797,29
TIKI,tui-thoi-trang-nam,89785881,"Túi đeo chéo nam da Pu họa tiết kẻ caro chống nước, phong cách thời trang năng động TC108-K",105000,145869,40869,28
TIKI,tui-thoi-trang-nam,173265833,"Túi Đeo Chéo, Đeo Ngực, Đeo Vai Tiện Lợi  8 TU031  ZZ",33000,87000,54000,62
TIKI,tui-thoi-trang-nam,248546690,"Ví nam da bò thật Nappa cao cấp LIDAN, bóp dáng ngang có hộp vintage kèm thiệp đẹp làm quà tặng LD11",429000,429000,0,0
TIKI,tui-thoi-trang-nam,248546709,"Ví nam da bò thật Nappa cao cấp LIDAN, bóp dáng ngang có hộp vintage kèm thiệp đẹp làm quà tặng LD10",469000,469000,0,0
TIKI,tui-thoi-trang-nam,110685965,"Ví Dài Cầm Tay Nam Kiểu Dáng Hàn Quốc Thiết Kế Nhiều Ngăn Tiện Lợi",499000,499000,0,0
TIKI,tui-thoi-trang-nam,189491698,"Ví Nam Da Bò Pullup Cao Cấp Dáng Đứng Ngang Songhan Leather – Thời Trang, Bảo Hành 12 Tháng",390000,390000,0,0
TIKI,tui-thoi-trang-nam,143708250,"HJ2118 - Bóp nam Huy Hoàng vân cá sấu gai lớn màu nâu",489000,489000,0,0
TIKI,tui-thoi-trang-nam,248546648,"Ví nam da bò thật Nappa cao cấp LIDAN, bóp dáng ngang có hộp vintage kèm thiệp đẹp làm quà tặng LD16",429000,429000,0,0
TIKI,tui-thoi-trang-nam,91447711,"Cặp Túi Da Nam C23",594000,594000,0,0
TIKI,tui-thoi-trang-nam,155155399,"Ví đựng thẻ card da bò D&D Fashion DDF088 nhỏ gọn, tiện lợi, bảo hành 12 tháng",99000,195000,96000,49
TIKI,tui-thoi-trang-nam,197419499,"Túi đeo chéo nam  phong cách mới  - BEE GEE DCN9082",490000,980000,490000,50
TIKI,tui-thoi-trang-nam,147891186,"Ví Cầm Tay Da Bò Dập Vân Cá Sấu 1 Ngăn Sang Trọng Nam Tính",92000,180000,88000,49
TIKI,tui-thoi-trang-nam,149451588,"Cặp da công sở cặp đựng laptop túi xách nam cao cấp",129000,129000,0,0
TIKI,tui-thoi-trang-nam,63085283,"Túi đeo chéo Nam tập GYM, thể thao chống thấm nước - DV003",220000,220000,0,0
TIKI,tui-thoi-trang-nam,84383105,"VÍ NAM DA BÒ",1651000,1651000,0,0
TIKI,tui-thoi-trang-nam,213676589,"Ví nam kiểu ngang phong cách bề mặt dập vân vô cùng lịch lãm và nam tính R024",95000,190000,95000,50
TIKI,tui-thoi-trang-nam,116886385,"Ví nam đẹp giá rẻ thời trang cao cấp nhiều ngăn đựng tiền Ví nam da đẹp chất, kiểu dáng thời trang",149000,149000,0,0
TIKI,tui-thoi-trang-nam,3937507,"Ví Dài Nam Aligro ALGVD16 Đỏ Đô (19 x 2cm)",907500,907500,0,0
TIKI,tui-thoi-trang-nam,7959702,"Túi xách công sở nam 6009",199000,199000,0,0
TIKI,tui-thoi-trang-nam,48192766,"Ví Nam Đứng Da Bò Pullup thật 100% Bóng Mềm",99000,99000,0,0
TIKI,tui-thoi-trang-nam,187512169,"Túi Xách, Cặp Công Sở Thời Trang Nam Da Bò Swift Cao Cấp 2 Khoá GCE22 Xanh",2600000,2600000,0,0
TIKI,tui-thoi-trang-nam,122587617,"Túi Đeo Chéo Nam BT06 Nhiều Ngăn Tiện Lợi Đựng Vừa Ipad",235000,450000,215000,48
TIKI,tui-thoi-trang-nam,128130700,"Cặp công sở nam cao cấp BHL1033 Vừa laptop 14inch. Da bò thô nguyên tấm",1755000,1755000,0,0
TIKI,tui-thoi-trang-nam,3139027,"Túi đeo chéo nam",44980,44980,0,0
TIKI,tui-thoi-trang-nam,149179081,"Túi đeo chéo nam da bò KANGAROO. KT: 27x23x7cm (Nâu,Đen) D.HSTORE",660000,660000,0,0
TIKI,tui-thoi-trang-nam,188996440,"Bao da dành cho Remote Honda Vario 125, Scoopy handmade da thật",99000,99000,0,0
TIKI,tui-thoi-trang-nam,55094706,"Ví bóp tiền logo đội bóng cực đẹp tiện dụng Chelsea",150000,150000,0,0
TIKI,tui-thoi-trang-nam,12273916,"Túi ipad Nam 28x25x4cm",99000,99000,0,0
TIKI,tui-thoi-trang-nam,91447669,"Cặp Túi Da Nam C102",1674000,1674000,0,0
TIKI,tui-thoi-trang-nam,120033571,"Bóp da đà điểu 3 gấp Huy Hoàng nhiều màu HP3403-04-05-06",1599000,1599000,0,0
TIKI,tui-thoi-trang-nam,45293664,"Ví da nam da bò cao cấp Gianni Conti 2157165BLA",1600000,1600000,0,0
TIKI,tui-thoi-trang-nam,54815112,"Ví nam da thật ELLY HOMME- EVM14 ",799000,799000,0,0
TIKI,tui-thoi-trang-nam,39320930,"Ví nam da bò / Bóp nam cao cấp TFH-01",99000,99000,0,0
TIKI,tui-thoi-trang-nam,14813590,"Ví/Bóp đăng kiểm ô tô cao cấp, sang trọng ERD21",63650,67000,3350,5
TIKI,tui-thoi-trang-nam,102012409,"Túi đeo chéo nam vải Polyester Hàn Quốc, túi chéo nam thiết kế nhỏ gọn thời trang năng động TC05",60000,85509,25509,30
TIKI,tui-thoi-trang-nam,98074549,"Ví dài nam in hình nổi bật nontop D47 Tặng móc khoa nam",85000,120498,35498,29
TIKI,tui-thoi-trang-nam,170179026,"Ví nam, bóp nam vuông mini cầm tay cao cấp da thật, giá rẻ nhỏ gọn, rất mềm và nhẹ",109000,109000,0,0
TIKI,tui-thoi-trang-nam,94583860,"Túi đeo chéo ôm sát người Bodi Baggu",767000,767000,0,0
TIKI,tui-thoi-trang-nam,183510924,"Túi Nam Đeo Chéo Cao Cấp túi đeo ngực cao cấp 205968",92000,113000,21000,19
TIKI,tui-thoi-trang-nam,76193868,"Ví Da Smeraldo Mini Card , Bóp Da Smeraldo Mini Card Da Tanmin, Màu Đen, Nâu, Bò, Kem",300000,300000,0,0
TIKI,tui-thoi-trang-nam,106604711,"Ví Ngắn Gập Da FLAT Da Saffiano Nhập Khẩu Cao Cấp Chống Thấm Nước Nam Nữ DOLANTO",220000,220000,0,0
TIKI,tui-thoi-trang-nam,148811830,"Ví Nam Ngắn Đựng Thẻ Tín Dụng, Ví Ngắn Da Vân Sần Đựng Thẻ Có Khóa Kéo (BLDY01)",88000,88000,0,0
TIKI,tui-thoi-trang-nam,57319744,"Ví Nam Da Cá Sấu 2 Mặt [Gù Cá Sấu Nguyên Con Rất Đẹp",839000,1350000,511000,38
TIKI,tui-thoi-trang-nam,165699456,"Đeo bao tử nịt bụng đa năng 5 ngăn đen rêu Shalla RT54",86863,118713,31850,27
TIKI,tui-thoi-trang-nam,97644673,"Ví cầm tay nam in hình nổi bật nontop DS98 Tặng móc khóa nam",85000,120460,35460,29
TIKI,tui-thoi-trang-nam,127604836,"HJ2110-11-12 - Bóp nam Huy Hoàng vân cá sấu màu da, đen, nâu",489000,489000,0,0
TIKI,tui-thoi-trang-nam,73791186,"Ví da bò nam Handmade AT Leather WEN-01",499000,590000,91000,15
TIKI,tui-thoi-trang-nam,58732889,"Túi Xách Nam Công Sở Cao Cấp - HGcork Corkor CK264 - Messenger Bag Cỡ Vừa - Hàng Chính Hãng, Sản Xuất Tại Bồ Đào Nha",2564050,2699000,134950,5
TIKI,tui-thoi-trang-nam,192009213,"Ví nam da bò bóp đựng tiền điện thoại di động dáng đứng và dáng ngang",72000,90000,18000,20
TIKI,tui-thoi-trang-nam,77703860,"Túi đeo bụng, đeo chéo đa năng ngang kéo Tian cao cấp LL032 Tăng móc khóa nam cao cấp",75000,106887,31887,30
TIKI,tui-thoi-trang-nam,52007745,"Ví Nam Dài The Heyday Long Wallet",468800,586000,117200,20
TIKI,tui-thoi-trang-nam,171776526,"Cặp giáo viên công chức khóa số bảo mật",957000,957000,0,0
TIKI,tui-thoi-trang-nam,3977979,"Ví nam da bò Pháp BALZIO MWCOW W01-BR",179000,320000,141000,44
TIKI,tui-thoi-trang-nam,149179380,"Túi đeo chéo nam da bò T05-3 2 size bảo hành 12 tháng (Nâu) D.HSTORE",720000,720000,0,0
TIKI,tui-thoi-trang-nam,149179820,"Túi đeo chéo nam da bò cao cấp KANGAROO. KT: 27x23x7cm (Nâu,Đen)",840000,840000,0,0
TIKI,tui-thoi-trang-nam,3750585,"Ví Da Đà Điểu - Đen",824500,850000,25500,3
TIKI,tui-thoi-trang-nam,168712047,"Ví đựng thẻ card Mango hàng chính hãng",210000,210000,0,0
TIKI,tui-thoi-trang-nam,40610332,"Ví Da Nam Bóp Da Phong Cách Hiện Đại - PI01 - Nâu Cà Phê",66000,66000,0,0
TIKI,tui-thoi-trang-nam,59164401,"Túi đeo chéo đeo hông thời trang hiện đại KMT001 Tặng móc khóa nam cao cấp",123000,174537,51537,30
TIKI,tui-thoi-trang-nam,68520574,"[VOUCHER 30K] Ví Clutch cầm tay LATA CT001 nhiều màu",620000,620000,0,0
TIKI,tui-thoi-trang-nam,82909010,"Ví da nam thủ công đỏ đô - Ví da handmade mini DTV003",325000,325000,0,0
TIKI,tui-thoi-trang-nam,206249814,"Ví da nam . ví nam cao cấp Full hộp WilliamPOLO -  V32",545000,545000,0,0
TIKI,tui-thoi-trang-nam,102731501,"Bóp da nam, ví da nam, da bò thật 100%, vân tay cá sấu A101V",159000,159000,0,0
TIKI,tui-thoi-trang-nam,69859926,"Túi phụ kiện đeo hông",109000,109000,0,0
TIKI,tui-thoi-trang-nam,43874609,"Cặp da công sở LATA CA26",559000,720000,161000,22
TIKI,tui-thoi-trang-nam,202997244,"Túi đeo bụng, đeo chéo cho nam, nữ kiểu dáng thể thao nhiều ngăn tiện lợi TUI-106",69000,69000,0,0
TIKI,tui-thoi-trang-nam,25688024,"Ví Nam Da Bò – Ví Ngang SAM Leather SAM006",649000,649000,0,0
TIKI,tui-thoi-trang-nam,102015604,"Túi đeo chéo nam da nhám nắp kéo đôi SS015 Tặng móc khóa hình khiên",103950,150150,46200,31
TIKI,tui-thoi-trang-nam,49763182,"Ví cầm tay nam",359000,359000,0,0
TIKI,tui-thoi-trang-nam,182994411,"Ví đứng nam da đà điểu 2 mặt, kích thước nhỏ gọn chất liệu da đà điểu thật cao cấp",986000,986000,0,0
TIKI,tui-thoi-trang-nam,81313175,"Clutch, Ví Cầm Tay Nam Sang Trọng T60809",133650,182655,49005,27
TIKI,tui-thoi-trang-nam,120036437,"Ví Namcard da bò Huy Hoàng nhiều màu HP9101-02-03",279000,279000,0,0
TIKI,tui-thoi-trang-nam,151574157,"Túi đeo chéo nam cao cấp phong cách HÀN QUỐC BEE GEE DCN9015 (Tặng quà tặng ngẫu nhiên trong BEEGEE GILF COLLECTION)",270000,540000,270000,50
TIKI,tui-thoi-trang-nam,197747595,"Hộp Bút Tam Giác SAIGON SWAGGER Vừa Máy Tính Casio -SGS Pencil Case",99000,99000,0,0
TIKI,tui-thoi-trang-nam,193720644,"VÍ CLUTCH NAM CHẤT LIỆU DA CAO CẤP",199000,199000,0,0
TIKI,tui-thoi-trang-nam,51733010,"Túi xách da nam công sở cao cấp",199000,199000,0,0
TIKI,tui-thoi-trang-nam,167470113,"Ví Nam, Bóp Nam Thời Trang Da Bò EPSOM Cao Cấp Gence HM04",1150000,1150000,0,0
TIKI,tui-thoi-trang-nam,169736599,"VÍ ĐỰNG THẺ MINI NAM NỮ Cardholder TRIFOLD Da Thật Cao Cấp Nhập Khẩu Thương Hiệu DOLANTO",250000,250000,0,0
TIKI,tui-thoi-trang-nam,15929671,"Ví da bò đựng Name Card Vinalea NCA0002G",98000,98000,0,0
TIKI,tui-thoi-trang-nam,58214240,"Ví Cầm Tay Thời Trang Unisex LATA VN37",469000,590000,121000,21
TIKI,tui-thoi-trang-nam,132834245,"Túi đeo chéo nam dáng ngang BHM8007 Da bò thật, mỏng gọn",802000,802000,0,0
TIKI,tui-thoi-trang-nam,19921227,"Ví Da Nam SAM Leather SAM001",690000,690000,0,0
TIKI,tui-thoi-trang-nam,163792834,"Túi đeo chéo - túi bao tử nam nữ du lịch thời trang",184000,184000,0,0
TIKI,tui-thoi-trang-nam,136091559,"Bóp ví nam da bò thật SEAGLE dáng đứng SMV201",245000,245000,0,0
TIKI,tui-thoi-trang-nam,156710959,"Túi đeo chéo để ipad nhều ngăn chống thấm nước cao cấp TUI-29",143000,143000,0,0
TIKI,tui-thoi-trang-nam,196704803,"Túi đeo chéo nam đựng điện thoại  - BEE GEE DCN9077",199000,398000,199000,50
TIKI,tui-thoi-trang-nam,70808435,"[Da thật] Ví nam da thật; Ví đứng 18 ngăn WS101A",165000,165000,0,0
TIKI,tui-thoi-trang-nam,172997593,"Ví đứng nam da cá sấu bàn tay Bóp đứng nam da cá sấu thật",790000,790000,0,0
TIKI,tui-thoi-trang-nam,183360075,"Ví đứng nam da đà điểu 2 mặt, kích thước nhỏ gọn chất liệu da đà điểu thật cao cấp",985000,985000,0,0
TIKI,tui-thoi-trang-nam,184414849,"Ví Da Nam VD03 Kiểu Ngang Nhỏ Gọn Siêu Bền ",75000,150000,75000,50
TIKI,tui-thoi-trang-nam,16256081,"Túi đeo chéo nam nữ unisex thời trang du lịch Hàn Quốc BEEGEE 029",34500,69000,34500,50
TIKI,tui-thoi-trang-nam,122230493,"Ví Da Nam Da Bò Sáp Thật Kiểu Dáng Đứng Sang Trọng Đẳng Cấp Phái Mạnh",299000,299000,0,0
TIKI,tui-thoi-trang-nam,149179973,"Túi đeo chéo nam thời trang vải canvas T63 KT:28x20x9cm và 29x25x13cm ( Đen - Nâu - Xám - Xanh)",360000,360000,0,0
TIKI,tui-thoi-trang-nam,102012727,"Ví nam dáng ngang cao cấp da PU ví nam cầm tay bóp nam đẹp nhỏ gọn đựng tiền - MB01",158000,158000,0,0
TIKI,tui-thoi-trang-nam,103886611,"Bóp Ví Nam Da Cá Sấu Lưng STM02",650000,760000,110000,14
TIKI,tui-thoi-trang-nam,53999530,"TÚI BAO TỬ ĐEO BỤNG DA BÒ MG057 SIÊU CAO CẤP",435000,435000,0,0
TIKI,tui-thoi-trang-nam,145145681,"Ví nam da thật dáng dài - ví da nam,bop ví nam đẹp - 204426",101000,138000,37000,27
TIKI,tui-thoi-trang-nam,115477606,"Ví nam cầm tay Gianni Conti Italy VP0176NAV - Xanh đen",3300000,3300000,0,0
TIKI,tui-thoi-trang-nam,31781113,"Túi đeo chéo nam da 4 ngăn",99000,99000,0,0
TIKI,tui-thoi-trang-nam,16371799,"Túi Đeo Chéo Cao Cấp Hàng Nhập Khẩu - Túi Chống Trộm Chuyên Nghiệp",295000,295000,0,0
TIKI,tui-thoi-trang-nam,37944799,"Túi Da Đeo Chéo P078",329000,329000,0,0
TIKI,tui-thoi-trang-nam,54836661,"Túi đeo chéo nam nữ unisex túi messenger du lịch thời trang Hàn quốc HOT TREND 2020 Bee Gee 083 chống thấm nước",40000,80000,40000,50
TIKI,tui-thoi-trang-nam,85558668,"Bóp nam / Ví nam SAM Leather da bò nhập khẩu kiểu dáng ngang cao cấp sang trọng - Ví da Saffiano Leather102",289000,389000,100000,26
TIKI,tui-thoi-trang-nam,5494435,"Ví cầm tay nam da bò BHM9013 Đen",499000,499000,0,0
TIKI,tui-thoi-trang-nam,33373108,"Ví nam da cao cấp",129000,129000,0,0
TIKI,tui-thoi-trang-nam,177929234,"Túi Xách Nam Nữ Công Sở, Cặp Đựng Laptop 15.6 Inch BEEGEE CCS5515",460000,460000,0,0
TIKI,tui-thoi-trang-nam,141009784,"Túi Đeo Chéo Nam Cao Cấp, Vải Bền Đẹp Chống Thấm Nước, Phong Cách Thời Trang Hàn Quốc",189000,189000,0,0
TIKI,tui-thoi-trang-nam,164362837,"Túi đeo hông nam nữ thời trang túi đeo bao tử unisex",184000,184000,0,0
TIKI,tui-thoi-trang-nam,50419887,"Ví nam da mềm-Valentino Creations-LQN-200132V-B-DBN",3390000,3390000,0,0
TIKI,tui-thoi-trang-nam,119617637,"Túi đeo chéo nam vải bố Kéo chỉ đỏ thời trang trẻ trung CX14 Tặng bút cảm ứng ĐT",53020,55811,2791,5
TIKI,tui-thoi-trang-nam,119443548,"Ví nam Huy Hoàng da bò màu da, đen, nâu HT2101-02-03",349000,349000,0,0
TIKI,tui-thoi-trang-nam,152705131,"Ví mini da bò Anh Tho Leather CAPT",199000,270000,71000,26
TIKI,tui-thoi-trang-nam,149179456,"Túi xách da công sở cao cấp JEEP BULUO T02(KT 39x29x8cm)",504000,504000,0,0
TIKI,tui-thoi-trang-nam,2121675,"Túi Đeo Chéo Hi Buddy BHB418 (27 x 5 x 40 cm) - Bạc",100000,100000,0,0
TIKI,tui-thoi-trang-nam,54845401,"Túi đeo chéo nam nữ chống shock để laptop  nam nữ thời trang Hàn quốc BEE GEE 087",105000,210000,105000,50
TIKI,tui-thoi-trang-nam,13417998,"Túi đeo chéo nam nữ unisex Hàn Quốc Bee Gee 046 XÁM",65000,130000,65000,50
TIKI,tui-thoi-trang-nam,190722537,"Cặp Da Công Sở - Cặp Da Thật Đựng Laptop CS07 Shinkozi ,Da Bò Thật 100%",2490000,2490000,0,0
TIKI,tui-thoi-trang-nam,58220738,"Bóp Nam Dáng Đứng Da Đuôi Cá Sấu 2 Mặt. ĐAN VIỀN THỦ CÔNG RẤT ĐẸP",868000,1291000,423000,33
TIKI,tui-thoi-trang-nam,26077885,"BÓP VÍ THƯ PHÁP CHA MẸ - mẫu ngẫu nhiên",48000,48000,0,0
TIKI,tui-thoi-trang-nam,49707229,"Ví nam da bò AT Leather NT36",330000,390000,60000,15
TIKI,tui-thoi-trang-nam,4898261,"Túi da đeo ngực nam vân cá sấu BHM1311",499000,499000,0,0
TIKI,tui-thoi-trang-nam,189641563,"Ví Da Nam Nữ Đựng Thẻ Handmade Lealux Mini Handmade 3",419000,419000,0,0
TIKI,tui-thoi-trang-nam,193720600,"TÚI ĐEO CHÉO NAM CHẤT LIỆU DA CAO CẤP",300000,300000,0,0
TIKI,tui-thoi-trang-nam,182297360,"Túi Nam Đeo Chéo DC04 Nhỏ Gọn Siêu Tiện Lợi Chất Da Cao Cấp Siêu Bền",265000,530000,265000,50
TIKI,tui-thoi-trang-nam,161298499,"Túi Xách, Cặp Thời Trang Nam Khóa Số Cao Cấp Da Bò Mill CTS12",2800000,2800000,0,0
TIKI,tui-thoi-trang-nam,191495039,"Túi Xách Nam Nữ Công Sở, Cặp Đựng Laptop 15.6 Inch BEEGEE CCS5521",435000,870000,435000,50
TIKI,tui-thoi-trang-nam,155776163,"Túi đeo chéo nam nữ unisex sợi polyester cao cấp chống thấm nước Haoshuai S15",50000,50000,0,0
TIKI,tui-thoi-trang-nam,173879495,"Ví đựng Card (cho nam) Gianni Conti Italy 3857394BLACK - Màu đen",990000,990000,0,0
TIKI,tui-thoi-trang-nam,54463132,"Túi Đeo Chéo Da Cao Cấp Thời Trang Tiện Lợi KN02",103950,150150,46200,31
TIKI,tui-thoi-trang-nam,186267701,"Ví Da Đựng Thẻ Handmade Cao Cấp Lealux Card Wallet",799000,799000,0,0
TIKI,tui-thoi-trang-nam,771416,"Túi Đeo Chéo Nam Haras HRTK105 (26 x 17 cm) - Xanh",65000,65000,0,0
TIKI,tui-thoi-trang-nam,164435864,"Ví đứng nam Đông Hải thiết kế da cao cấp  form gập nhỏ gọn  tiện dụng - KT07",570000,570000,0,0
TIKI,tui-thoi-trang-nam,164222909,"Ví nam Đông Hải thiết kế ngang da thật  cao cấp có vân nhẹ - KT09",590000,590000,0,0
TIKI,tui-thoi-trang-nam,4482829,"Cặp Da Nam Công Sở HT011( Màu Đen)",329000,329000,0,0
TIKI,tui-thoi-trang-nam,52275332,"Ví Nam cầm tay đựng điện thoại tiền và thẻ - V0001",174000,174000,0,0
TIKI,tui-thoi-trang-nam,57517411,"Túi da đeo chéo nam",1450000,1450000,0,0
TIKI,tui-thoi-trang-nam,86965109,"Túi đeo chéo da ipad kiểu đứng caro xanh CR31 Tặng móc khoa hình khiên",86000,121891,35891,29
TIKI,tui-thoi-trang-nam,149179150,"Túi xách cặp da giáo viên đựng laptop 14 inch da bò công sở T21 khóa số (Nâu-Đen) KT 38-27-7CM",1260000,1260000,0,0
TIKI,tui-thoi-trang-nam,206521689,"Bao da dành cho móc khoá bọc ốp chìa khoá xe ô tô Toyota Corolla Cross, da bò, nhiều màu, khâu thủ công To29",170000,170000,0,0
TIKI,tui-thoi-trang-nam,193013068,"Clutch Cầm Tay Nam Da Bò Epsom HT19",1350000,1350000,0,0
TIKI,tui-thoi-trang-nam,149796507,"Ví Nam Bóp Nam Da Bò SUNPOLO WSCT54 (Đen)",360000,360000,0,0
TIKI,tui-thoi-trang-nam,182462842,"Ví nam cầm tay, bóp nam nữ đựng thẻ tín dụng, thẻ ngân hàng atm, danh thiếp, hộp hợp kim nhôm có lẫy, công nghệ chống trộm thông mình RFID",278000,278000,0,0
TIKI,tui-thoi-trang-nam,55609537,"ví nam hàng da thật có khóa kéo ( có hộp đựng )",139000,139000,0,0
TIKI,tui-thoi-trang-nam,52173167,"Ví nam da bò AT Leather AT020",275000,325000,50000,15
TIKI,tui-thoi-trang-nam,191123281,"COHI B2 - Bao Da Bảo Quản 2 Điếu Cigar, TẶNG DAO CẮT, Ví Đựng Tiện Lợi Bỏ Túi, Du Lịch, Giã Ngoại, Chơi Golf (Humidor)",259000,259000,0,0
TIKI,tui-thoi-trang-nam,213678479,"Ví nam thời trang bỏ túi nhỏ gọn D031",90000,180000,90000,50
TIKI,tui-thoi-trang-nam,2793423,"Ví Nam Da Bò SUNPOLO WS06D",450000,450000,0,0
TIKI,tui-thoi-trang-nam,173542368,"Bóp Da Nam Ví Da Bò Nam Cao Cấp Hàng Hiệu POLO MEISDO Sang Trọng ( Da Bò Thật 100%) Bảo Hành 24 Tháng",1200000,1200000,0,0
TIKI,tui-thoi-trang-nam,193603184,"Túi đeo chéo chống nước, khóa số chống trôm cao cấp BG-22085",500000,500000,0,0
TIKI,tui-thoi-trang-nam,83692703," Ví Đứng Gấp 3 Da Bò VD190",258000,258000,0,0
TIKI,tui-thoi-trang-nam,173542439,"Ví Da Bò Nam Cao Cấp Hàng Hiệu POLO MEISDO Sang Trọng ( Da Bò Thật 100%) Làm Quà Biếu Tặng Sinh Nhật Cực Đẹp",1200000,1200000,0,0
TIKI,tui-thoi-trang-nam,193904102,"Ví nam da bò Collin Kacey, bóp da nam mềm mại, có khóa kéo-full hộp - Hàng nhập khẩu",199000,199000,0,0
TIKI,tui-thoi-trang-nam,169003932,"Ví Cầm Tay Clutch Da Nam Hàng Hiệu GENCE CK15 Da Bò Khóa Số Cao Cấp Màu Nâu",1800000,1800000,0,0
TIKI,tui-thoi-trang-nam,176130422,"Túi đeo chéo nam nữ chất liệu vải chống thấm nước phong cách Hàn Quốc - Túi bao tử Unisex TC06",178000,178000,0,0
TIKI,tui-thoi-trang-nam,109340213,"Túi đeo chéo bao tử Zakomi thời trang Unisex, phong cách cá tính, túi đeo trước ngực chất liệu vải chống nước cao cấp",149000,149000,0,0
TIKI,tui-thoi-trang-nam,39322045,"Ví nam da bò / Bóp nam cao cấp TFH-04",99000,99000,0,0
TIKI,tui-thoi-trang-nam,185843698,"Bóp Da Nam Ví Da Bò Nam Cao Cấp POLO MEISDO Sang Trọng ( Da Bò Thật 100%) Bảo Hành 24 Tháng",1000000,1000000,0,0
TIKI,tui-thoi-trang-nam,72558790,"Ví nam da thật kiểu đứng J4M cao cấp siêu chất, da bò thật, sản phẩm cho nam và nữ đựng tiền và giấy tờ",210000,210000,0,0
TIKI,tui-thoi-trang-nam,188995968,"Bao da dành cho Chìa Khoá Nissan Xtrail, Teana, Terra, Navara, Sunny chìa KHOÁ CƠ Handmade Da Thật 001",130000,130000,0,0
TIKI,tui-thoi-trang-nam,4781363,"Túi da đeo ngực nam BHM8871C",750000,750000,0,0
TIKI,tui-thoi-trang-nam,68530000,"Túi đeo chéo và bao tử PHẢN QUANG HOT TREND phong cách, cá tính mạnh mẽ.",141000,141000,0,0
TIKI,tui-thoi-trang-nam,149179289,"Túi đeo chéo nam thời trang da mềm BARNOROO,Túi đeo chéo, Túi đựng Ipad, Túi ví đeo chéo - ĐĂNG CẤP",820800,820800,0,0
TIKI,tui-thoi-trang-nam,95225257,"Túi Đeo Chéo Mini Thời Trang Hàn Quốc Praza - DCTK127",78000,78000,0,0
TIKI,tui-thoi-trang-nam,52702438,"Cặp da nam thời trang TL575",680000,680000,0,0
TIKI,tui-thoi-trang-nam,193582810,"Ví Da Nam cầm tay Gianni Conti Italy VP0202BLA - Đen ",3200000,3200000,0,0
TIKI,tui-thoi-trang-nam,188017812,"Túi Xách, Cặp Công Sở Thời Trang Nam Da Bò Epsom Cao Cấp CDX15 Nâu",3050000,3050000,0,0
TIKI,tui-thoi-trang-nam,2000371,"Ví Nam Vân Cá Sấu Kiểu Đứng Huy Hoàng HT2119 (12.5 x 10 cm) - Da Bò",489000,489000,0,0
TIKI,tui-thoi-trang-nam,120499963,"Ví nam da bò kiểu đứng nhiều màu Huy Hoàng HC2107-08-09",299000,299000,0,0
TIKI,tui-thoi-trang-nam,101380318,"Ví nam da bò nhập khẩu thời trang QT239 | Thương hiệu BALZIO",235000,470000,235000,50
TIKI,tui-thoi-trang-nam,120500136,"Ví nam Huy Hoàng da bò sọc ngang màu da, đen, nâu HC2131-32-33",399000,399000,0,0
TIKI,tui-thoi-trang-nam,1689017,"Ví Nam At Leather AT040-Đ (11.5 x 10 cm) - Đen",275000,325000,50000,15
TIKI,tui-thoi-trang-nam,68896660,"Bóp ví da nam gấp 3 SEAGLE SVA114",155000,155000,0,0
TIKI,tui-thoi-trang-nam,6891781,"Ví nam da bò AT Leather 014",249000,295000,46000,16
TIKI,tui-thoi-trang-nam,113232326,"Túi xách nam da bò công sở cao cấp phong cách Châu Âu mã 2019",599000,999000,400000,40
TIKI,tui-thoi-trang-nam,190738252,"Túi đeo chéo thời trang thiết kế thông minh, chống nước, ngăn chứa rộng, messengerbags hot pick 2022",395000,395000,0,0
TIKI,tui-thoi-trang-nam,149179175,"Túi đeo chéo nam da bò T75 BOLINDAISHU ̣27x23x5cm bảo hành 12 tháng (Nâu- Đen) D.HSTORE",1140000,1140000,0,0
TIKI,tui-thoi-trang-nam,131887001,"HJ2304-05-06 - Ví nam Huy Hoàng da trăn kiểu đứng màu đen, nâu, da nguyên thủy",839000,839000,0,0
TIKI,tui-thoi-trang-nam,103887188,"Ví Nam Da Cá Sấu, Bóp Nam Bàn Tay Cá Sấu",750000,750000,0,0
TIKI,tui-thoi-trang-nam,25062684,"Ví Đứng Da Cừu Nguyên Miếng Cao Cấp - BHL195",375000,375000,0,0
TIKI,tui-thoi-trang-nam,177556390,"Túi đựng Ipad cao cấp Đồ Da Thành Long TLG 208075",112000,139000,27000,19
TIKI,tui-thoi-trang-nam,153264997,"Đeo chéo nam loan màu vuông Sale sốc E01 Shalla",37161,53677,16516,31
TIKI,tui-thoi-trang-nam,86965011,"Đeo chéo thời trang cao cấp caro xanh MK45 Tặng móc hình khiên",89189,121891,32702,27
TIKI,tui-thoi-trang-nam,272185299,"Ví nam nhỏ ngang lớn da  - Màu Xám Ghi",990000,990000,0,0
TIKI,tui-thoi-trang-nam,182125812,"Túi Đeo Chéo Nam DC02 Nhiều Ngăn Tiện Dụng Phong Cách Sang Trọng Lịch Lãm",265000,530000,265000,50
TIKI,tui-thoi-trang-nam,127634706,"Ví nam Huy Hoàng vân cá sấu kiểu đứng màu da, đen, nâu HJ2119-20-21",489000,489000,0,0
TIKI,tui-thoi-trang-nam,69860647,"Túi đeo chéo thời trang Floless",162000,162000,0,0
TIKI,tui-thoi-trang-nam,116878095,"Ví Cá Sấu 1 Mặt | Ví Da Cá Sấu Gù To, Màu Nâu Cafe | Dáng Ngang | Bảo Hành 24 Tháng.",435000,435000,0,0
TIKI,tui-thoi-trang-nam,177093064,"Design 2023 - Quà tặng cho nam giới - Quà tặng sinh nhật - Quà lưu niệm cho bạn trai - Ví da nam Cao cấp _ full Túi hộp quà tặng y hình",79000,79000,0,0
TIKI,tui-thoi-trang-nam,102641939,"Túi đeo chéo nam, đeo eo, đeo ngực thời trang phong cách cho nam giới MS008",160550,169000,8450,5
TIKI,tui-thoi-trang-nam,52007749,"Ví Dài The Viva Zipped Long Wallet",680000,850000,170000,20
TIKI,tui-thoi-trang-nam,146150951,"Ví da nam dài, ví dài nam, ví nam da bò sin",390000,390000,0,0
TIKI,tui-thoi-trang-nam,192691676,"Ví Da Nam Da Bò Sáp Ngựa Điên Crazy Horse",299000,299000,0,0
TIKI,tui-thoi-trang-nam,272828984,"Túi đeo chéo nam  chất liệu Oxford chống thấm nước, đựng ipad, thiết kế nhiều ngăn tiện dụng – DCN9032 (Tặng quà tặng ngẫu nhiên trong BEEGEE GILF COLLECTION)",520000,520000,0,0
TIKI,tui-thoi-trang-nam,155061726,"Clutch Nam Cầm Tay Da Bò Taiga Chính Hãng Gence, Ví Cầm Tay Nam Công Sở Khóa Số CK14 Màu Đen",2200000,2200000,0,0
TIKI,tui-thoi-trang-nam,263038534,"Túi bao tử đeo bụng thể thao chống thấm nước - 0018",99000,99000,0,0
TIKI,tui-thoi-trang-nam,82121099,"COMBO Túi Đeo Chéo VHB418S+ Túi Chống Nước Waterlock + Ủng đi mưa",314000,314000,0,0
TIKI,tui-thoi-trang-nam,36842110,"VÍ NAM DA MỀM-LPA-220017Z-BK",3390000,3390000,0,0
TIKI,tui-thoi-trang-nam,10230744,"Túi Đeo Chéo anello Unisex Vải Polyester Cỡ Nhỏ AT-N0661",1180000,1180000,0,0
TIKI,tui-thoi-trang-nam,185843879,"Ví Cầm Tay Nam Da Bò POLO MEISDO Sang Trọng Lịch Lãm PL 06",1800000,1800000,0,0
TIKI,tui-thoi-trang-nam,196337224,"Ví Da Nam Cầm Tay VD07 Sang Trọng Lịch Lãm",48000,80000,32000,40
TIKI,tui-thoi-trang-nam,96046288," Ví da nam, bóp da nam Jeep bền đẹp, tiện lợi",39000,39000,0,0
TIKI,tui-thoi-trang-nam,147867169,"Ví đựng thẻ đa năng nhiều ngăn CL7129 bằng da bò thật",129000,129000,0,0
TIKI,tui-thoi-trang-nam,73829035,"Cặp nam công sở da bò thật Marrant BHM2019 Vừa laptop đến 15inch. Túi xách nam. Cặp văn phòng",750000,750000,0,0
TIKI,tui-thoi-trang-nam,171774787,"túi xách da , cặp giáo viên D3",600000,600000,0,0
TIKI,tui-thoi-trang-nam,247878667,"Túi Đeo Chéo Nam Nữ, Túi chống nước, chất liệu da PU,Cặp đi học cao cấp, thiết kế như túi đeo chéo đa năng nhiều ngăn",199000,199000,0,0
TIKI,tui-thoi-trang-nam,149179252,"Túi đeo chéo nam da cá sấu 100% T34 24x21x5cm bảo hành 12 tháng (Nâu-Đen) D.HSTORE",1152000,1152000,0,0
TIKI,tui-thoi-trang-nam,263058913,"Túi Đeo Chéo Nam Trước Ngực Da PU Cao Cấp Chống Nước Phong Cách Thể Thao Thời Trang Hàn Quốc Đậm Chất Nam Tính - TA082",439000,439000,0,0
TIKI,tui-thoi-trang-nam,119985783,"Ví Cầm Tay Nam Da Bò Nappa HT14",1400000,1400000,0,0
TIKI,tui-thoi-trang-nam,74281929,"Cặp táp kẹp văn kiện A4 đa năng",622000,622000,0,0
TIKI,tui-thoi-trang-nam,481767,"Túi Đeo Chéo Ipad Mikkor Betty Tablet BT008 - Đỏ Đen ",249000,249000,0,0
TIKI,tui-thoi-trang-nam,49208819,"Túi Đeo Chéo Nam Da Bò Sunpolo STU103",990000,990000,0,0
TIKI,tui-thoi-trang-nam,127594754,"HJ2110-11-12 - Bóp nam Huy Hoàng vân cá sấu màu da, đen, nâu",419000,419000,0,0
TIKI,tui-thoi-trang-nam,56683761,"Túi đeo chéo da nam nữ unisex chống thấm nước thời trang Hàn quốc BEE GEE 092 dày chống shock đựng ipad hay điện thoại",35000,70000,35000,50
TIKI,tui-thoi-trang-nam,116878101,"Ví Da Cá Sấu Thủ Công, Gù To | Da Cá Sấu Đan Viền 2 Mặt, Màu Nâu | Dáng Ngang",890000,890000,0,0
TIKI,tui-thoi-trang-nam,185843890,"Ví Cầm Tay Da Thật Nam Nữ Cao Cấp POLO MEISDO Bóp Ví Dài Cầm Tay Nam Nữ Sang Trọng Full Hộp",1400000,1400000,0,0
TIKI,tui-thoi-trang-nam,124716306,"Ví Nam Da Bò Sáp Màu Nâu Đơn Giản Nam Tính",180000,360000,180000,50
TIKI,tui-thoi-trang-nam,171764490,"túi da nam công sở , cặp công tác văn phòng cao cấp Y2 ddcg",957000,957000,0,0
TIKI,tui-thoi-trang-nam,184071715,"Túi xách bao tử unisex/ 1992 s t u d i o/ SMALL SQUARE BAG/ đeo chéo đeo hông, da đan, màu đen, size nhỏ",490000,490000,0,0
TIKI,tui-thoi-trang-nam,119989885,"HP2421 -Bóp nam Huy Hoàng da đà điểu da trơn kiểu đứng màu nâu đất",899000,899000,0,0
TIKI,tui-thoi-trang-nam,120538393,"Túi đeo trước nam da đà điểu Huy Hoàng màu vàng bò HC6445",5999000,5999000,0,0
TIKI,tui-thoi-trang-nam,120538289,"Túi đeo trước nam da cá sấu Huy Hoàng đầu cá sấu màu đen HC6289",7499000,7499000,0,0
TIKI,tui-thoi-trang-nam,143116948,"Tuí đeo chéo, ba lô Nam Nữ thời trang UNISEX BEE GEE 5104",185000,370000,185000,50
TIKI,tui-thoi-trang-nam,194025946,"Túi xách da cá sấu có quai đeo dành cho Doanh Nhân!",6800000,13000000,6200000,48
TIKI,tui-thoi-trang-nam,121970284,"Ví Nam Da Bò Kiểu Ví Đứng Thể Hiện Đẳng Cấp Phái Mạnh",99000,99000,0,0
TIKI,tui-thoi-trang-nam,157254153,"Ví Gập Đôi Nam In Báo SAIGON SWAGGER Journal Bi-Fold Wallet",350000,350000,0,0
TIKI,tui-thoi-trang-nam,34632931,"Ví nam cầm tay da thật ELLY HOMME – EVM9",999000,999000,0,0
TIKI,tui-thoi-trang-nam,76157448," cadakhso1 - D1-Đen quai cứng",797000,797000,0,0
TIKI,tui-thoi-trang-nam,144193312,"HJ2271 - Bóp nam Huy Hoàng da cá sấu nguyên con vip màu nâu đỏ",3499000,3499000,0,0
TIKI,tui-thoi-trang-nam,42607557,"Túi đeo chéo da thời trang nam nữ đẹp da bóng cực đẹp, dây dài tiện lợi",173000,173000,0,0
TIKI,tui-thoi-trang-nam,126797879,"Ví Ngang Công Sở Da Bò Thật Cao Cấp Bóp Đựng Thẻ Đựng Card GPLX Dành Cho Nam Có Kèm Hộp Full Box - B21 Shoemaker",99000,99000,0,0
TIKI,tui-thoi-trang-nam,103886626,"Ví Nam Cá Sấu - Bóp Cá Sấu Gù Nguyên Con STM01",950000,950000,0,0
TIKI,tui-thoi-trang-nam,120499848,"Bóp nam Huy Hoàng da đà điểu da trơn màu đen HP2426",799000,799000,0,0
TIKI,tui-thoi-trang-nam,476569,"Túi Đeo Chéo Ipad Mikkor Roady Sling RS 009 - Xanh Lá Mạ",249000,249000,0,0
TIKI,tui-thoi-trang-nam,13670375,"Túi đeo chéo du lịch nam nữ thời trang",44500,89000,44500,50
TIKI,tui-thoi-trang-nam,193065932,"Ví Da Nam Gence Dáng Ngang Da Bò Epsom C12",820000,820000,0,0
TIKI,tui-thoi-trang-nam,83942213,"Túi Đeo Chéo Colkids Club Viền Phản Quang ",79000,79000,0,0
TIKI,tui-thoi-trang-nam,188713962,"Ví nam da thật PANDAGO Pandora 02 dáng ngang nhỏ gọn bỏ túi nhiều ngăn cao cấp thời trang",301000,301000,0,0
TIKI,tui-thoi-trang-nam,120500032,"Ví nam Huy Hoàng da đà điểu da bụng kiểu đứng màu nâu đất, nâu đỏ, đen, vàng bò HC2408-09-10-18",799000,799000,0,0
TIKI,tui-thoi-trang-nam,141045151,"TÚI CANVAS KRAFT V2",125000,125000,0,0
TIKI,tui-thoi-trang-nam,72563946,"Túi Đeo Chéo nam Cao Cấp 4 Ngăn Túi đeo ngực,đeo chéo nam đã tích hợp công nghệ 4.0 Có Cổng Usb",97000,250000,153000,61
TIKI,tui-thoi-trang-nam,56698856,"Túi đeo hông đeo chéo Ytsute thời trang cao cấp MDS50",120000,170478,50478,30
TIKI,tui-thoi-trang-nam,58943419,"Ví nam da bò nhập khẩu W14",189000,380000,191000,50
TIKI,tui-thoi-trang-nam,52295966,"Ví nam đựng thẻ tín dụng dạng mỏng SLIM BIFOLD WALLET - HGcork Corkor CK153 - Nhiều màu - Vật liệu 100% da cork thực vật thuần chay từ vỏ cây sồi Bồ Đào Nha, Siêu bền, Chống cháy, Chống mốc, Chống thấm nước, Thân thiện với môi trường – Hàng chính hãng, Sả",759050,799000,39950,5
TIKI,tui-thoi-trang-nam,87367965,"Ví nam da bò AT028",299000,355000,56000,16
TIKI,tui-thoi-trang-nam,93838251,"Túi đeo chéo đeo hông đeo ngực nam unisex chống nước tiện lợi DC-B01",74000,104181,30181,29
TIKI,tui-thoi-trang-nam,144612831,"Túi đeo chéo đụng IPad Nam ( túi Jeep )",177000,177000,0,0
TIKI,tui-thoi-trang-nam,165210507,"Ví nam da bò Nappa cao cấp,bóp nam da bò thật nhiều ngăn đựng tiền đựng thẻ, dáng ngang và đứng có khóa kéo,2 màu nâu và đen Fullbox hộp sang trọng làm quà tặng",150000,150000,0,0
TIKI,tui-thoi-trang-nam,191592474,"Ví nam gập đôi da bò Crazy Horse may thủ công Handmade  Lucas Shoes, bảo hành 6 tháng",289000,289000,0,0
TIKI,tui-thoi-trang-nam,187641258,"Túi xách nam thiết kế sang trọng cặp da công sở thời trang thanh lịch YVan F80166-4",580000,580000,0,0
TIKI,tui-thoi-trang-nam,20959690,"Ví nam cầm tay",339000,339000,0,0
TIKI,tui-thoi-trang-nam,56021114,"Ví Unisex nhỏ gọn DA BÒ NC010CR để Name Card Danh Thiếp Thẻ, CMND",250000,250000,0,0
TIKI,tui-thoi-trang-nam,173542382,"Ví Da Bò Nam Cao Cấp Hàng Hiệu POLO MEISDO (Da Thật 100%) Full Hộp Phù Hợp Làm Quà Biếu Tặng Sinh Nhật Bảo Hành 2 Năm",1200000,1200000,0,0
TIKI,tui-thoi-trang-nam,69863298,"Túi phụ kiện thời trang cho phái mạnh",135000,135000,0,0
TIKI,tui-thoi-trang-nam,107075947,"Ví nam cầm tay Gianni Conti Italy VP00169BLA",4100000,4100000,0,0
TIKI,tui-thoi-trang-nam,181786183,"Túi chiến thuật rằn ri đi hành quân, dã ngoại, thao trường cho bộ đôi mẫu mới 2020 (2 cóc)",80000,80000,0,0
TIKI,tui-thoi-trang-nam,90485469,"Túi đeo chéo,đeo ngực nam đã tích hợp công nghệ 4.0 mã 7806",439000,799000,360000,45
TIKI,tui-thoi-trang-nam,78969930,"Ví NHẬP KHẨU 100% chất liệu da bò full túi hộp hãng như hình ",259000,259000,0,0
TIKI,tui-thoi-trang-nam,187610382,"Ví nam da bụng da đà điểu, bóp nam da bụng da đà điểu xanh lá",1145000,1145000,0,0
TIKI,tui-thoi-trang-nam,136940046,"Túi đeo chéo chống thấm 5 ngăn 5212 ( vừa ipad )",100000,100000,0,0
TIKI,tui-thoi-trang-nam,50677426,"Túi Đeo Vai Cao Cấp, Vải Chống Thấm Chống Nhăn (EP09)",315000,315000,0,0
TIKI,tui-thoi-trang-nam,98674884,"Túi đeo chéo nam thời trang cao cấp IX 8054, có lỗ cắm tai nghe, vải chống thấm nước, chống trầy xước",425000,425000,0,0
TIKI,tui-thoi-trang-nam,168231455,"Túi đeo bụng nam, nữ chất liệu vải dày bền chống trầy xước, có nhiều ngăn tiện dụng",109000,109000,0,0
TIKI,tui-thoi-trang-nam,110164229,"Túi đeo chéo nam cao cấp tích hợp cổng sạc USB Z 208211",97000,130400,33400,26
TIKI,tui-thoi-trang-nam,193720520,"TÚI ĐEO BỤNG HỌA TIẾT THIẾT KẾ",350000,350000,0,0
TIKI,tui-thoi-trang-nam,107962430,"Ví Mini Nam Ví Card Da Bò Sáp Handmade SVN9",199000,199000,0,0
TIKI,tui-thoi-trang-nam,57316170,"Túi đeo chéo đeo bụng vải bố mỏng cao cấp TiTn S99",36630,52910,16280,31
TIKI,tui-thoi-trang-nam,72799144,"Túi đeo chéo thể thao SPORTIA – MR7786 ",815000,815000,0,0
TIKI,tui-thoi-trang-nam,111119410,"[Da thật] Túi bao tử da bò thật, Túi đeo hông da sáp TD106LEA (Nâu/Vàng) - 100% da bò thật",345000,345000,0,0
TIKI,tui-thoi-trang-nam,191716981,"TÚI ĐEO CHÉO NAM VẢI BỐ SIÊU BỀN, TIỆN DỤNG THỜI TRANG HÀN QUỐC SIZE 24CM TUI-57",169000,169000,0,0
TIKI,tui-thoi-trang-nam,68951264,"Ví Da Cầm Tay Cao Cấp P103 – Đẳng Cấp Cho Quý Ông Lịch Lãm",265050,279000,13950,5
TIKI,tui-thoi-trang-nam,97762437,"Túi xách cặp da đựng laptop công sở JEEP BULUO T81 38x27x6cm (Nâu đậm - Nâu sáng - Đen)",375000,375000,0,0
TIKI,tui-thoi-trang-nam,125423168,"Túi chéo da bò thật, da bò sáp nâu rêu nhập khẩu cao cấp Pocket sling bag - Manuk vn Leather Design",750000,750000,0,0
TIKI,tui-thoi-trang-nam,97837661,"TÚI ĐEO CHÉO MARK RYDEN - MINI NEW CITY: GỌN NHẸ THỜI TRANG, TỎA SÁNG PHONG CÁCH",975000,975000,0,0
TIKI,tui-thoi-trang-nam,182296295,"Túi đeo chéo DC04 nam tính siêu sang trọng siêu tiện lợi",265000,530000,265000,50
TIKI,tui-thoi-trang-nam,143695000,"Túi đeo hông đeo bụng cao cấp thể thao du lịch sport viền cam Shalla RT3 tặng móc khóa hình khiêng",53000,74415,21415,29
TIKI,tui-thoi-trang-nam,168227974,"Ví da nam, Ví Nam Bóp Nam Da Bò Thật 100% Dáng Ngang Đẹp",210000,210000,0,0
TIKI,tui-thoi-trang-nam,81503974,"Túi đeo chéo nam dáng hộp BHM7512 Túi xách da bò thật, túi đeo vai nam",450000,450000,0,0
TIKI,tui-thoi-trang-nam,56737619,"Ví nam da bò cao cấp",99000,99000,0,0
TIKI,tui-thoi-trang-nam,143112557,"Couple Ví Heyday & Gerbera Handcrafted Wallet HAVIAS",856000,1070000,214000,20
TIKI,tui-thoi-trang-nam,168227944,"Bóp ví nam ngang da bò thật, Thiết kế ngăn đựng thông minh V086K1",110000,110000,0,0
TIKI,tui-thoi-trang-nam,117688364,"Video - Ví da cá sấu thật Konavis dạng đứng dành cho nam màu nâu làm cá sấu nguyên con",479000,479000,0,0
TIKI,tui-thoi-trang-nam,133000520,"HJ2401-02-03-04  - Ví nam Huy Hoàng da đà điểu màu vàng bò, đen, nâu đất, nâu đỏ",1259000,1259000,0,0
TIKI,tui-thoi-trang-nam,82491707,"Ví Nam Da Bò Kiểu Ví Đứng Thể Hiện Đẳng Cấp Phái Mạnh",50000,50000,0,0
TIKI,tui-thoi-trang-nam,193087601,"Túi xách nam công sở phong cách lịch lãm - BEEGEE 5524",270000,540000,270000,50
TIKI,tui-thoi-trang-nam,186558947,"Túi Xách Nam Nữ Công Sở, Cặp Đựng Laptop 15.6 Inch BEEGEE 5520",915000,1830000,915000,50
TIKI,tui-thoi-trang-nam,25971853,"VÍ DA KỲ ĐÀ - ĐỨNG - XANH NHỚT/XANH THẪM",599000,599000,0,0
TIKI,tui-thoi-trang-nam,127510411,"[Da thật] Ví nam ngang da bò thật, da Pullup Wax WS107N (Nâu) - 100% da bò thật",99000,99000,0,0
TIKI,tui-thoi-trang-nam,190172109,"Túi đeo chéo nam phong cách mới chống thấm nước cao cấp",299000,299000,0,0
TIKI,tui-thoi-trang-nam,116854559,"Túi nam đeo chéo canvas phốI da (xanh lam) 208109",47000,343000,296000,86
TIKI,tui-thoi-trang-nam,188995740,"Bao da dành cho Chìa Khoá Nissan Xtrail, Teana, Terra, Navara, Sunny, Almera Handmade Da Thật 002",200000,200000,0,0
TIKI,tui-thoi-trang-nam,176062151,"Ví Nam Gence Da Bò Box C05 Dáng Dọc",500000,500000,0,0
TIKI,tui-thoi-trang-nam,96987938,"Túi đeo chéo đeo bao tử sport vuông Sale sốc CF10",37000,52227,15227,29
TIKI,tui-thoi-trang-nam,195878755,"Túi đeo chéo nam da bò vân cá sấu - BEE GEE DCN9075",440000,880000,440000,50
TIKI,tui-thoi-trang-nam,129355668,"Hộp quà tặng ví nam cao cấp",620000,620000,0,0
TIKI,tui-thoi-trang-nam,4441677,"Ví Da Nam Handmade Ngang",99000,270000,171000,63
TIKI,tui-thoi-trang-nam,54581721,"Ví nam da bò nhập khẩu C09",149000,335000,186000,56
TIKI,tui-thoi-trang-nam,188997669,"Bao da dành cho Chìa Khóa Honda SH 2021, SH 2022, SH 350i, SH Mode, Lead, Cub, Winner X, AB 2022, PCX 160, Vario 160 (2 nút bấm)",99000,99000,0,0
TIKI,tui-thoi-trang-nam,58119412,"Ví Nam Dáng Đứng Da Cá Sấu. Da Bông Hông Cá Sấu Rất Mềm. Kiểu Dáng Mới Trẻ Trung Năng Động",410000,480000,70000,15
TIKI,tui-thoi-trang-nam,271408766,"Ví nam da bò nguyên tấm cao cấp, mềm mại PQ Leather-Bảo hành 12 tháng",360000,360000,0,0
TIKI,tui-thoi-trang-nam,272032611,"Card holder gập lịch thiệp BSB Leather xám  xi măng BSB1094",1400000,1400000,0,0
TIKI,tui-thoi-trang-nam,185775440,"Ví Da Hoẵng Nam Cao Cấp Bóp Da Nam POLO MEISDO Full Hộp Phù Hợp Làm Quà Biếu Tặng Sinh Nhật",2500000,2500000,0,0
TIKI,tui-thoi-trang-nam,190491219,"Bao da dành cho Chìa Khoá Subaru Forester, Outback, XV, WRX, Legacy handmade da thật 001",200000,200000,0,0
TIKI,tui-thoi-trang-nam,102918773,"Ví Đứng Da Sáp Đựng Giấy Tờ Cũ Handmade Lealux The Stand Wallet",559000,559000,0,0
TIKI,tui-thoi-trang-nam,102600557,"Bóp ví Naruto cầm tay đựng đồ nhỏ gọn, nhiều ngăn thời trang cá tính trẻ trung",109000,109000,0,0
TIKI,tui-thoi-trang-nam,188997280,"Bao da dành cho Chìa Khóa Vespa, Piaggio handmade da thật (chìa khoá DÀY)",100000,100000,0,0
TIKI,tui-thoi-trang-nam,184492598,"Túi Đeo Chéo Bao Tử Nam Chất Liệu Da Dễ Mang Theo Nhiều Ngăn",180000,360000,180000,50
TIKI,tui-thoi-trang-nam,82906831,"Túi xách nam da bò công sở cao cấp",882000,980000,98000,10
TIKI,tui-thoi-trang-nam,116667946,"[Da thật] Ví nam da bò thật; Ví ngang nam da bò sáp WS105LEA (Vàng bò/Nâu sáp) - 100% da bò thật",99000,99000,0,0
TIKI,tui-thoi-trang-nam,213676478,"Ví nam kiểu ngang 4 màu thời trang bóp da nam lịch lãm nam tính N9168",90000,180000,90000,50
TIKI,tui-thoi-trang-nam,169646321,"Ví Bifold Wallet",350000,350000,0,0
TIKI,tui-thoi-trang-nam,188994153,"Ví Sen da sáp handmade da thật",200000,200000,0,0
TIKI,tui-thoi-trang-nam,198525769,"Ví  Da Cá Sấu Lớn Đan Viền Đứng Hai Mặt Đan Viền Songhan Leather WL099.Bóp Da Nam Đan Viền Thủ Công Khâu Tay.Bảo Hành 12 Tháng",900000,900000,0,0
TIKI,tui-thoi-trang-nam,179941114,"Ví Da Nam Da Bò Kiểu Ví Đứng Sang Xịn Thể Hiện Phong Cách",165000,300000,135000,45
TIKI,tui-thoi-trang-nam,206521862,"Bao da dành cho móc khoá bọc ốp chìa khoá xe ô tô Toyota Raize, Veloz, Avanza, da bò, nhiều màu, khâu thủ công ToRVLA",170000,170000,0,0
TIKI,tui-thoi-trang-nam,47301846,"Ví Nam Da Bò Kiểu Ngang Màu Nâu - TCN1013",199000,199000,0,0
TIKI,tui-thoi-trang-nam,110169157,"Ví nam, bóp da nam phong thủy da bò khắc nổi rồng 204465 (nâu)",185400,185400,0,0
TIKI,tui-thoi-trang-nam,78033382,"Ví nam da bò 100% - full hộp",159000,159000,0,0
TIKI,tui-thoi-trang-nam,104438738,"Bóp ví tiền nam",50000,50000,0,0
TIKI,tui-thoi-trang-nam,176478695,"Ví nam da cao cấp mềm đẹp thời trang nhiều ngăn tiện dụng VN01",49000,98000,49000,50
TIKI,tui-thoi-trang-nam,173296936,"Túi Đeo Chéo Nam, Túi Đeo Chéo Nam Chất Vải Bền Đẹp, Đường Chỉ May Chắc Chắn, Nhiều Ngăn Chứa Đồ, Túi Đeo Vai Dành Cho Người Đi Làm, Đi Chơi, Học Sinh, Sinh Viên",465000,465000,0,0
TIKI,tui-thoi-trang-nam,184071799,"Túi xách nam nữ / 1992 s t u d i o/ BIG BAG/ túi da tole/ da bóng",199000,199000,0,0
TIKI,tui-thoi-trang-nam,189464993,"Túi đeo chéo nam vỏ PC chống va đập thời trang 2022",1140000,1140000,0,0
TIKI,tui-thoi-trang-nam,179437740,"Camkết hàng xịn Túi Đeo Chéo Canvas Cỡ Lớn Thời Trang Hàn Quốc Học Sinh Sinh Viên",139000,139000,0,0
TIKI,tui-thoi-trang-nam,184410716,"Túi Đeo Chéo Nam BT05 Kiểu Dáng Thông Minh Dành Cho Mọi Lứa Tuổi",235000,470000,235000,50
TIKI,tui-thoi-trang-nam,7960155,"Túi xách công sở Dubao",299000,299000,0,0
TIKI,tui-thoi-trang-nam,3266399,"Túi đeo chéo nam Jeep",185000,185000,0,0
TIKI,tui-thoi-trang-nam,191515279,"Túi Xách Laptop Nam Nữ, Túi Xách Công Sở, Cặp Xách Laptop, Cặp Xách Công Sở Văn Phòng Thời Trang Đi Làm - OTV194 - Ope Store",300000,300000,0,0
TIKI,tui-thoi-trang-nam,98738766," Túi đeo chéo nam kangaroo",578500,578500,0,0
TIKI,tui-thoi-trang-nam,46115624,"Túi đeo chéo đựng điện thoại đeo hong chống thấm - D001",110000,110000,0,0
TIKI,tui-thoi-trang-nam,193720613,"TÚI ĐEO CHÉO THIẾT KẾ SANG TRỌNG",250000,250000,0,0
TIKI,tui-thoi-trang-nam,188491311,"Túi nam |1992 s t u d i o | WYNN BAG| Chất liệu oxford chống thấm nước",399000,399000,0,0
TIKI,tui-thoi-trang-nam,157479078,"bóp ví clutch cầm tay nam hàng hiệu với nhiều ngăn với dây treo phong cách vintage - S3229",168000,329000,161000,49
TIKI,tui-thoi-trang-nam,179438478,"Túi Đeo Chéo Thời Trang Hàn Quốc Học Sinh Sinh Viên-Túi Đeo Chéo Siêu Đẹp Dành Cho Nam Và Nữ-CHỐNG NƯỚC",209000,209000,0,0
TIKI,tui-thoi-trang-nam,149179384,"Túi bao tử đeo chéo, đeo thắt lưng vải canvas thời trang nam T73 (Nâu Sáng - Nâu Đậm - Xanh - Đen)",175000,175000,0,0
TIKI,tui-thoi-trang-nam,113232786,"Túi xách da bò công sở nam cao cấp phong cách Châu Âu mã 2019",599000,999000,400000,40
TIKI,tui-thoi-trang-nam,20281882,"Túi đeo bụng đeo chéo đa năng 135",178500,178500,0,0
TIKI,tui-thoi-trang-nam,162090576,"Túi đeo chéo nam thời trang",85000,85000,0,0
TIKI,tui-thoi-trang-nam,52662192,"Túi đeo chéo Reeyee RY2015",825000,825000,0,0
TIKI,tui-thoi-trang-nam,120499883,"HC2448 - Bóp nam Huy Hoàng da đà điểu da trơn đan viền kiểu đứng màu nâu đất",999000,999000,0,0
TIKI,tui-thoi-trang-nam,120500230,"Ví nam Huy Hoàng da bò đan viền màu da, đen, nâu HC2134-35-36",449000,449000,0,0
TIKI,tui-thoi-trang-nam,168946107,"Túi đeo chéo đa năng có cổng tai nghe và cổng usb cho sạc dự phòng Artic Hunter cao cấp",418000,418000,0,0
TIKI,tui-thoi-trang-nam,23226474,"Túi Đeo Chéo Quân Đội Thời Trang HARAS HR252",170000,170000,0,0
TIKI,tui-thoi-trang-nam,119989868,"HH2415 - Bóp nam Huy Hoàng da đà điểu da chân kiểu đứng màu nâu đất",999000,999000,0,0
TIKI,tui-thoi-trang-nam,1537521,"Túi Đeo Chéo Cartinoe Freeman 15" MIVIDA1025 - Xám Tro",670000,670000,0,0
TIKI,tui-thoi-trang-nam,119989965,"Bóp nam Huy Hoàng da đà điểu da bụng kiểu đứng đan viền màu đen - HP2459",999000,999000,0,0
TIKI,tui-thoi-trang-nam,119989724,"HP2270-71-72-73 - Ví nam Huy Hoàng da cá sấu nguyên con vip màu đen, nâu đỏ, vàng, nâu đất",2499000,2499000,0,0
TIKI,tui-thoi-trang-nam,119989772,"HP2420-21-22-23 - Ví nam Huy Hoàng da đà điểu da trơn kiểu đứng màu đen, nâu đất, nâu đỏ, vàng bò",899000,899000,0,0
TIKI,tui-thoi-trang-nam,164435021,"Túi đựng công sở cao cấp 15.6 inch",539000,539000,0,0
TIKI,tui-thoi-trang-nam,183360797,"Ví nam da bụng cá sấu 2 mặt, chất liệu 2 mặt đều là da bụng da cá sấu màu nâu",1254000,1254000,0,0
TIKI,tui-thoi-trang-nam,173661231,"Ví Nam Da Bò Thật BIGGBEN Cao Cấp BG23",299000,390000,91000,23
TIKI,tui-thoi-trang-nam,143002995,"Bóp ví nam da bò thật SEAGLE dáng ngang sang trọng SMV103",280000,280000,0,0
TIKI,tui-thoi-trang-nam,120499925,"HC2320 - Bóp nam Huy Hoàng da trăn màu cam",599000,599000,0,0
TIKI,tui-thoi-trang-nam,109179814,"Túi Đeo Chéo Nam PT08",169000,169000,0,0
TIKI,tui-thoi-trang-nam,119989818,"Bóp nam Huy Hoàng da cá sấu nguyên con đan viền kiểu đứng màu đen HP2761",1399000,1399000,0,0
TIKI,tui-thoi-trang-nam,119989940,"HP2761-63-65 - Ví nam Huy Hoàng da cá sấu nguyên con đan viền kiểu đứng màu đen, nâu đất, nâu đỏ",1399000,1399000,0,0
TIKI,tui-thoi-trang-nam,119989927,"HP2423 - Bóp nam Huy Hoàng da đà điểu da trơn kiểu đứng màu vàng bò",899000,899000,0,0
TIKI,tui-thoi-trang-nam,188714057,"Ví nam da thật PANDAGO WingFlip 02 cao cấp bỏ túi thời trang",315000,315000,0,0
TIKI,tui-thoi-trang-nam,274471663,"Túi Đeo Chéo, Túi Da Nam Smeraldo ST191 Da Bò Màu Đen, Nâu, Bò",3440000,3440000,0,0
TIKI,tui-thoi-trang-nam,271090751,"[VOUCHER 30K] Cặp da nam công sở cao cấp LATA CA37",870000,870000,0,0
TIKI,tui-thoi-trang-nam,195917115,"[V02-011] Ví 3 Gấp Nappa Kaibaman Ví Đựng Tiền Thẻ ATM Giấy Tờ - KAIBAMAN SHOP",355000,355000,0,0
TIKI,tui-thoi-trang-nam,173654157,"Ví Nam Da Cá Sấu Thật BIGGBEN Cao Cấp BG9",1000000,1000000,0,0
TIKI,tui-thoi-trang-nam,120499904,"HC2201-02-03-40 - Bóp nam Huy Hoàng da cá sấu da bụng màu đen, nâu đỏ, vàng bò, nâu đất",999000,999000,0,0
TIKI,tui-thoi-trang-nam,92623920,"VÍ RAM TRỐNG ĐỒNG ĐỎ MAHOGANY DÁNG ĐỨNG (DA BÒ THUỘC THẢO MỘC) – MỆNH HỎA VÀ MỆNH THỔ - HÀNG CHÍNH HÃNG ",431000,431000,0,0
TIKI,tui-thoi-trang-nam,116878031,"Ví Cá Sấu Thật 100% | Ví Nam Da Cá Sấu Móng | Màu đen và Nâu | Dáng Ngang Một Mặt | Bảo Hành 24 Tháng",299000,299000,0,0
TIKI,tui-thoi-trang-nam,184081022,"Túi đeo chéo nam nữ Casual Crossbag chính hãng NATOLI đi làm đi học du lịch bản to chống nước cá tính",310000,443000,133000,30
TIKI,tui-thoi-trang-nam,157423667,"(Hàng Xịn) Túi chống nước, Túi đeo chéo tiện dụng, sang trọng – DCN9026",335000,670000,335000,50
TIKI,tui-thoi-trang-nam,112549741,"Ví da nam Gianni Conti Italy 1607220BLA ",1600000,1600000,0,0
TIKI,tui-thoi-trang-nam,113273139,"Ví đựng hộ chiếu da bò cao cấp Gianni Conti Italy 587455DBR - màu nâu",1300000,1300000,0,0
TIKI,tui-thoi-trang-nam,89656147,"DA CAO CẤP TÚI BAO TỬ HÀN QUỐC TÚI BẢO TỬ NAM PHONG CÁCH TRẺ TRUNG",94333,136259,41926,31
TIKI,tui-thoi-trang-nam,119723000,"HT2219-20-21-45 - Ví nam Huy Hoàng da cá sấu ngăn sau màu đen, nâu đất, vàng bò, nâu đỏ",1049000,1049000,0,0
TIKI,tui-thoi-trang-nam,59395340,"Ví Nam Cầm Tay Gianni Conti Italy 492019",3500000,3500000,0,0
TIKI,tui-thoi-trang-nam,3096605,"Ví nam da bò thật 100% NT22",189000,189000,0,0
TIKI,tui-thoi-trang-nam,24843817,"Ví , bóp da nam cao cấp có hộp và túi làm quà tặng",139000,139000,0,0
TIKI,tui-thoi-trang-nam,55465784,"Ví nam DA BÒ Handmade HM001 - HUNACRAFT",349000,349000,0,0
TIKI,tui-thoi-trang-nam,25691720,"Ví Nam Da Bò SAM Leather SAMDCL012",649000,649000,0,0
TIKI,tui-thoi-trang-nam,45293771,"Ví cầm tay nam da bò cao cấp Gianni Conti VP0169BLA",4100000,4100000,0,0
TIKI,tui-thoi-trang-nam,44822502,"Ví cầm tay da mềm để điện thoại và Ipad mini",238800,238800,0,0
TIKI,tui-thoi-trang-nam,55094704,"Ví bóp tiền logo đội bóng cực đẹp tiện dụng Barcalona",150000,150000,0,0
TIKI,tui-thoi-trang-nam,3977977,"Ví nam da bò Pháp BALZIO MWCOW W01-BL",179000,320000,141000,44
TIKI,tui-thoi-trang-nam,21132842,"Ví Da Nam Gianni Conti Italy 9407073TAN - Nâu",1500000,1500000,0,0
TIKI,tui-thoi-trang-nam,66814996,"Ví Nam Da Bò Thật Vân Cá Sấu VB25 Tặng Kèm Hộp",99000,99000,0,0
TIKI,tui-thoi-trang-nam,35529551,"VÍ THỦ CÔNG DA BÒ THẬT 100%- MÀU",299000,299000,0,0
TIKI,tui-thoi-trang-nam,172209504,"Ví nam Fox01 ví da nam kiểu đứng, bóp nam da bò sáp siêu đẹp, ví đựng tiền nhiều ngăn kiểu kiểu dáng nhỏ gọn",99000,99000,0,0
TIKI,tui-thoi-trang-nam,163552792,"Túi Messenger2 Oxford HAVIAS Hàng chính hãng",360000,450000,90000,20
TIKI,tui-thoi-trang-nam,26153804,"Ví Dài Da Bò Nguyên Tấm Marrant - BHL049",399000,399000,0,0
TIKI,tui-thoi-trang-nam,102484858," Túi Đeo DA Cao Cấp UNISEX (kèm video thật)",114000,161007,47007,29
TIKI,tui-thoi-trang-nam,91447778,"Cặp Túi Da Nam",1188000,1188000,0,0
TIKI,tui-thoi-trang-nam,162354986,"Túi đeo hông bụng Zocker  SPORT tập thể thao chống nước nhiều màu",149000,255000,106000,42
TIKI,tui-thoi-trang-nam,193038900,"Ví Da Nam Dáng Dọc Da Bò Epsom C09",820000,820000,0,0
TIKI,tui-thoi-trang-nam,177558168,"Túi đeo chéo nam da cao cấp Đồ da Thành Long TLG 208075",118000,135000,17000,13
TIKI,tui-thoi-trang-nam,16082829,"Ví da bò đựng Name Card Vinalea NCA0004F",98000,98000,0,0
TIKI,tui-thoi-trang-nam,101371884,"[Quà tặng] Ví nam da bò nhập khẩu thời trang QT199 | Thương hiệu BALZIO",190000,380000,190000,50
TIKI,tui-thoi-trang-nam,21943589,"Ví cầm tay nam Oscar - OCMWLLB021",6900000,6900000,0,0
TIKI,tui-thoi-trang-nam,110168120,"Túi đeo chéo nam da cao cấp Đồ da Thành Long TLG 208075",107000,162000,55000,34
TIKI,tui-thoi-trang-nam,173542320,"Ví Cầm Tay Da Bò Cao Cấp Hàng Hiệu POLO MEISDO PL08",1700000,1700000,0,0
TIKI,tui-thoi-trang-nam,116878070,"Ví Cá Sấu Gù Nhỏ | Ví Nam Da Cá Sấu Dáng Ngang 2 Mặt | Màu Đen | Đẳng Cấp Phái Mạnh",650000,650000,0,0
TIKI,tui-thoi-trang-nam,52608888,"Ví Da Havias Vinclass Handcrafted Mini Wallet",360000,450000,90000,20
TIKI,tui-thoi-trang-nam,116878042,"Ví Cá Sấu Thật 100% | Ví Da Cá Sấu Bụng 2 Mặt, Dáng Đứng | Đẳng Cấp Phái Mạnh",695000,695000,0,0
TIKI,tui-thoi-trang-nam,117688421,"Ví da cá sấu thật 2 mặt Konavis làm từ vân bụng cá sấu màu đen sang trọng - CW04-01B",1660000,1660000,0,0
TIKI,tui-thoi-trang-nam,196906733,"Ví card CH108 Nam tính, dành cho Nam giới lịch lãm, da thật",250000,250000,0,0
TIKI,tui-thoi-trang-nam,125423155,"Ví da nam | Da bò sáp ngựa điên | KHÁCH VUI LÒNG NHẮN TƯ VẤN CHỌN MÀU",300000,300000,0,0
TIKI,tui-thoi-trang-nam,196889532,"Ví Passport da bò VP002",320000,320000,0,0
TIKI,tui-thoi-trang-nam,137500994,"Bóp ví nam da bò thật dáng đứng nhiều màu hàng cao cấp chất da sang trọng phong cách Fullbox tặng hộp BH-24TH",590000,590000,0,0
TIKI,tui-thoi-trang-nam,188996885,"Bao da dành cho chìa khoá Piaggio Liberty, Zip, Medley handmade da thật",99000,99000,0,0
TIKI,tui-thoi-trang-nam,188994480,"Ví Sen vân cá sấu handmade da thật",180000,180000,0,0
TIKI,tui-thoi-trang-nam,120068153,"Bóp Ví nam da bò cao cấp dáng đứng màu đen Kalanos KBN210-Den, Ví nam da bò mịn êm, form đẹp & thời trang",479000,479000,0,0
TIKI,tui-thoi-trang-nam,83692599,"Bóp da nam",227000,227000,0,0
TIKI,tui-thoi-trang-nam,83692705,"Ví Da Nam Dáng Đứng",186000,186000,0,0
TIKI,tui-thoi-trang-nam,206249566,"Ví cầm tay nam - ví nam cao cấp Full hộp WilliamPOLO -  V28",655000,655000,0,0
TIKI,tui-thoi-trang-nam,185843805,"Ví Da Bò Nam Cao Cấp POLO MEISDO Sang Trọng ( Da Bò Thật 100%)",1000000,1000000,0,0
TIKI,tui-thoi-trang-nam,185843902,"Ví Da Bò Nam Bóp Da Nam Cao Cấp POLO MEISDO Full Hộp Phù Hợp Làm Quà Biếu Tặng Sinh Nhật",1000000,1000000,0,0
TIKI,tui-thoi-trang-nam,271408916,"Ví nam da bò cao cấp PQ Leather PV4 nhiều kiểu dáng, nhiều màu lựa chọn-BH 12 tháng",345000,345000,0,0
TIKI,tui-thoi-trang-nam,206521893,"Bao da dành cho móc khoá bọc ốp chìa khoá xe ô tô Hyundai Accent 2021 2023, elantra 2023 4 nút bấm, da bò, nhiều màu, khâu thủ công 12B",170000,170000,0,0
TIKI,tui-thoi-trang-nam,110691529,"Ví Da Thật Thiết Kế Cầm Tay Dành Cho Nam Sang Trọng, Lịch Sự",279000,279000,0,0
TIKI,tui-thoi-trang-nam,87914282,"Ví nam ngang da bò BHM7328 chống RFID",399600,399600,0,0
TIKI,tui-thoi-trang-nam,183349793,"Ví nam da bụng cá sấu 2 mặt, chất liệu 2 mặt đều là da bụng da cá sấu màu nâu",1256000,1256000,0,0
TIKI,tui-thoi-trang-nam,213571863,"Ví nam cao cấp bóp da nam đẹp kiểu dáng cực kì nam tính thiết kế nhiều ngăn đựng rộng rãi DN1306",130000,260000,130000,50
TIKI,tui-thoi-trang-nam,104438558,"Ví Nam Bóp Nam Chính Hãng Baellerry CAO CẤP Thiết Kế Mới B7-D9155",145000,145000,0,0
TIKI,tui-thoi-trang-nam,206522238,"Bao da dành cho móc khoá bọc ốp chìa khóa xe ô tô Toyota Altis 2022, da bò, nhiều màu, khâu thủ công To28AT",170000,170000,0,0
TIKI,tui-thoi-trang-nam,98737187," Túi Canvas Phối Da Bò C-396",1380000,1380000,0,0
TIKI,tui-thoi-trang-nam,73878351,"Ví / bóp nam thời trang 2021",79000,79000,0,0
TIKI,tui-thoi-trang-nam,82908996,"DTleather mang tới cho bạn mẫu ví nam mới - da bò nhuộm màu đen - thiết nhỏ mỏng không cộm khi mang theo DT039",299000,299000,0,0
TIKI,tui-thoi-trang-nam,122358552,"Túi Đeo Chéo Nam BT08 Da Cao Cấp Phong Cách Trẻ Trung Lịch Lãm",195000,370000,175000,47
TIKI,tui-thoi-trang-nam,183494390,"Túi đeo chéo nam cao cấp Hàn Quốc chống nước - Túi nam đeo đi học, đi chơi",80000,80000,0,0
TIKI,tui-thoi-trang-nam,161974098,"Cặp nam công sở MARRANT BHM5011 Da bò thật. Vừa laptop 16inch",1050000,1050000,0,0
TIKI,tui-thoi-trang-nam,98009199,"Cặp nam đựng tài liệu da thật BHM5006 Túi xách công sở, vừa laptop 14inch",750000,750000,0,0
TIKI,tui-thoi-trang-nam,20281289,"Túi đeo chéo nam da tổng hợp",120000,120000,0,0
TIKI,tui-thoi-trang-nam,69860535,"Túi đeo chéo thời trang lính mini",135000,135000,0,0
TIKI,tui-thoi-trang-nam,164362844,"TÚI ĐEO CHÉO NAM NỮ, TÚI DÙ đeo chéo và đeo bụng ngăn đứng 4 Màu",189000,189000,0,0
TIKI,tui-thoi-trang-nam,179013663,"Túi đeo chéo đeo bụng hiện đại siêu ngầu Kato thời trang siêu đẹo Shalla",159320,230129,70809,31
TIKI,tui-thoi-trang-nam,202040983,"Bóp Ví Nam Da Pu VD001",35000,35000,0,0
TIKI,tui-thoi-trang-nam,180317902,"Bóp ví nhiều ngăn tiện lợi ( giao mẫu ngẫu nhiên)",38000,38000,0,0
TIKI,tui-thoi-trang-nam,148716541,"Khuyến mãi - TÚI JEEP đeo chéo DA BÒ CAO CẤP",312000,312000,0,0
TIKI,tui-thoi-trang-nam,190313601,"Túi xách công sở, cặp laptop da bò Nubuck sang trọng",1300000,1300000,0,0
TIKI,tui-thoi-trang-nam,176130339,"Ví Da Nam Bỏ Túi Cao Cấp, Kiểu Dáng Nam Tính Mạnh Mẽ - Chất Liệu Da PU Cao Cấp - Ví nam cầm tay tiện lợi MB07",138000,138000,0,0
TIKI,tui-thoi-trang-nam,125363038,"Túi Nam Đeo Chéo Đeo Hông Da Bò BT04 Thiết Kế Hiện Đại",259000,518000,259000,50
TIKI,tui-thoi-trang-nam,177518039,"Túi đeo chéo đeo Nam thời trang - T0260",180000,180000,0,0
TIKI,tui-thoi-trang-nam,137979376,"Túi Đeo Chéo Nam Da Cá Sấu SPot2 Cao Cấp",175000,175000,0,0
TIKI,tui-thoi-trang-nam,140820950,"Túi Đeo Chéo KingBag KBG-001-2-BK- Black",780000,780000,0,0
TIKI,tui-thoi-trang-nam,119989849,"HP2426 - Bóp nam Huy Hoàng da đà điểu da trơn màu đen",799000,799000,0,0
TIKI,tui-thoi-trang-nam,119989712,"HP2417 - Bóp nam Huy Hoàng da đà điểu đan viền màu nâu đất",999000,999000,0,0
TIKI,tui-thoi-trang-nam,32135256,"Túi đeo chéo Nam gam màu cổ điển sang trong 0300",244300,349000,104700,30
TIKI,tui-thoi-trang-nam,127348478,"TÚI ĐEO CHÉO TDC002 CÓ NGĂN IPAD",116000,145000,29000,20
TIKI,tui-thoi-trang-nam,196759077,"Clutch Cầm Tay Nam Gence Da Bò Epsom HT18",1500000,1500000,0,0
TIKI,tui-thoi-trang-nam,187443969,"Túi Xách Nam Da Bò Swift 2 Khóa GCE22",3150000,3150000,0,0
TIKI,tui-thoi-trang-nam,119989686,"HP2762-64-66 - Ví nam Huy Hoàng da cá sấu nguyên con đan viền màu đen, nâu đất, nâu đỏ",1399000,1399000,0,0
TIKI,tui-thoi-trang-nam,119989954,"HP2444 - Bóp nam Huy Hoàng da đà điểu da chân đan viền kiểu đứng màu nâu đất",1099000,1099000,0,0
TIKI,tui-thoi-trang-nam,119989899,"HP2304-05-06 - Ví nam Huy Hoàng da trăn kiểu đứng màu đen, nâu, da nguyên thủy",599000,599000,0,0
TIKI,tui-thoi-trang-nam,120499954,"Ví nam Huy Hoàng mini màu da, đen, nâu HC2125-26-27",379000,379000,0,0
TIKI,tui-thoi-trang-nam,180995284,"Túi Xách, Cặp Thời Trang Công Sở Nam Da Bò Swift Cao Cấp GCE16 Đen",2800000,2800000,0,0
TIKI,tui-thoi-trang-nam,119989762,"HP2451 - Bóp nam Huy Hoàng da đà điểu da chân 2 mặt da màu đen",1449000,1449000,0,0
TIKI,tui-thoi-trang-nam,131498031,"HJ2270-71-72-73 - Ví nam Huy Hoàng da cá sấu nguyên con vip màu đen, nâu đỏ, vàng bò, nâu đất",3499000,3499000,0,0
TIKI,tui-thoi-trang-nam,171308370,"Ví Da Bò Ruột Cánh Gián Form Nhỏ Gọn SFA173D",283500,283500,0,0
TIKI,tui-thoi-trang-nam,20972636,"Túi Da Đeo Ngực Nam Cao Cấp _ BHM8871 Màu Đen",750000,750000,0,0
TIKI,tui-thoi-trang-nam,143701597,"HJ2114 - Bóp nam Huy Hoàng cao cấp màu đen",489000,489000,0,0
TIKI,tui-thoi-trang-nam,96222011,"Ví nam da bò thật VO 010305",165000,310000,145000,47
TIKI,tui-thoi-trang-nam,84382982,"VÍ NAM DA BÒ THÔ",518700,518700,0,0
TIKI,tui-thoi-trang-nam,83692704,"Ví Đứng Nam Bóp Da Bò",239000,239000,0,0
TIKI,tui-thoi-trang-nam,35260341,"Túi Xách Nam Công Sở Cao Cấp",315000,315000,0,0
TIKI,tui-thoi-trang-nam,189420150,"Túi đeo chéo nam cao cấp phong cách mới BEE GEE – DCN9071",135000,270000,135000,50
TIKI,tui-thoi-trang-nam,121268253,"Ví nhỏ gọn giá rẻ mã B22209210905",139000,139000,0,0
TIKI,tui-thoi-trang-nam,4371063,"Ví Da Nam Mini HNP01",325000,325000,0,0
TIKI,tui-thoi-trang-nam,53979111,"Ví Bóp Nam Da Bò Thật 100 % , Kiểu Dáng Ví Đứng Nhiều Ngăn, Ví Nam QN - L683",75000,75000,0,0
TIKI,tui-thoi-trang-nam,83692543,"Ví da nam dáng đứng",215000,215000,0,0
TIKI,tui-thoi-trang-nam,45882396,"Túi xách đeo chéo nam nữ thời trang BEE GEE 071",69000,138000,69000,50
TIKI,tui-thoi-trang-nam,193044108,"Túi xách nam công sở da bò thật cao cấp - BEEGEE 5523",1265000,2530000,1265000,50
TIKI,tui-thoi-trang-nam,177702331,"Túi đeo chéo nam cao cấp BEE GEE – DCN9055",190000,380000,190000,50
TIKI,tui-thoi-trang-nam,106244824,"Ví Da Bò Nam Kiểu Ví Đứng Chất Siêu Xịn Thể Hiện Đẳng Cấp",50000,50000,0,0
TIKI,tui-thoi-trang-nam,48037677,"Ví nam đựng hộ chiếu da bò cao cấp Gianni Conti 587455BLA",1300000,1300000,0,0
TIKI,tui-thoi-trang-nam,10903362,"Ví kẹp tiền và đựng card BD148 (Màu Đen Phối Xanh Lá)",189000,189000,0,0
TIKI,tui-thoi-trang-nam,10176975,"Ví cầm tay nam - Clutch nam da pu 3187",289000,289000,0,0
TIKI,tui-thoi-trang-nam,74283390,"Ví Da Bò Cao Cấp Nam Dòng Sản Phẩm Cho Quý Ông Lịch May Thủ Công , thời Trang Nam",125000,125000,0,0
TIKI,tui-thoi-trang-nam,157422441,"Túi đeo chéo đeo ngực nam cao cấp phong cách mới – 9025A",335000,670000,335000,50
TIKI,tui-thoi-trang-nam,84382059,"VÍ  NGANG NAM DA BÒ",546000,546000,0,0
TIKI,tui-thoi-trang-nam,8006538,"Ví Nam Da Bò Kẹp Tiền Dập Vân Cá Sấu PN2 - Nâu",450000,450000,0,0
TIKI,tui-thoi-trang-nam,69849645,"Bóp ví da nam dáng đứng nối SEAGLE SVA205",99000,99000,0,0
TIKI,tui-thoi-trang-nam,15730062,"Ví Nam da bò handmade Vinalea VNN0001C - Nâu đỏ",155000,155000,0,0
TIKI,tui-thoi-trang-nam,15228971,"Ví Nam Da Cá Sấu BIGGBEN BG2",1499000,1950000,451000,23
TIKI,tui-thoi-trang-nam,68707803,"[Da thật] Ví nam da thật, ví đứng 18 ngăn gập 3 WS102 - 100% da bò thật, BH 3 năm",155000,155000,0,0
TIKI,tui-thoi-trang-nam,187452413,"Túi xách nam công sở Gence da bò Swift GCE17 màu nâu",3080000,3080000,0,0
TIKI,tui-thoi-trang-nam,15654318,"Ví Nam, Bóp Nam [Dáng Đứng] Da Bò Thật",185000,185000,0,0
TIKI,tui-thoi-trang-nam,130844238,"HJ2225-26-27-47 - Ví nam Huy Hoàng da cá sấu nguyên con nhỏ màu đen, nâu đỏ, vàng bò, nâu đất",1819000,1819000,0,0
TIKI,tui-thoi-trang-nam,58340397,"Bóp Da Cá Sấu Dáng Đứng Sang Chảnh. DA BỤNG RẤT MỀM VÀ BỀN",748000,1212000,464000,38
TIKI,tui-thoi-trang-nam,197628823,"Túi xách nam Oscar - OCMHBLG049",7900000,7900000,0,0
TIKI,tui-thoi-trang-nam,809447,"Ví Da Bò Nam Viền May Thủ Công AT Leather AT105 (12 x 9.5 cm)",246000,290000,44000,15
TIKI,tui-thoi-trang-nam,153004899,"Ví mini da bò Anh Tho Leather 055",270000,320000,50000,16
TIKI,tui-thoi-trang-nam,52608894,"Ví Da Havias Cruiser Handcrafted Wallet",372000,465000,93000,20
TIKI,tui-thoi-trang-nam,145097890,"Bộ đôi thắt lưng nam + ví nam da thật Thanh Long 204057 (Đen) tặng móc khóa da thật cao cấp K550",355000,449000,94000,21
TIKI,tui-thoi-trang-nam,2209841,"Ví da bò nam cao cấp AT Leather 061 (11.5 x 10.5 cm) - Nâu",259000,305000,46000,15
TIKI,tui-thoi-trang-nam,13152975,"Balo 1 quai đeo chéo nam màu sắc basic , khóa giấu chống trộm mới bảo vệ đồ dùng",142000,201597,59597,30
TIKI,tui-thoi-trang-nam,24633825,"Đeo chéo nam thể thao bố Dad",60000,85239,25239,30
TIKI,tui-thoi-trang-nam,158172394,"Clutch Cầm Tay Nam Cao Cấp Gence CK14 Khóa Số",1980000,1980000,0,0
TIKI,tui-thoi-trang-nam,195749480,"Ví nam da thật - da bò cao cấp nhập Nhật",850000,850000,0,0
TIKI,tui-thoi-trang-nam,89786991," Túi đeo cheo nam vải Canvas nhỏ gọn tiện dụng, phong cách Hàn Quốc TC90",46143,48572,2429,5
TIKI,tui-thoi-trang-nam,252176504,"Ví Nam Da Bò Pullup, Bóp Nam Da Bò Pullup, Ví Nam Thời Trang_VietCow_1VINA003 (Dáng Ngang Phom Lớn, Chỉ Nhỏ)",350000,350000,0,0
TIKI,tui-thoi-trang-nam,252176314,"Ví Nam, Bóp Nam Da Bò Saffiano VietCow_0VINA001 (Dáng Ngang Có Phối)",300000,300000,0,0
TIKI,tui-thoi-trang-nam,163561529,"Móc khóa da bò vegtan khắc tên theo yêu cầu - RAM Leather",124000,124000,0,0
TIKI,tui-thoi-trang-nam,84381597,"VÍ NAM CÁ SẤU",1820000,1820000,0,0
TIKI,tui-thoi-trang-nam,4895835,"Túi da đeo bụng nam BHM9080D",66330,95810,29480,31
TIKI,tui-thoi-trang-nam,84381988,"VÍ KẸP TIỀN CÁ SẤU",1365000,1365000,0,0
TIKI,tui-thoi-trang-nam,83692580," Ví Da Bò Dáng Đứng",203000,203000,0,0
TIKI,tui-thoi-trang-nam,75691289,"Túi đeo hông thể thao đơn giản kiểu trơn  cao cấp KT03 Tặng móc khóa A3",65000,92004,27004,29
TIKI,tui-thoi-trang-nam,29372233,"Túi đeo hông, Túi đeo bụng, Túi đeo đa năng hàng cao cấp",66330,95810,29480,31
TIKI,tui-thoi-trang-nam,122234561,"Ví Nam Da Bò Thiết Kế Dáng Đứng Thể Hiện Bản Lĩnh Phái Mạnh",165000,300000,135000,45
TIKI,tui-thoi-trang-nam,72908078,"Túi đeo chéo học sinh da siêu dày chống nước phổ thông kiểu trơn 2 pát hít L42 tặng móc khóa cao cấp",98010,141570,43560,31
TIKI,tui-thoi-trang-nam,188997178,"Bao da dành cho chìa khóa Kia Morning, Cerato, K3, Rondo, Rio, Soluto, Seltos, Sorento, Sportage 005 handmade da thật",200000,200000,0,0
TIKI,tui-thoi-trang-nam,185782021,"Ví Da Hoẵng Nam Cao Cấp Bóp Da Nam POLO MEISDO Full Hộp Phù Hợp Làm Quà Biếu Tặng Sinh Nhật",2300000,2300000,0,0
TIKI,tui-thoi-trang-nam,4500005,"Đeo chéo thời trang hiện đại TĐ",76000,107157,31157,29
TIKI,tui-thoi-trang-nam,189491866,"3.	Ví Nam Da Bò NAPPA Nhập Khẩu Cao Cấp Dáng Đứng Ngang Songhan Leather – Thời Trang Hiện Đại. Bảo Hành 12 Tháng",290000,290000,0,0
TIKI,tui-thoi-trang-nam,122310279,"Ví Cầm Tay Nam Da Dập Vân Cá Sấu 1 Ngăn Phong Cách Phái Mạnh",92000,180000,88000,49
TIKI,tui-thoi-trang-nam,160293584,"Bóp Ví Nam Dài Cao Cấp Thời Trang Hàn Quốc model 2020",95900,95900,0,0
TIKI,tui-thoi-trang-nam,140511583,"Ví Đứng, Ngang May Tay Thủ Công Da Bò Nam Cao Cấp",97500,97500,0,0
TIKI,tui-thoi-trang-nam,106054088,"Bóp da nam, ví nam, ví da bò thật 100%, chuẩn đẹp xịn xò A147V",125000,125000,0,0
TIKI,tui-thoi-trang-nam,78969302,"Ví nam da bò 100% - full hộp",159000,159000,0,0
TIKI,tui-thoi-trang-nam,89786117,"Túi Đeo Chéo Nam Khóa Phản Quang Phong Cách Streetwear, Túi Bao Tử Nam Kháng Nước TC98 - Xanh",73000,101475,28475,28
TIKI,tui-thoi-trang-nam,107962128,"Ví nam thời trang châu âu 2019 mẫu S39-3",19000,19000,0,0
TIKI,tui-thoi-trang-nam,24849517,"Ví , bóp da nam cao cấp có hộp làm quà tặng",129000,129000,0,0
TIKI,tui-thoi-trang-nam,213571182,"Ví nam kiểu ngang nam tính cao cấp có ngăn khóa nhỏ 4 màu lịch lãm",90000,180000,90000,50
TIKI,tui-thoi-trang-nam,7600671,"Túi đeo chéo nam mỏng gọn BHM8006d",650000,650000,0,0
TIKI,tui-thoi-trang-nam,176130496,"Ví nam dáng ngang cao cấp da PU đẹp nhỏ gọn đựng tiền - MB01",138000,138000,0,0
TIKI,tui-thoi-trang-nam,152561049,"Túi đeo chéo thời trang",139000,139000,0,0
TIKI,tui-thoi-trang-nam,52243902,"Túi đeo chéo lính chiến thuật 511 cỡ vừa",170000,170000,0,0
TIKI,tui-thoi-trang-nam,194026553,"CẶP TÁP DOANH NHÂN... Da cá sấu thật 100% đẹp đẳng cấp!",6990000,13000000,6010000,46
TIKI,tui-thoi-trang-nam,188491297,"Túi nam | 1992 s t u d i o | DARIUS BAG | túi big size",499000,499000,0,0
TIKI,tui-thoi-trang-nam,191402053,"Túi Đeo Hông Đeo Bụng Bao Tử Nam Nữ Sport Loại Cao Cấp Chống Thấm Nước TUI-52",69000,69000,0,0
TIKI,tui-thoi-trang-nam,11017651,"Túi đeo bụng da bò BHM9080",450000,450000,0,0
TIKI,tui-thoi-trang-nam,122584464,"Túi Nam Đeo Chéo BT05 Da Cao Cấp Phong Cách Trẻ Trung Hiện Đại",235000,470000,235000,50
TIKI,tui-thoi-trang-nam,91447654,"Cặp Túi Da Nam C99",972000,972000,0,0
TIKI,tui-thoi-trang-nam,103887039,"Túi Đeo Chéo, Túi Đeo Vai Da Bò Thật CB05 Bảo Hành Da 12 Tháng",790000,790000,0,0
TIKI,tui-thoi-trang-nam,10007978,"Túi Nam Đeo Chéo Lưng Da Thật BZ02",1089000,1089000,0,0
TIKI,tui-thoi-trang-nam,151037888,"Túi đeo chéo da tiện dụng",149000,149000,0,0
TIKI,tui-thoi-trang-nam,193524345,"Túi bao tử đeo bụng đeo chéo BL059",180000,180000,0,0
TIKI,tui-thoi-trang-nam,171776727,"túi xách nam , cặp văn phòng cao cấp A1",857000,857000,0,0
TIKI,tui-thoi-trang-nam,6406251,"Cặp công sở nam cao cấp BHM7612",1750000,1750000,0,0
TIKI,tui-thoi-trang-nam,5885449,"Cặp da công sở nam cao cấp BHM9879 size 38cm",1550000,1550000,0,0
TIKI,tui-thoi-trang-nam,149179789,"Túi xách cặp da đựng laptop da bò công sở JEEP BULUO T20 (KT 39x28x6cm)",780000,780000,0,0
TIKI,tui-thoi-trang-nam,149179207,"Túi xách cặp da đựng laptop da bò 100% túi công sở T16 (KT 38.5x27.5x6.5cm)",1140000,1140000,0,0
TIKI,tui-thoi-trang-nam,181938579,"Túi Đeo Chéo Nam DC01 Trẻ Trung Năng Động Cá Tính Dễ Kết Hợp Nhiều Phong Cách",199000,370000,171000,46
TIKI,tui-thoi-trang-nam,168228733,"Ví Da Bò Đứng HANDMADE Hàng Cao Cấp, Da bò mềm cao cấp, dẻo dai, chắc chắn",189000,189000,0,0
TIKI,tui-thoi-trang-nam,149351186,"Túi bao tử, túi bao tử nam nữ, túi đeo chéo unisex nam nữ, túi đeo chéo phản quang, túi bao tử phản quang",145000,145000,0,0
TIKI,tui-thoi-trang-nam,67707792,"Túi phụ kiện nam Marrant BHLXB007 Da bò thật không bong nổ. ",650000,650000,0,0
TIKI,tui-thoi-trang-nam,252857832,"[Da thật] Clutch cầm tay nam da bò thật 2 ngăn khóa CL140LS (Đen, Nâu) - 100% da bò thật, BH 3 năm",649000,649000,0,0
TIKI,tui-thoi-trang-nam,186640202,"Hàng cao cấp Ví nam da bụng da đà điểu, bóp nam da bụng da đà điểu thật màu xanh lá",1500000,1500000,0,0
TIKI,tui-thoi-trang-nam,187566985,"Túi đeo bụng sport,đeo chéo, đựng điện thoại, thể thao nam, nữ TUI-31",69000,69000,0,0
TIKI,tui-thoi-trang-nam,143687407,"HJ2103 - Bóp nam Huy Hoàng da bò màu nâu",349000,349000,0,0
TIKI,tui-thoi-trang-nam,213678554,"Ví nam cao cấp nhiều ngăn kiểu dáng thời trang D1282",130000,260000,130000,50
TIKI,tui-thoi-trang-nam,10063878,"Túi Đeo Bụng Unisex Hasun HS627 (39 x 16 cm)",161000,185000,24000,13
TIKI,tui-thoi-trang-nam,192378926,"Túi Xách Nam Công Sở Gence Da bò Espom Cao Cấp CDX16",3800000,3800000,0,0
TIKI,tui-thoi-trang-nam,72747302,"Bóp Ví Nam Da Bò Thật PABNO Dáng Ngang Cao Cấp Sang Trọng VF38",650000,650000,0,0
TIKI,tui-thoi-trang-nam,153978743,"Túi đeo chéo 8 inch AGVA Milano - Kích thước Ngang 25 x Rộng 5 x Cao 34.5 cm - LTB347TEA (Xanh ngọc) - Bảo hành chính hãng 2 năm",750000,750000,0,0
TIKI,tui-thoi-trang-nam,133000671,"Ví nam da bò cao cấp với thiết kế sáng trọng mạnh mẽ - V16",432000,432000,0,0
TIKI,tui-thoi-trang-nam,74282679,"Túi công vụ nam OneShoulder",706000,706000,0,0
TIKI,tui-thoi-trang-nam,113836608,"Balo một quai đeo chéo cho nam Mikkor The Arnold Delux",590000,590000,0,0
TIKI,tui-thoi-trang-nam,119989828,"HP2424 - Bóp nam Huy Hoàng da đà điểu trơn đan viền màu nâu đỏ",999000,999000,0,0
TIKI,tui-thoi-trang-nam,84298418,"Ví dài nam cánh lật ngang bass nâu đỏ trơn- W0046B-2-2",740000,740000,0,0
TIKI,tui-thoi-trang-nam,188995961,"Ví đựng giấy tờ xe, đăng kiểm da bò thật handmade",220000,220000,0,0
TIKI,tui-thoi-trang-nam,120500134,"Bóp nam Huy Hoàng da cá sấu đan viền 2 gai màu nâu đất HC2772",1199000,1199000,0,0
TIKI,tui-thoi-trang-nam,173000098,"Ví nam da thật dáng dài - ví da nam,bop ví nam đẹp - 204426",100000,100000,0,0
TIKI,tui-thoi-trang-nam,187512104,"Túi Xách, Cặp Công Sở Thời Trang Nam Da Bò Swift Cao Cấp 2 Khoá GCE21",2600000,2600000,0,0
TIKI,cham-soc-nha-cua,248758024,"Combo 3 Túi Viên Giặt Quần Áo Omo Cho Máy Giặt Cửa Trước Và Cửa Trên Công Nghệ Anh Quốc 17 Viên",314000,420000,106000,25
TIKI,cham-soc-nha-cua,181426565,"Nước xả làm mềm vải Comfort chăm sóc chuyên sâu phơi trong nhà Hương nắng mới",205000,271000,66000,24
TIKI,cham-soc-nha-cua,184101589,"Combo 2 TúI Nước Giặt Omo Matic Cho Quần Áo Bé Yêu Chiết Xuất Tràm Trà Và Nha Đam Dịu Nhẹ, Sạsh Khuẩn , túi 3.6Kg",345000,454000,109000,24
TIKI,cham-soc-nha-cua,116410119,"Túi Nước giặt Omo Nước giặt cửa trước hương Lavender Khử mùi thư thái 3.6KG",175000,227000,52000,23
TIKI,cham-soc-nha-cua,116410159,"Túi Nước Giặt Omo Matic Cho Máy Giặt Cửa Trước Bền Đẹp Bền Màu Sau 100 Lần Giặt 3.6Kg",175000,227000,52000,23
TIKI,cham-soc-nha-cua,116407260,"Combo 2 túi nước giặt OMO Matic chuyên dụng Cửa Trước Lavender Khử Mùi Thư Thái 3.6kg",345000,454000,109000,24
TIKI,cham-soc-nha-cua,200618708,"Viên Rửa Chén Bát Hương Chanh Finish Powerball Power Essential Lemon Sparkle - Túi 100 viên siêu tiết kiệm",320000,450000,130000,29
TIKI,cham-soc-nha-cua,116407424,"Combo 2 túi nước giặt OMO Matic cho máy giặt cửa trên giúp quần áo sạch bẩn khử mùi toàn diện, túi 3.9kg",375000,454000,79000,17
TIKI,cham-soc-nha-cua,116410110,"TúI Nước Giặt Omo Matic Cho Máy Giặt Cửa Trên Xoáy Bay Vết Bẩn Sạch Bẩn Khử Mùi Toàn Diện 3.9Kg",175000,227000,52000,23
TIKI,cham-soc-nha-cua,116407426,"Combo 2 Túi Nước Giặt Omo Matic Máy Giặt Cửa Trên Hương Comfort Tinh Dầu Thơm Xoáy Bay Vết Bẩn Thơm Bền Lâu 3.6Kg",345000,454000,109000,24
TIKI,cham-soc-nha-cua,100989176,"Nước Xả Làm Mềm Vải Comfort Chăm Sóc Dịu Nhẹ Cho Da Nhạy Cảm 3.8L",205000,285000,80000,28
TIKI,cham-soc-nha-cua,111304924,"Túi Nước Giặt Omo Matic Cho Quần Áo Bé Yêu Chiết Xuất Tràm Trà Và Nha Đam Dịu Nhẹ, Sạch Khuẩn 3.6Kg",175000,227000,52000,23
TIKI,cham-soc-nha-cua,116407260,"Combo 2 túi nước giặt OMO Matic chuyên dụng Cửa Trước Lavender Khử Mùi Thư Thái 3.6kg",345000,454000,109000,24
TIKI,cham-soc-nha-cua,41356464,"Nước Rửa Chén Bát Sunlight Thiên Nhiên Muối Khoáng & Lô Hội 3.6kg",113000,126500,13500,11
TIKI,cham-soc-nha-cua,68370674,"Nước Xả Làm Mềm Vải COMFORT Nước Xả Vải Hương Ban Mai Đậm Đặc 1 Lần Xả Giúp Giữ Màu & Bền Vải 3.8L",205000,271000,66000,24
TIKI,cham-soc-nha-cua,116410107,"TúI Nước Giặt Omo Matic Comfort Cho Máy Giặt Cửa Trên Hương Tinh Dầu Thơm Xoáy Bay Vết Bẩn, Hương Thơm Bền Lâu 3.6Kg",175000,227000,52000,23
TIKI,cham-soc-nha-cua,198296337,"Nước Làm Bóng Chén Bát  Finish Rinse & Shine Aid",140000,185000,45000,24
TIKI,cham-soc-nha-cua,248758024,"Combo 3 Túi Viên Giặt Quần Áo Omo Cho Máy Giặt Cửa Trước Và Cửa Trên Công Nghệ Anh Quốc 17 Viên",314000,420000,106000,25
TIKI,cham-soc-nha-cua,199962063,"Combo 2 chai Nước Làm Bóng Chén Bát  Finish Rinse & Shine Aid - 500ML/chai",265000,370000,105000,28
TIKI,cham-soc-nha-cua,115667006,"[COMBO 6 LỐC] Khăn giấy lụa, khăn đa năng Premier Vinatissue 2 lớp 100% bột giấy nguyên sinh, không chất tẩy 280 tờ",120000,155000,35000,23
TIKI,cham-soc-nha-cua,184101589,"Combo 2 TúI Nước Giặt Omo Matic Cho Quần Áo Bé Yêu Chiết Xuất Tràm Trà Và Nha Đam Dịu Nhẹ, Sạsh Khuẩn , túi 3.6Kg",345000,454000,109000,24
TIKI,cham-soc-nha-cua,88784189,"Bột thông cống và khủ mùi hôi bồn cầu, lavabo, chậu rửa bát, đường ống cực  mạnh nắp xanh",16139,16139,0,0
TIKI,cham-soc-nha-cua,198296613,"Dung Dịch Tẩy Rửa Máy Rửa Chén Bát Finish Dishwasher Deep Cleaner",102000,135000,33000,24
TIKI,cham-soc-nha-cua,41356464,"Nước Rửa Chén Bát Sunlight Thiên Nhiên Muối Khoáng & Lô Hội 3.6kg",113000,126500,13500,11
TIKI,cham-soc-nha-cua,7178671,"Bột Tẩy Quần Áo Thiên Nhiên Baking Soda Mao Bao (12 g x 5 gói)",44000,55000,11000,20
TIKI,cham-soc-nha-cua,170565948,"Chai Xịt Đuổi Chuột Rat Off - Anti Rat Spray Thái Lan 200ml Tặng kèm móc khóa (Mẫu Ngẫu nhiên)",66000,66000,0,0
TIKI,cham-soc-nha-cua,116407258,"Combo 2 TúI Nước Giặt Omo Matic Cho Máy Giặt Cửa Trước Bền Đẹp Bền Màu Sau 100 Lần Giặt 3.6Kg",345000,454000,109000,24
TIKI,cham-soc-nha-cua,163575434,"Giấy Bỏ Túi Mylan Táo 4 Lớp",7600,8000,400,5
TIKI,cham-soc-nha-cua,116407426,"Combo 2 Túi Nước Giặt Omo Matic Máy Giặt Cửa Trên Hương Comfort Tinh Dầu Thơm Xoáy Bay Vết Bẩn Thơm Bền Lâu 3.6Kg",345000,454000,109000,24
TIKI,cham-soc-nha-cua,68612510,"Combo 2 Túi nước giặt xả Maxkleen Hương Huyền Diệu 3.8kg/túi ",355000,420000,65000,15
TIKI,cham-soc-nha-cua,206641076,"Combo phụ gia: Nước làm bóng 500ml + Dung dịch vệ sinh máy 250ml + Muối rửa chén bát 1kg",345000,489000,144000,29
TIKI,cham-soc-nha-cua,25096869,"Bột Tẩy Quần Áo Thiên Nhiên Mao Bao chứa Baking Soda (12g x 2 gói)",25000,32000,7000,22
TIKI,cham-soc-nha-cua,68347468,"Nước xả làm mềm vải COMFORT Nước xả vải hương Bella Giữ màu, Bền Vải & Hương nước hoa thiên nhiên 3.8L",205000,271000,66000,24
TIKI,cham-soc-nha-cua,125240682,"Nước Xả Vải Downy Dạng Túi",190000,275000,85000,31
TIKI,cham-soc-nha-cua,124708784,"Nước Giặt Ariel Hương Downy Túi 3.2Kg",160000,236500,76500,32
TIKI,cham-soc-nha-cua,576239,"Nước Tẩy Đa Năng Kháng Khuẩn Mao Bao 600ml",44000,50000,6000,12
TIKI,cham-soc-nha-cua,72924801,"Combo 3 Hộp 4 Viên Nén Vệ Sinh Lồng Giặt OMO Matic 80gr",218000,276000,58000,21
TIKI,cham-soc-nha-cua,34402891,"Viên Thả Làm Sạch Bồn Cầu (1 Gói 10 Viên)",8899,8899,0,0
TIKI,cham-soc-nha-cua,208676860,"Viên rửa bát Finish Classic mẫu mới",119000,119000,0,0
TIKI,cham-soc-nha-cua,15623940,"Diệt kiến dạng Gel Bayer Maxforce Quantum 0.03% (12g)",160000,160000,0,0
TIKI,cham-soc-nha-cua,174865692,"Combo 5 Bộ Viên tẩy bồn cầu Vim Power 5 Hương Lavender 275G (5x55G)",105000,120000,15000,13
TIKI,cham-soc-nha-cua,139723798,"Xịt Phòng Tinh Dầu Hữu Cơ Organic 24Care - Kháng khuẩn - Khử mùi hôi - Đuổi muỗi, kiến ba khoan - côn trùng - Hương thơm thư giãn",25000,25000,0,0
TIKI,cham-soc-nha-cua,116407424,"Combo 2 túi nước giặt OMO Matic cho máy giặt cửa trên giúp quần áo sạch bẩn khử mùi toàn diện, túi 3.9kg",375000,454000,79000,17
TIKI,cham-soc-nha-cua,116407258,"Combo 2 TúI Nước Giặt Omo Matic Cho Máy Giặt Cửa Trước Bền Đẹp Bền Màu Sau 100 Lần Giặt 3.6Kg",345000,454000,109000,24
TIKI,cham-soc-nha-cua,137337237,"[MUA 1 TẶNG 1] Giấy vệ sinh cao cấp Premier Deluxe có lõi, 3 lớp 100% bột giấy nguyên sinh, không chất tẩy lốc 10 cuộn",165000,200000,35000,18
TIKI,cham-soc-nha-cua,66385165,"Hộp 8 Viên Tẩy Lồng Máy Giặt SPEVI Dạng Sủi Xuất Xứ Nhật Bản - Vệ Sinh Máy Giặt, Diệt Sạch Vi Khuẩn, Vệ Sinh Lồng Máy Giặt Và Khử Mùi Hiệu Quả - Hàng chính hãng",36000,69000,33000,48
TIKI,cham-soc-nha-cua,68347468,"Nước xả làm mềm vải COMFORT Nước xả vải hương Bella Giữ màu, Bền Vải & Hương nước hoa thiên nhiên 3.8L",205000,271000,66000,24
TIKI,cham-soc-nha-cua,463748,"Chất Làm Sạch Lồng Giặt Mao Bao Ion Bạc Nâng Cấp Mới 300g + 6g",42000,50000,8000,16
TIKI,cham-soc-nha-cua,38438031,"Combo Viên tẩy bồn cầu 55G x 3 VIM Power 5 hương Oải hương Sạch Khuẩn Thơm Mát suốt 30 ngày",72000,84000,12000,14
TIKI,cham-soc-nha-cua,124722427,"Xịt đuổi chuột  200ml Thái Lan",55000,55000,0,0
TIKI,cham-soc-nha-cua,196234459,"Nước tẩy lồng máy giặt, Vệ sinh lồng máy giặt - Sản phẩm mới 2022",24750,25000,250,1
TIKI,cham-soc-nha-cua,181426565,"Nước xả làm mềm vải Comfort chăm sóc chuyên sâu phơi trong nhà Hương nắng mới",205000,271000,66000,24
TIKI,cham-soc-nha-cua,68088749,"Combo 2 Túi Nước Giặt Xả Maxkleen Hương Hoa Nắng (3.8kg/túi)",355000,420000,65000,15
TIKI,cham-soc-nha-cua,68370674,"Nước Xả Làm Mềm Vải COMFORT Nước Xả Vải Hương Ban Mai Đậm Đặc 1 Lần Xả Giúp Giữ Màu & Bền Vải 3.8L",205000,271000,66000,24
TIKI,cham-soc-nha-cua,114771868,"Nước giặt dưỡng vải Comfort Nước giặt xả đa chức năng hương Thời Thượng giúp quần áo sạch thơm & tươi màu Túi 3.8kg",145000,195000,50000,26
TIKI,cham-soc-nha-cua,200618708,"Viên Rửa Chén Bát Hương Chanh Finish Powerball Power Essential Lemon Sparkle - Túi 100 viên siêu tiết kiệm",320000,450000,130000,29
TIKI,cham-soc-nha-cua,165852603,"Hộp Viên Rửa Chén Bát SUNLIGHT 5 in 1 Cho Máy Rửa Chén Bát (28V/hộp)",95000,123200,28200,23
TIKI,cham-soc-nha-cua,102078670,"Thuốc ngừa mối diệt tận gốc , dầu diệt côn trùng phòng ngừa tận gốc , hiệu quả tức thì phù hợp với mọi gia đình ",53500,53500,0,0
TIKI,cham-soc-nha-cua,116410119,"Túi Nước giặt Omo Nước giặt cửa trước hương Lavender Khử mùi thư thái 3.6KG",175000,227000,52000,23
TIKI,cham-soc-nha-cua,206641076,"Combo phụ gia: Nước làm bóng 500ml + Dung dịch vệ sinh máy 250ml + Muối rửa chén bát 1kg",345000,489000,144000,29
TIKI,cham-soc-nha-cua,4328087,"Combo 03 túi nước giặt kháng khuẩn Mao Bao 1800g",226000,261000,35000,13
TIKI,cham-soc-nha-cua,248776334,"Túi viên giặt xả OMO tiện lợi công nghệ Anh Quốc (17 viên/Túi)",105000,125300,20300,16
TIKI,cham-soc-nha-cua,116410107,"TúI Nước Giặt Omo Matic Comfort Cho Máy Giặt Cửa Trên Hương Tinh Dầu Thơm Xoáy Bay Vết Bẩn, Hương Thơm Bền Lâu 3.6Kg",175000,227000,52000,23
TIKI,cham-soc-nha-cua,141990966,"Combo Túi Nước Giặt Xả MaxKleen Hương Huyền Diệu Túi 3.8kg + Hương Hoa Nắng 3.8kg",355000,420000,65000,15
TIKI,cham-soc-nha-cua,248758024,"Combo 3 Túi Viên Giặt Quần Áo Omo Cho Máy Giặt Cửa Trước Và Cửa Trên Công Nghệ Anh Quốc 17 Viên",314000,420000,106000,25
TIKI,cham-soc-nha-cua,53135547,"Lọ Tẩy Vệ Sinh Bồn Cầu Nhật Bản SPEVI - Khử Mùi Nhà Vệ Sinh, Diệt Sạch 99,9% Vi Khuẩn Thiết Kế Thông Minh Giúp Dễ Dàng Sử Dụng, Lọ Thả Bồn Cầu Hiệu Quả Rất Nhiều So Với Viên Thả Bồn Câ·",19000,19000,0,0
TIKI,cham-soc-nha-cua,133040504,"Combo 3 viên giặt xả MaxKleen hương ngày thư thái (34 viên/túi)",360000,420000,60000,14
TIKI,cham-soc-nha-cua,111304924,"Túi Nước Giặt Omo Matic Cho Quần Áo Bé Yêu Chiết Xuất Tràm Trà Và Nha Đam Dịu Nhẹ, Sạch Khuẩn 3.6Kg",175000,227000,52000,23
TIKI,cham-soc-nha-cua,66698381,"Sáp thơm phòng khử mùi Pure Aroma 230g - an toàn, hiệu quả",39000,39000,0,0
TIKI,cham-soc-nha-cua,165852603,"Hộp Viên Rửa Chén Bát SUNLIGHT 5 in 1 Cho Máy Rửa Chén Bát (28V/hộp)",95000,123200,28200,23
TIKI,cham-soc-nha-cua,141998900,"Combo Túi Nước Giặt Xả MaxKleen Thiên Nhiên 3.6kg + Túi Hoa Nắng 3.8kg",355000,420000,65000,15
TIKI,cham-soc-nha-cua,7459815," Thuốc diệt gián hộp 12 viên - Nội địa Nhật",55000,55000,0,0
TIKI,cham-soc-nha-cua,134647625,"Combo 2 túi viên giặt xả MaxKleen Hương ngày thư thái (34 viên/ túi)",242000,280000,38000,14
TIKI,cham-soc-nha-cua,116410159,"Túi Nước Giặt Omo Matic Cho Máy Giặt Cửa Trước Bền Đẹp Bền Màu Sau 100 Lần Giặt 3.6Kg",175000,227000,52000,23
TIKI,cham-soc-nha-cua,57302858,"Bột Thông Cống, Thông Tắc Bồn Cầu Hàn Quốc Cao Cấp combo ( Hộp 5 Gói )",35192,35192,0,0
TIKI,cham-soc-nha-cua,263982400,"Nước giặt OMO Chuyên dụng Cửa trước Ngăn ngừa Mùi Ẩm mốc Hương Hoa Anh Thảo 3.6kg",175000,227000,52000,23
TIKI,cham-soc-nha-cua,97008405,"Combo 02 Hộp Vệ Sinh Lồng Máy Giặt Ag+ Mao Bao 306g - Tặng Chất Làm Sạch Bình Đun Nước 25g x 1 gói",82000,100000,18000,18
TIKI,cham-soc-nha-cua,12425736,"Lốc 4 Gói Khăn Giấy Cao Cấp Tempo Softpack Mùi Bạc Hà, 4 Lớp, Không Gây Kích Ứng Da (90 Tờ/ Gói) - Thương Hiệu Đức",105000,105000,0,0
TIKI,cham-soc-nha-cua,6217533,"Nước Rửa Chén Hương Táo Loại Túi (500ml) Rocket",28000,36000,8000,22
TIKI,cham-soc-nha-cua,102738895,"Muối Rửa Bát Finish 1,2kg - Hàng Nhập Khẩu Đức",106975,106975,0,0
TIKI,cham-soc-nha-cua,75521920,"Combo 10 cuộn giấy vệ sinh lớn An Khang AKC500 hai lớp loại 500gr",293000,480000,187000,39
TIKI,cham-soc-nha-cua,89261232,"Combo 20 gói khăn giấy lau tay An Khang AK20-2 loại hai lớp dài 20cm - 102 tờ/gói",245000,440000,195000,44
TIKI,cham-soc-nha-cua,57967652,"Viên Thả Bồn Cầu Nhật Bản Dạng Nén Cao Cấp HOMI Mã HC01 Thế Hệ 2 Giúp Diệt Sạch Vi Khuẩn Khử Mùi Hiệu Quả Tuyệt Đối An Toàn Khi Sử Dụng (Hộp 10 viên) - Hàng Chính Hãng",89000,89000,0,0
TIKI,cham-soc-nha-cua,130209720,"Lốc 10 Gói khăn giấy rút Minibear Nhật, giấy khô, giấy lau mặt, giấy vệ sinh 300 tờ, chuyên dùng cho mẹ và bé",98000,138000,40000,29
TIKI,cham-soc-nha-cua,106307519,"1 VIÊN TẨY BỒN CẦU",2299,2299,0,0
TIKI,cham-soc-nha-cua,118235153,"Combo 5 giấy vệ sinh cuộn lớn 2 lớp 500g AN KHANG CARO | THẾ GIỚI GIẤY | 100% Bột giấy nguyên sinh | 5AKC500",148000,240000,92000,38
TIKI,cham-soc-nha-cua,54619802,"Chai Thả Bồn Cầu Nhật bản, Vệ Sinh Bồn Cầu, Giúp Hỗ Trợ Giảm Thông Tắc Bồn Cầu Và Khử Mùi, Diệt Sạch 99% Vi Khuẩn (Combo 02 Lọ) - Hàng Chính Hãng",55000,58000,3000,5
TIKI,cham-soc-nha-cua,7827140,"Chất thông tắc bồn cầu toilet chống hôi Siêu tốc 5 phút Sifa (1400g)",52000,52000,0,0
TIKI,cham-soc-nha-cua,168304491,"Thuốc diệt gián sinh học không mùi tận gốc 12 viên an toàn hiệu quả cho con người và vật nuôi KÈM khăn lau BaoAn  Hàng chính hãng",75000,89000,14000,16
TIKI,cham-soc-nha-cua,116452634,"[COMBO 3 LỐC] Khăn giấy bếp đa năng Premier VinaRoll có lõi, 2 lớp 100% bột giấy nguyên sinh, không chất tẩy lốc 2 cuộn",68000,99000,31000,31
TIKI,cham-soc-nha-cua,129577440,"Bột Tẩy Rong Rêu Trên Nền Xi Măng ROC",38997,38997,0,0
TIKI,cham-soc-nha-cua,57508303,"Nước tẩy trắng Javel thông minh Sifa ( tẩy trắng quần áo, đồ chất liệu vải ) cao cấp",30900,30900,0,0
TIKI,cham-soc-nha-cua,273926090,"Tẩy đa năng Mr Muscle hương chanh 500ml",39100,40800,1700,4
TIKI,cham-soc-nha-cua,52774130,"Bộ 2 chai chất thông tắc Cầu, Cống Sifa chống hôi Siêu nhanh Siêu mạnh 5 phút",109000,109000,0,0
TIKI,cham-soc-nha-cua,76539793,"Diệt côn trùng gián, kiến, kiến ba khoang, muỗi, ruồi, mối, mọt 100% Sinh học Thảo mộc 10s Chai xịt 100ml An toàn cho sức khỏe em bé và người già , đã được Bộ Y tế cho phép lưu hành",58000,58000,0,0
TIKI,cham-soc-nha-cua,116407424,"Combo 2 túi nước giặt OMO Matic cho máy giặt cửa trên giúp quần áo sạch bẩn khử mùi toàn diện, túi 3.9kg",375000,454000,79000,17
TIKI,cham-soc-nha-cua,68612841,"Combo 2 túi nước giặt xả Maxkleen hương Vườn Sớm Mai 3.8kg/túi ",355000,420000,65000,15
TIKI,cham-soc-nha-cua,70640837,"Xịt Phòng Tinh Dầu Thảo Mộc Hữu Cơ Organic 24Care 250ML - Kháng khuẩn - Khử mùi hôi - Đuổi muỗi, côn trùng - Tập trung tinh thần làm việc, lái xe, học hành - Hương thơm thư giãn",112000,149000,37000,25
TIKI,cham-soc-nha-cua,35322397,"Combo 3 lọ Thuốc diệt kiến gián sinh học  Hanpet",36996,36996,0,0
TIKI,cham-soc-nha-cua,76099465,"Chế phẩm diệt kiến gián sinh học Anbio - lọ 10ml",16800,16800,0,0
TIKI,cham-soc-nha-cua,118946346,"Nước rửa chén bát hữu cơ Golden Life 1L - Hương",42000,42000,0,0
TIKI,cham-soc-nha-cua,184217978,"Nước Giặt ARIEL Cửa Trên Sạch Sâu",160000,236500,76500,32
TIKI,cham-soc-nha-cua,273836660,"Combo 3 túi viên rửa chén bát Finish Powerball Quantum 21 viên/túi",457000,657000,200000,30
TIKI,cham-soc-nha-cua,124484886,"Giấy ăn lụa YCOOL khăn giấy rút đa năng trắng tự nhiên  300 tờ 4 lớp 24 gói",122550,129000,6450,5
TIKI,cham-soc-nha-cua,116410110,"TúI Nước Giặt Omo Matic Cho Máy Giặt Cửa Trên Xoáy Bay Vết Bẩn Sạch Bẩn Khử Mùi Toàn Diện 3.9Kg",175000,227000,52000,23
TIKI,cham-soc-nha-cua,189657651,"Nước giặt Lix Đậm Đặc Hương Hoa Túi 3.5Kg - Tẩy Sạch Cực Mạnh Vết Bẩn - NG350",115000,115000,0,0
TIKI,cham-soc-nha-cua,2213433,"Diệt Côn Trùng Gián, Kiến, Kiến Ba Khoang, Muỗi, Ruồi, Mối, Mọt 100% Sinh Học Thảo Mộc 10s Hương Sả Chanh Chai Xịt 500ml An Toàn Cho Sức Khỏe Em Bé Và Người Già, Đã Được Bộ Y Tế Cho Phép Lưu Hành",144000,144000,0,0
TIKI,cham-soc-nha-cua,10123669,"Nước tẩy rửa nhà vệ sinh không mùi 500ml nội địa Nhật Bản",33000,33000,0,0
TIKI,cham-soc-nha-cua,62315154,"Hộp 12 viên diệt gián tận gốc Nhật Bản",35999,35999,0,0
TIKI,cham-soc-nha-cua,68179518,"Nước Tẩy Nhà Tắm Mao Bao 600ml",42000,50000,8000,16
TIKI,cham-soc-nha-cua,48040396,"Muối rửa chén Finish Dishwasher Salt 4kg PTT017389",229000,229000,0,0
TIKI,cham-soc-nha-cua,134630198,"Túi viên giặt xả MaxKleen Hương ngày thư thái (34 viên/ túi)",133000,140000,7000,5
TIKI,cham-soc-nha-cua,72875812,"Combo 20 gói khăn giấy lau tay Roto eco20-2 hai lớp 100% bột giấy nguyên sinh, dài 20cm, họa tiết chấm bi xốp, thấm hút 2 chiều, gồm 102 tờ/gói",232000,360000,128000,36
TIKI,cham-soc-nha-cua,87378190,"Nước giặt LIX Đậm đặc Hương Nước hoa (Cam) tẩy sạch vết bẩn cực mạnh túi 3.5KGX2",189000,189000,0,0
TIKI,cham-soc-nha-cua,88270294,"Combo 2 Thuốc diệt chuột, Kẹo diệt chuột tiêu diệt cả đàn chuột hàng Thái Lan Tặng kèm Bẫy Chuột Thông Minh",55000,55000,0,0
TIKI,cham-soc-nha-cua,101148136,"Bột Thông Cống YUHAO 280gr - Thông Tắc Cực Mạnh, Đường Ống, Bồn Cầu, Bồn Rửa Mặt - Hàng Chính Hãng",31000,39000,8000,21
TIKI,cham-soc-nha-cua,89249057,"Combo 10 hộp khăn giấy lụa Japani Silk180 hai lớp kích thước 19x20cm hộp xanh - 180 tờ/hộp",210000,280000,70000,25
TIKI,cham-soc-nha-cua,58328581,"Túi Diệt Khuẩn Mền Gối Nệm HOMI Mã HK01 Công Nghệ Nhật Bản Chiết Xuất Tự Nhiên Loại Bỏ Ve Rận, Nấm Mốc Gây Ngứa Ngáy Khó Chịu [Combo 3 Hộp] - Hàng Chính Hãng",44000,79000,35000,44
TIKI,cham-soc-nha-cua,54509649,"Viên Khử Trùng và Vệ Sinh Bồn Cầu, Hỗ Trợ Diệt Khuẩn Giảm Thông Tắc Bồn Cầu Xuất Xứ Nhật Bản - Diệt Khuẩn, Khử Mùi, Vệ Sinh Bồn Cầu Cực Kì Hiệu Quả",32000,32000,0,0
TIKI,cham-soc-nha-cua,167543143,"Bình Xịt phòng tinh dầu Sả Chanh, Bạc hà, Quế, Bạch đàn chanh Vemoda giúp đuổi muỗi, khử khuẩn, thơm phòng nhanh chóng. Chai xịt đuổi muỗi từ tinh dầu thiên nhiên",129000,179000,50000,28
TIKI,cham-soc-nha-cua,576191,"Nước Giặt Kháng Khuẩn Mao Bao 3200g",127000,159000,32000,20
TIKI,cham-soc-nha-cua,175847142,"Giấy vệ sinh loại 10 cuộn không lõi trắng mịn dai không bụi cao cấp ERO - HTpaper (10 cuộn)",33000,55000,22000,40
TIKI,cham-soc-nha-cua,53626561,"Chất tẩy mốc xi măng trên nhiều chất liệu, tẩy rong rêu, tẩy gạch cũ bẩn, tẩy ron gạch siêu mạnh  HT01-TVS -1,8L (sản phẩm mới hoạt chất bảo vệ bề mặt 100%, chất lượng cao)",149000,180000,31000,17
TIKI,cham-soc-nha-cua,184489215,"Combo Mua 1 Tặng 1 Giấy Vệ Sinh Cao Cấp ASI Không Lõi 3 Lớp (20 Cuộn)",87000,172000,85000,49
TIKI,cham-soc-nha-cua,141998949,"Combo Túi Nước Giặt Xả MaxKleen Thiên Nhiên 3.6kg + Túi Huyền Diệu 3.8kg",420000,420000,0,0
TIKI,cham-soc-nha-cua,73103397,"Combo 6 Hộp Viên Rửa Chén Bát (28V/hộp) Sunlight 5 in 1 Cho máy rửa chén bát Công nghệ PureClean không để lại vêt ố",571000,840000,269000,32
TIKI,cham-soc-nha-cua,82007810,"Thuốc diệt muỗi, gián, kiến, ruồi, bọ chét, kiến ba khoang Fendona 10SC 50 ml x 1 chai KHÔNG MÙI (bao bì mới)",110000,110000,0,0
TIKI,cham-soc-nha-cua,2682725,"Thuốc viên diệt gián nội địa Nhật Bản",66000,77000,11000,14
TIKI,cham-soc-nha-cua,55045744,"Túi Than Hoạt Tính ECODEALS Khử Mùi, Chống Nấm Mốc, Vi Khuẩn, Khí Độc 100% than tre tự nhiên - 1 túi, giao màu ngẫu nhiên",32000,45000,13000,29
TIKI,cham-soc-nha-cua,173805163,"Tách Lẻ 10/20/40 Giấy Thơm Quần Áo BOUNCE Outdoor Fresh",40000,40000,0,0
TIKI,cham-soc-nha-cua,131192983,"[HÀNG CHÍNH HÃNG] Nước lau sàn chuyên dụng dành riêng cho Robot hút bụi lau nhà ECOVACS DEEBOT / ILIFE / XIAOMI / LIECTROUX / IROBOT",96900,96900,0,0
TIKI,cham-soc-nha-cua,193110738,"Combo 05 Hộp Chất Làm Sạch Lồng Máy Giặt Mao Bao (306g / Hộp) - Tặng 1 Hộp Bột Tẩy Quần Áo 12gx2 + 1 Chai Nước Giặt Cao Cấp 86g",180000,250000,70000,28
TIKI,cham-soc-nha-cua,24510746,"Chất thông tắc Cầu, Cống Sifa chống hôi Siêu nhanh Siêu mạnh 5 phút",74000,74000,0,0
TIKI,cham-soc-nha-cua,194806795,"GIẤY ĂN THỎ, GIẤY ĂN RÚT CAO CẤP NỘI ĐỊA TRUNG MÀU TRẮNG 2 LỚP",3861,3900,39,1
TIKI,cham-soc-nha-cua,196177335,"Lốc 10 Cuộn Giấy Vệ Sinh Bless You À La Vie Cao Cấp Mềm Mịn",92000,160000,68000,43
TIKI,cham-soc-nha-cua,77014311,"Nước Rửa Chén Sinh Học ENZYCO Lên Men Tự Nhiên Từ Dứa Và Bồ Hòn An Toàn Cho Da Tay Và Diệt Khuẩn - Hương Cam 480ml",100000,100000,0,0
TIKI,cham-soc-nha-cua,191387813,"Nước xả làm mềm vải Comfort Hương Nước Hoa Thiên Nhiên Jennie túi 3.8L",205000,243900,38900,16
TIKI,cham-soc-nha-cua,184101595,"Combo 2 túi Nước giặt OMO Matic Comfort Hương Hoa Hồng Ecuador cho máy giặt cửa trên, túi 3.6kg",345000,454000,109000,24
TIKI,cham-soc-nha-cua,104883479,"Nước Rửa Chén Gốc Thực Vật Peace Mass Công Nghệ Enzyme Rửa Sạch & Không Lưu Mùi (Thuộc nhóm Sản phẩm Lành tính / Hữu cơ) Can 3.6 Lít",162450,171000,8550,5
TIKI,cham-soc-nha-cua,39310764,"THUỐC DIỆT CHUỘT STORM",22900,22900,0,0
TIKI,cham-soc-nha-cua,163024879,"Giấy thơm quần áo Bounce 80 tờ - USA",158000,158000,0,0
TIKI,cham-soc-nha-cua,263388843,"Viên giặt xả Bold Gel Ball 3D hương hoa túi 44 viên của Nhật Bản",179000,179000,0,0
TIKI,cham-soc-nha-cua,55281845,"Combo 5 Túi Thơm Hương Hoa Thảo Mộc Thiên Nhiên Treo Tủ Quần Áo Khử Mùi, Đuổi Côn Trùng",17000,17000,0,0
TIKI,cham-soc-nha-cua,7250239,"Chất Thông Cống Siêu Mạnh SiFa (1.6kg)",88000,88000,0,0
TIKI,cham-soc-nha-cua,206542190,"Giấy vệ sinh ASI loại 10 cuộn/bịch 800gr cao cấp mịn không bụi - HTpaper",44000,86000,42000,49
TIKI,cham-soc-nha-cua,262072976,"Nước giặt xả hữu cơ Bồ Hòn tinh dầu Hoa Bưởi ECOCARE 4 lít - Bền màu, giữ dáng, làm mềm vải, an toàn da nhạy cảm",334000,345000,11000,3
TIKI,cham-soc-nha-cua,89802357,"Nước Rửa Bát Hữu Cơ ENZYCO Lên Men Từ Bồ Hòn Và Dứa Không Chất Tẩy Công Nghiệp Không Gây Dị Ứng Cho Tay An Toàn Cho Trẻ Nhỏ Mùi Hương - Chai",180000,180000,0,0
TIKI,cham-soc-nha-cua,31672125,"GIẤY THƠM BOUNCE  (160 Tờ x 1 hộp )",220000,220000,0,0
TIKI,cham-soc-nha-cua,170184241,"1 thùng (30 gói) Giấy ăn mặt cười SAKARA mặt cười 1 tờ 4 lớp mềm dai không bụi giấy lau an toàn cho sức khoẻ",140000,140000,0,0
TIKI,cham-soc-nha-cua,89221426,"Hai lốc giấy vệ sinh An Khang Classic10 hai lớp - 10 cuộn / lốc",51000,104000,53000,51
TIKI,cham-soc-nha-cua,190460515,"Combo 2 Túi Nước xả làm mềm vải Comfort Hương Nước Hoa Thiên Nhiên Jennie Túi 3.8L",414000,542000,128000,24
TIKI,cham-soc-nha-cua,126022163,"Bột thông tắc cống, bồn cầu, bồn rửa bát, đường ống cực mạnh HGO Super 250g",55000,55000,0,0
TIKI,cham-soc-nha-cua,58202555,"Giấy Lau Sàn Nhà Hòa Tan Thay Thế Nước Lau Sàn HOMI Mã HS01 Công Nghệ Tiên Tiến Vượt Trội Giúp Lau Sạch Bóng Sàn Nhà Chỉ Với Một Miếng Giấy - Hàng Chính Hãng",19000,29000,10000,34
TIKI,cham-soc-nha-cua,104412884,"GIẤY VỆ SINH 10 CUỘN 3 LỚP KHÔNG LÕI PRIME 1.5KG/DÂY /10 CUỘN  || TOILET PAPER",70000,70000,0,0
TIKI,cham-soc-nha-cua,125049270,"[Combo 2 sản phẩm] Gel Diệt Kiến Maxforce Quantum + Gel Diệt Gián Blattanex Chính Hãng",352000,352000,0,0
TIKI,cham-soc-nha-cua,151596732,"[COMBO 20 CUỘN] Giấy vệ sinh cao cấp Premier Deluxe có lõi, 3 lớp 100% bột giấy nguyên sinh, không chất tẩy lốc 10 cuộn",175000,200000,25000,13
TIKI,cham-soc-nha-cua,58978895,"Vi Sinh Xử Lý Hầm Cầu, Bể Phốt Bị Đầy - EcoClean Septic - Nhập Khẩu Mỹ - Túi 100gram",82000,82000,0,0
TIKI,cham-soc-nha-cua,91256196,"Nước rửa chén diệt khuẩn KAO Kyukyutto Clear 1380mL nội địa Nhật - Hương bưởi",159740,163000,3260,2
TIKI,cham-soc-nha-cua,37130044,"Vệ sinh máy rửa bát Finish",99000,99000,0,0
TIKI,cham-soc-nha-cua,186521304,"Nước rửa vàng bạc, dung dịch làm vàng bạc sáng bóng như mới",20000,20000,0,0
TIKI,cham-soc-nha-cua,38452362,"Giấy thơm và làm mềm Vải Bounce Outdoor Fresh 160 tờ - Canada",220000,220000,0,0
TIKI,cham-soc-nha-cua,167489070,"Bịch 1kg lông não thơm xịn nguyên liệu nhập Nhật long não đuổi con trùng thơm quần áo băng phiến khử mùi tủ đồ mùi hôi",97000,97000,0,0
TIKI,cham-soc-nha-cua,26011987,"Nước rửa bát Layer Clean Hương Quýt",40000,40000,0,0
TIKI,cham-soc-nha-cua,273892118,"Vệ sinh máy rửa bát Finish",120000,120000,0,0
TIKI,cham-soc-nha-cua,96608806,"Nước giặt đồ lót Lingerie Soap 120ml",94500,94500,0,0
TIKI,cham-soc-nha-cua,57844916,"Túi Nước Giặt Xả Maxkleen Hương Nước Hoa Huyền Diệu (3.8kg)",185000,210000,25000,12
TIKI,cham-soc-nha-cua,53627304,"Chất tẩy xi măng trên nhiều chất liệu, tẩy ron gạch siêu mạnh HT01-TVS -5 Lit (sản phẩm mới hoạt chất bảo vệ bề mặt 100%, chất lượng cao)",350000,399000,49000,12
TIKI,cham-soc-nha-cua,100930220,"Diệt thằn lằn - tắc kè Cicak Tokek",167400,167400,0,0
TIKI,cham-soc-nha-cua,12425734,"Lốc 4 Gói Khăn Giấy Cao Cấp Tempo Softpack Không Mùi, 4 Lớp, Không Gây Kích Ứng Da (90 Tờ/ Gói) - Thương Hiệu Đức",105000,105000,0,0
TIKI,cham-soc-nha-cua,122480895,"Túi hút ẩm SECCO 1 Kg gói hút ẩm tủ quần áo hoa khô giày dép treo phòng",110000,110000,0,0
TIKI,cham-soc-nha-cua,55038625,"Combo 5 Túi Thơm Hương Hoa Thảo Mộc Thiên Nhiên Treo Tủ Quần Áo Khử Mùi, Đuổi Côn Trùng",41000,41000,0,0
TIKI,cham-soc-nha-cua,2540045,"Nước tẩy xi măng HT 1,8LIT",138000,138000,0,0
TIKI,cham-soc-nha-cua,122575443,"Gói hút ẩm đóng túi 200 Gram, loại gói 1/2/3/5/10/50/100/200gram Silica Gel - Hạt hút ẩm thưc phẩm tủ quần áo giày dép",20000,20000,0,0
TIKI,cham-soc-nha-cua,51315018,"Nước Rửa Chén Layer Clean - Nước Rửa Chén Hữu Cơ - Nước Rửa Chén 5L",172000,172000,0,0
TIKI,cham-soc-nha-cua,160693982,"Máy khử mùi tủ lạnh CTFAST : Công nghệ ozone, khử mùi hôi, nấm mốc, loại bỏ dư lượng thuốc trừ sâu, thanh lọc không khí, bảo vệ sức khỏe gia đình",217000,399000,182000,46
TIKI,cham-soc-nha-cua,178958573,"Xịt phòng nước hoa tinh dầu Trà Trắng Vemoda giúp thơm phòng, thanh lọc không khí, thư giãn",135000,199000,64000,32
TIKI,cham-soc-nha-cua,59258002,"Chất thông tắc Cống sifa chống hôi siêu mạnh 5 phút 700gr thế hệ mới cao cấp ",55000,55000,0,0
TIKI,cham-soc-nha-cua,92496752,"Combo tẩy cặn canxi nhà tắm HGO Plus + tẩy dầu mỡ nhà bếp HGO bình xịt 500ml, sử dụng tiện lợi hiệu quả tiết kiệm",185000,185000,0,0
TIKI,cham-soc-nha-cua,192585024,"COMBO Giấy Ăn Gấu Trúc Sipiao Mylan 300 tờ (10 gói/ xách)",74000,145000,71000,49
TIKI,cham-soc-nha-cua,50256293,"Nước Tẩy Trắng Quần Áo Lix Javel 1kg",20000,20000,0,0
TIKI,cham-soc-nha-cua,51601097,"Combo 2 cục sáp thơm Renuzit Lovely Lavender 198g",80000,80000,0,0
TIKI,cham-soc-nha-cua,137599351,"Nước lau sàn chuyên dụng dành cho Robot hút bụi lau nhà ",70000,70000,0,0
TIKI,cham-soc-nha-cua,6473273,"Combo 5 Hộp Hút Ẩm Than Hoạt Tính Mr.Fresh Hàn Quốc",170000,170000,0,0
TIKI,cham-soc-nha-cua,576195,"Nước Giặt Cổ Áo Mao Bao 600ml",48000,60000,12000,20
TIKI,cham-soc-nha-cua,196177336,"Khăn Giấy Lụa Rút 2 lớp Bless You À La Vie cao cấp x 250 tờ",24000,40000,16000,40
TIKI,cham-soc-nha-cua,100253768,"Sáp thơm khử mùi Pure Aroma Mr Fresh 230g ( 4 mùi  )",39000,39000,0,0
TIKI,cham-soc-nha-cua,140368073,"Combo 30 viên tẩy vệ sinh bồn cầu - Viên thả bồn cầu tẩy sạch Diệt khuẩn vết bẩn ở toilet Nhật Bản",21000,21000,0,0
TIKI,cham-soc-nha-cua,180590958,"Khăn giấy lụa, khăn giấy rút Bless You Famile - 200 tờ",20000,33000,13000,39
TIKI,cham-soc-nha-cua,189673426,"Nước giặt Lix Hương Nước Hoa Túi 3.5Kg - Tẩy Sạch Cực Mạnh Vết Bẩn - NGH07",115000,115000,0,0
TIKI,cham-soc-nha-cua,122576944,"Gói Hút Ẩm đóng túi 1KG loại 1/2/3/5/10/20/50/100/200/500/1000g Silicagel - Hạt chống ẩm mốc, khử mùi - NU DRY",68000,68000,0,0
TIKI,cham-soc-nha-cua,184437908,"Túi Viên Giặt Xả Đa Năng 4 Trong 1 KA Universal (1 Viên/ Túi)",25000,25000,0,0
TIKI,cham-soc-nha-cua,29882824,"Túi than hoạt tính khử mùi xe hơi Hapaku - 100% từ gáo dừa Bến Tre",119000,150000,31000,21
TIKI,cham-soc-nha-cua,184486532,"Chai Nước Lau Sàn Ngàn Hoa Ngọt Ngào 3.6kg ",93000,93000,0,0
TIKI,cham-soc-nha-cua,58141815,"Bột Thông Tắc Cống, Đường Ống - EcoSock Hộp 0.5Kg - Hàng Chính Hãng Từ Mỹ",362000,362000,0,0
TIKI,cham-soc-nha-cua,59049510,"Chất thông tắc Cống và Cầu Sifa chống hôi Siêu nhanh siêu mạnh 5 phút 425ml cao cấp",39900,39900,0,0
TIKI,cham-soc-nha-cua,181921471,"Chai Xịt Tẩy Rỉ Sét Và Bôi Trơn RP7 150G",33000,35000,2000,6
TIKI,cham-soc-nha-cua,174624883,"Giấy vệ sinh 3 lớp cao cấp có lõi JAPANI SILK | Thế Giới Giấy | 100% bột giấy nguyên sinh | 10 cuộn",65000,86000,21000,24
TIKI,cham-soc-nha-cua,25271867,"Thuốc diệt mối thế hệ mới Termize 200SC diệt cả đàn (50ml)",150000,150000,0,0
TIKI,cham-soc-nha-cua,90475777,"Thuốc diệt chuột thái lan tiêu diệt cả đàn sau 3 ngày tặng kèm bịt thuốc diệt dán và kiến",31900,31900,0,0
TIKI,cham-soc-nha-cua,188695026,"Combo 2 Túi Nước Lau Sàn 3.6kg Ngàn Hoa Ngọt Ngào",148000,148000,0,0
TIKI,cham-soc-nha-cua,96708638,"Máy xịt thơm phòng cảm biến Glade nội địa Nhật (gồm máy & 01 lõi tinh dầu)",175000,175000,0,0
TIKI,cham-soc-nha-cua,107693416,"Nước rửa bát hữu cơ Fuwa3e organic Enzyme sinh học 500ml an toàn cho bé bảo vệ da tay",58000,58000,0,0
TIKI,cham-soc-nha-cua,274536010,"[Combo Tiện Lợi] Gói Men Bể Phốt EcoClean Septic - Men Vi Sinh Xử Lý Hầm Cầu, Bể Phốt Đầy, Tràn - Túi Gói 100gram",246000,246000,0,0
TIKI,cham-soc-nha-cua,10117533,"Vi sinh thông cống, xử lý hầm cầu, bể phốt, tự hoại BIO - SEPTIC - Chai 350ml",100000,100000,0,0
TIKI,cham-soc-nha-cua,166102275,"Giấy vệ sinh không lõi bịch 36 cuộn 4 lớp nặng 1.8kg dai mềm mịn dễ phân hủy.",74000,74000,0,0
TIKI,cham-soc-nha-cua,89011676,"Viên Thả Bồn Cầu SPEVI Thương Hiệu Đến Từ Nhật Bản - Dạng Nén Cao Cấp Thế Hệ 2 Giúp Diệt Sạch Vi Khuẩn, Khử Mùi Hiệu Quả Nhờ Hương Chanh Thơm Mát, An Toàn Khi Sử Dụng - Hàng Chính Hãng",59000,59000,0,0
TIKI,cham-soc-nha-cua,114358185,"Chế phẩm thảo mộc diệt muỗi gián kiến hiệu quả 24H - Cúc họa mi",135000,135000,0,0
TIKI,cham-soc-nha-cua,7591059,"Xà phòng chuyên giặt cổ áo bám bẩn hàng Nhật Bản",30500,30500,0,0
TIKI,cham-soc-nha-cua,205290276,"Nước làm bóng Finish 750ml",118000,118000,0,0
TIKI,cham-soc-nha-cua,24499123,"Bột men vi sinh Sifa xử lý hầm cầu chống hôi và đầy bồn cầu 300g",28800,28800,0,0
TIKI,cham-soc-nha-cua,184487039,"Chai Nước Lau Sàn Ban Mai Thanh Mát 3.6kg",89000,93000,4000,4
TIKI,cham-soc-nha-cua,122910048,"Dung dịch vệ sinh bếp từ Denkmit - Đức",112270,112270,0,0
TIKI,cham-soc-nha-cua,25141443,"Combo 2 Hộp Vệ Sinh Lồng Giặt Mao Bảo Ag+ 306g - Tặng 1 chai Nước Giặt Kháng Khuẩn Mao Bao 200g",81000,100000,19000,19
TIKI,cham-soc-nha-cua,53547869,"Combo Muối rửa bát finish 1.5kg+Nước làm bóng finish 750ml dùng cho Máy rửa bát",219999,219999,0,0
TIKI,cham-soc-nha-cua,188571425,"Túi Nước Lau Sàn MaxKleen 3.6kg - Ngàn Hoa Ngọt Ngào",74000,74000,0,0
TIKI,cham-soc-nha-cua,10091498,"Combo 03 chai Nước Tẩy Đa Năng Mao Bao 600ml",121000,150000,29000,19
TIKI,cham-soc-nha-cua,48184895,"Dung dịch tẩy rửa máy rửa chén Finish Dishwasher Cleaner Lemon 2x250ml QT04441 - hương chanh",179000,179000,0,0
TIKI,cham-soc-nha-cua,37890717,"Nước làm bóng Finish 750ml",149000,149000,0,0
TIKI,cham-soc-nha-cua,101359142,"Combo 2 Cốc thả bồn cầu tẩy xanh toilet Hàn Quốc Mr Fresh 180g hương ngàn hoa",78000,78000,0,0
TIKI,cham-soc-nha-cua,72744238,"Chai tẩy bồn cầu, gạch men siêu nhanh siêu sạch Sabo-S loại 100ml. Tẩy trắng bồn cầu, bồn sứ,sàn gạch men bị ố vàng cáu cặn lâu năm,an toàn tuyệt đối với bồn sứ tráng men.",29500,59000,29500,50
TIKI,cham-soc-nha-cua,15519960,"Men Vi Sinh Xử Lý Hầm Cầu Ecoclean septic 1 gói 100g",82000,82000,0,0
TIKI,cham-soc-nha-cua,72596137,"Nước Lau Sàn Hữu Cơ Bồ Hòn Ecocare - 100% thực vật, tinh dầu khử mùi, đuổi muỗi, chống trượt, kháng khuẩn - Chai 4000ml",223000,223000,0,0
TIKI,cham-soc-nha-cua,205290855,"Muối rửa bát Finish 1.2kg, muối finish 1,2kg là muối làm mềm nước trong máy rửa chén bát ly 1200g",104428,104428,0,0
TIKI,cham-soc-nha-cua,273877602,"Nước làm bóng finish 800ml dùng cho Máy rửa bát chén",117000,237800,120800,51
TIKI,cham-soc-nha-cua,161211248,"nước giặt Fuwa3e hữu cơ organic từ chế phẩm Enzyme sinh học 4.06L an toàn cho bé",365000,365000,0,0
TIKI,cham-soc-nha-cua,77161871,"Nước Rửa Chén Hữu Cơ Sinh Học ENZYCO Lên Men Từ Dứa Và Bồ Hòn Làm Sạch Chén Bát Không Gây Dị Ứng Da - Hương Cam 100ml",50000,50000,0,0
TIKI,cham-soc-nha-cua,121376981,"Gel Diệt Gián Blattanex Chính Hãng",192000,192000,0,0
TIKI,cham-soc-nha-cua,52667114,"Nước giặt 3.5Kg Surf Nước giặt thơm Hương Sương Mai Dịu Mát ",129000,129000,0,0
TIKI,cham-soc-nha-cua,89221865,"Hai lốc giấy lụa Japani Silk10 ba lớp - 10 cuộn / lốc",125000,174000,49000,28
TIKI,cham-soc-nha-cua,88968868,"Combo 5 lọ thuốc diệt kiến gián sinh học Bảo Châu",19000,19000,0,0
TIKI,cham-soc-nha-cua,118236751,"Combo 10 giấy vệ sinh cuộn lớn cao cấp 2 lớp giấy lụa 900g AN KHANG SOFT | THẾ GIỚI GIẤY | 100% Bột giấy nguyên sinh | 10AKS900",572000,890000,318000,36
TIKI,cham-soc-nha-cua,270233440,"COMBO 3 chai Xịt Phòng Tinh Dầu Sả Chanh + Sả Java + Bạc Hà  Hữu Cơ Organic 24Care 250ML/Chai - Kháng khuẩn - Khử mùi hôi - Đuổi muỗi, côn trùng - Tập trung tinh thần làm việc, lái xe, học hành - Hương thơm thư giãn",135000,135000,0,0
TIKI,cham-soc-nha-cua,45912608,"Dung dịch lau bóng đồ dùng bằng đồng thau inox Howard Pine-Ola Copper & Brass Polish CB0008 236ml",241200,241200,0,0
TIKI,cham-soc-nha-cua,59333295,"Set 02 Sáp thơm kháng khuẩn khử mùi tủ lạnh 150g - Nội địa Nhật Bản",76500,76500,0,0
TIKI,cham-soc-nha-cua,36701907,"Combo 2 hộp muối rửa Bát - Ly Somat 1.2kg - Đức",179000,179000,0,0
TIKI,cham-soc-nha-cua,12291782,"Long não 100g nhiều hương thiên nhiên thơm mát",16000,16000,0,0
TIKI,cham-soc-nha-cua,74459328,"Thuốc diệt chuột Storm 0.005% (5 gói x 20 viên) (Bao bì mới)",135000,135000,0,0
TIKI,cham-soc-nha-cua,189990461,"Bột Giặt LIX Extra Hương Nước Hoa 5.5Kg EH554 - Tăng Gấp Đôi Sức Mạnh Giặt Tẩy",155000,155000,0,0
TIKI,cham-soc-nha-cua,16659020,"Nước giặt Layer Clean hương Ocean Breeze 5L",207000,207000,0,0
TIKI,cham-soc-nha-cua,21219121,"Miếng Dán Thơm Khử Mùi Trong Nhà - Curve Fresher USA",82000,82000,0,0
TIKI,cham-soc-nha-cua,171950062,"Nước thơm lau sàn nhà Hando 5L hương Quế",95000,95000,0,0
TIKI,cham-soc-nha-cua,205290063,"Muối rửa bát Finish 4kg - Muối finish 4.0kg cho Máy rửa bát chén ly, Muối rửa chén finish hay gọi là Muối làm mềm nước Finish gói 1.5kg, 4 kg, 1.2kg",153000,153000,0,0
TIKI,cham-soc-nha-cua,45998865,".Nước hoa xịt phòng cao cấp Paris by night 500ml",34000,34000,0,0
TIKI,cham-soc-nha-cua,52129461,"Combo 2 cục Sáp Thơm Phòng Renuzit Pure Breeze 198g",75000,75000,0,0
TIKI,cham-soc-nha-cua,193699941,"Chai Xịt Tẩy Rửa Vệ Sinh Bồn Cầu Cực Mạnh Hương Nước Hoa Anh Đào, Khử Khuẩn, Siêu Sạch Không Độc Hại 500ml",21102,21102,0,0
TIKI,cham-soc-nha-cua,52776500,"Túi 80 viên rửa chén Finish All In 1 Max Dishwasher Tablets Lemon QT025452 - hương chanh",408600,408600,0,0
TIKI,cham-soc-nha-cua,189415660,"Set 10 Viên Thả Bồn Cầu - Làm Sạch Và Khử Mùi Cho Bồn Cầu",18999,18999,0,0
TIKI,cham-soc-nha-cua,170741430,"Tẩy trăng, tẩy mốc quần áo Tracatu - Tẩy quần áo trắng, tẩy quần áo màu .",15000,15000,0,0
TIKI,cham-soc-nha-cua,121325843,"Túi Thơm TỦ Quần Áo Denkmit HÀNG CHUẨN ĐỨC",92000,92000,0,0
TIKI,cham-soc-nha-cua,98756953,"Túi Thơm Cà Phê Hạt Rang Nguyên Chất Khử Mùi, Treo Phòng, Treo Xe Ô Tô, Chống Say Tàu Xe... Túi Vải Voan - Túi 25gr",23750,25000,1250,5
TIKI,cham-soc-nha-cua,205376849,"[HCM] Nước làm bóng chén bát Finish Eco 0% - 400ml/ chai",145000,145000,0,0
TIKI,cham-soc-nha-cua,176540054,"Combo 5 khăn giấy lụa Japani Silk180 hai lớp - 180 tờ/hộp - 100% bột giấy nguyên sinh",105000,140000,35000,25
TIKI,cham-soc-nha-cua,54848249,"Chất Tẩy Rửa Cốc Chén Siêu Sáng Bóng Mao Bao 15g x4 gói",47000,55000,8000,15
TIKI,cham-soc-nha-cua,169536356,"Combo 2 bịch Giấy Vệ Sinh Hà Nội Dây 10 Cuộn 1 bịch có lõi",120000,120000,0,0
TIKI,cham-soc-nha-cua,58587217,"Dung Dịch Làm Sạch, Tẩy Rửa Và Đánh Bóng Bề Mặt Inox Thang Máy Cao Cấp 500ml",65000,65000,0,0
TIKI,cham-soc-nha-cua,84304880,"Tẩy cặn canxi vách kính, vòi sen inox, bồn sứ, gạch men HGO Plus 500ml",95000,95000,0,0
TIKI,cham-soc-nha-cua,48565688,"Dung dịch vệ sinh máy rửa bát Finish 250ml (thị trường Đức) - Giao ngẫu nhiên",99000,99000,0,0
TIKI,cham-soc-nha-cua,44603251,"Tinh dầu xịt phòng, tủ quần áo, tạo mùi thơm, khử mùi hôi và đuổi côn trùng (Hương quế - 250ml)",160000,160000,0,0
TIKI,cham-soc-nha-cua,58804151,"Bột Giặt OMO Đỏ (6kg)",219000,219000,0,0
TIKI,cham-soc-nha-cua,188576313,"Túi Nước Lau Sàn MaxKleen 3.6kg - Ban Mai Thanh Mát",71000,74000,3000,4
TIKI,cham-soc-nha-cua,121326484,"Viên tẩy rửa lồng máy Giặt Denkmit Đức Hộp 60 viên",238000,238000,0,0
TIKI,cham-soc-nha-cua,196574207,"Combo 3 Chai Xịt Đuổi Chuột Thái Lan 200ml",155000,155000,0,0
TIKI,cham-soc-nha-cua,37883466,"Muối rửa bát Finish 4.0 kg",255000,255000,0,0
TIKI,cham-soc-nha-cua,51567691,"Muối rửa bát finish 1.5kg",99000,99000,0,0
TIKI,cham-soc-nha-cua,189461030,"Túi Thơm Cà Phê E-Sky Coffee Khử Mùi Ô Tô, Tủ Lạnh, Tủ Quần Áo, Văn Phòng Vải Bố Lanh 20gr",15000,19000,4000,21
TIKI,cham-soc-nha-cua,204745983,"Ecoclean Septic - Men Vi Sinh Xử Lý Hầm Cầu Bể Phốt - Khử mùi, phân hủy chất thải, hết nghẹt hầm, hiệu quả sau 1 đêm - Gói 100g - 1 gói 100g",82000,86000,4000,5
TIKI,cham-soc-nha-cua,102107836,"Nước tẩy xi măng Sifa  , nước tẩy gạch vệ sinh nhà cửa cao cấp ",41900,41900,0,0
TIKI,cham-soc-nha-cua,174624442,"Combo 5 cuộn giấy vệ sinh An khang Soft 700 hai lớp một cuộn 700gr",266000,380000,114000,30
TIKI,cham-soc-nha-cua,26062573,"Nước Xả Làm Mềm Vải Comfort Chăm Sóc Dịu Nhẹ Cho Da Nhạy Cảm 3.2L",204000,204000,0,0
TIKI,cham-soc-nha-cua,154532534,"Sáp khử mùi nhà vệ sinh/ sáp thơm phòng",37000,37000,0,0
TIKI,cham-soc-nha-cua,90476624,"1 kg Thuốc diệt chuột dạng viên Storm",260000,260000,0,0
TIKI,cham-soc-nha-cua,150938571,"Combo Sản Phẩm Gốc Thực Vật RCB1 Peace Mass - Nước Rửa Chén 3.6l + Nước Rửa Tay 340ml (Thuộc nhóm Sản phẩm Lành tính / Hữu cơ)",196650,207000,10350,5
TIKI,cham-soc-nha-cua,570099,"Bột Giặt Tide Chuyên Dụng 9Kg",289000,289000,0,0
TIKI,cham-soc-nha-cua,47208389,"[ComBo 2 Hộp ] Thông Tắc Ngẽn Bồn Cầu, Thông Tắc Ngẽn Cống, Bột thông cống mạnh. Loại lớn 260+-30g. Xử Lý nhanh tắc ngẽn",69000,69000,0,0
TIKI,cham-soc-nha-cua,190712077,"Combo 10 gói khăn giấy lau tay Roto eco20-2 RT20-2 hai lớp 100% bột giấy nguyên sinh, dài 20cm, họa tiết chấm bi xốp, thấm hút 2 chiều, gồm 102 tờ/gói",114000,180000,66000,37
TIKI,cham-soc-nha-cua,205436577,"Dung dịch vệ sinh máy rửa bát Finish hương chanh 250ml Finish EU",125000,125000,0,0
TIKI,cham-soc-nha-cua,4317493,"Nước lau bàn ăn Hando 500ml",32000,32000,0,0
TIKI,cham-soc-nha-cua,522683,"Combo 2 Hộp Chất Làm Sạch Lồng Máy Giặt Ag+ Mao Bao 306g - Tặng 1 Chai Nước Giặt Cao Cấp 86g",83000,100000,17000,17
TIKI,cham-soc-nha-cua,125046835,"[Combo 2 Sản Phẩm] Gel Diệt Kiến Maxforce Quantum Chính Hãng",320000,320000,0,0
TIKI,cham-soc-nha-cua,53629279,"Nước tẩy trắng  bồn bệ men sứ, lavabo, bồn rửa , sen vòi inox nhà tắm HT01-TVS-500ML",169000,200000,31000,16
TIKI,cham-soc-nha-cua,89652289,"Dầu bôi đuổi muỗi côn trùng của Thái lan",19000,19000,0,0
TIKI,cham-soc-nha-cua,102884140,"Combo 3 chai Nước hoa xịt phòng tinh dầu cao cấp Paris by Night 500ml - thơm lâu, khử mùi phòng",105000,105000,0,0
TIKI,cham-soc-nha-cua,897988,"Combo 04 Hộp Chất Làm Sạch Lồng Máy Giặt Mao Bao (300g / Hộp) - Tặng Chai Nước Giặt Kháng Khuẩn Mao Bao (200g)",164000,200000,36000,18
TIKI,cham-soc-nha-cua,247343507,"Hộp 12 Viên Tẩy Lồng Máy Giặt Nhật Bản Viên Nén Thế Hệ Mới - Lọ Thả Bồn Cầu Tẩy Trắng, Khử Mùi Hiệu Quả",16491,16491,0,0
TIKI,cham-soc-nha-cua,59140234,"Combo 2 chai xịt xả vải khô hương nước hoa Lâm Đại Phúc",99000,99000,0,0
TIKI,cham-soc-nha-cua,270130988,"Xịt Phòng Tinh Dầu Sả Chanh Hữu Cơ Organic 24Care 50ML/100ML - Kháng khuẩn - Khử mùi hôi - Đuổi muỗi, kiến ba khoan,Vắt - Côn trùng - Hương thơm thư giãn",25000,25000,0,0
TIKI,cham-soc-nha-cua,16914450,"Chai nước tẩy lồng máy giặt 400ml - Hàng Nội Địa Nhật",37500,37500,0,0
TIKI,cham-soc-nha-cua,87986625,"Lọ hình heo thả bồn cầu diệt khuẩn, khử mùi, tẩy siêu sạch, mùi thơm diệu nhẹ giúp giữ vệ sinh bồn cầu luôn sạch sẽ GD459-Heoboncau",15879,15879,0,0
TIKI,cham-soc-nha-cua,51855358,"combo 3 chai Nước làm bóng bát finish 800ml dùng cho máy",396500,396500,0,0
TIKI,cham-soc-nha-cua,67370852,"Nước giặt xả hữu cơ Bồ Hòn Ecocare tinh dầu Hoa Bưởi  4000ml",345000,399000,54000,14
TIKI,cham-soc-nha-cua,184907466,"Giấy thơm quần áo Boun,ce làm mềm sợi vải",29000,29000,0,0
TIKI,cham-soc-nha-cua,118997177,"Gel khử mùi bồn cầu diệt khuẩn toilet gel dính bồn cầu dạng thạch hình bông hoa với 5 mùi thơm cho nhà vệ sinh",10000,10000,0,0
TIKI,cham-soc-nha-cua,189226620,"COMBO 30 Cuộn Giấy Vệ Sinh Không Lõi Cao Cấp ERO",99000,170000,71000,42
TIKI,cham-soc-nha-cua,118522385,"GIẤY VỆ SINH 3 LỚP PRIME (0,9KG) CÓ LÕI - COMBO 2 DÂY MÀNG ĐÀ NẴNG",89000,89000,0,0
TIKI,cham-soc-nha-cua,10737297,"Khăn Giấy Bỏ Túi Petit Icy Methol Tempo (Lốc 18)",78000,78000,0,0
TIKI,cham-soc-nha-cua,121241582,"Túi hút ẩm bột treo container 1 kg gói hút ẩm treo phòng - SECCO",110000,110000,0,0
TIKI,cham-soc-nha-cua,124485947,"Siêu Tẩy Dầu Mỡ, Tẩy Canxi Nhôm Sắt, Inox, Máy Hút Mùi, Nồi Niêu Xoong Chảo... Chai 500ml",115000,115000,0,0
TIKI,cham-soc-nha-cua,88968911," 20 viên thuốc diệt chuột Strom",25000,25000,0,0
TIKI,cham-soc-nha-cua,8240579,"Tẩy ố, cặn canxi trên kính HT01 500ml - 700g",165000,165000,0,0
TIKI,cham-soc-nha-cua,193904067,"Thuốc diệt muỗi Map Permethrin 50 EC phòng chống sốt huyết, được sử dụng rộng rãi trong y tế ( chai 100ml hoặc 1 lít ).",99000,99000,0,0
TIKI,cham-soc-nha-cua,48579942,"Xịt Thơm Và Kháng Khuẩn Quần Áo 24h Hương Hoa 380ml Nhật Bản",87000,87000,0,0
TIKI,cham-soc-nha-cua,32049452,"Giấy Thơm Quần Áo - Kirkland Fabric Softener Sheets (250 tờ x 1 hộp)",210000,210000,0,0
TIKI,cham-soc-nha-cua,48574988,"Thùng 3 Can Nước Rửa Chén Sunlight Chanh 3.8kg",270000,270000,0,0
TIKI,cham-soc-nha-cua,171534737,"Bóng Giặt Là Thẳng Quần Áo, Banh Giặt Quần Áo Thông Minh Bảo Vệ Quần Áo Gia Đình",1800,1800,0,0
TIKI,cham-soc-nha-cua,13853027,"Nước Rửa Chén Layer Clean Túi 2LIT",72000,72000,0,0
TIKI,cham-soc-nha-cua,13852893,"Nước Rửa Chén Layer Clean 5LIT - Hồng",163000,163000,0,0
TIKI,cham-soc-nha-cua,77160799,"Nước Lau Sàn Sinh Học ENZYCO Lên Men Từ Dứa Và Bồ Hòn Làm Sạch Sàn Nhà Không Chất Hóa Học An Toàn Lành Tính - Hương Sả Chanh",169000,169000,0,0
TIKI,cham-soc-nha-cua,145613736,"Nước rửa chén Sunlight Trà xanh( Khử mùi tanh) Can 3.6KG",109000,109000,0,0
TIKI,cham-soc-nha-cua,57846864,"Túi Nước Giặt Xả Maxkleen Hương Hoa Nắng (3.8kg)",185000,210000,25000,12
TIKI,cham-soc-nha-cua,190708514,"Combo 5 khăn giấy rút lau tay đa năng 2 lớp 102 tờ ROTO ECO RT20-2 | 100% bột giấy nguyên sinh",54000,90000,36000,40
TIKI,cham-soc-nha-cua,184908351,"Giấy thơm quần áo cao cấp Kirk.land Pre.mium Fa.bric Soft.ener 4 in1",45000,45000,0,0
TIKI,cham-soc-nha-cua,98067211,"SÁP THƠM PHÒNG AMI",38000,38000,0,0
TIKI,cham-soc-nha-cua,174851966,"Combo 20 hộp khăn giấy lụa Japani Silk180 hai lớp kích thước 19x20cm hộp xanh - 180 tờ/hộp",356000,560000,204000,36
TIKI,cham-soc-nha-cua,174619837,"Combo 3 cuộn giấy giấy vệ sinh cuộn lớn 2 lớp 500g AN KHANG CARO  | 100% Bột giấy nguyên sinh",100000,144000,44000,31
TIKI,cham-soc-nha-cua,21553065,"Làm sạch cặn canxi ố sen vòi inox Sabo-I",119000,199000,80000,40
TIKI,cham-soc-nha-cua,63981299,"Túi 63 Viên Giặt Xả 3D Gel Ball Nội Địa Nhật Bản",189000,189000,0,0
TIKI,cham-soc-nha-cua,10244165,"Tẩy ố vàng, cáu cặn đồ sứ, bồn sứ HT01 - 500ml , 700g",165000,165000,0,0
TIKI,cham-soc-nha-cua,144179544,"Bịch lông não xịn 26 viên nguyên liệu nhập Nhật long não đuổi con trùng thơm quần áo băng phiến khử mùi tủ đồ mùi hôi",13500,13500,0,0
TIKI,cham-soc-nha-cua,7248879,"Bột Men Vi Sinh Xử Lý Hầm Cầu SiFa Bio Fast (300gr)",49000,49000,0,0
TIKI,cham-soc-nha-cua,68251375,"Nước rửa chén hữu cơ Bồ hòn Ecocare tinh dầu Quế 2000ml ",215000,250000,35000,14
TIKI,cham-soc-nha-cua,2705073,"Vỉ 6 viên tẩy và làm thơm toilet siêu tiện lợi Hando",65000,65000,0,0
TIKI,cham-soc-nha-cua,3684221,"Combo 3 bình xịt nước hoa thơm phòng Hàn Quốc Hommax",248000,248000,0,0
TIKI,cham-soc-nha-cua,43131552,"Thuốc diệt Gián dạng viên - hộp 12 viên (mẫu mới - nội địa Nhật)",40000,40000,0,0
TIKI,cham-soc-nha-cua,53484745,"Viên rửa bát Finish 120 viên + Muối Finish 1.5kg dùng cho Máy Rửa Bát Chén",453970,453970,0,0
TIKI,cham-soc-nha-cua,27655440,"Dung dịch làm sạch canxi vách kính tắm Smart - TK",200000,200000,0,0
TIKI,cham-soc-nha-cua,82459224,"Túi Than Tre Hoạt Tính Hút Độc 500g - Hút Mùi, Khí Độc Cho Ô Tô, Tủ Lạnh, Phòng Ngủ Làm Từ 100% Than Tre Siêu Sạch",74000,74000,0,0
TIKI,cham-soc-nha-cua,61819456,"Nước rửa chén hữu cơ Bồ hòn Ecocare - 100% thực vật, không hóa chất, tinh dầu khử mùi, chăm sóc da tay, tiết kiệm nước 30% - Chai 500ml - Quế",70500,75000,4500,6
TIKI,cham-soc-nha-cua,9793660,"Combo 02 chai Nước Tẩy Nhà Tắm Mao Bao 600ml",81000,100000,19000,19
TIKI,cham-soc-nha-cua,178755035,"Nước Giặt Xả Đậm Đặt HYGIENE Túi 1800ml Sạch mọi viết bẩn - hương thơm tươi mát cả ngày dài",135000,135000,0,0
TIKI,cham-soc-nha-cua,24495867,"Bột Thông Tắc Bồn Cầu, Thông Tắc Cống Sifa Đa Năng Siêu Nhanh 200g",27000,27000,0,0
TIKI,cham-soc-nha-cua,9796292,"Combo 03 túi Nước Thơm Lau Sàn Mao Bao 1000ml - Gỗ Đàn Hương",105000,120000,15000,13
TIKI,cham-soc-nha-cua,61975666,"Nước rửa chén hữu cơ Bồ hòn Ecocare - 100% thực vật, không hóa chất, tinh dầu khử mùi, chăm sóc da tay, tiết kiệm nước 30% - Chai 2000ml - Quế",205000,215000,10000,5
TIKI,cham-soc-nha-cua,7364771,"Nước rửa bát đậm đặc Mr.fresh hương quế 3800ml",85000,85000,0,0
TIKI,cham-soc-nha-cua,193434282,"Nàng thơ Đuổi kiến gián bằng hoa cỏ 90ml phương án đuổi côn trùng nhanh, tiện, nhỏ, gọn và an toàn",128000,128000,0,0
TIKI,cham-soc-nha-cua,14369440,"Dung Dịch Tẩy Trắng Quần Áo Nhật Bản 600ml",34500,34500,0,0
TIKI,cham-soc-nha-cua,176533686,"Giấy vệ sinh có lõi cuộn nhỏ An Khang Classic10 hai lớp 100% bột giấy nguyên sinh - 10 cuộn/ lốc",31000,52000,21000,40
TIKI,cham-soc-nha-cua,47058817,"[ComBo 3 Hộp ] Bột thông cống,Hoá chất thông bồn cầu mạnh, xử lý nhanh tắc ngẽn cầu nghẹt, lavabo nghẹt, bồn rửa chén nghẹt. Bot thong bon cau hộp lớn 268g",39056,39056,0,0
TIKI,cham-soc-nha-cua,141998303,"Combo 2 Túi Nước Giặt Xả MaxKleen Thiên nhiên 3.6kg",420000,420000,0,0
TIKI,cham-soc-nha-cua,9976348,"Hộp 12 viên diệt gián mẫu mới",29000,29000,0,0
TIKI,cham-soc-nha-cua,109125762,"(HÀNG CHUẨN) Thuốc muỗi MAP PERMETHRIN 50EC Diệt trừ hữu hiệu các loài muỗi truyền bệnh sốt rét, sốt xuất huyết",800000,800000,0,0
TIKI,cham-soc-nha-cua,4334121,"Nước thơm lau sàn nhà 1L Hando (hương quế)",25000,25000,0,0
TIKI,cham-soc-nha-cua,179512961,"Túi Viên Giặt Xả Đa Năng 4 Trong 1 KA Universal (5 Viên/ Túi)",40000,50000,10000,20
TIKI,cham-soc-nha-cua,119370022,"Combo 10 Tấm Lót Khử Mùi Bồn Tiểu & Lỗ Sàn ECODEALS P1 Fresher - Khử mùi gấp 3 sáp thơm - Mùi ngẫu nhiên",375000,475000,100000,21
TIKI,cham-soc-nha-cua,205293897,"Dung dịch vệ sinh máy rửa bát Finish 250ml (thị trường Đức) - Giao ngẫu nhiên",99000,99000,0,0
TIKI,cham-soc-nha-cua,48182043,"Dung dịch tẩy rửa máy rửa chén Finish Dishwasher Cleaner Lemon 250ml PTT006774 - hương chanh",109000,109000,0,0
TIKI,cham-soc-nha-cua,38288512,"COMBO 2 HỘP KHỬ MÙI TỦ LẠNH THAN HOẠT TÍNH",45580,45580,0,0
TIKI,cham-soc-nha-cua,7816820,"Chất thông tắc bồn cầu toilet chống hôi siêu tốc 1200g Sifa",74000,74000,0,0
TIKI,cham-soc-nha-cua,2983783,"Bột Giặt Lix Extra Hương Chanh 6Kg EC006 - Tẩy Sạch Vết Bẩn Cực Mạnh",129000,129000,0,0
TIKI,cham-soc-nha-cua,149552552,"Sáp Thơm Phòng Fragrance 190G để phòng, ô tô, tủ quần áo, toilet (giao ngẫu nhiên)",13000,13000,0,0
TIKI,cham-soc-nha-cua,40889382,"Tẩy mốc HT01 (Tẩy mốc quần áo, mốc tường đậm đặc H+T01-1,8L)",109000,120000,11000,9
TIKI,cham-soc-nha-cua,10000117,"Sáp thơm phòng Hando 87g hương hoa hồng",17000,17000,0,0
TIKI,cham-soc-nha-cua,505901,"Combo 3 Vỉ Tẩy Diệt Khuẩn Vệ Sinh Bồn Cầu Cao Cấp Hàn Quốc Blueshot",129000,150000,21000,14
TIKI,cham-soc-nha-cua,25980447,"Nước rửa bát Layer Clean Hương Quế",36000,36000,0,0
TIKI,cham-soc-nha-cua,73683244,"Combo 2 Túi Nước Giặt Xả Maxkleen Hương Hoa Nắng (2.4kg/túi)",300000,300000,0,0
TIKI,cham-soc-nha-cua,73287456,"Nước giặt LIX Đậm đặc (Đỏ) chai 3.8L",111000,111000,0,0
TIKI,cham-soc-nha-cua,186627086,"LỌ XỊT ĐUỔI CHUỘT THÁI LAN RAT OFF, ĐUỔI SẠCH CHUỘT HIỆU QUẢ",79000,79000,0,0
TIKI,cham-soc-nha-cua,89298235,"Cuộn giấy lớn đa năng Japani1000S dùng vệ sinh đa năng hai lớp cắt sheet 35cm - 1000gr",74000,115000,41000,36
TIKI,cham-soc-nha-cua,52980895,"COMBO 2 Hộp Viên Tẩy Lồng Máy Giặt Khử Sạch Cặn Bẩn, Vệ Sinh Máy Giặt Diệt Khuẩn Và Khử Mùi Lồng Máy - Đa Năng Phù Hợp Sử Dụng Cho Nhiều Loại Máy Giặt (COMBO 12 Viên)",15391,15391,0,0
TIKI,cham-soc-nha-cua,51840515,"Combo 2 hộp muối rửa bát finish dùng cho máy rửa bát 1,5kg (1.5kg x 2)",220000,220000,0,0
TIKI,cham-soc-nha-cua,56886621,"Thuốc diệt kiến gián sinh học không mùi combo 2 chai",9000,9000,0,0
TIKI,cham-soc-nha-cua,59547957,"Chất thống tắc nghẽn SIFA cầu W.C - CỐNG bicro phốt siêu tốc trị nghẹt chống hối 1.6kg thể tích thực 900ml cao cấp",64000,64000,0,0
TIKI,cham-soc-nha-cua,7485231,"Nước thông tắc đường ống thoát nước Hando 570ml xuất khẩu",27000,27000,0,0
TIKI,cham-soc-nha-cua,127802450,"Gel thơm làm sạch khử mùi vệ sinh Diệt khuẩn khử trùng bồn cầu hình bông hoa",10000,10000,0,0
TIKI,cham-soc-nha-cua,180852776,"Nước tẩy bồn cầu VIM Trắng Sáng Than hoạt tính và hoa oải hương (Tím) 880ml",39000,39000,0,0
TIKI,cham-soc-nha-cua,180255160,"Nước Rửa Chén Sinh Học Cô Cà Chua Yêu Nước 500ml ",68000,68000,0,0
TIKI,cham-soc-nha-cua,42418976,"Combo 5 túi thơm treo tủ quần áo ( Mẫu ngẩu nhiên)",18489,18489,0,0
TIKI,cham-soc-nha-cua,109491729,"Thuốc diệt chuột Thái Lan",22900,22900,0,0
TIKI,cham-soc-nha-cua,51948609,"Combo Bột rửa bát finish 2.5kg+Nước làm bóng finish 800ml+Muối rửa bát finish 1.5kg dùng cho Máy rửa bát",720000,720000,0,0
TIKI,cham-soc-nha-cua,98819920," COMBO 10 VIÊN TẨY BỒN CẦU HÀN QUỐC",12994,12994,0,0
TIKI,cham-soc-nha-cua,59236455,"Chất thông tắc cực mạnh 5 phút siêu nhanh SIFA Cầu  - Cống  1.06kg thể tích thực 900ml cao cấp - phiên bản kết nối yêu thương",49900,49900,0,0
TIKI,cham-soc-nha-cua,37892085,"Viên rửa bát Finish Nhật 150 viên",279000,279000,0,0
TIKI,cham-soc-nha-cua,169828050,"Tẩy dầu mỡ HGO tẩy sạch lưới lọc máy hút mùi, mặt bếp, bồn rửa bát, tường gạch ốp an toàn tiện lợi 500ml",105000,105000,0,0
TIKI,cham-soc-nha-cua,120104480,"GIẤY ĂN GIẤY RÚT PRIME KHỔ (20X20)  - COMBO 10 GÓI MÀNG XANH",155000,155000,0,0
TIKI,cham-soc-nha-cua,9805627,"Combo 03 hộp Bột Tẩy Quần Áo Thiên Nhiên Baking Soda (12g x 5 gói)",122000,165000,43000,26
TIKI,cham-soc-nha-cua,170391078,"MYTHIC 240SC Thuốc diệt mối, chống mối xây dựng",1700000,1700000,0,0
TIKI,cham-soc-nha-cua,205291413," vệ sinh máy rửa bát finish vỉ 3 viên",105900,105900,0,0
TIKI,cham-soc-nha-cua,48211175,"Hộp 100 viên rửa chén Finish Classic Dishwasher Tablets PTT025445",325000,670000,345000,51
TIKI,cham-soc-nha-cua,107693408,"Nước rửa chén hữu cơ Fuwa3e organic Enzyme sinh học 100ml an toàn cho bé bảo vệ da tay",8670,17000,8330,49
TIKI,cham-soc-nha-cua,48135747,"Túi 60 viên rửa chén Finish Quantum Max Dishwasher Tablets PTT025459",399000,399000,0,0
TIKI,cham-soc-nha-cua,11620290,"Hộp thơm phòng ngủ cao cấp của Nhật Bản thơm dịu",99000,99000,0,0
TIKI,cham-soc-nha-cua,153514472,"Chai Xịt Tẩy Rửa Đa Năng Kitchen Cleaner 500ml – Tẩy Rửa Nhà Bếp Dạng Bọt - Hàng Loại 1 Chính Hãng",35000,40000,5000,13
TIKI,cham-soc-nha-cua,58918466,"Viên Giặt Kirkland Signature Ultra Clean 152 Viên Của Mỹ - Mẫu mới",850000,850000,0,0
TIKI,cham-soc-nha-cua,52295356,"Hộp 12 Viên Tẩy Vệ Sinh Lồng Máy Giặt, Diệt Khuẩn Và Tẩy Chất Cặn Lồng Máy Giặt Hiệu Quả",9041,9041,0,0
TIKI,cham-soc-nha-cua,263440754,"Túi 54 Viên Giặt Xả 3D Gel Ball Nội Địa Nhật Bản",189000,189000,0,0
TIKI,cham-soc-nha-cua,38242346,"Chai xịt phòng tinh dầu Nước hoa cao cấp Paris 500ml khử mùi thuốc lá,ẩm mốc , hạn chế ruồi muỗi (giao màu ngẫu nhiên)",34000,34000,0,0
TIKI,cham-soc-nha-cua,2526755,"Nước rửa chén hương cam loại túi 500 ml Rocket nội địa Nhật Bản",33500,33500,0,0
TIKI,cham-soc-nha-cua,21174803,"Tẩy dầu mỡ két lâu năm trên thiết bị bếp chai Sabo-M 500ml không mùi ",109000,149000,40000,27
TIKI,cham-soc-nha-cua,74458578,"Combo 5 gói thuốc diệt muỗi, gián, kiến, ruồi, bọ chét, kiến ba khoang Fendona 10SC (5ml) (Bao bì mới)",57800,57800,0,0
TIKI,cham-soc-nha-cua,68257367,"Nước rửa chén hữu cơ Bồ hòn Ecocare tinh dầu Chanh Gừng 2000ml ",215000,280000,65000,23
TIKI,cham-soc-nha-cua,19963097,"Bình xịt vệ sinh bếp cao cấp Astonish hương cam C6790",89000,89000,0,0
TIKI,cham-soc-nha-cua,24195388,"Thuốc Diệt Muỗi Ruồi Gián Kiến Map Permethrin 55 EC",120000,120000,0,0
TIKI,cham-soc-nha-cua,8001205,"Combo Set 2 viên thả bồn cầu hương lavender nội địa Nhật Bản",62000,62000,0,0
TIKI,cham-soc-nha-cua,205293724,"Muối rửa chén Finish Dishwasher Salt 1,5kg PTT017383",107000,107000,0,0
TIKI,cham-soc-nha-cua,72597497,"Nước rửa chén hữu cơ Bồ hòn Ecocare - 100% thực vật, không hóa chất, tinh dầu khử mùi, chăm sóc da tay, tiết kiệm nước 30% - Chai 4000ml",390000,415000,25000,6
TIKI,cham-soc-nha-cua,180230324,"Nước Giặt Máy Sinh Học 10L Cô Cà Chua Yêu Nước An Toàn Cho Da Trẻ Nhỏ Và Da Nhạy Cảm",840000,840000,0,0
TIKI,cham-soc-nha-cua,2610755,"Hộp 2 gói bột tẩy cặn canxi cây nước, ấm đun nước, bình nóng lạnh Hando",29000,29000,0,0
TIKI,cham-soc-nha-cua,32294867,"Túi Khử mùi tủ lạnh Than Binchotan Kaola, Chống nấm mốc, Vi khuẩn, Khí độc đến 2 năm - 100% than binchotan tự nhiên",59000,59000,0,0
TIKI,cham-soc-nha-cua,149707231,"Gel Diệt Gián BLATTANEX COCKROACH - BAYER 12gram",165000,165000,0,0
TIKI,cham-soc-nha-cua,122910259,"Viên rửa bát Finish 110 viên (Hàng chính hãng )",339957,339957,0,0
TIKI,cham-soc-nha-cua,120219574,"GIẤY VỆ SINH 3 LỚP PRIME (1,5KG) KHÔNG LÕI - COMBO 2 DÂY MÀNG TÍM",130000,130000,0,0
TIKI,cham-soc-nha-cua,37488247,"Túi Thơm Thảo Dược Treo Xe Hơi, Khử Mùi Xe, Hương Thơm Thư Giãn Hapaku - 1 Túi",115000,119000,4000,3
TIKI,cham-soc-nha-cua,72614149,"Xịt Chùi Rửa Đa Năng Bồ Hòn Hữu Cơ ECOCARE 500ml - Diệt khẩn, khử mùi, hiệu quả mọi chất liệu - Mâu mới 2020",70500,75000,4500,6
TIKI,cham-soc-nha-cua,7459209,"Hộp 12 viên thuốc diệt gián nội địa Nhật Bản",36000,36000,0,0
TIKI,cham-soc-nha-cua,137480754,"COMBO 3 Túi Nước rửa chén Sunlight Thiên nhiên (trắng) Túi 750gx3",82000,82000,0,0
TIKI,cham-soc-nha-cua,173910966,"Siêu Bọ Trĩ Diệt Sạch Côn Trùng Gây Hại gói 18ml",16000,16000,0,0
TIKI,cham-soc-nha-cua,31133640,"2 lọ diệt kiến gián sinh học không mùi",10000,10000,0,0
TIKI,cham-soc-nha-cua,215736410,"Nước tẩy rửa bồn cầu Ecocare - Tẩy sạch vết bẩn cạn bã, ố vàng, tiêu diệt vi khuẩn, khử mùi với tinh dầu thiên nhiên - Chai 900ml",86000,89000,3000,3
TIKI,cham-soc-nha-cua,273877113,"Muối rửa bát Finish 4.0 kg",107000,217996,110996,51
TIKI,cham-soc-nha-cua,51953954,"Combo Muối rửa bát finish 1.5kg+Nước làm bóng finish800ml dùng cho Máy rửa bát",258667,517334,258667,50
TIKI,cham-soc-nha-cua,33219515,"Tẩy cặn canxi trên inox H+T01 250Gam",169000,180000,11000,6
TIKI,cham-soc-nha-cua,74466514,"Gel Làm Sạch Đa Năng Cho Cặn Canxi, Nước Cứng Stanhome Deep Gel 25ml/gói",17000,20000,3000,15
TIKI,cham-soc-nha-cua,44179904,"Combo Viên rửa bát Finish Classic 100 viên + Muối Finish 1.2kg + Nước làm bóng Finish 400ml",589000,589000,0,0
TIKI,cham-soc-nha-cua,67104388,"Set 5 túi thơm hương hoa tự nhiên treo tủ quần áo, giao màu ngẫu nhiên",30000,30000,0,0
TIKI,cham-soc-nha-cua,191348594,"Diệt chuột thông minh Racumin 0.75 TP Bayer 20gr",23700,23700,0,0
TIKI,cham-soc-nha-cua,120403572,"GIẤY ĂN GIẤY RÚT PRIME 2 LỚP KHỔ (20X20)cm - COMBO 10 GÓI MÀNG VÀNG",155000,155000,0,0
TIKI,cham-soc-nha-cua,94072972,"Túi Nước Giặt Xả MaxKleen Thiên Nhiên 2.2kg",132000,150000,18000,12
TIKI,cham-soc-nha-cua,45552968,"Bột Giặt Lix Extra Hương Nước Hoa 5.5Kg EH055 - Tăng Gấp Đôi Sức Mạnh Giặt Tẩy",139000,139000,0,0
TIKI,cham-soc-nha-cua,89298871,"Combo 10 cuộn giấy vệ sinh An khang Soft 700 hai lớp một cuộn 700gr",468000,760000,292000,38
TIKI,cham-soc-nha-cua,73287132,"COMBO 3 chai nước giặt LIX Đậm đặc (Đỏ) 3.8LX3",315000,315000,0,0
TIKI,cham-soc-nha-cua,190460283,"Nước rửa chén LIX 3.5KG siêu sạch hương trà xanh loại túi N8101 sạch bóng vết bẩn dầu mỡ không hại da tay",89000,89000,0,0
TIKI,cham-soc-nha-cua,82092184,"Nước thông cống Hando 1000ml nội địa",39000,39000,0,0
TIKI,cham-soc-nha-cua,41173955,"Giấy Làm Mềm Vải và thơm quần áo Bounce Outdoor Fresh 120 tờ ",195000,195000,0,0
TIKI,cham-soc-nha-cua,263444758,"Nước Tẩy Quần áo, Tẩy mốc, Tẩy ố vàng, Tẩy lem màu",48000,48000,0,0
TIKI,cham-soc-nha-cua,161712597,"Combo 2 hộp Giấy Thơm Quần Áo - Kirkland Fabric Softener Sheets (250 tờ x2 hộp)",415000,415000,0,0
TIKI,cham-soc-nha-cua,4987019,"Hộp Khử Mùi Tủ Lạnh Than Hoạt Tính Kobini Nhật Bản (150g)",49000,49000,0,0
TIKI,cham-soc-nha-cua,74458728,"Thuốc diệt chuột Storm 0.005% (1 gói x 20 viên) (bao bì mới)",40000,40000,0,0
TIKI,cham-soc-nha-cua,40965645,"Hạt Xả Vải Purex Crystal Lavender Blossom 1,10kg",105000,105000,0,0
TIKI,cham-soc-nha-cua,54473655,"VIÊN GIẶT TIDE 3 IN 1 HƯƠNG SPRING MEADOW 42 viên - Dạng túi",275000,275000,0,0
TIKI,cham-soc-nha-cua,178780441,"1 hộp nhang đuổi muỗi Thái Lan hộp 30 cây",15000,15000,0,0
TIKI,cham-soc-nha-cua,196410426,"Túi Viên Giặt Xả MaxKleen 2 Trong 1 Hương Nước Hoa Huyền Diệu (34 viên/ túi)",133000,140000,7000,5
TIKI,cham-soc-nha-cua,178000203,"Combo 2 cuộn giấy lau bếp đa năng Japani1000S dùng vệ sinh đa năng hai lớp cắt sheet 35cm - 1000gr",157000,162000,5000,3
TIKI,cham-soc-nha-cua,101271831,"Túi Thơm Nụ Hoa Lavender Khô - Hàng Nhập Khẩu",51329,54030,2701,5
TIKI,cham-soc-nha-cua,88968895," ( không sdt ) Thuốc diệt kiến gián sinh học tận gốc Bảo Châu",3000,3000,0,0
TIKI,cham-soc-nha-cua,49276997,"Combo 2 Túi Nước Giặt Xả Maxkleen Hương Nước Hoa Huyền Diệu (2.4kg/túi)",264000,300000,36000,12
TIKI,cham-soc-nha-cua,191947098,"Nước lau sàn Lix đuổi côn trùng dung tích 3.6L - LD360",89000,89000,0,0
TIKI,cham-soc-nha-cua,205416813,"Muối Rửa Bát Finish 4.0kg",107600,107600,0,0
TIKI,cham-soc-nha-cua,3732419,"Thuốc diệt kiến Nhật bản",115000,115000,0,0
TIKI,cham-soc-nha-cua,77900303,"Combo 2 dây Giấy Vệ Sinh HÀ NỘI SILK  3 lớp Tím Có Lõi Cao Cấp (Tặng Khăn giấy rút HN 150 tờ)",188800,188800,0,0
TIKI,cham-soc-nha-cua,2596451,"Bình hút ẩm khử mùi hương dịu nhẹ Hando 450ml",35000,35000,0,0
TIKI,cham-soc-nha-cua,68258376,"Nước rửa chén hữu cơ Bồ hòn Ecocare tinh dầu Vỏ Cam 2000ml",280000,280000,0,0
TIKI,cham-soc-nha-cua,76047381,"Nước thông cống Hando 570ml hàng nội địa",28000,28000,0,0
TIKI,cham-soc-nha-cua,192714588,"Sản xua đuổi chuột an Toàn RAT OFF Thái Lan chai xịt 200ml",67000,67000,0,0
TIKI,cham-soc-nha-cua,58985776,"Bột giặt tẩy đa năng Oxy Wash - Nhập khẩu Nhật Bản",44500,44500,0,0
TIKI,cham-soc-nha-cua,175976609,"Viên giặt xả Gelball 3D Bold P&G Nhật Bản mùi hương (12-16-17-39-46 viên)",75000,75000,0,0
TIKI,cham-soc-nha-cua,140248509,"10 Bịch Giấy ăn Slisoft 4 lớp Trắng tự nhiên đa năng,khăn giấy rút không chất tẩy trắng an toàn cho cả gia đình",191000,200000,9000,5
TIKI,cham-soc-nha-cua,215466253,"Viên rửa bát Finish Nhật bản 150 viên - Viên finish power cube 150v dùng cho máy rửa bát chén loại nhỏ từ 6 - 8 - 9 -10 bộ bát đĩa",179000,179000,0,0
TIKI,cham-soc-nha-cua,98736012," Bộ 2 chai tẩy đen xoong nồi nhà bếp",193700,193700,0,0
TIKI,cham-soc-nha-cua,129415944,"Combo 2 Gói Bột Tẩy Vệ Sinh Lồng Máy Giặt Hàn Quốc,Bột Tẩy Lồng Máy Giặt - Hàng Chất Lượng",45999,45999,0,0
TIKI,cham-soc-nha-cua,205293575,"Nước làm bóng Finish 750 ml+ muối rửa bát Finish 1200 g",129000,129000,0,0
TIKI,cham-soc-nha-cua,68237924,"Túi Treo Hút Ẩm Calcium Chloride Chống Ẩm Mốc Khử Mùi Quần Áo",25000,25000,0,0
TIKI,cham-soc-nha-cua,122910442,"Muối Rửa Bát Finish 4.0kg",105000,105000,0,0
TIKI,cham-soc-nha-cua,191606208,"Thạch cao thơm - treo tủ quần áo, treo túi xách, phòng tắm",110000,110000,0,0
TIKI,cham-soc-nha-cua,79671794,"Túi Nước Giặt Lix Siêu Sạch Hương Hoa Anh Đào 2.4Kg N2502 - Tẩy Sạch Vết Bẩn Cực Mạnh",79000,79000,0,0
TIKI,cham-soc-nha-cua,12352409,"Nước hoa xịt thơm phòng Auramax 300ml",69300,69300,0,0
TIKI,cham-soc-nha-cua,73638976,"Tẩy dầu mỡ máy hút mùi, mặt bếp, tường gạch ốp, bồn rửa bát HGO 500ml",105000,105000,0,0
TIKI,cham-soc-nha-cua,51953436,"Combo Viên rửa bát Finish 110 viên+Nước làm bóng finish 800ml dùng cho máy rửa bát",468322,632000,163678,26
TIKI,cham-soc-nha-cua,133232964,"10 Bịch Giấy ăn Slisoft Trắng 3 lớp x 100 tờ đa năng,khăn giấy rút không chất tẩy trắng an toàn cho cả gia đình",108500,120000,11500,10
TIKI,cham-soc-nha-cua,1715279,"Bình Xịt Côn Trùng Jumbo Vape Super A1 Hương Lavender 100712618 (600ml)",61000,61000,0,0
TIKI,cham-soc-nha-cua,136462715,"Dung Dịch Tẩy Vết Sơn Cứng Đầu Trên Về Mặt Nội Thất Nhà Cửa Cao Cấp 500ml",119000,119000,0,0
TIKI,cham-soc-nha-cua,172216274,"Chai Nước Thông Cống Mạnh Siêu Tốc BIO 1.6Kg Thông Tắc Nghẽn Cống Cực Mạnh. ",75000,75000,0,0
TIKI,cham-soc-nha-cua,205507012,"[HCM] Viên rửa bát Finish Eco 0% - 70 viên/ hộp",369000,369000,0,0
TIKI,cham-soc-nha-cua,111522099,"Viên Tẩy Vệ Sinh Lồng Máy Giặt Diệt khuẩn và Tẩy chất cặn Lồng máy giặt hiệu quả",2000,2000,0,0
TIKI,cham-soc-nha-cua,75752949,"Nước xả vải khô tinh dầu Comfort Sona",42000,42000,0,0
TIKI,cham-soc-nha-cua,192794234,"Nước rửa chén siêu sạch chanh 1,4kg NS140 sạch bóng vết dầu mỡ hương chanh thơm mát",45000,45000,0,0
TIKI,cham-soc-nha-cua,205293913,"Combo Muối rửa bát finish 1.5kg + Nước làm bóng finish 800ml dùng cho Máy rửa bát chén",235000,235000,0,0
TIKI,cham-soc-nha-cua,107693393,"Nước tẩy bồn cầu Fuwa3e hữu cơ diệt khuẩn với tinh chất khuynh diệp 100ml",17000,17000,0,0
TIKI,cham-soc-nha-cua,146249312,"(Gói 10 viên) Viên Thả Bồn Cầu Khử Mùi, Tự làm sạch, dễ nhìn Hàn Quốc",12064,12699,635,5
TIKI,cham-soc-nha-cua,205499978,"Xà phòng rửa bát Finish Gel Classic 1.3L / can ( Đức )",285000,285000,0,0
TIKI,cham-soc-nha-cua,169904349,"Gel thơm khử trùng bồn cầu gel khử mùi bồn cầu dạng thạch hình bông hoa với 6 mùi thơm cho toilet",12999,12999,0,0
TIKI,cham-soc-nha-cua,4465541,"Nước diệt kiến sạch kiến sau hai giờ - Hantox 50ml",25999,25999,0,0
TIKI,cham-soc-nha-cua,82458400,"Túi Than Tre Hoạt Tính 200g, Hút Ẩm, Khử Mùi, Khử Độc Không Khí",39000,39000,0,0
TIKI,cham-soc-nha-cua,1508591,"Chất Làm Sạch Bình Đun Nước Mao Bao (2 Gói x 25g)",38000,45000,7000,16
TIKI,cham-soc-nha-cua,32428423,"Combo Tinh dầu xịt phòng Xá Xị, khử mùi hôi (02 Chai xịt và 1 lọ treo nguyên chất)",220000,220000,0,0
TIKI,cham-soc-nha-cua,107907480,"Combo Máy diệt khuẩn tự động + Bình xịt Dettol Glen 20 Freshmatic Refill Fresh Air Scent của Úc- Massel Official",240000,484000,244000,50
TIKI,cham-soc-nha-cua,10199645,"Nước rửa bát Kao 1380ml hương trà xanh nội địa  Nhật Bản",144500,144500,0,0
TIKI,cham-soc-nha-cua,83387667," Nước hoa xịt phòng cao cấp 500ml - Sản xuất bởi Hando Việt Nam",35000,35000,0,0
TIKI,cham-soc-nha-cua,172686603,"COMBO 2 Nước Tẩy TRẮNG QUẦN ÁO Javel LIX 2Kgx2",60000,60000,0,0
TIKI,cham-soc-nha-cua,52393121,"Tẩy mốc tường, mốc quần áo đậm đặc HT01-5LIT (dùng cho nhà nghỉ, khách sạn, giặt là, vệ sinh công nghiệp...)",199000,220000,21000,10
TIKI,cham-soc-nha-cua,4618495,"Chai nước hoa xịt thơm phòng khử mùi Hando 200ml",20000,20000,0,0
TIKI,cham-soc-nha-cua,70637195,"Túi 46 viên giặt xả Gelball 3D màu Xanh Dương Nội địa NHẬT BẢN",269000,269000,0,0
TIKI,cham-soc-nha-cua,66587571,"Nước Lau Sàn Hữu Cơ Bồ Hòn Ecocare - 100% thực vật, tinh dầu khử mùi, đuổi muỗi, chống trượt, kháng khuẩn - Chai 2000ml",119000,128000,9000,7
TIKI,cham-soc-nha-cua,7678272,"Viên giặt quấn áo siêu sạch thơm mát nhập khẩu Nhật Bản",105000,105000,0,0
TIKI,cham-soc-nha-cua,176905681,"Combo 4 lọ Hạt xả thơm quần áo, viên xả thơm quần áo thơm cực lâu, lưu hướng và làm mềm vải",18000,18000,0,0
TIKI,cham-soc-nha-cua,14289257,"Nước giặt Layer Clean hương Poppy Coach 4L",185000,185000,0,0
TIKI,cham-soc-nha-cua,53978253,"Súng thông tắc cống đa năng - Dụng cụ thông tắc bồn cầu",294500,310000,15500,5
TIKI,cham-soc-nha-cua,180292751,"Nước Lau Bề Mặt Đa Năng Cô Cà Chua Sạch Tuốt Yêu Nước 4L",410000,410000,0,0
TIKI,cham-soc-nha-cua,5865883,"Nước thơm lau sàn nhà Hando 1L hương nhài",25000,25000,0,0
TIKI,cham-soc-nha-cua,180254228,"Nước Rửa Chén Sinh Học 4L Cô Cà Chua Yêu Nước An Toàn Cho Bé Bảo Vệ Da Tay",380000,380000,0,0
TIKI,cham-soc-nha-cua,26098065,"Combo Tinh dầu xịt phòng chanh sả 100ml + Lọ treo tinh dầu chanh sả",129000,129000,0,0
TIKI,cham-soc-nha-cua,191494119,"Nước rửa bát sinh học oải hương L'Artisan Savonnier 1L",125000,125000,0,0
TIKI,cham-soc-nha-cua,501433,"Nước Lau Sàn Mrs McKenic Chai 2L",175700,251000,75300,30
TIKI,cham-soc-nha-cua,134016306,"Bột cọ xoong nồi, tẩy vết ố mảng bám cleaner beauty 500g, Kem tẩy ố xoong nồi vệ sinh nhà bếp đa năng",15000,15000,0,0
TIKI,cham-soc-nha-cua,48612084,"Túi Than Hoạt Tính Lọc Không Khí Diệt Khuẩn Khử Mùi Cho Tủ Quần Áo",179000,179000,0,0
TIKI,cham-soc-nha-cua,59503290,"Chai tẩy rửa, vệ sinh  lồng máy giặt siêu đậm đặc Ultra Powers 550g - Nhập khẩu Nhật Bản",68500,68500,0,0
TIKI,cham-soc-nha-cua,75947095,"Khử mùi tủ lạnh Gel Fedios-Duo – Thức Ăn Luôn Tươi Ngon & Sạch Thuần Khiết",79000,79000,0,0
TIKI,cham-soc-nha-cua,216350905,"Gói băng phiến Long não khử mùi nấm mốc, đuổi côn trùng, khử mùi nhà vệ sinh",20000,20000,0,0
TIKI,cham-soc-nha-cua,136876263,"Sáp khử mùi tủ lạnh - than hoạt tính, giúp khử mùi mạnh mẽ các mùi khó chịu đáng lo ngại với sức mạnh của than củi - nội địa Nhật Bản",39500,39500,0,0
TIKI,cham-soc-nha-cua,56596932,"Combo Viên rửa bát Finish 77 viên hương chanh + Nước làm bóng finish 750ml dùng cho máy rửa bát",399000,399000,0,0
TIKI,cham-soc-nha-cua,39335537," Hộp khử mùi tủ lạnh than hoạt tính Kokubo 150g - Hàng nội địa Nhật Bản",38500,38500,0,0
TIKI,cham-soc-nha-cua,3774051,"Gói bột thông tắc hầm cầu M. phốt 300g Hando",25000,25000,0,0
TIKI,cham-soc-nha-cua,191654241,"Nước giặt xả Hiclass 3500ml - Hàng Thái Lan",199000,199000,0,0
TIKI,cham-soc-nha-cua,124276385,"Chat Bột Thông Cống Cực Mạnh Nhật Bản Loại Lớn 268gr",30000,32000,2000,6
TIKI,cham-soc-nha-cua,7691005,"Hộp than hoạt tính khử mùi ngăn đá tủ lạnh nội địa nhật bản",31500,31500,0,0
TIKI,cham-soc-nha-cua,10806339,"Sáp thơm khử mùi Shaldan Bio Fresh Scent & Care 180g",50000,50000,0,0
TIKI,cham-soc-nha-cua,190463985,"Nước Lau Sàn Mao Bao Hương Làn Gió Biển Mao Bao chai 1200ml",49000,60000,11000,18
TIKI,cham-soc-nha-cua,53088383,"Combo Bột Rửa Bát Finish Nhật 2,2kg + Bóng Finish 400ml + Muối Finish 1,2kg",628909,628909,0,0
TIKI,cham-soc-nha-cua,49336914,"Dung dịch khử trùng sát khuẩn gia dụng và y tế Sterine",220000,220000,0,0
TIKI,cham-soc-nha-cua,48609951,"Túi Than Hoạt Tính Diệt Khuẩn Khử Mùi Cho Tủ Lạnh Chỉ Sau 24h",179000,179000,0,0
TIKI,cham-soc-nha-cua,71014861,"Viên thả vệ sinh bồn cầu 30 viên tẩy sạch vết bẩn diệt khuẩn khử mùi nhà vệ sinh",24500,24500,0,0
TIKI,cham-soc-nha-cua,189533448,"Bột rửa chén Finish Dishwasher Power Powder Lemon Sparkle 2,5 kg QT017384 - hương chanh",559000,559000,0,0
TIKI,cham-soc-nha-cua,52782327,"Túi 60 viên rửa chén Finish Quantum Max Dishwasher Tablets Lemon QT025460 - hương chanh",398998,398998,0,0
TIKI,cham-soc-nha-cua,2662777,"Thuốc diệt chuột Dethmor dạng viên nội địa Nhật Bản",91500,91500,0,0
TIKI,cham-soc-nha-cua,2526705,"Chai nước rửa bát chén hương táo 600ml Rocket nội địa Nhật Bản",30450,30450,0,0
TIKI,cham-soc-nha-cua,47225303,"Chai vệ sinh tẩy rửa nấm mốc 500ml",91200,96000,4800,5
TIKI,cham-soc-nha-cua,52052246,"Nước làm bóng finish 800ml dùng cho Máy rửa bát chén",135000,135000,0,0
TIKI,cham-soc-nha-cua,52876847,"Nước làm bóng Alio 1000ml dùng cho Máy rửa bát chén",154999,154999,0,0
TIKI,cham-soc-nha-cua,175831934,"GÓI LÀM THƠM VÀ ĐUỔI CÔN TRÙNG NGĂN TỦ QUẦN ÁO HAKUGEN EARTH (HỘP 12 GÓI)",265000,349000,84000,24
TIKI,cham-soc-nha-cua,157045781,"Bột Thông Bồn Cầu, Thông Tắc Ngẽn Cống, Lavabo. Loại Mạnh Xử Lý Triệt Để Nhanh Chóng - Hàng Loại 1 - CHính Hãng MINIIN",25000,43000,18000,42
TIKI,cham-soc-nha-cua,187595760,"Sáp thơm phòng PureAroma MrFresh 180g cao cấp",45000,45000,0,0
TIKI,cham-soc-nha-cua,68819481,"Combo 2 chai Nước Giặt Đồ Lót Nhật Bản (120ml/chai x 2)",214000,214000,0,0
TIKI,cham-soc-nha-cua,57622890,"Nước tẩy trắng javel thông minh SIFA 1kg cao cấp - Nước javel tẩy quần áo, tẩy sạch những vết bẩn cứng đầu",22000,22000,0,0
TIKI,cham-soc-nha-cua,4300411,"Combo 3 hộp hút ẩm 800ml nội địa Nhật Bản",226500,226500,0,0
TIKI,cham-soc-nha-cua,72103652,"Combo 2 Nước Giặt Ariel Matic Đậm Đặc (3.6Kg/ Túi)",339000,339000,0,0
TIKI,cham-soc-nha-cua,3871463,"Nước hoa xịt phòng khử mùi Hando 200ml",20000,20000,0,0
TIKI,cham-soc-nha-cua,51953005,"combo viên rửa bát finish 110 viên+muối rửa bát finish 1,5kg dùng cho máy rửa bát",449950,449950,0,0
TIKI,cham-soc-nha-cua,158225321,"Bột Giặt Ariel Hương",199000,199000,0,0
TIKI,cham-soc-nha-cua,107741822,"[TỰ CHỌN 13 MÙI] Xịt Phòng Tinh Dầu Hữu Cơ Organic 24Care 50ML - Khử Mùi, Đuỗi Muỗi và Côn Trùng, Xịt Thơm Quần Áo",25000,25000,0,0
TIKI,cham-soc-nha-cua,459924,"Nước Rửa Chén Sunlight Chanh Dạng Chai 3.8kg",99000,99000,0,0
TIKI,cham-soc-nha-cua,101359079,"Combo 3 Cốc thả bồn cầu tẩy xanh toilet Hàn Quốc Mr Fresh 180g hương ngàn hoa",115000,115000,0,0
TIKI,cham-soc-nha-cua,576190,"Nước Giặt Kháng Khuẩn Mao Bao 1800g",78000,87000,9000,10
TIKI,cham-soc-nha-cua,112710607,"Nước Lau Sàn Gốc Thực Vật Peace Mass TD Chanh Sả - Bạc Hà Đuổi Muỗi và Côn Trùng (Thuộc nhóm Sản phẩm Lành tính / Hữu cơ) Can 3.6 lít",222300,234000,11700,5
TIKI,cham-soc-nha-cua,177487881,"[COMBO 6 GÓI] Khăn giấy lụa đa năng Premier VinaTissue 2 lớp 100% bột giấy nguyên sinh, không chất tẩy 180 tờ",98000,108000,10000,9
TIKI,cham-soc-nha-cua,68258691,"Nước rửa chén hữu cơ Bồ hòn Ecocare tinh dầu Sả Chanh 2000ml",215000,280000,65000,23
TIKI,cham-soc-nha-cua,1385293,"Nước Rửa Chén Hương Quả Hồng Layer Clean (5L / Bình)",165000,165000,0,0
TIKI,cham-soc-nha-cua,3941045,"Nước tẩy rửa bồn cầu đậm đặc Hando 960ml ",25000,25000,0,0
TIKI,cham-soc-nha-cua,74392889,"KEM TẨY RỬA XOONG NỒI ĐA NĂNG",16900,16900,0,0
TIKI,cham-soc-nha-cua,4534007,"  Hộp khử mùi tủ giày than hoạt tính nội địa Nhật Bản",37000,37000,0,0
TIKI,cham-soc-nha-cua,107693381,"Nước tẩy bồn cầu và nhà vệ sinh hữu cơ Fuwa3e 500ml tinh chất khuynh diệp diệt khuẩn, không chất độc hại, tẩy rửa cực mạnh, đánh bay cặn bẩn, hương thơm dài lâu",66000,66000,0,0
TIKI,cham-soc-nha-cua,65005758,"Xịt Phòng Tinh Dầu Bưởi Ngọt Hữu Cơ Organic 24Care 50ML/100ML - Kháng khuẩn - Khử mùi hôi - Đuổi muỗi, côn trùng - Xịt không gian bàn ăn, giúp ăn ngon miệng hơn - Hương thơm thư giãn",36000,36000,0,0
TIKI,cham-soc-nha-cua,90661011,"Bột Vệ Sinh Máy Pha Cà Phê Urnex Cafiza 2 Espresso Machine Cleaning Powder 900gram - Mã 12-C26-900",204600,204600,0,0
TIKI,cham-soc-nha-cua,14301961,"Tẩy rửa bồn cầu VIM chanh sả 880ml (chai) - [8934868161455]",38000,38000,0,0
TIKI,cham-soc-nha-cua,169804801,"Combo 10 dây nước xả vải đậm đặc (120 gói/20ml) - Nước xả vải được ưa chuộng tại Thái Lan",89000,159000,70000,44
TIKI,cham-soc-nha-cua,137479303,"COMBO 3 Túi Nước rửa chén Sunlight Trà xanh Túi 750gx3",79000,79000,0,0
TIKI,cham-soc-nha-cua,148022896,"[COMBO 5 HỘP] Khăn giấy lụa đa năng Premier Tôi Yêu Việt Nam 2 lớp 100% bột giấy nguyên sinh, không chất tẩy 180 tờ",88000,110000,22000,20
TIKI,cham-soc-nha-cua,110965021,"Nước Giặt Quần Áo Baking Soda Mao Bao 2000g",114000,145000,31000,21
TIKI,cham-soc-nha-cua,1352453,"Hộp 3 Gói Hợp Chất Làm Sạch Lồng Giặt Mao Bao Bản Nâng Cấp X3 (300g)",125000,147000,22000,15
TIKI,cham-soc-nha-cua,49280995,"Nước giặt Tide Pods 3 in 1 Spring Meadow thùng 168 Viên - USA",1200000,1200000,0,0
TIKI,cham-soc-nha-cua,170630701,"Xịt đuổi chuột Run Away - Không mùi, an toàn - Xua đuổi chuột, gián, côn trùng ...chỉ sau 1 lần xịt",22193,22193,0,0
TIKI,cham-soc-nha-cua,190455261,"Nước rửa chén LIX 3.5KG siêu sạch hương chanh loại túi N4301 sạch bóng vết bẩn dầu mỡ không hại da tay",89000,89000,0,0
TIKI,cham-soc-nha-cua,189674485,"Nước giặt Lix Đậm Đặc Hương Hoa Chai 3.6kg - Tẩy Sạch Cực Mạnh Vết Bẩn - NG360",125000,125000,0,0
TIKI,cham-soc-nha-cua,6515571,"Combo 6 Hộp Hút Ẩm Khử Mùi Nấm Mốc Hương Lavender 450Ml",186000,186000,0,0
TIKI,cham-soc-nha-cua,34007082,"Chai Tẩy vệ sinh toilet Mr.Fresh 1L siêu mạnh hương ngàn hoa",28000,28000,0,0
TIKI,cham-soc-nha-cua,68251330,"Hộp 12 Viên sủi tẩy lồng máy giặt diệt khuẩn và tẩy chất cặn chất lượng cao GD361-TayLG",11450,11450,0,0
TIKI,cham-soc-nha-cua,205293596,"Vệ sinh máy rửa bát Finish - vệ sinh máy finish hương chanh",104000,104000,0,0
TIKI,cham-soc-nha-cua,80901999,"Gói 10 Viên Thả Bồn Cầu Khử Mùi Hàn Quốc",8996,8996,0,0
TIKI,cham-soc-nha-cua,171320962,"Thuốc diệt gián Nhật Bản hộp 12 viên  ",59000,59000,0,0
TIKI,cham-soc-nha-cua,863947,"Chất Khử Mùi Ngăn Mát Tủ Lạnh Kokubo (300g)",45000,45000,0,0
TIKI,cham-soc-nha-cua,205289934,"Viên rửa bát Finish Quantum Ultimate 100 viên loại cao cấp nhất nhập khẩu Chính Hãng",229000,229000,0,0
TIKI,cham-soc-nha-cua,4705387,"Chai nước rửa bát chén hương cam 600ml Rocket nội địa Nhật Bản",32000,32000,0,0
TIKI,cham-soc-nha-cua,190353793,"Chai Xịt Diệt MỐI MỌT, Kiến, Gián và các loại côn trùng (hương Valender) - Nhập Khẩu THÁI LAN 600ml. ARS JET TERMITE LAVENDER",99000,99000,0,0
TIKI,cham-soc-nha-cua,50083407,"Nước rửa chén trung tính hương táo xanh Rocket 600g",30000,39000,9000,23
TIKI,cham-soc-nha-cua,122475061,"Nước Tẩy Rửa Bồn Cầu Okay Pink Toilet Cleaner Thái Lan 960ml siêu mạnh, siêu rẻ...",32100,32100,0,0
TIKI,cham-soc-nha-cua,113039850,"GEL BẢ DIỆT GIÁN ZENTEK NHẬP KHẨU HÀN QUỐC",220000,220000,0,0
TIKI,cham-soc-nha-cua,41619873,"Chất Làm Sạch Bình Đun Nước Mao Bao 25g x 1 gói",20000,25000,5000,20
TIKI,cham-soc-nha-cua,52310263,"combo 10 viên thả tẩy bồn cầu ",13700,13700,0,0
TIKI,cham-soc-nha-cua,121326910,"COMBO 20 Viên tẩy lồng máy giặt Denkmit",162000,162000,0,0
TIKI,cham-soc-nha-cua,67367666,"Nước giặt xả hữu cơ Bồ Hòn Ecocare tinh dầu Hoa Bưởi  2000ml",209000,280000,71000,25
TIKI,cham-soc-nha-cua,189688559,"Túi nước giặt Lix siêu sạch hương hoa anh đào 2.4Kg N2503",69000,69000,0,0
TIKI,cham-soc-nha-cua,85063052,"Túi Thơm Treo Tủ Quần Áo 3 Gói X 10g Hương Nhài",40000,40000,0,0
TIKI,cham-soc-nha-cua,63973380,"Nước Rửa Chén Hữu Cơ Bồ Hòn Và Tinh Dầu Sả Chanh 500ml thương hiệu Ecocare",75000,120000,45000,38
TIKI,cham-soc-nha-cua,45552696,"Nước Giặt Lix Nha Đam Aloe Vera 4Kg NG400 - Bảo Vệ Da Tay",105000,105000,0,0
TIKI,cham-soc-nha-cua,121327340,"chai nuớc vệ sinh lồng máy giặt 99% 550g",39500,39500,0,0
TIKI,cham-soc-nha-cua,4328087,"Combo 03 túi nước giặt kháng khuẩn Mao Bao 1800g",226000,261000,35000,13
TIKI,cham-soc-nha-cua,68819395,"Nước Giặt Đồ Lót Nhật Bản 120ml",103000,103000,0,0
TIKI,cham-soc-nha-cua,110001565,"Bột Thông Cống,Bồn Cầu,Lavabo Cực Mạnh YUHAO Siêu Thần Thánh 268G Thế Hệ Mới",38000,38000,0,0
TIKI,cham-soc-nha-cua,38382441,"Sáp Thơm Phòng Renuzit",40000,40000,0,0
TIKI,cham-soc-nha-cua,87637570,"Bột Thông Tắc Cống Nghẹt Cực Mạnh Lọ 268gram",16740,20325,3585,18
TIKI,cham-soc-nha-cua,73282283,"COMBO 3 túi nước giặt Ariel Nắng mai 3.6kg",499000,499000,0,0
TIKI,cham-soc-nha-cua,501435,"Bình Xịt Làm Sạch Không Khí Germ Killer 300ml ",118300,169000,50700,30
TIKI,cham-soc-nha-cua,72888257,"Nước Xả Vải Downy Hương Nước Hoa Đam Mê 8.5L",539000,539000,0,0
TIKI,cham-soc-nha-cua,62642809,"Nước tẩy gạch xi măng sifa 1.2L cũ thành mới cao cấp - tẩy trên nhiều chất liệu siêu nhanh siêu mạnh ",47900,47900,0,0
TIKI,cham-soc-nha-cua,205291422,"Combo Viên rửa bát Finish 110 viên + Muối Finish 1.2kg + Nước làm bóng Finish 400ml",589000,589000,0,0
TIKI,cham-soc-nha-cua,6473343," Hộp Hút Ẩm Than Hoạt Tính Mr.Fresh Hàn ",34000,34000,0,0
TIKI,cham-soc-nha-cua,171000638,"Phao nước tự động thông minh chống tràn tự ngắt nước thế hệ mới loại tốt - Phao cơ nhựa chống tràn bồn nước, bồn cầu",43000,43000,0,0
TIKI,cham-soc-nha-cua,4987047,"Chai Tẩy Lồng Giặt Siêu Sạch Ultra Powers Cao Cấp Kobini Nhật Bản (550g)",68000,68000,0,0
TIKI,cham-soc-nha-cua,39292644,"Nước làm bóng Finish 1150ml",235000,235000,0,0
TIKI,cham-soc-nha-cua,205384753,"Muối rửa bát Finish hộp 1,2kg dùng cho máy rửa chén bát",99000,99000,0,0
TIKI,cham-soc-nha-cua,53519335,"Kẹp Khử Mùi Nhà Vệ Sinh ECODEALS Clip Fresher - Hiệu quả vượt trội 30 ngày",55000,75000,20000,27
TIKI,cham-soc-nha-cua,176710100,"Hạt Xả Thơm Làm Mềm Vải Quần Áo Hương Nước Hoa Siêu Lưu Hương, sử dụng cho máy giặt tạo hương thơm dễ chịu - NGẨU NHIÊN",19000,19000,0,0
TIKI,cham-soc-nha-cua,195328185,"Nước lau sàn hương Gừng Sả SPY 950ml tự nhiên, thanh mát, giúp xua đuổi côn trùng hiệu quả",27456,31200,3744,12
TIKI,cham-soc-nha-cua,77278759,"COMBO 2 túi Nước xả vải Downy Nắng mai 3.5LX2",379000,379000,0,0
TIKI,cham-soc-nha-cua,169304095,"Nước lau kính thơm Hando 5L",90000,90000,0,0
TIKI,cham-soc-nha-cua,189676414,"Nước giặt Lix Đậm Đặc Hương Nước Hoa Chai 3.6Kg - Tẩy Sạch Cực Mạnh Vết Bẩn - NGH10",125000,125000,0,0
TIKI,cham-soc-nha-cua,119320344,"[Nhập khẩu Đức] Bột tẩy trắng quần áo DENKMIT 50g, Wäsche-Weiss, 50 g,  Tẩy trang phục công sở bị ngả màu, ố bẩn hay lem nhem",70000,70000,0,0
TIKI,cham-soc-nha-cua,137228145,"[COMBO 3 LỐC] Giấy vệ sinh Premier VinaRoll có lõi, 3 lớp 100% bột giấy nguyên sinh, không chất tẩy lốc 6 cuộn",158000,193000,35000,18
TIKI,cham-soc-nha-cua,177915900,"Hàng chính hãng - Nước lau sàn chuyên dụng Roborock OMO",480000,480000,0,0
TIKI,cham-soc-nha-cua,172455479,"Chai xịt tẩy rỉ sét RP7-300g",51000,51000,0,0
TIKI,cham-soc-nha-cua,65016458,"Xịt Phòng Tinh Dầu Bạc Hà Hữu Cơ Organic 24Care 50ML/100ML - Kháng khuẩn - Khử mùi hôi - Đuổi muỗi, côn trùng - Tập trung tinh thần làm việc, lái xe, học hành - Hương thơm thư giãn",37000,49000,12000,24
TIKI,cham-soc-nha-cua,53626932,"Tấm Lót Khử Mùi Bồn Tiểu & Lỗ Sàn ECODEALS Wave Fresher - Khử mùi, làm thơm toilet vượt trội 30 ngày, chống văng và giọt bắn - KT 18x18cm",57000,75000,18000,24
TIKI,cham-soc-nha-cua,180228019,"Nước Giặt Quần Áo Cô Cà Chua Yêu Nước 4L",360000,360000,0,0
TIKI,cham-soc-nha-cua,205293880,"Nước làm bóng finish 800ml dùng cho Máy rửa bát chén",139000,139000,0,0
TIKI,cham-soc-nha-cua,182131139,"Thuốc tẩy trắng quần áo Vic oxy X5000, Không làm mỏng vải quần áo, không hại da tay, phai màu quần áo, dày dép",39000,49000,10000,20
TIKI,cham-soc-nha-cua,124954933,"[HCM] Vệ sinh máy rửa bát finish vỉ 3 viên",100000,100000,0,0
TIKI,cham-soc-nha-cua,42892047,"Vi Sinh Xử Lý Dầu Mỡ, Khử Mùi - EcoClean FOG - Chai 1Lít - Chính Hãng Từ USA",253000,253000,0,0
TIKI,cham-soc-nha-cua,124035777,"Dung Dịch Tẩy Rửa Vết Bẩn Ghế Sofa Nội Thất Bằng Vải Nỉ Cao Cấp 500ml",95000,95000,0,0
TIKI,cham-soc-nha-cua,37888513,"Bột rửa bát Finish Classic 2.5kg",519000,519000,0,0
TIKI,cham-soc-nha-cua,84650839,"Combo 3 Cốc Thả két nước bồn cầu Hương Hoa Hàn Quốc",115150,117500,2350,2
TIKI,cham-soc-nha-cua,2154961,"Set 2 viên thả bồn cầu nội địa Nhật Bản",31000,31000,0,0
TIKI,cham-soc-nha-cua,25746921,"Tinh dầu xịt phòng Sá Xị, khử mùi hôi 100ml",95000,95000,0,0
TIKI,cham-soc-nha-cua,576225,"Nước Lau Sàn Gỗ Đàn Hương Mao Bao 1L",37500,40000,2500,6
TIKI,cham-soc-nha-cua,7413601,"Thuốc diệt chuột tiêu diệt cả đàn chuột hàng xách tay Nhật Bản",89000,89000,0,0
TIKI,cham-soc-nha-cua,10073147,"Nước Tẩy Trắng Quần Áo 600ml - Nội Địa Nhật Bản",34000,34000,0,0
TIKI,cham-soc-nha-cua,37135696,"Viên rửa bát Finish Classic 100 viên/ hộp (hương chanh)",332000,332000,0,0
TIKI,cham-soc-nha-cua,91220918,"Nước rửa chén diệt khuẩn KAO Kyukyutto 1380mL nội địa Nhật - Hương cam",159740,163000,3260,2
TIKI,cham-soc-nha-cua,55882427,"Viên rửa bát Finish Quantum Max 60 Viên 14 in 1 - Hanoimart",399000,399000,0,0
TIKI,cham-soc-nha-cua,142834840,"Dung dịch Tẩy trắng quần áo cao cấp X5000 Plus - Tẩy được cả các loại quần áo màu, không gây hại da tay, khử sạch mùi hôi khó chịu, Diệt khuẩn nấm mốc.",38000,38000,0,0
TIKI,cham-soc-nha-cua,47403699,"Kem Tẩy Vết Bẩn Đa Năng It Works 100ml",89000,130000,41000,32
TIKI,cham-soc-nha-cua,58047765,"Dung Dịch Xoá Vết Xước Gạch Sàn Nhà Siêu Sạch Cao Cấp 260ml",58000,58000,0,0
TIKI,cham-soc-nha-cua,17598685,"Viên thả làm sạch bồn cầu hương lavender  - Hàng nội địa Nhật",25000,25000,0,0
TIKI,cham-soc-nha-cua,39311068,"Hộp khử mùi làm thơm phòng hương Lavender -  Kobuko 3480 - Hàng nội địa Nhật Bản",37500,37500,0,0
TIKI,cham-soc-nha-cua,68472521,"Nước lau sàn Hữu cơ Ecocare đuổi muỗi tinh dầu Sả chanh 2000ml ",128000,160000,32000,20
TIKI,cham-soc-nha-cua,38295361,"Combo 2 gói Tiết Kiệm ECOCLEAN SEPTIC - Men Vi Sinh Xử Lý Hầm Cầu Bể Phốt - USA",164000,164000,0,0
TIKI,cham-soc-nha-cua,10091931,"Combo 03 Chai Nước Giặt Cổ Áo Mao Bao 600ml",127000,180000,53000,29
TIKI,cham-soc-nha-cua,193393058,"Giấy Lau Đa Năng Pulppy Lau Bếp tiện dụng thấm hút dầu mỡ",34000,55000,21000,38
TIKI,cham-soc-nha-cua,189557946,"Nước rửa chén On1 tinh dầu hương gừng cam dung tích 1Kg N5603 - Sạch bóng vết dầu mỡ - Bảo vệ da tay",59000,59000,0,0
TIKI,cham-soc-nha-cua,190171143,"Bột giặt LIX Extra hương nước hoa 2.4KG EH030- Tẩy Sạch Cực Mạnh Vết Bẩn",72000,72000,0,0
TIKI,cham-soc-nha-cua,50083415,"Gel làm sạch chống tắc đường ống Rocket 450g tẩy rửa mạnh",45000,45000,0,0
TIKI,cham-soc-nha-cua,53612175,"Nước tẩy bồn cầu Hồng  HT01-TVS-960ML (loại cực mạnh)",32000,33000,1000,3
TIKI,cham-soc-nha-cua,54415600,"Nước giặt xả hữu cơ Bồ Hòn Ecocare tinh dầu Hoa Bưởi 1000ml",115000,179000,64000,36
TIKI,cham-soc-nha-cua,4987043,"Chai Thông Tắc Đường Ống Loại To Rocket Kobini Nhật Bản (800g)",49500,49500,0,0
TIKI,cham-soc-nha-cua,6217535,"Nước Rửa Chén Hương Chanh Loại Túi 500ml Rocket",28000,36000,8000,22
TIKI,cham-soc-nha-cua,59211271,"HỘP 30 VIÊN GIẶT XẢ QUẦN ÁO nhiều mùi siêu sạch GD346-Viengiatxa",17000,17000,0,0
TIKI,cham-soc-nha-cua,113255747,"Bình xịt diệt côn trùng Muỗi Kiến Gián Mối Mọt Sinh Học 100% THẢO MỘC 10S - An toàn hiệu quả (Hương Bạc Hà mới )",145000,145000,0,0
TIKI,cham-soc-nha-cua,50235234,"Nước rửa chén trung tính hương chanh Rocket 600g",30000,39000,9000,23
TIKI,cham-soc-nha-cua,118711173,"Bộ 2 gói 60 viên băng phiến long não khử mùi,xua đuổi côn trùng 120Gr(Thiên Nhiên)",39000,39000,0,0
TIKI,cham-soc-nha-cua,205293819,"Nước làm bóng Alio 1000ml dùng cho Máy rửa bát chén",159000,159000,0,0
TIKI,cham-soc-nha-cua,139198591,"Gel Khử Mùi Diệt Khuẩn Bồn Cầu Hình Hoa Hương Thơm Dễ Chịu",10000,10000,0,0
TIKI,cham-soc-nha-cua,73314753,"Combo 02 Viên thả khử mùi bồn tiểu đứng (dành cho nam) 15g - Nhập khẩu Nhật Bản",79500,79500,0,0
TIKI,cham-soc-nha-cua,79672205,"Túi Nước Giặt Lix Đậm Đặc Hương Nước Hoa 3.5Kg NGH07 - Tẩy Sạch Vết Bẩn Cực Mạnh",90000,90000,0,0
TIKI,cham-soc-nha-cua,58608066,"Túi 60 viên rửa bát Finish Quantum Dishwasher Tablets Apple Lime Blast QT025461 - hương chanh, táo",399000,399000,0,0
TIKI,cham-soc-nha-cua,33139668,"Viên Giặt Quần Áo Kháng Khuẩn Kirkland Signature Ultra Clean 152 Viên Của Mỹ",750000,750000,0,0
TIKI,cham-soc-nha-cua,122910055,"Nước làm bóng Finish 750ml ( Đức )",135000,135000,0,0
TIKI,cham-soc-nha-cua,50234956,"Nước tẩy rửa vệ sinh bồn cầu Rocket 500ml ",39000,52000,13000,25
TIKI,cham-soc-nha-cua,51520769,"Nước Giặt Xả Gốc Thực Vật 2in1 Peace Mass (Thuộc nhóm Sản phẩm Lành tính / Hữu cơ) Can 3.6l",274550,289000,14450,5
TIKI,cham-soc-nha-cua,39324852,"Nước lau sàn S.P.Ca Premium 4.5 Lít - Sả & Chanh",104800,131000,26200,20
TIKI,cham-soc-nha-cua,88011456,"[COMBO 3 CHAI] Nước Xả Vải Khô Lâm Đại Phúc -MIX MÙI",125000,125000,0,0
TIKI,cham-soc-nha-cua,72875816,"Combo 2 chai xịt phòng RT300 mùi chanh sả, giúp khử mùi, làm sạch không khí, tạo cảm giác dễ chịu",142000,205000,63000,31
TIKI,cham-soc-nha-cua,110001190,"Gel Thơm Khử Trùng, Khử Mùi, Diệt Khuẩn Bồn Cầu Thông Minh Nhập Khẩu Hàn Quốc",10999,10999,0,0
TIKI,cham-soc-nha-cua,88964548,"Xịt tẩy rửa nhà bếp Magic Cleaning KAO 400ml",110000,110000,0,0
TIKI,cham-soc-nha-cua,35322959,"Thuốc diệt mối dạng nước có đầu xịt tiện dụng",54000,54000,0,0
TIKI,cham-soc-nha-cua,192172891,"Combo 10 viên tẩy bồn cầu tẩy bồn cầu khử mùi Hàn Quốc, viên thả bồn cầu gói 10 cục - binhome",19899,19899,0,0
TIKI,cham-soc-nha-cua,60890991,"Nước Rửa Chén Hữu Cơ Bồ Hòn Và Tinh Dầu Chanh Gừng 500ml Bảo Vệ Da Tay, An Toàn Cho Bé",75000,110000,35000,32
TIKI,cham-soc-nha-cua,171812394,"Giấy Ăn Gấu Trúc Cao Cấp Siêu Dai MINIIN - Giấy Rút Sợi Tre An Toàn Không Chất Tẩy Trắng",24000,26000,2000,8
TIKI,cham-soc-nha-cua,57385894,"Viên vệ sinh máy rửa bát Finish vỉ 4 Viên - HANOIMART",145000,145000,0,0
TIKI,cham-soc-nha-cua,82833069,"COMBO 6 dây Downy Đam mê 10 gói x6",119000,119000,0,0
TIKI,cham-soc-nha-cua,57670147,"Bộ combo sản phẩm tẩy rửa xi măng H+T01- TVS 5LIT và 2 pad cọ rửa xi măng, trên gạch đá, ngói, nhám, giả gỗ, sản phẩm mạnh nhất, can lớn tiết kiệm",350000,399000,49000,12
TIKI,cham-soc-nha-cua,172997367,"Combo 2 Túi Nước Giặt Ariel Matic Hương Downy Thơm Dài Lâu 3.9kg/túix2",389000,389000,0,0
TIKI,cham-soc-nha-cua,36704100,"Combo muối + Bột+ nước rửa Bát - Ly Somat 1.2kg - Đức",395000,395000,0,0
TIKI,cham-soc-nha-cua,188993651,"Dung Dịch Tẩy Vết Rỉ Sét Nhanh Chóng Trên Vải, Quần Áo Cao Cấp M01 100ml",69000,69000,0,0
TIKI,cham-soc-nha-cua,188794962,"10 cuộn giấy vệ sinh Bless You L'amour cao cấp 3 lớp",118000,118000,0,0
TIKI,cham-soc-nha-cua,81203536,"Combo 2 chai bột thông cống TVS cực mạnh, chai lớn 250gam (thông bồn cầu, chậu rửa bát, chậu rửa mặt, hầm cầu cống)",139000,159000,20000,13
TIKI,cham-soc-nha-cua,88861579,"Chai Thả Bồn Cầu Nhật Bản HOMI Mã HC01 -  Khử Mùi Nhà Vệ Sinh, Diệt Sạch 99,9% Vi Khuẩn, Siêu Tiết Kiệm - Hàng Chính Hãng",69000,69000,0,0
TIKI,cham-soc-nha-cua,100917509,"Lọ thả bồn cầu khử mùi Hàn Quốc",29761,29761,0,0
TIKI,cham-soc-nha-cua,49288564,"Combo 3 Túi Nước Giặt Xả Maxkleen Hương Nước Hoa Huyền Diệu (2.4kg/túi)",395000,450000,55000,12
TIKI,cham-soc-nha-cua,172373105,"Chai Tẩy vệ sinh toilet Mr.Fresh 1L",28000,28000,0,0
TIKI,cham-soc-nha-cua,70974797,"Bột Giặt Lix Extra Hương Hoa 9Kg EB010 - Tẩy Sạch Vết Bẩn Cực Mạnh",204000,204000,0,0
TIKI,cham-soc-nha-cua,102480627,"Nước Làm Bóng Finish 750ml - Hàng Nhập Khẩu Đức",125000,125000,0,0
TIKI,cham-soc-nha-cua,205293882,"Nước làm bóng Finish 750ml - Hàng chính hãng - Nhập khẩu EU",159000,159000,0,0
TIKI,cham-soc-nha-cua,180852772,"COMBO 2 chai Nước tẩy bồn cầu VIM Trắng Sáng Than hoạt tính và hoa oải hương (Tím) 870ml X2",70000,70000,0,0
TIKI,cham-soc-nha-cua,192795942,"Nước tẩy quần áo trắng nước Javel Lix 1Kg - tẩy quần áo sạch khuẩn, khử mùi hôi - JL100",39000,39000,0,0
TIKI,cham-soc-nha-cua,270243046,"Xịt khử mùi tinh dầu PK Dung tích 30ml - Khử mùi sát khuẩn, xua đuổi muỗi",49000,49000,0,0
TIKI,cham-soc-nha-cua,189460775,"Túi nước giặt xả On1 chống lem màu hương Bamboo Charcoal 3.5Kg - Sạch khuẩn, khử mùi, kết hợp giặt xả 2 trong 1 - N6903",150000,150000,0,0
TIKI,cham-soc-nha-cua,188785413,"Lọ thả bồn cầu khử mùi hương thơm tự nhiên, chai thả vệ sinh bồn cầu diệt khuẩn khử mùi cao cấp - Chính hãng MINIIN (Giao mẫu ngẫu nhiên)",26000,30000,4000,13
TIKI,cham-soc-nha-cua,172686604,"Nước Giặt Lix Đậm Đặc Hương Nước Hoa 9kg / can",235000,235000,0,0
TIKI,cham-soc-nha-cua,79672316,"Túi Nước Giặt Lix Đậm Đặc Hương Hoa 3.5Kg NG350 - Tẩy Sạch Vết Bẩn Cực Mạnh",90000,90000,0,0
TIKI,cham-soc-nha-cua,174046247,"[COMBO 40 GÓI] Khăn giấy bỏ túi đa năng Premier VinaTissue 2 lớp 100% bột giấy nguyên sinh, không chất tẩy gói 10 tờ",60000,80000,20000,25
TIKI,cham-soc-nha-cua,87378141,"Nước giặt LIX Siêu sạch Hương hoa anh đào (Hồng) túi 2.4KGX2",119000,119000,0,0
TIKI,cham-soc-nha-cua,53831170,"Xịt Tinh Dầu Đuổi Muỗi Sả Chanh Kobi Giúp Chống Muỗi, An Toàn Cho Bé",68000,100000,32000,32
TIKI,cham-soc-nha-cua,152809705,"Combo 3 Chai Xịt Xả Vải Khô - Tinh Dầu Comfort",70000,70000,0,0
TIKI,cham-soc-nha-cua,2598517,"Bộ 8 gói bột thông cống cực mạnh 100g nội địa Hando",158000,158000,0,0
TIKI,cham-soc-nha-cua,85065299,"Túi Thơm Treo Tủ Quần Áo 3 Gói X 10g Hương Lavender TI858",39000,39000,0,0
TIKI,cham-soc-nha-cua,172381858,"Xịt đuổi chuột Run Away - Xịt thảo mộc đuổi chuột không mùi, an toàn - Xua đuổi chuột, gián, côn trùng chỉ sau 1 lần xịt",21284,21284,0,0
TIKI,cham-soc-nha-cua,121326269,"Xịt Chống Muỗi 200ml Nhật Bản mẫu mới",172000,172000,0,0
TIKI,cham-soc-nha-cua,113182456,"Nước Tẩy Bồn Cầu Sinh Học Enzyco 90% Enzyme Lên Men Từ Dứa Và Bồ Hòn, Diệt Khuẩn, Phân Huỷ Nhanh Làm Sạch Thiết Bị Vệ Sinh - Chai 500ml",120000,120000,0,0
TIKI,cham-soc-nha-cua,193234432,"Tẩy cặn canxi, ố kính mốc kính xe hơi 3M Creme Cleanser - Chai 100ml chiết",65000,65000,0,0
TIKI,cham-soc-nha-cua,739345,"Bột Giặt Tide Trắng Sạch Chuyên Dụng (6kg)",185000,185000,0,0
TIKI,cham-soc-nha-cua,112046764,"Thuốc diệt côn trùng ruồi,muỗi Fendona 10SC chai 50ml",98000,98000,0,0
TIKI,cham-soc-nha-cua,137786502,"Bình xịt tẩy lau đa năng Fuwa3e hương nhu 500ml lau kính lau bếp và nhiều bề mặt",86000,86000,0,0
TIKI,cham-soc-nha-cua,119334117,"Viên vệ sinh làm sạch sâu trong máy rửa bát Finish",95000,95000,0,0
TIKI,cham-soc-nha-cua,54662736,"Tấm Lót Khử Mùi Bồn Tiểu & Lỗ Sàn ECODEALS P1 Fresher - Khử mùi hôi cống, thơm gấp 3 lần, chống văng hiệu quả - KT 16x16cm",45000,59000,14000,24
TIKI,cham-soc-nha-cua,59141041,"Xịt xả vải khô Lâm Đại Phúc hương nước hoa",49500,49500,0,0
TIKI,cham-soc-nha-cua,179998437,"Bịch 260 Tờ Khăn Giấy Rút Cellox -❖BỊCH LỚN -màu cam❖",42000,42000,0,0
TIKI,cham-soc-nha-cua,79739686,"TÚI THƠM KÈM MÓC TREO HƯƠNG DỊU NGỌT",20000,20000,0,0
TIKI,cham-soc-nha-cua,116355953,"Nước rửa bát Hữu cơ Golden Life 5L - Hương",129000,129000,0,0
TIKI,cham-soc-nha-cua,50943158," Nước xịt đa năng hữu cơ Bồ hòn và Tinh dầu Sả Chanh 500ml thương hiệu Ecocare",120000,120000,0,0
TIKI,cham-soc-nha-cua,170489690,"Tẩy cặn canxi HGO Plus tẩy sạch vách kính, vòi inox, bồn sứ, gạch men, gương soi nhà tắm an toàn tiện lợi 500ml",105000,105000,0,0
TIKI,cham-soc-nha-cua,119356150,"Combo 3 Kẹp Thơm Khử Mùi Nhà Vệ Sinh ECODEALS Clip Fresher - Gấp 3 sáp thường, an toàn sức khỏe - Mùi ngẫu nhiên",145000,210000,65000,31
TIKI,cham-soc-nha-cua,55987087,"Vi Sinh Xử Lý Bồn Cầu, Bể Phốt  Đầy, Tràn - EcoFlush Hộp Nhỏ - Túi Gói Sinh Học Tự Huỷ",69000,69000,0,0
TIKI,cham-soc-nha-cua,107693383,"Xịt tinh dầu tràm Fuwa3e hữu cơ 100ml",95000,95000,0,0
TIKI,cham-soc-nha-cua,52864830,"Viên rửa Chén Tổng Hợp Finish 100 Tabs classic Dùng Cho Máy Rửa Bát",336800,336800,0,0
TIKI,cham-soc-nha-cua,90117871,"Dung Dịch Tẩy Vết Mực Bút Bi Bút Lông Trên Quần Áo 120ml",63000,63000,0,0
TIKI,cham-soc-nha-cua,52262648,"Túi Nước Giặt Xả MaxKleen Hương Vườn Sớm Mai Sạch Khuẩn Thơm Mềm Tiện Lợi & Tiết Kiệm 2.4KG",132000,150000,18000,12
TIKI,cham-soc-nha-cua,576078,"Bình Xịt Đánh Bóng Đồ Pledge Hương Chanh Chai 330ml",80000,80000,0,0
TIKI,cham-soc-nha-cua,84441235,"Chai thả bồn cầu",32790,32790,0,0
TIKI,cham-soc-nha-cua,3470711,"Nước Lau Sàn S.P.Ca 4.5 Lít -  Hương Bạc Hà & Quế",97600,122000,24400,20
TIKI,cham-soc-nha-cua,159390736,"Khăn giấy lụa Pharmacity",14000,14000,0,0
TIKI,cham-soc-nha-cua,7485297,"Combo 2 Hộp 4 gói bột tẩy cặn canxi cây nước, ấm đun nước, bình nóng lạnh Hando",54000,54000,0,0
TIKI,cham-soc-nha-cua,92905042,"Viên tẩy lồng giặt Denkmit - Đức  1 viên ",7000,7000,0,0
TIKI,cham-soc-nha-cua,83673017,"Thuốc diệt chuột, Kẹo diệt chuột tiêu diệt cả đàn chuột hàng Thái Lan tặng kèm Bẫy chuột thông minh",60000,60000,0,0
TIKI,cham-soc-nha-cua,121326929,"Viên vệ sinh lồng máy giặt Denkmit Đức - Bán lẻ viên",9000,9000,0,0
TIKI,cham-soc-nha-cua,42687049,"Chai Xịt Tẩy Rửa Đa Năng Kitchen Cleaner 500ml – Tẩy Rửa Nhà Bếp Dạng Bọt",18999,18999,0,0
TIKI,cham-soc-nha-cua,4201551,"Combo 3 hộp hút ẩm 450ml nội địa Nhật Bản",98500,98500,0,0
TIKI,cham-soc-nha-cua,205883223,"Muối rửa bát finish 1.5kg - muối finish 1,5kg chuyên dùng làm mềm nước cho máy rửa bát chén finish",120673,120673,0,0
TIKI,cham-soc-nha-cua,3923419,"Combo 2 Hộp khử mùi tủ lạnh than hoạt tính nội địa Nhật Bản",66500,66500,0,0
TIKI,cham-soc-nha-cua,7164563,"Bột rửa bát - Ly Somat 1.2kg - Đức",219000,219000,0,0
TIKI,cham-soc-nha-cua,134799829," Nước rửa bát Kao CuCute 1380 ml Nhật Bản - hàng chính hãng",147980,151000,3020,2
TIKI,cham-soc-nha-cua,150826845,"Combo 2 Nước giặt OMO Matic chuyên dụng Cửa Trước Lavender Khử Mùi Thư Thái 3.6kg",349000,349000,0,0
TIKI,cham-soc-nha-cua,180036604,"Nước Tẩy Rửa Bồn Cầu Cà Chua Mới Toanh Diệt Khuẩn Nấm Khử Mùi 500ml",128000,128000,0,0
TIKI,cham-soc-nha-cua,107906719,"Combo 5 Giấy ăn Slisoft Trắng tự nhiên đa năng, khăn giấy rút không chất tẩy trắng an toàn cho cả gia đình",98000,100000,2000,2
TIKI,cham-soc-nha-cua,186526875,"Túi Thơm Cafe Arabica Rang Mộc Khử Mùi Xe Hơi, Phòng Ngủ - Hapaku",150000,190000,40000,21
TIKI,cham-soc-nha-cua,10051467,"Chai Thông Tắc Đường Ống Cống Daiichi 800g - Nội Địa Nhật Bản",44000,44000,0,0
TIKI,cham-soc-nha-cua,111415066,"Viên Rửa Chén Bát Finish Quantum Ultimate Túi 60 Viên - Nhập khẩu từ Đức",460000,460000,0,0
TIKI,cham-soc-nha-cua,51421822,"Sáp gel thơm phòng PureAroma 180g korea mẫu mới",39000,39000,0,0
TIKI,cham-soc-nha-cua,119645548,"Làm sạch sàn gạch, thiết bị men sứ Dr.C CHÍNH HÃNG - Super Clean S90 Tẩy Xi Măng, Vôi Vữa Trên Bề Mặt Sàn Gạch",110000,110000,0,0
TIKI,cham-soc-nha-cua,126937739,"Dung Dịch Xịt Diệt Cỏ, Rong Rêu, Nấm Mốc 500ML",99000,99000,0,0
TIKI,cham-soc-nha-cua,16935264,"Nước rửa chén Mr.Fresh 4,2L Hương Quế",95000,95000,0,0
TIKI,cham-soc-nha-cua,55437003," vệ sinh máy rửa bát finish vỉ 3 viên",99000,99000,0,0
TIKI,cham-soc-nha-cua,118772996,"GIẤY VỆ SINH CUỘN LỚN PRIME 2 LỚP (0,7KG) CÓ LÕI - COMBO 2 CUỘN",64000,64000,0,0
TIKI,cham-soc-nha-cua,7251019,"Chất Chống Tắc Nghẽn W.C Bicro Phốt Siêu Tốc SiFa Victory's (700gr)",55000,55000,0,0
TIKI,cham-soc-nha-cua,109125771,"Thuốc diệt muỗi Anh Quốc Permethrin Plus 50EC chai 1 lít",960000,960000,0,0
TIKI,cham-soc-nha-cua,19986898,"Mồi diệt kiến tận gốc KADO BAIT – Gel DIỆT KIẾN",55000,55000,0,0
TIKI,cham-soc-nha-cua,121326319,"Xịt chống muỗi và côn trùng Skin vepa Nhật Bản 200 ml /chai",133000,133000,0,0
TIKI,cham-soc-nha-cua,122576846,"Gói Hút Ẩm Lớn  1KG  - Hạt chống ẩm mốc, khử mùi hôi, treo trong phòng, xe, tủ quần áo nhà kho",40000,40000,0,0
TIKI,cham-soc-nha-cua,44970520,"Nước Rửa Chén Gốc Thực Vật Peace Mass Dùng Được Cho Máy Rửa Chén (Thuộc nhóm Sản phẩm Lành tính / Hữu cơ) Chai 500ml",34200,36000,1800,5
TIKI,cham-soc-nha-cua,38493316,"Combo 3 trái long não ",60000,60000,0,0
TIKI,cham-soc-nha-cua,91616315,"✿✿✿ Bột tẩy lồng máy giặt Hàn Quốc 450g cao cấp ✿✿✿",24000,24000,0,0
TIKI,cham-soc-nha-cua,274534751,"Tẩy Vết Bẩn Quần Áo Không Mất Màu - Hư Hại Sợi Vải Pre-Wash Extra Stanhome 500ml - 64350",213000,229000,16000,7
TIKI,cham-soc-nha-cua,100893207,"Làm Sạch Sen, Vòi Inox, Tường Sàn Gạch Nhà Tắm SMART TC - Tẩy Cặn Canxi, Vết Nước Cứng, Vết Bẩn Lâu Ngày - Tặng kèm chổi lông - MIFAN Phân Phối Chính Hãng",155000,155000,0,0
TIKI,cham-soc-nha-cua,107668550,"Bình Xịt Diệt Khuẩn Dettol Glen 20 Freshmatic Refill Fresh Air Scent  Tặng Kèm Máy Khuếch Tán Tự Động 174g của Úc",227000,484000,257000,53
TIKI,cham-soc-nha-cua,205379551,"Nước vệ sinh bảo trì máy rửa bát Finish ( Đức ) 250ml",99000,99000,0,0
TIKI,cham-soc-nha-cua,36374364,"PHẤN DIỆT KIẾN VÀ CÔN TRÙNG VIPESCO",9500,9500,0,0
TIKI,cham-soc-nha-cua,20833280,"Nước rửa chén bát siêu đậm đặc Mr.fresh 5L hương cam",99000,99000,0,0
TIKI,cham-soc-nha-cua,125048851,"[Combo 2 sản phẩm] Gel Diệt Gián Blattanex Chính Hãng",384000,384000,0,0
TIKI,cham-soc-nha-cua,97889754,"Set 2 Viên thả bồn cầu Nhật bản",37000,37000,0,0
TIKI,cham-soc-nha-cua,193124898,"Combo 2 chai Nước giặt Lix Matic hương nước hoa 3.6Kg NGM40 - chuyên dụng cho giặt máy",245000,245000,0,0
TIKI,cham-soc-nha-cua,9724337,"Nước rửa chén bát đậm đặc 1380ml nội địa Nhật Bản",135000,135000,0,0
TIKI,cham-soc-nha-cua,6473295,"Combo 6 Hộp Hút Ẩm Than Hoạt Tính Mr.Fresh Hàn Quốc",199000,199000,0,0
TIKI,cham-soc-nha-cua,122910125,"Viên rửa bát Finish Classic 120 viên / hộp ( Đức )",362000,797200,435200,55
TIKI,cham-soc-nha-cua,6320509,"Combo 2 chai tẩy diệt khuẩn bồn cầu, toilet Hương Lavender Mr.Fresh Korea 180g",82000,82000,0,0
TIKI,cham-soc-nha-cua,68522389,"Nước làm bóng chén bát Finish Eco 0% - 400ml/ chai",128999,128999,0,0
TIKI,cham-soc-nha-cua,10501080,"Chai Xịt Tẩy Diệt Khuẩn Đa Năng Vo.Temm (600ml)",78000,85000,7000,8
TIKI,cham-soc-nha-cua,71151060,"Combo 3 lọ thuốc diệt kiến gián tận gốc",20000,20000,0,0
TIKI,cham-soc-nha-cua,34154906,"Thuốc diệt chuột Killrat (2 gói 50g) - dạng đa liều",45000,45000,0,0
TIKI,cham-soc-nha-cua,121326672,"Nước làm bóng Finish 750 ml+ muối rửa bát Finish 1200 g",231000,231000,0,0
TIKI,cham-soc-nha-cua,84795188,"Chai xịt  thơm lau nhà bếp tẩy dầu mỡ Hando 500ml",26000,26000,0,0
TIKI,cham-soc-nha-cua,63129838,"Nước rửa bát hữu cơ Golden Life - Hương Quế - 1L",45000,45000,0,0
TIKI,cham-soc-nha-cua,205291767,"Nước làm bóng và khô chén, đĩa Finish Dishwasher Shine & Dry Regular 800ml PTT017394",158000,158000,0,0
TIKI,cham-soc-nha-cua,178010925,"Chai thả tẩy bồn cầu Hàn Quốc ,diệt khuẩn và tỏa hương thơm dịu nhẹ ,lọ thả bồn cầu trắng sạch thơm mát nhà vệ sinh",43998,43998,0,0
TIKI,cham-soc-nha-cua,72819935,"Nước hoa xịt phòng cao cấp Mr.Fresh 500 ml",35000,35000,0,0
TIKI,cham-soc-nha-cua,59048195,"Nước Rửa Bát Hữu Cơ LAYER CLEAN - Hương Quýt, Thể Tích 2L",79000,79000,0,0
TIKI,cham-soc-nha-cua,101976258,"Dung dịch làm sạch khuẩn, khử mùi, vệ sinh đa năng - ASFA All Purpose (Can 2 Lít)",155000,155000,0,0
TIKI,cham-soc-nha-cua,85064531,"Bộ 4 chai tẩy vệ sinh bồn cầu hương ngàn hoa HQ TI158",126699,126699,0,0
TIKI,cham-soc-nha-cua,6409563,"Tinh dầu ASA Ratpel- 350ml",59000,74000,15000,20
TIKI,cham-soc-nha-cua,10000261,"Sáp thơm phòng Hando 87g hương dâu",17000,17000,0,0
TIKI,cham-soc-nha-cua,97586414,"Long não ký",100000,100000,0,0
TIKI,cham-soc-nha-cua,103578279,"Lọ Thả Tẩy Bồn Cầu Hàn Quốc Hương Hoa",29922,29922,0,0
TIKI,cham-soc-nha-cua,174247205,"Bột thông tắc cống HGO Super có khả năng phân huỷ tuyệt đối chất hữu cơ siêu nhanh, an toàn với đường ống, hàng cao cấp đã được kiểm định",120000,120000,0,0
TIKI,cham-soc-nha-cua,122944568,"Dung Dịch Tẩy Vết Ố Vàng Và Làm Trắng Đồ Nhựa 500ML",129000,129000,0,0
TIKI,cham-soc-nha-cua,471771,"Viên Tẩy Vệ Sinh Diệt Khuẩn Bồn Cầu Cao Cấp Hàn Quốc BlueShot (2 Viên x 40g/Viên)",43000,50000,7000,14
TIKI,cham-soc-nha-cua,2983889,"Chất Tẩy Bẩn Đa Năng Siêu Sạch Sumo (700g)",54000,54000,0,0
TIKI,cham-soc-nha-cua,44184059,"Combo 6 lọ thuốc diệt kiến sinh học không mùi",31300,31300,0,0
TIKI,cham-soc-nha-cua,119645546,"Đặc biệt tri ân khách hàng ( Siêu tẩy dầu mỡ Dr.C + Bột thông tắc đường ống, chậu rửa, lồng giặt Be -easy) - Hàng chính hãng",135000,135000,0,0
TIKI,cham-soc-nha-cua,138206882,"Lăn Trị Muỗi Đốt, Côn Trùng Cắn Muhi 50ml Cho Bé Từ 6m+ - Hàng Nhật Nội Địa",107000,107000,0,0
TIKI,cham-soc-nha-cua,91271988,"Cốc, Lọ thả bồn cầu hàn quốc Lemon diệt sạch vi khuẩn và tỏa hương thơm",32498,32498,0,0
TIKI,cham-soc-nha-cua,51096698,"Xịt Vệ Sinh Máy Lạnh Điều hòa Sandokkaebi 330ml",99000,99000,0,0
TIKI,cham-soc-nha-cua,92011005,"Nước tẩy đa dụng 909 loại lớn và loại nhỏ",51300,54000,2700,5
TIKI,cham-soc-nha-cua,73090758,"Chai Tẩy Rửa Sen Vòi Nhà Tắm Sáng Bóng Như Mới SABO-I Loại 100ml. Tẩy vết đốm trắng, mảng bám cặn canxi trên vòi hoa sen, làm sáng bóng thiết bị nhà tắm như mới",29500,59000,29500,50
TIKI,cham-soc-nha-cua,4620645,"Combo 3 Hộp 9 túi thơm phòng Mr. Fresh Hàn Quốc hương ngàn hoa khử mùi tủ quần áo (10g/gói)",109000,109000,0,0
TIKI,cham-soc-nha-cua,4987073,"Bột Giặt Tẩy Đa Năng Siêu Mạnh Oxy Wash Kobini Nhật Bản (680g)",174560,174560,0,0
TIKI,cham-soc-nha-cua,54779872,"Nước nhỏ bồn cầu siêu thơm mát nội địa Nhật Bản Tặng khăn 7Days",77000,77000,0,0
TIKI,cham-soc-nha-cua,205416831,"Muối rửa chén Finish 4.0kg",109000,109000,0,0
TIKI,cham-soc-nha-cua,161211991,"Nước lau nhà sả chanh Fuwa3e hữu cơ lau sàn đuổi muỗi kiến đậm đặc 1L",95000,95000,0,0
TIKI,cham-soc-nha-cua,52789196,"Bột rửa chén Finish Dishwasher Power Powder Lemon Sparkle 2,5 kg QT017384 - hương chanh",558999,558999,0,0
TIKI,cham-soc-nha-cua,121099692,"Túi thơm hương hoa thảo mộc treo tủ quần áo dùng khử mùi hôi hiệu quả",12000,12000,0,0
TIKI,cham-soc-nha-cua,7485251,"Nước thông tắc đường ống thoát nước Hando 1000ml xuất khẩu",38000,38000,0,0
TIKI,cham-soc-nha-cua,169278979,"[Nhập Khẩu Đức] DUNG DỊCH TẨY RỬA NHÀ TẮM DENKMIT BADREINIGER NATURE 750ML, Giúp nhà tắm của bạn luôn sạch và thơm mát.",118000,180000,62000,34
TIKI,cham-soc-nha-cua,193925957,"Thùng 40 gói giấy ăn rúi hình thỏ siêu dai, mềm mịn, an toàn cả cho bé  - Chính hãng MINIIN ",97000,119000,22000,18
TIKI,cham-soc-nha-cua,48122905,"Nước làm bóng và khô chén, đĩa Finish Dishwasher Shine & Dry Regular 800ml PTT017394",144962,144962,0,0
TIKI,cham-soc-nha-cua,97872642,""FINISH TÀI TRỢ" VIÊN RỬA BÁT FINISH ALL IN ONE MAX 10 TÁC DỤNG - HƯƠNG CHANH",289000,289000,0,0
TIKI,cham-soc-nha-cua,74003941,"Túi thơm Pure Aroma 26g - Hoa Lan Chuông (Bell Orchid)",28000,28000,0,0
TIKI,cham-soc-nha-cua,52232693,"Combo Tiết Kiệm 5 Chai Xịt Chống Muỗi Và Côn Trùng Cho Trẻ Nhỏ Và Gia Đình Bảo Nhiên Chai 100ml - Chăm Sóc Và Bảo Vệ Làn Da Trẻ Nhỏ",329000,329000,0,0
TIKI,cham-soc-nha-cua,1988437,"Chai xịt baking soda 400ml Rocket nội địa Nhật Bản",51500,51500,0,0
TIKI,cham-soc-nha-cua,44174319,"Chai Dung Dịch GEL Tẩy Mốc Đa Năng Dành Cho Nhà Bếp, Nhà Tắm 200ml Cao Cấp",29000,29000,0,0
TIKI,cham-soc-nha-cua,162209815,"Gel rửa chén Finish Eco 0% 900ml",316000,637994,321994,50
TIKI,cham-soc-nha-cua,189469550,"Combo Muối rửa bát finish 1.5kg+Nước làm bóng finish800ml dùng cho Máy rửa bát",267799,267799,0,0
TIKI,cham-soc-nha-cua,172126073,"Chai xịt tẩy rửa mảng bám siêu năng Rinrei - Nhật Bản",95000,95000,0,0
TIKI,cham-soc-nha-cua,52590154,"Combo 2 gói bột tẩy vệ sinh lồng máy giặt Hàn Quốc,Bột tẩy lồng máy giặt",41999,41999,0,0
TIKI,cham-soc-nha-cua,2607189,"Bộ 8 gói bột thông tắc hầm cầu M. phốt 300g Hando",216000,216000,0,0
TIKI,cham-soc-nha-cua,51950895,"combo muối rửa bát finish 4kg+nước làm bóng finish 1150ml+viên rửa bát finish 120 viên dùng cho Máy rửa bát",787000,1590000,803000,51
TIKI,cham-soc-nha-cua,2071371,"Chai thông tắc đường ống cống Daiichi 800g nội địa Nhật Bản",48860,48860,0,0
TIKI,cham-soc-nha-cua,121326912,"Nước làm bóng (dầu bóng ) chuyên dùng cho máy rửa chén ly bát",107896,146000,38104,26
TIKI,cham-soc-nha-cua,138381219,"(Gói 10 Viên) Viên Thả Bồn Cầu Toilet Khử Mùi Diệt Khuẩn Hàn Quốc",22490,22490,0,0
TIKI,cham-soc-nha-cua,206250362,"TINH DẦU KHỬ MÙI MÁY RỬA BÁT - HƯƠNG CHANH VÀ CAM",102600,102600,0,0
TIKI,cham-soc-nha-cua,20521002,"Miếng dán khử mùi nhà vệ sinh hình thú",15000,15000,0,0
TIKI,cham-soc-nha-cua,6368303,"Combo 2 túi bột baking soda Sesuki 500g (tẩy trắng) Rocket nội địa Nhật Bản",189000,189000,0,0
TIKI,cham-soc-nha-cua,50945863,"Xịt Lau bàn ăn hữu cơ Bồ hòn tinh dầu Quế 500ml thương hiệu Ecocare",74000,75000,1000,1
TIKI,cham-soc-nha-cua,128597442,"Giấy ăn Slisoft Vàng tự nhiên đa năng,khăn giấy rút không chất tẩy trắng an toàn cho cả gia đình",17500,18000,500,3
TIKI,cham-soc-nha-cua,205293720,"Nước làm bóng và khô chén, đĩa Finish Dishwasher Shine & Dry Regular 750ml, bóng finish 800ml, 1150ml, 1500ml, 400ml",109000,109000,0,0
TIKI,cham-soc-nha-cua,180230994,"Nước Lau Sàn Cô Cà Chua Yêu Nước Hương Sả Chanh Đuổi Muỗi 500ml",62000,62000,0,0
TIKI,cham-soc-nha-cua,97693304,"Tẩy Cặn Canxi Trên Kính SMART TK - Vệ Sinh Sạch Cặn Bám Lâu Ngày Vách Kính Nhà Tắm, Gương - MIFAN Phân Phối Chính Hãng",175000,175000,0,0
TIKI,cham-soc-nha-cua,205414591,"Muối rửa chén Finish Dishwasher Salt 4kg QT017389",126000,257800,131800,51
TIKI,cham-soc-nha-cua,33396308,"Thuốc diệt dán Nhật Bản hộp 12 viên",37000,37000,0,0
TIKI,cham-soc-nha-cua,37426221,"Nước rửa và làm bóng ly - bát somat klarspũler+ Extra-Trocken-Effekt 750 ml - Đức",119000,119000,0,0
TIKI,cham-soc-nha-cua,121326318,"NƯỚC TẨY VỆ SINH LỒNG MÁY GIẶT ROCKET 99.9% NHẬT BẢN( Combo 2 chai )",95000,95000,0,0
TIKI,cham-soc-nha-cua,66852418,"Nước Tẩy Rửa Cặn Canxi Vách Kính Nhà Tắm SMART PLUS Đậm Đặc (300ml)",175000,175000,0,0
TIKI,cham-soc-nha-cua,108851948,"TÚI THƠM HỮU CƠ KHỬ MÙI NẤM MỐC, CHỐNG CÔN TRÙNG, TẠO HƯƠNG THƠM, LƯU HƯƠNG LÂU - XUẤT NHẬT/HÀN/CHÂU ÂU (An toàn cho sức khỏe)",29900,29900,0,0
TIKI,cham-soc-nha-cua,81419334,"BỘT THÔNG CỐNG CỰC MẠNH 268g-TVS55-Hạt Trắng",25000,50000,25000,50
TIKI,cham-soc-nha-cua,10143148,"Chai Tẩy Toilet Diệt Khuẩn Bồn Cầu (500ml)",42500,42500,0,0
TIKI,cham-soc-nha-cua,50334911,"Bột Thông Cống  SaBo-TC Chai 500gam [Hàng An Toàn Chính Hãng]",161250,215000,53750,25
TIKI,cham-soc-nha-cua,119287758,"Combo rửa bát Finish: Muối hộp 4kg, Bột Classic can 2,5kg, Nước Làm bóng 750ml - Chính Hãng.",790000,790000,0,0
TIKI,cham-soc-nha-cua,85063871,"Bộ 2 vỉ 12 viên tẩy và làm thơm bồn cầu Hando Tienich168 TI119 (Xanh)",134000,134000,0,0
TIKI,cham-soc-nha-cua,172307487,"Chai Nước Thông Cầu Siêu Tốc BIO Tím 1,6Kg Thông Tắt Nghẽn Cực Mạnh, Sử Dụng Đổ Trực Tiếp.",75000,75000,0,0
TIKI,cham-soc-nha-cua,82091380,"Bộ 3 chai nước hoa xịt phòng cao cấp Paris by night 500ml",105000,105000,0,0
TIKI,cham-soc-nha-cua,3731137,"Nước Rửa Chén Dành Cho Da Thường, Da Nhạy Cảm (Hàng Nội Địa Nhật Bản) - Chai 500ml",125000,125000,0,0
TIKI,cham-soc-nha-cua,119327221,"Xịt Lau Bàn Ăn từ Bồ Hòn Hữu Cơ ECOCARE 500ml - Diệt khẩn, khử mùi, hiệu quả mọi bề mặt",70500,75000,4500,6
TIKI,cham-soc-nha-cua,3470715,"Nước Lau Sàn S.P.Ca 4.5 Lít -  Hương Lavender",97600,122000,24400,20
TIKI,cham-soc-nha-cua,161214868,"Nước tẩy bồn cầu Fuwa3e hữu cơ diệt khuẩn với tinh chất khuynh diệp 500ml",80000,80000,0,0
TIKI,cham-soc-nha-cua,5183153,"Combo 4 chai tẩy diệt khuẩn bồn cầu, toilet hương hoa ly Mr.Fresh Korea 180g",155000,155000,0,0
TIKI,cham-soc-nha-cua,181673970,"Bột Thông Cống,Bồn Cầu,Lavabo Cực Mạnh YUHAO",33000,33000,0,0
TIKI,cham-soc-nha-cua,172981609,"Soda mix bạc hà MPDT làm trắng răng, tẩy rửa đa năng",18000,18000,0,0
TIKI,cham-soc-nha-cua,52052415,"Bột rửa bát Finish 2.5kg dùng cho Máy rửa bát chén",520000,520000,0,0
TIKI,cham-soc-nha-cua,58104653,"Bột Giặt OMO Chuyên Dụng (9kg)",329000,329000,0,0
TIKI,cham-soc-nha-cua,50083460,"Bột làm sạch lồng máy giặt Rocket 120g",29000,45000,16000,36
TIKI,cham-soc-nha-cua,229703699,"Chai Xịt Diệt Nhện (SP của ARS Thái Lan) - Hương hoa Oải Hương Hiệu quả bất ngờ an toàn với người sử dụng. ARS Skill Spider LAVENDER 600ml",125000,125000,0,0
TIKI,cham-soc-nha-cua,193904065,"Thuốc diệt chuột Storm (túi 20 viên).",37000,37000,0,0
TIKI,cham-soc-nha-cua,576189,"Nước Giặt Kháng Khuẩn Mao Bao 2000g",88000,105000,17000,16
TIKI,cham-soc-nha-cua,137478681,"Giá sỉ nguyên thùng bột giặt Surf Hương nước xả vải (Hồng) Gói lớn 5.8kgX3",439000,439000,0,0
TIKI,cham-soc-nha-cua,205293846,"Bột rửa bát - Ly Somat 1.2kg - Đức",202900,202900,0,0
TIKI,cham-soc-nha-cua,190316921,"Nước giặt Lix Matic hương nước hoa 3.6Kg NGM40 - Dành cho máy giặt cửa trước",145000,145000,0,0
TIKI,cham-soc-nha-cua,194016638,"Khăn giấy bỏ túi nhỏ gọn tiện lợi khi du lịch, ăn uống mini bear Nhật 4 lớp 210 tờ",83000,83000,0,0
TIKI,cham-soc-nha-cua,145828324,"DUNG DỊCH DIỆT KHUẨN KHỬ MÙI NANO HAKAWA 1 LÍT - HƯƠNG CHANH SẢ",600000,600000,0,0
TIKI,cham-soc-nha-cua,42749882,"LƯỚI CHỐNG CÔN TRÙNG RUỒI MUỖI KIẾN BA KHOANG – LƯỚI CHE CỬA SỔ",19000,19000,0,0
TIKI,cham-soc-nha-cua,185765587,"Chai Xịt Đuổi Chuột RAT OFF ANTI RAT SPRAY 200ml - Thái Lan",55000,55000,0,0
TIKI,cham-soc-nha-cua,172996827,"Nước Rửa Chén Siêu Sạch Ngát Hương Chanh 3.6Kg/Can",64000,64000,0,0
TIKI,cham-soc-nha-cua,65108038,"Tinh dầu xịt phòng 24Care diệt muỗi côn trùng 100ml - Thành phần từ Tinh dầu thiên nhiên",52000,69000,17000,25
TIKI,cham-soc-nha-cua,137479731,"COMBO 3 Túi Nước rửa chén Sunlight Chanh 100 Túi 750gx3",63000,63000,0,0
TIKI,cham-soc-nha-cua,169354805,"nước tẩy bồn cầu okay thái lan chai 960ml",38610,39000,390,1
TIKI,cham-soc-nha-cua,119326434,"[Nhập khẩu Đức] Set 2 Gói khử cặn bình nước 25gx2, DENKMIT Entkalker schnell (2 x 25 g), 50 g",60000,60000,0,0
TIKI,cham-soc-nha-cua,194582947,"Nước giặt hữu cơ Layer Clean 5 Lit, Hương Gió Biển",335000,335000,0,0
TIKI,cham-soc-nha-cua,172996983,"Nước Rửa Chén Siêu Sạch Ngát Hương Trà Xanh 3.6Kg/Can",67000,67000,0,0
TIKI,cham-soc-nha-cua,74896109,"Combo 2 tẩy bồn cầu hàng ngày cực mạnh HT01-TVS-960ML (TẶNG NGAY PAD CHÀ RỬA)",65000,70000,5000,7
TIKI,cham-soc-nha-cua,164304275,"Gel Thơm Khử Mùi Bồn Cầu Diệt Khuẩn Toilet Hình Bông Hoa",23750,25000,1250,5
TIKI,cham-soc-nha-cua,145488592,"Thuốc diệt muỗi, kiến FENDONA 10SC",13000,13000,0,0
TIKI,cham-soc-nha-cua,119932871,"10 Viên Tẩy Bồn Cầu, Thả Bồn Cầu, Diệt Vi Trùng, Khử Mùi Nhà Vệ Sinh Tiện Dụng (1 Gói 10 Viên)",9398,9398,0,0
TIKI,cham-soc-nha-cua,154501654,"KEM TẨY RỬA XOONG NỒI ĐA NĂNG - Hàng Loại 1 - Chính Hãng MINIIN",14250,15000,750,5
TIKI,cham-soc-nha-cua,100999563,"Tẩy rửa dầu mỡ đa năng hương chanh bạc hà Stanhome Degreaser Lemon&mint 750ml",242000,285000,43000,15
TIKI,cham-soc-nha-cua,172538068,"Giấy thơm quần áo Denkmit - dùng cho máy sấy, tủ quần áo, giày",140000,140000,0,0
TIKI,cham-soc-nha-cua,55475483,"Xịt Loại Bỏ Cặn Bám, Cặn Canxi, Nước  Cứng Nhà Tắm Stanhome Express Shine Care (500ml)",170000,199000,29000,15
TIKI,cham-soc-nha-cua,179522867,"Chai thả tẩy bồn cầu Hàn Quốc ,diệt khuẩn và tỏa hương thơm dịu nhẹ ,lọ thả bồn cầu trắng sạch thơm mát nhà vệ sinh",42749,44999,2250,5
TIKI,cham-soc-nha-cua,10000163,"Sáp thơm phòng Hando 87g hương chanh",17000,17000,0,0
TIKI,cham-soc-nha-cua,157086086,"Hộp 12 Viên Tẩy Vệ Sinh Lồng Máy Giặt, Diệt Khuẩn Và Tẩy Chất Cặn Lồng Máy Giặt Hiệu Quả - Hàng Loại 1 - Chính Hãng MINIIN",25000,28000,3000,11
TIKI,cham-soc-nha-cua,174200735,"Nước tẩy vệ sinh lồng máy giặt",55000,55000,0,0
TIKI,cham-soc-nha-cua,125710708,"[Nhập khẩu Đức] Dung dịch tẩy cặn Canxi cho ấm siêu tốc, máy pha Cafe, Máy Sưởi, đồ Inox Denk mit, cho ấm đun nước luôn sạch sáng bóng",150000,150000,0,0
TIKI,cham-soc-nha-cua,110235513,"[Nhập khẩu Đức] Nước Lau Sàn Gỗ Denkmit Đức 1000Ml - Nước Lau Nhà Denkmit Đức",190000,190000,0,0
TIKI,cham-soc-nha-cua,149765987,"Thuốc tẩy trắng, tẩy màu quần áo Thái Lan 250ml",25000,25000,0,0
TIKI,cham-soc-nha-cua,87744878,"Kem Tẩy Xoong Nồi Nhà Bếp Hàn Quốc Đa Năng Siêu Sạch Không Hại Da Tay",28999,28999,0,0
TIKI,cham-soc-nha-cua,188694883,"Combo Nước Lau Sàn 3,6kg Ngàn Hoa Ngọt Ngào - 1 Chai 3.6kg + 1 Túi 3.6kg",167000,167000,0,0
TIKI,cham-soc-nha-cua,127461322,"Xịt khử mùi đa năng Tinh dầu 24CARE 50ml/100m/250ml - Xịt bề mặt bị dính bẩn do đồ ăn rơi rớt trên bàn ghế, sàn nhà",35250,47000,11750,25
TIKI,cham-soc-nha-cua,172996913,"Nước Giặt Ariel Matic Hương Nắng Mai 4.1kg/túi",219000,219000,0,0
TIKI,cham-soc-nha-cua,117786362,"1 Gói 20 Viên Thuốc Diệt Chuột Stom",27000,27000,0,0
TIKI,cham-soc-nha-cua,172686615,"Nước giặt Siêu Sạch Lix hoa Hồng can 3.5L",92000,92000,0,0
TIKI,cham-soc-nha-cua,172996831,"Combo 2 Túi Nước Giặt Ariel Matic Hương Nắng Mai 4.1kg/túix2",389000,389000,0,0
TIKI,cham-soc-nha-cua,74182071,"Hộp 12 Viên Tẩy Lồng Máy Giặt Nhật Bản Viên Nén Thế Hệ Mới - Cho Máy Giặt Cửa Trên Và Cửa Trước Đều Dùng Dược, Viên Tẩy Giúp Vệ Sinh Máy Giặt Khỏi Cặn Bẩn, Khử Mùi Máy Giặt Hiệu Quả",11960,11960,0,0
TIKI,cham-soc-nha-cua,190171250,"Bột giặt LIX Extra Hương Nước Hoa 7KG EH070 - Tẩy Sạch Vết Bẩn Mạnh Gấp 2 Lần",195000,195000,0,0
TIKI,cham-soc-nha-cua,176050461,"COMBO (10 bịch/ 100 cuộn) Giấy vệ sinh Ero giá sỉ chất lượng (10 cuộn/ bịch)",157000,240000,83000,35
TIKI,cham-soc-nha-cua,97808087,"( HỘP 30 CÂY ) NHANG MUỖI CÂY THÁI LAN",8999,8999,0,0
TIKI,cham-soc-nha-cua,195891878,"Túi nước giặt 50ml SPY DEEP CLEAN sạch sâu, thơm lâu giúp làm mềm vải",8360,9500,1140,12
TIKI,cham-soc-nha-cua,184431147,"Túi Viên Giặt Xả Đa Năng 4 Trong 1 KA Universal (40 Viên/ Túi)",324000,369000,45000,12
TIKI,cham-soc-nha-cua,77035496,"Giấy vệ sinh HÀ NỘI SILK 3 lớp Xanh Không Lõi Cao Cấp (Tặng Khăn giấy rút lụa Hà Nội 150 tờ)",96000,96000,0,0
TIKI,cham-soc-nha-cua,121099681,"Vỏ quế khô xông thơm và khử khuẩn nhà cửa",35000,35000,0,0
TIKI,cham-soc-nha-cua,57675962,"Túi Nước Giặt Xả Maxkleen Hương Vườn Sớm Mai (3.8kg)",185000,210000,25000,12
TIKI,cham-soc-nha-cua,195480500,"[Combo 3 Lốc] Khăn Giấy Tempo Regular (Lốc 10 gói) - Thương Hiệu Đức",136500,136500,0,0
TIKI,cham-soc-nha-cua,188695859,"Combo 2 Túi Nước Lau Sàn 3.6kg Ban Mai Thanh Mát",142000,148000,6000,4
TIKI,cham-soc-nha-cua,205293607,"Viên rửa bát tổng hợp FINISH 100 viên hương chanh",299000,299000,0,0
TIKI,cham-soc-nha-cua,189700559,"Combo Túi Nước Lau Sàn 3.6kg Ngàn Hoa Ngọt Ngào + Túi Nước Giặt Xả MaxKleen Thiên Nhiên 3.6kg + Chai nước lau bề mặt đa năng",289000,315000,26000,8
TIKI,cham-soc-nha-cua,171284595,"CHAI XỊT XRUST TẨY RỬA NHÀ BẾP ĐA NĂNG SIÊU SẠCH, ĐÁNH BAY VẾT BẨN LÂU NGÀY TRÊN  MỌI VẬT LIỆU",35000,35000,0,0
TIKI,cham-soc-nha-cua,15462892,"COMBO 10 TÚI THƠM CAFE KHỬ MÙI (100G x 10)",249000,249000,0,0
TIKI,cham-soc-nha-cua,50256274,"Nước Giặt Lix Đậm Đặc Hương Hoa 2Kg NG201 - Tẩy Sạch Vết Bẩn Cực Mạnh",65000,65000,0,0
TIKI,cham-soc-nha-cua,58291951,"Dung Dịch Tẩy Trắng  Ron Gạch Sabo-R Chai 1 Lít",260100,289000,28900,10
TIKI,cham-soc-nha-cua,192670990,"Nước rửa chén Lix siêu sạch hương trà xanh 3.6Kg N8105 thơm dịu sạch bóng vết dầu mỡ",99000,99000,0,0
TIKI,cham-soc-nha-cua,80663972,"Túi thơm để tủ quần áo",6000,6000,0,0
TIKI,cham-soc-nha-cua,186615061,"Giấy vệ sinh không lõi 3 lớp cao cấp Japani Silk 600 JPS600 | Giấy vệ sinh trắng mịn dai tiết kiệm | Thế Giới Giấy",50000,75000,25000,33
TIKI,cham-soc-nha-cua,36293044,"Túi Thơm Nụ Hoa Khô Oải Hương Lavender Khử Mùi, Giảm Căng Thẳng, Cho Giấc Ngủ Ngon",13990,13990,0,0
TIKI,cham-soc-nha-cua,205293888,"combo viên rửa bát finish 110 viên + muối rửa bát finish 1,5kg dùng cho máy rửa bát",399000,399000,0,0
TIKI,cham-soc-nha-cua,122763221,"Nước tẩy rửa bồn cầu Hữu cơ diệt khuẩn Ecocare  với tinh chất Quế 1000 ml",89000,120000,31000,26
TIKI,cham-soc-nha-cua,31874789,"Tẩy trắng bồn sứ, sen vòi inox, gạch men Sabo-si chai 500ml không mùi",149000,225000,76000,34
TIKI,cham-soc-nha-cua,102515192,"CHAI XỊT ANTIKAL VỆ SINH & CHỐNG ĂN MÒN INOX 700ml",270000,270000,0,0
TIKI,cham-soc-nha-cua,39327784,"LỐC GIẤY THƠM QUẦN ÁO BOUNCE 160x2 TỜ (TOTAL 320 SHEETS) CỦA MỸ ",440000,440000,0,0
TIKI,cham-soc-nha-cua,7691208,"Viên giặt xả an toàn cho da hàng Nhật Bản",105000,105000,0,0
TIKI,cham-soc-nha-cua,59338433,"Set 02 Túi/Hộp bột giặt tẩy đa năng Oxy Wash - Nhập khẩu Nhật Bản",98500,98500,0,0
TIKI,cham-soc-nha-cua,121335840,"Nước tẩy bồn cầu , nhà vệ sinh okay",26988,26988,0,0
TIKI,cham-soc-nha-cua,177755359,"Giấy ăn lụa, khăn giấy rút cao cấp 1 gói khăn giấy rút 300 tờ",15900,15900,0,0
TIKI,cham-soc-nha-cua,576202,"Nước Lau Sàn Gỗ Đàn Hương 1200ml ",50500,60000,9500,16
TIKI,cham-soc-nha-cua,137478825,"Nước giặt Surf Túi Hồng 2.8L",129000,129000,0,0
TIKI,cham-soc-nha-cua,51953367,"combo viên rửa bát finish 110 viên+nước làm bóng finish 800ml+muối rửa bát finish 1,5kg dùng cho máy rửa bát",559714,559714,0,0
TIKI,cham-soc-nha-cua,75754326,"2 chai nước xả vải khô dạng xịt tinh dầu Comfort Sona",79000,79000,0,0
TIKI,cham-soc-nha-cua,21534112,"Tẩy trắng bồn sứ ố vàng, vệt nước đen lâu năm Sabo-S loại mạnh nhất chai 500ml không mùi",119000,225000,106000,47
TIKI,cham-soc-nha-cua,36592067,"Bình xịt tẩy vết mốc, vết bẩn trên tường 500ml",65000,65000,0,0
TIKI,cham-soc-nha-cua,121326834,"Xịt chống muỗi skin cape Nhật Bản",173000,173000,0,0
TIKI,cham-soc-nha-cua,59171374,"Hộp 30 Viên Nước Giặt Xanh",23999,23999,0,0
TIKI,cham-soc-nha-cua,3923233,"Combo 2 thanh Xà phòng thanh giặt cổ áo nội địa Nhật Bản",65500,65500,0,0
TIKI,cham-soc-nha-cua,196177341,"Lốc 10 Cuộn Giấy Cệ Sinh Bless You Lamour Cao Cấp 3 Lớp",141000,280000,139000,50
TIKI,cham-soc-nha-cua,127493804,"Xịt kháng khuẩn Sả Chanh 24Care - Dung tích 50ml/100ml/250ml - Diệt khuẩn 99,9%, làm sạch, đuổi muỗi, côn trùng",29000,39000,10000,26
TIKI,cham-soc-nha-cua,171058306,"Bình xịt tẩy mốc tường TVS-600ml, tẩy mốc tường, ron cao su, nẹp gỗ, trần, tường, quần áo, trên mọi chất liệu",99000,149000,50000,34
TIKI,cham-soc-nha-cua,16935103,"Nước rửa chén Mr.Fresh 4,2L Hàn Quốc Hương Trà Xanh",95000,95000,0,0
TIKI,cham-soc-nha-cua,12439299,"Máy xịt phòng tự động Auramax AU10",363000,363000,0,0
TIKI,cham-soc-nha-cua,118150082,"Lọ tẩy bồn cầu Hàn Quốc hương hoa",32690,32690,0,0
TIKI,cham-soc-nha-cua,152448827,"Viên rửa chén bát Finish All - in - 1 Max Eco 0% chính hãng, an toàn, thân thiện với môi trường - Túi 40 viên, 70 viên",362000,797980,435980,55
TIKI,cham-soc-nha-cua,72126997,"Hộp 30 viên nước giặt quần áo tiện lợi - hương hoa cỏ thơm mát, khử mùi hôi của quần áo (Giao Hàng Ngẫu Nhiên)",21239,21239,0,0
TIKI,cham-soc-nha-cua,195162651,"Chế Phẩm Diệt Rầy - gói 25ml - bọ nhảy - bọ trĩ - rệp sáp - bọ phấn trắng",18500,18500,0,0
TIKI,cham-soc-nha-cua,188662683,"Hộp Hút Ẩm khử mùi nấm mốc hương lavender 450Ml chuyên dùng trong tủ quần áo, tủ giày, két sắt, phòng vệ sinh",34000,34000,0,0
TIKI,cham-soc-nha-cua,14378849,"Nước lau sàn Layer Clean hương quế 5L ",135000,135000,0,0
TIKI,cham-soc-nha-cua,43829623,"Xịt khử mùi toilet tinh dầu Bạch Đàn Chanh PK - Khử mùi kháng khuẩn, xua đuổi muỗi",49000,49000,0,0
TIKI,cham-soc-nha-cua,143375091,"Nước Lau Sàn Khử Mùi & Làm Sạch Chuyên Dụng Tineco (1L)",350000,659000,309000,47
TIKI,cham-soc-nha-cua,96106173,"Túi 10 viên thả bồn cầu làm sạch vi khuẩn",12000,15460,3460,22
TIKI,cham-soc-nha-cua,137599624,"Nước lau sàn Orenji dành cho Robot hút bụi lau nhà",15000,15000,0,0
TIKI,cham-soc-nha-cua,205293540,"Viên rửa bát Finish Classic 100 viên/ hộp - Hương Chanh",299000,299000,0,0
TIKI,cham-soc-nha-cua,50272343,"Túi 150 Viên Nước Rửa Chén Bát Finish Diệt Khuẩn 99,99% Nội Địa Nhật Bản (Tặng Khăn Lau)",279000,279000,0,0
TIKI,cham-soc-nha-cua,77322686,"Combo 2 Chai Nước Rửa Chén Sinh Học ENZYCO Lên Men Từ Dứa Và Bồ Hòn Làm Sạch Chén Bát Không Gây Khô Da Không Hóa Chất - 02 Chai 100ml",50000,50000,0,0
TIKI,cham-soc-nha-cua,205293854,"viên rửa bát finish 110 tabs dùng cho máy rửa bát",359000,359000,0,0
TIKI,cham-soc-nha-cua,46184118,"Bình xịt vệ sinh máy điều hòa Sandokkaebi 330ml - nội địa Hàn Quốc",92000,92000,0,0
TIKI,cham-soc-nha-cua,4986981,"Chai Nước Tẩy Trắng Vùng Cổ, Tay Áo Kose Chiết Xuất Từ Thiên Nhiên Kobini Nhật Bản (500ml)",90500,90500,0,0
TIKI,cham-soc-nha-cua,145763997,"Dung Dịch Làm Sạch, Tẩy Vết Ố Vách Kính Nhà Tắm, Cặn Caxi Cao Cấp 500ml",105000,105000,0,0
TIKI,cham-soc-nha-cua,119363030,"Combo 2 Túi Than Hoạt Tính ECODEALS 200g - Khử mùi, chống nấm mốc, vi khuẩn, khí độc đến 2 năm",139000,165000,26000,16
TIKI,cham-soc-nha-cua,58579712,"Túi 60 viên rửa bát Finish Quantum Dishwasher Tablets Lemon Sparkle QT025460 - hương chanh",399000,399000,0,0
TIKI,cham-soc-nha-cua,190171457,"Bột Giặt LIX Extra Hương Hoa 5.5Kg EB568 - Tẩy Sạch Vết Bẩn Cực Mạnh",155000,155000,0,0
TIKI,cham-soc-nha-cua,145613814,"Nước Rửa Chén Bát Sunlight Extra Thiên Nhiên Muối Khoáng Và Lô Hội 2.1kg",72000,72000,0,0
TIKI,cham-soc-nha-cua,188688210,"Combo Túi Nước Lau Sàn 3.6kg Ban Mai Thanh Mát + Túi Nước Giặt Xả MaxKleen 3.8kg Huyền Diệu",284000,284000,0,0
TIKI,cham-soc-nha-cua,174628725,"Khăn giấy ăn rút 2 lớp 500 tờ JAPANI | Thế Giới Giấy | 100% bột giấy nguyên sinh JP500X",252000,360000,108000,30
TIKI,cham-soc-nha-cua,192858154,"CHAI XỊT DIỆT KHUẨN KHỬ MÙI TOILET NHÀ VỆ SINH -NANO XCLEAN TOILET SPRAY 500ML-NANO BẠC AHT CORP (AHTC)",87000,148500,61500,41
TIKI,cham-soc-nha-cua,141740705,"Nước tẩy rửa bồn cầu hữu cơ Ecocare 1L làm sạch, diệt khuẩn, khử mùi hiệu quả với tinh dầu Sả chanh/Quế",89000,120000,31000,26
TIKI,cham-soc-nha-cua,39852688,"Combo 2 hộp Viên Giặt Xả 3D Gel Bold 2in1 nội địa Nhật Bản",205000,267000,62000,23
TIKI,cham-soc-nha-cua,61305301,"Nước Rửa Chén Hữu Cơ Bồ Hòn Và Tinh Dầu Quế 500ml thương hiệu Ecocare",75000,120000,45000,38
TIKI,cham-soc-nha-cua,167432311,"Viên Xả Thơm Quần Áo Nội Địa - Hạt Xả Thơm - Làm Mềm Vải - Hộp 110 Gram ( Hàng Nội Địa)",30000,30000,0,0
TIKI,cham-soc-nha-cua,50944740,"Nước xịt tẩy đa năng hữu cơ Bồ Hòn tinh dầu Quế 500ML thương hiệu Ecocare",75000,120000,45000,38
TIKI,cham-soc-nha-cua,164437925,"Nước rửa chén Greenlife Hương Quế 4L ",121000,121000,0,0
TIKI,cham-soc-nha-cua,174228785,"Nước Lau Sàn Hương Quế Trà Bồng 1000ml - 5000ml, Organic Thiên Nhiên Diệt Khuẩn, Xua Đuổi Côn Trùng , An Toàn Cho Da, Nhà Luôn Thơm Ngát - Hàng Chính Hãng",50000,50000,0,0
TIKI,cham-soc-nha-cua,54415598,"Nước giặt xả hữu cơ Bồ Hòn tinh dầu Hoa Bưởi chai 2000ml ",207900,210000,2100,1
TIKI,cham-soc-nha-cua,50106181,"Nước lau sàn hữu cơ Bồ hòn Ecocare tinh dầu Quế 1000ml ",75000,120000,45000,38
TIKI,cham-soc-nha-cua,150877654,"Combo Sản Phẩm Gốc Thực Vật NRTC1 Peace Mass Nước Rửa Tay 340ml + Nước Rửa Chén 500ml (Thuộc nhóm Sản phẩm Lành tính / Hữu cơ)",68400,72000,3600,5
TIKI,cham-soc-nha-cua,124274804,"Bộ 10 Viên Tẩy Bồn Cầu Diệt Khuẩn",15000,16000,1000,6
TIKI,cham-soc-nha-cua,7999700,"Combo Chai nước tẩy toilet siêu đậm đặc 500ml nội địa Nhật Bản",81000,81000,0,0
TIKI,cham-soc-nha-cua,15675847,"Dung dịch tẩy rửa vệ sinh lồng máy giặt Rocket - Hàng nội địa Nhật",39500,39500,0,0
TIKI,cham-soc-nha-cua,63940298,"Thông tắc sifa bồn cầu W.C 700gr bicrophot siêu nhanh , cực mạnh 5 phút thế hệ mới cao cấp ",55000,55000,0,0
TIKI,cham-soc-nha-cua,76076249,"Chai Xịt Tẩy Rửa Đa Năng Kitchen Cleaner 500ml – Tẩy Rửa Nhà Bếp Dạng Bọt - mẫu ngẫu nhiên",20502,20502,0,0
TIKI,cham-soc-nha-cua,50947576,"Xịt lau bàn ăn hữu cơ Bồ hòn tinh dầu Sả Chanh dung tích 500ml thương hiệu Ecocare",75000,120000,45000,38
TIKI,cham-soc-nha-cua,41932803,"EcoClean FRESH - Vi Sinh Khử Mùi Hôi Cống, Lỗ Sàn, Đường Ống USA - Xử lý gốc rễ mùi hôi, an toàn tuyệt đối - Chai 1L",253000,266000,13000,5
TIKI,cham-soc-nha-cua,121326642,"10 Viên vệ sinh lồng máy giặt Denkmit hàng Đức",125000,125000,0,0
TIKI,cham-soc-nha-cua,90116867,"Hộp 30 Viên Giặt Xả Vải Nhiều Màu Sắc Lưu Hương Thơm Lâu 00865",52000,52000,0,0
TIKI,cham-soc-nha-cua,36990925,"Xịt Thơm Phòng Febreze Linen Sky 250g",130000,130000,0,0
TIKI,cham-soc-nha-cua,94801586,"Dụng cụ cọ rửa đa năng, cọ xoong nồi, cọ bếp, cọ rửa bát đĩa có bình chứa tiện lợi",8550,9000,450,5
TIKI,cham-soc-nha-cua,5992509,"Combo 3 Nước hoa xịt phòng khử mùi Hando 200ml Hương Lavender, Hồng, Cafe",59000,59000,0,0
TIKI,cham-soc-nha-cua,170491698,"Combo tẩy cặn canxi nhà tắm HGO Plus + tẩy dầu mỡ nhà bếp HGO thiết kế dạng bình xịt sử dụng tiện lợi hiệu quả tiết kiệm",165000,165000,0,0
TIKI,cham-soc-nha-cua,3164589,"Bột Thông Tắc Bồn Cầu Sifa (200g)",27500,27500,0,0
TIKI,cham-soc-nha-cua,39292836,"Viên rửa bát Finish Classic 110 viên/ hộp",358900,358900,0,0
TIKI,cham-soc-nha-cua,89145265,"Bột tẩy lồng giặt Hàn Quốc 450gr , Bột vệ sinh lồng máy giặt Hàn Quốc",22800,22800,0,0
TIKI,cham-soc-nha-cua,158904954,"Sáp Ong Đánh Bóng Đồ Gỗ, Sàn Gỗ Mifan Beeswax 80gr - Làm mới, Phục hồi màu gỗ, vết xước bàn ghế, tủ, cửa gỗ - Hàng chính hãng",50000,50000,0,0
TIKI,cham-soc-nha-cua,172589146,"Muối rửa bát cho máy rửa chén bát Fuwa3e làm mềm nước 1kg",75000,75000,0,0
TIKI,cham-soc-nha-cua,90409779,"  Loại Cực Mạnh  Bột thông Cống ,Thông Bồn Cầu Thần Thánh ,Thông Tắc Bồn Cầu Nhanh Chóng YUHAO Thế Hệ Mới",26000,26000,0,0
TIKI,cham-soc-nha-cua,161383586,"Bả diệt chuột, kẹo chuột Killrat 0.005 wax block - hộp 40gr x 2 gói (không cần trộn thức ăn)",25000,25000,0,0
TIKI,cham-soc-nha-cua,4103891,"Nước giặt giày thể thao Elmie - 500ml (Hàng nội địa Nhật bản)",116000,116000,0,0
TIKI,cham-soc-nha-cua,2616801,"Chai tẩy xanh bồn cầu hương ngàn hoa Hàn Quốc 180g",42000,42000,0,0
TIKI,cham-soc-nha-cua,205416958,"Combo Viên rửa bát Finish Classic 100 viên + Muối Finish 4.0kg + Nước làm bóng Finish 400ml",519000,519000,0,0
TIKI,cham-soc-nha-cua,31602975,"Túi Thơm Nụ Hoa Khô Oải Hương Lavender",13000,13800,800,6
TIKI,cham-soc-nha-cua,25757340,"Dung Dịch Thông Tắc Đường Ống Stanhome Active Drain 1000Ml",257000,289000,32000,11
TIKI,cham-soc-nha-cua,6515483,"Hộp Hút Ẩm Khử Mùi Nấm Mốc Hương Lavender 450Ml",33000,33000,0,0
TIKI,cham-soc-nha-cua,140374080,"[TIẾT KIỆM] Hộp 12 Gói Septic - Vi Sinh Xử Lý Hầm Cầu, Bể Phốt Đầy - Bảo Trì Hầm Tự Hoại 1 Năm",999000,999000,0,0
TIKI,cham-soc-nha-cua,51600938,"Combo 2 cục Sáp Thơm Phòng Renuzit Forever Raspberry 198g",75000,75000,0,0
TIKI,cham-soc-nha-cua,2137633,"Túi 44 viên giặt, xả 3D Gel Ball",245000,245000,0,0
TIKI,cham-soc-nha-cua,205730975,"Viên rửa bát Finish Quantum Max 60 Viên 14 in 1 - Hanoimart",468899,468899,0,0
TIKI,cham-soc-nha-cua,180293000,"Nước Tẩy Rửa Đa Năng Nhà Bếp Cô Cà Chua Yêu Nước 500ml",88000,88000,0,0
TIKI,cham-soc-nha-cua,168303254,"Nước rửa bát đậm đặc Mr.Fresh không mùi 3800ml",83000,83000,0,0
TIKI,cham-soc-nha-cua,90509440,"Hộp 30 Viên Giặt Xả Quần Áo Cao Cấp",18500,18500,0,0
TIKI,cham-soc-nha-cua,137480668,"Nước rửa chén Sunlight Trà xanh Túi 750g",27000,27000,0,0
TIKI,cham-soc-nha-cua,178027215,"Nước tẩy trắng quần áo Javel Hando 500ml",22000,22000,0,0
TIKI,cham-soc-nha-cua,119656237,"Bột thông tắc cống bồn cầu thần thánh, siêu gói thuốc cho đường ống",14195,14195,0,0
TIKI,cham-soc-nha-cua,26145733,"Viên rửa bát tổng hợp FINISH 100 viên hương chanh",325000,325000,0,0
TIKI,cham-soc-nha-cua,68472858,"Nước lau sàn Hữu cơ Ecocare đuổi muỗi tinh dầu Sả chanh 4000ml ",235000,265000,30000,11
TIKI,cham-soc-nha-cua,89396435,"Xịt khử mùi thuốc lá Caroline 100ml",45000,45000,0,0
TIKI,cham-soc-nha-cua,2099851,"Hộp khử mùi thơm phòng than hoạt tính nội địa Nhật Bản",49000,49000,0,0
TIKI,cham-soc-nha-cua,54614607,"Thuốc diệt chuột tiêu diệt cả đàn chuột hàng xách tay Nhật Bản - Tặng túi zip 3 kẹo mật ong Senjaku",138000,138000,0,0
TIKI,cham-soc-nha-cua,118488928,"Hộp 5 túi hút ẩm chống mốc treo tủ quần áo tủ giày dép tủ bếp Hando 5x50Gr",59000,59000,0,0
TIKI,cham-soc-nha-cua,197161452,"Nước Rửa Chén Bát Hương Quế Trà Bồng 1000ml – 5000ml, Thành Phần Tự Nhiên, An Toàn Cho Da Và Sức Khỏe, Đánh Bật Dầu Mỡ Và Mảng Bám, Mùi Hương Dễ Chịu – Hàng Chính Hãng",45000,45000,0,0
TIKI,cham-soc-nha-cua,221023806,"Muối rửa bát Finish 3kg làm mềm nước trong máy rửa bát, muối finish 1.2kg, muối rửa chén finish 1.5kg , muoi rua bat finish salt 3kg",126000,257326,131326,51
TIKI,cham-soc-nha-cua,77242655,"Combo Nước Giặt, Nước Lau Sàn Và Nước Rửa Chén Sinh Học ENZYCO Lên Men Từ Dứa Và Bồ Hòn Không Hóa Chất Không Hương Liệu Tạo Mùi",519000,519000,0,0
TIKI,cham-soc-nha-cua,19478772,"Sáp Thơm Aroma Pearl hương lavender 320g",45000,45000,0,0
TIKI,cham-soc-nha-cua,159380862,"Combo 3 chai xịt thơm quần áo, lưu hương lâu",49794,49794,0,0
TIKI,cham-soc-nha-cua,2082027,"Nước tẩy vệ sinh lồng máy giặt Rocket nội địa Nhật Bản",39500,39500,0,0
TIKI,cham-soc-nha-cua,121326575,"Hộp 4 túi thơm denkmit Đức",116000,116000,0,0
TIKI,cham-soc-nha-cua,95987389,"Dung dịch vệ sinh máy lạnh Sandokkaebi chai 330ml - Hàn Quốc ",85000,85000,0,0
TIKI,cham-soc-nha-cua,121326710,"bột rửa bát Somat 2,4kg chuyên dùng cho máy",380000,380000,0,0
TIKI,cham-soc-nha-cua,180284575,"Nước Cọ Toilet Tẩy Bồn Cầu Cô Cà Chua Yêu Nước Khử Mùi 500ml",88000,88000,0,0
TIKI,cham-soc-nha-cua,102846543,"Combo 2 vỉ 12 viên tẩy và làm thơm toilet Hando",130000,130000,0,0
TIKI,cham-soc-nha-cua,145613775,"Combo 3 Nước Rửa Chén Bát Sunlight Extra Khử Mùi Tanh Matcha Trà Nhật 2.1kgx3",205000,205000,0,0
TIKI,cham-soc-nha-cua,122516894,"Gói Hút Ẩm 10 Gram đóng gói  500Gram Silicagel - hạt hút ẩm thực phẩm quần áo giày dép máy ảnh hoa khô",11000,11000,0,0
TIKI,cham-soc-nha-cua,173910598,"Vua Rầy Rệp - Trị Rệp , Ruồi Vàng , Rầy Nâu - Gói 15gr",15000,15000,0,0
TIKI,cham-soc-nha-cua,122575027,"Gói Hút Ẩm 1KG quy cách 1/2/3/5/10g Silicagel - hạt hút ẩm thực phẩm quần áo giày dép máy ảnh",76000,76000,0,0
TIKI,cham-soc-nha-cua,133619317,"Giấy ăn Slisoft Trắng 100 tờ x 3 lớp, khăn giấy khô thân thiện môi trường không chất tẩy trắng an toàn cho cả gia đình",12000,12000,0,0
TIKI,cham-soc-nha-cua,6260145,"Combo 2 Hộp Bột thông cống Hando 100g Xuất khẩu",36000,36000,0,0
TIKI,cham-soc-nha-cua,127052292,"Nước tẩy rửa đa năng enzym bồ hòn can 2.2 lít",238000,238000,0,0
TIKI,cham-soc-nha-cua,57507180,"Nước Rửa Chén Bát Sunlight Mềm Dịu Da Tay Hương Bưởi & Hoa Anh Đào 3.6kg",109000,109000,0,0
TIKI,cham-soc-nha-cua,7459627,"Thuốc viên diệt gián hộp 12 viên - Nội địa Nhật",36900,36900,0,0
TIKI,cham-soc-nha-cua,63971344,"Nước Rửa Chén Hữu Cơ Bồ Hòn Và Tinh Dầu cam 500ml thương hiệu Ecocare",75000,99000,24000,24
TIKI,cham-soc-nha-cua,102846461,"Combo 3 vỉ 18 viên tẩy và làm thơm toilet Hando",195000,195000,0,0
TIKI,cham-soc-nha-cua,4312271,"Combo 2 chai nước tẩy quần áo 600ml Rocket nội địa Nhật Bản",61500,61500,0,0
TIKI,cham-soc-nha-cua,100129998,"Nước hoa xịt phòng cao cấp Mr. Fresh 500ml thiết kế dạng vòi xịt  thông minh  ( 7 mùi hương )",35000,35000,0,0
TIKI,cham-soc-nha-cua,54885735,"Xịt Phòng ASOHA 350ML Hương Hoa Ly",18000,30000,12000,40
TIKI,cham-soc-nha-cua,168378525,"viên rửa bát finish power cube 150 viên nhập khẩu nhật bản",359000,359000,0,0
TIKI,cham-soc-nha-cua,121326240,"Dung dịch vệ sinh máy rửa chén bát ( Tẩy cặn can xi ) 250 ml",99000,99000,0,0
TIKI,cham-soc-nha-cua,172587166,"gel rửa chén cho máy rửa chén bát Fuwa3e hữu cơ sinh học dạng gel 2L",385000,385000,0,0
TIKI,cham-soc-nha-cua,121315557,"Nước làm bóng Finish 750ml dành cho máy rửa bát - Hàng chính hãng ",125000,125000,0,0
TIKI,cham-soc-nha-cua,863965,"Tấm treo hút ẩm tủ quần áo 25g (khử mùi)",40000,40000,0,0
TIKI,cham-soc-nha-cua,57968603,"Chai nước hoa xịt phòng cao cấp Mr Fresh 500ml - khử mùi thuốc lá, ẩm mốc, hạn chế côn trùng ruồi muỗi",35000,35000,0,0
TIKI,cham-soc-nha-cua,58583751,"Hộp 100 viên rửa chén Finish Classic Dishwasher Tablets Lemon Sparkle QT025446 - hương chanh",333000,333000,0,0
TIKI,cham-soc-nha-cua,180103303,"Nước Tẩy Rửa Đa Năng Nhà Bếp Cô Cà Chua Sạch Tuốt 500ml Mới Toanh",128000,128000,0,0
TIKI,cham-soc-nha-cua,51844670,"viên rửa bát finish 110 tabs dùng cho máy rửa bát",358900,358900,0,0
TIKI,cham-soc-nha-cua,119384903,"Combo Vệ sinh máy rửa bát Finish: Dung dịch vệ sinh chai 250ml, Viên Treo khử mùi hôi trong máy rửa bát - Chính Hãng.",159999,159999,0,0
TIKI,cham-soc-nha-cua,8034077,"Combo chai xịt baking soda Rocket (400ml)",148500,148500,0,0
TIKI,cham-soc-nha-cua,49729536,"Combo 2 lốc Khăn giấy Tempo Petit Applewood 18 lốc 20x18x7",135000,135000,0,0
TIKI,cham-soc-nha-cua,168369654,"Muối rửa bát Somat 1,2kg - Muối rửa bát Somat CHLB Đức",100000,100000,0,0
TIKI,cham-soc-nha-cua,124413802,"Giấy ăn Slisoft Trắng tự nhiên đa năng,khăn giấy rút thân thiện môi trường không chất tẩy trắng an toàn cho cả gia đình",19500,20000,500,3
TIKI,cham-soc-nha-cua,191265641,"Nước làm sạch Sinh học Đa năng - Hương Lavender - All-Purpose Cleaning Concentrate (SCD Probiotics, USA) - 500ml Đậm đặc",586000,586000,0,0
TIKI,cham-soc-nha-cua,145417826,"Bột rửa bát Kyukyuto dành cho máy rửa bát KAO 680g hương cam",220000,220000,0,0
TIKI,cham-soc-nha-cua,53892508,"Nước rửa chén diệt khuẩn cao cấp trà xanh Lion 1,2L Hàn Quốc - Nước rửa chén Organic",99000,129000,30000,23
TIKI,cham-soc-nha-cua,10160055,"Túi Viên Giặt Xả 3D Gel Ball Tiện Dụng (44 Viên) - Nội Địa Nhật Bản",245000,319000,74000,23
TIKI,cham-soc-nha-cua,123243049,"Combo 5 Giấy ăn Slisoft Vàng x 450 tờ Đa Năng, Khăn Giấy Rút, Không Chất Tẩy Trắng An Toàn Cho Cả Gia Đình",86000,90000,4000,4
TIKI,cham-soc-nha-cua,142708105,"SÁP THƠM KHỬ MÙI KHÁNG KHUẨN HƯƠNG TỰ NHIÊN ĐỂ TỦ QUẦN ÁO, NHÀ VỆ SINH, PHÒNG TẮM",14000,14000,0,0
TIKI,cham-soc-nha-cua,206294371,"Gel rửa bát Finish hữu cơ 900ml",339000,339000,0,0
TIKI,cham-soc-nha-cua,100930363," Thuốc diệt rắn Superior Snake Killer Non - Toxic Odourless (250g)",744000,744000,0,0
TIKI,cham-soc-nha-cua,137804513,"Xịt Tinh Dầu Đuổi Muỗi Sả Nguyên Chất Giúp Chống Muỗi, An Toàn Cho Bé, Thơm Phòng, Khử Mùi - 100ml",90000,90000,0,0
TIKI,cham-soc-nha-cua,173589579,"Chai xịt đa năng tẩy rửa nhà bếp",45000,45000,0,0
TIKI,cham-soc-nha-cua,42134749,"Chai xịt tẩy rửa mảng bám siêu năng Rinrei hàng Nhật nội địa (mảng bám cháy khét trên xong nồi, thiết bị nhà bếp..)",94500,94500,0,0
TIKI,cham-soc-nha-cua,25735935,"Nước rửa chén sinh học Greenlife 4L",159500,159500,0,0
TIKI,cham-soc-nha-cua,160650589,"Nước tẩy trắng quần áo 600ml Rocket Nhật Bản",34500,34500,0,0
TIKI,cham-soc-nha-cua,205293117,"Nước làm bóng Finish 1150ml, dung dịch dầu làm bóng bát finish dùng cho máy rửa bát chén 1150ml, 800ml, 750ml, 1500ml",127900,127900,0,0
TIKI,cham-soc-nha-cua,152495005,"Nước giặt Good Care hương hoa hồng 1,8L",91630,130900,39270,30
TIKI,cham-soc-nha-cua,56306017,"Nước xịt rửa kính đa năng Sifa vệ sinh nhà cửa cao cấp 650ml",44000,44000,0,0
TIKI,cham-soc-nha-cua,166008221,"Bút tẩy vết bẩn quần áo siêu tốc Bully:",27550,29000,1450,5
TIKI,cham-soc-nha-cua,92353437,"Thuốc diệt kiến gián sinh học",4700,4700,0,0
TIKI,cham-soc-nha-cua,176629233,"Gel thơm khử trùng bồn cầu gel khử mùi bồn cầu dạng thạch hình bông hoa tạo mùi thơm cho toilet",14000,14000,0,0
TIKI,cham-soc-nha-cua,262072958,"Nước giặt xả hữu cơ Bồ Hòn tinh dầu Hoa Bưởi ECOCARE 2 lít - Bền màu, giữ dáng, làm mềm vải, an toàn da nhạy cảm",204000,210000,6000,3
TIKI,cham-soc-nha-cua,75517994,"Combo Vi Sinh Khử Mùi EcoFresh, EcoClean Septic - Xử Lý Mùi Hôi Hiệu Quả",417000,417000,0,0
TIKI,cham-soc-nha-cua,33160687,"Nước Lau Kính Hando Hương Quế 600ml",27000,27000,0,0
TIKI,cham-soc-nha-cua,122576724,"Gói Hút Ẩm 1KG quy cách 10/20/50/100/200/500/1000gram Silicagel - hạt hút ẩm quần áo giày dép máy ảnh",71000,71000,0,0
TIKI,cham-soc-nha-cua,49636456,"Khăn giấy ăn Oulu 3 lớp, sợi tre tự nhiên siêu dai, thấm hút tốt, thân thiện với môi trường, bảo vệ tài nguyên rừng - Thùng 30 gói 240 tờ - Màu vàng",469000,469000,0,0
TIKI,cham-soc-nha-cua,80877095,"Dung dịch tẩy rửa vết rỉ sét Selleys RP7 300g (Xanhlá)",88000,88000,0,0
TIKI,cham-soc-nha-cua,194959332,"Chất nước tẩy rửa giàn lạnh, điều hòa, lồng máy giặt - Dung dịch tẩy rửa điều hoà, giàn máy lạnh, lồng máy giặt",106000,106000,0,0
TIKI,cham-soc-nha-cua,167420997,"Viên tẩy lồng giặt công nghệ mới diệt khuẩn 99% và tẩy sạch cặn máy giặt",3186,3186,0,0
TIKI,cham-soc-nha-cua,143321367," Khăn giấy rút lau tay đa năng , Cuộn 120 miếng ,  dày mềm dai và thấm hút tốt",30999,30999,0,0
TIKI,cham-soc-nha-cua,115643526,"Khăn giấy 2 lớp Ellemoi 180 tờ",35000,35000,0,0
TIKI,cham-soc-nha-cua,51854845,"Combo 2 chai nước làm bóng finish 1150ml dùng cho máy rửa bát chén ",449999,899998,449999,50
TIKI,cham-soc-nha-cua,175167978,"GIẤY VỆ SINH CUỘN LỚN PRIME (0.8KG) 2 LỚP - COMBO 2 CUỘN",70000,70000,0,0
TIKI,cham-soc-nha-cua,161257076,"Xịt Thơm Quần Áo - Nước Xả Vải Khô Lâm Đại Phúc Lưu Hương Bền Lâu Chai 100ml",45500,45500,0,0
TIKI,cham-soc-nha-cua,73329551,"Long Não thơm TYTY gói 100g-Khử mùi,đuổi côn Trùng",12000,12000,0,0
TIKI,cham-soc-nha-cua,172686628,"Combo 2 Nước giặt Lix Matic hương nước hoa chai 3.6 lít",224000,224000,0,0
TIKI,cham-soc-nha-cua,174300155,"Chai tẩy vết xước sàn nhà, gạch men 260ml",246000,246000,0,0
TIKI,cham-soc-nha-cua,107693403,"Nước lau sàn Fuwa3e hữu cơ organic sả chanh khử mùi đuổi muỗi kiến diệt nấm mốc 100ml",15000,15000,0,0
TIKI,cham-soc-nha-cua,172686611,"Nước giặt Lix Matic hương nước hoa chai 3.6 lít",117000,117000,0,0
TIKI,cham-soc-nha-cua,145613742,"Nước Rửa Chén Bát Sunlight Extra Khử Mùi Tanh Matcha Trà Nhật 2.1kg",69000,69000,0,0
TIKI,cham-soc-nha-cua,191320689,"Nước Giặt Hương Hoa Surf 3,1L-3,5L",130000,130000,0,0
TIKI,cham-soc-nha-cua,162024572,"Sáp thơm khử mùi phòng ngủ tủ quần áo hương thơm tự nhiên bền lâu (Tặng thanh dũa móng tay ngẫu nhiên)",80000,80000,0,0
TIKI,cham-soc-nha-cua,6391635,"Combo 3 chai tẩy diệt khuẩn bồn cầu, toilet Hương Lavender Mr.Fresh Korea 180g",117000,117000,0,0
TIKI,cham-soc-nha-cua,179949978,"Nước Rửa Chén Sinh Học Cô Cà Chua Mới Toanh 2L An Toàn Cho Bé Bảo Vệ Da Tay",288000,288000,0,0
TIKI,cham-soc-nha-cua,121326343,"viên rửa chén bát finish maxin1 cao cấp chuyên dùng cho máy ( 12 trong 1) xuất xứ Mỹ",258900,258900,0,0
TIKI,cham-soc-nha-cua,68474228,"Nước lau sàn Hữu cơ Ecocare đuổi muỗi tinh dầu Quế 2000ml",128000,160000,32000,20
TIKI,cham-soc-nha-cua,107238001,"Combo 8 gói Khăn giấy rút lụa Hà Nội Silk ngắn 150 tờ",114400,114400,0,0
TIKI,cham-soc-nha-cua,195659497,"Nước giặt xả Booster can 3,7 kg hương hoa tự nhiên giặt sạch, lưu hương lâu(24_48h)",125000,125000,0,0
TIKI,cham-soc-nha-cua,2154899,"Gói tẩy vệ sinh lồng giặt 70g nội địa Nhật Bản ",32500,32500,0,0
TIKI,cham-soc-nha-cua,171944777,"Nước thơm lau sàn nhà Hando 1L hương Sả",25000,25000,0,0
TIKI,cham-soc-nha-cua,167031270,"Hộp nhử, dẫn dụ mối đảm bảo hiệu quả",30000,30000,0,0
TIKI,cham-soc-nha-cua,4214933,"Kem cọ xoong nồi Hàn Quốc ",18595,18595,0,0
TIKI,cham-soc-nha-cua,190318840,"Bột giặt Lix Extra đậm đặc 5.5Kg ED557 - Tẩy sạch vết bẩn cực mạnh",175000,175000,0,0
TIKI,cham-soc-nha-cua,53837083,"combo viên rửa bát finish 85 viên+muối rửa bát finish 1,2kg dùng cho máy rửa chén bát",399000,399000,0,0
TIKI,cham-soc-nha-cua,72711979,"Nước thông cống 1L xuất khẩu",42000,42000,0,0
TIKI,cham-soc-nha-cua,152550114,"Sáp thơm khử mùi Good Care hương Lily",38500,55000,16500,30
TIKI,cham-soc-nha-cua,70931241,"Giấy Lau Nhà Hòa Tan Thay Thế Nước Lau Sàn HOMI Mã HS01 Với Công Nghệ Nhật Bản Hương Thơm Dịu Nhẹ, Sạch Bóng Sàn Nhà Chỉ Với Một Miếng Giấy [Combo 02 Túi]",29000,29000,0,0
TIKI,cham-soc-nha-cua,49636466,"Khăn giấy ăn Dulu 3 lớp, sợi tre tự nhiên siêu dai, thấm hút tốt, thân thiện với môi trường, bảo vệ tài nguyên rừng - Túi 3 gói 390 tờ 190*153mm- Màu vàng",49000,49000,0,0
TIKI,cham-soc-nha-cua,170148114,"Gel khử mùi bồn cầu Tienich247, gel tẩy bồn cầu dạng thạch hình bông hoa",13399,13399,0,0
TIKI,cham-soc-nha-cua,205293598,"Gel rửa chén bát Finish Eco 0% - 900ml/ chai",339000,339000,0,0
TIKI,cham-soc-nha-cua,10153639,"Nước Tẩy Ố Vùng Tay Và Cổ Áo Sơ Mi - Nội Địa Nhật Bản",173000,173000,0,0
TIKI,cham-soc-nha-cua,85063270," Long não thơm 100g (hương Hồng, Lavender, Chanh, Vani)",17000,17000,0,0
TIKI,cham-soc-nha-cua,55474428,"Xịt làm sạch đá tự nhiên, đá cẩm thạch Stanhome Marble Cleaner 250ml",254000,299000,45000,15
TIKI,cham-soc-nha-cua,12351024,"Nước hoa xịt thơm phòng Auramax 300ml hương Lemon (chanh)",69300,69300,0,0
TIKI,cham-soc-nha-cua,124276083,"Bộ 12 Viên Tẩy Làm Sạch Và Khử Mùi Lồng Máy Giặt",14999,14999,0,0
TIKI,cham-soc-nha-cua,195536599,"[CHỌN MÙI HƯƠNG] Gel Thơm Làm Sạch Khử Mùi Vệ Sinh Diệt Khuẩn Khử Trùng Bồn Cầu Hình Bông Hoa - Hàng Chính Hãng",35000,59000,24000,41
TIKI,cham-soc-nha-cua,207013218,"Bột rửa bát Finish 4.5kg / hộp",899000,899000,0,0
TIKI,cham-soc-nha-cua,168503631,"Chai Xịt Tẩy Rửa Bếp Kitchen Cleaner Tẩy Sạch Vết Bẩn Mùi Thơm Dễ Chịu, Bình xịt vệ sinh bếp bọt tuyết đa năng",29998,29998,0,0
TIKI,cham-soc-nha-cua,90509164,"Combo 30 viên tẩy bồn cầu",17800,17800,0,0
TIKI,cham-soc-nha-cua,99085997,"Bộ 16 Viên Tẩy Vệ Sinh Khử Mùi Bồn Cầu Homes Queen Hàn Quốc",368000,400000,32000,8
TIKI,cham-soc-nha-cua,120170788,"Bột thông tắc cống, Toilet, Bồn rửa bát, Chậu rửa mặt – Xử lý tắc nghẽn đường ống, bồn cầu cực mạnh – Khử mùi hôi GD002",17900,17900,0,0
TIKI,cham-soc-nha-cua,101855986,"xịt ĐUỔI MUỖI,xịt THƠM PHÒNG  OASIS NATURAL (hàng Thái)",45000,45000,0,0
TIKI,cham-soc-nha-cua,13376361,"Nước Giặt Quần Áo Dành Cho Da Dị Ứng, Da Khô Và Da Nhạy Cảm (Hàng Nội Địa Nhật Bản) - Chai 1200ml",285000,285000,0,0
TIKI,cham-soc-nha-cua,114788860,"Hộp 12 Viên Tẩy Rửa Vệ Sinh Lồng Giặt Diệt Khuẩn Khử Mùi Tẩy Cặn Bẩn Máy Giặt Cửa Trước Ngang Trên Đứng Tại Nhà",35000,35000,0,0
TIKI,cham-soc-nha-cua,166594818,"Combo 04 Bột Rửa Chén Bát Hương Chanh Finish Classic Power Powder Lemon Sparkle chai 1 kg",1190000,1190000,0,0
TIKI,cham-soc-nha-cua,86143131,"Nước xả vải Pigeon Hàn Quốc chai 2.5L",115000,115000,0,0
TIKI,cham-soc-nha-cua,126765340,"Chai xịt diệt khuẩn khử mùi toilet, bồn cầu, nhà vệ sinh, nhà tắm Nano Xclean Toilet Spray 500ML - AHT Corp (AHTC)",89100,148500,59400,40
TIKI,cham-soc-nha-cua,122511911,"Gói Hút Ẩm 20 Gram đóng gói  500Gram Silicagel - hạt hút ẩm thực phẩm quần áo giày dép máy ảnh hoa khô",11000,11000,0,0
TIKI,cham-soc-nha-cua,205493280,"bán lẻ 1kg Bột rửa bát alio dùng cho máy rửa bát chén",159000,159000,0,0
TIKI,cham-soc-nha-cua,97872676,"BỘT RỬA BÁT SINH HỌC SATOS - 1.5kg, Sạch cho bát, tốt cho sức khỏe. DÀNH CHO CÁC LOẠI MÁY RỬA BÁT",218000,218000,0,0
TIKI,cham-soc-nha-cua,78887226,"Combo 3 Túi thơm treo quần áo kèm móc treo",15000,15000,0,0
TIKI,cham-soc-nha-cua,19347174,"Combo máy xịt phòng tự động CẢM BIẾN ÁNH SÁNG + Bình nước hoa xịt phòng Hommax Hàn Quốc",390000,390000,0,0
TIKI,cham-soc-nha-cua,172587040,"nước rửa bát cho máy rửa chén bát Fuwa3e hữu cơ sinh học dạng gel 500ml",135000,135000,0,0
TIKI,cham-soc-nha-cua,4243817,"Bộ máy xịt phòng tự động kèm chai xịt phòng cao cấp Sandokkaebi Hàn Quốc 300ml (Màu máy xịt và mùi hương ngẫu nhiên)",247500,247500,0,0
TIKI,cham-soc-nha-cua,206288718,"Viên Rửa Chén Bát Ludwik 30 viên - Dùng Cho Máy Rửa Bát (30 Viên)",245000,245000,0,0
TIKI,cham-soc-nha-cua,916414,"Bộ Máy Xịt Phòng Tự Động Auramax AU 10 + Chai Xịt Phòng Auramax Hương Lemon",426000,426000,0,0
TIKI,cham-soc-nha-cua,25746233,"Combo 2 chai 870ml Vim Diệt Khuẩn Trắng Sáng Hương Chanh Sả Dịu Mát",72000,72000,0,0
TIKI,cham-soc-nha-cua,122568298,"Túi hút ẩm silicagel xanh 1000 Gram tặng kèm túi vải hút ẩm máy ảnh linh kiện điện tử Phòng Ngủ Quần áo Giày dép",35000,35000,0,0
TIKI,cham-soc-nha-cua,102567316,"Xịt Khử Mùi Gốc Thực vật (Thuộc nhóm Sản phẩm Lành tính / Hữu cơ) Chai Xịt 150ml",76950,81000,4050,5
TIKI,cham-soc-nha-cua,91258477,"Nước rửa chén diệt khuẩn KAO Kyukyutto Clear 1380mL nội địa Nhật - Hương chanh",175000,175000,0,0
TIKI,cham-soc-nha-cua,170945059,"Viên rửa bát Finish Power Cube Nhật Bản (túi 150 viên) dành cho máy rửa bát",104000,104000,0,0
TIKI,cham-soc-nha-cua,179937230,"Nước Giặt Cô Cà Chua Mới Toanh Công Nghệ Mới An Toàn Nhẹ Dịu Cho Da 2L",278000,278000,0,0
TIKI,cham-soc-nha-cua,82685988,"Nước xả vải Downy Nắng mai Dây 10 gói",20000,20000,0,0
TIKI,cham-soc-nha-cua,181926835,"Thuốc xịt đuổi muỗi Hương Thảo Mộc Sinh Học ",43000,43000,0,0
TIKI,cham-soc-nha-cua,84794032,"Nước lau bàn khử mùi hương quế Hando 500ml",32000,32000,0,0
TIKI,cham-soc-nha-cua,205485477,"Muối Finish 1.5kg+Viên rửa bát Finish 110 viên (Đức) dùng cho máy rửa chén bát",489000,489000,0,0
TIKI,cham-soc-nha-cua,186111342,"NƯỚC XẢ VẢI GOOD CARE 3L",106400,152000,45600,30
TIKI,cham-soc-nha-cua,35236518,"Bột thông cống Hando cực mạnh 100g tiện ích",20000,20000,0,0
TIKI,cham-soc-nha-cua,169331009,"Khăn giấy ăn 3 lớp, sợi tre tự nhiên dai hơn, thấm hút tốt, thân thiện với môi trường, bảo vệ tài nguyên rừng - Thùng 40 gói 390 tờ/ 3 lớp",599000,599000,0,0
TIKI,cham-soc-nha-cua,161029052,"Nước lau sàn quế Fuwa3e hữu cơ đuổi muỗi diệt khuẩn đậm đặc 1L",95000,95000,0,0
TIKI,cham-soc-nha-cua,58290561,"Tẩy Dầu Mỡ  Bám Két Lưới Lọc Máy Hút Mùi Chai 1 Lít",160300,229000,68700,30
TIKI,cham-soc-nha-cua,96277957,"Xịt Khuẩn Khử Mùi Không Gian Nano Ariewa 250ml",60000,60000,0,0
TIKI,cham-soc-nha-cua,191605532,"Nước rửa bát sinh học đậm đặc bạc hà Harmonie Verte 1L",198000,198000,0,0
TIKI,cham-soc-nha-cua,59504157,"Combo 02 Chai tẩy rửa, vệ sinh  lồng máy giặt Nhật Bản Ultra Powers 550g",130000,130000,0,0
TIKI,cham-soc-nha-cua,48135843,"Túi 60 viên rửa chén Finish Quantum Max Dishwasher Tablets Lemon PTT025460 - hương chanh",384000,776000,392000,51
TIKI,cham-soc-nha-cua,17903110,"Nước lau sàn Layer Clean hương Quế 1,25L",36000,36000,0,0
TIKI,cham-soc-nha-cua,172372182,"Nước Cọ Rửa Toilet Gốc Thực Vật Peace Mass Tinh dầu Quế Công nghệ Enzyme (Thuộc nhóm Sản phẩm Lành tính / Hữu cơ) Chai Xit 700ml",94050,99000,4950,5
TIKI,cham-soc-nha-cua,10047421,"Combo Hộp Khử Mùi Tủ Lạnh Hương Trà Xanh Nhật Bản (150g)",69500,69500,0,0
TIKI,cham-soc-nha-cua,164058717,"Hộp Hút Ẩm Khử Mùi Chống Ẩm Mốc 500ml",35000,35000,0,0
TIKI,cham-soc-nha-cua,191654243,"Nước rửa chén bát, ly tách Lipon F 3600ml Không mùi - Hàng Thái Lan",160000,160000,0,0
TIKI,cham-soc-nha-cua,179934997,"Nước Giặt Xả Cô Cà Chua Mới Toanh Giặt Máy Thơm Sạch Thân Thiện 500ml",78000,78000,0,0
TIKI,cham-soc-nha-cua,74850687,"Gel Fedios-Duo khử mùi tủ lạnh – Thức Ăn Luôn Tươi Ngon & Sạch Thuần Khiết",89000,89000,0,0
TIKI,cham-soc-nha-cua,181808807,"Chai Diệt Muỗi MAP PERMETHRIN 50EC Chai Nhôm 1L, 500ml - Từ Anh Quốc, Tiêu Diệt Côn Trùng Sâu Bệnh",155000,155000,0,0
TIKI,cham-soc-nha-cua,126135377,"Tinh dầu cheo Finish khử mùi, tạo hương thơm cho máy rửa bát chén – Nhập khẩu tại Đức",99000,99000,0,0
TIKI,cham-soc-nha-cua,6287197,"Combo 2 hộp 18 viên nước giặt xả hương hoa màu xanh nội địa Nhật Bản",205000,267000,62000,23
TIKI,cham-soc-nha-cua,171283408,"CHAI TẨY QUẦN ÁO X5000 PLUS,  GIÚP QUẦN ÁO SẠCH NHƯ MỚI",39000,39000,0,0
TIKI,cham-soc-nha-cua,195328181,"Túi nước giặt 50ml SPY DEEP CLEAN PLUS khử mùi diệt khuẩn, sạch sâu, thơm lâu giúp làm mềm vải",8800,10000,1200,12
TIKI,cham-soc-nha-cua,61984321,"Nước rửa chén hữu cơ Bồ hòn Ecocare - 100% thực vật, không hóa chất, tinh dầu khử mùi, chăm sóc da tay, tiết kiệm nước 30% - Mẫu mới 2020 - Quế",415000,415000,0,0
TIKI,cham-soc-nha-cua,120061075,"GIẤY VỆ SINH 6 CUỘN PRIME 3 LỚP (1KG) CÓ LÕI - COMBO 2 DÂY MÀNG XANH",82000,82000,0,0
TIKI,cham-soc-nha-cua,118709704,"Gói 30 viên băng phiến long não khử mùi,xua đuổi côn trùng 120Gr(Thiên Nhiên)",20000,20000,0,0
TIKI,cham-soc-nha-cua,169422441,"Tẩy Mốc Quần Áo Thái Lan HN5750 Quần Áo Màu và quần áo trắng Cao Cấp -Phân Phối Chính Thức",25000,25000,0,0
TIKI,cham-soc-nha-cua,50178637,"Khăn giấy ăn - Giấy lụa Oulu 3 lớp - Combo 10 gói Dai hơn, Không mủn trong nước, Mềm mịn dùng được cho da em bé, Hàng chính hãng 100%",160000,160000,0,0
TIKI,cham-soc-nha-cua,56229344,"Chai Xịt Tẩy Keo Dính Đa Năng Trên Mọi Bề Mặt 450ml Cao Cấp AZONE",35000,35000,0,0
TIKI,cham-soc-nha-cua,104647507,"Bình Xịt kháng khuẩn, Khử Mùi Dành Cho Gia Đình_ Asfa Home Fresh 250m",108000,108000,0,0
TIKI,cham-soc-nha-cua,104401606,"GIẤY VỆ SINH 3 LỚP PRIME (1,8KG) CÓ LÕI - MÀNG BONG BÓNG",80000,80000,0,0
TIKI,cham-soc-nha-cua,188686691,"Combo Túi Nước Lau Sàn 3.6kg Ngàn hoa ngọt ngào + Túi Nước Giặt Xả MaxKleen 3.8kg Vườn Sớm Mai",256000,284000,28000,10
TIKI,cham-soc-nha-cua,66930562,"Bàn chải cọ vệ sinh bồn cầu toilet silicon siêu sạch nhanh sâu mền mại cọ sạch mọi ngóc ngách tay cầm dài chắc chắn dọn vệ sinh phòng tắm ( Giao màu ngẫu nhiên )",25000,50000,25000,50
TIKI,cham-soc-nha-cua,195961665,"Gel Rửa Bát Chuyên Dụng Cho Máy Hương Chanh Bạc Hà All in One Dish Gel Lemon Mint Stanhome (720ml) - 18154",369550,389000,19450,5
TIKI,cham-soc-nha-cua,180225477,"Nước Giặt Quần Áo Cô Cà Chua Yêu Nước 500ml",62000,62000,0,0
TIKI,cham-soc-nha-cua,117557332,"Giấy ăn lụa, khăn giấy rút cao cấp 2 lớp 1 gói 300 tờ",10000,10000,0,0
TIKI,cham-soc-nha-cua,3470709,"Nước Lau Sàn S.P.Ca 4.5 Lít -  Hương Bạc Hà & Dầu Thông",97600,122000,24400,20
TIKI,cham-soc-nha-cua,94583239,"Chổi quét nhà từ tính kèm thùng đựng rác đa năng KumiaWase Japan ",767000,767000,0,0
TIKI,cham-soc-nha-cua,10838384,"Xịt Phòng Hương Nước Hoa Sandokkaebi 300ml nhập khẩu Hàn Quốc",68500,68500,0,0
TIKI,cham-soc-nha-cua,4472661,"Túi 18 viên giặt xả 3D Gel Ball (2 trong 1) nội địa Nhật Bản",105000,105000,0,0
TIKI,cham-soc-nha-cua,127438753,"Nước làm bóng Finish Eco 0% 400ml",169000,169000,0,0
TIKI,cham-soc-nha-cua,186106374,"NƯỚC GIẶT GOOD CARE 3L",159320,227600,68280,30
TIKI,cham-soc-nha-cua,206289474,"Viên Rửa Bát Ludwik 50 viên - Dùng Cho Máy Rửa Bát chén 50v",274000,274000,0,0
TIKI,cham-soc-nha-cua,57358894,"Nước khử mùi, kháng khuẩn ASFA dành cho kênh HORECA",325000,325000,0,0
TIKI,cham-soc-nha-cua,121326786,"Thuốc diệt chuột Nhật Bản Dethmor hộp 4 vỉ",109000,109000,0,0
TIKI,cham-soc-nha-cua,4215329,"Nuớc thông cống 1L Nội Địa",35000,35000,0,0
TIKI,cham-soc-nha-cua,48568700,"Thùng 3 Can Nước Lau Sàn Sunlight Tinh Dầu Thiên Nhiên - Hương hoa Lily (3.8kg/Chai)",278000,278000,0,0
TIKI,cham-soc-nha-cua,13781346,"Combo 02 hộp viên diệt gián nhanh chóng hàng nội địa Nhật Bản (12 viên/ hộp)",54000,54000,0,0
TIKI,cham-soc-nha-cua,136631421,"EcoClean 4XFHC - Vi Sinh Xử Lý Mùi Hôi Chuồng Trại, Bãi Rác, Nước Thải, Hầm Tự Hoại  - Chai 1 lít",385000,385000,0,0
TIKI,cham-soc-nha-cua,6515561,"Combo 5 Hộp Hút Ẩm Khử Mùi Nấm Mốc Hương Lavender 450Ml",154000,154000,0,0
TIKI,cham-soc-nha-cua,68132343,"Bộ 2 hộp Sáp thơm phòng khử mùi an toàn, hiệu quả PureAroma 230g- nhiều mùi lựa chọn",78000,78000,0,0
TIKI,cham-soc-nha-cua,150567570,"Bình Xịt Thơm Phòng Glade Nature Hương Lavender 280g",65000,65000,0,0
TIKI,cham-soc-nha-cua,2612001,"Nước rửa chén Lipon 3.6L",140000,140000,0,0
TIKI,cham-soc-nha-cua,173989768,"Nút bịt xả cặn đáy bình nước nóng năng lượng mặt trời thái dương năng",75000,75000,0,0
TIKI,cham-soc-nha-cua,121327167,"Viên Rửa Bát Finish Nhật Gói 150 Viên .100 VIÊN",125000,125000,0,0
TIKI,cham-soc-nha-cua,190353593,"Bột giặt Lix đậm đặc hương nước hoa 5.5Kg PD575 - Khử mùi ẩm mốc",175000,175000,0,0
TIKI,cham-soc-nha-cua,169296273,"Nước rửa chén bát siêu sạch Mr Fresh 1,6L Tinh Dầu Gừng",46000,46000,0,0
TIKI,cham-soc-nha-cua,16552150,"Nước rửa bát Layer Clean hương quế 800ml ",33000,33000,0,0
TIKI,cham-soc-nha-cua,2612357,"Hộp 5 túi hút ẩm khử mùi hương thơm Hando (50g/túi)",52000,52000,0,0
TIKI,cham-soc-nha-cua,169904054,"Viên tẩy bồn cầu/ viên thả nước bồn cầu diệt khuẩn/ 10 viên",15740,15740,0,0
TIKI,cham-soc-nha-cua,153981814,"Gel khử mùi bồn cầu hình hoa (và hình cookie), gel bồn cầu hoa , khử mùi toilet",14000,14000,0,0
TIKI,cham-soc-nha-cua,172581999,"Nước Tẩy Rửa Bồn Cầu Okay Pink Toilet Cleaner Thái Lan 960ml Siêu Mạnh Chỉ Cần 1 Lần Tẩy",32105,32105,0,0
TIKI,cham-soc-nha-cua,6515527,"Combo 3 Hộp Hút Ẩm Khử Mùi Nấm Mốc Hương Lavender 450Ml",95000,95000,0,0
TIKI,cham-soc-nha-cua,124963611,"[HCM] Gel rửa chén bát Finish Eco 0% - 900ml/ chai",339000,339000,0,0
TIKI,cham-soc-nha-cua,137478310,"Combo 2 Sáp Thơm Glade Hương Hoa Lài 180gx2",119000,119000,0,0
TIKI,cham-soc-nha-cua,102860214,"Nước tẩy xóa vết xước gạch đa năng LCB 260ml",58000,58000,0,0
TIKI,cham-soc-nha-cua,36678026,"Bình Xịt Tẩy Nấm Mốc Tường Nhà, Phòng Tắm ,Nhà Bếp LKB 500ml Tặng Kèm Khẩu Trang Y Tế Cao Cấp AZONE",65000,65000,0,0
TIKI,cham-soc-nha-cua,12351052,"Nước hoa xịt thơm phòng Auramax 300ml hương CK (nước hoa CK)",69300,69300,0,0
TIKI,cham-soc-nha-cua,85064488,"Bộ 6 chai tẩy vệ sinh bồn cầu hương Lavender TI497",179000,179000,0,0
TIKI,cham-soc-nha-cua,3554671,"Dung dịch tẩy rửa vệ sinh bếp từ cao cấp 300g nội địa Nhật Bản",65000,65000,0,0
TIKI,cham-soc-nha-cua,261798912,"Chất tẩy rửa dàn nhôm COIL-KLEEN 5 lít",332500,350000,17500,5
TIKI,cham-soc-nha-cua,48555909,"Combo 02 can  Nước giặt xả July 2X Pink Sweet - 3500ml (Hồng)",342500,342500,0,0
TIKI,cham-soc-nha-cua,127458144,"Xịt nhà bếp tinh dầu 24CARE 50ml/100ml/250ml - Xịt lau chùi bếp, bề mặt bị dính bẩn, diệt bề mặt dính vi khuẩn, không khí chứa vi khuẩn",35000,47000,12000,26
TIKI,cham-soc-nha-cua,150938160,"Combo Sản Phẩm Gốc Thực Vật NGB5 Peace Mass - Nước Giặt Xả 2 in 1 3.6l+ Nước Rửa Chén 3.6l + Nước Lau Sàn TD Chanh Sả - Bạc Hà 3.6l(Thuộc nhóm Sản phẩm Lành tính / Hữu cơ)",632700,666000,33300,5
TIKI,cham-soc-nha-cua,767334,"Thuốc Diệt Kiến Trong 1 Ngày Sạch Kiến Không Quay Lại Hanvet",26999,26999,0,0
TIKI,cham-soc-nha-cua,32795406,"Combo 10 viên tẩy bồn cầu siêu sạch",11000,11000,0,0
TIKI,cham-soc-nha-cua,83751236,"Combo (2 hộp) Viên Tẩy Lồng Máy Giặt - Vệ Sinh Máy Giặt, Diệt Sạch Vi Khuẩn, Vệ Sinh Lồng Máy Giặt Và Khử Mùi Hiệu Quả - Dạng Sủi Xuất Xứ Nhật Bản",29938,29938,0,0
TIKI,cham-soc-nha-cua,7691655,"1 thùng 6 hộp viên nước giặt Gelball hương ngàn hoa 3D (2 trong 1) tặng Nhật Bản",569000,569000,0,0
TIKI,cham-soc-nha-cua,175779421,"Combo 5 Hộp Khăn Giấy Tempo Neutral 3 Lớp (90 Tờ/1 Hộp x 5)",190000,190000,0,0
TIKI,cham-soc-nha-cua,916422,"Bộ Máy Xịt Phòng Tự Động Auramax AU 10 + Chai Xịt Phòng Auramax Hương Potpourri",426000,426000,0,0
TIKI,cham-soc-nha-cua,73314826,"Viên thả khử mùi bồn tiểu đứng (dành cho nam) 15g - Nhập khẩu Nhật Bản",39500,39500,0,0
TIKI,cham-soc-nha-cua,205293858,"Hộp 51 viên rửa chén Finish Quantum Ultimate (Công thức mới 2020) – Hàng siêu cao cấp với 14x tính năng trong 1 viên (Dành cho máy rửa chén 13-14-15 bộ)",340955,358900,17945,5
TIKI,cham-soc-nha-cua,152508519,"Nước giặt Good Care hương ngàn hoa 1,8L",91630,130900,39270,30
TIKI,cham-soc-nha-cua,37885576,"Muối rửa bát Finish 1.2kg / hộp",92331,92331,0,0
TIKI,cham-soc-nha-cua,82092074,"Nước thông cống Hando 570ml nội địa",28000,28000,0,0
TIKI,cham-soc-nha-cua,147496394,"Nước Lau Kính Sáng Bóng Chống Bám Bẩn - ECO VIEW - Chai 500ml",60000,60000,0,0
TIKI,cham-soc-nha-cua,124273215,"Túi Thơm Nụ Hoa Khô Lavender Pháp",17900,17900,0,0
TIKI,cham-soc-nha-cua,171101399,"Bình xịt tẩy dầu mỡ bếp TVS 600ML loại mạnh nhất, tẩy dầu mỡ cáu két lâu ngày trên hút mùi, xoong nồi, bếp ăn, bếp công nghiệp",99000,149000,50000,34
TIKI,cham-soc-nha-cua,126246436," Dung Dịch Làm Sạch Đồ Nội Thất- Đồ Nhựa- DENKMIT, chai vòi xịt 500ml",190000,190000,0,0
TIKI,cham-soc-nha-cua,125724819,"[Nhập khẩu Đức] Xịt tẩy rửa phòng tắm 750ml, Badreiniger Total Zitrus, 750 ml, cho phòng tắm sạch bóng như mới.",210000,210000,0,0
TIKI,cham-soc-nha-cua,6515545,"Combo 4 Hộp Hút Ẩm Khử Mùi Nấm Mốc Hương Lavender 450Ml",127000,127000,0,0
TIKI,cham-soc-nha-cua,51843401,"Combo 3 hộp muối rửa bát finish 1,5kg (3x1.5=4.5kg)",357000,729250,372250,51
TIKI,cham-soc-nha-cua,12749273,"Nước hoa xịt thơm phòng Iscent 300ml",82000,82000,0,0
TIKI,cham-soc-nha-cua,193904044,"Chất khử khuẩn CLORAMIN B xuất xứ Tiệp Khắc (CH Séc) túi 1 Kg, vệ sinh nhà cửa, phòng chống dịch bệnh.",350000,350000,0,0
TIKI,cham-soc-nha-cua,51525888,"Hóa chất lau sàn đá Ecosophy ",399000,399000,0,0
TIKI,cham-soc-nha-cua,118719863,"Combo 2 gói bột thông tắc bồn cầu bể phốt Hando 300Gr [Chỉ dùng cho hầm cầu bể phốt không dùng cho đường ống]",59000,59000,0,0
TIKI,cham-soc-nha-cua,70658460,"Bột rửa chén ROCKET kháng khuẩn khử mùi 1KG dùng cho máy rửa chén Nội địa NHẬT BẢN",163000,163000,0,0
TIKI,cham-soc-nha-cua,128948669,"Nước Lau Sàn Nhà Nano Bạc Xclean Light 5L/4L AHT Corp - Làm Sạch Sàn Nhà An Toàn Hiệu Quả Hương Thơm Tự Nhiên",198000,220000,22000,10
TIKI,cham-soc-nha-cua,127457276,"Treo khử mùi máy rửa bát Finish hương chanh",99000,99000,0,0
TIKI,cham-soc-nha-cua,68521887,"Viên rửa bát Finish Eco 0% - 70 viên/ hộp",550000,550000,0,0
TIKI,cham-soc-nha-cua,48282708,"Bột Thông Cống Cực Mạnh-268g-TVS55-Hạt Trắng",22999,22999,0,0
TIKI,cham-soc-nha-cua,54866386,"Men vi sinh SIFA xử lí hầm cầu siêu tốc , chống hôi 5 phút - HÀNG CHÍNH HÃNG ",49000,49000,0,0
TIKI,cham-soc-nha-cua,51597449,"Combo 2 cục sáp thơm Renuzit Scent Swirls Vanila 198g",80000,80000,0,0
TIKI,cham-soc-nha-cua,169271514,"[Nhập khẩu Đức] NƯỚC GIẶT XẢ ĐỒ LEN, KHĂN LỤA, CHĂN LÔNG DENKMIT 1,5L, GIÚP ĐỒ KHĂN LỤA NHÀ BẠN LUÔN THƠM MÁT, MỀM MẠI.",230000,230000,0,0
TIKI,cham-soc-nha-cua,6714845,"Combo 5 Hộp Hút Ẩm Khử Mùi Nấm Mốc Hương Hồng 450Ml ",154000,154000,0,0
TIKI,cham-soc-nha-cua,118443302,"Bình xịt vệ sinh điều hòa máy lạnh Hàn Quốc 330ml-Tự làm tại nhà dễ sử dụng",109000,109000,0,0
TIKI,cham-soc-nha-cua,72031041,"Chai nước thông cống  1500g",75000,75000,0,0
TIKI,cham-soc-nha-cua,197516073,"Túi Thơm Treo Tủ Quần Áo Túi Thơm Phòng Có Móc Treo Tiện Lợi 6 Loại Hương Thảo Mộc Thiên Nhiên",25000,45000,20000,44
TIKI,cham-soc-nha-cua,193878899,"Chai tẩy xịt rửa đa năng vệ sinh bếp Kitchen 500ml ,tẩy các chất bẩn cứng đầu,  hương chanh thơm mát dịu dàng ",48510,49000,490,1
TIKI,cham-soc-nha-cua,248776334,"Túi viên giặt xả OMO tiện lợi công nghệ Anh Quốc (17 viên/Túi)",105000,125300,20300,16
TIKI,cham-soc-nha-cua,4071853,"Hộp khử mùi ngăn tủ bếp hương trà xanh nội địa Nhật Bản",38500,38500,0,0
TIKI,cham-soc-nha-cua,134773554,"HÀNG CAO CẤP Combo 3 hộp nước hoa khô dạng sáp",80000,80000,0,0
TIKI,cham-soc-nha-cua,80981002,"Dung dịch làm sạch canxi vách tắm,nhà kính lâu ngày SMART TK 500ml (hàng chính hãng )",225500,225500,0,0
TIKI,cham-soc-nha-cua,120522829,"Combo 10 Viên Thả Bồn Cầu Toilet Khử Mùi Diệt Khuẩn",12300,12300,0,0
TIKI,cham-soc-nha-cua,205666029,"Nước làm bóng (dầu bóng ) chuyên dùng cho máy rửa chén ly bát",113700,113700,0,0
TIKI,cham-soc-nha-cua,121101318,"Combo 500g than hoạt tính + 2 miếng vải cacbon khử mùi",115000,115000,0,0
TIKI,cham-soc-nha-cua,52397524,"Bột rửa bát  Finish túi 2,2kg dùng cho máy rửa chén bát",388900,777800,388900,50
TIKI,cham-soc-nha-cua,168369954," Combo 2 hộp Viên rửa bát Somat All-in-1 Extra 25 viên",330000,330000,0,0
TIKI,cham-soc-nha-cua,4987013,"Hộp Khử Mùi Toilet Hương Chanh Kobini Nhật Bản (200mlNhật Bản",42000,42000,0,0
TIKI,cham-soc-nha-cua,174637725,"Tinh dầu ASA Ratpel - 600ml",85000,110000,25000,23
TIKI,cham-soc-nha-cua,71338623,"Muối rửa bát Finish 1,5 kg",125000,125000,0,0
TIKI,cham-soc-nha-cua,205492102,"Bột Rửa Bát Alio 1,8kg / túi - Bột rửa bát nhật bản 2.2kg dùng cho máy rửa bát",299000,299000,0,0
TIKI,cham-soc-nha-cua,176684495,"Hạt xả thơm quần áo, viên xả thơm quần áo thơm cực lâu, lưu hướng và làm mềm vải",17998,17998,0,0
TIKI,cham-soc-nha-cua,173718801,"Muối làm mềm nước Finish 1.2kg dùng cho máy rửa chén bát",110700,110700,0,0
TIKI,cham-soc-nha-cua,10124720,"Chai Tẩy Rửa Baking Soda (Dạng Xịt) 300ml - Nội Địa Nhật Bản",68500,68500,0,0
TIKI,cham-soc-nha-cua,205413542,"Viên rửa bát Finish Classic 100 viên/ hộp (hương chanh)",299000,299000,0,0
TIKI,cham-soc-nha-cua,29098165,"Chất tẩy rửa lồng máy giặt Rocket 550g",38500,38500,0,0
TIKI,cham-soc-nha-cua,133418855,"Combo Viên rửa bát Finish nhật 100 viên + 750ml nước làm bóng finish",399000,399000,0,0
TIKI,cham-soc-nha-cua,100868286,"Làm Sạch Dầu Mỡ Lâu Ngày SMART CLEANER - Tẩy Sạch Dầu Mỡ Trong 5 Phút Không Cần Cọ Rửa - MIFAN Phân Phối Chính Hãng",130000,130000,0,0
TIKI,cham-soc-nha-cua,133775971,"Combo Viên rửa bát Finish eco 40 viên + Bóng finish hữu cơ 400ml",511670,538600,26930,5
TIKI,cham-soc-nha-cua,36999470,"Xịt Thơm Phòng Febreze Spring & Renewal 250g",130000,130000,0,0
TIKI,cham-soc-nha-cua,121414261,"Set nước rửa bát lá ổi 3 món cực hấp dân : can 3.68 lit, chai 450ml và nước rửa tay 450mm",359000,359000,0,0
TIKI,cham-soc-nha-cua,9441620,"Nước Rửa Rau Quả Và Chén Bát CJ Lion Real Green Tinh Chất Than Hoạt Tính 1.2kg",102000,133000,31000,23
TIKI,cham-soc-nha-cua,114733133,"Máy Khử Mùi Tủ Lạnh Có Thể Sạc Lại Tiện Dụng Cho Nhà Bếp Ôt Tủ Giày, Tủ Quần Áo",379000,379000,0,0
TIKI,cham-soc-nha-cua,188662791,"KHỬ MÙI TỦ LẠNH, HÚT MÙI TỦ LẠNH than tre hoạt tính chống hôi khử khuẩn an toàn sức khỏe được tin dùng tại các nước",39000,39000,0,0
TIKI,cham-soc-nha-cua,102680799,"Nước làm sạch khử mùi máy giặt Glisten 354ml",168000,168000,0,0
TIKI,cham-soc-nha-cua,8056197,"Nước rửa chén bát 3,5L Mr Fresh siêu sạch",89000,89000,0,0
TIKI,cham-soc-nha-cua,52483038,"Muối Finish 1.5kg+Viên rửa bát Finish 110 viên (Đức) dùng cho máy rửa chén bát",468999,468999,0,0
TIKI,cham-soc-nha-cua,144541231,"Nước khử trùng khử khuẩn HOCL chai xịt 500ml",45000,45000,0,0
TIKI,cham-soc-nha-cua,39304599,"Chai xịt tẩy rửa bồn cầu Rocket 300ml - Hàng nội địa Nhật Bản",42500,42500,0,0
TIKI,cham-soc-nha-cua,16378975,"Tinh dầu ASA Lakae - Xua đuổi côn trùng",56000,76000,20000,26
TIKI,cham-soc-nha-cua,2152989,"Nước giặt đồ lót và tẩy các vết bẩn siêu mạnh KOSE 200ml  - Nội địa Nhật Bản",100000,100000,0,0
TIKI,cham-soc-nha-cua,35860279,"Thuốc muỗi không mùi Ferdona FMC 10EC (100ml) Diệt muỗi suốt 4 tháng",67848,67848,0,0
TIKI,cham-soc-nha-cua,126672815,"COMBO FINISH: Viên rửa bát Classic 90 viên + Muối 1,2kg + Bóng 750ml",519000,519000,0,0
TIKI,cham-soc-nha-cua,121326988,"Thuốc diệt kiến Super Arinosu Koroki Nhật bản vỉ 2 hộp xuất xứ Nhật Bản",130000,130000,0,0
TIKI,cham-soc-nha-cua,100867801,"Bộ cây lau nhà tự vắt thông minh, chổi lau nhà tự vắt cao cấp - 2 miếng lau - MOP Z9",485000,485000,0,0
TIKI,cham-soc-nha-cua,105340705," Bộ 6 hộp hút ẩm &  khử mùi than hoạt tính Mr Fresh - Korea 256g",210000,210000,0,0
TIKI,cham-soc-nha-cua,49247824,"Nước Giặt Perwoll Wool & Delicates 1,5L dành cho đồ len, đồ mỏng - Đức",175000,175000,0,0
TIKI,cham-soc-nha-cua,8261237,"Combo Nước tẩy vệ sinh lồng máy giặt Rocket + Miếng dán bẫy chuột nội địa Nhật Bản",79000,79000,0,0
TIKI,cham-soc-nha-cua,186452448,"Hộp khử mùi tủ lạnh than hoạt tính - nội địa Nhật Bản",39500,39500,0,0
TIKI,cham-soc-nha-cua,72905073,"Combo 2 túi viên rửa bát Finish Quantum Max 100 viên (100*2=200 viên)",1150000,1150000,0,0
TIKI,cham-soc-nha-cua,10121190,"Nước rửa chén, bát hương bưởi 600ml ",29000,39000,10000,26
TIKI,cham-soc-nha-cua,54567012,"Viên rửa bát finish 110 viên+1150ml Nước làm bóng bát Finish dùng cho Máy rửa bát",589000,589000,0,0
TIKI,cham-soc-nha-cua,54711509,"Muối rửa bát Alio 2kg",185000,185000,0,0
TIKI,cham-soc-nha-cua,75970302,"Chai xịt Bioion Deo-Sanitizer 500ML khử mùi, làm sạch vật dụng gia đình",250000,250000,0,0
TIKI,cham-soc-nha-cua,121048834,"Nước lau sàn hương Quế An An, chai 1 lít - Khử mùi đuổi muỗi và côn trùng, thảo mộc thiên nhiên",75000,75000,0,0
TIKI,cham-soc-nha-cua,180031964,"Nước Rửa Chén Sinh Học Cô Cà Chua Mới Toanh An Toàn Cho Bé Bảo Vệ Da Tay 3.8L",488000,488000,0,0
TIKI,cham-soc-nha-cua,68300265,"Nước rửa chén hữu cơ Bồ hòn Ecocare tinh dầu Vỏ Cam 4000ml",415000,450000,35000,8
TIKI,cham-soc-nha-cua,102763454,"1 Gói Thuốc Diệt Chuột Dạng Cốm Thế Hệ Mới - Gói 50 Gam",30000,30000,0,0
TIKI,cham-soc-nha-cua,180301528,"Khăn giấy ăn Oulu 3 lớp, sợi tre tự nhiên siêu dai, thấm hút tốt, thân thiện với môi trường, bảo vệ tài nguyên rừng - Túi 3 gói 390 tờ 190*153mm- Màu vàng",49000,49000,0,0
TIKI,cham-soc-nha-cua,48122021,"Dung dịch tẩy rửa máy rửa chén Finish Dishwasher Cleaner 2x250ml QT04440",179000,179000,0,0
TIKI,cham-soc-nha-cua,58441622,"Bộ 2 chai nước hoa xịt phòng cao cấp Mr Fresh 500ml - khử mùi phòng, ẩm mốc, hạn chế côn trùng ruồi muỗi",69000,69000,0,0
TIKI,cham-soc-nha-cua,22823070,"Nước rửa bát đậm đặc Mr.fresh hương quế 800ml",24000,24000,0,0
TIKI,cham-soc-nha-cua,102882413,"Combo 7 chai Nước hoa xịt phòng Mr Fresh 500ml - thơm lâu, khử mùi ẩm mốc, đuổi côn trùng",245000,245000,0,0
TIKI,cham-soc-nha-cua,58828245,"COMBO 2 CHAI NƯỚC RỬA BÁT LAYER CLEAN : HƯƠNG QUẢ HỒNG 800ML +  HƯƠNG QUẾ 800ML",72000,72000,0,0
TIKI,cham-soc-nha-cua,213723919,"chất tẩy canxi ,xi măng ,chất tẩy đa năng vương triều",89000,89000,0,0
TIKI,cham-soc-nha-cua,176788205,"Bột Khử Khuẩn Sát Trùng CLORAMIN B Tiệp Khắc - 1kg",350000,350000,0,0
TIKI,cham-soc-nha-cua,153773370,"4 Cốc Thả Bồn Cầu Thuỷ Tinh Hàn Quốc diệt khuẩn và làm thơm 180g/cốc",149000,149000,0,0
TIKI,cham-soc-nha-cua,58290876,"Tẩy Cặn Canxi Ố Loang Trên Vách Kính  Tắm Sabo-K Chai 1 lít",299000,590000,291000,49
TIKI,cham-soc-nha-cua,59361032,"Combo 2 miếng khử mùi, diệt khuẩn máy rửa chén Finish Dishwasher Freshener Lemon",159000,159000,0,0
TIKI,cham-soc-nha-cua,169905546,"Gel thơm khử trùng bồn cầu - gel khử mùi bồn cầu dạng thạch hình bông hoa",29999,29999,0,0
TIKI,cham-soc-nha-cua,2604871,"Gói bột thông tắc hầm cầu M. phốt 200g Hando",19000,19000,0,0
TIKI,cham-soc-nha-cua,7989166,"Combo Hộp thơm phòng hương hoa hồng nội địa Nhật Bản",79000,79000,0,0
TIKI,cham-soc-nha-cua,119645520,"Siêu tẩy dầu mỡ Dr.C chính hãng ( TẶNG Lau kính Dr.C chính hãng)",145000,145000,0,0
TIKI,cham-soc-nha-cua,121326334,"viên rửa bát Finish Nhật 150 viên x 5 g ( Nhật Bản )",99000,99000,0,0
TIKI,cham-soc-nha-cua,6257005,"Combo 5 chai tẩy diệt khuẩn bồn cầu, toilet hương Ngàn Hoa Mr.Fresh Korea 180g",185000,185000,0,0
TIKI,cham-soc-nha-cua,109397839,"THUỐC DIỆT MỐI, PHÒNG MỐI MYTHIC 240SC - BASF ĐỨC",1600000,1600000,0,0
TIKI,cham-soc-nha-cua,39376857,"Combo 2 hộp Viên rửa bát và làm bóng cao cấp Somat All in 1 Extra 10 Multi - AKTIV 25 Viên - Đức",305000,305000,0,0
TIKI,cham-soc-nha-cua,122516775,"Gói Hút Ẩm 10 Gram đóng gói  1000Gram Silicagel - hạt hút ẩm thực phẩm quần áo giày dép máy ảnh hoa khô",21000,21000,0,0
TIKI,cham-soc-nha-cua,119645511,"Siêu tẩy dầu mỡ Dr.C CHÍNH HÃNG - đánh bay vết bẩn cứng đầu ( 500 ml )",132000,132000,0,0
TIKI,cham-soc-nha-cua,11553405,"Combo 2 Hộp Sáp Thơm Glade Laveder (180g/ Hộp)",110000,110000,0,0
TIKI,cham-soc-nha-cua,59483271,"Thông tắc Cồng cực mạnh 5 phút siêu nhanh thế hệ mới SIFA 800g thể tích thực 450ml cao cấp",55000,55000,0,0
TIKI,cham-soc-nha-cua,58678227,"Miếng dán sinh thái khử mùi rác TOWA Nội địa Nhật Bản",49000,49000,0,0
TIKI,cham-soc-nha-cua,188384247,"Keo dạng gel miết mạch gạch men, nhà tắm, nhà bếp màu trắng",80000,80000,0,0
TIKI,cham-soc-nha-cua,102545538,"Dung dịch vệ sinh máy rửa bát Finish hương chanh 250ml Finish EU",99000,99000,0,0
TIKI,cham-soc-nha-cua,102882637,"Combo 4 chai Nước hoa xịt phòng Mr Fresh 500ml - thơm lâu, khử mùi ẩm mốc, đuổi côn trùng",140000,140000,0,0
TIKI,cham-soc-nha-cua,76366698,"Set 3 Xịt xử lý vết bẩn trước khi giặt Stanhome Pre Wash Ecolabel 500ml/chai- mẫu mới",680000,777000,97000,12
TIKI,cham-soc-nha-cua,6320743,"Combo 8 Hộp Bột thông cống Hando 100g Xuất khẩu",150000,150000,0,0
TIKI,cham-soc-nha-cua,102513210,"Gói hút ẩm Kokubo 25g dùng để hút ẩm trong tủ quần áo, giày, đồ điện tử...vv - xuất xứ Nhật Bản",36500,36500,0,0
TIKI,cham-soc-nha-cua,206152841,"combo 3 chai Nước làm bóng bát finish 800ml dùng cho máy",399000,399000,0,0
TIKI,cham-soc-nha-cua,205480419,"COMBO FINISH: Viên rửa bát Finish Classic 110 viên + Muối 1,2kg + Nước làm bóng 750ml",569000,569000,0,0
TIKI,cham-soc-nha-cua,126517706,"Chai thả bồn cầu khử mùi diệt khuẩn Hàn Quốc - GDHN Loại Tốt",37800,37800,0,0
TIKI,cham-soc-nha-cua,206255450,"Viên rửa bát Finish Quantum 60 viên hương táo chanh - 14 chức năng",399000,399000,0,0
TIKI,cham-soc-nha-cua,58204441,"Combo 03 can giặt xả siêu sạch July 2X 3500ml -  Hàng Thái Lan nhập khẩu",519500,519500,0,0
TIKI,cham-soc-nha-cua,10124187,"Nước Tẩy Rửa Nhà Vệ Sinh Không Mùi 500ml - Nội Địa Nhật Bản",33000,33000,0,0
TIKI,cham-soc-nha-cua,79166469,"Set 100 Túi Lưới Lọc Rác Cho Bồn Rửa Chén",33000,33000,0,0
TIKI,cham-soc-nha-cua,121327111,"viên rửa chén finish quantum túi 120 viên (hàng Đức )Viên rửa bát chén siêu cao cấp",790000,790000,0,0
TIKI,cham-soc-nha-cua,14423203,"Bánh Xà Phòng Giặt Cổ Áo, Ống Tay Nhật Bản 100g (Không Cần Dùng Bàn Chải)",32000,32000,0,0
TIKI,cham-soc-nha-cua,916450,"Bộ 6 Chai Nước Hoa Xịt Phòng Auramax Hương CK",415800,415800,0,0
TIKI,cham-soc-nha-cua,2612445,"Bộ 2 hộp 10 gói hút ẩm khử mùi hương thơm Hando (50g/túi)",95000,95000,0,0
TIKI,cham-soc-nha-cua,128785095,"Hộp 12 Viên Tẩy Vệ Sinh Lồng Máy Giặt, Diệt Khuẩn Và Tẩy Chất Cặn Lồng Máy Giặt Hiệu Quả - Hàng Chất Lượng",15000,15000,0,0
TIKI,cham-soc-nha-cua,119334172,"Treo khử mùi hôi trong máy rửa bát Finish",99000,99000,0,0
TIKI,cham-soc-nha-cua,117285784,"Hộp hút ẩm 450mL( hàng nội địa nhật)",45000,45000,0,0
TIKI,cham-soc-nha-cua,186536769,"Hạt Giặt Viên Lưu Hương Quần Áo Xả Vải Hương Thơm Lâu Phai Có Nhiều Mùi G387-HatThom",17999,17999,0,0
TIKI,cham-soc-nha-cua,6714863,"Combo 4 Hộp Hút Ẩm Khử Mùi Nấm Mốc Hương Hồng 450Ml",129000,129000,0,0
TIKI,cham-soc-nha-cua,27526194,"Nước giặt xả 2in1 APLUS Thái lan 3.5L hương Hoa hồng - Hàng nhập khẩu (Mẫu mới đậm đặc gấp 3 lần)",185000,241000,56000,23
TIKI,cham-soc-nha-cua,206254341,"Viên rửa bát Finish Quantum 60 viên hương thường",399000,399000,0,0
TIKI,cham-soc-nha-cua,127446115,"Gel rửa bát Finish Classic  1.5 lít",319000,319000,0,0
TIKI,cham-soc-nha-cua,124948910,"[HCM] Muối rửa chén Finish Dishwasher Salt 4kg",269000,269000,0,0
TIKI,cham-soc-nha-cua,96094328,"THUỐC DIỆT GIÁN",57000,57000,0,0
TIKI,cham-soc-nha-cua,112509437,"combo 10 lọ diệt kiến gián sinh học",40000,40000,0,0
TIKI,cham-soc-nha-cua,49366552,"Nước lau kính siêu sạch sáng bóng Hando 680ml Tinh dầu Hương Quế",29000,29000,0,0
TIKI,cham-soc-nha-cua,102530985,"Bột rửa chén bát Finish Deep Clean hương chanh 2,5 kg Finish EU",530000,530000,0,0
TIKI,cham-soc-nha-cua,119374290,"Combo rửa bát Finish: Dung dịch vệ sinh máy rửa bát chai 250ml, Bóng 400ml, Muối hộp 1,5kg - Nhập khẩu Châu Âu.",297200,297200,0,0
TIKI,cham-soc-nha-cua,58580099,"Muối rửa bát Finish Dishwasher Salt 4kg QT017389",255360,268800,13440,5
TIKI,cham-soc-nha-cua,87707820," Bộ 2 vỉ 4 viên tẩy bồn cầu Hando RCB117",48000,48000,0,0
TIKI,cham-soc-nha-cua,9999850,"Sáp thơm phòng Hando (300g) - hương jeans màu tím",46000,46000,0,0
TIKI,cham-soc-nha-cua,10103609,"Hộp Khử Mùi Ngăn Đá Tủ Lạnh Than Hoạt Tính - Nội Địa Nhật Bản",36500,36500,0,0
TIKI,cham-soc-nha-cua,121326182,"Viên rửa chén bát Finish Quantum túi 64 . 60. 50 .36 viên",289000,289000,0,0
TIKI,cham-soc-nha-cua,121326982,"Muối rửa bát Finish Muối làm mềm nước Finish loại 4kg ,1,2kg",99000,99000,0,0
TIKI,cham-soc-nha-cua,38116491,"Combo 3 Chai Nước Tẩy Quần Áo Rocket Soap 600ml",108500,108500,0,0
TIKI,cham-soc-nha-cua,119645522,"Siêu tẩy dầu mỡ Dr.C CHÍNH HÃNG - đánh bay vết bẩn cứng đầu (Chai lớn 5L tiết kiệm)",550000,550000,0,0
TIKI,cham-soc-nha-cua,186677672,"Chai Xịt Đuổi Chuột",55000,55000,0,0
TIKI,cham-soc-nha-cua,90476642,"Thuốc diệt kiến gián sinh học tận gốc",12000,12000,0,0
TIKI,cham-soc-nha-cua,916454,"Bộ 6 Chai Nước Hoa Xịt Phòng Auramax Hương Potpourri",415800,415800,0,0
TIKI,cham-soc-nha-cua,176481005,"Chai xịt tẩy rửa đa năng Kitchen Cleaner 500ml - tẩy rửa nhà bếp, xịt tẩy bếp ga, xoong nồi, mặt bàn bếp, máy hút mùi...",21999,21999,0,0
TIKI,cham-soc-nha-cua,193733645,"Chai Xịt Tẩy Rửa Vệ Sinh Bồn Cầu Cực Mạnh Hương Nước Hoa Anh Đào, Khử Khuẩn, Siêu Sạch Không Độc Hại 500ml",22000,22000,0,0
TIKI,cham-soc-nha-cua,4375061,"Set 12 hộp diệt gián tận gốc hiệu quả ngay tức thì - Nội địa Nhật Bản",44000,44000,0,0
TIKI,cham-soc-nha-cua,121316272,"Viên vệ sinh máy rửa bát Finish vỉ 3 viên - Chính hãng ",99000,99000,0,0
TIKI,cham-soc-nha-cua,54644441,"Lau sàn siêu tẩy Q-FLOOR - can 4 lít - AVCOchem - Q-SPEC",243000,243000,0,0
TIKI,cham-soc-nha-cua,205293835,"Bán lẻ 1kg Bột rửa bát Alio dùng thử cho máy rửa bát",159000,159000,0,0
TIKI,cham-soc-nha-cua,54535664,"Viên rửa bát Finish Nhật 60 viên / túi",150000,150000,0,0
TIKI,cham-soc-nha-cua,3265073,"Chất Thông Cầu Sumo Hộp (175g)",35000,35000,0,0
TIKI,cham-soc-nha-cua,95732967,"Viên rửa bát Finish All in 1 Max ECO 0% - 70 viên / túi",698899,698899,0,0
TIKI,cham-soc-nha-cua,121326009,"Viên rửa bát Alio Classic 100 viên Đức",109000,109000,0,0
TIKI,cham-soc-nha-cua,7473823,"Nước thông tắc đường ống Hando 570ml Nội địa",25000,25000,0,0
TIKI,cham-soc-nha-cua,53029080,"Viên rửa Chén Tổng Hợp Finish 100 Tabs Dùng Cho Máy Rửa Bát",336800,336800,0,0
TIKI,cham-soc-nha-cua,14106985,"Dung dịch làm bóng chén bát cho máy rửa bát Ludwik 500ml",119000,119000,0,0
TIKI,cham-soc-nha-cua,4300345,"Combo 2 chai nước tẩy vệ sinh lồng máy giặt  nội địa Nhật Bản",65000,65000,0,0
TIKI,cham-soc-nha-cua,168321231,"Nước rửa chén Mr.Fresh 4,2L Hàn Quốc hương Chanh Tây",95000,95000,0,0
TIKI,cham-soc-nha-cua,1988569,"Bột baking soda Sesuki 500g (tẩy trắng) Rocket nội địa Nhật Bản",89000,89000,0,0
TIKI,cham-soc-nha-cua,122910328,"VIÊN RỬA BÁT FINISH 150 VIÊN NHẬT BẢN",101970,101970,0,0
TIKI,cham-soc-nha-cua,186494604,"CHAI XỊT ĐUỔI RUỒI KINCHO 300ML/CHAI",150360,179000,28640,16
TIKI,cham-soc-nha-cua,50251913,"Hóa chất tẩy rửa đa năng Ecosophy số 1 tại Nhật Bản",499000,499000,0,0
TIKI,cham-soc-nha-cua,4987059,"Dung Dịch Vệ Sinh Bếp Từ Cao Cấp Kaneyo Kobini Nhật Bản (300g)",99000,99000,0,0
TIKI,cham-soc-nha-cua,206294376,"Gel rửa chén Finish Eco 0% 900ml",339000,339000,0,0
TIKI,cham-soc-nha-cua,2541385,"Chai xịt tẩy rửa đồ dùng nhà bếp 300ml Rocket nội địa Nhật Bản",37500,37500,0,0
TIKI,cham-soc-nha-cua,162150524,"Combo Finish Eco : Gel rửa bát Eco 900ml + Bóng Eco 400ml + Muối 1,5kg",595000,1213600,618600,51
TIKI,cham-soc-nha-cua,121326579,"Nước làm bóng Alio 1000ml MẪU MỚI 2020",175000,175000,0,0
TIKI,cham-soc-nha-cua,225268464,"Hàng Mỹ - Vi Sinh Xử Lý Hầm Cầu, Bể Phốt, Tự Hoại - Bio Septic - Chai Gallon = 3,785 Lít",900000,900000,0,0
TIKI,cham-soc-nha-cua,105320340,"Combo 6 Sáp thơm Pure Aroma 220g",250000,250000,0,0
TIKI,cham-soc-nha-cua,10005081,"Sáp thơm phòng Hando 87g 5 Hương Thơm Tùy Chọn",18000,18000,0,0
TIKI,cham-soc-nha-cua,144181050,"Sáp thơm Glade 180g toả hương 30 ngày",53500,53500,0,0
TIKI,cham-soc-nha-cua,209869021,"Viên tẩy lồng máy giặt",7000,7000,0,0
TIKI,cham-soc-nha-cua,112834677,"Nước làm bóng Finish 1150ml - Nhập khẩu châu Âu",229000,229000,0,0
TIKI,cham-soc-nha-cua,46060664,"Combo 2 chai xịt tẩy nhà bếp và nhà vệ sinh",47046,53900,6854,13
TIKI,cham-soc-nha-cua,150938330,"Combo Sản Phẩm Gốc Thực Vật LSB2 Peace Mass - Nước Lau Sàn TD Chanh Sả - Bạc Hà 3.6l + Nước Rửa Tay 340ml (Thuộc nhóm Sản phẩm Lành tính / Hữu cơ)",247950,261000,13050,5
TIKI,cham-soc-nha-cua,5992317,"Nước hoa xịt phòng khử mùi Hando 200ml Hương Hồng",20000,20000,0,0
TIKI,cham-soc-nha-cua,4473781,"Combo 10 Viên Tẩy Bồn Cầu",13000,13000,0,0
TIKI,cham-soc-nha-cua,185245149,"Viên giặt xả kháng khuẩn PERSIL  4in1 Nội địa ĐỨC",132000,132000,0,0
TIKI,cham-soc-nha-cua,108808578,"Bàn chải cọ toilet từ xơ dừa hàng Nhật",43500,43500,0,0
TIKI,cham-soc-nha-cua,51931693,"Combo muối rửa bát Finish 1,5kg+viên rửa bát Finish 120 viên+Nước làm bóng bát chén finish 800ml",618000,1200000,582000,49
TIKI,cham-soc-nha-cua,19963117,"Bột tẩy đa năng Astonish C9630",139000,139000,0,0
TIKI,cham-soc-nha-cua,205293903,"Nước làm bóng Finish 1150ml - Nhập khẩu châu Âu",159000,159000,0,0
TIKI,cham-soc-nha-cua,205508494,"Gel rửa bát Finish Classic 1,5 lit - Nhập khẩu EU",295000,295000,0,0
TIKI,cham-soc-nha-cua,95335569,"Chai xịt làm sạch đánh bóng inox 3M stainless steel cleaner polish 59158",280000,280000,0,0
TIKI,cham-soc-nha-cua,73314678,"Combo 03 Viên thả khử mùi bồn tiểu đứng (dành cho nam) 15g - Nhập khẩu Nhật Bản",120000,120000,0,0
TIKI,cham-soc-nha-cua,6320613,"Combo 5 Hộp Bột thông cống Hando 100g Xuất khẩu",90000,90000,0,0
TIKI,cham-soc-nha-cua,77158553,"Nước xả vải Downy Chuyên dụng Huyền bí (Đen) Can khổng lồ 8.5L",539000,539000,0,0
TIKI,cham-soc-nha-cua,273017006,"Nước Giặt BLUE Hàn Quốc 2100ml, Hương Nước Hoa, Hương Thảo Mộc",71000,71000,0,0
TIKI,cham-soc-nha-cua,192074801,"Hương Muỗi, Nhang Muỗi, Diệt Côn Trùng An Toàn Siêu Hiệu Quả",15000,15000,0,0
TIKI,cham-soc-nha-cua,576012,"Bột Giặt Surf Nước Hoa Gold Duyên Dáng (5.5kg / Gói)",159000,159000,0,0
TIKI,cham-soc-nha-cua,141996383,"Túi Nước Giặt Xả MaxKleen Thiên Nhiên 3.6kg",185000,210000,25000,12
TIKI,cham-soc-nha-cua,150938071,"Combo Sản Phẩm Gốc Thực Vật NGB4 Peace Mass Nước Giặt Xả 2 in 1 3.6 l + Nước Lau Sàn TD Chanh Sả -Bạc Hà 3.6l (Thuộc nhóm Sản phẩm Lành tính / Hữu cơ)",470250,495000,24750,5
TIKI,cham-soc-nha-cua,196574182,"Combo 2 Chai xịt chuột thái land rat off 200ml",105000,105000,0,0
TIKI,cham-soc-nha-cua,170915542,"Combo 10 gói Giấy rút lụa hàng Việt Nam 3 lớp 300 tờ siêu dai mềm mịn Misy Home",89000,89000,0,0
TIKI,cham-soc-nha-cua,192790333,"Nước rửa chén siêu sạch chanh 3,6kg NS360 sạch bóng vết dầu mỡ hương chanh thơm mát ",99000,99000,0,0
TIKI,cham-soc-nha-cua,137479330,"COMBO 02 Nước Giặt Surf Hồng túi 2.8L",239000,239000,0,0
TIKI,cham-soc-nha-cua,49905256,"Nước Lau Sàn Diệt Khuẩn Mao Bao Hương Hoa Hồng chai 1000ml",39000,45000,6000,13
TIKI,cham-soc-nha-cua,146173458,"Nước xịt tẩy rửa đa năng nhà tắm, bếp, vòi nước",30290,30290,0,0
TIKI,cham-soc-nha-cua,51252373,"Nước tẩy quần áo Sawady Oxygen 450ml sạch an toàn vải",25000,25000,0,0
TIKI,cham-soc-nha-cua,205883206,"Muối Rửa Bát Finish 1,2kg - Hàng Nhập Khẩu Đức",111397,111397,0,0
TIKI,cham-soc-nha-cua,125759499,"[Nhập khẩu Đức] Xịt vệ sinh tủ lạnh hữu cơ 250ml, Hygienereiniger Kühlschrank mit Bio-Alkohol, 250 ml, cho tủ lạnh luôn thơm sạch.",250000,250000,0,0
TIKI,cham-soc-nha-cua,176664201,"COMBO TÚI NƯỚC GIẶT XẢ + NƯỚC LAU SÀN BAN MAI THANH MÁT 2.4KG/ 2.2KG + 600G",137000,170000,33000,19
TIKI,cham-soc-nha-cua,169217970,"Túi Hút Ẩm, Gói Hút Ẩm Chống Mốc Có Móc Treo Tủ Quần Áo",9000,9000,0,0
TIKI,cham-soc-nha-cua,68169294,"Xịt Phòng Tinh Dầu Ngọc Lan Tây Hữu Cơ Organic  24Care 50ML/100ML - Kháng khuẩn - Khử mùi hôi - Đuổi muỗi, côn trùng - Tạo không gian lãng mạn, hẹn hò - Hương thơm thư giãn",74000,99000,25000,25
TIKI,cham-soc-nha-cua,172279568,"1 thùng khăn giấy ướt vịt vàng 10 gói kèm thùng nhựa siêu tiện dụng đáng yêu",98000,98000,0,0
TIKI,cham-soc-nha-cua,85064427,"Nước thơm lau sàn nhà Hando can 20L (Hương quế)",345000,345000,0,0
TIKI,cham-soc-nha-cua,193733652,"Chai Xịt Tẩy Rửa Vệ Sinh Bồn Cầu Cực Mạnh Hương Nước Hoa Anh Đào, Khử Khuẩn, Siêu Sạch Không Độc Hại 500ml",21999,21999,0,0
TIKI,cham-soc-nha-cua,92355558,"HANTOX 200 loại 50ml Diệt côn trùng , muỗi, gián, kiến, ruồi, bọ chét...",40000,40000,0,0
TIKI,cham-soc-nha-cua,121326826,"Hộp Tẩy Lồng Giặt 60 viên",223500,223500,0,0
TIKI,cham-soc-nha-cua,31885136,"Nước giặt Surf hương cỏ hoa diệu kỳ can 3.8kg",149000,149000,0,0
TIKI,cham-soc-nha-cua,178336838,"Vua Nấm Bệnh - Sương Mai, Thán thư, Vàng Lá, Thối Rễ - Gói 30Gr",17000,17000,0,0
TIKI,cham-soc-nha-cua,197102613,"Bột giặt Lix Extra hương hoa 9kg EB010 làm sạch mọi vết bẩn cứng đầu khử mùi ẩm mốc cho giặt tay và máy ",245000,245000,0,0
TIKI,cham-soc-nha-cua,82833873,"COMBO 6 dây Nước Xả Vải Downy Nắng mai 10 gói x6",119000,119000,0,0
TIKI,cham-soc-nha-cua,179512945,"Combo 2 Túi Viên Giặt Xả Đa Năng 4 Trong 1 KA Universal (40 Viên/ Túi)",590000,738000,148000,20
TIKI,cham-soc-nha-cua,205293856,"Nước làm bóng Finish 400ml",99000,99000,0,0
TIKI,cham-soc-nha-cua,122910036,"Muối rửa chén Finish 4.0kg",99000,99000,0,0
TIKI,cham-soc-nha-cua,188879156,"Nước tẩy vết gỉ sét, cặn khoáng chất , nấm mốc hương chanh bạc hà hữu cơ Planet Pure 510ml",282000,282000,0,0
TIKI,cham-soc-nha-cua,154134533,"[Hàng Nhập khẩu Đức] Nước tẩy rửa inox dùng cho bồn rửa bát, dụng cụ nấu ăn bằng inox Edelstahreiniger 300ml, đánh bay các vết bẩn trên inox_Hàng chính hãng",150000,150000,0,0
TIKI,cham-soc-nha-cua,76470182,"[Nguyên thùng] COMBO 3 túi Nước xả vải Downy Huyền bí 3.5LX3",627000,627000,0,0
TIKI,cham-soc-nha-cua,36560727,"Kem Tẩy Rửa Đa Năng Nhà Bếp Oven Cookware Cleaner 500g Cao Cấp AZONE",24999,24999,0,0
TIKI,cham-soc-nha-cua,48613591,"Túi Than Hoạt Tính Diệt Khuẩn Khử Mùi Lọc Không Khí Cho Phòng Khách, Ngủ, Nhà Vệ Sinh",179000,179000,0,0
TIKI,cham-soc-nha-cua,189472591,"Combo muối rửa bát Finish 1,5kg+viên rửa bát Finish 120 viên+Nước làm bóng bát chén finish 800ml",634000,634000,0,0
TIKI,cham-soc-nha-cua,150826315,"Khăn ướt tẩm cồn Let green hộp 50 miếng",50000,50000,0,0
TIKI,cham-soc-nha-cua,163570189,"Giấy Rút Tình Nhân MyLan 3 Lớp (450 Tờ/Gói, 4 Gói/Xách)",80000,80000,0,0
TIKI,cham-soc-nha-cua,166626005,"Combo 05 túi Viên Rửa Chén Bát Hương Chanh Finish Powerball All In 1 Max Lemon Sparkle 30 viên",798900,798900,0,0
TIKI,cham-soc-nha-cua,49895455,"Combo 3 Vỉ Tẩy Vệ Sinh Khử Mùi Bồn Cầu Homes Queen Hàn Quốc",125000,149000,24000,16
TIKI,cham-soc-nha-cua,84795772,"Bột tẩy cặn canxi ấm đun nước, cây nước, bình nước nóng lạnh 100g Hando",29000,29000,0,0
TIKI,cham-soc-nha-cua,53214727,"Tinh dầu xịt phòng Warmer hỗ trợ diệt khuẩn, khử mùi giày, mùi ô tô, mùi toilet, mùi phòng hiệu quả",60000,100000,40000,40
TIKI,cham-soc-nha-cua,42808839,"Gói bột tẩy rửa thông tắc đường ống chậu rửa, Lavabo - Nội địa Nhật",43600,43600,0,0
TIKI,cham-soc-nha-cua,105311998,"Combo 4 Sáp thơm khử mùi Pure Aroma 230g (đào-dứa-vani-black ice)",156000,156000,0,0
TIKI,cham-soc-nha-cua,172190734,"Muối rửa bát Finish hộp 1,5kg - Dùng cho máy rửa bát",159000,159000,0,0
TIKI,cham-soc-nha-cua,2153113,"Chai nước tẩy trắng vùng cổ, tay áo KOSE 500ml - Nội địa Nhật Bản",95000,95000,0,0
TIKI,cham-soc-nha-cua,205325655,"Muối rửa Bát - Ly Somat 1.2kg - Đức",49000,49000,0,0
TIKI,cham-soc-nha-cua,48040392,"Muối rửa chén Finish Dishwasher Salt 1,5kg PTT017383",122000,156800,34800,22
TIKI,cham-soc-nha-cua,249858366,"Nước Giặt Binky 3,1kg Hương Nước Hoa",97000,97000,0,0
TIKI,cham-soc-nha-cua,117397330,"Xịt làm sạch bếp nướng BBQ, lò sưởi Stanhome Fireplace & BBQ Cleaner 500ml",255000,299000,44000,15
TIKI,cham-soc-nha-cua,109967928,"Sáp lau sạch đa năng làm sạch như ghế da 206740",51600,74000,22400,30
TIKI,cham-soc-nha-cua,140746600,"Viên rửa bát Finish Quantum 60 viên hương táo chanh - 14 chức năng",368228,368228,0,0
TIKI,cham-soc-nha-cua,191767378,"Viên rửa bát ludwik hộp 50 viên",299000,299000,0,0
TIKI,cham-soc-nha-cua,100067216,"Cô Cà Chua sạch tuốt 4L - Mùi Quế",410000,410000,0,0
TIKI,cham-soc-nha-cua,120069309,"GIẤY ĂN GIẤY VUÔNG TÍM KHỔ (32X32)cm - COMBO 4 GÓI MÀNG TÍM",40000,40000,0,0
TIKI,cham-soc-nha-cua,100067380,"Cô Cà Chua lau nhà 500ml - Mùi Sả Chanh",62000,62000,0,0
TIKI,cham-soc-nha-cua,6217517,"Xà Phòng Thanh Giặt Cổ Áo",28500,28500,0,0
TIKI,cham-soc-nha-cua,74212237," Bột thông tắc cống - HT SYS - Thông tắc cống chậu rửa bát - Thông tắc cống bồn cầu - SIÊU MẠNH - [SET 03 HỘP]",70000,70000,0,0
TIKI,cham-soc-nha-cua,2153231,"Nước tẩy quần áo 600ml Rocket nội địa Nhật Bản",34000,34000,0,0
TIKI,cham-soc-nha-cua,46013180,"Nước lau kính siêu sạch thơm Hando cao cấp",28000,28000,0,0
TIKI,cham-soc-nha-cua,7412793,"Thuốc diệt chuột hiệu quả 100% hàng Nhật Bản",93000,93000,0,0
TIKI,cham-soc-nha-cua,74561304,"Khăn Lau Đa Năng KRClean 200 tờ/cuộn 15x15cm - 1 túi 2 cuộn - Siêu Thấm Hút",75000,75000,0,0
TIKI,cham-soc-nha-cua,85064123,"Chai xịt làm sạch và đánh bóng đồ da Hando 600ml",85000,85000,0,0
TIKI,cham-soc-nha-cua,42818562,"Gói bột tẩy rửa thông tắc đường ống vệ sinh đa năng  - Nội địa Nhật",39500,39500,0,0
TIKI,cham-soc-nha-cua,129586417,"Nước Lau Sàn Sinh Học SoNa 3,6kg Hương Quế",111150,111150,0,0
TIKI,cham-soc-nha-cua,11477175,"Chai xịt thơm phòng Hàn Quốc cao cấp 300ml - Nhập khẩu chính hãng",55000,72000,17000,24
TIKI,cham-soc-nha-cua,192928526,"Combo 2 Chai Nước Lau Sàn Sinh Học ENZYCO Lên Men Từ Dứa Và Bồ Hòn Hương Sả Chanh 1.8L 바닥청소용 세제 Floor cleaner",300000,300000,0,0
TIKI,cham-soc-nha-cua,12707851,"Nước Lau Kính Hando Hương Hoa 600ml DT-30",27000,27000,0,0
TIKI,cham-soc-nha-cua,188883176,"Nước lau sàn không mùi hữu cơ Planet Pure 510ml",226000,226000,0,0
TIKI,cham-soc-nha-cua,170986200,"Thuốc diệt chuột Thái Lan - keo chuột hộp 100viên",24700,24700,0,0
TIKI,cham-soc-nha-cua,121315451,"Nước làm bóng Finish 800ml hương chanh dành cho máy rửa bát ",159000,159000,0,0
TIKI,cham-soc-nha-cua,132827320,"Bả chuột Storm 1kg",290000,290000,0,0
TIKI,cham-soc-nha-cua,172190771,"Nước bóng Finish Eco 0% 400ml (chất trợ xả)",118447,118447,0,0
TIKI,cham-soc-nha-cua,152809685,"Combo 3 Chai Xịt Xả Vải Khô - Tinh Dầu Comfort",70000,70000,0,0
TIKI,cham-soc-nha-cua,191410897,"Xi vệ sinh đánh bóng nhiều bề mặt hương cam Planet Pure 300g",385000,385000,0,0
TIKI,cham-soc-nha-cua,162209796,"Viên rửa bát Finish All in one 120 viên/ hộp",459000,459000,0,0
TIKI,cham-soc-nha-cua,53213374,"Combo 2 lọ thả bồn cầu Hàn Quốc",59999,59999,0,0
TIKI,cham-soc-nha-cua,193733635,"Chai Xịt Tẩy Rửa Vệ Sinh Bồn Cầu Cực Mạnh Hương Nước Hoa Anh Đào, Khử Khuẩn, Siêu Sạch Không Độc Hại 500ml",21999,21999,0,0
TIKI,cham-soc-nha-cua,31690536,"Chai Tẩy toilet Mr.Fresh 1L siêu mạnh",29000,29000,0,0
TIKI,cham-soc-nha-cua,3265075,"Bột Thông Cống Sumo Hộp (175g)",35000,35000,0,0
TIKI,cham-soc-nha-cua,124274940,"Hộp Đốt Nhang Chống Muỗi Chống Cháy Tốt",12000,12000,0,0
TIKI,cham-soc-nha-cua,122832484,"Hộp 30 Viên Giặt Công Nghệ Nhật Bản",35000,35000,0,0
TIKI,cham-soc-nha-cua,119320152,"[Nhập khẩu Đức] Set 4 gói túi thơm hương thiên nhiên  DENKMIT, Textilerfrischer Duftkissen Wäsche-Traum, 4 St, Bỏ trong tủ quần áo tủ giày hay túi xách thơm đến 8 tuần trở lên",180000,180000,0,0
TIKI,cham-soc-nha-cua,2646887,"Chất Tẩy Rửa Đa Năng Sumo (700g)",54000,54000,0,0
TIKI,cham-soc-nha-cua,77455206,"Combo 2 dây Giấy vệ sinh HÀ NỘI SILK 3 lớp Xanh Không Lõi Cao Cấp (Tặng Khăn giấy rút Hà Nội 150 tờ)",191600,191600,0,0
TIKI,cham-soc-nha-cua,108197645,"Viên Giặt Xả GELL BALL Bold 3D viên giặt Nhật Bản (mẫu mới)",105000,105000,0,0
TIKI,cham-soc-nha-cua,145613771,"Nước lau sàn Sunlight Thiên nhiên chiết xuất Chanh Zuzu & Sả túi 3.4 Kg",69000,69000,0,0
TIKI,cham-soc-nha-cua,196389528,"Combo 3 Túi Viên Giặt Xả MaxKleen Hương Huyền Diệu (34 viên/túi)",360000,420000,60000,14
TIKI,cham-soc-nha-cua,87378266,"COMBO 4 Chai Nước giặt LIX Đậm đặc (Đỏ) 3.8KGX4",420000,420000,0,0
TIKI,cham-soc-nha-cua,11861537,"Nước lau sàn hữu cơ Layer CLean Hương gió biển can 5 lít",122000,122000,0,0
TIKI,cham-soc-nha-cua,87378153,"Nước giặt LIX Đậm đặc (Đỏ) tẩy sạch vết bẩn cực mạnh túi 3.5KGX2",189000,189000,0,0
TIKI,cham-soc-nha-cua,116669050,"[CHÍNH HÃNG NHẬP KHẨU] Nước Xịt Thơm Quần Áo Cao Cấp MUMCHIT Fabric And Living Perfume 70ml (16 Mùi Hương)",138000,230000,92000,40
TIKI,cham-soc-nha-cua,3781257,"Hộp 2 gói tẩy lồng máy giặt siêu sạch Hando",29000,29000,0,0
TIKI,cham-soc-nha-cua,4987065,"Nước Giặt Giày Cao Cấp Kose Kobini Nhật Bản (500ml)",90000,90000,0,0
TIKI,cham-soc-nha-cua,140758959,"Hóa chất xử lý cặn đóng cứng đường ống nước kháng ăn mòn C88 ",1899000,1899000,0,0
TIKI,cham-soc-nha-cua,162397758,"Giấy Rút Tình Nhân MyLan 3 Lớp (450 Tờ/Gói, 4 Gói/Xách)",80000,80000,0,0
TIKI,cham-soc-nha-cua,82884254,"Nước xả vải Comfort 1 lần xả Dây 10 gói",19000,19000,0,0
TIKI,cham-soc-nha-cua,90923612," Chai thả bồn cầu khử mùi diệt khuẩn Hàn Quốc",38800,38800,0,0
TIKI,cham-soc-nha-cua,92904580,"Bột giặt Tide Trắng sạch chuyên dụng Downy 9KG",309000,309000,0,0
TIKI,cham-soc-nha-cua,472661,"Nước Xả Vải Downy Đam Mê Chai 1.8L ",129000,129000,0,0
TIKI,cham-soc-nha-cua,77451922,"Giấy Vệ Sinh HÀ NỘI SILK 3 lớp Tím Có Lõi Cao Cấp (Tặng Khăn giấy rút Hà Nội 150 tờ)",94000,94000,0,0
TIKI,cham-soc-nha-cua,189366269,"Combo bịch 6 viên  thơm khử mùi giày , mùi quần áo ,hút ẩm nấm mốc khử khuẩn vô cùng tiện lợi ",94050,99000,4950,5
TIKI,cham-soc-nha-cua,205387137,"combo Muối rửa bát Finish 1,5kg+Viên rửa chén bát Finish 77 viên dùng cho máy rửa bát",399000,399000,0,0
TIKI,cham-soc-nha-cua,115889244,"Sáp thơm Candle Warmer - Cherry Blossom",199000,269000,70000,26
TIKI,cham-soc-nha-cua,198076578,"Combo 2 Túi nước giặt Lix siêu sạch hương hoa anh đào 2.4Kg 2C-N2503",145000,145000,0,0
TIKI,cham-soc-nha-cua,74634778,"Nước rửa chén Hữu cơ Bồ hòn Tinh dầu thiên nhiên thương hiệu Ecocare 4 Lít- Tinh dầu Quế/ Tinh dầu Sả chanh/ Tinh dầu Cam/ Tinh dầu Chanh gừng",415000,515000,100000,19
TIKI,cham-soc-nha-cua,185445485,"Giấy Vệ Sinh Cuộn Lớn An Khang 703 | 100% bột giấy nguyên sinh | 2 lớp mềm mại | AK703",149000,216000,67000,31
TIKI,cham-soc-nha-cua,58038968,"Nước lau sàn Hữu cơ đuổi muỗi tinh dầu thiên nhiên thương hiệu Ecocare",75000,120000,45000,38
TIKI,cham-soc-nha-cua,68793552,"Combo 2 Túi Nước Giặt Xả Maxkleen Hương Vườn Sớm Mai (2.4kg/túi)",264000,300000,36000,12
TIKI,cham-soc-nha-cua,7250921,"Nước Lau Gạch Đa Năng SiFa (1.2L)",41500,41500,0,0
TIKI,cham-soc-nha-cua,57701946,"Bộ 2 nước tẩy gạch xi măng Sifa nhà tắm toilet đa năng 960ml cao cấp",123000,123000,0,0
TIKI,cham-soc-nha-cua,184505820,"Nước Rửa Chén Gốc Thực Vật Peace Mass Công Nghệ Enzyme Rửa Sạch & Không Lưu Mùi - Can 3.6l (Thuộc nhóm Sản phẩm Lành tính / Hữu cơ)",164255,172900,8645,5
TIKI,cham-soc-nha-cua,166564444,"Combo 04 túi Viên Rửa Chén Bát Finish Powerball Quantum 27 viên",780000,780000,0,0
TIKI,cham-soc-nha-cua,50256265,"Bột Giặt Lix Extra Hương Hoa 6Kg EB006 - Tẩy Sạch Vết Bẩn Cực Mạnh",130000,130000,0,0
TIKI,cham-soc-nha-cua,137479832,"COMBO 2 túi bột giặt Surf Hương nước xả vải (Hồng) Gói lớn 5.8kgX2",299000,299000,0,0
TIKI,cham-soc-nha-cua,49287403,"Viên nước giặt Tide Pods 3 in 1 Spring Meadow 42 Viên X 2 bịch  - USA",600000,600000,0,0
TIKI,cham-soc-nha-cua,36666584,"Bộ 2 Gói bột thông cống Hando 100g xuất khẩu cực mạnh - an toàn cho đường ống",45000,45000,0,0
TIKI,cham-soc-nha-cua,104950776,"Đầy đủ phụ kiện thay thế cho Robot Medion MD 18500, 18501, 19510, 19511 (chổi quét, màng hepa, giẻ, khay dính giẻ,..)",70000,70000,0,0
TIKI,cham-soc-nha-cua,98943354,"LỌ THẢ BỒN CẦU ️FREE SHIP️ HƯƠNG HOA HÀN QUỐC, VIÊN TẨY VỀ SINH",33000,33000,0,0
TIKI,cham-soc-nha-cua,37939389,"Nước giặt xả July 2X 3500ml hàng nhập khẩu chính hãng",179000,179000,0,0
TIKI,cham-soc-nha-cua,170491099,"Nước xịt tẩy rửa đa năng nhà tắm, bếp, vòi nước",35000,35000,0,0
TIKI,cham-soc-nha-cua,145613773,"Combo 2 Nước lau sàn Sunlight Thiên nhiên chiết xuất Chanh Zuzu & Sả túi 3.4Kg x2",139000,139000,0,0
TIKI,cham-soc-nha-cua,172997097,"Nước Giặt Ariel Matic Hương Downy Thơm Dài Lâu 3.9kg/túi",199000,199000,0,0
TIKI,cham-soc-nha-cua,100871401,"Làm Sạch Tẩy Trắng Đồ Dùng Bằng Sứ SMART TS - Bồn Cầu, Bồn Tắm, Bồn Rửa - Trắng Ngay Sau 5 Phút Không Cần Cọ Rửa - Tặng Kèm Chổi Lông",160000,160000,0,0
TIKI,cham-soc-nha-cua,56313411,"Nước giặt Túi 3.7kg OMO Matic Cho máy giặt cửa trước Cửa Trước Bền Màu Bền màu tinh chất Lựu Tre",175000,175000,0,0
TIKI,cham-soc-nha-cua,147204758," Gel Siêu Âm, Gel Lạnh Triệt Lông- Konix ECG Gel (Chai Nhỏ) -VT0653",27000,27000,0,0
TIKI,cham-soc-nha-cua,91862902,"Tinh dầu lăn đuổi muỗi KePha Antimos Oil - Lăn đuổi muỗi cho bé an toàn. Đuổi muỗi, làm lành vết sưng tấy nhanh, hiệu quả",75000,75000,0,0
TIKI,cham-soc-nha-cua,113255743,"Thuốc diệt mối có Iây truyền và không mùi OZAKI 240SC chai 100ml",160000,160000,0,0
TIKI,cham-soc-nha-cua,121053416,"Nước lau sàn hương Sả Chanh An An, Khử mùi đuổi muỗi đuổi côn trùng, thảo mộc thiên nhiên",110000,110000,0,0
TIKI,cham-soc-nha-cua,159863454,"Túi Thơm Cà Phê E-SKY Coffee Khử Mùi Ô Tô, Tủ Lạnh, Tủ Quần Áo, Văn Phòng, Nhà Ở Bằng Túi Vải Voan 50gr",23000,39000,16000,41
TIKI,cham-soc-nha-cua,194013439,"Nước giặt Lix Siêu sạch hương hoa anh đào 3.5kg N2504 làm sạch cực nhanh vết bẩn, tăng gấp đôi sức mạnh giặt tẩy",119000,119000,0,0
TIKI,cham-soc-nha-cua,137479458,"COMBO 2 túi Nước xả vải Comfort Nước hoa Sophia 3.2LX2",359000,359000,0,0
TIKI,cham-soc-nha-cua,25757344,"Dung Dịch Vệ Sinh Lồng Giặt, Máy Rửa Chén Stanhome Machine Booster 500Ml",234000,269000,35000,13
TIKI,cham-soc-nha-cua,73286020,"Bột giặt Surf Hương nước xả vải (Hồng) Gói lớn 5.8kg",149000,149000,0,0
TIKI,cham-soc-nha-cua,59512110,"Xịt muỗi Nhật mẫu mới màu xanh 200ml",126000,126000,0,0
TIKI,cham-soc-nha-cua,178592579,"Bình Xịt Đuổi Chuột Côn Trùng 300ml Trong Ô Tô Và Nhà Run Away Chiết Xuất Thảo Mộc Tự Nhiên Không Mùi An Toàn",22993,22993,0,0
TIKI,cham-soc-nha-cua,2622701,"Bình hút ẩm than hoạt tính Mr Fresh - Korea 256g",35000,35000,0,0
TIKI,cham-soc-nha-cua,176050463,"COMBO Giấy vệ sinh ASI không lõi loại 10 cuộn/bịch 800gr cao cấp mịn không bụi - HTpaper",265000,310000,45000,15
TIKI,cham-soc-nha-cua,193904073,"Thuốc diệt muỗi FENDONA 10SC-diệt Muỗi, phòng chống sốt xuất huyết (chai 50ml)",140000,140000,0,0
TIKI,cham-soc-nha-cua,131174763,"Túi thơm treo tủ quần áo phòng côn trùng F1 - giao ngẫu nhiên ",4800,4800,0,0
TIKI,cham-soc-nha-cua,191320537,"Bột giặt Surf ngát hương xuân 5.5kg",148000,148000,0,0
TIKI,cham-soc-nha-cua,4200659,"Túi nước xả vải Sandokkaebi Hàn Quốc cho da nhạy cảm 1.3L",42000,42000,0,0
TIKI,cham-soc-nha-cua,49333615,"Combo Tẩy Cặn Canxi Trên Kính + Tẩy Bồn Sứ, Sen Vòi Inox, Không Mùi, Chai 500ml.",316250,575000,258750,45
TIKI,cham-soc-nha-cua,1385289,"Nước Rửa Chén Bát Hương Quả Quýt Layer Clean (5L / Bình)",177000,177000,0,0
TIKI,cham-soc-nha-cua,4170883,"Hộp 3 túi thơm phòng ngàn hoa khử mùi tủ quần áo Mr Fresh Hàn Quốc (10g/gói)",39000,39000,0,0
TIKI,cham-soc-nha-cua,150938891,"Combo Sản Phẩm Gốc Thực Vật AF150C1 Peace Mass Xịt Côn Trùng & Không Gian 150ml + Xịt Khử Mùi 150ml  (Thuộc nhóm Sản phẩm Lành tính / Hữu cơ)",230850,243000,12150,5
TIKI,cham-soc-nha-cua,916416,"Bộ Máy Xịt Phòng Tự Động Auramax AU 10 + Chai Xịt Phòng Auramax Hương Lavender",426000,426000,0,0
TIKI,cham-soc-nha-cua,57007924,"Bộ 2 Chai xịt làm sạch, đánh bóng, bảo dưỡng và không làm phai màu bề mặt đồ gỗ Hando 600ml (Mẫu mới-Đen)",135000,135000,0,0
TIKI,cham-soc-nha-cua,57814685,"EcoClean Drain - Vi Sinh Ăn Mỡ Thừa Đường Ống - Mẫu 2020 - Hộp 1 Pound",660000,660000,0,0
TIKI,cham-soc-nha-cua,8021080,"Thuốc Diệt Muỗi Map Permethrin 50 EC",109000,109000,0,0
TIKI,cham-soc-nha-cua,124973188,"Gói hút ẩm 500 Gram  hạt hút ẩm Silica gel quy cách 1/2/3/5/10/50/100/200/500 Gram hút ẩm cho Thưc phẩm Quần áo Giày dép Máy ảnh Phòng Ngủ hoa khô",18000,18000,0,0
TIKI,cham-soc-nha-cua,205409257,"Viên rửa bát và làm bóng cao cấp Somat All in 1 Extra 10 Multi - AKTIV 25 Viên - Đức",179000,179000,0,0
TIKI,cham-soc-nha-cua,172997417,"COMBO 2 túi Nước xả vải Comfort Baby Cho Da Nhạy Cảm 3.2LX2",406000,406000,0,0
TIKI,cham-soc-nha-cua,172997341,"Nước Rửa Chén Siêu Sạch Ngát Hương Chanh 3.5Kg/túi",61000,61000,0,0
TIKI,cham-soc-nha-cua,53044610,"combo 2 Chai Xịt Tẩy Rửa Đa Năng Kitchen Cleaner 500ml tặng kèm miếng bọt biển cọ rửa đa năng",42500,42500,0,0
TIKI,cham-soc-nha-cua,97728865,"Combo Máy Xịt Nước Hoa Xịt Phòng Tự Động có điều khiển tặng kèm bình xịt",450000,450000,0,0
TIKI,cham-soc-nha-cua,190355295,"Nước lau sàn đuổi côn trùng 1L LD115 - Nhà sạch ngát hương thơm",39000,39000,0,0
TIKI,cham-soc-nha-cua,189681676,"Combo Túi Nước Lau Sàn 3.6kg Ngàn hoa ngọt ngào + Túi Nước Giặt Xả MaxKleen 3.6kg Thiên Nhiên",284000,284000,0,0
TIKI,cham-soc-nha-cua,107693412,"Nước rửa chén bát hữu cơ Fuwa3e 3.8L, đánh sạch mọi vết bẩn chén bát cứng đầu, 90% nguồn gốc thực vật, không hóa chất độc hại, an toàn cho bé, an toàn cho bà bầu.",335000,335000,0,0
TIKI,cham-soc-nha-cua,172190841,"10 CHAI DIỆT KIẾN GIÁN Sinh Học ANBIO Chai 10ml Xuất xứ Việt Nam",250000,250000,0,0
TIKI,cham-soc-nha-cua,272167700,"Túi Thơm Cà Phê E-SKY Coffee Khử MùI Ô Tô, Tủ Lạnh, Tủ Quần Áo, Văn Phòng, Nhà Ở Bằng Túi Vải Bố Lanh 20gr",15000,19900,4900,25
TIKI,cham-soc-nha-cua,44824922,"Vi Sinh Xử Lý Mùi Nhà Tắm, WC - EcoFresh - New USA - Hàng Chính Hãng ",253000,253000,0,0
TIKI,cham-soc-nha-cua,166558207,"Combo 03 túi Viên Rửa Chén Bát Finish Powerball Quantum 27 viên",570000,570000,0,0
TIKI,cham-soc-nha-cua,205485269,"Viên rửa bát Finish Classic 110 viên mẫu 2021 + Tặng 2 viên Finish Nhật",359000,359000,0,0
TIKI,cham-soc-nha-cua,189534807,"combo viên rửa bát finish 100 viên+nước làm bóng finish 750ml+muối rửa bát finish 1,5kg dùng cho máy rửa bát",569000,569000,0,0
TIKI,cham-soc-nha-cua,41933100,"EcoClean FOG - Vi Sinh Xử Thông Tắc Dầu Mỡ, Bảo Trì Đường Ống, Hiệu Quả Lâu Dài - Tối ưu cho hộ gia đình - Chai 1L",253000,266000,13000,5
TIKI,cham-soc-nha-cua,137480525,"COMBO 2 túi nước giặt OMO Cửa trên Tinh dầu 3.7kgX2",349000,349000,0,0
TIKI,cham-soc-nha-cua,169683693,"Các loại thảo mộc xông nhà khử mùi thanh tẩy không gian sống",42000,42000,0,0
TIKI,cham-soc-nha-cua,159276858,"Giấy ăn Pharmacity",18000,18000,0,0
TIKI,cham-soc-nha-cua,9793426,"Combo 02 Chai Nước Tẩy Đa Năng Mao Bao 600ml",82000,100000,18000,18
TIKI,cham-soc-nha-cua,51954801,"Combo nước làm bóng bát finish 800ml+Bột rửa bát finish 2.5kg dùng cho máy rửa bát",550000,550000,0,0
TIKI,cham-soc-nha-cua,59386319,"viên giặt 7 màu bịch 30v",23999,23999,0,0
TIKI,cham-soc-nha-cua,10730827,"Nước Giặt Xả July 2X Sweet Pink - 3500ml Hồng",174500,174500,0,0
TIKI,cham-soc-nha-cua,181118678,"Combo viên rửa bát Finish 120 viên + muối rửa bát Finish 1,5kg + Nước làm bóng bát finish 750ml",699000,699000,0,0
TIKI,cham-soc-nha-cua,119980090,"GIẤY VỆ SINH CAO CẤP PRIME 3 LỚP (1,6KG) CÓ LÕI - MÀNG NHŨ",80000,80000,0,0
TIKI,cham-soc-nha-cua,191654279,"Nước giặt xả Hiclass 3000ml - Màu Tím - Hàng Thái Lan",199000,199000,0,0
TIKI,cham-soc-nha-cua,134760498,"Gel rửa bát Finish hữu cơ 900ml",312000,629994,317994,50
TIKI,cham-soc-nha-cua,193597478,"Sáp Thơm Nhà Vệ Sinh Khử Mùi Sara 125g Sáp Thơm Toilet Khử Mùi Dùng Cho Cả Phòng Ngủ, Ô Tô, Tủ Quần Áo, Tủ Giày",48000,48000,0,0
TIKI,cham-soc-nha-cua,52879058,"Bộ 2 Sáp thơm phòng Pure Aroma 180g Hàn Quốc khử mùi ẩm mốc (Mẫu mới)",84000,84000,0,0
TIKI,cham-soc-nha-cua,165938084,"Thuốc diệt muỗi, gián, kiến, ruồi, bọ chét, kiến ba khoang Fendona 10SC 50 ml x 1 chai KHÔNG MÙI (bao bì mới)",95000,95000,0,0
TIKI,cham-soc-nha-cua,168851364,"Muối rửa bát Finish hộp 4kg - Nhập Khẩu EU",150000,150000,0,0
TIKI,cham-soc-nha-cua,51584689,"Hộp 6 Gói Vi Sinh Xử Lý Hầm Tự Hoại, Bồn Cầu Bị Đầy, Tràn - EcoFlush - Túi Gói Tự Phân Huỷ",330000,330000,0,0
TIKI,cham-soc-nha-cua,160268788,"Tẩy Chì Cao Cấp Siêu Mềm Siêu Sạch Pentel Ain Black Vỏ Xanh ZEAH | Tẩy Sạch, Ít Bụi, Ít Độc Hại",16000,16000,0,0
TIKI,cham-soc-nha-cua,146893650,"Thùng giấy ăn gấu trúc 4 lớp siêu dai, siêu mềm minh 30 gói hình mặt cười đáng yêu",146000,146000,0,0
TIKI,cham-soc-nha-cua,67649730,"Bộ gồm 2 chai Thông tắc + khử mùi bể phốt HANDO 860g",42000,42000,0,0
TIKI,cham-soc-nha-cua,196410582,"Combo 2 Túi Viên Giặt Xả MaxKleen Hương Huyền Diệu + Hương Ngày Thư Thái\ (34 viên/túi)",242000,280000,38000,14
TIKI,cham-soc-nha-cua,125719715,"[Nhập khẩu Đức] Dung dịch xịt tẩy nhà tắm đa năng BREF 750ml, Kalkreiniger Power gegen Kalk & Schmutz, 750 ml",210000,210000,0,0
TIKI,cham-soc-nha-cua,59208881,"Bột Giặt OMO Comfort Tinh Dầu Thơm (5.5kg)",219000,219000,0,0
TIKI,cham-soc-nha-cua,145635222,"Gel làm sạch không khí",36400,52000,15600,30
TIKI,cham-soc-nha-cua,181936340,"Túi Thơm Cà Phê E-Sky Coffee Khử Mùi Ô Tô, Tủ Lạnh, Tủ Quần Áo, Văn Phòng Túi Vải Voan 50Gr",25000,39000,14000,36
TIKI,cham-soc-nha-cua,84796848,"Bột thông cống Hando 280g",29000,29000,0,0
TIKI,cham-soc-nha-cua,11861498,"Nước lau sàn hữu cơ Layer Clean Hương nước hoa 5L",138000,138000,0,0
TIKI,cham-soc-nha-cua,138381155,"Kem Tẩy Trắng Nồi Xoong Chảo Đa Năng Hàn Quốc",24000,24000,0,0
TIKI,cham-soc-nha-cua,56511457,"Dầu diệt mối diệt côn trùng tận gốc 115 Sifa siêu mạnh 473ml cao cấp ",55000,55000,0,0
TIKI,cham-soc-nha-cua,97799047,"Kem tẩy xoong nồi đa năng Hàn Quốc - loại to",19999,19999,0,0
TIKI,cham-soc-nha-cua,163311340,"LỐC 36 CUỘN Giấy vệ sinh gấu trúc không lõi siêu dai",158000,158000,0,0
TIKI,cham-soc-nha-cua,78969975,"Nước giặt Lord 10kg",310000,310000,0,0
TIKI,cham-soc-nha-cua,48525832,"[ComBo 3 Hộp] Bột Thông Tắc Cống Cực Mạnh-TVS55-Bột Thông Bồn Cầu, Thông Tắc Ngẽn Cống, Lavabo-268G",37998,37998,0,0
TIKI,cham-soc-nha-cua,2597933,"Bột thông cống cực mạnh 100g nội địa Hando",19000,19000,0,0
TIKI,cham-soc-nha-cua,187595728,"Long não thơm phòng Hando 100g hương thiên nhiên thơm mát",22000,22000,0,0
TIKI,cham-soc-nha-cua,864075,"Miếng Xả Chống Nhăn Làm Mềm Quần Áo Lion (25 miếng)",198000,198000,0,0
TIKI,cham-soc-nha-cua,36995966,"Xịt Thơm Phòng Febreze Hawaiian Aloha 250g",130000,130000,0,0
TIKI,cham-soc-nha-cua,193142751,"Combo 5 cuộn giấy vệ sinh An khang Soft 900 giấy hai lớp một cuộn 900gr | 100% bột giấy nguyên sinh",299000,445000,146000,33
TIKI,cham-soc-nha-cua,79775566,"Thuốc  diệt muỗi Permecide 50EC mới, an toàn, hiệu quả với muỗi kháng thuốc (chai 1 lít)",850000,850000,0,0
TIKI,cham-soc-nha-cua,58169168,"Xịt Khử Trùng Resparkle - Chai 100ml 2020 - Hàng Chính Hãng",180000,180000,0,0
TIKI,cham-soc-nha-cua,120047150,"GIẤY VỆ SINH 3 LỚP PRIME (1,8KG) CÓ LÕI - COMBO 2 DÂY MÀNG BONG BÓNG",155000,155000,0,0
TIKI,cham-soc-nha-cua,205293622,"Túi 60 viên rửa bát Finish Quantum Dishwasher Tablets Lemon Sparkle QT025460 - hương chanh",399000,399000,0,0
TIKI,cham-soc-nha-cua,70635078,"Nước Lau Sàn/ Rửa Chén Tinh Dầu Thảo Mộc Hữu Cơ Organic PK 300ML - Đuổi muỗi và côn trùng - Hương thơm tinh dầu dịu nhẹ - An toàn cho bé vận động",139000,139000,0,0
TIKI,cham-soc-nha-cua,168545439,"Sẵn Hàng - Gel khử mùi bồn cầu diệt khuẩn - Gel thơm dính bồn cầu dạng thạch hình bông hoa",13490,13490,0,0
TIKI,cham-soc-nha-cua,189469063,"Nước giặt xả On1 chống lem màu hương Fresh Sakura 2.6Kg - Sạch khuẩn, khử mùi, kết hợp giặt xả 2 trong 1- N6401",129000,129000,0,0
TIKI,cham-soc-nha-cua,49907459,"Nước Lau Sàn Diệt Khuẩn Mao Bao Hương Hoa Oải Hương chai 1000ml",39000,45000,6000,13
TIKI,cham-soc-nha-cua,916448,"Bộ 6 Chai Nước Hoa Xịt Phòng Auramax Hương Lavender ",415800,415800,0,0
TIKI,cham-soc-nha-cua,193904078,"Thuốc diệt muỗi Fendo Green, chai 50 ml, nhập khẩu từ Vương Quốc Bỉ (Châu Âu). Phun phòng chống sốt xuất huyết hiệu quả,",50000,50000,0,0
TIKI,cham-soc-nha-cua,67651918,"Cốc tẩy toilet hando 200g tự động làm sạch khử mùi hôi",34000,34000,0,0
TIKI,cham-soc-nha-cua,145764004,"Dung Dịch Xịt Tẩy Cặn Đen Đáy Nồi, Xoong, Chảo Inox Siêu Sạch 500ML",125000,125000,0,0
TIKI,cham-soc-nha-cua,48582720,"Xịt thơm quần áo hương hoa Nội địa Nhật Bản ",149000,149000,0,0
TIKI,cham-soc-nha-cua,50256283,"Nước Giặt Lix Hương Nước Hoa 3.8Kg NGH01 - Tẩy Sạch Vết Bẩn Cực Mạnh",105000,105000,0,0
TIKI,cham-soc-nha-cua,150938488,"Combo Sản Phẩm Gốc Thực Vật LSB3 Peace Mass Nước Lau Sàn TD Chanh Sả - Bạc Hà 3.6 l + Nước Rửa Chén 3.6 l (Thuộc nhóm Sản phẩm Lành tính / Hữu cơ)",367650,387000,19350,5
TIKI,cham-soc-nha-cua,172408350,"LỌ XỊT SIÊU TẤY CẶN CANXI BÁM INOX TOMAS TIỆN DỤNG",119000,119000,0,0
TIKI,cham-soc-nha-cua,170985338,"Thuốc xịt chuột - thuốc đuổi chuột côn trùng hiệu quả chai 500ml",20000,20000,0,0
TIKI,cham-soc-nha-cua,126998546,"DUNG DỊCH KHỬ KHUẨN NANO BẠC NANO XPURE ANTIBACTERIAL 35PPM 4 LÍT-DÙNG CHO MÁY PHUN SƯƠNG-KHỬ KHUẨN, KHỬ MÙI, DIỆT KHUẨN-NANO SILVER AHT CORP (AHTC)",330000,550000,220000,40
TIKI,cham-soc-nha-cua,101236401,"Combo 5 Cốc thả bồn cầu tẩy xanh toilet Hàn Quốc Mr Fresh 180g ( hương ngàn hoa )",205000,205000,0,0
TIKI,cham-soc-nha-cua,49008904,"Tosto Oxygen - Chuyên gia khử mùi không khí - Chai 250ml",79000,79000,0,0
TIKI,cham-soc-nha-cua,188895353,"Nước vệ sinh bề mặt gỗ olive bergamot hữu cơ Planet Pure 510ml",280000,280000,0,0
TIKI,cham-soc-nha-cua,172686620,"Combo 4 Nước giặt Lix Matic hương nước hoa chai 3.6 lít",454000,454000,0,0
TIKI,cham-soc-nha-cua,194954221,"Khăn giấy lụa cao cấp Arosa Túi 10 Gói 300 tờ 3 lớp Trắng tự nhiên, Đa công dụng và tiện lợi, Phù hợp cho cả mẹ bầu và em bé, 100% bột giấy nguyên sinh rừng trồng",59000,59000,0,0
TIKI,cham-soc-nha-cua,192860792,"Viên giặt  xả Gelball 4D 4in1 12 viên (Sản phẩm mới 2022) -hàng Nhật Bản-Mẹ và Bé Unmei",75000,75000,0,0
TIKI,cham-soc-nha-cua,171944450,"Nước thơm lau sàn nhà Hando 1L hương Lavender",25000,25000,0,0
TIKI,cham-soc-nha-cua,10000203,"Sáp thơm phòng Hando 87g - hương táo mỹ",17000,17000,0,0
TIKI,cham-soc-nha-cua,140434752,"Gel thơm khử trùng bồn cầu, gel khử mùi bồn cầu dạng thạch hình bông hoa với 6 mùi thơm cho toilet",12991,12991,0,0
TIKI,cham-soc-nha-cua,194016680,"Khăn giấy bỏ túi rút MINI BEAR Nhật 4 lớp 210 tờ",380000,380000,0,0
TIKI,cham-soc-nha-cua,145626733,"Gel làm sạch không khí",36400,52000,15600,30
TIKI,cham-soc-nha-cua,126522821,"Hộp 12 Viên Tẩy Lồng Máy Giặt Nhật Bản Viên Nén Thế Hệ Mới - Cho Máy Giặt Cửa Trên Và Cửa Trước Đều Dùng Dược, Viên Tẩy Giúp Vệ Sinh Máy Giặt Khỏi Cặn Bẩn, Khử Mùi Máy Giặt Hiệu Quả - GDHN Loại Tốt",13400,13400,0,0
TIKI,cham-soc-nha-cua,171970880,"Giấy Thơm Quần Áo Và Mềm Vải BOUNCE Outdoor Fresh- hộp 160 tờ",215000,215000,0,0
TIKI,cham-soc-nha-cua,71765080,"Combo 3 hộp nước hoa khô dạng sáp",80000,80000,0,0
TIKI,cham-soc-nha-cua,173771050,"Nước giặt Lord hương nước  đậm đặc, sạch, thơm can 10kg",350000,350000,0,0
TIKI,cham-soc-nha-cua,49023112,"Nước Giặt Quần Áo Cao Cấp Mao Bao 473g",47500,60000,12500,21
TIKI,cham-soc-nha-cua,192931240,"Combo Nước Ngâm Rau Củ, Nước Rửa Bát Và Nước Rửa Tay Sinh Học ENZYCO 90% Enzyme Từ Dứa và Bồ Hòn식기 세정제Dishwashing liquid",320000,320000,0,0
TIKI,cham-soc-nha-cua,80408772,"Khăn giấy ăn - Giấy lụa Oulu 3 lớp - gói lơn Thùng 24 gói Dai hơn, Không mủn ngay trong nước, Mềm mịn dùng được cho da em bé, Hàng chính hãng 100%",400000,400000,0,0
TIKI,cham-soc-nha-cua,28729967,"Sáp thơm cao cấp 300g hình con vịt",39000,39000,0,0
TIKI,cham-soc-nha-cua,72874902," Nước giặt bảo vệ vải Hando 4L",145000,145000,0,0
TIKI,cham-soc-nha-cua,118516344,"Combo 2 hộp 10 túi hút ẩm chống mốc treo tủ quần áo tủ giày dép tủ bếp Hando 5x50Gr",109000,109000,0,0
TIKI,cham-soc-nha-cua,173438791,"Diệt Kiến Gián Sinh Học Hiệu Quả - An Toàn",3000,3000,0,0
TIKI,cham-soc-nha-cua,137479074,"COMBO 10 Túi Nước rửa chén Sunlight Thiên nhiên (trắng) Túi 750gx10",279000,279000,0,0
TIKI,cham-soc-nha-cua,104850029,"SÁP THƠM ĐUỔI MUỖI CHỐNG MUỖI CỰC HIỆU QUẢ THÁI LAN ĐỦ MÀU",54000,54000,0,0
TIKI,cham-soc-nha-cua,158791831,"CHAI TẨY CANXI HÀN QUỐC SIÊU SẠCH",38999,38999,0,0
TIKI,cham-soc-nha-cua,7364965,"Nước thơm lau sàn Hando 5L Hương Hồng",95000,95000,0,0
TIKI,cham-soc-nha-cua,83854452,"Giấy Vệ Sinh Fairy 12 cuộn đỏ có lõi",45000,45000,0,0
TIKI,cham-soc-nha-cua,163575292,"Giấy Bỏ Túi Mylan Táo 4 Lớp (8 Tờ/1 Gói, 15 Gói/Cây)",38000,40000,2000,5
TIKI,cham-soc-nha-cua,163574428,"Giấy Rút Con Nai MyLan 3 Lớp (465 Tờ/Gói, 8gói/Xách)",94050,99000,4950,5
TIKI,cham-soc-nha-cua,205293681,"Viên vệ sinh làm sạch sâu trong máy rửa bát Finish Vỉ 3 viên - Chính Hãng",99000,99000,0,0
TIKI,cham-soc-nha-cua,125164302,"Viên Tẩy Bồn Cầu/ Viên Thả Bồn Cầu Khử Mùi Hàn Quốc (Gói 10 viên) - Diệt Khuẩn",26000,26000,0,0
TIKI,cham-soc-nha-cua,192585015,"Giấy Ăn Gấu Trúc Sipiao Mylan (300 tờ/bịch) ",8000,14000,6000,43
TIKI,cham-soc-nha-cua,35191499,"COMBO 02 CHAI NƯỚC TẨY TOILET OKAY PINK 960ML (HỒNG)",53800,53800,0,0
TIKI,cham-soc-nha-cua,183541210,"2kg- Muối máy rửa chén bát ISRAEL, muối làm mềm nước",59000,59000,0,0
TIKI,cham-soc-nha-cua,145613795,"Combo 3 Nước lau sàn Sunlight Thiên nhiên chiết xuất Chanh Zuzu & Sả Can 3.6KG",278000,278000,0,0
TIKI,cham-soc-nha-cua,188685670,"Combo Túi Nước Lau Sàn 3.6kg Ngàn hoa ngọt ngào + Túi Nước Giặt Xả MaxKleen 3.8kg Hoa Nắng",256000,284000,28000,10
TIKI,cham-soc-nha-cua,4536473,"Cốc thả tẩy xanh diệt khuẩn và làm thơm bồn cầu hương ngàn hoa Hàn Quốc 180g",39000,39000,0,0
TIKI,cham-soc-nha-cua,167575475,"Khăn giấy rút Fairy ngắn 270 tờ x 3 lớp",7000,7000,0,0
TIKI,cham-soc-nha-cua,134354536,"Bột baking soda 500g (tẩy trắng)",95000,95000,0,0
TIKI,cham-soc-nha-cua,193904048,"Thuốc diệt chuột Racumin dạng bột, gói 20gam, sản phẩm của Bayer, thuốc làm vỡ nội tạng chuột.",50000,50000,0,0
TIKI,cham-soc-nha-cua,57717354,"Bình Xịt Tẩy Nấm Mốc Tường Nhà, Phòng Tắm ,Nhà Bếp 500ml",65000,65000,0,0
TIKI,cham-soc-nha-cua,10121255,"Nước Rửa Chén, Bát Hương Bưởi 600ml - Nội Địa Nhật Bản",39000,39000,0,0
TIKI,cham-soc-nha-cua,189463923,"Nước giặt xả On1 hương Bamboo Charcoal 3.6Kg - Sạch khuẩn, khử mùi, kết hợp giặt xả 2 trong 1 - N6902",169000,169000,0,0
TIKI,cham-soc-nha-cua,188694685,"Combo Túi Nước Lau Sàn 3.6kg Ban Mai Thanh Mát + Túi Nước Giặt Xả MaxKleen 3.6kg Thiên Nhiên",256000,284000,28000,10
TIKI,cham-soc-nha-cua,150710255,"Viên GeL Giặt Đồ Kháng Khuẩn Khử Mùi Welco - 52 viên",289000,289000,0,0
TIKI,cham-soc-nha-cua,10136850,"Chai Xịt Làm Phằng Và Kháng Khuẩn Cho Quần Áo (Nhiều Mùi Hương) - Nội Địa Nhật Bản",139000,139000,0,0
TIKI,cham-soc-nha-cua,189469530,"Nước giặt xả On1 hương Matic Garden Of Fame 2.6Kg - Sạch khuẩn, khử mùi, kết hợp giặt xả 2 trong 1 - N7001",129000,129000,0,0
TIKI,cham-soc-nha-cua,170475396,"Khăn giấy rút silkwell 280 tờ Cherry đỏ siêu tiện lợi",23000,23000,0,0
TIKI,cham-soc-nha-cua,121326176,"viên rửa bát finish Đức 66 viên dùng cho máy rửa bát , nuớc làm bóng , muối rửa bát ( muối làm mềm nước )",49000,49000,0,0
TIKI,cham-soc-nha-cua,7819271,"Combo Dung dịch tẩy rửa vệ sinh bếp từ cao cấp 300g + Chai xịt vệ sinh kính 300ml nội địa Nhật Bản",108000,108000,0,0
TIKI,cham-soc-nha-cua,13849504,"Nước Rửa Chén Layer Clean 800ml",32000,32000,0,0
TIKI,cham-soc-nha-cua,92791983,"COMBO 2 túi nước giặt Surf Nước hoa 3.1KgX2",239000,239000,0,0
TIKI,cham-soc-nha-cua,7690918,"Chất tẩy cặn canxi HT01 - 250g",165000,165000,0,0
TIKI,cham-soc-nha-cua,145846459,"Chai xịt tẩy rỉ sét RP7 Kim Khí Dung Anh, RP7 bôi trơn động cơ Selleys lọ 150G, 300G, 350G hàng chuẩn, RP7",65000,65000,0,0
TIKI,cham-soc-nha-cua,168513699,"GEL TẨY MỐC, TẨY VẾT Ố CAO SU THẦN THÁNH SIÊU HIỆU QUẢ",49000,49000,0,0
TIKI,cham-soc-nha-cua,118781349,"GIẤY ĂN GIẤY RÚT 2 LỚP PRIME KHỔ (20X20)cm - COMBO 4 GÓI MÀNG XANH",69000,69000,0,0
TIKI,cham-soc-nha-cua,77729539,"Khăn giấy ăn Napkin Fairy 320",13000,13000,0,0
TIKI,cham-soc-nha-cua,120033728,"GIẤY VỆ SINH 3 LỚP PRIME (1,5KG) CÓ LÕI - COMBO 2 DÂY MÀNG XANH",125000,125000,0,0
TIKI,cham-soc-nha-cua,172574698,"Nước Cọ Rửa Toilet Gốc Thực Vật Peace Mass Tinh dầu Quế (Thuộc nhóm Sản phẩm Lành tính / Hữu cơ) Can 3.6 Lít",450000,450000,0,0
TIKI,cham-soc-nha-cua,7496065,"Combo 3 Hộp khử mùi tủ giày than hoạt tính nội địa Nhật Bản",95500,95500,0,0
TIKI,cham-soc-nha-cua,72476756,"ComBo 2 Chai Nước Rửa Chén Hữu Cơ Layer Clean - Hương Qủa Hồng, Thể Tích: 800ml",65000,65000,0,0
TIKI,cham-soc-nha-cua,16630027,"Nước hoa khử mùi gia đình, phòng ngủ, khách sạn - Areon Gold Amber Premium",430000,430000,0,0
TIKI,cham-soc-nha-cua,57693283,"Xịt làm sạch, bảo dưỡng và đánh bóng đồ gỗ Hando 600ml",69000,69000,0,0
TIKI,cham-soc-nha-cua,102394022,"Nước tẩy rửa nhà vệ sinh, tẩy cặn nước tiểu,Denkmit 750 ml",109000,145000,36000,25
TIKI,cham-soc-nha-cua,115819494,"Tẩy lồng máy giặt hộp 12 viên diệt khuẩn, tẩy cặn bẩn máy giặt",20000,20000,0,0
TIKI,cham-soc-nha-cua,198103418,"Nước rửa thực phẩm tươi sống Sanodyna Food Wash - 100% Tự Nhiên - thương hiệu từ ITALIA – Dung tích 2L",139000,139000,0,0
TIKI,cham-soc-nha-cua,7936907,"Combo chai nước rửa bát chén hương cam 600ml Rocket nội địa Nhật Bản",33500,33500,0,0
TIKI,cham-soc-nha-cua,186277488,"Dung dịch vệ sinh máy rửa bát Finish 250ml - Dành cho máy rửa chén - Nhập khẩu tại Đức",124000,253600,129600,51
TIKI,cham-soc-nha-cua,198087837,"Combo 2 Túi nước giặt Lix đậm đặc Hương Hoa 3.5Kg - Tẩy Sạch Cực Mạnh Vết Bẩn - 2C-NG350",219000,219000,0,0
TIKI,cham-soc-nha-cua,58585492,"Dung Dịch Xịt Chống Tĩnh Điện Cho Quần Áo, Tóc, Đồ Kim Loại Cao Cấp 135ml",42000,42000,0,0
TIKI,cham-soc-nha-cua,16587354,"Dung dịch làm sạch vách kính tắm vẩy cá và cặn canxi Smart 500ml",215500,215500,0,0
TIKI,cham-soc-nha-cua,4632913,"Chai xịt tẩy vệ sinh khử khuẩn nhà bếp Sandokkaebi Korea 300ml",35000,35000,0,0
TIKI,cham-soc-nha-cua,194848017,"Khăn giấy Momo Diamond",6000,6000,0,0
TIKI,cham-soc-nha-cua,96704315,"Nước thơm phòng khử mùi Shoshu Gen Kobayashi 400mL",130000,130000,0,0
TIKI,cham-soc-nha-cua,87378398,"COMBO 2 Chai Nước giặt LIX Đậm đặc (Đỏ) 2KGX2",130000,130000,0,0
TIKI,cham-soc-nha-cua,158603739,"Combo [Can Cồn Sát Khuẩn 70 Độ Hoàng Long 3.8L Tặng Kèm Chai Xịt 500ml]",170000,170000,0,0
TIKI,cham-soc-nha-cua,61383089,"Hóa chất tẩy cáu cặn điều hòa chiller C88",1983000,1983000,0,0
TIKI,cham-soc-nha-cua,58292847,"Tẩy Trắng Bồn Sứ và Sen Vòi Inox Sabo-SI Chai 1 lít",199000,350000,151000,43
TIKI,cham-soc-nha-cua,52579985,"NƯỚC LAU BẾP CHANH TƯƠI ASTONISH C6760 750ML",119000,119000,0,0
TIKI,cham-soc-nha-cua,121326101,"Nước trợ xả Finish chuyên dùng cho máy ( dầu bóng dùng cho máy rửa chén bát ) hàng Đức",109000,109000,0,0
TIKI,cham-soc-nha-cua,6320687,"Combo 10 Hộp Bột thông cống Hando 100g Xuất khẩu",185000,185000,0,0
TIKI,cham-soc-nha-cua,25756955,"Nước Rửa Bát Hữu Cơ Degreaser Care Stanhome Dịu Nhẹ Cho Da 750Ml",210000,289000,79000,27
TIKI,cham-soc-nha-cua,43852128,"Xịt kháng khuẩn và khử mùi giúp ngủ ngon tinh dầu Phong Lữ PK - Khử mùi hiệu quả, thư giãn, giúp ngủ ngon",79000,79000,0,0
TIKI,cham-soc-nha-cua,160315413,"Nước hoa thơm phòng AREON YUZU SQUASH - hương Quýt Tây (Dịu Nhẹ - Thư Giãn) Nhập khẩu Bulgaria",380000,380000,0,0
TIKI,cham-soc-nha-cua,10192889,"Viên Rửa Chén Bát Ludwik - Dùng Cho Máy Rửa Bát (50 Viên)",299000,299000,0,0
TIKI,cham-soc-nha-cua,163575704,"Giấy rút hoa cúc mylan",25000,25000,0,0
TIKI,cham-soc-nha-cua,160313692,"Nước hoa thơm phòng Areon Home Spring Bouquet - hương Hoa Anh Đào ( Dịu Nhẹ - Tươi Mới )",380000,380000,0,0
TIKI,cham-soc-nha-cua,50256263,"Bột Giặt Lix Extra Đậm Đặc 6Kg ED010 - Tẩy Sạch Vết Bẩn Mạnh Gấp 2 Lần",145000,145000,0,0
TIKI,cham-soc-nha-cua,52778824,"Túi 60 viên rửa bát Finish Quantum Dishwasher Tablets QT025459",399000,399000,0,0
TIKI,cham-soc-nha-cua,84623563,"GIẤY RÚT GIẤY LAU TAY PRIME 2 LỚP - COMBO 10 GÓI MÀNG IN",110000,110000,0,0
TIKI,cham-soc-nha-cua,7816576,"Chất thông tắc cống chống hôi siêu tốc 5 phút 700g Sifa ",44900,44900,0,0
TIKI,cham-soc-nha-cua,77916296,"Khăn giấy ăn Napkin HÀ NỘI 220",8000,8000,0,0
TIKI,cham-soc-nha-cua,85064016,"Bộ 6 bình hút ẩm Hando Hồng 450ml TI608",180000,180000,0,0
TIKI,cham-soc-nha-cua,108807822,"Tinh chất khử mùi thơm phòng vệ sinh toilet Nhật Bản",42000,42000,0,0
TIKI,cham-soc-nha-cua,189140906,"Sáp thơm phòng hương nước hoa cao cấp Kobayashi Sawaday Happy Parfum 120g (4 mùi)",95000,95000,0,0
TIKI,cham-soc-nha-cua,174558407,"Nước Giặt Hữu Cơ Fuwa3e Organic Sinh Học 4L Giặt Quần Áo, Đồ Lót, Sạch Nhanh, Hương Cam, An Toàn Cho Em Bé, Cuong88vp",361000,365000,4000,1
TIKI,cham-soc-nha-cua,195640695,"Dung Dịch Sát Khuẩn Bề Mặt Gốc QUAT Saraya Sanitizer S-6, Dùng Trong - Can 5Kg",404000,404000,0,0
TIKI,cham-soc-nha-cua,169757134,"Dung dịch tẩy mốc hàn quốc mold cleaner tẩy mốc nhựa cao su silicon máy rửa mặt",58800,58800,0,0
TIKI,cham-soc-nha-cua,103850388,"[Hàng nhập khẩu - Đức] Combo 10 Viên Tẩy, Vệ sinh Lồng Máy Giặt Denkmit Anti Kalk Tabs, sử dụng 1-2/tuần, khử mùi ẩm mốc, thích hợp khi khí hậu nồm ẩm, phơi đồ lâu khô",70000,70000,0,0
TIKI,cham-soc-nha-cua,115892083,"Sáp thơm Candle Warmer - Cozy Cashmere",199000,249000,50000,20
TIKI,cham-soc-nha-cua,126596610,"COMBO FINISH: Viên rửa bát Classic 90 viên + Bóng 750ml + Muối 1,2kg + Dung dịch vệ sinh",619000,619000,0,0
TIKI,cham-soc-nha-cua,112168290,"10 Viên tẩy bồn cầu, viên thả nước bồn cầu diệt khuẩn",11000,11000,0,0
TIKI,cham-soc-nha-cua,100930283,"BỘT KHAI NHÀ YẾN BAO 25KG",558000,558000,0,0
TIKI,cham-soc-nha-cua,53134645,"KHĂN GIẤY LỤA NGUYÊN SINH CAO CẤP DALIN GÓI VUÔNG NHỎ",12000,12000,0,0
TIKI,cham-soc-nha-cua,576227,"Nước Lau Sàn Làn Gió Biển Mao Bao 1L",37500,40000,2500,6
TIKI,cham-soc-nha-cua,45360720,"Bộ 2 Bột thông cống cực mạnh nội địa Hando",35000,35000,0,0
TIKI,cham-soc-nha-cua,53087139,"Nước làm bóng và khô chén, đĩa Finish Dishwasher Shine & Dry Regular 750ml",144767,289534,144767,50
TIKI,cham-soc-nha-cua,91128898,"Kem Che Vết Xước Đồ Gỗ - SuperStore",325000,325000,0,0
TIKI,cham-soc-nha-cua,176718561,"Hạt Xả Thơm Làm Mềm Vải Quần Áo Hương Nước Hoa Siêu Lưu Hương, sử dụng cho máy giặt tạo hương thơm dễ chịu - NGẨU NHIÊN",19000,19000,0,0
TIKI,cham-soc-nha-cua,198462678,"NƯỚC GIẶT TOMAS - Lưu hương",175000,175000,0,0
TIKI,cham-soc-nha-cua,105656879,"Thuốc diệt mối Mythic 240SC chai 1 lít – Công nghệ trừ mối từ BASF (Đức)",1590000,1590000,0,0
TIKI,cham-soc-nha-cua,98219719,"COMBO 8 GÓI GIẤY ĂN VUÔNG KHỔ 24x24(cm) ll NAPKIN",55000,55000,0,0
TIKI,cham-soc-nha-cua,85065091,"Bộ 8 bình hút ẩm Hando Lavender 450ml TI604",250000,250000,0,0
TIKI,cham-soc-nha-cua,9441520,"Nước Rửa Rau Quả Và Chén Bát CJ Lion Real Green Tinh Chất Quả Mơ 1.2kg",90160,92000,1840,2
TIKI,cham-soc-nha-cua,50235182,"Nước giặt diệt khuẩn khử mùi Rocket 1,65kg Hương hoa dịu nhẹ (Túi refill)",146000,198000,52000,26
TIKI,cham-soc-nha-cua,162209865,"Combo Finish Eco : Gel rửa bát Eco 900ml + Bóng Eco 400ml + Muối 1,5kg",589000,589000,0,0
TIKI,cham-soc-nha-cua,181902963,"Nước hoa thơm phòng Areon Home Peony Blossom - hương Hoa Mẫu Đơn ( Dịu Nhẹ - Đằm Thắm )",430000,430000,0,0
TIKI,cham-soc-nha-cua,40968897,"Lọ xua đuổi kiến, mối, gián",37000,37000,0,0
TIKI,cham-soc-nha-cua,12292669,"Bộ 4 Long não 100g nhiều hương thiên nhiên thơm mát",55000,55000,0,0
TIKI,cham-soc-nha-cua,27695271,"Nước làm sạch đồ dùng bằng sứ SMART PLUS (Có tem đảm bảo Plus trên nắp chai và thân chai)",165000,165000,0,0
TIKI,cham-soc-nha-cua,174665706,"Lau Đa Năng Fuwa3e 500ml Hữu Cơ Diệt Khuẩn Với Tinh Dầu Hương Nhu Chống Nấm Kháng Khuẩn",140000,150000,10000,7
TIKI,cham-soc-nha-cua,198482842,"THÙNG 30 GÓI, BỊCH 10 GÓI GIẤY ĂN RÚT GUMI  3 LỚP CAO CẤP",69000,69000,0,0
TIKI,cham-soc-nha-cua,106975650,"Bộ 5 than hoạt tính thanh lọc không khí cho oto và phòng hình Angry birds 206141",108800,129800,21000,16
TIKI,cham-soc-nha-cua,170402684,"Hộp thơm phòng cao cấp hương đào Nhật Bản",80000,80000,0,0
TIKI,cham-soc-nha-cua,191767363,"Viên rửa bát Ludwik All in one hộp 120 viên",599000,599000,0,0
TIKI,cham-soc-nha-cua,127381157,"Bộ 10 Viên Khử Mùi Tẩy Bồn Cầu Thế Hệ Mới - Viên Thả Toilet Diệt Khuẩn, Tẩy Sạch Vệ Sinh Vết Bám Bẩn",12200,12200,0,0
TIKI,cham-soc-nha-cua,39309534,"Hộp khử mùi làm thơm phòng hương Bạc hà- Air Fragrance 3481 - Hàng nội địa Nhật Bản",38500,38500,0,0
TIKI,cham-soc-nha-cua,54998143,"Combo 02 hộp sáp thơm khử mùi Shaldan Scent & Care 180g hàng Thái Lan  nhập khẩu",99200,99200,0,0
TIKI,cham-soc-nha-cua,103332605,"COMBO 8 GÓI GIẤY ĂN ĐA NĂNG 3 LỚP 150 TỜ ll TISSUE ",80000,80000,0,0
TIKI,cham-soc-nha-cua,4329197,"Combo 2 hộp khử mùi tủ giày hương trà xanh nội địa Nhật Bản",71500,71500,0,0
TIKI,cham-soc-nha-cua,58584058,"Hộp 100 viên rửa chén Finish All In 1 Dishwasher Tablets QT04592",599000,599000,0,0
TIKI,cham-soc-nha-cua,194407833,"Nước giặt xả SPY ULTRA CLEAN PLUS can 3,6 kg màu VÀNG 2 trong 1 Sạch sâu Thơm lâu Diệt khuẩn",192192,218400,26208,12
TIKI,cham-soc-nha-cua,125290073,"[HCM] 1 viên rửa bát chén Finish All in one 6 in 1",5934,5934,0,0
TIKI,cham-soc-nha-cua,122910067,"Viên rửa bát mới Finish Quamtum  siêu cao cấp 60 viên ( Đức )",219000,219000,0,0
TIKI,cham-soc-nha-cua,195285728,"Nước lau sàn hữu cơ  Sả Chanh An An, Dung tích 1 lít, chiết xuất bồ hòn thiên nhiên",118000,118000,0,0
TIKI,cham-soc-nha-cua,121326784,"68 viên rửa chén Finish ( loại viên lớn ) Đức",299000,299000,0,0
TIKI,cham-soc-nha-cua,167549410,"Giấy vệ sinh Fairy 10 cuộn 4 lớp có lõi cao cấp",110000,110000,0,0
TIKI,cham-soc-nha-cua,127459369,"Viên rửa chén bát Finish Quantum Max 60 viên hương táo chanh ",387897,387897,0,0
TIKI,cham-soc-nha-cua,56966233,"Bột Thông Ống Nước Siêu Mạnh Đa Năng 300g",31200,31200,0,0
TIKI,cham-soc-nha-cua,138039835,"Bình xịt nước cất hương thảo nguyên chất 50ml đuổi muỗi hiệu quả, an toàn cho gia đình",35000,35000,0,0
TIKI,cham-soc-nha-cua,195639420,"Kem Tẩy Rửa Đa Năng Saraya Liquid Cleanser - Chai 400g",92000,92000,0,0
TIKI,cham-soc-nha-cua,6616885,"Combo nước giặt đồ lót và tẩy các vết bẩn siêu mạnh 200ml + chai nước tẩy lồng máy giặt 400ml nội địa Nhật Bản",132500,132500,0,0
TIKI,cham-soc-nha-cua,85065376,"Nước thơm lau sàn nhà Hando can 5L Hương Hồng",104000,104000,0,0
TIKI,cham-soc-nha-cua,4620411,"Hộp 3 túi thơm phòng Mr. Fresh Hàn Quốc hương ngàn hoa khử mùi tủ quần áo (10g/gói)",35000,35000,0,0
TIKI,cham-soc-nha-cua,108246556,"Sáp thơm Candle Warmer - Zen Garden",199000,269000,70000,26
TIKI,cham-soc-nha-cua,14497421,"Nước giặt cổ áo bẩn Elmie dành cho da dị ứng và da khô - 300ml (Hàng Nội Địa Nhật Bản)",125000,125000,0,0
TIKI,cham-soc-nha-cua,121326026,"viên rửa bát finish combo 10 viên dùng thử",30000,30000,0,0
TIKI,cham-soc-nha-cua,168321191,"Nước rửa chén Mr.Fresh 4,2L Hàn Quốc không mùi",95000,95000,0,0
TIKI,cham-soc-nha-cua,169404167,"Combo 4 gel thơm làm sạch khử mùi vệ sinh Diệt khuẩn khử trùng bồn cầu hình bông hoa",17500,17500,0,0
TIKI,cham-soc-nha-cua,193699969,"Chai Xịt Tẩy Rửa Vệ Sinh Bồn Cầu Cực Mạnh Hương Nước Hoa Anh Đào, Khử Khuẩn, Siêu Sạch Không Độc Hại 500ml",22000,22000,0,0
TIKI,cham-soc-nha-cua,113041296,"Combo bột tẩy lồng máy giặt sinh học cực mạnh, không chứa Clo 750g + túi lưới giặt quần áo - nội địa Nhật Bản",165200,165200,0,0
TIKI,cham-soc-nha-cua,172190813,"Viên rửa chén bát Nhật Bản Finish Power Cube - Bịch 150 viên",359000,359000,0,0
TIKI,cham-soc-nha-cua,6217537,"Nước Tẩy Quần Áo (600ml) Rocket",35500,35500,0,0
TIKI,cham-soc-nha-cua,49075735,"[TẨY MỐC QUẦN ÁO - SÀN - TƯỜNG NHÀ] Chai xịt tẩy vết nấm mốc Hando 500ml",26000,26000,0,0
TIKI,cham-soc-nha-cua,52486025,"Viên rửa bát Finish 120 viên + Nước làm bóng Finish 800ml dùng cho Máy rửa bát",488667,977334,488667,50
TIKI,cham-soc-nha-cua,170768066,"Giấy vệ sinh Hà Nội Silk 4 lớp cao cấp",125000,125000,0,0
TIKI,cham-soc-nha-cua,42563071,"Viên thông tắc khử khuẩn đường ống vệ sinh - Nội Địa Nhật",40500,40500,0,0
TIKI,cham-soc-nha-cua,192585017,"Thùng 30 Gói Giấy Ăn Gấu Trúc Cao cấp Sipiao Mylan (300 tờ/gói) ",210000,350000,140000,40
TIKI,cham-soc-nha-cua,205293848,"Viên rửa bát Finish Quantum Ultemate 60 viên",490000,490000,0,0
TIKI,cham-soc-nha-cua,122910177,"Combo 100 viên rửa bát Finish + 1.5kg Muối rửa chén finish + Nước bóng Finish 750ml (Nk Đức)",538970,538970,0,0
TIKI,cham-soc-nha-cua,77333139,"Combo 2 Chai Nước Giặt Sinh Học ENZYCO Lên Mên Từ Dứa Và Bồ Hòn Không Hóa Chất An Toàn Cho Da Tay Giữ Quần Áp Sạch Bền - 2 Chai 1.8 Lít",560000,560000,0,0
TIKI,cham-soc-nha-cua,121326013,"Viên rửa chén Finish Nhật 150 viên",299000,299000,0,0
TIKI,cham-soc-nha-cua,137480189,"Combo 3 Bột giặt OMO Tinh dầu thơm 360g",59000,59000,0,0
TIKI,cham-soc-nha-cua,137479700,"COMBO 10 Túi Nước rửa chén Sunlight Chanh 100 Túi 750gx10",205000,205000,0,0
TIKI,cham-soc-nha-cua,66852414,"Dung Dịch Làm Sạch Men Sứ SMART-TS (300ml)",145000,145000,0,0
TIKI,cham-soc-nha-cua,122494095,"Gói Hút Ẩm 50 Gram đóng gói  1000Gram Silicagel - hạt hút ẩm thực phẩm quần áo giày dép máy ảnh hoa khô",40000,40000,0,0
TIKI,cham-soc-nha-cua,134760023,"15 viên rửa bát Finish ALL in 1 Lẻ",59200,59200,0,0
TIKI,cham-soc-nha-cua,198323969,"Viên giặt xả mền thơm quần áo",20000,29000,9000,31
TIKI,cham-soc-nha-cua,167561020,"Khăn giấy rút lụa ngắn Fairy 150 tờ x 3 lớp",14000,14000,0,0
TIKI,cham-soc-nha-cua,77233449,"Combo Nước Giặt Sinh Học Và Nước Rửa Chén Sinh Học ENZYCO Lên Men Từ Dứa Và Bồ Hòn An Toàn Cho Da Tay - Hương Cam",369000,369000,0,0
TIKI,cham-soc-nha-cua,12351000,"Nước hoa xịt thơm phòng Auramax 300ml hương Lavender (hoa lavender)",69300,69300,0,0
TIKI,cham-soc-nha-cua,119321604,"[NHẬP KHẨU ĐỨC]Chất tẩy rửa vệ sinh máy giặt 3 trong 1 250ml DENKMIT, Waschmaschinen-Pflege-Reiniger 3in1, 250 ml dùng cho máy giặt",180000,180000,0,0
TIKI,cham-soc-nha-cua,82416604,"Nước xả vải Downy Đam mê Dây 10 gói",20000,20000,0,0
TIKI,cham-soc-nha-cua,52613569,"Viên Sủi Tẩy Lồng Máy Giặt Hiệu Quả (Hộp 12 viên)",11750,11750,0,0
TIKI,cham-soc-nha-cua,7250723,"Chất Chống Tắc Nghẽn Bồn Cầu SiFa Siêu Tốc SiFa (1.6kg)",88000,88000,0,0
TIKI,cham-soc-nha-cua,174661054,"Nước giặt Fuwa3e hữu cơ organic từ chế phẩm Enzyme sinh học 500L an toàn cho bé, hương thơm mùi cam",19000,22000,3000,14
TIKI,cham-soc-nha-cua,179235691,"Chai xịt côn trùng RAID - Hương Lavender - Chai 600ml (Tặng thêm 100ml)",67000,67000,0,0
TIKI,cham-soc-nha-cua,171009587,"Combo 10 viên tẩy bồn cầu sạch sẽ thơm tho",18050,19000,950,5
TIKI,cham-soc-nha-cua,147873450,"Xịt đuổi muỗi Kincho dùng trong 200 ngày 45ml (2 loại) Hương hoa hồng",274400,280000,5600,2
TIKI,cham-soc-nha-cua,121949367,"Thiết bị phun khử mùi tự động DISPENSER 900 ( Không bao gồm bình)",330000,330000,0,0
TIKI,cham-soc-nha-cua,183352785,"NƯỚC LAU ĐA NĂNG SINH HỌC ENZYCO HƯƠNG HƯƠNG NHU VÀ BẠC HÀ – 500ML",120000,120000,0,0
TIKI,cham-soc-nha-cua,48876050,"Combo 2 bình xịt khử mùi sinh học đa năng Cleans Berg 250ml ",88000,88000,0,0
TIKI,cham-soc-nha-cua,196389710,"Combo 2 Túi Viên Giặt Xả MaxKleen Hương Huyền Diệu (34 viên/túi)",280000,280000,0,0
TIKI,cham-soc-nha-cua,205293825,"Túi 60 viên rửa bát Finish Quantum Dishwasher Tablets QT025459",399000,399000,0,0
TIKI,cham-soc-nha-cua,77913295,"Combo 4 gói Khăn giấy rút lụa Hà Nội ngắn 150 tờ",51000,51000,0,0
TIKI,cham-soc-nha-cua,180236052,"Nước Lau Sàn Cô Cà Chua Yêu Nước Thơm Mát Diệt Khuẩn 4L",360000,360000,0,0
TIKI,cham-soc-nha-cua,48212160,"Túi 54 Viên Giặt Xả 3D Gel Ball Nội Địa Nhật Bản",309000,309000,0,0
TIKI,cham-soc-nha-cua,564648,"Tẩy Rửa Dầu Mỡ Đa Năng Cho Nhà Bếp Degreaser Stanhome 36742 (750ml)",240000,285000,45000,16
TIKI,cham-soc-nha-cua,119483285,"Viên rửa bát Finish Quantum Max 100 viên 14 in 1",679845,679845,0,0
TIKI,cham-soc-nha-cua,46106961,"Thuốc diệt côn trùng trong nhà, diệt muỗi, không mùi dùng trong gia đình y tế Pekacon 100SC xuất xứ từ Mỹ",110000,110000,0,0
TIKI,cham-soc-nha-cua,191542825,"Máy Khử Mùi Diệt Khuẩn Tủ Lạnh",270000,270000,0,0
TIKI,cham-soc-nha-cua,197058682,"Chai Xịt Chuột Thái Lan , Xịt Mối , Xịt Kiến , Xịt Gián , Xịt Muỗi , Diệt Côn Trùng 200ml- 600ml",54990,54990,0,0
TIKI,cham-soc-nha-cua,77241807,"Combo Nước Giặt Sinh Học Và Nước Lau Sàn Sinh Học ENZYCO Lên Men Từ Dứa Và Bồ Hòn Không Hóa Chất Không Gây Ô Nhiễm Môi Trường",429000,429000,0,0
TIKI,cham-soc-nha-cua,77233521,"Khăn giấy rút lụa Fairy Classy 280 tờ",24500,24500,0,0
TIKI,cham-soc-nha-cua,10191106,"Chai Xịt Tẩy Ố Quần Áo An Toàn, Hiệu Quả - Nội Địa Nhật Bản",129000,129000,0,0
TIKI,cham-soc-nha-cua,195328326,"Nước rửa chén bát SPY hương Gừng Sả 1900ml thành phần thiên nhiên, an toàn, sạch nhanh dầu mỡ",71808,81600,9792,12
TIKI,cham-soc-nha-cua,191901726,"Viên rửa Finish Quantum/ Quantum Ultimate/Ultimate Pro/ Ultimate Pro Eco 0% dùng cho máy rửa chén bát",219000,219000,0,0
TIKI,cham-soc-nha-cua,150931402,"Combo Sản Phẩm Gốc Thực vật NRTB1 Peace Mass - Nước Rửa Tay 3.6 lít + Nước Rửa Chén 3.6 lít (Thuộc nhóm Sản phẩm Lành tính / Hữu cơ)",495900,522000,26100,5
TIKI,cham-soc-nha-cua,4633889,"Chai xịt tẩy vệ sinh khử khuẩn nhà tắm Sandokkaebi Korea 300ml",39000,39000,0,0
TIKI,cham-soc-nha-cua,272056938,"Thuốc Diệt Muỗi Map Permethrin 50 EC",119000,119000,0,0
TIKI,cham-soc-nha-cua,178058835,"1 gói 300 tờ 3 lớp giấy ăn Hoa lan cao cấp MyLan",9000,9000,0,0
TIKI,cham-soc-nha-cua,189534026,"Hộp 120 viên rửa chén Finish Classic Dishwasher Tablets QT09444",375000,758000,383000,51
TIKI,cham-soc-nha-cua,192714106,"sản phẩm diệt kiến và côn trùng Reagt gói 1.6gr",15000,15000,0,0
TIKI,cham-soc-nha-cua,122910039,"Muối rửa bát Finish loại 4kg (NK EU)",269000,269000,0,0
TIKI,cham-soc-nha-cua,53828558,"Túi 76 viên rửa chén Finish All In 1 Max Dishwasher Tablets Baking Soda QT04590",397955,418900,20945,5
TIKI,cham-soc-nha-cua,168383201,"Viên rửa bát Finish All-In-1 (6 tính năng) hộp 90 viên + Tặng viên Finish dùng thử",398000,398000,0,0
TIKI,cham-soc-nha-cua,179236454,"Chai xịt côn trùng RAID - Hương cam chanh 600ml (Tặng thêm 100ml)",67000,67000,0,0
TIKI,cham-soc-nha-cua,35866069,"Tẩy Nhà Tắm và Toilet Sumo 1 Lít",55000,55000,0,0
TIKI,cham-soc-nha-cua,173798865,"Thuốc Diệt Ốc Sên THÁI LAN - 100GR",29000,29000,0,0
TIKI,cham-soc-nha-cua,191377362,"Khăn giấy lụa Bless You À La Vie 2 lớp cao cấp gói 250 tờ",24960,24960,0,0
TIKI,cham-soc-nha-cua,65002439,"Xịt Phòng Tinh Dầu Oải Hương Hữu Cơ Organic 24Care 50ML/100ML - Kháng khuẩn - Khử mùi hôi - Đuổi muỗi - Côn trùng - Giúp thư giãn, cải thiện giấc ngủ - Giảm căng thẳng khi làm việc",44000,59000,15000,25
TIKI,cham-soc-nha-cua,175431310,"Xịt làm sạch, rã đông và khử mùi cho tủ lạnh và tủ đông Fridge &amp; Frezeer Stanhome 500ml/chai",264000,299000,35000,12
TIKI,cham-soc-nha-cua,98067367,"SÁP THƠM OASIS",54000,54000,0,0
TIKI,cham-soc-nha-cua,159259334,"Giấy vệ sinh Pharmacity (Gói 2 cuộn)",9500,9500,0,0
TIKI,cham-soc-nha-cua,163574938,"Giấy Nhà Bếp Đa Năng 2 Lớp (360 Tờ/Gói, 4 Gói/Xách)",89000,150000,61000,41
TIKI,cham-soc-nha-cua,206249697,"viên rửa bát Finish Nhật 150 viên x 5 g ( Nhật Bản ) - bóc ra bán lẻ 25 viên finish nhật - bán lẻ cho khách dùng thử",95000,95000,0,0
TIKI,cham-soc-nha-cua,24861776,"Túi châm nước rủa chén bát Layer Clean 2L hương quýt",83000,83000,0,0
TIKI,cham-soc-nha-cua,121326634,"Xà phòng rửa bát cho máy (dạng gel) chai 1500 ml KHỬ MÙI DIỆT KHUẨN ,vệ sinh máy , bột rửa bát , nuớc làm bóng Finish",109700,109700,0,0
TIKI,cham-soc-nha-cua,154429192,"[Nhập khẩu Đức] Dung Dịch Vệ Sinh Bếp Từ Denkmit Glaskeramikreiniger 3in1 bảo vệ mặt bếp, tẩy sạch dầu mỡ rất tiện dùng.",150000,150000,0,0
TIKI,cham-soc-nha-cua,140290512,"10 Bịch Khăn giấy Slisoft 4 lớp Vàng tự nhiên đa năng, giấy ăn không chất tẩy trắng an toàn cho cả gia đình",168500,180000,11500,6
TIKI,cham-soc-nha-cua,166563599,"Combo 03 Bột Rửa Chén Bát Hương Chanh Finish Classic Power Powder Lemon Sparkle chai 1 kg",750000,750000,0,0
TIKI,cham-soc-nha-cua,172573467,"Nước Lau Kính Kết Hợp Lau Bếp Gốc Thực Vật - Tinh dầu Bạc hà Peace Mass Làm Sạch Hoàn Hảo Vết Mỡ Ở Bếp Nấu (Thuộc nhóm Sản phẩm Lành tính / Hữu cơ) Chai Xịt 700ml",94050,99000,4950,5
TIKI,cham-soc-nha-cua,194848054,"Khăn giấy rút VinaTissue",25000,25000,0,0
TIKI,cham-soc-nha-cua,53547628,"combo viên rửa bát finish 100 viên+nước làm bóng finish 750ml+muối rửa bát finish 1,5kg dùng cho máy rửa bát",499000,499000,0,0
TIKI,cham-soc-nha-cua,191921928,"Nước lau sàn Lix hương nắng hạ dung tích 3.6 lít LH360 - thơm mát sáng bóng sàn",89000,89000,0,0
TIKI,cham-soc-nha-cua,140617167,"Nước rửa chén sinh học Greenlife 450ml",23000,23000,0,0
TIKI,cham-soc-nha-cua,152495697,"Nước giặt Good Care hương lavender 1,8L",130900,130900,0,0
TIKI,cham-soc-nha-cua,145832121,"Thuốc diệt muỗi, kiến, gián Fendona10SC Gói 5ml ruồi, bọ mạc, kiến ba khoang, côn trùng",25000,25000,0,0
TIKI,cham-soc-nha-cua,71972061,"Tẩy cáu cặn canxi, nước cứng, loang trắng, bảy màu trên kính HG-01 HARDWATER STAIN REMOVE 500ml",250000,250000,0,0
TIKI,cham-soc-nha-cua,57044058,"Combo 02 can giặt xả đậm đặc  July 2X 3500ml hàng Thái Lan nhập khẩu",356500,356500,0,0
TIKI,cham-soc-nha-cua,88779712,"Combo gồm 01 Gel PlasmaKare No5 và 01 Xịt chống muỗi PlasmaKare, TRl ngứa, làm xẹp vết đốt, mẩn đỏ do Muỗi và côn trùng cắn, chống muỗi và côn trùng, bảo vệ toàn diện da bé yêu",300000,300000,0,0
TIKI,cham-soc-nha-cua,104412370,"GIẤY VỆ SINH 10 CUỘN 3 LỚP XANH CÓ LÕI PRIME 1.5KG/ DÂY/ 10 CUỘN || TOILET PAPER",65000,65000,0,0
TIKI,cham-soc-nha-cua,82833827,"COMBO 6 dây Downy Huyền bí 10 gói x6",119000,119000,0,0
TIKI,cham-soc-nha-cua,44968286,"Nước Xả Vải Downy Đam Mê dạng túi 1.4L",105000,105000,0,0
TIKI,cham-soc-nha-cua,85064793,"Nước thơm lau sàn nhà Hando can 20L (Hương lavender)",345000,345000,0,0
TIKI,cham-soc-nha-cua,27558558,"Máy xịt nước hoa tự động Xinda PXQ288A",720000,720000,0,0
TIKI,cham-soc-nha-cua,193618566,"Sáp Thơm Phòng Ngủ Khử Mùi Sara Bông 75g Cao Cấp Phòng Máy Lạnh, Xe Ô Tô, Tủ Quần Áo, Nhà Vệ Sinh, Toilet",34000,34000,0,0
TIKI,cham-soc-nha-cua,76367311,"Set 3 Xịt loại bỏ cặn bám, cặn canxi, nước cứng nhà tắm Stanhome Express Shine 500ml",502000,597000,95000,16
TIKI,cham-soc-nha-cua,196315371,"Nước giặt quần áo Elmie không chất phụ gia dành cho trẻ sơ sinh và trẻ nhỏ - 2000ml  (Hàng nội địa Nhật Bản)",360000,360000,0,0
TIKI,cham-soc-nha-cua,197097531,"Nước giặt Lix đậm đặc hương hoa chai 2kg NG201 tăng gấp đôi sức mạnh giặt tẩy quần áo",75000,75000,0,0
TIKI,cham-soc-nha-cua,72743159,"Chai tẩy cặn canxi inox Sabo-I loại 1000ml - Chuyên dụng tẩy vết ố mốc, cặn canxi, tẩy cặn rỉ sét, mảng ố vàng, làm cho inox sáng bóng như mới",152900,278000,125100,45
TIKI,cham-soc-nha-cua,141310804,"Hóa chất xử lý cặn đóng cứng đường ống nước kháng ăn mòn C88 ",1899000,1899000,0,0
TIKI,cham-soc-nha-cua,191320779,"Bình xịt muỗi Raid hương lavender 660ml",69000,69000,0,0
TIKI,cham-soc-nha-cua,59249301,"Dung dịch tẩy rửa vệ sinh dầu mỡ, cáu cặn canxi dùng máy máy rửa bát hãng Finish Đức - HANOIMART",99000,99000,0,0
TIKI,cham-soc-nha-cua,134354794,"Combo 3 chai tẩy siêu mạnh",350000,350000,0,0
TIKI,cham-soc-nha-cua,122489081,"Gói Hút Ẩm 100 Gram đóng gói  1000Gram Silicagel - hạt hút ẩm thực phẩm quần áo giày dép máy ảnh hoa khô",19000,19000,0,0
TIKI,cham-soc-nha-cua,196389917,"Sáp ong đánh bóng  đồ gỗ  100gr ,vệ sinh nội thất ,chống thấm nước dễ dàng lau chùi luôn như mới",45000,45000,0,0
TIKI,cham-soc-nha-cua,90503830,"Máy làm sạch vệ sinh bằng hơi nước đa năng STEAM CLEANER",903500,903500,0,0
TIKI,cham-soc-nha-cua,127554914,"Nước hoa thơm phòng Hotel Series",22000,22000,0,0
TIKI,cham-soc-nha-cua,83149533,"Nước Giặt Pao Win Wash (chai 850ml)",104000,104000,0,0
TIKI,cham-soc-nha-cua,127687075,"Hộp khử mùi, thơm phòng hương hoa 300g Nội địa Nhật Bản",55000,55000,0,0
TIKI,cham-soc-nha-cua,188662742,"Túi hút ẩm, gói hút ẩm loại lớn 1KG hút ẩm phòng ngủ, tủ bếp, xe, treo container, nhà kho, nhà xưởng",39000,39000,0,0
TIKI,cham-soc-nha-cua,44119517,"Bộ 5 gói long não hương thiên nhiên khử mùi hiệu quả",89000,89000,0,0
TIKI,cham-soc-nha-cua,195750414,"Gel thơm khử mùi diệt khuẩn bồn cầu hình hoa - Henrysa",29000,58000,29000,50
TIKI,cham-soc-nha-cua,8211831,"Thuốc diệt chuột Storm 0.005% (20 gói x 4 viên)",180000,180000,0,0
TIKI,cham-soc-nha-cua,206253044,"viên rửa bát Finish Quantum 60 viên Dishwasher Tablets Apple & Lime - hương chanh, táo",399000,399000,0,0
TIKI,cham-soc-nha-cua,194770166,"Nước Lau Sàn Nhà Gỗ SPCa 4.5Kg Cao Cấp Sả Chanh Và Hương Quế Giúp Khử Mùi Làm Sạch Sàn Nhà",230000,230000,0,0
TIKI,cham-soc-nha-cua,58212167,"Chai xịt thơm phòng Hàn Quốc Sandokkaebi 300ml - Nhiều hương thơm",68500,68500,0,0
TIKI,cham-soc-nha-cua,169972473,"B15 12 - thuốc nuôi cao cấp cho gà đá - của MỸ - LỌ CHIẾC LẺ 50 VIÊN",180000,180000,0,0
TIKI,cham-soc-nha-cua,59549735,"Xịt làm sạch bề mặt nhựa, nhựa resin, nhựa PVC Stanhome PLASTIC CLEANER 350ml",252000,299000,47000,16
TIKI,cham-soc-nha-cua,169355769,"Xịt thơm phòng hương hoa Bưởi, khử mùi, làm thơm phòng, thư giãn, giải tỏa căng thẳng, thành phần 100% từ thiên nhiên.",85000,85000,0,0
TIKI,cham-soc-nha-cua,205291493,"Dung dịch vệ sinh máy rửa bát Finish hương chanh 250ml",111800,111800,0,0
TIKI,cham-soc-nha-cua,73878190,"Nước giặt đồ lót kháng khuẩn Lingerie Soap 120ML Nhật Bản",135000,135000,0,0
TIKI,cham-soc-nha-cua,183056340,"Khử mùi tủ lạnh Than hoạt tính Nhật Bản 150g",49000,49000,0,0
TIKI,cham-soc-nha-cua,2765807,"Hộp khử mùi thuốc lá hương chanh nội địa Nhật Bản",149000,149000,0,0
TIKI,cham-soc-nha-cua,205293635,"Viên rửa bát Finish Classic 110 viên/ hộp",369000,369000,0,0
TIKI,cham-soc-nha-cua,7496223,"Combo 3 hộp khử mùi tủ lạnh hương trà xanh nội địa Nhật Bản",99500,99500,0,0
TIKI,cham-soc-nha-cua,186817156,"Viên xả thơm quần áo lưu hương lâu mềm vải, viên xả vải, hạt xả thơm quần áo dùng cho máy giặt",28000,28000,0,0
TIKI,cham-soc-nha-cua,53484669,"Nước Rửa Rau Quả Và Chén Bát Lion Charm Green Hàn Quốc - Túi 1,2 lít",96000,125000,29000,23
TIKI,cham-soc-nha-cua,93934036,"Nước giặt đồ lót và các vết bẩn siêu mạnh Kose chiết xuất từ thiên nhiên 200ml",135000,135000,0,0
TIKI,cham-soc-nha-cua,116730033,"Combo 3 Hộp Viên Giặt Công Nghệ 3D Mới (Hộp 30 viên)",510000,510000,0,0
TIKI,cham-soc-nha-cua,3164607,"Chất Thông Tắc Cống Chống Hôi Siêu Mạnh 5 phút Sifa (1400g)",74000,74000,0,0
TIKI,cham-soc-nha-cua,134758548,"Viên rửa bát Finish All in 1 Max",79000,79000,0,0
TIKI,cham-soc-nha-cua,60219951,"Combo 02 chai tẩy đa năng giúp không gian sống của bạn sạch sẽ thoáng mát - Hàng nội địa Hàn Quốc",69500,69500,0,0
TIKI,cham-soc-nha-cua,51109480,"Viên tẩy toilet sạch thơm thơm sạch Hando 400 lần xả nước",25000,25000,0,0
TIKI,cham-soc-nha-cua,75517543,"Làm sạch & đánh bóng da Hando 600ml",75000,75000,0,0
TIKI,cham-soc-nha-cua,9421874,"Dung dịch tẩy rửa, chống rỉ và bôi trơn 3M 5-W",76000,76000,0,0
TIKI,cham-soc-nha-cua,205472423,"Bộ 3 viên rửa bát finish 110 viên + Nước làm bóng finish 750 ml+muối finish 1.2kg dùng cho máy rửa bát chén",569000,569000,0,0
TIKI,cham-soc-nha-cua,162209733,"Muối finish 4kg",126000,279600,153600,55
TIKI,cham-soc-nha-cua,193614462,"Sáp Thơm Phòng Ngủ Khử Mùi Sara Hồng Nhung 75g Cao Cấp Phòng Máy Lạnh, Xe Ô Tô, Tủ Quần Áo, Nhà Vệ Sinh, Toilet...",65000,65000,0,0
TIKI,cham-soc-nha-cua,81815298,"Nước rửa chén sinh học Fuwa 3e Từ enzyme vỏ trái cây - 3.8L An toàn cho sức khỏe",330000,330000,0,0
TIKI,cham-soc-nha-cua,121327193,"Combo Alio, Bộ sản phẩm dành cho máy rửa chén HÀNG ĐỨC",329000,329000,0,0
TIKI,cham-soc-nha-cua,121326330,"108 viên rửa chén bát Finish Quantum siêu cao cấp dùng cho máy",750000,750000,0,0
TIKI,cham-soc-nha-cua,152472961,"Nước thông tắc đa năng",45500,65000,19500,30
TIKI,cham-soc-nha-cua,174419025,"[Moment U] Set Combo Xịt Thơm Quần Áo Đa Năng Dành Cho Nam [MORNING + NIGHT]",227000,227000,0,0
TIKI,cham-soc-nha-cua,121082549,"Gói Hút Ẩm 1KG quy cách 2 Gram Silicagel - hạt hút ẩm thực phẩm quần áo giày dép máy ảnh NU DRY",35000,35000,0,0
TIKI,cham-soc-nha-cua,6473179,"Combo 2 Hộp Hút Ẩm Than Hoạt Tính Mr.Fresh Hàn Quốc",69000,69000,0,0
TIKI,cham-soc-nha-cua,139441650,"Chế phẩm KINAPER 50EC  diệt côn trùng và diệt khuẩn trong y tế - gia dụng",75000,75000,0,0
TIKI,cham-soc-nha-cua,193516559,"NƯỚC THÔNG CỐNG SIFA CHAI 700G cực mạnh thông tắc nhanh cầu lavabo đường ống thoát nước bồn rửa chén bát bị nghẹt",39990,39990,0,0
TIKI,cham-soc-nha-cua,90073999,"Xịt Khử Mùi Và Kháng Khuẩn Fuwa 3E Từ Enzyme Rau Củ Và Tinh Dầu Tự Nhiên",85000,85000,0,0
TIKI,cham-soc-nha-cua,122910776,"Dung dịch vệ sinh Finish bảo trì khử cặn máy rửa bát 250ml",99000,99000,0,0
TIKI,cham-soc-nha-cua,130209467,"Nước giặt tinh dầu dừacho  mẹ&bé cao cấp Hàn Quốc cả giặt máy và giặt tay.",166000,166000,0,0
TIKI,cham-soc-nha-cua,97729440," SIÊU TẨY DẦU MỠ 500ml ĐÁNH TAN VẾT DẦU MỠ MẶT BẾP, MÁY HÚT MÙI",99000,99000,0,0
TIKI,cham-soc-nha-cua,146490254,"Combo 6 ￼Túi thơm hoa hồng khô chất lượng cao",30000,30000,0,0
TIKI,cham-soc-nha-cua,193904046,"Thuốc diệt rắn Snake Killer (chai 250g).",599000,599000,0,0
TIKI,cham-soc-nha-cua,191424743,"Chai xịt khử mùi Sinh học - Hương Lavender - 177ml - Probiotics Air Refresh (SCD Probiotics, USA) - Lavender - 6 FL. OZ.",196000,196000,0,0
TIKI,cham-soc-nha-cua,36358788,"Bột tiêu, khử tóc trong đường ống vệ sinh",47000,47000,0,0
TIKI,cham-soc-nha-cua,67548792,"Nước làm bóng Finish 1150ml tặng túi zip 3 kẹo Senjaku Nhật Bản",235000,235000,0,0
TIKI,cham-soc-nha-cua,104351890,"Gói Hút Ẩm Silicagel đóng túi 1KG - Hạt chống ẩm mốc, khử mùi",71000,71000,0,0
TIKI,cham-soc-nha-cua,16933323,"Nước giặt xả 6 in 1 Sawady Thái Lan 3,8L Hương Golden Mimosa",135000,135000,0,0
TIKI,cham-soc-nha-cua,102522864,"Nước làm bóng Finish 400ml",109000,109000,0,0
TIKI,cham-soc-nha-cua,119645526,"Dung Dich Tẩy Cặn Canxi, Làm Sạch vòi sen Inox, Cabin, vách kính nhà tắm Dr.C CHÍNH HÃNG (Chai 300ml)",280000,280000,0,0
TIKI,cham-soc-nha-cua,172190815,"Bột rửa Somat 1.2kg dùng cho máy rửa chén bát",194999,194999,0,0
TIKI,cham-soc-nha-cua,205507003,"Viên rửa bát Finish Eco 0% - 70 viên/ hộp",359000,359000,0,0
TIKI,cham-soc-nha-cua,36704637,"Combo 2 bịch bột Rửa Ly - Bát Somat 1,2 Kg - Đức",398000,398000,0,0
TIKI,cham-soc-nha-cua,85065346,"Bộ 2 bình hút ẩm Hando 450ml TI322",64000,64000,0,0
TIKI,cham-soc-nha-cua,130049488,"Giấy Ví Đôi 3 Lớp - MyLan ",15000,15000,0,0
TIKI,cham-soc-nha-cua,111517814,"Bình xịt bọt tuyết tẩy rửa siêu sạch mầu cam kitchen cleaner nhà bếp 500ml",29998,29998,0,0
TIKI,cham-soc-nha-cua,152515906,"Nước rửa chén cao cấp Good Care tinh dầu thông",41300,59000,17700,30
TIKI,cham-soc-nha-cua,177903802,"Thuốc diệt gián hộp 12 viên an toàn cho người sử dụng",69000,69000,0,0
TIKI,cham-soc-nha-cua,142403589,"1 gói 560 tờ giấy rút hoa hồng cao cấp MyLan",19000,25000,6000,24
TIKI,cham-soc-nha-cua,185584398,"Hút ẩm tủ quần áo tủ giầy tủ bếp phòng ngủ hộp hút ẩm nhật bản tránh nấm mốc khử mùi hôi PU001",40500,40500,0,0
TIKI,cham-soc-nha-cua,189533968,"Bộ 3 sản phẩm Bột rửa bát finish 2.5kg+nước bóng 1150ml+Muối rửa chén finish 1.5kg cho Máy",890000,890000,0,0
TIKI,cham-soc-nha-cua,4358355,"Combo 2 hộp thuốc viên diệt gián nội địa Nhật Bản",74000,74000,0,0
TIKI,cham-soc-nha-cua,122910140,"Combo 04 Lọ Tinh Dầu Đuổi Muỗi (Nhập khẩu Nhật Bản )",399000,399000,0,0
TIKI,cham-soc-nha-cua,173587376,"Sáp thơm phòng Renuzit 12 mùi - Mỹ - 198g",45000,45000,0,0
TIKI,cham-soc-nha-cua,145613748,"Nước lau sàn Sunlight Thiên nhiên chiết xuất Chanh Zuzu & Sả Can 3.6KG",89000,89000,0,0
TIKI,cham-soc-nha-cua,169217933,"Gel thơm khử trùng bồn cầu - gel khử mùi bồn cầu dạng thạch hình bông hoa",14900,14900,0,0
TIKI,cham-soc-nha-cua,11084533,"Máy xịt phòng tự động điều khiển từ xa B3255 - Tặng kèm chai nước hoa hương trà xanh 300ml",850000,850000,0,0
TIKI,cham-soc-nha-cua,7249651,"Bột Thông Tắc Cống Cực Mạnh SiFa Victory's (200gr)",24900,24900,0,0
TIKI,cham-soc-nha-cua,106760617,"Kem Tẩy Rửa Xoong Nồi Đa Năng Hàn Quốc ,Đánh Bay Các Vết Bẩn Cứng Đầu",20000,20000,0,0
TIKI,cham-soc-nha-cua,195970237,"Chai xịt đuổi chuột SAMURAI CARE, không hóa chất độc hại, thân thiện với môi trường",58999,58999,0,0
TIKI,cham-soc-nha-cua,148865106,"[HSP114] Sáp thơm phòng [Giá hủy diệt] [Ảnh thật] khử mùi phòng ngủ nhà vệ sinh toilet ô tô với 4 mùi ",11995,11995,0,0
TIKI,cham-soc-nha-cua,4634429,"Chai xịt tẩy vệ sinh khử khuẩn bồn cầu, toilet Sandokkaebi Korea 300ml",39000,39000,0,0
TIKI,cham-soc-nha-cua,62751836,"Nước vệ sinh lồng máy giặt Elmie - Túi 350g (Hàng nội địa Nhật)",85000,85000,0,0
TIKI,cham-soc-nha-cua,68229696,"thuốc diệt kiến gián sinh học không mùi combo 3 chai 10ml",13000,13000,0,0
TIKI,cham-soc-nha-cua,59552983,"Đế đốt nhang muỗi hình bán nguyệt siêu dễ thương – Giá để nhang diệt muỗi tiện lợi, nhỏ gọn",99000,99000,0,0
TIKI,cham-soc-nha-cua,75664747,"Chai xịt làm sạch vách kính nhà tắm Hando 570ml",59000,59000,0,0
TIKI,cham-soc-nha-cua,172686607,"Combo 2 Nước Rửa Chén Lix Ngát Hương Chanh 3.6Kg/Canx2",133000,133000,0,0
TIKI,cham-soc-nha-cua,125341519,"Dung Dịch Tẩy Rửa Vết Máu Trên Quần Áo, Đồ Lót Siêu Sạch 200ML",115000,115000,0,0
TIKI,cham-soc-nha-cua,5869869,"Nước thơm lau sàn nhà Hando 5L ",95000,95000,0,0
TIKI,cham-soc-nha-cua,53653020,"Bột Thông Tắc Hầm Cầu Hando Gói 300g (Bao Bì Mới)",25000,25000,0,0
TIKI,cham-soc-nha-cua,169208142,"Thùng 36 gói Khăn giấy rút silkwell 280 tờ Cherry đỏ",605000,605000,0,0
TIKI,cham-soc-nha-cua,106381935,"PALO SANTO Gỗ Thanh Tẩy 4 - 7 - 14 Thanh và 100gr",145000,145000,0,0
TIKI,cham-soc-nha-cua,98736549," Bình nước hoa hương thảo mộc trà xanh cho máy xịt phòng tự động 300ml",104000,104000,0,0
TIKI,cham-soc-nha-cua,98130439,"Nước nhỏ thơm bồn cầu Kobayashi Shoshugen 20ml (2 mùi hương)",79000,79000,0,0
TIKI,cham-soc-nha-cua,87046438,"COMBO 2 Chai Nước giặt LIX Nha đam Aloe Vera bảo vệ da tay chai 3.8KGX2",220000,220000,0,0
TIKI,cham-soc-nha-cua,49904410,"Nước Lau Sàn Diệt Khuẩn Mao Bao Hương Làn Gió Biển chai 1000ml",39000,45000,6000,13
TIKI,cham-soc-nha-cua,176112253,"Lốc 10 cuộn giấy vệ sinh Bless You Famille - giấy 3 lớp mịn màng",117000,117000,0,0
TIKI,cham-soc-nha-cua,4019391,"Bột làm sạch đa năng Bar Keepers Friend Cleanser nhập khẩu USA chính hãng",120000,120000,0,0
TIKI,cham-soc-nha-cua,4986979,"Nước Giặt Đồ Lót Và Tẩy Các Vết Bẩn Siêu Mạnh Kose Chiết Xuất Từ Thiên Nhiên Kobini Nhật Bản (200ml)",109000,109000,0,0
TIKI,cham-soc-nha-cua,49465053,"Combo 3 gói khăn giấy khô likado 300g kích thước 14 x20cm khoảng 270 tờ",150000,150000,0,0
TIKI,cham-soc-nha-cua,52052783,"2 Can Bột rửa bát finish 2,5kg dùng cho máy rửa bát (2.5x2=5kg)",820000,820000,0,0
TIKI,cham-soc-nha-cua,54886724,"Xịt Phòng ASOHA 350ML Hương Hoa Lài",18000,30000,12000,40
TIKI,cham-soc-nha-cua,191947078,"Nước lau sàn Lix hương LiLy và hoa hồng dung tích 3.6L - LL360",89000,89000,0,0
TIKI,cham-soc-nha-cua,105301625,"Combo 5 Hộp Hút Ẩm HANDO Khử Mùi Nấm Mốc Hương Lavender 450ml",175000,175000,0,0
TIKI,cham-soc-nha-cua,34477209,"Combo 5 Túi Thơm Treo Tủ Đồ Đuổi Côn Trùng",23900,23900,0,0
TIKI,cham-soc-nha-cua,189541696,"Hộp than hoạt tính khử mùi tủ lạnh công nghệ cao Hopp ,giúp làm sạch không khí và ngăn vi khuẩn phát triển ",94050,99000,4950,5
TIKI,cham-soc-nha-cua,53895993,"Nước rửa chén diệt khuẩn cao cấp trà xanh LION 1000ml Hàn Quốc - Nước rửa chén Organic",102000,133000,31000,23
TIKI,cham-soc-nha-cua,169355401,"Xịt đuổi muỗi và côn trùng hương sả quế chai 300ml, thành phần an toàn tự nhiên, hiệu quả tốt.",115000,115000,0,0
TIKI,cham-soc-nha-cua,152924114,"Cuộn Giấy Lau Nhà Bếp Đa Năng  200 Tờ Màu Trắng Siêu Dai - Giấy Mềm Có Thể Giặt Được - Hàng Chính Hãng ",17000,54000,37000,69
TIKI,cham-soc-nha-cua,145613747,"Nước rửa chén Sunlight Chanh 100 Túi 750g",21000,21000,0,0
TIKI,cham-soc-nha-cua,17472757,"BỘT TẨY TRẮNG ĐA NĂNG OXI WASH (TÚI 120G & HỘP 680G) - NỘI ĐỊA NHẬT BẢN",39000,39000,0,0
TIKI,cham-soc-nha-cua,188662806,"COMBO 20 Gói Hút Ẩm Silicagel, Túi Hút Ẩm Cho Giày Dép Chống Ẩm Mốc 1 gram / túi",3800,3800,0,0
TIKI,cham-soc-nha-cua,12699566,"Long não 100g nhiều hương thiên nhiên thơm mát DT21",17000,17000,0,0
TIKI,cham-soc-nha-cua,205293866,"viên rửa chén bát finish maxin1 cao cấp chuyên dùng cho máy ( 12 trong 1) xuất xứ Mỹ",289000,289000,0,0
TIKI,cham-soc-nha-cua,199997953,"Nước giặt Lord Matic 3,8kg chuyên dùng cho máy giặt cửa trước",250000,250000,0,0
TIKI,cham-soc-nha-cua,20702124,"Nước lau sàn hữu cơ đuổi muỗi hương Sả Chanh 4000ml thương hiệu Ecocare",235000,260000,25000,10
TIKI,cham-soc-nha-cua,170857548,"THÙNG 30 GÓI GIẤY RÚT CẦU VỒNG, GIẤY RÚT GẤU TRÚC MYLAN 3 LỚP",199000,199000,0,0
TIKI,cham-soc-nha-cua,208632023,"Giẻ Lau Cotton Trắng Thấm Hút",35000,35000,0,0
TIKI,cham-soc-nha-cua,71892216,"Muối rửa bát Finish 1,5kg - Hàng chính hãng - Nhập khẩu EU",125000,125000,0,0
TIKI,cham-soc-nha-cua,170288534,"Xịt Thơm Quần Áo Hương Comfort Loại 100ml Siêu Lưu Hương",26000,26000,0,0
TIKI,cham-soc-nha-cua,68522083,"Gel rửa chén bát Finish Eco 0% - 900ml/ chai",339000,339000,0,0
TIKI,cham-soc-nha-cua,24862277,"Nước lau sàn Hữu cơ Layer Clean 1,25 lít hương gió biển",33000,33000,0,0
TIKI,cham-soc-nha-cua,172211910,"Viên xả thơm quần áo hương nước hoa - Hạt xả thơm làm mềm vải hàng nội địa trung lọ 100Gr - T2K Shop",18000,19900,1900,10
TIKI,cham-soc-nha-cua,84806611,"Thụt thông tắc bồn cầu, chậu rửa",120000,120000,0,0
TIKI,cham-soc-nha-cua,175806901,"Nước tẩy rửa nhà vệ sinh, toilet Wai can 4L",135000,135000,0,0
TIKI,cham-soc-nha-cua,124431563,"Giấy ăn Slisoft Vàng tự nhiên đa năng,khăn giấy rút thân thiện môi trường không chất tẩy trắng an toàn cho cả gia đình",17500,18000,500,3
TIKI,cham-soc-nha-cua,97872667,"BỘT RỬA BÁT FINISH HƯƠNG CHANH 2.5KG",550000,550000,0,0
TIKI,cham-soc-nha-cua,79781658,"Thuốc diệt mối thế hệ mới Termize 200SC diệt cả đàn (500ml)",1200000,1200000,0,0
TIKI,cham-soc-nha-cua,10004438,"Nước giặt xả 6 in 1 Sawady Thái Lan 3,8L Hương Golden Perfume",130000,130000,0,0
TIKI,cham-soc-nha-cua,104269813,"Chế phẩm diệt muỗi dùng trong gia dụng và y tế SECSAIGON",85000,85000,0,0
TIKI,cham-soc-nha-cua,129983114,"Nước làm bóng chén đĩa GRUN TAB Brilliance dùng cho máy rửa bát 750ml",100000,100000,0,0
TIKI,cham-soc-nha-cua,117101811,"Tẩy trắng đa năng xoong nồi nền nhà Kem tẩy nồi đa năng - chất tẩy xoong nồi",20000,20000,0,0
TIKI,cham-soc-nha-cua,35221940,"Thuốc diệt chuột Killrat (100g/hộp) - dạng cốm",45000,45000,0,0
TIKI,cham-soc-nha-cua,191947484,"Nước lau sàn Lix đuổi côn trùng dung tích 2L - NLS2",49000,49000,0,0
TIKI,cham-soc-nha-cua,16653906,"Nước lau sàn Layer Clean hương Poppy Coach 5L",137500,137500,0,0
TIKI,cham-soc-nha-cua,558039,"Chai Xịt Chống Muỗi PARA’KITO™ - PSPRAY01",499000,499000,0,0
TIKI,cham-soc-nha-cua,10405518,"Dung dịch đa năng PROCA Tinh dầu sả chanh thiên nhiên 1100ml",69000,69000,0,0
TIKI,cham-soc-nha-cua,11387127,"Nước giặt vải len, vải dạ, nỉ Sandokkaebi 500g nhập khẩu Hàn Quốc",34500,34500,0,0
TIKI,cham-soc-nha-cua,52777339,"Túi 80 viên rửa chén Finish All In 1 Max Dishwasher Tablets QT025451",388455,408900,20445,5
TIKI,cham-soc-nha-cua,195527537,"Thuốc diệt muỗi nhập khẩu nguyên chai Anh Quốc Permethrin Plus 50EC chai 200 ml",320000,320000,0,0
TIKI,cham-soc-nha-cua,51133309,"Viên tẩy sạch và làm thơm xanh Hando 5 viên Value Pack",52000,52000,0,0
TIKI,cham-soc-nha-cua,150710181,"Viên làm sạch lồng giặt Ion Bạc Welco - 70g",139000,139000,0,0
TIKI,cham-soc-nha-cua,127459684,"Xịt nhà tắm tinh dầu 24CARE 50m/100ml/250ml - Xịt lau chùi bồn rửa tay, kính - Khử mùi hôi sàn, không khí",35250,47000,11750,25
TIKI,cham-soc-nha-cua,65101041,"Xịt Phòng Tinh Dầu Bạch Đàn Chanh Hữu Cơ Organic 24Care 50ML/100ML - Kháng khuẩn - Khử mùi hôi - Đuổi muỗi, côn trùng - Hương thơm mạnh mẽ giúp tái tạo năng lượng nhanh, giảm stress hiệu quả",49000,49000,0,0
TIKI,cham-soc-nha-cua,57658367,"Combo 5 Viên hút ẩm chống côn trùng gỗ long não 2x10cm",15789,15789,0,0
TIKI,cham-soc-nha-cua,166567268,"Combo 04 túi Viên Rửa Chén Bát Hương Chanh Finish Powerball All In 1 Max Lemon Sparkle 30 viên",791000,1597800,806800,50
TIKI,cham-soc-nha-cua,153839573,"Viên rửa bát Finish cho máy rửa bát 150viên-",299000,299000,0,0
TIKI,cham-soc-nha-cua,58940856,"Máy xịt phòng tự động Hàn Quốc Sandokkaebi 450g - Giao màu ngẫu nhiên",271500,271500,0,0
TIKI,cham-soc-nha-cua,41932368,"EcoClean ECOSOCK - Thông Tắc TỨC THỜI, Phân Hủy Tóc, Dầu Mỡ, Thức Ăn, Chất Thải - Hộp 500 gr",345000,362000,17000,5
TIKI,cham-soc-nha-cua,179796695,"Bột Tẩy vệ sinh lồng máy giặt SANDOKKAEBI nội địa Hàn Quốc 450g",28500,28500,0,0
TIKI,cham-soc-nha-cua,193994006,"Nước Xịt Thơm Phẳng Quần Áo Lưu Hương Lâu SPCa 450ml Cao Cấp Giúp Làm Thơm Phẳng, Khử Trùng, Khử Mùi Ẩm Mốc",48000,48000,0,0
TIKI,cham-soc-nha-cua,7473855,"Nước thông tắc đường ống Hando 1000ml Nội địa",37000,37000,0,0
TIKI,cham-soc-nha-cua,172842309,"Túi 30 viên long não băng phiến khử mùi xua đuổi côn trùng 120Gr (Thiên Nhiên An Toàn)",20000,20000,0,0
TIKI,cham-soc-nha-cua,169684174,"Gel thơm khử trùng bồn cầu, gel khử mùi bồn cầu dạng thạch hình bông hoa với 6 mùi thơm cho toilet",10000,10000,0,0
TIKI,cham-soc-nha-cua,121327187,"dụng cụ vệ sinh bếp từ bếp hồng ngoại ,Dao cạo putzboy vệ sinh bếp từ Hàng Đức",137000,137000,0,0
TIKI,cham-soc-nha-cua,12293133,"Sáp thơm Safie 165g nhiều hương thiên nhiên thơm mát",22000,22000,0,0
TIKI,cham-soc-nha-cua,88968871," Thuốc diệt kiến gián sinh học Bảo Châu",5000,5000,0,0
TIKI,cham-soc-nha-cua,508465,"Combo 2 Bột Giặt Tide Hương Downy 5kg",359000,359000,0,0
TIKI,cham-soc-nha-cua,69092729,"Bình xịt vệ sinh dụng cụ bếp Astonish C6700 750ml",119000,119000,0,0
TIKI,cham-soc-nha-cua,4987001,"Hộp Thơm Phòng Hương Hoa Hồng Kobini Nhật Bản (200ml)",49000,49000,0,0
TIKI,cham-soc-nha-cua,150938231,"Combo Sản Phẩm Gốc Thực Vật LSB1 Peace Mass - Nước Lau Sàn TD Chanh Sả - Bạc Hà 3.6l + Nước Rửa Chén 500ml (Thuộc nhóm Sản phẩm Lành tính / Hữu cơ)",239400,252000,12600,5
TIKI,cham-soc-nha-cua,159728946,"Sáp thơm phòng khử mùi phòng ngủ, nhà vệ sinh, tủ quần áo , Hộp 190ml có nhiều mùi hương",14000,14000,0,0
TIKI,cham-soc-nha-cua,162166359,"Combo 2 Can Dung dịch giặt quần áo en bé D-nee 3000ml",405000,430000,25000,6
TIKI,cham-soc-nha-cua,191452761,"Dây Thông Tắc Cống Dạng Lò Xo Dây Phi 10 - Sử Dụng Bằng Khoan dài 5m và 1 đầu kết lối máy khoan",399000,399000,0,0
TIKI,cham-soc-nha-cua,193564892,"Viên Tẩy Vệ Sinh Lồng Máy GiặtI Diệt khuẩn và Tẩy chất cặn Lồng máy giặt hiệu quả- JL",4000,4000,0,0
TIKI,cham-soc-nha-cua,222196133,"Dung dịch tẩy rửa đa năng Ecosophy chất tẩy đa năng số 1 Nhật Bản 100% từ tự nhiên an toàn với da tay loại bỏ khử mùi mọi vết bẩn nhanh chóng [TKT Mart",35000,35000,0,0
TIKI,cham-soc-nha-cua,53609103,"Tẩy dầu mỡ bếp cáu két lâu ngày HT01-TVS-500ML",139000,180000,41000,23
TIKI,cham-soc-nha-cua,13831146,"Nước Lau Sàn Layer Clean 1,25ML",39000,39000,0,0
TIKI,cham-soc-nha-cua,102736523," Bột thông tắc cống bồn cầu thần thánh, siêu gói thuốc cho đường ống",76999,76999,0,0
TIKI,cham-soc-nha-cua,119989562,"GIẤY VỆ SINH 3 LỚP PRIME (1,6KG) CÓ LÕI - COMBO 2 DÂY MÀNG NHŨ",155000,155000,0,0
TIKI,cham-soc-nha-cua,174610634,"Combo Sản Phẩm  Gốc Thực Vật TLB2 Peace Mass - Nước Cọ Toilet + Nước Lau Kính 3.6l+ Nước Rửa Tay 3.6l (Thuộc nhóm Sản phẩm Lành tính / Hữu cơ)",1154250,1215000,60750,5
TIKI,cham-soc-nha-cua,174665700,"Nước Lau Sàn Hữu Cơ Fuwa3e Sả Chanh 100ml Xua Đuổi Côn Trùng An Toàn Cho bé",17000,24000,7000,29
TIKI,cham-soc-nha-cua,83750841," Viên Tẩy Lồng Máy Giặt  - Vệ Sinh Máy Giặt, Diệt Sạch Vi Khuẩn, Vệ Sinh Lồng Máy Giặt Và Khử Mùi Hiệu Quả - Dạng Sủi Xuất Xứ Nhật Bản",16000,16000,0,0
TIKI,cham-soc-nha-cua,173697635,"Kem vệ sinh bảo dưỡng đồ dùng bằng da Astonish C6960 250ml làm sạch vết bẩn trên đồ dùng làm bằng da., đồng thời thẩm thấu, tái tạo lại sự đàn hồi dẻo dai của da, chăm sóc da khỏi bị khô nứt, hoặc ẩm mốc",169000,225000,56000,25
TIKI,cham-soc-nha-cua,187514236,"Hộp 12 viên tẩy vệ sinh lồng máy giặt sủi sạch vi khuẩn tẩy sạch cặn bẩn lồng giặt ",20000,20000,0,0
TIKI,cham-soc-nha-cua,20588026,"Nước xả vải làm mềm vải Comfort Chăm sóc Chuyên sâu Hương nước hoa thiên nhiên Sophia túi 3.2L",179000,179000,0,0
