ecommerce,category,original_id,name,price,original_price,discount,discount_rate
TIKI,nha-sach-tiki,74021317,"Cây Cam Ngọt Của Tôi",75500,108000,32500,30
TIKI,nha-sach-tiki,188940817,"Vị Thần Của Những Quyết Định",51300,79000,27700,35
TIKI,nha-sach-tiki,189643105,"Không Phải Sói Nhưng Cũng Đừng Là Cừu -Tặng kèm bookmark 2 mặt",92100,128000,35900,28
TIKI,nha-sach-tiki,26114399,"Nóng Giận Là Bản Năng , Tĩnh Lặng Là Bản Lĩnh",64900,89000,24100,27
TIKI,nha-sach-tiki,109017985,"Thiên Tài Bên Trái, Kẻ Điên Bên Phải (Tái Bản)",129000,179000,50000,28
TIKI,nha-sach-tiki,174301838,"BỘ BOOKMARK 1% TINH HOA",49000,49000,0,0
TIKI,nha-sach-tiki,52789367,"Nhà Giả Kim (Tái Bản 2020)",61500,79000,17500,22
TIKI,nha-sach-tiki,174444163,"Dear, Darling",63300,88000,24700,28
TIKI,nha-sach-tiki,69764541,"Tâm Lý Học Hành Vi (Tặng Kèm 1 Bookmark )",70500,98000,27500,28
TIKI,nha-sach-tiki,147920903,"Một Thoáng Ta Rực Rỡ Ở Nhân Gian",108000,135000,27000,20
TIKI,nha-sach-tiki,121635154,"Điều Đẹp Nhất Có Khi Là Buông Tay (Tặng Kèm Bookmark)",51700,72000,20300,28
TIKI,nha-sach-tiki,73787185,"Những Tù Nhân Của Địa Lý",168000,210000,42000,20
TIKI,nha-sach-tiki,42230121,"Sách Hiểu Về Trái Tim (Tái Bản 2019) - Minh Niệm",129000,158000,29000,18
TIKI,nha-sach-tiki,3954355,"Yêu Những Điều Không Hoàn Hảo",108000,139000,31000,22
TIKI,nha-sach-tiki,275243138,"Rèn Luyện Tư Duy Phản Biện - 2019",65600,71100,5500,8
TIKI,nha-sach-tiki,73207240,"Xa Ngoài Kia Nơi Loài Tôm Hát - Where The Crawdads Sing",135000,165000,30000,18
TIKI,nha-sach-tiki,117238177,"Thư Viện Nửa Đêm",120000,150000,30000,20
TIKI,nha-sach-tiki,143217512,"Điềm Tĩnh Và Nóng Giận",69900,96000,26100,27
TIKI,nha-sach-tiki,72882553,"Kỷ Luật Tự Giác (Tặng Kèm Bookmark )",65400,84000,18600,22
TIKI,nha-sach-tiki,193151000,"Trend Following – Cách thức để kiếm được VẬN MAY LỚN và GIÀU CÓ trong các thị trường BÒ, GẤU và các sự kiện THIÊN NGA ĐEN",599000,599000,0,0
TIKI,nha-sach-tiki,195969664,"Tokyo Revengers - Tập 4",46000,115000,69000,60
TIKI,nha-sach-tiki,121635152,"Không Ai Có Thể Làm Bạn Tổn Thương Trừ Khi Bạn Cho Phép (Tặng Kèm 1 Bộ Bookmark Gồm 4 Cái)",84900,119000,34100,29
TIKI,nha-sach-tiki,85763211,"Hãy Khiến Tương Lai Biết Ơn Vì Hiện Tại Bạn Đã Cố Gắng Hết Mình (Tặng Kèm: 01 Bookmark)",73200,99000,25800,26
TIKI,nha-sach-tiki,106863963,"Tâm Lý Học - Phác Họa Chân Dung Kẻ Phạm Tội",105000,145000,40000,28
TIKI,nha-sach-tiki,196515658,"Blue Period - Tập 04",33500,48000,14500,30
TIKI,nha-sach-tiki,117254517,"Đại Dương Đen - Những Câu Chuyện Từ Thế Giới Của Trầm Cảm",192000,240000,48000,20
TIKI,nha-sach-tiki,157432544,"Giải Thích Ngữ Pháp Tiếng Anh (Với Bài Tập Và Đáp Án) (Tái Bản)",144000,220000,76000,35
TIKI,nha-sach-tiki,68585576,"Càng Kỷ Luật, Càng Tự Do",79500,109000,29500,27
TIKI,nha-sach-tiki,194959173,"Semantic Error – Lỗi Logic (Tập 2)",155000,259000,104000,40
TIKI,nha-sach-tiki,194960721,"Blue Period - Tập 03",33700,48000,14300,30
TIKI,nha-sach-tiki,111285062,"Đắc Nhân Tâm (Bìa Mềm)(Tái Bản)",59200,86000,26800,31
TIKI,nha-sach-tiki,190861557,"Yêu Những Ngày Nắng Chẳng Ghét Những Ngày Mưa",59000,132000,73000,55
TIKI,nha-sach-tiki,145288029,"Xứ Cát",124000,249000,125000,50
TIKI,nha-sach-tiki,168283405,"Chiến Tranh Tiền Tệ - Phần 1 - Ai Thực Sự Là Người Giàu Nhất Thế Giới ( Tái Bản 2022)",119000,165000,46000,28
TIKI,nha-sach-tiki,10095276,"Ikigai - Bí Mật Sống Trường Thọ Và Hạnh Phúc Của Người Nhật",71900,90000,18100,20
TIKI,nha-sach-tiki,54614797,"Có Một Ngày, Bố Mẹ Sẽ Già Đi",67100,96000,28900,30
TIKI,nha-sach-tiki,72459686,"How Psychology Works - Hiểu Hết Về Tâm Lý Học",225000,300000,75000,25
TIKI,nha-sach-tiki,161008715,"Power Vs Force - Trường Năng Lượng Và Những Nhân Tố Quyết Định Hành Vi Của Con Người (Tái Bản)",134000,179000,45000,25
TIKI,nha-sach-tiki,3304875,"Điều Kỳ Diệu Của Tiệm Tạp Hóa NAMIYA (Tái Bản)",83900,105000,21100,20
TIKI,nha-sach-tiki,113530805,"Tuổi Trẻ Đáng Giá Bao Nhiêu (Tái Bản)",70100,90000,19900,22
TIKI,nha-sach-tiki,3639597,"Bước Chậm Lại Giữa Thế Gian Vội Vã (Tái Bản)",66200,85000,18800,22
TIKI,nha-sach-tiki,17336364,"Phía Sau Nghi Can X (Tái Bản 2019)",95800,129000,33200,26
TIKI,nha-sach-tiki,4780917,"Người Đua Diều (Tái Bản 2018)",102000,129000,27000,21
TIKI,nha-sach-tiki,92859698,"Tâm Lý Học Biểu Cảm",71400,98000,26600,27
TIKI,nha-sach-tiki,78598381,"Tâm Lý Học Tính Cách (Tặng Kèm: 1 Bookmark)",76200,109000,32800,30
TIKI,nha-sach-tiki,161008717,"Kiếp Nào Ta Cũng Tìm Thấy Nhau: Câu Chuyện Về Những Linh Hồn Tri Kỷ Vĩnh Viễn Không Chia Lìa (Tái Bản)",72200,99000,26800,27
TIKI,nha-sach-tiki,10005245,"Đàn Ông Sao Hỏa Đàn Bà Sao Kim",128000,188000,60000,32
TIKI,nha-sach-tiki,104612965,"FLASHCARD SachID Moon",10000,10000,0,0
TIKI,nha-sach-tiki,52788072,"Chiến Binh Cầu Vồng (Tái Bản 2020)",83800,109000,25200,23
TIKI,nha-sach-tiki,168373800,"Sách - Thao túng tâm lý - 1980BOOKS",109000,169000,60000,36
TIKI,nha-sach-tiki,8885995,"Sự Im Lặng Của Bầy Cừu (Tái Bản)",90700,115000,24300,21
TIKI,nha-sach-tiki,187338036,"Chiến Tranh Tiền Tệ - Tập 4",125000,185000,60000,32
TIKI,nha-sach-tiki,161310103,"Từ Vựng IELTS 8.0 - Từ Vựng Đắt Để Đạt Điểm Cao 4 Kỹ Năng",94400,135000,40600,30
TIKI,nha-sach-tiki,77774625,"Nghệ Thuật Tập Trung - Nâng Cao Năng Suất, Tối Ưu Thời Gian, Hiệu Quả Bất Ngờ",71900,99000,27100,27
TIKI,nha-sach-tiki,53720978,"Trong Cái Không Có Gì Không ? (Thiền Sư Thích Nhất Hạnh Trả Lời Cho Trẻ Em Những Thắc Mắc Về Ý Nghĩa Cuộc Sống, Về Cái Chết, Về Gia Đình, Bạn Bè Và Nhiều Câu Hỏi Khác)",126000,160000,34000,21
TIKI,nha-sach-tiki,49747007,"Hai Mặt Của Gia Đình",68500,98000,29500,30
TIKI,nha-sach-tiki,195801686,"Black Jack - Tập 13 (Bìa Mềm)",28100,30000,1900,6
TIKI,nha-sach-tiki,114937969,"Rừng Nauy (Tái Bản)",118000,150000,32000,21
TIKI,nha-sach-tiki,90622579,"Tâm Lý Học - Nghệ Thuật Giải Mã Hành Vi",105000,150000,45000,30
TIKI,nha-sach-tiki,57325187,"Sách Người Giàu Có Nhất Thành Babylon (Tái Bản 2020)",68500,98000,29500,30
TIKI,nha-sach-tiki,106318762,"Sách ID Tiếng Anh cho người mới bắt đầu - người mới mất gốc Cô Trang Anh",153000,250000,97000,39
TIKI,nha-sach-tiki,76388962,"Chúng Ta Rồi Sẽ Hạnh Phúc, Theo Những Cách Khác Nhau [Tặng Kèm: 01 Bookmark]",61800,86000,24200,28
TIKI,nha-sach-tiki,20917699,"Làm Sao Học Ít Hiểu Nhiều",83300,128000,44700,35
TIKI,nha-sach-tiki,184466860,"Hành Tinh Của Một Kẻ Nghĩ Nhiều",61800,86000,24200,28
TIKI,nha-sach-tiki,3014291,"Máy Tính Khoa Học Casio FX-580VN X",697000,784000,87000,11
TIKI,nha-sach-tiki,75307228,"Sách OSHO Yêu - Being In Love - Yêu Trong Tỉnh Thức",110000,168000,58000,35
TIKI,nha-sach-tiki,19792256,"Chuyện Con Mèo Dạy Hải Âu Bay (Tái Bản 2019)",38100,49000,10900,22
TIKI,nha-sach-tiki,7833728,"Dạy Con Làm Giàu (Tập 1) - Để Không Có Tiền Vẫn Tạo Ra Tiền - Cha Giàu Cha Nghèo (Tái Bản)",63900,80000,16100,20
TIKI,nha-sach-tiki,109505434,"Bạn Không Thông Minh Lắm Đâu (Tái Bản)(Tặng kèm Bookmark)",97200,139000,41800,30
TIKI,nha-sach-tiki,104769768,"Máy Tính CASIO FX580VN X-BU (Màu",680000,799700,119700,15
TIKI,nha-sach-tiki,197558905,"Komi - Nữ Thần Sợ Giao Tiếp - Tập 13",22400,25000,2600,10
TIKI,nha-sach-tiki,69978860,"Sói đội lốt Cừu - Kẻ hiếu chiến ngầm và các thủ thuật thao túng tâm lí",66000,110000,44000,40
TIKI,nha-sach-tiki,71345381,"Sách Thay Đổi Cuộc Sống Với Nhân Số Học - Lê Đỗ Quỳnh Hương",136000,248000,112000,45
TIKI,nha-sach-tiki,193614514,"[Gift] Tặng 01 bookmark cho mỗi đơn hàng",30000,30000,0,0
TIKI,nha-sach-tiki,15267827,"Hoàng Tử Bé (Tái Bản 2019)",59900,75000,15100,20
TIKI,nha-sach-tiki,112110014,"TÂM LÝ HỌC ỨNG DỤNG",93900,129000,35100,27
TIKI,nha-sach-tiki,197558907,"Bá Tước Tiểu Thư - Tập 4",28400,30000,1600,5
TIKI,nha-sach-tiki,54266567,"Sách Nghĩ Giàu Và Làm Giàu (Bìa Mềm)",75500,110000,34500,31
TIKI,nha-sach-tiki,80628929,"Từ IQ Đến EQ - Nắm Bắt Thành Công Qua Trí Tuệ Cảm Xúc",65400,91000,25600,28
TIKI,nha-sach-tiki,106185389,"Tổng ôn ngữ pháp Tiếng Anh cô Trang Anh- Sách luyện thi THPT Quốc gia môn tiếng anh",181000,250000,69000,28
TIKI,nha-sach-tiki,147999778,"Không Bao Giờ Là Thất Bại - Tất Cả Là Thử Thách (Ấn Bản Cập Nhật Đầy Đủ Nhất)(Bìa Cứng)",120000,268000,148000,55
TIKI,nha-sach-tiki,138107485,"Mặt Dày Tâm Đen (Tái Bản)",114000,169000,55000,33
TIKI,nha-sach-tiki,103640412,"Đừng Lựa Chọn An Nhàn Khi Còn Trẻ (Tái Bản)",71200,99000,27800,28
TIKI,nha-sach-tiki,168293266,"Chiến Tranh Tiền Tệ - Phần 2 - Sự Thống Trị Của Quyền Lực Tài Chính ( Tái Bản 2022)",122000,170000,48000,28
TIKI,nha-sach-tiki,195969669,"Chào Mừng Đến Lớp Học Đề Cao Thực Lực - 3 - Bản Đặc Biệt - Kèm Camera Card Độc Quyền, Số Lượng Có Hạn",95900,120000,24100,20
TIKI,nha-sach-tiki,174215347,"Ajin - Boxset Số 3 (Tập 13 - 17) - Tặng Kèm Bookmark 3D",135000,270000,135000,50
TIKI,nha-sach-tiki,196016785,"Ikigami - Tập 08",41800,45000,3200,7
TIKI,nha-sach-tiki,103379147,"Bạch Dạ Hành (Tái Bản)",165000,209000,44000,21
TIKI,nha-sach-tiki,72308265,"Hoa Vẫn Nở Mỗi Ngày",186000,234000,48000,21
TIKI,nha-sach-tiki,197587856,"Kẻ Thù Không Đội Trời Chung Của Tôi Cuối Cùng Cũng Phá Sản – Tập 1 + 2",267000,315000,48000,15
TIKI,nha-sach-tiki,56454897,"Hiệu Sách Nhỏ Ở Paris",117000,149000,32000,21
TIKI,nha-sach-tiki,23416722,"How The Body Works - Hiểu Hết Về Cơ Thể",240000,300000,60000,20
TIKI,nha-sach-tiki,184070223,"OSHO - Cảm Xúc",132000,188000,56000,30
TIKI,nha-sach-tiki,196923457,"Blue Flag - Tập 2",43600,45000,1400,3
TIKI,nha-sach-tiki,139303869,"Nghệ Thuật Tinh Tế Của Việc Đếch Quan Tâm (Tái Bản)",92100,128000,35900,28
TIKI,nha-sach-tiki,91947689,"7 Thói Quen Hiệu Quả (The 7 Habits Of Highly Effective People) - Stephen R. Covey - PACE Books",188000,250000,62000,25
TIKI,nha-sach-tiki,127844385,"Kiêu Hãnh Và Định Kiến (Tái Bản)",87000,116000,29000,25
TIKI,nha-sach-tiki,140416370,"Dòng Chảy",160000,228000,68000,30
TIKI,nha-sach-tiki,107802183,"Sách Sức Mạnh Tiềm Thức (Tái Bản) (Bìa Mềm)",89500,128000,38500,30
TIKI,nha-sach-tiki,76013378,"Storytelling With Data - Kể Chuyện Thông Qua Dữ Liệu (Cuốn Cẩm Nang Hướng Dẫn Trực Quan Hóa Dữ Liệu)",239000,319000,80000,25
TIKI,nha-sach-tiki,8835159,"Đời Ngắn Đừng Ngủ Dài (Tái Bản)",59900,85000,25100,30
TIKI,nha-sach-tiki,59262880,"Sách Người Bán Hàng Vĩ Đại Nhất Thế Giới (Tái Bản 2020)",102000,148000,46000,31
TIKI,nha-sach-tiki,74341297,"Không Sợ Chậm Chỉ Sợ Dừng",92800,129000,36200,28
TIKI,nha-sach-tiki,70224520,"Băng keo dán nano 2 mặt siêu dính trong suốt dày 1mm dài 2m rộng 3cm và 5cm",30000,30000,0,0
TIKI,nha-sach-tiki,27582931,"How Money Works - Hiểu Hết Về Tiền",237000,300000,63000,21
TIKI,nha-sach-tiki,72001057,"Chiến Tranh Tiền Tệ - Phần III",120000,175000,55000,31
TIKI,nha-sach-tiki,148760924,"How Management Works - Hiểu Hết Về Quản Lý",257000,330000,73000,22
TIKI,nha-sach-tiki,157255752,"Sức Mạnh Của Hiện Tại (Tái Bản)",118000,168000,50000,30
TIKI,nha-sach-tiki,192115858,"Chú Thuật Hồi Chiến -  Tập 5 - Giao Lưu Trường Kết Nghĩa Kyoto [Tặng Kèm Obi Và Thẻ Bo Góc Nhựa]",26400,30000,3600,12
TIKI,nha-sach-tiki,5067169,"Luật Hấp Dẫn (Tái Bản)",68400,89000,20600,23
TIKI,nha-sach-tiki,7718737,"Nghệ Thuật Tư Duy Rành Mạch (Tái Bản)",91900,118000,26100,22
TIKI,nha-sach-tiki,82912488,"Từ Tốt Đến Vĩ Đại (Tái bản 2021)",91100,130000,38900,30
TIKI,nha-sach-tiki,94173458,"Khuyến Học (Tái Bản)",51300,65000,13700,21
TIKI,nha-sach-tiki,194205608,"Cherry Magic - Tập 2",72900,109000,36100,33
TIKI,nha-sach-tiki,21367457,"Tôn Tử Binh Pháp ( Tái Bản )",59900,88000,28100,32
TIKI,nha-sach-tiki,173882437,"8 Vụ Án Hoàn Hảo - Vạch Trần Tâm Lý Kẻ Phạm Tội",104000,145000,41000,28
TIKI,nha-sach-tiki,3608625,"Payback Time - Ngày Đòi Nợ",299000,299000,0,0
TIKI,nha-sach-tiki,196851308,"Dragon Ball Full Color - Phần Năm: Truy Lùng Cell Bọ Hung - Tập 4",74600,77000,2400,3
TIKI,nha-sach-tiki,181699664,"Những Ngã Tư Và Những Cột Đèn",150000,200000,50000,25
TIKI,nha-sach-tiki,167972598,"Tôi Thích Bản Thân Nỗ Lực Hơn (Ấn Bản Kỷ Niệm)",84900,120000,35100,29
TIKI,nha-sach-tiki,120219394,"Tôi Nói Gì Khi Nói Về Chạy Bộ",59900,76000,16100,21
TIKI,nha-sach-tiki,192124399,"Blue Period Tập 2",33700,48000,14300,30
TIKI,nha-sach-tiki,179546672,"Làm Sao Học Hết Được Nhân Sinh",133000,169000,36000,21
TIKI,nha-sach-tiki,185067342,"Tô Bình Yên Vẽ Hạnh Phúc (Tái Bản)",63300,88000,24700,28
TIKI,nha-sach-tiki,11338092,"Hiểu Về Trump",125000,249000,124000,50
TIKI,nha-sach-tiki,108684605,"Trí Thông Minh Của Sự Tinh Tế",64000,89000,25000,28
TIKI,nha-sach-tiki,85396163,"Combo 2 Cuốn: Yêu Những Điều Không Hoàn Hảo + Bước Chậm Lại Giữa Thế Gian Vội Vã (Tái Bản)",170000,224000,54000,24
TIKI,nha-sach-tiki,163703151,"Chuyện Kể Rằng Có Nàng Và Tôi",51700,72000,20300,28
TIKI,nha-sach-tiki,196409700,"Công Chúa Ma Cà Rồng Quyền Năng Chỉ Muốn Có Một Người Em Gái Mà Thôi",136000,175000,39000,22
TIKI,nha-sach-tiki,55605170,"Cơ Thể Tự Chữa Lành: Thực Phẩm Thay Đổi Cuộc Sống",128000,185000,57000,31
TIKI,nha-sach-tiki,76776245,"Nghệ Thuật Tư Duy Phản Biện",83000,129000,46000,36
TIKI,nha-sach-tiki,52329763,"Kafka bên bờ biển (Tái Bản 2020)",126000,158000,32000,20
TIKI,nha-sach-tiki,105483727,"Ổn Định Hay Tự Do",92800,129000,36200,28
TIKI,nha-sach-tiki,124767703,"Cân Bằng Cảm Xúc Cả Lúc Bão Giông (Tặng Kèm Bookmark)(Tái Bản)",75600,105000,29400,28
TIKI,nha-sach-tiki,194205620,"Người Hướng Nội Trong Thế Giới Hướng Ngoại",83900,105000,21100,20
TIKI,nha-sach-tiki,171549981,"Cuộc Diễu Hành Thầm Lặng",154000,198000,44000,22
TIKI,nha-sach-tiki,273624916,"[ Trạm Đọc Official ]  Trí Tuệ Do Thái (Tái Bản)",142000,189000,47000,25
TIKI,nha-sach-tiki,179735872,"Sách Tâm Lý Dành Cho Người Nhạy Cảm",63800,89000,25200,28
TIKI,nha-sach-tiki,197353399,"Học Viện Siêu Anh Hùng Vigilantes - My Hero Academia Illegals - Tập 1: Đã Có Ta Ở Đây",27100,30000,2900,10
TIKI,nha-sach-tiki,69219919,"Muôn Kiếp Nhân Sinh (Khổ Nhỏ)",67500,98000,30500,31
TIKI,nha-sach-tiki,105663942,"Hành Trình Về Phương Đông (Tái Bản 2021)",82700,118000,35300,30
TIKI,nha-sach-tiki,8886007,"Ngàn Mặt Trời Rực Rỡ (Tái Bản)",104000,130000,26000,20
TIKI,nha-sach-tiki,158019962,"Combo 3 Cuốn Bộ Sách: Nuôi Con Không Phải Là Cuộc Chiến 2 (Tái Bản)",264000,377000,113000,30
TIKI,nha-sach-tiki,195885688,"Dragon Quest - Dấu Ấn Roto (Dragon Quest Saga Emblem Of Roto) Perfect Edition - Tập 9",72700,75000,2300,3
TIKI,nha-sach-tiki,71907876,"Từ Điển Tiếng “Em”",49600,69000,19400,28
TIKI,nha-sach-tiki,540039,"Giáo Trình Chuẩn HSK 1 - Bài Học (Kèm file MP3)",156000,198000,42000,21
TIKI,nha-sach-tiki,191920180,"Cherry Magic - Tập 1",72900,109000,36100,33
TIKI,nha-sach-tiki,139567621,"Thức Tỉnh Mục Đích Sống (Tái Bản)",99200,148000,48800,33
TIKI,nha-sach-tiki,100931416,"Bắt Đầu Với Câu Hỏi Tại Sao - Nghệ Thuật Truyền Cảm Hứng Trong Kinh Doanh (Tái Bản)",81700,109000,27300,25
TIKI,nha-sach-tiki,195187480,"Thiên Quan Tứ Phúc - Tập 6 (Tiểu thuyết, đam mỹ)",124000,159000,35000,22
TIKI,nha-sach-tiki,149089470,"Những Vị Thần Nước Mỹ",200000,250000,50000,20
TIKI,nha-sach-tiki,168234714,"Cư Xử Như Đàn Bà Suy Nghĩ Như Đàn Ông",81500,109000,27500,25
TIKI,nha-sach-tiki,185071145,"Sói Đầu Đàn Và Cún Nhỏ - Tập 2",108000,135000,27000,20
TIKI,nha-sach-tiki,126743459,"Fear - Sợ Hãi (Hóa Giải Sợ Hãi Bằng Tình Thương)",76100,109000,32900,30
TIKI,nha-sach-tiki,154245455,"Combo 2 Cuốn Nghiền Từ Vựng Tiếng Anh: Học Qua Gốc Từ Bằng Hình Ảnh - Gốc Từ Là Bí Quyết Để Ghi Nhớ Hàng Nghìn Từ Vựng",211000,270000,59000,22
TIKI,nha-sach-tiki,194960246,"Dược Sư Tự Sự (Combo 2 Manga Tập 5- 6 + 1 Light-Novel Tập 2 ) [Tặng Standee Ivory + Bookmark + Postcard Có Chân Đế + Postcard PVC]",204000,204000,0,0
TIKI,nha-sach-tiki,13333355,"Đọc Nhiều Nhớ Được Bao Nhiêu?",78900,118000,39100,33
TIKI,nha-sach-tiki,194960238,"Slam Dunk - Deluxe Edition - Tập 10",53900,60000,6100,10
TIKI,nha-sach-tiki,196851826,"Mi Mục Như Họa",104000,139000,35000,25
TIKI,nha-sach-tiki,196422809,"Bá Tước Tiểu Thư - Tập 3",28400,30000,1600,5
TIKI,nha-sach-tiki,104741661,"Combo 2 Tập : 999 Lá Thư Gửi Cho Chính Mình (Tái Bản)",204000,258000,54000,21
TIKI,nha-sach-tiki,35191892,"21 Bài Học Cho Thế Kỷ 21",163000,209000,46000,22
TIKI,nha-sach-tiki,167210779,"Quyền Lực",124000,155000,31000,20
TIKI,nha-sach-tiki,14508205,"Sổ tay thực hành 66 ngày thử thách",89000,89000,0,0
TIKI,nha-sach-tiki,73878873,"Tư Duy Sâu",66300,91000,24700,27
TIKI,nha-sach-tiki,77105730,"Tàn Ngày Để Lại (Bìa Cứng)",132000,169000,37000,22
TIKI,nha-sach-tiki,54748899,"Sách Muôn Kiếp Nhân Sinh (Bìa Mềm) - Nguyên Phong",116000,168000,52000,31
TIKI,nha-sach-tiki,196016781,"Kingdom - Tập 33",40600,45000,4400,10
TIKI,nha-sach-tiki,750578,"Khi Hơi Thở Hóa Thinh Không",80700,109000,28300,26
TIKI,nha-sach-tiki,3608623,"Bí Mật Của Phan Thiên Ân",69000,69000,0,0
TIKI,nha-sach-tiki,45902241,"Tìm Mình Trong Thế Giới Hậu Tuổi Thơ",111000,142000,31000,22
TIKI,nha-sach-tiki,152740748,"Lối Sống Tối Giản Của Người Nhật (Tái Bản)",88900,119000,30100,25
TIKI,nha-sach-tiki,57110087,"Siêu Cò – How To Be A Power Connector",249000,249000,0,0
TIKI,nha-sach-tiki,196851310,"Migi & Dali - Tập 2",38700,40000,1300,3
TIKI,nha-sach-tiki,12377498,"Bố Con Cá Gai (Tái Bản 2019)",76700,96000,19300,20
TIKI,nha-sach-tiki,170708233,"Thay Đổi Tí Hon - Hiệu Quả Bất Ngờ Atomic Habits (Tái Bản Lần 4)",132000,189000,57000,30
TIKI,nha-sach-tiki,57762732,"Nhà Đầu Tư Thông Minh (Tái Bản 2020)",159000,199000,40000,20
TIKI,nha-sach-tiki,110448022,"Ba Phút Sơ Cứu",109000,140000,31000,22
TIKI,nha-sach-tiki,87226756,"Những Đêm Không Ngủ, Những Ngày Chậm Trôi",50100,86000,35900,42
TIKI,nha-sach-tiki,196515661,"Văn Phòng Thám Tử Quái Vật - Tập 12",27800,30000,2200,7
TIKI,nha-sach-tiki,50414368,"Án Mạng Mười Một Chữ",82300,110000,27700,25
TIKI,nha-sach-tiki,158019964,"Combo 4 Cuốn Bộ Sách: Nuôi Con Không Phải Là Cuộc Chiến (Tái Bản)",384000,506000,122000,24
TIKI,nha-sach-tiki,53532186,"Tuyệt kỹ Giao dịch bằng đồ thị nến Nhật – Japanese Candlestick Charting Techniques",499000,499000,0,0
TIKI,nha-sach-tiki,90887853,"Mình Chỉ Là Người Bình Thường (Sách Tô Màu)",97900,138000,40100,29
TIKI,nha-sach-tiki,9948009,"Dám Hạnh Phúc",85700,110000,24300,22
TIKI,nha-sach-tiki,187827003,"Không Diệt Không Sinh Đừng Sợ Hãi (TB5)",71600,110000,38400,35
TIKI,nha-sach-tiki,183058543,"OSHO - Trưởng Thành",89500,128000,38500,30
TIKI,nha-sach-tiki,115266692,"Sách - Ám Ảnh Sợ Xã Hội - Chạy Trốn Hay Đối Mặt",56000,125000,69000,55
TIKI,nha-sach-tiki,128649312,"21 Nguyên Tắc Tự Do Tài Chính (Tái Bản)",41200,55000,13800,25
TIKI,nha-sach-tiki,84970841,"Men Chase Women Choose - Chuyện Tình Yêu Bạn Biết Được Bao Nhiêu?",74000,109000,35000,32
TIKI,nha-sach-tiki,145289356,"Sách Atomic Habits - Thay Đổi Tí Hon, Hiệu Quả Bất Ngờ ( Những Thay Đổi Nhỏ Tạo Nên Thành Công Lớn/ Tặng kèm Bookmark)",156870,189000,32130,17
TIKI,nha-sach-tiki,641906,"Bí Mật Của Naoko",85900,108000,22100,20
TIKI,nha-sach-tiki,191571494,"Black Jack - Tập 12",27500,30000,2500,8
TIKI,nha-sach-tiki,185242031,"The Shining - Thị Kiến",210000,269000,59000,22
TIKI,nha-sach-tiki,378448,"Nhà Giả Kim",68950,68950,0,0
TIKI,nha-sach-tiki,17336360,"Lolita (Tái Bản 2019)",99700,128000,28300,22
TIKI,nha-sach-tiki,173865570,"Một Cuốn Sách Về Chủ Nghĩa Tối Giản (Tái bản 2022)",129000,129000,0,0
TIKI,nha-sach-tiki,179546078,"Luật Hấp Dẫn - Quy Luật Về Sức Mạnh Tâm Trí Và Phát Huy Năng Lượng Tích Cực Để Làm Chủ Định Mệnh",101000,139000,38000,27
TIKI,nha-sach-tiki,162844699,"Tạm Biệt Tôi Của Nhiều Năm Về Trước",68300,95000,26700,28
TIKI,nha-sach-tiki,186237324,"Thiên quan tứ phúc - Tập 5 (Tiểu thuyết đam mỹ) - Tặng kèm 1 bookmark 2 mặt",127000,159000,32000,20
TIKI,nha-sach-tiki,145288026,"Chia Rẽ - Tại Sao Chúng Ta Đang Sống Trong Thời Đại Của Những Bức Tường",158000,200000,42000,21
TIKI,nha-sach-tiki,86517373,"Khoa Học Về Nấu Ăn - The Science Of Cooking",267000,350000,83000,24
TIKI,nha-sach-tiki,104074997,"Kỹ Năng Bán Hàng Tuyệt Đỉnh (Tái Bản)",80300,120000,39700,33
TIKI,nha-sach-tiki,2496281,"Đồi Gió Hú (Tái Bản)",89900,120000,30100,25
TIKI,nha-sach-tiki,73515859,"Sách OSHO - Can Đảm Là Chính Mình Trong Thế Giới Hiểm Nguy",61500,88000,26500,30
TIKI,nha-sach-tiki,11122712,"Bộ sách Làm Giàu Từ Chứng Khoán (How To Make Money In Stock) phiên bản mới + Hướng Dẫn Thực Hành CANSLIM Cho Người Mới Bắt Đầu",700000,700000,0,0
TIKI,nha-sach-tiki,197990865,"Dragon Quest - Dấu Ấn Roto (Dragon Quest Saga Emblem Of Roto) Perfect Edition - Tập 10",67400,75000,7600,10
TIKI,nha-sach-tiki,130233544,"Mèo Và Triết Lý Nhân Sinh - Mèo Đã Dạy Chúng Ta Điều Gì Về Cuộc Sống",152000,209000,57000,27
TIKI,nha-sach-tiki,7982628,"Suối Nguồn (Tái Bản)",215000,380000,165000,43
TIKI,nha-sach-tiki,168559521,"Sự Trung Thực Của Xác Chết – Ghi Chép Của Một Nhà Pháp Y",74200,99000,24800,25
TIKI,nha-sach-tiki,11368965,"Combo Giáo Trình Chuẩn HSK 1 - Bài Học (Kèm 1 MP3) và Giáo Trình Chuẩn HSK 1 - Bài Tập (Kèm 1 MP3) ( Tặng Kèm Viết )",284800,356000,71200,20
TIKI,nha-sach-tiki,828621,"Dolocher (Trinh Thám)",159000,159000,0,0
TIKI,nha-sach-tiki,155550591,"Dinh Dưỡng Học Bị Thất Truyền - Dinh Dưỡng Đẩy Lùi Bệnh Tật",128000,178000,50000,28
TIKI,nha-sach-tiki,194960244,"Fullmetal Alchemist - Cang Giả Kim Thuật Sư - Fullmetal Edition - Tập 16",66100,69000,2900,4
TIKI,nha-sach-tiki,196851314,"Nữ Chúa Tuyết",37700,40000,2300,6
TIKI,nha-sach-tiki,66090079,"Cơ Thể Tự Chữa Lành: Giải Cứu Gan",154000,250000,96000,38
TIKI,nha-sach-tiki,194104216,"Văn Phòng Thám Tử Quái Vật - Tập 11",27100,30000,2900,10
TIKI,nha-sach-tiki,73316977,"Hành Trình Của Linh Hồn (Tái Bản 2020)",96700,129000,32300,25
TIKI,nha-sach-tiki,174842858,"Sách Sức Mạnh Của Ngôn Từ (Tái Bản 2022)",75500,108000,32500,30
TIKI,nha-sach-tiki,52584834,"Tư Duy Hệ Thống Trong Công Việc",53400,89000,35600,40
TIKI,nha-sach-tiki,176909221,"Ngôi Nhà Bên Bờ Biển Xanh Thẳm",125000,174000,49000,28
TIKI,nha-sach-tiki,179063952,"Khi Mọi Điểm Tựa Đều Mất",68500,98000,29500,30
TIKI,nha-sach-tiki,274802547,"Tư Duy Phản Biện",54200,54200,0,0
TIKI,nha-sach-tiki,147988185,"Combo 2 Cuốn "Hiểu Hết" : How Business Works - Hiểu Hết Về Kinh Doanh + How Money Works - Hiểu Hết Về Tiền",483000,680000,197000,29
TIKI,nha-sach-tiki,35283863,"Lược Sử Thế Giới",248000,320000,72000,23
TIKI,nha-sach-tiki,130996082,"Bồ Câu Bay Đi Tìm Bà",61500,77000,15500,20
TIKI,nha-sach-tiki,106864418,"Combo 10 Cuốn: Chuyện Xóm Gà",435000,580000,145000,25
TIKI,nha-sach-tiki,197352631,"Anh Em Nhà Motohashi – Tập 3",38800,68000,29200,43
TIKI,nha-sach-tiki,22881852,"English Grammar in Use Book w Ans",162300,198000,35700,18
TIKI,nha-sach-tiki,179546070,"Luật Hấp Dẫn - Quy Luật Về Sức Mạnh Của Linh Hồn Và Năng Lượng Chữa Lành Cơ Thể Từ Bên Trong",85500,129000,43500,34
TIKI,nha-sach-tiki,126743464,"Kế Hoạch Của Linh Hồn - Khám Phá Ý Nghĩa Cuộc Sống Mà Bạn Đã Lên Kế Hoạch Trước Khi Sinh Ra",122000,169000,47000,28
TIKI,nha-sach-tiki,52785564,"Dịch Hạch (Nobel Văn Chương 1957)",103000,129000,26000,20
TIKI,nha-sach-tiki,102629318,"999 Lá Thư Gửi Cho Chính Mình (*) - Tập 1 - Mong Bạn Trở Thành Phiên Bản Hoàn Hảo Nhất (Tái bản)",92800,129000,36200,28
TIKI,nha-sach-tiki,11371249,"Chuyện Con Mèo Và Con Chuột Bạn Thân Của Nó - Tái Bản",30300,39000,8700,22
TIKI,nha-sach-tiki,52805060,"Chúa Ruồi - Tiểu Thuyết (Nobel Văn Chương 1983)(Tái Bản 2020)",69400,88000,18600,21
TIKI,nha-sach-tiki,191782162,"Trên Đường Băng (Tony Buổi Sáng)",78800,105000,26200,25
TIKI,nha-sach-tiki,21130350,"Vụ Án LEROUGE (Trinh Thám)",168000,168000,0,0
TIKI,nha-sach-tiki,540040,"Giáo Trình Chuẩn HSK 1 - Bài Tập (Kèm file MP3)",118000,158000,40000,25
TIKI,nha-sach-tiki,159004131,"Semantic Error – Lỗi Logic (Tập 1) - Bản thường (Tặng Kèm 01 Bookmark + 01 Postcard)",186000,259000,73000,28
TIKI,nha-sach-tiki,195357772,"Máy Tính CASIO FX-880BTG - Màu Đen",719000,799700,80700,10
TIKI,nha-sach-tiki,196923452,"Birdmen - Tập 7",28700,30000,1300,4
TIKI,nha-sach-tiki,160997378,"Giải Thích Ngữ Pháp Tiếng Anh Với Bài Tập Và Đáp Án (TB 2022) - Tác giả Mai Lan Hương, Hà Thanh Uyên",147000,220000,73000,33
TIKI,nha-sach-tiki,66619715,"Sách Vị Tu Sĩ Bán Chiếc Ferrari (Tái Bản)",68500,98000,29500,30
TIKI,nha-sach-tiki,186434700,"Người Bà Tài Giỏi Vùng Saga – Tập 8",41000,52000,11000,21
TIKI,nha-sach-tiki,190238356,"Kỷ Luật Bản Thân",125200,189000,63800,34
TIKI,nha-sach-tiki,25557704,"Bãi săn người - Trinh Thám Kinh Dị",78000,162000,84000,52
TIKI,nha-sach-tiki,157240665,"Ra Bờ Suối Ngắm Hoa Kèn Hồng (Truyện Dài-Nguyễn Nhật Ánh) - Bìa Mềm (Màu Hồng) (Tặng Kèm Bookmark Bồi Hai Mặt, Thiệp Trái Tim In Bài Thơ Của Tác Giả)",114000,145000,31000,21
TIKI,nha-sach-tiki,57761618,"Vụ Án Mạng Ở Lữ Quán Kairotei",97900,123000,25100,20
TIKI,nha-sach-tiki,79672197,"Bí Mật Của May Mắn (Khổ Nhỏ)(Tái Bản)",30900,45000,14100,31
TIKI,nha-sach-tiki,70016690,"Thế Giới Rộng Lớn Lòng Người Chật Hẹp (Tặng Kèm 1 Bookmark )",62500,92000,29500,32
TIKI,nha-sach-tiki,1926761,"Khởi Nghiệp Bán Lẻ - Bí Quyết Thành Công Và Giàu Có Bằng Những Cửa Hàng Đông Khách - Công Thức Kinh Doanh Và Quản Lý Cửa Hàng Hiệu Quả",118000,199000,81000,41
TIKI,nha-sach-tiki,50751279,"Vui Vẻ Không Quạu Nha - Tản Văn",49600,69000,19400,28
TIKI,nha-sach-tiki,14053724,"Sự Cứu Rỗi Của Thánh Nữ",102000,128000,26000,20
TIKI,nha-sach-tiki,160081250,"Tăng Cường Sức Mạnh Não Bộ",95900,120000,24100,20
TIKI,nha-sach-tiki,66067655,"Trải Nghiệm Khách Hàng Xuất Sắc",200000,250000,50000,20
TIKI,nha-sach-tiki,67271338,"Sách OSHO - Trò Chuyện Với Vĩ Nhân",135000,198000,63000,32
TIKI,nha-sach-tiki,162205263,"Những Đồ Vật Có Linh Hồn - Bản Thường (Tặng Kèm 1 Bookmark)",107000,149000,42000,28
TIKI,nha-sach-tiki,85029033,"Truyện Cổ Grimm (Ấn Bản Đầy Đủ Nhất Kèm 184 Minh Hoạ Của Philipp Grot Johann Và Robert Leinweber)",483000,680000,197000,29
TIKI,nha-sach-tiki,100931414,"Cách Khen Cách Mắng Cách Phạt Con (Tái Bản)",51700,69000,17300,25
TIKI,nha-sach-tiki,1938915,"Sự Tiếp Xúc Của Văn Hóa Việt Nam Với Pháp",81750,109000,27250,25
TIKI,nha-sach-tiki,137741275,"Ngỡ Như Lương Thiện, Hóa Ra Mềm Yếu",89700,125000,35300,28
TIKI,nha-sach-tiki,141333746,"Chúng Ta Học Thế Nào - How We Learn (Sự Thật Khó Tin Về Việc Học Nó Diễn Ra Khi Nào, Ở Đâu , Và Tại Sao)",118000,150000,32000,21
TIKI,nha-sach-tiki,187190676,"Black Jack - Tập 11",29000,30000,1000,3
TIKI,nha-sach-tiki,104314401,"Sách Bí Mật Của May Mắn (Khổ Lớn) (Tái Bản)",47500,68000,20500,30
TIKI,nha-sach-tiki,164336673,"How The Brain Works - Hiểu Hết Về Bộ Não",264000,330000,66000,20
TIKI,nha-sach-tiki,13419678,"Sách Đi Tìm Lẽ Sống (Tái Bản )",61700,88000,26300,30
TIKI,nha-sach-tiki,3976835,"Velma - Trinh Thám Cổ Điển Phương Tây",35000,49500,14500,29
TIKI,nha-sach-tiki,186286187,"Nhà Lãnh Đạo Không Chức Danh",86000,105000,19000,18
TIKI,nha-sach-tiki,108501279,"Viết Đi Đừng Sợ! Từ Tay Không Thành Tay Viết",194000,245000,51000,21
TIKI,nha-sach-tiki,143186001,"Chiến Thắng Con Quỷ Trong Bạn - Bí Quyết Tự Do Và Thành Công (Tái Bản)",88500,115000,26500,23
TIKI,nha-sach-tiki,193433626,"Kỹ năng tự học cho trẻ tiểu học",149000,199000,50000,25
TIKI,nha-sach-tiki,184070221,"Sách OSHO Hiểu - Đường Đến Tự Do",118000,168000,50000,30
TIKI,nha-sach-tiki,69644752,"Toàn Thư Chiêm Tinh Học Nhập Môn",217000,350000,133000,38
TIKI,nha-sach-tiki,95218451,"Lần Đầu Làm Mẹ - Tổng Hợp Những Kiến Thức Mới Nhất Về Mang Thai Và Sinh Nở (Tái Bản)",179000,260000,81000,31
TIKI,nha-sach-tiki,193988323,"Sa Vào Ánh Hào Quang Của Người – Tập 2",82700,138000,55300,40
TIKI,nha-sach-tiki,196001691,"Viên Tiên Sinh Luôn Không Vui - Tập 2",108000,179000,71000,40
TIKI,nha-sach-tiki,195801644,"Black Jack - Tập 13 (Bìa Cứng)",122000,135000,13000,10
TIKI,nha-sach-tiki,49910019,"Bác Sĩ Riêng Của Bé Yêu - Chào Con! Ba Mẹ Đã Sẵn Sàng (Tái Bản)",77800,95000,17200,18
TIKI,nha-sach-tiki,48481763,"Thiên Nga Đen (Tái Bản 2020)",223000,299000,76000,25
TIKI,nha-sach-tiki,52597663,"Đừng Chạy Theo Số Đông - Cuốn Sách Bạn Cần Đọc Trước Khi Quá Muộn",124000,200000,76000,38
TIKI,nha-sach-tiki,13624088,"Nghĩ Thiện Để Cuộc Đời Và Công Việc Viên Mãn",62900,85000,22100,26
TIKI,nha-sach-tiki,7916685,"All The Rule - Bình Tĩnh Khi Ế, Mạnh Mẽ Khi Yêu",53400,86000,32600,38
TIKI,nha-sach-tiki,100958457,"Gieo Trồng Hạnh Phúc (Tái Bản)",56960,89000,32040,36
TIKI,nha-sach-tiki,45321594,"Nghệ Thuật Bán Hàng Của Người Hướng Nội",92700,119000,26300,22
TIKI,nha-sach-tiki,184774173,"Những Người Nhật Tử Tế",91000,148000,57000,39
TIKI,nha-sach-tiki,145288031,"Tarot Toàn Thư - Đọc Vận Mệnh Qua Những Lá Bài",247000,380000,133000,35
TIKI,nha-sach-tiki,90469338,"Combo 5 cuốn: Cơ Thể Tự Chữa Lành",701000,923000,222000,24
TIKI,nha-sach-tiki,119694726,"Combo 6 cuốn Ehon Kích thích thị giác - Âm thanh cho Trẻ sơ sinh",117000,234000,117000,50
TIKI,nha-sach-tiki,145287904,"Sách - Giận (Tái Bản 2021)(Cuốn sách hay của Thiền sư Thích Nhất Hạnh/ Tặng kèm Bookmark)",128650,128650,0,0
TIKI,nha-sach-tiki,160759005,"Cơ Thể Tự Chữa Lành - Thanh Lọc Để Phục Hồi",192000,295000,103000,35
TIKI,nha-sach-tiki,170297937,"Tâm Lý Học Về Sự Lo Âu",90200,129000,38800,30
TIKI,nha-sach-tiki,129381090,"Minh Triết Trong Đời Sống (Tái Bản)",72400,108000,35600,33
TIKI,nha-sach-tiki,198016656,"Blue Flag - Tập 3",43600,45000,1400,3
TIKI,nha-sach-tiki,143172597,"2000 English Collocation and Idioms",114000,200000,86000,43
TIKI,nha-sach-tiki,136143567,"Thần Số Học",145100,219000,73900,34
TIKI,nha-sach-tiki,195190275,"Bá Tước Tiểu Thư - Tập 2",28200,30000,1800,6
TIKI,nha-sach-tiki,50072452,"Lâu Đài Bay Của Pháp Sư Howl (Tái Bản 2020)",83900,106000,22100,21
TIKI,nha-sach-tiki,113540576,"Hảo Nữ Trung Hoa",95900,128000,32100,25
TIKI,nha-sach-tiki,182548592,"Thiên Sứ Nhà Bên – Tập 3",80700,95000,14300,15
TIKI,nha-sach-tiki,54051752,"Bộ Ba Quái Hiệp (Trinh Thám)",138000,138000,0,0
TIKI,nha-sach-tiki,195357776,"Máy Tính CASIO FX-880BTG - Màu Hồng",699000,799700,100700,13
TIKI,nha-sach-tiki,96357336,"Cáo Pax",91900,116000,24100,21
TIKI,nha-sach-tiki,32155084,"Combo 25 Chuyên đề ngữ pháp tiếng anh trọng tâm ( trọn bộ tập 1+2 )",157000,230000,73000,32
TIKI,nha-sach-tiki,197634201,"Suy Nghĩ Thống Kê Trong Đời Thường",138600,165000,26400,16
TIKI,nha-sach-tiki,243358535,"Squid Game Móc khoá - Móc khoá Silicon 5cm-SQ1",10000,20000,10000,50
TIKI,nha-sach-tiki,100931418,"Giao Tiếp Bất Kỳ Ai - 101 Cách Nâng Cao Khả Năng Giao Tiếp (Tái Bản)",38300,55000,16700,30
TIKI,nha-sach-tiki,153045603,"Sách Người Giỏi Không Phải Là Người Làm Tất Cả (Tái Bản 2021)",40700,58000,17300,30
TIKI,nha-sach-tiki,100947274,"Tìm Bình Yên Trong Gia Đình (Tái Bản)",60100,99000,38900,39
TIKI,nha-sach-tiki,17719702,"Một Thế Giới Không Có Đàn Bà (Trinh Thám Việt Nam)",71000,142000,71000,50
TIKI,nha-sach-tiki,71957063,"Spy X Family - Tập 1",23600,25000,1400,6
TIKI,nha-sach-tiki,148802202,"How Philosophy Works - Hiểu Hết Về Triết Học",261000,330000,69000,21
TIKI,nha-sach-tiki,176752838,"Thay Đổi Tí Hon Hiệu Quả Bất Ngờ - Atomic Habits",156870,189000,32130,17
TIKI,nha-sach-tiki,44433397,"Yêu Mình Trước Đã, Yêu Đời Để Sau",78400,109000,30600,28
TIKI,nha-sach-tiki,1080002,"Boxset Harry Potter - Tiếng Việt (Trọn Bộ 7 Tập)",1570000,1750000,180000,10
TIKI,nha-sach-tiki,90056907,"Khởi Nghiệp Tinh Gọn (The Lean Startup) (Tái Bản)",103950,165000,61050,37
TIKI,nha-sach-tiki,179952621,"Hành Trình Tarot (Tái Bản 2022)",107000,149000,42000,28
TIKI,nha-sach-tiki,196944533,"Tài chính doanh nghiệp for Dummies",179000,239000,60000,25
TIKI,nha-sach-tiki,160081252,"Người Tan Làm Sau Cùng Là Người Nghỉ Việc Đầu Tiên (Tặng kèm bookmark)",85600,119000,33400,28
TIKI,nha-sach-tiki,179063564,"Tôi Tự Học",98300,120000,21700,18
TIKI,nha-sach-tiki,197781977,"Yu-Gi-Oh! Gx Tập 1: “Người Hùng Mới” Lộ Diện",29000,30000,1000,3
TIKI,nha-sach-tiki,626886,"Những Tấm Lòng Cao Cả",57500,80000,22500,28
TIKI,nha-sach-tiki,186091870,"Fullmetal Alchemist - Cang Giả Kim Thuật Sư - Fullmetal Edition Tập 15 [Tặng Kèm Bookmark PVC]",69000,69000,0,0
TIKI,nha-sach-tiki,171057415,"Cẩm nang hướng dẫn tự học tiếng Thái – trình độ sơ cấp – trung cấp",99600,120000,20400,17
TIKI,nha-sach-tiki,81323246,"90-20-30 90 Bài Học Vỡ Lòng Về Ý Tưởng Và Câu Chữ (Bản Đen Trắng)",152000,195000,43000,22
TIKI,nha-sach-tiki,80657321,"Cơ Thể Tự Chữa Lành: Phục Hồi Tuyến Giáp",122000,180000,58000,32
TIKI,nha-sach-tiki,194104631,"Mong Bạn Đừng Khóc Một Mình",63100,88000,24900,28
TIKI,nha-sach-tiki,57870426,"Sức Mạnh Của Ngôn Từ (Tặng Kèm 1 Photocard Mintbooks Limited)",69000,96000,27000,28
TIKI,nha-sach-tiki,176550321,"Bàn Về Ham Muốn: Tại Sao Chúng Ta Muốn Thứ Mà Ta Muốn",122000,169000,47000,28
TIKI,nha-sach-tiki,161245852,"Giải Thích Ngữ Pháp Tiếng Anh (Tái Bản 2022)",147400,220000,72600,33
TIKI,nha-sach-tiki,178483637,"Nước Ép Trị Liệu Và Chế Độ Ăn Theo Phương Pháp Cơ Thể Tự Chữa Lành",149000,199000,50000,25
TIKI,nha-sach-tiki,110448020,"Nhà Ảo Thuật Đen Và Vụ Án Mạng Tại Thị Trấn Không Tên",157000,199000,42000,21
TIKI,nha-sach-tiki,87959748,"451 Độ F",78100,99000,20900,21
TIKI,nha-sach-tiki,125528587,"Thần Với Chả Thoại (Những Câu Chuyện "Mệt Mỏi" Về Các Vị Thần)",105000,139000,34000,24
TIKI,nha-sach-tiki,71090268,"Ám Ảnh Từ Kiếp Trước - Bí Mật Của Sự Sống Và Cái Chết (Tái Bản 2020)",66700,89000,22300,25
TIKI,nha-sach-tiki,69644748,"Thiền Sư Và Em Bé 5 Tuổi",74300,120000,45700,38
TIKI,nha-sach-tiki,40933969,"Một Đời Quản Trị (Tái Bản)",166000,200000,34000,17
TIKI,nha-sach-tiki,168662171,"Vừa Nhắm Mắt Vừa Mở Cửa Số",59900,75000,15100,20
TIKI,nha-sach-tiki,3737963,"Bức Xúc Không Làm Ta Vô Can (Tái Bản)",67100,85000,17900,21
TIKI,nha-sach-tiki,195885690,"Birdmen - Tập 6",28400,30000,1600,5
TIKI,nha-sach-tiki,151994935,"Sói Đầu Đàn Và Cún Nhỏ - Tập 1",99300,128000,28700,22
TIKI,nha-sach-tiki,90985722,"Thương (Thơ) - Bản Thường (Tặng Kèm Bookmark)",46500,75000,28500,38
TIKI,nha-sach-tiki,58695343,"Kỹ Năng Giao Tiếp Đỉnh Cao",71900,96000,24100,25
TIKI,nha-sach-tiki,191148794,"Tôi Ước Mình Chưa Từng Được Sinh Ra -Tặng kèm 1 bookmark",64300,90000,25700,29
TIKI,nha-sach-tiki,73222800,"Nghĩ Giàu Và Làm Giàu (Khổ Nhỏ)",74400,108000,33600,31
TIKI,nha-sach-tiki,155550600,"Sống Bán Nông Bán X - Tâm Lý Mới Về Cuộc Sống Điền Viên",106000,148000,42000,28
TIKI,nha-sach-tiki,140416373,"Hành Trình Về Phương Đông (Khổ Nhỏ)(Tái Bản)",54700,78000,23300,30
TIKI,nha-sach-tiki,106863962,"Sách Bên Rặng Tuyết Sơn - Nguyên Phong (Tái Bản)",82500,118000,35500,30
TIKI,nha-sach-tiki,193433863,"101 Lời Khuyên Tài Chính Cá Nhân Từ Thái Phạm",299000,299000,0,0
TIKI,nha-sach-tiki,31509726,"Làm Bạn Với Bầu Trời (Bìa Mềm) (Tặng Kèm Khung Ảnh Số Lượng Có Hạn)",87900,110000,22100,20
TIKI,nha-sach-tiki,67491398,"Sách OSHO Từ Bi - Compassion",89500,128000,38500,30
TIKI,nha-sach-tiki,153521878,"Nhân Loại - Một Lịch Sử Tràn Đầy Hi Vọng",149450,245000,95550,39
TIKI,nha-sach-tiki,195649281,"Đọc Vị Tâm Lý Hành Vi Của Giới Giàu Và Siêu Giàu",224000,299000,75000,25
TIKI,nha-sach-tiki,49317816,"Cơ Thể Tự Chữa Lành",115000,160000,45000,28
TIKI,nha-sach-tiki,187622420,"The Art and Science of Technical Analysis – Phân tích kỹ thuật: Sự kết hợp giữa KHOA HỌC và NGHỆ THUẬT trong đầu tư chứng khoán",569000,569000,0,0
TIKI,nha-sach-tiki,66712456,"Trở Về Không - Trải Nghiệm Ho'oponopono - Thực Hiện Hóa Những Phép Màu Trong Cuộc Sống",122000,159000,37000,23
TIKI,nha-sach-tiki,113655533,"Giáo Trình Chủ Nghĩa Xã Hội Khoa Học (Dành Cho Bậc Đại Học Hệ Không Chuyên Lý Luận Chính Trị) - Bộ mới năm 2021",58000,58000,0,0
TIKI,nha-sach-tiki,147058065,"Phi Lý Trí - Khám Phá Những Động Lực Vô Hình Ẩn Sau Những Quyết Định Của Con Người ( Tái Bản)",126000,169000,43000,25
TIKI,nha-sach-tiki,69764534,"Thợ Xăm Ở Auschwitz",118000,148000,30000,20
TIKI,nha-sach-tiki,56697257,"Bí Mật Và Thực Tế Về Tự Kỉ Ám Thị (Self Mastery Through Conscious Autosuggestion) - Cuốn Sách Về Tự Kỉ Ám Thị Được Freud Và Các Bậc Thầy Phân Tâm Trích Dẫn Và Nghiên Cứu - Liệu Pháp Tự Chữa Lành Được Napoleon Hill Và Tony Robbin Sử Dụng Đều Xuất Phát Từ Đ",59800,99000,39200,40
TIKI,nha-sach-tiki,108715084,"Rio Book No.1 - Xấu Thế Nào, Đẹp Ra Sao - Bí Kíp Thẩm Định Thiết Kế Trong Marketing (Tái Bản Lần 6)",136000,175000,39000,22
TIKI,nha-sach-tiki,94173462,"Muôn Kiếp Nhân Sinh 2",185000,268000,83000,31
TIKI,nha-sach-tiki,63473605,"Ho’Oponopono: Sống Như Người Hawaii – Chấp Nhận, Biết Ơn Và Tha Thứ",69760,109000,39240,36
TIKI,nha-sach-tiki,195357782,"Máy Tính CASIO FX-880BTG - Màu Xám",698000,799700,101700,13
TIKI,nha-sach-tiki,95218447,"Con Đường Chuyển Hóa - Kinh Bốn Lĩnh Vực Quán Niệm (Tái Bản)",63000,89000,26000,29
TIKI,nha-sach-tiki,194960730,"Nỗi buồn chiến tranh",97500,130000,32500,25
TIKI,nha-sach-tiki,36363381,"Sao Chúng Ta Lại Ngủ",184200,249000,64800,26
TIKI,nha-sach-tiki,107331062,"Khởi Nghiệp Kinh Doanh Online - Bán Hàng Hiệu Quả Trên Face.book",150000,199000,49000,25
TIKI,nha-sach-tiki,95220861,"Tuần Làm Việc 4 Giờ (Tái Bản)",85900,115000,29100,25
TIKI,nha-sach-tiki,99513994,"Những Người Đàn Ông Không Có Đàn Bà (Tái Bản)",78900,100000,21100,21
TIKI,nha-sach-tiki,2126103,"Tazaki Tsukuru Không Màu Và Những Năm Tháng Hành Hương (Tái Bản 2018)",83900,128000,44100,34
TIKI,nha-sach-tiki,193446628,"Dragon Ball Full Color - Phần Năm: Truy Lùng Cell Bọ Hung Tập 3 [Tặng kèm Standee hoặc Postcard]",69200,77000,7800,10
TIKI,nha-sach-tiki,103550551,"Hung Khí Hoàn Mỹ",120000,150000,30000,20
TIKI,nha-sach-tiki,129381098,"Tiếp Thị 5.0: Công Nghệ Vị Nhân Sinh",66000,120000,54000,45
TIKI,nha-sach-tiki,394434,"Giấy Excel A4 DL70",48000,55000,7000,13
TIKI,nha-sach-tiki,197558899,"Anime Comics: One Piece Film Z - Tập 1",69200,77000,7800,10
TIKI,nha-sach-tiki,72680632,"Năng Lực Tìm Kiếm",40000,91000,51000,56
TIKI,nha-sach-tiki,77900454,"Bí Mật Của Nước (Tái Bản)",66700,89000,22300,25
TIKI,nha-sach-tiki,113540577,"Anne Tóc Đỏ Dưới Chái Nhà Xanh",95100,119000,23900,20
TIKI,nha-sach-tiki,197558902,"Anime Comics: One Piece Film Z - Tập 2",72400,77000,4600,6
TIKI,nha-sach-tiki,100947276,"Ung Thư - Sự Thật, Hư Cấu, Gian Lận Và Những Phương Pháp Chữa Bệnh Không Độc Hại (Tái Bản)",127000,169000,42000,25
TIKI,nha-sach-tiki,186578227,"Những kẻ cuồng nhạc Musicophilia – Tales of music and the brain",184000,230000,46000,20
TIKI,nha-sach-tiki,76012203,"Cuộc Đời Là Một Tiểu Thuyết",112000,140000,28000,20
TIKI,nha-sach-tiki,93734071,"Trí Thông Minh Trên Giường",142000,219000,77000,35
TIKI,nha-sach-tiki,160548374,"Yêu Thầm - Bản Thường (Tặng Kèm Postcard 2 Mặt)",123000,165000,42000,25
TIKI,nha-sach-tiki,87959745,"Hạnh Phúc Là Con Đường",120000,155000,35000,23
TIKI,nha-sach-tiki,197119849,"Chuông Gió (Tập 3)",95600,174000,78400,45
TIKI,nha-sach-tiki,17881046,"Trầm lặng - Sức mạnh tiềm ẩn của người hướng nội",78000,130000,52000,40
TIKI,nha-sach-tiki,72744612,"Nghề Thầy",54500,70000,15500,22
TIKI,nha-sach-tiki,173745189,"Clean Code – Mã Sạch Và Con Đường Trở Thành Lập Trình Viên Giỏi",286000,386000,100000,26
TIKI,nha-sach-tiki,130996088,"Câu Chuyện Ngôn Ngữ",126000,160000,34000,21
TIKI,nha-sach-tiki,90985718,"Càng Mạnh Mẽ, Càng Dịu Dàng (Tái Bản)",71200,99000,27800,28
TIKI,nha-sach-tiki,133599625,"Spy X Family Tập 6",23900,25000,1100,4
TIKI,nha-sach-tiki,96616370,"Con Đường Trở Thành Freelance Writer - Tôi Đã Kiếm 800.000.000 Một Năm Từ Viết Lách Như Thế Nào? (Tái Bản)",163000,220000,57000,26
TIKI,nha-sach-tiki,178294073,"Trading in The Zone - Thực Hành Kiểm Soát Cảm Xúc bằng Tâm Lý Học Hành Vi trong Đầu Tư và Giao Dịch",295000,295000,0,0
TIKI,nha-sach-tiki,189657049,"One Piece - Tập 99",23700,25000,1300,5
TIKI,nha-sach-tiki,39228816,"Kỹ Thuật Giao Dịch Để Kiếm Tiền Hàng Ngày Trên Thị Trường Chứng Khoán – Day Trade For A Living",298000,298000,0,0
TIKI,nha-sach-tiki,53722909,"Combo Trinh Thám Trung Quốc: Phục Thù (2 tập)",108000,225000,117000,52
TIKI,nha-sach-tiki,117595535,"Kẻ Ngoại Cuộc",97900,123000,25100,20
TIKI,nha-sach-tiki,194960245,"Migi & Dali -Tập 1",36100,40000,3900,10
TIKI,nha-sach-tiki,97561438,"Thế Giới Quả Là Rộng Lớn Và Có Rất Nhiều Việc Phải Làm (Tái Bản)",103000,139000,36000,26
TIKI,nha-sach-tiki,191045565,"Cô Gái Mặc Váy Tím",75900,95000,19100,20
TIKI,nha-sach-tiki,125776045,"Giấy in photo A4 IK Copy IK-01 - Định lượng 70 gsm - 500 tờ/ream - giấy chất lượng cao nhập khẩu Indonesia",70000,110000,40000,36
TIKI,nha-sach-tiki,21130354,"Vòng Tròn Máu - Trinh Thám Cổ Điển Anh",71000,102000,31000,30
TIKI,nha-sach-tiki,193605362,"Ali Và NiNo",99900,125000,25100,20
TIKI,nha-sach-tiki,637390,"Tuần Của Bé - Bé Thông Minh",22000,23000,1000,4
TIKI,nha-sach-tiki,197634260,"Black Jack - Tập 14",29000,30000,1000,3
TIKI,nha-sach-tiki,193590152,"Méthode Rose - Phương pháp hồng 1 - Năm thứ nhất với đàn piano - Giáo trình dạy piano nổi tiếng của Pháp",108000,150000,42000,28
TIKI,nha-sach-tiki,93249197,"22 Quy Luật Bất Biến Trong Marketing",54500,78000,23500,30
TIKI,nha-sach-tiki,194104223,"Quán Rượu Dị Giới "Nobu" - Tập 10",21000,40000,19000,48
TIKI,nha-sach-tiki,89179374,"Spy X Family Tập 4",23600,25000,1400,6
TIKI,nha-sach-tiki,10405966,"Tarot Nhập Môn (Tái Bản 2019)",95900,120000,24100,20
TIKI,nha-sach-tiki,106605689,"Spy X Family Tập 5 - Bản Thường",23600,25000,1400,6
TIKI,nha-sach-tiki,54051756,"19 Năm Mưu Sát - Tập 2 (Trinh Thám Trung Quốc)",115000,115000,0,0
TIKI,nha-sach-tiki,20444622,"Cẩm Nang Cấu Trúc Tiếng Anh",70500,98000,27500,28
TIKI,nha-sach-tiki,595724,"Giáo Trình Chuẩn HSK 4 Bài Học (Tập 1)",171000,228000,57000,25
TIKI,nha-sach-tiki,192048665,"Vỡ lòng về tiền tệ - Money for Beginners",118000,150000,32000,21
TIKI,nha-sach-tiki,195885680,"Tiệm Trừ Yêu Kì Ảo -  Tập 18",33900,35000,1100,3
TIKI,nha-sach-tiki,193896563,"Cô Bạn Tôi Thầm Thích Lại Quên Mang Kính Rồi - Tập 2 [Tặng Kèm Standee Ivory]",36500,38000,1500,4
TIKI,nha-sach-tiki,54624820,"Sức Mạnh Của Tĩnh Lặng (Tái Bản 2020)",47700,68000,20300,30
TIKI,nha-sach-tiki,87391039,"Thuật Yêu Đương (Tái Bản)",82500,120000,37500,31
TIKI,nha-sach-tiki,100958444,"Hạnh Phúc Cầm Tay (Tái Bản)",48000,75000,27000,36
TIKI,nha-sach-tiki,111582631,"Cái Dũng Của Thánh Nhân (Thu Giang Nguyễn Duy Cần) (Tái Bản)",73700,90000,16300,18
TIKI,nha-sach-tiki,168662558,"CCMR. Phải Trái Đúng Sai",127000,155000,28000,18
TIKI,nha-sach-tiki,192697068,"Sách Bước Ra Thế Giới: Cẩm Nang Du Học Và Săn Học Bổng",326000,435000,109000,25
TIKI,nha-sach-tiki,77109209,"Nghệ Thuật Đánh Cắp Ý Tưởng (10 Bí Mật Không Ai Nói Với Bạn Về Sáng Tạo)",73100,99000,25900,26
TIKI,nha-sach-tiki,197990871,"Doraemon Movie Story: Nobita Và Hòn Đảo Diệu Kì - Cuộc Phiêu Lưu Của Loài Thú",28400,30000,1600,5
TIKI,nha-sach-tiki,192909304,"Lên Tàu Cùng Socrates - Đi Tìm Ý Nghĩa Cuộc Sống Từ Các Triết Gia",137000,195000,58000,30
TIKI,nha-sach-tiki,56218385,"Thông Điệp Của Nước (Tái Bản 2020)",66700,89000,22300,25
TIKI,nha-sach-tiki,194042797,"Đọc Vị Tâm Lý Hành Vi Của Giới Giàu Và Giới Siêu Giàu",221260,299000,77740,26
TIKI,nha-sach-tiki,80960198,"Thiên Tài Bên Trái, Kẻ Điên Bên Phải (Tái Bản 2021)",132400,179000,46600,26
TIKI,nha-sach-tiki,381234,"Cuốn Sách Hoàn Hảo Về Ngôn Ngữ Cơ Thể - Body Language (Tái Bản)",150000,198000,48000,24
TIKI,nha-sach-tiki,197990869,"Doraemon Movie Story: Tân Nobita Và Chuyến Phiêu Lưu Vào Xứ Quỷ - 7 Dũng Sĩ Phép Thuật",26900,30000,3100,10
TIKI,nha-sach-tiki,52329861,"Con Đường Hồi Giáo (Tái Bản 2020)",78900,100000,21100,21
TIKI,nha-sach-tiki,14645351,"Cuộc Đời Của Pi ( Tái Bản 2019)",85700,110000,24300,22
TIKI,nha-sach-tiki,59293803,"A Holistic Approach To IELTS Writing",122000,189000,67000,35
TIKI,nha-sach-tiki,189641379,"Anh Em Nhà Motohashi - Tập 1",34000,68000,34000,50
TIKI,nha-sach-tiki,55506686,"Tiktok Marketing",89900,139000,49100,35
TIKI,nha-sach-tiki,54051754,"19 Năm Mưu Sát - Tập 1 (Trinh Thám Trung Quốc)",80100,115000,34900,30
TIKI,nha-sach-tiki,109505039,"Combo Mindmap English Grammar và Mindmap English Vocabulary - Học Kèm App Online",283240,388000,104760,27
TIKI,nha-sach-tiki,46789754,"Hiểu Hết Về Kinh Doanh",300000,380000,80000,21
TIKI,nha-sach-tiki,149180057,"Đừng Cố Làm Người Tốt Trong Mắt Tất Cả Mọi Người",81000,108000,27000,25
TIKI,nha-sach-tiki,187843301,"How Technology Works – Hiểu hết về công nghệ",264000,330000,66000,20
TIKI,nha-sach-tiki,124639646,"Bé chinh phục 2000 từ vựng tiếng Anh - My First 2000 English words",52000,120000,68000,57
TIKI,nha-sach-tiki,116406678,"Quản Lý Nghiệp (Tái Bản)",44200,59000,14800,25
TIKI,nha-sach-tiki,76175424,"Vụ Án Mạng Ở Nhà Khách Núi Hakuba",109000,138000,29000,21
TIKI,nha-sach-tiki,81224320,"Nước Ép Xanh Chữa Lành Cơ Thể",131000,179000,48000,27
TIKI,nha-sach-tiki,10397239,"Chiến Lược Dữ Liệu",99600,158000,58400,37
TIKI,nha-sach-tiki,190240560,"Bộ Sách Tô Màu - Bé Làm Họa Sĩ",14000,25000,11000,44
TIKI,nha-sach-tiki,176654072,"Bộ 5 bút chì gỗ 2B HB Deli - Có bán lẻ 1 chiếc - Nhiều loại mẫu mã màu sắc - Phù hợp cho học sinh sinh viên tập viết vẽ tranh",1600,2880,1280,44
TIKI,nha-sach-tiki,140635217,"Mất Kết Nối (Khám Phá Các Nguyên Nhân Thực Của Trầm Cảm Và Các Giải Pháp Bất Ngờ)",155000,250000,95000,38
TIKI,nha-sach-tiki,137161811,"Bút gel bấm ngòi 0.5mm nhiều màu Deli - Độ dài mực lên tới 1000m - 12 màu mực - 1 chiếc - EG118",6000,10800,4800,44
TIKI,nha-sach-tiki,105614684,"Bút gel 0.5mm Deli nhiều màu lựa chọn - Bút bi nước -  1 chiếc - Mực đỏ / Xanh / Đen - A116",3800,7200,3400,47
TIKI,nha-sach-tiki,162201947,"One Piece - Tập 98: “Phút Huy Hoàng Của Những Trung Thần",23700,25000,1300,5
TIKI,nha-sach-tiki,73125816,"Digital Marketing - Từ Chiến Lược Đến Thực Thi (Tái Bản 2020)",176000,220000,44000,20
TIKI,nha-sach-tiki,190708154,"Dragon Quest - Dấu Ấn Roto (Dragon Quest Saga Emblem Of Roto) Perfect Edition Tập 8 [Tặng Kèm Bookmark PVC]",67400,75000,7600,10
TIKI,nha-sach-tiki,196001724,"Dưới Cánh Đại Bàng (Bìa Mềm)",95100,138000,42900,31
TIKI,nha-sach-tiki,100347903,"Nói Một Cách Đơn Giản",103000,129000,26000,20
TIKI,nha-sach-tiki,148761077,"Khách Sạn Mặt Nạ 1",140000,175000,35000,20
TIKI,nha-sach-tiki,58342212,"Set 3 cuốn Moi Moi và những người bạn - Dành cho trẻ từ 0-2 tuổi",83900,117000,33100,28
TIKI,nha-sach-tiki,193434494,"Shaman King - Tập 15",31600,35000,3400,10
TIKI,nha-sach-tiki,144203242,"9 Lần Khởi Nghiệp - Chuyện Kể Về Những Thất Bại Và Thành Công Của Một Triệu Phú",149000,199000,50000,25
TIKI,nha-sach-tiki,50685547,"Bản Đồ (Bản Thông Thường)",276000,345000,69000,20
TIKI,nha-sach-tiki,10383904,"Tôi Là Bêtô",72200,95000,22800,24
TIKI,nha-sach-tiki,194104226,"Mô Hình Can Thiệp Sớm Denver Cho Trẻ Tự Kỷ - Thúc Đẩy Kỹ Năng Ngôn Ngữ, Học Tập Và Tương Tác",164000,210000,46000,22
TIKI,nha-sach-tiki,140360874,"Những Đòn Tâm Lý Trong Bán Hàng (Tái Bản)",103000,139000,36000,26
TIKI,nha-sach-tiki,706939,"The Subtle Art of Not Giving a F*Ck : A Counterintuitive Approach to Living a Good Life",266600,293000,26400,9
TIKI,nha-sach-tiki,62648441,"The Customer Rules - 39 Nguyên Tắc Cốt Lõi Để Mang Tới Dịch Vụ Đỉnh Cao",172000,220000,48000,22
TIKI,nha-sach-tiki,193736891,"Tâm Lý Học Xã Hội - Đi Tìm Chất Gây Nghiện Trong Mỗi Con Người",99600,139000,39400,28
TIKI,nha-sach-tiki,72542509,"Raw Vegan – Sức Mạnh Chữa Lành Của Thực Vật (Tặng kèm bookmark)",64300,92000,27700,30
TIKI,nha-sach-tiki,509829,"Giấy Double A A4 DL70",85500,92000,6500,7
TIKI,nha-sach-tiki,195801646,"Ninja Rantaro - Tập 60",38300,40000,1700,4
TIKI,nha-sach-tiki,138226289,"Storytelling With Data: Let’S Practice! - Thực Hành Kể Chuyện Thông Qua Dữ Liệu!",299000,399000,100000,25
TIKI,nha-sach-tiki,45663835,"Lạc Quan Tếu – Irrational Exuberance",299000,299000,0,0
TIKI,nha-sach-tiki,176906726,"Chân Dung Thật - Thấu Hiểu Khách Hàng Chỉ Bằng Những Cuộc Trò Chuyện",191000,245000,54000,22
TIKI,nha-sach-tiki,10325548,"How Food Works - Hiểu Hết Về Thức Ăn",236000,300000,64000,21
TIKI,nha-sach-tiki,84950232,"Hoa Sen Trên Tuyết (Tái Bản)",68500,98000,29500,30
TIKI,nha-sach-tiki,193978836,"Trí Óc Minh Mẫn: Để Não Bộ Sắc Bén Ở Mọi Lứa Tuổi",187000,249000,62000,25
TIKI,nha-sach-tiki,15397971,"Hà Nội Băm Sáu Phố Phường (Tái bản 2019)",31900,50000,18100,36
TIKI,nha-sach-tiki,168946125,"Digital Marketing - Chiến Lược Là Lược Đi Để Chiến",111200,139000,27800,20
TIKI,nha-sach-tiki,180851000,"Bảy Thanh Hung Giản 3 Mưa Phùn Chôn Nho - Truy Lùng Báo Săn Giá",181000,235000,54000,23
TIKI,nha-sach-tiki,46240929,"Rèn Luyện Tư Duy Phản Biện",90000,139000,49000,35
TIKI,nha-sach-tiki,130997085,"Chuyện Con Chó Tên Là Trung Thành",35000,45000,10000,22
TIKI,nha-sach-tiki,115873770,"Sách: Thay Đổi Một Suy Nghĩ Thay Đổi cả Cuộc Đời",120000,160000,40000,25
TIKI,nha-sach-tiki,49181801,"Oxford Advanced Learner's Dictionary : Paperback - 10th Edition (With 1 Year's Access To Both Premium Online And App)",569400,649000,79600,12
TIKI,nha-sach-tiki,197587849,"Yuri Espoir (Tập 3)",47300,79000,31700,40
TIKI,nha-sach-tiki,78975610,"Siêu Tập Trung (Tái Bản)",86700,140000,53300,38
TIKI,nha-sach-tiki,95090804,"Bút dạ viết bảng Deli - xóa được - Mực xanh/đen/đỏ - 1 chiếc – EU00120/ EU00130 / EU00140",8000,14400,6400,44
TIKI,nha-sach-tiki,148760915,"Khách Sạn Mặt Nạ 2 - Đêm Trước Lễ Hội Hóa Trang",98700,125000,26300,21
TIKI,nha-sach-tiki,171825201,"Người Bà Tài Giỏi Vùng Saga – Tập 7",41000,52000,11000,21
TIKI,nha-sach-tiki,165150439,"TalMud - Tinh Hoa Trí Tuệ Do Thái (Tái Bản)",85700,110000,24300,22
TIKI,nha-sach-tiki,196001693,"Trí Tuệ Của Trái Tim",65900,88000,22100,25
TIKI,nha-sach-tiki,152875147,"Miền Đất Hứa (A Promised Land) - Barack Obama (Bìa Cứng)",176000,768000,592000,77
TIKI,nha-sach-tiki,55119955,"Cách Sống (Tái Bản 2020)",54400,85000,30600,36
TIKI,nha-sach-tiki,95997783,"Sách Luyện thi B1 Vstep 4 kỹ năng - Ôn thi chứng chỉ tiếng Anh B1 bậc 3 (bằng B1 tiếng Anh) theo Khung NLNN Việt Nam",259000,300000,41000,14
TIKI,nha-sach-tiki,177637709,"Làm Chủ Bình Minh - Sống Đời Xuất Chúng - CLB 5 Giờ Sáng (Robin Sharma)",101000,185000,84000,45
TIKI,nha-sach-tiki,87226754,"Một Cuốn Sách Buồn… Cười - Vui Vẻ Không Quạu Nha 2",35000,79000,44000,56
TIKI,nha-sach-tiki,53452969,"Khởi Nghiệp Du Kích - Kinh Doanh Ít Vốn - Vận Dụng Nguồn Lực Nhỏ Chiến Thắng Cuộc Chơi Lớn (Tái Bản)",146000,199000,53000,27
TIKI,nha-sach-tiki,195190103,"Mèo Mốc & Thế Giới Diệu Kỳ Màu Xám",109000,128000,19000,15
TIKI,nha-sach-tiki,160375101,"Ngữ pháp luyện thi IELTS - Grammar for ielts",91300,110000,18700,17
TIKI,nha-sach-tiki,13446508,"Cánh Đồng Bất Tận (Tái Bản 2019)",69600,85000,15400,18
TIKI,nha-sach-tiki,101782486,"Làm Ra Làm, Chơi Ra Chơi (Tái Bản)",119000,159000,40000,25
TIKI,nha-sach-tiki,195357774,"Máy Tính CASIO FX-880BTG - Màu Xanh Biển",699000,799700,100700,13
TIKI,nha-sach-tiki,52329765,"Biên Niên Ký Chim Vặn Dây Cót (Tái Bản 2020)",159000,199000,40000,20
TIKI,nha-sach-tiki,54383647,"Fullmetal Alchemist - Cang Giả Kim Thuật Sư - Fullmetal Edition Tập 4",62000,69000,7000,10
TIKI,nha-sach-tiki,186271356,"Từ điển xây kênh từ cơ bản đến thành công",188000,188000,0,0
TIKI,nha-sach-tiki,189326210,"Nghệ thuật tư duy dựa trên dữ liệu - Để ra quyết điịnh thông minh hơn trong một thê giới không chắc chắn",120000,150000,30000,20
TIKI,nha-sach-tiki,76014598,"Blue Ocean Strategy - Chiến Lược Đại Dương Xanh (Bìa Cứng) (Tái Bản)",178000,239000,61000,26
TIKI,nha-sach-tiki,9695881,"Nghệ Thuật đầu tư Dhandho - The Dhandho Investor",238000,238000,0,0
TIKI,nha-sach-tiki,121185870,"Và Rồi Núi Vọng",118000,148000,30000,20
TIKI,nha-sach-tiki,74285820,"Cơ Thể Tự Chữa Lành: Nước Ép Cần Tây",96100,148000,51900,35
TIKI,nha-sach-tiki,75630595,"The Design Thinking Playbook- Thực Hành Tư Duy Thiết Kế",224000,299000,75000,25
TIKI,nha-sach-tiki,20520720,"Đối Thoại Với Thượng Đế ( Tái Bản )",76300,98000,21700,22
TIKI,nha-sach-tiki,73316970,"Osho - Ươm Mầm",81700,109000,27300,25
TIKI,nha-sach-tiki,185888686,"Trường An Ly Ca 3 – Cao Sơn Lưu Thuỷ",137000,170000,33000,19
TIKI,nha-sach-tiki,73102465,"Bé Tô màu - Combo 11 cuốn",58000,127255,69255,54
TIKI,nha-sach-tiki,72818335,"Bộ Thẻ học Thông minh - 416 Thẻ Flashcards Tiếng Anh - 16 Chủ đề mới nhất",56000,129000,73000,57
TIKI,nha-sach-tiki,4080373,"90% Trẻ Thông Minh Nhờ Cách Trò Chuyện Đúng Đắn Của Cha Mẹ",29000,39000,10000,26
TIKI,nha-sach-tiki,10678954,"Full bộ Ehon Nhật Bản cho bé 0-6 tuổi thông minh, sáng tạo",320000,390000,70000,18
TIKI,nha-sach-tiki,196849403,"Gửi Em, Người Bất Tử - Tập 8 (Tái Bản 2022)",27800,30000,2200,7
TIKI,nha-sach-tiki,196849389,"Gửi Em, Người Bất Tử - Tập 10 (Tái Bản 2022)",27800,30000,2200,7
TIKI,nha-sach-tiki,196849409,"Gửi Em, Người Bất Tử - Tập 11 (Tái Bản 2022)",26900,30000,3100,10
TIKI,nha-sach-tiki,37411897,"Sách Đen - Bộ Công Cụ Của Phụ Nữ Thành Đạt",56800,79000,22200,28
TIKI,nha-sach-tiki,63187280,"Combo 2 Cuốn: Cơ Thể Tự Chữa Lành",253000,345000,92000,27
TIKI,nha-sach-tiki,40774181,"Combo Sách Tiếng hàn tổng hợp dành cho người Việt Nam - Sơ cấp 1 (Phiên bản 1 màu)",175500,234000,58500,25
TIKI,nha-sach-tiki,167301575,"Khí Chất Bao Nhiêu Hạnh Phúc Bấy Nhiêu (Tái Bản 2022)",97200,139000,41800,30
TIKI,nha-sach-tiki,44627532,"Cẩm Nang Hướng Dẫn Thải Độc & Chế Độ Ăn Uống Lành Mạnh",109000,145000,36000,25
TIKI,nha-sach-tiki,273633981,"[ Trạm Đọc Official ] Sách: Tâm Lý Học Thành Công (Tái Bản)",149000,199000,50000,25
TIKI,nha-sach-tiki,73207098,"Làm Chủ - Mastery",110000,200000,90000,45
TIKI,nha-sach-tiki,4255933,"Plato Và Con Thú Mỏ Vịt Bước Vào Quán Bar (Tái Bản 2018 )",78900,100000,21100,21
TIKI,nha-sach-tiki,545278,"Combo Sherlock Holmes Toàn Tập (Trọn Bộ 3 Tập)",150000,300000,150000,50
TIKI,nha-sach-tiki,34612056,"Máy Tính CASIO FX570VNPLUS-2 (TL)",527000,627000,100000,16
TIKI,nha-sach-tiki,38223395,"Tâm Lý Học Hài Hước (Tái Bản)",66700,89000,22300,25
TIKI,nha-sach-tiki,57767468,"Cứ Làm Đi!",81000,109000,28000,26
TIKI,nha-sach-tiki,113656455,"Giáo Trình Tư Tưởng Hồ Chí Minh (Dành Cho Bậc Đại Học Hệ Không Chuyên Lý Luận Chính Trị) - Bộ mới năm 2021",55000,55000,0,0
TIKI,nha-sach-tiki,191320058,"Set 6 Chiếc Bút Highlight Hai Đầu Bút Nhớ Dòng Đánh Dấu Dạ Quang Take Note Ghi Chú Deli - Bảng Màu Pastel Macaron - 33002 S605 S735 S134",32000,57600,25600,44
TIKI,nha-sach-tiki,106693398,"Combo 4 cuốn: Luyện viết (Theo chương trình mới - Bé vào lớp 1)",36000,72000,36000,50
TIKI,nha-sach-tiki,76105910,"5 Ngôn Ngữ Yêu Thương - The Five Love Languages (Tái Bản)",89700,128000,38300,30
TIKI,nha-sach-tiki,109633951,"Combo 8 cuốn: Tô màu Nối số Thông minh",40000,96000,56000,58
TIKI,nha-sach-tiki,1471887,"Tớ Muốn Ăn Tụy Của Cậu",76700,96000,19300,20
TIKI,nha-sach-tiki,75615273,"Combo 3 Cuốn Sách Ehon: Buồn Ngủ Ơi Là Buồn Ngủ (Dành Cho Trẻ Từ 0 - 4 Tuổi)",77700,117000,39300,34
TIKI,nha-sach-tiki,74460137,"Sách Bí Quyết Áp Dụng 7 Thói Quen Của Bạn Trẻ Thành Đạt (Khổ Nhỏ) (Tái Bản 2020)",74400,108000,33600,31
TIKI,nha-sach-tiki,10920495,"Dế Mèn Phiêu Lưu Ký",126000,150000,24000,16
TIKI,nha-sach-tiki,148750882,"Khi Mọi Thứ Sụp Đổ - Lời Khuyên Chân Thành Trong Những Thời Điểm Khó Khăn",88900,119000,30100,25
TIKI,nha-sach-tiki,193211309,"Chuông Gió (Tập 2)",95600,174000,78400,45
TIKI,nha-sach-tiki,5067167,"Tôi Là Ai - Và Nếu Vậy Thì Bao Nhiêu? (Tái Bản 2018)",99400,126000,26600,21
TIKI,nha-sach-tiki,76013370,"Được Học - Educated (Tái Bản)",137000,182000,45000,25
TIKI,nha-sach-tiki,196849396,"Gửi Em, Người Bất Tử - Tập 3 (Tái Bản 2022)",27800,30000,2200,7
TIKI,nha-sach-tiki,147920907,"Combo Bộ 6 Cuốn: Thư Viện Song Ngữ Đầu Tiên Cho Bé (0-3 Tuổi)",86300,108000,21700,20
TIKI,nha-sach-tiki,552393,"Hiểu Về Trái Tim",141550,158000,16450,10
TIKI,nha-sach-tiki,179546074,"Luật Hấp Dẫn - Quy Luật Về Sự Thịnh Vượng Và Thành Công",83000,129000,46000,36
TIKI,nha-sach-tiki,176906754,"Inspired - Kiến Tạo Sản Phẩm Công Nghệ Chiếm Trọn Trái Tim Người Dùng",230000,295000,65000,22
TIKI,nha-sach-tiki,10767515,"Phân Tâm Học Nhập Môn",127000,159000,32000,20
TIKI,nha-sach-tiki,36854641,"Sự Thật Về Thế Giới : Mười Lý Do Khiến Ta Hiểu Sai Về Thế Giới - Và Vì Sao Thế Gian Này Tốt Hơn Ta Tưởng",128000,160000,32000,20
TIKI,nha-sach-tiki,189350061,"Giá Mà Nỗi Buồn Có Thể Cầm Nắm Trên Tay - Tặng kèm 03 postcard",76200,109000,32800,30
TIKI,nha-sach-tiki,195980676,"Phượng Hoàng Tái Sinh - 12 Phẩm Chất Quan Trọng Để Bứt Phá Sự Nghiệp Và Cuộc Sống",110960,152000,41040,27
TIKI,nha-sach-tiki,50322710,"48 Nguyên Tắc Chủ Chốt Của Quyền Lực (Tái Bản 2020)",140000,200000,60000,30
TIKI,nha-sach-tiki,196849393,"Gửi Em, Người Bất Tử - Tập 4 (Tái Bản 2022)",27800,30000,2200,7
TIKI,nha-sach-tiki,104651900,"Sách Seneca: Những Bức Thư Đạo Đức – Chủ nghĩa Khắc kỷ trong đời sống - Tập 1 (Tái bản 179k)",134000,179000,45000,25
TIKI,nha-sach-tiki,196849400,"Gửi Em, Người Bất Tử - Tập 5 (Tái Bản 2022)",27800,30000,2200,7
TIKI,nha-sach-tiki,187622581,"Sách Sức Mạnh Của Sự Trầm Lắng",92000,128000,36000,28
TIKI,nha-sach-tiki,95218547,"Đọc Vị Mọi Vấn Đề Của Trẻ - Giải Mã Mọi Vấn Đề Về Nuôi Con Nhỏ: Ăn - Ngủ - Kỷ Luật Hành Vi (Tái Bản)",145000,199000,54000,27
TIKI,nha-sach-tiki,193567343,"Bá Tước Tiểu Thư- Tập 1 [Tặng Kèm Lót Ly]",28400,30000,1600,5
TIKI,nha-sach-tiki,103471709,"Full bộ (10 quyển) Truyện cổ tích Việt Nam (Song ngữ Việt - Anh) (giao ngẫu nhiên)",60000,120000,60000,50
TIKI,nha-sach-tiki,140360872,"Để Xây Dựng Doanh Nghiệp Hiệu Quả (Tái Bản)",104000,139000,35000,25
TIKI,nha-sach-tiki,100384412,"Vô Cùng Tàn Nhẫn Vô Cùng Yêu Thương (Tái Bản)",133000,189000,56000,30
TIKI,nha-sach-tiki,59078520,"Các phương pháp giao dịch ngắn hạn hiệu quả trên thị trường Forex – Day Trading and Swing Trading the Currency Market",299000,299000,0,0
TIKI,nha-sach-tiki,193917227,"Mỹ Vị Hầm Ngục - 3 - Bản Đặc Biệt - Tặng Kèm Bìa 2 Mặt, Bộ Đôi Card Chiến Binh & Ẩm Thực",43800,70000,26200,37
TIKI,nha-sach-tiki,196150482,"Người nuôi ong thành Aleppo - The beekeeper of Aleppo (Aspen Words Literary Prize Winner)",121000,168000,47000,28
TIKI,nha-sach-tiki,139979524,"Thiền - Osho (Tái Bản)",112000,149000,37000,25
TIKI,nha-sach-tiki,116397449,"Người Tình Sputnik",67800,86000,18200,21
TIKI,nha-sach-tiki,95289208,"Người Bà Tài Giỏi Vùng Saga",83200,128000,44800,35
TIKI,nha-sach-tiki,54422996,"Nóng Giận Là Bản Năng, Tĩnh Lặng Là Bản Lĩnh (Tái Bản 2020)",62300,89000,26700,30
TIKI,nha-sach-tiki,5852521,"Combo Cà Phê Cùng Tony và Trên Đường Băng",157000,210000,53000,25
TIKI,nha-sach-tiki,188534368,"Khúc Ngẫu Hứng Trước Ga Mahoro",144000,180000,36000,20
TIKI,nha-sach-tiki,145300494,"The Mastery Of Self - Hành Trình Thấu Hiểu Bản Thân Và Tìm Thấy Tự Do",121000,180000,59000,33
TIKI,nha-sach-tiki,1565657,"Dốc Hết Trái Tim - Cách Starbucks Xây Dựng Công Ty Bằng Từng Tách Cà Phê (Tái Bản 2018)",120000,150000,30000,20
TIKI,nha-sach-tiki,95090643,"Bút màu marker chuyên nghiệp Deli -kèm túi vải - 30/40/60/80 Màu - 70806",129000,232200,103200,44
TIKI,nha-sach-tiki,192475873,"Để Con Được Ốm",89900,120000,30100,25
TIKI,nha-sach-tiki,109322300,"Combo 8 cuốn Ehon Kỹ năng sống: Bon và Gia đình, Bạn bè",120640,232000,111360,48
TIKI,nha-sach-tiki,136340700,"Trên Lưng Khổng Tượng - Kinh Doanh Online Trên Sàn Thương Mại Điện Tử - Khởi Nghiệp Với Bán Hàng Qua Mạng và Nhãn Hàng Riêng",146000,199000,53000,27
TIKI,nha-sach-tiki,186290802,"Bàn Có Năm Chỗ Ngồi (Tái Bản 2022)",31100,38000,6900,18
TIKI,nha-sach-tiki,131401030,"Ayurveda",240000,240000,0,0
TIKI,nha-sach-tiki,163902722,"Cơ Thể Và Não Bộ: Ai Làm Chủ?",90900,150000,59100,39
TIKI,nha-sach-tiki,274175495,"Tĩnh Lặng",42100,69000,26900,39
TIKI,nha-sach-tiki,22878271,"Essential Grammar in Use Book with Answers Edition: A Self-Study Reference and Practice Book for Elementary Learners of English",160200,178000,17800,10
TIKI,nha-sach-tiki,2716247,"Quẳng Gánh Lo Đi Và Vui Sống (Bìa Cứng)",75500,108000,32500,30
TIKI,nha-sach-tiki,19349145,"Bí Mật Tư Duy Triệu Phú (Tái Bản 2019)",85320,108000,22680,21
TIKI,nha-sach-tiki,190701644,"Dám Mơ Lớn, Đừng Hoài Phí Tuổi Trẻ (Tái Bản) -Tặng kèm 1 bookmark 2 mặt",85600,119000,33400,28
TIKI,nha-sach-tiki,185188826,"Fryderyk Chopin: Cuộc Đời Và Thời Đại ",374250,499000,124750,25
TIKI,nha-sach-tiki,129672282,"Từ vựng luyện thi IELTS - Vocabulary for Ielts with answers",45500,65000,19500,30
TIKI,nha-sach-tiki,57350380,"Very Easy Toeic 1 - Introduction",160000,228000,68000,30
TIKI,nha-sach-tiki,2812299,"Tiếng Nhật Cho Mọi Người - Sơ Cấp 1 - Bản Dịch Và Giải Thích Ngữ Pháp - Tiếng Việt (Bản Mới)",75000,100000,25000,25
TIKI,nha-sach-tiki,88791130,"Gôm Tẩy 2B Deli, 40×22×12Mm, Đen - 1 Viên - E3043",4000,7200,3200,44
TIKI,nha-sach-tiki,184236581,"Năng Lực Của Sự Ngu Ngốc",175000,225000,50000,22
TIKI,nha-sach-tiki,184801142,"Cutie Pie – Em Ngoan, Lại Cho Là Em Ngốc - Bản thường (tặng kèm 1 bookmark in bồi 2 mặt)",114000,189000,75000,40
TIKI,nha-sach-tiki,196849394,"Gửi Em, Người Bất Tử - Tập 6 (Tái Bản 2022)",27800,30000,2200,7
TIKI,nha-sach-tiki,273058881,"Lau Bảng Deli, Vàng/Xanh Lá/Tím - 1 Chiếc - E7840",12000,21600,9600,44
TIKI,nha-sach-tiki,57815506,"Sách Tư Duy Ngược Dịch Chuyển Thế Giới",123000,178000,55000,31
TIKI,nha-sach-tiki,77900446,"Thần Số Học: Thấu Hiểu Nhân Tâm",79500,109000,29500,27
TIKI,nha-sach-tiki,186088879,"Beyond Order - Vượt Lên Trật Tự",217000,350000,133000,38
TIKI,nha-sach-tiki,73105037,"Combo 9 cuốn Tập tô - Tập viết chữ - Làm quen chữ cái/chữ số (Chuẩn bị vào lớp 1)",54000,108000,54000,50
TIKI,nha-sach-tiki,73139676,"Full bộ (20 quyển) Truyện kể Mầm non - Cổ tích - Ngụ ngôn Aesop (giao ngẫu nhiên)",107781,207271,99490,48
TIKI,nha-sach-tiki,167210783,"Trường An Ly Ca 1 – Máu Đỏ Hoa Đào",116000,175000,59000,34
TIKI,nha-sach-tiki,100958526,"Nhân Tố Enzyme - Thực Hành (Tái Bản 2021)",73300,109000,35700,33
TIKI,nha-sach-tiki,192339426,"Không Ai Sống Giống Ai Trong Cuộc Đời Này",116000,145000,29000,20
TIKI,nha-sach-tiki,111285050,"Ai Lấy Miếng Pho Mát Của Tôi ? (Tái Bản)",46800,68000,21200,31
TIKI,nha-sach-tiki,196001721,"Sự Trỗi Dậy Và Suy Tàn Của Các Cường Quốc ( Tái bản)",425000,567000,142000,25
TIKI,nha-sach-tiki,69219921,"OKRs - Hiểu Đúng, Làm Đúng - Cách Để Áp Dụng Thành Công OKRs Ngay Từ Đầu",172000,239000,67000,28
TIKI,nha-sach-tiki,190464440,"Ikigami - Tập 05",31500,45000,13500,30
TIKI,nha-sach-tiki,53301006,"Sách Ping - Vượt Ao Tù Ra Biển Lớn (Tái Bản 2020)",71900,98000,26100,27
TIKI,nha-sach-tiki,135754581,"Những Câu Chuyện Truyền Cảm Hứng - I Will Be Better: Nguồn Năng Lượng Tích Cực",49200,58000,8800,15
TIKI,nha-sach-tiki,181379116,"Hackers Toeic Vocabulary (Tái Bản)",207000,279000,72000,26
TIKI,nha-sach-tiki,90227346,"Sapiens: Lược Sử Loài Người Bằng Tranh - Tập 1: Khởi Đầu Của Loài Người",258000,345000,87000,25
TIKI,nha-sach-tiki,76401055,"Sét Bong Bóng Trang Trí Sinh Nhật FUNU Nhiều Mẫu Kèm Bơm Tay- Hàng Chính Hãng",114000,130000,16000,12
TIKI,nha-sach-tiki,191801175,"Nhịn Khô",108000,139000,31000,22
TIKI,nha-sach-tiki,11357193,"Những Cuộc Phiêu Lưu Của Huckleberry Finn",70500,98000,27500,28
TIKI,nha-sach-tiki,88914965,"Nam Châm Gắn Bảng 15Mm Deli - 1 Vỉ - E7823",15000,28800,13800,48
TIKI,nha-sach-tiki,196517619,"Thiếu Nữ (Shoujo)",120000,150000,30000,20
TIKI,nha-sach-tiki,92492870,"Combo 6 Cuốn Ehon Nhật Bản : Ai Ở Sau Lưng Bạn Thế (Tái Bản)",162000,234000,72000,31
TIKI,nha-sach-tiki,58390336,"Python cơ bản",125000,125000,0,0
TIKI,nha-sach-tiki,22634335,"Kỹ Năng Quản Lý Nhân Sự Chuyên Nghiệp",77000,119000,42000,35
TIKI,nha-sach-tiki,186434701,"Khi Bạn Đang Say Giấc, Ai Đó Đã Đạt Được Ước Mơ-Tặng kèm 01 bookmark",77500,108000,30500,28
TIKI,nha-sach-tiki,2380007,"Khi Bạn Đang Mơ Thì Người Khác Đang Nỗ Lực",100000,104000,4000,4
TIKI,nha-sach-tiki,113583126,"Ngữ Pháp Tiếng Anh (Tái Bản)",62200,89000,26800,30
TIKI,nha-sach-tiki,193981038,"Vua sáng chế - Tập 15",19100,20000,900,5
TIKI,nha-sach-tiki,186211127,"Khởi Nghiệp Kinh Doanh Online - Bán Hàng Hiệu Quả Trên Shopee",142000,199000,57000,29
TIKI,nha-sach-tiki,8835165,"Ông Trăm Tuổi Trèo Qua Cửa Sổ Và Biến Mất (Tái Bản)",137000,190000,53000,28
TIKI,nha-sach-tiki,171170802,"Kỹ thuật giao dịch nâng cao để kiếm tiền hàng ngày trên thị trường chứng khoán – Advanced Techniques in Day Trading",359000,359000,0,0
TIKI,nha-sach-tiki,111580006,"Sách Muôn Kiếp Nhân Sinh 2 (Khổ Nhỏ) - Nguyên Phong",102100,148000,45900,31
TIKI,nha-sach-tiki,193605374,"Làm Sao Để Che Giấu Một Đế Quốc - How To Hide An Empire",236000,299000,63000,21
TIKI,nha-sach-tiki,188940825,"Những Chàng Trai Ở Lộc Phong Quán – Tập 10 - Tặng 1 bookmark 2 mặt ",38300,48000,9700,20
TIKI,nha-sach-tiki,9687409,"Thôi Miên Bằng Ngôn Từ",109850,169000,59150,35
TIKI,nha-sach-tiki,45349383,"Hashtag No.2 Fashion - Kinh Doanh Thời Trang Tại Thị Trường Việt Nam",166000,200000,34000,17
TIKI,nha-sach-tiki,8886005,"Bay Trên Tổ Chim Cúc Cu (Tái Bản)",93900,118000,24100,20
TIKI,nha-sach-tiki,3048355,"Nhà (Tái Bản)",68900,109000,40100,37
TIKI,nha-sach-tiki,186434891,"Cá Cược Với Tình Yêu",95000,95000,0,0
TIKI,nha-sach-tiki,68392386,"Stephen Hawking - Trả Lời Ngắn Gọn Những Câu Hỏi Lớn",71900,90000,18100,20
TIKI,nha-sach-tiki,197602047,"Fullmetal Alchemist - Cang Giả Kim Thuật Sư - Fullmetal Edition Tập 9",66100,69000,2900,4
TIKI,nha-sach-tiki,107342987,"Bút bi nước khô nhanh Deli - 0.5mm - Bút viết thư pháp - Ống bút liền mực - Mực Xanh - 1 chiếc - S856",7000,12600,5600,44
TIKI,nha-sach-tiki,189657596,"Komi - Nữ Thần Sợ Giao Tiếp Tập 11",21200,25000,3800,15
TIKI,nha-sach-tiki,193988321,"Đứng Vững Trong Đơn Độc",68600,96000,27400,29
TIKI,nha-sach-tiki,188487640,"Dragon Ball Full Color - Phần Năm: Truy Lùng Cell Bọ Hung  - Tập 2 [Tặng Ngẫu Nhiên 1 Trong 2 Mẫu Postcard Nhân Vật]",69200,77000,7800,10
TIKI,nha-sach-tiki,109018530,"Vườn Hoa Mạt Dược Ký Sự - Những Kỳ Án Nổi Tiếng Chưa Có Lời Giải (Tặng Kèm 1 Bookmark Chữ Nhật)",98900,139000,40100,29
TIKI,nha-sach-tiki,170094968,"Atlas Giải Phẫu Cơ Thể Người - Tái Bản",558000,680000,122000,18
TIKI,nha-sach-tiki,95090377," Bút màu sáp dầu học sinh hộp nhựa Deli - 12/18/24 màu - 72090/72091/72092",28000,52200,24200,46
TIKI,nha-sach-tiki,187619074,"Quý Cô Tài Chính",108000,139000,31000,22
TIKI,nha-sach-tiki,173093792,"Thao Túng Tâm Lý - Nhận Diện, Thức Tỉnh Và Chữa Lành Những Tổn Thương Tiềm Ẩn",118300,169000,50700,30
TIKI,nha-sach-tiki,13673970,"Combo Trinh Thám Giây Thứ 12 (2 Tập)",132000,276000,144000,52
TIKI,nha-sach-tiki,185595374,"Picasso Và Bức Tranh Khiến Thế Giới Sửng Sốt",299000,399000,100000,25
TIKI,nha-sach-tiki,58441509,"Ăn Uống Đúng Cách: Bộ Quy Tắc Ẩm Thực Lành Mạnh",91500,116000,24500,21
TIKI,nha-sach-tiki,191506179,"Sách Bạn Thật Sự Là Ai?",61500,88000,26500,30
TIKI,nha-sach-tiki,170463582,"Siêu Nhí Biết Tuốt - 101 Bí Ẩn Kích Thích Tò Mò Của Các Bạn Nhỏ",120000,240000,120000,50
TIKI,nha-sach-tiki,77324132,"Phụ Nữ Hiểu Biết Sẽ Có Cuộc Sống Đẳng Cấp Hơn (Tặng Kèm Bookmark)",83200,119000,35800,30
TIKI,nha-sach-tiki,75813201,"Không Đến Một (Tái Bản - Bìa Cam)",87900,110000,22100,20
TIKI,nha-sach-tiki,117035933,"Sách: Hài Hước Một Chút Thế Giới Sẽ Khác Đi (Tái Bản)",60000,80000,20000,25
TIKI,nha-sach-tiki,174038838,"Here U Are – Tập 2 - Bản Thường: Tặng Kèm 1 Bookmark Bế Hình",77100,110000,32900,30
TIKI,nha-sach-tiki,193684717,"Từ Vũ Trụ Đến Trái Tim – Những Thông Điệp Yêu Thương",88900,89000,100,0
TIKI,nha-sach-tiki,195801645,"Thực Học Của Inamori Kazuo: Quản Trị Và Kế Toán",75900,95000,19100,20
TIKI,nha-sach-tiki,26593338,"Misty Morning Walk With Mother - Cùng Mẹ Đi Trong Sương Sớm",62000,85000,23000,27
TIKI,nha-sach-tiki,126853168,"Thấu hiểu Hành vi giá Thị trường Tài chính (Understanding Price Action)",367000,367000,0,0
TIKI,nha-sach-tiki,193981046,"Tiệm trừ yêu kì ảo - Tập 17",33500,35000,1500,4
TIKI,nha-sach-tiki,137241842,"Trồng Một Nụ Cười - Cùng Trẻ Thực Hành Chánh Niệm",149000,199000,50000,25
TIKI,nha-sach-tiki,67477613,"Xin Bạn Hãy Ôm Lấy Trái Tim Mình Trước Đã (Tặng Kèm 1 Bookmark)",65200,96000,30800,32
TIKI,nha-sach-tiki,107363748,"Bút chì màu dạng cốc Deli - bút chì gỗ khô tự nhiên an toàn -  12/24/36/48 màu - 7070",29000,52200,23200,44
TIKI,nha-sach-tiki,107802188,"Bí Mật Tư Duy Triệu Phú (Tái Bản)",74400,108000,33600,31
TIKI,nha-sach-tiki,75403873,"Bộ Màu Nước Solid Water Color Cao Cấp - Tặng Kèm 2 Bút Nước, 2 Mút, 1 Palette - Chuyên Dùng Cho Học Sinh, Sinh Viên, Vẽ Chuyên Nghiệp - Hàng Chính Hãng - VinBuy",65000,120000,55000,46
TIKI,nha-sach-tiki,185024355,"Spy X Family 7",23500,25000,1500,6
TIKI,nha-sach-tiki,195306000,"Tư trị thông giám - Tập 9",234000,285000,51000,18
TIKI,nha-sach-tiki,56878836,"Sách Muôn Kiếp Nhân Sinh (Bìa Cứng) - Nguyên Phong",158000,228000,70000,31
TIKI,nha-sach-tiki,190214568,"Kỷ luật bản thân",122000,189000,67000,35
TIKI,nha-sach-tiki,95090744," Bút chì lục giác Deli - loại 2B/HB - 30 chiếc/hộp - 58166 / 58167",55000,99000,44000,44
TIKI,nha-sach-tiki,87389629,"OSHO - Sáng Tạo Bừng Cháy Sức Mạnh Bên Trong (Tái Bản)",72900,108000,35100,33
TIKI,nha-sach-tiki,117681065,"Sống Thực Tế Giữa Đời Thực Dụng (Tái Bản)",92800,129000,36200,28
TIKI,nha-sach-tiki,32192510,"Madame Chic - Rất Thần Thái, Rất Paris",69200,99000,29800,30
TIKI,nha-sach-tiki,130314065,"Tâm lý thị trường chứng khoán - Hành vi đám đông và sự thật đằng sau những con sóng",30000,50000,20000,40
TIKI,nha-sach-tiki,41131985,"Thực Hành 7 Thói Quen Của Bạn Trẻ Thành Đạt",53700,78000,24300,31
TIKI,nha-sach-tiki,189371286,"[ Gift] [Hàng Tặng Không Bán] Sổ Tay Sức Khỏe DHC",50000,50000,0,0
TIKI,nha-sach-tiki,22986051,"Atomic Habits",394800,458000,63200,14
TIKI,nha-sach-tiki,49249526,"Thiết Kế Cuộc Đời Thịnh Vượng - Design a Prosperous Life",299000,299000,0,0
TIKI,nha-sach-tiki,174377494,"Combo 10 cuốn Ehon Ươm mầm Tính cách",180000,390000,210000,54
TIKI,nha-sach-tiki,274876002,"Thiên Quan Tứ Phúc - Tập 4",129100,169000,39900,24
TIKI,nha-sach-tiki,191045569,"Viên Tiên Sinh Luôn Không Vui - Tập 1 - Bản thường: Bookmark chuột hamster, Postcard chữ ký tác giả",95300,159000,63700,40
TIKI,nha-sach-tiki,106788395,"Toán Tư duy - Beginning Creative Math (Dành cho bé 4-6 tuổi/Song ngữ Việt - Anh)",55000,110000,55000,50
TIKI,nha-sach-tiki,190701636,"Yuri Espoir (Tập 2) - Bản thường: tặng kèm postcard",47300,79000,31700,40
TIKI,nha-sach-tiki,178483666,"Những Lời Giáo Huấn Của Epictetus",173000,239000,66000,28
TIKI,nha-sach-tiki,23433003,"30 Chủ Đề Từ Vựng Tiếng Anh (Tập 1)",137000,190000,53000,28
TIKI,nha-sach-tiki,113655308,"Giáo Trình Kinh Tế Chính Trị Mác – Lênin (Dành Cho Bậc Đại Học Hệ Không Chuyên Lý Luận Chính Trị) - Bộ mới năm 2021",59000,59000,0,0
TIKI,nha-sach-tiki,142791749,"Sự Trỗi Dạy Và Suy Tàn Của Đế Chế Thứ 3 (Tái Bản)",303000,445000,142000,32
TIKI,nha-sach-tiki,171549988,"Trường An Ly Ca 2 - Vén Mây Thấy Trời",132000,165000,33000,20
TIKI,nha-sach-tiki,142675354,""Từ Điển" Sử Dụng Loài Người",75500,105000,29500,28
TIKI,nha-sach-tiki,126474205,"Làm giàu từ chứng khoán bằng phương pháp VSA chính gốc: Nghiên cứu chuyên sâu về cách giao dịch của Wyckoff",499000,499000,0,0
TIKI,nha-sach-tiki,142833449,"Sanctify - Tập 2",92700,109000,16300,15
TIKI,nha-sach-tiki,174605333,"Châu Phi Nghìn Trùng (Tái Bản)",128000,165000,37000,22
TIKI,nha-sach-tiki,116835635,"Tớ Học Lập Trình - Làm Quen Với Python",83900,105000,21100,20
TIKI,nha-sach-tiki,83004183,"Nhóc Miko! Cô Bé Nhí Nhảnh 34",20000,25000,5000,20
TIKI,nha-sach-tiki,971704,"Tạo Lập Mô Hình Kinh Doanh (Tái bản)",216000,299000,83000,28
TIKI,nha-sach-tiki,95311757,"Lưu Thông Máu Tốt Hóa Giải Bách Bệnh",72200,99000,26800,27
TIKI,nha-sach-tiki,192125806,"Dạy con làm giàu - Tập 11 - Trường dạy kinh doanh cho những người thích giúp đỡ người khác (Tái Bản 2022)",60700,80000,19300,24
TIKI,nha-sach-tiki,197629362,"Bức Họa Múa Rối Xương (Combo tập 1+2)",201000,279000,78000,28
TIKI,nha-sach-tiki,140416366,"Hôm Nay Phải Mở Mang (Một Tựa Sách Của Ngày Ngày Viết Chữ Dành Cho Người Học Viết Và Làm Nghề Viết)",83200,119000,35800,30
TIKI,nha-sach-tiki,175845415,"Bí Quyết Tìm Kiếm Mặt Bằng Kinh Doanh - Đến Sahara Mở Quán Trà Đá - Bộ Sách Khởi Nghiệp Bán Lẻ",162000,199000,37000,19
TIKI,nha-sach-tiki,181699672,"Shuggie Bain: Chiếc Linh Hồn Nhỏ",169000,235000,66000,28
TIKI,nha-sach-tiki,579823,"Nhà Lãnh Đạo Không Chức Danh",89000,105000,16000,15
TIKI,nha-sach-tiki,136232535,"Ux Content 4.0 (Chọn Đúng Chữ, Giữ Người Dùng)",100000,139000,39000,28
TIKI,nha-sach-tiki,192692368,"Phương Pháp Thực Chiến Hiệu Suất Cao Đến Từ Nhà Quán Quân Giao Dịch Tài Chính",364000,364000,0,0
TIKI,nha-sach-tiki,53434797,"Sách Tài Chính Cá Nhân Cho Người Việt Nam - Tặng Khóa học Online về Tài chính",200000,200000,0,0
TIKI,nha-sach-tiki,162426359,"Cà Insider No.1 - SENSORY - Chạm Cà Phê Từ Mọi Giác Quan",242000,285000,43000,15
TIKI,nha-sach-tiki,1445365,"Dưới Một Mái Nhà Ở Paris",94900,119000,24100,20
TIKI,nha-sach-tiki,55605172,"Tắt Đèn (Tái Bản 2020)",35900,50000,14100,28
TIKI,nha-sach-tiki,110944248,"Tôi Không Thích Ồn Ào (Tặng Kèm Bookmark)(Tái Bản)",45000,75000,30000,40
TIKI,nha-sach-tiki,197602052,"Fullmetal Alchemist - Cang Giả Kim Thuật Sư - Fullmetal Edition Tập 7",64900,69000,4100,6
TIKI,nha-sach-tiki,4466841,"Trưởng Thành Sau Ngàn Lần Tranh Đấu (Tái Bản)",74000,95000,21000,22
TIKI,nha-sach-tiki,185226873,"Achievers Grade 7 Student's Book with CLIL Book",251000,251000,0,0
TIKI,nha-sach-tiki,155463021,"Hành Trình Nuôi Con Mang Thai - Cẩm Nang Thai Sản Đầy Đủ Nhất",479000,699000,220000,31
TIKI,nha-sach-tiki,96327064,"Bye Béo - Cách giảm 7kg trong 30 ngày",199000,199000,0,0
TIKI,nha-sach-tiki,273896677,"Trí Tuệ Do Thái",139860,189000,49140,26
TIKI,nha-sach-tiki,194471830,"We Best Love - Mãi Mãi Là Số 1 & Cuộc Phản Công Của Số 2 [Tặng Kèm Bookmark + Postcard + Bìa Bao Giả Lập Poster + Giá Đỡ Điện Thoại]",136000,180000,44000,24
TIKI,nha-sach-tiki,98733259,"Những Tù Nhân Của Địa Lí - Khám Phá Sự Vận Hành Của Thế Giới Qua Những Tấm Bản Đồ - Phiên Bản Minh Hoạ Màu Dành Cho Độc Giả Trẻ",164000,230000,66000,29
TIKI,nha-sach-tiki,137561095,"Combo 2 Cuốn Sách Tâm Lý Học Nhập Môn: Toàn Thư Tâm Lý Học + Từ Điển Tâm Lý",183000,254000,71000,28
TIKI,nha-sach-tiki,188039858,"Combo 4 Cuốn Sổ Tay Ghi Chép A5 Gáy Xoắn 120 Trang Kẻ Ngang Deli - Phù Hợp Làm Sổ Kế Hoạch Planner, Nhật Kí, Tập Vở Ghi Chép Bullet Journal - LA560-06",37800,37800,0,0
TIKI,nha-sach-tiki,106149744,"Tôi Đã Kiếm 2.000.000 Đô La Từ Thị Trường Chứng Khoán Như Thế Nào (Tái Bản)",76400,109000,32600,30
TIKI,nha-sach-tiki,193099631,"Đại Gia Gatsby",67800,86000,18200,21
TIKI,nha-sach-tiki,197602124,"Fullmetal Alchemist - Cang Giả Kim Thuật Sư - Fullmetal Edition - Tập 6",62000,69000,7000,10
TIKI,nha-sach-tiki,56750844,"Tiểu Sử Steve Jobs (Tái Bản 2020)",336000,449000,113000,25
TIKI,nha-sach-tiki,187827390,"Gửi Tới Người Mùa Đông Này Sẽ Không Còn Nữa",88500,123000,34500,28
TIKI,nha-sach-tiki,187827443,"Ăn Gì Không Chết - Sức Mạnh Chữa Lành Của Thực Phẩm",235000,320000,85000,27
TIKI,nha-sach-tiki,3876677,"Hỏa Ngục",158000,239000,81000,34
TIKI,nha-sach-tiki,83664156,"Rio Book No.2 - Nhận Diện Thương Hiệu, Những Điểm Chạm Thị Giác (Tái Bản)",133000,170000,37000,22
TIKI,nha-sach-tiki,162832796,"Rilla Dưới Mái Nhà Bên Ánh Lửa",156000,200000,44000,22
TIKI,nha-sach-tiki,169621659,"Trầm Hương - Bản Thường - (Tặng Kèm 01 Bookmark 2 Mặt)",107000,135000,28000,21
TIKI,nha-sach-tiki,139979522,"Ăn Dặm Kiểu Nhật (Tái Bản)",134000,189000,55000,29
TIKI,nha-sach-tiki,23437685,"English Vocabulary in Use: Pre-Intermediate and Intermediate Book with Answers: Vocabulary Reference and Practice (Kèm CD)",167900,193000,25100,13
TIKI,nha-sach-tiki,105778970,"Nhật Ký Tarot",143000,199000,56000,28
TIKI,nha-sach-tiki,11336581,"Rich Habits - Thói Quen Thành Công Của Những Triệu Phú Tự Thân",104000,158000,54000,34
TIKI,nha-sach-tiki,77149524,"Range - Hiểu Sâu Biết Rộng Kiểu Gì Cũng Thắng",135000,179000,44000,25
TIKI,nha-sach-tiki,188663311,"Khi Bạn Đang Mơ Thì Người Khác Đang Nỗ Lực (2022)",108800,136000,27200,20
TIKI,nha-sach-tiki,43859629,"Người giàu nhất thành Babylon - phiên bản đầy đủ thêm 2 chương mới",48000,80000,32000,40
TIKI,nha-sach-tiki,106206473,"Thân Gửi Sở Thú",62900,79000,16100,20
TIKI,nha-sach-tiki,149257065,"Keanu Reeves - Ma Trận Cuộc Đời (Bí Ẩn Đằng Sau Người Đàn Ông Tử Tế Nhất Hành Tinh)",67000,168000,101000,60
TIKI,nha-sach-tiki,57590002,"Fullmetal Alchemist - Cang Giả Kim Thuật Sư - Fullmetal Edition Tập 5",62000,69000,7000,10
TIKI,nha-sach-tiki,3640427,"Quẳng Gánh Lo Đi Và Vui Sống (Nguyễn Hiến Lê - Bộ Sách Sống Sao Cho Đúng)",58400,90000,31600,35
TIKI,nha-sach-tiki,56377199,"Giải Mã Siêu Trí Tuệ",126000,169000,43000,25
TIKI,nha-sach-tiki,131879454,"Combo Philip Kotler: Tiếp Thị 5.0 - Công Nghệ Vị Nhân Sinh Và Tiếp Thị 4.0 - Dịch Chuyển Từ Truyền Thống Sang Công Nghệ Số",223250,235000,11750,5
TIKI,nha-sach-tiki,897016,"Combo Sân Chơi Trí Tuệ Của Chim Đa Đa (Bộ 6 Cuốn)",139000,180000,41000,23
TIKI,nha-sach-tiki,191571530,"Văn Phòng Thám Tử Quái Vật - Tập 09",15000,30000,15000,50
TIKI,nha-sach-tiki,54433518,"Combo Sách Học Tiếng Anh Little Stories 1 (5 Cuốn)",237000,325000,88000,27
TIKI,nha-sach-tiki,76278485,"Ảo Dạ (Tái Bản)",143000,179000,36000,20
TIKI,nha-sach-tiki,341073,"Xin Hãy Quên Em",91000,91000,0,0
TIKI,nha-sach-tiki,140635218,"Nuôi Dạy Đứa Trẻ Tự Chủ",125000,179000,54000,30
TIKI,nha-sach-tiki,192474352,"Vẻ Đẹp Của Sự Vừa Đủ",97800,136000,38200,28
TIKI,nha-sach-tiki,187933551,"Reiki - Nghệ Thuật Chữa Lành Bằng Năng Lượng",123000,189000,66000,35
TIKI,nha-sach-tiki,147802908,"Trong Cái Không Có Gì Không ? - Thiền Sư Thích Nhất Hạnh (NXB KĐ - bìa cứng)",144000,160000,16000,10
TIKI,nha-sach-tiki,11806671,"Combo Doraemon Truyện Tranh Màu Kỹ Thuật Số (6 Tập)",180000,180000,0,0
TIKI,nha-sach-tiki,150956757,"Combo 8 cuốn Túi tô màu Tập làm họa sĩ nhí",42000,84000,42000,50
TIKI,nha-sach-tiki,143185998,"Ăn Dặm Không Phải Là Cuộc Chiến (Tái Bản)",217000,289000,72000,25
TIKI,nha-sach-tiki,193917225,"Vẽ Vời Vẩn Vơ - 3",20000,58000,38000,66
TIKI,nha-sach-tiki,104315085,"Tư Duy Logic (Tái Bản)",73700,110000,36300,33
TIKI,nha-sach-tiki,174449882,"“Lần Đầu Làm Sếp” – (Your First Leadership Job)",149000,195000,46000,24
TIKI,nha-sach-tiki,178514165,"Dọc Đường",128000,160000,32000,20
TIKI,nha-sach-tiki,116158321,"7 Chiến Lược Thịnh Vượng Và Hạnh Phúc (Tái Bản 2021)",85000,85000,0,0
TIKI,nha-sach-tiki,82936273,"Óc Sáng Suốt (Tái Bản 2021)",47900,60000,12100,20
TIKI,nha-sach-tiki,195291930,"Bốn Thỏa Ước",87000,130000,43000,33
TIKI,nha-sach-tiki,185889844,"Tại Sao Chúng Tôi Muốn Bạn Giàu",108000,135000,27000,20
TIKI,nha-sach-tiki,58971674,"Sách Nghệ Thuật Bán Hàng Của Người Do Thái (Tái Bản 2020)",60600,88000,27400,31
TIKI,nha-sach-tiki,193605360,"Chuyện Xưa Tôi Nhớ Người Cũ Đã Quên (Lam – Lê)",63800,89000,25200,28
TIKI,nha-sach-tiki,65008052,"Từ Điển Anh - Anh - Việt",208600,298000,89400,30
TIKI,nha-sach-tiki,52798281,"Phương Pháp Giáo Dục Sớm Montessori Cho Trẻ Từ
0 – 3 Tuổi",64100,99000,34900,35
TIKI,nha-sach-tiki,148802204,"Chuyện Trà - Lịch Sử Một Thức Uống Lâu Đời Của Người Việt (Bìa Mềm)",229000,290000,61000,21
TIKI,nha-sach-tiki,165030714,"Black Jack 07 (Bìa Mềm)",27500,30000,2500,8
TIKI,nha-sach-tiki,1734377,"Những Chú Chó Bán Hàng",96100,140000,43900,31
TIKI,nha-sach-tiki,121372698,"NGÀI CÓC ĐI GẶP BÁC SĨ TÂM LÝ ( BÌA CỨNG)",160000,219000,59000,27
TIKI,nha-sach-tiki,9490657,"Hệ thống giao dịch Ichimoku Charts - Ichimoku Kinko Clouds (Phiên bản sách năm 2018)",330000,330000,0,0
TIKI,nha-sach-tiki,184782104,"Cha Mẹ Độc Hại (Tái Bản)",112000,148000,36000,24
TIKI,nha-sach-tiki,121185868,"Vang Bóng Một Thời (Việt Nam Danh Tác)",59900,76000,16100,21
TIKI,nha-sach-tiki,192909296,"Anh Em Phi Hành Gia - Tập 31",40600,45000,4400,10
TIKI,nha-sach-tiki,74981856,"Gửi Bạn, Người Đã Kiệt Sức Vì Những Chịu Đựng Âm Thầm [Tặng Kèm: 1 Bookmark Daisy]",67100,96000,28900,30
TIKI,nha-sach-tiki,85923342,"Minh Triết Trong Ăn Uống Của Phương Đông (Tái Bản)",92000,168000,76000,45
TIKI,nha-sach-tiki,84950236,"Người Nhạy Cảm Trong Thế Giới Vô Cảm",65400,85000,19600,23
TIKI,nha-sach-tiki,127077157,"Bà Tổng Thống Trước Họng Súng - Hai Số Phận - Phần III",115000,169000,54000,32
TIKI,nha-sach-tiki,186202768,"Và Rồi Tháng 9 Không Có Cậu Đã Tới (Tái Bản)",63500,106000,42500,40
TIKI,nha-sach-tiki,104273017,"Combo 2 Tập: Tăng Thông Khí - Bản Thường - (Tặng Kèm 2 Bookmark In 2 Mặt)(Bìa Mềm)",186000,258000,72000,28
TIKI,nha-sach-tiki,7644510,"Lòng Tốt Của Bạn Cần Thêm Đôi Phần Sắc Sảo",85200,108000,22800,21
TIKI,nha-sach-tiki,110583137,"Bút highlight nhấn dòng dạ quang Deli - Cam/ Vàng/ Xanh Lá/ Hồng/ Xanh Dương - S625",5900,10620,4720,44
TIKI,nha-sach-tiki,105231736,"How To Crack The Ielts Writing Test - Vol. 1 (Tái Bản)",226000,319000,93000,29
TIKI,nha-sach-tiki,69624539,"Khoa Học Về Yoga",240000,300000,60000,20
TIKI,nha-sach-tiki,187001113,"Giấy bọc sách vở / Giấy gói quà / giấy bao tập / giấy bao vở học sinh, sinh viên size A4, B5, A5 cao cấp – 24 cuốn",49000,88000,39000,44
TIKI,nha-sach-tiki,178032047,"Fullmetal Alchemist - Cang Giả Kim Thuật Sư - Fullmetal Edition Tập 14 [Tặng Kèm Bookmark Pvc]",66100,69000,2900,4
TIKI,nha-sach-tiki,75636226,"Phương pháp VPA - Kỹ thuật nhận diện Dòng Tiền Thông Minh bằng Hành Động Giá kết hợp Khối Lượng Giao Dịch",357000,357000,0,0
TIKI,nha-sach-tiki,13061338,"Series Địch Công Kỳ Án Tập 15 - Hoa Văn Cây Liễu",95000,99000,4000,4
TIKI,nha-sach-tiki,174215331,"Ajin - Boxset Số 2 (Tập 7 - 12) - Tặng Kèm Bookmark 3D",271000,300000,29000,10
TIKI,nha-sach-tiki,270665134,"Bút lông màu Fiber Pen 20 màu Pastel Thiên Long Colokit rửa được an toàn sử dụng tô màu, vẽ tranh, calligraphy SWM-C008",59000,87000,28000,32
TIKI,nha-sach-tiki,32802803,"Quản Trị Nhân Sự Đúng",201000,279000,78000,28
TIKI,nha-sach-tiki,28292286,"Combo 30 Chủ Đề Từ Vựng Tiếng Anh (2 Tập)",234000,380000,146000,38
TIKI,nha-sach-tiki,114765005,"Vụng Trộm Yêu Anh - Tập 1+2 (Tặng Kèm: 02 Bookmark 2 Mặt Theo Bìa)",179000,249000,70000,28
TIKI,nha-sach-tiki,184779709,"Xã Hội Học - Khái Lược Những Tư Tưởng Lớn",320000,390000,70000,18
TIKI,nha-sach-tiki,146223395,"Cách thức kinh doanh và đầu cơ cổ phiếu! – How to Trade in Stocks",349000,349000,0,0
TIKI,nha-sach-tiki,157255019,"Bộ Màu Nước Nén Water Color Cao Cấp 24 36 48 Màu Tặng Bút Lông Nước, Mút, Cọ, Tẩy, Bút Chì, Gọt, Màu Trắng Deli - Chuyên Dùng Cho Học Sinh, Sinh Viên, Vẽ Mĩ Thuật Chuyên Nghiệp",129000,232200,103200,44
TIKI,nha-sach-tiki,185242029,"Vũ Điệu Quỷ Satan",126000,158000,32000,20
TIKI,nha-sach-tiki,110447680,"Kế Hoạch Marketing Trên Một Trang Giấy (Những Chỉ Dẫn Dễ Hiểu Nhất Cho Một Kế Hoạch Marketing Thông Minh)",118000,159000,41000,26
TIKI,nha-sach-tiki,186265452,"My Hero Academia - Học Viện Siêu Anh Hùng Tập 29: Bakugo Katsuki: Trỗi Dậy",23500,25000,1500,6
TIKI,nha-sach-tiki,49722650,"12 Quy Luật Cuộc Đời: Thần Dược Cho Cuộc Sống Hiện Đại",195000,300000,105000,35
TIKI,nha-sach-tiki,447164,"Tôi Vẽ - Phương Pháp Tự Học Vẽ Truyện Tranh",73900,100000,26100,26
TIKI,nha-sach-tiki,169621653,"Đến Ngày Gặp Anh",103800,115000,11200,10
TIKI,nha-sach-tiki,194205624,"Pippi Tất Dài",99900,125000,25100,20
TIKI,nha-sach-tiki,150783204,"Combo 10 miếng dán keo 2 mặt xốp siêu dính",20000,20000,0,0
TIKI,nha-sach-tiki,196204932,"[A3/A4/A5/A6] Giấy Vẽ Màu Nước Tệp 16 Tờ 300Gsm A3 / A4 / A5 / A6 Chuyên Dụng Hạng Hoạ Sĩ Watercolor Paper Cao Cấp Finenolo Deli - Dùng Cho Màu Nước Gouache Acrylic Nhiều Cọ - EC270",18500,34200,15700,46
TIKI,nha-sach-tiki,62648437,"Kinh Doanh Dịch Vụ Tại Việt Nam - Tự Tay Vận Hành Hoạt Động Marketing Của Bạn",148000,190000,42000,22
TIKI,nha-sach-tiki,155049277,"IELTS Key Writing - Công Thức Học Nhanh IELTS Writing Task 1",92700,119000,26300,22
TIKI,nha-sach-tiki,97825967,"Tuyển Tập Những Câu Chuyện Hay Nhất Của AESOP (Song Ngữ Anh - Việt)",60800,108000,47200,44
TIKI,nha-sach-tiki,160488838,"Axit Và Kiềm Trong Thực Dưỡng (Tái Bản)",56200,75000,18800,25
TIKI,nha-sach-tiki,115897817,"Kỷ Luật Mềm Trong Gia Đình: Giáo Dục Trẻ 3 - 10 Tuổi Dành Cho Gia Đình Việt",124000,165000,41000,25
TIKI,nha-sach-tiki,130233550,"Vượt Qua Âu Lo, Chữa Lành Tâm Trí - Kiểm Soát Trầm Cảm Trong 7 Tuần Bằng Liệu Pháp Nhận Thức Hành Vi",127000,189000,62000,33
TIKI,nha-sach-tiki,74608742,"Vừa Đủ - Đẳng Cấp Sống Của Người Thụy Điển (Tái Bản)",67700,98000,30300,31
TIKI,nha-sach-tiki,169262882,"Combo 2 cuốn Giáo Trình Hán Ngữ (Sách học Tiếng Trung dành cho người Việt) Giáo Trình Hán Ngữ Tập 1 + Giáo Trình Hán Ngữ Tập 2 (Phiên bản mới - Học bằng App McBooks)",183000,244000,61000,25
TIKI,nha-sach-tiki,173650547,"30 Chuyên Đề Ngữ Pháp Tiếng Anh Cô Trang Anh: Sách ID Tổng ôn Ngữ pháp Tiếng Anh Moonbook",181000,250000,69000,28
TIKI,nha-sach-tiki,6915413,"Nghệ Thuật Tối Giản: Có Ít Đi, Sống Nhiều Hơn (Tái bản)",72300,108000,35700,33
TIKI,nha-sach-tiki,56373209,"Sách ehon - Set 4 cuốn Tớ là em bé ngoan - dành cho trẻ từ 2 tuổi",109000,156000,47000,30
TIKI,nha-sach-tiki,158641027,"Kẻ Nhắc Tuồng (Tái Bản)",120000,155000,35000,23
TIKI,nha-sach-tiki,127203905,"Băng Keo Dán Băng Dính 2 Mặt Nano Trong Suốt Đa Năng Siêu Dính Chống Nước Deli - Nhiều Kích Cỡ",23500,45000,21500,48
TIKI,nha-sach-tiki,81437585,"Tiếng Triều Dâng",111000,140000,29000,21
TIKI,nha-sach-tiki,80141519,"Hackers IELTS Basic- Writing",141000,199000,58000,29
TIKI,nha-sach-tiki,132355750,"Võ Nguyên Giáp - Hào Khí Trăm Năm (Tái Bản)",164000,200000,36000,18
TIKI,nha-sach-tiki,160081248,"Gấu Pooh Xinh Xắn",67500,90000,22500,25
TIKI,nha-sach-tiki,87960389,"Keo Siêu Dính Đa Năng Deli - 7Ml/ 20Ml - 7140/7149",9000,16200,7200,44
TIKI,nha-sach-tiki,101801426,"ĐÚNG VIỆC - Một góc nhìn về câu chuyện KHAI MINH - Giản Tư Trung - IRED Books",100000,125000,25000,20
TIKI,nha-sach-tiki,184466858,"Tâm Lý Học - Những Thí Nghiệm Não Bộ Chưa Được Tiết Lộ",89500,125000,35500,28
TIKI,nha-sach-tiki,273645890,"Trạm Đọc | Thuật Tẩy Não",140900,189000,48100,25
TIKI,nha-sach-tiki,104074993,"Nhảy Nhảy Nhảy (Tái Bản)",133000,169000,36000,21
TIKI,nha-sach-tiki,143226162,"Tỷ Phú Bán Giày (Tái Bản)",118000,159000,41000,26
TIKI,nha-sach-tiki,26272210,"Mọi người đều nói dối - Dữ liệu lớn, Dữ liệu mới và những điều Internet tiết lộ về chính chúng ta",90000,150000,60000,40
TIKI,nha-sach-tiki,184774171,"Đũa - Chuyện Linh Dị",233000,289000,56000,19
TIKI,nha-sach-tiki,75953557,"Tâm Lý Học Về Tiền",122000,189000,67000,35
TIKI,nha-sach-tiki,155463014,"Quốc Gia Khởi Nghiệp - Câu Chuyện Về Nền Kinh Tế Thần Kỳ Của Israel (Tái Bản)",157000,209000,52000,25
TIKI,nha-sach-tiki,192788797,"Fly Me To The Moon - Tóm Lại Là Em Dễ Thương, Được Chưa - Tập 2",46700,55000,8300,15
TIKI,nha-sach-tiki,13101929,"Series Địch Công Kỳ Án Tập 13 - Địch Gia Bát Án",82000,137000,55000,40
TIKI,nha-sach-tiki,181656866,"Lịch Sử Israel - Câu Chuyện Về Sự Hồi Sinh Của Một Dân Tộc (Daniel Gordis)",291000,389000,98000,25
TIKI,nha-sach-tiki,189940724,"Triệu Phú Khu Ổ Chuột",101000,126000,25000,20
TIKI,nha-sach-tiki,153521902,"Những Người Phụ Nữ Bé Nhỏ",90200,129000,38800,30
TIKI,nha-sach-tiki,77982978,"The Master COACH - Con Đường Trở Thành Nhà Khai Vấn Tài Ba",93000,150000,57000,38
TIKI,nha-sach-tiki,141483251,"Sách: Thai Giáo Theo Chuyên Gia - 280 Ngày Mỗi Ngày Đọc 1 Trang (Tái Bản)",83000,115000,32000,28
TIKI,nha-sach-tiki,69337681,"Nhà Tư Tưởng Lớn - Nietzsche Trong 60 Phút",64300,96000,31700,33
TIKI,nha-sach-tiki,114689806,"Full combo (Bộ 10 cuốn) Ehon song ngữ Kỹ năng - Màu sắc - Hình khối - Nhận biết",175000,350000,175000,50
TIKI,nha-sach-tiki,194110075,"Bẩm thầy Tường có thầy Vũ đến tìm - tập 2",115000,115000,0,0
TIKI,nha-sach-tiki,83432000,"Sách Người trong muôn nghề: Ngành Kinh tế có gì?",144000,189000,45000,24
TIKI,nha-sach-tiki,185410021,"Set Decal Bọc Sách Vở Dán Bìa Trong Suốt Chống Nước Nhiều Kích Cỡ Deli - Bọc SGK Vở Sổ Tay Ghi Chép Truyện Tiều Thuyết - Lưu Trữ Bền Đẹp - 70603 / 70602 / 70601",39600,39600,0,0
TIKI,nha-sach-tiki,124767704,"Bạn Đắt Giá Bao Nhiêu? (Tái Bản)",85600,119000,33400,28
TIKI,nha-sach-tiki,271536000,"Chú Thuật Hồi Chiến Tập 3: Cá Con Và Trừng Phạt Ngược",30000,30000,0,0
TIKI,nha-sach-tiki,127654481,"Tiệm Café Bên Rìa Thế Giới",77700,108000,30300,28
TIKI,nha-sach-tiki,157432540,"Thư Tình Gửi Một Người (Trịnh Công Sơn) (Tái Bản)",158000,195000,37000,19
TIKI,nha-sach-tiki,67040880,"Thân Mật Cội Nguồn Của Hạnh Phúc (Tái Bản 2020)",68600,98000,29400,30
TIKI,nha-sach-tiki,181379111,"Vô Cùng Tàn Nhẫn Vô Cùng Yêu Thương Tập 4",112000,149000,37000,25
TIKI,nha-sach-tiki,149942445,"Sức Mạnh Thương Mại Điện Tử - 12 Tháng Kiếm 1 Triệu Đô Bằng Kinh Doanh Online - Bộ Sách Trên Lưng Khổng Tượng",149000,199000,50000,25
TIKI,nha-sach-tiki,96366365,"Bức Tranh Dorian Gray (The Picture Of Dorian Gray)",118000,169000,51000,30
TIKI,nha-sach-tiki,108261352,"Tự Học Ngữ pháp Tiếng Anh Bằng Mindmap Tập 2",112000,145000,33000,23
TIKI,nha-sach-tiki,184226848,"Sợi tóc - Thạch Lam (Bìa mềm)",26200,35000,8800,25
TIKI,nha-sach-tiki,11347711,"All The Rule - Sống Bản Lĩnh Theo Cách Một Quý Cô",52800,96000,43200,45
TIKI,nha-sach-tiki,48592472,"Combo Truyện Tranh Song Ngữ Việt - Anh Cho Bé (12 Tập)",140000,180000,40000,22
TIKI,nha-sach-tiki,137751490,"Bảng từ trắng treo tường viết bút lông Deli Nhiều kích cỡ - Dùng Cho Văn Phòng, Trường Học, Tập Vẽ, Ghi Chú Công Thức Nấu Ăn, Trang Trí Nhà Cửa",319000,574200,255200,44
TIKI,nha-sach-tiki,73810559,"Combo 3 Cuốn: Hiệu Ứng Chim Mồi Tập 1 + 2 + 3",159000,265000,106000,40
TIKI,nha-sach-tiki,5112975,"Marketing giỏi phải kiếm được tiền - The end of marketing as we know it",299000,299000,0,0
TIKI,nha-sach-tiki,47323853,"Chinh Phục Luyện Thi Vào Lớp 10 Môn Tiếng Anh Theo Chủ Đề",95000,159000,64000,40
TIKI,nha-sach-tiki,73795265,"Sách Hợp Nhất Với Vũ Trụ (Bìa Mềm) (Tái Bản 2020)",61500,88000,26500,30
TIKI,nha-sach-tiki,327481,"Nói Dối Và Hẹn Hò Trực Tuyến",61000,61000,0,0
TIKI,nha-sach-tiki,71880692,"600 Câu Hỏi Dùng Cho Sát Hạch, Cấp Giấy Phép Lái Xe Cơ Giới Đường Bộ",43000,43000,0,0
TIKI,nha-sach-tiki,36727163,"Người Nam Châm (Tái Bản 2019)",57670,79000,21330,27
TIKI,nha-sach-tiki,188536931,"Gửi Người Bí Ẩn Thân Thương (Truyện Tranh)",92600,109000,16400,15
TIKI,nha-sach-tiki,107409375,"Tiếng Anh 6 I-Learn Smart World - Workbook (Sách Bài Tập)",68000,68000,0,0
TIKI,nha-sach-tiki,187009994,"Lôi Thần Và Nhân Viên Văn Phòng (Tập 5)",47400,66000,18600,28
TIKI,nha-sach-tiki,120357410,"Thực Hành Khởi Nghiệp - Từng Bước Nhỏ Làm Chủ Doanh Nghiệp Lớn",118000,169000,51000,30
TIKI,nha-sach-tiki,107409418,"Tiếng Anh 6 I-Learn Smart World - Student'S Book (Sách Học Sinh)",78000,78000,0,0
TIKI,nha-sach-tiki,186080463,"Hành Tinh Của Một Kẻ Nghĩ Nhiều",63600,86000,22400,26
TIKI,nha-sach-tiki,13065341,"Series Địch Công Kỳ Án Tập 16 - Quảng Châu Án",79000,158000,79000,50
TIKI,nha-sach-tiki,182149648,"Nước Ép Trị Liệu Và Chế Độ Ăn Theo Phương Pháp Cơ Thể Tự Chữa Lành",147200,199000,51800,26
TIKI,nha-sach-tiki,147920905,"Đường Mây Qua Xứ Tuyết (Tái Bản)",82700,118000,35300,30
TIKI,nha-sach-tiki,188694727,"Tập viết tiếng Thái",35000,50000,15000,30
TIKI,nha-sach-tiki,45438055,"BỘ SÁCH HỌC TIẾNG ANH lITTLE STORIES",445000,650000,205000,32
TIKI,nha-sach-tiki,14100920,"Bánh Mì Kẹp Chuột (Tái Bản 2019)",62900,79000,16100,20
TIKI,nha-sach-tiki,196395463,"Dưới cánh đại bàng (bìa mềm)",124200,138000,13800,10
TIKI,nha-sach-tiki,146988856,"Lựa Chọn Đúng Quan Trọng Hơn Nỗ Lực - 6 Bước Để Ra Quyết Định Hoàn Hảo",110000,170000,60000,35
TIKI,nha-sach-tiki,138269668,"Từ Điển Tiếng Việt (Hoàng Phê)(Tái Bản)",445000,495000,50000,10
TIKI,nha-sach-tiki,11508322,"Nội Tình Của Ngoại Tình",143000,220000,77000,35
TIKI,nha-sach-tiki,192339427,"Bà Bác Khủng Khiếp",118000,150000,32000,21
TIKI,nha-sach-tiki,190705661,"Lại Thằng Nhóc Emil",86900,109000,22100,20
TIKI,nha-sach-tiki,181699658,"Chiến Lược Giao Dịch Của Jesse Livermore",116000,159000,43000,27
TIKI,nha-sach-tiki,1029894,"Tuần Của Bé - Bé Tinh Tế (Dành Cho Trẻ 3 - 6 Tuổi)",22000,23000,1000,4
TIKI,nha-sach-tiki,185500894,"i-Learn Smart Start 5 Student's Book Special Edition",113000,113000,0,0
TIKI,nha-sach-tiki,274145052,"Trạm Đọc| Hackers IELTS Basic: Reading + Writing + Speaking + Listening ( Dành cho người mới bắt đầu )",627000,836000,209000,25
TIKI,nha-sach-tiki,58627102,"Sổ Tay Nhà Thôi Miên",101000,145000,44000,30
TIKI,nha-sach-tiki,89001327,"Giao Dịch Theo Xu Hướng Để Kiếm Sống",366000,366000,0,0
TIKI,nha-sach-tiki,183539219,"Thằng Huyện Con Hầu",71100,89000,17900,20
TIKI,nha-sach-tiki,46723656,"Sách Tử Tế Đáng Giá Bao Nhiêu",67700,98000,30300,31
TIKI,nha-sach-tiki,67712912,"Phát Triển Trí Tuệ Cảm Xúc- Chúng Mình Tôn Trọng Cơ Thể Và Cảm Xúc Của Nhau",38900,50000,11100,22
TIKI,nha-sach-tiki,193450572,"Quái Mèo Độc Tấu",102000,119000,17000,14
TIKI,nha-sach-tiki,568762,"Tam Quốc Diễn Nghĩa (Trọn Bộ 04 Tập)",175000,350000,175000,50
TIKI,nha-sach-tiki,72202103,"Con Chim Xanh Biếc Bay Về (Nguyễn Nhật Ánh) (Bìa Mềm)",111000,150000,39000,26
TIKI,nha-sach-tiki,3526069,"Quản Trị Nguồn Nhân Lực",96000,145000,49000,34
TIKI,nha-sach-tiki,188960732,"COMBO TỰ HỌC TAROT: Sách Nhật ký Tarot + Bộ Bài & Sách Hướng Dẫn (Tái bản 2022)",286000,398000,112000,28
TIKI,nha-sach-tiki,40933973,"Dịch Kinh Tường Giải (Di Cảo): Quyển Thượng (Tái Bản)",250000,340000,90000,26
TIKI,nha-sach-tiki,34751481,"Ngụ Ngôn Song Ngữ Anh - Việt: Kiến Và Chim Bồ Câu (Tái Bản 2019)",16000,28000,12000,43
TIKI,nha-sach-tiki,344788,"Bất Cứ Điều Gì Em Muốn",69000,69000,0,0
TIKI,nha-sach-tiki,185658131,"Dragon Quest - Dấu Ấn Roto (Dragon Quest Saga Emblem Of Roto) Perfect Edition Tập 7 [Tặng Kèm Bookmark PVC] ",67400,75000,7600,10
TIKI,nha-sach-tiki,95089986," Bút chì màu gốc dầu cao cấp Deli - 6565 / 6566 / 6567",139000,250200,111200,44
TIKI,nha-sach-tiki,168559524,"Gia Đình Tỉnh Thức",152000,209000,57000,27
TIKI,nha-sach-tiki,45321630,"Bạn Chỉ Tưởng Là Mình Đang Rất Cố Gắng",98300,123000,24700,20
TIKI,nha-sach-tiki,114228620,"Combo Tiếng Hàn Tổng Hợp Sơ Cấp 1 Dành Cho Người Việt Nam Bản In Màu - Học Kèm App",267750,357000,89250,25
TIKI,nha-sach-tiki,148802194,"Bản Đồ Các Ngày",140000,175000,35000,20
TIKI,nha-sach-tiki,100202726,"Phương Pháp Wyckoff Hiện Đại - Kỹ thuật Nhận diện Xu hướng Thị trường Tiềm năng",356000,356000,0,0
TIKI,nha-sach-tiki,171212880,"Ikigai – Đi Tìm Lý Do Thức Dậy Mỗi Sáng",66200,89000,22800,26
TIKI,nha-sach-tiki,193895767,"THE DAILY STOIC – 366 CHIÊM NGHIỆM VỀ TRÍ TUỆ VÀ LÒNG CAN TRƯỜNG CÙNG NGHỆ THUẬT SỐNG",174000,239000,65000,27
TIKI,nha-sach-tiki,71094783,"Linh Hồn Của Tiền - The Soul Of Money",249000,249000,0,0
TIKI,nha-sach-tiki,89204253,"4000 Từ Vựng Và Mẫu Câu Tiếng Anh Thiết Yếu Cho Trẻ Em",163000,250000,87000,35
TIKI,nha-sach-tiki,138934620,"Red Nile - Tiểu Sử Của Dòng Sông Vĩ Đại Nhất Thế Giới",298000,399000,101000,25
TIKI,nha-sach-tiki,155463025,"Nghệ Thuật Bán Hàng Bậc Cao - Bí Quyết Chốt Deal Mọi Thời Đại (Khổ Lớn)(Tái Bản)",139000,198000,59000,30
TIKI,nha-sach-tiki,193099629,"Chuyên Gia Kinh Tế Bước Vào Nhà Thổ Và Những Nơi Không Ngờ Khác Để Hiểu Về Rủi Ro",138000,175000,37000,21
TIKI,nha-sach-tiki,68456842,"Bài Tập Tiếng Anh 8 - Không Đáp Án",27900,40000,12100,30
TIKI,nha-sach-tiki,5743603,"Vật Lý Thiên Văn Cho Người Vội Vã",63900,80000,16100,20
TIKI,nha-sach-tiki,195959545,"Chú Thuật Hồi Chiến - Tập 6 - Bản Thường - Tặng Kèm Obi Và Thẻ Bo Góc Nhựa",28500,30000,1500,5
TIKI,nha-sach-tiki,115972858,"Sổ tay ghi chép lò xo màu pastel Deli - Giấy kẻ ngang 80 trang khổ A5 / B5 - Phù hợp làm sổ kế hoạch, sổ nhật kí, tập vở ghi chép - 24202 / 24203",39000,70200,31200,44
TIKI,nha-sach-tiki,195190269,"Combo Anime Comics: One Piece Film Strong World (2 Cuốn)",146000,154000,8000,5
TIKI,nha-sach-tiki,55589742,"Sách Bài Học Diệu Kỳ Từ Chiếc Xe Rác (Khổ Lớn) (Tái Bản)",63100,108000,44900,42
TIKI,nha-sach-tiki,66698344,"Sách Bài Học Diệu Kỳ Từ Chiếc Xe Rác (Khổ Nhỏ) (Tái Bản 2020)",61500,88000,26500,30
TIKI,nha-sach-tiki,171055469,"TikTok Tất Tần Tật",114000,158000,44000,28
TIKI,nha-sach-tiki,38265901,"Điều Quan Trọng Nhất – The Most Important Thing",299000,299000,0,0
TIKI,nha-sach-tiki,67060012,"Phát Triển Trí Tuệ Cảm Xúc- Cảm Xúc Của Con Màu Gì?",37400,50000,12600,25
TIKI,nha-sach-tiki,138504809,"EQ - Đừng Để Cảm Xúc Hạ Gục Bản Thân",116000,159000,43000,27
TIKI,nha-sach-tiki,58732189,"Liệu Pháp Tâm Lý: Ứng Dụng Màu Sắc Thay Đổi Cuộc Sống",120000,159000,39000,25
TIKI,nha-sach-tiki,187827433,"Sau Tang Lễ",99600,145000,45400,31
TIKI,nha-sach-tiki,22725674,"Kinh Nghiệm Từ Nước Nhật - Giúp Con Tự Lập Từ 0-6 Tuổi",52600,62000,9400,15
TIKI,nha-sach-tiki,176824199,"Thần Số Học - Làm Chủ Cuộc Đời",99300,138000,38700,28
TIKI,nha-sach-tiki,159259322,"Nhớ Hà Nội, Thương Sài Gòn",90200,129000,38800,30
TIKI,nha-sach-tiki,190708149,"Chitose Trong Chai Ramune – Tập 1 - Bản Phổ Thông - [Tặng Bookmark Bế Hình Có Chân Đế]",78800,105000,26200,25
TIKI,nha-sach-tiki,1534613,"Giáo Trình Chuẩn HSK 5 Bài Học (Tập 1)",220000,278000,58000,21
TIKI,nha-sach-tiki,51845986,"Chinh Phục Luyện Thi Vào 10 Môn Ngữ Văn Theo Chủ Đề",100000,159000,59000,37
TIKI,nha-sach-tiki,172206434,"Huyền Thuật Và Các Đạo Sĩ Tây Tạng (Tái Bản)",75500,108000,32500,30
TIKI,nha-sach-tiki,193895769,"Cao Thủ "Đổi Đen Thay Trắng" - Tập 6 (Tiểu thuyết)",119000,159000,40000,25
TIKI,nha-sach-tiki,11368983,"Combo Giáo Trình Chuẩn HSK 2 - Bài Học (Kèm 1 MP3) và Giáo Trình HSK 2 - Sách Bài Tập (Kèm MP3) ( Tặng Kèm Viết )",308800,386000,77200,20
TIKI,nha-sach-tiki,7369223,"Cho Tôi Xin Một Vé Đi Tuổi Thơ",67900,90000,22100,25
TIKI,nha-sach-tiki,143513113,"Con Yêu Bố Chừng Nào",63100,79000,15900,20
TIKI,nha-sach-tiki,194959693,"Hàn Quốc Quốc Gia Gây Sững Sờ",180000,225000,45000,20
TIKI,nha-sach-tiki,181699688,"Husky Và Sư Tôn Mèo Trắng Của Hắn - Tập 3",131000,169000,38000,22
TIKI,nha-sach-tiki,191636255,"Chòm Sao Linh Thú Tập 7 [Tặng Kèm Bookmark]",37600,40000,2400,6
TIKI,nha-sach-tiki,8886001,"Giết Con Chim Nhại (Tái Bản)",94900,120000,25100,21
TIKI,nha-sach-tiki,123236564,"Combo 6 cuốn: Miếng dán Thông minh cho bé (Phát triển EQ - IQ) - My First Sticker Book",126000,252000,126000,50
TIKI,nha-sach-tiki,58547334,"Bài Tập Tiếng Anh 9 - Không Đáp Án (Tái Bản 2020)",36300,52000,15700,30
TIKI,nha-sach-tiki,343364,"Những Con Chữ Tình Yêu",40000,40000,0,0
TIKI,nha-sach-tiki,197751561,"MONSTER #8 - Tập 5",51000,58000,7000,12
TIKI,nha-sach-tiki,192125793,"Harry Potter và tên tù nhân ngục Azkaban (Tái Bản 2022)",145000,205000,60000,29
TIKI,nha-sach-tiki,2583023,"Bé Nhanh Nhẹn",16000,23000,7000,30
TIKI,nha-sach-tiki,181379287,"Tốc Độ Của Niềm Tin (The Speed Of Trust)(Tái Bản 2022)",131000,175000,44000,25
TIKI,nha-sach-tiki,57211757,"Utopia - Địa đàng trần gian (Tái Bản 2020)",47900,60000,12100,20
TIKI,nha-sach-tiki,46849710,"Robinson Crusoe ",124000,190000,66000,35
TIKI,nha-sach-tiki,50668886,"Thiện, Ác Và Smart Phone (Tái Bản)",89900,105000,15100,14
TIKI,nha-sach-tiki,165030729,"Những Kẻ Âu Lo",144000,180000,36000,20
TIKI,nha-sach-tiki,110112108,"Phương Pháp Đầu Tư Warren Buffett",109000,169000,60000,36
TIKI,nha-sach-tiki,59478514,"Combo 2 Cuốn: Osho Đàn Ông + Osho Phụ Nữ",160000,228000,68000,30
TIKI,nha-sach-tiki,143676192,"Màu Acrylic tuýp mini chuyên nghiệp Deli - 5ml/tuýp - Vẽ vải / Vẽ quần áo / Vẽ giày - 12/18/24 màu",45000,81000,36000,44
TIKI,nha-sach-tiki,197656790,"Kaguya-Sama: Cuộc Chiến Tỏ Tình - Tập 1 - Tặng Kèm Lót Ly",38000,40000,2000,5
TIKI,nha-sach-tiki,186229224,"Bộ Sách Khởi Nghiệp Kinh Doanh Online - Marketing và Bán Hàng Hiệu Quả Với Thương Mại Điện Tử Tại Việt Nam",276000,378000,102000,27
TIKI,nha-sach-tiki,191655862,"[Combo Manga] Diệt Slime Suốt 300 Năm, Tôi Levelmax Lúc Nào Chẳng Hay (Tập 8 + 9)",129000,184000,55000,30
TIKI,nha-sach-tiki,102629342,"999 Lá Thư Gửi Cho Chính Mình (**) - Tập 2 - Mong Bạn Trở Thành Phiên Bản Hạnh Phúc Nhất (Tái bản)",92800,129000,36200,28
TIKI,nha-sach-tiki,101325467,"Bộ Truyện Tranh Gieo Hạt Cùng Vĩ Nhân (Tập 1-10)",270000,270000,0,0
TIKI,nha-sach-tiki,70016676,"Nghệ Thuật Thuyết Trình Bằng Câu Chuyện",149000,199000,50000,25
TIKI,nha-sach-tiki,106149739,"Thế Giới Otome Game Thật Khắc Nghiệt Với Nhân Vật Quần Chúng - Tập 3",108000,179000,71000,40
TIKI,nha-sach-tiki,92996206,"Kinh Yoga Của Patanjali",65400,85000,19600,23
TIKI,nha-sach-tiki,185232575,"Tiếng Anh 3 Extra and Friends Activity book (Sách bài tập)",65000,65000,0,0
TIKI,nha-sach-tiki,2903309,"Khéo Ăn Nói Sẽ Có Được Thiên Hạ ( Tái Bản )",97500,130000,32500,25
TIKI,nha-sach-tiki,15256884,"Đầu Tư Tài Chính (Investments)",615000,659000,44000,7
TIKI,nha-sach-tiki,193605361,"Những Đứa Trẻ Chưa Lớn",54400,109000,54600,50
TIKI,nha-sach-tiki,145977548,"Kiếp Người - Vĩnh Cửu Và Vô Thường ",31000,79000,48000,61
TIKI,nha-sach-tiki,160585834,"Tôi Thích Tin Tức Tố Của Cậu - Tập 1 (Tặng Kèm Bookmark)",129100,169000,39900,24
TIKI,nha-sach-tiki,160585830,"Tôi Thích Tin Tức Tố Của Cậu - Tập 2 (Tặng Kèm Bookmark)",127000,169000,42000,25
TIKI,nha-sach-tiki,194959695,"Thế Giới Mênh Mông Buồn Vui Cất Vào Lòng",49400,90000,40600,45
TIKI,nha-sach-tiki,56757447,"Tiền Đẻ Ra Tiền: Đầu Tư Tài Chính Thông Minh",90350,139000,48650,35
TIKI,nha-sach-tiki,195801705,"Một Nửa Chiếc Va Li",104000,130000,26000,20
TIKI,nha-sach-tiki,464132,"Truyện Kiều",25100,35000,9900,28
TIKI,nha-sach-tiki,48629547,"Tiền Không Mua Được Gì (What money can't buy?) - Michael Sandel Tác giả Phải Trái Đúng Sai",99900,125000,25100,20
TIKI,nha-sach-tiki,152743081,"Bàn Tay Ánh Sáng",194000,269000,75000,28
TIKI,nha-sach-tiki,71898415,"Cơ Thể Ta Đã Hai Triệu Năm - Giải Mã Các Căn Bệnh Thời Hiện Đại",59200,79000,19800,25
TIKI,nha-sach-tiki,49002497,"Tâm Bệnh Học",116000,145000,29000,20
TIKI,nha-sach-tiki,48362502,"Sang Chấn Tâm Lý - Hiểu Để Chữa Lành",227000,350000,123000,35
TIKI,nha-sach-tiki,113656189,"Giáo Trình Lịch Sử Đảng Cộng Sản Việt Nam (Dành Cho Bậc Đại Học Hệ Không Chuyên Lý Luận Chính Trị) - Bộ mới năm 2021",84000,84000,0,0
TIKI,nha-sach-tiki,167149888,"Khám Phá Đứa Trẻ Bên Trong Bạn",76500,139000,62500,45
TIKI,nha-sach-tiki,149534865,"Bảy Thanh Hung Giản 2 - Hổ Phách Đỏ Son - Gió Cuốn Cát Bụi",173000,230000,57000,25
TIKI,nha-sach-tiki,44976191,"Economix - Các Nền Kinh Tế Vận Hành (Và Không Vận Hành) Thế Nào Và Tại Sao?",114000,152000,38000,25
TIKI,nha-sach-tiki,144779882,"Here U Are - Tập 1 - Bản Thường [Tặng Kèm 1 Bookmark Bế Hình Nhân Vật (2 Mẫu Ngẫu Nhiên)]",77100,99000,21900,22
TIKI,nha-sach-tiki,151597556,"American Jetstream Pre-Intermediate A Student's book & Workbook ( không kèm CD)",207000,207000,0,0
TIKI,nha-sach-tiki,185500892,"i-Learn Smart Start 5 Workbook Special Edition",81000,81000,0,0
TIKI,nha-sach-tiki,55119185,"Sách Nghĩ Giàu và Làm Giàu (Bìa Cứng) (Tái Bản 2020)",116000,168000,52000,31
TIKI,nha-sach-tiki,181122317,"Chân Trần Chí Thép (Tái Bản 2022)",118000,168000,50000,30
TIKI,nha-sach-tiki,182736915,"Combo 3 Cuốn Sách: Cuộc Hành Hương Nội Tại - Chính Trực - Giác Ngộ",309400,467000,157600,34
TIKI,nha-sach-tiki,191919683,"Tro tàn của Angela",171000,220000,49000,22
TIKI,nha-sach-tiki,198016658,"Birdmen - Tập 8",29000,30000,1000,3
TIKI,nha-sach-tiki,89294990,"Marco Polo - Từ Venice tới Thượng Đô",179250,239000,59750,25
TIKI,nha-sach-tiki,7958959,"5 Điểm Chết Trong Teamwork",79800,128000,48200,38
TIKI,nha-sach-tiki,75601401,"Nghệ Thuật Bán Hàng Bằng Câu Chuyện",126000,188000,62000,33
TIKI,nha-sach-tiki,197634256,"Black Jack - Tập 14 (Bìa Cứng)",121000,135000,14000,10
TIKI,nha-sach-tiki,184419723,"Sapiens Lược Sử Loài Người (Tái Bản 2022)",224000,299000,75000,25
TIKI,nha-sach-tiki,14655498,"Bút bi TriTouch ngòi 0.7mm (hộp 12 cái)",54000,54000,0,0
TIKI,nha-sach-tiki,188128048,"Ikigami - Tập 04",31600,45000,13400,30
TIKI,nha-sach-tiki,100947280,"Những Phương Thức Phục Hồi Sức Khỏe Theo Tự Nhiên (Tái Bản)",73600,99000,25400,26
TIKI,nha-sach-tiki,102893964,"Combo 5-10-20 Bút Bi Thiên Long TL-027 - Mực Xanh/Đen/Đỏ/Tím",17000,23000,6000,26
TIKI,nha-sach-tiki,95090673," Bút gel nhiều màu Deli - 0.5mm - Mực trơn đều - 8 màu 8 chiếc/Hộp - 1 hộp - S855",59000,106200,47200,44
TIKI,nha-sach-tiki,14136016,"Phía Nam Biên Giới, Phía Tây Mặt Trời (Tái Bản 2018)",67900,85000,17100,20
TIKI,nha-sach-tiki,186265453,"Komi - Nữ Thần Sợ Giao Tiếp Tập 10 [Tặng Kèm PVC Card]",23500,25000,1500,6
TIKI,nha-sach-tiki,73685374,"Combo Trinh Thám Đen: Cô Dâu Đen + Ám Ảnh Đen + Điểm Hẹn Đen + Kết Hôn Với Người Chết",399000,399000,0,0
TIKI,nha-sach-tiki,195801690,"The Witcher - Thuật Sĩ, Điều Ước Cuối Cùng",140000,175000,35000,20
TIKI,nha-sach-tiki,173364636,"Cái Tên Khắc Sâu Trong Tim Người (Bản Thường: Tặng Kèm 01 Bookmark Hai Mặt)",100000,129000,29000,22
TIKI,nha-sach-tiki,189765038,"Python lập trình thuật toán",95000,95000,0,0
TIKI,nha-sach-tiki,32219488,"Doanh Nghiệp Của Thế Kỷ 21 (Tái Bản 2019)",67900,100000,32100,32
TIKI,nha-sach-tiki,186578226,"Hy vọng mong manh",126000,158000,32000,20
TIKI,nha-sach-tiki,160370181,"Khói Trời Lộng Lẫy (Tập Truyện Ngắn Nguyễn Ngọc Tư)(Tái Bản)",71900,90000,18100,20
TIKI,nha-sach-tiki,4978895,"Biết Chính Mình",63700,85000,21300,25
TIKI,nha-sach-tiki,58067801,"Luyện Kỹ Năng Phát Âm Tiếng Anh (Trình Độ Sơ Cấp) - English Pronunciation In Use (Elementary)",56000,80000,24000,30
TIKI,nha-sach-tiki,52788074,"Khu Vườn Mùa Hạ (Tái Bản 2020)",54100,68000,13900,20
TIKI,nha-sach-tiki,192733741,"Mùi hương - Tái Bản",91900,115000,23100,20
TIKI,nha-sach-tiki,1362559,"Cổ Phiếu Thường, Lợi Nhuận Phi Thường (Tái Bản)",147200,199000,51800,26
TIKI,nha-sach-tiki,181974015,"Thế Giới Otome Game Thật Khắc Nghiệt Với Nhân Vật Quần Chúng (Tập 5)",77300,129000,51700,40
TIKI,nha-sach-tiki,197652268,"Như Cơn Gió Thoảng - Nghĩ Về Những Qui Luật Cuộc Sống",106900,115000,8100,7
TIKI,nha-sach-tiki,27971953,"Lược Sử Tôn Giáo",103000,129000,26000,20
TIKI,nha-sach-tiki,48329799,"Tự Học Toàn Diện Hóa Học - Từ Cơ Bản Đến Nâng Cao Lớp 9",67000,99000,32000,32
TIKI,nha-sach-tiki,13312178,"Combo Tôi Tự Học và Óc Sáng Suốt ( Tặng Kèm Sổ Tay )",181350,181350,0,0
TIKI,nha-sach-tiki,185409035,"Bút Bi Nước Mực Gel Bấm Ngòi 0.5mm Deli - Có Ngòi Thay Thế Viết Trơn Đều Phù Hợp Ghi Chép Văn Phòng Học Sinh Sổ Tay - A575",2700,5400,2700,50
TIKI,nha-sach-tiki,90679276,"Mở Cửa Tương Lai",130000,200000,70000,35
TIKI,nha-sach-tiki,10379317,"Nghệ Thuật Giao Tiếp Để Thành Công (Tái Bản 2019)",126000,169000,43000,25
TIKI,nha-sach-tiki,141472522,"Sách: Cẩm Nang Tuổi Dậy Thì Dành Cho Bạn Gái (Tái Bản)",80000,100000,20000,20
TIKI,nha-sach-tiki,192909289,"Quán Rượu Dị Giới "Nobu" - Tập 09",21000,40000,19000,48
TIKI,nha-sach-tiki,111582624,"Trải Nghiệm Apple - Xây Dựng Lòng Trung Thành Không Chỉ Từ Sản Phẩm",186000,239000,53000,22
TIKI,nha-sach-tiki,117254518,"Thiên Nga Hoang Dã",280000,350000,70000,20
TIKI,nha-sach-tiki,68049234,"Đừng Để Mất Bò - 7 Bước Quản Lý Cửa Hàng Hiệu Quả Và Chống Thất Thoát",140000,169000,29000,17
TIKI,nha-sach-tiki,105614665,"Bút bi bấm ngòi 0.7mm mực xanh Deli - Màu sắc theo lựa chọn -  1 chiếc - EQ199-BL",4000,7200,3200,44
TIKI,nha-sach-tiki,177569697,"Perfect Ielts Vocabulary (Tái Bản)",193000,259000,66000,25
TIKI,nha-sach-tiki,1007137,"Tự Học 2000 Từ Vựng Tiếng Anh Theo Chủ Đề",47450,65000,17550,27
TIKI,nha-sach-tiki,83396665,"Hướng dẫn khởi động & 200 tư thế Yoga từ cơ bản đến nâng cao",128000,185000,57000,31
TIKI,nha-sach-tiki,146271773,"Nghiệp Tình Yêu - Karma Of Love (Tái Bản 2021)",153200,199000,45800,23
TIKI,nha-sach-tiki,113540588,"Thiên Táng",76700,96000,19300,20
TIKI,nha-sach-tiki,32720778,"Sách tiếng Anh - Principles: Life and Work",586800,652000,65200,10
TIKI,nha-sach-tiki,176550198,"Nam Hải Dị Nhân Liệt Truyện",400000,500000,100000,20
TIKI,nha-sach-tiki,88592202,"Tiny Habits : Thói quen tí hon - Tiềm năng khổng lồ",299000,299000,0,0
TIKI,nha-sach-tiki,195521211,"Diệt Slime Suốt 300 Năm, Tôi Levelmax Lúc Nào Chẳng Hay (Tập 11)",127000,159000,32000,20
TIKI,nha-sach-tiki,187827438,"Vọng Lâu Tử Thần",95900,120000,24100,20
TIKI,nha-sach-tiki,170490710,"Bàn Về Cách Sống – Đối Thoại Giữa Triết Gia, Bác Sĩ Và Nhà Sư",104000,139000,35000,25
TIKI,nha-sach-tiki,153518828,"Hong Tay Khói Lạnh (Tản Văn Nguyễn Ngọc Tư)",67400,90000,22600,25
TIKI,nha-sach-tiki,174605338,"Bách Khoa Thư Về Nghệ Thuật",373000,499000,126000,25
TIKI,nha-sach-tiki,109298270,"Sách Cẩm Nang Con Gái (Tái Bản)",47700,68000,20300,30
TIKI,nha-sach-tiki,145092110,"Cách Biến Đổi Câu Trong Tiếng Anh",53600,80000,26400,33
TIKI,nha-sach-tiki,189643106,"Tự Tôn",123000,169000,46000,27
TIKI,nha-sach-tiki,77900450,"Đạo Phật Vỡ Lòng (Tái Bản)",53700,69000,15300,22
TIKI,nha-sach-tiki,194197858,"Achievers grade 7 Workbook",112000,112000,0,0
TIKI,nha-sach-tiki,165700192,"Lịch Sử Vú",193000,248000,55000,22
TIKI,nha-sach-tiki,196518832,"Khi Băn Khoăn Hãy Cùng Nói Chuyện",74200,99000,24800,25
TIKI,nha-sach-tiki,190705658,"Bật Khóc Ở H Mart",109000,140000,31000,22
TIKI,nha-sach-tiki,46259908,"Fibonacci Trading",299000,299000,0,0
TIKI,nha-sach-tiki,136539753,"Tự Chữa Lành Thông Qua Hiểu Biết Về Khoa Học Tâm Thức",86800,119000,32200,27
TIKI,nha-sach-tiki,189557422,"THINK OUT OF THE BOOK - Nghĩ Ngoài Sách Vở",172000,220000,48000,22
TIKI,nha-sach-tiki,193981040,"Birdmen - Tập 5",28400,30000,1600,5
TIKI,nha-sach-tiki,137241901,"Thần Số Học: Sức Mạnh Của Những Con Số",100000,139000,39000,28
TIKI,nha-sach-tiki,170345811,"Phân Tích Khách Hàng For Dummies",171000,229000,58000,25
TIKI,nha-sach-tiki,75697497,"Lịch Sử Triết Học (Trọn Bộ 2 Tập) (Tập 1: Triết Học Cổ Đại Và Trung Đại + Tập 2: Triết Học Cận Đại Và Hiện Đại)",766000,900000,134000,15
TIKI,nha-sach-tiki,12533371,"Đạo Đức Kinh",73800,99000,25200,25
TIKI,nha-sach-tiki,69621516,"Combo sách: Bài thơ - bài hát - câu đố dành cho bé (tái bản 2020)",135000,135000,0,0
TIKI,nha-sach-tiki,196001728,"Vạn Sắc Hư Vô",119000,150000,31000,21
TIKI,nha-sach-tiki,193177952,"Bản đặc biệt Tổng ôn 30 chuyên đề ngữ pháp tiếng anh cô Trang anh 2023",191000,300000,109000,36
TIKI,nha-sach-tiki,273714632,"Trí Tuệ Do Thái (Tái Bản)",141000,189000,48000,25
TIKI,nha-sach-tiki,127377217,"Sách Người Trong Muôn Nghề: Ngành Sáng tạo và Nghệ thuật có gì?",197100,219000,21900,10
TIKI,nha-sach-tiki,157468180,"Trọn Bộ 4 Quyển Sách Trên Lưng Khổng Tượng - Kinh Doanh Online Trên Sàn Thương Mại Điện Tử - Khởi Nghiệp Với Bán Hàng Qua Mạng và Nhãn Hàng Riêng",481000,796000,315000,40
TIKI,nha-sach-tiki,185055209,"Osho - Combo Sống Hài Hòa (Yêu, Cảm Xúc, Hiểu)",393000,524000,131000,25
TIKI,nha-sach-tiki,190242072,"Qủy Ấn - Bộ 2 tập ( Tập 1 và 2) - tặng kèm 1 bookmark",209000,291000,82000,28
TIKI,nha-sach-tiki,160585764,"Veil - Thân Nhiệt Của Sắc Cam - Tập 1 (Tặng Kèm Postcard)",78700,109000,30300,28
TIKI,nha-sach-tiki,87149160,"Bộ Cọ Vẽ Chuyên Nghiệp Deli - Dùng Cho Màu Nước/Bột/Sơn Acrylic -Set 4/6 Cây- 73885/73866/73867",35000,63000,28000,44
TIKI,nha-sach-tiki,58067806,"Từ Vựng Tiếng Anh Thực Hành (Trình Độ Trung Cấp) - English Collocation In Use (Intermediate)",56000,80000,24000,30
TIKI,nha-sach-tiki,192048663,"Sáng trăng",59900,75000,15100,20
TIKI,nha-sach-tiki,38436464,"Khác Biệt Để Bứt Phá (Tái Bản 2019)",89700,128000,38300,30
TIKI,nha-sach-tiki,6482397,"Hàn Quốc Dưới Chế Độ Độc Tài Phát Triển Park Chung Hee (1961 – 1979)(Tái Bản 2020)",78500,98000,19500,20
TIKI,nha-sach-tiki,13797246,"Combo 6 Cuốn Ehon nhật bản - Giờ Chơi Của Bé ( Tái Bản )",129000,174000,45000,26
TIKI,nha-sach-tiki,193896561,"Ninja Rantaro - Tập 59",38300,40000,1700,4
TIKI,nha-sach-tiki,272003250,"Dragon Ball Full Color - Phần Năm: Truy Lùng Cell Bọ Hung - Tập 1",73800,77000,3200,4
TIKI,nha-sach-tiki,86267527,"Một Nghệ Thuật Sống (Tái Bản)",55100,85000,29900,35
TIKI,nha-sach-tiki,196394972,"Thương Tiến Tửu - Tập 2",135000,169000,34000,20
TIKI,nha-sach-tiki,160585832,"Veil – Sắc Trắng Yêu Kiều - Tập 3 (Tặng Kèm Postcard)",92700,109000,16300,15
TIKI,nha-sach-tiki,142833447,"Sanctify - Tập 3",90100,109000,18900,17
TIKI,nha-sach-tiki,176909238,"Hà Nội Còn Một Chút Này",86000,109000,23000,21
TIKI,nha-sach-tiki,187843292,"Hoa trên mộ Algernon",120000,150000,30000,20
TIKI,nha-sach-tiki,148008757,"Combo 2 Cuốn "Tim Marshall": "Những Tù Nhân Của Địa Lý" + "Chia Rẽ - Tại Sao Chúng Ta Đang Sống Trong Thời Đại Của Những Bức Tường"",320000,410000,90000,22
TIKI,nha-sach-tiki,72667834,"Sách Ehon - Combo 3 Cuốn Âm Thanh Quanh Bé - Dành Cho Trẻ Từ 0 - 6 Tuổi",93500,117000,23500,20
TIKI,nha-sach-tiki,71149569,"Cách kiếm lợi nhuận 18.000% từ thị trường chứng khoán - Trade Like An O'Neil Disciple",499000,499000,0,0
TIKI,nha-sach-tiki,189326211,"Văn phòng thám tử quái vật - Tập 08",27100,30000,2900,10
TIKI,nha-sach-tiki,980770,"Chí Phèo",34400,48000,13600,28
TIKI,nha-sach-tiki,598974,"Dạy Con Làm Giàu 05 - Để Có Sức Mạnh Về Tài Chính",110000,160000,50000,31
TIKI,nha-sach-tiki,4077687,"Bài Tập Trắc Nghiệm Tiếng Anh 9 (Có Đáp Án)",37500,56000,18500,33
TIKI,nha-sach-tiki,94132196,"Bộ Luật Lao Động Hiện Hành (Mới Nhất) Thông Qua Tại Kỳ Họp Thứ 8 Quốc Hội Khóa XIV",58000,119000,61000,51
TIKI,nha-sach-tiki,185408437,"Bút Bi Nước Mực Gel Bấm Ngòi 0.5mm Deli - Mực Đen Nhanh Khô, Viết Đều, Trơn Tru, Phù Hợp Văn Phòng Học Sinh - S08-B",6200,11700,5500,47
TIKI,nha-sach-tiki,173481387,"Eo Thon Nhỏ",165000,239000,74000,31
TIKI,nha-sach-tiki,187827445,"Lược Sử Thời Gian",91900,115000,23100,20
TIKI,nha-sach-tiki,76531748,"Sách DevUP",134100,149000,14900,10
TIKI,nha-sach-tiki,446881,"Các Thế Giới Song Song (Tái Bản 2018)",109000,128000,19000,15
TIKI,nha-sach-tiki,112332742,"English Grammar In Use - 130 Bài Ngữ Pháp Tiếng Anh (Tái Bản)",124000,165000,41000,25
TIKI,nha-sach-tiki,126742911,"Món Quà Của Linh Hồn - Sức Mạnh Chữa Lành Của Những Thữ Thách Trong Cuộc Sống",203000,289000,86000,30
TIKI,nha-sach-tiki,3152291,"Hướng Dẫn Giao Dịch Theo Sóng Elliott",369000,369000,0,0
TIKI,nha-sach-tiki,146225297,"Flow - Dòng Chảy",157300,228000,70700,31
TIKI,nha-sach-tiki,167940010,"Thao Túng Tâm Lý",109000,169000,60000,36
TIKI,nha-sach-tiki,147220978,"Sự Tiến Hóa Của Tiền Tệ",92100,139000,46900,34
TIKI,nha-sach-tiki,106365090,"Kinh Dịch Đạo Của Người Quân Tử - Nguyễn Hiến Lê (Tái Bản)",153000,268000,115000,43
TIKI,nha-sach-tiki,185854305,"Full bộ 4 cuốn Truyện - Thơ - Đồng dao - Câu đố cho Trẻ mầm non (Giúp bé sáng dạ, thông minh, tập nói và đọc nhanh)",136000,278429,142429,51
TIKI,nha-sach-tiki,158235745,"Phương Pháp Kaizen
 (The Kaizen Way)(Tái Bản)",71300,95000,23700,25
TIKI,nha-sach-tiki,53563837,"Combo Sách Nuôi Dạy Trẻ: Phương Pháp Giáo Dục Con Của Người Do Thái + Chờ Đến Mẫu Giáo Thì Đã Muộn +90% Trẻ Thông Minh Nhờ Cách Trò Chuyện Đúng Đắn Của Cha Mẹ + Cách Khen, Cách Mắng, Cách Phạt Con + Poster An Toàn(Tủ Sách Người Mẹ Tốt)",235000,245250,10250,4
TIKI,nha-sach-tiki,193450565,"Nam Đình Cốc Vi– Tập 7 -  Tặng 1 Postcard Nam Đình Cốc Vi",102000,119000,17000,14
TIKI,nha-sach-tiki,111537689,"Án Mạng Trên Sông Nile (Agatha Christie)(Tái Bản)",108000,135000,27000,20
TIKI,nha-sach-tiki,170706996,"Điểm Bùng Phát ( Tái Bản)",134000,179000,45000,25
TIKI,nha-sach-tiki,17719704,"Hạn Chót Lúc Bình Minh",85000,122000,37000,30
TIKI,nha-sach-tiki,188381614,"Thẻ học Thông minh (Size Lớn - 18 Chủ đề - 288 thẻ) - Song ngữ Anh - Việt - Thế giới Xung quanh",100000,200000,100000,50
TIKI,nha-sach-tiki,161383826,"Đảo Mộng Mơ (Tái Bản)",59900,75000,15100,20
TIKI,nha-sach-tiki,49204092,"Tái Tạo Tổ Chức: Phá Vỡ Rào Cản, Thổi Bùng Sinh Khí (Tái Bản)",118000,190000,72000,38
TIKI,nha-sach-tiki,59618902,"Ehon - Hướng Dẫn Sử Dụng Mẹ (Tái Bản 2020)",44200,59000,14800,25
TIKI,nha-sach-tiki,186578993,"Đu Đưa Trên Ngọn Cây Bàng",94300,118000,23700,20
TIKI,nha-sach-tiki,130863107,"Sách Người Tìm Xác tập 1+2 - Truyện trinh thám, linh dị",283000,378000,95000,25
TIKI,nha-sach-tiki,195662905,"Circe",160000,200000,40000,20
TIKI,nha-sach-tiki,175724125,"Chú Thuật Hồi Chiến Tập 2: Chú Thai Đới Thiên [Tặng Kèm Obi Và Thẻ Bo Góc Nhựa]",25400,30000,4600,15
TIKI,nha-sach-tiki,176906739,"UX Writing - Quyền Năng Tối Thượng Của Nội Dung Tương Tác",74200,99000,24800,25
TIKI,nha-sach-tiki,66398387,"Trời Sinh Vụng Về, Hãy Bù Đắp Bằng Sự Kiên Trì",94100,129000,34900,27
TIKI,nha-sach-tiki,32490132,"Một Đời Như Kẻ Tìm Đường",140000,175000,35000,20
TIKI,nha-sach-tiki,182736912,"Vu Giả - Bản Thường (Tặng Kèm 01 Bookmark 2 mặt)",114000,159000,45000,28
TIKI,nha-sach-tiki,77539095,"Nghệ Thuật Dạy Con Từ Kinh Talmud (20 Câu Chuyện Sâu Sắc Từ Bộ Kinh Cổ Của Người Do Thái)",108000,135000,27000,20
TIKI,nha-sach-tiki,129766803,"Sách Khác Biệt Hay Là Chết (Tái Bản)",89500,128000,38500,30
TIKI,nha-sach-tiki,147988202,"Combo 2 Cuốn Tớ Học Lập Trình: Tớ Học Lập Trình - Làm Quen Với Python + Tớ Học Lập Trình - Làm Quen Với Lập Trình Scratch",176000,210000,34000,16
TIKI,nha-sach-tiki,157540009,"Diệt Slime Suốt 300 Năm, Tôi Levelmax Lúc Nào Chẳng Hay (Tập 7)",38300,48000,9700,20
TIKI,nha-sach-tiki,112333133,"Quý Cô Thịnh Vượng - Khi Phụ Nữ Tư Duy Đúng Về Tiền",53300,89000,35700,40
TIKI,nha-sach-tiki,125362334,"Dinh Dưỡng Thai Kỳ (Mẹ Bầu Ăn Gì Giúp Con Phát Triển Toàn Diện Và Thông Minh",125200,189000,63800,34
TIKI,nha-sach-tiki,14684952,"Khu Vườn Bí Mật ( Tái Bản 2019 )",74800,96000,21200,22
TIKI,nha-sach-tiki,194205609,"Ai Đó Chạy Cùng Ta",180000,225000,45000,20
TIKI,nha-sach-tiki,164336681,"Việt Nam Danh Tác - Bỉ Vỏ",71900,90000,18100,20
TIKI,nha-sach-tiki,273656715,"Trạm Đọc Official |  Tư Duy Nhanh Và Chậm",199000,269000,70000,26
TIKI,nha-sach-tiki,55071991,"Combo Trọn Bộ 6 Cuốn Giáo Trình Hán Ngữ",512400,732000,219600,30
TIKI,nha-sach-tiki,58828012,"Ai Lấy Miếng Pho Mát Của Tôi ? - Phiên Bản Dành Cho Độc Giả Nhí",47000,68000,21000,31
TIKI,nha-sach-tiki,76737958,"Mind Map English Vocabulary - Từ Vựng Tiếng Anh Qua Sơ Đồ Tư Duy",132600,198000,65400,33
TIKI,nha-sach-tiki,188767663,"Quỷ Giá - Bản Thường ( Tặng kèm 1 Bookmark 2 mặt)",106000,159000,53000,33
TIKI,nha-sach-tiki,190859600,"Lôi Thần Và Nhân Viên Văn Phòng (Tập 4)",47400,66000,18600,28
TIKI,nha-sach-tiki,72027523,"Ehon - Đi Đã Ngoại Ngày Mưa (Tái Bản 2020)",42300,55000,12700,23
TIKI,nha-sach-tiki,74277389,"Combo 4 Cuốn: Bộ Tuyển Tập Truyện Hay Dành Cho Thiếu Nhi (Tái Bản)",132000,192000,60000,31
TIKI,nha-sach-tiki,867314,"Tuần Của Bé - Bé Sạch Sẽ",22000,23000,1000,4
TIKI,nha-sach-tiki,192913462,"Lớp 7(bộ Kết nối, Cánh diều, Chân trời) - Sách Siêu trọng tâm môn Toán, Anh, KHTN - Nhà sách Ôn luyện",160000,160000,0,0
TIKI,nha-sach-tiki,80920029,"Nguyên lý kế toán TBL9",56000,90000,34000,38
TIKI,nha-sach-tiki,347334,"Có Hai Con Mèo Ngồi Bên Cửa Sổ",76900,100000,23100,23
TIKI,nha-sach-tiki,58220389,"Mô Hình Biểu Đồ - Phương pháp Hiệu quả để Tìm kiếm Lợi nhuận",368000,368000,0,0
TIKI,nha-sach-tiki,8288935,"Của Chuột Và Người",76000,76000,0,0
TIKI,nha-sach-tiki,13673964,"Giây Thứ 12 - Tập 1 (Trinh Thám)",84000,87000,3000,3
TIKI,nha-sach-tiki,57587819,"Tui Ship Đối Thủ X Tui",119000,159000,40000,25
TIKI,nha-sach-tiki,176132374,"Truyện Thiếu Nhi Hạt Giống Tâm Hồn - Điều Ước Gửi Các Vì Sao",39100,56000,16900,30
TIKI,nha-sach-tiki,4040663,"25 Chuyên Đề Ngữ Pháp Tiếng Anh Trọng Tâm – (Tập 1)",76900,110000,33100,30
TIKI,nha-sach-tiki,71990280,"Nói Chuyện Là Bản Năng, Giữ Miệng Là Tu Dưỡng, Im Lặng Là Trí Tuệ",122000,189000,67000,35
TIKI,nha-sach-tiki,190702862,"Siddhartha",96000,120000,24000,20
TIKI,nha-sach-tiki,151597210,"Practice Test Grade 6",118000,118000,0,0
TIKI,nha-sach-tiki,8149335,"Cổ Học Tinh Hoa (Bìa Mềm)",99500,99500,0,0
TIKI,nha-sach-tiki,188535073,"Tối Giản Thông Thái",68600,96000,27400,29
TIKI,nha-sach-tiki,186290792,"Bồ Câu Không Đưa Thư (Tái Bản 2022)",30300,38000,7700,20
TIKI,nha-sach-tiki,68437861,"Đừng Chết Bởi Canxi",119000,159000,40000,25
TIKI,nha-sach-tiki,72290296,"Bí Quyết Đầu Tư & Kinh Doanh Chứng Khoán Của Tỷ Phú Warren Buffett Và George Soros (Tái Bản 2020)",110000,158000,48000,30
TIKI,nha-sach-tiki,1029908,"Tuần Của Bé - Bé Công Bằng (Dành Cho Trẻ 3 - 6 Tuổi)",11000,11500,500,4
TIKI,nha-sach-tiki,40750124,"Không Gia Đình (Phiên Bản Mới) - Tặng kèm bộ Postcard",119250,159000,39750,25
TIKI,nha-sach-tiki,197464901,"Bẩm Thầy Tường Có Thầy Vũ Tới Tìm - Tập 2",88500,115000,26500,23
TIKI,nha-sach-tiki,174444166,"Cẩm Nang Diện Chẩn – Phương Pháp Đơn Giản Áp Dụng Tại Gia",138000,179000,41000,23
TIKI,nha-sach-tiki,100958464,"Hỏi Đáp Từ Trái Tim (Tái Bản)",112000,149000,37000,25
TIKI,nha-sach-tiki,109654814,"Bút bi gel 0.5mm nhiều màu Deli - Có nắp gài - 1 chiếc - Đỏ/ Xanh Dương/ Xanh Lá/ Tím/ Cam - A119",6000,10800,4800,44
TIKI,nha-sach-tiki,111537682,"Bách Khoa Cho Trẻ Em - Bách Khoa Động Vật (Tái Bản)",153000,180000,27000,15
TIKI,nha-sach-tiki,175956866,"Giới Hạn Của Bạn Chỉ Là Xuất Phát Điểm Của Tôi (Tái Bản)",49000,89000,40000,45
TIKI,nha-sach-tiki,34708988,"Bộ 10 Bút Gel Điểm 10 xóa được TP-GELE01",95000,120000,25000,21
TIKI,nha-sach-tiki,16284286,"Tuổi Thơ Dữ Dội - Tập 1 (Tái Bản)",58900,80000,21100,26
TIKI,nha-sach-tiki,73684906,"Marketing Phải Bán Được Hàng",103000,159000,56000,35
TIKI,nha-sach-tiki,21031780,"Pháo Đài Số ( Tái Bản )",136000,199000,63000,32
TIKI,nha-sach-tiki,155351487,"IELTS 16 ACADEMIC",185000,195000,10000,5
TIKI,nha-sach-tiki,195479322,"Tàn Tro",54000,108000,54000,50
TIKI,nha-sach-tiki,187889757,"Gọt bút chì mini Deli - Màu ngẫu nhiên - E0594",2800,5400,2600,48
TIKI,nha-sach-tiki,150711999,"Michelle Obama - Chất Michelle (Bìa Cứng) (Tái Bản)",364000,520000,156000,30
TIKI,nha-sach-tiki,195969658,"Tiệm Sách Cũ Biblia - Ngoại Truyện 2 - Tobirako Và Thời Gian Bỏ Ngỏ",38000,95000,57000,60
TIKI,nha-sach-tiki,109982979,"Isaac Newton - Nhà Khoa Học Vĩ Đại",27900,40000,12100,30
TIKI,nha-sach-tiki,135552451,"Các Triều Đại Việt Nam",80500,120000,39500,33
TIKI,nha-sach-tiki,8011021,"Tâm Lý Học Thành Công (Tái Bản)",147260,199000,51740,26
TIKI,nha-sach-tiki,165038798,"OKRs - Tối Ưu Hóa Hiệu Suất Của Bất Kỳ Đội Nhóm Nào",102000,169000,67000,40
TIKI,nha-sach-tiki,259537049,"Hộp 10 Bút Lông Bảng Thiên Long WB-03",80000,93000,13000,14
TIKI,nha-sach-tiki,74616448,"Lập Kế Hoạch Kinh Doanh Cho Người Mới Bắt Đầu",88800,119000,30200,25
TIKI,nha-sach-tiki,191148968,"Bút Hết Nặng Viết Hết Đau",187000,239000,52000,22
TIKI,nha-sach-tiki,13673968,"Giây Thứ 12 - Tập 2 (Trinh Thám)",102000,145000,43000,30
TIKI,nha-sach-tiki,193988316,"Siêu Tâm Trí – Học Cách Suy Nghĩ Như Sherlock Holmes",104000,145000,41000,28
TIKI,nha-sach-tiki,193684715,"Ngoan Cường Vượt Định Kiến",47300,79000,31700,40
TIKI,nha-sach-tiki,332626,"Oxford Learner's Pocket Dictionary : A Pocket-sized Reference to English Vocabulary (Fourth Edition)",80100,90000,9900,11
TIKI,nha-sach-tiki,46107068,"Thế Giới Ảo, Thương Hiệu Thật",74600,149000,74400,50
TIKI,nha-sach-tiki,76305752,"Combo Bộ 2 Cuốn: Giết Chỉ Huy Đội Kỵ Sĩ (Tập 1: Ý Tưởng Xuất Hiện + Tập 2: Ẩn Dụ Dịch Chuyển)",332000,410000,78000,19
TIKI,nha-sach-tiki,101297001,"Tâm Lý Hành Vi Trong Đầu Tư Chứng Khoán",116000,159000,43000,27
TIKI,nha-sach-tiki,175833959,"Combo 5-10-20 Bút Bi Bấm Deli EQ24 Ngòi 0.7mm - Mực Xanh/Đen/Đỏ - Bút bi dầu phù hợp học sinh văn phòng",1800,3420,1620,47
TIKI,nha-sach-tiki,77403145,"The Story Of Food - Câu Chuyện Thực Phẩm",378000,486000,108000,22
TIKI,nha-sach-tiki,197629358,"Chúng Ta Có Hẹn Với Bình Yên",63600,89000,25400,29
TIKI,nha-sach-tiki,167043770,"Xiaomi - Hành Trình Một Công Ty Khởi Nghiệp Trở Thành Thương Hiệu Toàn Cầu",80600,115000,34400,30
TIKI,nha-sach-tiki,168181452,"Thiên Sứ Nhà Bên - Tập 2",85500,95000,9500,10
TIKI,nha-sach-tiki,83162438,"Combo Kinh Tế Vi Mô và Câu Hỏi - Bài Tập - Trắc Nghiệm Kinh Tế Vi Mô",149000,180000,31000,17
TIKI,nha-sach-tiki,189598539,"Bài tập bổ trợ Tiếng Anh 10",118000,118000,0,0
TIKI,nha-sach-tiki,191926650,"Trái cây đại chiến Zombie - Thế giới khủng long: Tập 11 - Thợ săn đáy biển",63900,89000,25100,28
TIKI,nha-sach-tiki,10581200,"Dế Mèn Phiêu Lưu Ký (Tái Bản)",38900,50000,11100,22
TIKI,nha-sach-tiki,5974545,"Series Địch Công Kỳ Án Tập 11: Bóng Ma Trong Chùa",49000,110000,61000,55
TIKI,nha-sach-tiki,169603497,"Macmillan Dictionary Vietnam ED with App – Soft cover",339150,399000,59850,15
TIKI,nha-sach-tiki,17530147,"Series Địch Công Kỳ Án Tập 14 - Hầu Tử Và Lão Hổ ( Tái Bản )",84000,88000,4000,5
TIKI,nha-sach-tiki,150682463,"Linh Ứng - Hành Trình Của Kẻ Siêu Vô Thần Đến Thế Giới Tâm Linh",169000,268000,99000,37
TIKI,nha-sach-tiki,177117486,"Nửa Kia Biệt Tích",133000,185000,52000,28
TIKI,nha-sach-tiki,164323204,"Semantic Error - Lỗi Logic - Tập 1 - Tặng Kèm Bookmark + 01 Postcard",233100,259000,25900,10
TIKI,nha-sach-tiki,74983567,"Tứ Trấn Huyền Linh",129000,259000,130000,50
TIKI,nha-sach-tiki,87941401,"Lối Tắt Khởi Nghiệp - Con Đường Ngắn Từ Tay Trắng Đến Thành Công Bền Vững",118000,169000,51000,30
TIKI,nha-sach-tiki,147988196,"Combo 3 Cuốn "Hiểu Hết": How Food Works - Hiểu Hết Về Thức Ăn + How The Body Works - Hiểu Hết Về Cơ Thể + How Psychology Works - Hiểu Hết Về Tâm Lý Học",756000,900000,144000,16
TIKI,nha-sach-tiki,99681443,"Khoa Học - Khái Lược Những Tư Tưởng Lớn ",338000,450000,112000,25
TIKI,nha-sach-tiki,152517438,"Dữ Liệu Bạch Kim (Văn Học Trinh Thám)",95300,159000,63700,40
TIKI,nha-sach-tiki,68456844,"Bài Tập Tiếng Anh 8 - Tập 1 - Có Đáp Án (Theo Chương Trình Mới Của Bộ GD&ĐT)",36000,48000,12000,25
TIKI,nha-sach-tiki,146936894,"Combo 4 cuốn Sách tự xóa: Chữ cái - Toán - Chữ số - Hình khối & Màu sắc (tặng kèm bút)",76000,152939,76939,50
TIKI,nha-sach-tiki,173092689,"Phát triển trí tuệ (140 câu đố) - Bộ sách Rèn luyện Trí thông minh - Dành cho trẻ 5-6 tuổi",24000,46152,22152,48
TIKI,nha-sach-tiki,51660434,"Những Bí Quyết Vàng Đầu Tư Bất Động Sản",79000,79000,0,0
TIKI,nha-sach-tiki,187190670,"Black Jack - Tập 11 (Bìa Cứng)",94500,135000,40500,30
TIKI,nha-sach-tiki,166033485,"Sách 14 Nguyên Tắc Tăng Trưởng Thần Tốc Như Amazon",118000,188000,70000,37
TIKI,nha-sach-tiki,46755107,"2500 Từ Vựng Cần Thiết Cho Kỳ Thi Năng Lực Nhật Ngữ N2",67000,135000,68000,50
TIKI,nha-sach-tiki,95090180," Bút dấu dòng dạ quang Deli – 6 chiếc/ hộp - S624",29000,52200,23200,44
TIKI,nha-sach-tiki,172800656,"Komi - Nữ Thần Sợ Giao Tiếp Tập 8 [Tặng kèm Card bo góc Nữ thần]",22200,25000,2800,11
TIKI,nha-sach-tiki,194959697,"Thánh Hiệp Sĩ Nơi Tận Cùng Thế Giới – Tập 1",116000,145000,29000,20
TIKI,nha-sach-tiki,5087505,"Ám Dạ Hành (Trinh Thám Hiện Đại Trung Quốc)",56000,75000,19000,25
TIKI,nha-sach-tiki,191353862,"Green Witchcraft - Năng lượng từ thảo mộc",96000,149000,53000,36
TIKI,nha-sach-tiki,714012,"Truyện Ngụ Ngôn La Fontaine",58800,98000,39200,40
TIKI,nha-sach-tiki,520337,"Luật Im Lặng (Mario Puzo)",61800,95000,33200,35
TIKI,nha-sach-tiki,42180465,"Đừng Chỉ Đẹp Mà Không Hiểu Chuyện",62200,89000,26800,30
TIKI,nha-sach-tiki,85242387,"Chuyện Lạ Ở Bệnh Viện Tư Nhân Hiệp Tế Đường Đồng Hoa Trung",82000,149000,67000,45
TIKI,nha-sach-tiki,136753126,"Tôi Đã Kiếm 1 Triệu Đô Đầu Tiên Trên Internet Như Thế Nào Và Bạn Cũng Có Thể Làm Như Thế (Tái Bản)",150000,199000,49000,25
TIKI,nha-sach-tiki,184781428,"Nuôi Con Bằng Yêu Thương Dạy Con Bằng Lý Trí (Tái bản) - Tặng Kèm Bookmark",82000,114000,32000,28
TIKI,nha-sach-tiki,101897983,"Không Tức Giận Bạn Đã Thắng",107000,149000,42000,28
TIKI,nha-sach-tiki,194130753,"Bong bóng số 0-9 nhiều màu 35cm trang trí tiệc xinh",15000,15000,0,0
TIKI,nha-sach-tiki,109982956,"Leonardo Da Vinci - Thiên Tài Toàn Năng",41900,60000,18100,30
TIKI,nha-sach-tiki,11413619,"Combo Mẹ Hỏi Bé Trả Lời (4 Cuốn)",104000,120000,16000,13
TIKI,nha-sach-tiki,190592917,"Combo 2 Quyển: Thiên Tài Bên Trái, Kẻ Điên Bên Phải + Tâm Lý Học Tội Phạm: Phác Họa Chân Dung Kẻ Phạm Tội",229000,324000,95000,29
TIKI,nha-sach-tiki,112588572,"Yêu Trong Tỉnh Thức - Từ Bạn Đời Đến Bạn Đạo Tập 1",185000,185000,0,0
TIKI,nha-sach-tiki,73222804,"Sách Putin Logic Của Quyền Lực (Tái Bản 2020)",116000,168000,52000,31
TIKI,nha-sach-tiki,195801643,"Cà Phê Cùng Tony (Tái Bản 2022)",83900,105000,21100,20
TIKI,nha-sach-tiki,91120169,"Homecoming - Hồi Sinh Đứa Trẻ Bên Trong Bạn",134000,169000,35000,21
TIKI,nha-sach-tiki,176909246,"Bí Quyết Bấm Huyệt Chữa Bệnh",125000,178000,53000,30
TIKI,nha-sach-tiki,191148787,"Green Witchcraft - Năng lượng từ thảo mộc",109000,149000,40000,27
TIKI,nha-sach-tiki,109982972,"Marie Curie - Nhà Nữ Khoa Học Kiệt Xuất",52500,75000,22500,30
TIKI,nha-sach-tiki,870619,"Túp Lều Bác Tom",68000,110000,42000,38
TIKI,nha-sach-tiki,6807847,"Cảm Ơn Người Lớn (Bìa Mềm) - Bản Tặng Kèm Thiệp + Phong Bì Thiệp + Bookmark (Số Lượng Có Hạn)",90100,110000,19900,18
TIKI,nha-sach-tiki,1544255,"Băng Keo Trong 5F (2 Cuộn / Lốc)",16000,21000,5000,24
TIKI,nha-sach-tiki,130997089,"[Manga] Diệt Slime Suốt 300 Năm, Tôi Levelmax Lúc Nào Chẳng Hay (Tập 6)",46900,48000,1100,2
TIKI,nha-sach-tiki,72688720,"Năm Phút Nữa Thôi",47100,59000,11900,20
TIKI,nha-sach-tiki,73553840,"Truyện Thiếu Nhi Hạt Giống Tâm Hồn - Thế Giới Trong Ngăn Tủ (Tái Bản 2020)",28100,40000,11900,30
TIKI,nha-sach-tiki,72688722,"Giáo Dục - Tương Lai & Đổi Mới",121000,180000,59000,33
TIKI,nha-sach-tiki,171821043,"Bộ "Anne Tóc Đỏ" 8 Cuốn",862000,972000,110000,11
TIKI,nha-sach-tiki,36311444,"Đàn Ông Sao Hỏa Đàn Bà Sao Kim (Tặng Bookmark PL)",131600,188000,56400,30
TIKI,nha-sach-tiki,158972052,"Cẩm Nang Con Trai",47500,68000,20500,30
TIKI,nha-sach-tiki,100382935,"Sách - Hành Trình Về Phương Đông (Bìa Mềm - Tái bản 2021) - First News",106650,106650,0,0
TIKI,nha-sach-tiki,161426372,"Trí Huệ - Những Hiểu Biết Thay Đổi Cuộc Đời",168000,210000,42000,20
TIKI,nha-sach-tiki,76117849,"Luyện Kỹ Năng Nghe Tiếng Anh (Trình Độ Cơ Bản) -Tactics For Listening Basic",63000,90000,27000,30
TIKI,nha-sach-tiki,26135056,"Bộ 2 cuốn sách về kinh tế hay nhất : Dạy Con Làm Giàu (Tập 1) - Để Không Có Tiền Vẫn Tạo Ra Tiền + Dạy Con Làm Giàu (Tập 2) - Sử Dụng Đồng Vốn (Tặng kèm Bookmark thiết kế AHA)",180010,191500,11490,6
TIKI,nha-sach-tiki,100376369,"Đứa Con Gái Hoang Đàng - Hai Số Phận - Phần II",143000,209000,66000,32
TIKI,nha-sach-tiki,10568888,"Làm Đĩ (Tái Bản)",42800,55000,12200,22
TIKI,nha-sach-tiki,160814425,"Thai Giáo Theo Chuyên Gia - 280 Ngày - Mỗi Ngày Đọc Một Trang (Tái Bản 2021)",82800,115000,32200,28
TIKI,nha-sach-tiki,46107066,"Học Cách Học",117660,159000,41340,26
TIKI,nha-sach-tiki,11119019,"Oxford Advanced Learner's Dictionary 8th Edition (With Vietnamese Translation) and CD - ROM (Paperback)",550000,625000,75000,12
TIKI,nha-sach-tiki,1667307,"Quân Vương – Thuật Cai Trị (Tái Bản)",81100,109000,27900,26
TIKI,nha-sach-tiki,105614549,"Khay pha màu 10/14 ngăn Deli - 1 chiếc - 9402 / 9403",9000,16200,7200,44
TIKI,nha-sach-tiki,173420792,"Người Hạt Dẻ",153000,199000,46000,23
TIKI,nha-sach-tiki,273636756,"Trạm Đọc Official | Hackers Toeic Vocabulary",209000,279000,70000,25
TIKI,nha-sach-tiki,178514167,"Tìm Lại Màu Xanh (Phần Tiếp Theo Của Người Truyền Ký Ức)",85900,108000,22100,20
TIKI,nha-sach-tiki,172422019,"Vì Con Gái Tôi Có Thể Đánh Bại Cả Ma Vương - Tập 5 - Tặng Kèm Poster + Bookmark",117600,140000,22400,16
TIKI,nha-sach-tiki,598975,"Dạy Con Làm Giàu 10 - Trước Khi Bạn Thôi Việc",68300,110000,41700,38
TIKI,nha-sach-tiki,52691750,"Tự Do Đầu Tiên & Cuối Cùng",125000,178000,53000,30
TIKI,nha-sach-tiki,3840809,"New Economy Toeic Lc 1000 (Kèm file MP3)",157000,198000,41000,21
TIKI,nha-sach-tiki,178240555,"Tần Số Của Chúng Ta",138000,179000,41000,23
TIKI,nha-sach-tiki,42877486,"Văn Học Kinh Điển Thế Giới - Peter Pan (Tái Bản)",63300,88000,24700,28
TIKI,nha-sach-tiki,42975887,"Nuốt Cá Lớn - Eating The Big Fish",299000,299000,0,0
TIKI,nha-sach-tiki,72744539,"IELTS 15 ACADEMIC",135000,142000,7000,5
TIKI,nha-sach-tiki,392568,"Marvellous Techniques For IELTS Writing",210000,268000,58000,22
TIKI,nha-sach-tiki,31515106,"Đàn Kiến Chăm Chỉ - Ngụ Ngôn Song Ngữ (Tái Bản 2019)",18000,32000,14000,44
TIKI,nha-sach-tiki,187933180,"OKR - Phương Pháp Thiết Lập Mục Tiêu Và Quản Lý Công Việc Vượt Trội (Tái Bản 2022)",94100,129000,34900,27
TIKI,nha-sach-tiki,11413616,"Mẹ Hỏi Bé Trả Lời 4-5 Tuổi (Tái Bản)",25400,30000,4600,15
TIKI,nha-sach-tiki,196373994,"Sổ Tay Ghi Chép Bìa Da A5 300 Trang Kẻ Ngang Deli - Phù Hợp Làm Sổ Kế Hoạch Planner, Nhật Kí, Tập Vở Ghi Chép Bullet Journal - EN012 / EN013",58500,106200,47700,45
TIKI,nha-sach-tiki,197587848,"Mỗi Ngày Gửi Cậu Một Cái Ôm",92800,129000,36200,28
TIKI,nha-sach-tiki,195305999,"Giải mã truyện Tây Du",95100,119000,23900,20
TIKI,nha-sach-tiki,51215567,"Đồng Tiền Hạnh Phúc",68300,95000,26700,28
TIKI,nha-sach-tiki,59362973,"Osho Phụ Nữ - The Book Of Women",81700,109000,27300,25
TIKI,nha-sach-tiki,190705657,"Nuôi Dạy Con Theo Phương Pháp Montessori: Em Bé Sơ Sinh Từ 0-1 Tuổi",174000,220000,46000,21
TIKI,nha-sach-tiki,7440075,"Lâu Đài Trên Mây",75700,96000,20300,21
TIKI,nha-sach-tiki,184075082,"Học Đàn Piano",97400,125000,27600,22
TIKI,nha-sach-tiki,192048655,"Tớ đã từng sợ hãi",59900,75000,15100,20
TIKI,nha-sach-tiki,163553056,"Thần Chết Làm Thêm 300 Yên/Giờ (Tái Bản)",83900,105000,21100,20
TIKI,nha-sach-tiki,10971007,"EQ - Trí Thông Minh Xúc Cảm Trong Công Việc",103000,159000,56000,35
TIKI,nha-sach-tiki,560242,"Outliers - The Story Of Success",190000,190000,0,0
TIKI,nha-sach-tiki,193109496,"Chuộc Tội ",112000,280000,168000,60
TIKI,nha-sach-tiki,134846272,"Education - Kinh Doanh Giáo Dục Tại Thị Trường Việt Nam",172000,220000,48000,22
TIKI,nha-sach-tiki,173135243,"Vòng Đời (Life Cycles)",227000,350000,123000,35
TIKI,nha-sach-tiki,152522279,"Phúc Cho Ai Không Thấy Mà Tin - Những Câu Chuyện Nhiệm Mầu Về Hồng Ân Thiên Chúa",61500,88000,26500,30
TIKI,nha-sach-tiki,182548599,"Dragon Quest - Dấu Ấn Roto (Dragon Quest Saga Emblem Of Roto) Perfect Edition Tập 6 - Tặng Kèm Bookmark PVC",71900,75000,3100,4
TIKI,nha-sach-tiki,197353392,"Holmes Ở Kyoto - Tập 6",72300,85000,12700,15
TIKI,nha-sach-tiki,134605012,"15 Nguyên Tắc Vàng Về Phát Triển Bản Thân (Tái Bản)",119000,179000,60000,34
TIKI,nha-sach-tiki,586937,"Carlo Ancelotti - Lãnh Đạo Trầm Lặng - Thu Phục Nhân Tâm Và Chiến Thắng Các Trận Đấu",161000,180000,19000,11
TIKI,nha-sach-tiki,171549996,"Never Get Bored - Tí Ta Tí Toáy",124000,155000,31000,20
TIKI,nha-sach-tiki,173425949,"Khung ảnh để bàn nhiều kích thước, khung ảnh trong suốt Anzzar loại 2.5cm",55000,55000,0,0
TIKI,nha-sach-tiki,34750340,"Ngụ Ngôn Song Ngữ Anh - Việt: Đừng Tin Lời Gã Cáo (Tái Bản 2019)",13000,14000,1000,7
TIKI,nha-sach-tiki,35410612,"Combo Sách Tư Duy - Kỹ Năng Sống Ai Cũng Cần Phải Có : Cân Bằng Cảm Xúc, Cả Lúc Bão Giông + Nóng Giận Là Bản Năng , Tĩnh Lặng Là Bản Lĩnh ( Tặng Kèm Bookmark Green Life)",156960,163500,6540,4
TIKI,nha-sach-tiki,77323488,"Chatter - Trò Chuyện Với Chính Mình",123000,199000,76000,38
TIKI,nha-sach-tiki,997535,"Gọi Em Bằng Tên Anh - Call Me By Your Name",91900,115000,23100,20
TIKI,nha-sach-tiki,194206884,"Frugal Innovation - Làm tốt hơn với nguồn lực ít hơn",137000,220000,83000,38
TIKI,nha-sach-tiki,181699596,"Jesse Livermore - Nhà Đầu Tư Chứng Khoán Vĩ Đại",153000,219000,66000,30
TIKI,nha-sach-tiki,121236564,"PHÂN TÍCH MẪU HÌNH BIỂU ĐỒ - Những Bí Quyết Giúp Nhà Giao Dịch Siêu Hạng DAN ZANGER Biến 11 Nghìn Đô Thành 42 Triệu Đô Trong 23 Tháng",334000,348000,14000,4
TIKI,nha-sach-tiki,195661677,"Tư Duy Sâu, Ý Tưởng Bén, Sáng Tạo Thần Sầu",101000,139000,38000,27
TIKI,nha-sach-tiki,12081419,"Doraemon - Chú Mèo Máy Đến Từ Tương Lai Tập 23 (Tái Bản)",20800,22000,1200,5
TIKI,nha-sach-tiki,168559528,"Chiêm Tinh Học For Dummies",187000,249000,62000,25
TIKI,nha-sach-tiki,160371977,"Ăn Tối Cùng Chef Và Nói Chuyện Bếp",136000,170000,34000,20
TIKI,nha-sach-tiki,173515430,"Khám Phá Vận Mệnh - 7 Bước Đánh Thức Bản Thân",116000,145000,29000,20
TIKI,nha-sach-tiki,146272575,"Ăn Ít Để Khỏe - 1 Bữa Là Đủ Sao Phải Cần 3 (Tái Bản 2021)",91600,119000,27400,23
TIKI,nha-sach-tiki,74235036,"Điều Kỳ Diệu của Thái Độ Sống (Tái Bản)",40600,58000,17400,30
TIKI,nha-sach-tiki,74307132,"Arty Mouse - Đồ Theo Nét (Học Tập Đầu Đời Thông Qua Mỹ Thuật)",36000,45000,9000,20
TIKI,nha-sach-tiki,187058656,"Bộ Luật Hình Sự (Hiện Hành) (Bộ Luật Năm 2015, Sửa Đổi, Bổ Sung Năm 2017) - Tái bản năm 2022",110000,110000,0,0
TIKI,nha-sach-tiki,73116944,"Combo 20 cuốn - Bé Tô màu - Luyện chữ (Mầm non - Chuẩn bị vào lớp 1)",95000,190907,95907,50
TIKI,nha-sach-tiki,19274771,"Chuỗi Án Mạng A.B.C (Tái Bản)",83900,105000,21100,20
TIKI,nha-sach-tiki,70540568,"Nuôi Dạy Bé Gái Từ 0 Đến 6 Tuổi (Tái Bản 2020)",56200,75000,18800,25
TIKI,nha-sach-tiki,157054867,"Tôi Muốn Giỏi Tiếng Anh Nhưng Tôi Không Muốn Chăm Chỉ",157000,210000,53000,25
TIKI,nha-sach-tiki,14683083,"Nhượng Quyền Khỏi Nghiệp - Con Đường Ngắn Để Bước Ra Thế Giới (Tái Bản)",136000,160000,24000,15
TIKI,nha-sach-tiki,195541265,"Bài Tập Thực Hành Tiếng Anh 7 (Có Đáp Án) - Dùng Kèm SGK Tiếng Anh 7 GLOBAL SUCCESS",50600,65000,14400,22
TIKI,nha-sach-tiki,593709,"Góc Khuất Đàn Bà - Bản Thông Thường",62400,89000,26600,30
TIKI,nha-sach-tiki,10675287,"EAT CLEAN Thực Đơn 14 Ngày Thanh Lọc Cơ Thể Và Giảm Cân",130000,149000,19000,13
TIKI,nha-sach-tiki,16422526,"365 Chuyện Kể Trước Giờ Đi Ngủ - Những Câu Chuyện Phát Triển Chỉ Số Tình Cảm EQ (Tái Bản)",54500,78000,23500,30
TIKI,nha-sach-tiki,273119845,"Ông Trùm Cuối Cùng (Mario Puzo)",97600,150000,52400,35
TIKI,nha-sach-tiki,115078652,"Huấn Luyện Cảm Xúc Để Con Trẻ Phát Triển Toàn Diện",158000,198000,40000,20
TIKI,nha-sach-tiki,173973552,"Sách Từ Vựng Tiếng Anh : Từ Cùng Trường Nghĩa Trong Tiếng Anh Cô Trang Anh",143000,200000,57000,29
TIKI,nha-sach-tiki,146502516,"[Hàng Cao Cấp Loại Dày 2mm] Băng Dính 2 Mặt Đa Năng Trong Suốt Siêu Dày 2mm – Chọn Chiều Dài – Siêu Bám Dính - Băng Keo Trong Suốt Chính Hãng dododios",40000,40000,0,0
TIKI,nha-sach-tiki,272588674,"Giấy Photo, giấy in Samsung A4/70gsm - 500 tờ/ream",78000,78000,0,0
TIKI,nha-sach-tiki,109982974,"Alfred Nobel Và Bản Di Chúc Bất Hủ",45600,65000,19400,30
TIKI,nha-sach-tiki,91343895,"Những Sự Thật Về Ung Thư - Hiểu Thêm Để Bớt Lo",69900,105000,35100,33
TIKI,nha-sach-tiki,193897108,"Trái Tim Kẻ Phản Bội, Tập 1 + Tập 2",180000,226000,46000,20
TIKI,nha-sach-tiki,8128223,"Lột xác để trở thành nhà đầu tư giá trị - The education of a value investor",268000,268000,0,0
TIKI,nha-sach-tiki,34751670,"Ngụ Ngôn Song Ngữ Anh - Việt: Đôi Sừng Hươu (Tái Bản 2019)",18000,32000,14000,44
TIKI,nha-sach-tiki,173878382,"Bảng Từ Trắng Viết Bút Lông Deli - Bảng Mica Hít Nam Châm Nhiều Kích Cỡ - Có Khay Đựng - Phù Hợp Học Sinh Văn Phòng - EV450 / EV600 / EV900",225000,405000,180000,44
TIKI,nha-sach-tiki,1029852,"Tuần Của Bé - Bé Thân Thiện (Dành Cho Trẻ 3 - 6 Tuổi)",11000,11500,500,4
TIKI,nha-sach-tiki,148802195,"How We’Re F***Ing Up Our Planet - Ta Đang Hủy Diệt Trái Đất Như Thế Nào",264000,330000,66000,20
TIKI,nha-sach-tiki,52709770,"Từ điển Anh Việt bìa đỏ cứng Tái bản mới nhất - Sách học từ vựng Tiếng Anh Học nhanh Nhớ lâu Giấy nhớ PS",202640,298000,95360,32
TIKI,nha-sach-tiki,4319337,"Tạo Dựng Thương Hiệu Cá Nhân",70000,109000,39000,36
TIKI,nha-sach-tiki,186578233,"Trúc thư dao 2 (Nước Tấn - Gió nổi cung đình)",175000,219000,44000,20
TIKI,nha-sach-tiki,427631,"Tầm Nhìn Thay Đổi Quốc Gia",188000,268000,80000,30
TIKI,nha-sach-tiki,14684312,"Dấn Thân (Tái Bản)",84100,112000,27900,25
TIKI,nha-sach-tiki,82072617,"Các Lỗi Thường Gặp Trong Tiếng Anh",53600,80000,26400,33
TIKI,nha-sach-tiki,41556498,"Tác Phẩm Kinh Điển: Thiên Tài Bên Trái, Kẻ Điên Bên Phải / Sách Văn Học Hay (Tặng Kèm Bookmark Thiết Kế Bookmark Happy Life)",163250,163250,0,0
TIKI,nha-sach-tiki,82996527,"Tinh Thần Chiến Đấu Rực Lửa",71200,95000,23800,25
TIKI,nha-sach-tiki,163297416,"My Hero Academia - Học Viện Siêu Anh Hùng Tập 3: All Might (Tái Bản)",23700,25000,1300,5
TIKI,nha-sach-tiki,730723,"Tuần Của Bé Tháng 7- Bé Tự Tin",22000,23000,1000,4
TIKI,nha-sach-tiki,194103341,"Bột Nước Muối Men: Nền tảng của bánh mỳ và pizza thủ công",260000,360000,100000,28
TIKI,nha-sach-tiki,714023,"Ngụ Ngôn E Dốp - Văn Học Cổ Điển Hi Lạp",58800,98000,39200,40
TIKI,nha-sach-tiki,185435297,"Tiệm Cắt Tóc Lúc Nửa Đêm",83000,116000,33000,28
TIKI,nha-sach-tiki,47323978,"Quick Quick Học Nhanh Toàn Diện Từ Vựng Tiếng Anh Theo Chủ Đề Lớp 1",59100,89000,29900,34
TIKI,nha-sach-tiki,337887,"Mộng Phù Du",110000,110000,0,0
TIKI,nha-sach-tiki,22881827,"Complete IELTS B1 Student's Book with answer with CD-ROM",251100,279000,27900,10
TIKI,nha-sach-tiki,11371241,"1Q84 (Tập 1) - Tái Bản",112000,160000,48000,30
TIKI,nha-sach-tiki,49252204,"Dạy Con Làm Giàu - Tập 12: Lời Tiên Tri Của Người Cha Giàu (Tái Bản)",106000,160000,54000,34
TIKI,nha-sach-tiki,75454261,"Stay Positive - Sống Tích Cực, Đời Hết Bực - Bí Quyết Sống Vui Mỗi Ngày",86400,120000,33600,28
TIKI,nha-sach-tiki,188930498,"Người Bà Tài Giỏi Vùng Saga – Tập 6",40900,52000,11100,21
TIKI,nha-sach-tiki,110649726,"Hành Trình Thức Tỉnh ",160000,229000,69000,30
TIKI,nha-sach-tiki,19948893,"Chạm Tay Hóa Vàng (Tái Bản)",86000,125000,39000,31
TIKI,nha-sach-tiki,154245459,"Nghiền Từ Vựng Tiếng Anh - Học Qua Gốc Từ Bằng Hình Ảnh - Gốc Từ Là Bí Quyết Để Ghi Nhớ Hàng Nghìn Từ Vựng - Quyển 1",105000,135000,30000,22
TIKI,nha-sach-tiki,147964307,"COMBO SÁCH PHÙ HỢP MỌI THỂ LOẠI ĐẦU TƯ – KỸ THUẬT KHÓ CHẲNG LO",428000,428000,0,0
TIKI,nha-sach-tiki,186265472,"Thế Giới Của Truyện Nôm",136000,170000,34000,20
TIKI,nha-sach-tiki,63924629,"Tạp Văn Nguyễn Ngọc Tư (Tái Bản Lần Thứ 20-2020)",71900,90000,18100,20
TIKI,nha-sach-tiki,191782142,"Điều Vĩ Đại Đời Thường",69100,92000,22900,25
TIKI,nha-sach-tiki,191926658,"Trái cây đại chiến Zombie - Thế giới khủng long: Tập 10 - Vương quốc ngủ say",64100,89000,24900,28
TIKI,nha-sach-tiki,273714602,"Trạm Đọc | Thuật Tẩy Não - Nghệ Thuật Thao Túng Và Kiểm Soát Tâm Lý Đối Phương",141000,189000,48000,25
TIKI,nha-sach-tiki,117106069,"Máy Tính Casio FX 580 VN X (Lựa Chọn Màu Sắc)",768000,784000,16000,2
TIKI,nha-sach-tiki,196394987,"Hai Ta Trên Đường Kẻ Cuộc Đời",92700,109000,16300,15
TIKI,nha-sach-tiki,273568395,"Husky Và Sư Tôn Mèo Trắng Của Hắn (Tập 2)",129100,169000,39900,24
TIKI,nha-sach-tiki,17960478,"RIO Book No.3 - Hình Ảnh Điều Khiển Tâm Trí - 30 Kỹ Thuật Điều Khiển Tâm Lý Trong Truyền Thông Thị Giác",121000,155000,34000,22
TIKI,nha-sach-tiki,190238358,"Nhặt Sao - Bản Thường - (Tặng kèm 1 bookmark in 2 mặt)",143000,179000,36000,20
TIKI,nha-sach-tiki,111537683,"Và Rồi Chẳng Còn Ai (Agatha Christie)",87900,110000,22100,20
TIKI,nha-sach-tiki,192833921,"Combo 2 Sách: Tiếng Anh Cho Người Mới Bắt Đầu và Tổng Ôn Ngữ Pháp Tiếng Anh Cô Trang Anh",315000,400000,85000,21
TIKI,nha-sach-tiki,192714730,"Tuyển Tập Đề Kiểm Tra Định Kì Khoa Học Tự Nhiên Lớp 7 ( Theo Chương Trình GDPT Mới )",67160,92000,24840,27
TIKI,nha-sach-tiki,193896500,"How Yoga Works: Bí mật Yoga",179000,239000,60000,25
TIKI,nha-sach-tiki,12107379,"Barron's Essential Words For The Ielts (Tái Bản)",143000,208000,65000,31
TIKI,nha-sach-tiki,194104629,"Một Quyển Phong Hoa Đại Đường",96900,139000,42100,30
TIKI,nha-sach-tiki,157244522,"Văn Minh Đông Phương Và Tây Phương (Ts Thu Giang Nguyễn Duy Cần)(Tái Bản)",47900,60000,12100,20
TIKI,nha-sach-tiki,55957270,"Sách Hoa Trôi Trên Sóng Nước (Tái Bản 2020) - Nguyên Phong",67600,98000,30400,31
TIKI,nha-sach-tiki,190707619,"Của Chuột Và Người",60700,76000,15300,20
TIKI,nha-sach-tiki,1686729,"Học Tiếng Anh Giao Tiếp Chỉ Trong 30 Ngày",232000,298000,66000,22
TIKI,nha-sach-tiki,111155169," [Manga] Diệt Slime Suốt 300 Năm, Tôi Levelmax Lúc Nào Chẳng Hay (Tập 5) ",28700,48000,19300,40
TIKI,nha-sach-tiki,595726,"Giáo Trình Chuẩn HSK 4 Bài Học (Tập 2)",188000,238000,50000,21
TIKI,nha-sach-tiki,41299108,"Trở Về Từ Cõi Sáng (Tái Bản)",68500,98000,29500,30
TIKI,nha-sach-tiki,58165559,"Ngữ Pháp Tiếng Hàn Thông Dụng - Sơ Cấp",170000,250000,80000,32
TIKI,nha-sach-tiki,67120551,"Đây Là Monet",112000,150000,38000,25
TIKI,nha-sach-tiki,189557421,"Blog Writing - Sống với nghề viết blog",189000,250000,61000,24
TIKI,nha-sach-tiki,557457,"Giấy Decal A4 Đế Xanh",72000,72000,0,0
TIKI,nha-sach-tiki,11470936,"Combo Giáo Trình HSK 3 - Sách Bài Học (Kèm MP3) và Giáo Trình HSK 3 - Sách Bài Tập (Kèm MP3) ( Tặng Kèm Sổ Tay)",380800,476000,95200,20
TIKI,nha-sach-tiki,7982626,"Thế Giới Phẳng (Tái Bản)",206000,310000,104000,34
TIKI,nha-sach-tiki,386182,"Thế Giới Tuổi Thần Tiên - Những Câu Chuyện Trong Rừng Xanh",20000,38000,18000,47
TIKI,nha-sach-tiki,73553827,"Dữ Liệu Lớn Cho Doanh Nghiệp Nhỏ For Dummies",79500,159000,79500,50
TIKI,nha-sach-tiki,112331977,"Quiz! Khoa Học Kì Thú: Khám Phá Trái Đất",57700,75000,17300,23
TIKI,nha-sach-tiki,273634677,"Trạm Đọc Official | Hackers Ielts 4 cuốn  ( Listening + Reading + Speaking + Writing )",743000,996000,253000,25
TIKI,nha-sach-tiki,41299102,"Những Nguyên Lý Quản Trị Bất Biến Mọi Thời Đại (Tái Bản 2019)",96700,138000,41300,30
TIKI,nha-sach-tiki,46253703,"Danh Gia Cổ Vật - Bí Ẩn Thanh Minh Thượng Hà Đồ",126000,150000,24000,16
TIKI,nha-sach-tiki,7556499,"GAM7 No.11 Promotion - Khuyến Mại",129000,165000,36000,22
TIKI,nha-sach-tiki,187859732,"Spy Room – Lớp Học Điệp Viên 4",86000,109000,23000,21
TIKI,nha-sach-tiki,15634588,"Who? Chuyện Kể Về Danh Nhân Thế Giới: Ludwig Van Beethoven (Tái Bản 2019)",44100,55000,10900,20
TIKI,nha-sach-tiki,1732997,"Hồ Sơ Mật Lầu 5 Góc Và Hồi Ức Về Chiến Tranh Việt Nam (Sách Tham Khảo)",290000,290000,0,0
TIKI,nha-sach-tiki,189076559,"Gatsby vĩ đại",182000,280000,98000,35
TIKI,nha-sach-tiki,187859733,"Thám Tử Đã Chết Tập 4 - Bản Phổ Thông - Quà Tặng Kèm Bookmark, Bộ Card Trong Bù Của Tập 3 (Trong Lần In Đầu)",87100,109000,21900,20
TIKI,nha-sach-tiki,29190890,"Tôi Đi Tìm Tôi",104000,160000,56000,35
TIKI,nha-sach-tiki,187279375,"Sách Luyện thi B2 Vstep 4 kỹ năng - Ôn thi chứng chỉ tiếng Anh bậc 4 (bằng B2 tiếng Anh) khung năng lực Ngoại ngữ 6 bậc Việt Nam",287000,350000,63000,18
TIKI,nha-sach-tiki,68350215,"Combo Chinh Phục Luyện Thi Vào 10 Toán Văn Anh Theo Chủ Đề",340000,477000,137000,29
TIKI,nha-sach-tiki,49904794,"Fullset Ehon Nhật Bản cho bé thông minh sáng tạo: Ehon Điều Kỳ Diệu Của Hình Khối + Điều Kỳ Diệu Của Âm Thanh + Điều Kỳ Diệu Của Màu Sắc (Bộ 10 cuốn cho bé 0-6 tuổi / Bộ Sách Phát Triển Trí Tuệ & Kích Thích Thị Giác Cho Bé)",261000,390000,129000,33
TIKI,nha-sach-tiki,9687403,"The Book Of Leadership - Dẫn Dắt Bản Thân, Đội Nhóm Và Tổ Chức Vươn Xa",140000,218000,78000,36
TIKI,nha-sach-tiki,191045567,"Làm Người Là Như Thế Nào? How To Be Human – The Manual",143000,179000,36000,20
TIKI,nha-sach-tiki,178240500,"Đường Gia Tiểu Miêu",138000,179000,41000,23
TIKI,nha-sach-tiki,190701640,"Diệt Slime Suốt 300 Năm, Tôi Levelmax Lúc Nào Chẳng Hay (Tập 4) - (Tái Bản)",34900,52000,17100,33
TIKI,nha-sach-tiki,172175794,"Lý Thuyết Dow - Khoa Học Đầu Cơ Chứng Khoán: Bí Quyết Phân Tích Hành Vi Thị Trường Của Cha Đẻ Chỉ Số Dow Jones - Tác Phẩm Nền Tảng Của Phân Tích Kĩ Thuật Hiện Đại",33000,55000,22000,40
TIKI,nha-sach-tiki,195288800,"Combo 2 Cuốn Khám Phá Sứ Mệnh Với Câu Hỏi Tại Sao – Bắt Đầu Với Câu Hỏi Tại Sao",154000,208000,54000,26
TIKI,nha-sach-tiki,77281352,"Lời giải bài tập Python cơ bản",75000,75000,0,0
TIKI,nha-sach-tiki,195623888,"Truyện tranh tuổi thần tiên - Cây táo thần",12100,15000,2900,19
TIKI,nha-sach-tiki,584873,"Sách Kiến Tạo Thế Hệ Việt Nam Ưu Việt - John Vu",55500,88000,32500,37
TIKI,nha-sach-tiki,13443851,"Cùng Khủng Long Học Tiếng Anh Theo Chủ Đề Lớp 1 (Tái Bản)",46100,68000,21900,32
TIKI,nha-sach-tiki,111271288,"Mô Hình Phân Phối Và Bán Lẻ - Giải Pháp Cho Doanh Nghiệp Việt Nam (Tái Bản)",74200,99000,24800,25
TIKI,nha-sach-tiki,595738,"Giáo Trình Chuẩn HSK 4 Bài Tập (Tập 1)",109000,148000,39000,26
TIKI,nha-sach-tiki,196906879,"Máy Tính Khoa Học FX-880 BTG [ Siêu Máy Tính 2022",870000,870000,0,0
TIKI,nha-sach-tiki,531103,"Không Gia Đình (Khang Việt)",139360,268000,128640,48
TIKI,nha-sach-tiki,51244265,"Lược Sử Kinh Tế Học",105000,135000,30000,22
TIKI,nha-sach-tiki,447670,"Phép Tắc Của Loài Sói (Tái Bản 2015)",125000,125000,0,0
TIKI,nha-sach-tiki,67060010,"Thực Đơn Ăn Dặm Kiểu Nhật",109000,168000,59000,35
TIKI,nha-sach-tiki,2906447,"Series Địch Công Kỳ Án Tập 7 - Ngọc Xuyến Án",87000,91000,4000,4
TIKI,nha-sach-tiki,111285054,"Quẳng Gánh Lo Đi & Vui Sống (Tái Bản)",47600,86000,38400,45
TIKI,nha-sach-tiki,192115854,"Ninja Rantaro - Tập 58 [Tặng Kèm Postcard]",38300,40000,1700,4
TIKI,nha-sach-tiki,74855017,"Quản Lý Tài Chính Cá Nhân Cho Phụ Nữ",103000,159000,56000,35
TIKI,nha-sach-tiki,5067155,"Nhật Ký Anne Frank (Tái Bản)",76300,98000,21700,22
TIKI,nha-sach-tiki,191655860,"Làm Đẹp Thuần Chay",100000,139000,39000,28
TIKI,nha-sach-tiki,165098800,"My Hero Academia - Học Viện Siêu Anh Hùng - Tập 4: Cậu Bé Sinh Ra Với Tất Cả (Tái Bản 2022)",23700,25000,1300,5
TIKI,nha-sach-tiki,76688366,"Leader Mindset - Thay Đổi Tư Duy Lãnh Đạo - LOAN VĂN SƠN",325000,500000,175000,35
TIKI,nha-sach-tiki,196377993,"Sáng Mắt",112000,155000,43000,28
TIKI,nha-sach-tiki,47273271,"Inbound Selling - Thay Đổi Phương Thức Bán Hàng Theo Mô Hình Inbound",99600,158000,58400,37
TIKI,nha-sach-tiki,22634351,"Combo All The Rules Bình Tĩnh Khi Ế, Mạnh Mẽ Khi Yêu + Sống Bản Lĩnh Theo Cách Một Quý Cô (2 Cuốn)",124000,182000,58000,32
TIKI,nha-sach-tiki,82041440,"Models: Quyến Rũ Phái Đẹp Bằng Cả Chân Tình",107000,160000,53000,33
TIKI,nha-sach-tiki,191148802,"Tâm lý học giao tiếp",138000,189000,51000,27
TIKI,nha-sach-tiki,29290844,"Kho Tàng Truyện Thần Thoại Cổ Đại Trung Quốc (Không CD)",22000,22000,0,0
TIKI,nha-sach-tiki,73717906,"Khởi Nghiệp Công Nghệ - Máu Bẩn",156000,239000,83000,35
TIKI,nha-sach-tiki,186578228,"Đời sống vỉa hè Sài Gòn",135000,169000,34000,20
TIKI,nha-sach-tiki,36399672,"Trò Đùa Của Sự Ngẫu Nhiên",157000,209000,52000,25
TIKI,nha-sach-tiki,275513386,"Thiên Quan Tứ Phúc - Tập 2 (Tái Bản)",121000,121000,0,0
TIKI,nha-sach-tiki,74217686,"Gi Gỉ Gì Gi, Cái Gì Cũng Biết - 130 Bí Mật Vui Nhất Cho Tuổi Tiểu Học",90700,115000,24300,21
TIKI,nha-sach-tiki,111271564,"Vòng Xoáy Đi Lên - Đảo Chiều Trầm Cảm Từ Những Thay Đổi Nhỏ",112000,149000,37000,25
TIKI,nha-sach-tiki,80142837,"Hackers IELTS Basic- Listening",169000,229000,60000,26
TIKI,nha-sach-tiki,188930500,"Người Bà Tài Giỏi Vùng Saga – Tập 5",40900,52000,11100,21
TIKI,nha-sach-tiki,394438,"Giấy Excel A4 DL80 ",65000,65000,0,0
TIKI,nha-sach-tiki,196305161,"Cơ Thể Con Là Của Con (Tái bản 2022)",58200,75000,16800,22
TIKI,nha-sach-tiki,66464344,"Sài Gòn Đất Và Người (Tái Bản 2020)",131000,165000,34000,21
TIKI,nha-sach-tiki,197142885,"Sách Pháp Y Tần Minh : Búp Bê ( Tặng sổ tay xương rồng )",156000,199000,43000,22
TIKI,nha-sach-tiki,730782,"Tuần Của Bé Tháng 7 - Bé Trung Thực",22000,23000,1000,4
TIKI,nha-sach-tiki,192377680,"Cách Dạy, Cách Học, Cách Sống Trong Thế Kỷ XXI: Khảo Sát Triết Lý Giáo Dục Của Dewey Và Makiguchi Để Đưa Ra Phương Thức Giáo Dục Mới Cho Nhân Loại",122000,145000,23000,16
TIKI,nha-sach-tiki,59010153,"100 Kỹ Năng Sinh Tồn",69300,99000,29700,30
TIKI,nha-sach-tiki,105835879,"Gôm tẩy học sinh Deli đủ màu - 20 chiếc -  7533",20000,36000,16000,44
TIKI,nha-sach-tiki,192475874,"Tôi Muốn Vì Bạn Mà Trở Thành Người Tốt",61800,86000,24200,28
TIKI,nha-sach-tiki,13443886,"Giáo Trình Chuẩn HSK 3 Bài Học (Kèm file MP3) - Tái Bản",245000,288000,43000,15
TIKI,nha-sach-tiki,186290796,"Còn chút gì để nhớ (Tái Bản 2022)",35200,43000,7800,18
TIKI,nha-sach-tiki,50269973,"Biểu Tượng Thất Truyền (Tái Bản 2020)",158000,239000,81000,34
TIKI,nha-sach-tiki,644083,"Thời Gian Để Sống Và Thời Gian Để Chết",86900,100000,13100,13
TIKI,nha-sach-tiki,189642774,"Thay Đổi Vận Mệnh Từ Bàn Tay",99700,128000,28300,22
TIKI,nha-sach-tiki,194104230,"Gió Lẻ Và 9 Câu Chuyện Khác",74600,90000,15400,17
TIKI,nha-sach-tiki,166525103,"NFT – Cuộc Cách Mạng Công Nghệ Tiếp Nối Blockchain Và Kỷ Nguyên Tiền Điện Tử",105300,159000,53700,34
TIKI,nha-sach-tiki,120509490,"Thương Nhớ Mười Hai (Việt Nam Danh Tác) (Tái Bản)",78100,99000,20900,21
TIKI,nha-sach-tiki,73268489,"Những Ông Trùm Tài Chính",223000,299000,76000,25
TIKI,nha-sach-tiki,194960237,"Dược Sư Tự Sự (Light-Novel) – Tập 2",93400,110000,16600,15
TIKI,nha-sach-tiki,29830245,"Thuật Thôi Miên Trong Giao Tiếp",64000,108000,44000,41
TIKI,nha-sach-tiki,161929579,"Fullmetal Alchemist - Cang Giả Kim Thuật Sư - Fullmetal Edition Tập 13 [Tặng Kèm Bookmark PVC]",62000,69000,7000,10
TIKI,nha-sach-tiki,59043891,"Hố (Louis Sachar)(Tái Bản 2020)",57500,72000,14500,20
TIKI,nha-sach-tiki,180400055,"Thất Lạc Cõi Người (Tái Bản 2022)",95000,119000,24000,20
TIKI,nha-sach-tiki,185243203,"Tiếng Anh 10 Bright Workbook (Sách bài tập)",65000,65000,0,0
TIKI,nha-sach-tiki,185903114,"Bài tập Thực hành tiếng Anh 6 (Có đáp án) - Dùng kèm SGK TA 6 GLOBAL SUCCESS",41900,60000,18100,30
TIKI,nha-sach-tiki,161930883,"Thói Quen Thứ 8 - Từ Hiệu Quả Đến Vĩ Đại (Bìa Mềm)",113000,168000,55000,33
TIKI,nha-sach-tiki,194959711,"Đao Ngữ (Katanagatari) 3",94700,120000,25300,21
TIKI,nha-sach-tiki,3529957,"i-Learn Smart World 8 Workbook",82000,82000,0,0
TIKI,nha-sach-tiki,160754106,"Nghiên Cứu Phân Tâm Học",107000,135000,28000,21
TIKI,nha-sach-tiki,111165275,"Cao Thủ Đổi Đen Thay Trắng - Tập 3 (Dành Cho 18+)",112000,149000,37000,25
TIKI,nha-sach-tiki,138934615,"Tô Màu Phát Triển Trí Não Bộ Cho Bé 1-5 Tuổi - Tập 4",12700,16000,3300,21
TIKI,nha-sach-tiki,56609155,"Trường Ca Achilles (Quà Tặng Kèm: 01 Bookmark + 01 Phụ Lục)",125000,156000,31000,20
TIKI,nha-sach-tiki,174444190,"Người Bên Gối",89300,119000,29700,25
TIKI,nha-sach-tiki,1823525,"Series Địch Công Kỳ Án: Đạo Quán Có Ma",38000,79000,41000,52
TIKI,nha-sach-tiki,52332414,"Nghi thức trì Chú Đại Bi, Chú Dược Sư & Niệm Phật A Di Đà ",19000,19000,0,0
TIKI,nha-sach-tiki,520330,"Đất Máu Sicily (Mario Puzo)",78000,120000,42000,35
TIKI,nha-sach-tiki,185435307,"Thần Mộc Cào Bất Tận – Tập 2 - Bản Thường (Tặng 1 Bookmark in 2 Mặt)",119000,166000,47000,28
TIKI,nha-sach-tiki,54616131,"Tử Huyệt Cảm Xúc",130000,130000,0,0
TIKI,nha-sach-tiki,122848364,"EQ - Từ Âm Vô Cực Đến Dương Vô Cùng",105300,159000,53700,34
TIKI,nha-sach-tiki,185243205,"Tiếng Anh 10 Bright Student's Book (Sách học sinh)",69000,69000,0,0
TIKI,nha-sach-tiki,184781427,"Những Câu Hỏi Lớn Từ Người Phàm Trần Tí Hon Về Cái Chết",56400,79000,22600,29
TIKI,nha-sach-tiki,185653966,"Tâm Lý Học Đám Đông",111650,149000,37350,25
TIKI,nha-sach-tiki,107034694,"Gọt Chì Mini Deli - Xanh Lá/Xanh Dương/Hồng/Vàng - 1 chiếc - E0531 - Màu ngẫu nhiên",2700,5400,2700,50
TIKI,nha-sach-tiki,57870430,"Trò Chuyện Với Thượng Đế (Tặng Kèm 01 Bookmark Một Mặt)",104000,159000,55000,35
TIKI,nha-sach-tiki,157019700,"Thiệp chúc mừng sinh nhật 12x12 SDstationery SN2 STARRY họa tiết ngôi sao typography chữ viết tay đơn giản",54000,64800,10800,17
TIKI,nha-sach-tiki,149409114,"Bổ Được Cà Chua, Mở Được Tiệm Cơm; Bật Được Nắp Chai, Mở Được Quán Nhậu (Tái Bản)",71400,105000,33600,32
TIKI,nha-sach-tiki,57318113,"Từ Điển Chính Tả Tiếng Việt ( Tác Phẩm Được Viện Ngôn Ngữ Học Thẩm Định)",62300,80000,17700,22
TIKI,nha-sach-tiki,195801639,"Hế Lô Nyao - Tập 09",25000,25000,0,0
TIKI,nha-sach-tiki,32855400,"Tâm Lý Học Đám Đông (Tái Bản) ( tặng kèm bookmark Sáng Tạo )",111000,149000,38000,26
TIKI,nha-sach-tiki,541248,"Võ Nguyên Giáp - Những Năm Tháng Cuộc Đời (Tái Bản)",67100,82000,14900,18
TIKI,nha-sach-tiki,572247,"Chiến Thắng Kì Thi 9 Vào 10 Chuyên Vật Lý (Tập 1)",113400,189000,75600,40
TIKI,nha-sach-tiki,192161603,"Chú Thuật Hồi Chiến - Tập 5 - Bản Thường - Tặng Kèm Obi Và Thẻ Bo Góc Nhựa",28500,30000,1500,5
TIKI,nha-sach-tiki,185786203,"Hộp đựng răng sữa cho bé bằng gỗ - Hộp đựng răng sữa kỷ niệm cho bé",55800,60000,4200,7
TIKI,nha-sach-tiki,195306005,"Nhà thờ Đức Bà Paris (Bìa Cứng)",520000,650000,130000,20
TIKI,nha-sach-tiki,115702579,"Quảng Cáo Không Nói Láo - Sự Thật Về Quảng Cáo Dưới Góc Nhìn Khoa Học, Toàn Diện Và Thực Tiễn",163000,195000,32000,16
TIKI,nha-sach-tiki,169376042,"Từ Điển Tiếng Việt Hoàng Phê (Tái Bản)",460300,495000,34700,7
TIKI,nha-sach-tiki,195801321,"The One Thing - Điều Ý Nghĩa Nhất (Tái Bản 2022)",85600,119000,33400,28
TIKI,nha-sach-tiki,147265098,"Volume Profile - Góc nhìn từ người trong cuộc",209000,209000,0,0
TIKI,nha-sach-tiki,145144836,"Sách Bóc Dán Dành Cho Bé Gái - Những Nàng Tiên Chăm Chỉ",43900,55000,11100,20
TIKI,nha-sach-tiki,92096347,"Trở Về Từ Xứ Tuyết (Tái Bản)",64500,92000,27500,30
TIKI,nha-sach-tiki,69908762,"Luyện viết chữ Hán Sơ cấp 1 (Theo Giáo trình Hán ngữ BOYA)",125000,250000,125000,50
TIKI,nha-sach-tiki,56819709,"Thiền Chữa Lành Thân Và Tâm (Tái Bản 2020)",71200,95000,23800,25
TIKI,nha-sach-tiki,195291853,"Kỳ Nghỉ Dưỡng Của Chàng Quý Tộc Ôn Hòa (Tập 3)",78000,196000,118000,60
TIKI,nha-sach-tiki,102159092,"36 KẾ VÀ 36 ĐỐI KẾ (72 Phép xử lý khó khăn trong cuộc đời & kinh doanh)",228000,280000,52000,19
TIKI,nha-sach-tiki,170490622,"Người Điều Khiển Mê Cung",99300,128000,28700,22
TIKI,nha-sach-tiki,179547036,"Bộ Sách Khởi Nghiệp Du Kích - Kinh Doanh Ít Vốn: Làm Thế Nào Để Khởi Động và Vận Hành Doanh Nghiệp Bằng Nguồn Vốn Hạn Hẹp",325000,567000,242000,43
TIKI,nha-sach-tiki,71658956,"Full Combo (Bộ 10 cuốn) Ehon Kỹ năng - Âm thanh - Nhận biết",161000,322000,161000,50
TIKI,nha-sach-tiki,108130861,"Tiếng Anh 1 i-Learn Smart Start - Notebook",28000,28000,0,0
TIKI,nha-sach-tiki,77988131,"Văn Học Kinh Điển - Thể Xác Và Tâm Hồn (Ấn Bản Phổ Thông - Bìa Cứng) [Tặng Kèm: Postcard + Bookmark]",388000,388000,0,0
TIKI,nha-sach-tiki,15634596,"Búp Sen Xanh (Tái Bản)",72000,72000,0,0
TIKI,nha-sach-tiki,52004412,"D. Trump - Nghệ Thuật Đàm Phán (Tái bản 2020)",87100,109000,21900,20
TIKI,nha-sach-tiki,76443018,"Lược Sử Triết Học",114000,142000,28000,20
TIKI,nha-sach-tiki,104074530,"Tôi, Tương Lai Và Thế Giới (Tái Bản)",108000,160000,52000,33
TIKI,nha-sach-tiki,77917794,"Từ Nước Mắt Đến Nụ Cười - Tận Cùng Khổ Đau Đến Ngời Sáng Tâm Hồn",104000,148000,44000,30
TIKI,nha-sach-tiki,581983,"Việt Nam Sử Lược (Bản Đặc Biệt - Ấn Bản Kỉ Niệm 60 Năm NXB Kim Đồng)",158000,250000,92000,37
TIKI,nha-sach-tiki,47504724,"Những Tấm Lòng Cao Cả (Tái Bản 2020)",67400,90000,22600,25
TIKI,nha-sach-tiki,10271803,"Combo Ngữ Pháp Và Giải Thích Ngữ Pháp Tiếng Anh Cơ Bản Và Nâng Cao",292000,400000,108000,27
TIKI,nha-sach-tiki,67060014,"Phát Triển Trí Tuệ Cảm Xúc - Con Được Là Chính Mình!",37600,50000,12400,25
TIKI,nha-sach-tiki,195928317,"Hộp Bút Túi Đựng Bút Đồ Dùng Học Tập Đồ Dùng Cá Nhân Học Sinh Họa Tiết Vui Nhộn Deli -  Bóp Viết Phù Hợp Cho Học Sinh, Đựng Mĩ Phẩm - Màu Sắc Tươi Sáng",29200,54000,24800,46
TIKI,nha-sach-tiki,32192511,"Checklist Thông Minh Cho Mọi Dự Án",64500,129000,64500,50
TIKI,nha-sach-tiki,176487508,"Trường Pháp Ở Việt Nam 1945 -1975",187000,249000,62000,25
TIKI,nha-sach-tiki,13828940,"Văn Học Kinh Điển Thế Giới - Phù Thủy Xứ OZ",63400,88000,24600,28
TIKI,nha-sach-tiki,173406524,"Kẻ Lãng Quên - Pháp Y Tần Minh",183500,183500,0,0
TIKI,nha-sach-tiki,185055210,"Có Lẽ Bạn Nên Gặp Bác Sỹ Tâm Lý",187000,249000,62000,25
TIKI,nha-sach-tiki,59291594,"100 Phương Pháp Thực Tiễn Để Cải Thiện Trải Nghiệm Khách Hàng",119000,150000,31000,21
TIKI,nha-sach-tiki,59362963,"Osho Đàn Ông - The Book Of Men",89200,119000,29800,25
TIKI,nha-sach-tiki,197531553,"Blue Period - Tập 4 - Tặng Kèm Bookmark Giấy",46500,48000,1500,3
TIKI,nha-sach-tiki,49549966,"Ba Người Lính Ngự Lâm (Đông A) (Tái Bản)",163000,250000,87000,35
TIKI,nha-sach-tiki,73107479,"Hình Xăm - Bản Thường (Tặng Kèm:  1 Bookmark)",112000,159000,47000,30
TIKI,nha-sach-tiki,145279201,"Sách Đường Xưa Mây Trắng - Theo Gót Chân Bụt (Tái bản năm 2020) (Bìa mềm/ Câu Chuyện Thú Vị Về Bụt/ Tặng Kèm Bookmark)",311650,311650,0,0
TIKI,nha-sach-tiki,50322534,"Song Ngữ Việt - Anh - Diary Of A Wimpy Kid - Nhật Ký Chú Bé Nhút Nhát",66200,96000,29800,31
TIKI,nha-sach-tiki,183539215,"Trần Triều Nhàn Thoại",95100,119000,23900,20
TIKI,nha-sach-tiki,191949999,"ĐẠO ĐỨC HỌC - SPINOZA",134000,268000,134000,50
TIKI,nha-sach-tiki,72511282,"Bộ Sách Tự Xóa Thông Minh - Bé Học Toán Mỗi Ngày (5 -7 tuổi) (Tặng Kèm Bút Xóa)",64000,89000,25000,28
TIKI,nha-sach-tiki,69764547,"Hẹn Nhau Phía Sau Tan Vỡ",61800,86000,24200,28
TIKI,nha-sach-tiki,114937975,"Bóng Trăng Trắng Ngà - Bản Thường (Tặng Kèm: Bìa Áo + 1 Book Mark)",92400,129000,36600,28
TIKI,nha-sach-tiki,186495460,"Những Bài Diễn Văn Làm Thay Đổi Thế Giới Từ 1945 Đến Nay",272000,340000,68000,20
TIKI,nha-sach-tiki,435090,"Harry Potter Part 1 : Harry Potter And The Philosopher's Stone (Harry Potter và Hòn đá phù thủy) (Paperback) (English Book)",196200,218000,21800,10
TIKI,nha-sach-tiki,188533804,"Chuyện Dài Thành Chuyện Ngắn",82700,115000,32300,28
TIKI,nha-sach-tiki,19349136,"Sức Mạnh Tiềm Thức (Tái Bản)",102000,128000,26000,20
TIKI,nha-sach-tiki,184283143,"Combo 10 bìa nút túi hồ sơ tài liệu A4 loại dày màu tự chọn Deli - Phù hợp học sinh văn phòng - EF10412 / EF10432 / EF10442 / EF10452 / EF10462 / EF10472",11200,21600,10400,48
TIKI,nha-sach-tiki,68580163,"Sổ Tay Học Nhanh Toàn Diện Kiến Thức Và Dạng Bài Hóa Học Lớp  10 - 11 - 12",84500,119000,34500,29
TIKI,nha-sach-tiki,148937423,"Sách: Vì Sao Đơn Giản Lại Hiệu Quả",37000,130000,93000,72
TIKI,nha-sach-tiki,193433940,"Tập luyện cổ họng – 5 phút 1 ngày giúp kéo dài 10 năm tuổi thọ",59200,79000,19800,25
TIKI,nha-sach-tiki,185909452,"Điệp Viên Hoàn Hảo X6 (Bìa Mềm)",125000,178000,53000,30
TIKI,nha-sach-tiki,75630589,"Tốc Độ Của Niềm Tin (The Speed Of Trust: The One Thing That Changes Everything) - Stephen M. R. Covey, Rebecca R. Merrill - PACE Books",140000,175000,35000,20
TIKI,nha-sach-tiki,150997930,"Thế Giới Otome Game Thật Khắc Nghiệt Với Nhân Vật Quần Chúng - Tập 4",129000,179000,50000,28
TIKI,nha-sach-tiki,195801673,"Khoa Học Khám Phá - Vũ Trụ Trong Vỏ Hạt Dẻ (Tái Bản 2022)",68900,108000,39100,36
TIKI,nha-sach-tiki,109982968,"Albert Einstein - Tuổi Thơ Gian Khó Và Cuộc Đời Khoa Học Vĩ Đại",38400,55000,16600,30
TIKI,nha-sach-tiki,186578985,"Hãy Yêu Đời Dẫu Đời Có Trái Ngang -Tặng kèm 01 Bookmark",64000,89000,25000,28
TIKI,nha-sach-tiki,63516905,"Boxset 4 Cuốn: Cá Voi Đêm Bão Và Những Câu Chuyện Khác…",170000,200000,30000,15
TIKI,nha-sach-tiki,966503,"Tuần Của Bé - Bé Lắng Nghe",22000,23000,1000,4
TIKI,nha-sach-tiki,186880675,"Thế Chiến Thứ Hai",524000,699000,175000,25
TIKI,nha-sach-tiki,18002162,"Sách Thiếu Nhi - Truyện Tranh Mây Trắng và hành trình giải cứu Trái đất ",32000,32000,0,0
TIKI,nha-sach-tiki,186267247,"Shaman King 11",31500,35000,3500,10
TIKI,nha-sach-tiki,16391543,"Cha Voi - Dạy Con Nên Người Ở Thời Đại Số",97400,150000,52600,35
TIKI,nha-sach-tiki,83757985,"Cao Thủ “Đổi Đen Thay Trắng” - Tập 2 (Dành Cho 18+)",112000,149000,37000,25
TIKI,nha-sach-tiki,164273180,"Dệt Nên Sự Sống: Khám Phá Bí Mật Cứu Tinh Của Thế Giới Tự Nhiên",65400,119000,53600,45
TIKI,nha-sach-tiki,716891,"Mom's Letters: Alphabet",17000,18000,1000,6
TIKI,nha-sach-tiki,8306438,"Combo Lược Sử Thời Gian và Vũ Trụ Trong Vỏ Hạt Dẻ",193969,206350,12381,6
TIKI,nha-sach-tiki,16284262,"Tuổi Thơ Dữ Dội - Tập 2 (Tái Bản 2019)",60800,80000,19200,24
TIKI,nha-sach-tiki,93249305,"Tư Duy Nhanh Và Chậm (Bản mới nhất 2020)",200000,269000,69000,26
TIKI,nha-sach-tiki,196853079,"Búp Bê - Pháp Y Tần Minh",159000,189000,30000,16
TIKI,nha-sach-tiki,108261354,"Tự Học Ngữ pháp Tiếng Anh Bằng Mindmap Tập 1",112000,145000,33000,23
TIKI,nha-sach-tiki,75615221,"Combo 3 Cuốn Sách Ehon: Ai Giấu Cái Gì Đó (Dành Cho Trẻ Từ 0 - 4 Tuổi)",84900,117000,32100,27
TIKI,nha-sach-tiki,2782635,"Nghệ Thuật Quản Lý Tài Chính Cá Nhân",103000,159000,56000,35
TIKI,nha-sach-tiki,57708766,"Kẻ trừng phạt (Tái Bản 2020)",125000,125000,0,0
TIKI,nha-sach-tiki,76181976,"Hậu Vận Rất Đắt Xin Đừng Lãng Phí",90200,129000,38800,30
TIKI,nha-sach-tiki,196201375,"Sách - Bình Yên Trong Bão Tố",205000,213750,8750,4
TIKI,nha-sach-tiki,173093879,"Liễu Phàm Tứ Huấn - Tích Tập Phúc Đức, Cải Tạo Vận Mênh (Tái Bản 2022)",44200,59000,14800,25
TIKI,nha-sach-tiki,62373311,"Nồi Niêu Xoong Chảo - Sổ Tay Bếp Núc Của Tôi (Sách Màu)",89900,120000,30100,25
TIKI,nha-sach-tiki,105614631,"Kéo mini tiện lợi 105mm Deli - 5 màu Đen/ Xanh/ Hồng/ Trắng - Dành cho văn phòng, học sinh, sắc bén - 6072",29000,52200,23200,44
TIKI,nha-sach-tiki,91625816,"Trên Đỉnh Phố Wall (Tái bản 2021)",132000,219000,87000,40
TIKI,nha-sach-tiki,192333857,"Ông già và biển cả",130000,200000,70000,35
TIKI,nha-sach-tiki,2583037,"Series Địch Công Kỳ Án: Ngự Châu Án",44000,99000,55000,56
TIKI,nha-sach-tiki,11475738,"Combo 2 Cuốn: Kế Toán Tài Chính (Tập 1 & 2)",560000,750000,190000,25
TIKI,nha-sach-tiki,43665704,"Combo Chiến thắng kì thi 9 vào 10 chuyên môn Vật Lí( Tập 1 - Tập 2)",214800,358000,143200,40
TIKI,nha-sach-tiki,170352757,"Người Sống Cũng Phải Hồi Sinh",96000,129000,33000,26
TIKI,nha-sach-tiki,73176340,"Combo 10 cuốn Truyện Ngụ ngôn Aesop Song ngữ - Truyện kể mầm non (giao ngẫu nhiên)",60000,120000,60000,50
TIKI,nha-sach-tiki,53974339,"Combo 3 Cuốn Di Sản Của GS. Phan Văn Trường Để Lại Cho Thế Hệ Sau: Một Đời Thương Thuyết + Một Đời Quản Trị + Một Đời Như Kẻ Tìm Đường (Cả Đời Trên Thương Trường)",423300,510000,86700,17
TIKI,nha-sach-tiki,44911496,"Little Stories - The Best Book For Your Leisure Time",42200,65000,22800,35
TIKI,nha-sach-tiki,52805069,"Những Vị Thần Bắc Âu",123000,175000,52000,30
TIKI,nha-sach-tiki,66398385,"Hành Trình Sinh Tử",81700,109000,27300,25
TIKI,nha-sach-tiki,173718231,"Combo 2 Cuốn Luyện viết Lớp 1 - Chương trình SGK Cánh diều",31000,60000,29000,48
TIKI,nha-sach-tiki,191571444,"Anh Em Phi Hành Gia - Tập 30",41000,45000,4000,9
TIKI,nha-sach-tiki,189940682,"Hãy Sống Cuộc Đời Như Bạn Muốn  (Tái bản)",74200,99000,24800,25
TIKI,nha-sach-tiki,27639410,"Toán Song Ngữ Tiền Tiểu Học - Sách Học 3",28900,36000,7100,20
TIKI,nha-sach-tiki,193895765,"Lập Kế Hoạch Công Việc chu Trình PDCA (Tái Bản)",109000,149000,40000,27
TIKI,nha-sach-tiki,31993279,"4000 Từ Vựng Tiếng Anh Thường Dùng Nhất (Kèm CD Hoặc File MP3)",196000,248000,52000,21
TIKI,nha-sach-tiki,1205103,"Free Marketing  –  101 Ý Tưởng Phát Triển Doanh Nghiệp Với Chi Phí Thấp (Tái Bản 2017)",149000,199000,50000,25
TIKI,nha-sach-tiki,27639420,"Toán Song Ngữ Tiền Tiểu Học - Sách Học 2",32300,36000,3700,10
TIKI,nha-sach-tiki,176132390,"Truyện Thiếu Nhi Hạt Giống Tâm Hồn - Lễ Tạ Ơn",41900,56000,14100,25
TIKI,nha-sach-tiki,90480255,"Sách - Lão Tử Đạo Đức kinh - Nguyễn Hiến Lê ( Tuyển Tập Bách Gia Tranh Minh)",103000,159000,56000,35
TIKI,nha-sach-tiki,194959710,"Đâu Chỉ Độc Mình Tôi Đơn Độc",69900,88000,18100,21
TIKI,nha-sach-tiki,53789573,"Bến Xe (Tái Bản 2020)",50800,76000,25200,33
TIKI,nha-sach-tiki,34750208,"Ngụ Ngôn Song Ngữ Anh - Việt: Con Quạ Thông Minh (Tái Bản 2019)",13000,14000,1000,7
TIKI,nha-sach-tiki,5743619,"Học Tiếng Anh Siêu Thú Vị : Sách Luyện - Tập 2",19100,24000,4900,20
TIKI,nha-sach-tiki,185415267,"Bút gel B màu Pastel Thiên Long Flexoffice Pazto FO-GELB039/VN - Mực xanh (5 cây)",39000,50000,11000,22
TIKI,nha-sach-tiki,186262546,"BILLY SUMMERS – VỤ ÁM SÁT CUỐI CÙNG",194000,299000,105000,35
TIKI,nha-sach-tiki,4219547,"Người đàn ông đánh bại mọi thị trường - A man for all markets",349000,349000,0,0
TIKI,nha-sach-tiki,1750249,"Phân Tích Chứng Khoán",300000,499000,199000,40
TIKI,nha-sach-tiki,186094200,"Trò chơi Trứng Phục Sinh -Tập 2 - Bản Thường (Tặng kèm 1 Art print + 1 Bookmark)",93100,186000,92900,50
TIKI,nha-sach-tiki,187503389,"Thiên Thần Diệt Thế - Seraph Of The End - Tập 24",21000,22000,1000,5
TIKI,nha-sach-tiki,13362558,"Làm sạch tâm hồn - Các bài tập thiền",51700,69000,17300,25
TIKI,nha-sach-tiki,136939563,"Ho’Oopnopono: Phục Hồi Tự Nhiên, Chữa Lành Cuộc Sống, Hoàn Thiện Cuộc Đời",42800,66000,23200,35
TIKI,nha-sach-tiki,170298048,"Dịch Bệnh Atlantis",154000,195000,41000,21
TIKI,nha-sach-tiki,165089915,"7 Câu Hỏi "Thần Kỳ" Của Mọi Sếp Giỏi (Tái bản)",101000,150000,49000,33
TIKI,nha-sach-tiki,89222118,"Sổ Vẽ Phác Thảo Deli 40 Trang - Gáy Lò Xo - Khổ Ngang A4/B5 - Giấy Định Lượng 100Gsm / 110Gsm - 7696 / 7697 / 73632",32000,57600,25600,44
TIKI,nha-sach-tiki,190708160,"Nhất Quỷ Nhì Ma, Thứ Ba Takagi Tập 14 [Tặng Kèm Postcard]",28700,30000,1300,4
TIKI,nha-sach-tiki,27957156,"Ehon Thông Minh Cho Trẻ Mẫu Giáo : Xếp Hàng Làm Gì Thế?",40900,52000,11100,21
TIKI,nha-sach-tiki,169621651,"Nam Đình Cốc Vi - Tập 6",92600,109000,16400,15
TIKI,nha-sach-tiki,19963125,"Thiên Tài Bên Trái, Kẻ Điên Bên Phải",141410,179000,37590,21
TIKI,nha-sach-tiki,860415,"Cổ Tích Việt Nam - Sự Tích Đầm Mực - Legend Of The Ink Pond (Song Ngữ Anh - Việt)",15000,16000,1000,6
TIKI,nha-sach-tiki,34340291,"Não Bộ Kể Gì Về Bạn",111000,149000,38000,26
TIKI,nha-sach-tiki,129381392,"Cuốn Sách Tranh Đầu Tiên Về Quốc Kỳ (Ehon Nhật Bản)",74200,99000,24800,25
TIKI,nha-sach-tiki,53486723,"Vô Cùng Tàn Nhẫn Vô Cùng Yêu Thương 3 - Phương Pháp Dạy Con Của Một Người Cha Do Thái",89000,129000,40000,31
TIKI,nha-sach-tiki,105614601,"Cặp đựng tài liệu A4 Deli - 8 ngăn phân trang - file lưu trữ tài liệu - linfini - Xanh Dương / Trắng - 72456",47000,88200,41200,47
TIKI,nha-sach-tiki,3283713,"Phong Thủy Cho Người Mua Nhà Chung Cư",399000,399000,0,0
TIKI,nha-sach-tiki,167019786,"Cơ Thể Tự Chữa Lành - Thanh Lọc Để Phục Hồi",212400,295000,82600,28
TIKI,nha-sach-tiki,44044693,"Anh Là Ai Tôi Là Ai",73600,109000,35400,32
TIKI,nha-sach-tiki,730678,"Tuần Của Bé Tháng 7 - Bé Hòa Đồng",22000,23000,1000,4
TIKI,nha-sach-tiki,73553837,"Ngọc Sáng Trong Hoa Sen (Tái Bản 2020)",88400,128000,39600,31
TIKI,nha-sach-tiki,11954630,"Combo Quản Lý Nghiệp (Tái Bản) + Năng Đoạn Kim Cương (Tái Bản 2018)",166400,208000,41600,20
TIKI,nha-sach-tiki,20104310,"Hệ thống bán hàng đỉnh cao - The Snowball System",328000,328000,0,0
TIKI,nha-sach-tiki,44858499,"Dạy Con Theo Phương Pháp Montessori - Dậy Nào Bé Ơi",13000,13600,600,4
TIKI,nha-sach-tiki,174449880,"Một Nghiên Cứu Về Giác Tính Con Người 
 (An Enquiry Concerning Human Understanding)",114000,145000,31000,21
TIKI,nha-sach-tiki,67835582,"Chiến Quốc Tung Hoành - Thế Cục Quỷ Cốc Tử: Tập 10",141000,195000,54000,28
TIKI,nha-sach-tiki,157412117,"Chưa Kịp Lớn Đã Phải Trưởng Thành",62000,79000,17000,22
TIKI,nha-sach-tiki,48212494,"How To Crack The IELTS Speaking Test - Part 1 (Tái Bản)",222000,299000,77000,26
TIKI,nha-sach-tiki,171549938,"Quy Tắc Làm Việc Của Google (Tái Bản)",164000,219000,55000,25
TIKI,nha-sach-tiki,193109498,"Hung Hiểm ",235000,280000,45000,16
TIKI,nha-sach-tiki,48629535,"Ngày Xưa Có Một Chuyện Tình (Tái Bản)",99900,125000,25100,20
TIKI,nha-sach-tiki,176144899,"Sổ tay bìa Da PU A5 ghi chép 360 trang mẫu hươu sang trọng Tặng kèm bút viết",65990,65990,0,0
TIKI,nha-sach-tiki,170706992,"Thám Tử Lừng Danh Conan: Hồ Sơ Tuyệt Mật - Shuichi Akai & Toru Amuro",115000,120000,5000,4
TIKI,nha-sach-tiki,85258271,"Bút Gel xóa được Mondee Thiên Long TP-GELE003",11000,14000,3000,21
TIKI,nha-sach-tiki,75696174,"Vẫy Vùng Giữa Vũng Lầy",140000,140000,0,0
TIKI,nha-sach-tiki,50322156,"Thấu Hiểu Tiếp Thị Từ A Đến Z - 80 Khái Niệm Nhà Quản Lý Cần Biết (Tái Bản 2020)",91900,115000,23100,20
TIKI,nha-sach-tiki,100395623,"Bước Đi Ngẫu Nhiên Trên Phố Wall (Tái Bản)",185000,249000,64000,26
TIKI,nha-sach-tiki,1475793,"Little Stories - To Make You A Good Person",42200,65000,22800,35
TIKI,nha-sach-tiki,190601856,"Tâm",69300,89000,19700,22
TIKI,nha-sach-tiki,73553846,"Sức Mạnh Niềm Tin (Tái Bản 2020)",61700,88000,26300,30
TIKI,nha-sach-tiki,68586415,"Cao Thủ Đổi Đen Thay Trắng - Tập 1 (Dành Cho Lứa Tuổi 18+)",112000,149000,37000,25
TIKI,nha-sach-tiki,2245453,"Đúng Việc (Tái Bản)",98750,125000,26250,21
TIKI,nha-sach-tiki,165030720,"Miko! Tất Tần Tật - Best Selection",22600,25000,2400,10
TIKI,nha-sach-tiki,83680361,"ISMS - Hiểu Về Nghệ Thuật Hiện Đại",177000,239000,62000,26
TIKI,nha-sach-tiki,4687535,"Series Thám Tử Kỳ Phát: Kỳ Phát Giết Người",44000,107000,63000,59
TIKI,nha-sach-tiki,2449681,"Sách Tương Tác - Big Book - Cuốn Sách Khổng Lồ Về Các Ngôi Sao Và Các Hành Tinh (Tái Bản)",118000,168000,50000,30
TIKI,nha-sach-tiki,59207573,"Luyện Viết Chữ Nhớ Từ Vựng Tiếng Anh Theo Chương Trình Sách Giáo Khoa Lớp 5 – Tập 2",24600,35000,10400,30
TIKI,nha-sach-tiki,192339908,"Cuộc Nổi Dậy Của Cô Nàng Mọt Sách - Phần 1 : Con Gái Của Người Lính II",99000,165000,66000,40
TIKI,nha-sach-tiki,15634598,"Who? Chuyện Kể Về Danh Nhân Thế Giới: Coco Chanel (Tái Bản 2019)",44900,55000,10100,18
TIKI,nha-sach-tiki,174037877,"Điểm Dối Lừa ( Tái Bản)",133000,205000,72000,35
TIKI,nha-sach-tiki,171549998,"Never Get Bored - Tí Ta Tí Toáy Ngoài Trời",124000,155000,31000,20
TIKI,nha-sach-tiki,53772001,"Bên Lề Sách Cũ - Bìa Cứng (Tái Bản 2020)",103000,130000,27000,21
TIKI,nha-sach-tiki,184779719,"Bách Khoa Cho Trẻ Em – Bách Khoa Khủng Long",131000,180000,49000,27
TIKI,nha-sach-tiki,273119803,"Cha Con Giáo Hoàng (Mario Puzo)",87800,135000,47200,35
TIKI,nha-sach-tiki,167685123,"Sách Vượt Bẫy Cảm Xúc",118000,188000,70000,37
TIKI,nha-sach-tiki,73686632,"Combo 14 Truyện Ngụ ngôn Aesop - Truyện kể mầm non - Truyện cổ tích (Giao ngẫu nhiên)",80000,160000,80000,50
TIKI,nha-sach-tiki,109960224,"Sách Dạy Con Học Nói Tập 1 (Tái Bản)",239000,299000,60000,20
TIKI,nha-sach-tiki,531109,"i-Learn Smart Start Grade 3 Student's Book (Phiên Bản Dành Cho Các Tỉnh)",106700,110000,3300,3
TIKI,nha-sach-tiki,74217673,"Gi Gỉ Gì Gi, Cái Gì Cũng Biết - Dành Cho Lớp 3",91700,119000,27300,23
TIKI,nha-sach-tiki,136540009,"Toàn Thư Tâm Lý Học (Tặng Kèm Bookmark)",90600,126000,35400,28
TIKI,nha-sach-tiki,719930,"Mom's Letters: Family",17000,18000,1000,6
TIKI,nha-sach-tiki,13527009,"Thúc Đẩy Giao Tiếp - 300 Trò Chơi Và Các Hoạt Động Cho Trẻ Tự Kỷ",61100,79000,17900,23
TIKI,nha-sach-tiki,196054990,"Đông Dương: Một Nền Thuộc Địa Nhập Nhằng, Giai Đoạn 1858 - 1954",329000,439000,110000,25
TIKI,nha-sach-tiki,78975579,"Bí Mật Một Tâm Hồn Cuốn Hút (Tái Bản Lại Từ Cuốn: Để Có 1 Tâm Hồn Đẹp)",67100,96000,28900,30
TIKI,nha-sach-tiki,21049645,"Xấp 10 Bìa lá A4 Plus dày ",20000,21000,1000,5
TIKI,nha-sach-tiki,2583035,"Bé Chu Đáo",22000,23000,1000,4
TIKI,nha-sach-tiki,15686499,"Nghệ Thuật Quyến Rũ (Tái Bản 2019)",172000,215000,43000,20
TIKI,nha-sach-tiki,1029750,"Tuần Của Bé - Bé Thanh Lịch (Dành Cho Trẻ 3 - 6 Tuổi)",11000,11500,500,4
TIKI,nha-sach-tiki,39521136,"Để Hiệu Quả Trong Công Việc (Tái Bản 2019)",35700,52000,16300,31
TIKI,nha-sach-tiki,136684902,"Combo 3 sách luyện thi B1 Vstep: Luyện thi B1 Vstep 4 kỹ năng + 30 đề thi viết luận tiếng Anh B1, B2 Vstep + 10 bộ đề thi Đọc hiểu Vstep B1-B2-C1 ôn thi chứng chỉ ngoại ngữ bậc 3 Vstep writing, reading, speaking, listening",653000,800000,147000,18
TIKI,nha-sach-tiki,182551495,"Black Jack 10 (Bìa Cứng)",74000,135000,61000,45
TIKI,nha-sach-tiki,161426354,"Netflix - Phá Bỏ Nguyên Tắc Để Bứt Phá",129000,198000,69000,35
TIKI,nha-sach-tiki,2601231,"Sài Côn Cố Sự",21000,120000,99000,83
TIKI,nha-sach-tiki,176824195,"Cách Quản Trị Của Amazon (Working Backwards: Insights, Stories, And Secrets From Inside Amazon)",132000,205000,73000,36
TIKI,nha-sach-tiki,142791683,"Sourdough Bread - Bánh Mì Men Tự Nhiên",129000,179000,50000,28
TIKI,nha-sach-tiki,184081012,"Sách tham khảo Vật Lí 10 - Biên soạn theo chương trình GDPT mới",95000,95000,0,0
TIKI,nha-sach-tiki,181131175,"Combo 4 Cuốn Đề Ôn Luyện Và Tự Kiểm Tra Toán + Tiếng Việt Lớp 1",110000,156000,46000,29
TIKI,nha-sach-tiki,595480,"Sherlock Holmes – Tập 3",82700,115000,32300,28
TIKI,nha-sach-tiki,150838230,"Everybody Writes - Ai Rồi Cũng Viết (Cuốn Cẩm Nang Giúp Bạn Viết Content “Chất Như Nước Cất”)",125000,179000,54000,30
TIKI,nha-sach-tiki,190605360,"Người Bà Tài Giỏi Vùng Saga – Tập 1 (Tái Bản)",44100,52000,7900,15
TIKI,nha-sach-tiki,48659055,"Cuộc Sống "Đếch" Giống Cuộc Đời",59900,90000,30100,33
TIKI,nha-sach-tiki,181997205,"Nhập môn thuật toán",215000,215000,0,0
TIKI,nha-sach-tiki,184790643,"Nền kinh Tế Trải Nghiệm",224000,299000,75000,25
TIKI,nha-sach-tiki,188551111,"Tiệm Trừ Yêu Kì Ảo - Tập 15",33500,35000,1500,4
TIKI,nha-sach-tiki,28285288,"Little Stories - To Change Your Life",42200,65000,22800,35
TIKI,nha-sach-tiki,58444919,"Lời Nguyện Cầu Chernobyl (Biên Niên Sử Của Tương Lai)",128000,170000,42000,25
TIKI,nha-sach-tiki,112331969,"Quiz! Khoa Học Kì Thú: Thực Phẩm Dinh Dưỡng",57700,75000,17300,23
TIKI,nha-sach-tiki,118124353,"Thức Tỉnh Điều Vô Hình (Hành Trình Khám Phá Tâm Linh)",96700,138000,41300,30
TIKI,nha-sach-tiki,184633072,"Tư Trị Thông Giám - Tập 8",229000,286000,57000,20
TIKI,nha-sach-tiki,9688926,"Phát Triển Tư Duy Đột Phá Giải Bài Tập Tài Liệu Dạy - Học Vật Lí Lớp 8",77000,134000,57000,43
TIKI,nha-sach-tiki,167148807,"Tâm Lý Học Nói Gì Về Ấn Tượng Ban Đầu",62900,126000,63100,50
TIKI,nha-sach-tiki,1028645,"Như Mây Thong Dong",57900,90000,32100,36
TIKI,nha-sach-tiki,186265470,"Theo Dấu Chân Bác Hồ",58900,65000,6100,9
TIKI,nha-sach-tiki,76776247,"Hà Nội Bảo Thế Là Thường (Bìa Mềm)(Tản Văn)",91700,108000,16300,15
TIKI,nha-sach-tiki,138342170,"Sức Mạnh Của Sự Tử Tế (Tái bản năm 2020)",88000,104000,16000,15
TIKI,nha-sach-tiki,485326,"Những Cuộc Phiêu Lưu Của Sherlock Holmes",56000,79000,23000,29
TIKI,nha-sach-tiki,462169,"Đồng Hồ Angrybirds Năng Động",30000,30000,0,0
TIKI,nha-sach-tiki,34749958,"Ngụ Ngôn Song Ngữ Anh - Việt: Cừu Non Nhanh Trí (Tái Bản 2019)",13000,28000,15000,54
TIKI,nha-sach-tiki,116397383,"Omoiyari - Nghệ Thuật Đối Nhân Xử Thế Của Người Nhật",96500,142000,45500,32
TIKI,nha-sach-tiki,1689505,"Đồng Thoại Song Ngữ Anh - Việt: Nhím Con Muốn Lông Mình Suôn Mượt",27000,28000,1000,4
TIKI,nha-sach-tiki,190194623,"Không Phải Sói Nhưng Cũng Đừng Là Cừu",101120,128000,26880,21
TIKI,nha-sach-tiki,22099041,"KẸP BẤM 1 LỖ KIM LOẠI",32000,32000,0,0
TIKI,nha-sach-tiki,1534615,"Giáo Trình Chuẩn HSK 5 Bài Tập (Tập 1)",141000,188000,47000,25
TIKI,nha-sach-tiki,58963727,"Viết Chì Bấm Tombow Ngòi 0.5mm DPA-136 - Màu",75000,88200,13200,15
TIKI,nha-sach-tiki,184594032,"Không gia đình (Tái bản)",119250,159000,39750,25
TIKI,nha-sach-tiki,98355902,"Gọt Bút Chì Điện Tự Động Deli - 1 Chiếc - 502",149000,268200,119200,44
TIKI,nha-sach-tiki,3136211,"Bắt Đầu Với Câu Hỏi Tại Sao? ( Tái Bản )",99501,99501,0,0
TIKI,nha-sach-tiki,157169477,"Hộp Đựng Bút Viết Đa Năng Grepaco Bằng Vải Bố Canvas Tote Đẹp Nhiều Ngăn Dạng Túi Đựng Dụng Cụ Đồ Dùng Học Tập, Phụ Kiện Học Sinh, Sinh Viên, Đồ Cá Nhân Văn Phòng – Hàng Chính Hãng",49000,49000,0,0
TIKI,nha-sach-tiki,77111961,"Bộ 5 thiệp vuông 12cm SDstationery LIVE GREEN sinh nhật, tình bạn, tình yêu, chúc mừng, truyền cảm hứng",54000,135000,81000,60
TIKI,nha-sach-tiki,192583632,"Lốc 10 Vở (Tập) Ô ly Siêu nhí Cao cấp 80 trang (4 ô ly - Giao mẫu ngẫu nhiên)",91000,127000,36000,28
TIKI,nha-sach-tiki,2583031,"Bé Thông Thái",22000,23000,1000,4
TIKI,nha-sach-tiki,46332534,"Sherlock Holmes Toàn Tập (3 Tập - Hộp Đứng) (Bìa Mềm)(Tái Bản)",394000,495000,101000,20
TIKI,nha-sach-tiki,51348621,"Bỉ Vỏ (Tái Bản)",36400,50000,13600,27
TIKI,nha-sach-tiki,56094203,"Heidi (Bìa Cứng)",210000,280000,70000,25
TIKI,nha-sach-tiki,184476623,"Bút dạ quang màu Pastel Thiên Long Flexoffice Pazto FO-HL009/VN - Bút dạ quang rửa được - Không để lại vết khi Photocopy",11000,13000,2000,15
TIKI,nha-sach-tiki,170094970,"Bách Khoa Lịch Sử Thế Giới - Tái Bản",429000,550000,121000,22
TIKI,nha-sach-tiki,49747011,"Nghĩ Từ Trái Tim (Tái Bản 2020)",40000,50000,10000,20
TIKI,nha-sach-tiki,192692429,"Thức Tỉnh",69500,139000,69500,50
TIKI,nha-sach-tiki,182541449,"Billy Summers - Vụ Ám Sát Cuối Cùng",209000,299000,90000,30
TIKI,nha-sach-tiki,87569364,"Bộ Dụng Cụ Vẽ Phác Thảo 27 Phụ Kiện Deli - Vẽ Mỹ Thuật - 1 Bộ - 58125",165000,297000,132000,44
TIKI,nha-sach-tiki,189161030,"Điều Thuộc Về Em",99300,138000,38700,28
TIKI,nha-sach-tiki,62686754,"Thanh Gươm Diệt Quỷ Tập 14: Mu Trong Muichiro",23600,25000,1400,6
TIKI,nha-sach-tiki,50246190,"Life A1 - A2 : Student Book with Web App Code with Online Workbook (British English) (Viet Nam Edition) (Second Edition)",225000,250000,25000,10
TIKI,nha-sach-tiki,177312713,"Tâm Lý Học Thấu Hiểu Bản Thân",85600,119000,33400,28
TIKI,nha-sach-tiki,100285591,"Bảng Tóm Tắt Toán Tiểu Học",6000,7000,1000,14
TIKI,nha-sach-tiki,192398103,"Cấu Trúc Dữ Liệu Và Thuật Toán - Nguyễn Đức Nghĩa (Xuất bản lần thứ năm - năm 2023)",127800,142000,14200,10
TIKI,nha-sach-tiki,111059103,"Bút dạ kính 2 đầu Deli - không xóa được, mực vĩnh cửu - Mực Đen/Xanh/Đỏ - 1 cây - EU10420 / EU10430 / EU10440",9000,16200,7200,44
TIKI,nha-sach-tiki,186575354,"Siddhartha",102000,120000,18000,15
TIKI,nha-sach-tiki,104935828,"Truyện Ngắn Nguyễn Huy Thiệp (Bìa Cứng) - Ấn Bản Kỷ Niệm 70 Năm Ngày Sinh Tác Giả - Với Minh Họa Của Các Họa Sĩ (Tái Bản - Bìa Xanh)",293000,450000,157000,35
TIKI,nha-sach-tiki,10392851,"Tôi Thấy Hoa Vàng Trên Cỏ Xanh",113000,150000,37000,25
TIKI,nha-sach-tiki,170298038,"Harvard Bốn Rưỡi Sáng",110000,139000,29000,21
TIKI,nha-sach-tiki,91343901,"Huyễn Tưởng Về Trí Tuệ Nhân Tạo",135000,169000,34000,20
TIKI,nha-sach-tiki,167019723,"TalMud - Tinh Hoa Trí Tuệ Do Thái (Tái Bản)",91300,110000,18700,17
TIKI,nha-sach-tiki,94383325,"Người Bà Tài Giỏi Vùng Saga - Tập 3",40700,52000,11300,22
TIKI,nha-sach-tiki,13105198,"Combo Kĩ Năng Giao Tiếp - Dành Cho Bé 2-6 Tuổi (Trọn Bộ 10 cuốn)",106000,150000,44000,29
TIKI,nha-sach-tiki,131497044,"Sách 33 Bài Thực Hành Giúp Phát Triển Não Bộ Cho Trẻ Theo Phương Pháp Shichida",82700,118000,35300,30
TIKI,nha-sach-tiki,58063000,"Sông - Nguyễn Ngọc Tư (Tiểu Thuyết)(Tái Bản)",81100,99000,17900,18
TIKI,nha-sach-tiki,77105728,"Có Thanh Xuân Nào Không Đau Đớn, Có Tuổi Trẻ Nào Không Bão Giông",103000,129000,26000,20
TIKI,nha-sach-tiki,186290791,"Cô gái đến từ hôm qua (Tái Bản 2022)",68000,85000,17000,20
TIKI,nha-sach-tiki,156968646,"Thiệp chúc mừng sinh nhật 12x12 SDstationery CLASSY BLUE họa tiết bong bóng, nến, màu xanh đơn giản tinh tế",54000,64800,10800,17
TIKI,nha-sach-tiki,43341584,"Tiểu Thuyết Trinh Thám 1/14 - Tập 5 - 14 Ngày Kinh Hoàng (Tái Bản)",84000,168000,84000,50
TIKI,nha-sach-tiki,167034122,"Spotify Và Những Chuyện Chưa Kể  - Hành Trình Đánh Bại Apple, Google Và Amazon Trong Cuộc Đua Âm Thanh Số Của Nhà Sáng Lập Daniel Ek",126000,175000,49000,28
TIKI,nha-sach-tiki,2430427,"Thùng 5 Ream Giấy In Photo A4 Excel DL 80gsm",315000,315000,0,0
TIKI,nha-sach-tiki,16564276,"TNT TOEIC - Intensive (Third Edition) (Kèm file MP3)",163000,298000,135000,45
TIKI,nha-sach-tiki,191782133,"Không Phải Huyền Thoại - Tiểu Thuyết Lịch Sử Đầu Tiên Về Đại Tướng Võ Nguyên Giáp Trong Chiến Dịch Điện Biên Phủ",192000,255000,63000,25
TIKI,nha-sach-tiki,31375305,"Sống Lành Để Trẻ",63200,85000,21800,26
TIKI,nha-sach-tiki,88979638,"Sổ tay ghi chép A5 gáy xoắn 60 trang Deli - Kẻ ngang - Màu ngẫu nhiên - LA560-01",21000,37800,16800,44
TIKI,nha-sach-tiki,156821160,"Tổng Quan Về Tarot (Bìa Cứng)",217000,350000,133000,38
TIKI,nha-sach-tiki,120460868,"Thay Đổi Câu Hỏi Thay Đổi Cuộc Đời (Tái bản 2021 có bổ sung)",44000,63000,19000,30
TIKI,nha-sach-tiki,273643617,"Trạm Đọc Official | Sách: Quốc Gia Khởi Nghiệp",156000,209000,53000,25
TIKI,nha-sach-tiki,185055215,"Kinh Doanh Nhỏ Thu Lợi Lớn (Tái Bản 2022)",74000,99000,25000,25
TIKI,nha-sach-tiki,47339151,"Sống Xanh Như Những Lá Trà",76200,109000,32800,30
TIKI,nha-sach-tiki,155106681,"Rung Cảm Đầu Đời (Thơ - Sách Màu",74200,99000,24800,25
TIKI,nha-sach-tiki,43341578,"Tiểu Thuyết Trinh Thám 1/14 - Tập 3 - Lời Cảnh Báo (Tái Bản)",32000,114000,82000,72
TIKI,nha-sach-tiki,67477617,"Phát Triển Trí Tuệ Cảm Xúc- Sự Tử Tế Đẹp Như Bông Hoa",38900,50000,11100,22
TIKI,nha-sach-tiki,180396223,"Sách 7 Thói Quen Hiệu Quả (The 7 Habits Of Highly Effective People)- Tặng sổ tay",200000,250000,50000,20
TIKI,nha-sach-tiki,193897099,"Cuộc săn cừu hoang",108000,136000,28000,21
TIKI,nha-sach-tiki,179735870,"Ta Chỉ Gặp Nhau Vào Ban Đêm (Tặng Kèm 03 postcard (10x15 cm) + 01 bookmark)",79900,129000,49100,38
TIKI,nha-sach-tiki,107707548,"Nụ Hôn Dối Lừa (Bộ 2 Tập) - Biên Niên Sử Còn Sót Lại - Phần 1 (Tặng Kèm Bộ 2 Postcard)",165000,228000,63000,28
TIKI,nha-sach-tiki,145092099,"Thì Và Sự Phối Hợp Thì Trong Tiếng Anh",46900,70000,23100,33
TIKI,nha-sach-tiki,35473845,"Định Mệnh Chiến Tranh",184500,246000,61500,25
TIKI,nha-sach-tiki,25980689,"Complete IELTS B2 Student's Book with answer & CD-Rom",251100,279000,27900,10
TIKI,nha-sach-tiki,45299959,"Căn Bản Kỹ Thuật Nhiếp Ảnh",114000,135000,21000,16
TIKI,nha-sach-tiki,193701771,"Truyện Cổ Nhật Bản",156000,209000,53000,25
TIKI,nha-sach-tiki,94347317,"Câu Chuyện Cơ Thể Con Người: Tiến Hóa, Sức Khỏe Và Bệnh Tật",148000,195000,47000,24
TIKI,nha-sach-tiki,2612737,"Thùng 5 ram giấy A4 Double A 70gsm",425000,425000,0,0
TIKI,nha-sach-tiki,21130352,"Mùa Gặt Đỏ - Trinh Thám Cổ Điển Phương Tây",71000,102000,31000,30
TIKI,nha-sach-tiki,171549942,"Black Jack 08 (Bìa Cứng)",122000,135000,13000,10
TIKI,nha-sach-tiki,109982964,"Những Thăng Trầm Trong Cuộc Đời Và Sự Nghiệp Của Andersen",42100,60000,17900,30
TIKI,nha-sach-tiki,151597548,"American Jetstream Intermediate B Student's book & Workbook ( không kèm CD)",207000,207000,0,0
TIKI,nha-sach-tiki,159814614,"Đại Học Nghệ Thuật Tokyo",105000,149000,44000,30
TIKI,nha-sach-tiki,35761355,"Binh Pháp Tôn Tử Trong Kinh Doanh",82500,118000,35500,30
TIKI,nha-sach-tiki,137694341,"My First 1000 English Words - 1000 Từ Tiếng Anh Đầu Tiên Cho Bé (Bìa Cứng) (Tái Bản)",89900,120000,30100,25
TIKI,nha-sach-tiki,185854301,"Những bài đồng dao cho bé (Minh họa bằng tranh theo chủ đề - Dành cho bé tập nói, tập đọc)",35000,70000,35000,50
TIKI,nha-sach-tiki,193450582,"Metaverse Handbook",105000,209000,104000,50
TIKI,nha-sach-tiki,730580,"Tuần Của Bé Tháng 7 - Bé Đảm Đang",22000,23000,1000,4
TIKI,nha-sach-tiki,2469667,"Dạy Con Theo Phương Pháp Montessori - Tớ Là Bạn Tốt",13000,13600,600,4
TIKI,nha-sach-tiki,31219037,"Làm Chủ Tuổi 20 (Phiên bản mới) - Dành cho độc giả từ 16-30",198000,198000,0,0
TIKI,nha-sach-tiki,13853115,"Chiến Lược Mở Rộng Kinh Doanh Từ Cốt Lõi",81300,109000,27700,25
TIKI,nha-sach-tiki,192339432,"Giao Tiếp Cơ Bản – Cẩm Nang Làm Chủ Mọi Cuộc Trò Chuyện",92400,129000,36600,28
TIKI,nha-sach-tiki,115768007,"Ruột bút bi cao cấp PARKER",129000,180000,51000,28
TIKI,nha-sach-tiki,188930496,"Những Chàng Trai Ở Lộc Phong Quán – Tập 3 (Tái Bản)",40700,48000,7300,15
TIKI,nha-sach-tiki,2583033,"Bé Trách Nhiệm",22000,23000,1000,4
TIKI,nha-sach-tiki,576300,"Hướng Dẫn Tự Lắp Ráp 100 Mạch Điện - Điện Tử",50000,50000,0,0
TIKI,nha-sach-tiki,186880522,"Bí Mật Tiền Bạc Của Giới Siêu Giàu",84100,108000,23900,22
TIKI,nha-sach-tiki,106365087,"Người Giải Mã Thị Trường Tài Chính - Cách Jim Simons Tiến Hành Cuộc Cách Mạng Định Lượng",217000,229000,12000,5
TIKI,nha-sach-tiki,165030731,"Vượt Qua Chuyện Sao Hỏa - Sao Kim",133000,160000,27000,17
TIKI,nha-sach-tiki,47161879,"Bách Khoa Toàn Thư Giáo Dục Và Phát Triển  Tâm Lý Tính Cách Trẻ 0 -6 Tuổi",80000,160000,80000,50
TIKI,nha-sach-tiki,23134440,"Hỷ Lạc Từ Tâm",93000,150000,57000,38
TIKI,nha-sach-tiki,186237327,"Livestream – Hướng dẫn chi tiết cách kiếm tiền từ livestream",138000,189000,51000,27
TIKI,nha-sach-tiki,145540463,"Combo 2 cuốn: Đường xưa mây trắng - Theo gót chân Bụt( Bìa Mềm) + Hành Trình Của Linh Hồn ( Bộ Sách Trò Chuyện Cùng Tâm Linh/ Tặng Kèm Bookmark)",349000,363350,14350,4
TIKI,nha-sach-tiki,2583027,"Bé Bao Dung",22000,23000,1000,4
TIKI,nha-sach-tiki,179952631,"Chiến Dịch Trị - Thiên 1972",224000,280000,56000,20
TIKI,nha-sach-tiki,32921595,"Sổ Tay Học Nhanh , Toàn Diện Kiến Thức Và Dạng Bài Hóa Học Lớp 8 - 9",43000,68000,25000,37
TIKI,nha-sach-tiki,381274,"Cẩm Nang Dưỡng Sinh Thông Kinh Lạc",223000,298000,75000,25
TIKI,nha-sach-tiki,186669701,"Danh Nhân Thế Giới: Lincoln (Tái Bản 2022)",27600,30000,2400,8
TIKI,nha-sach-tiki,80927136,"Hệ thống bài tập & câu hỏi trắc nghiệm nguyên lý kế toán ",20000,30000,10000,33
TIKI,nha-sach-tiki,10761049,"Gôm Bút Mực Mono Tombow ES-512A",46000,54000,8000,15
TIKI,nha-sach-tiki,191410859,"Trưởng Thành Sau Biến Cố",80600,130000,49400,38
TIKI,nha-sach-tiki,36996379,"Người Mẹ Tốt Hơn Là Người Thầy Tốt - Tập 2",128310,136500,8190,6
TIKI,nha-sach-tiki,8121460,"Giáo Trình Hán Ngữ 1 - Tập 1 - Quyển Thượng (Phiên Bản Mới)",87000,116000,29000,25
TIKI,nha-sach-tiki,177747013,"Giác Ngộ",92100,139000,46900,34
TIKI,nha-sach-tiki,185409456,"Bút Bi Nước Mực Gel Bấm Ngòi 0.5mm Deli - Thiết Kế Vỏ Trong Suốt Phù Hợp Văn Phòng Sinh Viên Học Sinh Ghi Chép Sổ Tay - A057B",9000,18000,9000,50
TIKI,nha-sach-tiki,56271593," Nắm Nhầm Một Bàn Tay, Tìm Được Người Như Ý",74300,99000,24700,25
TIKI,nha-sach-tiki,1995037,"21 Cách Học Tiếng Anh Du Kích - FuSuSu (Song ngữ)",142000,148000,6000,4
TIKI,nha-sach-tiki,5458537,"Tài Chính Doanh Nghiệp - Corporate Finance",650000,659000,9000,1
TIKI,nha-sach-tiki,182972777,"Rồng Đỏ",108000,135000,27000,20
TIKI,nha-sach-tiki,166525107,"Lịch Sử Đô Thị Hiện Đại",118000,169000,51000,30
TIKI,nha-sach-tiki,173156781,"Combo 2 Sách Thành thạo Tin học văn phòng: Thành thạo Hàm Excel phổ biến nhất + Thành thạo Soạn thảo văn bản Word - Mẹo xử lý lỗi Word Excel trong công việc -  tinhocmos",265000,308000,43000,14
TIKI,nha-sach-tiki,48035293,"Kỷ Luật Tự Giác Thói Quen Của Người Thành Công",103000,159000,56000,35
TIKI,nha-sach-tiki,175724209,"Những Triết Gia Vĩ Đại",72100,90000,17900,20
TIKI,nha-sach-tiki,169621664,"Anh Đừng Quyến Rũ Tôi - Tập 3",131000,169000,38000,22
TIKI,nha-sach-tiki,195845908,"EMPOWERED - Khai phóng tiềm năng nhân lực, sản phẩm công nghệ đột phá",239000,295000,56000,19
TIKI,nha-sach-tiki,197657395,"[PRE-ORDER] Tokyo Revengers - Tập 4 - Bản Thường",103500,115000,11500,10
TIKI,nha-sach-tiki,189938281,"Một Thư Viện Ở Paris",142000,148000,6000,4
TIKI,nha-sach-tiki,145499994,"Sách Quẳng Gánh Lo Đi Và Vui Sống (Khổ Nhỏ) (Tái Bản 2021)",47500,68000,20500,30
TIKI,nha-sach-tiki,77036504,"Trí Tuệ Xúc Cảm (Tái Bản 2021)",148500,199000,50500,25
TIKI,nha-sach-tiki,74953479,"Em Bé Hạnh Phúc: Nuôi Dạy Trẻ Tại Nhà Theo Phương Pháp Montessori",84600,110000,25400,23
TIKI,nha-sach-tiki,197878872,"[Bìa cứng có áo, in màu toàn bộ]  Người Bán Hạnh Phúc - Davide Calì - Marco Somà minh họa - Crabit Kidbooks",114000,119000,5000,4
TIKI,nha-sach-tiki,87726331,"Chết Vì Chứng Khoán",145000,199000,54000,27
TIKI,nha-sach-tiki,9734633,"Ngày đó có em",55000,55000,0,0
TIKI,nha-sach-tiki,159259017,"Ngày của người chết tập 1+ 2 - Đằng Bình - Truyện phiêu lưu viễn tưởng, mạt thế, kinh dị",330000,330000,0,0
TIKI,nha-sach-tiki,182541451,"Khế Ước Bán Dâu",118600,179000,60400,34
TIKI,nha-sach-tiki,110448030,"Chuyện Xảy Đến Trong Đêm",143000,179000,36000,20
TIKI,nha-sach-tiki,136941173,"Giải Mã Hành Vi Disc: Bạn Thuộc Kiểu Lãnh Đạo Nào Trong 8 Nhóm Hành Vi?",88800,148000,59200,40
TIKI,nha-sach-tiki,190565198,"Combo Bút lông màu Fiber Pen Thiên Long Colokit 40/56/76 màu rửa được an toàn sử dụng tô màu, vẽ tranh, calligraphy",105000,150000,45000,30
TIKI,nha-sach-tiki,48362492,"Sách Tương Tác Vừa Học Vừa Chơi - Khủng Long Kỳ Thú",60700,79000,18300,23
TIKI,nha-sach-tiki,343365,"Hành Trình Tình Yêu",89000,89000,0,0
TIKI,nha-sach-tiki,41754180,"Nghệ Thuật Bán Hàng Bằng Câu Chuyện (Tặng Bookmark dễ thương)",122200,188000,65800,35
TIKI,nha-sach-tiki,2099189,"Khéo Ăn Nói Sẽ Có Được Thiên Hạ (Bìa Cứng)",112500,150000,37500,25
TIKI,nha-sach-tiki,112053760,"Bồi dưỡng năng lực tự học Toán lớp 6 (Theo chương trình GDPT mới)",66000,66000,0,0
TIKI,nha-sach-tiki,192474344,"BỘ SÁCH KỶ LUẬT: Không Sợ Chậm Chỉ Sợ Dừng – Càng Kỷ Luật Càng Tự Do",190000,238000,48000,20
TIKI,nha-sach-tiki,170352966,"Trí Tuệ Gia Đình Từ Vị Tu Sĩ Bán Đi Chiếc Ferrari",91400,130000,38600,30
TIKI,nha-sach-tiki,17493916,"Luyện Nói Tiếng Trung Quốc Cấp Tốc Cho Người Bắt Đầu - Tập 1 (Kèm file MP3) (Tái Bản)",133000,168000,35000,21
TIKI,nha-sach-tiki,188930494,"Người Bà Tài Giỏi Vùng Saga – Tập 4",43100,52000,8900,17
TIKI,nha-sach-tiki,50475521,"Sách Đánh Thức Con Người Phi Thường Trong Bạn",115900,168000,52100,31
TIKI,nha-sach-tiki,56908132,"Đảo Giấu Vàng (Tái Bản 2020)",63400,100000,36600,37
TIKI,nha-sach-tiki,176906756,"Dẫu Hóa Linh Hồn Xin Hãy Ở Bên Tôi",84900,118000,33100,28
TIKI,nha-sach-tiki,8835539,"Vĩ Đại Do Lựa Chọn (Tái Bản)",106000,165000,59000,36
TIKI,nha-sach-tiki,52855109,"SÁCH KẾ HOẠCH DẠY TRẺ CHẬM NÓI - Tự Kỷ (Tái bản lần I - 2020)",229000,280000,51000,18
TIKI,nha-sach-tiki,109088709,"Hứa Với Con, Ba Nhé",126000,179000,53000,30
TIKI,nha-sach-tiki,34751487,"Ngụ Ngôn Song Ngữ Anh - Việt: Một Cuộc Thi Chạy (Tái Bản 2019)",18000,32000,14000,44
TIKI,nha-sach-tiki,1639671,"Ngay Bây Giờ Hoặc Không Bao Giờ (Tái Bản)",58800,79000,20200,26
TIKI,nha-sach-tiki,1352355,"Bộ Kỹ Năng Trong Sinh Hoạt I - Ăn Thế Nào Cho Đủ - How To Eat Healthy (Song Ngữ Việt - Anh)",28000,29000,1000,3
TIKI,nha-sach-tiki,270660740,"Combo Cẩm Nang Sinh Hoạt Bằng Tranh Cho Bé (4 tập)",116000,144000,28000,19
TIKI,nha-sach-tiki,1073276,"Combo Mê Cung Phát Triển Tư Duy (4 Cuốn)",238400,298000,59600,20
TIKI,nha-sach-tiki,58616751,"Nha Sĩ Yêu Quái (Tái Bản 2020)",68500,109000,40500,37
TIKI,nha-sach-tiki,966505,"Tuần Của Bé - Bé Sâu Sắc",22000,23000,1000,4
TIKI,nha-sach-tiki,966501,"Tuần Của Bé - Bé Quyết Đoán",22000,23000,1000,4
TIKI,nha-sach-tiki,161878354,"Combo 05 Cây Bút Lông Bảng FO-WB02 Và 01 Hộp Mực Lông Bảng FO-WBI02",70000,70000,0,0
TIKI,nha-sach-tiki,560425,"Lean In",286100,311000,24900,8
TIKI,nha-sach-tiki,137555857,"Bộ Đề Kiểm Tra Tiếng Anh 8 (Chương Trình Thí Điểm)",67000,86000,19000,22
TIKI,nha-sach-tiki,190857214,"Dinh Dưỡng Lành Mạnh - Ngại Gì Bệnh Tim",195000,259000,64000,25
TIKI,nha-sach-tiki,90624167,"Hạnh Phúc Tự Thân",89200,119000,29800,25
TIKI,nha-sach-tiki,87642541,"Combo Lấy Nước Đường Xa và  Chú Bé Mang Pyjama Sọc  ",150250,150250,0,0
TIKI,nha-sach-tiki,447497,"Phật Thuyết Đại Thừa Vô Lượng Thọ Trang Nghiêm Thanh Tịnh Bình Đẳng Giác Kinh (Quyển 1)",46000,48000,2000,4
TIKI,nha-sach-tiki,4439909,"Kĩ Năng Cho Bé Trong Giao Tiếp Hàng Ngày: Lời Chào Đi Trước (Tái Bản)",17000,17500,500,3
TIKI,nha-sach-tiki,89764009,"Bóng của cây sồi",93840,136000,42160,31
TIKI,nha-sach-tiki,4439903,"Kĩ Năng Cho Bé Trong Giao Tiếp Hàng Ngày: Biết Cảm Ơn Khi Nhận (Tái Bản)",17000,17500,500,3
TIKI,nha-sach-tiki,181379273,"Ngài Kẹo",48100,60000,11900,20
TIKI,nha-sach-tiki,186862153,"Danh Nhân Thế Giới: Napoleon (Tái Bản 2022)",27600,30000,2400,8
TIKI,nha-sach-tiki,1021663,"Thủy Hử (Trọn Bộ 2 Tập)",209000,320000,111000,35
TIKI,nha-sach-tiki,54120846,"Hannibal Trỗi Dậy",97700,138000,40300,29
TIKI,nha-sach-tiki,76048205,"Sách - Tip Công Sở 2 - Khả Năng Đặt Câu Hỏi - Hỏi sao cho đúng",66000,97000,31000,32
TIKI,nha-sach-tiki,95090938,"Bút chì màu chuyên nghiệp dạng cốc Deli 24/36/48 màu - 68123/68124/68125",59000,106200,47200,44
TIKI,nha-sach-tiki,510195,"Tiếng Gọi Nơi Hoang Dã (Khang Việt)",36000,72000,36000,50
TIKI,nha-sach-tiki,189076565,"Nhật ký Anne Frank (TB 2022)",65100,100000,34900,35
TIKI,nha-sach-tiki,34567948,"Combo Phát Triển IQ Cho Trẻ Em: Chữ Số Biến Ảo + Nhận Biết Thế Giới + Tư Duy LôGic + Rèn Luyện Trí Tuệ + Nhanh Tay Tinh Mắt + Trò Chơi Trí Tuệ (Bộ 6 Cuốn - Tặng Kèm Postcard Greenlife)",198350,198350,0,0
TIKI,nha-sach-tiki,88783858,"Màu Nước Dạng Tuýp 5Ml Deli - 12 Màu/18 Màu/24 Màu - 73859 / 73860 / 73861",48000,86400,38400,44
TIKI,nha-sach-tiki,57211761,"Nhóc Nicolas: Những chuyện chưa kể Tập 2 (Tái Bản 2020)",72200,85000,12800,15
TIKI,nha-sach-tiki,52665707,"Nghệ Thuật Kiếm Tiền Của Người Do Thái (Tái Bản 2020)",60200,90000,29800,33
TIKI,nha-sach-tiki,138934612,"Combo 4 Cuốn: Tô Màu Phát Triển Trí Não Bộ Cho Bé 1-5 Tuổi",54300,64000,9700,15
TIKI,nha-sach-tiki,138504802,"Kinh Doanh Giỏi Phải Kiếm Được Tiền",116000,159000,43000,27
TIKI,nha-sach-tiki,169621652,"Anh Đừng Quyến Rũ Tôi - Tập 2",131000,169000,38000,22
TIKI,nha-sach-tiki,128635778,"Thái Nhân Cách - Phía Sau Tội Ác (Khám Phá Bộ Não Của Những Kẻ Sát Nhân Máu Lạnh)",138000,189000,51000,27
TIKI,nha-sach-tiki,51251660,"Chữa Lành Ánh Sáng Bản Thể",143000,220000,77000,35
TIKI,nha-sach-tiki,95090623," Dao rọc giấy nhỏ Deli - Đỏ/Tím/Xanh lá/Xanh dương - 1 chiếc màu ngẫu nhiên - E2066",9000,16200,7200,44
TIKI,nha-sach-tiki,173732586,"423 Lời Vàng của Phật Kinh Pháp Cú Dhammapada (Tái bản)",33000,33000,0,0
TIKI,nha-sach-tiki,148802212,"Phong Ma Yến Tước Tập 1 - Nuối Tiếc Giang Hồ",170000,215000,45000,21
TIKI,nha-sach-tiki,53303190,"Perfect IELTS Vocabulary",193550,259000,65450,25
TIKI,nha-sach-tiki,101985321,"12 Quy Tắc Lãnh Đạo Từ Seal (Trách Nhiệm Tối Thượng - Thành Công Tối Đa)",149000,186000,37000,20
TIKI,nha-sach-tiki,32314551,"Không Đọc Sách Này, Chụp Xấu Đừng Buồn !",108700,125000,16300,13
TIKI,nha-sach-tiki,860788,"Harvard Bốn Rưỡi Sáng",111000,139000,28000,20
TIKI,nha-sach-tiki,138934624,"Tô Màu Phát Triển Trí Não Bộ Cho Bé 1-5 Tuổi - Tập 1",12900,16000,3100,19
TIKI,nha-sach-tiki,104732038,"Tớ Học Lập Trình - Làm Quen Với Lập Trình Scratch",82900,105000,22100,21
TIKI,nha-sach-tiki,145288033,"Năm Tháng Tĩnh Lặng, Kiếp Này Bình Yên (Tái Bản)",108000,138000,30000,22
TIKI,nha-sach-tiki,53095307,"Nàng Tóc Đỏ (Nobel Văn Chương 2006)",95400,120000,24600,21
TIKI,nha-sach-tiki,95089958," Bút gel Deli - 0.5mm - Nắp đậy - Mực Xanh - 1 chiếc - EQ300-BL",6000,10800,4800,44
TIKI,nha-sach-tiki,16631728,"Sách Dám Nghĩ Lớn (Bìa Cứng)",132000,188000,56000,30
TIKI,nha-sach-tiki,273636803,"Trạm Đọc Official | Combo 2 Cuốn Hackers IELTS : Hackers IELTS Listening + Hackers IELTS Reading",373000,498000,125000,25
TIKI,nha-sach-tiki,84565498,"Thuật Xử Thế Của Người Xưa (Tái Bản 2021)",38500,55000,16500,30
TIKI,nha-sach-tiki,109262820,"Gôm tẩy hình hoa anh đào Nhật Bản Deli -1 chiếc - dành cho học sinh - 71135 / 71136",3900,7200,3300,46
TIKI,nha-sach-tiki,58946834,"Lãnh Đạo Tỉnh Thức (The Mindful Leader) - Michael Bunting - PACE Books",108000,135000,27000,20
TIKI,nha-sach-tiki,555504,"Sách Đắc Nhân Tâm (Bìa Cứng) (Tái Bản)",72000,108000,36000,33
TIKI,nha-sach-tiki,160370109,"Chính Bắc (Discover Your True North) - Khám Phá Ra “Chiếc La Bàn Nội Tâm” Của Chính Mình Để Dẫn Dắt Bản Thân Nhằm Trở Thành Nhà Lãnh Đạo Đích Thực (Tái Bản)",117000,155000,38000,25
TIKI,nha-sach-tiki,194005243,"Truyện cổ Andersen",49900,79000,29100,37
TIKI,nha-sach-tiki,173347859,"Thiết Kế Sự Nghiệp Tương Lai",78400,109000,30600,28
TIKI,nha-sach-tiki,115897815,"Tâm Hơn Thuốc - Minh Chứng Khoa Học Về Sự Tự Chữa Lành",133000,179000,46000,26
TIKI,nha-sach-tiki,148802208,"Phong Ma Yến Tước Tập 2 - Địa Ngục Thiên Đường",211000,265000,54000,20
TIKI,nha-sach-tiki,68330624,"Dế Mèn Phiêu Lưu Ký – Đậu Đũa Minh Họa - Ấn Bản Kỉ Niệm 100 Năm Tô Hoài",184000,225000,41000,18
TIKI,nha-sach-tiki,74416876,"Luyện Giải Bộ Đề Bồi Dưỡng Học Sinh Giỏi Tiếng Anh Lớp 6",53100,89000,35900,40
TIKI,nha-sach-tiki,156224977,"Sống Đơn Giản Cho Mình Thanh Thản (Tái Bản)",63700,85000,21300,25
TIKI,nha-sach-tiki,109488215,"Tóm Tắt Kiến Thức Toán Phổ Thông (Bí Quyết Học Nhẹ, Điểm Cao Trong Môn Toán)",116000,145000,29000,20
TIKI,nha-sach-tiki,113530800,"Vụ Án",75400,98000,22600,23
TIKI,nha-sach-tiki,73871086,"Bộ Dây Trang Trí Sinh Nhật Chữ Happy Birthday Thiết Kế Hoạt Hình",40000,40000,0,0
TIKI,nha-sach-tiki,171549980,"Bức Tranh Toàn Cảnh - Nguồn Gốc Của Sự Sống, Của Nghĩa Lý Và Của Chính Vũ Trụ",210000,269000,59000,22
TIKI,nha-sach-tiki,77665074,"The Way To Stay Positive",48400,70000,21600,31
TIKI,nha-sach-tiki,5914507,"Quân Vương (Tái Bản)",53600,68000,14400,21
TIKI,nha-sach-tiki,435988,"Cambridge IELTS Intensive Training Writing (Không CD)",111000,148000,37000,25
TIKI,nha-sach-tiki,124894164,"Yoga cho người mới bắt đầu",115000,145000,30000,21
TIKI,nha-sach-tiki,135754583,"Những Câu Chuyện Truyền Cảm Hứng - I Will Be Better: Con Sẽ Không Dựa Dẫm",49200,58000,8800,15
TIKI,nha-sach-tiki,3957061,"Thông Reo Ngàn Hống: Tiểu Thuyết Lịch Sử",113000,140000,27000,19
TIKI,nha-sach-tiki,65443438,"KPI Thước Đo Mục Tiêu Trọng Yếu (Key Performance Indicators) - David Parmenter - PACE Books",147000,195000,48000,25
TIKI,nha-sach-tiki,1053642,"Sức Mạnh Của Việc Đặt Câu Hỏi Tại Sao",74000,99000,25000,25
TIKI,nha-sach-tiki,151612100,"Achievers Grade 6 Workbook",112000,112000,0,0
TIKI,nha-sach-tiki,77621574,"Khí Tâm Trị Liệu - Ứng Dụng Luân Xa Chữa Lành 5 Thể Con Người",98700,125000,26300,21
TIKI,nha-sach-tiki,7125311,"10 Vạn Câu Hỏi Vì Sao - Vật Lý Vui (Tái Bản 2018)",38500,55000,16500,30
TIKI,nha-sach-tiki,6756517,"Người Thành Công Không Bao Giờ Trì Hoãn",81400,109000,27600,25
TIKI,nha-sach-tiki,145134948,"Combo 7 Quyển: Dạy Trẻ Hành Vi Tốt",146600,203000,56400,28
TIKI,nha-sach-tiki,2469669,"Dạy Con Theo Phương Pháp Montessori - Tớ Là Trò Giỏi",13000,13600,600,4
TIKI,nha-sach-tiki,3529955,"i-Learn Smart World 8 Student Book",112000,112000,0,0
TIKI,nha-sach-tiki,485261,"Chí Phèo (Tập Truyện Ngắn) ",40000,50000,10000,20
TIKI,nha-sach-tiki,867306,"Tuần Của Bé - Bé Đáng Yêu ",22000,23000,1000,4
TIKI,nha-sach-tiki,191693167,"Sổ Tay Ghi Chép Lò Xo Kẻ Ngang A5 Gáy Xoắn 120 Trang Deli - Phù Hợp Làm Sổ Kế Hoach Planner, Viết Nhật Kí, Tập Vở Học Sinh Sổ Tay Văn Phòng - Màu Ngẫu Nhiên - LA560 ELA560 LPA560",16500,30600,14100,46
TIKI,nha-sach-tiki,96649478,"Sách Mẹ Teresa - Trên Cả Tình Yêu (Tái Bản)",61700,88000,26300,30
TIKI,nha-sach-tiki,15309643,"Combo Thầy Cô Giáo Hạnh Phúc Sẽ Thay Đổi Thế Giới 1 và 2 ( Tặng Kèm Sổ Tay )",218350,218350,0,0
TIKI,nha-sach-tiki,52207306,"Quo Vadis (Bìa Cứng) - Tác Phẩm Đoạt Giải Nobel Văn học 1905 (Đông A)",263000,350000,87000,25
TIKI,nha-sach-tiki,74415935,"Hãy Chọn Một Cách Sống (A Better Way To Live)",49200,78000,28800,37
TIKI,nha-sach-tiki,1645715,"Bộ Luật Hình Sự Hiện Hành (Bộ Luật Năm 2015, Sửa Đổi, Bổ Sung Năm 2017)",103500,103500,0,0
TIKI,nha-sach-tiki,136942986,"Bút chì 2B HB gỗ tự nhiên Deli - Dễ gọt và nhạy với máy chấm thi - Kèm tẩy và gọt - 10 chiếc/vỉ 50 chiếc/hộp - 33431 / 33433",25000,45000,20000,44
TIKI,nha-sach-tiki,145092101,"Giới Từ Tiếng Anh",55900,80000,24100,30
TIKI,nha-sach-tiki,119026340,"Tiếng Anh 6 I-Learn Smart World - Notebook",38000,38000,0,0
TIKI,nha-sach-tiki,63587072,"Tĩnh Lặng (Tái Bản Lần Thứ 11/2020)",53100,69000,15900,23
TIKI,nha-sach-tiki,73521489,"Vượt Qua Bản Ngã - Chiến Thắng Kẻ Thù Lớn Nhất Của Bạn",111000,149000,38000,26
TIKI,nha-sach-tiki,188663318,"Đi Tìm Lẽ Sống (Tái Bản 2022)",60700,88000,27300,31
TIKI,nha-sach-tiki,176909240,"Đường Hầm",85900,108000,22100,20
TIKI,nha-sach-tiki,1864759,"Giáo Trình HSK 3 - Sách Bài Tập (Kèm MP3)",141000,188000,47000,25
TIKI,nha-sach-tiki,120219392,"Người Thầy (Hồi Ức Của Một Nhà Giáo Mỹ)",93900,118000,24100,20
TIKI,nha-sach-tiki,10411542,"Combo Giáo Trình Hán Ngữ Boya Sơ Cấp 1 + Sách Bài Tập Đáp Án (Tái Bản - Kèm App)",210240,288000,77760,27
TIKI,nha-sach-tiki,103511949,"Đạo Của Vật Lý (Tái Bản)",196000,199000,3000,2
TIKI,nha-sach-tiki,76176359,"Logic Của Tâm Trí",67000,143000,76000,53
TIKI,nha-sach-tiki,170706974,"Lãnh Đạo Giỏi Hỏi Câu Hỏi Hay (Tái Bản)",141000,189000,48000,25
TIKI,nha-sach-tiki,480040,"Đắc Nhân Tâm (Khổ Lớn)",80840,86000,5160,6
TIKI,nha-sach-tiki,157422653,"Bút Viết Thư Pháp Hán Tự Calligraphy Kanji Tiếng Trung Nhật Hàn Ngòi Lông Nhiều Kích Cỡ Deli - Brush Pen Phù Hợp Luyện Chữ Nét Trang Trí Sổ Có Thể Thêm Mực - 75514 75515 75516",11500,21600,10100,47
TIKI,nha-sach-tiki,4780907,"Oscar Và Bà Áo Hồng (Tái Bản)",43900,55000,11100,20
TIKI,nha-sach-tiki,195472150,"Lời Hiệu Triệu Của Cthulhu (Tuyển Tập H.P. Lovecraft)",70400,80000,9600,12
TIKI,nha-sach-tiki,262695598,"Chú Bé Rắc Rối",31100,38000,6900,18
TIKI,nha-sach-tiki,128656374,"Combo 5-10-20 Bút Bi Thiên Long TL-093",14900,20000,5100,26
TIKI,nha-sach-tiki,188373990,"Combo 5 cuốn Toán Lớp 10 tập 1+2 (Kết nối tri thức với cuộc sống) (SGK+BT+Chuyên đề)",82500,82500,0,0
TIKI,nha-sach-tiki,36474716,"Gieo Hạt Giống Thương Yêu (Trọn Bộ 8 Tập)",126000,160000,34000,21
TIKI,nha-sach-tiki,188833581,"Sách: Chiến TRanh Tiền Tệ ( Trọn bộ 4 cuốn)_Tặng Bookmark ",561650,561650,0,0
TIKI,nha-sach-tiki,167114300,"Bị Đuổi Khỏi Nhóm Anh Hùng, Tôi Muốn Sống Tự Do Tự Tại Ở Vương Đô, Tập 3",79400,159000,79600,50
TIKI,nha-sach-tiki,95220863,"Làm Sạch Mạch Và Máu (Tái Bản)",66700,89000,22300,25
TIKI,nha-sach-tiki,71907868,"Sinh Vật Thần Thoại Khắp Thế Gian",64600,79000,14400,18
TIKI,nha-sach-tiki,119026255,"Tiếng Anh 2 I-Learn Smart Start - Notebook (Vở Tập Viết)",28000,28000,0,0
TIKI,nha-sach-tiki,53301432,"Bước Vào Cửa Hiệu Nhiệm Màu",104000,148000,44000,30
TIKI,nha-sach-tiki,181699642,"Cũng Là “Tiếng Em” Mà Lạ Lắm",49600,99000,49400,50
TIKI,nha-sach-tiki,196906635,"Phóng Đãng",280000,350000,70000,20
TIKI,nha-sach-tiki,155115299,"Giải Thích Chuyên Đề Thi Vào 10 Chuyên Tiếng Anh",102000,145000,43000,30
TIKI,nha-sach-tiki,196422801,"Tôi Ổn - Bạn Ổn",160000,228000,68000,30
TIKI,nha-sach-tiki,54609022,"Yin Yoga – Tâm Yên Bình, Đẹp Dáng Xinh",139000,199000,60000,30
TIKI,nha-sach-tiki,9932005,"Combo Cà Phê Cùng Tony và Trên Đường Băng (Tặng Kèm Sổ Tay)",178500,210000,31500,15
TIKI,nha-sach-tiki,53243293,"Green Smoothies - Giảm Cân, Làm Đẹp Da, Tăng Cường Sức Đề Kháng Với 7 Ngày Uống Sinh Tố Xanh",108000,159000,51000,32
TIKI,nha-sach-tiki,175956867,"Từ Phú Điền Đến New York",129000,215000,86000,40
TIKI,nha-sach-tiki,181122325,"Thai Giáo (Tái Bản 2022)",104000,148000,44000,30
TIKI,nha-sach-tiki,51030886,"Combo Dạy Con Theo Montessori - Cho Bé 2-6 Tuổi (Bộ 5 Cuốn)",67000,69600,2600,4
TIKI,nha-sach-tiki,186267243,"Kingdom 28",41300,45000,3700,8
TIKI,nha-sach-tiki,138226278,"Pendragon 10 - Những Chiến Binh Halla",140000,255000,115000,45
TIKI,nha-sach-tiki,90738221,"Sét Bong Bóng Trang Trí Sinh Nhật Peppa Pig Tặng Kèm Bơm Tay Siêu Đáng Yêu",189000,378000,189000,50
TIKI,nha-sach-tiki,188551115,"Vua Sáng Chế - Tập 12",20000,20000,0,0
TIKI,nha-sach-tiki,40429235,"Bí Quyết Ứng Tuyển Vào Harvard",72100,90000,17900,20
TIKI,nha-sach-tiki,867296,"Tuần Của Bé - Bé Năng Động ",11000,11500,500,4
TIKI,nha-sach-tiki,90328974,"Hướng Dẫn Thiết Lập Farmstay (Sách Dành Tặng Những Ai Khởi Nghiệp Farmstay)",85000,110000,25000,23
TIKI,nha-sach-tiki,170345818,"Đời Thay Đổi Khi Chúng Ta Thay Đổi (Combo 7 Tập)",359000,515000,156000,30
TIKI,nha-sach-tiki,141002533,"Hậu Khủng Hoảng: Bảy Bí Quyết Bảo Toàn Của Cải Trong Thời Gian Tới",144000,205000,61000,30
TIKI,nha-sach-tiki,110595924,"Sách Đục Trổ Thông Minh - Những Từ Vựng Đầu Đời Của Bé - My First Words- Sự Tương Phản - Opposites",49100,68000,18900,28
TIKI,nha-sach-tiki,72161356,"Di Sản Hồ Chí Minh - Học Ở Trường, Học Ở Sách Vở, Học Lẫn Nhau Và Học Nhân Dân",40000,50000,10000,20
TIKI,nha-sach-tiki,137375020,"Giấy A4 Hồng Hà Delus giấy in định lượng 80gsm - 4956",101800,101800,0,0
TIKI,nha-sach-tiki,1548699,"Combo Bé Học Nói Lời Hay (6 Quyển)",86000,111000,25000,23
TIKI,nha-sach-tiki,160488880,"OKR - Từ Chiến Lược Mục Tiêu Đến Kết Quả Then Chốt",94100,129000,34900,27
TIKI,nha-sach-tiki,186112407,"Vô Cùng Tàn Nhẫn Vô Cùng Yêu Thương T2  (Tái bản)",112000,149000,37000,25
TIKI,nha-sach-tiki,14764326,"Combo Không Theo Lối Mòn (Tái Bản) + Đi Tìm Lẽ Sống (2 cuốn)",140201,140201,0,0
TIKI,nha-sach-tiki,83607353,""Bố Bỉm Sữa"Dạy Con Thành "Công Dân Toàn Cầu"",102000,135000,33000,24
TIKI,nha-sach-tiki,197352178,"Tội ác sau những bức tranh",156750,209000,52250,25
TIKI,nha-sach-tiki,186237333,"Thương tiến tửu - Tập 1 (Tiểu thuyết đam mỹ) -Tặng 1 bookmark",132000,169000,37000,22
TIKI,nha-sach-tiki,158222302,"Sasaki và Miyano - Tập 2 (Manga)",56650,69000,12350,18
TIKI,nha-sach-tiki,273655287,"Trạm Đọc Official |  Sức Mạnh Của Thói Quen",127000,169000,42000,25
TIKI,nha-sach-tiki,196290944,"Lời Vàng Của Bố Dành Cho Con Gái",54500,99000,44500,45
TIKI,nha-sach-tiki,425716,"Atlas Giải Phẫu Cơ Thể Người",612000,680000,68000,10
TIKI,nha-sach-tiki,95090468,"Bút highlight dấu dòng 2 đầu Deli - 3 cây 6 màu - nét trơn mượt, màu tươi sáng - 3 chiếc / Hộp - S736",29000,52200,23200,44
TIKI,nha-sach-tiki,95090259," Bút chì lục giác Deli - loại 2B/HB - 10 chiếc/hộp - 33311 / 33312",16000,28800,12800,44
TIKI,nha-sach-tiki,109740141,"KINH ĐỊA TẠNG BỔN NGUYỆN",88000,88000,0,0
TIKI,nha-sach-tiki,48513049,"Sách Làm Người Thú Vị",89700,128000,38300,30
TIKI,nha-sach-tiki,170094958,"Chiêm Tinh Học Dưới Góc Nhìn Tâm Linh",186000,300000,114000,38
TIKI,nha-sach-tiki,337774,"Truyện thiếu nhi tiếng Anh - Diary Of A Wimpy Kid 01: A Novel In Cartoons",155400,169000,13600,8
TIKI,nha-sach-tiki,107016488,"Kệ ống đựng mỹ phẩm 4 ngăn Deli - Xanh/ Trắng/ Hồng - 8932 / 8933",34700,64800,30100,46
TIKI,nha-sach-tiki,110585305,"Bút chì phác thảo phiên bản cao cấp Deli - 2H, HB, 2B, 4B, 6B, 8B - 1 chiếc - S998",2416,4500,2084,46
TIKI,nha-sach-tiki,33506009,"Sách Tâm Hồn Cao Thượng (Tái Bản)",111000,158000,47000,30
TIKI,nha-cua-doi-song,73124602,"Bình Giữ Nhiệt Bằng Thép Không Gỉ Lock&amp;Lock Vacuum Bottle LHC6180FU (800ML)",344000,677000,333000,49
TIKI,nha-cua-doi-song,53789448,"Bộ cây lau nhà tự vắt thông minh, chổi lau nhà 360 độ, lau sạch khô nhanh - Parroti Pro PR01",419000,799000,380000,48
TIKI,nha-cua-doi-song,83412126,"Bình Giữ Nhiệt Lock&Lock Energetic One-Touch Tumbler LHC3249 - 550ML",249000,528000,279000,53
TIKI,nha-cua-doi-song,58804363,"Dụng Cụ Băm Rau Củ Quả Lock&amp;Lock Quick Chopper CKS309GRN",98900,193000,94100,49
TIKI,nha-cua-doi-song,84566545,"Ổ cắm điện đa năng kết hợp ổ cắm USB Nakagami chất lượng cao công nghệ Nhật Bản - Màu ngẫu nhiên",155000,155000,0,0
TIKI,nha-cua-doi-song,169848307,"Kệ Wifi Treo Tường 2 Tầng Không Cần Khoan Để Đầu Thu Kỹ Thuật Số, Remote, Điện Thoại - IG407",56000,60000,4000,7
TIKI,nha-cua-doi-song,56941523,"Ly nhựa 2 lớp LocknLock kèm ống hút HAP507 750ml",99000,217000,118000,54
TIKI,nha-cua-doi-song,99994000,"Bình giữ nhiệt có ống hút Lock&Lock Bucket Tumbler with Straw LHC4268 540ml - Màu",207000,473000,266000,56
TIKI,nha-cua-doi-song,92453371,"Áo Mưa Cánh Dơi Có Kiếng Đèn, Áo Mưa Kiếng Đèn Vải Dù Loại Siêu Dày, Hàng Việt Nam, Khổ To Rộng, Chống Thấm Hiệu Quả, Phù Hợp Nam Và Nữ, Có Túi Đựng, Có Lựa Chọn Màu Sắc",130000,130000,0,0
TIKI,nha-cua-doi-song,99868980,"Bình Giữ Nhiệt Locknlock Bucket Tumbler 540ml LHC4269DPIK",207000,473000,266000,56
TIKI,nha-cua-doi-song,71890908,"Bộ lau nhà xoay 360 độ Sunhouse KS-CL330S",275000,406000,131000,32
TIKI,nha-cua-doi-song,52574827,"Ô (dù) tự động 2 chiều cao cấp DandiHome chống UV",110000,110000,0,0
TIKI,nha-cua-doi-song,54484578,"Đèn Bàn Học LED USB Di Động Cao Cấp Có Thể Gập Hai Chỗ – 03 Chế Độ Ánh Sáng Vàng Bảo Vệ Mắt Chống Cận eLights",162000,259000,97000,37
TIKI,nha-cua-doi-song,2119173,"Cây Lau Nhà Dạng Xịt Nước Lock&Lock ETM472",274000,539000,265000,49
TIKI,nha-cua-doi-song,186558014,"Combo 10 Móc Dán Tường Treo Đồ Đa Năng Siêu Chịu Lực",23750,25000,1250,5
TIKI,nha-cua-doi-song,94778000,"Ô Dù che nắng, che mưa, có nút bấm 2 chiều, hàng chất lượng, dễ thương, thiết kế sang trọng và bền bỉ, ô dù có lựa chọn màu sắc",196000,196000,0,0
TIKI,nha-cua-doi-song,53583472,"Bộ Hộp Cơm Giữ Nhiệt Lock&amp;Lock Easy Carry 2L LHC8039WHT Có Túi (1 Hộp 720ml, 2 Hộp 420ml Kèm 1 Bộ Muỗng Và Nĩa) Màu",857000,1667000,810000,49
TIKI,nha-cua-doi-song,120552065,"Bình giữ nhiệt inox 304 Elmich EL-8013OL dung tích 480ml",143000,389000,246000,63
TIKI,nha-cua-doi-song,21441057,"Chảo Chống Dính Đá Sunhouse SBD18 - 18cm",197000,260000,63000,24
TIKI,nha-cua-doi-song,2119169,"Bộ Cây Lau Nhà Lock&Lock Squeeze Flat Mop ETM471",508000,979000,471000,48
TIKI,nha-cua-doi-song,46202190,"Combo nhiều túi lưới giặt đồ cho máy giặt bảo vệ quần áo chống biến dạng chất lượng tốt dây kéo lưới mịn Polyester",51300,54000,2700,5
TIKI,nha-cua-doi-song,892121,"Pin Max 8 + 4 Viên Energizer E91 BP8+4 AA",150000,180000,30000,17
TIKI,nha-cua-doi-song,90531871,"Đèn Pixar, Đèn Bàn Học Chống Cận Thị, Đèn Đọc Sách, Đèn Làm Việc Bảo Vệ Mắt - Hàng Chính Hãng Moontronics",119000,119000,0,0
TIKI,nha-cua-doi-song,11488920,"Bình Giữ Nhiệt Lock&amp;Lock RigaTumbler (London) LHC4160GRY 897ml - màu Gray",364000,715000,351000,49
TIKI,nha-cua-doi-song,173211404,"Ghế Xoay Văn Phòng Ngồi Làm Việc Công Thái Học Deli - Tay Gập Thông Minh, Có Ngả Lưng, Lưới Thoáng Khí, Chân Xoay Tiện Ích, Đệm Ghế Êm Aí - Phù Hợp Học Sinh, Văn Phòng, Game Thủ, Gaming - Hàng Chính Hãng - E4928 / E4929 / E4925 / E4926G",599000,1078200,479200,44
TIKI,nha-cua-doi-song,99621372,"Bình giữ nhiệt Lock&amp;Lock Belt Bottle LHC4267MIT 490ml - Màu",245000,473000,228000,48
TIKI,nha-cua-doi-song,146262084,"Gối Ngủ Memory Foam NOOZ Ruột Gối Cao Su Non Giúp Nâng Đỡ Đốt Sống Cổ Chống Đau Vai Gáy Ngủ Sâu Hỗ Trợ Chống Trào Ngược Phù Hợp Với Mọi Tư Thế Nằm Vỏ Gối Tencel",329000,560000,231000,41
TIKI,nha-cua-doi-song,104270135,"Bình Giữ Nhiệt LocknLock Featherlight One-touch Tumbler 500ml LHC3257WHT - Màu trắng",266000,517000,251000,49
TIKI,nha-cua-doi-song,17423771,"5 Viên Pin CR2032 3V Panasonic Lithium thay pin Smartkey , Cmos , Pin thay Airtag - Hàng chính hãng",80000,100000,20000,20
TIKI,nha-cua-doi-song,73125530,"Hộp cơm thủy tinh kèm muỗng đũa LocknLock LLG991CLNVY 930ml - Màu Navy",184000,362000,178000,49
TIKI,nha-cua-doi-song,152700947,"Bộ Lau Nhà MyJae Sợi Microfiber Xoay 360 Độ Thông Minh, Lau Sạch Nhanh Khô 134cm",399000,690000,291000,42
TIKI,nha-cua-doi-song,273624233,"Bình giữ nhiệt LocknLock Metro Two Way LHC4272/LHC4274 - Hàng chính hãng",311000,605000,294000,49
TIKI,nha-cua-doi-song,122700651,"Cây lau kính, gạt chùi kính đa năng 2 đầu trong 1 - Parroti Shiny SN01",126000,199000,73000,37
TIKI,nha-cua-doi-song,122692850,"Cây chà sàn thông minh cao cấp, chổi chà sàn đa năng 2 trong 1, cọ sàn và gạt nước – Parroti Easy ES02",126000,199000,73000,37
TIKI,nha-cua-doi-song,71178441,"Áo Mưa Bít Dù Trơn, Áo Mưa Kín Người Vải Dù Siêu Dày, Chống Thấm Hiệu Quả, Phù Hợp Nam Và Nữ, Có Túi Đựng, Có Lựa Chọn Màu Sắc",115000,115000,0,0
TIKI,nha-cua-doi-song,94724913,"Ron Dán Che Khe Cửa ,Chân Cửa,Khung Cửa CTFAST Chống Bụi, Ngăn Côn Trùng, Chống Ồn, Chống Thoát Nhiệt Điều Hòa, Chống Va Đập Cửa - Mẫu Cải Tiến 2021 ( Hàng Chính Hãng )",49000,68000,19000,28
TIKI,nha-cua-doi-song,182971940,"Bình giữ nhiệt LocknLock có 2 nắp thay thế New Clip Tumbler 540ml LHC4279",264000,520000,256000,49
TIKI,nha-cua-doi-song,3480627,"Bộ Cây Lau Nhà Xoay Tay Compact Spin Mop Lock&Lock ETM466: Thùng Giặt + Cây + Bông Lau",480000,924000,444000,48
TIKI,nha-cua-doi-song,92385690,"Áo Mưa Cánh Dơi 2 Đầu Vải Dù Loại Siêu Dày, Hàng Việt Nam Chất Lượng Cao, Khổ To Rộng Phù Hợp Cho 2 Người, An Toàn Cho Người Sử Dụng, Có Túi Đựng Dễ Bảo Quản.",140000,140000,0,0
TIKI,nha-cua-doi-song,119195755,"Bộ lau nhà tự vắt thông minh, chổi lau nhà 360 độ, lau sạch khô nhanh - Parroti ProMax PX01",519000,849000,330000,39
TIKI,nha-cua-doi-song,57867024,"Bộ Lau Nhà Xoay 360 Độ Sunhouse Ks-Cl350PO",329000,513000,184000,36
TIKI,nha-cua-doi-song,120759154,"Bó 100 Dây Thít, Dây Rút, Lạt Nhựa Đủ Mọi Kích Cỡ Tiện Lợi",23750,25000,1250,5
TIKI,nha-cua-doi-song,54145105,"Cọ Bồn Cầu Toilet, Cọ Vệ Sinh Cao Cấp - Parroti Silicon SL01 – Có Bình Đựng Nước Tẩy, Cây Gắp Tóc Tiện Dụng",81000,89000,8000,9
TIKI,nha-cua-doi-song,73147684,"Thanh xốp gắn chân cửa chống kẹt chân cho bé, bịt khe hở, chắn gió, chặn côn trùng",38000,40000,2000,5
TIKI,nha-cua-doi-song,106457363,"Túi Giữ Nhiệt Đựng Hộp Cơm 2 Ngăn – Chọn Màu Túi Giữ Nhiệt Đựng Cặp Lồng Cơm – Nhiều Màu – Chống Thấm Nước Chính Hãng",33000,43000,10000,23
TIKI,nha-cua-doi-song,76834277,"Combo 2 Miếng Lau Nhà Thế Hệ Mới Parroti Pro PAD2-PR01 - Kích Thước 33 x12 CM (Chỉ dùng được cho Bộ lau nhà Parroti Pro)",76000,79000,3000,4
TIKI,nha-cua-doi-song,147265074,"Vỉ 2 VPin AA , Pin AAA DURACELL 1,5V Siêu Bền - Hàng chính hãng",25000,30000,5000,17
TIKI,nha-cua-doi-song,115092053,"Bộ ga giường poly cotton LIDACO drap giường đủ size nệm 1m2, 1m4, 1m6, 1m8",65000,90000,25000,28
TIKI,nha-cua-doi-song,32328782,"Trung Nguyên Legend - Phin nhôm hoa văn màu đen Vĩ Nhân",79000,79000,0,0
TIKI,nha-cua-doi-song,1399571,"Gối Memory Foam 50D Hình Cong Lock&Lock HLW111 (50 x 30 cm) - Trắng",286000,483000,197000,41
TIKI,nha-cua-doi-song,119007194,"Thanh 4 Móc Treo Dán Tường, Móc Treo Đồ Đa Năng Parroti Handy HD41",21000,36000,15000,42
TIKI,nha-cua-doi-song,119030223,"Keo Dán Giày, Gỗ, Nhựa, Sứ Siêu Dính Chống Thấm Đa Năng Deli - 7Ml / 20Ml - 7140 / 7149",9000,16200,7200,44
TIKI,nha-cua-doi-song,71924330,"Bộ Chổi Quét Nhà Lock&Lock Gồm Cây Chổi và Dụng Cụ Hốt ETM465",246000,428000,182000,43
TIKI,nha-cua-doi-song,185910176,"Giấy Nến Vàng Lót Nồi Chiên Không Dầu Sạch Sẽ Tiện Dụng An Toàn Cho Sức Khỏe - 1 set 50 Tờ",85000,85000,0,0
TIKI,nha-cua-doi-song,84886093,"Vợt muỗi thông minh 3in1 SUNHOUSE SHE-PRO11.W",203000,344000,141000,41
TIKI,nha-cua-doi-song,183907622,"Cây Lăn Bụi Quần Áo, Ghế Sofa - Tặng Kèm 2 lõi lăn",38000,55000,17000,31
TIKI,nha-cua-doi-song,138952791,"Móc Treo Cây Lau Nhà Dán Tường Đa Năng Chịu Lực Tốt, 2 Trong 1 - Parroti Keeper KP03",22000,42000,20000,48
TIKI,nha-cua-doi-song,143841853,"Bình Giữ Nhiệt Coffee Bugu Mini Inox 304 LI-02 – Hàng Chính Hãng",108000,150000,42000,28
TIKI,nha-cua-doi-song,1651191,"Kệ Đỡ Màn Hình Máy Tính Monitor Stand Walnut Plyconcept MSM01003 (490 x 200 mm) - Nâu Đậm",290000,380000,90000,24
TIKI,nha-cua-doi-song,57806524,"Áo Mưa Bộ Vải Dù Cao Cấp Cho Bé Từ 3 -10 Tuổi, Chống Thấm, Che Kín Người An Toàn Cho Bé, Lựa Chọn Màu Sắc Phù Hợp Giới Tính (Giao Màu - Mẫu Ngẫu Nhiên)",110000,110000,0,0
TIKI,nha-cua-doi-song,64988886,"Bình giữ nhiệt Lock&amp;Lock Flat nắp gỗ 400ml - LHC4227WHT - Màu",277000,534000,257000,48
TIKI,nha-cua-doi-song,52504270,"Chiếu Mây Điều Hòa Cao Cấp Loại dày",165000,300000,135000,45
TIKI,nha-cua-doi-song,122911188,"Găng tay cao su siêu dai rửa bát, bao tay cao su rửa chén, vệ sinh nhà cửa, an toàn, không mùi hôi Parroti Active AT01",44000,89000,45000,51
TIKI,nha-cua-doi-song,58357614,"Đèn bắt muỗi, ruồi và các loại côn trùng Con Dơi",390000,390000,0,0
TIKI,nha-cua-doi-song,52756206,"1kg Túi Đựng Rác Tự Phân Hủy Sinh Học Gimex II (full size)",26000,26000,0,0
TIKI,nha-cua-doi-song,273244363,"Kệ Sách Gỗ 5 Tầng, Giá Sách Đứng Cạnh Bàn Làm Việc - GP189",319000,348000,29000,8
TIKI,nha-cua-doi-song,112321595,"Đèn Học Chống Cận Thị, Đèn Đọc Sách, Đèn Làm Việc Để Bàn Chống Chói Mắt Lóa Mắt Bảo Vệ Mắt Chống Cận Thị, Cảm Ứng Siêu Sáng - VinBuy",300000,300000,0,0
TIKI,nha-cua-doi-song,119203295,"Combo 5 Khăn Lau Bếp, Lau Kính Siêu Thấm Hút Parroti - Fiber FB02",43000,89000,46000,52
TIKI,nha-cua-doi-song,186627908,"Ghế Gác Chân Công Thái Học Ergonomic Footrest, Ghế Kê Chân Ghế Gác Chân Văn Phòng",315000,480000,165000,34
TIKI,nha-cua-doi-song,119112667,"Combo 2 Miếng Lau Nhà Parroti ProMAX - Kích Thước 38 x12 CM",83000,145000,62000,43
TIKI,nha-cua-doi-song,73638934,"Chảo chống dính đáy từ Elmich 4703OL size 20cm",156000,450000,294000,65
TIKI,nha-cua-doi-song,163550425,"Nệm Bông Gòn Xuất Nhật, Nệm Trải Sàn Tiện Lợi, Đệm Văn Phòng Size 1m x 2m; 1.4m x 2m; 1.6m x 2m",399000,500000,101000,20
TIKI,nha-cua-doi-song,153066085,"Pin CR2032 Lithium 3V Maxell cao cấp Made In Japan - Hàng chính hãng",18000,30000,12000,40
TIKI,nha-cua-doi-song,181410158,"Bàn Làm Việc Đa Năng Decor Phong Cách Gaming Thương Hiệu IGA - GM62",294000,320000,26000,8
TIKI,nha-cua-doi-song,104680895,"Cây Lau Nhà Đơn MyJae Sợi Microfiber Xoay 360 Độ Phù Hợp Cho Nhiều Loại Thùng Lau 134cm",199000,330000,131000,40
TIKI,nha-cua-doi-song,173732608,"Combo Khăn Lau Đa Năng 2 Mặt Siêu Thấm , Khăn Lau Bếp , Khăn Lau Kính , Khăn Lau Chén Bát , Khăn Lau Tay , Khăn Lau Ô Tô PaKaSa",38000,38000,0,0
TIKI,nha-cua-doi-song,74014046,"Bộ 6 Ống Hút Silicone Có Thể Tái Sử Dụng Kèm 2 Cọ Rửa Lock&Lock TLL080 ( 250 x 78 mm)",71600,138000,66400,48
TIKI,nha-cua-doi-song,892141,"Pin Max 8 + 4 Viên Energizer E92 BP8+4 AAA",150000,180000,30000,17
TIKI,nha-cua-doi-song,46163430,"Sáo Recorder Soprano Yamaha YRS-24B Tone C (Đô) - Kèm Móng Gảy DreamMaker",129000,129000,0,0
TIKI,nha-cua-doi-song,52484490,"Keo Dán Chống Thấm Siêu Dính Nhật Bản Bosui Dài 5m ",17000,27500,10500,38
TIKI,nha-cua-doi-song,162548473,"Hộp Đựng Giày Nhựa Cứng Cao Cấp Size Lớn Cửa Nam Châm Lắp Ráp Tiện Lợi Song Anh- Hàng Chính Hãng",75000,150000,75000,50
TIKI,nha-cua-doi-song,149617968,"Thùng đựng gạo thông minh M&L Royalcare 6068 - bao gồm khay đựng ngũ cốc - chống ẩm mốc côn trùng - đồ gia dụng tiện ích",469000,469000,0,0
TIKI,nha-cua-doi-song,127031393,"Ca nước giữ nhiệt LocknLock Metro Mug LHC4219MIT 475ml - Màu",299000,506000,207000,41
TIKI,nha-cua-doi-song,131407951,"Bàn làm việc bàn hoc chữ k",366000,396000,30000,8
TIKI,nha-cua-doi-song,128969410,"Kệ Sách Để Bàn, Giá Sách Thiết Kế Hiện Đại Thương Hiệu IGA - GP157",188000,205000,17000,8
TIKI,nha-cua-doi-song,71206737,"Đèn Pin Laser 303 - Hàng Chính Hãng",121000,135000,14000,10
TIKI,nha-cua-doi-song,110001215,"Nẹp Dây Điện Dán Tường Siêu Dính ,Kẹp Dây Điện Cố Định Và Giữ Dây Điện Siêu Sốc an toàn tiện lợi dễ lắp đặt",33250,35000,1750,5
TIKI,nha-cua-doi-song,117353723,"Chiếu ngủ văn phòng cao cấp",45000,45000,0,0
TIKI,nha-cua-doi-song,63051860," Đèn Học Làm Việc Đọc Sách Để Bàn Pixar Chống Cận Thị Bảo Vệ Mắt - Hàng Chính Hãng eLights",129000,129000,0,0
TIKI,nha-cua-doi-song,174236741,"Găng tay cao su tự nhiên Lock&amp;Lock ETM830 (có móc treo)",28000,56000,28000,50
TIKI,nha-cua-doi-song,2153015,"Bộ Vít 24 Món Xiaomi Wiha Precision Screwdriver",399000,490000,91000,19
TIKI,nha-cua-doi-song,44620765,"Đèn Pin Led Siêu Sáng Mini Có Sạc USB Có Hỗ Trợ Sạc Dự Phòng Lại Cho Điện Thoại Khẩn Cấp - Hàng Chính Hãng",102300,102300,0,0
TIKI,nha-cua-doi-song,118858137,"Nạo Gọt Rau Củ Quả  Inox 304 Hàng Cao Cấp - Mua 1 Lần Dùng Mãi Mãi",70000,70000,0,0
TIKI,nha-cua-doi-song,104110135,"Bàn chải nhà tắm, cọ bồn rửa Parroti Clever CR01",54000,99000,45000,45
TIKI,nha-cua-doi-song,57999394,"Bộ Ga Gối Cotton Đũi Tici LIDACO Cao Cấp - Xanh Mint",149000,220000,71000,32
TIKI,nha-cua-doi-song,149573787,"Thùng rác thông minh cảm ứng tự động M&L-FH-2 phong cách Hàn Quốc",479000,479000,0,0
TIKI,nha-cua-doi-song,74396976,"Máy xay tỏi ớt bằng tay Lock&Lock (Nhiều kích cỡ) - Hàng chính hãng, lực nghiền mạnh với 3 lưỡi dao thép không gỉ",94000,171000,77000,45
TIKI,nha-cua-doi-song,189491905,"Nhang Sen Thuần Khiết Liên Tâm 20.5cm 160 cây - Ít khói, dịu nhẹ, 100% Đài sen thiên nhiên",69000,75000,6000,8
TIKI,nha-cua-doi-song,121396300,"Dây rút nhựa 10cm ,15cm, 20cm, 25cm, 30cm ( Khoảng 80 sợi/bịch )",21000,21000,0,0
TIKI,nha-cua-doi-song,162526068,"Đất trồng cây SOILMIX cho hoa hồng, cây cảnh, sen đá, rau sạch hữu cơ, bổ sung phân bón vi sinh, trichoderma, đá perlite",50000,50000,0,0
TIKI,nha-cua-doi-song,1400785,"Gối Memory Foam 50D Hình Dáng Thường Lock&Lock HLW112 (50 x 30 cm) - Trắng",257000,439000,182000,41
TIKI,nha-cua-doi-song,206485076,"Hương nhang sạch Dương Minh nhang 20cm và 30cm 100% thành phần tự nhiên các loại nhang Cam Sả nhang Bồ Kết nhang Bắc nhang Thảo Mộc nhang Quế nhang Khuynh Diệp và Trầm Hương cao cấp",37800,60000,22200,37
TIKI,nha-cua-doi-song,52187161,"Giá Treo Ổ Điện Dán Tường Tiết Kiệm Không Gian",9405,9900,495,5
TIKI,nha-cua-doi-song,110894852,"Giấy Bạc Màng Nhôm MyJae Đài Loan Để Bảo Quản, Nướng Thức Ăn, Bọc Thực Phẩm 30cm x 14m",68000,119000,51000,43
TIKI,nha-cua-doi-song,75615959,"Combo 5 khăn lau đa năng siêu thấm hút, khăn size lớn (30x40 cm) khăn lau kính, ô tô, mặt bàn, bếp Parroti Fiber FB01",43000,89000,46000,52
TIKI,nha-cua-doi-song,147806385,"Đũa gắp thức ăn vặt DandiHome siêu nhẹ cho chơi game, làm việc văn phòng",14000,15000,1000,7
TIKI,nha-cua-doi-song,57867023,"Cây Lau Nhà Xoay 360 Độ Sunhouse Ks-Mo350I",127000,200000,73000,37
TIKI,nha-cua-doi-song,949687,"Kệ Đỡ Màn Hình Máy Tính Monitor Stand Plyconcept MSM01001 (490 x 200 mm) - Gỗ",240000,300000,60000,20
TIKI,nha-cua-doi-song,82875291,"Bộ 2 thùng vải, hộp vải đựng đồ đa năng -Màu Nâu Kem + Tặng kèm dây cột tóc- Hộp vải đựng quần áo 2 size đựng quần áo, đồ lót, giày, văn phòng phẩm, đồ dùng cá nhân rất tiện lợi-Bộ 2 hộp vải đựng đồ vải canvas siêu xinh có nắp đậy, tủ vải đựng đồ hộp cái ",94000,99000,5000,5
TIKI,nha-cua-doi-song,102488853,"Thùng Đựng Gạo Cao Cấp 5kg & 10kg - Thùng Đựng Gạo Nắp Đậy Thông Minh, Thiết Kế Hiện Đại & Đẹp Mắt, Chất Liệu ABS &PP An Toàn Chống Nước, Chống Ẩm Mốc, Mối Mọt - Hàng Nhập Khẩu",201000,343500,142500,41
TIKI,nha-cua-doi-song,134853381,"Bình giữ nhiệt LocknLock Feather Light Ring LHC4244IVY 460ml - Màu",312000,601000,289000,48
TIKI,nha-cua-doi-song,180378151,"Bình giữ nhiệt LocknLock Metro Drive LHC4277S 650ml - Kèm ống hút và cọ rửa",294000,579000,285000,49
TIKI,nha-cua-doi-song,55900887,"Đèn Bàn Học Đọc Sách, Làm Việc (Học Sinh, Sinh Viên, Văn Phòng) LED Chống Cận, Cảm Ứng Nhôm Cao Cấp eLights",315000,315000,0,0
TIKI,nha-cua-doi-song,114204740,"Bình giữ nhiệt inox 304 Sunhouse 900ml KS-TU900I",146000,225000,79000,35
TIKI,nha-cua-doi-song,53518638,"2 Móc Dán Tường Giữ Dây Cắm Điện Phích Cắm Loại Trong Suốt",14250,15000,750,5
TIKI,nha-cua-doi-song,10227148,"Dụng Cụ Mài Dao 3 Lớp Lock&Lock CKK112 (245 x 53 x 72 mm)",164000,275000,111000,40
TIKI,nha-cua-doi-song,71005991,"Bình xịt dầu Lock&Lock 100ml kèm phểu và cọ rửa - CKO109",91900,174000,82100,47
TIKI,nha-cua-doi-song,14640240,"Cân Điện Tử Nhà Bếp 5kg - Cân Chia Thực Phẩm Nhà Bếp - Cân Tiểu Ly 5kg",39000,62000,23000,37
TIKI,nha-cua-doi-song,3927949,"Bộ sạc Energizer Charger kèm 4 pin Ener AA 2000mAh, tự ngắt sạc (CHVCM4)",460000,460000,0,0
TIKI,nha-cua-doi-song,178783625,"Combo 2 Giá đỡ bàn chải máy dán tường NAVIVU",35000,35000,0,0
TIKI,nha-cua-doi-song,199728521,"Bộ lau nhà đa năng Space Saving Sunhouse KS-CL3211PW",276000,450000,174000,39
TIKI,nha-cua-doi-song,71111080,"Kệ Để Giày Dép Inox 5 Tầng Chính Hãng Amalife, Giá Để Giày Inox 5 Tầng - Chọn Màu",99000,99000,0,0
TIKI,nha-cua-doi-song,55669191,"Đèn Pixar, Đèn Học Chống Cận Thị, Đèn Đọc Sách, Đèn Làm Việc Để Bàn Chống Chói Mắt Lóa Mắt Bảo Vệ Mắt - Hàng Chính Hãng",195000,275000,80000,29
TIKI,nha-cua-doi-song,118960590,"Bộ 2 Móc Treo Dán Tường Cao Cấp, Móc Treo Đồ Dán Tường - Parroti Handy HD02",11000,20000,9000,45
TIKI,nha-cua-doi-song,696495,"Ổ Cắm Điện 4 Lỗ 3 Chấu 3m Philips SPN1348WB/74 (2500W)",345000,369000,24000,7
TIKI,nha-cua-doi-song,195852183,"Bình giữ nhiệt bằng thép không gỉ LocknLock Jumbo Tumbler LHC4300YRED 900ML",399000,730000,331000,45
TIKI,nha-cua-doi-song,3677799,"Hộp 6 Lõi  Lọc Nước BRITA Maxtra Plus Filter Cartridge",1490000,1490000,0,0
TIKI,nha-cua-doi-song,68716605,"Dao Làm Bếp Đa Năng Sunhouse KS-KN165KS",75900,117000,41100,35
TIKI,nha-cua-doi-song,155794592,"Kệ lò vi sóng đa năng Thép Carbon cao cấp Vando, kệ để đồ nhà bếp siêu chịu lực 300kg sơn tĩnh điện chống bong tróc, kệ nhà bếp",599000,999000,400000,40
TIKI,nha-cua-doi-song,52885368,"1 Kg túi zip chỉ đỏ thương hiệu Gimex II",64000,72000,8000,11
TIKI,nha-cua-doi-song,71999229,"Nồi Inox 3 Lớp Đáy Liền Elmich Trimax Classic 2407OL",498000,870000,372000,43
TIKI,nha-cua-doi-song,106208909,"Ô dù che mưa cỡ lớn tự động đóng mở, gấp gọn tiện lợi - Thiết kế mở ngược chống ướt khi mở, gập - Chính hãng NIKITA",157000,199000,42000,21
TIKI,nha-cua-doi-song,54130086,"Cây lau nhà tự vắt thông minh đa năng cao cấp Parroti Magic MG01 - Tặng 1 Miếng Lau",240000,349000,109000,31
TIKI,nha-cua-doi-song,35058677,"Vỉ 5 Viên Pin CR1632 ( CR 1632/5BE x 1 Vỉ ) Panasonic Lithium 3 V - Hàng Chính Hãng",84000,100000,16000,16
TIKI,nha-cua-doi-song,55365176,"0.5kg túi zipper chỉ đỏ đựng thực phẩm",34000,35000,1000,3
TIKI,nha-cua-doi-song,141246639,"Hộp giữ nhiệt đựng đồ ăn có tay cầm Handle Food Jar LocknLock 700ml LHC8042NVY - Màu",407000,800000,393000,49
TIKI,nha-cua-doi-song,54686184,"Bạt Áo Trùm Máy Giặt Cửa Trên, Cửa Ngang Vải Dù Siêu Dày, Chống Thấm Nước, Không Phai Màu - (Giao Màu - Họa Tiết Ngẫu Nhiên)",105000,105000,0,0
TIKI,nha-cua-doi-song,53973090,"Ghế xếp thư giãn cao cấp SUMIKA 168 - Có thể ngã thành giường nằm, vải lưới Textilene thoáng khí, gối có thể tháo rời, tải trọng 300kg, khung ghế bằng thép không gỉ, đế chống trượt",1234000,1500000,266000,18
TIKI,nha-cua-doi-song,7114709,"Đèn Pin Đội Đầu Sunhouse Cỡ Nhỏ She 5012",61000,99000,38000,38
TIKI,nha-cua-doi-song,578967,"Chảo Đá Chống Dính Siêu Bền Sunhouse SBD28 28cm",267000,430000,163000,38
TIKI,nha-cua-doi-song,11203853,"Bộ 10 đinh treo tranh, mắc màn loại 4 chân",23655,24900,1245,5
TIKI,nha-cua-doi-song,85029598,"Ổ cắm Điện Quang ĐQ 002A-02 (3 lỗ)",92000,92000,0,0
TIKI,nha-cua-doi-song,193433927,"Đèn Bàn Học Led Đọc Sách Làm Việc Học Tập Bảo Vệ Mắt Chống Cận - 2 Trục Đèn Chiếu Sáng - Gấp Gọn Tiện Lợi",539000,699000,160000,23
TIKI,nha-cua-doi-song,54122078,"Pin AAAA Energizer E96 BP2",63000,80000,17000,21
TIKI,nha-cua-doi-song,63133571,"Mền lông cừu xanh dương đậm cao cấp A - 1m8x2m",165000,180000,15000,8
TIKI,nha-cua-doi-song,56880195,"Bình nước Lock&Lock Eco Bottle ABF664BLU 750ml - Màu",112000,242000,130000,54
TIKI,nha-cua-doi-song,58828647,"Xe đẩy hàng 4 bánh SUMIKA T150 - Khung thép, tay cầm gấp mở tiện lợi, tải trọng 150kg",842000,1350000,508000,38
TIKI,nha-cua-doi-song,178068438,"Khăn giấy cuộn đa năng, lau bếp, lau kính, chén bát, lau tay (50 khăn/cuộn, 25cm x25cm) - Parroti Bingo NG01",36000,78000,42000,54
TIKI,nha-cua-doi-song,51554889,"Ron Dán Che Khe Cửa ,Chân Cửa Chống Gió Lùa, Chống Bụi Và Chống Côn Trùng - Hàng Chính Hãng Cuộn 2m",40000,52000,12000,23
TIKI,nha-cua-doi-song,69929041,"Móc Treo Quần Áo, Móc Phơi Đồ Trẻ Em Inox Kẹp Chống Rơi, Móc Treo Tất, Vớ, Đồ Lót Nhiều Kiểu Dáng",47500,50000,2500,5
TIKI,nha-cua-doi-song,51476716,"Bộ 10 đôi đũa inox 304 - 316 DandiHome 2020 chống trơn trượt, sang trọng, tinh tế",229000,300000,71000,24
TIKI,nha-cua-doi-song,72211934,"Combo 2 giỏ nhựa treo bồn rửa chén tiện lợi - Màu ngẫu nhiên- Hàng chính hãng",20000,20000,0,0
TIKI,nha-cua-doi-song,210760574,"Cây lau nhà tự vắt thông minh sợi microfiber",169000,209000,40000,19
TIKI,nha-cua-doi-song,87873126,"Áo Mưa Bộ Vải Dù, Bộ Quần Áo Mưa Có Phản Quang Đủ Size, Chống Thấm Hiệu Quả, Phù Hợp Nam Và Nữ, Có Túi Đựng, Có Lựa Chọn Màu Sắc",150000,150000,0,0
TIKI,nha-cua-doi-song,161225352,"Miếng dán đỡ kệ gỗ, chia ngăn tủ, không cần đóng đinh",20900,22000,1100,5
TIKI,nha-cua-doi-song,19719366,"Võng dù 2 lớp BAN MAI, gọn nhẹ 230x145 cm, nặng 600gr (Giao màu ngẫu nhiên)",114000,150000,36000,24
TIKI,nha-cua-doi-song,22081865,"TÚI ÁO BÌNH GIỮ NHIỆT TIỆN LỢI",38000,40000,2000,5
TIKI,nha-cua-doi-song,2127549,"Bình Đựng Dầu Với Nắp Mở Tự Động Lock&Lock CKO101BLK (550ml)",125000,241000,116000,48
TIKI,nha-cua-doi-song,51662145,"Keo dán siêu dính X2000 (50g) dán gỗ, sắt, sứ, kim loại đa năng",46645,49100,2455,5
TIKI,nha-cua-doi-song,1453915,"Ly Giữ Nhiệt Bằng Thép Không Gỉ Lock&Lock Clip Tumbler LHC4151BLK (540ml) - Đen",272000,506000,234000,46
TIKI,nha-cua-doi-song,146887829,"Đèn Pixar, Đèn Bàn Học Chống Cận Thị, Đèn Đọc Sách LED, Đèn Làm Việc Bảo Vệ Mắt, đèn học để bàn, đèn học cho học sinh sinh viên, đèn trang trí decor - Hàng Chính Hãng dododios",173000,173000,0,0
TIKI,nha-cua-doi-song,54485029,"Đèn Bàn Học Đọc Sách LED Chống Cận 03 Chế Độ Ánh Sáng Bảo Vệ Mắt Có Hộp Bút Và Giá Để Điện Thoại eLights",149000,149000,0,0
TIKI,nha-cua-doi-song,31672125,"GIẤY THƠM BOUNCE  (160 Tờ x 1 hộp )",179000,179000,0,0
TIKI,nha-cua-doi-song,153291977,"Băng Keo Chống Thấm, Chống Dột Dán Siêu Dính Trên Mọi Bề Mặt, Dán Mái Tôn, Dán Tường, Dán Ống Nước - PucaMart",17000,27500,10500,38
TIKI,nha-cua-doi-song,76046302,"Móc treo quần áo gắn sau cánh cửa tử HOBBY MTGC Nice Day 6 chấu - 2 màu tùy chọn",52000,79000,27000,34
TIKI,nha-cua-doi-song,130767592,"Ổ cắm Điện Quang ĐQ ESK 5W. SM740SL (4 lỗ 3 chấu dây 5 mét màu Trắng Đỏ)",140000,198091,58091,29
TIKI,nha-cua-doi-song,272453821,"[Tặng Bông Lau] Bộ Lau Nhà MyJae Đài Loan Sợi Microfiber Xoay Siêu Tốc 360 Độ Thông Minh 129.5cm",699000,990000,291000,29
TIKI,nha-cua-doi-song,3677797,"Hộp 3 Lõi Lọc Nước BRITA Maxtra Plus Filter Cartridge",949000,949000,0,0
TIKI,nha-cua-doi-song,178078834,"Móc treo đồ dán tường, treo vật dụng nhà bếp, khăn giấy - Parroti Handy HD11",37000,37000,0,0
TIKI,nha-cua-doi-song,655378,"Đèn Tích Điện Đa Năng 360 Cỡ Trung Sunhouse SHE-6848LA - Trắng",197000,331000,134000,40
TIKI,nha-cua-doi-song,73529777,"Kệ chén bát đa năng bằng thép carbon không gỉ, chống xước, sơn đen tĩnh điện, giá bát trên bồn rửa ráo nước cho nhà bếp sạch sẽ VANDO",290000,349000,59000,17
TIKI,nha-cua-doi-song,77448059,"Cốc giữ nhiệt LocknLock LHC4247PIK Table Mug 473ml",246000,484000,238000,49
TIKI,nha-cua-doi-song,146384829,"Ghế xoay văn phòng công thái học ergonomic có ngả lưng Premium 02, ghế xoay Gaming cao cấp nhập khẩu",1175000,2490000,1315000,53
TIKI,nha-cua-doi-song,55875210,"Tủ Vải Đựng Đồ Khung Thép Chịu Lực, Túi Đựng Chăn Màn Quần Áo miDoctor Tiện Lợi - Giao Màu Ngẫu Nhiên",82000,125000,43000,34
TIKI,nha-cua-doi-song,466737,"Hộp Cơm Cắm Điện - Hộp Hâm Nóng Văn Phòng 2 Tầng Life360 EL-ALS263 (Tím) - Hàng Chính Hãng",422000,749000,327000,44
TIKI,nha-cua-doi-song,27609461,"Dụng cụ thông tắc bồn cầu, cống bằng khi nén áp lực siêu mạnh",235000,235000,0,0
TIKI,nha-cua-doi-song,134419302,"Combo 8 móc dán tường chịu lực inox 304 có sẵn keo dán Hobby Home Decor 4545-2 không rỉ sét dán được gạch men, kính",81000,88000,7000,8
TIKI,nha-cua-doi-song,477936,"Lõi Lọc Kova-Barrier Tiêu Chuẩn - FC-STD",179000,250000,71000,28
TIKI,nha-cua-doi-song,579928,"Chảo Sâu Chống Dính Sunhouse SHS20 20cm",109000,180000,71000,39
TIKI,nha-cua-doi-song,199581980,"Kệ Sách Gỗ Để Bàn Thương Hiệu IGA - GP62",100000,109000,9000,8
TIKI,nha-cua-doi-song,25412653,"Cây lăn bụi quần áo đa năng kèm 2 cục dự phòng",13000,22990,9990,43
TIKI,nha-cua-doi-song,274121764,"Ruột Gối Ôm Gòn Cozy Thuần Việt - Sợi Gòn Cao Cấp, Êm Ái - Kích Thước 20x100",178000,350000,172000,49
TIKI,nha-cua-doi-song,81936300,"BIG SIZE -Túi Đựng Quần Áo Khung Thép 88L: 60x40x35 (cm) Morning House- Gấp gọn tiện lợi, bảo quản quần áo bền đẹp",88000,88000,0,0
TIKI,nha-cua-doi-song,32178097,"Chảo Sâu Lòng NAG2653 Đáy Từ 5 Lớp Chống Dính Vung Kính Siêu Bền Nagakawa (26cm) - Dùng Trên Mọi Loại Bếp - Hàng Chính Hãng",445000,585000,140000,24
TIKI,nha-cua-doi-song,72904497,"Kệ Nhà Tắm Kèm Nhả Kem Đánh Răng Tự Động 2 Cốc OENON Lắp Đặt Dán Tường - OEKEM",159000,300000,141000,47
TIKI,nha-cua-doi-song,193709920,"Bình Đựng Nước 1L Bao Bì Dễ Thương Có Vạch Báo Giờ Uống Nước Chia Lượng Nước Deli - Nhựa Cao Cấp An Toàn Đầy Đủ Kiểm Định Chất Lượng Phủ Hợp Bình Nước Thể Thao Cho Bé Tới Trường - VS822 VS823",109000,196200,87200,44
TIKI,nha-cua-doi-song,70820849,"Pin CR2032 Energizer 3V vỉ 5 viên",80000,100000,20000,20
TIKI,nha-cua-doi-song,241805597,"Móc Dán Tường, Móc Dính Tường Treo Đồ Nặng Siêu Dính Inox 304 - Treo Thớt, Nồi Niêu Xong Chảo, Treo Đồ Đa Năng",12000,12000,0,0
TIKI,nha-cua-doi-song,134621577,"[Nhập CECAMP70KD1 giảm 70k đơn 999k] Bộ Dao 7 Món Lock&amp;Lock CKK301",1559000,2657000,1098000,41
TIKI,nha-cua-doi-song,54483857,"Đèn Bàn Học Đọc Sách, Làm Việc (Học Sinh, Sinh Viên, Văn Phòng) LED Chống Cận, Cảm Ứng Tích Điện Pin 2500mAh Elights BT-618",42000,49000,7000,14
TIKI,nha-cua-doi-song,191820658,"Gối Cao Su Thiên Nhiên Gummi Cookie Thiết Kế Vòm Cong Tối Ưu Giúp Giảm Đau Cổ Vai Gáy Vượt Trội",489000,720000,231000,32
TIKI,nha-cua-doi-song,14981747,"01 hộp đũa Inox 304 cao cấp DandiHome (10 đôi) - Cá chép vượt cổng Vũ Môn",278000,278000,0,0
TIKI,nha-cua-doi-song,74598515,"Đệm ngồi 3D Silicon cao cấp thoáng khí chống đau mỏi - Hàng nhập khẩu",149000,149000,0,0
TIKI,nha-cua-doi-song,100522012,"Cây Lau Nhà Thông Minh, Chổi Lau Nhà 360 Độ Đa Năng (Không Bao Gồm Thùng Vắt) - Parroti MOP-PR01",211000,269000,58000,22
TIKI,nha-cua-doi-song,52006431,"Hộp đựng thìa đũa cá nhân DandiHome (màu ngẫn nhiên)",29000,30000,1000,3
TIKI,nha-cua-doi-song,113458874,"Tủ Để Đồ Thông Minh S Smart Tận Dụng Không Gian Cạnh Cửa Sổ - GP131",406000,444000,38000,9
TIKI,nha-cua-doi-song,176592358,"Cây lau nhà tự vắt đa năng Sunhouse KS-MO3211PW",163000,263000,100000,38
TIKI,nha-cua-doi-song,146509745,"Bộ Hộp Cơm Giữ Nhiệt Văn Phòng Cao Cấp Cắm Điện inox 3 tầng - Chính hãng dododios",218000,218000,0,0
TIKI,nha-cua-doi-song,195968874,"Đèn LED Mini Móc Khóa Siêu Sáng Tiện Dụng US ARMY,  Đèn Pin COB Dã Ngoại Thường Ngày, Sạc TYPE-C Tiện Dụng Dung Lượng PIN 500mAh  Full Hộp Sạc- HÀNG CHÍNH HÃNG",59000,125000,66000,53
TIKI,nha-cua-doi-song,172447892,"Bộ 6 túi giặt siêu dày 3 lớp cao cấp - Combo 6 túi lưới bảo vệ quần áo dùng cho máy giặt siêu bền tiện dụng chính hãng",141000,153000,12000,8
TIKI,nha-cua-doi-song,143217219,"Kệ Đa Năng Lưu Trữ Đồ Dùng, Giá Sách Có Bánh Xe Thương Hiệu IGA - GP173",293000,318000,25000,8
TIKI,nha-cua-doi-song,112760341,"Thùng rác treo tủ bếp có nắp đậy thông minh, thùng rác treo tường dán tường, có thanh trượt cửa bếp – Parroti Bin BN02",156000,299000,143000,48
TIKI,nha-cua-doi-song,579962,"Bộ Nồi 5 Đáy Cao Cấp Núm Vàng Sunhouse SH781 Quay Mạ Vàng Cao Cấp (16cm, 20cm, 24cm) - Dùng Cho Mọi Loại Bếp - Hàng Chính Hãng",675000,960000,285000,30
TIKI,nha-cua-doi-song,134242996,"Ly Nhựa Có Ống Hút Lock&amp;Lock HAP507YEL",100000,217000,117000,54
TIKI,nha-cua-doi-song,51541280,"Hộp Cơm Cắm Điện - Hộp Hâm Nóng Văn Phòng 2 Tầng ArirangLife EL-ALS263 (Hồng) - Hàng chính hãng",422000,749000,327000,44
TIKI,nha-cua-doi-song,128584341,"Ổ cắm đa năng USB Rạng Đông dài 3m Model: OC02.USB 3C/3M/10A",246400,308000,61600,20
TIKI,nha-cua-doi-song,72049662,"Combo 6 Túi Giặt Lưới Bảo Vệ Quần Áo, túi lưới mịn polyester bảo quản quần áo",119700,126000,6300,5
TIKI,nha-cua-doi-song,146432055,"Túi Chân Không Tự Hút Đựng Chăn Mền Quần Áo Không Cần Dụng Cụ Hút",33250,35000,1750,5
TIKI,nha-cua-doi-song,19929974,"Bộ 4 Ống Hút Thủy Tinh Chịu Nhiệt (2 Cong + 2 Thẳng) + 2 Cọ Rửa + 1 Túi Vải",47500,50000,2500,5
TIKI,nha-cua-doi-song,116048764,"Kệ sách tổ ong vân gỗ dễ dàng kết hợp với bàn làm việc chính hãng IGA - GP100",122000,130000,8000,6
TIKI,nha-cua-doi-song,89992214,"Kệ Góc Nhà Tắm INOX 304 dán tường gạch men siêu chắc",69000,125000,56000,45
TIKI,nha-cua-doi-song,52238726,"Mùng Chụp Tự Bung Cao Cấp Siêu Dày - Màu Xanh Da Trời  + Tặng kèm túi thơm thảo dược",140000,210000,70000,33
TIKI,nha-cua-doi-song,53599746,"Combo Giá Treo Ổ Cắm Điện, Modem Dán Tường Tiện Dụng",30400,32000,1600,5
TIKI,nha-cua-doi-song,88925284,"Ổ Cắm Điện LIOA 10 ổ dây 3m(4D6S32) & 5m (4D6S52)",152000,152000,0,0
TIKI,nha-cua-doi-song,163827070,"Combo 2 hộp chia ngăn sắp xếp quần áo phong cách Nhật Bản VINAVU",190000,200000,10000,5
TIKI,nha-cua-doi-song,17488465,"Vỉ 5 viên Pin GP 12V 23A",40000,40000,0,0
TIKI,nha-cua-doi-song,165109465,"Kệ Lò Vi Sóng 2 Tầng, Kệ Nhà Bếp Thương Hiệu IGA - GM52",155000,169000,14000,8
TIKI,nha-cua-doi-song,59259444,"Mùng chụp tự bung cao cấp FUNU - Màn chống muỗi thông minh - Hàng chính hãng (Sản xuất tại Việt Nam)",129675,136500,6825,5
TIKI,nha-cua-doi-song,192258425,"Thảm Chùi Chân 4 Lớp Siêu Thấm Hút Nhiều Hoa Văn Độc Đáo",79000,79000,0,0
TIKI,nha-cua-doi-song,70083074,"Ghế xếp thư giãn SUMIKA 199 - có lăn tay massage, khung vuông cao cấp, tải trọng 300kg",1126000,1580000,454000,29
TIKI,nha-cua-doi-song,169978766,"Túi Hút Chân Không Đựng Quần Áo, Chăn Ga Gối, Thú Bông Deli - Loại Dày Cao Cấp, Nhiều Hoạ Tiết, Bảo Vệ Quần Áo, Chăn Ga Khỏi Ẩm, Nấm Mốc, Chống Nước Tuyệt Đối",14900,26820,11920,44
TIKI,nha-cua-doi-song,71174837,"Đèn Pin Mini Siêu Sáng XML-T6 miDoctor - Chính Hãng",86000,86000,0,0
TIKI,nha-cua-doi-song,45404047,"[ĐẶC BIỆT] Nhang Xanh Trầm Hương Cao Cấp 15 năm -100g - mùi thơm tự nhiên, dịu ngọt của trầm - Nhang Thiền",125000,125000,0,0
TIKI,nha-cua-doi-song,191822621,"Gối Foam Contour Doona Sofy Cấu Trúc Lượn Sóng Nâng Đỡ Định Hình Xương Cổ Và Đầu Hoàn Hảo",339000,600000,261000,44
TIKI,nha-cua-doi-song,199593599,"Kệ Sách Hình Cây Để Sàn",225000,245000,20000,8
TIKI,nha-cua-doi-song,134515126,"Bình giữ nhiệt cho trẻ em LocknLock Cozy Kids Straw Tumbler LHC4236BLU 330ml - Màu",347000,592000,245000,41
TIKI,nha-cua-doi-song,803123,"Thùng rác nhựa Fitis Compact X PPL1-906",280000,350000,70000,20
TIKI,nha-cua-doi-song,270862516,"Gối cao su chống đau cột sống - Gối cao su dành cho người hay ngủ ngáy mỏi cổ vai gáy – Hàng chính hãng",75000,89000,14000,16
TIKI,nha-cua-doi-song,31576989,"Quai xách Dây Dù bình giữ nhiệt 2GOOD Para Handle",65000,65000,0,0
TIKI,nha-cua-doi-song,68716607,"Dao Thái Sunhouse KS-KN165SS",72000,117000,45000,38
TIKI,nha-cua-doi-song,162597633,"Combo 4 miếng dán đỡ kệ gỗ VINAVU, giúp chia ngăn tủ, không cần đóng đinh",22800,24000,1200,5
TIKI,nha-cua-doi-song,75340681,"Hộp Đựng Đồ Đa Năng TD1 – Túi Vải Đựng Quần Áo Chăn Màn Phong Cách Thụy Điển Sang Trọng, Lịch Sự – Hàng Chính Hãng",77000,83000,6000,7
TIKI,nha-cua-doi-song,89980825,"Bộ 2 nhả kem đánh răng tự động OENON, Kệ nhà tắm thông minh kèm cốc láp đặt dán tường - 2NHAKEM",229000,400000,171000,43
TIKI,nha-cua-doi-song,97924113,"Đồng Hồ Báo Thức Dạ Quang Deli - Khung Thép Không Gỉ - 9024",169000,304200,135200,44
TIKI,nha-cua-doi-song,169650796,"Màn chụp, mùng chụp đỉnh vuông Không chân viền cao cấp Một Cửa - Hàng chính hãng (Giao ngẫu nhiên)",255027,268450,13423,5
TIKI,nha-cua-doi-song,114976767,"Nệm foam Goodnight Massage bán chạy số 1 Việt Nam 9cm tại Vua Nệm - Cấu trúc lượn sóng duy trì tư thế tự nhiên của cột sống",2859000,5500000,2641000,48
TIKI,nha-cua-doi-song,54412879,"Lô 4 túi rác tiện dụng Soji - size 10L - 25L và 50L",31000,35000,4000,11
TIKI,nha-cua-doi-song,91475535,"Áo Mưa Cánh Dơi Rằn Ri, Áo Mưa Xẻ Tà Màu Lính Vải Dù Siêu Dày 1M4, Chống Thấm Hiệu Quả, Phù Hợp Nam Và Nữ, Có Túi Đựng",130000,130000,0,0
TIKI,nha-cua-doi-song,57272706,"Combo 200 túi lọc rác bồn rửa bát - Túi lưới lọc rác giúp ngăn chặn tắc đường ống",35000,35000,0,0
TIKI,nha-cua-doi-song,53647975,"1 Gối Ôm thương hiệu A có khóa kéo - an toàn sức khỏe, không chứa chất độc hại - êm ái, mềm mịn - KT",120000,150000,30000,20
TIKI,nha-cua-doi-song,190989483,"Bình giữ nhiệt Baby Inox 316 Elmich EL8017 dung tích 300ml",231000,319000,88000,28
TIKI,nha-cua-doi-song,15343778,"Kệ góc nhà tắm dán tường inox 304 bóng Hobby Home Decor KG1 kèm keo dán và đinh ốc",153000,185000,32000,17
TIKI,nha-cua-doi-song,79267304,"Túi rác tự hủy inochi tiện dụng SOJI có quai xuất nhật Dùng đựng rác gia đình ,Bao đựng rác văn phòng đủ size -màu đen mềm nhẹ dai túi rác tự hủy giúp bảo vệ môi trường",36000,45000,9000,20
TIKI,nha-cua-doi-song,104681179,"Bông Lau Thay Thế MyJae Dạng Tròn Dành Cho Cây Lau Nhà Xoay 360 Độ",95000,200000,105000,53
TIKI,nha-cua-doi-song,185380294,"Lưới Polyester Phủ Chống Thấm, Vải Polyester Gia Cố Chống Thấm Mái Nhà Sàn Nhà Khe Nứt Khổ 10 cm",77350,91000,13650,15
TIKI,nha-cua-doi-song,54132706,"Bộ sạc Energizer Charger kèm 4 pin Ener AA 2000mAh, tự ngắt sạc (CHVCM4) ( Mẫu mới)",460000,460000,0,0
TIKI,nha-cua-doi-song,97817455,"Bộ túi hộp cơm thủy tinh COBA'COOK. Gồm 3 hộp 400ml và 1 túi giữ nhiệt với 2 khóa kéo tiện dụng- CCR43BL",193000,560000,367000,66
TIKI,nha-cua-doi-song,272966734,"Ổ cắm điện 5 lỗ 2m Điện Quang SM750SL - Hàng Chính Hãng",172000,172000,0,0
TIKI,nha-cua-doi-song,137572447,"Bóng đèn LED Bulb PHILIPS Essential E27 - Tiết kiệm điện, Ánh sáng chất lượng cao - Hàng Chính Hãng",39000,66000,27000,41
TIKI,nha-cua-doi-song,95335291,"Combo 10 cặp kẹp dán tường thông minh - Không cần khoan lỗ, đục tường- Chịu lực lên đến 3Kg",55000,55000,0,0
TIKI,nha-cua-doi-song,162360312,"[HÀNG XỊN - CHỌN SIZE] Chiếu điều hòa sợi mây tổng hợp lót vải không dệt cao cấp hàng xuất khẩu 2 mặt giá rẻ 1m2 1m6 1m8 chính hãng",187000,300000,113000,38
TIKI,nha-cua-doi-song,55202824,"Bình Nước Nhựa Nắp Vặn Dây Treo Họa Tiết Hươu Và Trăng Tiện Dụng Phù Hợp Với Mọi Lứa Tuổi 560ml",129000,258000,129000,50
TIKI,nha-cua-doi-song,64618364,"Day Đèn LED Siêu Sáng 5050 RGB Chống Nước Quấn Cây Trang Trí Ngoài Trời",170050,179000,8950,5
TIKI,nha-cua-doi-song,92441037,"[LOẠI XỊN - CÓ TẶNG BƠM TAY] Bộ 8 Túi Hút Chân Không Đựng Quần Áo, Chăn Màn CỠ ĐẠI Cao Cấp - Hàng chính hãng",190000,198000,8000,4
TIKI,nha-cua-doi-song,47163069,"Túi Đựng Chăn Mền Quần Áo Kháng Mốc Cỡ Lớn Nhiều Màu",59850,63000,3150,5
TIKI,nha-cua-doi-song,52238368,"Chiếu điều hòa cao cấp Ánh Sao - Sợi mây tổng hợp + Tặng kèm túi thơm thảo dược - giao mẫu ngẫu nhiên",105000,140000,35000,25
TIKI,nha-cua-doi-song,20103667,"Combo Cọ Rửa Dành Cho Ống Hút Inox và Ống Hút Thủy Tinh",26600,28000,1400,5
TIKI,nha-cua-doi-song,241806648,"Móc Dán Tường Treo Chậu Rổ, Treo Đồ Đa Năng Inox 304 Jodily Sử Dụng Miếng Dán Thế Hệ Mới",20000,20000,0,0
TIKI,nha-cua-doi-song,135321411,"Giấy Bạc Tráng Nhôm, dán bếp tăng thẩm mỹ và rất sạch sẽ(2M)",19000,32399,13399,41
TIKI,nha-cua-doi-song,70316883,"KỆ ĐỂ GIÀY DÉP GỖ THÔNG- Dài 50cm - 2T500",119000,119000,0,0
TIKI,nha-cua-doi-song,68413077,"Đèn đọc sách mini, pin sạc tiện dụng Baseus Comfort Reading Mini Clip Lamp ( Dịu mắt, chân kẹp, 3 mức sáng, 350mAh, 24h sử dụng)hàng nhập khẩu",208000,208000,0,0
TIKI,nha-cua-doi-song,59092666,"MÁY KHUẾCH TÁN TINH DẦU CHUYÊN DỤNG | Vân Gỗ Cao Cấp | Có Điều Khiển Từ Xa | Máy Phun Sương Tỏa Hương Tinh Dầu 500ML Cho Phòng Lớn",229000,478000,249000,52
TIKI,nha-cua-doi-song,58546654,"Đèn Pixar, Đèn Học Chống Cận Thị, Đèn Đọc Sách, Đèn Làm Việc Để Bàn Chống Chói Mắt Lóa Mắt Bảo Vệ Mắt + Bóng Đèn + Chân Kẹp + Chân Đế - Hàng Chính Hãng Amalife",165000,165000,0,0
TIKI,nha-cua-doi-song,51373821,"Đèn bàn học led cảm ứng chính hãng Rạng Đông Model: RD RL 36 LED",203000,203000,0,0
TIKI,nha-cua-doi-song,164479566,"Ghế chỉnh dáng ngồi đúng - Roichen Hàn Quốc (Made in Korea). Dùng cho Nam, Nữ, Trẻ em. Hàng chính hãng",673000,750000,77000,10
TIKI,nha-cua-doi-song,54460849,"Bộ chăn ga gối cotton LIDACO PL1 - Caro Nâu (SP000661)",199000,280000,81000,29
TIKI,nha-cua-doi-song,75659112,"Kệ Sách Tổ Ong IGEA Đa Tầng Convent 234F - GP100",123000,135000,12000,9
TIKI,nha-cua-doi-song,114621700,"Kệ để hồ sơ văn phòng tiện lợi, kệ sách để bàn nhỏ gọn gỗ MDF chống ẩm chất lượng cao",171000,171000,0,0
TIKI,nha-cua-doi-song,71925401,"Đèn Bàn Học Đọc Sách, Đèn Bàn Làm Việc Sang Trọng, Đèn Ngủ Cao Cấp (Học Sinh, Sinh Viên, Văn Phòng) LED Chống Cận 03 Mức Độ Sáng, Cảm Ứng Tích Điện Pin 2500mAh - Hàng Chính Hãng - VinBuy",186000,260000,74000,28
TIKI,nha-cua-doi-song,193708669,"Bình Đựng Nước 2L Kèm Ống Hút Bao Bì Dễ Thương Có Vạch Báo Giờ Uống Nước Chia Lượng Nước Deli - Bình Nước 2 Lít Nhựa Cao Cấp An Toàn Đầy Đủ Kiểm Định Chất Lượng Phủ Hợp Bình Nước Thể Thao Cho Bé Tới Trường - VS818 VS819",89000,160200,71200,44
TIKI,nha-cua-doi-song,53830678,"1 cặp ruột gối hơi cao cấp - Gòn bông nhân tạo an toàn sức khỏe, không chứa chất độc hại - Có khóa kéo dễ dàng thêm bớt gòn bên trong - Êm ái, mềm mịn",58000,65000,7000,11
TIKI,nha-cua-doi-song,263990262,"Lọ xay tiêu Inox 304 DandiHome cao cấp",53000,65000,12000,18
TIKI,nha-cua-doi-song,30008695,"Vĩ 5 viên pin Maxell dòng cao cấp CR2032",17000,22030,5030,23
TIKI,nha-cua-doi-song,117195930,"Pin Maxell Super Đỏ - Hộp 40 Viên Pin Tiểu AA (2A) 1.5V",97000,97000,0,0
TIKI,nha-cua-doi-song,169919224,"Kệ Để Kem Đánh Răng & Bàn Chải, Tặng Kèm Cốc - Kệ Nhà Tắm Dán Tường Thông Minh - Giá Treo Bàn Chải Đánh Răng Kiêm Để Đồ & Úp Cốc - Giao Màu Ngẫu Nhiên [HÀNG CHÍNH HÃNG",99000,120000,21000,18
TIKI,nha-cua-doi-song,52789105,"Đế Bình Giữ Nhiệt Silicone Boot 2GOOD Flask 900ml",50000,50000,0,0
TIKI,nha-cua-doi-song,19867726,"Võng lưới mềm dày 99, gỗ 50 (Giao màu ngẫu nhiên)",225000,350000,125000,36
TIKI,nha-cua-doi-song,263488472,"Tủ kệ sách để bàn H6689 nhiều màu tiện ích ( Ngẫu nhiên )",62000,62000,0,0
TIKI,nha-cua-doi-song,67650750,"Đệm ngồi lót ghế làm từ hợp chất TPE, thoáng khí, hỗ trợ tuần hoàn máu, chống ê mông, mỏi lưng - Thương hiệu Nhà của Mẹ- giao màu ngẫu nhiên",133000,160000,27000,17
TIKI,nha-cua-doi-song,135442410,"Máy Đo Khoảng Cách Laser Deli Chính Hãng Loại 40m / 50m / 60m Đa Năng - Dễ Dàng Sử Dụng Từ Xa - DL331050P / EDL4168",464000,896000,432000,48
TIKI,nha-cua-doi-song,163304843,"Máy phun rửa áp lực cao Karcher K2 Classic ",1936000,2390000,454000,19
TIKI,nha-cua-doi-song,117645437,"Ổ cắm điện LiOA đa năng kết hợp - 2D2S, 3D3S, 4D6S dây dài 3m/5m - Ổ cắm điện Lioa Chính Hãng",96000,96000,0,0
TIKI,nha-cua-doi-song,42740561,"Bộ Hộp Thủy Tinh Vuông HappyCook 3pcs 520ml HCG-03SBE",195000,329000,134000,41
TIKI,nha-cua-doi-song,178101136,"Bơm điện 2 chiều bơm và hút chân không cao cấp miDoctor",101000,180000,79000,44
TIKI,nha-cua-doi-song,141201958,"Ly Giữ Nhiệt Cà Phê Có Tay Cầm Nắp Trượt Chống Tràn Rinfere (415ml)",287000,449000,162000,36
TIKI,nha-cua-doi-song,188375839,"Khăn tắm Khăn lau mặt Cotton 100% Mềm Êm Dày dặn Màu trơn Nhấn viền họa tiết 74x33cm",49000,49000,0,0
TIKI,nha-cua-doi-song,143002904,"Ổ  điện đa năng shoptida hình tháp nhiều tầng T8/ T12 chịu tải 3600W, an toàn chống cháy chống giật, dây dài 3m và 4m",579000,579000,0,0
TIKI,nha-cua-doi-song,111410597,"Kính bảo hộ Honeywell A700 Mắt kính chống bụi, chống tia UV, chống trầy xước, đọng sương",65000,65000,0,0
TIKI,nha-cua-doi-song,78633940,"Máy Sấy Và Khử Trùng Giày Xiaomi Youpin SOTHING DSHJ-S-1904 có hẹn giờ",259000,269000,10000,4
TIKI,nha-cua-doi-song,125771437,"Khay nướng Bít-tết Phụ kiện nồi chiên không dầu 2GOOD ",380000,380000,0,0
TIKI,nha-cua-doi-song,72459016,"Bộ Nhả Kem Đánh Tự Động OENON, Kệ Treo Bàn Chải Nhà Tắmg Dán Tường Kèm Cốc Hút Từ Tính - OEKEM",99000,190000,91000,48
TIKI,nha-cua-doi-song,58469713,"Dây đèn nháy led đom đóm trang trí dùng pin nhiều màu, bóng đèn nháy fairy light cao cấp décor phòng, nhà cửa, tết (Tùy chọn chiều dài dây)",115000,115000,0,0
TIKI,nha-cua-doi-song,14764119,"Ly Giữ Nhiệt Nắp Trượt Chống Tràn Rinfere - Tặng Kèm Ống Hút Không Gỉ, Dụng Cụ Vệ Sinh Ông Hút (590ml)",269000,299000,30000,10
TIKI,nha-cua-doi-song,195469953,"Súng Bắn Keo (Cỡ Lớn/Nhỏ) Kèm 10 Keo Nến Silicon",95000,100000,5000,5
TIKI,nha-cua-doi-song,5146283,"Ấm đun nước Inox 304 Elmich 3L EL3373 dùng bếp từ",643000,890000,247000,28
TIKI,nha-cua-doi-song,190491180,"Túi Hút Chân Không Mặt Nhám Crénot Joice M5 Bảo Quản Thực Phẩm An Toàn 1 Cuộn 500cm",85000,85000,0,0
TIKI,nha-cua-doi-song,68513020,"Combo 3 hộp đựng đồ cao cấp Việt Nam phong cách Nhật (38x25xH25cm) Storage Box",199500,210000,10500,5
TIKI,nha-cua-doi-song,116185291,"Nhiệt ẩm kế cơ học TANAKA TH101E Chính hãng nhật,nhiệt ẩm kế cơ theo công nghệ nhật bản,đồng hồ đo ẩm kế chính xác,nhiệt ẩm kế phòng,nhiệt ẩm kế sử dụng cho trẻ sơ sinh,nhiệt ẩm kế treo tường ",115000,140000,25000,18
TIKI,nha-cua-doi-song,57971649,"Bộ 2 chảo Lock&Lock Easy Frypan 2P Set, Chảo 1 tay cầm 24cm + Chảo lòng sâu 26cm (LEY1243 x 1, LEY1265 x 1) LEY1243S2",283000,593000,310000,52
TIKI,nha-cua-doi-song,19590366,"Kệ Đa Năng Inochi B4 (45,5 x 26,0 x 44,7 cm)",72000,80000,8000,10
TIKI,nha-cua-doi-song,195980111,"Bình giữ nhiệt LocknLock LHC3275 - 490ML - Hàng chính hãng",293000,490000,197000,40
TIKI,nha-cua-doi-song,41318920,"Bộ chặn cửa chống va đập nam châm hít cửa dán sàn Hobby Home Decor CC1 inox 304 kèm keo dán sàn",88000,94500,6500,7
TIKI,nha-cua-doi-song,54133235,"Pin Sạc AA 2000mAh NH15 Power Plus RP2 Energizer NH15 RP2 (Mẫu mới)",160000,160000,0,0
TIKI,nha-cua-doi-song,272452316,"Bộ Lau Nhà MyJae Đài Loan Sợi Fiber Xoay 360 Độ Thông Minh 125cm",429000,1200000,771000,64
TIKI,nha-cua-doi-song,13287995,"Cây gãi lưng chỉnh độ dài có đầu gãi bằng PVC ",18000,18000,0,0
TIKI,nha-cua-doi-song,75478111,"Bộ tượng 04 chú tiểu trang trí xe hơi, bàn làm việc, mang lại bình an, hạnh phúc",41400,45000,3600,8
TIKI,nha-cua-doi-song,177171936,"Ly thuỷ tinh đổi màu Luminarc Lille Scale Giraffe 425ml - LUSCQ3808",155000,155000,0,0
TIKI,nha-cua-doi-song,181909422,"Chảo Sâu Lòng Suit LocknLock CSU1225PIK – 22cm - Màu Pink",344000,677000,333000,49
TIKI,nha-cua-doi-song,159971094,"Bộ 2 hộp vải đựng đồ 7 ngăn mã HQ2 - Combo 2 hộp vải đựng quần áo chia ngăn gọn gàng tiện lợi chất vải Oxford cao cấp miDoctor",156000,250000,94000,38
TIKI,nha-cua-doi-song,185647202,"Tranh Cát Chảy Chuyển Động 3D KUNBE Nhiều Mẫu Trang Trí Nhà Cửa Bàn Làm Việc, Giảm Stress",168000,168000,0,0
TIKI,nha-cua-doi-song,68187835,"Bộ dụng cụ di chuyển đồ vật nặng trong nhà thông minh KIOTOOL tải trọng 600kg chuyên dụng di chuyển don nhà - Màu ngầu nhiên",285000,285000,0,0
TIKI,nha-cua-doi-song,275044260,"Tấm trải tiện ích Everon Lite (Giao màu ngẫu nhiên)",316000,395000,79000,20
TIKI,nha-cua-doi-song,50294624,"Lưới Đèn LED Chống Nước Trang Trí Ngoài Trời Cho Giánh Sinh, Tiệc, Lễ Tết - Nhiều kích cỡ",119000,119000,0,0
TIKI,nha-cua-doi-song,117318253,"Nệm xếp đa năng Goodnight 70x180cm, Nệm gấp văn phòng, Nệm xếp 3 thiết kế gọn nhẹ, kèm túi đựng (Giao màu ngẫu nhiên)",456000,570000,114000,20
TIKI,nha-cua-doi-song,73640967,"Miếng lau nhà thay thế Bộ lau nhà KITIMOP-C6 PLUS ( 33 x 12cm)",15000,19000,4000,21
TIKI,nha-cua-doi-song,15444566,"Kệ đựng xà bông dán tường phòng tắm Hobby Home Decor SBL2 có miếng dán gạch men",68000,68000,0,0
TIKI,nha-cua-doi-song,94847014,"Nến thơm trang trí phong cách hoa khô thảo mộc",125000,125000,0,0
TIKI,nha-cua-doi-song,37495650,"Kệ Sách Để Sàn Cao Cấp 11 Tầng Bằng Gỗ MDF Phủ Melamin Chống Nước, Chống Xước - Hàng Chính Hãng",400000,439000,39000,9
TIKI,nha-cua-doi-song,32021492,"Ổ Khóa Số Du Lịch Stanley S742-054",138000,167000,29000,17
TIKI,nha-cua-doi-song,115972789,"HỘP ĐỰNG TÚI ĐỰNG QUẦN ÁO KHUNG THÉP 66L- LIVING BOX 66L- Dài 50x Rộng 40x Cao 33.5 cm",85000,85000,0,0
TIKI,nha-cua-doi-song,12736380,"Đồng hồ để bàn led báo thức thông minh",190000,200000,10000,5
TIKI,nha-cua-doi-song,98153708,"Chậu Gội Đầu Tại Giường KUNBE, Chậu Gội Đầu Tại Nhà Thông Minh Cho Mọi Người - Tặng Lược Massage Và Cốc Gội Đầu",199000,199000,0,0
TIKI,nha-cua-doi-song,54682452,"Pin vuông 9V Energizer 522 ALKALINE chính hãng ( Mẫu mới )",60000,60000,0,0
TIKI,nha-cua-doi-song,42491736,"Bút thử nước TDS, dụng cụ đo TDS, máy đo độ cứng của nước - Hàng chính hãng",118000,135000,17000,13
TIKI,nha-cua-doi-song,194465292,"Bình giữ nhiệt LocknLock DIY Strap Tumbler LHC3283 350ml",252000,489000,237000,48
TIKI,nha-cua-doi-song,181909427,"Nồi 2 Tay Cầm Suit LocknLock CSU1202PIK - Màu Pink",565000,1112000,547000,49
TIKI,nha-cua-doi-song,75044183,"Đèn Đọc Sách Cao Cấp - Đèn Bàn Làm Việc Sang Trọng - Đèn Ngủ - Đèn Trang Trí - Có Thể Gập Hai Chỗ – 03 Chế Độ Ánh Sáng Vàng Bảo Vệ Mắt Chống Cận Pin Sạc - Hàng Chính Hãng - VinBuy",195000,300000,105000,35
TIKI,nha-cua-doi-song,75411116,"Lót chân ghế, miếng dán chống trầy, chống rung lắc bàn ghế - Hàng chính hãng",23000,25000,2000,8
TIKI,nha-cua-doi-song,80757840,"Combo 3 hộp vải đựng đồ đa năng TD2 – Bộ 3 túi vải Thụy Điển không nắp tiết kiệm sang trọng dung tích 24L mỗi hộp - chính hãng",147000,220000,73000,33
TIKI,nha-cua-doi-song,185004372,"Ly Thủy Tinh Phong Cách Bắc Âu Đế Xoay 170ml - Navivu Rock Glass",34200,36000,1800,5
TIKI,nha-cua-doi-song,781987,"Gối Memory Foam 50D Lock & Lock HLW114 (61 x 34 x 10 cm)",474000,791000,317000,40
TIKI,nha-cua-doi-song,74859074,"Chuông Cửa Không Dây Thông Minh CTFAST CT - 01 (1 Nút Bấm, 1 Chuông ), Chống Nước, Khoảng Cách Sử Dụng Hiệu Quả 300 mét - Hàng Chính Hãng",145000,145000,0,0
TIKI,nha-cua-doi-song,68521325,"Trung Nguyên Legend - Phin nhôm hoa văn Trống Đồng",49000,49000,0,0
TIKI,nha-cua-doi-song,118451214,"Ổ cắm điện LiOA đa năng - Ổ on/off 4 lỗ, 6 lỗ mỗi ổ 1 công tắc dây dài 3m",165000,165000,0,0
TIKI,nha-cua-doi-song,181223364,"Bộ vòi xịt vệ sinh toilet kèm giá treo và dây lò xo co giãn HOBBY Home Decor VSR2 inox 304 ren chờ 21mm",143000,229000,86000,38
TIKI,nha-cua-doi-song,81936258,"Hộp đựng quần áo gấp gọn có nắp Màu kem Morning House  - SIZE S",50000,50000,0,0
TIKI,nha-cua-doi-song,106338289,"Dép Lỗ Đi Trong Nhà Tắm Chống Trơn Trượt Nhanh Khô, Thoáng Mát, Mẫu Mới Nhất. Dép Cho Cả Gia Đình",155000,155000,0,0
TIKI,nha-cua-doi-song,77962744,"Kệ nhà tắm, kệ dán tường đựng đồ nhà tắm, đồ bếp, nhà vệ sinh, siêu chịu lực, (không dán lên tường sơn nước, sơn vôi) - Giao màu ngẫu nhiên",41400,45000,3600,8
TIKI,nha-cua-doi-song,59425995,"Bộ Ga Gối Cotton Tici Kẻ LIDACO Cao Cấp - Kẻ Cam Ghi",159000,229000,70000,31
TIKI,nha-cua-doi-song,7202377,"Bộ 3 Lõi Lọc Nước Máy Tiêu Chuẩn Barrier",473000,660000,187000,28
TIKI,nha-cua-doi-song,32178075,"Bộ 3 Nồi Inox Cao Cấp 4 Đáy Nagakawa NAG1304 (16cm, 20cm, 24cm) Dùng Cho Mọi Loại Bếp - Hàng Chính Hãng",500000,700000,200000,29
TIKI,nha-cua-doi-song,75354717,"Tủ Quần Áo 2 Buồng 6 Ngăn Tiện Lợi, Tủ Vải 170cm Chất Lượng Cao Chắc Chắn, Vững Chãi - Hàng Chính Hãng miDoctor",330000,415000,85000,20
TIKI,nha-cua-doi-song,59238383,"Vòi nước đa năng 2 đầu đồng mạ chorme cao cấp mẫu mới 2024 (Hàng chính hãng)",156000,185000,29000,16
TIKI,nha-cua-doi-song,72829989,"Lá diệp phật - Ngọc Quý Gemstones",39000,39000,0,0
TIKI,nha-cua-doi-song,189157824,"Bộ 8 túi hút chân không tặng kèm bơm hút chân không đựng quần áo, chăn màn, ga gối gọn gàng D Danido",182000,198000,16000,8
TIKI,nha-cua-doi-song,134360720,"Bộ 8 Pin AAA ( R03NT/2S ) Panasonic 1,5V Không Chì - Hàng Chính Hãng",40000,45000,5000,11
TIKI,nha-cua-doi-song,191918107,"Bình lắc LocknLock Balance Shake It Bottle HAP949BLK 800ml - Màu",137000,267000,130000,49
TIKI,nha-cua-doi-song,7699064,"Chảo Nhôm Sâu Lòng Chống Dính Lock&Lock Baum Marble 1 Tay Cầm, Nắp Thủy Tinh LBU1285 (28cm)",395000,776000,381000,49
TIKI,nha-cua-doi-song,73464817,"Kệ gia vị dán tường dài 30/40/50cm sơn đen tĩnh điện Vando chính hãng - kèm keo chuyên dụng kệ treo tường bằng thép carbon không gỉ, siêu chịu lực 30kg",79000,141000,62000,44
TIKI,nha-cua-doi-song,105374376,"Bộ Lõi Lọc Khử Mùi Hôi Lỗ Thoát Sàn Cao Cấp MIFAN - Ngăn chặn mùi hôi cống, chống côn trùng lỗ thoát nước nhà tắm, vệ sinh, bồn rửa - Mẫu mới 2024",29000,50000,21000,42
TIKI,nha-cua-doi-song,88914388,"Bộ 04 chân đế cao su chống rung máy giặt - HT SYS - Đế chống rung máy giặt - Đế chống ồn máy giặt, máy sấy,tủ lạnh, bàn ghế + Sét 3 móc dính dán tường vàng tài lộc HT SYS",73000,77000,4000,5
TIKI,nha-cua-doi-song,73314056,"Lọ xay tiêu cầm tay nắp viền inox 304 lọ thủy tinh Hobby Home Decor XT mẫu thon cao và mẫu thấp tùy chọn",53000,68000,15000,22
TIKI,nha-cua-doi-song,102508672,"Thùng Đựng Rác Thông Minh E1906, Nắp Đóng Mở Một Chạm Tiện Ích, Chất Liệu Nhựa Cao Cấp Chống Nước, Chịu Nhiệt Tốt, Dung Tích 10 Lít - Hàng Nhập Khẩu",220000,360000,140000,39
TIKI,nha-cua-doi-song,42759652,"Chốt cửa dây xích an toàn inox 304 gắn cửa HOBBY Home Decor KLC1 bảo vệ phòng cho chung cư phòng ngủ không rỉ sét",81000,129000,48000,37
TIKI,nha-cua-doi-song,38462026,"Đèn Led Trang Trí Bóng Tròn Dài 3M - 20 Bóng Trang Trí Noel Lễ Tết",42750,45000,2250,5
TIKI,nha-cua-doi-song,87966539,"Sọt rác lưới tròn 26x23x18.5cm - Màu Ngẫu Nhiên",87000,120000,33000,28
TIKI,nha-cua-doi-song,87982701,"Pin Nút Áo CR2032 BR2032 DL2032 ECR2032 Lithium 3V CR 2032 220mAh (5 Viên) Pin Cho Đồng Hồ Điện Tử/ Đồ Chơi Điều Khiển Từ Xa/ Đèn Xe Đạp",27000,27000,0,0
TIKI,nha-cua-doi-song,104681142,"(Chọn Loại) Túi Zip PE Trong Suốt 2 Đường Kéo MyJae, Túi Bọc Đồ Ăn, Rau Củ Bảo Quản Trong Tủ Lạnh",63000,99000,36000,36
TIKI,nha-cua-doi-song,20104505,"Hộp 3 ống hút inox và cọ rửa",42900,42900,0,0
TIKI,nha-cua-doi-song,657076,"Màng Bọc Thực Phẩm PE Ringo 150 (30cm x 150m)",103000,103000,0,0
TIKI,nha-cua-doi-song,90530495,"Đèn Pixar, Đèn Bàn Học Chống Cận Thị, Đèn Đọc Sách, Đèn Làm Việc Bảo Vệ Mắt - Hàng Chính Hãng Moontronics MT01",179000,179000,0,0
TIKI,nha-cua-doi-song,169696716,"Bình Đựng Nước 2L Dễ Thương Kèm Ống Hút , Có Vạch Báo Giờ Uống Nước - Hàng Loại 1 Chính Hãng",124000,218000,94000,43
TIKI,nha-cua-doi-song,174262175,"Bát Sen Tắm Của Vòi Tắm Hoa Sen Nóng Lạnh Pimisi Với Tay Sen Bằng Nhựa Cao Cấp Mạ Xi Cr/Ni Màu Inox Sáng Bóng Kiểu Vuông Bo Tròn Góc - Ổn Định Nhiệt Độ Nước Nóng Lạnh Theo Công Nghệ Đầu Phun Tăng Áp Dạng Phun Mưa Tiết Kiệm Nước | Hàng Chính Hãng",124000,200000,76000,38
TIKI,nha-cua-doi-song,55465365,"Pin Max 8 + 4 Viên Energizer E92 BP8+4 AAA - Hàng Chính Hãng Model 2020",136000,136000,0,0
TIKI,nha-cua-doi-song,205819517," Bóng đèn Led thông minh Xiaomi Yeelight Bulb W3 đui xoắn E27 (RGB 16 triệu màu) - tích hợp Razer Chroma",265000,350000,85000,24
TIKI,nha-cua-doi-song,185654331,"Hộp, Lọ, Hũ Thủy Tinh Nắp Gỗ JIMMEAL 200ml 350ml 500ml 750ml 1000ml 1200ml 1600ml",32000,32000,0,0
TIKI,nha-cua-doi-song,67416013,"CỐC GIỮ NHIỆT ELMICH INOX 304 470ML EL3668",246000,399000,153000,38
TIKI,nha-cua-doi-song,11341623,"Hộp 40 viên pin 2A Maxell",130000,130000,0,0
TIKI,nha-cua-doi-song,3677753,"Bình Lọc Nước BRITA Flow Basic Blue - 8.2L (Kèm Maxtra Plus) - Hàng Chính Hãng",2499000,2499000,0,0
TIKI,nha-cua-doi-song,76119803,"Bộ ga giường Everon Lite ELM 102 Microfiber Xám (4 món) 160x200cm",500000,770000,270000,35
TIKI,nha-cua-doi-song,142261128,"Đệm Lót Ghế Ngồi NOOZ Home Goods Gối Lót Ghế Ngồi Bệt Memory Foam Giúp Chống Đau Lưng, Đau Xương Cụt, Đau Thần Kinh Tọa Ruột Đệm Cao Su Non Danh Cho Dân Văn Phòng",329000,450000,121000,27
TIKI,nha-cua-doi-song,127693039,"1Kg, 5Kg, 10Kg, 18Kg Keo Sơn Chống Thấm Sàn Mái Lộ Thiên TAIKO NITTON (Gốc Acrylic) - Tặng Kèm Vải Kết Cấu Và Chổi Lăn Sơn - Chống Thấm Sàn Mái, Máng Xối, Ban Công Lô Gia, Bể Nước, Bể Cá, Bề Mặt Cát Xi Măng (Hiệu quả hơn khi pha với Xi Măng",199000,320000,121000,38
TIKI,nha-cua-doi-song,74615464,"Phin pha cà phê nhôm Trung Nguyên( Không Hoa Văn)",30000,30000,0,0
TIKI,nha-cua-doi-song,7699062,"Chảo Nhôm Chống Dính Lock&Lock Baum Marble 1 Tay Cầm LBU1283C (28cm)",294000,567000,273000,48
TIKI,nha-cua-doi-song,141971329,"Túi Đựng Hộp Cơm Grepaco Giữ Nhiệt Nóng Lạnh Dạng Đứng Có Ngăn Phụ Đựng Đồ Thức Ăn Văn Phòng, Du Lịch – Vải Bố Canvas, Kích Thước Size Vừa, Kiểu Giỏ Xách Thời Trang Nam Nữ - Tặng Túi Đựng Muỗng Nĩa - Hàng Chính Hãng",69000,69000,0,0
TIKI,nha-cua-doi-song,187622257,"Bộ 3 Kệ Trang Trí Treo Góc Tường SIB DECOR Hình Cung Tròn",149000,149000,0,0
TIKI,nha-cua-doi-song,84953200,"Kệ đựng dụng cụ rửa chén dán tường Hobby Home Decor KRC6 inox 304 có miếng dán",172000,177000,5000,3
TIKI,nha-cua-doi-song,155546820,"Hộp nhựa đựng thực phẩm tủ lạnh 2 lớp Homepower ghi chú thời gian bảo quản thông minh kèm rổ thoát nước tiện lợi - Cao cấp",299000,299000,0,0
TIKI,nha-cua-doi-song,274121804,"Ruột Gối Ôm Lông Vũ Thuần Việt - Sợi Lông Vũ Nhân Tạo Microfiber Êm Ái Mềm Mịn - KT 20x100cm",310000,550000,240000,44
TIKI,nha-cua-doi-song,181909425,"Nồi 1 Tay Cầm Suit LocknLock CSU1181PIK (18cm) - Màu Pink",480000,945000,465000,49
TIKI,nha-cua-doi-song,149959628,"Cmbo 6 Cuộn Túi Đựng Rác Gia Đình, Bao Đựng Rác Văn Phòng, Trường Học Tiện Lợi Màu Đen Đầy Đủ 3 Size Tiểu Trung Đại - Chính Hãng MINIIN",45000,45000,0,0
TIKI,nha-cua-doi-song,116244976,"Túi Đựng Hộp Cơm Grepaco Giữ Nhiệt Nóng Lạnh Đựng Đồ Thức Ăn Văn Phòng, Du Lịch – Vải Bố Canvas, Kích Thước To (Cỡ Lớn), Kiểu Dáng Giỏ Xách Thời Trang Nam Nữ - Tặng Túi Đựng Muỗng Nĩa",149000,149000,0,0
TIKI,nha-cua-doi-song,87637536,"Máy Diệt Muỗi Cao Cấp, Diệt Côn Trùng, Kiêm Đèn LED Ngủ Thông Minh, Thân Thiện Với Môi Trường - Hàng Chính Hãng - VinBuy",45000,80000,35000,44
TIKI,nha-cua-doi-song,105026602,"Chuông báo động, còi báo động dành cho người lớn tuổi, người bệnh ",231570,249000,17430,7
TIKI,nha-cua-doi-song,11710987,"Combo 10 cuộn keo lụa vặn ren vòi nước, ren ống cao cấp (Cao su non, băng tan) ",29000,38000,9000,24
TIKI,nha-cua-doi-song,198214329,"Combo 2 bộ chuyển đổi 3 chấu thành 2 chấu phích tròn Barwell - Chính hãng, giao màu ngẫu nhiên",23750,25000,1250,5
TIKI,nha-cua-doi-song,113899477,"Đèn học để bàn, đèn đọc sách LED tích điện di động Homepower gập 2 chỗ - 3 chế độ ánh sáng vàng bảo vệ mắt, chống cận Pin 2500mAh",179000,179000,0,0
TIKI,nha-cua-doi-song,149242704,"Combo 20 Móc treo ảnh gắn tường, móc treo ảnh cưới ôm sát tường decor rất đẹp, không cần khoan đục - Hàng chính hãng",32200,35000,2800,8
TIKI,nha-cua-doi-song,140791193,"Bóng đèn LED Bright PHILIPS E27 - Thay thế hoàn hảo cho bóng đèn Compact - Hàng Chính Hãng",56000,90000,34000,38
TIKI,nha-cua-doi-song,72615961,"Dây đèn led đom đóm trang trí decor phòng, du lịch cắm trại, fairy light cao cấp (tùy chọn loại nguồn cấp, chiều dài dây và màu sắc)",23000,23000,0,0
TIKI,nha-cua-doi-song,157511267,"Ổ Cắm Thông Minh 16A - Ổ Cắm Wifi Rạng Đông 3500W - Chức Năng Hẹn Giờ, Điều Khiển Từ Xa Bằng Điện Thoại ",189000,189000,0,0
TIKI,nha-cua-doi-song,58014281,"Giá treo móc phơi, kẹp quần áo cho gọn loại lớn Inox 304 dán tường gạch men - kèm keo dán sealant fix - HOBBY GPM3",122000,133000,11000,8
TIKI,nha-cua-doi-song,73887002,"Đèn Ngủ Cảm Ứng Cảm Biến Dán Tường Sạc Pin USB Đời Mới",76000,80000,4000,5
TIKI,nha-cua-doi-song,72041730,"Bộ Dao 6 Món Lock&Lock (4 Dao, 1 Kéo, 1 Hộp Đựng Dao) CKK802",517000,996000,479000,48
TIKI,nha-cua-doi-song,167954128,"BỘ LAU NHÀ TRÒN XOAY 360 ĐỘ MẪU MỚI",190000,350000,160000,46
TIKI,nha-cua-doi-song,272298582,"Bóng đèn bắt muỗi ( dùng để thay thế bóng khi bóng chính bị hỏng)",68000,68000,0,0
TIKI,nha-cua-doi-song,32072094,"Dầu neem hữu cơ DOCNEEM phòng trị sâu bệnh hoa hồng, phong lan, cây cảnh, dầu neem oil nguyên chất ép lạnh 100ml",150000,150000,0,0
TIKI,nha-cua-doi-song,145767958,"Set 3 hộp tròn đựng thực phẩm tủ lạnh, bảo quản thực phẩm có lót đáy ráo nước, van thoát khí PET Xuất Khẩu EU",299000,299000,0,0
TIKI,nha-cua-doi-song,192975755,"Kệ Gỗ Trang Trí Treo Tường Không Cần Khoan - Tặng Kèm Móc Treo Inox Và Phụ Kiện",95000,110000,15000,14
TIKI,nha-cua-doi-song,49100347,"Cây massage đa chức năng: gãi lưng , đấm lưng , massage đầu, tay, chân, vai tặng kèm móc treo siêu dính (màu ngẫu nhiên)",31000,31000,0,0
TIKI,nha-cua-doi-song,718885,"Thùng rác nhựa Fitis Compact PPS1-904 - xanh xám - 10L",232000,290000,58000,20
TIKI,nha-cua-doi-song,197826403,"Bình Đựng Nước 2L Có Vạch Báo Giờ Uống Nước",89000,89000,0,0
TIKI,nha-cua-doi-song,58679667,"Chuỗi dây đèn led gương trang điểm 10 bóng 5 màu điều chỉnh",236550,249000,12450,5
TIKI,nha-cua-doi-song,149376396,"Túi peva SmileBox size lớn bọc nhiều bộ quần áo treo tủ chống thấm, chống bụi, có khóa kéo đôi tiện lợi nhiều size ngắn dài 90cm 110cm- Hàng chính hãng",105000,105000,0,0
TIKI,nha-cua-doi-song,99099494,"Bóng Đèn LED 38W COMET Bulb Fighter CB02F0386 Ánh Sáng Trắng - Hàng Chính Hãng",164000,164000,0,0
TIKI,nha-cua-doi-song,66903798,"Remote Điều Khiển Từ Xa Cho Quạt SenkoTR1428, TR1628, DR1608 – Hàng Chính Hãng",69000,69000,0,0
TIKI,nha-cua-doi-song,26334551,"Mền dù cao cấp  - mỏng nhẹ - thoáng mát - Cho giấc ngủ dễ chịu [chăn ga gối đệm",160000,180000,20000,11
TIKI,nha-cua-doi-song,15605817,"Bộ Dao Nhà Bếp 5 Món Cookplus Lock&Lock CKK101S5BLK",149000,292000,143000,49
TIKI,nha-cua-doi-song,135442243,"Bộ Lục Giác Deli Đầu Bằng Chữ L Cao Cấp - Kiểu Dáng Nhỏ Gọn Giúp Người Dùng Cầm Nắm, Thao Tác Dễ Dàng DL230008 DL230009",22000,46800,24800,53
TIKI,nha-cua-doi-song,71518280,"Đèn Led Thanh 8 Bóng Để Bàn Đầu Gắn Ngõ USB Dự Phòng 4W (0.5W/led) Siêu Sáng",14000,14000,0,0
TIKI,nha-cua-doi-song,75836319,"Phân bón hữu cơ Kích Hoa cho Hoa hồng, Hoa lan, cây cảnh, cây kiểng trong nhà và ngoài trời, giàu lân giúp phân nhánh nụ, hoa, giảm chồi điếc, dung tích 1 lít, chính hãng DOCNEEM",119000,119000,0,0
TIKI,nha-cua-doi-song,144590196," Kéo Nhật Nhà Bếp Cắt Gà Cắt Đồ Đa Năng Jodily - Hàng Chính Hãng ",105000,105000,0,0
TIKI,nha-cua-doi-song,72016703,"Bếp Nướng Than Hoa Phiên Bản Cải Tiến Loại Dài 2023 Chống Cháy Thực Phẩm, An Toàn Sức Khỏe, Không Cần Quạt, Bếp Nướng Không Khói, Bếp Nướng Ngoài Trời, Bếp Nướng Than Hoa Vuông",199000,199000,0,0
TIKI,nha-cua-doi-song,162424714,"Khay Giấy Bạc, Khay Bạc Đựng Thực Phẩm Lót Nồi Chiên Không Dầu Chịu Nhiệt Cao - Hàng Loại 1 - Chính Hãng MINIIN",52000,52000,0,0
TIKI,nha-cua-doi-song,4355547,"Bộ lọc nước thô đầu nguồn 3 cấp lọc 10inch Yamato YMTH10-3TX",339000,385000,46000,12
TIKI,nha-cua-doi-song,50241058,"Kệ sách gỗ để bàn - Tủ,kệ sách mini - Giao màu sắc ngẫu nhiên ",80000,82000,2000,2
TIKI,nha-cua-doi-song,143001862,"Ổ cắm điện đa năng shoptida có sạc nhanh PD 20W cổng USB+TYPEC, có 4-6 lỗ cắm tải 2500W, 1 đổi 1 15 tháng",250000,250000,0,0
TIKI,nha-cua-doi-song,93760107,"Dây đèn trang trí ngoài trời chống nước dùng cho quán cà phê, trà chanh, trà sữa đuôi đèn chống nước -thương hiệu Kiotool",103000,103000,0,0
TIKI,nha-cua-doi-song,188769126,"Chuông cửa không dây thông minh CACAZI A10, chống nước khoảng cách sử dụng trong 300M, 60 loại nhạc chuông, 110 DB",185000,185000,0,0
TIKI,nha-cua-doi-song,185004559,"Ly Thủy Tinh Hoa Văn Navivu Vintage Glass 300 - 350ml",45000,45000,0,0
TIKI,nha-cua-doi-song,42718737," Đèn Led Trang Trí Bóng Tròn Dài 6M - 40  Bóng Trang Trí Noel Lễ Tết",76000,80000,4000,5
TIKI,nha-cua-doi-song,53497035,"40 VIÊN PIN MAXELL AAA TEM BẠC - HÀNG CHÍNH HÃNG",49200,49200,0,0
TIKI,nha-cua-doi-song,696521,"Ổ Cắm Điện 4 Lỗ 3 Chấu 2 cổng USB Philips SPN6248WB/74 (2500W)",438000,469000,31000,7
TIKI,nha-cua-doi-song,153263106,"Kéo Cắt Gà  Nhật Bản Làm Bếp Đa Năng Cắt Vải Cắt Giấy SK5 Siêu Sắc - Hàng Loại 1- Chính Hãng",62000,62000,0,0
TIKI,nha-cua-doi-song,89473437,"Keo chống thấm vá vết nứt tường siêu chắc đa năng - keo trám tường thông minh",33000,33000,0,0
TIKI,nha-cua-doi-song,42264813,"Kẹp phơi đồ Inox -Kẹp phơi quần áo đồ chống gió",61750,61750,0,0
TIKI,nha-cua-doi-song,36935892,"Combo 10 khăn lau bếp đa năng - KL29 (Giao ngẫu nhiên mẫu)",10000,11343,1343,12
TIKI,nha-cua-doi-song,12461025,"Nước cắm hoa công nghệ nano đồng Fresh Flowers AHT 430ml - giúp hoa lâu tàn, không thối nước",49500,55000,5500,10
TIKI,nha-cua-doi-song,38306937,"Vỉ 5 Viên Pin CR1616 Lithium 3V Panasonic - Hàng Chính Hãng",89000,89000,0,0
TIKI,nha-cua-doi-song,57521842,"Bàn Học Bàn Làm Việc Kết Hợp Kệ Sách Thương Hiệu IGEA",570000,620000,50000,8
TIKI,nha-cua-doi-song,70840199,"Vá Canh Bằng Gỗ Nhãn Tự Nhiên - VAGOO - Làm Thủ Công Chống Thấm, Chống Ẩm Mốc, An Toàn Cho Sức Khoẻ",99000,99000,0,0
TIKI,nha-cua-doi-song,3677777,"Bình Lọc Nước BRITA Active Pink - 600ml (Kèm Microdisc)",549000,849000,300000,35
TIKI,nha-cua-doi-song,32153958,"Khóa Số ABUS 145/20 (20mm) - Nhiều Màu",125000,139000,14000,10
TIKI,nha-cua-doi-song,23046928,"Bộ 6 Ly Cốc Thủy Tinh 8 Góc Lùn Uống Trà Đá Camdaco (305ML)",61000,61000,0,0
TIKI,nha-cua-doi-song,53521887,"Giấy lọc cà phê Hario 40 cái (V60-VCF-02-40M)",62000,62000,0,0
TIKI,nha-cua-doi-song,126244017,"Ghế Học Sinh Tiểu Học Chống Gù Thông Minh Có Gác Chân BHS288 Ghế Ngồi Bàn Học Cho Bé Tuỳ Chỉnh Độ Cao - Hàng Chính Hãng",1035000,1265000,230000,18
TIKI,nha-cua-doi-song,58536862,"Cặp Vỏ Gối Lụa Cao cấp A - 50x70cm hoặc 60x80cm - mềm mịn mát lạnh",156000,200000,44000,22
TIKI,nha-cua-doi-song,139161475," Muỗng, Muôi Múc Canh, Vá múc canh Inox 304 Cao Cấp, Sang Trọng Cho Bữa Cơm",45000,45000,0,0
TIKI,nha-cua-doi-song,82877146,"Đèn Bàn Học LED Chống Cận GHINER GN-1902 (Pin 4500mAh)",320000,320000,0,0
TIKI,nha-cua-doi-song,73758944,"Kệ Đa Năng Để Lò Vi Sóng INOX Trắng Cao Cấp Chống Han Gỉ Kệ Để Đồ Nặng Siêu Gọn Cho Nhà Bếp VANDO",479000,856000,377000,44
TIKI,nha-cua-doi-song,52354974,"Combo 9 Ván Sàn Gỗ Tự Nhiên Màu Nâu Vàng, Vỉ Gỗ Lót Sàn Ban Công, Sân Vườn, Hồ Bơi, Phòng Spa, Siêu Bền, Chịu Nước Tốt, Chống Trơn Trượt, Tiêu Chuẩn Xuất Khẩu",249000,279000,30000,11
TIKI,nha-cua-doi-song,4361879,"Bộ lọc nước thô đầu nguồn 3 cấp lọc 10inch Yamato YMTH10-3T",339000,450000,111000,25
TIKI,nha-cua-doi-song,174897090,"Combo 4 Miếng dán tường treo kệ bếp, kệ nhà tắm",22800,24000,1200,5
TIKI,nha-cua-doi-song,150561019,"Ủng Bọc Giày Đi Mưa Cổ Cao Có Đế Chống Trượt",38900,38900,0,0
TIKI,nha-cua-doi-song,48354676,"Bộ 2 Hộp Thủy Tinh Chịu Nhiệt KLOCK KV400 (2 x 400ml) Tặng Túi Giữ Nhiệt",117000,199000,82000,41
TIKI,nha-cua-doi-song,67980198,"Phân bón hữu cơ sinh học KingCrop, dùng trồng rau, cây ăn trái sạch, an toàn",70000,70000,0,0
TIKI,nha-cua-doi-song,274541068,"Combo 10 cặp nút tai chống ồn cao cấp Honeywell Max 1 - Nút bịt tai chống ồn khi đi ngủ, ôn thi, đi máy bay, công trình, xưởng in",3000,3000,0,0
TIKI,nha-cua-doi-song,46185330,"COMBO 10 MÓC INOX HÌNH CHỮ S NHỎ",57000,60000,3000,5
TIKI,nha-cua-doi-song,100431737,"Bộ hộp bảo quản thực phẩm đa năng Nora Ez – FS11-E1++++",198000,198000,0,0
TIKI,nha-cua-doi-song,197649725,"Bình Nước Giữ Nhiệt 500ml Bằng Thép Không Gỉ 304 Hai Lớp Có Màn Hình Kỹ Thuật Số Hiển Thị Nhiệt Độ Cảm Biến 1 Chạm",125000,125000,0,0
TIKI,nha-cua-doi-song,116749239,"Ruột Gối Doona Basic độ bền cao, mềm mịn, an toàn cho sức khoẻ",189000,210000,21000,10
TIKI,nha-cua-doi-song,192443483,"Hộp cơm văn phòng KIPOR KP-HC01 - Thuỷ tinh cao cấp dùng được trong lò vi sóng - Chống tràn, tiện lợi - Hàng chính hãng",43000,67000,24000,36
TIKI,nha-cua-doi-song,58499716,"Nano bạc 1000ppm đậm đặc chai 500ml pha với 20 lít nước dùng phun diệt khuẩn nhà cửa, văn phòng. Hương tinh dầu trà trắng dịu nhẹ",273000,352000,79000,22
TIKI,nha-cua-doi-song,157175018,"Kệ Thanh Ngang Treo Tường Kết Cấu Giấu Chân SIB Decor, Gỗ Lõi Xanh Chống Ẩm, Kèm Phụ Kiện Và Thước Thuỷ Lấy Cân Bằng",89000,89000,0,0
TIKI,nha-cua-doi-song,28619438,"Thang nhôm rút gọn SUMIKA SK320 - Chiều cao tối đa 3.2m, chiều dài rút gọn 0.8m, hợp kim nhôm cao cấp, khóa chốt chắc chắn, đế cao su chống trượt, nhỏ gọn, di chuyển tiện lợi",1130500,1500000,369500,25
TIKI,nha-cua-doi-song,27068546,"Bộ 2 Túi Đựng Chăn Màn - Túi Quần Áo Khung Sắt Gấp Gọn 2 Chiếc Cao Cấp (Giao màu ngẫu nhiên)",183000,270000,87000,32
TIKI,nha-cua-doi-song,173768367,"Hộp đựng đồ chia ngăn 7 - 9 và 12 ngăn sắp xếp quần áo Danido - Khay đựng đồ chia ngăn tiện ích, chất liệu cao cấp",73000,79000,6000,8
TIKI,nha-cua-doi-song,148810239,"Hộp Cơm Cắm Điện Đời Mới Chính Hãng MINIIN, Hâm Nóng, Giữ Nhiệt, Nấu Chín Cơm Và Thức Ăn, 2 Tầng Nhỏ Gọn, 4 Bát Innox Không Gỉ, Tặng Kèm Bộ Đũa Và Thìa, Đa Chức Năng, Dễ Dàng Vệ Sinh",299000,299000,0,0
TIKI,nha-cua-doi-song,25620364,"Set 300 ống hút nhựa PP an toàn",72000,72000,0,0
TIKI,nha-cua-doi-song,184915910,"Chậu Gội Đầu Tại Nhà, Tại Giường Cho Người Già, Người Bệnh, Trẻ Em",81000,125000,44000,35
TIKI,nha-cua-doi-song,59412424,"Bộ Dụng Cụ Bếp (Đũa, Sạn, Vá) Bằng Gỗ Nhãn Tự Nhiên - VAGOO - Làm Thủ Công Chống Thấm, Chống Ẩm Mốc, An Toàn Sức Khoẻ",169000,169000,0,0
TIKI,nha-cua-doi-song,13892115,"Đèn Bàn Comet CT412 60W Cá Heo",130000,130000,0,0
TIKI,nha-cua-doi-song,8085585,"Giấy lọc cà phê Hario 40 cái (V60-VCF-02-40W)",55000,58000,3000,5
TIKI,nha-cua-doi-song,198562465,"Bàn Làm Việc, Bàn Học Có Ngăn Để Đồ Tiện Dụng Phong Cách Bắc Âu Thương Hiệu IGA - GP185",499000,499000,0,0
TIKI,nha-cua-doi-song,42354346,"Gối Chữ U Kèm Bịt Mắt, Bịt Tai – Gối Ngủ Du Lịch, Tựa Đầu Chống Mỏi Chất Liệu Memory Foam Chính Hãng miDoctor – mi1711",149000,149000,0,0
TIKI,nha-cua-doi-song,25036470,"Bình Lọc Nước Barrier Nika (2.5l) - Xanh Lá",342000,450000,108000,24
TIKI,nha-cua-doi-song,76058957,"Kệ gia vị chữ E cao cấp VANDO bằng thép carbon chống gỉ, chống xước, kệ đựng chai lọ gia vị đa năng, kệ để đồ nhà bếp gọn gàng, sang trọng",279000,427000,148000,35
TIKI,nha-cua-doi-song,1084776,"Chảo Chống Dính Vân Đá Đáy Từ HappyCook MFP-26IH GRAY (26cm)",235000,373000,138000,37
TIKI,nha-cua-doi-song,38447686,"Bộ 12 Ly Thủy Tinh Uống Sinh Tố 8 Góc Cao Camdaco (420ML)",113000,113000,0,0
TIKI,nha-cua-doi-song,68716601,"Dao Gọt Hoa Quả Sunhouse KS-KN100PS",33000,49000,16000,33
TIKI,nha-cua-doi-song,59387881,"Bộ Ga Gối Cotton Tici Kẻ LIDACO Cao Cấp - Caro Xanh",159000,230000,71000,31
TIKI,nha-cua-doi-song,16284231,"Bộ 50 móc dán tường siêu dính ",39199,39199,0,0
TIKI,nha-cua-doi-song,49123718,"Bàn Học, Bàn Làm Việc Thông Ming Thương Hiệu IGEA",758000,825000,67000,8
TIKI,nha-cua-doi-song,71342375,"Áo Mưa Bít Trẻ Em Vải Dù Siêu Dày Hàng Việt Nam, Chống Thấm Nước, Phơi Mau Khô Ráo, Che Kín Người An Toàn Cho Bé, Có Lựa Chon Size, Giới Tính Cho Bé ( Giao Màu - Mẫu Ngẫu Nhiên Vì Nhiều Hoạt Tiết)",90000,90000,0,0
TIKI,nha-cua-doi-song,138534630,"Tủ nhựa KATA 5 tầng giá rẻ, chất lượng, chính hãng, nhiều màu sắc",999000,1200000,201000,17
TIKI,nha-cua-doi-song,46178511,"Túi Lọc Sữa Đậu Nành, Túi Lọc Sữa Hạt Cao Cấp, Túi Lọc Trà, Túi Lọc Gia Vị - Hàng Chính Hãng",31000,37000,6000,16
TIKI,nha-cua-doi-song,263488389,"Kệ sách để bàn HT003  - Vàng vân gỗ - Ván dày 12mm",53000,62000,9000,15
TIKI,nha-cua-doi-song,165219472,"Sét 10 khay giấy bạc,khay bạc đựng thực phẩm lót nồi chiên không dầu chịu nhiệt độ cao",12000,12998,998,8
TIKI,nha-cua-doi-song,275226851,"Ngăn Kéo Nhựa Nhỏ Mini, Khay Đựng Bút Gắn, Hộp ngăn kéo Treo Dưới Bàn Làm Việc Giúp Cất Giữ Gọn Gàng Bàn Làm Việc (Giao Màu Ngẫu Nhiên)",150000,155000,5000,3
TIKI,nha-cua-doi-song,133245917,"Hộp Đựng Bàn Chải Và Nhả Kem Đánh Răng Tự Động Tặng Kèm  Cốc Hút Từ -Kệ Để Đồ Nhà Tắm Dán Tường Tiện Lợi- Hàng Chính Hãng MINIIN",153000,153000,0,0
TIKI,nha-cua-doi-song,85908084,"Nhang Sạch Phòng Máy Lạnh - Ít khói - Hương trầm dịu nhẹ - Chân tăm mộc - Nhang Xanh - 300g - 20cm",120000,120000,0,0
TIKI,nha-cua-doi-song,146373034,"Hộp Đựng Đồ Dùng Gấp Gọn Cao Cấp BA01 Kích Thước 38x25x25cm Tiện Lợi, Hộp Vải Chia Ngăn Đựng Quần áo, Hộp vải chia 7 ngăn, chia 9 ngăn, chia 11 ngăn, chia 12 ngăn - Chính Hãng dododios",80000,80000,0,0
TIKI,nha-cua-doi-song,25731116,"Thùng vuông 55 lít - có bánh xe Duy Tân No.748 (61 x 43 x 32 cm)",195000,195000,0,0
TIKI,nha-cua-doi-song,243047801,"Gối tựa lưng văn phòng cao su non A kích thước 34 x 34 cm x 6/10cm",140000,180000,40000,22
TIKI,nha-cua-doi-song,118898224,"Trung Nguyên Legend - Phin nhôm hoa văn màu đen Vĩ Nhân - có hộp giấy (giao mẫu ngẫu nhiên)",75000,75000,0,0
TIKI,nha-cua-doi-song,190989561,"Bình đựng thức ăn giữ nhiệt Inox 316 Elmich EL-8019 dung tích 600ml",299000,419000,120000,29
TIKI,nha-cua-doi-song,31206755,"Hộp 40 viên pin Maxell AAA",48000,49700,1700,3
TIKI,nha-cua-doi-song,34527170,"Giấy bạc dán tường nhà bếp chống thấm dầu, thấm nước tiện dụng 3mx60cm",27999,27999,0,0
TIKI,nha-cua-doi-song,144203362,"Bộ túi hộp cơm thủy tinh Lock&amp;Lock 3EA LLG429DS2GRY (LLG429Dx1, LLG428x1, HWB820GRYx1) - Màu",347000,682000,335000,49
TIKI,nha-cua-doi-song,54644755,"Áo bọc bàn để ủi quần áo, nhiều họa tiết - Áo trùm bàn ủi đồ, chọ size theo ý, giao mẫu ngẫu nhiên+ Tặng kèm hình dán",55000,59000,4000,7
TIKI,nha-cua-doi-song,183254388,"Ô (Dù) Tự Động 2 Chiều Cao Cấp Teement, Che Mưa, Che Nắng, Chống UV - Hàng Chính Hãng",170000,170000,0,0
TIKI,nha-cua-doi-song,172950048,"Kệ Nhà Bếp Đa Năng, Kệ Để Lò Vi Sóng Chính Hãng IGA - GM05",215000,232000,17000,7
TIKI,nha-cua-doi-song,193081467,"Ghế Xoay Văn Phòng Lưới Làm Việc Công Thái Học Deli - Tay Gập Thông Minh, Có Chỉnh Lưng, Lưới Thoáng Khí, Chân Xoay Tiện Ích, Đệm Ghế Êm Aí, Nhiều Màu - Phù Hợp Học Sinh, Văn Phòng, Game Thủ, Gaming - Hàng chính hãng",899000,1618200,719200,44
TIKI,nha-cua-doi-song,67932480,"Topper Everon White",764150,899000,134850,15
TIKI,nha-cua-doi-song,67937873,"Tấm bảo vệ nệm Everon White",296000,370000,74000,20
TIKI,nha-cua-doi-song,76545899,"Bộ Máy Khoan Mài khuôn Khắc mini Đa Năng 100 chi tiết 6 tốc độ Kiotool",545000,545000,0,0
TIKI,nha-cua-doi-song,980512,"Cân Nhơn Hòa NHS-5 (5kg) - Hàng Chính Hãng",304000,315000,11000,3
TIKI,nha-cua-doi-song,59401658,"Cuộn Đèn LED Trang Trí Quấn Cây RGB Chống Nước, Dài 5M Kèm Remote 44 Phím",120000,120000,0,0
TIKI,nha-cua-doi-song,182148476,"Combo Móc Dán Tường In Hình Họa Tiết Dễ Thương Loại Lớn PaKaSa - Hàng Chính Hãng ( Giao họa tiết ngẫu nhiên )",19000,38000,19000,50
TIKI,nha-cua-doi-song,112068381,"Kệ Đa Năng, Kệ Để Đồ Black Kodo Phong Cách Hiện Đại - GM06",203000,220000,17000,8
TIKI,nha-cua-doi-song,116191376,"Nhang trầm hương tự nhiên Thiên Mộc Hương 30cm, Ít Khói, Thơm Nhẹ, Dễ Chịu, Không kích mũi",99000,150000,51000,34
TIKI,nha-cua-doi-song,73113608,"Bình PET Đựng Nước Tròn Có Vòi 10 Lít Duy Tân thân bình trong suốt giao quai màu ngẫu nhiên (Ø 20 x 40.2 cm) No.625 ",61000,64000,3000,5
TIKI,nha-cua-doi-song,56247996,"Kệ sách mini bằng gỗ, để trên bàn làm việc hoặc bàn học. Hàng tự lắp ghép đa năng, thông minh. Gồm 3 màu đẹp hiện đại",80000,82000,2000,2
TIKI,nha-cua-doi-song,230013933,"Kệ Sách Để Bàn Phong Cách Nordic Thương Hiệu IGA - GP176",281000,305000,24000,8
TIKI,nha-cua-doi-song,6256843,"Cân hành lý cầm tay 50kg - Cân điện tử cầm tay max 50kg",95000,95000,0,0
TIKI,nha-cua-doi-song,208761326,"Chai xịt chuột thái land rat off",84000,84000,0,0
TIKI,nha-cua-doi-song,144203367,"Bộ túi hộp cơm thủy tinh Lock&Lock 3EA LLG428S2IVY (LLG429Dx1, LLG428x1, HWB821GRYx1) - Màu",370000,726000,356000,49
TIKI,nha-cua-doi-song,125555122,"Bàn Học, Bàn Làm Việc Gấp Gọn Hiện Đại Thương Hiệu IGA - GP154",155000,169000,14000,8
TIKI,nha-cua-doi-song,125084260,"Vỏ gối ôm cotton tici Lidaco kích thước 35x100cm",35000,39000,4000,10
TIKI,nha-cua-doi-song,165705675,"Cọ vệ sinh Bình Giữ Nhiệt chuyên dụng, Cứng cáp, Đế gỗ",150000,150000,0,0
TIKI,nha-cua-doi-song,270862442,"Ổ Cắm Điện Đa Năng Chống Giật Có 3 Cổng USB, Sạc Trực Tiếp, Tiết Kiệm Điện – Bộ Ổ Cắm Điện Xanh Lá Cao Cấp Chính Hãng - (Model ngẫu nhiên)",58000,69000,11000,16
TIKI,nha-cua-doi-song,191057553,"Ổ Cắm Điện Thông Minh USB Cao Cấp Jodily StarHome",185000,185000,0,0
TIKI,nha-cua-doi-song,177344420,"Bộ 2 Ly Bia Thuỷ Tinh Luminarc Benidorm 450ml - LUBEG2616",119000,150000,31000,21
TIKI,nha-cua-doi-song,72652196,"Bộ túi hộp cơm thủy tinh Lock&amp;Lock 3EA (LLG429Dx1,LLG428x1,BAG-HPL815SGRNx1) LLG428S2GRN - Màu",330000,649000,319000,49
TIKI,nha-cua-doi-song,77947848,"Kệ Chén Đĩa Thép Cao Cấp Sơn Đen Tĩnh Điện Kèm Khay Ráo Nước VANDO, Giá Kệ Úp Bát Đa Năng",383000,656000,273000,42
TIKI,nha-cua-doi-song,122311338,"Nhang Nụ Trầm Hương tự nhiên khói chảy ngược - Hộp 40 nụ - Mùi thơm dịu nhẹ, không cay mắt, không kích mũi",550000,700000,150000,21
TIKI,nha-cua-doi-song,108605078,"Pin kiềm Akaline AA Deli - Vỉ 2 viên/ 4 viên - 18500 / 18501",19000,34200,15200,44
TIKI,nha-cua-doi-song,272453779,"[Tặng Bông Lau] Cây Lau Nhà MyJae Sợi Microfiber Tự Vắt Phun Sương Xoay 360 Độ Thông Minh 138cm",429000,429000,0,0
TIKI,nha-cua-doi-song,195979652,"Bình giữ nhiệt LocknLock Easy Outdoor Vacuum Bottle LHC1485 - Có nắp sử dụng được như cốc và dây đeo vai - 1.8L - Hàng chính hãng",548000,1139000,591000,52
TIKI,nha-cua-doi-song,152521474,"Combo 200 Túi Lọc Rác Bồn Rửa Bát - Túi Lưới Lọc Rác Giúp Ngăn Chặn Tắc Đường Ống- Hàng Loại 1 - Chính Hãng MINIIN",32000,32000,0,0
TIKI,nha-cua-doi-song,194005519,"Ghế Kê Chân Văn Phòng, Chịu lực 200 kg Plyconcept Seiza Chair - Gỗ Uốn Cong",160000,280000,120000,43
TIKI,nha-cua-doi-song,108936951,"Bảng Gỗ Quy Tắc Gia Đình, Tranh Treo Tường Gia đình, Những Quy Tắc Để Con Có Cuộc Sống Hạnh Phúc",160000,160000,0,0
TIKI,nha-cua-doi-song,161030427,"Cây lau trần nhà, chổi quét trần nhà đa năng hình tam giác - Kitimop A3",149000,199000,50000,25
TIKI,nha-cua-doi-song,117059826,"Giấy lọc cà phê Hario 100 cái (V60-VCF-02-100W)",89000,99000,10000,10
TIKI,nha-cua-doi-song,73467694,"Kệ để lò vi sóng đa năng Inox 304 cao cấp Vando chính hãng kệ để đồ lò nướng chắc chắn, sơn tĩnh điện chống bong tróc, kệ nhà bếp siêu chịu lực 300kg",899000,1570000,671000,43
TIKI,nha-cua-doi-song,111472777,"Miếng Dán Tường Đa Năng SenNai - Móc Dán Cây Lau Nhà Loại Tốt - Chịu Tải Lên Đến 5kg",18000,18000,0,0
TIKI,nha-cua-doi-song,104027916,"Bộ gối tựa lưng và đệm lót ghế chống đau xương cụt Ema loại có gel cao cấp cho dân văn phòng, lái xe, sinh viên",323400,660000,336600,51
TIKI,nha-cua-doi-song,94891198,"Hộp Cơm Giữ Nhiệt INOX304 Hiện Đại Kèm Hộp Đựng Canh Soup và Bộ Đũa Thìa INOX – Chất Liệu Cao Cấp An Toàn Cho Sức Khỏe – Hàng Chính Hãng Vinbuy",285000,500000,215000,43
TIKI,nha-cua-doi-song,183029245,"Mền lông cừu Caro cao cấp A kích thước 1m8 x 2m",195000,199000,4000,2
TIKI,nha-cua-doi-song,143861521,"Dây Led Neon Flex 12V Kèm Nguồn Dài 1M/2M/3M/5M Trang Trí Cổ Điển",100000,100000,0,0
TIKI,nha-cua-doi-song,121268576,"Ổ cắm điện 5 lỗ 2m Điện Quang SM750SL - Hàng Chính Hãng",168000,168000,0,0
TIKI,nha-cua-doi-song,192635575,"Combo Chén/ Bát gáo dừa + Muỗng gỗ dừa DK Harvest - Loại size lớn 12 - 14cm (Loại Xuất khẩu)",38000,38000,0,0
TIKI,nha-cua-doi-song,191918105,"Bộ Bàn Chải Vệ Sinh Các Khe LocknLock ETM415 - 2 cái/bộ",18900,39000,20100,52
TIKI,nha-cua-doi-song,127152344,"Chổi Cọ Nhà Vệ Sinh Bồn Cầu Toilet Không Dây Đa Năng SENNAI Pin 4000mAh - Hàng Chính Hãng",155000,195000,40000,21
TIKI,nha-cua-doi-song,69843631,"CÂY TREO QUẦN ÁO HÀN QUỐC GỖ LẮP RÁP- STANDING HANGER- BLUE HOME- MÀU GỖ TỰ NHIÊN",279000,279000,0,0
TIKI,nha-cua-doi-song,79691104,"Bộ Hộp Cơm Giữ Nhiệt Văn Phòng Cao Cấp Cắm Điện inox 3 tầng - Chính Hãng",209000,300000,91000,30
TIKI,nha-cua-doi-song,56228508,"Phân bón hữu cơ dịch chuối DOCNEEM, phân bón cho phong lan, hoa hồng, cây cảnh kích rễ, kích kei, chồi, mầm, chai 1 lít",119000,119000,0,0
TIKI,nha-cua-doi-song,143363686,"Băng keo chống thấm x2000 Nhật Bản chống thấm dột, dán tường, dán mái tôn, dán ống nước",25000,31000,6000,19
TIKI,nha-cua-doi-song,134360863,"Vỉ 6 Viên Pin AA , Pin AAA Energizer Max 1,5V Alkaline - Hàng chính hãng",77000,90000,13000,14
TIKI,nha-cua-doi-song,135156091,"Tua vít bake thép 3*100mm",10000,10000,0,0
TIKI,nha-cua-doi-song,199263383,"Bàn Ăn Phong Cách Bắc Âu Đơn Giản Thương Hiệu IGA - GP181",486000,528000,42000,8
TIKI,nha-cua-doi-song,178936441," Đũa Gỗ Mộc Hương Cao Cấp - Gỗ Tự Nhiên - Đánh Bóng Thủ Công - Không Ẩm Mốc - Vỉ 10 đôi ",135000,135000,0,0
TIKI,nha-cua-doi-song,131145091,"Giá Sách Mini Tủ Đầu Giường Phong Cách Nordic Thương Hiệu IGA - GP156",221000,240000,19000,8
TIKI,nha-cua-doi-song,117138509,"Ổ cắm điện LiOA đa năng - 3 lỗ, 4 lỗ, 6 lỗ, 8 lỗ dây dài 3m/5m - Chính Hãng - MITA",121000,121000,0,0
TIKI,nha-cua-doi-song,89198232,"Kệ Gia Vị Để Bàn Nora Cho Phòng Bếp Gọn Gàng - GM04",134000,146000,12000,8
TIKI,nha-cua-doi-song,184282768,"Combo 6 túi giặt 3 lớp bảo vệ quần áo, đồ lót dùng cho máy giặt chính hãng Dododios",174000,174000,0,0
TIKI,nha-cua-doi-song,131498054,"Bóng đèn LED trụ Hi-lumen G3 PHILIPS E27 - Độ sáng cao, tiết kiệm điện, chất lượng ánh sáng vượt trội - Hàng Chính Hãng",132000,264000,132000,50
TIKI,nha-cua-doi-song,135442402,"Mỏ Hàn Điện Deli Chính Hãng 30W / 60W Chất Lượng Cao - Sử Dụng Đa Năng, Tiện Ích - DL8830 / DL8860",80000,142200,62200,44
TIKI,nha-cua-doi-song,193541405,"Áo Mưa Bít Trẻ Em Cho Bé Cute Dễ Thương Siêu Dày Chống Thấm Nước Có Phản Quang Phơi Mau Khô Ráo Che Kín Người Kèm Túi Đựng Deli - Chất Liệu An Toàn Có Lựa Chọn Nhiều Size Màu Sắc",196500,358200,161700,45
TIKI,nha-cua-doi-song,96175682,"Giường ngủ gấp gọn thông minh NIKITA, Xếp thành ghế SOFA dễ di chuyển",1439000,1889000,450000,24
TIKI,nha-cua-doi-song,6880341,"Cây lau nhà Xiaomi 2 trong 1 - Có phun nước Deerma Spray Water Spray Mop - Hàng Chính Hãng",249000,329000,80000,24
TIKI,nha-cua-doi-song,162407831,"Kệ Để Máy Tính Kết Hợp Kệ Sách Đa Năng Hiện Đại Thương Hiệu IGA - GP184",176000,186000,10000,5
TIKI,nha-cua-doi-song,186348775,"Đệm ngồi ghế văn phòng chống đau xương cụt, ê mông, thâm mông, xệ mông cho dân văn phòng, lái xe, học sinh - Thương hiệu EMA - Loại cao cấp có gel tản nhiệt",279300,570000,290700,51
TIKI,nha-cua-doi-song,158804921,"Gối ngủ cao su non vỏ sợi tre kháng khuẩn cao cấp cho người lớn EMA - Phong cách Nhật Bản - Chống đau mỏi cổ vai gáy, ngủ ngáy - KT 50x30x10cm",126420,258000,131580,51
TIKI,nha-cua-doi-song,76451291,"Đèn Led Đom Đóm Dây Kẽm Dễ Uốn Kèm Pin CR2032",19000,20000,1000,5
TIKI,nha-cua-doi-song,208358660,"Ổ cắm điện LiOA đa năng - 3 lỗ, 4 lỗ, 6 lỗ, 8 lỗ dây dài 3m/5m - Chính Hãng - MITA",104000,104000,0,0
TIKI,nha-cua-doi-song,175147417,"Set 10 hộp nhựa chữ nhật mỏng đựng thực phẩm Đại Đồng Tiến 100% nhựa PP an toàn cho sức khỏe dùng được cho lò vi sóng",43000,43000,0,0
TIKI,nha-cua-doi-song,51473042,"Kệ đa năng Tokyo 4 tầng hàng cao cấp",154000,154000,0,0
TIKI,nha-cua-doi-song,113773790,"Bình Thủy Tinh 2 Lớp Pha Trà Doron MS79 - Cách Nhiệt Tốt - Có Lõi Lọc Inox 304 - Dung Tích 400ml - Hàng Loại 1",123000,129000,6000,5
TIKI,nha-cua-doi-song,135507759,"Dây vòi hoa sen tắm nóng lạnh Pimisi bằng inox 304 với đầu dây đồng thau không gỉ phù hợp với mọi sen tắm trong nhà vệ sinh dài 150cm chống xoắn - mạ xi sáng bóng - ống mềm cấp nước và dùng được cho cả vòi xịt nhà vệ sinh phòng tắm | Hàng chính hãng",87000,120000,33000,28
TIKI,nha-cua-doi-song,165758264,"Bộ dao 2 chiếc Eco Family Sunhouse KS-KN2E1",100000,163000,63000,39
TIKI,nha-cua-doi-song,191918103,"Dụng cụ rửa chai và ly LocknLock ETM143DGRY - Màu xám đen",39900,79000,39100,49
TIKI,nha-cua-doi-song,27948515,"Bộ 2 móc treo chổi, cây lau nhà dụng cụ tẩy rửa nhà tắm dán tường chống khuẩn tiết kiệm không gian chịu lực tối đa 5Kg",20000,20000,0,0
TIKI,nha-cua-doi-song,52021508,"Bảng điện nổi V2 Điện Quang ĐQ FEP 32W 02S (màu trắng, 3 lỗ 2 chấu, 2 công tắc)",55900,81153,25253,31
TIKI,nha-cua-doi-song,59318679,"Bộ Ga Gối Cotton Tici Kẻ LIDACO Cao Cấp - Caro Nâu Nhạt",159000,238000,79000,33
TIKI,nha-cua-doi-song,6710595,"Bộ 10 móc treo dán tường chịu lực 10kg",5894,5894,0,0
TIKI,nha-cua-doi-song,35273810,"Keo vá tường,Keo trám vết nứt tường thông minh - Tặng kèm bộ dụng cụ",33000,33000,0,0
TIKI,nha-cua-doi-song,139600248,"Miếng Tấm Pát Pad Thép Vuông Sửa Bản Lề Tủ Cửa Gỗ Lỗ Vít Door Hinge Repair Kit",10000,10000,0,0
TIKI,nha-cua-doi-song,144582478," Dán Tường Để Đồ Đa Năng, Dán Tường Để Điện Thoại, Để Điều Khiển... - Giao màu ngẫu nhiên ",15000,15000,0,0
TIKI,nha-cua-doi-song,55481938,"Đồng hồ gỗ LED để bàn cao cấp, có nhiệt độ, ngày tháng năm, cảm biến âm thanh",190000,200000,10000,5
TIKI,nha-cua-doi-song,116571657,"Ga Chống Thấm Cotton LIDACO Cao Cấp - Kitty hồng - 2m2x2mxdưới12cm",199000,217000,18000,8
TIKI,nha-cua-doi-song,116571619,"Ga Chống Thấm Cotton LIDACO Cao Cấp - Kẻ sao - 1m2x2mxdưới12cm",149000,200000,51000,26
TIKI,nha-cua-doi-song,116571663,"Ga Chống Thấm Cotton LIDACO Cao Cấp - Kẻ sao - 1m8x2mxdưới12cm",155000,200000,45000,23
TIKI,nha-cua-doi-song,129144356,"Ga Chống Thấm Cotton LIDACO Cao Cấp - Lông vũ - 1m2x2mxdưới12cm",149000,189000,40000,21
TIKI,nha-cua-doi-song,116571693,"Ga Chống Thấm Cotton LIDACO Cao Cấp - Baby shark - 1m4x2mxdưới12cm",149000,184000,35000,19
TIKI,nha-cua-doi-song,116571735,"Ga Chống Thấm Cotton LIDACO Cao Cấp - Thỏ bé - 1m6x2mxdưới12cm",149000,179000,30000,17
TIKI,nha-cua-doi-song,116571655,"Ga Chống Thấm Cotton LIDACO Cao Cấp - Kẻ sao - 1m4x2mxdưới12cm",149000,189000,40000,21
TIKI,nha-cua-doi-song,36300228,"Bộ Móc treo chữ S, có 3 size chọn lựa",23750,25000,1250,5
TIKI,nha-cua-doi-song,116571623,"Ga Chống Thấm Cotton LIDACO Cao Cấp - Kitty hồng - 1m4x2mxdưới12cm",149000,189000,40000,21
TIKI,nha-cua-doi-song,116571660,"Ga Chống Thấm Cotton LIDACO Cao Cấp - Kẻ sao - 1m6x2mxdưới12cm",149000,179000,30000,17
TIKI,nha-cua-doi-song,28659189,"Thang nhôm rút gọn SUMIKA SK510 - Chiều cao tối đa 5.1m, hợp kim nhôm cao cấp",1795500,2400000,604500,25
TIKI,nha-cua-doi-song,149387829,"Hộp Đựng Giấy Vệ Sinh Đa Năng 2 Tầng Treo Tường Cao Cấp - Có Ngăn Kéo Và Khe Cắm Điện Thoại, Ipad - Hàng Chính Hãng Nhập Khẩu",159000,159000,0,0
TIKI,nha-cua-doi-song,116571667,"Ga Chống Thấm Cotton LIDACO Cao Cấp - Baby shark - 1m2x2mxdưới12cm",149000,154000,5000,3
TIKI,nha-cua-doi-song,116571741,"Ga Chống Thấm Cotton LIDACO Cao Cấp - Thỏ bé - 1m2x2mxdưới12cm",149000,250000,101000,40
TIKI,nha-cua-doi-song,116571731,"Ga Chống Thấm Cotton LIDACO Cao Cấp - Thỏ bé - 1m4x2mxdưới12cm",149000,160000,11000,7
TIKI,nha-cua-doi-song,164158123,"Vỉ 2 Viên Pin Duracell CR2032 / CR2025 / CR2016 Lithium 3V - Hàng chính hãng",60000,60000,0,0
TIKI,nha-cua-doi-song,7221847,"Bộ Nồi Inox Sunhouse Mama cao cấp 5 đáy SH784 (16cm, 20cm, 24cm) - Dùng cho mọi loại bếp - Hàng chính hãng",806000,811000,5000,1
TIKI,nha-cua-doi-song,116571649,"Ga Chống Thấm Cotton LIDACO Cao Cấp - Kitty hồng - 1m2x2mxdưới12cm",149000,217000,68000,31
TIKI,nha-cua-doi-song,106385679,"Túi Giữ Nhiệt Đựng Hộp Cơm Văn Phòng Siêu Dày – Chọn Size – Giữ Nhiệt – 3 Lớp - Chống Thấm Cao Cấp Chính Hãng miDoctor",67000,67000,0,0
TIKI,nha-cua-doi-song,116571671,"Ga Chống Thấm Cotton LIDACO Cao Cấp - Kẻ sao - 2m2x2mxdưới12cm",199000,226000,27000,12
TIKI,nha-cua-doi-song,96209890,"Dụng cụ thông ống thoát nước chuyên nghiệp có tay cầm - Độ dài dây lò xo: 5m",145000,145000,0,0
TIKI,nha-cua-doi-song,116571707,"Ga Chống Thấm Cotton LIDACO Cao Cấp - Baby shark - 2m2x2mxdưới12cm",199000,213000,14000,7
TIKI,nha-cua-doi-song,118680989,"Set nến thơm hộp quà thắt nơ – xinh xắn phù hợp làm quà tặng bạn gái",80000,80000,0,0
TIKI,nha-cua-doi-song,217736127,"Ga Chống Thấm Cotton LIDACO Cao Cấp - San hô",149000,200000,51000,26
TIKI,nha-cua-doi-song,116571710,"Ga Chống Thấm Cotton LIDACO Cao Cấp - Baby shark - 1m6x2mxdưới12cm",149000,159000,10000,6
TIKI,nha-cua-doi-song,116571687,"Ga Chống Thấm Cotton LIDACO Cao Cấp - Thỏ bé - 2m2x2mxdưới12cm",199000,250000,51000,20
TIKI,nha-cua-doi-song,116571699,"Ga Chống Thấm Cotton LIDACO Cao Cấp - Baby shark - 1m8x2mxdưới12cm",155000,200000,45000,23
TIKI,nha-cua-doi-song,186645870,"Máy Bắn Keo Nến Deli - Phù hợp DIY Làm Đồ Handmade Thủ Công - An Toàn, Nhỏ Gọn, Dễ Sử Dụng - DL390120",95000,171000,76000,44
TIKI,nha-cua-doi-song,116571716,"Ga Chống Thấm Cotton LIDACO Cao Cấp - Thỏ bé - 1m8x2mxdưới12cm",155000,242000,87000,36
TIKI,nha-cua-doi-song,189492088,"Nhang Sen Thuần Khiết Liên Tâm 29cm 200 cây - Ít khói, dịu nhẹ, 100% Đài sen thiên nhiên",99750,99750,0,0
TIKI,nha-cua-doi-song,135720334,"Bình pha trà cafe French Press Lock&Lock, 800ml - LLG018",174000,250000,76000,30
TIKI,nha-cua-doi-song,69226574,"Combo 10 viên pin CR2032 Maxell Nhật Bản",28000,31800,3800,12
TIKI,nha-cua-doi-song,89144285,"Cốc Dán Tường Nhà Tắm Hình Gấu Nâu Dễ Thương - Cốc Đựng Bàn Chải Đánh Răng - Cốc Hình Gấu",7000,9000,2000,22
TIKI,nha-cua-doi-song,204207230,"Nhang nụ trầm hương đốt xông nhà tẩy uế HÀ XÁ đồ thờ cúng phong thủy, xua đuổi vận xui, thu hút nguồn năng lượng tích cực, thanh lọc không khí, an toàn cho sức khỏe",198000,198000,0,0
TIKI,nha-cua-doi-song,202840456,"Kệ Lò Vi Sóng Effect Đa Năng - GM02",129000,139000,10000,7
TIKI,nha-cua-doi-song,168234677,"[Hàng chính hãng] Ghế chỉnh dáng ngồi đúng - Curble Wider_Premium Model Hàn Quốc (Made in Korea). Phù hợp mọi đối tượng (Free Size)",729000,729000,0,0
TIKI,nha-cua-doi-song,451856,"Cáp nối dài Điện Quang ĐQ EPF 5W.2PN dây dài 5m (Giao màu ngẫu nhiên)",65700,87732,22032,25
TIKI,nha-cua-doi-song,578902,"Chảo Đáy Từ Chống Dính Sunhouse SHM26 26cm",202000,300000,98000,33
TIKI,nha-cua-doi-song,72527573,"Hộp Đựng Giấy Vệ Sinh Cao Cấp OENON Dán Tường, Hộp Đựng Giấy Đa Năng Có Thêm Ngăn Để Đồ Tiện Lợi - OENON",149000,280000,131000,47
TIKI,nha-cua-doi-song,55580718,"Bộ 3 Nồi Inox 304 Đáy Từ 5 Đáy Nagakawa NAG1352 (16cm, 20cm, 24cm) - Hàng Chính Hãng",1100000,1890000,790000,42
TIKI,nha-cua-doi-song,57046106,"Bình Đựng Nước Lock&Lock Easy Grip Dung Tích 1.5L HAP814",30000,30000,0,0
TIKI,nha-cua-doi-song,142441475,"Hộp Sấy Và Khử Khuẩn Đũa Thìa Muỗng Thông Minh,  Có Nắp Đậy Cao Cấp Chống Côn Trùng, Kiến, Dán Tường Chắc Chắn- Hàng Loại 1 Chính Hãng MINIIN",229000,229000,0,0
TIKI,nha-cua-doi-song,103755910,"Ghế tatami, ghế lười bệt tựa lưng nệm - Có 5 cấp độ ngã lưng - Chính hãng TIDO",390000,390000,0,0
TIKI,nha-cua-doi-song,24482769,"Dây xịt vệ sinh inox 304 dài 120cm",45000,60000,15000,25
TIKI,nha-cua-doi-song,1918931,"Keo Dán Đa Năng Selleys Epoxy Fix (10ml / Tuýp)",38000,39000,1000,3
TIKI,nha-cua-doi-song,54156958,"Pin Sạc Energizer AAA 700mAh Power Plus",160000,160000,0,0
TIKI,nha-cua-doi-song,4546881,"Bộ 12 Ly Thủy Tinh Bầu Lùn Uống Trà Đá Camdaco (225ml)",75000,75000,0,0
TIKI,nha-cua-doi-song,272035598,"HỘP 10 ĐÔI ĐŨA INOX 304 - CAO CẤP - SANG TRỌNG - NGUYÊN KHỐI INOX 304",211000,235000,24000,10
TIKI,nha-cua-doi-song,196051243,"Búa Lùn Nguyên Khối Deli Chính Hãng - Đóng Đinh, Nhổ Đinh Dễ Dàng, Tiện Dụng - Nhỏ Gọn, Tay Cầm Bọc Cao Su - DL441008",55000,106000,51000,48
TIKI,nha-cua-doi-song,28624165,"Thang nhôm rút gọn SUMIKA SK440 - Chiều cao tối đa 4.4m, hợp kim nhôm cao cấp",1600500,2100000,499500,24
TIKI,nha-cua-doi-song,55134471,"1kg - Túi đựng rác gia đình , Bao đựng rác văn phòng 3 màu size trung 55x65",26000,26000,0,0
TIKI,nha-cua-doi-song,168837331,"Giấy Nến Lót Nồi Chiên Không Dầu Hình Khuôn Bánh Siêu Tiện Lợi - Thấm Giảm Thiểu Tối Đa Dầu Mỡ Bám - Hàng Chính Hãng MINIIN",55000,55000,0,0
TIKI,nha-cua-doi-song,85029640,"Ổ cắm Điện Quang ĐQ ESK 2WR 23-3U (2 lỗ 3 chấu, 3 USB, dây dài 2m, màu trắng đỏ)",147236,267700,120464,45
TIKI,nha-cua-doi-song,162875961,"Hộp 10 Đôi Đũa  Sừng Chất Liệu Hợp Kim Mạ Vàng Cao Cấp Đầu Đũa Có Chống Trơn - Hàng Loại 1 - Chính Hãng MINIIN",32000,32000,0,0
TIKI,nha-cua-doi-song,183488628,"Hộp đựng thức ăn cho bé LocknLock LLG510S3 260ml x 3 hộp - Nắp màu cam, silicone màu cam",219000,430000,211000,49
TIKI,nha-cua-doi-song,75330721,"Then Chốt Cài Cửa, Chốt Khóa Bằng Thép Không Gỉ KUNBE An Toàn Tiện Lợi Nhiều Kích Thước",22900,22900,0,0
TIKI,nha-cua-doi-song,2391311,"Cân Treo Mini Bỏ Túi 1 Mặt Số 5kg Nhơn Hòa NHMGS-5 - Hàng Chính Hãng",66000,69000,3000,4
TIKI,nha-cua-doi-song,116194623,"Dụng Cụ Thoát Nước Sàn Nhà Tắm, Bịt Nắp Cống Inox KUNBE, Thoát Nhanh, Chặn Tóc, Lọc Rác, Chống Tắc Hiệu Quả",26900,26900,0,0
TIKI,nha-cua-doi-song,196530625,"Xô nước gấp gọn, xô đa năng vệ sinh nhà cửa, xô giặt lau nhà, chùi kính, xô ô tô Parroti Extra XT01",146000,209000,63000,30
TIKI,nha-cua-doi-song,47462861,"Bộ 6 vỉ (12 viên pin) pin Kiềm Alkaline Panasonic AAA LR03T/2B-Hàng chính hãng",175000,180000,5000,3
TIKI,nha-cua-doi-song,172143534,"Kệ Gỗ Để Đồ Đa Năng Có Bánh Xe Di Chuyển Dễ Dàng - GP190",217000,235000,18000,8
TIKI,nha-cua-doi-song,56451459,"Pin C carbon Panasonic R14UT/2S chính hãng",25000,30400,5400,18
TIKI,nha-cua-doi-song,196974615,"Chế phẩm đặc trị vàng lá, thối rễ, diệt tuyến trùng, kích rễ, tái tạo rễ mới BS03 Physa 250/500g NSX Bacsicayxanh",201000,201000,0,0
TIKI,nha-cua-doi-song,117125057,"Ổ Cắm Điện LiOA Phổ Thông - Ổ Cắm Điện 3 lỗ - 4 lỗ - 5 lỗ - 6 lỗ - dài 3m - MITA",69000,69000,0,0
TIKI,nha-cua-doi-song,158462914,"Cây Lau Kính, Gạt Chùi Kính Đa Năng 2 Đầu Trong 1 MyJae Cán Dài Uốn Xoay Thông Minh Chống Trơn Trượt",239000,390000,151000,39
TIKI,nha-cua-doi-song,2039747,"Bộ Nồi Inox 3 Đáy Sunhouse SH334",479000,690000,211000,31
TIKI,nha-cua-doi-song,195544340,"Bình Inox Đựng Rượu CCCP Truyền Thống Dung Tích 2.0L Dày 0,6 ly - 64OZ ( Loại 1 ), Kèm Bao Da Phong Cách",191000,398000,207000,52
TIKI,nha-cua-doi-song,124691053,"Đệm thắt lưng tam giác Ema thế hệ 2 - Rộng hơn - Thoải mái xoay trở - Dành cho người thoát vị thắt lưng, bà bầu, người cao tuổi",188160,370000,181840,49
TIKI,nha-cua-doi-song,139723967,"Combo Khăn Lau Đa Năng Mặt Siêu Thấm, Khăn Lau Bếp, Khăn Lau Kính, Khăn Lau Bát, Khăn Lau Tay, Khăn Lâu Ô Tô miDoctor",16000,16000,0,0
TIKI,nha-cua-doi-song,156222332,"SEN TẮM CÂY NÓNG LẠNH NHẬP KHẨU NGA FULLBOX F2428 - HÀNG CHÍNH HÃNG - SIÊU BỀN BỈ",4700000,4700000,0,0
TIKI,nha-cua-doi-song,26670490,"Kệ Góc Nhà Tắm Chống Nước",205000,222000,17000,8
TIKI,nha-cua-doi-song,96271704,"Ổ Cắm Điện Thông Minh XSmart Đa Tính Năng Chống Giật Hàng Siêu Cao Cấp,  Chống Cháy Nổ Chịu Được Công Suất Cao, Chính Hãng",139000,139000,0,0
TIKI,nha-cua-doi-song,10404394,"Bình Đựng Thức Ăn Giữ Nhiệt ELmich Inox 304 EL0631 (500ml)",276000,469000,193000,41
TIKI,nha-cua-doi-song,273377437,"Ổ cắm điện kéo dài Rạng Đông 2m/5m Model OC04, OC05 chống giật, rơ le tự ngắt chống quá tải",112000,140000,28000,20
TIKI,nha-cua-doi-song,170927755,"Hộp nhựa đựng thực phẩm Homepower trong suốt có khay lót đáy giúp ráo nước, chất liệu cao cấp, an toàn cho sức khỏe",229000,229000,0,0
TIKI,nha-cua-doi-song,75783351,"Máy Xay Tỏi Ớt Cầm Tay Mini Sạc Điện 100ml 250ml Tiện Lợi",160000,160000,0,0
TIKI,nha-cua-doi-song,68736740,"Ruột gối nằm lông vũ khách sạn cao cấp sợi microfiber nhân tạo Hanvico by Homemark có kích thước trẻ em và 50x70 cm",142000,250000,108000,43
TIKI,nha-cua-doi-song,114204741,"Bình giữ nhiệt inox 304 Sunhouse 450ml KS-TU450I",96000,150000,54000,36
TIKI,nha-cua-doi-song,116198000,"Đệm Ngồi Thông Minh Lưu Thông Máu Thoáng Khí PEAFLO",142000,165000,23000,14
TIKI,nha-cua-doi-song,14639229,"Nắp Kính Cường Lực Nồi Và Chảo Fivestar",55000,100000,45000,45
TIKI,nha-cua-doi-song,151462143,"Sáo recorder 6 lỗ cao cấp ",89000,89000,0,0
TIKI,nha-cua-doi-song,67811819,"Đèn LED Cảm Biến Chuyển Động Nhiều Kích Cỡ, Cảm Ứng Hồng Ngoại 3 Chế Độ",189050,199000,9950,5
TIKI,nha-cua-doi-song,38160071,"Bút Thử Điện Điện Quang ĐQ ETP03 R  (2 Đầu Vít, 160 mm, Màu Đỏ)",20232,25300,5068,20
TIKI,nha-cua-doi-song,53830664,"Mùng ngủ không cửa giăng dây 4 góc truyền thống - Vải tuyn dày lỗ nhỏ chống muỗi tuyệt đối",110000,155000,45000,29
TIKI,nha-cua-doi-song,112072065,"Túi Đựng Hộp Cơm Giữ Nhiệt - Túi Trữ Lạnh Cao Cấp Chống Thấm Nước – Túi Giữ Nhiệt Hàng Chính Hãng",29000,55000,26000,47
TIKI,nha-cua-doi-song,119446046,"Bát Tô Canh Sứ Trắng Đủ Size - Tô khum Sứ Long Phương - 6 inch",38400,38400,0,0
TIKI,nha-cua-doi-song,95333782,"Đế lót chậu cây có bánh xe MONROVIA, đế để chậu cây, kệ chậu cây do động, có bánh xe, mặt tròn hoặc vuông bằng gỗ tràm cao cấp loại 1, trên 10 năm tuổi, màu vàng đường kinh 30 cm, chính hãng thương hiệu MONROVIA",85000,85000,0,0
TIKI,nha-cua-doi-song,190512159,"Nước Ngâm Rửa Rau Củ Quả Sinh Học ENZYCO Lên Men Từ Dứa Loại Bỏ Hóa Chất Khử Mùi Tanh Thịt Cá - 1 Lít",89000,95000,6000,6
TIKI,nha-cua-doi-song,74329992,"Hộp Đựng Trang Sức Nữ Trang Cỡ Lớn Da Cao Cấp",128250,135000,6750,5
TIKI,nha-cua-doi-song,76514380,"Ổ Cắm Điện Đa Năng Chống Giật Có 3 Cổng USB – Sạc Trực Tiếp – Tiết Kiệm Điện – Bộ Ổ Cắm Điện Xanh Lá Cao Cấp Chính Hãng Amalife - DE30",52000,52000,0,0
TIKI,nha-cua-doi-song,171174862,"Vỏ Thay Thế Cho Gối Nooz Mềm Mịn Kháng Khuẩn Và Không Gây Kích Ứng Da",99000,150000,51000,34
TIKI,nha-cua-doi-song,117212183,"Ổ Cắm Nối Chia 3 Lioa, Phích Cắm 1 ra 3 Lioa - MITA",22000,22000,0,0
TIKI,nha-cua-doi-song,50098102,"Tủ Vải Quần Áo 3 Buồng 8 Ngăn To, Bền - Hàng Chính Hãng",343000,373000,30000,8
TIKI,nha-cua-doi-song,143779168,"Thảm ngủ cá nhân văn phòng",25000,25000,0,0
TIKI,nha-cua-doi-song,189373783,"Máy Rửa Xe Mini Deli Công Suất Lớn - Tiết Kiệm Điện Năng, Phun Rửa Đa Năng - DL882201",1224000,2399000,1175000,49
TIKI,nha-cua-doi-song,135442231,"Máy Khoan Deli Chính Hãng Pin 12V Bắt Vít - Nhỏ Gọn, Tiện Dụng - Dùng Cho Sửa Chữa Vật Dụng - DL600012",508000,1006200,498200,50
TIKI,nha-cua-doi-song,161024967,"Combo 2 hộp chia ngăn sắp xếp quần áo phong cách Nhật Bản Mai Anh House",189050,199000,9950,5
TIKI,nha-cua-doi-song,696349,"Ổ Cắm Điện 4 Lỗ 3 Chấu 3m Philips SPN1248WB/74 (2500W)",265000,299000,34000,11
TIKI,nha-cua-doi-song,59273521,"Combo 02 Khăn tắm, khăn mặt FUNU, mềm mịn, siêu thấm, kháng khuẩn - Hàng chính hãng, hàng nhiều mẫu design, giao mẫu ngẫu nhiên",89000,100000,11000,11
TIKI,nha-cua-doi-song,187829576,"VỎ GỐI NẰM,GỐI ÔM COTTON MỀM MỊN. THOÁNG MÁT GIÁ SIÊU RẺ,KÍCH THƯỚC 40X60.50X70.35X105",29600,40000,10400,26
TIKI,nha-cua-doi-song,51368456,"Bộ 6 thìa Inox 304 cán dài kiểu châu Á (số 11)",183000,210000,27000,13
TIKI,nha-cua-doi-song,54348370,"Kệ di động Inochi hàng cao cấp",111000,135000,24000,18
TIKI,nha-cua-doi-song,62292300,"Bộ vòi sen tắm lạnh – tay sen tăng áp  (Hàng chính hãng)",187000,350000,163000,47
TIKI,nha-cua-doi-song,67910007,"Vỉ 20 nẹp cố định dây điện dán tường, bàn ghế",33250,35000,1750,5
TIKI,nha-cua-doi-song,184591044,"Đèn Pixar, Đèn Bàn Chống Cận Thị, Đèn Đọc Sách LED, Đèn Làm Việc Bảo Vệ Mắt - Hàng Chính Hãng",218000,320000,102000,32
TIKI,nha-cua-doi-song,189568098,"Bình giữ nhiệt inox 304 Elmich",219000,499000,280000,56
TIKI,nha-cua-doi-song,51461989,"Thùng rác đạp chữ nhật Hiro 15L",139000,139000,0,0
TIKI,nha-cua-doi-song,84153167,"Kệ Sách Đa Năng Athena 5F Thương Hiệu IGEA",410000,445000,35000,8
TIKI,nha-cua-doi-song,66877577,"Hộp đựng cơm thủy tinh cao cấp 3 ngăn ( Giao mầu ngẫu nhiên)",89000,89000,0,0
TIKI,nha-cua-doi-song,121162213,"Set 10 Móc Treo Quần Áo Người Lớn Jodily inox 304 Sáng Bóng Bền Mãi Với Thời Gian",150000,150000,0,0
TIKI,nha-cua-doi-song,8141095,"Bình nước Lock&Lock Aqua HAP739B/HAP739W 2,6L",61000,109000,48000,44
TIKI,nha-cua-doi-song,120166109,"Bóng Philips LED bulb Essential E27 (5W,7W,9W,11W,13W) - E27 (3000K/6500K)",38000,66000,28000,42
TIKI,nha-cua-doi-song,42270992,"Bình Giữ Nhiệt Rinfere, Với Miệng Rộng, Nắp Quai Cầm - Nhiều Kích Cỡ Và Màu Sắc",319000,499000,180000,36
TIKI,nha-cua-doi-song,176530481,"Chiếu điều hòa tencel Lidaco (Nhiều mẫu lựa chọn)",389000,560000,171000,31
TIKI,nha-cua-doi-song,137796584,"Thảm Lau Chân Nhà Tắm Đa Năng Chất Liệu Chống Trơn Trượt Cao Cấp 4 Lớp Thấm Hút Tốt 40x60cm Loại 1 - Hàng Chính Hãng -( Màu Và Chữ Ngẫu Nhiên)",99000,99000,0,0
TIKI,nha-cua-doi-song,128935485,"Thìa Ăn Phở Ăn Soup - Inox 304 Jodily Cao Cấp Sáng Bóng Bền Mãi Với Thời Gian",15000,15000,0,0
TIKI,nha-cua-doi-song,106281062,"Bộ 6 Ly Bia Thuỷ Tinh Luminarc Benidorm 450ml - LUBEG2616",323000,386000,63000,16
TIKI,nha-cua-doi-song,117282929,"Phích ổ cắm đa năng LiOA chuyển 3 chân thành 2 chân 15A/220V Chân Tròn/Dẹt - Ổ điện chuyển đổi từ 3 chấu sang 2 chấu",20000,20000,0,0
TIKI,nha-cua-doi-song,133866129,"Móc Dán Tường Inox 304 Sang Trọng, Cứng Cáp, Dùng Keo 3M, Nhiều Kiểu Dáng Đẹp",49000,49000,0,0
TIKI,nha-cua-doi-song,124480954,"Nhang trầm hương tự nhiên Thiên Mộc Hương, 20cm, Ít Khói, Mùi thơm nhẹ diu, an toàn cho sức khỏe",200000,200000,0,0
TIKI,nha-cua-doi-song,134360858,"Bộ 8 Pin AA Panasonic 1,5V Không chì , Pin không chảy nước R6DT/4S - Hàng chính hãng",40000,60000,20000,33
TIKI,nha-cua-doi-song,165758266,"Bộ dao 3 chiếc Eco Family Sunhouse KS-KN3E1",277000,438000,161000,37
TIKI,nha-cua-doi-song,168641002,"Kệ Góc Đa Năng White Corner 5F Thông Minh Phong Cách Hiện Đại",322000,350000,28000,8
TIKI,nha-cua-doi-song,193713061,"Bàn Học Và Làm Việc Thông Minh Đa Năng Mặt Bàn Nghiêng 90 Độ, Bàn Laptop Xếp Gọn Có Bánh Xe - Hàng Chính Hãng",790000,999000,209000,21
TIKI,nha-cua-doi-song,89642725,"Bình xịt nước tưới cây bằng nhựa, bình xịt nước tạo mẫu tóc, xịt nước làm bánh cao cấp - Hàng chính hãng, giao màu ngẫu nhiên",41400,45000,3600,8
TIKI,nha-cua-doi-song,52581646,"Dây Đèn LED Rèm Trăng Sao Chống Thấm Nước Trang Trí Ngoài Trời - Dài 2.5 Mét",78596,78596,0,0
TIKI,nha-cua-doi-song,98556230,"Kệ Gỗ Trang Trí Treo Tường Không Cần Khoan Với Móc Treo Inox Và Đầy Đủ Phụ Kiện Tặng Kèm, Dễ Dàng Gắn Lên Tường",119000,125000,6000,5
TIKI,nha-cua-doi-song,74986118,"Màng Bọc Thực Phẩm PE Shinsen 30 x 40000",163000,163000,0,0
TIKI,nha-cua-doi-song,125149573,"Sáo Tiêu Recorder Soprano Yamaha YRS-402, YRS-20,YRS-24B Chính Hãng, Độ Bền Cao, Chất Liệu ABS An Toàn",129000,129000,0,0
TIKI,nha-cua-doi-song,7699055,"Chảo Nhôm Chống Dính Lock&Lock Baum Marble 1 Tay Cầm LBU1243C (24cm)",234000,451000,217000,48
TIKI,nha-cua-doi-song,34816875,"Dụng Cụ Thông Tắc Cống, Kẹp Gắp Rác Đa Năng Loại Tốt",36500,36500,0,0
TIKI,nha-cua-doi-song,72751318,"Báo Động Chống Trộm, Chuông Báo Khách Mở Cửa Đa Chức Năng Có Điều Khiển Từ Xa MC - 02, Báo Động Nhiều Chế Độ : Chống Trộm Xâm Nhập , Báo Chuông Cửa..",199000,199000,0,0
TIKI,nha-cua-doi-song,16170433,"Combo 3 lõi lọc nước yamato 1,2,3 - 10 inch",135000,155000,20000,13
TIKI,nha-cua-doi-song,169262530,"Băng Dính Chống Thấm Đa Năng, Chống Dột Dán Được Trên Mọi Bề Mặt Chọn Size Dododios – Băng Keo Siêu Dính Chống Thấm Cao Cấp Nhật Bản",29000,29000,0,0
TIKI,nha-cua-doi-song,171198348,"Ghế Xoay Văn Phòng Công Thái Học Ergonomic Có Ngả Lưng Gác Chân TANNI Premium 02 Plus, Ghế Xoay Gaming Cao Cấp Nhập Khẩu",1252000,2450000,1198000,49
TIKI,nha-cua-doi-song,135322547,"Set 10 Móc áo chống trượt Inochi Hara 186",45100,45100,0,0
TIKI,nha-cua-doi-song,37730520,"Thanh treo quần áo 4 chấu dán tường Hobby 4TV160 chuẩn Inox 304 - kèm keo dán siêu dính",149000,219000,70000,32
TIKI,nha-cua-doi-song,77746708,"Dây đèn led đom đóm trang trí pin không nháy tiểu dây bóng đèn fairy light cao cấp, tinh tế sang trọng decor phòng, du lịch, lều trại, luôn sáng - Chính hãng DEHA",65000,65000,0,0
TIKI,nha-cua-doi-song,181909421,"Nồi Thấp Suit LocknLock CSU1242PIK – 24cm - Màu Pink",602000,1184000,582000,49
TIKI,nha-cua-doi-song,85512749,"Kẹp dán tường thông minh - Không cần khoan lỗ, đục tường- Chịu lực lên đến 3Kg",28500,30000,1500,5
TIKI,nha-cua-doi-song,90852479,"Bộ liền 2 nhả kem đánh răng tự động, Giá treo bàn chải kèm 3 cốc hút từ tính lắp đặt dán tường - OE2KEM",225000,450000,225000,50
TIKI,nha-cua-doi-song,580040,"Chảo Đá Chống Dính Siêu Bền Sunhouse SBD24 24cm",203000,320000,117000,37
TIKI,nha-cua-doi-song,195732766,"Chế phẩm phòng trị xoăn ngọn, xoăn lá, khảm lá, sượng trái, An toàn sức khoẻ BS05 Movir 100/250ml NSX Bacsicayxanh",98000,98000,0,0
TIKI,nha-cua-doi-song,106677814,"Hộp thuỷ tinh chữ nhật Nikko 370 ml",43000,43000,0,0
TIKI,nha-cua-doi-song,70809147,"SET 2 TÚI ĐỰNG QUẦN ÁO KHUNG THÉP GẤP GỌN 66L -  Dài 50 cm x Rộng 40 cm x Cao 33 cm",139000,139000,0,0
TIKI,nha-cua-doi-song,199263969,"Bàn Trang Điểm Mini Ngồi Bệt Hiện Đại Thương Hiệu IGA - GP143",385000,419000,34000,8
TIKI,nha-cua-doi-song,167545572,"Bộ 2 hộp đựng đồ chia 7 ngăn sắp xếp quần áo dododios - Hộp vải đa năng HQ2 tiện ích, chất liệu cao cấp, phong cách Nhật Bản sang trọng",163000,163000,0,0
TIKI,nha-cua-doi-song,174299634,"Giá Treo Bàn Chải Nhà Tắm OENON - Bộ nhả kem đánh răng tự động kèm cốc và miếng dán tường - OEKEM",99000,190000,91000,48
TIKI,nha-cua-doi-song,98650585,"Bộ Ga Gối Cotton Kẻ 3F Lidaco Chuyên Dụng Cho Homestay, Khách Sạn (Nhiều Mẫu Lựa Chọn)",189000,250000,61000,24
TIKI,nha-cua-doi-song,213491032,"Bàn để ủi quần áo khung bằng thép Lebenlang LBB363",629000,888000,259000,29
TIKI,nha-cua-doi-song,1254623,"Chai Xịt Chăm Sóc Da, Nội Thất Ô Tô- 3M Leather & Vinyl Restorer PN39040LT (400ml) - Đen",165000,165000,0,0
TIKI,nha-cua-doi-song,152816167,"Bình Đựng Nước 2L Dễ Thương Có Vạch Báo Giờ Uống Nước Mỗi Ngày Kèm Khăn Lau 2 Mặt BaoAn - Hàng Chính Hãng",95000,99000,4000,4
TIKI,nha-cua-doi-song,72659983,"Khay Đựng Xà Bông Dán Tường OENON chất liệu nhựa ABS cao cấp - OE09",89000,150000,61000,41
TIKI,nha-cua-doi-song,73371758,"Găng tay làm vườn -  Găng Tay Chống Cắt Ansell 11-801 Cấp Độ 1 - Chống Đâm Xuyên, Giặt Và Tái Sử Dụng",57000,60000,3000,5
TIKI,nha-cua-doi-song,204279461,"Lư xông trầm gỗ hương nguyên khối cao cấp HÀ XÁ",398000,398000,0,0
TIKI,nha-cua-doi-song,10768010,"Đèn bắt muỗi Điện Quang ĐQ EML06L ",300000,300000,0,0
TIKI,nha-cua-doi-song,49116420,"Bút thử nước TDS, dụng cụ đo TDS, máy đo độ cứng của nước",102000,159000,57000,36
TIKI,nha-cua-doi-song,52760599,"Dây Đèn LED Đom Đóm Fairy Light Trang Trí Ngoài Trời Chống Nước, Nhiều Chế Độ Sáng",75050,79000,3950,5
TIKI,nha-cua-doi-song,119025800,"Bộ 5 Hộp Đựng Thực Phẩm Giỏ Có Nắp Đậy Khay Nhựa Kèm Rổ Ráo Nước Để Tủ Lạnh Bảo Quản Thức Ăn Tiện Dụng",119935,119935,0,0
TIKI,nha-cua-doi-song,114938906,"Bộ 6 Ly Thấp Thuỷ Tinh Luminarc Louvre 260ml -  LULON1808",281000,281000,0,0
TIKI,nha-cua-doi-song,195826972,"Chế phẩm xử lý lúa lộn, lúa cỏ, lúa 2 tầng, chống xì phèn, chết cây con BS11 Quản lý lúa lộn 500g NSX Bacsicayxanh",161000,161000,0,0
TIKI,nha-cua-doi-song,69253420,"Ổ khóa cao cấp Toplex, 1205-50mm",90000,90000,0,0
TIKI,nha-cua-doi-song,167391475,"Kệ Để Giày Dép 05 Tầng Khung Inox, Giá Để Giày Inox 05 Tầng, Giày Dép, Kệ Để Đồ, Kệ Sách Loại Cao Cấp miDoctor",102000,180000,78000,43
TIKI,nha-cua-doi-song,155184630,"Móc Treo Quần Áo, Móc Treo Đa Năng Hara, Bộ Sưu Tập Móc Quần Áo Người Lớn Nhựa Cao Cấp Inochi",26950,26950,0,0
TIKI,nha-cua-doi-song,204204717,"Nhang khoanh trầm hương HÀ XÁ xông nhà 100g đồ thờ cúng thanh lọc không khí, an toàn cho sức khỏe",398000,398000,0,0
TIKI,nha-cua-doi-song,121243851,"Vòi rửa bát inox 304 Pimisi gắn chậu rửa bát 1 đường nước lạnh đơn cho mọi loại chậu rửa chén phổ biến trong nhà bếp | Hàng chính hãng",463000,700000,237000,34
TIKI,nha-cua-doi-song,451852,"Cáp nối dài Điện Quang ĐQ EPF 2W.2PN dây dài 2m (Giao màu ngẫu nhiên)",43300,57608,14308,25
TIKI,nha-cua-doi-song,170876560,"Khăn giấy ướt vịt vàng 10 gói kèm thùng nhựa tiện dụng siêu đáng - Amina",49000,49000,0,0
TIKI,nha-cua-doi-song,148797223,"Bộ Hộp Cơm Giữ Nhiệt Văn Phòng Cao Cấp Cắm Điện inox 3 Tầng - Chính Hãng MINIIN",199000,199000,0,0
TIKI,nha-cua-doi-song,130978265,"Ổ cắm Xoay 90° Điện Quang ĐQ ESK RT 6GW (6 lỗ, màu xanh lá trắng)",82602,103300,20698,20
TIKI,nha-cua-doi-song,448378,"Hộp Cơm Giữ Nhiệt Zojirushi ZOCM-SL-JAF14-SA 4 Ngăn - 1.3L (Bạc)",890000,950000,60000,6
TIKI,nha-cua-doi-song,196362415,"Máy cắt cỏ, tỉa cành cầm tay LAPUSEN pin khủng 15000mah, động cơ mạnh 1800w",888000,888000,0,0
TIKI,nha-cua-doi-song,52145781,"Bàn Trà Cafe, Bàn Trà Sofa Phong Cách Bắc Âu Thương Hiệu IGEA",198000,218000,20000,9
TIKI,nha-cua-doi-song,249157000,"Giá Treo Bàn Chải Đánh Răng OENON liền 2 Nhả Kem tự động kèm cốc hút từ tính lắp đặt dán tường gạch men",99000,180000,81000,45
TIKI,nha-cua-doi-song,108280989,"1 Vỏ gối ôm cao cấp A kích thước 35x100cm (giao mẫu ngẫu nhiên), lớp vải dày cùng với đường may chắc chắn giúp bảo vệ lõi gối bên trong an toàn",55000,80000,25000,31
TIKI,nha-cua-doi-song,47461891,"Bộ 6 vỉ (12 viên pin) pin Kiềm Alkaline Panasonic AA LR6T/2B-Hàng chính hãng",175000,180000,5000,3
TIKI,nha-cua-doi-song,166659124,"Dao Nhật Bản Siêu Sắc Bén Hàng Chính Hãng Cao Cấp ",365000,365000,0,0
TIKI,nha-cua-doi-song,163583429,"Máy Xay Hạt Cafe, Hạt Khô, Hạt Tiêu, Ngũ Cốc, Đậu Nành Đa Năng, Cối Xay Thép Không Gỉ SUS 304 Cao Cấp - Hàng Chính Hãng MINIIN",199000,199000,0,0
TIKI,nha-cua-doi-song,71544914," Ổ Cắm Wifi Thông Minh TP-Link Tapo P100 - Hàng Chính Hãng ",219000,349000,130000,37
TIKI,nha-cua-doi-song,14526627,"Quánh Inox 430 Bếp Từ 3 Đáy Fivestar Nắp Kính",199000,360000,161000,45
TIKI,nha-cua-doi-song,181909432,"Chảo Suit LocknLock CSU1243PIK - Màu Pink",365000,709000,344000,49
TIKI,nha-cua-doi-song,130769103,"Bộ 12 Hũ Thủy Tinh Sọc Làm Sữa Chua 100ml, Hũ Lọ Yaourt, Lọ Pudding, Hủ Làm Sữa Chua, Caramen- Có Nắp Đậy- Hàng Chính Hãng MINIIN",63000,63000,0,0
TIKI,nha-cua-doi-song,149149135,"Kệ Gia Vị 3 Tầng Để Bàn Thương Hiệu IGA - GM04",183000,197000,14000,7
TIKI,nha-cua-doi-song,517873,"Giá Phơi Đồ Inox Co Giãn Thông Minh Prota - 86 Cm",290000,290000,0,0
TIKI,nha-cua-doi-song,164326067,"Bộ Chổi Điện Cọ Rửa Đa Năng Spin 3 Đầu - Máy Chà Tẩy Rửa Vệ Sinh Thông Minh Dùng Cho Nhà Tắm, Nhà Bếp - HÀNG CHÍNH HÃNG",495000,495000,0,0
TIKI,nha-cua-doi-song,56562967,"Combo 5 Miếng Xốp Dán Tường Giả Gạch Dày 4mm -  Trắng",69000,69000,0,0
TIKI,nha-cua-doi-song,186142362,"Ô Dù Chống Nắng Che Mưa Cản UV Tự Động Đóng Mở Khung 12 Xương",171000,180000,9000,5
TIKI,nha-cua-doi-song,76827765,"Pin Energizer ECR2025 Lithium 3V Chính Hãng | Bộ Vỉ 5 Viên",59000,59000,0,0
TIKI,nha-cua-doi-song,67096743,"Combo Full Bộ Ống Hút Inox 304 Thép Không Gỉ, Tái Chế Sử Dụng, Thân Thiện Môi Trường - Hàng Chính Hãng",29000,29000,0,0
TIKI,nha-cua-doi-song,50254577,"Thước Đo Khoảng Cách Bằng Tia Laser SNDWAY Phạm Vi 50m SW-M50 Cao Cấp AZONE",350000,350000,0,0
TIKI,nha-cua-doi-song,186883908,"Khăn tắm nén du lịch (70x140cm) bằng cotton thấm hút tốt, dùng một lần tiện lợi - Chính hãng MINIIN",29000,29000,0,0
TIKI,nha-cua-doi-song,81936306,"Kệ Decor Phòng Gương 2 Tầng Morning House",169000,169000,0,0
TIKI,nha-cua-doi-song,80657249,"Hộp vải đựng đồ đa năng có nắp TD3a và TD3b – Túi vải Thụy Điển có nắp rời 34L sang trọng vải Oxford chính hãng miDoctor",124000,200000,76000,38
TIKI,nha-cua-doi-song,263076438,"Gối chống trào ngược dạ dày thực quản người lớn Ema giúp giảm trào ngược dạ dày, viêm họng mãn tính, nuốt vướng, nghẹn cổ, khó thở khi ngủ, ngáy ngủ",573300,1170000,596700,51
TIKI,nha-cua-doi-song,135099603,"Cây lau nhà thay thế bộ lau nhà PX01 (Không bao gồm thùng vắt) - Parroti MOP-PX01",229000,280000,51000,18
TIKI,nha-cua-doi-song,92084871,"Giàn phơi đồ thông minh  đa năng, Giàn phơi để sàn Inox gấp gọn, Chính hãng NIKITA nhiều mẫu mã lựa chọn",885000,890000,5000,1
TIKI,nha-cua-doi-song,135059226,"Móc Dán Tường Inox 304 Dùng Keo 3M Siêu Chắc, Chịu lực lên đến hơn 20kg, Nhiều Kiểu Dáng Đẹp",41000,41000,0,0
TIKI,nha-cua-doi-song,16093882,"Phích Cắm Chuyển Đổi 3 Chấu Sang 2 Chấu Milliken NL-3106",15000,15000,0,0
TIKI,nha-cua-doi-song,57863885,"Đồng hồ LED để bàn hình hộp gỗ - Nhiệt kế - Báo thức - Cảm ứng âm thanh",142500,150000,7500,5
TIKI,nha-cua-doi-song,167046966,"Áo bọc bàn để ủi cầu là quần áo có mút Kokomega BU04 KT: 35*100cm( Và Sử Dụng Cho BU-120)",79000,79000,0,0
TIKI,nha-cua-doi-song,81647926,"Đầu nối chia điện đa năng 3 cửa SOPOKA P11 P12 chịu tải 2200W",29000,29000,0,0
TIKI,nha-cua-doi-song,159144262,"Cây lau nhà VILEDA Turbo Easy Wring&Clean đầu lau tam giác, xô giặt quay bằng chân, thêm 2 bông lau",695000,900000,205000,23
TIKI,nha-cua-doi-song,111410485,"Găng tay lao động chống cắt 3M Cấp độ 1 - Găng tay bảo hộ chống đâm xuyên tiêu chuẩn EN388:4131 - Sản phẩm chính hãng",32000,32000,0,0
TIKI,nha-cua-doi-song,33404972,"Tủ kệ sách để bàn HT003",65000,65000,0,0
TIKI,nha-cua-doi-song,59386141,"Bọc Giày Đi Mưa Silicon Siêu Bền Nhiều Màu",39000,39000,0,0
TIKI,nha-cua-doi-song,90597884,"Bàn Học Bàn Làm Việc Ngồi Bệt Model 1 Thông Minh - GP116",382000,415000,33000,8
TIKI,nha-cua-doi-song,63479866,"[CHÍNH HÃNG] Khoá treo đồng bấm Việt - Tiệp Cao cấp - Chống trộm | Mã SP: 01524",132600,132600,0,0
TIKI,nha-cua-doi-song,43389470,"Bàn Ăn Thông Minh Tiết Kiệm Diện Tích Màu Sắc Hiện Đại",1120000,1220000,100000,8
TIKI,nha-cua-doi-song,46207255,"Combo 2 túi lưới giặt đồ 2 lớp Polyester dạng lưới mịn giặt đồ chống biến dạng quần áo cho máy giặt dạng hộp khóa kéo phù hợp giặt đồ nhỏ đồ lót",64600,68000,3400,5
TIKI,nha-cua-doi-song,124483451,"TREO CHỔI TREO CÂY LAU NHÀ TREO Ô DÙ VÒI HOA SEN VÒI NƯỚC JODILY DÁN TƯỜNG INOX 304",45000,45000,0,0
TIKI,nha-cua-doi-song,196982238,"Phân bón vi lượng BS06 Nano Đồng Rửa vườn, tẩy rong rêu, nấm móc, phòng ngừa bệnh cây trồng 250/500ml NSX Bacsicayxanh",58000,58000,0,0
TIKI,nha-cua-doi-song,195732757,"Chế phẩm trị thán thư, thối trái, héo rũ, chết cây con, phòng ngừa nấm bệnh BS01 Chaetomium 200ml NSX Bacsicayxanh",270000,270000,0,0
TIKI,nha-cua-doi-song,73988526,"Đuôi thoát sàn ngăn mùi hôi, chống côn trùng trọng lực nhựa ABS Hiwin FD-50LID",54000,54000,0,0
TIKI,nha-cua-doi-song,75339729,"Chổi Quét Trần Nhà, Chổi Phất Trần Có Cán Điều Chỉnh Độ Dài KUNBE Quét Mạng Nhện, Lau Chùi Bụi Bẩn Trên Cao Tiện Dụng",149000,149000,0,0
TIKI,nha-cua-doi-song,187179371,"Dụng Cụ Kẹp Càng Cua, Ghẹ, Qủa Óc Chó Và Các Hạt Khô Tiện Ích Inox",65000,65000,0,0
TIKI,nha-cua-doi-song,73553244,"Hộp Đựng Trang Sức MOHI MH10 Kích Thước 10x10x5.5cm - Hàng Chính Hãng",64400,70000,5600,8
TIKI,nha-cua-doi-song,117058329,"Giấy lọc cà phê Hario 100 cái (V60-VCF-01-100W)",87000,99000,12000,12
TIKI,nha-cua-doi-song,114572066,"Combo set 6 móc treo dán tường đa năng chịu lực có sẵn keo dán màu trắng Deli - Nhiều kích cỡ - Phù hợp cho nhà tắm, nhà bếp - 19350",20000,36000,16000,44
TIKI,nha-cua-doi-song,241980823,"Combo 20 Kẹp Inox 304 Phơi Quần Áo, Chăn Mền",25000,25000,0,0
TIKI,nha-cua-doi-song,195827265,"Phân bón Canxi-Bo bổ sung vi lượng Chống rụng trái, nứt trái, trái chắc nặng, bóng đẹp BS16 250/500ml NSX Bacsicayxanh",81000,81000,0,0
TIKI,nha-cua-doi-song,162427187,"Dụng Cụ Bơm Hút Rượu Xăng Dầu Chất Lỏng Bóp Tay Tiện Lợi Đa Năng - Hàng Loại 1-  Chính Hãng MINIIN",76000,76000,0,0
TIKI,nha-cua-doi-song,187843307,"Đèn Năng Lượng Mặt Trời Chống Lóa 100W 200W 300W, 4LED 200W 300W 500W",1200000,1200000,0,0
TIKI,nha-cua-doi-song,69198239,"Ruột Gối Cao Cấp Vinpearl",417000,430000,13000,3
TIKI,nha-cua-doi-song,177679445,"Chuông Cửa Không Dây Thông Minh Besti YBT01 (1 Nút Bấm, 1 Chuông ), Chống Nước, Khoảng Cách Sử Dụng Hiệu Quả 300M, 60 Loại Nhạc Chuông, 4 Mức Điều Chỉnh Âm Lượng - Hàng Chính Hãng",220000,220000,0,0
TIKI,nha-cua-doi-song,213710307,"Lưỡi cưa xích RAKUTEN LOẠI 1 gắn máy mài cầm tay, bộ dụng cụ chuyển đổi máy mài thành máy cưa gỗ mini",133000,139000,6000,4
TIKI,nha-cua-doi-song,272452606,"Bộ cây lau nhà tự vắt thông minh 3 thanh vắt sợi microfiber",550000,1190000,640000,54
TIKI,nha-cua-doi-song,95875948,"Ổ khóa cửa treo Việt Tiệp đồng vàng",55000,61100,6100,10
TIKI,nha-cua-doi-song,89227279,"Giấy bạc dán tường nhà bếp chống thấm dầu, thấm nước tiện dụng, cách nhiệt",39000,69000,30000,43
TIKI,nha-cua-doi-song,108243510,"Chảo Inox cao cấp 5 Đáy chống dính siêu bền Sunhouse IN20M2 - 20 cm - Dùng trên mọi loại bếp - Hàng chính hãng",264000,287000,23000,8
TIKI,nha-cua-doi-song,107016572,"Thùng rác văn phòng lưới Deli - Sọt đựng rác - Màu đen - 28cm - 9188/E9190",99000,178200,79200,44
TIKI,nha-cua-doi-song,118090738,"Kệ Treo Tường - Thanh Ngang Trang Trí Màu Vân Gỗ Sồi Đơn Giản SIB Decor, Gỗ Chống Ẩm 25mm, Kết Cấu Không Giá Đỡ Chắc Chắn Thẩm Mỹ",159000,159000,0,0
TIKI,nha-cua-doi-song,67707813,"Phụ kiện Ngăn mùi nhà tắm - INOX 304 lắp thoát sàn chống mùi hôi ngăn vi khuẩn trào ngược lên – DH2011",99000,99000,0,0
TIKI,nha-cua-doi-song,137136435," Keo silicon Apollo A500 chống thấm tốt, bền bỉ (keo trong - keo trắng đục) 300ml",68000,68000,0,0
TIKI,nha-cua-doi-song,191326374,"Bộ Sạc Pin AA, AAA Beston Tự ngắt khi đầy Sạc Tốc Độ Cao Có Led báo trạng thái sạc BST-C9009, Pin sạc chính hãng",60000,60000,0,0
TIKI,nha-cua-doi-song,73829087,"Kệ để đồ rửa chén bát gác trên bồn rửa inox 304 Hobby Home Decor KRC5 có khay hứng nước",89000,98000,9000,9
TIKI,nha-cua-doi-song,52021362,"Bảng điện nổi V3 Điện Quang ĐQ FEP 32W 03S (màu trắng, 3 lỗ 2 chấu, 3 công tắc)",70000,91900,21900,24
TIKI,nha-cua-doi-song,187512713,"Ly Thủy Tinh Navivu Oval 380ml - Cốc Thủy Tinh Uống Trà",40000,40000,0,0
TIKI,nha-cua-doi-song,35422376,"Ô Dù 4 Lớp Che Nắng, Đi Mưa Chống Tia UV",37996,37996,0,0
TIKI,nha-cua-doi-song,202185819,"Bình Giữ Nhiệt Cao Cấp 304  Có Nắp Xoáy Tiện Lợi Giữ Nhiệt Nóng Lạnh",200000,200000,0,0
TIKI,nha-cua-doi-song,141001207,"Ghế Gấp Inox Phòng Chờ, Ghế Xếp Văn Phòng, Ghế Phòng Họp Gấp Gọn - Hàng Chính Hãng",800000,800000,0,0
TIKI,nha-cua-doi-song,101870479,"Thanh treo rèm cửa đa năng, không cần khoan tường hay bắt vít, thay đổi vị trí linh hoạt",69000,85000,16000,19
TIKI,nha-cua-doi-song,132209590,"Thảm chùi chân siêu thấm hút nước 3 giây  cho phòng tắm, phòng bếp, dễ dàng vệ sinh, nhanh khô vệ sinh nhà cửa an toàn với da.",30438,30438,0,0
TIKI,nha-cua-doi-song,26159911,"Decal dán tường thước đo chiều cao Hươu cao cổ 5 AmyShop (145 x 84 cm)",75000,75000,0,0
TIKI,nha-cua-doi-song,117370665,"Chiếu ngủ trưa văn phòng cá nhân dày 3.5ly / Chiếu Cách Nhiệt Văn Phòng 100 X 190 cm",46000,46000,0,0
TIKI,nha-cua-doi-song,84958837,"Kệ sách tổ ong đa năng.GP100",135000,135000,0,0
TIKI,nha-cua-doi-song,778124,"Bộ Hộp Cơm Giữ Nhiệt Lock&Lock LHC8015 (910ml) - Xám Bạc ",566100,1038000,471900,45
TIKI,nha-cua-doi-song,143299139,"Bình Đựng Nước Cho Bé, Bình Nước Goki Rudy 450ml, Bình Nước Cao Cấp Chính Hãng Inochi Đạt Tiêu Chuẩn Xuất Nhật",118000,118000,0,0
TIKI,nha-cua-doi-song,4995493,"Thang Nhôm Rút Chữ A Sumika SK380D NEW - Chữ A cao 1.9m, chữ I cao 3.8m, tải trọng 300kg",1738500,2300000,561500,24
TIKI,nha-cua-doi-song,162041563,"Giá Đỡ Ổ Cắm Điện; Khay Đi Gọn Dây Điện; Giá Đở Giấu Dây Gắn Dưới Bàn Làm Việc; Máng Luồn Dây",300000,300000,0,0
TIKI,nha-cua-doi-song,50324146,"Combo 5 Chai Thủy Tinh đựng nước 500ML - Nắp Thiếc vặn có dây treo (Bình thủy tinh đựng nước, đựng sữa - Chai thủy tinh đựng nước ép)",54000,54000,0,0
TIKI,nha-cua-doi-song,14886261," Máy sấy khử mùi giày",195000,195000,0,0
TIKI,nha-cua-doi-song,191604178,"Đèn đốt nến thơm, an toàn, sang trọng, phù hợp mọi không gian",435000,435000,0,0
TIKI,nha-cua-doi-song,72659852,"Kệ Nhà Tắm Dán Tường OENON chất liệu nhựa ABS có thêm thanh nhôm treo khăn - OE08",169000,300000,131000,44
TIKI,nha-cua-doi-song,174307623,"Đệm Ngồi Bệt Tròn Cho Bàn Trang Điểm Vải Cao Cấp Kiểu Hàn Chính Hãng IGA - GC13",81000,81000,0,0
TIKI,nha-cua-doi-song,107486345,"Bộ chăn ga giường Lidaco cotton Tici cao cấp (Nhiều mẫu lựa chọn)",249000,339000,90000,27
TIKI,nha-cua-doi-song,192909616,"Khăn mặt khô KIPOR dùng 1 lần lau khô, lau ướt - 60 khăn/cuộn, kích thước 20x20cm - Hàng chính hãng",65000,65000,0,0
TIKI,nha-cua-doi-song,75356087,"Túi Đựng Hộp Cơm Giữ Nhiệt Đa Lớp Cỡ Lớn 34cm*25cm*15cm",56430,59400,2970,5
TIKI,nha-cua-doi-song,81588389,"Rèm Kim Tuyến  Trang Trí Sinh Nhật 1,2m - Hàng Chính Hãng",34000,39000,5000,13
TIKI,nha-cua-doi-song,159144266,"Cây lau nhà VILEDA Turbo Easy Wring&Clean đầu lau tam giác, xô giặt quay bằng chân",604000,920000,316000,34
TIKI,nha-cua-doi-song,152548213,"Thùng rác đạp chữ nhật Hiro 15L (loại kèm ruột) - Giao màu ngẫu nhiên",179550,189000,9450,5
TIKI,nha-cua-doi-song,204230323,"Bộ nhang không tăm đầy đủ hộp đựng và máng đốt bằng gỗ nhà HÀ XÁ cao cấp",198000,198000,0,0
TIKI,nha-cua-doi-song,72797082,"Chảo Sâu Lòng DECOR Lock&Lock LDE1225IH 22cm (màu vàng) - Hàng chính hãng",388000,662000,274000,41
TIKI,nha-cua-doi-song,58451521,"Combo 2 Miếng Lau Nhà Parroti Magic MG01 – Kích Thước 32x10 CM - Chất Liệu Microfiber Cao Cấp",53000,109000,56000,51
TIKI,nha-cua-doi-song,44297321,"Đèn Diệt Côn Trùng Đại Sinh DS-D6",585000,585000,0,0
TIKI,nha-cua-doi-song,115436781,"Đèn Fairy Light Năng Lượng Mặt Trời Điều Khiển Remote",270000,270000,0,0
TIKI,nha-cua-doi-song,117196166,"Pin Maxell R6P super AA hộp 40 viên tiểu",75000,75000,0,0
TIKI,nha-cua-doi-song,173673833,"Ghế Quầy Bar Cao Cấp Phong Cách Hiện Đại Decor Tại Nhà Hoặc Văn Phòng Thư Giãn - Hàng Chính Hãng",865000,935000,70000,7
TIKI,nha-cua-doi-song,162405563,"Cọ Bồn Cầu Toilet Nhà Vệ Sinh Cao Cấp Kèm Giá Cắm Chổi  Silicon - Hàng Loại 1 - Chính Hãng MINIIN",89000,89000,0,0
TIKI,nha-cua-doi-song,191136118,"Bóng Đèn Led Bulb, Led Edison Đui E27 Các Loại - Hàng Chính Hãng NAVIVU",15000,15000,0,0
TIKI,nha-cua-doi-song,107713002,"Nam châm siêu trường, siêu mạnh, siêu hút dính dùng để trục vớt đồ vật, nâng vật nặng, treo đồ Dan House - DST15, Hàng chính hãng-D20",75000,92000,17000,18
TIKI,nha-cua-doi-song,73566076,"Cây lau nhà tự vắt thông minh chổi lau nhà 360 độ, kèm 2 miếng lau Kitimop-RED, vắt kiệt nước dễ dàng, cầm nhẹ tay, chổi lau nhà thông minh",145000,145000,0,0
TIKI,nha-cua-doi-song,108601464,"Pin kiềm Akaline AAA Deli - Vỉ 2 viên/ 4 viên - 18504/18505",19000,34200,15200,44
TIKI,nha-cua-doi-song,94888985,"Sọt Đựng Quần Áo Bẩn Túi Đựng Đồ Đa Năng",90250,95000,4750,5
TIKI,nha-cua-doi-song,69543163,"Cây thông tắc bồn cầu, nhà vệ sinh đa năng cao cấp- Dụng cụ thông tắc bồn cầu, cống bằng khi nén áp lực siêu mạnh kèm bơm rời Morado - Hàng Chính Hãng",310000,310000,0,0
TIKI,nha-cua-doi-song,173710560,"Cuộn Khăn Giấy Lau Đa Năng - Chất Liệu Rayon An Toàn - Lau Chén Đĩa , Lau Nhà Bếp..vv - Hàng Chính Hãng",39000,78000,39000,50
TIKI,nha-cua-doi-song,19853979,"Võng lưới số 9.2, căng kim dày BAN MAI, khổ rộng, cán thép 50 (Giao màu ngẫu nhiên)",224000,300000,76000,25
TIKI,nha-cua-doi-song,81988120,"Dây nguồn phích âm SOPOKA N8-N10 dây 2,3m-6,5m",43000,43000,0,0
TIKI,nha-cua-doi-song,73755163,"Hộp Đựng Mỹ Phẩm,Đồ Trang Điểm MOHI MT9 ,2 Ngăn Có Kệ Trên Và Nắp Đậy-Hàng Chính Hãng",414000,450000,36000,8
TIKI,nha-cua-doi-song,162189829,"Nhang Xanh Phổ Thông 30cm 500g (Đỏ)",165000,165000,0,0
TIKI,nha-cua-doi-song,70536777,"Đèn bắt muỗi, ruồi và các loại côn trùng Đại Sinh DS-D6",585000,585000,0,0
TIKI,nha-cua-doi-song,49724259,"Nệm Foam Cao Cấp Nest Ru9 15cm - Màu Xám | 100 Đêm Ngủ Thử | 2 Lớp Foam Nâng Đỡ | Bao Gồm 6 Kích Thước",5211000,5790000,579000,10
TIKI,nha-cua-doi-song,131407865,"bàn làm việc chân gấp gọn",428000,450000,22000,5
TIKI,nha-cua-doi-song,58448882,"Thanh xốp chắn khe cửa đa năng thông minh",21000,24000,3000,13
TIKI,nha-cua-doi-song,54752502,"Bộ 10 khăn lau 2 mặt xuất Nhật Toki - Khăn lau không phai màu không rụng sợi- nhanh khô- Khăn lau bếp, khăn lau kính, lau bát lau tay - HN09421L",10000,16000,6000,38
TIKI,nha-cua-doi-song,77317036,"Combo 2 Chai Nước Ngâm Rửa Rau Củ Quả Sinh Học ENZYCO Lên Men Từ Dứa Loại Bỏ Hóa Chất Thuốc Trừ Sâu Khử Mùi Tanh Thực Phẩm",210000,210000,0,0
TIKI,nha-cua-doi-song,108243508,"Chảo sâu đáy từ miệng rót Sunhouse SHS20MRD - Dùng trên mọi loại bếp - Hàng chính hãng",255000,400000,145000,36
TIKI,nha-cua-doi-song,148877182,"Ruột gối nằm K-Bedding chất liệu Microfiber màu ngẫu nhiên (45x65cm)",300000,400000,100000,25
TIKI,nha-cua-doi-song,74307763,"Chảo Wok Lock&Lock Handycook LHD1165 Có Tay Cầm 15.5cm - Màu Xám",123000,242000,119000,49
TIKI,nha-cua-doi-song,13561925,"Nồi Hấp 2 Tầng Bằng Inox Lock&Lock LLH1282 (28cm)",773000,1319000,546000,41
TIKI,nha-cua-doi-song,175432384,"Bàn để ủi quần áo cao cấp Nakagami tư thế đứng có giá đỡ chất lượng Công nghệ Nhật Bản - Màu ngẫu nhiên - Hàng chính hãng",395000,395000,0,0
TIKI,nha-cua-doi-song,62734430,"Gói 5 Kg Phân bón đầu trâu hữu cơ vi sinh cao cấp Trichoderma + TE giúp kháng bệnh và tăng trưởng khỏe cho cây trồng",119000,119000,0,0
TIKI,nha-cua-doi-song,112218352,"Ron Gioăng Chữ T Dán Chặn Che Khe Hở Khung Chân Cửa Chống Gió Bụi Côn Trùng Thoát Hơi Máy Lạnh",13000,13000,0,0
TIKI,nha-cua-doi-song,117291914,"Bàn Trang Điểm Ngồi Bệt IGA Sắp Xếp Mỹ Phẩm, Son Gọn Gàng - GP143",385000,419000,34000,8
TIKI,nha-cua-doi-song,154157961,"Màn Dây Không Cửa FUNU Chống Muỗi Cao Cấp, Vải Màn Mềm, Mịn, Mắt Dày Dặn Chống Muỗi Tuyệt Đối - Hàng Chính Hãng",143000,155000,12000,8
TIKI,nha-cua-doi-song,984246,"Kèn Melodion - Melodica Suzuki MX-37 37 Phím",750000,750000,0,0
TIKI,nha-cua-doi-song,207227522,"Giấy nến nấu ăn thương hiệu MyJae",53000,130000,77000,59
TIKI,nha-cua-doi-song,101627081,"Ô dù cầm tay siêu nhẹ 105g cho phái đẹp, chống tia UV - Nason Feather Umbrella for Lady - Dù gấp gọn bỏ túi Nason",199000,295000,96000,33
TIKI,nha-cua-doi-song,162210732,"Bộ Tua Vít Deli Cao Cấp 30 Chi Tiết Đa Năng Vặn Ốc Vít, Bu Lông - Phù Hợp Sửa Chữa Vật Dụng, Xe Máy - DL1130",161000,268000,107000,40
TIKI,nha-cua-doi-song,196376951,"Cốc Giữ Nhiệt Nóng Lạnh Vusign Inox 304 Cao Cấp Viền Cao Su Cách Nhiệt Deli Dung Tích 510ml -Phù Hợp Cà Phê Trà Nước Ép Sinh Tố Đá Du Lịch Đi Học Tập Gym",139000,250200,111200,44
TIKI,nha-cua-doi-song,20680352,"Combo 5 bẫy diệt chuột thông minh",75000,75000,0,0
TIKI,nha-cua-doi-song,72049797,"Set 02 Cuộn Giấy Nến, Giấy Sáp, Giấy Lót Nướng Bánh, Lẩu Nướng, Hấp Bánh, Nướng Thực Ăn Chịu Nhiệt, Chống Dính, Không Thấm Dầu Tiện Dụng 30cm x 5m + Tặng Chổi Phếu Dầu Ăn",45000,45000,0,0
TIKI,nha-cua-doi-song,136227595,"Khay đựng remote  - điện thoại dán tường có khe luồn sạc nhỏ gọn tiện lợi  ( Giao màu ngẫu nhiên ) - Hàng chính hãng ",30000,30000,0,0
TIKI,nha-cua-doi-song,148026925,"Bình Đựng Nước 2L Dễ Thương Có Vạch Báo Giờ Uống Nước - Hàng Loại 1 - Chính Hãng MINIIN",102000,102000,0,0
TIKI,nha-cua-doi-song,189208326,"Thảm nhà tắm, nhà bếp siêu thấm nước, chống trơn trượt tối giản, hiện đại NAVIVU",94050,99000,4950,5
TIKI,nha-cua-doi-song,195891839,"Đèn LED Mini Móc Khóa - Đèn Pin COB - Đèn Pin Dã Ngoại - Sạc USB Tiện Dụng - Hàng Loại 1 - Chính Hãng MINIIN",59000,59000,0,0
TIKI,nha-cua-doi-song,794973,"Gối Cao Su Liên Á Oval LAGOV4565 (45 x 65 cm) - Trắng",701000,825000,124000,15
TIKI,nha-cua-doi-song,55502241,"Bộ chăn ga gối cotton LIDACO PL1 - Dưa Hấu Hồng (SP001111)",199000,299000,100000,33
TIKI,nha-cua-doi-song,10115744,"Ổ cắm Điện Quang ECO ĐQ ESK 2BR 6ECO (6 Lỗ, dây dài 2m, màu đen đỏ)",108268,135300,27032,20
TIKI,nha-cua-doi-song,111705115,"Túi đựng dụng cụ 13 inch INGCO HTBG281328",90000,97000,7000,7
TIKI,nha-cua-doi-song,275587431,"Ổ cắm điện đa năng Hoco DC15 sạc nhanh PD18W hỗ trợ 4 cổng USB- cổng AC tiện dụng - Hàng chính hãng",229000,400000,171000,43
TIKI,nha-cua-doi-song,73639522,"Miếng lau nhà thay thế Cây lau nhà KITIMOP-RED ( 38 x 12cm)",15000,19000,4000,21
TIKI,nha-cua-doi-song,169208973,"Bộ 3 Hộp Nhựa đựng Thực Phẩm Chữ Nhật Hokkaido Inochi 500 -1000 -2000 ML Chịu Nhiệt Giao Màu Ngẫu Nhiên",198000,198000,0,0
TIKI,nha-cua-doi-song,59163919,"Túi Đựng Chăn Màn (Được Chọn Màu) - Hộp Đựng Quần Áo Khung Sắt Gấp Gọn - Tủ Vải Chăn Màn Tiện Lợi",83000,83000,0,0
TIKI,nha-cua-doi-song,21326864,"Decal giấy dán tường kệ xương rồng  HM71007",49000,94000,45000,48
TIKI,nha-cua-doi-song,38452362,"Giấy thơm và làm mềm Vải Bounce Outdoor Fresh 160 tờ - Canada",214000,214000,0,0
TIKI,nha-cua-doi-song,112321653,"Thảm lau chân nhà tắm siêu thấm cao cấp chất liệu sợi lông cừu dày mềm mại - Hàng nhập khẩu",89000,89000,0,0
TIKI,nha-cua-doi-song,188196590,"Nạo, Gọt Vỏ Hoa Củ Quả Inox 304 Cán Gỗ Cao Cấp Jodily StarHome",55000,55000,0,0
TIKI,nha-cua-doi-song,144532704,"[HÀNG CHÍNH HÃNG]Kéo nhà bếp đa sắc màu dài 25cm, lưỡi kéo dài 14cm bằng thép không gỉ của GGOMi Hàn Quốc GG173",61200,68000,6800,10
TIKI,nha-cua-doi-song,173972990,"Bộ 3 hộp tròn 400ml đựng cơm kèm túi hộp thủy tinh chịu nhiệt cường lực COBA'COOK- XẢ KHO",200000,339000,139000,41
TIKI,nha-cua-doi-song,104557047,"   Ổ cắm Điện Quang ĐQ ESK 5W.SM750SL (5 lỗ 3 chấu dây 5 mét màu Trắng Đỏ)",202000,202000,0,0
TIKI,nha-cua-doi-song,192120961,"Túi Zip Lụa Nhựa CPE Trong Mờ Có Khóa Kéo Đa Năng",38950,41000,2050,5
TIKI,nha-cua-doi-song,38445652,"Bộ 6 Ly Thủy Tinh Uống Bia Úp Ngược 8 Góc Cao Camdaco (420ML)",77000,77000,0,0
TIKI,nha-cua-doi-song,186654717,"Combo 4 Miếng Dán Treo Kệ, Rổ, Miếng Treo Dành Cho Hộp Giấy Ecoco",22800,24000,1200,5
TIKI,nha-cua-doi-song,186557908,"Túi 100 Dây Rút, Lạt Nhựa (Trắng/Đen) Siêu Bền Để Làm Vườn, Thi Công Tiện Lợi",18525,19500,975,5
TIKI,nha-cua-doi-song,155287344,"Hộp Đựng Trứng Hai Tầng 32 Ô Tiện Dụng Tích Hợp Khay Trượt Đựng Trứng gà Phong Cách Nhật Bản",85000,85000,0,0
TIKI,nha-cua-doi-song,196675194,"Đệm Ngồi 3D Silicon 2 Lớp Tổ Ong Lót Ghế Thoáng Khí Chống Đau Mỏi Lưng Amalife ",107700,107700,0,0
TIKI,nha-cua-doi-song,69240971,"Ổ khóa cao cấp Toplex, chống cắt tròn, size 40mm",80000,80000,0,0
TIKI,nha-cua-doi-song,193723418,"Lót Ly Siêu Thấm Diatom Mud Họa Tiết Gạch Terrazzo",26000,26000,0,0
TIKI,nha-cua-doi-song,32729258,"Gói 1+1 Cây lăn bụi lớn Scotch Brite 3M XA010909407",96000,99000,3000,3
TIKI,nha-cua-doi-song,69182343,"Bộ Hộp Cơm Giữ Nhiệt Thủy Tinh Văn Phòng Cao Cấp - Kèm Túi Xách giữ nhiệt hình cá ( mầu sắc ngẫu nhiên)",125000,125000,0,0
TIKI,nha-cua-doi-song,11097788,"Ổ cắm công suất lớn Điện Quang ĐQ ESKHP 3RB 5M (3 lỗ, màu đỏ đen, dây dài 5m)",182000,250700,68700,27
TIKI,nha-cua-doi-song,144868820,"Hương nhang Quế Dương Minh nhang sạch 100% thành phần organic nhang thơm tự nhiên không hóa chất nhang cây an toàn",110000,180000,70000,39
TIKI,nha-cua-doi-song,52676101,"Bộ Combo 100 Túi Lọc Rác Siêu Tiên Ích Cho Bồn Rửa Bát",17000,22000,5000,23
TIKI,nha-cua-doi-song,54583763,"Đèn bàn học Rạng Đông chính hãng RD RL 38 LED",189000,189000,0,0
TIKI,nha-cua-doi-song,56537855,"Bộ dụng cụ sửa chữa đa năng chính hãng HAKAWA HK-850",1790000,2490000,700000,28
TIKI,nha-cua-doi-song,99211523,"Nồi inox FiveStar Standard 3 đáy sandwich bếp từ nắp kính tặng 1 muỗng canh ( 16cm / 18cm / 20cm / 24cm )",199000,350000,151000,43
TIKI,nha-cua-doi-song,184318192,"Ly Giữ Nhiệt Matte 3 Lớp INOX304 900ml - Tặng Kèm Túi và Ống Hút",150000,150000,0,0
TIKI,nha-cua-doi-song,194818369,"Hộp Đựng Trang Sức Mini Cho Nữ, Đựng Vòng Cổ Nhẫn Bông Tai Hộp Đựng Đồ Trang Sức Có Khóa Kéo",73000,76000,3000,4
TIKI,nha-cua-doi-song,51461576,"Thùng rác đạp chữ nhật Hiro 10L",99000,99000,0,0
TIKI,nha-cua-doi-song,76254098,"Ruột Chăn Hè Thu Lidaco Chần Bông Bông Trắng Tinh Khiết Kích Thước 2mx2,2m",209000,280000,71000,25
TIKI,nha-cua-doi-song,73743740,"Combo 6 tấm lót bàn ăn cao cấp chịu nhiệt, chống thấm, chống trượt giúp trang trí bàn ăn sang trọng như khách sạn 5 sao - Hàng chính hãng",151800,165000,13200,8
TIKI,nha-cua-doi-song,66672429,"Bộ 2 móc dán tường treo chổi, cây lau nhà, móc treo tường tiện lợi, Giao màu ngẫu nhiên",19000,20000,1000,5
TIKI,nha-cua-doi-song,75440160,"Móc dán tường chịu lực",700,1000,300,30
TIKI,nha-cua-doi-song,127743951,"Thanh vắt khăn nhà tắm OENON, Giá treo dép phòng tắm dán tường gạch men chất liệu nhựa ABS - OE48",129000,129000,0,0
TIKI,nha-cua-doi-song,76070067,"Giá Để Đồ Nhà Tắm OENON, Kệ treo máy sấy tóc chất liệu nhựa ABS cao cấp lắp đặt dán tường - OE039",99000,180000,81000,45
TIKI,nha-cua-doi-song,148873333,"Sạc Thông Minh K65 3.7V 4.2V Sạc Các Loại Pin 14500, 18650 (Sạc tự ngắt, có đèn báo, không kèm pin)",94050,99000,4950,5
TIKI,nha-cua-doi-song,627748,"Áo Mưa Rando Easy Trum APPC-10",76000,76000,0,0
TIKI,nha-cua-doi-song,43808661,"Bồ đoàn (đệm) ngồi thiền vỏ đậu xanh The Yogis'Shop | Đường kính 25cm - 30cm",195000,195000,0,0
TIKI,nha-cua-doi-song,73100258,"Kệ Nhà Tắm OENON Cao Cấp lắp đặt Dán Tường, Kệ để đồ phòng tắm cao cấp ",175000,350000,175000,50
TIKI,nha-cua-doi-song,99338532,"LƯỚI VÕNG DUY LỢI MỀM MỊN NẰM ÊM",429000,429000,0,0
TIKI,nha-cua-doi-song,106563599,"Bóng đèn PHILIPS LED Bright E27-Công suất (9W, 11W, 13W, 15W, 17W) ánh sáng vàng, ánh sáng trắng",64600,89500,24900,28
TIKI,nha-cua-doi-song,10914085,"Ổ cắm Điện Quang ĐQ 001A-02-2M (2 lỗ dây 2 mét)",72000,98000,26000,27
TIKI,nha-cua-doi-song,190791221,"Hộp 4 pin sạc AA AAA Beston dung lượng cao, sạc lại nhiều lần - Hàng chính hãng",60000,60000,0,0
TIKI,nha-cua-doi-song,161683477,"Xô nước nhựa màu xám 10L và 14L",119000,119000,0,0
TIKI,nha-cua-doi-song,106281094,"Bộ 6 ly thủy tinh thấp Luminarc Salto 320ml  -LUSAG2562",235000,281000,46000,16
TIKI,nha-cua-doi-song,99211918,"Nắp kính cường lực Fivestar dùng cho nồi -chảo-quánh-bộ nồi xửng(16 cm /18cm /20cm/ 22cm/24cm / 26cm / 28cm/ 30cm/ 32cm)",62000,110000,48000,44
TIKI,nha-cua-doi-song,87864580,"Rổ (Khay) Úp Chén Dĩa Có Khay Đựng Nước",70000,75000,5000,7
TIKI,nha-cua-doi-song,50252568,"Thước Đo Khoảng Cách Laser SNDWAY 50m - 70m - 100m - 120m Phạm Vi Đo Tùy Chọn Chuyên Dụng Cho Thiết Kế",350000,350000,0,0
TIKI,nha-cua-doi-song,58132193,"Giường xếp gọn thư giãn văn phòng SUMIKA 183 - Khung thép, vải lưới Oxford, tải trọng 450kg",940500,1350000,409500,30
TIKI,nha-cua-doi-song,28324641,"Bình Nước Handle Bottle 1.4L-PP-VN-15 HAP817PIK",42000,83000,41000,49
TIKI,nha-cua-doi-song,372944,"Chảo Nướng Chống Dính Kova Vuông HGS",323000,450000,127000,28
TIKI,nha-cua-doi-song,140011015,"Vòi hoa sen Luva VS6, đường kính bát sen 11cm, Bật/Tắt trực tiếp trên vòi sen",248000,248000,0,0
TIKI,nha-cua-doi-song,121004607,"Bình Nước Thuỷ Tinh Luminarc Octime 1,1L - LUBIG2664 ",158000,158000,0,0
TIKI,nha-cua-doi-song,275471374,"Combo 6 cuộn Túi đựng rác gia đình, Bao đựng rác văn phòng tiện lợi màu đen size trung 55x65",39000,39000,0,0
TIKI,nha-cua-doi-song,104273703,"Đèn LED Để Bàn Thông Minh Tự Động 2200mAh Cho Phòng Ngủ, Văn Phòng, Bàn Học, Bảo Vệ Mắt - Hàng Chính Hãng Baseus",620000,650000,30000,5
TIKI,nha-cua-doi-song,179505447,"Bình Nước Giữ Nhiệt Cute 800ml Chất Liệu Inox 304 Giữ Nhiệt Không Gỉ Nóng Lạnh 24 Giờ Kèm Ống Hút Và Sticker - Hàng Loại 1 - Chính Hãng MINIIN",98250,131000,32750,25
TIKI,nha-cua-doi-song,137181690,"Nhang Xanh Trầm Hương - Cao 20cm Hộp 200 gram",82500,82500,0,0
TIKI,nha-cua-doi-song,162116332,"Bộ 6 Tô Thuỷ Tinh Luminarc Diwali Lines 18cm - LUDIQ1672",497000,630000,133000,21
TIKI,nha-cua-doi-song,197676301,"Tủ nhựa TABI Vân gỗ cao cấp, chất lượng, giá rẻ, nhiều mẫu mã chính hãng Nhựa Duy Tân",999000,1300000,301000,23
TIKI,nha-cua-doi-song,75881900,"Kệ để lò vi sóng 2 tầng hình chữ Z, khung thép sơn tĩnh điện, mặt bằng gỗ MDF xử lý chống ẩm - Chính hãng",395000,395000,0,0
TIKI,nha-cua-doi-song,116766480,"Túi Đựng Bình Nước Grepaco Giữ Nhiệt Dạng Quai Xách Thể Thao Phù Hợp Bình/Ly Nước Thể Tích 500ml, 750ml, 800ml, 900ml, 1500ml – Vải Bố Canvas",59000,59000,0,0
TIKI,nha-cua-doi-song,191356959,"Dù Chống Tia UV MINI Siêu Gọn 8 Xương Có Hộp Đựng Chống Sốc",142500,150000,7500,5
TIKI,nha-cua-doi-song,162122783,"Bộ 6 Đĩa Sâu Thuỷ Tinh Luminarc Diwali Lines 20cm - LUDIQ1662",370000,470000,100000,21
TIKI,nha-cua-doi-song,138456818,"Màng bọc thực phẩm Laspalm chính hãng MBTP00006163",112000,174900,62900,36
TIKI,nha-cua-doi-song,99213205,"Nồi inox Fivestar 3 đáy bếp từ nắp inox (16cm ) ,tặng 1 muỗng canh",199000,350000,151000,43
TIKI,nha-cua-doi-song,20223034,"Decal dán tường kệ hoa trang trí SK6093DS",49000,80000,31000,39
TIKI,nha-cua-doi-song,73400195,"Máy ủ ấm khăn giấy ướt Fatzbaby - Warm 1 - FB7200MX Hàng chính hãng",822000,822000,0,0
TIKI,nha-cua-doi-song,181223608,"Bộ vòi xịt vệ sinh rửa toilet tăng áp inox 304 Hobby home decor VSR1 dây sen 1.2m",128000,148000,20000,14
TIKI,nha-cua-doi-song,16341786,"Bình Giữ Nhiệt Lock&Lock LHC1439 Dung Tích 1000ml",290000,569000,279000,49
TIKI,nha-cua-doi-song,105731887,"Kìm bấm ghim 3 trong 1 INGCO HSG1405",135000,145000,10000,7
TIKI,nha-cua-doi-song,19522394,"Bộ Đàn Ukulele Concert BWS - Bao, Capo, Móng Gẩy BWS (Bảo trì trọn đời - Uku Gỗ Mahogany trơn cỡ trung 23 inch B-01 - Kèm Sách giáo trình học Ukulele online cơ bản dài 80 trang)",590000,590000,0,0
TIKI,nha-cua-doi-song,52316356,"Bộ máy khoan pin RAKUTEN 66V  khoan tường, khoan sắt, khoan bê tông máy 2 pin, đảo chiều và mũi khoan",588000,588000,0,0
TIKI,nha-cua-doi-song,107409149,"Bộ dây đàn Guitar Classic (Nylon) - D'Addario EJ27N - Normal Tension, Clear Nylon - Hàng chính hãng",190000,252000,62000,25
TIKI,nha-cua-doi-song,80934535,"Ổ chia điện, đầu nối thông minh SOPOKA Q3T-Q5T chia 3 chia 5 siêu gọn, siêu tiết kiệm",35000,35000,0,0
TIKI,nha-cua-doi-song,754592,"Ổ Cắm Điện 3D + 3S Dây 3m x 2 Lioa 3D3S32 - Đen",120000,120000,0,0
TIKI,nha-cua-doi-song,39286757,"Túi lưới giặt giày quần áo tổ ong có khoá kéo cao cấp dùng cho máy giặt nhanh chóng và tiện lợi",46550,49000,2450,5
TIKI,nha-cua-doi-song,73571741,"Bàn Trà Sofa Hiện Đại Thương Hiệu IGEA",294000,320000,26000,8
TIKI,nha-cua-doi-song,25421013,"Bộ Nồi Inox 3 Đáy Sunhouse SH335(16cm, 20cm, 24cm ) - Dùng trên mọi loại bếp - Hàng chính hãng",345000,620000,275000,44
TIKI,nha-cua-doi-song,59518200,"Nệm tiện ích Everon  201 ( Màu ngẫu nhiên )",350000,350000,0,0
TIKI,nha-cua-doi-song,144492733,"Nệm cói/đệm ngồi bệt cói ONGTRE cao cấp dành cho nhà hàng, quán cafe, phòng khách, đệm yoga",79350,115000,35650,31
TIKI,nha-cua-doi-song,150851260," Miếng Xốp Dán Tường Giả Gạch 3D- Trang Trí Nhà Cửa, Phòng Học, Nhà Hàng , Chống Thấm, Ẩm Mốc -Lớp Dán Siêu Chắc - Hàng Chính Hãng MINIIN(70 x 77cm)",15000,15000,0,0
TIKI,nha-cua-doi-song,59359188,"PHÍCH  CẮM CHUYỂN ĐỔI 3 CHẤU SANG 2 CHẤU VÀ CHIA 2 Ổ TOSHINO PS18-A2  2000W - HÀNG CHÍNH HÃNG",49000,49000,0,0
TIKI,nha-cua-doi-song,10647257,"Ổ cắm Điện Quang ĐQ ESK 2B.SM750SL (5 lỗ 3 chấu dây 2 mét màu Đen Trắng Đỏ)",191000,238700,47700,20
TIKI,nha-cua-doi-song,68788653,"Tủ Quần Áo miDoctor Cải Tiến Thế Hệ Mới, Tủ Vải Quần Áo 3 Buồng 8 Ngăn 1,7m Cao Cấp",358000,373000,15000,4
TIKI,nha-cua-doi-song,79445924,"Nến thơm hoa khô thiên nhiên, sáp nến thơm phòng MO hi cao cấp - Hàng chính hãng, giao màu, hình, họa tiết hộp ngẫu nhiên",41400,45000,3600,8
TIKI,nha-cua-doi-song,101858930,"Áo Mưa Khoá Kéo, Áo Mưa Măng Tô Vải Dù Cao Cấp, Hàng Việt Nam, Khổ To Rộng, Chống Thấm Hiệu Quả, Phù Hợp Nam Và Nữ, Có Túi Đựng, Có Lựa Chọn Màu Sắc",140000,140000,0,0
TIKI,nha-cua-doi-song,59292206,"Lõi lọc BRITA ON TAP VM-F- Thương hiệu đến từ Đức",699000,1069000,370000,35
TIKI,nha-cua-doi-song,179759048,"Bộ 10 Móc Dán Tường Gạch Men INOX304, Móc Dán Tường Keo 3M Treo Đồ Dùng Gia Đình - M08",69000,120000,51000,43
TIKI,nha-cua-doi-song,59358608,"Combo 2 Ron Thanh Nẹp Xốp Chèn Chắn Cửa Chống Bụi Côn Trùng Dài 95cm Legaxi",40000,40000,0,0
TIKI,nha-cua-doi-song,59602156,"Combo Bộ 2 gối nằm + 1 gối ôm - Gòn bông nhân tạo an toàn sức khỏe - Có khóa kéo dễ dàng thêm bớt gòn bên trong - Êm ái, mềm mịn",225000,240000,15000,6
TIKI,nha-cua-doi-song,103757642,"Chuông Báo Khách Cửa Hàng, Báo Động Chống Trộm Cảm Biến Chuyển Động Hồng Ngoại Không Dây CTFAST 02 - Lời Chào Báo Khách Ghé Thăm, Dọa Trộm Xâm Nhập",375000,409000,34000,8
TIKI,nha-cua-doi-song,20557823,"Bộ dây 20 kẹp ảnh có đèn led trang trí sinh nhât, nhà cửa, sự kiện chụp ảnh MT-203 (dùng pin AA)",76000,80000,4000,5
TIKI,nha-cua-doi-song,15666493,"Bộ 6 thìa Inox 304 ngắn bún phở DandiHome",152000,210000,58000,28
TIKI,nha-cua-doi-song,69754010,"Keo dán Đa Năng Nhật Bản Dán thủy tinh, bê tông, gạch, đá, gỗ , nhựa cứng ULTRA SU HARD (CỨNG) 10ml #05140, chống thấm nước  (Hàng nội địa Nhật)",117810,138600,20790,15
TIKI,nha-cua-doi-song,100867528,"Hộp Thủy Tinh Kháng Khuẩn Tròn Nikko 400ml-620ml-950ml Chính Hãng Inochi",40000,40000,0,0
TIKI,nha-cua-doi-song,146845870,"Đèn Bàn Học Chống Cận Thị, Đèn Đọc Sách, Đèn Làm Việc Bảo Vệ Mắt - Đèn Bàn Học LED USB Di Động Cao Cấp Có Thể Gập Hai Chỗ – 03 Chế Độ Ánh Sáng Vàng Bảo Vệ Mắt Chống Cận, đèn học để bàn, đèn học cho học sinh sinh viên, trang trí - Hàng Chính Hãng dododios",228000,228000,0,0
TIKI,nha-cua-doi-song,187184291,"Băng Dính Silicol 2 Mặt Siêu Dính Siêu Tiện Lợi Ứng Dụng Vào Mọi Công Việc Vị Trí Trong Gia Đình",35000,35000,0,0
TIKI,nha-cua-doi-song,43878049,"Ổ cắm chia 3 ngả đa năng MPE TA4 - Tích hợp 2 cổng USB sạc nhanh 2.4A",190000,190000,0,0
TIKI,nha-cua-doi-song,85029113,"Set 5 Phích cắm công suất lớn cao cấp Điện Quang ĐQ EPR HP 2PN (Màu ngẫu nhiên)",53727,97700,43973,45
TIKI,nha-cua-doi-song,130978475,"Đèn Pin LED Điện Quang ĐQ PFL08 R (Pin sạc)",108000,146606,38606,26
TIKI,nha-cua-doi-song,153665555,"Hũ Đựng Cà Phê Có Van Hút Chân Không",269000,269000,0,0
TIKI,nha-cua-doi-song,126865171,"Vỏ gối ôm lụa cao cấp A 35 x 100 cm - mát mẻ, mềm mịn, không kích ứng da",78000,150000,72000,48
TIKI,nha-cua-doi-song,111631559,"Hộp đựng đồ kiêm ghế ngồi đa năng - Ghế sofa đựng đồ gấp gọn cứng cáp tiện lợi có chọn size, hàng chính hãng miDoctor",267000,500000,233000,47
TIKI,nha-cua-doi-song,196889763,"Bình tưới cây 5 lít Monrovia, phun hai chế độ, áp suất lớn tiêu chuẩn Châu Âu",399000,399000,0,0
TIKI,nha-cua-doi-song,52774383,"Đèn LED Đom Đóm Chipsbling Dùng Pin Năng Lượng Mặt Trời",99000,99000,0,0
TIKI,nha-cua-doi-song,186256010,"Vỏ gối nằm cotton tici Lidaco kích thước tiêu chuẩn (1 chiếc)",29000,45000,16000,36
TIKI,nha-cua-doi-song,51737688,"Túi Đựng Chăn Màn - Hộp Đựng Quần Áo Khung Sắt Gấp Gọn Amalife - Màu Ngẫu Nhiên",82000,82000,0,0
TIKI,nha-cua-doi-song,154835137,"Thìa, Muỗng Mạ Inox 304 Mạ Vàng Jodily Cao Cấp - Thìa Vàng Bắc Âu KT: 20.5x4 cm ",45000,45000,0,0
TIKI,nha-cua-doi-song,130369125,"Cây Treo Quần Áo, Túi Xách, Mũ Thông Minh Phong Cách VINTAG Gọn Gàng Tiết Kiệm Diện Tích Nhà Cửa- Hàng Chính Hãng MINIIN",219000,219000,0,0
TIKI,nha-cua-doi-song,184614872,"Chảo Đá Siêu Bền SUNHOUSE SBD20",191000,300000,109000,36
TIKI,nha-cua-doi-song,76403675,"(Chống Cắt) Ổ Khóa Ngăn Ngừa Trộm 60mm KhoNCC-Padlock Hàng Chính Hãng Cho Gia Đình - Kho Xưởng Cực Kỳ An Toàn - KPD-Padlock-6PCC (Bạc, Đồng)",189000,248000,59000,24
TIKI,nha-cua-doi-song,70825693,"Pin Cr2025 Energizer 3V vỉ 1 viên",30000,30000,0,0
TIKI,nha-cua-doi-song,77747671,"Miếng lau nhà thay thế Cây lau nhà KITIMOP-XPRO, WHITE ( 42 x 12cm)",15000,19000,4000,21
TIKI,nha-cua-doi-song,24888275,"Nhang Nụ Trầm Hương tự nhiên khói chảy ngược - Trầm Hương 12 năm - Thơm dịu nhẹ, không cay mắt, không kích mũi - Hộp 40 nụ - Thiên Mộc Hương",290000,350000,60000,17
TIKI,nha-cua-doi-song,41227454,"Combo 30 móc treo quần áo Prota",75000,75000,0,0
TIKI,nha-cua-doi-song,186351890,"Đệm ngồi chống trĩ, đau xương cụt Ema cho dân văn phòng, lái xe, phụ nữ sau sinh",305760,650000,344240,53
TIKI,nha-cua-doi-song,789439,"Găng Tay Chống Cắt Cấp Độ 5 3M (Size M) - Xám",125000,125000,0,0
TIKI,nha-cua-doi-song,171196878,"Bộ Nam Châm Vuông 90 Độ KUNBE Gắn Dán Cửa Tủ, Lực Hút Mạnh, Chắc Chắn",24000,24000,0,0
TIKI,nha-cua-doi-song,117717315,"Tủ điện nhựa ngoài trời - Hộp kỹ thuật LiOA JL-00C & JL-00C",124000,124000,0,0
TIKI,nha-cua-doi-song,108430436,"Nhiệt ẩm kế Tanaka Th337 - Đo nhiệt độ, độ ẩm trong nhà và ngoài trời",105000,165000,60000,36
TIKI,nha-cua-doi-song,103711453,"Máy Pha Trà Bear SUBE011",1390000,1390000,0,0
TIKI,nha-cua-doi-song,72804257,"Pin AA Energizer Ultimate Lithium L91 - Vỉ 2 viên",129000,129000,0,0
TIKI,nha-cua-doi-song,135391727,"Lô 4 cuộn túi rác tiện dụng Inochi Soji (10L-25L-50L)",59000,59000,0,0
TIKI,nha-cua-doi-song,144505446,"[Gói 4 miếng] Cước Rửa Chén Siêu Mạnh Scotch Brite - Cọ rửa mọi vết bẩn cứng đầu, an toàn cho vỉ nướng, nồi inox, gang, thép",39000,51000,12000,24
TIKI,nha-cua-doi-song,68447740,"Bộ cấp nước bồn cầu - Bộ cấp nước két nước vệ sinh sử dụng phao cơ thông minh",108000,155000,47000,30
TIKI,nha-cua-doi-song,75707305,"Bộ May Vá Quần Áo Đa Năng Cho Gia Đình KUNBE Kèm Hộp Đựng Kim Chỉ",49000,49000,0,0
TIKI,nha-cua-doi-song,112532029,"Khay đựng túi rác dành cho thùng rác thông minh TOWNEW T1, T1S, T Air X, T Air Lite_Hàng chính hãng",70000,70000,0,0
TIKI,nha-cua-doi-song,185409647,"Hũ Nhựa Pet Vuông Kín Hơi, Lọ, Hộp Nhựa Vuông Kín Hơi Đựng Sữa, Bột, Trà, Cà Phê, Thực Phẩm Đồ Khô Chống Ẩm, Côn Trùng",50000,50000,0,0
TIKI,nha-cua-doi-song,33337588,"Áo Bọc Nệm Hai Mặt Có Khóa Đủ Kích Thước 10cm - Màu Ngẫu Nhiên",95000,95000,0,0
TIKI,nha-cua-doi-song,58469517,"Dây đèn nháy Led đom đóm trang trí pin dây bóng đèn nháy cao cấp decor nhà cửa, lễ tết, lều trại du lịch, fairy light cao cấp (Tùy chọn màu và chiều dài dây)",113000,113000,0,0
TIKI,nha-cua-doi-song,130829751,"Combo 12 Hũ Thủy Tinh PEAFLO Làm Caramen, Sữa Chua, Đựng Gia Vị Đa Năng - Giao Ngẫu Nhiên",48000,49000,1000,2
TIKI,nha-cua-doi-song,2395003,"Khăn lau đa năng cao cấp 3M xanh dương 36cm",55000,55000,0,0
TIKI,nha-cua-doi-song,192523772,"Tấm Lót Tủ Lạnh, Tủ Bếp, Tủ Quần Áo Nhựa EVA Dễ Dàng Vệ Sinh (Đủ màu, đủ size)",46500,46500,0,0
TIKI,nha-cua-doi-song,115334461,"Combo 2 Lõi cây lăn bụi ,Lông Động Vật, Sợi Vải, Đồ Da, Chăn Nệm, Ghế Salon",28000,29000,1000,3
TIKI,nha-cua-doi-song,26062785,"Combo 50 Đinh 3 Chân Treo Ảnh Không Cần Khoan Milliken",21000,21000,0,0
TIKI,nha-cua-doi-song,984242,"Kèn Melodion - Melodica Suzuki MX-32D 32 Phím",600000,600000,0,0
TIKI,nha-cua-doi-song,172527718,"Set 50 Giấy Nến Lót Nồi Chiên Không Dầu Siêu Tiện Dụng (Tặng 1 Cọ Quét Silicone)",17999,17999,0,0
TIKI,nha-cua-doi-song,53954421,"Pin D Energizer Max E95 BP2",150000,150000,0,0
TIKI,nha-cua-doi-song,71063177,"Đèn Pin Mini Siêu Sáng D02 miDoctor Kiêm Sạc Dự Phòng - Chính Hãng",99000,99000,0,0
TIKI,nha-cua-doi-song,117207768,"Biến Áp Đổi Nguồn Hạ Áp LiOA - Biến Áp Đổi Nguồn LiOA 1000/1200/1500/2000VA( Điện Vào 220V- Điện Ra 100/120V) - MITA",535000,535000,0,0
TIKI,nha-cua-doi-song,253081471,"Miếng rửa chén đa năng sợi tre MyJae, miếng rửa chén chống xước 2 mặt, siêu bền đánh bay dầu bẩn",35000,69000,34000,49
TIKI,nha-cua-doi-song,162743067,"Bộ 1 Viên Pin Cell Panasonic NCR18650GA 3500 mAh , Pin 18650 dung lượng cao , Xả cao",150000,150000,0,0
TIKI,nha-cua-doi-song,74651405,"Chai rót dầu ăn, nước tương thủy tinh bọc Inox 304 cao cấp 300ml bằng thủy tinh chai hũ lọ gia vị dụng cụ nhà bếp tiện ích VANDO",38000,50000,12000,24
TIKI,nha-cua-doi-song,176728501,"Bàn trang điểm gương viền LED phong cách Nordic thương hiệu IGA- GP196",608000,660000,52000,8
TIKI,nha-cua-doi-song,130470014,"Vỏ trứng gà Sfarm đã qua xử lý",35000,35000,0,0
TIKI,nha-cua-doi-song,85029756,"Ổ cắm du lịch Điện Quang ĐQ ESK TV06B 2U (màu xanh dương - 2 cổng USB)",177557,221900,44343,20
TIKI,nha-cua-doi-song,164433381,"Bộ Đèn PHILIPS LED Âm Trần MESON IO Thế Hệ Mới - 5W 7W 9W 13W",100100,154000,53900,35
TIKI,nha-cua-doi-song,70191598,"Combo 8 Viên Pin AA đỏ Chính Hãng Maxell",24000,25000,1000,4
TIKI,nha-cua-doi-song,126730148,"Hộp cơm thủy tinh 2,3 ngăn, hộp thủy tinh đựng thức ăn NIKKO INOCHI chính hãng",81600,81600,0,0
TIKI,nha-cua-doi-song,14310197,"Thang nhôm rút chữ A SUMIKA SK500D NEW - Chữ A cao 2.5m, chữ I cao 5.0m, tải trọng 300kg",2242000,3100000,858000,28
TIKI,nha-cua-doi-song,136605740,"Áo Bọc Bàn Để Ủi Nguyễn Trường Thắng - Ironing Board Cover",70000,70000,0,0
TIKI,nha-cua-doi-song,71518871,"Nồi Decor Lock&Lock LDE1244IH Hai Tay Cầm (24cm) - Màu Mint",687000,1171000,484000,41
TIKI,nha-cua-doi-song,78964736,"Chốt Khóa Cài Cửa Có Lỗ Cài KUNBE, Chốt Cửa Khóa Gài Cây Gạt, An Toàn Cao Cấp Tiện Dụng",32000,32000,0,0
TIKI,nha-cua-doi-song,274121892,"Vỏ Áo gối nằm Thuần Việt - Lụa Tencel Thoáng Mát, Thấm Hút Mồ Hôi Tốt - Họa Tiết Hoa Văn - Đa Dạng Họa Tiết",220000,220000,0,0
TIKI,nha-cua-doi-song,165085520,"Bộ Thìa Đũa  Cá Nhân Văn Phòng  3 Món Lúa Mạch Chất Liệu Inox 304 Không Rỉ Kèm Hộp- Hàng Loại 1 - Chính Hãng MINIIN",43000,43000,0,0
TIKI,nha-cua-doi-song,59471210,"Bộ 3 Túi Đựng Chăn Màn Khung Sắt Gấp Gọn miDoctor (CÓ CHỌN MÀU)",239000,400000,161000,40
TIKI,nha-cua-doi-song,4166657,"Máy sạc Pin  ENERGIZER CHVC4 (kèm 4 viên pin sạc AA 1300 mAh)",330000,330000,0,0
TIKI,nha-cua-doi-song,186816987,"Dụng Cụ Mài Dao, Kéo 3 Rãnh Inox Jodily Đa Năng Dễ Sử Dụng",135000,135000,0,0
TIKI,nha-cua-doi-song,71744195,"Bộ Lau Nhà Xoay Tay Lock&Lock Dual Bucket Spin Mop  ETM478 ( thùng giặt , cây , 2 bông lau)",657000,1200000,543000,45
TIKI,nha-cua-doi-song,37875059,"Bình xịt tưới cây 2 lit DUDACO, Bình tưới phun sương, phun mưa, Phun thuốc muỗi mối",49000,49000,0,0
TIKI,nha-cua-doi-song,138173087,"Cuộn Decal Dán Bếp Chọn Chiều Dài Giấy Decal Dán Tường Tráng Nhôm Cách Nhiệt Cao Cấp Chính Hãng",29000,49000,20000,41
TIKI,nha-cua-doi-song,74383210,"Kệ úp ly chén HOBBY KUL41 Inox 304 kèm khay hứng nước không rỉ sét - ngang 41cm",383000,383000,0,0
TIKI,nha-cua-doi-song,529402,"Chất Bôi Trơn Chống Gỉ Sét Selleys RP7 150g",73000,79000,6000,8
TIKI,nha-cua-doi-song,6137123,"Phân Bón Npk 20-20-15 đa năng 3 màu  (1Kg)- bón cây, rau, cây ăn trái, hoa kiểng - bón gốc dễ sử dụng, kích thích ra lá, ra hoa, đậu trái",45000,45000,0,0
TIKI,nha-cua-doi-song,77662747,"Bình giữ nhiệt Nhật Bản inox Thermos nút bấm 500ml JNL 502 SBR (JNL - 500/2) - Hàng chính hãng",445000,950000,505000,53
TIKI,nha-cua-doi-song,174618568,"Thùng rác cảm ứng thông minh 18 lít ML B-JA-18",859000,859000,0,0
TIKI,nha-cua-doi-song,195852180,"Ly nhựa 2 lớp có ống hút LocknLock Bucket Cold Cup with Straw HAP520PIK 580ml",144000,241000,97000,40
TIKI,nha-cua-doi-song,74380878," CHỔI LÔNG QUÉT BỤI CÁN INOX RÚT GỌN TẶNG KÈM MÓC TREO 3D",73000,78000,5000,6
TIKI,nha-cua-doi-song,134360700,"Vỉ 10 Viên Pin LR44 , Pin A76 , Pin AG13 1,5V Energizer - Hàng Chính Hãng",80000,80000,0,0
TIKI,nha-cua-doi-song,167429965,"LY GIỮ NHIỆT ELEMENTAL ARTISAN MÀU TRƠN (360ML)",699000,699000,0,0
TIKI,nha-cua-doi-song,158973350,"Lư Đốt Trầm Hương, Lư Xông Trầm Bằng Gốm Sứ - Hàng Chính Hãng",46550,49000,2450,5
TIKI,nha-cua-doi-song,174812493,"3500W-Phích cắm ổ cắm chuyển 3 chấu sang 2 chấu,Công suất lớn Toshino EA-ES",150000,150000,0,0
TIKI,nha-cua-doi-song,106699435,"Bàn làm việc, bàn học ngồi bệt gaming - Chân gấp gọn - Lắp sẵn - Chính Hãng TIDO",449000,449000,0,0
TIKI,nha-cua-doi-song,68135337,"Kệ nhà tắm dán tường HT SYS-ECOCO-E1923-chất liệu ABS cao cấp kèm thanh treo khăn SUS 304",116000,122000,6000,5
TIKI,nha-cua-doi-song,21576181,"Công Tắc Thông Minh SONOFF Điều Khiển Qua Wifi, Mạng 3G, 4G",105000,105000,0,0
TIKI,nha-cua-doi-song,139979908,"Thác khói trầm hương - tặng nụ trầm Cao Cấp - Trầm hương khói ngược - Xông nhà, văn phòng, mùi dễ chịu, không kích mũi - Thiên Mộc Hương",59000,80000,21000,26
TIKI,nha-cua-doi-song,68460154,"ỐNG LÕI THÉP BỌC NHỰA PHI 11, COMBO 10 ỐNG",175000,175000,0,0
TIKI,nha-cua-doi-song,83480720,"Combo 2 Túi Bạt Đựng Quần Áo, Chăn Mền (Giao Ngẫu Nhiên) Chống Thấm Nước, Bộ 2 Giỏ Sọt Đựng Đồ Dơ Họa Tiết Vintage miDoctor",66000,120000,54000,45
TIKI,nha-cua-doi-song,55126177,"[Xuất Nhật] Kệ Để Đồ Đa Năng 3 Tầng Tokyo - Nhựa Cao Cấp Rất Chắc Chắn Dùng Để Đựng Đồ Nhà Bếp  Hoặc Làm Giá Để Đồ Nhà Tắm Phòng Ngủ",109000,109000,0,0
TIKI,nha-cua-doi-song,110024738,"PHÍCH CẮM CHUYỂN ĐỔI 3 CHẤU SANG 2 CHẤU VÀ CHIA 2 Ổ MPE  2000W - HÀNG CHÍNH HÃNG",22000,22000,0,0
TIKI,nha-cua-doi-song,186619847,"Chậu cây để bàn MONROVIA cho hoa, cây cảnh, ban công, bonsai",34000,34000,0,0
TIKI,nha-cua-doi-song,52731281,"Kéo Thép Đa Năng Nhật Bản, Size Lớn, Chất Liệu Thép Cao Cấp Không Gỉ",35000,35000,0,0
TIKI,nha-cua-doi-song,10000461,"Bình xịt chống chuột 3M",175000,199000,24000,12
TIKI,nha-cua-doi-song,70192533,"Bộ dụng cụ nhả kem đánh răng tự động 4 cốc và giá treo bàn chải đa năng HT SYS-COCO-E1922-chất liệu ABS cao cấp",295000,295000,0,0
TIKI,nha-cua-doi-song,116813584,"Set 4 Kệ Gỗ Treo Tường Thanh Ngang SIB Decor Trang Trí Phòng Khách Góc Làm Việc, Tặng Kèm Phụ Kiện Giấu Chân",338000,350000,12000,3
TIKI,nha-cua-doi-song,271224926,"Đàn Piano Kết Hơp Organ, Đàn Điện Tử Cho Bé, Đàn Đồ Chơi - Hàng chính hãng",166250,175000,8750,5
TIKI,nha-cua-doi-song,111410844,"Găng tay bảo hộ lao động Jogger Superpro - Bao tay lao động chống dầu nhớt, trơn trượt, độ linh hoạt cao - Chính hãng",15000,15000,0,0
TIKI,nha-cua-doi-song,108243370,"Đèn Pin Laze miDoctor Cao Cấp SD Lazer 303 Full Hộp - Chính Hãng",115000,115000,0,0
TIKI,nha-cua-doi-song,98678358,"MC2 - 25x9x9 cm - 20 Thùng hộp carton",37800,37800,0,0
TIKI,nha-cua-doi-song,186501762,"Kệ Nhà Tăm Dán Tường INOX 304 Treo Dầu Gội Mỹ Phẩm Sữa Tắm Thiết Kế 6 Móc Treo Đồ Thông Minh - KT40CM",95000,180000,85000,47
TIKI,nha-cua-doi-song,50393230,"Nhang Sạch Phòng Máy Lạnh - Ít khói - Hương trầm dịu nhẹ - Chân tăm mộc - Nhang Xanh",27000,27000,0,0
TIKI,nha-cua-doi-song,154566300,"Hộp đựng trứng 24 quả - Khay nhựa đựng trứng gà, vịt để tủ lạnh có nắp đậy tiện dụng  - Hàng loại 1 chính hãng",47000,47000,0,0
TIKI,nha-cua-doi-song,123455475,"Combo 10 Khăn Lau Đa Năng Cỡ Lớn Siêu Mịn Bám Bụi Thấm Nước Jodily. KT:26x26cm",65000,65000,0,0
TIKI,nha-cua-doi-song,579790,"Chảo Đá Chống Dính Siêu Bền Sunhouse SBD30 30cm",280000,480000,200000,42
TIKI,nha-cua-doi-song,69228398,"Ổ khóa Toplex hợp kim thép, lõi đồng, càng dài",90000,90000,0,0
TIKI,nha-cua-doi-song,141472707,"Keo dán chuột keo dính chuột keo bẫy chuột (Dài 1.2M)",84000,84000,0,0
TIKI,nha-cua-doi-song,41332433,"Tinh dầu xua đuổi chuột",75000,75000,0,0
TIKI,nha-cua-doi-song,58021652,"Băng keo chống thấm dột mái tôn đa năng siêu dính khổ 10cm dài 5 mét",43000,43000,0,0
TIKI,nha-cua-doi-song,147763329,"Bộ 8 Túi Hút Chân Không Đựng Quần Áo, Chăn Màn Kèm Bơm Cao Cấp - Chính Hãng dododios",197000,197000,0,0
TIKI,nha-cua-doi-song,21391325,"Combo 2 Ống Hút Thủy Tinh Trong Suốt Dài 20cm Kèm Cọ Rửa và Túi Vải Bố Màu Tùy Chọn",49000,49000,0,0
TIKI,nha-cua-doi-song,195462469,"Miếng Lót Ly, Đế Lót Đá Xốp Diatomite Siêu Thấm Hút",52250,55000,2750,5
TIKI,nha-cua-doi-song,22605669,"Bàn Làm Việc Lắp Ghép Tiện Lợi",546000,546000,0,0
TIKI,nha-cua-doi-song,217145037,"Giỏ Nhựa Đựng Đồ Đa Năng Có Nắp Đậy Cao Cấp Deli - Đựng Sách Vở Đồ Cá Nhân Mỹ Phẩm Quần Áo Chăn Gối Ga Mền - Nhiều Size, Kích Cỡ Lớn Nhỏ , Có Tay Cầm, Phong Cách Nhật Bản Đơn Giản, Tiện Dụng, Vật Liệu An Toàn",66000,118800,52800,44
TIKI,nha-cua-doi-song,129379800,"Giường Ngủ Gấp Gọn Văn Phòng Và Gia Đình Thông Minh Đa Năng 1 Tầng, Giường Xếp Có Thể Làm Giường Trong Bệnh Viện Dành Cho Bệnh Nhân - Hàng Chính Hãng",1984000,2145000,161000,8
TIKI,nha-cua-doi-song,88785294,"Đèn bàn Bảo vệ Thị lực       Model: RD-RL-24.V2 5W",200640,250800,50160,20
TIKI,nha-cua-doi-song,10604175,"Ổ cắm Điện Quang ĐQ ESK 2W.SM750SL (5 lỗ 3 chấu dây 2 mét màu Trắng Đỏ)",189000,238700,49700,21
TIKI,nha-cua-doi-song,69500507,"Áo mưa cánh bướm trẻ em Rando Pocho dành cho các bé có độ tuổi từ (2 tuổi đến 12 tuổi) tương đương với các size từ số 1 đến số 5",54000,54000,0,0
TIKI,nha-cua-doi-song,151483218,"Sáo recorder 8 lỗ cao cấp",89000,89000,0,0
TIKI,nha-cua-doi-song,87628025,"Dây Đèn LED Bóng Tròn Năng Lượng Mặt Trời Chống Nước Trang Trí Sân Vườn",247000,260000,13000,5
TIKI,nha-cua-doi-song,2909831,"Máy khoan động lực Bosch GSB 550 550W - Tặng bộ phụ kiện FREEDOM 90 chi tiết",1378000,1617000,239000,15
TIKI,nha-cua-doi-song,57763337,"BÌNH ĐỰNG NƯỚC VỎ LÚA MẠNH AN TOÀN, CAO CẤP IN HÌNH XƯƠNG RỒNG, TOTORO (Giao Hàng Theo Mẫu Ngẫu Nhiên)",10000,15000,5000,33
TIKI,nha-cua-doi-song,125673210," Thớt Inox 2 Mặt Cao Cấp - 01 Mặt Inox 304 01 Mặt Nhựa PP Sử Dụng Đa Năng Cho Nhà Bếp",305000,305000,0,0
TIKI,nha-cua-doi-song,35958689,"Thang nhôm rút đôi chữ a Nhật Bản HAKAWA HK256 (5,6M) - Phân phối chính hãng - Nhỏ gọn tiện lợi ",3900000,4350000,450000,10
TIKI,nha-cua-doi-song,135442312,"Keo Siêu Dính Đa Năng Deli - 7ml/ 20ml - Có Thể Dán Trên Mọi Bề Mặt - Phù Hợp Sửa Chữa, Ghép Nối - 7140 / 7149",8000,16200,8200,51
TIKI,nha-cua-doi-song,148801631,"Cân Tiểu Ly Điện Tử Nhà Bếp Định Lượng 3000g - 0.1g  Cân Làm Bánh Có Độ Chính Xác Cao - Hàng Chính Hãng MINIIN",199000,199000,0,0
TIKI,nha-cua-doi-song,66647096,"Nệm đa năng Everon New ( màu ngẫu nhiên )",1342500,1790000,447500,25
TIKI,nha-cua-doi-song,49127906,"Bao Da Đựng Đàn Guitar 3 Lớp Yamaha Bag YAB (Túi đựng Acoustic và Classic Ghi-ta, Có 2 quai đeo, Ngăn đựng đồ ) - Bao Acoustic Guitar",149000,149000,0,0
TIKI,nha-cua-doi-song,75131601,"(Loại Tốt) Áo Mưa Cánh Dơi (xẻ tà) KhoNCC - Vải Dù Cao Cấp Loại Lớn 1m4 - Che Kín 2 Người Mùa Mưa - NQL-AoMuaDu (Xanh lá, Xanh Đen, Xanh Dương, Đỏ Đô, Cỏ Úa) - Hàng Chính Hãng",109000,158000,49000,31
TIKI,nha-cua-doi-song,21373904,"Ống Hút Thủy Tinh Lẻ Thẳng/Cong - Nhiều Màu - 20cm x 0.8cm",17100,18000,900,5
TIKI,nha-cua-doi-song,68661084,"Đèn led treo tường Baseus Magnetic Stepless Dimming Charging Desk Lamp Pro - Hàng chính hãng",279000,279000,0,0
TIKI,nha-cua-doi-song,171590605,"Tủ nhựa TABI-L cao cấp size lớn mặt ốp mica chính hãng Nhựa Duy Tân",1359000,1600000,241000,15
TIKI,nha-cua-doi-song,169514577,"Dụng Cụ Xay Tiêu Thuỷ Tinh Benchusch",110000,190000,80000,42
TIKI,nha-cua-doi-song,696894,"Bộ Dây Đàn Guitar Acoustic Alice AW436",74000,74000,0,0
TIKI,nha-cua-doi-song,100623179,"Combo 2 Kệ Góc Để Đồ Nhà Tắm INOX SUS304 Dán Tường Gạch Men kèm bộ đinh vít khoan tường - OENON",242000,242000,0,0
TIKI,nha-cua-doi-song,20203015,"Ống Hút Inox 304 (Ống Hút Thép Không Rỉ) - Nhiều Màu Tùy Chọn",8000,8000,0,0
TIKI,nha-cua-doi-song,137753122,"Công tắc thông minh ĐIỀU KHIỂN TỪ XA qua wifi HUNONIC DATIC 1 Kênh 500W - Cơ Điện Shop",99000,99000,0,0
TIKI,nha-cua-doi-song,96995267,"Bình đựng thức ăn giữ nhiệt nóng-lạnh chính hãng Rạng Đông RD 0850 N1.T",161000,161000,0,0
TIKI,nha-cua-doi-song,130412896,"Bộ 10 Túi Chân Không Đựng Chăn Màn, Quần Áo - Gọn Gàng, Tiện Lợi + Tặng Bơm Hút Chân Không- Hàng Chính Hãng MINIIN",189999,189999,0,0
TIKI,nha-cua-doi-song,135442380,"Bộ Tua Vít Đa Năng 6 Chiếc Deli Cao Cấp Chính Hãng - Nhỏ Gọn, Tiện Ích, Dễ Dàng Sử Dụng - Thiết Thể Đẹp Mắt - EDL3206",25000,52200,27200,52
TIKI,nha-cua-doi-song,101360455,"Giá Để Sạc Điện Thoại, Remote Dán Tường Đa Năng",19000,20000,1000,5
TIKI,nha-cua-doi-song,120047160,"Vỏ gối ôm K-Bedding MicroTencel Họa Tiết 80*100cm",148000,190000,42000,22
TIKI,nha-cua-doi-song,52126872,"Kệ Treo Tường 3 Thanh Ngang SIB DECOR Dài 40cm x Sâu 15cm (Màu trắng, đen, vân gỗ sồi)",275000,280000,5000,2
TIKI,nha-cua-doi-song,192688324,"Dụng Cụ Xay Tiêu 2 trong 1 Benchusch",180000,245000,65000,27
TIKI,nha-cua-doi-song,81577986,"Hộp Nhựa, Hũ Nhựa Pet Nắp Nhôm Đựng Thực Phẩm, Đồ Khô, Ngũ Côc JIMMEAL 200ml 250ml 500ml 600ml 700ml 800ml 1000ml 1200ml 1500ml",6500,6500,0,0
TIKI,nha-cua-doi-song,69237854,"Ổ khóa cao cấp Toplex, chống cắt vuông, 1203-40mm",90000,90000,0,0
TIKI,nha-cua-doi-song,181361773,"Bàn học gấp gọn, bàn laptop đa năng tùy chỉnh được góc nghiêng giảm đau lưng mỏi mắt - GM55",182000,199000,17000,9
TIKI,nha-cua-doi-song,174032615,"Ô Dù Cán Thẳng 2 Tầng - Ô Golf 2 tầng chống tia UV đường kính 145cm - Nhiều Màu",259000,500000,241000,48
TIKI,nha-cua-doi-song,13158001,"Combo 50 đinh 3 chân treo khung ảnh không cần khoan tường",33155,34900,1745,5
TIKI,nha-cua-doi-song,169198042,"Bóng Đèn Wifi Thông Minh TP-Link Tapo L520E Ánh Sáng Trắng Điều Chỉnh Độ Sáng - Hàng Chính Hãng",149000,278000,129000,46
TIKI,nha-cua-doi-song,96403049,"Sọt rác, thùng rác thông minh có khay đựng túi rác, giúp dễ dàng thay túi rác nhanh chóng và sạch sẽ - Hàng chính hãng",81880,89000,7120,8
TIKI,nha-cua-doi-song,85186733,"Giá thể mụn dừa đã qua xử lý Sfarm",18000,18000,0,0
TIKI,nha-cua-doi-song,157027637,"Kệ đựng gia vị 2 tầng Inox 304 HOBBY Home Decor GV2T không rỉ sét và có chân chống trượt",575000,575000,0,0
TIKI,nha-cua-doi-song,21929492,"Gối Ngủ Du Lịch Văn Phòng Cao Cấp Amalife",339000,339000,0,0
TIKI,nha-cua-doi-song,176909993,"Bình xịt chống gỉ sét và bôi trơn Selleys RP7 350g",82000,85000,3000,4
TIKI,nha-cua-doi-song,111821413,"Dù Che Mưa Che Nắng Ngăn Tia UV",40999,40999,0,0
TIKI,nha-cua-doi-song,183503039,"Kệ Gỗ Để Màn Hình Bàn Làm Việc 2 Tầng SIB Decor",330000,349000,19000,5
TIKI,nha-cua-doi-song,137672212,"Bộ 8 Miếng dán treo tranh Command 3M tải trọng 7.2kg độ bền cao, bám cực chắc, tháo cực dễ",92000,121000,29000,24
TIKI,nha-cua-doi-song,139528426,"Dụng Cụ Bào Củ Quả Đa Năng Có Tay Cầm Kèm Khay Đựng - PaKaSa ( Giao màu ngẫu nhiên )",92820,150000,57180,38
TIKI,nha-cua-doi-song,71924152,"Mùng chụp, màn chụp tự bung chống muỗi FUNU - Hàng chính hãng, sản xuất tại Việt Nam",129675,136500,6825,5
TIKI,nha-cua-doi-song,41369724,"Pin Maxell CR2025 3V",55000,70000,15000,21
TIKI,nha-cua-doi-song,137672504,"Móc dán tường Jumbo Command 3M chịu lực 3.4kg - Dễ sử dụng, độ bền cao, bám cực chắc, tháo cực dễ 17004ES",53000,68000,15000,22
TIKI,nha-cua-doi-song,62231649,"Combo 3 cặp thanh chắn khe cửa (ron chắn khe cửa) chống thoát hơi máy lạnh, máy điều hòa",55000,69000,14000,20
TIKI,nha-cua-doi-song,107453161,"Bộ Đèn led dây dán RGB đổi màu điểu khiển 44 phím chọn màu đứng yên, nhấp nháy, bóng 5050 strip light trang trí  Tiktok dán tường, bàn máy tính, cửa hàng, quán cafe, chống nước bền đẹp (Tùy chọn chiều dài dây)",298000,298000,0,0
TIKI,nha-cua-doi-song,20036138,"5 Viên Pin CR2025 3V Panasonic Lithium made in Indonesia - Hàng chính hãng",80000,90000,10000,11
TIKI,nha-cua-doi-song,54097692,"Pin Energizer 12V A23 BP1",40000,40000,0,0
TIKI,nha-cua-doi-song,187058636,"Khăn giấy nén hình viên kẹo dùng một lần tiện dụng khi đi du lịch, Khăn lau mặt Hàn Quốc nhỏ gọn đa năng - Chính hãng MINIIN",2000,2000,0,0
TIKI,nha-cua-doi-song,2432307,"Decal dán tường đoàn tàu sở thú ZOOYOO AM7123",39900,70000,30100,43
TIKI,nha-cua-doi-song,68607055,"Muỗng xào DandiHome Inox 304 kết hợp bề mặt muỗng silicon cao cấp - chịu được nhiệt độ cao, an toàn với chảo chống dính",106000,110000,4000,4
TIKI,nha-cua-doi-song,145297805,"(Hộp Đựng Giày) Combo 2 Hộp Đựng Giày THAFA Có Nắp Đậy Trong Suốt chọn màu",95000,95000,0,0
TIKI,nha-cua-doi-song,69193092,"Bộ đầu nối vòi rửa chén tăng áp 3 chế độ Hobby Home Decor VSTADAY có khớp nối",82000,86000,4000,5
TIKI,nha-cua-doi-song,145495739,"Nụ Trầm Dương Minh 100% thành phần tự nhiên nụ trầm, nụ quế, nụ bồ kết - nụ khói tỏa ngược hương nhang sạch an toàn cho sức khỏe",90000,150000,60000,40
TIKI,nha-cua-doi-song,147265095,"Vỉ 2 Viên Pin Đại ( Pin D ) 1,5V DURACELL Siêu Bền - Hàng chính hãng",110000,110000,0,0
TIKI,nha-cua-doi-song,69253904,"Đèn Led 28 Bóng Cổng Usb Thân Kim Loại Có Thể Uốn Cong - Hàng Chính Hãng (Giao Màu Ngẫu Nhiên)",38000,40000,2000,5
TIKI,nha-cua-doi-song,242707636,"Ca lọc cặn dầu bằng thép không gỉ - Chính hãng (Giao ngẫu nhiên)",70000,70000,0,0
TIKI,nha-cua-doi-song,16195896,"Combo 03 lõi lọc số 1 (lõi PP) 20 inch Yamato",100000,155000,55000,35
TIKI,nha-cua-doi-song,10791010,"Ổ cắm kéo dài đa năng LiOA 3 ổ cắm (3D32N 3D52N)",90000,90000,0,0
TIKI,nha-cua-doi-song,179689675,"Nến thơm Candle Cup/Agaya - Hương khơi gợi đặc điểm địa danh TWILIGHT",220000,220000,0,0
TIKI,nha-cua-doi-song,83196608,"Ly Giữ Nhiệt Lock&Lock Clip Tumbler LHC4151 (540ml) - Hàng Chính Hãng, Bằng Thép Không Gỉ Inox 304, Kèm Ống Hút Nhựa Dùng Được Nhiều Lần, Nắp Vặn Chặt - Tặng Cọ Rửa Ống Hút",289300,526000,236700,45
TIKI,nha-cua-doi-song,107336808,"Bộ chăn chần ga giường cotton Tici kẻ LIDACO cao cấp (Nhiều mẫu lựa chọn)",449000,690000,241000,35
TIKI,nha-cua-doi-song,79366461,"Tủ Kệ Nhà Tắm IGA Treo Tường Sắp Xếp Phòng Tắm Gọn Gàng",352000,383000,31000,8
TIKI,nha-cua-doi-song,155487222,"Kệ Chén Đĩa Kéo Giãn Thông Minh VANDO Giá Úp Bát Thay Đổi Kích Thước Trên Bồn Rửa 1 Tầng Chống Han Gỉ Cao Cấp",699000,1207000,508000,42
TIKI,nha-cua-doi-song,50326149,"Bình giữ nhiệt Elmich inox 304 EL3665 (700ml)",377000,599000,222000,37
TIKI,nha-cua-doi-song,2739235,"Thang nhôm rút chữ A Sumika SK440D NEW - Chữ A cao 2.2m, chữ I cao 4.4m, tải trọng 300kg",1947500,2800000,852500,30
TIKI,nha-cua-doi-song,55052995,"Máy vặn vít dùng pin Bosch go gen 2 Mới",1021000,1197000,176000,15
TIKI,nha-cua-doi-song,115992688,"Nệm cao su 100% thiên nhiên cao cấp Gummi Standard 10cm tại Vua Nệm - Nâng đỡ vượt trội, thoáng kí tối ưu",6112000,8679000,2567000,30
TIKI,nha-cua-doi-song,173854188,"Ổ cắm xoay gấp gọn Điện Quang ĐQ ESK RT",25900,35129,9229,26
TIKI,nha-cua-doi-song,77200011,"Set Nồi đá Ecoramic cao cấp phủ 5 lớp chống dính ceramic siêu bền gồm 4 nồi",2005500,2865000,859500,30
TIKI,nha-cua-doi-song,153273930,"Hộp cơm giữ nhiệt LEBENLANG LBT856 bằng inox 304 với 4 khay riêng biệt, dung tích 2.2L - hàng chính hãng",679000,879000,200000,23
TIKI,nha-cua-doi-song,95014508,"Công tắc điều khiển từ xa bằng điện thoại Hunonic Lahu 4 kênh 500W/kênh + Hẹn giờ thông minh | Công nghệ 4.0",398000,398000,0,0
TIKI,nha-cua-doi-song,166033411,"Ly thuỷ tinh đổi màu Luminarc Lille Scale Unicorn 425ml - LUSCQ3810",120000,155000,35000,23
TIKI,nha-cua-doi-song,59437399,"Nệm bông chần gòn Everon Lite EV09 ( màu ngẫu nhiên )",2540000,2540000,0,0
TIKI,nha-cua-doi-song,263488917,"Kệ sách gỗ mini để bàn ( Màu Ngẫu Nhiên )",62000,62000,0,0
TIKI,nha-cua-doi-song,4581757,"Phích Nước Nóng Rạng Đông Inox RD 2545 ST1.E (2.5L)",480000,480000,0,0
TIKI,nha-cua-doi-song,142331006,"Chuôi đèn liền công tắc Điện Quang ĐQ LH E27",46000,62736,16736,27
TIKI,nha-cua-doi-song,58481259,"Kệ nâng màn hình máy tính 1 tầng lắp ghép MS 07",35000,65000,30000,46
TIKI,nha-cua-doi-song,6775905,"Thùng nhựa đựng đồ Đa Năng Bestlock",179000,179000,0,0
TIKI,nha-cua-doi-song,138359526,"Máy Xay Tiêu Tự Động Bằng Điện Benchusch Màu Trắng/ Đen/ Xanh/ Đỏ",449000,599000,150000,25
TIKI,nha-cua-doi-song,195797725,"Thớt tre tự nhiên Sunhouse KS-CH3522B",95000,153000,58000,38
TIKI,nha-cua-doi-song,121162096,"Hộp 5 Đôi Đũa Inox Mạ Vàng Jodily Cao Cấp - Không Trơn Trượt, Bền Mãi Với Thời Gian",205000,205000,0,0
TIKI,nha-cua-doi-song,118847639,"MÓC DÁN TƯỜNG TREO CỔ TRAI INOX 304 JODILY TIỆN LỢI - SỬ DỤNG KEO SIÊU DÍNH ",50000,50000,0,0
TIKI,nha-cua-doi-song,88784706,"Đèn bàn Bảo vệ Thị lực Model: RD-RL-27.V2 5W",200640,250800,50160,20
TIKI,nha-cua-doi-song,980486,"Cân Đồng Hồ Lò Xo Nhơn Hòa NHS-30 (30kg) - Hàng Chính Hãng",675000,710000,35000,5
TIKI,nha-cua-doi-song,116828169,"Tấm bảo vệ nệm Doona Bamboo ứng dụng công nghệ vải lạnh giúp làm mát và chống thấm hiệu quả",798000,808000,10000,1
TIKI,nha-cua-doi-song,117207732,"Biến Áp Đổi Nguồn Hạ Áp LiOA - Biến Áp Đổi Nguồn LiOA 200/400/600VA ( Điện Vào 220V- Điện Ra 100/120V)",316000,316000,0,0
TIKI,nha-cua-doi-song,160577685,"Dung dịch hỗ trợ hàn thiếc với kim loại Sắt, thép, inox,... thích hợp hàn cell pin",54900,54900,0,0
TIKI,nha-cua-doi-song,195791850,"Chảo chống dính Ultra titanium Sunhouse ST20B - Dùng cho mọi loại bếp - Hàng chính hãng",379000,650000,271000,42
TIKI,nha-cua-doi-song,466646,"Cáp Nối Dài Điện Quang ĐQ EPF 5R.2PN (Màu Đỏ)",68000,87700,19700,22
TIKI,nha-cua-doi-song,85029571,"Set 5 Phích cắm công suất lớn Điện Quang ECO ĐQ EPR HP 2PN ECO (Màu ngẫu nhiên)",46008,60400,14392,24
TIKI,nha-cua-doi-song,485396,"Giá Lấy Ly/Cốc Giấy Tự Động Kova Hàn Quốc GDL",279000,380000,101000,27
TIKI,nha-cua-doi-song,101894776,"Bóng bulb trụ PHILIPS Tforce Core G3 (Thế hệ mới)- Hi Lumen (22W,30W,40W,50W)",73900,185400,111500,60
TIKI,nha-cua-doi-song,132276904,"Bình Ủ Trà  Giữ Nhiệt Inox 304 Có Vòi Bấm Nước- Dung Tích 8-12 L - Hàng Loại 1- Chính Hãng MINIIN",363000,363000,0,0
TIKI,nha-cua-doi-song,147020767,"Hộp cơm văn phòng giữ nhiệt 3 tầng Inox 304 cao cấp , giữ nhiệt lâu 6 - 8 tiếng - Hàng chính hãng",449000,459000,10000,2
TIKI,nha-cua-doi-song,95160676,"Nệm Lò Xo Cao Su Liên Kết Zinus 18cm Bonnel Mattress",2299000,2619000,320000,12
TIKI,nha-cua-doi-song,122413518,"Bình giữ nhiệt LOCK&LOCK 1.000mL Easy Take - LHC1439",289000,400000,111000,28
TIKI,nha-cua-doi-song,75027386,"Chậu Tắm Gấp Gọn Cho Người Lớn Trẻ Em Dài 1,4m - Thau Tắm Silicon Cao Cấp - Bồn Xông Hơi Gia Đình",1389000,2300000,911000,40
TIKI,nha-cua-doi-song,104681190,"Màng bọc thực phẩm PE MyJae Đài Loan 30cmx50m dạng xé chấm đứt bảo quản thực phẩm an toàn tiện lợi",55000,99000,44000,44
TIKI,nha-cua-doi-song,89308771,"Thước Dây Deli Có Thể Làm Móc Chìa Khóa- Dài 1.5M - Thước Dây Cuộn - Màu Trơn Xanh Lá / Xanh Dương / Hồng / Trắng  - 1 Chiếc",18000,32400,14400,44
TIKI,nha-cua-doi-song,17461856,"Giá treo đồ gập gọn di động sau cửa Wellex MH1060",280000,350000,70000,20
TIKI,nha-cua-doi-song,137907052,"Đèn bàn học sinh chống cận LED Rạng Đông 5W màu xanh /hồng RD-RL-24",165000,165000,0,0
TIKI,nha-cua-doi-song,87651538,"BỘ ÁO ĐI MƯA TRONG MÀU PHẢN QUANG, AN TOÀN, RANDO",234000,234000,0,0
TIKI,nha-cua-doi-song,139106099,"Túi Đựng Ly Giữ Nhiệt Grepaco Dạng Quai Xách Và Dây Rút Đựng Bình Nước Thể Tích 500ml, 750ml, 800ml, 900ml, 1500ml – Vải Bố Canvas Dù Chống Thấm Nước Phong Cách Thời Trang Bảo Vệ Môi Trường Phong Cách Nhật Bản",49000,49000,0,0
TIKI,nha-cua-doi-song,174012858,"Sáo dọc Recorder Soprano YAMAHA YRS-24B kèm túi đựng - Nốt thổi Baroque, tiêu chuẩn giáo dục quốc tế",147273,147273,0,0
TIKI,nha-cua-doi-song,176598081,"Bình giữ nhiệt LocknLock Metro Two Way LHC4274NVY 475ml",332700,605000,272300,45
TIKI,nha-cua-doi-song,185922606,"Cốc Thủy Tinh Hai Lớp Cách Nhiệt Ly Đựng Cà Phê Trà Trang Nhã",86110,86110,0,0
TIKI,nha-cua-doi-song,70090449,"Bộ dụng cụ nhả kem đánh răng tự động độc lập và giá treo bàn chải đa năng 02 cốc HT SYS-ECOCO-E1924 - chất liệu ABS cao cấp",188000,325000,137000,42
TIKI,nha-cua-doi-song,190707199,"Đệm ngồi 3D silicon thoáng khí, đàn hồi tốt, Nệm lót ghế chất liệu mềm mại chống đau mỏi - Chính hãng MINIIN (Giao mẫu ngẫu nhiên)",89000,89000,0,0
TIKI,nha-cua-doi-song,171922257,"Áo Mưa Bộ RANDO Chính Hãng, Nhựa Trong Thời Trang, Siêu Nhẹ, Không Thấm Nước, Dành Cho Đi Phượt, Đi Xe Đạp",219000,219000,0,0
TIKI,nha-cua-doi-song,57243045,"Cuộn 10 Mét Ron Dán Khung Cửa Giảm Tiếng Ồn Va Đập, Ngăn Bụi, Ngăn Côn Trùng Size  4 mm 6 mm 8 mm 10 mm - Hàng Chính Hãng",70000,102000,32000,31
TIKI,nha-cua-doi-song,75373271,"Túi Bạt Đựng Quần Áo, Chăn Mền, Túi Chăn 100L Chống Thấm Nước - Sọt Đựng Đồ Gấp Gọn Cỡ Đại 50x40x50cm - Hàng Chính Hãng",60000,100000,40000,40
TIKI,nha-cua-doi-song,105880677,"Bóng Đèn Compact V-Light PL 13W",48000,48000,0,0
TIKI,nha-cua-doi-song,59452008,"Ổ cắm điện đa năng Sopoka",36000,36000,0,0
TIKI,nha-cua-doi-song,41578500,"Bộ bù lông ốc vít các loại 900g Milliken",250000,250000,0,0
TIKI,nha-cua-doi-song,111410133,"Kính bảo hộ Kings KY314B Mắt kính chống bụi, chống tia UV, chống trầy xước, đọng sương, dùng trong lao động, đi xe máy",115000,115000,0,0
TIKI,nha-cua-doi-song,168960299,"Băng Keo Siêu Dính Đa Năng, Băng Dính Chống Thấm, Chống Dột Dán Được Trên Mọi Bề Mặt Chọn Size WaterProof Tape Chính Hãng Amalife – Băng Dính Chống Thấm Nhật Bản",40000,40000,0,0
TIKI,nha-cua-doi-song,106676756,"Thùng rác đạp chữ nhật Inochi 30L",349000,349000,0,0
TIKI,nha-cua-doi-song,4546885,"Bộ 12 Ly Thủy Tinh Bầu Lùn Góc Uống Trà Đá Camdaco (225ml)",81000,81000,0,0
TIKI,nha-cua-doi-song,6555639,"Đèn bàn LED cảm ứng Rạng Đông, Model  RD-RL-21.LED",375000,375000,0,0
TIKI,nha-cua-doi-song,83397883,"MHL7 - 45x45x45 cm - 10 Thùng hộp carton",206000,206000,0,0
TIKI,nha-cua-doi-song,19911204,"Hộp Nhựa Chia Thuốc 7 Ngày KOMONOYA -  Hàng Nội Địa Nhật Bản ",35340,35340,0,0
TIKI,nha-cua-doi-song,85378825,"Chuông Báo Khách Cửa Hàng, Báo Động Chống Trộm Cảm Biến Hồng Ngoại CTFAST 01 - Chuông Cửa Báo Khách Ghé Thăm, Dọa Trộm Xâm Nhập, Ánh Sáng Đèn Ngủ",340000,379000,39000,10
TIKI,nha-cua-doi-song,268505461,"Dù Golf cao cấp khung chịu lực kép Nason 27 inch, khắc tên logo lên cán gỗ, chống lật trong gió to, che 2 3 người, nan sợi thủy tinh, lịch lãm, hợp thời trang",349000,349000,0,0
TIKI,nha-cua-doi-song,253047582,"Thanh Xốp Chắn Khe Cửa Tiện Lợi Và Chống Côn Trùng Chắn Gió Điều Hòa",14500,14500,0,0
TIKI,nha-cua-doi-song,480128,"Bình Nước Thể Thao PC Lock&Lock HPP722 - 700Ml",97000,168000,71000,42
TIKI,nha-cua-doi-song,71105367,"Cuộn Giấy Decal Dài Khoảng Từ 3 Mét, Giấy Decal Dán Bếp, Giấy Dán Tường Tráng Nhôm Cách Nhiệt Cao Cấp Chính Hãng Amalife",41000,41000,0,0
TIKI,nha-cua-doi-song,558335,"Ổ Cắm Điện Có Nắp Che 5 Lỗ 2 Chân Mpower MP-153 - 3 Mét",99000,125000,26000,21
TIKI,nha-cua-doi-song,187764887,"Tấm Chắn Gió Bếp Chống Văng Dầu Mỡ KUNBE Chất Liệu Inox 304 Chắc Chắn Bền Đẹp, Chắn Gió Hiệu Quả",249000,249000,0,0
TIKI,nha-cua-doi-song,4464525,"Bộ lọc nước thô đầu nguồn 2 cấp lọc 10inch Yamato YMTH10-2TX",276000,285000,9000,3
TIKI,nha-cua-doi-song,102464159,"Sơn xịt ATM Spray đa năng xịt trên mọi chất liệu cao cấp",36000,36000,0,0
TIKI,nha-cua-doi-song,106707718,"Cục chống va đập cửa vào tường dán gạch men Hobby Home Decor CC3 có đệm cao su kèm keo dán và đinh ốc",39000,39000,0,0
TIKI,nha-cua-doi-song,24184873,"Ấm đun nước bằng inox 304 Smartcook 2.5L SM 3372",299000,299000,0,0
TIKI,nha-cua-doi-song,2239281,"Decal dán tường thế giới cá ngộ nghĩnh cho bé ZOOYOO XL7225",39900,60000,20100,34
TIKI,nha-cua-doi-song,11290201,"Ổ Cắm Công Suất Lớn Điện Quang ĐQ ESKHP 3RB (3 Lỗ, Màu Đỏ Đen, Không Dây)",81834,102300,20466,20
TIKI,nha-cua-doi-song,273546668,"Nhang cây trầm hương đốt xông nhà tẩy uế HÀ XÁ đồ thờ cúng phong thủy, xua đuổi vận xui, thu hút nguồn năng lượng tích cực, thanh lọc không khí, an toàn cho sức khỏe",198000,198000,0,0
TIKI,nha-cua-doi-song,905112,"Bình Lưỡng Tính Zojirushi SF- CC20- XA (2L)",1129000,1129000,0,0
TIKI,nha-cua-doi-song,75179250,"Kiềng Chắn Gió Bếp Gas, Tấm, Vỉ Che Bếp Chống Tỏa Nhiệt, Tiết Kiệm Gas KUNBE Mẫu Mới - Tặng Khăn Lau Bếp Đa Năng",38000,38000,0,0
TIKI,nha-cua-doi-song,11088145,"Ổ cắm Công suất lớn Điện Quang ĐQ ESKHP 3RB 2M (3 lỗ, màu đỏ đen, dây dài 2m)",120000,164200,44200,27
TIKI,nha-cua-doi-song,1937707,"Decal Dán Tường Bé Đi Sở Thú",39000,77000,38000,49
TIKI,nha-cua-doi-song,45838799,"Túi lưới giặt đồ lót siêu tiện lợi",32000,32000,0,0
TIKI,nha-cua-doi-song,161236346,"Bộ 2 chiếc hộp vải đựng đồ Thụy Điển 24L, Combo 2 chiếc túi vải đa năng TD1 có chọn màu miDoctor",145000,250000,105000,42
TIKI,nha-cua-doi-song,53993306,"Thước kẹp điện tử với phạm vi đo 0-150mm hiển thị màn hình kỹ thuật số",58999,58999,0,0
TIKI,nha-cua-doi-song,181503592,"Ghế Đôn Hộp Vải Đa Năng VINAVU Chất Liệu Vải Oxford Cao Cấp",147000,147000,0,0
TIKI,nha-cua-doi-song,94737742,"Kệ Vuông 3 Tầng Màu Gỗ Tự Nhiên- Tháo lắp dễ dàng, sức chịu lực lớn",169000,169000,0,0
TIKI,nha-cua-doi-song,103564402,"Dây sen inox 304 cấp nước tay sen vòị xịt Home Decor DS dùng nóng lạnh",49000,75000,26000,35
TIKI,nha-cua-doi-song,51005591,"Túi Giặt Bảo Vệ Quần Áo - Nhiều Mẫu",29450,31000,1550,5
TIKI,nha-cua-doi-song,153546308,"Phân bón hoa lan BIOGROW kích thân mầm lá, siêu kích kie lan, mầm to, cành khỏe, dung tích 500ml, chính hãng DOCNEEM",119000,119000,0,0
TIKI,nha-cua-doi-song,186636635,"Vòi xịt vệ sinh có giá đỡ và dây cấp Chiba Hafele 589.34.921 (Hàng chính hãng)",369000,410000,41000,10
TIKI,nha-cua-doi-song,54747122,"Chặn cửa chống va đập cửa Hy Lạp",110000,110000,0,0
TIKI,nha-cua-doi-song,101995256,"Thanh Xốp Chắn Khe Cửa Đa Năng Thông Minh",28000,28000,0,0
TIKI,nha-cua-doi-song,37929600,"Đèn bắt muỗi Đại Sinh D6 tặng kèm 1 bóng thay thế",665000,665000,0,0
TIKI,nha-cua-doi-song,28079716,"Hộp đựng xà phòng dầu gội sữa tắm Xinda ZYQ138 White",135000,135000,0,0
TIKI,nha-cua-doi-song,173903547,"Khăn lau nhà bếp siêu thấm hút 2 mặt đa năng mềm mịn - Henrysa",19000,19000,0,0
TIKI,nha-cua-doi-song,100159967,"Bộ Dụng Cụ Cuốc Xẻng Làm Vườn Trồng Cây Mini 03 Chiếc - Home Basics",29000,29000,0,0
TIKI,nha-cua-doi-song,53970712,"Bàn Trang Điểm Ngồi Bệt Thông Minh Gương Gập Tiện Ích",321000,349000,28000,8
TIKI,nha-cua-doi-song,13729970,"Ruột Gối Khách Sạn 5 Sao DADA - Gòn  Microfiber Polyester 
- Êm Ái, Mềm Mại, Dễ Chịu",213000,220000,7000,3
TIKI,nha-cua-doi-song,172940012,"Bộ Dao Nhà Bếp Nhật 6 Món Cao Cấp - Chính hãng DODODIOS, dao nhà bếp Nhật Bản - Logo trên thân dao ngẫu nhiên",185000,185000,0,0
TIKI,nha-cua-doi-song,157537059,"Thảm chống trơn trượt nhà tắm size 30x30cm tiện dụng, Tấm thảm nhựa lót sàn nhà tắm kháng khuẩn chống trượt",11760,12000,240,2
TIKI,nha-cua-doi-song,154880475,"Bàn Gaming, Bàn làm việc chân sắt TI-GM01",790000,790000,0,0
TIKI,nha-cua-doi-song,150902332,"Bộ chăn ga gối cotton LIDACO PL1 - Kẻ ô xanh dương nhỏ SP001454",199000,289000,90000,31
TIKI,nha-cua-doi-song,105137438,"Bàn học làm việc, bàn gaming chân sắt chữ Z hiện đại 1m2 - Chính hãng TIDO",690000,690000,0,0
TIKI,nha-cua-doi-song,71057267,"Combo 2 Hộp Muối Dưa Cà - Ngâm Hoa Quả Lock&Lock INL413 (2.1 Lit) và INL412 (1.3Lit) Có Thể Để Trong Tủ Lạnh",192400,296000,103600,35
TIKI,nha-cua-doi-song,186636765,"Vòi xịt vệ sinh có giá đỡ và dây cấp Chiba Hafele 589.34.920 (Hàng chính hãng)",283000,410000,127000,31
TIKI,nha-cua-doi-song,56737810,"Lô 4 Cuộn Túi Rác Tự Hủy Có Quai Tiện Dụng SOJI INOCHI Nhật Bản - Nhiều Màu - Nhiều Size - Đa dạng công năng sử dụng",25000,45000,20000,44
TIKI,nha-cua-doi-song,111498921,"Ghế xếp thư giãn SUMIKA 139 -  khóa bằng kim loại, vải lưới Textilene thoáng khí kèm nệm, tải trọng 300kg",1136000,1750000,614000,35
TIKI,nha-cua-doi-song,168923896,"Bàn bệt chân Z bệt gaming mặt bo tròn - Chân sắt gấp gọn - Lắp sẵn - TIDO",590000,590000,0,0
TIKI,nha-cua-doi-song,96182053,"Kệ để bếp từ bếp gas mini 1 tầng Hobby Home Decor KBN1 đặt trên bếp tiện dụng khó rỉ sét",172000,175000,3000,2
TIKI,nha-cua-doi-song,69568450,"Sticker Giấy Dán Tường Decal Dán tường Mẫu Hoa Lá Cực Xinh ZH019",59000,90000,31000,34
TIKI,nha-cua-doi-song,25470491,"Bình Nước Lock&Lock HAP812 1,5L (Trắng) - Hàng Chính Hãng",29000,29000,0,0
TIKI,nha-cua-doi-song,173632748,"Áo Mưa Cánh Dơi Vải Dù 2 Đầu",135000,180000,45000,25
TIKI,nha-cua-doi-song,137226640,"Nhang xanh trầm hương phổ thông - Hộp 500 gram",165000,165000,0,0
TIKI,nha-cua-doi-song,274060710,"Chuông cửa không dây, không dùng pin, chống nước cao Linbell G1",225000,225000,0,0
TIKI,nha-cua-doi-song,134841092,"Kẹp ga trải giường chống xê dịch, cố định và giữ phẳng drap ga phủ giường (Giao mầu ngẫu nhiên)",53000,59000,6000,10
TIKI,nha-cua-doi-song,139202816," Tạp Dề Polime Không Thấm Nước, Sạch Sẽ Cute Jodily",75000,75000,0,0
TIKI,nha-cua-doi-song,188474170,"Ly Thủy Tinh Vuông, Cốc Thủy Tinh Vuông Chịu Nhiệt Uống Nước Pha Trà Ca Phê Decor 200ml 350ml 500ml",38000,38000,0,0
TIKI,nha-cua-doi-song,116631755,"HAP512GRP - Ly nhựa 2 lớp LocknLock Animal 520ml in hình gấu trúc - Màu",142000,241000,99000,41
TIKI,nha-cua-doi-song,148811025,"Bình Nước Chia Giờ Nhắc Uống Nước 2 Lít- Bình Nước Siêu Dễ Thương, Tiện Dụng",56496,56496,0,0
TIKI,nha-cua-doi-song,6731165,"Đèn Bàn Bảo Vệ Thị Lực Điện Quang ĐQ DKL14",308000,420407,112407,27
TIKI,nha-cua-doi-song,194570463,"Găng Tay Cao Su Nấu Ăn, Làm Bếp, Dọn Dẹp Siêu Dai, Siêu Bền",22800,24000,1200,5
TIKI,nha-cua-doi-song,68237228,"Hạt giống hoa Hướng Dương Lùn giống nảy mầm khỏe - hoa to VTS105",13000,13000,0,0
TIKI,nha-cua-doi-song,53547712,"Bàn xếp học sinh vân gỗ mini 30X50X22",135000,135000,0,0
TIKI,nha-cua-doi-song,130385982,"Vòi hoa sen tăng áp  Luva VS4, tăng áp lực nước, hàng chính hãng",150000,150000,0,0
TIKI,nha-cua-doi-song,143116837,"Dây Lẻ Đàn Guitar Acoustic 1-2-3-4-5-6",7000,7000,0,0
TIKI,nha-cua-doi-song,184689674,"Khăn giấy nén rửa mặt dạng viên kẹo hàn quốc, khăn nén ướt dạng viên HBH",1000,1500,500,33
TIKI,nha-cua-doi-song,190589797,"Bể bơi cho bé, hồ bơi trẻ em loại dày hình chữ nhật 1m2, 1m3, 1m5, 1m8, 2m1 | 2 tầng, 3 tầng, Bể Bơi Phao Bơi Trong Nhà 3 Tầng Cho Trẻ Em, Hồ Bơi Tắm Cho Bé Dày Dặn, Bể bơi cho bé, Hồ bơi trẻ em - dododios",186000,186000,0,0
TIKI,nha-cua-doi-song,102050886,"Bàn để ủi quần áo Nakagami tư thế ngồi có giá đỡ chất lượng Công nghệ Nhật Bản - Màu ngẫu nhiên - Hàng chính hãng",149000,149000,0,0
TIKI,nha-cua-doi-song,984252,"Kèn Melodion - Melodica Suzuki Study-32 32 Phím",619000,619000,0,0
TIKI,nha-cua-doi-song,148654134,"Áo bọc bàn để ủi quần áo nhiều size, nhiều mẫu - CHỌN SIZE - Áo trùm bàn ủi đồ, giao mẫu ngẫu nhiên tùy đợt hàng",75000,79000,4000,5
TIKI,nha-cua-doi-song,71518864,"Nồi Decor Lock&Lock LDE1182IH (18cm) - Màu Kem",612000,1043000,431000,41
TIKI,nha-cua-doi-song,128569047,"Phích đựng nước Rạng Đông nút bấm 2 lít Model: RD-2045ST3.E",448000,560000,112000,20
TIKI,nha-cua-doi-song,72587793,"Ghế xếp thư giãn SUMIKA 638 - Dòng cao cấp, bề rộng 73cm, vải lưới Textilene thoáng khí, tải trọng 300kg",1136000,1800000,664000,37
TIKI,nha-cua-doi-song,274843590,"GHẾ BỐ XẾP THƯ GIÃN GIÁ RẺ CADATI C-03 - KHÔNG NỆM",1149000,2200000,1051000,48
TIKI,nha-cua-doi-song,74409358,"Chặn cửa chống va đập nam châm gắn sàn nhà Hobby Home Decor CC5 inox 304",81000,119000,38000,32
TIKI,nha-cua-doi-song,3604691,"Đèn Bắt Muỗi Điện Quang ĐQ EML02 BL",200000,265300,65300,25
TIKI,nha-cua-doi-song,174050794,"COMBO 2 CHIẾC PHÍCH CẮM ( Ổ CẮM) CHUYỂN ĐỔI 3 CHẤU KÈM CÔNG TẮC C06S",135000,135000,0,0
TIKI,nha-cua-doi-song,37465377,"bộ 10 miếng xốp dán tường giả gạch aa 3dt mầu trắng ",128000,128000,0,0
TIKI,nha-cua-doi-song,191506484,"Đèn Bàn Học LED Đọc Sách Làm Việc Chống Cận Bảo Vệ Mắt - Cảm Ứng 5 Cấp Độ Điều Chỉnh  - Điều Chỉnh Vùng Sáng - Gấp Gọn Tiện Lợi",550000,550000,0,0
TIKI,nha-cua-doi-song,14605513,"Nắp Kính Cường Lực Fivestar Nồi Và Chảo",60000,110000,50000,45
TIKI,nha-cua-doi-song,8909611,"Phân bón hữu cơ vi sinh Đầu Trâu HCMK7 - ngừa bệnh cải tạo và tốt đất (túi 5kg)",119000,119000,0,0
TIKI,nha-cua-doi-song,105736063,"Kéo cắt đa năng INGCO HES02855",42000,45000,3000,7
TIKI,nha-cua-doi-song,118877620,"Bộ mũi khoan vặn vít 23 chi tiết 15095-B1",215000,215000,0,0
TIKI,nha-cua-doi-song,59234562,"Đồng Hồ Vạn Năng Đo Điện Tự Động ZOYI ZT-S4 Có Thể Đo Được Dòng Điện DC, AC",290000,290000,0,0
TIKI,nha-cua-doi-song,558347,"Ổ Cắm Điện Có Nắp Che 4 Lỗ 3 Chân Mpower MP-243S - 3 Mét",181000,199000,18000,9
TIKI,nha-cua-doi-song,59119832,"Đèn LED Bóng Tròn Có Chuôi Ping Pong Ball Trang Trí Kiểu Cổ Điển",152000,160000,8000,5
TIKI,nha-cua-doi-song,144803506,"Nhang thơm hương tết xưa - Nhang Thảo Mộc Dương Minh 180cây 30cm nhang sạch 100% thành phần tự nhiên từ các loại thảo dược",130500,220000,89500,41
TIKI,nha-cua-doi-song,136078949,"Giàn gỗ treo chậu cây, hoa trang trí ban công, giàn leo cho cây, hoa, kệ gỗ gắn tường ban công",590000,590000,0,0
TIKI,nha-cua-doi-song,69844170,"Bộ 12 Ly Cốc Thủy Tinh Uống Cà Phê LG60 155ML Camdaco PCD22004",89000,89000,0,0
TIKI,nha-cua-doi-song,134443512,"Phểu Nhựa Rót Nước - Chính hãng",18400,20000,1600,8
TIKI,nha-cua-doi-song,46190364,"Khuôn Làm Bún Tươi - Bánh Canh - Bánh Lọt - Sợi Phở - Ép Khoai Tây Đa Năng Hiệu Dragon",154000,154000,0,0
TIKI,nha-cua-doi-song,23269956,"Bộ đèn LED bán nguyệt M26 0,3m 9w Rạng Đông",99000,99000,0,0
TIKI,nha-cua-doi-song,173553141," Cặp Lồng Inox 3 Tầng 1.4 - 2 Lít -Cặp Lồng  Đựng Cơm Cháo Phở Giữ Nhiệt Cao Cấp - Cà Mên Inox - Hàng Loại 1 - Chính Hãng MINIIN",142000,142000,0,0
TIKI,nha-cua-doi-song,108209734,"Bộ Đèn Philips LED Ốp Trần tròn lắp nổi DN027C- Công suất (11W, 15W, 18W, 23W)",343400,580000,236600,41
TIKI,nha-cua-doi-song,52260722,"Pin Maxell AAA Super Power Ace (2 Viên)",6000,6000,0,0
TIKI,nha-cua-doi-song,106056414,"Vỉ 5 Viên Pin CR2450 3V Panasonic - Hàng Chính Hãng",97000,120000,23000,19
TIKI,nha-cua-doi-song,529404,"Bình Xịt Chống Gỉ Sét Selleys RP7 (300g)",83000,99000,16000,16
TIKI,nha-cua-doi-song,159394148,"Bộ 4 Miếng Đế Đệm Cao Su Lót Kê Chân Máy Giặt Chống Rung Ồn, Chống Rỉ Sét - Chính Hãng dodosios",36000,36000,0,0
TIKI,nha-cua-doi-song,96392151,"Mành, rèm cửa, vách ngăn phòng sợi kim tuyến lấp lánh trang trí nhà cửa, spa sang trọng, phông rạp cưới loại 1m x 2m R102",119000,119000,0,0
TIKI,nha-cua-doi-song,113693449,"Mũi khoan tường, gạch Unika (Nhật) chân lục giác mã RJ",59000,59000,0,0
TIKI,nha-cua-doi-song,274597284,"Hộp Nhựa Chia Thuốc 7 Ngăn - Giao Màu Ngẫu Nhiên",29000,38000,9000,24
TIKI,nha-cua-doi-song,183036473,"TREO CHỔI TREO CÂY LAU NHÀ TREO Ô DÙ VÒI HOA SEN VÒI NƯỚC JODILY DÁN TƯỜNG INOX 304 Loại Có Móc",55000,55000,0,0
TIKI,nha-cua-doi-song,166088798,"Đèn học LED cảm ứng Rạng Đông Model: RD-RL-60 8W, có đế để chậu cây nhỏ, ánh sáng bảo vệ thị lực đồng thời bổ sung ánh sáng giúp cây phát triển",484000,605000,121000,20
TIKI,nha-cua-doi-song,20883988,"Máy Sấy Giày Và Khử Mùi Tavana SG-002",183000,189000,6000,3
TIKI,nha-cua-doi-song,52281723,"Móc treo quần áo, móc phơi đồ inox chống rơi, có 8 kẹp cố định- Phơi quần áo trẻ em, treo đồ nhà tắm, treo tất vớ, đồ lót",35000,35000,0,0
TIKI,nha-cua-doi-song,175154541,"Bình xịt dầu ăn phun sương cầm tay KIPOR KP-XD01 - Chai thuỷ tinh cao cấp - Tiện lợi, dễ sử dụng",70000,70000,0,0
TIKI,nha-cua-doi-song,52260383,"Pin Maxell AA Super Power Ace (2 Viên)",5782,5900,118,2
TIKI,nha-cua-doi-song,74983464,"Giá kệ để gia vị 3 tầng SIÊU CHƯA ĐỒ - BẢN MỚI NÂNG CẤP 2023 thép Carbon sơn đen KHÔNG GỈ VANDO cao cấp Giá kệ nhà bếp đa năng nhà bếp",199000,399000,200000,50
TIKI,nha-cua-doi-song,13451491,"Dây đèn LED trang trí hình bong bóng cắm cổng USB",80000,80000,0,0
TIKI,nha-cua-doi-song,87959612,"Bộ 6 Hộp Vải Oxford Đựng Đồ Lót Phụ Kiện",142500,150000,7500,5
TIKI,nha-cua-doi-song,2127561,"Kệ Gấp Để Đồ Bằng Nhựa, 5 Tầng Lock&Lock ETM362 (30 x 30 x 87 cm)",187000,319000,132000,41
TIKI,nha-cua-doi-song,54455019,"Ấm pha cà phê Bialetti Moka Express 4 cup . Hàng chính hãng ",1099000,1099000,0,0
TIKI,nha-cua-doi-song,157055091,"Combo 3 Bịt Nắp Cống Silicon - Ngăn Mùi Thoát Sàn, Ngăn Trào Ngược Nhà Tắm, Côn Trùng Xâm Nhập - HÀNG LOẠI 1",32000,32000,0,0
TIKI,nha-cua-doi-song,176079518,"Hộp thủy tinh đựng thực phẩm (tròn, vuông, chữ nhật) chính hãng INOCHI - Tiêu chuẩn nhật bản",40600,40600,0,0
TIKI,nha-cua-doi-song,105310628,"Hạt giống bắp cải xanh F1 chịu nhiệt giống ngắn ngày nảy mầm chuẩn",12000,12000,0,0
TIKI,nha-cua-doi-song,2075139,"Trầm nụ tháp nhỏ - 40g - 60 viên - Xông nhà , xông phòng , thanh lọc không khí - Chuyên dùng cho các lò xông , lư xông - Nhang Thiền",165000,165000,0,0
TIKI,nha-cua-doi-song,77775195,"Băng dính chống thấm X2000 chống thấm chịu nhiệt rộng 20cm dài 5m",122000,122000,0,0
TIKI,nha-cua-doi-song,118895071,"Ly/Cốc uống nước văn phòng - Ca LPV sứ trắng Long Phương  - LPV 3 - 210 ML",34400,34400,0,0
TIKI,nha-cua-doi-song,36332269,"Phích bơm nước cao cấp Rạng Đông Model 2545ST1.E - Chính hãng, thân inox, vai nhựa, dạng cần bơm, dung tích 2.5 lít",284062,284062,0,0
TIKI,nha-cua-doi-song,185821808,"Cuộn Giấy Bạc Dán Tường Nhà Bếp Chống Thấm Dầu, Thấm Nước Tiện Dụng - Hàng Chính Hãng",39000,78000,39000,50
TIKI,nha-cua-doi-song,16169716,"Combo 4 lõi lọc nước yamato 1,2,3 (10 inch)",130000,165000,35000,21
TIKI,nha-cua-doi-song,22165646,"Khăn Trải Bàn PAULEE WLG 751 hoa văn phủ nhũ vàng (90 x 150 cm)",155000,155000,0,0
TIKI,nha-cua-doi-song,157072555,"Dụng Cụ Chà Xoong Nồi Đa Năng Cầm Tay Siêu Sạch - Có Ngăn Đựng Nước Rửa Chén Tiện Lợi - Hàng Loại 1 Chính Hãng MINIIN",9000,9000,0,0
TIKI,nha-cua-doi-song,85029736,"Ổ cắm Điện Quang ECO ĐQ ESK 6ECO (6 Lỗ)",105000,105000,0,0
TIKI,nha-cua-doi-song,171327943,"Giấy Bạc Nướng Thực Phẩm, Màng Nhôm Nướng Thịt, Bảo Quản Thức Ăn Nồi Chiên Không Dầu, Lò Nướng 30cmx5,10,20m - Hàng Chính Hãng MINIIN",41000,41000,0,0
TIKI,nha-cua-doi-song,195716115,"Bộ Đũa Ăn 10 Đôi Gỗ Muồng Tự Nhiên Không Hóa Chất Cao Cấp BEAR CX-E0103 Chống Mốc - Hàng Chính Hãng",219000,349000,130000,37
TIKI,nha-cua-doi-song,144801072,"Nhang Bồ Kết Dương Minh hộp 180cây nhang 30cm nhang sạch 100% tự nhiên nhang thắp và xông nhà hương nhang thơm an toàn không hóa chất",130500,180000,49500,28
TIKI,nha-cua-doi-song,20103028," Đầu Vòi rửa chén Tăng Áp Xoay đổi kiểu_ bông tăng áp rửa chén BTA5_Đầu vòi rửa bát tăng áp lực nước 2 chế độ phun_đầu tăng áp rửa chén bát nhựa ABS si inox cao cấp_ đầu vòi rửa chén tăng áp_ vòi rửa chén đa năng",67000,85000,18000,21
TIKI,nha-cua-doi-song,83398577,"M1 - 12x12x10 cm - 20 Thùng hộp carton",31600,31600,0,0
TIKI,nha-cua-doi-song,916729,"Bộ Dao Nhà Bếp 6 Món Lock&Lock CKK101S01",191000,390000,199000,51
TIKI,nha-cua-doi-song,51251851,"Máy Phun Rửa Áp Lực Cao Karcher K2 Horizontal",2584000,2936000,352000,12
TIKI,nha-cua-doi-song,193013072,"[Độc Quyền] Nệm Cao Su Thiên Nhiên Foam Cao Cấp Kim Cương Stella 15cm Công Nghệ Kháng Khuẩn Chuẩn Châu Âu, Độ Đàn Hồi Tối Ưu, Nâng Đỡ Cơ Thể Tuyệt Đối",4469000,8490000,4021000,47
TIKI,nha-cua-doi-song,172816524," Bình Thuỷ Tinh Luminarc Dona Embossment Circle 1L - LUDOQ0434",84000,107000,23000,21
TIKI,nha-cua-doi-song,107063648,"Ly nhựa 2 lớp Lock&Lock HAP507 750ml - Hàng chính hãng, có ống hút, có nắp đậy - Tặng kèm cọ rửa",124800,227000,102200,45
TIKI,nha-cua-doi-song,99233776,"Thùng Rác Mini Ô Tô, Để Bàn Làm Việc Chính Hãng Baseus Siêu Tiện Dụng Và 30 Túi Đựng( Bán Lẻ Túi)",197937,250000,52063,21
TIKI,nha-cua-doi-song,50094239,"D'Addario EJ13 - Bộ Dây Đàn Acoustic Guitar Cỡ 11 (.011-.052) - Chính Hãng (80/20 Bronze Strings) - Kèm Móng Gảy DreamMaker",149000,149000,0,0
TIKI,nha-cua-doi-song,145750524,"Bộ Giá Đỡ Ke Bàn Gấp Treo Tường KUNBE, Bản Lề Gập Thông Minh Tiết Kiệm Không Gian, Chịu Tải Tốt",115000,115000,0,0
TIKI,nha-cua-doi-song,23427410,"Bộ 5 Ổ cắm nối chia 3 ngả chân cắm tròn PHI5 Φ5 LIOA",77000,77000,0,0
TIKI,nha-cua-doi-song,150549978,"Túi Giữ Nhiệt Đựng Hộp Cơm Văn Phòng  Trụ Đứng Có Dây Buộc Miệng Chống Thấm YESURE Y1T1 - Hàng chính hãng",64000,99000,35000,35
TIKI,nha-cua-doi-song,58374586,"Nệm lò xo túi hút chân không cao cấp Zinus - Extra Firm Spring Mattress",3699000,6425000,2726000,42
TIKI,nha-cua-doi-song,44102624,"Đồ chặn cửa đế dẹp nam châm giữ cửa chống va đập Hobby home decor CC2 không rỉ sét kèm keo dán dính",101000,104000,3000,3
TIKI,nha-cua-doi-song,263488818,"Kệ sách gỗ để bàn - Tủ,kệ sách mini - Giao màu sắc ngẫu nhiên",50000,62000,12000,19
TIKI,nha-cua-doi-song,142478266,"Lõi lọc sản phẩm iPura - AquaHandy - Lõi Lọc",165000,165000,0,0
TIKI,nha-cua-doi-song,74978675,"Nhang Quế Chi An Gia 30cm 200 g ",70000,70000,0,0
TIKI,nha-cua-doi-song,62866185,"Áo Mưa Rando Poncho Bisur - Bảo Vệ Toàn Diện - APNS-23 - Size 2XL Màu Ngẫu Nhiên",335000,335000,0,0
TIKI,nha-cua-doi-song,170477630,"FELIX, Giường ngủ 3 ngăn tủ cánh mở, Phong cách Bắc Âu, 200x30cm",4104000,4104000,0,0
TIKI,nha-cua-doi-song,54071386,"Kệ gầm bếp đa năng tokyo",99000,99000,0,0
TIKI,nha-cua-doi-song,10768545,"Ổ Cắm Điện Quang ĐQ 002A-02 (3 Lỗ) dây 2m",85000,123200,38200,31
TIKI,nha-cua-doi-song,28307053,"Đá mài đa chức năng",17000,17000,0,0
TIKI,nha-cua-doi-song,146939630,"Bàn bệt chân Z làm việc, bàn học ngồi bệt gaming - Chân sắt gấp gọn - Lắp sẵn - Chính Hãng TIDO",450000,450000,0,0
TIKI,nha-cua-doi-song,180746646,"Bàn tăng giảm nâng hạ chiều cao thông minh công thái học iCockpit 1460, nâng hạ 80 kg, tặng móc treo tai nghe, giá để ly nước, thảm lót chuột",2659000,5400000,2741000,51
TIKI,nha-cua-doi-song,195649371,"Bình Tông Nhôm Xanh Truyền Thống Đựng Nước Dung Tích 1,2L Tiện Dụng (Loại Cực Dày), Chất Liệu Vỏ Nhôm An Toàn Dây Đeo Tiện Dụng",124000,258000,134000,52
TIKI,nha-cua-doi-song,129183017,"Nệm tiện ích Everon Lite ( mẫu ngẫu nhiên )",355500,395000,39500,10
TIKI,nha-cua-doi-song,169465254,"Kệ Sách Treo Tường Giá Sách Gỗ Treo Tường Thương Hiệu IGA - GP13",283000,308000,25000,8
TIKI,nha-cua-doi-song,73637243,"Thảm lau chân cao cấp, thảm chùi chân thấm hút nước, thảm nhà tắm chống trơn trượt kích thước 60x40 cm - Hàng nhập khẩu",50000,50000,0,0
TIKI,nha-cua-doi-song,160549748,"Kệ Để Trên Bồn Rửa Locknlock LDR209 (800x310x590 mm - Kích thước sau khi lắp ráp) - Màu Đen",1398000,2750000,1352000,49
TIKI,nha-cua-doi-song,54022832,"Thang nhôm rút gọn SUMIKA SK380 - Chiều cao tối đa 3.8m, hợp kim nhôm cao cấp, khóa chốt chắc chắn, đế cao su chống trượt, nhỏ gọn, di chuyển tiện lợi - Hàng chính hãng",1377500,1900000,522500,28
TIKI,nha-cua-doi-song,191314447,"Bình giữ nhiệt Lock&Lock 505ml Maman Cup Vacuum Bottle LHC1487 - Hàng chính hãng, nắp dùng làm cốc nước uống - JoyMall",283200,515000,231800,45
TIKI,nha-cua-doi-song,122310849,"Nhang trầm hương tự nhiên Thiên Mộc Hương | Loại 12 Năm | Không cay mắt, Không Ngứa Mũi, Thơm Nhẹ, Dễ Chịu, An Toàn sức khỏe",150000,200000,50000,25
TIKI,nha-cua-doi-song,152556226,"Combo quốc dân (2 gối nằm + 1 gối ôm) tiêu chuẩn khách sạn 5 sao",559000,700000,141000,20
TIKI,nha-cua-doi-song,153515495,"Dao Chặt Xương, Chặt Thịt Gà Vịt Thái Thịt Thực Phẩm SEKI Nhật Hàng Cao Cấp Dao Sắc Dùng Siêu Thích- HÀNG CHÍNH HÃNG",219000,219000,0,0
TIKI,nha-cua-doi-song,141349418,"Cốc ly sứ có nắp Bát Tràng cao cấp - Cốc sứ uống trà - Cốc sứ uống nước đẹp có nắp giá rẻ",70000,70000,0,0
TIKI,nha-cua-doi-song,16376462,"Bao Giày Đi Mưa - Áo Mưa Giày Dép Thời Trang Bằng Cao Su Khô Ráo Dù Mưa Bão",39000,39000,0,0
TIKI,nha-cua-doi-song,69237807,"Bóng đèn LED ECO STICK E27 OSRAM",93000,93000,0,0
TIKI,nha-cua-doi-song,186255503,"Chăn hè cotton 100% chần bông LIDACO thoáng khí, mát mẻ và bền màu khổ 200x230cm",399000,650000,251000,39
TIKI,nha-cua-doi-song,75302784,"Mèo Thần Tài  Maneki Neko  vẫy tay chiêu tài lộc 16cm bằng gốm sứ - mẫu giao ngẫu nhiên",298000,330000,32000,10
TIKI,nha-cua-doi-song,53238570,"Chiếu điều hòa Tencel latex A - tặng kèm 2 vỏ gối 50x70cm",340000,450000,110000,24
TIKI,nha-cua-doi-song,135442362,"Bút Thử Điện 100-500V Deli Chính Hãng - Nhỏ Gọn, Tiện Lợi, An Toàn Sử Dụng - EDL8001",9000,18000,9000,50
TIKI,nha-cua-doi-song,137995209,"NgocTrinh Store Official - Màng bọc bảo quản thực phẩm tủ lạnh dùng trong lò vi sóng hâm nóng thực phẩm 30cmx400 LasPlams (Chính hãng)",229000,229000,0,0
TIKI,nha-cua-doi-song,134844476,"Bộ đèn PHILIPS âm trần Meson G3 (594xxx)-Công suất (5W,6W,7W,9W,13W)",80100,128100,48000,37
TIKI,nha-cua-doi-song,120294515,"Keo dán đa năng, siêu dính 3M Pr100 chuyên dán giày, nhựa plastic, rubber - cao su, sắt cao cấp ",129000,129000,0,0
TIKI,nha-cua-doi-song,85482946,"Dụng Cụ Mài Dao Kéo Lock&Lock 4 Lớp CKK114 - Màu Đen",141000,214000,73000,34
TIKI,nha-cua-doi-song,19920948,"Ô dù gập 3 tự động đóng mở bằng nút bấm 60cm - Hàng xuất khẩu Nhật Bản",83000,83000,0,0
TIKI,nha-cua-doi-song,17510214,"Bộ 20 gói giấy ăn than tre gấu trúc",39000,59000,20000,34
TIKI,nha-cua-doi-song,144268637,"Ổ Cắm WiFi Thông Minh TP-Link Tapo P105 Điều Khiển Từ Xa - Hàng Chính Hãng",199000,359000,160000,45
TIKI,nha-cua-doi-song,147429712,"Vòi hoa sen tăng áp Luva VS4- Hàng Chính Hãng",199000,199000,0,0
TIKI,nha-cua-doi-song,197104665,"Kệ gỗ decor Monrovia để cây trang trí trong nhà, ban công siêu bền bỉ, tiêu chuẩn Châu Âu",380000,380000,0,0
TIKI,nha-cua-doi-song,26051922,"BỒN CẦU 1 KHỐI, NHẬP KHẨU CAO CẤP CHÍNH HÃNG RHENWARE CB-906",2731050,5355000,2623950,49
TIKI,nha-cua-doi-song,167547371,"Ô tự động thông minh Nason Beauty Umbrella 8K chống tia UV, siêu chống thấm nước, khóa an toàn, màu tươi sáng hot trend",339000,599000,260000,43
TIKI,nha-cua-doi-song,38160041,"Bút Thử Điện Điện Quang ĐQ ETP06 R (Đầu Vít Dẹp,140 mm, Màu Đỏ)",12753,17718,4965,28
TIKI,nha-cua-doi-song,193758611,"Bình giữ nhiệt Lock&Lock DIY Strap Tumbler 350ml LHC3283 - Hàng chính hãng, hoạ tiết dễ thương, đựng nước cho bé - JoyMall",268900,489000,220100,45
TIKI,nha-cua-doi-song,149459663,"Gối Ngủ Văn Phòng Chữ U Tặng Kèm Bịt Mắt Bịt Tai Cao Cấp – Bộ Gối Ngủ Du Lịch Tựa Đầu Chống Mỏi Chất Liệu Memory Foam Mật Độ Cao Hàng Chính Hãng Dododios",168000,168000,0,0
TIKI,nha-cua-doi-song,152915395,"Keo Dán Tường Đa Năng - Trám Vết Nứt Tường Thông Minh- LOẠI 1 - HÀNG CHÍNH HÃNG",32000,32000,0,0
TIKI,nha-cua-doi-song,32895306," Đèn Bàn Học Đọc Sách LED Chống Cận 03 Chế Độ Ánh Sáng Vàng Bảo Vệ Mắt ",141550,149000,7450,5
TIKI,nha-cua-doi-song,194773056,"Tấm lót bàn ăn cao cấp, chịu nhiệt, chống thấm, chống trượt - Lót bàn ăn trang trí sang trọng cho nhà hàng, khách sạn",150000,165000,15000,9
TIKI,nha-cua-doi-song,132800256,"Bộ 8 Khuôn Làm Cơm, Ép Trứng Bento, Làm Bánh Tạo Hình Ngộ Nghĩnh Kích Thích Cho Bé Ăn-Chất Lượng An Toàn- Chính Hãng MINIIN",109000,109000,0,0
TIKI,nha-cua-doi-song,89692680,"Ca Lọc Dầu Ăn Có Lưới Lọc Cặn Bằng INOX 304 Không Gỉ",50000,50000,0,0
TIKI,nha-cua-doi-song,4581785,"Bình Thủy Inox Rạng Đông RD1040 ST2.E - Trắng (1L)",280000,280000,0,0
TIKI,nha-cua-doi-song,153066088,"Vỉ 5 Viên Pin CR2032 / CR2025 / CR2016 / CR1632 / CR1620 / CR1616 / CR1220 Maxell Lithium 3V - Made In Japan",10000,10000,0,0
TIKI,nha-cua-doi-song,21753291,"Bộ đổi nguồn 220v sang 100v lioa 200va",305000,305000,0,0
TIKI,nha-cua-doi-song,45597601,"Ron Dán Che Khe Cửa ,Chân Cửa Chống Gió Lùa , Chống Ồn , Bụi Bẩn, Ngăn Côn Trùng Chính Hãng 3M - Cuộn Dài 5m",99000,130000,31000,24
TIKI,nha-cua-doi-song,172362577,"Hộp đựng giấy vệ sinh ECOCO chống thấm nước, không cần khoan tường 1903 GDTA",150000,150000,0,0
TIKI,nha-cua-doi-song,138460516,"Ấm đun nước inox Happy Cook",188000,307000,119000,39
TIKI,nha-cua-doi-song,71149760,"Ổ cắm điện đa năng Honjianda HJD-0448B",240000,240000,0,0
TIKI,nha-cua-doi-song,74292490,"Đèn Tích Điện Năng Lượng Mặt Trời Sunhouse SHE-6899S",210000,350000,140000,40
TIKI,nha-cua-doi-song,156795679,"Máy lên dây, chỉnh dây, chỉnh âm, Clip Tuner - Takahama AT10 - Dành cho Chromatic, Guitar, Bass, Ukulele C, Kèm pin - Hàng chính hãng",82000,84000,2000,2
TIKI,nha-cua-doi-song,32767676,"Thùng vuông 30 lít - có bánh xe Duy Tân 750 (52 x 32 x 27.5 cm) giao quai màu ngẫu nhiên thùng đựng thực phẩm đồ đa năng",115000,115000,0,0
TIKI,nha-cua-doi-song,83927931,"Giấm Gỗ Sinh Học DOCNEEM xua đuổi côn trùng sâu bệnh, trị nấm, bọ trĩ, nhện, rệp, dạng hữu cơ an toàn tuyệt đối, chai dạng phun, dung tích 500ml, chính hãng thương hiệu DOCNEEM",155000,155000,0,0
TIKI,nha-cua-doi-song,263488974,"GIÁ SÁCH MINI ĐỂ BÀN BẰNG GỖ CAO CẤP",50000,62000,12000,19
TIKI,nha-cua-doi-song,52049950,"Bộ 6 nĩa trái cây inox 304 DandiHome 2020 cao cấp, sang trọng, tinh tế",105600,105600,0,0
TIKI,nha-cua-doi-song,114152769,"Thùng đá giữ nhiệt Nhật Bản Galasea hàng nhập khẩu chính hãng #Made in Japan",398500,398500,0,0
TIKI,nha-cua-doi-song,165967342,"Túi Lọc Sữa Đậu Nành, Túi Lọc Sữa Hạt Cao Cấp, Túi Lọc Trà, Túi Lọc Gia Vị, Túi lọc nước cốt dừa/ Túi lọc đa năng - Hàng Chính Hãng DODODIOS",36000,36000,0,0
TIKI,nha-cua-doi-song,89718996,"Dụng Cụ Hái Trái Cây Trên Cao Kèm Túi Vải KUNBE Chuẩn Size 16 Cm, Vợt Hái Quả Bằng Kim Loại Siêu Chắc - Hàng Loại 1",169000,169000,0,0
TIKI,nha-cua-doi-song,735534,"Ổ Cắm Điện 4 Hai Chấu Super Dây 2.5m x 2 Lioa 4SS2.5-2 – Trắng",160000,160000,0,0
TIKI,nha-cua-doi-song,85029373,"Ổ Cắm ECO Điện Quang ĐQ ESK 5ECO 2A (5 lỗ, 2 cổng USB 2.0A, màu trắng đỏ)",203000,203000,0,0
TIKI,nha-cua-doi-song,157483311,"Ca cao 5 sứ Long Phương cao cấp Ly sứ dung tích 550ml",78200,78200,0,0
TIKI,nha-cua-doi-song,15453283,"Bộ 3 Hộp thủy tinh tròn Lock&Lock LLG822 400ml tặng túi giữ nhiệt",154800,154800,0,0
TIKI,nha-cua-doi-song,25036394,"Bình Lọc Nước Barrier Nika (2.5l) - Tím",89000,450000,361000,80
TIKI,nha-cua-doi-song,38037592,"Gối Ngủ Văn Phòng Du Lịch Chữ U Cao Cấp - Chính Hãng miDoctor",329000,329000,0,0
TIKI,nha-cua-doi-song,53261292,"Thảm Nhà Bếp Thảm chùi chân Thảm trang trí",49000,80000,31000,39
TIKI,nha-cua-doi-song,84885783,"Bảo vệ gối tiêu chuẩn khách sạn cao cấp Hanvico by Homemark cotton màu trắng chống mùi, chống ẩm có kích thước 50x70 cm",72000,106000,34000,32
TIKI,nha-cua-doi-song,55324101,"Giỏ treo chậu hoa ban công mạ chống han gỉ - GTC",21599,21599,0,0
TIKI,nha-cua-doi-song,208414253,"Đèn Bắt Muỗi Điện Quang ĐQ EML04L",468000,584100,116100,20
TIKI,nha-cua-doi-song,50600336,"Bộ 2 hộp vải đựng đồ, giỏ vải đựng đồ có quai, giỏ đựng quần áo, nhiều màu ( giao màu ngẫu nhiên) + Tặng quà ngẫu nhiên",49000,49000,0,0
TIKI,nha-cua-doi-song,75791934,"Bồn phụ, bình phụ, bồn giảm áp 50L – Inox 304 dùng máy máy năng lượng mặt trời mặt trời",546000,590000,44000,7
TIKI,nha-cua-doi-song,113651684,"Vòi chậu rửa mặt | rửa tay | Lavabo lạnh đồng thau mạ crome",135000,220000,85000,39
TIKI,nha-cua-doi-song,85029482,"Set 5 Phích cắm Điện Quang ECO EP01 (chân tròn, màu ngẫu nhiên)",24000,31500,7500,24
TIKI,nha-cua-doi-song,4604235,"Xe Đẩy Tay 4 Bánh (Có Thể Gấp Gọn) Stanley PC527",1250000,1250000,0,0
TIKI,nha-cua-doi-song,718991,"Thùng rác inox FITIS nhấn vuông lớn STL1-903 - đen - 22L",990000,990000,0,0
TIKI,nha-cua-doi-song,96475040,"Bộ nồi chảo inox 5 đáy Sunhouse SHG995",1007000,1007000,0,0
TIKI,nha-cua-doi-song,20910797,"Kềm KNIPEX Lắp Điện Đa Năng 13 96 200",1600000,2010000,410000,20
TIKI,nha-cua-doi-song,133811221,"Bộ 3 Túi Đựng Chăn Màn Quần Áo Đa Năng Bằng Vải Chống Thấm Cực Tốt Tiện Dụng – Giao ngẫu nhiên- Hàng Chính Hãng MINIIN",153000,153000,0,0
TIKI,nha-cua-doi-song,109090764,"1 Mét Ron Chân Cửa Thanh Chắn Chân Cửa Nhôm Kèm Chổi Sẵn Keo Dán 50mm 60mm Ngăn Bụi Côn Trùng Gián Chuột Legaxi",103000,103000,0,0
TIKI,nha-cua-doi-song,94737759,"Hộp Đựng Đồ Lót Gấp Gọn 24 Ngăn Morning House- Form Vải Đứng, Gấp Gọn Dễ Dàng, Sắp Xếp Các Loại Tất, Đồ Lót Rất Gọn",39000,39000,0,0
TIKI,nha-cua-doi-song,125803989,"Giá, Kệ Dán Tường Để Sạc điện thoại, Remote Đồ Dùng Giá Đỡ Sạc Điện Thoại Có Móc Treo Giữ Dây Điện",14842,15959,1117,7
TIKI,nha-cua-doi-song,56736495,"Ổ cắm hẹn giờ ĐQ ESK DT08 W 13 (Điều chỉnh điện tử, 1 lỗ - 3 chấu, trắng)",192000,266673,74673,28
TIKI,nha-cua-doi-song,59495338,"Bình xịt chống thấm tường, chống dột đa năng Leak Sealer B125 Bosny - Nhập khẩu Thái Lan.",159000,159000,0,0
TIKI,nha-cua-doi-song,176634011,"50 Tờ Giấy Nến Lót Nồi Chiên Không Dầu Hình Khuôn Bánh Siêu Tiện Lợi - Thấm Giảm Thiểu Tối Đa Dầu Mỡ Bám",10000,21000,11000,52
TIKI,nha-cua-doi-song,274179389,"Pin sạc eneloop Panasonic 2000mAh - BK-3MCCE/2B (Hàng chính hãng)",245000,250000,5000,2
TIKI,nha-cua-doi-song,53913537,"Máy Xay Tỏi Ớt Kéo Tay, Dụng Cụ Xay Nghiền Tỏi Ớt Mẫu Mới 2020",22000,22000,0,0
TIKI,nha-cua-doi-song,158774697,"Quánh Nồi Bột Inox 304 3 lớp đáy liền Trimax ECO ELMICH El3990 16cm",560000,560000,0,0
TIKI,nha-cua-doi-song,120338124,"Băng keo chống thấm x2000 Nhật Bản chống thấm dột, dán tường, dán mái tôn, dán ống nước",21848,21848,0,0
TIKI,nha-cua-doi-song,59410891,"Gối hơi du lịch, gối tựa cổ đa năng tự bơm, chọn màu theo ý+ Tặng kèm thẻ đeo hành lý, giao mẫu ngẫu nhiên",48000,48000,0,0
TIKI,nha-cua-doi-song,76004568,"Đèn led để bàn học sạc usb có kệ đựng bút hoặc điện thoại hình tròn - Chính hãng",175000,175000,0,0
TIKI,nha-cua-doi-song,507437,"Máy Khoan Búa Bosch GBH 2-26 DRE - 0611253709",4188000,5024000,836000,17
TIKI,nha-cua-doi-song,657102,"Giấy Lọc Cà Phê THP 1 x 2 (Bịch 100 Tờ) - Trắng",94000,94000,0,0
TIKI,nha-cua-doi-song,73310078,"Kệ Giày Dép 4 Tầng Bằng Nhựa Màu Ngẫu Nhiên",24000,29000,5000,17
TIKI,nha-cua-doi-song,162505218,"Combo Cây Lăn Bụi Quần Áo, Lông Chó Mèo, Giường Đệm, Nội Thất Trong Nhà  + Tặng Kèm 2 Cuộn Lăn Siêu Tiện Lợi - Hàng Loại 1 - Chính Hãng MINIIN",39000,39000,0,0
TIKI,nha-cua-doi-song,20222967,"Decal dán tường dán kính giỏ cây SK9343ds",69000,80000,11000,14
TIKI,nha-cua-doi-song,195470662,"Combo 10 Keo Nến Silicon Làm Thủ Công, Trang Trí (Loại Lớn/Nhỏ)",27550,29000,1450,5
TIKI,nha-cua-doi-song,65204670,"Phân bón lá đầu trâu MK 501 chuyên cho hoa Lan và hoa Cảnh giúp ĐẺ NHÁNH - TẠO MẦM - NẢY CHỒI - RA LÁ hộp 400g",89000,89000,0,0
TIKI,nha-cua-doi-song,73921498,"Cây lăn bụi giường chăn COLOCOLO",235000,235000,0,0
TIKI,nha-cua-doi-song,66546589,"Hạt giống cải chíp -  cải thìa cao sản gói 20g VTP20",10300,10300,0,0
TIKI,nha-cua-doi-song,135442320,"Kéo Cắt Tỉa Cành Cây Deli Chính Hãng 8inch - Lưỡi Thép Sắc Bén, Siêu Bền, Tay Cầm Đệm Cao Su An Toàn, Chắc Chắn DL580201",68000,154800,86800,56
TIKI,nha-cua-doi-song,718962,"Thùng rác inox FITIS đạp vuông lớn SPL1-904 - trắng - 22L",950000,950000,0,0
TIKI,nha-cua-doi-song,105632980,"Combo nệm ngủ trưa văn phòng cao cấp A 80x190cm + 1 gối hơi 35 x 50 cm - tặng kèm 1 vỏ gối cotton poly cùng màu",245000,300000,55000,18
TIKI,nha-cua-doi-song,50324186,"Combo 10 Chai Thủy Tinh đựng nước 500ML - Nắp Thiếc vặn có dây treo (Bình thủy tinh đựng nước, đựng sữa - Chai thủy tinh đựng nước ép)",98000,98000,0,0
TIKI,nha-cua-doi-song,135442387,"Bộ Lục Giác Chữ L 8 Chiếc Đầu Bằng Deli Cao Cấp Chính Hãng - Kích Thước 1,5-6mm - Nhỏ Gọn, Tiện Dụng - EDL3080",17000,32400,15400,48
TIKI,nha-cua-doi-song,650496,"Hũ Thủy Tinh Nắp Cài Kín Hơi Fido Bormioli Rocco 149220M04321991 (1000ml)",149000,186000,37000,20
TIKI,nha-cua-doi-song,156165766,"Ổ Cắm Du Lịch Đa Năng Thông Minh Phích Cắm Chuyển Đổi Bugu HHT931 - Hàng Chính Hãng",125800,148000,22200,15
TIKI,nha-cua-doi-song,187597928,"Kệ Sách Gỗ Đa Năng Thiết Kế Thông Minh - GP209",513000,557000,44000,8
TIKI,nha-cua-doi-song,148812174,"Thìa, Muỗng Inox 316L Cao Cấp, Sản Phẩm Cao Cấp Và Sang Trọng Số 1 - KT: 16.7x3.3cm",50000,50000,0,0
TIKI,nha-cua-doi-song,26545683,"Decal dán tường trang trí các nhân vật hoạt hình sticker trong One Piece (Đảo Hải Tặc) - Hàng Chính Hãng",29000,29000,0,0
TIKI,nha-cua-doi-song,203904827,"Máy Bào Đá, Máy Bào Đá Tuyết 2 LƯỠI, 2 NẮP Công Suất 300W/500W Thương Hiệu Doron",639000,639000,0,0
TIKI,nha-cua-doi-song,152705765,"Đèn Ngủ Điều Khiển Từ Xa OVAL NIGHT LIGHT - Đèn Ngủ Thông Minh - Có 10 Cấp Độ Sáng, Hẹn Giờ - Hàng Chính Hãng",92000,99000,7000,7
TIKI,nha-cua-doi-song,173609360,"Ghế Văn Phòng Làm Việc Cao Cấp VL2238 Ghế Xoay Văn Phòng Gaming Tựa Lưng Lưới Thư Giãn Công Thái Học - Hàng Chính Hãng",1387000,1950000,563000,29
TIKI,nha-cua-doi-song,55598652,"Combo 3 Cuộn Ron Dán Che Khe Cửa ,Chân Cửa Cao Cấp Ngăn Bụi , Chống Ồn ,Chống Côn Trùng Và Chống Thoát Nhiệt Điều Hòa - Hàng Chính Hãng (Cuộn 2m)",95000,139000,44000,32
TIKI,nha-cua-doi-song,43743399,"Đèn Led Trang Trí Dài 10M - 80 Bóng Trang Trí Noel Lễ Tết",150000,150000,0,0
TIKI,nha-cua-doi-song,96246379,"Gối kê chân chống giãn tĩnh mạch chân Ema thế hệ thứ 2 - Chiều cao chuẩn y tế - Bác sĩ khuyên dùng",999000,999000,0,0
TIKI,nha-cua-doi-song,167046914,"Bàn Để Ủi Cầu Là Quần Áo Kiểu Đứng BU120 35*100CM (Ø25) - Tiện Lợi - Thông Minh - Điều Chỉnh Cao Thấp",359100,399000,39900,10
TIKI,nha-cua-doi-song,58546285,"Keo dán giày, gỗ, nhựa đa năng siêu dính 3M Scotch 3M-3M-AD113",25000,25000,0,0
TIKI,nha-cua-doi-song,162118204,"Bộ 6 Đĩa Thuỷ Tinh Luminarc Diwali Lines 19cm - LUDIQ1669",276000,355000,79000,22
TIKI,nha-cua-doi-song,171825718,"Đồng Hồ Treo Tường Casio IQ-126-5DF Vỏ Gỗ,  Kim Trôi Im Lặng",730620,891000,160380,18
TIKI,nha-cua-doi-song,73100586,"Bộ Nhả Kem Đánh Răng OENON kèm 3 cốc hút từ tính lắp đặt dán tường - OEKEM03",199000,380000,181000,48
TIKI,nha-cua-doi-song,173640970,"Ghế Xoay Văn Phòng Phong Cách Tây Âu Làm Việc Và Học Tập Tựa Lưng Đệm Ngồi Da Hiện Đại Êm Ái Thư Giãn - Hàng Chính Hãng",1984000,2145000,161000,8
TIKI,nha-cua-doi-song,144630273,"[HÀNG CHÍNH HÃNG]Vá sạn đảo lật chiên xào thực phẩm nhà bếp bằng thép không gỉ an toàn sức khỏe GGOMi Hàn Quốc",79200,88000,8800,10
TIKI,nha-cua-doi-song,31622931,"Khăn Trải Bàn PAULEE FY 045K-2K2 (130 x 160 cm)",181000,210000,29000,14
TIKI,nha-cua-doi-song,181369370,"Kệ đựng mĩ phẩm 2 tầng, kệ mĩ phẩm mini để bàn họa tiết hiện đại - IG408",84000,91000,7000,8
TIKI,nha-cua-doi-song,145971794,"Siêu Phẩm Độc Quyền Ghế Văn Phòng Thông Minh Tay Cất Gọn AZP FURNITURE Ergonomic AZP-98723 XÁM - Style Đương Đại",1290000,1890000,600000,32
TIKI,nha-cua-doi-song,116382538,"Combo 2 Bộ Nam Châm Hít, Giữ Ngăn Kéo, Cửa Tủ KUNBE, Không Cần Khoan Siêu Tiện Lợi",39000,39000,0,0
TIKI,nha-cua-doi-song,53792661,"Ghế chống gù điều chỉnh tư thế Curble Wider",729000,729000,0,0
TIKI,nha-cua-doi-song,211300074,"Miếng nhắc nồi vải dày, đẹp, tốt, siêu rẻ, tiện dụng cho bếp, họa tiết ngẫu nhiên",12900,12900,0,0
TIKI,nha-cua-doi-song,58135646,"BỒN CẦU 1 KHỐI, NHẬP KHẨU CAO CẤP CHÍNH HÃNG RHENWARE CB-65819",2244000,4580000,2336000,51
TIKI,nha-cua-doi-song,130812731,"Bộ 4 Miếng dán thay thế treo kệ INOX, Miếng dán pvc dán tường gạch men siêu chắc - PVC04",25000,50000,25000,50
TIKI,nha-cua-doi-song,108798622,"1 Cặp vỏ, áo gối nằm cao cấp A (giao ngẫu nhiên) - kích thước 50x70cm, đường may chắc chắn, vải dày đẹp",85000,95000,10000,11
TIKI,nha-cua-doi-song,579932,"Chảo Trơn Chống Dính Sunhouse CT20 20cm",87000,140000,53000,38
TIKI,nha-cua-doi-song,7699060,"Nồi Nhôm Chống Dính Lock&Lock Baum Marble 2 Tay Cầm, Nắp Thủy Tinh LBU1242 (24cm)",440000,866000,426000,49
TIKI,nha-cua-doi-song,106208918,"Ô dù che mưa cỡ lớn tự động đóng mở, gấp gọn tiện lợi - Thiết kế mở ngược chống ướt khi mở, gập - Chính hãng NIKITA",157000,199000,42000,21
TIKI,nha-cua-doi-song,107359459,"Nệm ngồi văn phòng chống thâm mông, xệ mông, đau xương cụt Ema cho dân văn phòng, lái xe, sinh viên, học sinh",197568,420000,222432,53
TIKI,nha-cua-doi-song,71961087,"Đèn Led Trang Trí Bóng Tròn Dài Cao Cấp Hai Chế Độ Nguồn Pin AAA Hoặc Cắm Điện Trực Tiếp (Độ dài 2M/4M/6M) - Hàng Chính Hãng VinBuy - Dây Bóng Đèn Trang Trí Noel Lễ Tết Bền, Đẹp, Sang Trọng",35000,70000,35000,50
TIKI,nha-cua-doi-song,7016593,"Bàn học sinh vân gỗ chân gấp xếp gọn",63998,63998,0,0
TIKI,nha-cua-doi-song,53972329,"Ghế xếp thư giãn cao cấp SUMIKA 179 - Khóa bằng kim loại, vải lưới Textilene thoáng khí, tải trọng 300kg, có khay đựng ly, dụng cụ tiện lợi, khung ghế bằng thép không gỉ, đế chống trượt",940000,1300000,360000,28
TIKI,nha-cua-doi-song,37695783,"Bàn học gấp gọn thông minh có khe cắm ipad  - Đen",72000,72000,0,0
TIKI,nha-cua-doi-song,161253442,"Kìm Đa Năng 6-8 inch Deli Cao Cấp Chính Hãng - Chất Liệu Thép Cacbon Siêu Bền - Có Thể Sử Dụng Nhiều Mục Đích",62000,124000,62000,50
TIKI,nha-cua-doi-song,21233181,"Bình Giữ Nhiệt Thép Không Gỉ Vacuum Bottle Lock&Lock LHC6180-FU (800ml) - Xanh Đậm",372300,677000,304700,45
TIKI,nha-cua-doi-song,184651798,"Gương Tròn Treo Tường Dây Da Siêu Đẹp VANDO D40cm",287000,427000,140000,33
TIKI,nha-cua-doi-song,131407909,"Bàn làm việc bàn học bàn máy tính kệ lửng",352750,352750,0,0
TIKI,nha-cua-doi-song,57390338,"Kệ Để Sách Treo Tường Hiện Đại Thương Hiệu SIB DECOR",545000,750000,205000,27
TIKI,nha-cua-doi-song,177091957,"Ô tự động 2 chiều móc treo độc đáo Nason Umbrella Carabiner Z siêu tiện lợi Vải siêu chống thấm nước tay cầm nhựa cao cấp",269000,390000,121000,31
TIKI,nha-cua-doi-song,75346666,"BST Tranh số hoá tự tô màu theo số - Tranh động vật thú cưng mèo con cute dễ thương ngộ nghĩnh HH2004",105000,105000,0,0
TIKI,nha-cua-doi-song,69572812,"Sticker Giấy Dán Tường Decal Dán tường Mẫu Hoa Lá Cực Xinh ZH011",59000,90000,31000,34
TIKI,nha-cua-doi-song,119084016,"Cáp Nối Dài LiOA dây dài 3m/5m/10m/15m 10A-15A 2 lõi",66000,66000,0,0
TIKI,nha-cua-doi-song,63139040,"Cuộn 10 Mét Ron Dán Chân Cửa, Khe Cửa Cao Cấp Chống Ồn Ngăn Bụi, Chống Côn Trùng , Chống Thoát Nhiệt Điều Hòa - Hàng Chính Hãng 3M",212000,212000,0,0
TIKI,nha-cua-doi-song,15432583,"Kệ để bàn chải đánh răng dán tường phòng tắm đa năng Hobby home decor KBC31 inox 304 kèm keo dán",81000,129000,48000,37
TIKI,nha-cua-doi-song,122356424,"Ổ cắm điện công suất lớn LiOA có đồng hồ Vol - 3 lỗ, 4 lỗ, 5 lỗ, 6 lỗ dây dài 2.5m 2 lõi",320000,320000,0,0
TIKI,nha-cua-doi-song,90022060,"Kệ để đồ nhà tắm INOX 304 Dán tường gạch men, Giá treo đồ phòng tắm inox",65000,120000,55000,46
TIKI,nha-cua-doi-song,73502149,"Móc Dán Tường Inox 304 Vando Hình Chữ Nhật Móc Cong Treo Đồ Siêu Tiện Lợi",12000,21000,9000,43
TIKI,nha-cua-doi-song,89134266,"Ổ cắm wifi đơn chính hãng Rạng Đông Model: OC.01.WF 16A",248160,310200,62040,20
TIKI,nha-cua-doi-song,134360748,"Pin CR2032 Panasonic Lithium 3V - 1 Viên",15000,15000,0,0
TIKI,nha-cua-doi-song,175431992,"Bộ 3 Khay nướng Thuỷ Tinh Luminarc Smart Cuisine Tròn 14cm- LUKHP0310",360000,360000,0,0
TIKI,nha-cua-doi-song,38160059,"Đèn Bàn Led Điện Quang ĐQ LDL05 3W",430000,599000,169000,28
TIKI,nha-cua-doi-song,25924380,"Combo 3 Bình Đựng Nước Lock&Lock HAP812 1,5L (Trắng) - Hàng Chính Hãng",183000,269000,86000,32
TIKI,nha-cua-doi-song,135442444,"Kìm Cắt Dây Điện Đa Năng Deli Cao Cấp Chính Hãng - Kích Thước 6 Inch - Lưỡi Thép Sắc Bén, Tay Cầm Chống Trượt - EDL2706",87000,156600,69600,44
TIKI,nha-cua-doi-song,135442318,"Bút Thử Điện Deli Chính Hãng 12-250V - Màn Hình Hiển Thị LED Kỹ Thuật Số Thuận Tiện - Vỏ Bút An Toàn - Hãng chính hãng - DL8005 / EDL8003",18000,32400,14400,44
TIKI,nha-cua-doi-song,72659704,"Bộ Cây Chổi Cọ Nhà Vệ Sinh OENON có thêm ngăn chứa đồ lắp đặt dán tường - OEWC",159000,300000,141000,47
TIKI,nha-cua-doi-song,185002810,"Ly Thủy Tinh Lục Giác 320ml Navivu Hexagon Rock",45000,45000,0,0
TIKI,nha-cua-doi-song,91530402,"Bộ 7 túi lưới giặt đồ cao cấp, mẫu mới, nhiều size- Túi giặt đa năng loại tốt, túi lưới giặt đồ bảo vệ quần, áo, đồ lót, tất vớ không bị rách 7 size khác nhau, giao màu ngẫu nhiên",218000,229000,11000,5
TIKI,nha-cua-doi-song,97359314,"Áo Trùm Tủ Lạnh, Miếng Trùm Tủ Lạnh, Tấm Che Tủ Lạnh Chống Bám Bụi Bẩn, Chống Thấm Nước, Lau Chùi Thoải Mải, Có Nhiều Ngăn Đựng Đồ Tiện Lợi",55000,55000,0,0
TIKI,nha-cua-doi-song,108294088,"Bóng đèn Led sạc tích điện có móc treo, pin sạc dung lượng lớn, không cần dây điện, bulb chống nước, chiếu sáng du lịch, cắm trại camping, quầy hàng, câu cá, sửa xe - Đèn sạc không dây",170000,170000,0,0
TIKI,nha-cua-doi-song,113175064,"Đèn Học Để Bàn Chống Cận Rạng Đông RD-RL-31.LED - 5W Phím Cảm Ứng Thay Đổi 3 Cấp Độ Sáng Đế Đèn Đổi 7 Màu - Hàng chính hãng",604560,604560,0,0
TIKI,nha-cua-doi-song,191678388,"Thảm nhà bếp siêu thấm nước, chống trơn trượt tối giản hiện đại",250000,250000,0,0
TIKI,nha-cua-doi-song,76230136,"Ổ Khóa Thép Không Gỉ Chống Cắt Chống Trộm KhoNCC-Zetop-6084 - Cho Gia Đình - Phòng Trọ An Toàn Hơn - Hàng Chính Hãng",179000,238000,59000,25
TIKI,nha-cua-doi-song,7699066,"Chảo Nhôm Sâu Lòng Chống Dính Lock&Lock Baum Marble 1 Tay Cầm, Nắp Thủy Tinh LBU1305 (30cm)",456000,879000,423000,48
TIKI,nha-cua-doi-song,155367822,"Tủ đựng đồ mini 3 ngăn HQ1 phong cách Hàn trang nhã – Hộp vải đựng đồ đa năng 3 tầng Hàn Quốc chính hãng",122000,149000,27000,18
TIKI,nha-cua-doi-song,20580153,"Võng xếp khung thép cao cấp VINANOI KVT32 - Lưới võng cỡ đại màu xanh lá",780000,780000,0,0
TIKI,nha-cua-doi-song,3326251,"Đèn Diệt Côn Trùng Đại Sinh DS-D62 (xanh)",675000,675000,0,0
TIKI,nha-cua-doi-song,160356456,"Dây Led 5050 RGB Trang Trí TV, Case PC Điều Khiển Remote Cảm Biến Nhạc, Nguồn USB",259000,259000,0,0
TIKI,nha-cua-doi-song,38076907,"Viên đất sét nung (sỏi nhẹ leca / keramite) popper trồng xương rồng,sen đá, thủy canh, lọc nước THAILAND - 1 lít",25000,25000,0,0
TIKI,nha-cua-doi-song,72750093,"Báo Động Chống Trộm, Chuông Báo Khách Mở Cửa Đa Chức Năng MC - 03, Báo Động Nhiều Chế Độ : Chống Trộm Xâm Nhập , Báo Chuông Cửa..",115000,124000,9000,7
TIKI,nha-cua-doi-song,117048535,"Giấy lọc cà phê Hario 100 cái (V60-VCF-02-100M)",109000,109000,0,0
TIKI,nha-cua-doi-song,124322906,"Đầu nối vòi rửa bát tăng áp đa năng 3 chế độ, xoay 360 độ Pimisi sử dụng cho cả vòi nước lavabo chậu rửa mặt và vòi chậu rửa chén bát ren trong và ren ngoài | Hàng chính hãng",51000,80000,29000,36
TIKI,nha-cua-doi-song,116902889,"Bộ 6 Tô Thuỷ Tinh Luminarc Harena 20cm - LUHAN5416 ",446000,559000,113000,20
TIKI,nha-cua-doi-song,85377241,"Gương trang điểm để bàn vuông tròn",24000,32000,8000,25
TIKI,nha-cua-doi-song,167019283,"Đèn Pixar, Đèn Bàn Học Chống Cận Thị, Đèn Làm Việc Để Bàn Bảo Vệ Mắt - Hàng Chính Hãng - VinBuy",215000,350000,135000,39
TIKI,nha-cua-doi-song,90968122,"Két sắt mini Hafele mã số cảm ứng SB700/ 836.28.380 - 836.28.380 (Hàng chính hãng)",3723000,5770000,2047000,35
TIKI,nha-cua-doi-song,120037022,"Vỏ gối ôm Everon Lite Cotton Họa Tiết 80*100cm",180000,180000,0,0
TIKI,nha-cua-doi-song,78632468,"Đèn bàn LED Rạng Đông chính hãng model RD-RL-40",360800,451000,90200,20
TIKI,nha-cua-doi-song,183057936,"Set 50 khuôn giấy nến vàng thấm dầu lót nồi chiên không dính",10000,12998,2998,23
TIKI,nha-cua-doi-song,135442367,"Mỏ Lết Đa Năng Deli Cao Cấp 16-68mm - Tiện Dụng Cho Công Việc Sửa Chữa - Chất Liệu Thép Chống Ăn Mòn Chắc Chắn DL120108",74000,124200,50200,40
TIKI,nha-cua-doi-song,82438829,"Ghế kê chân toilet ,bồn cầu  Notoro INOCHI để chân khi đi vệ sinh dễ dàng và thoải mái chống táo bón GHETOILET",79000,79000,0,0
TIKI,nha-cua-doi-song,125287085,"Bộ vòi hoa sen cây tắm đứng nóng lạnh inox 304 kiểu tròn Pimisi đầy đủ phụ kiện với bát sen to - bát nhỏ cầm tay tăng áp dùng được cho cả nhà tắm nhỏ và thấp | Hàng chính hãng",923000,1400000,477000,34
TIKI,nha-cua-doi-song,193645278,"Ổ cắm đa năng chống giật 3m Model: OC04 4C/3M/10A",334400,418000,83600,20
TIKI,nha-cua-doi-song,97815776,"Giá treo bàn chải kem đánh răng kèm 5 cốc cho cả gia đình, bộ nhả kem đánh răng tự động lắp đặt dán tường - OENON",245000,450000,205000,46
TIKI,nha-cua-doi-song,77754942,"Then Chốt Cài Cửa Hình Chữ L KUNBE, Chốt Khóa Cài Cửa Góc Vuông 90 Độ Bằng Thép Không Gỉ, An Toàn Tiện Lợi Nhiều Kích Thước - Cỡ Nhỏ",24900,24900,0,0
TIKI,nha-cua-doi-song,124658780,"Bóng đèn Philips LEDStick",92600,131000,38400,29
TIKI,nha-cua-doi-song,122310722,"Nhang Nụ Trầm Hương Loại 12 Năm tích trầm - Tặng kèm thác khói xông nhà - Thơm lâu, mùi dễ chịu, an toàn sức khỏe - Thiên Mộc Hương",320000,590000,270000,46
TIKI,nha-cua-doi-song,104611197,"Đôi vỏ gối khách sạn cotton cao cấp Hanvico by Homemark có size trẻ em và 50x70 cm",215000,318000,103000,32
TIKI,nha-cua-doi-song,73935625,"Móc dán tường trong suốt siêu chắc chắn",700,1000,300,30
TIKI,nha-cua-doi-song,104542459,"Bộ đèn Led dây dán RGB đổi màu điều khiển từ xa chọn màu đứng yên, nhấp nháy strip light trang trí quay Tiktok dán tường, bàn máy tính, chống nước bền đẹp (Tùy chọn loại led, chiều dài dây)",282000,282000,0,0
TIKI,nha-cua-doi-song,57045660,"Bình Đựng Nước Lock&Lock Easy Grip Dung Tích 1.2L HAP813",42300,60000,17700,30
TIKI,nha-cua-doi-song,186555776,"Combo 5 Miếng Dán Chữ U Đa Năng Treo Ổ Điện, Treo Hộp Giấy",14250,15000,750,5
TIKI,nha-cua-doi-song,157511278,"Ổ cắm thông minh Wifi 3m 5m Rạng Đông Model: OC02.WF 3C/3M/10A",257000,257000,0,0
TIKI,nha-cua-doi-song,137860014,"Bình Giữ Nhiệt Kim Cương Inox 304- Chống Rỉ Set, Nắp Đậy Chặt, Giữ Nhiệt Nóng Lạnh Tốt 6- 8h, Quai Đeo Chắc Chắn, Thiết Kế Sang Trọng, Màu Sắc Thanh Lịch, Tiện Lợi, Pha Lọc Trà, Hàng Chính Hãng MINIIN",183000,183000,0,0
TIKI,nha-cua-doi-song,88740285,"Vợt muỗi tích điện thông minh sạc USB - Hàng chính hãng",138000,150000,12000,8
TIKI,nha-cua-doi-song,189264051,"Dù che mưa, Dù che nắng kính lái Ô Tô, Vải dù 2 lớp - Hàng chính hãng NIKITA",157000,199000,42000,21
TIKI,nha-cua-doi-song,272359826,"Búa đập thịt, tỏi, gừng, xả ... đa năng DandiHome cao cấp-Tiêu chuẩn quốc tế",120000,125000,5000,4
TIKI,nha-cua-doi-song,135220125,"Đầu Vòi Tăng Áp Lực Nước 7 Chế Độ Rửa Xe , Tưới Cây Sân Vườn .. - PaKaSa",39000,78000,39000,50
TIKI,nha-cua-doi-song,177781721,"Nến thơm Candle Cup/Agaya - Hương Thảo Mộc GOODNIGHT",120000,120000,0,0
TIKI,nha-cua-doi-song,217258270,"Thảm chùi chân Bathroom, thảm lau chân chất liệu bằng nhung cao cấp - Hàng  Chính Hãng",53000,58000,5000,9
TIKI,nha-cua-doi-song,214154197,"Dụng cụ gọt vỏ inox 304 DandiHome",53000,55000,2000,4
TIKI,nha-cua-doi-song,54707710,"Túi Đựng Hộp Cơm Giữ Nhiệt Đa Lớp Nhiều Hoa Văn - Denim Lá Thông",38000,40000,2000,5
TIKI,nha-cua-doi-song,1611957,"Bộ Vợt Muỗi Đa Năng Điện Quang ĐQ EMR05L WPI - Trắng Phối Hồng",126000,154300,28300,18
TIKI,nha-cua-doi-song,20033756,"Bịt mắt ngủ có túi giải nhiệt làm mát mắt - Mẫu ngẫu nhiên",37000,39000,2000,5
TIKI,nha-cua-doi-song,104805376,"Đế lót chậu cây có bánh xe MONROVIA, đế để chậu cây, kệ chậu cây do động, có bánh xe, mặt tròn hoặc vuông bằng gỗ tràm cao cấp loại 1, trên 10 năm tuổi, màu vàng đường kinh 30 cm, chính hãng thương hiệu MONROVIA - Đế tròn",85000,85000,0,0
TIKI,nha-cua-doi-song,67724749,"Kính hàn tự động Weldcom W200A- Chính hãng",215000,215000,0,0
TIKI,nha-cua-doi-song,58918400,"Dây rửa xe cao áp cho máy xịt rửa áp lực cao ren trong 22mm dài 15 mét",99000,99000,0,0
TIKI,nha-cua-doi-song,169266826,"Ổ Cắm Điện Đa Năng Chống Giật Có 3 Cổng USB Sạc Điện Thoại Trực Tiếp – An Toàn - Tiết Kiệm Điện – Chính Hãng miDoctor",69000,69000,0,0
TIKI,nha-cua-doi-song,130767608,"Đèn bàn LED Bảo vệ thị lực Điện Quang ĐQ LDL14 WCH 15W (Tích hợp sạc không dây, 15W)",757280,946600,189320,20
TIKI,nha-cua-doi-song,193530021,"Áo bọc/ áo trùm bàn ủi đồ size lớn 140x50cm, chất liệu cotton có lót mút- GIAO MẪU NGẪU NHIÊN",129000,129000,0,0
TIKI,nha-cua-doi-song,26350629,"Ron Dán Chân Cửa Legaxi Keo Đỏ Cải Tiến Ngăn Bụi và Côn Trùng 25 35 45 60 110mm",53000,53000,0,0
TIKI,nha-cua-doi-song,71508089,"Kệ Để Lò Vi Sóng 4 Tầng Morning House Dài 60cm x Cao 114cm- Gỗ Cao Su Chắc Chắn Chịu Lực 60kg, Để Được Lò Nướng, Nồi Chiên Không Dầu",319000,319000,0,0
TIKI,nha-cua-doi-song,59410591,"Set 10 Phích cắm công suất lớn cao cấp Điện Quang ĐQ EPR HP 2PN (Màu ngẫu nhiên)",102000,195400,93400,48
TIKI,nha-cua-doi-song,91859871,"Két Sắt Hình Con Bò Dễ Thương MOHI MKS -Chính hãng",65550,69000,3450,5
TIKI,nha-cua-doi-song,163398765,"Chân Kệ Tủ Lạnh Máy Giặt  Tủ Lạnh Chống Rung Lắc Khung Inox Đế Nhựa Có Điều Chỉnh Kích Thước - Chịu Lực Lên Đến 300Kg - Hàng Chuẩn Loại  1 - MINIIN",105000,105000,0,0
TIKI,nha-cua-doi-song,15164014,"Keo dán đa năng dán thủ công mỹ nghệ B7000 50ml",46000,46000,0,0
TIKI,nha-cua-doi-song,13877176,"Đèn Sạc Khẩn Cấp Kentom KT2200",284000,299000,15000,5
TIKI,nha-cua-doi-song,77333937,"Tay bóp cho bình Dudaco 4L và 8L",22000,22000,0,0
TIKI,nha-cua-doi-song,160754789,"Combo 3 Hộp Giấy Bạc Màng Nhôm MyJae Đài Loan Để Bảo Quản, Nướng Thức Ăn, Bọc Thực Phẩm 30cm x 14m",199000,357000,158000,44
TIKI,nha-cua-doi-song,38309801,"Vỉ 5 Viên Pin CR1220 ( CR 1220/5BE x 1 Vỉ ) Lithium 3V Panasonic - Hàng Chính Hãng",95000,95000,0,0
TIKI,nha-cua-doi-song,51144810,"Kệ giày dép, giá để giày dép 4 tầng tiện dụng - giao màu ngẫu nhiên",29000,29000,0,0
TIKI,nha-cua-doi-song,176715776,"100 Túi Màng Bọc Thực Phẩm Thông Minh PE An Toàn Túi Gấu Có Chun Bọc Đồ Ăn Co Giãn Siêu Dai Cao Cấp Chính Hãng Dododios",36000,36000,0,0
TIKI,nha-cua-doi-song,160310126,"Miếng rửa chén chống xước VILEDA loại có mút, gói 5 miếng - TSU156160",35000,50000,15000,30
TIKI,nha-cua-doi-song,46694285,"Nồi Inox Cao Cấp 3 Lớp Đáy Liền Tri-Max 2353732",650000,819000,169000,21
TIKI,nha-cua-doi-song,48872675,"Phân bón hữu cơ đậu tương, đậu nành trứng chuối humic DOCNEEM kích mầm, chồi, hoa chuẩn form trên hoa hồng, cây cảnh, chai 1 lít",130000,130000,0,0
TIKI,nha-cua-doi-song,199583018,"Ghế Bàn Trang Điểm IGA Đa Năng Thiết Kế Hiện Đại - GP138",222000,245000,23000,9
TIKI,nha-cua-doi-song,158808245,"Chảo inox Kangaroo chống dính KG01F126 (size",599000,1030000,431000,42
TIKI,nha-cua-doi-song,177780261,"Nến thơm Candle Cup/Agaya - Hương Hoa JASMINT",120000,120000,0,0
TIKI,nha-cua-doi-song,175162131,"Bàn học gấp gọn ngồi bệt, bàn chân nhựa cứng 40x60cm mặt gỗ MDF loại đẹp ( giao màu ngẫu nhiên )",75000,75000,0,0
TIKI,nha-cua-doi-song,173854526,"Chai Tẩy Rỉ Sét Và Bôi Trơn  3M 5-W - Hàng chính hãng - Tẩy sét, bôi trơn các loại ổ khóa, khe cửa lùa, đẩy nước ra khỏi ổ khóa xe, bugi, công tắc ôtô xe máy sau khi rửa xe, ngập nước.",66000,82000,16000,20
TIKI,nha-cua-doi-song,162795015,"Ghế Kê Chân Toilet Chống Táo Bón Ngăn Ngừa Các Bệnh Tiêu Hóa Khi Đi Vệ Sinh - Hàng Chính Hãng MINIIN",49000,49000,0,0
TIKI,nha-cua-doi-song,43078046,"Hạt Giống Mồng Tơi Cao Sản Phú Nông",12000,12000,0,0
TIKI,nha-cua-doi-song,81320710,"SƠN SHELL FLINTKOTE / CHỐNG THẤM BỂ NƯỚC HỒ CÁ ĐA DỤNG / LON 3.5L",372000,412100,40100,10
TIKI,nha-cua-doi-song,115281843,"[FREESHIP] Nệm bông ép Goodnight Nova gấp gọn tiện dụng, nâng đỡ 5 tiếp điểm cơ thể",2029000,4750000,2721000,57
TIKI,nha-cua-doi-song,192308302,"Kệ sách để bàn làm việc, bàn học IGA - GP176 - Giá đựng sách phong cách Nordic hiện đại tiết kiệm diện tích",185000,185000,0,0
TIKI,nha-cua-doi-song,103789765,"Vòi nước đa năng 2 đầu (Hàng chính hãng)",86000,150000,64000,43
TIKI,nha-cua-doi-song,170700257,"Chổi Quét Trần Nhà, Chổi Phất Trần Có Cán Điều Chỉnh Độ Dài Quét Mạng Nhện, Lau Chùi Bụi Bẩn Trên Cao Tiện Dụng - Henrysa",78000,150000,72000,48
TIKI,nha-cua-doi-song,127964576,"Vòi nước nối dài uốn cong 360 độ chống tung tóe lắp cho mọi loại vòi Minh House",88000,166000,78000,47
TIKI,nha-cua-doi-song,174609283,"Kệ Màn Hình Để Bàn Làm Việc Đơn Giản SIB Decor",173000,250000,77000,31
TIKI,nha-cua-doi-song,14939901,"Phích cắm chuyển 3 chấu ĐQ NK 803 tiện lợi màu  xanh dương , trắng ( Hàng Chính Hãng )",51147,63900,12753,20
TIKI,nha-cua-doi-song,137672584,"Móc dán tường Command 3M vỉ 1 cái cỡ lớn chịu lực 2.2kg - Dễ sử dụng, độ bền cao, bám cực chắc, tháo cực dễ 17003",36000,45000,9000,20
TIKI,nha-cua-doi-song,140221254,"Dụng Cụ Xay Tỏi Ớt Cầm Tay Máy Xay Thịt Bằng Tay Mini Đa Năng Lưỡi Cắt Thép Không Gỉ An Toàn Thực Phẩm 650ml KONKA KJ-LS01 - Hàng Chính Hãng",106000,194000,88000,45
TIKI,nha-cua-doi-song,72660053,"Miếng Dán Tường Dự Phòng Cho Kệ Nhà Tắm OENON",29000,50000,21000,42
TIKI,nha-cua-doi-song,148812388,"Thìa, Muống Inox 304 Nhật Bản Cao Cấp, Sang Trọng Bền, Đẹp Mãi Với Thời Gian",32000,32000,0,0
TIKI,nha-cua-doi-song,22622993,"Bàn Trà Cafe Đa Năng",122000,133000,11000,8
TIKI,nha-cua-doi-song,57642343,"Chảo Inox Cao Cấp 2 Lớp Đáy Liền Elmich Tri-Max",475000,659000,184000,28
TIKI,nha-cua-doi-song,201225920,"Màn chụp, mùng chụp đỉnh vuông chân viền cao cấp Một Cửa, có thể gấp gọn, dễ dịch chuyển, mang đi hay cất giữ - Hàng chính hãng (Giao màu viền ngẫu nhiên)",303000,340000,37000,11
TIKI,nha-cua-doi-song,118013604,"Set 3 Kệ Treo Tường Thanh Ngang Để Sách, Vật Dụng Nhà Bếp, Đồ Trang Trí SIB Decor, Gỗ 25mm Chống Ẩm, Tặng Kèm Phụ Kiện Lắp Đặt",405000,405000,0,0
TIKI,nha-cua-doi-song,84224292,"Giường gấp văn phòng, giường xếp ngủ trưa gia đình cao cấp",1340000,1705000,365000,21
TIKI,nha-cua-doi-song,177613982,"Túi Đựng Hộp Cơm Giữ Nhiệt 2 Ngăn – Chọn Màu - Túi Giữ Nhiệt Cho Cặp Lồng Cơm 2 Tầng Chống Thấm Nước Chính Hãng Amalife",35000,35000,0,0
TIKI,nha-cua-doi-song,122494119,"Chậu rửa bát inox 304 đơn 1 hố đúc Pimisi kích thước 6045-4540 cm đầy đủ xi phông loại to và kèm rổ đựng đồ dùng để rửa chén bát gắn được cả âm bàn đá | Hàng chính hãng",874000,1420000,546000,38
TIKI,nha-cua-doi-song,155214629,"Túi Giữ Nhiệt, Đựng Bình Nước Chống Va Đập - Hàng Chính Hãng (Giao Màu, Mẫu Ngẫu Nhiên)",45000,45000,0,0
TIKI,nha-cua-doi-song,106502964,"[Tặng Kèm Túi Giữ Nhiệt] Bộ Hộp Đựng Cơm 3 Tầng Có Lõi Hâm Nóng Màu Đen – Tặng Túi Giữ Nhiệt Cao Cấp Chính Hãng miDoctor – Túi Giữ Nhiệt Màu Ngẫu Nhiên (Xanh, Xám)",279000,279000,0,0
TIKI,nha-cua-doi-song,87651880,"ÁO MƯA CỔ RÙA CAO CẤP KIẾNG - RANDO",185000,185000,0,0
TIKI,nha-cua-doi-song,176472413,"{LIMITED EDISION] ĐÈN TREO MÀN HÌNH THÔNG MINH YEELIGHT PRO RGB YLYTD0003 (màu đen) - Hỗ trợ Razer Chroma - Bản US có sẵn Adapter",1790000,2500000,710000,28
TIKI,nha-cua-doi-song,176169965,"Chăn chần bông Everon Lite chất vải microfiber TDELM kích thước 1m6x2m",500000,500000,0,0
TIKI,nha-cua-doi-song,193542285,"Bàn Gấp Học Sinh Thông Minh Gấp Gọn Có Khe Máy Tính Bảng Và Ổ USB Tuỳ Loại Deli - Bàn Xếp Laptop Đa Năng Có Thể Gấp Gọn - Nhiều Màu",204000,376200,172200,46
TIKI,nha-cua-doi-song,192780801,"Hộp nhựa bảo quản thực phẩm khô, hộp đựng ngũ cốc hút chân không có vòng ghi chú thời gian Homepower chống ẩm mốc mối mọt",130000,130000,0,0
TIKI,nha-cua-doi-song,99213076,"Nồi inox kho cá thịt chống dính bếp từ Fivestar ( 18cm / 20cm / 22cm ) nắp kính , 3 đáy , inox 430- tặng 1 vá canh",209000,360000,151000,42
TIKI,nha-cua-doi-song,68891750,"Bộ Hộp Cơm Thủy Tinh 3 Ngăn Cao Cấp - Kèm Túi Xách và Đũa Thìa Cán Gỗ",160000,160000,0,0
TIKI,nha-cua-doi-song,128732371," Chổi Quét Dầu Ăn Silicol Quét Dầu Đồ Nướng, Chiên ",25000,25000,0,0
TIKI,nha-cua-doi-song,176153358,"[Chính hãng Curble Ablue] Ghế chỉnh dáng ngồi đúng, chống gù Curble Grand - Premium Model. # Lớn hơn # mạnh mẽ hơn. Phù hợp mọi đối tượng cân nặng từ 65kg (Nam, Nữ) (Made in Korea)",869000,869000,0,0
TIKI,nha-cua-doi-song,190455805,"Thùng rác cảm ứng tự động - Thùng rác thông minh VKIT (cảm biến chip P30 PRO) RCU02",777000,777000,0,0
TIKI,nha-cua-doi-song,199251709,"Kệ Sách Đa Năng White Athena 5F Phong Cách Hiện Đại",410000,445000,35000,8
TIKI,nha-cua-doi-song,169127538,"Ghế Gấp Ngủ Trưa Văn Phòng Lưới Võng Ôm Lưng Thoáng Mát Dễ Ngủ - Hàng Chính Hãng",900000,900000,0,0
TIKI,nha-cua-doi-song,104681211,"Miếng Bọt Biển Rửa Chén MyJae 2 Mặt, Mút Xốp Rửa Bát Đa Năng Kèm Miếng Nhựa Hít Kê 11.3cm x 7.8cm x 2.7cm (2 Miếng/Gói)",25000,49000,24000,49
TIKI,nha-cua-doi-song,68513683,"Gối Tựa Lưng Sofa Kèm Ruột LIDACO, Chất Liệu Vải Bố, Kích Thước 45 x 45cm",95000,99000,4000,4
TIKI,nha-cua-doi-song,117735031,"VỈ 3 MÓC DÁN TƯỜNG PHỦ BẠC VÀNG SIÊU CHẮC CHẮN - CHỊU TẢI 10KG",25000,25000,0,0
TIKI,nha-cua-doi-song,104681085,"Miếng Bọt Biển Rửa Chén MyJae 2 Mặt, Mút Xốp Rửa Bát Đa Năng Kèm Miếng Nhựa Hít Kê  11.3cm x 7.8cm x 3cm  (2 Miếng/Gói)",25000,49000,24000,49
TIKI,nha-cua-doi-song,14939043,"Phích cắm chuyển 3 chấu ĐQ NK 803 tiện lợi màu đỏ trắng ( Hàng Chính Hãng )",50000,63900,13900,22
TIKI,nha-cua-doi-song,32665801,"Bình PET tròn 15L - có vòi Duy Tân No.626 Thân trong suốt",70000,70000,0,0
TIKI,nha-cua-doi-song,117970516,"Bộ 55 đâù vít đa năng INGCO HKSDB0558",201000,220000,19000,9
TIKI,nha-cua-doi-song,130043701,"Ổ cắm điện Điện Quang 6 lỗ 5m ECO ĐQ ESK 5WR 6ECO - Hàng chính hãng",125000,125000,0,0
TIKI,nha-cua-doi-song,67290760,"USA Dunlop 6582 Dầu Lau Dây Đàn Guitar Ultraglide 65 String Cleaner & Conditioner Hàng Chính Hãng - Kèm Móng Gẩy DreamMaker",170000,170000,0,0
TIKI,nha-cua-doi-song,7699053,"Nồi Nhôm Chống Dính Lock&Lock Baum Marble 2 Tay Cầm, Nắp Thủy Tinh LBU1202 (20cm)",346000,681000,335000,49
TIKI,nha-cua-doi-song,145673593,"Chai xịt dầu 100ml bằng thủy tinh an toàn, bình xịt phun sương đa năng VANDO",20000,50000,30000,60
TIKI,nha-cua-doi-song,103511027,"GIÀY BẢO HỘ SAFETY JOGGER BESTBOY S3",466000,466000,0,0
TIKI,nha-cua-doi-song,133775658,"Chảo chống dính đáy từ vân đá Green cook, chảo chống dính bếp từ Green Cook GCP02",299000,305000,6000,2
TIKI,nha-cua-doi-song,121161886,"Thìa, Muỗng Jodily Inox 304 Mạ Vàng Cao Cấp - Uống Cà Phê, Sinh Tố, Nước Ngọt, Ăn Hoa Quả KT:19.5x3cm",25000,25000,0,0
TIKI,nha-cua-doi-song,187587129,"Bàn Trang Điểm Đẹp Kèm Gương LED Cảm Ứng 1 Chạm Sang Trọng - GP202",800000,870000,70000,8
TIKI,nha-cua-doi-song,207196788,"Combo 2 Cuộn ron gioăng mút xốp dán khe khung cửa cách âm giảm chấn chống bụi dài 2 mét",31000,31000,0,0
TIKI,nha-cua-doi-song,105893670,"Bộ đèn Philips LED âm trần tròn DN027B G2 -Công suất (7W, 10W,14W, 17W,22W)",153700,254000,100300,39
TIKI,nha-cua-doi-song,71518875,"Chảo Decor Lock&Lock LDE1263IH (26cm) - Màu Mint",445000,744000,299000,40
TIKI,nha-cua-doi-song,3077491,"Nồi Ủ Khaluck KL-702 2.5L (Trắng) - Hàng Chính Hãng",450000,450000,0,0
TIKI,nha-cua-doi-song,44016222,"Viên đất nung (sỏi nhẹ) cỡ viên 10-20mm trồng lan, sứ, sen đá, thủy canh Sfarm (5dm3)  | Bonsai soil",49000,49000,0,0
TIKI,nha-cua-doi-song,176059637,"Hộp Pin AAA 1,5V Panasonic R03NT/2S - Hàng chính hãng",55000,55000,0,0
TIKI,nha-cua-doi-song,116900439,"Bộ 6 Đĩa Thuỷ Tinh Luminarc Trianon Trắng 16cm - LUTRN3653 ",238000,299000,61000,20
TIKI,nha-cua-doi-song,189552500,"Bộ Lọ, Hộp, Hũ Đựng Gia Vị, Hũ Thủy Tinh Đựng Gia Vị250ml + Chai Đựng Dầu Ăn 500ml",35000,35000,0,0
TIKI,nha-cua-doi-song,20152022,"Thảm da trải bàn làm việc hai mặt 120 x 60 CM",230850,243000,12150,5
TIKI,nha-cua-doi-song,55202550,"Bộ 3 Hộp Thủy Tinh Chịu Nhiệt KOVA (370ml + 640mlx2) Kèm Túi Giữ Nhiệt Họa Tiêt",229000,390000,161000,41
TIKI,nha-cua-doi-song,58252037,"Bông Lau Nhà Microfiber Xoay 360 Độ Sunhouse KS-CO350M",24000,35000,11000,31
TIKI,nha-cua-doi-song,90035904,"Kệ nhà tắm 2 Cốc OENON liền 2 nhả kem đánh răng tự động lắp đặt dán tường gạch men",225000,420000,195000,46
TIKI,nha-cua-doi-song,35766804,"10 Miếng dán tường trang trí chống cửa va đập 4cm Legaxi",63000,63000,0,0
TIKI,nha-cua-doi-song,174301196,"Giá Treo Bàn Chải Nhà Tắm 4 Cốc liền 2 Nhả kem đánh răng tự động OENON kèm miếng dán tường - OE2KEM",268000,268000,0,0
TIKI,nha-cua-doi-song,43680897,"Bình nước Học sinh Duy Tân No.1246 – Màu ngẫu nhiên",45000,45000,0,0
TIKI,nha-cua-doi-song,54447888,"BỘ 5 KỆ ĐỂ HOA BAN CÔNG BẰNG SÁT -ĐEN ",118000,118000,0,0
TIKI,nha-cua-doi-song,3515593,"Decal dán tường Xương rồng XC9005",49000,81500,32500,40
TIKI,nha-cua-doi-song,100947858,"NỒI Ủ KHALUCK.HOME KL-711 (6 Lít)",849000,849000,0,0
TIKI,nha-cua-doi-song,67865283,"Ổ cắm xoay 90º Điện Quang ĐQ ESK RT 63 (6 lỗ 3 chấu)",78000,111628,33628,30
TIKI,nha-cua-doi-song,14178085,"Đèn diệt muỗi Con Dơi",395000,395000,0,0
TIKI,nha-cua-doi-song,75794505,"Cốc (Ly) cách nhiệt, giữ nhiệt DandiHome inox 304 (500ml)",166000,202000,36000,18
TIKI,nha-cua-doi-song,46208141,"Đèn LED Chữ Cái Loại Lớn 22cm Trang Trí Tiệc Cưới, Sinh Nhật - 26 Chữ Cái",70000,70000,0,0
TIKI,nha-cua-doi-song,76138486,"Áo Mưa BIT - Xanh Đen hoặc Đỏ Đô",109000,158000,49000,31
TIKI,nha-cua-doi-song,1084778,"Chảo Chống Dính Vân Đá Đáy Từ HappyCook MFP-28IH GRAY (28cm)",246000,395000,149000,38
TIKI,nha-cua-doi-song,1323701,"Ghế Cao Xếp Duy Tân 0943 (33.7 x 29.2 x 42.4 cm) - Màu Ngẫu Nhiên",86000,90000,4000,4
TIKI,nha-cua-doi-song,83852328,"Pin máy trợ thính Signia 13",90000,90000,0,0
TIKI,nha-cua-doi-song,72458022,"Bóng Đèn Wifi Thông Minh TP-Link Tapo L510E Điều Chỉnh Ánh Sáng - Hàng Chính Hãng",139000,143000,4000,3
TIKI,nha-cua-doi-song,77765609,"Bàn để ủi quần áo Jumbo 03 chân Inox 38x100cm - Xanh Cobalt",539000,539000,0,0
TIKI,nha-cua-doi-song,91209319,"Sáo Tiêu  Recorder Soprano Yamaha YRS-24B Tone C - CHÍNH HÃNG",150000,150000,0,0
TIKI,nha-cua-doi-song,73772578,"Chăn Everon  Waffle",994500,1170000,175500,15
TIKI,nha-cua-doi-song,56308226,"BÓNG ĐÈN LED SẠC TÍCH ĐIỆN MỸ LINH",32000,32000,0,0
TIKI,nha-cua-doi-song,76738100,"Khăn mặt khách sạn 5 sao – Khăn Cotton 100% - Sợi bông cao cấp – Sợi se đôi – Thấm hút tốt – Kích thước 34 x 70 cm",42000,42000,0,0
TIKI,nha-cua-doi-song,152755198,"Sơn Kẻ Chỉ Gạch Nền Nhà , Keo Chà Ron Công Nghệ Hàn Quốc Đa Năng Dung Tích 280ml",72000,72000,0,0
TIKI,nha-cua-doi-song,70061337,"Bộ kệ 3 thớt nhựa kháng khuẩn LOCK&LOCK Index Cutting Board CSC251",399000,699000,300000,43
TIKI,nha-cua-doi-song,135442391,"Kìm Mũi Nhọn 6inch Deli Cao Cấp Chính Hãng - Chất Liệu Thép Cacbon Siêu Bền - Tay Cầm Chống Trượt - EDL2106",68000,99000,31000,31
TIKI,nha-cua-doi-song,81089185,"(LOẠI XỊN – CÓ CHỌN SIZE) Túi Chăn Màn Khung Sắt Nhật Bản, Túi Đựng Chăn Mền Quần Áo Cao Cấp Chính Hãng  – Hàng Xuất Khẩu",193000,209000,16000,8
TIKI,nha-cua-doi-song,193978021,"[LOẠI 1] Máy khoan pin SUSANO 36V 3 chức năng- Tặng bộ phụ kiện 24 chi tiết, Lõi đồng, Máy bắn vít cầm tay",599000,599000,0,0
TIKI,nha-cua-doi-song,175146524,"Chổi quét dầu silicon KIPOR KP-QD01 - Cọ quét bơ, ướp gia vị tiện lợi - Chịu nhiệt tốt ",18000,18000,0,0
TIKI,nha-cua-doi-song,73610037,"Bộ 6 Túi Giặt Siêu Dày 3 Lớp",152000,160000,8000,5
TIKI,nha-cua-doi-song,138180649,"Áo nệm, bọc nệm topper 2 mặt có khóa kéo, kích thước 1mx2m, 1m4x2m, 1m6x2m, 1m8x2m, Dùng cho nệm dày 3-9cm",139000,139000,0,0
TIKI,nha-cua-doi-song,73771205,"Bộ sạc pin AA AAA 1.2V Sạc nhanh Tự ngắt Có đèn báo pin đầy",133000,140000,7000,5
TIKI,nha-cua-doi-song,133790468,"Đèn Pin Siêu Sáng XML-T6  Cao Cấp Hợp Kim Chống Nước Pin Có Thể Sạc Lại Hộp Full Box- MINIIN Chính Hãng",114000,114000,0,0
TIKI,nha-cua-doi-song,82385249,"Vợt muỗi NAKAGAMI 3 trong 1 diệt muỗi tự động 3 chức năng thế hệ mới công nghệ Nhật Bản - Màu ngẫu nhiên",149000,149000,0,0
TIKI,nha-cua-doi-song,153546474,"Phân bón kích rễ Bio Root 500ml, rễ khỏe vượt trội, dinh dưỡng tối ưu, dùng cho hoa lan, cây cảnh, chính hãng DOCNEEM",119000,119000,0,0
TIKI,nha-cua-doi-song,10910595,"Camen Đựng Cơm La Gourmet Millennium 3 Ngăn 357120",232000,499000,267000,54
TIKI,nha-cua-doi-song,174489164,"Màng bọc thực phẩm Horeca Sunhouse KS-WR30250H",117000,173000,56000,32
TIKI,nha-cua-doi-song,124431705,"Ngăn kéo mini dán dưới bàn làm việc, hộc dán ngăn bàn cực tiện lợi, kín đáo giúp làm gọn góc PC, bàn làm việc (có bộ bắt vít đi kèm)",25000,25000,0,0
TIKI,nha-cua-doi-song,106676695,"Bộ Thau Rổ Nhựa Cao Cấp Yoko INOCH - Nhựa Cao Cấp Chắc Chắn Sang Trọng, Gọn Gàng, An Toàn Cho Sức Khoẻ",35000,35000,0,0
TIKI,nha-cua-doi-song,53466034,"Khay để chén đĩa trái cây gác trên bồn rửa chén Hobby Home Decor KDC3 inox 304 điều chỉnh được",205000,205000,0,0
TIKI,nha-cua-doi-song,69644015,"Sticker Giấy Dán Tường Decal Dán tường Mẫu Hoa Lá Cực Xinh ZH017",59000,90000,31000,34
TIKI,nha-cua-doi-song,4581783,"Phích Nước Rạng Đông RD 2035 N5 (2L) - Màu Ngẫu Nhiên",212000,212000,0,0
TIKI,nha-cua-doi-song,169747912,"Rổ Kèm Thau LocknLock CKB014GRY 280x232x163mm- Màu xám",141000,277000,136000,49
TIKI,nha-cua-doi-song,48318867,"Nồi Inox 3 đáy inox 430  Fivestar bếp từ nắp inox tặng 2 vá canh - Hàng Chính Hãng",449000,810000,361000,45
TIKI,nha-cua-doi-song,102099647,"Dép đi trong nhà tắm / Nhà vệ sinh Massage Chân_Màu xanh ngọc & Xanh dương nhạt_ size M & L_ HÀNG XUẤT NHẬT/ CHÂU ÂU_hàng chất lượng tốt",99000,99000,0,0
TIKI,nha-cua-doi-song,14251502,"Lưới Võng Đại Tín Thành Phát",300000,300000,0,0
TIKI,nha-cua-doi-song,6077793,"Ổ Khoá Việt Tiệp Chống Cắt Loại Lớn 96 x 60 Ống Phi 12mm",152000,195000,43000,22
TIKI,nha-cua-doi-song,79408587,"Mền lông cừu Thái Lan vân hạt bắp vải microfiber nặng 1.2 kg cao cấp A - mềm mại, ấm áp, kích thước 1m7x2m",155000,160000,5000,3
TIKI,nha-cua-doi-song,94186847,"GHẾ THƯ GIÃN HẠNG SANG HAKAWA HK-G22 - HÀNG CHÍNH HÃNG",1980000,2280000,300000,13
TIKI,nha-cua-doi-song,47115292,"Đèn led đom đóm fairy light dây đồng trang trí decor phòng, cắm trại tạo không gian cổ tích lãng mạn",20000,20000,0,0
TIKI,nha-cua-doi-song,80417240,"Tượng Mèo Thần Tài Ngũ phúc lâm môn vẫy tay chiêu tài lộc 20cm bằng gốm sứ - mẫu giao ngẫu nhiên",406000,450000,44000,10
TIKI,nha-cua-doi-song,59477703,"Túi Đựng Quần Áo, Giỏ Đựng Đồ, Chăn Mền, Chống Thấm Nước, Hoa Văn Đẹp, Chất Liệu Bạt Dày Dặn, Có Lựa Chọn Mẫu",95000,95000,0,0
TIKI,nha-cua-doi-song,103508184,"Đèn LED chiếu gương cảm biến 8w chính hãng Rạng Đông Model: G04.PIR 8W",160500,160500,0,0
TIKI,nha-cua-doi-song,184829996,"Bộ Sạc Pin Đôi 18650 3.7V ( Sạc 2 Pin Cùng Lúc - Có Mạch Bảo Vệ Pin)",69000,69000,0,0
TIKI,nha-cua-doi-song,173554863,"Combo 2 Hộp Vải Đựng Đồ Canvas, Túi Vải Đựng Quần Áo, Đồ Dùng Đa Năng Có Nắp Đậy Loại 1 - Hàng Chính Hãng MINIIN",69000,69000,0,0
TIKI,nha-cua-doi-song,72081863,"Khay mây tre đan đựng đồ tiện dụng|Hình bầu dục| Hàng thủ công thân thiện môi trường",66000,69000,3000,4
TIKI,nha-cua-doi-song,157961567,"Bình Đựng Nước Có Vòi 3,5L  Để Trong Tủ Lạnh Tiện Lợi Đa Năng Ngăn Nắp Loại 1 - Hàng Chính Hãng MINIIN",69000,69000,0,0
TIKI,nha-cua-doi-song,54899804,"GỐI CHỐNG GIÃN TĨNH MẠCH YOROKOBI KÍCH THƯỚC 55x48x25CM KÊ CHÂN CHỐNG TÊ BÌ, VỌP BẺ, PHÙ CHÂN CHO NGƯỜI GIÀ, BÀ BẦU",699000,707000,8000,1
TIKI,nha-cua-doi-song,52111936,"Giá Sách Treo Tường Sáng Tạo Với Kết Cấu Giấu Chân Chắc Chắn SIB DECOR (Nhiều màu)",648000,750000,102000,14
TIKI,nha-cua-doi-song,96213632,"Móc Dán Tường Inox 304 Cao Cấp MIFAN - Keo 3M Siêu Dính - Treo Quần Áo, Khăn, Dụng Cụ Bếp, Đồ Nhà Tắm",35000,35000,0,0
TIKI,nha-cua-doi-song,77158378,"Savarez 500CJ - Bộ dây Đàn Guitar Cổ Điển Classic Ghi-ta High Tension (Không đóng hộp - Nylon Strings Sets) Hàng Chính Hãng - Kèm Móng Gẩy DreamMaker",193000,199000,6000,3
TIKI,nha-cua-doi-song,6443663,"Vòi Xịt Tưới Cây Đa Năng Claber 8536, có van khóa, điều chỉnh được 2 chế độ, nhựa ABS, kết nối nhanh, không kèm phụ kiện",162000,162000,0,0
TIKI,nha-cua-doi-song,114938453,"Combo 10 Ron | Zoăng | Gioăng cao su dùng cho ren 27 | dùng cho chân sen nóng lạnh",7000,10000,3000,30
TIKI,nha-cua-doi-song,35948084,"Khay đựng xà phòng dán tường phòng tắm inox 304 Hobby Home Decor SB5 kèm keo dán không rỉ sét",125000,139000,14000,10
TIKI,nha-cua-doi-song,137672120,"Bộ 10 Móc dán tường Command 3M chịu lực 2.2kg - Gói siêu ưu đãi, độ bền cao, bám cực chắc, tháo cực dễ 17008EXVP",119000,154000,35000,23
TIKI,nha-cua-doi-song,44106824,"Pin Maxell CR2016",45000,45000,0,0
TIKI,nha-cua-doi-song,194504632,"Đèn Pin Móc Khóa Siêu Sáng Chống Nước Mini miDoctor - Tích Hợp Nam Châm, Nẫy Mở Bia",35000,35000,0,0
TIKI,nha-cua-doi-song,108894757,"Kẹp Phơi Quần Áo Chăn Mền Inox Chống Gió",42750,45000,2250,5
TIKI,nha-cua-doi-song,35918538,"Thang nhôm rút đơn Nhật Bản HAKAWA HK138 ( 3,8M ) - Phân phối chính hãng - Nhỏ gọn tiện lợi",2200000,2500000,300000,12
TIKI,nha-cua-doi-song,7478361,"06 Bóng đèn led tròn 9W Rạng Đông, Model LED BULB LED A60N1/9w",240000,240000,0,0
TIKI,nha-cua-doi-song,105229027,"Bộ khay lọc rác bồn rửa chén, kèm kệ để miếng chùi xoong nồi tiện lợi",18000,19000,1000,5
TIKI,nha-cua-doi-song,53789152,"Tấm Lót Tủ Bếp Tủ Lạnh Dạng Cuộn 150cmx45cm",67999,67999,0,0
TIKI,nha-cua-doi-song,125621320,"Cọ rửa ống hút bình sữa, cọ rửa dây máy hút sữa cho bé thép không gỉ uốn cong dễ dàng làm sạch mọi ngóc ngách",5000,5000,0,0
TIKI,nha-cua-doi-song,11660212,"Ruột gối đầu ép hơi Hometex",76000,89000,13000,15
TIKI,nha-cua-doi-song,42305900,"Ống Hút Thủy Tinh Loại Lớn Hút Trân Châu Kèm Cọ Rửa - Đường Kính 14mm, Dài 22 - 25cm",25000,25000,0,0
TIKI,nha-cua-doi-song,19353425,"Máy Thổi Hơi Nóng Stanley STEL670 (2000W) - Vàng",645000,645000,0,0
TIKI,nha-cua-doi-song,32807114,"Nhiệt Ẩm Kế Beurer HM 16 + Tặng Đèn Soi Tai",323000,399000,76000,19
TIKI,nha-cua-doi-song,103674615,"Ống hút thủy tinh Organic thân thiện môi trường,  ống hút trà sữa, tái sử dụng nhiều lần",3000,3000,0,0
TIKI,nha-cua-doi-song,690381,"Bộ 3 Bao Tay Ringo (Hộp 100 Cái)",54000,54000,0,0
TIKI,nha-cua-doi-song,174523841,"Set 10 hộp nhựa tròn mỏng đựng thức ăn Đại Đồng Tiến an toàn cho sức khỏe",49020,51600,2580,5
TIKI,nha-cua-doi-song,69254004,"Ron Thanh Nẹp Xốp Chèn Chắn Cửa Chống Bụi Côn Trùng Dài 90cm Legaxi",20000,20000,0,0
TIKI,nha-cua-doi-song,137144152,"Keo silicon Apollo A600 chống thấm tốt, bền bỉ (keo trong - keo trắng đục) 300ml",72000,72000,0,0
TIKI,nha-cua-doi-song,189491105,"Combo Khăn Đa Năng Nhà Bếp Navivu Loại Dày Cỡ 30x30cm, Vải San Hô Siêu Thấm Hút",60000,60000,0,0
TIKI,nha-cua-doi-song,74620918,"Găng tay rửa bát Silicon có lót nỉ siêu ấm - Hàng nhập khẩu",39000,39000,0,0
TIKI,nha-cua-doi-song,50310124,"Combo 4 Kẹp Treo Đồ INOX 304 Có Móc Treo Đa Năng",30000,30000,0,0
TIKI,nha-cua-doi-song,48373983,"Ổ CẮM CHUYỂN ĐỔI 3 CHẤU – KÈM CÔNG TẮC TOSHINO – CO-6S",55000,55000,0,0
TIKI,nha-cua-doi-song,127297076," Kéo Cắt Gà Cắt Thực Phẩm Nhà Bếp Mở Nắp Chai Cắt Đồ Đa Năng Jodily ",50000,50000,0,0
TIKI,nha-cua-doi-song,173206635,"Bộ 6 Đĩa Thuỷ Tinh Luminarc Harena 23cm - LUHAN5413",319000,390000,71000,18
TIKI,nha-cua-doi-song,102049672,"Dụng cụ khui hộp, mở nắp chai đa năng mẫu mới, hàng cao cấp 19x5.5cm+ Tặng kèm móc treo sản phẩm",81000,110500,29500,27
TIKI,nha-cua-doi-song,4581755,"Phích Nước Nóng Inox Rạng Đông RD 2045 ST1.E (2L)",397100,397100,0,0
TIKI,nha-cua-doi-song,179689676,"Nến thơm tinh dầu Aurae - dòng Signature -SX tại VN - WOOD SAGE & SEA SALT",200000,200000,0,0
TIKI,nha-cua-doi-song,52311363,"Dụng cụ thông cống thông đường nước tặng kèm que thông cống đa năng",115000,115000,0,0
TIKI,nha-cua-doi-song,38241122,"Combo 20 đinh 4 chân chịu lực không cần khoan tường (Loại to - có móc treo)",47500,50000,2500,5
TIKI,nha-cua-doi-song,3604699,"Đèn Bắt Muỗi Điện Quang ĐQ EML06L (247 x 65 x 131 mm)",320000,320000,0,0
TIKI,nha-cua-doi-song,58156247,"bao giày không thấm nước, chống trượt, ủng giày đi mưa siêu nhẹ",79000,79000,0,0
TIKI,nha-cua-doi-song,54351163,"Pin 12V Energizer A27 BP1",40000,40000,0,0
TIKI,nha-cua-doi-song,175148937,"Nệm foam Premium Goodnight Nagoya 12cm tại Vua Nệm - Bảo vệ cột sống, kháng khuẩn hiệu quả",2770000,8151000,5381000,66
TIKI,nha-cua-doi-song,201042510,"Bàn Trang Điểm Cho Các Cô Nàng Yêu Phong Cách Bắc Âu Thương Hiệu IGEA (Không Bao Gồm Ghế)",590000,590000,0,0
TIKI,nha-cua-doi-song,71196190,"2 tạp dề nấu bếp, thiết kế đơn giản, có túi đựng điện thoại phía trước, kích thước freesize, chất liệu vải dù mỏng, không thấm nước (Nhiều mẫu mã hoa văn)",62000,75000,13000,17
TIKI,nha-cua-doi-song,121268659,"Nắp đậy - giỏ lọc rác inox 304 của chậu rửa bát chén Pimisi | hàng chính hãng",28000,40000,12000,30
TIKI,nha-cua-doi-song,192443468,"Hộp cơm văn phòng 3 ngăn KIPOR KP-G155 - Thuỷ tinh cao cấp, dùng được trong lò vi sóng - Kèm đũa thìa INOX an toàn- Hàng chính hãng",107000,179000,72000,40
TIKI,nha-cua-doi-song,83398128,"Màng co PE đen đóng hàng - Mã MPE2 - 50 cm x 3 kg (lõi 0.3 kg)",155400,155400,0,0
TIKI,nha-cua-doi-song,193222357,"Nhang Trầm Hương MỘC LÂM 29cm 200cây, Nhang Sạch Ít Khói Ít Tàn, Hương Dịu Nhẹ, Nhang Phòng Máy Lạnh",63500,63500,0,0
TIKI,nha-cua-doi-song,155178884,"Bình Xịt Tưới Cây Bằng Nhựa/Bình Xịt Nước Tạo Mẫu Tóc - Chọn Màu - Chính hãng",49000,98000,49000,50
TIKI,nha-cua-doi-song,52402357,"Dụng cụ ép tỏi Inox 304 DandiHome cao cấp",160000,160000,0,0
TIKI,nha-cua-doi-song,188059117,"Màng Bọc Thực Phẩm Ringo PVC ST412SC ",212000,212000,0,0
TIKI,nha-cua-doi-song,74678334,"Combo Dụng cụ tách sò huyết inox và dụng cụ tách hào tặng kèm móc khóa",78000,78000,0,0
TIKI,nha-cua-doi-song,50713339,"Bao Túi Đựng Trống Điện Tử Yamaha DD-75 Da Dày 3 Lớp - Bag Electronic Drums DD75 - Kèm Móng Gẩy DreamMaker",199000,199000,0,0
TIKI,nha-cua-doi-song,4533677,"Bộ lọc nước sinh hoạt 1 cấp lọc 10inch Yamato YMTH10-1T",128000,155000,27000,17
TIKI,nha-cua-doi-song,177626101,"Kệ Gỗ Để Đồ, Kệ Máy In Đa Năng Tiết Kiệm Diện Tích Thương Hiệu IGA - GP193",143000,155000,12000,8
TIKI,nha-cua-doi-song,139478577,"Tủ nhựa MINA 5 tầng cao cấp, chất lượng, giá rẻ, chính hãng Nhựa Duy Tân",1199000,1480000,281000,19
TIKI,nha-cua-doi-song,74831675,"Túi đựng rác (một cuộn 30 túi) - Chính hãng- Giao màu ngẫu nhiên",26680,29000,2320,8
TIKI,nha-cua-doi-song,120058445,"Bàn Trà Đa Năng Có Thể Làm Bàn Học Bàn Trang Điểm Đa Năng Phong Cách Hiện Đại - GP147B",187000,205000,18000,9
TIKI,nha-cua-doi-song,73503576,"Kệ Inox Để Chén Đĩa Trên Bồn Rửa Chống Han Gỉ Róc Nước Sạch Sẽ Tiện Lợi VANDO",699000,1284000,585000,46
TIKI,nha-cua-doi-song,53926654,"Combo 6 cuộn Túi đựng rác gia đình, Bao đựng rác văn phòng tiện lợi 3 màu size tiểu 45x55cm",52000,52000,0,0
TIKI,nha-cua-doi-song,73466625,"Kệ đa năng gấp gọn 3/4/5 tầng bằng Thép Carbon không gỉ Vando chính hãng, Kệ lò vi sóng có bánh xe, kệ sách trang trí",499000,899000,400000,44
TIKI,nha-cua-doi-song,183907685,"Bồn Rửa Chén INOX 1 Hộc Lớn Pimisi Làm Từ Thép Không Gỉ SUS 304 Cao Cấp Kiểu Ngăn To 1 Hố, Kèm 1 Khay Chậu Rửa Bát Nhỏ Đơn Phụ Gác Bồn -  Tháo Rời Với Đầy Đủ Phụ Kiện Xi Phông, Gắn Được Cả Âm - Dương Bàn Đá Bếp Nhiều Kích Thước | Hàng Chính Hãng",2043000,3500000,1457000,42
TIKI,nha-cua-doi-song,73785488,"Bộ 3 nồi inox 4 đáy Nagakawa NAG1306 (16cm, 20cm, 24cm) - Quai mạ vàng - Dùng trên mọi loại bếp - Hàng Chính Hãng",500000,1000000,500000,50
TIKI,nha-cua-doi-song,162250528,"Bộ Dụng Cụ Sửa Chữa Đa Năng 116 Chi Tiết Deli Cao Cấp Chính Hãng - Sử Dụng Nhiều Mục Đích, An Toàn, TIện Lợi - DL5973",599000,1315000,716000,54
TIKI,nha-cua-doi-song,192951644,"Bàn Xếp Gấp Gọn Thông Minh PHB609 Bàn Làm Việc Và Học Tập 4 Cấp Độ Đa Năng Pehouse",1294000,1399000,105000,8
TIKI,nha-cua-doi-song,189596867,"Kê chân văn phòng, giá đỡ, kệ để gác nâng hạ massage tại bàn làm việc, học tập FOOTREST Ergohome Công thái học",279000,500000,221000,44
TIKI,nha-cua-doi-song,209603615,"Giường Ngủ Văn Phòng Và Gia Đình Gấp Gọn Thông Minh Đa Năng, Giường Xếp Gọn Có Thể Làm Giường Bệnh Nhân Trong Bệnh Viện - Hàng Chính Hãng",1340000,1705000,365000,21
TIKI,nha-cua-doi-song,76062071,"Nệm Cuộn Trải Sàn Cao Cấp (Foam Topper) Ru9 - Thoải Mái Mọi Nơi | Lớp Foam Nâng Đỡ | 7 Kích Thước | 30 Ngày 1 Đổi 1",2691000,2990000,299000,10
TIKI,nha-cua-doi-song,187895987,"Giá Treo Quần Áo IGA Có Kệ Để Giày Khung Thép Chống Ghỉ Sơn Tĩnh Điện - GM60",283000,309000,26000,8
TIKI,nha-cua-doi-song,99211522,"Nồi inox 3 đáy sandwich  FiveStar Standard nắp inox ( 16cm/18cm/ 20cm/24cm ),tặng 1 muỗng canh, dùng được mọi bếp",195000,340000,145000,43
TIKI,nha-cua-doi-song,168059071,"CẶP LỒNG, CAMEN GIỮ NHIỆT CAO CẤP INOX 304 DUNG TÍCH 1.5L HÀNG SIÊU ĐẸP",355000,355000,0,0
TIKI,nha-cua-doi-song,192788986,"Kệ đựng đồ phòng tắm inox 304 xước dán tường Hobby home decor KCNX có keo dán",170000,170000,0,0
TIKI,nha-cua-doi-song,20346270,"Nồi áp suất inox 304 Elmich 20cm EL3369 (4L) - Hàng Chính Hãng",1070000,1550000,480000,31
TIKI,nha-cua-doi-song,153644135,"Bộ 2 Hộp Vải Đựng Đồ Đa Năng HQ3 Có Nắp Đậy, Set 2 Tủ Vải Đựng Đồ Có Quai Xách, Chính hãng",129000,160000,31000,19
TIKI,nha-cua-doi-song,23068209,"Bộ 3 Nồi Quánh Vân Đá Đáy Từ Sunhouse SHG2003MMA (16cm, 20cm, 24cm) - Vung kính cường lực, Dùng trên mọi loại bếp - Hàng chính hãng",1423000,2110000,687000,33
TIKI,nha-cua-doi-song,117702090,"THÌA, MUỖNG INOX 304 MẠ VÀNG JODILY - CAO CẤP - SANG TRỌNG - TINH TẾ",30000,30000,0,0
TIKI,nha-cua-doi-song,76057409,"Kệ Gỗ Trang Trí Treo Tường Đơn Giản Mà Đẹp SIB Decor, Để Sách, Khung Ảnh, Vật Dụng Trang Trí Cho Phòng Khách, Phòng Ngủ, Khu Vực Làm Việc",595000,678000,83000,12
TIKI,nha-cua-doi-song,68237257,"Hạt giống hoa Hướng Dương Tháp siêu hoa VTS110",13000,13000,0,0
TIKI,nha-cua-doi-song,7699058,"Chảo Nhôm Chống Dính Lock&Lock Baum Marble 1 Tay Cầm LBU1203C (20cm)",221100,402000,180900,45
TIKI,nha-cua-doi-song,93391457,"Giá để lưới và nước rửa bát gác bồn",21999,21999,0,0
TIKI,nha-cua-doi-song,77913133,"Dụng cụ kẹp gắp đồ nóng DandiHome inox 304 với mút silicon chống trơn trượt",99000,115000,16000,14
TIKI,nha-cua-doi-song,72527242,"Kệ Nhà Tắm Thông Minh OENON Dán Tường, Giá Treo Bàn Trải Đánh Răng, Bán Kèm Hộp Nhả Kem Đánh Răng Tự Động",139000,250000,111000,44
TIKI,nha-cua-doi-song,95010249,"Công tắc ĐIỀU KHIỂN TỪ XA bằng điện thoại Hunonic Lahu 2 kênh 500W/kênh + Hẹn giờ thông minh | Công nghệ 4.0",298000,298000,0,0
TIKI,nha-cua-doi-song,271929248,"Ô dù cao cấp tán siêu to siêu rộng G30 NASON UMBRELLA Cán gỗ sang trọng khung trợ lực kép chống lật",399000,600000,201000,34
TIKI,nha-cua-doi-song,75380795,"Tấm Lót, Thảm Nhào Bột Silicon Làm Bánh Chống Dính Chuyên Dụng KUNBE - Tặng Dụng Cụ Cắt Vét Bột",45000,45000,0,0
TIKI,nha-cua-doi-song,15450297,"Bộ 3 Hộp thủy tinh tròn Lock&Lock LLG822 400ml",149000,149000,0,0
TIKI,nha-cua-doi-song,1511705,"Combo 2 Bông Lau Thay Thế Của Bộ Lau Nhà ETM498 Lock&Lock - ETM451",92000,165000,73000,44
TIKI,nha-cua-doi-song,51472857,"Kệ đa năng Tokyo 3 tầng cao cấp",104000,104000,0,0
TIKI,nha-cua-doi-song,451843,"Phích Cắm Chuyển Đa Chiều Điện Quang ĐQ EPC NK-803-K-O (Màu Cam)",51147,63900,12753,20
TIKI,nha-cua-doi-song,698608,"Bộ Hộp Nhựa Lock&Lock Classic 6EA HPL818SHP",299000,504000,205000,41
TIKI,nha-cua-doi-song,54819042,"Bình Giữ Nhiệt Nóng Lạnh Camelbak Chute Mag Insulated Stainless Steel 1L",999000,999000,0,0
TIKI,nha-cua-doi-song,14639274,"Nồi Inox 430 Bếp Từ 3 Đáy Nắp Kính Fivestar",189000,350000,161000,46
TIKI,nha-cua-doi-song,57789106,"CỐI XAY TIÊU CẦM TAY TIỆN DỤNG BẰNG THỦY TINH CÓ TAY VẶN TIỆN LỢI ( Giao ngẫu nhiên mẫu)",15000,21999,6999,32
TIKI,nha-cua-doi-song,1575707,"Bình Giữ Nhiệt Lock&Lock New Basic Table LHC4026B (500ml)",233200,424000,190800,45
TIKI,nha-cua-doi-song,161230814,"Búa Đóng Đinh, Nhổ Đinh Cán Dài Deli Đa Năng - Chất Liệu Thép Cacbon Cao Cấp, Chắc Chắn - Tay Cầm Chống Trượt - EDL5002",92000,196000,104000,53
TIKI,nha-cua-doi-song,193988167,"[Tặng bọc ghế + Đai chống gù] Ghế học sinh ngồi học chống gù giúp con có tư thế ngồi lành mạnh chuẩn khoa học, ngăn ngừa cong vẹo cột sống",1690000,1690000,0,0
TIKI,nha-cua-doi-song,647768,"Ổ Khóa Chống Cắt Titalium ABUS 96CSTI/60 (60mm)",698000,795000,97000,12
TIKI,nha-cua-doi-song,68074866,"Tấm Làm Mềm Nệm Topper LIDACO Cao Cấp",359000,539000,180000,33
TIKI,nha-cua-doi-song,20634390,"Ghế sofa giường BNS đa năng TW-MH2021V-N",1980000,1980000,0,0
TIKI,nha-cua-doi-song,92011179,"Bộ thoát nước máy giặt, chậu rửa, thoát nước thải kiêm chống mùi hôi, ngăn côn trùng trào ngược MIHOCO 2-Loại 2 đường thoát-Hàng chính hãng",115000,115000,0,0
TIKI,nha-cua-doi-song,145258510,"Đàn Organ điện tử/ Portable Keyboard - Kzm Kurtzman K250 - Perfect for Learning & Performing - Màu đen (BL) - Hàng chính hãng",6230000,7350000,1120000,15
TIKI,nha-cua-doi-song,52297710,"Bộ 25 Móc dán tường, dính tường trong suốt Siêu chắc, siêu chịu lực loại 10kg",21000,21000,0,0
TIKI,nha-cua-doi-song,43126026,"Bàn để ủi Inox 100x38cm (điều chỉnh được độ cao, không kênh chân)",539000,539000,0,0
TIKI,nha-cua-doi-song,143700598,"Vỉ gỗ lót sàn D30xR30xC2.4cm, vỉ gỗ lót ban công, ngoài trời, sân vườn, siêu bền, xuất khẩu Châu Âu",16900,16900,0,0
TIKI,nha-cua-doi-song,10647762,"Ổ cắm Điện Quang ĐQ ESK 5B.SM750SL (5 lỗ 3 chấu dây 5 mét màu Đen Trắng Đỏ)",228000,294100,66100,22
TIKI,nha-cua-doi-song,170354329,"KHUNG VÕNG XẾP DUY LỢI THÉP - CỠ LỚN (KHÔNG BAO GỒM VÕNG LƯỚI) - TẶNG 10 MÓC ÁO KÉP NHỰA CAO CẤP DUY LỢI",759000,759000,0,0
TIKI,nha-cua-doi-song,52173227,"Kệ Sách Gỗ Treo Tường 4 Tầng Đơn Giản Mà Đẹp SIB DECOR (Nhiều màu)",764000,790000,26000,3
TIKI,nha-cua-doi-song,686899,"Bộ 2 Hộp Thủy Tinh Glasslock 400ml Và Túi Giữ Nhiệt Lunch Set 2",198000,319000,121000,38
TIKI,nha-cua-doi-song,154029917,"Bàn treo ban công bán nguyệt, bàn treo ban công gấp gọn ",700000,700000,0,0
TIKI,nha-cua-doi-song,184913941,"Bộ Vòi Tưới Cây , Rửa Xe 12m Kèm Vòi Tưới 6 Chế Độ - Hàng Nhập Khẩu",437000,550000,113000,21
TIKI,nha-cua-doi-song,146939868,"Chui nối ống nước Karcher (2.645-256.0)",84000,88363,4363,5
TIKI,nha-cua-doi-song,87651508,"Áo mưa Poncho vải BEST có kiếng phủ đèn xe máy RANDO",338000,338000,0,0
TIKI,nha-cua-doi-song,192812477,"Ghế Văn Phòng, Ghế Xếp Gấp Gọn Văn Phòng Kết Hợp Ghế Gaming - Hàng Chính Hãng",490000,550000,60000,11
TIKI,nha-cua-doi-song,108091670,"Bộ Sản Phẩm Ống Hút,Muỗng,Đũa Kèm Cây Vệ Sinh Ống Hút BaoAn- Có 2 Mẫu Để Lựa Chọn - Giao Màu Ngẫu Nhiên - Hàng Chính Hãng",57000,79000,22000,28
TIKI,nha-cua-doi-song,5750351,"Combo Trống Lắc Tay Và Bao Đựng Lục Lạc Gõ Bo Tambourine Yamaha MT6-102B (Xanh)",293000,299000,6000,2
TIKI,nha-cua-doi-song,72030396,"Máy Làm Sữa Chua Cốc Thủy Tinh Song Anh",265000,500000,235000,47
TIKI,nha-cua-doi-song,173764710,"Kệ đựng dụng cụ Duy Tân đủ size",29900,29900,0,0
TIKI,nha-cua-doi-song,9855318,"Áo bọc nệm 2 mặt thun Lạnh NA 16200 (200 x 160 x 10 cm) Màu Ngẫu Nhiên ",110000,110000,0,0
TIKI,nha-cua-doi-song,194478059,"Thố chưng yến Daisy Ly's Minh Long 0.88L + nắp - Trắng Ngà",137160,137160,0,0
TIKI,nha-cua-doi-song,106281037,"Bình Nước Thuỷ Tinh Luminarc Arc 1L - LUBIG2635",89000,109000,20000,18
TIKI,nha-cua-doi-song,71742126,"Bộ 6 hộp nhựa đựng thực phẩm chữ nhật Inochi (500-750-1000-1500-2000-2500ml)",186000,186000,0,0
TIKI,nha-cua-doi-song,37317513,"Keo Bột bả vá tường thông minh siêu tốc tiện lợi tặng kèm bay khi mua 2 sản phẩm trở lên",51500,51500,0,0
TIKI,nha-cua-doi-song,87130162,"Thùng đá giữ nhiệt Ice box Living on 9L và 21L - Hàng chính hãng",159000,280000,121000,43
TIKI,nha-cua-doi-song,71003207,"Hạt giống Hoa Đồng Tiền F1 Mix - giống nẩy mầm khỏe hoa to VTS115",13500,13500,0,0
TIKI,nha-cua-doi-song,36960736,"Dây Đèn LED Trang Trí Bông Tuyết",44999,44999,0,0
TIKI,nha-cua-doi-song,183513712,"[Ráp sẵn] Kệ Máy In, Kệ Sách Để Bàn Làm Việc Văn Phòng SIB Decor",620000,680000,60000,9
TIKI,nha-cua-doi-song,186309370,"Cây lau nhà Vileda dạng đĩa tròn, công nghệ sợi microfiber sạch sâu, kèm xô giặt xoay 360 độ, model Spin&Clean",599000,779000,180000,23
TIKI,nha-cua-doi-song,99511867,"Thảm bếp cao cấp, thảm nhà bếp siêu thấm hút nước, chống trượt tốt - Hàng chính hãng",350000,350000,0,0
TIKI,nha-cua-doi-song,213877154,"Hộp Bảo Quản Gạo, Đồ Khô Special Lock&Lock Chất Liệu Nhựa PP, Nắp Có Gioăng Silicone - Nhiều Kích Thước - Hàng Chính Hãng",114400,176000,61600,35
TIKI,nha-cua-doi-song,80896130,"Ổ cắm điện lõi sứ chống cháy SOPOKA 6000W siêu chịu tải",41000,41000,0,0
TIKI,nha-cua-doi-song,3677795,"Hộp 2 Lõi Lọc Nước BRITA Maxtra Plus Filter Cartridge",499000,749000,250000,33
TIKI,nha-cua-doi-song,173302805,"Đèn Bàn Học ,Đọc Sách, Đèn Ngủ Cao Cấp  LED Chống Cận 03 Chế Độ Ánh Sáng Bảo Vệ Mắt -KOVER (tặng dây cáp sạc pin)",52640,56000,3360,6
TIKI,nha-cua-doi-song,41106507,"Pin đồng hồ Maxell SR626SW 1.5V",15000,15000,0,0
TIKI,nha-cua-doi-song,161409750,"Áo mưa nilon tiện lợi Pharmacity",12000,12000,0,0
TIKI,nha-cua-doi-song,64076345,"Ga Chống Thấm Cotton LIDACO Loại Dày - Lông Vũ (Nệm 15cm)",155000,199000,44000,22
TIKI,nha-cua-doi-song,8380873,"Ủng Bọc Giày Đi Mưa Dùng Nhiều Lần",84000,84000,0,0
TIKI,nha-cua-doi-song,177921835,"Dụng cụ nặn kem đánh răng tự động có giá treo bàn chải dán tường NAVIVU",48355,50900,2545,5
TIKI,nha-cua-doi-song,108243504,"Chảo sâu miệng rót đáy từ Sunhouse SHS26MRD - 26cm - Dùng trên mọi loại bếp - Hàng chính hãng",308000,460000,152000,33
TIKI,nha-cua-doi-song,56274865,"Hộp Đựng Soup, Hộp Canh 2 Lớp Cách Nhiệt Sử Dụng Tốt Trong Lò Vi Sóng 300ml",30000,30000,0,0
TIKI,nha-cua-doi-song,56868404,"Dây đèn led đom đóm DEHA trang trí nguồn USB kèm điều khiển 8 chế độ nháy nhiều màu",165000,165000,0,0
TIKI,nha-cua-doi-song,85029095,"Đèn ngủ cảm biến LED Điện Quang ĐQ LNL10 (Cảm biến quang)",36000,51679,15679,30
TIKI,nha-cua-doi-song,44016627,"Combo 3 đèn rọi ray 7W + 1 ray 1 mét vỏ đen KX500 loại chuẩn",295000,295000,0,0
TIKI,nha-cua-doi-song,194583058,"Đèn Pin Móc Khóa Mini Siêu Sáng Chống Nước Amalife - Tích Hợp Nam Châm, Nẫy Mở Bia",37000,37000,0,0
TIKI,nha-cua-doi-song,158601820,"Nệm Bông Trải Sàn Xuất Nhật Fukoji, Kích Thước 1mx2m, 1m4x2m, 1m6x2m dày 7-9cm",383000,500000,117000,23
TIKI,nha-cua-doi-song,7202337,"Bộ 3 Hộp Thủy Tinh Vuông KOVA (1050 + 640 + 370 ml)",178000,270000,92000,34
TIKI,nha-cua-doi-song,53926794,"Combo 6 cuộn Túi đựng rác gia đình, Bao đựng rác văn phòng tiện lợi 3 màu size trung 55x65",52000,52000,0,0
TIKI,nha-cua-doi-song,110737305,"Kéo nhà bếp DELI 22.5cm - Màu đỏ 77770",102000,183600,81600,44
TIKI,nha-cua-doi-song,57309500,"Thiết bị lọc nước tại vòi BRITA ON TAP (có sẵn 1 lõi lọc BRITA ON TAP HF) - Thương hiệu đến từ Đức",2199000,3299000,1100000,33
TIKI,nha-cua-doi-song,7351379,"Nồi áp suất 3 đáy Inox 304 Elmich 22cm 5.5L EL3371 dùng bếp từ - Hàng chính hãng",1100000,1790000,690000,39
TIKI,nha-cua-doi-song,77037622,"Bình Giữ Nhiệt Lưỡng Tính Tiger MMJ-A361 (360ml) - Nâu Sô-Cô-La",384000,649000,265000,41
TIKI,nha-cua-doi-song,51668278,"Chảo chiên chống dính đáy từ Tefal So Chef 28cm, dùng cho mọi loại bếp- Hàng chính hãng",425000,435000,10000,2
TIKI,nha-cua-doi-song,72641853,"Bình đựng thức ăn giữ nhiệt ELMICH 550ml EL3669",200000,545000,345000,63
TIKI,nha-cua-doi-song,76150362,"Bồn Tắm Ngâm Người Thảo Dược Có Thể Gấp Gọn KUNBE Cho Người Lớn Và Trẻ Em, Bồn Tắm Di Động Thông Minh, Chậu Tắm Xông Hơi Giữ Nhiệt Tiện Lợi",499000,499000,0,0
TIKI,nha-cua-doi-song,37038721,"Combo 2 Bóng Đèn LED Bulb 20W Model: A95N1 20W",308000,308000,0,0
TIKI,nha-cua-doi-song,26602007,"Kẹp Bẫy Bắt Chuột Thông Minh",8000,10000,2000,20
TIKI,nha-cua-doi-song,44822929,"Máy Bơm Bong Bóng Chính Hãng miDoctor – Máy Bơm Bóng Bay  2 Vòi Bằng Điện",215000,215000,0,0
TIKI,nha-cua-doi-song,184438501,"Cây lăn bụi quần áo, chăn màn, giường, lông thú cưng - Hàng chính hãng",18400,20000,1600,8
TIKI,nha-cua-doi-song,32018391,"Giường gấp văn phòng Nikita NKT-TT01",839000,839000,0,0
TIKI,nha-cua-doi-song,162366804,"Đồng Hồ Dán Tường DIY VINAVU Sang Trọng Cỡ Siêu Lớn Nhiều Mẫu",161500,170000,8500,5
TIKI,nha-cua-doi-song,7654183,"Phân bón hữu cơ đậm đặc Đầu Trâu AGRIMARTIN SUPER ORGANIC (gói 1kg)",39000,39000,0,0
TIKI,nha-cua-doi-song,99212501,"Bộ nồi inox đáy từ cao cấp FiveStar Plus FS08CG-304 nắp kính 4 chiếc,inox 304 , tặng 1 vá canh",1523000,2610000,1087000,42
TIKI,nha-cua-doi-song,50367433,"Sáo Recorder Soprano Suzuki SRG-405 - Suzuki SRG-405",89000,89000,0,0
TIKI,nha-cua-doi-song,165767116,"Thước Kẻ Thép Deli Cao Cấp - Kích Thước 15cm Nhỏ Gọn, Tiện Lợi - Chất Liệu Chống Mòn Gỉ - DL8015",7000,14000,7000,50
TIKI,nha-cua-doi-song,21391557,"Đèn chùm - đèn thả phòng khách - đèn thả bàn ăn - đèn treo trần trang trí cao cấp PUCA lamp bộ 3 đèn",395000,395000,0,0
TIKI,nha-cua-doi-song,71001139,"Túi Đựng Hộp Cơm Giữ Nhiệt Văn Phòng Size Lớn Màu Đen Có Dây Kéo Vừa Quai Xách Quai Đeo Ngăn Phụ Trong Ngoài Tặng Túi Muỗng Nĩa (Lunch Bags, Box)",99000,99000,0,0
TIKI,nha-cua-doi-song,135442396,"Kìm Cộng Lực 6inch Deli Cao Cấp Chính Hãng - Chất Liệu Thép Cacbon Siêu Bền - Có Thể Sử Dụng Nhiều Mục Đích - EDL2006",65000,117000,52000,44
TIKI,nha-cua-doi-song,56091947,"Bình Đựng Nước Hoa Quả Detox Lock&Lock Milky 500ml nhựa PET BPA Free HAP654W",43000,89000,46000,52
TIKI,nha-cua-doi-song,188379989,"Cốc Giữ Nhiệt Coffeeholic Teement Inox 304 Dung Tích 510ml Cao Cấp Kiểu Dáng Hàn Quốc Cầm Tay Sang Trọng- Hàng Chính Hãng",145000,145000,0,0
TIKI,nha-cua-doi-song,48453870,"Chảo chống dính 2 lớp inox 430 FiveStar Standard 2 quai bếp từ tặng 5 muỗng ( 18cm / 22cm / 26cm )",399000,720000,321000,45
TIKI,nha-cua-doi-song,23270570,"Xốp Dán Tường Nhiều Màu Cỡ 70x77cm Dày 6mm",10000,19000,9000,47
TIKI,nha-cua-doi-song,197645089,"Nồi Sứ Dưỡng Sinh Minh Long Healthy Cook Luna 2.0 L - Dùng Cho Bếp Gas, Bếp Hồng Ngoại",629640,629640,0,0
TIKI,nha-cua-doi-song,547401,"Máy Khoan Động Lực Bosch GSB 550",1015000,1190000,175000,15
TIKI,nha-cua-doi-song,193710187,"Nệm Foam NOOZ Home Goods  Tiêu Chuẩn CertiPUR-US Với Hai Tầng Foam Nâng Đỡ Ruột Đệm Cao Su Non Vỏ Nệm Tencel",2299000,3750000,1451000,39
TIKI,nha-cua-doi-song,154411975,"Cành lựu giả trang trí cao cấp giống thật",85000,85000,0,0
TIKI,nha-cua-doi-song,169604404,"Đèn LED dây Yeelight Lightstrip Pro Starter 2M RGB 16 triệu màu - Bản Quốc Tế - Hàng Chính Hãng",790000,790000,0,0
TIKI,nha-cua-doi-song,137672365,"Cây lau nhà siêu tốc dùng khăn giấy thay thế Scotch-Brite 3M đa năng, xoay 360 độ, lấy sạch bụi và tóc mọi ngóc ngách",304000,457000,153000,33
TIKI,nha-cua-doi-song,21712076,"Dây đèn Led đom đóm Fairy Light GIVASOLAR dài 10 mét - Nguồn USB",55000,55000,0,0
TIKI,nha-cua-doi-song,191428679,"SEN TẮM NÓNG LẠNH FRAP F2428-001 (MẪU VUÔNG) - HÀNG CHÍNH HÃNG",4700000,4700000,0,0
TIKI,nha-cua-doi-song,92387171,"10 Hạt giống Hoa Sen Mini Nhật ( Màu Ngẫu Nhiên ) - Nông Sản Vàng",17000,17000,0,0
TIKI,nha-cua-doi-song,96470885,"Combo bấc nến cotton và đế kẹp dùng làm nến thơm cao cấp, tặng mẫu thử tinh dầu Kobi",29000,50000,21000,42
TIKI,nha-cua-doi-song,4581739,"Phích Đựng Nước Nóng Rạng Đông RD 2035 N1.E",200000,250000,50000,20
TIKI,nha-cua-doi-song,24766023,"Bộ Sạc Pin AA AAA + 4 Pin AA 1200mAh Doublepow (Hàng nhập khẩu)",74000,74000,0,0
TIKI,nha-cua-doi-song,141792990,"Bát sen tắm của vòi tắm hoa sen nóng lạnh Pimisi 1 chế độ với tay sen bằng nhựa cao cấp mạ xi Cr/Ni sáng bóng - đầu lỗ bát cao su massage tăng áp | Hàng chính hãng",57000,100000,43000,43
TIKI,nha-cua-doi-song,7903644,"Ổ Cắm Công Suất Lớn Điện Quang ĐQ ESKHP 3RW 2m ( 3 Lỗ, Màu Đỏ Trắng, Dây 2m)",123000,164198,41198,25
TIKI,nha-cua-doi-song,718970,"Thùng rác inox FITIS đạp vuông nhỏ SPS1-901 - inox - 15L",675000,750000,75000,10
TIKI,nha-cua-doi-song,51134040,"Combo chậu rửa chén bát inox hai hố cân 8245, vòi rửa bát inox rút dây 01, bộ xả chậu, bình xà phòng, rá inox đa năng",1390000,2450000,1060000,43
TIKI,nha-cua-doi-song,72216749,"Hộp Cơm Điện 2 Tầng Mocato M601",470000,470000,0,0
TIKI,nha-cua-doi-song,169208250,"Bình đựng nước Biwa inochi An toàn cho sức khoẻ với khả năng kháng khuẩn",79000,79000,0,0
TIKI,nha-cua-doi-song,37032720,"Áo Nệm Bọc Hai Mặt 1mx2mx10cm Có Khóa - Giao màu Ngẫu Nhiên",90000,90000,0,0
TIKI,nha-cua-doi-song,55478942,"Dụng cụ bơm hút rượu, chất lỏng bóp tay tiện dụng",15000,27000,12000,44
TIKI,nha-cua-doi-song,130978276,"Đèn Pin LED Điện Quang ĐQ PFL09 R (Pin sạc)",157000,214000,57000,27
TIKI,nha-cua-doi-song,35120155,"Bóng đèn LED Bulb 9W MPE - Ánh sáng trắng LBD-9T",46000,46000,0,0
TIKI,nha-cua-doi-song,184847169,"Chổi Cọ Nhà Vệ Sinh Nhà Tắm, Bồn Cầu Toilet Không Dây Đa Năng XIAOMI CL99 - Hàng Chính Hãng",1299000,2399000,1100000,46
TIKI,nha-cua-doi-song,182783761,"Bình giữ nhiệt Zojirushi SJ-TG08-XA 800ml, hàng chính hãng",699000,699000,0,0
TIKI,nha-cua-doi-song,196018527,"Lót Ly Gỗ Họa Tiết Sông Núi Tối Giản NAVIVU",35000,35000,0,0
TIKI,nha-cua-doi-song,162405980,"Cây Lau Nhà Phun Sương Siêu Sạch Thiết Kế Chổi Đa Năng Xoạy 360 Độ Lau Sạch Mọi Ngóc Ngách Trong Nhà Bạn- Hàng Loại 1 - Chính Hãng MINIIN",167000,167000,0,0
TIKI,nha-cua-doi-song,68199747,"Túi sọt vải bố dầy cỡ lớn có quai xách gỗ sang trọng đựng đồ giặt, quần áo bẩn, giỏ đựng chơi, vật dụng đa năng- Hàng chính hãng",275000,275000,0,0
TIKI,nha-cua-doi-song,133079408,"Vòi hoa sen tắm nóng lạnh Pimisi bằng đồng thau, mạ crom-niken sáng bóng dùng trong nhà tắm, điều chỉnh nước bằng gật gù nóng lạnh gắn tường đầy đủ đế cài tay sen - bát sen tắm tăng áp - dây sen mạ inox bóng mềm - chân nối chữ Z | Hàng chính hãng",884000,1400000,516000,37
TIKI,nha-cua-doi-song,754593,"Ổ Cắm Điện 3D + 3S Dây 5m x 2 Lioa 3D3S52 - Đen",130000,130000,0,0
TIKI,nha-cua-doi-song,127123538,"Bộ thoát nước máy giặt, chậu rửa, thoát nước thải kiêm chống mùi hôi, ngăn côn trùng trào ngược, cổ xoay 360 độ, loại đứng có khe 2 đường thoát Minh House",85000,125000,40000,32
TIKI,nha-cua-doi-song,113428652,"Ổ khóa chống cắt ABUS 66CSTI/60 Titalium (60mm)",569000,599000,30000,5
TIKI,nha-cua-doi-song,182487120,"Miếng rửa chén hạt nổi siêu sạch Scotch Brite 3M đa năng, công nghệ độc quyền mới, mút kháng khuẩn ngăn vi trùng, không gây mùi, không bám cặn bẩn, dễ dàng vệ sinh (Màu cam/ Màu xanh lục)",22000,29000,7000,24
TIKI,nha-cua-doi-song,14708813,"Bộ Cút Nối Ống Nước Đa Năng Kết Nối Nhanh (Đực Cái) No.1",34300,58650,24350,42
TIKI,nha-cua-doi-song,118329934,"Tạp dề thỏ, tạp dề vòng hoa hình thỏ",21892,21892,0,0
TIKI,nha-cua-doi-song,19584471,"Combo 5 Bình đựng nước thủy tinh đẹp 500ml",34000,54000,20000,37
TIKI,nha-cua-doi-song,50406004,"CHẢO INOX CHỐNG DÍNH ELMICH 3 ĐÁY MAX A 20CM",317000,317000,0,0
TIKI,nha-cua-doi-song,116902947,"Bộ 6 Chén Thuỷ Tinh Luminarc Harena 11cm - LUHAN5418 ",209000,262000,53000,20
TIKI,nha-cua-doi-song,33549912,"Ghế sofa giường đa năng BNS-HD2001",1999000,1999000,0,0
TIKI,nha-cua-doi-song,696344,"Ổ Cắm Điện 4 Lỗ 3 Chấu 5m Mpower MP-245S (2500W)",194000,229000,35000,15
TIKI,nha-cua-doi-song,148040890,"[HÀNG XUẤT KHẨU] Túi Đựng Chăn Mền Quần Áo Xuất Hàn Quốc 66L, 100L Khung Sắt Cao Cấp - Chính Hãng dododios",240000,240000,0,0
TIKI,nha-cua-doi-song,650502,"Hũ Thủy Tinh Nắp Cài Kín Hơi Fido Bormioli Rocco 149240M02321991 (2000ml)",197000,246000,49000,20
TIKI,nha-cua-doi-song,372849,"Bình Ngâm Rượu, Nước Hoa Quả Kova BNR2.7 2.7 Lít",157000,219000,62000,28
TIKI,nha-cua-doi-song,71063513,"Tấm phủ tủ lạnh PEVA chống thấm, đặc biệt tấm phủ tủ lạnh có nhiều ngăn vô cùng tiện lợi để chứa đồ dùng cần thiết cho gia đình",49000,49000,0,0
TIKI,nha-cua-doi-song,83680089,"Pin tiểu Maxell AA. Cặp 2 Viên Supper Power ACE Red – Indonesia Vỏ Nhôm 1.5V",6000,6000,0,0
TIKI,nha-cua-doi-song,152784110,"Khay Đá Silicon Có Nắp Đậy 14 Viên, Khay Đựng Đá Tủ Lạnh, Làm Đá Thạch Kem Bảo Quản Chống Mùi Tuyệt Đối- Hàng Loại 1",49000,49000,0,0
TIKI,nha-cua-doi-song,70772936,"Đèn Bàn Học LED USB Di Động Cao Cấp Có Thể Gập Hai Chỗ – 03 Chế Độ Ánh Sáng Vàng Bảo Vệ Mắt Chống Cận - Hàng Chính Hãng  miDoctor",175000,175000,0,0
TIKI,nha-cua-doi-song,132837361,"Hộp Đựng Túi Nilong KUNBE, Hộp Đựng Khăn Giấy Túi Để Rác Dán Tường Tiện Dụng Tiết Kiệm Không Gian",95000,95000,0,0
TIKI,nha-cua-doi-song,1611889,"Vợt Muỗi Điện Quang ĐQ EMR01 BLR - Đen Phối Đỏ",95900,132900,37000,28
TIKI,nha-cua-doi-song,67175850,"Pin Đồng hồ đeo tay Maxell SR920 1.55V 371",85000,85000,0,0
TIKI,nha-cua-doi-song,110895947,"Đèn led USB 8 bóng siêu sáng - Hàng chính hãng",90440,146000,55560,38
TIKI,nha-cua-doi-song,9805349,"Ổ cắm Điện Quang ECO ĐQ ESK 5WR 8ECO (8 Lỗ, dây dài 5m, màu trắng đỏ)",154000,159000,5000,3
TIKI,nha-cua-doi-song,63295725,"Ga Chống Thấm Cotton LIDACO Loại Dày - Sao Kẻ (Nệm 15cm)",155000,249000,94000,38
TIKI,nha-cua-doi-song,9793357,"Decal dán tường hoa mặt trời đón năng XL8011 Flowerdecal",49000,97000,48000,49
TIKI,nha-cua-doi-song,144874085,"Nhang Khuynh Diệp Dương Minh 180cây nhang sạch 30cm 100% thành phần tự nhiên nhang thơm an toàn không hóa chất - nhang cây hương organic",120000,180000,60000,33
TIKI,nha-cua-doi-song,83679973,"Máy Đồng Hồ Treo Tường Cao Cấp KIM TRÔI EASTAR – Bộ KIM VÀNG ĐỒNG Có DẠ QUANG + Tặng Pin Maxell - Trục Kim 13.5mm",99000,99000,0,0
TIKI,nha-cua-doi-song,100379752,"Đèn Đọc Sách Mini, Pin Sạc Tiện Dụng Comfort Reading Mini Clip Lamp Hàng Chính Hãng Baseus",215000,250000,35000,14
TIKI,nha-cua-doi-song,118514048,"Ổ Cắm Điện Công Suất Lớn Chịu Tải LiOA - 4 lỗ, 6 lỗ dây dài 2.5m 2 lõi",160000,160000,0,0
TIKI,nha-cua-doi-song,657077,"Màng Bọc Thực Phẩm PE Ringo 175 (30cm x 175m)",118000,118000,0,0
TIKI,nha-cua-doi-song,5506245,"Bộ 1 gói hạt giống Sen Đá hoa hồng",8990,8990,0,0
TIKI,nha-cua-doi-song,116192703,"Hộp Nhựa Đựng Muỗng Đũa An Toàn Có Nắp Khóa Sanada 1.6L hàng Made in Japan",44000,44000,0,0
TIKI,nha-cua-doi-song,185798331,"Máy chà nhà vệ sinh Jesopb K129 phiên bản 5 in 1, chổi cọ bồn cầu đa năngm lau chùi bề mặt không dây, Pin 4000mAh, Tốc Độ Cao 320 Vòng/Phút, hàng chính hãng",735000,735000,0,0
TIKI,nha-cua-doi-song,118090508,"Kệ Treo Tường SIB Decor Màu Trắng Gỗ Chống Ẩm 25mm, Kết Cấu Chịu Lực Không Giá Đỡ, Để Sách, Vật Dụng Sinh Hoạt, Đồ Dùng Nhà Bếp",159000,159000,0,0
TIKI,nha-cua-doi-song,164078555,"Máy Sấy Giày Cao Cấp Chính Hãng MINIIN Làm Khô Siêu Nhanh - Loại Bỏ Mùi Hôi Và Vi Khuẩn, Kiểu Dáng Nhỏ Gọn, Dễ Sử Dụng - Tăng Kèm Nước Tẩy Trắng Giày",229000,229000,0,0
TIKI,nha-cua-doi-song,46203612,"Bộ xả, xi phông chậu rửa chén",99000,129000,30000,23
TIKI,nha-cua-doi-song,157508710,"Bộ chăn gối văn phòng 3 trong 1 hình thú dễ thương EMA kèm gối luồn tay giữ nhiệt - Tựa lưng - Ngủ trưa - Gối ôm",137200,280000,142800,51
TIKI,nha-cua-doi-song,189885572,"Lưới Chống Muỗi Vải Mỏng, Rèm Chống Côn Trùng Tự Lắp",19000,20000,1000,5
TIKI,nha-cua-doi-song,95056530,"Túi đựng cơm trưa văn phòng tiện lợi, phù hợp cho cả nam và nữ, có kích thước từ lớn đến nhỏ",99000,99000,0,0
TIKI,nha-cua-doi-song,109545425,"Bút thử nước sạch cao cấp TDS & EC, dụng cụ đo TDS, máy độ cứng của nước - Hàng chính hãng, tặng kèm bao da sang trọng",106000,129000,23000,18
TIKI,nha-cua-doi-song,161253119,"Combo 10 Miếng Tấm Pát Pad Thép Vuông Chữ Nhật Sửa Bản Lề Tủ Cửa Gỗ Lỗ Vít Door Hinge Repair Kit",100000,100000,0,0
TIKI,nha-cua-doi-song,54150625,"Combo 9 cuộn Túi đựng rác văn phòng, Bao đựng rác trường học tiện lợi 3 màu size trung 55x65",60000,80000,20000,25
TIKI,nha-cua-doi-song,3232679,"Chảo Inox Chống Dính 3 Đáy 28cm Five Star CKD28-3DI - Hàng Chính Hãng",329000,600000,271000,45
TIKI,nha-cua-doi-song,155833455,"Bàn Chải Kokubo Đa Năng 2 Trong 1 Chà Rửa Nhà Tắm Hàng Nội Địa Nhật",43000,43000,0,0
TIKI,nha-cua-doi-song,177748906,"Sơn xịt chịu nhiệt độ cao 200/600 độ C màu đen nhám, đen mờ, sơn pô xe, sơn chống cháy  HI TEMP Bosny dung tích 400ml - Thái Lan",87000,87000,0,0
TIKI,nha-cua-doi-song,4581765,"Bình Thủy Inox Rạng Đông RD1040 TS (1L) - (Giao Màu Ngẫu Nhiên)",109000,109000,0,0
TIKI,nha-cua-doi-song,48277781,"Nồi inox 3 đáy sandwich inox 430 FiveStar Standard bếp từ nắp kính tặng 2 vá canh",199000,360000,161000,45
TIKI,nha-cua-doi-song,120338283,"Móc Phơi Giày, Treo Giày Inox 304, Móc Phơi Đồ Đa Năng Cao Cấp Không Gỉ Siêu Bền",13000,14000,1000,7
TIKI,nha-cua-doi-song,203973987,"Dăm trầm hương đốt xông nhà tẩy uế HÀ XÁ sạch tự nhiên đồ thờ cúng phong thủy mang lại may mắn tài lộc cho gia chủ",198000,198000,0,0
TIKI,nha-cua-doi-song,43169306,"Combo 10 Cặp Kệ Dụng Cụ Nhỏ Duy Tân (12 x 18 x 8 cm) - Ke nhua dung oc vit, hang hoa, da nang, giup sap xep gon gang do dac",270000,270000,0,0
TIKI,nha-cua-doi-song,128596841,"Set Bình Pha Cà Phê Drip Hario V60 Coffee server 02 Set",531360,531360,0,0
TIKI,nha-cua-doi-song,198379758,"Pin đồng hồ Maxell SR920SW 1.5V",18000,18000,0,0
TIKI,nha-cua-doi-song,76539983,"Nhiệt kế đo tủ lạnh, tủ đông Anymetre",54000,54000,0,0
TIKI,nha-cua-doi-song,17011712,"Bộ Nồi Anod Sunhouse Vàng 16-20-24cm",583000,840000,257000,31
TIKI,nha-cua-doi-song,16422707,"Vòng Đệm Cao Su 270 cái",59000,59000,0,0
TIKI,nha-cua-doi-song,10751030,"Ổ cắm kéo dài phổ thông LiOA 4 ổ cắm có 1 công tắc tổng",78000,78000,0,0
TIKI,nha-cua-doi-song,14380849,"Hộp 20 Mũi Khoan Thép Mini ( Mũi 0.3-1.6mm ) Milliken NL-3083",32900,32900,0,0
TIKI,nha-cua-doi-song,707995,"Vòi Sen Tăng Áp Luva VS4",150000,150000,0,0
TIKI,nha-cua-doi-song,24605723,"Ghế Kê Chân Toilet Chống Táo Bón Ngăn Ngừa Các Bệnh Tiêu Hóa Khi Đi Vệ Sinh",40000,40000,0,0
TIKI,nha-cua-doi-song,124475692,"Hantox 200 diệt ve rận, bọ chét, ruồi, muỗi, kiến, gián (chai 50ml)",27399,27399,0,0
TIKI,nha-cua-doi-song,183338850,"Găng tay cao su Locknlock nhiều size lựa chọn ETM830/ ETM831/ ETM832 có móc treo",30800,56000,25200,45
TIKI,nha-cua-doi-song,169448758,"Khăn Tắm Diệt Khuẩn Cao Cấp - Tắm Sạch Hơn Ngăn Ngừa Mụn",72000,72000,0,0
TIKI,nha-cua-doi-song,45374394,"Gioăng (ron) silicon - cao su chịu nhiệt phi 21 dùng cho máy nước nóng năng lượng mặt trời",14000,22000,8000,36
TIKI,nha-cua-doi-song,99324909,"Vòi xả nước cấp nước máy giặt, xả rửa sàn Inox 304 HOBBY VIN2 - 2 mẫu tùy chọn - không rỉ sét",81000,82000,1000,1
TIKI,nha-cua-doi-song,77780804,"Bộ 10 đôi đũa gỗ trắc DandiHome cao cấp",499000,499000,0,0
TIKI,nha-cua-doi-song,41232091,"chuyển máy khoan thành máy cắt đa năng có lá chắn bộ như hình",159000,159000,0,0
TIKI,nha-cua-doi-song,117221129,"Móc treo đơn Pimisi inox 304 DÁN TƯỜNG dùng để treo quần áo - khăn tắm - phụ kiện - đồ dùng gia đình | Hàng chính hãng",102000,200000,98000,49
TIKI,nha-cua-doi-song,132011833,"[VIDEO]-Bộ 6 túi lưới giặt đồ polyester 3 lớp cao cấp bảo vệ quần áo 6 size khác nhau",233000,245700,12700,5
TIKI,nha-cua-doi-song,186286485,"Ủng Bọc Giày Đi Mưa Cổ Cao Trong Suốt Có Dây Khóa Kéo Chống Bẩn, Chống Thấm",54999,54999,0,0
TIKI,nha-cua-doi-song,67879546,"Giỏ sọt canvas cỡ lớn phong cách Zakka, Bohemian vải chống thấm đựng đồ giặt, quần áo bẩn, giỏ đựng đồ chơi đồ dùng đa năng sang trọng - Hàng chính hãng",180000,180000,0,0
TIKI,nha-cua-doi-song,2226247,"Decal dán tường hàng rào động vật cho bé ZOOYOO XL7181",39900,70000,30100,43
TIKI,nha-cua-doi-song,194570336,"Túi Đựng Đồ Lót Treo Tủ 2 Mặt, 30 Ngăn Tiết Kiệm Không Gian",37050,39000,1950,5
TIKI,nha-cua-doi-song,104681154,"Khăn Lau Sợi Tre MyJae Lau Bếp, Lau Tay Đa Năng Hút Nước Tốt 2 Mặt Có Móc Treo 30cm x 42cm",49000,99000,50000,51
TIKI,nha-cua-doi-song,70840667,"Pin Energizer Specialty ECR2032 Vỉ 1 Viên",23000,23000,0,0
TIKI,nha-cua-doi-song,50434921," Combo khuyến mãi đặc biệt khi mua đàn Ukulele Concert Woim 33A19 cao cấp - Mua 1 tặng 7",570000,570000,0,0
TIKI,nha-cua-doi-song,247652614,"Đũa Gỗ Cẩm Cẩn Dây Đàn - Đồ Gỗ Nhà Bếp Thương Hiệu Trường Sơn ( 10 Đôi )",53100,59000,5900,10
TIKI,nha-cua-doi-song,21260228,"Combo 4 móc treo dán tường chịu lực inox 304 có sẵn keo dán Hobby Home Decor V35 không rỉ sét dán gạch men kính",118000,120000,2000,2
TIKI,nha-cua-doi-song,143713990,"Hạt giống Hoa Lưu Ly nhiều màu VTS188",15900,15900,0,0
TIKI,nha-cua-doi-song,34500805,"Móc treo quần áo 7 chấu inox 304 Kibath MS-GNL",250000,250000,0,0
TIKI,nha-cua-doi-song,4438483,"Combo 2 nắp đậy dùng cho lò vi sóng nội địa Nhật Bản",76500,76500,0,0
TIKI,nha-cua-doi-song,3709213,"Sơn Xịt ATM A200  ( Màu Trắng )",36000,36000,0,0
TIKI,nha-cua-doi-song,75706283,"Phễu thoát sàn ngăn mùi Inox 304 có lỗ thoát nước máy giặt",89000,89000,0,0
TIKI,nha-cua-doi-song,718856,"Túi Rác Dây Rút - Size L ( 20 Cái/ túi )",125000,125000,0,0
TIKI,nha-cua-doi-song,274173870,"Kính Bảo Hộ Chống Hóa Chất 3M 1621/ 1621AF - Thiết Kế Đeo Ngoài Kính Cận, Chống Bụi, Văng Bắn",70000,70000,0,0
TIKI,nha-cua-doi-song,40566158,"Pin Maxell LR44",60000,60000,0,0
TIKI,nha-cua-doi-song,166300860,"Dụng Cụ Dàn Đều Cà Phê | Tamper OCD 51, 53, 58MM",360000,360000,0,0
TIKI,nha-cua-doi-song,4298679,"Combo 10 miếng dán treo móc đồ chắc khỏe",25000,35000,10000,29
TIKI,nha-cua-doi-song,263273757,"Vỉ Gỗ Lót Sàn Ban Công Thương Hiệu ANKAN Gu Màu Đen 12 Nan, Ván Lót Sàn Gỗ Tự Nhiên Dùng Để Lót Sân Vườn, Hồ Bơi, Phòng Spa, Siêu Bền, Chịu Nước Tốt, Chống Trơn Trượt, Tiêu Chuẩn Xuất Khẩu",259000,315000,56000,18
TIKI,nha-cua-doi-song,74008888,"Đui đèn cảm biến chuyển động - ánh sáng Rạng Đông",170720,213400,42680,20
TIKI,nha-cua-doi-song,26182729,"Nhang Sen Hương Tràm Liên Tâm 20.5cm 160 cây - Thanh lọc, diệt khuẩn, 100% Từ Lá Tràm tự nhiên",79500,79500,0,0
TIKI,nha-cua-doi-song,111472732,"Móc Dán Tường Chịu Lực SENNAI, Móc Inox 304, Móc Treo Đồ Nhà Bếp Đa Năng",35000,35000,0,0
TIKI,nha-cua-doi-song,518861,"Kệ Dép Lưới Lớn 3 Tầng Duy Tân (47 x 19 x 54 cm) - Màu Ngẫu Nhiên",65000,65000,0,0
TIKI,nha-cua-doi-song,15264661,"Chân Đế Kẹp Micro Để Bàn Alctron SM316 AZONE",179000,185000,6000,3
TIKI,nha-cua-doi-song,178827552,"(Tiện Dụng) Khay Lọc Rác Mỏ Vịt KHONCC Hàng Chính Hãng - Gắn Vòi Rửa Bát , Bồn Rửa Chén Hình Thiên Nga Đa Năng - NTM-LRHTN (Nhiều Màu)",4900,9800,4900,50
TIKI,nha-cua-doi-song,113175147,"Đèn Bàn Học Chống Cận Rạng Đông RL 20 LED 6W, Phím Cảm Ứng, Đổi 4 Màu và 3 Mức Độ Sáng",250000,250000,0,0
TIKI,nha-cua-doi-song,16196295,"Lõi lọc số 1 (lõi PP) 20 inch Yamato",44000,65000,21000,32
TIKI,nha-cua-doi-song,74226890,"Bóng đèn LED nến 4.5W đui đèn E14 PARATHOM DIM CLASSIC B40 DIMMABLE OSRAM - Ánh sáng (Vàng 2700K)",161000,161000,0,0
TIKI,nha-cua-doi-song,78916183,"Tủ Giày Thông Minh Multi 4F Phong Cách Nordic Hiện Đại Thương Hiệu IGA - GP108",779000,848000,69000,8
TIKI,nha-cua-doi-song,57518159,"Cốc nhựa Folio có quai 310ml - Hàng nội địa Nhật Bản",31500,31500,0,0
TIKI,nha-cua-doi-song,217511597,"Tủ Quần Áo IGA Shelf Phong Cách Nordic - GP129",1452000,1600000,148000,9
TIKI,nha-cua-doi-song,10817885,"Hộp 2 Lọ Tinh Dầu Đuổi Muỗi nội địa Nhật Bản",166000,179000,13000,7
TIKI,nha-cua-doi-song,8046454,"Kéo Tỉa Cành BARNEL Có Răng Cưa 1010L",889000,889000,0,0
TIKI,nha-cua-doi-song,141816133,"Bàn nâng hạ chiều cao công thái học iCockpit EL05 1460. Phiên bản nâng cấp 2024 tặng kèm thảm lót chuột, móc treo tai nghe và giá để ly nước",2659000,5500000,2841000,52
TIKI,dien-thoai-may-tinh-bang,184036446,"Apple iPhone 11",8250000,12990000,4740000,36
TIKI,dien-thoai-may-tinh-bang,184059211,"Apple iPhone 13",14060000,25990000,11930000,46
TIKI,dien-thoai-may-tinh-bang,183330021,"Apple iPad 10.2-inch (9th Gen) Wi-Fi 2021",6990000,10990000,4000000,36
TIKI,dien-thoai-may-tinh-bang,120295859,"Điện Thoại Nokia C30 (2GB/32GB) - Hàng Chính Hãng",1490000,1990000,500000,25
TIKI,dien-thoai-may-tinh-bang,135332196,"Điện Thoại Nokia C20 2GB/16GB - Hàng Chính Hãng",1050000,2290000,1240000,54
TIKI,dien-thoai-may-tinh-bang,204237269,"Điện Thoại Bàn Panasonic KX-TSC11 - Hàng Chính Hãng",620000,620000,0,0
TIKI,dien-thoai-may-tinh-bang,201067649,"Combo máy đọc sách Kindle Paperwhite 5 (11th gen) tặng kèm bao da ( Cover ) - Hàng nhập khẩu",3890000,3890000,0,0
TIKI,dien-thoai-may-tinh-bang,181928208,"Điện thoại bàn Panasonic KX-TGC310 hàng chính hãng",1090000,1090000,0,0
TIKI,dien-thoai-may-tinh-bang,163914808,"Điện thoại bàn Panasonic  KX-TS500MX-hàng chính hãng",300000,300000,0,0
TIKI,dien-thoai-may-tinh-bang,11415485,"ĐIỆN THOẠI CỐ ĐỊNH PANASONIC KX-TS580MX",940000,940000,0,0
TIKI,dien-thoai-may-tinh-bang,181977398,"Điện thoại bàn Panasonic KX-TS880 hàng chính hãng",1090000,1090000,0,0
TIKI,dien-thoai-may-tinh-bang,184578632,"Điện thoại Itel it9010 4G - Hàng chính hãng",399000,399000,0,0
TIKI,dien-thoai-may-tinh-bang,121744434,"Điện Thoại Xiaomi Redmi 10 4GB/128GB - Hàng Chính Hãng",2879000,4290000,1411000,33
TIKI,dien-thoai-may-tinh-bang,189466001,"Điện thoại Xiaomi Redmi 10A (2GB/32GB) - Hàng chính hãng",1899000,2890000,991000,34
TIKI,dien-thoai-may-tinh-bang,139632023,"Máy đọc sách Kobo Libra 2 - hàng nhập khẩu",5586000,5999999,413999,7
TIKI,dien-thoai-may-tinh-bang,197666071,"Điện thoại Masstel Fami 65 4G - Tặng dock sạc - Gọi HD Call - Hàng chính hãng",655000,900000,245000,27
TIKI,dien-thoai-may-tinh-bang,125182567,"Máy đọc sách All New Kindle Paperwhite 5 (11th Gen) - Hàng nhập khẩu",4040000,4590000,550000,12
TIKI,dien-thoai-may-tinh-bang,11251951,"Điện thoại bàn không dây Panasonic KX-TGB110-Hàng Chính Hãng",830000,830000,0,0
TIKI,dien-thoai-may-tinh-bang,197652030,"Điện thoại Masstel Lux 20 4G - Sang trọng - Gọi HD Call - Hàng chính hãng",579000,800000,221000,28
TIKI,dien-thoai-may-tinh-bang,118486668,"Máy đọc sách Kobo Elipsa - Hàng nhập khẩu",12000000,12000000,0,0
TIKI,dien-thoai-may-tinh-bang,226552005,"Điện thoại bàn Panasonic KX-TSC11 hàng chính hãng",600000,600000,0,0
TIKI,dien-thoai-may-tinh-bang,168526284,"Điện thoại Nokia 105 4G - Hàng chính hãng",769000,769000,0,0
TIKI,dien-thoai-may-tinh-bang,170448099,"Điện Thoại Người Già Masstel Fami 60 4G - Loa To, FM Không Dây, Đọc Số Bằng Giọng Nói, SOS, Đèn Pin Kép,... Hàng Chính Hãng",682000,882000,200000,23
TIKI,dien-thoai-may-tinh-bang,4048581,"Điện Thoại Bàn Panasonic KX-TSC11",669000,689000,20000,3
TIKI,dien-thoai-may-tinh-bang,181266509,"Điện thoại Ulefone Armor 14 pro (chống nước,chống va đập,pin khủng,pin 10.000mAh,Ram 8Gb,Rom 128Gb)- hàng chính hãng",5990000,5990000,0,0
TIKI,dien-thoai-may-tinh-bang,170165701,"Điện thoại bàn Ktel 645 hàng chính hãng",430000,430000,0,0
TIKI,dien-thoai-may-tinh-bang,125590981,"Điện thoại Nokia C30 2GB/32GB - Hàng chính hãng",1550000,1550000,0,0
TIKI,dien-thoai-may-tinh-bang,126050455,"Điện thoại Nokia C20 (2GB/16GB) - Hàng Chính Hãng",1189000,2290000,1101000,48
TIKI,dien-thoai-may-tinh-bang,181452535,"Điện thoại Itel it9200 4G - WIFI - Xem YTB , FB - Hàng chính hãng",559000,790000,231000,29
TIKI,dien-thoai-may-tinh-bang,11251735,"Điện thoại bàn không dây Panasonic KX-TGC312 - Hàng chính hãng",1750000,1750000,0,0
TIKI,dien-thoai-may-tinh-bang,181918564,"Điện thoại OUKITEL WP16 (pin 10.600mAh,  Ram 8Gb,Rom 128Gb, màn hình 6,39 in , Android 11, Máy ảnh nhìn ban đêm 20MP, chống nước IP68,chống va đập, hai SIM 4G, NFC..) – hàng chính hãng",5990000,5990000,0,0
TIKI,dien-thoai-may-tinh-bang,16521748,"Điện thoại để bàn Panasonic KX-TS880 hàng chính hãng",1150000,1150000,0,0
TIKI,dien-thoai-may-tinh-bang,167466044,"Điện thoại Masstel FAMI 60 4G Pin 2000 mah - Hàng chính hãng",649000,750000,101000,13
TIKI,dien-thoai-may-tinh-bang,167465972,"Điện thoại Masstel IZI 55 4G , Pin 1800mah - Hàng chính hãng",465000,699000,234000,33
TIKI,dien-thoai-may-tinh-bang,167465704,"Điện thoại Masstel IZI 20 4G , Pin 1700 mAh - Hàng chính hãng",399000,499000,100000,20
TIKI,dien-thoai-may-tinh-bang,140184098,"Điện Thoại Vsmart Bee Lite 2GB/16GB - Hàng Chính Hãng",964000,1990000,1026000,52
TIKI,dien-thoai-may-tinh-bang,117929342,"Điện thoại Panasonic KX-TSC11MX -Hàng chính hãng",599000,599000,0,0
TIKI,dien-thoai-may-tinh-bang,29931445,"Ulefone Armor X 5 ( chống nước,chống va đập,pin 5.000mAh ) hàng chính hãng",3590000,3590000,0,0
TIKI,dien-thoai-may-tinh-bang,140940220,"Máy đọc sách Kobo Sage - hàng nhập khẩu",7390000,8679000,1289000,15
TIKI,dien-thoai-may-tinh-bang,125753416,"Điện thoại Nokia 110 4G - Hàng chính hãng",740000,740000,0,0
TIKI,dien-thoai-may-tinh-bang,176909016,"Máy tính bảng HANET Smart Edu Tablet Model T432 - Hàng Chính Hãng",3300000,3300000,0,0
TIKI,dien-thoai-may-tinh-bang,162866839,"Máy tính bảng VNPT Technology VNT Tab8 Plus 8 Inch Android 11 RAM 4GB - Hàng chính hãng",3146000,3146000,0,0
TIKI,dien-thoai-may-tinh-bang,155833852,"Điện Thoại Masstel Hapi 30 3GB/32GB - Hàng Chính Hãng",1469000,2390000,921000,39
TIKI,dien-thoai-may-tinh-bang,11251770,"Điện thoại bàn không dây Panasonic KX-TGD310 - Hàng Chính Hãng",1340000,1340000,0,0
TIKI,dien-thoai-may-tinh-bang,192694043,"Điện thoại để bàn Panasonic KX-TS880 hàng chính hãng",1060000,1060000,0,0
TIKI,dien-thoai-may-tinh-bang,143359355,"Điện Thoại Tecno Spark 6 Go 4GB/64GB - Hàng Chính Hãng",2069000,2990000,921000,31
TIKI,dien-thoai-may-tinh-bang,125753291,"Điện thoại Nokia 105 4G - Hàng chính hãng",629000,629000,0,0
TIKI,dien-thoai-may-tinh-bang,160450655,"Điện Thoại Masstel Tab 10A 3GB/32GB - Hàng Chính Hãng",2351000,3790000,1439000,38
TIKI,dien-thoai-may-tinh-bang,84757299,"Điện thoại Itel it9200 4G - Hàng chính hãng",700000,700000,0,0
TIKI,dien-thoai-may-tinh-bang,72310352,"Máy tính bảng Vankyo MatrixPad Z10 - Hàng Chính Hãng",2990000,2990000,0,0
TIKI,dien-thoai-may-tinh-bang,197651936,"Điện thoại Masstel Izi 25 4G Pin siêu khỏe, Gọi HD call- Hàng chính hãng",599000,599000,0,0
TIKI,dien-thoai-may-tinh-bang,196193895,"Điện Thoại di động vivo Y16 (4GB/128GB) - Hàng Chính Hãng",3290000,4490000,1200000,27
TIKI,dien-thoai-may-tinh-bang,147969070,"Điện thoại thông minh itel A26 - giá rẻ | 2 Sim 2 Sóng 4G LTE | Màn hình IPS 5.7" HD+ | RAM 2GB + ROM 32 GB (Hỗ trợ thẻ nhớ 32 GB) | Mở khoá bằng Gương Mặt | Chính Hãng bảo hành 12 tháng| 1 đổi 1 trong 30 ngày",2390000,2390000,0,0
TIKI,dien-thoai-may-tinh-bang,23142193,"Điện thoại bàn không dây Panasonic KX-TGC313 - Hàng Chính Hãng",2250000,2250000,0,0
TIKI,dien-thoai-may-tinh-bang,181216830,"Điện thoại ZTE Blade V40 Vita (ZTE 8045) - MH giọt nước HD+ 6.75" - Pin 6000 mAh sạc nhanh 22.5W -  Bộ nhớ mở rộng (4+2)GB - Hàng chính hãng",4290000,4290000,0,0
TIKI,dien-thoai-may-tinh-bang,157835051,"Điện Thoại Để Bàn Panasonic KX-TS500MX - Hàng Chính Hãng",380000,380000,0,0
TIKI,dien-thoai-may-tinh-bang,140747649,"Điện thoại Realme C11 2021 (4GB/64GB) - Hàng chính hãng",2690000,3790000,1100000,29
TIKI,dien-thoai-may-tinh-bang,158895857,"Điện thoại Vivo Y33s (8GB/128GB) - Hàng chính hãng",5990000,5990000,0,0
TIKI,dien-thoai-may-tinh-bang,29440849,"điện thoại  IP622C - hàng chính hãng",1650000,1650000,0,0
TIKI,dien-thoai-may-tinh-bang,118102328,"Điện thoại Panasonic KX-TGC310CX -Hàng chính hãng",1029000,1029000,0,0
TIKI,dien-thoai-may-tinh-bang,140144656,"Điện thoại Realme C25Y (4GB/128GB) - Hàng chính hãng",3529000,4990000,1461000,29
TIKI,dien-thoai-may-tinh-bang,91281318,"Máy Đọc Sách Likebook P10 - Hàng chính hãng",9090000,9090000,0,0
TIKI,dien-thoai-may-tinh-bang,23865953,"Điện Thoại Để Bàn Panasonic KX-TS500MX - Hàng Chính Hãng",310000,310000,0,0
TIKI,dien-thoai-may-tinh-bang,174085242,"Điện Thoại Cho Người Già Masstel Fami 12 4G - Viền Kim Loại, Ăng Ten FM Không Dây - Hàng Chính Hãng",589000,699000,110000,16
TIKI,dien-thoai-may-tinh-bang,156222386,"Điện thoại Panasonic KX-TS520MX -Hàng chính hãng",450000,450000,0,0
TIKI,dien-thoai-may-tinh-bang,118103703,"Điện thoại Panasonic KX-TGC312CX -Hàng chính hãng",1599000,1599000,0,0
TIKI,dien-thoai-may-tinh-bang,125171841,"Điện Thoại Bàn Panasonic KX-TSC11 - Hàng Chính Hãng",620000,620000,0,0
TIKI,dien-thoai-may-tinh-bang,170727305,"Điện thoại bàn Panasonic KX-TS580 hàng chính hãng",999000,999000,0,0
TIKI,dien-thoai-may-tinh-bang,113475741,"Điện thoại Panasonic KX-TS520MX - Trắng - Hàng chính hãng",450000,450000,0,0
TIKI,dien-thoai-may-tinh-bang,170165658,"Điện thoại bàn Ktel 303 hàng chính hãng",400000,400000,0,0
TIKI,dien-thoai-may-tinh-bang,4048043,"Điện Thoại Bàn Panasonic KX-TS500",339000,370000,31000,8
TIKI,dien-thoai-may-tinh-bang,117347869,"ĐIỆN THOẠI HỘI NGHỊ YEALINK CP960 -HÀNG CHÍNH HÃNG",15230000,15230000,0,0
TIKI,dien-thoai-may-tinh-bang,94453667,"Điện thoại VoIP Yealink SIP-T30",1050000,1050000,0,0
TIKI,dien-thoai-may-tinh-bang,14508445,"Điện thoại Ip phone Cisco CP-7841-K9 chính hãng",4200000,4200000,0,0
TIKI,dien-thoai-may-tinh-bang,117929538,"Điện thoại Panasonic KX-TS560MX -Hàng chính hãng",699000,699000,0,0
TIKI,dien-thoai-may-tinh-bang,11376644,"Điện thoại bàn có dây Panasonic KX-TS560MX",730000,730000,0,0
TIKI,dien-thoai-may-tinh-bang,31820638,"Điện Thoại Bàn Panasonic KX-TS500MX - Panasonic KX-TS500MX Integrated Telephone System - Hàng chính hãng",310000,310000,0,0
TIKI,dien-thoai-may-tinh-bang,72310420,"Máy tính bảng VANKYO MatrixPad S30 - Hàng Chính Hãng",3090000,3090000,0,0
TIKI,dien-thoai-may-tinh-bang,15428119,"Điện thoại Ip phone Cisco CP-7945G chính hãng",4500000,4500000,0,0
TIKI,dien-thoai-may-tinh-bang,52326343,"Cisco Unified IP Phone CP-7821-K9 - Hàng chính hãng",2580000,2580000,0,0
TIKI,dien-thoai-may-tinh-bang,172537996,"(Hàng chính hãng) Điện thoại bàn hữu tuyến H2P, hiệu Alcatel - Lucent",2220000,2220000,0,0
TIKI,dien-thoai-may-tinh-bang,224873580,"Điện thoại Masstel izi 26 - Hàng chính hãng ",600000,600000,0,0
TIKI,dien-thoai-may-tinh-bang,215097578,"Điện Thoại Di Động Forme D666 4G - Hàng Chính Hãng",650000,650000,0,0
TIKI,dien-thoai-may-tinh-bang,271290719,"Điện Thoại Cho Người Già Masstel Fami 65 - SOS, Loa To, FM Không Dây, Đọc Số Bằng Giọng Nói, Xem Lịch Âm - HÀNG CHÍNH HÃNG",689000,999000,310000,31
TIKI,dien-thoai-may-tinh-bang,262908601,"Máy tính bảng chắc chắn oukitel RT3 (chống nước,chống va đập,Ram 4Gb,Rom 64 Gb,màn hình 8 inch,pin 5150 mAh)- hÀng chính hãng",4990000,4990000,0,0
TIKI,dien-thoai-may-tinh-bang,273366296,"ulefone Armor 24 (TIÊU CHUẨN MIL-STD-810H ,IP69K, chống nước ,chống sốc,pin 22000mah , màn hình6,78 inch, NFC, Ram24GB(12Gb+12Gb),rom 256GB)-hàng chính hãng ",7990000,7990000,0,0
TIKI,dien-thoai-may-tinh-bang,271822675,"Máy Tính Bảng Samsung Galaxy Tab A8 - Hàng Chính Hãng",5856000,5856000,0,0
TIKI,dien-thoai-may-tinh-bang,274378214,"Điện thoại Ulefone Note 17 Pro(Ram 12Gb,Rom 256Gb,Android 13,camera 108MP, MediaTek Helio G99,sạc nhanh 33W,Màn hình AMOLED 6.78 inch,pin 5.050mAh)- hàng chính hãng",7490000,7490000,0,0
TIKI,dien-thoai-may-tinh-bang,247730209,"Điện thoại Samsung Galaxy A34 5G (8GB/128GB) - Hàng chính hãng",7164000,7164000,0,0
TIKI,dien-thoai-may-tinh-bang,249890023,"Điện Thoại Xiaomi Redmi Note 12 Pro 5G 8GB/256GB - Hàng Chính Hãng",9000000,9000000,0,0
TIKI,dien-thoai-may-tinh-bang,252884859,"Tay con điện thoại bàn Panasonic TGDA30-hàng chính hãng",990000,990000,0,0
TIKI,dien-thoai-may-tinh-bang,197902452,"Điện thoại Masstel Lux 20 4G dành cho người lớn tuổi - Hàng chính hãng, Nguyên Seal",790000,790000,0,0
TIKI,dien-thoai-may-tinh-bang,213931247,"Điện thoại Samsung Galaxy A04 (3GB / 32GB) - Hàng chính hãng - Mới 100% Nguyên Seal - Pin Khủng 5000 mAh - Bảo Hành 12 Tháng",2400000,2400000,0,0
TIKI,dien-thoai-may-tinh-bang,252073075,"Điện thoại Masstel IZI11 4G - Hàng Chính Hãng",468000,468000,0,0
TIKI,dien-thoai-may-tinh-bang,249730344,"Điện thoại Masstel IZI 12 4G LTE - 2 Sim 2 Sóng - Pin 1000 mAh - Loa to - Hàng Chính Hãng - Bảo Hành 12 Tháng",456000,456000,0,0
TIKI,dien-thoai-may-tinh-bang,247299188,"Điện thoại Tecno Spark Go 2023 4GB/64GB - Hàng chính hãng",2199000,3290000,1091000,33
TIKI,dien-thoai-may-tinh-bang,252865847,"Điện thoại di động Forme Q8 (4G) - Hàng chính hãng",599000,599000,0,0
TIKI,dien-thoai-may-tinh-bang,251772653,"Điện thoại Masstel izi 56 4G (pin trâu-loa chữ to rõ) - Hàng Chính Hãng",687000,687000,0,0
TIKI,dien-thoai-may-tinh-bang,273373420,"Điện thoại Xiaomi Redmi 13C (4GB/128GB) - Hàng chính hãng - Bảo hành 18 tháng",2699000,3090000,391000,13
TIKI,dien-thoai-may-tinh-bang,249168949,"Điện thoại Samsung Galaxy A34 5G 8GB/128GB Bạc - Hàng chính hãng",7164000,7164000,0,0
TIKI,dien-thoai-may-tinh-bang,249178196,"Điện thoại Samsung Galaxy A34 5G 8GB/128GB Xanh - Hàng chính hãng",7164000,7164000,0,0
TIKI,dien-thoai-may-tinh-bang,261965186,"Điện Thoại Xiaomi Redmi Note 12S (8GB/256GB) - Hàng Chính Hãng",6132000,6132000,0,0
TIKI,dien-thoai-may-tinh-bang,53380152,"Điện Thoại IP Phone Fanvil X1S - Hàng Chính Hãng",950000,950000,0,0
TIKI,dien-thoai-may-tinh-bang,11251743,"Điện thoại bàn không dây Panasonic KX-TGB112 - Hàng Chính Hãng",1260000,1260000,0,0
TIKI,dien-thoai-may-tinh-bang,204671569,"Điện Thoại Oppo A17k 3GB/64GB - Hàng Chính Hãng",2499000,3290000,791000,24
TIKI,dien-thoai-may-tinh-bang,121059239,"Máy Tính Bảng Samsung Galaxy Tab A7 Lite T225 3GB/32GB - Hàng Chính Hãng",3300000,3300000,0,0
TIKI,dien-thoai-may-tinh-bang,274959114,"Điện thoại Tecno CAMON 20 Pro 8GB/256GB - Hàng Chính Hãng",4250000,5490000,1240000,23
TIKI,dien-thoai-may-tinh-bang,274116886,"Điện Thoại Xiaomi Redmi A2+ 3GB/64GB - Hàng Chính Hãng",1999000,2790000,791000,28
TIKI,dien-thoai-may-tinh-bang,273685412,"Điện thoại Samsung Galaxy A25 5G (6GB/128GB) - Hàng chính hãng",5539000,6590000,1051000,16
TIKI,dien-thoai-may-tinh-bang,217706932,"Combo Máy đọc sách All New Kindle Paperwhite 5 (11th Gen) và Bao da - Hàng nhập khẩu",4080000,4190000,110000,3
TIKI,dien-thoai-may-tinh-bang,273640492,"Điện Thoại Samsung Galaxy A05 (6GB/128GB) - Hàng Chính Hãng",3450000,3450000,0,0
TIKI,dien-thoai-may-tinh-bang,274019932,"Điện thoại Masstel Izi 56 4G (LTE) Gọi HD Call ,Pin khủng ,loa lớn - Hàng Chính Hãng",545000,650000,105000,16
TIKI,dien-thoai-may-tinh-bang,181928189,"Điện thoại bàn Panasonic KX-TGC312 hàng chính hãng",1690000,1690000,0,0
TIKI,dien-thoai-may-tinh-bang,275362333,"Điện thoại Samsung Galaxy M15 5G - Hàng chính hãng",4319000,4690000,371000,8
TIKI,dien-thoai-may-tinh-bang,274440344,"Điện thoại Xiaomi Redmi Note 13 pro (8GB - 128GB) hàng chính hãng - Bảo hành 18 tháng",6089000,6790000,701000,10
TIKI,dien-thoai-may-tinh-bang,271087979,"Điện thoại OPPO A58 (6GB/128GB) - Hàng Chính Hãng",4459000,4990000,531000,11
TIKI,dien-thoai-may-tinh-bang,204872160,"Điện thoại Oppo A17k (3GB/64GB) - Hàng chính hãng",2629000,3290000,661000,20
TIKI,dien-thoai-may-tinh-bang,273411988,"Điện thoại Xiaomi Redmi 13C (6+128GB) | 6.74" 90Hz| Media Tek Helio G85| 5000mAh - Hàng chính hãng",2979000,3490000,511000,15
TIKI,dien-thoai-may-tinh-bang,275510578,"Điện thoại OPPO A79 5G (8GB/256GB) - Hàng Chính Hãng",7450000,7490000,40000,1
TIKI,dien-thoai-may-tinh-bang,270510406,"Điện thoại Vivo Y36 (8GB/128GB) - Hàng Chính Hãng - Camera 50MP - Sạc Nhanh 44W",4990000,5190000,200000,4
TIKI,dien-thoai-may-tinh-bang,271235147,"Điện thoại Oppo A58 (6GB/128GB) - Hàng chính hãng",4199000,4990000,791000,16
TIKI,dien-thoai-may-tinh-bang,275295008,"Máy tính bảng cho trẻ em chống sốc 7 inch TEKKIN TI-868 cpu 4 nhân 2gb 32gb - hàng nhập khẩu",1100000,1100000,0,0
TIKI,dien-thoai-may-tinh-bang,275585819,"Máy tính bảng Máy tính bảng Alcatel Tab 3T8 (2GB/32GB) - Hàng chính hãng",890000,1290000,400000,31
TIKI,dien-thoai-may-tinh-bang,274568845,"Điện thoại Xiaomi 14 5G (12GB/256GB) - Hàng chính hãng",19899000,22990000,3091000,13
TIKI,dien-thoai-may-tinh-bang,160434731,"Máy Tính Bảng Samsung Galaxy Tab A8 4GB/64GB - Hàng Chính Hãng",5856000,5856000,0,0
TIKI,dien-thoai-may-tinh-bang,249955152,"Điện thoại Xiaomi Redmi Note 12 Pro 5G (8GB/256GB) - Hàng chính hãng",7790000,9490000,1700000,18
TIKI,dien-thoai-may-tinh-bang,270707514,"Máy Đọc Sách BOOX Tab Mini C - Hàng Chính Hãng",11750000,12990000,1240000,10
TIKI,dien-thoai-may-tinh-bang,274536294,"Máy đọc sách Kindle Paperwhite 5 (16GB) - Đen - Hàng chính hãng",4000000,4990000,990000,20
TIKI,dien-thoai-may-tinh-bang,274544634,"Điện thoại Redmi Note 12R 5G 6/128GB Snapdragon 4 Gen 2, Rom Quốc tế có sẳn Tiếng việt - Hàng nhập khẩu",3099000,3590000,491000,14
TIKI,dien-thoai-may-tinh-bang,242434782,"Máy đọc sách New Kindle 11th 2022 (16GB) - Hàng nhập khẩu",3080000,3290000,210000,6
TIKI,dien-thoai-may-tinh-bang,271218081,"Máy đọc sách Kindle Oasis Edition 3 (8GB) - Hàng chính hãng",6100000,7690000,1590000,21
TIKI,dien-thoai-may-tinh-bang,273258830,"Điện thoại Samsung Galaxy A05 (4GB/128GB) - Đã kích hoạt bảo hành điện tử -Hàng chính hãng",2490000,3050000,560000,18
TIKI,dien-thoai-may-tinh-bang,274840015,"Máy tính bảng Samsung Galaxy Tab S9 FE Wifi 8GB/256GB - Hàng chính hãng",10990000,11990000,1000000,8
TIKI,dien-thoai-may-tinh-bang,197214029,"Apple iPhone 14",16490000,24990000,8500000,34
TIKI,dien-thoai-may-tinh-bang,270794184,"Máy đọc sách Kobo Clara (Clara Colour, Clara BW, Clara 2e, Clara HD) - 6inch, 16gb - Hàng Chính Hãng",4199000,4290000,91000,2
TIKI,dien-thoai-may-tinh-bang,273942001,"Điện thoại Xiaomi Redmi Note 13 (6GB/128GB) - Hàng chính hãng",4090000,4490000,400000,9
TIKI,dien-thoai-may-tinh-bang,275510579,"Điện thoại OPPO Reno12F 5G (8GB/256GB) - Hàng Chính Hãng",9450000,9490000,40000,0
TIKI,dien-thoai-may-tinh-bang,274374725,"Điện thoại Samsung Galaxy S24 Ultra 5G 256GB - Hàng Chính Hãng",26260000,31490000,5230000,17
TIKI,dien-thoai-may-tinh-bang,274868116,"Máy tính bảng Samsung Galaxy Tab A9+ 5G 8GB/128GB - Hàng chính hãng",7990000,8490000,500000,6
TIKI,dien-thoai-may-tinh-bang,274840632,"Điện thoại Xiaomi Redmi A3 - Hàng chính hãng",2419000,2890000,471000,16
TIKI,dien-thoai-may-tinh-bang,273897590,"Điện thoại Tecno SPARK 20c (8+8)GB/128GB - MTK G36 | 5000 mAh | Sạc nhanh 18W | Hàng Chính Hãng",2449000,2690000,241000,9
TIKI,dien-thoai-may-tinh-bang,173387789,"Máy đọc sách All New Kindle Oasis 3 - Hàng nhập khẩu",6590000,6590000,0,0
TIKI,dien-thoai-may-tinh-bang,273359059,"Điện Thoại Chắc Chắn OUKITEL WP23 PRO ( Ram 16Gb(8GB+8Gb),Rom 128GB ,Android13, Pin 10600mAh,Màn hình 6.52 "HD + ,13MP camera Sau,chống nước,chống va đập)-hàng chính hãng",4990000,4990000,0,0
TIKI,dien-thoai-may-tinh-bang,274959690,"Điện thoại Tecno SPARK GO 4GB/64GB - Hàng chính hãng",1890000,2190000,300000,14
TIKI,dien-thoai-may-tinh-bang,274506430,"Điện thoại Xiaomi Redmi A2+ (3GB/64GB) - Hàng chính hãng",2139000,2790000,651000,23
TIKI,dien-thoai-may-tinh-bang,274946446,"Điện Thoại POCO X6 5G (8GB/256GB) - Hàng Chính Hãng",6750000,8490000,1740000,20
TIKI,dien-thoai-may-tinh-bang,217158870,"Máy tính bảng Samsung Galaxy Tab A8 (4GB/64GB) - Hàng Chính Hãng",5856000,5856000,0,0
TIKI,dien-thoai-may-tinh-bang,258787119,"Máy tính bảng OUKITEL RT2 chắc chắn (chống nước,chống va đập ,pin xài lâu,Pin  20.000Mah, Màn hình  10,1 inch,Ram 8GB,Rom  128 GB, lõi tám nhân,Máy ảnh 16MP,Android 12,sạc nhanh 33W)- hàng chính hãng",9990000,9990000,0,0
TIKI,dien-thoai-may-tinh-bang,275349801,"Điện thoại Xiaomi Redmi 13C (8GB/256GB) - Hàng chính hãng",3290000,3990000,700000,18
TIKI,dien-thoai-may-tinh-bang,274101262,"Máy Tính Bảng Samsung Galaxy Tab A9 Plus Wifi 4GB/64GB - Hàng Chính Hãng",3890000,5990000,2100000,35
TIKI,dien-thoai-may-tinh-bang,274989836,"Điện thoại Tecno SPARK 10 Pro 8GB/128GB  Hàng chính hãng",2590000,2990000,400000,13
TIKI,dien-thoai-may-tinh-bang,274610468,"Điện thoại Samsung Galaxy S24 8GB/512GB - Độc quyền Online - Hàng chính hãng",25485000,26490000,1005000,4
TIKI,dien-thoai-may-tinh-bang,275504632,"Điện thoại Samsung Galaxy Z Flip 6 (8GB/256GB) - Độc quyền online - Hàng chính hãng",28985000,28990000,5000,0
TIKI,dien-thoai-may-tinh-bang,193366048,"Điện thoại OnePlus 10T 5G - Hàng Chính Hãng",15990000,15990000,0,0
TIKI,dien-thoai-may-tinh-bang,275543373,"Điện thoại Samsung Galaxy Z Fold 6 12GB/512GB - Độc quyền online - Hàng chính hãng",47985000,47990000,5000,0
TIKI,dien-thoai-may-tinh-bang,263438199,"Máy tính bảng Edutab 10.1 Pro & Case da tặng Hệ thống quản lý học tập & kiểm soát dành cho Phụ huynh trọn đời",4989000,4989000,0,0
TIKI,dien-thoai-may-tinh-bang,252428990,"Điện thoại Tecno SPARK 10 Pro 8GB/256GB - Helio G88 | 5000 mAh | Sạc nhanh 18W | Cảm ứng vân tay - Hàng chính hãng",3079000,4490000,1411000,31
TIKI,dien-thoai-may-tinh-bang,274191773,"Điện thoại ZTE Libero 5G IV - 4GB/128GB Dimensity 700 , Kháng nước IP67 , Sạc nhanh 22,5W - Mới nguyên seal - Hàng nhập khẩu",2259000,2990000,731000,24
TIKI,dien-thoai-may-tinh-bang,198868735,"Điện thoại IP Grandstream GRP 2601 hàng chính hãng",880000,880000,0,0
TIKI,dien-thoai-may-tinh-bang,260406257,"Điện thoại oukitel wp23 ( chống nước,chống va đập,pin 10600mAh,Ram 4Gb.Rom 64Gb,màn hình 6.52 inch,mạng 2,3,4G,Android 13 )-hàng chính hãng",3990000,3990000,0,0
TIKI,dien-thoai-may-tinh-bang,212040689,"Điện Thoại Samsung Galaxy A04 (3GB/32GB) - Hàng Chính Hãng - Đã kích hoạt bảo hành điện tử",2400000,2400000,0,0
TIKI,dien-thoai-may-tinh-bang,274392442,"Điện thoại Oppo A38 - Hàng chính hãng",4389000,4990000,601000,12
TIKI,dien-thoai-may-tinh-bang,271134741,"Điện thoại Samsung Galaxy Z Flip5 (8GB/512GB) - Hàng chính hãng",16749000,29990000,13241000,44
TIKI,dien-thoai-may-tinh-bang,273430216,"Điện thoại Ulefone Armor 13 (pin khủng,pin 13.200mAh, Ram 8Gb,Rom 256Gb,chống sốc,chống va đập,nội soi,tia hồng ngoại,tia lade,loa to,học online)- hàng chính hãng",8980000,8980000,0,0
TIKI,dien-thoai-may-tinh-bang,220670303,"Yealink W73P - Điện thoại IP cầm tay không dây DECT - Hàng Chính Hãng - Điện thoại IP mẹ bồng con",2800000,2800000,0,0
TIKI,dien-thoai-may-tinh-bang,220678495,"Điện thoại bàn DECT không dây Yealink W73H có chân đế - Hàng chính hãng",2200000,2200000,0,0
TIKI,dien-thoai-may-tinh-bang,273232944,"Máy tính bảng Masstel Tab 10.4 - Hàng chính hãng",3990000,4990000,1000000,20
TIKI,dien-thoai-may-tinh-bang,274059475,"Điện Thoại Samsung Galaxy S24 Ultra (12GB/256GB) - Hàng Chính Hãng",25390000,33990000,8600000,25
TIKI,dien-thoai-may-tinh-bang,188948039,"Máy tính bảng Samsung Galaxy Tab A8 64GB Xám (2022) - Hàng Chính Hãng",5856000,5856000,0,0
TIKI,dien-thoai-may-tinh-bang,274516951,"Điện thoại Masstel izi 16 4G(LTE) , Bàn phím nổi, FM không dây - Hàng chính hãng",415000,499000,84000,17
TIKI,dien-thoai-may-tinh-bang,248185228,"Điện Thoại Masstel Lux 10 4G - Hàng Chính Hãng",675000,675000,0,0
TIKI,dien-thoai-may-tinh-bang,262516014,"Điện Thoại Samsung Galaxy A34 5G - Hàng Chính Hãng",7164000,7164000,0,0
TIKI,dien-thoai-may-tinh-bang,207268158,"Điện thoại Samsung Galaxy A04 (3G+32G) SM-A045F Đen - Hàng Chính Hãng (chỉ giao HN và một số khu vực)",2400000,2400000,0,0
TIKI,dien-thoai-may-tinh-bang,274507025,"Điện thoại Realme V50 5G 6GB/128GB ,CPU Dimensity 6100+ , Màn 120HZ , Rom Quốc tế có tiếng việt - Hàng nhập khẩu",2869000,3990000,1121000,28
TIKI,dien-thoai-may-tinh-bang,271982547,"Điện thoại Oukitel  WP12 Pro (chống nước,chống va đập,RAM 8GB(Ram 4GB+ 4Gb),Rom 64 Gb,8 nhân)- hÀng chính hãng",3590000,3590000,0,0
TIKI,dien-thoai-may-tinh-bang,271234577,"Điện Thoại Nokia 105 4G Pro - Hàng Chính Hãng",669000,680000,11000,2
TIKI,dien-thoai-may-tinh-bang,252073056,"Điện thoại Mobell M239 - Hàng chính hãng",404100,404100,0,0
TIKI,dien-thoai-may-tinh-bang,271798615,"Điện thoại thông minh siêu bền Oukitel WP28 (màn hình 6.52‘' ,HD+ ,pin 10600mAh ,Ram 15Gb(8GB+7Gb),Rom 256GB ,Android13, camera 48MP)-hàng chính hãng",4990000,4990000,0,0
TIKI,dien-thoai-may-tinh-bang,270832077,"Điện thoại Xiaomi Redmi 12 (4GB-128GB) - Hàng Chính Hãng",3890000,3890000,0,0
TIKI,dien-thoai-may-tinh-bang,275407523,"Máy đọc sách Pocketbook Era Color- Hàng chính hãng",7090000,7500000,410000,5
TIKI,dien-thoai-may-tinh-bang,271128271,"Điện Thoại Oppo A58 6GB/128GB - Hàng Chính Hãng",4069000,4990000,921000,18
TIKI,dien-thoai-may-tinh-bang,273718967,"Điện Thoại Samsung A15 8GB/128GB - Hàng Chính Hãng",4229000,4990000,761000,15
TIKI,dien-thoai-may-tinh-bang,25949745,"Máy Đọc Sách Kindle Oasis (10th Gen) 2019- 8GB - Hàng Chính Hãng",6790000,6790000,0,0
TIKI,dien-thoai-may-tinh-bang,274156763,"Điện Thoại Oppo A38 4GB/128GB - Hàng Chính Hãng",3869000,4490000,621000,14
TIKI,dien-thoai-may-tinh-bang,275588494,"Máy tính bảng 10.1 inch TEKKIN TI-8020 cpu 4 nhân 2.0ghz ram 8gb 64gb tặng bao da - hàng nhập khẩu",1750000,1750000,0,0
TIKI,dien-thoai-may-tinh-bang,274639670,"Điện thoại Realme V30 (V30T) 4GB/128GB Dimensity 700 - Rom tiếng việt - Hàng nhập khẩu",2539000,3590000,1051000,29
TIKI,dien-thoai-may-tinh-bang,197654695,"Điện thoại Masstel izi 26 4G - Gọi HD Call - Hàng chính hãng",600000,600000,0,0
TIKI,dien-thoai-may-tinh-bang,164697930,"Máy tính bảng Samsung Galaxy Tab A8  (2022) - Hàng chính hãng - ĐÃ KÍCH HOẠT BẢO HÀNH ĐIỆN TỬ",5856000,5856000,0,0
TIKI,dien-thoai-may-tinh-bang,275276075,"[MỚI] Điện thoại vivo Y17s - Hàng chính hãng - Camera 50MP - Pin 5000 mAh - Sạc nhanh- RAM mở rộng đến 8GB",3090000,3390000,300000,9
TIKI,dien-thoai-may-tinh-bang,43924153,"Máy đọc sách Kindle Oasis 3 (2019) - Amazon - Hàng nhập khẩu",6700000,6700000,0,0
TIKI,dien-thoai-may-tinh-bang,275386374,"Điện Thoại Oppo A60 8GB/128GB - Hàng Chính Hãng",5319000,5490000,171000,3
TIKI,dien-thoai-may-tinh-bang,274361820,"Máy Tính Bảng Học Tập Smart Study 1, Hàng Chính Hãng, Cho Trẻ Từ 5-12 Tuổi, 64GB, Tích Hợp Chương Trình Học Tập Toàn Diện",4900000,7900000,3000000,38
TIKI,dien-thoai-may-tinh-bang,274608056,"Điện thoại Samsung Galaxy S23 FE 128G - Độc quyền online- Hàng chính hãng",12889600,14889600,2000000,13
TIKI,dien-thoai-may-tinh-bang,274959698,"Điện thoại Tecno SPARK 20 8GB/128GB - Hàng chính hãng",2650000,3490000,840000,24
TIKI,dien-thoai-may-tinh-bang,212040697,"Điện Thoại Samsung Galaxy A04 (3GB/32GB) - Hàng Chính Hãng - Đã kích hoạt bảo hành điện tử",2400000,2400000,0,0
TIKI,dien-thoai-may-tinh-bang,186149961,"Máy tính bảng Samsung Galaxy Tab A7 Lite 32GB Xám - Hàng Chính Hãng",3587000,3587000,0,0
TIKI,dien-thoai-may-tinh-bang,272270730,"Điện thoại Samsung Galaxy A05 (4GB/128GB) - Hàng chính hãng",2794000,2794000,0,0
TIKI,dien-thoai-may-tinh-bang,273373436,"Điện thoại Xiaomi Redmi 13C (6GB/128GB) - Hàng chính hãng - Bảo hành 18 tháng",2990000,3490000,500000,14
TIKI,dien-thoai-may-tinh-bang,270495179,"Điện thoại Oppo A78 (8GB/256GB) - Hàng chính hãng",5959000,6990000,1031000,15
TIKI,dien-thoai-may-tinh-bang,248235765,"Điện Thoại Masstel iZi 26 4G - Hàng Chính Hãng",600000,600000,0,0
TIKI,dien-thoai-may-tinh-bang,275043046,"Apple iPad Pro M4 13-Inch Wi-Fi",36810000,37990000,1180000,3
TIKI,dien-thoai-may-tinh-bang,273610368,"Điện Thoại Samsung Galaxy A25 5G (6GB/128GB) - Hàng chính hãng",5590000,6590000,1000000,15
TIKI,dien-thoai-may-tinh-bang,274945338,"Điện thoại Realme C53 (8GB/256GB) - Hàng Chính Hãng",3450000,4790000,1340000,28
TIKI,dien-thoai-may-tinh-bang,273438724,"Điện Thoại Samsung A05s 4GB/128GB , Snapdragon 680 , Sạc nhanh 25W - Hàng Chính Hãng",3335000,3335000,0,0
TIKI,dien-thoai-may-tinh-bang,274166857,"Điện thoại Samsung Galaxy S23 FE (8GB/128GB) - Hàng chính hãng",11290000,14890000,3600000,24
TIKI,dien-thoai-may-tinh-bang,275583780,"Máy tính bảng Xiaomi Redmi Pad Pro 8GB/128GB - Hàng chính hãng",7490000,7990000,500000,6
TIKI,dien-thoai-may-tinh-bang,209927605,"Combo máy đọc sách Kindle 2022 (11th) tặng kèm bao da ( Cover ) - Hàng nhập khẩu",3356000,3356000,0,0
TIKI,dien-thoai-may-tinh-bang,272222033,"Máy đọc sách Boox Palma - Hàng Chính Hãng",7150000,8590000,1440000,17
TIKI,dien-thoai-may-tinh-bang,272348047,"Điện Thoại Samsung A05s 4GB/128GB - Hàng Chính Hãng",3625000,3625000,0,0
TIKI,dien-thoai-may-tinh-bang,262514707,"Điện thoại Xiaomi Redmi Note 12 Pro (8GB/256GB) - Hàng chính hãng",5999000,7990000,1991000,25
TIKI,dien-thoai-may-tinh-bang,270471106,"Điện Thoại Nokia 105 4G Pro TA-1538 - Hàng Chính Hãng",630000,680000,50000,7
TIKI,dien-thoai-may-tinh-bang,275206903,"Điện thoại Tecno Camon 30 (12GB/256GB) - Hàng Chính Hãng",5250000,6990000,1740000,25
TIKI,dien-thoai-may-tinh-bang,263073555,"Điện thoại Tecno CAMON 20 8GB/256GB - Camera 64MP + 32MP | 5000 mAh | Sạc nhanh 33W | 6.7'' FHD AMOLED - BH 13 Tháng - Hàng Chính Hãng",4490000,4990000,500000,10
TIKI,dien-thoai-may-tinh-bang,274542883,"Điện Thoại Samsung A35 5G 8GB/128GB - Hàng Chính Hãng",7229000,8290000,1061000,13
TIKI,dien-thoai-may-tinh-bang,275543388,"Điện thoại Samsung Galaxy Z Fold 6 12GB/1TB - Độc quyền online - Hàng chính hãng",54985000,54990000,5000,0
TIKI,dien-thoai-may-tinh-bang,230157205,"Điện thoại Xiaomi Redmi Note 10T 5G 4GB/64GB - Màn 90HZ - Chống Nước IP68 - Hàng Nhập Khẩu - Bản quốc tế",2499000,4190000,1691000,40
TIKI,dien-thoai-may-tinh-bang,275093800,"Apple iPad Air 6 M2 13-Inch Wi-Fi",21490000,22490000,1000000,4
TIKI,dien-thoai-may-tinh-bang,273636845,"Điện Thoại Samsung Galaxy A05 (4GB/64GB) - Hàng Chính Hãng",2587000,2587000,0,0
TIKI,dien-thoai-may-tinh-bang,275093810,"Apple iPad Air 6 M2 11-Inch Wi-Fi",16390000,16990000,600000,4
TIKI,dien-thoai-may-tinh-bang,252586291,"Máy đọc sách All New Kindle Paperwhite 5 (11th Gen) - Hàng chính hãng",3990000,3990000,0,0
TIKI,dien-thoai-may-tinh-bang,273252926,"Điện Thoại Oppo A18 (4GB/128GB) - Hàng Chính Hãng",3190000,3990000,800000,20
TIKI,dien-thoai-may-tinh-bang,273774937,"Điện thoại Samsung Galaxy A15 (8GB/128GB) - Hàng chính hãng - Đã kích hoạt bảo hành điện tử",4239000,4990000,751000,15
TIKI,dien-thoai-may-tinh-bang,244332381,"Điện thoại Samsung Galaxy A04 32GB - Hàng chính hãng",2400000,2400000,0,0
TIKI,dien-thoai-may-tinh-bang,258667842,"Điện thoại Xiaomi Redmi Note 12 Pro 4G (8GB/256GB) - Hàng chính hãng",5930000,7990000,2060000,26
TIKI,dien-thoai-may-tinh-bang,271966786,"iPhone 15",18990000,22490000,3500000,16
TIKI,dien-thoai-may-tinh-bang,271494404,"Điện thoại Tecno POVA 5 (8GB+8GB/128GB) RAM mở rộng 16GB | Pin 6000 mAh | Màn 120Hz - Sạc nhanh 45W - Hàng Chính Hãng",3599000,4490000,891000,20
TIKI,dien-thoai-may-tinh-bang,271801317,"Máy tính bảng siêu bền Oukitel RT6 (chống nước,chống va đập,pin 20000mAh,Ram 16Gb(8GB+8Gb),Rom 256GB,Màn hình 10.1" ,FHD,Android 13,CPU MTK8788 ,Camera 16MP,sạc nhanh 33W)-hàng chính hãng",9990000,9990000,0,0
TIKI,dien-thoai-may-tinh-bang,249851724,"Điện Thoại 4G Masstel Lux 10 - 2 Sim 2 Sóng - Sóng 4G HD Call - Loa To Rõ - Pin Bền - Hàng Chính Hãng - Bảo Hành 12 Tháng",675000,675000,0,0
TIKI,dien-thoai-may-tinh-bang,273185467,"Điện thoại Samsung A05 4GB - hàng chính hãng",3037000,3037000,0,0
TIKI,dien-thoai-may-tinh-bang,252073123,"Mua Itel it9200 4G - Hàng chính hãng",609000,609000,0,0
TIKI,dien-thoai-may-tinh-bang,251930431,"Samsung Galaxy A04e 3G/32G - Hàng Chính Hãng - Đã kích hoạt bảo hành điện tử",2090000,2090000,0,0
TIKI,dien-thoai-may-tinh-bang,273659145,"Máy tính bảng Tab10 Kidzone dành cho bé - quản lý thời gian cho bé - bé học tốt, hiệu quả cao - 1 đổi 1 trong 100 ngày - Hàng chính hãng",2990000,3990000,1000000,25
TIKI,dien-thoai-may-tinh-bang,52002453,"Cisco Unified IP Phone 7962G - Hàng chính hãng",4900000,4900000,0,0
TIKI,dien-thoai-may-tinh-bang,274617822,"Điện thoại Samsung Galaxy S24 Ultra 12GB/256GB - Độc quyền Online - Hàng chính hãng",29985000,33990000,4005000,12
TIKI,dien-thoai-may-tinh-bang,275263668,"Điện thoại Samsung Galaxy A15 (8GB/256GB)  - Đã kích hoạt bảo hành điện tử - Hàng Chính Hãng",4290000,4690000,400000,9
TIKI,dien-thoai-may-tinh-bang,273958512,"Điện thoại Xiaomi Redmi Note 13 (6GB/128GB) - Hàng chính hãng",4329000,4890000,561000,11
TIKI,dien-thoai-may-tinh-bang,219400421,"Điện thoại OPPO CPH2471 - A17k Xanh - Hàng Chính Hãng (chỉ giao HN và một số khu vực)",3276000,3276000,0,0
TIKI,dien-thoai-may-tinh-bang,273231495,"Máy tính bảng Masstel tab 10.1 pro - Hàng chính hãng",4290000,4290000,0,0
TIKI,dien-thoai-may-tinh-bang,249782771,"Máy tính bảng Xelex Gama Tab X8 EDU (Hàng chính hãng)",2890000,2890000,0,0
TIKI,dien-thoai-may-tinh-bang,274257669,"Điện thoại Masstel Izi S1 4G (LTE) Gọi HD Call - Hàng chính hãng",439000,499000,60000,12
TIKI,dien-thoai-may-tinh-bang,274524033,"Điện thoại người già Masstel Fami 12S 4G(LTE) , Bàn phím chữ số to, Loa lớn , Máy viền thép chắc chắn - Hàng chính hãng",589000,650000,61000,9
TIKI,dien-thoai-may-tinh-bang,274958815,"Samsung Galaxy Tab A9 (LTE) 8GB/128GB - Hàng chính hãng",6490000,6490000,0,0
TIKI,dien-thoai-may-tinh-bang,273407277,"Máy tính bảng chắc chắn Oukitel RT7 5G(Chống va đập,Màn hình 10.1" FHD+,Pin 32000mAh ,Ram 24GB,Rom 256GB, Android 13,Camera sau 48MP, tầm nhìn ban đêm 20MP,camera trước 32MP,5G) – hàng chính hãng",11970000,11970000,0,0
TIKI,dien-thoai-may-tinh-bang,248754839,"Điện Thoại OPPO A17K (3GB/64GB) - Hàng Chính Hãng",3276000,3276000,0,0
TIKI,dien-thoai-may-tinh-bang,181927736,"Điện thoại bàn Panasonix KX-TGD312 hàng chính hãng",1950000,1950000,0,0
TIKI,dien-thoai-may-tinh-bang,175851126,"Máy Tính Bảng Galaxy Tab A8 4GB | 64GB - Hàng Chính Hãng",5856000,5856000,0,0
TIKI,dien-thoai-may-tinh-bang,215119245,"Điện Thoại Di Động Forme D888 4G - Hàng Chính Hãng",680000,680000,0,0
TIKI,dien-thoai-may-tinh-bang,258766897,"Điện Thoại Masstel iZi 11 4G - Hàng Chính Hãng",468000,468000,0,0
TIKI,dien-thoai-may-tinh-bang,274638556,"BÚT MÁY ĐỌC SÁCH KINDLE SCRIBE - HÀNG CHÍNH HÃNG",2000000,2000000,0,0
TIKI,dien-thoai-may-tinh-bang,275044287,"Máy tính bảng siêu bền Ulefone Armor Pad 3 Pro (Pin 33280 mAh,chống nước,chống va đập,RAM 16GB (8+8), ROM 256GB ,camera 50MP,Màn hình 10.36 Inch)-hàng chính hãng",9990000,9990000,0,0
TIKI,dien-thoai-may-tinh-bang,251930414,"Redmi Note 12 Cấu Hình Khủng- hàng chính hãng- Giá rẻ",4490000,4490000,0,0
TIKI,dien-thoai-may-tinh-bang,253380146,"Điện thoại di động Forme N82 4G - Hàng chính hãng",590000,590000,0,0
TIKI,dien-thoai-may-tinh-bang,275295006,"Máy tính bảng cho trẻ chống sốc 10.1 inch TEKKIN TI-8010 cpu 4 nhân 4gb 64gb - hàng nhập khẩu",1599000,1599000,0,0
TIKI,dien-thoai-may-tinh-bang,136364272,"Máy tính bảng Masstel Tab 10.4" (4GB/64GB) - Hàng chính hãng - ĐÃ KÍCH HOẠT BẢO HÀNH ĐIỆN TỬ",4800000,4800000,0,0
TIKI,dien-thoai-may-tinh-bang,275042833,"Apple iPad Pro M4 11-Inch Wi-Fi+ Cellular",32990000,34490000,1500000,4
TIKI,dien-thoai-may-tinh-bang,273227290,"Combo Máy đọc sách Kindle Scribe kèm bút – thế hệ đầu tiên có thể đọc và viết, màn hình 10,2” 300PPI, đèn vàng warmlight, bộ nhớ 16-64GB, đồng bộ dữ liệu qua Microsoft Word - hàng nhập khẩu",11390000,11390000,0,0
TIKI,dien-thoai-may-tinh-bang,274721231,"Điện thoại Realme C65 (8GB/256GB) - Hàng Chính Hãng",3850000,4790000,940000,20
TIKI,dien-thoai-may-tinh-bang,103168071,"Máy tính bảng Samsung Galaxy Tab A7 Lite LTE SM-T225 - Hàng Chính Hãng",3587000,3587000,0,0
TIKI,dien-thoai-may-tinh-bang,270512785,"Điện thoại Nokia 105 4G Pro - Hàng chính hãng",680000,680000,0,0
TIKI,dien-thoai-may-tinh-bang,275335546,"Máy tính bảng Samsung Galaxy Tab A9+ Wifi (4GB/64GB) - Hàng chính hãng",4129000,5990000,1861000,31
TIKI,dien-thoai-may-tinh-bang,179547641,"Máy đọc sách Kindle Paperwhite 5 (8GB) - Hàng chính hãng",3790000,3790000,0,0
TIKI,dien-thoai-may-tinh-bang,250109584,"Điện thoại Xiaomi Redmi Note 12 (4GB/128GB) - Hàng chính hãng",3600000,3600000,0,0
TIKI,dien-thoai-may-tinh-bang,246163082,"Điện Thoại Nokia C30 2GB/32GB - Hàng Chính Hãng",1609000,2290000,681000,30
TIKI,dien-thoai-may-tinh-bang,249534908,"Điện thoại Tecno SPARK GO 2023 3GB/64GB - Helio A22 | 5000 mAh | 6,6" HD+| Cảm ứng vân tay | Hàng chính hãng | Bảo hành chính hãng 13 tháng",1999000,2490000,491000,20
TIKI,dien-thoai-may-tinh-bang,273595363,"Oukitel wp30 Pro 5g SIÊU BỀN (sạc nhanh 120W ,pin 11000 mAh,màn hình 6.78 inch,Ram 24 GB(12gb + 12GB),Rom 512GB ,120Hz ,Android 13,camera 108mp)- hàng chính hãng",11990000,11990000,0,0
TIKI,dien-thoai-may-tinh-bang,191089547,"Điện Thoại Nokia 110 4G - Hàng Chính Hãng",689000,899000,210000,23
TIKI,dien-thoai-may-tinh-bang,200819471,"Điện thoại Mobell Rock 4 4G , Pin 3250mah , Loa Siêu lớn - Hàng chính hãng",699000,799000,100000,13
TIKI,dien-thoai-may-tinh-bang,272273680,"Điện thoại Samsung Galaxy A05s (4GB/128GB) - Hàng chính hãng",3335000,3335000,0,0
TIKI,dien-thoai-may-tinh-bang,200829966,"Điện thoại Mobell M239 4G - 2 SIM - Hàng chính hãng",439000,500000,61000,12
TIKI,dien-thoai-may-tinh-bang,249890677,"Điện Thoại Xiaomi Redmi Note 12 4GB/128GB - Hàng Chính Hãng",3600000,3600000,0,0
TIKI,dien-thoai-may-tinh-bang,270791102,"Điện Thoại Sony XPERIA 10 MARK V  | ROM 128GB - Pin khủng 5000mAh - Hệ điều hành Snapdragon 695 - Màn hình OLED | HÀNG CHÍNH HÃNG",12490000,12490000,0,0
TIKI,dien-thoai-may-tinh-bang,275504716,"Điện Thoại Xiaomi Redmi A3 4GB/128GB - Hàng Chính Hãng",2769000,3290000,521000,16
TIKI,dien-thoai-may-tinh-bang,198968094,"Điện Thoại Xiaomi Redmi A1 2GB/32GB - Hàng Chính Hãng",1779000,2190000,411000,19
TIKI,dien-thoai-may-tinh-bang,274762125,"Điện thoại Samsung Galaxy A35 5G ( 8GB - 128GB ) - Hàng chính hãng",8290000,8290000,0,0
TIKI,dien-thoai-may-tinh-bang,274866839,"Máy tính bảng Samsung Galaxy Tab A9 (Wi-Fi) 4GB/64GB - Hàng chính hãng",3489700,3989700,500000,13
TIKI,dien-thoai-may-tinh-bang,274364026,"Máy tính bảng học tập thông minh Nexta Edutab Pro tối ưu cho trẻ 9-12 tuổi, 64GB, tích hợp ứng dụng học tập - Hàng nhập khẩu",4490000,6490000,2000000,31
TIKI,dien-thoai-may-tinh-bang,274560616,"Máy tính bảng học tập giá rẻ Nexta Edutab Kid cho bé từ 5-8 tuổi, màn hình full HD 64GB, bao da, kính dán cường lực, hàng chính hãng",2990000,4990000,2000000,40
TIKI,dien-thoai-may-tinh-bang,206218031,"Máy tính bảng viết tay Xiaomi Wicue màn hình LCD màu cầu vồng không đèn nền 12inch",443000,768000,325000,42
TIKI,dien-thoai-may-tinh-bang,200848570,"Điện thoại Mobell M539 4G - Màn hình lớn 2.8 inch - Hàng chính hãng",629000,730000,101000,14
TIKI,dien-thoai-may-tinh-bang,225960096,"Điện Thoại Samsung Galaxy S23+ 5G - Hàng Chính Hãng",18000000,18000000,0,0
TIKI,dien-thoai-may-tinh-bang,242771940,"Điện Thoại Samsung A04e 3GB/32GB - Hàng Chính Hãng",2149000,2990000,841000,28
TIKI,dien-thoai-may-tinh-bang,275583785,"Máy tính bảng Xiaomi Redmi Pad Pro 6GB/128GB - Hàng chính hãng",6690000,7290000,600000,8
TIKI,dien-thoai-may-tinh-bang,273553649,"Điện thoại Oppo A18 - Hàng chính hãng",3099000,3690000,591000,16
TIKI,dien-thoai-may-tinh-bang,274037365,"Điện Thoại POCO C65 (8GB/256GB) - Hàng Chính Hãng",3280000,3590000,310000,9
TIKI,dien-thoai-may-tinh-bang,274619667,"Điện thoại Samsung Galaxy S24 Ultra 12GB/512GB - Độc quyền Online - Hàng chính hãng",33490000,37490000,4000000,11
TIKI,dien-thoai-may-tinh-bang,197214015,"Apple iPhone 14 Plus",19290000,27990000,8700000,31
TIKI,dien-thoai-may-tinh-bang,274681250,"Điện Thoại Samsung Galaxy A55 5G (8GB/128GB)- Đã Kích Hoạt Điện Tử- Hàng Chính Hãng",8490000,9990000,1500000,15
TIKI,dien-thoai-may-tinh-bang,274375122,"Điện thoại Xiaomi Redmi Note 13 Pro 4G (8GB/128GB) - Hàng chính hãng",6399000,7290000,891000,12
TIKI,dien-thoai-may-tinh-bang,271362153,"Combo Máy đọc sách All New Kindle Paperwhite 5 (11th Gen) và Bao da FOR KIDS (Bản KIDS, Không Quảng Cáo) - Hàng chính hãng",3970000,4590000,620000,14
TIKI,dien-thoai-may-tinh-bang,275206906,"Điện thoại Tecno Camon 30 (8GB/256GB) - Hàng Chính Hãng",4990000,6490000,1500000,23
TIKI,dien-thoai-may-tinh-bang,273897523,"Điện thoại Tecno SPARK 20 (8+8)GB/128GB - Helio G85 | 5000 mAh | Sạc nhanh 18W | Hàng Chính Hãng",2799000,3490000,691000,20
TIKI,dien-thoai-may-tinh-bang,273378164,"Điện thoại Xiaomi Redmi 13C (6GB/128GB) - Hàng chính hãng - Đã kích hoạt bảo hành điện tử",2910000,3490000,580000,17
TIKI,dien-thoai-may-tinh-bang,275583801,"Điện thoại Xiaomi Redmi Note 13 (8GB/128GB) - Hàng chính hãng",4290000,4990000,700000,14
TIKI,dien-thoai-may-tinh-bang,230155305,"Điện thoại Xiaomi Redmi Note 10 JE 5G 4GB/64GB - Màn 90HZ - Chống Nước IP68 - Hàng Nhập Khẩu - Bản quốc tế",2299000,3990000,1691000,42
TIKI,dien-thoai-may-tinh-bang,274611998,"Điện thoại Xiaomi Redmi 12 (4GB/128GB) - Hàng chính hãng",3079000,3790000,711000,19
TIKI,dien-thoai-may-tinh-bang,270164674,"Điện thoại OPPO A78 (8GB/256GB) - Hàng Chính Hãng",6326000,6990000,664000,9
TIKI,dien-thoai-may-tinh-bang,275543355,"Điện thoại Samsung Galaxy Z Flip 6 (8GB/512GB) - Độc quyền online - Hàng chính hãng",32985000,32990000,5000,0
TIKI,dien-thoai-may-tinh-bang,270975124,"Điện Thoại Oppo A58 6GB/128GB - Hàng Chính Hãng",4090000,4990000,900000,18
TIKI,dien-thoai-may-tinh-bang,275589387,"Điện thoại Nokia 220 4G - Hàng chính hãng",990000,990000,0,0
TIKI,dien-thoai-may-tinh-bang,275510581,"Điện thoại OPPO Reno12 5G (12GB/256GB) - Hàng Chính Hãng",12950000,12990000,40000,0
TIKI,dien-thoai-may-tinh-bang,271973414,"iPhone 15 Pro Max 256GB Titan Tự Nhiên",28490000,33990000,5500000,16
TIKI,dien-thoai-may-tinh-bang,102620086,"Điện thoại VoIP Yealink SIP-T30 - Hàng Chính Hãng",1200000,1200000,0,0
TIKI,dien-thoai-may-tinh-bang,181699208,"Máy tỉnh bảng Samsung Galaxy Tab A8 -Hàng chính hãng",5856000,5856000,0,0
TIKI,dien-thoai-may-tinh-bang,271046571,"Điện thoại Xiaomi Redmi Note 12 (8GB/128GB) - Hàng chính hãng",3790000,4530000,740000,16
TIKI,dien-thoai-may-tinh-bang,215125094,"Điện Thoại Di Động Forme D999 4G - Hàng Chính Hãng",760000,760000,0,0
TIKI,dien-thoai-may-tinh-bang,207883258,"Điện thoại oukitel  wp21 (Ram 12Gb,Rom 256Gb ,chống sốc,chống nước,pin khủng, pin 9.800mAh) - hàng chính hãng",9970000,9970000,0,0
TIKI,dien-thoai-may-tinh-bang,272834546,"điện thoại Redmi A2 - Hàng chính hãng",1890000,1890000,0,0
TIKI,dien-thoai-may-tinh-bang,221274391,"Điện thoại Tecno SPARK GO 2023 4GB/64GB - Helio A22 | 5000 mAh | 6,6" HD+| Cảm ứng vân tay | Hàng chính hãng | Bảo hành chính hãng 13 tháng",2199000,3290000,1091000,33
TIKI,dien-thoai-may-tinh-bang,217640502,"Máy đọc sách Kindle Scribe - Hàng chính hãng",11990000,12990000,1000000,8
TIKI,dien-thoai-may-tinh-bang,208171115,"Điện thoại OUKITEL WP18 (Chống nước ,chống va đập, pin khủng 12500mAh, Ram 4GB ,Rom 32GB ,màn hình 5.93 inch,Điện thoại chắc chắn) – HÀNG CHÍNH HÃNG",3990000,3990000,0,0
TIKI,dien-thoai-may-tinh-bang,249169833,"Điện thoại Samsung Galaxy A34 5G 8GB/128GB Đen - Hàng chính hãng",7164000,7164000,0,0
TIKI,dien-thoai-may-tinh-bang,274681248,"Điện Thoại Samsung Galaxy A35 5G (8GB/128GB)- Đã Kích Hoạt Điện Tử- Hàng Chính Hãng",6850000,8290000,1440000,17
TIKI,dien-thoai-may-tinh-bang,194462682,"Điện thoại ZTE Blade A52 4GB l 64GB, Pin 5000mAh, Màn hình 6.52", Camera AI Triple - Hàng chính hãng",3490000,3490000,0,0
TIKI,dien-thoai-may-tinh-bang,225381612,"Điện Thoại Samsung Galaxy S23 Ultra 5G (8GB/256GB) - Hàng Chính Hãng",21750000,31990000,10240000,32
TIKI,dien-thoai-may-tinh-bang,270976558,"Điện thoại di động Mobell M331 - Hàng chính hãng",549000,549000,0,0
TIKI,dien-thoai-may-tinh-bang,248762051,"Điện Thoại Samsung A34 5G 8GB/128GB - Hàng Chính Hãng",7164000,7164000,0,0
TIKI,dien-thoai-may-tinh-bang,273438458,"Điện thoại Samsung Galaxy A05 (4GB/128GB)- Helio G85 - Sạc nhanh 25W - Hàng chính hãng",2794000,2794000,0,0
TIKI,dien-thoai-may-tinh-bang,197960169,"Điện thoại Masstel Lux 10 4G - Sang trọng - Gọi HD Call - Hàng chính hãng",675000,675000,0,0
TIKI,dien-thoai-may-tinh-bang,273511450,"Điện thoại Xiaomi Redmi 12 8GB/128GB - Hàng Chính Hãng",4390000,4390000,0,0
TIKI,dien-thoai-may-tinh-bang,251407092,"Điện Thoại Samsung Galaxy A34 5G (8GB/128GB) ĐKH -  Hàng Chính Hãng",7164000,7164000,0,0
TIKI,dien-thoai-may-tinh-bang,11251937,"Điện thoại bàn không dây Panasonic KX-TGC310-Hàng Chính Hãng",1200000,1200000,0,0
TIKI,dien-thoai-may-tinh-bang,208193365,"Điện thoại Samsung Galaxy A04 3/32GB - Hàng chính hãng",2400000,2400000,0,0
TIKI,dien-thoai-may-tinh-bang,103168844,"Máy tính bảng Samsung Galaxy Tab A7 Lite LTE SM-T225) - ĐÃ KÍCH HOẠT ĐIỆN TỬ - Hàng Chính Hãng",3587000,3587000,0,0
TIKI,dien-thoai-may-tinh-bang,275093806,"Apple iPad Air 6 M2 13-Inch Wi-Fi+ Cellular",24990000,26490000,1500000,6
TIKI,dien-thoai-may-tinh-bang,160051501,"Điện thoại Masstel IZI 20 4G - Hàng chính hãng, Nguyên Seal",512000,512000,0,0
TIKI,dien-thoai-may-tinh-bang,173789184,"Điện thoại bàn treo tường TC990",250000,250000,0,0
TIKI,dien-thoai-may-tinh-bang,250113073,"Điện thoại Xiaomi Redmi Note 12 Pro 5G (8GB/256GB) - Hàng chính hãng",9000000,9000000,0,0
TIKI,dien-thoai-may-tinh-bang,215135773,"Điện Thoại Di Động Forme D111 4G - Hàng Chính Hãng",520000,520000,0,0
TIKI,dien-thoai-may-tinh-bang,273186334,"Điện thoại Samsung Galaxy A05s 4GB/128GB- Hàng Chính hãng",3625000,3625000,0,0
TIKI,dien-thoai-may-tinh-bang,275386465,"Điện Thoại Oppo A38 6GB/128GB - Hàng Chính Hãng",4199000,4990000,791000,16
TIKI,dien-thoai-may-tinh-bang,274456687,"Điện thoại Samsung Galaxy A55 5G (8GB/128GB) - Hàng chính hãng",8899000,9990000,1091000,11
TIKI,dien-thoai-may-tinh-bang,258373871,"Điện Thoại Itel S23 128GB/16GB (8GB+8GB) | Pin 5000mAh | 6.6 Inch | Camera 50MP | 90Hz | Face ID - Hàng chính Hãng",2290000,3490000,1200000,34
TIKI,dien-thoai-may-tinh-bang,273367316,"Điện Thoại Xiaomi Redmi 13C 6GB/128GB - Hàng Chính Hãng",2959000,3490000,531000,15
TIKI,dien-thoai-may-tinh-bang,274019962,"Điện thoại Masstel Fami 8 4G(LTE) Gọi HD call , Bàn phím chữ số lớn,Loa to - Hàng chính hãng",489000,550000,61000,11
TIKI,dien-thoai-may-tinh-bang,217276360,"Điện thoại Mobell F209 4G ,Loa to, Phím lớn - Hàng chính hãng",569000,670000,101000,15
TIKI,dien-thoai-may-tinh-bang,274638430,"Điện thoại Redmi Note 13R 5G 4GB/128GB Dimensity 6100+ , Màn 90Hz , Rom quốc tế có sẳn Tiếng việt - Hàng nhập khẩu",2629000,3590000,961000,27
TIKI,dien-thoai-may-tinh-bang,273668660,"Điện Thoại Oppo A18 4GB/64GB - Hàng Chính Hãng",2989000,3690000,701000,19
TIKI,dien-thoai-may-tinh-bang,274162900,"Điện thoại OPPO A18 4GB-128GB - Hàng chính hãng",3159000,3990000,831000,21
TIKI,dien-thoai-may-tinh-bang,274030201,"Điện thoại TECNO SPARK 10 8GB/128GB - Hàng Chính Hãng",2819000,3590000,771000,21
TIKI,dien-thoai-may-tinh-bang,273440662,"Điện thoại Xiaomi Redmi 12 (4GB/128GB) , Helio G88 , Màn 90HZ - Hàng chính hãng",2959000,4290000,1331000,31
TIKI,dien-thoai-may-tinh-bang,203278278,"Điện Thoại Samsung A04 3GB/32GB - Hàng Chính Hãng",2200000,2200000,0,0
TIKI,dien-thoai-may-tinh-bang,274608680,"Điện thoại Samsung Galaxy S23 FE 256G - Độc quyền online - Hàng chính hãng",14890500,16890500,2000000,12
TIKI,dien-thoai-may-tinh-bang,274065023,"Điện thoại Xiaomi Redmi Note 13 (8GB/128GB) - Hàng chính hãng",4849000,5290000,441000,8
TIKI,dien-thoai-may-tinh-bang,200816374,"Điện Thoại Forme D888 - Hàng Chính Hãng",587000,699000,112000,16
TIKI,dien-thoai-may-tinh-bang,191636459,"Điện thoại Masstel IZI 11 4G - Hàng chính hãng",468000,468000,0,0
TIKI,dien-thoai-may-tinh-bang,275175815,"Điện thoại Xiaomi 14 Ultra (16GB/512GB) - Hàng chính hãng",28849000,32990000,4141000,13
TIKI,dien-thoai-may-tinh-bang,270504848,"Điện thoại Nokia 110 4G Pro - Hàng chính hãng",710000,710000,0,0
TIKI,dien-thoai-may-tinh-bang,274393574,"Điện thoại Xiaomi Poco C65 - Hàng chính hãng",2759000,3090000,331000,11
TIKI,dien-thoai-may-tinh-bang,271234313,"Điện Thoại Nokia 110 4G Pro - Hàng Chính Hãng",699000,710000,11000,2
TIKI,dien-thoai-may-tinh-bang,275486710,"Điện thoại Samsung Galaxy A15 LTE (8GB/256GB) - Hàng chính hãng",4769000,5590000,821000,15
TIKI,dien-thoai-may-tinh-bang,274550926,"Điện thoại Realme C60 (4GB/64GB) - Hàng Chính Hãng",2290000,2990000,700000,23
TIKI,dien-thoai-may-tinh-bang,203853390,"Điện Thoại Oppo A17k (3GB/64GB)",2590000,3290000,700000,21
TIKI,dien-thoai-may-tinh-bang,273559020,"Máy tính bảng Kindle Fire HD10 2023 13th - 32Gb - Hàng chính hãng",3200000,3590000,390000,11
TIKI,dien-thoai-may-tinh-bang,274948705,"Điện thoại POCO X6 Pro 5G (12GB/512GB) - Hàng Chính Hãng",9250000,11490000,2240000,19
TIKI,dien-thoai-may-tinh-bang,272241346,"Điện thoại Samsung Galaxy A05s (4GB/128GB) - Hàng chính hãng",3469000,3990000,521000,13
TIKI,dien-thoai-may-tinh-bang,274456447,"Điện thoại Samsung Galaxy A35 5G (8GB/128GB) - Hàng chính hãng",7349000,8290000,941000,11
TIKI,dien-thoai-may-tinh-bang,274959691,"Điện thoại Tecno SPARK 20 Pro+ 8GB/256GB - Hàng chính hãng",4650000,5490000,840000,15
TIKI,dien-thoai-may-tinh-bang,275496965,"Máy đọc sách Boox Go Color 7- Đen - Hàng chính hãng",7570000,8590000,1020000,12
TIKI,dien-thoai-may-tinh-bang,272151221,"Điện thoại Xiaomi Redmi 10 2022 (4GB/128GB) - Hàng chính hãng",2670000,3990000,1320000,33
TIKI,dien-thoai-may-tinh-bang,275621214,"Điện Thoại Oppo Reno12 F 5G 8GB/256GB - Hàng Chính Hãng",9490000,9490000,0,0
TIKI,dien-thoai-may-tinh-bang,271967379,"iPhone 15 Plus 128GB Xanh Dương",21990000,25990000,4000000,15
TIKI,dien-thoai-may-tinh-bang,270814388,"Điện thoại Tecno POVA 5 (8+8)/128GB - MediaTek Helio G99 - Sạc nhanh 45W - 6.8'' FHD+120HZ - Hàng Chính Hãng - BH 13 Tháng",3790000,4490000,700000,16
TIKI,dien-thoai-may-tinh-bang,274365104,"Điện thoại Xiaomi Redmi Note 13 Pro (8GB/128GB) - Hàng Chính Hãng",5990000,7290000,1300000,18
TIKI,dien-thoai-may-tinh-bang,272113804,"[MỚI] Điện thoại vivo Y17s - Hàng chính hãng - Camera 50MP - Pin 5000 mAh - Sạc nhanh- RAM mở rộng đến 8GB",3790000,3990000,200000,5
TIKI,dien-thoai-may-tinh-bang,209872337,"Máy đọc sách Kindle 2022 (11th) - All new kindle 2022 11th màn hình 6inch 300PPI gấp 2 lần độ sắc nét, 16GB bộ nhớ trong với cổng kết nối USB-C - Hàng nhập khẩu",3080000,3090000,10000,0
TIKI,dien-thoai-may-tinh-bang,251514670,"Điện thoại Xiaomi Redmi Note 12 (4GB/128GB) Màn AMOLED 120HZ, Snapdragon 685 , Sạc 33W - Hàng chính hãng",3600000,3600000,0,0
TIKI,dien-thoai-may-tinh-bang,273454566,"Điện thoại Xiaomi POCO C65 (6GB/128GB) - Helio G85 - Màn 90HZ - Hàng chính hãng",2599000,3290000,691000,21
TIKI,dien-thoai-may-tinh-bang,274946444,"Điện Thoại POCO M6 Pro (8GB/256GB) - Hàng Chính Hãng",5650000,6490000,840000,13
TIKI,dien-thoai-may-tinh-bang,275237083,"Điện thoại Nokia 3210 - Hàng Chính Hãng",1440000,1590000,150000,9
TIKI,dien-thoai-may-tinh-bang,273348837,"Điện thoại Xiaomi Redmi 13C (6GB/128GB) - Hàng chính hãng",2890000,3290000,400000,12
TIKI,dien-thoai-may-tinh-bang,251448280,"Samsung Galaxy A34 5G A346E (8+128G) Silver Bạc - Hàng Chính Hãng (chỉ giao HN và một số khu vực)",7164000,7164000,0,0
TIKI,dien-thoai-may-tinh-bang,213858174,"Máy tính bảng Samsung Galaxy Tab A7 Lite (3GB/32GB) - Hàng chính hãng - Màn hình 8.7inch TFT LCD, Camera sau 8MP - Bảo Hành 12 Tháng",3587000,3587000,0,0
TIKI,dien-thoai-may-tinh-bang,275018185,"Máy đọc sách BOOX Poke 5 2024 - Hàng Chính Hãng",4900000,6590000,1690000,26
TIKI,dien-thoai-may-tinh-bang,273359931,"Điện Thoại Thông Minh siêu bền Oukitel WP27 (Ram 12GB,Rom 256GB,Màn hình 6.78 “FHD + ,pin 8300MAH,NFC, Android 13 ,CPU MTK G99,chống nước,chống sốc) –hàng chính hãng",6990000,6990000,0,0
TIKI,dien-thoai-may-tinh-bang,273165324,"Điện thoại Xiaomi Redmi A2 (2GB/32GB) - Hàng chính hãng",1849000,2190000,341000,16
TIKI,dien-thoai-may-tinh-bang,201001781,"Điện thoại Masstel Lux 10 4G - Nhiều chức năng - Hàng chính hãng",675000,675000,0,0
TIKI,dien-thoai-may-tinh-bang,274516245,"Điện thoại Masstel Fami 60S 4G(LTE) ,Bàn phím lớn, Khung viền kim loại - Hàng chính hãng",659000,750000,91000,12
TIKI,dien-thoai-may-tinh-bang,274559076,"Điện thoại Samsung Galaxy A55 5G - Hàng Chính Hãng",9990000,9990000,0,0
TIKI,dien-thoai-may-tinh-bang,263675862,"Điện thoại OPPO A77 4GB+4GB/128GB - Sạc siêu nhanh 33W - Hàng nhập khẩu nhật - Bản quốc tế",3399000,4990000,1591000,32
TIKI,dien-thoai-may-tinh-bang,263438008,"Điện thoại Masstel Hapi 30 4G Hàng Chính Hãng",2290000,2290000,0,0
TIKI,dien-thoai-may-tinh-bang,181927718,"Điện thoại bàn Panasonic KX-TGC313 hàng chính hãng",2150000,2150000,0,0
TIKI,dien-thoai-may-tinh-bang,273653444,"Máy tính bảng Kindle Fire Hd 10 2023 13th - Hàng nhập khẩu",3790000,3790000,0,0
TIKI,dien-thoai-may-tinh-bang,273559306,"Máy tính bảng Kindle Fire Max 11 inch - 13th - 2023 - Ram 4Gb - Hàng chính hãng",5130000,5590000,460000,8
TIKI,dien-thoai-may-tinh-bang,273683300,"Điện thoại Samsung Galaxy A15 LTE (8GB/128GB) - Hàng chính hãng",4449000,4990000,541000,11
TIKI,dien-thoai-may-tinh-bang,273498357,"Điện Thoại Itel S23 16GB(8GB+8GB)/256GB | Pin 5000mAh | 6.6 Inch | Camera 50MP | HÀNG CHÍNH HÃNG",2590000,3490000,900000,26
TIKI,dien-thoai-may-tinh-bang,160556149,"Máy tính bảng Samsung Galaxy Tab A8 - Hàng chính hãng",5856000,5856000,0,0
TIKI,dien-thoai-may-tinh-bang,201631518,"Điện thoại Samsung Galaxy A04 (3GB/32GB) - Hàng chính hãng",2400000,2400000,0,0
TIKI,dien-thoai-may-tinh-bang,158742790,"Máy tính bảng Samsung Galaxy Tab A8 (4GB/64GB) - Hàng Chính Hãng",5856000,5856000,0,0
TIKI,dien-thoai-may-tinh-bang,275093801,"Apple iPad Air 6 M2 11-Inch Wi-Fi+ Cellular",20490000,20990000,500000,2
TIKI,dien-thoai-may-tinh-bang,273610105,"Điện Thoại Samsung Galaxy A05 - Hàng Chính Hãng",2587000,2587000,0,0
TIKI,dien-thoai-may-tinh-bang,249730338,"Điện Thoại 4G Masstel Lux 20 - 2 Sim 2 Sóng - Sóng 4G Hd Call - Loa To Rõ - Hàng Chính Hãng - Bảo Hành 12 Tháng",790000,790000,0,0
TIKI,dien-thoai-may-tinh-bang,273684137,"Máy tính bảng quản lý thời gian sử dụng dành cho trẻ em Tab8 Kidzone-1 đổi 1 trong vòng 100 ngày",1990000,1990000,0,0
TIKI,dien-thoai-may-tinh-bang,196197701,"Điện thoại Samsung Galaxy Z Fold4 5G (12GB/256GB) - Hàng chính hãng",40990000,40990000,0,0
TIKI,dien-thoai-may-tinh-bang,271799133,"Máy tính bảng chắc chắn oukitel RT5 (chống nước,chống va đập,pin 11.000mAh,Màn hình 10.1 inch FHD, Ram 14Gb,Rom 256Gb, CPU : Mediatek 8788,lõi 8, lên đến 2.0 GHz, Camera Trước,sau 16 MP, Android 13)- hàng chính hãng",7490000,7490000,0,0
TIKI,dien-thoai-may-tinh-bang,274405521,"Điện Thoại Samsung A05 4GB/64GB - Hàng Chính Hãng",2489000,2990000,501000,17
TIKI,dien-thoai-may-tinh-bang,213587929,"Điện Thoại Samsung Galaxy A04 (3GB/32GB) - Hàng Chính Hãng",2400000,2400000,0,0
TIKI,dien-thoai-may-tinh-bang,191764688,"Điện thoại Xiaomi Redmi 10A (2GB/32GB) - Hàng chính hãng",2556000,2556000,0,0
TIKI,dien-thoai-may-tinh-bang,219392186,"Điện thoại OPPO CPH2471 - A17k Vàng - Hàng Chính Hãng (chỉ giao HN và một số khu vực)",3276000,3276000,0,0
TIKI,dien-thoai-may-tinh-bang,271389593,"điện thoại Nokia 110 4G Pro -Kiểu dáng bền bỉ - hiển thị rõ nét- Hàng chính hãng",745000,745000,0,0
TIKI,dien-thoai-may-tinh-bang,105830021,"Máy Tính Bảng Samsung Galaxy Tab A7 Lite LTE T225 (3GB/32GB) ĐÃ KÍCH HOẠT BẢO HÀNH ĐIỆN TỬ - Hàng Chính Hãng",3587000,3587000,0,0
TIKI,dien-thoai-may-tinh-bang,167465856,"Điện thoại Masstel IZI 50 4G , Pin 1700 mah - Hàng chính hãng",549000,549000,0,0
TIKI,dien-thoai-may-tinh-bang,252073258,"Điện thoại di động ITEL 9210 4G - Hàng Chính Hãng",699000,699000,0,0
TIKI,dien-thoai-may-tinh-bang,275577204,"Điện thoại Realme C60 (4GB/64GB) - Hàng chính hãng",2490000,2790000,300000,11
TIKI,dien-thoai-may-tinh-bang,274959117,"Điện thoại Tecno POVA 5 8GB/256GB  Hàng Chính Hãng",4150000,5490000,1340000,24
TIKI,dien-thoai-may-tinh-bang,275338696,"Máy tính bảng Samsung Galaxy Tab A9+ 5G - Hàng chính hãng",6190000,7490000,1300000,17
TIKI,dien-thoai-may-tinh-bang,275605662,"Điện thoại Xiaomi Poco M6 (6GB/128GB) - Hàng chính hãng",3890000,4290000,400000,9
TIKI,dien-thoai-may-tinh-bang,274946440,"Điện Thoại POCO M6 Pro (12GB/512GB) - Hàng Chính Hãng",6490000,7490000,1000000,13
TIKI,dien-thoai-may-tinh-bang,274948704,"Điện Thoại POCO X6 5G (12GB/256GB) - Hàng Chính Hãng",7290000,8990000,1700000,19
TIKI,dien-thoai-may-tinh-bang,274625676,"Điện thoại Samsung Galaxy S24+ 12GB/256GB - Độc quyền Online - Hàng chính hãng",25990000,26990000,1000000,4
TIKI,dien-thoai-may-tinh-bang,272238679,"Điện thoại Samsung Galaxy A05 (4GB/128GB) - Hàng chính hãng",2729000,3090000,361000,12
TIKI,dien-thoai-may-tinh-bang,270471101,"Điện Thoại Nokia 110 4G Pro TA-1559 - Hàng Chính Hãng",650000,710000,60000,8
TIKI,dien-thoai-may-tinh-bang,273175604,"Máy đọc sách Boox Note Air 3 C - Hàng Chính Hãng",14390000,15990000,1600000,10
TIKI,dien-thoai-may-tinh-bang,275589968,"Điện thoại Nokia 3210 4G - Hàng chính hãng",1590000,1590000,0,0
TIKI,dien-thoai-may-tinh-bang,272328188,"Điện Thoại Samsung A05 4GB/128GB - Hàng Chính Hãng",2794000,2794000,0,0
TIKI,dien-thoai-may-tinh-bang,274037360,"Điện Thoại POCO C65 (6GB/128GB) - Hàng Chính Hãng",2690000,3090000,400000,13
TIKI,dien-thoai-may-tinh-bang,274095168,"Điện thoại Xiaomi Redmi A2+ (3GB/64GB) - Hàng Chính Hãng",1850000,2790000,940000,34
TIKI,dien-thoai-may-tinh-bang,215746882,"Điện thoại OPPO Reno8T 4G - Hàng chính hãng",8136000,8136000,0,0
TIKI,dien-thoai-may-tinh-bang,274839974,"Máy tính bảng Samsung Galaxy Tab S9 FE Wifi 6GB/128GB - Hàng chính hãng",8990200,9990200,1000000,10
TIKI,dien-thoai-may-tinh-bang,16518729,"Điện thoại để bàn Panasonic KX-TS580 hàng chính hãng",850000,850000,0,0
TIKI,dien-thoai-may-tinh-bang,273958619,"Điện Thoại Xiaomi Redmi Note 13 6GB-128GB - Hàng chính hãng",4027000,4890000,863000,18
TIKI,dien-thoai-may-tinh-bang,225936344,"Máy tính bảng Samsung Galaxy Tab A8 (4GB/64GB) - Hàng Chính Hãng",5856000,5856000,0,0
TIKI,dien-thoai-may-tinh-bang,274800490,"Điện thoại Xiaomi Redmi A3 (4GB/128GB) - Hàng Chính Hãng",2350000,2990000,640000,21
TIKI,dien-thoai-may-tinh-bang,272392928,"Điện thoại Samsung Galaxy A05 (4GB/128GB) - Hàng chính hãng - ĐÃ KÍCH HOẠT BẢO HÀNH ĐIỆN TỬ",2794000,2794000,0,0
TIKI,dien-thoai-may-tinh-bang,273947792,"Điện thoại AI Samsung Galaxy S24 Ultra 12GB/256GB, Camera 200MP Zoom 100x, S Pen- Tím- Hàng Chính Hãng",25990000,34490000,8500000,25
TIKI,dien-thoai-may-tinh-bang,273029857,"Điện Thoại Samsung Galaxy A05s (4GB/128GB) - Hàng Chính Hãng",3625000,3625000,0,0
TIKI,dien-thoai-may-tinh-bang,275254316,"Điện thoại POCO M6 (6GB/128GB) - Hàng Chính Hãng",3690000,4290000,600000,14
TIKI,dien-thoai-may-tinh-bang,274904904,"Máy tính bảng Samsung Galaxy Tab A9 Wifi / LTE (4GB/64GB) - Hàng chính hãng",2799000,3990000,1191000,30
TIKI,dien-thoai-may-tinh-bang,270814412,"Điện thoại Tecno CAMON 20 Premier 5G - 8GB/512GB | Dimensity 8050| Cụm Camera 108+50+ 2MP | AMOLED - Tần số quét 120Hz - Hàng chính hãng",9390000,11990000,2600000,22
TIKI,dien-thoai-may-tinh-bang,275042829,"Apple iPad Pro M4 11-Inch Wi-Fi",26990000,28990000,2000000,7
TIKI,dien-thoai-may-tinh-bang,263798932,"Máy đọc sách Boox Page - Hàng Chính Hãng",6650000,7990000,1340000,17
TIKI,dien-thoai-may-tinh-bang,275152276,"Điện thoại Tecno Spark 20 Pro+ (8+8)GB/256GB - Hàng Chính Hãng",5149000,5490000,341000,6
TIKI,dien-thoai-may-tinh-bang,263041214,"Điện thoại Gaming Tecno POVA 4 8GB/128GB - Hàng Chính Hãng - MediaTek G99 | 6000mAh - 6.82 inch - Bảo hành 13 Tháng",3514000,4690000,1176000,25
TIKI,dien-thoai-may-tinh-bang,274101255,"Máy Tính Bảng Samsung Galaxy Tab A9 Wifi 4GB/64GB - Hàng Chính Hãng",2590000,3990000,1400000,35
TIKI,dien-thoai-may-tinh-bang,252427658,"Điện thoại Tecno SPARK 10 Pro 8GB/128GB - Helio G88 | 5000 mAh | Sạc nhanh 18W | Cảm ứng vân tay - Hàng chính hãng",3544000,3990000,446000,11
TIKI,dien-thoai-may-tinh-bang,275543365,"Điện thoại Samsung Galaxy Z Fold 6 12GB/256GB - Độc quyền online - Hàng chính hãng",43985000,43990000,5000,0
TIKI,dien-thoai-may-tinh-bang,271972435,"iPhone 15 Pro 128GB Titan Xanh",23990000,27990000,4000000,14
TIKI,dien-thoai-may-tinh-bang,271530789,"Combo Máy đọc sách All New Kindle Paperwhite 5 (11th) KIDS EDITTION (KHÔNG QUẢNG CÁO) và Bao da - Hàng chính hãng",4190000,4190000,0,0
TIKI,dien-thoai-may-tinh-bang,214756058,"Máy đọc sách New Kindle 11th 2022 (16GB) - Hàng chính hãng",2890000,3190000,300000,9
TIKI,dien-thoai-may-tinh-bang,198868573,"Điện thoại IP Grandstream GRP 2601P hàng chính hãng",1050000,1050000,0,0
TIKI,dien-thoai-may-tinh-bang,188030974,"Máy tính bảng Oukitel RT1 - hàng chính hãng  (chống nước,chống va đập , pin khủng,pin 10.000mAh,màn hình 10,1 inch,Ram 4Gb,Rom 64Gb,tám nhân,học online)",6990000,6990000,0,0
TIKI,dien-thoai-may-tinh-bang,217158529,"Máy tính bảng Samsung Galaxy Tab A7 Lite - Hàng chính hãng",3587000,3587000,0,0
TIKI,dien-thoai-may-tinh-bang,274908645,"Ulefone Armor 16S (loa toHiFi 122dB ,NFC, chống nước,chống sốc,Ram 16GB,rom128GB ,Camera 50MP,pin 9600mAh,Màn hình 5.93 inch)- hàng chính hãng",4990000,4990000,0,0
TIKI,dien-thoai-may-tinh-bang,254125720,"Điện thoại oukitel WP22 (Loa to,Chống nước ,chống sốc IP68/IP69K,Ram 13Gb(8GB+5Gb mở rộng),Rom 256Gb,Màn hình 6.58 FHD,tầm nhìn ban đêm,Pin 10.000mAh)- Hàng chính hãng",5990000,5990000,0,0
TIKI,dien-thoai-may-tinh-bang,274958868,"Samsung Galaxy Tab S9 Wifi 12GB/256GB - Hàng chính hãng",21990000,21990000,0,0
TIKI,dien-thoai-may-tinh-bang,275254310,"Điện thoại POCO M6 (8GB/256GB) - Hàng Chính Hãng",4550000,5290000,740000,14
TIKI,dien-thoai-may-tinh-bang,274541336,"Điện thoại vivo Y03 (4GB+64GB) - Hàng chính hãng",2990000,2990000,0,0
TIKI,dien-thoai-may-tinh-bang,252884932,"Tay con điện thoại bàn Panasonic TGCA30- Hàng chính hãng-Chỉ xài được khi đã có máy mẹ",750000,750000,0,0
TIKI,dien-thoai-may-tinh-bang,249956458,"Điện thoại Xiaomi Redmi Note 12 (4GB/128GB) - Hàng chính hãng",3600000,3600000,0,0
TIKI,dien-thoai-may-tinh-bang,126682340,"Điện thoại Xiaomi Redmi 10 (4GB/128GB) - Hàng chính hãng",4290000,4290000,0,0
TIKI,dien-thoai-may-tinh-bang,249730334,"Điện Thoại Masstel Izi 20 4G LTE - 2 sim -Pin 1700 mAh - Loa To - Camera 0.08 MP - Hàng Chính Hãng - Bảo Hành 12 Tháng",512000,512000,0,0
TIKI,dien-thoai-may-tinh-bang,271284934,"Máy tính bảng Edutab 10.4 & Case da tặng Quà hot Hệ thống quản lý học tập & kiểm soát dành cho Phụ huynh trọn đời - Hàng Chính Hãng",5769000,5769000,0,0
TIKI,dien-thoai-may-tinh-bang,248929458,"Điện thoại Samsung Galaxy A34 5G (8GB/128GB) - Hàng chính hãng",7164000,7164000,0,0
TIKI,dien-thoai-may-tinh-bang,271368354,"Điện thoại di động Nokia 105 4G Pro - Hàng chính hãng",699000,699000,0,0
TIKI,dien-thoai-may-tinh-bang,172920927,"Điện thoại Masstel izi 12 4G - Hàng chính hãng",456000,456000,0,0
TIKI,dien-thoai-may-tinh-bang,271822725,"Máy Tính Bảng Samsung Galaxy Tab A8 2022 (3GB/32GB) - Hàng Chính Hãng",5856000,5856000,0,0
TIKI,dien-thoai-may-tinh-bang,181927774,"Điện thoại bàn Panasonic KX-TGD310 hàng chính hãng",1230000,1230000,0,0
TIKI,dien-thoai-may-tinh-bang,118136229,"Điện thoại Panasonic KX-TGD312CX -Hàng chính hãng",1999000,1999000,0,0
TIKI,dien-thoai-may-tinh-bang,271329051,"Máy tính bảng Kindle Fire MAX 11, màn hình 11 inch, RAM 4GB, CPU Octa-core 2.2Ghz, bộ nhớ 64/128GB - Hàng chính hãng",5500000,5500000,0,0
TIKI,dien-thoai-may-tinh-bang,263117493,"Điện thoại di động Masstel Izi 30 (new) - Hàng chính hãng",599000,599000,0,0
TIKI,dien-thoai-may-tinh-bang,275386982,"Điện Thoại Nokia 220 4G - Hàng Chính Hãng",979000,990000,11000,1
TIKI,dien-thoai-may-tinh-bang,170449059,"Điện Thoại Masstel Izi 20 4G - Loa To, Pin Trâu, 2 Sim 2 Sóng, Hỗ Trợ 4G VoLTE, Đèn Pin Sáng, Giá Rẻ - Hàng Chính Hãng",488000,489000,1000,0
TIKI,dien-thoai-may-tinh-bang,221518066,"Máy đọc sách Kindle Oasis 3 10th - Hàng nhập khẩu",6789000,6789000,0,0
TIKI,dien-thoai-may-tinh-bang,195894801,"Masstel izi 26 4G - Chữ to - Loa to - Hàng Chính Hãng",600000,600000,0,0
TIKI,dien-thoai-may-tinh-bang,248005118,"Điện Thoại Samsung Galaxy A34 5G (8GB/128GB) - Hàng Chính Hãng",7164000,7164000,0,0
TIKI,dien-thoai-may-tinh-bang,217548686,"Máy đọc sách Kindle Scribe – thế hệ đầu tiên có thể đọc và viết, màn hình 10,2” 300PPI, đèn vàng warmlight, bộ nhớ 16-64GB, đồng bộ dữ liệu qua Microsoft Word - hàng nhập khẩu",11150000,11150000,0,0
TIKI,dien-thoai-may-tinh-bang,274524050,"Điện thoại Masstel izi T2 4G(LTE), Màn hình 2.4 inch, Đèn pin siêu sáng, Loa to - Hàng chính hãng",489000,550000,61000,11
TIKI,dien-thoai-may-tinh-bang,217505504,"Máy tính bảng Kindle Fire HD8 PLUS 2022 (Fire HD 8 12th) - Màn hình 8inch HD, RAM 3GB, CPU Hexa-core 2.0 GHz, CÀI ĐƯỢC CH PLAY- Hàng nhập khẩu",2790000,2790000,0,0
TIKI,dien-thoai-may-tinh-bang,195177036,"Máy tính bảng Samsung Galaxy Tab A7 Lite LTE SM-T225 - Hàng Chính Hãng",3587000,3587000,0,0
TIKI,dien-thoai-may-tinh-bang,198648645,"Điện thoại Xiaomi Redmi A1 (2GB/32GB)",2190000,2190000,0,0
TIKI,dien-thoai-may-tinh-bang,274415640,"Điện Thoại Xiaomi Redmi Note 13 Pro 8GB/128GB - Hàng Chính Hãng",6159000,7290000,1131000,16
TIKI,dien-thoai-may-tinh-bang,249143473,"Điện thoại Samsung Galaxy A34 5G (8GB/128GB) - Hàng chính hãng - ĐÃ KÍCH HOẠT BẢO HÀNH ĐIỆN TỬ",7164000,7164000,0,0
TIKI,dien-thoai-may-tinh-bang,271451188,"Điện thoại Xiaomi Redmi A2| IPS LCD 6.52" HD+| MediaTek Helio G36| 5000 mAh - Hàng chính hãng",1759000,1769000,10000,1
TIKI,dien-thoai-may-tinh-bang,271954384,"Điện thoại OPPO A58 6GB/128GB , Sạc nhanh 33W - Hàng Chính Hãng",4099000,4990000,891000,18
TIKI,dien-thoai-may-tinh-bang,271467653,"Điện thoại Realme C51 (4GB/128GB) - Hàng chính hãng",2969000,3990000,1021000,26
TIKI,dien-thoai-may-tinh-bang,230203067,"Điện thoại OPPO A55s 5G 4GB/64GB - Màn 90hz - Chống nước IP68 - Hàng nhập khẩu - Bản quốc tế",2859000,3699000,840000,23
TIKI,dien-thoai-may-tinh-bang,204066551,"Điện thoại Samsung Galaxy A04 (3GB/32GB) - Hàng chính hãng",2400000,2400000,0,0
TIKI,dien-thoai-may-tinh-bang,217505430,"Máy tính bảng Kindle Fire HD8 2022 (Fire HD 8 12th) - Màn hình 8inch HD, RAM 2GB, CPU Hexa-core 2.0 GHz, CÀI ĐƯỢC CH PLAY- Hàng nhập khẩu",2050000,2050000,0,0
TIKI,dien-thoai-may-tinh-bang,273990229,"Điện Thoại Xiaomi Redmi Note 13 6GB/128GB - Hàng Chính Hãng",4139000,4890000,751000,15
TIKI,dien-thoai-may-tinh-bang,171685825,"Điện thoại Nokia 105 4G -  chính hãng - Đen",690000,690000,0,0
TIKI,dien-thoai-may-tinh-bang,217645692,"Combo Máy đọc sách All New Kindle Paperwhite 5 (11th Gen) - 16Gb và Bao da - Hàng nhập khẩu",4080000,4190000,110000,3
TIKI,dien-thoai-may-tinh-bang,225912504,"Điện Thoại Forme D111 - Hàng Chính Hãng",499000,519000,20000,4
TIKI,dien-thoai-may-tinh-bang,272850971,"Điện thoại Libero 5G III - 4/64GB Dimensity 700 ,Màn OLED ,Kháng nước IP57 - Hàng nhập khẩu nhật",2189000,2990000,801000,27
TIKI,dien-thoai-may-tinh-bang,273412211,"Điện thoại Xiaomi Redmi 13C (4+128GB) | 6.74" 90Hz| Media Tek Helio G85| 5000mAh - Hàng chính hãng",2689000,3290000,601000,18
TIKI,dien-thoai-may-tinh-bang,275177234,"Điện thoại Realme C67 (8GB/128GB) - Hàng Chính Hãng",3990000,5290000,1300000,25
TIKI,dien-thoai-may-tinh-bang,273258825,"Điện thoại Samsung Galaxy A05s (4GB/128GB) - Đã kích hoạt bảo hành điện tử - Hàng chính hãng",3625000,3625000,0,0
TIKI,dien-thoai-may-tinh-bang,270814316,"Điện thoại Tecno POVA 5 (8+8)/256GB - MediaTek Helio G99 - Sạc nhanh 45W - 6.8'' FHD+120HZ - Hàng Chính Hãng -  BH 13 Tháng",4479000,5290000,811000,15
TIKI,dien-thoai-may-tinh-bang,272394241,"Điện thoại Samsung Galaxy A05s (4Gb/128Gb) - Hàng chính hãng - Đã kích hoạt bảo hành điện tử",3335000,3335000,0,0
TIKI,dien-thoai-may-tinh-bang,273357326,"Điện thoại Xiaomi Redmi 13C (6GB/128GB) - Hàng chính hãng",3119000,3490000,371000,11
TIKI,dien-thoai-may-tinh-bang,274610380,"Điện thoại Samsung Galaxy S24 8GB/256GB - Độc quyền Online - Hàng chính hãng",21985000,22990000,1005000,4
TIKI,dien-thoai-may-tinh-bang,275571990,"Điện thoại Samsung Galaxy Z Flip6, điện thoại AI, 512GB, pin lớn nhất, Flexcam 50MP - Hàng chính hãng",31990000,31990000,0,0
TIKI,dien-thoai-may-tinh-bang,275571989,"Điện thoại Samsung Galaxy Z Flip6, điện thoại AI, 256GB, pin lớn nhất, Flexcam 50MP - Hàng chính hãng",27990000,27990000,0,0
TIKI,dien-thoai-may-tinh-bang,274424330,"Điện thoại Người Già Good A60 Pro 4G (LTE) Gọi HD Call , Có SOS , Màn lớn - Phím to - Pin trâu - Sạc Type C - Hàng nhập khẩu",449000,490000,41000,8
TIKI,dien-thoai-may-tinh-bang,274625697,"Điện thoại Samsung Galaxy S24+ 12GB/512GB - Độc quyền Online - Hàng chính hãng",29490000,30490000,1000000,3
TIKI,dien-thoai-may-tinh-bang,274069052,"Điện Thoại Xiaomi Redmi Note 12 Pro 4G 8GB/256GB - Hàng Chính Hãng",5190000,7990000,2800000,35
TIKI,dien-thoai-may-tinh-bang,274638822,"Điện thoại Xiaomi Redmi Note 12 Turbo , Snapdragon 7 Gen 2 , Màn OLED 120Hz , Sạc nhanh 67W , Rom tiếng việt  - Hàng nhập khẩu",6399000,6690000,291000,4
TIKI,dien-thoai-may-tinh-bang,262706645,"Máy đọc sách kindle 2022 11th - hàng chính hãng",2990000,2990000,0,0
TIKI,dien-thoai-may-tinh-bang,274164375,"Máy Tính Bảng Samsung Galaxy Tab A9 Plus WIFI 4GB-64GB - Hàng chính hãng",3989000,5990000,2001000,33
TIKI,dien-thoai-may-tinh-bang,252073151,"Điện thoại Nokia 8210 4G - Hàng chính hãng - pin lâu - Bàn phím nút giá rẻ chỉ có tại Long Tâm Store",1415500,1415500,0,0
TIKI,dien-thoai-may-tinh-bang,270260682,"Điện thoại Gaming Tecno POVA 4 8GB/128GB - Hàng Chính Hãng - MediaTek G99 | 6000mAh - 6.82 inch - Bảo hành 13 Tháng",3490000,4690000,1200000,26
TIKI,dien-thoai-may-tinh-bang,272072274,"Combo Máy Đọc Sách reMarkable 2 và Bút Marker Plus - Hàng Chính Hãng",13770000,14990000,1220000,8
TIKI,dien-thoai-may-tinh-bang,275572013,"Điện thoại Samsung Galaxy Z Fold6, 256GB, điện thoại AI, màn hình cực đại 7.6", mỏng nhẹ nhất - Hàng chính hãng",42990000,42990000,0,0
TIKI,dien-thoai-may-tinh-bang,214603586,"Điện Thoại Samsung Galaxy A04e (3GB/32GB)- Hàng Chính Hãng",2099000,2690000,591000,22
TIKI,dien-thoai-may-tinh-bang,274869053,"Điện thoại cố định Panasonic KX-TS 500 (Đen, trắng, xanh, đỏ, xám) -Hàng Chính Hãng",289000,289000,0,0
TIKI,dien-thoai-may-tinh-bang,275571988,"Điện thoại Samsung Galaxy Z Fold6, 512GB, điện thoại AI, màn hình cực đại 7.6", mỏng nhẹ nhất - Hàng chính hãng",46990000,46990000,0,0
TIKI,do-choi-me-be,97551646,"Bộ 2 Lon Sữa Bột Friso Gold 4 1400g Dành Cho Trẻ Từ 2 - 6 Tuổi + Tặng Lon Sữa Friso Gold 4 380g",1400000,1770000,370000,21
TIKI,do-choi-me-be,1000534,"Sữa Bột Anlene Gold Movepro Hương Vanilla (Hộp Giấy 440g)",190000,204000,14000,7
TIKI,do-choi-me-be,59143353,"Combo Tiết Kiệm: 6 Gói Khăn Ướt Bobby Care Không Hương 100 Miếng/Gói",179000,284400,105400,37
TIKI,do-choi-me-be,20088686,"Sữa tắm gội toàn thân Johnson's Baby (500ml)",171000,171000,0,0
TIKI,do-choi-me-be,272847939,"Hạt nêm rau củ Massel Úc 100% từ rau củ thảo mộc bảo vệ sức khỏe, dành cho ăn chay, ăn mặn, ăn kiêng và cho bé ăn dặm - QuaTangMe Extaste",93000,186000,93000,50
TIKI,do-choi-me-be,116447512,"Sữa tắm Johnson's Baby chứa sữa và yến mạch (1000ml)",254000,254000,0,0
TIKI,do-choi-me-be,24028050,"Sữa bột Abbott Pediasure 1.6kg cho trẻ từ 1-10 tuổi",950000,1240250,290250,23
TIKI,do-choi-me-be,532984,"Combo 6 Khăn Ướt Unifresh Vitamin E 80M (80 Miếng)",132000,158394,26394,17
TIKI,do-choi-me-be,6840059,"Combo 2 Tã Dán Người Lớn SunMate G2 Size M10 (10 Miếng)",160000,182618,22618,12
TIKI,do-choi-me-be,1745009,"Tấm Đệm Lót Siêu Thấm Caryn (20 Miếng)",109000,128700,19700,15
TIKI,do-choi-me-be,169522868,"Bộ 2 chai sữa tắm Johnson's Baby cho bé - Dung Tích 1000mlx2",508000,508000,0,0
TIKI,do-choi-me-be,32030382,"Combo 12 Gói Khăn Ướt Huggies Cacao và Bơ Hạt Mỡ (72 Miếng/ Gói)",349000,408000,59000,14
TIKI,do-choi-me-be,1000540,"Sữa Bột Anlene Gold Movepro 3X Hương Vanilla (Hộp Thiếc 800g)",365000,410000,45000,11
TIKI,do-choi-me-be,498670,"Combo 2 Tã Dán Người Lớn SunMate G2 Size XL10 (10 Miếng)",218000,261164,43164,17
TIKI,do-choi-me-be,57044932,"Thùng 48 Hộp Sữa Nước Abbott Pediasure Vani 180ml cho trẻ từ 1 - 10 tuổi",1339000,1633728,294728,18
TIKI,do-choi-me-be,34537694,"Tã Dán Siêu Thấm Caryn Gói Siêu Tiết Kiệm M40 (40 Miếng)",339000,391600,52600,13
TIKI,do-choi-me-be,88949154,"Sữa Bột Friso Gold 4 1400g (Dành Cho Trẻ Từ 2 - 6 Tuổi)",705000,885000,180000,20
TIKI,do-choi-me-be,59143355,"Combo Tiết Kiệm: 6 Gói Khăn Ướt Bobby Care Bổ Sung 80 Miếng/Gói",149000,231000,82000,35
TIKI,do-choi-me-be,23957552,"Combo 2 Tã Quần Người Lớn Sunmate Mềm Mại L8 (8 Miếng)",170000,199998,29998,15
TIKI,do-choi-me-be,95269395,"Tã Quần Siêu Cao Cấp Huggies Platinum Nature Made L44 (44 Miếng)",280000,460000,180000,39
TIKI,do-choi-me-be,573673,"Thùng 48 Hộp Sữa Nước Abbott Grow Gold 180ml cho trẻ 1 tuổi trở lên",786000,904224,118224,13
TIKI,do-choi-me-be,19944395,"Tã Quần Moony Natural Bông Organic L36 (36 Miếng)",271000,569400,298400,52
TIKI,do-choi-me-be,135328953,"Sữa bột Nestlé NAN SupremePro 2 lon 800g nhập khẩu từ Đức với 5HMO & đạm Gentle Optipro (6 - 24 tháng)",585000,585000,0,0
TIKI,do-choi-me-be,413088,"Miếng Lót Sơ Sinh Bobby Fresh Newborn 2 - 40 (40 Miếng)",74900,98000,23100,24
TIKI,do-choi-me-be,19944385,"Tấm Đệm Lót Caryn Mỏng Nhẹ (14 Miếng)",96900,102900,6000,6
TIKI,do-choi-me-be,55512044,"Sữa Bột Anlene Gold Movepro 3X Hương Vanilla (Hộp Giấy 1,2kg)",460000,491000,31000,6
TIKI,do-choi-me-be,1000532,"Sữa Bột Anlene Gold Movepro Hương Chocolate (Hộp Giấy 440g)",201000,204000,3000,1
TIKI,do-choi-me-be,24026125,"Thùng 30 Chai Sữa Nước Abbott Glucerna Vani 220ml",1369000,1661550,292550,18
TIKI,do-choi-me-be,10054452,"Thùng 48 Hộp Sữa Bột Pha Sẵn Friso Gold Rtd Vani (48 Hộp X 110ml)",382000,505000,123000,24
TIKI,do-choi-me-be,23957447,"Combo 2 Tã Quần Người Lớn Sunmate Mềm Mại M9 (9 Miếng)",199998,199998,0,0
TIKI,do-choi-me-be,57044926,"Thùng 48 Hộp Sữa Nước Abbott Pediasure Vani 110ml cho trẻ từ 1 - 10 tuổi",920000,1111824,191824,17
TIKI,do-choi-me-be,88949152,"Sữa Bột Frisolac Gold 3 1400g (Dành Cho Trẻ Từ 1 - 2 Tuổi)",680000,680000,0,0
TIKI,do-choi-me-be,35043572,"Thùng 48 Hộp Sữa Nước Abbott Similac 110ml cho trẻ từ 1 tuổi",589000,699600,110600,16
TIKI,do-choi-me-be,134516823,"Combo 2 túi nước xả vải cho bé Comfort cho da nhạy cảm với công thức riêng dịu nhẹ 100% nguồn gốc thực vật - túi 3.8L",442000,570000,128000,22
TIKI,do-choi-me-be,88924594,"Sữa Bột Frisolac Gold 1 850g Dành Cho Trẻ Từ 0 - 6 Tháng Tuổi",494000,494000,0,0
TIKI,do-choi-me-be,117836946,"[Mới] Hộp giấy 2 Kg Frisolac Gold 3",875000,875000,0,0
TIKI,do-choi-me-be,435762,"Sữa Bột Abbott Grow Gold 3+ cho trẻ từ 3 - 6 tuổi (1.7Kg)",684000,781380,97380,12
TIKI,do-choi-me-be,95269420,"Tã Quần Huggies Platinum Nature Made Size M (58 Miếng)",280000,460000,180000,39
TIKI,do-choi-me-be,159387940,"Đai đi xe máy cho bé phản quang, thoáng khí sử dụng khóa 2 cấp bền chắc, chống bui bẩn",122000,179000,57000,32
TIKI,do-choi-me-be,130461479,"Sữa Bột Similac Einstein 4 cho trẻ từ 2 - 6 tuổi",465000,547560,82560,15
TIKI,do-choi-me-be,453774,"Kem Dưỡng Da Chứa Sữa Và Gạo Johnson’s Baby 20309343 (50g)",66000,66000,0,0
TIKI,do-choi-me-be,249054309,"Sữa Ensure Vanila Úc cho người già, người suy dinh dưỡng, cấp đầy đủ dinh dưỡng giúp hồi phục sức khỏe - Massel Official (850g/lon)",1108000,2216000,1108000,50
TIKI,do-choi-me-be,47961612,"Combo 2 Que Thử Thai QuickStick",40000,40000,0,0
TIKI,do-choi-me-be,543122,"Nước Giặt Quần Áo Em Bé D-nee Hương Lavender 3L - [8851989061535]",209000,245000,36000,15
TIKI,do-choi-me-be,68268748,"Viên sắt, acid folic, DHA, vitamin & khoáng chất Fe-NANA - Hộp 20 viên",65000,110000,45000,41
TIKI,do-choi-me-be,182709739,"Combo 2 Sữa tắm gội dịu lành cho bé Cetaphil Baby Gentle Wash & Shampoo 400ml/chai",542000,542000,0,0
TIKI,do-choi-me-be,115483450,"Sữa bột Enfamil A+ NeuroPro 2 với 2’-FL HMO cho trẻ từ 6 –12  tháng tuổi– 2.2kg",1209000,1209000,0,0
TIKI,do-choi-me-be,17888580,"Cờ Vua Cao Cấp miDoctor (Chính Hãng) - NHỎ 3810A:  25 x 25 x 2 cm - Hàng chính hãng",92000,92000,0,0
TIKI,do-choi-me-be,168663291,"Sữa bột Nestlé NAN INFINIPRO A2 1 cho trẻ từ 0-12 tháng tuổi hộp 800g nhập khẩu nguyên lon từ Thụy Sỹ",699000,699000,0,0
TIKI,do-choi-me-be,77858363,"Nước Súc Miệng Listerine Kids dành riêng cho trẻ trên 6 tuổi 250ml - ",55000,55000,0,0
TIKI,do-choi-me-be,135328955,"Sữa Bột Nestlé NAN SupremePro 1 lon 400g với 5HMO & đạm Gentle Optipro nhập khẩu nguyên lon từ Đức",295000,295000,0,0
TIKI,do-choi-me-be,95269446,"Tã Dán Siêu Cao Cấp Huggies Platinum Naturemade L54 (54 Miếng)",280000,460000,180000,39
TIKI,do-choi-me-be,168662602,"Sữa bột NAN INFINIPRO A2 Thụy Sĩ 3 800g với đạm quý A2 tiêu hóa tốt sau 7 ngày và 5HMO tăng cường đề kháng (2 - 6 tuổi)",535000,600000,65000,11
TIKI,do-choi-me-be,146556777,"Cờ Vua Gỗ - Cờ Vua Cao Cấp - Đồ Chơi Bằng Gỗ Tự Nhiên - Chính hãng dododios",161000,161000,0,0
TIKI,do-choi-me-be,61292593,"Combo 4 Gói Khăn Ướt Yuniku 90 Tờ Hương Lài ( 90 tờ x 4 )",167200,167200,0,0
TIKI,do-choi-me-be,48964146,"Set 2 Khăn Tắm Em Bé Sợi Tre Bonny Siêu Mềm Và Thấm Hút (KT: 1m2x1m2) - Giao họa tiết ngẫu nhiên",184000,190000,6000,3
TIKI,do-choi-me-be,82525136,"Combo 3 lon Sữa Morinaga số 2 Chilmil 850g và 1 lon sữa Morinaga số 2 320gr dành cho bé từ 6-36 tháng tuổi",1450000,1450000,0,0
TIKI,do-choi-me-be,7827140,"Chất thông tắc bồn cầu toilet chống hôi Siêu tốc 5 phút Sifa (1400g)",50000,50000,0,0
TIKI,do-choi-me-be,147246867,"Sữa Bột Anlene Gold 5X Hương Vanilla (Hộp Thiếc 400g)",262000,268000,6000,2
TIKI,do-choi-me-be,158887692,"Đồ chơi lắp ráp, xếp hình Qman 1801 - Trực thăng chiến đấu - 381 mảnh ghép",179000,269000,90000,33
TIKI,do-choi-me-be,88949156,"Sữa Bột Friso Gold 4 850g (Dành Cho Trẻ Từ 2 - 6 Tuổi)",461000,600000,139000,23
TIKI,do-choi-me-be,25027164,"Combo 2 Gói Tã Quần Người Lớn Sunmate Khô Thoáng L7 (7 Miếng/ Gói)",199998,199998,0,0
TIKI,do-choi-me-be,84705786,"Gạc Rơ Lưỡi, Vệ Sinh Răng Miệng Cho Bé Dr Papie (1 hộp 30 gói)",109000,109000,0,0
TIKI,do-choi-me-be,173164598,"Sữa Bột Anlene Gold 5X Hương Vanilla (Hộp Thiếc 800g)",475000,508000,33000,6
TIKI,do-choi-me-be,88949150,"Sữa Bột Frisolac Gold 3 850g (Dành Cho Trẻ Từ 1 - 2 Tuổi)",454000,454000,0,0
TIKI,do-choi-me-be,35043549,"Thùng 48 Hộp Sữa Nước Abbott Similac 180ml cho trẻ từ 1 tuổi",844000,1003200,159200,16
TIKI,do-choi-me-be,68925517,"Cháo Tươi Tôm Rau Ngót Cây Thị",21000,25000,4000,16
TIKI,do-choi-me-be,115483434,"Sữa bột Enfamil A+ NeuroPro 2 với 2’-FL HMO cho trẻ từ 6 –12  tháng tuổi– 1.7kg",979000,979000,0,0
TIKI,do-choi-me-be,114958267,"Bộ Bài Tình Yêu Game Card Lovetouch - Love card game, board games, bài cho cặp đôi, bài thấu hiểu [Kim Ngọc Thuỷ]",150000,300000,150000,50
TIKI,do-choi-me-be,52774130,"Bộ 2 chai chất thông tắc Cầu, Cống Sifa chống hôi Siêu nhanh Siêu mạnh 5 phút",109000,109000,0,0
TIKI,do-choi-me-be,2173355,"Combo 5 Bịch Khăn Vải Khô Likado (300g)",169000,169000,0,0
TIKI,do-choi-me-be,19944398,"Tã Quần Moony Natural Bông Organic M46 (46 Miếng)",268000,569400,301400,53
TIKI,do-choi-me-be,967305,"Sữa Bột Abbott Similac Mom Vani 900g",425000,493020,68020,14
TIKI,do-choi-me-be,175953065,"Combo 4 Tã Dán Người Lớn SunMate G2 size M10, M/L10, XL10, M/L18",344000,420220,76220,18
TIKI,do-choi-me-be,49600080,"Xốp Bong Bóng Gói Hàng Khổ 1 Mét 4",31000,32000,1000,3
TIKI,do-choi-me-be,49884598,"Sữa Morinaga Số 2 - Chilmil (850g) dành cho bé từ 6 đến 36 tháng tuổi",513000,578000,65000,11
TIKI,do-choi-me-be,105901380,"Vitamin k2 d3 hỗ trợ tăng chiều cao, hết còi xương cho trẻ sơ sinh - LINEABON K2D3 - Sản phẩm từ Châu Âu - Công nghệ mới giúp hấp thu tối đa canxi tự nhiên",284000,284000,0,0
TIKI,do-choi-me-be,184597571,"Đồ chơi lắp ráp, xếp hình Qman 4801 - Phòng của bé gái (194 mảnh ghép) - Dành cho bé từ 6 tuổi",149000,249000,100000,40
TIKI,do-choi-me-be,175953079,"Combo 4 Gói Tã Quần Người Lớn SunMate Khô Thoáng",359000,399996,40996,10
TIKI,do-choi-me-be,146555381,"Đồ Chơi Rút Gỗ Trẻ Em - 2 Cỡ (Lớn và Nhỏ) - 54 Thanh Rút Gỗ Kèm 4 Con Súc Sắc Cho Bé – Bộ Đồ Chơi Rút Gỗ Cao Cấp Chính Hãng dododios",63000,63000,0,0
TIKI,do-choi-me-be,6632811,"Cháo Tươi Thịt Heo Bí Đỏ Cây Thị",17000,21000,4000,19
TIKI,do-choi-me-be,61285745,"Combo 4 Gói Khăn Ướt Yuniku 90 Tờ Không Hương ( 90 tờ x 4 )",167200,167200,0,0
TIKI,do-choi-me-be,19944439,"Tã Dán Moony Natural Bông Organic M46 (46 Miếng)",271000,569400,298400,52
TIKI,do-choi-me-be,61290431,"Combo 4 Gói Khăn Ướt Yuniku 90 Tờ Hương Phấn ( 90 tờ x 4 )",167200,167200,0,0
TIKI,do-choi-me-be,57044918,"Thùng 24 Chai Sữa Nước Abbott Pediasure Vani 237ml cho trẻ từ 1-10 tuổi",929000,1033200,104200,10
TIKI,do-choi-me-be,20088701,"Dầu gội Johnson's Baby dịu nhẹ (800ml)",192000,192000,0,0
TIKI,do-choi-me-be,88928273,"Combo 10 Gói Khăn Ướt Trẻ Em MAMAMY 100 Tờ",294000,294000,0,0
TIKI,do-choi-me-be,167128613,"Tã dán êm mềm khô thoáng Bobby M46",184000,222600,38600,17
TIKI,do-choi-me-be,17114404,"Sữa tắm gội toàn thân Johnson's Baby mềm mịn (500ml)",196000,196000,0,0
TIKI,do-choi-me-be,435891,"Sữa Bột Abbott Glucerna Vani 850g",890000,890000,0,0
TIKI,do-choi-me-be,130461472,"Sữa Bột Similac Einstein 3 cho trẻ 1 – 2 tuổi",535000,548000,13000,2
TIKI,do-choi-me-be,152469540,"Ghép Hình Lực Lượng Cảnh Sát - Xe Tuần Tra 158 Chi Tiết DK81063",81000,108000,27000,25
TIKI,do-choi-me-be,274694402,"Tã Quần Mỏng Nhẹ Caryn Gói Siêu Lớn M16",175000,175000,0,0
TIKI,do-choi-me-be,25769067,"Cờ Vua Nam Châm Cỡ Lớn miDoctor 4812A",175000,175000,0,0
TIKI,do-choi-me-be,88928340,"Combo 10 khăn ướt Mamamy ( 80 tờ )",300000,300000,0,0
TIKI,do-choi-me-be,543129,"Nước Giặt Quần Áo Cho Bé D-Nee - Chai 3000ml (Xanh)",184000,245000,61000,25
TIKI,do-choi-me-be,10054502,"Thùng 48 Hộp Sữa Bột Pha Sẵn Friso Gold Rtd Vani (48 x 180Ml)",602000,807000,205000,25
TIKI,do-choi-me-be,10021552,"Sữa Bột Meiji 0-1 Infant Formula (800g)",519000,519000,0,0
TIKI,do-choi-me-be,53210144,"Bộ 2 Gói Nước Rửa Bình Sữa D-nee (550ml x 2)",105000,105000,0,0
TIKI,do-choi-me-be,104131972,"Núm vú cổ rộng silicone siêu mềm Plus Pigeon 2 Cái/Vỉ",120000,199000,79000,40
TIKI,do-choi-me-be,6464021,"Cháo Tươi Cá Lóc Đậu Xanh Cây Thị",21000,25000,4000,16
TIKI,do-choi-me-be,29540357,"Đồ chơi lắp ghép xếp hình  Trực thăng chiến đấu 8 trong 1 Qman 1801",229000,229000,0,0
TIKI,do-choi-me-be,85239904,"Cuộn Xốp Bọc Cạnh Bàn 2M - Dây Cao Su Che Bịt Cạnh Bàn, Ghế An Toàn Cho Bé",55000,55000,0,0
TIKI,do-choi-me-be,76072139,"Xe công trình xây dựng bằng kim loại  KAVY gồm 6 xe chi tiết sắc sảo, an toàn cho bé, dùng làm đồ chơi trẻ em hoặc trang trí",129000,129000,0,0
TIKI,do-choi-me-be,170331247,"Gạc Rơ Lưỡi Oribebe Vệ Sinh Răng Miệng Cho Bé Hộp 30 Gói",113000,165000,52000,32
TIKI,do-choi-me-be,43191091,"Thùng 48 Hộp Sữa Anlene Đậm Đặc 4X Ít Béo Hương Vani (12 x 4 x 125 ml)",523000,552000,29000,5
TIKI,do-choi-me-be,91205731,"Đồ chơi xếp hình, lắp ráp Qman 1411 - Tàu tuần dương biển (700 mảnh ghép)",355000,459000,104000,23
TIKI,do-choi-me-be,76507811,"Đồ Chơi Rút Gỗ Trẻ Em - 2 Cỡ (Lớn và Nhỏ) - 54 Thanh Rút Gỗ Kèm 4 Con Súc Sắc Cho Bé – Bộ Đồ Chơi Rút Gỗ Cao Cấp Chính Hãng Amalife",39000,39000,0,0
TIKI,do-choi-me-be,71080136,"Sure Prevent Gold HT 900g",560000,560000,0,0
TIKI,do-choi-me-be,270845223,"Sữa cho bé 1 đến 3 tuổi Meiji nội địa Nhật giúp bé phát triển cân đối chiều cao, cân nặng, trí não - QuaTangMe Extaste",529000,1058000,529000,50
TIKI,do-choi-me-be,53039237,"Combo 2 Túi Nước rửa bình sữa Arau Baby (450ml x 2 túi)",229000,229000,0,0
TIKI,do-choi-me-be,168779219,"Bàn Chải Đánh Răng Silicon Hình Chữ U Cho Trẻ Em - Bàn Chải Tập Đánh Răng Cho Bé Từ 2 - 6 Tuổi - Hàng Chính Hãng MINIIN",32000,32000,0,0
TIKI,do-choi-me-be,34537693,"Tã Dán Siêu Thấm Caryn Gói Siêu Tiết Kiệm L40 (40 Miếng)",390000,444000,54000,12
TIKI,do-choi-me-be,95082968,"Sữa bột Enfamil A2 Neuropro 2 cho trẻ từ 6 - 12 tháng tuổi – 800g",722000,722000,0,0
TIKI,do-choi-me-be,6464033,"Cháo Tươi Rau Củ Thập Cẩm Cây Thị",18690,22000,3310,15
TIKI,do-choi-me-be,6464017,"Cháo Tươi Cá Hồi Rong Biển Cây Thị",26000,26000,0,0
TIKI,do-choi-me-be,249030271,"Ensure Úc sữa cho người lớn Giúp hồi phục sức khỏe cho người gầy yếu, người suy dinh dưỡng - QuaTangMe Extaste",2216000,2216000,0,0
TIKI,do-choi-me-be,95035819,"Bột ăn dặm dinh dưỡng Sữa - Ăn dặm khởi đầu HiPP Organic 250g",145000,145000,0,0
TIKI,do-choi-me-be,109882431,"BẤM MÓNG TAY AN TOÀN CHO TRẺ SƠ SINH NUK DÙNG CHO BÉ TỪ 0 THÁNG TUỔI",59000,69000,10000,14
TIKI,do-choi-me-be,97846795,"Set 5 Khăn Rửa Mặt 4 Lớp Sợi Tre Lụa Mềm, Thấm Hút Tốt, Kháng Khuẩn 100% Thương Hiệu Bonny (KT: 30x30 Cm)",96040,98000,1960,2
TIKI,do-choi-me-be,95269416,"Tã Dán Siêu Cao Cấp Huggies Platinum Naturemade M64 (64 Miếng)",280000,460000,180000,39
TIKI,do-choi-me-be,17459641,"Hộp xếp hình lắp ráp sáng tạo 460 chi tiết Qman 2901",175000,214000,39000,18
TIKI,do-choi-me-be,214238333,"Sữa tăng chiều cao và tăng cân cho trẻ Milo Úc và A2 Full Cream High In Calcium Úc - Chống loãng xương ở người lớn, tăng sức khỏe tổng thể - Massel Official",511000,1022000,511000,50
TIKI,do-choi-me-be,196757806,"Set 2 Miếng Silicon Bọc Góc Bàn, Góc Tủ, Cạnh Giường Giữ An Toàn Cho Bé",17900,17900,0,0
TIKI,do-choi-me-be,150385649,"Đồ chơi khoa học kính hiển vi cầm tay chính hãng TOPBRIGHT",349000,499000,150000,30
TIKI,do-choi-me-be,25026925,"Combo 2 Gói Tã Quần Người Lớn Sunmate Khô Thoáng M8 (8 Miếng/ Gói)",170000,199998,29998,15
TIKI,do-choi-me-be,54477959,"Đồ chơi trẻ em bằng nhựa ABS Vô Lăng Tập Lái Cho Bé Có 2 màu cho bé trai và gái",219000,300000,81000,27
TIKI,do-choi-me-be,146499353,"Bộ Bài Tây Poker Nền Đen Cao Cấp Chọn Màu – Bài Tây Đen Bằng Nhựa PVC Chống Thấm Nước Chống Gập Chính Hãng Dododios",40000,40000,0,0
TIKI,do-choi-me-be,164075691,"Tả quần Kitin Natural size L40 (9-14kg)",154000,225000,71000,32
TIKI,do-choi-me-be,115483438,"Sữa bột Enfamil A+ NeuroPro 1 với 2’-FL HMO cho trẻ từ 0 – 6 tháng tuổi– 830g",558000,558000,0,0
TIKI,do-choi-me-be,105356858,"Sữa Bột Meiji 0-1 Infant Formula (800g)",585000,585000,0,0
TIKI,do-choi-me-be,95269415,"Tã Dán Siêu Cao Cấp Huggies Platinum Naturemade NB60 (60 Miếng)",145000,305000,160000,52
TIKI,do-choi-me-be,116448455,"Nước hoa Johnson's Baby Cho Bé - Dung Tích 125ml",87000,87000,0,0
TIKI,do-choi-me-be,125628724,"Cờ Tỉ Phú Monopoly – Cờ Tỷ Phú Vui Nhộn Cao Cấp, An Toàn Cỡ Cực Đại 42x42 – Hàng Chính Hãng",93000,93000,0,0
TIKI,do-choi-me-be,20088699,"Dầu dưỡng ẩm mát xa Johnson's Baby (200ml)",115000,115000,0,0
TIKI,do-choi-me-be,115483446,"Sữa bột Enfagrow A+ NeuroPro 3 với 2’-FL HMO cho trẻ từ 1 – 3 tuổi– 400g",239000,239000,0,0
TIKI,do-choi-me-be,95269391,"Tã Dán Siêu Cao Cấp Huggies Platinum Naturemade S82 (82 Miếng)",280000,460000,180000,39
TIKI,do-choi-me-be,104144223,"Tắm gội dịu nhẹ Pigeon Hoa hướng dương 200ml/700ml",56000,79000,23000,29
TIKI,do-choi-me-be,1745007,"Tấm Đệm Lót Siêu Thấm Caryn (10 Miếng)",55000,67800,12800,19
TIKI,do-choi-me-be,130015080,"[MUA LÀ CÓ QUÀ] Tấm Lót Thấm Sữa Nha Đam Pigeon 12 miếng/30 miếng/50 miếng",39000,52000,13000,25
TIKI,do-choi-me-be,1000538,"Sữa Bột Anlene Gold Movepro 3X Hương Vanilla (Hộp Thiếc 400g)",220000,224000,4000,2
TIKI,do-choi-me-be,74973224,"Đồ chơi xe địa hình điều khiển từ xa KAVY tỷ lệ 1:16 bằng hợp kim tốc độ cao, bền bỉ chắc chắn, dẫn động 2 bánh",345000,345000,0,0
TIKI,do-choi-me-be,273235757,"Sữa dành cho người tiểu đường Glucerna Úc Bổ sung dinh dưỡng, cân bằng đường huyết, tạo sức khỏe tim, tăng sức khỏe chung - QuaTangMe Extaste",1130000,2260000,1130000,50
TIKI,do-choi-me-be,24510746,"Chất thông tắc Cầu, Cống Sifa chống hôi Siêu nhanh Siêu mạnh 5 phút",53000,53000,0,0
TIKI,do-choi-me-be,195969740," Ráp hính 3D -Bạch Tuột Lật- Kamikara",22500,22500,0,0
TIKI,do-choi-me-be,117720148,"Combo 4 miếng bịt góc bàn silicon an toàn cho trẻ - TIDO",20000,20000,0,0
TIKI,do-choi-me-be,102459754,"Đồ Chơi Xếp Hình Thông Minh Bằng Gỗ 180 Miếng Ghép Tangram Có Hộp Đựng Cho Bé Tư Duy Sáng Tạo Và Học Hình Khối Màu Sắc",119000,119000,0,0
TIKI,do-choi-me-be,67729762,"Sữa tắm gội toàn thân Cetaphil Baby Gentle Wash & Shampoo 2 in 1 400ml",215000,375000,160000,43
TIKI,do-choi-me-be,37037753,"Combo tăng chiều cao 1 Dimao (Vitamin D3 400IU dạng xịt) + 1 Keovon (Vitamin K2 – MK7 dạng xịt)",585000,585000,0,0
TIKI,do-choi-me-be,412763,"Tã Quần Cao Cấp Moony Nhật Bản Bé Trai L44 (44 Miếng)",265000,466400,201400,43
TIKI,do-choi-me-be,182709864,"Combo 2 Sữa tắm gội dịu lành cho bé Cetaphil Baby Wash & Shampoo with Organic Calendula 400ml/chai",655000,655000,0,0
TIKI,do-choi-me-be,78989144,"Nệm (thảm) chơi Nhà của Mẹ gấp gọn 2 mặt cho bé kích thước 180x200x1cm - họa tiết hình thú dễ thương giao ngẫu nhiên",219000,240000,21000,9
TIKI,do-choi-me-be,130470106,"Similac Einstein 1 cho trẻ từ 0 - 6 tháng tuổi",287000,287000,0,0
TIKI,do-choi-me-be,59196226,"Dầu húng chanh Minion 30ml",259000,259000,0,0
TIKI,do-choi-me-be,142422033,"Combo 3 Túi Nước Rửa Bình Sữa Dnee 600ml/túi",149000,149000,0,0
TIKI,do-choi-me-be,67546214,"Sữa Tắm Gội Toàn Thân Cetaphil Baby Gentle Wash Shampoo 2 in 1 (400ml)",203000,226000,23000,10
TIKI,do-choi-me-be,213517312,"Sữa Ensure cho người già Úc - Cung cấp dinh dưỡng giúp hồi phục sức khỏe cho người suy dinh dưỡng, ốm yếu, người già - QuaTangMe Extaste",1108000,2216000,1108000,50
TIKI,do-choi-me-be,129540643,"Kem chống hăm tã em bé Sudocrem hộp 60g",109000,109000,0,0
TIKI,do-choi-me-be,168662079,"Sữa bột NAN INFINIPRO A2 Thụy Sĩ 2 800g với sự kết hợp độc đáo giữa đạm quý A2 và 5HMO (12 - 24 tháng)",699000,699000,0,0
TIKI,do-choi-me-be,44140382,"Túi Ngũ Cốc NAVAN (800G) -  Dinh Dưỡng Thiết Yếu Cho Mẹ",199000,199000,0,0
TIKI,do-choi-me-be,262974809,"Sữa Bột Nestle Milo Value Pack  Úc, Bổ Sung vitamin và khoáng chất giúp bé phát triển chiều cao và cân năng, thông minh và sáng tạo năng động vượt trội - Massel Official",385000,770000,385000,50
TIKI,do-choi-me-be,115483435,"Sữa bột Enfamil A+ NeuroPro 2 với 2’-FL HMO cho trẻ từ 6 –12  tháng tuổi– 830g",575000,575000,0,0
TIKI,do-choi-me-be,44246534,"Bộ Cờ Tướng Gỗ Sồi + Bàn Cờ Tướng 40*35cm, Cờ Tướng Gỗ Có Bàn Là Hộp Đựng Chính Hãng",253000,450000,197000,44
TIKI,do-choi-me-be,55294509,"Đồ Chơi Lắp Ghép Bộ Chữ Số Biến Hình Từ 1 2 3 4 5 6 7 8 9 Thành Robot",299000,400000,101000,25
TIKI,do-choi-me-be,119706884,"Sữa tắm gội dịu lành cho bé Cetaphil Baby Wash & Shampoo with Organic Calendula 400ml",326000,326000,0,0
TIKI,do-choi-me-be,7250239,"Chất Thông Cống Siêu Mạnh SiFa (1.6kg)",82000,82000,0,0
TIKI,do-choi-me-be,108753317,"Núm ty Silicon mô phỏng tự nhiên hiệu Philips Avent cho trẻ sơ sinh",235000,235000,0,0
TIKI,do-choi-me-be,81227999,"Xe Cứu Hoả Duka DK81039",135000,180000,45000,25
TIKI,do-choi-me-be,118288089,"Sữa Dành Cho Người Tiểu Đường Abbott Glucerna Úc Bổ Sung Đầy Đủ Dinh Dưỡng Và Cân Bằng Đường Huyết - Lon 850g - Massel Official",1130000,2260000,1130000,50
TIKI,do-choi-me-be,113864742,"Bỉm Aikuu Bear CHÍNH HÃNG Dán/Quần đủ size S112,M100/M100,L96,XL92,XXL88,XXXL84",256000,300000,44000,15
TIKI,do-choi-me-be,10021580,"Sữa Bột Meiji 1-3 Growing Up Formula (800g)",455000,455000,0,0
TIKI,do-choi-me-be,150565149,"Bộ Dụng Cụ Lấy Ráy Tai Có Đèn Led Cao Cấp Kèm Hộp Đựng Sịn Sò Sử Dụng Cổng Sạc USB",175420,179000,3580,2
TIKI,do-choi-me-be,435753,"Sữa Bột Abbott Grow 3 cho trẻ từ 1- 2 tuổi (900g)",335000,335000,0,0
TIKI,do-choi-me-be,108598576,"[LOẠI XỊN - CÓ CHỌN SIZE] Cờ Vây Nam Châm Cao Cấp, Cờ Caro Tiện Dụng Chính Hãng - Chọn Nhiều Cỡ",137000,153000,16000,10
TIKI,do-choi-me-be,74871422,"Đồ chơi xe ô tô địa hình chạy đà KAVY quán tính bằng nhựa nguyên sinh an toàn, chạy rất xa và khỏe",24000,24000,0,0
TIKI,do-choi-me-be,967303,"Sữa Bột Abbott Similac Mom Vani 400g",215000,243540,28540,12
TIKI,do-choi-me-be,173910843,"Xe ô tô điều khiển từ xa KAVY 058 bằng cử chỉ có nhạc, đèn phun được khói xoay 360 độ cao",525000,525000,0,0
TIKI,do-choi-me-be,51661295,"Vitamin k2 d3 Lineabon từ Châu Âu chứa MK7 giúp hấp thụ calci – Hỗ trợ hấp thu canxi tự nhiên cho trẻ, giúp tăng chiều cao, hết còi xương - Hết ngay khóc đêm, trằn trọc, mồ hôi trộn",295000,295000,0,0
TIKI,do-choi-me-be,54412956,"Bộ Cờ Cá Ngựa – Cờ Cá Ngựa Nam Châm – Chính Hãng An Toàn Vui Nhộn Cho Bé (Vỏ Hộp Màu Ngẫu Nhiên)",92000,95000,3000,3
TIKI,do-choi-me-be,192339772,"Bàn chải đánh răng điện cho bé LocknLock ENR226WHT-5V, 1.5W - Màu trắng",566000,1090000,524000,48
TIKI,do-choi-me-be,49884596,"Sữa Morinaga Số 3 Hương Vani - Kodomil (850g) dành cho bé trên 36 tháng tuổi",499000,551000,52000,9
TIKI,do-choi-me-be,78283430,"Đồ chơi mô hình xe bus 2 tầng mui trần  KAVY có nhạc và đèn chạy cót bằng kim loại bền bỉ, xe thăm quan du lịch thành phố",185000,185000,0,0
TIKI,do-choi-me-be,107995394,"Bộ 2 Bình sữa mô phỏng tự nhiên hiệu Philips Avent (125 ml) cho trẻ từ 0 tháng tuổi 690.23",495000,495000,0,0
TIKI,do-choi-me-be,51064515,"Tấm lót chống thấm cho bé Organic Good Cotton Babyup. Miếng lót chống thấm 4 lớp. Tấm lót thay tả mềm mại, thoáng khí, siêu thấm hút, có thể giặt, an toàn cho bé",199000,199000,0,0
TIKI,do-choi-me-be,95035813,"Bột ăn dặm dinh dưỡng Sữa, Chuối, Đào HiPP Organic 250g",145000,145000,0,0
TIKI,do-choi-me-be,115483210,"Sữa bột Enfagrow A+ NeuroPro 3 với 2’-FL HMO cho trẻ từ 1 – 3 tuổi – 830g",533000,533000,0,0
TIKI,do-choi-me-be,55500745,"Bộ đồ chơi nhà bếp cao 40cm",209000,209000,0,0
TIKI,do-choi-me-be,196675403,"Cốc tập uống bằng nhựa HiPP - Nhập khẩu Đức (Màu ngẫu nhiên)",75000,75000,0,0
TIKI,do-choi-me-be,198614354,"Bình Trữ Sữa Cổ Rộng Mama's Choice 180ml–240ml, Tương Thích Máy Hút Sữa Spectra, Avent, Fatz, Rozabi, Cimilre",95000,95000,0,0
TIKI,do-choi-me-be,105112589,"Sữa non Colosmulti Pedia Gold hộp 28 gói x 16g dành cho trẻ biếng ăn",1250000,1250000,0,0
TIKI,do-choi-me-be,138581421,"Combo 10 Gói Khăn Ướt Yuniku 20 Tờ Hương Hoa Lài ( 20 Tờ x 10 )",85000,137000,52000,38
TIKI,do-choi-me-be,116727455,"(Date mới) Sữa Hữu Cơ Miwako A+ Hộp 700g Vị Vani Nhập Khẩu Malaysia, Sữa Hạt Organic Dinh Dưỡng Phát Triển Trí Não & Chiều Cao Cho Bé Từ 1-6 Tuổi Vị Ngọt Thanh Dễ Uống",698000,698000,0,0
TIKI,do-choi-me-be,212607471,"Ensure Đức cho người lớn tuổi Ensure Vanille-Geschmask giúp hồi phục sức khỏe cho người gầy, suy dinh dưỡng - QuaTangMe Extaste",529000,1058000,529000,50
TIKI,do-choi-me-be,144121555,"Túi Trữ Sữa Và Bảo Quản Sữa Mẹ Mama’s Choice, Bịch Đựng Sữa Mẹ, Có Khóa Zip Tiện Lợi An Toàn, Lẻ 10 Túi",87000,87000,0,0
TIKI,do-choi-me-be,474633,"Tã Dán Bobby Siêu Mỏng Thấm Gói Siêu Lớn XL62 (62 Miếng)",285000,363400,78400,22
TIKI,do-choi-me-be,879798,"3 Gói Khăn Ướt Yuniku Max Cool YK20-02 (20 Tờ x 3) - 3 Màu",41100,41100,0,0
TIKI,do-choi-me-be,168293316,"Canxi & vitamin D Ostelin Úc cho bà bầu (130 viên)",325000,330000,5000,2
TIKI,do-choi-me-be,969623,"Sữa Bột Friso mum Gold Hương Cam (900g)",515000,616000,101000,16
TIKI,do-choi-me-be,115694868,"Đồ chơi lắp ráp xếp hình robot người máy Qman 1414 - Siêu Robot khủng long (553 mảnh ghép) dành cho bé trên 6 tuổi",258000,359000,101000,28
TIKI,do-choi-me-be,104137482,"Núm vú cổ hẹp silicone mềm Pigeon (2 cái/vỉ)",19000,26000,7000,27
TIKI,do-choi-me-be,95269411,"Tã Dán Siêu Cao Cấp Huggies Platinum Naturemade XL44 (44 Miếng)",280000,460000,180000,39
TIKI,do-choi-me-be,95269393,"Tã Quần Siêu Cao Cấp Huggies Platinum Nature Made XL38 (38 Miếng)",269000,269000,0,0
TIKI,do-choi-me-be,112969206,"Bộ Thẻ Bài Pokemon 25 Thẻ Sword Shield BATTLESTYLES ( Mẫu Ngẫu Nhiên) Loại Cao cấp",40000,40000,0,0
TIKI,do-choi-me-be,49209058,"Combo 3 Khăn Tắm Bonny Sợi Tre Siêu Mềm Và Thấm Hút Cho Bé",276000,285000,9000,3
TIKI,do-choi-me-be,147993531,"[HÀNG CAO CẤP - GỖ TỰ NHIÊN] Bộ Cờ Tướng Gỗ Cao Cấp 40 x 35cm Khắc Nét Tinh Xảo, Chính Hãng dododios",254000,254000,0,0
TIKI,do-choi-me-be,180396538,"Đai địu vải 4 tư thế có đỡ cổ cho bé sơ sinh, trẻ em 36 tháng tuổi ngồi xe máy an toàn - MySun",139000,255000,116000,45
TIKI,do-choi-me-be,131246833,"Lều Xông Hơi Tự Bung Lều Xông Hơi Sau Sinh Trị Cúm Tại Nhà Kèm Nồi Hơi Cao Cấp Dung Tích 2L",539000,539000,0,0
TIKI,do-choi-me-be,164075817,"Tả quần Kitin Natural size XXXL34(>18kg)",154000,225000,71000,32
TIKI,do-choi-me-be,43282996,"Cờ Vua Nam Châm Cao Cấp 25cm, 32cm, 36cm – Hàng Chính Hãng",89000,89000,0,0
TIKI,do-choi-me-be,164075724,"Tả quần Kitin Natural size XL38 (12-15kg)",154000,225000,71000,32
TIKI,do-choi-me-be,84785219,"Bàn chải đánh răng trẻ em Curly Sue nhập khẩu Hàn Quốc (Dành cho bé từ 3 đến 8 tuổi)",18000,36000,18000,50
TIKI,do-choi-me-be,629921,"Bộ 2 Gói Nước Rửa Bình Sữa Wesser (500ml x 2)",160000,160000,0,0
TIKI,do-choi-me-be,7187943,"Sữa Bột Vinamilk Sure Diecerna - Hộp Thiếc 900g",530000,530000,0,0
TIKI,do-choi-me-be,115483447,"Sữa bột Enfamil A+ NeuroPro 2 với 2’-FL HMO cho trẻ từ 6 –12  tháng tuổi– 400g",268000,268000,0,0
TIKI,do-choi-me-be,24448316,"Nước rửa bình sữa D-nee Mild & Care chai 500ml",70000,91000,21000,23
TIKI,do-choi-me-be,113767814,"Sữa Bột Meiji 1-3 Growing Up Formula (800g)",509000,509000,0,0
TIKI,do-choi-me-be,151745410,"Ghế ăn dặm cho bé gấp gọn nâng hạ độ cao Mastela 07110 / 07112  - Ghế tập ăn dặm cho bé chuẩn ASTM Mỹ BPA Free",579000,579000,0,0
TIKI,do-choi-me-be,115483441,"Sữa bột Enfamil A+ NeuroPro 1 với 2’-FL HMO cho trẻ từ 0 – 6 tháng tuổi– 400g",258000,258000,0,0
TIKI,do-choi-me-be,805558,"Cháo Ăn Dặm Mabu Nguyên Hạt (400g)",99000,99000,0,0
TIKI,do-choi-me-be,20024063,"Thùng 48 Hộp x 110ml Sữa Bột Pha Sẵn GrowPLUS+ Đỏ 110ml Suy Dinh Dưỡng - Hàng Chính Hãng",389000,389000,0,0
TIKI,do-choi-me-be,255174867,"Cờ Vây Nam Châm Chọn size, Cờ Caro Cao Cấp, Có Bàn Là Hộp Đựng Rộng 28.5cm Và 37cm - Hàng chính hãng Amalife",140140,143000,2860,2
TIKI,do-choi-me-be,68554792,"Tấm lót chống thấm cho bé dùng được 2 mặt. Miếng lót chống thấm xuống nệm, thoáng khí, hàng chính hãng - 50x70",129000,129000,0,0
TIKI,do-choi-me-be,49957356,"Bánh Ăn Dặm Gạo Lứt Phô Mai Bebedang Cho Bé Nhập Khẩu Hàn Quốc",55000,55000,0,0
TIKI,do-choi-me-be,74915440,"Đồ chơi lắp ghép xe công trình KAVY gồm 4 xe kèm vít, rất nhiều màu sắc, nhựa nguyên sinh an toàn",98000,98000,0,0
TIKI,do-choi-me-be,3005389,"Nước Giặt Quần Áo Cho Bé D-Nee - Chai 3000ml (Xanh lá)",185000,245000,60000,24
TIKI,do-choi-me-be,127197584,"Xe đồ chơi mô hình đầu kéo container vận chuyển KAVY No.8807 đầu hợp kim tháo rời kích thước lớn tỷ lệ 1:48 - nhiều màu",125000,125000,0,0
TIKI,do-choi-me-be,105778887,"Đồ chơi mô hình 6 xe cảnh sát hình sự KAVY No.8807 nhiều màu sắc bằng kim loại",132000,132000,0,0
TIKI,do-choi-me-be,59258002,"Chất thông tắc Cống sifa chống hôi siêu mạnh 5 phút 700gr thế hệ mới cao cấp ",55000,55000,0,0
TIKI,do-choi-me-be,101236401,"Combo 5 Cốc thả bồn cầu tẩy xanh toilet Hàn Quốc Mr Fresh 180g ( hương ngàn hoa )",185000,185000,0,0
TIKI,do-choi-me-be,48877200,"Khăn giấy khô Fudo® TISSUEPack™ từ tre không bụi vụn, không tẩy trắng - Thùng 20 gói/130 tờ - 03 lớp siêu thấm",380000,380000,0,0
TIKI,do-choi-me-be,58457905,"Tấm lót chống thấm cho bé cao cấp - Kích thước 70x120cm. Miếng lót chống thấm thoáng khí, siêu thấm và an toàn cho trẻ sơ sinh và trẻ nhỏ - TLCTCB00001",245000,245000,0,0
TIKI,do-choi-me-be,96912147,"Bịch 10 Khăn sữa Cotton viền màu 4 lớp an toàn cho trẻ sơ sinh - Aiko (Hàng Việt Nam xuất Nhật) (Khăn kích thước 27cm x 25cm)",39000,39000,0,0
TIKI,do-choi-me-be,171833960,"Viên Xông Giúp Thông Mũi Họng Giảm Nghẹt Mũi Sổ Mũi Tinh Dầu Hương Tràm ( Hộp 20 viên )",29000,37000,8000,22
TIKI,do-choi-me-be,49232078,"Gạc Rơ Lưỡi Dr Papie Vệ Sinh Răng Miệng Cho Bé , Gạc Răng Miệng Dr Papie Làm Sạch Răng Miệng Cho Bé Hộp 30 Miếng",101200,110000,8800,8
TIKI,do-choi-me-be,146517995,"Bộ Cờ Vua Nam Châm Cao Cấp Chính Hãng dododios - Nhiều Kích Cỡ",213000,213000,0,0
TIKI,do-choi-me-be,165220829,"Bộ dụng cụ lấy ráy tai có đèn thông minh 10 món chuyên nghiệp HBH",88000,99000,11000,11
TIKI,do-choi-me-be,543025,"Nước Giặt Quần Áo Cho Bé D-Nee - Chai 3000ml (Hồng)",185000,245000,60000,24
TIKI,do-choi-me-be,74554678,"Bộ Cờ Búng Bàn Đấu Ice Hockey Bằng Gỗ - Chọn Size -  Foosball Winner, Sling Puck - Bắn Bi Gỗ Xuyên Lỗ Chính Hãng",115000,195000,80000,41
TIKI,do-choi-me-be,146845862,"Miếng lót sơ sinh Bobby NB1-108( Tặng 9m tã dán sơ sinh)",140000,140000,0,0
TIKI,do-choi-me-be,153912537,"Ghế ăn dặm cho bé đi du lịch Mastela 1013 ăn dặm kèm mặt bàn - tiêu chuẩn ASTM Mỹ, BPA FREE an toàn cho bé",630000,630000,0,0
TIKI,do-choi-me-be,25982539,"Đồ Chơi Cờ Trí Tuệ UNO W2085",123300,169000,45700,27
TIKI,do-choi-me-be,198915804,"Đá Khô Bảo Quản Sữa Mama’s Choice, Giữ Lạnh Sữa Mẹ Lên Đến 14 Tiếng, Chất Liệu Gel Y Tế Cao Cấp, Độ Bền Cao Từ 4-5 Năm",180000,180000,0,0
TIKI,do-choi-me-be,104154761,"Phấn rôm sẩy Pigeon nắp màu 100g/200g",42000,49000,7000,14
TIKI,do-choi-me-be,612898,"Kệ Chữ A Nhựa Chợ Lớn K2 (Có nhạc) - M1476-BB9",341000,341000,0,0
TIKI,do-choi-me-be,19944401,"Tã Quần Moony Natural Bông Organic XL32 (32 Miếng)",265000,265000,0,0
TIKI,do-choi-me-be,805454,"Cháo Ăn Dặm Mabu Hạt Vỡ (900g)",199000,199000,0,0
TIKI,do-choi-me-be,685882,"Thùng 24 Chai Sữa Nước Abbott Ensure 237ml",1499000,1499000,0,0
TIKI,do-choi-me-be,168778815,"Gạc Rơ Lưỡi Dr.Papie Vệ Sinh Răng Miệng Cho Bé",110000,160000,50000,31
TIKI,do-choi-me-be,190702377,"Sữa bột Enfagrow A2 Neuropro 3 dành cho trẻ từ 1 - 6 tuổi –800g",611000,611000,0,0
TIKI,do-choi-me-be,108915932,"Bộ 3 Bình Trữ Sữa Mẹ FATZBABY 150ml FB0120N",115000,115000,0,0
TIKI,do-choi-me-be,74769722,"Kutieskin 30gr Kem mẩn ngứa – hăm Kutieskin",110000,110000,0,0
TIKI,do-choi-me-be,160821055,"Đồ chơi xếp hình, lắp ráp 6 in 1 Qman 1414 - Siêu Robot khủng long Sura",359000,359000,0,0
TIKI,do-choi-me-be,273720404,"Sữa Ensure Úc hồi phục sức khỏe cho người già, người ốm yếu, suy dinh dưỡng, người sau phẫu thuật - QuaTangMe Extaste",1108000,2216000,1108000,50
TIKI,do-choi-me-be,272103774,"Sữa dành cho người tiểu đường Glucerna Úc Bổ sung dinh dưỡng, cân bằng đường huyết, tạo sức khỏe tim, tiêu hóa, tăng sức khỏe chung - OZ Slim Store",1130000,2260000,1130000,50
TIKI,do-choi-me-be,89643366,"Boardgame Cờ Tỷ Phú Việt Nam Sato Cỡ Lớn 42x42 Tặng Kèm Xúc Xắc Gỗ-Trò Chơi Rèn Luyện Tư Duy Làm Giàu",87000,87000,0,0
TIKI,do-choi-me-be,1008834,"Máy đưa võng em bé VINANOI - Vn365",380000,550000,170000,31
TIKI,do-choi-me-be,94762046,"Túi Trữ Sữa Mama's Choice, Túi Đựng Sữa Mẹ Loại 250ml và 120ml, Kiểm Định An Toàn Bởi Bureau Veritas, Hộp 30 Túi",125000,125000,0,0
TIKI,do-choi-me-be,26612371,"Tã quần cao cấp Bobby Extra Soft Dry thun chân ngăn hằn",308000,377300,69300,18
TIKI,do-choi-me-be,272423158,"Sữa tăng chiều cao A2 nguyên kem full cream high in calcium phát triển xương, răng ở trẻ, chống loãng xương ở người lớn, tăng sức khỏe - OZ Slim Store",511000,1022000,511000,50
TIKI,do-choi-me-be,168160974,"Khăn Lau Hạ Sốt 0+ Dr.Papie Cho Bé Hạ Nhiệt Giảm Sốt Ngăn Ngừa Co Giật",185000,185000,0,0
TIKI,do-choi-me-be,110808894,"Quả bồ kết khô xông nhà diệt khuẩn",25000,25000,0,0
TIKI,do-choi-me-be,105219052,"Mút Cao Su Dán, Bọc Cạnh, Góc Bàn An Toàn Cho Bé - KUB",74000,74000,0,0
TIKI,do-choi-me-be,177751108,"MÁY HÚT SỮA ĐIỆN ĐÔI FATZ BABY - CHORUS 2 - FB1182MX",1390000,1390000,0,0
TIKI,do-choi-me-be,270697757,"Kẽm cho bé Úc Healthy Care Kids Chewable Zinc + Vitamin C Hỗ trợ tăng trưởng, phát triển sức khỏe và hệ thống miễn dịch cho trẻ - QuaTangMe Extaste",238000,476000,238000,50
TIKI,do-choi-me-be,55021326,"Bộ giáp bảo hộ tay chân dùng trượt patin , bảo hộ xe đạp , trượt ván gồm 3 món, bảo hộ tay, gối và khuỷu tay chuyên nghiệp  Size",118000,215000,97000,45
TIKI,do-choi-me-be,110138019,"MÁY ĐA NĂNG ĐIỆN TỬ (ALL-IN-ONE) FATZBABY - MULTIMAX 1 - FB9002SJ CHÍNH HÃNG BẢO HÀNH 12 THÁNG",1046000,1046000,0,0
TIKI,do-choi-me-be,121678667,"Đồ Chơi Đèn Pin Kể Chuyện Mideer Phiên Bản 12 Truyện - Mideer StoryBook Torch (có bản dịch tiếng Việt)",318000,450000,132000,29
TIKI,do-choi-me-be,27657637,"Khăn vải khô đa năng Mama 240 tờ",53000,53000,0,0
TIKI,do-choi-me-be,59049510,"Chất thông tắc Cống và Cầu Sifa chống hôi Siêu nhanh siêu mạnh 5 phút 425ml cao cấp",39900,39900,0,0
TIKI,do-choi-me-be,119706876,"Sữa tắm gội dịu lành cho bé Cetaphil Baby Gentle Wash & Shampoo 400ml",272000,272000,0,0
TIKI,do-choi-me-be,150731733,"Đồ chơi khoa học kính hiển vi cầm Tay Chính Hãng TOPBRIGHT - Đồ chơi giáo dục cho bé từ 8 tuổi",355000,550000,195000,35
TIKI,do-choi-me-be,154702528,"Nôi ru ngủ thư giãn kết hợp ghế ngồi đọc sách cho bé nhạc trắng Mastela 8104/8106 - điều khiển từ xa - kết hợp Bluetooth",2190000,2190000,0,0
TIKI,do-choi-me-be,116572142,"Thùng 6 lon sữa bột dinh dưỡng công thức HiPP 3 Organic Combiotic chất lượng hữu cơ tăng cường sức khoẻ hệ miễn dịch, bổ sung Canxi và vitamin D dành cho trẻ trên 12 tháng tuổi (6 lon x 800g)",4710000,4710000,0,0
TIKI,do-choi-me-be,2758763,"Bộ Lắp Ráp Thùng Gạch Lớn Classic Sáng Tạo LEGO CLASSIC 10698 (790 chi tiết)",1920000,1920000,0,0
TIKI,do-choi-me-be,2173351,"Combo 3 Bịch Khăn Vải Khô Likado (300g)",120000,120000,0,0
TIKI,do-choi-me-be,133545034,"Combo 6 Gói Khăn Ướt Yuniku 90 Tờ Hương Lài ( 90 Tờ x 6 )",145000,250800,105800,42
TIKI,do-choi-me-be,270796181,"Vitamin tổng hợp cho trẻ L'il Critters Gummy Vites Daily Mỹ chứa vitamin và khoáng chất hỗ trợ miễn dịch, mắt, chống oxy hóa và tăng sức khỏe tổng thể - QuaTangMe Extaste",618000,1236000,618000,50
TIKI,do-choi-me-be,68328015,"Bệ Thu Nhỏ Bồn Cầu Cho Bé Cleverbees - Nhựa PVC Cao Cấp",200000,249000,49000,20
TIKI,do-choi-me-be,17702472,"4 Bịch Khăn vải khô đa năng LIKADO 400g (20 x 22cm)",240000,240000,0,0
TIKI,do-choi-me-be,129665688,"(HCM) Tấm đệm lót người già Caryn khổ lớn 60x70cm gói 14 miếng",98000,98000,0,0
TIKI,do-choi-me-be,55461311,"Tinh dầu tràm Huế Kim Vui 125ml - Tinh dầu dùng cho trẻ sơ sinh",190000,190000,0,0
TIKI,do-choi-me-be,197329427,"Cuộn 2m Mút Xốp Bọc Cạnh Bàn Ghế Giường Tủ Bảo Vệ An Toàn Cho Bé",52250,52250,0,0
TIKI,do-choi-me-be,70839639,"Bàn Tỷ Phú Lớn",127000,127000,0,0
TIKI,do-choi-me-be,107972572,"Bình sữa mô phỏng tự nhiên hiệu Philips Avent (125 ml - đơn) cho trẻ từ 0 tháng tuổi 690.13",295000,295000,0,0
TIKI,do-choi-me-be,134440669,"Ghế ăn dặm gấp gọn cao cấp Umoo mới nhất 2021, có bánh xe và điều chỉnh được độ cao",622000,714900,92900,13
TIKI,do-choi-me-be,165846177,"XE ĐẨY GẤP GỌN CHO BÉ HAKAWA HK-B07 - HÀNG CHÍNH HÃNG",950000,1200000,250000,21
TIKI,do-choi-me-be,130470101,"Sữa bột Similac 2 900g/lon Dinh Dưỡng 5G Mới cho trẻ dưới 2 tuổi",614000,614000,0,0
TIKI,do-choi-me-be,74850451,"Đồ chơi mô hình xe ô tô cảnh sát chạy pin, nhựa nguyên sinh an toàn, chạy rất nhanh và xa",36000,36000,0,0
TIKI,do-choi-me-be,95035851,"Trà cốm lợi sữa HiPP dành cho phụ nữ cho con bú 200g",175000,175000,0,0
TIKI,do-choi-me-be,74769754,"Đồ chơi mô hình xe trộn bê tông KAVY NO.8809 chất liệu hợp kim và nhựa nguyên sinh an toàn, chi tiết sắc sảo",68000,68000,0,0
TIKI,do-choi-me-be,730491,"Nước Rửa Bình Thảo Mộc Arau Baby Dạng Túi (450ml)",112230,129000,16770,13
TIKI,do-choi-me-be,116572109,"Combo 3 Trà cốm lợi sữa hoà tan HiPP Mama Herbal Nursing Tea 100% thảo mộc, dành cho mẹ sau sinh và đang cho con bú giúp bồi bổ cơ thể, hỗ trợ và tăng cường lượng sữa (2 hộp x 200g)",525000,525000,0,0
TIKI,do-choi-me-be,147588060,"Bộ Bài Tây Poker Mạ Si Vàng 24K Cao Cấp Phủ Nhũ Vàng Chính Hãng Dododios – Bộ 54 Lá Bài Tây Pocker Nhựa Dẻo Chống Thấm Nước Chống Gãy",40000,40000,0,0
TIKI,do-choi-me-be,52890089,"Đồ Chơi BATTAT Bộ Học Chữ Và Số BT2532Z",529000,529000,0,0
TIKI,do-choi-me-be,212558186,"Ensure Đức cho người lớn tuổi Ensure Vanille-Geschmask Cung cấp dinh dưỡng giúp hồi phục sức khỏe cho người gầy yếu, suy dinh dưỡng - OZ Slim Store",529000,1058000,529000,50
TIKI,do-choi-me-be,73272562,"Combo 4 Gói Khăn Ướt Max Cool 80 Tờ Tặng 2 Gói Cùng Loại",99000,124000,25000,20
TIKI,do-choi-me-be,49498423,"Combo 2 bịch bỉm/tã quần cao cấp MIJUKU - M",358000,358000,0,0
TIKI,do-choi-me-be,247474808," Bàn Chải Đánh Răng Trẻ Em Jodily 1-4 Tuổi Siêu Mền Mại (Dành Cho Bé Tập Đánh Răng)",55000,55000,0,0
TIKI,do-choi-me-be,187739490,"Đồ chơi xếp hình, lắp ráp người máy robot Qman 1412: Người máy hợp kim (419 mảnh ghép)",258000,349000,91000,26
TIKI,do-choi-me-be,755394,"Cờ Domino Ngà Lớn Liên Hiệp Thành KDNL",86000,86000,0,0
TIKI,do-choi-me-be,144278087,"Lều Xông Hơi Tự Bung 3 Lớp Và Nồi Xông Hơi Cao Cấp Dùng Tại Nhà Spa",639000,639000,0,0
TIKI,do-choi-me-be,1380479,"Combo 3 Gói Khăn Giấy Ướt 100 Tờ, Hương Thơm Mát Kháng Khuẩn An Toàn Cho Bé Mamamy (100 Tờ x 3)",97500,97500,0,0
TIKI,do-choi-me-be,52579303,"[COMBO 4 GÓI] KHĂN VẢI KHÔ ĐA NĂNG AIKO X 270 TỜ/ GÓI",136000,136000,0,0
TIKI,do-choi-me-be,74944614,"Đồ chơi hình cú mèo chạy cót KAVY nhấn là chạy đáng yêu dễ thương nhựa nguyên sinh an toàn",22000,22000,0,0
TIKI,do-choi-me-be,44885577,"Đồ Chơi Gỗ Bộ Domino 100 Quốc Gia Trên Thế Giới",95000,150000,55000,37
TIKI,do-choi-me-be,68142209,"Nutifood GrowPLUS+ Đỏ 1500 Gr : sữa dành cho trẻ từ 1- 10 tuổi bị suy dinh dưỡng thấp còi (mẫu mới)",565000,565000,0,0
TIKI,do-choi-me-be,117031983,"Áo Hút Sữa Rảnh Tay Mama’s Choice, Mặc Hút Sữa Cho Mẹ, Có Dây Giữ Bình Hút Sữa Chắc Chắn, Chất Liệu Thoáng Khí, Freesize - MÀU ĐEN",390000,390000,0,0
TIKI,do-choi-me-be,115694932,"Đồ chơi lắp ráp xếp hình tên lửa chiến đấu Qman 1728 - Tên lửa đánh chặn (409 mảnh ghép) dành cho bé trai trên 6 tuổi",269000,359000,90000,25
TIKI,do-choi-me-be,274536010,"[Combo Tiện Lợi] Gói Men Bể Phốt EcoClean Septic - Men Vi Sinh Xử Lý Hầm Cầu, Bể Phốt Đầy, Tràn - Túi Gói 100gram",246000,246000,0,0
TIKI,do-choi-me-be,70844277,"Bộ Thẻ Bài Pokemon 324 Thẻ Cao Cấp Nhiều Loại",198000,198000,0,0
TIKI,do-choi-me-be,135478535,"Nước giặt Dnee cho bé chai 3000ml-hàng chính hãng có hoá đơn",195000,195000,0,0
TIKI,do-choi-me-be,40722646,"Sữa tắm gội xả Suave Kids 3 in 1 mùi Dưa hấu mẫu mới của Mỹ",139000,139000,0,0
TIKI,do-choi-me-be,146399059,"Sữa bột Nutricare Care 100 Plus phục hổi dinh dưỡng cho trẻ biếng ăn (900g)",348801,348801,0,0
TIKI,do-choi-me-be,146366199,"MÁY ĐA NĂNG ĐIỆN TỬ (ALL-IN-ONE) FATZBABY - MULTIMAX 2 - FB9013SLTHẾ HỆ MỚI",1099000,1099000,0,0
TIKI,do-choi-me-be,24030105,"Sữa bột Abbott Pediasure 850g cho trẻ từ 1 - 10 tuổi",610000,610000,0,0
TIKI,do-choi-me-be,176937782,"Bình trữ sữa Medela 150ml/250ml - Nắp bình tách rời có thể nắp núm ty vào cho bé bú",155000,155000,0,0
TIKI,do-choi-me-be,55576959,"Tinh dầu tràm Con Dơi ( Nguyên chất 100%)",137000,137000,0,0
TIKI,do-choi-me-be,104156562,"Sữa tắm dịu nhẹ Jojoba Pigeon 200ml/700ml",47000,67000,20000,30
TIKI,do-choi-me-be,184522257,"Đồ chơi lắp ráp, xếp hình tàu chiến Qman 1411 cho bé trai - Tàu tuần dương biển (700 mảnh ghép)",355000,459000,104000,23
TIKI,do-choi-me-be,16862593,"Bài Tarot - Bài Bói The Rider Tarot Deck (kèm túi)",75000,75000,0,0
TIKI,do-choi-me-be,15519960,"Men Vi Sinh Xử Lý Hầm Cầu Ecoclean septic 1 gói 100g",82000,82000,0,0
TIKI,do-choi-me-be,179992878,"Thanh Sữa Meiji Ezcube Infant Formula Dạng Viên (5 Viên)",40000,40000,0,0
TIKI,do-choi-me-be,17461315,"Sữa bột Nutricare Fine dinh dưỡng y học tăng cường miễn dịch cho bệnh nhân ung thư (900g)",515000,515000,0,0
TIKI,do-choi-me-be,87483010,"Miếng Lót Sơ Sinh Bobby Fresh Newborn 2 - 60 (60 Miếng)",115000,140300,25300,18
TIKI,do-choi-me-be,24704442,"BỘT ĂN DẶM RIDIELAC GOLD 4 VỊ MẶN - HỘP GIẤY 200G",66000,66000,0,0
TIKI,do-choi-me-be,190108309,"Đồ chơi lắp ráp xếp hình 8 trong 1 chủ đề quân sự Qman 42301 - Xe tăng quân sự (642 chi tiết)",369000,489000,120000,25
TIKI,do-choi-me-be,543147,"Dung Dịch Giặt Quần Áo Cho Bé D-Nee - Túi 600ml (Tím)",80000,80000,0,0
TIKI,do-choi-me-be,7492907,"Nhiệt kế điện tử Microlife MT850 (Dạng bút)",199000,246500,47500,19
TIKI,do-choi-me-be,88924605,"Sữa Bột Frisolac Gold 1 380g Dành Cho Trẻ Từ 0 - 6 Tháng Tuổi",232000,232000,0,0
TIKI,do-choi-me-be,23610135,"GEL BÔI GIẢM SƯNG NƯỚU VÀ BỆNH TAY CHÂN MIỆNG KIN BABY 30ML",162000,162000,0,0
TIKI,do-choi-me-be,23067533,"Đai Đỡ Bụng Bầu Chính Hãng miDoctor",117000,117000,0,0
TIKI,do-choi-me-be,49884590,"Sữa Morinaga Số 2 - Chilmil (320g)",255000,278000,23000,8
TIKI,do-choi-me-be,64984596,"Combo 10 Gói Khăn Ướt Yuniku 20 Tờ Hương Trà Xanh ( 20 Tờ x 10 )",85000,137000,52000,38
TIKI,do-choi-me-be,73088843,"Combo 10 gói Khăn Giấy Ướt Aiko 100 tờ/gói không hương màu Hồng",310000,310000,0,0
TIKI,do-choi-me-be,190861588,"Thùng 24 hộp pha sẵn Nutren Junior 200ml/hộp cho trẻ từ 1-10 tuổi tăng trưởng 3 chuẩn: Thế chất, Đề kháng, Tư duy - Tặng balo con hổ",778000,778000,0,0
TIKI,do-choi-me-be,154702807,"Thanh chắn cửa, chắn cầu thang chính hãng Mastela D04 bảo vệ an toàn cho bé, Không cần khoan tường, có thể thanh mở rộng",985000,985000,0,0
TIKI,do-choi-me-be,118090342,"Set 4 Dụng Cụ Lấy Ráy Tai Có Đèn Led Kèm Hộp Đựng Tiện Dụng Sử Dụng Cổng Sạc USB",161700,165000,3300,2
TIKI,do-choi-me-be,4819361,"Sữa bột Nutricare Glucare Gold dinh dưỡng cho người tiểu đường (900g)",405000,405000,0,0
TIKI,do-choi-me-be,116572135,"Combo 2 lon sữa bột dinh dưỡng công thức HiPP 3 Organic Combiotic chất lượng hữu cơ, tăng cường sức khoẻ hệ miễn dịch, bổ sung Canxi và vitamin D dành cho trẻ trên 12 tháng tuổi (2 lon x 800g)",1570000,1570000,0,0
TIKI,do-choi-me-be,101359142,"Combo 2 Cốc thả bồn cầu tẩy xanh toilet Hàn Quốc Mr Fresh 180g hương ngàn hoa",78000,78000,0,0
TIKI,do-choi-me-be,272095209,"Sữa dành cho người tiểu đường Glucerna Úc Bổ sung dinh dưỡng, cân bằng đường huyết, tạo sức khỏe tim, tiêu hóa, tăng sức khỏe chung - OZ Slim Store",1130000,2260000,1130000,50
TIKI,do-choi-me-be,45551664,"2 Hộp Sữa Bột Meiji 1-3 Growing Up Formula (800g)",930000,930000,0,0
TIKI,do-choi-me-be,115483202,"Sữa bột Enfagrow A+ NeuroPro 4 với 2’-FL HMO cho trẻ từ 2 – 6 tuổi – 830g",468000,549000,81000,15
TIKI,do-choi-me-be,421291,"Đồ Chơi Lắp Ráp LEGO Thùng Gạch Trung Classic Sáng Tạo 10696 Cho Bé Trên 1 Tuổi (484 chi tiết)",1269000,1269000,0,0
TIKI,do-choi-me-be,199053626,"Dây Hút Sữa Medela Pump Thương Hiệu Maymom, Không Chứa BPA, An Toàn 100%, Vệ Sinh Dễ Dàng",100000,100000,0,0
TIKI,do-choi-me-be,114445481,"Sữa Bột Namyang Imperial Kid XO GT 800g",549000,619000,70000,11
TIKI,do-choi-me-be,40750355,"Bộ 5 Túi Sữa Bột Nguyên Kem Nutifood (400g)",390000,390000,0,0
TIKI,do-choi-me-be,74689863,"Đồ chơi mô hình xe cần cẩu nâng hàng KAVY chất liệu hợp kim và nhựa nguyên sinh an toàn, chi tiết sắc sảo các khớp chuyển động",98000,98000,0,0
TIKI,do-choi-me-be,95035802,"Sữa bột công thức HiPP 3 Organic Combiotic 800g",785000,785000,0,0
TIKI,do-choi-me-be,40632464,"SỮA HOÀNG GIA ÚC PREGNANT MOTHER FORMULA - DÀNH CHO PHỤ NỮ MANG THAI",601000,660000,59000,9
TIKI,do-choi-me-be,46470963,"Đồ bơi bé trai liền thân bao gồm nón size cho bé từ 9kg đến 27kg",209540,209540,0,0
TIKI,do-choi-me-be,129859744,"Sữa Bột Enfamama 360° Brain Plus Cho Mẹ Mang Thai Và Cho Con Bú",469000,744278,275278,37
TIKI,do-choi-me-be,99845987,"Đồ chơi mô hình xe tăng  KAVY NO.8807 chất liệu nhựa an toàn tỷ lệ 1:32 so với phiên bản thực - màu xanh",75000,75000,0,0
TIKI,do-choi-me-be,112194231,"Thùng sữa nước Nutricare Smarta Grow dinh dưỡng cho trẻ thấp còi (110ml)",328328,328328,0,0
TIKI,do-choi-me-be,53308234,"Combo 6 Gói Khăn Ướt AGI Không Mùi Gấu Nâu (100 tờ x 6 gói)",222000,222000,0,0
TIKI,do-choi-me-be,68909222,"Combo Đủ Vị Cháo Tươi Dinh Dưỡng Cây Thị",241000,292500,51500,18
TIKI,do-choi-me-be,53562815,"Khăn Tắm Em Bé, Khăn Sợi Tre Bonny Kháng Khuẩn Siêu Mềm (Giao Ngẫu Nhiên)",88200,90000,1800,2
TIKI,do-choi-me-be,77154216,"Vitamin bầu Elevit chính hãng Úc mẫu mới",1130000,1130000,0,0
TIKI,do-choi-me-be,24025059,"Combo 6 Chai Sữa Nước Abbott Glucerna Vani 220ml",370000,370000,0,0
TIKI,do-choi-me-be,6464037,"Cháo Tươi Thịt Bò Cà Rốt Cây Thị",19000,23000,4000,17
TIKI,do-choi-me-be,2983649,"Sữa Bột Namyang Imperial Dream XO 4 GT 800g",499000,619000,120000,19
TIKI,do-choi-me-be,181512506,"Nón tập đi cho bé. Mũ bảo vệ đầu cho bé tập đi. Nón bảo vệ đầu cho bé, tập đi và tập ngồi. Mũ bảo hiểm an toàn cho bé tập ngồi, tập bò, tự chơi",125000,195000,70000,36
TIKI,do-choi-me-be,11253530,"Túi Đựng Sữa Mẹ (Trữ Sữa Mẹ) Unimom Compact Không Có BPA UM870268 210ml (60 Túi/Hộp)",125000,125000,0,0
TIKI,do-choi-me-be,173830829,"Xe địa hình điều khiển từ xa KAVY BS009A có đèn LED, phun được khói tỷ lệ 1: 14 chất liệu hợp kim tốc độ cao tần số 2.4 GHZ",398000,398000,0,0
TIKI,do-choi-me-be,2791853,"Kem nghệ tươi dưỡng da trắng mịn, sạch sạm nám Wonmom 50g",185000,185000,0,0
TIKI,do-choi-me-be,24499123,"Bột men vi sinh Sifa xử lý hầm cầu chống hôi và đầy bồn cầu 300g",27500,27500,0,0
TIKI,do-choi-me-be,74901695,"Xe ô tô điều khiển từ xa KAVY tốc độ cao, vượt mọi địa hình, bền bỉ chắc chắn",126000,126000,0,0
TIKI,do-choi-me-be,162148529,"Đồ chơi mô hình xe ô tô Mercedes Benz AMG G63 KAVY No. 8810 tỷ lệ 1:36 hợp kim chạy cót",142000,142000,0,0
TIKI,do-choi-me-be,99846006,"Bộ đồ chơi nấu ăn nhà bếp KAVY NO.8808 cho bé gái nhiều chi tiết, nhựa nguyên sinh an toàn - màu hồng",109000,109000,0,0
TIKI,do-choi-me-be,152875697,"Sữa Bột Cho Người Lớn Phục Hồi Sức Khỏe Sau Khi Ốm Tăng Sức Đề Kháng Bổ Sung Vitamin Khoáng Chất Pillow Care A",251000,336000,85000,25
TIKI,do-choi-me-be,188382929,"Gối trẻ em cotton LIDACO cho bé 3-8 tuổi kích thước 30x50cm",89000,120000,31000,26
TIKI,do-choi-me-be,69180169,"Sữa bột GrowPLUS+ Đỏ 900 Gr : sữa dành cho trẻ từ 1- 10 tuổi bị suy dinh dưỡng thấp còi (mẫu mới) của NutiFood",370000,370000,0,0
TIKI,do-choi-me-be,113394177,"Sữa tăng chiều cao A2 High In Calcium Úc - Giúp trẻ phát Triển chiều cao, Chống loãng xương ở người lớn, Hỗ Trợ tăng sức khỏe tổng thể - Massel Official",511000,1022000,511000,50
TIKI,do-choi-me-be,164032821,"Đồ chơi cho bé xe tăng địa hình KAVY No. 8807 chạy đà biến hình có bắn đạn quay 360 độ",55000,55000,0,0
TIKI,do-choi-me-be,86155733,"Bộ đồ chơi nhập vai BOWA – Bộ Trang điểm ( BOWA 8252 / BOWA 8255P )",205000,259000,54000,21
TIKI,do-choi-me-be,6702545,"Nutifood GrowPLUS+ Đỏ 1500 Gr : sữa dành cho trẻ từ 1- 10 tuổi bị suy dinh dưỡng thấp còi",575000,575000,0,0
TIKI,do-choi-me-be,74861731,"Bộ 24 Nút Bịt Ổ Cắm Điện Chất Liệu Chống Cháy, Có Khóa An Toàn - KUB",168000,168000,0,0
TIKI,do-choi-me-be,755371,"Bàn Cờ Tướng Nhỏ Có Cờ Liên Hiệp Thành BTNCC",100000,100000,0,0
TIKI,do-choi-me-be,98879577,"Đai đỡ lưng Xe Máy An Toàn Cho Bé, Đai Đi Xe Máy Giữ An Toàn Cho Bé Nhiều màu sắc Ngộ Nghĩnh-SUNBABY",173000,173000,0,0
TIKI,do-choi-me-be,114042520,"Trái cây nghiền vị táo, mâm xôi và phomai tươi Fruto Nyanya 90g",47000,47000,0,0
TIKI,do-choi-me-be,9999303,"Xe Jeep cảnh sát tuần tra hộ tống đồ chơi - Polesie Toys",215100,239000,23900,10
TIKI,do-choi-me-be,58767957,"Miếng lót siêu thấm Bobby Newborn 1 - 108 miếng",173200,173200,0,0
TIKI,do-choi-me-be,2173353,"Combo 4 Bịch Khăn Vải Khô Likado (300g)",200000,200000,0,0
TIKI,do-choi-me-be,56405129,"XỊT DA CHỐNG MUỖI PLASMAKARE 100ml xua đuổi Muỗl, xẹp vết đốt, Viện Sốt rét - KST -Côn trùng TƯ đã chứng nhận hiệu quả",125000,125000,0,0
TIKI,do-choi-me-be,101365784,"Sữa non Colosmulti Pedia hộp 22 gói x 16g chuyên biệt giúp bé ăn ngoan",950000,950000,0,0
TIKI,do-choi-me-be,75529967,"Dây bọt biển bọc cạnh bàn chống va đập, bịt góc bàn, ghế, tường, tủ, giường  Chính hãng",55000,55000,0,0
TIKI,do-choi-me-be,24699281,"BỘT ĂN DẶM RIDIELAC GOLD 3 VỊ NGỌT - HỘP GIẤY 200G",58000,58000,0,0
TIKI,do-choi-me-be,164075673,"Tả quần Kitin Natural size M44 (6-10kg)",154000,225000,71000,32
TIKI,do-choi-me-be,119706886,"Sữa dưỡng ẩm dịu lành hằng ngày cho bé Cetaphil Baby Daily Lotion with Organic Calendula 400ml",359000,359000,0,0
TIKI,do-choi-me-be,38220113,"TPBVSK Special kid Multivitamin - Siro Bổ sung vitamin và khoáng chất - Hỗ trợ nâng cao sức khỏe, tăng cường sức đề kháng (125ml) [Siro - Nhập khẩu Pháp]",234000,360000,126000,35
TIKI,do-choi-me-be,78490166,"Đồ chơi mô hình xe cứu thương KAVY có nhạc và đèn chạy cót mở được tất cả các cảnh cửa",189000,189000,0,0
TIKI,do-choi-me-be,107457718,"CỜ TỶ PHÚ + CỜ CÁ NGỰA",99000,99000,0,0
TIKI,do-choi-me-be,73237619,"Ghép Hình - Trực Thăng Cứu Hỏa (252 Chi Tiết) CRESTA DK81027",172500,230000,57500,25
TIKI,do-choi-me-be,20021601,"Thùng 48 Hộp x 180ml Sữa Bột Pha Sẵn GrowPLUS+ Đỏ 180ml Suy Dinh Dưỡng - Hàng Chính Hãng",575000,575000,0,0
TIKI,do-choi-me-be,57804868,"Viên sắt cho bà bầu  Blackmores Pregnancy Iron 30 viên chính hãng Úc",198000,247500,49500,20
TIKI,do-choi-me-be,10710955,"Sữa Bột Vinamilk Sure Prevent - Hộp Thiếc 900g",580000,580000,0,0
TIKI,do-choi-me-be,168806831,"Nước giặt hữu cơ Fuwa3e organic sinh học 100ml giặt quần áo đồ lót, an toàn cho em bé",16000,16000,0,0
TIKI,do-choi-me-be,88928270,"Combo 7 Gói Khăn Ướt Trẻ Em Mamamy 100 Tờ-Nắp",228000,228000,0,0
TIKI,do-choi-me-be,104144579,"Máy hút sữa điện đôi GoMini Pigeon (HSD: 03/2025)",1009000,2893000,1884000,65
TIKI,do-choi-me-be,16659020,"Nước giặt Layer Clean hương Ocean Breeze 5L",210000,210000,0,0
TIKI,do-choi-me-be,435855,"Sữa Bột Abbott Grow Gold 6+cho trẻ từ 6 tuổi trở lên (900g)",479000,479000,0,0
TIKI,do-choi-me-be,72040205,"Áo ngực cho con bú chống chảy xệ. Áo lót cho con bú siêu mềm, thoáng khí, mát mẻ. Áo lót không gọng cho bé bú sau sinh. Áo ngực cho bà bầu cao cấp Vemoda",93000,99000,6000,6
TIKI,do-choi-me-be,114140785,"Trái cây nghiền vị táo, mơ và kem tươi Fruto Nyanya 90g",47000,47000,0,0
TIKI,do-choi-me-be,80098785,"ta quan hingig 100 mieng size 5XL",250000,250000,0,0
TIKI,do-choi-me-be,104159464,"Cây súc rửa bình sữa và núm vú Pigeon - Tay xoay hai chiều/một chiều (HSD:08/2024)",69000,76000,7000,9
TIKI,do-choi-me-be,73636252,"TPBVSK Special Kid Zinc - Bổ sung Kẽm cho cơ thể, hỗ trợ tăng cường sức đề kháng (125ml) [Siro – Nhập khẩu Pháp]",234000,254000,20000,8
TIKI,do-choi-me-be,79847161,"Đồ chơi lắp ráp, xếp hình Qman 10 in 1 (Combo 10 hộp) – mô hình xe, máy bay, thú, khủng long",119000,149000,30000,20
TIKI,do-choi-me-be,130392474,"Thảm Trải Sàn Cho Bé Xốp XPE 2 Mặt Phủ Silicone Hàn Quốc Mẫu Đẹp Chống Thấm, Chống Va Đập Trơn Trượt-1m8*2m Hàng Chính Hãng MINIIN ",199000,199000,0,0
TIKI,do-choi-me-be,152517175,"Đồ chơi: Ghép Hình Khí Tài Quân Sự - Xe Bọc Thép 131 Chi Tiết DK81059",81000,108000,27000,25
TIKI,do-choi-me-be,76265391,"Bộ đồ chơi máy bay  KAVY chở đồ kèm 4 xe cảnh sát bằng kim loại, có giàn cẩu, thang trượt, biển báo đa chức năng chạy pin",395000,395000,0,0
TIKI,do-choi-me-be,192679196,"LEGO Speed Champions 76911 Siêu Xe 007 Aston Martin DB5 (298 chi tiết)",561180,796000,234820,30
TIKI,do-choi-me-be,23047533,"Sữa Bột Vinamilk Dielac Grow Plus 2+ (1500g / Hộp Thiếc)",535000,535000,0,0
TIKI,do-choi-me-be,137119518,"Combo 10 Nút Bịt Ổ Điện An Toàn Cho Bé - Loại 2 Chạc Như Hình",30000,30000,0,0
TIKI,do-choi-me-be,51875169,"Bộ Đồ Chơi Câu Cá Cho Bé - Bể phao 62*47*7 cm",92000,150000,58000,39
TIKI,do-choi-me-be,805326,"Cháo Ăn Dặm Mabu Hạt Vỡ (400g)",99000,99000,0,0
TIKI,do-choi-me-be,141789828," Combo 100 túi trữ sữa mẹ Sunmum 250ml (2 hộp) + tặng 2 lót thấm sữa sunmum",153000,153000,0,0
TIKI,do-choi-me-be,179198582,"Combo 6 Gói Trái cây nghiền mix ngẫu nhiên FrutoNyanya 90g/gói",276360,276360,0,0
TIKI,do-choi-me-be,50422449,"Sản phẩm dinh dưỡng công thức Nestlé NAN SUPREME 3 lon 800g (CÔNG THỨC BỔ SUNG 2HM-O)",549000,549000,0,0
TIKI,do-choi-me-be,74687385,"Đồ chơi mô hình xe lu KAVY NO.8810 chất liệu hợp kim và nhựa an toàn, chi tiết sắc sảo",82000,82000,0,0
TIKI,do-choi-me-be,168352541,"Tấm lót chống thấm cho người già Longlife size 50x70cm",199000,199000,0,0
TIKI,do-choi-me-be,20620548,"Combo 5 bịch khăn vải đa năng likado 300g (kt14x20)",200000,200000,0,0
TIKI,do-choi-me-be,857884,"Set 2 Núm Ty Dr.Brown's Cho Bình Sữa Cổ Thường - Số 4",169000,169000,0,0
TIKI,do-choi-me-be,181367051,"ING Organic After Balm - Kem Hữu Cơ Thoa Vết Muỗi Và Côn Trùng Đốt - Không Ngứa - Không Sưng Đỏ - Không Sẹo Thâm",313650,369000,55350,15
TIKI,do-choi-me-be,146518353,"Sữa Glico Icreo Balance Milk (Icreo Số 0) - Hộp 10 Thanh Tiện Dụng",120000,120000,0,0
TIKI,do-choi-me-be,131170228,"Bộ đất sét nặn 3D Deli 24 màu - Chất liệu an toàn cho trẻ nhỏ, màu sắc tươi sáng đa dạng, kèm phụ kiện khuôn nặn - 67825",61700,117000,55300,47
TIKI,do-choi-me-be,180380038,"Nước biển sâu Xisat xịt sạch, thông mũi dành cho trẻ em (75ml)",33000,33000,0,0
TIKI,do-choi-me-be,17463773,"Sữa bột Nutricare Gastro dinh dưỡng y học cho người viêm dạ dày, rối loạn tiêu hoá (900g)",450000,450000,0,0
TIKI,do-choi-me-be,25597768,"Sữa bột Nutricare Gastro dinh dưỡng y học cho người viêm dạ dày, rối loạn tiêu hoá 2 Hộp (900g)",875000,875000,0,0
TIKI,do-choi-me-be,38444012,"Bài Tarot Kèm Túi Đựng Bài – Bài Bói Tarot Chính Hãng Amalife - The Rider Waite Deck",69900,69900,0,0
TIKI,do-choi-me-be,26274580,"Nước xông tắm sau sinh Dao'spa mama người Dao đỏ 750ml - DK Pharma",350000,350000,0,0
TIKI,do-choi-me-be,109084626,"Núm ty ngậm thông khí Philips Avent hình thú (phiên bản Lime) cho trẻ từ 0-6 tháng tuổi _ vỉ đôi",245000,245000,0,0
TIKI,do-choi-me-be,55771564,"Viên dầu cá bổ sung DHA cho trẻ thông minh, mắt sáng tinh anh Bioisland DHA For Kids nhập khẩu Úc",380000,475000,95000,20
TIKI,do-choi-me-be,272319464,"Sữa tăng cân cho trẻ 1-3 tuổi Meiji Nhật giàu dưỡng chất kèm DHA giúp phát triển cân đối chiều cao, cân nặng, trí não trẻ - OZ Slim Store",529000,1058000,529000,50
TIKI,do-choi-me-be,113234813,"DHA cho bé từ 4 tháng - 12 tuổi Healthy Care Kids High Strength  - Úc, Giúp trẻ phát triển trí tuệ, thông minh, mắt sáng khỏe - QuaTangMe Extaste",266000,532000,266000,50
TIKI,do-choi-me-be,54406649,"Combo 5 Quần Bỏ Bỉm Goodmama",177000,177000,0,0
TIKI,do-choi-me-be,40366433,"BỘ DỤNG CỤ GẮP RÁY TAI THÔNG MINH CÓ ĐÈN",69000,75000,6000,8
TIKI,do-choi-me-be,109866598,"Túi đựng sữa mẹ sunmum 250ml (Hộp 50 túi) tặng 2 túi zipper bảo quản",85000,119000,34000,29
TIKI,do-choi-me-be,95650376,"Túi đựng gối chống trào ngược Rototo bebe chính hãng Hàn Quốc (80x80cm)",128000,128000,0,0
TIKI,do-choi-me-be,69194166,"Tã quần Bobby - Đệm Lưng Thấm Mồ Hôi XL62 (62 miếng) - Tặng 8 miếng trong gói",349000,349000,0,0
TIKI,do-choi-me-be,272050409,"Sữa tăng chiều cao cho trẻ biếng ăn từ 1-10 tuổi Úc Pediasure Vanilla giúp phát triển cân đối chiều cao, cân nặng, trí não - QuaTangMe Extaste",1108000,2216000,1108000,50
TIKI,do-choi-me-be,147987171,"[HÀNG CAO CẤP - CÓ CHỌN SIZE] Cờ Cá Ngựa Nam Châm, Bộ Cờ Cá Ngựa Cao Cấp Kích Thước 28x28 và 38x38cm - Chính Hãng dododios",102000,102000,0,0
TIKI,do-choi-me-be,15444884,"Thảm xốp lót sàn cho bé - chữ cái Pastel (26 miếng, diện tích 2.4m2) Smile Puzzle",344000,370000,26000,7
TIKI,do-choi-me-be,2791837,"Cốt nghệ hạ thổ dưỡng trắng body, sạch thâm rạn, thơm tho body sau sinh Wonmom 200ml",209000,250000,41000,16
TIKI,do-choi-me-be,45086636,"Kem dưỡng Aveeno Baby cho da khô và nhạy cảm 227g - 101016747",255000,400000,145000,36
TIKI,do-choi-me-be,45207940,"Khăn ướt làm sạch tinh khiết dành cho bé Oma&Baby với công thức Chlorhexidine Digluconate kháng khuẩn an toàn, dịu nhẹ trong khăn ( 25 tờ ) - Oma&Baby premium baby wet wipes ( 25 sheets per package)",19000,19000,0,0
TIKI,do-choi-me-be,129710160,"Tắm gội dịu nhẹ 2 in 1 Sakura Pigeon 200ML/700ML",63000,89000,26000,29
TIKI,do-choi-me-be,50218043,"Đồ Chơi Siêu Xe Điều Khiển Từ Xa Veyron Sport DK81001 - Màu Xanh",187500,250000,62500,25
TIKI,do-choi-me-be,188128745,"Đồ chơi trẻ em: Xe ô tô mô hình hợp kim chống bạo động DK 81104. Kiểu dáng, mẫu xe, màu sắc ngẫu nhiên.",93750,125000,31250,25
TIKI,do-choi-me-be,48490790,"Bộ xếp hình 2 tấm 48 mảnh ghép khổ A3, Xì trum và Doremon . Tia Sáng Việt Nam. Đồ chơi trí tuệ cho bé từ 3 tuổi. Ký hiệu: Xếp hình.",78000,78000,0,0
TIKI,do-choi-me-be,270988461,"Sữa non cho trẻ sơ sinh từ 0 -12 tháng Ildong Plus 1 Hàn giúp trẻ phát triển trí não, xương, răng, tăng sức đề kháng, tiêu hóa tốt - QuaTangMe Extaste",350000,700000,350000,50
TIKI,do-choi-me-be,152477312,"Đồ Chơi Lắp Ráp Khí Tài Quân Sự - Chiến Đấu Cơ - Cresta DK81056 (140 Chi tiết)",81000,108000,27000,25
TIKI,do-choi-me-be,249161079,"Núm ty Cổ Rộng Wesser S/M/L (2 cái/hộp)",100050,115000,14950,13
TIKI,do-choi-me-be,31824189,"Sữa bột Nutifood DiabetCare Gold 900g – DD cho người bị tiểu đường",510000,510000,0,0
TIKI,do-choi-me-be,84698911,"Nước Tắm Gội Thảo Dược Dr Papie",119000,119000,0,0
TIKI,do-choi-me-be,155723630,"Khăn Sữa Unmei 6 lớp 30x30cm - Khăn Lau cho Bé - Khăn Vải Xô - Dày dặn - Thấm Hút Tốt - Màu Trắng Hoa văn ngẫu nhiên",15000,15000,0,0
TIKI,do-choi-me-be,22099539,"Sữa Bột VitaDairy ColosBaby Gold 0+ (800g)",501000,501000,0,0
TIKI,do-choi-me-be,95255494,"Combo 3 Tã Quần Siêu Cao Cấp Huggies Platinum Nature Made L44 (44 Miếng)",795000,898000,103000,11
TIKI,do-choi-me-be,136387363,"2 Hộp Sữa Bột Meiji 1-3 Growing Up Formula (800g)",1018000,1018000,0,0
TIKI,do-choi-me-be,182739555,"Sữa bột Similac Total Protection 3 cho trẻ 1-2 tuổi 900g",568000,568000,0,0
TIKI,do-choi-me-be,131138312,"Tự lắp ráp khủng long - Khủng long bạo chúa DK81087",77000,110000,33000,30
TIKI,do-choi-me-be,6464025,"Cháo Tươi Gà Ác Đậu Xanh Cây Thị",27500,27500,0,0
TIKI,do-choi-me-be,1030565,"Khăn Giấy Ướt Hương Thơm Mát, Kháng Khuẩn An Toàn Cho Bé Mamamy (100 Tờ) - Hồng",33000,33000,0,0
TIKI,do-choi-me-be,73535991,"Khăn sữa sợi tre mềm mại thấm hút tốt, thương hiệu KACHOO 8 cái/hộp kích thước 30x30cm",79000,79000,0,0
TIKI,do-choi-me-be,98103420,"Siro Ăn Ngon BaBy Plus-Cải Thiện Tình Trạng Biếng Ăn Giúp Bé Tăng Cân Khỏe Mạnh",358000,358000,0,0
TIKI,do-choi-me-be,109334060,"Núm ty ngậm thông khí Philips Avent hình thú (phiên bản Lime) cho trẻ từ 6-18 tháng tuổi _ vỉ đôi",245000,245000,0,0
TIKI,do-choi-me-be,46183076,"3 Hộp Sữa bột nguyên kem của NutiFood 900 Gr",535000,535000,0,0
TIKI,do-choi-me-be,69194167,"Tã quần Bobby - Đệm Lưng Thấm Mồ Hôi XXL56 (56 miếng) - Tặng 8 miếng trong gói",898000,898000,0,0
TIKI,do-choi-me-be,194963459,"Bình Nước Có Ống Hút Cho Bé Tập Uống Có Van Chống Sặc Hình Mũi Lợn Cao Cấp 250-350ml Bằng Nhựa PP Chịu Nhiệt Tốt Có Tay Cầm Tiện Lợi - Hàng Loại 1 - Chính Hãng MINIIN",41160,58800,17640,30
TIKI,do-choi-me-be,104806945,"Combo 5 Quần Lót Bé Gái ATUNER QLG023, Quần Chip Đùi Bé Gái 3-10 Tuổi, Vải Cotton Mềm Mại, Thoáng Mát, Kháng Khuẩn, Màu Sắc, Họa Tết Tươi Sáng, Đáng Yêu - Hàng Chính Hãng",279000,345000,66000,19
TIKI,do-choi-me-be,56998980,"Tinh dầu hoa anh thảo - Blackmores Evening Primrose (190 viên - MẪU MỚI NHẤT)",535000,668750,133750,20
TIKI,do-choi-me-be,180855734,"Sữa Tắm Gội Toàn Thân Cho Bé Natural Botanical Pigeon 200ml/500ml",84000,112000,28000,25
TIKI,do-choi-me-be,120380556,"Combo 2 nước rửa bình sữa  (Gói)",142400,160000,17600,11
TIKI,do-choi-me-be,19944387,"Tã Dán Siêu Thấm Caryn M10 (10 Miếng)",95900,102700,6800,7
TIKI,do-choi-me-be,14236896,"Thảm nằm chơi dành cho trẻ em Toys House NACH-28",2269000,2269000,0,0
TIKI,do-choi-me-be,168183965,"Khăn Lau Hạ Sốt Dr.Papie 3+ Cho Bé Hạ Nhiệt Giảm Sốt Ngăn Ngừa Co Giật",185000,185000,0,0
TIKI,do-choi-me-be,37545724,"Khăn Tắm Em Bé Sợi Tre Bonny Cỡ Lớn 1m2x1m2 Siêu Mềm Và Thấm Hút (Được Chọn Họa Tiết)",95000,98000,3000,3
TIKI,do-choi-me-be,182800115,"Tã/Bỉm Quần Mijuku đủ size M/L/XL/2Xl/3Xl số lượng 50 Miếng cho bé",159000,159000,0,0
TIKI,do-choi-me-be,136981293,"Hộp 1 Bình sữa mô phỏng tự nhiên hiệu Philips Avent cho trẻ từ 6 tháng tuổi",315000,315000,0,0
TIKI,do-choi-me-be,191925662,"Boardgame Thám Tử Lừng Danh Conan Nàng Dâu Halloween - Thính",87100,99000,11900,12
TIKI,do-choi-me-be,116572144,"Thùng 4 lon sữa bột dinh dưỡng công thức HiPP 3 Organic Combiotic chất lượng hữu cơ tăng cường sức khoẻ hệ miễn dịch, bổ sung Canxi và vitamin D dành cho trẻ trên 12 tháng tuổi (4 lon x 800g)",3140000,3140000,0,0
TIKI,do-choi-me-be,109127772,"Núm ty ban đêm Philips Avent cho trẻ từ 6-18 tháng tuổi 376.21",265000,265000,0,0
TIKI,do-choi-me-be,173858511,"Xe ô tô điều khiển từ xa KAVY 608 tỷ lệ 1:12 kích cỡ rất lớn tốc độ cao, màu sắc cực kì ngầu",545000,545000,0,0
TIKI,do-choi-me-be,440484,"Hút Mũi Dây Bằng Silicone Mềm Kuku KU5342",69000,69000,0,0
TIKI,do-choi-me-be,57776884,"Combo Bộ 16 Miếng Dụng Cụ Silicone Chặn Và Bịt Góc Bàn Tủ Cửa Bảo Vệ Bé Legaxi",7000,7000,0,0
TIKI,do-choi-me-be,15356106,"Thùng 48 Hộp Sữa Bột Pha Sẵn Vinamilk Dielac Grow Plus - Đỏ 110ml",365000,365000,0,0
TIKI,do-choi-me-be,89565445,"Yến mạch nguyên hạt cán mỏng DK Harvset nhập khẩu ÚC - Thích hợp cho bé ăn dặm từ 6 tháng tuổi - Túi 500g",39000,39000,0,0
TIKI,do-choi-me-be,58722050," Bộ 6 sách vải Song ngữ VIỆT - ANH kích thích thị giác cho bé (PiPô Việt Nam)",109000,109000,0,0
TIKI,do-choi-me-be,68258090,"Gối cao su non cho bé chống bẹp đầu cao cấp. Gối dành cho bé từ 1 tuổi đến 6 tuổi. Mềm mại, thoáng khí, giúp con ngủ ngon hơn",247000,247000,0,0
TIKI,do-choi-me-be,174293493,"Xe ô tô điều khiển từ xa KAVY BS009A có tạo hình chữ đèn LED tốc độ cực kì cao, trình diễn tự động 5 chế độ",353000,353000,0,0
TIKI,do-choi-me-be,73243127,"Cetaphil tắm gội hữu cơ Organic - Cetaphil Baby Wash & Shampoo with Organic Calendula ",264900,450000,185100,41
TIKI,do-choi-me-be,176472306,"Ghế gội đầu cho bé Holla 03151 - Hàng chính hãng",479000,660000,181000,27
TIKI,do-choi-me-be,249168957,"Dụng cụ vệ sinh bình sữa Wesser",61060,71000,9940,14
TIKI,do-choi-me-be,109365794,"Philips Avent Núm Ty Ngậm Thông Khí / Siêu Mềm dành cho Bé 0-6 và 6-18 Tháng (Hộp Đơn/Hộp Đôi)",195000,195000,0,0
TIKI,do-choi-me-be,53252195,"Núm Ty Silicon Siêu Mềm Tự Nhiên Cho Bé Tommee Tippee Natural Start Fast Flow Từ 6 Tháng (Vỉ đôi, tách lẻ)",195000,195000,0,0
TIKI,do-choi-me-be,144637608,"Lều xông hơi tự bung kèm nồi xông dung tích lớn",539000,539000,0,0
TIKI,do-choi-me-be,82073505,"Máy Massage Thông Tắc Tia Sữa Kích Sữa Lavie Tự Làm Tại Nhà Chữa Tắc Nhanh An Toàn Không Đau Ngừa Tái Phát Hàng Đầu Hoa Kỳ",1089000,1089000,0,0
TIKI,do-choi-me-be,132301165,"Dây Bọt Biển Bọc Cạnh Bàn, Góc Tủ, Ghế- Tránh Va Đập Góc Cạnh Sắt Dài 2M Chữ L Kèm Băng Dán ( Giao Màu Ngẫu Nhiên )- Hàng Loại 1- Chính Hãng MINIIN",49000,49000,0,0
TIKI,do-choi-me-be,97823805,"Set 3 Khăn Sữa Sợi Tre Lụa 4 Lớp Bonny Hàng Cao Cấp Thấm Hút Tốt, Kháng Khuẩn (Kích thước: 30x30Cm)",53900,55000,1100,2
TIKI,do-choi-me-be,49362845,"Com bo 4 bịch khăn vải đa năng LIKADO 300g gấp tư  kích thước 14 *20cm (khoảng 270 tờ)",160000,160000,0,0
TIKI,do-choi-me-be,21509748,"Áo lót bầu và sau sinh cho con bú- Sunbaby",62000,62000,0,0
TIKI,do-choi-me-be,4105713,"Sữa Tắm Gội Cho Trẻ Sơ Sinh Và Em Bé Da Thường Mustela (500ml)",324950,335000,10050,3
TIKI,do-choi-me-be,15356104,"Thùng 48 Hộp Sữa Bột Pha Sẵn Vinamilk Optimum Gold 110ml",375000,375000,0,0
TIKI,do-choi-me-be,21442721,"Bộ 5 quần lót giấy miễn giặt cho mẹ bầu- Sunbaby",26000,26000,0,0
TIKI,do-choi-me-be,104158078,"Bình uống nước tay cầm có ống hút Pigeon 150ml",127000,211000,84000,40
TIKI,do-choi-me-be,112109438,"Thùng sữa nước pha sẵn Nutricare Care 100 GOLD cho trẻ thấp còi, biếng ăn từ 1 tuổi (180ml)",553760,553760,0,0
TIKI,do-choi-me-be,104155144,"[MUA LÀ CÓ QUÀ] Bình tập ăn Pigeon 120ml/240ml",65000,72000,7000,10
TIKI,do-choi-me-be,132209270,"Rubik 4x4 - Đồ chơi trí tuệ - DK81084",87500,125000,37500,30
TIKI,do-choi-me-be,95082970,"Sữa bột Enfagrow A2 Neuropro 3 dành cho trẻ từ 1 - 6 tuổi – 350g",275000,275000,0,0
TIKI,do-choi-me-be,5448935,"Sữa bột Nutricare Gold Mới phục hồi bồi bổ cơ thể (400g, 900g)",398000,398000,0,0
TIKI,do-choi-me-be,175549412,"Viên uống DHA Bio Island cho bà bầu (60 viên)",560000,560000,0,0
TIKI,do-choi-me-be,96995992,"Đồ Chơi DISCOVERY Bộ Khảo Cổ Truy Tìm Xương Khủng Long - T.Rex 1423004871",399000,399000,0,0
TIKI,do-choi-me-be,95269397,"Tã Quần Siêu Cao Cấp Huggies Platinum Nature Made XXL26 (26 Miếng)",269000,269000,0,0
TIKI,do-choi-me-be,88998734,"Xe mô hình mô tô cảnh sát KAVY NO.8808 bằng hợp kim và nhựa có nhạc và đèn",112000,112000,0,0
TIKI,do-choi-me-be,59140234,"Combo 2 chai xịt xả vải khô hương nước hoa Lâm Đại Phúc",58000,58000,0,0
TIKI,do-choi-me-be,191726145,"Máy tiệt trùng sấy khô nấu cháo thông minh tích hợp máy hâm sữa - CAPTAIN 2 - FB4315SL",1222000,1222000,0,0
TIKI,do-choi-me-be,273595369,"Bộ cờ vua nam châm 25*25cm gấp gọn cao cấp- Hàng Chính Hãng",121380,186000,64620,35
TIKI,do-choi-me-be,112101672,"Thùng sữa nước Nutricare Metacare ECO giúp trẻ phát triển toàn diện (110ml)",296000,296000,0,0
TIKI,do-choi-me-be,485783,"Sữa Công Thức Glico Icreo Follow Up Milk Số 9 (820g)",544909,544909,0,0
TIKI,do-choi-me-be,159004238,"Bộ thẻ Bài Pokemon Hộp 360 Thẻ Cao Cấp Siêu Đẹp",219000,219000,0,0
TIKI,do-choi-me-be,28604727,"Thẻ bài Lầy - Trò chơi vui nhất dành cho nhóm bạn - Party game",96700,129000,32300,25
TIKI,do-choi-me-be,513966,"Sữa Bột Dành Cho Mẹ Bầu Anmum Materna Hương Chocolate 800g",443000,471000,28000,6
TIKI,do-choi-me-be,124175653,"Tã/bỉm dán Molfix Thiên nhiên Super Jumbo L (9kg - 13kg) - Gói 68+8 miếng",370000,370000,0,0
TIKI,do-choi-me-be,76399518,"Xe đồ chơi mô hình KAVY xe tải nâng hàng cho bé chất liệu nhựa an toàn, kích thước lớn",74000,74000,0,0
TIKI,do-choi-me-be,124209061,"Tã/bỉm quần Molfix Thiên nhiên Super Jumbo L (9kg - 13kg) - Gói 54+8 miếng",175000,355000,180000,51
TIKI,do-choi-me-be,146518373,"Combo 2 Lon Sữa Glico Icreo Balance Milk (Icreo Số 0) Dinh Dưỡng Cho Bé Từ 0 Đến 12 Tháng (800g/lon) Kèm 5 Thanh Sữa",1109000,1109000,0,0
TIKI,do-choi-me-be,15214223,"Gối chống bẹp đầu, méo đầu cho bé. Gối cao su non Babyupp - Tặng kèm cẩm nang chăm sóc bé",209000,209000,0,0
TIKI,do-choi-me-be,24926510,"Sữa bột Weight Gain dành cho người gầy- Sunbaby SBTW2019",395000,395000,0,0
TIKI,do-choi-me-be,15787852,"Thảm xốp lót sàn cho bé - đơn màu Pastel (10 miếng, diện tích 1m2)",113000,130000,17000,13
TIKI,do-choi-me-be,89253743,"Combo Sữa Tắm Arau Baby Chai 450ml Và Túi 400ml",285360,328000,42640,13
TIKI,do-choi-me-be,19914619,"Siro hỗ trợ phát triển não bộ và thị lực cho bé Doppelherz Aktiv Kinder Omega-3 Syrup (Chai 250ml)",478000,478000,0,0
TIKI,do-choi-me-be,32807168,"Đồ chơi bàn bi lắc bóng đá Table Top Foosball (Gỗ) - Bàn Bóng Đá Bi Lắc Trẻ Em Chính Hãng",209000,209000,0,0
TIKI,do-choi-me-be,104153835,"Ty ngậm đơn Pigeon size S",94000,104000,10000,10
TIKI,do-choi-me-be,173810325,"Khăn mặt cho bé xô Muslin 25x25cm - AICDBGMTKQ06 - AIN Closet",15000,25000,10000,40
TIKI,do-choi-me-be,69302428,"Bộ Tranh Ghép Xếp Hình 1000 Pcs Jigsaw Puzzle (Tranh ghép 70*50cm) Bản Thú Vị Cao Cấp",109000,109000,0,0
TIKI,do-choi-me-be,112097646,"Thùng sữa nước Nutricare Metacare GOLD hỗ trợ hệ tiêu hóa và miễn dich (110ml)",350000,350000,0,0
TIKI,do-choi-me-be,29829803,"Chất Nhờn Ma Quái Slimy Slime - Nguyên Bản Ánh Kim",62100,69000,6900,10
TIKI,do-choi-me-be,58918395,"Kẹo dẻo đa Vitamin thiết yếu cho bé - L’il Critters Gummy Vites 300 viên mẫu mới",480000,480000,0,0
TIKI,do-choi-me-be,95280846,"Sữa Dê Công Thức DG-2 800gr  [kèm quà tặng]",869000,869000,0,0
TIKI,do-choi-me-be,74691460,"Đồ chơi mô hình xe xúc KAVY chất liệu hợp kim và nhựa nguyên sinh an toàn, chi tiết sắc sảo, các khớp chuyển động",94000,94000,0,0
TIKI,do-choi-me-be,181462676,"Cốc tập uống 3 giai đoạn AQ Richell Nhật Bản phiên bản châu Á | Baby",283745,283745,0,0
TIKI,do-choi-me-be,104140563,"Dầu gội dịu nhẹ cho bé Pigeon Hương Jojoba 200ml/700ml",46000,70000,24000,34
TIKI,do-choi-me-be,14534547,"Bộ 10 tấm Thảm xốp cho bé ECOBABY, thảm xốp đạt tiêu chuẩn Mỹ và Châu Âu - kích thước 1 tấm 30x30cm, độ dày khoảng 1cm - Hình động vật",94900,94900,0,0
TIKI,do-choi-me-be,97847773,"Quây Cũi Kiêm Nhà Bóng Cho Bé - Quây Bóng Cho Bé Hình Chữ Nhật Có Ném Bóng Rổ - Hàng nhập khẩu",599000,599000,0,0
TIKI,do-choi-me-be,119706874,"Sữa tắm gội dịu lành cho bé Cetaphil Baby Gentle Wash & Shampoo 230ml",170000,170000,0,0
TIKI,do-choi-me-be,142711935,"[COMBO 2 Hộp 1KG] Ngũ Cốc Cao Cấp Lợi Sữa Min Min 30 Hạt _ Chuyên Lợi Sữa và Phụ Hồi Sức Khỏe Sau Sinh (1 Hộp 500Gr)",480000,480000,0,0
TIKI,do-choi-me-be,16386201,"Sáp Giữ Ấm Cho Bé Giúp Chống Cảm Giảm Ho Giúp Bé Không Bị Nhiễm Lạnh Khi Tắm Khi Ngủ Đêm Hoặc Đi Chơi Ngoài Trời Gió Bí Quyết Chăm Con Của Mẹ 10g",83000,90000,7000,8
TIKI,do-choi-me-be,474635,"Tã Dán Bobby Siêu Mỏng Gói Cực Đại XXL56 (56 Miếng)",269000,363400,94400,26
TIKI,do-choi-me-be,174114983,"Xe ô tô địa hình điều khiển từ xa  KAVY 609 tỷ lệ 1:8 kích cỡ siêu khủng bằng hợp kim có đèn tốc độ cao tần số 2.4 GHz",910000,910000,0,0
TIKI,do-choi-me-be,147003701,"Núm ty Pigeon cổ hẹp silicon siêu mềm (LL) dành cho bé từ 12 tháng tuổi vỉ 2 cái",87000,102000,15000,15
TIKI,do-choi-me-be,78500624,"Đồ chơi mô hình xe tải container KAVY No.8807 chất liệu nhựa an toàn, chi tiết sắc sảo bền và đẹp",65000,65000,0,0
TIKI,do-choi-me-be,178007097,"TÃ DÁN NGƯỜI GIÀ CARYN SIZE XL20 MIẾNG",262000,262000,0,0
TIKI,do-choi-me-be,188453611,"Đồ chơi lắp ráp, xếp hình chủ đề quân sự Qman 42301 – Xe Tăng Quân Sự (642 chi tiết, 8 trong 1)",489000,489000,0,0
TIKI,do-choi-me-be,129665819,"TẤM ĐỆM LÓT SIÊU THẤM CARYN 20 MIẾNG",118000,118000,0,0
TIKI,do-choi-me-be,146520695,"Đồ chơi Cờ cá ngựa phiên bản ô tô bằng gỗ chính hãng TOPBRIGHT – Family Games Motown Flying Chess (cho bé từ 3 tuổi)",209000,309000,100000,32
TIKI,do-choi-me-be,148073878,"KHĂN ƯỚT BOBBY KHÔNG MÙI/CÓ MÙI LOẠI 100 TỜ CÓ NẮP",35000,35000,0,0
TIKI,do-choi-me-be,97990859,"Set 2 Khăn Tắm Bonny 4 Lớp 90x90Cm Chất Liệu Tre Lụa Mềm Mại Kháng Khuẩn Siêu Thấm Hút An Toàn Cho Da Bé (Hàng Cao Cấp)",269500,275000,5500,2
TIKI,do-choi-me-be,158409967,"Bộ Xếp Hình TOI Thăng Cấp Từ Dễ Đến Khó Cho Bé 1-7 TUỔI - TOI LEVELED PUZZLE",209000,209000,0,0
TIKI,do-choi-me-be,22978392,"Sữa Bột Nutifood Grow Plus+ Đỏ (900g)",392000,392000,0,0
TIKI,do-choi-me-be,270699074,"Canxi cho bé Healthy Care Kids Milk Calcium Úc, Hỗ trợ tăng trưởng chiều cao, hệ thống xương, răng, bé ngủ ngon không trằn trọc ban đêm - QuaTangMe Extaste",263000,526000,263000,50
TIKI,do-choi-me-be,175466027,"Sản Phẩm Dinh Dưỡng Nestle Nutren Junior (850g)",635000,635000,0,0
TIKI,do-choi-me-be,57793181,"Pregnacare Breast-feeding Bổ Sung Vitamin Và Lợi Sữa cho mẹ sau sinh số 1 Anh chính hãng",368000,460000,92000,20
TIKI,do-choi-me-be,88924591,"Sữa Bột Frisolac Gold 3 380g Dành Cho Trẻ Từ 1 - 2 Tuổi",220000,220000,0,0
TIKI,do-choi-me-be,176937772,"Medela - Kem Purelan 37g - Dành cho mẹ có đầu ty khô, nứt, chảy máu - 100% chiết xuất thiên nhiên, an toàn tuyệt đối.",395000,395000,0,0
TIKI,do-choi-me-be,117208992,"Hút Mũi Dây Silicon UPASS Tự Điều Chỉnh Lực Hút Cho Bé / UP1006C",63000,63000,0,0
TIKI,do-choi-me-be,132339708,"Đồ chơi mô hình máy bay dân dụng chạy trớn",40000,40000,0,0
TIKI,do-choi-me-be,41382916,"Combo 3 bịch Khăn vải khô đa năng Mama (bịch 240 tờ)",149000,149000,0,0
TIKI,do-choi-me-be,44959788,"Sữa Bột Namyang Imperial Mom XO GT 800g",527000,594000,67000,11
TIKI,do-choi-me-be,192880134,"Đồ chơi mô hình xe cẩu ủi KAVY-032 chạy đà có móc đồ theo cơ chế ròng rọc bánh cao su",94000,94000,0,0
TIKI,do-choi-me-be,188135082,"Đồ chơi trẻ em: Xe ô tô mô hình hợp kim, xe cứu hỏa DK 81105. Kiểu dáng, mẫu xe, màu sắc ngẫu nhiên.",87500,125000,37500,30
TIKI,do-choi-me-be,75510737,"Đồ Chơi : Đồ Chơi Máy Bay DK81038",195000,260000,65000,25
TIKI,do-choi-me-be,70844478,"Bộ 324 Thẻ Bài Chơi Pokemon Sun&Moon Unbroken Bonds Cao Cấp",199000,199000,0,0
TIKI,do-choi-me-be,21553065,"Làm sạch cặn canxi ố sen vòi inox Sabo-I",199000,199000,0,0
TIKI,do-choi-me-be,14537741,"Thảm Xốp Cho Bé, Thảm Chơi Xếp Hình Lắp Ghép, Xốp Lót Trải Sàn Thoại Tân Thành - Bộ 40 tấm (15x15cm)",90000,90000,0,0
TIKI,do-choi-me-be,110308330,"Sữa bột Nutricare Bone phòng chống loãng xương sụn khớp cho người lớn tuổi (900g)",337844,337844,0,0
TIKI,do-choi-me-be,84778751,"Núm ty Philips Avent tự nhiên vỉ đôi 654.23 Dành Cho Bé Trên 6 tháng",225000,225000,0,0
TIKI,do-choi-me-be,59393787,"Bàn Cờ Caro Kết Hợp Cờ Vua Quốc Tế Bằng Gỗ Tiện Lợi Đồ Chơi Gỗ Thông Minh",165000,207000,42000,20
TIKI,do-choi-me-be,91668933,"Xe ô tô điều khiển từ xa KAVY NO.8808 thông minh đa chức năng cảm biến ngoại vật, di chuyển 360 độ đi theo đường nét vẽ",382000,382000,0,0
TIKI,do-choi-me-be,7248879,"Bột Men Vi Sinh Xử Lý Hầm Cầu SiFa Bio Fast (300gr)",49000,49000,0,0
TIKI,do-choi-me-be,270988323,"Vitamin tổng hợp nữ One Daily Women's Multivitamin Puritan's Pride tăng sức đề kháng và tăng sức khỏe tổng thể - QuaTangMe Extaste",384000,768000,384000,50
TIKI,do-choi-me-be,7816820,"Chất thông tắc bồn cầu toilet chống hôi siêu tốc 1200g Sifa",74000,74000,0,0
TIKI,do-choi-me-be,73577614,"Sản Phẩm Dinh Dưỡng Công Thức ColosBaby IQ 0+ 800g - S",525000,525000,0,0
TIKI,do-choi-me-be,52664603,"GỐI ÔM BÀ BẦU CHỮ U Zcare - màu tím sang trọng",619000,619000,0,0
TIKI,do-choi-me-be,176937904,"Medela - Trợ ti hỗ trợ cho trẻ bú, size S/M/L - Dùng cho các mẹ đầu ty bị nứt hoặc phẳng, tụt, ngắn - Giúp cho trẻ ngậm bú dễ dàng",495000,495000,0,0
TIKI,do-choi-me-be,142212910,"Lều xông hơi tự bung chui đầu tại nhà chống thấm nước ( giao màu ngẫu nhiên)",198000,198000,0,0
TIKI,do-choi-me-be,25293740,"Gia vị rắc cơm thập cẩm Hello Kitty Sanrio Nhật Bản",65000,65000,0,0
TIKI,do-choi-me-be,629718,"Nước Rửa Bình Sữa Wesser Dạng Gói (500ml)",80000,80000,0,0
TIKI,do-choi-me-be,184294558,"LEGO City 60354 Nhiệm Vụ Thám Hiểm Sao Hỏa (298 chi tiết)",679000,959000,280000,29
TIKI,do-choi-me-be,154703056,"Áo yếm máng dài tay Cotton chống thấm nước cho bé tập ăn, tập vẽ Mastela",90000,90000,0,0
TIKI,do-choi-me-be,182748148,"Sữa bột Similac Total Protection 2 900g cho trẻ 6-12 tháng tuổi",639000,639000,0,0
TIKI,do-choi-me-be,412776,"Tã Quần Cao Cấp Moony Nhật Bản Bé Trai XL38 (38 Miếng)",270000,466400,196400,42
TIKI,do-choi-me-be,24495867,"Bột Thông Tắc Bồn Cầu, Thông Tắc Cống Sifa Đa Năng Siêu Nhanh 200g",33000,33000,0,0
TIKI,do-choi-me-be,2790305,"Gel gừng thảo dược, massage tan mỡ bụng, săn chắc eo Wonmom 70g",212000,212000,0,0
TIKI,do-choi-me-be,77032298,"Bài Tây Poker Copag 100% Plastic Chính Hãng Siêu Bền",90000,90000,0,0
TIKI,do-choi-me-be,58706577,"1 thùng Sữa Dinh Dưỡng Tăng Chiều Cao từ Óc chó Hạnh nhân Đậu đen hiệu Golden Health (thùng 20 bịch 195ml)",255000,255000,0,0
TIKI,do-choi-me-be,755471,"Cờ Domino Ngà Nhỏ Liên Hiệp Thành KDNN",73000,73000,0,0
TIKI,do-choi-me-be,40863685,"Đai Đỡ Bụng Bầu Cho Mẹ Bầu Chính Hãng Amalife - Nhiều size",109000,109000,0,0
TIKI,do-choi-me-be,116727410,"Sữa Hữu Cơ Miwako Nhập Khẩu Malaysia Hộp 700g Vị Gạo, Sữa Hạt Dinh Dưỡng Cho Bé Biếng Ăn Tiêu Hóa Kém Thấp Còi",710500,715000,4500,1
TIKI,do-choi-me-be,181455505,"[DATE THÁNG 10.24] Thùng 48 hộp IQLac Colostrum Biếng Ăn Suy Dinh Dưỡng Premium 110ml cho trẻ biếng ăn, thấp còi, suy dinh dưỡng từ 1 tuổi",399000,508800,109800,22
TIKI,do-choi-me-be,249346935,"Bột canxi cá tuyết Fine Japan Nhật Bản (140g)",149000,149000,0,0
TIKI,do-choi-me-be,188835460,"Sữa bột CaloSure Gold – dinh dưỡng dành cho người cao tuổi 900G",529000,529000,0,0
TIKI,do-choi-me-be,95010190,"Đồ chơi xếp hình, lắp ráp Qman 1720 - Cuộc xung đột bờ biển  (235 mảnh ghép)",175000,199000,24000,12
TIKI,do-choi-me-be,73642565,"NƯỚC GIẶT ĐỒ SƠ SINH HỮU CƠ K-MOM HÀN QUỐC (1300ML/1700ML) TẶNG 2 ZIPPER 15CM",173630,179000,5370,3
TIKI,do-choi-me-be,74956654,"Dụng Cụ Dập Lỗ Núm Ty FARLIN - BF-112",129000,129000,0,0
TIKI,do-choi-me-be,14536554,"Bộ 10 tấm Thảm xốp cho bé ECOBABY, thảm xốp đạt tiêu chuẩn Mỹ và Châu Âu -  kích thước 1 tấm 30x30cm, độ dày khoảng 1cm - Hình học",94900,94900,0,0
TIKI,do-choi-me-be,77702037,"Đồ chơi xếp hình Qman 42101 - Tàu hỏa biến hình (305 mảnh ghép)",179000,199000,20000,10
TIKI,do-choi-me-be,152532293,"Đồ Chơi ghép hình 4 mùa - Mùa Hè DK81075",95200,136000,40800,30
TIKI,do-choi-me-be,119706870,"Dầu gội dịu lành cho bé Cetaphil Baby Shampoo 200ml",170000,170000,0,0
TIKI,do-choi-me-be,1347577,"Phấn Gạo Chống Hăm, Rôm, Sảy, Da Khô Hương Dịu Nhẹ ReisCare Extra Mild (50g)",58410,64900,6490,10
TIKI,do-choi-me-be,170487028,"Khăn Lau Hạ Sốt 2Y+ Oribebe Cho Bé Giúp Hạ Nhiệt Giảm Sốt Hộp 4 Túi x 6 Khăn",134000,195000,61000,31
TIKI,do-choi-me-be,93152375,"Combo Tiết Kiệm: Nước rửa bình sữa Arau Baby 450 - Mẫu Mới, Hàng Có Tem Phụ Chính Hãng",200208,258000,57792,22
TIKI,do-choi-me-be,450230,"Dầu Gội Và Xả 2 Trong 1 Cho Bé Gái Bubchen Rosalea (230ml) - N",115000,115000,0,0
TIKI,do-choi-me-be,146630598,"Đệm Toilet ngồi đi vệ sinh , giúp  thu nhỏ bồn cầu trẻ em Cleverbees - Hàng chính hãng",99000,99000,0,0
TIKI,do-choi-me-be,117667864,"Thùng sữa nước trái cây Nutricare Smarta Grow (vị dâu) dinh dưỡng cho trẻ thấp còi (110ml)",224620,224620,0,0
TIKI,do-choi-me-be,172000892,"Tã Dán Siêu Thấm Caryn Gói Siêu Tiết Kiệm M40 (40 Miếng)",357000,357000,0,0
TIKI,do-choi-me-be,73224108,"Khăn vải khô đa năng Mipbi loại bản to gói 900g",110000,110000,0,0
TIKI,do-choi-me-be,124716612,"Thùng 6 lon Sữa bột công thức HiPP 4 Organic Combiotic 800g (6 lon x 800g)",4410000,4410000,0,0
TIKI,do-choi-me-be,126022179,"Tã Bỉm Dán/Quần YOULI XANH Đủ Size S56/M48/M44/L42/XL40/XXL36/XXXL34",125000,125000,0,0
TIKI,do-choi-me-be,820405,"Sữa Tắm Gội Toàn Thân Cetaphil Baby 2 In 1 (230ml)",144000,168000,24000,14
TIKI,do-choi-me-be,55102682,"Bàn xây dựng đa năng 2020",980000,980000,0,0
TIKI,do-choi-me-be,576817,"Tã Dán Cao Cấp Moony Nhật Bản L54 (54 Miếng )",265000,466400,201400,43
TIKI,do-choi-me-be,112078424,"Đồ chơi mô hình xe cẩu móc nâng vật liệu xây dựng có chân đỡ KAVY NO. 8807  bánh xe di chuyển được",98000,98000,0,0
TIKI,do-choi-me-be,32334432,"Đặc Sản Phan Thiết - Nước Mắm Tĩn Trẻ Em Cá Cơm Than Cặp 2 Chai 250Ml Không Chất Bảo Quản, An Toàn Cho Bé",187000,380000,193000,51
TIKI,do-choi-me-be,270691604,"Sữa non cho trẻ sơ sinh từ 0 -12 tháng Ildong Colostrum Meal Plus 1 ( Hàn ) bổ sung đầy đủ dinh dưỡng cần thiết cho bé - OZ Slim Store",265000,265000,0,0
TIKI,do-choi-me-be,73642514,"Máy Hút Sữa Không Dây Mama's Choice, Vắt Sữa Rảnh Tay Mọi Lúc Mọi Nơi, Pin Sạc Tiện Lợi, BH 1 Đổi 1 Mới 12 Tháng - 1 Máy",1990000,1990000,0,0
TIKI,do-choi-me-be,117399458,"bộ dụng cụ lấy ráy tai Kèm Kẹp Gắp Có Đèn Cho Bé Cao Cấp Mầu Hồng",118000,138000,20000,14
TIKI,do-choi-me-be,93553646,"Siêu Cứu Hỏa - Rồng Phương Đông (Orient Dragon) Winka DK81044",345000,690000,345000,50
TIKI,do-choi-me-be,101365701,"[ HỘP DÙNG THỬ] Sữa non cho bé Colosmulti Pedia hộp 2 gói x16g,chuyên biệt hỗ trợ trẻ ăn ngon",139000,139000,0,0
TIKI,do-choi-me-be,104147948,"Núm vú cổ hẹp silicone siêu mềm Pigeon (2 cái/vỉ)",82000,102000,20000,20
TIKI,do-choi-me-be,187393405,"Máy hút sữa điện rảnh tay và không dây Fatz Baby- Freemax 2- FB1202CW (1 chiếc)",1636000,1636000,0,0
TIKI,do-choi-me-be,111657955,"Tả quần Babies Organic size L 50 miếng ( 9-14kg)",245000,320000,75000,23
TIKI,do-choi-me-be,42023052,"Sữa Non Non ILDong Foodis CHOYUMEAL Plus: Số 1 - 100gr (Hàn Quốc)",263000,263000,0,0
TIKI,do-choi-me-be,57516996,"Lá xô thơm (white sage hay sage trắng) - Bó xô thơm và cỏ ngọt 10cm - 30gr",125000,125000,0,0
TIKI,do-choi-me-be,2563681,"Bột Ăn Dặm Vinamilk Ridielac Cá Hồi Bông Cải Xanh (200g)",69000,69000,0,0
TIKI,do-choi-me-be,85754700,"Thảo mộc vệ sinh cho mẹ, xông vùng kín thơm tho, se khít Wonmom ( 10 Túi/Hộp )",160000,180000,20000,11
TIKI,do-choi-me-be,92901201,"Combo Tiết Kiệm: 10 Gói Khăn Ướt Bobby Care Không Hương 100 Miếng/Gói",375000,375000,0,0
TIKI,do-choi-me-be,116841132,"Healthy Care Kids Gummy Multivitamin 250v Của Úc - Kẹo Dẻo Bổ Sung Vitamin Cho Bé ",415000,415000,0,0
TIKI,do-choi-me-be,35043557,"Sữa Bột Abbott Similac 4 900g",539000,539000,0,0
TIKI,do-choi-me-be,119706878,"Sữa tắm dưỡng ẩm dịu lành cho bé Cetaphil Baby Moisturizing Bath & Wash 230ml",170000,170000,0,0
TIKI,do-choi-me-be,79008843,"[COMBO 6 GÓI] KHĂN VẢI KHÔ ĐA NĂNG AIKO 270 TỜ/ GÓI",205000,205000,0,0
TIKI,do-choi-me-be,52588245,"Combo 2 lon Sữa Morinaga số 2 (Chilmil) 850g",948000,1156000,208000,18
TIKI,do-choi-me-be,110681205,"Cốc trữ sữa Philips Avent dung tích 180ml/cốc",635000,635000,0,0
TIKI,do-choi-me-be,195552647,"Dép Eva Bé Trai Biti's DEB009200XDD (Xanh Dương Đậm)",115000,125000,10000,8
TIKI,do-choi-me-be,124174883,"Tã/bỉm dán Molfix Thiên nhiên Super Jumbo M (6kg - 11kg) - Gói 76+8 miếng",340000,340000,0,0
TIKI,do-choi-me-be,108003928,"Bộ 2 Bình sữa mô phỏng tự nhiên hiệu Philips Avent (260ml) cho trẻ từ 1 tháng tuổi 693.23",525000,525000,0,0
TIKI,do-choi-me-be,77665180,"Máy hâm sữa tiệt trùng điện tử Duo 3 Fatz baby FB3093VN Hàn Quốc",599000,599000,0,0
TIKI,do-choi-me-be,107961508,"CỜ THÚ HỘP GIẤY LIÊN HIỆP THÀNH NEW",80000,80000,0,0
TIKI,do-choi-me-be,56699120,"Thùng 35 Gói - 7 Vị Cháo Tươi Cây Thị: Gà Ác Đậu Xanh, Cá Hồi, Cá Lóc, Lươn Đậu Xanh, Thịt Bò, Rau Củ, Thịt Heo ",646000,842500,196500,23
TIKI,do-choi-me-be,72549297,"Gối chống trào ngược cho bé Rototo bebe cao cấp khắc phục tình trạng trào ngược dạ dày trẻ sơ sinh hiệu quả - Loại Cotton lụa mẫu mới nhất",1720000,1720000,0,0
TIKI,do-choi-me-be,67550669,"Bộ đồ chơi nhà bếp cho bé nấu nướng có vòi nước và bảng vẽ Toyshouse - đồ hướng nghiệp cho bé từ 3 tới 8 tuổi",329000,329000,0,0
TIKI,do-choi-me-be,172300775,"Núm Ty Philips Avent - Núm Vú Philips Avent - Thay Bình Sữa dòng Natural - Đủ Size 1 / 2 / 3 / 4 / Y Lỗ - Tặng 1 Khăn Sữa Gạc Vải thương hiệu Unmei",115000,115000,0,0
TIKI,do-choi-me-be,52588247,"Combo 2 lon Sữa Morinaga số 2 (Chilmil) 320g (6 - 36 tháng)",380000,556000,176000,32
TIKI,do-choi-me-be,60192179,"Balo Bỉm Sữa Cao Cấp Mama's Choice 4in1 | Balo Cho Mẹ Bỉm Sữa và Bé Yêu | Lớp Giữ Nhiệt Dày Dặn và Chống Thấm | Nhiều Ngăn Siêu Tiện Dụng",340000,340000,0,0
TIKI,do-choi-me-be,180963493,"Đồ Chơi Peek A Boo Đàn Ukulele PAB016",269000,269000,0,0
TIKI,do-choi-me-be,145176658,"Yếm Bonny Vải Xô 6 Lớp Có Cúc Bấm Bên Vai Giúp Bé Thấm Rớt, Giữ Ấm Ngực (10 Tháng - 3 Tuổi)",29000,30000,1000,3
TIKI,do-choi-me-be,57520029,"Xe Thăng Bằng Tập Đi Cho Bé, Xe Chòi Chân Cho Bé Từ 18 Tháng Đến 5 Tuổi, Giúp Bé Ham Vận Động, Phát Triển Thể Chất Tối Ưu EBV GROUP An Toàn, Bền Đẹp - Hàng Chính Hãng",469000,690000,221000,32
TIKI,do-choi-me-be,197600292,"Que Thử Thai Cao Cấp Dùng Một Lần Power Test - Chính Xác Và Tiện Dùng",19000,19000,0,0
TIKI,do-choi-me-be,74871616,"Bộ đồ chơi lắp ráp xe công trình KAVY  gồm 6 xe kèm hộp đựng, tua vít, nhựa nguyên sinh kích thích tính thực hành của bé",255000,255000,0,0
TIKI,do-choi-me-be,176937847,"Medela - Kem Purelan 7g - Dùng cho mẹ bị khô, nứt, chảy máu đầu ty - 100% chiết xuất thiên nhiên, an toàn tuyệt đối",260000,260000,0,0
TIKI,do-choi-me-be,88257240,"Gối Xô Bonny 10 Lớp Thấm Hút Mồ Hôi, Mềm Mịn, Gối Cho Bé Sơ Sinh Từ 0 Đến 1 Tuổi",53000,55000,2000,4
TIKI,do-choi-me-be,24724062,"BỘT ĂN DẶM RIDIELAC GOLD GẠO SỮA - HỘP THIẾC 350G",80000,80000,0,0
TIKI,do-choi-me-be,98069609,"Ghế bô vệ sinh Inox cao cấp, có bánh xe di chuyển tiện lợi, cho người già, người bệnh và trẻ em mẫu 2021",939000,1219000,280000,23
TIKI,do-choi-me-be,152547966,"Đồ Chơi - Xe Cảnh Sát DK 81040",126000,180000,54000,30
TIKI,do-choi-me-be,125785229,"Quần chíp bé gái, set 5 chiếc quần lót bé gái Kháng Khuẩn hàng xuất Hàn Quốc dành cho bé từ 3-10 tuổi 100% Cotton",87000,169000,82000,49
TIKI,do-choi-me-be,95035801,"Sữa bột công thức HiPP 4 Organic Combiotic 800g",735000,735000,0,0
TIKI,do-choi-me-be,173383478,"Bộ Nghiền Thức Ăn Cho Bé Pigeon",354000,471000,117000,25
TIKI,do-choi-me-be,151838910,"Lều Xông Hơi cao cấp Và Nồi Xông Hơi 4L công suất lớn giúp giải cảm, chữa cúm tại nhà hiệu quả",839000,839000,0,0
TIKI,do-choi-me-be,52873241,"Mẫu mới 2020 Bình sữa Wesser PPSU cao cấp cổ hẹp cổ rộng các cỡ",201400,212000,10600,5
TIKI,do-choi-me-be,191945212,"Sữa Bột Pediasure 10+ Hương Vani 800g (cho trẻ từ 10 tuổi trở lên)",749000,749000,0,0
TIKI,do-choi-me-be,142777049,"Bô Ngồi Vệ Sinh Cho Trẻ Em Có Nắp Đậy",149000,149000,0,0
TIKI,do-choi-me-be,272310041,"Sữa tăng cân cho trẻ 1-3 tuổi Meiji Nhật giàu dưỡng chất kèm DHA giúp phát triển cân đối chiều cao, cân nặng, trí não trẻ - OZ Slim Store",529000,1058000,529000,50
TIKI,do-choi-me-be,4879479,"Đồ Chơi Xếp Hình Cho Bé Mầm Non Sato 72 Chi Tiết",104000,130000,26000,20
TIKI,do-choi-me-be,8038349,"Cốc Hứng Sữa Mama’s Choice, Hút Sữa Rảnh Tay, Chất Liệu Silicone Cao Cấp, Chứng Nhận An Toàn FDA - 1 Cốc",389000,389000,0,0
TIKI,do-choi-me-be,44832490,"Bài Tây Mạ Vàng Cao Cấp Nhũ Vàng 24K Chính Hãng miDoctor",36000,36000,0,0
TIKI,do-choi-me-be,23413563,"Máy Tiệt Trùng Bình Sữa Mama’s Choice 5in1 Tích Hợp Chức Năng Sấy Khô Phụ Kiện và Hâm Sữa Cho Bé, BH Chính Hãng 12 Tháng",1690000,1690000,0,0
TIKI,do-choi-me-be,143948628,"Combo 12 hộp pha sẵn Nutren Junior 200ml/hộp cho trẻ từ 1-10 tuổi tăng trưởng 3 chuẩn: Thế chất, Đề kháng, Tư duy - Tặng gối con mèo",379000,398000,19000,5
TIKI,do-choi-me-be,124205685,"Tã/bỉm quần Molfix Thiên nhiên Jumbo XXXL (20kg - 35kg) - Gói 24+6 miếng",265000,265000,0,0
TIKI,do-choi-me-be,107931184,"Bịch khăn ướt 100 Tờ không mùi an toàn kháng khuẩn cho bé KU01_SUNBABY",37000,37000,0,0
TIKI,do-choi-me-be,78955128,"SIRO ĂN NGON BABY PLUS - Giúp bé hết biếng ăn, tăng cân, tiêu hóa tốt - Bí Quyết Nuôi Con Nhàn Tênh",358000,358000,0,0
TIKI,do-choi-me-be,132684152,"Dung Dịch Giặt Quần Áo Cho Bé D-Nee - Túi 600ml (Xanh Lá)",79000,79000,0,0
TIKI,do-choi-me-be,136025117,"Thùng 12 gói ăn dặm trái cây nghiền mix vị Fruto Nyanya 90g/gói",541440,541440,0,0
TIKI,do-choi-me-be,113299654,"Viên Uống Milk Calcium Healthy Care Bổ Sung Canxi Cho Trẻ Trên 4 Tháng Tuổi, 60 viên, Hỗ Trợ Phát Triển Xương và Răng Giúp Cao Lớn và Khỏe Mạnh, Bé Hết Khóc Đêm, Rụng Tóc, Tóc Dựng Ngược - Ăn Ngon Ngủ Ngoan",228000,228000,0,0
TIKI,do-choi-me-be,56960573,"Viên kẹo bổ sung canxi và vitamin D thơm ngon Ostelin Ostelin Kids Calcium & Vitamin D3 nhập khẩu Úc 90 viên",268000,335000,67000,20
TIKI,do-choi-me-be,5422589,"Sữa bột Nutricare Bone phòng loãng xương cải thiện xương khớp (400g, 900g)",295000,295000,0,0
TIKI,do-choi-me-be,55647274,"Trò chơi cờ cá ngựa SPIN MASTER 6038084",159000,159000,0,0
TIKI,do-choi-me-be,6464029,"Cháo Tươi Lươn Đậu Xanh Cây Thị",20240,24000,3760,16
TIKI,do-choi-me-be,59547957,"Chất thống tắc nghẽn SIFA cầu W.C - CỐNG bicro phốt siêu tốc trị nghẹt chống hối 1.6kg thể tích thực 900ml cao cấp",40500,40500,0,0
TIKI,do-choi-me-be,22012614,"Gối cao su non đa năng ngăn ngừa méo đầu, bẹp đầu, nghẹo cổ, còm lưng cho bé. Gối cao su non Babyupp",209000,209000,0,0
TIKI,do-choi-me-be,156718469,"Thùng 30 hộp thực phẩm Formeal dinh dưỡng y học (dạng lỏng)  - Thay thế bữa ăn, dễ hấp thu -  dành cho người bệnh - Orgalife",2265000,2265000,0,0
TIKI,do-choi-me-be,175950822,"Khăn Lau Hạ Sốt 0Y+ Oribebe Cho Bé Giúp Hạ Nhiệt Giảm Sốt Hộp 4 Túi x 6 Khăn",134000,195000,61000,31
TIKI,do-choi-me-be,129665687,"(HCM) Tã quần người già Caryn size M gói lớn 32 miếng siêu tiết kiệm",349000,349000,0,0
TIKI,do-choi-me-be,399372,"Xe Buýt Nội Thành Siku - 1021",99000,99000,0,0
TIKI,do-choi-me-be,7243389,"Nhà búp bê Ngôi nhà thu nhỏ lắp ghép Pink Girl",159000,280000,121000,43
TIKI,do-choi-me-be,190135894,"Đồ chơi xếp hình, lắp ráp tàu chiến Qman 1720 - Cuộc xung đột bờ biển (235 mảnh ghép)",158000,208950,50950,24
TIKI,do-choi-me-be,30679548,"Bộ 6 Gói Khăn Ướt Không Hương Agi (100 Tờ x 6) - Giao Mẫu Ngẫu Nhiên",240000,240000,0,0
TIKI,do-choi-me-be,249171583,"Bình sữa cổ hẹp PP Wesser 60ml/140ml/250ml",115240,134000,18760,14
TIKI,do-choi-me-be,4105507,"Kem Dưỡng Da Mặt Cho Trẻ Sơ Sinh Và Em Bé Da Thường Mustela (40ml)",227950,235000,7050,3
TIKI,do-choi-me-be,198739898,"Túi Đá Khô Trữ Sữa Mama’s Choice, Giữ Lạnh Sữa Mẹ Lên Đến 14 Tiếng, Túi Giữ Nhiệt Bình Sữa, Đựng Và Giữ Ấm Đồ Ăn Cho Bé",250000,250000,0,0
TIKI,do-choi-me-be,3048073,"Khăn vải  khô đa năng StayDry (350 gram)",38000,49000,11000,22
TIKI,do-choi-me-be,74871579,"Bộ xếp hình lắp ráp bóng lăn KAVY với 101 chi tiết nhiều màu sắc kích thích giác quan, sáng tạo của trẻ",110000,110000,0,0
TIKI,do-choi-me-be,169191270,"Sữa Smatie Canxi Xương Khớp cho người tiểu đường",435000,435000,0,0
TIKI,do-choi-me-be,543915,"Nước Xả Quần Áo Cho Bé D-nee - Chai 3000ml (Xanh)",186000,220000,34000,15
TIKI,do-choi-me-be,173383480,"Bình Sữa PP Streamline Pigeon Hình Chuột Mickey 150ml/250ml",121000,201000,80000,40
TIKI,do-choi-me-be,45551545,"3 Hộp Sữa Bột VitaDairy Nepro 1 (900g)",1370000,1370000,0,0
TIKI,do-choi-me-be,66921662,"BỘT NGŨ CỐC 5 THỨ ĐẬU KHÔNG ĐƯỜNG VITAPRO (350 gr) - MẪU 1",43000,43000,0,0
TIKI,do-choi-me-be,68920900,"Cháo Tươi Bào Ngư Nấm Bào Ngư Cây Thị",32000,38000,6000,16
TIKI,do-choi-me-be,59323136,"Combo 10 bịch Sữa Óc Chó, Hạnh Nhân, Đậu Đen, Macca tăng chiều cao và cân nặng hiệu Golden Health Hàn Quốc",139000,139000,0,0
TIKI,do-choi-me-be,51116839,"Bình Uống Nước Cho Bé Bằng Nhựa PP KuKu KU5485",225000,225000,0,0
TIKI,do-choi-me-be,56536143,"Combo Bộ 4 Miếng Dụng Cụ Silicone Chặn Và Bịt Góc Bàn Tủ Cửa Bảo Vệ Bé Legaxi",7000,7000,0,0
TIKI,do-choi-me-be,55890398,"Bộ 2 kem đánh răng trẻ em Colgate Kid Free From không chất nhân tạo cho bé 3 đến 5 tuổi 80g/tuýp",89000,89000,0,0
TIKI,do-choi-me-be,10210851,"Thùng sữa nước pha sẵn Nutricare Metacare - phát triển toàn diện cho trẻ từ 1 tuổi (110ml x 48 hộp)",335000,335000,0,0
TIKI,do-choi-me-be,113623641,"Sữa Tắm, Dầu Gội 2in1 Bubchen Đức - Hương Thơm Tự Nhiên, Không Cay Mắt (hàng chuẩn Đức)",105000,105000,0,0
TIKI,do-choi-me-be,207284650,"Đồ chơi bóng vòng nhựa mềm kết hợp gặm nướu cho bé ToysHouse 822-86",109000,109000,0,0
TIKI,do-choi-me-be,84331242,"Sữa Oggi 0+ 800g - Giúp trẻ khoẻ mạnh phát triển toàn diện",305000,305000,0,0
TIKI,do-choi-me-be,109320339,"Bộ 4 gói tẩy vệ sinh máy giặt Homes Queen Hàn Quốc (400g/gói): Tẩy sạch vi khuẩn, cặn can xi, nấm trong máy giặt",200000,200000,0,0
TIKI,do-choi-me-be,94727540,"Yếm ăn dặm silicon có máng, chống rơi vãi, chống bám bẩn và dễ dàng điều chỉnh kích cỡ cho bé Royalcare TH601",90000,90000,0,0
TIKI,do-choi-me-be,55348883,"Đồ Chơi Bé Gái Xe bán kém lưu động Bằng nhựa ABS an toàn",119000,200000,81000,41
TIKI,do-choi-me-be,80367850,"Đồ chơi lắp ráp, xếp hình Qman 32012: Căn phòng công chúa - 282 mảnh ghép",179100,199000,19900,10
TIKI,do-choi-me-be,195286657,"Đồ chơi đâm hải tặc size lớn 20cm 24 kiếm",75000,75000,0,0
TIKI,do-choi-me-be,74616401,"TPBVSK Special Kid Vision - Siro tăng cường thị lực, cơ chế bảo vệ mắt 3 lớp, hỗ trợ ngăn ngừa ánh sáng xanh (125ml) [Nhập khẩu Pháp]",234000,360000,126000,35
TIKI,do-choi-me-be,48324723,"FITOBIMBI OMEGA JUNIOR – SIRO THẢO DƯỢC CHUẨN HÓA CHÂU ÂU HỖ TRỢ PHÁT TRIỂN NÃO BỘ VÀ THỊ GIÁC CHO TRẺ (30ML)",382000,382000,0,0
TIKI,do-choi-me-be,21174803,"Tẩy dầu mỡ két lâu năm trên thiết bị bếp chai Sabo-M 500ml không mùi ",149000,149000,0,0
TIKI,do-choi-me-be,72799097,"Trợ Phễu Silicone Mama's Choice NewFit, Đệm Hạ Size Phễu Size 15-17-19-21mm, Hút Sữa Hiệu Quả và Êm Ái - 2 Cái GIÁ TỐT",270000,270000,0,0
TIKI,do-choi-me-be,54014700,"Trống Thả Hình Đa Năng Happy Baby",62500,125000,62500,50
TIKI,do-choi-me-be,8001205,"Combo Set 2 viên thả bồn cầu hương lavender nội địa Nhật Bản",81500,81500,0,0
TIKI,do-choi-me-be,152528795,"Ghép Hình 4 Mùa - Mùa Xuân 24 Chi Tiết DK81074",95200,136000,40800,30
TIKI,do-choi-me-be,157833253,"Combo 2 Túi ngũ cốc Navan ",409000,409000,0,0
TIKI,do-choi-me-be,86305279,"Bộ chăm sóc mẹ đẹp như tiên, giúp da mặt sáng khỏe và trắng hồng mịn màng Wonmom (1 sữa rửa mặt hữu cơ+ 1 kem nghệ tươi)",423000,505000,82000,16
TIKI,do-choi-me-be,1549545,"Nước Giặt Arau Baby Túi (720ml) ",118874,129000,10126,8
TIKI,do-choi-me-be,41178419,"Bộ 5 Lon Sữa Bột NutiFood Diabet Care Gold Lon 900g Cho Người Tiểu Đường, Đái Tháo Đường Và Tiền Đái Tháo Đường",2460000,2460000,0,0
TIKI,do-choi-me-be,196339522,"Dây Đai Đeo Tay Chống Lạc KUNBE Dài 2.5M Khóa Nam Châm Cảm Ứng An Toàn Cho Bé",139000,139000,0,0
TIKI,do-choi-me-be,108362580,"Nước xông ngâm rửa phụ phu GSPA - Dứt điểm viêm phụ khoa dai dẳng, giảm đau, nhanh hết sản dịch, tăng co cơ tử cung, rẻ hóa và làm hồng vùng kín",165000,165000,0,0
TIKI,do-choi-me-be,479464,"Đồ Chơi Gỗ Winwintoys - Đàn Mộc Cầm 7 Thanh 63062",109000,109000,0,0
TIKI,do-choi-me-be,54008643,"Trống Lục Lạc Baby Rock Star- Màu ngẫu nhiên",74000,148000,74000,50
TIKI,do-choi-me-be,115245999,"Set 2 núm ti cho bình PUR Advanced (size L) (1813)",85500,85500,0,0
TIKI,do-choi-me-be,94761783,"SỮA BỘT OPTIMUM GOLD 3 850G (CHO TRẺ TỪ 1 - 2 TUỔI)",385000,385000,0,0
TIKI,do-choi-me-be,273042837,"[MUA 3 TẶNG 1] Combo 3 bịch khăn ướt 100 Sunbaby SBB2020",31000,31000,0,0
TIKI,do-choi-me-be,21724541,"SPECIAL KID FER & VITAMINES - Siro Bổ sung sắt và các vitamin C, B2, B9, B12 - Giúp giảm thiếu máu do thiếu sắt - Nhập khẩu Pháp (125ml)",234000,360000,126000,35
TIKI,do-choi-me-be,15356110,"Thùng 48 Hộp Sữa Bột Pha Sẵn Vinamilk Optimum Gold 180ml",590000,590000,0,0
TIKI,do-choi-me-be,110695767,"Combo 2 Tã quần Bobby có đệm lưng thấm mồ hôi đủ size",909000,1213000,304000,25
TIKI,do-choi-me-be,151745411,"Ghế ngồi ăn dặm điều chỉnh độ cao, điều chỉnh ngả lưng có bánh xe Mastela 1015 cho bé 6 tháng đến 5 tuổi chuẩn ASTM Mỹ",1890000,1890000,0,0
TIKI,do-choi-me-be,57930183,"Hộp 8 bộ đồ chơi lắp ráp Trực thăng tấn công 8in1 Qman 1801 (381 chi tiết)",179000,269000,90000,33
TIKI,do-choi-me-be,176937761,"Bộ 2 bình trữ sữa Medela 250ml",450000,450000,0,0
TIKI,do-choi-me-be,8347252,"Bột Ăn Dặm Vinamilk Ridielac Gold Vị Heo Bó Xôi (200g)",62000,62000,0,0
TIKI,do-choi-me-be,110696798,"Bình tập uống nhiều màu Philips Avent dung tích 200ml",265000,265000,0,0
TIKI,do-choi-me-be,53142980,"Khăn giấy khô Fudo® TISSUEPack™ từ tre không bụi vụn, không tẩy trắng - 2 Túi lớn - 08 gói/130 tờ - 03 lớp siêu thấm",160000,160000,0,0
TIKI,do-choi-me-be,181462617,"Cốc tập uống 3 giai đoạn AQ Richell Nhật Bản | Baby",283745,283745,0,0
TIKI,do-choi-me-be,154532842,"Hộp quà tặng cao cấp Súp uống vi chất Fomeal Care Gold Yến Sào Thiên Nhiên hấp thu nhẹ bụng, bổ sung HMB - bồi bổ sức khỏe",280000,280000,0,0
TIKI,do-choi-me-be,81587571,"ta quan yubest gold size xl 46 mieng",250000,250000,0,0
TIKI,do-choi-me-be,80403862,"Combo Tiết Kiệm 3 Gói Khăn Ướt Bobby Care Không Hương 100 Tờ/Gói - Tặng 1 Gói Cùng Loại",123000,123000,0,0
TIKI,do-choi-me-be,112169671,"Thùng sữa nước Nutricare Hanie Kid cho trẻ biếng ăn suy dinh dưỡng (110ml)",395000,395000,0,0
TIKI,do-choi-me-be,110262359,"Sữa bột tốt cho bé Care 100 GOLD dành cho trẻ thấp còi, biếng ăn",387151,387151,0,0
TIKI,do-choi-me-be,94587831,"Combo 2 hộp lá xông giúp khử mùi, giải cảm, lưu thông khí huyết Wonmom",92000,104000,12000,12
TIKI,do-choi-me-be,55349100,"Mô Hình Nhà Búp Bê Cỡ Lớn Cho Các Bé Chơi Đồ Chơi Barbie",289000,400000,111000,28
TIKI,do-choi-me-be,77032355,"Bài Poker Texas Hold'em Hold em Siêu bền siêu đàn hồi",90000,90000,0,0
TIKI,do-choi-me-be,435746,"Sữa Bột Abbott Grow 2 cho trẻ 6 - 12 tháng tuổi (900g)",329000,329000,0,0
TIKI,do-choi-me-be,183375257,"Bộ Đồ Chơi Khoa Học Tự Làm Máy Bay Vận Tải, Bộ Đồ Chơi Lắp Ghép STEM Máy Bay Vận Tải F-12, Bộ Đồ Chơi Gỗ Cao Cấp Khoa Học Tự Làm DIY Wood Steam-Chính Hãng BABYBOSS + Tặng Kèm Tranh Ghép Gỗ.",55000,65000,10000,15
TIKI,do-choi-me-be,197656014,"Bình sữa Pigeon PPSU Plus thế hệ III phiên bản Nhật hình Gấu 160ml/240ml",361000,451000,90000,20
TIKI,do-choi-me-be,51928840,"Sữa tắm gội toàn thân cho bé Sebamed pH5.5 - SBB08",191000,239000,48000,20
TIKI,do-choi-me-be,48477021,"Combo Bộ Bài Tarot Bói Smith Waite Tarot Cao Cấp và Túi Nhung Đựng Tarot và Khăn Trải Bàn Tarot",180000,180000,0,0
TIKI,do-choi-me-be,197656233,"Bình sữa Pigeon PPSU Plus thế hệ III phiên bản Nhật hình Cây 160ml/240ml",361000,451000,90000,20
TIKI,do-choi-me-be,108916688,"Tã Dán Người Lớn Caryn Siêu Thấm Size Xl - 10 Miếng/ 20 Miếng Dành Cho Người Hạn Chế Khả Năng Đi Lại",130000,130000,0,0
TIKI,do-choi-me-be,104134007,"Bình uống nước và nước trái cây Pigeon 50ml",93000,103000,10000,10
TIKI,do-choi-me-be,196357382,"Balo Cho Bé Mẫu Giáo Siêu Nhẹ Chống Lạc Cho Trẻ Em",179000,179000,0,0
TIKI,do-choi-me-be,435749,"Sữa Bột Abbott Grow 1 900g",345000,345000,0,0
TIKI,do-choi-me-be,4655703,"Dầu Tràm Cung Đình - Diamond (50ml)",250000,250000,0,0
TIKI,do-choi-me-be,820411,"Sữa Dưỡng Thể Toàn Thân Cetaphil Baby (400ml)",243000,270000,27000,10
TIKI,do-choi-me-be,45184509,"Khăn vải khô đa năng cho bé Oma Baby ( 1 Hộp/ 80 Miếng) - Oma & Baby Premium Baby Dry Multi-Functional Cloths ( 80 cloths per box)",88500,88500,0,0
TIKI,do-choi-me-be,174605509,"TÃ DÁN CARYN NGƯỜI GIÀ SIZE L40 MIẾNG",398000,398000,0,0
TIKI,do-choi-me-be,173768518,"Xe địa hình điều khiển từ xa KAVY 3699-L6 có 3 đèn LED tỷ lệ 1:20 dẫn động 2 bánh tốc độ cao nhiều màu sắc",225000,225000,0,0
TIKI,do-choi-me-be,118962950,"Cờ tỷ phú Monopoly Ultimate Banking , Monopoly Here & Now The World Edition",450000,450000,0,0
TIKI,do-choi-me-be,412767,"Tã Quần Cao Cấp Moony Nhật Bản Bé Gái L44 (44 Miếng)",270000,466400,196400,42
TIKI,do-choi-me-be,117434350,"Khăn Khô Đa Năng Yuniku 270 Tờ",44500,57000,12500,22
TIKI,do-choi-me-be,2627115,"Đồ gặm nướu silicon cho bé Sensory Marcus & Marcus, từ 6 tháng",188000,188000,0,0
TIKI,do-choi-me-be,107018282,"Điện Thoại Khúc Khích",74000,130000,56000,43
TIKI,do-choi-me-be,76067268,"Xe đồ chơi đầu kéo vận chuyển gỗ KAVY, nhựa ABS an toàn, kích thước lớn",182000,182000,0,0
TIKI,do-choi-me-be,76283100,"Tuyển tập xe đồ chơi mô hình ô tô kim loại KAVY chạy cót có led phát sáng, nhiều loại mẫu  (màu ngẫu nhiên)",78000,78000,0,0
TIKI,do-choi-me-be,187618596,"Đồ chơi trẻ em: Xe vệ sinh môi trường điều khiển từ xa DK81091. Màu ngẫu nhiên",186000,300000,114000,38
TIKI,do-choi-me-be,72957942,"Đồ Chơi LEAPFROG Laptop Màu Xanh 80-19150",869000,869000,0,0
TIKI,do-choi-me-be,114080423,"Đồ chơi mô hình xe cảnh sát KAVY NO.8808 có nhạc và đèn chạy đà nhiều màu sắc",42000,42000,0,0
TIKI,do-choi-me-be,187610227,"Đồ chơi trẻ em: Máy xúc lật điều khiển từ xa  DK81094, Màu ngẫu nhiên",224000,320000,96000,30
TIKI,do-choi-me-be,71344672,"Bộ 2 tấm tranh xếp hình 48 mảnh: Baby bus và Heo Pepa. Sản xuất tại Việt Nam.",69000,69000,0,0
TIKI,do-choi-me-be,108091465,"Thảm Chơi cho bé Umoo xốp XPE, Dày, Cuộn Tròn, Không Mùi, Không Thấm Nước",624000,780000,156000,20
TIKI,do-choi-me-be,65191151,"Đồ chơi phát triển kỹ năng cho bé DIY MODEL, lắp ghép mô hình 12 phương tiện giao thông 282 chi tiết Toyshouse TLH-17",439000,439000,0,0
TIKI,do-choi-me-be,129584815,"Thảm xốp ghép EVA trải sàn cho bé chất lượng Châu Âu EN71 - Toys House",479000,479000,0,0
TIKI,do-choi-me-be,273156032,"Men vi sinh hỗ trợ tiêu hóa Ildong Hàn ngừa rối loạn tiêu hóa, tăng hấp thụ dinh dưỡng và bổ sung vitamin, khoáng chất từ sữa non - QuaTangMe Extaste",265000,265000,0,0
TIKI,do-choi-me-be,80358747,"Đồ Chơi Nhập Vai Bác Sĩ Cho Bé Từ 3 Tuổi Bowa",185000,239000,54000,23
TIKI,do-choi-me-be,142339285,"Hộp 50 túi trữ sữa Sunmum Thái Lan 250ml",240000,240000,0,0
TIKI,do-choi-me-be,43863262,"Sữa Bột Hoàng Gia Úc Royal Ausnz Kids Fomula Bổ Sung Dưỡng Chất Cho Trẻ Từ 3 Tuổi Trở Lên 900G",640000,640000,0,0
TIKI,do-choi-me-be,2563665,"Bột Ăn Dặm Vinamilk Ridielac Gạo Sữa (200g)",52000,52000,0,0
TIKI,do-choi-me-be,167427142,"Xe đồ chơi chạy đà hình con vật KAVY No.8808 gồm 2 xe vui nhộn, chứa đựng lẫn nhau",58000,58000,0,0
TIKI,do-choi-me-be,74769720,"Kutieskin 30gr giành cho da bé bị chàm sữa",245000,245000,0,0
TIKI,do-choi-me-be,247889024,"Đất Nặn Làm Bếp Làm Kem Mì Cùng Bé Khuôn Và Máy Thủ Công Deli - Đồ Chơi Giáo Dục Nhập Vai Thông Minh Cho Bé - 67801 67802 67805 YC",116500,214200,97700,46
TIKI,do-choi-me-be,213974796,"Ensure Đức cho người lớn tuổi Ensure Vanille Geschmask - Giúp hồi phục sức khỏe cho người gầy yếu, người suy dinh dưỡng - QuaTangMe Extaste",529000,1058000,529000,50
TIKI,do-choi-me-be,57781462,"COMBO 10 GIẤY VỆ SINH CUỘN LỚN DALIN 700G TIẾT KIỆM",560000,560000,0,0
TIKI,do-choi-me-be,200039253,"Xe Đạp Trẻ Em Nhựa Chợ Lớn 12 inch K106 Dành Cho Bé Từ 2 - 3 tuổi - M1820-X2B",756000,756000,0,0
TIKI,do-choi-me-be,63516988,"Nôi em bé cao cấp Prota (không có máy đưa nôi)",725000,725000,0,0
TIKI,do-choi-me-be,91656731,"Đồ chơi mô hình xe đầu kéo xe xúc và xe xúc đất KAVY NO.8807 gồm 2 xe ( đầu kéo chạy đà, nhựa ABS an toàn bền đẹp)",185000,185000,0,0
TIKI,do-choi-me-be,109262751,"Hũ Đất Nặn Sáng Tạo Cho Bé Deli - Chất Liệu An Toàn Màu Sắc Tươi Sáng Đa Dạng - 67803 / 67804",84200,160200,76000,47
TIKI,do-choi-me-be,48331524,"FITOBIMBI IMMUNO – SIRO THẢO DƯỢC CHUẨN HÓA CHÂU ÂU TĂNG CƯỜNG MIỄN DỊCH TOÀN CHO TRẺ (200ML)",358000,358000,0,0
TIKI,do-choi-me-be,80981497,"Bộ bài tây mạ vàng cao cấp, chống nước - Bài lá bằng nhựa PVC - Hàng chính hãng",36000,39000,3000,8
TIKI,do-choi-me-be,84709888,"Gạc Rơ Lưỡi, Vệ Sinh Răng Miệng Cho Bé Dr Papie (Tách lẻ 10 gói)",38500,38500,0,0
TIKI,do-choi-me-be,68936268,"Cháo Tươi Ếch Đậu Hà Lan Cây Thị",21000,25000,4000,16
TIKI,do-choi-me-be,41343230,"Vitamin tổng hợp Wellbaby cho bé từ 6 tháng đến 4 tuổi 150ml",268000,335000,67000,20
TIKI,do-choi-me-be,124171072,"Tã/bỉm dán Molfix Thiên nhiên Jumbo M (6kg - 11kg) - Gói 46+6 miếng",185000,225000,40000,18
TIKI,do-choi-me-be,55572761,"Con Quay Hand Fidget Spinner 3 Cánh Nhôm Cao Cấp",119000,119000,0,0
TIKI,do-choi-me-be,113245073,"Canxi cho bé Healthy Care Kids Milk Calcium Úc, Hỗ trợ tăng trưởng chiều cao, hệ thống xương, răng, bé ngủ ngon không trằn trọc đêm - OZ Slim Store",227000,526000,299000,57
TIKI,do-choi-me-be,180236417,"Cháo Tươi Cá Chẽm Khoai Môn Cây Thị Mở Gói Ăn Ngay 240G",23760,28000,4240,15
TIKI,do-choi-me-be,11253546,"Túi Đá Khô Diệt Khuẩn Unimom UM871857 (12 x 18 cm)",30000,30000,0,0
TIKI,do-choi-me-be,52178168,"Gối cho bé bú kê tay Rototo Bebe - Gối bú sữa giúp bố, mẹ đỡ mỏi tay",520000,520000,0,0
TIKI,do-choi-me-be,194445768,"Dụng cụ lấy ráy tai nhiều đầu sử dụng cổng sạc USB Có Đèn Cho Bé Cao Cấp ",87220,89000,1780,2
TIKI,do-choi-me-be,54084852,"Combo 4 Đồ Chơi Lúc Lắc Cho Trẻ Happy Baby",112500,150000,37500,25
TIKI,do-choi-me-be,755476,"Cờ Tỷ Phú Hộp Giấy Lớn 5 Trong 1 Liên Hiệp Thành KTP5T1",107000,107000,0,0
TIKI,do-choi-me-be,77035294,"Bộ 500 Chip Poker Không Số ( Phỉnh Poker ) Hàng Cao Cấp",1080000,1080000,0,0
TIKI,do-choi-me-be,26141592,"Khăn vải khô đa năng StayDry (550 gram)",59500,77000,17500,23
TIKI,do-choi-me-be,138076850,"[COMBO] Ngũ Cốc Dinh Dưỡng Bầu 29 hạt _ Lợi Sữa Cao Cấp Min Min _ Ngũ Cốc Lợi Sữa Min Min 29 Hạt và 30 Hạt",195000,195000,0,0
TIKI,do-choi-me-be,52588252,"Combo 2 lon Sữa Morinaga số 3 Hương vani (Kodomil) 850g",998000,1102000,104000,9
TIKI,do-choi-me-be,152517831,"Đồ chơi: Ghép hình lực lượng cảnh sát - Trực thăng tuần tra DK81062",75600,108000,32400,30
TIKI,do-choi-me-be,77736112,"Khăn sữa sợi tre Organic",99000,99000,0,0
TIKI,do-choi-me-be,152475770,"Ghép hình lực lượng cảnh sát - xe cứu hộ 146 chi tiết DK81064",67000,108000,41000,38
TIKI,do-choi-me-be,71099268,"Cờ Domino A1",51000,51000,0,0
TIKI,do-choi-me-be,13408700,"Mô Hình Xe Harley Davidson 2015 Street Glide Special Black 1:12 Maisto MH-32328",369000,369000,0,0
TIKI,do-choi-me-be,114841571,"Combo 3 Lọ Nước Tắm Thảo Dược Dr.Papie Cho Bé Giúp Ngăn Ngừa Và Giảm Các Vấn Đề Về Da",344000,344000,0,0
TIKI,do-choi-me-be,51599206,"Gối Ôm Chữ U Đa Năng cho Bà Bầu - Gối Ngủ cho Mẹ Bầu chính hãng Zcare - chứng nhận Độc Quyền bởi bộ Khoa học công nghệ; Gối bà bầu có hình chữ U nâng đỡ 6 điểm, giúp bà bầu thoải mái khi ngủ; Gối chuyên dụng cho bà bầu nên các nguyên vật liệu an toàn và c",619000,619000,0,0
TIKI,do-choi-me-be,74815615,"Đồ chơi mô hình xe thang cứu hỏa thang nâng KAVY NO.8827 chất liệu hợp kim và nhựa nguyên sinh an toàn, chi tiết sắc sảo",89000,89000,0,0
TIKI,do-choi-me-be,161020504,"(Loại Chuẩn) Đai Địu 04 Tư Thế KhoNCC Hàng Chính Hãng - Tiện Lợi Cho Bé Sơ Sinh Đến 30 Tháng Tuổi - Đỡ Mỏi - Bảo Vệ Đầu Cổ - KPD-DAI4-545 (Nhiều màu)",129000,158000,29000,18
TIKI,do-choi-me-be,751831,"Trà vằng túi lọc lợi sữa, nhanh lấy lại vóc dáng sau sinh Wonmom 40gr ( 20 Túi/Hộp )",89100,99000,9900,10
TIKI,do-choi-me-be,158409197,"Xếp Hình Gỗ Khám Phá cho bé 2+ - 3+ Mideer & TOI",289000,289000,0,0
TIKI,do-choi-me-be,58964368,"Combo 5 Bịch Tấm Lót Xu Sơ Sinh Aiko (Bịch 30 Miếng)",115000,115000,0,0
TIKI,do-choi-me-be,184846327,"Bộ Đồ Chơi Xúc Cát Đi Biển Cao Cấp Cho Bé - KUB",195000,195000,0,0
TIKI,do-choi-me-be,58719908,"Bộ 4 sách vải song ngữ ANH - VIỆT kích thích thị giác cho bé sơ sinh dưới 1 tuổi (PiPô Việt Nam)",80000,80000,0,0
TIKI,do-choi-me-be,415150,"Dầu Tràm Cung Đình 30 ml",71250,75000,3750,5
TIKI,do-choi-me-be,84575971,"Vòng dâu tằm 7 và 9 bi bạc cho bé",79000,79000,0,0
TIKI,do-choi-me-be,153547703,"Ghế Ăn Dặm, Ghế Ngồi Ăn Em Bé Nâng Hạ Độ Cao Có Đế Chắc Chắn Mastela 07110 - Màu",745000,745000,0,0
TIKI,do-choi-me-be,188012845,"TÃ DÁN HUGGIES SIZE XXL56 MIẾNG",305000,305000,0,0
TIKI,do-choi-me-be,43237770,"Bình sữa cổ rộng McGOLDSON Premium 180ml",206000,206000,0,0
TIKI,do-choi-me-be,181259363,"Sữa Colos Opti 1+ lon 800g - Tiêu hoá tốt, Hô hấp khoẻ, Dành cho bé từ 1 tuổi trở lên của VitaDairy",358000,358000,0,0
TIKI,do-choi-me-be,57653558,"[Combo 10 gói] Tấm lót phân xu họa tiết vui nhộn sơ sinh cho bé Mama (30 tờ/túi x 10 )",219000,219000,0,0
TIKI,do-choi-me-be,90143580,"Kem Bôi Da Chống Hăm Ngăn Ngừa Rôm Sảy Cho Bé Oribebe Giúp Dưỡng Ẩm Và Làm Mịn Da Bé - An Toàn Cho Da Nhạy Cảm",98000,109000,11000,10
TIKI,do-choi-me-be,4775257,"Sữa Nutricare Care 100 Gold cho trẻ biếng ăn suy dinh dưỡng 1-10 tuổi (900g)",330000,330000,0,0
TIKI,do-choi-me-be,12478875,"Gel Làm Sạch Tóc Và Toàn Thân Dịu Nhẹ Cho Bé A-Derma Primalba Cleansing (500ml)",339000,523000,184000,35
TIKI,do-choi-me-be,54392195,"ĐAI NỊT BỤNG ĐỊNH HÌNH GIẢM MỠ M+ MỚI NHẤT",73000,73000,0,0
TIKI,do-choi-me-be,88769864,"Bộ cờ vua nam chân loại 25*25*2cm - HENRYSA",125000,200000,75000,38
TIKI,do-choi-me-be,100586366,"Tã Quần Siêu Mỏng UniDry Ultrathin Gói Cực Đại Size M74 (74 miếng)",269000,389000,120000,31
TIKI,do-choi-me-be,178078865,"Đồ Chơi LEGO Siêu Xe Mercedes-Amg F1 W12 E Performance &amp; Mercedes-Amg Pro 76909 (564 chi tiết)",1120781,1296000,175219,14
TIKI,do-choi-me-be,132201095,"Rubik 2x2 Mã  DK81082",47600,68000,20400,30
TIKI,do-choi-me-be,143117551,"Bộ Đồ Chơi Lắp Ghép STEAM Robot Kéo Xe, Đồ Chơi Gỗ Cao Cấp Robot Kéo Xe, Đồ Chơi Khoa Học Tự Làm DIY Wood Steam-Chính Hãng BABYBOSS + Tặng Kèm Tranh Ghép Gỗ",60000,90000,30000,33
TIKI,do-choi-me-be,4199237,"Bộ 2 Núm Ti Silicone S1 Nuk NU66057 (Size L)",144530,149000,4470,3
TIKI,do-choi-me-be,70520391,"Bộ Chăm Sóc Love Mom, Khử Mùi Vùng Kín Và Dưỡng Trắng Da Body Wonmom (1 Hộp Thảo Mộc Xông Vùng Kín + 1 Cốt Nghệ Hạ Thổ)",344000,344000,0,0
TIKI,do-choi-me-be,104155209,"Bình uống nước tay cầm có ống hút Pigeon 330ml (HSD 07/2024)",190000,316000,126000,40
TIKI,do-choi-me-be,79671794,"Túi Nước Giặt Lix Siêu Sạch Hương Hoa Anh Đào 2.4Kg N2502 - Tẩy Sạch Vết Bẩn Cực Mạnh",79000,79000,0,0
TIKI,do-choi-me-be,156212009,"Combo nước rửa bình Arau Baby bình và túi thay thế",285360,328000,42640,13
TIKI,do-choi-me-be,188175360,"Khăn Tắm Xô Unmei  100% Cotton 4 Lớp Kích Thước 75x80 - Giao Viền Ngẫu Nhiên",49000,49000,0,0
TIKI,do-choi-me-be,40752351,"Combo 5 bịch khăn vải khô đa năng Mama (bịch 240 tờ)",249000,249000,0,0
TIKI,do-choi-me-be,75977831,"Đồ chơi lật đật phát âm thanh hình gà con xinh xắn biết chớp mắt và có nhạc nhẹ nhàng cho bé yêu, chọn màu theo ý-Đồ chơi giải trí - Đồ chơi ngộ nghĩnh cho bé từ 3 tháng tuổi trở lên",75000,75000,0,0
TIKI,do-choi-me-be,76047617,"Ly uống nước có nắp đậy cho bé STENLOCK (Chính hãng Hàn Quốc)",155000,167000,12000,7
TIKI,do-choi-me-be,12080528,"Đồ Chơi Dinosauria Mô Hình Khủng Long Bay Lượn Thời Tiền Sử New4all 8018",139000,189000,50000,26
TIKI,do-choi-me-be,128664638,"Đồ Chơi Gỗ,Board Game Chiến Thuật, Bàn Chơi Caro Bằng Gỗ Có Thang Chia Tỷ Số 64 Quân Kích Thước 25x22Cm",139000,174000,35000,20
TIKI,do-choi-me-be,176937785,"Chổi cọ bình và núm ty Medela - 2 đầu cọ bình và núm ty riêng biệt, có đế dựng thẳng",195000,195000,0,0
TIKI,do-choi-me-be,202606089,"Xe Lắc Nhựa Chợ Lớn hình Chú Ong Con (Có nhạc) - M1786B-X3B",486000,486000,0,0
TIKI,do-choi-me-be,53300530,"	 02 Bộ  Flashcard thẻ trắng học từ vựng các nước Anh Nhật Hàn Trung Đức Pháp. Giao bìa màu ngẫu nhiên",30000,30000,0,0
TIKI,do-choi-me-be,19802553,"Dầu gội & xả trẻ em Milmil Kids hương Vani 500ml tặng kèm móc khóa",109000,109000,0,0
TIKI,do-choi-me-be,120294395," Tẩy Đa Năng General Purpose Adhesive Cleaner 3M 08987",149000,149000,0,0
TIKI,do-choi-me-be,16317565,"Nước giặt hữu cơ K-Mom Hàn Quốc dạng túi (1300ml)",173630,179000,5370,3
TIKI,do-choi-me-be,1347579,"Phấn Gạo Chống Hăm, Rôm, Sảy, Da Khô Hương Hoa Cỏ ReisCare Floral Sweet (50g)",58410,64900,6490,10
TIKI,do-choi-me-be,51509874,"Bộ cờ vua cao cấp hộp lớn 42x42cm đồ chơi trí tuệ giải trí",135000,135000,0,0
TIKI,do-choi-me-be,33934889,"Sữa tắm cho bé chiết xuất thảo dược Yaocare baby 250ml - DK Pharma",185000,185000,0,0
TIKI,do-choi-me-be,541795,"Mũ Bảo Vệ Đầu Cho Bé Mumguard Hình Bọ Cánh Cam - Xanh",204250,215000,10750,5
TIKI,do-choi-me-be,42688572,"Máy hút sữa điện đôi Biohealth IE - Sử dụng pin sạc, có chế độ massage và 3 chế độ hút",1179000,1370000,191000,14
TIKI,do-choi-me-be,131174711,"Đồ chơi tự lắp ráp khủng long - Khủng long ba sừng DK81088",77000,110000,33000,30
TIKI,do-choi-me-be,49884586,"Sữa Morinaga Số 1 - Hagukumi (320g)",222000,222000,0,0
TIKI,do-choi-me-be,113919089,"Bình sữa cổ thường Pur Advanced 250ml (1802)",110700,110700,0,0
TIKI,do-choi-me-be,152465544,"GHÉP HÌNH 4 MÙA - MÙA ĐÔNG 24 CHI TIẾT DK81077",95200,136000,40800,30
TIKI,do-choi-me-be,53756902,"Sữa bột Nutricare ColosCare 0+ - sữa non tăng cường miễn dịch (800g)",405000,405000,0,0
TIKI,do-choi-me-be,76776189,"Xe ô tô tải Hali đồ chơi Polesie 3294 - Hàng chính hãng nhập khẩu châu âu",179100,199000,19900,10
TIKI,do-choi-me-be,48012718,"Bộ Đồ Chơi Bác Sĩ - Màu Xanh Có Đèn Và Âm Thanh Giả Lập DUKA - 660-67",170500,275000,104500,38
TIKI,do-choi-me-be,197409762,"Tấm lót chống thấm thay tã cho bé 4 lớp cao cấp Bonny thấm hút nhanh, kháng khuẩn, thoáng khí (KT50x70Cm)",116000,120000,4000,3
TIKI,do-choi-me-be,183913622,"(chính hãng) 01 van chân không / van lưỡi gà máy hút sữa fatzbaby Resonance 3",25000,25000,0,0
TIKI,do-choi-me-be,479467,"Cân Bập Bênh Winwintoys 61072",88000,88000,0,0
TIKI,do-choi-me-be,181462670,"Bàn chải đánh răng trẻ em TLI Richell Nhật Bản | Baby",126655,126655,0,0
TIKI,do-choi-me-be,107016385,"Đồ Chơi Cắt Rau Quả - Susu",90000,120000,30000,25
TIKI,do-choi-me-be,76199379,"Xe Đạp Trẻ Em Nhựa Chợ Lớn K85 - K86 - K87 - K89 - K90",981000,981000,0,0
TIKI,do-choi-me-be,41300533,"Đồ chơi mô hình Pokemon vui nhộn (24 chi tiết)",59000,79000,20000,25
TIKI,do-choi-me-be,183727568,"Tranh xếp Hình Tia Sáng Trang viên Ánh Sáng(925 mảnh ghép)",103600,129500,25900,20
TIKI,do-choi-me-be,108957913,"Combo 5 Gói Khăn Vải Khô Đa Năng AIKO - Gói 300g",175000,175000,0,0
TIKI,do-choi-me-be,29362805,"Combo 6 Quần bỏ bĩm Goodmama - 6 lớp cho bé từ 5-18kg",212000,212000,0,0
TIKI,do-choi-me-be,8078786,"Tranh xếp Hình Tia Sáng Đất Nước Hà Lan (2035 Mảnh Ghép)",197600,247000,49400,20
TIKI,do-choi-me-be,86406635,"Đồ chơi giáo dục sớm thả hình khối có quai xách cho bé Toyshouse 0702-TH-HE0218. - BPA free",129000,129000,0,0
TIKI,do-choi-me-be,188835548,"Sữa bột Gluvita Gold – Dinh dưỡng dành cho người bệnh ĐÁI THÁO ĐƯỜNG 900G",539000,539000,0,0
TIKI,do-choi-me-be,13943439,"Mũ gội đầu hà mã - Royalcare 
(Màu",109000,109000,0,0
TIKI,do-choi-me-be,177054925,"Đồ bơi bé gái liền thân PONY cầu vồng",259000,259000,0,0
TIKI,do-choi-me-be,805618,"Cháo Ăn Dặm  Mabu Nguyên Hạt (900g)",199000,199000,0,0
TIKI,do-choi-me-be,55498362,"Combo 10 Quần bỏ bỉm vải cotton 6 lớp siêu thấm, thoáng mát hiệu Goodmama cho Bé Gái từ 5-17 kg",370000,370000,0,0
TIKI,do-choi-me-be,40443862,"Nước Giặt Xả Quần Áo Em Bé Docilee 2IN1 Xanh 3000ml ",221160,228000,6840,3
TIKI,do-choi-me-be,73228364,"Khăn khô khử khuẩn McGOLDSON-St.Bro 310g",49000,49000,0,0
TIKI,do-choi-me-be,65028610,"Combo 10 Gói Khăn Ướt Max Cool 25 Tờ Hương Trà Xanh ( 25 Tờ x 10 )",137000,137000,0,0
TIKI,do-choi-me-be,73591697,"Bột ăn dặm Nutricare Metacare Tôm phô mai củ dền olive (200g)",65000,70000,5000,7
TIKI,do-choi-me-be,755385,"Bàn 3T1 Nhỏ Liên Hiệp Thành B31NVCCN (Vây - Caro - Cá Ngựa) ",100000,100000,0,0
TIKI,do-choi-me-be,51597263,"Gối Ôm Chữ U Đa Năng cho Bà Bầu - Gối Ngủ cho Mẹ Bầu chính hãng Zcare - chứng nhận Độc Quyền bởi bộ Khoa học công nghệ; Gối bà bầu có hình chữ U nâng đỡ 6 điểm, giúp bà bầu thoải mái khi ngủ; Gối chuyên dụng cho bà bầu nên các nguyên vật liệu an toàn và c",619000,619000,0,0
TIKI,do-choi-me-be,138907432,"Combo 2 hộp sữa bột Hi-CANXI của hãng GIGO giành cho người trưởng thành ngăn ngừa loãng xương, tiểu đường-> tặng khăn mềm mịn",470000,760000,290000,38
TIKI,do-choi-me-be,193741716,"Cờ tướng nam châm bỏ túi cao cấp - Cờ tướng nam châm hộp da có bàn là hộp đựng - Hàng chính hãng  D Danido",57000,80000,23000,29
TIKI,do-choi-me-be,54014704,"Đồ Chơi Baby Rock Star Happy Baby - Organ Điện Tử",77000,110000,33000,30
TIKI,do-choi-me-be,96924122,"BỊCH KHĂN VẢI KHÔ ĐA NĂNG 500GR - AIKO (HÀNG VIỆT NAM CHẤT LƯỢNG CAO)",60000,60000,0,0
TIKI,do-choi-me-be,40279365,"Nước Rửa Bình Sữa D-Nee - Chai 500ml",66000,66000,0,0
TIKI,do-choi-me-be,188189577,"Khăn Xô Tắm Xô 2 Lớp In Hình Unmei Kích Thước 80x85cm, Dùng Để Lau Mình, Quấn Cho Bé",55000,55000,0,0
TIKI,do-choi-me-be,183930455,"Đồ Chơi Lắp Ráp Mô Hình Nhân Vật Thanh Gươm Diệt Quỷ - LinkGo 68291 - Tsuyuri Kanao (253 Mảnh Ghép)",76200,93000,16800,18
TIKI,do-choi-me-be,180855518,"Bàn chải đánh răng điện trẻ em Philips Sonicare HX6352/43 hỗ trợ Bluetooth kết nối với ứng dụng và giúp trẻ từ từ tăng thời gian đánh răng - HÀNG NHẬP KHẨU",1817000,1817000,0,0
TIKI,do-choi-me-be,45841290,"Bộ 4 thìa ăn dặm báo nóng Munchkin Mỹ tặng 5 túi zipper",183330,189000,5670,3
TIKI,do-choi-me-be,53872113,"Ngũ Cốc Mẹ Bầu Pregnlife Long Liên Cao Cấp Siêu Dinh Dưỡng Gồm 14 Loại Hạt - Tặng Kèm Muỗng Gỗ ",240000,320000,80000,25
TIKI,do-choi-me-be,15587886,"Bột ăn dặm dinh dưỡng Metacare 8 loại hỗ trợ phát triển toàn diện (200g)",56000,61000,5000,8
TIKI,do-choi-me-be,107018280,"Trống Bi Bô - Nốt Nhạc Xanh",90000,120000,30000,25
TIKI,do-choi-me-be,54084855,"Combo 3 Đồ Chơi Lúc Lắc Cho Trẻ Happy Baby  - Giao màu ngẫu nhiên",84000,120000,36000,30
TIKI,do-choi-me-be,55890312,"Kem đánh răng Colgate Kid Free From 6-9 80g",43000,43000,0,0
TIKI,do-choi-me-be,434450,"Combo 3 Chai Dầu Tràm Cung Đình (15ml)",113050,119000,5950,5
TIKI,do-choi-me-be,195695590,"Bộ Đồ Chơi Lắp Ghép STEM Mô Hình Chim Gõ Kiến, Bộ Đồ Chơi Khoa Học Tự Làm Chim Gõ Kiến, Bộ Đồ Chơi Gỗ Cao Cấp Khoa Học Tự Làm DIY Wood Steam - Chính Hãng BABYBOSS.",55000,75000,20000,27
TIKI,do-choi-me-be,7591655,"Đồ Chơi Gỗ Chàng Trai Gỗ - Máy Bay BABY 94006",105000,105000,0,0
TIKI,do-choi-me-be,107018284,"Trống Bi Bô - Bé Nói Cười",90000,120000,30000,25
TIKI,do-choi-me-be,13312863,"BÌNH SỮA Y TẾ CỔ THƯỜNG 250 ML DR.BROWN'S",374420,386000,11580,3
TIKI,do-choi-me-be,248544526,"Lốc 6 lọ nước yến sào Nunest Kid 4 hương vị (70ml)",209250,209250,0,0
TIKI,do-choi-me-be,125393651,"Đồ chơi nhà tắm cho bé-set 4 món hình con cá, quả bóng, sinh vật biển vô cùng dễ thương Toys House, hàng chính hãng",45000,45000,0,0
TIKI,do-choi-me-be,152534382,"Ghép Hình 4 Mùa - Mùa Thu 24 Chi Tiết DK81076",95200,136000,40800,30
TIKI,do-choi-me-be,140628018,"Sữa Tắm Gội Cho Bé Công Nghệ Anh Quốc Tami Natural 2 Trong 1 An Toàn Dịu Nhẹ 350ml",99000,123200,24200,20
TIKI,do-choi-me-be,54008653,"Mộc Cầm Baby Rock Star",63000,126000,63000,50
TIKI,do-choi-me-be,2627105,"Bộ thìa nĩa tập ăn cho bé Palm Grasp Marcus & Marcus, từ 18 tháng",208000,208000,0,0
TIKI,do-choi-me-be,101359079,"Combo 3 Cốc thả bồn cầu tẩy xanh toilet Hàn Quốc Mr Fresh 180g hương ngàn hoa",115000,115000,0,0
TIKI,do-choi-me-be,53577228,"Muối Tắm Bé Độc Mộc 400G - Muối Tắm Bé Sinh Dược  Làm Giảm Rôm Sẩy,  Hăm Tả, Cứt Trâu, Mẩn Ngứa, Mồ Hôi Trộm CHo Bé An Toàn CHo Cả TRẻ Sơ SInh Tặng Kèm 01 Túi Muối NGâm Chân",189000,189000,0,0
TIKI,do-choi-me-be,20282147,"Bộ 3 Áo Lót Bầu Và Cho Con Bú Thông Hơi - Màu Ngẫu Nhiên",135000,135000,0,0
TIKI,do-choi-me-be,24592446,"Quần lót bầu su lưới cạp chéo combo 5 cái",140000,140000,0,0
TIKI,do-choi-me-be,72819395,"Đồ Chơi Ghép Hình - Xe Đua Biến Hình Gồm 248 Chi Tiết - DK81024",130000,210000,80000,38
TIKI,do-choi-me-be,176070603,"Sữa công thức OraCare step 3 lon 900g - Dinh dưỡng cho trẻ biếng ăn từ 1 - 10 tuổi.",440000,440000,0,0
TIKI,do-choi-me-be,180365017,"Balo bỉm sữa ĐA NĂNG có túi đựng đồ giữ nhiệt cho mẹ và em bé sơ sinh MÈO YÊU - MySun",169000,265000,96000,36
TIKI,do-choi-me-be,76121715,"Sữa bột VinamilkOptimum Gold Step 4 Hộp Thiếc 1450g",569000,569000,0,0
TIKI,do-choi-me-be,126022187,"Tã Bỉm Dán/Quần YOULI XANH Đủ Size S108/M96/M88/L84/XL80/XXL72/XXXL68",250000,250000,0,0
TIKI,do-choi-me-be,82847723,"Quần chip đùi cotton mát mẻ cho bé gái 2-12 tuổi mẫu mới đủ họa tiết màu sắc nhã nhặn đáng yêu  – SC023",20000,20000,0,0
TIKI,do-choi-me-be,160299378,"Tã dán/quần Huggies Platinum Nature Made size NB60/S82/M64/L54/XL44/M58/L44/XL38/XXL26",169400,169400,0,0
TIKI,do-choi-me-be,154859341,"[Chính hãng] Địu vải EmBé Sling dành cho bé sơ sinh từ 0-24 tháng, dòng FLEX/ FLEX plus có dây tăng đơ để điều chỉnh size",990000,990000,0,0
TIKI,do-choi-me-be,273495793,"Đồ Chơi Lắp Ráp Khủng Long Qman 42106 Khủng Long Biến Đổi (287 Mảnh Ghép) Dành Cho Bé Trai Trên 6 Tuổi",149000,249000,100000,40
TIKI,do-choi-me-be,19556965,"Baby Vit Drop cung cấp các vitamin cần thiết cho trẻ sơ sinh và trẻ nhỏ",290000,290000,0,0
TIKI,do-choi-me-be,271541948,"Sữa cho trẻ sơ sinh 0-1 tuổi Meiji Nhật Bản giàu dưỡng chất kèm DHA giúp phát triển cân đối chiều cao, cân nặng, trí não - Massel Official",704000,1408000,704000,50
TIKI,do-choi-me-be,157313329,"Bộ Bài Tây Nhựa PVC Nền Đen Cao Cấp Chọn Màu – Bài Tây Đen Poker Chống Nước – Chính Hãng miDoctor",47000,80000,33000,41
TIKI,do-choi-me-be,157482533,"Bộ Đồ Chơi Nấu Ăn 36 Món Cỡ Đại Bằng Nhựa An toàn Cho Bé Yêu - Hàng Loại 1 - Chính Hãng MINIIN",219000,219000,0,0
TIKI,do-choi-me-be,43862691,"Sữa Bột Hoàng Gia Úc Royal Ausnz Agedcare Fomula Bổ Sung Dinh Dưỡng Cho Người Trên 40 Tuổi 900G",640000,640000,0,0
TIKI,do-choi-me-be,57963986,"Bộ Đồ Chơi Xếp Hình Thông Minh Nam Châm, Thanh Bi Buckyball Chính Hãng miDoctor",119000,119000,0,0
TIKI,do-choi-me-be,112108799,"Thùng sữa nước pha sẵn Nutricare Care 100 GOLD cho trẻ thấp còi, biếng ăn từ 1 tuổi (110ml)",389000,389000,0,0
TIKI,do-choi-me-be,129453921,"Trà cốm hoa quả Burine (HiPP) dinh dưỡng dành cho bé - Vị Dâu tây giúp hỗ trợ giảm viêm nhiễm, tăng cường đề kháng (Không dành cho trẻ dưới 6 tháng tuổi)",155000,155000,0,0
TIKI,do-choi-me-be,110638857,"Máy Hâm sữa & thức ăn siêu tốc Philips Avent",1195000,1195000,0,0
TIKI,do-choi-me-be,161983629,"Bình  sữa Mô phòng tự nhiên Philips Avent dung tích 260ml cho bé từ 1 tháng tuổi (họa tiết Hippo/Flamingo)",315000,315000,0,0
TIKI,do-choi-me-be,67244209,"Sữa Bột Babys Care Canxi Nano 900 gam (Từ 25  tuổi) – Xương khỏe – Ngăn ngừa Loãng xương – Bổ sung Nano Canxi –  FONTERRA NEW ZEALAND",320000,320000,0,0
TIKI,do-choi-me-be,46630867,"Bình Nước Trẻ Em Camelbak Eddy+ Kids 400ml",350000,350000,0,0
TIKI,do-choi-me-be,63810452,"Tã Dán Bobby Sơ Sinh 72 (72 Miếng Size XS)",195000,195000,0,0
TIKI,do-choi-me-be,272427087,"Sữa tăng chiều cao A2 nguyên kem full cream high in calcium phát triển xương, răng ở trẻ, chống loãng xương ở người lớn, tăng sức khỏe - OZ Slim Store",511000,1022000,511000,50
TIKI,do-choi-me-be,177906498,"Đồ chơi mô hình xe ô tô cảnh sát KAVY - 01 bằng hợp kim chạy cót",59000,59000,0,0
TIKI,do-choi-me-be,168553541,"Tinh dầu tràm Huế 100% nguyên chất loại 1 HỒNG TÂM 100ml xông phòng, đuổi muỗi, giữ ấm cơ thể tặng kèm khẩu trang cho bé",150000,190000,40000,21
TIKI,do-choi-me-be,183101218,"Balo Cho Bé Trai Từ 1 Đến 6 Tuổi Đi Học Người Nhện Chống Thấm Nước - BEE GEE HS1023A",171000,342000,171000,50
TIKI,do-choi-me-be,270716292,"Men vi sinh Ildong Foodis Hàn Quốc hỗ trợ tiêu hóa, hấp thụ dinh dưỡng, ngăn ngừa rối loạn tiêu hóa, Bổ sung vitamin và khoáng chất từ sữa non - OZ Slim Store",265000,265000,0,0
TIKI,do-choi-me-be,76063981,"Đồ chơi mô hình xe cẩu móc KAVY chất liệu nhựa an toàn cho bé, tỷ lệ kích thước lớn, với các khớp xe chuyển động",82000,82000,0,0
TIKI,do-choi-me-be,71192411,"Chậu xông vùng kín sau sinh loại gấp gọn (chọn mầu)",79000,79000,0,0
TIKI,do-choi-me-be,76543375,"Xe Đạp Trẻ Em Nhựa Chợ Lớn K104 - K105 - K106 - K107 - K108 - K109",756000,756000,0,0
TIKI,do-choi-me-be,58243698,"Combo 2 tấm lót chống thấm cho bé Organic Good Cotton Babyup. Size 50x70cm. Miếng lót chống thấm 4 lớp, mềm mại, thoáng khí",275000,275000,0,0
TIKI,do-choi-me-be,169375199,"[Bịch] Tã Bỉm AIKUU BEAR Dán/Quần đủ size S56,M50,L48,XL46,XXL44,XXXL42 Chính Hãng",135000,152000,17000,11
TIKI,do-choi-me-be,270679750,"Omega 3 cho bé Healthy Care Kids Gummy Hỗ trợ phát triển trí tuệ toàn diện, tăng cường thị lực, Giúp bé học tập và ghi nhớ tốt hơn (dạng kẹo)- QuaTangMe Extaste",503000,1006000,503000,50
TIKI,do-choi-me-be,49495083,"Tã/Bỉm quần cao cấp MIJUKU gói 50 miếng - XL",184000,184000,0,0
TIKI,do-choi-me-be,106058243,"Đồ chơi mô hình xe cứu hộ vận chuyển ô tô KAVY No.8809 gồm 2 xe có nhạc và đèn",175000,175000,0,0
TIKI,do-choi-me-be,17705917,"5 Bịch Khăn vải khô đa năng LIKADO 400g (20 x 22cm)",300000,300000,0,0
TIKI,do-choi-me-be,270550657,"Sữa tăng chiều cao cho trẻ biếng ăn từ 1-10 tuổi Úc Pediasure Vanilla giúp phát triển cân đối chiều cao, cân nặng, trí não - QuaTangMe Extaste",1108000,2216000,1108000,50
TIKI,do-choi-me-be,113625694,"Dầu Óc Chó cho bé ăn dặm Maguzt nguyên chất",56800,56800,0,0
TIKI,do-choi-me-be,68168686,"BOBBY TẢ QUẦN XXXL24 (TẶNG 6 MIẾNG CÙNG SIZE)",255000,255000,0,0
TIKI,do-choi-me-be,180855741,"Dầu Massage Cho Bé Natural Botanical Pigeon 120ml",124000,165000,41000,25
TIKI,do-choi-me-be,21078841,"Combo 02 nước mắm Lê Gia cho bé ăn dặm 200ml",128000,128000,0,0
TIKI,do-choi-me-be,116328331,"Dầu Gấc Cho Bé ăn dặm Maguzt 60ml",42900,42900,0,0
TIKI,do-choi-me-be,55348832,"Đồ Chơi Lắp Ráp Trẻ Em Robot MECHA 12 trong 1 - Bằng nhựa ABS an toàn ",199000,300000,101000,34
TIKI,do-choi-me-be,104131738,"Ly Mag Mag tập uống có ống hút Pigeon 180ml",114000,189000,75000,40
TIKI,do-choi-me-be,32001183,"Bộ Đồ Chơi Xếp Hình Thông Minh Nam Châm, Thanh Bi Buckyball Chính Hãng",122000,122000,0,0
TIKI,do-choi-me-be,176937814,"Bộ 3 bình trữ sữa Medela 150ml",465000,465000,0,0
TIKI,do-choi-me-be,17462885,"Sữa bột Nutricare Gastro dinh dưỡng y học cho người viêm dạ dày, rối loạn tiêu hoá (400g)",248000,249000,1000,0
TIKI,do-choi-me-be,55209437,"Đồ chơi  lắp ghép, xếp hình Qman 4803: Khủng long biến hình",265000,299000,34000,11
TIKI,do-choi-me-be,121975070,"Tã quần Jo 3S Plus size M72/L64/XL56/XXL48",365000,365000,0,0
TIKI,do-choi-me-be,116929866,"Sữa Hikid - Hàn Quốc vị vani (600g)",560000,580000,20000,3
TIKI,do-choi-me-be,50083407,"Nước rửa chén trung tính hương táo xanh Rocket 600g",29000,29000,0,0
TIKI,do-choi-me-be,249043639,"Sữa Ensure Úc cho người già, người gầy yếu suy dinh dưỡng, người sau phẫu thuật, cung cấp dinh dưỡng giúp hồi phục sức khỏe - OZ Slim Store -850g/lon",1108000,2216000,1108000,50
TIKI,do-choi-me-be,152529198,"Rubik 3x3x3 kèm rubik nhỏ 2x2x2 DK81085",90000,130000,40000,31
TIKI,do-choi-me-be,147920058,"Bộ Đồ Chơi Lắp Ráp Qman 1416 Robot Người Máy Sao Hỏa 498 Chi Tiết Cho Trẻ Từ 6 Tuổi",259000,259000,0,0
TIKI,do-choi-me-be,183702551,"Xếp hình Tia Sáng Muôn thú (30 Mảnh Ghép) - Tặng kèm tranh tô màu cho bé",14450,17000,2550,15
TIKI,do-choi-me-be,50241276,"Sữa bột Nutricare Kidney 1 - dinh dưỡng cho người suy thận, tiền chạy thận nhân tạo (900g)",494000,494000,0,0
TIKI,do-choi-me-be,23048034,"Bột Ăn Dặm Vinamilk Ridielac Gold Heo Cà Rốt (200g / Hộp Giấy)",62000,62000,0,0
TIKI,do-choi-me-be,72640767,"COMBO 5 GÓI KHĂN ƯỚT AGI KHÔNG HƯƠNG LOẠI 100 TỜ - GIAO MÀU NGẪU NHIÊN",179000,179000,0,0
TIKI,do-choi-me-be,94936730,"Đồ chơi xếp hình, lắp ráp Qman 1412 - Người máy hợp kim (498 mảnh ghép)",269000,339000,70000,21
TIKI,do-choi-me-be,20064786,"Tã dán Bobby đệm thun thấm mồ hôi",307000,370100,63100,17
TIKI,do-choi-me-be,101773857,"Quần tất múa bale, vớ bale múa siêu xinh cho bé yêu",35000,35000,0,0
TIKI,do-choi-me-be,120468958,"Bộ Đồ Chơi Xúc Cát Polesie 2136 - Hàng chính hãng nhập khẩu châu âu",53100,59000,5900,10
TIKI,do-choi-me-be,755390,"Cờ Tướng Ngà Lớn KTNLH Liên Hiệp Thành (Hộp Nhựa) ",90000,90000,0,0
TIKI,do-choi-me-be,81587308,"ta quan yubest gold size m 60 mieng",250000,250000,0,0
TIKI,do-choi-me-be,7061645,"Combo 2 gói mì MUG Nhật Bản cho bé - vị hải sản",145000,145000,0,0
TIKI,do-choi-me-be,47501977,"2 HỘP THỰC PHẨM BẢO VỆ SỨC KHỎE TENDOACTIVE",765800,765800,0,0
TIKI,do-choi-me-be,72779424,"Đồ Chơi Ghép Hình – Xe Đua Biến Hình Gồm 246 Chi Tiết -DK81026",130000,210000,80000,38
TIKI,do-choi-me-be,103595275,"Nước rửa bình sữa Wesser (chai)",115200,128000,12800,10
TIKI,do-choi-me-be,88822106,"Bộ đồ chơi xếp hình cảnh sát KAVY NO.8807  với hơn 820 chi tiết với robot, máy bay, xe cảnh sát... kèm hộp đựng",280000,280000,0,0
TIKI,do-choi-me-be,74892021,"Bộ đồ chơi lắp ráp xe tải KAVY nhiều màu sắc kích thích giác quan của bé, kích thước rất lớn, nhựa an toàn (kèm vít)",79000,79000,0,0
TIKI,do-choi-me-be,31957378,"MÁY ĐƯA VÕNG CAO CẤP AUTORU 85KG AUHRM85",690000,690000,0,0
TIKI,do-choi-me-be,53324045,"Sữa bột Colos Care Adult 800g - Dinh dưỡng tăng sức đề kháng người lớn tuổi ",410000,410000,0,0
TIKI,do-choi-me-be,80366462,"Bộ đồ chơi nhập vai BOWA – Vali trang điểm 21 món / Cặp trang điểm 26 món (BOWA 8228/BOWA 8256P)",155000,179000,24000,13
TIKI,do-choi-me-be,104328695,"Combo 4 Khóa tủ lạnh, chốt an toàn tủ lạnh, ngăn kéo, tủ đồ. Khóa cửa tủ an toàn cho bé. Chất liệu nhựa cao cấp. KHOANGAN001",49000,49000,0,0
TIKI,do-choi-me-be,270845213,"Sữa cho trẻ sơ sinh từ 0-1 tuổi Meiji nội địa Nhật giúp bé phát triển cân đối chiều cao, cân nặng, trí não  - QuaTangMe Extaste",704000,1408000,704000,50
TIKI,do-choi-me-be,53626686,"Ghế Ngồi Gắn Xe Đạp An Toàn Cho Bé Song Long",128000,128000,0,0
TIKI,do-choi-me-be,413228,"Sữa Bột Bầu Enfamama A+ với 360° Brain Plus - Vị Vanilla - 400g",235000,376419,141419,38
TIKI,do-choi-me-be,272047490,"Sữa hữu cơ cho trẻ biếng ăn từ 1-10 tuổi Úc Pediasure Organic Vanilla giúp phát triển cân đối chiều cao, cân nặng, trí não - QuaTangMe Extaste",1108000,2216000,1108000,50
TIKI,do-choi-me-be,147857839,"Tã dán cao cấp Moony 3S dành cho trẻ sơ sinh dưới 3 KG",114000,159000,45000,28
TIKI,do-choi-me-be,48329565,"FITOBIMBI FERRO C – SIRO THẢO DƯỢC CHUẨN HÓA CHÂU ÂU BỔ SUNG SẮT VÀ KẼM CHO TRẺ (200ML)",329000,329000,0,0
TIKI,do-choi-me-be,559006,"Khăn Ướt Mamamy Không Hương - Gói 30 Tờ",14000,14000,0,0
TIKI,do-choi-me-be,58766204,"Miếng lót siêu thấm Bobby Newborn 1-64",90000,90000,0,0
TIKI,do-choi-me-be,104159446,"Phấn thơm em bé Pigeon Nắp màu 100g/200g/450g",33000,38000,5000,13
TIKI,do-choi-me-be,76407075,"Xe đồ chơi mô hình KAVY xe cần cẩu cứu hộ NO.8807 cho bé chất liệu nhựa an toàn, kích thước lớn",77000,77000,0,0
TIKI,do-choi-me-be,147003827,"Bình tập uống bằng nhựa có ống hút hiệu Philips Avent (300ml/10oz) cho bé từ 12 tháng tuổi 798/00",305000,305000,0,0
TIKI,do-choi-me-be,192339768,"Đầu bàn chải điện cho bé LocknLock ENR226WHT-RB- 4pcs- Màu Trắng",98900,190000,91100,48
TIKI,do-choi-me-be,181568348,"Balo chống gù dáng hộp 3D cho bé trai ,balo học sinh tiểu học PHI HANH GIA siêu dễ thương HS1029",370000,740000,370000,50
TIKI,do-choi-me-be,80086962,"ta quan hingiga 100 mieng size 5xl",250000,250000,0,0
TIKI,do-choi-me-be,142426683,"Combo 3 nước rửa bình sữa Dnee 620ml/chai",175000,175000,0,0
TIKI,do-choi-me-be,173885880,"Kem hăm Sudocrem (60g) cho bé",115000,115000,0,0
TIKI,do-choi-me-be,129278493,"[Tặng kèm đèn nháy] Lều Công Chúa Cho Bé Cao Cấp - Lều Ngôi Nhà Vui Chơi - Lều Cắm Trại Công Chúa Hoàng Tử",308000,308000,0,0
TIKI,do-choi-me-be,40750301,"Sữa Bột Nguyên Kem Nutifood (400g)",79000,79000,0,0
TIKI,do-choi-me-be,11341358,"Sữa Bột Vinamilk Dielac Alpha 2 - Hộp Thiếc 900g",245000,245000,0,0
TIKI,do-choi-me-be,160111132,"TI GIẢ  BIBS COLOUR - Baby Blue NIGHT - Size 2 từ 6 - 18 tháng",160000,160000,0,0
TIKI,do-choi-me-be,146967928,"Bộ Đồ Chơi Xếp Hình Thông Minh Nam Châm, Thanh Bi Buckyball Chính Hãng dododios",146000,146000,0,0
TIKI,do-choi-me-be,80092491,"ta quan cao cap keiann xxxl 44 +2 mieng",190000,190000,0,0
TIKI,do-choi-me-be,76104101,"Đồ chơi xe ô tô điều khiển từ xa KAVY  tốc độ cao, dẫn động 2 bánh nhựa ABS an toàn",130000,130000,0,0
TIKI,do-choi-me-be,18288302,"Ghế Xe Đạp Trẻ Em Song Long - Màu Ngẫu Nhiên",126000,126000,0,0
TIKI,do-choi-me-be,13428892,"Gia vị rắc cơm 6 vị 30 gói, nội địa Nhật Bản",69900,69900,0,0
TIKI,do-choi-me-be,183896202,"Tấm lót chống thấm cho người già LONGLIFE size 70x100cm",349000,349000,0,0
TIKI,do-choi-me-be,132022509,"Đồ Chơi Gỗ Mô Hình Vòng Đu Quay Mặt Trời, Đồ Chơi Thí Nghiệm DIY WOOD STEAM Cho Bé,  Đồ Chơi Lắp Ghép Vòng Đu Quay Bằng Gỗ-Chính Hãng BABYBOSS + Tặng Kèm Tranh Ghép Bằng Gỗ",69000,125000,56000,45
TIKI,do-choi-me-be,31904594,"Muối rửa mũi Nha Đam Dr.Green| Hộp 30 gói| Dùng cho bé và người lớn| Hỗ trợ điều trị viêm mũi, sổ mũi, viêm mũi xoang",81000,81000,0,0
TIKI,do-choi-me-be,116572122,"Combo 3 lon sữa bột dinh dưỡng công thức HiPP 3 Organic Combiotic chất lượng hữu cơ, tăng cường sức khoẻ hệ miễn dịch, bổ sung Canxi và vitamin D dành cho trẻ trên 12 tháng tuổi (3 lon x 800g)",2355000,2355000,0,0
TIKI,do-choi-me-be,53447916,"KEM ĐÁNH RĂNG TRẺ EM NUK KHÔNG FLOURIDE 3-36 THÁNG (50G)",154230,159000,4770,3
TIKI,do-choi-me-be,111152167,"Tã quần JO Economy M72/L66/XL60/XXL54",155000,155000,0,0
TIKI,do-choi-me-be,125342064,"Đồ Chơi PLAYDOH Hộp Bột Nặn Playdoh Màu Trắng Nhạt NHAT/B5517C/WH",29000,29000,0,0
TIKI,do-choi-me-be,86142322,"Bộ dưỡng trắng hồng, mịn màng da mặt Wonmom ( 1 serum vitamin C + 1 kem nghệ tươi )",523000,625000,102000,16
TIKI,do-choi-me-be,153407418,"Lợi sữa Himom dạng cao lỏng cao cấp hỗ trợ tăng tiết sữa, giảm nguy cơ tắc tuyến sữa (hộp 30 gói)",325000,325000,0,0
TIKI,do-choi-me-be,195328185,"Nước lau sàn hương Gừng Sả SPY 950ml tự nhiên, thanh mát, giúp xua đuổi côn trùng hiệu quả",31200,31200,0,0
TIKI,do-choi-me-be,45307287,"Gối chống trào ngược cho bé Rototo Bebe cao cấp nhập khẩu Hàn Quốc khắc phục tình trạng trào ngược dạ dày trẻ sơ sinh hiệu quả - Loại Ripple nhăn thoáng mát, không bám dính",1590000,1590000,0,0
TIKI,do-choi-me-be,20087371,"Tã quần Moony siêu thoáng Boy",280000,280000,0,0
TIKI,do-choi-me-be,132827241,"Nước giặt hữu cơ Fuwa3e organic sinh học 500ml giặt quần áo đồ lót, an toàn cho em bé",75000,75000,0,0
TIKI,do-choi-me-be,23377880,"Siro bổ sung Kẽm, Vitamin C và D Brauer Úc Baby & Kids Liquid Zinc cho bé trên 1 tuổi (200ml)",518000,1036000,518000,50
TIKI,do-choi-me-be,97320850,"Khăn lau mặt dùng 1 lần Likado cho trẻ em và ngưới lớn kt 20*20cm( 1 cuộn 50 khăn)",45000,45000,0,0
TIKI,do-choi-me-be,76065165,"Đồ chơi mô hình xe đục KAVY đục phá bê tông mô phỏng chi tiết xe ngoài đời thực, với các khớp chuyển động",82000,82000,0,0
TIKI,do-choi-me-be,147008581,"Bình tập uống bằng nhựa có ống hút Philips Avent (200ml/7oz) cho bé từ 9 tháng tuổi 796/00",305000,305000,0,0
TIKI,do-choi-me-be,74879546,"Bộ đồ chơi nấu ăn nhà bếp KAVY với 36 chi tiết cao 63 cm có nhạc và đèn, nhựa nguyên sinh an toàn",345000,345000,0,0
TIKI,do-choi-me-be,186712674,"Chăn Đắp, Khăn Tắm Và Quấn Ủ Bonny 100% Sợi Tre Lụa 4 Lớp Siêu Mềm, Thấm Hút, An Toàn Cho Làn Da Của Bé Yêu (Kt:1m1x1m2)",179000,185000,6000,3
TIKI,do-choi-me-be,2147119,"Sữa bột nguyên kem của NutiFood 900 Gr",179000,179000,0,0
TIKI,do-choi-me-be,75105961,"Đồ chơi lắp ráp xe cứu hỏa phun nước KAVY có nhạc và đèn, đẹp bên bỉ phát huy tính thực hành cho bé",210000,210000,0,0
TIKI,do-choi-me-be,104126409,"Bình sữa cổ hẹp PP Streamline Pigeon 150ml/ 250ml",103000,158000,55000,35
TIKI,do-choi-me-be,103660237,"Nước rửa bình sữa Wesser (gói)",72000,80000,8000,10
TIKI,do-choi-me-be,193894788,"[GỖ TỰ NHIÊN CAO CẤP] Bộ cờ tướng gỗ sồi cao cấp kích thước 40 x 35cm, Bộ cờ tướng cao cấp khắc nét tinh xảo có bàn là hộp đựng gấp gọn - Hàng chính hãng D Danido",251000,380000,129000,34
TIKI,do-choi-me-be,20239324,"Máy tiệt trùng sấy khô và hâm sữa đa năng Moaz Bebe MB-005 ",1565000,1565000,0,0
TIKI,do-choi-me-be,150607076,"[HÀNG CAO CẤP - NANO TRÁNG GƯƠNG] Rubik Biến Thể Mirror Cube 3x3, Rubic Gương Có Chọn Màu dododios",63000,63000,0,0
TIKI,do-choi-me-be,48602661,"Xếp Hình Nam Châm Magnetic Blocks KUB",893000,893000,0,0
TIKI,do-choi-me-be,113429259,"Thùng sữa nước Nutricare ColosCare giúp trẻ tăng cường hệ miễn dịch (110ml)",384880,384880,0,0
TIKI,do-choi-me-be,66573724,"Bộ Bài Tây Poker Nền Đen Cao Cấp Chọn Màu – Bài Tây Nhựa PVC Chống Nước – Chính Hãng miDoctor",29000,29000,0,0
TIKI,do-choi-me-be,76076707,"đồ chơi ô tô quán tính KAVY  mô tả xe cứu hỏa, cứu thương, cảnh sát, taxi đẹp và dễ thương có đèn và nhạc",48000,48000,0,0
TIKI,do-choi-me-be,163576538,"Tả quần Babies Organic size XXXL (>18kg)",245000,320000,75000,23
TIKI,do-choi-me-be,4696281,"Tã Quần Bobby Ultra Jumbo XXL56 Siêu Siêu Lớn (Size XXL) - 56 Miếng",325000,325000,0,0
TIKI,do-choi-me-be,70340833,"Sữa Bột Vitadairy COLOSBABY BIO GOLD 0+ 800g",520000,520000,0,0
TIKI,do-choi-me-be,141755342,"Quần lót bé trai ATUNER QLN024, quần chip bé trai từ 2-8 tuổi, vải cotton co giãn, chất liệu kháng khuẩn, an toàn với làn da, họa tiết dễ thương, tươi sáng – Hàng Chính Hãng",35000,62000,27000,44
TIKI,do-choi-me-be,102760908,"Sữa bột Nutricare ColosCare Adult tăng cường sức đề kháng cho người lớn tuổi (800g)",467000,467000,0,0
TIKI,do-choi-me-be,7385567,"Cờ Tỷ Phú A1 Liên Hiệp Thành",64000,64000,0,0
TIKI,do-choi-me-be,74880955,"Bộ đồ chơi  lắp ghép đường ray ô tô KAVY kèm khủng long và nhiều chi tiết khác nhau",245000,245000,0,0
TIKI,do-choi-me-be,59400562,"KEM ĐÁNH RĂNG PIGEON CHO BÉ",90000,90000,0,0
TIKI,do-choi-me-be,157603714,"Ngũ cốc lợi sữa Lạc Lạc Plus mới cao cấp 39 loại hạt giúp mẹ bổ sung vitamin và khoáng chất, canxi giúp xương chắc khỏe 600g (hộp 30 gói)",299000,299000,0,0
TIKI,do-choi-me-be,104140706,"Bình sữa cổ hẹp PP Streamline hình ngôi sao hồng/xanh Pigeon 150ml (S)",94000,156000,62000,40
TIKI,do-choi-me-be,64988996,"Combo 10 Gói Khăn Ướt Yuniku 20 Tờ Hương Phấn  ( 20 Tờ x 10 )",85000,137000,52000,38
TIKI,do-choi-me-be,59298959,"Đặc Sản Phan Thiết - Nước Mắm Tĩn Trẻ Em Cho Bé Ăn Dặm Độ Đạm 42N Chai Thủy Tinh Mini 60Ml Rin Nguyên Chất Truyền Thống Sạch",28000,50000,22000,44
TIKI,do-choi-me-be,58807739,"Bột nấu công thức Mabu dành cho trẻ ăn dặm 400g",99000,99000,0,0
TIKI,do-choi-me-be,94855293,"Tã Quần Huggies Dry size XL32 (32 miếng+ khuyến mãi) - HSD Luôn Mới",215000,215000,0,0
TIKI,do-choi-me-be,55208639,"Đồ chơi lắp ghép,xếp hình Qman 4801: Phòng của bé gái",179000,199000,20000,10
TIKI,do-choi-me-be,125769167,"Vương miện cho bé, vương miện công chúa cho nàng cho bé đính đá cực xinh",40000,45000,5000,11
TIKI,do-choi-me-be,23011787,"Thảm xốp lót sàn cho bé - chữ cái + viền ngoài (26 miếng, diện tích 2.5m2) Smile Puzzle_KHÔNG MÙI TIÊU CHUẨN CHÂU ÂU",204000,210000,6000,3
TIKI,do-choi-me-be,115972826,"Sữa Miwako A+ Hộp 400g Vị Vani Nhập Khẩu Malaysia, Sữa Hạt Hữu Cơ Organic Cho Bé Từ 1-6 Tuổi Giúp Cải Thiện Ngôn Ngữ Phát Triển Trí Não & Chiều Cao Vị Ngọt Tự Nhiên Dễ Uống",425000,425000,0,0
TIKI,do-choi-me-be,143040800,"Túi trữ sữa Pur, hộp 50 túi",200000,200000,0,0
TIKI,do-choi-me-be,13752093,"Combo 6 Gói Khăn giấy ướt cho trẻ sơ sinh Huggies không mùi, gói 64 tờ",175000,175000,0,0
TIKI,do-choi-me-be,262679220,"Sữa dinh dưỡng Morinaga Nutritional Milk Powder PLUS 300g",445000,445000,0,0
TIKI,do-choi-me-be,72606261,"Ngũ cốc bầu siêu dinh dưỡng Lạc Lạc giảm ốm nghén, giúp xương của bé phát triển toàn diện, vào con nhiều hơn vào mẹ",299000,299000,0,0
TIKI,do-choi-me-be,128261455,"Siro Colosmulti MumMum hỗ trợ giúp trẻ ăn ngoan, tăng cường hấp thu hộp 20 ống x 10ml",350000,350000,0,0
TIKI,do-choi-me-be,191298281,"Đồ Chơi PLAYDOH Combo Bột Nặn 4 Màu Và Bột Nặn 4 Màu Mini CBB5517-23241-33 - Giao hàng ngẫu nhiên",208000,208000,0,0
TIKI,do-choi-me-be,65167422,"Bộ Thẻ Bài Chơi Pokemon 100 Thẻ (50Gx, 20Mega, 20Energy, 10trainer) Chơi Đối Kháng New Đẹp",119000,119000,0,0
TIKI,do-choi-me-be,39242473,"Thùng 48 hộp sữa YOKOGOLD pha sẵn 180ml",815000,815000,0,0
TIKI,do-choi-me-be,152018804,"Fatzbaby Máy tiệt trùng sấy khô UVC - LED Fatz baby - 19L - KING 2 - FB4799BT",2710180,2794000,83820,3
TIKI,do-choi-me-be,177825294,"Tã/bỉm quần cao cấp mijuku M50 / L50 / XL50 / XXL50 / XXXL50",185000,185000,0,0
TIKI,do-choi-me-be,183684100,"Xếp hình Tia Sáng  3 chú heo con và sói (30 Mảnh Ghép) - Tặng kèm tranh tô màu cho bé",14450,17000,2550,15
TIKI,do-choi-me-be,106935306,"Omega 3 cho bé Healthy Care Kids Gummy Hỗ trợ phát triển trí tuệ toàn diện, tăng cường thị lực, Giúp bé học tập và ghi nhớ tốt hơn - OZ Slim Store",503000,1006000,503000,50
TIKI,do-choi-me-be,23395327,"Viên mềm Dầu gan cá Tuyết tinh khiết và DHA Brauer Baby & Kids Ultra Pure Cod Liver Oil with DHA cho bé trên 1 tuổi (90 viên) - Nhập khẩu Australia",471000,1050000,579000,55
TIKI,do-choi-me-be,192558839,"Bộ đồ chơi 8 xe ô tô Poli  KAVY-82 biệt đội tàu bay siêu đẳng dễ thương chạy đà nhiều màu sắc",235000,235000,0,0
TIKI,do-choi-me-be,59167285,"Sữa Bột Namyang Imperial Majesty XO Care 800g",630000,711000,81000,11
TIKI,do-choi-me-be,184226271,"Lều Công Chúa Hoàng Tử Hình Ngôi Nhà",235000,235000,0,0
TIKI,do-choi-me-be,160930792,"Thước Đo Ti Mama’s Choice, Xác Định Đường Kính Núm Ti Mẹ, Giúp Mẹ Chọn Được Size Phễu Phù Hợp Khi Hút Sữa",40000,40000,0,0
TIKI,do-choi-me-be,138811444,"Bột rau củ dinh dưỡng cho bé Dalahouse Hộp 63gr (Mẫu mới gồm 21 tuýp tiện dụng) Sấy lạnh nguyên chất, đạt chuẩn Châu Âu",157500,175000,17500,10
TIKI,do-choi-me-be,111717003,"Sữa bột cho người suy thận Nutricare Kidney 1 giảm protein & giúp cân bằng điện giải, kiểm soát đường huyết (900g)",495000,495000,0,0
TIKI,do-choi-me-be,173718407,"Bộ Đồ Chơi Gỗ Xếp Khối, Giáo Cụ Montessori Ghép chữ, Ghép số, Câu Cá, Ghép Hình Cho Bé PaKaSa - Chính Hãng",179000,229800,50800,22
TIKI,do-choi-me-be,188694081,"Sữa bột ColosBaby Gold 0+ /Lon 800g",520000,520000,0,0
TIKI,do-choi-me-be,117727344,"Lốc 3 hộp thực phẩm dinh dưỡng Fomeal Basic Soup 250ml/hộp - Bữa ăn thay thế, giúp người bệnh phục hồi nhanh chóng",114000,114000,0,0
TIKI,do-choi-me-be,186236614,"Cháo Tươi Baby SG Food Bò & Đậu Hà Lan 240G",25000,25000,0,0
TIKI,do-choi-me-be,14526393,"Bộ 10 tấm Thảm xốp cho bé ECOBABY, thảm xốp đạt tiêu chuẩn Mỹ và Châu Âu - kích thước 1 tấm 30x30cm, độ dày khoảng 1cm - 10 số",94900,94900,0,0
TIKI,do-choi-me-be,31165864,"Sữa Bột Nutifood Enplus Gold (900g) – DD hàng ngày cho người trưởng thành",475000,475000,0,0
TIKI,do-choi-me-be,180238461,"Cháo Tươi Gà Nấm Đông Cô Cây Thị Mở Gói Ăn Ngay 260G",28000,28000,0,0
TIKI,do-choi-me-be,67493026,"Combo 6 Gói Khăn Ướt Yuniku 90 Tờ Hương Phấn ( 90 Tờ x 6 )",145000,250800,105800,42
TIKI,do-choi-me-be,23377020,"Xếp hình Tia Sáng Vui đùa bên mẹ  (30 Mảnh Ghép) - Tặng kèm tranh tô màu cho bé",13400,14500,1100,8
TIKI,do-choi-me-be,80468398,"Bộ 3 bình trữ sữa mẹ cổ rông 140ml vừa với máy hút sữa RESONANCE Fatzbaby",125000,145000,20000,14
TIKI,do-choi-me-be,11790092,"Siro Kích Thích Ăn Ngon Cho Trẻ Suvactif Appétit: Thực Phẩm Bảo Vệ Sức Khỏe Cao Cấp Từ Pháp, Bổ Sung Vitamin, Giúp Tăng Cân, Hết Biếng Ăn, Chậm Lớn, Vị Vani Dễ Uống, Đường Không Chứa Calo",279000,306000,27000,9
TIKI,do-choi-me-be,110664481,"Bộ 36 thảm xốp EVA lót sàn in hình an toàn cho bé ( 26 chữ cái + 10 chữ số), màu ngẫu nhiên",199000,199000,0,0
TIKI,do-choi-me-be,130440972,"Bột ăn dặm súp lơ, bông cải, phô mai Heinz",196000,196000,0,0
TIKI,do-choi-me-be,124209104,"Tã/bỉm quần Molfix Thiên nhiên Super Jumbo XL (12kg - 17kg) - Gói 48+8 miếng",355000,355000,0,0
TIKI,do-choi-me-be,180290433,"Cháo Tươi Hải Sản Thập Cẩm Cây Thị Mở Gói Ăn Ngay 240G",23000,28000,5000,18
TIKI,do-choi-me-be,178078918,"Dầu Tràm Khuynh Diệp Ích Nhi Nam Dược-Phòng cảm lạnh,an toàn cho trẻ sơ sinh,phụ nữ có thai,sau sinh",67000,67000,0,0
TIKI,do-choi-me-be,191756938,"Sandal Eva Phun Bé Trai Biti's DEB009300XNH",274000,335000,61000,18
TIKI,do-choi-me-be,90116922,"set 8 bịt góc bàn silicone - br00505",38000,48000,10000,21
TIKI,do-choi-me-be,3136589,"Núm Vú Cổ Hẹp Wesser (Size +)",83000,83000,0,0
TIKI,do-choi-me-be,164421747,"Đồ chơi âm nhạc giáo dục Alilo Baby Bunny G9S+ giáo dục sớm cho trẻ từ 0-4 tuổi, trợ lý giấc ngủ - Hàng chính hãng - Máy phát nhạc, kể chuyện cho bé, trợ lý giấc ngủ giúp bé ngủ ngon",1790000,1790000,0,0
TIKI,do-choi-me-be,168352561,"Tấm lót chống thấm cho người già Longlife size 60x90cm",299000,299000,0,0
TIKI,do-choi-me-be,50083415,"Gel làm sạch chống tắc đường ống Rocket 450g tẩy rửa mạnh",45000,45000,0,0
TIKI,do-choi-me-be,124163460,"Tã/bỉm dán sơ sinh Molfix Thiên nhiên Jumbo Newborn  (dưới 5kg) - Gói 70 miếng",225000,225000,0,0
TIKI,do-choi-me-be,111717745,"Sữa bột Nutricare Gastro dinh dưỡng y học cho người viêm dạ dày, rối loạn tiêu hóa (900g)",517000,517000,0,0
TIKI,do-choi-me-be,134341645,"Sữa Hoàng Gia Úc Royal Ausnz Premium Gold Dành Cho Trẻ Từ 1-3 Tuổi, Hỗ Trợ Phát Triển Chiều Cao Vượt Trội, Tăng Khả Năng Hấp Thụ Canxi, Phát Triển Trí Não, Tăng Khả Năng Miễn Dịch",636000,680000,44000,6
TIKI,do-choi-me-be,51544071,"Siro Tăng Đề Kháng Suvactif Immunité: Thực Phẩm Bảo Vệ Sức Khỏe Cho Trẻ Từ 6 Tháng Tuổi Chính Hãng Pháp, Giúp Tăng Miễn Dịch, Ngừa Bệnh Về Đường Hô Hấp, Hết Ốm Vặt, Cải Thiện Tình Trạng Biếng Ăn, Chậm Lớn. ",311000,341000,30000,9
TIKI,do-choi-me-be,52989058,"Đồ Chơi Gỗ Bàn Bi Lắc Mini 6 Tay Cầm Chất Lượng Cao - Đồ Chơi Vận Động Cho Bé + Tặng Kèm 1 Sâu Bướm Bằng Gỗ",299000,420000,121000,29
TIKI,do-choi-me-be,40750346,"Bộ 3 Túi Sữa Bột Nguyên Kem Nutifood (400g)",235000,235000,0,0
TIKI,do-choi-me-be,76478655,"Đồ chơi mô hình VECTO Transracers - Xe cứu hỏa biến hình Xe SUV VN463875-06",59000,59000,0,0
TIKI,do-choi-me-be,111657985,"Tả dán Babies Organic size M 56 miếng (6-11kg)",245000,320000,75000,23
TIKI,do-choi-me-be,89768858,"Đồ Chơi Bộ Đá Banh 6 TOONYKIDS - Đồ Chơi Vận Động Cho Bé - FOOTBALL PLAYER TN150 [Tặng Kèm Sticker]",259000,388500,129500,33
TIKI,do-choi-me-be,23377012,"Xếp hình Tia Sáng Đàn cừu  (30 Mảnh Ghép) - Tặng kèm tranh tô màu cho bé",14450,17000,2550,15
TIKI,do-choi-me-be,181986223,"[VIDEO]- Áo trùm máy quạt 45cm bảo vệ an toàn cho bé -Áo bọc quạt điện cao cấp, giao màu ngẫu nhiên",35000,35000,0,0
TIKI,do-choi-me-be,2563629,"Bộ 2 Bột Ăn Dặm Vinamilk Ridielac Alpha Vị Bò Rau Củ (200g/ Hộp)",124000,124000,0,0
TIKI,do-choi-me-be,196059173,"Đồ Chơi Rút Gỗ Số Thú Vị Thông Minh Cho Bé, Có 3 Cỡ Lựa Chọn (Nhỏ, Trung Và Lớn) - Chính Hãng",79000,79000,0,0
TIKI,do-choi-me-be,196998262,"Chậu Gấp Gọn Cho Bé Đa Năng Tiện Lợi Siêu Tiết kiệm Không Gian - 210",32000,32000,0,0
TIKI,do-choi-me-be,902326,"Núm ty cổ rộng McGOLDSON - Size L ( 2 cái/ Hộp)",60000,60000,0,0
TIKI,do-choi-me-be,23376996,"Xếp hình Tia Sáng Supper Wings  (48 Mảnh Ghép) - Tặng kèm câu đố mặt sau cho bé",25925,30500,4575,15
TIKI,do-choi-me-be,83204453,"Tã quần cao cấp Moony XXL26 dành cho bé gái",276000,276000,0,0
TIKI,do-choi-me-be,80955515,"Máy Tiệt Trùng Sấy Khô Hâm Sữa Điện Tử Có Tích Hợp Máy Hâm Sữa - CAPTAIN 1 - FB4320SJ",922000,922000,0,0
TIKI,do-choi-me-be,132814585,"Nước rửa bình Berkley Green 739ml Mỹ",195000,195000,0,0
TIKI,do-choi-me-be,79672205,"Túi Nước Giặt Lix Đậm Đặc Hương Nước Hoa 3.5Kg NGH07 - Tẩy Sạch Vết Bẩn Cực Mạnh",90000,90000,0,0
TIKI,do-choi-me-be,59373193,"Tã quần Bobby Siêu thoáng M76/L68/XL62/XXL56",379000,450600,71600,16
TIKI,do-choi-me-be,59350795,"Tã dán Bobby Siêu thấm - khô thoáng size XS",134700,134700,0,0
TIKI,do-choi-me-be,179371421,"Bộ sưu tập trứng - Đồ chơi lắp ráp mô hình Hello Kitty màu hồng cho bé gái",79000,79000,0,0
TIKI,do-choi-me-be,146643972,"Siro tăng đề kháng cho bé Doppelherz Kinder Immune Syrup hỗ trợ phòng ngừa ốm vặt cho bé (Chai 150ml)",389000,389000,0,0
TIKI,do-choi-me-be,154702923,"Ghế rung cho bé sơ sinh Mastela 6915/6917 có đồ chơi kèm  nhạc trắng ru ngủ, 4 nấc điều chỉnh độ cao gọn nhẹ tiện lợi",1095000,1095000,0,0
TIKI,do-choi-me-be,182292428,"Vitamin tổng hợp sau sinh Pregnacare Breast-feeding",499000,499000,0,0
TIKI,do-choi-me-be,127677587,"Máy Hút Sữa Điện Đôi ICHIKO Nhật Bản M5 (Massage, Kích sữa ,Vắt Kiệt) 9 cấp độ bảo hành 12 tháng (kèm quà tặng)",600000,600000,0,0
TIKI,do-choi-me-be,59357285,"Thùng sữa công thức pha sẵn Nutricare ColosCare (110ml x 48 hộp)- sữa non tăng cường miễn dịch",439000,439000,0,0
TIKI,do-choi-me-be,46758257,"LEGO DUPLO 10913 Thùng Gạch Duplo Sáng Tạo (65 Chi tiết)",791000,1319000,528000,40
TIKI,do-choi-me-be,25904341,"Set 3 Khăn Xô Sọi Tre Muslin Cho Bé 110x120cm",140140,143000,2860,2
TIKI,do-choi-me-be,253213390,"Hộp đựng thức ăn cho bé Lock&Lock có vạch chia LLG508S3 230ml x 3 hộp - LLG542S3 280ml x 3 hộp",192500,350000,157500,45
TIKI,do-choi-me-be,173251732,"Thùng sữa bột pha sẵn Oggi suy dinh dưỡng 110ml (Thùng 48 hộp)",325000,325000,0,0
TIKI,do-choi-me-be,214759193,"sữa non cho trẻ từ 1- 9 tuổi Ildong Hàn Quốc số 2  Giúp phát triển trí não, xương, răng và thị lực, tăng hệ miễn dịch, tạo hệ tiêu hóa khỏe mạnh - OZ Slim Store",41000,82000,41000,50
TIKI,do-choi-me-be,89801498,"Xe Trượt Scooter 3 Bánh Có Đèn LED Phát Sáng Điều Chỉnh Hướng Thế Hệ Mới Đại Nam Sport",323000,600000,277000,46
TIKI,do-choi-me-be,137484351,"Bình sữa cổ rộng Lansinoh 160ml",132500,265000,132500,50
TIKI,do-choi-me-be,1549555,"Sữa tắm trẻ em Arau Baby 450ml",173130,199000,25870,13
TIKI,do-choi-me-be,848992,"Tã Dán Huggies Dry Gói Cực Đại L68 (68 Miếng) - Bao Bì Mới",310000,310000,0,0
TIKI,do-choi-me-be,176124825,"Thảm Chơi Cho Bé Thảm Xốp Cuộn Umoo Trải Sàn Cho Bé Nằm Tập Bò",575000,584900,9900,2
TIKI,do-choi-me-be,119706900,"Combo Sữa tắm gội Cetaphil Baby W&S with Organic Calendula 400ml + Sữa dưỡng thể Cetaphil Baby with Organic Calendula 400ml",676000,676000,0,0
TIKI,do-choi-me-be,69704206,"Combo 4 gói khăn ướt Bobby Care có hương 100 tờ",130000,164000,34000,21
TIKI,do-choi-me-be,136377296,"2 Hộp Sữa Bột Meiji 0-1 Infant Formula (800g)",1138000,1138000,0,0
TIKI,do-choi-me-be,113459561,"Bộ đồ chơi hướng nghiệp nấu ăn nhà bếp cho bé từ 3 tới 8 tuổi Toyshouse 889-173",165000,165000,0,0
TIKI,do-choi-me-be,81237364,"Nhộng chũn cho bé cao cấp Babyup. Nhộng ngủ cho trẻ sơ sinh Giúp bé ngủ ngon, sâu giấc, chống giật mình - Nhộng ngủ Vải cotton co giãn 4 chiều, mềm mại thoáng mát - Có khóa kéo 2 chiều",195000,195000,0,0
TIKI,do-choi-me-be,134146,"Địu Trẻ Em Aprica Pitta 39400",960000,1767273,807273,46
TIKI,do-choi-me-be,107016387,"Đồ Chơi Điện Thoại Thỏ Xanh",53000,86000,33000,38
TIKI,do-choi-me-be,148541501,"Bộ Bàn Đấu Cờ Búng Bắn Bi Xuyên Lỗ Đối Kháng Chính Hãng Dododios - Chọn Size - Foosball Winner, Sling Puck – Bộ Cờ Ice Hockey Bằng Gỗ Cao Cấp",207000,207000,0,0
TIKI,do-choi-me-be,117405280,"Sữa non Colosmulti BioBio giúp tăng cường miễn dịch, cải thiện tiêu hóa hộp 20 gói x 3g",350000,350000,0,0
TIKI,do-choi-me-be,49023186,"Thùng sữa bột pha sẵn Nutricare Hanie Kid - dinh dưỡng cho trẻ biếng ăn & suy dinh dưỡng trên 1 tuổi (110ml x 48 hộp)",415000,432000,17000,4
TIKI,do-choi-me-be,214128755,"Sữa tăng cân cho bé Pediasure Grow & Gain with fiber  Mỹ - Giúp trẻ phát triển chiều cao, cân nặng, trí tuệ - QuaTangMe Extaste",2078000,4156000,2078000,50
TIKI,do-choi-me-be,273044353,"[MUA 5 TẶNG 2] Combo 5 bịch khăn ướt 100 tờ Sunbaby SBB2020",31000,31000,0,0
TIKI,do-choi-me-be,2791865,"Dầu gội cốt bồ kết đánh bay gàu, mọc tóc, dưỡng tóc đen mượt Wonmom 250ml",173000,195000,22000,11
TIKI,do-choi-me-be,150814710,"Đồ chơi sáng tạo Kính vạn hoa Magic Kaleidoscope - chính hãng MIDEER",89000,129000,40000,31
TIKI,do-choi-me-be,15356096,"Thùng 48 Hộp Sữa Bột Pha Sẵn Vinamilk Dielac Grow Plus - Đỏ 180ml",530000,530000,0,0
TIKI,do-choi-me-be,115719846,"Sữa bột Vinamilk KenKo Haru dành cho người lớn - Hộp thiếc 850g",595000,595000,0,0
TIKI,do-choi-me-be,35912637,"Combo 2 gói Gia vị rắc cơm cho bé (6 vị 30 gói) - nội địa Nhật Bản",136000,136000,0,0
TIKI,do-choi-me-be,166389287,"LEGO DUPLO 10913 Thùng Gạch Duplo Sáng Tạo",378000,755000,377000,50
TIKI,do-choi-me-be,156718472,"Lốc 3 hộp thực phẩm dinh dưỡng Delisoup 250ml/hộp - Bữa ăn thay thế - Giúp người bệnh phục hồi nhanh chóng - Orgalife",88500,88500,0,0
TIKI,do-choi-me-be,113585459,"Bộ Tranh Ghép Xếp Hình 1000 Pcs Jigsaw Puzzle (Tranh ghép 70*50cm) Bản Thú Vị Cao Cấp",50000,50000,0,0
TIKI,do-choi-me-be,137484360,"Núm vú Lansinoh size S/M/F",95500,191000,95500,50
TIKI,do-choi-me-be,88011456,"[COMBO 3 CHAI] Nước Xả Vải Khô Lâm Đại Phúc -MIX MÙI",125000,125000,0,0
TIKI,do-choi-me-be,147966160,"Chốt Cánh Tủ An Toàn Cho Bé, Khóa Chốt Theo Phong Cách Hiện Đại, Sản Phẩm An Toàn Cho Em Bé, Tiện Ích Cho Gia Đình. TakyHome 3107",35000,35000,0,0
TIKI,do-choi-me-be,181462590,"Bình ống hút AQ Richell Nhật Bản 320ml | Baby",391745,391745,0,0
TIKI,do-choi-me-be,2791861,"Gừng toàn thân hạ thổ giữ ấm cơ thể, lưu thông khí huyết, giảm đau nhức Wonmom 200ml",184000,220000,36000,16
TIKI,do-choi-me-be,269897780,"Máy hút sữa bằng điện Philips Avent 394.11",7855000,7855000,0,0
TIKI,do-choi-me-be,270713659,"Sữa non cho bé từ 1 - 9 tuổi Ildong Plus 2 Hàn Bổ sung đầy đủ dinh dưỡng cho bé phát triển trí não, xương, răng và thị lực, tăng hệ miễn dịch, tạo hệ tiêu hóa khỏe mạnh - OZ Slim Store",292000,584000,292000,50
TIKI,do-choi-me-be,37597448,"Sữa Công Thức Hữu Cơ Bước 3 Bellamy's Organic (900g)",790000,790000,0,0
TIKI,do-choi-me-be,57952815,"Bộ Đồ Chơi Lắp Ráp Ghép Hình Mô Hình Xe Tăng C-25 Bằng Gỗ. Đồ Chơi Thí Nghiệm Cho Bé - Tặng Kèm 1 Tranh Ghép Bằng Gỗ (Ngẫu nhiên)",65000,85000,20000,24
TIKI,do-choi-me-be,99630240,"Sữa Non ILDong Foodis  Plus 2Hàn Quốc, tăng kháng thể cho trẻ em còi xương, suy dinh dưỡng, bé mới ốm dậy, không được khỏe và những bé biếng ăn, số 2 - OZ Slim Store",254000,584000,330000,57
TIKI,do-choi-me-be,76067973,"Đồ chơi mô hình xe đầu kéo container KAVY chi tiết sắc sảo, nhiều màu sắc kích thích thị giác của trẻ, có thể trưng bày",195000,195000,0,0
TIKI,do-choi-me-be,848996,"Tã Dán Huggies Dry Gói Cực Đại XXL56 (56 Miếng) - Bao Bì Mới",310000,310000,0,0
TIKI,do-choi-me-be,181462653,"Ống hút S-2 Richell Nhật Bản - 2 bộ | Baby",165927,165927,0,0
TIKI,do-choi-me-be,196205339,"Combo 05 Gói Súp Dinh Dưỡng Cây Thị: Nui Thịt Bằm Bí Đỏ, Nui Óc Heo Cà Rốt, Hải Sản Tóc Tiên, Hải Sản Măng Tây, Bắp Cua Hạt Sen",128000,150000,22000,15
TIKI,do-choi-me-be,184099509,"Sữa Bột Vinamilk Dielac Alpha Gold IQ Step 3 - Hộp Thiếc 850g",285000,285000,0,0
TIKI,do-choi-me-be,112098994,"Thùng sữa nước Nutricare Metacare GOLD hỗ trợ hệ tiêu hóa và miễn dich (180ml)",548000,548000,0,0
TIKI,do-choi-me-be,101851971,"Thùng sữa pha sẵn Nuvi Grow 110ml - Dinh dưỡng tối ưu chiều cao, thông minh, khoẻ mạnh cho bé trên 1 tuổi",380000,380000,0,0
TIKI,do-choi-me-be,543137,"Nước Giặt Quần Áo Cho Bé D-Nee - Chai 960ml (Xanh)",100000,109000,9000,8
TIKI,do-choi-me-be,153994330,"Đồ chơi giáo dục sớm cho trẻ sơ sinh:Sách vải Toyshouse với nhiều chủ đề giúp phát triển đa giác quan cho bé từ sơ sinh",141000,141000,0,0
TIKI,do-choi-me-be,98179288,"Xe thăng bằng cho em bé - hàng chính hãng Em Bé Vàng -Bảo hành 12 tháng (tặng bọc tay lái)",469000,469000,0,0
TIKI,do-choi-me-be,26270885,"Thú nhún bơm hơi Toyshouse (KÈM BƠM)- Tiêu chuẩn xuất khẩu Mỹ (ASTM) và Châu Âu (EN71)- Đồ chơi vận động cho bé từ 8 tháng",360000,360000,0,0
TIKI,do-choi-me-be,479485,"Đồ Chơi Gỗ Winwintoys - Trò Chơi Lăn Banh 60092",226000,226000,0,0
TIKI,do-choi-me-be,95085104,"Bỉm - Tã dán Bobby size M - 76 miếng (Cho bé 6 - 10kg)",285000,285000,0,0
TIKI,do-choi-me-be,55348939,"Bộ đồ chơi lắp ráp Robot Không Gian Kích thước 38*27 cm Bằng nhựa ABS an toàn",209000,209000,0,0
TIKI,do-choi-me-be,80134625,"ta quan hingig 100 ta quan size M 100 ta quan size L 100 ta quan size XL 100 ta quan size XXL 100 ta quan size XXXL",225000,225000,0,0
TIKI,do-choi-me-be,543158,"Dung Dịch Giặt Quần Áo Cho Bé D-Nee - Túi 600ml (Hồng)",85000,85000,0,0
TIKI,do-choi-me-be,15840502,"Gói 50 Khăn sữa vải gạc Thanh Thanh Dày 4 lớp 25x30cm 100% cotton (Đồ dùng vệ sinh cho bé) ",195000,195000,0,0
TIKI,do-choi-me-be,115829773,"Đồ Chơi Gỗ Xe Mô Hình Bánh Răng Công Nghệ, Đồ Chơi Lắp Ráp Xe Đẩy Khứ Hồi, Đồ Chơi Khoa Học Tự Làm DIY Wood Steam C-24 - Chính Hãng BABYBOSS + Tặng Kèm Tranh Ghép Gỗ",59000,85000,26000,31
TIKI,do-choi-me-be,79672316,"Túi Nước Giặt Lix Đậm Đặc Hương Hoa 3.5Kg NG350 - Tẩy Sạch Vết Bẩn Cực Mạnh",90000,90000,0,0
TIKI,do-choi-me-be,146925316,"Dụng cụ lấy ráy tai cho Bé, bộ ngoáy tai tich hợp đèn soi cho cảm giác siêu đỉnh",53900,55000,1100,2
TIKI,do-choi-me-be,54914739,"GẤU BÔNG ÔM TRÀ SỮA TRÒN CỰC MỊN 4 SIZE",89000,89000,0,0
TIKI,do-choi-me-be,56274632,"Nôi ru ngủ thư giãn kết hợp ghế ngồi đọc sách cho bé có nhạc Mastela 8104/8106 - điều khiển từ xa - kết hợp Bluetooth",2389000,2389000,0,0
TIKI,do-choi-me-be,110575696,"Máy hâm sữa và thức ăn siêu tốc Sunshine hiệu Philips Avent 358.00",2035000,2035000,0,0
TIKI,do-choi-me-be,88031365,"ĐẦM BÉ GÁI CÔNG CHÚA  FREESHIP ĐẦM BÉ GÁI SƠ SINH ĐẾN 6 TUỔI NHIỀU MẦU CHO BÉ",134000,150000,16000,11
TIKI,do-choi-me-be,111635087,"Đồ chơi xếp hình lắp ráp Qman 2901 - Hộp gạch sáng tạo cơ bản (460 mảnh ghép)",179000,199000,20000,10
TIKI,do-choi-me-be,191921923,"Đồ chơi trẻ em: Ô tô mô hình hợp kim xe bán tải DK 81107. Kiểu dáng, mẫu xe, màu sắc ngẫu nhiên.",87500,125000,37500,30
TIKI,do-choi-me-be,49499052,"Combo 4 bịch bỉm/tã quần cao cấp MIJUKU - M",719000,719000,0,0
TIKI,do-choi-me-be,106063557,"Gạc Răng Miệng Tottee Tinh Chất Cỏ Ngọt - Hộp 25 Gói ( Dr Papie)",65000,65000,0,0
TIKI,do-choi-me-be,116727417,"Sữa Hữu Cơ Miwako Nhập Khẩu Malaysia Hộp 400g Vị Gạo, Sữa Hạt Dinh Dưỡng Cho Bé Biếng Ăn Tiêu Hóa Kém Thấp Còi",347900,355000,7100,2
TIKI,do-choi-me-be,58666961,"Sữa bột OPTIMUM GOLD Step 4 - Hộp thiếc 1,5kg (dành cho trẻ 2-6 tuổi)",569000,569000,0,0
TIKI,do-choi-me-be,70853747,"Bộ Thẻ Bài Pokemon 100 Thẻ Cao Cấp Nhiều Loại",119000,119000,0,0
TIKI,do-choi-me-be,4948115,"Kem đánh răng cho bé Kuku - Hương nho",65000,65000,0,0
TIKI,do-choi-me-be,74814983,"Đồ chơi mô hình xe xúc đất KAVY NO.8810 chất liệu hợp kim và nhựa nguyên sinh an toàn, chi tiết sắc sảo",93000,93000,0,0
TIKI,do-choi-me-be,62485218,"Đồ Chơi Đàn Mini Piano Cao Cấp - KUB, Đèn LED Hướng Dẫn, Âm Thanh Cực Hay",1182000,1182000,0,0
TIKI,do-choi-me-be,77014669,"Viên kẹo nhai bổ sung kẽm Healthy Care Zinc + Vitamin C Chewable cho bé 60 viên chính hãng Úc - Tăng sức đề kháng, giúp bé ăn ngon, phòng ngừa ốm vặt vặt ",208100,208100,0,0
TIKI,do-choi-me-be,97820444,"Đồ chơi mô hình xe ben mini KAVY NO.8807 chất liệu hợp kim an toàn cho bé có thể làm đồ trang trí - màu vàng",29000,29000,0,0
TIKI,do-choi-me-be,15792061,"Thảm xốp lót sàn cho bé - đơn màu (10 miếng, diện tích 1m2)",105000,120000,15000,13
TIKI,do-choi-me-be,399543,"Xe Buýt Đi Học Siku - 1319",119000,119000,0,0
TIKI,do-choi-me-be,192833833,"Núm ty ban đêm Philips Avent cho trẻ từ 0-6 tháng tuổi SCF376/10",275000,275000,0,0
TIKI,do-choi-me-be,35607001,"combo 10 gói khăn ướt em bé Beeno",220000,220000,0,0
TIKI,do-choi-me-be,107020747,"Đồ chơi Điện Thoại Thỏ Hồng Duka",64500,86000,21500,25
TIKI,do-choi-me-be,2222539,"Đồ Chơi FISHER PRICE Thảm Chơi Piano FGG45",1799000,1799000,0,0
TIKI,do-choi-me-be,23377022,"Tranh xếp hình Tia Sáng Đàn gà 30 mảnh ghép- Tặng kèm tranh tô màu cho bé",14450,17000,2550,15
TIKI,do-choi-me-be,21555710,"Đồ Chơi Gỗ Bảng Ghép Chữ Cái Tiếng Việt In Hoa Benrikids Tặng Kèm Bộ 40 Thẻ Học Flashcards Cho Bé Học Chữ Và Số Đếm",55000,69000,14000,20
TIKI,do-choi-me-be,143465598,"Đồ Chơi Lắp Ghép STEM Mô Hình Máy Bay Vận Tải, Đồ Chơi Gỗ Cao Cấp Máy Bay Vận Tải, Đồ Chơi Khoa Học Tự Làm DIY Wood Steam-Chính Hãng BABYBOSS + Tặng Kèm Tranh Ghép Gỗ.",40000,75000,35000,47
TIKI,do-choi-me-be,113251759,"DHA cho bé từ 4 tháng - 12 tuổi Healthy Care Kids High Strength Úc, Giúp trẻ phát triển trí tuệ, thông minh, mắt sáng khỏe - OZ Slim Store 60 viên",266000,532000,266000,50
TIKI,do-choi-me-be,111582665,"Bộ sưu tập đồ chơi trí tuệ Rubik Qiyi – Phiên bản Stickerless 2x2 3x3 4x4 5x5 6x6 7x7 Pyraminx Skewb Megaminx Mastermorphix Square-1 Windmill Dino Fisher Axis",28800,32000,3200,10
TIKI,do-choi-me-be,3016043,"Tã Quần Cao Cấp Moony Nhật Bản Bé Trai XXL26 (26 Miếng)",271000,466400,195400,42
TIKI,do-choi-me-be,543134,"Nước Giặt Quần Áo Cho Bé D-Nee - Chai 960ml (Hồng)",100000,109000,9000,8
TIKI,do-choi-me-be,59300266,"Đặc Sản Phan Thiết - Nước Mắm Tĩn Trẻ Em Cho Bé Ăn Dặm Độ Đạm 42N Tự Nhiên Chai Thủy Tinh 250Ml Nước Mắm Rin Nguyên Chất Truyền Thống Sạch Nước Mắm Nhỉ Từ Thùng Lều Gỗ Cốt Đặc Biệt Cá Cơm Than Muối Tinh Khiết, Cho Bé Ăn Dặm Không Chất Bảo Quản",98000,190000,92000,48
TIKI,do-choi-me-be,113759643,"Dầu Mè Đen Ăn Dặm Maguzt Nguyên Chất",38600,38600,0,0
TIKI,do-choi-me-be,168582437,"Nước Tắm Gội Thảo Dược Dr.Papie Cho Bé Giúp Ngăn Ngừa Và Giảm Các Vấn Đề Về Da",180000,180000,0,0
TIKI,do-choi-me-be,249036980,"Ống hút thay thế thông minh Wesser",79210,89000,9790,11
TIKI,do-choi-me-be,10909431,"Thùng sữa nước Nutricare Metacare ECO - phát triển toàn diện cho trẻ từ 1 tuổi (110ml x 48 hộp)",285000,285000,0,0
TIKI,do-choi-me-be,34289431,"Nước Rửa Bình Sữa Và Rau Quả Thành Phần Chuyên Làm Sạch Thực Phẩm An Toàn Cho Bé Mamamy (600ml)",114500,114500,0,0
TIKI,do-choi-me-be,35247516,"Bộ 2 núm ti comotomo silicone + tặng khăn/yếm tam giác giữ ấm cổ cho bé họa tiết ngẫu nhiên",266750,275000,8250,3
TIKI,do-choi-me-be,89429345,"Hartus Immunity Hỗ Trợ Miễn Dịch & Tăng Cường Sức Đề Kháng, Giúp Bé Khỏe Mạnh Tự Nhiên, Phát triển toàn diện - Phù hợp cho trẻ từ 4 tháng tuổi - Sản phẩm nhập khẩu chính hãng, uy tín, an toàn",272000,299000,27000,9
TIKI,do-choi-me-be,56433290,"Bình rửa mũi cho trẻ Dr.Green Kids, kèm 30 gói muối rửa mũi, dung tích 180ml, đầu rửa silicon mềm mại, phù hợp rửa mũi với trẻ em",179000,179000,0,0
TIKI,do-choi-me-be,152738175,"Đồ Chơi LEGO NINJAGO Rồng Thần Sấm Sét Của Jay 71760",586040,598000,11960,2
TIKI,do-choi-me-be,198697358,"Van Trắng Máy Hút Sữa Maymom, Phụ Kiện Thay Thế Máy Medela Pump, Harmony, Swing, Mini Electric",25000,25000,0,0
TIKI,do-choi-me-be,89373236,"Bộ đồ chơi xe tăng KAVY NO.8827 kèm 4 xe quân sự bằng kim loại có đèn và nhạc thanh trượt, cất giữ bên trong",440000,440000,0,0
TIKI,do-choi-me-be,110308934,"Sữa bột tốt Nutricare Glucare Gold tốt cho người tiểu đường, phụ nữ tiểu đường thai kỳ (850g)",450000,450000,0,0
TIKI,do-choi-me-be,29559865,"Đồ Chơi Ghép Hình Quân Đội Chiến Xa Lội Nước 8 trong 1 Qman 1803 Cho Bé Từ 6 Tuổi",199000,249000,50000,20
TIKI,do-choi-me-be,53252736,"Núm ty silicon siêu mềm tự nhiên cho bé Tommee Tippee Natural Start Medium Flow 3-6 tháng (vỉ đôi)",195000,195000,0,0
TIKI,do-choi-me-be,74871299,"Đồ chơi mô hình xe tăng chạy pin chạy nhanh khỏe, nhựa nguyên sinh an toàn",36000,36000,0,0
TIKI,do-choi-me-be,74816689,"Đồ chơi mô hình xe cứu hỏa phun nước KAVY NO.8827 chất liệu hợp kim và nhựa nguyên sinh an toàn, chi tiết sắc sảo",90000,90000,0,0
TIKI,do-choi-me-be,190108475,"Lốc 61 - Combo 6 Cháo Tươi Baby Sài Gòn Food 240G (Gà, Thịt Bằm, Bò, Tôm, Lươn, Cá Hồi)",147000,147000,0,0
TIKI,do-choi-me-be,59141041,"Xịt xả vải khô Lâm Đại Phúc hương nước hoa",29000,29000,0,0
TIKI,do-choi-me-be,169914725,"Lốc 3 hộp thực phẩm dinh dưỡng y học Fomeal 237ml/hộp - Dinh dưỡng cho người bệnh, kém hấp thu, phục hồi nhanh chóng",226500,226500,0,0
TIKI,do-choi-me-be,270694157,"Canxi cho bé Healthy Care Kids Milk Calcium Úc, Hỗ trợ tăng trưởng chiều cao, hệ thống xương, răng, bé ngủ ngon không trằn trọc ban đêm - Massel Official",263000,526000,263000,50
TIKI,do-choi-me-be,58809549,"Bột nấu công thức Mabu dành cho trẻ ăn dặm 900g",199000,199000,0,0
TIKI,do-choi-me-be,55648295,"Sữa Bột Namyang Imperial Mom XO GT 400g",283000,319000,36000,11
TIKI,do-choi-me-be,77033523,"Combo 10 Chip Poker  Phỉnh Poker Có Số Cao Cấp",30000,30000,0,0
TIKI,do-choi-me-be,100625065,"Set 2 Khăn Tắm Bonny 4 Lớp 90x90Cm Chất Liệu Tre Lụa Mềm Mại Kháng Khuẩn Siêu Thấm Hút An Toàn Cho Da Bé (Hàng Cao Cấp)",148000,275000,127000,46
TIKI,do-choi-me-be,78490455,"Bộ đô chơi xếp hình xe đua ô tô KAVY model 31003 và 31005C hơn 160 chi tiết sáng tạo độc đáo",94000,94000,0,0
TIKI,do-choi-me-be,58558883,"Bộ Thẻ Bài Pokemon 324 Thẻ Trading Card Game Swoad & Shield TCG Sưu Tập Đẹp Đọc Đáo",199000,199000,0,0
TIKI,do-choi-me-be,174581603,"Vitamin D3 Drops Ostelin (0-12Y)",209000,230000,21000,9
TIKI,do-choi-me-be,198696813,"Phễu Hút Sữa Maymom Myfit, Phụ Kiện Thay Thế Máy Vắt Sữa Medela, Spectra, Avent, Unimom, Rozabi, Cimilre",125000,125000,0,0
TIKI,do-choi-me-be,117727340,"Thùng 30 hộp thực phẩm dinh dưỡng Fomeal Basic Soup 250ml/hộp - Bữa ăn thay thế, giúp người bệnh phục hồi nhanh chóng",1140000,1140000,0,0
TIKI,do-choi-me-be,37033160,"Sữa Bột VitaDairy Nepro 1 (900g)",458000,458000,0,0
TIKI,do-choi-me-be,86534483,"Đồ Chơi Mô Hình BATMAN Người Dơi Batman 12 Inch 6055152",379000,379000,0,0
TIKI,do-choi-me-be,62478215,"Thang Vệ Sinh Kèm Bệ Ngồi Toilet - Crowned Love",657000,657000,0,0
TIKI,do-choi-me-be,98267553," Sữa bột PURELAC 3 800g nhập khẩu New Zealand",790000,790000,0,0
TIKI,do-choi-me-be,17035665,"Khăn ướt Agi không mùi V438 (5 gói màu ngẫu nhiên)",185000,185000,0,0
TIKI,do-choi-me-be,119706894,"Combo Sữa tắm gội dịu lành Cetaphil Baby Gentle Wash & Shampoo 400ml + Sữa dưỡng thể dịu lành Cetaphil Baby Lotion 400ml",558000,558000,0,0
TIKI,do-choi-me-be,396961,"Đồ Chơi BRUDER Dạng Mô Hình Theo Tỷ Lệ Thu Nhỏ 1:16 Xe Cứu Hỏa Có T BRU02532",1199000,1599000,400000,25
TIKI,do-choi-me-be,55987087,"Vi Sinh Xử Lý Bồn Cầu, Bể Phốt  Đầy, Tràn - EcoFlush Hộp Nhỏ - Túi Gói Sinh Học Tự Huỷ",69000,69000,0,0
TIKI,do-choi-me-be,16097960,"GrowPLUS+ Đỏ Cho Trẻ Suy Dinh Dưỡng Trên 1 Tuổi - Hàng Chính Hãng",379000,379000,0,0
TIKI,do-choi-me-be,49025554,"Xe Địa Hình Điều Khiển Từ Xa Duka - Quán Quân",123750,165000,41250,25
TIKI,do-choi-me-be,117495741,"Túi Khăn Sữa 4 Lớp sợi dày Baby Bear - 1 Túi 10 cái kích thước 25x27 cm",37000,37000,0,0
TIKI,do-choi-me-be,38408974,"Nhiệt kế hồng ngoại 3 trong 1 Omron MC 720",899000,1020000,121000,12
TIKI,do-choi-me-be,54548618,"SỮA BỘT VINAMILK DIELAC GROW PLUS 2+ 1,5 KG (CHO TRẺ TỪ 2 - 10 TUỔI)",560000,560000,0,0
TIKI,do-choi-me-be,50362834,"Đồ Chơi Gỗ Bàn Chơi Khúc Côn Cầu",320000,630000,310000,49
TIKI,do-choi-me-be,152738145,"Đồ Chơi LEGO TECHNIC Xe Formula E Porsche 99X Electric 42137",1272384,1692000,419616,25
TIKI,do-choi-me-be,66940988,"Bộ 6 Gói Khăn Ướt Aiko Kháng Khuẩn 100 tờ/Gói",175000,175000,0,0
TIKI,do-choi-me-be,3869551,"Combo 5 Bịch Tấm lót sơ sinh Likado (30 miếng/ Bịch)",125000,125000,0,0
TIKI,do-choi-me-be,755392,"Cờ Tướng Ngà Trung KTNTH Liên Hiệp Thành (Hộp Nhựa)",77000,77000,0,0
TIKI,do-choi-me-be,86534419,"Đồ Chơi Mô Hình BATMAN Người Dơi Batman 6 Inch 6055412",179000,179000,0,0
TIKI,do-choi-me-be,16046598,"Nước tắm thảo dược Dr Papie",116250,125000,8750,7
TIKI,do-choi-me-be,101365721,"Sữa non Colosmulti Biotic hộp 26 gói x 16g chuyên biệt cho trẻ táo bón, tiêu hóa kém",950000,950000,0,0
TIKI,do-choi-me-be,249057452,"Bình sữa cổ hẹp PPSU Wesser 60ml/140ml/250ml",209440,238000,28560,12
TIKI,do-choi-me-be,57378097,"COMBO 3 GIẤY VỆ SINH CUỘN LỚN DALIN 700G TIẾT KIỆM",168000,168000,0,0
TIKI,do-choi-me-be,160931140,"Dụng Cụ Vệ Sinh Dây Hút Sữa Mama's Choice, Thiết Kế Thép Không Rỉ, Uốn Cong Dễ Dàng, Chiều Dài 70cm",70000,70000,0,0
TIKI,do-choi-me-be,69701578,"Mô hình xe Mercedes Benz X Class",439000,439000,0,0
TIKI,do-choi-me-be,183896204,"Tấm lót chống thấm cho người già LONGLIFE size trải giường 1,2x2m - 1,4x2m - 1,6x2m - 1,8x2m - 2,2x2m",699000,699000,0,0
TIKI,do-choi-me-be,19830496,"Xe Cảnh Sát Kết Hợp Ánh Sáng Và Âm Thanh Duka",136400,220000,83600,38
TIKI,do-choi-me-be,68924301,"Cháo Tươi Yến Hạt Sen Lá Dứa Cây Thị",30800,36000,5200,14
TIKI,do-choi-me-be,49012488,"Set đồ khay bát ăn dặm 10 món - xanh aqua - Dụng cụ ăn dặm cho bé Uinlui ăn toàn làm từ dừa",599200,749000,149800,20
TIKI,do-choi-me-be,106913149,"Sữa tắm gội chiết xuất hoa cúc Chicco",221900,221900,0,0
TIKI,do-choi-me-be,4140007,"Kem Đánh Răng Hương Dâu 12M+ Chicco",171690,177000,5310,3
TIKI,do-choi-me-be,2791829,"Túi lọc thảo mộc tắm bé ngăn ngừa rôm sảy, dưỡng da và tóc bé mềm mại Wonmom 120g ( 10 Túi/ Hộp )",61000,69000,8000,12
TIKI,do-choi-me-be,117499673,"Combo 4 Gói Khăn Ướt Bobby Care 100 Không Hương 100 Tờ",140000,140000,0,0
TIKI,do-choi-me-be,120355969,"FITOBIMBI D3K2 - BỔ SUNG VITAMIN D3 VÀ K2 HỖ TRỢ CHUYỂN HÓA VÀ HẤP THU TỐI ĐA CANXI VÀO XƯƠNG RĂNG GIÚP GIẢM NGUY CƠ CÒI XƯƠNG Ở TRẺ ",294000,294000,0,0
TIKI,do-choi-me-be,31165866,"Combo 2 hộp Sữa Bột Nutifood Enplus Gold (900g) – DD hàng ngày cho người trưởng thành",925000,925000,0,0
TIKI,do-choi-me-be,160416665,"Combo 3 Quần lót bầu cạp chéo nâng bụng cao cấp. Bộ 3 Quần lót cho bà bầu và sau sinh",129000,129000,0,0
TIKI,do-choi-me-be,180855730,"Bình Sữa Pigeon Softouch PP Plus Disney Baby - Màu Vàng",141000,234000,93000,40
TIKI,do-choi-me-be,191778316,"Vitamin tổng hợp cho bà bầu Pregnacare max hộp 84 viên",440000,440000,0,0
TIKI,do-choi-me-be,188136596,"Đồ chơi trẻ em: Xe ô tô mô hình hợp kim, xe đua công thức 1 DK81106. Kiểu dáng, mẫu xe, màu sắc ngẫu nhiên.",87500,125000,37500,30
TIKI,do-choi-me-be,9992700,"Máy bay trực thăng cảnh sát Alpha đồ chơi - Polesie Toys",170100,189000,18900,10
TIKI,do-choi-me-be,1391399,"Tranh xếp Hình Tia Sáng  Cung Kim Ngưu Tia Sáng (475 Mảnh Ghép)",72800,91000,18200,20
TIKI,do-choi-me-be,181462640,"Bộ chế biến ăn dặm kiểu Nhật Richell Nhật Bản | Baby",489927,489927,0,0
TIKI,do-choi-me-be,76441091,"Bộ Scrub Nghệ Tẩy Tế Bào Chết Và Dưỡng Trắng Da Mặt, Ngăn Ngừa Mụn Wonmom ( 1 Kem Nghệ Tươi + 1 Scrub Nghệ Tẩy Mặt )",304000,304000,0,0
TIKI,do-choi-me-be,104311506,"LEGO DUPLO 10954 Tàu lửa học đếm số (23 chi tiết)",799000,799000,0,0
TIKI,do-choi-me-be,76154489,"Combo Dưỡng Da Toàn Diện Cho Mẹ Sau Sinh Wonmom",455000,455000,0,0
TIKI,do-choi-me-be,3529137,"Sữa bột giúp tăng trưởng chiều cao cho trẻ từ 1-17 tuổi Gigo Opti Grow 900 Gr",241000,380000,139000,37
TIKI,do-choi-me-be,57487059,"NÚM VÚ THAY THẾ BÌNH SỮA CỔ RỘNG WESSER",106000,106000,0,0
TIKI,do-choi-me-be,73631553,"TPBVSK Special Kid Appetit+ Bổ sung các loại Vitamin và Khoáng chất - Hỗ trợ tiêu hóa tốt, giúp bé ăn ngon miệng (125ml)[Siro – Nhập khẩu Pháp]",234000,360000,126000,35
TIKI,do-choi-me-be,186232419,"Cháo Tươi Baby SG Food Lươn & Đậu Xanh 240G",25000,25000,0,0
TIKI,do-choi-me-be,13756033,"Bộ 4 tấm Thảm xốp lót sàn ECOBABY an toàn cho bé - hình Doraemon - kích thước 1 tấm 60x60cm, độ dày khoảng 0,9-1cm",155000,155000,0,0
TIKI,do-choi-me-be,19849661,"Bộ 4 tấm Thảm xốp lót sàn ECOBABY an toàn cho bé - hình cá - kích thước 1 tấm 60x60cm, độ dày khoảng 0,9-1cm",155000,155000,0,0
TIKI,do-choi-me-be,181503356,"Khăn Vải Khô đa năng Mama 320gr",55000,55000,0,0
TIKI,do-choi-me-be,196470341,"Balo Giữ Nhiệt Bỉm Sữa Mama’s Choice, Giữ Lạnh Sữa Mẹ Lên Đến 14h, Giữ Ấm Thức Ăn Cho Mẹ và Bé, Thiết Kế Thời Trang - Balo + 02 Đá Khô",700000,700000,0,0
TIKI,do-choi-me-be,68033772,"Combo 4 túi đá khô diệt khuẩn unimom tặng 5 zipper 15x20cm",140000,140000,0,0
TIKI,do-choi-me-be,128261405,"Siro Colosmulti Yến Sào hộp 20 ống x 10ml tăng cường sức đề kháng, bổ sung dưỡng chất",350000,350000,0,0
TIKI,do-choi-me-be,23377000,"Tranh xếp hình Tia Sáng Nôbita-Thám hiểm mặt trăng (48 Mảnh Ghép)-Tặng kèm câu đố mặt sau cho bé",25925,30500,4575,15
TIKI,do-choi-me-be,62736327,"Đồ Chơi Xếp Hình Thế Giới Thú Cưng 102 Chi Tiết",199000,199000,0,0
TIKI,do-choi-me-be,7251019,"Chất Chống Tắc Nghẽn W.C Bicro Phốt Siêu Tốc SiFa Victory's (700gr)",55000,55000,0,0
TIKI,do-choi-me-be,155061763,"Đồ chơi xe cảnh sát nhiều màu  và cứu thương  trắng NO. 8807 có nhạc và đèn chạy bánh đà vui nhộn",48000,48000,0,0
TIKI,do-choi-me-be,36373167,"Đồ chơi Khối quay lập phương Infinity Cube Vô Cực Thần Kỳ Legaxi",43000,43000,0,0
TIKI,do-choi-me-be,420825,"Kem Ngăn Ngừa Và Hỗ Trợ Điều Trị Rạn Da PALMER'S - 4035 (125g)",331500,390000,58500,15
TIKI,do-choi-me-be,105787345,"Đồ chơi lắp ghép trứng khủng long KAVY kèm vít,  quả trứng có súng bắn giúp bé sáng tạo khám phá thế giới",90000,90000,0,0
TIKI,do-choi-me-be,162165651,"Bình bóp ăn dặm silicon có thìa cho bé Marcus & Marcus, từ 6 tháng",158000,158000,0,0
TIKI,do-choi-me-be,85753062,"Sữa tắm hữu cơ cho mẹ bầu, dưỡng da body trắng mịn Wonmom 250ml",162000,180000,18000,10
TIKI,do-choi-me-be,10710902,"Sữa bột Vinamilk Dielac Alpha 4 - Hộp thiếc 1500g (dành cho trẻ 2-6 tuổi)",355000,355000,0,0
TIKI,do-choi-me-be,107990853,"b.box Disney Bình nước 360 độ cho bé tập uống nước 240ml - Winnie The Pooh",315000,315000,0,0
TIKI,do-choi-me-be,73636162,"TPBVSK Special Kid Vitamine D3 - Xương răng chắc khỏe, cơ thể cứng cáp (20ml) [Siro – Nhập khẩu Pháp]",234000,360000,126000,35
TIKI,do-choi-me-be,152473172,"Ghép hình xe công trường - Xe xúc, 9 chi tiết - DK81078",64500,86000,21500,25
TIKI,do-choi-me-be,192549746,"Combo 14 Gói Đủ Vị Cháo Tươi Dinh Dưỡng Cây Thị",304000,376500,72500,19
TIKI,do-choi-me-be,249178590,"Bình Ống Hút PPSU Wesser 260ml",260400,310000,49600,16
TIKI,do-choi-me-be,59301662,"Đặc Sản Phan Thiết - Nước Mắm Tĩn Trẻ Em Cho Bé Ăn Dặm Độ Đạm 42N Lốc 10 Chai Thủy Tinh Mini 60Ml Rin Nguyên Chất Truyền Thống Sạch",236000,350000,114000,33
TIKI,do-choi-me-be,116392962,"Bộ chữ cái, chữ số nam châm Mideer cho bé từ 3 tuổi trở lên học chữ cái nhận biết con vật và ghép từ đơn giản",159000,250000,91000,36
TIKI,do-choi-me-be,171731799,"FERROLIP BABY – SẮT HỮU CƠ NHỎ GIỌT NHẬP KHẨU CHÂU ÂU - 30ml DÀNH CHO BÉ TỪ SƠ SINH",295000,310000,15000,5
TIKI,do-choi-me-be,111657893,"Tả quần Babies Organic 46 miếng size XL (12-17kg)",245000,320000,75000,23
TIKI,do-choi-me-be,84119548,"Mùng chụp/Màn chụp Thái 75x115cm KACHOOBABY dành cho bé sơ sinh, tránh côn trùng và muỗi đốt, ngăn ngừa sốt xuất huyết",99000,123500,24500,20
TIKI,do-choi-me-be,171658611,"Combo 2 túi Nước giặt đồ sơ sinh với chiết xuất thảo mộc hữu cơ K-Mom Km13127 1300ml",347260,358000,10740,3
TIKI,do-choi-me-be,152447477,"Thảm xốp XPE cho bé dày 1,5cm của Umoo",497000,538900,41900,8
TIKI,do-choi-me-be,141678377,"Viên uống bổ sung dưỡng chất cho bé Healthy Care High Strength DHA 60 viên",508000,508000,0,0
TIKI,do-choi-me-be,44486305,"COMBO 3 HỘP SỮA BỘT DIELAC ALPHA 4 900G (CHO TRẺ TỪ 2- 6 TUỔI)",665000,665000,0,0
TIKI,do-choi-me-be,171816822,"Cháo Tươi Baby Sài Gòn Food Thịt Thăn Bằm & Bí Đỏ 240g",25000,25000,0,0
TIKI,do-choi-me-be,194965708,"Bình Nước Có Ống Hút Cho Bé Tập Uống Có Van Chống Sặc Hình Vương Niệm Cao Cấp 300ml Bằng Nhựa PP Chịu Nhiệt Tốt Có Tay Cầm Tiện Lợi - Hàng Loại 1 - Chính Hãng MINIIN",41160,58800,17640,30
TIKI,do-choi-me-be,2636349,"Tắm Gội Toàn Thân Kids Tím D-Nee Dành Cho Bé Trên 3 Tuổi (400ml)",105000,105000,0,0
TIKI,do-choi-me-be,125776722,"Quần lót bé gái set 5 chiếc, quần chíp bé gái kháng Khuẩn hàng xuất Hàn Quốc dành cho bé từ 3-10 tuổi 100% Cotton",87000,169000,82000,49
TIKI,do-choi-me-be,44885346,"Cờ Cá Ngựa - Đồ Chơi An Toàn Việt",85000,99000,14000,14
TIKI,do-choi-me-be,41399742,"BỘ 2 LON SỮA BỘT GROWPLUS+ DINH DƯỠNG HIỆU QUẢ GIÚP TRẺ TĂNG CÂN KHỎE MẠNH - LON 1.5KG",810000,810000,0,0
TIKI,do-choi-me-be,53596099,"Bộ Nước Rửa Bình Sữa + Dụng Cụ Vệ Sinh Bình Sữa Đa Năng Wesser",231570,249000,17430,7
TIKI,do-choi-me-be,183290489,"Xếp hình Tia Sáng Cái cò, cái vạc, cái nông (30 Mảnh Ghép) - Tặng kèm tranh tô màu cho bé",14450,17000,2550,15
TIKI,do-choi-me-be,109846714,"Nước muối sinh lý Physiodose (40 ống/hộp)",142500,150000,7500,5
TIKI,do-choi-me-be,183682627,"Xếp hình Tia Sáng Chuột , thỏ, sóc và nhím  (30 Mảnh Ghép) - Tặng kèm tranh tô màu cho bé",14450,17000,2550,15
TIKI,do-choi-me-be,86732441,"Tấm đệm lót CANNY siêu thấm hút 10 miếng/gói",54000,60000,6000,10
TIKI,do-choi-me-be,148637150,"Quần nỉ bầu thể thao 2 sọc trẻ trung năng động QB1289",102000,102000,0,0
TIKI,do-choi-me-be,152567926,"Bộ Đồ Chơi - Xe Cứu Hỏa Kết Hợp Ánh Sáng Và Âm Thanh DK832334",154000,220000,66000,30
TIKI,do-choi-me-be,4140123,"Dầu Mát-Xa Chiết Xuất Cám Gạo 0M+ Chicco (200ml)",334650,345000,10350,3
TIKI,do-choi-me-be,193524611,"Đồ chơi mô hình xe xúc ủ, cẩu ủi, móc gỗ và đục ủi KAVY-82 chạy đà có hộp chứa đồ các khớp chuyến động nhựa ABS an toàn",94000,94000,0,0
TIKI,do-choi-me-be,66127344,"Miếng Lót Thấm Sữa Mỏng Nhất Thế Giới NatureBond Dùng 1 Lần, Siêu Nhẹ, Siêu Mỏng "Vô Hình", Thấm Hút 40 Lần Trọng Lượng, Vật Liệu Polymer Nhật Bản Cao Cấp, An Toàn Cho Da Nhạy Cảm, Hộp 120 Tấm",469000,469000,0,0
TIKI,do-choi-me-be,2791797,"Sữa rửa mặt hữu cơ dưỡng ẩm da mịn màng, sạch mụn, trắng da Wonmon 70g",177000,177000,0,0
TIKI,do-choi-me-be,159484535,"Đồ chơi lắp ráp, xếp hình Qman 3206 – Tấn công xe tăng (430 mảnh ghép)",369000,489000,120000,25
TIKI,do-choi-me-be,145394086,"Lợi sữa Hi Mom Hapi- Sữa nhiều hơn, thơm hơn, đặc hơn, mát hơn, thông tắc tia sữa",320000,320000,0,0
TIKI,do-choi-me-be,8078844,"Tranh xếp Hình Tia Sáng Chớm Hè (247 Mảnh Ghép)",46400,58000,11600,20
TIKI,do-choi-me-be,103264893,"Đồ chơi gỗ Cân bập bênh | Winwintoys 61072 | Phát triển tư duy và sự khéo léo | Đạt chứng nhận CE và CR",99000,99000,0,0
TIKI,do-choi-me-be,74844895,"Đồ chơi mô hình xe cứu hỏa thang gập KAVY chất liệu hợp kim và nhựa an toàn , chạy đà rất xa chi tiết sắc sảo",82000,82000,0,0
TIKI,do-choi-me-be,52529755,"Combo 2 Chai Dầu gội và xả Bubchen Rosalea công chúa (2 in 1) 230ml",229000,229000,0,0
TIKI,do-choi-me-be,125342060,"Đồ Chơi PLAYDOH Hộp Bột Nặn Playdoh Màu Vàng Đậm DAM/B5517C/YE",29000,29000,0,0
TIKI,do-choi-me-be,82478887,"Búp Bê Emily - Người Mẫu Thời Trang DK81033 - Màu Ngẫu Nhiên",154000,220000,66000,30
TIKI,do-choi-me-be,57160258,"Bộ Tarot Angel Answers Oracle Cards Bài Bói New",149000,149000,0,0
TIKI,do-choi-me-be,73090758,"Chai Tẩy Rửa Sen Vòi Nhà Tắm Sáng Bóng Như Mới SABO-I Loại 100ml. Tẩy vết đốm trắng, mảng bám cặn canxi trên vòi hoa sen, làm sáng bóng thiết bị nhà tắm như mới",59000,59000,0,0
TIKI,do-choi-me-be,13752496,"Bộ 4 tấm Thảm xốp lót sàn an toàn Thoại Tân Thành hình thú Disney (60x60cm)",155000,155000,0,0
TIKI,do-choi-me-be,86284266,"Bộ dưỡng trắng hồng da mặt và sáng da body Wonmom ( 1 kem nghệ tươi + 1 cốt n.ghệ hạ thổ)",440000,525000,85000,16
TIKI,do-choi-me-be,58078050,"Phao Bơi Trẻ Em xỏ chân Sportslink - Hình Con Vịt",77000,102000,25000,25
TIKI,do-choi-me-be,948855,"Bàn Chải Đánh Răng Hình Con Voi Dr.Brown's HG014 - Xanh",149000,149000,0,0
TIKI,do-choi-me-be,104267769,"Đồ Chơi VECTO Lắp Ráp Diy - Xe Tăng VT1073",199000,199000,0,0
TIKI,do-choi-me-be,111708907,"Sữa bột Fortimel Vanilla 335g",504000,504000,0,0
TIKI,do-choi-me-be,181462727,"Bộ khay trữ đông thức ăn dặm Richell",126655,126655,0,0
TIKI,do-choi-me-be,71903177,"Son dưỡng mềm môi trẻ em Chuchu baby",137000,137000,0,0
TIKI,do-choi-me-be,32226049,"Bộ Rút Thanh Gỗ Hollie Wood",143200,191000,47800,25
TIKI,do-choi-me-be,23376970,"Xếp hình Tia Sáng Doremon (48 Mảnh Ghép) - Tặng kèm câu đố mặt sau cho bé",25925,30500,4575,15
TIKI,do-choi-me-be,214658624,"Sữa non ho trẻ sơ sinh từ 0 -12 tháng Ildong Hàn giúp trẻ phát triển trí não, xương, răng, tăng sức đề kháng, tiêu hóa tốt - Massel Official",350000,700000,350000,50
TIKI,do-choi-me-be,12745030,"Cọ rửa bình sữa và núm ty Tommee Tippee Closer to Nature",245000,245000,0,0
TIKI,do-choi-me-be,37550814,"Bộ Đồ Chơi Máy Tính Tiền Màu Hồng, Hiển Thị Màn Hình, Có Đèn Báo Và Âm Thanh",196000,280000,84000,30
TIKI,do-choi-me-be,31260536,"Combo 3 khăn tắm sơ sinh in hình 2 Lớp sợi mịn Baby Bear túi 1 cái 75x95 cm",156000,156000,0,0
TIKI,do-choi-me-be,120380401,"Bộ 1 chai nước rửa bình sữa + 1 gói nước rửa bình sữa",187200,208000,20800,10
TIKI,do-choi-me-be,755383,"Bàn Cá Ngựa Lớn Có Cờ Liên Hiệp Thành BCNLCC",136000,136000,0,0
TIKI,do-choi-me-be,8078857,"Tranh xếp Hình Tia Sáng Bến Nước (247 Mảnh Ghép)",46400,58000,11600,20
TIKI,do-choi-me-be,181809483,"Bộ Bài Drinking Game - Tới Bến",92600,109000,16400,15
TIKI,do-choi-me-be,75946164,"Đồ chơi giáo dục STEM: Bộ robot lập trình Makeblock mBot cho trẻ từ 8 tuổi",2565000,2700000,135000,5
TIKI,do-choi-me-be,133630224,"KEM ĐA NĂNG CHỐNG MUỖI CHO BÉ CHICCO 100ML",309000,309000,0,0
TIKI,do-choi-me-be,32183115,"Combo 6 gói Khăn giấy ướt cho trẻ sơ sinh HUGGIES (Gói 72 tờ) - Chiết xuất Cao cao & Bơ hạt mỡ",210000,210000,0,0
TIKI,do-choi-me-be,96631170,"COLOSBABY BIO GOLD 2+ 800g hỗ trợ tiêu hóa tốt, miễn dịch khỏe cho bé - VitaDairy",546382,546382,0,0
TIKI,do-choi-me-be,183683954,"Xếp hình Tia Sáng Hổ (30 Mảnh Ghép) - Tặng kèm tranh tô màu cho bé",14450,17000,2550,15
TIKI,do-choi-me-be,271542128,"Sữa cho trẻ sơ sinh 0-1 tuổi Meiji Nhật giàu dưỡng chất kèm DHA giúp phát triển cân đối chiều cao, cân nặng, trí não cho bé - Massel Official",704000,1408000,704000,50
TIKI,do-choi-me-be,76757031,"Dầu Tràm Bảo Nhiên 50ml",105000,105000,0,0
TIKI,do-choi-me-be,179226361,"Đồ Chơi LEGO TECHNIC Xe Mô Tô Độ 42132 (163 chi tiết)",283730,308000,24270,8
TIKI,do-choi-me-be,96111197,"Nút Bịt Ổ Điện An Toàn, nhựa ABS cao cấp, có Móc Kéo (Bộ 10 cái). Nút chặn ổ cắm điện loại 2 chân 3 chân cao cấp chống giật nhỏ gọn chắc chắn bảo vệ an toàn cho bé",25000,25000,0,0
TIKI,do-choi-me-be,23377008,"Xếp hình Tia Sáng Hà mã   (30 Mảnh Ghép) - Tặng kèm tranh tô màu cho bé",14450,17000,2550,15
TIKI,do-choi-me-be,97008257," Sữa tắm trẻ em Arau baby túi 400ml (new)",112230,129000,16770,13
TIKI,do-choi-me-be,177924855,"Kem Bôi Panthenol Compliment Hỗ Trợ Bôi Bỏng,Dưỡng Phục Hồi Da Bị Tổn Thương Tuýp 75ml",67000,70000,3000,4
TIKI,do-choi-me-be,74277318,"Nui Rau Củ Hữu Cơ Cho Bé Hình Sao 200g Dalla Costa ",79000,79000,0,0
TIKI,do-choi-me-be,13408672,"Mô Hình Xe KTM 1290 Super Duke Orange 1:12 Maisto MH-31101(20-13065)",289000,289000,0,0
TIKI,do-choi-me-be,2812811,"Xe 3 Bánh Nhựa Chợ Lớn L7 Con Cows (Không Nhạc) - M1307A-X3B",366000,366000,0,0
TIKI,do-choi-me-be,54014702,"Đồ Chơi Lúc Lắc Cho Trẻ Happy Baby - Chuông Mặt Trời ( Màu Ngẫu Nhiên)",25200,36000,10800,30
TIKI,do-choi-me-be,40960128,"Combo 1 kem đa năng xua muỗi Chicco + 1 lăn bôi vết muỗi đốt, côn trùng cắn Chicco",551930,569000,17070,3
TIKI,do-choi-me-be,110103463,"Túi Nhai BEREX Ăn Dặm Cho Bé",59000,59000,0,0
TIKI,do-choi-me-be,95013504,"Kem multi 16 hũ to 30g  athena giảm rạn thâm cam kết hiệu quả cao",229000,229000,0,0
TIKI,do-choi-me-be,4140051,"Xịt đa năng xua muỗi Chicco 100ml ",309430,319000,9570,3
TIKI,do-choi-me-be,1728331,"Combo 2 Núm Ty Rời Comotomo Size 3 dành cho bé từ 6 tháng",266750,275000,8250,3
TIKI,do-choi-me-be,32226000,"Trò Chơi Rút Thanh Số (Đồ Chơi Gỗ)",255800,328000,72200,22
TIKI,do-choi-me-be,2563679,"Bột Ăn Dặm Vinamilk Ridielac Gà Rau Củ Hộp (200g)",62000,62000,0,0
TIKI,do-choi-me-be,1030567,"Khăn Giấy Ướt Không Mùi Kháng Khuẩn An Toàn Cho Bé Mamamy Mm0334 (100 Tờ) - Xanh",45200,45200,0,0
TIKI,do-choi-me-be,20576395,"(Mua 3 tặng 1) Combo 3 Khăn Ướt K-mom KM13110 (100 Cái) - Mẫu Ngẫu Nhiên",201663,207900,6237,3
TIKI,do-choi-me-be,129742461,"Cốc hứng sữa Gen.1 100ml Haakaa. Chất liệu silicone cao cấp, an toàn. Không chứa BPA, PVC và phthalate. Hút sữa, hứng sữa rảnh tay",319000,399000,80000,20
TIKI,do-choi-me-be,32226453,"Bộ Chữ Số Nam Châm Anto95",48600,57000,8400,15
TIKI,do-choi-me-be,71358433,"Bộ 8 hộp trữ đông đồ ăn dặm nắp dẻo mini 100ml tặng 2 túi zipper 12cm",74000,74000,0,0
TIKI,do-choi-me-be,173674458,"Bộ Xếp Hình Khổ A4 Puzzle Minh Châu 35-09 - Safari (35 Mảnh Ghép)",17500,19500,2000,10
TIKI,do-choi-me-be,41178423,"Bộ 5 Lon Sữa Bột Nutifood Enplus Gold - Dành cho người cao tuổi, người bệnh, người ăn uống kém (900g)",2299000,2299000,0,0
TIKI,do-choi-me-be,71959282,"Vita gummies multi vitamin for fussy eaters kích thích ăn ngon, hỗ trợ tiêu hóa cho trẻ",310000,310000,0,0
TIKI,do-choi-me-be,12197457,"Xe 3 Bánh Nhựa Chợ Lớn L7 Con Thỏ (Không Nhạc) - M1060A-X3B",366000,366000,0,0
TIKI,do-choi-me-be,111857869,"Combo 2 Nước Giặt Arau Baby Bình 800ml + 2 Túi 720ml ",598000,598000,0,0
TIKI,do-choi-me-be,17490231,"Khăn vải khô đa năng cuộn nhỏ LIKADO ",88000,88000,0,0
TIKI,do-choi-me-be,629985,"Nước Rơ Lưỡi Wesser (80g)",158000,158000,0,0
TIKI,do-choi-me-be,80855064,"ta quan yubest angel size l 60mieng",250000,250000,0,0
TIKI,do-choi-me-be,52248204,"Bộ cây vệ sinh bình sữa và núm vú McGOLDSON",66000,66000,0,0
TIKI,do-choi-me-be,54510164,"Sữa bột ColosCare 1+ 800g - Sữa non tăng cường miễn dịch của NutriCare",370000,370000,0,0
TIKI,do-choi-me-be,73232996,"Ghép hình đoàn tàu chữ cái - 62 chi tiết",270000,450000,180000,40
TIKI,do-choi-me-be,23377006,"Xếp hình Tia Sáng Dê và thỏ  (30 Mảnh Ghép) - Tặng kèm tranh tô màu cho bé",14450,17000,2550,15
TIKI,do-choi-me-be,183718676,"Xếp hình Tia Sáng Muôn thú quy tụ  (30 Mảnh Ghép) - Tặng kèm tranh tô màu cho bé",14450,17000,2550,15
TIKI,do-choi-me-be,57777522,"COMBO 6 GIẤY VỆ SINH CUỘN LỚN DALIN 700G TIẾT KIỆM",336000,336000,0,0
TIKI,do-choi-me-be,63160503,"Sách vải song ngữ Anh-Việt: " Đuôi mình đâu ? " (PiPô Việt Nam )",75000,75000,0,0
TIKI,do-choi-me-be,155156962,"COMBO LỀU VÀ NỒI XÔNG 4L DUNG TÍCH LỚN HÀNG CHÍNH HÃNG",739000,739000,0,0
TIKI,do-choi-me-be,2791825,"Dầu tràm nguyên chất, ngăn ngừa ho, cảm cho bé và người lớn Wonmom 15ml",88000,99000,11000,11
TIKI,do-choi-me-be,9999837,"Xe môi trường xử lý rác đồ chơi - Wader Toys",215100,239000,23900,10
TIKI,do-choi-me-be,54749091,"Ghế Nhà Tắm Notoro Nhật Bản Dành cho Mẹ Và Bé - Nhựa Cao Cấp Chắc Chắn - giao màu ngẫu nhiên",83000,83000,0,0
TIKI,do-choi-me-be,75378409,"Đồ chơi LEGO Creator Expert Bó Hoa 10280",1799000,1799000,0,0
TIKI,do-choi-me-be,108914349,"Đồ chơi Đường trượt bi lăn Migoga-Basic QUERCETTI 6535",479200,599000,119800,20
TIKI,do-choi-me-be,173249366,"Thùng sữa bột pha sẵn Oggi suy dinh dưỡng 180ml (Thùng 48 hộp)",455000,455000,0,0
TIKI,do-choi-me-be,183719313,"Xếp hình Tia Sáng  Đại dương muôn màu (30 Mảnh Ghép) - Tặng kèm tranh tô màu cho bé",14450,17000,2550,15
TIKI,do-choi-me-be,25767856,"Combo 2 Gói Tã Quần Cao Cấp Moony Nhật Bản Bé Trai XXL26 (26 Miếng)",560000,575000,15000,3
TIKI,do-choi-me-be,124198558,"Tã/bỉm quần Molfix Thiên nhiên Jumbo L (9kg - 13kg) - Gói 36+6 miếng",265000,265000,0,0
TIKI,do-choi-me-be,413234,"Sữa Bầu Enfamama A+ (400g) - Hương Choco",238000,281400,43400,15
TIKI,do-choi-me-be,177633830,"LEGO ADULTS 10311 Hoa Lan LEGO (608 chi tiết)",1599000,1599000,0,0
TIKI,do-choi-me-be,4615695,"Sữa Bột Dinh Dưỡng Meiji Số 0 dành Cho Bé Từ 0-1 Tuổi (Dạng lon)",569455,569455,0,0
TIKI,do-choi-me-be,112251496,"Bột ăn dặm tốt cho bé Nutricare Metacare 4 gói vị mặn (200g)",66224,66224,0,0
TIKI,do-choi-me-be,146262142,"Thùng sữa tươi Nutricare Meta Fresh Ít Đường sữa non tăng cường miễn dịch",274340,274340,0,0
TIKI,do-choi-me-be,168543530,"Bộ Đồ Chơi Lắp Ráp Xe Tăng Điều Khiển Từ Xa, Đồ Chơi Gỗ Cao Cấp Mô Hình Xe Tăng Điều Khiển Từ Xa, Bộ Đồ Chơi Lắp Ghép Vật Lý Khoa Học Tự Làm DIY Wood Steam - Chính Hãng BABYBOSS",195000,250000,55000,22
TIKI,do-choi-me-be,49559479,"Cờ Vua Thủy Tinh - Bộ Cờ Vua Cao Cấp",230000,250000,20000,8
TIKI,do-choi-me-be,7344615,"Sữa bột Vinamilk Dielac MaMa Gold hương Vani lon 900g",245000,245000,0,0
TIKI,do-choi-me-be,68114004,"Giỏ đựng đồ đi sinh bằng nhựa cao cấp quai giữa có nắp đậy NACHI INOCHI Nhật Bản - Nhiều Màu - ( D x R x C ) tương ứng ( 463 x 320 x 311 ) mm",75000,75000,0,0
TIKI,do-choi-me-be,54914259,"GẤU BÔNG ÔM TRÁI BƠ TRÒN CỰC CUTE 3 SIZE",99000,99000,0,0
TIKI,do-choi-me-be,10907761,"Thùng sữa nước Nutricare Metacare ECO - phát triển toàn diện cho trẻ từ 1 tuổi (180ml x 48 hộp)",390000,390000,0,0
TIKI,do-choi-me-be,117614008,"Thùng sữa nước trái cây Smarta Grow (vị cam) giúp trẻ tăng trưởng chiều cao, phát triển não bộ, dinh dưỡng cho trẻ thấp còi (48 hộp x 110ml)",224620,224620,0,0
TIKI,do-choi-me-be,50083460,"Bột làm sạch lồng máy giặt Rocket 120g",45000,45000,0,0
TIKI,do-choi-me-be,54714169,"Máy Tiệt Trùng Sấy Khô bằng tia Fatzbaby UV Super 2 FB4706SL",2167950,2235000,67050,3
TIKI,do-choi-me-be,23047544,"Bột Ăn Dặm Vinamilk Ridielac Gold Gạo Trái Cây (200g / Hộp Giấy)",57000,57000,0,0
TIKI,do-choi-me-be,154703358,"Xe đẩy gấp gọn cho bé Mastela HN-275 - Xe đẩy em bé sơ sinh cao cấp với tay kéo du lịch tiện lợi và khung aluminium siêu bền bảo hành 12 tháng",2749000,2749000,0,0
TIKI,do-choi-me-be,129665765,"TÃ QUẦN NGƯỜI GIÀ CARYN SIZE L14 MIẾNG",189000,189000,0,0
TIKI,do-choi-me-be,124116872,"Miếng lót sơ sinh Molfix Thiên nhiên Jumbo Newborn 1 (dưới 1 tháng tuổi) - Gói 64+10 miếng ",105000,105000,0,0
TIKI,do-choi-me-be,119706872,"Sữa dưỡng thể dịu lành cho bé Cetaphil Baby Daily Lotion 400ml",293000,293000,0,0
TIKI,do-choi-me-be,84284189,"Sữa Oggi Gold 900g - Dành cho trẻ suy dinh dưỡng, thấp còi",319000,319000,0,0
TIKI,do-choi-me-be,191435985,"Bài Tarot - Bài Bói The Rider Tarot Deck, Bài Tarot Kèm Túi Đựng Bài – Bài Bói Tarot Chính Hãng dododios",140000,140000,0,0
TIKI,do-choi-me-be,179176066,"Sữa bột Vitadairy Colos Gain 1+ 800g từ 1 đến 10 tuổi",348000,348000,0,0
TIKI,do-choi-me-be,183893542,"Bỉm - Tã Quần Moony Blue (bé trai) size XXL 26 miếng (Cho bé 13-28kg)",279900,284890,4990,2
TIKI,do-choi-me-be,101365677,"[ HỘP DÙNG THỬ] Sữa non Colosmulti A0 hộp 2 gói x 14g hỗ trợ tăng cường sức đề kháng cho trẻ",139000,139000,0,0
TIKI,do-choi-me-be,201088392,"Dầu húng chanh lên men Minion gold 30ml tăng đề kháng, giảm ho, khò khè",259000,259000,0,0
TIKI,do-choi-me-be,124205620,"Tã/bỉm quần Molfix Thiên nhiên Jumbo XXL (15kg - 25kg) - Gói 28+6 miếng",265000,265000,0,0
TIKI,do-choi-me-be,45264663,"Sữa tắm gội toàn thân Aveeno baby 236ml - 101016746",270001,270001,0,0
TIKI,do-choi-me-be,110572178,"Máy tiệt trùng bình sữa và sấy khô Philips Avent Starlight plus 293.00",3495000,3495000,0,0
TIKI,do-choi-me-be,78497267,"Đồ chơi mô hình xe tải hàng rào KAVY No.8807 nhựa an toàn chi tiết đẹp",74000,74000,0,0
TIKI,do-choi-me-be,272374630,"Vitamin tổng hợp cho trẻ Brauer Multivitamin Úc hỗ trợ trẻ phát triển cân đối, tăng sức đề kháng, giảm biếng ăn, giúp trẻ ngủ ngon - OZ Slim Store",497000,994000,497000,50
TIKI,do-choi-me-be,115288813,"Đồ Chơi Lắp Ráp Robot Lau Nhà, Đồ Chơi Gỗ Xe Oto Quét Dọn, Đồ Chơi Khoa Học Tự Làm J-50 DIY Wood Steam - Chính Hãng BABYBOSS + Tặng Kèm 01 Tranh Ghép Bằng Gỗ",69000,85000,16000,19
TIKI,do-choi-me-be,57349343,"Combo 10 Gói Cháo Tươi Cây Thị: 2 Gà Ác Đậu Xanh, 2 Thịt Bò, 2 Thịt Heo, 1 Cá Hồi, 1 Cá Lóc, 1 Lươn Đậu Xanh, 1 Rau Củ",191000,240000,49000,20
TIKI,do-choi-me-be,76146927,"Xe Tập Đi Nhựa Chợ Lớn L3 Con Vịt Dành Cho Bé Từ 6 - 12 Tháng (Không nhạc) - M1441A-XTĐ",345000,345000,0,0
TIKI,do-choi-me-be,141317652,"Lều xông hơi và nồi xông hơi toàn thân hàng chính hãng",539000,539000,0,0
TIKI,do-choi-me-be,76288040,"Đồ chơi mô hình xe cứu hỏa KAVY xe tải bơm chữa cháy, xe nâng chở người trên cao chi tiết sắc sảo các khớp chuyển động, bền bỉ vô cùng",73000,73000,0,0
TIKI,do-choi-me-be,9692313,"Siro bổ máu Pediakid Fer + Vitamines B cho bé, bổ sung sắt, vitamin nhóm B (125ml)",285000,356250,71250,20
TIKI,do-choi-me-be,13408541,"Mô Hình Xe Lamborghini Aventador Lp700-4 Orange 1:24 Maisto MH-31210",399000,399000,0,0
TIKI,do-choi-me-be,108851500,"Bình sữa thủy tinh  mô phỏng tự nhiên hiệu Philips Avent (240ml - đơn) cho trẻ từ 1 tháng tuổi 673.13",455000,455000,0,0
TIKI,do-choi-me-be,73437628,"Cọ rửa bình sữa siêu bền Munchkin tự đứng tặng 2 zipper 12cm",95000,109000,14000,13
TIKI,do-choi-me-be,42688734,"BỘ 2 LON SỮA BỘT NGUYÊN KEM CÓ ĐƯỜNG VINAMILK DINH DƯỠNG - 900G",405000,405000,0,0
TIKI,do-choi-me-be,76273573,"Bộ đồ chơi xếp hình KAVY tàu tuần tra với 1005 chi tiết nhiều tạo hình nhân vật khác nhau nhựa ABS an toàn",410000,410000,0,0
TIKI,do-choi-me-be,55576262,"Combo 7 Vị Cháo Tươi Dinh Dưỡng Cây Thị",140505,168500,27995,17
TIKI,do-choi-me-be,89159744,"Túi Trữ Sữa Unimom 210ml 60 Túi BPA Free, Hai Lớp Chắc Chắn, Khóa Zipper",32900,32900,0,0
TIKI,do-choi-me-be,198651014,"Cổ Nối Phễu Maymom Myfit Loại Cổ Hẹp, Tương Thích Phễu Hút Sữa Medela, Pumpin, Lacteck, Mini Pum, Pumpa, Silicon",90000,90000,0,0
TIKI,do-choi-me-be,69313632,"Váy đầm bé gái ️Đầm xanh Ngọc hoa dải cho bé gái",151000,170000,19000,11
TIKI,do-choi-me-be,188895424,"Nước Rửa Bình Sữa Pigeon Hương Yuzu (New 2022)",86000,95000,9000,9
TIKI,do-choi-me-be,112082703,"Đồ chơi xe quán tính có nhạc và đèn KAVY NO8808 gồm 4 xe taxi, cứu thương, cứu hỏa, cảnh sát",190000,190000,0,0
TIKI,do-choi-me-be,4140057,"Lăn Bôi Vết Muỗi Đốt, Côn Trùng Cắn Chicco",238280,259000,20720,8
TIKI,do-choi-me-be,36279696,"Cao chè vằng lợi sữa dành cho mẹ",96000,96000,0,0
TIKI,do-choi-me-be,191751948,"Bộ Đồ Chơi Đất Sét 21 Chi Tiết Chủ Đề Máy Làm Kem - Ice Cream Maker Color Dough Set Bowa 8739",229000,229000,0,0
TIKI,do-choi-me-be,183291103,"Sữa Bột Vinamilk Dielac Alpha Gold IQ Step 2 - Hộp Thiếc 800g",335000,335000,0,0
TIKI,do-choi-me-be,44142535,"NHIỆT KẾ HỒNG NGOẠI FR1MF1",835000,835000,0,0
TIKI,do-choi-me-be,98674846,"Dây đeo tay dắt trẻ đi dạo chống lạc an toàn bé dài 3 mét có khóa an toàn",189999,189999,0,0
TIKI,do-choi-me-be,1030589,"Bọt Tắm Gội (Sữa Tắm Gội) Thiên Nhiên Siêu Kháng Khuẩn An Toàn Cho Bé Mamamy Hương Fancy (400ml)",114000,114000,0,0
TIKI,do-choi-me-be,124163581,"Tã/bỉm dán Molfix Thiên nhiên Jumbo S (4kg - 8kg) - Gói 60 miếng",175000,225000,50000,22
TIKI,do-choi-me-be,44234938,"Ghế ăn dặm Umoo Hàn Quốc 2 nấc điều chỉnh độ cao, thiết kế chắc chắn",581000,777600,196600,25
TIKI,do-choi-me-be,115695017,"Đồ chơi lắp ráp xếp hình cứu hỏa Qman 2807 – Ô TÔ CỨU HỎA (366 mảnh ghép) dành cho bé trai trên 6 tuổi",359000,359000,0,0
TIKI,do-choi-me-be,150509379,"LEGO City 60312 Xe cảnh sát (94 chi tiết)",299000,299000,0,0
TIKI,do-choi-me-be,190621545,"Đồ Chơi BEYBLADE Con Quay B-160 Booster King Helios.Zn 1B 157199",349000,349000,0,0
TIKI,do-choi-me-be,16554662,"Sữa bột Nutricare MetaMom ít ngọt hỗ trợ giảm béo chăm sóc toàn diện cho mẹ bầu & cho con bú (900g)",349000,388000,39000,10
TIKI,do-choi-me-be,68357153,"Combo 6 Gói Khăn Uớt Aiko Hồng Không Mùi 100 Tờ/gói",175000,175000,0,0
TIKI,do-choi-me-be,46475999,"Đồ Chơi Gỗ Con Quay Gỗ Nhiều Màu",35000,50000,15000,30
TIKI,do-choi-me-be,9992395,"Máy bay trực thăng cứu thương Alpha đồ chơi - Polesie Toys",170100,189000,18900,10
TIKI,do-choi-me-be,14348194,"Tinh bột nghệ đỏ An Bình",350000,350000,0,0
TIKI,do-choi-me-be,100196769,"Xếp Hình Nam Châm Thả Bi Magnetic Blocks - KUB",709000,709000,0,0
TIKI,do-choi-me-be,58561715,"Bộ Đồ Chơi Lắp Ghép STEM Robot Đi Bộ J-12 Bằng Gỗ. Đồ Chơi Thí Nghiệm Cho Bé + Tặng Kèm 1 Tranh Ghép Bằng Gỗ",70000,100000,30000,30
TIKI,do-choi-me-be,36349281,"Cờ Tỉ Phú MoNoPoLy Vui Nhộn cho bé - Hàng Việt Nam SATO có hướng dẫn tiếng việt Bibebo",61000,77000,16000,21
TIKI,do-choi-me-be,176892852,"Bột ăn dặm Ridielac Gold lươn cà rốt đậu xanh hộp 200g (7 - 24 tháng)",65000,65000,0,0
TIKI,do-choi-me-be,112231678,"Bột ăn dặm tốt cho bé Nutricare Metacare Gạo trái cây nhiệt đới & olive (200g)",57829,57829,0,0
TIKI,do-choi-me-be,71080140,"Sure Prevent Gold HT 400g",295000,295000,0,0
TIKI,do-choi-me-be,109787975,"Hộp Chia Sữa 4 Ngăn Kuku Ku5305",76000,76000,0,0
TIKI,do-choi-me-be,70832716,"Combo 8 Gói Khăn Ướt AGI Không Mùi Hình Vịt Vàng (100 tờ x 8 gói)",292000,292000,0,0
TIKI,do-choi-me-be,101852772,"Thùng sữa pha sẵn Nuvi Grow 180ml - Dinh dưỡng tối ưu chiều cao, thông minh, khoẻ mạnh cho bé trên 1 tuổi",535000,535000,0,0
TIKI,do-choi-me-be,24449700,"Nước rửa bình sữa D-nee Organic túi 550ml",59000,59000,0,0
TIKI,do-choi-me-be,3229211,"Tã quần Moony XL38 cho bé gái (38 miếng)",279900,284500,4600,2
TIKI,do-choi-me-be,89910999,"Bộ Dung Dịch Vệ Sinh Phụ Nữ Lactacyd Odor Fresh Ngăn Mùi 24H 250ml + Sữa Tắm Gội Trẻ em Lactacyd Baby Extra Milky 500ml",259000,281000,22000,8
TIKI,do-choi-me-be,74281446,"Nui Rau Củ Hữu Cơ Cho Bé Hình Tàu Xe 250g Dalla Costa",95000,95000,0,0
TIKI,do-choi-me-be,194960093,"Tai Nghe Nhạc Bà Bầu BellySmart",360000,720000,360000,50
TIKI,do-choi-me-be,130730098,"Nước tắm thảo dược cho Mẹ sau sinh Dao'Spa Mama (hộp 3 chai)",350000,350000,0,0
TIKI,do-choi-me-be,161383388,"Đồ Chơi PLAY-DOH Hộp Bột Nặn Màu Tím Đậm DAM/B5517C/PP",29000,29000,0,0
TIKI,do-choi-me-be,561679,"Tã dán Bobby Sơ Sinh Siêu Mỏng Thấm Gói Đại S56(56 Miếng)",190000,190000,0,0
TIKI,do-choi-me-be,31840721,"Bộ 5 siêu xe Hot Wheels 1806H - Giao hàng ngẫu nhiên",339000,339000,0,0
TIKI,do-choi-me-be,848994,"Tã Dán Huggies Dry Gói Cực Đại XL62 (62 Miếng) - Bao Bì Mới",305000,305000,0,0
TIKI,do-choi-me-be,74891873,"Bộ đồ chơi lắp ghép đường ray tàu cao tốc KAVY gồm nhiều chi tiết như hầm chui, cầu vượt, nhà cửa, biển báo..",645000,645000,0,0
TIKI,do-choi-me-be,113459535,"Tấm lót chống thấm cho bé thay tã 4 lớp vải sợi tre Bamboo cao cấp  kháng khuẩn và thoáng khí Comfybaby PAD",179000,179000,0,0
TIKI,do-choi-me-be,53097253,"Siro Tăng Đề Kháng Brauer Immunity 100 Ml.",379000,758000,379000,50
TIKI,do-choi-me-be,56960223,"Ostelin Vitamin D3 nhỏ giọt cho bé vị dâu chính hãng từ Úc",168000,210000,42000,20
TIKI,do-choi-me-be,16166568,"Siro Ho cho bé Doppelherz Aktiv Kinder Thymepect Cough Syrup (Chai 100ml)",216000,216000,0,0
TIKI,do-choi-me-be,160072776,"Đồ chơi hướng nghiệp - Bộ trống Jazz Drum cho bé Toyshouse - Nhạc cụ, âm nhạc cho bé yêu - màu xanh",109000,109000,0,0
TIKI,do-choi-me-be,23705407,"Sữa non COLOSBABY GOLD 1+ (800G)",465000,465000,0,0
TIKI,do-choi-me-be,57742525,"Máy hút mũi cho bé Moaz bebe MB010",820000,820000,0,0
TIKI,do-choi-me-be,399545,"Xe Buýt 2 Tầng Siku - 1321",107100,119000,11900,10
TIKI,do-choi-me-be,74769756,"Đồ chơi mô hình xe tải chở đá KAVY NO.8809 chất liệu hợp kim và nhựa nguyên sinh an toàn, chi tiết sắc sảo",68000,68000,0,0
TIKI,do-choi-me-be,176050461,"COMBO (10 bịch/ 100 cuộn) Giấy vệ sinh Ero giá sỉ chất lượng (10 cuộn/ bịch)",170000,240000,70000,29
TIKI,do-choi-me-be,22784987,"COMBO 48 HỘP SỮA BỘT PHA SẴN DIELAC GROW PLUS 110ML",370000,370000,0,0
TIKI,do-choi-me-be,46911328,"Sữa bột Calokid Gold 2+ 900g",430000,430000,0,0
TIKI,do-choi-me-be,249050890,"Bình sữa cổ rộng PP Wesser 180ml/260ml",134390,151000,16610,11
TIKI,do-choi-me-be,190621616,"Đồ Chơi BEYBLADE Con Quay B-161 Booster Glide Ragnaruk.Wh.R 1S 157205",349000,349000,0,0
TIKI,do-choi-me-be,119706880,"Sữa tắm gội dịu lành cho bé Cetaphil Baby Wash & Shampoo with Organic Calendula 230ml",210000,210000,0,0
TIKI,do-choi-me-be,13408683,"Mô Hình Xe Kawasaki Ninja H2R Black 1:12 Maisto MH-31101-14",289000,289000,0,0
TIKI,do-choi-me-be,55348868,"Đồ chơi lắp ráp trẻ em bằng nhựa ABS an toàn -Tàu chiến MECH và SIEU ROBOT BẢO VỆ TRÁI ĐẤT-  ",399000,399000,0,0
TIKI,do-choi-me-be,129665669,"TÃ QUẦN NGƯỜI GIÀ CARYN SIZE XL12 MIẾNG",189000,189000,0,0
TIKI,do-choi-me-be,195668186,"Dép Eva Bé Trai Biti's DEB009200DEN (Đen)",113000,125000,12000,10
TIKI,do-choi-me-be,57477357,"BÌNH SỮA CỔ RỘNG WESSER PPSU CAO CẤP",255000,255000,0,0
TIKI,do-choi-me-be,76145613,"Xe Đạp Trẻ Em Nhựa Chợ Lớn K88",981000,981000,0,0
TIKI,do-choi-me-be,73631992,"TPBVSK Special Kid Calcium Vitamin D - Bổ sung Canxi và Vitamin D giúp xương, răng chắc khỏe - Giúp con cao lớn hơn (125ml) [Siro – Nhập khẩu Pháp]",234000,360000,126000,35
TIKI,do-choi-me-be,70857839,"Bộ Thẻ Bài Pokemon 60 Thẻ Cao Cấp Nhiều Loại",89000,89000,0,0
TIKI,do-choi-me-be,95183378,"Sữa Blackmores Toddler số 3 900g (Trên 12 tháng)",669000,669000,0,0
TIKI,do-choi-me-be,74878916,"Bộ đồ chơi nhà bếp nấu ăn KAVY kèm vali kéo tiện lợi nhựa nguyên sinh an toàn, chi tiết sinh động, màu sắc trực quan",160000,160000,0,0
TIKI,do-choi-me-be,14242540,"Máy đưa võng Fujishi không kèm bộ nguồn  - hàng chính hãng",250000,250000,0,0
TIKI,do-choi-me-be,159385134,"Xe Thăng Bằng Cho Bé Từ 2-4 Tuổi - KUB",998000,998000,0,0
TIKI,do-choi-me-be,74906848,"Bộ đồ chơi lắp ghép xe thang cứu hỏa KAVY có nhạc và đèn loại thang trượt phun nước, đẹp và bền bỉ nhựa nguyên sinh an toàn",212000,212000,0,0
TIKI,do-choi-me-be,78973653,"Đồ chơi lắp ghép máy bay  KAVY có 39 chi tiết có âm thanh và đèn sáng, nhựa nguyên sinh an toàn, có hướng dẫn lắp đặt",135000,135000,0,0
TIKI,do-choi-me-be,180380036,"Nước súc miệng cho trẻ em Listerine Kids Mouthwash hương berry (250ml)",57000,57000,0,0
TIKI,do-choi-me-be,176937809,"Phụ kiện máy hút sữa Medela, 1 phễu Flex size 21/24/27/30mm - Có vành silicon mềm, thiết kế hình oval đem lại sự thoải mái",250000,250000,0,0
TIKI,do-choi-me-be,76121717,"Sữa bột Vinamilk Optimum Gold Step 4 Hộp Thiếc 850g",380000,380000,0,0
TIKI,do-choi-me-be,56361457,"SỮA TẮM GỘI PIGEON CÓ VÒI",198000,198000,0,0
TIKI,do-choi-me-be,104154668,"Bình sữa cổ hẹp PPSU Pigeon 160ml/ 240ml",196000,326000,130000,40
TIKI,do-choi-me-be,89893414,"Gối chống trào ngược MonMon (được chọn mẫu)",265000,265000,0,0
TIKI,do-choi-me-be,88928240,"Khăn Ướt Trẻ Em MAMAMY 100 Tờ Có Mùi",32300,32300,0,0
TIKI,do-choi-me-be,77154232,"Vitamin bầu Elevit chính hãng Úc mẫu mới",1130000,1130000,0,0
TIKI,do-choi-me-be,132808075,"Kem đánh răng trẻ em Kid's Spry 60ml - Mỹ (vị Bubble Gum)",155000,155000,0,0
TIKI,do-choi-me-be,249175817,"Bình sữa Cổ Rộng PPSU Wesser 180ml/260ml",245100,285000,39900,14
TIKI,do-choi-me-be,183319614,"Đồ Chơi MINIFORCE Biệt Đội Siêu Nhân Nhí - Phiên Bản Hợp Nhất Siêu Cấp 309019",999000,999000,0,0
TIKI,do-choi-me-be,105178250,"Hạt Gỗ Loại Đẹp Cho Bé Chơi Trò Xúc Cát Đồ Chơi- Đồ Chơi Cho Trẻ, Đồ Chơi Gỗ An Toàn (200g)",37000,47000,10000,21
TIKI,do-choi-me-be,474634,"Tã Dán Bobby Siêu Mỏng Thấm Gói Siêu Lớn L68 (68 Miếng)",285000,285000,0,0
TIKI,do-choi-me-be,13408730,"Mô Hình Xe Ducati 1199 Panigale Red 1:12 Maisto MH-31101(20-11108)",274550,289000,14450,5
TIKI,do-choi-me-be,18317925,"Ghế bô vệ sinh cho bé Song Long - Màu ngẫu nhiên",57800,57800,0,0
TIKI,do-choi-me-be,156226617,"[COMBO] 4 GÓI SỮA CHUA HOA QUẢ SẤY YOMIT HÀN QUỐC CHO BÉ",270180,284400,14220,5
TIKI,do-choi-me-be,23695343,"Bộ 8 Xe Phương Tiện Giao Thông - Đồ Chơi Gỗ Chàng Trai Gỗ",560000,560000,0,0
TIKI,do-choi-me-be,116835804,"Kẹo Dẻo Healthy Care Kids Gummy Multivitamin 250v Của Úc, Bổ Sung Vitamin Tổng Hợp Và Khoáng Chất Cần Thiết Cho Trẻ, Tăng Đề Kháng, Ngừa Cảm Cúm, Cải Thiện Tình Trạng Biếng Ăn",415000,415000,0,0
TIKI,do-choi-me-be,93220417,"Combo Tiết Kiệm: Thùng 16 Gói Khăn Ướt Bobby Care Không Hương 100 Miếng/Gói tặng 15 khẩu trang Unicharm Nhật Bản",598000,598000,0,0
TIKI,do-choi-me-be,57746755,"GẤU BÔNG GỐI NẰM QUẢ BƠ HÌNH DONUT 3IN1 - ICHIGO",99000,99000,0,0
TIKI,do-choi-me-be,122740501,"Sữa bột Vinamilk Dielac Grow Plus 2+ Hộp thiếc 850g (Sữa Non)",339000,339000,0,0
TIKI,do-choi-me-be,31874789,"Tẩy trắng bồn sứ, sen vòi inox, gạch men Sabo-si chai 500ml không mùi",225000,225000,0,0
TIKI,do-choi-me-be,55348839,"Đồ Chơi Bé Gái Khu vui chơi Công viên Tuổi Thơ 14514 Bằng nhựa ABS an toàn",169000,250000,81000,32
TIKI,do-choi-me-be,55422193,"Máy tiệt trùng bình sữa bằng tia UV Haenim, Thế hệ thứ 4",6142000,6950000,808000,12
TIKI,do-choi-me-be,188507447,"Sữa Bột Colosmulti Pro+ 2 450g/30túi tăng cường hấp thu, miễn dịch, phát triển thể chất và nhận thức",459000,459000,0,0
TIKI,do-choi-me-be,74792468,"Đồ chơi mô hình xe nâng móc hàng KAVY NO.8832 chất liệu hợp kim và nhựa nguyên sinh an toàn, chi tiết sắc sảo",63000,63000,0,0
TIKI,do-choi-me-be,73438721,"Bộ sưu tầm trứng - Đội chó cứu hộ Paw Patrol - Chó cứu hỏa -Marshall  PPB-130114",69000,69000,0,0
TIKI,do-choi-me-be,272361186,"Calcium (canxi) hữu cơ, vitamin D3 cho trẻ sơ sinh, trẻ nhỏ Brauer Úc hỗ trợ phát triển chiều cao, cơ bắp, ngủ ngon, tăng hệ miễn dịch-OZ Slim Store",560000,1120000,560000,50
TIKI,do-choi-me-be,143370933,"Sữa Dưỡng Ẩm Dịu Nhẹ Hằng Ngày Cho Bé Cetaphil Baby Daily Lotion with Organic Calendula 400ml",291000,300000,9000,3
TIKI,do-choi-me-be,190087684,"Đồ Chơi MAGIC CUBE Khối Lập Phương Ma Thuật Màu Xanh Dương MC01/BLU",119000,119000,0,0
TIKI,do-choi-me-be,179373465,"Xe mô hình biệt đội chó cứu hộ Paw Patrol - Chó đội trưởng Chase",129000,129000,0,0
TIKI,do-choi-me-be,42468247,"Combo 3 yếm áo cotton ăn dặm JOU cho bé trai, bé gái, chất vải cotton 100% mềm, mịn, thoáng mát, giữ gìn vệ sinh cho bé yêu",65000,65000,0,0
TIKI,do-choi-me-be,682289,"Combo Nước Rửa Bình Arau Baby ( Bình 500ml + Túi 450ml)",254528,328000,73472,22
TIKI,do-choi-me-be,109570071,"Dung Dịch Tắm Gội Toàn Thân Cho Bé Dưới 3 Tuổi D-nee Oganic - Tem phụ Công ty Đại Thịnh",59000,59000,0,0
TIKI,do-choi-me-be,187008714,"Bình sữa đa năng 3 trong 1 BEBU Silicone Y Tế kháng khuẩn an toàn cho bé (240ml)",400000,400000,0,0
TIKI,do-choi-me-be,1744987,"Tã Quần Mỏng Nhẹ Caryn Gói Siêu Lớn M16 (16 Miếng)",179000,179000,0,0
TIKI,do-choi-me-be,104131856,"Bình sữa Pigeon cổ hẹp thủy tinh 120ml/240ml",182000,260000,78000,30
TIKI,do-choi-me-be,146519467,"Cờ Vây Nam Châm Chất Lượng Cao 28x28 và 37x37cm Có Hộp Đựng Quân Cờ - Chính Hãng dododios",149000,149000,0,0
TIKI,do-choi-me-be,132899373,"Siro Ăn Ngon Hoa Thiên KID Hộp 20 ống 10ml giúp hổ trợ hệ tiêu hóa cho bé",108000,120000,12000,10
TIKI,do-choi-me-be,75378569,"Đồ chơi LEGO SUPERHEROES Chiến Giáp Thần Sấm Thor 76169",359000,449000,90000,20
TIKI,do-choi-me-be,68193275,"Combo 2 tã dán Bobby đệm thun thấm mồ hôi",614000,740200,126200,17
TIKI,do-choi-me-be,50308416,"	 Set 4 Quần Lót Bầu Cotton Az1003",121000,125000,4000,3
TIKI,do-choi-me-be,118330329,"Lốc 6 chai 237ml Sữa Bột Pha Sẵn Värna Complete",199000,199000,0,0
TIKI,do-choi-me-be,32290665,"Bột ăn dặm cho bé An Việt hộp 500 Gram",100000,100000,0,0
TIKI,do-choi-me-be,44922078,"2 Thùng Sữa Bột Pha Sẵn GrowPLUS+ Đỏ 110ml Suy Dinh Dưỡng (48 Hộp x 110ml)",789000,789000,0,0
TIKI,do-choi-me-be,169268634,"Tả quần Kitin Natural size XXL36 (15-18kg)",154000,225000,71000,32
TIKI,do-choi-me-be,104153295,"Bình sữa cổ rộng PP Plus họa tiết xanh/hồng Pigeon 160ml (SS)",138000,230000,92000,40
TIKI,do-choi-me-be,140821527,"Bọt Tắm Gội Thảo Dược Pippi Cho Bé Sơ Sinh Không Cay Mắt Cỏ Mềm 250g",195000,195000,0,0
TIKI,do-choi-me-be,125157749,"Bỉm Dán/Quần NABIZAM ULTRATHIN Nội Địa Hàn M32/L30/XL26/XXL22/XXXL20",245000,245000,0,0
TIKI,do-choi-me-be,36282998,"Thực phẩm Bột Đậu tương lên men kiểu nhật Natto Anphaco ăn dặm dành cho bé và mẹ",170000,170000,0,0
TIKI,do-choi-me-be,94729039,"Ghế ăn dặm cho bé gấp gọn và nâng hạ độ cao Mastela 1013 - Ghế tập ăn dặm đạt chuẩn ASTM Mỹ BPA Free",695000,695000,0,0
TIKI,do-choi-me-be,128261203,"Colosmulti Canxi Nano hộp 20 gói x 3g hỗ trợ chắc khỏe xương, phát triển chiều cao cho bé",350000,350000,0,0
TIKI,do-choi-me-be,19381181,"Thùng 48 Hộp x 180ml Sữa Bột Pha Sẵn GrowPLUS+ Xanh 180ml Tăng Cân Khoẻ Mạnh - Hàng Chính Hãng",510000,510000,0,0
TIKI,do-choi-me-be,73233650,"Ghép Hình Cơ Bản Khối Lớn Cresta - 112 Chi Tiết",206250,275000,68750,25
TIKI,do-choi-me-be,544191,"Dung Dịch Tắm Gội Toàn Thân Cho Bé Dưới 3 Tuổi D-nee - Chai 800ml (Hồng)",136000,140000,4000,3
TIKI,do-choi-me-be,112106913,"Thùng sữa nước ca cao lúa mạch Nutricare Care 100 Active giúp trẻ phát triển chiều cao (180ml)",332640,332640,0,0
TIKI,do-choi-me-be,10207375,"Thùng sữa nước pha sẵn Nutricare Metacare - phát triển toàn diện cho trẻ từ 1 tuổi (180ml x 48 hộp)",510000,510000,0,0
TIKI,do-choi-me-be,120527384,"Giường cũi trẻ em Joie Kubbie Sleep",2647963,3043636,395673,13
TIKI,do-choi-me-be,152618921,"Đồ chơi ghép hình chính hãng Mideer Huge Animal Dinosaur World MD3083 - Thế giới khủng long (280 mảnh ghép)",299000,389000,90000,23
TIKI,do-choi-me-be,58291951,"Dung Dịch Tẩy Trắng  Ron Gạch Sabo-R Chai 1 Lít",289000,289000,0,0
TIKI,do-choi-me-be,104142554,"Bình uống nước ống hút có tay cầm Pigeon 300ml - Màu Xanh/ Hồng (HSD: 10/2025)",169000,281000,112000,40
TIKI,do-choi-me-be,71080134,"Sữa bột Vinamilk Optimum Gold 2 800g",395000,395000,0,0
TIKI,do-choi-me-be,3193073,"Tã Quần Huggies Dry Gói Đại L48 (48 Miếng) - Bao Bì Mới",230000,230000,0,0
TIKI,do-choi-me-be,200491965,"Xe Đạp Trẻ Em Nhựa Chợ Lớn 14 inch K101 Dành Cho Bé Từ 4 - 5 tuổi - M1775-X2B",914000,914000,0,0
TIKI,do-choi-me-be,7243175,"Nhà búp bê Ngôi nhà thu nhỏ lắp ghép Mood of love",159000,260000,101000,39
TIKI,do-choi-me-be,17489463,"5 Bịch Khăn vải khô đa năng LIKADO 400g Mẫu Mới (15 x 20cm)",275000,275000,0,0
TIKI,do-choi-me-be,116406694,"Nước Mắm Ăn Dặm Cho Bé Maguzt cá cơm than 60ml",33800,33800,0,0
TIKI,do-choi-me-be,127842705,"Combo 2 hộp Sữa non Colosmulti Pedia hộp 22 gói x 16g chuyên biệt hỗ trợ giúp bé ăn ngoan",1900000,1900000,0,0
TIKI,do-choi-me-be,54417111,"Sữa Bột Nestlé NAN Nga Optipro 1 (800g) 0-6 tháng",512000,512000,0,0
TIKI,do-choi-me-be,192851127,"Canxi Sinh Học Bestical Hỗ Trợ Xương Răng Chắc Khỏe",290000,310000,20000,6
TIKI,do-choi-me-be,184545065,"Đồ chơi lắp ráp, xếp hình Qman 2029 - Xe Kem (388 Mảnh Ghép) dành cho bé gái từ 6 tuổi",249000,299000,50000,17
TIKI,do-choi-me-be,181462683,"Bình ống hút AQ Richell Nhật Bản 200ml | Baby",342655,342655,0,0
TIKI,do-choi-me-be,116931297,"Nước giặt Dnee 3000ml xanh/hồng/trắng - Thái Lan",204000,204000,0,0
TIKI,do-choi-me-be,151592700,"Xe máy điện trẻ em, xe moto điện cho bé có kết nối Bluetooth TILO KIDS TLK-9999",1099000,2000000,901000,45
TIKI,do-choi-me-be,32182656,"Combo 4 gói Khăn giấy ướt cho trẻ sơ sinh HUGGIES (Gói 72 tờ) - Chiết xuất Cao cao & Bơ hạt mỡ",130000,130000,0,0
TIKI,do-choi-me-be,151708475,"Xe tập đi kết hợp xe chòi chân và xe scooter 3 trong 1 hình sư tử có nhạc cho bé Winfun 0855",1290000,1290000,0,0
TIKI,do-choi-me-be,14472037,"Sữa non COLOSBABY GOLD 0+ (800G)",558753,558753,0,0
TIKI,do-choi-me-be,76121712,"Sữa bột Vinamilk Optimum Gold Step 3 Hộp Thiếc 850g",410000,410000,0,0
TIKI,do-choi-me-be,73331967,"Vỏ gối chống trào ngược Rototo bebe chính hãng chất liệu cotton lụa cao cấp mềm mại, thấm hút mồ hôi tốt",720000,720000,0,0
TIKI,do-choi-me-be,35460650,"Siêu Xe Tải Hot Wheels BFM60 - Giao hàng ngẫu nhiên",209000,209000,0,0
TIKI,do-choi-me-be,755486,"Cờ Lô Tô Liên Hiệp Thành KLT",167000,167000,0,0
TIKI,do-choi-me-be,107459181,"Cờ Vua - Cờ Quốc Tế K1 [Liên Hiệp Thành | Aboardgame]",67000,67000,0,0
TIKI,do-choi-me-be,106912615,"Hạt Gỗ Xúc Cát Đồ Chơi Cho Bé Thỏa Sức Vui Đùa Với Chất Liệu Tự Nhiên, An Toàn Tặng Kèm 1 Xẻng Xúc Gỗ ( 1kg hạt gỗ)",175000,219000,44000,20
TIKI,do-choi-me-be,122232848,"Đồ chơi rèn luyện trí nhớ cho bé, tìm hình con vật giống nhau. Trò chơi trí tuệ cho bé. ",110000,110000,0,0
TIKI,do-choi-me-be,74902049,"Đồ chơi lắp ráp xe tải chở rác kèm 4 thùng rác KAVY  có nhạc và đèn, nhiều chi tiết phụ giúp bé phát triển các kĩ năng",298000,298000,0,0
TIKI,do-choi-me-be,147965674,"Set 4 Miếng Silicon Bịt Góc Bàn Bảo Vệ An Toàn Cho Bé, Góc Bàn Silicon Nhiều Kiểu Dáng Lựa Chọn, Tiện Dụng Trong Gia Đình. TakyHome 5500",25000,25000,0,0
TIKI,do-choi-me-be,172838805,"Combo Tiết Kiệm: 12 Gói Khăn Ướt Bobby Care Bổ Sung 80 Miếng/Gói",432000,432000,0,0
TIKI,do-choi-me-be,78021198,"Bô Vệ Sinh Thông Minh Boom Potty",325000,325000,0,0
TIKI,do-choi-me-be,177421071,"Ga Giường Chống Thấm Cotton Cao Cấp Goodmama Chính Hãng Bảo Hành 6 Tháng",395000,395000,0,0
TIKI,do-choi-me-be,513971,"Sữa Bột Dành Cho Mẹ Bầu Anmum Materna Hương Vanilla 800g",443000,471000,28000,6
TIKI,do-choi-me-be,150980864,"Sữa bột ngôi sao nhỏ Little Étoile số 3 (1-3 tuổi) 800g",680000,680000,0,0
TIKI,do-choi-me-be,121176720,"Thùng sữa nước trái cây Smarta Grow (vị dâu) giúp trẻ tăng chiều cao, phát triển não bộ, dinh dưỡng cho trẻ thấp còi (48 hộp x 180ml)",341264,341264,0,0
TIKI,do-choi-me-be,137940049,"Size trải giường Tấm lót chống thấm cho bé cotton 4 lớp SIÊU VIỆT (SUPERMAT)",699000,699000,0,0
TIKI,do-choi-me-be,182139783,"Thùng sữa pha sẵn Colos Baby 110ml ( 48 hộp x 110ml)",395000,395000,0,0
TIKI,do-choi-me-be,74870552,"Bộ đồ chơi xếp hình xe đua KAVY hơn 90 chi tiết bằng nhựa nguyên sinh an toàn, phát triển tư duy của trẻ",60000,60000,0,0
TIKI,do-choi-me-be,169749684,"LEGO Classic 11023 Đế Lắp Ráp Màu Xanh Lá (1 chi tiết)",269000,269000,0,0
TIKI,do-choi-me-be,97858085,"Khăn Tắm Bonny 100% Sợi Tre Lụa 4 Lớp Siêu Mềm Mịn, Thấm Hút, An Toàn Cho Bé (Kích thước: 90x90Cm)",145040,148000,2960,2
TIKI,do-choi-me-be,189568844," Tã quần Huggies Tràm Trà Tự Nhiên Dry Pants Jumbo XL34 + Tặng 4 miếng",226000,226000,0,0
TIKI,do-choi-me-be,270884316,"Brauer Hỗ Trợ Hệ Miễn Dịch Cho Trẻ Sơ Sinh & Trẻ Nhỏ - Baby & Child Immunity Support Oral Liquid 100ml - QuaTangMe Extaste",379000,758000,379000,50
TIKI,do-choi-me-be,159829550,"Xe ô tô đồ chơi cho bé KAVY NO.8807 chạy đà quán tính mô tả xe cảnh sát, cứu hỏa, taxi, bus đẹp dễ thương",39000,39000,0,0
TIKI,do-choi-me-be,124209186,"Tã/bỉm quần Molfix Thiên nhiên Super Jumbo XXL (15kg - 25kg) - Gói 44+8 miếng",355000,355000,0,0
TIKI,do-choi-me-be,2791801,"Mặt nạ nghệ phục hồi da, se khít chân lông, đánh bay mụn thâm Wonmom 50g",212000,212000,0,0
TIKI,do-choi-me-be,179715890,"Đồ Chơi Sáng Tạo Slimy Foam_Slime Xốp Nhiều Màu 38008",159000,159000,0,0
TIKI,do-choi-me-be,111717762,"Sữa bột Nutricare Fine giúp tăng cường miễn dịch cho bệnh nhân ung thư (900g)",517000,517000,0,0
TIKI,do-choi-me-be,11194478,"Dầu Mè Đen Nguyên Chất Bảo Tâm (Dầu Mè Nguyên Chất, Dầu Vừng Đen Nguyên Chất) – Sản xuất từ Hạt Mè Đen Thuần Chủng Tự nhiên, Cao cấp - Nấu Canh, Trộn Salad, Cho bé Ăn Dặm - Hàng Chính Hãng – 500 ml",268000,268000,0,0
TIKI,do-choi-me-be,88822348,"Bộ đồ chơi lắp ghép tàu vũ trụ con thoi KAVY NO.8809 khám phá không gian với 671 chi tiết bền đẹp",480000,480000,0,0
TIKI,do-choi-me-be,612888,"Kệ Chữ A Nhựa Chợ Lớn K1 (Không nhạc) - M1417-BB5",208000,208000,0,0
TIKI,do-choi-me-be,72043259,"Áo ngực cho con bú cao cấp. Áo ngực cho bà bầu vải lưới siêu thoáng khí. Áo lót cho con bú siêu mềm, thoáng khí, mát mẻ. Áo lót không gọng cho bé bú sau sinh. Áo ngực không gọng cho con bú cao cấp Vemoda",249000,249000,0,0
TIKI,do-choi-me-be,74012254,"Mô hình xe Mercedes-Benz G500 1:24 Welly - 24012W",439000,439000,0,0
TIKI,do-choi-me-be,115714371,"Sữa Grow Plus xanh 900g (cho trẻ 1 tuổi trở lên) công thức FDI độc quyền của Nutifood Thụy Điển giúp trẻ biếng ăn tăng cân hiệu quả. Tặng khăn mặt mềm mịn cho bé.",305000,305000,0,0
TIKI,do-choi-me-be,146372984,"Combo lều và nồi xông hơi 3L hàng cao cấp loại 1",639000,639000,0,0
TIKI,do-choi-me-be,274759098,"Bình Sữa PPSU Ty Siêu Mềm Tự Nhiên Tommee Tippee Natural Start 260ml, Núm Ty Của Bình 3-6 tháng (Bình Đôi)",725000,725000,0,0
TIKI,do-choi-me-be,76708051,"Gối Ôm Chữ U Cho Bà Bầu Ngủ Ngon, Giảm Chuột Rút, Tê Chân UB19 - màu xám",619000,619000,0,0
TIKI,do-choi-me-be,153539576,"Ghế Ăn Dặm Du Lịch Điều Chỉnh Độ Cao Có Nệm Mastela 1013",630000,630000,0,0
TIKI,do-choi-me-be,73384818,"Vỏ gối chống trào ngược Rototo bebe chính hãng chất liệu ripple nhăn thoáng mát chống bụi bẩn nấm mốc tốt",590000,590000,0,0
TIKI,do-choi-me-be,50462239,"Đồ chơi lắp ráp Đoàn Tàu Học Chữ Lego Duplo 10915 (36 chi tiết)",1269000,1269000,0,0
TIKI,do-choi-me-be,193748466,"Bình tập uống nước có vòi mút kháng khuẩn chống tràn, chống sặc Tommee Tippee SuperStar, 190ml, cho bé từ 4 tháng – Xanh lá",245000,245000,0,0
TIKI,do-choi-me-be,4696323,"Kem Chống Hăm Tã Cho Trẻ Sơ Sinh Và Em Bé Mustela (100ml)",247350,255000,7650,3
TIKI,do-choi-me-be,79279556,"Đồ chơi mô hình nâng hạ công trình KAVY  gồm nhiều chi tiết sắc sảo, đẹp, chuyển động được",140000,140000,0,0
TIKI,do-choi-me-be,42348129,"BỘ 2 LON SỮA BỘT VINAMILK CANXIPRO 400G",380000,380000,0,0
TIKI,do-choi-me-be,193570314,"Lồng Đèn Trung Thu/Tết Hình Thú Kết Hợp Đèn Led Cho Bé 3+ - TOi",99000,99000,0,0
TIKI,do-choi-me-be,212321269,"Chai Uống Giúp Ăn Ngon Miệng Tăng Cường Sức Đề Kháng ZinC Oral ( Chai 200ml )",85000,114000,29000,25
TIKI,do-choi-me-be,23025279,"COMBO 24 HỘP SỮA BỘT PHA SẴN OPTIMUM GOLD - HỘP 180ML",360000,360000,0,0
TIKI,do-choi-me-be,187618420,"Đồ chơi trẻ em: Xe thang cứu hộ điều khiển từ xa DK81093, Màu ngẫu nhiên",224000,320000,96000,30
TIKI,do-choi-me-be,74892198,"Bộ đồ chơi lắp ghép xe trộn bê tông KAVY với kết hợp của nhiều màu sắc, nhựa nguyên sinh, kích thước rất lớn (kèm vít)",87000,87000,0,0
TIKI,do-choi-me-be,86403163,"Set đồ chơi Xúc xắc, lục lạc, kèn, trống Toyshouse dành cho bé từ sơ sinh TH1220-733A-53 - giúp bé phát triển thị giác, thính",99000,99000,0,0
TIKI,do-choi-me-be,192375813,"Đồ chơi trẻ em: Xe ô tô mô hình hợp kim, xe địa hình DK 81108. Kiểu dáng, mẫu xe, màu sắc ngẫu nhiên.",87500,125000,37500,30
TIKI,do-choi-me-be,73363906,"Sữa Glico Icreo Follow Up Milk (Icreo số 1) 10 thanh/hộp, 13,6g/thanh",120000,120000,0,0
TIKI,do-choi-me-be,124177001,"Tã/bỉm dán Molfix Thiên nhiên Super Jumbo XL (12kg - 17kg) - Gói 62+2 miếng",280000,370000,90000,24
TIKI,do-choi-me-be,83525610,"Máy Hút Sữa Không Dây Mama's Choice",1650000,1650000,0,0
TIKI,do-choi-me-be,76070473,"Đồ chơi mô hình xe đầu kéo xe tăng KAVY (gồm 2 xe) nhựa ABS an toàn, kích thước lớn, chi tiết sắc sảo, đẹp",180000,180000,0,0
TIKI,do-choi-me-be,124146278,"Miếng lót sơ sinh Molfix Thiên nhiên Super Jumbo Newborn 1 (dưới 1 tháng tuổi) - Gói 90+10 miếng ",125000,145000,20000,14
TIKI,do-choi-me-be,75426606,"Lật đật cho bé hình thú hoạt hình ngộ nghĩnh đáng yêu hình gà con thỏ trắng và chim cánh cụt – DC041",35000,35000,0,0
TIKI,do-choi-me-be,193894868,"Áo hút sữa rảnh tay Fatzbaby (mềm mại - co giãn - chắc chắn - dễ chịu)",325000,365000,40000,11
TIKI,do-choi-me-be,4670821,"Hạt Diêm Mạch Hữu Cơ Úc Absolute Organic (Quinoa seed Túi 1kg)",286160,292000,5840,2
TIKI,do-choi-me-be,187008608,"Bàn chải tưa lưỡi BEBU silicon hình ngón tay",69000,69000,0,0
TIKI,do-choi-me-be,80130092,"ta quan hingig size 4XL 100 mieng",240000,240000,0,0
TIKI,do-choi-me-be,84119328,"Khăn sữa sợi tre Organic",99000,188500,89500,47
TIKI,do-choi-me-be,33235852,"Xông ngâm vùng kín sau sinh Yaocare mama 250ml - DK Pharma",185000,185000,0,0
TIKI,do-choi-me-be,97857770,"Đồ chơi mô hình xe xúc mini KAVY NO.8808 chất liệu kim loại an toàn cho bé có thể làm trang trí - màu đỏ",29000,29000,0,0
TIKI,do-choi-me-be,58803653,"Gối cao su em bé Vạn Thành (22x39x5) cao su thiên nhiên 100%",240000,240000,0,0
TIKI,do-choi-me-be,188507463,"Sữa Bột Colosmulti Pro+ 3 560g/28túi tăng cường hấp thu, miễn dịch, phát triển thể chất và nhận thức",680000,680000,0,0
TIKI,do-choi-me-be,1030577,"Khăn Khô Đa Năng Mamamy Không Chứa Huỳnh Quang Mm0914 (180 Tờ)",65000,65000,0,0
TIKI,do-choi-me-be,53391811,"Sữa phát triển chiều cao Asumiru Nhật Bản 180g ( cho bé 3-16 tuổi )",891000,891000,0,0
TIKI,do-choi-me-be,15202129,"Đồ Chơi Phun Nước Nhựa Chợ Lớn hình Gấu Trúc - M1778-BB89",101000,101000,0,0
TIKI,do-choi-me-be,22731082,"COMBO 48 HỘP SỮA BỘT PHA SẴN DIELAC ALPHA GOLD IQ (110ML)",385000,385000,0,0
TIKI,do-choi-me-be,194769203,"Đồ chơi hướng nghiệp - Bộ trống Jazz Drum cho bé Toyshouse - Nhạc cụ, âm nhạc cho bé yêu",98000,98000,0,0
TIKI,do-choi-me-be,730262,"Nước Rửa Bình Thảo Mộc Arau Baby (500ml)",173130,199000,25870,13
TIKI,do-choi-me-be,94762040,"SỮA BỘT OPTIMUM GOLD 3 1450G (CHO TRẺ TỪ 1 - 2 TUỔI)",620000,620000,0,0
TIKI,do-choi-me-be,166090780,"Tã Quần Người Lớn Canny Siêu Thấm Size M8 (8 miếng)",67600,70000,2400,3
TIKI,do-choi-me-be,104127074,"Ty ngậm đơn Pigeon size L - Boy/Girl/Unisex",94000,104000,10000,10
TIKI,do-choi-me-be,272024184,"Túi 5 Miếng lót chống thấm JOU001, 1 mặt cotton 100% mềm mịn, 1 mặt nhựa PE chống thấm nước, kích thước 35x40 cm",138000,138000,0,0
TIKI,do-choi-me-be,48736033,"Cốt Nghệ Hạ Thổ Dưỡng Trắng Da Mờ Thâm Bảo Nhiên Chai 330Ml",144000,144000,0,0
TIKI,do-choi-me-be,104126221,"Bình sữa cổ hẹp PP cao cấp bé trai Pigeon 120ml/ 240ml",86000,142000,56000,39
TIKI,do-choi-me-be,2799523,"Xe Đạp Trẻ Em Nhựa Chợ Lớn 12 inch K88 - M1611-X2B - Dành Cho Bé Từ 2 - 3 tuổi",981000,981000,0,0
TIKI,do-choi-me-be,11341356,"Sữa Bột Vinamilk Dielac Alpha 1 - Hộp Thiếc 900g",245000,245000,0,0
TIKI,do-choi-me-be,88033734,"CÀI TÓC CHO BÉ ️HOT️ CÀI TÓC HOA CHO BÉ CỰC ĐẸP",22000,25000,3000,12
TIKI,do-choi-me-be,184860970,"Nước Giặt Quần Áo Cho Bé D-Nee - Chai 3000ml (Tím)",200000,215000,15000,7
TIKI,do-choi-me-be,249168395,"Núm ty Cổ Hẹp Wesser S/M/L/+ (2 cái/hộp)",84390,97000,12610,13
TIKI,do-choi-me-be,138838287,"Đồ Chơi Lắp Ráp Xếp Hình Qman 42104 Biệt Đội Biến Hình Dành Cho Bé Trai Trên 6 Tuổi",119000,159000,40000,25
TIKI,do-choi-me-be,167343584,"Bộ Đồ Chơi Xếp Hình Khối Bằng Gỗ Tự Nhiên 100 chi tiết Có Hộp Đựng Tiện Lợi Đồ Chơi Thông Minh Bằng Gỗ",145000,182000,37000,20
TIKI,do-choi-me-be,59306483,"Sách vải Pipo - nhận biết màu sắc - song ngữ Anh Việt chủ đề: Con gì màu gì ( PiPô Việt Nam )",22000,22000,0,0
TIKI,do-choi-me-be,41178418,"Bộ 2 Lon Sữa Bột NutiFood Diabet Care Gold Lon 900g Cho Người Tiểu Đường, Đái Tháo Đường Và Tiền Đái Tháo Đường",990000,990000,0,0
TIKI,do-choi-me-be,249033307,"Sữa tắm gội Wesser 2 in 1 500ml",114750,135000,20250,15
TIKI,do-choi-me-be,114071036,"Đồ chơi mô hình máy bay BOEING 777 KAVY NO.8807 âm thanh và ánh sáng bằng hợp kim có thể trưng bày",198000,198000,0,0
TIKI,do-choi-me-be,173521346,"Thùng 48 hộp Sữa bột pha sẵn GrowPLUS+ Vàng - Sữa non tăng đề kháng (180ml/hộp)",625000,625000,0,0
TIKI,do-choi-me-be,58047099,"Bộ đồ chơi xếp hình 252 chi tiết lớn trượt chạy pin",580000,580000,0,0
TIKI,do-choi-me-be,84579638,"Nước Giặt Arau Baby Dạng Bình 800ml",173130,199000,25870,13
TIKI,do-choi-me-be,84119351,"Khăn sữa sợi tre KACHOOBABY, hộp 8 cái",79000,79000,0,0
TIKI,do-choi-me-be,74902216,"Bộ đồ chơi lắp ráp xe tải quét dọn đường KAVY có nhạc và đèn giúp bé phát triển các kĩ năng cơ bản",285000,285000,0,0
TIKI,do-choi-me-be,6710519,"Đoàn Tàu Gỗ - Đồ Chơi Gỗ Chàng Trai Gỗ 94005 Chất Liệu An Toàn Cho Bé",398000,398000,0,0
TIKI,do-choi-me-be,70340831,"Sữa Bột Vitadairy COLOSBABY BIO GOLD 1+ 800g",490000,490000,0,0
TIKI,do-choi-me-be,177216469,"Combo 3 Tấm Đệm Lót Người Lớn Canny 45x70cm (10 miếng)",148000,180000,32000,18
TIKI,do-choi-me-be,414631,"Kem Đặc Biệt Hỗ Trợ Trị Hăm Bubchen - 4920",147000,147000,0,0
TIKI,do-choi-me-be,129742403,"Miếng lót hứng sữa con bọ rùa HaaKaa. Dung tích 40ml và 75ml. Chất liệu silicone cao cấp, an toàn. Không chứa BPA, PVC và phthalate",365000,424000,59000,14
TIKI,do-choi-me-be,17489371,"4 Bịch LIKADO 400g Mẫu Mới (15 x 20cm)",220000,220000,0,0
TIKI,do-choi-me-be,48464926,"Ngũ Cốc Mẹ Bầu Long Liên (500gr) - Ngũ Cốc Cho Bà Bầu - Ngũ Cốc Dinh Dưỡng Cho Mẹ Và Thai Nhi - Bổ Sung Omega3, DHA, Canxi, Sắt - Hỗ Trợ Cho Sự Phát Triển Toàn Diện Và An Toàn Của Bé - Chứng Nhận ATVSTP",270000,270000,0,0
TIKI,do-choi-me-be,270862401,"Vitamin tổng hợp cho trẻ sơ sinh 1-3 tuổi Brauer Baby & Kids Liquid Multivitamin For Infant tăng sức đề kháng - QuaTangMe Extaste",497000,994000,497000,50
TIKI,do-choi-me-be,158410004,"Bộ Thủ Công Trẻ Tự Làm Thú Bông 6+ - AVENIR",239000,239000,0,0
TIKI,do-choi-me-be,92699503,"Ty ngậm dạ quang cho bé Tommee Tippee Night Time 6-18 tháng (vỉ đôi) - Cá Voi",255000,255000,0,0
TIKI,do-choi-me-be,270854292,"Vitamin D cho trẻ sơ sinh và trẻ nhỏ Brauer Baby & Kids Liquid Vitamin D 400IU giúp phát triển hệ xương, răng, ngủ ngon - QuaTangMe Extaste",415000,830000,415000,50
TIKI,do-choi-me-be,176800689,"Tã Dán Bobby Siêu Mỏng Thấm Gói Siêu Lớn XXL56 (56 Miếng)",285000,285000,0,0
TIKI,do-choi-me-be,90503618,"Lá xông, thơm tho cơ thể mẹ sau sinh, lưu thông khí huyết Wonmom",46000,52000,6000,12
TIKI,do-choi-me-be,77558438,"Đồ Chơi Xe Bồn Chở Dầu Polesie 38173 Phát Triển Kỹ Năng Và Sáng Tạo, An Toàn, Thông Minh, Giáo Dục",215100,239000,23900,10
TIKI,do-choi-me-be,50068501,"Thùng sữa bột pha sẵn Nutricare Hanie Kid - dinh dưỡng cho trẻ biếng ăn & suy dinh dưỡng (180ml x 48 hộp)",629000,662400,33400,5
TIKI,do-choi-me-be,15188340,"Áo choàng tắm khách sạn DADA ",450000,450000,0,0
TIKI,do-choi-me-be,10688489,"Combo 04 chai nước mắm cho bé ăn dặm Lê Gia 60ml",106600,106600,0,0
TIKI,do-choi-me-be,13421392,"Bộ 10 Nút Bịt Ổ Điện Bảo Vệ An Toàn Cho Bé  Miliken Tampe NL-3057",19000,19000,0,0
TIKI,do-choi-me-be,160814691,"Đồ Chơi Xếp Hình Lắp Ráp Qman 41104 - Cảnh sát biến hình (453 mảnh ghép) Dành Cho Các Bé Trên 6 Tuổi",259000,389000,130000,33
TIKI,do-choi-me-be,164929069,"Thanh mở rộng chắn cửa, phụ kiện của thanh chắn cầu thang chính hãng Mastela CT-D04 bảo vệ an toàn cho bé (Không cần khoan tường), Thanh mở rộng 28CM",262000,262000,0,0
TIKI,do-choi-me-be,35226708,"Hạt nêm ăn dặm cho bé nội địa Nhật Bản (Tặng trà sữa macca)",213000,213000,0,0
TIKI,do-choi-me-be,104157449,"Ty ngậm đơn Pigeon size M",94000,104000,10000,10
TIKI,do-choi-me-be,75589859,"Tã/bỉm quần Merries Jumbo đủ size L56/XL50/XXL32",409000,409000,0,0
TIKI,do-choi-me-be,76016634,"Bộ cốt gừng + Cốt nghệ dưỡng trắng chống rạn cho mẹ ở cữ sau sinh Bảo Nhiên",304000,304000,0,0
TIKI,do-choi-me-be,42347080,"BỘ 2 LON SỮA BỘT VINAMILK CANXIPRO 900G",740000,740000,0,0
TIKI,do-choi-me-be,127123650,"Bình uống nước Tritan bật hút 2 tay cầm có phao 360 độ 250ml FATZBABY FB0250NX",120000,120000,0,0
TIKI,do-choi-me-be,77663857,"Tã/bỉm quần moony xanh không cộng miếng nội địa Nhật Bản size XL 38 bé trai ( dành cho bé từ 12-22kg)",120000,120000,0,0
TIKI,do-choi-me-be,55514183,"Đồ Chơi LEAPFROG Xe Bus Vui Học 80-601300",1079000,1079000,0,0
TIKI,do-choi-me-be,193912078,"Bình tập uống nước có vòi mút kháng khuẩn chống tràn, chống sặc cho bé Tommee Tippee SuperStar, 190ml – Vàng",245000,245000,0,0
TIKI,do-choi-me-be,1347581,"Phấn Gạo Chống Hăm, Rôm, Sảy, Da Khô  Hương Dịu Nhẹ ReisCare Extra Mild (150g)",121440,151800,30360,20
TIKI,do-choi-me-be,34947532,"SỮA BỘT OPTIMUM GOLD 1 HỘP THIẾT 900G (VINAMILK)",455000,455000,0,0
TIKI,do-choi-me-be,88826092,"Đồ chơi mô hình xe chở xăng dầu, xe quét rác đường phố, xe đựng rác KAVY NO.8827 chạy bánh đà rất xa đẹp và bền bỉ",73000,73000,0,0
TIKI,do-choi-me-be,101579404,"Sách vải tương tác PiPo - Khám phá đại dương",75000,75000,0,0
TIKI,do-choi-me-be,137739238,"Giỏ xách quai giữa có nắp Inochi Nachi (làn đi sinh cho các mẹ chuẩn bị sinh, mang vào viện)",106300,106300,0,0
TIKI,do-choi-me-be,188176173,"Đồ chơi trẻ em: Lắp ghép, xếp hình Robot biến hình transformer chiến đấu cơ DK 81101. Kiểu dáng, màu sắc ngẫu nhiên.",161000,230000,69000,30
TIKI,do-choi-me-be,4140005,"Kem Đánh Răng Hương Chuối - Táo 6M+ Chicco",159000,159000,0,0
TIKI,do-choi-me-be,78973610,"Bộ đồ chơi đường ray chuột hamster KAVY có nhạc chú chuột hamster di chuyển vui nhộn dễ thương",310000,310000,0,0
TIKI,do-choi-me-be,1380483,"Combo 3 Gói Khăn Giấy Ướt 80 Tờ Không Mùi Kháng Khuẩn An Toàn Cho Bé Mamamy ( 80 Tờ Nắp x 3)",81000,81000,0,0
TIKI,do-choi-me-be,141091138,"Dầu ăn dinh dưỡng cho trẻ Ranee KIDS 250ml + tặng kèm chén ăn dặm cao cấp hình cá",90000,90000,0,0
TIKI,do-choi-me-be,16170046,"Cao tinh dầu tràm Cung đình Huế",65000,65000,0,0
TIKI,do-choi-me-be,103264981,"Đồ chơi gỗ Đường luồn lý thú | Winwintoys 65072 | Rèn luyện sự khéo léo và kiên nhẫn | Đạt tiêu chuẩn CE và TCVN",336000,336000,0,0
TIKI,do-choi-me-be,24733267,"BỘT ĂN DẶM RIDIELAC GOLD HEO BÓ XÔI - HỘP THIẾC 350G",100000,100000,0,0
TIKI,do-choi-me-be,119078558,"Kẹo Dẻo Cho Bé Nature's Way Kids Smart Vita Gummies Multi Vitamin for Fussy Eaters Kích Thích Ăn Ngon 60 Viên",292000,584000,292000,50
TIKI,do-choi-me-be,88029839,"Đầm Bé Gái ️FREESHIP️ Đầm Công Chúa cho Bé Đỏ Nơ Đính Đá",113000,150000,37000,25
TIKI,do-choi-me-be,184218967,"Lều Công Chúa - Hoàng Tử Hình Lục Giác Cho Bé",245000,245000,0,0
TIKI,do-choi-me-be,4105711,"Sữa Tắm Gội Cho Trẻ Sơ Sinh Và Em Bé Da Thường  Gentle Cleaning Gel (750ml)",485000,500000,15000,3
TIKI,do-choi-me-be,32410432,"Bộ Bài Tarot The Smith-Waite Tarot Centennial Edition Pamela Colman Smith Commemorative Cao Cấp",199000,199000,0,0
TIKI,do-choi-me-be,68728505,"Nui rau củ hữu cơ cho bé hình chuột Mickey 300g Dalla Costa",125000,125000,0,0
TIKI,do-choi-me-be,68108191,"Gối đi xe máy cho bé 2 đầu Pucca",97000,97000,0,0
TIKI,do-choi-me-be,48309066,"b.box Bình nước 360 độ cho bé tập uống nước 240ml - Xanh Lá",295000,295000,0,0
TIKI,do-choi-me-be,106869907,"Khối 216 nam châm vuông xếp hình sáng tạo (size 5mm Gold)",289000,289000,0,0
TIKI,do-choi-me-be,20907865,"Nhiệt kế điện tử hồng ngoại đo trán Yamada - Đo không chạm chỉ 1 giây: thân nhiệt, sữa, nước tắm và nhiệt độ phòng",399000,399000,0,0
TIKI,do-choi-me-be,191757210,"Sandal Eva Phun Doreamon Bé Gái Biti's DEG001022",294000,335000,41000,12
TIKI,do-choi-me-be,544096,"Nước Rửa Bình Sữa Dạng Túi D-nee - Xanh lá (550ml)",64505,70000,5495,8
TIKI,do-choi-me-be,196470030,"Balo Bỉm Sữa Giữ Nhiệt Mama’s Choice Đa Năng, Giữ Nhiệt Bình Sữa, Đựng Đồ Cho Mẹ Bé, Thiết Kế 2 Tầng, Chất Liệu Cao Cấp - Balo + 01 Đá Khô",520000,520000,0,0
TIKI,do-choi-me-be,10930948,"Thùng sữa nước Nutricare Care 100 Gold - phát triển toàn diện cho trẻ từ 1 tuổi (180ml x 48 hộp)",570000,570000,0,0
TIKI,do-choi-me-be,13751985,"Combo 4 Gói Khăn giấy ướt cho trẻ sơ sinh Huggies không mùi, gói 64 tờ",148000,148000,0,0
TIKI,do-choi-me-be,71975984,"Viên Uống Dầu Cá Nature's Way Omega-3 Fish Oil Trio Giúp Bổ Sung DHA Phát Triển Trí Tuệ Cho Bé 60 Viên",490000,490000,0,0
TIKI,do-choi-me-be,95218658,"Máy đưa võng tự động Sbaby SH20 sức đưa 100 kg",530000,530000,0,0
TIKI,do-choi-me-be,154274585,"Đồ chơi xếp hình, lắp ráp Qman 1805 - Biệt đội xe cứu hỏa (313 mảnh ghép)",179000,269000,90000,33
TIKI,do-choi-me-be,24765808,"BỘT ĂN DẶM RIDIELAC GOLD YẾN MẠCH SỮA - HỘP THIẾC 350G",100000,100000,0,0
TIKI,do-choi-me-be,112225617,"Bột ăn dặm tốt cho bé Nutricare Metacare Cá hồi phô mai cải bó xôi & olive (200g)",57000,57000,0,0
TIKI,do-choi-me-be,35236673,"Sữa Bột Bellamy's Organic Số 2 (900g)",790000,790000,0,0
TIKI,do-choi-me-be,37970419,"Thực phẩm Men vi sinh OptiBac Probiotics xanh Anh 30 gói hỗ trợ điều trị táo bón Dành cho Mẹ và bé",495000,618750,123750,20
TIKI,do-choi-me-be,152483506,"Đồ chơi: Ghép Hình Khí Tài Quân Sự - Trực Thăng Chiến Đấu 120 Chi Tiết DK81057",81000,108000,27000,25
TIKI,do-choi-me-be,54925933,"Combo 4 Gói Khăn Ướt AGI Không Mùi, Không Hương 100 tờ/gói (x 4 gói) - Giao Màu Ngẫu Nhiên",168000,168000,0,0
TIKI,do-choi-me-be,116385610,"COMBO 3 Yếm sơ sinh cài vai cotton 2 lớp THT-TomTom Baby- Chất vải cotton mềm mịn, thấm hút tốt",39000,39000,0,0
TIKI,do-choi-me-be,136465362,"Mô hình xe Bugatti Divo 1:24 Maisto - 31526",429000,429000,0,0
TIKI,do-choi-me-be,57449762,"Đồ chơi Mô hình Siku Xe cứu thương 1536",129000,129000,0,0
TIKI,do-choi-me-be,436277,"Kem Đánh Răng Hương Dâu  KuKu KU1087 - 50g",65000,65000,0,0
TIKI,do-choi-me-be,169397515,"GẬY BATONG DÀNH CHO NGƯỜI GIÀ BẰNG GỖ HƯƠNG ĐÁ KT 90×13,5×4CM",999000,999000,0,0
TIKI,do-choi-me-be,48912680,"Sữa Tắm Gội Cho Bé Cetaphil Baby Wash & Shampoo With Organic Calendula 230ml",184000,190000,6000,3
TIKI,do-choi-me-be,143495272,"Bình thìa ăn dặm cho bé 120ml Haakaa. Chất liệu silicone cấp thực phẩm cao cấp, an toàn. Không chứa BPA, PVC và phthalate. Hỗ trợ bé ăn dặm hiệu quả",429000,429000,0,0
TIKI,do-choi-me-be,107971240,"Nước Hoa Hương Tự Nhiên CHICCO Baby Moments Sweet Perfumed Water, Cho Bé Từ 0 Tháng, 100ml",387000,387000,0,0
TIKI,do-choi-me-be,91343548," Gel Tắm Gội Cho Trẻ Sơ Sinh & Em Bé Da Chàm Thể Tạng Mustela 200ml",392000,560000,168000,30
TIKI,do-choi-me-be,2791857,"Serum vitamin C trắng da, đánh bay sạm nám Wonmom 20ml",233000,233000,0,0
TIKI,do-choi-me-be,48324771,"FITOBIMBI APPETITO – SIRO ĂN NGON 3 TÁC ĐỘNG TỪ THẢO DƯỢC CHUẨN HÓA CHÂU ÂU(200ML)",334000,334000,0,0
TIKI,do-choi-me-be,20937011,"Giường lưới trẻ em siêu thoáng VNGL01",308000,430000,122000,28
TIKI,do-choi-me-be,140860006,"Set 5 quần lót bé trai ATUNER QLN024, quần chip bé trai từ 2-8 tuổi, vải cotton co giãn, chất liệu kháng khuẩn, an toàn với làn da, họa tiết dễ thương, tươi sáng – Hàng Chính Hãng",35000,69000,34000,49
TIKI,do-choi-me-be,19775734,"Tranh xếp hình Tia Sáng  Kỷ khủng long ( 63 mảnh)",15725,18500,2775,15
TIKI,do-choi-me-be,92499221,"Lưới tắm sơ sinh cho bé, phao lưới tắm cho trẻ 3D với 3 khóa giữ an toàn, siêu nhẹ và chắc chắn",99000,99000,0,0
TIKI,do-choi-me-be,155785284,"Bộ 6 sách vải PiPoVietnam song ngữ Anh - Việt giúp trẻ phát triển trí thông minh",119000,119000,0,0
TIKI,do-choi-me-be,109209205,"Polyvi Canxi Tăng Chiều Cao Cho Trẻ Với Calxi Glucoheptonate Nhập Khẩu Từ Pháp - Bổ Sung Canxi  Cho Bé Chắc Khỏe Xương - Polyvi Canxi Hộp 20 Ống 10ml",110000,110000,0,0
TIKI,do-choi-me-be,193746523,"Máy hút sữa điện đôi Tommee Tippee Made for Me",4550000,4550000,0,0
TIKI,do-choi-me-be,3230907,"Cũi 3D 6 Cánh Mẹ Vì Bé",1320000,1320000,0,0
TIKI,do-choi-me-be,132899333,"Siro Ăn Ngon Hoa Thiên chai 120ml giúp kích thích hệ tiêu hóa bé ăn ngon hơn",64000,80000,16000,20
TIKI,do-choi-me-be,58770841,"Miếng lót siêu thấm Bobby Newborn 2-40",99800,99800,0,0
TIKI,do-choi-me-be,63940298,"Thông tắc sifa bồn cầu W.C 700gr bicrophot siêu nhanh , cực mạnh 5 phút thế hệ mới cao cấp ",55000,55000,0,0
TIKI,do-choi-me-be,171662517,"Đồ Chơi Bảng Vẽ Thông Minh Clever Hippo Toy ZJ15/PK - Cam Nhạt",269100,299000,29900,10
TIKI,do-choi-me-be,7243425,"Nhà búp bê Ngôi nhà thu nhỏ lắp ghép Home of Helen",269000,450000,181000,40
TIKI,do-choi-me-be,2202163,"Máy đưa võng Sbaby",540000,540000,0,0
TIKI,do-choi-me-be,195284153,"Đồ Chơi Lắp Ráp Mô Hình Nhân Vật Pink Panther - LinkGo 68108 (256 Mảnh Ghép)",100000,100000,0,0
TIKI,do-choi-me-be,96996086,"Bộ Đồ Chơi DISCOVERY Khảo Cổ Truy Tìm Kho Báu 2Pc 1423004801",229000,229000,0,0
TIKI,do-choi-me-be,14846399,"Xe Trượt Scooter AnneLowSon ALS-A003 Đen",880000,880000,0,0
TIKI,do-choi-me-be,15617929,"Gói 50 Khăn sữa vải gạc Thanh Thanh Nhỏ 3 lớp 25x30cm 100% cotton",165000,165000,0,0
TIKI,do-choi-me-be,188145788,"Đồ chơi trẻ em: Lắp ghép, xếp hình Robot biến hình transformer xe đặc chủng DK81103. Kiểu dáng, màu sắc ngẫu nhiên.",143000,230000,87000,38
TIKI,do-choi-me-be,130471891,"Bộ 2 dụng cụ lấy ráy tai cho bé hình thú có đèn soi- Tặng kèm hộp đựng",38000,39000,1000,3
TIKI,do-choi-me-be,99846038,"Đồ chơi mô hình xe đầu kéo container chở xe ô tô  KAVY NO.8810 đầu hợp kim có thể tháo rời tỷ lệ 1:48 - nhiều màu",130000,130000,0,0
TIKI,do-choi-me-be,121326642,"10 Viên vệ sinh lồng máy giặt Denkmit hàng Đức",45000,45000,0,0
TIKI,do-choi-me-be,90117055,"Set 2 Khóa chặn cửa tủ lạnh an toàn cho bé br00498",37000,38000,1000,3
TIKI,do-choi-me-be,17460123,"Sữa bột Nutricare Fine dinh dưỡng y học tăng cường miễn dịch cho bệnh nhân ung thư (400g)",255000,280000,25000,9
TIKI,do-choi-me-be,119617207,"Sữa non cho bé từ 1-9 tuổi Ildong Plus 2 Hàn Bổ sung dinh dưỡng giúp phát triển trí não, xương, răng, tăng sức đề kháng, tiêu hóa tốt - Massel Official",292000,584000,292000,50
TIKI,do-choi-me-be,139296609,"Bàn chải đánh răng trẻ em PIERROT BABY (0- 2 tuổi)",45000,49900,4900,10
TIKI,do-choi-me-be,43781086,"Sữa bột Bellamy's Organic Số 4 (900g)",790000,790000,0,0
TIKI,do-choi-me-be,558552,"Boardgame Ma Sói Character Việt Hóa",114800,140000,25200,18
TIKI,do-choi-me-be,67520389,"Combo 6 Gói Khăn Ướt Yuniku 90 Tờ Không Hương ( 90 Tờ x 6 )",145000,250800,105800,42
TIKI,do-choi-me-be,51235682,"Gen Nịt Bụng Định Hình Cột Sống Lưng Và Hỗ Trợ Giảm Mỡ Bụng Sau Sinh Freesize Wonmom - Giảm Eo Sau Sinh An Toàn",137000,137000,0,0
TIKI,do-choi-me-be,151708815,"Set 3 món đồ chơi công nghệ, xúc xắc kèm gặm nướu Winfun 3024-25-26-27-28",338000,338000,0,0
TIKI,do-choi-me-be,31824289,"Combo 2 hộp Sữa bột Nutifood DiabetCare Gold 900g – DD cho người bị tiểu đường",990000,990000,0,0
TIKI,do-choi-me-be,72820368,"Đồ Chơi Xếp Hình - Ghép Hình Sáng Tạo Khối Nhỏ Gồm 450 Chi Tiết - DK81018",183750,245000,61250,25
TIKI,do-choi-me-be,116665854,"Đồ chơi lắp ráp xếp hình Máy bay chiến đấu Qman 21013 – Máy bay ném bom (557 mảnh ghép) dành cho các bé trên 6 tuổi",369000,459000,90000,20
TIKI,do-choi-me-be,19775794,"Tranh xếp hình Tia Sáng Mẹ con voi ( 63 mảnh)",15725,18500,2775,15
TIKI,do-choi-me-be,178769666,"Sách vải song ngữ Anh - Việt PiPoVietnam kích thích thị giác dành cho bé sơ sinh",23800,23800,0,0
TIKI,do-choi-me-be,143793176,"Nước Giặt Xả Quần Áo Em Bé Docilee 2IN1 3000ml",169000,189000,20000,11
TIKI,do-choi-me-be,140374080,"[TIẾT KIỆM] Hộp 12 Gói Septic - Vi Sinh Xử Lý Hầm Cầu, Bể Phốt Đầy - Bảo Trì Hầm Tự Hoại 1 Năm",999000,999000,0,0
TIKI,do-choi-me-be,192880552,"Bộ đồ chơi giáo dục khám phá khảo cổ hóa thạch khủng long KAVY-82 gồm 12 quả trứng đầy đủ các loại",255000,255000,0,0
TIKI,do-choi-me-be,166159594,"Siro Bổ Sung Kẽm Giúp Trẻ Hấp Thụ Tốt Tăng Sức Đề Kháng Imochild Zinc Nhập Khẩu Ý  ( Chai 100ml )",305000,427000,122000,29
TIKI,do-choi-me-be,16683272,"Sữa bột Nutricare Liver dinh dưỡng y học chuyên biệt cải thiện chức năng gan (400g)",252000,252000,0,0
TIKI,do-choi-me-be,189263673,"Dầu Khuynh Diệp Thái An Plus [An toàn cho cả trẻ sơ sinh] Giúp làm ấm, giảm ho, xua đuổi muỗi (C/25ml)",59000,59000,0,0
TIKI,do-choi-me-be,49379521,"Đồ Chơi Xe Địa Hình Điều Khiển Từ Xa Xe Quân Đội DK81010",102300,165000,62700,38
TIKI,do-choi-me-be,82457877,"[COMBO 3 BỊCH] Bỉm quần Kibie - Tã quần Hàn Quốc size",810000,810000,0,0
TIKI,do-choi-me-be,58579795,"Bóng Montessori Fruits (PiPô Việt Nam)",185000,185000,0,0
TIKI,do-choi-me-be,4103891,"Nước giặt giày thể thao Elmie - 500ml (Hàng nội địa Nhật bản)",116000,116000,0,0
TIKI,do-choi-me-be,73812389,"Sữa Hoàng Gia Úc   cho trẻ từ 1 - 3 tuổi Royal AUSNZ Premium Gold 3 ",643000,680000,37000,5
TIKI,do-choi-me-be,129742605,"Túi nhai ăn dặm, chống hóc cho bé Haakaa. Chất liệu silicone cao cấp, an toàn. Không chứa BPA, PVC và phthalate",429000,429000,0,0
TIKI,do-choi-me-be,2034523,"Sữa Bột Hikid Hương Vani (600g)",500000,500000,0,0
TIKI,do-choi-me-be,105043761,"Kẹo Dẻo Healthy Care Kids Gummy Omega 3 250 Viên Cho Bé Bổ Sung Dinh Dưỡng, Tăng Sức Đề Kháng, Hỗ trợ Tim Mạch, Phát Triển Khả Năng Tư Duy Cho Bé",369000,450000,81000,18
TIKI,do-choi-me-be,181462662,"Bộ ăn dặm khởi đầu Richell Nhật Bản | Baby",489927,489927,0,0
TIKI,do-choi-me-be,53969760,"Sữa Bột Nestlé NAN Nga Optipro 3 (800g) - Mẫu mới",512000,512000,0,0
TIKI,do-choi-me-be,110474625,"Lá sả khô xông nhà diệt khuẩn",15000,15000,0,0
TIKI,do-choi-me-be,73089376,"Combo 10 Gói Khăn Ướt Aiko Kháng Khuẩn 100 tờ/Gói không hương màu Xanh",295000,295000,0,0
TIKI,do-choi-me-be,188908358,"Sữa Thanh Meiji 0-1 Infant Formula Dạng Viên 540g",475000,475000,0,0
TIKI,do-choi-me-be,46041428,"Trò Chơi Trí Tuệ Uno Mattel Games W2085",169000,169000,0,0
TIKI,do-choi-me-be,81602991,"ta dan yubest gold size m 60 mieng",250000,250000,0,0
TIKI,do-choi-me-be,65047146,"Bàn chải đánh răng silicon cho bé Marcus & Marcus, từ 2 tuổi",188000,188000,0,0
TIKI,do-choi-me-be,174849319,"Sữa bột UC2 Platinum Optimum 0+ 800g - Bổ sung bột yến sào và sữa non 24h (giúp bé phát triển toàn diện, dành cho trẻ từ 0-12 tháng tuổi)",478000,478000,0,0
TIKI,do-choi-me-be,146248132,"Váy múa bale co dãn 4 chiều và thấm hút mồ hôi cực tốt cho bé DT108",96000,96000,0,0
TIKI,do-choi-me-be,191500066,"Combo 5 gói Cháo Tươi Baby SG Food 240g (Gà, Thịt Bằm, Bò, Tôm, Lươn)",122000,122000,0,0
TIKI,do-choi-me-be,46202086,"COMBO 2 HỘP SỮA BỘT DIELAC ALPHA GOLD IQ 2 900G (CHO TRẺ TỪ 6 - 12 THÁNG TUỔI)",725000,725000,0,0
TIKI,do-choi-me-be,2636347,"Tắm Gội Toàn Thân Kids Hồng D-Nee Dành Cho Bé Trên 3 Tuổi (400ml)",105000,105000,0,0
TIKI,do-choi-me-be,104140425,"Dụng cụ kéo núm vú Pigeon (Tặng kèm hộp đựng)",100000,100000,0,0
TIKI,do-choi-me-be,57395621,"Đồ chơi Mô hình Siku Xe BMW 645i Convertible 1007",99000,99000,0,0
TIKI,do-choi-me-be,113758112,"Bộ bông ráy tai cho bé cho cảm giác tuyệt đỉnh",137998,137998,0,0
TIKI,do-choi-me-be,57449729,"Bộ Tarot Nature’s Whispers Oracle Bài Bói New",149000,149000,0,0
TIKI,do-choi-me-be,73577611,"Sản Phẩm Dinh Dưỡng Công Thức ColosBaby IQ 1+ 800g - S",490000,490000,0,0
TIKI,do-choi-me-be,58479378,"Serum Hỗ Trợ Trị Mụn Cho Mẹ Bầu Và Sau Sinh 20ml Wonmom",244000,244000,0,0
TIKI,do-choi-me-be,13755869,"Bộ 4 tấm Thảm xốp lót sàn an toàn Thoại Tân Thành hình công chúa (60x60cm)",155000,155000,0,0
TIKI,do-choi-me-be,7351401,"Mô Hình Cầu Thủ Bio Myth - 6 GGO 72321-1",104000,208000,104000,50
TIKI,do-choi-me-be,2791833,"Cốt gừng hạ thổ săn chắc eo sau sinh Wonmom 200ml",188000,188000,0,0
TIKI,do-choi-me-be,112568297,"Xông tắm sau sinh Dao'spa Mama 250ml - DK PHARMA",150000,150000,0,0
TIKI,do-choi-me-be,68027497,"Bình sữa ty siêu mềm tự nhiên Tommee Tippee Closer to Nature 340ml, núm ty đi kèm 3-6 tháng - Hồng",255000,255000,0,0
TIKI,do-choi-me-be,146569117,"Đồ chơi máy bắt hạt đậu  KAVY NO.8807 hình lâu đài kèm vô lăng ô tô có đèn, nhạc và chân đỡ",525000,525000,0,0
TIKI,do-choi-me-be,174847412,"Máy đa năng điện tử Multimax 2",1422000,1422000,0,0
TIKI,do-choi-me-be,19757399,"Tranh xếp hình Tia Sáng NÔ-BI-TA VÀ ĐẢO KỲ DIỆU 2 ( 108 mảnh)",22950,27000,4050,15
TIKI,do-choi-me-be,88923697,"Combo 4 Bàn chải đánh răng trẻ em Curly Sue nhập khẩu Hàn Quốc (Dành cho bé từ 3 đến 8 tuổi)",72000,144000,72000,50
TIKI,do-choi-me-be,103168995,"Bình sữa Wesser cổ hẹp PP 140ml",127000,127000,0,0
TIKI,do-choi-me-be,176747935,"Thảm gấp Umoo Thảm cuộn Umoo 2021 dày 1.5cm Hàng chính hãng",515000,525000,10000,2
TIKI,do-choi-me-be,1514693,"Sữa Asumiru Phát Triển Chiều Cao (Từ 3 đến 16 tuổi)",878000,1250000,372000,30
TIKI,do-choi-me-be,15356099,"Thùng 48 Hộp Sữa Bột Pha Sẵn Vinamilk Dielac Alpha Gold IQ 110ml",385000,385000,0,0
TIKI,do-choi-me-be,54631646,"COMBO 3 GÓI TẢ DÁN MOONY",840000,843000,3000,0
TIKI,do-choi-me-be,115530023,"MONKEY STORIES - Mã học phần mềm tiếng Anh và tặng 3 tháng Monkey Math",599000,599000,0,0
TIKI,do-choi-me-be,104650692,"Sữa bột VNM Diealac Grow Plus step 2+ 900g- dành cho trẻ trên 2 tuổi ",360000,360000,0,0
TIKI,do-choi-me-be,100898331,"Bộ Sưu Tập Khối Rubik 2x2 3x3 4x4 5x5 Tam Giác Biến thể Viền đen cao cấp QiYi",32400,36000,3600,10
TIKI,do-choi-me-be,59143351,"Combo Tiết Kiệm - 4 Gói Khăn Ướt Bobby Care Hương Dịu Nhẹ 100 Tờ/Gói",170000,170000,0,0
TIKI,do-choi-me-be,44435834,"Sữa Bột Hoàng Gia Úc Royal Ausnz Premium Gold Số 1 Bổ Sung Vitamin, Khoáng Chất Cho Trẻ (400G-900G)",660000,660000,0,0
TIKI,do-choi-me-be,56307763,"BÌNH SỮA PIGEON PPSU CỔ HẸP",280000,280000,0,0
TIKI,do-choi-me-be,112255689,"Thùng sữa nước pha sẵn cho bé Nutricare ColosCare tăng cường hệ miễn dịch cho bé từ 1 tuổi (180ml)",608720,608720,0,0
TIKI,do-choi-me-be,57364531,"Kem đánh răng hữu cơ cho bé mới mọc răng Buccotherm 50ml",135000,155000,20000,13
TIKI,do-choi-me-be,74280067,"Nui Rau Củ Hữu Cơ Cho Bé Hình Gấu Teddy 200g Dalla Costa",79000,79000,0,0
TIKI,do-choi-me-be,42688724,"BỘ 4 HỘP SỮA BỘT NGUYÊN KEM VINAMILK DINH DƯỠNG CÓ ĐƯỜNG - GIÚP DUY TRÌ VÀ PHÁT TRIỂN THỂ LỰC - 400G",305000,305000,0,0
TIKI,do-choi-me-be,194420209,"Đồ Chơi Đèn Pin Kể Chuyện Cho Bé MIDEER StoryBook Storch Phiên Bản Mới 12 Truyện - Có File Âm Thanh và Sách Tiếng Việt Kèm Theo",318000,450000,132000,29
TIKI,do-choi-me-be,14170375,"Bộ 4 tấm Thảm xốp lót sàn ECOBABY an toàn cho bé - hình mèo Kitty - kích thước 1 tấm 60x60cm, độ dày khoảng 0,9-1cm",155000,155000,0,0
TIKI,do-choi-me-be,400344,"Xe Xúc Thủy Lực Liebherr Siku - 1874",449000,449000,0,0
TIKI,do-choi-me-be,272322010,"Sữa cho trẻ sơ sinh 0-12 tháng tuổi Meiji Nhật giàu dưỡng chất kèm DHA giúp phát triển cân đối chiều cao, cân nặng, trí não cho bé - OZ Slim Store",704000,1408000,704000,50
TIKI,do-choi-me-be,76673134,"Thú Vương Đại Chiến Zoids - Bộ Trang Bị ZW41 Dash Breaker Unit",246000,259000,13000,5
TIKI,do-choi-me-be,115552878,"Mũ bảo hiểm xe đạp trẻ em, mũ trượt patin, mũ dành cho họat động ngoài trời cao cấp Protec Smile 024 họa tiết Hello Kitty- Màu hồng nhạt",338000,438000,100000,23
TIKI,do-choi-me-be,14176302,"Bàn Chải Đánh Răng Cho Bé Từ 2-8 Tuổi Ku.Ku Duckbill KU1113A",58000,58000,0,0
TIKI,do-choi-me-be,47270017,"Thoái hóa cột sống, thoát vị đĩa đệm, thần kinh tọa, đau nhức xương khớp AN CỐT ĐAN",300000,300000,0,0
TIKI,do-choi-me-be,114612302,"Áo lót cho con bú, áo ngực bầu và sau sinh mở cúc trước tiện lợi. chất liệu cotton co giãn không gọng đệm vừa  chống chảy xệ cho chị em sau sinh",55000,60000,5000,8
TIKI,do-choi-me-be,150937886,"Combo Gốc Thực Vật NGB1 Peace Mass Nước Giặt Xả 2 in 1 3.6 lít + Nước Rửa Chén 500ml",266800,290000,23200,8
TIKI,do-choi-me-be,159383275,"Xe Tập Đi Đa Chức Năng - KUB",1050000,1050000,0,0
TIKI,do-choi-me-be,93553357,"Siêu Địa Hình - Hiệp Sĩ Khiêu Vũ Winka DK81043",465000,620000,155000,25
TIKI,do-choi-me-be,190558282,"Dung Dịch Xả Quần Áo Cho Bé D-nee màu Tím - Tem phụ Công ty Đại Thịnh",200000,205000,5000,2
TIKI,do-choi-me-be,84119416,"Ghế tắm lưới, ghế gội đầu cho trẻ sơ sinh giá rẻ, dụng cụ tắm bé",76700,76700,0,0
TIKI,do-choi-me-be,29167323,"COMBO 2 Hộp BỘT ĂN DẶM RIDIELAC
 GOLD LƯƠN CÀ RỐT ĐẬU XANH - 
HỘP GIẤY 200G",124000,124000,0,0
TIKI,do-choi-me-be,23376968,"Xếp hình Tia Sáng Nàng tiên cá  (48 Mảnh Ghép) - Tặng kèm câu đố mặt sau cho bé",25925,30500,4575,15
TIKI,do-choi-me-be,36711437,"Cờ Domino Ngà Nhỏ",91100,98000,6900,7
TIKI,do-choi-me-be,76143500,"Combo Serum và Kem Dưỡng Da Mụn Cho Mẹ Bầu Và Sau Sinh Wonmom",422000,422000,0,0
TIKI,do-choi-me-be,155700716,"Đồ chơi ghép hình Mideer Puzzle MD3028 – Người đẹp ngủ trong rừng (104 mảnh ghép)",275000,369000,94000,25
TIKI,do-choi-me-be,120562813,"Combo nước rửa bình sữa gói + Dụng cụ vệ sinh bình sữa đa năng Wesser",137280,156000,18720,12
TIKI,do-choi-me-be,106869908,"Rubik trái cây - Rubik hình quả Chuối (Hack IQ mạnh) FX8803",89000,89000,0,0
TIKI,do-choi-me-be,1081578,"Tấm Lót Chống Thấm VIETMAT (180 x 200 cm)",749000,749000,0,0
TIKI,do-choi-me-be,193912076,"Bình tập uống nước có ống hút đáy nặng kháng khuẩn chống tràn, chống sặc Tommee Tippee SuperStar, 300ml, cho bé từ 6 tháng – Xanh lá",275000,275000,0,0
TIKI,do-choi-me-be,77451218,"Trợ Phễu Silicone Mama's Choice NewFit, Đệm Hạ Size Phễu Size 15-17-19-21mm, Hút Sữa Hiệu Quả và Êm Ái - 1 Cái",135000,135000,0,0
TIKI,do-choi-me-be,162060333,"Bô vệ sinh cho bé KidAndMom gấp gọn di động thuận tiện để trong nhà hoặc đi du lịch",249000,386000,137000,35
TIKI,do-choi-me-be,167469632,"Cuộn Dây Bọc Biển Bọc Cạnh Bàn Chống Va Đập , Bịt Góc Bàn , Ghế , Tủ , Gường PaKaSa - Hàng Chính Hãng",59000,98000,39000,40
TIKI,do-choi-me-be,117970432,"Thùng sữa uống dinh dưỡng vị chua Nutricare Metacare Yoyo Hương dâu (110ml x 48 hộp)",229000,242000,13000,5
TIKI,do-choi-me-be,190194625,"[Kèm Video] Mắt Kính Trẻ Em SiPU Chính Hãng MK17 Chống Ánh Sáng Xanh + Chống gãy - Bé Trai Bé Gái (Kèm Hộp Ô Tô)",189000,189000,0,0
TIKI,do-choi-me-be,248651728,"Yến Việt - Cháo yến trẻ em Nest Grow công thức đặc chế cho trẻ suy dinh dưỡng thấp còi, nhiều vị, thùng 30g x 50g",353280,384000,30720,8
TIKI,do-choi-me-be,110694795,"Miếng lót thấm sữa dùng 1 lần Philips Avent",305000,305000,0,0
TIKI,do-choi-me-be,482493,"Đường Luồn Đôi Winwintoys 60352",129000,129000,0,0
TIKI,do-choi-me-be,155315288,"Trang phục nhảy Aerobic trẻ em cho nhóm (Có size người lớn)",126000,126000,0,0
TIKI,do-choi-me-be,35819745,"Sữa Morinaga Chilmil 850G (6 - 36M)",469000,469000,0,0
TIKI,do-choi-me-be,23067495,"SỮA BỘT VINAMILK OPTIMUM MAMA GOLD- HỘP THIẾC 400G",205000,205000,0,0
TIKI,do-choi-me-be,177947316,"Mô hình xe mô tô Ducati X Diavel S 1:12 Maisto 31101",289000,289000,0,0
TIKI,do-choi-me-be,53253108,"Núm Ty Silicon Siêu Mềm Tự Nhiên Cho Bé Tommee Tippee Natural Start Slow Flow 0-3 Tháng (Vỉ đôi)",195000,195000,0,0
TIKI,do-choi-me-be,174864921,"Cháo tươi Sài Gòn Food nếp cẩm đậu đỏ 240g",19500,19500,0,0
TIKI,do-choi-me-be,1391397,"Tranh xếp Hình Tia Sáng  Cung Xử Nữ Tia Sáng (475 Mảnh Ghép)",72800,91000,18200,20
TIKI,do-choi-me-be,42688781,"Bộ 2 Lon Sữa Bột Vinamilk Dielac Grow Plus 2+ - Đỏ Hộp Thiếc 900g",675000,675000,0,0
TIKI,do-choi-me-be,49940877,"Combo 5 túi đồ chơi cát motion sand tặng kèm bộ khuôn làm bánh ",350000,350000,0,0
TIKI,do-choi-me-be,107459984,"BÀN CỜ TƯỚNG CỜ ÚP LIÊN HIỆP THÀNH NEW",177000,177000,0,0
TIKI,do-choi-me-be,187659231,"Đồ chơi trẻ em: Xe Đua F1 điều khiển từ xa Thần Gió DK 81095. Màu ngẫu nhiên",198000,320000,122000,38
TIKI,do-choi-me-be,191500086,"Combo 5 Cháo Tươi Baby SG Food 240g (Gà, Thịt Bằm, Bò, Lươn, Cá Hồi)",122000,122000,0,0
TIKI,do-choi-me-be,184095119,"Tranh xếp Hình Tia Sáng SOCHI - Hòn Ngọc Nước Nga (475 Mảnh Ghép)",72800,91000,18200,20
TIKI,do-choi-me-be,103125918,"Bình sữa PP Wesser 60ml",123000,123000,0,0
TIKI,do-choi-me-be,194468356,"Địu Vải EmBé Sling Dòng Flex Và Flex Plus Màu Olive Cho Bé Từ 0 Đến 24 Tháng Tuổi",990000,990000,0,0
TIKI,do-choi-me-be,19830490,"Xe Ben - Kỹ Thuật Công Trình Có Nhạc, Đèn Duka",143000,230000,87000,38
TIKI,do-choi-me-be,477555,"Đồ Chơi Gỗ Winwintoys - Búa Đập Thỏ 64192",174000,174000,0,0
TIKI,do-choi-me-be,89912180,"Bộ Dung Dịch Vệ Sinh Phụ nữ Lactacyd Odor Fresh Ngăn Mùi 24H 250ml + Sữa Tắm Gội Trẻ em Lactacyd Baby Gentle Care 250ml",181000,195000,14000,7
TIKI,do-choi-me-be,77578090,"Đồ Chơi CoolKids Bảng Vẽ Thông Minh - Hồng  ZJ15/PK",299000,299000,0,0
TIKI,do-choi-me-be,136400954,"FERROLIP BABY – Bổ sung Sắt Hữu Cơ Nhỏ Giọt cho bé sơ sinh",295000,310000,15000,5
TIKI,do-choi-me-be,181462714,"Dụng cụ hút mũi cho bé Richell Nhật Bản | Baby",165927,165927,0,0
TIKI,do-choi-me-be,59058439,"Bình (Bộ Dụng Cụ) Xịt Rữa Mũi Xoang Cho Bé Neilmed Sinus Rinse Paediatric Starter Kit (1 bình + 30 gói hỗn hợp muối rửa)",424000,424000,0,0
TIKI,do-choi-me-be,108957891,"Núm Ty Ngậm Ultra Air Night Ban Đêm, Núm Ty Phát Sáng, Dạ Quang Ban Đêm Philips Avent Bé Từ 6-18 tháng (2 chiếc/hộp)",265000,265000,0,0
TIKI,do-choi-me-be,169312994,"Lều Chơi Cho Bé - Lều Công Chúa Hoàng Tử Hình Hoa Và Ngôi Sao PaKaSa - Hàng Chính hãng",339000,390000,51000,13
TIKI,do-choi-me-be,44013966,"Lớp học Mật ngữ - Siêu Thú Ngân Hà - Trò chơi gia đình nhập vai cung hoàng đạo thu phục siêu thú giải cứu thế giới cực vui!",594100,699000,104900,15
TIKI,do-choi-me-be,72709574,"Nước tắm thảo dược Elemis hộp 20 gói - DK Pharma",150000,150000,0,0
TIKI,do-choi-me-be,55077808,"b.box Disney Bình nước 360 độ cho bé tập uống nước 240ml -  Xanh Lam",295000,295000,0,0
TIKI,do-choi-me-be,41178405,"Bộ 3 Lon Sữa Nucalci Gold bổ sung canxi cho người từ 51 tuổi trở lên - 800g",855000,1250000,395000,32
TIKI,do-choi-me-be,147812977,"Bàn chải đánh răng điện dành cho trẻ em nhãn hiệu Philips Sonicare For Kids HX6322/04 Kết nối Bluetooth trên ứng dụng - HÀNG NHẬP KHẨU",1770000,1770000,0,0
TIKI,do-choi-me-be,107020742,"Đồ chơi Câu Cá Biển Xanh Duka",140000,225000,85000,38
TIKI,do-choi-me-be,179805966,"Đồ chơi lắp ráp lego Qman 42107 - Hộp phát nhạc sáng tạo dành cho bé gái từ 6 tuổi (418 chi tiết)",359000,489000,130000,27
TIKI,do-choi-me-be,75623652,"Mũ Nón Bảo Hiểm Bảo Vệ Đầu Cho Bé & Người Lớn Mẫu Da 3 Cọng - KhoNCC Hàng Chính Hãng - KHK-NBH3S (Nhiều màu, loại)",129000,185000,56000,30
TIKI,do-choi-me-be,86155534,"Bộ chăm sóc mẹ là siêu nhân, khử mùi, phục hồi năng lượng cho mẹ sau sinh Wonmom (1 lá xông + 1 hộp thảo mộc vệ sinh vùng kín cho mẹ)",194000,232000,38000,16
TIKI,do-choi-me-be,52643826,"Lều bóng công chúa , hoàng tử",297000,297000,0,0
TIKI,do-choi-me-be,171555789,"Combo Bình Trữ Sữa và Túi Trữ Sữa Mama’s Choice, Bảo Quản và Trữ Sữa Mẹ, Kiểm Định An Toàn Quốc Tế Bureau Veritas",255000,255000,0,0
TIKI,do-choi-me-be,146518357,"Sữa Glico Icreo Follow Up Milk (Icreo Số 1) - Hộp 10x13,6g/Thanh Tiện Dụng",113000,113000,0,0
TIKI,do-choi-me-be,14379051,"Kẹp gắp đồ Mamachi",168000,168000,0,0
TIKI,do-choi-me-be,2154941,"Mô Hình Máy Bay Trưng Bày Airbus A380 Qantas Airway Everfly QT20 (20cm)",279000,279000,0,0
TIKI,do-choi-me-be,157061258,"Xe tròn tập đi có đồ chơi và nhạc cho bé Mastela W2002 bánh xe cao su hãm di chuyển theo quán tính siêu nhẹ xoay 360 độ",790000,790000,0,0
TIKI,do-choi-me-be,66466220,"Combo 3 Gói Khăn giấy ướt cho trẻ sơ sinh HUGGIES không mùi gói 64 tờ",114000,114000,0,0
TIKI,do-choi-me-be,37809197,"Thực phẩm dinh dưỡng dành cho người cao tuổi Nutifood Enplus Gold 900g",475000,475000,0,0
TIKI,do-choi-me-be,44385880,"Nước rửa cho bé không cần dùng nước thường No Rinse Cleansing Water 300 ml – Thương hiệu Mustela của Pháp",392850,405000,12150,3
TIKI,do-choi-me-be,177420765,"Tấm lót mồ hôi lưng cho bé Goodmama (set 2 cái)",55000,55000,0,0
TIKI,do-choi-me-be,49367434,"Gối chống trào ngược cho bé Rototo Bebe cao cấp nhập khẩu - Loại ripple thiết kế giấu khóa",1690000,1690000,0,0
TIKI,do-choi-me-be,11253495,"Túi Đựng Sữa Mẹ (Trữ Sữa Mẹ) Unimom Compact Không Có BPA UM870251 210ml (30 Túi/Hộp)",69000,69000,0,0
TIKI,do-choi-me-be,184429752,"Xếp hình Tia Sáng  Bayby Shark 2  (48 Mảnh Ghép) - Tặng kèm câu đố mặt sau cho bé",24400,30500,6100,20
TIKI,do-choi-me-be,86783893,"Tã Dán Người Lớn Canny Siêu Thấm Size M10, M/L10, XL10 (10miếng)",68000,79000,11000,14
TIKI,do-choi-me-be,173153312,"Đồng hồ đếm ngược cho bé JC-Timer CHÍNH HÃNG , đồng hồ hẹn giờ cho bé lalunavn - B45",445000,445000,0,0
TIKI,do-choi-me-be,157432658,"Bộ Bài Mạ Vàng 24K Cao Cấp Chất Liệu Đàn Hồi, Bộ Bài Tây Poker Mạ Vàng miDoctor",48000,80000,32000,40
TIKI,do-choi-me-be,129976744,"Combo 2 Núm ty Philips Avent Mô Phỏng tự nhiên dùng cho thức ăn đặc 656.23 rãnh chữ Y phù hợp bé từ 6 tháng tuổi",225000,225000,0,0
TIKI,do-choi-me-be,44803303,"Bình Ủ Sữa Đôi giữ nhiệt cho bé sunbaby BSUA2019",94000,94000,0,0
TIKI,do-choi-me-be,180855714,"Bình Sữa Pigeon Softouch PP Plus Disney Baby - Màu Tím",141000,234000,93000,40
TIKI,do-choi-me-be,2790325,"Kem sữa nghệ toàn thân dưỡng trắng da body, đánh bay thâm rạn hiệu quả Wonmom 180g",293000,350000,57000,16
TIKI,do-choi-me-be,73373320,"Con Quay Hand Fidget Spinner 6 cánh 150-200 giây Legaxi HSM6",141000,141000,0,0
TIKI,do-choi-me-be,87859332,"Khăn Ướt Em Bé Bobby Không Mùi Gói 100 Miếng",35000,35000,0,0
TIKI,do-choi-me-be,174029734,"Đèn LED Trang Trí Để Bàn Kiêm Đèn Ngủ Hình Nhánh Cây Giúp Căn Phòng/ Ngôi Nhà Bạn Trở Nên Lung Linh - Hàng Chính Hãng",282000,380000,98000,26
TIKI,do-choi-me-be,193665996,"Đồ Chơi CUBIC FUN Trẻ Em Xếp Hình 3D Nasa: Tàu Con Thoi Discovery DS1057H",359000,359000,0,0
TIKI,do-choi-me-be,46640186,"Máy Hút Sữa Silicone NatureBond, Số 1 Tại Anh, Canada, Hàng Đầu Hoa Kỳ, Kích Sữa Khi Con Bú, Hít Chặt Ngực Mẹ, Rảnh Tay 100%, Hút Được Khi Nằm, Giảm Tắc Tia Sữa, Silicon Cao Cấp, An Toàn, FDA Chứng Nhận, Model 2020, Dây Da Chống Rơi, Mềm Hơn, Hút Tốt Hơn",499000,499000,0,0
TIKI,do-choi-me-be,129562557,"Hộp đồ chơi trang điểm Toys House 008-917 - đồ chơi hướng nghiệp",269000,269000,0,0
TIKI,do-choi-me-be,19830486,"Xe Cấp Cứu Kết Hợp Ánh Sáng Và Âm Thanh Duka",136000,220000,84000,38
TIKI,do-choi-me-be,272368298,"DHA dầu cá tuyết tinh khiết cho trẻ sơ sinh, trẻ nhỏ Brauer DHA Úc giúp phát triển trí não, tăng khả năng tập trung, cải thiện thị lực-OZ Slim Store",525000,1050000,525000,50
TIKI,do-choi-me-be,52738948,"[Dụng cụ ăn dặm] Set 2 thìa Silicon hình Cú, Thỏ cho bé từ 4 tháng chính hãng Edison - Hàn Quốc",239000,239000,0,0
TIKI,do-choi-me-be,21238255,"Ghế Ăn Dặm Điều Chỉnh Độ Cao Cao Cấp Mastela 1015 - Chính Hãng",1890000,1890000,0,0
TIKI,do-choi-me-be,73259034,"Bịch 8 Miếng Lót Giặt Máy Aiko (30x30) Cho Bé Sơ Sinh, Viền Vải Không Cấn Khi Lót Cho Bé",49000,49000,0,0
TIKI,do-choi-me-be,272446609,"Canxi + Vitamin D cho trẻ 2-11 tuổi Gummies Calcium Vitamin D Nature's Way Úc giúp hỗ trợ xương, răng và cơ bắp khỏe mạnh, cao lớn - OZ Slim Store",292000,584000,292000,50
TIKI,do-choi-me-be,179809061,"Sữa tắm gội cho bé; sữa tắm bé;sữa tắm gội 2in1;sữa tắm gội 2in1 AromaKids-Hương cherry, 750ml/chai ",139000,139000,0,0
TIKI,do-choi-me-be,20859982,"Chặn sữa Spectra ",90000,90000,0,0
TIKI,do-choi-me-be,46910212,"Sữa bột ColosBaby Gold 0+ 336g (Dạng Gói Tiện Lợi)",307211,307211,0,0
TIKI,do-choi-me-be,52696057,"Combo 6 Gói Khăn Ướt AGI Không Hương Chim cánh cụt (100 tờ/6 gói)",250000,250000,0,0
TIKI,do-choi-me-be,195926999,"Bộ nấu cháo trong nồi cơm điện Richell Nhật Bản | Baby",391745,391745,0,0
TIKI,do-choi-me-be,37033217,"Sữa Bột VitaDairy Nepro 2 (900g)",465000,465000,0,0
TIKI,do-choi-me-be,147047364,"Combo 2 hộp sữa non cho bé Colosmulti Biotic hộp 26 gói x 16g chuyên biệt cho trẻ táo bón, tiêu hóa kém",1900000,1900000,0,0
TIKI,do-choi-me-be,178078920,"Siro ăn ngon Ích Nhi Plus cho bé lọ 100ml giúp tăng sức đề kháng,tăng chuyển hóa hấp thu dưỡng chất",72000,72000,0,0
TIKI,do-choi-me-be,197422222,"Set 10 Bịt Ổ Điện Chống Giật, Miếng Chặn Ổ Điện Chống Cháy Bảo Vệ An Toàn Cho Bé - Chính Hãng NAVIVU",30000,30000,0,0
TIKI,do-choi-me-be,74989256,"Núm Ty Ngậm Ultra Air Night (Ban Đêm) Philips Avent Cho Bé Từ 6-18 tháng, 2 chiếc/hộp SCF 376/21 - Màu Ngẫu Nhiên",265000,265000,0,0
TIKI,do-choi-me-be,110092516,"Gối cao su non cho bé cao cấp. Gối Memory Foam chống méo đầu - bẹp đầu - nghẹo cổ em bé. Tặng kẻm vỏ gối dự phòng thay thế",215000,219000,4000,2
TIKI,do-choi-me-be,63279921,"SỮA NON NATRUMAX SPECIAL ( FAMILY ) 800Gram Dành Cho Người Gầy - Ốm",890000,950000,60000,6
TIKI,thiet-bi-kts-phu-kien-so,109393113,"Tai nghe bluetooth nhét tai chống ồn cao cấp V5.0 chính hãng dùng cho iPhone Samsung OPPO VIVO HUAWEI XIAOMI tai nghe không dây Hàng Chính Hãng PKCB",250000,500000,250000,50
TIKI,thiet-bi-kts-phu-kien-so,123836523,"Adapter Sạc 1 Cổng USB Type-C 20W Apple",420000,790000,370000,47
TIKI,thiet-bi-kts-phu-kien-so,73179180,"Thẻ Nhớ microSD SanDisk Ultra 128GB UHS-I - 100MB/s (New 2020) - Hàng Nhập Khẩu",229000,229000,0,0
TIKI,thiet-bi-kts-phu-kien-so,176899932,"Chuột không dây bluetooth Logitech Signature M650 - Hàng chính hãng",625000,878900,253900,29
TIKI,thiet-bi-kts-phu-kien-so,110850007,"Tai nghe nhét tai có dây jack 3.5mm Remax RM-512 (New Package) - Hàng chính hãng",99000,150000,51000,34
TIKI,thiet-bi-kts-phu-kien-so,73315307,"Thẻ Nhớ microSD SanDisk Ultra 64GB UHS-I - 100MB/s (New 2020) - Hàng Nhập Khẩu",139000,139000,0,0
TIKI,thiet-bi-kts-phu-kien-so,142439870,"Cáp sạc Baseus Cafule sạc nhanh dùng cho iPhone - Hàng chính hãng",79000,150000,71000,47
TIKI,thiet-bi-kts-phu-kien-so,1935009,"Tai Nghe Apple EarPods Cổng Lightning - MMTN2",469000,790000,321000,41
TIKI,thiet-bi-kts-phu-kien-so,72796676,"Giá Đỡ Laptop Hợp Kim Nhôm Cao Cấp Có Thể Gấp Gọn, Giúp Tản Nhiệt Laptop, Macbook, Máy Tính Xách Tay. 07 Vị Trí Điều Chỉnh Góc Độ. Hàng Chính Hãng Tamayoko FS060",219000,219000,0,0
TIKI,thiet-bi-kts-phu-kien-so,123838761,"Apple AirPods 2 - MV7N2 - Hộp Sạc Thường",2790000,5390000,2600000,48
TIKI,thiet-bi-kts-phu-kien-so,174593826,"Lót chuột máy tính PixLink kích thước 22x18cm hàng chính hãng",25000,39000,14000,36
TIKI,thiet-bi-kts-phu-kien-so,158868703,"[MIỄN PHÍ 1 NĂM] SIM MAX DATA 4G VIETNAMOBILE 6GB/Ngày. Ưu Đãi Trọn Gói 12 Tháng Không Cần Nạp Tiền - Hàng Chính Hãng",750000,750000,0,0
TIKI,thiet-bi-kts-phu-kien-so,299431,"Chuột Không Dây Logitech M221",229000,229000,0,0
TIKI,thiet-bi-kts-phu-kien-so,56859344,"Chuột không dây sạc điện HXSJ M103 - Hàng chính hãng",119000,199000,80000,40
TIKI,thiet-bi-kts-phu-kien-so,389145,"Chuột không dây Logitech B175 - đầu thu USB 2.4Ghz, pin 1 năm, nhỏ gọn, thiết kế thuận cả 2 tay, phù hợp PC/ Laptop - Hàng chính hãng",173000,179000,6000,3
TIKI,thiet-bi-kts-phu-kien-so,1517005,"Thẻ Nhớ Micro SDHC SanDisk UHS-1 32GB Class 10 - Hàng Chính Hãng",106000,135000,29000,21
TIKI,thiet-bi-kts-phu-kien-so,102782859,"Tai nghe In Ear Remax RM330 - Hàng chính hãng",196000,250000,54000,22
TIKI,thiet-bi-kts-phu-kien-so,134364129,"Bộ Thu Phát Bluetooth TP-Link UB500 USB Nano Bluetooth 5.0 - Hàng Chính Hãng",118000,118000,0,0
TIKI,thiet-bi-kts-phu-kien-so,172146754,"Ốp lưng chống sốc lưng trong phong cách mới dành cho iPhone 11 / 12 / 13 / 11 Pro / 12 Pro / 13 Pro / 11 Pro Max / 12 Pro Max / 13 Pro Max / 12 Mini / 13 Mini - Hàng chính hãng",179000,250000,71000,28
TIKI,thiet-bi-kts-phu-kien-so,71672203,"Thẻ Nhớ microSDHC SanDisk Ultra 32GB UHS-I - 100MB/s (New 2020) - Hàng Nhập Khẩu",88000,88000,0,0
TIKI,thiet-bi-kts-phu-kien-so,1059892,"Dây Cáp Sạc Lightning Cho iPhone Anker PowerLine II 0.9m - A8432H21",219000,330000,111000,34
TIKI,thiet-bi-kts-phu-kien-so,162772687,"Chuột không dây Logitech SIGNATURE M650 Wireless/Bluetooth - Hàng Chính Hãng",630000,630000,0,0
TIKI,thiet-bi-kts-phu-kien-so,174593860,"Chuột Không Dây Bluetooth PIX-LINK P100B Chống Ồn, DPI 1600, Chế Độ Kép Wireless Usb 2.4Ghz, Bluetooth Dùng Cho Macbook, Laptop, PC - Hàng chính Hãng",136000,299000,163000,55
TIKI,thiet-bi-kts-phu-kien-so,123518348,"Tai nghe Remax RM-201 - Hàng chính hãng",104000,150000,46000,31
TIKI,thiet-bi-kts-phu-kien-so,144803533,"Chuột không dây bluetooth Logitech POP Mouse - Hàng chính hãng",590000,890000,300000,34
TIKI,thiet-bi-kts-phu-kien-so,19419738,"Bộ Thu Phát Bluetooth TP-Link UB400 USB Nano Bluetooth 4.0 - Hàng Chính Hãng",119000,189000,70000,37
TIKI,thiet-bi-kts-phu-kien-so,174490279,"Chuột không dây bluetooth Logitech Signature M650 - Dành cho tay có kích cỡ từ nhỏ tới trung bình, Cuộn SmartWheel, giảm ồn, các nút bên có thể tùy chỉnh - Hàng chính hãng",626000,649000,23000,4
TIKI,thiet-bi-kts-phu-kien-so,126697,"Tai Nghe Nhét Tai Sony MDR-EX15AP",199000,199000,0,0
TIKI,thiet-bi-kts-phu-kien-so,123847933,"Apple Pencil 2 - MU8F2",2490000,4890000,2400000,49
TIKI,thiet-bi-kts-phu-kien-so,10198980,"Chuột Không Dây Logitech M220 Silent Plus - Hàng Chính Hãng",259000,259000,0,0
TIKI,thiet-bi-kts-phu-kien-so,1060082,"Dây Cáp Sạc Li.ght.ning Cho i.Phone Anker PowerLine II 1.8m - A8433H22",239000,380000,141000,37
TIKI,thiet-bi-kts-phu-kien-so,299461,"Chuột Không Dây Logitech M331 Silent",389000,389000,0,0
TIKI,thiet-bi-kts-phu-kien-so,36007224,"Bàn phím có dây Dell KB216 USB - Hàng Chính Hãng",172000,180000,8000,4
TIKI,thiet-bi-kts-phu-kien-so,171657209,"Thẻ Nhớ Micro SDXC Samsung Evo Plus U3 130MB/s 128GB New  - Hàng Nhập Khẩu",315000,315000,0,0
TIKI,thiet-bi-kts-phu-kien-so,137864606,"Tấm Lót Chuột, Thảm Da Trải Bàn Làm Việc VinBuy, Miếng Di Chuột Cỡ Lớn 40cmx80cm - Hàng Chính Hãng",109000,180000,71000,39
TIKI,thiet-bi-kts-phu-kien-so,123850440,"Apple AirTag - 1 Pack",725000,890000,165000,19
TIKI,thiet-bi-kts-phu-kien-so,201437484,"Giá Đỡ Máy Tính, Laptop, iPad, Macbook Hợp Kim Nhôm Cao Cấp. Hỗ Trợ Tản Nhiệt Chống Mỏi Cổ, Vai, Gáy. Hàng Chính Hãng Tamayoko",459000,489900,30900,6
TIKI,thiet-bi-kts-phu-kien-so,3671793,"Sim 4G Mobifone 12FD50 Tặng 150GB/Tháng(5GB/Ngày) Trọn Gói 1 Năm- Hàng Chính Hãng - Mẫu ngẫu nhiên",799000,799000,0,0
TIKI,thiet-bi-kts-phu-kien-so,14388590,"Thẻ Nhớ Micro SD Hikvision 32Gb Class 10 - Hàng Chính hãng",83000,95000,12000,13
TIKI,thiet-bi-kts-phu-kien-so,88798139,"Dây Cáp Dù Lõi HDMI 2.1 8K 48Gbps, 4K 165Hz Dài 2M CHOETECH XHH01 Dùng Cho Tivi/ Máy Tính/ Playstation - Hàng Chính Hãng",219000,390000,171000,44
TIKI,thiet-bi-kts-phu-kien-so,56889347,"Chuột Không Dây HXSJ X50 Plus - Hàng Chính Hãng",245000,245000,0,0
TIKI,thiet-bi-kts-phu-kien-so,174593840,"Chuột Không Dây PIX-LINK P100 Wireless 2.4Ghz Sạc Pin, Chống Ồn, DPI1600 Dùng Cho Máy Tính, Laptop, Tivi-Hàng Chính Hãng",89000,230000,141000,61
TIKI,thiet-bi-kts-phu-kien-so,161007768,"Ốp lưng dẻo mỏng dành cho iPhone 11 / 12 / 13 / 11 Pro / 12 Pro / 13 Pro / 11 Pro Max / 12 Pro Max / 13 Pro Max / 12 Mini / 13 Mini - Hàng chính hãng",49000,69000,20000,29
TIKI,thiet-bi-kts-phu-kien-so,181772131,"Tai Nghe Bluetooth Chụp Tai Sony WH-1000XM5 Hi-Res Noise Canceling - Hàng Chính Hãng",6490000,7990000,1500000,19
TIKI,thiet-bi-kts-phu-kien-so,1457747,"Thẻ Nhớ Micro SDXC SanDisk UHS-1 64GB Class 10 - Hàng Chính Hãng",149000,250000,101000,40
TIKI,thiet-bi-kts-phu-kien-so,170273830,"Thẻ nhớ Micro SD Hikvision 32GB 64GB 128GB Class 10 tốc độ 92MB/s - Hàng chính hãng",160000,160000,0,0
TIKI,thiet-bi-kts-phu-kien-so,176752662,"Kính Cường Lực Kingkong iPhone, Màn Nhám Chống Vân Tay Dành Cho Game Thủ - Full Hộp - Hàng Chính Hãng",115000,115000,0,0
TIKI,thiet-bi-kts-phu-kien-so,73324095,"Bộ điều khiển thông minh Google Chromecast with Google TV - Hàng Nhập Khẩu",1350000,1500000,150000,10
TIKI,thiet-bi-kts-phu-kien-so,80857582,"Kính Cường Lực Chống Nhìn Trộm KingKong Dành Cho iPhone - Full Hộp - Dán Full Màn - Hàng Chính Hãng ",33999,67998,33999,50
TIKI,thiet-bi-kts-phu-kien-so,130172342,"Cáp sạc nhanh siêu bền IP 20W Baseus Superior Series Fast Charging Data Cable Type-C to iP PD (480Mbps)-Hỗ trợ sạc nhanh PD 20W trên iPhone 12 / PD 18W trên iP11/ iP XS Max- Hàng chính hãng",109000,109000,0,0
TIKI,thiet-bi-kts-phu-kien-so,359484,"Bàn phím có dây Logitech K120 - Hàng chính hãng",156000,164000,8000,5
TIKI,thiet-bi-kts-phu-kien-so,179541784,"Cáp sạc nhanh siêu bền C to IP Baseus Dynamic Series FAST CHARGING DATA CABLE 20W dùng cho IP 13,12,... - Hàng chính hãng",110000,159000,49000,31
TIKI,thiet-bi-kts-phu-kien-so,167528098,"HUB TYPE C Và HUB USB 3.0 Tốc Độ Cao Chia 4 Cổng VinBuy, HUB Chuyển Đổi Dành Cho Macbook Pro Laptop PC Hỗ Trợ Sạc Pin Kết Nối Đa Năng Ổ Cứng Bàn Phím Chuột Máy In, Thiết Bị Ổ Chia USB - Hàng Chính Hãng",115000,200000,85000,43
TIKI,thiet-bi-kts-phu-kien-so,76067387,"Đầu đọc thẻ nhớ 2.0 Hoco HB20 Mindful - hỗ trợ khe microSD/SD (Hàng chính hãng)",74000,74000,0,0
TIKI,thiet-bi-kts-phu-kien-so,56608719,"Chuột không dây Bluetooth  HXSJ M90 - Hàng chính hãng",99000,185000,86000,46
TIKI,thiet-bi-kts-phu-kien-so,56885648,"Đầu Chuyển Đổi USB Type C Sang USB 3.0 Hàng Chính Hãng Helios",59000,59000,0,0
TIKI,thiet-bi-kts-phu-kien-so,89208874,"Chuột không dây Logitech M330 Silent Plus giảm ồn 90% - USB 2.4GHz, pin 2 năm, phù hợp người thuận tay phải, PC/ Laptop - Hàng chính hãng - Màu Đen",318000,325000,7000,2
TIKI,thiet-bi-kts-phu-kien-so,78010530,"Adapter Củ Sạc CHOETECH PD5005 PD 20W Chuyên Sạc Nhanh iPhone, iPad - Hàng Chính Hãng",199000,300000,101000,34
TIKI,thiet-bi-kts-phu-kien-so,1819263,"Mini Displayport To HDMI Ugreen (10460) - Hàng chính hãng",145000,190000,45000,24
TIKI,thiet-bi-kts-phu-kien-so,195300861,"Cáp ANKER Powerline III Flow USB-C To USB-C - A8552 / A8553 - Siêu Mềm Mại và Bền Bỉ - Hàng Chính Hãng",140000,300000,160000,53
TIKI,thiet-bi-kts-phu-kien-so,113568856,"Tai nghe chụp tai không dây Remax RB-660HB - Hàng chính hãng",700000,700000,0,0
TIKI,thiet-bi-kts-phu-kien-so,145495427,"Thẻ Nhớ Lexar MICRO 633X Tốc Độ 100mb/s - Hàng Chính Hãng",86000,88000,2000,2
TIKI,thiet-bi-kts-phu-kien-so,194458001,"Tai nghe bluetooth nhét tai chống ồn cao cấp V5.3 chính hãng dùng cho iPhone Samsung OPPO VIVO HUAWEI XIAOMI tai nghe không dây - Hàng Chính Hãng PKCB",287000,500000,213000,43
TIKI,thiet-bi-kts-phu-kien-so,49658272,"Đen Xám - Dây cáp sạc nhanh Type-C dài 2M hiệu Baseus Cafule Type C to Type C PD truyền data tốc độ cao  cho Smartphone / Tablet / Macbook / Laptop Type C Samsung Huawei Oppo Xiaomi (3A, 60W, Sạc nhanh PD, Sạc nhanh QC 4.0 Quick Charge)-Hàng nhập khẩu",109000,109000,0,0
TIKI,thiet-bi-kts-phu-kien-so,192977208,"Đồng hồ Thông minh Chống nước IP67 Dành cho Trẻ em nhuẩn AMA Watch Q16S Hàng chính hãng",395000,395000,0,0
TIKI,thiet-bi-kts-phu-kien-so,174599595,"Chuột game có dây Logitech G203 Lightsync - Tùy chỉnh RGB, 6 nút lập trình, nhẹ, 8000 DPI, PC/Mac - Hàng chính hãng",421000,439000,18000,4
TIKI,thiet-bi-kts-phu-kien-so,67517393,"Thẻ Nhớ Camera Hikvision 64Gb Class 10 ( Chuyên dùng cho Camera IP ) - Hàng Chính hãng",100000,100000,0,0
TIKI,thiet-bi-kts-phu-kien-so,154835064,"Đồng hồ Thông minh Trẻ em AMA Watch Q15 lắp SIM nghe gọi 2 chiều 3 màu Xanh Hồng Đen Hàng chinh hãng",400000,400000,0,0
TIKI,thiet-bi-kts-phu-kien-so,107067035,"Thẻ Nhớ SanDisk Ultra MicroSDXC UHS-1 100 MB/s Class 10 32GB/64GB/128GB - Hàng Chính Hãng",115000,141000,26000,18
TIKI,thiet-bi-kts-phu-kien-so,191502436,"Dây Đeo Thay Thế Viền Dành Cho Vòng Đeo Tay Thông Minh Xiaomi Mi Band 5/ Miband 6 - Hàng chính hãng",38000,39000,1000,3
TIKI,thiet-bi-kts-phu-kien-so,53977774,"Phụ kiện giữ dây cáp sạc Giá Silicon mini cố định dây cáp sạc cho các thiết bị điện tử trên bàn làm việc - Hàng Chính Hãng",19000,69000,50000,72
TIKI,thiet-bi-kts-phu-kien-so,111978854,"Hub Chuyển Đổi USB Type C to HDMI CHOETECH HUB-H10 Độ Phân Giải 4K 60Hz, 1080P Cho Tivi/Laptop/Playstation/PC - Hàng Chính Hãng",269000,590000,321000,54
TIKI,thiet-bi-kts-phu-kien-so,112287571,"Đồng Hồ Thông Minh cho Trẻ em 6 tuổi, 7 tuổi, 8 tuổi, 9 tuổi, 10 tuổi, 11 tuổi Lắp Sim Độc lập nghe gọi 2 chiều AMA Watch Y92 Chống nước Định vị Wifi độ chính xác cao Hàng nhập khẩu",525000,577000,52000,9
TIKI,thiet-bi-kts-phu-kien-so,132144149,"Cường Lực Chống Nhìn Trộm KingKong Dành Cho iPhone X-XS, XS Max, iPhone 11, 11Pro, 11ProMax, iPhone 12, 12Mini, 12Pro, 12Pro Max, iPhone 13, 13Mini, 13Pro, 13Pro Max - Dán Full Màn - Hàng Chính Hãng",35000,35000,0,0
TIKI,thiet-bi-kts-phu-kien-so,128678712,"Apple Watch Series 7 GPS Sport Band (Viền Nhôm, Dây Cao Su)",6909000,7990000,1081000,14
TIKI,thiet-bi-kts-phu-kien-so,35420153,"Cáp sạc nhanh, truyền dữ liệu tốc độ cao Baseus Cafule Type C cho Samsung S8/S9/ Note8/ Note9/ Xiaomi/ Huawei/ Oppo/Nokia ( 3A, Sạc nhanh Quick charge 3.0, Siêu bền)- Hàng nhập khẩu",79000,150000,71000,47
TIKI,thiet-bi-kts-phu-kien-so,112087792,"Thẻ nhớ chuyên camera Mirco SD HIKVISION  64G - 32GB - 92MB/s, chuyên ghi hình cho camera, máy ảnh, ... Hàng nhập khẩu",72300,72300,0,0
TIKI,thiet-bi-kts-phu-kien-so,127695415,"Loa Bluetooth HXSJ V6 Bản Mở Rộng Hỗ Trợ Kết Nối Bluetooth 5.0, Thẻ Nhớ, USB, Công suất 2 loa 10W Nhiều Màu Sắc - Hàng chính hãng",299000,549000,250000,46
TIKI,thiet-bi-kts-phu-kien-so,24865067,"Bút laser trình chiếu Slide VSON N35 - Hàng nhập khẩu",165000,165000,0,0
TIKI,thiet-bi-kts-phu-kien-so,88796437,"Dây Cáp Nối Dài Âm Thanh 2 Đầu Đực 3.5mm Dài 1.2M CHOETECH AUX002 - Hàng Chính Hãng",76000,150000,74000,49
TIKI,thiet-bi-kts-phu-kien-so,201437397,"Giá Đỡ Laptop Hợp Kim Nhôm Cao Cấp Dễ Dàng Gấp Gọn, Giúp Tản Nhiệt Laptop, Máy Tính Xách Tay - 07 Nấc Điều Chỉnh Góc Độ. Hàng Chính Hãng Tamayoko",129000,129000,0,0
TIKI,thiet-bi-kts-phu-kien-so,637038,"Chuột Có Dây Dell MS116 (Đen) - Hàng Chính Hãng",119000,119000,0,0
TIKI,thiet-bi-kts-phu-kien-so,191684818,"Tai Nghe Bluetooth True Wireless AMOI F9 Cảm Ứng Vân Tay, Nâng Cấp Dock Sạc có Led Báo Pin Kép - Hàng Nhập Khẩu",89000,99000,10000,10
TIKI,thiet-bi-kts-phu-kien-so,195277333,"Ốp lưng dẻo cho iPhone 8 / SE 2020 / 8 Plus / X / XS / XR / XS Max / 11 / 11 Pro / 11 Pro Max / 12 / 12 Pro / 12 Pro Max / 12 Mini / 13 / 13 Pro / 13 Pro Max / 13 Mini / 14 / 14 Pro / 14 Pro Max / 14 Max -Hàng chính hãng-Photodesign VN",149000,250000,101000,40
TIKI,thiet-bi-kts-phu-kien-so,192364741,"Miếng Lót Chuột ,Bàn Di Chuột Huqu -Chất Liệu Sợi Fiber -Hàng Chính Hãng ",30000,30000,0,0
TIKI,thiet-bi-kts-phu-kien-so,102391960,"Giá Đỡ Máy Tính, Laptop, iPad, Macbook Hợp Kim Nhôm Cao Cấp. Hỗ Trợ Tản Nhiệt Chống Mỏi Cổ, Vai, Gáy. Hàng Chính Hãng Tamayoko",449000,449000,0,0
TIKI,thiet-bi-kts-phu-kien-so,155780905,"Tai nghe có dây nhét tai âm bass sâu Remax RM-620 - Hàng chính hãng",300000,300000,0,0
TIKI,thiet-bi-kts-phu-kien-so,95085073,"Dây Cáp Chuyển Đổi USB Type C To HDMI 4K 60Hz Dài 1.8M CHOETECH CH0019 - Hàng Chính Hãng",349000,590000,241000,41
TIKI,thiet-bi-kts-phu-kien-so,68985833,"Dây sạc Cáp sạc Nam châm Đồng hồ Thông minh Q12, Q16, Q19, Q100, TD26, A28, DS60, DS66, Y95, D06, DF39 Hàng nhập khẩu",47000,47000,0,0
TIKI,thiet-bi-kts-phu-kien-so,188998014,"Ốp Bảo Vệ Chống Sốc Armor TPU PC Cho Airpods 1,2 / Airpods 3/ Airpods Pro/ Airpods Pro 2 Kèm Móc Treo- Hàng Chính Hãng",97000,99000,2000,2
TIKI,thiet-bi-kts-phu-kien-so,189474023,"Sạc dự phòng không dây từ tính Remax RPP-65 10000mAh - Hàng chính hãng",711000,990000,279000,28
TIKI,thiet-bi-kts-phu-kien-so,87675294,"Đồng Hồ Thông Minh Trẻ Em Chống Nước Chuẩn IP67 AMA Watch Q12 Hàng nhập khẩu",280000,280000,0,0
TIKI,thiet-bi-kts-phu-kien-so,157504731,"[Dài 2M] Cáp Sạc Baseus 100W Type-C to Type-C - Hàng Chính Hãng",127000,150000,23000,15
TIKI,thiet-bi-kts-phu-kien-so,107338360,"Bàn Di Chuột - Miếng Lót Chuột Cỡ Lớn Doron-HDC01 Size 40x80, 45x90 cm - Kiêm Deskpad Thảm Da, Trải Bàn Làm Việc Chống Nước Dùng Được Hai Mặt - Hàng Nhập Khẩu",99000,99000,0,0
TIKI,thiet-bi-kts-phu-kien-so,117987260,"Loa Máy Tính Doron V-196 - Âm Thanh Siêu Trầm 4D, Bass Êm - Hàng Chính Hãng",190000,190000,0,0
TIKI,thiet-bi-kts-phu-kien-so,88796298,"Dây Cáp Nối Dài Âm Thanh 3.5mm Dài 2M CHOETECH AUX001-BK - Hàng Chính Hãng",69000,150000,81000,54
TIKI,thiet-bi-kts-phu-kien-so,87106876,"Dây Cáp Sạc Nhanh USB Type C to Type C 100W Dài 1.8M Chuyên Sạc iPhone 15, Macbook, Laptop, Smartphone CHOETECH XCC-1002-GY - Hàng Chính Hãng",169000,280000,111000,40
TIKI,thiet-bi-kts-phu-kien-so,91013563,"Remote Quạt Senko Điều Khiển (Tất Cả Các Loại như TR1683, DR1608, TR1628, DH1600) Hàng Chính Hãng",69000,69000,0,0
TIKI,thiet-bi-kts-phu-kien-so,126032985,"Ốp Lưng Trong Suốt MIPOW TEMPERED GLASS Dành Cho iPhone 13 Mini, Iphone 13/ 13 Pro, 13 Pro Max - Hàng Chính Hãng",70000,290000,220000,76
TIKI,thiet-bi-kts-phu-kien-so,53547831,"Lót chuột  siêu bền 26x21 cm - Hàng chính hãng",19000,19000,0,0
TIKI,thiet-bi-kts-phu-kien-so,895314,"Tai Nghe Nhét Tai Langsdom Super Bass JM26",45000,50000,5000,10
TIKI,thiet-bi-kts-phu-kien-so,110169574,"Thảm Lót Chuột Cỡ Lớn, Dùng Được Hai Mặt - Da PU Chống Nước - Doron HD01 - Kiêm Deskpad Thảm Da, Trải Bàn Làm Việc - Hàng Nhập Khẩu",79000,79000,0,0
TIKI,thiet-bi-kts-phu-kien-so,111983048,"Dây Cáp HDMI 2.1 CHOETECH XHH03-BK Dài 2M Phân Giải Tối Đa 8K 48Gbps, 4K 120Hz Dùng Cho Tivi/Laptop/Playstation/PC - Hàng Chính Hãng",179000,260000,81000,31
TIKI,thiet-bi-kts-phu-kien-so,135410778,"Ốp Lưng Trong Suốt Hoco Dành Cho iPhone - Hàng Chính Hãng ",69000,69000,0,0
TIKI,thiet-bi-kts-phu-kien-so,104268199,"Chuột không dây kiểu đứng sạc pin HXSJ T22 wireless USB 2.4GHz chống mỏi tay chuyên dùng cho pc laptop macbook ipad tivi - Hàng chính hãng",295000,295000,0,0
TIKI,thiet-bi-kts-phu-kien-so,67907870,"Chuột Bluetooth Silent Logitech Pebble M350 - Hàng chính hãng",479000,489000,10000,2
TIKI,thiet-bi-kts-phu-kien-so,72540740,"Ốp lưng dẻo thoát nhiệt dành cho iPhone  XR",49000,69000,20000,29
TIKI,thiet-bi-kts-phu-kien-so,360660,"Bộ Bàn Phím Và Chuột Logitech MK220 Không Dây - Hàng chính hãng",419000,419000,0,0
TIKI,thiet-bi-kts-phu-kien-so,111748361,"Lót chuột phím tắt văn phòng đã Việt hóa khổ lớn cực tiện dụng - Hàng chính hãng",55000,55000,0,0
TIKI,thiet-bi-kts-phu-kien-so,173058453,"Chuột không dây bluetooth Logitech POP MOUSE - giảm ồn, nút emoji tùy chỉnh - Hàng chính hãng",599000,599000,0,0
TIKI,thiet-bi-kts-phu-kien-so,122158068,"Tẩu sạc nhanh 20W trên xe hơi ô tô HOCO Z42 PD QC 3.0 Dành cho điện thoại iPhone iP Samsung Oppo cốc củ cóc sạc oto  - Hàng chính hãng",107000,159000,52000,33
TIKI,thiet-bi-kts-phu-kien-so,7734288,"SIM 4G Mobifone MDT250A Trọn Gói 1 Năm Không Cần Nạp Tiền - Hàng chính hãng - Mẫu ngẫu nhiên",320000,320000,0,0
TIKI,thiet-bi-kts-phu-kien-so,177334663,"Thẻ Nhớ Micro SDXC SanDisk UHS-1 128GB Class 10 100MB/s - Hàng Chính Hãng",259000,480000,221000,46
TIKI,thiet-bi-kts-phu-kien-so,56049649,"CỐC SẠC NHANH 15W 2 CỔNG CHỐNG CHÁY NỔ HOCO C73 - CỦ SẠC ĐA NĂNG 2.4A CHO CÁC DÒNG ĐIỆN THOẠI CHÍNH HÃNG",54000,54000,0,0
TIKI,thiet-bi-kts-phu-kien-so,72725402,"Combo chuột phím không dây Logitech MK295 Silent - Chống ồn 90%, có phím số, mắt đọc cải tiến, bền bỉ, không lag - Hàng chính hãng",590000,790000,200000,25
TIKI,thiet-bi-kts-phu-kien-so,137827548,"Giá Đỡ Điện Thoại, Máy Tính Bảng Selfiecom K10 Dành cho các dòng máy từ 4~13 inch, Với thiết kế gấp gọn đa năng - Hàng Nhập Khẩu",54000,60000,6000,10
TIKI,thiet-bi-kts-phu-kien-so,55210024,"Giá Đỡ Dành Cho Laptop Macbook Để Bàn Chất Liệu Hợp Kim Nhôm Cao Cấp Hàng Nhập Khẩu Helios",215000,215000,0,0
TIKI,thiet-bi-kts-phu-kien-so,270767050,"[Mới 100%] Sim VIETNAMOBILE Chuyên Dùng Để Nghe Gọi & Tạo Tài Khoản TMĐT, Laz, Sope, Sen, Face, ZaL0, Momo, Tw, Tele, X, Game... TK 0đ Giá Rẻ - Cam Kết Sim Chưa Xước Phôi, Chưa Từng Đăng Ký Dịch Vụ Gì. Hàng Chính Hãng",75000,100000,25000,25
TIKI,thiet-bi-kts-phu-kien-so,86018342,"Kính Cường Lực KingKong 9D Trong Suốt Dành Cho iPhone - Full Hộp Sắt Cao Cấp - Dán Full Màn - Hàng Chính Hãng",105999,211998,105999,50
TIKI,thiet-bi-kts-phu-kien-so,158868825,"[FREE 6 Tháng] SIM MAX DATA 4G VIETNAMOBILE 6GB/Ngày + Miễn Phí Gọi Nội Mạng. Trọn Gói 6 Tháng Không Cần Nạp Tiền - Hàng Chính Hãng",268000,500000,232000,46
TIKI,thiet-bi-kts-phu-kien-so,115847303,"Giá Đỡ Để Bàn Điện Thoại Di Động, Máy Tính Bảng. Chất Liệu Hợp Kim Nhôm Cao Cấp. Xoay 270 Độ Tự Do Điều Chỉnh Góc Nhìn Model Z4. Hàng Chính Hãng Tamayoko",79000,79000,0,0
TIKI,thiet-bi-kts-phu-kien-so,195998782,"Cáp sạc và truyền dữ liệu 2.4A Remax RC-138a USB to TypeC  - Hàng chính hãng",52000,99000,47000,47
TIKI,thiet-bi-kts-phu-kien-so,95681232,"Adapter Sạc Anker 1 cổng 65W Hỗ Trợ Sạc Nhanh PIQ 3.0 PowerPort III Pod Lite - A2718 - Hàng chính hãng",499000,750000,251000,33
TIKI,thiet-bi-kts-phu-kien-so,173034520,"Combo chuột phím không dây Logitech MK345 - 1 đầu thu USB, pin lâu, chống tràn, fullsize - Hàng chính hãng",636000,649000,13000,2
TIKI,thiet-bi-kts-phu-kien-so,3416201,"Bảng Vẽ Wacom Intuos S CTL-4100 - Hàng Chính Hãng",2147000,2147000,0,0
TIKI,thiet-bi-kts-phu-kien-so,148813604,"Chuột không dây Logitech M331 SILENT-Hàng chính hãng",397000,397000,0,0
TIKI,thiet-bi-kts-phu-kien-so,356188,"Chuột Có Dây Logitech B100 - Hàng Chính Hãng",98000,98000,0,0
TIKI,thiet-bi-kts-phu-kien-so,97034068,"Tai Nghe Nhét Tai XSmart HiFi S2000 Pro Super Bass Chống Ồn Cực Tốt, Âm Thanh Khủng, Chơi Game Ngon - Hàng Chính Hãng",69000,69000,0,0
TIKI,thiet-bi-kts-phu-kien-so,22633043,"Dây 2 Đầu HDMi 5M UNITEK - Cáp HDMI 5M UNITEK Full HD 4K - Hàng Nhập Khẩu",128500,128500,0,0
TIKI,thiet-bi-kts-phu-kien-so,68467585,"Đồng Hồ Thông Minh Trẻ Em ngôn ngữ Tiếng Việt, Pin sử dụng được 2 ngày, dây đeo có Hoa văn hình Trái tim Dễ thương Model Y85 Pro - Hàng nhập khẩu",490000,490000,0,0
TIKI,thiet-bi-kts-phu-kien-so,183119284,"Case Silicon dành cho Airpods 1,2/ Airpods Pro/ Airpods 3 Hình Chó Cori_ Hàng Chính Hãng",75000,75000,0,0
TIKI,thiet-bi-kts-phu-kien-so,171939157,"Lót chuột Logitech Mouse Pad - Đế cao su chống trượt, lướt dễ dàng, bề mặt chống đổ tràn, bền bỉ, nhỏ gọn - Hàng chính hãng - Màu",220000,220000,0,0
TIKI,thiet-bi-kts-phu-kien-so,175104946,"Thẻ Nhớ Micro SDXC Samsung Evo Plus U3 130MB/s 256GB New - Hàng Nhập Khẩu",480000,480000,0,0
TIKI,thiet-bi-kts-phu-kien-so,130084156,"Cáp sạc cho iPhone/ iPad Baseus Superior Series Fast Charging Data Cable USB to iP (2.4A, 480Mbps, Fast charge, ABS/ TPE Cable)",69000,69000,0,0
TIKI,thiet-bi-kts-phu-kien-so,126003,"Tai Nghe Chụp Tai Sony MDR-ZX310AP",669000,790000,121000,15
TIKI,thiet-bi-kts-phu-kien-so,135412837,"Đế Sạc Nhanh Không Dây Đa Năng 3in1 Remax RP-W53 - Hỗ Trợ Sạc Nhanh Lên Đến 15W - Hàng Chính Hãng",479000,479000,0,0
TIKI,thiet-bi-kts-phu-kien-so,162028506,"Ốp lưng thoát nhiệt dành cho iPhone 11 / 12 / 13 / 11 Pro / 12 Pro / 13 Pro / 11 Pro Max / 12 Pro Max / 13 Pro Max / 12 Mini / 13 Mini - Hàng chính hãng",59000,99000,40000,40
TIKI,thiet-bi-kts-phu-kien-so,10784603,"Tai nghe chuyên game có Mic Plextone G25",195000,215000,20000,9
TIKI,thiet-bi-kts-phu-kien-so,54665,"Chuột không dây Logitech M185 - Hàng chính hãng - Màu",219000,289000,70000,24
TIKI,thiet-bi-kts-phu-kien-so,135716055,"Ốp da cao cấp dành cho iPhone 13 / 13 Pro / 13 Pro Max / 13 Mini - Hàng chính hãng",149000,250000,101000,40
TIKI,thiet-bi-kts-phu-kien-so,138489704,"Găng tay chơi game MEMO - Sợi Carbon cao cấp siêu bền, co dãn, đàn hồi tốt , độ nhạy cao - Hàng nhập khẩu",10000,20000,10000,50
TIKI,thiet-bi-kts-phu-kien-so,72008056,"Đế Sạc Không Dây Apple MagSafe Charger Hỗ Trợ Sạc Nhanh 15W MHXH3 - Trắng",1160000,1990000,830000,42
TIKI,thiet-bi-kts-phu-kien-so,5934053,"Dây Cáp Chuyển Đổi HDMI To VGA Hỗ Trợ Nguồn Ugreen",209000,350000,141000,40
TIKI,thiet-bi-kts-phu-kien-so,900466,"Miếng Lót Chuột Logitech G440 - Hàng Chính Hãng",468000,469000,1000,0
TIKI,thiet-bi-kts-phu-kien-so,33651679,"Ốp Lưng Silicon TPU trong suốt GOR cho Samsung Note 10/ Note 10 Plus_Hàng NHập Khẩu",40000,40000,0,0
TIKI,thiet-bi-kts-phu-kien-so,72818491,"Giá Đỡ Điện Thoại, Máy Tính Bảng Hợp Kim Nhôm Gập Hai Chỗ Có Thể Gấp Gọn Hàng Chính Hãng Tamayoko",249000,249000,0,0
TIKI,thiet-bi-kts-phu-kien-so,25410296,"Chuột Không Dây Wireless 2.4G HXSJ T21 - Hàng chính hãng",249000,249000,0,0
TIKI,thiet-bi-kts-phu-kien-so,74165192,"Giá Đỡ Laptop Đế Tản Nhiệt Laptop Để Bàn Chất Liệu Hợp Kim Nhôm Cao Cấp Tản Nhiệt – Nâng Hạ Điều Chỉnh Độ Cao - Gấp Gọn Cho Kích Cỡ 10-18 Inches Hàng Chính Hãng",599000,599000,0,0
TIKI,thiet-bi-kts-phu-kien-so,73261935,"Giá Đỡ Để Bàn Điện Thoại Di Động, Máy Tính Bảng, Ipad Mini. Chất Liệu Hợp Kim Nhôm Cao Cấp. Hàng Chính Hãng Tamayoko",69000,69000,0,0
TIKI,thiet-bi-kts-phu-kien-so,75655835,"Chuột không dây A2 Pro, chuột máy tính không tạo tiếng ồn, có thể sạc lại, hiệu ứng đèn Led RGB- Hàng nhập khẩu",60000,62800,2800,4
TIKI,thiet-bi-kts-phu-kien-so,45579046,"Adapter Sạc 2 Cổng Tích Hợp Type-C In/Out Hỗ Trợ Sạc Nhanh PD Power Delivery 61W RAVPower RP-PC105 - Hàng Chính Hãng",469000,850000,381000,45
TIKI,thiet-bi-kts-phu-kien-so,112984330,"Giá Đỡ Laptop Để Bàn Hợp Kim Nhôm Cao Cấp - Gấp Gọn Tiện Lợi - Tản Nhiệt Mang Đến Góc Độ Nhìn Khoa Học Khi Làm Việc Học Tập-Hàng Chính Hãng",298000,298000,0,0
TIKI,thiet-bi-kts-phu-kien-so,3237483,"Bàn Phím Gaming DareU LK145 USB - Hàng Chính Hãng",380000,380000,0,0
TIKI,thiet-bi-kts-phu-kien-so,192127239,"Đầu Chuyển Đổi USB Type C Sang USB 3.0 Hàng Chính Hãng, Hub Type C, Hub chuyển đổi USB Type-C Sang USB 3.0 - Hàng Chính Hãng",45000,90000,45000,50
TIKI,thiet-bi-kts-phu-kien-so,191501918,"Dây Cao Su Thay Thế cho Samsung Galaxy Fit 2 (SM-R220)- Hàng chính hãng",75000,75000,0,0
TIKI,thiet-bi-kts-phu-kien-so,87107826,"Dây Cáp Sạc Type C To Lightning CHOETECH IP0039 MFI C94 Dài 1.2M Sạc Nhanh 20W Dành Cho iPhone 11, 12, IP13, IP14, Cho iPad - Hàng Chính Hãng",269000,450000,181000,40
TIKI,thiet-bi-kts-phu-kien-so,145124952,"Kính cường lực full màn hình Hoco G5 cho iPhone 13/ 13 pro/ 13 pro max - Hàng nhập khẩu",26000,51998,25998,50
TIKI,thiet-bi-kts-phu-kien-so,213490729,"Tai Nghe Bluetooth Soundpeats TrueAir3 Game Mode QCC3040, Đèn báo cảm biến tai đeo - Hàng Nhập Khẩu",689000,689000,0,0
TIKI,thiet-bi-kts-phu-kien-so,103637245,"Dây sạc type C to C PROLiNK GCC_60_01 dài 1M, sạc siêu nhanh 60W, dành cho Samsung, Xiaomi, iPad Pro - Hàng chính hãng",79000,100000,21000,21
TIKI,thiet-bi-kts-phu-kien-so,180912,"Bàn Phím Bluetooth Logitech K380 - Hàng Chính Hãng",699000,699000,0,0
TIKI,thiet-bi-kts-phu-kien-so,47470738,"Giá đỡ điện thoại kẹp điện thoại cao cấp 126  - Hàng Chính Hãng",89500,159000,69500,44
TIKI,thiet-bi-kts-phu-kien-so,87108370,"Dây Cáp Sạc Nhanh USB Type C To Type C 60W Dài 1.2M Hỗ Trợ Sạc Nhanh iPhone 15 CHOETECH XCC-1003 - Hàng Chính Hãng",99000,210000,111000,53
TIKI,thiet-bi-kts-phu-kien-so,69238917,"Dây cáp sạc nhanh 100W chuẩn PD 2.0 Type C to type-c QC 3.0 hiệu Baseus Cafule type c to Type C cho iPad Pro 2018 / 2020 / Samsung / Huawei / Xiaomi / Tablet / Macbook / Laptop Type C - Hàng nhập khẩu",150000,259000,109000,42
TIKI,thiet-bi-kts-phu-kien-so,195531282,"Ốp lưng dành cho iPhone 14 / 14 Max / 14 Pro / 14 Pro Max - Hàng chính hãng",179000,250000,71000,28
TIKI,thiet-bi-kts-phu-kien-so,77673897,"Tai Nghe Bluetooth Nhét Tai True Wireless Không Dây PKCB - Hàng Chính Hãng H309",155000,500000,345000,69
TIKI,thiet-bi-kts-phu-kien-so,1011253,"Tai Nghe Chụp Tai Logitech H370 - Hàng Chính Hãng",595000,595000,0,0
TIKI,thiet-bi-kts-phu-kien-so,130448805,"Tai nghe Hoco M60 Perfect với cáp đàn hồi cao TPE mic -Hàng nhập khẩu",68000,75000,7000,9
TIKI,thiet-bi-kts-phu-kien-so,194193205,"Tai Nghe Bluetooth Không Dây True Wireless - Cảm Ứng Nhạy - 3 Chế Độ Chuyển Đổi Normal - Transparency - Chống Ồn Chủ Động ANC - Chất Âm Chuẩn HiFi TCT-S10 - Hàng Chính Hãng",880000,990000,110000,11
TIKI,thiet-bi-kts-phu-kien-so,72636913,"Jack chuyển Type C to 3.5 chính hãng Baseus chính hãng",109000,109000,0,0
TIKI,thiet-bi-kts-phu-kien-so,190565076,"Ốp Case LOLIFO Kai Protective Dành Cho Airpods 3 và Airpods PRO Khoá Thông Minh- Hàng chính hãng",153000,159000,6000,4
TIKI,thiet-bi-kts-phu-kien-so,156634748,"	Cáp Sạc truyền dữ liệu 2.4 chống dối, dây dù dành cho Iphone,Ipad Hoco X14 Giao màu ngẫu nhiên- Hàng chính hãng",31000,31900,900,3
TIKI,thiet-bi-kts-phu-kien-so,19772753,"Dây cáp sạc nhanh Type-c truyền data tốc độ cao Baseus Cafule Type C to Type C PD cho Smartphone / Tablet / Macbook / Laptop Type C (3A, 60W, Sạc nhanh PD, Sạc nhanh QC 4.0 Quick Charge)",99000,99000,0,0
TIKI,thiet-bi-kts-phu-kien-so,7739073,"SIM 4G Vinaphone D500 Trọn Gói 1 Năm Tặng 5GB/Tháng - Hàng Chính Hãng- Mẫu Ngẫu Nhiên",419000,419000,0,0
TIKI,thiet-bi-kts-phu-kien-so,227386,"Pin Sạc Dự Phòng Anker PowerCore 20100mAh - A1271",799000,1400000,601000,43
TIKI,thiet-bi-kts-phu-kien-so,74860644,"Tai Nghe Bluetooth Cảm Ứng Thông Minh - Hàng Chính Hãng",180000,500000,320000,64
TIKI,thiet-bi-kts-phu-kien-so,191377941,"Chuột Không Dây Ôtô Huqu V1- Kết Nối Không Dây 2.4Ghz- Hàng Chính Hãng",134000,140000,6000,4
TIKI,thiet-bi-kts-phu-kien-so,58251130,"Tai Nghe Gaming Dareu EH416 RGB (Phiên Bản Nâng Cấp Với Led RGB) - Hàng Chính Hãng",368000,368000,0,0
TIKI,thiet-bi-kts-phu-kien-so,149499376,"Chuột không dây văn phòng Newmen F266 - Hàng Chính Hãng - Màu vàng",170000,170000,0,0
TIKI,thiet-bi-kts-phu-kien-so,191354473,"Chuột Không Dây Mô Hình Ôtô Huqu V2-Kết Nối USB  2.4GHz -Hàng Chính Hãng",191000,230000,39000,17
TIKI,thiet-bi-kts-phu-kien-so,11443614,"Sim 4G Vinaphone D500 Vào Mạng Trọn Gói 1 Năm Miễn Phí Không Nạp Tiền - Mẫu ngẫu nhiên",419000,419000,0,0
TIKI,thiet-bi-kts-phu-kien-so,191389901,"Chuột Máy Tính Bọ Cạp Huqu HQ-T37-Tương Thích Với Nhiều Hệ Điều Hành -Hàng Chính Hãng",394000,410000,16000,4
TIKI,thiet-bi-kts-phu-kien-so,106902314,"Đế sạc nhanh không dây dạng đứng Remax WK WP-U84 công suất 10W",250000,250000,0,0
TIKI,thiet-bi-kts-phu-kien-so,117070803,"Tai nghe chụp tai Gaming tích hợp Mix HXSJ F16 RGB âm thanh 3D Bass cực đã chuyên dùng nghe nhạc, chơi game - Hàng chính hãng",299900,599000,299100,50
TIKI,thiet-bi-kts-phu-kien-so,113063452,"Ốp lưng chống sốc phong cách mới dành cho iPhone 11 / 12 / 11 Pro / 12 Pro / 11 Pro Max / 12 Pro Max - Hàng chính hãng",129000,199000,70000,35
TIKI,thiet-bi-kts-phu-kien-so,183513216,"Chuột công thái học không dây Logitech Lift Vertical - Bluetooth|USB Logi Bolt, Silent giảm ồn, 4 nút tùy chỉnh, tương thích với Windows/macOS/iPad/PC - Hàng chính hãng",1250000,1270000,20000,2
TIKI,thiet-bi-kts-phu-kien-so,187118836,"Bộ 2 miếng kính cường lực Gor cho iPhone 13 Mini / 13 / 13 Pro / 13 Pro Max - Full Box - Gor - Hàng chính hãng",109000,109000,0,0
TIKI,thiet-bi-kts-phu-kien-so,196187316,"Chuột Không Dây Hình  OTO Huqu V3- Độ Phân Giải Quang Học 1200DPI- Hàng Chính Hãng",225000,270000,45000,17
TIKI,thiet-bi-kts-phu-kien-so,88073058,"Túi chống nước UAG WaterProof cho điện thoại - Hàng Chính Hãng",120000,200000,80000,40
TIKI,thiet-bi-kts-phu-kien-so,195166291,"Case ốp cho Samsung Galaxy Buds 2 Pro/ Buds 2/ Buds Pro/ Buds Live TPU Kai Trong Suốt Animal Kèm Móc Treo_ Hàng Chính Hãng",86000,90000,4000,4
TIKI,thiet-bi-kts-phu-kien-so,88778021,"Ốp Lưng Silicon TPU trong suốt GOR cho Samsung Galaxy S21 / S21 Plus / S21 Ultra - Hàng Nhập Khẩu",38000,38000,0,0
TIKI,thiet-bi-kts-phu-kien-so,149797747," Đồng Hồ Thông Minh Trẻ em AMA Q12S Model mới nhất ra mắt tháng 12/2021 - Hàng nhập khẩu",591000,591000,0,0
TIKI,thiet-bi-kts-phu-kien-so,115105450,"Thiết Bị Đọc Thẻ Nhớ ROBOT CR102 USB 3.0/Khe Cắm Thẻ Nhớ SD/Micro SD 5.0 - Hàng Chính Hãng",98100,109000,10900,10
TIKI,thiet-bi-kts-phu-kien-so,8004965,"Cáp Sạc Nhanh Micro USB Cho Smartphone Android 2.4A Baseus Cafule",54499,54499,0,0
TIKI,thiet-bi-kts-phu-kien-so,91412768,"[Hàng nhập khẩu] Bộ vệ sinh Laptop, Macbook Cao Cấp JRC 5 Trong 1",200640,228000,27360,12
TIKI,thiet-bi-kts-phu-kien-so,115786359,"Giá Đỡ Để Bàn Dành Cho Laptop, Máy Tính Xách Tay Chất Liệu Hợp Kim Nhôm Cao Cấp Model HL001- Hàng Chính Hãng Tamayoko",249000,249000,0,0
TIKI,thiet-bi-kts-phu-kien-so,152810169,"Cáp sạc nhanh, truyền dữ liệu tốc độ cao Baseus Cafule Type C cho Samsung S9/S10/ Note8/ Note9/ Xiaomi/ Huawei/ Oppo/Nokia ( 3A, Sạc nhanh Quick charge 3.0, Siêu bền) - Hàng Chính Hãng",64000,64000,0,0
TIKI,thiet-bi-kts-phu-kien-so,15677446,"Tai Nghe Gaming Có Mic Plextone G20 New Edition - Hàng Chính Hãng",165000,165000,0,0
TIKI,thiet-bi-kts-phu-kien-so,93395080,"Adapter Củ Sạc 38W CHOETECH PD5002 USB-A Quick Charge 3.0, USB Type C PD 20W - Hàng Chính Hãng",249000,500000,251000,50
TIKI,thiet-bi-kts-phu-kien-so,72907962,"Giá Đỡ Laptop, Máy Tính Bảng Hợp Kim Nhôm 7 Mức Điều Chỉnh Chiều Cao Thông Thoáng Hỗ Trợ Tản Nhiệt Hàng Chính Hãng Tamayoko",255000,259000,4000,2
TIKI,thiet-bi-kts-phu-kien-so,174673994,"Miếng Vải Lót Phím Microfiber dành cho Macbook chống bụi bẩn bàn phím, vệ sinh màn hình Macbook",99000,99000,0,0
TIKI,thiet-bi-kts-phu-kien-so,91865173,"Bàn phím cơ E-DRA EK384 Led RGB - Hàng chính hãng",799000,799000,0,0
TIKI,thiet-bi-kts-phu-kien-so,57705006,"Micro karaoke kèm Loa bluetooth nhập khẩu cao Cấp Cắm thẻ nhớ 3 trong 1 Hàng chính hãng",875000,1100000,225000,20
TIKI,thiet-bi-kts-phu-kien-so,195915487,"Thẻ Nhớ MicroSDXC SanDisk Extreme Pro V30 A2 128GB 200MB/s SDSQXCD-128G (New 2022) - Hàng Nhập Khẩu",425000,425000,0,0
TIKI,thiet-bi-kts-phu-kien-so,32400627,"Lót Chuột Chữ Nhật Có Kê Tay Họa Tiết Dễ Thương 17.5 x 21.5 cm",85000,85000,0,0
TIKI,thiet-bi-kts-phu-kien-so,185409375,"Bao Case Dành Cho Airpods 3/ Airpods Pro Kai TPU Họa Tiết Kaws- Hàng Chính Hãng",95000,99000,4000,4
TIKI,thiet-bi-kts-phu-kien-so,766342,"Dây Cáp Âm Thanh AUX 3.5mm Anker 2.4m - A8220011 (Đen) - Hàng Chính Hãng",122000,180000,58000,32
TIKI,thiet-bi-kts-phu-kien-so,147400127,"Thiết bị thu phát âm thanh Usb bluetooth 5.0 âm thanh đa chức năng jack cắm 3.5mm  KitAcoom cho loa, ô tô tai nghe bluetooth, biến loa thường thành loa Bluetooth, Hàng Chính Hãng",92999,99999,7000,7
TIKI,thiet-bi-kts-phu-kien-so,89692612,"Tai nghe Bluetooth 5.0 không dây Bluetooth chống nước Tai nghe âm thanh nổi TWS - Hàng Chính Hãng PKCB",107000,500000,393000,79
TIKI,thiet-bi-kts-phu-kien-so,118722616,"Chuột có dây LOGITECH B100 - Hàng chính hãng",75000,75000,0,0
TIKI,thiet-bi-kts-phu-kien-so,168918231,"Ốp Lưng Nillkin CamShield Armor cho Samsung Galaxy S22 Ultra - Hàng Nhập Khẩu",299000,299000,0,0
TIKI,thiet-bi-kts-phu-kien-so,185946121,"Bàn phím cơ không dây E-DRA EK361W V2 (Black/White/Bluetooh) -Hàng Chính Hãng",789000,789000,0,0
TIKI,thiet-bi-kts-phu-kien-so,763106,"Cáp HDMI Ugreen HD104 10110 (10m) - Đen - Hàng Chính Hãng - Hàng Chính Hãng",321000,350000,29000,8
TIKI,thiet-bi-kts-phu-kien-so,184132996,"Cốc Sạc Đa Năng 3 Cổng Sạc Baseus Compact Charger 17W - Hàng chính hãng",136000,149500,13500,9
TIKI,thiet-bi-kts-phu-kien-so,11212346,"Chuột Fuhlen Gaming G90 - Hàng chính hãng",353000,353000,0,0
TIKI,thiet-bi-kts-phu-kien-so,536965,"Tai nghe chụp tai Logitech H111 - Hàng chính hãng",175000,179000,4000,2
TIKI,thiet-bi-kts-phu-kien-so,135284107,"Headphone Tai Nghe Chụp Tai bluetooth Rockspace O2 kết nối không dây có mic nghe nhạc liên tục 15h - Hàng chính hãng bảo hành 12 tháng",475000,595000,120000,20
TIKI,thiet-bi-kts-phu-kien-so,584798,"Webcam Logitech C922 Full HD 1080p - 720p/60FPS micro kép to rõ, tự động lấy nét và chỉnh sáng HD, phù hợp PC/ Laptop/ Mac - Hàng chính hãng",2299000,2299000,0,0
TIKI,thiet-bi-kts-phu-kien-so,56033,"Chuột Không Dây Logitech M187 - Hàng chính hãng",265000,265000,0,0
TIKI,thiet-bi-kts-phu-kien-so,187657388,"Case Dành Cho Airtag Chống sốc Hình Animal Kai- Hàng Chính Hãng",53000,55000,2000,4
TIKI,thiet-bi-kts-phu-kien-so,177613972,"Tai nghe Bluetooth TWS không dây Jlab Go Air Pop thời gian nghe 32H EQ3 Sound chuẩn IPX4 chống ồn tích hợp dây sạc - Hàng chính hãng BH đổi mới 2 năm",445000,890000,445000,50
TIKI,thiet-bi-kts-phu-kien-so,74890302,"Ốp lưng da chống sốc dành cho iPhone 7 / 8 / SE 2020 / 7 PLUS / 8 PLUS / X / XS / XS MAX / XR / 11 / 11 PRO / 11 PRO MAX / 12 MINI / 12 / 12Pro / 12 Pro Max - Hàng chính hãng",119000,199000,80000,40
TIKI,thiet-bi-kts-phu-kien-so,71505389,"Đồng hồ Điện thoại có 7 GAME Giải trí, Hỗ trợ Thẻ nhớ 32G Music, lắp Sim không cần Đăng ký 4G, Thêm danh bạ dễ dàng không cần ứng dụng - Hàng nhập khẩu",450000,570000,120000,21
TIKI,thiet-bi-kts-phu-kien-so,75582647,"Bộ Cốc sạc và Cáp sạc nhanh Baseus Super Si PD 20W CCCJGCC for iPhone 12 (Hàng chính hãng)",299000,299000,0,0
TIKI,thiet-bi-kts-phu-kien-so,554912,"Chuột Chơi Game Có Dây Logitech G102 8000DPI RGB 6 Phím - Hàng Chính Hãng",418000,429000,11000,3
TIKI,thiet-bi-kts-phu-kien-so,35277311,"Giá Đỡ Điện Thoại Thông Minh Hoco CAD01 - Hàng Chính Hãng",149000,149000,0,0
TIKI,thiet-bi-kts-phu-kien-so,141502002,"[Xả Kho]Sim 4G mobifone  sim mạng 1 năm không phải nạp tiền",286000,298000,12000,4
TIKI,thiet-bi-kts-phu-kien-so,105829753,"(Tặng túi đựng TOPK) Củ sạc nhanh Baseus mini 20W, hai cổng sạc USB và Type-C sạc nhanh cho iPhone, Samsung, Xiaomi, Huawei,...-Hàng chính hãng",175000,189000,14000,7
TIKI,thiet-bi-kts-phu-kien-so,188318615,"Case Ốp Bảo Vệ Gấu Nice dành cho Tai Nghe AIRPODS 3/Airpods Pro/Airpods 1/2 Kèm Khóa treo hình- Hàng chính hãng",105000,109000,4000,4
TIKI,thiet-bi-kts-phu-kien-so,196946349,"Ốp Lưng dành cho iPhone 14 / 14 Plus / 14 Pro / 14 ProMax Nillkin S.Frosted Shield Pro- Hàng chính hãng",191000,199000,8000,4
TIKI,thiet-bi-kts-phu-kien-so,179444874,"Ốp lưng chống sốc dành cho iPhone 11 / 12 / 13 / 11 Pro / 12 Pro / 13 Pro / 11 Pro Max / 12 Pro Max / 13 Pro Max / 12 Mini / 13 Mini - Hàng chính hãng",79000,150000,71000,47
TIKI,thiet-bi-kts-phu-kien-so,136818264,"Ốp lưng kéo nắp kiểu mới dành cho iPhone 11 / 12 / 13 / 14 / 11 Pro / 12 Pro / 13 Pro / 14 Pro / 11 Pro Max / 12 Pro Max / 13 Pro Max / 14 Pro Max / 12 Mini / 13 Mini / 14 Plus - Hàng chính hãng",99000,150000,51000,34
TIKI,thiet-bi-kts-phu-kien-so,73837518,"Tai Nghe Không Dây True Wireless Nhét Tai – Hàng Chính Hãng",221000,500000,279000,56
TIKI,thiet-bi-kts-phu-kien-so,29238111,"Tai Nghe Bluetooth True Wireless TaoTronics SoundLiberty 53 (TT-BH053) - Hàng Chính Hãng",950000,950000,0,0
TIKI,thiet-bi-kts-phu-kien-so,151605868,"Chuột Không Dây Chống Ồn Genius NX-8000S - Hàng Chính Hãng ",179000,179000,0,0
TIKI,thiet-bi-kts-phu-kien-so,109455098,"Cáp sạc nhanh PD20W truyền dữ liệu Baseus Metal Data Type-C sang iPhone ( 2 size ) - Hàng chính hãng",139000,250000,111000,44
TIKI,thiet-bi-kts-phu-kien-so,192376330,"Vỏ Ốp silicon bọc bút dành cho Apple Pencil 2 Hình Mèo Carton- Hàng chính hãng",85000,89000,4000,4
TIKI,thiet-bi-kts-phu-kien-so,109983015,"Cáp sạc iPhone Baseus Superior Series Fast Charging Data Cable (2.4A, 480Mbps, Fast charge, ABS/ TPE Cable) -  Hàng Chính Hãng ",78999,78999,0,0
TIKI,thiet-bi-kts-phu-kien-so,134656521,"USB OTG SanDisk Ultra Dual Drive m3.0 - Hàng Chính Hãng",100000,100000,0,0
TIKI,thiet-bi-kts-phu-kien-so,1570185,"Bảng Vẽ Wacom Intuos Pro Medium PTH-660",8890000,8890000,0,0
TIKI,thiet-bi-kts-phu-kien-so,108202304,"Củ sạc nhanh chuẩn kép PD+QC 20W Remax RP-U64 - Hàng chính hãng",239000,239000,0,0
TIKI,thiet-bi-kts-phu-kien-so,197387432,"Ốp Lưng MIPOW SOFT TPU CRYSTAL CLEAR Nguyên Liệu Đức (DROPTEST 1.8M, Chống Ố Vàng) dành cho iPhone 14 / iPhone 14 Plus/ iPhone 14 Pro/ iPhone 14 ProMax- Hàng chính hãng",240000,240000,0,0
TIKI,thiet-bi-kts-phu-kien-so,197653378,"Ốp lưng Trong Suốt dành cho Samsung Galaxy Z Flip 4 Chống Sốc, Chống Ố Vàng - Hàng chính hãng",111099,111099,0,0
TIKI,thiet-bi-kts-phu-kien-so,63536208,"Túi chống nước điện thoại đi biển, bao đựng điện thoại chống nước cao cấp 4 lớp, đạt chuẩn chất lượng GoodFit GF202WP - Hàng chính hãng",79000,120000,41000,34
TIKI,thiet-bi-kts-phu-kien-so,190703469,"Túi chống sốc 2 ngăn vải chống thấm đựng ổ cứng di động size 2.5inch, máy chụp hình du lịch, phụ kiện cáp sạc - Hàng chính hãng",54000,54000,0,0
TIKI,thiet-bi-kts-phu-kien-so,184297059,"Bao da dành cho SamSung Galaxy Tab A7 Lite T225/T220 chính hãng Onjess lưng silicone mềm - Hàng chính hãng",222000,222000,0,0
TIKI,thiet-bi-kts-phu-kien-so,70524690,"Giá Đỡ Máy Tính Laptop Macbook Hợp Kim Nhôm Cao Cấp Giúp Tản Nhiệt Có Thể Tháo Rời Hàng Chính Hãng Tamayoko",390000,600000,210000,35
TIKI,thiet-bi-kts-phu-kien-so,197620972,"Ốp lưng Trong Suốt dành cho Samsung Galaxy Z Fold 4 Chống Sốc, Chống Ố - Hàng chính hãng",107135,107135,0,0
TIKI,thiet-bi-kts-phu-kien-so,103660293,"Dây sạc type A To C PROLiNK GCA_40_01 dài 1M, sạc siêu nhanh 40W, dành cho iPad, Samsung, Huawei, Xiaomi - Hàng chính hãng",79000,110000,31000,28
TIKI,thiet-bi-kts-phu-kien-so,150937588,"Cáp Sạc Nhanh 20W Dành Cho iPhone Remax RC-171, Chuẩn TypeC to IP,  Sử Dụng Chip E-marker, Chống Sạc Quá Tải, Chống Gãy Cáp - Hàng Chính Hãng",113000,139000,26000,19
TIKI,thiet-bi-kts-phu-kien-so,144534656,"Loa Thanh LG 2.1ch SP2 (100W) - Hàng chính hãng",1190000,1190000,0,0
TIKI,thiet-bi-kts-phu-kien-so,105144403,"Ốp lưng chống sốc toàn phần dành cho iPhone 12 Mini / 12 / 12 pro / 12 Pro Max - Hàng chính hãng",9000,18000,9000,50
TIKI,thiet-bi-kts-phu-kien-so,15665489,"Dây Cáp Sạc Li.ght.ning Chuẩn M.F.i Cho i.Phone Anker Li.ght.ning PowerLine Select+ A8012 0.9m / A8013 1.8m - Hàng Chính Hãng",350000,360000,10000,3
TIKI,thiet-bi-kts-phu-kien-so,53631890,"Miếng lót chuột, Pad chuột 90x40 cm Siêu rộng - Hàng chính hãng",68000,68000,0,0
TIKI,thiet-bi-kts-phu-kien-so,68823687,"Giá Đỡ Để Bàn Máy Tính Bảng Ipad Điện Thoại (Lớn) Hợp Kim Nhôm Cao Cấp - Điều Chỉnh Góc Độ - Trục Kép- Gấp Lại Tiện Lợi Hàng Chính Hãng",379000,399000,20000,5
TIKI,thiet-bi-kts-phu-kien-so,118424390,"Chuột không dây DAREU LM115G Black - Pink - Hàng Chính Hãng",123000,123000,0,0
TIKI,thiet-bi-kts-phu-kien-so,56260034,"Sạc dự phòng Energizer 10,000mAh /3.7V Li-Polymer - UE10054 - Hàng Chính Hãng",259000,299000,40000,13
TIKI,thiet-bi-kts-phu-kien-so,58393093,"Loa Bluetooth 60W công suất lớn Super Bass chống nước IPX5 pin 6600MAH sạc nhanh Type C công nghệ AI Hàng Chính Hãng PKCB",1250000,2500000,1250000,50
TIKI,thiet-bi-kts-phu-kien-so,188941352,"Quạt Mini Cầm Tay Tích Điện Cao Cấp Không Gây Ồn Với 5 Tốc Độ Gió, Dung Lượng Pin Cao, Màn Hình Led Hiển Thị Mức Pin Tiện Dụng - Hàng Nhập Khẩu",255000,255000,0,0
TIKI,thiet-bi-kts-phu-kien-so,113835505,"Giá Đỡ Máy Tính Bảng, Ipad, Điện Thoại - Chất Liệu Hợp Kim Nhôm Cao Cấp - Hàng Chính Hãng Tamayoko",349000,349000,0,0
TIKI,thiet-bi-kts-phu-kien-so,111231167,"Thanh Kẹp Giữ Cố Định Dây Cáp Sạc Dây Điện Silicon - Hàng Nhập Khẩu",45000,90000,45000,50
TIKI,thiet-bi-kts-phu-kien-so,111031533,"Cáp sạc nhanh 2.4A và truyền dữ liệu chân type-C Remax Colorful Light RC-152a [Hàng chính hãng",104000,150000,46000,31
TIKI,thiet-bi-kts-phu-kien-so,122012,"Combo chuột phím không dây Logitech MK240 - nhỏ gọn, 1 đầu thu USB, không dây 10m, pin lâu vượt trội - Màu",469000,620000,151000,24
TIKI,thiet-bi-kts-phu-kien-so,72811865,"Dây Cáp Sạc Nhanh Type-C To Light.ning 20W Dành Cho iPhone, Cho iPad Chuẩn MFI C94, Dài 1.2 Mét RAVPower RP-CB1004 - Hàng Chính Hãng",299000,500000,201000,40
TIKI,thiet-bi-kts-phu-kien-so,75980492,"Micro Không Dây Hát Karaoke Cực Hay Kết Nối Bằng Bluetooth K1 - Hàng Chính Hãng",1058000,2750000,1692000,62
TIKI,thiet-bi-kts-phu-kien-so,191477357,"Ốp lưng dẻo trong phong cách mới dành cho iPhone 12 / 12 Pro / 12 Pro Max / 12 Mini / 13 / 13 Pro / 13 Pro Max / 13 Mini  - Hàng chính hãng",139000,199000,60000,30
TIKI,thiet-bi-kts-phu-kien-so,195305683,"Adapter Sạc ANKER PowerPort III Nano 20W Phiên Bản Marvel Giới Hạn - A2633 - Hàng Chính Hãng",379000,480000,101000,21
TIKI,thiet-bi-kts-phu-kien-so,188685608,"Chuột không dây Bluetooth Logitech MX Master 3s - Hàng Chính Hãng",2250000,3299000,1049000,32
TIKI,thiet-bi-kts-phu-kien-so,56606433,"Chuột Không Dây Sạc Điện HXSJ M80 - Hàng chính hãng",99000,129000,30000,23
TIKI,thiet-bi-kts-phu-kien-so,14520200,"Tai Nghe HOCO M34 - Hàng Chính Hãng",36000,39900,3900,10
TIKI,thiet-bi-kts-phu-kien-so,171183734,"Cáp sạc nhanh, truyền dữ liệu tốc độ cao siêu bền Baseus Crystal Shine Series Fast Charging Data Cable IP 2.4A - Hàng chính hãng",120000,139000,19000,14
TIKI,thiet-bi-kts-phu-kien-so,190602137,"Dây Cáp Sạc Từ Tính cho Đồng Hồ Xiaomi Mi Band 5/ Mi Band 6/ Mi Band 7- Hàng chính hãng",30000,39000,9000,23
TIKI,thiet-bi-kts-phu-kien-so,119068085,"Bàn Phím Có Dây Dell KB216 - Đen - Hàng Chính Hãng",152000,152000,0,0
TIKI,thiet-bi-kts-phu-kien-so,3424667,"Bảng vẽ Wacom Intuos Bluetooth S CTL-4100WL/E0 (hàng phân phối chính thức)",2703000,2703000,0,0
TIKI,thiet-bi-kts-phu-kien-so,177548270,"Chuột không dây DareU LM115B Silent, kết nối Bluetooth, 2,4Ghz - Hàng chính hãng",249000,249000,0,0
TIKI,thiet-bi-kts-phu-kien-so,82955918,"Tai Nghe Bluetooth Nhét Tai PKCB True Wireless - Hàng Chính Hãng VN/A",155000,500000,345000,69
TIKI,thiet-bi-kts-phu-kien-so,88778074,"Chân Đế Đỡ Laptop Nillkin Bolster Portable Stand cho Laptop Macbook / Laptop Surface / Laptop Asus / Laptop HP / Laptop Dell / Laptop Lenovo / Laptop LG / Laptop Acer / Laptop MSI - Hàng Nhập Khẩu",90000,237998,147998,62
TIKI,thiet-bi-kts-phu-kien-so,183111772,"Dây Đeo Sport Loop Kai Dành Cho Apple Watch- Hàng Chính Hãng",95000,99000,4000,4
TIKI,thiet-bi-kts-phu-kien-so,2989999,"{ Lắp Là Dùng } Sim 5G Thái Lan 10 Ngày 50GB Và 100 Phút Gọi Thái Lan - Mẫu ngẫu nhiên",165000,165000,0,0
TIKI,thiet-bi-kts-phu-kien-so,142323009,"Dây Cáp DisplayPort 2 Đầu Đực Dài 2M 1.2 Phân Giải 8K 60hz Tốc Độ 32.4Gbps CHOETECH XDD01 - Hàng Chính Hãng",149000,390000,241000,62
TIKI,thiet-bi-kts-phu-kien-so,272420302,"Cáp sạc thay thế cho các dòng đồng hồ Garmin Fenix 7, Fenix 6, Fenix 5, Forerunner 955, 945, 935, 245, 265, 255, 45, 645, Instinct, Viviactive 3, Venu/ Garmin Epix Gen 2- Hàng Chính Hãng",70000,79000,9000,11
TIKI,thiet-bi-kts-phu-kien-so,418620,"Bộ Bàn Phím Và Chuột Có Dây Logitech MK200 - Hàng Chính Hãng",320000,379500,59500,16
TIKI,thiet-bi-kts-phu-kien-so,74498670,"Bộ sạc nhanh 20W USB Type C Baseus Super SI Quick Charger QC3.0 cho iPhone 12 (1C, 20W, Chân dẹt) - Hàng chính hãng",141899,141899,0,0
TIKI,thiet-bi-kts-phu-kien-so,153821917,"Đồng hồ Thông minh Gọi Video Call 4G, GPS, Wifi Chống nước Định vị Chuẩn AMA Watch LT36 có 3 màu Đen Hồng Xanh Hàng nhập khẩu",1050000,1050000,0,0
TIKI,thiet-bi-kts-phu-kien-so,171949837,"Bao da kèm bàn phím Logitech Combo Touch iPad Pro 11 inch gen 1, 2, 3 (2021) - Backlit keys có thể tháo rời, Trackpad siêu nhạy - Hàng chính hãng",4250000,4250000,0,0
TIKI,thiet-bi-kts-phu-kien-so,195300886,"Cáp Sạc ANKER PowerLine+ II USB-C to Lightning - Phiên Bản Marvel - A9548 - Hàng Chính Hãng",349000,550000,201000,37
TIKI,thiet-bi-kts-phu-kien-so,72746857,"Bàn Phím Không Dây Bluetooth Logitech K580 - Hàng Chính Hãng",959000,979000,20000,2
TIKI,thiet-bi-kts-phu-kien-so,72309016,"Chuột máy tính có dây PROLiNK PMC1005 giá rẻ, đèn LED xanh, hoạ tiết bắt mắt - Hàng chính hãng",50000,99000,49000,49
TIKI,thiet-bi-kts-phu-kien-so,181922008,"Case Silicon Dành Cho Airpods Pro In Hình Tai Nghe-Kèm Móc Khóa_ Hàng Chính Hãng",66000,69000,3000,4
TIKI,thiet-bi-kts-phu-kien-so,158641574,"[xả hàng cuối năm]Tai nghe nhét tai có Mic Texet-Crossloop E3169 hàng nhập khẩu",90000,90000,0,0
TIKI,thiet-bi-kts-phu-kien-so,143860118,"Sạc dự phòng 20000mAh sạc nhanh không dây 15W Remax RPP-207 sạc nhanh 22.5W QC3.0 - Hàng chính hãng",585000,900000,315000,35
TIKI,thiet-bi-kts-phu-kien-so,56196502,"Chuột Gaming Logitech G102 Gen 2 Lightsync - Hàng Chính Hãng",429000,439000,10000,2
TIKI,thiet-bi-kts-phu-kien-so,193005797,"Đồng hồ Thông minh 25 GAME Y8S gắn thẻ nhớ 32G Nghe nhạc Lắp Sim gọi Điện thoại không cần App Quản lý Hàng nhập khẩu",1000000,1000000,0,0
TIKI,thiet-bi-kts-phu-kien-so,167596574,"HÀNG CHÍNH HÃNG-  Kính cường lực Kingkong iP hộp sắt, không hộp WEKOME cho IP 6 Plus 7 8 X XS Max 11 12 Pro 13 13pro 13 PROMAX",21000,48999,27999,57
TIKI,thiet-bi-kts-phu-kien-so,2054469,"Cáp HDMI 2.0 Ugreen 40411 3m - Hàng chính hãng",147000,220000,73000,33
TIKI,thiet-bi-kts-phu-kien-so,35278834,"Hàng Chính Hãng- Loa Máy Vi Tính SADA V-196, Hỗ Trợ Đèn Led, Âm Thanh Siêu Trầm",186000,186000,0,0
TIKI,thiet-bi-kts-phu-kien-so,5987217,"Cáp HDMI 2.0 hỗ trợ 3D, 4K dài 5m UGREEN HD118 40412 - Hàng chính hãng",193000,210000,17000,8
TIKI,thiet-bi-kts-phu-kien-so,114100979,"Chuột Không Dây Không Ồn E-DRA EM603W (Silent Switch) - Hàng Chính Hãng",98000,159000,61000,38
TIKI,thiet-bi-kts-phu-kien-so,140742956,"Sạc nhanh AUKEY PA-Y30S PD 30W - Hàng chính hãng",268000,268000,0,0
TIKI,thiet-bi-kts-phu-kien-so,73406907,"Tai Nghe Không Dây Chống Nước Ipx5, Tai Nghe Nhét Tai Mini Bluetooth PKCB - Hàng Chính Hãng",190000,500000,310000,62
TIKI,thiet-bi-kts-phu-kien-so,81613252,"Micro Karaoke Bluetooth cao cấp PKCB Chính Hãng",925000,2300000,1375000,60
TIKI,thiet-bi-kts-phu-kien-so,157490476,"Bút Vệ Sinh Tai Nghe Bluetooth 3 Trong 1 Cao Cấp MIFAN - Làm sạch bụi bẩn trong hộp đựng, loa, cổng sạc, điện thoại - Hàng chính hãng",79000,100000,21000,21
TIKI,thiet-bi-kts-phu-kien-so,178735823,"Tai Nghe Nhét Tai Đa Năng HuQu HQ-ProX6 Kiêm Sạc Không Dây Cho Điện Thoại Di Động -Hàng Chính Hãng",758000,790000,32000,4
TIKI,thiet-bi-kts-phu-kien-so,178031593,"Tai Nghe Không Dây HUQU F.808 Âm Thanh Sống Động Chân Thực, Đường Truyền Ổn Định - Hàng chính hãng ",590000,590000,0,0
TIKI,thiet-bi-kts-phu-kien-so,76474502,"[Loại Tốt] Bút Chỉ Laser Trình Chiếu Điều Khiển Không Dây Từ Xa KhoNCC-R400 2.4ghz Hàng Chính Hãng Dùng Khi Thuyết Trình PowerPoint - KLVQ-BTC-R400-200 (Đen)",230000,230000,0,0
TIKI,thiet-bi-kts-phu-kien-so,214802387,"Quạt tản nhiệt MEMO DL05 - Thiết bị hạ nhiệt gaming dành cho điên thoại siêu lạnh, hiển thị nhiệt độ, LED RGB, Kẹp thu vào 2 chiều - Hàng Nhập Khẩu",215000,250000,35000,14
TIKI,thiet-bi-kts-phu-kien-so,51716152,"Bao da caro nữ kiêm ví cao cấp",99000,179000,80000,45
TIKI,thiet-bi-kts-phu-kien-so,113078398,"Hộp Đựng Tai Nghe, Cáp Sạc, Pin Sạc Dự Phòng, Ổ Cứng, Cáp USB, Pin Dự Phòng – Túi Đựng Củ Sạc Điện Thoại Đồng Hồ Thông Minh Bảo Vệ Phụ Kiện Di Động LapTop Hàng Chính Hãng miDoctor",55000,55000,0,0
TIKI,thiet-bi-kts-phu-kien-so,112734786,"Giá Đỡ Để Bàn Dành Cho Máy Tính Bảng, Ipad T003 - Chất Liệu Hợp Kim Nhôm Cao Cấp Hàng Chính Hãng Tamayoko",150000,150000,0,0
TIKI,thiet-bi-kts-phu-kien-so,149653443,"Giá Đỡ Tản Nhiệt Laptop/ Máy tính bảng/ Ipad để bàn chất liệu hợp kim nhôm loại cao cấp nhất (Giao màu ngẫu nhiên) - Hàng Chính Hãng ",65900,65900,0,0
TIKI,thiet-bi-kts-phu-kien-so,96466997,"Chuột Game Có Dây XSmart FREE WOLF V5 LED 7 màu cực đẹp chuyên gaming, siêu bền, chỉnh được dpi - Hàng Chính Hãng",129000,129000,0,0
TIKI,thiet-bi-kts-phu-kien-so,67975846,"Giá đỡ kẹp điện thoại cho xe máy/ xe mô tô C2 - Chống trộm, chống rung lắc, dễ dàng lắp đặt - Hàng chính hãng",35770,36500,730,2
TIKI,thiet-bi-kts-phu-kien-so,173137800,"Thẻ Nhớ Micro SDXC Samsung Evo Plus U3 130MB/s 512GB New - Hàng Nhập Khẩu",870000,870000,0,0
TIKI,thiet-bi-kts-phu-kien-so,73753804,"Combo RAVPower Củ Sạc Điện Thoại 2 Cổng 30W RP-PC132 + Dây Cáp Sạc Type-C To C RP-CB047 - Hàng Chính Hãng",419000,750000,331000,44
TIKI,thiet-bi-kts-phu-kien-so,195444597,"Thẻ Nhớ MicroSDXC SanDisk Extreme V30 A2 128GB 190MB/s SDSQXAA-128G (New 2022) - Hàng Nhập Khẩu",315000,315000,0,0
TIKI,thiet-bi-kts-phu-kien-so,47270547,"Ốp lưng dẻo mỏng dành cho iPhone 6 / iPhone 6s - Màu đen",45000,45000,0,0
TIKI,thiet-bi-kts-phu-kien-so,33598239,"Ốp lưng chống sốc cho Samsung Galaxy Note 10 Plus hiệu Likgus Crashproof (siêu mỏng, chống chịu mọi va đập) - Hàng nhập khẩu",72552,145104,72552,50
TIKI,thiet-bi-kts-phu-kien-so,196675011,"Tai Nghe Dẫn Xương Huqu HQ-HS2 - Giảm Ồn Hiệu Quả - Hàng Chính Hãng .",659000,780000,121000,16
TIKI,thiet-bi-kts-phu-kien-so,53547999,"Miếng lót chuột hình tròn siêu dễ thương - Hàng chính hãng",12000,12000,0,0
TIKI,thiet-bi-kts-phu-kien-so,74730315,"Tai Nghe Gaming Có Mic Rời xMOWI RX3 Dùng Được Cho Cả Máy Tính Và Điện Thoại - Hàng Chính Hãng",135000,139000,4000,3
TIKI,thiet-bi-kts-phu-kien-so,186907112,"[FREE 1 Tháng] Sim MAX DATA 4G VIETNAMOBILE 6GB/Ngày (180GB/Tháng) + Miễn Phí Gọi Nội Mạng. Sản Phẩm Độc Quyền VIETNAMOBILE - SIMTHE.VN. Dùng Trên Toàn Quốc - Hàng Chính Hãng",95000,170000,75000,44
TIKI,thiet-bi-kts-phu-kien-so,555019,"Bàn phím game có dây Logitech G213 Prodigy RGB Lightsync - Hàng chính hãng",920000,920000,0,0
TIKI,thiet-bi-kts-phu-kien-so,95681214,"Adapter sạc Anker 4 cổng 63W / 45W GaN + PIQ 3.0 PowerPort Atom III Slim Tích Hợp USB Type-C - A2046 - Hàng chính hãng - Đen",949000,1200000,251000,21
TIKI,thiet-bi-kts-phu-kien-so,214154015,"Giá Đỡ Dành Cho Điện Thoại, Máy Tính Bảng Chất Liệu Hợp Kim Nhôm Cao Cấp Model T002 - Hàng Chính Hãng Tamayoko",209000,209000,0,0
TIKI,thiet-bi-kts-phu-kien-so,96224276,"Tai Nghe Phone Nhét Tai Nghe Nhạc Chơi Game XSmart QKZ AK2 Pro 2021 Mới Nhất Âm Thanh Super Bass, Dây Chống Rối, Có Mic Đàm Thoại Tương Thích Điện Thoại Máy Tính Bảng Laptop PC, Hàng Chính Hãng",99000,99000,0,0
TIKI,thiet-bi-kts-phu-kien-so,90082542,"Tai nghe bluetooth Lanith F9 Pro 5.0 - Tai nghe nhét tai kết nối không dây phiên bản quốc tế - Âm bass êm và sâu, chip AIC chống gây chói tai - Thiết kế thời thượng, hiện đại - Hàng nhập khẩu - TAI0F9PRO",68000,129000,61000,47
TIKI,thiet-bi-kts-phu-kien-so,73188683,"Giá Đỡ Máy Tính, Laptop, iPad, Macbook Hợp Kim Nhôm Cao Cấp. Hỗ Trợ Tản Nhiệt Chống Mỏi Cổ, Vai, Gáy. Hàng Chính Hãng Tamayoko",299000,299000,0,0
TIKI,thiet-bi-kts-phu-kien-so,96230088,"Lót chuột XSmart đẹp, pad bàn di mouse 21 * 25cm độ dày 2mm đa dạng hình game, giao hàng ngẫu nhiên, may viền chắc chắn, Chính Hãng",9000,9000,0,0
TIKI,thiet-bi-kts-phu-kien-so,97547734,"Giá Đỡ Để Bàn Điện Thoại Di Động, Máy Tính Bảng, Ipad Hợp Kim Nhôm Cao Cấp Hai Trục Xoay 180 Độ Chống Đổ Hàng Chính Hãng Tamayoko - Xám",349000,349000,0,0
TIKI,thiet-bi-kts-phu-kien-so,169548885,"Chuột không dây Logitech B175 -Hàng chính hãng",177000,177000,0,0
TIKI,thiet-bi-kts-phu-kien-so,161397226,"Miếng dán màn hình GOR cho Apple Watch Series 7 / Apple Watch Series 8 / Apple Watch Series 9 Size 41mm / 45mm (Hộp 3 Miếng) - Hàng Nhập Khẩu",119000,119000,0,0
TIKI,thiet-bi-kts-phu-kien-so,65367594,"Dây đeo điện thoại/móc khóa/máy ảnh Ringke Lanyard Wrist Strap - Hàng Chính Hãng",101150,119000,17850,15
TIKI,thiet-bi-kts-phu-kien-so,182129885,"Bàn Phím Cơ Gaming Cao Cấp XSmart K1 Có 20 Chế Độ Nháy LED RGB Cực Đẹp, 104 Phím Full Size Sử Dụng Trục Cơ Red Switch Gõ Siêu Êm Bản Nâng Cấp Mới Nhất Tương Thích Với Các Dòng Máy Tính, Laptop, PC - Hàng Chính Hãng",599000,599000,0,0
TIKI,thiet-bi-kts-phu-kien-so,111050867,"Cáp sạc nhanh 2.4A và truyền dữ liệu cho android Remax Colorful Light RC-152m [Hàng chính hãng",104000,150000,46000,31
TIKI,thiet-bi-kts-phu-kien-so,145279028,"Bàn phím cơ không dây bluetooth | USB Logitech POP KEYS - phím emoji có thể tùy chỉnh - DayDream Mint - Hàng chính hãng",2020000,2449000,429000,18
TIKI,thiet-bi-kts-phu-kien-so,56799621,"Ốp lưng dẻo chống bụi dành cho",49000,69000,20000,29
TIKI,thiet-bi-kts-phu-kien-so,33142561,"Củ sạc HOCO 1A UH102 - Hàng nhập khẩu",20000,20000,0,0
TIKI,thiet-bi-kts-phu-kien-so,73992109,"USB Bluetooth 5.0 tốc độ 5Mbps Orico BTA-508 – Hàng Phân Phối Chính Hãng",95000,95000,0,0
TIKI,thiet-bi-kts-phu-kien-so,38997194,"[Miếng dán màn hình] Kính cường lực chống nhìn trộm dành cho Iphone 6/7/8/X/11 6Plus 7Plus 8Plus XS MAX Iphone 11 Pro Max chất lượng",20000,39998,19998,50
TIKI,thiet-bi-kts-phu-kien-so,95998092,"Chuột bi xoay không dây ERGO M575 Wireless - Hàng Chính Hãng",938000,938000,0,0
TIKI,thiet-bi-kts-phu-kien-so,71087453,"Củ Sạc Điện Thoại 2 Cổng USB-A và 2 Cổng Type-C PD 65W QC 3.0 RAVPower RP-PC136 - Hàng Chính Hãng",899000,1450000,551000,38
TIKI,thiet-bi-kts-phu-kien-so,124702774,"Adapter Củ Sạc 40W 2 Cổng Type C PD 3.0 & QC 3.0 Nhỏ Gọn RAVPower RP-PC152 - Hàng Chính Hãng",399000,800000,401000,50
TIKI,thiet-bi-kts-phu-kien-so,119003179,"Chuột Không Dây DAREU LM115G SPARROW ARTIC White (Màu Trắng) - Hàng Chính Hãng",125000,125000,0,0
TIKI,thiet-bi-kts-phu-kien-so,359480,"Combo chuột phím có dây Logitech MK120 - Hàng chính hãng",224000,224000,0,0
TIKI,thiet-bi-kts-phu-kien-so,63171394,"Miếng Lót Chuột Da 26x21 cm Màu Sắc Tinh Tế YORN - Hàng Nhập Khẩu",24000,24000,0,0
TIKI,thiet-bi-kts-phu-kien-so,57842537,"Củ Sạc Nhanh Cho Iphone Hoco C80 - Hỗ trợ sạc nhanh 20W PD QC3.0 - Hàng Chính Hãng",129000,250000,121000,48
TIKI,thiet-bi-kts-phu-kien-so,94304443,"Đồng Hồ Thông Minh AMA Watch Nam Nữ chống nước | Gọi điện thoại Xem tin nhắn Theo dõi Sức khỏe vận động Thiết kế nhỏ gọn Thời trang Hàng nhập khẩu",1132200,1258000,125800,10
TIKI,thiet-bi-kts-phu-kien-so,166545922,"Dây Cáp Chuyển Đổi Type C To HDMI 4K 60Hz CHOETECH XCH-M180 Dây Nylon Dài 1.8M, Tương Thích Thunderbolt 3 Dành Cho Macbook, Kèm Cổng Type C Sạc Nhanh 60W - Hàng Chính Hãng",369000,750000,381000,51
TIKI,thiet-bi-kts-phu-kien-so,108932578,"Tay Cầm Không Dây Sony DualSense Black CFI-ZCT1G -Hàng Chính hãng ",1890000,1999000,109000,5
TIKI,thiet-bi-kts-phu-kien-so,17913419,"Tai nghe Moxpad X3 in-ear Monitor - Hàng chính hãng",460000,460000,0,0
TIKI,thiet-bi-kts-phu-kien-so,73644584,"Dây Đeo Thay Thế Silicone Vòng Tay Thông Minh Mi Band 5 Mi Band 6 - Hàng Chính Hãng",30000,69000,39000,57
TIKI,thiet-bi-kts-phu-kien-so,59482840,"Bộ Hub QGeeM đa năng 5 trong 1 dành cho MacBook Pro 13/15 Surface Go, USB C Adapter - Hàng chính hãng",272000,279000,7000,3
TIKI,thiet-bi-kts-phu-kien-so,379462,"Loa Vi Tính Microlab B51 - Hàng Chính Hãng",295000,295000,0,0
TIKI,thiet-bi-kts-phu-kien-so,25748826,"Đầu chuyển usb type-C ra USB 3.0 chính hãng Ugreen 50283",80000,80000,0,0
TIKI,thiet-bi-kts-phu-kien-so,107971562,"Cáp âm thanh nối dài AUX 3.5mm Remax RL-L100/L200 - Hàng chính hãng",66000,100000,34000,34
TIKI,thiet-bi-kts-phu-kien-so,73166945,"Bàn phím không dây Bluetooth Logitech MX Keys - đa thiết bị, sạc nhanh, Mac/ PC - Hàng chính hãng",2590000,2590000,0,0
TIKI,thiet-bi-kts-phu-kien-so,50253867,"Lót Chuột, Pad Chuột Bền Đẹp 80x30 cm - Hàng Chính Hãng",52000,52000,0,0
TIKI,thiet-bi-kts-phu-kien-so,96811310,"Tai nghe chụp tai máy tính GAMING XSmart MC Q9 có đèn LED đổi màu, mic đàm thoại, headphone chơi game trên laptop, pc - Hàng Chính Hãng",349000,349000,0,0
TIKI,thiet-bi-kts-phu-kien-so,2993273,"Sim Du Lịch 35 Nước Châu Âu Three-Mẫu ngẫu nhiên",450000,450000,0,0
TIKI,thiet-bi-kts-phu-kien-so,185669076,"Ghế Gaming Chơi Game Deli - Bọc Da Cao Cấp - Có Gác Chân Gối Tựa Lưng, Đầu Nâng Hạ Ngả Lưng - Phù Hợp Game Thủ Streamer  Văn Phòng Làm Việc Học Sinh - Hàng Chính Hãng - E4927",1874000,3418200,1544200,45
TIKI,thiet-bi-kts-phu-kien-so,7574741,"Bao Da Smart Case Gen2 TPU Dành Cho iPad Mini 1/ 2/ 3/ 4",119000,220000,101000,46
TIKI,thiet-bi-kts-phu-kien-so,178737463,"Kính Cường Lực KingKong Full Màn Chính Hãng WEKOME Chống Vỡ Viền cho ĐT Hàng chính hãng",47000,47000,0,0
TIKI,thiet-bi-kts-phu-kien-so,359483,"Bàn Phím Không Dây Logitech K270 - Hàng Chính Hãng",420000,429000,9000,2
TIKI,thiet-bi-kts-phu-kien-so,74235841,"Bao Da Case Cover Dành Cho iPad Pro 11 inch (2020) / iPad Air 4 (10.9 inch) / iPad Pro 12.9 inch (2020) Có Khe Cắm Apple Pencil - Hàng Chính Hãng Meliya accessories - Hồng - iPad Air 4 (10.9 inch)",99000,99000,0,0
TIKI,thiet-bi-kts-phu-kien-so,192431673,"Vỏ Bút dành cho Apple Pencil 2 Retro Hình Bút Chì- Hàng Chính Hãng",162000,169000,7000,4
TIKI,thiet-bi-kts-phu-kien-so,70847754,"Bộ 2 miếng kính cường lực Gor cho iPhone 12 Mini / 12 / 12 Pro / 12 Pro Max - Full Box - Gor - Hàng nhập khẩu",89500,89500,0,0
TIKI,thiet-bi-kts-phu-kien-so,270493352,"Bàn phím cơ Gaming DAREU EK87 v2 (2 sides RGB strip, Black: Rainbow light , White: Single blue Backlight) - Hàng Chính Hãng",489000,499000,10000,2
TIKI,thiet-bi-kts-phu-kien-so,183559913,"Micro có dây Nhật Bản  TOMAHAWK - Hàng nhập khẩu  - Hàng cao cấp Nhật Bản",199000,380000,181000,48
TIKI,thiet-bi-kts-phu-kien-so,83982862,"Dây Cáp Sạc Type C to C Sạc Nhanh 60W, Dài 1m, Dây Dù Nylon Siêu Bền RAVPower RP-CB047 - Hàng Chính Hãng",99000,200000,101000,51
TIKI,thiet-bi-kts-phu-kien-so,114243462,"Giá Đỡ Máy Tính, Laptop Máy Tính Bảng Chất Liệu Hợp Kim Nhôm Cao Cấp Hỗ Trợ Tản Nhiệt Chống Mỏi Cổ, Vai, Gáy. Hàng Chính Hãng Tamayoko",479000,479000,0,0
TIKI,thiet-bi-kts-phu-kien-so,136971092,"Ốp lưng kéo nắp cao cấp dành cho iPhone 13 / 13 Pro / 13 Pro Max / 13 Mini - Hàng chính hãng",49000,69000,20000,29
TIKI,thiet-bi-kts-phu-kien-so,225971148,"Adapter sạc nhanh 25W USB-C PD (PPS) Belkin - Hàng Chính Hãng - WCA004dqWH",350000,490000,140000,29
TIKI,thiet-bi-kts-phu-kien-so,69978395,"Giá Đỡ Laptop Để Bàn Hợp Kim Nhôm Cao Cấp Tản Nhiệt Gọn Nhẹ",238000,238000,0,0
TIKI,thiet-bi-kts-phu-kien-so,1026342,"Bút trình chiếu từ xa Logitech Spotlight - không dây đến 30m, kết nối Bluetooth và USB, phóng to để nhấn mạnh, điều khiển con trỏ bật video - Hàng chính hãng",2189000,2189000,0,0
TIKI,thiet-bi-kts-phu-kien-so,195445913,"Thẻ Nhớ MicroSDXC SanDisk Extreme V30 A2 256GB 190MB/s SDSQXAV-256G (New 2022) - Hàng Nhập Khẩu",570000,570000,0,0
TIKI,thiet-bi-kts-phu-kien-so,49648343,"Thẻ Nhớ Micro SD Hikvision 64Gb Class 10 - Hàng Chính hãng",110000,200000,90000,45
TIKI,thiet-bi-kts-phu-kien-so,97346860,"Tai Nghe Chống Ồn Có Dây XSmart AK9 Premium BASS 2021 Thế Hệ Mới, Giải Trí, Chơi Game Dùng Cho Cả Điện Thoại, Máy Tính - Hàng Chính Hãng",199000,199000,0,0
TIKI,thiet-bi-kts-phu-kien-so,112976329,"Củ sạc nhanh Samsung 25w Type C ( Không kèm cáp) - Hàng chính hãng",379000,379000,0,0
TIKI,thiet-bi-kts-phu-kien-so,94886842,"Tai Nghe Bluetooth Không Dây Kết Nối Bluetooth Nhanh Chóng Cảm Ứng Vân Tay Thông Minh - Hàng Chính Hãng",250000,500000,250000,50
TIKI,thiet-bi-kts-phu-kien-so,57841587,"Bộ Củ Sạc Hoco C80 + Cáp Sạc Type C - Hỗ trợ sạc nhanh QC3.0 - Hàng Chính Hãng",117000,130000,13000,10
TIKI,thiet-bi-kts-phu-kien-so,57900120,"Loa bluetooth mini 5.0 nhỏ gọn PKCB PF1002 - Hàng chính hãng",165000,300000,135000,45
TIKI,thiet-bi-kts-phu-kien-so,44217261,"Flydigi Wasp Feelers 2 | Găng tay chơi game PUBG, Liên quân, chống mồ hôi, cực nhạy - Hàng Chính Hãng",75000,75000,0,0
TIKI,thiet-bi-kts-phu-kien-so,6431175,"Chuột game hiệu suất cao Logitech G502 Hero RGB Lightsync - Hàng chính hãng",999000,999000,0,0
TIKI,thiet-bi-kts-phu-kien-so,93931233,"Bàn phím game cơ học Logitech G512 - RGB Lightsync, 3 loại GX Switch, vật liệu cải tiến, cổng USB 2.0 - Hàng chính hãng",1999000,1999000,0,0
TIKI,thiet-bi-kts-phu-kien-so,169489699,"Đồng Hồ Thông Minh Lắp Sim Định vị Chuẩn GPS WIFI Chống nước IP67 Kiểu dáng Thể thao Cá tính cho Trẻ em 4-13 tuổi Hàng chính hãng",1035000,1035000,0,0
TIKI,thiet-bi-kts-phu-kien-so,2829433,"Bút Trình Chiếu Vesine VP-101 (Đen) - Hàng Chính Hãng",113800,113800,0,0
TIKI,thiet-bi-kts-phu-kien-so,171443057,"Dây Đeo Thay Thế Dành Vòng Đeo Tay Thông Minh Mi Band 3 Mi Band 4 - Hàng chính Hãng PKCB",42000,90000,48000,53
TIKI,thiet-bi-kts-phu-kien-so,149248566,"Bao da iPad Gen 9 10.2 inch 2021 chính hãng Mutural kèm khay đựng bút - Hàng nhập khẩu",191000,339999,148999,44
TIKI,thiet-bi-kts-phu-kien-so,20589215,"Pin Sạc AAA Eneloop Panasonic - Hàng Chính Hãng",189050,215000,25950,12
TIKI,thiet-bi-kts-phu-kien-so,7718059,"Sound card âm thanh 7.1 cho máy tính PC chuyên game GS3 - Hàng Chính hãng",175000,179000,4000,2
TIKI,thiet-bi-kts-phu-kien-so,112056073,"Bao da cho iPad Pro 11 inch / iPad Pro 12.9 inch 2021/2022 Nillkin Bumper Leather Case Pro (Có khe cắm bút Apple Pencil) - Hàng Nhập Khẩu",326000,700000,374000,53
TIKI,thiet-bi-kts-phu-kien-so,144973012,"Chuột không dây Bluetooth 5.0 Dareu LM115B + Wireless 2.4GHz ( Silent Switch ) - Hàng chính hãng",229000,229000,0,0
TIKI,thiet-bi-kts-phu-kien-so,73204703,"Máy trợ giảng không dây SHIDU kết nối bằng tần số cao cấp, mic trợ giảng cho giáo viên và hướng dẫn viên du lịch, loa trợ giảng cài áo tiện lợi, Hàng nhập khẩu",340000,340000,0,0
TIKI,thiet-bi-kts-phu-kien-so,195986399,"Bộ Vệ Sinh Macbook/Laptop/Lens/Máy ảnh/Điện thoại Khăn Rút Kai Cleaning Wipes Hộp 88 Khăn - Hàng Chính Hãng",120000,120000,0,0
TIKI,thiet-bi-kts-phu-kien-so,138386143,"Cáp sạc đa năng Baseus Rapid Series 4 trong 1 cho iPhone/ iPad, Smartphone & Tablet Android (3.5A, 1.2M, Type C/ Micro/ IP , Fast charge 4 in 1 Cable)- Hàng chính hãng",115000,125000,10000,8
TIKI,thiet-bi-kts-phu-kien-so,47081914,"Hộp Túi Vải Đựng Phụ Kiện Công Nghệ Đa Năng Nhiều Ngăn Chống Thấm Nước Túi Phụ Kiện Du Lịch Cho Cáp Sạc Di Động, Sạc Dự Phòng, Điện Thoại, Tai Nghe, Thẻ Nhớ - Hàng Chính Hãng + Kèm 1 Mét Dây Gai Dính Tròn Buộc Gọn Cáp",79000,79000,0,0
TIKI,thiet-bi-kts-phu-kien-so,361277,"Bộ Bàn Phím Và Chuột Không Dây Fuhlen A120G - Hàng chính hãng",320000,320000,0,0
TIKI,thiet-bi-kts-phu-kien-so,85460045,"Pin sạc dự phòng Hoco J72 Easy travel 10000mAh 2 cổng Input/Output max 2A - Hàng chính hãng",134000,134000,0,0
TIKI,thiet-bi-kts-phu-kien-so,22436063,"Miếng Lót Chuột (29 x 23 cm) - Hàng Nhập Khẩu",21900,21900,0,0
TIKI,thiet-bi-kts-phu-kien-so,136312573,"Dây Đeo RINGKE Lanyard Finger Strap - Hàng Chính Hãng",68000,80000,12000,15
TIKI,thiet-bi-kts-phu-kien-so,67503564,"Thẻ Nhớ Camera Hikvision 32Gb Class 10 - Hàng nhập khẩu",89000,89000,0,0
TIKI,thiet-bi-kts-phu-kien-so,74191048,"Sạc nhanh 20W cho iPhone và điện thoại Android - Baseus Super Si Quick Charger - Hàng chính hãng",169000,189000,20000,11
TIKI,thiet-bi-kts-phu-kien-so,172833589,"Bàn phím không dây Bluetooth Logitech MX Keys Mini - Nhỏ gọn, Sạc USB-C, Phím tắt thông minh, Có bản cho Mac - Hàng chính hãng",2489000,2489000,0,0
TIKI,thiet-bi-kts-phu-kien-so,195300846,"Cáp Sạc ANKER Powerline+ II USB-C To USB-C Phiên Bản Marvel - A9547 / A9549 - Hàng Chính Hãng",179000,300000,121000,40
TIKI,thiet-bi-kts-phu-kien-so,59091343,"Pin Sạc Dự Phòng Nhỏ Gọn RAVPower 10000mAh Quick Charge 3.0 + PD 20W, In/Out Type-C - RP-PB186 - Hàng Chính Hãng",1100000,1100000,0,0
TIKI,thiet-bi-kts-phu-kien-so,115088020,"Pin sạc dự phòng Baseus Bipow Digital Display Power Bank 20000mAh ( 15W/20W, USB*2+Type C , LED Display, 2 Way Fast charge ) - Hàng chính hãng",420000,450000,30000,7
TIKI,thiet-bi-kts-phu-kien-so,148840448,"Hộp Đựng Tai Nghe Cáp Sạc Củ Sạc Pin Sạc Dự Phòng, Ổ Cứng, Cáp USB, Pin Dự Phòng – Hộp Đựng Phụ Kiện Điện Thoại Đồng Hồ Thông Minh – Bảo Vệ Phụ Kiện Di Động LapTop Hàng Chính Hãng Dododios",85000,85000,0,0
TIKI,thiet-bi-kts-phu-kien-so,175901359,"Củ Sạc Nhanh 20W PD & QC3.0 2 Cổng Hoco C80/C80A - Cốc Sạc Siêu Nhanh Cho iPhone, Samsung, Xiaomi,... - Hàng Chính Hãng",98000,150000,52000,35
TIKI,thiet-bi-kts-phu-kien-so,515550,"Bộ Bàn Phím Và Chuột Không Dây Logitech MK235 - Hàng chính hãng",489000,499000,10000,2
TIKI,thiet-bi-kts-phu-kien-so,56515226,"Bút Cảm Ứng V-Tech Dành Cho Điện Thoại Ipad Máy Tính Bảng - Hàng Nhập Khẩu (Tặng Đầu Cảm Ứng Thay Thế)",125000,250000,125000,50
TIKI,thiet-bi-kts-phu-kien-so,109764211,"Ốp lưng kéo nắp cao cấp dành cho iPhone 12 Pro Max / 11 Pro Max / XR / X/XS / XS Max / 7 Plus/ 8 Plus / 11 Pro / 12 Pro / 11/ 12 / 12 Mini - Hàng chính hãng",49000,69000,20000,29
TIKI,thiet-bi-kts-phu-kien-so,174397451,"Ốp lưng kéo nắp kiểu mới dành cho iPhone 7 / 8 / SE 2020 / SE 2022 / 7 Plus / 8 Plus / X / XS / XR / XS Max - Hàng chính hãng",99000,150000,51000,34
TIKI,thiet-bi-kts-phu-kien-so,59253777,"Ốp lưng dẻo silicon cho Samsung Galaxy Note 10 Plus hiệu Ultra Thin (siêu mỏng 0.6mm, chống trầy, chống bụi) - Hàng nhập khẩu",34999,34999,0,0
TIKI,thiet-bi-kts-phu-kien-so,180576829,"Tai Nghe Chống Ồn HuQu HQ-P30 Giảm Tiếng Ồn - Hàng Chính Hãng",292000,350000,58000,17
TIKI,thiet-bi-kts-phu-kien-so,181908744,"Tai Nghe Bluetooth Thời Trang HUQU HQ-K6131 Hỗ Trợ Nghe FM -Hàng Chính Hãng",422000,440000,18000,4
TIKI,thiet-bi-kts-phu-kien-so,82861299,"Loa Bluetooth PKCB Bản Mở Rộng, chống nước IPX5 Hỗ Trợ Kết Nối Bluetooth ,Thẻ Nhớ, USB - Hàng chính hãng",176000,550000,374000,68
TIKI,thiet-bi-kts-phu-kien-so,72575224,"Ốp lưng dẻo mỏng màu đen dành cho iPhone 7 Plus / 8 Plus - Hàng chính hãng",39000,45000,6000,13
TIKI,thiet-bi-kts-phu-kien-so,178044028,"Tai Nghe Chụp Tai HUQU HQ33 - Chống Ồn, Âm Bass Mạnh Mẽ, Âm Thanh Vòm 360 - Hàng Chính Hãng",308000,370000,62000,17
TIKI,thiet-bi-kts-phu-kien-so,73768914,"Ốp lưng Memumi cho iPhone 12 mini / 12 Pro /12 Pro Max bảo vệ camera, siêu mỏng 0.3 mm Hàng nhập khẩu",99000,99000,0,0
TIKI,thiet-bi-kts-phu-kien-so,180580800,"Tai Nghe Có Dây HuQu HQ-XB450 - Thiết Kế Đệm Tai Êm Ái - Hàng Chính Hãng",141000,170000,29000,17
TIKI,thiet-bi-kts-phu-kien-so,111977850,"Bộ Cáp Type C to HDMI Phân Giải 4K 60Hz Dài 1.8M Kèm Đầu Chuyển C to HDMI Thunderbolt 3 CHOETECH CH0033-BK - Hàng Chính Hãng",499000,1090000,591000,54
TIKI,thiet-bi-kts-phu-kien-so,107362350,"Cốc sạc nhanh Baseus Dual Quick Charger 20W - Hàng chính hãng",175000,190000,15000,8
TIKI,thiet-bi-kts-phu-kien-so,118220588,"Cáp Sạc nhanh Baseus B01 (dài 1m 2.4A, Sạc nhanh, Siêu bền) có đèn LED Cho Iphone / Ipad - Hàng chính Hãng",79000,79000,0,0
TIKI,thiet-bi-kts-phu-kien-so,275409822,"Sim Và Esim 3G/4G/5G Du Lịch Thái Lan - Hàng Chính Hãng - Mẫu ngẫu nhiên - Mạng Trumove: 15GB Data + 30 Phút Gọi Thái",130000,130000,0,0
TIKI,thiet-bi-kts-phu-kien-so,155289779,"Dây Cáp Type C To HDMI 4K 60Hz Dài 1.8M, Dây Nylon Dù Thunderbolt 3 CHOETECH CH0021 - Hàng Chính Hãng",299000,690000,391000,57
TIKI,thiet-bi-kts-phu-kien-so,71771600,"Ốp lưng lụa mỏng dành cho iPhone 12/ 12 Pro /12 Pro Max bảo vệ camera, siêu mỏng 0.3 mm - Hàng Chính Hãng Memumi",85000,177798,92798,52
TIKI,thiet-bi-kts-phu-kien-so,47272512,"Ốp lưng dẻo mỏng dành cho iPhone 11 - Màu đen",49000,69000,20000,29
TIKI,thiet-bi-kts-phu-kien-so,54894940,"Baseus LV119-A01 Đầu Chuyển USB Type A Sang USB Type C Tốc Độ Cao Baseus | Chính hãng Baseus",89000,89000,0,0
TIKI,thiet-bi-kts-phu-kien-so,2462825,"Chuột game không dây Lightspeed Logitech G304 - Cảm biến Hero, 12k DPI, nhẹ, 6 nút lập trình, on-board memory, pin 250h - Hàng chính hãng",795000,795000,0,0
TIKI,thiet-bi-kts-phu-kien-so,85306600,"Máy Nghe Nhạc MP3 Lossless Bluetooth 5.1 Ruizu D51 Bộ Nhớ Trong 8GB (Có Loa Ngoài) - Hàng Chính Hãng",528000,528000,0,0
TIKI,thiet-bi-kts-phu-kien-so,125161825,"Đế sạc không dây Remax RP-W36 - Hàng chính hãng",550000,550000,0,0
TIKI,thiet-bi-kts-phu-kien-so,93936518,"Túi hộp EVA bọc da khung cứng chống sốc đựng phụ kiện điện thoại, tai nghe, bộ sạc điện thoại, pin dự phòng mini (11,5x9x4cm)- Hàng chính hãng",45000,45000,0,0
TIKI,thiet-bi-kts-phu-kien-so,10023304,"Thẻ Nhớ MicroSD 128GB class 10_UHS1 - Hàng chính hãng",350000,350000,0,0
TIKI,thiet-bi-kts-phu-kien-so,68418553,"Cáp Thunderbolt 3 Belkin 0.8m, hỗ trợ truyền tải 40Gbps, sạc PD 100W, xuất hình ảnh 4K/5K/UltraHD, chứng nhận bởi Intel - F2CD084BT - Hàng chính hãng",719000,1099000,380000,35
TIKI,thiet-bi-kts-phu-kien-so,97340085,"Tai Nghe Chống Ồn XSmart CK8 PRO NEW BASS 2021 Full hộp Giải Trí Chơi Game Cực Đã Có Mic Đàm Thoại - Hàng Chính Hãng",89000,89000,0,0
TIKI,thiet-bi-kts-phu-kien-so,73811766,"Loa thanh soundbar Samsung HW-T420 - Hàng chính hãng",1320000,1320000,0,0
TIKI,thiet-bi-kts-phu-kien-so,142467213,"Cáp sạc nhanh USB Type C - Light ning BOOST↑CHARGE Belkin 30W vỏ nhựa 1M - Hàng chính hãng",295000,425000,130000,31
TIKI,thiet-bi-kts-phu-kien-so,112249487,"Đồng Hồ Thông Minh Định vị Trẻ em AMA Watch Y79 Pin khỏe Ngôn ngữ Tiếng Việt sài Sim 4G gọi Điện thoại 2 chiều Hàng nhập khẩu",480000,550000,70000,13
TIKI,thiet-bi-kts-phu-kien-so,19821434,"Cáp OTG USB Type C to USB 3.0 Ugreen 30701 - Hàng chính hãng",74900,79900,5000,6
TIKI,thiet-bi-kts-phu-kien-so,106234919,"Bảng Vẽ Cảm Ứng Điện Tử 8.5 Inch – Hàng Chính Hãng ",62000,120000,58000,48
TIKI,thiet-bi-kts-phu-kien-so,17914711,"Tai nghe Moxpad X6 in-ear Monitor Bass HD - Hàng chính hãng",580000,580000,0,0
TIKI,thiet-bi-kts-phu-kien-so,125773832,"Miếng Dán Cường Lực Mipow Kingbull Chống Nhìn Trộm Premium HD (2.7D) iPhone 13 Mini / iPhone 13/ iPhone 13 Pro/ iPhone 13 ProMax_ Hàng Chính Hãng",194000,252998,58998,23
TIKI,thiet-bi-kts-phu-kien-so,160946538,"Ốp lưng da thời trang kết hợp MICA dành cho iPhone 13 / 13 Pro / 13 Pro Max / 13 Mini - Hàng nhập khẩu",149000,250000,101000,40
TIKI,thiet-bi-kts-phu-kien-so,26312778,"Dây sạc 4 IN 1 đa năng của Baseus  (3.5A, 120cm , Fast charge 4 in 1 Cable) cho iPhone/ iPad, Smartphone Android  - Hàng chính hãng",104499,104499,0,0
TIKI,thiet-bi-kts-phu-kien-so,170334689,"Chuột Không Dây Sạc Điện HXSJ Siêu Mỏng Chống Ồn - HÀNG CHÍNH HÃNG",99000,189000,90000,48
TIKI,thiet-bi-kts-phu-kien-so,192257703,"Ốp Case Kính Cường Lực Curved Glass Dành Cho Apple Watch- Hàng Chính Hãng",95000,99000,4000,4
TIKI,thiet-bi-kts-phu-kien-so,54549048,"Miếng Phủ Bàn Phím Laptop 12-13/13-14/15-17 inch Silicon Chống Nước, Chống Bụi Bẩn Hàng Chính Hãng Helios",14000,14000,0,0
TIKI,thiet-bi-kts-phu-kien-so,183502973,"Cáp Sạc Nhanh Baseus Horizontal Data Cable - Dùng Cho iPhone iPad - Trang Bị Đèn Led - Công Nghệ Chống Đứt Gãy SR - Hàng Chính Hãng",85000,85000,0,0
TIKI,thiet-bi-kts-phu-kien-so,130969202,"Kính Cường Lực Chống Nhìn Trộm KingKong Dành Cho iPhone 13, 13Mini, 13Pro, 13Pro Max, iPhone 14, 14Plus, 14Pro, 14Pro Max - Dán Full Màn - Full Hộp - Hàng chính hãng",112999,123747,10748,9
TIKI,thiet-bi-kts-phu-kien-so,47272446,"Ốp lưng dẻo mỏng dành cho iPhone 7 Plus / iPhone 8 Plus - Màu xanh dương đậm",45000,45000,0,0
TIKI,thiet-bi-kts-phu-kien-so,114359470,"Cáp sạc 3.5A Baseus Rapid Series kết nối 2 Type-C/ Micro/ iPhone tiện lợi dài 1.2M - Hàng chính hãng",123000,156000,33000,21
TIKI,thiet-bi-kts-phu-kien-so,140135744,"Bộ 2 miếng kính cường lực Gor cho iPhone 13 Mini / 13 / 13 Pro / 13 Pro Max - Full Box - Gor - Hàng nhập khẩu",93000,119898,26898,22
TIKI,thiet-bi-kts-phu-kien-so,73744564,"Loa Bluetooth Di động Không Dây Thể Thao Chống Nước Ngoài Trời 5W Cột Nghe Nhạc - Hàng Chính Hãng",172000,500000,328000,66
TIKI,thiet-bi-kts-phu-kien-so,195305637,"Adapter Sạc ANKER Nano II 45W Type-C 713 GaN II PPS Có Thể Gấp Gọn Tương Thích Nhiều Thiết Bị - A2664 - Hàng Chính Hãng",559000,950000,391000,41
TIKI,thiet-bi-kts-phu-kien-so,76149479,"Dây cáp quang Toslink âm thanh kỹ thuật số SPDIF dùng cho TV smart, bộ khuếch đại, Xbox One, PS4, PlayStation, Soundbar, đầu phát Blu-Ray, đầu CD UGREEN AV122 - Hàng chính hãng",69000,75000,6000,8
TIKI,thiet-bi-kts-phu-kien-so,82874789,"Loa Bluetooth PKCB Bản Mở Rộng, chống nước IPX5 Hỗ Trợ Kết Nối Bluetooth ,Thẻ Nhớ, USB - Hàng chính hãng",180000,500000,320000,64
TIKI,thiet-bi-kts-phu-kien-so,73161165,"Thẻ Nhớ MicroSD SanDisk Ultra 32GB 100MB/s - Hàng Chính Hãng",153000,153000,0,0
TIKI,thiet-bi-kts-phu-kien-so,103635480,"Dây sạc type C To C PROLiNK GCC_100_01 dài 2M, sạc siêu nhanh 100W, dành cho iPad, Macbook, Laptop, Samsung - Hàng chính hãng",119000,149000,30000,20
TIKI,thiet-bi-kts-phu-kien-so,151564798,"Chuột Không Dây Silent Wireless Và Bluetooth RAPOO M300 - Hàng chính hãng",299000,299000,0,0
TIKI,thiet-bi-kts-phu-kien-so,142793158,"Bảng Vẽ One by Wacom Small CTL-472 - Hàng Chính Hãng",799000,799000,0,0
TIKI,thiet-bi-kts-phu-kien-so,191571013,"Dây Cao Su Sport Color dành cho Samsung Galaxy Fit 2 (SM-R220)- Hàng chính hãng",99000,99000,0,0
TIKI,thiet-bi-kts-phu-kien-so,158165120," Dây Cáp Sạc Micro USB Dành Cho Samsung, OPPO- Hàng Nhập khẩu",27000,42898,15898,37
TIKI,thiet-bi-kts-phu-kien-so,31547651,"Adapter Sạc 1 Cổng 18W Xiaomi ZMI HA612 Hỗ Trợ Sạc Nhanh QC 3.0 - HÀNG NHẬP KHẨU",123500,123500,0,0
TIKI,thiet-bi-kts-phu-kien-so,272420279,"Cáp sạc nhanh thay thế cho các dòng đồng hồ Garmin cổng Type C- Hàng Chính Hãng",72000,75000,3000,4
TIKI,thiet-bi-kts-phu-kien-so,73165085,"Chuột không dây Bluetooth Logitech MX Anywhere 3 - Màu",1550000,1550000,0,0
TIKI,thiet-bi-kts-phu-kien-so,111156743,"Bộ cáp sạc nhanh đa năng REMAX Wanbo Series 60W RC-190 - Hàng chính hãng",199000,300000,101000,34
TIKI,thiet-bi-kts-phu-kien-so,127360306,"Ốp lưng bảo vệ Camera dành cho iPhone 13/ 13 Pro/ 13 Pro Max chính hãng NILLKIN CamShield - hàng nhập khẩu",116000,153998,37998,25
TIKI,thiet-bi-kts-phu-kien-so,190707483,"Cáp chuyển đổi Mini Displayport to HDMI KINGMASTER KM027 - Hàng chính hãng",109000,109000,0,0
TIKI,thiet-bi-kts-phu-kien-so,190240726,"Pad chuột cỡ lớn lót bàn phím, miếng lót chuột, bàn di siêu mượt trải bàn kích thước lớn - Hàng chính hãng",55000,55000,0,0
TIKI,thiet-bi-kts-phu-kien-so,142477644,"Adapter Củ Sạc 33W PPS/ PD 30W / QC 3.0 1 Cổng Type C 1 Cổng USB Nhỏ Gọn CHOETECH PD5006 Sạc Nhanh iPhone, iPad, Samsung - Hàng Chính Hãng",329000,550000,221000,40
TIKI,thiet-bi-kts-phu-kien-so,66708181,"Miếng Lót Chuột 80x30cm Chất Liệu Da, Pad Chống Nước, Bàn Di Chuột YORN - Hàng Chính Hãng",80000,80000,0,0
TIKI,thiet-bi-kts-phu-kien-so,8387126,"Máy ghi âm Sony ICD-PX470 - Hàng Nhập Khẩu",1650000,1650000,0,0
TIKI,thiet-bi-kts-phu-kien-so,112316466,"Bàn phím cơ không dây Newmen GM610 - Hàng chính hãng",989000,989000,0,0
TIKI,thiet-bi-kts-phu-kien-so,74265058,"Bộ Chuyển Âm Thanh TV 4K Quang Optical Sang Audio AV Ra Amply + Cáp Optical (1m) HÀNG CHÍNH HÃNG NETBOX",139000,139000,0,0
TIKI,thiet-bi-kts-phu-kien-so,150936608,"Bàn phím cơ không dây Dareu EK807G Black - Hàng Chính Hãng",600000,600000,0,0
TIKI,thiet-bi-kts-phu-kien-so,142238727,"Bàn phím không dây bluetooth Logitech MX Keys Mini - Hàng Chính Hãng",2299000,2299000,0,0
TIKI,thiet-bi-kts-phu-kien-so,195741816,"Kính Cường Lực Kingkong 3D Trong Suốt Cho iPhone - Dán Full Màn - Full Hộp Sắt Cao Cấp - Hàng Chính Hãng",110000,110000,0,0
TIKI,thiet-bi-kts-phu-kien-so,91192959,"Dây máy in USB 2.0 chuẩn A đực sang chuẩn B đực độ dài từ 1-5m UGREEN US135 - Hàng Chính hãng",46000,50000,4000,8
TIKI,thiet-bi-kts-phu-kien-so,202793622,"Chuột Chơi Game Có Dây Logitech G102 8000DPI RGB 6 Phím - Hàng Chính Hãng",419000,419000,0,0
TIKI,thiet-bi-kts-phu-kien-so,112251499,"Đế Sạc Nhanh Không Dây Để Bàn Chuẩn QI, Thương Hiệu NBAYOU, Có Lựa Chọn Model, Sạc Thông Minh, An Toàn, Sang Trọng, Sản Phẩm Như Hình, Hàng Chính Hãng",155000,155000,0,0
TIKI,thiet-bi-kts-phu-kien-so,208248,"Bàn phím không dây bluetooth Logitech K480 - Kết nối 3 thiết bị, tối giản, phù hợp Mac/ PC/ Laptop/ Điện thoại/Tablet - Hàng chính hãng - Màu",689000,689000,0,0
TIKI,thiet-bi-kts-phu-kien-so,6919753,"SIM 4G VINAPHONE D500 5GB/Tháng Trọn Gói Một Năm Không Nạp Tiền - Hàng chính hãng - Mẫu ngẫu nhiên",419000,419000,0,0
TIKI,thiet-bi-kts-phu-kien-so,54568580,"Đầu chuyển USB 3.0 to Type C (âm) Ugreen 50533 - Hàng chính hãng",97900,108000,10100,9
TIKI,thiet-bi-kts-phu-kien-so,77094229,"Ốp lưng Samsung Galaxy S21/ S21 Plus/ S21 Ultra chính hãng SULADA dạng da mềm",69000,69000,0,0
TIKI,thiet-bi-kts-phu-kien-so,17946135,"Đài  836s USB thẻ nhớ nghe đài FM có đèn pin hàng nhập khẩu",145000,145000,0,0
TIKI,thiet-bi-kts-phu-kien-so,172328504,"Bao Da Dành Cho iPad Pro 12.9 inch M1 2021/ Pro 12.9 inch M2 2022 ESR Urban Premium Case with Pencil Holder- Hàng Chính Hãng",758000,790000,32000,4
TIKI,thiet-bi-kts-phu-kien-so,40737659,"Túi phụ kiện công nghệ BUBM chuyên dụng 1 ngăn, 2 ngăn đựng bộ sạc macbook, máy tính bảng, dây cáp sạc, pin dự phòng, tai nghe",145000,145000,0,0
TIKI,thiet-bi-kts-phu-kien-so,162112331,"Bao Da Dành Cho iPad 10.2 Gen 7/8/9 ESR Ascend Trifold With Clasp - Hàng Chính Hãng",662000,690000,28000,4
TIKI,thiet-bi-kts-phu-kien-so,191437000,"Dây dán Velcro Ugreen Cable Organizer LP124 - Hàng chính hãng",28000,28000,0,0
TIKI,thiet-bi-kts-phu-kien-so,15366901,"Chuột máy tính không dây Foter V181( màu đen) - Hàng Nhập Khẩu",44000,44000,0,0
TIKI,thiet-bi-kts-phu-kien-so,56018289,"Đầu nối giá đỡ kẹp điện thoại gắn vào tripod hỗ trợ livestream, quay phim nhiều máy cùng lúc- Hàng chính hãng",69000,69000,0,0
TIKI,thiet-bi-kts-phu-kien-so,550418,"Loa Vi Tính Logitech Z333 2.1 80W - Hàng Chính Hãng",1980000,1980000,0,0
TIKI,thiet-bi-kts-phu-kien-so,191604412,"Dây Đeo Thay Thế Dành Cho Vòng Đeo Tay Thông Minh Xiaomi MiBand 7 Dẻo TPU- Hàng chính hãng",43000,45000,2000,4
TIKI,thiet-bi-kts-phu-kien-so,77868208,"Webcam HXSJ S4 HD 1080P USB3.0 2.0 Có Thể Điều Chỉnh 360° Kèm Mic Cho Cuộc Gọi Video - Hàng Chính Hãng",359000,699000,340000,49
TIKI,thiet-bi-kts-phu-kien-so,159440670,"Đồng hồ Thông minh Gắn Sim 4G có Rung gọi Video call Định vị GPS, Wifi cho Trẻ em Học sinh Người lớn Chống nước IP67 Model cao cấp FA56 Hàng chính hãng",1587000,1587000,0,0
TIKI,thiet-bi-kts-phu-kien-so,52049435,"Bút cảm ứng stylus thông minh hiệu WIWU Pencil Magic Gen 2 cho màn hình cảm ứng iPad / iPhone / Samsung Xiaomi Huawei Oppo Sony LG (cảm ứng siêu mượt mà, dung lượng pin cao, thiết kế thời trang) - Hàng nhập khẩu - Trắng",639000,639000,0,0
TIKI,thiet-bi-kts-phu-kien-so,10127938,"Giá đỡ điện thoại Ô tô Baseus Osculum Car Mount - Hàng chính hãng",144999,144999,0,0
TIKI,thiet-bi-kts-phu-kien-so,75574549,"Tai nghe Bluetooth nhét tai không dây có hộp sạc - Tai nghe âm thanh nổi 3D có tính năng chống ồn - IPX5 - Chống nước - Hàng Chính Hãng PKCB",103000,500000,397000,79
TIKI,thiet-bi-kts-phu-kien-so,116638640,"Quạt hút gió tản nhiệt laptop máy tính Cool Cold hàng chính hãng máy tính tương thích với mọi loại laptop tặng kèm móc khóa 5TECH",115000,115000,0,0
TIKI,thiet-bi-kts-phu-kien-so,4340431,"Thẻ Nhớ Micro SD Netac 32GB - Hàng Chính Hãng",97800,97800,0,0
TIKI,thiet-bi-kts-phu-kien-so,136096397,"Ốp lưng da cổ điển dành cho iPhone 11 / 12 / 13 / 11 Pro / 12 Pro / 13 Pro / 11 Pro Max / 12 Pro Max / 13 Pro Max / 12 Mini / 13 Mini - Hàng chính hãng",149000,250000,101000,40
TIKI,thiet-bi-kts-phu-kien-so,8700751,"Cáp USB Type-C to HDMI hỗ trợ 4K dài 1.5m Ugreen 50570 - Hàng Chính Hãng",450000,590000,140000,24
TIKI,thiet-bi-kts-phu-kien-so,138226961,"Giá đỡ điện thoại dán tường khi sạc MW5 kiêm khay đựng remote ( Màu ngẫu nhiên) Hàng chính hãng",7999,7999,0,0
TIKI,thiet-bi-kts-phu-kien-so,97319439,"Ốp lưng da kính cao cấp dành cho iPhone 12 Mini / 12 / 12 Pro / 12 Pro Max - Hàng chính hãng",149000,199000,50000,25
TIKI,thiet-bi-kts-phu-kien-so,188214047,"Sạc dự phòng không dây từ tính Remax RPP-65, 10000mAH hỗ trợ sạc nhanh PD20W - Hàng Chính Hãng",531000,590000,59000,10
TIKI,thiet-bi-kts-phu-kien-so,191757014,"Cáp sạc nhanh đa năng Remax RC-190 - Hỗ trợ sạc nhanh lên đến 60W - Hàng Chính Hãng",169000,169000,0,0
TIKI,thiet-bi-kts-phu-kien-so,52087768,"Sim 4G MAY V77 (Vinaphone-Itelecom) gói cước 90GB/ tháng tốc độ cao – Hàng chính hãng - Giao mẫu ngẫu nhiên",79000,79000,0,0
TIKI,thiet-bi-kts-phu-kien-so,15186378,"USB OTG SanDisk Ultra Dual 128GB Type-C USB 3.1 DDC2 SDDDC2-128G-G46 - Hàng Chính Hãng",359000,385000,26000,7
TIKI,thiet-bi-kts-phu-kien-so,127930319,"Ốp lưng dành cho iPhone 13 Pro Max Memumi mỏng trong suốt (không ố màu) - Hàng nhập khẩu",87899,167000,79101,47
TIKI,thiet-bi-kts-phu-kien-so,15170396,"Máy Nghe Nhạc MP3 Ruizu X02 Bộ Nhớ Trong 8GB AZONE - Hàng Nhập Khẩu",438000,438000,0,0
TIKI,thiet-bi-kts-phu-kien-so,59044202,"Thẻ nhớ MicroSD Kioxia 32GB Class 10 - Hàng Nhập Khẩu",95000,95000,0,0
TIKI,thiet-bi-kts-phu-kien-so,58207084,"Tai nghe nhét tai Hoco M64 Melodious jack kết nối 3.5, âm thanh tuyệt vời - HÀNG NHẬP KHẨU",89000,89000,0,0
TIKI,thiet-bi-kts-phu-kien-so,190703528,"Dây đeo Magnetic Silicone Strap Dành Cho Apple Watch- Hàng chính hãng",182000,190000,8000,4
TIKI,thiet-bi-kts-phu-kien-so,138226190,"Cáp HDMI dài 3m cao cấp hỗ trợ Ethernet + 4k 2k chính hãng Ugreen 10108 10109 - Hàng chính hãng",95000,95000,0,0
TIKI,thiet-bi-kts-phu-kien-so,184100707,"Ốp lưng chống sốc trong suốt cho Samsung Galaxy S21 FE hiệu Likgus Crashproof giúp chống chịu mọi va đập - hàng nhập khẩu",89000,89000,0,0
TIKI,thiet-bi-kts-phu-kien-so,6610413,"Đầu jack chuyển đổi âm thanh từ cổng 3.5mm cái sang cổng 6.5mm đực chính hãng UGREEN 20503 - Hàng chính hãng",56000,56000,0,0
TIKI,thiet-bi-kts-phu-kien-so,162144193,"Ốp lưng chống sốc trong suốt cho Samsung Galaxy Note 9 hiệu Likgus Crashproof giúp chống chịu mọi va đập - hàng nhập khẩu",80000,99000,19000,19
TIKI,thiet-bi-kts-phu-kien-so,190520210,"Giá đỡ điện thoại Topshot 90 độ quay video chụp ảnh từ trên xuống hỗ trợ review sản phẩm - Giao màu ngẫu nhiên - Hàng chính hãng",159000,250000,91000,36
TIKI,thiet-bi-kts-phu-kien-so,140323745,"Tai Nghe Dây Nhét Tai Chống Ồn XSmart X6 Âm Thanh Siêu Bass Nghe Nhạc, Xem Phim, Chơi Game Cực Đã Tích Hợp Mic Lọc Âm, jack 3.5 - Hàng Chính Hãng",169000,169000,0,0
TIKI,thiet-bi-kts-phu-kien-so,193006708,"Định vị GPS không dây Thông minh FA81 Dành cho Trẻ em, Học sinh, Người già, Hàng hóa, Ô tô, Xe máy Hàng nhập khẩu",1250000,1250000,0,0
TIKI,thiet-bi-kts-phu-kien-so,134522531,"Ốp Lưng dành cho Google Pixel 7a/7/7 Pro/6/6 Pro RINGKE Fusion - Hàng Chính Hãng",206550,243000,36450,15
TIKI,thiet-bi-kts-phu-kien-so,116754406,"Băng dính gai làm gọn dây điện, băng dán gai đa năng băng nhám làm gọn góc PC, dây cáp sạc, tai nghe - Hàng nhập khẩu",8000,8000,0,0
TIKI,thiet-bi-kts-phu-kien-so,174593834,"Chuột bluetooth PIXLINK P103BL 2 chế độ sạc pin siêu mỏng không gây tiếng ồn chuyên dùng cho Máy tính, pc, Laptop, Tivi Hàng Chính Hãng",132000,299000,167000,56
TIKI,thiet-bi-kts-phu-kien-so,5986499,"Cáp HDMI 2.0 hỗ trợ 3D , 4K dài 1.5m UGREEN HD118 40409 - Hàng Chính Hãng",92000,100000,8000,8
TIKI,thiet-bi-kts-phu-kien-so,8112536,"Cáp Thunderbolt - Mini Displayport to HDMI + VGA Ugreen 20422 - Hàng Chính Hãng",337000,337000,0,0
TIKI,thiet-bi-kts-phu-kien-so,192445205,"Củ sạc nhanh GaN công suất 33W Remax RP-U25 chuẩn kép PD + QC 3.0 - Hàng chính hãng",315000,390000,75000,19
TIKI,thiet-bi-kts-phu-kien-so,122901569,"Bao da cao cấp dạng ví dành cho iPhone 13 Pro Max hàng chính hãng Caseme",120000,120000,0,0
TIKI,thiet-bi-kts-phu-kien-so,174511679,"Cổng chuyển đổi Ugreen USB 3.0 to USB-C Adapter US276 50533 - Hàng chính hãng",99000,130000,31000,24
TIKI,thiet-bi-kts-phu-kien-so,195915991,"Thẻ Nhớ MicroSDXC SanDisk Extreme Pro V30 A2 256GB 200MB/s SDSQXCD-256G (New 2022) - Hàng Nhập Khẩu",665000,665000,0,0
TIKI,thiet-bi-kts-phu-kien-so,168869275,"Bao da dành cho iPad Gen 9 10.2 inch 2021 có nắp bảo vệ camera Nillkin Bumper Leather - Hàng chính hãng",364999,444999,80000,18
TIKI,thiet-bi-kts-phu-kien-so,192198514,"Pin sạc dự phòng không dây WEKOME tích hợp sạc nhanh PD20W + QC22.5W nhiều cổng 10000mAh 287 289 Hàng nhập khẩu",375000,375000,0,0
TIKI,thiet-bi-kts-phu-kien-so,120782190,"Giá đỡ / Đế đỡ tản nhiệt dành cho laptop, macbook, máy tính bảng gấp gọn tiện dụng + tặng kèm túi đựng, ( Giao màu ngẫu nhiên )- Hàng chính hãng",67700,67700,0,0
TIKI,thiet-bi-kts-phu-kien-so,21297952,"Tai nghe nhét tai không dây cao cấp bluetooth v 4.1 Roman z6000,  hỗ trợ rung khi có cuộc gọi - Hàng Nhập Khẩu",500000,700000,200000,29
TIKI,thiet-bi-kts-phu-kien-so,176082185,"Ốp Lưng TPU trong suốt Siêu Mỏng Thinfit cho iPhone 13 / 13 Pro / 13 Pro Max - Hàng Chính Hãng",37990,37990,0,0
TIKI,thiet-bi-kts-phu-kien-so,151420174,"Loa Bluetooth JBL Go 3 JBLGO3 - Hàng chính hãng",990000,1090000,100000,9
TIKI,thiet-bi-kts-phu-kien-so,169809666,"Micro Karaoke Bluetooth kèm loa kết nối điện thoại, máy tính bảng Hát Không Dây, Nghe Nhạc, Hỗ Trợ Kết Nối Thẻ Nhớ, USB Pin sạc - Hàng Chính Hãng",450000,900000,450000,50
TIKI,thiet-bi-kts-phu-kien-so,172341289,"Bao Da Dành Cho iPad Pro 11 inch 2021/ 2022 ESR Rebound Magnetic Slim Case - Hàng Chính Hãng",721000,751000,30000,4
TIKI,thiet-bi-kts-phu-kien-so,114680946,"Bao da kèm bàn phím Logitech Combo Touch dành cho iPad Pro 12.9 inch (gen 5) - Bàn phím Backlit có thể tháo rời, Trackpad siêu nhạy - Hàng chính hãng",4400000,4590000,190000,4
TIKI,thiet-bi-kts-phu-kien-so,195916600,"Thẻ Nhớ MicroSDXC SanDisk Extreme Pro V30 A2 64GB 200MB/s SDSQXCU-064G (New 2022) - Hàng Nhập Khẩu",260000,260000,0,0
TIKI,thiet-bi-kts-phu-kien-so,108207118,"Cáp mạng Cat6 hỗ trợ truyền dữ liệu lên đến 1000Mbps dài 1-5m UGREEN NW135 - Hàng chính hãng",85000,100000,15000,15
TIKI,thiet-bi-kts-phu-kien-so,49548834,"Tai Nghe Có Dây Nhét Tai Sennheiser CX 80S - Hàng Chính Hãng",629000,629000,0,0
TIKI,thiet-bi-kts-phu-kien-so,181796865,"Tai nghe Bluetooth True Wireless Go Air Pop JLab màu xám xanh (slate) - Hàng chính hãng",890000,890000,0,0
TIKI,thiet-bi-kts-phu-kien-so,75434583,"Túi đựng điện thoại chống nước hình thú - Chính hãng",23000,25000,2000,8
TIKI,thiet-bi-kts-phu-kien-so,54626520,"Giá Đỡ Để Bàn Điện Thoại Di Động, Máy Tính Bảng Hợp Kim Nhôm Cao Cấp - 02 Vị Trí Điều Chỉnh Góc Nhìn Hàng Chính Hãng Helios",34000,34000,0,0
TIKI,thiet-bi-kts-phu-kien-so,162168764,"Bao Da Dành Cho iPad Pro 11 inch M1 2021/ Pro 11 inch M2 2022 ESR Rebound Pencil Case- Hàng Chính Hãng",720000,750000,30000,4
TIKI,thiet-bi-kts-phu-kien-so,2002793,"Bộ Switch Ugreen Vào 3 HDMI Ra 1 HDMI 40234",465000,490000,25000,5
TIKI,thiet-bi-kts-phu-kien-so,50295352,"Đầu chuyển đổi HDMI to VGA có hỗ trợ cổng audio 3.5mm VENTION AIDB0 - Hàng chính hãng",195000,230500,35500,15
TIKI,thiet-bi-kts-phu-kien-so,139462714,"Tai Nghe Bluetooth Tai Mèo Phát Sáng VinBuy, Tai Nghe Không Dây, Tai Nghe Chụp Tai, Tai Nghe Mèo Có Mic, Đèn LED Và Âm Bass Mạnh Mẽ - Chính Hãng",138000,250000,112000,45
TIKI,thiet-bi-kts-phu-kien-so,170105386,"Thẻ Nhớ Micro SDXC Samsung Evo Plus 130MB/s 64GB New - Hàng Nhập Khẩu",165000,165000,0,0
TIKI,thiet-bi-kts-phu-kien-so,176213226,"Micro Karaoke kèm loa Bluetooth iCore YM99 - Hàng chính hãng",990000,1290000,300000,23
TIKI,thiet-bi-kts-phu-kien-so,3571519,"Bộ Thu Phát Âm Thanh Chuyển Đổi Bluetooth 4.1 TP-Link HA100 (Đen) - Hàng Chính Hãng",399000,699000,300000,43
TIKI,thiet-bi-kts-phu-kien-so,106054017,"Cáp sạc nhanh C to C màn hình LED PD 100W Baseus Display Series CATSK-C01- Hàng chính hãng",167000,167000,0,0
TIKI,thiet-bi-kts-phu-kien-so,192986165,"Đồng hồ Thông minh SOS Gọi điện thoại Định vị GPS Chống nước IP67 AMA Watch D06S cho Trẻ con 4 tuổi 5 tuổi 6 tuổi 7 tuổi 8 tuổi 9 tuổi 10 tuổi 11 tuổi Hàng nhập khẩu",950000,950000,0,0
TIKI,thiet-bi-kts-phu-kien-so,197574571,"Ốp Lưng Elago Clear Case Dành Cho iPhone 14 ProMax / 14 Pro / 14 Plus / 14 - Hàng Chính Hãng",330000,373000,43000,12
TIKI,thiet-bi-kts-phu-kien-so,72217122,"Ốp Lưng TPU Dẻo Viền Vuông Giả iPhone 12 Dành Cho iPhone 6,7,6 Plus,7Plus,X,Xr,Xs Max,11,11 Pro, 11 Pro Max- Hàng Chính Hãng",79000,79000,0,0
TIKI,thiet-bi-kts-phu-kien-so,58080959,"Túi đựng dây sạc củ sạc chuột máy tính, tai nghe và phụ kiện công nghệ Baona - Hàng nhập khẩu",156024,177300,21276,12
TIKI,thiet-bi-kts-phu-kien-so,160906816,"Tai nghe có dây Sony MDR-EX155AP - Hàng chính hãng",379000,390000,11000,3
TIKI,thiet-bi-kts-phu-kien-so,144684441,"Ốp lưng kháng khuẩn Baseus Liquid Silica Gel Protective Case dành cho iPhone 13 Promax/ 13/ 13 Pro_ Hàng Chính Hãng",182000,274998,92998,34
TIKI,thiet-bi-kts-phu-kien-so,71986961,"Tai nghe KZ EDX - Bản nâng cấp mới, Bass tốt hơn, có micro - hàng chính hãng",178000,178000,0,0
TIKI,thiet-bi-kts-phu-kien-so,108753341,"Cốc sạc siêu nhỏ gọn 20W Baseus Compact Quick Charger (USB + Type C, công suất 20W) - Hàng Chính Hãng",165000,199000,34000,17
TIKI,thiet-bi-kts-phu-kien-so,74908430,"Bàn phím cơ E-Dra EK3104 Huano Switch(Blue/Brown",1118600,1118600,0,0
TIKI,thiet-bi-kts-phu-kien-so,22380700,"Dây 2 Đầu HDMI 3m Unitek - Cáp HDMI 3m Unitek Full HD 4K - Hàng nhập khẩu ",84900,84900,0,0
TIKI,thiet-bi-kts-phu-kien-so,115529829,"SD/TF chuẩn USB 3.1 Type C Đầu đọc thẻ nhớ vỏ nhôm cao cấp Ugreen đt401n80888CM - Hàng chính hãng",270000,270000,0,0
TIKI,thiet-bi-kts-phu-kien-so,56026597,"Hộp đựng phụ kiện công nghệ SmileBox form cứng đựng ổ cứng, pin sạc, tai nghe, bộ sạc điện thoại nhiều size- Hàng chính hãng",45000,45000,0,0
TIKI,thiet-bi-kts-phu-kien-so,189580427,"Chuột Không Dây Logitech M221 White - Hàng Chính Hãng",249000,249000,0,0
TIKI,thiet-bi-kts-phu-kien-so,2431785,"Máy Trợ Giảng Không Dây Shidu SD-S611 (UHF)",684000,713000,29000,4
TIKI,thiet-bi-kts-phu-kien-so,72646091,"Giá Đỡ Điện Thoại Gương Chiếu Hậu Trong Xe Hơi Chất Liệu Nhựa ABS Hoco CA70 - Siêu Chắc Chắn - Hàng Nhập Khẩu",48888,66813,17925,27
TIKI,thiet-bi-kts-phu-kien-so,196559521,"Loa Nghe Nhạc Mini Cầm Tay Huqu HQ-M10- Thiết Kế Nhỏ Gọn, Cầm Tay -Hàng Chính Hãng",241000,290000,49000,17
TIKI,thiet-bi-kts-phu-kien-so,195305688,"Adapter Sạc 2 Cổng ANKER 521 Nano Pro 40W Type-C Sạc Nhanh Nhỏ Gọn Tích Hợp PIQ 3.0 Tương Thích Iphone 13/13 Mini / 13 Pro / 13 Pro Max / 12, Galaxy, Pixel 4/3, Ipad / Ipad Mini A2038 - Hàng Chính Hãng",649000,950000,301000,32
TIKI,thiet-bi-kts-phu-kien-so,4167993,"Bàn phím gấp gọn Bluetooth tích hợp chuột touchpad hỗ trợ chơi game B033 Aturos (màu Đen) - Hàng chính hãng",445000,445000,0,0
TIKI,thiet-bi-kts-phu-kien-so,102766392,"Loa Bluetooth thông minh kháng nước Remax RB-M28 hàng chính hãng",1083000,1300000,217000,17
TIKI,thiet-bi-kts-phu-kien-so,157215759,"Chuột Không Dây GX9 - Bluetooth + Wireless 2.4G  - Pin sạc  - Chống ồn - hàng nhập khẩu",278000,290000,12000,4
TIKI,thiet-bi-kts-phu-kien-so,5911431,"Cáp Chuyển Đổi Displayport To HDMI 4K Ugreen 40363 - Hàng Chính Hãng",185000,280000,95000,34
TIKI,thiet-bi-kts-phu-kien-so,188565088,"Loa Bluetooth JBL Flip 6 - Hàng Chính Hãng",2590000,2990000,400000,13
TIKI,thiet-bi-kts-phu-kien-so,97057371,"Pin sạc dự phòng Hoco J72-10.000mAh-HÀNG CHÍNH HÃNG",135000,135000,0,0
TIKI,thiet-bi-kts-phu-kien-so,145613865,"2 Bộ đàm Motorola XPR-368 + 2 Tai nghe chuyên dụng cho bộ đàm, phiên bản mới nhỏ gọn, liên lạc xa 2.5 km, pin dùng 12 giờ, xuyên phá vật cản tốt - Hàng nhập khẩu",540000,540000,0,0
TIKI,thiet-bi-kts-phu-kien-so,163281226,"Cáp Sạc OPPO Micro USB  DL109 - Hàng Chính Hãng",84000,120000,36000,30
TIKI,thiet-bi-kts-phu-kien-so,144643830,"Ốp lưng kính cường lực nhám chống vân tay Baseus Frosted Glass Protective Case dành cho iPhone 13 Series_ Hàng Chính Hãng",240000,274998,34998,13
TIKI,thiet-bi-kts-phu-kien-so,361279,"Bàn Phím Game Fuhlen L411 - Hàng Chính Hãng",169000,169000,0,0
TIKI,thiet-bi-kts-phu-kien-so,98149754,"Bao Da Dành Cho iPad Pro 11 inch 2021/2022 và iPad Pro 12.9 inch 2021/2022 ESR Rebound Magnetic Slim Case - Hàng Nhập Khẩu",850000,850000,0,0
TIKI,thiet-bi-kts-phu-kien-so,101187475," Chuột Gaming không dây Chuột DareU EM901 RGB (Đen/Hồng) - CHÍNH HÃNG",550000,550000,0,0
TIKI,thiet-bi-kts-phu-kien-so,80446970,"Loa Nghe Nhạc Bluetooth Hỗ Trợ Khe Cắm Thẻ Nhớ, USB - Hàng Chính Hãng",169000,350000,181000,52
TIKI,thiet-bi-kts-phu-kien-so,5911429,"Cáp Chuyển Displayport Sang HDMI Ugreen 40362 - Hàng Chính Hãng",158000,158000,0,0
TIKI,thiet-bi-kts-phu-kien-so,195032632,"Bao da cao cấp dành cho iPhone 13 / 13 Pro / 13 Pro Max - Hàng chính hãng - Photodesign VN",239000,300000,61000,20
TIKI,thiet-bi-kts-phu-kien-so,98073814,"Tai Nghe Không Dây Nhét Tai, Tai Nghe Stereo Rảnh Tay ABS TWS Bluetooth 5.0 - Hàng Chính Hãng PKCB",186000,500000,314000,63
TIKI,thiet-bi-kts-phu-kien-so,181000098,"Bao Da Dành Cho iPad Air 4/ Air 5 ESR Ascend Trifold Hard Case - Hàng Chính Hãng",662000,690000,28000,4
TIKI,thiet-bi-kts-phu-kien-so,172369953,"Loa Bluetooth PKCB Bản Mở Rộng, chip DSP, Hỗ Trợ Kết Nối Bluetooth, USB, Thẻ Nhớ,  dây 3.5mm 100W TWS Âm Thanh Sống Động - Hàng chính hãng",2500000,5000000,2500000,50
TIKI,thiet-bi-kts-phu-kien-so,2850663,"Gá Kẹp Điện Thoại Ulanzi Phone Tripod Mount 360 - Hàng Chính Hãng",78000,78000,0,0
TIKI,thiet-bi-kts-phu-kien-so,184410513,"Chuột công thái học không dây Logitech Lift Vertical Ergonomic - Hàng Chính Hãng",1339000,1339000,0,0
TIKI,thiet-bi-kts-phu-kien-so,189386912,"SIM ĐẸP VIETTEL 09 TRẢ TRƯỚC - CHỌN SỐ - NGHE GỌI - 4G - MỚI 100% - HÀNG CHÍNH HÃNG",129000,129000,0,0
TIKI,thiet-bi-kts-phu-kien-so,23518127,"Chuột Không Dây Microsoft 1850 Receiver USB - Hàng Chính Hãng",225000,225000,0,0
TIKI,thiet-bi-kts-phu-kien-so,120364526,"Chuột máy tính gaming SIDOTECH G5S chuyên chơi game Esport đèn Led Rgb / 6 Nút Bấm / DPI 3200 / tuổi thọ 30 triệu lần click cao thiết kế công thái học cho game thủ streamer FPS Moba lướt web thiết kế làm việc văn phòng tương  - Hàng chính hãng",62000,67540,5540,8
TIKI,thiet-bi-kts-phu-kien-so,17533229,"Bao Da Smart Case Gen2 TPU Dành Cho iPad Mini 5 - Hàng nhập khẩu",101000,285998,184998,65
TIKI,thiet-bi-kts-phu-kien-so,87233516,"Củ Sạc Điện Thoại Ô Tô 38W CHOETECH TC0005 V2 USB Quick Charge 3.0 18W, Type-C PD 20W - Hàng Chính Hãng",199000,390000,191000,49
TIKI,thiet-bi-kts-phu-kien-so,360759,"Tai nghe có dây Logitech H340 - Hàng chính hãng",469000,479000,10000,2
TIKI,thiet-bi-kts-phu-kien-so,91189740,"Dây dán tiên lợi Velcro làm gọn dây sạc, dây tai nghe,... UGREEN 50370- Hàng chính hãng",15000,15000,0,0
TIKI,thiet-bi-kts-phu-kien-so,56024494,"Kẹp điện thoại vặn bằng đinh ốc, kẹp ngang kẹp dọc điện thoại gắn lên tripod chuẩn ren 1/4 - Hàng chính hãng",55000,55000,0,0
TIKI,thiet-bi-kts-phu-kien-so,127794615,"Cáp Sạc Nhanh Iphone PD 20w Superior Series, Q.C 3.0, Truyền Dữ Liệu Nhanh 480Mbps - Hàng Chính Hãng Baseus",85000,89000,4000,4
TIKI,thiet-bi-kts-phu-kien-so,165032162,"Ốp lưng dành cho Samsung Galaxy S21 FE Rugged Shield Cao Cấp - Hàng Nhập Khẩu",95998,95998,0,0
TIKI,thiet-bi-kts-phu-kien-so,67056051,"Giá Đỡ Để Bàn Điện Thoại Máy Tính Bảng Ipad Hợp Kim Nhôm ABS Cao Cấp Nâng Hạ - Xoay Tròn - Điều Chỉnh Góc Độ - KT 95x95x20 Cm - Hàng Chính Hãng",198000,198000,0,0
TIKI,thiet-bi-kts-phu-kien-so,44836348,"Ốp lưng da vải kiêm ví cao cấp dành cho iPhone 11 Pro",69000,119000,50000,42
TIKI,thiet-bi-kts-phu-kien-so,74456975,"Ốp Lưng Silicon TPU trong suốt GOR cho iPhone 12 Mini / 12 / 12 Pro / 12 Pro Max - Hàng Nhập Khẩu",38000,79998,41998,52
TIKI,thiet-bi-kts-phu-kien-so,80950282,"Ốp lưng chống sốc trong suốt siêu mỏng cho iPhone 12 Pro Max (6.7 inch) bảo vệ camera hiệu Likgus Crashproof giúp chống chịu mọi va đập - hàng nhập khẩu",79931,150000,70069,47
TIKI,thiet-bi-kts-phu-kien-so,174593799,"Chuột Bluetooth Không Dây PIX-LINK  P90A Wireless USB Tự Sạc Pin Siêu Mỏng, Chống Ồn - Hàng Chính Hãng",125000,229000,104000,45
TIKI,thiet-bi-kts-phu-kien-so,56879851,"Chuột Quang MACRO HXJS J900 RGB Bề Mặt Lưới Xuyên Thấu Cực Đẹp DPI 6400 - Hàng chính hãng",299000,399000,100000,25
TIKI,thiet-bi-kts-phu-kien-so,140523443,"Chuột Bluetooth Dareu LM115B Pink (Màu Hồng) - Kết Nối Điện Thoại, iPad, Macbook - Hàng Chính Hãng",265000,265000,0,0
TIKI,thiet-bi-kts-phu-kien-so,203734,"Chuột Không Dây Logitech M325 - Hàng Chính Hãng",432000,432000,0,0
TIKI,thiet-bi-kts-phu-kien-so,50254961,"Ốp lưng dẻo cho Samsung Galaxy S20 Plus hiệu Nillkin mỏng 0.6mm, chống trầy xước - Hàng chính hãng",88000,88000,0,0
TIKI,thiet-bi-kts-phu-kien-so,57518181,"Webcam HYSJ A849S cho máy tính - hàng nhập khẩu",145000,145000,0,0
TIKI,thiet-bi-kts-phu-kien-so,165519983,"Dán cường lực Zeelot Pure Shield Glass Cho Galaxy Tab S8/ S8 Plus/ S8 Ultra - Hàng Chính Hãng",450000,450000,0,0
TIKI,thiet-bi-kts-phu-kien-so,112055244,"Đầu ngòi thay thế cho bút Apple Pencil 1/ Pencil 2 - Dùng như ngòi gốc Apple pencil tips_ Hàng Chính Hãng",67620,69000,1380,2
TIKI,thiet-bi-kts-phu-kien-so,54889765,"Baseus LV106-B01 Đầu Chuyển OTG USB Type C Sang USB | Chính hãng Baseus",85000,85000,0,0
TIKI,thiet-bi-kts-phu-kien-so,56248615,"Dây Đeo Thay Thế Cho Vòng Đeo Tay Thông Minh Xiaomi Mi Band 3 Mi Band 4 - Hàng Chính Hãng",40500,80000,39500,49
TIKI,thiet-bi-kts-phu-kien-so,195134097,"Ốp lưng chống sốc cho Samsung Galaxy Z Fold 3 hiệu Likgus Glitter siêu mỏng 1.5mm độ trong tuyệt đối, chống trầy xước, chống ố vàng, tản nhiệt tốt - hàng nhập khẩu",99999,99999,0,0
TIKI,thiet-bi-kts-phu-kien-so,140376071,"Tai nghe bluetooth True Wireless thiết kế retro Remax TWS-38 - Hàng chính hãng",497000,990000,493000,50
TIKI,thiet-bi-kts-phu-kien-so,101847035,"Loa Bluetooth Không Dây Cao Cấp XSmart A36 PRO BASS 2021 Âm Thanh Nghe Nhạc Siêu Đã Tương Thích Điện Thoại Máy Tính Laptop Tivi - Hàng Chính Hãng",179000,179000,0,0
TIKI,thiet-bi-kts-phu-kien-so,33762008,"Miếng Dán Kính Cường Lực Cho Iphone 11 - Màu Đen - Full Màn Hình - Hàng Chính Hãng",26994,53988,26994,50
TIKI,thiet-bi-kts-phu-kien-so,32216052,"ốp lưng cho samsung note 10 và note 10 plus chống sốc - chính hãng Xundd",79000,79000,0,0
TIKI,thiet-bi-kts-phu-kien-so,196478933,"Tai Nghe Bluetooth True Wireless Cảm Ứng Không Dây TCT-HGD-X10 Dung Lượng Pin Lớn-Điều Chỉnh Âm Lượng - Hàng Chính Hãng",568000,599000,31000,5
TIKI,thiet-bi-kts-phu-kien-so,73604989,"Combo 2 bộ đàm Motorola Minitor VI siêu nhỏ, siêu nhẹ bỏ túi - Hàng nhập khẩu",560000,560000,0,0
TIKI,thiet-bi-kts-phu-kien-so,16051164,"Vô Lăng Logitech G29 Kèm Cần Số Rời - Hàng chính hãng",8190000,8190000,0,0
TIKI,thiet-bi-kts-phu-kien-so,98653521,"Miếng dán màn hình kính cường lực cho iPad Pro 11 inch 2021/2022 hiệu Nillkin Amazing H+ (mỏng 0.2 mm, vát cạnh 2.5D, chống trầy, chống va đập) - Hàng Chính Hãng",199993,399986,199993,50
TIKI,thiet-bi-kts-phu-kien-so,110948021,"Tai nghe HiFi Headphone có dây siêu nhẹ Remax RM-595 [Hàng chính hãng",216000,330000,114000,35
TIKI,thiet-bi-kts-phu-kien-so,94519609,"Tai nghe game in-ear Logitech G333 - màn loa động kép Dual Driver, độ bền cao, 3.5mm Aux, Mic và điều khiển trên dây - Màu",949000,949000,0,0
TIKI,thiet-bi-kts-phu-kien-so,59306865,"Tai nghe KZ ZSN Pro X - Bản nâng cấp tốt hơn, đẹp hơn có micro - Hàng chính hãng",549000,599000,50000,8
TIKI,thiet-bi-kts-phu-kien-so,73165600,"Chuột không dây Bluetooth Logitech MX Anywhere 3 for Mac - nhỏ gọn, kết nối 3 thiết bị, cuộn siêu nhanh, sạc nhanh USB-C - Hàng chính hãng",1690000,1690000,0,0
TIKI,thiet-bi-kts-phu-kien-so,58943519,"Cáp Chuyển Đổi Belkin từ USB Type-C Sang HDMI / USB Type-C PD 60W - Hàng Chính Hãng",690000,990000,300000,30
TIKI,thiet-bi-kts-phu-kien-so,5993887,"Dây cáp DisplayPort 2 đầu đực tốc độ 21.6Gbps dài 3M UGREEN DP102 10212 - Hàng Chính Hãng",190000,190000,0,0
TIKI,thiet-bi-kts-phu-kien-so,71088250,"Củ Sạc Điện Thoại 30W 1 Cổng USB Và 1 Type-C PD 18W RAVPower RP-PC132 - Hàng Chính Hãng",299000,550000,251000,46
TIKI,thiet-bi-kts-phu-kien-so,2246543,"Máy Nghe Nhạc Mp3 Ruizu X02 (Trắng) - Hàng Chính Hãng",350000,350000,0,0
TIKI,thiet-bi-kts-phu-kien-so,159604316,"Combo Củ Sạc Nhanh Type-C 25W RAVPower RP-PC156-B Và Cáp C to Light.ning MFI C94 Sạc Nhanh 20W Cho iPhone, Cho iPad RP-CB1017 - Hành Chính Hãng",549000,890000,341000,38
TIKI,thiet-bi-kts-phu-kien-so,7090463,"Loa Bluetooth Anker SoundCore Motion B - A3109011",1400000,1400000,0,0
TIKI,thiet-bi-kts-phu-kien-so,196479355,"Tai Nghe Bluetooth True WIreless TWS Cảm Ứng TCT-S18 Chống Ồn ENC - Mic Đàm Thoại- Chế Độ Nhạc vs Gaming - Điều Chỉnh Tăng Giảm Âm Lượng - Hàng Chính Hãng",800000,800000,0,0
TIKI,thiet-bi-kts-phu-kien-so,105513634,"Tai Nghe Bluetooth Tai Nghe Cảm Ứng Không Dây Wireless Headset - Hàng Chính Hãng PKCB",187000,500000,313000,63
TIKI,thiet-bi-kts-phu-kien-so,34177220,"Bộ gộp-chia HDMI 2 chiều hỗ trợ 4K2K@30Hz hàng chính hãng Ugreen mã UG-50966",214000,240900,26900,11
TIKI,thiet-bi-kts-phu-kien-so,117091126,"Bao da kèm bàn phím Bluetooth dành cho Samsung Galaxy Tab S7 FE cao cấp - Hàng nhập khẩu",545000,545000,0,0
TIKI,thiet-bi-kts-phu-kien-so,72455227,"Ốp lưng chống sốc lưng trong cao cấp dành cho",149000,199000,50000,25
TIKI,thiet-bi-kts-phu-kien-so,97030109,"Tai Nghe Chống Ồn XSmart QKZ AK6 PRO Bass Siêu Khủng, Âm Thanh Cực Đỉnh, Giải Trí Chơi Game Siêu Thích - Hàng Chính Hãng",119000,119000,0,0
TIKI,thiet-bi-kts-phu-kien-so,57825125,"Chuột Không Dây Kiểu Đứng HXSJ T24X, Chống Mỏi Tay 2400DPI - Hàng chính hãng",490000,490000,0,0
TIKI,thiet-bi-kts-phu-kien-so,9357400,"Cáp nối dài loa Ugreen 40673 dài 1m chính hãng hỗ trợ mic",80000,80000,0,0
TIKI,thiet-bi-kts-phu-kien-so,141122603,"Pad Chuột Logitech Desk Mat Studio Series - Hàng Chính Hãng",469000,469000,0,0
TIKI,thiet-bi-kts-phu-kien-so,160797845,"Cáp Sạc Cho iPhone, iPad Hoco X14 - Cáp Sạc Dây Dù Siêu Bền - Dài 1M/2M - Hàng Chính Hãng",49000,49000,0,0
TIKI,thiet-bi-kts-phu-kien-so,59384196,"Chuột game không dây Lightspeed Logitech G502 - Hàng chính hãng",2380000,2380000,0,0
TIKI,thiet-bi-kts-phu-kien-so,419024,"Webcam Logitech C920 Pro Full HD 1080p 30FPS - micro kép to rõ, tự động lấy nét và chỉnh sáng HD, thấu kinh Full HD cao cấp, phù hợp PC/ Laptop/ Mac - Hàng chính hãng",1980000,2999000,1019000,34
TIKI,thiet-bi-kts-phu-kien-so,73622188,"Kẹp Dán Cố Định Dây Cáp, Dây Sạc Điện Thoại - Hàng Chính Hãng",18000,99000,81000,82
TIKI,thiet-bi-kts-phu-kien-so,56078205,"Ốp lưng dành cho Samsung A50 / A50s mẫu Ngày Bình An",42000,55000,13000,24
TIKI,thiet-bi-kts-phu-kien-so,88191430,"Loa Bluetooth Không Dây Siêu Bass Âm Thanh Trầm Nghe Nhạc Usb Thẻ Nhớ - Hàng Chính Hãng PKCB",191000,500000,309000,62
TIKI,thiet-bi-kts-phu-kien-so,97036830,"Tai Nghe Gaming 2021 Chống Ồn Cao Cấp XSmart GH5 Gamer Pro Phiên Bản Nâng Cấp sendem S2 , Tặng Bộ Phụ Kiện Mic Rời - Hàng Chính Hãng",189000,189000,0,0
TIKI,thiet-bi-kts-phu-kien-so,121242259,"Chuột có dây Dell MS116-Hàng chính hãng",99000,99000,0,0
TIKI,thiet-bi-kts-phu-kien-so,6411193,"Cáp chuyển đổi mini HDMI đực sang HDMI cái dài 25CM UGREEN 20137 - Hàng Chính Hãng",89000,89000,0,0
TIKI,thiet-bi-kts-phu-kien-so,159971506,"Bàn phím cơ Newmen GE87 TKL N-Box Outemu Switch - Hàng chính hãng",450000,450000,0,0
TIKI,thiet-bi-kts-phu-kien-so,59090334,"Pin Sạc Dự Phòng RAVPower 20000mAh Quick Charge 3.0 + PD 60W, In/Out Type-C, Sạc Được Macbook - RP-PB201 - Hàng Chính Hãng",1090000,1690000,600000,36
TIKI,thiet-bi-kts-phu-kien-so,91190620,"Cáp SATA 3.0 tốc độ truyền tải cao 6Gb/s dài 0.5m UGREEN US217 - Hàng chính hãng",41000,45000,4000,9
TIKI,thiet-bi-kts-phu-kien-so,126075524,"Củ sạc nhanh 30W Remax RP-U82 chuẩn kép QC+PD - Hàng chính hãng",370000,370000,0,0
TIKI,thiet-bi-kts-phu-kien-so,150936706,"Bàn phím cơ không dây Dareu EK807G White- Hàng Chính Hãng",649000,649000,0,0
TIKI,thiet-bi-kts-phu-kien-so,191725990,"Thẻ nhớ Samsung Evo Plus MicroSDXC 32GB | 64GB | 128GB | 256GB | 512GB - Hàng chính hãng",170000,200000,30000,15
TIKI,thiet-bi-kts-phu-kien-so,210427335,"Takstar E300W- Tặng túi rút đựng máy trợ giảng - Máy Trợ Giảng Không Dây UHF, Kết Nối Bluetooth, Công Suất 10W Cho Giáo Viên, Bán Hàng- Hàng chính hãng",990000,990000,0,0
TIKI,thiet-bi-kts-phu-kien-so,191809663,"Sạc dự phòng không dây từ tính Remax RPP-281 dung lượng 10000mAh kèm cáp sạc nhanh 2 chiều tiện lợi - Hàng chính hãng",711000,990000,279000,28
TIKI,thiet-bi-kts-phu-kien-so,32292159,"ốp lưng cho iphone 11 pro và iphone 11 max pro chống sốc - chính hãng Xundd",92999,92999,0,0
TIKI,thiet-bi-kts-phu-kien-so,70820558,"Ốp cho Samsung Galaxy Note 10 Plus - Silicon trong suốt hãng GOR Hàng nhập khẩu",38000,38000,0,0
TIKI,thiet-bi-kts-phu-kien-so,123367765,"Ốp Nillkin Camshield bảo vệ Camera cho iPhone 13 Pro Max - Hàng nhập khẩu",128000,299998,171998,57
TIKI,thiet-bi-kts-phu-kien-so,111726388,"Đầu bút thay thế ngòi cao cấp dành cho Apple Pencil 1, 2 - Apple Pencil Tips_ Hàng Chính Hãng",56000,64000,8000,13
TIKI,thiet-bi-kts-phu-kien-so,97057377,"Pin sạc dự phòng Hoco J75 10000mAh 2 cổng Input/Output max 2A,HÀNG CHÍNH HÃNG",150000,150000,0,0
TIKI,thiet-bi-kts-phu-kien-so,186206677,"Túi hộp Smilebox khung cứng chống sốc đựng tai nghe chụp đầu, tai nghe chụp 2 tai bluetooth loại lớn - Hàng chính hãng",89000,89000,0,0
TIKI,thiet-bi-kts-phu-kien-so,95466098,"Bao da kèm bàn phím Bluetooth Samsung Tab S6 Lite P610 Smart Keyboard - Hàng nhập khẩu",338990,338990,0,0
TIKI,thiet-bi-kts-phu-kien-so,58875726,"SIM 4G Mobifone VPB51 Tặng 500GB/Tháng",750000,750000,0,0
TIKI,thiet-bi-kts-phu-kien-so,78011688,"Adapter Củ Sạc 100W 2 Cổng Type C cho Macbook, Laptop, Smartphone CHOETECH PD6008 Kèm Dây Cáp Type C to C 100W - Hàng Chính Hãng",849000,1500000,651000,43
TIKI,thiet-bi-kts-phu-kien-so,130269035,"Củ sạc nhanh Baseus compact quick charger 3 cổng 2A1C 30W- hàng chính hãng",299000,299000,0,0
TIKI,thiet-bi-kts-phu-kien-so,77125504,"Bàn Phím Không Dây Đa Năng HiBow - Hàng Chính Hãng",190000,190000,0,0
TIKI,thiet-bi-kts-phu-kien-so,55670282,"Chân cắm sạc tròn chắc chắn, thẩm mỹ thay thế cho chân dẹt của Iphone/Ipad/Macbook",69000,69000,0,0
TIKI,thiet-bi-kts-phu-kien-so,79600205,"Thiết Bị Chuyển Đổi Ethernet Adapter ROBOT EA10 USB 2.0 to LAN Tốc Độ  10/100Mbps - Hàng chính hãng",171000,190000,19000,10
TIKI,thiet-bi-kts-phu-kien-so,101530842,"Pin Sạc Dự Phòng Xiaomi Redmi 20000mAh sạc nhanh 18W - Hàng chính hãng",550000,550000,0,0
TIKI,thiet-bi-kts-phu-kien-so,103850348,"Tai Nghe Không Dây Mẫu Mới Thiết Kế Màn Hình Led Ấn Tượng Sử Dụng Cảm Biến Vân Tay Thông Minh - Hàng Chính Hãng PKCB",184000,500000,316000,63
TIKI,thiet-bi-kts-phu-kien-so,33115720,"Micro Ghi Âm Cài Áo BOYA BY-M - Hàng nhập khẩu",250000,250000,0,0
TIKI,thiet-bi-kts-phu-kien-so,141304837,"Kính cường lực Nillkin CP+ PRO cho iPhone 13 Mini / 13 / 13 Pro / 13 Pro Max - Hàng Nhập Khẩu",123000,269999,146999,54
TIKI,thiet-bi-kts-phu-kien-so,73751947,"Tai Nghe Bluetooth không dây True Wireless PKCB, Màn Hình Led hiển Thị Pin - Hàng chính hãng",221000,500000,279000,56
TIKI,thiet-bi-kts-phu-kien-so,191719745,"Loa Bluetooth Marshall Willen Portable - Hàng chính hãng",2790000,2790000,0,0
TIKI,thiet-bi-kts-phu-kien-so,179911051,"Micro không Dây F18 cho điện thoại , máy tính bảng , android , ios chất lượng cao - hàng nhập khẩu",135000,135000,0,0
TIKI,thiet-bi-kts-phu-kien-so,360738,"Tay cầm chơi game console có dây Logitech F310 - 4 phím di chuyển D-Pad, tương thích TV Android, dây 1.8m - Hàng chính hãng",489000,499000,10000,2
TIKI,thiet-bi-kts-phu-kien-so,190506536,"Miếng Dán Mặt Lưng Và Cạnh Viền Film Hydrogel Dành Cho Iphone 14/ 14pro/ 14 promax/ 13/13 Pro/ 13 Promax/ 12 Promax- Hàng chính hãng",37000,39000,2000,5
TIKI,thiet-bi-kts-phu-kien-so,82033657,"Bao Da Case Cover Dành Cho iPad Mini 5/ iPad Pro 11 inch/ iPad Air 3 / iPad Pro 3/ iPad Air 4 / iPad 7/8 / iPad Pro 12.9 inch - Hàng Chính Hãng Có Khe Cắm Apple Pencil",99000,99000,0,0
TIKI,thiet-bi-kts-phu-kien-so,121603766,"Micro Có Dây Cao Cấp SHURE KSM8A- chính hãng",380000,380000,0,0
TIKI,thiet-bi-kts-phu-kien-so,178315901,"HUB Chuyển Đổi Type C To HDMI 4K/ PD 100W/ USB 3.0/ Rj45 Ethernet/ VGA/ TF/ SD (9 Trong 1) CHOETECH HUB-M15 - Hàng Chính Hãng",848000,1690000,842000,50
TIKI,thiet-bi-kts-phu-kien-so,57287349,"Đài USB THẺ NHỚ NGHE NHẠC WAXIBA XB-521URT RADIO AM\FM\SW LOA TO X-BASS CÓ ĐÈN PIN GIAO MÀU NGẪU NHIÊN HÀNG CHÍNH HÃNG",165000,165000,0,0
TIKI,thiet-bi-kts-phu-kien-so,1600005,"Tai Nghe Nhét Tai Mi Basic Xiaomi",125000,129000,4000,3
TIKI,thiet-bi-kts-phu-kien-so,38151960,"Cáp sạc nhanh Micro USB Hoco X14, dây sạc bọc dù chống đứt, chống rối, hỗ trợ truyền dữ liệu dành cho Samsung/Huawei/Xiaomi/Oppo/Sony, sạc nhanh 2A Max - Hàng chính hãng",44000,44000,0,0
TIKI,thiet-bi-kts-phu-kien-so,88796681,"Dây Cáp Nối Dài USB 3.0 Dài 2M CHOETECH XAA001-BK - Hàng Chính Hãng",89000,190000,101000,53
TIKI,thiet-bi-kts-phu-kien-so,190936461,"Cáp sạc USB-C to Light.ning BOOST↑CHARGE PRO Flex Belkin vỏ silicone bọc dù 60W - Hàng chính hãng - CAA011bt",660000,899000,239000,27
TIKI,thiet-bi-kts-phu-kien-so,186608758,"Ốp lưng silicon dẻo trong suốt cho Samsung Galaxy A52 / A52 5G / A52s hiệu Ultra Thin mỏng 0.6mm độ trong tuyệt đối chống trầy xước - Hàng nhập khẩu",39000,39000,0,0
TIKI,thiet-bi-kts-phu-kien-so,116753482,"Kẹp dán cố định dây cáp sạc, tai nghe, dây phụ kiện đa năng làm gọn bàn làm việc, taplo xe hơi cực tiện dụng - Hàng nhập khẩu",15000,15000,0,0
TIKI,thiet-bi-kts-phu-kien-so,23490593,"Bộ bàn phím Logitech K120 + chuột Logitech B100 - Hàng chính hãng",289000,289000,0,0
TIKI,thiet-bi-kts-phu-kien-so,56718615,"Bao da Samsung Galaxy Tab S6 Lite P610/P615 DUX DUCIS Smartcover - Hàng nhập khẩu",289000,289000,0,0
TIKI,thiet-bi-kts-phu-kien-so,72014868,"Ốp lưng da cao cấp dành cho",149000,199000,50000,25
TIKI,thiet-bi-kts-phu-kien-so,136684907,"Tai Nghe Nhét Tai Chống Ồn Gaming XSmart G10 Cao Cấp Siêu Ngầu Dùng Cho Cả Máy Tính, Điện Thoại, Có Mic Rời, Tặng Bộ Phụ Kiện - Hàng Chính Hãng",199000,199000,0,0
TIKI,thiet-bi-kts-phu-kien-so,190086553,"Miếng Dán Mặt Đồng Hồ Cường Lực Dẻo 3D Kai dành cho Apple Watch- Hàng chính hãng",40000,40000,0,0
TIKI,thiet-bi-kts-phu-kien-so,125772028,"Case ốp dành cho macbook kèm tấm phủ phím - Hàng chính hãng",221000,279000,58000,21
TIKI,thiet-bi-kts-phu-kien-so,178331551,"ĐÀI RADIO USB NGHE NHẠC WAXIBA XB-402 BT CÓ ĐỒNG HỒ ,NGHE FM/AM/SW LOA SIÊU LỚN hàng chính hãng",210000,210000,0,0
TIKI,thiet-bi-kts-phu-kien-so,554401,"Đầu Nối HDMI Ugreen (20107) - Hàng Chính Hãng",55000,55000,0,0
TIKI,thiet-bi-kts-phu-kien-so,184707950,"Bao Case ESR Air Ripple Chống Sốc Dành Cho Airpods Pro- Hàng Chính Hãng",160000,160000,0,0
TIKI,thiet-bi-kts-phu-kien-so,73775727,"Tai nghe Bluetooth Baseus Encok True Wireless Earphones WM01 (TWS, Bluetooth 5.0, Stereo Earbuds, Touch Control, Noise Cancelling) - Hàng chính hãng",430000,550000,120000,22
TIKI,thiet-bi-kts-phu-kien-so,192726528,"Ốp Case Siêu Mỏng Thinfit cho Apple Watch Series 7/ Series 8 Size 41/45mm- Hàng chính hãng",76000,79000,3000,4
TIKI,thiet-bi-kts-phu-kien-so,5812981,"Webcam Logitech C310 720p HD - Hàng chính hãng",729000,729000,0,0
TIKI,thiet-bi-kts-phu-kien-so,45556353,"Ốp lưng dành cho SamSung Galaxy A51 chính hãng Nillkin dạng sần",96995,96995,0,0
TIKI,thiet-bi-kts-phu-kien-so,184573164,"Ốp Lưng Dành Cho Samsung Galaxy A73 5G Chính Hãng Nillkin Dạng Sần Viền Dẻo Chống Sốc - Hàng Chính Hãng",119998,119998,0,0
TIKI,thiet-bi-kts-phu-kien-so,31174410,"Chuột chơi game Dare U LM115G Pink - Hàng chính hãng",115000,115000,0,0
TIKI,thiet-bi-kts-phu-kien-so,88916772,"Bộ Củ Sạc CHOETECH PD 3.0 20W PD5005-W Và Cáp Type-C To Lightning MFI Apple 1.2M IP0039 Sạc Nhanh 20W cho iPhone, cho iPad - Hàng Chính Hãng",399000,790000,391000,49
TIKI,thiet-bi-kts-phu-kien-so,124976828,"Đầu Chuyển Đổi OTG Cổng Type-C Sang USB 3.0 - ROBOT RT-OTG04 - Chất Liệu Vỏ Kim Loại - Hàng Chính Hãng",58500,65000,6500,10
TIKI,thiet-bi-kts-phu-kien-so,184768998,"Dây nguồn số 8 cao cấp Honjianda - Hàng chính hãng",59400,85000,25600,30
TIKI,thiet-bi-kts-phu-kien-so,52341716,"Pin AAA Panasonic Ankaline LEO Vua Năng Lượng Vỉ 4 Viên - Hàng Chính Hãng",70000,70000,0,0
TIKI,thiet-bi-kts-phu-kien-so,191375629,"Tai Nghe Phone Nhét Tai Nghe Nhạc Chơi Game Teement Qkz Ak2 Pro Mới Nhất Âm Thanh Super Bass, Dây Chống Rối, Có Mic Đàm Thoại Tương Thích Điện Thoại Máy Tính Bảng Laptop Pc - Hàng Chính Hãng",125000,125000,0,0
TIKI,thiet-bi-kts-phu-kien-so,158693009,"Combo 2 kính cường lực Gor cho iPhone 14 Promax/ 14 Pro/ 14 Plus/ 14/ 13 Mini / 13 / 13 Pro / 13 Pro Max - Hàng Chính Hãng",144000,150000,6000,4
TIKI,thiet-bi-kts-phu-kien-so,20495992,"Sạc dự phòng Energizer UE10046 Dung Lượng 10,000mAh - Hàng Chính Hãng",299000,550000,251000,46
TIKI,thiet-bi-kts-phu-kien-so,178329646,"Ốp Silicone Kai Full Color cho Sony WF-1000XM4 - Hàng Chính Hãng",114000,119000,5000,4
TIKI,thiet-bi-kts-phu-kien-so,173484024,"Loa thông minh OLLI MAIKA - Đen Nguyên Bản - Hàng Chính Hãng",2390000,2390000,0,0
TIKI,thiet-bi-kts-phu-kien-so,76195375,"Giá Đỡ Để Bàn Điện Thoại Di Động, Máy Tính Bảng, Ipad Hợp Kim Nhôm Cao Cấp, Có Thể Điều Chỉnh 7 Góc Nghiêng; Mầu Trắng S650- Hàng Nhập Khẩu",258999,350000,91001,26
TIKI,thiet-bi-kts-phu-kien-so,143963350,"Micro karaoke Bluetooth cao Cấp Cắm thẻ nhớ 3 trong 1 Hàng chính hãng",317000,900000,583000,65
TIKI,thiet-bi-kts-phu-kien-so,85118373,"Cáp sạc Baseus Type C 100W, Cáp sạc siêu nhanh 100W Baseus Metal Data Cable Type C to Type C (100W) - Hàng nhập khẩu",129000,139000,10000,7
TIKI,thiet-bi-kts-phu-kien-so,107939646,"[VIDEO]- Hộp đựng dây sạc, cóc sạc điện thoại bằng mica trong suốt- Khay đựng remote, phụ kiện đa năng mẫu mới, sang trọng- Chọn mẫu theo ý",89000,89000,0,0
TIKI,thiet-bi-kts-phu-kien-so,82668652,"Tai nghe Bluetooth nhét tai không dây True wireless earbuds PKCB Hàng Chính Hãng",152000,500000,348000,70
TIKI,thiet-bi-kts-phu-kien-so,145243983,"Bộ 2 kính cường lực cho Google Pixel 6 trong suốt, siêu mươt ( hộp 2 kính) Hàng nhập khẩu",99000,99000,0,0
TIKI,thiet-bi-kts-phu-kien-so,155292688,"Giá Đỡ Tản Nhiệt Dành Cho Macbook, Laptop Từ 9 Đến 17 Inch Khung Nhôm Cao Cấp CHOETECH H033 - Hàng Chính Hãng",199000,490000,291000,59
TIKI,thiet-bi-kts-phu-kien-so,165865088,"Tai nghe bluetooth Sabbat X12 ultra - Sabbat X12 pro - Hàng chính hãng",880000,880000,0,0
TIKI,thiet-bi-kts-phu-kien-so,143416791,"Loa Bluetooth nghe nhạc không dây 100W công suất lớn Super Bass có cổng usb, thẻ nhớ, line 3.5mm pin 10400MAH sạc Type C Chip DSP TWS lên 200W cao cấp Hàng Chính Hãng PKCB",2300000,4600000,2300000,50
TIKI,thiet-bi-kts-phu-kien-so,117635957,"Cáp sạc siêu nhanh công suất tối đa 100W chuẩn PD Remax Lesu Pro typeC to typeC RC-187c - Hàng chính hãng",135000,200000,65000,33
TIKI,thiet-bi-kts-phu-kien-so,195552804,"Tai Nghe Truewireless Chống Ồn JBL Live Pro 2 TWS - Hàng Chính Hãng",2490000,2690000,200000,7
TIKI,thiet-bi-kts-phu-kien-so,191825332,"Chuột game không dây Logitech G Pro Wireless - Thiết kế cấp độ Esport, nhẹ, cảm biến Hero 25k, RGB Lightsync, Lightspeed - Hàng chính hãng",1980000,1980000,0,0
TIKI,thiet-bi-kts-phu-kien-so,186591278,"Tai nghe true wireless earbuds Plextone xMowi T2 - Điều khiển cảm ứng - Sạc Type C - Âm bass mạnh mẽ - Pin trâu - Mic khử ồn - Độ trễ thấp - Thiết kế đẹp - Hàng Chính Hãng",290000,350000,60000,17
TIKI,thiet-bi-kts-phu-kien-so,88928186,"Bộ Củ Sạc Dành Cho Macbook, Laptop, Điện Thoại 65W CHOETECH PD8002 GaN Tech + Type-C to C 100W 1.8M XCC-1002-GY - Hàng Chính Hãng",649000,1180000,531000,45
TIKI,thiet-bi-kts-phu-kien-so,88197059,"Tai Nghe Bluetooth 5.0 TWS Tai nghe âm thanh nổi Tai nghe thể thao Chống thấm nước Mini True Wireless Radio Earbuds - Hàng Chính Hãng PKCB",188000,500000,312000,62
TIKI,thiet-bi-kts-phu-kien-so,115129026,"Bút cảm ứng Baseus Smooth Writing Capacitive Stylus dùng cho iPad Pro/ Smartphone/ Tablet Android (Active + Passive Version, Magnetic Adsorption, Tilt & Strength sensitive) - Hàng chính hãng",580000,580000,0,0
TIKI,thiet-bi-kts-phu-kien-so,190544240,"Loa Bluetooth JBL Flip 6 JBLFLIP6 - Hàng chính hãng",2699000,2990000,291000,10
TIKI,thiet-bi-kts-phu-kien-so,97057240,"Pin Sạc Dự Phòng 30.000mAh Remax RPP-167 Lango Series Fast Charing 2.1A Tích Hợp 2 Cổng USB(HÀNG CHÍNH HÃNG)",339000,339000,0,0
TIKI,thiet-bi-kts-phu-kien-so,515545,"Combo chuột phím không dây Logitech MK215 - nhỏ gọn với đủ phím số, 1 đầu thu USB, không dây 10m, pin 2 năm - Hàng chính hãng",399000,399000,0,0
TIKI,thiet-bi-kts-phu-kien-so,72790369,"Ốp lưng cho Samsung Galaxy S20 FE  Nillkin Textured Case - Hàng nhập khẩu",140000,140000,0,0
TIKI,thiet-bi-kts-phu-kien-so,87118238,"Hộp túi công nghệ đựng tai nghe nhét tai - Hàng chính hãng",34000,34000,0,0
TIKI,thiet-bi-kts-phu-kien-so,91190711,"Cáp sạc và truyền dữ liệu UGREEN US288 cổng Type-c, độ dài từ 0.25m đến 2m, dòng 3A, đầu nhôm vỏ nylon - Hàng chính hãng",44000,49000,5000,10
TIKI,thiet-bi-kts-phu-kien-so,50702432,"Ốp lưng cho Iphone 11 - 01240 - Ốp dẻo trong - Hàng Chính Hãng",80000,80000,0,0
TIKI,thiet-bi-kts-phu-kien-so,126415021,"Chân Micro Kẹp Bàn Thu Âm LiveStream Arm Dr.MIC NB35 - Giá đỡ đế Mic Standard NB-35 Microphone Hàng Chính Hãng - Kèm Móng Gẩy DreamMaker",99000,99000,0,0
TIKI,thiet-bi-kts-phu-kien-so,66613014,"Bao da bò thật dạng ví chính hãng Caseme dành cho SamSung Galaxy Note 20 Ultra",135000,135000,0,0
TIKI,thiet-bi-kts-phu-kien-so,550442,"Tai Nghe Chụp Tai Logitech H151 - Hàng Chính Hãng",292000,299000,7000,2
TIKI,thiet-bi-kts-phu-kien-so,38089568,"Vỉ 2 Viên Pin Sạc AAA Eneloop BK4MCCE Made In Japan - Chính Hãng",200000,200000,0,0
TIKI,thiet-bi-kts-phu-kien-so,74862358,"Bộ miếng dán kính cường lực bảo vệ Camera cho iPhone 12 Pro Max HOTCASE Kuzoom mang lại khả năng chụp hình sắc nét full HD (độ cứng 9H, chống trầy, chống chụi & vân tay, bảo vệ toàn diện) - Hàng nhập khẩu",60000,143996,83996,58
TIKI,thiet-bi-kts-phu-kien-so,72928043,"Tai Nghe Bluetooth Amoi F9 kèm Củ Sạc 1A và Cáp Sạc cho Dock Sạc 3500mAh- Hàng Chính Hãng",125000,129000,4000,3
TIKI,thiet-bi-kts-phu-kien-so,67366756,"Đồng hồ thông minh định vị trẻ em ANNCOE Y92 nghe gọi nhắn tin hai chiều  định vị bằng sóng 4G + Wifi chống nước cấp độ IP67 mẫu mới nhất 2020 - Hàng Chính Hãng",950000,950000,0,0
TIKI,thiet-bi-kts-phu-kien-so,15184550,"USB OTG SanDisk Ultra Dual 64GB Type-C USB 3.1 DDC2 SDDDC2-064G-G46 - Hàng Chính Hãng",259000,279000,20000,7
TIKI,thiet-bi-kts-phu-kien-so,72010730,"CHUỘT MÁY TÍNH KHÔNG DÂY CHỐNG ỒN BT21 BABY BEENS MOUSE",139000,139000,0,0
TIKI,thiet-bi-kts-phu-kien-so,181698959,"Củ sạc mini chuẩn PD 20W Remax RP-U75 - Hàng chính hãng",153000,290000,137000,47
TIKI,thiet-bi-kts-phu-kien-so,129241549,"Dán Cường Lực Bảo Vệ Camera dành cho iPhone 13 Pro Max/13 Pro/iPhone 13/13 Mini ZEELOT PIshield Titanium Alloy Viền Màu - Hàng Nhập Khẩu",237650,350000,112350,32
TIKI,thiet-bi-kts-phu-kien-so,191571091,"Dây Đeo Thay Thế Sport Dành Cho Vòng Đeo Tay Thông Minh Xiaomi Mi Band 5/ Miband 6 - Hàng chính hãng",55000,55000,0,0
TIKI,thiet-bi-kts-phu-kien-so,28414681,"LOA CARAVEN CR-853 nghe nhạc usb,thẻ nhớ ,đài radio FM Hàng Nhập khẩu",157000,157000,0,0
TIKI,thiet-bi-kts-phu-kien-so,7857039,"Ốp lưng dành cho iPhone 6/6S - Pikachu",42000,55000,13000,24
TIKI,thiet-bi-kts-phu-kien-so,44123726,"Loa di động Acnos CS450 Hàng Chính Hãng",6050000,6050000,0,0
TIKI,thiet-bi-kts-phu-kien-so,58736477,"Giá Đỡ Kẹp Điện Thoại, Máy Tính Bảng Có Chân Kẹp Đầu Giường, Cạnh Bàn Hàng Chính Hãng Helios",195994,195994,0,0
TIKI,thiet-bi-kts-phu-kien-so,100286176,"Dây Đeo Mesh UNIQ DANTE cho Apple Watch Mesh Steel Strap Size 40/44MM_ Hàng Chính Hãng",780000,780000,0,0
TIKI,thiet-bi-kts-phu-kien-so,702134,"Chuột không dây Bluetooth Logitech MX Anywhere 2s - nhỏ gọn, dùng mọi bề mặt, con lăn HyperFast, sạc nhanh USB-A, phù hợp Mac/ Laptop - Hàng chính hãng",1180000,1180000,0,0
TIKI,thiet-bi-kts-phu-kien-so,112937202,"Chuột DareU Gaming EM908 (LED RGB) - Hàng Chính Hãng",315000,315000,0,0
TIKI,thiet-bi-kts-phu-kien-so,127360244,"Ốp lưng lụa dành cho iPhone 13 Pro/ 13 Pro Max chính hãng siêu mỏng 0.3mm bảo vệ camera - Hàng Nhập Khẩu",80000,159999,79999,50
TIKI,thiet-bi-kts-phu-kien-so,123150986,"Ốp lưng dành cho iPhone 13 Pro Max chính hãng Nillkin dạng sần",124000,250000,126000,50
TIKI,thiet-bi-kts-phu-kien-so,58073638,"Túi đựng cáp sạc phụ kiện công nghệ 2 ngăn dáng dọc Baona - Hàng nhập khẩu",117304,133300,15996,12
TIKI,thiet-bi-kts-phu-kien-so,115959856,"Miếng Dán Dẻo Gor Cho Galaxy Note 8/9/10/10+/ Note 20 Ultra, Galaxy S8 Plus/S9/S9 Plus/S10/S10 Plus/S10e/S105G/S20/S20 Plus/S20 Ultra/S21 Ultra (Dán Full Màn Hình) - Hàng NHập Khẩu",65000,65000,0,0
TIKI,thiet-bi-kts-phu-kien-so,52580515,"Micro karaoke không dây bluetooth kiêm loa nghe nhạc  3 trong 1 PF72 Gold - Hàng Chính Hãng",309000,800000,491000,61
TIKI,thiet-bi-kts-phu-kien-so,140135702,"Miếng Dán Kính Cường Lực Camera chống trầy GOR cho iPhone 13 Mini / 13 / 13 Pro / 13 Pro Max (Bộ 2 Miếng) - Hàng Nhập Khẩu",57000,74787,17787,24
TIKI,thiet-bi-kts-phu-kien-so,24006018,"Miếng Dán Kính Cường Lực 3D Chống Trầy - Chống Nhìn Trộm Baseus Anti Spy - Break Edge Cho iPhone 7/ 8/ Plus (0.23mm, 3D Anti Peeping Tempered Glass Film) - Hàng Chính Hãng",96000,250000,154000,62
TIKI,thiet-bi-kts-phu-kien-so,91189545,"Cáp mạng Cat6 UTP UGREEN NW102 - Hàng chính hãng",175000,190000,15000,8
TIKI,thiet-bi-kts-phu-kien-so,72634099,"Miếng Dán Cường Lực Chống Nhìn Trộm Mipow Kingbull ANTI-SPY PREMIUM HD (2.7D) iPhone 12 Mini / iPhone 12/ iPhone 12 Pro/ iPhone 12 Promax",95000,430000,335000,78
TIKI,thiet-bi-kts-phu-kien-so,155784334,"Cáp Hoco X37 Hỗ Trợ Sạc Nhanh 2.4A Max Cho Điện Thoại Iphone, Micro,Type-c  - Hàng Chính Hãng - Hoco X37 Sạc Nhanh",17000,17000,0,0
TIKI,thiet-bi-kts-phu-kien-so,106332665,"[Hàng chính hãng], Củ sạc nhanh 20W Aukey PA-B1pro, PD20W và QC 3.0",265000,265000,0,0
TIKI,thiet-bi-kts-phu-kien-so,51245217,"Củ Sạc Hoco C72 - hàng chính hãng",51490,51490,0,0
TIKI,thiet-bi-kts-phu-kien-so,48464589,"Đầu đổi USB-A 2.0 dương sang USB Type-C 3.1 âm màu Trắng Ugreen TC50568US280 Hàng chính hãng.",105000,105000,0,0
TIKI,thiet-bi-kts-phu-kien-so,132023427,"Ốp Lưng UNIQ Hybrid MagSafe-Compatible Transforma Dành Cho Iphone 13/ 13 Pro, 13 Pro Max - Hàng Chính Hãng",590000,590000,0,0
TIKI,thiet-bi-kts-phu-kien-so,174378779,"Đầu Thu USB Logi Bolt dành để sử dụng trên nhiều máy tính - Hàng Chính Hãng",199000,219000,20000,9
TIKI,thiet-bi-kts-phu-kien-so,164115080,"Cường lực full dành cho Samsung S21 FE dòng CP+ Pro - Hàng nhập khẩu Nillkin",123998,134823,10825,8
TIKI,thiet-bi-kts-phu-kien-so,72894385,"Giá Đỡ Laptop, Máy Tính Bảng Hợp Kim Nhôm 6 Mức Điều Chỉnh Chiều Cao Thông Thoáng Hỗ Trợ Tản Nhiệt Hàng Chính Hãng Tamayoko",169000,169000,0,0
TIKI,thiet-bi-kts-phu-kien-so,93275642,"Pin dự phòng sạc nhanh Baseus Adaman Metal Digital Display Quick Charge (22.5W QC3.0/ PD3.0/ SCP/ AFAFC Quick charge) - Hàng Chính Hãng",399399,399399,0,0
TIKI,thiet-bi-kts-phu-kien-so,144904228,"Cáp sạc nhanh tích hợp màn hình LED Baseus Display Fast Charging Data Cable Type-C to IP 20W - Hàng nhập khẩu",175000,219000,44000,20
TIKI,thiet-bi-kts-phu-kien-so,144449722,"Loa Bluetooth Chip DSP công suất 100W TWS Lên 200W gắn thẻ nhớ, usb, Line 3.5mm cao cấp Hàng chính hãng",2250000,4500000,2250000,50
TIKI,thiet-bi-kts-phu-kien-so,176588545,"Cáp sạc nhanh Baseus cổng usb 3 trong 1 micro type C 100W - Hàng Chính Hãng",350000,350000,0,0
TIKI,thiet-bi-kts-phu-kien-so,75662072,"Tai Nghe Bluetooth Không Dây Kết Nối Bluetooth Nhanh Chóng Cảm Ứng Vân Tay Thông Minh - Hàng Chính Hãng",152000,450000,298000,66
TIKI,thiet-bi-kts-phu-kien-so,73752322,"Máy Nghe Nhạc Ruizu H6 Cảm Ứng Hệ Điều Hành Android 5.1 Có Wifi Bluetooth - Hàng Chính Hãng",1130920,1154000,23080,2
TIKI,thiet-bi-kts-phu-kien-so,35223007,"Ốp lưng Memumi siêu mỏng 0.3 mm cho Apple iPhone 11 Pro Max 6.5 - Hàng nhập khẩu",68000,150000,82000,55
TIKI,thiet-bi-kts-phu-kien-so,71049733,"Bao da bò thật dạng ví chính hãng Caseme dành cho Samsung Galaxy A51",135000,135000,0,0
TIKI,thiet-bi-kts-phu-kien-so,2034021,"Đầu Chuyển Đổi Ugreen USB Type-C Sang USB 3.0 30155 - Hàng Chính Hãng",99000,99000,0,0
TIKI,thiet-bi-kts-phu-kien-so,402164,"Loa Vi Tính SoundMax A-150/2.0 10W - Hàng Chính Hãng",339000,349000,10000,3
TIKI,thiet-bi-kts-phu-kien-so,10651230,"Bộ 4 miếng Dán Dẻo Gor Cho Galaxy Note 9 (dán Full màn hình) - Hàng nhập khẩu",82000,82000,0,0
TIKI,thiet-bi-kts-phu-kien-so,168352306,"Loa Bluetooth Harman Kardon Onyx Studio 7 HKOS7 - Hàng chính hãng",3990000,5990000,2000000,33
TIKI,thiet-bi-kts-phu-kien-so,177659963,"Tai nghe Bluetooth chụp Tai Jlab Go Work gen 2 thời gian nghe 45H kết nối 2 thiết bị Micro lọc tiếng ồn khi gọi điện",1190000,1620000,430000,27
TIKI,thiet-bi-kts-phu-kien-so,2063013,"Đầu Đọc Thẻ Nhớ Ugreen 20250 - Hàng Chính Hãng",175000,190000,15000,8
TIKI,thiet-bi-kts-phu-kien-so,56308749,"Ốp Lưng Kính Cường Lực Trong Suốt, Viền Máy Dẻo Dành Cho Iphone X / XS/ XS Max / XR /  7 8 PLus Hàng Chính Hãng Helios",102600,108000,5400,5
TIKI,thiet-bi-kts-phu-kien-so,157467738,"Củ Sạc Nhanh Baseus Công Suất 24W, 3A, Qualcomm QC3.0 - Hàng Chính Hãng",139000,139000,0,0
TIKI,thiet-bi-kts-phu-kien-so,157205570,"Dây đeo RINGKE Basic Lanyard Strap - Hàng Chính Hãng",144000,160000,16000,10
TIKI,thiet-bi-kts-phu-kien-so,2054629,"Cáp Chuyển Đổi Ugreen HDMI Sang DVI Sợi Tròn 11150 1.5m - Hàng Chính Hãng",109000,119000,10000,8
TIKI,thiet-bi-kts-phu-kien-so,142008316,"Bao da smart case KAKU TPU MINGYA SERIES có khay để bút, tự động tắt mở, chống nóng dành cho iPad - Hàng nhập khẩu",124000,188999,64999,34
TIKI,thiet-bi-kts-phu-kien-so,2045727,"Cáp Chia Jack Ugreen Thành Mic Headphone 10789 - Hàng Chính Hãng",63000,68000,5000,7
TIKI,thiet-bi-kts-phu-kien-so,89980950,"Bộ 2 kính cường lực cho Redmi Note 10 Pro - chính hãng GOR",89500,89500,0,0
TIKI,thiet-bi-kts-phu-kien-so,162769891,"Chổi Quét Bàn Phím Đa Chức Năng; Bàn Chải Làm Sạch Tai Nghe, Dụng Cụ Loại Bỏ Bụi - Hàng Nhập Khẩu",149000,180000,31000,17
TIKI,thiet-bi-kts-phu-kien-so,73912203,"Tai nghe dẫn xương bluetooth F808 -  Hàng Nhập Khẩu",501000,549000,48000,9
TIKI,thiet-bi-kts-phu-kien-so,32268448,"Bàn di chuột DARE-U ESP100 350x300x5mm - Hàng chính hãng",99000,99000,0,0
TIKI,thiet-bi-kts-phu-kien-so,2883895,"Bộ Bàn Phím Chuột Bosston D5300 - Hàng Chính Hãng",111500,111500,0,0
TIKI,thiet-bi-kts-phu-kien-so,125890134,"Bộ 5 Máy Bộ Đàm Motorola MT-918",2500000,2500000,0,0
TIKI,thiet-bi-kts-phu-kien-so,21430781,"Máy trợ giảng SHIDU SD-S358 - Hàng Chính Hãng",377000,377000,0,0
TIKI,thiet-bi-kts-phu-kien-so,104311425,"Bút Cảm Ứng Điện Dung Dành Cho Điện Thoại Cảm Ứng Samsung Xiaomi Huawei - Hàng Chính Hãng Baseus",148899,148899,0,0
TIKI,thiet-bi-kts-phu-kien-so,26532448,"Bộ 3 miếng dán Samsung Galaxy Note 10 Plus hiệu GOR - Hàng Nhập Khẩu",85000,85000,0,0
TIKI,thiet-bi-kts-phu-kien-so,127360217,"Ốp lưng lụa mỏng dành cho iPhone 13 Pro /13 Pro Max bảo vệ camera, siêu mỏng 0.3 mm - Hàng Chính Hãng Memumi",86000,148000,62000,42
TIKI,thiet-bi-kts-phu-kien-so,116587732,"Tai Nghe Bluetooth True Wireless Không Dây - Gaming Mode "0" Trì Hoãn - Chế Độ 2 Máy Chủ Sử Dụng Độc Lập - Khử Ồn ENC TCT-A10  - Hàng Chính Hãng",659000,799000,140000,18
TIKI,thiet-bi-kts-phu-kien-so,66511024,"Phụ kiện giữ dây cáp sạc Giá Silicon mini cố định dây cáp sạc cho các thiết bị điện tử trên bàn làm việc - Hàng chính hãng",25000,57000,32000,56
TIKI,thiet-bi-kts-phu-kien-so,140135974,"Dán cường lực GOR cho Smartwatch Galaxy Watch 4 / Galaxy Watch 4 Classic Size 40/42/44/46mm",135000,135000,0,0
TIKI,thiet-bi-kts-phu-kien-so,899654,"Chuột Không Dây DareU LM115G MultiColor - Cừu - Hàng Chính Hãng",229000,229000,0,0
TIKI,thiet-bi-kts-phu-kien-so,192275761,"Case dành cho Airpods 3 Magic Box Kèm Khóa_ Hàng Chính Hãng",144000,150000,6000,4
TIKI,thiet-bi-kts-phu-kien-so,185884498,"VietKTV DA9S - DAC giải mã âm thanh nghe nhạc chất lượng cao 24bit - Có khiển từ xa, bluetooth 5.0 - Chuyển đổi quang học sang AV - Hàng chính hãng ",685000,685000,0,0
TIKI,thiet-bi-kts-phu-kien-so,72886104,"Giá đỡ kẹp điện thoại, ipad, máy tính bảng Baseus cài sau ghế ô tô SUHZ-01 - Hàng nhập khẩu",199000,199000,0,0
TIKI,thiet-bi-kts-phu-kien-so,133162070,"Tai nghe gaming nhét tai E-Dra EH420E kèm mic rời - Hàng chính hãng",490000,490000,0,0
TIKI,thiet-bi-kts-phu-kien-so,137572991,"Bao Da Smart Case Gen2 TPU Dành Cho iPad Mini 6",98000,158000,60000,38
TIKI,thiet-bi-kts-phu-kien-so,32989128,"Dây 2 Đầu HDMI 1.5m Unitek - Cáp Chuyển HDMI Sang HDMI 1.5m - Hàng Chính Hãng",84456,84456,0,0
TIKI,thiet-bi-kts-phu-kien-so,197009802,"Tai nghe Bluetooth chụp tai chống ồn SENNHEISER Momentum 4 Wireless - Hàng chính hãng",9024050,9024050,0,0
TIKI,thiet-bi-kts-phu-kien-so,168234975,"Ốp Lưng ESR Metal Kickstand dành cho iPhone 13 / 13 Pro / 13 Pro Max- Hàng Chính Hãng",490000,490000,0,0
TIKI,thiet-bi-kts-phu-kien-so,189420224,"Sim Viettel 09 -Trả Trước - Chọn số - đồng giá 99.000đ - Nghe Gọi - 4G -Hàng Chính hãng",99000,99000,0,0
TIKI,thiet-bi-kts-phu-kien-so,30010029,"Cáp USB Type-c To Type-c 1.5M Ugreen 50998 - Dây 2 Đầu Type-c Hàng Chính Hãng",77000,90000,13000,14
TIKI,thiet-bi-kts-phu-kien-so,2883909,"Bộ Bàn Phím Chuột Có Dây Bosston 837 Tích Hợp Đèn LED - Hàng Chính Hãng",169000,169000,0,0
TIKI,thiet-bi-kts-phu-kien-so,190706721,"Tai Nghe Không Dây HUQU HQ-L350 - Thiết Kế Gập Gọn, Âm Thanh Sống Động - Hàng Chính Hãng",394000,410000,16000,4
TIKI,thiet-bi-kts-phu-kien-so,22877109,"Combo chuột phím không dây Logitech MK275 - Hàng chính hãng",528000,528000,0,0
TIKI,thiet-bi-kts-phu-kien-so,32728442,"Bao Case Leeu Design cho Airpods 1/ Airpods 2",159000,159000,0,0
TIKI,thiet-bi-kts-phu-kien-so,72801647,"Loa Bluetooth USLION Mini Plus Bản Mở Rộng, chống nước IPX5. Hỗ Trợ Kết Nối Bluetooth 5.0. Thẻ Nhớ- Hàng Chính Hãng",269000,269000,0,0
TIKI,thiet-bi-kts-phu-kien-so,50693281,"Loa Bluetooth Marshall Stanmore II - Hàng Nhập Khẩu",7900000,7900000,0,0
TIKI,thiet-bi-kts-phu-kien-so,137939354,"Bao da kèm bàn phím Bluetooth dành cho iPad Gen 9 10.2 2021 Smart Keyboard - Hàng nhập khẩu",357999,357999,0,0
TIKI,thiet-bi-kts-phu-kien-so,130361168,"Ốp lưng silicon dẻo cho Samsung Galaxy Note 20 hiệu Ultra Thin siêu mỏng 0.6mm - Hàng nhập khẩu",34300,34300,0,0
TIKI,thiet-bi-kts-phu-kien-so,94801128,"(Hàng chính hãng) Hub chuyển đổi đa năng Baseus Type-C - HDMI, USB, RJ45, SD, TF,... dành cho Macbook, Notebook, Laptop",394000,419000,25000,6
TIKI,thiet-bi-kts-phu-kien-so,57640796,"Máy trợ giảng không dây sử dụng sóng UHF TAKSTAR E300W cao cấp - Hàng chính hãng",890000,890000,0,0
TIKI,thiet-bi-kts-phu-kien-so,89003628,"Sạc pin dự Phòng HOCO J52 10.000mAh-Hàng chính hãng - Đen",155000,155000,0,0
TIKI,thiet-bi-kts-phu-kien-so,179229024,"Th.iết bị Định vị GPS A9 mini Thiết kế Nhỏ gọn Theo dõi Hàng hóa, Trẻ em, Người già, Xe hơi, Thú cưng Hàng nhập khẩu",1000000,1050000,50000,5
TIKI,thiet-bi-kts-phu-kien-so,160946349,"Loa Bluetooth nghe nhạc không dây 100W công suất lớn Super Bass có cổng usb, thẻ nhớ, line 3.5mm pin 10400MAH sạc Type C Chip DSP TWS lên 200W cao cấp Hàng Chính Hãng PKCB",4600000,4600000,0,0
TIKI,thiet-bi-kts-phu-kien-so,192567083,"Keycap cờ đỏ sao vàng dành cho bàn phím cơ E-Dra - Nhựa ABS V2 - Hàng chính hãng",45000,45000,0,0
TIKI,thiet-bi-kts-phu-kien-so,145620839,"Sạc dự phòng Mophie Snap+ 5,000mAh - Hàng chính hãng",699000,1100000,401000,36
TIKI,thiet-bi-kts-phu-kien-so,190757937,"Chai xịt vệ sinh máy ảnh, bàn phím, bo mạch máy tính 450ML- Bình xịt khí nén đa năng dùng cho máy quay, ống kính, điện thoại...- Hàng nhập khẩu",79000,79000,0,0
TIKI,thiet-bi-kts-phu-kien-so,115968406,"Ốp Lưng Silicon Trong Suốt Gor Cho Iphone 11/ 11 Pro/ 11 Pro Max/ 12/ 12 Pro/ 12 Pro Max/ XR/ Xs Max/ XS Có Gờ Bảo Vệ Camera - Hàng Nhập Khẩu",40000,40000,0,0
TIKI,thiet-bi-kts-phu-kien-so,194398769,"Bàn Phím Cơ Cao Cấp K3 Premium Gaming Nhiều Chế Độ Led Cực Đẹp, Trục Cơ Học Red Switch Dùng Cho Máy Tính, Laptop-HÀNG CHÍNH HÃNG",649000,649000,0,0
TIKI,thiet-bi-kts-phu-kien-so,56306151,"Ốp Lưng Kính Cường Lực Trong Suốt, Viền Máy Dẻo Dành Cho Iphone 11/ 11 Pro/ 11 Pro Max Hàng Chính Hãng Helios",77000,181996,104996,58
TIKI,thiet-bi-kts-phu-kien-so,196928645,"Bao da dạng ví dành cho Xiaomi POCO C40 Hanman có quai cài - Hàng nhập khẩu",150000,150000,0,0
TIKI,thiet-bi-kts-phu-kien-so,178077895,"Giá Đỡ Máy Tính Laptop Macbook Besti BTY01 Hợp Kim Nhôm Cao Cấp Giúp Tản Nhiệt Có Thể Tháo Rời - Hàng Chính Hãng",370000,370000,0,0
TIKI,thiet-bi-kts-phu-kien-so,125766729,"Miếng Dán Cường Lực Mipow Kingbull Premium Silk HD (2.7D) iPhone 13 Mini / iPhone 13/ iPhone 13 Pro/ iPhone 13 ProMax",202000,249000,47000,19
TIKI,thiet-bi-kts-phu-kien-so,195928309,"Sạc BOOST↑CHARGE PRO GaN Belkin 65W - 2 cổng USB-C PD 3.0 PPS WCH013 - Hàng chính hãng",835000,1390000,555000,40
TIKI,thiet-bi-kts-phu-kien-so,69146962,"Tai Nghe Bluetooth Dẫn Xương X19  - Truyền Âm Thanh Qua Xương Sọ Không Gây Đau Tai, Bảo Vệ Thính Giác Của Bạn - Hàng Nhập Khẩu",439000,439000,0,0
TIKI,thiet-bi-kts-phu-kien-so,418636,"Webcam Logitech C270 720P - Hàng chính hãng",384000,384000,0,0
TIKI,thiet-bi-kts-phu-kien-so,97057124,"Pin Sạc Dự Phòng HOCO J59A-20.000mAh LED,2 Cổng Sạc Vào,2 Cổng Sạc Ra DC5V-2.0A,HÀNG CHÍNH HÃNG",289000,289000,0,0
TIKI,thiet-bi-kts-phu-kien-so,5986195,"Cáp HDMI 2.0 hỗ trợ 3D , 4K dài 1m UGREEN HD118 40408 - Hàng chính hãng",64000,70000,6000,9
TIKI,thiet-bi-kts-phu-kien-so,68360730,"Bàn Phím Cơ Gaming DAREU EK87 MULTI-LED - Hàng Chính Hãng",580000,580000,0,0
TIKI,thiet-bi-kts-phu-kien-so,168925166,"Ốp lưng Nillkin Textured dành cho Galaxy S21 FE - Hàng chính hãng",145000,145000,0,0
TIKI,thiet-bi-kts-phu-kien-so,126023110,"Củ sạc siêu nhanh 65W Remax RP-U55 - 2 typeC 1 USB - Hàng chính hãng",578000,660000,82000,12
TIKI,thiet-bi-kts-phu-kien-so,32924732,"Đài Radio FM/AM Panasonic RF - P150DBAGA Kèm Pin Chính Hãng",410000,420000,10000,2
TIKI,thiet-bi-kts-phu-kien-so,48576455,"Máy trợ giảng Unizone UZ-U2 - Máy trợ giảng không dây Hàn Quốc chính hãng mới nhất 2020",2850000,3500000,650000,19
TIKI,thiet-bi-kts-phu-kien-so,75994791,"Bộ chia 4 Port USB 3.0 Vention Hàng chính hãng - CHKBB",209000,238000,29000,12
TIKI,thiet-bi-kts-phu-kien-so,187050070,"Tai Nghe Bluetooth Lenovo Livepods XT92 Gamming 5.1 - Hàng Chính Hãng",279000,279000,0,0
TIKI,thiet-bi-kts-phu-kien-so,271336602,"Chuột Gaming không dây Dareu EM911X RGB - Hàng chính hãng",569000,569000,0,0
TIKI,thiet-bi-kts-phu-kien-so,68303946,"Ốp lưng cho Samsung Galaxy Note 20/ Note 20 Ultra bảo vệ camera Nillkin CamShield chính hãng",147988,147988,0,0
TIKI,thiet-bi-kts-phu-kien-so,100796894,"THẺ NHỚ MIXIE 32GB/64GB/128 MICRO TF TỐC ĐỘ 95MB/S GHI 70M/S cho camera, điện thoại, camera hành trình - hàng nhập khẩu (TẶNG KÈM ĐẦU ĐỌC THẺ NHỚ)",85000,85000,0,0
TIKI,thiet-bi-kts-phu-kien-so,75585051,"Radio Tecsun PL-660 (Hàng nhập khẩu)",2950000,2950000,0,0
TIKI,thiet-bi-kts-phu-kien-so,44946468,"Ốp Hybrid Viền TPU Mặt Kính Cường Lực Leeu Design dành cho iPhone Xs Max _ Hàng Nhập Khẩu",157000,349998,192998,55
TIKI,thiet-bi-kts-phu-kien-so,71972222,"Ốp Lưng Silicon TPU trong suốt GOR cho Samsung Galaxy S20 / S20 Plus / S20 Ultra - Hàng Nhập Khẩu",45000,45000,0,0
TIKI,thiet-bi-kts-phu-kien-so,195448232,"Thẻ Nhớ MicroSDXC SanDisk Extreme V30 A2 512GB 190MB/s SDSQXAV-512G (New 2022) - Hàng Nhập Khẩu",1050000,1050000,0,0
TIKI,thiet-bi-kts-phu-kien-so,154164516,"Dán cường lực bảo vệ camera HODA Sapphire dành cho iPhone 13 Pro/13 Pro Max - Hàng Nhập Khẩu",590000,590000,0,0
TIKI,thiet-bi-kts-phu-kien-so,58023971,"Bộ chuyển đổi USB Type-C sang Hub USB 3.0 4 cổng hỗ trợ cổng nguồn Micro USB 5V UGREEN CM164 70336 - Hàng chính hãng",276000,300000,24000,8
TIKI,thiet-bi-kts-phu-kien-so,188110605,"Ốp lưng silicon cho Samsung Galaxy A52, A52 5G , A52S 5G dẻo Gor Bảo vệ camera trong suốt Hàng nhập khẩu",40000,40000,0,0
TIKI,thiet-bi-kts-phu-kien-so,74923685,"Ốp Lưng Silicon TPU Hoco  Dành Cho iPhone 12 Mini, iPhone 12 Pro , iPhone 12 Pro Max - Hàng Chính Hãng",37000,89998,52998,59
TIKI,thiet-bi-kts-phu-kien-so,1998403,"Cáp Nối Dài Ugreen USB 2.0 10321 (10m) - Hàng Chính Hãng",234000,234000,0,0
TIKI,thiet-bi-kts-phu-kien-so,59314545,"Dây nguồn số 8 dùng cho adapter sạc laptop 1m Ugreen 159OL40312CD Hàng chính hãng",79000,90000,11000,12
TIKI,thiet-bi-kts-phu-kien-so,7198079,"Bộ chia 4 cổng USB 3.0 dài 80cm UGREEN CR113 20291 - Hàng chính hãng",207000,230000,23000,10
TIKI,thiet-bi-kts-phu-kien-so,173380246,"Tai Nghe game có dây Logitech G335 - Mic gập để Mute, Jack 3.5mm, Đệm tai Memory Foam, Nhẹ 240g, Tương thích PC/ PS4 PS5/ Xbox/ Nitendo - Hàng chính hãng",1349000,1349000,0,0
TIKI,thiet-bi-kts-phu-kien-so,118275020,"Lót chuột có đệm tay chống mỏi chất liệu silicon siêu êm - Hàng nhập khẩu",39000,39000,0,0
TIKI,thiet-bi-kts-phu-kien-so,153544569,"Loa Máy Tính Để Bàn, Âm Thanh Siêu Trầm, Dành Cho Học Online, Nghe Nhạc, Xem Phim - Hàng Chính Hãng",220000,220000,0,0
TIKI,thiet-bi-kts-phu-kien-so,108962702,"Bàn phím không dây Logitech K580 Slim (Graphite) - Hàng Chính Hãng",949000,949000,0,0
TIKI,thiet-bi-kts-phu-kien-so,275588109,"Máy Trợ Giảng Có Dây Shidu SD-S358 - Hàng Nhập Khẩu - Bản Có Bluetooth",400000,400000,0,0
TIKI,thiet-bi-kts-phu-kien-so,69572942,"Micro Karaoke Bluetooth Không Dây, Có Nắp Đậy, Hộp Đựng Cao Cấp - Hàng Chính Hãng",1103000,2500000,1397000,56
TIKI,thiet-bi-kts-phu-kien-so,160067138,"Adapter Củ Sạc Nhanh Type C 25W PPS PD3.0 CHOETECH PD6003 Sạc Nhanh iPhone, iPad Samsung, Vivo, Xiaomi, Oppo - Hàng Chính Hãng",249000,490000,241000,49
TIKI,thiet-bi-kts-phu-kien-so,127600345,"Máy trợ giảng không dây TAKSTAR E261W khoảng cách truyền 40M, công suất cao 25W -Tặng túi đựng máy trợ giảng - Hàng Chính Hãng",1550000,1550000,0,0
TIKI,thiet-bi-kts-phu-kien-so,141673214,"Lót chuột Logitech Mouse Pad - Đế cao su chống trượt, lướt dễ dàng, bề mặt chống đổ tràn, bền bỉ, nhỏ gọn - Màu",209000,209000,0,0
TIKI,thiet-bi-kts-phu-kien-so,172431997,"Ốp lưng dành cho Samsung Galaxy S22 - S22 Plus - S22 Ultra - mẫu Cung Hoàng Đạo - Virgo",40000,55000,15000,27
TIKI,thiet-bi-kts-phu-kien-so,203176630,"Cáp sạc nhanh USB Type C - C BOOST↑CHARGE Belkin 60W vỏ nhựa PVC, 1M & 2M - Hàng chính hãng",235000,325000,90000,28
TIKI,thiet-bi-kts-phu-kien-so,169556652,"Bộ chia HUB USB 3 cổng tốc độ cao cho Máy tính, Laptop, PC, Tivi, Ô tô, xe hơi, thiết bị ngoại vi nhỏ gọn USB3.0/2.0 - Hàng chính hãng",148000,148000,0,0
TIKI,thiet-bi-kts-phu-kien-so,124089297,"Cáp Sạc Micro-USB Có Đèn Cho Android, Samsung,... Hoco DU08 1M/2M, Cáp Dây Dù Siêu Bền, Sạc Nhanh 2.4 - Hàng Chính Hãng",39000,39000,0,0
TIKI,thiet-bi-kts-phu-kien-so,97693641,"Loa vi tính để bàn XSmart MC D221 SUPER BASS cực đã, có LED, dòng loa cao cấp cho laptop, pc, điện thoại - Hàng Chính Hãng",349000,349000,0,0
TIKI,thiet-bi-kts-phu-kien-so,31141484,"Ốp lưng Nillkin Textured dành cho Samsung Galaxy Note 10/ Note 10 Plus - Hàng chính hãng",148999,297998,148999,50
TIKI,thiet-bi-kts-phu-kien-so,91191211,"Dây nối dài USB 3.0 mạ vàng dài từ 1-3m UGREEN US129 dây dạng dẹt và tròn - Hàng Chính Hãng",80000,80000,0,0
TIKI,thiet-bi-kts-phu-kien-so,96344633,"Bàn Phím Gaming XSmart K618 Super Pro New 2021 Đổi Màu 10 Chế Độ Led Khác Nhau Cực Đẹp Sử Dụng Trên Máy Tính Laptop Pc TiVi - Hàng Chính Hãng",498000,498000,0,0
TIKI,thiet-bi-kts-phu-kien-so,193974034,"Dây Silicon dành cho đồng hồ Apple nhiều màu- Hàng chính hãng",64829,92000,27171,30
TIKI,thiet-bi-kts-phu-kien-so,135655246,"Bộ gộp chia HDMI 2 chiều hỗ trợ 4K@60Hz Ugreen mã UG-50966 - Hàng Chính Hãng",245000,245000,0,0
TIKI,thiet-bi-kts-phu-kien-so,69457234,"Bộ giá đỡ Điện thoại/Macbook/Laptop NILLKIN Bolster Mini Portable Stand - Hàng Nhập Khẩu",119000,119000,0,0
TIKI,thiet-bi-kts-phu-kien-so,4073159,"Bộ 3 Bộ đàm Motorola CP6688 - Hàng chính hãng",1040000,1040000,0,0
TIKI,thiet-bi-kts-phu-kien-so,21363410,"Máy trợ giảng Takstar E126- hàng chính hãng",450000,450000,0,0
TIKI,thiet-bi-kts-phu-kien-so,117785958,"Bàn Phím Logitech Combo Touch For Ipad Pro 11inch 3RD GEN - Hàng Chính Hãng",4190000,4190000,0,0
TIKI,thiet-bi-kts-phu-kien-so,107748830,"Bộ giá đỡ tản nhiệt mini cho Macbook / laptop siêu nhỏ gọn hiệu Nillkin Laptop Bolster portable stand (thiết kế chắn chắn, nhỏ gọn tiện dụng) - hàng chính hãng",138965,138965,0,0
TIKI,thiet-bi-kts-phu-kien-so,514927,"Chuột Chơi Game Có Dây Logitech Hyperion Fury G402 4000DPI LED 8 Phím - Hàng Chính Hãng",630000,630000,0,0
TIKI,thiet-bi-kts-phu-kien-so,3494769,"Miếng dán màn hình cường lực chống nhìn trộm full màn hình 3D Baseus cho iPhone 7 Plus/ iPhone 8 Plus - Đen - Hàng chính hãng",141000,270000,129000,48
TIKI,thiet-bi-kts-phu-kien-so,25749035,"Tai nghe chụp tai Bluetooth P47",73000,78000,5000,6
TIKI,thiet-bi-kts-phu-kien-so,45586976,"Đế tản nhiệt COOLING PAD cho laptop - Hàng nhập khẩu",118900,118900,0,0
TIKI,thiet-bi-kts-phu-kien-so,195916596,"Thẻ Nhớ MicroSDXC SanDisk Extreme Pro V30 A2 1TB 200MB/s SDSQXCD-1T00 (New 2022) - Hàng Nhập Khẩu",2990000,2990000,0,0
TIKI,thiet-bi-kts-phu-kien-so,108633882,"Củ sạc nhanh Baseus 30W, Củ sạc Baseus Si 30W, Củ sạc Baseus Super Si Quick Charger 30W dùng cho iPhone/ Samsung/ OPPO... (30W, Type C, PD/ QC3.0 Quick charger)",295000,319000,24000,8
TIKI,thiet-bi-kts-phu-kien-so,196892131,"Ốp lưng dành cho iPhone 14 Pro Max chính hãng Likgus trong suốt, chống sốc, chống ố - hàng chính hãng",56000,68999,12999,19
TIKI,thiet-bi-kts-phu-kien-so,125594820,"Ốp Lưng ESR CLOUD SOFT Dành Cho iPhone 13 Mini, Iphone 13/ 13 Pro, 13 Pro Max - Hàng Chính Hãng",450000,450000,0,0
TIKI,thiet-bi-kts-phu-kien-so,2010041,"Máy Nghe Nhạc Lossless Bluetooth Ruizu D02 8GB (2018)",560000,560000,0,0
TIKI,thiet-bi-kts-phu-kien-so,550407,"Bộ Chuyển Đổi Bluetooth Logitech Receiver - Hàng Chính Hãng",649000,649000,0,0
TIKI,thiet-bi-kts-phu-kien-so,24633902,"Đầu chuyển Type-C 3.1 ra cổng LAN RJ45 hiệu CHOETECH HUB-R01 cho điện thoại Macbook (Kết nối mạng có dây, thiết kế nhỏ gọn, tốc độ cao) - Hàng chính hãng",329000,329000,0,0
TIKI,thiet-bi-kts-phu-kien-so,4594727,"Bộ Chuyển Tín Hiệu 2 CPU Dùng 1 Màn Hình KVM Switch USB Ugreen 30357 - Hàng Chính Hãng",345000,345000,0,0
TIKI,thiet-bi-kts-phu-kien-so,77403120,"Micro karaoke kèm loa bluetooth Mini, AUX, USB, microSD, FM, TWS - Hàng Chính Hãng",384000,799000,415000,52
TIKI,thiet-bi-kts-phu-kien-so,188543326,"Case Ốp Vỏ Hình Gương sóng Gradient dành cho Airpods 1/2/ Airpods 3/ Airpods Pro- Hàng chính hãng",109000,109000,0,0
TIKI,thiet-bi-kts-phu-kien-so,76271254,"Cáp sạc và truyền dữ liệu 2 cổng USB Type-C, một đầu bẻ góc 90 độ, hỗ trợ sạc nhanh PD 60W, dòng tối đa 3A UGREEN US255 - Hàng chính hãng",130000,130000,0,0
TIKI,thiet-bi-kts-phu-kien-so,128677420,"Bao Da dành cho iPad Pro 12.9 2021 M1 MUTURAL Y-Type With Pencil Holder - Hàng Nhập Khẩu",590000,590000,0,0
TIKI,thiet-bi-kts-phu-kien-so,74555237,"Túi Đựng Phụ Kiện 1 Ngăn Chống Nước, Chống Sốc Cao Cấp – Túi Để Phụ Kiện Điện Thoại – Hàng Chính Hãng miDoctor",119000,119000,0,0
TIKI,thiet-bi-kts-phu-kien-so,34495897,"Máy Trợ Giảng 4 IN 1 ROLTON K300 TẶNG Kèm Micro Không Dây Gài Tai AZONE - Hàng Nhập Khẩu",345000,345000,0,0
TIKI,thiet-bi-kts-phu-kien-so,70771922,"Bao da chống sốc cho Samsung Galaxy Tab S7 T870/ T875 thương hiệu DUX DUCIS Domo Series cao cấp - Hàng nhập khẩu",277000,277000,0,0
TIKI,thiet-bi-kts-phu-kien-so,109947285,"Giá đỡ điện thoại để bàn, Máy tính bảng đa năng Hợp Kim Nhôm dành cho tất cả điện thoại thông minh - Hàng Chính Hãng PKCB",78000,179000,101000,56
TIKI,thiet-bi-kts-phu-kien-so,178102405,"Bao Da Dạng Ví Dành Cho Samsung  A73, A53, A33, A23, A13 4G Hiệu Hanman Có Ngăn Thẻ- Hàng Chính hãng",115000,115000,0,0
TIKI,thiet-bi-kts-phu-kien-so,72573302,"Ốp lưng dẻo mỏng màu xanh dương dành cho iPhone X / XS  - Hàng chính hãng",39000,45000,6000,13
TIKI,thiet-bi-kts-phu-kien-so,190707857,"Miếng dán kính cường lực full 3D cho Samsung Galaxy S22 Ultra hiệu Nillkin CP+ Max (Mỏng 0.3mm, Kính ACC Japan, Chống Lóa, Hạn Chế Vân Tay) - Hàng nhập khẩu",217527,217527,0,0
TIKI,thiet-bi-kts-phu-kien-so,141050950,"Hộp Đựng Dành Cho Chuột Logitech MX Master/ Master 2S/ Master 3/ MX Lucas - Hàng Chính Hãng",98000,98000,0,0
TIKI,thiet-bi-kts-phu-kien-so,100910755,"Đôi loa bass 30 cho loa karaoke và nghe nhạc Hải Triều (hàng chính hãng) 1 cặp ",649000,649000,0,0
TIKI,thiet-bi-kts-phu-kien-so,5862639,"Dây nối dài USB 2.0 (1 đầu đực, 1 đầu cái) dài 1m UGREEN US103 10314 - Hàng chính hãng",41000,45000,4000,9
TIKI,thiet-bi-kts-phu-kien-so,147800518,"Gậy chụp ảnh tự sướng Mawa K07 - Tích hợp 3 chân tripod và remote bluetooth chụp từ xa - Hàng chính hãng",99000,99000,0,0
TIKI,thiet-bi-kts-phu-kien-so,43384946,"Ốp lưng da kính cao cấp dành cho iPhone 7 Plus / iPhone 8 Plus - Màu đỏ - Hàng nhập khẩu - DELICATE",149000,150000,1000,1
TIKI,thiet-bi-kts-phu-kien-so,185409734,"Tai nghe Bluetooth Lenovo HQ08 TWS chống nước HiFi Âm nhạc ,chơi game Tai nghe thể thao Bluetooth không dây-Hàng Chính Hãng",258000,289000,31000,11
TIKI,thiet-bi-kts-phu-kien-so,197546361,"Bass loa 4 tấc từ 140 côn 51 Hải Triều (hàng chính hãng) 1 cặp ",800000,800000,0,0
TIKI,thiet-bi-kts-phu-kien-so,48056587,"Bao da iPad pro 10.5 2017/ ipad air 3 10.5 2019  KAKU_ hàng nhập khẩu",119000,119000,0,0
TIKI,thiet-bi-kts-phu-kien-so,73731363,"Túi Vải Đựng Phụ Kiện Dụng Cụ Tiện Ích Thời Trang SAKOS VERSA",90000,180000,90000,50
TIKI,thiet-bi-kts-phu-kien-so,107780600,"Cáp sạc nhanh Baseus C to C 100W màn led, Cáp sạc nhanh 100W Baseus Display Fast Charging Data Cable Type C to C 100W (20V/5A) - Hàng chính hãng",199000,249000,50000,20
TIKI,thiet-bi-kts-phu-kien-so,10727171,"Cổng chuyển/Hub USB Type-C ra USB Type-A 2.0 Baseus - Hàng Chính Hãng",69499,69499,0,0
TIKI,thiet-bi-kts-phu-kien-so,169558817,"Bàn phím máy tính không dây Ajazz 308i - Hàng chính hãng",437000,454800,17800,4
TIKI,thiet-bi-kts-phu-kien-so,47282611,"Ốp lưng dẻo mỏng dành cho iPhone XS Max - Màu đen",45000,45000,0,0
TIKI,thiet-bi-kts-phu-kien-so,32866408,"Đồng hồ thông minh định vị trẻ em Wonlex KT04 - Hàng Nhập Khẩu",890000,890000,0,0
TIKI,thiet-bi-kts-phu-kien-so,90021971,"Hub chuyển đổi đa năng Baseus Type-C - HDMI, USB, RJ45, SD, TF,... dành cho Macbook, Notebook, Laptop,... - phân phối chính hãng tại Baseus Việt Nam",850000,850000,0,0
TIKI,thiet-bi-kts-phu-kien-so,96615280,"Chuột Máy Tính XSmart Free Wolf V1 LED RGB Chơi Game Tự Động Đổi Màu Cực Đẹp - Hàng Chính Hãng",129000,129000,0,0
TIKI,thiet-bi-kts-phu-kien-so,138940950,"Ốp lưng dành cho Iphone 13 Mini - Iphone 13 - Iphone 13 Pro -  Iphone 13 Pro Max - Tranh Hoa Nền Trắng",41000,55000,14000,25
TIKI,thiet-bi-kts-phu-kien-so,34843660,"Kính cường lực Nillkin XD CP+ MAX",112000,263998,151998,58
TIKI,thiet-bi-kts-phu-kien-so,9947322,"Cáp Chuyển Đổi Mini Displayport Sang HDMI và VGA UGREEN 20421 - Hàng Chính Hãng (Tặng kèm tai nghe điện thoại)",390000,390000,0,0
TIKI,thiet-bi-kts-phu-kien-so,91190426,"Cáp sạc Light/ning MFI UGREEN US155 US199 US291 cho iPhone / iPad / iPod dòng 2.4A dài 1m 2m - Hàng chính hãng",248000,270000,22000,8
TIKI,thiet-bi-kts-phu-kien-so,6213359,"Ốp lưng chống sốc Likgus cho Samsung Galaxy Note 8 (chuẩn quân đội, chống va đập, chống vân tay) - Hàng chính hãng",79000,79000,0,0
TIKI,thiet-bi-kts-phu-kien-so,142833965,"Bao da Dux Ducis cho iPhone 13 Pro Max dạng ví - hàng chính hãng",259000,259000,0,0
TIKI,thiet-bi-kts-phu-kien-so,2063027,"Hub USB Ugreen 4 Cổng USB 2.0 20277 (1m) - Hàng Chính Hãng",134000,134000,0,0
TIKI,thiet-bi-kts-phu-kien-so,49501166,"Hộp đựng ổ cứng SATA cổng USB-C 3.1 cao cấp Ugreen 50743 - Hàng chính hãng",316000,316000,0,0
TIKI,thiet-bi-kts-phu-kien-so,188941440,"Ốp lưng chống sốc cho Samsung Galaxy A23 hiệu Likgus vân kim loại , chống sốc chuẩn quân đội, chống va đập - hàng nhập khẩu",97000,97000,0,0
TIKI,thiet-bi-kts-phu-kien-so,197541988,"[ VGA Male ra HDMI Female ] Đầu chuyển đổi tín hiệu VGA ra HDMI Vention ACNB - Hàng chính hãng",220000,220000,0,0
TIKI,thiet-bi-kts-phu-kien-so,54348325,"Túi phụ kiện công nghệ mẫu quai xách đứng chuyên dụng đựng bộ sạc macbook, dây cáp sạc, tai nghe, điện thoại và pin dự phòng",249999,249999,0,0
TIKI,thiet-bi-kts-phu-kien-so,22493615,"Ốp lưng cho Oppo A5s - Ốp dẻo trong - Hàng Chính Hãng",12000,12000,0,0
TIKI,thiet-bi-kts-phu-kien-so,171097976,"Ốp lưng silicon dẻo trong suốt mỏng 0.6mm cho Samsung Galaxy S20 FE hiệu Ultra Thin độ trong tuyệt đối, chống trầy xước - Hàng nhập khẩu",39000,39000,0,0
TIKI,thiet-bi-kts-phu-kien-so,153273898,"Bao da dành cho Samsung Tab S8 Plus / Tab S7 Plus / S7 FE  -  Hàng Chính hãng",590000,590000,0,0
TIKI,thiet-bi-kts-phu-kien-so,111450483,"Dây Đeo Thay Thế Vòng Đeo Tay Xiaomi Mi Band 3 Mi Band 4 Chất Liệu Silicone - Hàng Chính Hãng",120000,120000,0,0
TIKI,thiet-bi-kts-phu-kien-so,35347363,"Bao Case Cho Airpods 1/ 2 Mèo Lucky",69000,69000,0,0
TIKI,thiet-bi-kts-phu-kien-so,178566601,"Chuột Có Dây Mitsumi Loại Lớn Thiết Kế Tinh Tế - Hàng Chính Hãng",45000,45000,0,0
TIKI,thiet-bi-kts-phu-kien-so,167418883,"Ốp Lưng Chống Sốc Mặt Lưng Trong Suốt Bảo Vệ Cho Samsung Galaxy S20 Fe - Hàng Chính Hãng Xundd",109999,109999,0,0
TIKI,thiet-bi-kts-phu-kien-so,91192960,"Cáp chuyển đổi từ 6.5mm sang AV Cannon (XLR) âm cho microphone, stereo, mixer, amplifier UGREEN AV131 - Hàng chính hãng",105000,105000,0,0
TIKI,thiet-bi-kts-phu-kien-so,167441543,"Ốp Lưng Silicon Gor Cho Samsung Galaxy S22/ S22 Plus/ S22 Ultra Trong Suốt Có Gờ Bảo Vệ Camera, hãng GOR - Hàng nhập khẩu",36000,49999,13999,28
TIKI,thiet-bi-kts-phu-kien-so,49861267,"Loa bluetooth mini KIMISO KMS-225 soundbar hỗ trợ FM/AUX/USB/TF - kèm dây đeo (màu ngẫu nhiên) Hàng Nhập Khẩu",199000,199000,0,0
TIKI,thiet-bi-kts-phu-kien-so,50446431,"Ốp Lưng in cho Samsung A50 Mẫu Hoa Khô - Hàng Chính Hãng",35000,55000,20000,36
TIKI,thiet-bi-kts-phu-kien-so,91833246,"Sound Card Thu Âm Behringer UFO202- Hàng chính hãng",591700,610000,18300,3
TIKI,thiet-bi-kts-phu-kien-so,38056232,"Dây nguồn sạc số 8 Dài 0.5m Màu Đen Ugreen ACC40311CD159 Hàng chính hãng",62900,62900,0,0
TIKI,thiet-bi-kts-phu-kien-so,40795550,"Middle Green - Ốp lưng nhám siêu mỏng cho iPhone 11 (6.1 inch) hiệu Memumi Độ mỏng 0.3mm, Có gờ bảo vệ camera - Hàng nhập khẩu",76000,179998,103998,58
TIKI,thiet-bi-kts-phu-kien-so,84210858,"Bộ 3 Miếng Dán Dẻo Gor Cho Xiaomi Mi 10 / Mi 10 Pro ( Dán Full Màn Hình ) - Hàng Nhập Khẩu",85000,85000,0,0
TIKI,thiet-bi-kts-phu-kien-so,11859172,"Dây Loa Audio 1 đầu 3,5 mm ra 2 đầu hoa sen (RCA) dài 1,5m UGREEN - Hàng Chính Hãng",145000,145000,0,0
TIKI,thiet-bi-kts-phu-kien-so,194103367,"SẠC ĐA CỔNG HYPERJUICE GAN 245W CHARGER 4 USB-C PD/PPS/QC4.0 NHỎ NHẤT THẾ GIỚI GAN245 - Hàng Chính Hãng",4190000,4190000,0,0
TIKI,thiet-bi-kts-phu-kien-so,184770634,"Dây cáp sạc Type C sạc nhanh 100W chuẩn PD 3.0 Type C to Type C hiệu Baseus Display Fast Charging Data Cable trang bị màn hình LED chuẩn 5A/QC 4.0, Smartchip - hàng nhập khẩu",239000,239000,0,0
TIKI,thiet-bi-kts-phu-kien-so,72850635,"Đầu Đọc Thẻ Usb 3.0 Đa Năng Cf Sd Tf Ms Otg 50cm Ugreen 125DT30230CR 0.5M hàng chính hãng",284000,284000,0,0
TIKI,thiet-bi-kts-phu-kien-so,72128011,"Ốp Lưng Nillkin Super Frosted Shield Matte cho Samsung Galaxy Note 20 Ultra _ Hàng Nhập Khẩu",115000,115000,0,0
TIKI,thiet-bi-kts-phu-kien-so,145977610,"Chuột không dây Eblue EMS816 (USB-Wireless) - hàng chính hãng",69000,80000,11000,14
TIKI,thiet-bi-kts-phu-kien-so,133786165,"Dây loa 2 đầu jack 3.5mm hoco upa14 - cáp âm thanh chất lượng cao AUX Audio 3.5 - hàng chính hãng",69000,69000,0,0
TIKI,thiet-bi-kts-phu-kien-so,133138645,"Chuột E-DRA EM630 Ultra Light - Hàng chính hãng ",290000,290000,0,0
TIKI,thiet-bi-kts-phu-kien-so,143494566,"Kính Cường Lực Camera Lens Zeelot Titanium Dành Cho iPhone 12 Promax/ 12 Pro_ Hàng Chính Hãng",250000,250000,0,0
TIKI,thiet-bi-kts-phu-kien-so,91241820,"Miếng Dán PPF Cầu Vồng Tự Phục Hồi Mặt Sau cho iPhone X/ XS/ XS Max/ 11/ 11 Pro/ 11 Pro Max/ 12 Mini/ 12/ 12 Pro/ 12 Pro Max - Hàng Chính Hãng",44999,44999,0,0
TIKI,thiet-bi-kts-phu-kien-so,144294839,"Bộ Củ Sạc Nhanh CHOETECH 38W PD5002 Và Cáp C to C 60W Dài 1.8M CC0005-SR Cho Điện Thoại Samsung, Oppo, Vivo, Xiaomi - Hàng Chính Hãng",329000,700000,371000,53
TIKI,thiet-bi-kts-phu-kien-so,188128780,"Củ loa bass 30 từ 140 coil 51 Sườn nhôm Hải Triều (hàng chính hãng) 1 cặp.",940000,940000,0,0
TIKI,thiet-bi-kts-phu-kien-so,47733739,"Cáp LN Mophie 9cm - chống rối - đạt chứng nhận MFI từ Apple dành cho iPhone - Hàng chính hãng",319000,450000,131000,29
TIKI,thiet-bi-kts-phu-kien-so,91190769,"Dây AV nối dài 3.5mm đầu mạ vàng dài từ 0.5-2m UGREEN AV118 - Hàng chính hãng",139000,139000,0,0
TIKI,thiet-bi-kts-phu-kien-so,101284469,"Chuột Văn Phòng Không Dây Cao Cấp  IMICE G-6 Silent 2.4G Wireless, 6 nút điều khiển, Kết Nối Nhanh,  Bộ Thu Nano Tự Động Kết Nối Khoảng Cách Làm Việc 10m Tiết Kiệm Pin Thông Minh Độ Phân Giải 800/1200/1600DPI - Hàng Chính Hãng",172744,196300,23556,12
TIKI,thiet-bi-kts-phu-kien-so,27983285,"Ốp lưng dẻo trong suốt chính hãng Nillkin Nature dành cho SamSung Galaxy Note 10 Plus",89000,89000,0,0
TIKI,thiet-bi-kts-phu-kien-so,262689341,"Ruizu H10 - Máy Nghe Nhạc Buetooth 5.0 Hai Chiều, Màn Hình Cảm Ứng, Xem Phim Full HD, Có Loa Ngoài (16GB) - Hàng Chính Hãng",1049000,1049000,0,0
TIKI,thiet-bi-kts-phu-kien-so,43831781,"Midle Green - Ốp lưng chống sốc cho iPhone 11 Pro Max (6.5 inch) hiệu Memumi Ultra Thin độ mỏng 0.3mm , có gờ bảo vệ Camera - Hàng nhập khẩu",78000,162334,84334,52
TIKI,thiet-bi-kts-phu-kien-so,43130947,"Dây cáp sạc nhanh đầu USB-C to light sạc  cho iPhone / iPad dài 100cm hiệu CHOETECH S-MT009L cho iPhone / iPad (sạc nhanh 2.4A, chất liệu cao cấp, chip sạc thông minh) - Hàng chính hãng",99000,99000,0,0
TIKI,thiet-bi-kts-phu-kien-so,58079182,"Micro Behringer SL 75C - Dynamic Cardioid Microphone- Hàng chính hãng",630500,650000,19500,3
TIKI,thiet-bi-kts-phu-kien-so,125772673,"Miếng Dán Cường Lực Mipow Kingbull Mờ Chống Vân MIPOW KINGBULL ANTI-GLARE Premium Silk HD (2.7D) iPhone 13 Mini / iPhone 13/ iPhone 13 Pro/ iPhone 13 ProMax_ Hàng Chính Hãng",299000,299000,0,0
TIKI,thiet-bi-kts-phu-kien-so,71510605,"Miếng Dán Dẻo GOR dành cho Samsung Galaxy Note 20 Ultra (Bộ 3 Miếng Dán) - Hàng Nhập Khẩu",85000,85000,0,0
TIKI,thiet-bi-kts-phu-kien-so,67811917,"Bàn phím chơi game cơ quang E-DRA EK308 RGB Plus - Hàng chính hãng ",1039000,1039000,0,0
TIKI,thiet-bi-kts-phu-kien-so,74190625,"Miếng dán màn hình kính cường lực cho iPad Air 4 10.9 inch 2020 hiệu Nillkin Amazing H+ (mỏng 0.2 mm, vát cạnh 2.5D, chống trầy, chống va đập) - Hàng chính hãng",220000,220000,0,0
TIKI,thiet-bi-kts-phu-kien-so,87108804,"Dây Cáp Sạc Điện Thoại USB Type C To Type C 30W Dài 1M CHOETECH CC0002-V2 - Hàng Chính Hãng",59000,180000,121000,67
TIKI,thiet-bi-kts-phu-kien-so,188229207,"Keycap cờ đỏ sao vàng dành cho bàn phím cơ E-Dra - Nhựa ABS - Hàng chính hãng",50000,50000,0,0
TIKI,thiet-bi-kts-phu-kien-so,44909503,"Bàn di chuột có kê cổ tay ELECOM MP-AN01",314100,314100,0,0
TIKI,thiet-bi-kts-phu-kien-so,51615527,"Thiết bị streaming Elgato CamLink 4K - Hàng Chính Hãng",2890000,2890000,0,0
TIKI,thiet-bi-kts-phu-kien-so,76797145,"Ốp lưng dẻo silicon cho iPhone SE 2020 / iPhone 7 / iPhone 8 hiệu HOTCASE Ultra Thin (siêu mỏng 0.6mm, chống trầy, chống bụi) - Hàng nhập khẩu",34899,50000,15101,30
TIKI,thiet-bi-kts-phu-kien-so,90220177,"Cáp máy in màu Đen 2.0 USB A sang B 3M đầu nhôm dây bọc lưới chống nhiễu Ugreen 80804 US369 Hàng chính hãng",133000,149000,16000,11
TIKI,thiet-bi-kts-phu-kien-so,54525,"Đế Tản Nhiệt Laptop Cooler Master I100",289000,289000,0,0
TIKI,thiet-bi-kts-phu-kien-so,515551,"Bộ Bàn Phím Và Chuột Không Dây Logitech MK345 - Hàng chính hãng",793000,793000,0,0
TIKI,thiet-bi-kts-phu-kien-so,187568392,"Bộ 5 miếng dán Gor TPU cho Apple Watch Series 4/ 5/ 6/ 7/ 8/ 9/ SE Size 40/ 41/ 44/ 45 mm ( hộp 5 miếng)- Hàng chính hãng",62000,65000,3000,5
TIKI,thiet-bi-kts-phu-kien-so,10579669,"Ốp lưng chống sốc Likgus cho Samsung Galaxy S10 Plus (chuẩn quân đội, chống va đập, chống vân tay) - Hàng chính hãng",80000,80000,0,0
TIKI,thiet-bi-kts-phu-kien-so,5865627,"Dây nối dài USB 2.0 (1 đầu đực, 1 đầu cái) dài 2m UGREEN US103 10316 - Hàng Chính Hãng",70000,70000,0,0
TIKI,thiet-bi-kts-phu-kien-so,171232008,"Giá Đỡ Điện Thoại, Máy Tính Bảng FIREWOLF Z4 Kim Loại Nguyên Khối - Hàng Chính Hãng",89000,89000,0,0
TIKI,thiet-bi-kts-phu-kien-so,537791,"Hub 4 Cổng USB 3.0 Ugreen 20291 1m - Hàng Chính Hãng",224000,229000,5000,2
TIKI,thiet-bi-kts-phu-kien-so,135284116,"Dây cáp sạc nhanh Rockspace Z18 dành cho iphone, chuẩn PD 20W, ổn định, không nóng máy - Hàng chính hãng ",179000,179000,0,0
TIKI,thiet-bi-kts-phu-kien-so,2010525,"Cáp VGA Ugreen 11631 3m - Hàng Chính Hãng",149000,149000,0,0
TIKI,thiet-bi-kts-phu-kien-so,74935461,"LÓT CHUỘT PEANUTS SNOOPY HÀNG CHÍNH HÃNG",99000,99000,0,0
TIKI,thiet-bi-kts-phu-kien-so,106990172,"Miếng Dán Cường Lực cho ĐIỆN THOẠI SAMSUNG GALAXY A32 (4G- 6.4 inch)  - Full màn hình - Màu Đen - Hàng Chính Hãng",41990,41990,0,0
TIKI,thiet-bi-kts-phu-kien-so,90582384,"Bộ 2 Kính cường lực cho Google Pixel 5A 5G - trong suốt chính hãng GOR vát 2,5D ( 2 miếng)",99000,99000,0,0
TIKI,thiet-bi-kts-phu-kien-so,3602035,"Bộ Chia 2 Máy Tính Dùng Chung 1 Máy In Ugreen 30345 - Hàng Chính Hãng",249000,249000,0,0
TIKI,thiet-bi-kts-phu-kien-so,104850969,"Cáp sạc nhanh 2.4A Baseus Cafule dây bện chống gập đồng bộ data nhanh chóng dành cho iPhone dài 100CM ( nhiều màu ) - Hàng chính hãng",79000,150000,71000,47
TIKI,thiet-bi-kts-phu-kien-so,183551497,"Micro không dây Soundmax MC-01 - Hàng Chính hãng ",650000,650000,0,0
TIKI,thiet-bi-kts-phu-kien-so,96186082,"Bộ 2 Kính Cường Lực GOR cho Asus ROG Phone 5 , 5 Pro ( 2 Miếng ) trong suốt, siêu mượt _ Hàng Nhập Khẩu",99000,99000,0,0
TIKI,thiet-bi-kts-phu-kien-so,58232513,"Bộ 2 Kính Cường Lực GOR cho iPhone X/XS ( 2 Miếng full box ) - Hàng Nhập Khẩu",99000,99000,0,0
TIKI,thiet-bi-kts-phu-kien-so,138940635,"Ốp lưng dành cho Iphone 13 Mini - Iphone 13 - Iphone 13 Pro -  Iphone 13 Pro Max - Vợ Chồng Bên Nhau",41000,55000,14000,25
TIKI,thiet-bi-kts-phu-kien-so,155110508,"Bàn phím giả cơ một tay Nuos K13 chơi game cực tốt - Hàng nhập khẩu",139000,139000,0,0
TIKI,thiet-bi-kts-phu-kien-so,42970784,"Combo 2 Cuộn Băng Gai Dính, Băng Dán Thu Gọn Dây 3 Mét giúp buộc gọn dây Cáp sạc điện thoại, dây LAN, máy tính",49000,49000,0,0
TIKI,thiet-bi-kts-phu-kien-so,58678581,"Dây đeo vai điện thoại/Máy ảnh Ringke Shoulder Design Strap - Hàng Chính Hãng",250000,250000,0,0
TIKI,thiet-bi-kts-phu-kien-so,35369594,"Miếng Dán PPF Mặt Trước cho Samsung Galaxy Note 10 Plus – Dẻo full màn hình – Hàng Chính Hãng",22000,22000,0,0
TIKI,thiet-bi-kts-phu-kien-so,45476928,"Ốp Lưng Da SULADA Viền silicon cho iPhone 8 Plus - Hàng Chính Hãng",99000,99000,0,0
TIKI,thiet-bi-kts-phu-kien-so,102757626,"Bao da cao cấp dành cho SamSung Galaxy Note 10 Lite dạng ví chính hãng Caseme - Hàng Nhập Khẩu",159000,159000,0,0
TIKI,thiet-bi-kts-phu-kien-so,25948900,"Giá đỡ máy tính bảng, IPad để bàn có khóa bảo vệ",1400000,1400000,0,0
TIKI,thiet-bi-kts-phu-kien-so,191504420,"Bàn Phím Giả Cơ Chuyên Game Huqu HQ-G20-Đèn Led Nổi Bật -Hàng Chính Hãng",250000,260000,10000,4
TIKI,thiet-bi-kts-phu-kien-so,10202746,"Cáp sạc 3 màu 3 IN 1 (iPhone+Type-C+Micro) Baseus Three Primary Colors 30cm - Hàng chính hãng",98000,98000,0,0
TIKI,thiet-bi-kts-phu-kien-so,191021232,"Chuột Máy Tính Huqu HQ-PAN01 -Tương Thích Với Nhiều Hệ  Điều Hành -Hàng Chính Hãng",144000,150000,6000,4
TIKI,thiet-bi-kts-phu-kien-so,185409732,"Tai Nghe Bluetooth Lenovo Livepods LP40 TWS Hàng Chính Hãng",147980,151000,3020,2
TIKI,thiet-bi-kts-phu-kien-so,55596971,"Loa Thanh Samsung 2.1ch 150W HW-T420/XV - Hàng Chính Hãng",1320000,1320000,0,0
TIKI,thiet-bi-kts-phu-kien-so,125380080,"Tai nghe True wireless phong cách Retro Remax TWS-39 - Hàng chính hãng",452000,990000,538000,54
TIKI,thiet-bi-kts-phu-kien-so,376848,"Loa Vi Tính Logitech Z313 2.1 50W - Hàng Chính Hãng",1090000,1090000,0,0
TIKI,thiet-bi-kts-phu-kien-so,60206621,"Sạc dự phòng Energizer 20.000 mAh/3.7V Li-Polymer - UE20011PQ - Hàng chính hãng - Đen",799000,1100000,301000,27
TIKI,thiet-bi-kts-phu-kien-so,196855678,"Bàn Phím Không Dây Logitech Signature K650 - Nhỏ gọn, gác tay tích hợp, tương thích Mac , Bluetooth & USB Bolt - Hàng chính hãng",990000,999000,9000,1
TIKI,thiet-bi-kts-phu-kien-so,149268229,"Tai nghe có dây Sony MDR-EX15AP - Hàng chính hãng",195000,199000,4000,2
TIKI,thiet-bi-kts-phu-kien-so,72727057,"Bộ phím chuột không dây logitech MK470 Slim - Hàng Chính Hãng",1035000,1035000,0,0
TIKI,thiet-bi-kts-phu-kien-so,178608262,"Ốp Lưng Silicon Chống Bám Bẩn GOR cho iPhone 13/ 13 Pro/ 13 Pro Max - Hàng Chính Hãng",45000,45000,0,0
TIKI,thiet-bi-kts-phu-kien-so,58876034,"SIM 4G Mobifone VPB51 Tặng 500GB/Tháng Trọn Gói 12 Tháng Không Cần Nạp Tiền - Mẫu ngẫu nhiên",1250000,1250000,0,0
TIKI,thiet-bi-kts-phu-kien-so,20063312,"Cáp HDMI 2.1 8K@60Hz or 4K@120Hz Belkin AV10175BT2M-BLK (2m)",619000,1099000,480000,44
TIKI,thiet-bi-kts-phu-kien-so,113569143,"Tai nghe bluetooth chụp tai Remax RB-620HB kiểu dáng on-ear - Hàng chính hãng",596000,1000000,404000,40
TIKI,thiet-bi-kts-phu-kien-so,179944607,"[Chính hãng] giá đỡ ipad điện thoại, máy tính bảng, kẹp đầu giường, cạnh bàn đa năng xoay 360 độ - Hàng chính hãng DODODIOS",107000,107000,0,0
TIKI,thiet-bi-kts-phu-kien-so,76473301,"Kính Cường Lực KingKong Chống Nhìn Trộm Dành Cho iPhone 12Mini, 12-12Pro, 12Pro Max - Dán Full Màn - Hàng chính hãng",37000,245998,208998,85
TIKI,thiet-bi-kts-phu-kien-so,159299261,"Bao Case ESR Hybrid Protective Bounce Carrying Case dành cho AirPods 3 (2021) - Hàng Chính Hãng",240000,250000,10000,4
TIKI,thiet-bi-kts-phu-kien-so,418574,"Tai Nghe Chụp Tai Logitech H110 - Hàng Chính Hãng",179000,185000,6000,3
TIKI,thiet-bi-kts-phu-kien-so,19359126,"Chuột Không Dây Dell WM126 - Hàng Chính Hãng",268000,279000,11000,4
TIKI,thiet-bi-kts-phu-kien-so,37971642,"Giá đỡ điện thoại khóa tự động cho xe hơi Baseus Universal Car gắn lỗ thông gió xe hơi ô tô đóng mở tự động khi để điện thoại vào (màu ngẫu nhiên) - Hàng nhập khẩu",189499,189499,0,0
TIKI,thiet-bi-kts-phu-kien-so,26165963,"Chuột Không Dây Dareu LM115G Có LED Tem Mai Hoàng - Hàng Nhập Khẩu",139000,139000,0,0
TIKI,thiet-bi-kts-phu-kien-so,359726,"Thiết Bị Trình Chiếu Logitech R400 - Hàng Chính Hãng",529000,529000,0,0
TIKI,thiet-bi-kts-phu-kien-so,176678283,"Tai nghe Bluetooth True Wireless Havit TW967 - Hàng chính hãng",290000,450000,160000,36
TIKI,thiet-bi-kts-phu-kien-so,53931751,"Giá Đỡ Gấp Để Bàn Cho Điện thoại, Ipad, Tablet - Hàng Nhập Khẩu",35000,35000,0,0
TIKI,thiet-bi-kts-phu-kien-so,152567389,"Sạc Dự Phòng Hoco J82 10000mAh Chính Hãng",139000,139000,0,0
TIKI,thiet-bi-kts-phu-kien-so,2034095,"Cáp Chuyển Đổi Ugreen USB Type-C Sang HDMI 30841 (1.5m) - Hàng Chính Hãng",421000,550000,129000,23
TIKI,thiet-bi-kts-phu-kien-so,52809028,"Dây USB 2.0 sang Mini USB mạ vàng dài 1M UGREEN US132 10355 (đen) - Hàng chính hãng",46000,50000,4000,8
TIKI,thiet-bi-kts-phu-kien-so,75068056,"Củ Sạc Nhanh ZMI APB03 50W Kiêm Pin Dự Phòng 6700mAh, Kèm Cáp 2 Đầu Type C Dài 1m - Hàng Nhập Khẩu",990000,990000,0,0
TIKI,thiet-bi-kts-phu-kien-so,165085694,"Combo Củ Sạc Nhanh PPS PD 25W CHOETECH PD6003 Và Cáp Type C 60W Dài 1.2m XCC-1003 Cho Điện Thoại Samsung, Oppo, Vivo, Xiaomi - Hàng Chính Hãng",279000,500000,221000,44
TIKI,thiet-bi-kts-phu-kien-so,137851155,"Bộ 2 kính cường lực Gor cho Xiaomi Mi 11T, 11T Pro 5G  trong suốt, vuốt mượt ( hộp 2 miếng) hàng nhập khẩu",99000,99000,0,0
TIKI,thiet-bi-kts-phu-kien-so,169977869,"Ốp lưng Usams siêu mỏng khoét từng camera dành cho iPhone 13 Pro Max - Hàng chính hãng",131039,137936,6897,5
TIKI,thiet-bi-kts-phu-kien-so,74749721,"Chuột game không dây Logitech G Pro X Superlight - Siêu nhẹ, cảm biến Hero 25k, 25.6k DPI, Lightspeed, 5 nút lập trình, pin lâu, PC - Hàng chính hãng",2949000,2949000,0,0
TIKI,thiet-bi-kts-phu-kien-so,14104513,"Củ Sạc HOCO 1A UH102 - Hàng Chính Hãng",55000,55000,0,0
TIKI,thiet-bi-kts-phu-kien-so,167545410,"Keycap nhựa PBT cao cấp công nghệ in tiên tiến cực sắc nét nhiều mẫu lựa chọn - Hàng nhập khẩu",150000,150000,0,0
TIKI,thiet-bi-kts-phu-kien-so,72850567,"Cáp HDMI 2.1 8K 60Hz 4K 120hz Cao Cấp màu đen Ugreen 135MM70319HD 1M hàng chính hãng",250000,250000,0,0
TIKI,thiet-bi-kts-phu-kien-so,196515840,"Đế SẠC ĐÔI Samsung không dây - P5400 - Hàng Chính Hãng -  (Sản phẩm  gồm có: 1 đế sạc đôi & 1 bộ sạc nhanh 25w)",790000,790000,0,0
TIKI,thiet-bi-kts-phu-kien-so,100083467,"Tai Nghe Bluetooth Không Dây Nhét Tai, Cảm Ứng Vân Tay, Âm Thanh Hay - Hàng Chính Hãng",154000,500000,346000,69
TIKI,thiet-bi-kts-phu-kien-so,113245352,"Case Silicon cho Sony WF-1000XM4 Hình Máy Game Switch Kèm Móc Treo_ Hàng Chính Hãng",187000,199000,12000,6
TIKI,thiet-bi-kts-phu-kien-so,12276970,"Bàn Phím Cơ Có Dây DareU EK87 LED Tenkeyless",495000,495000,0,0
TIKI,thiet-bi-kts-phu-kien-so,12516512,"Ốp lưng silicon chống sốc cho iPhone XS MAX hiệu Likgus Crashproof giúp chống chịu mọi va đập  - Hàng chính hãng",78999,150000,71001,47
TIKI,thiet-bi-kts-phu-kien-so,198126604,"Miếng Lót Chuột Cỡ Lớn, Pad Chuột Cỡ Lớn Bằng Da Cao Cấp 40cmx80cm, Tấm Lót Chuột Thảm Da Trang Trí Bàn Làm Việc VinBuy - Hàng Chính Hãng",180000,180000,0,0
TIKI,thiet-bi-kts-phu-kien-so,195658280,"Ốp Lưng Nillkin Super Frosted Shield Pro dành cho iPhone 14 / 14 Max / 14 Pro / 14 ProMax - Hàng Chính Hãng",116800,116800,0,0
TIKI,thiet-bi-kts-phu-kien-so,10179466,"Cáp chuyển đổi type C sang jack 3.5 Baseus Cable Yiven Type-C male To 3.5 male Audio Cable M01",114000,119000,5000,4
TIKI,thiet-bi-kts-phu-kien-so,10691668,"Loa Bosston Bluetooth 2.1 T3500-BT - Hàng chính hãng",345000,345000,0,0
TIKI,thiet-bi-kts-phu-kien-so,43264527,"Bao da kèm bàn phím Logitech Slim Folio dành cho iPad Pro 11 | 12.9 inch (2018) - kết nối Bluetooth, pin 3 tháng/lần sạc - Hàng chính hãng",2590000,2590000,0,0
TIKI,thiet-bi-kts-phu-kien-so,88737583,"Đế giữ điện thoại / iPad trên xe hơi Baseus Backseat Car Mount - Hàng Chính Hãng",199000,199000,0,0
TIKI,thiet-bi-kts-phu-kien-so,133138478,"Bàn phím cơ DAREU A87 Cherry Switch ( Childhood,summer,Dream,Swallow ) - Hàng chính hãng",1799000,1799000,0,0
TIKI,thiet-bi-kts-phu-kien-so,127180726,"Ốp case cho macbook siêu sang - Hàng chính hãng - XANH THAN - Macbook Air 13.3 inch đời 2017 về trước",176000,222000,46000,21
TIKI,thiet-bi-kts-phu-kien-so,253892634,"Loa Vi Tính SoundMax SB-201 2.0 12W - Hàng Chính Hãng",415000,415000,0,0
TIKI,thiet-bi-kts-phu-kien-so,251257169,"Tai nghe có dây Logitech H390 -  Hàng chính hãng",679000,679000,0,0
TIKI,thiet-bi-kts-phu-kien-so,173469202,"Tai nghe chụp tai có dây Sony MDR-ZX110AP - Hàng chính hãng",529000,540000,11000,2
TIKI,thiet-bi-kts-phu-kien-so,7286185,"Ốp Lưng iPhone 7 Plus / iPhone 8 Plus Anker KARAPAX Shield - A9006011",200000,200000,0,0
TIKI,thiet-bi-kts-phu-kien-so,2774881,"Sim 4G/5G Vinaphone 5GB/tháng trọn gói 1 năm miễn phí - Hàng chính hãng - Mẫu ngẫu nhiên",419000,419000,0,0
TIKI,thiet-bi-kts-phu-kien-so,188308313,"Case Ốp Bảo Vệ Hình Heo Fitting Cho Airpods 1/2/ Airpods Pro/ Airpod 3- Hàng chính hãng",79000,79000,0,0
TIKI,thiet-bi-kts-phu-kien-so,160919813,"Micro Thu Âm Cao Cấp CV Cắm cổng USB, Độ Nhậy Cao, Chống ồn, Livestream, Hát Karaoke, quay video, ghi âm, Vlog, Chơi game, Học Online trò chuyện qua Zoom, MSN, SKYPE Tương thích máy tính để bàn, Laptop, MAC OS- Hàng chính hãng",880000,880000,0,0
TIKI,thiet-bi-kts-phu-kien-so,167433819,"Chuột không dây Logitech Signature M650L màu trắng- Hàng chính hãng",793000,793000,0,0
TIKI,thiet-bi-kts-phu-kien-so,98150508,"Bao Da Dành Cho iPad Pro 11 inch 2021/2022 và iPad Pro 12.9 inch 2021/2022 ESR Ascend Trifold Hard Case - Hàng Nhập Khẩu",690000,690000,0,0
TIKI,thiet-bi-kts-phu-kien-so,199828,"Bàn phím không dây Logitech K400 Plus - có touchpad để kết nối PC đến TV, nút Media tùy chỉnh, phù hợp Laptop/ TV/ Tablets - Màu",648000,648000,0,0
TIKI,thiet-bi-kts-phu-kien-so,103677742,"Micro Không dây Bluetooth Karaoke - Hàng Chính Hãng",1018000,3190000,2172000,68
TIKI,thiet-bi-kts-phu-kien-so,5844491,"Dây HDMI 1.4 thuần đồng 19+1 Dài 5M UGREEN HD104 10109 - Hàng chính hãng",150000,150000,0,0
TIKI,thiet-bi-kts-phu-kien-so,177992767,"Bao Da Samsung Galaxy Tab S7 Fe Kèm Bàn Phím Có Bàn Di Chuột TouchPad Hiệu Dux Ducis-Hàng Chính Hãng",1150000,1150000,0,0
TIKI,thiet-bi-kts-phu-kien-so,76062253,"Loa Nghe Nhạc Bluetooth Không Dây Mini LittleFUN - Hàng Chính Hãng",120000,295000,175000,59
TIKI,thiet-bi-kts-phu-kien-so,55587762,"Bảng vẽ Wacom Cintiq DTC-133 (Wacom One 13.3″) - Hàng Chính Hãng",10070000,10070000,0,0
TIKI,thiet-bi-kts-phu-kien-so,91189476,"Hub USB 3.0 4 cổng tốc độ 5Gbps UGREEN CR113 - Hàng chính hãng",196000,220000,24000,11
TIKI,thiet-bi-kts-phu-kien-so,53401241,"Pin dự phòng QC 3.0 cao cấp hỗ trợ sạc nhanh ( Đen)- Hàng chính hãng",518899,518899,0,0
TIKI,thiet-bi-kts-phu-kien-so,190702798,"Dây cáp sạc cho đồng hồ thông minh Samsung Galaxy Fit 2 SM-R220- Hàng chính hãng",73500,75000,1500,2
TIKI,thiet-bi-kts-phu-kien-so,32291496,"ốp lưng cho iphone 11 chống sốc - chính hãng Xundd",98000,98000,0,0
TIKI,thiet-bi-kts-phu-kien-so,10139000,"Gậy Chụp Ảnh Tự Sướng Có Điều Khiển YT1288 - Hàng chính hãng",91900,91900,0,0
TIKI,thiet-bi-kts-phu-kien-so,142238866,"Tai Nghe Nhét Tai Có Dây Earldom E45 Jack 3.5mm Có Micro Đàm Thoại - Hàng chính hãng",35000,35000,0,0
TIKI,thiet-bi-kts-phu-kien-so,88917231,"Bộ Củ Sạc CHOETECH QC 3.0 & PD 3.0 38W PD5002-W + Cáp Type C To Lightning MFI Apple 1.2M IP0039 Sạc Nhanh Cho iPhone - Hàng Chính Hãng",449000,990000,541000,55
TIKI,thiet-bi-kts-phu-kien-so,192291113,"Loa Bluetooth Harman Kardon SoundSticks 4 HKSOUNDSTICK4 - Hàng chính hãng",7149000,7990000,841000,11
TIKI,thiet-bi-kts-phu-kien-so,126036026,"Ốp Lưng Magsafe Trong Suốt MIPOW TEMPERED GLASS Dành Cho iPhone 13 Mini, Iphone 13/ 13 Pro, 13 Pro Max - Hàng Chính Hãng",470000,490000,20000,4
TIKI,thiet-bi-kts-phu-kien-so,195872022,"Ốp lưng Samsung Fold 4  kèm Bút Spen & Chân Đứng  - màu đen - Hàng Chính hãng ( EF-OF93PCBEGWW) ",1990000,1990000,0,0
TIKI,thiet-bi-kts-phu-kien-so,34557311,"Túi phụ kiện công nghệ BUBM chuyên dụng 1 ngăn, 2 ngăn đựng dây cáp, pin sạc dự phòng có quai xách cầm tay tiện lợi- Hàng chính hãng",73296,100171,26875,27
TIKI,thiet-bi-kts-phu-kien-so,31694551,"Ốp lưng lụa siêu mỏng dành cho iPhone 7 Plus chính hãng Memumi",98998,98998,0,0
TIKI,thiet-bi-kts-phu-kien-so,196956316,"Ốp Lưng  dành cho iPhone 14 / 14 Plus/ 14 Pro / 14 ProMax Nillkin Nature TPU Pro- Hàng Chính Hãng",88000,120000,32000,27
TIKI,thiet-bi-kts-phu-kien-so,182833187,"Giá đỡ kẹp điện thoại kim loại gắn gương chiếu hậu xe máy C2 hàng TiMa.lala - Hàng chính hãng",76000,89000,13000,15
TIKI,thiet-bi-kts-phu-kien-so,4364947,"Bộ sạc và pin PANASONIC Eneloop CC51E ( 2 viên AA 2000mAh) - Hàng chính hãng",415000,415000,0,0
TIKI,thiet-bi-kts-phu-kien-so,195902063,"Loa Pháp, Loa Nghe Đài FM, Loa Nghe Nhạc USB, Thẻ Nhớ Craven CR-836S Có Đèn Pin - Hàng Nhập Khẩu",142500,155000,12500,8
TIKI,thiet-bi-kts-phu-kien-so,34346317,"Loa Marshall Stanmore 2 Bluetooth",7900000,7900000,0,0
TIKI,thiet-bi-kts-phu-kien-so,26530641,"Micro Karaoke Có Dây Shunison SN688- Hàng Nhập Khẩu",340000,340000,0,0
TIKI,thiet-bi-kts-phu-kien-so,196058713,"Loa Bluetooth WEKOME D11 - V5.0 , Âm Thanh Vòm - Hỗ Trợ USB, Thẻ Nhớ, Jack 3.5 Kết Nối Tivi, Máy Tính, Thiết Kế Sang Trọng - Hàng Chính Hãng",395000,395000,0,0
TIKI,thiet-bi-kts-phu-kien-so,5812985,"Webcam Laptop 720P Logitech C270
 - Hàng Chính Hãng",419000,419000,0,0
TIKI,thiet-bi-kts-phu-kien-so,102409485,"[Chính Hãng Mỹ] Tai Nghe Kiểm Âm AKG K52 Over-Ear Studio Monitor Headphones Professional - Kèm Móng Gẩy DreamMaker",1150000,1150000,0,0
TIKI,thiet-bi-kts-phu-kien-so,198020948,"Ốp lưng dành cho Iphone series 14 Spigen CrystaI Slot  - hàng chính hãng",550000,550000,0,0
TIKI,thiet-bi-kts-phu-kien-so,195300843,"Tai Nghe Bluetooth ANKER Soundcore Life Note 3i A3983 - Hàng Chính Hãng",959000,1800000,841000,47
TIKI,thiet-bi-kts-phu-kien-so,105235579,"Ốp lưng dành cho Samsung Galaxy A32 - A52 - A72 - mẫu Tranh Sen Đẹp",40000,55000,15000,27
TIKI,thiet-bi-kts-phu-kien-so,2054663,"Cáp Chuyển Đổi Ugreen MicroHDMI Sang HDMI V1.4 30102 1.5m - Hàng Chính Hãng",147000,187000,40000,21
TIKI,thiet-bi-kts-phu-kien-so,196056692,"Ốp Samsung Silicone Flip 4 kèm vòng đeo màu Hồng - Hàng chính hãng - EF-PF721TPEGWW",690000,690000,0,0
TIKI,thiet-bi-kts-phu-kien-so,188489159,"Case Ốp Bảo Vệ Vui Nhộn Ngồi Bồn Cầu Dành cho Tai Nghe AIRPODS 3/ Airpods Pro/ Airpods 1/2- Hàng chính hãng",105000,109000,4000,4
TIKI,thiet-bi-kts-phu-kien-so,92084797,"Củ Sạc Adapter Baseus Super Si 20W Mini Type C Blue - PD/QC 3.0 - Tự Động Điều Chỉnh Ổn Định Dòng Điện - Hàng Chính Hãng",185000,185000,0,0
TIKI,thiet-bi-kts-phu-kien-so,129198595,"Bộ chia USB 2 máy tính dùng chung 1 máy in Ugreen 30345-Hàng chính hãng",257000,279000,22000,8
TIKI,thiet-bi-kts-phu-kien-so,183116805,"Loa kiểm âm Edifier MR4 Xử lý tín hiệu số Đầu vào TRS balance - Hàng chính hãng",1730000,1730000,0,0
TIKI,thiet-bi-kts-phu-kien-so,35227361,"Ốp lưng lụa dành cho iPhone 11 6.1 chính hãng Memumi siêu mỏng 0.3mm",98999,197998,98999,50
TIKI,thiet-bi-kts-phu-kien-so,181750420,"Cáp chuyển HDMI to VGA Kingmaster KY-H121B - Hàng chính hãng",115000,115000,0,0
TIKI,thiet-bi-kts-phu-kien-so,175470882,"Tai nghe Samsung  có dây -  Giắc 3.5mm (EO-IA500) Hàng Chính hãng",239000,239000,0,0
TIKI,thiet-bi-kts-phu-kien-so,172307355,"Kính Cường Lực Camera ESR cho Samsung Galaxy S22/ S22 Plus (Bộ 2 miếng)_ Hàng Chính Hãng",161000,161000,0,0
TIKI,thiet-bi-kts-phu-kien-so,88248106,"Webcam Asus C3 FullHD 1080p - Hàng Chính Hãng",960000,960000,0,0
TIKI,thiet-bi-kts-phu-kien-so,38215822,"Cáp sạc Micro USB Hoco X14 Pro, cáp sạc bọc dù siêu bền, hỗ trợ sạc nhanh 3A Max, tự ngắt khi pin đầy, LED báo sạc dành cho Samsung, Huawei, Xiaomi, Oppo, Sony - Hàng chính hãng",35000,54990,19990,36
TIKI,thiet-bi-kts-phu-kien-so,5980833,"Cáp chuyển Micro HDMI Type D sang HDMI Type A Dài 2M UGREEN HD127 30103 - Hàng chính hãng",156000,180000,24000,13
TIKI,thiet-bi-kts-phu-kien-so,178776473,"Vỏ thùng loa đứng 3 tấc thùng sơn KP 6012 Hải Triều (hàng chính hãng) ",1450000,1450000,0,0
TIKI,thiet-bi-kts-phu-kien-so,155879638,"Pin dự phòng sạc nhanh 10.000mah hoco J87 QC 3.0 và PD 20w,cổng sạc type-c sạc đảo chiều(HÀNG CHÍNH HÃNG)",199000,199000,0,0
TIKI,thiet-bi-kts-phu-kien-so,184284197,"Ốp lưng chống sốc silicon cho Samsung Galaxy Z Fold 3 bảo vệ Camera hiệu Nillkin Camshield Silky Silicon Case (chống sốc cực tốt, chất liệu cao cấp, có khung và nắp đậy bảo vệ Camera) - hàng nhập khẩu",240967,240967,0,0
TIKI,thiet-bi-kts-phu-kien-so,207335374,"Ruizu X66 (16GB; 8GB;4GB) - Máy Nghe Nhạc Thể Thao Nhỏ Gọn, Có Bluetooth (Tặng Tai Nghe Nhạc) - Hàng Chính Hãng",400000,400000,0,0
TIKI,thiet-bi-kts-phu-kien-so,52853342,"Chuột Không Dây Forter Màu Hồng - Hàng Chính Hãng",99000,99000,0,0
TIKI,thiet-bi-kts-phu-kien-so,15013997,"Cốc Củ sạc nhanh Baseus công suất 24W Công nghệ Sạc Nhanh Qualcomm QC 3.0 tự động điều chình dòng sạc - Hàng nhập khẩu",145000,149000,4000,3
TIKI,thiet-bi-kts-phu-kien-so,146363083,"Tai nghe không dây Sabbat X12 ultra - Sabbat X12 pro - Hàng chính hãng",880000,880000,0,0
TIKI,thiet-bi-kts-phu-kien-so,105663864,"Bao da kèm bàn phím Bluetooth Samsung Tab A7 Lite T225 Smart Keyboard - Hàng nhập khẩu",379000,379000,0,0
TIKI,thiet-bi-kts-phu-kien-so,172828838,"Micro Bluetooth không dây Karaoke hút âm siêu nhẹ cao cấp PKCB cho điện thoại - Hàng Chính Hãng",984000,2500000,1516000,61
TIKI,thiet-bi-kts-phu-kien-so,162024953,"Bao da Nillkin Bumper Leather Case (Có khe cắm bút Apple Pencil) - Hàng Nhập Khẩu",363000,700000,337000,48
TIKI,thiet-bi-kts-phu-kien-so,190589667,"Bộ 2 miếng dán màn hình full cho Samsung Galaxy S22 Ultra, S22 Ultra 5G hãng Gor - Hàng nhập khẩu ( hộp 2 miếng)",65000,65000,0,0
TIKI,thiet-bi-kts-phu-kien-so,150967,"Tai Nghe Urbanista San Francisco",290000,290000,0,0
TIKI,thiet-bi-kts-phu-kien-so,43104016,"Ốp lưng da kính cao cấp dành cho iPhone X / iPhone XS - Màu xanh",149000,150000,1000,1
TIKI,thiet-bi-kts-phu-kien-so,34277812,"Ốp lưng iPhone 11 Pro Max RINGKE Fusion - hàng chính hãng",270000,270000,0,0
TIKI,thiet-bi-kts-phu-kien-so,197346190,"Ốp Lưng dành cho iPhone 14/14 Plus/14 Pro/14 Pro Max RINGKE Fusion - Hàng Chính Hãng",330000,330000,0,0
TIKI,thiet-bi-kts-phu-kien-so,152518144,"Đế sạc nhanh không dây PD 15W  Hoco CR33 - đế sạc 3 in 1 cho IP apple watch tai nghe thông minh -  hàng chính hãng",499000,499000,0,0
TIKI,thiet-bi-kts-phu-kien-so,145497704,"Bao da Nillkin iPad Pro M1 11 inch 2021/ 2020 chống sốc, thanh đẩy che camera",360000,360000,0,0
TIKI,thiet-bi-kts-phu-kien-so,93205535,"Tai Nghe Bluetooth TWS 5.0 Giảm tiếng ồn Tai nghe không dây nhét tai chống nước - Hàng Chính Hãng PKCB",250000,500000,250000,50
TIKI,thiet-bi-kts-phu-kien-so,115999380,"Dây sạc nhanh 2 cổng Type C, dài 0.5-2m UGREEN US286",57000,70000,13000,19
TIKI,thiet-bi-kts-phu-kien-so,13856093,"Cáp nối USB 1 đầu đực, 1 đầu cái  3.0, mạ vàng Ugreen 30125",99000,99000,0,0
TIKI,thiet-bi-kts-phu-kien-so,59562726,"Giá Đỡ Để Bàn Điện Thoại Di Động, Máy Tính Bảng Chất Liệu Hợp Kim Nhôm Cao Cấp Có Thể Xoay 360 Độ Hàng Nhập Khẩu Helios",29000,29000,0,0
TIKI,thiet-bi-kts-phu-kien-so,110376984,"Ốp dẻo cao cấp dành cho iPhone  - Hàng chính hãng",69000,119000,50000,42
TIKI,thiet-bi-kts-phu-kien-so,71674971,"Loa bluetooth Zealot không dây di động ngoài trời âm thanh siêu trầm nghe nhạc cực hay hàng chính hãng",369000,369000,0,0
TIKI,thiet-bi-kts-phu-kien-so,71972268,"Ốp Lưng Silicon TPU trong suốt GOR cho Samsung Galaxy Note 20 / Note 20 Ultra - Hàng Nhập Khẩu",45000,45000,0,0
TIKI,thiet-bi-kts-phu-kien-so,56799815,"Bộ Găng Tay 4 Ngón Cảm Ứng CONVI CV04 Chơi Game Điện Thoại - Bộ Bao Tay 4 Ngón Chống Mồ Hôi, Chống Trượt Gear Chuyên Game Mobile - Hàng Chính Hãng",13000,13500,500,4
TIKI,thiet-bi-kts-phu-kien-so,73167033,"Bao da cho iPad Air 10..9 2020 ,iPad Air 4 Nillkin chống sốc, có khay để bút- Hàng chính hãng.",333000,500000,167000,33
TIKI,thiet-bi-kts-phu-kien-so,103703414,"Micro không dây Bluetooth Karaoke - Hàng Chính Hãng",872500,1545000,672500,44
TIKI,thiet-bi-kts-phu-kien-so,109168997,"Chuôt Văn Phòng Không Dây Logi B175 - Hàng Chính Hãng",165000,165000,0,0
TIKI,thiet-bi-kts-phu-kien-so,95442989,"Webcam HIKVISION DS-U02 (1920 × 1080) - Hàng chính hãng",450000,450000,0,0
TIKI,thiet-bi-kts-phu-kien-so,21147485,"Miếng dán màn hình cho Ipad Pro 12.9 inches Elecom Paper- Feel TB-A18LFLAPLL-W - Hàng chính hãng",584100,584100,0,0
TIKI,thiet-bi-kts-phu-kien-so,136587242,"Cáp dp ra displayport 8K 1.4 màu đen hợp kim bọc lưới chống nhiễu Ugreen DP114 Hàng chính hãng",225000,225000,0,0
TIKI,thiet-bi-kts-phu-kien-so,36357005,"Đầu chuyển DVI-I 24+5 dương to VGA âm Ugreen GK20122 Hàng chính hãng",70000,70000,0,0
TIKI,thiet-bi-kts-phu-kien-so,73771544,"Ốp cho iPhone 12 Pro Max, 12 Pro, 12 , 12 Mini - Silicon dẻo màu hãng Gor có gờ bảo vệ camera Hàng nhập khẩu",33500,33500,0,0
TIKI,thiet-bi-kts-phu-kien-so,430674,"Loa Fenda A110 2.1 - Hàng Chính Hãng",615000,615000,0,0
TIKI,thiet-bi-kts-phu-kien-so,174593802,"Chuột Không Dây PIX-LINK P103A Pin Sạc USB 2.4GHz DPI 1600, Không Tiếng Ồn Sử Dụng Cho PC, Laptop, Tivi Hàng Chính Hãng",116000,289000,173000,60
TIKI,thiet-bi-kts-phu-kien-so,88793887,"Micro Karaoke Kết Nối Bluetooth Nhanh Chóng Cầm Nhẹ Tay Hút Âm Tốt PKCB - Hàng Chính Hãng",1125000,2500000,1375000,55
TIKI,thiet-bi-kts-phu-kien-so,91190115,"Cáp sạc và truyền dữ liệu dài 1-2m UGREEN US284 - Hàng chính hãng",109000,119000,10000,8
TIKI,thiet-bi-kts-phu-kien-so,26440006,"Micro trợ giảng không dây oris m996 - hàng chính hãng",390000,390000,0,0
TIKI,thiet-bi-kts-phu-kien-so,142872893,"Dây cáp sạc MFI sạc nhanh 30W chuẩn PD 3.0 Type-C / USB C to đầu sạc cho iPhone / iPad hiệu CHOETECH IP0040 dài 120cm - hàng chính hãng",235000,235000,0,0
TIKI,thiet-bi-kts-phu-kien-so,133940670,"Ốp lưng iPhone 13 Pro Max Nillkin Nature TPU Pro Case - Hàng chính hãng",76000,104498,28498,27
TIKI,thiet-bi-kts-phu-kien-so,85799997,"(Hỗ Trợ Tiếng Việt) Máy Nghe Nhạc Android MP4 Màn Hình Cảm Ứng 4.0 Inch Bluetooth WiFi Ruizu H8 Bộ Nhớ Trong 16GB - Hàng Chính Hãng",1453000,1483000,30000,2
TIKI,thiet-bi-kts-phu-kien-so,189791616,"HUB TYPE C Và HUB USB Tốc Độ Cao Chia 4 Cổng USB 3.0 CV, HUB Chuyển Đổi Dành Cho Macbook Pro, Laptop, PC, Hỗ Trợ OTG Kết Nối Điện Thoại, Sạc Pin, Kết Nối Đa Năng Ổ Cứng, Bàn Phím, Chuột, Máy In, Thiết Bị Ổ Chia USB - Hàng Chính Hãng",148000,148000,0,0
TIKI,thiet-bi-kts-phu-kien-so,13974717,"Cáp USB Type-C to 1 cổng audio 3.5, 1 cổng xạc Type Ugreen -50596 - Hàng chính hãng",149000,149000,0,0
TIKI,thiet-bi-kts-phu-kien-so,7286241,"Ốp Lưng iPhone 7 / iPhone 8 Anker KARAPAX Shield - A9005011",67200,200000,132800,66
TIKI,thiet-bi-kts-phu-kien-so,35411153,"Ốp lưng dẻo cao cấp dành cho iPhone XS MAX - Màu tím mờ",29000,49000,20000,41
TIKI,thiet-bi-kts-phu-kien-so,124935012,"Miếng Dán Kính Cường Lực JCPAL Preserver 2.5D Dành Cho iPhone 13 Mini/ 13/ 13 Pro/ 13 Pro Max - Hàng Chính Hãng",278000,290000,12000,4
TIKI,thiet-bi-kts-phu-kien-so,197339569,"Ốp Lưng ESR Classic Kickstand Case dành cho iPhone 14 / 14 Plus/ 14 Pro / 14 Pro Max- Kèm Kính Cường Lực Màn Hình- Hàng Chính Hãng",432000,450000,18000,4
TIKI,thiet-bi-kts-phu-kien-so,195183348,"Loa vi tính Microlab MS212 10W Bluetooth / FM / Thẻ nhớ / USB / AUX / Pin sạc - Hàng chính hãng",449000,449000,0,0
TIKI,thiet-bi-kts-phu-kien-so,190595892,"Dây Sạc, Cáp Sạc Dành Cho Xiaomi MiBand 5, Mi Band 6, MiBand 7 - Hàng Nhập Khẩu",53900,55000,1100,2
TIKI,thiet-bi-kts-phu-kien-so,24176299,"Cáp Luồn ống dây điện Protection Cable 3M 3M Đen Lp121 - Hàng Chính Hãng",141000,141000,0,0
TIKI,thiet-bi-kts-phu-kien-so,126690362,"Tai nghe có dây Xiaomi Mi Basic ZBW4354TY HSEJ03JY - Hàng chính hãng",109000,130000,21000,16
TIKI,thiet-bi-kts-phu-kien-so,197672785,"Ốp lưng chống sốc trong suốt cho Samsung Galaxy Z Flip 3 Likgus Crashproof giúp chống chịu mọi va đập - hàng nhập khẩu",99999,99999,0,0
TIKI,thiet-bi-kts-phu-kien-so,116480052,"Tai nghe bluetooth Hoco E60 V5.0 dòng 1 tai có micro và nút chỉnh âm lượng,Hàng Chính Hãng",89000,89000,0,0
TIKI,thiet-bi-kts-phu-kien-so,39012636,"Máy nghe nhạc Ruizu X52 Bluetooth Lossless 8GB - Hàng Nhập Khẩu",484000,484000,0,0
TIKI,thiet-bi-kts-phu-kien-so,6010115,"Dây Audio 3,5mm ra 2 đầu RCA (Hoa sen) dài 2M UGREEN AV116 - 10584 - Hàng chính hãng",117000,132000,15000,11
TIKI,thiet-bi-kts-phu-kien-so,80970228,"Ốp lưng silicon Gor cho Samsung Galaxy S21 Ultra, S21 Plus, S21 / 5G siêu mỏng, có gờ bảo vệ camera hàng nhập khẩu",33000,50000,17000,34
TIKI,thiet-bi-kts-phu-kien-so,11008870,"Bàn phím full cơ FUHLEN DESTROYER - Hàng Chính Hãng",885000,885000,0,0
TIKI,thiet-bi-kts-phu-kien-so,197345920,"Miếng Dán Cường Lực Mipow Kingbull Chống Vân Tay ANTI-GLARE Premium Silk HD (2.7D) dành cho iPhone 14 / iPhone 14 Plus/ iPhone 14 Pro/ iPhone 14 ProMax- Hàng chính hãng",210000,420000,210000,50
TIKI,thiet-bi-kts-phu-kien-so,147259219,"Chuột Không Dây DAREU LM115 PINK - Chuột Máy Tính Màu Hồng Dễ Thương - Hàng Chính Hãng",135000,135000,0,0
TIKI,thiet-bi-kts-phu-kien-so,479092,"Chuột Có Dây A4Tech N-500F - Hàng Chính Hãng",150000,150000,0,0
TIKI,thiet-bi-kts-phu-kien-so,54608774,"Túi Chống Sốc Dành Cho Ipad Mini 5 2019, Ipad Mini 1 2 3, Các Loại Máy Tính Bảng Kích Thước 7.9 Inch Chống Thấm Nước, Chống Xước, Bụi Bẩn Helios",29000,29000,0,0
TIKI,thiet-bi-kts-phu-kien-so,80878117,"Chuột gaming chơi game có dây Fuhlen G90 nút bấm bất tử led RGB tem Ninza - Hàng chính hãng",353000,353000,0,0
TIKI,thiet-bi-kts-phu-kien-so,12419745,"Chuột không dây Bosston Q1– Hàng Chính Hãng",48990,48990,0,0
TIKI,thiet-bi-kts-phu-kien-so,46781219,"Dán màn hình Samsung Galaxy Watch Active 2 GOR (Hộp 2 miếng)- hàng nhập khẩu",110000,110000,0,0
TIKI,thiet-bi-kts-phu-kien-so,184068493,"Ốp lưng silicone dành cho điện thoại Iphone 13 6.1 inch Màu Navy Blue Ugreen 80674 hàng chính hãng",255000,255000,0,0
TIKI,thiet-bi-kts-phu-kien-so,198231345,"Máy nghe nhạc Bluetooth Ruizu D15 Hifi 2019 (8GB) - Hàng Chính Hãng",590000,590000,0,0
TIKI,thiet-bi-kts-phu-kien-so,110153980,"Cáp sạc Baseus PD20W Baseus High Density kết nối Type-C sang iPhone dài 100CM ( 3 màu ) - Hàng chính hãng",85000,202400,117400,58
TIKI,thiet-bi-kts-phu-kien-so,112669719,"Miếng Dán Dẻo GOR dành cho Apple Watch Series 4/5/6/SE Size 40/44mm (Bộ 3 Miếng) - Hàng Nhập Khẩu",99000,99000,0,0
TIKI,thiet-bi-kts-phu-kien-so,479091,"Chuột Có Dây A4Tech N-70FX-1 - Hàng Chính Hãng",168000,179000,11000,6
TIKI,thiet-bi-kts-phu-kien-so,190753295,"Bao da TOMTOC (USA) dành cho iPad Pro 12.9 inch từ tính đa góc SMART-TRI-B02-004 hỗ trợ sạc không dây APPLE PENCIL - Hàng chính hãng",1130500,1190000,59500,5
TIKI,thiet-bi-kts-phu-kien-so,509921,"Cáp Sạc Hoco X1 Charging For iPhone 4 - 1M - Hàng chính hãng",45000,45000,0,0
TIKI,thiet-bi-kts-phu-kien-so,2038581,"Cáp Chuyển Đổi Ugreen DisplayPort Sang HDMI 2.0 20363 - Hàng Chính Hãng",195000,195000,0,0
TIKI,thiet-bi-kts-phu-kien-so,196910364,"Cáp sạc nhanh siêu bền dùng cho iPhone/iPad Baseus Tungsten Gold (USB to IP, 2.4A Fast Charging & Data Cable)- Hàng chính hãng",175000,199000,24000,12
TIKI,thiet-bi-kts-phu-kien-so,197644087,"Ốp Lưng dành cho iPhone 15 Pro Max/14/14 Plus/14 Pro/14 Pro Max SPIGEN Thin Fit - Hàng Chính Hãng",272300,389000,116700,30
TIKI,thiet-bi-kts-phu-kien-so,43006632,"Bộ phím chuột có dây Dell - Phím KB216 + Chuột MS116 - Hàng chính hãng",249000,249000,0,0
TIKI,thiet-bi-kts-phu-kien-so,167152597,"Ốp lưng chính hãng Nillkin dành cho Samsung S22 Plus dạng sần - Hàng Nhập Khẩu",133000,133000,0,0
TIKI,thiet-bi-kts-phu-kien-so,10860173,"Bút Cảm Ứng Điện Dung 2 Trong 1 Baseus Smartphone Tablet IPad - Màu Ngẫu Nhiên - Hàng chính hãng",155000,185000,30000,16
TIKI,thiet-bi-kts-phu-kien-so,16393113,"Cáp USB 3.0 Type-C Male to micro B Male Unitek Y-C475BK - Hàng nhập khẩu",109000,109000,0,0
TIKI,thiet-bi-kts-phu-kien-so,43389374,"Ốp lưng da kính cao cấp dành cho iPhone 11 - Màu đỏ - Hàng nhập khẩu - DELICATE",149000,199000,50000,25
TIKI,thiet-bi-kts-phu-kien-so,119425908,"CỦ LOA BASS 25 BM TỪ 156 COIL 65 CAO CẤP HÀNG NHẬP KHẨU - GỒM 1 LOA",640000,640000,0,0
TIKI,thiet-bi-kts-phu-kien-so,146678599,"Phụ kiện gaming thương hiệu MEMO - Quạt Tản Nhiệt Điện Thoại - Bao tay chơi game - Mặt hàng thiết yếu cho game thủ - Hàng Chính Hãng Memo",135000,150000,15000,10
TIKI,thiet-bi-kts-phu-kien-so,105658468,"Chuột không dây AKKO Smart 1 - Hàng Chính Hãng",369000,369000,0,0
TIKI,thiet-bi-kts-phu-kien-so,2473239,"Màng Lọc Âm Kim Loại Alctron MA-19B - Hàng Chính Hãng",250000,269000,19000,7
TIKI,thiet-bi-kts-phu-kien-so,508536,"Hub 4 Cổng USB 3.0 Ugreen 20290 0.5m - Hàng chính hãng",215000,227500,12500,5
TIKI,thiet-bi-kts-phu-kien-so,140135909,"Miếng Dán GOR Bảo Vệ Viền cho iPhone 13 / 13 Pro / 13 Pro Max (5 Bộ Miếng Dán) - Hàng Nhập Khẩu",59000,76998,17998,23
TIKI,thiet-bi-kts-phu-kien-so,197568305,"Bàn phím cơ Filco Majestouch 3 Fullsize - Hàng Chính Hãng",4290000,4290000,0,0
TIKI,thiet-bi-kts-phu-kien-so,66667776,"Bao da bò thật dạng ví chính hãng Caseme dành cho iPhone X/Xs - Hàng chính hãng",142000,142000,0,0
TIKI,thiet-bi-kts-phu-kien-so,181681023,"Chuột máy tính Logitech B100 (Đen) - Hàng Chính Hãng",75000,75000,0,0
TIKI,thiet-bi-kts-phu-kien-so,43398852,"Ốp lưng da kính cao cấp dành cho iPhone XS Max - Màu vàng nâu - Hàng nhập khẩu - DELICATE",149000,199000,50000,25
TIKI,thiet-bi-kts-phu-kien-so,90519355,"micro dây guinness bg-68S hàng chính hãng",600000,600000,0,0
TIKI,thiet-bi-kts-phu-kien-so,275264232,"Chuột gaming có dây Dareu EM908X RGB - Hàng Chính Hãng",249000,249000,0,0
TIKI,thiet-bi-kts-phu-kien-so,76203364,"Ốp lưng Samsung Galaxy S20 Plus/ S20 Ultra chính hãng SULADA dạng da mềm",75000,75000,0,0
TIKI,thiet-bi-kts-phu-kien-so,78509927,"Ốp lưng chống sốc trong suốt siêu mỏng cho Samsung Galaxy S21 Plus hiệu Likgus Crashproof giúp chống chịu mọi va đập - hàng nhập khẩu",83870,150000,66130,44
TIKI,thiet-bi-kts-phu-kien-so,146936179,"Bao da bò dạng ví chính hãng Caseme dành cho Xiaomi 11 Lite 5G NE - Hàng chính hãng",168990,168990,0,0
TIKI,thiet-bi-kts-phu-kien-so,102047540,"Dây XLR ra 3.5mm (Canon cái ra 3.5) chuyên dùng cho micro thu âm, soundcard, PC - Dài 2.5m - Truyền tín hiệu tốt - Hàng chính hãng",92000,92000,0,0
TIKI,thiet-bi-kts-phu-kien-so,136820198,"Ốp lưng dành cho Samsung Galaxy A7 2018 iron man chống sốc kèm iring - hàng nhập khẩu",89000,89000,0,0
TIKI,thiet-bi-kts-phu-kien-so,181810365,"Ốp Lưng Silicon TPU trong suốt GOR cho Samsung Galaxy S22 / S22 Plus / S22 Ultra - Hàng Nhập Khẩu",90000,90000,0,0
TIKI,thiet-bi-kts-phu-kien-so,90898855,"Bộ miếng dán kính cường lực bảo vệ Camera iPhone 12 Pro (6.1 inch) hiệu Wiwu Guard Lens Ring mang  lại khả năng chụp hình sắc nét full HD (độ cứng 9H, chống trầy, chống chụi & vân tay, bảo vệ toàn diện) - hàng nhập khẩu",127000,200000,73000,37
TIKI,thiet-bi-kts-phu-kien-so,67240253,"Bộ Chia USB HUB ORICO AT2U3-7AB-GY (Xám) 7 Cổng USB 3.0 Với Các Cổng Riêng Lẻ- Hàng Chính Hãng",863000,863000,0,0
TIKI,thiet-bi-kts-phu-kien-so,479097,"Chuột Không Dây A4Tech G3.280A - Hàng Chính Hãng",158000,169000,11000,7
TIKI,thiet-bi-kts-phu-kien-so,197387454,"Ốp Lưng MIPOW TEMPERED GLASS TRANSPARENT Nguyên Liệu Đức (DROPTEST 1.8M, Chống Ố Vàng) dành cho iPhone 14 / iPhone 14 Plus/ iPhone 14 Pro/ iPhone 14 ProMax- Hàng chính hãng",326000,340000,14000,4
TIKI,thiet-bi-kts-phu-kien-so,103670110,"Rapoo C280 Webcam 2K HD với USB2.0 với nắp đậy camera có thể xoay mic - hàng Chính Hãng",820000,820000,0,0
TIKI,thiet-bi-kts-phu-kien-so,161553090,"Chuột có dây Logitech B100- Hàng chính hãng",77000,77000,0,0
TIKI,thiet-bi-kts-phu-kien-so,77111794,"Tai Nghe Bluetooth TWS  Cảm Ứng Vân Tay Một Chạm Thông Minh PKCB - Hàng Chính Hãng",245000,500000,255000,51
TIKI,thiet-bi-kts-phu-kien-so,176694590,"Bộ chuyển đổi USB-C sang 2*USB 3.0+HDMI, RJ45, SD TF và PD hỗ trợ 4 K Ugreen 60515 HÀng chính hãng",1120000,1120000,0,0
TIKI,thiet-bi-kts-phu-kien-so,76052628,"BEHRINGER DI100 - DI BOXES-HÀNG CHÍNH HÃNG",1164000,1200000,36000,3
TIKI,thiet-bi-kts-phu-kien-so,182755151,"Miếng Dán Cường Lực JCPAL Preserver 2.5D Dành Cho iPhone 13ProMax-13Pro-13-13Mini  - Hàng Chính Hãng",316000,329000,13000,4
TIKI,thiet-bi-kts-phu-kien-so,73937859,"Ốp Lưng ESR ESSENTIAL ZERO TPU Dành Cho iPhone 12 Mini, Iphone 12/ 12 Pro, 12 Pro Max - Hàng Chính Hãng",116998,233996,116998,50
TIKI,thiet-bi-kts-phu-kien-so,2774937,"Dây Cáp HDMI Unitek Y-C142 (10m) - Hàng Nhập Khẩu",277000,277000,0,0
TIKI,thiet-bi-kts-phu-kien-so,142118162,"Bàn di chuột cỡ lớn Logitech Desk Mat - Đế cao su chống trượt, lướt dễ dàng, bề mặt chống đổ tràn, bền bỉ, nhỏ gọn - Màu",460000,460000,0,0
TIKI,thiet-bi-kts-phu-kien-so,189371296,"Ốp lưng silicon dẻo cho Samsung Galaxy S21 FE hiệu Ultra Thin mỏng 0.6mm độ trong tuyệt đối chống trầy xước - Hàng nhập khẩu",39000,39000,0,0
TIKI,thiet-bi-kts-phu-kien-so,191655874,"Ốp lưng Auto Focus dành cho Xiaomi Redmi 10C silicon vân da - Hàng Chính Hãng",50000,50000,0,0
TIKI,thiet-bi-kts-phu-kien-so,167418060,"Tai nghe không dây Sabbat E16 - Hàng chính hãng",1980000,1980000,0,0
TIKI,thiet-bi-kts-phu-kien-so,196353630,"Bao da bò thật dạng ví dành cho iPhone 14 Pro Max Caseme - Hàng Nhập Khẩu",112000,131998,19998,15
TIKI,thiet-bi-kts-phu-kien-so,98185800,"Micro Karaoke Bluetooth Không Dây - Âm Thanh Chất Lượng Cao - Hàng Chính Hãng",1103000,2190000,1087000,50
TIKI,thiet-bi-kts-phu-kien-so,78511171,"Đồng hồ thông minh theo dõi vận động theo dõi sức khỏe Garmin Approach S62 w/CT10 Bundle, Golf GPS, Black, SEA_010-02200-52 - Hàng Chính Hãng",13990000,13990000,0,0
TIKI,thiet-bi-kts-phu-kien-so,32281343,"Đỏ - Bao case da cho iPhone 11 Pro hiệu Nillkin Qin (có ngăn đựng thẻ, mặt da tinh xảo) - Hàng chính hãng",157999,300000,142001,47
TIKI,thiet-bi-kts-phu-kien-so,165124171,"Bao Đựng Điện Thoại Chống Nước Dây Đeo Tiện Lợi - Hàng nhập khẩu",21000,21000,0,0
TIKI,thiet-bi-kts-phu-kien-so,6009539,"Cáp chia 2 cổng Audio 3.5mm 1 đầu đực ra 2 đầu cái 20cm UGREEN AV123 10532 - Hàng Chính Hãng",99000,99000,0,0
TIKI,thiet-bi-kts-phu-kien-so,21343921,"Chuột Bay KM800 (Không Voice) - Hàng chính hãng",128900,128900,0,0
TIKI,thiet-bi-kts-phu-kien-so,142473275,"Củ Sạc Nhanh 20W Cổng USB + Type C Tích Hợp PD/QC 3.0 - Hàng Chính Hãng Baseus",185000,250000,65000,26
TIKI,thiet-bi-kts-phu-kien-so,112663057,"Bao da Dux Ducis Package Series dành cho Samsung Galaxy Note 20 Ultra hàng chính hãng",220000,220000,0,0
TIKI,thiet-bi-kts-phu-kien-so,13452654,"Bàn phím cơ DareU EK87 "D" Switch Black - Hàng chính hãng",499000,499000,0,0
TIKI,thiet-bi-kts-phu-kien-so,170425709,"Ốp Lưng dành cho Iphone 13 Pro Max Navy Blue Silicone 6.7inch  Ugreen 80678OLP546  Hàng chính hãng",259000,259000,0,0
TIKI,thiet-bi-kts-phu-kien-so,68457630,"Tai nghe chụp tai chuyên game Wangming 9800S Pink  Âm Thanh 7.1 - Led RGB - Jack Cắm USB - Hàng chính hãng",289000,289000,0,0
TIKI,thiet-bi-kts-phu-kien-so,72958553,"Jack âm thanh chuyển đổi 6.3mm dương sang 3.5mm âm Ugreen 503JA20503DA  hàng chính hãng",45000,45000,0,0
TIKI,thiet-bi-kts-phu-kien-so,44874754,"Tai nghe gaming WangMing WM9800 giả lập âm thanh vòm 7.1 kết nối USB - Hàng chính hãng (Màu hồng)",259000,259000,0,0
TIKI,thiet-bi-kts-phu-kien-so,197821724,"Hub USB 3.0 Và Hub Type C Đầu Ra 4 Cổng USB 3.0, Cổng Chuyển Đổi Dành Cho Macbook, Laptop, PC -  Hàng Chính Hãng",115000,200000,85000,43
TIKI,thiet-bi-kts-phu-kien-so,154148887,"Bao Da UNIQ Moven Antimicrobial dành cho Ipad Mini 6 Kháng Khuẩn Có Khe Cắm Bút_ Hàng Chính Hãng",720000,750000,30000,4
TIKI,thiet-bi-kts-phu-kien-so,87346168,"Hub chuyển đa năng Baseus Metal Gleam Series Multifunctional Docking Station ( Type-C to HDMI/ USB3.0/ LAN / SD Card Reader/ Type C PD 100W, Multifunctional HUB) - Hàng Chính Hãng",419000,419000,0,0
TIKI,thiet-bi-kts-phu-kien-so,22436030,"cáp sạc tự ngắt cho iphone chính hãng baseus",92000,92000,0,0
TIKI,thiet-bi-kts-phu-kien-so,107626938,"Cóc sạc  Baseus Compact Quick  nhỏ gọn 20W (USB + Type C Dual Port, 20W PD/QC 3.0 Multi Quick Charge Support) cho iPhone 12/iP11/XS Max, Android .. - Hàng chính hãng",159000,159000,0,0
TIKI,thiet-bi-kts-phu-kien-so,172433214,"Ốp lưng dành cho Samsung Galaxy S22 - S22 Plus - S22 Ultra - mẫu Sen Trắng Vàng 1",40000,55000,15000,27
TIKI,thiet-bi-kts-phu-kien-so,75715698,"Bao da dạng ví dành cho Huawei P40 Pro Chính Hãng Caseme có ngăn đựng thẻ - Hàng Chính Hãng",120000,120000,0,0
TIKI,thiet-bi-kts-phu-kien-so,192640012,"Case Ốp Thinfit Kính Cường Lực KAI Curved Glass Dành Cho Apple Watch - Hàng Nhập Khẩu",88000,119898,31898,27
TIKI,thiet-bi-kts-phu-kien-so,73666789,"Ốp lưng cho Xiaomi Mi10T , Mi 10T Pro 5G, Redmi K30S chính hãng Nillkin dạng sần",99000,99000,0,0
TIKI,thiet-bi-kts-phu-kien-so,162019817,"Ốp lưng (S20 5G) silicon Nillkin chống sốc - Hàng chính hãng",89000,89000,0,0
TIKI,thiet-bi-kts-phu-kien-so,41267176,"Ốp lưng dẻo chống sốc cao cấp dành cho iPhone 11 Pro - Màu trắng mờ",49000,69000,20000,29
TIKI,thiet-bi-kts-phu-kien-so,81800823,"Tai Nghe Kết Nối Không Dây Bluetooth TWS PKCB - Hàng Chính Hãng",240000,500000,260000,52
TIKI,thiet-bi-kts-phu-kien-so,2001029,"Bộ Chuyển Đổi Ugreen HDMI Sang VGA Audio Cáp Tròn Có Nguồn Phụ 40253 - Hàng Chính Hãng",175000,190000,15000,8
TIKI,thiet-bi-kts-phu-kien-so,646407,"Cáp HDMI Ugreen HD104 10106 (1m) - Hàng Chính Hãng",79000,79000,0,0
TIKI,thiet-bi-kts-phu-kien-so,88778028,"Miếng Dán Dẻo GOR dành cho Samsung Galaxy S21 Ultra (Bộ 3 Miếng) - Hàng Nhập Khẩu",84000,84000,0,0
TIKI,thiet-bi-kts-phu-kien-so,90220550,"Hộp đựng ổ cứng USB 3.0 2.5Inch Ugreen 80556 CM237 Hàng Chính Hãng",399000,415000,16000,4
TIKI,thiet-bi-kts-phu-kien-so,48464599,"Đầu đọc thẻ USB Type-C cho thẻ nhớ 2 cổng Micro SD/SD và TF có hỗ trợ chức năng OTG màu Xám Ugreen TC50704CM184 Hàng chính hãng.",164000,164000,0,0
TIKI,thiet-bi-kts-phu-kien-so,95028909,"Bàn Trộn Mixer USB 5 cổng Behringer XENYX Q502USB-Hàng Chính Hãng",1755000,1755000,0,0
TIKI,thiet-bi-kts-phu-kien-so,16077553,"Bao da iPad Mini 5 2019 (7.9 inch) kèm khay đựng bút chính hãng Mutural",246999,246999,0,0
TIKI,thiet-bi-kts-phu-kien-so,66611880,"Bao da bò thật dạng ví chính hãng Caseme dành cho Xiaomi Redmi Note 9s",120000,120000,0,0
TIKI,thiet-bi-kts-phu-kien-so,22104492,"Nút bấm chụp ảnh điều khiển từ xa cho gậy tự sướng, chân máy ảnh điện thoại android, iOS Mai Lee- Hàng chính hãng (Màu giao ngẫu nhiên)",9000,9000,0,0
TIKI,thiet-bi-kts-phu-kien-so,174548334,"Ốp lưng dành cho Vivo Y21 - Vivo Y21s mẫu Tân Binh Anime Thuỷ Trụ",40000,55000,15000,27
TIKI,thiet-bi-kts-phu-kien-so,15512978,"Dây đeo điện thoại di động tiện lợi -Giao màu ngẫu nhiên",18000,18000,0,0
TIKI,thiet-bi-kts-phu-kien-so,188941708,"Ốp lưng chống sốc cho Samsung Galaxy A73 5G hiệu Likgus vân kim loại , chống sốc chuẩn quân đội, chống va đập - hàng nhập khẩu",97000,97000,0,0
TIKI,thiet-bi-kts-phu-kien-so,188111490,"Bộ 2 Kính cường lực cho Samsung Galaxy A52S 5G - trong suốt chính hãng GOR vát 2,5D ( 2 miếng) Hàng nhập khẩu",99000,99000,0,0
TIKI,thiet-bi-kts-phu-kien-so,150225716,"Dây cáp sạc nhanh 30W chuẩn PD 3.0 hỗ trợ MFI dành cho iPhone / iPad hiệu CHOETECH IP0040 dài 120cm - hàng chính hãng",249000,249000,0,0
TIKI,thiet-bi-kts-phu-kien-so,197165208,"Miếng Dán Cường Lực MIPOW KINGBULL Chống Nhìn Trộm Dành Cho iPhone 14 ProMax / 14 Pro / 14 Max / 14 - Hàng Chính Hãng",402000,419000,17000,4
TIKI,thiet-bi-kts-phu-kien-so,87909019,"Kẹp điện thoại ipad xoay 360 độ treo ghế sau ô tô, xe hơi, giá đỡ kẹp máy tính bảng khớp kéo dài xoay dọc ngang bằng kim loại cao cấp- Hàng chính hãng",225000,225000,0,0
TIKI,thiet-bi-kts-phu-kien-so,173846534,"Ugreen 20228 cáp HDMI 2.1 dài 2M Dây Dẹt 8k 60hz 4k 120hz 48Gbps HD145 Hàng Chính Hãng",382000,382000,0,0
TIKI,thiet-bi-kts-phu-kien-so,170331138,"[ S21 / S21 Plus / S21 FE 5G ] Cường lực full màn Nillkin CP+Pro - Hàng chính hãng",153000,153000,0,0
TIKI,thiet-bi-kts-phu-kien-so,50495325,"Ốp lưng cho Samsung Galaxy S20 Ultra (S20 Ultra 5G) silicon Nillkin chống sốc - Hàng chính hãng",84000,84000,0,0
TIKI,thiet-bi-kts-phu-kien-so,73782264,"Bao da bò thật dạng ví chính hãng Caseme dành cho iPhone 7 Plus / 8 Plus",149855,149855,0,0
TIKI,thiet-bi-kts-phu-kien-so,91190683,"Dây cáp DisplayPort 1.2 hỗ trợ 3D, 4Kx2K 60Hz dài từ 1-10m UGREEN DP107 - Hàng chính hãng",289000,340000,51000,15
TIKI,thiet-bi-kts-phu-kien-so,181568297,"Bao Da Kai Dành cho Airpods Pro Kèm Móc Treo- Hàng Chính Hãng",115000,120000,5000,4
TIKI,thiet-bi-kts-phu-kien-so,176612933,"Loa máy tính Bluetooth Microlab U210/ 2.1 (Bluetooth/ TF/ FM)",310000,310000,0,0
TIKI,thiet-bi-kts-phu-kien-so,550554,"Cần Số Gaming Logitech - Hàng Chính Hãng",1499000,1499000,0,0
TIKI,thiet-bi-kts-phu-kien-so,34965372,"Túi 2 ngăn BUBM chuyên dụng đựng laptop 13inch, 15inch có lớp chống sốc, lớp lót nhung nỉ mịn có ngăn đựng chuột, cáp sạc- Hàng chính hãng",206000,206000,0,0
TIKI,thiet-bi-kts-phu-kien-so,11589650,"Ốp lưng chống sốc cho Samsung Galaxy S10 Plus hiệu Likgus Crashproof giúp chống chịu mọi va đập  - Hàng chính hãng",97000,97000,0,0
TIKI,thiet-bi-kts-phu-kien-so,74597487,"Dán Gor màn hình Samsung Galaxy Watch Active 2 40/44 mm (Hộp 2 miếng)- hàng nhập khẩu",80000,80000,0,0
TIKI,thiet-bi-kts-phu-kien-so,191755119,"Ốp lưng cho Xiaomi Poco C40 silicon giả da, chống sốc Auto Focus - Hàng Chính Hãng",50000,50000,0,0
TIKI,thiet-bi-kts-phu-kien-so,26181293,"Củ sạc trên oto chia tẩu Baseus High efficiency one tow two cigarette lighter (CRDYQ-01) - Hàng chính hãng",188000,188000,0,0
TIKI,thiet-bi-kts-phu-kien-so,190213283,"Ốp Case LOLIFO Kai Nguyen Protective Dành Cho Airpods 3 và Airpods PRO, Khoá Thông Minh Bảo Vệ Toàn Diện, Chống Rơi Vỡ - Hàng Nhập Khẩu",153000,159000,6000,4
TIKI,thiet-bi-kts-phu-kien-so,119102608,"Kính Cường Lực Gor Cho Samsung Galaxy S21 Plus Dán Full Màn, Viền Đen Cao Cấp Hãng Gor ( Fullbox ) - Hàng Nhập Khẩu",109000,109000,0,0
TIKI,thiet-bi-kts-phu-kien-so,170433373,"Dán Camera cường lực viền màu chống va đập Zeelot iPhone 12 Pro/12 Pro Max - Hàng chính hãng",179000,350000,171000,49
TIKI,thiet-bi-kts-phu-kien-so,32715590,"Xanh - Ốp lưng viền màu mạ crom cho iPhone 11 Pro (5.8 inch) hiệu Baseus Glitter (mỏng 0.6mm, chống va đập, gờ bảo vệ Camera, Mạ Crom sang trọng)",118000,118000,0,0
TIKI,thiet-bi-kts-phu-kien-so,56076012,"Ốp lưng dành cho Samsung A7 2018 mẫu Tâm Chiếc Lá",45000,55000,10000,18
TIKI,thiet-bi-kts-phu-kien-so,116273116,"Chuột Chơi Game E-Dra EM624 Led RGB - Hàng Chính Hãng",369000,369000,0,0
TIKI,thiet-bi-kts-phu-kien-so,164816969,"Bao da dạng ví dành cho Samsung Galaxy S22 Plus hàng chính hãng Caseme",120000,120000,0,0
TIKI,thiet-bi-kts-phu-kien-so,123830217,"Miếng dán màn hình kính cường lực cho iPad Mini 6 2021 hiệu Nillkin Amazing H+ (mỏng 0.2 mm, vát cạnh 2.5D, chống trầy, chống va đập) - Hàng Nhập Khẩu",226961,226961,0,0
TIKI,thiet-bi-kts-phu-kien-so,196967125,"Card âm thanh / usb âm thanh chuyển Usb ra 2 cổng 3.5mm Vention VAB-S13 / CDKHB / CDYB0  - Hàng chính hãng",80000,80000,0,0
TIKI,thiet-bi-kts-phu-kien-so,194130066,"Bộ 3 Miếng Dán Cường lực GOR cho Đồng Hồ Garmin Fenix 7 / 7S / 7X / Garmin Epix Gen 2 - Hàng Chính Hãng",133000,139000,6000,4
TIKI,thiet-bi-kts-phu-kien-so,181269220,"Bao Case Ốp Mạ Chrome Cao Cấp Cho Airpods 3/ Airpods Pro- Hàng Chính Hãng",106000,110000,4000,4
TIKI,thiet-bi-kts-phu-kien-so,182326305,"Ốp lưng cho SamSung Galaxy S22 Plus chính hãng Xlevel dạng da mềm - Hàng nhập khẩu",89000,89000,0,0
TIKI,thiet-bi-kts-phu-kien-so,184130521,"Ốp lưng dành cho Samsung A23 4G - A53 5G - A73 mẫu Tâm Chú Tiểu Thuyền",40000,55000,15000,27
TIKI,thiet-bi-kts-phu-kien-so,146361751,"Bộ sạc nhanh Baseus GaN3 Pro Quick Charger 65W (Type Cx2 + USB , PD3.0/ PPS/ QC4.0/ SCP/ FCP Multi Quick Charge Protocol, GaN2 Technology) - Hàng nhập khẩu",568899,568899,0,0
TIKI,thiet-bi-kts-phu-kien-so,22493423,"Ốp lưng cho Samsung Galaxy Note 8 - 01062 - Ốp dẻo trong - Hàng Chính Hãng",35000,35000,0,0
TIKI,thiet-bi-kts-phu-kien-so,165245338,"Ốp lưng dành cho Samsung S21 FE cao cấp - Hàng nhập khẩu Xundd",101000,118000,17000,14
TIKI,thiet-bi-kts-phu-kien-so,1998347,"Cáp Máy In Ugreen 10351 (3m) - Hàng Chính Hãng",94000,94000,0,0
TIKI,thiet-bi-kts-phu-kien-so,103662947,"Chuột Gaming Fuhlen G90 Màu Hồng (Led RGB, Nút Bấm Bất Tử) - Hàng Chính Hãng",358000,358000,0,0
TIKI,thiet-bi-kts-phu-kien-so,101887706,"Tai Nghe Có Dây Mic Bass Âm Thanh Jack 3.5Mm Cho Điện Thoại(Encok H06) Samsung Xiaomi - Hàng Chính Hãng Baseus",158499,158499,0,0
TIKI,thiet-bi-kts-phu-kien-so,71022933,"Miếng phủ bàn phím cho MacBook Air 13.3 New 2020 hiệu JCPAL FitSkin Clear Tpu siêu mỏng 0.2 mm - Hàng nhập khẩu",196000,200000,4000,2
TIKI,thiet-bi-kts-phu-kien-so,155045141,"Combo Bao da+túi đựng phụ kiện dành cho Surface Pro 4,5,6,7,7Plus và Go- Hàng nhập khẩu",489000,489000,0,0
TIKI,thiet-bi-kts-phu-kien-so,174547534,"Ốp lưng dành cho Xiaomi Redmi Note 11 Pro 5G mẫu Tranh Loang Viền Đen",40000,55000,15000,27
TIKI,thiet-bi-kts-phu-kien-so,76775222,"Ốp lưng HOCO dành cho Samsung Galaxy S9 Plus dẻo silicon màu đen mờ - Hàng nhập khẩu",50000,50000,0,0
TIKI,thiet-bi-kts-phu-kien-so,192153208,"ĐÀI Radio FM SW-999URT FM USB Thẻ Nhớ phong cách cổ điển QUÀ TẶNG CHO NGƯỜI THÂN YÊU-Hàng Chính Hãng",220000,220000,0,0
TIKI,thiet-bi-kts-phu-kien-so,125577828,"Ốp lưng chống sốc Clear Protective Samsung Galaxy S21 Ultra 5G EF-GG998 -Hàng chính hãng",599000,790000,191000,24
TIKI,thiet-bi-kts-phu-kien-so,11720616,"Ốp lưng chống sốc Likgus cho Nokia 8.1 / Nokia X7  (chuẩn quân đội, chống va đập, chống vân tay) - Hàng chính hãng",85000,85000,0,0
TIKI,thiet-bi-kts-phu-kien-so,152011102,"Cáp sạc nhanh USB 2.0 Type C  dùng cho điện thoại Android Samsung Galaxy S, Galaxy Note 8.9.10 - hàng chính hãng ",32000,32000,0,0
TIKI,thiet-bi-kts-phu-kien-so,196469814,"Bao da cao cấp dành cho iPhone 14 Pro Max dạng ví chính hãng Caseme - Hàng Nhập Khẩu",159000,159000,0,0
TIKI,thiet-bi-kts-phu-kien-so,98184504,"Bao da dành cho iPad Pro 11 inch 2021, 12.9 2021 hiệu Mutural - Hàng nhập khẩu",202000,529998,327998,62
TIKI,thiet-bi-kts-phu-kien-so,76551611,"Miếng Dán Kính Cường Lực Camera chống trầy GOR cho iPhone 12 Mini / 12 / 12 Pro / 12 Pro Max (Bộ 2 Miếng) - Hàng Nhập Khẩu",59989,119978,59989,50
TIKI,thiet-bi-kts-phu-kien-so,164563949,"Miếng Dán Cường Lực ZEELOT Dành cho Samsung Galaxy S22/ S22 Plus_ Hàng Chính Hãng",190000,190000,0,0
TIKI,thiet-bi-kts-phu-kien-so,197939369,"Ốp Lưng Trong Suốt GOR TPU Dành Cho iPhone 14 ProMax / 14 Pro / 14Plus / 14 - Hàng Chính Hãng",40000,40000,0,0
TIKI,thiet-bi-kts-phu-kien-so,6679771,"Bộ chuyển đổi USB 2.0 sang LAN 10/100 Mbps CR110 20254 - Hàng Chính Hãng",174000,189000,15000,8
TIKI,thiet-bi-kts-phu-kien-so,13884156,"HDMI 2.0 Carbon fiber Zinc alloy Ugreen Cable",219000,219000,0,0
TIKI,thiet-bi-kts-phu-kien-so,119238931,"Chuột Không Dây Akko Hamster MoMo Plus 2021 Màu Hồng - Hàng Chính Hãng",345000,345000,0,0
TIKI,thiet-bi-kts-phu-kien-so,152859531,"Loa vi tính SoundMax A-2140 (có Bluetooth)- Hàng chính hãng",1699000,1699000,0,0
TIKI,thiet-bi-kts-phu-kien-so,3265743,"Tai Nghe Nhét Tai Elecom EHP-CN300ABU1",169150,169150,0,0
TIKI,thiet-bi-kts-phu-kien-so,17599227,"Ốp lưng chống sốc cho Sony Xperia XZ2 hiệu Likgus (chuẩn quân đội, chống va đập, chống vân tay) - Hàng chính hãng",76000,76000,0,0
TIKI,thiet-bi-kts-phu-kien-so,198099038,"Cáp âm thanh Optical for Audio Cable dây nhựa PVC Vention BAEBG  - Hàng chính hãng",90000,90000,0,0
TIKI,thiet-bi-kts-phu-kien-so,80992519,"Miếng Dán Cường Lực ZEELOT Chống Vân Tay (Có Lưới Loa) cho iPhone 12 Pro Max / 12 Pro / 12 / 12 Mini Hàng Chính Hãng",390000,390000,0,0
TIKI,thiet-bi-kts-phu-kien-so,184783393,"Kính Cường Lực Full Màn 9D Cho Samsung Galaxy A53 5G Tấm Dán Màn Hình Chính Hãng Glass Độ Cứng 9H - Hàng Chính Hãng",50000,50000,0,0
TIKI,thiet-bi-kts-phu-kien-so,163919783,"Ốp lưng chống sốc trong suốt siêu mỏng 1mm cho iPhone 13 Pro Max hiệu Memumi Glitter (độ trong tuyệt đối, chống trầy xước, chống ố vàng, tản nhiệt tốt) - hàng nhập khẩu",99000,99000,0,0
TIKI,thiet-bi-kts-phu-kien-so,23476161,"Bộ Vệ Sinh Máy Tính King Master (6 Món) - Hàng Chính Hãng",42000,43000,1000,2
TIKI,thiet-bi-kts-phu-kien-so,149568916,"Miếng dán kính cường lực độ cứng 9H cho iPhone 13 Pro Max hiệu Nillkin Amazing H (độ trong HD, mỏng 0.33mm) - Hàng chính hãng",129000,129000,0,0
TIKI,thiet-bi-kts-phu-kien-so,33762361,"Miếng Dán Kính Cường Lực Cho Iphone 11 Pro - Màu Đen - Full Màn Hình - Hàng Chính Hãng",69998,139996,69998,50
TIKI,thiet-bi-kts-phu-kien-so,84226839,"Ốp lưng dành cho Vsmart Joy 3 mẫu Chép Đỏ",45000,55000,10000,18
TIKI,thiet-bi-kts-phu-kien-so,24891334,"Ốp in cho iPhone 8 Hít Nhạc - Hàng chính hãng",41000,55000,14000,25
TIKI,thiet-bi-kts-phu-kien-so,74743146,"Transhine DC-03 - Cáp Tín Hiệu Cho Transmitter, Kết Nối Máy Quay XLR - 3.5mm, Dài 0.3m",154000,154000,0,0
TIKI,thiet-bi-kts-phu-kien-so,153835740,"Bao da dành cho iPad Pro 12.9 inch 2018 ESR Rebound Pencil Slim Smart Case (Có khe cắm bút Apple Pencil) - Hàng Nhập Khẩu",650000,650000,0,0
TIKI,thiet-bi-kts-phu-kien-so,167615733,"Tai nghe Bluetooth WEKOME (TWS) kích thước nhỏ gọn, kết nối ổn định không dây nâng cấp 5.1 Hàng nhập khẩu",150000,150000,0,0
TIKI,thiet-bi-kts-phu-kien-so,12513355,"Ốp lưng silicon chống sốc cho iPhone X / Xs hiệu Likgus Crashproof giúp chống chịu mọi va đập  - Hàng chính hãng",80746,150000,69254,46
TIKI,thiet-bi-kts-phu-kien-so,195443817,"Bao da cho Samsung Galaxy Tab A8 10.5 inch 2022 X200 X205 chính hãng Dux Ducis Domo - Hàng chính hãng",251424,279360,27936,10
TIKI,thiet-bi-kts-phu-kien-so,184784802,"Kính Cường Lực Full Màn 9D Cho Samsung Galaxy A13 4G, Galaxy A13 5G Tấm Dán Màn Hình Chính Hãng Glass Độ Cứng 9H - Hàng Chính Hãng",39998,50999,11001,22
TIKI,thiet-bi-kts-phu-kien-so,125650528,"Ốp lưng dành cho iPhone Xs Max Likgus trong suốt - Hàng chính hãng",79999,119000,39001,33
TIKI,thiet-bi-kts-phu-kien-so,20272019,"Cáp Sạc Nhanh Micro USB Cho Smartphone Android 2.4A Baseus Cafule - Hàng chính Hãng",59900,59900,0,0
TIKI,thiet-bi-kts-phu-kien-so,194130340,"Bộ 2 Miếng Dán Màn Hình 3D GOR Cho Đồng Hồ Xiaomi Mi band 6, Mi band 7, Xiaomi Smart Band 7 Pro - Hàng Chính Hãng",98000,98000,0,0
TIKI,thiet-bi-kts-phu-kien-so,184573110,"Ốp Lưng Dành Cho Samsung Galaxy A23 4G  Chính Hãng Nillkin Dạng Sần, Chống Bám Vân Tay - Hàng Chính Hãng",105000,105000,0,0
TIKI,thiet-bi-kts-phu-kien-so,75550841,"Loa Phóng Đại Âm Thanh - KhoNCC Hàng Chính Hãng – Loại Megaphone Tạo Âm Lớn Phù Hợp Cho Cổ Vũ, Truyền Thông, Bán Rong - KDHS-5792-LoaCT (Màu ngẫu nhiên)",176000,185000,9000,5
TIKI,thiet-bi-kts-phu-kien-so,192158487,"Dán cường lực GOR cho Đồng Hồ Xiaomi Watch S1 - Hàng Nhập Khẩu",139000,139000,0,0
TIKI,thiet-bi-kts-phu-kien-so,186169130,"Ốp lưng dành cho Realme C35 - Realme Narzo 50A Prime mẫu Cậu Bé Lội Suối",42000,55000,13000,24
TIKI,thiet-bi-kts-phu-kien-so,52200439,"Ốp lưng in cho Samsung A70 Mẫu Bước Chân An Lạc",42000,55000,13000,24
TIKI,thiet-bi-kts-phu-kien-so,88950158,"Dán cường lực Samsung Galaxy A52/A72 5G Nillkin CP+ Pro Full keo màn hình - Hàng Nhập Khẩu",149000,149000,0,0
TIKI,thiet-bi-kts-phu-kien-so,68257835,"DÁN DA GOOGLE PIXEL 4A - CHÍNH HÃNG KHACTEN.COM",200000,200000,0,0
TIKI,thiet-bi-kts-phu-kien-so,83333738,"USB thu Bluetooth 4.0 Ugreen 30443 - Hàng chính hãng",180000,180000,0,0
TIKI,thiet-bi-kts-phu-kien-so,19364721,"Cáp HDMI Choseal 2.0/4K chính hãng Cao Cấp ,Loại Dẹt 3m",80500,104650,24150,23
TIKI,thiet-bi-kts-phu-kien-so,52151883," Miếng dán màn hình kính cường lực cho iPad Pro 11 inch 2020 / iPad Pro 11 inch 2018  hiệu Nillkin Amazing H+ Pro (mỏng 0.2 mm, vát cạnh 2.5D, chống trầy, chống va đập) - Hàng chính hãng",202999,350000,147001,42
TIKI,thiet-bi-kts-phu-kien-so,171745,"Chuột Không Dây Forter V181",44400,44400,0,0
TIKI,thiet-bi-kts-phu-kien-so,56975743,"Ốp lưng dành cho Xiaomi Mi 8 Lite mẫu Tay Phật",45000,55000,10000,18
TIKI,thiet-bi-kts-phu-kien-so,19878983,"Ốp kính cường lực cho iPhone 6s Plus hoa 26 - Hàng chính hãng",35000,55000,20000,36
TIKI,thiet-bi-kts-phu-kien-so,20448665,"Ốp lưng kính cường lực cho iPhone XR HOA SEN 8 - Hàng chính hãng",35000,55000,20000,36
TIKI,thiet-bi-kts-phu-kien-so,72934998,"Ốp lưng dành cho Iphone 12 mẫu Gaming Mắt Hồng Xanh",42000,55000,13000,24
TIKI,thiet-bi-kts-phu-kien-so,35354732,"Ốp lưng dẻo cao cấp dành cho iPhone 6 / iPhone 6s - Màu đen mờ",29000,49000,20000,41
TIKI,thiet-bi-kts-phu-kien-so,80886760,"Ốp lưng dành cho Nokia 5.3 Likgus armor chống sốc - Hàng chính hãng",65000,65000,0,0
TIKI,thiet-bi-kts-phu-kien-so,45485247,"Cáp sạc 3 đầu Baseus Three Primary Colors 3-in-1 Cable USB For M+L+T 3.5A",134499,134499,0,0
TIKI,thiet-bi-kts-phu-kien-so,113673928,"Webcam Rapoo C270L FullHD 1080p - Hàng Chính Hãng",750000,750000,0,0
TIKI,thiet-bi-kts-phu-kien-so,24782424,"Bao da dành cho Máy Tính Bảng Samsung Galaxy Tab A8 8" T295 (2019) dòng Stand Case- Hàng nhập khẩu",99000,99000,0,0
TIKI,thiet-bi-kts-phu-kien-so,21399082,"Ốp lưng cho Samsung Galaxy A30 mẫu RỒNG VÀNG 1 - Hàng chính hãng",35000,55000,20000,36
TIKI,thiet-bi-kts-phu-kien-so,24887444,"Ốp kính cho iPhone X ĐOG 1 - Hàng chính hãng",35000,55000,20000,36
TIKI,thiet-bi-kts-phu-kien-so,35977135,"Bộ sạc nhanh 30W 2 cổng Usb  Qc3.0 + Qc3.0 36W Usb Charger Quick Charge màu trắng UGREEN 40715CD161 Hàng chính hãng",452000,452000,0,0
TIKI,thiet-bi-kts-phu-kien-so,51723505,"Ốp lưng in cho Oppo A83 Mẫu Mẫu Đơn Hồng Đen",21000,22000,1000,5
TIKI,thiet-bi-kts-phu-kien-so,71693488,"Kính cường lực Kingkong chống nhìn trộm iPhone 12 series - Hàng chính hãng",48999,97998,48999,50
TIKI,thiet-bi-kts-phu-kien-so,23103832,"Ốp in cho Samsung Galaxy Note 9 Rồng Xanh - Hàng chính hãng",40000,55000,15000,27
TIKI,thiet-bi-kts-phu-kien-so,88776856,"Ốp lưng dành cho Vsmart Joy 3 mẫu Công Lược",35000,55000,20000,36
TIKI,thiet-bi-kts-phu-kien-so,5762489,"Dây Cáp Micro USB (A-microB) Sạc Nhanh 2.A Elecom MPA-AMBC2U02 (0.2m)",99000,99000,0,0
TIKI,thiet-bi-kts-phu-kien-so,195480728,"Miếng dán kính cường lực Cho iPhone 13 / 13 Pro / 13 Pro Max full màn hình 2.5D chống nứt vỡ cạnh  hiệu WIWU iVista Chống va đập, vát cạnh 2.5D, chống vân tay - hàng nhập khẩu",149000,149000,0,0
TIKI,thiet-bi-kts-phu-kien-so,20065946,"Ốp lưng cho Samsung Galaxy A50  Mặt Trăng Nghe Nhạc - Hàng chính hãng",42000,55000,13000,24
TIKI,thiet-bi-kts-phu-kien-so,73311360,"Bộ 2 Kính Cường Lực GOR cho Xiaomi Mi 10T, 10T Pro, 10T lite ( 2 Miếng full box ) _ Hàng Nhập Khẩu",98887,98887,0,0
TIKI,thiet-bi-kts-phu-kien-so,197415773,"Tai nghe Headphones DJ Hercules HDP DJ45- Hàng Chính Hãng",999100,1030000,30900,3
TIKI,thiet-bi-kts-phu-kien-so,10142449,"Miếng Dán Mặt Kính Cường Lực Microsoft Surface đủ dòng",220000,220000,0,0
TIKI,thiet-bi-kts-phu-kien-so,82383758,"Kính cường lực full màn hình Hoco G5 cho iPhone",49998,85000,35002,41
TIKI,thiet-bi-kts-phu-kien-so,105235727,"Ốp lưng dành cho Samsung Galaxy A32 - A52 - A72 - mẫu Vòng Tròn Xanh Đỏ",40000,55000,15000,27
TIKI,thiet-bi-kts-phu-kien-so,23104311,"Ốp in cho Samsung Galaxy Note 9 Đá Xanh Ngọc - Hàng chính hãng",40000,55000,15000,27
TIKI,thiet-bi-kts-phu-kien-so,127114118,"Tấm lót chuột Razer Firefly V2-Hard Mat-Chroma_RZ02-03020100-R3M1- HÀNG CHÍNH HÃNG",1290000,1290000,0,0
TIKI,thiet-bi-kts-phu-kien-so,77665426,"TC Electronic Ditto X2 Looper Guitar Effects Pedal -Hàng Chính Hãng",4520200,4660000,139800,3
TIKI,thiet-bi-kts-phu-kien-so,87003645,"Dây cáp USB cho máy quét Datalogic QW2100 Hàng nhập khẩu",300000,300000,0,0
TIKI,thiet-bi-kts-phu-kien-so,72289246,"Bàn phím cơ Gaming DAREU EK1280s PINK-WHITE 104KEY (PINK LED, Blue D switch) - Hàng Chính Hãng",749000,749000,0,0
TIKI,thiet-bi-kts-phu-kien-so,138940446,"Ốp lưng dành cho Iphone 13 Mini - Iphone 13 - Iphone 13 Pro -  Iphone 13 Pro Max - LOVE",41000,55000,14000,25
TIKI,thiet-bi-kts-phu-kien-so,21396868,"Ốp kính cường lực cho iPhone XS MAX mẫu MÈO ĐEN 1 - Hàng chính hãng",35000,55000,20000,36
TIKI,thiet-bi-kts-phu-kien-so,2066619,"Cáp Chuyển Đổi Ugreen USB 3.0 Sang RJ45 20255 (Đen) - Hàng Chính Hãng",289000,307000,18000,6
TIKI,thiet-bi-kts-phu-kien-so,84225645,"Ốp lưng dành cho Samsung A11 mẫu Bướm Vàng Giả Da",45000,55000,10000,18
TIKI,thiet-bi-kts-phu-kien-so,137458361,"Cáp Chuyển Đổi Ugreen HDMI Sang DVI Sợi Tròn 11150 2m - Hàng Chính Hãng",135000,135000,0,0
TIKI,thiet-bi-kts-phu-kien-so,150377233,"Bao Case Ốp Bảo Vệ Có Khóa Dành Cho Tai Nghe Airpods 3 Chống Sốc Kai Lolifo Transformers Kèm Móc Treo_ Hàng Chính Hãng",80000,80000,0,0
TIKI,thiet-bi-kts-phu-kien-so,30738343,"Ốp Lưng Chống Sốc Kiểu Dáng Thể Thao Xundd Dành cho",79000,79000,0,0
TIKI,thiet-bi-kts-phu-kien-so,84546768,"Ốp lưng dành cho Xiaomi Redmi 9 mẫu Rồng Trăng",40000,55000,15000,27
TIKI,thiet-bi-kts-phu-kien-so,149153821,"Tai nghe chụp tai không dây Logitech G733 Lightspeed RGB - Hàng chính hãng",3090000,3990000,900000,23
TIKI,thiet-bi-kts-phu-kien-so,105664304,"Ốp lưng dành cho Oppo A54 - A74 - A94 - mẫu Ngắm Biển",40000,55000,15000,27
TIKI,thiet-bi-kts-phu-kien-so,52177182,"Ốp lưng điện thoại VSMART LIVE viền silicon dẻo TPU  hình Phong Cách Độc Lạ Mẫu 4",69000,69000,0,0
TIKI,thiet-bi-kts-phu-kien-so,1819223,"Cáp Mini DisplayPort 2 Đầu Ugreen 2m (10429) - Hàng Chính Hãng",139000,139000,0,0
TIKI,thiet-bi-kts-phu-kien-so,59256259,"Ốp lưng dẻo silicon cho Samsung Galaxy S10e hiệu Ultra Thin (siêu mỏng 0.6mm, chống trầy, chống bụi) - Hàng nhập khẩu",39000,39000,0,0
TIKI,thiet-bi-kts-phu-kien-so,125571781,"Ốp lưng dẻo Silicone Samsung Galaxy S21+ 5G EF-PG996 - Hàng chính hãng",439000,550000,111000,20
TIKI,thiet-bi-kts-phu-kien-so,72750905,"Micro Cho Điện Thoại, Máy Tính Bảng Apple, Chuẩn MFi, Giắc Cắm Lightning Saramonic Smartmic Di Mini - hàng chính hãng",980000,980000,0,0
TIKI,thiet-bi-kts-phu-kien-so,418581,"Tai nghe có dây Logitech H540 - Hàng chính hãng",779000,779000,0,0
TIKI,thiet-bi-kts-phu-kien-so,135613419,"Cáp MicroUSB 3.0 Ugreen 10840 ,10841 , 10842, 10843,10365 - Hàng Chính Hãng",84000,84000,0,0
TIKI,thiet-bi-kts-phu-kien-so,84792666,"Ốp lưng chống sốc dành cho Samsung A52 hàng chính hãng Rugged Shield cao cấp",60000,60000,0,0
TIKI,thiet-bi-kts-phu-kien-so,50195098,"Popsocket in hình dành cho điện thoại Mẫu Heo Tho",34000,35000,1000,3
TIKI,thiet-bi-kts-phu-kien-so,84222896,"Ốp lưng dành cho Xiaomi Redmi 9 mẫu Hoa Lan Xanh Trắng",42000,55000,13000,24
TIKI,thiet-bi-kts-phu-kien-so,173846861,"Ốp lưng trong suốt viền đen dành cho iPhone 13 Pro Max có chân đế Ugreen 90149 6.7 inch  LP490 hàng chính hãng",271000,271000,0,0
TIKI,thiet-bi-kts-phu-kien-so,76203159,"Ốp lưng cho SamSung Galaxy Nte 20/ Note 20 Ultra chính hãng SULADA dạng da mềm",75000,75000,0,0
TIKI,thiet-bi-kts-phu-kien-so,179565066,"Bao da khay dẻo dành cho Samsung Tab A8 2022 10.5inch(X200/X205C) hiệu Lishen( Hàng chính hãng)",149000,149000,0,0
TIKI,thiet-bi-kts-phu-kien-so,133941211,"Ốp lưng cho iPhone 13 Pro Max hiệu Memumi PP Ultra-thin Slim mỏng nhám - Hàng nhập khẩu",81000,177998,96998,54
TIKI,thiet-bi-kts-phu-kien-so,170336951,"Đế tản nhiệt chính hãng HXSJ dành cho Macbook, Laptop - Hàng nhập khẩu",249000,399000,150000,38
TIKI,thiet-bi-kts-phu-kien-so,217439540,"Bàn phím cơ không dây bluetooth | USB Logitech POP KEYS - với 8 phím emoji có thể điều chỉnh, switch tactile, kết nối 3 thiết bị - Hàng chính hãng",2190000,2199000,9000,0
TIKI,thiet-bi-kts-phu-kien-so,75617687,"Bộ dung dịch vệ sinh dành cho Macbook JCPal Cleaning Solution",125000,175275,50275,29
TIKI,thiet-bi-kts-phu-kien-so,84878780,"Tay cầm không dây Dualsense Ps5 -Hàng Nhập Khẩu",1550000,1550000,0,0
TIKI,thiet-bi-kts-phu-kien-so,165585662,"Tai Nghe Điện Thoại OPPO MH151 Cổng 3.5mm | Công Nghệ Hi-Res | Âm Thanh 3D | Hàng Chính Hãng",359000,590000,231000,39
TIKI,thiet-bi-kts-phu-kien-so,164266659,"Tai nghe bluetooth không dây nhét tai True Wireless thể thao pin trâu kết nối nhanh, ổn định kèm mic hỗ trợ đàm thoại, chống ồn tốt tương thích với điện thoại, laptop, máy tính 5Tech hàng chính hãng",68000,94900,26900,28
TIKI,thiet-bi-kts-phu-kien-so,130387252,"Đồng hồ Thông minh Đinh vị Kép Chống nước Dành cho Trẻ em 5 tuổi, 6 tuổi, 7 tuổi, 8 tuổi, 9 tuổi, 10 tuổi, 11 tuổi AMA Watch Q13 Hàng nhập khẩu",1071000,1071000,0,0
TIKI,thiet-bi-kts-phu-kien-so,8209696,"Tai Nghe nhét tai cao cấp Baseus H06 - Hàng chính hãng",154499,154499,0,0
TIKI,thiet-bi-kts-phu-kien-so,90525220,"Đồng Hồ Thông Minh AMA Watch S2 | Nam Nữ | Chống nước | Kết nối Bluetooth gọi Điện thoại Theo dõi Sức khỏe Vận động Màn hình cong tràn viền Hàng nhập khẩu",1219500,1355000,135500,10
TIKI,thiet-bi-kts-phu-kien-so,135229347,"Adapter sạc nhanh BOOST↑CHARGE Belkin 40W - 2 cổng USB-C PD 20W - Hàng chính hãng",495000,690000,195000,28
TIKI,thiet-bi-kts-phu-kien-so,74985442,"Loa Bluetooth Không Dây 60W Super Bass Công Suất Lớn bluetooth 5.0 TWS Âm thanh vòm ngoài trời, Loa Nghe Nhạc - Hàng Chính Hãng PKCB",1295000,2590000,1295000,50
TIKI,thiet-bi-kts-phu-kien-so,168226110,"Tai nghe chụp tai Bluetooth Havit i62 BT 5.0 HVBT-I62 - Hàng chính hãng",390000,590000,200000,34
TIKI,thiet-bi-kts-phu-kien-so,6907827,"Cáp máy in sử dụng cho thiết bị hỗ trợ cổng USB Type C dài 1.5m UGREEN US241 40417 - Hàng Chính Hãng",115000,115000,0,0
TIKI,thiet-bi-kts-phu-kien-so,146925608,"Kẹp Dán Cố Định Dây Cáp KitAcoom, Đế Kẹp Dây Sạc Điện Thoại, Dây Tai Nghe, Cáp Chuột Máy Tính - Hàng Chính Hãng",55799,59999,4200,7
TIKI,thiet-bi-kts-phu-kien-so,87212382,"Dây Cáp Sạc Điện Thoại USB to USB Type C 30W Dài 0.5M Đến 2M CHOETECH AC0001/AC0002/AC0003 - Hàng Chính Hãng",49000,150000,101000,67
TIKI,thiet-bi-kts-phu-kien-so,75082841,"Giá Đỡ Laptop Hợp Kim Nhôm Cao Cấp Có Thể Gấp Gọn - Đế Tản Nhiệt Laptop - Macbook, Máy Tính Xách Tay - 07 Vị Trí Điều Chỉnh Góc Độ - Hàng Chính Hãng - VinBuy",78000,78000,0,0
TIKI,thiet-bi-kts-phu-kien-so,75759526,"Tai nghe bluetooth không dây Nhét Tai, Tai nghe hiển thị kỹ thuật số 5.0 Ngăn sạc 1200mAh để sạc điện thoại di động - Hàng Chính Hãng PKCB PF267",250000,500000,250000,50
TIKI,thiet-bi-kts-phu-kien-so,162087109,"Hub Type-C to HDMI 6 in 1 cho Macbook có sạc nhanh - Chuyển đổi HUB USB Type C to HDMI, VGA, USB 3.0, PD Type-C Vention - Hàng chính hãng",449000,449000,0,0
TIKI,thiet-bi-kts-phu-kien-so,174588230,"Củ Sạc Nhanh OPPO 18W OP92CAUH | Đầu ra USB: 9V - 2A | Hỗ Trợ Sạc Nhanh | Hàng Chính Hãng OPPO",310000,490000,180000,37
TIKI,thiet-bi-kts-phu-kien-so,153020569,"Củ Sạc Nhanh Đa Năng 5in1 Remax RP-U66 - 4 Cổng USB + 1 Cổng TypeC 20W(Max) - Tổng Công Suất Lên Đến 35.5W - Hàng Chính Hãng",295000,295000,0,0
TIKI,thiet-bi-kts-phu-kien-so,7555917,"Bao Da Smart Case Gen2 TPU Dành Cho iPad Air / Air 2 / Pro 9.7inch / The New 2017 / 9.7 2018",120000,255998,135998,53
TIKI,thiet-bi-kts-phu-kien-so,55162604,"Bao Da Dành Cho Máy Đọc Sách Kindle Paperwhite Gen 4 10th Hàng Chính Hãng Helios",39000,39000,0,0
TIKI,thiet-bi-kts-phu-kien-so,157419647,"Hub chuyển đa năng Baseus 6-in-1 Metal Gleam Series Multifunctional Docking Station - Hàng Chính Hãng",618499,618499,0,0
TIKI,thiet-bi-kts-phu-kien-so,8273645,"Cáp sạc nhanh MicroUSB 2.4A UGREEN US290",45000,52000,7000,13
TIKI,thiet-bi-kts-phu-kien-so,136820031,"Sạc dự phòng không dây Mophie Snap+ Powerstation Stand 10,000mAh - Hàng chính hãng",1650000,1650000,0,0
TIKI,thiet-bi-kts-phu-kien-so,142431114,"Cáp sạc nhanh USB Type C - C BOOST↑CHARGE Belkin 60W vỏ dù 1M - Hàng chính hãng",290000,412000,122000,30
TIKI,thiet-bi-kts-phu-kien-so,113125415,"TAI NGHE SENNHEISER CX TRUE WIRELESS - HÀNG CHÍNH HÃNG",2564050,2564050,0,0
TIKI,thiet-bi-kts-phu-kien-so,75318981,"Cáp USB-C to Lightning BOOST↑CHARGE Belkin vỏ dù, chứng chỉ MFi, sạc nhanh 30W, 1m & 2m - Hàng Chính Hãng CAA004bt",425000,650000,225000,35
TIKI,thiet-bi-kts-phu-kien-so,79445601,"Ốp Lưng Silicon cho Samsung Galaxy S20 FE TPU trong suốt GOR - Hàng Nhập Khẩu",39000,39000,0,0
TIKI,thiet-bi-kts-phu-kien-so,176898787,"Chuột không dây Bluetooth Logitech Signature M650 L - Hàng Chính Hãng",793000,793000,0,0
TIKI,thiet-bi-kts-phu-kien-so,125802463,"Tại nghe Bluetooth không dây 2021 Model L2 thời trang Thương hiệu AMA Hàng nhập khẩu",277001,277001,0,0
TIKI,thiet-bi-kts-phu-kien-so,108179037,"Bàn phím cơ VSP eSport  HN Gaming VM01 - Hàng nhập khẩu",369000,384700,15700,4
TIKI,thiet-bi-kts-phu-kien-so,91190049,"Cáp mạng Cat6 aluminum dạng dẹt/tròn UGREEN NW102 - Hàng chính hãng",26000,30000,4000,13
TIKI,thiet-bi-kts-phu-kien-so,16980141,"Đầu đọc thẻ nhớ SD, TF chân Type C, USB 3.0 Ugreen 50706 - Hàng chính hãng",221000,240000,19000,8
TIKI,thiet-bi-kts-phu-kien-so,138076777,"Ốp Lưng Cường Lực Viền Trong Suốt Cao Cấp Dùng Cho iPhone 13 / iPhone 13 Pro / iPhone 13 Pro Max - Bảo Vệ Full Camera - Hàng Chính Hãng CAFELE",199998,274987,74989,27
TIKI,thiet-bi-kts-phu-kien-so,161951824,"Kính Cường Lực Gor cho Samsung Galaxy S22/ Galaxy S22 Plus Full Màn, Viền Đen Cao Cấp, Hãng Gor (Fullbox) - Hàng nhập khẩu",109000,109000,0,0
TIKI,thiet-bi-kts-phu-kien-so,7496499,"Radio Sony ICF-P26 (Hàng nhập khẩu)",850000,850000,0,0
TIKI,thiet-bi-kts-phu-kien-so,97057382,"Pin Sạc Dự Phòng Hoco J72A Easy travel 20000mAh 2 cổng Input/Output max 2A - Hãng Phân Phối Chính Thức - HOCO-J72A",248000,248000,0,0
TIKI,thiet-bi-kts-phu-kien-so,188278246,"Vỏ Ốp TPU Trong suốt KAi Cho Đồng hồ Apple Watch 4/5/6/7- Hàng chính hãng",45000,45000,0,0
TIKI,thiet-bi-kts-phu-kien-so,162582680,"Ốp lưng silicon cho Samsung Galaxy S21 FE 5G dẻo Gor Bảo vệ camera  trong suốt Hàng nhập khẩu",20000,20000,0,0
TIKI,thiet-bi-kts-phu-kien-so,103511959,"Bàn Phím Cơ Máy Tính XSmart K2 Pro Màu Xanh Led RGB, Chuyên Game Blue Switch Có 10 Chế Độ Màu Siêu Đẹp - Hàng Chính Hãng",489000,489000,0,0
TIKI,thiet-bi-kts-phu-kien-so,94587960,"Máy trợ giảng Shidu SD-S92 (Hàng nhập khẩu)",1812000,1849000,37000,2
TIKI,thiet-bi-kts-phu-kien-so,178603898,"Máy trợ giảng không dây CV Rolton K500 Có Bluetooth, thời gian sử dụng lên đến 12 giờ, chơi nhạc qua Thẻ nhớ TF (Không quá 32 GB), ghi âm bằng 1 nút bấm - Hàng chính hãng",579000,579000,0,0
TIKI,thiet-bi-kts-phu-kien-so,172373074,"Loa Bluetooth PKCB Bản Mở Rộng, chip DSP, Hỗ Trợ Kết Nối Bluetooth, USB, Thẻ Nhớ, dây 3.5mm 100W TWS Âm Thanh Sống Động - Hàng chính hãng",2500000,5000000,2500000,50
TIKI,thiet-bi-kts-phu-kien-so,43891180,"Máy ghi âm Sony ICD-UX570F (Hàng nhập khẩu)",2590000,2590000,0,0
TIKI,thiet-bi-kts-phu-kien-so,190892422,"Cáp sạc USB Type C - C BOOST↑CHARGE PRO Flex Belkin vỏ silicone bọc dù 60W - Hàng chính hãng - CAB011bt",475000,679000,204000,30
TIKI,thiet-bi-kts-phu-kien-so,197628463,"Tai nghe chụp tai Bluetooth Havit H633BT - Hàng chính hãng",390000,590000,200000,34
TIKI,thiet-bi-kts-phu-kien-so,91190312,"Cáp chuyển đổi Mini DisplayPort sang HDMI female UGREEN MD112 18cm - Hàng chính hãng",129000,140000,11000,8
TIKI,thiet-bi-kts-phu-kien-so,139497670,"Ốp Lưng dành cho iPhone 13 / 13 Pro / 13 Pro Max ESR Metal Kickstand Phone Case - Hàng Nhập Khẩu",590000,590000,0,0
TIKI,thiet-bi-kts-phu-kien-so,15628631,"Ốp lưng chống sốc Ringke Fusion cho iPhone XS/X / iPhone XR / iPhone XS Max - Hàng chính hãng",229500,270000,40500,15
TIKI,thiet-bi-kts-phu-kien-so,57820362,"Loa Bluetooth mini TWS 5.0 PKCB không dây - Hàng Chính Hãng",127000,293000,166000,57
TIKI,thiet-bi-kts-phu-kien-so,26267834,"cáp âm thanh 3.5Mm nối dài 0.5M UGREEN Av118-40672 - hàng chính hãng",70000,70000,0,0
TIKI,thiet-bi-kts-phu-kien-so,57843899,"Loa trợ giảng Aporo T18 công suất 30W 2.4G Bluetooth 5.0 không dây ( hàng nhập khẩu )",998000,998000,0,0
TIKI,thiet-bi-kts-phu-kien-so,105880750,"(Hỗ Trợ Tiếng Việt) Máy Nghe Nhạc Lossless MP3 MP4 Bluetooth Màn Hình Cảm Ứng 4 inch Ruizu H9 Bộ Nhớ 16GB - Hàng Chính Hãng",978000,978000,0,0
TIKI,thiet-bi-kts-phu-kien-so,142457974,"Ốp lưng silicon dẻo cho Samsung Galaxy Note 20 Ultra hiệu Ultra Thin siêu mỏng 0.6mm bảo vệ Camera - Hàng nhập khẩu",39000,39000,0,0
TIKI,thiet-bi-kts-phu-kien-so,126808483,"Miếng Dán Cường Lực Chống Nhìn Trộm UNIQ OPTIX Privacy  cho iPhone 13 Pro Max / 13 Pro / 13 / 13 Mini_Hàng Chính Hãng",238000,307998,69998,23
TIKI,thiet-bi-kts-phu-kien-so,137956128,"Ốp Lưng Dẻo Gor Cho Xiaomi Mi 11 Lite, Mi 11 Lite 5G NE, Mi 11 Lite 5G Trong Suốt Có Gờ Bảo Vệ Camera - Hàng nhập khẩu",39000,39000,0,0
TIKI,thiet-bi-kts-phu-kien-so,72322834,"Ốp lưng Sony Xperia 5 hiệu Likgus chống sốc chuẩn quân đội, chống va đập, chống vân tay - Hàng nhập khẩu",87000,87000,0,0
TIKI,thiet-bi-kts-phu-kien-so,147980981,"Ốp Lưng Dẻo Trong Suốt Cho Xiaomi 11T, Xiaomi 11T Pro 5G Có Gờ Bảo Vệ Camera, Hãng Gor - Hàng nhập khẩu",40000,40000,0,0
TIKI,thiet-bi-kts-phu-kien-so,386464,"Chuột Không Dây Fuhlen A09G/A09B - Hàng Chính Hãng ",149000,149000,0,0
TIKI,thiet-bi-kts-phu-kien-so,135608173,"Bàn phím có dây Genius Smart KB-100 hàng chính hãng",149000,149000,0,0
TIKI,thiet-bi-kts-phu-kien-so,97056905,"Thẻ Nhớ 32GB YOOSEE-Chuyên Dụng Camera - Hàng chính hãng",70000,70000,0,0
TIKI,thiet-bi-kts-phu-kien-so,113030637,"Cáp sạc Type C to Type C Remax RC-010 - Hàng nhập khẩu",150000,150000,0,0
TIKI,thiet-bi-kts-phu-kien-so,115161210,"[HÀNG CHÍNH HÃNG] Dây quấn cáp Topk J02 chống rối tiện lợi - Phân phối bởi TOPK VIỆT NAM",1000,1000,0,0
TIKI,thiet-bi-kts-phu-kien-so,194483156,"Ốp lưng silicon case chống sốc cho iPhone XS Max chống bám bẩn siêu mỏng mịn hiệu HOTCASE vật liệu cao cấp, dễ lau chùi - hàng nhập khẩu",99000,99000,0,0
TIKI,thiet-bi-kts-phu-kien-so,28326201,"Pin Sạc AA Eneloop 2000 mah Made In Japan BK3MCCE/2B Chính Hãng ( Panasonic Phân Phối Trực TIếp Tại Việt Nam )",202000,210000,8000,4
TIKI,thiet-bi-kts-phu-kien-so,189473461,"Loa Bluetooth Gấu Bearick Siêu Hot - Âm Đỉnh, Màu Sắc Sang Chảnh - HÀNG CHÍNH HÃNG MINIIN - LOẠI 1",129000,129000,0,0
TIKI,thiet-bi-kts-phu-kien-so,5417729,"Ốp lưng dẻo dành cho iPhone XS MAX Ultra Thin (mỏng 0.3mm, Trong suốt) - Hàng chính hãng",34998,50000,15002,30
TIKI,thiet-bi-kts-phu-kien-so,17917941,"Tai nghe Moxpad X9 in-ear Monitor Bass HD - Hàng chính hãng",620000,620000,0,0
TIKI,thiet-bi-kts-phu-kien-so,31594543,"Máy trợ giảng không dây UHF 2.4G Aporo T20 ( hàng nhập khẩu )",799000,799000,0,0
TIKI,thiet-bi-kts-phu-kien-so,162237798,"ROGTZ Thiết Bị Thu Phát Nhạc Không Dây Bluetooth 5.0 Màn Hình LCD C39S - Hàng Nhập Khẩu",275000,295000,20000,7
TIKI,thiet-bi-kts-phu-kien-so,152492437,"Giá Đỡ Điện Thoại , Máy Tính Bảng Có Thể Gấp Gọn, Chống Trượt, Tùy Chỉnh Độ Cao - Hàng CHÍNH HÃNG - LOẠI 1",43000,43000,0,0
TIKI,thiet-bi-kts-phu-kien-so,127360210,"Ốp lưng lụa mỏng dành cho iPhone 13 bảo vệ camera, siêu mỏng 0.3 mm - Hàng Chính Hãng Memumi",89549,129000,39451,31
TIKI,thiet-bi-kts-phu-kien-so,115840623,"Giá Đỡ Điện Thoại Xe Hơi Ô Tô Cảm Ứng - Hỗ Trơ Sạc Thông Minh Không Dây Qi - Kẹp Cửa Thông Gió Hoặc Sử Dụng Đế Hít Tiện Lợi - Hàng Chính Hãng ",990000,1200000,210000,18
TIKI,thiet-bi-kts-phu-kien-so,47271214,"Ốp lưng dẻo mỏng dành cho iPhone 6 / iPhone 6s - Màu xanh dương đậm",45000,45000,0,0
TIKI,thiet-bi-kts-phu-kien-so,109773487,"Ốp lưng Google Pixel 4/ 4 XL Likgus Armor chống sốc - Hàng chính hãng",99000,99000,0,0
TIKI,thiet-bi-kts-phu-kien-so,66650870,"Bút Laser trình chiếu Baseus Orange Dot Wireless Presenter - Hàng chính hãng",198000,198000,0,0
TIKI,thiet-bi-kts-phu-kien-so,143959699,"Chuột không dây Genius NX-7000 - Hàng chính hãng",155000,190000,35000,18
TIKI,thiet-bi-kts-phu-kien-so,97057251,"Tai nghe Bluetooth Remax T9 (Đen),HÀNG CHÍNH HÃNG",129000,129000,0,0
TIKI,thiet-bi-kts-phu-kien-so,7405805,"Cốc sạc Hoco UH102 1A Chính hãng",29000,38900,9900,25
TIKI,thiet-bi-kts-phu-kien-so,87228357,"Củ Sạc Điện Thoại Ô Tô 40W, 2 Cổng Type-C PD 20W CHOETECH TC0008 V2 - Hàng Chính Hãng",199000,300000,101000,34
TIKI,thiet-bi-kts-phu-kien-so,168183454,"Cáp Sạc Micro-USB Hoco X38 Cho Android, Samsung, Xiaomi, Oppo,... 1 Mét, Dây Dù Siêu Bền - Hàng Chính Hãng",32000,35000,3000,9
TIKI,thiet-bi-kts-phu-kien-so,32848289,"Giá Đỡ Kẹp Điện Thoại Đa Năng PKCB SF126 ĐEN - Hàng Chính Hãng ",68000,207100,139100,67
TIKI,thiet-bi-kts-phu-kien-so,187827496,"Chuột không dây Asus - Hàng Chính hãng",1000000,1000000,0,0
TIKI,thiet-bi-kts-phu-kien-so,88068131,"Chuột Không Dây Wireless 2.4GHz ROBOT Chuyên Dùng Văn Phòng, Khoảng Cách Tín Hiệu 10m, Kèm Pin - Hàng Chính Hãng",98000,98000,0,0
TIKI,thiet-bi-kts-phu-kien-so,73540647,"Bao da bò thật dạng ví chính hãng Caseme dành cho iPhone 12, iPhone 12 Pro",120000,120000,0,0
TIKI,thiet-bi-kts-phu-kien-so,120760546,"Loa Tháp Samsung MX-T70/XV - HÀNG CHÍNH HÃNG",4240000,4240000,0,0
TIKI,thiet-bi-kts-phu-kien-so,59266028,"Loa soundbar TV Xiaomi Redmi hỗ trợ Bluetooth 5.0, S/PDIF, AUX - Hàng Nhập Khẩu",755000,783000,28000,4
TIKI,thiet-bi-kts-phu-kien-so,137694507,"Bàn phím bluetooth không dây XSmart 308i cho điện thoại, máy tính bảng, laptop, pc máy tính bàn siêu CUTE, phím cực thích - Hàng Chính Hãng",599000,599000,0,0
TIKI,thiet-bi-kts-phu-kien-so,58947556,"Loa Thanh Soundbar LG SNH5 - Hàng Chính Hãng",2499000,2680000,181000,7
TIKI,thiet-bi-kts-phu-kien-so,47271217,"Pin dự phòng sạc nhanh Baseus Adaman QC 3.0 22.5W 20000mAh - Hàng chính hãng",499500,499500,0,0
TIKI,thiet-bi-kts-phu-kien-so,79239706,"Vòng Đeo Tay Thông Minh M5 Chống Nước Kết Nối Bluetooth Theo Dõi Sức Khỏe Kèm Phụ Kiện- Hàng Chính Hãng",135000,135000,0,0
TIKI,thiet-bi-kts-phu-kien-so,3606453,"Pin sạc dự phòng Arun 5600 mAh - chính hãng(trắng)",55000,55000,0,0
TIKI,thiet-bi-kts-phu-kien-so,109961411,"Dây Đeo Cao Su Miband 3, Miband 4 Dây Đeo Thay Thế Cho Đồng Hồ - Hàng Chính Hãng PKCB",25000,80000,55000,69
TIKI,thiet-bi-kts-phu-kien-so,45798744,"Hub USB Type-C Chia Đa Cổng USB-A/ USB-C/HDMI 4K/LAN/SD card Belkin F4U092btSGY - Hàng Chính Hãng",1890000,2699000,809000,30
TIKI,thiet-bi-kts-phu-kien-so,91189983,"Cáp chuyển USB TYPE C sang HDMI UGREEN 70444 - Hàng chính hãng",414000,450000,36000,8
TIKI,thiet-bi-kts-phu-kien-so,196282900,"Bàn phím không dây có kê tay Logitech K650 - Bluetooth/2.4Ghz - Hàng chính hãng",979000,979000,0,0
TIKI,thiet-bi-kts-phu-kien-so,108945894,"ĐẾ SẠC ĐÔI KHÔNG DÂY SAMSUNG P5400 ĐEN - HÀNG CHÍNH HÃNG ( Gồm 1 đế sạc đôi, 01 bộ sạc cáp 25w )",790000,790000,0,0
TIKI,thiet-bi-kts-phu-kien-so,4040483,"Loa Bluetooth Bose SoundLink Micro - Hàng Chính Hãng",2490000,3590000,1100000,31
TIKI,thiet-bi-kts-phu-kien-so,109661809,"Đồng hồ thông minh Garmin Forerunner 55, GPS, KOR/SEA - Hàng chính hãng",5290000,5290000,0,0
TIKI,thiet-bi-kts-phu-kien-so,101846835,"Cốc Sạc Nhanh AUKEY PA-B1 Pro Cổng Type C Power Delivery 20W - Hàng Chính Hãng",182000,182000,0,0
TIKI,thiet-bi-kts-phu-kien-so,5984995,"Dây nối dài USB 3.0 mạ vàng dài 2M UGREEN US115 10373 (đen) - Hàng Chính Hãng",109000,115000,6000,5
TIKI,thiet-bi-kts-phu-kien-so,2067293,"Gậy Chụp Hình Đa Năng Kèm Chân Yunteng YT-9928 - Hàng Nhập Khẩu",239000,350000,111000,32
TIKI,thiet-bi-kts-phu-kien-so,15725114,"Ốp lưng nhám siêu mỏng 0.3mm cho iPhone XS Max hiệu Memumi có gờ bảo vệ camera (đen) - Hàng chính hãng",87433,87433,0,0
TIKI,thiet-bi-kts-phu-kien-so,124706345,"Bộ Sạc Không Dây Mag.Safe Nam Châm Hít 15W RAVPower RP-WC012-WC-B Kèm Củ Sạc Type-C 20W Dành Cho iPhone 14, Cho iPhone 13, iPhone 12 - Hàng Chính Hãng",499000,1090000,591000,54
TIKI,thiet-bi-kts-phu-kien-so,130834713,"Kính Cường Lực Chống Nhìn Trộm Iphone 11 Promax Xsmax Xs X 6s Plus 7 8 Plus 12 Promax KINGKONG 4D Chính Hãng",43999,79000,35001,44
TIKI,thiet-bi-kts-phu-kien-so,71956828,"Combo RAVPower Củ Sạc Điện Thoại USB Type-C 61W RP-PC105 + Dây Cáp Sạc Type C to Type C RP-CB047 - Hàng Chính Hãng",549000,1050000,501000,48
TIKI,thiet-bi-kts-phu-kien-so,105303724,"Pin sạc dự phòng Xiaomi Power Bank 3 10,000mAh Ultra Compact - Hàng chính hãng",468000,468000,0,0
TIKI,thiet-bi-kts-phu-kien-so,146000272,"Combo Củ Sạc Nhanh Type-C PPS 25W RAVPower RP-PC156-B và Cáp Type-C To C 60W Dài 1M RP-CB047-B Dành Cho Điện Thoại Android, Cho Samsung, Cho Vivo, Cho Oppo, Cho Xiaomi Và Máy Tính Bảng - Hàng Chính Hãng",349000,690000,341000,49
TIKI,thiet-bi-kts-phu-kien-so,150805653,"Bộ sạc nhanh Baseus 65W GaN3 Pro Bộ sạc nhanh 4 trong 1 cho iPhone 13 Pro Max Samsung Power Station cho máy tính xách tay CCDK65S -Hàng Chính Hãng",669499,669499,0,0
TIKI,thiet-bi-kts-phu-kien-so,77662822,"Micro Bluetooth cao cấp PKCBK312 Chính Hãng",461000,1000000,539000,54
TIKI,thiet-bi-kts-phu-kien-so,53447698,"Trắng - Adapter củ cóc sạc nhanh 65W đa năng 1 cổng sạc USB và 2 PD Type-C hiệu Baseus Mini GaN Travel chuẩn sạc nhanh PD 3.0 & QC 4.0 - Hàng nhập khẩu",557000,599500,42500,7
TIKI,thiet-bi-kts-phu-kien-so,89703291,"Bàn Phím Cơ Máy Tính XSmart Crack K2 PRO Led RGB 10 Chế Độ Khác Nhau, Chơi Game Dùng Văn Phòng Cực Đã, Tương Thích Với Laptop, PC, Máy Tính, Kiểu Dáng Gaming",474000,474000,0,0
TIKI,thiet-bi-kts-phu-kien-so,64762415,"Combo dung dịch nano Hukey lau chùi vệ sinh 7 món cho màn hình, bàn phím cho máy tính, laptop, macbook  - Chính hãng",149000,149000,0,0
TIKI,thiet-bi-kts-phu-kien-so,93451533,"CHUỘT KHÔNG DÂY MITSUMI W5608 HÀNG CHÍNH HÃNG",131000,139000,8000,6
TIKI,thiet-bi-kts-phu-kien-so,162177103,"Bao Da Dành Cho iPad Pro 12.9 inch M1 2021/ Pro 12.9 inch M2 2022 ESR Rebound Pencil Case- Hàng Chính Hãng",758000,790000,32000,4
TIKI,thiet-bi-kts-phu-kien-so,1373911,"Chuột Chơi Game Có Dây Fuhlen G90 3500DPI LED 7 Phím",342000,342000,0,0
TIKI,thiet-bi-kts-phu-kien-so,189363615,"Lót chuột HXSJ kích thước 22x18 cm có đế cao su chống trượt cao cấp - Hàng chính hãng",9000,18000,9000,50
TIKI,thiet-bi-kts-phu-kien-so,108412416,"Túi đựng phụ kiện sạc dành cho macbook",97000,102000,5000,5
TIKI,thiet-bi-kts-phu-kien-so,36778572,"Bảng vẽ điện tử Xiaomi Mijia - Hàng nhập khẩu",265000,272350,7350,3
TIKI,thiet-bi-kts-phu-kien-so,59265067,"Bàn phím cơ không dây Logitech G913 TKL GL Clicky Key Switch Lightspeed Wireless - Hàng Chính Hãng",3999000,3999000,0,0
TIKI,thiet-bi-kts-phu-kien-so,2589863,"Ốp Lưng Dẻo Trong Suốt Ultra Thin Cho Samsung Galaxy J7 Pro - Hàng Chính Hãng",12000,12000,0,0
TIKI,thiet-bi-kts-phu-kien-so,96403483,"Loa bluetooth Divoom Ditoo Plus 10W - Hình dáng máy tính cổ, màn hình LED 256 Full RGB, tích hợp nhiều tính năng trên app Divoom - HÀNG CHÍNH HÃNG",1390000,2300000,910000,40
TIKI,thiet-bi-kts-phu-kien-so,73476789,"Micro HyperX SoloCast - Hàng Chính Hãng",1498000,1498000,0,0
TIKI,thiet-bi-kts-phu-kien-so,133258148,"DÁN DA DÀNH CHO SAMSUNG GALAXY Z FOLD 3 - CHÍNH HÃNG KHACTEN.COM",200000,200000,0,0
TIKI,thiet-bi-kts-phu-kien-so,70823216,"Miếng Dán Cường Lực Mipow Kingbull Premium HD (2.7D) iPhone 12 Mini / iPhone 12/ iPhone 12 Pro/ iPhone 12 ProMax",28000,279999,251999,90
TIKI,thiet-bi-kts-phu-kien-so,13822082,"Cáp USB 3.0 cho ổ cứng di động dài 50cm Vention VAS-A12 - Hàng Chính Hãng",86000,115000,29000,25
TIKI,thiet-bi-kts-phu-kien-so,73854753,"Adapter Cóc củ sạc type c sạc nhanh 20W chuẩn PD 3.0 Type-C hiệu Baseus Super Si trang bị chip sạc thông minh cho iPhone 12 / iPad Pro 2020 / Samsung / Oppo / Huawei / Vivo (phiên bản đầu cắm US-UK) - Hàng nhập khẩu",149899,149899,0,0
TIKI,thiet-bi-kts-phu-kien-so,176761115,"Bút trình chiếu Logitech Spotlight Presentation Remote - Hàng chính hãng",2090000,2090000,0,0
TIKI,thiet-bi-kts-phu-kien-so,109064318,"[Một Cặp, Bluetooth] Presonus E3.5 BT Loa Kiểm Âm Nghe Nhạc Eris Powered Studio Monitor Speaker E35 BT Pair Hàng Chính Hãng - Kèm Móng Gẩy DreamMaker",3799000,3799000,0,0
TIKI,thiet-bi-kts-phu-kien-so,32188898,"Bộ 3 miếng dán full màn hình Dành cho Samsung Galaxy Note 10,Note 10 Plus hiệu Gor (3 mặt trước)",85000,85000,0,0
TIKI,thiet-bi-kts-phu-kien-so,43393337,"Ốp lưng da kính cao cấp dành cho iPhone 11 Pro - Màu xanh - Hàng nhập khẩu - DELICATE",149000,150000,1000,1
TIKI,thiet-bi-kts-phu-kien-so,148679930,"ĐÀI FM KNSTAR-1030BT Chất Lượng Tốt  Am Fm Sw Đa Chức Năng Radio Với USB/Khe Cắm SD- Hàng chính hãng",250000,250000,0,0
TIKI,thiet-bi-kts-phu-kien-so,3920913,"SIM 4G Vinaphone D500 5GB/Tháng Trọn Gói 1 Năm Không Nạp Tiền - Hàng Chính Hãng - Mẫu ngẫu nhiên",419000,419000,0,0
TIKI,thiet-bi-kts-phu-kien-so,130021961,"Ốp lưng cho  Samsung dành cho Z Flip 4 - TRONG SUỐT - Clear cover - Hàng  chính hãng",429000,429000,0,0
TIKI,thiet-bi-kts-phu-kien-so,189374529,"SIM ĐẸP VIETTEL ĐẦU 09 - SIM TRẢ TRƯỚC - CHỌN SỐ - GIÁ 129.000 - HÀNG CHÍNH HÃNG",129000,129000,0,0
TIKI,thiet-bi-kts-phu-kien-so,110944430,"Loa bluetooth mini Remax RB-M53 - Hàng chính hãng",444000,660000,216000,33
TIKI,thiet-bi-kts-phu-kien-so,162060191,"Bao Da Dành Cho iPad Mini 6 ESR Ascend Trifold With Clasp - Hàng Chính Hãng",662000,690000,28000,4
TIKI,thiet-bi-kts-phu-kien-so,20327587," Dây Cáp Sạc 4 Trong 1 Input USB Type-C/USB-A và Output USB Type-C/Micro USB MiLi 1m - HX-L41",139000,250000,111000,44
TIKI,thiet-bi-kts-phu-kien-so,73279927,"Bao chống sốc GEAR4 Apollo dành cho Airpod Pro - Hàng chính hãng",89000,250000,161000,64
TIKI,thiet-bi-kts-phu-kien-so,124088830,"Bộ Sạc Hoco C72 Cho iPhone, iPad.,.. - Sạc Nhanh Tối Đa 2.1 A, Bảo Vệ Mạch Điện - Hàng Chính Hãng",52000,52000,0,0
TIKI,thiet-bi-kts-phu-kien-so,144399701,"Micro Bluetooth không dây Karaoke hút âm siêu nhẹ cao cấp PKCB cho điện thoại - Hàng Chính Hãng",317000,600000,283000,47
TIKI,thiet-bi-kts-phu-kien-so,2430659,"Máy Trợ Giảng Không Dây Shidu SD-S615 (UHF)",770000,770000,0,0
TIKI,thiet-bi-kts-phu-kien-so,74530820,"Giá Đỡ Kẹp Điện Thoại, Máy Tính Bảng Có Chân Kẹp Đầu Giường, Cạnh Bàn Hàng Xoay Chuyển – Điều Chỉnh Góc Độ Tùy Thích Hàng Chính Hãng",199000,199000,0,0
TIKI,thiet-bi-kts-phu-kien-so,101307127,"Case/ Ốp silicon kiểu bút chì cho Apple Pencil 2 Elago - Hàng Chính Hãng",285000,285000,0,0
TIKI,thiet-bi-kts-phu-kien-so,77743707,"Loa Bluetooth Speaker không dây PKCB - Hàng chính hãng",1107000,2300000,1193000,52
TIKI,thiet-bi-kts-phu-kien-so,167355376,"Loa Nghe Nhạc Bluetooth Công Suất 100W Dung Lượng Pin 10400mAh Kết nối Bluetooth, USB, Thẻ nhớ, Line in 3.5mm, Chíp DSP khuyếch đại âm thanh cao cấp, Kết nối đôi lên 200W Sạc nhanh Type C - Hàng Chính Hãng PKCB",2250000,4500000,2250000,50
TIKI,thiet-bi-kts-phu-kien-so,44938330,"Loa kéo di động Acnos KBeatBox CS450 - Hàng Chính Hãng",6100000,6100000,0,0
TIKI,thiet-bi-kts-phu-kien-so,51109135,"Bộ chuyển đổi 2 chiều HDMI 2 cổng (4k) Vention AFUH0 - Hàng chính hãng",289000,460000,171000,37
TIKI,thiet-bi-kts-phu-kien-so,37554539,"Máy Nghe Nhạc MP3 Bluetooth Ruizu X52 Bộ Nhớ Trong 8GB Cao Cấp AZONE - Hàng Chính Hãng",515000,515000,0,0
TIKI,thiet-bi-kts-phu-kien-so,79411238,"Ốp lưng chống sốc trong suốt siêu mỏng cho Samsung Galaxy Note 20 hiệu Likgus Crashproof giúp chống chịu mọi va đập - hàng nhập khẩu",87646,150000,62354,42
TIKI,thiet-bi-kts-phu-kien-so,124089281,"Bộ Hub Chia Cổng USB Hoco HB1 - Chia 1 Thành 4 Cổng USB Cho Macbook, Dell, Máy Tính Window, Linux,... Hàng Chính Hãng",99000,99000,0,0
TIKI,thiet-bi-kts-phu-kien-so,185990466,"Đài FM Radio Waxiba XB-895 REC MẪU MỚI Nhất  HỖ TRỢ THẺ NHỚ-USB-Đèn chiếu sáng -Hàng Chính Hãng",175000,175000,0,0
TIKI,thiet-bi-kts-phu-kien-so,8299504,"Sim 4G Vinaphone Vina 5GB/Tháng Trọn Gói 1 Năm Miễn Phí-Gói D500 - Hàng Chính Hãng - Mẫu ngẫu nhiên",419000,419000,0,0
TIKI,thiet-bi-kts-phu-kien-so,109088549,"Chuột Logitech G102 Lightsync Gen 2 Đèn Led RGB, Chỉnh Led Theo Ý Thích Bằng Phần Mềm, Phiên bản Mới Nhất 2021 - Hàng Chính Hãng",419000,419000,0,0
TIKI,thiet-bi-kts-phu-kien-so,176254187,"Ốp lưng dành cho iPhone 13 Pro Max/13 Pro/ 13 Tiger It Okay chống sốc bảo vệ camera _ Hàng Chính Hãng",82000,85000,3000,4
TIKI,thiet-bi-kts-phu-kien-so,194525191,"ĐÀI FM RADIO DC-82BT bluetooth MẪU MỚI Nhất CHO NGƯỜI CAO TUỔI-Hàng Chính Hãng",200000,200000,0,0
TIKI,thiet-bi-kts-phu-kien-so,76124894,"Kẹp cố định dây cáp, dây tai nghe, dây mạng, dây sạc... giúp gọn không gian 3 rãnh và 1 rãnh UGREEN 70585 - Hàng chính hãng",48000,48000,0,0
TIKI,thiet-bi-kts-phu-kien-so,47271498,"Ốp lưng dẻo mỏng dành cho iPhone 6 Plus / iPhone 6s Plus - Màu xanh dương đậm",45000,45000,0,0
TIKI,thiet-bi-kts-phu-kien-so,193898444,"Case TPU dành cho Airpods 1/2/3/ Pro Khủng Long Draw Kèm Khóa Treo- Hàng chính hãng",95000,99000,4000,4
TIKI,thiet-bi-kts-phu-kien-so,155701456,"ĐÀI FM WAXIBA XB-XB741C CÓ ĐỒNG HỒ , NGHE NHẠC USB THẺ NHỚ RADIO AM FM SW CÓ ĐÈN PIN THEO KÈM PIN SẠC – 741 HÀNG CHÍNH HÃNG",195000,195000,0,0
TIKI,thiet-bi-kts-phu-kien-so,190707596,"Ốp lưng silicon dẻo cho Samsung Galaxy A33 5G hiệu Ultra Thin mỏng 0.6mm độ trong tuyệt đối chống trầy xước - Hàng nhập khẩu",39000,39000,0,0
TIKI,thiet-bi-kts-phu-kien-so,108285972,"Bao da chống sốc cho iPad Pro 11 2021 Chip M1 / iPad Pro 11 2020 hiệu Nillkin Bumber có ngăn đựng bút chống va đập, mặt lưng show Logo táo, cơ chế smartsleep - hàng chính hãng",401978,700000,298022,43
TIKI,thiet-bi-kts-phu-kien-so,114906903,"Giá Đỡ Điện Thoại Xe Hơi Ô Tô Cảm Ứng Thông Minh - Hợp Kim Nhôm Tinh Xảo - Kẹp Cửa Thông Gió Hoặc Dùng Đế Hít Kèm Theo - Hàng Chính Hãng ",658000,689000,31000,4
TIKI,thiet-bi-kts-phu-kien-so,8432262,"Cáp sạc VOOC nhanh 4.0 cho các dòng điện thoại OPPO - Hàng Chính Hãng",89000,89000,0,0
TIKI,thiet-bi-kts-phu-kien-so,75614175,"Chuột máy tính có dây G5 ES, chuột gaming DPI 4 cấp độ, hiệu ứng đèn nền 7 màu- Hàng nhập khẩu",64000,64000,0,0
TIKI,thiet-bi-kts-phu-kien-so,2436229,"Máy Trợ Giảng Có Dây Shidu SD-S358 - Hàng Nhập Khẩu",380000,380000,0,0
TIKI,thiet-bi-kts-phu-kien-so,8281099,"Hộp nhựa ABS đựng ổ cắm điện / dây sạc điện thoại UGREEN LP110 30397 - Hàng Chính Hãng",230000,250000,20000,8
TIKI,thiet-bi-kts-phu-kien-so,166107670,"Thẻ nhớ Kioxia Micro SDHC Exceria UHS-I C10 U1 32/64/128GB - Hàng Chính Hãng",105000,150000,45000,30
TIKI,thiet-bi-kts-phu-kien-so,97057404,"Cóc Sạc Nhanh Hoco C85 20W PD + QC 3.0 Tiêu Chuẩn Châu Âu - Sạc Siêu Nhanh -Vật Liệu Chống Cháy(Trắng),HÀNG CHÍNH HÃNG",89000,89000,0,0
TIKI,thiet-bi-kts-phu-kien-so,173764867,"THẺ NHỚ MICRO ADATA 32GB/64GB/128GB/256GB UHS-I CLASS10 - Hàng Chính Hãng",87000,89000,2000,2
TIKI,thiet-bi-kts-phu-kien-so,249130038,"Chuột Không Dây Xiaomi Mi Dual Mode Wireless Mouse Silent Edition - Hàng Chính Hãng",349000,349000,0,0
TIKI,thiet-bi-kts-phu-kien-so,90220378,"Cáp chuyển đổi có chipset lightning sang 3.5mm 10CM màu đen Ugreen 70860  US211 Hàng Chính Hãng",456000,456000,0,0
TIKI,thiet-bi-kts-phu-kien-so,68788522,"Máy Trợ Giảng Không Dây Shidu SD-M500 UHF Kèm Micro Cài Áo Có Dây - Hàng Chính Hãng",720000,720000,0,0
TIKI,thiet-bi-kts-phu-kien-so,152923535,"Bình xịt vệ sinh màn hình, bàn phím laptop/ máy tính 650ML+ Tặng kèm khăn lau cao cấp- Chai xịt đa năng trên loại bề mặt- CHỌN MẪU",72000,72000,0,0
TIKI,thiet-bi-kts-phu-kien-so,213702311,"Bàn phím máy tính có dây Gaming Newmen e340 + - Hàng Chính Hãng",149000,149000,0,0
TIKI,thiet-bi-kts-phu-kien-so,130842252,"Ốp lưng Likgus trong suốt chống sốc không ố màu dành cho iPhone 13 Pro Max, 13, 13 Pro - iPhone 13 Pro",63000,98000,35000,36
TIKI,thiet-bi-kts-phu-kien-so,163850036,"Bộ 3 Kính cường lực Gor cho Huawei Watch GT3 46mm trong suốt ( 3 miếng) Hàng nhập khẩu",99000,99000,0,0
TIKI,thiet-bi-kts-phu-kien-so,80964760,"Ốp lưng cho SamSung Galaxy S21 Plus/ S21 Ultra chính hãng GREENCASE dạng da mềm",99000,99000,0,0
TIKI,thiet-bi-kts-phu-kien-so,271742108,"[TRIPOD] Cây Livestream Selfiecom - Hỗ trợ chụp ảnh, quay video, chơi tiktok, gắn đèn livestream - Tặng kèm remote bluetooth chụp ảnh- Hàng chính hãng",199000,199000,0,0
TIKI,thiet-bi-kts-phu-kien-so,108759788,"CHUỘT KHÔNG DÂY BT21 LINE FRIENDS VER 2019 SEASON 1- HÀNG CHÍNH HÃNG",119000,119000,0,0
TIKI,thiet-bi-kts-phu-kien-so,130842256,"Ốp lưng Likgus trong suốt chống sốc không ố màu dành cho iPhone 13 Pro Max, 13, 13 Pro - iPhone 13 Pro Max",63000,98000,35000,36
TIKI,thiet-bi-kts-phu-kien-so,124089209,"Củ Sạc Nhanh 3 Cổng 3.4A Hoco C15 Có Đèn Led, Màn LCD Hiển Thị Dòng Điện - Hàng Chính Hãng",132000,132000,0,0
TIKI,thiet-bi-kts-phu-kien-so,91909097,"Bàn Phím Cơ chuyên GAME EDRA EK384 - Keycaps PBT - LED RGB - Hàng Chính Hãng",748000,748000,0,0
TIKI,thiet-bi-kts-phu-kien-so,127221618,"Ugreen 70607 4K 30Hz 2 Way Hdmi Bidirectional Switch Splitter with Cable CM311  Hàng chính Hãng",304000,304000,0,0
TIKI,thiet-bi-kts-phu-kien-so,95225506,"[Hàng chính hãng] Tai nghe Marshall MODE EQ - Bảo Hành 1 Năm 1 Đổi 1",1790000,1790000,0,0
TIKI,thiet-bi-kts-phu-kien-so,58406254,"Ốp chống sốc cầm tay xoay 360 độ có khay cài bút Apple Pencil 2 kèm giá đỡ dựng ngang dọc cho iPad Pro 11 inch 2018/2020- Hàng chính hãng",359000,359000,0,0
TIKI,thiet-bi-kts-phu-kien-so,197889874,"Cổng chuyển đổi Ugreen USB-C to 3.5mm Headset Adapter AV142 - Hàng chính hãng",75000,105000,30000,29
TIKI,thiet-bi-kts-phu-kien-so,104269966,"Thiết bị định vị 2 chiều tìm đồ vật dùng Bluetood Itag ( tìm chìa khóa, điện thoại....) - Hàng Chính Hãng",45000,45000,0,0
TIKI,thiet-bi-kts-phu-kien-so,74913983,"Bàn di chuột DareU ESP101 - Hàng chính hãng",69000,69000,0,0
TIKI,thiet-bi-kts-phu-kien-so,194502963,"Dây sạc type C To C PROLiNK GCC_100_02 dài 2M, sạc siêu nhanh 100W, màn hình Led, dành cho Tablet, Macbook, Laptop - Hàng chính hãng",239000,399000,160000,40
TIKI,thiet-bi-kts-phu-kien-so,75302620,"Cổng Chuyển Hyperdrive Bar 6-in-1 USB-C Hub (HD22E) For Macbook, Ipad Pro 2018, PC & Devices",1850000,1850000,0,0
TIKI,thiet-bi-kts-phu-kien-so,44227327,"Micro SoundMax MC-01 - Hàng Chính Hãng",650000,650000,0,0
TIKI,thiet-bi-kts-phu-kien-so,170578539,"Ốp Lưng dành cho Samsung Galaxy A53/A73 5G RINGKE Fusion - Hàng Chính Hãng",255000,300000,45000,15
TIKI,thiet-bi-kts-phu-kien-so,117220904,"Dây cáp sạc chính hãng Remax RC-124i hỗ trợ sạc nhanh",34000,99998,65998,66
TIKI,thiet-bi-kts-phu-kien-so,2066611,"Cáp Chuyển Đổi Ugreen USB 2.0 Sang RS232-DB9 20222 (2m) - Hàng Chính Hãng",181000,181000,0,0
TIKI,thiet-bi-kts-phu-kien-so,177703819,"Kính Cường Lực Camera UNIQ Optix Lens Protector Dành Cho iPhone 13 Pro Max / 13 Pro_ Hàng Chính Hãng",290000,290000,0,0
TIKI,thiet-bi-kts-phu-kien-so,168918272,"Ốp Lưng Nillkin CamShield Silky Silicone cho Samsung Galaxy S22 Ultra - Hàng Nhập Khẩu",165765,182341,16576,9
TIKI,thiet-bi-kts-phu-kien-so,15602620,"Ốp lưng Nillkin Textured Case vân carbon cho iPhone X/XS / iPhone XR / iPhone XS Max - Hàng nhập khẩu",148999,297998,148999,50
TIKI,thiet-bi-kts-phu-kien-so,152011221,"Chuột Fuhlen G90 Pro Gaming Hàng chính hãng Ninja",460000,489000,29000,6
TIKI,thiet-bi-kts-phu-kien-so,55142944,"Ốp lưng chống sốc cho Samsung Galaxy A71 hiệu Likgus (chuẩn quân đội, chống va đập, chống vân tay) - Hàng nhập khẩu",79000,79000,0,0
TIKI,thiet-bi-kts-phu-kien-so,73954077,"Tai nghe bluetooth Hoco E57 Essential V5.0 Dùng liên tục 10H (Hàng chính hãng)",179000,179000,0,0
TIKI,thiet-bi-kts-phu-kien-so,102856763,"Giá Đỡ Laptop Dành Cho Các Loại Máy Tính, IPad, Macbook Hợp Kim Nhôm Cao Cấp. Hỗ Trợ Tản Nhiệt Chống Mỏi Cổ, Vai, Gáy - Hàng Chính Hãng",250000,250000,0,0
TIKI,thiet-bi-kts-phu-kien-so,26267759,"Cáp âm thanh 3.5Mm âm ra 2 đâu 3.5Mm dương mic và tai nghe  đàu mạ vàng ver 20897 20Cm màu trắng UGREEN Av140- Hàng chính hãng",63000,68000,5000,7
TIKI,thiet-bi-kts-phu-kien-so,2000975,"Cáp Chuyển Đổi HDMI Sang VGA + Audio Cáp Dẹt Có Nguồn Phụ Ugreen 40248 - Hàng Chính Hãng",200000,350000,150000,43
TIKI,thiet-bi-kts-phu-kien-so,37887622,"Máy Nghe Nhạc Lossless MP3 MP4 Bluetooth Màn Hình Cảm Ứng 4 inch Ruizu H1 Bộ Nhớ Trong 8GB Cao Cấp AZONE - Hàng Chính Hãng",870000,889000,19000,2
TIKI,thiet-bi-kts-phu-kien-so,168918224,"Ốp Lưng Nillkin Nature TPU Pro cho Samsung Galaxy S22 Ultra - Hàng Nhập Khẩu",99000,99000,0,0
TIKI,thiet-bi-kts-phu-kien-so,161249996,"Chân Đế Đỡ Laptop Nillkin Bolster Plus Portable Stand cho Laptop Macbook / Laptop Surface / Laptop Asus / Laptop HP / Laptop Dell / Laptop Lenovo / Laptop LG / Laptop Acer / Laptop MSI - Hàng Nhập Khẩu",146000,245000,99000,40
TIKI,thiet-bi-kts-phu-kien-so,55143700,"Ốp lưng chống sốc cho Samsung Galaxy S10 5G hiệu Likgus (chuẩn quân đội, chống va đập, chống vân tay) - Hàng nhập khẩu",80000,80000,0,0
TIKI,thiet-bi-kts-phu-kien-so,53200698,"Ốp lưng chống sốc toàn phần dành cho iPhone 11 Pro Xanh dương",9000,18000,9000,50
TIKI,thiet-bi-kts-phu-kien-so,174431036,"Cáp sạc USB Type C hỗ trợ sạc nhanh cho Samsung, Hàng chính hãng",39000,39000,0,0
TIKI,thiet-bi-kts-phu-kien-so,11586496,"Bao da siêu chống sốc cho iPad Pro 12.9 inch 2018 hiệu Nillkin có ngăn đựng bút - Hàng chính hãng",378000,700000,322000,46
TIKI,thiet-bi-kts-phu-kien-so,53069930,"Ốp lưng chống sốc toàn phần dành cho iPhone 11 Pro - Màu đỏ",9000,18000,9000,50
TIKI,thiet-bi-kts-phu-kien-so,167620449,"Keypuller dụng cụ nhổ Keycap switch - Hàng nhập khẩu",3000,3000,0,0
TIKI,thiet-bi-kts-phu-kien-so,32262969,"Ốp lưng trong suốt viền màu chống sốc chính hãng XunDD Beatle Series dành cho iPhone 11 Pro Max",87000,177986,90986,51
TIKI,thiet-bi-kts-phu-kien-so,187494188,"Ốp Lưng Silicon TPU trong suốt GOR ARMOR cho iPhone 13 Mini / 13 / 13 Pro / 13 Pro Max - Hàng Chính Hãng",99000,99000,0,0
TIKI,thiet-bi-kts-phu-kien-so,112890778,"Đế tản nhiệt cho Laptop Cooler Master X150 Spectrum - Hàng chính hãng",1290000,1290000,0,0
TIKI,thiet-bi-kts-phu-kien-so,2034109,"Cáp Chuyển Đổi Ugreen USB Type-C Sang VGA HDMI 30843 (15cm) - Hàng Chính Hãng",437000,450000,13000,3
TIKI,thiet-bi-kts-phu-kien-so,1998359,"Cáp MiniUSB Ugreen 10385 (1.5m) - Hàng Chính Hãng",68000,68000,0,0
TIKI,thiet-bi-kts-phu-kien-so,55990648,"Giá đỡ điện thoại HOCO CA56 cửa gió thanh điều hòa trên ô tô - Thiết bị đỡ điện thoại trên xe hơi oto , Thiết kế kiểu dáng thông minh - kẹp điện thoại oto",98000,98000,0,0
TIKI,thiet-bi-kts-phu-kien-so,39306849,"Bao da dành cho SamSung Galaxy Tab A6 10.1 T585, Tab A 2016 chính hãng KAKU",128000,190000,62000,33
TIKI,thiet-bi-kts-phu-kien-so,70833036,"Micro karaoke kèm loa bluetotoh cao cấp âm thanh vượt trội PKCB PF1018 - Hàng chính hãng",1250000,2500000,1250000,50
TIKI,thiet-bi-kts-phu-kien-so,84859323,"Ốp lưng chống sốc dành cho Samsung A32 4G hàng chính hãng Rugged Shield cao cấp",60000,60000,0,0
TIKI,thiet-bi-kts-phu-kien-so,67269548,"Giá đỡ chân kẹp điện thoại, tablet Baseus Otaku Life Rotary Adjustment Lazy holder - Hàng Nhập Khẩu",390000,390000,0,0
TIKI,thiet-bi-kts-phu-kien-so,73871931,"Kính cường lực Nillkin Amazing Guardian Anti-Spy cho iPhone 12 Mini / 12 / 12 Pro / 12 Pro Max (Chống Nhìn Trộm) - Hàng Nhập Khẩu",173000,359998,186998,52
TIKI,thiet-bi-kts-phu-kien-so,188686488,"Bàn phím cơ văn phòng Logitech MX Mechanical FullSize Wireless/Bluetooth - Hàng Chính Hãng",4139000,4139000,0,0
TIKI,thiet-bi-kts-phu-kien-so,138149161,"Cáp USB 2.0 to USB Mini 3m mạ vàng Ugreen 10386 Hàng chính hãng",89000,89000,0,0
TIKI,thiet-bi-kts-phu-kien-so,179059004,"Kính cường lực full màn hình Nillkin Amazing CP+ Pro cho Samsung Galaxy S22 Plus (S22+)- Hàng chính hãng",129989,185000,55011,30
TIKI,thiet-bi-kts-phu-kien-so,179949776,"Cóc Sạc Hoco Uh102 5V 1A - Hàng Chính Hãng",29000,29000,0,0
TIKI,thiet-bi-kts-phu-kien-so,57706767,"Bộ 2 Miếng Kính Cường Lực Gor Dành Cho SAMSUNG GALAXY A71/ A90 Full Box - GOR - Hàng Nhập Khẩu",99000,99000,0,0
TIKI,thiet-bi-kts-phu-kien-so,17538826,"Bao Da Smart Case Gen2 TPU Dành Cho iPad Pro 10.5 Inch - Hàng nhập khẩu",139000,289798,150798,52
TIKI,thiet-bi-kts-phu-kien-so,108586961,"Cáp sạc nhanh 2.1A 3 trong 1 Remax Sury Series RC185th - Hàng chính hãng",190000,250000,60000,24
TIKI,thiet-bi-kts-phu-kien-so,2066599,"Cáp Chuyển Đổi Ugreen USB 2.0 Sang Audio 3.5mm 30143 - Hàng Chính Hãng",154000,154000,0,0
TIKI,thiet-bi-kts-phu-kien-so,49548822,"Tai Nghe Bluetooth Chụp Tai Sennheiser HD 350BT - Hàng Chính Hãng",1899050,1899050,0,0
TIKI,thiet-bi-kts-phu-kien-so,74596977,"Bao da thật dạng ví cho Xiaomi Redmi Note 9 Pro Chính Hãng Caseme có ngăn đựng thẻ - Hàng Nhập Khẩu",120000,120000,0,0
TIKI,thiet-bi-kts-phu-kien-so,188174455,"Chuột không dây Logitech Lift Vertical Ergonomic Mouse - Hàng chính hãng",1390000,1599000,209000,13
TIKI,thiet-bi-kts-phu-kien-so,74629311,"Loa Bluetooth speaker không dây PKCB250 - Hàng Chính Hãng",180000,500000,320000,64
TIKI,thiet-bi-kts-phu-kien-so,74923175,"Webcam máy tính HXSJ S20 HD 640x480  Pixel USB3 2.0  Kèm Mic Cho Cuộc Gọi Video - Hàng Chính Hãng",299000,449000,150000,33
TIKI,thiet-bi-kts-phu-kien-so,190860313,"Bàn Phím Chơi Game Huqu HQ-M200 - Đèn Led 3 Màu-Hàng Chính Hãng",370000,370000,0,0
TIKI,thiet-bi-kts-phu-kien-so,73291835,"Bộ 2 Miếng dán màn hình ppf Silicon Samsung Galaxy Note 20 / Note 20 Ultra siêu mỏng 0.15mm hiệu Baseus Soft Screen  cảm ứng siêu nhạy, chống trầy, chống va đập, bảo vệ màn hình - Hàng nhập khẩu",159000,159000,0,0
TIKI,thiet-bi-kts-phu-kien-so,53853891,"Loa JBL Bar 2.0 ALL-IN-ONE 80W Chính hãng",4270000,4500000,230000,5
TIKI,thiet-bi-kts-phu-kien-so,16235287,"Bao da SamSung Galaxy Tab A6 10.1 2016 Spen P580, P585 chính hãng KAKU",114990,114990,0,0
TIKI,thiet-bi-kts-phu-kien-so,176588567,"Ốp Lưng Da Sulada  cho Điện Thoại Iphone ( Full Modem ) - Hàng Chính Hãng",75000,75000,0,0
TIKI,thiet-bi-kts-phu-kien-so,168375677,"Micro Rode Wireless Go II Single - Bộ 1 Phát 1 Thu Go 2 Mic Thu Âm Livestream, Phỏng vấn ngoài trời GoII Microphone Không dây Go2 Hàng Chính Hãng - Kèm Móng Gẩy DreamMaker",5199000,5199000,0,0
TIKI,thiet-bi-kts-phu-kien-so,114376556,"Bàn Phím Logitech Combo Touch iPad Pro 12.9 inch 5TH GEN - Hàng Chính Hãng",4990000,4990000,0,0
TIKI,thiet-bi-kts-phu-kien-so,7079899,"Loa Bluetooth Anker SoundCore Mini 2 - A3107H11",549000,1000000,451000,45
TIKI,thiet-bi-kts-phu-kien-so,2405235,"Logitech Bluetooth Audio Receiver 980-000915 - Hàng chính hãng",739000,769000,30000,4
TIKI,thiet-bi-kts-phu-kien-so,195875910,"Óp lưng Samsung Slim  Fold 4 dạng đứng Màu Da - Hàng chính hãng ( EF-MF936CUEGWW)",990000,990000,0,0
TIKI,thiet-bi-kts-phu-kien-so,75186039,"Ốp lưng siêu mỏng chống bám vân tay dùng cho iPhone 12 mini / iPhone 12 / iPhone 12 Pro / iPhone 12 Promax Baseus Wing Case_ Hàng Nhập Khẩu",99000,99000,0,0
TIKI,thiet-bi-kts-phu-kien-so,137118482,"SIM 4G VINAPHONE 500GB/THÁNG - U1500 KHÔNG GIỚI HẠN DATA ( CÓ 500Gb/tháng tốc độ 4G, hết vẫn tiếp tục dùng KHÔNG GIỚI HẠN DUNG LƯỢNG với tốc độ cao 5Mbps) - Hàng chính hãng",1145000,1145000,0,0
TIKI,thiet-bi-kts-phu-kien-so,91192766,"Dây AV3.5mm bện vải sợi tổng hợp, màu xanh tím than dài 0.5-5m UGREEN AV112 - Hàng Nhập khẩu",74000,80000,6000,8
TIKI,thiet-bi-kts-phu-kien-so,73554122,"Dàn Âm Thanh Di Động ACNOS CS445 -Hàng chính hãng",4590000,4590000,0,0
TIKI,thiet-bi-kts-phu-kien-so,137442258,"Micro Karaoke Bluetooth Kèm Loa cao cấp kết nối Bluetooth, thẻ nhớ, USB pin sạc - Hàng chính hãng",377000,900000,523000,58
TIKI,thiet-bi-kts-phu-kien-so,496177,"Sạc Dự Phòng Xiaomi Original 20000mAh - Hàng Chính Hãng",570000,570000,0,0
TIKI,thiet-bi-kts-phu-kien-so,97057182,"Pin Sạc Dự Phòng HOCO 10.000mAh-J48,HÀNG CHÍNH HÃNG",148000,148000,0,0
TIKI,thiet-bi-kts-phu-kien-so,195927140,"Sạc BOOST↑CHARGE Belkin 30W USB-C PD 3.0 PPS WCA005 - Hàng chính hãng",419000,590000,171000,29
TIKI,thiet-bi-kts-phu-kien-so,108311556,"Ốp lưng chống sốc lưng trong cao cấp dành cho iPhone 12 / 12 Pro / 12 Pro Max / 12 Mini - Hàng chính hãng",69000,119000,50000,42
TIKI,thiet-bi-kts-phu-kien-so,55386033,"BỘ CHUYỂN ĐỔI ÂM THANH KIWI KA08-HÀNG CHÍNH HÃNG",339000,339000,0,0
TIKI,thiet-bi-kts-phu-kien-so,152561108,"Bàn Phím Gập Bluetooth TARGUS Ergonomic Foldable Kháng Khuẩn - AKF003 - Hàng Chính Hãng",999999,1190000,190001,16
TIKI,thiet-bi-kts-phu-kien-so,173964770,"Thiết bị nhận tín hiệu logitech (Bolt USB Receiver) - Hàng chính hãng",229000,249000,20000,8
TIKI,thiet-bi-kts-phu-kien-so,184097842,"Case bao da leather chống sốc cho Samsung Galaxy Note 20 Ultra hiệu Nillkin Qin (Chất liệu da cao cấp, có ngăn đựng thẻ, mặt da siêu mềm mịn) - hàng nhập khẩu",184000,184000,0,0
TIKI,thiet-bi-kts-phu-kien-so,95098445,"Giá đỡ xe hơi Belkin Car Vent Mount PRO with MagSafe - Hàng Chính Hãng - Bảo Hành 2 Năm Đổi Mới - WIC002btGR",750000,1590000,840000,53
TIKI,thiet-bi-kts-phu-kien-so,56117365,"Máy Nghe Nhạc MP3 Màn Hình Cảm Ứng Bluetooth Ruizu M7 Bộ Nhớ Trong 8GB Cao Cấp AZONE - Hàng Chính Hãng",644000,644000,0,0
TIKI,thiet-bi-kts-phu-kien-so,142775457,"Cáp HDMI chuẩn 2.0 chất lượng  4K 60Hz Vention dây cáp HDMI tốc độ cao chuyên dụng dành cho 1080P 3D TV LCD/màn hình máy chiếu PS4/Xbox/Máy tính/Laptop - Hàng chính hãng",89000,89000,0,0
TIKI,thiet-bi-kts-phu-kien-so,39999207,"Kệ nhôm để tai nghe Headphone đầu bọc da vòm Crossline - Hàng chính hãng",269000,269000,0,0
TIKI,thiet-bi-kts-phu-kien-so,68418555,"Loa 4 tấc karaoke và nghe nhạc BellPlus (hàng chính hãng) 1 cặp",2960000,2960000,0,0
TIKI,thiet-bi-kts-phu-kien-so,136034105,"Giá đỡ điện thoại để bàn Màu Đen Ugreen 80628 LP106 - Hàng Chính Hãng",88000,88000,0,0
TIKI,thiet-bi-kts-phu-kien-so,22632049,"Chuột Fuhlen Gaming G90 - Hàng nhập khẩu",350000,350000,0,0
TIKI,thiet-bi-kts-phu-kien-so,98078281,"Tai nghe không dây Tai nghe Bluetooth True Wireless Tai nghe nhét tai Âm thanh trầm bổng - Hàng Chính Hãng PKCB",249500,499000,249500,50
TIKI,thiet-bi-kts-phu-kien-so,109064004,"[New, Gen 2] Loa Kiểm Âm Nghe Nhạc Presonus E3.5 Gen2 Eris Powered Studio Monitor Speaker E35 Pair Hàng Chính Hãng",3190000,3190000,0,0
TIKI,thiet-bi-kts-phu-kien-so,6840381,"Ốp lưng chống sốc Likgus cho iPhone 6 / 6s (chuẩn quân đội, chống va đập, chống vân tay) - Hàng chính hãng",97000,97000,0,0
TIKI,thiet-bi-kts-phu-kien-so,48460342,"Ốp Lưng in cho iPhone 6 Plus / 6s Plus Mẫu Cúc Họa Mi 5 - Hàng Chính Hãng",35000,55000,20000,36
TIKI,thiet-bi-kts-phu-kien-so,155049787,"Cốc sạc HOCO C89 - Củ sạc 2 cổng USB tối đa 2.1A, dùng cho iPhone, Samsung và máy khác - Hàng chính hãng",39000,39000,0,0
TIKI,thiet-bi-kts-phu-kien-so,137123301,"{Trọn Gói 1 Năm} Sim 4G Vinaphone FHAPPY  Tặng 2GB/Ngày Tương Đương 60GB/Tháng - Hàng Chính Hãng - Mẫu Ngẫu Nhiên",750000,750000,0,0
TIKI,thiet-bi-kts-phu-kien-so,169545360,"Bộ Bàn phím + Chuột không dây Logitech MK295- Hàng chính hãng",589000,589000,0,0
TIKI,thiet-bi-kts-phu-kien-so,20022917,"Bút Trình Chiếu Vesine VP-101 - Hàng Nhập Khẩu",91000,91000,0,0
TIKI,thiet-bi-kts-phu-kien-so,45579051,"Adapter Sạc 1 Cổng Type-C 30W Công Nghệ GaN Hỗ Trợ Sạc Nhanh PD Power Delivery RAVPower RP-PC120 Với Đầu AC Gập - Hàng Chính Hãng",359000,690000,331000,48
TIKI,thiet-bi-kts-phu-kien-so,187056529,"Tai Nghe Bluetooth Chụp Tai Lenovo HD200 Gamming 5.1 , Chống Ồn Chủ Động ANC - Hàng Chính Hãng",235000,235000,0,0
TIKI,thiet-bi-kts-phu-kien-so,11834620,"Đế tản nhiệt laptop N99 2 quạt đế nâng - Hàng nhập khẩu",105000,116400,11400,10
TIKI,thiet-bi-kts-phu-kien-so,133138709,"Chuột không dây Dareu LM115G - Hàng chính hãng",139000,139000,0,0
TIKI,thiet-bi-kts-phu-kien-so,91189947,"Cáp sạc nhanh UGREEN US287 USB 2.0 sang USB Type-C, điện áp 3A, độ dài từ 0.25m đến 2m  - Hàng chính hãng",34000,39000,5000,13
TIKI,thiet-bi-kts-phu-kien-so,160835193,"Bao da Samsung dành cho Tab A8 ( X205 ) Hàng Chính Hãng ",159000,159000,0,0
TIKI,thiet-bi-kts-phu-kien-so,189369892,"SIM VIETTEL ĐẦU 09 ĐẸP - SIM TRẢ TRƯỚC - CHỌN SỐ - NGHE GỌI -4G - HÀNG CHÍNH HÃNG",199000,199000,0,0
TIKI,thiet-bi-kts-phu-kien-so,24850336,"Đế tản nhiệt cho Laptop Remax RT-W02 - Chính Hãng",119000,119000,0,0
TIKI,thiet-bi-kts-phu-kien-so,103074041,"Pin sạc dự phòng Polymer Pocket Power 10,000 mAh, 15w PD, cáp đi kèm A-C Belkin - BPB011bt",515000,790000,275000,35
TIKI,thiet-bi-kts-phu-kien-so,114903102,"Giá Đỡ Điện Thoại Xe Hơi Ô Tô Hợp Kim Nhôm - Nút Ấn Thông Minh - Tư Do Xoay Chuyển 360 Độ - Kẹp Cánh Thông Gió Điều Hòa Hoặc Dùng Đế Hit Kèm Theo - Mini Nhỏ Gọn Tiện Lợi - Hàng Chính Hãng",599000,599000,0,0
TIKI,thiet-bi-kts-phu-kien-so,5986835,"Cáp HDMI 2.0 hỗ trợ 3D , 4K dài 2m UGREEN HD118 40410 - Hàng chính hãng",127000,127000,0,0
TIKI,thiet-bi-kts-phu-kien-so,51197258,"Cáp Mạng Lan Cat6 Dây Dẹt 0.5M Màu Đen Cat 6 Ugreen Nw10250172 Hàng Chính Hãng",22000,25000,3000,12
TIKI,thiet-bi-kts-phu-kien-so,135548560,"Gel vệ sinh bàn phím đa năng, vệ sinh nội thất ô tô, chất liệu tự nhiên, làm sạch bụi bẩn nhanh chóng TÂM LUÂN Chổi lau tẩm dầu - Hàng chính hãng",9000,15000,6000,40
TIKI,thiet-bi-kts-phu-kien-so,72302710,"Ốp lưng chống sốc cho Samsung Galaxy Note 20 Ultra hiệu Likgus (chuẩn quân đội, chống va đập, chống vân tay) - Hàng nhập khẩu",85999,85999,0,0
TIKI,thiet-bi-kts-phu-kien-so,45842739,"Chuột không dây sạc điện cao cấp",84000,84000,0,0
TIKI,thiet-bi-kts-phu-kien-so,38407102,"Chuột Quang Không Dây Dell WM118 (Đen) - Hàng Chính Hãng",139000,139000,0,0
TIKI,thiet-bi-kts-phu-kien-so,108388308,"Loa bass 2 tấc 20cm viền cao su  Hải Triều (hàng chính hãng)  1 cặp",420000,420000,0,0
TIKI,thiet-bi-kts-phu-kien-so,74985619,"LỌC XÌ BEHRINGER FBQ1502HD Graphic Equalizer-HÀNG CHÍNH HÃNG",3104000,3200000,96000,3
TIKI,thiet-bi-kts-phu-kien-so,67262554,"Đế Sạc Không Dây Đa Chức Năng Cho Apple Watch & Iphone & AirPods US02- Hàng chính hãng",485400,485400,0,0
TIKI,thiet-bi-kts-phu-kien-so,110970663,"Dây Đeo Tay Dùng Cho Đồng Hồ Thông Minh Xiaomi Mi Band 3 Mi Band 4 - Hàng Chính Hãng",120000,120000,0,0
TIKI,thiet-bi-kts-phu-kien-so,43395521,"Thẻ Nhớ Hikvision 64GB Chuyên Cho Camera Class 10 - Hàng Chính hãng",100000,100000,0,0
TIKI,thiet-bi-kts-phu-kien-so,73772784,"Bộ Full Vô Lăng Chơi Game PXN V9 Gaming Racing Wheel - Hàng Chính Hãng",3289000,3390000,101000,3
TIKI,thiet-bi-kts-phu-kien-so,143139489,"Bàn phím cơ không dây Bluetooth Newmen GM680 Jungle Hot Swap Outemu Switch (Blue/Brown/Red/Purple) - Hàng chính hãng",1290000,1290000,0,0
TIKI,thiet-bi-kts-phu-kien-so,525668,"Đầu Cáp Chuyển Đổi DVI Sang HDMI Ugreen (20118) - Hàng Chính Hãng",89000,89000,0,0
TIKI,thiet-bi-kts-phu-kien-so,11661085,"Loa Vi Tính Kisonli V310 - Hàng Chính Hãng",46000,47490,1490,3
TIKI,thiet-bi-kts-phu-kien-so,13884193,"Cáp Ugreen HDMI to DVI",110000,110000,0,0
TIKI,thiet-bi-kts-phu-kien-so,147988346,"Bộ bàn phím chuột không dây PROLiNK PCWM7005 Fullsize cao cấp, chống thấm nước, thời lượng pin cao dành cho PC, Laptop - Hàng chính hãng",379000,400000,21000,5
TIKI,thiet-bi-kts-phu-kien-so,77712221,"Loa Bluetooth speaker Loa di động chip DPS khuyếch đại âm thanh công suất lớn 50W Kết nối TWS lên 100W  Hàng Chính Hãng",1030000,2300000,1270000,55
TIKI,thiet-bi-kts-phu-kien-so,128590443,"Ốp lưng chống sốc Gear4 D3O Santa Cruz Snap 4m hỗ trợ sạc Magsafe cho iPhone 13 series - Hàng chính hãng",279000,600000,321000,54
TIKI,thiet-bi-kts-phu-kien-so,21440168,"DÂY TÍN HIỆU CHOSEAL 1 ĐẦU 3.5MM RA 2 ĐẦU BÔNG SEN DÀI 10 MÉT - Hàng Nhập Khẩu",115000,115000,0,0
TIKI,thiet-bi-kts-phu-kien-so,102690857,"Jack âm thanh cao cấp, Rắc canon đầu đực/ đầu cái loại xịn",55000,55000,0,0
TIKI,thiet-bi-kts-phu-kien-so,83397858,"MPE1 - Khổ 50 cm - 3kg - Cuộn PE màng co",135400,135400,0,0
TIKI,thiet-bi-kts-phu-kien-so,106384460,"Bảng Vẽ Điện Tử XP-Pen Deco Fun L 10x6.27 inch inch Android Hỗ Trợ Cảm ứng Nghiêng kèm Bút Vẽ Không Sạc P01 - Hàng Chính Hãng",1500000,1990000,490000,25
TIKI,thiet-bi-kts-phu-kien-so,97678405,"Loa Vi Tính Bluetooth Gaming XSmart SADA D-209 Super Bass Phiên bản nâng cấp của 2GOOD Dùng Cho PC Laptop Điện Thoại - Hàng Chính Hãng",479000,479000,0,0
TIKI,thiet-bi-kts-phu-kien-so,44887774,"Miếng Dán Kính Cường Lực Camera chống trầy GOR (Bộ 2 Miếng) _ Hàng Nhập Khẩu",30000,69998,39998,57
TIKI,thiet-bi-kts-phu-kien-so,89429331,"Tai nghe nhét tai không dây bluetooth tốt nhất cho điện thoại di động - Hàng Chính Hãng PKCB",245000,500000,255000,51
TIKI,thiet-bi-kts-phu-kien-so,139712202,"Micro Rode NT-USB Mini - Mic Thu Âm Podcast, Livestream, Radio, ASMR NTUSB Microphone Phòng Thu Studio NT USB Hàng Chính Hãng - Kèm Móng Gẩy DreamMaker",3050000,3050000,0,0
TIKI,thiet-bi-kts-phu-kien-so,274919416,"Bàn Phím LED LANGTU L1B cho máy tính - Hàng nhập khẩu",440000,440000,0,0
TIKI,thiet-bi-kts-phu-kien-so,58817656,"Loa Bluetooth Siêu Bass Điều Khiển Bằng Giọng Nói 60W PKCB103 - Hàng Chính Hãng",1107000,2500000,1393000,56
TIKI,thiet-bi-kts-phu-kien-so,59409729,"Thẻ Nhớ MicroSD DSS 32Gb Class 10 (Thẻ Chuyên Dụng Cho Camera, Điện Thoại) - Hàng Chính Hãng ",78000,78000,0,0
TIKI,thiet-bi-kts-phu-kien-so,2066609,"Cáp Chuyển Đổi Ugreen USB 2.0 Sang RS232 20201 (1.5m) - Hàng Chính Hãng",195000,196900,1900,1
TIKI,thiet-bi-kts-phu-kien-so,138081574,"Bộ thiết bị Hub chuyển đổi chia USB 3.0 QGeeM 7 trong 1 4K sang HDMI, 3 x USB-A, 1 x USB-C sạc nhanh PD 100w, 1 khe đọc thẻ SD&TF hỗ trợ HDMI và tương thích với Chromebook Thunderbolt - Hàng Nhập Khẩu",587000,599000,12000,2
TIKI,thiet-bi-kts-phu-kien-so,48428977,"Cáp Micro USB 3.0 sang Type C cao cấp 1M màu Đen Ugreen UC20103US312 Hàng chính hãng",93000,93000,0,0
TIKI,thiet-bi-kts-phu-kien-so,79582374,"Đế Sạc Nhanh Không Dây Đa Năng 4in1 - Hàng Chính Hãng",499000,499000,0,0
TIKI,thiet-bi-kts-phu-kien-so,4027535,"Chuột Chơi Game Có Dây A4tech A70 4000DPI 8 Nút (Đen) - Hàng Chính Hãng",700000,700000,0,0
TIKI,thiet-bi-kts-phu-kien-so,187829788,"Bao da dành cho iPad Air 5 2022 10.9 Inch ESR Rebound Pencil Case (Có khe cắm bút Apple Pencil) - Hàng Chính Hãng",690000,690000,0,0
TIKI,thiet-bi-kts-phu-kien-so,106457399,"Ốp lưng thoát nhiệt dành cho iPhone 12 / 12 Pro / 12 Pro Max / 12 Mini - Hàng chính hãng",39000,78000,39000,50
TIKI,thiet-bi-kts-phu-kien-so,86417195,"Sim 4G Vinaphone U900 Trọn Gói 6 Tháng Và U1500 Trọn Gói 12 Tháng Tặng 500GB/Tháng - Hàng Chính Hãng",1145000,1145000,0,0
TIKI,thiet-bi-kts-phu-kien-so,43406088,"Ốp lưng da kính cao cấp dành cho iPhone XR - Màu đen - Hàng nhập khẩu - DELICATE",149000,150000,1000,1
TIKI,thiet-bi-kts-phu-kien-so,97057089,"Pin Sạc Dự Phòng 10000mah Remax RPP-96 Garie Series Fast Charing 2.1A tích hợp 2 cổng USB(HÀNG CHÍNH HÃNG)",139000,139000,0,0
TIKI,thiet-bi-kts-phu-kien-so,104952747,"Loa Karaoke mini xách tay ACNOS CS200PU - Hàng chính hãng",2790000,2790000,0,0
TIKI,thiet-bi-kts-phu-kien-so,20581259,"Bộ chuyển đổi cổng USB sang cổng mạng LAN Orico UTJ-U2 - Hàng nhập khẩu",171000,171000,0,0
TIKI,thiet-bi-kts-phu-kien-so,160305888,"Chuột không dây Logitech M331 - Hàng chính hãng",349000,469000,120000,26
TIKI,thiet-bi-kts-phu-kien-so,186083612,"Ốp Lưng Dành Cho Samsung Galaxy S21 FE Silicone Dẻo Lót Nhung Nỉ Chống Sốc chống bẩn hạn chế bám vân tay - Hàng Nhập Khẩu",80000,80000,0,0
TIKI,thiet-bi-kts-phu-kien-so,85185806,"Ốp lưng lụa dành cho Samsung Galaxy S21, S21 Plus, S21 Ultra chính hãng siêu mỏng 0.3mm bảo vệ camera - Hàng Nhập Khẩu",94999,94999,0,0
TIKI,thiet-bi-kts-phu-kien-so,101361110,"Củ Sạc Nhanh Baseus GaN2 Pro Quick Charger 65W Màu Đen (Type C x 2 + USB, Multi Quick Charge Protocol) - Hàng Chính Hãng",580000,580000,0,0
TIKI,thiet-bi-kts-phu-kien-so,159349211,"Ốp Lưng ESR Magsafe Air Armor Clear dành cho iPhone 13 / 13 Pro / 13 Pro Max  - Hàng Chính Hãng",432000,450000,18000,4
TIKI,thiet-bi-kts-phu-kien-so,160879414,"Bộ thu phát USB bluetooth 5.0 CV, mạnh mẽ không dây hai chiều Laptop, PC, Tivi, ô tô phát nhạc Hifi Stereo, Màn hình LED trực quan, Tích hợp Mic giảm tiếng ồn - Hàng chính hãng",198000,198000,0,0
TIKI,thiet-bi-kts-phu-kien-so,1016673,"Sim 3G/4G Vinaphone (Trọn Gói 12 Tháng Không Cần Nạp Tiền Duy Trì) - Mẫu ngẫu nhiên",419000,419000,0,0
TIKI,thiet-bi-kts-phu-kien-so,149397412,"Tai nghe game không dây Bluetooth và Lighspeed Logitech G435 – Mic ảo tích hợp, nhẹ, tương thích PC, Điện thoại, PS4, PS5 - Hàng chính hãng - Màu",1480000,1480000,0,0
TIKI,thiet-bi-kts-phu-kien-so,26348659,"Tai Nghe Bluetooth True Wireless AMOI F9 5.0 Cảm Ứng Vân Tay, Nâng Cấp Dock Sạc có Led Báo Pin Kép - Hàng Nhập Khẩu",68000,99000,31000,31
TIKI,thiet-bi-kts-phu-kien-so,78887664,"Micro Bluetooth không dây Karaoke hút âm siêu nhẹ cao cấp PKCB cho điện thoại  - Hàng Chính Hãng",1018000,2550000,1532000,60
TIKI,thiet-bi-kts-phu-kien-so,56078706,"Ốp lưng dành cho Samsung A51 mẫu Tâm Chiếc Lá",42000,55000,13000,24
TIKI,thiet-bi-kts-phu-kien-so,29918892,"Bàn di chuột, miếng lót chuột khổ lớn kiêm thảm da trải bàn làm việc chống nước 120 X 60 CM",279000,279000,0,0
TIKI,thiet-bi-kts-phu-kien-so,97057394,"Sạc Dự Phòng Romoss Sense 4S  Mini Siêu Nhỏ 10000Mah 2 Cổng Sạc Vào-HÀNG CHÍNH HÃNG",159000,159000,0,0
TIKI,thiet-bi-kts-phu-kien-so,105548307,"Cáp sạc nhanh PD20W Baseus Rapid kết nối Type-C to iPhone/Type-C/Micro dây dù siêu bền dài 150CM cho Smartphone ( 2 màu ) - Hàng chính hãng",185000,185000,0,0
TIKI,thiet-bi-kts-phu-kien-so,136835705,"Bàn phím cơ DareU EK880 Black- HÀNG CHÍNH HÃNG",780000,780000,0,0
TIKI,thiet-bi-kts-phu-kien-so,57441768,"BAO CASE AIRPODS VỎ ỐP CHO TAI NGHE AIRPODS 1, AIRPODS 2, AIRPODS PRO",78000,99000,21000,21
TIKI,thiet-bi-kts-phu-kien-so,98822732,"Sạc dự phòng không dây nam châm Baseus PPCXW10 10000mAh Sạc Nhanh 20W Cho Iphone 12- Hàng chính hãng.",589899,589899,0,0
TIKI,thiet-bi-kts-phu-kien-so,96727277,"Ốp lưng kéo nắp camera dành cho iPhone 12 Mini / 12 / 12 Pro / 12 ProMax - Hàng chính hãng",39000,78000,39000,50
TIKI,thiet-bi-kts-phu-kien-so,32692753,"Đen nhám - Ốp lưng nhám siêu mỏng 0.3mm cho iPhone 11 (6.1 inch) hiệu Memumi có gờ bảo vệ camera - Hàng nhập khẩu - Xám ",84000,197998,113998,58
TIKI,thiet-bi-kts-phu-kien-so,122650000,"Bao da cao cấp dành cho iPhone 13 Pro Max dạng ví chính hãng Caseme - Hàng Nhập Khẩu",159000,159000,0,0
TIKI,thiet-bi-kts-phu-kien-so,174593880,"Chuột Không Dây Sạc Pin 2.4GHz PIX-LINK P1 Siêu Mỏng Không Gây Tiếng Ồn Sạc 1 Lần Dùng 1 Tuần Cho Laptop Macbook PC Tivi - Hàng Chính Hãng",74000,159000,85000,53
TIKI,thiet-bi-kts-phu-kien-so,52889826,"Tai Nghe Bluetooth Không Dây 5.0, AMOI F9, Cảm Ứng Vân Tay, Màn Led Báo Pin, Kháng Nước, Chống Ồn, Âm Thanh Cực Chất - Hàng Nhập Khẩu",75000,119000,44000,37
TIKI,thiet-bi-kts-phu-kien-so,98085825,"Bàn di chuột khổ Lớn XSmart Totoro Doremon Pubg – Lót Pad cỡ To 80x30 cm GIAO NGẪU NHIÊN - Hàng Chính Hãng",59000,59000,0,0
TIKI,thiet-bi-kts-phu-kien-so,68656265,"Máy Nghe Nhạc MP3 Ruizu M4 Bộ Nhớ Trong 16Gb - Màn Hình Cảm Ứng 1.8 Inch - Kết Nối Bluetooth 4.0 - Hàng Chính Hãng",547000,559000,12000,2
TIKI,thiet-bi-kts-phu-kien-so,190466757,"Loa đứng 2 tấc thùng sơn nhỏ gọn BellPlus HP - 660 BellPlus (hàng chính hãng)",1750000,1750000,0,0
TIKI,thiet-bi-kts-phu-kien-so,66681174,"Micro Bluetooth cao cấp PKCBK1  Chính Hãng",1056000,2200000,1144000,52
TIKI,thiet-bi-kts-phu-kien-so,75781229,"Đế Sạc Nhanh Không Dây Qi 5W Siêu Mỏng Cho Điện Thoại Thông Minh- Hàng Chính Hãng",89000,89000,0,0
TIKI,thiet-bi-kts-phu-kien-so,26129328,"Chuột game không dây Lightspeed RGB Logitech G703 - Cảm biến Hero 25k, tương thích PowerPlay, nhẹ 95g+10g cân tùy chỉnh, pin 60h, PC/Mac - Hàng chính hãng",1999000,1999000,0,0
TIKI,thiet-bi-kts-phu-kien-so,156205412,"Củ Sạc Siêu Nhanh 20W PD Cho iPhone, iPad, Samsung,... - Cốc Sạc Hoco C76 Pus/C76A Plus 3.0 Siêu Nhanh Siêu Bền - HÀNG CHÍNH HÃNG",89000,89000,0,0
TIKI,thiet-bi-kts-phu-kien-so,115529247,"Cáp usb C  0.5M 2 đầu bẻ góc 90 độ  Ugreen US20855CB176S - Hàng chính hãng",89000,89000,0,0
TIKI,thiet-bi-kts-phu-kien-so,149127116,"Bàn phím không dây Bluetooth Logitech K580 - Hàng chính hãng",999000,1299000,300000,23
TIKI,thiet-bi-kts-phu-kien-so,58227165,"Giá Đỡ Điện Thoại Từ Tính Kẹp Cửa Gió Trên Xe Ô Tô US04- Hàng Chính Hãng",99000,99000,0,0
TIKI,thiet-bi-kts-phu-kien-so,157446248,"Đầu Chuyển OTG Baseus Từ USB to Type-C - Hàng Chính Hãng",74000,74000,0,0
TIKI,thiet-bi-kts-phu-kien-so,104194942,"Pin Sạc Dự Phòng Aukey PB-N83S 10.000mAh, Sạc Nhanh Power Delivery 18W và Quick Charge 3.0 18W - Hàng Chính Hãng",440000,440000,0,0
TIKI,thiet-bi-kts-phu-kien-so,72567881,"Kính cường lực cho Samsung Galaxy S20 FE Nillkin Amazing CP+ Pro -Hàng nhập khẩu",129000,129000,0,0
TIKI,thiet-bi-kts-phu-kien-so,6938071,"Ốp lưng chống sốc Likgus cho iPhone XS MAX (chuẩn quân đội, chống va đập, chống vân tay) - Hàng chính hãng",88000,88000,0,0
TIKI,thiet-bi-kts-phu-kien-so,155367848,"Hub USB Type-C 9 in 1 cho Macbook, Laptop Remax RU-U91 - Hàng chính hãng",839000,1500000,661000,44
TIKI,thiet-bi-kts-phu-kien-so,105293037,"Dây Apple Watch 41mm 40mm 38mm, Chất Liệu Da Bò Cao Cấp, Dây Đeo Phong Cách Cổ Điển, Đơn Giản Và Tinh Tế, Tương Thích Các Phiên Bản Series 9/8/7/6/5/4/3/2/1/SE/SE2",981000,999000,18000,2
TIKI,thiet-bi-kts-phu-kien-so,113491072,"Đồng Hồ Thông Minh Định Vị GPS Chống nước | Nam Nữ | Gắn Sim 4G độc lập Model AMA Watch FA66 dành cho Trẻ em Học sinh Sinh viên Người lớn Hàng nhập khẩu",1435500,1900000,464500,24
TIKI,thiet-bi-kts-phu-kien-so,2589865,"Ốp Lưng Dẻo Trong Suốt Ultra Thin Cho Samsung Galaxy Note 8 - Hàng Chính Hãng",38000,38000,0,0
TIKI,thiet-bi-kts-phu-kien-so,162243912,"Ốp lưng silicon dẻo trong suốt cho iPhone 13 6.1 inch hiệu Ultra Thin siêu mỏng 0.6mm - Hàng nhập khẩu",29999,39000,9001,23
TIKI,thiet-bi-kts-phu-kien-so,190464353,"Ốp Case Chống Shock Dual dành cho Apple Watch- Hàng chính hãng",101000,105000,4000,4
TIKI,thiet-bi-kts-phu-kien-so,68579717,"Hộp/ Túi đựng sạc và phụ kiện Macbook Lucas - Hàng chính hãng",90000,90000,0,0
TIKI,thiet-bi-kts-phu-kien-so,43398433,"Ốp lưng da kính cao cấp dành cho iPhone XS Max - Màu đỏ - Hàng nhập khẩu - DELICATE",149000,150000,1000,1
TIKI,thiet-bi-kts-phu-kien-so,32694646,"Ốp lưng nhám siêu mỏng 0.3mm cho iPhone 11 Pro Max (6.5 inch) hiệu Memumi có gờ bảo vệ camera - Hàng nhập khẩu",68000,197998,129998,66
TIKI,thiet-bi-kts-phu-kien-so,46134973,"Máy Nghe nhạc Ruizu M9 - Hàng Chính Hãng",528000,550000,22000,4
TIKI,thiet-bi-kts-phu-kien-so,193708066,"Microphone Kingston HyperX QuadCast S RGB - Hàng Chính Hãng",3449000,3580000,131000,4
TIKI,thiet-bi-kts-phu-kien-so,4375273,"Ốp lưng dẻo dành cho iPhone 5 / iPhone 5s / iPhone SE Ultra Thin (Trong suốt) - Hàng chính hãng",34990,34990,0,0
TIKI,thiet-bi-kts-phu-kien-so,138492558,"MEMO DL05 - Quạt tản nhiệt điện thoại - Siêu lạnh, hiển thị nhiệt độ, LED RGB, Kẹp thu vào 2 chiều - Hàng Nhập Khẩu",242000,242000,0,0
TIKI,thiet-bi-kts-phu-kien-so,119988875,"Ốp lưng dẻo Silicone Samsung Galaxy A52 EF-PA525 - Hàng chính hãng",199000,199000,0,0
TIKI,thiet-bi-kts-phu-kien-so,187827249,"Kính Cường Lực KingKong Chính Hãng Full MÀN Chống Vỡ Viền cho 8Plus/X/XsMax/11ProMax/12ProMax - Hàng nhập khẩu",45000,45000,0,0
TIKI,thiet-bi-kts-phu-kien-so,178832757,"Bao da/ Case kiêm bàn phím Bluetooth cho iPad Gen 9 10.2 inch 2021 có Trackpad hiệu Nillkin - Hàng nhập khẩu",1299999,1690000,390001,23
TIKI,thiet-bi-kts-phu-kien-so,56078766,"Ốp lưng dành cho Samsung A50 / A50s mẫu Tâm Chiếc Lá",42000,55000,13000,24
TIKI,thiet-bi-kts-phu-kien-so,257186445,"Loa Soundbar SoundMax SB201  LED RGB. Bluetooth 5.0- Hàng chính hãng",415000,415000,0,0
TIKI,thiet-bi-kts-phu-kien-so,91189575,"Dây Audio 3.5mm dẹt, mạ vàng 1 đầu vuông 90 độ UGREEN AV119 - Hàng chính hãng",60000,65000,5000,8
TIKI,thiet-bi-kts-phu-kien-so,31525270,"Ốp lưng lụa dành cho iPhone XR chính hãng Memumi siêu mỏng 0.3mm",98999,98999,0,0
TIKI,thiet-bi-kts-phu-kien-so,40759252,"Dây Cáp Sạc USB-C to Lightning Chuẩn MFi Cho iPhone/iPad  HyperDrive - Hàng Chính Hãng",500000,500000,0,0
TIKI,thiet-bi-kts-phu-kien-so,63906398,"Túi chống sốc đựng iPad, máy tính bảng 2 ngăn kèm khe cắm bút, có quai xách nhiều size 8in, 9.7in, 10.2in, 10.5in, 11in - Hàng chính hãng",145000,145000,0,0
TIKI,thiet-bi-kts-phu-kien-so,160066063,"Bảng Vẽ Wacom Intuos M CTL-6100 - Hàng Chính Hãng",4028000,4028000,0,0
TIKI,thiet-bi-kts-phu-kien-so,29647758,"Dây Audio Chia Jack 3.5mm Ra 1 Tai Nghe 1 Mic Ugreen Màu Trắng Dây Dài 20cm - Hàng Chính Hãng",135000,135000,0,0
TIKI,thiet-bi-kts-phu-kien-so,487511,"Thẻ Nhớ Micro SD Samsung Evo Plus U1 32GB Class 10 - 95MB/s (Kèm Adapter) - Hàng Chính Hãng",149000,159000,10000,6
TIKI,thiet-bi-kts-phu-kien-so,19840068,"Giá đỡ, Kẹp điện thoại khe thông gió trên xe Ô tô/ xe hơi Mai Lee This is One - Hàng chính hãng",57000,57000,0,0
TIKI,thiet-bi-kts-phu-kien-so,136844157,"Ốp chống sốc XUNDD dành cho iPad mini 6 - Hàng Nhập Khẩu",224000,224000,0,0
TIKI,thiet-bi-kts-phu-kien-so,72025352,"Giá Đỡ Laptop Macbook Để Bàn Chất Liệu Hợp Kim Nhôm Cao Cấp – Nâng Hạ - Gấp Lại Kích Thước 26.5x23.5x5cm Hàng Chính Hãng",339000,339000,0,0
TIKI,thiet-bi-kts-phu-kien-so,193758074,"Củ loa bass SUb 3 tấc Hải Triều (hàng chính hãng (giá trên là 1 cái)",420000,420000,0,0
TIKI,thiet-bi-kts-phu-kien-so,126018708,"Ốp Lưng Nillkin CamShield Armor Cho iPhone 13 & 13 Pro / iPhone 13 Pro Max - Hàng Nhập Khẩu",299000,299000,0,0
TIKI,thiet-bi-kts-phu-kien-so,202482067,"Tai nghe HyperX Cloud EARBUDS II - Hàng Chính Hãng",899000,899000,0,0
TIKI,thiet-bi-kts-phu-kien-so,90116195,"Ốp lưng Nillkin Textured dành cho Samsung Note 10 Plus - Hàng chính hãng",158999,158999,0,0
TIKI,thiet-bi-kts-phu-kien-so,16406297,"Chuột gaming Corsair Harpoon RGB PRO - Hàng chính hãng",479000,479000,0,0
TIKI,thiet-bi-kts-phu-kien-so,88778118,"Chân Đế Giá Đỡ Laptop Cao Cấp Nillkin ProDesk Adjustable Stand cho Laptop Macbook / Laptop Surface / Laptop Asus / Laptop HP / Laptop Dell / Laptop Lenovo / Laptop LG / Laptop Acer / Laptop MSI - Hàng Nhập Khẩu",890000,890000,0,0
TIKI,thiet-bi-kts-phu-kien-so,110184737,"Ốp lưng chống sốc nút màu dành cho iPhone 12 / 12 Pro / 12 Pro Max / 12 Mini - Hàng chính hãng",79000,119000,40000,34
TIKI,thiet-bi-kts-phu-kien-so,13403347,"Bộ thu Bluetooth 4.2 cho Loa Và Amply cao cấp Ugreen - Hàng chính hãng",540000,540000,0,0
TIKI,thiet-bi-kts-phu-kien-so,41267299,"Ốp lưng dẻo chống sốc cao cấp dành cho iPhone 11 Pro Max - Màu hồng mờ",29000,49000,20000,41
TIKI,thiet-bi-kts-phu-kien-so,115529255,"Cáp HDMI 2.1  3M 2.1 8K 60Hz 48Gbps 4k 120 hz màu đen độ phân giải siêu Cao Ugreen HD80404W140 - Hàng chính hãng",260000,260000,0,0
TIKI,thiet-bi-kts-phu-kien-so,136061507,"Ốp lưng cho iPhone 13 Pro Max hiệu Likgus camera trong suốt (Không ố màu) chống sốc - Hàng nhập khẩu",69000,137992,68992,50
TIKI,thiet-bi-kts-phu-kien-so,75031093,"[VÒNG CAMERA 12] Bảo Vệ Camera giành cho IPhone 12 Pro Max, 12, 12PRO, 12Mini  FULLBOX- Hàng chính hãng",53000,109958,56958,52
TIKI,thiet-bi-kts-phu-kien-so,191770932,"Dây Da Classic Kai Leather dành cho Apple Watch- Hàng chính hãng",278000,290000,12000,4
TIKI,thiet-bi-kts-phu-kien-so,188043469,"Bao Case Ốp Vỏ Vệ Mèo Lina Bell dành cho Airpods 1/2/ Airpods Pro/ Airpods 3 Kèm khóa treo- Hàng Chính Hãng",89000,89000,0,0
TIKI,thiet-bi-kts-phu-kien-so,44808308,"Túi ví Silicone Đựng Card/Tiền Dán Điện Thoại - Baseus chính hãng",99999,99999,0,0
TIKI,thiet-bi-kts-phu-kien-so,185992274,"Bao Case ESR Tough Shock Armor Case dành cho AirPods 3 - Hàng Chính Hãng",278000,290000,12000,4
TIKI,thiet-bi-kts-phu-kien-so,91190848,"Dây cáp DisplayPort sang HDMI hỗ trợ phân giải 1920x1200 UGREEN DP101 - Hàng chính hãng",202000,220000,18000,8
TIKI,thiet-bi-kts-phu-kien-so,8389455,"Đầu đọc thẻ SD/TF USB type-C Ugreen 50704 - Hàng chính hãng",175000,190000,15000,8
TIKI,thiet-bi-kts-phu-kien-so,135284213,"Tai nghe có dây nhét tai Rockspace ES07 chuẩn cắm 3.5 có mic chơi game nghe nhạc - Hàng chính hãng bảo hành 1 năm",48000,75000,27000,36
TIKI,thiet-bi-kts-phu-kien-so,174547287,"Ốp lưng dành cho Xiaomi Redmi Note 11 5G - Redmi Note 11T - Redmi Note 11S mẫu Máy Đỏ 8",40000,55000,15000,27
TIKI,thiet-bi-kts-phu-kien-so,78010736,"Củ Sạc Điện Thoại Ô Tô 40W 2 Cổng Type C Tối Đa 20W CHOETECH C0054 - Hàng Chính Hãng",179000,390000,211000,54
TIKI,thiet-bi-kts-phu-kien-so,122909454,"Bao da dành cho iPhone 13 Pro Max hàng chính hãng Nillkin QIN có nắp trượt bảo vệ camera",149999,299998,149999,50
TIKI,thiet-bi-kts-phu-kien-so,189473795,"Loa kéo cột 4 tấc đôi thùng sơn cao cấp chuyên dành cho karaoke ngoài trời và trong nhà Hải Triều (hàng chính hãng)",6950000,6950000,0,0
TIKI,thiet-bi-kts-phu-kien-so,26098635,"Ốp lưng cứng Nillkin cho Samsung Note 10 Plus (Đen) - Hàng chính hãng",97000,97000,0,0
TIKI,thiet-bi-kts-phu-kien-so,192158249,"Dán cường lực GOR cho Đồng Hồ Garmin Fenix 7 / 7S / 7X / Garmin Epix Gen 2 - Hàng Nhập Khẩu",149000,149000,0,0
TIKI,thiet-bi-kts-phu-kien-so,44833263,"Bao da kiêm ví dành cho iPhone 11 Pro Max - Màu đen",239000,250000,11000,4
TIKI,thiet-bi-kts-phu-kien-so,121242752,"Bàn phím có dây Logitech K120-Hàng chính hãng",189000,189000,0,0
TIKI,thiet-bi-kts-phu-kien-so,186251538,"Ốp lưng Nillkin dành cho SamSung Galaxy A13 4G - A23 - A33 5G - A53 5G A73 5G dạng sần - hàng nhập khẩu",104999,104999,0,0
TIKI,thiet-bi-kts-phu-kien-so,141002060,"Dán Cường Lực Mặt Lưng dành cho iPhone 13/13 Mini/13 Pro Max GOR (Hộp 2 Miếng) - Hàng Nhập khẩu",129000,179000,50000,28
TIKI,thiet-bi-kts-phu-kien-so,80978113,"Ốp Lưng Silicon cho Google Pixel 5 trong suốt GOR - Hàng Nhập Khẩu",39000,39000,0,0
TIKI,thiet-bi-kts-phu-kien-so,73159057,"Pin sạc dự phòng sạc nhanh 22.5W dung lượng 20000 mAh hiệu Baseus Adaman Metal Digital Display cho Smartphone / Tablet / Laptop / Macbook - Hàng nhập khẩu",498000,498000,0,0
TIKI,thiet-bi-kts-phu-kien-so,56029744,"Hộp phụ kiện công nghệ SmileBox form cứng in hoa văn đựng tai nghe, cáp sạc, pin dự phòng, ổ cứng mini - Hàng chính hãng",71000,73600,2600,4
TIKI,thiet-bi-kts-phu-kien-so,117031899,"Cáp sạc UGREEN US355 Type-C sang Type-C - Hỗ trợ sạc nhanh PD 100W Dòng 5A - Hàng nhập khẩu chính hãng",360000,360000,0,0
TIKI,thiet-bi-kts-phu-kien-so,114119053,"Máy trợ giảng Không dây, Loa Bluetooth Aporo T18, hàng chính hãng",1097000,1097000,0,0
TIKI,thiet-bi-kts-phu-kien-so,14033757,"Cáp VGA, dây tín hiệu dùng cho màn hình máy tính, cáp màn hình máy tính hàng Chính Hãng",20000,27000,7000,26
TIKI,thiet-bi-kts-phu-kien-so,116962541,"Cáp sạc Baseus 60W USB C sang Type-C cho điện thoại",89100,99000,9900,10
TIKI,thiet-bi-kts-phu-kien-so,1939675,"Hub USB 3.0 Orico W5PH4-U3 4 Cổng - Hàng Chính Hãng",192000,192000,0,0
TIKI,thiet-bi-kts-phu-kien-so,93248723,"Giá Đỡ Điện Thoại Baseus Gắn Lỗ Điều Hòa Xe Hơi",199000,199000,0,0
TIKI,thiet-bi-kts-phu-kien-so,19345462,"Miếng Lót chuột chính hãng Dareu ESP 100 (350 x 300 x 5mm) - Hàng Chính Hãng",99000,99000,0,0
TIKI,thiet-bi-kts-phu-kien-so,48466163,"Bộ chuyển âm thanh TV 4K quang optical sang audio AV ra amply + Cáp optical Kiwi KA03 - Hàng chính hãng",107000,107000,0,0
TIKI,thiet-bi-kts-phu-kien-so,72308460,"Chuột không dây PROLiNK PMW5009 giá rẻ, tốc độ cao, tiết kiệm pin dành cho PC, Macbook, Laptop - Hàng chính hãng",119000,179000,60000,34
TIKI,thiet-bi-kts-phu-kien-so,162021343,"Ốp lưng Nillkin dạng sần - Hàng nhập khẩu - Xiaomi Redmi Note 10 Pro 4G , Redmi Note 10 Pro Max",99000,99000,0,0
TIKI,thiet-bi-kts-phu-kien-so,123833747,"DS-U320 - Webcam HIKVISION 2MP Full HD - Hàng chính hãng",450000,450000,0,0
TIKI,thiet-bi-kts-phu-kien-so,165024992,"Micro Karaoke Bluetooth Cao Cấp CV Aluminum Alloy Tích Hợp Loa Kép Stereo, Âm Thanh Đỉnh Cao, Âm Bass Cực Chất, Mic Nhạy, Hát Nhẹ Và Hay Như Ca Sĩ - Hàng Chính Hãng",980000,980000,0,0
TIKI,thiet-bi-kts-phu-kien-so,33599846,"Ốp lưng silicon chống sốc cho Samsung Galaxy Note 10 hiệu Likgus Crashproof (siêu mỏng, chống chịu mọi va đập, chống ố vàng) - Hàng nhập khẩu",86000,150000,64000,43
TIKI,thiet-bi-kts-phu-kien-so,134330265,"CHUỘT KHÔNG DÂY BT21 BABY VER 3 2021 CHỐNG ỒN KẾT NỐI 2 CÁCH-HÀNG CHÍNH HÃNG",289000,289000,0,0
TIKI,thiet-bi-kts-phu-kien-so,99540997,"Tai Nghe Kiểm Âm Audio Technica M20X - Studio Monitor Headphones Professional ATH-M20X ATHM20X Hàng Chính Hãng",1350000,1350000,0,0
TIKI,thiet-bi-kts-phu-kien-so,23198050,"Chuột Có Dây Vision G8 - Hàng Nhập Khẩu",44900,44900,0,0
TIKI,thiet-bi-kts-phu-kien-so,107478430,"Ốp lưng MEMUMI dành cho iPhone siêu mỏng 0.3mm  bảo vệ camera-hàng chính hãng",89999,179998,89999,50
TIKI,thiet-bi-kts-phu-kien-so,39146110,"Miếng Dán Kính Cường Lực Cho Oppo Reno 2F - Màu Đen - Full Màn Hình - Hàng Chính Hãng",20000,49996,29996,60
TIKI,thiet-bi-kts-phu-kien-so,20342347,"Cáp nối dài loa Ugreen 40675 dài 2m chính hãng hỗ trợ mic",139000,159000,20000,13
TIKI,thiet-bi-kts-phu-kien-so,183111275,"Loa bluetooth Edifier R1700BTS Qualcomm AptX HD Công suất 66W Đầu ra loa siêu trầm - Hàng chính hãng",2328000,2425000,97000,4
TIKI,thiet-bi-kts-phu-kien-so,56083269,"Ốp lưng dành cho Samsung Note 8 mẫu Tâm Chiếc Lá",42000,55000,13000,24
TIKI,thiet-bi-kts-phu-kien-so,23089030,"Combo Bàn Phím Giả cơ R8 1822 Tặng lót hình game lớn Kích thước 3 ly HN - HÀNG NHẬP KHẨU",197000,197000,0,0
TIKI,thiet-bi-kts-phu-kien-so,52674338,"Kính cường lực full màn hình Hoco G5 cho iPhone 11 6.1inch - Hàng chính hãng",24000,63774,39774,62
TIKI,thiet-bi-kts-phu-kien-so,108358329,"SẠC ĐA CỔNG PD/QC3.0 VÀ PPS HYPERJUICE 66W GAN CHARGER (2C1A) NHỎ NHẤT THẾ GIỚI – HJ265 - HÀNG CHÍNH HÃNG",1450000,1450000,0,0
TIKI,thiet-bi-kts-phu-kien-so,31521497,"Túi đựng phụ kiện nhiều ngăn vải Nylon chống thấm nước cho Cáp sạc di động, Sạc dự phòng, điện thoại, tai nghe, thẻ nhớ - Hàng chính hãng",28400,28400,0,0
TIKI,thiet-bi-kts-phu-kien-so,81437719,"Bao Da TPU Dành Cho iPad 10.2 inch/ Pro 10.5 inch/ Air 3 10.5 inch - Hàng Nhập Khẩu",108000,299998,191998,64
TIKI,thiet-bi-kts-phu-kien-so,68448273,"Máy Trợ Giảng Shidu M500 Kèm Micro Không Dây UHF Chống Hú  Công Suất Loa 10W Tích Hợp Cổng AUX, USB Dung Lượng Pin Lớn 1800mAh - Hàng Chính Hãng",795000,795000,0,0
TIKI,thiet-bi-kts-phu-kien-so,6076917,"Dây audio quang (Toslink Optical) đầu nhôm dài 1.5M UGREEN AV108 10542 (màu đen) - Hàng chính hãng",185000,185000,0,0
TIKI,thiet-bi-kts-phu-kien-so,116725239,"Chuột không dây Bluetooth, chuột máy tính HXSJ M107B chống ồn, DPI 1600, chế độ kép wireless usb 2.4Ghz, bluetooth chuyên dùng cho laptop, máy tính, tivi - Hàng chính hãng",249000,249000,0,0
TIKI,thiet-bi-kts-phu-kien-so,71102080,"Túi Đựng Phụ Kiện 2 Ngăn Lớn Cải Tiến Nhiều Ngăn Chống Nước, Chống Sốc – Túi Đựng Phụ Kiện Điện Thoại Chính Hãng Amalife",99000,99000,0,0
TIKI,thiet-bi-kts-phu-kien-so,105626412,"Máy Nghe Nhạc MP3/MP4 Ruizu H6 HĐH Android Màn Hình IPS Full HD 4inchs Bộ Nhớ Trong 16Gb Kết Nối Wifi - Bluetooth 5.0 Tích Hợp Loa Ngoài Hỗ Trợ Nghe FM, Ghi Âm, Xem Film - Hàng Chính Hãng",1159000,1159000,0,0
TIKI,thiet-bi-kts-phu-kien-so,116169514,"Cáp sạc và truyền dữ liệu cổng Type-c, dòng 3A UGREEN 60408 - Hàng nhập khẩu chính hãng",118000,166000,48000,29
TIKI,thiet-bi-kts-phu-kien-so,186961535,"Bộ sạc nhanh PROLiNK chuẩn USB 3.0, nhiều cổng (Type-C, A) dùng cho Điện thoại, iPad, Macbook, Nintendo Switch",235000,399000,164000,41
TIKI,thiet-bi-kts-phu-kien-so,6010061,"Dây Audio 3,5mm ra 2 đầu RCA (Hoa sen) dài 1,5M UGREEN AV116 10583 - Hàng Chính Hãng",96000,104000,8000,8
TIKI,thiet-bi-kts-phu-kien-so,165184212,"Ốp lưng dành cho Samsung S22 Ultra cao cấp - Hàng nhập khẩu Xundd",94997,94997,0,0
TIKI,thiet-bi-kts-phu-kien-so,188080564,"Dán Màn Hình Cường Lực dành cho Samsung A73 5G GOR (Hộp 2 Miếng) - Hàng Nhập Khẩu",99000,99000,0,0
TIKI,thiet-bi-kts-phu-kien-so,118053170,"2 LOA TREBLE RỜI LOA TĂNG TREBLE AT20 CHÍNH HÃNG - GIÁ 1 CẶP",135000,135000,0,0
TIKI,thiet-bi-kts-phu-kien-so,141755120,"Bộ sạc nhanh Baseus GaN3 Pro Quick Charger 65W (Type Cx2 + USB , PD3.0/ PPS/ QC4.0/ SCP/ FCP Multi Quick Charge Protocol, GaN2 Technology) hàng chính hãng",568899,568899,0,0
TIKI,thiet-bi-kts-phu-kien-so,178035466,"Phủ Phím Macbook Air/Pro 13 inch 2020 M1, Pro 14/16inch 2021 Innostyle (USA) - Hàng Chính Hãng",373000,389000,16000,4
TIKI,thiet-bi-kts-phu-kien-so,25468367,"Miếng Lót Chuột (24.5 x 20 cm) - Hàng Nhập Khẩu",14500,14500,0,0
TIKI,thiet-bi-kts-phu-kien-so,59383819,"Miếng đệm ốp tai nghe dùng cho tai nghe DareU VH350SE - Hàng Chính Hãng",62500,62500,0,0
TIKI,thiet-bi-kts-phu-kien-so,162087187,"Bao Da Dành Cho iPad Air 4 2020/ Air 5 ESR Ascend Trifold With Clasp - Hàng Chính Hãng",662000,690000,28000,4
TIKI,thiet-bi-kts-phu-kien-so,91189715,"Cáp sạc nhanh USB Type C PD hỗ trợ 100W UGREEN US316 US334 dài 1m 2m - Tương thích Macbook / iPad Pro / Laptop - Hàng chính hãng",129000,149000,20000,13
TIKI,thiet-bi-kts-phu-kien-so,75783152,"Đế Sạc Nhanh Không Dây Qi 10W Tiện DỤng Cho Điện Thoại Thông Minh- Hàng Chính Hãng",89000,89000,0,0
TIKI,thiet-bi-kts-phu-kien-so,95682864,"Túi Vải Đựng Phụ Kiện Dụng Cụ Tiện Ích Thời Trang SAKOS COMPACT - Hàng chính hãng",125000,249000,124000,50
TIKI,thiet-bi-kts-phu-kien-so,172406997,"Miếng Dán Kính Cường Lực Camera ESR Tempered-Glass Camera Lens cho iPhone 13 Mini / 13 / 13 Pro / 13 Pro Max - Hàng Chính Hãng",136000,136000,0,0
TIKI,thiet-bi-kts-phu-kien-so,487524,"Thẻ Nhớ Micro SD Samsung Evo Plus 64GB Class 10 - 100MB/s (Kèm Adapter) - Hàng Chính Hãng",179000,185000,6000,3
TIKI,thiet-bi-kts-phu-kien-so,6411043,"Cáp chuyển đổi micro HDMI đực sang HDMI cái dài 22cm UGREEN 20134 (màu đen) - Hàng chính hãng",88000,90500,2500,3
TIKI,thiet-bi-kts-phu-kien-so,28338127,"Cáp Nối Dài USB Orico U3-MAA01 USB 3.0 - Đen - Hàng Chính Hãng",59000,59000,0,0
TIKI,thiet-bi-kts-phu-kien-so,137255859,"Micro Karaoke Bluetooth Kèm Loa cao cấp kết nối Bluetooth, thẻ nhớ, USB pin sạc - Hàng chính hãng",309000,790000,481000,61
TIKI,thiet-bi-kts-phu-kien-so,73127366,"Bao da bò thật dạng ví chính hãng Caseme dành cho Samsung S10 5G - Hàng chính hãng",145000,145000,0,0
TIKI,thiet-bi-kts-phu-kien-so,43394470,"Ốp lưng da kính cao cấp dành cho iPhone 11 Pro Max - Màu đỏ - Hàng nhập khẩu - DELICATE",149000,150000,1000,1
TIKI,thiet-bi-kts-phu-kien-so,53196722,"Ốp lưng chống sốc toàn phần màu lá mạ dành cho iPhone 11 Pro",9000,18000,9000,50
TIKI,thiet-bi-kts-phu-kien-so,176420418,"Case Ốp Apple Watch UNIQ Valencia (40/41mm) dành cho Apple Watch Series 4,5,6,7, SE- Hàng chính hãng",479000,499000,20000,4
TIKI,thiet-bi-kts-phu-kien-so,28324579,"Pin Sạc AA Eneloop Pro 2550 mah Made In Japan - Hàng Chính Hãng ( Panasonic Việt Nam nhập khẩu và Phân Phối)",420000,420000,0,0
TIKI,thiet-bi-kts-phu-kien-so,13855296,"Cáp Displayport male to HDMI male Ugreen 10203",269000,269000,0,0
TIKI,thiet-bi-kts-phu-kien-so,42697787,"Loa vi tính Microlab MS212 - Hàng chính hãng",449000,449000,0,0
TIKI,thiet-bi-kts-phu-kien-so,55144012,"Ốp lưng chống sốc cho Samsung Galaxy Note 10 Plus hiệu Likgus (chuẩn quân đội, chống va đập, chống vân tay) - Hàng nhập khẩu",84549,84549,0,0
TIKI,thiet-bi-kts-phu-kien-so,174302200,"Tai Nghe Bluetooth nhét tai True Wireless Không Dây Wireless Headset chất lượng cao cấp, bền, đẹp, dễ vệ sinh màu đen - Hàng Chính Hãng PKCB",500000,500000,0,0
TIKI,thiet-bi-kts-phu-kien-so,152183994,"Phụ kiện bóp đựng cho máy chơi game Nintendo Switch OLED model",109000,109000,0,0
TIKI,thiet-bi-kts-phu-kien-so,275291245,"Ốp lưng da dành cho Samsung Galaxy Z Flip 3 , Z Flip 4, Z Flip 5 hiệu Caseme - Hàng nhập khẩu",150000,150000,0,0
TIKI,thiet-bi-kts-phu-kien-so,110931439,"Roto quạt B3_46 - B4_44 - B4_46 - B5_46 - roto - 3HT",15000,15000,0,0
TIKI,thiet-bi-kts-phu-kien-so,185092183,"Bàn phím cơ không dây E-DRA EK3187w - Hàng Chính Hãng",1039000,1039000,0,0
TIKI,thiet-bi-kts-phu-kien-so,159315470,"Ốp Lưng ESR Air Armor Clear dành cho iPhone 13 / 13 Pro / 13 Pro Max  - Hàng Chính Hãng",390000,390000,0,0
TIKI,thiet-bi-kts-phu-kien-so,182547103,"Case bao da leather chống sốc cho Samsung Galaxy Z Fold 3 trang bị ngăn đựng S-Pen hiệu Nillkin Aoge Leather Cover Case (bảo vệ máy cực tốt, chất liệu da thật cao cấp, thiết kế thời trang cá tính) - hàng nhập khẩu",314000,389000,75000,19
TIKI,thiet-bi-kts-phu-kien-so,90220235,"Cáp máy in 2M 2.0 USB A sang B đầu nhôm dây bọc lưới chống nhiễu màu Đen  Ugreen 80803 US369 Hàng chính hãng",113000,129000,16000,12
TIKI,thiet-bi-kts-phu-kien-so,170969410,"Cáp sạc nhanh, truyền dữ liệu tốc độ cao siêu bền Type C to IP Baseus Crystal Shine Series Fast Charging Data Cable 20W- Hàng chính hãng",91000,148000,57000,39
TIKI,thiet-bi-kts-phu-kien-so,186571680,"Bao da Caseme cao cấp dành cho Samsung Galaxy A13 - Hàng Nhập Khẩu",139000,139000,0,0
TIKI,thiet-bi-kts-phu-kien-so,97330074,"Tai Nghe Chống Ồn Cao Cấp XSmart T05 GTS PRO BASS khủng Driver Dynamic 14mm chiến hêt mọi loại game - Hàng Chính Hãng",89000,89000,0,0
TIKI,thiet-bi-kts-phu-kien-so,72047601,"Bộ 2 Kính Cường Lực GOR cho Asus ROG Phone 3 ZS661KL ( 2 Miếng full box ) _ Hàng Nhập Khẩu",98998,98998,0,0
TIKI,thiet-bi-kts-phu-kien-so,2775643,"Đế Tản Nhiệt Laptop N99 2 Fan - Hàng Nhập Khẩu",105000,113800,8800,8
TIKI,thiet-bi-kts-phu-kien-so,143529532,"Ốp Lưng Nillkin CamShield Armor Cho iPhone 13 / 13 Pro / iPhone 13 Pro Max - Hàng Nhập Khẩu",220000,295898,75898,26
TIKI,thiet-bi-kts-phu-kien-so,13453141,"Bàn phím cơ DareU EK1280 RGB "D" Switch - Hàng chính hãng",820000,820000,0,0
TIKI,thiet-bi-kts-phu-kien-so,8705375,"Cáp usb to RS232 chính hãng Unitek Y-105 - Hàng Chính Hãng",194000,198000,4000,2
TIKI,thiet-bi-kts-phu-kien-so,6010267,"Dây cáp Audio 3,5mm ra 2 đầu RCA (Hoa sen) dài 5M UGREEN AV116 10591 - Hàng chính hãng",163000,163000,0,0
TIKI,thiet-bi-kts-phu-kien-so,6583501,"Cáp Nối HDMI Orico V2.0 HD303-10-BK",81000,81000,0,0
TIKI,thiet-bi-kts-phu-kien-so,4757629,"Miếng dán kính cường lực iPhone XS Max Nillkin CP Max full màn hình vô cực - Hàng chính hãng",173000,353990,180990,51
TIKI,thiet-bi-kts-phu-kien-so,176295134,"Kính dán Cường Lực UNIQ OPTIX Clear Không viền siêu đẹp cho iPhone 13 Series - Hàng Chính Hãng",210000,219000,9000,4
TIKI,thiet-bi-kts-phu-kien-so,21276386,"Cáp USB Type C to USB 3.0 Ugreen 20884 dài 2m chính hãng ",130000,130000,0,0
TIKI,thiet-bi-kts-phu-kien-so,30745440,"Ốp Lưng Chống Sốc Kiểu Dáng Thể Thao Xundd Dành cho",107999,107999,0,0
TIKI,thiet-bi-kts-phu-kien-so,71656427,"Ốp Lưng Dẻo TPU Trong Suốt Dành Cho Iphone 12/ 12 Pro/ 12Promax/ SE 2020/ iPhone11/ 11Pro/ 11Promax/ X / XS/ XS Max / XR / 7 8 Plus. Hàng Chính Hãng Helios",17998,17998,0,0
TIKI,thiet-bi-kts-phu-kien-so,7180459,"Ốp lưng dẻo dành cho iPhone XR hiệu Nillkin (Trong suốt) - Hàng chính hãng - Hàng chính hãng",79000,79000,0,0
TIKI,thiet-bi-kts-phu-kien-so,8231320,"Dây cáp âm thanh AUX Audio 3.5mm Baseus M30 100cm - hàng chính hãng",87499,87499,0,0
TIKI,thiet-bi-kts-phu-kien-so,33395706,"Cáp USB Type C 2 đầu dương dài 1,5m kết nối sạc, truyền dữ liệu, hình ảnh 4K chính hãng Ugreen 50751",230000,250000,20000,8
TIKI,thiet-bi-kts-phu-kien-so,35443778,"Kính cường lực Nillkin CP+ PRO",117000,275998,158998,58
TIKI,thiet-bi-kts-phu-kien-so,131866600,"Dây Cáp Chuyển Đổi Âm Thanh Cho Iphone, Ipad Sang Cổng 3.5mm- AD169- Hàng Nhập Khẩu",38700,38700,0,0
TIKI,thiet-bi-kts-phu-kien-so,166503151,"Chuột Không Dây E-DRA EM604W - Hàng Chính Hãng",64000,69000,5000,7
TIKI,thiet-bi-kts-phu-kien-so,178605756,"Túi Đựng Phụ Kiện Công Nghệ Grepaco, Pin Sạc Dự Phòng, Điện Thoại, Cáp Sạc USB, Tai Nghe Vải Bố Canvas, Nhiều Ngăn, Có Quai Cầm, Chống Nước, Khóa Kéo YKK Dành Cho Nam Nữ Đi Học, Làm, Du Lịch - Hàng Chính Hãng",39000,39000,0,0
TIKI,thiet-bi-kts-phu-kien-so,22493613,"Ốp lưng cho Huawei P30 Lite - 01203 - Ốp dẻo trong - Hàng Chính Hãng",12000,12000,0,0
TIKI,thiet-bi-kts-phu-kien-so,76129068,"Bộ sạc nhanh đa năng thế hệ mới Baseus GaN2 Lite Travel Quick Charger 65W - Hàng Chính Hãng",598499,598499,0,0
TIKI,thiet-bi-kts-phu-kien-so,72750546,"Bộ 3 miếng dán màn hình cho Samsung Galaxy Watch 3 – chính hãng GOR",64000,64000,0,0
TIKI,thiet-bi-kts-phu-kien-so,102163459,"Jack av hoa sen PALIC khoá mạ va`ng (bắt vít) - Rắc AV Palic - rắc av hoa sen (đơn giá 1 chiếc)",49000,49000,0,0
TIKI,thiet-bi-kts-phu-kien-so,24998257,"Boya By-M1 mic thu âm cao cấp cho điện thoại, camera, máy tính ",247000,247000,0,0
TIKI,thiet-bi-kts-phu-kien-so,88794070,"Hub Adapter Chuyển Đổi Cổng USB Type C To VGA CHOETECH HUB-V01 1080P 60Hz - Hàng Chính Hãng",249000,490000,241000,49
TIKI,thiet-bi-kts-phu-kien-so,174096489,"Khăn lau màn hình đa năng dùng cho máy ảnh, tivi, điện thoại...17x20cm-Hàng nhập khẩu",15000,15000,0,0
TIKI,thiet-bi-kts-phu-kien-so,24029249,"Dây Dán Velcro Tiện Dụng 2M chính hãng UGREEN 40354 - Hàng Chính Hãng",125000,125000,0,0
TIKI,thiet-bi-kts-phu-kien-so,73770733,"Ốp cho iPhone 11/ 11 Pro/ 11 Pro Max - Silicon hãng Gor có gờ bảo vệ camera Hàng nhập khẩu",24000,49998,25998,52
TIKI,thiet-bi-kts-phu-kien-so,162085351,"Ốp lưng dành cho Samsung Galaxy S21 FE iron chống sốc kèm iring - Hàng nhập khẩu",88001,88001,0,0
TIKI,thiet-bi-kts-phu-kien-so,191780023,"Dây cáp sạc nhanh cho Iphone/Ipad bọc dù chống rối chống đứt cao cấp - Hàng chính hãng",15000,15000,0,0
TIKI,thiet-bi-kts-phu-kien-so,56027306,"Hộp túi phụ kiện công nghệ SmileBox form cứng đựng dây cáp sạc, tai nghe, bút cảm ứng Apple Pencil cầm tay nhỏ gọn- Hàng chính hãng",69000,69000,0,0
TIKI,thiet-bi-kts-phu-kien-so,192432383,"Case Silicon dành cho Airpods Pro 2/ Airpods 1,2/ Airpods Pro/ Airpods 3 Hình Gấu Brown_ Hàng Chính Hãng",72000,75000,3000,4
TIKI,thiet-bi-kts-phu-kien-so,360750,"Tay cầm chơi game console không dây Logitech F710 - USB 2.4Ghz, 4 phím di chuyển D-Pad, tương thích TV Android - Hàng chính hãng",980000,980000,0,0
TIKI,thiet-bi-kts-phu-kien-so,105611200,"Ốp lưng dành cho Xiaomi Xiaomi Redmi Note 10 - Redmi Note 10 Pro - mẫu Chim Công Nền Da",40000,55000,15000,27
TIKI,thiet-bi-kts-phu-kien-so,14660601,"Bộ 2 Micro có dây Arirang Mi 3.6C (Đen)- Hàng Chính Hãng",165000,165000,0,0
TIKI,thiet-bi-kts-phu-kien-so,193724549,"Bao da chống sốc cho Samsung Galaxy Tab A8 10.5 inch 2022 (SM-X200 / X205 / X207) hiệu HOTCASE thiết kế siêu mỏng hỗ trợ Smartsleep, gập nhiều tư thế, mặt da siêu mịn - hàng nhập khẩu",149000,149000,0,0
TIKI,thiet-bi-kts-phu-kien-so,40753981,"Micro HyperX QuadCast - Hàng chính hãng",2949000,2949000,0,0
TIKI,thiet-bi-kts-phu-kien-so,76217501,"Giá đỡ điện thoại, máy tính bảng, kim loại, dạng đặt bàn, kích thước 17.5x10.5x10.5cm dùng cho điện thoại, máy tính bảng UGREEN LP177 60343 - Hàng chính hãng",147000,160000,13000,8
TIKI,thiet-bi-kts-phu-kien-so,116584222,"Cáp sạc Type-C UGREEN US313 Sạc nhanh QC 2.0 3.0 Dòng 3A - Đầu vẻ vuông góc - Hàng nhập khẩu chính hãng",106000,115000,9000,8
TIKI,thiet-bi-kts-phu-kien-so,73117102,"Tai Nghe Bluetooth không dây True Wireless earbuds cảm ứng PKCB267 - Hàng chính hãng",152000,500000,348000,70
TIKI,thiet-bi-kts-phu-kien-so,196182793,"Cáp Sạc Thay Thế Nillkin dành cho Đồng Hồ Garmin Fenix / Forerunner  / Instinct / Vivoactive / Vivomove / Venu / Approach / Epix - Hàng Chính Hãng",199000,199000,0,0
TIKI,thiet-bi-kts-phu-kien-so,116024554,"Hub mở rộng 1 cổng ra 4 cổng USB 3.0 hãngUGREEN CM416 - Hàng nhập khẩu chính hãng",220000,220000,0,0
TIKI,thiet-bi-kts-phu-kien-so,55514631,"Bao da dành cho Samsung Galaxy Tab S6 Lite SM-P615 chính hãng ONJESS lưng silicon",188999,188999,0,0
TIKI,thiet-bi-kts-phu-kien-so,98026287,"Ốp lưng chống sốc Vân Sợi Carbon cho Realme 8, Realme 8 Pro - Hàng nhập khẩu",99000,99000,0,0
TIKI,thiet-bi-kts-phu-kien-so,26735584,"Kính Cường Lực Cho Samsung Galaxy A8 2018 - Màu Đen - Full Màn Hình - Hàng Chính Hãng",69158,72798,3640,5
TIKI,thiet-bi-kts-phu-kien-so,9993511,"Miếng dán cường lực camera iPhone X/XS/XS Max độ cứng 9h - Hàng Chính Hãng",49989,80000,30011,38
TIKI,thiet-bi-kts-phu-kien-so,193152491,"Tai nghe Sony MDR-7506 - Hàng Chính hãng",2850000,2850000,0,0
TIKI,thiet-bi-kts-phu-kien-so,182799605,"Gậy chụp hình tự sướng K07 kèm nút bluetooth điểu khiển từ xa hàng TiMa.lala - hàng chính hãng",87000,99000,12000,12
TIKI,thiet-bi-kts-phu-kien-so,184119273,"Bao da dạng ví dành cho Samsung Galaxy A73 5G Hanman có quai cài - Hàng chính hãng",129000,129000,0,0
TIKI,thiet-bi-kts-phu-kien-so,51065436,"Thiết bị định vị GPS quản lý xe, giám sát hành trình VIETMAP GSM-AT35L-Hàng chính hãng",1600000,1600000,0,0
TIKI,thiet-bi-kts-phu-kien-so,193559378,"Bao da dạng ví chính hãng Caseme dành cho SamSung Galaxy A33 - hàng nhập khẩu",130000,130000,0,0
TIKI,thiet-bi-kts-phu-kien-so,273284018,"Tai nghe nhét tai jack cắm type-C  có mic Baseus Encok C17 NGCR010002 - Hàng chính hãng",140000,140000,0,0
TIKI,thiet-bi-kts-phu-kien-so,81264856,"Cáp chuyển cổng QGeeM USB 3.1 Type C (Tương thích Thunderbolt 3) sang DP dài 1.2m 4K @ 60HZ, chuyển đổi USB C sang DP tương thích rộng rãi- Hàng chính hãng        ",244000,249000,5000,2
TIKI,thiet-bi-kts-phu-kien-so,137425557,"Dây cáp sạc type C sạc nhanh 100W Type-C to Type-C chuẩn PD 3.0 hiệu CHOETECH XCC-GY-1002 dài 180cm truyền data tốc độ cao 480Mbps (20V/5A, QC 4.0 & PD 3.0) sạc cho iPhone 15 pro max 15 plus ipad pro macbook samsung huawei oppo laptop  - hàng nhập khẩu",179000,179000,0,0
TIKI,thiet-bi-kts-phu-kien-so,195916281,"Thẻ Nhớ MicroSDXC SanDisk Extreme Pro V30 A2 512GB 200MB/s SDSQXCD-512G (New 2022) - Hàng Nhập Khẩu",1350000,1350000,0,0
TIKI,thiet-bi-kts-phu-kien-so,105611211,"Ốp lưng dành cho Xiaomi Xiaomi Redmi Note 10 - Redmi Note 10 Pro - mẫu Khủng Long Xanh",40000,55000,15000,27
TIKI,thiet-bi-kts-phu-kien-so,53452248,"Bao da bò thật dạng ví chính hãng Caseme dành cho Samsung Note 10 Lite ( A81 ) - Hàng chính hãng",120000,120000,0,0
TIKI,thiet-bi-kts-phu-kien-so,12618638,"[GIAO MÀU NGẪU NHIÊN] Tai Nghe Chụp Tai Kèm Mic Ovann X1 - HÀNG CHÍNH HÃNG",110900,110900,0,0
TIKI,thiet-bi-kts-phu-kien-so,85208543,"Bàn phím cơ Gaming DAREU EK810 Pink / Black (MULTI-LED, Blue/ Brown/ Red D switch)",470000,470000,0,0
TIKI,thiet-bi-kts-phu-kien-so,1998343,"Cáp Nối Dài Ugreen USB 2.0 10318 (5m) - Hàng Chính Hãng",115000,119000,4000,3
TIKI,thiet-bi-kts-phu-kien-so,88967997,"Túi Chống Sốc XP-Pen Cho Bảng Vẽ Điện Tử",195000,195000,0,0
TIKI,thiet-bi-kts-phu-kien-so,5762139,"Bút cảm ứng Adonit Mini 4 _ Đen Xám_ (Hàng chính hãng) ",650000,650000,0,0
TIKI,thiet-bi-kts-phu-kien-so,170823451,"Miếng dán màn hình InvisibleShield Ultra Clear dành cho Samsung Galaxy S22 series - Hàng chính hãng",180000,360000,180000,50
TIKI,thiet-bi-kts-phu-kien-so,19944026,"Bộ Chuyển Đổi Mạng LAN Ethernet 3.1 Type C to RJ45 10/100/1000 Gigabit CHOETECH HUB-R01 - Hàng Chính Hãng",299000,550000,251000,46
TIKI,thiet-bi-kts-phu-kien-so,110180962,"[Chính Hãng] Tai Nghe Phòng Thu Roland RH5 - Cho Nhạc Cụ, Đàn Piano, Organ, Trống, Amply Headphones Closed Back RH-5 Hàng Chính Hãng - Kèm Móng Gẩy DreamMaker",999000,999000,0,0
TIKI,thiet-bi-kts-phu-kien-so,56829336,"Cable USB in Kingmaster 1.5m ( 2.0) KM 042,3M KM043, 5M KM044, 10M KM045, CÁP MÁY IN, CÁP USB SỬ DỤNG CHO MÁY IN, CÁP USB, CÁP KẾT NỐI MÁY TÍNH VÀ MÁY IN-HÀNG CHÍNH HÃNG",85000,85000,0,0
TIKI,thiet-bi-kts-phu-kien-so,78622503,"Dây đeo Ringke Shoulder/Hand Strap điện thoại/tablet/máy ảnh - Hàng Chính Hãng",170000,200000,30000,15
TIKI,thiet-bi-kts-phu-kien-so,67956687,"Bộ Chia USB HUB ORICO CT2U3-10AB 10 Cổng USB 3.0 Với Các Cổng Riêng Lẻ- Hàng Chính Hãng",1139000,1139000,0,0
TIKI,thiet-bi-kts-phu-kien-so,124089282,"Tai Nghe Chụp Tai Có Mic Hoco W21 - Trẻ Trung, Âm Thanh Trung Thực, Chơi Game, Nghe Nhạc Cực Phê - Hàng Chính Hãng",132000,132000,0,0
TIKI,thiet-bi-kts-phu-kien-so,76148124,"Giá đỡ điện thoại để bàn có thể gập lại được UGREEN LP247 chất liệu nhựa ABS - Hàng chính hãng",91000,99000,8000,8
TIKI,thiet-bi-kts-phu-kien-so,17539156,"Loa Nghe nhạc USB, thẻ nhớ Craven 836 2pin (màu ngẫu nhiên) - hàng nhập khẩu",151802,154900,3098,2
TIKI,thiet-bi-kts-phu-kien-so,7823183,"Ốp lưng dẻo silicon dành cho Samsung Galaxy A9 2018 Ultra Thin (mỏng 0.6mm, Trong suốt) - Hàng chính hãng",38000,38000,0,0
TIKI,thiet-bi-kts-phu-kien-so,2045339,"Cáp Chuyển Đổi Ugreen MiniDP Sang HDMI 10461",140000,140000,0,0
TIKI,thiet-bi-kts-phu-kien-so,311940,"Hộp Đựng Tai Nghe / Cáp Sạc / Pin Sạc Dự Phòng / Ổ Cứng ORICO PHD-25",61000,61000,0,0
TIKI,thiet-bi-kts-phu-kien-so,56445715,"Chuột Văn Phòng, Chuột Game Có Dây A867 HXSJ - Hàng chính hãng",249000,249000,0,0
TIKI,thiet-bi-kts-phu-kien-so,54048692,"Ốp lưng dẻo silicon cho Samsung Galaxy S20 Plus hiệu Ultra Thin (siêu mỏng 0.6mm, chống trầy, chống bụi) - Hàng nhập khẩu",39000,39000,0,0
TIKI,thiet-bi-kts-phu-kien-so,19285345,"Máy Nghe Nhạc MP3 Ruizu X02 8GB - Hàng Chính Hãng",431000,449000,18000,4
TIKI,thiet-bi-kts-phu-kien-so,14050570,"Máy trợ giảng Takstar E126 (Hàng chính hãng)",450000,450000,0,0
TIKI,thiet-bi-kts-phu-kien-so,142471187,"Dây Cáp Sạc Nhanh Type C To C 60W Dài 1.8M, Dây Nylon Dù, Hỗ Trợ Sạc Nhanh iPhone 15 CHOETECH CC0005 H - Hàng Chính Hãng",99000,290000,191000,66
TIKI,thiet-bi-kts-phu-kien-so,15174570,"Bao Da Smart Case Gen2 TPU Dành Cho iPad Air 2",98000,289992,191992,66
TIKI,thiet-bi-kts-phu-kien-so,190318869,"Giá Đỡ Laptop Hợp Kim Nhôm Cao Cấp STA 100 Có Thể Gấp Gọn, Giúp Tản Nhiệt Laptop, Macbook, Máy Tính Xách Tay. 07 Vị Trí Điều Chỉnh Góc Độ - Hàng Chính Hãng",189000,189000,0,0
TIKI,thiet-bi-kts-phu-kien-so,41147065,"Loa Soundbar 100 USB Genius - Hàng chính hãng",229000,229000,0,0
TIKI,thiet-bi-kts-phu-kien-so,54375121,"Đầu chuyển Audio 6.5mm Male to RCA Female Vention VDD-C03 - Hàng chính hãng",59000,79000,20000,25
TIKI,thiet-bi-kts-phu-kien-so,77775158,"Ốp lưng chống sốc trong suốt siêu mỏng cho Samsung Galaxy Note 20 Ultra hiệu Likgus Crashproof giúp chống chịu mọi va đập - hàng nhập khẩu",78000,150000,72000,48
TIKI,thiet-bi-kts-phu-kien-so,74817859,"DÂY CÁP LOA RẮC 3.5 RA 2 AV 1.8 MÉT ĐỒNG NGUYÊN CHẤT HÀNG CHÍNH HÃNG",49000,49000,0,0
TIKI,thiet-bi-kts-phu-kien-so,31581227,"Chuột không dây Wireless FD V8",168900,168900,0,0
TIKI,thiet-bi-kts-phu-kien-so,14363347,"Tai Nghe Nhét Tai Super Bass BYZ SE519A Cao cấp - Hàng Nhập Khẩu",40800,40800,0,0
TIKI,thiet-bi-kts-phu-kien-so,32783934,"Ốp lưng dẻo silicon cho iPhone 11 Pro Max (6.5 inch) hiệu Ultra Thin (siêu mỏng 0.6mm, chống trầy, chống bụi) - Hàng nhập khẩu",35000,50000,15000,30
TIKI,thiet-bi-kts-phu-kien-so,9844714,"Dây cáp HDMI Unitek 3m Full HD độ phân giải 4K - Hàng Chính Hãng",93789,93789,0,0
TIKI,thiet-bi-kts-phu-kien-so,87986163,"Cảm biến nhiệt độ và độ ẩm Aqara temperature and humidity sensor WSDCGQ11LM",350000,549000,199000,36
TIKI,thiet-bi-kts-phu-kien-so,14114183," Gậy tự sướng bluetooth kiêm chân đế Yunteng VCT 1688 - HÀNG CHÍNH HÃNG",164000,164000,0,0
TIKI,thiet-bi-kts-phu-kien-so,111152877,"Kính cường lực cho Máy Tính Bảng Samsung  Tab A7 Lite T225 / Tab A7 T505",47999,90000,42001,47
TIKI,thiet-bi-kts-phu-kien-so,112350234,"Tai nghe chụp tai có dây RAPOO H120, jack cắm USB - Hàng chính hãng",246000,246000,0,0
TIKI,thiet-bi-kts-phu-kien-so,156219750,"Miếng phủ bàn phím bảo vệ dành cho MacBook Air 13 inch 2020 M1 hiệu INNOSTYLE (USA) KEYGUARD NAVIGATOR SHORTCUT - Hàng Chính Hãng",390000,390000,0,0
TIKI,thiet-bi-kts-phu-kien-so,115529306,"Jack chuyển USB type C bẻ góc 90 độ ra 3.5mm Headphone Audio Ugreen 154JC80384AV - Hàng chính hãng",78000,78000,0,0
TIKI,thiet-bi-kts-phu-kien-so,192978868,"Chuột không dây INPHIC M6P ROBOT kết nối bằng chip USB 2.4GHz thiết kế cực ngầu có đèn led báo hiệu dung lượng pin- JL- HÀNG CHÍNH HÃNG",195000,195000,0,0
TIKI,thiet-bi-kts-phu-kien-so,15173454,"Bao Da Smart Case Gen2 TPU Dành Cho iPad Air",124000,218000,94000,43
TIKI,thiet-bi-kts-phu-kien-so,22388156,"Ốp iPad XUNDD dành cho iPad mini 5 - Hàng Nhập Khẩu",219847,219847,0,0
TIKI,thiet-bi-kts-phu-kien-so,196515285,"Loa Nghe Nhạc Kết Nối Bluetooth Huqu HQ-BT Hình Bông Hoa -Hỗ Trợ Nghe Đài FM- Hàng Chính Hãng",430000,430000,0,0
TIKI,thiet-bi-kts-phu-kien-so,71049718,"Bao da bò thật dạng ví chính hãng Caseme dành cho Samsung Galaxy A71",124999,124999,0,0
TIKI,thiet-bi-kts-phu-kien-so,96650225,"Chuột Không Dây Gaming Led Siêu Đẹp XSmart Free Wolf X13 Premium Pin Sạc Dùng Siêu Trâu Cho Máy Tính, Laptop, Tivi - Hàng Chính Hãng",229000,229000,0,0
TIKI,thiet-bi-kts-phu-kien-so,183948336,"Bao da dành cho SamSung Galaxy A33 5G Dux Ducis Skin khung mềm - siêu mỏng - siêu mịn - Hàng chính hãng",180000,180000,0,0
TIKI,thiet-bi-kts-phu-kien-so,191592838,"Ốp lưng sần chống sốc cho Samsung Galaxy A73 5G mặt lưng nhám hiệu Nillkin Super Frosted Shield Pro cho khả năng chống sốc cực tốt, chất liệu cao cấp, mặt lưng nhám sang trọng - hàng nhập khẩu",124000,124000,0,0
TIKI,thiet-bi-kts-phu-kien-so,87717111,"Bộ 2 miếng dán màn hình full Samsung S21 Ultra hãng Gor - Hàng nhập khẩu",65000,65000,0,0
TIKI,thiet-bi-kts-phu-kien-so,28730935,"Xanh - Ốp lưng nhám siêu mỏng 0.3mm cho Samsung Galaxy Note 10 Plus hiệu Memumi có gờ bảo vệ camera - Hàng nhập khẩu",110000,110000,0,0
TIKI,thiet-bi-kts-phu-kien-so,72193419,"Bao da bò thật dạng ví chính hãng Caseme dành cho SamSung Galaxy S20 FE",158000,158000,0,0
TIKI,thiet-bi-kts-phu-kien-so,175196259,"Loa Vi Tính SoundMax A-828 2.1 20W - Hàng Chính Hãng",665000,665000,0,0
TIKI,thiet-bi-kts-phu-kien-so,48260129,"Cáp Lightning sang cổng âm thanh 3.5mm Ugreen 30756 US211 - hàng chính hãng",322000,350000,28000,8
TIKI,thiet-bi-kts-phu-kien-so,116962557,"Cáp sạc nhanh, truyền dữ liệu tốc độ cao Baseus Cafule Type C",107900,107900,0,0
TIKI,thiet-bi-kts-phu-kien-so,58184549,"Củ loa bass 25cm Hải Triều (hàng chính hãng)",550000,550000,0,0
TIKI,dien-gia-dung,48537880,"Ấm Siêu Tốc Inox SUNHOUSE HAPPY TIME HTD1055 (1.5L) - Hàng Chính Hãng",129000,190000,61000,32
TIKI,dien-gia-dung,72825272,"Máy Hút Bụi Cầm Tay Không Dây Damas XC628 - Chính Hãng",384000,850000,466000,55
TIKI,dien-gia-dung,52293499,"Máy Cạo Râu Xiaomi Enchen BlackStone 3 - Hàng Nhập Khẩu",254000,390000,136000,35
TIKI,dien-gia-dung,72286199,"Máy UỐN, ÉP, LÀ Tóc Đa Năng 3 Trong 1 Cao Cấp Sang Trọng Kiểu Hàn Quốc - Kết Hợp Duỗi, Uốn, Tạo Kiểu Tóc Thông Minh – Dùng Cho Salon Tóc & Tại Nhà – Chính Hãng VinBuy (Tùy Chọn 2 Màu Trắng Đen) - Đen",202000,400000,198000,50
TIKI,dien-gia-dung,273310816,"Máy Vắt Cam Lock&Lock EJJ231 (40W) - Hàng chính hãng",209000,452000,243000,54
TIKI,dien-gia-dung,72543784,"Máy Sấy Tóc Damas JT3377 (Chính Hãng) - Tay cầm gấp gọn tiện dụng, chế độ bảo vệ nguồn điện, tự động ngắt nguồn chống cháy thiết bị",120000,239000,119000,50
TIKI,dien-gia-dung,22095583,"Bàn Ủi Hơi Nước Nagakawa NAG1505 (1200W) - Hàng Chính Hãng",289000,595000,306000,51
TIKI,dien-gia-dung,33414955,"Tông đơ cắt tóc xiaomi Enchen Boost phiên bản mới 2020 hàng chính hãng",189000,208900,19900,10
TIKI,dien-gia-dung,79410098,"Nồi Cơm Điện Lock&Lock EJR716IVY 0.8L - Hàng Chính Hãng",885000,1703000,818000,48
TIKI,dien-gia-dung,186272720,"Quạt mini để bàn, quạt tích điện, quạt cầm tay chính hãng CWELL, động cơ không tiếng ồn, xoay 210 độ, pin khủng, bản mới",99000,149000,50000,34
TIKI,dien-gia-dung,35216213,"Máy cạo râu Xiaomi Enchen BlackStone - Hàng Nhập Khẩu",175000,299000,124000,41
TIKI,dien-gia-dung,48025254,"Máy Xay Sinh Tố Lock&Lock EJM436MIT (250W - 600ml) - Hàng chính hãng",477000,920000,443000,48
TIKI,dien-gia-dung,4701559,"Ấm Điện Thủy Tinh Siêu Tốc Có Điều Chỉnh Nhiệt Độ Lock&Lock EJK341 (1.8L) - Hàng chính hãng",541000,1145000,604000,53
TIKI,dien-gia-dung,630207,"Bình Đun Siêu Tốc Sunhouse HTD1088 (1.8 lít) - Hàng chính hãng",148000,220000,72000,33
TIKI,dien-gia-dung,20366631,"Bàn Ủi Hơi Nước Sunhouse SHD2063P (1600W) – Hàng Chính Hãng",219000,332000,113000,34
TIKI,dien-gia-dung,102432143,"Ấm Đun Siêu Tốc Inox 2 Lớp Sunhouse SHD1351 (1.8 Lít) - Hàng Chính Hãng",215000,422000,207000,49
TIKI,dien-gia-dung,3480333,"Bình Đun Siêu Tốc 2 lớp Lock&Lock EJK738WHT (1.7 Lít) - Trắng - Hàng chính hãng",377000,797000,420000,53
TIKI,dien-gia-dung,684651,"Ấm Siêu Tốc Inox Happy Time Sunhouse HTD1081 (1.8 lít)- Hàng chính hãng",138000,220000,82000,37
TIKI,dien-gia-dung,71159586,"Nồi Chiên Không Dầu Điện Tử Lock&Lock EJF296BLK (7.2 Lít) - Kèm Chảo Nướng - Hàng Chính Hãng",2200000,5625000,3425000,61
TIKI,dien-gia-dung,10597625,"Máy Xay Thịt 2 Lưỡi Dao Kép Lock&Lock EJM171 (2 Lít - 300W) - Hàng Chính Hãng",679000,1434000,755000,53
TIKI,dien-gia-dung,66663092,"Nồi điện đa năng phủ chống dính cao cấp - Nồi lẩu điện gia đình Bcook 1.8L - Hàng nhập khẩu",271000,539000,268000,50
TIKI,dien-gia-dung,66512832,"Máy Hút Bụi Lock&Lock ENV336BLK (400W) - Hàng Chính Hãng",1690000,3258000,1568000,48
TIKI,dien-gia-dung,185860447,"Nồi điện đa năng LocknLock 2 trong 1 nướng lẩu tối ưu 4 chế độ nhiệt (4 Lít)- EJP544WHT - Hàng chính hãng",1140000,2200000,1060000,48
TIKI,dien-gia-dung,54716577,"Bình Đun Siêu Tốc 2 Lớp Lock&amp;Lock EJK738BLK (1.7L)",412000,797000,385000,48
TIKI,dien-gia-dung,104850983,"Quạt mini để bàn, quạt USB tích điện cầm tay CTFAST - M109 : Thiết kế thông minh 3 tốc độ làm mát, chất liệu cao cấp bền bỉ, điều chỉnh 360 độ, không gây ồn, pin sạc 1200mah, dễ dàng mang theo sử dụng - hàng chính hãng",140000,199000,59000,30
TIKI,dien-gia-dung,36626940,"Nồi Chiên Không Dầu Điện Tử Lock&Lock EJF357BLK (5.2 Lít) - Hàng Chính Hãng",2190000,5215000,3025000,58
TIKI,dien-gia-dung,36785535,"Bếp Từ Đơn Lock&Lock EJI411 (2000W) - Hàng Chính Hãng",1140000,2188000,1048000,48
TIKI,dien-gia-dung,118137722,"Bàn ủi hơi nước cầm tay Lock&Lock ENI223WHT 1600W - Hàng chính hãng",767000,1477000,710000,48
TIKI,dien-gia-dung,794609,"Máy Nướng Bánh Mì Lock& Lock EJB221BLU (730 - 870 W) - Hàng chính hãng",541000,1043000,502000,48
TIKI,dien-gia-dung,59479717,"Máy sấy tóc Philips BHC010/10 - Hàng Chính Hãng",329000,395000,66000,17
TIKI,dien-gia-dung,68771348,"Nồi Cơm Điện Mini Lock&Lock EJR426 Dung Tích 0.8 lít (Hàng chính hãng)",569000,1000000,431000,43
TIKI,dien-gia-dung,4534531,"Máy Làm Sữa Chua Lock&Lock EJY110SLV (1000ml) - Hàng chính hãng",341000,658000,317000,48
TIKI,dien-gia-dung,392067,"Bàn Ủi Khô Philips HD1172/01 (1000W) - Hàng chính hãng",299000,369000,70000,19
TIKI,dien-gia-dung,147903536,"Bếp Từ Đơn Sunhouse SHD6803 (1800W) - Kèm Nồi Lẩu - Hàng Chính Hãng",859000,1187000,328000,28
TIKI,dien-gia-dung,22095571,"Bàn Ủi Khô Nagakawa NAG1502 (1200W) - Màu Ghi - Hàng Chính Hãng",145000,255000,110000,43
TIKI,dien-gia-dung,414764,"Lò Vi Sóng Sharp R-205VN(S) - 20L - Hàng chính hãng",1350000,1690000,340000,20
TIKI,dien-gia-dung,885374,"Bàn Ủi Hơi Nước Đứng Philips GC518 (1600W) - Xanh Ngọc - Hàng chính hãng",1340000,2159000,819000,38
TIKI,dien-gia-dung,11755648,"Bếp Đôi Điện Từ Hồng Ngoại Sunhouse SHB8609 (Tổng công suất 3600W) - Hàng chính hãng",2290000,3601000,1311000,36
TIKI,dien-gia-dung,166124677,"Máy sấy tóc mini CWELL 2 chiều nóng lạnh C02HD 1200W, bản ngắt nhiệt nhanh - Tặng đầu sấy tạo kiểu",95000,199000,104000,52
TIKI,dien-gia-dung,113271935,"Nồi Chiên Không Dầu Kết Hợp Chức Năng Hấp Lock&Lock EJF881BLK 7L",3120000,6490000,3370000,52
TIKI,dien-gia-dung,11413192,"Quạt Đứng Thân Sắt Senko DTS1607 (Hàng Chính Hãng) - Giao màu ngẫu nhiên",450000,450000,0,0
TIKI,dien-gia-dung,114535577,"Nồi Cơm Điện Tử Lòng Niêu BlueStone RCB-5949 1.5 Lít- Hàng chính hãng",1770000,2999000,1229000,41
TIKI,dien-gia-dung,127046577,"Quạt bàn Senko sang trọng cao cấp B1216 màu ngẫu nhiên - Hàng Chính Hãng",291000,291000,0,0
TIKI,dien-gia-dung,57921973,"Nồi Chiên Ngập Dầu Lock&Lock EJF716SLV (1.5 Lít) - Hàng chính hãng",719000,1385000,666000,48
TIKI,dien-gia-dung,104908436,"Quạt mini để bàn, quạt tích điện usb CTFAST M102 - Quạt cầm tay 3 tốc độ, điều chỉnh hướng gió 360 độ, không gây ồn, pin sạc dung lượng cao - hàng chính hãng",205000,240000,35000,15
TIKI,dien-gia-dung,273600804,"Quạt Kẹp Sạc Mini Tích Điện Comet CRF0705 (5W) - Hàng chính hãng",235000,329000,94000,29
TIKI,dien-gia-dung,900908,"Máy Xay Sinh Tố Đa Năng 4 Cối Kangaroo KG4B3 (380W) - Hàng chính hãng",790000,1320000,530000,40
TIKI,dien-gia-dung,77767851,"Máy lọc không khí SUNHOUSE SHD-15AP9715 (40W) - Hàng chính hãng",1099000,2030000,931000,46
TIKI,dien-gia-dung,37455760,"Máy Làm Sữa Hạt Đa Năng Bluestone SMB-7329 (1.3 Lít) - Hàng Chính Hãng",1500000,1999000,499000,25
TIKI,dien-gia-dung,157950027,"Máy lọc không khí nano và xông tinh dầu cho ô tô, văn phòng, phòng ngủ AirPOT - nhập khẩu trực tiếp từ Hàn Quốc",480000,693000,213000,31
TIKI,dien-gia-dung,20831735,"Lõi lọc nước số 1 Kangaroo thay thế cho các loại máy lọc RO - Hàng chính hãng",30000,37500,7500,20
TIKI,dien-gia-dung,53729264,"Nồi Cơm Điện Nắp Gài Nagakawa NAG0131 (1.2 Lít) - Hàng Chính Hãng",699000,1305000,606000,46
TIKI,dien-gia-dung,2386315,"Bếp Nướng Điện Lock&Lock Electric Grill EJG231 (2000W) - Hàng Chính Hãng",856000,1529000,673000,44
TIKI,dien-gia-dung,63564217,"Ấm sắc thuốc Trường An TA68 Vàng - Hàng chính hãng - Gốm sứ cao cấp - Điện gia dụng - Siêu thuốc - Siêu điện - Ấm sắc thuốc bằng điện - Dụng cụ nấu thuốc -Hàng Việt Nam chất lượng cao",545000,545000,0,0
TIKI,dien-gia-dung,558109,"Bộ Lọc Thay Thế Pureit - Hàng chính hãng",455900,470000,14100,3
TIKI,dien-gia-dung,42648351,"Máy Làm Sữa Đậu Nành Lock&Lock EJS226 (1.3 Lít) - Hàng Chính Hãng",1740000,3344000,1604000,48
TIKI,dien-gia-dung,106053875,"Robot Hút Bụi Lau Nhà LIECTROUX C30B- Hàng chính hãng.",3298000,3617000,319000,9
TIKI,dien-gia-dung,174186211,"Ấm Siêu Tốc Inox 2 Lớp DAMAS DK-6018B (1.8L) - Hàng Chính Hãng",405000,800000,395000,49
TIKI,dien-gia-dung,187938785,"Máy sấy tóc Philips BHC010/10 - Dễ dàng chăm sóc tóc - An toàn",388000,455000,67000,15
TIKI,dien-gia-dung,35597937,"Máy hút bụi mini cầm tay DEERMA DX118C - Giao màu ngẫu nhiên - Hàng chính hãng",489000,499000,10000,2
TIKI,dien-gia-dung,44996545,"Máy hấp thực phẩm đa năng 03 tầng Magic Korea A61 (10.5 lít) - Hàng Chính Hãng",470000,799000,329000,41
TIKI,dien-gia-dung,36627517,"Bếp Hồng Ngoại Lock&Lock EJI421 (2000W) - Hàng Chính Hãng",1200000,2306000,1106000,48
TIKI,dien-gia-dung,16934551,"Máy Cạo Râu Mạnh Mẽ Tiện Dụng Phong Cách SCW301U",86000,89000,3000,3
TIKI,dien-gia-dung,140950114,"Máy Xay Thịt ,Xay Đa Năng, máy xay sinh tố, máy xay ăn dặm cho bé BCOOK BC06 - HÀNG CHÍNH HÃNG",259000,319000,60000,19
TIKI,dien-gia-dung,60824784,"Máy Lọc Nước Pureit Classic Không Dùng Điện - Hàng Chính Hãng",1290000,2390000,1100000,46
TIKI,dien-gia-dung,73325952,"Máy vắt cam Lock&Lock EJJ256BLK 85W - Hàng chính hãng",695000,1338000,643000,48
TIKI,dien-gia-dung,78488079,"Quạt Điện Đứng Senko L1638 - Giao Màu Ngẫu Nhiên - Hàng Chính Hãng",367000,367000,0,0
TIKI,dien-gia-dung,56048866,"Lõi Lọc Diệt Khuẩn Cho Máy Lọc Không Khí Xiaomi Mi Air Purifier HEPA Filter Màu Xám - Hàng Chính Hãng",575000,575000,0,0
TIKI,dien-gia-dung,174666584,"Máy Uốn Tóc, Máy Ép Tóc, Duỗi Tóc Đa Năng Kiểu Hàn Quốc DAMAS DH6120 - Thiết kế với 4 mức nhiệt tùy chỉnh phù hợp với nhiều loại tóc khác nhau giúp duỗi thẳng, làm xoăn tóc chuẩn Salon ngay tại nhà mà không cần phải ra cửa tiệm - Hàng Chính Hãng",233000,450000,217000,48
TIKI,dien-gia-dung,108020412,"Máy hút chân không thực phẩm Shineye W230 tự động, hút khô và hút ướt với 2 chế độ hàn, tích hợp hàn độc lập, kiểm soát lực hút, hàng chính hãng",600000,600000,0,0
TIKI,dien-gia-dung,57790305,"Máy xay thịt, cá, xay đa năng B.COOK 2 lưỡi dao kép cối thủy tinh (350W) - Hàng chính hãng",279000,490000,211000,43
TIKI,dien-gia-dung,3577985,"Quạt Đứng Toshiba F- LSA20(W)VN (60W) - Trắng - Hàng chính hãng",1150000,1310000,160000,12
TIKI,dien-gia-dung,147903537,"Bếp Từ Đơn Sunhouse SHD6157 (1800W) - Kèm Nồi Lẩu - Hàng Chính Hãng",569000,1094000,525000,48
TIKI,dien-gia-dung,71111211,"TÔNG ĐƠ CẮT TÓC CHUYÊN NGHIỆP KEMEI- KM 809A",217000,228500,11500,5
TIKI,dien-gia-dung,242411227,"Máy Lọc Không Khí XIAOMI Mi Air Purifier 4 Lite Lọc Bụi Mịn Kết Nối App, Phù Hợp Không Gian 45 m2 - Hàng Chính Hãng",2689000,5199000,2510000,48
TIKI,dien-gia-dung,113633607,"Bếp từ đơn Hafele HSI-21FW (Hàng chính hãng)",1159000,2030000,871000,43
TIKI,dien-gia-dung,448842,"Máy Sấy Tóc Panasonic PAST-EH-ND11-W645 - Hàng Chính Hãng",300000,329000,29000,9
TIKI,dien-gia-dung,50722604,"Máy hút bụi cầm tay mini Deerma DX118C dung tích bình chứa bụi 1.2L - Hàng chính hãng",545000,560000,15000,3
TIKI,dien-gia-dung,2393139,"Nồi Lẩu Điện Sunhouse SHD4521 (3L) - Hàng chính hãng",415000,776000,361000,47
TIKI,dien-gia-dung,9483224,"Combo 3 lõi lọc nước Karofi 1,2,3 chính hãng",119000,134000,15000,11
TIKI,dien-gia-dung,2365901,"Nồi Cơm Nắp Gài Toshiba RC-10JFM(H)VN (1L) - Hàng chính hãng",519000,650000,131000,20
TIKI,dien-gia-dung,65221065,"Máy hút chân không tự động không kén túi P290B Hàng Nhập Khẩu",2200000,2200000,0,0
TIKI,dien-gia-dung,114750893,"Nồi Lẩu Mini 2 Tầng - Nồi Điện Đa Năng Tặng Kèm Khay Hấp Cao Cấp 1.2 Lít - Hàng Chính Hãng - Logo trên thân nồi hình ngẫu nhiên",143000,149000,6000,4
TIKI,dien-gia-dung,38041512,"Nồi Chiên Không Dầu Magic A-801 (6.0 Lít)",1250000,2590000,1340000,52
TIKI,dien-gia-dung,113643018,"Nồi Chiên Không Dầu Sunhouse SHD4026 (6 lít) - Hàng Chính Hãng",1840000,2790000,950000,34
TIKI,dien-gia-dung,900834,"Nồi Cơm Điện Kangaroo KG826S (1.2L) - Cam - Hàng chính hãng",650000,970000,320000,33
TIKI,dien-gia-dung,72285990,"Máy Sấy Tóc Cao Cấp Kiểu Dáng Sang Trọng Tinh Tế Công Suất Lớn Chuyên Dụng Tại Nhà và Cho Hair Salon - Máy Sấy Tóc Bổ Sung Ion Dưỡng Ẩm, Làm Mềm Mượt Tóc - Máy Sấy Tóc Cao Cấp Động Cơ Êm Ái, Ổn Định – Chính Hãng VinBuy (Máy sấy tóc)",195000,350000,155000,44
TIKI,dien-gia-dung,74173695,"Bộ Lọc Thay Thế Pureit Classic - Hàng chính hãng",455900,470000,14100,3
TIKI,dien-gia-dung,6774373,"Máy Xay Sinh Tố Đa Năng Sunhouse HappyTime HTD5113G (Xanh) 350W - Hàng chính hãng",289000,590000,301000,51
TIKI,dien-gia-dung,275189129,"Máy ép chậm, máy ép trái cây Mitomo EC-55 hàng chính hãng - Màu trắng",979000,1320000,341000,26
TIKI,dien-gia-dung,109393205,"Máy xay sinh tố cầm tay mini, cốc xay sinh tố đa năng CTFAST - JUICER 01 (50W - 300ml) : Thiết kế cảm ứng tự động, cốc xay thủy tinh an toàn tuyệt đối khi sử dụng, pin sạc 1500 mAh - Hàng chính hãng",195000,199000,4000,2
TIKI,dien-gia-dung,20831639," Bộ lõi lọc nước Kangaroo số 1, 2, 3 Hàng chính hãng",83000,92000,9000,10
TIKI,dien-gia-dung,650250,"Máy Hấp Thực Phẩm Magic Korea A64 (5.0 Lít) - Hàng chính hãng",329000,499000,170000,34
TIKI,dien-gia-dung,126131828,"Máy cạo râu lưỡi kép 3 mức tốc độ Kemei KM-2026 màn hình LCD, công suất 5w mạnh mẽ dùng cạo trắng fade tóc, cạo trọc đầu tặng kèm lưỡi dự phòng",350000,350000,0,0
TIKI,dien-gia-dung,53758851,"Bình Đun Siêu Tốc 2 Lớp Nagakawa NAG0315 (1.8 Lít)",390000,690000,300000,43
TIKI,dien-gia-dung,1695753,"Máy Sấy Tóc Philips HP8108/00 - Hàng Chính Hãng",249000,291000,42000,14
TIKI,dien-gia-dung,2394877,"Bếp Gas Hồng Ngoại Đôi Sunhouse SHB004MT - Hàng chính hãng",609000,871000,262000,30
TIKI,dien-gia-dung,20701352,"Quạt bàn Senko B102 (giao màu ngẫu nhiên) - Hàng Chính Hãng",240000,240000,0,0
TIKI,dien-gia-dung,190860235,"Nồi chiên không dầu đa chức năng 12 trong 1 Sunhouse SHD4087 (6.0 Lít) - Hàng chính hãng",1659000,3590000,1931000,54
TIKI,dien-gia-dung,4526261,"Quạt đứng Senko DTS1607 - Hàng chính hãng",450000,450000,0,0
TIKI,dien-gia-dung,161017652,"Máy Hút Bụi Cầm Tay Không Dây Sử Dụng Pin Sạc DAMAS Vacuum Cleaner D610W - Hàng Chính Hãng",579000,950000,371000,39
TIKI,dien-gia-dung,984199,"Máy Sấy Tóc Ion Panasonic PAST-EH-NE81-K645 - Hàng Chính Hãng",1180000,1180000,0,0
TIKI,dien-gia-dung,81676555,"Bàn Ủi Hơi Nước Philips STH3010/70 (1000W) - Hàng Chính Hãng",791000,1199000,408000,34
TIKI,dien-gia-dung,658092,"Quạt treo tường 2 dây SENKO TC1626 - Hàng Chính Hãng",355000,355000,0,0
TIKI,dien-gia-dung,170658293,"Máy cắt tỉa lông mũi Panasonic ER-GN30-K453 - Hàng chính hãng",380000,419000,39000,9
TIKI,dien-gia-dung,70832055,"Máy Cạo Râu Panasonic ES534DP527 - Hàng Chính Hãng",239000,269000,30000,11
TIKI,dien-gia-dung,76016726,"Bộ 3 Lõi Lọc Số 1 RO KAROFI KRF-L1 - Hàng Chính Hãng",132000,169000,37000,22
TIKI,dien-gia-dung,8073003,"Bàn Ủi Hơi Nước không dây Bluestone SIB-3854 (2400W) - Hàng chính hãng",699000,899000,200000,22
TIKI,dien-gia-dung,183484077,"Nồi Lẩu Điện Mini 2 Mức Nhiệt - Ca Nấu Mì Điện Đa Năng DAMAS DK-8012 (1.2 Lít) - Hàng Chính Hãng",235000,500000,265000,53
TIKI,dien-gia-dung,107223590,"Máy cắt tỉa lông mũi Xiaomi ShowSee C1-BK - Hàng Nhập Khẩu",135000,155000,20000,13
TIKI,dien-gia-dung,63560677,"Ấm sắc thuốc Trường An TA68 Nâu - Hàng chính hãng",545000,545000,0,0
TIKI,dien-gia-dung,6772415,"Lò Nướng Điện Sunhouse SHD4206 (10L) - Hàng chính hãng",489000,786000,297000,38
TIKI,dien-gia-dung,166524882,"Máy sấy tóc mini, máy sấy tóc CameWell 1000W-1200W, sấy 2 chiều nóng lạnh, ánh sáng xanh CW01HD",129000,189000,60000,32
TIKI,dien-gia-dung,78625780,"Quạt điện Senko để bàn tiện lợi cao cấp B1216 màu ngẫu nhiên - Hàng Chính Hãng",291000,291000,0,0
TIKI,dien-gia-dung,456050,"Nồi Cơm Điện Nắp Gài Sharp KS-181TJV - 1.8 L - Hàng chính hãng",540000,899000,359000,40
TIKI,dien-gia-dung,57588479,"Máy Lọc Không Khí Lock&Lock ENP126WHT (23W) - Hàng Chính Hãng",2100000,4045000,1945000,48
TIKI,dien-gia-dung,185248203,"Máy Xay Đồ Ăn Dặm Cho Bé 6 Lưỡi Cối Thuỷ Tinh Hàng Nội Địa Trung Bản Cao Cấp Siêu Mịn Tiện Dụng - Tặng Kèm Dụng Cụ Rửa Máy-Hàng Chính Hãng",249000,249000,0,0
TIKI,dien-gia-dung,27577963,"Nồi Điện Đa Năng Lock&Lock EJC141 (1.5 Lít) - Hàng Chính Hãng",1080000,2073000,993000,48
TIKI,dien-gia-dung,87960372,"Lò Nướng Chân Không Điện Tử Lock&Lock EJF291BLK 10L - Hàng Chính Hãng",2710000,6180000,3470000,56
TIKI,dien-gia-dung,15398266,"Máy Xay Sinh Tố Mini Hafele GS-621 (350W) - Hàng Chính Hãng",589000,1010000,421000,42
TIKI,dien-gia-dung,73230349,"Nồi cơm điện Kim Cương 0.6L - KC-0.6L - Hàng chính hãng",239000,239000,0,0
TIKI,dien-gia-dung,134333386,"Nồi áp suất điện tử Lock&Lock EJP666SLV 6 Lít - Hàng chính hãng",2000000,3841000,1841000,48
TIKI,dien-gia-dung,132847951,"Bếp Gas Dương Đôi Kangaroo KG8G1A - Hàng Chính Hãng",690000,970000,280000,29
TIKI,dien-gia-dung,11502504,"Máy xay thịt osaka japan new 2019 - Hàng Chính Hãng",149900,149900,0,0
TIKI,dien-gia-dung,169561154,"Tông Đơ Cắt Tóc Chuyên Nghiệp Kemei 809A, Tích Hợp Pin 2600 mAh Sử Dụng 240 phút Công Suất 5W, Đèn Led Hiện Dung Lượng Pin, Lưỡi Cắt Titatium, Động Cơ Hạn Chế Tiếng Ồn - HÀNG CHÍNH HÃNG",218000,229000,11000,5
TIKI,dien-gia-dung,253190854,"Nồi Chưng Yến, Nồi Tiềm Thuốc Bắc, Nồi Nấu Chậm BEAR SUBE001 Kèm Lồng Hấp Dung Tích 0.8 Lít, Công Suất 200 W - Hàng Chính Hãng",421300,421300,0,0
TIKI,dien-gia-dung,162841495,"Máy cạo râu khô và ướt Philips S1103/02 - Hàng Chính Hãng",499000,790000,291000,37
TIKI,dien-gia-dung,68942787,"Tông Đơ Cắt Tóc Kemei KM 5017 - Tặng Kèm Bộ Kéo Cắt Và Tỉa Tóc Không Gỉ Và Lược",299000,350000,51000,15
TIKI,dien-gia-dung,2635459,"Quạt Treo Tường Toshiba F-WSA20(H)VN (55W) - Xám - Hàng chính hãng",1020000,1220000,200000,16
TIKI,dien-gia-dung,48972911,"Tông đơ cắt tóc chuyên nghiệp thế hệ mẫu mã kiểu dáng mớiKemei KM1998",394000,394000,0,0
TIKI,dien-gia-dung,2241935,"Cây Nước Nóng Lạnh Sunhouse SHD9601 - Hàng chính hãng",979000,1600000,621000,39
TIKI,dien-gia-dung,27577966,"Máy Xay Sinh Tố Lock&Lock EJM462 (350W - 1.2 Lít) - Hàng Chính Hãng",887000,1723000,836000,49
TIKI,dien-gia-dung,178462936,"Máy cạo râu du lịch Philips PQ206",345000,425000,80000,19
TIKI,dien-gia-dung,162177652,"Nồi Chiên Không Dầu Sunhouse SHD4027 (6 Lít) - Hàng chính hãng",1059000,2590000,1531000,59
TIKI,dien-gia-dung,26031273,"Máy ép chậm Panasonic MJ L500 - Hàng nhập khẩu",4899000,4899000,0,0
TIKI,dien-gia-dung,174085836,"Máy Cạo Râu KM-6650 Đa Năng 4 Trong 1 Tích Hợp Pin 1400 mAh Công Suất 3W Kiêm Tông Đơ Cắt Tóc & Máy Tỉa Lông Mũi -HÀNG CHÍNH HÃNG",175000,350000,175000,50
TIKI,dien-gia-dung,109298151,"Máy Pha Cà Phê KONKA KCFCS2 Thiết Kế Kiểu Mới Hiện Đại, Sang Trọng - Hàng nhập khẩu",407000,485000,78000,16
TIKI,dien-gia-dung,178462954,"Máy cạo râu du lịch cầm tay Philips S1301/02 - Chính hãng",1051000,1155000,104000,9
TIKI,dien-gia-dung,91978576,"Nồi cơm điện áp suất Cuckoo CRP-PK1000S 1,8 lít nhiều màu - Hàng chính hãng",3590000,4990000,1400000,28
TIKI,dien-gia-dung,7270329,"Bếp Gas Dương Mặt Kính Sunhouse SHB204MT - Hàng chính hãng",642000,1023000,381000,37
TIKI,dien-gia-dung,102431931,"Ấm Đun Siêu Tốc Inox 2 Lớp Sunhouse SHD1353 (1.8 Lít) - Hàng Chính Hãng",255000,461000,206000,45
TIKI,dien-gia-dung,73090080,"Máy hút bụi cầm tay Karcher VCH 2",891000,990000,99000,10
TIKI,dien-gia-dung,163825477,"Nồi Hấp Điện Đa Năng 3 Tầng Braburg- Hàng Chính Hãng",533000,890000,357000,40
TIKI,dien-gia-dung,51998725,"Tông đơ cắt tóc chuyên nghiệp kemei 809A",227600,280000,52400,19
TIKI,dien-gia-dung,130412385,"Bàn Là Ủi Áo Quần Hơi Nước Cầm Tay Tiện Lợi Loại 1 Hàng Chính Hãng MINIIN- Là Được Tất Cả Loại Vải- Gấp Gọn Tiện Dụng",384000,384000,0,0
TIKI,dien-gia-dung,137851814,"Quạt sạc đa năng Comet CRF1406 có đèn Led, pin Lithium 2 viên x 1500 mAh - Hàng chính hãng",349000,349000,0,0
TIKI,dien-gia-dung,2498045,"Quạt Điện Đứng 7 cánh Senko LTS1636 - Giao Màu Ngẫu Nhiên - Hàng Chính Hãng",419000,419000,0,0
TIKI,dien-gia-dung,3611017,"Bếp Nướng Điện Kangaroo KG699G 2000W - Hàng chính hãng",539000,940000,401000,43
TIKI,dien-gia-dung,127907978,"Nồi cơm điện mini Chigo 0.8L - CFXB15E dùng cho 1-2 người ăn công suất 350W nấu nhanh ruột chống dính 5 lớp - Hàng Chính Hãng",439000,800000,361000,45
TIKI,dien-gia-dung,403438,"Máy Làm Bánh 3 Trong 1 Tiross TS513 (750W) - Hàng Chính Hãng",729000,790000,61000,8
TIKI,dien-gia-dung,187345103,"Máy hút bụi không dây Lock&lock ENV356GRY đa năng cầm tay 3 trong 1 (lau sàn, hút bụi, hút bụi giường nệm), động cơ BLDC - Hàng chính hãng",5150000,9900000,4750000,48
TIKI,dien-gia-dung,184973099,"Máy Hút Bụi Cầm Tay Không Dây VinBuy Lực Hút Mạnh Mẽ 16000PA Chức Năng Hút Bụi Khô Và Ướt - Máy Hút Bụi Ô Tô, Máy Hút Bụi Gia Đ��nh - Hàng Chính Hãng",341000,750000,409000,55
TIKI,dien-gia-dung,173550857,"Máy ép chậm Elmich JEE - 1855OL - Hàng chính hãng (New)",1750000,3890000,2140000,55
TIKI,dien-gia-dung,795679,"Quạt Bàn Đảo 2 Tấc Senko BD230 (27W)",230000,230000,0,0
TIKI,dien-gia-dung,133815741,"Nồi Lẩu Điện Mini Núm Xoay 2 Nấc Nhiệt Kèm Giá Hấp 1,8L, Ca Nấu Mì,Nấu Cơm Đa Năng 2 Tầng Cao Cấp- Chính Hãng MINIIN",169000,169000,0,0
TIKI,dien-gia-dung,137543567,"Máy làm sữa hạt xay nấu UNIE V8S công suất 1800W dung tích 1.75L - Hàng chính hãng",2890000,5290000,2400000,45
TIKI,dien-gia-dung,532619,"Ấm Siêu Tốc Inox Sunhouse SHD1186 - 1.8L - Hàng chính hãng",169000,270000,101000,37
TIKI,dien-gia-dung,169604123,"Tông Đơ Cắt Tóc Cao Cấp KEMEI 809C Loại Có Dây, Công Suất 12W, Máy Hớt Tóc Gia Đình Salon Chuyên Nghiệp, Lưỡi Cắt Titatium, Động Cơ Hạn Chế Tiếng Ồn - HÀNG CHÍNH HÃNG",238000,416000,178000,43
TIKI,dien-gia-dung,158746240,"Máy Hút Bụi Công Nghiệp Hút Khô Và Ướt USA Stanley SL19417P-6A - 23 lít/ Công suất 4000W (5.5HP) - Hàng Chính Hãng",1790000,1790000,0,0
TIKI,dien-gia-dung,74594174,"Nồi Chiên Không Dầu Philips HD9200/90 (4.1 Lít) - Hàng Chính Hãng",1350000,2850000,1500000,53
TIKI,dien-gia-dung,14035043,"Len Sợi Đan Móc Cuộn 50gr Bao Gồm 42 Màu , Len Milk Cotton BOBO Mềm Mịn Sợi To 2mm Dành Cho Người Mới Bắt Đầu Rất Thích Hợp Móc Thú Len, Thêu Len Xù Punch Needle",25000,25000,0,0
TIKI,dien-gia-dung,1460199,"Bếp Nướng Điện Sunhouse SHD4607 (1500W) - Hàng chính hãng",400000,599000,199000,33
TIKI,dien-gia-dung,92514179,"Len milk hàn cuộn 25g - Bảng màu 1",17000,17000,0,0
TIKI,dien-gia-dung,171873643,"Bếp Hồng Ngoại Perfect PF-BH82 (2200W) - Hàng chính hãng",576000,1090000,514000,47
TIKI,dien-gia-dung,14678375,"Quạt đứng Toshiba F-LSD10(W)VN (30W) - Hàng chính hãng",1590000,1820000,230000,13
TIKI,dien-gia-dung,50247154,"Lõi lọc nước Toshiba F-1643-C1 - Hàng chính hãng",184000,190000,6000,3
TIKI,dien-gia-dung,50367048,"Máy hút bụi đệm giường, chăn nệm Deerma CM800 diệt khuẩn bằng tia UV ( hàng nhập khẩu )",679000,689000,10000,1
TIKI,dien-gia-dung,91625551,"Ấm Đun Siêu Tốc Hafele T-602C - 535.43.732 - 1,7L (Hàng chính hãng)",699000,1120000,421000,38
TIKI,dien-gia-dung,182144472,"Máy pha cà phê HiBREW H11 pha cafe espresso bán tự động, mini nhỏ gọn cho gia đình, văn phòng, hot and cold đặc biệt, tặng kèm tấm lót, temper và ca đánh sữa 350ml, hàng chính hãng",3590000,3590000,0,0
TIKI,dien-gia-dung,426283,"Bàn Ủi Khô Panasonic NI-317TXRA – Xanh Lá - Hàng chính hãng",440000,480000,40000,8
TIKI,dien-gia-dung,58477448,"Máy hút bụi giường Tiross TS9305 (400W) - Hàng chính hãng",1950000,2490000,540000,22
TIKI,dien-gia-dung,113457048,"Nồi chiên không dầu LocknLock EJF284BLK (5.5 Lít) - Hàng chính hãng",2300000,5355000,3055000,57
TIKI,dien-gia-dung,392729,"Máy Ép Trái Cây Philips HR1811 (300W) - Trắng Xanh - Hàng chính hãng",850000,1449000,599000,41
TIKI,dien-gia-dung,82605430,"Khay Silicone Dành Cho Nồi Chiên Không Dầu Và Lò Vi Sóng Lock&Lock CKB003PIK - Màu",197000,330000,133000,40
TIKI,dien-gia-dung,523883,"Máy Xay Sinh Tố Cầm Tay DAEWOO DEB-JZ150 (150W) - Trắng Xanh - Hàng chính hãng",250000,459000,209000,46
TIKI,dien-gia-dung,60710348,"Siêu sắc thuốc điện tự động ngắt Fujika K7, cống suất 450W, dung tích 3L, tự động ngắt-hàng chính hãng",217000,224000,7000,3
TIKI,dien-gia-dung,496573,"Siêu Sắc Thuốc Tự Động Trường Thọ BA2086 - Vàng Kem- Hãng chính hãng",310000,310000,0,0
TIKI,dien-gia-dung,70591134,"Máy Hút Chân Không Không Kén Túi Shineye P290A, Hút Khô và Hút Ướt, Công Suất Mạnh Mẽ 220W, Tặng Kèm 10 Túi Hút Chân Không, Hàng Chính Hãng",1850000,1850000,0,0
TIKI,dien-gia-dung,73118910,"Nồi cơm điện Mini Kim Cương 0.3L - Chỉ 1 người ăn - Hàng chính hãng",222000,250000,28000,11
TIKI,dien-gia-dung,74890928,"Nồi cơm điện tử Toshiba RC-18NTFV(W) (1.8 Lít) - HÀNG CHÍNH HÃNG",2270000,2890000,620000,21
TIKI,dien-gia-dung,3611007,"Bếp Nướng Điện Kangaroo KG699 2000W - Hàng chính hãng",529000,880000,351000,40
TIKI,dien-gia-dung,50705450,"LÕI LỌC TOSHIBA F-1643-C2 - Hàng chính hãng",213000,220000,7000,3
TIKI,dien-gia-dung,116033388,"Máy tạo độ ẩm, phun sương Deerma DEM-F628 - F628W (Hàng nhập khẩu)",413000,423000,10000,2
TIKI,dien-gia-dung,57489538,"Lò Vi Sóng Tráng Men Samsung Dòng Vi Sóng MS23K3513AS (23 lít) - Hàng Chính Hãng",1615000,2190000,575000,26
TIKI,dien-gia-dung,36676655,"Máy cạo râu Xiaomi Enchen BlackStone  3 đầu cắt với lưỡi dao đôi - Hàng nhập khẩu",215000,215000,0,0
TIKI,dien-gia-dung,36211157,"Cửa gió nhựa vuông Décor 140*140/100s- Hàng nhập khẩus",130000,130000,0,0
TIKI,dien-gia-dung,58616785,"Quạt Bàn Đảo 2 Tấc Senko BD230 - Hàng Chính Hãng - Màu Ngẫu Nhiên",230000,230000,0,0
TIKI,dien-gia-dung,107982425,"Nồi Cơm Điện Tử Cảm Ứng Nagakawa NAG0136 Trắng đen - Giảm tinh bột - Lòng niêu chống dính - 11 chức năng (1.2L - 500W) - Hàng Chính Hãng",1300000,1860000,560000,30
TIKI,dien-gia-dung,92514138,"Len sợi đan móc cuộn 25gr bao gồm 50 màu , len milk cotton Hàn Quốc mềm mịn chuyên móc thú hoặc khăn mũ trẻ em",17000,17000,0,0
TIKI,dien-gia-dung,107137543,"Bếp Từ Đơn Elmich ICE-1828OL (2100W) - Hàng Chính Hãng",918000,1790000,872000,49
TIKI,dien-gia-dung,252701622,"Nồi Chưng Yến Nấu Cháo Kho Cá Bear SB-NNC20 - Bản Tiếng Việt Dung Tích 2 Lít Công Suất 175 W - Hàng Chính Hãng",719000,1349000,630000,47
TIKI,dien-gia-dung,15294431,"Quạt Treo Tường Senko Có Remote TR1628 - Giao Màu Ngẫu Nhiên - Hàng Chính Hãng",513000,513000,0,0
TIKI,dien-gia-dung,158996421,"Máy Ép Chậm Kangaroo KG180SJD (180W) - Hàng Chính Hãng",1790000,2300000,510000,22
TIKI,dien-gia-dung,175161661,"Bình đun nước siêu tốc kiêm giữ nhiệt Deerma DR035S trang bị màn hình thị nhiệt độ nước - Hàng chính hãng",590000,590000,0,0
TIKI,dien-gia-dung,155065478,"Máy Hút Bụi Cầm Tay Không Dây 9000Pa, Hút Bụi Ô Tô, Giường Nệm, Sofa, Laptop - HÀNG CHÍNH HÃNG",279000,279000,0,0
TIKI,dien-gia-dung,194473397,"Nồi Chiên Không Dầu Locknlock Visible Air Fryer CUBE EJF996BLK (5.5 Lít) - Hàng Chính Hãng",2400000,5400000,3000000,56
TIKI,dien-gia-dung,162540539,"Bộ 3 Lõi lọc nước số 1,2,3 hàng chính hãng Karofi",180000,180000,0,0
TIKI,dien-gia-dung,274165500,"Máy Lọc Không Khí Xiaomi Mi Air Purifier 4 Kết Nối App Điên Thoại Phù Hợp Không Gian 50 m2 - Hàng Chính Hãng",3899000,7269000,3370000,46
TIKI,dien-gia-dung,102432145,"Quạt Sạc Mini Sunhouse SHD7110 (7W) - Hàng Chính Hãng",239000,340000,101000,30
TIKI,dien-gia-dung,187645122,"Lò nướng chân không kết hợp chức năng hấp Lock&Lock EJF693GRY Steam Air Fryer Oven (12.5 Lít) - Hàng chính hãng",3850000,7990000,4140000,52
TIKI,dien-gia-dung,158595860,"Đầu Lọc Nước Tại Vòi Nhỏ Gọn Cấp Nước Sạch Và An Toàn Cho Gia Đình KONKA - Hàng Nhập Khẩu",298000,435000,137000,31
TIKI,dien-gia-dung,143116407,"Máy phun sương xông tinh dầu tạo ẩm Rhino H901 dung tích 420ml, nhỏ gọn, không gây tiếng ồn, tích hợp đèn ngủ RGB nhiều màu, có chế độ tự ngắt - Hàng chính hãng",95000,102000,7000,7
TIKI,dien-gia-dung,171470149,"Máy Cạo Râu Tiện Dụng Kemei 2026,Dao Cạo Râu Tích Hợp Pin 1400 mAh Công Suất 5W, Đèn Led Hiện Dung Lượng Pin, Lưỡi Cắt Titatium, Động Cơ Hạn Chế Tiếng Ồn - HÀNG CHÍNH HÃNG",326900,341900,15000,4
TIKI,dien-gia-dung,87890602,"Bếp điện từ Xiaomi Mijia DCL002CM Youth Version 2 - Hàng Nhập Khẩu",735000,815000,80000,10
TIKI,dien-gia-dung,1908441,"Bàn Ủi Khô Sunhouse SHD1072 - Hồng (1200W) - Hàng chính hãng",150000,165000,15000,9
TIKI,dien-gia-dung,72299914,"Máy Vắt Cam Lock&Lock EJJ236 (700ml) - Hàng chính hãng",237000,400000,163000,41
TIKI,dien-gia-dung,34281542,"Quạt Đứng Toshiba F-LSA10(K)VN (50W) - Hàng Chính Hãng",868000,1050000,182000,17
TIKI,dien-gia-dung,20003196,"Nồi Lẩu Điện 2 Ngăn Perfect PF-A2N (5.0 Lít)- Hàng Chính Hãng",334000,490000,156000,32
TIKI,dien-gia-dung,2174695,"Nồi chưng cất yến Homepro HP-7M 700ml - Hàng chính hãng",529000,529000,0,0
TIKI,dien-gia-dung,181667508,"Quạt đứng Midea SAD35EZ màu cà phê Phiên bản mới 2022 của quạt cây Midea SAD35EA 3 Mức gió tự tăng giảm theo nhiệt độ phòng Có điều khiển từ xa Hàng Chính Hãng",1504000,1550000,46000,3
TIKI,dien-gia-dung,48269559,"Tông Đơ Cắt Tóc Cho Bé, Trẻ Em Codol 531 TẶNG Bộ Kéo Cắt Tóc + Áo Choàng Cắt Tóc + Lược Cắt Tóc (Dày-Thưa) - Tăng Đơ Hớt Tóc Gia Đình Cho Người Lớn Và Bé Sơ Sinh Máy Chạy Êm Lưỡi Có Thể Thay",299000,299000,0,0
TIKI,dien-gia-dung,125087214,"Máy Xay Sinh Tố BlueStone BLB-5339, 800W Cối Thủy Tinh Và Inox 304, Xay được hạt và đá, Hàng chính hãng",1450000,1999000,549000,27
TIKI,dien-gia-dung,191925968,"Dây cấp và dây thải máy lọc nước Nano Geyser, Dây phi 10 và phi 6, Giá 1 mét - Hàng Chính Hãng",7000,12000,5000,42
TIKI,dien-gia-dung,73281375,"Máy phun sương tạo độ ẩm không khí Deerma DEM-F628 Hàng Chính Hãng",449000,590000,141000,24
TIKI,dien-gia-dung,114773096,"Cao su non, băng tan, keo lụa cuốn ren ống nước, cuốn ren co nối, tê máy lọc nước (Cuộn 10 mét) - Hàng chính hãng",15000,15000,0,0
TIKI,dien-gia-dung,11477863,"Quạt treo 2 dây Senko ( Hàng Chính Hãng ) TC1626",345000,345000,0,0
TIKI,dien-gia-dung,530774,"Bếp Hồng Ngoại Sunhouse SHD6011 (2000W) - Đen- hàng chính hãng",513000,529000,16000,3
TIKI,dien-gia-dung,10310018,"Nồi Cơm Điện Tử Lock&Lock EJR151 (1.8 Lít) - Đen - Hàng chính hãng",1390000,2188000,798000,36
TIKI,dien-gia-dung,253328282,"Nồi Kho Thịt, Nồi Chưng Yến, Nồi Nấu Chậm Bear SUBE003 - Bản Tiếng Việt Kèm Khay Hấp Và 5 Thố Dung Tích 2.5 Lít Công Suất 380 W- Hàng Chính Hãng",1239000,2279000,1040000,46
TIKI,dien-gia-dung,82605269,"Khay Silicone Dành Cho Nồi Chiên Không Dầu Và Lò Vi Sóng Lock&amp;Lock CKB002PIK - Màu",243000,405000,162000,40
TIKI,dien-gia-dung,52189513,"Lõi Lọc Toshiba F-1686-C - Hàng chính hãng",213000,220000,7000,3
TIKI,dien-gia-dung,102868300,"Máy hút bụi diệt khuẩn UV Xiaomi Mijia MJCMY01DY - Hàng Nhập Khẩu",786000,876000,90000,10
TIKI,dien-gia-dung,42838693,"Bộ 02 Tê chia ba đầu dây nối nhanh dùng trong máy lọc nước – hàng chính hãng",29000,45000,16000,36
TIKI,dien-gia-dung,130083414,"Lõi Lọc Diệt Khuẩn Cho Máy Lọc Không Khí Xiaomi - Hàng Chính Hãng",586000,590000,4000,1
TIKI,dien-gia-dung,80964740,"Máy Sấy Tóc Cao Cấp Công Suất Lớn 2200W Chuyên Dụng Cho Hair Salon - Máy Sấy Tóc Bổ Sung Ion Dưỡng Ẩm, Làm Mềm Mượt Tóc - Máy Sấy Tóc Cao Cấp Động Cơ Êm Ái, Ổn Định – Chính Hãng VinBuy",249000,500000,251000,50
TIKI,dien-gia-dung,188976646,"Máy Hút Mùi Âm Tủ Ecalite EH-AT700T (Ngang 70cm) - Công Suất Hút Mạnh 750 m3/h - Điều Khiển Cảm Ứng - Hàng Chính Hãng",2220000,4440000,2220000,50
TIKI,dien-gia-dung,403455,"Kẹp Nướng Sandwich Tiross TS514 (750W) - Hàng Chính Hãng",581000,590000,9000,2
TIKI,dien-gia-dung,179745773,"Máy Làm Sữa Hạt Đa Năng BlueStone SMB-7330 / SMB-7329, 1.3Lit-1000w, 8 Chế độ xay nấu, Hàng chính hãng",1549000,1999000,450000,23
TIKI,dien-gia-dung,106303361,"Máy lọc không khí mini chính hãng Airko WP-AU12L / sản phẩm thiết yếu cho ô tô, văn phòng",266000,1900000,1634000,86
TIKI,dien-gia-dung,14498191,"Kim móc len cao cấp",35000,35000,0,0
TIKI,dien-gia-dung,53969748,"Quạt Đứng Senko Có Chức Năng Hẹn Giờ Sang Trọng, Cao Cấp DH1600 - Hàng Chính Hãng",450000,450000,0,0
TIKI,dien-gia-dung,418080,"Nồi Lẩu Điện Đa Năng Happy Cook HCHP-300A - Hàng chính hãng",857000,857000,0,0
TIKI,dien-gia-dung,262733056,"Máy Sấy Tóc LocknLock - Trắng ENA136WHT 2000-2200W - Hàng chính hãng",426800,776000,349200,45
TIKI,dien-gia-dung,118693086,"Quạt Sạc Comet CRF0705 (5W) - Xanh - Hàng chính hãng",235000,329000,94000,29
TIKI,dien-gia-dung,93862547,"Nồi hấp điện MIDEA MZ-ZG26Easy401 3 ngăn hấp dung tích 10 lít - Hàng chính hãng",1135000,1290000,155000,12
TIKI,dien-gia-dung,1563561,"Máy Xay Sinh Tố Đa Năng Sunhouse SHD5340B (500W) - Hàng chính hãng",740000,1394000,654000,47
TIKI,dien-gia-dung,70784089,"Tông đơ cạo lông toàn thân Panasonic ER-GK20-K401 - Hàng chính hãng",1225000,1499000,274000,18
TIKI,dien-gia-dung,55719960,"Tông Đơ Hớt Tóc Gia Đình Cho Bé JICHEN 0817 TẶNG Bộ Kéo Cắt Tỉa + Lấy Ráy Tai Có Đèn - Tăng Đơ Cắt Tóc Trẻ Em Công Suất 3W An Toàn Tiện Lợi",144000,199000,55000,28
TIKI,dien-gia-dung,152788852,"Máy Đánh Trứng Cầm Tay 7 Tốc Độ Công Suất Lớn Tặng Kèm 4 Que Đánh Cao Cấp Thép Không Gỉ - Hàng Chính Hãng - Hàng Nhập Khẩu",105000,105000,0,0
TIKI,dien-gia-dung,58979082,"Máy Cạo Râu Dùng Sạc Kemei 2801 - Có Thể Cạo Râu Khô Ướt Và Dùng Kem Cạo Sát Không Đau",187000,215000,28000,13
TIKI,dien-gia-dung,70818712,"Máy Sấy Tóc Panasonic EH-ND21-P645 - Hàng Chính Hãng",440000,490000,50000,10
TIKI,dien-gia-dung,176509785,"Máy Sấy Tóc Mini Gấp Gọn Besti Cao Cấp, Công Suất Lớn, Động Cơ Êm Ái, Ổn Định, Tặng Đầu Sấy Tạo Kiểu Tóc Chuyên Nghiệp - Hàng Chính Hãng",159000,159000,0,0
TIKI,dien-gia-dung,103515716,"Máy hút bụi cầm tay, hút bụi xe ô tô, xe hơi, giường nệm, lực hút mạnh 16000PA, pin sạc không dây - Chính hãng VinBuy",338000,600000,262000,44
TIKI,dien-gia-dung,2138075,"Máy Lọc Không Khí Sharp FP-J30E-A (50W)- Hàng chính hãng",1970000,2400000,430000,18
TIKI,dien-gia-dung,192391024,"Máy Xay Nấu Đa Năng 5 In 1 Lazychef - Máy Làm Sữa Hạt, Máy Đa Năng Làm Sữa Đậu Nành,Nấu Cháo Chậm 800ml - Hàng Chính Hãng",1390000,2150000,760000,35
TIKI,dien-gia-dung,52189092,"LÕI LỌC TOSHIBA F-1686-PAC - Hàng chính hãng",431000,440000,9000,2
TIKI,dien-gia-dung,80859671,"Máy Uốn, Duỗi, Ép Tóc Mini Cao Cấp – Máy Uốn Ép Là Tóc Đa Năng 2 trong 1 Tiện Lợi, Bàn Kẹp To An Toàn Dễ Dàng Sử Dụng (Tự Chọn Màu Sắc) – Hàng Chính Hãng VinBuy",38000,60000,22000,37
TIKI,dien-gia-dung,71543823,"Nồi Cơm Điện Mini đa năng 0.8 lít Lock&Lock EJR326 - Hàng chính hãng",899000,1490000,591000,40
TIKI,dien-gia-dung,188847055,"[HCM]Máy Hút Bụi Công Nghiệp 4000W (5.5HP) Hút Khô Và Ướt USA Stanley SL19417P-6A - 23 lít (MẪU MỚI 2022) - Hàng Chính Hãng",1870000,1870000,0,0
TIKI,dien-gia-dung,125485714,"Máy Sấy Tóc ionity Panasonic EH-NE66-K645 – Công nghệ ionity bảo vệ và chăm sóc tóc bóng mượt – Công suất cực mạnh 2000W – Có đầu sấy tạo kiểu - Hàng chính hãng",855000,1019000,164000,16
TIKI,dien-gia-dung,72971523,"Bếp Hồng Ngoại 2000W Fujika FJ-SV211 Mặt Kính Ceramic Nấu Mọi Loại Nồi Có Thể Nướng Trực Tiếp Trên Bếp-Hàng Nhập Khẩu",532000,548000,16000,3
TIKI,dien-gia-dung,136839729,"Lẩu điện 2 ngăn đa năng Nagakawa NAG1906 (6.0 Lít) - Hàng Chính Hãng",1000000,1640000,640000,39
TIKI,dien-gia-dung,6768703,"Nồi Cơm Điện Nắp Gài Sunhouse SHD8217W (1.2L) - Hàng chính hãng",549000,890000,341000,38
TIKI,dien-gia-dung,15394613,"Máy Vắt Cam Hafele GS-401 - Hàng Chính Hãng",689000,1236000,547000,44
TIKI,dien-gia-dung,110348059,"Nối thẳng 2 đầu ren 13/21/27 dùng trong máy lọc nước - Hàng chính hãng",15000,15000,0,0
TIKI,dien-gia-dung,49919340,"Máy tạo độ ẩm, phun sương Deerma DEM-F628s Dung tích 5 lít - Độ ồn thấp 36dB - Diện tích hoạt động 35m2 - Hàng chính hãng",668000,720000,52000,7
TIKI,dien-gia-dung,50668677,"Quạt điện cao cấp Senko TR1683 điều khiển từ xa bằng Remote màu ngẫu nhiên - Hàng chính hãng",513000,513000,0,0
TIKI,dien-gia-dung,162822107,"Máy Nướng Bánh Mì Sandwich Làm Nóng Thức Ăn Cho Bữa Sáng Đa Năng Dễ Sử Dụng - Hàng Chính Hãng MINIIN",260000,260000,0,0
TIKI,dien-gia-dung,181502181,"Nước lau sàn chuyên dụng cho robot hút bụi Ecovacs Deebot",110400,138000,27600,20
TIKI,dien-gia-dung,188131681,"Băng tan, Băng cao su non dài 10m, Băng quấn ren ống nước - Hàng Chính Hãng",4000,12000,8000,67
TIKI,dien-gia-dung,32069555,"Máy Lọc Nước R.O 8 Lõi Sunhouse SHA8818K - Hàng Chính Hãng",3099000,8281000,5182000,63
TIKI,dien-gia-dung,105153852,"Ấm Đun Siêu Tốc Thủy Tinh Perfect PF-IN19 (1.8 Lít) - Hàng Chính Hãng",250000,299000,49000,16
TIKI,dien-gia-dung,52150375,"Kim móc len 2 đầu inox màu vàng đồng dành cho người mới học , bộ dụng cụ len sợi đan móc chuyên dụng dễ sử dụng",15000,15000,0,0
TIKI,dien-gia-dung,41622977,"Tông Đơ Cắt Tóc Trẻ Em JC 0817 TẶNG Bộ Kéo Cắt Tỉa + Áo Choàng Cắt Tóc - Tăng Đơ Cắt Tóc Trẻ Em ",193000,199000,6000,3
TIKI,dien-gia-dung,3873843,"Máy Vắt Cam Philips HR-2738 - Hàng Nhập Khẩu",589000,589000,0,0
TIKI,dien-gia-dung,51615336,"TÔNG ĐƠ CẮT TÓC KEMEI KM - 1998 MÁY NHẸ SIÊU MẠNH",399000,399000,0,0
TIKI,dien-gia-dung,46581920,"QUẠT ĐỨNG HẸN GIỜ SENKO DH1600 hàng chính hãng (Màu sắc ngẫu nhiên)",450000,450000,0,0
TIKI,dien-gia-dung,3619821,"Máy cạo râu Panasonic ES6850 - Hàng Chính Hãng",255000,255000,0,0
TIKI,dien-gia-dung,692156,"Máy Hút Bụi Samsung VC18M2120SB/SV (1.5 Lít) 1800W - Hàng chính hãng",1220000,1890000,670000,35
TIKI,dien-gia-dung,2498757,"Quạt Điện Đứng Senko L1338 - Giao Màu Ngẫu Nhiên - Hàng Chính Hãng",369000,369000,0,0
TIKI,dien-gia-dung,274909923,"Máy ép trái cây hoa quả tốc độ chậm SAVTM JE-07 | JE-56 (Model 2024) Máy Ép Trái Cây Cỡ Lớn - Hàng Nhập Khẩu",694000,1200000,506000,42
TIKI,dien-gia-dung,31252945,"Bếp Từ Đơn Nagakawa NAG0704 (2000W) - Kèm Nồi Lẩu - Hàng Chính Hãng",999000,1310000,311000,24
TIKI,dien-gia-dung,191894802,"Bình Đun Siêu Tốc Ecalite EK-G1812 (1.8L) - Điều Chỉnh Nhiệt Độ 60°C Đến 100°C - Đèn LED Đổi Màu - Hàng Chính Hãng",345000,760000,415000,55
TIKI,dien-gia-dung,184954825,"Quạt Tích Điện Không Dây XIAOMI Smartmi Gen 3, Sử Dụng 20 Giờ Liên Tục 100 Tốc Độ Gió Quạt Siêu Êm, Có Remote, Kết Nối App Thông Minh Công Suất 25W- Hàng Chính Hãng",2289000,4569000,2280000,50
TIKI,dien-gia-dung,392842,"Bình Đun Siêu Tốc Philips HD9306 (1.5L) - Hàng chính hãng",550000,749000,199000,27
TIKI,dien-gia-dung,109452393,"QUẠT SÀN CÔNG NGHIỆP HALI SN186C- 80W- CÁNH 450mm - BẢO HÀNH 1 NĂM - Hàng chính hãng",630000,630000,0,0
TIKI,dien-gia-dung,271078037,"Quạt Mini Để Bàn, Quạt Tích Điện Sạc USB Besti - Quạt Cầm Tay 3 Tốc Độ, Điều Chỉnh Hướng Gió Xoay 360 Độ, Kiểu Dáng Sang Trọng , Không Gây Ồn, Pin Sạc Dung Lượng Lớn - Hàng Chính Hãng",270000,270000,0,0
TIKI,dien-gia-dung,178462960,"Máy Sấy tóc Philips - HP8108/00 - Dễ dàng sấy - Tạo nhiều kiểu tóc - Chính hãng",249000,315000,66000,21
TIKI,dien-gia-dung,108067800,"Máy Hút Bụi Khử Khuẩn & Vệ Sinh Giường Nệm Cầm Tay Deerma CM800 hàng chính hãng",699000,890000,191000,21
TIKI,dien-gia-dung,178462940,"Máy cạo râu du lịch cầm tay Philips S1103/02 - Êm ái - An Toàn - Chính hãng",842000,935000,93000,10
TIKI,dien-gia-dung,185809153,"Máy xay thịt đa năng KIPOR KP-MC502 - Cối Inox 304, dung tích 2L, 4 lưỡi dao bằng thép (400W) - Hàng Chính Hãng",707000,1200000,493000,41
TIKI,dien-gia-dung,692114,"Nồi Lẩu Điện Lock&Lock EJP331BLK (5 lít) - Hàng chính hãng",679000,1200000,521000,43
TIKI,dien-gia-dung,48077372,"Combo 8 lõi lọc nước dành cho máy lọc Karofi 8 cấp ( Lõi 123+RO+Nanosilver+Mineral+Gac T33+Far Infrared) - Hàng chính hãng",983000,1100000,117000,11
TIKI,dien-gia-dung,250740073,"Máy Xay Thực Phẩm Đa Năng, Máy Xay Ăn Dặm BEAR GR-B03V2 Xay Cực Êm An Toàn Vệ Sinh, Dung Tích 0.3 Lít Công Suất 120 W - Hàng Chính Hãng",433000,869000,436000,50
TIKI,dien-gia-dung,444297,"Máy Xay Thịt Philips HR1393 (0.7 Lít) - Hàng chính hãng",610000,610000,0,0
TIKI,dien-gia-dung,70777395,"Máy Sấy Tóc Dưỡng Ẩm Nanoe Panasonic EH-NA27PN645 - Công Suất 1200W - Tay cầm gập dễ mang đi - Hàng Chính Hãng",1412000,1999000,587000,29
TIKI,dien-gia-dung,115265205,"COMBO LÕI LỌC NƯỚC SỐ 1-2-3 (PP 10" 5MICRO - CTO - OCB) - HÀNG CHÍNH HÃNG",130000,130000,0,0
TIKI,dien-gia-dung,14707270,"Máy Ép Trái Cây Hafele GS-353 (400W) - Hàng Chính Hãng",989000,1690000,701000,41
TIKI,dien-gia-dung,57489540,"Máy Hút Bụi Samsung Không Dùng Túi Rambo VCC8836V36 (2200W)- Hàng Chính Hãng",2220000,3390000,1170000,35
TIKI,dien-gia-dung,120998519,"Nồi cơm điện tử Cuckoo 1.8L CR-1020F - Lòng nồi chống dính - Nhiều chế độ nấu ăn - Tiết kiệm điện - Hàng chính hãng",1880000,2350000,470000,20
TIKI,dien-gia-dung,2499243,"Quạt Trần Đảo Senko TD105 - Trắng - Hàng Chính Hãng",420000,420000,0,0
TIKI,dien-gia-dung,80934244,"Nồi Điện Đa Năng Lock&Lock EJP316BLK (1.2 Lít), nắp kính cường lực, lòng nồi inox 304,an toàn sức khỏe - Hàng Chính Hãng",422000,800000,378000,47
TIKI,dien-gia-dung,1368543,"Nồi Nấu Cháo Đa Năng BBCooker BS15 (1.5L) - Hàng Chính Hãng",429000,620000,191000,31
TIKI,dien-gia-dung,58261015,"Máy xay sinh tố  cầm tay philips  HR2531 Hàng nhập khẩu",609000,609000,0,0
TIKI,dien-gia-dung,473139,"Quạt Đứng Mitsubishi LV16-RV CY-GY - Xám Đậm",2239000,2239000,0,0
TIKI,dien-gia-dung,76366605,"Nồi Chiên Không Dầu Hafele AF-602A 11 Lít – Hàng Chính Hãng",2859000,5886000,3027000,51
TIKI,dien-gia-dung,175549760,"Khẩu khoá máy lọc nước Nano Geyser, Khoá chia nước, khoá nước đầu vào máy lọc nước - Hàng Chính Hãng",50000,90000,40000,44
TIKI,dien-gia-dung,97707350,"Máy Xay Thịt Đa Năng Perfect PF-X06 (2 Lít) - Hàng Chính Hãng",319000,499000,180000,36
TIKI,dien-gia-dung,120824825,"Nồi cơm điện Cuckoo 1.08L CR-0671 - Lòng nồi chống dính - Tiết kiệm điện - Hàng chính hãng Cuckoo Vina",940000,1180000,240000,20
TIKI,dien-gia-dung,189641775,"Máy hút bụi lau nhà cầm tay không dây thông minh Ultty V08 - Lực hút 24000 pascal - Hàng chính hãng",6050000,6050000,0,0
TIKI,dien-gia-dung,447316,"Máy Cạo Râu Panasonic PACR-ES534DP527 - Hàng Chính Hãng",197000,219600,22600,10
TIKI,dien-gia-dung,112694371,"Máy nướng bánh mì Electrolux E2TS1-100W - Hàng chính hãng",729000,790000,61000,8
TIKI,dien-gia-dung,56857479,"Nồi áp suất điện Elmich Smartcook PCS-1803 dung tích 2.5 lít 600W hàng chính hãng",1090000,1090000,0,0
TIKI,dien-gia-dung,70384421,"Bộ 2 nối thẳng 02 đầu ren ngoài 21 -21 nối ly lọc, cốc lọc ",30000,50000,20000,40
TIKI,dien-gia-dung,184880507,"Máy Ép Chậm OLIVO SJ200 [Hàng Chính Hãng] Ép Kiệt Bã 98% - Tốc Độ Chậm 39 vòng/phút - Thương Hiệu Mỹ",3190000,3190000,0,0
TIKI,dien-gia-dung,550582,"Máy Sấy Tóc Philips HP8108 (1000W)",245000,253000,8000,3
TIKI,dien-gia-dung,44082577,"Khóa 2 đầu dây, van ngang, van sục rửa màng R.O, van xả tay- Hàng chính hãng",25000,28000,3000,11
TIKI,dien-gia-dung,60239676,"Máy xay cầm tay Braun MQ5235 - Hàng Chính Hãng",1498000,1498000,0,0
TIKI,dien-gia-dung,42958067,"Vòi máy lọc nước R.O dây 6mm",125000,130000,5000,4
TIKI,dien-gia-dung,214200144,"Vòi máy lọc nước Inox 304 Nano Geyser không Chì, Vòi gạt cổ ngỗng nối nhanh - Hàng Chính Hãng",105000,160000,55000,34
TIKI,dien-gia-dung,107872664,"Bình Đun Siêu Tốc LocknLock EJK136SLV (1.7 Lít) - Hàng chính hãng",778000,1498000,720000,48
TIKI,dien-gia-dung,14485199,"Van điều áp áp thấp Namilux NA-337S sử dụng cho bình gas xám, vàng ,tặng dây VN. Hàng chính hãng ",149000,149000,0,0
TIKI,dien-gia-dung,184697577,"Máy ép trái cây Promix FJ-01 - 1000W - Hàng chính hãng",2900000,2900000,0,0
TIKI,dien-gia-dung,195840787,"Nồi nấu chậm Panasonic NF-N51AWRA (5 lít) - Hàng Chính Hãng",1820000,2203000,383000,17
TIKI,dien-gia-dung,59300189,"Máy Xay Thịt đa năng Midimori Chopper (500W) - Hàng Chính Hãng - Tặng Kèm 1 Bộ Lưỡi Dao Dự Phòng",387000,529000,142000,27
TIKI,dien-gia-dung,70784092,"Máy sấy tóc Panasonic EH–ND57 – Hàng chính hãng",630000,689000,59000,9
TIKI,dien-gia-dung,179745781,"Máy Làm Sữa Hạt Unie V8S, 1.75Lit-1800W, 12 Chức Năng Xay Nấu Đa Năng, Hàng Chính Hãng",2390000,2999000,609000,20
TIKI,dien-gia-dung,165846189,"Tông Đơ Cắt Tóc Gia Đình Cho Bé KEMEI 1986, Tăng Đơ Cắt Tóc Trẻ Em Công Suất 8W An Toàn Tiện Lợi Thiết Kế Chống Ồn Thông Minh Tiện Dụng",600000,1398000,798000,57
TIKI,dien-gia-dung,377077,"Máy May Brother AS2730S - Hàng chính hãng",4290000,4490000,200000,4
TIKI,dien-gia-dung,84710777,"Bàn Ủi Hơi Nước Cầm Tay Xiaomi Zanjia GT-306W (công suất 1200W) - Hàng chính hãng",377000,699000,322000,46
TIKI,dien-gia-dung,149914938,"Máy Xay Sinh Tố Philips HR2223 - 3 Cối + 1 Lõi Ép - Công Suất 700W Xay Được Đá, Hạt - Hàng Chính Hãng",1495000,1495000,0,0
TIKI,dien-gia-dung,125362382,"Bình đun nước kiêm giữ nhiệt cao cấp Morphy Richards MR6060 công suất 350W, dung tích 350ml - Hàng Nhập Khẩu",991000,991000,0,0
TIKI,dien-gia-dung,105156505,"Bình Đun Siêu Tốc Thủy Tinh Perfect PF-T18 (1.8 Lít) - Hàng chính hãng",279000,279000,0,0
TIKI,dien-gia-dung,466383,"Máy Xay Cà Phê Tiross TS532 (150W) - Hàng chính hãng",575000,690000,115000,17
TIKI,dien-gia-dung,103692716,"Nồi Cơm Điện Tử Toshiba RC-10NMFVN (WT) (1 Lít) - Hàng Chính Hãng",1990000,2550000,560000,22
TIKI,dien-gia-dung,243047768,"ĐẦU QUẠT TREO TƯỜNG - KO LÒNG CÁNH 3HT - HÀNG CHINH HÃNG",160000,160000,0,0
TIKI,dien-gia-dung,195966432,"Bếp Ga Mini Inox Chống Rỉ MS-3800SP - Công Suất 2900W Vòng Chắn Gió Bảo Hiểm Chống Nổ Hàng Chính Hãng",369000,399000,30000,8
TIKI,dien-gia-dung,117929505,"Máy hút bụi mini không dây cầm tay nhỏ nhắn tiện dụng Deli - Lực hút ổn đinh - Phù hợp vệ sinh bàn phím, laptop, góc học tập, nhà bếp, ô tô - Trắng/Xanh dương - 18883",155000,279000,124000,44
TIKI,dien-gia-dung,72549513,"Quạt sạc tích điện Honjianda FL 223 - tích hợp đèn LED & cổng USB",800000,800000,0,0
TIKI,dien-gia-dung,114195416,"Máy Xay Thịt Cao Cấp Lock&Lock Meat Chopper EJM186SLV Công Suất 400w- 2,4L - Hàng Chính Hãng",695000,1250000,555000,44
TIKI,dien-gia-dung,130470387,"Máy pha cà phê Espresso Zamboo ZB-68CF - màu đen - hàng chính hãng",869000,869000,0,0
TIKI,dien-gia-dung,50693514,"LÕI LỌC TOSHIBA F-1643-PP- Hàng chính hãng",155000,160000,5000,3
TIKI,dien-gia-dung,116875360,"Bộ lọc nước thô đầu nguồn 3 cấp lọc 10 inch by Scitech - Hàng chính hãng",590000,590000,0,0
TIKI,dien-gia-dung,129276238,"Bàn ủi hơi nước Panasonic NI-GSE050ARA - Hàng chính hãng",2249000,2249000,0,0
TIKI,dien-gia-dung,20046513,"Quạt treo tường remote Senko Hàng Chính Hãng - TR1428 - Giao màu ngẫu nhiên",513000,513000,0,0
TIKI,dien-gia-dung,43926404,"Máy hút bụi công nghiệp dạng nhỏ Sumika K20, Màu Vàng, 20L, 1600W, Có thể hút nước, Motor Ametek của Mỹ, Tầng lọc HEPA, Dây điện dài 10m, Thùng chứa Thép không gỉ - Hàng Chính Hãng",1650000,2100000,450000,21
TIKI,dien-gia-dung,8420031,"Bếp Điện Từ Đôi Kangaroo KG498N (3100W) - Hàng chính hãng",2790000,4720000,1930000,41
TIKI,dien-gia-dung,58570537,"Máy vắt cam 0.7lit LB389 Lebenlang (Hàng nhập khẩu)",239000,350000,111000,32
TIKI,dien-gia-dung,112020006,"Bộ phụ kiện kết nối bộ lọc thô, bộ lọc nước sinh hoạt 10 inch ren 13/21 - Hàng chính hãng",105000,105000,0,0
TIKI,dien-gia-dung,123772063,"Máy Pha Cà Phê Bear KFJ-A02N1 Pha Nespresso, Americano, Cappuccino Tạo Bọt Sữa Dễ Dàng Có Tạo Bọt Sữa Dung Tích 240 ML Công Suất 800 W - Hàng Chính Hãng",1299000,2099000,800000,38
TIKI,dien-gia-dung,262606222,"Ấm Siêu Tốc Bình Pha Trà Bear YSH-C15Q5 1.5L Công Suất 1000 W - Hàng Chính Hãng",1149000,2199000,1050000,48
TIKI,dien-gia-dung,162841493,"Máy cạo râu khô và ướt Philips S1301/02 - Hàng Chính Hãng",839000,990000,151000,15
TIKI,dien-gia-dung,273217576,"Máy Vắt Cam Lock&Lock EJJ231 (40W) - Hàng chính hãng",248600,452000,203400,45
TIKI,dien-gia-dung,144162573,"[Loại Tốt] Máy Hút Chân Không KhoNCC Hàng Chính Hãng - Đa Năng Có Hàn Ép Miệng Túi Thực Phẩm - KLVQ-5233-MECK",189000,270000,81000,30
TIKI,dien-gia-dung,171856533,"Máy Xay Thịt 2 Lưỡi Kép BlueStone CHB-5145 (2 Lít) - Hàng chính hãng",519000,1299000,780000,60
TIKI,dien-gia-dung,193013426,"Quạt Cầm Tay Mini Tích Điện Teement, Có Giá Đở Điện Thoại, Sạc USB Di Động Tiện Lợi - Hàng Chính Hãng",110000,110000,0,0
TIKI,dien-gia-dung,68737242,"TÔNG ĐƠ CẮT TÓC KEMEI ",192000,200000,8000,4
TIKI,dien-gia-dung,444402,"Nồi Áp Suất Điện Philips HD2103 (5 Lít) - Hàng Chính Hãng",1480000,2209000,729000,33
TIKI,dien-gia-dung,105516210,"Bình đun nước siêu tốc Electrolux E2EK1-100W 1.7L - Hàng chính hãng",639000,690000,51000,7
TIKI,dien-gia-dung,178462957,"Máy ép tóc Philips HP8401/00 - Sử dụng dễ dàng - An toàn - Chính hãng",617000,685000,68000,10
TIKI,dien-gia-dung,110255220,"Ấm đun nước siêu tốc Elmich Smartcook ICS-3859 (1.7 Lít) - Hàng chính hãng",290000,579000,289000,50
TIKI,dien-gia-dung,242444398,"Bàn là hơi nước cầm tay LEBENLANG LBD528S nhập khẩu Đức, công suất 1500W - 300ml",642000,950000,308000,32
TIKI,dien-gia-dung,171850605,"Nồi chiên không dầu KIPOR KP-AF310 - 10L - Điều khiển cơ công nghệ RAPID AIR nướng đối lưu - phủ chống dính cao cấp - Hàng chính hãng",1799000,1799000,0,0
TIKI,dien-gia-dung,177482641,"Bộ Lọc Hepa Cho Máy Hút Bụi DAMAS XC628 - Hàng chính hãng",70000,150000,80000,53
TIKI,dien-gia-dung,171874399,"Máy ép chậm KIPOR KP-SJ595 - Chân đế chống rung lắc - Tặng lưới làm kem - Động cơ đồng nguyên chất công suất lớn -Hàng chính hãng",2191000,3899000,1708000,44
TIKI,dien-gia-dung,192894253,"Nồi Lẩu Điện Đa Năng OENON Chống Dính Vân Đá Tự Động Ngắt Điện Khi Đủ Nhiệt - Hàng Chính Hãng",439000,800000,361000,45
TIKI,dien-gia-dung,138514272,"Máy lọc không khí Lock&lock Air purifier ENP124WHT (50W) Màu trắng - Hàng chính hãng",5320000,8860000,3540000,40
TIKI,dien-gia-dung,93293156,"Máy Lọc Không Khí Bù Ẩm ULTTY SKJ-CR022 Dạng Quạt, Diệt Khuẩn Bằng Tia UV, Chế Độ Làm Mát 9 Cấp, Bộ Lọc HEPA H13 Loại Bỏ 99,97% Bụi Mịn, Vi Khuẩn, Virut, Bù Ẩm 3 Cấp - Hàng Chính Hãng",8580000,8580000,0,0
TIKI,dien-gia-dung,108939702,"Len Milk Bò 50gr (Mã 01 đến 21)",15600,15600,0,0
TIKI,dien-gia-dung,77200428,"Máy Xay Thịt Cối Thủy Tinh Lock&Lock Meat Chopper EJM156BLK 1 Lít - Hàng Chính Hãng, 4 Lưỡi Dao Cho Lực Nghiền Mạnh, Công Suất 400W",519000,800000,281000,35
TIKI,dien-gia-dung,177196981,"Lưỡi thay thế cho Máy cạo râu Enchen Blackstone",89000,99000,10000,10
TIKI,dien-gia-dung,70823166,"Máy Duỗi Tạo Kiểu Tóc Panasonic EH-HV11-P645 - Hàng Chính Hãng",810000,879000,69000,8
TIKI,dien-gia-dung,179372625,"Máy Ép Chậm Hurom H310A - Hàng Chính Hãng",5950000,8900000,2950000,33
TIKI,dien-gia-dung,94997508,"Máy Là, Ép, Uốn Tóc Cao Cấp TẶNG KÈM 02 Lược Chải Tóc Đa Năng 3 Trong 1 Cao Cấp Sang Trọng - Dùng Cho Salon Tóc & Tại Nhà – Chính Hãng VinBuy",229000,450000,221000,49
TIKI,dien-gia-dung,173425151,"Nồi Nấu Chậm 0,8L Bear SUBE001 Đa Năng Nấu Cháo, Chưng Yến Bản Quốc Tế - Hàng Chính Hãng",459000,590000,131000,22
TIKI,dien-gia-dung,57983571,"Lõi lọc nước Toshiba số 2 F-1686-RO - HÀNG CHÍNH HÃNG",900000,900000,0,0
TIKI,dien-gia-dung,56100002,"Máy đánh trứng Mishio MK215 300W - 5 tốc độ, đi kèm que đánh bột và đánh trứng - Hàng chính hãng",194000,399000,205000,51
TIKI,dien-gia-dung,73912559,"Bếp nướng điện Lebenlang LBG8588 - Thương hiệu của CHLB Đức",699000,1000000,301000,30
TIKI,dien-gia-dung,20882633,"Máy Hút Bụi Cầm Tay Deerma-Deerma Vacuum Cleaner DX700 - Hàng Chính Hãng",666000,666000,0,0
TIKI,dien-gia-dung,185496093,"Máy pha cà phê cầm tay HiBREW ACM009 3 in 1, ô tô, du lịch và tại nhà, túi xách tiện lợi, hàng chính hãng",2490000,2490000,0,0
TIKI,dien-gia-dung,135079395,"Bàn ủi hơi nước Philips GC1740 (2000W) - Hàng chính hãng",459000,699000,240000,34
TIKI,dien-gia-dung,125087348,"Máy Đánh Trứng Bluestone HMB-6338 (400W) - Hàng chính hãng",690000,999000,309000,31
TIKI,dien-gia-dung,195787224,"Máy Tạo Bọt Sữa Cầm Tay CASO Fomini 1610, Tốc Độ Cao 12,000 Vòng/Phút, Công Suất 5W - Hàng Nhập Khẩu Đức",431000,440000,9000,2
TIKI,dien-gia-dung,175422668,"Máy lọc nước Nano Geyser ECO CRYSTAL công nghệ lọc UF - Hàng Chính Hãng",1281000,2480000,1199000,48
TIKI,dien-gia-dung,44664444,"Máy sấy tóc Panasonic EH-ND30-K645 Đen/ EH-ND30-P645 Hồng - Hàng Chính Hãng",635000,702000,67000,10
TIKI,dien-gia-dung,188131717,"Tay mở cốc lọc 123, Tay vặn cốc lọc 10in, 20in, Tay mở vỏ màng RO - Hàng Chính Hãng - TAY GÔNG 10 INCH",17000,20000,3000,15
TIKI,dien-gia-dung,42867263,"Dây dẫn nước máy lọc nước",45000,50000,5000,10
TIKI,dien-gia-dung,658093,"Quạt Treo Tường Điều Khiển Từ Xa Senko TR1628 - Hàng Chính Hãng - Giao màu ngẫu nhiên",512000,512000,0,0
TIKI,dien-gia-dung,108916695,"Quạt treo Asia L16019 có remote điều khiển - Màu xám - Hàng chính hãng",780000,780000,0,0
TIKI,dien-gia-dung,112074239,"Bếp điện từ đơn công nghiệp KL671",2730000,2730000,0,0
TIKI,dien-gia-dung,97626600,"Ấm đun siêu tốc 2 lớp BlueStone KTB-3455 ( 1.5L - 2200W) - Hàng chính hãng",429000,799000,370000,46
TIKI,dien-gia-dung,51984203,"Tông đơ cắt tóc Kemei Pro KM809A",222000,229000,7000,3
TIKI,dien-gia-dung,179064450,"Nồi chiên không dầu Hafele HS-AF601B 6.4L (535.43.714) (Hàng chính hãng)",2490000,4590000,2100000,46
TIKI,dien-gia-dung,95052954,"Quạt Cầm Tay Cao Cấp Vinbuy Tích Điện Tiện Lợi Kèm Cáp Sạc Và Pin Có Tặng Chân Đế Tích Hợp Giá Đỡ Điện Thoại, 3 Chế Độ Gió Siêu Mát Siêu Bền - Hàng chính hãng VinBuy",113000,200000,87000,44
TIKI,dien-gia-dung,13822784,"Lõi Số 1 - 10'' PP - 5 micro Kangaroo K28 - Hàng chính hãng",60000,79000,19000,24
TIKI,dien-gia-dung,11386192,"Thiết Bị Lọc Nước Lắp Tại Vòi EF401 - Hàng chính hãng",1168363,1168363,0,0
TIKI,dien-gia-dung,187063609,"Quạt Mini Để Bàn M102, Quạt Tích Điện Dung Lượng Pin 4000 mAh, 3 Chế Độ Gió, Xoay 360 Độ - Hàng Chính Hãng",199000,199000,0,0
TIKI,dien-gia-dung,275401725,"Máy sấy thực phẩm gia đình 5 khay Septree DBC-05A hẹn giờ sấy khô tự ngắt, hàng chính hãng",1829000,1829000,0,0
TIKI,dien-gia-dung,159319026,"Quạt Treo Tường Điều Khiển Từ Xa Senko TR1628 - (màu xám)Hàng Chính Hãng",518000,518000,0,0
TIKI,dien-gia-dung,95748596,"Quạt cây MIDEA SAD35EA tự điều chỉnh gió thông minh Hàng chính hãng",1403000,1640000,237000,14
TIKI,dien-gia-dung,88206665,"Máy Sấy Tóc Philips BHD350/10 - Công Suất 2100W, 3 Chế Độ Sấy, ION - Hàng Chính Hãng",744000,895000,151000,17
TIKI,dien-gia-dung,7177651,"Bộ 3 Lõi Lọc Nước Thông Minh Sunhouse - Hàng chính hãng",110000,110000,0,0
TIKI,dien-gia-dung,136987758,"Máy ép chậm Hafele GS-133N - 535.43.811 (Hàng chính hãng)",2140000,4190000,2050000,49
TIKI,dien-gia-dung,57899819,"Nồi cơm cao tần Toshiba RC-18IX1PV (1.8 Lít) - Hàng Chính Hãng",3190000,3390000,200000,6
TIKI,dien-gia-dung,174162754,"Máy Kẹp Tạo Kiểu Tóc PHILIPS HP8401 - Hàng Chính Hãng",497000,512000,15000,3
TIKI,dien-gia-dung,106032473,"Máy Xay Thịt, Xay Thực Phẩm Đa Năng BEAR QSJ-C04V3 - Xay Cực Êm Cối Thủy Tinh Dung Tích 2.5 Lít Công Suất 350 W - Hàng Nhập Khẩu",881000,1599000,718000,45
TIKI,dien-gia-dung,72797225,"Máy Xay Bột Khô Đa Năng Seka - Hàng chính hãng",775000,1250000,475000,38
TIKI,dien-gia-dung,111305682,"Máy Ép Chậm MOKKOM - SJ001 Hàng Chính Hãng",999000,1800000,801000,45
TIKI,dien-gia-dung,250739146,"Máy Xay Thịt, Máy Xay Ăn Dặm Bear GR-B06V1 Xay Cực Êm Dung Tích 0.6 Lít Công Suất 200 W- Hàng Chính Hãng",588000,1019000,431000,42
TIKI,dien-gia-dung,44563766,"CHỤP THÔNG HƠI VENT CAP INOX",80000,80000,0,0
TIKI,dien-gia-dung,191448135,"Nồi Cơm Điện Kim Cương 0.8 Lít Nắp Rời Chống Dính - Hàng Chính Hãng",380000,380000,0,0
TIKI,dien-gia-dung,51227503,"Bàn ủi hơi nước Philips GC1756 (2000W) - Hàng chính hãng",759000,759000,0,0
TIKI,dien-gia-dung,53562464,"Máy Nướng Bánh Mì Philips HD2582 (830W)- Hàng nhập khẩu.( Giao màu ngẫu nhiên)",849000,849000,0,0
TIKI,dien-gia-dung,54053868,"CỬA GIÓ NHỰA TRÒN - DECOR 100s - Hàng Nhập Khẩu",110000,110000,0,0
TIKI,dien-gia-dung,71685858,"2 Lõi lọc số 1 Karofi - Lõi SMAX DUO 1 - VI LỌC - hàng chính hãng Karofi",107000,110000,3000,3
TIKI,dien-gia-dung,191651843,"Bình Đun Siêu Tốc Perfect PF-B2 (1.8 Lít) - Hàng chính hãng",125000,199000,74000,37
TIKI,dien-gia-dung,177714084,"Máy Phun Sương Besti BTY01 Cao Cấp - Tạo Ẩm Không Khí Và Giữ Ẩm Da 420ml - Thiết Kế Nhỏ Gọn, Không Gây Tiếng Ồn - Máy Tạo Ẩm Không Gian Thư Giãn Tích Hợp Đèn Ngủ RGB Nhiều Màu Để Bàn Tiện Lợi, Có Chế Độ Tự Ngắt Khi Hết Nước - Hàng Chính Hãng",139000,139000,0,0
TIKI,dien-gia-dung,56525193,"Tay vặn ly cốc máy lọc nước R.O đa năng vặn 03 ly lọc thô và màng RO",35000,35000,0,0
TIKI,dien-gia-dung,110965194,"Máy Đánh Trứng Hafele HH-B400A - Hàng Chính Hãng",399000,790000,391000,49
TIKI,dien-gia-dung,447317,"Máy Tỉa Lông Mũi Panasonic PAMT-ER-GN30-K453 - Hàng Chính Hãng",380000,419000,39000,9
TIKI,dien-gia-dung,692360,"Máy Hút Bụi Samsung VC18M3110VB/SV (2 lít) 1800W - Hàng chính hãng",1315000,2190000,875000,40
TIKI,dien-gia-dung,189466182,"Nguồn máy lọc nước 24V 1.5A - Hàng Chính Hãng",148000,240000,92000,38
TIKI,dien-gia-dung,558110,"Máy Làm Bánh Mì Panasonic SD-P104WRA - Chế độ hẹn giờ 13 tiếng - Chức năng ghi nhớ khi mất điện - 13 thực đơn tự động - Hàng chính hãng",5210000,7020000,1810000,26
TIKI,dien-gia-dung,188696769,"Quạt Cây, Quạt Đứng Cảm Ứng BEAR DFS-D47F2 Gồm 6 Tốc Độ 9 Cánh Quạt Làm Mát Sâu, Có Hẹn Giờ Và Điều Khiển Từ Xa Độ Ồn Cực Thấp 35 dB Công Suất 47 W - Hàng Chính Hãng",1371000,2599000,1228000,47
TIKI,dien-gia-dung,68258241,"Máy hút bụi cầm tay Deerma DX115C (600W) - Hàng Chính Hãng",459000,740000,281000,38
TIKI,dien-gia-dung,253461486,"Máy Ép Trái Cây Hoa Quả Tốc Độ Chậm SAVTM JE-35 - Ép Kiệt, Ép Nguyên Trái - Hàng Nhập Khẩu",1099000,2000000,901000,45
TIKI,dien-gia-dung,217729422,"Máy Pha Cà Phê Mini Gia Đình Bear KFJ-403 Dung Tích 600 ML Công Suất 550 W - Hàng Chính Hãng",549000,939000,390000,42
TIKI,dien-gia-dung,274541995,"Máy Làm Sữa Hạt OLIVO X20 PLUS Phiên Bản Mới - Đa Chức Năng - Tạm Dừng Thông Minh - Vệ Sinh Khử Khuẩn Độc Quyền - Chống Trào Tuyệt Đối - Hàng Chính Hãng",2294000,4000000,1706000,43
TIKI,dien-gia-dung,3873855,"Máy Ép Trái Cây Philips HR1811 - Trắng Xanh - Hàng Nhập Khẩu",1049000,1049000,0,0
TIKI,dien-gia-dung,73190767,"Ấm siêu tốc thuỷ tinh 1,8lit Lebenlang LBE2819 (hàng chính hãng)",399000,599000,200000,33
TIKI,dien-gia-dung,187816688,"Máy sấy tóc BHD510/00 -Sấy tóc nhanh khô - Bảo vệ tóc không quá nóng",1555000,1555000,0,0
TIKI,dien-gia-dung,896341,"Máy Xay Thịt Đa Năng Thân Inox Chopper Midimori GC-24338 (500W) - Đen - Hàng chính hãng",341000,499000,158000,32
TIKI,dien-gia-dung,46252190,"Nồi cơm điện Hiệp Hưng HH501 (1.2 lít) - Giao màu ngẫu nhiên",289000,289000,0,0
TIKI,dien-gia-dung,52189605,"LÕI LỌC TOSHIBA F-1643-RO - hàng chính hãng",930000,960000,30000,3
TIKI,dien-gia-dung,105602373,"Lon gas chuyên dụng Namilux - HÀNG CHÍNH HÃNG NAMILUX (MP)",27000,27000,0,0
TIKI,dien-gia-dung,63166969,"Ca nấu đa năng Mishio MK214 600W 1,5L inox 304, nấu nước, nấu mì, lẩu - Màu trắng xám - Hàng chính hãng",399000,499000,100000,20
TIKI,dien-gia-dung,366229,"Nồi Áp Suất Comet CM6150 (5 Lít) - Hàng Chính Hãng",1099000,1590000,491000,31
TIKI,dien-gia-dung,468655,"Bình Thủy Điện Panasonic PABT-NC-EG3000CSY 3L - Hàng chính hãng",1990000,2387000,397000,17
TIKI,dien-gia-dung,203286162,"Nồi điện đa năng MIDEA Nồi lẩu điện mini nấu hầm xào luộc Làm nóng nhanh Cảm ứng chống cháy nổ 2 Mức nhiệt độ Hàng chính hãng",569000,593000,24000,4
TIKI,dien-gia-dung,45474334,"Bộ 5 Đầu Bàn Chải Hút Bụi đa năng, đường kính ống 32mm",225000,225000,0,0
TIKI,dien-gia-dung,192737515,"Robot Hút Bụi - Lau Nhà Liectroux C30B Hàng chính hãng",3086510,3149500,62990,2
TIKI,dien-gia-dung,110982026,"Máy sấy tóc Xiaomi ShowSee A1-W - Hàng Nhập Khẩu",275000,339000,64000,19
TIKI,dien-gia-dung,650002,"Quạt Tháp Tiross TS9181 (45W) - Trắng - Hàng chính hãng",2400000,2590000,190000,7
TIKI,dien-gia-dung,973082,"Quạt Hút Thông Gió Senko H150 (30W) - Trắng - Hàng Chính Hãng",274000,274000,0,0
TIKI,dien-gia-dung,82875074,"Quạt lỡ thân sắt SENKO LTS1636 - Hàng chính hãng",428000,428000,0,0
TIKI,dien-gia-dung,143463476,"Máy lọc nước nóng lạnh Karofi KAD-R38 - Hàng chính hãng",9198000,13140000,3942000,30
TIKI,dien-gia-dung,15257640,"Ấm Sắc Thuốc Fujika FJ-CK33K3 - Hàng Chính Hãng",319000,319000,0,0
TIKI,dien-gia-dung,793322,"Bếp Ga Đơn Rinnai RV-150 (G) - Đen- Hãng chính hãng",388000,388000,0,0
TIKI,dien-gia-dung,58065291,"Nồi Cơm Điện Philips HD4533/66 - Hàng Chính Hãng",1865000,2238000,373000,17
TIKI,dien-gia-dung,1725813,"Bộ Van Bình Ngắt Gas Tự Động NaMilux NH-205S - Hàng chính hãng",179000,239000,60000,25
TIKI,dien-gia-dung,76145264,"Bộ 2 co cút nối nhanh ren 21 ra dây 10mm hoặc dây 6mm – linh kiện máy lọc nước, phun sương, lắp dàn tưới cây, bể thủy sinh, cá cảnh, bán cạn (Hàng chính hãng)",20000,25000,5000,20
TIKI,dien-gia-dung,22044141,"Ấm sắc thuốc bắc truyền thống NodaCook không mâm nhiệt kim loại bên trong 1.8 lít màu đen không kèm bếp điện - Hàng chính hãng",245000,450000,205000,46
TIKI,dien-gia-dung,140718467,"Kẹp nướng sandwich 3 in 1 Tiross TS9655 (900W) - Hàng chính hãng",979000,1000000,21000,2
TIKI,dien-gia-dung,194585794,"Bếp điện mini đa năng đun nước pha cà phê, pha trà, hơ lá trầu, bếp dùng cho sinh viên, nhà đình ít người, công suất 1000w - Hàng Chính Hãng",151800,165000,13200,8
TIKI,dien-gia-dung,107985162,"Bếp Từ Điều Khiển Cảm Ứng 2 Hướng Nagakawa NAG0712 (2200W) - Chức Năng Booster Nấu Nhanh - Hàng Chính Hãng",1740000,1970000,230000,12
TIKI,dien-gia-dung,73182663,"Lõi lọc của máy lọc không khí Lock&Lock air furifier filter ENP126_FLT - Hàng chính hãng",449000,875000,426000,49
TIKI,dien-gia-dung,73603606,"Ấm Siêu Tốc Inox 5L Fujika FJ-SD50 Công Suất 1500W Tiết Kiệm Điện Cho Quán,Nhà Hàng,Nhà Đông Người-Hàng Chính Hãng",241000,248000,7000,3
TIKI,dien-gia-dung,405170,"Máy Sấy Quần Áo TIROSS TS880 (900W) - Hàng Chính Hãng",1350000,1490000,140000,9
TIKI,dien-gia-dung,1733803,"Quạt Hút Thông Gió Âm Trần Senko HT150 (30W) - Hàng Chính Hãng",274000,274000,0,0
TIKI,dien-gia-dung,556607,"Nồi Cơm Điện Nắp Gài Tiger JNP-1000 - 1L JASMIN - Hàng Chính Hãng",2239000,2239000,0,0
TIKI,dien-gia-dung,55057555,"Máy Đánh Trứng Cầm Tay 7 Tốc Độ Công Suất Lớn Tặng Kèm 4 Que Đánh Cao Cấp Thép Không Gỉ - Hàng Chính Hãng - Hàng Nhập Khẩu",74000,79799,5799,7
TIKI,dien-gia-dung,172436841,"Máy Hút Bụi Cầm Tay Midea MVC-16T-B (Công Suất 800W, Độ ồn: 84 dB, Bộ lọc Hepa H13, Dây Diện 5m)",1890000,1890000,0,0
TIKI,dien-gia-dung,188992568,"Máy Cạo Râu Và Tỉa Lông Mũi Đa Năng, Máy Cạo Râu Cạo Sát, Êm, Sạc Pin Nhanh, Chống Nước, Sạc USB Tiện Lợi, Động Cơ Mạnh Mẽ",135000,135000,0,0
TIKI,dien-gia-dung,195772997,"Nồi Cơm Điện Kim Cương 0.6 Lít Nắp Rời - Hàng Chính Hãng",290000,290000,0,0
TIKI,dien-gia-dung,141113188,"Ấm siêu tốc, ấm thủy tinh cao cấp ZHUNE 1.8L công suất 1500W hàng chính hãng",345000,540000,195000,36
TIKI,dien-gia-dung,162838903,"Máy ép tóc Philips HP8401/00 - Hàng Chính Hãng",513000,655000,142000,22
TIKI,dien-gia-dung,132075876,"Nồi Lẩu Điện Đa Năng, Ca Nấu Mì Tiện Lợi Kèm Giá Hấp Có Tay Cầm Tiện Dụng 18cm, Nồi Lẩu Hấp Mini 2 Tầng Cao Cấp- Hàng Chính Hãng MINIIN",137900,137900,0,0
TIKI,dien-gia-dung,178599953,"Máy sấy tóc Panasonic EH-NE66-K645 - Hàng chính hãng",870000,1019000,149000,15
TIKI,dien-gia-dung,403472,"Vỉ Nướng Điện Đa Năng Tiross TS965 - Hàng Chính Hãng",1180000,1290000,110000,9
TIKI,dien-gia-dung,144271164,"Túi giấy đựng bụi Model 19-3100N dùng cho máy hút bụi Stanley SL19117, SL19116, SL19116P - 19-3100N - Hàng chính hãng",310000,310000,0,0
TIKI,dien-gia-dung,13233002,"Combo bếp gas khè công nghiệp Redhome. tặng van dây - Hàng chính hãng",659000,659000,0,0
TIKI,dien-gia-dung,175173285,"Máy sấy tóc Showsee A4-W ion âm chống khô tóc công suất lớn 1800W - Hàng chính hãng",349000,590000,241000,41
TIKI,dien-gia-dung,250055371,"Quạt đứng Xiaomi Smart Fan 2 Lite - Hàng Chính Hãng",1090000,1090000,0,0
TIKI,dien-gia-dung,177659918,"Máy pha cà phê viên nén Xiaomi SCISHARE S1201 thích hợp với máy Nespresso - Hàng nhập khẩu",2624400,2916000,291600,10
TIKI,dien-gia-dung,149914925,"Máy Đánh Trứng Philips HR3705 - Công Suất 300W - Hàng Chính Hãng",668000,689000,21000,3
TIKI,dien-gia-dung,73104628,"Máy lọc không khí, khử mùi, kết nối Wifi BOHMANN B501 - Hàng chính hãng",1890000,2890000,1000000,35
TIKI,dien-gia-dung,90024050,"Bếp Âm Từ Đôi Sunhouse SHB9003-EC (70 cm) - Hàng Chính Hãng",2269000,4613000,2344000,51
TIKI,dien-gia-dung,13116577,"Bộ điếu inox, sen đồng loại tốt. Sử dụng cho các dòng bếp kính, inox phổ thông - Hàng chính hãng",79210,89000,9790,11
TIKI,dien-gia-dung,35088891,"Thiết bị lọc nước Cleansui trên bồn rửa ET101-hàng chính hãng",6381818,6381818,0,0
TIKI,dien-gia-dung,26078293,"Quạt đứng Toshiba F-LSA10(H)VN (50W) - Xám - Hàng chính hãng",868000,1080000,212000,20
TIKI,dien-gia-dung,7756048,"Lõi lọc Karofi số 4 (Màng lọc RO) - Hàng chính hãng",319000,329000,10000,3
TIKI,dien-gia-dung,92492872,"Nồi Chiên Không Dầu Điện Tử Philips HD9270/90 (6.2 Lít)  - Hàng Chính Hãng",3249000,3898800,649800,17
TIKI,dien-gia-dung,192897216,"Dây cấp và dây thải máy lọc nước, Giá 1 mét - Hàng Chính Hãng",7000,8000,1000,13
TIKI,dien-gia-dung,163825318,"Máy Xay Thịt 2 Lưỡi Dao Kép DAMAS KF-260 (2 Lít - 300W) - Hàng Chính Hãng",411000,800000,389000,49
TIKI,dien-gia-dung,125087259,"Máy sấy tóc Bluestone HDB-1827 , Công Suất 1100W , Bảo hành điện tử 2 năm, Hàng chính hãng",289000,299000,10000,3
TIKI,dien-gia-dung,75332563,"Máy Cạo Râu 3 Lưỡi Chuyên Nghiệp Máy Cạo Sạch Không Đau Có Thể Cạo Râu Khô và Dùng Nước KM2801",193000,220000,27000,12
TIKI,dien-gia-dung,496739,"Bếp Gas Dương Đôi Rinnai RV-360 GMN – Đen- Hãng chính hãng",729000,729000,0,0
TIKI,dien-gia-dung,192155126,"Bàn là hơi nước cầm tay Lock&lock ENI148 ( Model 2022 ) - Hàng Chính Hãng",499000,800000,301000,38
TIKI,dien-gia-dung,393735,"Nồi Cơm Điện Midea CM06SA (0.6 Lít) - Hàng Chính Hãng",488000,488000,0,0
TIKI,dien-gia-dung,36225725,"Cửa gió nhựa vuông Décor 155*155H- Hàng nhập khẩu",190000,190000,0,0
TIKI,dien-gia-dung,125087219,"Bàn Ủi Hơi Nước Đứng BlueStone GSB-3911 (1800W) - Hàng Chính Hãng",1199000,1799000,600000,33
TIKI,dien-gia-dung,128294177,"Chảo vuông 15x20 cm đáy từ / Induction cao cấp Hàn Quốc, chống dính vân đá an toàn cho sức khỏe, dùng được tất cả các loại bếp – Hàng chính hãng",199000,500000,301000,60
TIKI,dien-gia-dung,456057,"Lò Vi Sóng Có Nướng Sharp R-G227VN-M - 20L - Hàng chính hãng",1949000,1949000,0,0
TIKI,dien-gia-dung,11388341,"Quạt Lỡ Thân Sắt Senko LTS1636 (Hàng Chính Hãng) - Giao màu ngẫu nhiên",428000,428000,0,0
TIKI,dien-gia-dung,192150893,"Nồi cơm điện Cuckoo 1.8L CR-1005 lòng nồi chống dính, 1 nút ấn dễ dàng điều khiển - Hàng chính hãng Cuckoo Vina",740000,990000,250000,25
TIKI,dien-gia-dung,56291075,"Máy hút bụi cầm tay không dây cao cấp Xiaomi Deerma VC01 ( hàng nhập khẩu )",1285000,1590000,305000,19
TIKI,dien-gia-dung,189475890,"Quạt Tích Điện Gấp Gọn - Quạt Mini Để Bàn Xoay 180 Độ, 3 Tốc Độ Gió, Cổng Sạc USB Có Thể Điều Chỉnh Độ Cao Siêu Tiện Lợi - HÀNG CHÍNH HÃNG MINIIN",149000,149000,0,0
TIKI,dien-gia-dung,55726670,"Máy xay sinh tố và ép trái cây Tefal BL42Q166- 2L - Hàng chính hãng",1299000,1522800,223800,15
TIKI,dien-gia-dung,137904273,"Máy tạo bọt cà phê, sữa LEBENLANG LBF3088 hâm nóng và tạo bọt sữa, dung tích",759000,900000,141000,16
TIKI,dien-gia-dung,160893031,"Máy Hút Bụi Cầm Tay Siêu Lốc Xoáy Deerma DX810 - Hàng Nhập Khẩu",639000,849000,210000,25
TIKI,dien-gia-dung,126979953,"Máy sấy tóc Philips BHD510/00 - Hàng Chính Hãng",1200000,1200000,0,0
TIKI,dien-gia-dung,907086,"Nồi Áp Suất Điện Đa Năng Sunhouse SH1550 (5 Lít) - Nâu - Hàng chính hãng",883000,883000,0,0
TIKI,dien-gia-dung,637446,"Quạt Trần Panasonic F-56MPG-S – Bạc - Hàng chính hãng",2657000,2657000,0,0
TIKI,dien-gia-dung,64239886,"Máy xay sinh tố cầm tay Philips HR2534 (650W) - Hàng chính hãng",725000,725000,0,0
TIKI,dien-gia-dung,175175506,"Bàn ủi hơi nước CẦM TAY Lofans GT-306 LW - Hàng chính hãng",379000,599000,220000,37
TIKI,dien-gia-dung,637387,"Quạt Trần Panasonic F-60MZ2 (18inch) - Hàng chính hãng",1165000,1165000,0,0
TIKI,dien-gia-dung,79742205,"Máy ép trái cây Tefal ZE420D38 - Hàng chính hãng",1060000,1699000,639000,38
TIKI,dien-gia-dung,122646060,"Bếp Hồng Ngoại Đơn Kangaroo KG20IFP1 (2000W) - Hàng Chính Hãng",540000,1010000,470000,47
TIKI,dien-gia-dung,2365981,"Nồi Cơm Nắp Gài Toshiba RC-18JFM(H)VN (1.8L) - Hàng chính hãng",750000,800000,50000,6
TIKI,dien-gia-dung,191089378,"Máy duỗi, ép tóc Philips BHS53000",1980000,1980000,0,0
TIKI,dien-gia-dung,58125154,"Siêu sắc thuoc điện 1.8 lít NodaCook - Hàng Chính Hãng",550000,745000,195000,26
TIKI,dien-gia-dung,176723662,"Máy ép trái cây, máy ép chậm Mitomo EC-55 hàng chính hãng",979000,1599000,620000,39
TIKI,dien-gia-dung,112448930,"Bình Đun Siêu Tốc Kangaroo KG20SK3 (2.0 Lít) - Hàng Chính Hãng",260000,520000,260000,50
TIKI,dien-gia-dung,42833330,"Van cấp nước đầu nguồn kết nối nhanh dùng trong máy lọc nước – Hàng chính hãng",48000,70000,22000,31
TIKI,dien-gia-dung,78488438,"Quạt Đứng Thân Sắt Senko DTS1609 - Màu ngẫu nhiên - Hàng Chính Hãng",491000,491000,0,0
TIKI,dien-gia-dung,108240595,"Máy lọc nước Unilever Pureit Delica UR5440  thiết kế nhỏ gọn tóc độ lọc 1 lít/phút -Hàng chính hãng",7750000,7990000,240000,3
TIKI,dien-gia-dung,108084722,"Quạt không dây gấp gọn CYKE P10 tự động xoay, có remote điều khiển, hẹn giờ và kiêm đèn ngủ, 5 cánh, hàng chính hãng",990000,990000,0,0
TIKI,dien-gia-dung,148000944,"Nồi cơm điện MIDEA MB-FS4020E Nấu cơm nhanh chín Tiết kiệm điện Dung tích 1.5L Nhiều chế độ nấu Hàng Chính Hãng",799000,890000,91000,10
TIKI,dien-gia-dung,29287558,"Máy Hút Bụi Không Dây Có Cán vừa hút vừa lau Philips FC6728 - Hàng Chính Hãng",5499000,10000000,4501000,45
TIKI,dien-gia-dung,658094,"Quạt Bàn Senko B102 - Giao Màu Ngẫu Nhiên - Hàng Chính Hãng",235000,235000,0,0
TIKI,dien-gia-dung,165045990,"Cây nước nóng lạnh để bàn Nagakawa NAG1107 (500W) - Hàng Chính Hãng",990000,1990000,1000000,50
TIKI,dien-gia-dung,33597004,"Bàn Ủi Hơi Nước Không Dây Panasonic NI-WL30VRA - Mặt Đế Silver Titan - Công Suất 1550W - Hàng Chính Hãng",1360000,1720000,360000,21
TIKI,dien-gia-dung,142261054,"Bếp nướng không khói đă năng Namilux GS2621PF - HÀNG CHÍNH HÃNG (MP)",549000,549000,0,0
TIKI,dien-gia-dung,74447300,"Máy phun sương tạo độ ẩm không khí dung tích lớn 550ml - cấp ẩm cho da, phòng điều hòa, khuếch tán tinh dầu - Chĩnh Hãng - VinBuy",265000,500000,235000,47
TIKI,dien-gia-dung,11386190,"Thiết Bị Lọc Nước Lắp Tại Vòi EF201 - Hàng chính hãng",2248363,2248363,0,0
TIKI,dien-gia-dung,157431724,"Máy Nướng Bánh Mỳ, Máy Kẹp Bánh Mỳ Sandwich-Waffle 2 Khay BEAR SMZ-B05N1 Công Suất 450 W - Hàng Chính Hãng",433500,435000,1500,0
TIKI,dien-gia-dung,82558771,"Máy uốn tóc 3 trục Kemei KM-1010 điều chỉnh 2 mức nhiệt độ chuyên dụng làm tóc xoăn gợn sóng, uốn tóc uốn sóng nước bồng bềnh tiện lợi",342000,349000,7000,2
TIKI,dien-gia-dung,21403520,"Quạt Đứng Panasonic F-409KBE - Hàng nhập khẩu",2839000,2839000,0,0
TIKI,dien-gia-dung,214819929,"Máy Nướng Bánh Mì 2 Ngăn , máy nướng bánh mì sandwich- sokany-700w Hàng chính hãng",379000,379000,0,0
TIKI,dien-gia-dung,133931756,"Máy trộn bột làm bánh Sohef SC216 3 trong 1, đánh trứng, đánh kem, trộn thực phẩm, hàng chính hãng",1595000,1595000,0,0
TIKI,dien-gia-dung,24598534,"Máy Tạo Kiểu Tóc Panasonic EH-HV11-K645 (Đen) - Hàng Chính Hãng",739000,879000,140000,16
TIKI,dien-gia-dung,189671864,"Bộ tạo kiểu tóc Philips BHP398/00 Gồm 1 Máy ép tóc + 1 Máy sấy tóc -  tạo kiểu tóc dễ dàng - nhanh - chuyên nghiệp",1179000,1309000,130000,10
TIKI,dien-gia-dung,53034918,"Tông đơ cắt tóc Xiaomi Enchen Humming bird 3 lưỡi dao 10W độ ồn thấp - Hàng Nhập Khẩu",239000,314000,75000,24
TIKI,dien-gia-dung,178093045,"Máy Sấy Tóc, Tạo Kiểu Tóc Fmall SK-2202 Nhỏ Gọn, Công Suất Lớn",128000,128000,0,0
TIKI,dien-gia-dung,790397,"Máy Đánh Trứng Daewoo DWHM-318 (150W) - Hàng chính hãng",240000,439000,199000,45
TIKI,dien-gia-dung,57911705,"Máy ép trái cây chậm cao cấp Hurom H200 (200W) - Hàng Chính Hãng - Màu xám",7899000,15000000,7101000,47
TIKI,dien-gia-dung,72454938,"Nồi Ninh Hầm, Nấu Cháo, Chưng Yến, Nấu Cháo Chậm Đa Năng ( Hấp + Nấu ) 2 Tầng. Tặng Kèm Lồng Hấp + 2 Nồi Sứ 500ml -- Hàng Nhập Khẩu",787900,788900,1000,0
TIKI,dien-gia-dung,257538128,"Combo Máy Lọc Không Khí Bù Ẩm ULTTY SKJ - CR022 Dạng Quạt, Khử Khuẩn Bằng Tia UV + Màng lọc HEPA H14 Nano Phân Tử Bạc - Hàng Chính Hãng",9100000,12000000,2900000,24
TIKI,dien-gia-dung,417994,"Nồi Cơm Điện HappyCook HC-060 (0.6L) - Xanh - Hàng chính hãng",749000,749000,0,0
TIKI,dien-gia-dung,150977057,"Lõi lọc số 3 Karofi Smax Duo vi lọc đa điểm - Hàng chính hãng",68000,70000,2000,3
TIKI,dien-gia-dung,113579153,"Máy đánh trứng cầm tay, tiết kiệm điện, sạc USB, thương hiệu NBAYOU, thiết kế dễ thương, nhỏ gọn, tốc độ đánh nhanh, nhiều màu sắc lựa chọn - hàng chính hãng",195000,195000,0,0
TIKI,dien-gia-dung,157542552,"Ca Nấu Mì Mini, Nồi Lẩu Điện Đa Năng Có Tay Cầm, Nắp Thủy Tinh, Size To 18cm Kèm Xửng Hấp - Hàng Loại 1 - Chính Hãng MINIIN",131000,131000,0,0
TIKI,dien-gia-dung,576178,"Máy Làm Tỏi Đen Tiross TS906 - Màu Bạc - Hàng chính hãng",1500000,1690000,190000,11
TIKI,dien-gia-dung,36295619,"Máy lọc không khí và tạo ẩm Daikin MCK55TVM6 - Hàng chính hãng",7890000,9900000,2010000,20
TIKI,dien-gia-dung,31885425,"Quạt bàn Senko sang trọng cao cấp B1210 màu ngẫu nhiên - Hàng Chính Hãng",291000,291000,0,0
TIKI,dien-gia-dung,58057114,"Máy xay sinh tố Philips HR2223/00 - Hàng Chính Hãng",1450000,1495000,45000,3
TIKI,dien-gia-dung,134529669,"Máy Hút Chân Không Life360 AL-HCK21–Tặng 10 Túi (15x25cm)–Màu Đen (90W) ; Máy Hút Chân Không Thực Phẩm Đa Chức Năng, Với Thiết Kế Gọn Nhẹ, Thao Tác Đơn Giản, Hút Và Hàn Nhanh Chóng, Bảo Quản Thức Ăn Lâu Hơn, Phù Hợp Với Mọi Gia Đình – Hàng Chính Hãng",233000,499000,266000,53
TIKI,dien-gia-dung,26020574,"Bếp Dương Từ Đôi Proficook PC-DKI 1067 (3500W) - Hàng Chính Hãng",7840000,7840000,0,0
TIKI,dien-gia-dung,179059925,"Nồi chiên không dầu Hafele HS-AF502B 5.7L (535.43.713) (Hàng chính hãng)",2449000,4190000,1741000,42
TIKI,dien-gia-dung,109331044,"Quạt treo tường Lifan TE-1689 có remote điều khiển, quạt đảo lượn sóng",685000,685000,0,0
TIKI,dien-gia-dung,114691245,"Lõi Lọc Nước Số 2 Kanzo - GAC/OCB Than Hoạt Tính- Hàng Chính Hãng",80000,80000,0,0
TIKI,dien-gia-dung,392857,"Bình Đun Siêu Tốc Philips HD9316 (1.7L) - Hàng chính hãng",1035000,1242000,207000,17
TIKI,dien-gia-dung,42326460,"Bộ 02 co L hai đầu dây nối nhanh dùng trong máy lọc nước – hàng chính hãng",19000,30000,11000,37
TIKI,dien-gia-dung,2166847,"Bộ Túi Lọc Bụi Karcher VC 2 (5 Cái) - Hàng chính hãng",175000,186545,11545,6
TIKI,dien-gia-dung,117161148,"Lưỡi dao thay thế cho máy cạo râu enchen blackstone 3 - Hàng nhập khẩu",129000,138000,9000,7
TIKI,dien-gia-dung,185816374,"Nồi cơm điện KIPOR KP-N25912 - 1.2L - Phủ chống dính HOÀNG KIM, Nồi cơm có tặng kèm vỉ hấp - phù hợp 2-3 người ăn - Hàng chính hãng",540000,899000,359000,40
TIKI,dien-gia-dung,129766377,"Máy Xay Sinh Tố Đa Năng Mini Cầm tay Sạc Pin Tiện Dụng, Máy Xay 6 Lưỡi Thép Không Gỉ - Gọn Nhẹ - Hàng Chính Hãng MINIIN",96000,96000,0,0
TIKI,dien-gia-dung,392839,"Bình Đun Siêu Tốc Philips HD9303 (1.2 Lít) - Hàng chính hãng",400000,630000,230000,37
TIKI,dien-gia-dung,51398877,"ĐẦU VÒI LỌC NƯỚC ĐA NĂNG V2 (mang lại nguồn nước tinh khiết cho gia đình) - Hàng Nhập Khẩu",83000,89000,6000,7
TIKI,dien-gia-dung,48962461,"Lò Vi Sóng Sharp R-207VN-SL (20L) - Hàng Chính Hãng",1450000,1450000,0,0
TIKI,dien-gia-dung,169417287,"Bình đun siêu tốc Sharp 1.7 lít EKJ-17EVPS - Hàng chính hãng",489000,610000,121000,20
TIKI,dien-gia-dung,171945063,"Máy xay sinh tố KIPOR KP-S306 - Lưỡi thép chống ăn mòn siêu bền - Tặng kèm 3 cối 0,2L, 0,5L, 1,5L - Tự ngắt chống quá tải - Hàng chính hãng",453000,749000,296000,40
TIKI,dien-gia-dung,2745859,"Bếp Từ Đôi Hồng Ngoại Cảm Ứng KAFF KF-073IC - Hàng Chính Hãng",5450000,5450000,0,0
TIKI,dien-gia-dung,109850925,"MÁY CẠO RÂU PHILIPS PQ206",341000,368000,27000,7
TIKI,dien-gia-dung,176152243,"Bàn ủi hơi nước BlueStone SIB-3879,Công Suất 2400W, Màn LCD hiển thị thông số, Hàng Chính Hãng",849000,999000,150000,15
TIKI,dien-gia-dung,55937178,"Cửa kỹ thuật NHỰA có tay nắm 300х300 - LT3030P - Hàng nhập khẩu",210000,210000,0,0
TIKI,dien-gia-dung,13239533,"Bộ kiềng bếp gas 5 chân, sử dụng thay thế cho các dòng bếp kính phổ thông - Hàng chính hãng",49000,49000,0,0
TIKI,dien-gia-dung,57902421,"Bình Đun Siêu Tốc Toshiba KT-15DS1NV (1.5L) - Hàng Chính Hãng",899000,950000,51000,5
TIKI,dien-gia-dung,197674846,"Quạt Treo Tường Công Nghiệp 2 Dây SanKyo B4 - Hàng chính hãng",360000,690000,330000,48
TIKI,dien-gia-dung,112076659,"Combo 3 Lõi Lọc Nước 1,2,3 Kanzo RO L123 (Lõi PP5 + OCB + PP1) - Hàng chính hãng",200000,200000,0,0
TIKI,dien-gia-dung,142208048,"Cây Trộn Phết Kem Dùng Làm Bánh Thiết Kế Tiện Dụng",18400,20000,1600,8
TIKI,dien-gia-dung,192897190,"Tay mở cốc lọc 123, Tay vặn cốc lọc 10in, 20in, Tay mở vỏ màng RO - Hàng Chính Hãng - TAY GÔNG 10 INCH",16000,24000,8000,33
TIKI,dien-gia-dung,192897184,"Vòi máy lọc nước Inox 304, Không Chì an toàn cho sức khoẻ - Hàng Chính Hãng - VÒI INOX THƯỜNG",106000,190000,84000,44
TIKI,dien-gia-dung,243245301,"Combo 3 lõi lọc nước Karofi 1,2,3 chính hãng",54000,54000,0,0
TIKI,dien-gia-dung,16654646,"Quạt Treo Tường Có Điều Khiển Tiross TS9186 (50W) - Hàng Chính Hãng",1300000,1499000,199000,13
TIKI,dien-gia-dung,149914949,"Nồi Chiên Không Dầu Philips HD9200 - 4.1Lit/1400W - Hàng Chính Hãng",1649000,2699000,1050000,39
TIKI,dien-gia-dung,192897201,"Khẩu khoá máy lọc nước - Hàng Chính Hãng",58000,100000,42000,42
TIKI,dien-gia-dung,74932973,"Máy may Brother JK17B - Hàng chính hãng",3198000,3280000,82000,3
TIKI,dien-gia-dung,176150706,"Combo Nồi Nấu Chậm 0,8L SUBE001 + Máy Xay Ăn Dặm 0,3L B03V2 cháo, chưng yến dinh dưỡng, tiện dụng - Hàng Chính Hãng",765000,1012999,247999,24
TIKI,dien-gia-dung,3873779,"Bình Đun Siêu Tốc Philips HD9350/90 (1.7L) - Hàng Nhập Khẩu",739000,739000,0,0
TIKI,dien-gia-dung,146289318,"Máy ép  trái cây, máy ép Mitomo EC-55 xuất xứ thái lan",979000,1320000,341000,26
TIKI,dien-gia-dung,243051073,"Máy Lọc Không Khí Philips AC0850/20 AC1715/20 – Hàng Chính Hãng",3299000,4500000,1201000,27
TIKI,dien-gia-dung,403444,"Máy Pha Cà Phê Espresso Tiross TS620 - Hàng Chính Hãng",1170000,1990000,820000,41
TIKI,dien-gia-dung,48462032,"Nồi Cơm Điện Lock&Lock EJR431 Dung Tích 1 lít (Hàng Chính Hãng)",599000,1100000,501000,46
TIKI,dien-gia-dung,72637441,"Lò chiên không dầu hấp nướng đối lưu Panasonic NU-SC180BYUE 20 lít - Hàng Chính Hãng",8081000,12530000,4449000,36
TIKI,dien-gia-dung,42617248,"Phụ kiện kết nối bộ lọc thô, lọc sinh hoạt 10 inch ren phi 21",92000,115000,23000,20
TIKI,dien-gia-dung,691584,"Lò Vi Sóng Tráng Men Có Nướng Samsung MG23K3515AS/SV (23 lít) - Hàng Chính Hãng",1820000,2890000,1070000,37
TIKI,dien-gia-dung,31252978,"Lẩu Điện Nagakawa NAG1902 (4.0 Lít) - Hàng Chính Hãng",800000,1070000,270000,25
TIKI,dien-gia-dung,57878964,"Nồi cơm cao tần Toshiba RC-10IX1PV (1 Lít)- Hàng Chính Hãng",2640000,2990000,350000,12
TIKI,dien-gia-dung,154241416,"Máy hút bụi lau nhà airbot iClean Pro tích hợp tự động giặt Dẻ, 3 công việc trong 1, hút và lau chuyên sâu, hàng chính hãng",4990000,4990000,0,0
TIKI,dien-gia-dung,126979955,"Máy sấy tóc Philips BHD500/00 - Hàng Chính Hãng",825000,984000,159000,16
TIKI,dien-gia-dung,81387722,"Cửa thông hơi gắn tường đôi 4513DP- Hàng nhập khẩu",180000,180000,0,0
TIKI,dien-gia-dung,70671961,"Tủ sấy quần áo chính hãng cao cấp ",795000,795000,0,0
TIKI,dien-gia-dung,166449072,"[ HCM] Bếp Từ 2 Vùng Nấu Bosch HMH.PPI82560MS (Series 8) - 78cm - Hàng Chính Hãng",12544000,12800000,256000,2
TIKI,dien-gia-dung,124015743,"Nồi cơm điện TOSHIBA RC-18NMF-WT Thái Lan Hàng nhập khẩu",2150000,2150000,0,0
TIKI,dien-gia-dung,54808192,"Niêu nồi đất kho cá nấu cơm truyền thống",52000,52000,0,0
TIKI,dien-gia-dung,43547272,"Máy Cạo Râu Kemei KM-2801 Dùng Sạc Có Thể Cạo Râu Khô Và Nước và Kem Cạo Râu",193000,220000,27000,12
TIKI,dien-gia-dung,1746051,"Quạt đứng 4 số Điện cơ 91 QRCO - Hàng Chính Hãng",440000,440000,0,0
TIKI,dien-gia-dung,186741174,"Máy Kẹp Sandwich Cao Cấp Nướng Siêu Nhanh Chỉ 3 Phút, Máy Nướng Bánh Mì Đa Năng Chống Dính Tuyệt Đối, Chiên Trứng, Nướng Thịt - Hàng Chính Hãng",495000,495000,0,0
TIKI,dien-gia-dung,132847950,"Bếp Gas Dương Đôi Kangaroo KG8G1C - Hàng Chính Hãng",690000,1120000,430000,38
TIKI,dien-gia-dung,108279986,"Máy hút bụi diệt khuẩn giường nệm Mamibot Uvlite100 - Hàng chính hãng",1980000,1980000,0,0
TIKI,dien-gia-dung,50461038,"Máy Hút Bụi Cầm Tay Đa Năng Deerma CM1300 (350W) - Hàng chính hãng",938000,938000,0,0
TIKI,dien-gia-dung,20659766,"Bếp Gas Mini Cao Cấp NaMilux PL-1911PF-Hàng Chính Hãng (Giao Màu Ngẫu Nhiên)",259000,259000,0,0
TIKI,dien-gia-dung,57900412,"Nồi cơm cao tần Toshiba RC-10IP1PV (1 Lít) - Hàng Chính Hãng",3530000,3790000,260000,7
TIKI,dien-gia-dung,106740604,"Quạt Kẹp Tích Điện Yoobao F04 Mini Pin Siêu Khủng 6400mah Thoải Mái 2 Ngày Với 4 Tốc Độ - Hàng Chính Hãng",256623,259700,3077,1
TIKI,dien-gia-dung,429546,"Bếp Hồng Ngoại Iruka I-77 (2200W) - Hàng Chính Hãng",1700000,2490000,790000,32
TIKI,dien-gia-dung,187812590,"Máy sấy tóc Philips BHD500/00 - Sấy tóc nhanh khô - Bảo vệ tóc không bị quá nóng - Hàng Chính Hãng",1105000,1300000,195000,15
TIKI,dien-gia-dung,12878026,"Bộ điếu inox hồng ngoại fi90mm thay thế cho các dòng bếp cùng kích thước ( trắng ) - Hàng chính hãng",69520,79000,9480,12
TIKI,dien-gia-dung,188492538,"Máy Hút Bụi Cầm Tay Không Dây Besti, Máy Hút Bụi Xe Ô Tô, Máy Hút Bụi Gia Đình Cao Cấp, Lực Hút Cực Mạnh 6000PA, Dung Lượng Pin Lớn 4000mAh - Hàng Chính Hãng",260000,260000,0,0
TIKI,dien-gia-dung,128817707,"Máy làm sữa hạt mini Snapbee SK-205VN- dung tích 300ml 5 chức năng tiện lợi - Hàng chính hãng",1150000,1150000,0,0
TIKI,dien-gia-dung,21072910,"Quạt Tích Điện Mini YooBao - 6400mAh - Sử Dụng Lên Đến 32h - Hàng Chính Hãng",265000,349900,84900,24
TIKI,dien-gia-dung,548609,"Máy đánh trứng Tiross TS5400 - Đen - Hàng chính hãng",559000,790000,231000,29
TIKI,dien-gia-dung,368612,"Lò Vi Sóng Có Nướng Sharp R-G222VN-S- 20 Lít - Hàng chính hãng",1749000,1749000,0,0
TIKI,dien-gia-dung,158897700,"Nồi cơm áp suất đa năng Elmich PCE-1806 (5 Lít) - Hàng chính hãng",1750000,2690000,940000,35
TIKI,dien-gia-dung,3071301,"Đầu Lọc Nước Trực Tiếp Tại Vòi Eurolife EL-LS-D10 (Trắng) - Hàng Chính Hãng",420750,495000,74250,15
TIKI,dien-gia-dung,73330429,"Nồi cơm điện giảm tinh bột cao cấp La gourmet 5l - 363992 (chứng nhận bởi SGS tách giảm 37% tinh bột nhanh)",1999000,1999000,0,0
TIKI,dien-gia-dung,170184016,"Máy Trộn Bột Đánh Trứng Đa Năng Unie EM5 Cao Cấp Tiêu Chuẩn Đức Dung Tích 8 Lít Công Suất 1300W  - Hàng Chính Hãng",3331000,6599000,3268000,50
TIKI,dien-gia-dung,74261830,"Máy Xay Cà Phê Mini Zamboo ZB-100GR - Hàng Chính Hãng",369000,450000,81000,18
TIKI,dien-gia-dung,187183489,"Hàng chính hãng Quạt đối lưu không khí Iris Ohyama STF-DC18T",3480000,4000000,520000,13
TIKI,dien-gia-dung,80087066,"Nồi áp suất điện đa năng 6L Tefal CY601868 - Hàng chính hãng",1869000,2242800,373800,17
TIKI,dien-gia-dung,3492413,"Máy sấy hoa quả Makxim USA MKX-DH-2015 - Hàng chính hãng",1145000,1145000,0,0
TIKI,dien-gia-dung,273020028,"Nồi Chiên Không Dầu KALITE KL-1200 Dung Tích 12 Lít Công Suất 1800 W - Hàng Chính Hãng",2999000,5979000,2980000,50
TIKI,dien-gia-dung,43935650,"Máy xay ép đa năng Panasonic MJ-M176 - hàng nhập khẩu",2089000,2089000,0,0
TIKI,dien-gia-dung,66456774,"Ấm Đun Thủy Tinh Siêu Tốc Cao Cấp Đa Năng Ariranglife AL-A17G5 – màu xám (1,7 lít) - Ấm Đun Thủy Tinh Thông Minh Chịu Nhiệt - Bình đun thủy tinh siêu nhanh cao cấp đa năng, có thể đun nước, pha trà, pha sữa, pha mì, tự ngắt điện khi sôi, an toàn sức khỏe",452000,899000,447000,50
TIKI,dien-gia-dung,72801254,"Bàn ủi hơi nước bình treo công nghiệp ES-94AL Silver Star - Hàng chính hãng",2200000,2200000,0,0
TIKI,dien-gia-dung,10909636,"Máy Vắt Cam Lock&Lock EJJ241 (40W - 1.2 Lít) - Hàng chính hãng",290000,400000,110000,28
TIKI,dien-gia-dung,125536262,"Nồi chiên không dầu OLIVO AF15-hàng chính hãng",3190000,3190000,0,0
TIKI,dien-gia-dung,197971037,"hộp cơm cắm điện giữ nhiệt 3 tầng, chất liệu inox 304 an toàn sức khỏe, hộp cơm giữ nhiệt, hộp cơm văn phòng tiện lợi - Chính hãng DoDoDios",118000,118000,0,0
TIKI,dien-gia-dung,58057110,"Máy xay sinh tố Philips HR2222/00 (700W) - Hàng Chính Hãng",1325000,1567000,242000,15
TIKI,dien-gia-dung,220661346,"Bàn Ủi Hơi Nước Cầm Tay Sokany 3060 Có Thể Gấp Gọn - Hàng Chính Hãng",439000,439000,0,0
TIKI,dien-gia-dung,147721633,"[HCM]Quạt Kẹp Bình 12V Công Nghiệp B3 Lổ Cắm 5.5 ly 3 Tốc Độ Gió Chạy Trực Tiếp NLMT. HÀNG CHÍNH HÃNG",249000,249000,0,0
TIKI,dien-gia-dung,155608271,"Thiết bị lọc nước tại vòi Torayvino MK303-600B-EG - Uống trực tiếp tại vòi - 600L - Hàng chính hãng Nhật Bản",1012000,1190000,178000,15
TIKI,dien-gia-dung,10951384,"Quạt Treo 2 Dây Senko TC1626 (47W) - Hàng chính hãng",355000,355000,0,0
TIKI,dien-gia-dung,184697585,"Máy xay sinh tố công nghiệp Promix PM-819B - 1.5 lít - Hàng Chính Hãng",2490000,2490000,0,0
TIKI,dien-gia-dung,186276961,"Nồi Chiên Không Dầu Elmich AFE-3950 (14Lít) - Hàng Chính Hãng",3400000,4690000,1290000,28
TIKI,dien-gia-dung,159885560,"Máy Xay Sinh Tố Philips HR2041/30 (450W) - Hàng Chính Hãng",790000,846000,56000,7
TIKI,dien-gia-dung,108747198,"Quạt treo tường Senko TR1628 có remote điều khiển - Bảo hành 2 năm - Hàng chính hãng - Được chọn màu",513000,513000,0,0
TIKI,dien-gia-dung,141258440,"Bộ Lọc Máy Lọc Không Khí Samsung 60m2 AX60R5080WD (CFX-D100/GB) - Hàng Chính Hãng",1350000,1990000,640000,32
TIKI,dien-gia-dung,37535371,"Lò Vi Sóng Sharp R-209VN-SK (20 lít) - Hàng Chính Hãng",1290000,1290000,0,0
TIKI,dien-gia-dung,72945629,"Bộ lọc nước Konka KPW - LT01 (KJ) mẫu mới, lọc sạch nước an toàn không mùi clo, công nghệ 9 màng lọc, máy lắp trực tiếp tại vòi nước -Hàng nhập khẩu",547000,650000,103000,16
TIKI,dien-gia-dung,533336,"Bếp Hồng Ngoại Sunhouse SHD6014Đ - Đen - Hàng chính hãng",809000,809000,0,0
TIKI,dien-gia-dung,468656,"Bình Thủy Điện Tử Panasonic NC-EG4000CSY 4L - Hàng chính hãng",2249000,2590000,341000,13
TIKI,dien-gia-dung,82874777,"Quạt Lỡ ống nhựa SENKO L1638 - Hàng chính hãng",369000,369000,0,0
TIKI,dien-gia-dung,34438039,"Dàn giải nhiệt - Hàng chính hãng",380000,380000,0,0
TIKI,dien-gia-dung,146214755,"Máy Hút Bụi Cầm Tay cho Xe Hơi/Ô tô Dòng Điện DC USA Stanley SL18125DC - Hàng Chính Hãng",980000,980000,0,0
TIKI,dien-gia-dung,97045675,"Quạt treo tường Hali công nghiệp TC197 (2 Dây) Hàng Chính Hãng (màu đen) ",555000,555000,0,0
TIKI,dien-gia-dung,103368920,"Ấm Siêu Tốc Thủy Tinh Sunhouse SHD1215B (Đen) - Hàng Chính Hãng",340000,340000,0,0
TIKI,dien-gia-dung,105602617,"Quạt đứng SENKO sải cảnh lớn , hẹn giờ bật tắt cao cấp hàng chính hãng- GIAO MÀU NGẪU NHIÊN  ",450000,450000,0,0
TIKI,dien-gia-dung,4754633,"Máy Đánh Trứng Philips HR3705 (300W) - Hàng Chính Hãng",685000,797000,112000,14
TIKI,dien-gia-dung,117837053,"Ấm Siêu Tốc Sunhouse SHD1306 (1.7 Lít) - Hàng Chính Hãng",369000,590000,221000,37
TIKI,dien-gia-dung,174121440,"Nồi Cơm Điện Tử BlueStone RCB-5938, 1.8Lit - 760W, Hàng Chính Hãng",1349000,1999000,650000,33
TIKI,dien-gia-dung,153495047,"Bếp điện từ Elmich ICE-3874 - Hàng chính hãng",1070000,1070000,0,0
TIKI,dien-gia-dung,175154487,"Nồi Cơm Điện cao tần Sharp KS-IH191V-GL(1.8L) Đa Chức Năng Hàng Chính Hãng",3122000,4200000,1078000,26
TIKI,dien-gia-dung,111704764,"Thiết bị phun khử trùng nano cầm tay CTFAST - 05 : Máy phun khử trùng gia đình tích điện không dây kết hợp ánh sáng xanh an toàn, khử trùng, diệt khuẩn, đuổi muỗi",199000,349000,150000,43
TIKI,dien-gia-dung,1734985,"Máy Nước Nóng Lạnh Toshiba RWF-W1669BV(K1) 650W - Hàng chính hãng",3880000,5390000,1510000,28
TIKI,dien-gia-dung,11259209,"Ấm Sắc Thuốc Gốm Bát Tràng Fujika FJ-Ck33K6 (3.3L) - Hàng chính hãng",290700,290700,0,0
TIKI,dien-gia-dung,825270,"Chân Vịt Máy Điện Tử Cuốn Biên Dẹp Brother F002N (7mm) - Hàng chính hãng",99000,99000,0,0
TIKI,dien-gia-dung,444408,"Nồi Áp Suất Điện Tử Philips HD2136 (5 Lít) - Hàng Chính Hãng",2329000,2694000,365000,14
TIKI,dien-gia-dung,21190041,"Bình Đun Siêu Tốc SmartCook KES-3865 (1.0 Lít) - Hàng Chính Hãng",377000,599000,222000,37
TIKI,dien-gia-dung,116036994,"Tông đơ cắt tóc xiaomi Enchen Boost phiên bản mới 2020 - Màu ngẫu nhiên",188000,200000,12000,6
TIKI,dien-gia-dung,12638220,"Máy Sấy Tóc Tiross TS4321",399000,399000,0,0
TIKI,dien-gia-dung,274906423,"Ấm Siêu Tốc Bình Pha Trà Bear YSH-E15M1 1.5L Công Suất 800 W - Hàng Chính Hãng",949000,1699000,750000,44
TIKI,dien-gia-dung,75390204,"Máy Hút Ẩm  Lọc Không Khí -2 Trong 1 - KOSMEN KM-12N - 12 Lít/ Ngày - Công suất 190W - Diện tích 10-40m2 - Hàng Chính Hãng",4598000,4598000,0,0
TIKI,dien-gia-dung,468727,"Bếp Từ BLUESTONE ICB-6655  - Hàng chính hãng",1390000,1390000,0,0
TIKI,dien-gia-dung,191422249,"Nồi cơm điện tử Toshiba RC-10DH2PV(W) - Dung tích 1.0 Lít - Lòng nồi dày 2.2 mm - Nồi giữ ấm 12 tiếng - Hàng chính hãng",1579000,1720000,141000,8
TIKI,dien-gia-dung,122949157,"Bộ lõi số 1,2,3 máy lọc nước Nano Geyser TK by Scitech (Lõi CTO/Cation-GAC-Aragon) - Hàng chính hãng",1150000,1150000,0,0
TIKI,dien-gia-dung,182558874,"Máy tạo kiểu tóc Multi Stlyes 2022 trục long",15500000,15500000,0,0
TIKI,dien-gia-dung,7171841,"Bình Thủy Điện Sunhouse SHD 1533 (3.3L) - Hàng chính hãng",820000,820000,0,0
TIKI,dien-gia-dung,121082586,"Máy Trộn Bột Ủ Bột Lên Men Tự Động BEAR HMJ-A70C1 Chống Dính Dung Tích 7 Lít Công Suất 250 W - Hàng Chính Hãng",2155000,4389000,2234000,51
TIKI,dien-gia-dung,118689737,"Điều Hòa Di Động Rowenta AU5010 Turbo Cool - Hàng Nhập Khẩu Đức",15990000,15990000,0,0
TIKI,dien-gia-dung,194122818,"Đầu hút vệ sinh nệm, nỉ, ghế saloS DXVA13-4364 sử dụng cho máy hút bụi Stanley - Hàng chính hãng",270000,270000,0,0
TIKI,dien-gia-dung,120441829,"Cây nước nóng lạnh Toshiba RWF-W1917TV(K) - Hàng chính hãng",2715000,3390000,675000,20
TIKI,dien-gia-dung,466051,"Ấm Siêu Tốc Du Lịch Tiross TS1360 0.5L- Tím - Hàng chính hãng",369000,390000,21000,5
TIKI,dien-gia-dung,161242040,"Máy xay sinh tố Panasonic MX-MG53C1CRA - Hàng chính hãng",1590000,1944000,354000,18
TIKI,dien-gia-dung,5818893,"Siêu sắc thuốc Gali GL-1801 (3.3L)- Hãng chính hãng",639000,639000,0,0
TIKI,dien-gia-dung,177429481,"Máy sấy tóc 1500W Panasonic EH-ND57-H645 - Hàng Chính Hãng",600000,630000,30000,5
TIKI,dien-gia-dung,36216612,"Cửa gió nhựa tròn Décor 80s - Hàng nhập khẩu",90000,90000,0,0
TIKI,dien-gia-dung,84284715,"Cửa gió tròn nhựa - 10DK- Hàng nhập khẩu",100000,100000,0,0
TIKI,dien-gia-dung,161501282,"Máy Hút Bụi UV-C Cầm Tay Mini đa năng Deerma CM1300 (3 in 1) Giường Nệm, Sofa, Chăn Mền Gia Đình Cao Cấp (nhập khẩu)",840000,840000,0,0
TIKI,dien-gia-dung,63562791,"Ấm sắc thuốc Trường An TA68 Ngọc   - Hàng chính hãng - Gốm sứ cao cấp  - Điện gia dụng - Siêu thuốc - Siêu điện - Ấm sắc thuốc bằng điện -  Dụng cụ nấu thuốc  -Hàng Việt Nam chất lượng cao",545000,545000,0,0
TIKI,dien-gia-dung,172111121,"Nồi chiên không dầu KIPOR KP-AF655 - 24L - Lò nướng 2 mặt trên dưới RAPID AIR đối lưu toả nhiệt đều - Thân nồi inox 304 - Hàng chính hãng",3230000,5199000,1969000,38
TIKI,dien-gia-dung,160392484,"Tông đơ cắt tóc trẻ em chuyên nghiệp chấn viền tốt máy tăng đơ điện sạc pin có dây rời kèm 9 phụ kiện 3 lược chắn viền máy cắt tóc chống nước",178000,283000,105000,37
TIKI,dien-gia-dung,403418,"Vỉ Nướng Điện Tiross TS968 - Hàng chính hãng",1070000,1290000,220000,17
TIKI,dien-gia-dung,115523313,"Ly lọc nước 10 inch - Hàng chính hãng",145000,145000,0,0
TIKI,dien-gia-dung,193723969,"Nồi Áp Suất Nhôm Đáy Từ GOLDSUN GPC1930-05IH Dung Tích 5 Lít Có Van An Toàn - Hàng Chính Hãng",724000,1279000,555000,43
TIKI,dien-gia-dung,11786176,"Bình Đun Siêu Tốc Kangaroo KG642 (1.7L) - Hàng chính hãng",390000,890000,500000,56
TIKI,dien-gia-dung,135415392,"Nồi cơm nắp gài Cuckoo CR- 1713 3 lít - Hàng chính hãng",2350000,2350000,0,0
TIKI,dien-gia-dung,162838907,"Máy ép tóc Philips BHS530/00 - Hàng Chính Hãng",1667000,1667000,0,0
TIKI,dien-gia-dung,637489,"Quạt Trần Panasonic F-56MZG-GO – Vàng - Hàng chính hãng",2656000,2656000,0,0
TIKI,dien-gia-dung,171716258,"Bàn ủi hơi nước Philips DST3040/70 - Hàng chính hãng",1390000,1499000,109000,7
TIKI,dien-gia-dung,36224613,"Cửa gió nhựa vuông Décor 220*300s -  Hàng Nhập Khẩu",250000,250000,0,0
TIKI,dien-gia-dung,4173393,"Siêu sắc thuốc điện Trường Thọ Bát Tiên Rồng Vàng BA2086V (3.2 Lít) - Hàng Chính Hãng",300000,300000,0,0
TIKI,dien-gia-dung,190703005,"Nồi Lảu Mini Đa Năng 2 Tầng, Ca Nấu Mì Hàn Quốc Có Kèm Khay Hấp 1.8L  Amalife - Hàng Chính Hãng",125000,125000,0,0
TIKI,dien-gia-dung,190864912,"Hàng Chính hãng - Máy hút bụi cầm tay, máy hút bụi giường nệm Moaz Bébé mb-037",1230000,1230000,0,0
TIKI,dien-gia-dung,141673650,"Ấm siêu tốc Happy Cook 1.8L HEK-180PW - Hàng Chính Hãng",439000,439000,0,0
TIKI,dien-gia-dung,155013713,"Lõi PP Ecotar Geyser by Scitech - Lõi số 1 máy lọc nước Nano Geyser Ecotar 2, máy lọc nước RO Geyser Allegro - Hàng chính hãng",150000,150000,0,0
TIKI,dien-gia-dung,185889330,"Máy uốn tóc Kemei KM-219 có 2 mức điều chỉnh nhiệt phù hợp mọi tính trạng tóc dòng chuyên dụng uốn xoăn lọn, uốn cụp",279000,289000,10000,3
TIKI,dien-gia-dung,185051316,"1 Hộp Cổ Dê (Đai Xiết) Cố Định Ống Dẫn Gas (200 Chiếc/Hộp)",200000,200000,0,0
TIKI,dien-gia-dung,70527500,"Quạt Bàn Tròn Hatari HT-PS20M1 - Hàng Chính Hãng - Màu Ngẫu Nhiên",470000,470000,0,0
TIKI,dien-gia-dung,1007250,"Quạt Hút Âm Trần Mitsubishi EX-25SC5T - Hàng Chính Hãng",850000,850000,0,0
TIKI,dien-gia-dung,22132884,"LÕI LỌC KHOÁNG MINERAL KAROFI - CHÍNH HÃNG  - Hàng chính hãng",160000,160000,0,0
TIKI,dien-gia-dung,121185839,"Lõi GAC Geyser by Scitech - Lõi số 2 máy lọc nước Nano Geyser TK - Hàng chính hãng",250000,250000,0,0
TIKI,dien-gia-dung,76277433,"Máy Vắt Cam Sharp EJ-J407-BK - Hàng chính hãng",269000,329000,60000,18
TIKI,dien-gia-dung,185439751,"Ấm siêu tốc HAPPY TIME SUNHOUSE Inox 1.8L HTD1088 - Hàng chính hãng",145000,145000,0,0
TIKI,dien-gia-dung,42837784,"Bộ 02 nối nhanh ren 13 – Hàng chính hãng",22000,35000,13000,37
TIKI,dien-gia-dung,31883144,"Quạt điện Senko để bàn tiện lợi cao cấp B1213 màu ngẫu nhiên - Hàng Chính Hãng",291000,291000,0,0
TIKI,dien-gia-dung,89591624,"Tông đơ cắt tóc Kemei KM-1998 công suất mạnh có màn hình LED hiển thị pin tiện lợi, dùng để fade tóc, tattoo cạo trắng thích hợp sử dụng salon tóc, barber shop",599000,599000,0,0
TIKI,dien-gia-dung,54018540,"Dao cắt, bấm dây dẫn nước RO- Hàng chính hãng",31000,35000,4000,11
TIKI,dien-gia-dung,57041563,"Nồi cơm điện 1.8L SUNHOUSE SHD8601 - Hàng chính hãng",499000,499000,0,0
TIKI,dien-gia-dung,186708921,"Máy pha cà phê espresso CF07-PLUS tích hợp xay hạt cà phê 20 mức, đánh bọt sữa, pha espresso 20 bar mạnh mẽ, 4 trong 1 tiện lợi, 2 boilers và DIY kiểm soát nhiệt độ 3 cấp, họng pha chuyên nghiệp 58mm",9790000,9790000,0,0
TIKI,dien-gia-dung,115972704,"Bộ lõi số 1,2,3,4 K-Pro Series by Scitech (Lõi PP-GAC-CTO-UF) dùng cho máy lọc nước nóng lạnh, máy lọc nước UF - Hàng chính hãng",250000,250000,0,0
TIKI,dien-gia-dung,117837049,"Ấm Siêu Tốc Thủy Tinh Sunhouse SHD1330 (1.7 Lít) - Hàng Chính Hãng",469000,780000,311000,40
TIKI,dien-gia-dung,155429679,"Robot hút bụi, lau nhà Samsung Powerbot-E (VR05R5050WK) - Hàng chính hãng",3820000,7790000,3970000,51
TIKI,dien-gia-dung,75790706,"Máy xay sinh tố Philips HR2221 - Hàng nhập khẩu",1035000,1035000,0,0
TIKI,dien-gia-dung,127502022,"Nồi cơm điện Cuckoo CR-1021R",1690000,1900000,210000,11
TIKI,dien-gia-dung,19578975,"Máy đánh trứng ngoáy sữa,cafe cầm tay mini tự động (Mẫu ngẫu nhiên) - Hàng chính hãng",25000,25000,0,0
TIKI,dien-gia-dung,53270314,"Tông đơ KEMEI KM-1949 cao cấp không dây toàn thân là hợp kim nhôm không gỉ chuyên dùng chấn viền, cạo viền, khắc tóc",549000,549000,0,0
TIKI,dien-gia-dung,122576690,"Máy Làm Sữa Chua Hương Vị Truyền Thống Song Anh - Hàng Chính Hãng",252000,500000,248000,50
TIKI,dien-gia-dung,88270302,"Bếp từ thông minh Xiaomi Mi Induction Cooker - Hàng Chính Hãng",999000,999000,0,0
TIKI,dien-gia-dung,45882438,"Bàn ủi hơi nước đứng công nghiệp SR-5000 Silver Star - Hàng chính hãng",3900000,3900000,0,0
TIKI,dien-gia-dung,192375707,"Máy lọc nước Nano Geyser ECO 8 không dùng điện - Hàng Chính Hãng",1718000,3058000,1340000,44
TIKI,dien-gia-dung,1733761,"Bộ van gas cao áp tự động an toàn Namilux NA-537SH - Hàng chính hãng",168000,168000,0,0
TIKI,dien-gia-dung,165043669,"Máy tạo độ ẩm không khí Philips HU4803/00 - Hàng nhập khẩu",1750000,2800000,1050000,38
TIKI,dien-gia-dung,42170766,"Bếp Âm Đôi Từ - Hồng Ngoaị Sunhouse Mama MMB9100VN (73 cm) (4000W) - Hàng Chính Hãng",3459000,6973000,3514000,50
TIKI,dien-gia-dung,178034158,"Nồi cơm điện tử Sharp KS-COM100DV-WH(1L)-Hàng Chính Hãng",1009000,1450000,441000,30
TIKI,dien-gia-dung,89764089,"Nồi Kho Cá Thịt 2.5L,Nồi Nấu Chậm,Nồi Nấu Cháo Cho Bé ,Nồi Chưng Yến,Nồi Tiềm Dung Tích 2.5L Năp Kính Fujika KC25 Màu Trắng Họa Tiết-Hàng chính hãng",243000,250000,7000,3
TIKI,dien-gia-dung,196559752,"Ron cao su họng Group máy Breville the Bambino/ Bambino plus (BES 450 / BES 500)- Hàng chính hãng",220000,220000,0,0
TIKI,dien-gia-dung,21652972,"Máy Sấy Tóc Bổ Sung Ion Âm Professional Tescom NNIB19",3490000,3490000,0,0
TIKI,dien-gia-dung,130398774,"Hàng Chính Hãng - Bộ Máy Đánh Trứng Kèm Xay Tỏi Ớt, Đánh Kem, Trộn Bột, Máy Cầm Tay Không Dây Đa Năng Tiện Dụng 3 Trong 1",195000,195000,0,0
TIKI,dien-gia-dung,163878489,"Quạt tháp không cánh Panworld PW-8207(W) màu trắng - Hàng chính hãng",1290000,1290000,0,0
TIKI,dien-gia-dung,32371308,"Lõi lọc cho máy lọc nước Pure 258 NUVO",200000,200000,0,0
TIKI,dien-gia-dung,59097384,"Quạt Treo Tường 2 Dây SENKO TC1626 - Màu Ngẫu Nhiên - Hàng Chính Hãng",355000,355000,0,0
TIKI,dien-gia-dung,171898434,"Bàn ủi khô Philips HD1172/01 - Hàng chính hãng",339000,349000,10000,3
TIKI,dien-gia-dung,58827092,"Bộ Lọc không khí samsung CFX-G100/GB sử dụng cho máy AX40R3030WM/SV và AX34R3020WW/SV - Hàng Chính Hãng",1095000,1490000,395000,27
TIKI,dien-gia-dung,157244400,"Lõi lọc nước thay thế tại vòi Torayvino MKC.2000B - Uống trực tiếp tại vòi - 2000L - Hàng chính hãng Nhật Bản",1161000,1290000,129000,10
TIKI,dien-gia-dung,192276244,"Quạt tích điện để bàn 12h Xiaomi Solove F5 - Hàng Chính hãng",365000,399000,34000,9
TIKI,dien-gia-dung,56592720,"Bộ Tông Đơ Cắt Tóc, Cạo Râu, Cạo Lông, Đa Năng 5 in 1 Chống Nước Toàn Thân, Phù Hợp Cho Cả Gia Đình - Hàng Chính Hãng",550000,550000,0,0
TIKI,dien-gia-dung,275515112,"Nồi áp suất Elmich PCE-1805G dung tích 2,5L - Hàng Chính Hãng",850000,2090000,1240000,59
TIKI,dien-gia-dung,973084,"Quạt Hút Thông Gió Âm Trần Senko HT250 (40W) - Hàng Chính Hãng",303000,303000,0,0
TIKI,dien-gia-dung,195840788,"Nồi nấu chậm Panasonic NF-N31AWRA - Hàng Chính Hãng",1300000,1642000,342000,21
TIKI,dien-gia-dung,165046253,"Máy vắt cam điện Nagakawa NAG0814 (0.75 Lít) - Hàng Chính Hãng",300000,499000,199000,40
TIKI,dien-gia-dung,912416,"Vỉ Nướng Điện Lock&Lock EJG211BLK (1800W) - Hàng chính hãng",799000,1429000,630000,44
TIKI,dien-gia-dung,72076730,"Tông đơ cắt tóc chuyên nghiệp - Tông đơ chạy pin - Tông đơ cắt tóc Rewell S7 pin 2500mAh, lưỡi cắt titanium sắc nét",575700,575700,0,0
TIKI,dien-gia-dung,48152656,"Máy Xay Thịt Cối Inox Lock&Lock EJM172 (2 lít) Hàng Chính Hãng",799000,1400000,601000,43
TIKI,dien-gia-dung,1953527,"Máy Sấy Tóc Sunhouse SHD2305 - Xanh",120000,120000,0,0
TIKI,dien-gia-dung,184955159,"Quạt Tích Điện Không Dây XIAOMI Smartmi Gen 2S, Sử Dụng 20 Giờ Liên Tục 100 Tốc Độ Gió Quạt Siêu Êm, Có Remote, Kết Nối App Thông Minh Công Suất 25W- Hàng Chính Hãng",1753000,3499000,1746000,50
TIKI,dien-gia-dung,172307694,"Máy Ép Chậm Trục Ngang Olivo SJ22 [Hàng Chính Hãng] Ép Rau Không Lo Kẹt Máy - Ép Kiệt Bã - Dễ Vệ Sinh",3390000,3390000,0,0
TIKI,dien-gia-dung,102572188,"Máy cạo râu Xiaomi Mijia S300 - Hàng Nhập Khẩu",378000,417000,39000,9
TIKI,dien-gia-dung,134306036,"CHÍNH HÃNG: Máy hút bụi giường, đệm, thảm không dây CHIGO, lực hút 10.000 Pa, diệt khuẩn bằng tia UV và nhiệt độ 50 độ C",580000,580000,0,0
TIKI,dien-gia-dung,75374493,"Máy pha cà phê Espresso chuẩn áp suất 20 bar, chế độ cốc đôi CM6863 tích hợp cảm ứng tiện lợi Hàng Chính Hãng",2545000,2545000,0,0
TIKI,dien-gia-dung,21403616,"Quạt Đứng Panasonic F-409KBE -Hàng Chính Hãng",2890000,2890000,0,0
TIKI,dien-gia-dung,191651847,"Bình Đun Siêu Tốc Perfect PF-B3 (1.8 Lít) - Hàng chính hãng - ( Màu Ngẫu Nhiên)",162000,279000,117000,42
TIKI,dien-gia-dung,196186238,"Máy xay mini cầm tay 3 trong 1 (máy xay nghiền tỏi ớt, rau củ, sinh tố;, máy nạo gọt hoa quả; máy cắt sợi, thái lát đồ ăn) dễ dàng vệ sinh - Chính hãng MINIIN (Giao màu ngẫu nhiên)",149000,149000,0,0
TIKI,dien-gia-dung,169002747,"MÁY ÉP TRÁI CÂY KANGAROO KG200SJD2 (MÁY ÉP CHẬM 665ml - 200W) Hàng Chính Hãng",3900000,3900000,0,0
TIKI,dien-gia-dung,50712789,"Nồi cơm điện cao tần Sharp KS-IH191V 1.8L, hàng chính hãng (Giao màu ngẫu nhiên)",2399000,3500000,1101000,31
TIKI,dien-gia-dung,3071357,"Lõi lọc cho máy lọc nước tại vòi Eurolife LS-D10",121550,143000,21450,15
TIKI,dien-gia-dung,813164,"Nồi Áp Suất Điện Comet CM6151 (6.0 Lít) - Hàng Chính Hãng",1240000,1690000,450000,27
TIKI,dien-gia-dung,1695751,"Máy Sấy Tóc Philips BHC010/00 - Hàng Chính Hãng",323000,323000,0,0
TIKI,dien-gia-dung,729907,"Quạt Bàn Lifan B-106 - Xanh Dương - Hàng Chính Hãng",185000,185000,0,0
TIKI,dien-gia-dung,136966246,"Nồi Nấu Cháo Chậm Cho Bé Ăn Dặm SEKA GT68 - Nồi Hầm Cháo, Kho Cá Chậm, Hầm Cách Thủy, Ninh Cháo Cho Bé 4 In 1 - Hàng chính hãng",280000,280000,0,0
TIKI,dien-gia-dung,162507161,"Máy lọc nước nóng lạnh 9 lõi lọc hàng chính hãng Karofi Livotec 612, màng RO 100GDP Hàn Quốc",6710400,9320000,2609600,28
TIKI,dien-gia-dung,142672117,"Máy Ép Chậm Hurom H300E-RBE - Hàng Chính Hãng",8310000,14200000,5890000,41
TIKI,dien-gia-dung,125087205,"Bàn ủi hơi nước mini BlueStone SIB-3819 (1200W) - thiết kế nhỏ gọn, dễ dàng mang theo và cất giữ - Hàng chính hãng",590000,699000,109000,16
TIKI,dien-gia-dung,146365034,"[Hàng chính hãng] Nồi Nấu Cháo Cho Bé SEKA GT68 - Nồi Hầm Cháo Chậm, Chưng Yến, Hầm Cách Thủy",270000,280000,10000,4
TIKI,dien-gia-dung,185889703,"Máy rửa và khử trùng thực phầm D'HOME COH10-C5B - Hàng Chính Hãng",827000,866000,39000,5
TIKI,dien-gia-dung,150977066,"Máy lọc nước nóng lạnh Karofi KAD-D66 - Hàng chính hãng",12096000,13440000,1344000,10
TIKI,dien-gia-dung,16215259,"Quạt Hộp USS-H3VU-Hàng chính hãng",285000,285000,0,0
TIKI,dien-gia-dung,179221297,"Nồi chiên hơi nước KIPOR KP-STEAM677 - bảng điều khiển điện tử nấu đa chế độ, chiên hấp đồng thời - Hàng chính hãng",3639000,5590000,1951000,35
TIKI,dien-gia-dung,142024770,"Bếp điện từ Elmich ICE-1831 hàng chính hãng",1154000,1499000,345000,23
TIKI,dien-gia-dung,185495917,"Nồi cơm điện Sunhouse SHD8606 1.8L - Hàng chính hãng",599000,1319000,720000,55
TIKI,dien-gia-dung,137536953,"Hộp cơm cắm điện văn phòng UNIE UV hộp đựng cơm giữ nhiệt 2 tầng 4 ngăn inox",490000,1060000,570000,54
TIKI,dien-gia-dung,144743247,"Lò vi sóng nướng đối lưu chiên không dầu Panasonic NN-CT65MBYUE – 20 thực đơn tự động – Dung tích 27L – Hàng chính hãng",4510000,6520000,2010000,31
TIKI,dien-gia-dung,110931903,"ĐẦU TREO 2 DÂY - 3HT Hàng chính hãng",175000,175000,0,0
TIKI,dien-gia-dung,117309670,"Lò vi sóng Cuckoo 20 lít CMW-A201DW - Nhỏ gọn cao cấp thời trang - Công suất 1050W - Hàng chính hãng",1199000,2470000,1271000,51
TIKI,dien-gia-dung,225938034,"Máy Hút Bụi Cầm Tay Không Dây Yoice, hút bụi ô tô - công suất 120w- Hàng chính hãng",362000,362000,0,0
TIKI,dien-gia-dung,53131650,"Máy cạo râu Philips S1121 - Hàng chính hãng",989000,989000,0,0
TIKI,dien-gia-dung,44327908,"Máy Uốn, Duỗi Và Tạo Kiểu Tóc Panasonic EH-HT40-K645 - Hàng Chính Hãng",990000,1197600,207600,17
TIKI,dien-gia-dung,56085151,"Màng Lọc HEPA Cho Máy Hút Bụi Deerma DX128/DX118C - Hàng chính hãng",49000,69000,20000,29
TIKI,dien-gia-dung,125632855,"Ấm siêu tốc thủy tinh đa năng Nagakawa NAG0316 (1.8 Lít) - Hàng chính hãng",569000,1485000,916000,62
TIKI,dien-gia-dung,11384814,"Quạt treo 2 dây mẫu mới F23 Senko TC1620 - Màu ngẫu nhiên - Hàng chính hãng",399000,399000,0,0
TIKI,dien-gia-dung,155163055,"Máy Hút Gia Đình Cao Cấp, Máy Hút Bụi Cầm Tay Không Dây Tiện Lợi, Hút Bụi Xe Ô Tô, Laptop, Giường Nệm - Lực Hút 9000PA- Hàng Chính Hãng",295000,295000,0,0
TIKI,dien-gia-dung,273159644,"Máy hút bụi cầm tay không dây UNIQ Free A7 đa năng gia đình mini pin sạc hút giường đệm nệm sofa xe hơi lực hút mạnh - Hàng chính hãng",2670000,2670000,0,0
TIKI,dien-gia-dung,174241905,"Quạt tháp không cánh và lọc không khí Tiross TS9176 (33W) - Hàng Chính Hãng",5400000,6990000,1590000,23
TIKI,dien-gia-dung,147352659,"Bàn ủi hơi nước PHILIPS GC7933/30 2400W - Hàng Chính Hãng",3699000,3699000,0,0
TIKI,dien-gia-dung,187316658,"Bình Pha Cà Phê French Press Lock&Lock LLG019 Chất Liệu Thủy Tinh Và Thép Không Gỉ - 800ml - Hàng Chính Hãng",387000,499000,112000,22
TIKI,dien-gia-dung,71159450,"Máy Lọc Không Khí ULTTY SKJ-CR021 Dạng Quạt, Chế Độ Làm Mát 9 Cấp, Bộ Lọc HEPA H13 Loại Bỏ 99,97% Bụi Mịn, Vi Khuẩn, Virut - Màu Trắng - Hàng Chính Hãng",4600000,4600000,0,0
TIKI,dien-gia-dung,837150,"Nồi Lẩu Điện Có Xửng Happy Cook HCHP-350ST (3.5L) - Hàng Chính Hãng",619000,619000,0,0
TIKI,dien-gia-dung,119308993,"Quạt Hút Thông Gió - Quạt Thông Gió Gắn Tường LiOA -  Hàng chính hãng",344000,344000,0,0
TIKI,dien-gia-dung,53299584,"Nồi cơm điện cao tần Sharp 1.8 lít KS-IH191V-BK",2200000,2773333,573333,21
TIKI,dien-gia-dung,272563162,"Nồi Lẩu Nướng BEAR DKL-C15L1 Gồm 2 Ngăn Dung Tích 2.5 Lít Công Suất 1600 W - Hàng Nhập Khẩu",1449000,2889000,1440000,50
TIKI,dien-gia-dung,21407423,"Quạt Treo Tường Có Remote Panasonic F409MB - Xanh Dương - Hàng nhập khẩu",2079000,2079000,0,0
TIKI,dien-gia-dung,181505052,"Quạt điện lưu thông không khí MIDEA Bản màu vàng model GAF20ER Tạo dòng khí đối lưu thông gió trong phòng 3 Mức gió Hẹn giờ tắt Thiết kế 2 trong 1 Có điều khiển từ xa Hàng chính hãng",1930000,1990000,60000,3
TIKI,dien-gia-dung,125087198,"Nồi cơm điện Bluestone RCB-5519 1.8L - Bảo Hành điện tử 24 tháng - Hàng chính hãng",649000,849000,200000,24
TIKI,dien-gia-dung,74623864,"Bộ Cốc Lọc Đầu Nguồn Kangaroo KG01G3 – Hàng Chính Hãng",991000,2000000,1009000,50
TIKI,dien-gia-dung,55521294,"Máy hút ẩm gia dụng chính hãng Dorosin Airko 630E (80m2)/Công suất hút ẩm 30 lít /ngày/ Cảm ứng điện tử thông minh",5500000,6600000,1100000,17
TIKI,dien-gia-dung,121036328,"Nồi Chiên Không Dầu BEAR QZG-A15V1 Cách Nhiệt, Giảm Độ Ồn, 8 Chương Trình Chiên Tự Động, Dung Tích 10 Lít Công Suất 1500 W - Hàng Chính Hãng",2547000,5179000,2632000,51
TIKI,dien-gia-dung,149914962,"Máy Xay Sinh Tố Philips HR2221 - Công suất 700W Xay Đá , Xay Hạt - Hàng Chính Hãng",1035000,1035000,0,0
TIKI,dien-gia-dung,172081643,"Ấm siêu tốc KIPOR KP-A318SA - 1.8L - Ấm điện inox 304 chống ăn mòn - Chân đế xoay 360 độ tự ngắt chống quá tải, quá nhiệt- Hàng chính hãng",128000,319000,191000,60
TIKI,dien-gia-dung,922171,"Máy Hút Bụi Trên Giường Tiross TS9302 (350W) - Hàng chính hãng",1940000,2190000,250000,11
TIKI,dien-gia-dung,825945,"Máy Thổi Bụi Kèm Theo 1 Túi Chứa Bụi, 1 Ống Và 2 Vòi Hút Total TB2086 (800W)",835000,835000,0,0
TIKI,dien-gia-dung,58617116,"Nồi Điện Đa Năng Lock&Lock EJG556 (2.5 Lít) - Hàng Chính Hãng",2099000,3500000,1401000,40
TIKI,dien-gia-dung,548599,"Máy Pha Cà Phê Espresso Tiross TS-621 (4 bar) - Hàng Chính Hãng",1029000,1029000,0,0
TIKI,dien-gia-dung,23462368,"Máy Cạo Râu Xiaomi MIJIA Mini",329000,379000,50000,13
TIKI,dien-gia-dung,548382,"Nồi Cơm Điện Nắp Gài Cuckoo CR- 0661 màu xanh - 1L - Hàng Chính Hãng",1339000,1339000,0,0
TIKI,dien-gia-dung,173251811,"Máy xay thịt Kangaroo KG12T (1.2 Lít) - Hàng chính hãng",1160000,1200000,40000,3
TIKI,dien-gia-dung,128116608,"Bếp Hồng Ngoại Lock&Lock EJI341 (Model 2021) - Hàng Chính Hãng",1079000,2000000,921000,46
TIKI,dien-gia-dung,21406389,"Quạt Trần Panasonic F-56MZG-GO – Vàng-Hàng Chính Hãng ",2656000,2656000,0,0
TIKI,dien-gia-dung,17486987,"Bình Đun Nước Thông Minh MOAZ BEBE MB - 002",1150000,1150000,0,0
TIKI,dien-gia-dung,125363359,"Máy hút bụi cầm tay HAFELE HSV-21G (Hàng chính hãng)",3740000,6220000,2480000,40
TIKI,dien-gia-dung,147723791,"Bàn là hơi nước cầm tay Lock&lock Handy Steamer ENI222WHT (Model New) - Hàng chính hãng",749000,1400000,651000,47
TIKI,dien-gia-dung,56225103,"Quạt bàn đảo 4 Tấc chuyển hướng điện cao cấp Senko BD1410 ( Hàng Chính Hãng )- Giao màu ngẫu nhiên",491000,491000,0,0
TIKI,dien-gia-dung,729875,"Quạt Gió Nhỏ Lifan GN-4 - Đen - Hàng Chính Hãng",172000,172000,0,0
TIKI,dien-gia-dung,242406040,"Nồi Chiên Hơi Nước Kalite Steam Star Tích Hợp 10 Chương Trình Nấu Dung Tích 15 Lít Công Suất 1800 W - Hàng Chính Hãng",3999000,7969000,3970000,50
TIKI,dien-gia-dung,116877695,"Nồi cơm điện Cuckoo 3 lít CR-1720/SIVNCV màu bạc - Hàng chính hãng",2410000,2410000,0,0
TIKI,dien-gia-dung,188785423,"Máy Xay Sinh Tố Mini Cầm Tay Sử Dụng Pin Sạc Cổng USB, Máy Xay Mini 6 Lưỡi Siêu Tiện Lợi - Hàng chính hãng MINIIN (Giao màu ngẫu nhiên)",199000,199000,0,0
TIKI,dien-gia-dung,48952752,"Máy tạo ẩm cá nhân BONECO U50 Dùng Cho Xe Hơi/Xe Đẩy Em Bé/Bàn Làm Việc - Hàng nhập khẩu",1250000,1250000,0,0
TIKI,dien-gia-dung,178549512,"Quạt Mini Tích Điện Đeo Cổ Thời Trang Besti Y01,  3 Tốc Độ Gió Siêu Mát, Chạy Siêu Êm, Dung Lượng Pin 2000mAh, Phù Hợp Khi Chạy Bộ, Đi Du Lịch , Văn Phòng, Đi Chơi- Hàng Chính Hãng",250000,250000,0,0
TIKI,dien-gia-dung,146630136,"Nồi lẩu mini, ca nấu mì, Nồi Lẩu Điện Đa Năng Mini 2 Tầng Cao Cấp Núm Xoay 2 Nấc Nhiệt Tặng Kèm Giá Hấp 1,8L - Chính Hãng dododios - Logo ngẫu nhiên trên thân nồi, ca nấu mỳ đa năng mini",129000,129000,0,0
TIKI,dien-gia-dung,68419791,"Tông đơ cắt tóc Xiaomi Enchen Boost - Enchen Boost Hair Clipper - Hàng Nhập Khẩu",189000,202000,13000,6
TIKI,dien-gia-dung,689250,"Ấm Đun Siêu Tốc LocknLock EJK418SLV - Hàng Chính Hãng",428000,800000,372000,47
TIKI,dien-gia-dung,115243711,"COMBO 3 LÕI LỌC NƯỚC SỐ 1-2-3 (PP - CTO - PP) - HÀNG CHÍNH HÃNG ĐẠI VIỆT",120000,120000,0,0
TIKI,dien-gia-dung,51626369,"Tông đơ bấm viền cao cấp kemei 1949 vỏ nhôm nguyên khối pin LITHIUM 1400mah-hãng phân phối",340000,369000,29000,8
TIKI,dien-gia-dung,59097386,"Quạt Lỡ Sắt Senko LS1630 - Màu Ngẫu Nhiên - Hàng Chính Hãng",377000,377000,0,0
TIKI,dien-gia-dung,165972136,"Nồi Hấp Điện Đa Năng 3 Tầng Braburg- Hàng Chính Hãng",628000,628000,0,0
TIKI,dien-gia-dung,66727944,"Máy xay sinh tố cầm tay Philips HR2537 (650W) - Hàng chính hãng",1289000,1494000,205000,14
TIKI,dien-gia-dung,19755982,"Quạt tháp Tiross TS9182 (35W) - Hàng Chính Hãng",3200000,3990000,790000,20
TIKI,dien-gia-dung,192113318,"Máy Xay Sinh Tố Cầm Tay Philips Promix HR2534, 650W Thanh Kim Loại, Hàng Chính Hãng",790000,999000,209000,21
TIKI,dien-gia-dung,174817344,"Nồi cơm điện Goldsun GRC5020 (1L) Hàng chính hãng",650000,650000,0,0
TIKI,dien-gia-dung,68736683,"Máy Cạo Râu Tiện Dụng KM 2024 - Tặng Kèm Đầu Dao Cạo",193000,215000,22000,10
TIKI,dien-gia-dung,274184213,"Chính Hãng - Lõi Lọc Nước RO Số 3 Lõi PP 10" 1 Micro  Đại Việt",40000,40000,0,0
TIKI,dien-gia-dung,172573484,"Quạt Treo Tường 3 Cánh Midea FW40-6H (Công Suất 55W - 3 Cấp Gió) - Hàng Chính Hãng",1490000,1490000,0,0
TIKI,dien-gia-dung,50328769,"Tông đơ cắt tóc kemei 1997 chuyên nghiệp",599000,599000,0,0
TIKI,dien-gia-dung,13818028,"Máy ép chậm SAVTM JE31 250W (Đỏ) - Hàng nhập khẩu",1129000,2000000,871000,44
TIKI,dien-gia-dung,70495040,"Đèn Khò Gas Namilux NH-T3091RN - Hàng Chính Hãng",139000,190000,51000,27
TIKI,dien-gia-dung,1754771,"Bình thủy điện thép không gỉ Comet CM3217 3.4 Lít (Bạc) - Hàng Chính Hãng",849000,1090000,241000,22
TIKI,dien-gia-dung,647177,"Bình Đun Siêu Tốc Tiger PCD-A10W (1 lít) - Màu Đồng",1599000,2450000,851000,35
TIKI,dien-gia-dung,104662472,"Cây nước nóng lạnh Nhật Bản Fujihome WD5320E khóa vòi nóng, máy nước uống nóng lạnh mini tự ngắt tiết kiệm điện - Hàng Chính hãng",1430000,2000000,570000,29
TIKI,dien-gia-dung,74238494,"Quạt cầm tay tiện lợi gắn tai thỏ Damas N10 - Thiết kế dễ thương - Phù hợp tiêu chuẩn hiện đại (Giao màu ngẫu nnhiên)",159000,250000,91000,36
TIKI,dien-gia-dung,77985981,"Máy Xay Thịt Cối Inox 3 Lít Midimori (800W) - Hàng Chính Hãng",630000,849000,219000,26
TIKI,dien-gia-dung,74386218,"ĐÈN KHÒ GAS NAMILUX TS1719RN ( SẢN PHẨM HỢP TÁC XUẤT KHẨU ASAHI SEISAKUSHO - JAPAN )",96000,120000,24000,20
TIKI,dien-gia-dung,127031344,"Máy Nướng Bánh Mì Kẹp BlueStone SBB-2333 (650W) - Hàng Chính Hãng",599000,799000,200000,25
TIKI,dien-gia-dung,126863136,"Lõi Lọc CF Pureit Lavita Nóng Thông Minh (DIY) - Hàng Chính Hãng",358900,370000,11100,3
TIKI,dien-gia-dung,140136287,"Máy Phun Sương Tạo Ẩm Mini Xông Hơi Nước 380ml KONKA KZ-HU0001(B) - Hàng Chính Hãng",135000,185000,50000,27
TIKI,dien-gia-dung,1368775,"Nồi Nấu Cháo Đa Năng BBCooker BS35 (3.5L) - Hàng chính hãng",545000,790000,245000,31
TIKI,dien-gia-dung,110152711,"Bếp gas du lịch hồng ngoại Namilux PM1817AS - HÀNG CHÍNH HÃNG NAMILUX (MP)",370000,370000,0,0
TIKI,dien-gia-dung,157241885,"Bộ lõi máy lọc nước KAROFI Smax hiệu suất cao HP 6.2 - Hàng chính hãng",791000,815000,24000,3
TIKI,dien-gia-dung,262758706,"Máy cạo râu 3 lưỡi Panasonic ES-SL41-S453 - Hàng Chính Hãng",1429000,1599000,170000,11
TIKI,dien-gia-dung,174162760,"Máy Tạo Kiểu Tóc PHILIPS BHS530 - Hàng Chính Hãng",1889000,1889000,0,0
TIKI,dien-gia-dung,185411479,"Bình Đun Siêu Tốc 2 Lớp Damas DK-6018 1.8L - Trang Bị Công Nghệ Giữ Nhiệt 3 Lớp Hiện Đại, Bộ Cảm Biến Nhiệt Đạt Chuẩn EU - Công Suất Lớn 1800W Sôi Nhanh Chỉ Trong 6 Phút - Thiết Kế Bề Mặt Bên Trong Bằng Thép Không Gỉ Inox 304 Cao Cấp - Hàng Nhập Khẩu",387000,700000,313000,45
TIKI,dien-gia-dung,46131258,"Đầu Bàn Chải Hút Bụi Khô - Phụ kiện máy hút bụi",225000,225000,0,0
TIKI,dien-gia-dung,13410712,"Quạt treo điều khiển từ xa TR1628 - Hàng chính hãng",513000,513000,0,0
TIKI,dien-gia-dung,189601101,"Máy Xay Thịt 2 lưỡi dao kép BlueStone CHB-5135 ( 300W- 1,2 Lít ) - Hàng Chính Hãng",550000,799000,249000,31
TIKI,dien-gia-dung,456061,"Lò Vi Sóng Có Nướng Sharp R-G302VN-S - 23 Lít - Hàng chính hãng",1969000,2550000,581000,23
TIKI,dien-gia-dung,176545146,"Hộp Cơm Cắm Điện Hâm Nóng Besti 2 Tầng 4 Khay Inox Cao Cấp Không Gỉ, Hộp Cơm Cắm Điện Văn Phòng Sang Trọng Đa Năng, Tiện Lợi Dễ Sử Dụng - Hàng Chính Hãng",320000,320000,0,0
TIKI,dien-gia-dung,115833922," Lọc bụi của máy hút bụi Black&Decker  PV1820/PV1420/PV1020/PV1200 N566707- Hàng chính hãng",46000,46000,0,0
TIKI,dien-gia-dung,463515,"Máy Làm Tỏi Đen TIROSS TS904 - Hàng chính hãng",1249000,1288000,39000,3
TIKI,dien-gia-dung,51337072,"Bộ 3 túi đựng bụi MODEL 19-3100N dùng cho máy hút bụi STANLEY SL19117, SL19116, SL19116P- Hàng chính hãng",305000,305000,0,0
TIKI,dien-gia-dung,157544494,"Chổi Chính Robot hút bụi Ecovacs Deebot OZMO 920/950/T5/T8/ N8 Pro/ T9_Hàng chính hãng",150000,150000,0,0
TIKI,dien-gia-dung,110025293,"Tê nối nhanh 3 đầu dây dùng trong máy lọc nước - Hàng chính hãng",15000,15000,0,0
TIKI,dien-gia-dung,143610510,"Robot hút bụi lau nhà thông minh thương hiệu Nhật Bản UONI S2- Hàng chính hãng",2990000,2990000,0,0
TIKI,dien-gia-dung,37595554,"Nồi Cơm Điện CUCKOO CR-1065 1.8L Màu Đồng - Hàng chính hãng",1050000,1310000,260000,20
TIKI,dien-gia-dung,68570475,"Tủ sấy chén bát khử trùng Midea MXV-ZLP80XC65-R (750W) - Hàng Chính Hãng",2716000,3990000,1274000,32
TIKI,dien-gia-dung,10231021,"Nồi lẩu điện 2 ngăn Mishio MK112 5L - Hàng chính hãng",349000,349000,0,0
TIKI,dien-gia-dung,187005226,"Nồi điện đa năng Bcook BC03 Có khay hấp - Hàng chính hãng",359000,490000,131000,27
TIKI,dien-gia-dung,103787824,"Máy Ép Chậm SUNHOUSE MAMA SHD5505 (240W) - Hàng Chính Hãng",2200000,3760000,1560000,41
TIKI,dien-gia-dung,270250410,"Cây nước nóng lạnh để bàn mini FUJIHOME, máy nước uống nóng lạnh mini tiết kiệm điện - Hàng chính hãng",990000,990000,0,0
TIKI,dien-gia-dung,79561024,"Máy làm sữa hạt, xay sinh tố và nấu đa năng Tefal BL967B66, 1300W, 1.75L - Hàng chính hãng",2870000,5290000,2420000,46
TIKI,dien-gia-dung,129233362,"ĐÈN LED KIÊM QUẠT TRẦN VÔ HÌNH THÔNG MINH YEELIGHT C2101C1060 (XIAOMI YOUPIN) - BẢN QUỐC TẾ - CÔNG SUẤT LỚN - HÀNG CHÍNH HÃNG",4300000,4300000,0,0
TIKI,dien-gia-dung,973086,"Quạt Treo Tường Điều Khiển Từ Xa Senko TR1428 (Remote) - Xám - Hàng chính hãng",517000,517000,0,0
TIKI,dien-gia-dung,67695796,"Bếp Ga Chống Nổ Mini Namilux Van An Toàn 2 Cấp Công Nghệ Nhật Bản-Hàng Chính Hãng (Giao Màu Ngẫu Nhiên)",242000,299000,57000,19
TIKI,dien-gia-dung,110931703,"QUẠT LỠ CÔNG NGHIỆP 3HT - HÀNG CHÍNH HÃNG",219000,219000,0,0
TIKI,dien-gia-dung,70771349,"Máy Sấy Chăm Sóc Tóc Nanoe Panasonic EH-NA98RP645/ EH-NA98-K645 - Công Suất 1800W - Hàng Chính Hãng",4690000,5099000,409000,8
TIKI,dien-gia-dung,3610991,"Bếp Điện Từ - Hồng Ngoại Đôi Kangaroo KG499N 3100W - Hàng chính hãng",2210000,4720000,2510000,53
TIKI,dien-gia-dung,247704443,"Quạt Không Cánh Xiaomi Keheal A4 Pro Tiếng Việt Kiêm Lọc Không Khí Cấp 12 Cấp Độ Gió Độ Ồn Thấp Tạo Lọc Khử Khuẩn Ion - Hàng Chính Hãng",2949000,5799000,2850000,49
TIKI,dien-gia-dung,57588481,"Nồi Điện Đa Năng Lock&Lock EJP116BLK (0.8 Lít) - Hàng Chính Hãng",488400,888000,399600,45
TIKI,dien-gia-dung,79855901,"Bình đun siêu tốc 0.8L Tefal BI81252A- Hàng chính hãng",499000,499000,0,0
TIKI,dien-gia-dung,253133968,"Nồi Chưng Yến Tiềm Thuốc Bắc, Nấu Cháo Bear SUBE002 Gồm 3 Thố Và Khay Hấp Dung Tích 1.6 Lít Công Suất 200 W - Hàng Chính Hãng",879000,1559000,680000,44
TIKI,dien-gia-dung,72292970,"Nồi áp suất đun ga đáy từ 4L size 20cm AG197 dùng được trên cả bếp từ và các bếp khác, màu ngẫu nhiên-hàng chính hãng",416000,429000,13000,3
TIKI,dien-gia-dung,143463479,"Máy lọc nước không tủ Hydrogen Karofi KAQ-U10 chính hãng",5187000,7410000,2223000,30
TIKI,dien-gia-dung,147352661,"Bàn ủi hơi nước cầm tay PHILIPS DST3040/70 2600W - Hàng Chính Hãng",1249000,1498800,249800,17
TIKI,dien-gia-dung,158748802,"Máy Hút Bụi Công Nghiệp Hút Khô Và Ướt USA Stanley SL19417-6A - 23 lít/ Công suất 4000W (5.5HP) - Hàng Chính Hãng",2350000,2350000,0,0
TIKI,dien-gia-dung,124706116,"Máy Nướng Bánh Mỳ, Máy Kẹp Bánh Mỳ Sandwich-Waffle BEAR DBC-C06M1 Dung Tích 0.8 Lít, Công Suất 600 W - Hàng Chính Hãng",852000,1539000,687000,45
TIKI,dien-gia-dung,171894493,"Máy cạo râu Philips PQ206/18 - Hàng chính hãng",399000,425000,26000,6
TIKI,dien-gia-dung,58962653,"Máy hút bụi khô và ướt HiClean HC30P (thùng nhựa ABS cao cấp, dung tích 30L) - Hàng chính hãng",1550000,2100000,550000,26
TIKI,dien-gia-dung,74246362,"Nồi nấu chậm Sowun (3.5 Lít) SW 6013 -  Hàng chính hãng",745000,760000,15000,2
TIKI,dien-gia-dung,274892364,"Robot Hút Bụi Lau Nhà Dreame L10S Ultra SE | Dreame S10 - Tự Động Giặt Sấy Giẻ Gom Rác Tự Động Camera AI Diện Tích 200m2 Lực Hút 5300 Pa - Hàng Chính Hãng",8999000,17699000,8700000,49
TIKI,dien-gia-dung,57960490,"Máy Lọc Nước Pureit Ultima White Lọc Nguyên Khối Tích Hợp Công Nghệ RO + UV + MF - Hàng Chính Hãng",7999000,12400000,4401000,35
TIKI,dien-gia-dung,173426749,"Nồi Nấu Chậm 1,6L Bear SUBE002 Đa Năng Nấu Cháo, Chưng Yến Bản Quốc Tế - Hàng Chính Hãng",725000,727900,2900,0
TIKI,dien-gia-dung,126795031,"Bàn ủi hơi nước cầm tay STH3020/10 (1000W) - Hàng chính hãng ",1235000,1398000,163000,12
TIKI,dien-gia-dung,160094786,"Nồi Lẩu Điện Mini KONKA KDZG-8000L Ca Nấu Mì 2 Mức Công Suất, Thiết Kế Đẹp Mắt -HÀNG CHÍNH HÃNG",377000,590000,213000,36
TIKI,dien-gia-dung,92477737,"Máy vắt cam LEBENLANG model LBC388 600W-400ml Bảo hành 2 năm",929000,1500000,571000,38
TIKI,dien-gia-dung,203246988,"Nồi hầm điện ninh cháo cách thủy nồi chưng yến MIDEA Đi kèm tô sứ cao cấp tiệt trùng bình sữa em bé bằng hơi nước Hàng chính hãng",1448000,1639000,191000,12
TIKI,dien-gia-dung,264018196,"Nồi Chưng Yến Tiềm Thuốc Bắc Kho Cá Bear SB-NNC15 Gồm 6 Chức Năng Nấu Dung Tích 1.5 Lít Công Suất 120 W - Hàng Chính Hãng",719000,1299000,580000,45
TIKI,dien-gia-dung,125087218,"Máy xay Sinh Tố BlueStone BLB-5310,Công suất 450w - Kèm 3 Cối Xay Mang Đi, Hàng chính hãng",699000,999000,300000,30
TIKI,dien-gia-dung,529093,"Máy Sấy Quần Áo Tiross TS882 (1500W) - Xanh Dương - Hàng chính hãng",2050000,2050000,0,0
TIKI,dien-gia-dung,1919531,"Máy Pha Cà Phê Delonghi EC685.R - Hàng Chính Hãng",5200000,5200000,0,0
TIKI,dien-gia-dung,406352,"Máy Cạo Râu Nam Philips AT620",1125000,1125000,0,0
TIKI,dien-gia-dung,73089414,"Máy Hút Bụi Cầm Tay Karcher VC 4s - Hàng Chính Hãng",7690000,7690000,0,0
TIKI,dien-gia-dung,476959,"Máy Ép Trái Cây Tốc Độ Chậm Nguyên Trái Iruka I-52 (150W) - Hàng chính hãng",2490000,3990000,1500000,38
TIKI,dien-gia-dung,192375743,"Máy lọc nước Nano Geyser ECO CRYSTAL 8 cấp công nghệ lọc UF - Hàng Chính Hãng",1367000,2900000,1533000,53
TIKI,dien-gia-dung,181503535,"Quạt điện lưu thông không khí MIDEA Bản màu xanh model GAF20EQ Tạo dòng khí đối lưu thông gió trong phòng 3 Mức gió Hẹn giờ tắt Thiết kế 2 trong 1 Có điều khiển từ xa Hàng chính hãng",1751000,1990000,239000,12
TIKI,dien-gia-dung,140587780,"Kẹp nướng sandwich Tiross TS9658 - Hàng chính hãng",569000,790000,221000,28
TIKI,dien-gia-dung,36978258,"Máy hút bụi  Deerma DX115C  ( Hàng nhập khẩu )",829000,829000,0,0
TIKI,dien-gia-dung,11824785,"Nồi Cơm Điện Kangaroo KG823 (1.2 Lít) - Hàng chính hãng",699000,1170000,471000,40
TIKI,dien-gia-dung,21980528,"Ấm sắc thuốc bắc điện NodaCook Bát Tràng tự động sắc thuốc không có mâm nhiệt kim loại bên trong ấm 3 lít màu đen - Hàng chính hãng",650000,925000,275000,30
TIKI,dien-gia-dung,165934869,"Nồi Nấu Đa Năng Lẩu Và Hấp 2 Trong 1 BEAR DZG-D80D2 10L Cao Cấp Công Suất 1200 W - Hàng Chính Hãng",1273000,2399000,1126000,47
TIKI,dien-gia-dung,57496390,"Lò Vi Sóng Tráng Men Samsung Có Nướng 30L MG30T5018CK - Hàng Chính Hãng",3110000,4390000,1280000,29
TIKI,dien-gia-dung,75649136,"(Loại Tốt) Bếp Vỉ Nướng Điện Không Khói BBG KhoNCC - Electric BarBecue Grill 2000W - KPD-BEPDKK-425 - Hàng Chính Hãng",259000,318000,59000,19
TIKI,dien-gia-dung,91252008,"Quạt hút thông gió phi 200 - Quạt hút gió đồng trục cấp khí tươi cho công trình nhà - Hàng chính hãng GDXLFJ siêu chống ồn",1900000,1900000,0,0
TIKI,dien-gia-dung,73856567,"Quạt Lửng Sharp Có Điều Khiển PJ-L40RV-LG - Hàng Chính Hãng",1190000,1190000,0,0
TIKI,dien-gia-dung,165106847,"Máy Hàn Miệng Túi Thực Phẩm Mini Đa Năng Tiện Lợi - Hàng Loại 1 - Chính Hãng MINIIN",74000,74000,0,0
TIKI,dien-gia-dung,58065295,"Bàn Ủi Hơi Nước Đứng Philips GC487/89 (1800W) - Hàng Chính Hãng",2598000,3042000,444000,15
TIKI,dien-gia-dung,74537187,"Siêu Sắc Thuốc 3L ,Ấm Sắc Thuốc Tự Động Fujika K5 Lòng Ấm Tráng Men Chịu Nhiệt Cao Màu Đen Họa Tiết Kí Tự- Hàng Chính Hãng",341000,341000,0,0
TIKI,dien-gia-dung,127060997,"Quạt bàn B4 Senko B1616 - Màu ngẫu nhiên - Hàng Chính Hãng",325000,325000,0,0
TIKI,dien-gia-dung,164587236,"Robot hút bụi lau nhà Ecovacs Deebot X1 OMNI – Trợ lý ảo YIKO – Lực hút Max 5000Pa– Bản Quốc Tế - Hàng Chính Hãng",16090000,31900000,15810000,50
TIKI,dien-gia-dung,55520530,"Máy hút ẩm gia dụng chính hãng Dorosin 618C (40m2)/Công suất hút ẩm 18 lít /ngày - Cảm biến điện tử thông minh - Độ ồn thấp",4480000,4520000,40000,1
TIKI,dien-gia-dung,100948032,"NỒI Ủ KHALUCK.HOME KL-710 5L",699900,999000,299100,30
TIKI,dien-gia-dung,449043,"Máy Ép Trái Cây Sunhouse SHD5520 (260W) - Đỏ - Hàng chính hãng",590000,1160000,570000,49
TIKI,dien-gia-dung,55442805,"Máy Lọc Nước Pureit Casa G2 Công Suất Lớn Lọc Nguyên Khối Tích Hợp Công Nghệ RO+MF - Hàng chính hãng",5905000,7500000,1595000,21
TIKI,dien-gia-dung,658090,"Quạt Treo Tường 2 Dây Senko TC16 - Hàng Chính Hãng",377000,377000,0,0
TIKI,dien-gia-dung,188445944,"Máy Cạo Râu Và Tỉa Lông Mũi Mini Cầm Tay Cạo Êm Chống Thấm Nước, Sạc USB Tiện Lợi, Động Cơ Mạnh Mẽ",135000,135000,0,0
TIKI,dien-gia-dung,70834481,"Máy Thổi Hút Bụi  Cầm Tay ABG Công Suất Lớn 1200W Máy Vừa Thổi Vừa Hút Công Nghiệp  Đa Năng Ứng Dụng Nhiều Trong Các Xưởng Mộc, Vệ Sinh Máy Móc – Hàng Chính Hãng",680000,680000,0,0
TIKI,dien-gia-dung,250737261,"Máy Xay Cà Phê, Máy Xay Hạt Thực Phẩm Khô Đa Năng BEAR MDJ – A02G3 Chế Độ Xay Cực Êm Dung Tích 200 ML Công Suất 200 W- Hàng Chính Hãng",655000,1199000,544000,45
TIKI,dien-gia-dung,178462956,"Máy sấy tóc Philips BHD350/10 - Sấy khô tóc mạnh mẽ",812000,955000,143000,15
TIKI,dien-gia-dung,17010845,"Quạt hút thông gió 2 chiều âm tường Senko Hàng Chính Hãng H150 30W",274000,274000,0,0
TIKI,dien-gia-dung,91565152,"Máy Lọc Không Khí ULTTY SKJ-CR021 Dạng Quạt, Chế Độ Làm Mát 9 Cấp, Bộ Lọc HEPA H13 Loại Bỏ 99,97% Bụi Mịn, Vi Khuẩn, Virut - Màu Đen - Hàng Chính Hãng",4580000,4580000,0,0
TIKI,dien-gia-dung,24352990,"Máy Xay Sinh Tố Đa Năng Sunhouse SHD5322 (220W - 1.25 Lít) - Đỏ - Hàng Chính Hãng",590000,1214000,624000,51
TIKI,dien-gia-dung,71506728,"Phụ kiện robot hút bụi Mi Robot Vacuum-Mop P Filter (màng lọc HEPA) - Hàng chính hãng",190000,190000,0,0
TIKI,dien-gia-dung,164396485,"Bàn Là Hơi Nước Cầm Tay Gấp Gọn - Bàn Ủi Hơi Nước SEKA Cao Cấp An Toàn Tiện Dụng - Hàng chính hãng",299000,340000,41000,12
TIKI,dien-gia-dung,56029960,"Nồi cơm điện nắp gài 1Lit Fujika FJ-CM10, công suất 400W, lồng men chống dính, màu ngẫu nhiên-Hàng chính hãng",291000,300000,9000,3
TIKI,dien-gia-dung,178462962,"Máy sấy tóc Philips BHD300/10 - Chính hãng",626000,795000,169000,21
TIKI,dien-gia-dung,114894205,"Máy hút bụi giường nệm Bear CMY-B03M1 diệt khuẩn UV-C, công nghệ khí nóng làm khô và kết hợp tinh dầu thơm, hàng chính hãng",1250000,1250000,0,0
TIKI,dien-gia-dung,1684181,"Bàn Ủi Điện Panasonic NI-U400CPRA - Hàng Chính Hãng",1620000,1750000,130000,7
TIKI,dien-gia-dung,730095,"Quạt Đứng Lifan Đ-616A (Trắng - Lồng Xi) - Hàng chính hãng",644000,644000,0,0
TIKI,dien-gia-dung,104948934,"Nồi Cơm Điện Perfect PF-C101 (1.2 Lít) - Hàng chính hãng",299000,399000,100000,25
TIKI,dien-gia-dung,113932107,"Máy Ép Chậm Olivo SJ210 [CHÍNH HÃNG] Làm Kem, Ép Rau Củ Quả, Ép Đậu Nành 3 Trong 1, Ép Kiệt Bã 99% Thiết Kế Đột Phá, Dễ Dàng Vệ Sinh",2199000,2199000,0,0
TIKI,dien-gia-dung,7647826,"Lò Nướng Electrolux EOT38MXC (38 Lít) - Hàng chính hãng",2090000,2090000,0,0
TIKI,dien-gia-dung,72549285,"Quạt sạc tích điện Honjianda FL 301 - tích hợp đèn LED & cổng USB",835000,835000,0,0
TIKI,dien-gia-dung,102551598,"Quạt Sạc Tích Điện Sunhouse SHD7223 (24W) - Hàng Chính Hãng",1220000,2050000,830000,40
TIKI,dien-gia-dung,125087287,"Máy Làm Sữa Hạt BlueStone BLB-6035, 1,75Lít - 1700w, Máy Xay Nấu Đa Năng, Cháo Dinh Dưỡng, Hàng Chính Hãng",1999000,2499000,500000,20
TIKI,dien-gia-dung,227543350,"Máy ép chậm Magic Eco AC-132 - Hàng chính hãng",1490000,3190000,1700000,53
TIKI,dien-gia-dung,14640744,"Nồi cơm điện Kim Cương nắp rời 1.8L (18R) - Chính Hãng",339000,399000,60000,15
TIKI,dien-gia-dung,449796,"Ấm Siêu Tốc Inox Sunhouse SHD1182- Hàng chính hãng",140000,140000,0,0
TIKI,dien-gia-dung,195746478,"Máy Làm Sữa Hạt Đa Năng OLIVO CB20, 1.75Lit - 2000W, Kèm Cối Xay Khô, Hàng Chính Hãng",2450000,3499000,1049000,30
TIKI,dien-gia-dung,130233649,"Quạt Lỡ ống nhựa SENKO L1638 - Màu ngẫu nhiên - Hàng chính hãng",369000,369000,0,0
TIKI,dien-gia-dung,827916,"Chân Vịt Vắt Sổ Brother F015N - Hàng chính hãng",110000,110000,0,0
TIKI,dien-gia-dung,186623443,"Máy may gia đình Brother JA1450NT - Hàng chính hãng",3250000,3250000,0,0
TIKI,dien-gia-dung,52480695,"Lưỡi Dao thay thế cho máy cạo râu xiaomi Enchen BlackStone - Hàng Nhập Khẩu",98000,134500,36500,27
TIKI,dien-gia-dung,100947624,"NỒI ÁP SUẤT KHALUCK.HOME KL-160 16L HÀNG CHÍNH HÃNG",3499000,3499000,0,0
TIKI,dien-gia-dung,79855914,"Bàn ủi hơi nước gập cầm tay tiện lợi Tefal DT3030E0-1300W - Hàng chính hãng",1020000,1020000,0,0
TIKI,dien-gia-dung,56492437,"Quạt Bàn Đảo 3 Tấc Senko BD1010 - Màu Ngẫu Nhiên - Hàng chính hãng",355000,355000,0,0
TIKI,dien-gia-dung,57900800,"Nồi Cơm Cao Tần Toshiba RC-18IP1PV (1.8 Lít) - Hàng Chính Hãng",4030000,4290000,260000,6
TIKI,dien-gia-dung,166322424,"Bếp hồng ngoại 2 vòng nhiệt tiết kiệm điện Ladomax 669 công suất 2200W, không kén nồi chảo, nướng được thức ăn-Hàng chính hãng",895000,895000,0,0
TIKI,dien-gia-dung,193289835,"Nồi cơm điện KIPOR KP-N965 1.2L - Lòng nồi dạng niêu, phủ lớp chống dính cao cấp - Tặng kèm vỉ hấp - Hàng chính hãng",658000,1149000,491000,43
TIKI,dien-gia-dung,52574340,"Bộ lọc nước  - lõi lọc nước trực tiếp tại vòi Bộ lọc nước  - Lõi lọc thay thế",62000,90000,28000,31
TIKI,dien-gia-dung,188620591,"Dao Cạo Râu Điện Mini, Máy Cạo Râu Nam Bỏ Túi 3 Lưỡi Siêu Nhỏ Gọn, Không Dây Công Nghệ Nhật Bản, Không Trầy Xước, Chống Nước, Sạc Nhanh",190000,190000,0,0
TIKI,dien-gia-dung,48267534,"Tông Đơ Cắt Tóc Cho Bé, Trẻ Em Codol 531 TẶNG Bộ Kéo Cắt Tóc, Tỉa Tóc + Lược Chuyên Dụng - Tăng Đơ Cắt Tóc Gia Đình Cho Người Lớn Và Bé Sơ Sinh Máy Chạy Êm Lưỡi Có Thể Thay",261000,275000,14000,5
TIKI,dien-gia-dung,121009841,"Máy Hâm Nóng, Đế Hâm Nóng Giữ Nhiệt Đồ Uống KUNBE Với 3 Chế Độ Nhiệt, Hâm Nóng Trà, Cà Phê, Sữa Cho Bé, Nhỏ Gọn, Màn Hình Điện Tử Cao Cấp",375000,375000,0,0
TIKI,dien-gia-dung,984385,"Máy Sấy Tóc Panasonic PAST-EH-NE20-K645-Hàng Chính Hãng",855000,1090000,235000,22
TIKI,dien-gia-dung,95154301,"Máy Xay Bột Khô Siêu Mịn Seka Z10-800Y - Máy Xay Nghiền Bột Đa Năng Inox 304, Công Suất Lớn - Hàng chính hãng",779000,850000,71000,8
TIKI,dien-gia-dung,456015,"Nồi Cơm Điện Sharp KS-NR181STV SS - 1.8 Lít - Hàng chính hãng",1150000,1150000,0,0
TIKI,dien-gia-dung,448841,"Máy Sấy Tóc Panasonic PAST-EH-ND11-A645 - Hàng Chính Hãng",299000,356400,57400,16
TIKI,dien-gia-dung,160605955,"Máy hút chân không VS-86 hút mọi loại túi, tích hợp hàn thông minh, hút khô và hút ướt dễ dàng với 2 bình nước thải, sử dụng 2 motor hút mạnh mẽ, hút và thổi phồng tiện lợi, hàng chính hãng",2990000,2990000,0,0
TIKI,dien-gia-dung,174162744,"Máy Cạo Râu Du Lịch Philips S1103 - Hàng Chính Hãng",679000,700000,21000,3
TIKI,dien-gia-dung,1021427,"Sưởi Điện Hồng Ngoại Sunhouse SHD7013 (800W) - Đen Đỏ - Hàng Chính Hãng",349998,349998,0,0
TIKI,dien-gia-dung,576131,"Ấm Siêu Tốc Du Lịch Tiross TS1360 (0.5 Lít) - Xanh - Hàng chính hãng",369000,390000,21000,5
TIKI,dien-gia-dung,56647581,"Nồi chiên nhúng điện đơn, chiên gà, chiên khoai tây,... loại Tốt- Hàng nhập khẩu",999000,999000,0,0
TIKI,dien-gia-dung,253414567,"Máy sấy tóc Lebenlang LBL3088 công suất 2100W của Đức, chống xơ rối tóc bằng công nghệ ion - Hàng Chính Hãng",335000,550000,215000,39
TIKI,dien-gia-dung,183719013,"Máy sấy tóc LEBENLANG 2 chiều nóng lạnh, gấp gọn tiện lợi, chống xơ rối tóc bằng công nghệ ion, 2100W",364000,500000,136000,27
TIKI,dien-gia-dung,51369162,"TÔNG ĐƠ CẮT TÓC CODOS T9 CHÍNH HÃNG LOẠI 1",530000,530000,0,0
TIKI,dien-gia-dung,146676601,"Bếp Điện Hồng Ngoại Ladomax Ha666 Màu giả gỗ, công suất 2200w, không kén nồi chảo-Hàng chính hãng",665000,665000,0,0
TIKI,dien-gia-dung,272624441,"Bàn Ủi Hơi Nước Cầm Tay Xiaomi GT-306W Công Suất 1200 W - Hàng Nhập Khẩu",617000,849000,232000,27
TIKI,dien-gia-dung,132953313,"Nồi chiên hơi nước KALITE STEAM 7, công nghệ mới chiên không dầu kết hợp chức năng hấp, màn hình điều khiển cảm ứng, 9 chế độ nấu lập trình sẵn, công suất 1700w, dung tích 7L, hàng chính hãng",2050000,2050000,0,0
TIKI,dien-gia-dung,69226426,"Ấm sắc thuốc Trường An TA59 Vàng - Siêu điện - Hàng Việt Nam chất lượng cao - Chính hãng",610000,610000,0,0
TIKI,dien-gia-dung,152881151,"Máy Cạo Râu Cầm Tay Smate ST-R102C, ST-R101C , Vỏ Kim Loại Sang Trọng Sạc Nhanh Type-C Kháng Nước IPX7 Bảo Vệ Da Mặt Có Chế Độ Khóa An Toàn",322000,899000,577000,64
TIKI,dien-gia-dung,174523824,"Máy sấy tóc Panasonic EH-ND65-K645 – Công suất tương đương 2300W – Sấy nóng lạnh – Đầu sấy tạo kiểu 11mm – Hàng chính hãng",706000,869000,163000,19
TIKI,dien-gia-dung,16391516,"Bình đun siêu tốc 1.5L Comet CM8215 - Hàng Chính Hãng",179000,199000,20000,10
TIKI,dien-gia-dung,274184581,"Chính Hãng - Lõi Lọc Nước RO Số 1 Lõi PP 10" 5 Micro Đại Việt",40000,40000,0,0
TIKI,dien-gia-dung,62366574,"Máy sấy bát Smartcook DDS-3906",1850000,1850000,0,0
TIKI,dien-gia-dung,36994841,"Máy Xay Sinh Tố Toshiba MX-60T(H) (600W - 1.5 Lít) - Hàng Chính Hãng",700000,890000,190000,21
TIKI,dien-gia-dung,106032500,"Máy Trộn Bột Ủ Bột Lên Men Tự Động BEAR HMJ-A70C1 Chống Dính Bột Dung Tích 7 Lít Công Suất 250 W - Bản Nội Địa",2645000,5299000,2654000,50
TIKI,dien-gia-dung,167061511,"Máy Sấy Tóc Bluestone HDB-1859, 1800W, Sấy ion Giữ Ẩm, Hàng Chính Hãng",450000,699000,249000,36
TIKI,dien-gia-dung,112265564,"Hộp cơm hâm nóng cắm điện HT SYS - BUCOOK DFH C02 - 2 Lít 2 Tầng 4 Ngăn Có Thể Nấu Và Hâm Nóng Thức Ăn, Ruột Bằng Inox 304",222000,222000,0,0
TIKI,dien-gia-dung,110841096,"Khóa 2 đầu dây 6 hoặc khóa 2 đầu dây 10 dùng trong máy lọc nước - Hàng chính hãng",30000,30000,0,0
TIKI,dien-gia-dung,175413084,"Bình Thủy Điện, Bình Thủy Giữ Ấm Đun Nóng Thông Minh BEAR KE-B30V1 Khử Clo Dung Tích 3L, Công Suất 1350W - Hàng Chính Hãng",1214000,2299000,1085000,47
TIKI,dien-gia-dung,171828127,"Nồi cơm điện KIPOR KP-N55918-1.8L-Lòng nồi niêu chống dính CERAMIC chống trầy xước dầy 3mm-Hàng chính hãng",988000,1699000,711000,42
TIKI,dien-gia-dung,184697578,"Máy ép trái cây chậm Promix PM-800 - 400W - Hàng chính hãng",2825000,2825000,0,0
TIKI,dien-gia-dung,82921009,"Quạt sạc tích điện mini HT SYS- Yoobao - 6400mAh-04 cấp độ gió - Đế kẹp đa năng - Góc xoay 720 -  Hàng Nhập Khẩu",250000,250000,0,0
TIKI,dien-gia-dung,11427610,"Quạt hút thông gió 2 chiều âm tường cao cấp Senko H200 35W (Hàng Chính Hãng)",291000,291000,0,0
TIKI,dien-gia-dung,100947622,"MÁY XAY SINH TỐ KHALUCK.HOME KL-303 HÀNG CHÍNH HÃNG",389000,389000,0,0
TIKI,dien-gia-dung,825947,"Máy Thổi Bụi Kèm Theo 1 Túi Gom Bụi Total TB2066 (600W)",613000,613000,0,0
TIKI,dien-gia-dung,247975016,"Máy Lọc Không Khí Xiaomi Air Purifier 4 Lite - Bản Quốc Tế Lọc Bụi Mịn Kết Nối App Phù Hợp Không Gian 45 m2 - Hàng Chính Hãng",2649000,5099000,2450000,48
TIKI,dien-gia-dung,35250138,"Lò Vi Sóng Điện Tử Bluestone MOB-7815 (20 Lít) - Hàng chính hãng",1699000,2499000,800000,32
TIKI,dien-gia-dung,106032489,"Máy Hút Chân Không Thực Phẩm Tự Động Gia Đình BEAR VS-B01V1 Công Suất 130 W - Hàng Chính Hãng",1273000,2399000,1126000,47
TIKI,dien-gia-dung,169712232,"Nồi cơm điện nắp rời Goldsun GRC5101 2.8L - Hàng Chính Hãng",690000,690000,0,0
TIKI,dien-gia-dung,71866232,"Máy hút mùi cao cấp chữ "T" Sunhouse Mama MMB6817-70 - Hàng Chính Hãng",4378000,4513000,135000,3
TIKI,dien-gia-dung,1023416,"Ấm Đun Siêu Tốc 2 Lớp Happy Cook HEK-17WF (1.7L)",459000,459000,0,0
TIKI,dien-gia-dung,168989748,"MÁY ÉP TRÁI CÂY KANGAROO KG200SJF (MÁY ÉP CHẬM 665ml - 200W) Hàng Chính Hãng",3890000,3890000,0,0
TIKI,dien-gia-dung,193928962,"Mâm quạt thay thế cho quạt đứng Senko - dùng cho các mã DTS1607, LTS1636, LTS1632, DTS1609, DCN1806, DCN1808 - Hàng chính hãng",82000,82000,0,0
TIKI,dien-gia-dung,82889681,"Quạt treo 1 dây SENKO T1682 - Hàng chính hãng",315000,315000,0,0
TIKI,dien-gia-dung,89691201,"Máy Cạo Râu Enchen BlackStone 3 chống nước - Pin sạc siêu bền",325000,325000,0,0
TIKI,dien-gia-dung,174539208,"Bếp từ đơn Electrolux ETD29MKC - Hàng chính hãng",1219000,1590000,371000,23
TIKI,dien-gia-dung,112291534,"Lõi Lọc RO Số 4 màng FILMTEC Mỹ- Hàng Chính Hãng",322000,360000,38000,11
TIKI,dien-gia-dung,225958440,"Nồi Chưng Yến, Nồi Hầm Kho Đa Năng, Nồi Nấu Chậm BEAR DDZ-B25Q3 Bản Tiếng Anh 5 Trong 1 BEAR Dung Tích 2.5 Lít Công Suất 400 W - Hàng Chính Hãng",1249000,2349000,1100000,47
TIKI,dien-gia-dung,121185639,"Bộ lọc nước thô đầu nguồn mini Scitech GB (Nhỏ gọn, có van xả cặn) - Hàng chính hãng",395000,395000,0,0
TIKI,dien-gia-dung,194961498,"Ấm Siêu Tốc Cao Cấp Thuỷ Tinh Lebenlang 1.8L LBLB2828 - 1,7L LBDD2628 Điều Chỉnh Nhiệt Độ Kèm Lõi Lọc Inox - Hàng Chính Hãng",382000,800000,418000,52
TIKI,dien-gia-dung,156637053,"Bộ lõi thay thế máy lọc nước Nano Geyser Ecotar by Scitech (Tặng kèm lõi tiền lọc) - Hàng chính hãng",1550000,1550000,0,0
TIKI,dien-gia-dung,57960503,"Bộ Lọc Thay Thế Pureit Casa - Hàng Chính Hãng",1309500,1350000,40500,3
TIKI,dien-gia-dung,509870,"Ấm Đun Nước Electrolux EEK3505 - 1,7L (Đen) - Hàng chính hãng",809000,890000,81000,9
TIKI,dien-gia-dung,495738,"Quạt Sạc Kiêm Đèn Sạc 2 Bình Kentom KT9100- Hãng chính hãng",775000,775000,0,0
TIKI,dien-gia-dung,366232,"Bình Thủy Điện Comet CM3216 (3.6L) - Hàng chính hãng",999000,1290000,291000,23
TIKI,dien-gia-dung,179758112,"Máy Tạo Ẩm Cá Nhân U50 Màu Đen Dùng Cho Xe Hơi/ Xe Đẩy Em Bé/ Bàn Làm Việc - Nhập Khẩu Thuỵ Sỹ",1200000,1250000,50000,4
TIKI,dien-gia-dung,193604081,"Quạt sàn công nghiệp Lifan S-18CN công suất 55W, chân đế kim loại bọc vỏ cao su chắc chắn, sải cánh 45cm - Hàng chính hãng",621000,621000,0,0
TIKI,dien-gia-dung,47197271,"Máy cạo râu khô kemei 2024",170000,175000,5000,3
TIKI,dien-gia-dung,69226489,"Ấm sắc thuốc Trường An TA59 Nâu",610000,610000,0,0
TIKI,dien-gia-dung,55583867,"Nồi Cơm Điện Tử Toshiba RC-10DH2PV(W) - Hàng chính hãng",1599000,1720000,121000,7
TIKI,dien-gia-dung,186577383,"Máy Hút Bụi Cầm Tay Không Dây Teement TM01 Cao Cấp, Lực Hút Lớn 6000PA, Êm Ái Mạnh Mẽ, Sử Dụng Trong Nhà, Ngoài Trời Và Cho Ô Tô , Công Suất Lớn - Hàng Chính Hãng",370000,370000,0,0
TIKI,dien-gia-dung,187722394,"Máy xay sinh tố công nghiệp Uniblend UB-712 - Bao gồm hộp chống ồn - Hàng chính hãng",3699000,3699000,0,0
TIKI,dien-gia-dung,43298657,"Lõi Lọc Không Khí Mi Air Purifier HEPA Filter Màu Xám - Hàng Chính Hãng",585000,625000,40000,6
TIKI,dien-gia-dung,111972630,"Dây dẫn nước máy lọc nước - Dây 6, dây 10 dùng trong máy lọc nước - Hàng chính hãng",40000,40000,0,0
TIKI,dien-gia-dung,130172671,"Chân vịt vắt sổ Brother F015N - Hàng chính hãng",99000,100000,1000,1
TIKI,dien-gia-dung,109369397,"Co nối nhanh 2 đầu dây dùng trong máy lọc nước (Co nối nhanh 2 đầu dây 6, Co nối nhanh 2 đầu dây 10, Co nối nhanh dây 10 ra dây 6...) - Combo 2 cái hoặc 5 cái hoặc 10 cái",20000,20000,0,0
TIKI,dien-gia-dung,23404305,"Lõi Lọc Số 3 Dành Cho Nước Giếng Khoan - Chính Hãng Karofi",90000,90000,0,0
TIKI,dien-gia-dung,125087293,"Nồi cơm điện Bluestone 1.8 lít RCB-5520 - Hàng chính hãng",699000,899000,200000,22
TIKI,dien-gia-dung,140888392,"Viên rửa vệ sinh máy pha cà phê Melitta Perfect Cleaner Tabs espresso machine- Hàng nhập khẩu từ Đức",165000,165000,0,0
TIKI,dien-gia-dung,12881146,"Bộ điếu inox hồng ngoại fi90mm, thay thế cho các dòng bếp hồng ngoại cùng kích thước ( đen ) - Hàng chính hãng",69520,79000,9480,12
TIKI,dien-gia-dung,78631347,"Quạt bàn B4 Senko B1612 - Giao màu ngẫu nhiên - Hàng Chính Hãng",325000,325000,0,0
TIKI,dien-gia-dung,181358609,"Máy ép trái cây rau củ LEBENLANG công suất cực mạnh 800W, dung tích lớn 1100ml, model LBEJ3468 - hàng chính hãng",1212000,1500000,288000,19
TIKI,dien-gia-dung,110873304,"Bàn Ủi Hơi Nước Cầm Tay Xiaomi Zanjia GT-306W công suất định mức 1200W - Hàng Nhập Khẩu",385000,498000,113000,23
TIKI,dien-gia-dung,161959915,"Lọc giấy và vòng giữ (SL19116, SL19116P) Stanley 19-1500N - Hàng chính hãng",120000,120000,0,0
TIKI,dien-gia-dung,171020172,"BỘ 3 LÕI LỌC KAROFI THAY CHO MODEL S-S038 | OP1310 - HÀNG CHÍNH HÃNG",168000,168000,0,0
TIKI,dien-gia-dung,426282,"Bàn Ủi Khô Panasonic PABU-NI-317TVRA (1000W) - Hàng chính hãng",440000,480000,40000,8
TIKI,dien-gia-dung,36494034,"Bếp gas Mini Cao Cấp Namilux NH-P3031PS-Hàng Chính Hãng",399000,479000,80000,17
TIKI,dien-gia-dung,149146055,"Máy xay sinh tố SUNHOUSE SHD5112 - Hãng chính hãng",365954,365954,0,0
TIKI,dien-gia-dung,14485875,"Van áp thấp Namilux NA-337S, sử dụng cho bình gas xám, vàng + tặng dây bọc inox - Hàng chính hãng",165000,165000,0,0
TIKI,dien-gia-dung,20363159,"Bếp Gas Dương Kính Sunhouse Mama MMBB0787B - Hàng Chính Hãng",1004000,1035000,31000,3
TIKI,dien-gia-dung,44157951,"Gioăng – ron các loại ly lọc, cốc lọc và cốc vỏ màng- Hàng chính hãng",12000,15000,3000,20
TIKI,dien-gia-dung,1733781,"Quạt Treo Tường 2 Dây Senko TC1622 (65W) - Xanh Lá - Hàng Chính Hãng",416000,416000,0,0
TIKI,dien-gia-dung,124283260,"Bộ lõi máy lọc nước AO Smith A1/A2/M2 - E2/E3 - AR75-AS1E/AR75-AS2/M1/G1/G2 kèm co nối Scitech cho lõi nối nhanh - Hàng chính hãng",350000,350000,0,0
TIKI,dien-gia-dung,184603384,"Cửa thông gió NHÔM gắn tường - DECOR M 150*150s A - Hàng Nhập Khẩu",110000,110000,0,0
TIKI,dien-gia-dung,176296117,"Máy Xay Thực Phẩm Đa Năng &amp; Trong 1 Mishio MK323 - Hàng Chính Hãng",699000,1399000,700000,50
TIKI,dien-gia-dung,359479,"Máy Đánh Trứng Bluestone HMB-6333S (300W) - Hàng chính hãng",629000,829000,200000,24
TIKI,dien-gia-dung,188189727,"Lõi lọc Philips All-in-One ADD550 dành cho máy lọc nước RO để bàn ADD6910 - Hàng chính hãng",1935000,2150000,215000,10
TIKI,dien-gia-dung,19790643,"Bàn Là Khô Bluestone DIB-3726 (1300W) - Hàng Chính Hãng",319000,369000,50000,14
TIKI,dien-gia-dung,158755220,"Máy Hút Bụi Công Nghiệp Hút Khô Và Ướt USA Stanley SL19417-8A - 30 lít/ Công suất 4000W (5.5HP) - Hàng Chính Hãng",2850000,2850000,0,0
TIKI,dien-gia-dung,175173294,"Máy sấy tóc bổ sung ion âm ShowSee A1 1800W cao cấp Chống Xù Rối Khô Tóc - Hàng chính hãng",279000,490000,211000,43
TIKI,dien-gia-dung,71049798,"Máy Ép Chậm trái cây mini BUD BJ08 cơ chế hai kênh, tách rời bã cặn riêng biệt, tốc độ 60 vòng/phút",1050000,1050000,0,0
TIKI,dien-gia-dung,48480933,"Ấm Đun Nước Siêu Tốc Elmich KEE-1785 (1.5 Lít) - Hàng chính hãng",850000,1219000,369000,30
TIKI,dien-gia-dung,23089693,"Nồi Nấu Cháo Đa Năng BBCooker BS15 (1.5L) - Hàng nhập khẩu",499000,499000,0,0
TIKI,dien-gia-dung,186349365,"Lõi lọc không khí Xiaomi Xiaomi Mi Air Purifier Filter Có chip RFID - Hàng chính hãng",590000,590000,0,0
TIKI,dien-gia-dung,68778633,"Bộ lõi lọc 1,2,3 máy lọc nước empire",180000,180000,0,0
TIKI,dien-gia-dung,188189667,"Lõi lọc thô PPC Philips AUT706 (cho AUT2015 và AUT3015)",585000,690000,105000,15
TIKI,dien-gia-dung,70528161,"Quạt Đảo Điều Khiển 18 inch Hatari HT-C18R1(S) - Màu Ngẫu Nhiên - Hàng Chính Hãng",1746000,1800000,54000,3
TIKI,dien-gia-dung,12284683,"Ca Nấu Đa Năng Tiross TS1366 (1.2L) - Hồng - Hàng chính hãng",650000,790000,140000,18
TIKI,dien-gia-dung,70383543,"Bộ 2 nối thẳng 02 đầu ren ngoài 13 -13 nối ly lọc, cốc lọc ",34000,50000,16000,32
TIKI,dien-gia-dung,117207820,"Lõi UDF/GAC 10 inch - Lõi số 2 máy lọc nước RO, bộ lọc thô - Hàng chính hãng",125000,125000,0,0
TIKI,dien-gia-dung,57630144,"Máy xay công nghiệp 1800W Osako OS-1800 dung tích cối 2L, bộ dao 6 lưỡi, chức năng hẹn giờ, màu ngẫu nhiên-Hàng chính hãng",1890000,1890000,0,0
TIKI,dien-gia-dung,15257644,"Ấm Sắc Thuốc Gốm Bát Tràng Fujika FJ-CK33K7 (3.3L) - Hàng Chính Hãng",241000,250000,9000,4
TIKI,dien-gia-dung,13462562,"Máy xử lý nước thải phòng khám - Hàng Chính Hãng",17500000,17500000,0,0
TIKI,dien-gia-dung,127493499,"Nồi cơm điện LHTR-0609F 1.08l - Hàn quốc - Hàng chính hãng",10490000,14375000,3885000,27
TIKI,dien-gia-dung,526678,"Máy May Brother JA1400 (50W) - Hàng chính hãng",2890000,2890000,0,0
TIKI,dien-gia-dung,48962414,"Lò Vi Sóng Sharp R-208VN-WS (20L) - Hàng Chính Hãng",1569000,1750000,181000,10
TIKI,dien-gia-dung,1644719,"Máy Lọc Nước Pureit Ultima Lọc Nguyên Khối Tích Hợp Công Nghệ RO + UV + MF - Hàng chính hãng",8100000,12400000,4300000,35
TIKI,dien-gia-dung,120790044,"Máy hút bụi lau sàn làm sạch thông minh không dây Tineco Floor One S3 - Hàng chính hãng",5990000,6990000,1000000,14
TIKI,dien-gia-dung,1733779,"Quạt Treo Tường 2 Dây Senko TC1622 (65W) - Cam - Hàng Chính Hãng",416000,416000,0,0
TIKI,dien-gia-dung,120797515,"Máy hút bụi lau sàn làm sạch thông minh không dây Tineco IFLOOR 2 - Hàng chính hãng",2990000,4090000,1100000,27
TIKI,dien-gia-dung,20372569,"Máy Ép Trái Cây Elmich JEE-1854 (800ml - 240W) - Hàng Chính Hãng",4420000,5990000,1570000,26
TIKI,dien-gia-dung,17014393,"Quạt đứng điều khiển từ xa Senko hàng chính hãng - DR1608",775000,775000,0,0
TIKI,dien-gia-dung,179987813,"Quạt Gắn Màn Hình Kiêm Để Bàn Baseus Refreshing Monitor Clip-On &amp; Stand-Up Desk Fan - Hàng Chính Hãng",670000,730000,60000,8
TIKI,dien-gia-dung,46134873,"Bàn Ủi Hơi Nước Đứng Philips GC482/29 (1600W)- Hàng Chính Hãng",1149000,2000000,851000,43
TIKI,dien-gia-dung,173177112,"Máy lọc nước nóng lạnh 10 lõi lọc, Karofi KAD-N69, Màng RO 100GPD Mỹ - Hàng Chính Hãng - Miễn Phí Lắp Đặt Toàn Quốc",12065800,14030000,1964200,14
TIKI,dien-gia-dung,169778442,"Máy hút bụi khô và ướt Karcher WD 3 S Premium (new 2022) - Hàng chính hãng",3754000,3890000,136000,3
TIKI,dien-gia-dung,77117575,"Máy lọc nước tại vòi Xiaomi Mijia MUL11 tặng kèm 3 lõi lọc",699000,699000,0,0
TIKI,dien-gia-dung,160759206,"Máy lọc nước Pureit Delica Âm tủ bếp RO  11,000L UR5440 ,Hàng chính hãng",9790000,10900000,1110000,10
TIKI,dien-gia-dung,108747393,"Quạt treo tường Senko TR1683 có remote điều khiển từ xa - Hàng chính hãng - Được chọn màu",518000,518000,0,0
TIKI,dien-gia-dung,127911456,"Nồi Cơm Điện Sharp KS-R181ST - 1.8 Lít - Hàng Nhập Khẩu Thái Lan",1190000,1190000,0,0
TIKI,dien-gia-dung,151525726,"Máy ép chậm elmich smartcook 3896 hàng chính hãng",1454000,1890000,436000,23
TIKI,dien-gia-dung,192290300,"Máy cạo râu mini Xiaomi Mijia S100 MSX201 - Hàng Chính Hãng",409000,409000,0,0
TIKI,dien-gia-dung,70586449,"Máy Lọc Nước Unilever Pureit Delica – Công Nghệ Lọc RO - Lắp Dưới Ngăn Tủ Bếp - Hàng Chính Hãng",11590000,13650000,2060000,15
TIKI,dien-gia-dung,10131404,"Máy lọc không khí Sharp FP-J40E-W (23W) - Hàng chính hãng",3599000,3599000,0,0
TIKI,dien-gia-dung,76753870,"Nồi Chiên Không Dầu Sharp KF-AF42MV-ST (4.2 Lít) – Hàng Chính Hãng",1219000,1219000,0,0
TIKI,dien-gia-dung,145832230,"Nồi chiên không dầu cao cấp Mishio - Hàng chính hãng",514500,799000,284500,36
TIKI,dien-gia-dung,91512881,"Quạt đảo trần Thái Lan Hatari HT-C16R1 - Hàng nhập khẩu (có điều khiển)",1215000,1215000,0,0
TIKI,dien-gia-dung,160759200,"Máy lọc nước Pureit Tanka Âm tủ bếp với Công suất RO 5,000L , Hàng chính hãng",5700000,6400000,700000,11
TIKI,dien-gia-dung,68832220,"BẾP ĐÔI ĐIỆN TỪ SUNHOUSE MAMA MMB-88HL - Hàng chính hãng",4589000,4589000,0,0
TIKI,dien-gia-dung,85137578,"Máy sấy chén Cuckoo 40 lít CDD-A910S - Hàng chính hãng",3190000,3190000,0,0
TIKI,dien-gia-dung,137611593,"Nối ống tròn + van ngăn gió ngược 10SKPO - Hàng nhập khẩu",50000,50000,0,0
TIKI,dien-gia-dung,55928052,"Máy hút ẩm lọc không khí VF-STORM - hàng chính hãng (40m2 - 1000ml/ngày)",2890000,2890000,0,0
TIKI,dien-gia-dung,159872085,"Nồi Lẩu Điện Đa Năng Chống Dính 3 Lít 1000W KONKA KZG-HP03 - HÀNG CHÍNH HÃNG ",570000,950000,380000,40
TIKI,dien-gia-dung,176224289,"Máy phun sương tạo độ ẩm Xiaomi Mi Smart Antibacterial Humidifier SKV4140GL ZNJSQ01DEM - Hàng chính hãng",1179000,1390000,211000,15
TIKI,dien-gia-dung,367142,"Quạt Treo Tường KDK M40M (Đen) - Hàng chính hãng",2249000,3500000,1251000,36
TIKI,dien-gia-dung,249766236,"Máy Pha Cà Phê Tự Động Espresso BEAR CF-B15V1 Với Công Thức Pha Nespresso, Americano, Cappuccino Tạo Bọt Sữa Dễ Dàng Áp Suất 15 Bar Công Suất 950 W - Hàng Chính Hãng",2249000,4489000,2240000,50
TIKI,dien-gia-dung,19702151,"Máy ép chậm Kuvings E7000 - Chính hãng",6370000,6500000,130000,2
TIKI,dien-gia-dung,162571848,"NỒI CHIÊN KHÔNG DẦU LOTTE 5,5L LTS - AF5SM  HÀNG CHÍNH HÃNG",2280000,2280000,0,0
TIKI,dien-gia-dung,122619602,"Nồi Điện Đa Năng, Nồi Lẩu Nướng Đa Năng BEAR SUBE004 3 Khay Rời Dung Tích 4L, Công Suất 1200W - Hàng Chính Hãng",1567000,3189000,1622000,51
TIKI,dien-gia-dung,473212,"Quạt Treo Tường MITSUBISHI W16-RV CY-GY - Xám Đậm - Hàng Chính Hãng",1789000,1789000,0,0
TIKI,dien-gia-dung,193512877,"Máy hút bụi giường nệm morphy richards MR3100 phiên bản không dây, lực hút mạnh mex13000Pa, hệ thống lọc 6 lớp bền bỉ, hàng nhập khẩu",2690000,2690000,0,0
TIKI,dien-gia-dung,175213250,"Máy lọc nước Nano Geyser ECO công nghệ lọc Nano - Hàng Chính Hãng",1709000,3058000,1349000,44
TIKI,dien-gia-dung,187184425,"Hàng chính hãng Quạt đối lưu không khí Iris Ohyama PCF-SM12 màu trắng",783000,900000,117000,13
TIKI,dien-gia-dung,75320808,"Nồi Cơm Điện Mini Mishio MK265 0.8 Lít - Hàng chính hãng",294000,599000,305000,51
TIKI,dien-gia-dung,43950691,"Màng lọc máy lọc không khí Bohmann B401, B501 - Hàng chính hãng",390000,450000,60000,13
TIKI,dien-gia-dung,566866,"Bếp Đôi Điện Từ - Hồng Ngoại Sunhouse SHB9103MT - Hàng chính hãng",2229000,4613000,2384000,52
TIKI,dien-gia-dung,75353840,"Máy nhào bột, đánh trứng, trộn thực phẩm làm bánh 5 lít 1200W Hàng Chính Hãng",2150000,2150000,0,0
TIKI,dien-gia-dung,17907380,"Bàn ủi hơi nước bình treo công nghiệp Silver Star ES-94A - Hàng Chính Hãng",1233750,1233750,0,0
TIKI,dien-gia-dung,191808972,"Máy sấy tóc Philips BHC01000 - Dễ dàng chăm sóc tóc của bạn",388000,455000,67000,15
TIKI,dien-gia-dung,2138525,"Máy Lọc Không Khí Sharp FP-J30E-B - Hàng chính hãng",2099000,4000000,1901000,48
TIKI,dien-gia-dung,48452380,"Nồi lẩu 3 đáy inox 430 Fivestar sử dụng bếp từ nắp kính tặng 2 vá canh ( 24cm / 26cm / 28cm )",269000,490000,221000,45
TIKI,dien-gia-dung,132904116,"Nồi chiên hơi nước Kalite STEAM PRO, kết hợp chiên không dầu và hấp, bảng điều khiển cảm ứng, công suất 1800W, dung tích 15L, hàng chính hãng",7264000,7264000,0,0
TIKI,dien-gia-dung,47273565,"Nồi chiên không dầu Rapido RAF6.5M2 - 1800W (6.5L, Chính hãng)",1700000,1700000,0,0
TIKI,dien-gia-dung,87649567,"Máy hút bụi khô và ướt HiClean HC15P (dung tích 15L, 1500W) - Hàng chính hãng",1450000,2000000,550000,28
TIKI,dien-gia-dung,82912300,"Quạt đứng hẹn giờ SENKO DH1600 - Hàng chính hãng",450000,450000,0,0
TIKI,dien-gia-dung,8348786,"Bếp hồng ngoại Osako OHA-1820 - 2000W - Hàng chính hãng",675000,675000,0,0
TIKI,dien-gia-dung,1563563,"Máy Xay Sinh Tố 3 Cối Sunhouse SHD5582W (400W) - Hàng chính hãng",670000,1190000,520000,44
TIKI,dien-gia-dung,193110728,"Máy pha cà phê gia đình, văn phòng GAGGIA GRAN DELUXE - Hàng chính hãng",4398000,5656000,1258000,22
TIKI,dien-gia-dung,54053867,"NỐI ỐNG TRÒN CÓ VAN CHỐNG GIÓ NGƯỢC - RVK 100- Hàng Nhập Khẩu",70000,70000,0,0
TIKI,dien-gia-dung,7171913,"Bếp Hồng Ngoại Cảm Ứng Sunhouse SHD 6011 (2000W) - Hàng chính hãng",575000,593000,18000,3
TIKI,dien-gia-dung,153891547,"Thiết bị lọc nước tại vòi Philips AWP3753 - Hàng chính hãng",999000,1399000,400000,29
TIKI,dien-gia-dung,31502006,"Nồi Cơm Tách Đường Magic A-511 (1.5 Lít) - Hàng Chính Hãng",2990000,5190000,2200000,42
TIKI,dien-gia-dung,58666787,"Máy pha cà phê Espresso Zamboo ZB90-PRO (1350W) - Hàng chính hãng",2645000,2645000,0,0
TIKI,dien-gia-dung,69746671,"Tông Đơ Cắt Tóc Chuyên Nghiệp Không Dây USLION- Được nhiều thợ cắt tóc tin dùng",299000,344000,45000,13
TIKI,dien-gia-dung,510494,"Lò Nướng Halogen Tiross TS9601 - 9L (Trắng) - Hàng chính hãng",786000,890000,104000,12
TIKI,dien-gia-dung,129235211,"Quạt đảo trần Panasonic F-409QGO/ F-409QB (Nhập khẩu)",2540000,2540000,0,0
TIKI,dien-gia-dung,173796447,"Máy Hút Ẩm & Lọc Không Khí ULTTY LUK016 Công suất 16-20L/Ngày - Hàng Chính Hãng",5600000,5600000,0,0
TIKI,dien-gia-dung,274890492,"Robot Hút Bụi Lau Nhà Dreame X10 - Kết Nối Áp Điện Thoại Tự Giặt Sấy Khô Giẻ Khí Nóng Kháng Khuẩn Hoạt Động 300 m2 Lực Hút 5050 Pa - Hàng Nhập Khẩu",10999000,20499000,9500000,46
TIKI,dien-gia-dung,107325994,"Máy pha cà phê viên nén Stelang ST504 3 trong 1, dùng được cà phê bột và Dolce Gusto, Nespresso, áp suất 19 bar hàng chính hãng",2450000,2450000,0,0
TIKI,dien-gia-dung,182729131,"Nồi cơm điện áp suất cao tần Zojirushi NP-HRQ10-XT 1L, sản xuất tại Nhật, hàng chính hãng",15190000,18990000,3800000,20
TIKI,dien-gia-dung,72659413,"Bộ Bàn Ủi Hơi Nước Đứng Cao Cấp CHIGO ZD168 Đầu Phun Hơi Mạnh Mẽ Công Suất 1700W - Hàng Chính Hãng",450000,450000,0,0
TIKI,dien-gia-dung,10131469,"Máy lọc không khí Sharp FP-J80EV-H - Hàng chính hãng",6789000,8590000,1801000,21
TIKI,dien-gia-dung,112248520,"Máy lọc nước Nano TK9 Hydrogen by Scitech (Không dùng điện, không nước thải, tích hợp công nghệ tạo nước ion kiềm) - Hàng chính hãng",2790000,2790000,0,0
TIKI,dien-gia-dung,195773166,"Nồi Cơm Điện Kim Cương 0.3 Lít - Mini, Nắp Rời",249000,249000,0,0
TIKI,dien-gia-dung,637552,"Quạt Trần Panasonic F-60TDN - Hàng chính hãng",4690000,4690000,0,0
TIKI,dien-gia-dung,474857,"Quạt Đứng Panasonic F-308NH- Hồng -Hàng Chính Hãng",2789000,4000000,1211000,30
TIKI,dien-gia-dung,152529206,"Bình đun siêu tốc Sunhouse 1.8 lít SHD1351 - Hàng chính hãng",250000,250000,0,0
TIKI,dien-gia-dung,175857327,"Bếp Âm Từ Đôi Hafele HC-I2712A (536.61.716) (Hàng chính hãng)",9499000,16489000,6990000,42
TIKI,dien-gia-dung,3577753,"Quạt đứng Toshiba F- LSA20(H)VN (60W) - Xám - Hàng chính hãng",1460000,1590000,130000,8
TIKI,dien-gia-dung,81597752,"Bộ 2 chổi quét góc - Phụ kiện Robot hút bụi lau nhà Liectroux ZK901 - Hàng chính hãng",170000,170000,0,0
TIKI,dien-gia-dung,56551761,"Vòi bình lọc nước VBL01 (Hàng chính hãng)",92000,109000,17000,16
TIKI,dien-gia-dung,174070848,"Bình đun siêu tốc đa năng Cuckoo CK-A170T dung tích lớn 1.7L - 1850W - Điều chỉnh nhiệt độ nước - Hàng chính hãng",1390000,1390000,0,0
TIKI,dien-gia-dung,185225505,"Máy Hút Bụi Không Dây DR79 - Pin 4000 mAh, Lực Hút 9000 Pa - Máy Hút Bụi Giường Nệm, Ô Tô, Máy Tính/PC - Hàng Chính Hãng",298000,298000,0,0
TIKI,dien-gia-dung,206191755,"Máy sưởi gốm không khô da FujiE, tự ngắt, quạt sưởi gốm điều khiển từ xa không đốt oxi - Hàng chính hãng",1478000,2500000,1022000,41
TIKI,dien-gia-dung,146676608,"[Hàng chính hãng] Bếp Điện Hồng Ngoại Ladomax Ha666 khung tay cầm inox, công suất 2200W",665000,665000,0,0
TIKI,dien-gia-dung,78939953,"Máy Pha cafe gia đình Hàng Nội Địa Hàn Quốc thương hiệu Mediheim",440000,440000,0,0
TIKI,dien-gia-dung,50731778,"Quạt treo 2 dây mẫu mới F23 Senko TC1620 (1 thùng / 2 cây) - Màu ngẫu nhiên - Hàng chính hãng",805000,805000,0,0
TIKI,dien-gia-dung,12634650,"Bộ Lọc Thay Thế Toray Torayvino MKC.MXJ - Hàng chính hãng",563000,625000,62000,10
TIKI,dien-gia-dung,116962871,"Máy phun sương tạo ẩm, xông tinh dầu mini dùng cho xe hơi Baseus Time Aromatherapy Humidifier",341500,341500,0,0
TIKI,dien-gia-dung,73230929,"[CHÍNH HÃNG] Máy Làm Sữa Hạt OLIVO X20 - Chống Tràn - Xay Mịn Không Cần Lọc - Máy Xay Nấu Đa Năng - Thương Hiệu Mỹ",2390000,2390000,0,0
TIKI,dien-gia-dung,81508743," Tấm lọc HEPA - Phụ kiện Robot hút bụi lau nhà Liectroux ZK901 - Hàng chính hãng",90000,90000,0,0
TIKI,dien-gia-dung,42489602,"Van điện từ 24V dùng trong máy lọc nước R.O",79000,109000,30000,28
TIKI,dien-gia-dung,178595455,"Nồi nấu chậm Bear 0.8 lít DDZ-A08D1 - Hàng chính hãng",399000,699000,300000,43
TIKI,dien-gia-dung,149145484,"Ấm Đun Siêu Tốc SUNHOUSE 2 Lớp Dung Tích 1.8L SHD1351 - Hàng chính hãng",227000,234000,7000,3
TIKI,dien-gia-dung,138465607,"[CÓ HĐ VAT] Trọn bộ 9 lõi lọc nước Kangaroo hàng chính hãng cho máy KG-109 + TẶNG 1 LÕI SỐ 1 KANGAROO",2000000,2000000,0,0
TIKI,dien-gia-dung,58057116,"Bàn ủi hơi nước đứng Philips GC485/49 (1800W) - Hàng Chính Hãng",2059000,2580000,521000,20
TIKI,dien-gia-dung,37082390,"Bếp Gas Đôi Rinnai 360G Xám - Hàng Chính Hãng",730000,730000,0,0
TIKI,dien-gia-dung,102551671,"Quạt Sạc Tích Điện Sunhouse SHD7228 - Hàng Chính Hãng",1339000,1339000,0,0
TIKI,dien-gia-dung,108914010,"Máy phun sương, tạo ẩm Essesa giúp điều hòa không khí, máy khuếch tán tinh dầu tạo mùi thơm phòng - Hàng chính hãng",246000,279000,33000,12
TIKI,dien-gia-dung,151438751,"Nồi hấp thực phẩm 3 tầng Morphy Richards MR1148 công suất 750W - Hàng Nhập Khẩu",1723000,1723000,0,0
TIKI,dien-gia-dung,253498803,"Bộ Lọc Thay Thế Pureit Ultima 2 - Hàng Chính Hãng",1920600,1980000,59400,3
TIKI,dien-gia-dung,484666,"Lò Nướng Đa Năng COMET CM6516 (18 Lít) - Hàng Chính Hãng",899000,1090000,191000,18
TIKI,dien-gia-dung,90660566,"Máy ép chậm Kalite KL 565, công suất 240W, ống tiếp nguyên liệu size lớn, có dao cắt nhỏ hoa quả, có ống làm kem - Hàng chính hãng - Tặng 1 bình nước cao cấp ",5145000,5145000,0,0
TIKI,dien-gia-dung,194124806,"Máy Ép Trái Cây Tốc Độ Chậm Elmich JEE-1855OL (Công Suất 240W, - Ống Tiếp Nguyên Liệu size Lớn) - Hàng chính hãng",3890000,3890000,0,0
TIKI,dien-gia-dung,394721,"Máy May Brother GS-2500 (52W) - Hàng chính hãng",3990000,4190000,200000,5
TIKI,dien-gia-dung,125731297,"Quạt Thông Gió Gắn Trần Có Ống Hút Ngang LiOA EVF24CU7 - Hàng Chính Hãng",480000,480000,0,0
TIKI,dien-gia-dung,57489542,"Máy Lọc Không Khí Samsung 60m2 AX60R5080WD - Hàng Chính Hãng",7120000,10090000,2970000,29
TIKI,dien-gia-dung,210428707,"Máy Lọc Không Khí Xiaomi Smart Air Purifier 4 Compact Lọc Bụi Mịn Phù Hợp 20 m2 - Hàng Chính Hãng",1690000,3499000,1809000,52
TIKI,dien-gia-dung,106320899,"Quạt đảo trần Asia X16002 có điều khiển từ xa công suất 55W - Hàng chính hãng",805000,805000,0,0
TIKI,dien-gia-dung,21925885,"Bàn ủi hơi nước mini cầm tay hàng hiệu nhập khẩu cao cấp Royalstar",320000,320000,0,0
TIKI,dien-gia-dung,116475122,"Máy Lọc Không Khí Samsung AX34R3020WW (Diện tích sử dụng 34m2) - Hàng Chính Hãng",3820000,5190000,1370000,26
TIKI,dien-gia-dung,105666369,"Nồi Điện Đa Năng Lock&Lock EJP546BLK 4 lít , phủ lớp chống dính - hàng chính hãng",699000,1250000,551000,44
TIKI,dien-gia-dung,22524049,"Máy Hút Mùi Teka TLR2 72 SS (70 cm) - Hàng Chính Hãng",2750000,4525200,1775200,39
TIKI,dien-gia-dung,192391003,"Máy Xay Sinh Tố Đa Năng Lazychef 5in1- Làm Smoothie, Soup Bột Mịn, Sữa Ngô, Bình Đun Nước Công Nghệ Đức – Hàng Chính Hãng",1289000,2150000,861000,40
TIKI,dien-gia-dung,182602978,"[HÀNG CHÍNH HÃNG] Máy Làm Sữa Hạt TAPUHO T01 - Thương hiệu Đức - 1.750ml",2750000,2750000,0,0
TIKI,dien-gia-dung,58400681,"Quạt Bàn Đảo 3 Tấc Senko BD1012 cao cấp - Màu Ngẫu Nhiên - Hàng chính hãng",325000,325000,0,0
TIKI,dien-gia-dung,90331616,"Máy xay cầm tay  Braun Sản xuất 100% tại Châu Âu Số 1 thế giới - hàng chính hãng",1599000,2090000,491000,23
TIKI,dien-gia-dung,89399344,"Máy lọc nước Karofi KAQ-P95 - Hàng chính hãng",8632800,9810000,1177200,12
TIKI,dien-gia-dung,103379574,"Nồi Lẩu Điện Sunhouse SHD4527 (3.5L) - Hàng Chính Hãng",435000,448480,13480,3
TIKI,dien-gia-dung,58258643,"Nồi Chiên Không Dầu Magic A-802 (4.6 Lít) Đen - Hàng Chính Hãng",978500,1030000,51500,5
TIKI,dien-gia-dung,109219377,"Máy hút bụi Deerma DX700S ( hàng nhập khẩu )",658000,658000,0,0
TIKI,dien-gia-dung,447306,"Máy Sấy Tóc Panasonic PAST-EH-NA45RP645-Hàng Chính Hãng",2209000,2699000,490000,18
TIKI,dien-gia-dung,556623,"Nồi Cơm Điện Nắp Gài Tiger JNP-1803 - 1.8L - Hàng Chính Hãng",2658000,2658000,0,0
TIKI,dien-gia-dung,11385211,"Quạt treo 2 dây mẫu mới F23 Senko TC1622 - Hàng chính hãng",416000,416000,0,0
TIKI,dien-gia-dung,190507534,"Nồi Lẩu Điện, Nồi Điện Đa Năng Hiện Đại Damas DK8012 - Thiết Kế Thông Minh Đa Chức Năng, Nấu lẩu, Luộc, Hấp, Xào,... Chất Liệu Thép Không Gỉ Cao Cấp, Dung Tích 1,2 Lít Phù Hợp Cho Những Người FA - Hàng Nhập Khẩu",251000,500000,249000,50
TIKI,dien-gia-dung,174820904,"Nồi Nấu Đa Năng Mishio MK321 Dung Tích 1.5L Dành Cho 1-2 Người - Hàng Chính Hãng",494000,690000,196000,28
TIKI,dien-gia-dung,152780021,"Quạt Đứng Mitsubishi LV16-RA CY-GY - Xám Đậm - Hàng chính hãng",2090000,3000000,910000,30
TIKI,dien-gia-dung,900904,"Máy Xay Sinh Tố 2 Cối Kangaroo KG2B3 (380W) - Bạc- Hàng chính hãng",550000,1040000,490000,47
TIKI,dien-gia-dung,186564098,"Máy làm sữa hạt mini, Máy xay sữa hạt ARBER MLSH4WMĐ dung tích 350ml màu đỏ - Hàng chính hãng",1024000,1045000,21000,2
TIKI,dien-gia-dung,160265699,"Máy Hút Bụi Lau Sàn Không Dây Đa Năng Deerma VX100 - Hàng Nhập Khẩu",5290000,5490000,200000,4
TIKI,dien-gia-dung,12643754,"Bộ Lọc Thay Thế Toray Torayvino MKC.TJ - Hàng chính hãng",509000,537000,28000,5
TIKI,dien-gia-dung,39188644,"Nồi cơm điện Lock&Lock EJR156 1,8lit - GOLD (hàng chính hãng)",1399000,2550000,1151000,45
TIKI,dien-gia-dung,165937758,"Nồi Điện Đa Năng, Nồi Điện Mini BEAR DRG-P16M2 Dung Tích, 1.6L Công Suất 700W Bản Quốc Tế - Hàng Chính Hãng",569300,575000,5700,1
TIKI,dien-gia-dung,48076547,"Combo 7 lõi lọc nước dành cho máy lọc  Karofi 7 cấp ( Lõi 123+RO+Mineral+Gac T33+Nanosilver) ( Hàng chính hãng)",819000,844000,25000,3
TIKI,dien-gia-dung,126743486,"Bếp từ đôi (2 vùng nấu) Bosch Series 6 PPI82560MS - Hàng chính hãng",12300000,12300000,0,0
TIKI,dien-gia-dung,57633440,"Quạt  Mini Để Bàn, Quạt Tích Điện, Quạt Sạc K168 Kiểu Dáng Sang Trọng - Có 3 Tốc Độ Gió, Làm Mát Nhanh, Dung Lượng Pin 1800mAh - Hàng Nhập Khẩu",268000,279000,11000,4
TIKI,dien-gia-dung,84572580,"Tông đơ cắt tóc chuyên nghiệp Kemei 1997",599000,599000,0,0
TIKI,dien-gia-dung,506949,"Máy Vắt Sổ Brother 2104D - Trắng - Hàng chính hãng",7899000,7899000,0,0
TIKI,dien-gia-dung,57496385,"Lò Vi Sóng Tráng Men Samsung Có Nướng 23L MG23T5018CK/SV",3000000,3990000,990000,25
TIKI,dien-gia-dung,73640087,"Nồi Chiên Không Dầu Điện Tử BlueStone AFB-5880 (5,5 Lít) - Hàng Chính Hãng",1599000,2899000,1300000,45
TIKI,dien-gia-dung,58057112,"Máy xay sinh tố Philips HR2221/00 (700W) - Hàng Chính Hãng",1035000,1035000,0,0
TIKI,dien-gia-dung,178112129,"Bàn là hơi nước đứng Elmich GSE-3953-Hàng chính hãng",2149000,2149000,0,0
TIKI,dien-gia-dung,729928,"Quạt Treo Tường Tường Lồng Nhựa Lifan T-109 - Xám Trắng - Hàng chính hãng",255000,255000,0,0
TIKI,dien-gia-dung,175415489,"Máy lọc nước Nano Geyser RO ECO, Công nghệ lọc nước tinh khiết RO - Hàng Chính Hãng",2050000,3900000,1850000,47
TIKI,dien-gia-dung,77657057,"Van bình áp - van khóa bình chứa nước máy lọc nước, van dùng trong bộ lọc nước, máy lọc nước (Hàng chính hãng)",27000,35000,8000,23
TIKI,dien-gia-dung,43715859,"Tông Đơ Cắt Tóc F10 TẶNG Bộ Kéo Cắt Tỉa Chuyên Nghiệp (Có Pin Sơ Cua)",387000,426000,39000,9
TIKI,dien-gia-dung,169000196,"MÁY ÉP TRÁI CÂY KANGAROO KG200SJD1 (MÁY ÉP CHẬM 665ml - 200W) Hàng Chính Hãng)",5210000,5210000,0,0
TIKI,dien-gia-dung,156175302,"Bếp Điện Từ Đơn Cảm Ứng Kèm Nồi Lẩu Inox NK Media MD-BT1820 - Hàng Chính Hãng",582000,600000,18000,3
TIKI,dien-gia-dung,139243803,"Máy lọc nước Karofi KAQ-O06 chính hãng",5768000,8240000,2472000,30
TIKI,dien-gia-dung,52590924,"MÁY XAY SINH TỐ CHÂN KHÔNG HAFELE BR230-19E00/ 535.43.271-Hàng chính hãng",2399000,3990000,1591000,40
TIKI,dien-gia-dung,42620808,"Phụ kiện kết nối bộ lọc thô, lọc sinh hoạt 10 inch ren phi 21 dây mềm - Hàng chính hãng",92000,139000,47000,34
TIKI,dien-gia-dung,192113320,"Máy Xay Sinh Tố Philips HR2041/50, Công Suất 450W, 2 Cối Lớn và 1 Cối Nhỏ, Hàng Chính Hãng",870000,897000,27000,3
TIKI,dien-gia-dung,187414027,"Máy sấy tóc Philips BHC015/00 - Chăm sóc tóc dễ dàng",428000,475000,47000,10
TIKI,dien-gia-dung,52593583,"Bàn là, bàn ủi hơi nước cầm tay đứng gấp gọn , bàn là hơi nước cầm tay SOKANY 3060 - 1500W, là nhanh mọi loại vải không lo mỏi tay - HÀNG CHÍNH HÃNG",421000,439000,18000,4
TIKI,dien-gia-dung,194953279,"Máy Xay Nấu Đa Năng OLIVO CB20 - Độ Ồn Thấp Nhất - Chống Trào Tuyệt Đối - Vệ Sinh Khử Khuẩn - Chống Dính Gốm - Hàng Chính Hãng",2490000,2490000,0,0
TIKI,dien-gia-dung,94490164,"Nồi Cơm Điện Nắp Cài Happy Cook HCJ-180V (1.8L) - Hàng Chính Hãng",825000,825000,0,0
TIKI,dien-gia-dung,88798404,"Quạt thông gió nối ống phi 100 - Quạt hút đồng trục cấp khí tươi cho công trình nhà - Hàng chính hãng GDXLFJ siêu chống ồn",1050000,1050000,0,0
TIKI,dien-gia-dung,75427539,"Nồi nấu chậm Bear 2.5L có lồng hấp (5 thố sứ)- Có lồng hấp (Hàng chính hãng)",1590000,1590000,0,0
TIKI,dien-gia-dung,247842917,"Máy Xay Thịt Thực Phẩm Bear SB-MA02L Xay Cực Êm Dung Tích 2 Lít Công Suất 300 W - Hàng Chính Hãng",599000,1049000,450000,43
TIKI,dien-gia-dung,78631427,"Quạt treo 1 dây Senko T1680 - Giao màu ngẫu nhiên - Hàng Chính Hãng",315000,315000,0,0
TIKI,dien-gia-dung,188189693,"Bộ lọc nước tại vòi Philips AWP3753 - Hàng Chính Hãng",1030000,1350000,320000,24
TIKI,dien-gia-dung,115583785,"Bộ 6 Lõi Chức Năng Đúc Nguyên Khối Karofi SMAX Hiệu Suất Cao HP 6.1 - Hàng Chính Hãng",1358000,1400000,42000,3
TIKI,dien-gia-dung,248129690,"Máy Xay Sinh Tố Đa Năng BEAR BL-B10V2 Gồm 3 Cối Dung Tích 1.2 Lít Công Suất 300 W - Hàng Chính Hãng",709000,1219000,510000,42
TIKI,dien-gia-dung,121101405,"Robot hút bụi Ecovacs Deebot N8 Pro - Hàng chính hãng",7390000,11900000,4510000,38
TIKI,dien-gia-dung,524109,"Máy Xay Sinh Tố Cầm Tay Inox DAEWOO DEB-JN200 (150W) - Đỏ - Hàng chính hãng",329000,569000,240000,42
TIKI,dien-gia-dung,29168708,"Máy Lọc Nước RO Không Vỏ Tủ Kangaroo KG109A 9 Lõi - Hàng Chính Hãng",4130000,7160000,3030000,42
TIKI,dien-gia-dung,1024798,"Ấm Siêu Tốc Comet CM8219 (1.8L) - Bạc - Hàng Chính Hãng",219000,219000,0,0
TIKI,dien-gia-dung,22095575,"Bàn Ủi Khô Nagakawa NAG1502 (1200W) - Tím - Hàng Chính Hãng",149000,255000,106000,42
TIKI,dien-gia-dung,114894198,"Máy làm sữa hạt đa năng Bear PBJ-B06W1 độ ồn thấp, nấu cháo, súp, xay sinh tố, nước ép, hẹn giờ thông minh, hàng chính hãng",2590000,2590000,0,0
TIKI,dien-gia-dung,124475724,"Máy Pha Cà Phê Espresso Zamboo ZB-68CF (3.5Bar) - Hàng Chính Hãng",855000,855000,0,0
TIKI,dien-gia-dung,120339826,"Nồi Cơm Điện Mini 2 Trong 1 Thế Hệ Mới  Dung Tích 1,2 Lít Đa Chức Năng Vừa Là Chiếc Cặp Lồng Xách Tay Dùng Cho Dân Văn Phòng - Hàng chính hãng",269000,269000,0,0
TIKI,dien-gia-dung,73871094,"Máy ép chậm trái cây gia đình BUD-JE32  đa năng tiện lợi Hàng Chính Hãng",1750000,1750000,0,0
TIKI,dien-gia-dung,50331023,"Máy Ép Trái Cây Tốc Độ Chậm Kuvings NS-621CBM2 (Xám) - Hàng Chính Hãng",6669000,9990000,3321000,33
TIKI,dien-gia-dung,56373215,"Lò Nướng Không Khí Lock&Lock EJF696 (12 Lít) - Hàng Chính Hãng",2306000,4000000,1694000,42
TIKI,dien-gia-dung,21465891,"Máy Phun Sương Tạo Ẩm Cao Cấp BONECO U200 Khuếch Tán/Xông Tinh Dầu, Bộ Lọc Kháng Khuẩn Chống Viêm Mũi Cho Trẻ Em, Giữ Ẩm Da (<30m2) - Hàng Nhập Khẩu",4128000,4300000,172000,4
TIKI,dien-gia-dung,84841801,"MÁY PHA CÀ PHÊ ZAMBOO ZB-88CF - Hàng chính hãng",1590000,2290000,700000,31
TIKI,dien-gia-dung,186884367,"Máy Lọc Không Khí Samsung AX32BG3100GB (Diện tích sử dụng 41m2) - Hàng Chính Hãng",3815000,6290000,2475000,39
TIKI,dien-gia-dung,252601365,"Nồi Điện Đa Năng OENON 2.5L Công Suất 700W Chống Dính 3 Lớp Phù Hợp Nấu Lẩu, Rán, Chiên, Xào - Hàng Chính Hãng",558000,1000000,442000,44
TIKI,dien-gia-dung,12334266,"Quạt Sàn Rút Lỡ Hatari IS18M1 - Hàng chính hãng",1590000,1590000,0,0
TIKI,dien-gia-dung,181358611,"Máy xay thịt đa năng LEBENLANG công suất 400W, dung tích cối xay 500ml, bảo hành điện tử 2 năm, model LBMF8906 - hàng chính hãng",779000,900000,121000,13
TIKI,dien-gia-dung,4464537,"Bộ lọc nước thô đầu nguồn 2 cấp lọc 10inch Yamato YMTH10-2X - Hàng chính hãng",253000,380000,127000,33
TIKI,dien-gia-dung,140556797,"Máy hút chân không thực phẩm Magic Seal MS400 không kén túi, hút khô và hút nước, mối hàn dính lớn 8mm kín kẽ, hút mạnh mẽ, tự động và bán tự động, hàng chính hãng",4740500,4740500,0,0
TIKI,dien-gia-dung,188147582,"Bình áp máy lọc nước 8L Nano Geyser, Tặng van bình áp nối nhanh - Hàng Chính Hãng",358000,580000,222000,38
TIKI,dien-gia-dung,229810556,"Nồi Chiên Không Dầu, Nồi Chiên Hơi Nước OLIVO SF18 Thương Hiệu Mỹ Cao Cấp Gồm 50 Chức Năng Làm Bít Tết Hấp Nướng Hâm Nóng Đa Năng Dung Tích 18 Lít Công Suất 2450 W - Hàng Chính Hãng",5599000,10559000,4960000,47
TIKI,dien-gia-dung,145289548,"(HÀNG CHÍNH HÃNG) Nồi cơm điện tử thông minh niêu E-Spherical Supor CFXB-50FC33VN-75 - 1.8L, 750W",1386000,1386000,0,0
TIKI,dien-gia-dung,162521850,"Nồi chiên không dầu kết hợp hấp Magic Eco S12 12L - Hàng chính hãng",4190000,6390000,2200000,34
TIKI,dien-gia-dung,184781419,"Máy xay cà phê MAHLKONIG X54 - Hàng chính hãng",20220000,20220000,0,0
TIKI,dien-gia-dung,262305727,"Máy Phun Sương Tạo Ẩm Khuếch Tán Tinh Dầu Xiaomi Deerma F628S Dung Tích 5 Lít Công Suất 25 W - Hàng Chính Hãng",869000,1699000,830000,49
TIKI,dien-gia-dung,125087228,"Nồi chiên không dầu điện tử BlueStone AFB-5878 - 5.5 Lít, Công nghệ làm nóng Rapid Air - Hàng chính hãng",1790000,2499000,709000,28
TIKI,dien-gia-dung,152874286,"Máy Cạo Râu Cầm Tay Smate ST-R201 - Sạc Nhanh Type-C Kháng Nước IPX7 Màn Hình LCD Cao Cấp Bảo Vệ Da Mặt Chất Liệu Kim Loại Sang Trọng",372000,890000,518000,58
TIKI,dien-gia-dung,190860233,"Nồi chiên không dầu Sunhouse SHD4035 (9.0 Lít) - Hàng chính hãng",1780000,3290000,1510000,46
TIKI,dien-gia-dung,76599982,"Quạt công nghiệp Stanley 24” Model SLF306027- Hàng chính hãng",4000000,4000000,0,0
TIKI,dien-gia-dung,711034,"Máy May Gia Đình Juki HZL-29Z - Trắng Tím - Hàng chính hãng",3830000,3830000,0,0
TIKI,dien-gia-dung,265546751,"Quạt Tích Điện Mi-Lux F188 Đối Lưu Không Khí Thế Hệ Mới Pin 8000mAh Tích Điện 20- 60 Giờ Gồm 4 Cấp Độ GióTích Hợp Đèn Ngủ - Hàng Chính Hãng",1599000,2999000,1400000,47
TIKI,dien-gia-dung,146288116,"Máy ép hoa quả Mitomo-EC55 hàng chính hãng bảo hành 3 năm",979000,1320000,341000,26
TIKI,dien-gia-dung,64313758,"Nồi Cơm Điện 1L Fujika FJ-NC1005 Công Suất 400W Lồng Men Chống Dính Cho 2,3 Người Ăn (Mẫu Ngẫu Nhiên)-Hàng Chính Hãng",291000,300000,9000,3
TIKI,dien-gia-dung,31522970,"Lò nướng thủy tinh 16L Khaluck.Home KL-658H - Hàng Chính Hãng",689000,689000,0,0
TIKI,dien-gia-dung,10098952,"Combo lõi lọc nước Karofi 1, 2, 3 dành cho nước Cứng - Hàng Chính Hãng",161000,254000,93000,37
TIKI,dien-gia-dung,105602628,"Quạt Điện Đứng Senko L1338 - thay mã mới L1638 Giao Màu Ngẫu Nhiên - Hàng Chính Hãng",369000,369000,0,0
TIKI,dien-gia-dung,26669664,"Máy xay cà phê cầm tay - Coffee Grinder - nhanh chóng, tiện lợi, sang trọng - Coffee New",232000,239000,7000,3
TIKI,dien-gia-dung,2270899,"Robot Hút Bụi Lau Nhà ILife V5s Pro - Hàng Chính Hãng",3679000,3679000,0,0
TIKI,dien-gia-dung,165343269,"ĐẦU QUẠT TREO TƯỜNG 3HT - HÀNG CHÍNH HÃNG",160000,160000,0,0
TIKI,dien-gia-dung,128824319,"Nồi Chiên Ngập Dầu Sâu Lòng, Bếp Chiên Ngập Dầu Kaisa Villa 2.5L - Hàng Chính Hãng",499000,499000,0,0
TIKI,dien-gia-dung,70527519,"Quạt Sàn Công Nghiệp Chân Quỳ 18'' Hatari IT18M2 - Hàng Chính Hãng - Màu Ngẫu Nhiên",1499000,1499000,0,0
TIKI,dien-gia-dung,74653321,"Máy pha cà phê chính hãng LELIT ANNA PL41EM",14680000,14680000,0,0
TIKI,dien-gia-dung,170964334,"Máy Ép Chậm OLIVO SJ200 [ HÀNG CHÍNH HÃNG] Máy Ép Trái Cây Rau Củ Quả Thương Hiệu Mỹ",3190000,3190000,0,0
TIKI,dien-gia-dung,163552503,"Máy Hàn Miệng Túi FS-200 – Giúp Bảo Quản Thực Vật Tươi Lâu Hơn, Áp Dụng Phổ Biến Trong Đời Sống – Hàng Chính Hãng MINIIN",285000,285000,0,0
TIKI,dien-gia-dung,54614613,"Bàn ủi hơi nước bình treo công nghiệp ES-94A Silver Star + Mặt nạ chống bóng vải - Hàng Chính Hãng",1258950,1258950,0,0
TIKI,dien-gia-dung,1953341,"Máy Sấy Tóc Sunhouse SHD2306 - Đen",180000,340000,160000,47
TIKI,dien-gia-dung,23266924,"Bàn là hơi nước cầm tay PHILIPS GC362 hàng nhập khẩu",1444000,1444000,0,0
TIKI,dien-gia-dung,2500311,"Quạt Hộp 4 Tấc Senko BD850 - Giao Màu Ngẫu Nhiên - Hàng Chính Hãng",491000,491000,0,0
TIKI,dien-gia-dung,111976756,"Quạt Hộp USS-H3VU-Hàng chính hãng",285000,285000,0,0
TIKI,dien-gia-dung,147356517,"Máy Xay Sinh Tố PHILIPS HR2041/10 450W - Hàng Chính Hãng",685000,858000,173000,20
TIKI,dien-gia-dung,205915127,"Quạt Đứng KDK M40K - Xám - Hàng chính hãng",3469000,3469000,0,0
TIKI,dien-gia-dung,197161534,"Máy sưởi gốm không khô da mini nhập khẩu FujiE CH-202, quạt sưởi ceramic không đốt oxi, không phát sáng, làm nóng nhanh, tự ngắt an toàn - Hàng chính hãng",453000,650000,197000,30
TIKI,dien-gia-dung,55583871,"Nồi Cơm Điện Tử Toshiba RC-18DH2PV(W) (1.8 Lít) - Hàng chính hãng",1790000,1920000,130000,7
TIKI,dien-gia-dung,184218808,"Máy ép tốc độ chậm miệng rộng thế hệ mới Magic Eco AC-139 - Hàng chính hãng",3800000,5390000,1590000,29
TIKI,dien-gia-dung,73606924,"Nồi chiên không dầu điện tử Philips HD9252/90 (4.1 Lít) - Hàng chính hãng",1599000,2990000,1391000,47
TIKI,dien-gia-dung,108941339,"Len Nhung Chenille siêu mềm mịn (Mã 01 đến 20)",38900,38900,0,0
TIKI,dien-gia-dung,515782,"Bếp Điện Từ Electrolux ETD29KC - Đen (Kèm Nồi Lẩu) - Hàng chính hãng",1790000,1790000,0,0
TIKI,dien-gia-dung,82880367,"Robot quét nhà thông minh LIECTROUX Hàng chính hãng Robot hút bụi Đức XR500 chức năng 2 trong 1 vừa quét vừa lau Lực hút siêu khỏe CHIP xử lí thông minh Tính năng vượt vật cản",4150000,4650000,500000,11
TIKI,dien-gia-dung,31251787,"Máy hút mùi âm tủ Hafele HH-TI90D 539.81.085 - Hàng Chính Hãng",6368000,7840000,1472000,19
TIKI,dien-gia-dung,377075,"Máy May Brother GS2700 ( 51W) - Hàng chính hãng",4390000,4490000,100000,2
TIKI,dien-gia-dung,150815943,"Máy hút bụi Airbot iRoom 2.0 phiên bản 19000 Pa, động cơ không chổi than, hút giường nệm và dây ống hút cầm tay, Hàng Chính Hãng",2990000,2990000,0,0
TIKI,dien-gia-dung,176749867,"Máy Ép Trục Ngang FORESTO PRANA Màu Đen Hàng Chính Hãng Ép Rau Không Lo Kẹt Bã",4150000,4150000,0,0
TIKI,dien-gia-dung,8309625,"Quạt Trần Mitsubishi C56-RA4 SF-GY - Hàng chính hãng",3290000,3290000,0,0
TIKI,dien-gia-dung,76102965,"Nồi Cơm Điện Cuckoo CRP-PK0600F/BKRDVN 1.08L - Hàng chính hãng",3360000,4190000,830000,20
TIKI,dien-gia-dung,72334364,"Nồi Lẩu Điện Đa Năng Cao Cấp Morphy Richards MR9088 (2,5L) - Có 3 Khay Hấp, Lẩu, Nướng Riêng Biệt - Hàng Chính Hãng - Tiêu chuẩn (3 Khay)",2837000,2837000,0,0
TIKI,dien-gia-dung,13698019,"Bếp Điện Từ Đơn TEKA FIC 31T30 (2000W) - Tặng Kèm Nồi Lẩu - Hàng chính hãng",1590000,2160000,570000,26
TIKI,dien-gia-dung,38628206,"Bếp Ga Đơn Rinnai RV-150 (G) + Tặng kèm 1 bộ dây và van gas- Hãng chính hãng",523000,523000,0,0
TIKI,dien-gia-dung,125087275,"Máy Ép Trái Cây BlueStone JEB-6545 (850W) - Hàng chính hãng",1349000,1999000,650000,33
TIKI,dien-gia-dung,74541023,"Ấm sắc thuốc điện tự động fujika FJ-ck33 dung tích 3L,Màu chọn phân loại, hoa văn ngẫu nhiên-Hàng chính hãng",375000,375000,0,0
TIKI,dien-gia-dung,50328112,"Tông đơ cắt tóc chuyên nghiệp kemei 1996",484000,499000,15000,3
TIKI,dien-gia-dung,54445323,"Ống nối co rút dành cho máy hút bụi - Ống dẫn hướng máy hút bụi 30-35mm",275000,275000,0,0
TIKI,dien-gia-dung,168503402,"Máy hút bụi mini cầm tay không dây hút bụi chăn ga giường đệm thảm có tia UV OALPLE - Hàng nhập khẩu",599000,599000,0,0
TIKI,dien-gia-dung,274907433,"Máy Ép Chậm Cao Cấp Kalite KL-598 Kiệt Nước Tiêu Chuẩn Châu Âu 0.4 Lít Công Suất 400W - Hàng Chính Hãng",5499000,10799000,5300000,49
TIKI,dien-gia-dung,147822401,"Bếp Lẩu Nướng Đa Năng 2 Trong 1- Nồi ĐIện 2 Ngăn- Phong Cách Hàn Quốc-Hàng Loại 1 Chính Hãng- MINIIN",299000,299000,0,0
TIKI,dien-gia-dung,51200047,"Nồi Chiên Không Dầu Philips HD9745 (1500W) - Hàng Chính Hãng",5720000,6349000,629000,10
TIKI,dien-gia-dung,2890867,"Lò vi sóng inverter có nướng Panasonic PALM-NN-GD37HBYUE (23L) - Hàng chính hãng",4290000,4290000,0,0
TIKI,dien-gia-dung,37709143,"Tông đơ cắt tóc KEMEI 1997",599000,599000,0,0
TIKI,dien-gia-dung,230086770,"Máy Trộn Bột Đánh Trứng Đa Năng Unie EM2 Cao Cấp Tiêu Chuẩn Đức Dung Tích 5 Lít Công Suất 1000 W - Hàng Chính Hãng",3699000,6999000,3300000,47
TIKI,dien-gia-dung,10369519,"[Hàng chính hãng]- Máy hút bụi dùng pin(18v) Makita DCL180ZB(chưa kèm pin sạc)",1269000,1269000,0,0
TIKI,dien-gia-dung,23411036,"Máy Hút Bụi DEERMA DX700 ( hàng nhập khẩu )",658500,658500,0,0
TIKI,dien-gia-dung,35242894,"Tông Đơ Cắt Tóc Philips HC3520 - Hàng chính hãng",1382000,1549000,167000,11
TIKI,dien-gia-dung,249859672,"Bình Thủy Giữ Nhiệt, Bình Thủy Điện KALITE KL-888 Pha Trà Pha Sữa, Mức Nhiệt Cài Sẵn Dung Tích 2.7 Lít Công Suất 2200 W - Hàng Chính Hãng",1999000,3989000,1990000,50
TIKI,dien-gia-dung,66546602,"Máy Uốn Tóc, Ép Duỗi Tóc 2in1 PA001 Có Chỉnh Được Nhiệt Độ Giúp Duỗi Thẳng, Làm Xoăn 2in1 Chuẩn Salon tại Nhà",575000,599000,24000,4
TIKI,dien-gia-dung,73374989,"Máy pha cà phê từ hạt tự động hai trong một, chức năng nghiền hạt độc lập và giữ ấm cà phê Hàng Chính Hãng",2450000,2450000,0,0
TIKI,dien-gia-dung,165286204,"ĐẦU QUẠT ĐỨNG 3HT - HÀNG CHÍNH HÃNG",160000,160000,0,0
TIKI,dien-gia-dung,76124825,"Máy Xay Thịt Làm Giò Chả Ruốc, Xay Cua, Xay Cá Gia Đình NEWSUN 1 Kg/ Mẻ, Inox Cao Cấp, Công Suất 900W, Chân vuông",3050000,3050000,0,0
TIKI,dien-gia-dung,178100509,"Phụ kiện thay thế Robot hút bụi Xiaomi Mijia Vacuum Mop Pro - Hàng chính hãng",190000,250000,60000,24
TIKI,dien-gia-dung,68692812,"Máy Lọc Trực Tiếp Đầu Vòi Eurolife EL-LS-D20 - Hàng Chính Hãng",578000,680000,102000,15
TIKI,dien-gia-dung,78487832,"Quạt Lửng Thân Sắt Senko LTS1632 - Màu ngẫu nhiên - Hàng Chính Hãng",462000,462000,0,0
TIKI,dien-gia-dung,448834,"Máy Hút Bụi Panasonic PAHB-MC-CL431AN46 - Hàng chính hãng",2360000,2360000,0,0
TIKI,dien-gia-dung,39186205,"Bếp gas đôi dương Rinnai RV-375 SW(N) (Trắng)- Hàng chính hãng",997000,997000,0,0
TIKI,dien-gia-dung,19361193,"Cây Nước Nóng Lạnh 2 Vòi FUJIE WD1105E - Hàng Chính Hãng",1290000,1990000,700000,35
TIKI,dien-gia-dung,217291175,"Máy xay thịt đa năng SOKANY LB7005A 3L- Hàng chính hãng",479000,499000,20000,4
TIKI,dien-gia-dung,130063458,"Quạt treo Toshiba F-WSA20(H)VN - Hàng chính hãng",1098000,1262000,164000,13
TIKI,dien-gia-dung,52695660,"Máy cạo râu Kemei 1102",193000,199000,6000,3
TIKI,dien-gia-dung,42958544,"Biến áp (Adaptor) - chuyển nguồn",133000,150000,17000,11
TIKI,dien-gia-dung,548440,"Nồi Cơm Điện Nắp Gài Cuckoo CR- 0661 màu cam - 1L - Hàng Chính Hãng",1339000,1339000,0,0
TIKI,dien-gia-dung,157030258,"Bếp Nướng Điện Bluestone EGB-7408 (1450W) - Phủ Men Ceramic Chống Dính Siêu Bền - Hàng Chính Hãng",699000,999000,300000,30
TIKI,dien-gia-dung,146097554,"Combo 3 lõi lọc nước Karofi 1,2,3 dùng cho máy S-S038 - Hàng chính hãng",176000,176000,0,0
TIKI,dien-gia-dung,189702459,"Bộ chổi lăn thay thế Máy hút bụi lau sàn khô và ướt Roborock Dyad - Hàng chính hãng",590000,590000,0,0
TIKI,dien-gia-dung,74261828,"Máy Pha Cà Phê Espresso Zamboo ZB-68CF (3.5Bar) - Hàng Chính Hãng",950000,950000,0,0
TIKI,dien-gia-dung,168972477,"Bình đun siêu tốc Philips 1.7 lít HD9316/03 - Hàng chính hãng",999000,1249000,250000,20
TIKI,dien-gia-dung,119967922,"Máy hút bụi không dây siêu nhẹ Panasonic MC-SBV01W246 – Hút sạch mọi lúc mọi nơi – Dễ dàng tháo lắp - Tích hợp đèn LED phát hiện bụi - Hàng chính hãng",4489000,4489000,0,0
TIKI,dien-gia-dung,185495919,"Nồi cơm điện Sunhouse SHD8305 3L - Hàng chính hãng",920000,1580000,660000,42
TIKI,dien-gia-dung,495733,"Quạt Sạc Kiêm Đèn Sạc Kentom KT9100- Hãng chính hãng",695000,695000,0,0
TIKI,dien-gia-dung,188513963,"Linh kiện máy xay sinh tố công nghiệp của Osako Os-1800 1800W-hàng chính hãng",99000,99000,0,0
TIKI,dien-gia-dung,126863127,"Lõi Lọc PPCF Pureit Lavita Nóng Thông Minh (DIY) - Hàng Chính Hãng",455900,470000,14100,3
TIKI,dien-gia-dung,204069031,"Nồi Áp Suất Điện Đa Năng OLIVO PC60 [Hàng Chính Hãng] 16 Chức Năng - Dung Tích 6L - Công Suất 1000W - Thương Hiệu Mỹ",2590000,2590000,0,0
TIKI,dien-gia-dung,115324059,"Máy Xay Sinh Tố Cầm Tay YOICE REKKY  (150W - 300ml- loại SẠC PIN ). máy xay sinh tố mini - Hàng Chính Hãng",354000,369000,15000,4
TIKI,dien-gia-dung,449515,"Bếp Hồng Ngoại Cảm Ứng Sunhouse SHD6017 - Hàng chính hãng",870000,897000,27000,3
TIKI,dien-gia-dung,171816262,"Nồi chiên không dầu KIPOR KP-AF657 - 15L - Lò nướng điển tử công nghệ RAPID AIR nhiệt tối đa 230 độ lòng nồi inox 304- Hàng chính hãng",3782000,5549000,1767000,32
TIKI,dien-gia-dung,165345772,"ĐẦU QUẠT TREO SẮT ĐỘNG CƠ 100% ĐỒNG - HÀNG CHÍNH HÃNG 3HT",220000,220000,0,0
TIKI,dien-gia-dung,229806089,"Máy Ép Trái Cây, Máy Ép Chậm Cao Cấp KALITE KL-599 Tiêu Chuẩn Châu Âu , Dung Tích 400 ML Công Suất 400 W - Hàng Chính Hãng",5899000,11499000,5600000,49
TIKI,dien-gia-dung,362105,"Máy Sấy Tóc Panasonic PAST-EH-ND13-V645",430000,469000,39000,8
TIKI,dien-gia-dung,106378953,"Bếp Gas Dương Kính Sunhouse SHB2106 - Hàng Chính Hãng",553000,570000,17000,3
TIKI,dien-gia-dung,110035573,"Chân kệ để máy lọc nước R.O (free size) - Hàng chính hãng",73000,82000,9000,11
TIKI,dien-gia-dung,176762199,"Máy Xay Sinh Tố Công Nghiệp Uniblend UB - 712 ( Hàng Nhập Khẩu)",2399000,2399000,0,0
TIKI,dien-gia-dung,1368631,"Nồi Nấu Cháo Đa Năng BBCooker BS25 (2.5L) - Hàng Chính Hãng",529000,680000,151000,22
TIKI,dien-gia-dung,10071344,"Máy May Điện Tử Brother A80 - Hàng chính hãng",9570000,9590000,20000,0
TIKI,dien-gia-dung,44467818,"Máy sấy tóc Panasonic EH-NE81-K645 - tạo ion dòng Ionity - Công suất 2500W - Hàng chính hãng - Đen",1245000,1414800,169800,12
TIKI,dien-gia-dung,272420836,"Máy Làm Đá Gia Đình CASO IceMaster Ecostyle 3301 Pro/3304 Icemaster Ecostyle - Nhập Khẩu Đức Cao Cấp, Thời Gian Làm Đá 0.5 Kg/Giờ Dung Tích 2.2 Lít Công Suất 90 W - Hàng Nhập Khẩu",4899000,9759000,4860000,50
TIKI,dien-gia-dung,658108,"Quạt Bàn Đảo 3 Tấc Senko BD8860 - Màu Ngẫu Nhiên - Hàng chính hãng",355000,355000,0,0
TIKI,dien-gia-dung,50643212,"Quạt bàn đảo 4 Tấc chuyển hướng điện cao cấp Senko ( Hàng Chính Hãng ) BD1410",491000,491000,0,0
TIKI,dien-gia-dung,110931901,"Cánh Quạt B4 5 Lá Cánh 3HT - Hàng Chính Hãng",20000,20000,0,0
TIKI,dien-gia-dung,680672,"Máy Xay Sinh Tố Electrolux EMB3025 (600ml) - Hàng Chính Hãng",769000,769000,0,0
TIKI,dien-gia-dung,161241984,"Quạt treo Mitsubishi W16-RA CY-GY - Hàng chính hãng",1739000,1739000,0,0
TIKI,dien-gia-dung,184218737,"Bếp hồng ngoại Magic Korea A47 - Hàng chính hãng",1070000,1790000,720000,40
TIKI,dien-gia-dung,52275716,"Bình Lọc Nước Gia Đình Tạo ion Kiềm - Hàng Chính Hãng Nhập Khẩu USA",3985000,3985000,0,0
TIKI,dien-gia-dung,253498875,"Bộ Lọc Thay Thế Pureit Ultima 1 - Hàng Chính Hãng",1212500,1250000,37500,3
TIKI,dien-gia-dung,264014444,"Máy Hút Bụi Lau Sàn Khô Uớt Tineco Floor 3 - Thương Hiệu Mỹ Tự Giặt Giẻ Diệt Khuẩn Lực Hút 12.000 Pa Công Suất 190 W - Hàng Chính Hãng",6999000,13939000,6940000,50
TIKI,dien-gia-dung,181911655,"Máy xay hạt cà phê Espresso Shardor BDCJ015 công suất 150W, dung tích ngăn chứa hạt 275g - Hàng Nhập Khẩu",1903000,1903000,0,0
TIKI,dien-gia-dung,380070,"Quạt Lửng Có Remote Panasonic F307K - Bạc - Hàng Chính Hãng",1899000,1899000,0,0
TIKI,dien-gia-dung,101845731,"Đèn khò gas ECO 20 công suất cao TS2022RN - HÀNG CHÍNH HÃNG NAMILUX (MP)",169000,169000,0,0
TIKI,dien-gia-dung,53035999,"Bình Thủy Điện CASO HW660 2,7 Lít - Nhập Khẩu Chính Hãng Từ Đức",3233000,3299000,66000,2
TIKI,dien-gia-dung,52343801,"Bình Lọc Nước Cầm Tay Tạo ion Kiềm - Hàng Chính Hãng Nhập Khẩu USA",2408000,2408000,0,0
TIKI,dien-gia-dung,71505303,"Phụ kiện robot hút bụi Mi Robot Vacuum-Mop P Side Brush (chổi quét góc) - Hàng chính hãng",190000,190000,0,0
TIKI,dien-gia-dung,8259703,"Quạt Đứng Công Nghiệp 18'' Motor SanKyo B500 (54W)",466000,700000,234000,33
TIKI,dien-gia-dung,103914497,"Combo 3 lõi lọc thô 123 + 1 màng RO Karofi - Hàng chính hãng",459000,483000,24000,5
TIKI,dien-gia-dung,111686760,"Tông đơ cắt tóc Enchen Boost tặng kèm áo choàng và kéo tạo kiểu tóc chuyên nghiệp như salon phiên bản 2021",299000,299000,0,0
TIKI,dien-gia-dung,267339636,"Máy Xay Thịt, Máy Xay Thực Phẩm BEAR QSJ-B02Q1 Xay Cực Êm Dung Tích 2 Lít Công Suất 300 W - Hàng Chính Hãng",559000,919000,360000,39
TIKI,dien-gia-dung,179939630,"Cây nước nóng lạnh FUJIHOME WD531C, làm lạnh Block cao cấp, khóa vòi nóng an toàn, tự động ngắt an toàn tiết kiệm điện - Hàng Chính hãng",2180000,2599000,419000,16
TIKI,dien-gia-dung,117327266,"Nồi cơm điện Cuckoo 1.08L CR-0631F - Hàng chính hãng",2290000,2989000,699000,23
TIKI,dien-gia-dung,75558085,"Máy hút bụi khô và ướt HiClean HC30 NEW (30L) - Hàng chính hãng",2600000,3100000,500000,16
TIKI,dien-gia-dung,161960188,"Màng lọc bụi bằng xốp sử dụng cho máy hút bụi - Hàng chính hãng",120000,120000,0,0
TIKI,dien-gia-dung,184308196,"Nồi cơm điện tử 3L Nineshield KB-1002 - Hàng chính hãng",1109000,1700000,591000,35
TIKI,dien-gia-dung,126943293,"Nồi Cơm Điện SHARP KS-1800Q (1.8L) - Hàng nhập khẩu Thái Lan",1050000,1050000,0,0
TIKI,dien-gia-dung,73124820,"Nồi Kho Cá Thịt,Nấu Chậm,Nấu Cháo ,Chưng Yến 1.5L Fujika KC15 Màu Vàng-Hàng chính hãng",164000,169000,5000,3
TIKI,dien-gia-dung,58690213,"Lưỡi cạo râu thay thế cho máy cạo râu Xiaomi Mijia Electric Shaver S500 , S500C, S300 - Hàng Chính Hãng",359000,359000,0,0
TIKI,dien-gia-dung,155142298,"Nồi cơm điện tử Elmich RCE-1789 - 1.2 lít - Hàng chính hãng",1348000,1790000,442000,25
TIKI,dien-gia-dung,56946211,"Miếng lọc bụi Hepa 13 VC 3 - Hàng chính hãng",326000,373091,47091,13
TIKI,dien-gia-dung,193888006,"Bàn ủi hơi nước Philips GC1740/20 - Hàng chính hãng",589000,699000,110000,16
TIKI,dien-gia-dung,42252702,"Bộ 2 nối nhanh thẳng 2 đầu dây – Hàng chính hãng",15000,24000,9000,38
TIKI,dien-gia-dung,658097,"Quạt Đứng Ống Nhựa Senko L1338 - Màu ngẫu nhiên - Hàng chính hãng ",367000,367000,0,0
TIKI,dien-gia-dung,73850638," Bếp Điện Từ Đơn 2000W FUJIKA FJ-BT1920 Kèm Nồi Lẩu Inox Điều Khiển Cảm Ứng Mặt Kính Cao Cấp-Hàng Chính Hãng ",615000,615000,0,0
TIKI,dien-gia-dung,89066183,"Máy xanh sinh tố Lock&Lock High Speed Blender EJM376BLK, 220-240V, 50/60Hz, 600W (Đen) - Hàng chính hãng",766000,1400000,634000,45
TIKI,dien-gia-dung,171811946,"Nồi cơm điện KIPOR KP-N1512 - 1.2L - Lớp chống dính TEFLON 5 lớp lòng nồi dầy 3mm nặng 690G toả nhiệt đều cho 2-3 người ăn - Hàng chính hãng",685000,1149000,464000,40
TIKI,dien-gia-dung,174162747,"Bình Đun Siêu Tốc PHILIPS HD9339, 1.7 Lít, Bình Thủy Tinh - Hàng Chính Hãng",1049000,1099000,50000,5
TIKI,dien-gia-dung,46799657,"Nồi chiên không dầu điện tử Mishio MK165 5.5L – Màu",594000,799000,205000,26
TIKI,dien-gia-dung,194140444,"Bếp Từ Đơn Elmich Smartcook ICS-3873 (Công Suất 2100W, Điều Khiển Cảm Ứng, Mặt Kính Ceramic Cường Lực, Chống Sốc Nhiệt) - Hàng Chính Hãng",1329000,1329000,0,0
TIKI,dien-gia-dung,250742999,"Máy Xay Thực Phẩm Xay Ăn Dặm BEAR Xay Cực Êm An Toàn Vệ Sinh 0.3L Công Suất 120 W  - Hàng Chính Hãng",559000,959000,400000,42
TIKI,dien-gia-dung,13524712,"Quạt sàn Tiross TS957 - Hàng chính hãng",1450000,1590000,140000,9
TIKI,dien-gia-dung,173967857,"Robot Hút Bụi Ecovacs Deebot N8 Thông Minh Công Nghệ Quét Laser Thiết Lập Bản Đồ TrueMapping , Lực Hút Lớn Lên Tới 2300pa - Hàng Chính Hãng",5790000,10900000,5110000,47
TIKI,dien-gia-dung,52067128,"Quạt đứng Senko có đèn DD1602 hàng chính hãng màu sắc ngẫu nhiên ",542000,542000,0,0
TIKI,dien-gia-dung,96609323,"MÁY LỌC NƯỚC NÓNG LẠNH KAROFI KAD-D50 - hàng chính hãng ",8085000,10780000,2695000,25
TIKI,dien-gia-dung,58616803,"Quạt Treo Remote ASIA L16019 - Hàng Chính Hãng - Màu Ngẫu Nhiên",780000,780000,0,0
TIKI,dien-gia-dung,137826470,"Bình thủy tinh thay thế cho máy đun và hâm nước điện tử Fatz Baby Fb3505SL - Hàng Chính Hãng",366000,366000,0,0
TIKI,dien-gia-dung,70528167,"Quạt Treo Tường Điều Khiển 18 inch Hatari HF-W18R1 - Màu Ngẫu Nhiên - Hàng Chính Hãng",1480000,1480000,0,0
TIKI,dien-gia-dung,206488252,"Nồi Lẩu Điện Comet CM7731 - Hàng Chính Hãng",579000,659000,80000,12
TIKI,dien-gia-dung,184697582,"Máy ép chậm trục ngang Promix SJ-02 - 150W - Hàng chính hãng",2449000,2449000,0,0
TIKI,dien-gia-dung,194585430,"Lõi số 4 Màng RO 100GPD Hàn Quốc - Hàng Chính Hãng",426000,636000,210000,33
TIKI,dien-gia-dung,42694944,"Tông Đơ Cắt Tóc Trẻ Em G5 TẶNG Áo Choàng Cắt Tóc",257000,275000,18000,7
TIKI,dien-gia-dung,22407312,"MÁY CẠO RÂU MINI MIJIA MSX201 - HÀNG NHẬP KHẨU",369000,369000,0,0
TIKI,dien-gia-dung,179074046,"Bình đun siêu tốc Hafele HS-K1703X 1.7L (535.43.733) (Hàng chính hãng)",569000,830000,261000,31
TIKI,dien-gia-dung,179059960,"Máy xay sinh tố Nutribullet NB-201 - Hàng Chính Hãng",2150000,2230000,80000,4
TIKI,dien-gia-dung,43867482,"Máy ép trái cây Braun J700 - hàng nhập khẩu",4249000,4249000,0,0
TIKI,dien-gia-dung,143492954,"Combo Máy Lọc Không Khí U ULTTY SKJ CR021 Dạng Quạt Màu Đen + Màng lọc HEPA H13 Nano Phân Tử Bạc - Hàng Chính Hãng",5050000,6250000,1200000,19
TIKI,dien-gia-dung,273897719,"THAN HOẠT TÍNH, LƯỚI LỌC DẦU MỠ MÁY HÚT MÙI ELECTROLUX EFT6510/9510/6520/9520 – HÀNG CHÍNH HÃNG",399000,399000,0,0
TIKI,dien-gia-dung,48838150,"Nồi cơm điện tử Panasonic SR-CL108WRA 1 lít - Hàng chính hãng",1950000,1950000,0,0
TIKI,dien-gia-dung,12765442,"Bộ kiềng bếp gas đa năng, sử dụng cho tất cả các dòng bếp gas mặt inox phổ thông - Hàng chính hãng",89000,89000,0,0
TIKI,dien-gia-dung,195919420,"Bếp Ga Mini Maxsun MS-3800 - Công Suất 2900W Kiềng Bếp Phủ Sứ Cao Cấp Bảo Hiểm Chống Nổ Hàng Chính Hãng",349000,399000,50000,13
TIKI,dien-gia-dung,86012217,"Combo bếp gas khè công nghiệp WinDo. tặng van dây - Hàng chính hãng",659000,659000,0,0
TIKI,dien-gia-dung,182830449,"Máy Nướng Bánh Mì Đa Năng Cầm Tay Chống Dính Tuyệt Đối, Máy Kẹp Nướng Bánh Siêu Nhanh, Chiên Trứng, Nướng Thịt 2 Mặt Mini Thế Hệ Mới Máy Nướng Bánh Mì Sandwich Bánh Kẹp Đa Năng Dễ Sử Dụng, Rán Trứng, Rán Thịt Chống Dính Tuyệt Đối - Hàng chính hãng",450000,450000,0,0
TIKI,dien-gia-dung,59050980,"Bộ 2 tông đơ cắt tóc KemeI-1997 và chấn viền Kemei-1949 chuyên nghiệp không dây toàn thân là hợp kim nhôm cao cấp",863000,950000,87000,9
TIKI,dien-gia-dung,192897417,"Vỏ tủ cường lực máy lọc nước phù hợp tất cả các dòng máy lọc nước trên thị trường - Hàng Chính Hãng - TỦ CƯỜNG LỰC ĐEN",1138000,1650000,512000,31
TIKI,dien-gia-dung,7177821,"Lõi Lọc Nước Sunhouse Số 1 SHRLL1 - Hàng chính hãng",46500,46500,0,0
TIKI,dien-gia-dung,161908894,"Nồi chiên không dầu Kalite KL 1500, dung tích 15L, công suất 1700W, dải nhiệt 40-200 độ, bộ phụ kiện xiên quay, giỏ lồng quay đa dạng, setup sẵn 10 chức năng nấu, hàng chính hãng",5780000,5780000,0,0
TIKI,dien-gia-dung,21129035,"Nồi Nấu Cháo Đa Năng BBCooker BS25 (2.5L) - Hàng nhập khẩu",569000,569000,0,0
TIKI,dien-gia-dung,81377624,"Pin thay thế Phụ kiện Robot hút bụi lau nhà Liectroux C30B Hàng chính hãng",850000,850000,0,0
TIKI,dien-gia-dung,189702113,"Bộ lọc HEPA thay thế cho Máy hút bụi lau sàn khô và ướt Roborock Dyad - Hàng chính hãng",390000,390000,0,0
TIKI,dien-gia-dung,184469028,"Cửa thông gió NHỰA CN cặp đôi, gắn cửa - DECOR 455*91T-2 - Hàng Nhập Khẩu",240000,240000,0,0
TIKI,dien-gia-dung,48928996,"18V MÁY HÚT BỤI DÙNG PIN BLACK & DECKER PV1820LF-B1 - HÀNG CHÍNH HÃNG",1999000,1999000,0,0
TIKI,dien-gia-dung,143378994,"Con Lăn Bàn Chải Thay Thế Cho Máy Hút Bụi Lau Nhà Tineco",333000,592000,259000,44
TIKI,dien-gia-dung,510070,"Máy Nướng Bánh Mì Electrolux ETS3505 - Đen - Hàng chính hãng",819000,890000,71000,8
TIKI,dien-gia-dung,7285805,"Nồi Cơm Điện Cao Tần Kangaroo KG599N (1.8L) - Hàng chính hãng",2010000,3500000,1490000,43
TIKI,dien-gia-dung,44580609,"CHỤP THÔNG HƠI  VENT CAP FLAT INOX",162000,162000,0,0
TIKI,dien-gia-dung,52415387,"Máy Ép Chậm BlueStone SJB-655 (150W) - Hàng chính hãng",1749000,2999000,1250000,42
TIKI,dien-gia-dung,171833753,"Nồi cơm điện KIPOR KP-N6518 - 1.8L - Nồi cơ dung tích lớn 4-6 người ăn, chống dính TEFLON 3mm 1Kg, màu đỏ/vàng đa năng -Hàng chính hãng- Bảo hành tại nhà 12 tháng",988000,1749000,761000,44
TIKI,dien-gia-dung,88999771,"Vòi Máy Lọc Nước RO Karofi SL-D031 - Inox 304 - Hàng chính hãng",175000,180000,5000,3
TIKI,dien-gia-dung,52653885,"Ấm siêu tốc inox Fujika dung tích 4Lit/5Lit, công suất 1500W-Hàng chính hãng",227000,235000,8000,3
TIKI,dien-gia-dung,1919527,"Máy Pha Cà Phê Delonghi EC685.BK (1300W - 1350W) - Hàng Chính Hãng",5500000,5500000,0,0
TIKI,dien-gia-dung,15245304,"Lò Vi Sóng Cơ Sharp R-31A2VN-S (23 Lít) - Hàng chính hãng",1849000,2150000,301000,14
TIKI,dien-gia-dung,58862522,"Nồi Cơm Điện GUGKDD GK-208 Phủ Lớp Chống Dính Whitford Công Suất 900W Dung Tích 2L Cho Gia Đình 5-8 Người-Hàng Nhập Khẩu",539000,539000,0,0
TIKI,dien-gia-dung,42244179,"Nối thẳng 02 đầu ren ngoài – Hàng chính hãng",22000,25000,3000,12
TIKI,dien-gia-dung,182804987," Cửa gió vuông NHỰA A2323C- Hàng Nhập Khẩu",79000,79000,0,0
TIKI,dien-gia-dung,921983,"Máy Sấy Thực Phẩm - Làm Sữa Chua Tiross TS9682 (250W) - Hàng chính hãng",1330000,1490000,160000,11
TIKI,dien-gia-dung,36225639,"Cửa gió nhựa tròn Décor 150s - Hàng Nhập Khẩu",160000,160000,0,0
TIKI,dien-gia-dung,188189682,"Lõi lọc vòi sen Philips AWP175 (cho AWP1775)",610000,680000,70000,10
TIKI,dien-gia-dung,193111702,"Tông đơ cắt tóc gia đình Kemei KM-1256 cữ lược kèm điều chỉnh 10 mức độ dài sạc USB dùng cắt tóc được cho trẻ em và người lớn",199000,199000,0,0
TIKI,dien-gia-dung,42833505,"Bộ khẩu + khóa cấp nước đầu vào máy lọc nước RO - Hàng chính hãng",58000,79000,21000,27
TIKI,dien-gia-dung,67185862,"Thanh nối dài ống máy hút bụi 30 - 35mm",83000,83000,0,0
TIKI,dien-gia-dung,449214,"Máy Xay Ép Đa Năng Panasonic PAXD-MX-AC400WRA – 1.0 Lít - Hàng chính hãng",2699000,3910000,1211000,31
TIKI,dien-gia-dung,173783141,"Bếp đôi điện từ Sunhouse Mama MMB9302-EC (3600W) - Hàng Chính Hãng",4469000,9990000,5521000,55
TIKI,dien-gia-dung,36232998,"Cửa gió nhựa vuông Decor 205*205s - Hàng nhập khẩu",170000,170000,0,0
TIKI,dien-gia-dung,16085288,"Bếp gas đôi mặt men Namilux NA-681DFM Tặng dây bọc inox Hàng chính hãng",658000,658000,0,0
TIKI,dien-gia-dung,191058860,"Mặt bích nối ống tròn D100 - 10F - Hàng Nhập Khẩu",40000,40000,0,0
TIKI,dien-gia-dung,70520257,"Nồi Chiên Chân Không Hiệu Magic Korea 6L (Không Dùng Dầu) -Hàng Chính Hãng",1290000,1389000,99000,7
TIKI,dien-gia-dung,11385166,"Máy hút khói, khử mùi KAFF KF-TL700 - Hàng chính hãng",2850000,2850000,0,0
TIKI,dien-gia-dung,76149437,"Bộ 2 co, cút nối nhanh ren 13 ra dây 10 hoặc dây 6mm – linh kiện máy lọc nước, phun sương, lắp dàn tưới cây, bể thủy sinh, cá cảnh, bán cạn (Hàng chính hãng)",22000,28000,6000,21
TIKI,dien-gia-dung,77728740,"Máy Xay Thịt Cối Inox 3 Lít Midimori MDMR- 800 (800W) - Tặng Kèm 1 Bộ Lưỡi Dao (4 Lưỡi) Dự Phòng - Hàng Chính Hãng",630000,890000,260000,29
TIKI,dien-gia-dung,193536649,"Bình đun sôi giữ nhiệt morphy richards phiên bản MR6060 cầm tay du lịch, nhỏ gọn, 4 mức nhiệt pha trà, cafe, sữa và nước sôi mọi nơi, hàng chính hãng",998000,998000,0,0
TIKI,dien-gia-dung,1209537,"Bếp Gas Âm Hồng Ngoại Có Pép Hâm Kaff KF-208I - Hàng Chính Hãng",1990000,1990000,0,0
TIKI,dien-gia-dung,106603520,"Bếp nướng gas đa năng Namilux GM2120PS - HÀNG CHÍNH HÃNG NAMILUX (MP)",749000,749000,0,0
TIKI,dien-gia-dung,187604324,"Máy xay cà phê Zamboo ZB-100GR - Hàng chính hãng",539000,539000,0,0
TIKI,dien-gia-dung,158430066,"Bột Vệ Sinh Máy Pha Cà Phê Espresso Cafiza Chính Hãng Urnex Mỹ",235000,235000,0,0
TIKI,dien-gia-dung,131922653,"Combo máy pha cà phê Espresso Zamboo ZB-68CF + máy xay ZB100g - hàng chính hãng",1315000,1315000,0,0
TIKI,dien-gia-dung,127869206,"Máy pha cà phê tự động Espresso Zamboo ZB-99PRO- hàng chính hãng",3390000,4250000,860000,20
TIKI,dien-gia-dung,118135933,"Quạt sàn UNOLD 86756 công suất lớn - Hàng chính hãng",2244000,2290000,46000,2
TIKI,dien-gia-dung,153760819,"MÁY LỌC NƯỚC LOTUS CHÍNH HÃNG TLRP99 KHÔNG VỎ TỦ LẮP GẦM BẾP",2750000,2750000,0,0
TIKI,dien-gia-dung,108940606,"Len Cúc Tần (Mã 01 đến 20)",31100,31100,0,0
TIKI,dien-gia-dung,57441197,"Máy Lọc Nước RO Hydrogen Ion Kiềm Kangaroo KG100EO 7 Lõi - Hàng Chính Hãng",7790000,7790000,0,0
TIKI,dien-gia-dung,152070785,"Bàn là hơi nước 2000w Philips GC1740/20 - Hàng chính hãng",552000,552000,0,0
TIKI,dien-gia-dung,121604006,"Bơm Siro Torani Pump Syrup - Hàng Chính Hãng",79920,79920,0,0
TIKI,dien-gia-dung,25169568,"Nồi Cơm Điện IH Tách Đường Tiross TS9911 (1.5 Lít) - Vàng Kim - Hàng Chính Hãng",4030000,4030000,0,0
TIKI,dien-gia-dung,78473108,"Máy Làm Sữa Hạt BlueStone BLB-6035 (1700W) - Hàng chính hãng",1990000,2999000,1009000,34
TIKI,dien-gia-dung,455597,"Bàn Là Phun Hơi Ohi@Ma HMI-6038 - Màu ngẫu nhiên - Hàng chính hãng",339000,339000,0,0
TIKI,dien-gia-dung,137543950,"Nồi chiên hơi nước kết hợp nướng hấp UNIE Steam US6800 công suất - Hàng chính hãng",1690000,3980000,2290000,58
TIKI,dien-gia-dung,123930203,"Máy chế biến thức ăn chăn nuôi 3A2,2Kw (Động cơ rời) - Băm nhỏ, nghiền nát nhuyễn, nghiền cám - Hàng Chính Hãng",7000000,7000000,0,0
TIKI,dien-gia-dung,190298297,"Máy Lọc Không Khí Tạo Ẩm BONECO H300 Khuếch Tán Xông Tinh Dầu Thơm, Tạo Độ Ẩm Phòng Ngủ, Lọc Bụi, Kháng Vi Khuẩn, Kết Nối Blutooth Điều Khiển Từ Xa - Hàng Chính Hãng",16128000,16800000,672000,4
TIKI,dien-gia-dung,166619530,"Bộ máy sấy và duỗi tóc Philips BHP398/00 - Hàng Chính Hãng",1025000,1302000,277000,21
TIKI,dien-gia-dung,131535902,"Máy vắt cam Sharp EJ-J408-WH - Hàng chính hãng",402000,520000,118000,23
TIKI,dien-gia-dung,155906547,"Máy pha cà phê tự động Melitta CI Touch Plus- Hàng nhập khẩu 100% từ thương hiệu Melitta, Đức",25920000,34560000,8640000,25
TIKI,dien-gia-dung,6970493,"Combo 2 điếu hồng ngoại bếp ga (đen) - Hàng chính hãng",199000,199000,0,0
TIKI,dien-gia-dung,983450,"Bếp Gas Dương Rinnai RV-360GM - Xám - Hàng Chính Hãng",731000,731000,0,0
TIKI,dien-gia-dung,106317461,"Quạt Treo 2 dây Asia Vina L16018 - Hàng Chính Hãng",600000,600000,0,0
TIKI,dien-gia-dung,130331629,"Lebenlang - Máy sấy tóc gấp gọn, 2 chiều nóng lạnh với công suất 2100W, chống xơ rối tóc, model LBH3088P - hàng chính hãng",339000,600000,261000,44
TIKI,dien-gia-dung,95649706,"MÁY ÉP TRÁI CÂY BIOCHEF 888 - hàng nhập khẩu",8888000,8888000,0,0
TIKI,dien-gia-dung,74511538,"BẾP NƯỚNG + NẤU GAS ĐA NĂNG NAMILUX GM2120PS HỒNG NGOẠI - HÀNG CHÍNH HÃNG ( CÓ KÈM KIỀNG ĐỂ CHUYỂN NƯỚNG SANG NẤU - SỬ DỤNG VAN NGẮT GAS AN TOÀN INLINE CUT )",799000,799000,0,0
TIKI,dien-gia-dung,168341806,"Máy nhồi bột trộn bột đánh trứng Unie UE-990 dung tích 6.5L - Hàng chính hãng",3790000,6380000,2590000,41
TIKI,dien-gia-dung,727006,"Máy Sấy Tóc Bổ Sung Ion Âm Tescom NTID45 (1650W)",899000,899000,0,0
TIKI,dien-gia-dung,110347508,"(Hàng chính hãng) Máy hút bụi Perfect có thể tháo rời làm máy hút bụi cầm tay vệ sinh ga giường, ghế, xe hơi, rèm cửa",475000,475000,0,0
TIKI,dien-gia-dung,121263987,"Máy lọc nước UF 5 cấp lọc by Scitech (Không dùng điện, không nước thải) - Hàng chính hãng",1990000,1990000,0,0
TIKI,dien-gia-dung,59407925,"Ấm đun nước siêu tốc Điện Quang ĐQ EKT06 1518 BL (1500W, 1.8L, inox 201, nhựa PP màu đen) - Hàng chính hãng",177316,221600,44284,20
TIKI,dien-gia-dung,78017876,"Lõi lọc UF Philips AWP315 (cho AWP3753) - Hàng chính hãng",629100,699000,69900,10
TIKI,dien-gia-dung,965160,"Nồi Cơm Điện Kim Cương 12R (1.2L) - Hàng Chính Hãng",330000,330000,0,0
TIKI,dien-gia-dung,89646490,"Nồi cơm điện nắp rời 5.6 lít GUGKDD, công suất 2000W, màu ngẫu nhiên-Hàng chính hãng",795000,820000,25000,3
TIKI,dien-gia-dung,44912695,"QUẠT BÀN THAÍ LAN ĐA NĂNG HATARI PS20M1 - Màu ngẫu nhiên - HÀNG CHÍNH HÃNG",485000,500000,15000,3
TIKI,dien-gia-dung,196356893,"Máy lọc không khí nhập khẩu UV diệt khuẩn FUJIHOME AP8026US, 4 cấp bộ lọc bụi mịn PM2.5, điều khiển bằng app, khử mùi loại bỏ vi khuẩn vi rút lông thú cưng, cảm biến hiển thị màu sắc-Hàng Chính hãng",1490000,2350000,860000,37
TIKI,dien-gia-dung,141192125,"Nồi áp suất Gas Goldsun 5 lít PC-GJY50A - Hàng Chính Hãng",539100,629000,89900,14
TIKI,dien-gia-dung,175885517,"Máy Xay Thịt Bluestone CHB-5145, Công Suất 350W, Cối Thủy Tinh 2 Lít, Hàng Chính Hãng",649000,999000,350000,35
TIKI,dien-gia-dung,54653667,"Máy xay bột khô đa năng E500 - Hàng chính hãng",779000,850000,71000,8
TIKI,dien-gia-dung,181779270,"Túi đựng rác dùng cho robot hút bụi ECOVACS DEEBOT OMNI X1 - Hàng Chính Hãng",223200,279000,55800,20
TIKI,dien-gia-dung,89501501,"Bếp gas âm Kanzo KZ-PRO-99 GA Italy Technology - 9 đầu hâm công nghệ mới (Tặng miếng chắn gió) - Hàng chính hãng",2200000,2200000,0,0
TIKI,dien-gia-dung,19824343,"Máy Ép Chậm Thông Minh Kuvings NS-2026BC 240W (400ml) - Hàng Chính Hãng",9599000,13990000,4391000,31
TIKI,dien-gia-dung,82959842,"Máy lọc nước YAMATO công nghệ UF – POST – HYDROGEN – NANO SILVER Korea 7 bước lọc (Hàng chính hãng)",1663000,2500000,837000,33
TIKI,dien-gia-dung,11598063,"Ấm Đun Nước Siêu Tốc Tiross TS1367 (1L) - Hàng chính hãng",559000,790000,231000,29
TIKI,dien-gia-dung,38306523,"Combo lõi lọc Karofi 1, 2, 3, màng RO - Hàng chính hãng",528000,544000,16000,3
TIKI,dien-gia-dung,68593373,"Quạt thông gió âm tường chính hãng Roman- Có màng che ngăn nước mưa mùi quay ngược lại hiệu quả cao RBV25",555000,555000,0,0
TIKI,dien-gia-dung,418008,"Nồi Cơm Điện HappyCook HC-180A - Xanh - Hàng chính hãng",1039000,1039000,0,0
TIKI,dien-gia-dung,177196997,"Máy cạo râu du lịch Mini Enchen traveller chống nước IPX6 Pin sạc siêu bền tiện lợi du lịch",199000,259000,60000,23
TIKI,dien-gia-dung,149145208,"Bếp Hồng Ngoại Đơn Sunhouse SHD6011 - Hàng chính hãng",566000,584000,18000,3
TIKI,dien-gia-dung,115281186,"Bình áp máy lọc nước (Tặng kèm van bình áp) - Hàng chính hãng",400000,400000,0,0
TIKI,dien-gia-dung,122696093,"Nồi Áp Suất Đáy Từ Dùng Mọi Bếp FUJIKA FJ-AG220 (5 lít) - Màu Ngẫu Nhiên - Hàng Chính Hãng",534000,550000,16000,3
TIKI,dien-gia-dung,12886341,"Bộ điếu gang hồng ngoại fi120 có chế độ hâm ( đen ) - Hàng chính hãng",225000,225000,0,0
TIKI,dien-gia-dung,162870013,"Quạt treo tường Kangaroo KG723 (55W) - Hàng chính hãng",491000,990000,499000,50
TIKI,dien-gia-dung,83751594,"Máy sấy tóc nội địa hàn quốc siêu nhanh khô dùng trong khách sạn gia đình du lịch",468000,468000,0,0
TIKI,dien-gia-dung,147352662,"Bình Đun Thủy Tinh PHILIPS HD9339/80 1.7lít - Hàng Chính Hãng",1294800,1294800,0,0
TIKI,dien-gia-dung,82908072,"Quạt đứng thân sắt SENKO DTS1609 - Hàng chính hãng",491000,491000,0,0
TIKI,dien-gia-dung,98059195," Bếp ga đơn dùng cho hầm khí sinh học biogas",195000,195000,0,0
TIKI,dien-gia-dung,114691250,"Lõi Lọc Nước Số 3 Kanzo – PP1 Micron- Hàng Chính Hãng",80000,80000,0,0
TIKI,dien-gia-dung,186254352,"Nồi Cơm Điện Kim Cương 2.2 Lít Nắp Rời - Hàng Chính Hãng",484000,484000,0,0
TIKI,dien-gia-dung,73892643,"Máy uốn tóc chuyên nghiệp Kemei KM-1010 có mức điều chỉnh nhiệt độ dùng để uốn cong, uốn xoăn, uốn phồng chân tóc tiện lợi",274000,299000,25000,8
TIKI,dien-gia-dung,647180,"Bình Đun Siêu Tốc Tiger PFY-A10W (1 lít) - Màu Trắng - Hàng chính hãng",1499000,2550000,1051000,41
TIKI,dien-gia-dung,115266172,"COMBO 3 LÕI LỌC NƯỚC PP 10" 5 MICRO - HÀNG CHÍNH HÃNG ",110000,110000,0,0
TIKI,dien-gia-dung,184910157,"Bàn là hơi nước HiTECH ASB16 phiên bản đa năng 4 in 1, công suất mạnh mẽ 1600W, 3 cấp độ phun đáp ứng đa dạng vải, thiết kế gấp gọn siêu tiện lợi, hàng chính hãng",745000,745000,0,0
TIKI,dien-gia-dung,362117,"Máy Sấy Tạo Kiểu Panasonic PAST-EH-KA71-W645 - Hàng Chính Hãng",1070000,1199000,129000,11
TIKI,dien-gia-dung,91928709," Lõi lọc Sediment Kori Home - Hàng chính hãng",100000,176000,76000,43
TIKI,dien-gia-dung,152786275,"Quạt Đứng Mitsubishi LV16-RA SF-GY - Xám Nhạt - Hàng Chính Hãng",2090000,3000000,910000,30
TIKI,dien-gia-dung,173393361,"Máy Ép chậm, máy ép trái cây Mitomo EC-55 hàng chính hãng",979000,1599000,620000,39
TIKI,dien-gia-dung,176059635,"2 Đôi Pin Đại Panasonic Không chảy nước dùng cho bếp gas , đồng hồ , đài radio ... - Hàng chính hãng",55000,55000,0,0
TIKI,dien-gia-dung,174145982,"Máy xay sinh tố Kalite KEB 4171 công suất xay 1000W lưỡi dao thép không gỉ, 2 cối xay tiện dụng được làm bằng thủy tinh và inox 304, hàng chính hãng",2365000,2365000,0,0
TIKI,dien-gia-dung,17478766,"Quạt Lỡ Senko thân Inox Hàng Chính Hãng - LTS106A",462000,462000,0,0
TIKI,dien-gia-dung,56714558,"Nồi chiên không dầu Lock&Lock Inverter  EJF586BLK 6.5L - Hàng chính hãng",2790000,4725000,1935000,41
TIKI,dien-gia-dung,139301836,"Bàn Ủi Hơi Nước Cầm Tay Dạng Đứng Để Bàn Mini Thông Minh Kalpen HSK - 3801, Nhập Khẩu Chính Hãng",530000,530000,0,0
TIKI,dien-gia-dung,56603117,"Máy Đánh Trứng Panasonic MK-GH3WRA (175W) - Hàng Chính Hãng",899000,899000,0,0
TIKI,dien-gia-dung,85559719,"Máy Uấn Và Duỗi Thẳng Tóc ION Âm Dưỡng Ẩm Cho Tóc, Giúp Tóc Thẳng, Bóng Mượt Và Khỏe Mạnh, Bản Đặc Biệt K-SKIN KD380A - Hàng Chính Hãng",420000,420000,0,0
TIKI,dien-gia-dung,88206667,"Máy Sấy Tóc Philips BHD300/10 - Công Suất 1600W, 3 Chế Độ Sấy - Hàng Chính Hãng",569000,569000,0,0
TIKI,dien-gia-dung,163245285,"Máy Cạo Râu Nam Mini Nhỏ Gọn, Cạo Khô Ướt Không Trầy Xước - HÀNG CHÍNH HÃNG",109000,109000,0,0
TIKI,dien-gia-dung,111518,"Máy Sấy Tóc Tiross TS429",199000,230000,31000,13
TIKI,dien-gia-dung,3082315,"Bình Thủy Điện Khaluck KL-955 - Hàng Chính Hãng",845000,845000,0,0
TIKI,dien-gia-dung,11446529,"Quạt bàn đảo 4 Tấc chuyển hướng điện cao cấp Senko ( Hàng Chính Hãng ) BD850",491000,491000,0,0
TIKI,dien-gia-dung,140970993,"Dung dịch lọc cặn máy pha cà phê Melitta Anti Calc Bio Liquid Descaler Multi Usage 250ml - Hàng nhập khẩu từ Đức",396000,396000,0,0
TIKI,dien-gia-dung,126863140,"Lõi Lọc RO Pureit Lavita Nóng Thông Minh (DIY) - Hàng Chính Hãng",1261000,1300000,39000,3
TIKI,dien-gia-dung,474821,"Quạt Đứng Panasonic F-409KBE - BEIGE - Hàng Chính Hãng",2715000,4000000,1285000,32
TIKI,dien-gia-dung,556669,"Nồi Cơm Điện Nắp Gài Tiger JNP-1800 - 1.8L (Đồng) - Hàng chính hãng",2490000,2490000,0,0
TIKI,dien-gia-dung,76213467,"Máy Nướng Bánh Mì Lock&Lock EJB222BLK 850W Màu đen - hàng chính hãng",599000,1000000,401000,40
TIKI,dien-gia-dung,249920523,"Robot Hút Bụi Lau Nhà Xiaomi Vaccum Mop E10 - Bản 2023 Công Nghệ Dẫn Đường LDS Laser Làm Sạch Sát Tường Có Cảm Biến Chống Rơi Chống Va Đập Điều Khiển Giọng Nói Và Kết Nối App Diện Tích Hoạt Động 150m2 Lực Hút 4000 Pa- Hàng Chính Hãng",4199000,8199000,4000000,49
TIKI,dien-gia-dung,11477695,"Quạt treo 2 dây Senko ( Hàng Chính Hãng ) TC16",377000,377000,0,0
TIKI,dien-gia-dung,11259207,"Ấm Sắc Thuốc Gốm Bát Tràng Fujika FJ-CK33K5 (3.3L) - Hàng chính hãng",341000,341000,0,0
TIKI,dien-gia-dung,119398141,"Máy Hút Bụi Công Nghiệp Khô - Nước CleproX X1/40 - Hàng Chính Hãng",2299000,2299000,0,0
TIKI,dien-gia-dung,58532708,"Hộp khăn lau Ecovacs Deebot Ozmo Slim 11 - Hàng Chính Hãng",120000,120000,0,0
TIKI,dien-gia-dung,26484002,"Nồi Cơm Điện Happytime Sunhouse HTD-8172 (1.2L) - Hàng Chính Hãng",475000,475000,0,0
TIKI,dien-gia-dung,24364149,"Sưởi Điện 3 Bóng Halogen Sunhouse Shd7016 (1000W) - Đỏ Đen - Hàng Chính Hãng",476000,490912,14912,3
TIKI,dien-gia-dung,153501391,"Máy sấy tóc Bluestone HDB-1871, Công Suất 2300W, Hàng Chính Hãng",649000,999000,350000,35
TIKI,dien-gia-dung,58213024,"Bếp Nướng Điện mặt bếp tháo rời Fujika EG3620 Công Suất 2000W, 5 mức chỉnh nhiệt-Hàng chính hãng",672000,672000,0,0
TIKI,dien-gia-dung,55638683,"Combo 2 bộ lõi lọc 1,2,3 Kangaroo - Chính hãng",320000,330000,10000,3
TIKI,dien-gia-dung,117076918,"Máy ép trái cây BioChef 666 Hàng nhập khẩu - Tặng Cân nhà bếp Beurer KS19",6488000,6488000,0,0
TIKI,dien-gia-dung,55237721,"Máy hàn miệng túi đa năng HS20, dùng được cho mọi loại túi, phù hợp nhu cầu gia đình, hộ kinh doanh. Hàng chính hãng SGE Thailand.",310000,320000,10000,3
TIKI,dien-gia-dung,404030,"Nồi Cơm Nắp Rời Sharp KSH-D40V (3.8L) - Màu Ngẫu Nhiên - Hàng chính hãng",1249000,1249000,0,0
TIKI,dien-gia-dung,192164545,"Máy Sấy Tóc Đa Năng Tạo Kiểu Tóc Teement, Sấy Khô, Duỗi Thẳng, Uốn Cụp, Công Suất Lớn 1000W, Giảm Tiếng Ồn, An Toàn Khi Sử Dụng, Tạo Kiểu Chuyên Nghiệp, Bổ Sung Ion Dưỡng Ẩm, Làm Mềm Mượt Tóc, Chống Hư Tổn Tóc - Hàng Chính Hãng",240000,240000,0,0
TIKI,dien-gia-dung,13822750,"Lõi Số 2 - G.A.C cacbon Kangaroo K29 - Hàng chính hãng",82000,85000,3000,4
TIKI,dien-gia-dung,55931424,"Cửa kỹ thuật NHỰA có tay nắm 300х400 - LT3040P - Hàng nhập khẩu",240000,240000,0,0
TIKI,dien-gia-dung,50739688,"Bình Đun Nước Siêu Tốc Elmich Smartcook KES-3863 (1.2L) - Hàng Chính Hãng",429000,429000,0,0
TIKI,dien-gia-dung,66118397,"Combo 50 Núm Vặt Lông Gà Vịt NEWSUN, Núm Cao Su Mềm Dẻo - Hàng Chính Hãng",370000,370000,0,0
TIKI,dien-gia-dung,186522968,"Len cotton cầu vồng Flowers - Nhập khẩu từ chính hãng Yarnart - 250gram dài 1000m (Bảng màu từ 301-320)",250000,250000,0,0
TIKI,dien-gia-dung,184903613,"Bếp điện từ CREEN CR-CB11VN-GR-210 Công suất 2000W - Hàng chính hãng",1050000,1050000,0,0
TIKI,dien-gia-dung,59126207,"Tông Đơ Cắt Tóc Không Dây Enchen Boost",189000,215000,26000,12
TIKI,dien-gia-dung,182804324,"	 Cửa gió vuông NHỰA A1919C- Hàng Nhập Khẩu",50000,50000,0,0
TIKI,dien-gia-dung,164283605,"Điều Khiển Máy Dyson TP04 DP04 TP06 TP07 TP09 Remote Control - Hàng chính hãng",1550000,1550000,0,0
TIKI,dien-gia-dung,175549769,"Vỏ tủ cường lực máy lọc nước Nano Geyser - Hàng Chính Hãng",1132000,1500000,368000,25
TIKI,dien-gia-dung,80014659,"Lõi Lọc HEPA, Than Hoạt Tính Dành Cho Máy Lọc Không Khí Đa Năng AP - Máy Lọc Không Khí Cho Ô Tô/Xe Hơi - Hàng Nhập Khẩu",199000,199000,0,0
TIKI,dien-gia-dung,11592952,"Kẹp Nướng Điện Đa Năng Tiross TS9654 - Hàng chính hãng",1560000,1750000,190000,11
TIKI,dien-gia-dung,98059160,"2 khay inox bếp gas mặt kính",50000,50000,0,0
TIKI,dien-gia-dung,21404392,"Quạt Đứng Panasonic F-307KHB -Hàng Chính Hãng",1890000,1890000,0,0
TIKI,dien-gia-dung,120298327,"(CODOS CHC 970) Tông đơ cắt tóc cao cấp - Điều chỉnh 4 cấp độ thông minh",969000,1300000,331000,25
TIKI,dien-gia-dung,658100,"Quạt Đứng Thân Sắt Senko DTS107 - Hàng Chính Hãng",491000,491000,0,0
TIKI,dien-gia-dung,184947617,"Linh kiện quạt - mâm quạt đứng thay thế cho quạt- DTS1607 Senko Hàng chính hãng",105000,105000,0,0
TIKI,dien-gia-dung,122219419,"Vỉ nướng điện Bluestone EGB-7417- Hàng chính hãng",1350000,1350000,0,0
TIKI,dien-gia-dung,184886533,"Máy cạo râu Panasonic ES-SL10-K401 - Hàng chính hãng",969000,1169000,200000,17
TIKI,dien-gia-dung,130744689,"Combo 9 lõi lọc nước Korihome chính hãng cho máy lọc nước Korihome WPK-915,  WPK-910 nhập khẩu Hàn Quốc",1808000,3101000,1293000,42
TIKI,dien-gia-dung,186277470,"Nồi Chiên Hấp Hơi Nước Elmich AFE-3944 (20 Lít) - Hàng Chính Hãng",6239000,8690000,2451000,28
TIKI,dien-gia-dung,21583187,"Nồi Lẩu Điện Tiger Queen SQ-C330 (4.0 Lít) - Nâu - Hàng Chính Hãng",1799000,2490000,691000,28
TIKI,dien-gia-dung,193314885,"Máy Tạo Ẩm Thụy Sỹ BONECO U250 Công Nghệ Ultrasonic Phun Sương Nano Tạo Độ Ẩm Không Khí, Xông Tinh Dầu Thơm Phòng, Bộ Lọc Nước Khử Khuẩn- Hàng Chính Hãng",7100000,7100000,0,0
TIKI,dien-gia-dung,185810345,"Lõi Lọc Bụi Hepa Dành Cho Máy Hút Bụi Cầm Tay Không Dây UNIQ Free A7 - Hàng chính hãng",120000,120000,0,0
TIKI,dien-gia-dung,72900608,"Vòi máy lọc nước R.O, NANO, UF nối nhanh SUS 304 - tặng kèm nối dây 6-6mm",191000,280000,89000,32
TIKI,dien-gia-dung,67344085,"Nồi Chiên Không Dầu Perfect PF-D92 (5 Lít) - Hàng Chính Hãng",1225000,1225000,0,0
TIKI,dien-gia-dung,978204,"Máy Pha Cà Phê Nuova Simonelli Nhập khẩu Ý Oscar II - Hàng chính hãng",28080000,28080000,0,0
TIKI,dien-gia-dung,55998254,"Combo 5 lõi lọc 5,6,7,8,9 Kangaroo - hàng chính hãng Kangaroo",1698000,1750000,52000,3
TIKI,dien-gia-dung,101580994,"Y Chia Bình Gas 2 bếp ",85000,85000,0,0
TIKI,dien-gia-dung,194041794,"Đầu hút bảng lớn Stanley 19-2300 phụ kiện máy hút bụi Stanley có model SL19117, SL19417-8A, SL19199P, SL19156, SL19403PE-8A; Dewalt: DXV15T, DXV23P, DXV25S, DXV30S, DXV34P và DXV38S- Hàng chính hãng",407000,420000,13000,3
TIKI,dien-gia-dung,174627584,"Quạt sạc tích điện SUNHOUSE SH7116, quạt mini để bàn kiêm đèn ngủ, 3 mức gió siêu mát - Hàng chính hãng",1050000,1050000,0,0
TIKI,dien-gia-dung,91547428,"robot hút bụi lau nhà Ecovacs Deebot T9 - Lực hút Max 3000Pa -Làm thơm không khí - Hàng Chính Hãng -  Bảo Hành 18 tháng",8290000,16990000,8700000,51
TIKI,dien-gia-dung,1826509,"Nồi Cơm Điện Nắp Gài Sharp KS-19TJVBC (1.8L) - Hàng Chính Hãng",629000,720000,91000,13
TIKI,dien-gia-dung,118085725,"Đèn UV di động khử trùng phòng, khử mùi hôi Rama UV60W - Hàng Chính Hãng",3099000,3099000,0,0
TIKI,dien-gia-dung,180365637,"Bình đun siêu tốc và hâm nước Bear TNQ-D12W7 - Hàng chính hãng",849000,1490000,641000,43
TIKI,dien-gia-dung,189593058,"Máy sấy tóc Weilaiya -  tốc độ cao sấy nhanh khô, nhiệt độ thông minh đảm bảo độ bóng ẩm của tóc",195000,199000,4000,2
TIKI,dien-gia-dung,73922993,"Nồi Nấu Cháo Tự Động BBCooker 2.5L - Hàng Chính Hãng",499000,499000,0,0
TIKI,dien-gia-dung,11509103,"Máy xay thịt đa năng Mishio MK-135 1,8L - Hàng chính hãng",699000,699000,0,0
TIKI,dien-gia-dung,181806616,"Máy Ép Trái Cây, Máy Ép Chậm Mini KALITE KSJ4414 Tiêu Chuẩn Châu Âu Dung Tích 400 ML Công Suất 200 W - Hàng Chính Hãng",2204000,4489000,2285000,51
TIKI,dien-gia-dung,190543562,"Bình đun siêu tốc Xiaomi Mi Smart Kettle Pro BHR4198GL MJHWSH02YM - Hàng chính hãng",1299000,1499000,200000,13
TIKI,dien-gia-dung,116393840,"Combo 10 lõi lọc PP 10 inch 5 micron - Lõi số 1 máy lọc nước Nano/UF/RO, bộ lọc thô - Hàng chính hãng",250000,250000,0,0
TIKI,dien-gia-dung,112047349,"Vòi máy lọc nước cao cấp - Vòi đơn hoặc vòi đôi, vòi tay gạt hoặc vòi tay vặn - Hàng chính hãng",150000,150000,0,0
TIKI,dien-gia-dung,196200866,"Robot Hút Bụi Lau Nhà Xiaomi Vacuum X20 Plus - Kết Nối App Tự Giặt Giấy Giẻ Gom Rác Tự Động Bản Đồ 3D Lưu 4 Bản Đồ Lực Hút 6000Pa - Hàng Chính Hãng",13915000,27999000,14084000,50
TIKI,dien-gia-dung,151748552,"Lõi lọc nước KONKA, lõi lọc thay thế cho bộ lọc nước tại vòi KONKA KPW-LT01",112000,150000,38000,25
TIKI,dien-gia-dung,1919529,"Máy Pha Cà Phê Delonghi EC685.M - Hàng Chính Hãng",5200000,5200000,0,0
TIKI,dien-gia-dung,686820,"Siêu Sắc Thuốc Gali GL-1800 (3.3 lít) - Xanh Dương - Hàng Chính Hãng",599000,599000,0,0
TIKI,dien-gia-dung,2581851,"Đèn Khò Gas Namilux NA-187 - Hàng Chính Hãng",239000,239000,0,0
TIKI,dien-gia-dung,973078,"Quạt Hút Thông Gió Senko H100 (25W) - Trắng - Hàng Chính Hãng",189000,189000,0,0
TIKI,dien-gia-dung,138654386,"Quạt sưởi đối lưu Mini nhập khẩu Fujihome FH-001 không phát sáng, không đốt oxi - Hàng chính hãng ",550000,550000,0,0
TIKI,dien-gia-dung,10681299,"Máy Đánh Bột Ariete MOD 1588/05 (5.5 lít) - Hàng chính hãng",2645000,2699000,54000,2
TIKI,dien-gia-dung,57691817,"Máy Xay Sinh Tố Công Nghiệp Osako OS-1800 Đa Năng Công Suất Lớn 1800W Bộ 6 Lưỡi Dao Xay Tất Cả Các Loại Thực Phẩm",1850000,1850000,0,0
TIKI,dien-gia-dung,368529,"Bình Thủy Điện Sharp KP-20BTV 1.7L - Hàng chính hãng",1149000,1350000,201000,15
TIKI,dien-gia-dung,79245583,"Máy lọc nước tại vòi iAquao,lõi lọc nước UF Mitsubishi, bộ lọc nước không dùng điện, không nước thải, lọc nước giữ khoáng chất. Hàng Chính Hãng AquaHandy ",6250000,6250000,0,0
TIKI,dien-gia-dung,57814750,"Bộ Lọc Hepa Cho Máy Hút Bụi Cầm Tay Derrma CM800 / CM900 - Hàng Chính Hãng",60000,63500,3500,6
TIKI,dien-gia-dung,175451638,"Tông đơ chấn viền Kemei KM-5017H thiết kế độc đáo, sử dụng sạc USB tiện lợi có thể cắt tóc, cạo râu, cạo đầu fade tóc... Hàng chính hãng",449000,449000,0,0
TIKI,dien-gia-dung,258668275,"Hệ màng lọc ULTTY HEPA H13 dùng cho Quạt lọc không khí CR021 - Hàng chính hãng",600000,650000,50000,8
TIKI,dien-gia-dung,90107406,"Phụ kiện Robot Hút Bụi Chổi Trụ Xiaomi Vacuum - Mop ESSENTIAL BRUSH (BHR4247TY) - Hàng chính hãng",190000,190000,0,0
TIKI,dien-gia-dung,167932850,"Máy sấy hoa quả, thực phẩm Biolomix BD-1200E có 5 tầng khay không chứa BPA – Công suất: 400W - HÀNG NHẬP KHẨU",1620000,1620000,0,0
TIKI,dien-gia-dung,161408911,"Bếp Điện 3 Vùng Nấu HAFELE HC-R603D 536.01.901 - Mặt Kính Schott Ceran - Hàng Chính Hãng",16160000,16160000,0,0
TIKI,dien-gia-dung,86515288,"Máy Lọc Không Khí Ion Âm VinBuy Không Tiếng Ồn, Khử Mùi Khử Khói Độc Hại Hiệu Quả, Ngăn Ngừa Các Bệnh Hô Hấp Cho Người Lớn Và Trẻ Nhỏ - Thiết Bị Lọc Không Khí Nhỏ Gọn Tiện Dụng Tiết Kiệm Điện Tối Ưu, Dùng Trong Phòng Ngủ, Nhà Vệ Sinh và Trong Gia Đình – H",86000,86000,0,0
TIKI,dien-gia-dung,115694916,"Lõi Gốm Ceramic Standard 10 inch by Scitech - Lõi số 1 máy lọc nước Nano/UF/RO (Dùng thay thế lõi PP) - Hàng chính hãng",295000,295000,0,0
TIKI,dien-gia-dung,782215,"Nồi Áp Suất Điện Khaluck.Home Kl-688 (6L) - Đỏ Đô- Hãng chính hãng",967000,967000,0,0
TIKI,dien-gia-dung,196243498,"Nồi lẩu điện đa năng Bear SUBE004 - Hàng chính hãng",1290000,1790000,500000,28
TIKI,dien-gia-dung,160583633,"[Đa Năng] Máy Hút Thổi Bụi Công Suất 700w KhoNCC Hàng Chính Hãng - Bảo Vệ Máy Móc Bụi Bẩn Cho Gia Đình - Nhà Xưởng - Văn Phòng - KLVQ-4840-HTB (Đỏ)",289000,358000,69000,19
TIKI,dien-gia-dung,152548051,"Máy Ép Trái Cây, Máy Ép Chậm Cao Cấp KALITE KL-565 Tiêu Chuẩn Châu Âu Dung Tích Công Suất 240 W - Hàng Chính Hãng",2596000,5279000,2683000,51
TIKI,dien-gia-dung,158788387,"Ấm Siêu Tốc Inox 2 Lớp 2.5L NK Media MD-EK6525 - Màu Ngẫu Nhiên - Hàng Chính Hãng",175000,180000,5000,3
TIKI,dien-gia-dung,69157400,"Bếp ga mini INOX Namilux 2S chống nổ PL2021AS chính hãng",280000,320000,40000,13
TIKI,dien-gia-dung,420332,"Bình Thủy Điện Toshiba PLK-45SF(WT)VN (4.5L) - Hàng chính hãng",2490000,2490000,0,0
TIKI,dien-gia-dung,87652219,"Bộ Lọc Hepa Cho Máy Hút Bụi DEERMA DX115C - Hàng chính hãng",14000,14000,0,0
TIKI,dien-gia-dung,150932320,"Máy khuếch tán tinh dầu không dùng nước i118 (20-100m2) - Tạo mùi thơm, khử mùi hôi trong phòng, spa, cửa hàng iCHARM",1349000,1900000,551000,29
TIKI,dien-gia-dung,171732832,"Bình đun siêu tốc Philips 1.2 lít HD9303/03 - Hàng chính hãng",599000,630000,31000,5
TIKI,dien-gia-dung,145773086,"Bình đun inox304 nấu đa năng 1.5L Mishio - Hàng chính hãng",394000,399000,5000,1
TIKI,dien-gia-dung,10368980,"Máy Hút Bụi Dùng Pin Makita DCL182ZB - Hàng chính hãng",1632000,1632000,0,0
TIKI,dien-gia-dung,58860071,"Quạt Cây Thông Minh Smartmi Gen 2S (2019) (Pin 2800mAh, Wifi) - Hàng Nhập Khẩu",1785000,2248000,463000,21
TIKI,dien-gia-dung,184592399,"Máy Xay Thịt BEAR QSJ-C04R8 Cao Cấp Dung Tích 2.5L Công Suất 300W - Hàng Chính Hãng",763000,1359000,596000,44
TIKI,dien-gia-dung,248244127,"Màng lọc thô Pureit Casa/ Pureit Casa G2 , Hàng chính hãng",97000,100000,3000,3
TIKI,dien-gia-dung,192897242,"Combo 3 lõi lọc nước 123 dùng cho máy Ecotar 3, Ecotar 6, Lõi Ecotar, Aragon, CBC  - Hàng Chính Hãng",1301000,2260000,959000,42
TIKI,dien-gia-dung,155013859,"Lõi Ecotar Geyser by Scitech - Lõi số 1 máy lọc nước Nano Geyser Ecotar 3, Geyser Ecotar 4 - Hàng chính hãng",550000,550000,0,0
TIKI,dien-gia-dung,115520417,"Combo 5 lõi lọc PP 10 inch 5 micron - Lõi số 1 máy lọc nước Nano/UF/RO, bộ lọc thô - Hàng chính hãng",150000,150000,0,0
TIKI,dien-gia-dung,77682758,"Bàn là (bàn ủi) hơi nước cầm tay Homedics PS-HH50 Turbo - hàng chính hãng ",2150000,2150000,0,0
TIKI,dien-gia-dung,72910531,"Đèn sưởi nhà tắm âm trần có điều khiển từ xa ASIA - 4 bóng (Model: DS4AT01)",1320000,1320000,0,0
TIKI,dien-gia-dung,20373507,"Nồi Lẩu Điện Sunhouse SHD4526 (4.0 Lít) - Hàng Chính Hãng",870000,870000,0,0
TIKI,dien-gia-dung,48221916,"Máy phun sương tạo ẩm dùng cho ô tô, xe hơi nhãn hiệu Baseus CRJSQ01 - Hàng Nhập Khẩu",437000,450000,13000,3
TIKI,dien-gia-dung,138855056,"Máy phun sương tạo ẩm siêu âm Deerma DEM-F628 - Hàng Chính Hãng",419000,590000,171000,29
TIKI,dien-gia-dung,79414512,"Nồi nấu chậm, nồi kho cá nấu cháo Fujika 1.5L/2.5L(chọn phân loại), công suất 140W-240W, màu ngẫu nhiên-hàng chính hãng",146000,146000,0,0
TIKI,dien-gia-dung,1733783,"Quạt Bàn Mini Senko B102 (28W) - Tím Khoai Môn - Hàng Chính Hãng",240000,240000,0,0
TIKI,dien-gia-dung,119467619,"Bàn Ga Máy May Cơ Brother",450000,450000,0,0
TIKI,dien-gia-dung,11596130,"Ấm Nấu Đa Năng Tiross TS1366 (1.2L) - Hàng chính hãng",650000,790000,140000,18
TIKI,dien-gia-dung,26024212,"Nồi cơm Kitchen Flower Cookin RM-NA05 (MÀU NGẪU NHIÊN) - Hàng chính hãng",1895000,1895000,0,0
TIKI,dien-gia-dung,825528,"Chân Vịt May Nhúng Brother F012N - Hàng chính hãng",159000,159000,0,0
TIKI,dien-gia-dung,165251209,"Nồi Lẩu Điện Comet CM7731 - Hàng Chính Hãng",429000,429000,0,0
TIKI,dien-gia-dung,143302682,"Combo Máy Nhào Trộn Bột Thân Khung Thép Midimori, MDMR-9819A (1800W) Và Máy Xay Thịt Midimori (500W) – Hàng Chính Hãng",3983000,5980000,1997000,33
TIKI,dien-gia-dung,178592742,"Cửa gió vuông NHỰA 2525RC - Hàng Nhập Khẩu",100000,100000,0,0
TIKI,dien-gia-dung,403522,"Vỉ Nướng Điện Tiross TS969 - Hàng chính hãng",949000,1100000,151000,14
TIKI,dien-gia-dung,181448118,"Quạt đứng công nghiệp Hali DC209C công suất 100W cánh 50cm chất liệu nhựa ABS bền bỉ - Hàng chính hãng - Bảo hành 12 tháng",1145000,1145000,0,0
TIKI,dien-gia-dung,83363163,"Tông đơ chấn viền cắt tóc, cạo trọc, cạo râu fade tóc, khắc tóc đi viền nét Kemei KM-5021 chuyên dụng cho salon, tiệm tóc, cá nhân đi kèm với máy có bộ cữ lược căn độ dài chuyên dụng Tặng kèm bộ 2 kẹp cá sấu chia tóc ( màu ngẫu nhiên )",348000,348000,0,0
TIKI,dien-gia-dung,192897268,"Cốc lọc nước đầu nguồn 10in ren 21, ren 13, đầu nối nhanh - Hàng Chính Hãng - CỐC REN 13 MÁY NANO",106000,190000,84000,44
TIKI,dien-gia-dung,186121587,"Cửa gió nhựa VUÔNG - mái che lỗ vuông - Decor 185*185H - Hàng Nhập Khẩu",180000,180000,0,0
TIKI,dien-gia-dung,125535837,"Combo 3 Lõi Lọc Nước Thô 1-2-3 ( PP 5 MCR - CTO ANTHRACITE - CERAMIC) Hàng Chính Hãng",170000,170000,0,0
TIKI,dien-gia-dung,168516578," Máy Bào Đá Công Nghiệp 300W siêu khỏe hàng nhập khẩu",659000,659000,0,0
TIKI,dien-gia-dung,98059120,"Ngã 3 đấu dây chia lửa chữ T",15000,15000,0,0
TIKI,dien-gia-dung,114691195,"Lõi Lọc Nước Số 1 Kanzo - PP5 Micron - Hàng Chính Hãng",80000,80000,0,0
TIKI,dien-gia-dung,60704225,"Siêu sắc thuốc điện tự động Fujika K3 dung tích 3Lit, công suât 450W-Hàng chính hãng",289000,289000,0,0
TIKI,dien-gia-dung,194811732,"Bếp Âm Điện từ Hồng Ngoại KAFF KF-IC79H - Tặng kèm bộ nồi Fivestar - Hàng chính hãng",19800000,19800000,0,0
TIKI,dien-gia-dung,33577715,"Đèn Sưởi Nhà Tắm 2 bóng Kohn KN02G 550W - Hàng Chính Hãng",489000,489000,0,0
TIKI,dien-gia-dung,170283231,"Nồi Chiên Không Dầu Unie UE-800 Tiêu Chuẩn Đức Công Suất 1800W Dung Tích 8L- Hàng Chính Hãng",2322000,4719000,2397000,51
TIKI,dien-gia-dung,103472001,"Máy sấy tóc Ion âm Enchen Air - mềm mại không làm hư tổn tóc",219600,439200,219600,50
TIKI,dien-gia-dung,110365210,"Combo 2 co nối nhanh ren 10 ra dây 6 (Co vỏ màng) dùng trong máy lọc nước - Hàng chính hãng",20000,20000,0,0
TIKI,dien-gia-dung,40925178,"NỒI CƠM ĐIỆN 1.0L - LÒNG DÀY CERAMIC - Ủ 3D - TỰ CÂN BẰNG NƯỚC - HASUKA HSK801 - HÀNG CHÍNH HÃNG",850000,850000,0,0
TIKI,dien-gia-dung,117213213,"sải cánh 1m67 dài, Quạt trần 6 cánh có đèn Led trang trí, điều khiển từ xa, động cơ DC 6 số tiết kiệm điện",2100000,2100000,0,0
TIKI,dien-gia-dung,98065131,"Khò ga thui trâu bò cán dài",169000,169000,0,0
TIKI,dien-gia-dung,193442681,"Nồi Nấu Chậm Tự Động BBCooker DS15 (1.5L)- Hàng Chính Hãng",720000,890000,170000,19
TIKI,dien-gia-dung,115006528,"Chổi xoắn thay thế dành cho robot hút bụi ECOVACS T8 AIVI T5 MAX T5 HERO Hàng chính hãng",200000,200000,0,0
TIKI,dien-gia-dung,87993197,"Máy cạo râu Xiaomi Enchen Warrior - Hàng Nhập Khẩu",189000,211000,22000,10
TIKI,dien-gia-dung,42749423,"Máy Hút Mùi Hút Khói Khử Mùi Vỏ Inox Sunhouse SHB6118I New - Chính Hãng",1740000,1740000,0,0
TIKI,dien-gia-dung,2001055,"Máy Hút Mùi Kính Cong Sunhouse Apex APB6601-70C - Hàng chính hãng",2789000,2875000,86000,3
TIKI,dien-gia-dung,176150377,"Máy sấy tóc SUNHOUSE SHD2313 (1000W) - Hàng chính hãng",241000,430000,189000,44
TIKI,dien-gia-dung,36836228,"Đèn Sưởi Phòng Nhà Tắm Klopper LH02 (2 Bóng) - Chính Hãng",193000,199000,6000,3
TIKI,dien-gia-dung,149146287,"Ấm Đun Siêu Tốc SUNHOUSE 2 Lớp Dung Tích 1.8L SHD1353 - Hàng chính hãng",278000,278000,0,0
TIKI,dien-gia-dung,790401,"Máy Đánh Trứng Daewoo DWHM- 831S (250W) - Hàng chính hãng",382000,659000,277000,42
TIKI,dien-gia-dung,97511923,"Lõi lọc nước 123 Đại Việt PP-CTO-PP",135000,135000,0,0
TIKI,dien-gia-dung,174430950,"QUẠT SẠC TÍCH ĐIỆN ĐỂ BÀN DP-7626 HÀNG NHẬP KHẨU",199000,199000,0,0
TIKI,dien-gia-dung,127218893,"Quạt tháp hơi nước 3 in 1 Klarstein Highrise - hàng chính hãng",3380000,3380000,0,0
TIKI,dien-gia-dung,175436659,"Tông đơ cắt tóc không dây chuyên nghiệp Kemei KM-MAX2092 công suất mạnh, sạc nhanh USB, pin trâu Tặng kèm bộ 8 cữ lược căn độ dài và phụ kiện đầy đủ - Hàng chính hãng",587000,599000,12000,2
TIKI,dien-gia-dung,190172204,"Nồi tiềm nấu cháo chậm Bennix BN-20SLC - 2 lít [40SLC - 4 lít] - Hàng chính hãng",690000,690000,0,0
TIKI,dien-gia-dung,75582126,"COMBO 2 Bộ lọc Hepa dành cho máy hút bụi Deerma CM1300/CM1900 - Hàng Nhập Khẩu",35000,35000,0,0
TIKI,dien-gia-dung,182787167,"Máy xay thịt Elmich EDA0829 công xuất 350W dung tích cối 1.2 L - Hàng chính hãng",620000,620000,0,0
TIKI,dien-gia-dung,188997052,"Máy Cạo Râu Mini Đa Năng Nhật Bản, Dao Cạo Râu Điện Khô Sử Dụng Lưỡi Dao Cạo Râu 3 Cạnh Không Trầy Xước",190000,190000,0,0
TIKI,dien-gia-dung,127219206,"Máy Trộn Bột Ủ Bột Lên Men, Máy Làm Bánh Tự Động BEAR HMJ-A70C1 Chống Dính Dung Tích 7 Lít Công Suất 250 W - Hàng Chính Hãng",2253000,4589000,2336000,51
TIKI,dien-gia-dung,52671105,"Viên nén vệ sinh máy pha cafe Jura Cleaning Tablets 6 viên/ hộp - 62715 - Hàng Chính Hãng",770000,770000,0,0
TIKI,dien-gia-dung,122868420,"Bếp Hồng Ngoại Cảm Ứng NK Media MD-SV222 - Hàng Chính Hãng",553000,570000,17000,3
TIKI,dien-gia-dung,71900726,"Quạt trần trang trí -  quạt mát F25 cho  phòng khách và phòng ngủ",2110000,2110000,0,0
TIKI,dien-gia-dung,127351318,"Van Xả Nước Thải Flow 300 Máy Lọc Nước Đầu Nối Nhanh ĐÀI LOAN - Hàng chính hãng",39000,39000,0,0
TIKI,dien-gia-dung,99844226,"Máy xông tinh dầu xe hơi, máy khếch tán tinh dầu USB-OTO Krishna - Chuyên Ô tô - Hàng nhập khẩu",330000,330000,0,0
TIKI,dien-gia-dung,2166849,"Túi Lọc Bụi WD 4 Premium - Hàng chính hãng",267000,284727,17727,6
TIKI,dien-gia-dung,24156622,"Bộ đèn UV 25W dùng cho máy lọc nước",1045000,1200000,155000,13
TIKI,dien-gia-dung,33759008,"Ấm đun siêu tốc Panafresh SK-178 1,7 lít - Hàng nhập khẩu",408000,408000,0,0
TIKI,dien-gia-dung,21172928,"Nồi nấu chậm 2.5L Fatz Baby hàng chính hãng ",638000,638000,0,0
TIKI,dien-gia-dung,11259213,"Nồi Kho Cá Fujika FJ-KC25 (2.5L) - Màu Nâu - Hàng chính hãng",243000,250000,7000,3
TIKI,dien-gia-dung,186285922,"Máy sấy tóc Philips 2 chiều nóng lạnh BHC020 công suất lớn 1800W - Hàng nhập khẩu",549000,549000,0,0
TIKI,dien-gia-dung,113439730,"Vỏ màng RO kèm van 1 chiều và co nối dùng trong máy lọc nước (Dùng cho màng RO 50-200 GPD) - Hàng chính hãng",110000,110000,0,0
TIKI,dien-gia-dung,101870090,"Đèn khò đế Namilux NA-191SP-VN - HÀNG CHÍNH HÃNG NAMILUX (MP)",279000,279000,0,0
TIKI,dien-gia-dung,114644392,"Bộ Lõi Lọc Dyson Filter TP06 - Hàng Chính Hãng",1950000,1950000,0,0
TIKI,dien-gia-dung,38560301,"Tủ, Máy  Sấy Quần Áo 2 Tầng, Máy Sưởi Phòng Mùa Đông, Công suất 1200W, Inox304, Vải Chịu Nhiệt, Hasuka HSK 115 - Hàng Chính Hãng",1750000,1750000,0,0
TIKI,dien-gia-dung,57740468,"Tông đơ cắt tóc cho bé thông minh Moaz Bebe MB-014 có tính năng hút tóc",665000,665000,0,0
TIKI,dien-gia-dung,792626,"Siêu Sắc Thuốc Tự Động Trường Thọ BA 2086 - Nâu (2.8L) - Hàng Chính Hãng",264000,264000,0,0
TIKI,dien-gia-dung,14486887,"Van áp thấp Namilux NA-337S/1, tặng dây dẫn gss VN, sử dụng cho bình gas đỏ. Hàng chính hãng",169000,169000,0,0
TIKI,dien-gia-dung,559180,"Máy Ép Chậm Kuvings NS-321CBM2 (Đỏ) - Hàng Chính Hãng",7999000,10990000,2991000,27
TIKI,dien-gia-dung,33392748,"Cặp chổi ven ecovacs SLIM 11, 930, OZMO 600, 610_Hàng chính hãng",150000,150000,0,0
TIKI,dien-gia-dung,176681317,"chế biogas gia đình, đánh lửa bếp gas khí chăn nuôi, sinh học",40000,40000,0,0
TIKI,dien-gia-dung,56514020,"Tay vặn – mở - khóa ly - cốc máy lọc nước R.O – lọc thô 4 chấu",22000,30000,8000,27
TIKI,dien-gia-dung,3605337,"Máy Xay Sinh Tố Cối Thuỷ Tinh Elmich BLE-1846 (600W) - Hàng chính hãng",949000,1290000,341000,26
TIKI,dien-gia-dung,449721,"Ấm Siêu Tốc Thủy Tinh Sunhouse SHD1217- Hàng chính hãng",397000,409000,12000,3
TIKI,dien-gia-dung,194017196,"Đập Breville bã cà phê mini (đen) 15x15cm - Hàng chính hãng",385000,385000,0,0
TIKI,dien-gia-dung,52129844,"Combo Bếp Gas Dương Kính Sunhouse MaMa MMBB0787B Kèm Van Dây - Chính Hãng",1096000,1130000,34000,3
TIKI,dien-gia-dung,178575347,"Máy cạo râu Enchen Victor lưỡi nổi 4D công suất 3W có thể sạc pin - Hàng chính hãng",199000,229000,30000,13
TIKI,dien-gia-dung,523488,"Máy Vắt Cam Kenwood JE290 - Trắng - Hàng Chính Hãng",390000,561000,171000,30
TIKI,dien-gia-dung,71929264,"Quạt trần có đèn trang trí cho phòng khách và phòng ngủ F27",1790000,1790000,0,0
TIKI,dien-gia-dung,72453880,"Máy xay bột mịn PG500. Xay liên tục mạnh mẽ hàng đầu Việt Nam. Hàng chính hãng Thái Lan chất lượng cao.",1750000,1900000,150000,8
TIKI,dien-gia-dung,194957700,"Máy hút mùi cổ điển màu đen 600mm KAFF KF_638B Tặng bộ lọc than thay thế _ Hàng Chính Hãng",3780000,3780000,0,0
TIKI,dien-gia-dung,37415380,"Tông Đơ Cắt Tóc Chuyên Nghiệp Kemei KM-5027",390000,390000,0,0
TIKI,dien-gia-dung,95222643,"Chổi xoắn thay thế dành cho Robot hút bụi lau nhà Liectroux XR500 Hàng chính hãng",180000,180000,0,0
TIKI,dien-gia-dung,82179448,"Van áp cao, van áp thấp taiwan - linh kiện máy lọc nước R.O gia đình - kèm dây  (Hàng chính hãng)",78000,95000,17000,18
TIKI,dien-gia-dung,190703158,"Nồi nấu ủ trân châu tự động đa năng Yubann 5 lít - Hàng chính hãng",2066000,2066000,0,0
TIKI,dien-gia-dung,272950021,"Máy Xay Thịt Thực Phẩm Đa Năng CASO UZ400 - Nhập Khẩu Đức Dung Tích 1.2 Lít Công Suất 400 W - Hàng Nhập Khẩu",1349000,2689000,1340000,50
TIKI,dien-gia-dung,184895499,"Máy lọc nước Unilever Pureit Ultima Trắng - Máy lọc nước bù khoáng để bàn treo tường Ultima - Bảo hành chính hãng 12 tháng",7990000,8490000,500000,6
TIKI,dien-gia-dung,50783183,"Combo 2 Quạt bàn b1210 senko (1 thùng / 2 cái) - Hàng Chính Hãng (giao màu ngẫu nhiên)",582000,582000,0,0
TIKI,dien-gia-dung,71905869,"Máy Xay Sinh Tố 2 Ly Morphy Richards (300W) MR9500 - Xanh - Hàng Chính Hãng",1091000,1091000,0,0
TIKI,dien-gia-dung,169905799,"(Pin Sạc) Máy Hút Bụi Mini Cầm Tay Không Dây KhoNCC Hàng Chính Hãng - Hút Mọi Ngóc Ngách Vệ Sinh Sạch Sẽ Oto Xe Hơi Của Bạn - KLM-MHBCTOBW",429000,566000,137000,24
TIKI,dien-gia-dung,196156300,"Quạt Sàn Lifann  S-18CN - Hàng chính hãng",621000,621000,0,0
TIKI,dien-gia-dung,1389957,"Đèn Sưởi 4 Bóng Hans Loại Âm Trần (1180W) - Hàng chính hãng",1030000,1030000,0,0
TIKI,dien-gia-dung,172168346,"Nồi áp suất điện KIPOR KP-AS351 - 6L - Điều khiển cơ đa chức năng 7 trong 1 - Lòng nồi 5 lớp chống dính TEFLON - Hàng chính hãng",1848000,2749000,901000,33
TIKI,dien-gia-dung,647740,"Máy Sấy Tóc Sunhouse SHD2317 - Đen",360000,360000,0,0
TIKI,dien-gia-dung,93882901,"Bếp từ Smaragd 3 từ DORTMUND",5590000,5590000,0,0
TIKI,dien-gia-dung,105251228,"Bình Thủy Điện SHARP KP-B28SV-SC (2.8 Lít) - Hàng Chính Hãng",809000,809000,0,0
TIKI,dien-gia-dung,192333806,"Miếng chống khoáng BONECO A451 giảm vôi hoá trong bình bay hơi, giảm tần xuất hiện tượng canxi hoá cho máy phun sương tạo ẩm S450 - Hàng Chính Hãng",190000,190000,0,0
TIKI,dien-gia-dung,6619163,"Lõi lọc Karofi số 7 (Lõi ORP Alkaline) - Hàng Chính Hãng",149000,391000,242000,62
TIKI,dien-gia-dung,192376889,"Bột rửa CalcOff A7417 Chất làm sạch và khử mùi cho các máy phun sương tạo độ ẩm, giảm vôi hoá của nước -Hàng Chính Hãng",300000,300000,0,0
TIKI,dien-gia-dung,58047274,"Bình đun siêu tốc Toshiba 1.7 lít KT-17SH2NV - HÀNG CHÍNH HÃNG",549000,590000,41000,7
TIKI,dien-gia-dung,174308786,"Bộ Lọc Thô PARTEK P1012-PRS 10 inch Cao Cấp Công Nghệ Mỹ Chuẩn NSF - Hàng Chính Hãng - (Cốc Lọc Sinh Hoạt 10in, Lọc Nước Đầu Nguồn, Tiền Xử Lý Nước Sinh Hoạt, Sediment Filter, Pre-treatment 5 micron, P1012PRS P1005-PP PP-CATION)",980000,980000,0,0
TIKI,dien-gia-dung,119467616,"Bàn Ga Máy May Điện Tử Brother",400000,400000,0,0
TIKI,dien-gia-dung,403433,"Máy Làm Bánh Mì Tiross TS820 - Hàng chính hãng",2200000,2590000,390000,15
TIKI,dien-gia-dung,111717809,"Van nước thải, van Flow máy lọc nước - Hàng chính hãng",55000,55000,0,0
TIKI,dien-gia-dung,110287133,"Máy Hàn Miệng Túi Mini BepXua Sealer - Hàng Nhập Khẩu",35000,35000,0,0
TIKI,dien-gia-dung,37140242,"TÔNG ĐƠ ĐIỆN CẮT TÓC CHAOBA 808 TRẮNG LOẠI 1",206000,215000,9000,4
TIKI,dien-gia-dung,138674341,"Bộ lọc Hepa dành cho máy hút bụi Mini VCH 2 Karcher (2 cái)",213900,225818,11918,5
TIKI,dien-gia-dung,177197018,"Máy sấy tóc Ion Enchen Air giúp bổ sung Ion làm tóc suôn mượt giảm khô rối, bảo vệ tóc",199000,229000,30000,13
TIKI,dien-gia-dung,183032070,"Cửa gió vuông NHỰA A2525R- Hàng Nhập Khẩu",115000,115000,0,0
TIKI,dien-gia-dung,164080652,"Bếp hồng ngoại Goldsun GIF3500-M Hàng chính hãng",650000,650000,0,0
TIKI,dien-gia-dung,456029,"Nồi Cơm Điện Sharp KS-N191ETV SB - 1.8 Lít - Hàng chính hãng",1050000,1050000,0,0
TIKI,dien-gia-dung,165239978,"Máy Xay Sinh Tố Thủy Tinh COMET CM9986 - Hàng chính hãng",575000,575000,0,0
TIKI,dien-gia-dung,59228277,"Tông đơ cắt tóc chuyên nghiệp có đèn led kemei KM1983",500000,525000,25000,5
TIKI,dien-gia-dung,188996248,"Máy Cạo Râu Mini Bỏ Túi Cao Cấp, 3 Lưỡi Siêu Nhỏ Gọn Công Nghệ Nhật Bản, Siêu Bén, Siêu An Toàn, Công Suất Lớn",190000,190000,0,0
TIKI,dien-gia-dung,366249,"Nồi Cơm Điện Comet CM8021 - Hàng chính hãng",459000,579000,120000,21
TIKI,dien-gia-dung,125536215,"Máy Sấy Khử Trùng Chén Bát Dhome DH - 266 Dung Tích 40l - Hàng Chính Hãng",2120000,2120000,0,0
TIKI,dien-gia-dung,138339825,"Gỗ Vụn Sous Vide Tools Dùng Cho Thiết Bị Xông Khói Wood Chips (250ml Container) - Hàng Nhập khẩu",158760,158760,0,0
TIKI,dien-gia-dung,78945102,"Bếp Ga Mini,Bếp Ga Du Lịch Cao Cấp Hayasa Ha-8102M Có Hộp Đựng Siêu Bền Tiện Lợi - Hàng Chính Hãng",359000,359000,0,0
TIKI,dien-gia-dung,121414573,"Máy xay nghiền đa năng 3A1,5KW (Động cơ rời)",6300000,6300000,0,0
TIKI,dien-gia-dung,189697856,"Nồi cơm điện nắp rời 1.8L Ladomax HA-7118 lòng nhôm chống dính, dùng cho 4 - 6 người ăn - Hàng chính hãng",493000,493000,0,0
TIKI,dien-gia-dung,127515673,"Lõi số 2 Karofi Cation T33 dùng cho các máy N-e117, N-e118...xử lý nguồn nước cứng nhiễm đá vôi Hàng chính hãng có xuất hóa đơn VAT",91000,136000,45000,33
TIKI,dien-gia-dung,449132,"Bình Thủy Điện Sunhouse SH1530 (3 lít) - Hàng chính hãng",830000,830000,0,0
TIKI,dien-gia-dung,51953410,"Máy lọc nước Sinh hoạt BYQ-3000L công nghệ lõi lọc UF Có Xả cặn , màng vỏ INOX 304 đầu ra Gen-27 Hàng Chính Hãng",2190000,2190000,0,0
TIKI,dien-gia-dung,188342752,"Quạt trần đèn cánh gỗ Kim Thuận Phong KTP BT586i - Hàng chính hãng",4700000,4700000,0,0
TIKI,dien-gia-dung,6522955,"Lõi lọc Karofi số 8 (Lõi Hồng ngoại) - Chính Hãng",128000,128000,0,0
TIKI,dien-gia-dung,117207824,"Lõi CTO 10 inch - Lõi số 3 máy lọc nước RO, bộ lọc thô - Hàng chính hãng",125000,125000,0,0
TIKI,dien-gia-dung,831124,"Siêu Sắc Thuốc Tự Động Trường Thọ BA-86 (2.8L) - Xanh Ngọc - Hàng chính hãng",271949,271949,0,0
TIKI,dien-gia-dung,115884591,"Vòi cho cây nước nóng lạnh",20000,20000,0,0
TIKI,dien-gia-dung,1733759,"Van ngắt gas tự động Namilux NA-337S - Dùng cho bình gas XÁM SP - Hàng chính hãng",109000,109000,0,0
TIKI,dien-gia-dung,178340190,"Vòi inox 304 cao cấp dùng trong máy lọc nước - Hàng chính hãng",250000,250000,0,0
TIKI,dien-gia-dung,48586992,"Đĩa Lò Vi Sóng Cao Cấp đường kính 27cm",75000,75000,0,0
TIKI,dien-gia-dung,162986710,"Combo thùng 2 cái Quạt điện Senko để bàn tiện lợi cao cấp B1216 màu ngẫu nhiên - Hàng Chính Hãng",581000,581000,0,0
TIKI,dien-gia-dung,178313371,"Máy vắt cam Goldsun GOS3901 - Hàng Chính Hãng",640000,640000,0,0
TIKI,dien-gia-dung,447304,"Máy Uốn Tóc Panasonic PAST-EH-KE46VP645 - Hàng Chính Hãng",936000,1186800,250800,21
TIKI,dien-gia-dung,191067105,"Mặt bích nối ống tròn D150 - 15F - Hàng Nhập Khẩu",68000,68000,0,0
TIKI,dien-gia-dung,192276310,"Máy vắt cam Bear CZJ-A04B1 - Hàng chính hãng",319000,499000,180000,36
TIKI,dien-gia-dung,184597929,"Kiềng bếp ga bán công nghiệp 4,6,8 lò đốt ( cạnh vuông 18cm )",48000,48000,0,0
TIKI,dien-gia-dung,22152049,"Lõi Lọc Thay Thế Toray Torayvino RSC-51 - Chính hãng",563000,625000,62000,10
TIKI,dien-gia-dung,82673534,"Quạt treo 2 dây SENKO TC1626 - Hàng chính hãng",354000,354000,0,0
TIKI,dien-gia-dung,150622157,"Máy xay sinh tố Electrolux E3TB1-710S (1000W) - Hàng chính hãng",998000,998000,0,0
TIKI,dien-gia-dung,645765,"Máy Tạo Kiểu Tóc Panasonic PAST-EH-HT40-K645 (32mm)",1080000,1169000,89000,8
TIKI,dien-gia-dung,97619562,"Lưỡi dao thay thế cho tông đơ Xiaomi Enchen Boost - Hàng Nhập Khẩu",98010,99000,990,1
TIKI,dien-gia-dung,13237426,"Bếp gas công nghiệp Redhome 280C, tặng dây - Hàng chính hãng",580000,580000,0,0
TIKI,dien-gia-dung,69248848,"Đầu Hút Dyson High Torque Cleaner Head - Hàng Chính Hãng",2450000,2450000,0,0
TIKI,dien-gia-dung,125087346,"Máy sấy tóc Bluestone HDB-1871, Công Suất 2300W, Bảo Hành Điện Tử 2 Năm , Hàng Chính Hãng",809000,899000,90000,10
TIKI,dien-gia-dung,115972725,"Lõi CTO 10 inch Olsmo Pure by Scitech - Lõi số 3 máy lọc nước RO, bộ lọc thô - Hàng chính hãng",145000,145000,0,0
TIKI,dien-gia-dung,6959449,"Bếp Hồng Ngoại Cảm Ứng Sunhouse SHD6005 (2000W) - Hàng chính hãng",795000,795000,0,0
TIKI,dien-gia-dung,7192421,"Chảo Lẩu Điện Đa Năng 2 In 1 Hayasa HA-688 - Hàng chính hãng",1267000,1267000,0,0
TIKI,dien-gia-dung,533429,"Máy Sấy Quần Áo Sunhouse SHD2707 - Tím - Hàng chính hãng",1455000,1500000,45000,3
TIKI,dien-gia-dung,32572813,"Máy Ép, Uốn Tóc Mini PYT Lõi Sứ  - Mini Ceramic Neon Orange (Màu Cam Neon)",399000,800000,401000,50
TIKI,dien-gia-dung,3682311,"Đèn sưởi 4 bóng âm trần có điều khiển Hans - Heizen HE-4BR - Hàng chính hãng",1750000,1750000,0,0
TIKI,dien-gia-dung,16830040,"Máy (Nồi) Làm Tỏi Đen Nikio NK-686 - Công Nghệ Làm Tỏi Tự Động Nhật Bản, Thời Gian Làm Tỏi Và Sấy Khô Tùy Chỉnh Linh Hoạt Giúp Tỏi Thơm Ngon, Giàu Chất Dinh Dưỡng - Dung Tích 6 Lít, Làm Được 2Kg Tỏi - Cafe Sữa",1927000,3150000,1223000,39
TIKI,dien-gia-dung,56754404,"Máy Hút Chân Không Đa Năng T1320 Hút Khô Và Ướt - Hàng chính hãng",1690000,1690000,0,0
TIKI,dien-gia-dung,130829702,"Dụng Cụ Đựng Ly Giấy 1 Ngăn Dán Tường PaKaSa -Hàng Chính Hãng ",107000,152000,45000,30
TIKI,dien-gia-dung,548722,"Nồi Cơm Điện Nắp Gài Cuckoo CR- 3521 - 6.3L - Hàng Chính Hãng",4199000,4199000,0,0
TIKI,dien-gia-dung,13535615,"Dây dẫn gas áp cao, sử dụng cho bếp khè, bếp gas dân dụng",65000,65000,0,0
TIKI,dien-gia-dung,514656,"Máy Tạo Ẩm BEURER LB44 - Trắng - Hàng chính hãng",1548000,1580000,32000,2
TIKI,dien-gia-dung,92488000,"LÕI LỌC NƯỚC SỐ 5 KANGAROO – NANO SILVER - Hàng chính hãng",162000,265000,103000,39
TIKI,dien-gia-dung,56522050,"Tay vặn cốc, ly lọc nước loại 20 inch - Hàng chính hãng",32000,50000,18000,36
TIKI,dien-gia-dung,3736143,"Đèn sưởi nhà tắm âm trần 2 bóng Kottmann K9-R (điều khiển), hàng chính hãng",1320000,2250000,930000,41
TIKI,dien-gia-dung,92024561,"LÕI SỐ 2 - SMAX DUO 2 - ION EXCHANGE - Hàng chính hãng",78000,80000,2000,3
TIKI,dien-gia-dung,831364,"Siêu Sắc Thuốc Tự Động Bát Tiên BA-2086 (3.2L) - Vàng - Hàng chính hãng",300000,300000,0,0
TIKI,dien-gia-dung,178593120,"Cửa gió vuông NHỰA 3434RC - Hàng Nhập Khẩu",130000,130000,0,0
TIKI,dien-gia-dung,8313666,"Bàn là hơi Sunhouse SHD2065 - Hàng chính hãng",240000,240000,0,0
TIKI,dien-gia-dung,77674225,"Combo 10 phe cài, chốt cài cho co, cút, tê nối . . . linh kiện lọc nước  nối nhanh (Hàng chính hãng)",15000,25000,10000,40
TIKI,dien-gia-dung,14767921,"Lõi Lọc R.O SUNHOUSE Số 1 SHRLL1 - Hàng Chính Hãng",34500,34500,0,0
TIKI,dien-gia-dung,7319925,"Máy Hút Mùi Vỏ Inox Sunhouse SHB 6118I - Hàng chính hãng",1790000,1845000,55000,3
TIKI,dien-gia-dung,111717802,"Van áp cao nối nhanh kèm dây điện dùng trong máy lọc nước - Hàng chính hãng",75000,75000,0,0
TIKI,dien-gia-dung,53994912,"Lõi Bình Lọc Nước Cầm Tay Carry On ( BellaVie Water) ",960000,960000,0,0
TIKI,dien-gia-dung,14786661,"Robot Lau Chà Sàn Nhà ilife W400 - Hàng chính hãng",6799000,6799000,0,0
TIKI,dien-gia-dung,973080,"Quạt Hút Thông Gió Senko H250 40W - Hàng Chính Hãng",299000,299000,0,0
TIKI,dien-gia-dung,177066141,"Nồi cơm điện tử áp suất cao tần Cuckoo 1.8 lít CRP-LHTR1009F - Phiên bản Quốc tế - Hàng chính hãng",11490000,15525000,4035000,26
TIKI,dien-gia-dung,173176435,"Máy lọc nước nóng lạnh 10 lõi lọc Karofi KAD-N89, màng lọc RO chuẩn Mỹ 100GPD - Hàng Chính Hãng - Miễn phí  lắp đặt toàn quốc",13031000,15700000,2669000,17
TIKI,dien-gia-dung,59404907,"Bếp Điện Từ Cảm Ứng KUCHEN MI376 (Bếp 3 ngăn từ) - Hàng nhập khẩu",18900000,18900000,0,0
TIKI,dien-gia-dung,172684141,"Nồi cơm điện Cao tần Cuckoo CRP-HUT1070FH 1.8L - Chính hãng",6999000,6999000,0,0
TIKI,dien-gia-dung,118113680,"Nồi cơm điện Cuchen CJE-A0401 0.72L (Nhập khẩu chính hãng)",1799000,2249000,450000,20
TIKI,dien-gia-dung,35910532,"Nồi Cơm Điện Nắp Gài Geidea 1,2 lít - Màu Ngẫu Nhiên - Chính Hãng",340000,350000,10000,3
TIKI,dien-gia-dung,195125850,"Máy Làm Sữa Hạt Cao Cấp Unie V8S - 1.75Lit 1800W - Xay Nấu Đa Năng - Bảo Hành Chính Hãng 2 Năm",2399000,3500000,1101000,31
TIKI,dien-gia-dung,160691952,"Tay vặn cốc lọc RO, Hàng chính hãng",20000,20000,0,0
TIKI,dien-gia-dung,68591369,"Quạt thông gió âm tường chính hãng Roman - Quạt gắn tường có màng che ngăn nước mưa ngăn mùi quay ngược lại hiệu quả RBV20",495000,495000,0,0
TIKI,dien-gia-dung,556320,"Nồi Cơm Điện Tử Tiger JBV-S18W - 1.8 Lít - Hàng Chính Hãng",3646500,4290000,643500,15
TIKI,dien-gia-dung,192705726,"Nồi cơm điện tử Cuckoo 1.08L CR-0690F nhiều chế độ nấu, lòng nồi chống dính, thiết kế sang trọng - Hàng chính hãng",1970000,2190000,220000,10
TIKI,dien-gia-dung,85931421,"Bếp gas Dr.Hows Twinkle Stove - Hàng chính hãng",1271000,1271000,0,0
TIKI,dien-gia-dung,244306896,"Bàn Ủi Hơi Nước Đứng Philips GC482 GC485 GC487 - Hàng Chính Hãng",1189000,2000000,811000,41
TIKI,dien-gia-dung,142401101,"NỒI NẤU ĐA NĂNG THÔNG MINH FRICO FC-SP601 - HÀNG NHẬP KHẨU",7388000,7388000,0,0
TIKI,dien-gia-dung,149914940,"Nồi Cơm Điện Tử Bluestone RCB-5949, Lòng Nồi Niêu 1.5Lit-860w, Hàng Chính Hãng",1549000,1999000,450000,23
TIKI,dien-gia-dung,12333137,"Quạt Thổi Sàn Benny BF-181F (120W) - Made In Thailan - Hàng chính hãng",1800000,1800000,0,0
TIKI,dien-gia-dung,10007045,"Nồi cơm áp suất điện tử Cuckoo CRP-PK1000S - 1.8 Lít - Hàng Chính Hãng",3590000,3590000,0,0
TIKI,dien-gia-dung,118102106,"Nồi cơm đa năng FlexCuc CFP-GP10N1SB (Nhập khẩu chính hãng)",42250000,42250000,0,0
TIKI,dien-gia-dung,118099948,"Nồi cơm điện cao tần IR Cuchen CJR-PK1001RHW Điều khiển bằng giọng nói (Hàng nhập khẩu chính hãng)",20999000,20999000,0,0
TIKI,dien-gia-dung,49408734,"Quạt tháp không cánh Vf - poco - trắng - tích hợp chế độ cung cấp ion âm, lọc không khí",1180000,1590000,410000,26
TIKI,dien-gia-dung,22824950,"Tủ hấp nóng trưng bày bánh bao ( Hàng chính hãng)",3750000,3750000,0,0
TIKI,dien-gia-dung,80118853,"Phụ Kiện Du Lịch Cho Máy Duỗi Và Uốn PYT - An Toàn Cách Nhiệt, Chống Sốc, Bảo Vệ Máy Duỗi Và Uốn Của Bạn",99000,200000,101000,51
TIKI,dien-gia-dung,541517,"Quạt Đứng Mitsubishi LV16-RV SF-GY - Xám Nhạt - Hàng Chính Hãng",2239000,2239000,0,0
TIKI,dien-gia-dung,193916641,"Máy lọc nước Pureit Delica UR5840, Hàng Chính Hãng",17090000,18900000,1810000,10
TIKI,dien-gia-dung,73872622,"Quạt Lửng Sharp Có Điều Khiển PJ-L40RV-WH - Hàng Chính Hãng",1080000,1306666,226666,17
TIKI,dien-gia-dung,82895229,"Quạt đứng điều khiển từ xa SENKO DR1608 - Hàng chính hãng",775000,775000,0,0
TIKI,dien-gia-dung,130438186,"Máy hút bụi cầm tay Samsung VS15A6031R1/SV - Hàng chính hãng",4420000,7890000,3470000,44
TIKI,dien-gia-dung,10007294,"Nồi cơm áp suất điện tử Cuckoo CRP-M1000S - 1.8 Lít - Hàng Chính Hãng",3890000,4990000,1100000,22
TIKI,dien-gia-dung,179073244,"Nồi chiên không dầu Hafele HS-AF1102B 11L (535.43.715) (Hàng chính hãng)",4491000,4990000,499000,10
TIKI,dien-gia-dung,15966624,"Nồi cơm điện tử niêu Supor CFXB40FC33VN-75 1.5L Hàng chính hãng",1099000,1099000,0,0
TIKI,dien-gia-dung,79653644,"Robot hút bụi lau nhà thông minh Liectroux XR500 - Hàng chính hãng Model mới nhất 2021",4338720,4716000,377280,8
TIKI,dien-gia-dung,160889219,"Máy Hút Bụi Nệm Giường Cao Cấp Deerma CM818 - Hàng Nhập Khẩu",699000,799000,100000,13
TIKI,dien-gia-dung,192807436,"Máy là hơi nước cầm tay bàn ủi quần áo bằng hơi nước MIDEA YBJ10G1 làm nóng nhanh ủi được nhiều chất vải Hàng chính hãng",395000,488000,93000,19
TIKI,dien-gia-dung,17023078,"Quạt đứng công nghiệp Senko DCN1806 65W - Hàng Chính Hãng",525000,525000,0,0
TIKI,dien-gia-dung,179059965,"Máy xay sinh tố Nutribullet NB-101B (NBR-0805R2) - Hàng Chính Hãng",2100000,2519000,419000,17
TIKI,dien-gia-dung,58065297,"Nồi Cơm Điện Cao Tần (IH) Philips HD4528/66 - Hàng Chính Hãng",3390000,3390000,0,0
TIKI,dien-gia-dung,206561318,"Máy Lọc Không Khí Xiaomi Mi Air Purifier 4 (BHR5096GL) - Hàng Chính Hãng",4190000,4190000,0,0
TIKI,dien-gia-dung,197605149,"Cây nước nóng lạnh để bàn Nhật Bản Fujihome WD5510E tiết kiệm điện, bình lọc tủ máy lọc nước nóng lạnh mini- Hàng Nhập Khẩu",1005000,1005000,0,0
TIKI,dien-gia-dung,181375234,"Máy lọc nước nóng lạnh Karofi KAD-I55 công nghệ làm lạnh Block 10 lõi lọc hàng chính hãng",9862500,13150000,3287500,25
TIKI,dien-gia-dung,196272348,"Robot Hút Bụi Lau Nhà Neabot N2 Lite - Thương Hiệu Mỹ - Điều Khiển Qua App Điện Thoại Có Trợ Lý Nói Tiếng Việt Lưu Tới 30 Bản Đồ Pin 5200 mAh Lực Hút 2700 Pa Công Suất 50 W - Hàng Chính Hãng",5389000,10949000,5560000,51
TIKI,dien-gia-dung,66646621,"Máy lọc nước Karofi không tủ SLIM S-S038 (8 cấp)- Hàng chính hãng",3667000,3780000,113000,3
TIKI,dien-gia-dung,273379488,"Nồi cơm điện cao tần IH Cuchen CJH-TPM0601iP, CJH-TPM0602iP (Nhập khẩu chính hãng)",21299000,21299000,0,0
TIKI,dien-gia-dung,192859181,"Nồi Điện Đa Năng 1.5L Nấu lẩu đa năng phù hợp văn phòng ký túc xá sinh viên - Hàng Chính Hãng",399000,399000,0,0
TIKI,dien-gia-dung,82884137,"CHÍNH HÃNG ĐỨC Robot hút bụi lau nhà ABIR X8 Robot hút bụi thông minh App điều khiển tiếng Việt Tự trở về đế sạc Điều hướng thông minh Cảm biến chống rơi chống va chạm Hàng chính hãng",6272000,6466000,194000,3
TIKI,dien-gia-dung,71999133,"Máy Xay Sinh Tố Cầm Tay Morphy Richards MR9800 (50W - 300ml) - Hàng Chính Hãng",893000,893000,0,0
TIKI,dien-gia-dung,125360451,"Máy xay sinh tố HAFELE HSB-0621FS - 535.43.277 (Hàng chính hãng)",1049000,1800000,751000,42
TIKI,dien-gia-dung,184218810,"Máy Làm Sữa Hạt Đa Năng Giảm Tiếng Ồn Magic Eco AC -141 (1.5 Lít) - Hàng chính hãng",2400000,3590000,1190000,33
TIKI,dien-gia-dung,206561068,"Máy Lọc Không Khí Xiaomi Mi Air Purifier 4 Pro Hàng chính hãng",990000,990000,0,0
TIKI,dien-gia-dung,75583174,"Máy hút bụi công nghiệp HiClean HC70A (thùng nhựa chống va đập, 70L) - Hàng chính hãng",3200000,4200000,1000000,24
TIKI,dien-gia-dung,173854716,"Bàn là hơi nước đứng Elmich GSE-3953 - Hàng chính hãng",2070000,2790000,720000,26
TIKI,dien-gia-dung,247241443,"Máy Hút Bụi Lau Sàn Roborock Dyad Pro Công Nghệ Tự Động Giặt Và Sấy Giẻ Lau Bằng Khí Nóng Khử Khuẩn Ion Bạc Cảm Biến Vết Bẩn Kết Nối App Lực Hút 17.000 Pa Diện Tích Lau 300 m2 Công Suất 260 W- Hàng Chính Hãng",9699000,18999000,9300000,49
TIKI,dien-gia-dung,145770366,"Nồi áp suất Mishio MK303 2.5L - Hàng chính hãng",899000,1499000,600000,40
TIKI,dien-gia-dung,89401104,"Máy lọc nước Karofi KAQ-U95 - hàng chính hãng",4433000,4570000,137000,3
TIKI,dien-gia-dung,98848784,"Quạt bàn B4 Senko B1616 - Màu ngẫu nhiên - Hàng Chính Hãng",325000,325000,0,0
TIKI,dien-gia-dung,555021,"Bếp Gas Dương Hồng Ngoại Taka TK-HG8 - Hàng chính hãng",1050000,1050000,0,0
TIKI,dien-gia-dung,187513168,"Quạt không cánh thế hê mới lọc không khí bằng công nghệ ion cho không khí trong lành hơn( Hàng nhập khẩu)",1846800,2280000,433200,19
TIKI,dien-gia-dung,112218301,"Nồi chiên không dầu 5.5L điện tử Mishio MK284 - Hàng chính hãng",1299000,1799000,500000,28
TIKI,dien-gia-dung,134550148,"Nồi cơm điện tử Elmich RCE-1789 (1.2 Lít) - Hàng chính hãng",1290000,1899000,609000,32
TIKI,dien-gia-dung,194017566,"Máy pha cà phê Breville 870 the Barista Express - Hàng chính hãng",21120000,21120000,0,0
TIKI,dien-gia-dung,91540443,"[NEW]Robot hút bụi lau nhà Ecovacs Deebot OZMO N8 Pro - Lực hút MAX 2600 Pa - Bản quốc tế - bảo hành 18 tháng.",7890000,7890000,0,0
TIKI,dien-gia-dung,134982803,"Nồi chiên hơi nước KALITE STEAM STAR dung tích 15L, chức năng chiên hấp 2in1, phụ kiện chống dính, cửa kính cường lực, hàng chính hãng",6245000,6245000,0,0
TIKI,dien-gia-dung,248801700,"Máy lọc nước nóng lạnh để bàn cao cấp FujiE WPD508C, 4 cấp lọc màng siêu lọc UF Kortech Hàn Quốc - Hàng chính hãng",3468000,5500000,2032000,37
TIKI,dien-gia-dung,110931351,"BỘ VỎ QUẠT LỠ CÔNG NGHIỆP - HÀNG CHÍNH HÃNG",129000,129000,0,0
TIKI,dien-gia-dung,177968154,"Máy pha cà phê Espresso Zamboo ZB-92CF - Hàng Chính Hãng",2290000,2990000,700000,23
TIKI,dien-gia-dung,59280544,"[Hàng chính hãng] Bếp từ đơn Neoflam Fika. Hàng có sẵn, giao ngay",1584000,1980000,396000,20
TIKI,dien-gia-dung,194017305,"Máy pha cà phê Breville 878 the Barista Pro - Hàng chính hãng",25960000,25960000,0,0
TIKI,dien-gia-dung,247019523,"Quạt Treo Tường Có Remote Panasonic F409M (B/G) -Hàng Chính Hãng",1990000,1990000,0,0
TIKI,dien-gia-dung,252685508,"Robot Hút Bụi Lau Nhà Thông Minh Xiaomi Lydsto W2/ Lydsto W2 Lite Tự Động Đổ Rác Giặt Sấy Công Nghệ Sấy Khô Giẻ Nhiệt Độ Cao 60 Độ C Diệt Khuẩn Ozone Và Ion Bạc 99.9% Diện Tích Hoạt Động 200 m2 Công Suất 50 W - Hàng Chính Hãng",13999000,27869000,13870000,50
TIKI,dien-gia-dung,2385791,"Nồi Chiên Không Dầu Lock&Lock EJF351BLK (5.2L) (Đen) - Hàng chính hãng",1999000,3000000,1001000,33
TIKI,dien-gia-dung,57678731,"Máy ép trái cây chậm cao cấp Hurom H200 (200W) - Hàng Chính Hãng - Màu đen",8599000,12500000,3901000,31
TIKI,dien-gia-dung,80752494,"Lõi nồi nấu cháo BBCooker 1.5L- Hàng chính hãng",295000,295000,0,0
TIKI,dien-gia-dung,49409055,"Quạt tháp không cánh Vf - poco ( 45w) - Vàng Hồng - Tích hợp chế độ cung cấp ion âm, lọc không khí - Hàng chính hãng.",1180000,1690000,510000,30
TIKI,dien-gia-dung,71514318,"Quạt Làm Mát Và Sưởi Ấm ULTTY SKJ-CR018H, Chất Liệu Sưởi Gốm Ceramic Không Đốt Cháy Oxy, Không Khô Da, Tự Động Tắt Khi Quá Nhiệt - Màu Đen - Hàng Chính Hãng",4750000,5350000,600000,11
TIKI,dien-gia-dung,98285406,"Lò vi sóng Electrolux EMM20D38GB 20 lít - Hàng chính hãng",2280000,2280000,0,0
TIKI,dien-gia-dung,118109245,"Nồi cơm điện áp suất điện tử Cuchen CJS-FC1009F 1.8L (Nhập khẩu chính hãng)",6699000,6699000,0,0
TIKI,dien-gia-dung,184904844,"Máy hút bụi mini không dây Liectroux i3 Thiết kế nhỏ gọn Động cơ mạnh mẽ Dung lượng pin lớn Cổng sạc USB tiện lợi Sản phẩm mới của thương hiệu LIECTROUX ROBOTICS Hàng chính hãng",370500,390000,19500,5
TIKI,dien-gia-dung,973090,"Quạt Hút Thông Gió Senko H200 (35W) - Hàng Chính Hãng",291000,291000,0,0
TIKI,dien-gia-dung,814122,"Bàn Ủi Đứng Panasonic NI-GSE050ARA (1800W) - Xanh Lam - Hàng Chính Hãng",1890000,1890000,0,0
TIKI,dien-gia-dung,194498686,"Nồi cơm điện tử áp suất kép cao tần Cuckoo 1.08L CRP-FHTR0609F (tùy chọn phiên bản tiếng Anh & tiếng Hàn) - Áp suất kép, lòng nồi Xwall độc quyền, nhiều chức năng nấu ăn - Sản xuất tại Hàn Quốc - Hàng chính hãng",10600000,12490000,1890000,15
TIKI,dien-gia-dung,26349242,"Thiết Bị Lọc Nước Lắp tại vòi EF102- Hàng Chính Hãng",2994545,2994545,0,0
TIKI,dien-gia-dung,188042106,"Bàn ủi hơi nước cầm tay PHILIPS STH1000/10 (900W) - Hàng Chính Hãng",799000,958800,159800,17
TIKI,dien-gia-dung,52757053,"Bóng đèn UV trong máy lọc nước – 4 chấu",193000,225000,32000,14
TIKI,dien-gia-dung,175807088,"Bình đun siêu tốc Thủy tinh Mitomo ST-220 dung tích 1.8L Hàng chính hãng",383000,590000,207000,35
TIKI,dien-gia-dung,242449692,"Máy Hút Bụi Không Dây Dyson V12 Detect Slim Total Clean - Hàng Chính Hãng",14050000,14050000,0,0
TIKI,dien-gia-dung,2500825,"Quạt Treo Tường Senko Có Remote TR1428 - Giao Màu Ngẫu Nhiên - Hàng Chính Hãng",513000,513000,0,0
TIKI,dien-gia-dung,745857,"Nồi Áp Suất Điện Tử Philips HD2137/65 (6L) - Hàng Chính Hãng",2739000,3286800,547800,17
TIKI,dien-gia-dung,189374422,"Máy lọc nước Nano Geyser SLIM S8 công nghệ Ro - Hàng Chính Hãng - ECO SLIM S6 CẤP LỌC",2855000,5100000,2245000,44
TIKI,dien-gia-dung,186278651,"Máy Ép Chậm Elmich JEE-3898 200W - Hàng Chính Hãng",1750000,3890000,2140000,55
TIKI,dien-gia-dung,195189560,"Ấm siêu tốc thủy tinh LEBENLANG LBWE2626 bằng thủy tinh chịu nhiệt - hàng chính hãng",399000,500000,101000,20
TIKI,dien-gia-dung,174558496,"Quạt không cánh Baseus Refreshing Monitor Clip-On &amp; Stand-Up Desk Fan- hàng chính hãng",730000,730000,0,0
TIKI,dien-gia-dung,15778664,"Máy hút bụi Dyson V10 Absolute - Cam Đồng Copper ",12100000,12100000,0,0
TIKI,dien-gia-dung,25939131,"Bếp Gas Âm 3 Bếp Electrolux EGT7838CK (78cm)",3890000,3890000,0,0
TIKI,dien-gia-dung,89057370,"Nồi cơm điện cơ Tefal 0.7L - Thương hiệu Pháp - RK224168- Hàng chính hãng",750000,999000,249000,25
TIKI,dien-gia-dung,191592770,"Bộ dụng cụ pha cà phê GOAT STORY GINA Smart - màu trắng/ màu đen [Hàng Chính Hãng",6500000,6500000,0,0
TIKI,dien-gia-dung,262455791,"Nồi Nấu Cháo Chưng Yến Tiềm Thuốc Bắc Bear DDZ-A08T8 - Bản Tiếng Anh Có Kèm Khay Hấp Dung Tích 0.8 Lít Công Suất 200 W - Hàng Chính Hãng",578000,1099000,521000,47
TIKI,dien-gia-dung,192897286,"Bút thử nước TDS, dụng cụ đo TDS, máy đo độ cứng của nước - Hàng Chính Hãng",77000,140000,63000,45
TIKI,dien-gia-dung,141729752,"Máy ép trái cây Biochef 666 - Máy ép chậm - Hàng Chính Hãng",6375000,6375000,0,0
TIKI,dien-gia-dung,103093461,"Bếp gas mini Namilux PL2027PS - HÀNG CHÍNH HÃNG NAMILUX (MP)",398000,398000,0,0
TIKI,dien-gia-dung,41374565,"Máy Hút Bụi Nhỏ Cầm Tay Tự Làm Sạch Deerma DX900 - Hàng nhập khẩu",589500,589500,0,0
TIKI,dien-gia-dung,168114464,"Máy Lọc Nước 3M BREW110-MS | BREW120-MS | ICE140-S Chuẩn Nước Khoáng Uống Trực Tiếp - Nhập Khẩu Mỹ, Hàng Chính Hãng 3M - BREW110MS BREW120MS ICE140S HF10-MS HF20-MS HF40-S",5500000,5500000,0,0
TIKI,dien-gia-dung,421053,"Máy lọc nước không điện Coway Nadi (L) P-300L - Hàng chính hãng",5399000,6000000,601000,10
TIKI,dien-gia-dung,101825652,"Đèn khò gas mini Namilux TS1922RF - HÀNG CHÍNH HÃNG NAMILUX (MP)",199000,199000,0,0
TIKI,dien-gia-dung,46768480,"Nồi cơm điện Panasonic SR-CP108NRA 1Lit - Chế độ giữ ấm 12 tiếng - Công nghệ nấu Fuzzy điều chỉnh nhiệt độ theo từng loại gạo - Hàng Chính Hãng",2490000,2710000,220000,8
TIKI,dien-gia-dung,75362212,"Máy nhào bột, đánh trứng, trộn thực phẩm làm bánh 5 lít 1200W SC205A Hàng Chính Hãng",1990000,1990000,0,0
TIKI,dien-gia-dung,125087302,"Máy xay sinh tố Bluestone BLB-5329 - Kèm 3 Cối Đa Dụng, Hàng chính hãng",849000,1199000,350000,29
TIKI,dien-gia-dung,101234930,"Hút bụi cầm tay không dây hút được chất lỏng tự giặt giẻ lau LIECTROUX I5 PRO Hàng chính hãng",5325000,5490000,165000,3
TIKI,dien-gia-dung,81438823,"Bộ 2 chổi quét góc - Phụ kiện Robot hút bụi lau nhà Liectroux C30B - Hàng chính hãng",150000,150000,0,0
TIKI,dien-gia-dung,1941995,"Lò Nướng Sharp EO-A323RCSV-ST (32L) - Hàng Chính Hãng",1848000,1848000,0,0
TIKI,dien-gia-dung,54512463,"Phao cơ chống tràn mini dùng trong máy lọc nước, hệ thống R.O, bồn nước nhỏ",63000,90000,27000,30
TIKI,dien-gia-dung,91248120,"Quạt hút thông gió phi 150 - Quạt hút gió đồng trục cấp khí tươi cho công trình nhà - Hàng chính hãng GDXLFJ siêu chống ồn",1250000,1250000,0,0
TIKI,dien-gia-dung,14035887,"Nồi cơm điện Cao tần Cuckoo CRP-HMF1070SB 1.8L nhập khẩu Hàn quốc",5650000,5650000,0,0
TIKI,dien-gia-dung,37963346,"Combo Gói Cà Phê CULI Nguyên Chất Đặc Biệt 300gr Dạng Hạt + Máy Xay Cà Phê Cầm Tay - Coffee New",309000,319000,10000,3
TIKI,dien-gia-dung,33693907,"Nồi Chiên Nướng Chân Không Đa Năng Magic Korea A78N 4.6L lít- Hàng Chính Hãng",1320000,2390000,1070000,45
TIKI,dien-gia-dung,134333384,"Máy đánh trứng Lock&Lock Hand Mixer EJM501DGRY 250-300W - Hàng chính hãng",535100,973000,437900,45
TIKI,dien-gia-dung,25939125,"Bếp Gas Âm 3 Bếp Electrolux EGT9239CK (90cm)",4090000,4090000,0,0
TIKI,dien-gia-dung,181358607,"Máy xay sinh tố LEBENLANG gồm 2 cối tích hợp bình chứa dung tích 300-600ml, công suất 350W, model LBSP8648 - hàng chính hãng",697000,900000,203000,23
TIKI,dien-gia-dung,94091446,"BioloMix Sous Vide máy nấu chậm nồi nấu chân không 1200W điều khiển LED và App Wifi thông minh thế hệ thứ 3",2990000,2990000,0,0
TIKI,dien-gia-dung,125363043,"Bình đun nước kiêm giữ nhiệt 2 trong 1 cao cấp Morphy Richards MR6060 cảm biến nhiệt độ NTC THERMISTOR Công suất: 60-350W - Hàng nhập khẩu",991000,991000,0,0
TIKI,dien-gia-dung,242442857,"Bàn là hơi nước cầm tay Lebenlang công suất 1500W, dung tích 300ml model LBD528 - hàng chính hãng",642000,950000,308000,32
TIKI,dien-gia-dung,72726152,"MÁY LỌC KHÔNG KHÍ ĐA NĂNG - Lọc Không Khí Cho Nhiều Không Gian Và Khử Mùi Hiệu Quả, Lõi Lọc HEPA Lọc Sạch Bụi Mịn PM2.5 (Màu đen) - Hàng Nhập Khẩu",799000,799000,0,0
TIKI,dien-gia-dung,192113300,"Bàn Ủi Hơi Nước Đứng Philips GC482/29, 1600W-1.4Lit, Hàng Chính Hãng",1299000,1599000,300000,19
TIKI,dien-gia-dung,37941179,"Nồi cơm điện nắp gài Sharp KS-18TJV 1,8L - Hàng Chính Hãng",349000,700000,351000,50
TIKI,dien-gia-dung,190543782,"Máy hút mùi âm tủ Junger HRJ-701 - Hàng chính hãng",10300000,10300000,0,0
TIKI,dien-gia-dung,250066507,"Nồi Chiên Không Dầu Kalite KL-1500 Nướng Gà Nguyên Con Gồm 10 Chương Trình Cài Đặt Dung Tích 15 Lít Công Suất 1700 W - Hàng Chính Hãng",3589000,5899000,2310000,39
TIKI,dien-gia-dung,55386294,"Máy xay thịt công suất 1000W, cối inox 6L Osako OST-1020-hàng chính hãng",1379000,1379000,0,0
TIKI,dien-gia-dung,74219216,"Máy May Brother FS60X - Hàng Chính Hãng",7190000,7190000,0,0
TIKI,dien-gia-dung,53029881,"Lõi Lọc Bình Lọc Nước Gia Đình BellaVie Water",1260000,1260000,0,0
TIKI,dien-gia-dung,187063412,"Máy Xay Sinh Tố Cầm Tay Bear, Nghiền Hoa Quả Công Suất Lớn, Chất Liệu An Toàn LLJ-D04A1 - Hàng Chính Hãng",529000,790000,261000,33
TIKI,dien-gia-dung,13224952,"Bếp gas khè công nghiệp Redhome 168C, tặng dây dẫn gas áp cao - Hàng chính hãng",550000,550000,0,0
TIKI,dien-gia-dung,73119972,"Ấm đun nước Kim Cương 5 lít (Siêu tốc) - KC-ST50 - Hàng chính hãng (giao màu ngẫu nhiên)",339000,390000,51000,13
TIKI,dien-gia-dung,107632066,"Phin lọc 2 cup máy pha cà phê Zamboo- Hàng Chính Hãng",100000,100000,0,0
TIKI,dien-gia-dung,182733310,"Nồi cơm điện áp suất cao tần Zojirushi NP-HRQ18-XT 1,8L, sản xuất tại Nhật, hàng chính hãng",15500000,15500000,0,0
TIKI,dien-gia-dung,99081935,"Nồi Nấu Chậm Bear DDZ-A08G2 - Phiên Bản Quốc Tế - Hàng Chính Hãng",489000,528900,39900,8
TIKI,dien-gia-dung,54420142,"Thiết bị lọc nước đầu nguồn – lọc nước sinh hoạt có đồng hồ áp – Hàng chính hãng",102000,120000,18000,15
TIKI,dien-gia-dung,102013909,"Bếp nướng gas hồng ngoại Namilux NA-24N - HÀNG CHÍNH HÃNG NAMILUX (MP)",520000,520000,0,0
TIKI,dien-gia-dung,118100277,"Nồi cơm điện cao tần IR Cuchen CJR-PM0610RHW (Nhập khẩu chính hãng)",18499000,18499000,0,0
TIKI,dien-gia-dung,14340665,"Tê đều nối nhanh 3 đầu dây 6 (702-Q003A) - Hàng chính hãng",6000,20000,14000,70
TIKI,dien-gia-dung,38243191,"Nồi chiên không dầu Philips HD9654 - Hàng nhập khẩu",4999000,4999000,0,0
TIKI,dien-gia-dung,34593198,"Bộ 3 ly lọc 20 inch - Hàng Chính Hãng",850000,850000,0,0
TIKI,dien-gia-dung,121268438,"Bếp từ đôi Sunhouse SHB9101 - Hàng chính hãng",3700000,3700000,0,0
TIKI,dien-gia-dung,197162043,"Nồi chiên không dầu 8L điện tử Fujihome Nhật Bản tự ngắt (đi kèm gắp), Lò chiên nướng không khí ko dầu cơ không hơi nước air fryer 8 lít - Hàng Nhập Khẩu",1468000,1468000,0,0
TIKI,dien-gia-dung,540124,"Máy Cạo Râu Flyco - FS-371VN",987000,987000,0,0
TIKI,dien-gia-dung,7647624,"Lò Nướng Electrolux EOT30MXC (30L) - Hàng chính hãng",1890000,1890000,0,0
TIKI,dien-gia-dung,192683798,"Bàn là, ủi hơi nước cầm tay Philips GC362/88 công suất 1300W - Hàng Nhập Khẩu",1444000,1444000,0,0
TIKI,dien-gia-dung,78631962,"Quạt Đứng điều khiển từ xa DR1608 - Màu ngẫu nhiên - Hàng Chính Hãng",775000,775000,0,0
TIKI,dien-gia-dung,164084870,"Robot Hút Bụi Lau Nhà Tự Đổ Rác Và Giặt Giẻ Ecovacs Deebot X1 Omni Thông Minh Công Suất Hút Lên Tới 5000pa Hệ thống AIVI 3D Thế Hệ 2 Có Sức Mạnh Tính Toán Hơn 8 Tần T8 Aivi, 16 Lần T9 - Hàng Chính Hãng",18900000,31900000,13000000,41
TIKI,dien-gia-dung,31889220,"Quạt điện Senko mẫu mới BX1212 tiện lợi cao cấp màu ngẫu nhiên - Hàng Chính Hãng",325000,325000,0,0
TIKI,dien-gia-dung,157449477,"Máy hút bụi gia đình Philips công suất lớn 1500W có hộc chứa XB2023 /81 - Hàng nhập khẩu",2086000,2150000,64000,3
TIKI,dien-gia-dung,95648522,"MÁY ÉP TRÁI CÂY BIOCHEF 555 - hàng chính hãng",3888000,3888000,0,0
TIKI,dien-gia-dung,75312780,"Máy Làm Đồ Ăn Sáng Sandwich Hamilton Beach 25475-SAU - Hàng nhập khẩu",1187000,1187000,0,0
TIKI,dien-gia-dung,45464168,"Combo 01 co 21 ra dây 6mm, 01 co 21 ra dây 10mm (nối nhanh)",32000,40000,8000,20
TIKI,dien-gia-dung,164353547,"Bình thủy điện Khaluck KL-955 (Bạc) HÀNG CHÍNH HÃNG",799000,799000,0,0
TIKI,dien-gia-dung,52253301,"LIECTROUX Q8000 robot hút bụi,điều hướng bản đồ,điều khiển bằng APP,có tường ảo,đèn UV khử trùng,Lực hút 3000Pa;lau hút một thể mua 1 được 2",4623000,4623000,0,0
TIKI,dien-gia-dung,95036200,"Máy Tạo Nước Từ Không Khí Aquaboy (Màu Đen) Hàng Nhập Khẩu",50000000,50000000,0,0
TIKI,dien-gia-dung,70649593,"Máy Hút Chân Không Không Kén Túi Shineye P280A Hút Khô, Hút Ướt, Hàn Độc Lập Hàng Chính Hãng",1179000,1179000,0,0
TIKI,dien-gia-dung,197164230,"Nồi chiên không dầu 9.2L Nhật Bản Fujihome tự ngắt (kèm gắp), Lò chiên nướng không khí cơ 9 lít không hơi nước air fryer - Hàng Nhập Khẩu",1468000,1468000,0,0
TIKI,dien-gia-dung,170897508,"Lò hấp nướng chiên không dầu 20 lít Panasonic NU-SC180BYUE - Hàng chính hãng",8049000,12530000,4481000,36
TIKI,dien-gia-dung,133775737,"Bình đun siêu tốc 5 Lít, ấm điện bền đẹp, nấu nước an toàn Fujika FJ-SD50  - Hàng chính hãng",264000,264000,0,0
TIKI,dien-gia-dung,250752492,"Máy Xay Thực Phẩm Đa Năng, Máy Xay Ăn Dặm BEAR QSJ-D02Q1 Xay Cực Êm An Toàn Vệ Sinh Dung Tích 0.6 Lít Công Suất 200 W - Hàng Nhập Khẩu",636000,1119000,483000,43
TIKI,dien-gia-dung,24598536,"Máy Tạo Kiểu Tóc Panasonic EH-HV11-P645 (Hồng) - Hàng Chính Hãng",740000,740000,0,0
TIKI,dien-gia-dung,106066364,"Máy Nhồi, Trộn Bột, Đánh Trứng, Xay Ép Đa Năng Klarstein Lucia Rosa - Hàng Chính Hãng",5233000,5340000,107000,2
TIKI,dien-gia-dung,95569739,"Tông đơ cắt tóc không dây Kemei KM-27C chuyên dụng cắt tóc trẻ em sơ sinh, cắt tóc cá nhân và gia đình, lưỡi sứ an toàn dễ sử dụng có 4 mức điều chỉnh lưỡi",170000,199000,29000,15
TIKI,dien-gia-dung,24862374,"MÁY LỌC NƯỚC PURE 258 NUVO – CÔNG NGHỆ LỌC SẠCH (HÀNG CHÍNH HÃNG)",1520000,1520000,0,0
TIKI,dien-gia-dung,1942005,"Lò Nướng Sharp EO-A383RCSV-ST (38L) - HÀNG CHÍNH HÃNG",2090000,2090000,0,0
TIKI,dien-gia-dung,498202,"Bếp Ga Dương Đôi Rinnai RV-6Double Glass(B) - Đen- Hãng chính hãng",2060000,2060000,0,0
TIKI,dien-gia-dung,41880917,"Máy tạo ẩm siêu âm, khuếch tán tinh dầu, điều hòa tự động thiết kế 2019 - Hàng Chính Hãng",625000,625000,0,0
TIKI,dien-gia-dung,71072988,"Ca nấu lẩu, nấu mì đa năng mini ( giao màu ngẫu nhiên) Greencook 600W, dung tích 1.2L-Hàng chính hãng",695000,695000,0,0
TIKI,dien-gia-dung,36154427,"Bóng đèn UV 14w dài 300mm - 4 chấu - Hàng chính hãng",250000,250000,0,0
TIKI,dien-gia-dung,163566116,"Máy xay cà phê Solis Scala Zero Static - Thương hiệu uy tín đến từ Thuỵ Sĩ - Hàng nhập khẩu",2916000,2916000,0,0
TIKI,dien-gia-dung,50669832,"Quạt lửng Senko cao cấp Hàng Chính Hãng - LS1630",377000,377000,0,0
TIKI,dien-gia-dung,109563595,"Máy pha cà phê Nespresso cầm tay Wacaco Nanopresso - 5 Màu cơ bản - Kèm hộp chống sốc",2100000,2100000,0,0
TIKI,dien-gia-dung,138617973,"Đầu phun và hút làm sạch ghế sofa, nệm tích hợp với máy làm sạch thảm SE 4001, SE 4002 (Hàng chính hãng)",678900,716727,37827,5
TIKI,dien-gia-dung,146249620,"Nồi chiên không dầu OLIVO AF15 [HÀNG CHÍNH HÃNG] - Dung Tích 15 Lít - 16 Chức Năng",4190000,4190000,0,0
TIKI,dien-gia-dung,75701132,"Robot hút bụi lau nhà thông minh thương hiệu Đức Liectroux ZK901 - Hàng chính hãng",4650000,4650000,0,0
TIKI,dien-gia-dung,109347689,"Máy Lọc Nước Điện Giải Ion Kiềm Kangen LeveLuk K8 – Hàng Chính Hãng Nhập Khẩu Bởi Kim Long Phát",139000000,139000000,0,0
TIKI,dien-gia-dung,107186414,"Bộ lọc thay thế cho máy hút bụi Deerma DX115C - Hàng Nhập Khẩu",85000,90000,5000,6
TIKI,dien-gia-dung,950377,"Lò Vi Sóng Panasonic NN-SM33HMYUE (800W) - Hàng Chính Hãng",2490000,2490000,0,0
TIKI,dien-gia-dung,250731956,"Máy Sinh Tố Cầm Tay Bear LLJ-E03F1 Dung Tích 300 ML Công Suất 50 W - Hàng Nhập Khẩu",530000,1049000,519000,49
TIKI,dien-gia-dung,180223383," Bàn ủi khô Sunhouse SHD1072  - Hàng Chính Hãng",158900,158900,0,0
TIKI,dien-gia-dung,155255208,"Nồi cơm điện Mini Bluestone RCB-5512, Dung Tích 1.2L, Công Suất 500W, Hàng Chính Hãng",649000,999000,350000,35
TIKI,dien-gia-dung,145221825,"Máy hút mùi kính cong Sunhouse SHB6626 - Hàng chính hãng",3290000,3290000,0,0
TIKI,dien-gia-dung,21405040,"Quạt Bàn Panasonic F-400C-Hàng Chính Hãng",1080000,1080000,0,0
TIKI,dien-gia-dung,32453666,"Quạt Sạc Comet CRF0904 (3W)",157000,157000,0,0
TIKI,dien-gia-dung,196470905,"Cây nước nóng lạnh Nhật Bản Fujihome WD531C tiết kiệm điện, bình lọc tủ máy lọc nước nóng lạnh mini uống tự ngắt khóa vòi nóng- Hàng Nhập Khẩu",2256000,2256000,0,0
TIKI,dien-gia-dung,108824194,"Bếp gas đôi inox Windo 718[HÀNG CHÍNH HÃNG]",519000,519000,0,0
TIKI,dien-gia-dung,78631843,"Máy sấy tay cảm ứng 2 chế độ SOKIMI SM-2160",1250000,1250000,0,0
TIKI,dien-gia-dung,142827909,"Nồi cơm điện tử Happy Cook 1.2L HDC-WNB120W - Hàng Chính Hãng",1227000,1227000,0,0
TIKI,dien-gia-dung,90460887,"Máy lọc không khí tạo ẩm Sharp KI-L80V-T( 62m2) - Hàng chính hãng",12149000,15690000,3541000,23
TIKI,dien-gia-dung,91471570,"[Quà Tặng] Máy uốn xoăn tóc cao cấp Hàn Quốc xoay trục 360 độ Koremi NA-886- Chuyên nghiệp cho Salon [ Chính Hãng",450000,450000,0,0
TIKI,dien-gia-dung,197581690,"Quạt Trần Mini 3 Cánh Giá Rẻ LÊ GIA LGFAN730V - Chiều Cao 22cm - Sải Cánh 61cm - Bảo Hành 5 Năm",2720000,2750000,30000,1
TIKI,dien-gia-dung,43815413,"Ấm Sắc Thuốc Seika 3.2L - SKS326 (Gốm Sứ Bát Tràng) - Hàng chính hãng ",621000,640000,19000,3
TIKI,dien-gia-dung,195981455,"Bếp chiên nhúng điện 12 Lít ",1990000,1990000,0,0
TIKI,dien-gia-dung,76076632,"Máy Hút Mùi Junger H90 - Hàng Chính Hãng",14950000,14950000,0,0
TIKI,dien-gia-dung,78631871,"Quạt Đứng Thân Sắt F32 Senko DTS1607 - Màu ngẫu nhiên - Hàng Chính Hãng",450000,450000,0,0
TIKI,dien-gia-dung,197143670,"Quạt trần Model: QT06 ASIA ( hàng chính hãng) - Trắng",1184400,1184400,0,0
TIKI,dien-gia-dung,160518517,"Bếp Điện Từ Đơn Cảm Ứng Đặt Âm OWANI OW-2628ALL - Hàng Chính Hãng",922000,950000,28000,3
TIKI,dien-gia-dung,8347279,"Máy Xay Sinh Tố Công Nghiệp 1500W OSAKO Đa Năng Dung Tích 2L Có Đủ Linh Kiện Thay Thế - Hàng Chính Hãng",1390000,1390000,0,0
TIKI,dien-gia-dung,155366978,"Máy tạo ẩm siêu âm khử khuẩn TotalComfort  Deluxe Homedics UHE-CMTF90 - Hàng nhập khẩu USA",5490000,5490000,0,0
TIKI,dien-gia-dung,51201505,"Máy lọc nước RO Philips AUT2015/74 - Hàng Chính Hãng",6885000,9042000,2157000,24
TIKI,dien-gia-dung,162362957,"Máy nấu chậm Sous vide BioloMix SV-8008 công suất 1200W - Hàng Nhập Khẩu",2811000,2811000,0,0
TIKI,dien-gia-dung,189684575,"Máy hút mùi Junger HRJ-700 - Hàng Chính Hãng",11650000,11650000,0,0
TIKI,dien-gia-dung,193186380,"Máy Làm Sữa Hạt Olivo CB22 Pro, 1800W-1.75Lit,14 Chế Độ Xay Nấu Đa Năng, Hàng Chính Hãng",2549000,3999000,1450000,36
TIKI,dien-gia-dung,198262418,"Bình lọc nước Daily Philips AWP2732PK/97 - Hàng chính hãng",650000,888000,238000,27
TIKI,dien-gia-dung,116254794,"Tông đơ Cắt Tóc Trẻ Em Jichen - Hàng Chính Hãng",99000,99000,0,0
TIKI,dien-gia-dung,198269382,"Bình lọc nước Daily Philips AWP2732GN/97 - Hàng chính hãng",650000,950000,300000,32
TIKI,dien-gia-dung,108404492,"Quạt trần ASIA thiết kế hiện đại siêu tiết kiệm điện",1360000,1360000,0,0
TIKI,dien-gia-dung,368310,"Nồi Cơm Điện Nắp Rời Sharp KSH-D77V (7L) - Hàng chính hãng",2500000,2500000,0,0
TIKI,dien-gia-dung,49036800,"Máy Ép Trái Cây Tốc Độ Chậm Dành Cho Công Nghiệp Kuvings CS520CB",18660000,23990000,5330000,22
TIKI,dien-gia-dung,138674766,"Ấm đun nước siêu tốc điều chỉnh nhiệt độ Morphy Richards MR6070 công suất 1800W, dung tích 1.5L, tích hợp chế độ giữ ấm ở các mức lựa chọn- Hàng chính hãng",1507000,1507000,0,0
TIKI,dien-gia-dung,1733789,"Quạt Treo Tường 2 Dây Senko TC1886 (45W) - Hàng Chính Hãng",479000,479000,0,0
TIKI,dien-gia-dung,119904565,"Máy Hút Mùi Đảo MOON ISLAND - ELICA Ý - Hàng Chính Hãng",46800000,46800000,0,0
TIKI,dien-gia-dung,112357333,"Máy Hút Mùi Âm Tủ FILO - ELICA Ý - Hàng Chính Hãng",32800000,32800000,0,0
TIKI,dien-gia-dung,179693788,"Lõi lọc nước Kangaroo số 4 – Màng lọc RO Hàng Chính Hãng",610000,610000,0,0
TIKI,dien-gia-dung,36133134,"Adaptor 14w-Hàng chính hãng",250000,250000,0,0
TIKI,dien-gia-dung,197497487,"Nồi nấu lẩu đa năng Bear DRG-C12K1 - Hàng chính hãng",509000,690000,181000,26
TIKI,dien-gia-dung,533872,"Lò Vi Sóng Sharp R-203VN-M - 20L (Bạc) - Hàng chính hãng",1479000,1750000,271000,15
TIKI,dien-gia-dung,198530639,"Quạt treo tường 1 dây Senko T1680 ( Màu ngẫu nhiên) - Hàng chính hãng",325000,325000,0,0
TIKI,dien-gia-dung,28926253,"BÌNH NÓNG BÌNH LẠNH. Hàng chính hãng",920000,920000,0,0
TIKI,dien-gia-dung,158785461,"Nồi áp suất đa năng Instant Pot Duo 60  5,7L 7 in 1 - hàng chính hãng",3190000,3190000,0,0
TIKI,dien-gia-dung,178513031,"Bếp Từ Đôi Sakura Công Nghệ HEATTECH SE-1270B Hàng Chính Hãng ",9900000,9900000,0,0
TIKI,dien-gia-dung,92135898,"Bếp điện từ, bếp từ đơn 2000W Fujika - tặng kèm nồi lẩu inox-hàng chính hãng",600000,600000,0,0
TIKI,dien-gia-dung,9933723,"Nồi Áp Suất Anod Sunhouse SHA8604 (6L) Màu Vàng - Hàng chính hãng",629000,648000,19000,3
TIKI,lam-dep-suc-khoe,632680,"Dầu gội Selsun chống gàu, sạch gàu & hết ngứa da đầu Selsun Anti-Dandruff Shampoo 100ml",79900,99000,19100,19
TIKI,lam-dep-suc-khoe,273598230,"Máy Tăm Nước Không Dây LocknLock Cordless Oral Irrigator",758000,1263000,505000,40
TIKI,lam-dep-suc-khoe,5902685,"Sữa rửa mặt vitamin làm sáng da, mờ sẹo thâm dạng kem Acnes Vitamin Cleanser 100g",56300,70000,13700,20
TIKI,lam-dep-suc-khoe,2738475,"Bộ 3 Hộp Silcot Bông Trang Điểm (bông tẩy trang) Nhật Bản (82 Miếng/Hộp)",96900,126000,29100,23
TIKI,lam-dep-suc-khoe,116438272,"Kem Dưỡng Cấp Nước Cho Da Hỗn Hợp Neutrogena Hydro Boost Water Gel",110000,110000,0,0
TIKI,lam-dep-suc-khoe,1672157,"Bao cao su Durex Invisible Extra Thin Extra Sensitive 1 Hộp 10 Bao",209700,317000,107300,34
TIKI,lam-dep-suc-khoe,158399593,"[CHÍNH HÃNG] Một thùng 300 CÁI khẩu trang 4 lớp KF94 kháng khuẩn, chống bụi mịn, công nghệ 4D Hàn Quốc",210000,320000,110000,34
TIKI,lam-dep-suc-khoe,193879341,"Gel bôi trơn Feelex Lubricant mát lạnh, ấm nóng, siêu trơn - Lọ 250ml",97000,99000,2000,2
TIKI,lam-dep-suc-khoe,25108217,"Sữa rửa mặt ngăn ngừa mụn Acnes Creamy Wash 100g",56300,70000,13700,20
TIKI,lam-dep-suc-khoe,22254660,"Combo Dầu Gội, Dầu Xả TRESEMME Keratin Smooth Dưỡng tóc khô xơ rối Công thức chuẩn salon Hydrolyzed Keratin trong Dầu Gội và dầu Xả dưỡng Tóc Vào Nếp Suôn Mượt 640g, 620g",300000,462000,162000,35
TIKI,lam-dep-suc-khoe,10071383,"Sữa Tắm Lifebuoy Detox Và Sạch Sâu Khỏi Bụi Mịn Pm2.5 Detox Bảo Vệ Khỏi Vi Khuẩn Gây Mụn Cơ Thể Matcha & Khổ Qua Chai 800G",162000,214500,52500,24
TIKI,lam-dep-suc-khoe,121485346,"Bàn Chải Điện P/S S100 PRO Trắng Răng Công Nghệ Sóng Âm Đen Nhám Chải Sạch Mảng Bám Tới 10X 1 Bộ",791000,1130999,339999,30
TIKI,lam-dep-suc-khoe,1672153,"Bao cao su Durex Performa 12 bao",215000,300000,85000,28
TIKI,lam-dep-suc-khoe,767101,"Bao cao su Durex Kingtex 12 bao",115000,185000,70000,38
TIKI,lam-dep-suc-khoe,460943,"Bộ Đôi Nước Súc Miệng Hương Bạc Hà Listerine Cool Mint (750ml/ Chai) - 8850007800071",338000,338000,0,0
TIKI,lam-dep-suc-khoe,78280482,"Bộ 2 Chai Nước Súc Miệng Listerine Giúp Hơi Thở Thơm Mát Cool Mint Zero Alcohol 750mlx2",338000,338000,0,0
TIKI,lam-dep-suc-khoe,46179013,"Máy Massage Cầm Tay KINGTECH KH-320 - 6 Cấp Độ, Hỗ Trợ Mát Xa Chuyên Sâu, Giảm Đau Cơ, Cứng Khớp - Quà Tặng Cho Sức Khỏe",510000,950000,440000,46
TIKI,lam-dep-suc-khoe,1313871,"Kem chống nắng Sunplay cực mạnh dạng sữa Sunplay Super Block SPF 81, PA++++ 30g",82600,103000,20400,20
TIKI,lam-dep-suc-khoe,55915384,"Nước hoa hồng không chứa cồn Neutrogena Alcohol Free Toner 150ml ",133000,133000,0,0
TIKI,lam-dep-suc-khoe,15795542,"Sữa Tắm Trắng Da Giữ Ẩm Hatomugi Nhật Bản 800ml",90900,119700,28800,24
TIKI,lam-dep-suc-khoe,190489303,"Khẩu trang KF94 - 4D trẻ em, từ 3 đến 11 tuổi, nhiều họa tiết, kháng virus dễ thở, không đau tai",8000,8000,0,0
TIKI,lam-dep-suc-khoe,796867,"Bao cao su Durex Invisible Extra Thin Extra Sensitive 1 Hộp 3 Bao",76100,95000,18900,20
TIKI,lam-dep-suc-khoe,72644676,"Gối Massage Đa Năng KingTech KP-315 - Máy Mát xa Toàn Thân Nhiệt Hồng Ngoại - Chuyên Sâu Cho Cổ, Vai Gáy, Lưng Dưới, Đùi, Chân - Sử Dụng Tại Nhà, Văn Phòng, Trên Ô Tô - Quà Tặng Cho Bạn Bè, Người Thân",745000,1250000,505000,40
TIKI,lam-dep-suc-khoe,1634981,"Giấy thấm dầu kiểm soát nhờn, ngừa mụn Acnes Oil Remover Paper 100 tờ",29900,33000,3100,9
TIKI,lam-dep-suc-khoe,2042227,"Bao cao su Durex Invisible Extra Thin Extra Lubricated 1 Hộp 10 Bao",230000,330000,100000,30
TIKI,lam-dep-suc-khoe,66640235,"Combo Dove Phục Hồi Hư Tổn Dầu Gội 640g + Kem Xả 610g",245000,340000,95000,28
TIKI,lam-dep-suc-khoe,74450527,"Máy Xông Tinh Dầu Cao Cấp Tặng 3 Chai Tinh Dầu Sả Chanh + Bạc Hà + Quế. Máy Khuếch Tán Tinh Dầu Có Remote Điều Khiển Từ Xa Chuyên Dụng Xông Tinh Dầu",248000,596000,348000,58
TIKI,lam-dep-suc-khoe,630777,"Kem chống nắng Sunplay cực mạnh dạng sữa Sunplay Super Block SPF 81, PA++++ 70g",148000,185000,37000,20
TIKI,lam-dep-suc-khoe,168562118,"Dung Dịch Vệ Sinh Nam X2 Manly - Làm sạch tức thì Lưu hương 24h dung tích 150g Cocayhoala",150000,200000,50000,25
TIKI,lam-dep-suc-khoe,57243183,"Máy Tăm Nước Vệ Sinh Răng Miệng Xiaomi Mijia MEO701 - Hàng Nhập Khẩu",599000,990000,391000,39
TIKI,lam-dep-suc-khoe,35761444,"Hộp Khẩu Trang 3D Mask Unicharm Nhật Bản Ngăn Ngừa Khói Bụi Chống Ô Nhiễm (100 miếng)",236000,315000,79000,25
TIKI,lam-dep-suc-khoe,87913382,"Tinh Dầu Xông Phòng Nguyên Chất, Tự Chọn Mùi | Chính Hãng, Có Kiểm Định Chất Lượng | Tinh Dầu TIDAMO Xông Thơm Phòng, Khử Khuẩn, Bảo Vệ Sức Khỏe và Đuổi Muỗi",38000,148000,110000,74
TIKI,lam-dep-suc-khoe,73638938,"Tinh Dầu Xông Phòng Sả Chanh 100ML Nguyên Chất Nhập Khẩu - Tinh dầu Sả Chanh Giúp Bảo Vệ Sức Khỏe, Kháng Khuẩn, Đuổi Muỗi Và Thư Giãn Tinh Thần",198000,396000,198000,50
TIKI,lam-dep-suc-khoe,121485349,"[Nhập Coupon giảm ngay 50K]Bàn Chải Điện P/S S100 PRO - Công Nghệ Sóng Âm, Chải Sạch Mảng Bám Tới 10X - Trắng Sáng",830000,1130999,300999,27
TIKI,lam-dep-suc-khoe,108535196,"Bao cao su Sagami Superthin - Mỏng - Kiểu truyền thống - Hộp 10 chiếc",85000,120000,35000,29
TIKI,lam-dep-suc-khoe,68421547,"Combo 2 Dầu gội Romano hương nước hoa 650g/chai",289000,382000,93000,24
TIKI,lam-dep-suc-khoe,169246554,"(Vải tốt) Thùng 300 cái Khẩu Trang KF94 4D SKY MASK Hàn Quốc - Chống Bụi Mịn Và Kháng Khuẩn (Chọn màu)",169000,169000,0,0
TIKI,lam-dep-suc-khoe,54640942,"Khẩu Trang Y Tế TDCare 4 Lớp-Màu Trắng-Hộp 50 Cái",48000,48000,0,0
TIKI,lam-dep-suc-khoe,127026903,"Combo 2 Nước rửa tay sạch khuẩn Lifebuoy Bạc Bảo Vệ và Sữa Dưỡng Ẩm Chai 450G",134000,156000,22000,14
TIKI,lam-dep-suc-khoe,98872338,"Máy Massage Cầm Tay Cao Cấp KINGTECH KH-720 - 20 Cấp Độ, Hỗ Trợ Mát Xa Chuyên Sâu, Giảm Đau Cơ, Cứng Khớp - Chính Hãng",1106000,1850000,744000,40
TIKI,lam-dep-suc-khoe,98605258,"Bao cao su Durex Jeans Hộp 30 bao",262000,490000,228000,47
TIKI,lam-dep-suc-khoe,191680827,"Kem chống nắng nâng tông kiềm dầu innisfree Tone Up No Sebum Sunscreen EX SPF 50+ PA++++ 60 mL (New 2023)",405000,450000,45000,10
TIKI,lam-dep-suc-khoe,179988643,"Combo 2 Nước Rửa Tay Lifebuoy Chăm Sóc Da Giúp Dưỡng ẩm Mềm Mại Và Bảo Vệ Khỏi 99.9% Vi Khuẩn Trên Tay Chai 450G",155000,156000,1000,1
TIKI,lam-dep-suc-khoe,179980125,"Combo 2 Nước Rửa Tay Lifebuoy Bảo Vệ Vượt Trội 10 Giúp Sạch Khuẩn Và Bảo Vệ Vượt Trội Khỏi 99.9% Vi Khuẩn Tốt Nhất Chai 450g",155000,156000,1000,1
TIKI,lam-dep-suc-khoe,75523405,"Combo 3 Tinh Dầu Sả Chanh + Tinh Dầu Bạc Hà + Tinh Dầu Oải Hương (Lavender) - Tinh Dầu Xông Phòng Nguyên Chất Giúp Thư Giãn, Đuổi Muỗi Và Thơm Phòng (3 chai 10ML)",78000,176000,98000,56
TIKI,lam-dep-suc-khoe,121485363,"[Coupon giảm 50K]Bàn Chải Điện P/S S100 PRO Trắng Răng Công Nghệ Sóng Âm Xanh Chải Sạch Mảng Bám Tới 10X 1 bộ",830000,1130999,300999,27
TIKI,lam-dep-suc-khoe,91565733,"Chỉ nha khoa SGS nhập khẩu Hàn Quốc - 500D hương bạc hà mới",35000,70000,35000,50
TIKI,lam-dep-suc-khoe,385654,"Bao cao su Durex Performa 3 bao",62000,77000,15000,19
TIKI,lam-dep-suc-khoe,92146086,"Combo Bao cao su Durex Invisible Extra Thin Extra Lubricated 10 Bao và Extra Sensitive 10 Bao",608000,608000,0,0
TIKI,lam-dep-suc-khoe,74527291,"Máy Xông Tinh Dầu Tặng 3 Tinh Dầu Sả Chanh + Bạc Hà + Quế. Máy Khuếch Tán Tinh Dầu Có Remote Điều Khiển Từ Xa Chuyên Dụng Xông Tinh Dầu Cho Phòng Lớn",278000,656000,378000,58
TIKI,lam-dep-suc-khoe,50699284,"Nước tẩy trang Công Nghệ Micella Bioderma Sensibio H2O",445000,525000,80000,15
TIKI,lam-dep-suc-khoe,202062554,"Sữa Tắm Lifebuoy Sạch Khuẩn Bảo Vệ Vượt Trội Mạnh Mẽ Chứa Ion Bạc+ Hỗ Trợ Cùng Đề Kháng Da Tự Nhiên Chai 1000G",173000,197000,24000,12
TIKI,lam-dep-suc-khoe,96593702,"Tinh Dầu Nguyên Chất Treo Xe Hơi, Treo Phòng Gia Đình| Tự Chọn Mùi, Có Kiểm Định Chất Lượng| Tinh Dầu TIDAMO Treo Thơm Phòng, Khử Mùi Xe Hơi, Thư Giản và Đuổi Muỗi",23000,88000,65000,74
TIKI,lam-dep-suc-khoe,25074713,"Phấn phủ kiềm dầu dạng bột innisfree No Sebum Mineral Powder 5g",132000,180000,48000,27
TIKI,lam-dep-suc-khoe,36987686,"Dầu gội dược liệu Antisol - Ngăn ngừa nấm da đầu, gàu, ngứa da đầu",283000,283000,0,0
TIKI,lam-dep-suc-khoe,907522,"Viên uống bổ mắt Lutein Rohto V5 ( Hộp 30 viên)",390000,485000,95000,20
TIKI,lam-dep-suc-khoe,1672211,"Gel bôi trơn Durex Play Warming 100ml",162000,194000,32000,16
TIKI,lam-dep-suc-khoe,20541866,"Dầu gội Selsun chống gàu, sạch gàu & hết ngứa da đầu Selsun Anti-Dandruff Shampoo 50ml",50500,59000,8500,14
TIKI,lam-dep-suc-khoe,212219580,"Bàn Chải Đánh Răng Điện LocknLock ENR346WHT - DC3.7V, Trọng Lượng 235g, Sạc Không Dây - Màu Trắng",864000,1664000,800000,48
TIKI,lam-dep-suc-khoe,116446788,"Sữa Tắm pH 5.5 Johnson’s Adult - Dung Tích 750ml",187000,187000,0,0
TIKI,lam-dep-suc-khoe,90683425,"Bao Cao Su Durex Jeans",40000,50000,10000,20
TIKI,lam-dep-suc-khoe,56381615,"Nước Tẩy Trang Thanh Lọc Và Làm Sạch Sâu Neutrogena Deep Clean Micellar Purifying Water 400ml",220000,220000,0,0
TIKI,lam-dep-suc-khoe,128912879,"Túi chườm bụng kinh 700ml, túi chườm nóng giảm đau bụng đau lưng nam tặng nữ",169000,169000,0,0
TIKI,lam-dep-suc-khoe,1537315,"Gel bôi trơn Durex K-Y Jelly 50g - KY Jelly",78000,90000,12000,13
TIKI,lam-dep-suc-khoe,260844985,"Kem Làm Mờ Sẹo Thâm, Sẹo Rỗ, Sẹo Lõm Scar Esthetique của Rejuvaskin - thương hiệu hỗ trợ trị sẹo Hoa Kỳ ",320000,400000,80000,20
TIKI,lam-dep-suc-khoe,118708687,"Máy Đo Nồng Độ Oxy Trong Máu và Nhịp Tim Dạng Kẹp Ngón Tay KINGTECH PULSE SPO2 - Hàng Chuẩn",216000,495000,279000,56
TIKI,lam-dep-suc-khoe,35526543,"Sữa Rửa Mặt Neutrogena Làm Sạch Sâu Và Kiểm Soát Nhờn",125000,125000,0,0
TIKI,lam-dep-suc-khoe,54058501,"Kem dưỡng trắng Hada Labo Perfect White Tranexamic Acid Cream 50g",192000,240000,48000,20
TIKI,lam-dep-suc-khoe,124480931,"Derma Forte Gel 15g - Adavanced, Giảm Mụn Trứng Cá, Mờ Sẹo, Dưỡng Da",122000,160000,38000,24
TIKI,lam-dep-suc-khoe,186434710,"Túi chườm nóng thảo dược giảm đau nhức mỏi mắt dùng lò vi sóng - Hapaku",179000,198000,19000,10
TIKI,lam-dep-suc-khoe,78280123,"Bộ 2 Chai Nước Súc Miệng làm trắng răng LISTERINE HEALTHY BRIGHT 750mlx2 Chai",374000,374000,0,0
TIKI,lam-dep-suc-khoe,13325863,"Sữa chống nắng nâng tông Skin Aqua Tone up Lavender cho da tối màu & da vàng Sunplay Skin Aqua Tone Up UV Milk Lavender SPF 50+ PA++++ 50g",199000,199000,0,0
TIKI,lam-dep-suc-khoe,426104,"Combo 3 Phim Thấm Dầu Jomi Mayan (70 Tờ) - Xanh",163000,198000,35000,18
TIKI,lam-dep-suc-khoe,108535197,"Bao cao su Sagami Spearmint - Hương bạc hà - Hộp 10 chiếc",105000,170000,65000,38
TIKI,lam-dep-suc-khoe,91256307,"Tinh Dầu Xông Phòng Nguyên Chất TIDAMO 50ML, Tự Chọn Mùi | Có Kiểm Định Chất Lượng | Sử Dụng Với Máy Xông Tinh Dầu Giúp Thơm Phòng, Khử Khuẩn, Tốt Cho Sức Khỏe và Làm Đẹp",68000,176000,108000,61
TIKI,lam-dep-suc-khoe,177911621,"Gương trang điểm để bàn có đèn LED Xiaomi Jordan Judy NV026 - Hàng Chính Hãng",159000,249000,90000,36
TIKI,lam-dep-suc-khoe,385574,"Durex Gel Bôi Trơn Play Massage 2 - in- 1 200ml",250000,300000,50000,17
TIKI,lam-dep-suc-khoe,50736325,"Sáp Vuốt Tóc Apestomen Volcanic Clay V4 + Lược Bán Nguyệt",249000,249000,0,0
TIKI,lam-dep-suc-khoe,68826659,"Bàn Chải Đánh Răng Điện LocknLock Portable Electric Toothbrush ENR236 (162 x 20 x 20 mm)",283000,337000,54000,16
TIKI,lam-dep-suc-khoe,73632586,"Tinh dầu Sả Chanh Thiên Nhiên Cao Cấp 50ML (Lemongrass) - Tinh dầu Sả Chanh Nguyên Chất TIDAMO Giúp Bảo Vệ Sức Khỏe, Kháng Khuẩn, Đuổi Muỗi Và Thư Giãn Tinh Thần",119000,238000,119000,50
TIKI,lam-dep-suc-khoe,108535251,"Bao cao su Sagami 002 - Siêu mỏng - Non Latex - Hộp 6 chiếc",300000,300000,0,0
TIKI,lam-dep-suc-khoe,8959289,"Tinh chất chống nắng nâng tông Skin Aqua Tone up Lavender cho da tối màu & da vàng Sunplay Skin Aqua Tone Up UV Essence Lavender SPF 50+ PA++++ 50g",159000,199000,40000,20
TIKI,lam-dep-suc-khoe,95253531,"Combo Dầu gội, Dầu xả & Kem ủ TRESEMME Keratin Smooth Dưỡng tóc vào nếp suôn mượt vào nếp suôn mượt Công thức chuẩn salon Hydrolyzed Keratin 640g, 620g, 180ml",395000,640000,245000,38
TIKI,lam-dep-suc-khoe,42889999,"Tẩy Da Chết Cà phê Đăk Lăk Cocoon 200ml",100000,125000,25000,20
TIKI,lam-dep-suc-khoe,17043131,"Dầu gội TRESEMME Keratin Smooth Cho tóc khô xơ rối Công thức Hydrolyzed Keratin Dưỡng Tóc Vào Nếp Suôn Mượt 850g",225000,276000,51000,18
TIKI,lam-dep-suc-khoe,10298023,"Saffron nhụy hoa nghệ tây Kingdom Herb Iran chính hãng loại thượng hạng hộp 1 gram",284000,519000,235000,45
TIKI,lam-dep-suc-khoe,48627056,"Máy Massage Cầm Tay Đa Năng KINGTECH  KT1768 - Mát Xa Chuyên Sâu Cho Cổ, Vai Gáy, Bụng, Lưng, Cánh Tay, Chân - Giảm Đau Mỏi Toàn Thân Cho Dân Văn Phòng, Gymer, Người Già, Người Lao Động Nặng - Món Quà Tuyệt Vời Cho Ông Bà, Bố Mẹ - Hàng Chính Hãng",509000,1050000,541000,52
TIKI,lam-dep-suc-khoe,19640804,"Cân điện tử thông minh Xiaomi Body Composition Scale 2 - Chính hãng",459000,599000,140000,23
TIKI,lam-dep-suc-khoe,16625449,"(Mẫu mới) Bộ Đôi Kem Dưỡng Da Ngày Và Đêm Trắng Hồng Rạng Rỡ Pond's White Beauty (45g)",274000,300000,26000,9
TIKI,lam-dep-suc-khoe,133245970,"Bộ 2 đầu bàn chải điện P/S - Sạch Sâu",169000,245455,76455,31
TIKI,lam-dep-suc-khoe,1672155,"Bao cao su Durex Kingtex 3 bao",35000,49000,14000,29
TIKI,lam-dep-suc-khoe,82403069,"[NEW] Khẩu Trang Anyguard Hàn Quốc 3 Lớp Màu Đen Chính Hãng -  Lọc 99% Vi Khuẩn, UV Protection (Hộp 30 Cái) - Bảo Vệ Hằng Ngày - Tiêu Chuẩn Công Nghệ Hàn Quốc - ISO 9001:2015, ISO 13485:2016, QCVN 01:2017/BTC",63281,63281,0,0
TIKI,lam-dep-suc-khoe,190252222,"Khẩu trang KF94 - 4D An Tâm, không xù lông, dễ thở, ko đứt dây, nhiều màu ( 10 cái/túi)",7900,7900,0,0
TIKI,lam-dep-suc-khoe,877362,"Combo 3 Bông Tẩy Trang Jomi (80 Miếng / Túi)",63100,90000,26900,30
TIKI,lam-dep-suc-khoe,68832828,"Cân Sức Khỏe Điện Tử LocknLock ENC516BLK Dùng Trong Gia Đình - 180kg",420000,702000,282000,40
TIKI,lam-dep-suc-khoe,174834852,"Sữa Rửa Mặt Dạng Gel Dành Cho Da Nhờn Mụn SVR Sebiaclear Gel Moussant 400ml",388000,555000,167000,30
TIKI,lam-dep-suc-khoe,66469559,"Máy Xông Tinh Dầu Siêu Âm Dung Tích Lớn 500ml Có Điều Khiển Từ Xa",179000,358000,179000,50
TIKI,lam-dep-suc-khoe,125608918,"Megaduo Gel 15g - Giảm Mụn Trứng Cá, Ngừa Thâm, Mờ Sẹo, Dưỡng Da - Gam ma",116000,158000,42000,27
TIKI,lam-dep-suc-khoe,90218797,"Bộ 2 Chai Nước súc miệng giúp nướu chắc khỏe Listerine Gum Care 750ml/chai 101109930",338000,338000,0,0
TIKI,lam-dep-suc-khoe,92702781,"Serum chống nắng cơ thể Vaseline 50x bảo vệ da với SPF 50+ PA++++ giúp da sáng hơn gấp 2X 300ML",136000,190000,54000,28
TIKI,lam-dep-suc-khoe,52758862,"[MẪU 2020] Lăn khử mùi Etiaxil Detranspirant Traitement Aisselles 15ml",209000,209000,0,0
TIKI,lam-dep-suc-khoe,52280564,"Kem chống nắng nâng tông Skin Aqua Tone up Mint Green cho da trắng có khuyết điểm đỏ, dạng sữa Sunplay Skin Aqua Tone Up UV Milk Mint Green SPF 50+ PA++++ 50g",161000,199000,38000,19
TIKI,lam-dep-suc-khoe,11949005,"[24 cái] Bộ 2 hộp bao cao su Innova Đen - Kéo dài thời gian | Hộp 12 cái",160000,160000,0,0
TIKI,lam-dep-suc-khoe,26339567,"Cân Sức Khỏe Xiaomi Thông Minh Mi Smart Scale 2",267000,267000,0,0
TIKI,lam-dep-suc-khoe,45559087,"Bao Cao su Okamoto 0.01 PU Siêu mỏng Truyền Nhiệt Nhanh Hộp 2 Cái ",79000,79000,0,0
TIKI,lam-dep-suc-khoe,5560235,"Gel bôi trơn Durex Play Classic 50ml",77000,93000,16000,17
TIKI,lam-dep-suc-khoe,25917932,"Gel Hỗ Trợ Trị Sẹo Mổ, To, Lồi Và Phì Đại Hiruscar Silicone Pro 10G",307000,307000,0,0
TIKI,lam-dep-suc-khoe,183076377,"Combo 3 Túi Khẩu Trang Y Tế ANYGUARD SENSE Lọc 99% Vi Khuẩn, Màu Sắc Trendy, An Toàn Da Nhạy Cảm Dành Cho Người Lớn (Túi 10 Chiếc/ Màu Xanh, Tím, Hồng)",69776,71200,1424,2
TIKI,lam-dep-suc-khoe,74246900,"Khẩu Trang Y Tế Hàn Quốc Chính Hãng ANYGUARD 3 Lớp Kháng Khuẩn, Vải Mịn An Toàn Cho Da Nhạy Cảm - Dành Cho Người Lớn (Hộp 50 cái)",83000,87360,4360,5
TIKI,lam-dep-suc-khoe,385614,"Bao cao su Durex Pleasuremax Hộp 3 Bao",54100,70000,15900,23
TIKI,lam-dep-suc-khoe,568659,"Mặt Nạ Ngủ Cho Môi Laneige Lip Sleeping Mask Berry 8g",185000,220000,35000,16
TIKI,lam-dep-suc-khoe,186253037,"Bao cao su Feelex Superthin siêu mỏng, nhiều gel bôi trơn, hương thơm - Hộp 30bcs",160000,160000,0,0
TIKI,lam-dep-suc-khoe,153599393,"Son lì dạng thỏi Flawsome Creamy Lip Stain (2g) Sunday Morning (Màu Đỏ hồng trầm)",180000,180000,0,0
TIKI,lam-dep-suc-khoe,80138957,"Kem chống nắng nâng tông Skin Aqua Tone up Rose cho da trắng, khuyết điểm xanh hoặc tái xanh, dạng sữa Sunplay Skin Aqua Tone Up UV Milk Happiness Aura (Rose) SPF 50+ PA++++ 50g",161000,199000,38000,19
TIKI,lam-dep-suc-khoe,631498,"Kem dưỡng cải thiện lão hóa Hada Labo Pro-Aging Retinol B3 Cream 50g",249000,295000,46000,16
TIKI,lam-dep-suc-khoe,25917926,"Gel Chăm Sóc Sẹo Mụn Và Mụn Thâm Hiruscar Post Acne 10G",307000,307000,0,0
TIKI,lam-dep-suc-khoe,197971015,"Lăn khử mùi Perspirex Original: khử mùi hôi nách và ngăn tiết mồ hôi cho da thường",270000,270000,0,0
TIKI,lam-dep-suc-khoe,125864764,"Combo Serum Dưỡng Sáng Mờ Thâm 3D Glow và Kem Dưỡng Ẩm Ngày Đêm Pond's Bright Beauty 30G & 45G x2",454000,559000,105000,19
TIKI,lam-dep-suc-khoe,74163324,"Khẩu Trang Y Tế Kháng Khuẩn Trẻ Em TDCare- Hộp 50 Cái.",21900,21900,0,0
TIKI,lam-dep-suc-khoe,272362188,"100 Viên Nến Tealight Sáp Cọ 2 giờ Lorganic An Toàn Sức Khỏe, dùng kết hợp với đèn xông và tinh dầu, khử mùi, xua đuổi muỗi và côn trùng hiệu quả, trang trí",95000,140000,45000,32
TIKI,lam-dep-suc-khoe,56371532,"Kem Chống Nắng Mỏng Nhẹ Neutrogena U.S Dry Touch SPF 50 88ml",380000,400000,20000,5
TIKI,lam-dep-suc-khoe,442348,"Nhiệt Kế Điện Tử Hồng Ngoại Đo Trán Microlife FR1MF1",836000,1000000,164000,16
TIKI,lam-dep-suc-khoe,137534886,"Túi chườm nóng bụng kinh PUHA quà tặng cho bạn nữ, túi chườm ấm giảm đau bụng kinh tặng kèm túi vải đựng BVS mẫu dễ thương",229000,229000,0,0
TIKI,lam-dep-suc-khoe,25917928,"Gel Cải Thiện Sẹo Vừa, Sẹo Lõm, Sẹo Thâm Hiruscar 20G",390000,390000,0,0
TIKI,lam-dep-suc-khoe,132353050,"[HỘP - FAMAPRO 4D KIDS] - Khẩu trang trẻ em kháng khuẩn cao cấp Famapro 4D KIDS tiêu chuẩn KF94 (10 cái/ hộp)",12900,12900,0,0
TIKI,lam-dep-suc-khoe,385615,"Bao cao su Durex Pleasuremax Hộp 12 Bao",186000,280000,94000,34
TIKI,lam-dep-suc-khoe,116426405,"Bộ 2 Chai Dầu gội đầu và dầu xả OGX - Dung Tích 385ml",590000,590000,0,0
TIKI,lam-dep-suc-khoe,44107220,"Máy tăm nước cầm tay Panasonic công nghệ siêu âm EW1511 - Hàng Chính Hãng - Trắng",2600000,2900000,300000,10
TIKI,lam-dep-suc-khoe,176672113,"Kem chấm mụn chuyên sâu Acnes Blemish Clear Cream 10g",53600,60000,6400,11
TIKI,lam-dep-suc-khoe,2042221,"Gel bôi trơn Durex Play Strawberry 100ml",162000,194000,32000,16
TIKI,lam-dep-suc-khoe,90135780,"Tinh Dầu Sả Chanh TOKIMORI Xuất Khẩu Nhật Bản (50ml) 100% Thiên Nhiên, An Toàn Cho Trẻ, Xông Phòng, Khử Mùi, Kháng Khuẩn, Đuổi Muỗi, Giải Cảm",117000,218000,101000,46
TIKI,lam-dep-suc-khoe,638369,"Kem Chống Nắng Không Màu Kiểm Soát Dầu La Roche-Posay Anthelios XL Dry Touch Gel-Cream SPF 50+ UVB & UVA (50ml)",358000,525000,167000,32
TIKI,lam-dep-suc-khoe,78280986,"Bộ 2 Chai Nước súc miệng ngăn ngừa mảng bám Listerine Tartar Protection 750mlx2",374000,374000,0,0
TIKI,lam-dep-suc-khoe,75832520,"Sữa Tắm Chuyên Biệt Cho Mụn Lưng Mông Ngực Acnevir ( Chai 210ml )",129000,171000,42000,25
TIKI,lam-dep-suc-khoe,137780195,"Trà giảm mỡ bụng Genpi Orihiro Nhật Bản hỗ trợ giảm mỡ bắp tay, đùi hiệu quả, chống oxy hoá gói 60 túi lọc JN-ORGEN01",116000,182700,66700,37
TIKI,lam-dep-suc-khoe,92159194,"Combo 2 Bao cao su Durex Performa 12 bao ",430000,600000,170000,28
TIKI,lam-dep-suc-khoe,195927144,"[148 Mùi Hương] Tinh Dầu Thơm Phòng Trái Cây Thiên Nhiên - Xông Thơm Phòng, Khử Mùi - Tinh Dầu Đào/ Xoài/ Táo Xanh/ Chuối/ Dưa Hấu/ Dưa Lưới/ Me (20ml)",110000,110000,0,0
TIKI,lam-dep-suc-khoe,63524260,"Bàn Chải Điện BOORUI Primus Z2 (TB-018) 3 Chế Độ , Bàn Chải Đánh Răng  Tặng Kèm 3 Đầu Bản Chải - Hàng Chính Hãng , Chống Nước IPX7 , Sạc nhanh USB",166000,199000,33000,17
TIKI,lam-dep-suc-khoe,1347157,"Combo Sữa Tắm L'amont En Provence Cherry Blossom Shower Gel Hương Hoa Anh Đào + Hoa Hồng (500ml / Chai)",189000,270000,81000,30
TIKI,lam-dep-suc-khoe,1081764,"Dầu tẩy trang dưỡng ẩm Hada Labo Advanced Nourish Hyaluron Cleasing Oil 200ml",215000,266000,51000,19
TIKI,lam-dep-suc-khoe,86174955,"Dầu gội Thái Dương 7 Plus Gold 500ml - Dầu gội thảo dược hỗ trợ chống gàu, ngứa, giảm rụng tóc",300000,330000,30000,9
TIKI,lam-dep-suc-khoe,7319063,"Dung Dịch Tẩy Tế Bào Chết Paula's Choice Skin Perfecting 2% BHA Liquid (30ml)",339000,399000,60000,15
TIKI,lam-dep-suc-khoe,1687625,"Kem chống muỗi Rohto Metholatum Remos Hương Sả Chanh 70g",25900,27000,1100,4
TIKI,lam-dep-suc-khoe,126945321,"Bao Cao Su Kéo Dài Thời Gian LifeStyles Love Time Thiết kế Ôm Sát Nhiều Gel 100% Không Rách Bao - Hộp 3 bao",49920,60000,10080,17
TIKI,lam-dep-suc-khoe,11368961,"Bao Cao Su Innova Đen- Gai Lớn - Kéo Dài Thời Gian Cực Đã hộp 12c",85000,85000,0,0
TIKI,lam-dep-suc-khoe,65401394,"Kem Hỗ Trợ Giảm Mụn Mủ Mụn Viêm Mụn Bọc Acnevir Santafa xanh ( Tuýp 10gr )",89000,123000,34000,28
TIKI,lam-dep-suc-khoe,460765,"Sữa Dưỡng Thể 350Ml Vaseline Dưỡng Ẩm Sáng Da Perfect Youth Phức Hợp Pro-Retinol Kích Thích Sản Sinh Collagen Hoạt Chất Aha Cải Thiệt Nếp Nhăn",110000,150000,40000,27
TIKI,lam-dep-suc-khoe,89441903,"[HỘP - FAMAPRO 4D] - Khẩu trang y tế kháng khuẩn cao cấp Famapro 4D tiêu chuẩn KF94 (10 cái/ hộp)",9900,9900,0,0
TIKI,lam-dep-suc-khoe,103341055,"Tinh Dầu Thơm Phòng Đuổi Muỗi 100ML HOMER Sả Chanh/ Quế/ Oải hương/ Bưởi/ Cam/ Hoa Lài/ Quýt/ Tràm Huế/ Hoa Hồng/ Lavender/ Ngọc Lan Tây/ Tràm Trà/ Sả Java/ Trà Xanh/ Cà Phê/ Chanh",149000,149000,0,0
TIKI,lam-dep-suc-khoe,126945340,"Bao cao su LifeStyles Classic thiết kế mỏng ôm sát nhiều gel 12 bao",91200,135000,43800,32
TIKI,lam-dep-suc-khoe,54058503,"Sữa rửa mặt dưỡng trắng Hada Labo Perfect White Tranexamic Acid Cleanser 80g",79000,93000,14000,15
TIKI,lam-dep-suc-khoe,152097288,"Combo 5 gói bông tẩy trang Ipek 150 miếng ( 5 x 150 miếng)",139500,139500,0,0
TIKI,lam-dep-suc-khoe,34346450,"Dầu Gội đầu Clear Botanique 9 Thảo Dược Quý Cho Da Đầu Yếu Với 3X Sức Mạnh Đánh Bay Gàu Nhờn Ngứa 630g",153000,182700,29700,16
TIKI,lam-dep-suc-khoe,198560707,"Bao cao su Feelex 3in1 gân gai, nhiều gel bôi trơn, kéo dài thời gian quan hệ",117000,119000,2000,2
TIKI,lam-dep-suc-khoe,116416531,"Dầu Gội Đầu OGX - Dung Tích 385ml",295000,295000,0,0
TIKI,lam-dep-suc-khoe,216211166,"Sữa tắm gội hương nước hoa cao cấp Gentleman 3 in 1 NERMAN 350ml",203000,300000,97000,32
TIKI,lam-dep-suc-khoe,10278713,"Nước uống collagen giúp sáng da, dạ dày khỏe Blossomy lốc 10 chai x 50ml",424000,530000,106000,20
TIKI,lam-dep-suc-khoe,43117919,"SỮA DƯỠNG THỂ VASELINE HỒNG LÀM MỊN &TRẮNG DA 725ML",141000,141000,0,0
TIKI,lam-dep-suc-khoe,93457801,"Phấn Nước M.O.I 5M BABY SKIN CUSHION Hồ Ngọc Hà (2021)",399000,399000,0,0
TIKI,lam-dep-suc-khoe,171495459,"Serum Hoặc sửa rửa mặt giảm mụn Mugung 7 ngày hiệu quả giảm mụn đầu đen,mụn bọc (Làm xẹp không bong da) Acne Treatment",150000,150000,0,0
TIKI,lam-dep-suc-khoe,214230523,"Collagen Mỹ Youtheory (Collagen Type 1-2-3) 390 Viên - QuaTangMe Extaste",803000,1634000,831000,51
TIKI,lam-dep-suc-khoe,182457734,"Túi chườm nóng lạnh PUHA 350ml, túi chườm sưởi ấm giảm đau bụng kinh họa tiết dễ thương",105000,105000,0,0
TIKI,lam-dep-suc-khoe,70661122,"Mặt nạ dưỡng trắng da và ngăn ngừa lão hoá Truesky Integrated Mask chiết xuất hoa hồng đá 25g",18000,30000,12000,40
TIKI,lam-dep-suc-khoe,93840468,"Máy Xông Tinh Dầu Có Pin Tích Điện, Vỏ Kim Loại Nguyên Khối, Nút Cảm Ứng, Tặng Tinh Dầu (Tùy Chọn) - Máy Khuếch Tán Tinh Dầu Trực Tiếp Chuyên Dụng Cho Xe ô tô và Gia Đình",378000,1196000,818000,68
TIKI,lam-dep-suc-khoe,14617774,"Dưỡng Chất Chuyên Sâu Giúp Hỗ Trợ Quá Trình Tái Tạo Da La Roche-Posay Hyalu B5 Serum 30ml",779000,795000,16000,2
TIKI,lam-dep-suc-khoe,54896450,"Dung dịch vệ sinh nam dịu nhẹ lành tính thành phần tự nhiên chai nhỏ gọn 80ml - LOLI & THE WOLF",109000,109000,0,0
TIKI,lam-dep-suc-khoe,196953338,"Sữa rửa mặt se khít lỗ chân lông innisfree Volcanic Pore BHA Cleansing Foam 150g",195000,260000,65000,25
TIKI,lam-dep-suc-khoe,58850613,"Bột Than Hoạt Tính Trắng Răng Sạch Mãng Bám Fobe Smile - Hũ 30 gram",99000,170000,71000,42
TIKI,lam-dep-suc-khoe,631525,"Sữa rửa mặt cải thiện dấu hiệu lão hóa dạng kem Hada Labo Pro-Aging Retinol B3 Cleanser 80g",86900,89000,2100,2
TIKI,lam-dep-suc-khoe,7352431,"Dầu Gội và Xả Thảo Dược Hà Thủ Ô Giảm Rụng Tóc, Bạc Tóc Cocayhoala 300g",220000,300000,80000,27
TIKI,lam-dep-suc-khoe,153869040,"Bao cao su LifeStyles Fantasy Gân Ngang, Nhiều Gel Bôi Trơn tăng Khoái Cảm - Hộp 3 bao",27840,39000,11160,29
TIKI,lam-dep-suc-khoe,133245977,"Bộ 2 đầu bàn chải điện P/S - Trắng Răng Tự Nhiên",184000,245455,61455,25
TIKI,lam-dep-suc-khoe,171495457,"Serum giảm mụn Mugung 7 ngày hiệu quả giảm mụn đầu đen,mụn bọc (Làm xẹp không bong da) Acne Treatment 15ml",250000,250000,0,0
TIKI,lam-dep-suc-khoe,385477,"Bao cao su Durex Fetherlite Ultima Hộp 12 Bao",213000,304000,91000,30
TIKI,lam-dep-suc-khoe,73923578,"COMBO CƠ BẢN CHO DA MỤN DECUMAR ADVANCED",145000,145000,0,0
TIKI,lam-dep-suc-khoe,35031098,"Son thỏi dưỡng môi trang điểm, cho môi căng mọng Lip On Lip Water Color",132000,132000,0,0
TIKI,lam-dep-suc-khoe,5730933,"Thực phẩm chức năng viên uống bổ khớp, hỗ trợ trị đau nhức xương khớp Glucosamine Orihiro 1500mg Nhật bản",565000,800000,235000,29
TIKI,lam-dep-suc-khoe,385582,"Bao cao su Durex Fetherlite Hộp 12 Bao",192000,268000,76000,28
TIKI,lam-dep-suc-khoe,97712326,"Dầu gội đầu Head&Shoulders Clinical Strength Shampoo dry scalp rescue làm sạch gầu 400ml mẫu mới",275000,280000,5000,2
TIKI,lam-dep-suc-khoe,68429877,"Combo 2 Tắm gội 2 trong 1 Romano hương nước hoa 650g/chai",301000,382000,81000,21
TIKI,lam-dep-suc-khoe,70550671,"Kem Dưỡng Thể Ngăn Ngừa Viêm Lỗ Chân Lông Weightless Body Treatment 2% BHA 60mL Paula's Choice",315000,349000,34000,10
TIKI,lam-dep-suc-khoe,74257575,"Máy Massage Mắt Cao Cấp KINGTECH KY-925 - Mát xa Áp Suất Túi Khí Kèm Nhiệt - Tích Hợp Nghe Nhạc Bluetooth -  Giảm Mỏi, Khô Mắt, Quầng Thâm - Cải Thiện Giấc Ngủ - Hàng Chính Hãng",1571000,2750000,1179000,43
TIKI,lam-dep-suc-khoe,26113983,"Viên Uống Bổ Sung Vitamin C DHC Vitamin C Hard Capsule Nhật Bản",84100,95000,10900,11
TIKI,lam-dep-suc-khoe,54865932,"Khẩu Trang Y Tế TDCare 4 Lớp",28000,48000,20000,42
TIKI,lam-dep-suc-khoe,7548593,"Viên uống tăng chiều cao GH Creation EX Nhật Bản - 270 viên",699000,890000,191000,21
TIKI,lam-dep-suc-khoe,140953992,"[12 mùi - 3 size] Nến thơm tinh dầu cao cấp không khói an toàn Aurae",50000,50000,0,0
TIKI,lam-dep-suc-khoe,148714567,"Cân Điện Tử thông minh Kachi MK315 - Hàng chính hãng",291000,299000,8000,3
TIKI,lam-dep-suc-khoe,192894194,"Cây massage đầu thư giãn BaoAn chính hãng",25000,25000,0,0
TIKI,lam-dep-suc-khoe,74212316,"Tinh dầu Cam Ngọt Nguyên Chất 50ML (ORANGE) - Tinh dầu Cam Cao Cấp Giúp Thư Giãn Tinh Thần, Khử Mùi, Xua Đuổi Côn Trùng, Thích Hợp Dùng Với Đèn Xông Và Máy Khuếch Tán Tinh Dầu",98000,196000,98000,50
TIKI,lam-dep-suc-khoe,160147181,"Máy massage ngực thông minh CTFAST WX-006: Mát xa 5 cấp độ rung kết hợp nhiệt ổn định hỗ trợ giảm tình trạng chảy xệ, cải thiện nâng và tăng kích thước vòng 1 đem lại vóc bộ ngực săn chắc quyến rũ - Món quà ý nghĩa dành cho chị em phụ nữ",679000,679000,0,0
TIKI,lam-dep-suc-khoe,117926982,"Tăm nước cầm tay H2ofloss HF-9P. Phiên bản thế hệ thứ 5",549000,850000,301000,35
TIKI,lam-dep-suc-khoe,193583705,"Sữa tắm dưỡng thể Dove Sakura Blossoms Da mềm mịn hương hoa với hương hoa anh đào & muối hồng 900g",168000,226000,58000,26
TIKI,lam-dep-suc-khoe,74306493,"Khẩu Trang Trẻ Em Anyguard Hàn Quốc 3 Lớp Chính Hãng (Cỡ Lớn Cho Bé Dưới 13Tuổi - Hộp 50 Chiếc)-베이비 마스크 - Face Mask For Kids Under 13 yearsold-ISO 9001:2015, ISO 13485:2016, QCVN 01:2017/BTC",82000,84100,2100,2
TIKI,lam-dep-suc-khoe,273849758,"Bao cao su siêu mỏng, trơn mượt LifeStyles SKYN Elite - Non-latex không mùi cao su - 10 bao",210240,335000,124760,37
TIKI,lam-dep-suc-khoe,72790514,"[CHÍNH HÃNG] TINH DẦU BƯỞI VIJULLY - HAIR LOTION",150000,150000,0,0
TIKI,lam-dep-suc-khoe,33597687,"Son dưỡng môi không màu chuyển kem mịn LipIce Creamy",50000,62500,12500,20
TIKI,lam-dep-suc-khoe,50699261,"Nước tẩy trang Công Nghệ Micella Bioderma Sebium H2O",445000,525000,80000,15
TIKI,lam-dep-suc-khoe,10758843,"Dụng Cụ Cạo Lưỡi Người Lớn Sản Xuất Tại Thụy Sĩ Trisa Double Action",86000,92000,6000,7
TIKI,lam-dep-suc-khoe,54864521,"Khẩu Trang Y Tế TDCare 4 Lớp - Màu Xanh-Hộp 50 Cái",30000,48000,18000,38
TIKI,lam-dep-suc-khoe,125827955,"Combo 8 Băng Vệ Sinh Kotex Minimeow 8 miếng",140000,176000,36000,20
TIKI,lam-dep-suc-khoe,25704809,"Kem chống nắng giảm bóng nhờn La Roche Posay Anthelios XL Dry Touch 50ml",392000,560000,168000,30
TIKI,lam-dep-suc-khoe,118124189,"Viên uống ALIPAS tăng cường sinh lý nam với Eurycoma longifolia, Oyster Meat, Pine Bark Extract (30 viên)",750000,750000,0,0
TIKI,lam-dep-suc-khoe,193583716,"Sữa tắm dưỡng thể Dove Deep Moisture Dưỡng ẩm chuyên sâu với dưỡng chất lợi khuẩn da 900g",161000,226000,65000,29
TIKI,lam-dep-suc-khoe,189337681,"Phấn phủ bạc Mochi Nhật Bản. Phấn che khuyết điểm tóc thưa, phủ tóc bạc chính hãng",199000,199000,0,0
TIKI,lam-dep-suc-khoe,136855407,"Sữa tắm nam hương nước hoa Bergami Savage",165000,165000,0,0
TIKI,lam-dep-suc-khoe,90331609,"Đai Chống Gù Lưng Nam Nữ Có Nẹp Dành Cho Dân Văn Phòng miDoctor mi04",147000,147000,0,0
TIKI,lam-dep-suc-khoe,2079711,"Sữa Dưỡng Thể 350Ml Vaseline Dưỡng Ẩm Sáng Da Chống Nắng Spf24Pa++ Sun + Pollution Protection Bảo Vệ Da Tới 4H Với Spf 24 Pa++",99100,150000,50900,34
TIKI,lam-dep-suc-khoe,117170053,"Nước hoa hồng Simple Toner làm dịu và cân bằng độ ẩm cho da - lành tính không chứa cồn 200ml [Chính hãng độc quyền]",109000,160500,51500,32
TIKI,lam-dep-suc-khoe,215539080,"[HỘP - FAMAPRO VN95] Khẩu trang y tế kháng khuẩn 4 lớp Famapro VN95 đạt chuẩn N95 (10 cái/ hộp) - HỘP",14900,14900,0,0
TIKI,lam-dep-suc-khoe,74167275,"Cà Phê Đắk Lắk Làm Sạch Da Chết Mặt Cocoon 150ml",132000,165000,33000,20
TIKI,lam-dep-suc-khoe,43252810,"Sữa Tắm Dạng Gel Neutrogena Rainbath Original Refreshing Shower And Bath Gel 473ml",312000,312000,0,0
TIKI,lam-dep-suc-khoe,45319679,"Bao cao su Durex Naughty Chocolate hộp 3 bao",40000,51000,11000,22
TIKI,lam-dep-suc-khoe,137860001,"Bông Tẩy Trang Jomi 80 Miếng/Túi",19000,25000,6000,24
TIKI,lam-dep-suc-khoe,170491702,"[VIDEO]-Bộ dụng cụ ráy tai/ ngoáy tai cao cấp 6 món kèm bao da kiêm móc khóa- CHỌN MẪU- Dụng cụ ráy tai thông minh cho người lớn và trẻ em",39000,39000,0,0
TIKI,lam-dep-suc-khoe,151519665,"Bao cao su cao cấp OZO Feelex Invisible Cool - Hộp 10 bcs",97000,99000,2000,2
TIKI,lam-dep-suc-khoe,131504769,"Dầu gội dược liệu Thái Dương 7 plus 100ml - Sao Thái Dương",75000,75000,0,0
TIKI,lam-dep-suc-khoe,140537792,"Sữa rửa mặt Hatomugi hạt ý dĩ",54180,54180,0,0
TIKI,lam-dep-suc-khoe,93047706,"Tinh Dầu Sả Chanh Ấn Homer 100ml - Chính Hãng, Đạt Chuẩn Kiểm Định Cao Cấp - Tinh Dầu Xông Thơm Phòng, Thư Giãn, Khử Mùi hiệu quả",60000,60000,0,0
TIKI,lam-dep-suc-khoe,48291660,"Kem chống nắng body Skin Aqua dưỡng trắng dùng hàng ngày Sunplay Skin Aqua UV Body Whitening Lotion SPF 50+ PA++++ 150g",177000,219000,42000,19
TIKI,lam-dep-suc-khoe,77094737,"Viên Uống Thơm Miệng Breath Pearls",119000,119000,0,0
TIKI,lam-dep-suc-khoe,46060478,"Kem tan mỡ bụng Truesky S Body Cream chiết xuất quế gừng an toàn và hiệu quả 100g",109000,180000,71000,39
TIKI,lam-dep-suc-khoe,170820908,"Lược gội đầu massage silicon CWELL, mát xa da đầu, gỡ rối và giảm rụng tóc hiệu quả C04PK",39000,75000,36000,48
TIKI,lam-dep-suc-khoe,580508,"Lăn Khử Mùi Romano Classic 50ml - 1412047",56000,68000,12000,18
TIKI,lam-dep-suc-khoe,152097293,"Bông tẩy trang ipek thổ nhĩ kì 150 miếng ( 120+30 miếng)",27900,27900,0,0
TIKI,lam-dep-suc-khoe,1313873,"Kem chống nắng Sunplay mát lạnh giải nhiệt dạng sữa Sunplay Super Cool SPF 50, PA++++ 30g",78000,97000,19000,20
TIKI,lam-dep-suc-khoe,186288869,"Bộ đai chườm nóng thảo dược giảm đau đầu gối dùng điện - Hapaku",929000,955000,26000,3
TIKI,lam-dep-suc-khoe,149460253,"Tinh Dầu Oải Hương Homer 100ML - Tinh Dầu Lavender Thiên Nhiên Nhập Khẩu Nguyên Chất Giúp Giảm Stress, Khử Khuẩn và Xua Đuổi Côn Trùng, Sử Dụng Hiệu Quả với Máy Xông Tinh Dầu",85000,85000,0,0
TIKI,lam-dep-suc-khoe,7727580,"Mặt nạ giấy hàn quốc tinh chất lô hội trắng da DABO HÀN QUỐC ( 22ml/ miếng)",8900,8900,0,0
TIKI,lam-dep-suc-khoe,45319677,"Bao cao su Durex Sensual Strawberry hộp 3 bao",40000,51000,11000,22
TIKI,lam-dep-suc-khoe,35031109,"Son lì dưỡng môi siêu mịn Lip On Lip Silky Matte",176000,177000,1000,1
TIKI,lam-dep-suc-khoe,74608134,"Khẩu Trang Trẻ Em Anyguard Hàn Quốc 3 Lớp Chính Hãng (Cho Bé Dưới 7 Tuổi - Hộp 50 Chiếc)-베이비 마스크 - Face Mask For Kids Under 7 yearsold-ISO 9001:2015, ISO 13485:2016, QCVN 01:2017/BTC",77530,78845,1315,2
TIKI,lam-dep-suc-khoe,15134851,"Sáp vuốt tóc Apestomen Volcanic Clay",240000,240000,0,0
TIKI,lam-dep-suc-khoe,25917930,"Gel Cải Thiện Sẹo Vừa, Sẹo Lõm, Sẹo Thâm Hiruscar 5G",147000,147000,0,0
TIKI,lam-dep-suc-khoe,21482823,"Lược thưa chải tóc xoăn - Giao hàng màu ngẫu nhiên",20000,20000,0,0
TIKI,lam-dep-suc-khoe,35526564,"Sữa Rửa Mặt Neutrogena Ngừa Mụn Đầu Đen 100ml",125000,125000,0,0
TIKI,lam-dep-suc-khoe,191995136," Tinh dầu treo xe thiên nhiên HOMER / Bạc Hà/ Quế/ Oải hương/ Bưởi/ Cam/ Hoa Lài/ Quýt/ Tràm Huế/ Hoa Hồng/ Lavender/ Ngọc Lan Tây/ Tràm Trà/ Sả Java/ Trà Xanh/ Cà Phê/ Chanh/ Trà xanh/ Trà trắng",39000,39000,0,0
TIKI,lam-dep-suc-khoe,57649867,"Sữa Dưỡng Thể 350Ml Vaseline Dưỡng Ẩm Sáng Da Fresh & Bright 10X Niacinamide Giúp Da Sáng Khỏe Mịn Căng Tinh Chất Menthol Mát Lạnh Như Tuyết Tan Trên Da",110000,150000,40000,27
TIKI,lam-dep-suc-khoe,7255881,"Thực phẩm chức năng Tảo xoắn Spirulina nội địa Nhật Bản 2200 viên",369000,453600,84600,19
TIKI,lam-dep-suc-khoe,25108019,"Gel chấm mụn đầu trắng và đầu đen Acnes Sealing Jell 18g",62400,69000,6600,10
TIKI,lam-dep-suc-khoe,166595471,"Set Dưỡng Trắng Da Ốc Sên Cấp Ẩm Se Khít Lỗ Chân Lông Và Chống Lão Hóa Dewytree Ultra Vitalizing Snail 20ml",69000,90000,21000,23
TIKI,lam-dep-suc-khoe,119068215,"Cân sức khỏe Cân gia đình Camry BR202007A cao cấp hoạt động cơ học, trọng tải tối đa 130kg ( bước nhảy +-1kg ) - Hàng nhập khẩu",175000,175000,0,0
TIKI,lam-dep-suc-khoe,75997194,"Máy Xông Tinh Dầu 2200ML Cho Phòng Rộng + Tinh Dầu Sả Chanh TIDAMO - Máy Khuếch Tán Tinh Dầu Thể Tích Lớn Nhất, Chuyên Dụng Xông Tinh Dầu, Phun Sương Tạo Ẩm Cho Không Gian Lớn",319000,776000,457000,59
TIKI,lam-dep-suc-khoe,47149569,"Gel Vệ Sinh Phụ Nữ Giảm Viêm Ngứa X2 Nano Nghệ Cocayhoala 150ml",209000,330000,121000,37
TIKI,lam-dep-suc-khoe,284446,"Thuốc nhuộm dưỡng tóc phủ bạc thảo dược Bigen Nhập Khẩu 100% Nhật Bản Speedy Color Cream 80ml dạng kem - BSH Số",245000,266000,21000,8
TIKI,lam-dep-suc-khoe,72555195,"50 que thử tiểu đường On call plus của hãng ACON/Mỹ, dùng cho máy On call plus và On call EZii",153000,250000,97000,39
TIKI,lam-dep-suc-khoe,274172122,"Combo 5 Cặp Nút Tai Chống Ồn 3M 1110/1100 - Giảm ồn khi ngủ, làm việc, đi máy bay",30000,30000,0,0
TIKI,lam-dep-suc-khoe,435317,"Máy Đo Huyết Áp Bắp Tay Omron - HEM-8712 - 100610698",789000,840000,51000,6
TIKI,lam-dep-suc-khoe,197922834,"Tinh dầu Cà Phê Homer 100ml - Tinh Dầu Xông Thơm Phòng, Thư Giãn, Khử Mùi - Tinh dầu Sả Chanh/ Vỏ Quế/ Cam Ngọt/ Oải hương/ Ngọc Lan Tây/ Tràm Trà/ Bưởi Ngọt",65000,65000,0,0
TIKI,lam-dep-suc-khoe,126945370,"Bao Cao Su LifeStyles ZERO Cao Cấp Siêu Mỏng Tuyệt Đối, Dẻo Dai  - Hộp 12 bao",171840,215000,43160,20
TIKI,lam-dep-suc-khoe,6430923,"Lăn khử mùi chiết xuất thiên nhiên Refre Natural Green Tea Hương Trà Xanh 40ml",53900,65000,11100,17
TIKI,lam-dep-suc-khoe,2609469,"Nước Tẩy Trang Làm Sạch Sâu Cho Da Nhạy Cảm La Roche-Posay Micellar Water Ultra Sensitive Skin 400ml",348000,405000,57000,14
TIKI,lam-dep-suc-khoe,191514845," Máy Rửa Mặt Mini Cầm Tay Crénot Nia P5 Chính Hãng, Sử Dụng Sóng Âm Và Silicone Siêu Mềm Sạch Sâu Bụi Bẩn Trang Điểm Ngừa Mụn - Máy Rửa Mặt Massage Mát xa Matxa Tốt Chăm Sóc Da Dầu Mụn Nhạy Cảm Cho Nam Nữ",580000,1160000,580000,50
TIKI,lam-dep-suc-khoe,43163776,"Nước hoa nam cao cấp chính hãng Jile Guilty 50ml với hương thơm mạnh mẽ, nam tính, lịch lãm, quý phái.",325000,470000,145000,31
TIKI,lam-dep-suc-khoe,169778290,"Combo 2 chai Dung Dịch Vệ Sinh Nam X2 Manly - Làm sạch tức thì Lưu hương 24h dung tích 150g Cocayhoala (Combo 2 chai)",299000,399000,100000,25
TIKI,lam-dep-suc-khoe,108830964,"Bộ 3 Kem đánh răng P/S Than Hoạt Tính 230g",107000,135000,28000,21
TIKI,lam-dep-suc-khoe,1362445,"Sữa Rửa Mặt Cetaphil Gentle Skin Cleanser (125ml)",131000,140000,9000,6
TIKI,lam-dep-suc-khoe,14423711,"Tấm thảo dược thay thế của đai chườm lưng cắm điện - Hapaku",123000,127000,4000,3
TIKI,lam-dep-suc-khoe,147043572,"Xịt Thơm Miệng Befresh Cho Hơi Thở Thơm Mát Chỉ Trong 3 Giây Dung Tích 10ml",44000,75900,31900,42
TIKI,lam-dep-suc-khoe,631403,"Nước Súc Miệng Làm Trắng Răng Listerine Healthy Bright (750ml) - 8850007813385",187000,187000,0,0
TIKI,lam-dep-suc-khoe,3282871,"Gel rửa mặt tạo bọt làm sạch & giảm nhờn cho da dầu nhạy cảm La Roche-Posay Effaclar Purifying Foaming Gel (400ml)",399000,585000,186000,32
TIKI,lam-dep-suc-khoe,35526560,"Nước Rửa Mặt Neutrogena Dịu Nhẹ 100ml",100000,100000,0,0
TIKI,lam-dep-suc-khoe,44878245,"Cho máy Braun Oral-B, Bộ 4 đầu bàn chải đánh răng điện - Đánh tan mảng bám- SB-17A",165000,165000,0,0
TIKI,lam-dep-suc-khoe,76169589,"[HỘP - FAMAPRO VN95] - Khẩu trang y tế kháng khuẩn 4 lớp Famapro VN95 đạt chuẩn N95 (10 cái/ hộp) - COMBO 5 HỘP",57000,75000,18000,24
TIKI,lam-dep-suc-khoe,129868878,"Combo Dầu Gội X-Men Nước hoa Wood 650G và Sữa Tắm X-Men Nước hoa Wood 650G",382000,382000,0,0
TIKI,lam-dep-suc-khoe,134592241,"Lăn khử mùi dành cho nữ Aquaselin 50ml (loại mạnh)",290000,290000,0,0
TIKI,lam-dep-suc-khoe,106074482,"Viên uống Vitamin C DHC Nhật Bản giúp sáng da mờ thâm thực phẩm chức năng giúp tăng cường sức đề kháng JN-DHC-C",90720,90720,0,0
TIKI,lam-dep-suc-khoe,176756454,"Cân Điện Tử Sức Khoẻ Thông Minh Mặt Vuông Kính Cường Lực Chịu Lực 180Kg Deli - Phù Hợp Gia Đình Trường Học -  Nhiều Màu Sắc - Hàng Chính Hãng - E86120",149000,268200,119200,44
TIKI,lam-dep-suc-khoe,195972836,"Máy Triệt Lông Vĩnh Viễn Băng Lạnh Trẻ Hóa Da Mini Cầm Tay Tại Nhà Crénot Graci X3 Dành Cho Nách Vùng Bikini Mặt Chân Toàn Thân Cá Nhân Giảm Mụn IPL Hair Removal Ice Cooling Compress",2090000,2190000,100000,5
TIKI,lam-dep-suc-khoe,631049,"Dung dịch dưỡng ẩm tối ưu Hada Labo Advanced Nourish Lotion dùng cho da dầu 170ml",166000,208000,42000,20
TIKI,lam-dep-suc-khoe,197378660,"Phấn Nước Che Khuyết Điểm Nâng Tone Kiềm Dầu Chống Nắng Dưỡng Da Dewytree Urban Shade Cover & Fit Sun Cushion SPF50+ PA++++(14g)",442000,520000,78000,15
TIKI,lam-dep-suc-khoe,76166201,"[HỘP - FAMAPRO MAX] - Khẩu trang y tế kháng khuẩn 4 lớp Famapro Max (40 cái/ hộp) - COMBO 5 HỘP",112000,112000,0,0
TIKI,lam-dep-suc-khoe,195937695,"Máy Massage Mắt Cầm Tay Mini Nhiệt Rung Crenot Erie V2 Mát Xa Giảm Thâm Bọng Nhức Mỏi Mờ Nếp Nhăn",725000,1420000,695000,49
TIKI,lam-dep-suc-khoe,55895699,"Bigsize - Kem tan mỡ bụng Truesky S Body Cream chiết xuất quế gừng an toàn và hiệu quả 200g",145000,280000,135000,48
TIKI,lam-dep-suc-khoe,173224731,"Máy phun sương mini CWELL 2L, máy tạo độ ẩm không khí 3 chế độ phun sương mịn kiêm đèn Led nhiều màu",219000,299000,80000,27
TIKI,lam-dep-suc-khoe,544425,"Cân Sức Khỏe 120kg Nhơn Hòa (Nhiều màu) - Giao màu ngẫu nhiên - Hàng Chính Hãng",378000,378000,0,0
TIKI,lam-dep-suc-khoe,1313905,"Tinh chất vitamin C dưỡng trắng da, chống thâm nám Melano CC Whitening Essence 20ml",258000,350000,92000,26
TIKI,lam-dep-suc-khoe,192831802,"Tinh dầu nguyên chất Bạc Hà 24Care/ Sả chanh/ Quế/ Oải hương/ Bưởi/ Cam/ Hoa Lài/ Quýt/ Tràm Huế/ Hoa Hồng/ Lavender/ Ngọc Lan Tây/ Tràm Trà/ Sả Java/ Trà Xanh/ Gỗ Hồng/ Hoa Anh Đào",345000,345000,0,0
TIKI,lam-dep-suc-khoe,112728673,"Bọt vệ sinh nam giới Oniiz 100ml",120000,120000,0,0
TIKI,lam-dep-suc-khoe,470430,"Kem Dưỡng Giảm Mụn, Ngừa Thâm, Thông Thoáng Lỗ Chân Lông La Roche-Posay Effaclar Duo+ 40ml",336000,480000,144000,30
TIKI,lam-dep-suc-khoe,116148009,"Dụng Cụ Lấy Ráy Tai, Bộ Ngoáy Tai 6 Chiếc KUNBE, Chất Liệu Inox Cao Cấp Giúp Vệ Sinh Tai An Toàn, Chuyên Nghiệp",32000,32000,0,0
TIKI,lam-dep-suc-khoe,179717787,"Toner giảm mụn dịu da Acnes Blemish Control Toner 100ml",84900,85000,100,0
TIKI,lam-dep-suc-khoe,13416097,"Nhuộm Tóc Dược Liệu Thái Dương (5 Gói)",90000,90000,0,0
TIKI,lam-dep-suc-khoe,105621214,"Bộ Bao Cao Su Durex Kingtex 3 Hộp 12 Bao",335000,588000,253000,43
TIKI,lam-dep-suc-khoe,108535259,"Bao cao su Sagami Exceed 2000 - Thiết kế 3D - Một lần thắt - Hộp 12 chiếc",120000,120000,0,0
TIKI,lam-dep-suc-khoe,58916736,"Lăn Khử Mùi ETIAXIL Détranspirant Traitement Aisselles Peaux Sensibles 15ml (Dành Cho Da Nhạy Cảm) + Quà Tặng",249000,320000,71000,22
TIKI,lam-dep-suc-khoe,3179511,"Sữa Tắm White Conc Body Nhật Bản Dưỡng Da Trắng Hồng, 360ml",200000,233100,33100,14
TIKI,lam-dep-suc-khoe,11956889,"Kem Nứt Gót Dưỡng Ẩm, Giảm Đau, Làm Lành Nhanh Vùng Nứt Gót Chân Oriss - Dưỡng Ẩm Vượt Trội Suốt 24h - tuýp 30g ",44000,57000,13000,23
TIKI,lam-dep-suc-khoe,52280562,"Kem chống nắng nâng tông Skin Aqua Tone up Mint Green cho da trắng có khuyết điểm đỏ, dạng tinh chất Sunplay Skin Aqua Tone Up UV Essence Mint Green SPF 50+ PA++++ 50g",161000,199000,38000,19
TIKI,lam-dep-suc-khoe,135029845,"Gel Rửa Mặt Dịu Nhẹ Làm Sạch Sâu Neutrogena Hydro Boost Cleanser Water Gel - Dung tích 145ml",350000,350000,0,0
TIKI,lam-dep-suc-khoe,55615437,"Tẩy Da Chết Tế Bào Gốc Thực Vật Làm Sạch Sâu Dịu Nhẹ Dưỡng Ẩm Trắng Da Chống Nhăn Cho Da Nhạy Cảm Cellkey-Scien White Peeling Gel (80ml)",264000,350000,86000,25
TIKI,lam-dep-suc-khoe,35226725,"Tinh chất ngừa mụn thâm The Ordinary Niacinamide 10% + Zinc 1",228000,265000,37000,14
TIKI,lam-dep-suc-khoe,247999867,"Gôm xịt tóc tạo kiểu siêu cứng, giữ nếp lâu Mugens Hair Spray Hàn Quốc 300ml + Móc khóa",145000,145000,0,0
TIKI,lam-dep-suc-khoe,14694900,"Xà Phòng Cải Thiện Thâm Mông Pelican Hip Care Soap nội địa Nhật",113000,115920,2920,3
TIKI,lam-dep-suc-khoe,252679985,"Combo lịch lãm Nerman - Sữa tắm gội Gentleman 3in1 hương nước hoa cao cấp 350ml",309000,460000,151000,33
TIKI,lam-dep-suc-khoe,34480145,"Combo 2 Hộp Miếng Dán Mụn Cóc Loại Bỏ Mụn Cóc Tại Nhà An Toàn Hiệu Quả - Hộp 6 miếng",109000,143000,34000,24
TIKI,lam-dep-suc-khoe,172303081,"Gel lột mụn hút sạch mụn cám, mụn đầu đen YOSHI 200gr",65000,65000,0,0
TIKI,lam-dep-suc-khoe,144228451,"Khẩu Trang 4D Kiếu Dáng Hàn Quốc KF94 (10 Cái / Túi), kháng Khuẩn, Chống Bụi, Màu Trắng - Đạt Các Chứng Chỉ ISO 13485, ISO 9001, CE, FDA, TGA.",15000,15000,0,0
TIKI,lam-dep-suc-khoe,50331044,"Xà phòng rửa tay diệt khuẩn nano bạc Nano Vio 190ml - ít bọt, không triclosan, hương thơm tinh dầu dịu nhẹ",29700,49500,19800,40
TIKI,lam-dep-suc-khoe,117793839,"Tăm nước cầm tay H2ofloss HF-2 phiên bản nâng cấp được phân phối độc quyền với nút mở bình nước tiện lợi, tặng kèm 7 đầu tăm, củ sạc nguồn thấp",749000,1399000,650000,46
TIKI,lam-dep-suc-khoe,1529993,"Xịt Khử Mùi Dưỡng Trắng Hương Nước Hoa Refre Whitening Sweetie Hương Ngọt Ngào (30ml)",58000,62000,4000,6
TIKI,lam-dep-suc-khoe,12081510,"Kem Thoa Giãn Tĩnh Mạch Hỗ Trợ Giảm Đau, Sưng, Phù Chân Vascovein (tuýp 50g)",164000,201000,37000,18
TIKI,lam-dep-suc-khoe,84875620,"Tinh Dầu Hoa Nhài 30ML Nguyên Chất, Nhập Khẩu - Tinh Dầu Hoa Lài TIDAMO (Jasmine) Có Kiểm Nghiệm, Hương Thơm Dịu Nhẹ Quý Phái - Xông Thơm Phòng, Thư Giãn và Tốt Cho Sức Khỏe",74800,176000,101200,58
TIKI,lam-dep-suc-khoe,149467412,"Tinh Dầu Ngọc Lan Tây Homer 100ML - Tinh Dầu Thiên Nhiên Nhập Khẩu Nguyên Chất Giúp Giảm Stress, Khử Khuẩn và Xua Đuổi Côn Trùng, Sử Dụng Hiệu Quả với Máy Xông Tinh Dầu",85000,85000,0,0
TIKI,lam-dep-suc-khoe,74973204,"Máy Rửa Mặt Mini Massage Tích Hợp Sóng Âm Giúp Làm Sạch Sâu Da, Nâng Cơ Mặt, Sáng Da, Trẻ Hóa Làn Da - Máy Rửa Mặt Chính hãng VinBuy",119000,180000,61000,34
TIKI,lam-dep-suc-khoe,134591513,"Lăn khử mùi dành cho nam Aquaselin 50ml",290000,290000,0,0
TIKI,lam-dep-suc-khoe,72924805,"Máy Xông Tinh Dầu Hiệu Ứng Ánh Sáng 3D Cực đẹp, Máy Khuếch Tán Tinh Dầu Chuyên Dụng Xông Tinh Dầu Và Đèn LED 3D Trang Trí Phòng",319000,696000,377000,54
TIKI,lam-dep-suc-khoe,170402456,"Combo 10 Gói Khẩu trang Bông Bạch Tuyết KF94 4 lớp trắng (10 cái/gói)",200000,200000,0,0
TIKI,lam-dep-suc-khoe,195937919,"[148 Mùi Hương] Tinh Dầu Thơm Phòng Trái Cây Thiên Nhiên Nhiệt Đới - Khử Mùi, Xông Thơm Phòng - Tinh Dầu Đào/ Chuối/ Táo Xanh/ Mơ/ Me/ Xoài/ Dưa Lưới/ Dưa Hấu (100ml)",275000,275000,0,0
TIKI,lam-dep-suc-khoe,67555393,"Dung dịch vệ sinh nam dịu nhẹ lành tính thành phần tự nhiên mùi hương nam tính chai vòi nhấn 150ml - LOLI & THE WOLF",149000,149000,0,0
TIKI,lam-dep-suc-khoe,122092245,"[+Tặng mũ trùm] BỘ DẦU GỘI XẢ PASIORI TM COLLAGEN & BIOTIN TRẮNG PHỤC HỒI, MỀM MƯỢT NGĂN GÃY RỤNG MỌC TÓC ITALY 1000ML*2 [MẪU MỚI]",371000,390000,19000,5
TIKI,lam-dep-suc-khoe,47809115,"Đai Chống Gù Lưng Có Nẹp Cho Nam, Nữ và Trẻ Em",135000,135000,0,0
TIKI,lam-dep-suc-khoe,22052325,"Sữa rửa mặt cho nam Oxy sạch sâu mát lạnh dạng kem Oxy Perfect Wash 100g",66900,82000,15100,18
TIKI,lam-dep-suc-khoe,1687621,"Kem chống muỗi Rohto Metholatum Remos Hương Cam 70g",25900,27000,1100,4
TIKI,lam-dep-suc-khoe,24910578,"Son kem lì Bbia Last Velvet Lip Tint Version 3 5g (5 màu)",140000,290000,150000,52
TIKI,lam-dep-suc-khoe,76133761,"[HỘP - FAMAPRO 5D BABY] - Khẩu trang y tế trẻ em kháng khuẩn 3 lớp Famapro 5D Baby (10 cái/ hộp) - 1 HỘP",8900,8900,0,0
TIKI,lam-dep-suc-khoe,580507,"Lăn Khử Mùi Romano Attitude 50ml - 1412046",56000,68000,12000,18
TIKI,lam-dep-suc-khoe,114056241,"Tinh bột nghệ Nano HNT 200g - Đã được kiểm nghiệm và công bố - 100% Nguyên chất - Nguyên liệu hữu cơ - Sản phẩm chính hãng - Uy tín - Chất lượng",109000,109000,0,0
TIKI,lam-dep-suc-khoe,73438399,"Kem chống nắng lâu trôi innisfree Intensive Long Lasting Sunscreen SPF50+ PA++++ 60ml (New 2023)",405000,450000,45000,10
TIKI,lam-dep-suc-khoe,1600039,"Combo 6 Băng Vệ Sinh Diana Siêu Thấm Siêu Mỏng 0.1 (Gói 8 Miếng)",124000,144000,20000,14
TIKI,lam-dep-suc-khoe,138662376,"Dung dịch vệ sinh Phụ nữ Gel X2 Nano Nghệ Đào Hồng Mềm Mại Lưu Hương 24h Cocayhoala - 150ml",209000,330000,121000,37
TIKI,lam-dep-suc-khoe,12053893,"Lăn Khử Mùi Etiaxil Détranspirant Traitement Aisselles Peaux Sensibles 15ml (Dành cho da hỗn hợp, da nhạy cảm)",215000,350000,135000,39
TIKI,lam-dep-suc-khoe,77749059,"Tinh Dầu Sả Chanh 50ML + Tinh Dầu Treo xe Treo Phòng Sả Chanh (Lemongrass) - Tinh Dầu Xông Phòng Sả Chanh Nguyên Chất TIDAMO Giúp Bảo Vệ Sức Khỏe, Kháng Khuẩn, Đuổi Muỗi Và Thư Giãn Tinh Thần",128000,256000,128000,50
TIKI,lam-dep-suc-khoe,105821846,"Tinh Dầu Treo Xe Homer 7ML - Khử Mùi Xe Hơi, Treo Thơm Phòng, Treo Tủ - Tinh dầu treo Sả chanh/ Bạc Hà/ Quế",8000,8000,0,0
TIKI,lam-dep-suc-khoe,146584853,"Bàn chải đánh răng điện FAIRYWILL D7 Công nghệ sóng siêu âm 5 Chế độ làm sạch 3 Đầu thay thế đặc biệt Hàng Chính Hãng",218000,267000,49000,18
TIKI,lam-dep-suc-khoe,75528793,"Combo 3 Tinh Dầu Sả Chanh + Tinh Dầu Bạc Hà + Tinh Dầu Cam Ngọt - Tinh Dầu Xông Phòng Nguyên Chất Nhập Khẩu Giúp Thư Giãn, Đuổi Muỗi Và Thơm Phòng (3 chai 10ML)",118000,236000,118000,50
TIKI,lam-dep-suc-khoe,70633870,"Khẩu Trang Y Tế Kháng Khuẩn Cao Cấp TDCare 4 Lớp",27400,27400,0,0
TIKI,lam-dep-suc-khoe,262677342,"Hộp 48 cái Bao cao su Tâm Thiện Chí Guardian - Mỏng trơn, Nhiều dầu bôi trơn, Size 52mm",60000,65000,5000,8
TIKI,lam-dep-suc-khoe,186305097,"Gối Kê Gáy, Cổ Thảo Dược Hapaku - Làm Nóng Bằng Lò Vi Sóng",179000,198000,19000,10
TIKI,lam-dep-suc-khoe,20640806,"Lưỡi Lược Thép Lược Bướm Tập Quay",52900,52900,0,0
TIKI,lam-dep-suc-khoe,128125614,"Combo 6 Băng Vệ Sinh Diana Hàng Ngày Compact Gói 20+2 Miếng",88000,108000,20000,19
TIKI,lam-dep-suc-khoe,53296092,"Sữa chống nắng Shiseido GSC The Perfect Protector 50ml",1250000,1250000,0,0
TIKI,lam-dep-suc-khoe,184793101,"Máy Massage Cầm Tay Cao Cấp KINGTECH - Hỗ Trợ Toàn Thân - Chuyên Sâu Cổ, Vai, Gáy, Lưng - Giảm Đau Mỏi Cho Dân Văn Phòng, Gymer, Người Già, Người Lao Động Nặng - Chính Hãng",865000,1750000,885000,51
TIKI,lam-dep-suc-khoe,135352499,"Túi chườm nóng đau bụng kinh nguyệt PUHA 700ml, túi chườm ấm bụng giảm đau hiệu quả cho bạn nữ",169000,169000,0,0
TIKI,lam-dep-suc-khoe,442858,"Nhiệt Ẩm Kế Beurer HM 16",360000,380000,20000,5
TIKI,lam-dep-suc-khoe,1754767,"Combo 2 Gel vệ sinh nam Serenys 100ml - Dung dịch vệ sinh phụ khoa nam giới",249000,249000,0,0
TIKI,lam-dep-suc-khoe,75321691,"Nước Súc Miệng Chăm sóc chuyên sâu Amfagold Care Gingival 0.12% Chlorhexedine",80000,120000,40000,33
TIKI,lam-dep-suc-khoe,176812001,"Vitamin Bầu Tổng Hợp Elevit Cho Phụ Nữ Trước, Trong và Sau Thai Kỳ 30 Viên",333000,333000,0,0
TIKI,lam-dep-suc-khoe,74307186,"Serum Tinh Chất Chấm Mụn Lành Tính Nhanh Xẹp Mụn Chống Thâm Và Sẹo Rỗ DewyTree The Clean Lab AC DEW Calamine Blemish Spot 20ml",297500,350000,52500,15
TIKI,lam-dep-suc-khoe,78007672,"Sữa rửa mặt không gây kích ứng cho da nhạy cảm Eucerin pH5 Facial Cleanser 400ml",193000,279000,86000,31
TIKI,lam-dep-suc-khoe,205080549,"Viên uống tăng cường sinh lý nam giới Powergra (Super Gold Magic) - Vỉ 1 viên",202400,220000,17600,8
TIKI,lam-dep-suc-khoe,631959,"Kem mờ sẹo và thâm dạng gel Acnes Scar Care 12g",71400,79000,7600,10
TIKI,lam-dep-suc-khoe,55613571,"Kem Chống Nắng Tế Bào Gốc Kiềm Dầu Chống Nhăn Dưỡng Ẩm Trắng Da Cellkey-Scien Multi Perfect Sun Cream SPF50+PA+++ (50ml)",382500,450000,67500,15
TIKI,lam-dep-suc-khoe,1911371,"Kem Dưỡng Làm Dịu Kích Ứng Và Phục Hồi Da La Roche-Posay Cicaplast Baume B5 (40ml)",226000,238000,12000,5
TIKI,lam-dep-suc-khoe,2007545,"Nước Súc Miệng Hương Bạc Hà Listerine Cool Mint (750ml)",169000,169000,0,0
TIKI,lam-dep-suc-khoe,186270829,"Bộ đai chườm nóng thảo dược giảm đau lưng bụng dùng điện - Hapaku",966000,995000,29000,3
TIKI,lam-dep-suc-khoe,105632361,"Bộ 1 hộp bao cao su Durex Performa 12 bao và 1 Durex Fetherlite 12 bao",407000,568000,161000,28
TIKI,lam-dep-suc-khoe,273952811,"Bộ Đôi Kem Dưỡng Chống Lão Hóa Da Ngày Và Đêm Pond's Age Miracle giúp mờ đốm nâu, nếp nhăn với 50X Hexyl-Retinol 45g x 2",525000,760000,235000,31
TIKI,lam-dep-suc-khoe,95175125,"Tinh Dầu Quế Homer 100ml - Chính Hãng, Đạt Chuẩn Kiểm Định Cao Cấp - Tinh Dầu Xông Thơm Phòng, Thư Giãn, Khử Mùi hiệu quả",65000,65000,0,0
TIKI,lam-dep-suc-khoe,161368381,"Dung dịch tẩy tế bào chết Paula’s Choice Skin Perfecting 2% BHA Liquid Exfoliant 118 ml-2010",855000,949000,94000,10
TIKI,lam-dep-suc-khoe,48291658,"Kem chống nắng body Skin Aqua mát lạnh dùng hàng ngày Sunplay Skin Aqua UV Body Cooling Lotion SPF 50+ PA++++ 150g",178000,219000,41000,19
TIKI,lam-dep-suc-khoe,131504747,"Dầu gội dược liệu Thái Dương 7 Plus Gold (Chai 250ml/500ml, Hoa phong Ian) - Sao Thái Dương",165000,165000,0,0
TIKI,lam-dep-suc-khoe,195969972,"Kem đánh răng dạng gel Closeup White Attraction Diamond (100g)",31600,39500,7900,20
TIKI,lam-dep-suc-khoe,118089852,"Bộ 2 Tuýp Kem Chống Hăm Bepanthen Balm Dạng Kem Mỡ 30G/Tuýp ",191000,191000,0,0
TIKI,lam-dep-suc-khoe,70809049,"TINH BỘT NGHỆ NGUYÊN CHẤT 100% ORGANIC TETE 500 gram",155000,155000,0,0
TIKI,lam-dep-suc-khoe,76122941,"Mật ong Rừng Nhiệt Đới chai 1350g",168000,280000,112000,40
TIKI,lam-dep-suc-khoe,59085965,"Máy Xông Tinh Dầu Vân Gỗ Cao Cấp Dung Tích 500ML Chuyên Dụng Cho Phòng Lớn",226000,478000,252000,53
TIKI,lam-dep-suc-khoe,12054639,"Lăn khử mùi Etiaxil Détranspirant Traitement Confort+ Aisselles Peaux Sensibles 15ml (Dành cho da siêu nhạy cảm)",249000,320000,71000,22
TIKI,lam-dep-suc-khoe,58962618,"Máy Massage Cầm Tay Đa Năng KINGTECH YT-1803 - Mát Xa Không Dây Toàn Thân - Giảm Đau Cơ, Cứng Khớp Cho Cổ, Vai Gáy, Lưng, Chân, Cánh Tay - Hỗ Trợ Giảm Béo Vòng Bụng - Hàng Chính Hãng",624000,1100000,476000,43
TIKI,lam-dep-suc-khoe,80960308,"Gối Massage Hồng Ngoại 8 Bi Đảo Chiều Chính Hãng THAFA -Massage Cổ, Vai, Gáy , Kèm Tẩu Sạc Trên Xe Hơi Vô Cùng Tiện Lợi",206000,325000,119000,37
TIKI,lam-dep-suc-khoe,877460,"Combo 5 Miếng Dán hỗ trợ điều trị Mụn Mayancare 20 Miếng (0.8cm)",144000,175000,31000,18
TIKI,lam-dep-suc-khoe,58536309,"Đai chông gù lưng, áo chống gù lưng chính hãng GoodFit GF713P",499000,599000,100000,17
TIKI,lam-dep-suc-khoe,105626002,"Bộ 4 Bao Cao Su Durex Sensual Strawberry - Hộp 3 Bao",172000,208000,36000,17
TIKI,lam-dep-suc-khoe,108535223,"Bao cao su Sagami Green - Có gân gai - Hộp 10 chiếc",95000,120000,25000,21
TIKI,lam-dep-suc-khoe,95127416,"Tinh Dầu Cam Ngọt Homer 100ml - Chính Hãng, Đạt Chuẩn Kiểm Định Cao Cấp - Tinh Dầu Xông Thơm Phòng, Thư Giãn, Khử Mùi hiệu quả",60000,60000,0,0
TIKI,lam-dep-suc-khoe,14576680,"Máy Xông Mũi Họng Oron Nhật Bản NE-C801",1026000,1657960,631960,38
TIKI,lam-dep-suc-khoe,1313897,"Lotion dưỡng ẩm cao cấp - Siêu cấp ẩm cho da căng mượt Hada Labo Gokujyun Premium Hydrating Lotion (170ml)",258000,320000,62000,19
TIKI,lam-dep-suc-khoe,22103020,"The Ordinary AHA 30% + BHA 2% Peeling Solution - Giải Pháp Hỗ Trợ Giảm Vết Thâm, Da Sần Mụn, Lỗ Chân Lông 30ml",275000,280000,5000,2
TIKI,lam-dep-suc-khoe,630793,"Kem chống nắng Skin Aqua trang điểm tạo nền trắng mịn & đều màu dạng sữa Sunplay Skin Clear White CC Milk SPF 50, PA++++ 25g",123000,145000,22000,15
TIKI,lam-dep-suc-khoe,150016863,"Set 50 cái khẩu trang y tế KF94 Kháng Khuẩn, Chống Bụi Mịn, Hàng Cao Cấp",48000,80000,32000,40
TIKI,lam-dep-suc-khoe,60684152,"Dầu Gội Hà Thủ Ô 2in1 Dành Riêng Cho TÓC BẠC Và RỤNG TÓC Cocayhoala Chai Lớn 450g Tiết Kiệm Hơn 1,5 lần",270000,450000,180000,40
TIKI,lam-dep-suc-khoe,12084610,"Kem Dưỡng Ẩm Cho Da Khô Và Nhạy Cảm Eucerin Lipo Balance (50ml)",215000,215000,0,0
TIKI,lam-dep-suc-khoe,158762755,"Bọt vệ sinh nam giới Oniiz - Dung dịch vệ sinh nam tạo bọt 100ml",120000,120000,0,0
TIKI,lam-dep-suc-khoe,117147637,"Sữa rửa mặt Simple giúp cấp ẩm, da trông khỏe và mịn màng - cho da khô nhạy cảm 150ml [CHÍNH HÃNG ĐỘC QUYỀN] [MỚI]",102000,132000,30000,23
TIKI,lam-dep-suc-khoe,181097570,"Tinh Chất Dưỡng Sáng Da Laneige Radian-C Vitamin Spot Serum 10g",605000,750000,145000,19
TIKI,lam-dep-suc-khoe,25917940,"Gel Cải Thiện Sẹo Và Vết Thâm Ngứa Trẻ Em Hiruscar Kids 10G",245000,245000,0,0
TIKI,lam-dep-suc-khoe,75523734,"Combo 3 Tinh Dầu Sả Chanh + Tinh Dầu Bạc Hà + Tinh Dầu Vỏ Quế - Tinh Dầu Thiên Nhiên Xông Phòng Cao Cấp Giúp Thư Giãn, Đuổi Muỗi Và Thơm Phòng (3 chai 10ML)",74000,176000,102000,58
TIKI,lam-dep-suc-khoe,70662253,"Kem Chống Nắng Không Màu Kiểm Soát Dầu La Roche-Posay Anthelios XL Dry Touch Gel-Cream SPF 50+ UVB & UVA (50ml)",392000,560000,168000,30
TIKI,lam-dep-suc-khoe,26115522,"Viên uống Bổ Sung Kẽm DHC ZinC Nhật Bản",72000,75000,3000,4
TIKI,lam-dep-suc-khoe,111937524,"Betaclor® Austria Viên đặt phụ khoa, Giải Pháp Toàn Diện Bệnh Phụ Khoa: Viêm Phụ Khoa, Nấm Candida, Tăng Tiết Dịch Nhầy Bôi Trơn. Viên Đặt Se Khít Tái Tạo Phục Hồi Niêm Mạc, Ngừa Teo Hoá, Cân Bằng pH Lợi Khuẩn. Nhập Khẩu Nguyên Hộp Austria Châu Âu",339000,339000,0,0
TIKI,lam-dep-suc-khoe,67017650,"Combo 6 Băng vệ sinh Diana Siêu thấm Cool Fresh Siêu mỏng Cánh gói 8 miếng",124000,138000,14000,10
TIKI,lam-dep-suc-khoe,158772428,"Máy massage mini cầm tay CTFAST-720: Mát xa 6 cấp độ, hỗ trợ maassage chuyên sâu, giảm đau cơ, cứng khớp hiệu quả nhanh chóng, đi kèm 4 đầu chuyên dụng - Quà tặng cho sức khỏe",415000,549000,134000,24
TIKI,lam-dep-suc-khoe,1521643,"Xịt Khoáng Avène Thermal Spring Water 100715921 (300ml)",261000,385000,124000,32
TIKI,lam-dep-suc-khoe,21155024,"Dầu hấp ủ tóc siêu mượt Karseell Maca Essence Repair Collagen (dạng túi) 500ml",171000,199000,28000,14
TIKI,lam-dep-suc-khoe,23079051,"Combo 3 Hộp Tăm Bông Diva Thân Giấy - 200 Que/Hộp",74900,74900,0,0
TIKI,lam-dep-suc-khoe,43859841,"Sữa Rửa Mặt Cetaphil Gentle Skin Cleanser 591 ML nhập Costco USA",325000,325000,0,0
TIKI,lam-dep-suc-khoe,52216318,"Combo 3 Kem Đánh Răng Closeup Dạng Gel Trắng Răng Diamond Attraction Ngay Sau 1 Lần Chải 100G/Tuýp",117000,117000,0,0
TIKI,lam-dep-suc-khoe,93514280,"Máy Massage Cầm Tay Đa Năng Cao Cấp KINGTECH LUX-900 - Mát Xa Toàn Thân, Chuyên Sâu Cho Lưng, Cổ, Vai, Gáy Cánh Tay - Chính Hãng",1050000,1750000,700000,40
TIKI,lam-dep-suc-khoe,453517,"Nhiệt Kế Nhỏ Đầu Cứng Beurer FT09",98500,185309,86809,47
TIKI,lam-dep-suc-khoe,78509478,"Combo 3 Tinh Dầu Oải Hương + Tinh Dầu Bạc Hà + Tinh Dầu Vỏ Quế Nguyên Chất - Tinh Dầu TIDAMO Cao Cấp Xông Phòng Giúp Thư Giãn, Thơm Phòng Và Nâng Cao Sức Khỏe (3 chai 10ML)",84000,236000,152000,64
TIKI,lam-dep-suc-khoe,385568,"Bao cao su Durex Fetherlite Hộp 3 Bao",54100,69000,14900,22
TIKI,lam-dep-suc-khoe,44810580,"Bộ Dầu Gội Xả Hỗ Trợ Trị Rụng Tóc Kích Thích Mọc Tóc Weilaiya Tinh Chất Gừng Hà Thủ Ô Cao Cấp Ngăn Ngừa Rụng Tóc Lưu Thông Mạch Máu Hương Thảo Dược (Gội 400ml- Xả:250ml)- Sản Phẩm Chính Hãng",477000,477000,0,0
TIKI,lam-dep-suc-khoe,63793228,"Máy Khuếch Tán Tinh Dầu Siêu Âm Loại Lớn có Đèn LED đổi màu Và Remote Điều Khiển Cao Cấp",153000,338000,185000,55
TIKI,lam-dep-suc-khoe,878393,"Tỏi Kim Cương Đông Á túi 500g- Tỏi đen cô đơn SX theo công nghệ Nhật Bản -Kiểm nghiệm chất lượng bởi Bộ Y Tế, Intertek",495000,560000,65000,12
TIKI,lam-dep-suc-khoe,94098195,"Khẩu trang 4D kháng khuẩn Hello Mask Fashion - Premium",45900,45900,0,0
TIKI,lam-dep-suc-khoe,108535216,"Bao cao su Sagami Superthin - Mỏng - Kiểu truyền thống - Hộp 2 chiếc",32000,35000,3000,9
TIKI,lam-dep-suc-khoe,85701615,"KỀM CẮT DA INOX",165000,165000,0,0
TIKI,lam-dep-suc-khoe,53923837,"Tinh chất dưỡng the Ordinary Hyaluronic Acid 2 % + B5",245000,249000,4000,2
TIKI,lam-dep-suc-khoe,15520057,"Tinh chất chống lão hóa Hada Labo Pro Anti Aging α Lifting Essence 30g",258000,322000,64000,20
TIKI,lam-dep-suc-khoe,1313881,"Kem chống nắng Skin Aqua dưỡng trắng & dưỡng ẩm, dùng hàng ngày dạng gel Sunplay Skin Aqua Silky White Gel Eco Việt Nam SPF 50, PA++++ 30g",88900,109000,20100,18
TIKI,lam-dep-suc-khoe,183558378,"Xịt Khử Mùi Hôi Nách SAKITO LANCEJ - Khử Mùi Hôi Nách, Hôi Chân, Thâm Nách, Ra Mồ Hôi Nách - Thành Phần Từ Thiên Nhiên | Dung Tích 50ml - HÀNG CHÍNH HÃNG",90000,180000,90000,50
TIKI,lam-dep-suc-khoe,58530142,"Kem Dưỡng Trắng Da Ban Đêm Oribe Dưỡng Ẩm Làm Mờ Thâm Nám Làm Mờ Tàn Nhang 30g",263000,320000,57000,18
TIKI,lam-dep-suc-khoe,204009169,"Dung dịch vệ sinh nam Bergami for Man - Ngăn mùi suốt 12h",65000,100000,35000,35
TIKI,lam-dep-suc-khoe,33606875,"Sữa rửa mặt trị mụn và se khít lỗ chân lông Paula’s Choice Clear Pore Normalizing Cleanser 177 ml",510000,579000,69000,12
TIKI,lam-dep-suc-khoe,12146976,"EUCERIN GEL RỬA MẶT DÀNH CHO DA NHỜN MỤN EUCERIN PROACNE CLEASING 200ML",250000,369000,119000,32
TIKI,lam-dep-suc-khoe,68176012,"Khẩu trang than hoạt tính GP Extreme (Mẫu mới, nhiều màu để lựa chọn)",50000,50000,0,0
TIKI,lam-dep-suc-khoe,195210591,"Tinh dầu Bưởi Ngọt 24Care 100ML - Chiết xuất thiên nhiên, khử mùi, thơm phòng, thư giãn tinh thần",75000,75000,0,0
TIKI,lam-dep-suc-khoe,170066594,"Combo 3 Hộp Khẩu trang Bông Bạch Tuyết 3 lớp trắng (50 cái/hộp)",177000,177000,0,0
TIKI,lam-dep-suc-khoe,91864374,"Set 5 Cây Son Kem Lì VONGEE Mịn Mượt Như Nhung Và Không Khô Môi",48000,95000,47000,49
TIKI,lam-dep-suc-khoe,7690641,"Thiên Môn Bổ Phổi Bình Đông – Giúp giảm ho, Bổ phổi – Chai 280ml",72520,74000,1480,2
TIKI,lam-dep-suc-khoe,186633014,"Tinh Dầu Sả Chanh Tự Nhiên Nguyên Chất 10ml Hapaku",95000,109000,14000,13
TIKI,lam-dep-suc-khoe,7331189,"Son Dưỡng Môi DHC Lip Cream 1,5g",165000,199000,34000,17
TIKI,lam-dep-suc-khoe,21024823,"Gel nghệ Nano siêu hấp thu Decumar New (20g) - Ngừa mụn, Giảm thâm sẹo, Kiểm soát nhờn",60000,60000,0,0
TIKI,lam-dep-suc-khoe,201816436,"Bàn Chải Điện Halio Sonic Whitening Toothbrush Pro",999000,1550000,551000,36
TIKI,lam-dep-suc-khoe,129521118,"Kem Dưỡng Da Mờ Thâm Nám, Tàn Nhang Fixderma Skarfix-TX Cream 15g",179000,278000,99000,36
TIKI,lam-dep-suc-khoe,19901553,"Máy Rửa Mặt Halio Sensitive Facial Device Dành Cho Da Nhạy Cảm - Sóng Âm Sạch Sâu, Kèm Hộp Treo",699000,849000,150000,18
TIKI,lam-dep-suc-khoe,140586253,"INFLUPROP Austria, Nasal Spray Dung dịch xịt sương giúp hỗ trợ điều trị viêm xoang, viêm mũi,  phòng ngừa vi khuẩn, virus, tạo màng niêm mạc bảo vệ lành nhanh vết thương, dưỡng ẩm, chống ngạt sổ mũi, ngưng chảy dịch mũi. Nhập khẩu Châu Âu",259000,259000,0,0
TIKI,lam-dep-suc-khoe,116369227,"Khẩu trang 3D mask Long Hưng công nghệ Nhật Bản chống bụi mịn cao cấp hộp đóng 50 cái",38000,40000,2000,5
TIKI,lam-dep-suc-khoe,2075159,"Gel hỗ trợ điều trị Mụn Thâm Neocurma (20g)",118000,118000,0,0
TIKI,lam-dep-suc-khoe,25917924,"Gel Hỗ Trợ Trị Sẹo Mổ, To, Lồi Và Phì Đại Hiruscar Silicone Pro 4G",172000,172000,0,0
TIKI,lam-dep-suc-khoe,158091977,"Tinh Dầu Hoa Nhài TIDAMO 100ML Nhập Khẩu, Có Kiểm Nghiệm, Hương Thơm Dịu Nhẹ Quý Phái - Tinh Dầu Hoa Lài (Jasmine) Xông Thơm Phòng, Thư Giãn và Tốt Cho Sức Khỏe",193800,398000,204200,51
TIKI,lam-dep-suc-khoe,52637902,"Dầu Gội Sạch Gàu Antisol pH6.5 Chiết Xuất Dược Liệu Ngăn Ngừa Gàu, Rụng Tóc, Ngứa Da Đầu Tái Phát - Chai 240ml - Thương Hiệu iCare Pharma",225000,283000,58000,20
TIKI,lam-dep-suc-khoe,82721610,"Máy Tăm Nước LocknLock Oral Irrigator ENR111BLU - Màu Xanh Dương",949000,1584000,635000,40
TIKI,lam-dep-suc-khoe,28517939,"Viên uống Tinh Chất Hàu biển OB - Tăng cường sinh lý nam, Bổ Thận, Tăng Chất Lượng Tinh Trùng, hộp 30v",329000,379000,50000,13
TIKI,lam-dep-suc-khoe,12056666,"Lăn Khử Mùi Etiaxil Detranspirant Traitement Aisselles Peaux Normales 15ml (Dành cho da thường)",215000,350000,135000,39
TIKI,lam-dep-suc-khoe,50308042,"Goodhealth Oyster Plus Tinh Chất Hàu 60 Viên - Tăng Cường Sinh Lý - Cải Thiện Chất Lượng Tinh Trùng - Hàng Chính Hãng New Zealand",427000,429000,2000,0
TIKI,lam-dep-suc-khoe,177424215,"Cân Điện Tử Sức Khoẻ Thông Minh Mặt Vuông Kính Cường Lực Chịu Lực Màu Đen Sang Trọng 180Kg Deli - Phù Hợp Gia Đình Trường Học - Hàng Chính Hãng - E86120",179000,322200,143200,44
TIKI,lam-dep-suc-khoe,2623229,"Sữa Rửa Mặt SVR Sebiaclear Gel Moussant  (50ml)",95000,140000,45000,32
TIKI,lam-dep-suc-khoe,184042484,"Combo Sữa Rửa Mặt và Serum Mugung Dưỡng da 24k xóa thâm nám chống lão hóa chứa Vitamin C,E, collagen",400000,400000,0,0
TIKI,lam-dep-suc-khoe,157548456,"Viên Uống Xuyên Tâm Liên Bổ Phổi Giảm Ho Đờm Ho Khan Đau Rát Họng Xuyên Tâm Huyền Thảo ( Hộp 30 viên )",97000,128000,31000,24
TIKI,lam-dep-suc-khoe,71950236,"Dầu Gội Clear Sạch Gàu Dầu Gội Sạch Gàu Mát Lạnh Bạc Hà 3X Sức Mạnh Đánh Bay Gàu, Ngứa, Vi Khuẩn 880G",175000,216900,41900,19
TIKI,lam-dep-suc-khoe,74593902,"ComBo 10 Chiếc Khẩu Trang Trẻ Em KF94 - Form 3D Cao Cấp Chống Bụi Siêu Mịn 0.4um Anyguard Hàn Quốc Chính Hãng - 4 Lớp - 베이비 마스크 - Face Mask For Kids-ISO 9001:2015, ISO 13485:2016, QCVN 01:2017/BTC",54000,55200,1200,2
TIKI,lam-dep-suc-khoe,74402547,"ComBo (30 Chiếc) Khẩu Trang 2D Hàn Quốc Anyguard Chính Hãng - Dành Cho Người Lớn (10 gói) - Quai Đeo Siêu Đàn Hồi, 3 Lớp Bảo Vệ Tối Ưu - ISO 9001:2015, ISO 13485:2016, QCVN 01:2017/BTC",98000,100000,2000,2
TIKI,lam-dep-suc-khoe,25444067,"Son kem lì Bbia Last Velvet Lip Tint - 25 Final Note 5g (màu cam nâu đất)",140000,290000,150000,52
TIKI,lam-dep-suc-khoe,105618884,"Tinh Dầu Xông Phòng Chai Lớn 100ML, Tự Chọn Mùi | Chính Hãng TIDAMO, Chiết xuất Tự Nhiên, Có Kiểm Nghiệm | Xông Thơm Phòng, Thư Giãn và Bảo Vệ Sức Khỏe",119000,336000,217000,65
TIKI,lam-dep-suc-khoe,57855825,"Kem Nền Che Khuyết Điểm Kiềm Dầu Mịn Nhẹ Chống Nắng DD Cream Oribe 25g",256000,320000,64000,20
TIKI,lam-dep-suc-khoe,460386,"Sữa Tắm Lifebuoy Sạch Khuẩn Chăm Sóc Da Ngăn Ngừa Vi Khuẩn Lây Lan Với Ion Bạc+ Hỗ Trợ Cùng Đề Kháng Da Tự Nhiên Túi 800G",119000,119000,0,0
TIKI,lam-dep-suc-khoe,153597872,"Son thỏi dưỡng môi trang điểm chất son satin Lip On Lip Glowy Satin",165000,166000,1000,1
TIKI,lam-dep-suc-khoe,6583921,"Combo Sữa Tắm L'amont En Provence Shower Gel Hương Almond + Olive (500ml / Chai)",189000,280000,91000,33
TIKI,lam-dep-suc-khoe,1313877,"Kem chống nắng Sunplay cho bé từ 6 tháng tuổi và da nhạy cảm, dạng sữa Sunplay Baby Mild SPF 35, PA++ 30g",79900,97000,17100,18
TIKI,lam-dep-suc-khoe,36158810,"Bộ tắm trắng toàn thân Truesky gồm 1 kem ủ trắng toàn thân 100g và 1 kem dưỡng trắng toàn thân 100g",169000,320000,151000,47
TIKI,lam-dep-suc-khoe,2835905,"MỠ TRĂN NGUYÊN CHẤT 100ml triệt lông, bôi bỏng",66666,99000,32334,33
TIKI,lam-dep-suc-khoe,260847275,"Gel giảm sẹo lồi, phì đại Rejuvasil",420000,450000,30000,7
TIKI,lam-dep-suc-khoe,114467131,"Bộ dụng cụ lấy ráy tai chuyên nghiệp,dụng cụ lấy ráy tai người lớn,dụng cụ lấy ráy tai thông minh cho bé kèm dây đeo BaoAn- Nhiều mẫu lựa chọn -Hàng Chính Hãng - Màu hộp giao ngẫu nhiên",48000,69000,21000,30
TIKI,lam-dep-suc-khoe,33761260,"Bao Cao Su Kéo Dài Thời Gian Quan Hệ và Có Gai Innova Đen - Hộp 3 Cái",39000,39000,0,0
TIKI,lam-dep-suc-khoe,173401401,"Máy Khuếch Tán Tinh Dầu Có Loa Bluetooth Nghe Nhạc Cực Hay, Máy Xông Tinh Dầu Chuyên Dụng, Có Remote Điều Khiển Và Đèn LED 7 Màu",287300,668000,380700,57
TIKI,lam-dep-suc-khoe,190630654,"Sữa Rửa Mặt Dịu Nhẹ Cho Da Khô CeraVe SA Smoothing Cleanser 236ml",264000,330000,66000,20
TIKI,lam-dep-suc-khoe,270808499,"Xịt họng keo Ong Úc Vitatree Super Propolis Spray Complex with Honey 15+ Giúp bổ sung kháng khuẩn tự nhiê, Giảm đau rát viêm họng, ho, nhiệt lỡ miệng - OZ Slim Store",312000,668000,356000,53
TIKI,lam-dep-suc-khoe,95735629,"Sữa dưỡng thể vaseline healthy bright hồng làm mịn &trắng da 725ml mẫu mới",165000,165000,0,0
TIKI,lam-dep-suc-khoe,7222235,"Kem chống nắng đa năng siêu nhẹ không bết dính Paula’s Choice Resist Super -Light Daily Wrinkle Defense SPF30 60ml",855000,950000,95000,10
TIKI,lam-dep-suc-khoe,75639107,"Nước súc miệng hàng ngày chiết xuất thiên nhiên giúp Ngăn ngừa vi khuẩn Ngăn ngừa màng bám Cải thiện viêm nướu, viêm nha chu AMFAGOLD Care DAILY USE 250ml",74000,100000,26000,26
TIKI,lam-dep-suc-khoe,186270101,"Bộ đai chườm nóng thảo dược giảm đau vai gáy dùng điện - Hapaku",969000,995000,26000,3
TIKI,lam-dep-suc-khoe,132097368,"Nước Súc Miệng Giúp Nướu Chắc Khỏe Listerine Gum Protect Zero Alcohol - Dung Tich 250ml -750ml",71000,71000,0,0
TIKI,lam-dep-suc-khoe,174481487,"[COMBO 2 HỘP KHÔNG ĐƯỜNG] Kẹo ngậm Viacol Vietnat 20 viên - gừng Vietnat 20 viên giảm ho rát họng",64700,64700,0,0
TIKI,lam-dep-suc-khoe,114230314,"Kem hỗ trợ giảm mụn Differin Cream 0.1% Adapalene tuýp 30 gram(Hàng nội địa Pháp)",293000,450000,157000,35
TIKI,lam-dep-suc-khoe,161451877,"Dung dịch vệ sinh mũi Nose Hygiene Spray",85000,85000,0,0
TIKI,lam-dep-suc-khoe,104791199,"Collagen Viên Nhật Bản, Hỗ Trợ Ngăn Ngừa Lão Hóa Da, Giúp Tóc Móng Chắc Khỏe, Hộp 180 Viên",799000,935000,136000,15
TIKI,lam-dep-suc-khoe,69463660,"Máy xông tinh dầu sóng siêu âm cao cấp vân gỗ - Có Remote. Máy khuếch tán tinh dầu giúp tỏa hương, tạo độ ẩm, làm thơm phòng",219000,468000,249000,53
TIKI,lam-dep-suc-khoe,933547,"Bao Cao Su Powermen Longer Plus Cá Ngựa Bạc (Hộp 3 Cái)",40000,50000,10000,20
TIKI,lam-dep-suc-khoe,92159183,"Combo 2 hộp Bao cao su Durex Fetherlite Ultima 12 Bao",430000,600000,170000,28
TIKI,lam-dep-suc-khoe,394686,"Nước Xịt Khoáng Evoluderm 400ml - 7084  ",189000,298000,109000,37
TIKI,lam-dep-suc-khoe,194468327,"Máy khuếch tán/ máy xông tinh dầu Lorganic hình Núi Caro FX2079 + tinh dầu sả chanh 10ml/ Công nghệ hiện đại (tích hợp remote)/ Thích hợp xông  phòng 15-40m2",275000,500000,225000,45
TIKI,lam-dep-suc-khoe,91566964,"Chỉ nha khoa SGS nhập khẩu Hàn Quốc - 840D hương bạc hà",35000,70000,35000,50
TIKI,lam-dep-suc-khoe,56104679,"Combo 2 Xịt toàn thân Romano Classic cổ điển lịch lãm 150ml",159000,206000,47000,23
TIKI,lam-dep-suc-khoe,172368164,"Cồn Sát Khuẩn 70 Độ Hoàng Long (Can 3.8L)",160000,160000,0,0
TIKI,lam-dep-suc-khoe,185396832,"Kệ , Tủ Mỹ Phẩm Trang Điểm Để Bàn Có Gương Nhiều Ngăn - Hàng Chính Hãng",136850,206000,69150,34
TIKI,lam-dep-suc-khoe,128934972,"Nước Đông Trùng Hạ Thảo 60 Gói Deadong Hàn Quốc ",1343000,1500000,157000,10
TIKI,lam-dep-suc-khoe,136049636,"Tinh Dầu Lavender 30ML Nhập Khẩu Cao Cấp - Tinh Dầu Oải Hương TIDAMO Xông Phòng Thư Giãn, Bảo Vệ Sức Khỏe",78000,176000,98000,56
TIKI,lam-dep-suc-khoe,77156720,"Sữa Tắm Dưỡng Ẩm Trắng Da Hatomugi Xanh 600ml",109000,126000,17000,13
TIKI,lam-dep-suc-khoe,11860156,"Viên uống Ngăn Rụng Tóc, Giúp Tóc Mọc Dày và Nhanh, Làm Đen Tóc Welhair for Women (Hộp 30 viên)",242000,320000,78000,24
TIKI,lam-dep-suc-khoe,70662873,"Gel rửa mặt tạo bọt làm sạch & giảm nhờn cho da dầu nhạy cảm La Roche-Posay Effaclar Purifying Foaming Gel (200ml)",277000,325000,48000,15
TIKI,lam-dep-suc-khoe,15063796,"Combo Hộp 50 que thử đường huyết và 50 kim lấy máu cho máy đo đường huyết Sinocare Safe - Accu",160000,160000,0,0
TIKI,lam-dep-suc-khoe,13959405,"Heliocare Oral Viên Uống Chống Nắng Ngừa Lão Hóa 60 viên",930000,930000,0,0
TIKI,lam-dep-suc-khoe,139135659,"Kẹo ngậm Viasol húng chanh Vietnat giảm ho ấm họng - hộp 100 viên",49500,49500,0,0
TIKI,lam-dep-suc-khoe,72912939,"Nước dưỡng ẩm & làm sáng da Reihaku Hatomugi Lotion (1000ml)",187000,233100,46100,20
TIKI,lam-dep-suc-khoe,178559959,"Sữa Rửa Mặt Nghệ Nhân Sâm MELA Dịu Nhẹ Lành Tính, Hỗ Trợ Làm Sáng Da 200ml - ML08",180000,180000,0,0
TIKI,lam-dep-suc-khoe,43754492,"Kem bôi da Thuần Mộc Thanh Mộc Hương mẫu mới",104000,104000,0,0
TIKI,lam-dep-suc-khoe,166120705,"SPECIAL COMBO làm sạch da chết cơ thể và mặt từ cà phê Đắk Lắk Cocoon (tặng tẩy da chết môi cà phê Đắk Lắk 5g)",290000,290000,0,0
TIKI,lam-dep-suc-khoe,24685119,"Que Thử Đường Huyết Safe Accu Sinocare 50 Que + 50 Kim Chích Máu",160000,160000,0,0
TIKI,lam-dep-suc-khoe,10091481,"Túi Chườm nóng lạnh Đa Năng Hướng Dương cỡ lớn (37 x 26 x 7 cm)",123000,123000,0,0
TIKI,lam-dep-suc-khoe,133158593,"Tinh dầu Trà Trắng Oricen 10ml",66000,110000,44000,40
TIKI,lam-dep-suc-khoe,74989524,"Máy Xông Tinh Dầu Cao Cấp + Tinh Dầu Sả Chanh Nguyên Chất Nhập Khẩu, Máy Khuếch Tán Tinh Dầu Chuyên Dụng, Họa Tiết Sang Trọng và Đèn LED Biến Đổi Màu Cực Đẹp (họa tiết ngẫu nhiên)",298000,596000,298000,50
TIKI,lam-dep-suc-khoe,174509075,"[COMBO 3 HỘP] Kẹo ngậm Viatux Extra Vietnat giảm ho khàn tiếng - 30 viên/ hộp",90750,90750,0,0
TIKI,lam-dep-suc-khoe,75436781,"Son kem lì Bbia Last Velvet Lip Tint Version 8 5g (5 màu)",140000,290000,150000,52
TIKI,lam-dep-suc-khoe,22983097,"Sáp tạo kiểu tóc nam cứng mờ Aurane Cool Stylish Clay 80ml",120000,120000,0,0
TIKI,lam-dep-suc-khoe,8729465,"Tẩy Tế Bào Da Chết Chiết Xuất Từ Than Hoạt Tính ARRAHAN CHARCOAL PEELING GEL (180ml)",62000,62000,0,0
TIKI,lam-dep-suc-khoe,10278480,"Nước uống collagen giúp sáng da, dạ dày khỏe Blossomy lốc 03 chai x 50ml",133000,165000,32000,19
TIKI,lam-dep-suc-khoe,113000272,"Dụng Cụ  Massage Đầu Hình Bạch Tuộc - Hàng Chính Hãng THAFA  (màu ngẫu nhiên)",10000,10000,0,0
TIKI,lam-dep-suc-khoe,55506863,"Hộp 50 cái khẩu trang y tế 4 lớp VN Number One",30000,30000,0,0
TIKI,lam-dep-suc-khoe,188767619,"Dầu gội phủ bạc Mochi Nhật Bản (Lược chải & vòi nhấn). Dầu gội nhuộm tóc thảo dược ngay tại nhà",249000,249000,0,0
TIKI,lam-dep-suc-khoe,57362543,"Cây bông tắm Nufresh - Giao màu ngẫu nhiên",75900,75900,0,0
TIKI,lam-dep-suc-khoe,112976646,"Tinh Dầu Khuếch Hương DAILY COMMA Crystal Hologram Diffuser 100ML (MẪU MỚI NHẬP KHẨU)",270000,270000,0,0
TIKI,lam-dep-suc-khoe,10795695,"Serum Chống Nắng Dưỡng Thể Kháng Bụi - Sáng Mịn Mát Lạnh Biore (150ml)",216000,216000,0,0
TIKI,lam-dep-suc-khoe,1313875,"Kem chống nắng Sunplay dưỡng trắng da, dạng sữa Sunplay Whitening UV SPF 50, PA++++ 30g",80000,97000,17000,18
TIKI,lam-dep-suc-khoe,20649902,"Kem Chống Nắng Cho Mọi Loại Da Cell Fusion C Laser Sunscreen 100 SPF 50+/PA+++ (50ml)",345000,345000,0,0
TIKI,lam-dep-suc-khoe,262899667,"Glucosamine 1500mg Chondroitin 1200mg Kirkland Signature  - Phục hồi sụn khớp, Giảm đau nhức xương khớp và Hỗ trợ sự vận động linh hoạt hiệu quả - QuaTangMe Extaste",674000,1370000,696000,51
TIKI,lam-dep-suc-khoe,58214750,"Khẩu trang y tế 4D 4 lớp cao cấp Hamita - Bịch 1 cái - ISO13485, Dấu CE - Sử dụng giấy kháng khuẩn cao cấp Mealtblown, hiệu quả lọc kháng khuẩn giữ nguyên 99.9% sau 5 lần giặt",9000,9000,0,0
TIKI,lam-dep-suc-khoe,195559389,"Kem dưỡng cấp ẩm ban đêm Neutrogena® Hydro Boost Hyaluronic Acid Night Cream 50g",440000,440000,0,0
TIKI,lam-dep-suc-khoe,3928315,"Bấm Lông Mi Trim",62000,70000,8000,11
TIKI,lam-dep-suc-khoe,271299398,"Collagen Neocell Types 1 & 3 Mỹ Hỗ trợ cang da, giảm nhăn da, giúp da, tóc, móng tay và khớp khỏe mạnh từ bên trong ra ngoài - Massel Official",721000,1442000,721000,50
TIKI,lam-dep-suc-khoe,112998207,"Son Môi M.O.I Nhung Lì Sgirl SUMMER EDITION Hồ Ngọc Hà (2021)",99000,99000,0,0
TIKI,lam-dep-suc-khoe,68005401,"Combo 2 Sữa tắm nước hoa dưỡng da Enchanteur Charming 650gr/ Chai",304000,392000,88000,22
TIKI,lam-dep-suc-khoe,70052293,"Combo máy khuếch tán/ máy xông tinh dầu Lorganic bình hoa FX2057 + tinh dầu bạch đàn chanh Lorganic (10ml) LGN0366",300000,600000,300000,50
TIKI,lam-dep-suc-khoe,128756250,"MUSK KHẨU TRANG Y TẾ 5 LỚP N95 / FFP2 Nhập Khẩu Châu Âu Turkey, Phòng Tránh Lây Nhiễm Vi Khuẩn, Virus, Bệnh Hô Hấp, Hoá Chất, Phòng Thí Nghiệm, Bệnh Viện, Môi Trường Y Tế, Bụi Khuẩn Độc Hại. LỌC VI KHUẨN, VIRUS 99%. Hộp 10 Chiếc Màu Trắng",160000,160000,0,0
TIKI,lam-dep-suc-khoe,7677552,"Thực phẩm bảo vệ sức khỏe Viên dầu cá Kirkland Signature Fish Oil 1000mg từ Mỹ, bổ sung Omega-3, DHA và EPA - 400 Viên",846000,1720000,874000,51
TIKI,lam-dep-suc-khoe,95975019,"Nước Uống Tăng Lực Hồng Sâm Won KGC Cheong Kwan Jang 100ml x 10 Chai",265000,300000,35000,12
TIKI,lam-dep-suc-khoe,116418824,"Gel ngừa mụn Nano THC Decumar 20gr làm sáng da mụn viêm thâm",105000,105000,0,0
TIKI,lam-dep-suc-khoe,127515106,"Hỗ trợ mọc tóc Natrol Biotin Beauty giúp tóc mọc nhanh dài, dày hơn, làn da rạng rỡ và móng tay chắc khỏe - OZ Slim Store",318000,682000,364000,53
TIKI,lam-dep-suc-khoe,173989703,"Sáp Tạo Kiểu Nam Gatsby Styling Giữ Nếp Tóc Cá Tính Full Màu - Tặng móc khoá chính hãng",28000,28000,0,0
TIKI,lam-dep-suc-khoe,152097308,"Bông tẩy trang ipek thỗ nhĩ kì 130 miếng",26500,26500,0,0
TIKI,lam-dep-suc-khoe,15149797,"Bàn Lăn Chân Gỗ Massage 6 Hàng ( 31 X 24 X 10 Cm)",178000,178000,0,0
TIKI,lam-dep-suc-khoe,6738207,"Máy Đo Huyết Áp Cổ Tay Omron - HEM-6161",785000,1280000,495000,39
TIKI,lam-dep-suc-khoe,170066637,"Combo 3 Hộp Khẩu trang Bông Bạch Tuyết 3 lớp Trẻ Em 6 -11 tuổi (30 cái/ hộp)",90000,90000,0,0
TIKI,lam-dep-suc-khoe,4423491,"Thực Phẩm Chức Năng Dầu Cá Omega 3 Orihiro Nhật Bản 180 Viên",315000,352800,37800,11
TIKI,lam-dep-suc-khoe,12084496,"Gel Rửa Mặt Trị Mụn Loại Bỏ Nhờn Ngừa Mụn Eucerin (200ml)",273000,369000,96000,26
TIKI,lam-dep-suc-khoe,74625269,"Gel chấm mụn, mờ thâm Oxy Anti-Acne Spot Gel 10g",63900,78000,14100,18
TIKI,lam-dep-suc-khoe,911351,"Kem Hỗ Trợ Giảm Mụn Ngừa Thâm Liền Sẹo Ori'be Chiết Xuất Tảo Nâu Từ Pháp Tuýp 20g",66000,80000,14000,18
TIKI,lam-dep-suc-khoe,108535212,"Bao cao su Sagami Miracle - Thiết kế 3D - Ôm khít - Size 49 mm - Hộp 10 chiếc",95000,120000,25000,21
TIKI,lam-dep-suc-khoe,104190749,"Viên uống bổ sung kẽm DHC Nhật Bản thực phẩm chức năng Zinc giúp ăn ngon miệng, dưỡng tóc và móng khỏe, giảm mụn, hỗ trợ sinh lý nam 30 ngày JN-DHC-ZIN30",95000,95000,0,0
TIKI,lam-dep-suc-khoe,173744230,"[CHÍNH HÃNG] Một thùng 200 CÁI, màu trắng, khẩu trang 4 lớp KF94 kháng khuẩn, chống bụi mịn, công nghệ 4D Hàn Quốc",148000,148000,0,0
TIKI,lam-dep-suc-khoe,140333343,"Serum dưỡng hồng môi và căng mọng Lipstician Lip Serum Youth Booster 9g",321000,399000,78000,20
TIKI,lam-dep-suc-khoe,270548993,"Dầu Cá Omega 3 Kirkland Signature Fish Oil Bổ não, bổ mắt, Hỗ trợ sức khỏe tim mạch, khớp - QuaTangMe Extaste",846000,1720000,874000,51
TIKI,lam-dep-suc-khoe,72082648,"Mật ong thiên nhiên nguyên chất Hoa Cà Phê ( MS) - ( 700G)",120000,120000,0,0
TIKI,lam-dep-suc-khoe,7074045,"Nước Hoa Hồng Naturie Hatomugi 500ml chiết xuất từ ý dĩ cho da gặp vấn đề lỗ chân lông, mụn",150000,188370,38370,20
TIKI,lam-dep-suc-khoe,559949,"Serum Dew&Dew Vitamin C Treatment Serum - DEW&DEW03 - 50ml",146900,235000,88100,37
TIKI,lam-dep-suc-khoe,75617844,"Combo 2 gói dầu gội xả phục hồi tóc hư tổn RRline Macadamia Star 30ml",23000,50000,27000,54
TIKI,lam-dep-suc-khoe,102739210,"Dầu Gội Nhuộm Tóc Tại Nhà Sin Hair 500ml Mẫu Mới Không Lược - Dầu Gội Nhuộm Tóc Nhân Sâm Nhật Bản Giúp Phủ Bạc Đen Tóc - Nâu Tóc  Tặng Kèm 01 túi Muối Ngâm Chân Thư Giãn",265000,265000,0,0
TIKI,lam-dep-suc-khoe,64994332,"MÁY XÔNG TINH DẦU CAO CẤP CHUYÊN DỤNG CHO PHÒNG LỚN, CÓ ĐIỀU KHIỂN TỪ XA, ĐÈN LED TRANG TRÍ RẤT ĐẸP",199000,398000,199000,50
TIKI,lam-dep-suc-khoe,76134414,"[HỘP - FAMAPRO VN95] - Khẩu trang y tế kháng khuẩn 4 lớp Famapro VN95 đạt chuẩn N95 (10 cái/ hộp) - 1",11500,17000,5500,32
TIKI,lam-dep-suc-khoe,73346761,"Sáp vuốt tóc BY VILAIN GOLD DIGGER 65 ml",419000,419000,0,0
TIKI,lam-dep-suc-khoe,50700390,"Kem Dưỡng Phục Hồi Da Tổn Thương Bioderma Cicabio Crème - 40ml",345000,345000,0,0
TIKI,lam-dep-suc-khoe,53381306,"Máy đo huyết áp bắp tay điện tử Yamada - trợ lý ảo Assistant+ giọng nói tiếng Việt thông minh, đọc kết quả, cảnh báo nhịp tim Heart Link, đo chính xác, thiết kế cao cấp",598000,598000,0,0
TIKI,lam-dep-suc-khoe,186309376,"Gối chườm nóng thảo dược đa năng cho vùng cổ, lưng bụng, đầu gối, giảm nhức mỏi, thư giãn, gối ngủ ngon dùng lò vi sóng làm nóng - Hapaku",242000,259000,17000,7
TIKI,lam-dep-suc-khoe,195981759,"Nước súc miệng P/S Pro Complete (Chai 500ml)",75000,75000,0,0
TIKI,lam-dep-suc-khoe,58676808,"Kem chống muỗi đốt cho bé từ 6 tháng tuổi hương khuynh diệp Rohto Mentholatum Remos Baby Cream 70g",45900,55000,9100,17
TIKI,lam-dep-suc-khoe,108535222,"Bao cao su Sagami 002 - Siêu mỏng - Non Latex - Hộp 2 chiếc",80000,100000,20000,20
TIKI,lam-dep-suc-khoe,37153816,"Viên Uống Bổ Gan Kanzo Ukon Genki Fami Nhật Bản, Hỗ Trợ Giải Độc, Tăng Cường Chức Năng Gan (90 viên/30 ngày)",711000,830000,119000,14
TIKI,lam-dep-suc-khoe,196892106,"Máy massage cầm tay Crenot Therap M5 sung matxa thư giãn giảm dau nhức toàn thân với 6 đầu mát xa cao cấp và 20 cấp độ",860000,1080000,220000,20
TIKI,lam-dep-suc-khoe,5136709,"Kem chống nắng Fixderma Shadow SPF 50+ Cream (75g)",228000,337000,109000,32
TIKI,lam-dep-suc-khoe,76596657,"Tinh Dầu Xông Phòng TRẦM HƯƠNG TIDAMO Cao Cấp - Tinh Dầu Trầm Hương Từ Thiên Nhiên Giúp Bảo Vệ Sức Khỏe, Thư Giãn Và Tĩnh Lặng Tinh Thần - Kiểm Nghiệm Chất Lượng Tại Trung Tâm Quatest 3",34000,168000,134000,80
TIKI,lam-dep-suc-khoe,12084520,"Gel Chống Nắng Cho Da Nhờn Mụn Eucerin Sun Gel-Cream Dry Touch Oil Control SPF50+ (50ml)",372000,549000,177000,32
TIKI,lam-dep-suc-khoe,197575307," Cân điện tử sức khoẻ thông minh Crénot Health GoFit S2 kết nối bluetooth đo phân tích chỉ số cơ thể body fat scale can dien tu suc khoe thong minh Crenot",645000,645000,0,0
TIKI,lam-dep-suc-khoe,17954885,"Bộ sản phẩm cốc nguyệt san Lincup (34ml) ",380000,380000,0,0
TIKI,lam-dep-suc-khoe,1321077,"Viên Uống Đẹp Da Chống Nám Ngăn Ngừa Lão Hóa Oribe (Hộp 30 viên)",211000,286000,75000,26
TIKI,lam-dep-suc-khoe,11183003,"Kem Ủ Tóc Collagen Karseell Maca 500ml (Hủ)",176000,199000,23000,12
TIKI,lam-dep-suc-khoe,1659085,"Combo 10 Gói Mặt Nạ Tái Tạo Da Từ Collagen 3w Clinic Fresh Collagen Mask Sheet 100% Cotton (23ml/Miếng)",56000,56000,0,0
TIKI,lam-dep-suc-khoe,112984896,"Omega 3 Úc Healthy Care Fish Oil 1000mg Hỗ trợ sức khỏe não bộ, tim mạch, khớp, bổ mắt và tăng sức khỏe tổng thể - Massel Official - 400viên /hộp",474000,964000,490000,51
TIKI,lam-dep-suc-khoe,149346549,"Viên uống Biotin DHC Nhật Bản kích thích mọc tóc nhanh và dày, dưỡng da, móng khỏe mạnh JN-DHC-B30 (30 ngày)",125000,180000,55000,31
TIKI,lam-dep-suc-khoe,3415803,"Bông Tăm Kháng Khuẩn Jomi (160 Que)",32100,33000,900,3
TIKI,lam-dep-suc-khoe,119251217,"Sữa rửa mặt dịu lành cho da nhạy cảm Cetaphil Gentle Skin Cleanser 125ml",175000,175000,0,0
TIKI,lam-dep-suc-khoe,76212747,"Combo 2 Tinh Dầu Sả Chanh (Lemongrass) + Tinh Dầu Oải Hương (Lavender) Cao Cấp Nhập Khẩu - Tinh Dầu TIDAMO Nguyên Chất Xông Phòng Giúp Thư Giãn, Thơm Phòng và Nâng Cao Sức Khỏe (2 chai 10ML) - Thích Hợp Sử Dụng Với Máy Xông Tinh Dầu",78000,156000,78000,50
TIKI,lam-dep-suc-khoe,55768758,"Tinh chất The Ordinary Retinol 0.5% In Squalane - 30ml",339000,339000,0,0
TIKI,lam-dep-suc-khoe,74540152,"Tinh Dầu BẠC HÀ Cao Cấp 50ML - Tinh Dầu Bạc Hà Thiên Nhiên Nguyên Chất Nhập Khẩu Sử Dụng Với Máy Xông Tinh Dầu Giúp Bảo Vệ Sức Khỏe, Kháng Khuẩn, Thư Giãn Tinh Thần và Xua Đuổi Côn Trùng",78000,236000,158000,67
TIKI,lam-dep-suc-khoe,170425580,"Combo Hoàn Hảo - Sữa tắm gội hương nước hoa 350ml & Gel rửa mặt 60S Fresh 100ml & Dung dịch vệ sinh nam giới 100ml",650000,650000,0,0
TIKI,lam-dep-suc-khoe,54058499,"Dung Dịch Dưỡng Trắng Da Tối Ưu Hada Labo Perfect White Lotion 100ml",199000,199000,0,0
TIKI,lam-dep-suc-khoe,31637622,"Viên uống DHC Rau Củ Quả Tổng hợp Premium",425000,520000,95000,18
TIKI,lam-dep-suc-khoe,52107862,"Cân Sức Khỏe Xiaomi Thông Minh Mi Smart Scale 2 (NUN4056GL)- Trắng - Hàng chính hãng",320000,350000,30000,9
TIKI,lam-dep-suc-khoe,24312036,"Son Thỏi Siêu Mướt Mềm Mịn Môi Belips Thiên Nhiên Không Chì An Toàn Cho Cả Bà Bầu BST Mới "The Queen" 3,7g",249000,331000,82000,25
TIKI,lam-dep-suc-khoe,117786521,"Dụng cụ xét nghiệm nhanh COVID-19 Humasis chính hãng",35000,35000,0,0
TIKI,lam-dep-suc-khoe,160310283,"Găng Tay Tắm Funu Giúp Tẩy Tế Bào Chết, Làm Sạch Da - Giao Màu Ngẫu Nhiên",30000,33000,3000,9
TIKI,lam-dep-suc-khoe,76777344,"Tinh Dầu Xông Phòng TRẦM HƯƠNG TIDAMO 50ML - Tinh Dầu Trầm Hương Cao Cấp Từ Thiên Nhiên Giúp Bảo Vệ Sức Khỏe, Thư Giãn Và Tĩnh Lặng Tinh Thần - Kiểm Nghiệm Chất Lượng Tại Trung Tâm Quatest 3",98000,276000,178000,64
TIKI,lam-dep-suc-khoe,152097299,"Combo 4 gói bông tẩy trang Ipek 150 miếng ( 4 x 150 miếng)",111600,111600,0,0
TIKI,lam-dep-suc-khoe,16928041,"Đai Chống Gù Lưng miDoctor Cho Người Lớn, Trẻ Em - Hàng Chính Hãng",199000,199000,0,0
TIKI,lam-dep-suc-khoe,77105404,"[HỘP - FAMAPRO 5D MASK] - Khẩu trang y tế kháng khuẩn 3 lớp Famapro 5D Mask (10 cái/ hộp)",9900,18000,8100,45
TIKI,lam-dep-suc-khoe,173469753,"Combo 2 hộp JEX giảm đau, bảo vệ xương khớp 60 viên tặng 1 hộp 15 viên",1260000,1440000,180000,13
TIKI,lam-dep-suc-khoe,117927305,"Tăm nước cầm tay H2ofloss HF-6. Tăm nước 5 chế độ, 5 đầu tăm đa chức năng, túi vải đựng máy, pin sử dụng tối đa 21 ngày, tặng kèm củ sạc nguồn thấp",490000,950000,460000,48
TIKI,lam-dep-suc-khoe,11980971,"Serum Kích Thích Mọc Tóc Ngăn Rụng Tóc Phục Hồi Tóc Hư Tổn  Welhair 100ml",234000,293000,59000,20
TIKI,lam-dep-suc-khoe,927571,"Dung dịch rửa mũi tiện dụng Rohto NoseWash (Bình thay thế) 400ml",61900,75000,13100,17
TIKI,lam-dep-suc-khoe,12218834,"Kem Phục Hồi Da Làm Lành Da, Chống Nhiễm Khuẩn Cicalfate Cream 40ml Avene",266000,424000,158000,37
TIKI,lam-dep-suc-khoe,49904088,"Dầu Massage BIYOKEA Body Premium Relaxing B2 - Thư giãn 200ml",387000,387000,0,0
TIKI,lam-dep-suc-khoe,194040985,"Bộ 2 Nước súc miệng cho răng nhạy cảm Listerine Total Care Sensitive Soothing Taste 250ml/chai",164000,164000,0,0
TIKI,lam-dep-suc-khoe,73623601,"Sủi Da 2 Đầu Thép Không Gỉ KỀM NGHĨA S.516 Loại Nhỏ (1 đầu nhọn, 1 đầu bầu)",24840,27000,2160,8
TIKI,lam-dep-suc-khoe,70660612,"Combo máy khuếch tán, máy xông tinh dầu + bạch đàn chanh Lorganic (10ml) Thích hợp xông phòng 15-40m2/ NHIỀU MẪU",150000,300000,150000,50
TIKI,lam-dep-suc-khoe,65100091,"Phấn Nước Căng Bóng 24H Laneige Neo Cushion Glow 15g 23N",535000,630000,95000,15
TIKI,lam-dep-suc-khoe,31892171,"Tinh Chất Cấp Nước, Phục Hồi Da The Ordinary Hyaluronic Acid 2% + B5 30ml",245000,249000,4000,2
TIKI,lam-dep-suc-khoe,216472834,"Dung dịch vệ sinh nam giới Nerman Elegant Men Nerman hương nước hoa cao cấp 100ml/ chai",105000,105000,0,0
TIKI,lam-dep-suc-khoe,63165307,"Kem Hỗ Trợ Làm Mờ Sẹo Dermatix Ultra 15g",340000,370000,30000,8
TIKI,lam-dep-suc-khoe,197960229,"Perspirex for Men Maximum - Lăn khử mùi và ngăn tiết mồ hôi loại mạnh",290000,290000,0,0
TIKI,lam-dep-suc-khoe,117570362,"Viên sủi bổ sung Vitamin Berocca Performance Mango",98000,98000,0,0
TIKI,lam-dep-suc-khoe,2984029,"Nước Súc Miệng Listerine Zero (750ml) - 8850007813149",169000,169000,0,0
TIKI,lam-dep-suc-khoe,80994699,"Gel Chống Nắng Màng Nước Dưỡng Ẩm Bioré UV Aqua Rich Watery SPF50+/PA++++ 90ml",194000,249000,55000,22
TIKI,lam-dep-suc-khoe,76158697,"Combo 2 Chai xịt tinh dầu bưởi kích mọc tóc, giảm rụng tóc Pomelo Tabaha 120ml cho tóc dày và dài hơn gấp 2 đến 3 lần",150000,150000,0,0
TIKI,lam-dep-suc-khoe,184038082,"Combo ngăn ngừa mụn Mugung gồm Sữa rửa mặt và Serum Acne Treatment không bong da bí quyết sạch bay mụn thâm,mụn bọc,mụn trứng cá, dành cho mọi loại da 15ml và 15gram",400000,400000,0,0
TIKI,lam-dep-suc-khoe,186271109,"Bộ đai chườm nóng thảo dược giảm đau cổ gáy dùng điện - Hapaku",466000,489000,23000,5
TIKI,lam-dep-suc-khoe,23257530,"NƯỚC SÚC MIỆNG KIN GINGIVAL NGĂN NGỪA VIÊM NƯỚU 250ML",135000,135000,0,0
TIKI,lam-dep-suc-khoe,43248066,"Sữa dưỡng thể giữ ẩm hằng ngày cho da thường, da khô và da nhạy cảm Aveeno Daily Moisturizing 354ml",419000,419000,0,0
TIKI,lam-dep-suc-khoe,129947293,"Kem dưỡng trắng da mặt Yococi giúp sáng da, ngăn chặn ánh sáng xanh White Perfect Face Cream 20g",176000,320000,144000,45
TIKI,lam-dep-suc-khoe,50779213,"Vitamin tổng hợp One A Day Men’s 50+ Multivitamin Healthy Advantage 300 viên Hàng Nhập Mỹ",600000,620000,20000,3
TIKI,lam-dep-suc-khoe,72864994,"Máy Xông Tinh Dầu Có Loa Bluetooth Kết Nối Với Điện Thoại Nghe Nhạc Cực Hay, Máy Khuếch Tán Tinh Dầu Cho Phòng Lớn Thể Tích 1000ML, Có Remote Điều Khiển Từ Xa và Đèn LED Biến Đổi Màu Cực Đẹp",368000,788000,420000,53
TIKI,lam-dep-suc-khoe,7073667,"Sữa Dưỡng Thể Chống Nắng Hatomugi SPF31 PA+++ Nhật Bản, 250ml",129000,159390,30390,19
TIKI,lam-dep-suc-khoe,173854434,"Set 100cái khẩu trang y tế KF94 Kháng Khuẩn, Màu Trắng, Chống Bụi Mịn, Hàng Cao Cấp",82000,120000,38000,32
TIKI,lam-dep-suc-khoe,2469427,"Bao Cao Su Masculan Das Kondom Long Pleasure (10 Cái/ Hộp)",143000,143000,0,0
TIKI,lam-dep-suc-khoe,1831605,"Dung Dịch Vệ Sinh Nam Serenys - 100ml",129000,129000,0,0
TIKI,lam-dep-suc-khoe,3490039,"Tinh Chất Chống Lão Hóa Chứa Vitamin C Paula's Choice Resist C15 Super Booster (20ml)",1440000,1600000,160000,10
TIKI,lam-dep-suc-khoe,58601415,"Viên uống Vitamin tổng hợp cho Nữ - One A Day women Multivitamin 300 viên của Mỹ - mẫu mới",600000,600000,0,0
TIKI,lam-dep-suc-khoe,132286262,"Dầu gội bưởi Cocoon giúp giảm gãy rụng và làm mềm tóc 310ml",265000,265000,0,0
TIKI,lam-dep-suc-khoe,10734388,"Nước cân bằng giàu khoáng dành cho da dầu La Roche Posay Effaclar Astringent Lotion 200ml ",341000,455000,114000,25
TIKI,lam-dep-suc-khoe,13423145,"Kem Chống Nắng Dành Cho Da Bóng Dầu, Dễ Nổi Mụn La Roche-Posay Anthelios Anti-Imperfection 50ml",263000,585000,322000,55
TIKI,lam-dep-suc-khoe,75307295,"[HỘP - FAMAPRO MAX] - Khẩu trang y tế kháng khuẩn 4 lớp Famapro Max (40 cái/ hộp) - 1 HỘP",25900,25900,0,0
TIKI,lam-dep-suc-khoe,72341010,"Tinh chất se khít lỗ chân lông tối ưu Paula's Choice Clinical Niacinamide 20% Treatment 20ml mã 8030",1699000,1890000,191000,10
TIKI,lam-dep-suc-khoe,74212735,"Tinh dầu Quế Nguyên Chất 50ML. Tinh Dầu Vỏ Quế Cao Cấp Nhập Khẩu Ấn Độ. Tinh Dầu Xông Phòng Kháng Khuẩn, Phòng Tránh Cảm Cúm - Dùng Với Máy Xông Tinh dầu",114000,228000,114000,50
TIKI,lam-dep-suc-khoe,101552499,"Kem Chống Nắng Cell Fusion C Toning Sunscreen 100 SPF50+/ PA +++ Nâng Tông Sáng Hồng",600000,600000,0,0
TIKI,lam-dep-suc-khoe,69839188,"Dầu gội bưởi VIJULLY kích thích mọc tóc giảm gãy rụng tóc",280000,280000,0,0
TIKI,lam-dep-suc-khoe,72117492,"BÌNH RỬA MŨI WATER PULSE TẶNG KÈM 1 CHAI NƯỚC MUỐI SINH LÍ 500ML",144000,144000,0,0
TIKI,lam-dep-suc-khoe,92558840,"Lăn khử mùi dưỡng trắng hương nước hoa Refre Whitening Perfume In Love - Hương Tình Yêu 40ml",51400,62000,10600,17
TIKI,lam-dep-suc-khoe,167926077,"Đông trùng hạ thảo Kingdom Herb chính hãng loại thượng hạng sấy thăng hoa hộp",430000,869000,439000,51
TIKI,lam-dep-suc-khoe,68279712,"Combo 2 Lăn khử mùi Romano kháng khuẩn & khô thoáng cả ngày 50mlx2 Force",106000,136000,30000,22
TIKI,lam-dep-suc-khoe,59238608,"MÁY XÔNG TINH DẦU CHUYÊN DỤNG DUNG TÍCH 550ML, VÂN GỖ CAO CẤP, TÍCH HỢP ĐIỀU KHIỂN TỪ XA",229000,496000,267000,54
TIKI,lam-dep-suc-khoe,125759964,"Combo 3 Gói Tăm Bông Kháng khuẩn Diva que nhựa - 200 Que/Gói",50000,50000,0,0
TIKI,lam-dep-suc-khoe,470626,"Kem Dưỡng Làm Dịu Mát, Phục Hồi Da La Roche-Posay Cicaplast Baume B5 (40ml) - M3232900",287000,410000,123000,30
TIKI,lam-dep-suc-khoe,13566981,"Kem dưỡng da chống lão hóa Shiseido Benefiance Wrinkle Smoothing Cream 50ml",1850000,1850000,0,0
TIKI,lam-dep-suc-khoe,166417513,"Khẩu Trang Y tế  KF94 PT Mask Kháng khuẩn, Chống Bụi. Đạt Các Chứng Chỉ ISO 13485, ISO 9001, CE, FDA, TGA",9900,9900,0,0
TIKI,lam-dep-suc-khoe,58220974,"Kem Dưỡng Thể 2% BHA Paula’s Choice Resist Weightless Body Treatment With 2% BHA  - M",855000,950000,95000,10
TIKI,lam-dep-suc-khoe,174829842,"Kem Dưỡng Ẩm Làm Dịu Cho Da Khô, Ngứa, Mẫn Đỏ Latopic Face And Body Cream 75ml",312000,379000,67000,18
TIKI,lam-dep-suc-khoe,50699279,"Nước tẩy trang Công Nghệ Micella Bioderma Sensibio H2O",353000,415000,62000,15
TIKI,lam-dep-suc-khoe,3490333,"Tinh chất chống nám và nếp nhăn độc đáo Paula's Choice Clinical 1% Retinol Treatment 30ml",1699000,1950000,251000,13
TIKI,lam-dep-suc-khoe,63511644,"Cân điện tử bluetooth phân tích chỉ số cơ thể Kachi MK223 - Màu đen - Hàng chính hãng",230000,399000,169000,42
TIKI,lam-dep-suc-khoe,556237,"Nước Súc Miệng Trà Xanh Listerine Natural Green Tea (750ml)",187000,187000,0,0
TIKI,lam-dep-suc-khoe,50884640,"Kem Dưỡng Reihaku Hatomugi Cải Thiện Làn Da khô, thâm, mụn 300g",105000,163800,58800,36
TIKI,lam-dep-suc-khoe,16443914,"Son Dưỡng Môi Gạo Hương Cam Có Màu Phớt Cam Nhẹ Dưỡng Môi Hết Khô Nẻ An Toàn Từ Thiên Nhiên Cỏ Mềm 3.8g",79000,90000,11000,12
TIKI,lam-dep-suc-khoe,101018297,"Miếng Dán Lột Mụn Đầu Đen Vùng Mũi Cằm Trán Từ Tro Núi Lửa Đảo JeJu Dewytree Black Head Out Nose Patch (1 Miếng)",9000,15000,6000,40
TIKI,lam-dep-suc-khoe,25917934,"Gel Xử Lý Mụn Hiruscar Anti-Acne Spot Gel + 10G",139000,139000,0,0
TIKI,lam-dep-suc-khoe,72790654,"Lăn khử mùi nam Degree Men Motionsense Ultra Clear Black White 76g",89000,89000,0,0
TIKI,lam-dep-suc-khoe,72759100,"Bao cao su Ôm sát Siêu mỏng Powermen Kéo dài thời gian quan hệ cho Nam ( Size 49mm)",120000,120000,0,0
TIKI,lam-dep-suc-khoe,5780691,"Son dưỡng có màu chiết xuất trái cây Lipice Sheer Color Fruit Juice Strawberry",83900,103000,19100,19
TIKI,lam-dep-suc-khoe,25917935,"Gel Chăm Sóc Sẹo Mụn Và Mụn Thâm Hiruscar Post Acne 5G",190000,190000,0,0
TIKI,lam-dep-suc-khoe,94613156,"ĐỆM MASSGE HỒNG NGOẠI TOÀN THÂN CAO CẤP HAKAWA HK-M11 - HÀNG CHÍNH HÃNG",2500000,2800000,300000,11
TIKI,lam-dep-suc-khoe,173472760,"Combo 2 hộp ANGELA GOLD tăng cường sinh lý nữ 60 viên tặng 1 hộp 15 viên",1440000,1630000,190000,12
TIKI,lam-dep-suc-khoe,253396800," KHẨU TRANG Y TẾ WAKAMONO - COMBO 5 hộp - (4 Lớp, 50 cái)",225000,225000,0,0
TIKI,lam-dep-suc-khoe,248790766,"Vitamina Tổng hợp Kirkland Daily Multi Vitamins - Mỹ - QuaTangMe Extaste",681000,1384000,703000,51
TIKI,lam-dep-suc-khoe,37545731,"Bột Khử Mùi Wings-Up Khử Mùi Hôi Chân Hôi Nách Ngăn Tiết Mồ Hôi Hôi Khử Mùi Giày Không Mùi An Toàn Từ Thiên Nhiên Cỏ Mềm 25g",106000,115000,9000,8
TIKI,lam-dep-suc-khoe,7221953,"Sữa Rửa Mặt Cân Bằng Độ Ẩm Và Giảm Dầu Skin Balancing Oil Reducing Cleanser 237ml",629000,699000,70000,10
TIKI,lam-dep-suc-khoe,173600339,"Dung dịch xịt họng PlasmaKare H - Spray 30ml, cho trẻ từ 06 tháng, an toàn cho phụ nữ có thai không kháng sinh",150000,150000,0,0
TIKI,lam-dep-suc-khoe,54682884,"Dầu gội đầu Head&Shoulders Clinical Strength Shampoo",248000,248000,0,0
TIKI,lam-dep-suc-khoe,10638708,"Sữa rửa mặt dưỡng trắng dạng kem Acnes Whitening+ Cleanser 100g",56600,70000,13400,19
TIKI,lam-dep-suc-khoe,73631483,"Cân sức khỏe điện tử LAICA PS1036 - Mức cân tối đa 150 Kg - Mặt kính dày 8mm",375000,650000,275000,42
TIKI,lam-dep-suc-khoe,88992738,"Combo Mật ong  rừng Phương Nam 100% mật ong chín Honimore 990g",190000,282000,92000,33
TIKI,lam-dep-suc-khoe,252063162,"Bổ não Úc Healthy Care Ginkgo Biloba 2000, Giúp tăng tuần hoàn máu não, Cải thiện chức năng nhận thức, Trí nhớ, Giúp an thần và Giảm Stress (100 V/Hộp) - QuaTangMe Extaste",262000,532000,270000,51
TIKI,lam-dep-suc-khoe,20534750,"Khẩu trang trẻ em Gấu trúc StayDry",39000,39000,0,0
TIKI,lam-dep-suc-khoe,7615194,"Sữa tắm cá ngựa Algemarin Perfume Shower Gel  300ml",89000,89000,0,0
TIKI,lam-dep-suc-khoe,1687623,"Kem chống muỗi Rohto Metholatum Remos Hương Lavender 70g",25900,27000,1100,4
TIKI,lam-dep-suc-khoe,270808576,"Bổ não Úc Healthy Care Ginkgo Biloba 2000, Giúp tăng tuần hoàn máu não, Cải thiện chức năng nhận thức, Trí nhớ, Giúp an thần và Giảm Stress - QuaTangMe Extaste",262000,532000,270000,51
TIKI,lam-dep-suc-khoe,568277,"Lăn Nách Dành Cho Nam Aquaselin Extreme For Men Antiperspirant For Excessive Perspiration 50ml - 3936",285000,362500,77500,21
TIKI,lam-dep-suc-khoe,208303315,"Combo máy khuếch tán/ máy xông tinh dầu bình hoa + tinh dầu sả chanh + tinh dầu cam Lorganic (10ml x2 chai)",275000,550000,275000,50
TIKI,lam-dep-suc-khoe,117170051,"Combo 2 Sữa rửa mặt Simple giúp kiềm dầu và ngừa mụn hiệu quả - cho da mụn nhạy cảm 150ml [CHÍNH HÃNG ĐỘC QUYỀN] [DIỆN MẠO MỚI]",193000,264000,71000,27
TIKI,lam-dep-suc-khoe,55891956,"Bigsize - Kem dưỡng trắng da toàn thân Truesky Whitening Body Lotion chiết bơ Shea 200g",145000,250000,105000,42
TIKI,lam-dep-suc-khoe,48085908,"Phấn Nước M.O.I 5M BABY SKIN CUSHION Hồ Ngọc Hà (Chính Hãng)",379050,399000,19950,5
TIKI,lam-dep-suc-khoe,43108211,"Hấp ủ phục hồi cấp tốc LUJO KERATIN MASK & COLLAGEN cho mái tóc",180000,180000,0,0
TIKI,lam-dep-suc-khoe,42559192,"Eucerin Pro ACNE Solution Cleansing Gel: Gel Rửa Mặt Da Mụn (400 ml)",355000,355000,0,0
TIKI,lam-dep-suc-khoe,88967146,"Bao Cao Su Gai Kéo Dài Thời Gian Của Nhật Bản Sagami Xtreme Feel Long (Hộp 10 Chiếc) Không Mùi Cao Su  - Tặng 1 Chiếc BCS Power Men - Che Tên Sản Phẩm",75000,75000,0,0
TIKI,lam-dep-suc-khoe,193742017,"Băng vệ sinh AO2 siêu mỏng nhẹ mặt lưới có cánh - Dùng cho ngày (23cm), đêm (28cm) 7 miếng/gói",11000,12500,1500,12
TIKI,lam-dep-suc-khoe,24924199,"Son kem lì Bbia Last Velvet Lip Tint Version 1 5g (5 màu)",140000,290000,150000,52
TIKI,lam-dep-suc-khoe,117175571,"Máy Massage Lưng Cao Cấp KINGTECH KB-920  - Mát xa Thắt Lưng, Eo, Cột Sống - Hỗ Trợ Điều Trị Thoát Vị Đĩa Đệm, Thoái Hóa, Đau Đốt Sống, Vai Gáy - Tích Hợp Tính Năng Nhiệt Hồng Ngoại 45 - 65 độ - Hàng Chính Hãng",1858000,3350000,1492000,45
TIKI,lam-dep-suc-khoe,25738219,"Floslek Sữa Rửa Mặt Dạng Gel Cho Da Nhờn Mụn Anti Acne Bacterial Face Cleansing Gel 200ml",265000,396000,131000,33
TIKI,lam-dep-suc-khoe,67810097,"Bộ Máy Đo Đường Huyết Acon On Call Plus + Tặng hộp 25 que thử",595000,850000,255000,30
TIKI,lam-dep-suc-khoe,75842514,"Viên Hà Thủ Ô Mật Ong Rừng Phúc Khang 300g (7 trong 1) - Làm đen tóc, giảm rụng tóc, kích thích mọc tóc; giúp ăn ngon, ngủ ngon; hũ thủy tinh cao cấp, dạng viên tiện lợi, vị ngọt dễ uống",180500,190000,9500,5
TIKI,lam-dep-suc-khoe,21408570,"Kem Dưỡng Giảm Thâm Quầng Mắt Himalaya 15ml",139000,139000,0,0
TIKI,lam-dep-suc-khoe,58668263,"Combo 2 Sữa tắm hương nước hoa Enchanteur Delightful 650gr/ Chai",304000,392000,88000,22
TIKI,lam-dep-suc-khoe,20701571,"Tinh dầu dưỡng tóc AURANE Softliss Fantastic Repair hair oil 125ml",124000,130000,6000,5
TIKI,lam-dep-suc-khoe,108535201,"Bao cao su Sagami White box - Có gai - Hộp 10 chiếc",95000,120000,25000,21
TIKI,lam-dep-suc-khoe,59085169,"Bình (Bộ Dụng Cụ) Rửa Mũi Xoang Người Lớn NeilMed SinusRinse Adult Kit -Xuất Xứ Mỹ(1 bình + 10 gói)",327000,327000,0,0
TIKI,lam-dep-suc-khoe,170066572,"Combo 3 Hộp Khẩu trang Bông Bạch Tuyết than hoạt tính (50 cái/hộp)",234000,234000,0,0
TIKI,lam-dep-suc-khoe,126795077,"Viên uống JEX giảm đau, bảo vệ xương khớp với Eggshell Membrane, Collagen Peptide, Collagen Type II không biến tính (60 viên)",630000,630000,0,0
TIKI,lam-dep-suc-khoe,76564284,"Xịt Họng Keo Ong 3T 25ml Giảm Đau Họng, Ho Khan, Ngứa Rát Họng",57230,59000,1770,3
TIKI,lam-dep-suc-khoe,29496992,"FLOSLEK PHARMA GEL RỬA MẶT DIỆT KHUẨN NGỪA MỤN ANTIBACTERIAL FACE CLEANSING GEL 200ML",277000,396000,119000,30
TIKI,lam-dep-suc-khoe,190290564,"Khẩu trang y tế VN95 an tâm, Lẻ 10 cái. sỉ thùng 500 cái, kháng khuẩn chống virus Corona chủng BA5, chuyên dụng cho bệnh viện",7000,7000,0,0
TIKI,lam-dep-suc-khoe,176048170,"Thực phẩm bảo vệ sức khỏe Thảo mộc cải thiện cân nặng Slimming Care X3 ( số 2) hộp 15 viên - dành cho người béo lâu năm, cơ địa chai lì",450000,550000,100000,18
TIKI,lam-dep-suc-khoe,11118835,"Combo 2 lon Thực Phẩm chức năng Tinh bột nghệ đỏ An Bình",590000,590000,0,0
TIKI,lam-dep-suc-khoe,8057340,"Xà Phòng Giảm Mụn Lưng For Back 135g Nội Địa Nhật Bản",93900,98280,4380,4
TIKI,lam-dep-suc-khoe,270548759,"Omega 3 Úc Healthy Care Fish Oil giúp bổ mắt, kháng viêm, tốt cho trí não, tim mạch - QuaTangMe Extaste",474000,964000,490000,51
TIKI,lam-dep-suc-khoe,91565658,"Combo 6 Băng Vệ Sinh Quần Peppy Shana Siêu Thấm Free Size (12 miếng)",79000,85000,6000,7
TIKI,lam-dep-suc-khoe,132081941,"Mặt Nạ Ngủ Dưỡng Ẩm Laneige Water Sleeping Mask EX",281000,310000,29000,9
TIKI,lam-dep-suc-khoe,46643670,"Cho máy Oral-B Braun,  Bộ 4 đầu bàn chải đánh răng điện - Trẻ em, cho mọi loại máy - EB10A",88000,88000,0,0
TIKI,lam-dep-suc-khoe,385469,"Bao cao su Durex Fetherlite Ultima Hộp 3 bao",62000,76000,14000,18
TIKI,lam-dep-suc-khoe,188785183,"Saffron mật ong đông trùng hạ thảo Kingdom Herb chính hãng thượng hạng hộp 312g (tặng bình thuỷ tinh và cây lấy mật)",400000,789000,389000,49
TIKI,lam-dep-suc-khoe,118090021,"Bộ 2 Hộp Viên Sủi Bổ Sung Vitamin Berocca Performance Mango 10 Viên/Hộp",196000,196000,0,0
TIKI,lam-dep-suc-khoe,74192960,"Máy Massage Cổ Vai Gáy Chuyên Sâu 3D KINGTECH KS460 - Hỗ Trợ Mát xa Đùi, Chân, Lưng Dưới - Tích Hợp Nhiệt Hồng Ngoại - Tiện Sử Dụng Tại Nhà, Văn Phòng, Du Lịch - Quà Tặng Tuyệt Vời Dành Cho Người Thân - Chính Hãng",1115000,1750000,635000,36
TIKI,lam-dep-suc-khoe,176296819,"Nước Cân Bằng Giảm Mụn Và Thông Thoáng Lỗ Chân Lông SVR Sebiaclear Micro - Peel 150ml",292000,390000,98000,25
TIKI,lam-dep-suc-khoe,190641506,"Sữa Rửa Mặt Dịu Nhẹ Cho Da Dầu CeraVe Foaming Cleanser 473ml",355000,455000,100000,22
TIKI,lam-dep-suc-khoe,11874956,"Viên Uống Cân Bằng Nội Tiết Tố, Cải Thiện Sinh Lý Nữ Marilyn (Hộp 30 viên)",186000,198000,12000,6
TIKI,lam-dep-suc-khoe,8011746,"Tinh Chất Hàu Biển OYSTER MAN Tăng Cường Sinh Lý Nam, Cải Thiện Xuất Tinh Sớm, Yếu Sinh Lý (Hộp 30 Viên)",120000,120000,0,0
TIKI,lam-dep-suc-khoe,186272570,"Đôi Giày Chườm Nóng Thảo Dược Giảm Đau Bàn Chân Dùng Điện Phiên Bản Vỏ Đai Bằng Vải Da Lộn - Hapaku",969000,995000,26000,3
TIKI,lam-dep-suc-khoe,631026,"Dung dịch dưỡng ẩm tối ưu Hada Labo Advanced Nourish Lotion dùng cho da thường và da khô 170ml",175000,208000,33000,16
TIKI,lam-dep-suc-khoe,144208515,"Dầu gội khô Girlz Only Dry Shampoo 200ml",89000,89000,0,0
TIKI,lam-dep-suc-khoe,180303300,"Dầu chăm sóc da giúp cải thiện rạn da, mờ sẹo và đều màu da - BIO-OIL SKINCARE OIL (chai 200ml)",435000,460000,25000,5
TIKI,lam-dep-suc-khoe,190119292,"Bấm Móng Tay Thép Carbon Chuyên Dụng KỀM NGHĨA B.939 - Lưỡi Cong (Loại Lớn)",26680,29000,2320,8
TIKI,lam-dep-suc-khoe,118089805,"Kem Chống Hăm Bepanthen Balm Dạng Kem Mỡ 30G/Tuýp",71000,71000,0,0
TIKI,lam-dep-suc-khoe,34315213,"Dao Cạo Râu 2 Lưỡi Dorco TG 710YL-5P (05 Dao Cạo)",28000,28000,0,0
TIKI,lam-dep-suc-khoe,181133300,"Sữa Tắm Gội Coast Classic Scent Vòi Dành Cho Nam 946ml - USA",133000,133000,0,0
TIKI,lam-dep-suc-khoe,11625471,"Titan Gel Nga - Gel bôi trơn  tăng kích thước 50ml - hàng chuẩn Nga",230000,230000,0,0
TIKI,lam-dep-suc-khoe,126959538,"Serum hôi nách INOD Huyền Phi 5ml tác dụng triệt hôi nách, hôi chân , mồ hôi tay chân vĩnh viên",161400,161400,0,0
TIKI,lam-dep-suc-khoe,10639651,"Thực Phẩm Chức Năng Heposal - Phục hồi tổn thương viêm gan xơ gan",360000,360000,0,0
TIKI,lam-dep-suc-khoe,76210034,"Combo 2 Tinh Dầu Sả Chanh 50ML (Lemongrass) + Tinh Dầu Oải Hương 50ML (Lavender) - Tinh Dầu TIDAMO Nguyên Chất Xông Phòng Giúp Thư Giãn, Thơm Phòng và Nâng Cao Sức Khỏe - Rất Tốt Khi Sử Dụng Với Máy Xông Tinh Dầu",184000,336000,152000,45
TIKI,lam-dep-suc-khoe,108801868,"ĐÁNH BAY MỤN CÓC SINH DỤC SÙI MÀO GÀ BẰNG KEM BÔI LARIFAN UNGO 0.05% TỪ CHÂU ÂU",544500,544500,0,0
TIKI,lam-dep-suc-khoe,166369511,"Sữa tắm gội cho nam Romano 2 trong 1 Gentleman 650g",154000,191000,37000,19
TIKI,lam-dep-suc-khoe,57762842,"KEM TẨY LÔNG PERFECT CLEAN HUYỀN PHI TẶNG KÈM BÔNG RỬA MẶT",169000,169000,0,0
TIKI,lam-dep-suc-khoe,2775397,"Bao Cao Su Có Gai Nhật Bản Sagami Extreme White (10 Cái / Hộp)",69000,69000,0,0
TIKI,lam-dep-suc-khoe,273217865,"Combo Máy khuếch tán/ máy xông tinh dầu Bí Ngô Lorganic FX2027 + tinh dầu sả chanh + tinh dầu cam Lorganic (10ml x2)",285000,400000,115000,29
TIKI,lam-dep-suc-khoe,126945380,"Dung Dịch Vệ Sinh Chuyên Biệt Cho Nam Giới Oriss 100g",170000,170000,0,0
TIKI,lam-dep-suc-khoe,108535228,"Gel bôi trơn Sagami - Cao cấp - Gốc nước - Tuýp 60g",195000,215000,20000,9
TIKI,lam-dep-suc-khoe,74607743,"Tinh Dầu BẠC HÀ Nguyên Chất Nhập Khẩu 100ML - Tinh Dầu Xông Phòng Bạc Hà (Peppermint) Giúp Bảo Vệ Sức Khỏe, Kháng Khuẩn, Thư Giãn Tinh Thần và Xua Đuổi Côn Trùng. Thích Hợp Sử Dụng Với Máy Xông Tinh Dầu",148000,356000,208000,58
TIKI,lam-dep-suc-khoe,2775387,"Bao Cao Su Sagami Xtreme Super Thin (10 Cái / Hộp)",95000,95000,0,0
TIKI,lam-dep-suc-khoe,132047096,"Dầu Gội Phủ Bạc Laco Black Hair 200ml giúp tóc đen tự tin sau 9 phút",245000,350000,105000,30
TIKI,lam-dep-suc-khoe,49294599,"Viên uống chống nắng UV Fine Japan Nhật Bản, chống nắng toàn diện, giảm thâm nám, 30 viên/túi",229000,245700,16700,7
TIKI,lam-dep-suc-khoe,33768251,"Máy SPO2 OXY200 chính hãng Microlife Thụy Sĩ dùng để đo nhịp tim và nồng độ oxy trong máu",575000,750000,175000,23
TIKI,lam-dep-suc-khoe,68281314,"Combo 2 Lăn khử mùi Romano kháng khuẩn & khô thoáng cả ngày 50mlx2 Attitude",104000,136000,32000,24
TIKI,lam-dep-suc-khoe,76103131,"Siro Zhealth - Hỗ trợ tăng cường sức đề kháng, Hệ miễn dịch, Bổ phế, Giảm ho tức thì, Cải thiện sức khỏe đường hô hấp cho trẻ nhỏ, người già(10ml)",159000,179000,20000,11
TIKI,lam-dep-suc-khoe,112074140,"Nhiệt Kế Hồng Ngoại Đo Trán Chính Hãng Sinocare",188000,299000,111000,37
TIKI,lam-dep-suc-khoe,88952138,"Tinh Dầu Sả Chanh Krishna nguyên chất nhập khẩu 10 ml - Tinh Dầu Thiên Nhiên Nguyên Chất, Tinh Dầu Xông Phòng, Giúp Giảm Stress, Xua Đuổi Côn Trùng Và Khử Mùi Hiệu Quả, Thích Hợp Dùng Với Đèn Xông Và Máy Khuếch Tán Tinh Dầu",58000,58000,0,0
TIKI,lam-dep-suc-khoe,273009719,"Hỗ trợ giảm đau nhức xương khớp Schiff Move Free Mỹ nâng cao sức khỏe khớp, sụn và xương, tăng khả năng vận động linh hoạt thoải mái-QuaTangMe Extaste",831000,1662000,831000,50
TIKI,lam-dep-suc-khoe,65100105,"Phấn Nước Mịn Lì 24H Laneige Neo Cushion Matte 15g*2 23N",899000,1050000,151000,14
TIKI,lam-dep-suc-khoe,59168970,"Gói Hỗn Hợp Muối Rửa Mũi Xoang Người Lớn NeilMed SinusRinse Adult Sachets - Xuất xứ Mỹ (Hộp 120 gói)",662000,662000,0,0
TIKI,lam-dep-suc-khoe,73925328,"COMBO TOÀN DIỆN CHO DA MỤN DECUMAR ADVANCED",295000,295000,0,0
TIKI,lam-dep-suc-khoe,270548709,"Omega 3 Úc Healthy Care Fish Oil Hỗ trợ sức khỏe não bộ, Tim mạch, Khớp, Bổ mắt, Làm đẹp da, Và tăng sức khỏe tổng thể - QuaTangMe Extaste",482000,964000,482000,50
TIKI,lam-dep-suc-khoe,208311637,"Combo máy khuếch tán/ máy xông tinh dầu núi lửa + tinh dầu sả chanh + tinh dầu cam Lorganic (10ml x 2 chai)",295000,500000,205000,41
TIKI,lam-dep-suc-khoe,6761497,"Bộ 4 Bàn Chải Đánh Răng Trisa Fresh",155000,170000,15000,9
TIKI,lam-dep-suc-khoe,185941089,"[Size du lịch] Sữa tắm dưỡng thể Nano Collagen Sắc Ngọc Khang giúp da sạch-căng mịn-trắng sáng (Chai 30ml)",24000,39000,15000,38
TIKI,lam-dep-suc-khoe,71999833,"Sữa rửa mặt dạng Gel Decumar Clean Advanced 100gr hoàn toàn mới kiểm soát nhờn mụn",105000,105000,0,0
TIKI,lam-dep-suc-khoe,108535235,"Bao cao su Sagami 001 - Siêu mỏng - Non Latex - Hộp 5 chiếc",425000,720000,295000,41
TIKI,lam-dep-suc-khoe,107254729,"Viên uống bổ sung Glucosamine ORIHIRO Nhật Bản giảm đau xương khớp 900 viên - 950 viên",365000,600000,235000,39
TIKI,lam-dep-suc-khoe,51288234,"Serum giảm mụn 24h Anti-Acnes 20ml",298000,298000,0,0
TIKI,lam-dep-suc-khoe,96826251,"Băng vệ sinh hàng ngày Laurier Nhật Bản 72 miếng",79000,79000,0,0
TIKI,lam-dep-suc-khoe,42260194,"Dầu Dừa Lên Men Tách Lạnh Tinh Khiết VietHealthy 1000ml",389000,389000,0,0
TIKI,lam-dep-suc-khoe,105632400,"Bộ 3 Bao Cao Su Durex Jeans - Hộp 3 chiếc",106000,147000,41000,28
TIKI,lam-dep-suc-khoe,49217739,"Kem dánh răng crest 3D white 158g",124000,124000,0,0
TIKI,lam-dep-suc-khoe,59236451,"Viên xương khớp Blackmores glucosamine 1500mg chính hãng Úc 180 viên - dùng 6 tháng mẫu mới",635000,793750,158750,20
TIKI,lam-dep-suc-khoe,2728621,"Dầu dừa ép lạnh tinh khiết Coco-Secret hũ 500 ml",145000,145000,0,0
TIKI,lam-dep-suc-khoe,54643914,"Combo 2 Lăn khử mùi Romano Classic kháng khuẩn & khô thoáng cả ngày 50ml*2",104000,136000,32000,24
TIKI,lam-dep-suc-khoe,25107897,"Sữa rửa mặt tạo bọt ngăn ngừa mụn Acnes Foaming Wash 150ml",63000,79000,16000,20
TIKI,lam-dep-suc-khoe,15654981,"Cây Lấy Khóe Đầu Cong Inox Hỗ Trợ Móc Khóe và Vệ Sinh Khóe KỀM NGHĨA",6440,7000,560,8
TIKI,lam-dep-suc-khoe,104323277,"Tinh Dầu Sả Chanh Treo Xe TOKI MORI Xuất Khẩu Nhật Bản (10ml) 100% Thiên Nhiên, An Toàn Cho Trẻ, Xông Phòng, Khử Mùi, Thơm Xe, Chống Ói, Kháng Khuẩn",58000,99000,41000,41
TIKI,lam-dep-suc-khoe,79411386,"Kem chống nắng nâng tông Skin Aqua Tone up Rose cho da trắng, khuyết điểm xanh hoặc tái xanh, dạng tinh chất Sunplay Skin Aqua Tone Up UV Essence Happiness Aura (Rose) SPF 50+ PA++++ 50g",161000,199000,38000,19
TIKI,lam-dep-suc-khoe,37974580,"Viên uống Trắng da DHC Adlay Extract Nhật Bản - 60 Ngày (60 viên)",415000,500000,85000,17
TIKI,lam-dep-suc-khoe,140107223,"Sữa dưỡng thể Vaseline Healthy White UV Lightening Body Lotion 725ml",165000,165000,0,0
TIKI,lam-dep-suc-khoe,96199726,"NAKIZ LIVELY BUTT kem ngừa mụn, mờ thâm Mông bẹn nách Thái Lan 100g",299000,299000,0,0
TIKI,lam-dep-suc-khoe,137847856," Nước Hoa Nam Dạng Sáp Khô Cao Cấp Meidian Hương Thơm Cuốn Hút,Nam Tính(Combo 3 mùi)",64000,125000,61000,49
TIKI,lam-dep-suc-khoe,40935834,"Dầu gội Sunsilk Óng Mượt Rạng Ngời 1.4kg dành cho tóc khô xơ với tinh chất Bồ Kết truyền thống",205000,205000,0,0
TIKI,lam-dep-suc-khoe,140440052,"Máy Massage Chân VISPO VP-C21G - Máy Massage Lòng Bàn Chân, Mu Bàn Chân Công Nghê Hiện Đại, Xoa Bóp, Trườm Ấm Thư Giãn, giải tỏa Căng Thằng Mệt Mỏi",1699000,2980000,1281000,43
TIKI,lam-dep-suc-khoe,89139805,"[TÚI - FAMAPRO 4D] - Khẩu trang y tế kháng khuẩn cao cấp Famapro 4D tiêu chuẩn KF94 (5 cái/ túi)",6000,12000,6000,50
TIKI,lam-dep-suc-khoe,58053818,"Bấm Móng Tay Chân Thép Không Gỉ KỀM NGHĨA B.904 - Lưỡi Cong (Loại Nhỏ)",36800,40000,3200,8
TIKI,lam-dep-suc-khoe,36678762,"Combo 6 gói Băng vệ sinh Diana Siêu thấm siêu mỏng cánh 8 miếng",121000,132000,11000,8
TIKI,lam-dep-suc-khoe,1313893,"Xịt khử mùi chiết xuất thiên nhiên Refre Natural Rosemary Hương Thảo (30ml)",53900,65000,11100,17
TIKI,lam-dep-suc-khoe,136816203,"Saffron ngâm mật ong Kingdom Herb chính hãng thượng hạng hộp 311g",308000,599000,291000,49
TIKI,lam-dep-suc-khoe,271473344,"Viên uống bổ não Healthy Care Ginkgo Biloba 100 viên",309000,309000,0,0
TIKI,lam-dep-suc-khoe,212317103,"Vitamin E Mỹ Kirkland Signature E 180mg  – Chống Oxy hóa mạnh, làm chậm quá trình lão, đẹp da, tóc và tốt cho tim mạch - Massel Official - 500 Viên",491000,1000000,509000,51
TIKI,lam-dep-suc-khoe,77722505,"Cân điện tử thông minh Laica PS7011 - Cân đo 6 chỉ số - Mức cân tối đa 180 kg",750000,750000,0,0
TIKI,lam-dep-suc-khoe,106503541,"Máy mát xa cổ vai gáy trị liệu cao cấp - Máy matxa cổ",136000,139000,3000,2
TIKI,lam-dep-suc-khoe,75621730,"Viên Uống Hỗ Trợ Co Thắt Búi Trĩ Trimax Hủ 30 Viên Nguyên Liệu Từ Thiên Nhiên",170000,180000,10000,6
TIKI,lam-dep-suc-khoe,2616909,"Nước Tẩy Trang Làm Sạch Sâu & Kiểm Soát Bã Nhờn Cho Da Dầu Nhạy Cảm La Roche-Posay Micellar Water Ultra Oily Skin 400ml",355000,495000,140000,28
TIKI,lam-dep-suc-khoe,32237380,"Kem dưỡng ban đêm Sắc Ngọc Khang dưỡng sáng và mờ thâm nám 30g",268000,270000,2000,1
TIKI,lam-dep-suc-khoe,1628055,"Lăn Khử Mùi Giúp Khô Thoáng Vùng Da Dưới Cánh Tay 72h Vichy Detransprirant Intensif 72h Transpiration Excessive (50ml)",240000,320000,80000,25
TIKI,lam-dep-suc-khoe,3490281,"Nước Hoa Hồng Cân Bằng Và Điều Chỉnh Lỗ Chân Lông Paula's Choice Skin Balancing Pore Reducing Toner (190ml)",655000,729000,74000,10
TIKI,lam-dep-suc-khoe,46644605,"Cho máy Braun Oral-B, Bộ 4 đầu bàn chải đánh răng điện - Đánh bật cao răng- EB-25A-Cho răng sáng bóng",165000,165000,0,0
TIKI,lam-dep-suc-khoe,158788377,"COMBO 5 GÓI 400 CÂY Tăm chỉ nha khoa ENVIRONTMENT  - Chỉ Đức công nghệ Nhật ENVIRONTMENT",150000,175000,25000,14
TIKI,lam-dep-suc-khoe,270886117,"Vitamin E Mỹ Kirkland Signature E 180mg (400 IU) – Giúp đẹp da, tóc, làm chậm quá trình lão hóa và tăng sức khỏe tổng thể - QuaTangMe Extaste",491000,1000000,509000,51
TIKI,lam-dep-suc-khoe,51696125,"Combo 2 Xịt toàn thân Romano Force tươi mát năng động 150ml",159000,206000,47000,23
TIKI,lam-dep-suc-khoe,59052059,"Viên uống tăng cường nội tiết tố nữ Marilyn Plus 30 viên",215000,229000,14000,6
TIKI,lam-dep-suc-khoe,58451261,"Gói Bột Uống Giảm Nhanh Ợ Nóng Ợ Chua Trào Ngược Dạ Dày Fobe-AD (Hộp 20 gói).",156000,206000,50000,24
TIKI,lam-dep-suc-khoe,148895418,"Khẩu trang chống nắng Anti UV Soteria Ebony đạt chuẩn UPF 50+, chống khuẩn chống bụi siêu mịn 0.1 micro - Size S,M,L",171990,171990,0,0
TIKI,lam-dep-suc-khoe,152709665,"Máy Tăm Nước Cầm Tay - Tăm Nước Vệ Sinh Răng Miệng Oral Irrigator - Bản Quốc Tế Chuẩn Châu Âu",165000,165000,0,0
TIKI,lam-dep-suc-khoe,67909702,"[Combo G] Dung Dịch Ngâm Kính Áp Tròng + Nước Nhỏ Mắt Áp Tròng",150000,150000,0,0
TIKI,lam-dep-suc-khoe,41352350,"Mặt nạ giấy Maycreate HA Mask (hộp 20 miếng)",85000,87000,2000,2
TIKI,lam-dep-suc-khoe,11254937,"Kem dưỡng trắng da ban đêm White Lucent Overnight Cream & Mask 75mL",2300000,2300000,0,0
TIKI,lam-dep-suc-khoe,97435337,"Cho máy Oral B Braun Cross Action EB-50A, Set Bộ 4 đầu bàn chải đánh răng điện đánh tan mảng bám",165000,165000,0,0
TIKI,lam-dep-suc-khoe,10795648,"Serum Chống Nắng Dưỡng Thể Kháng Bụi - Trắng Sáng Mịn Màng Biore (150ml)",216000,216000,0,0
TIKI,lam-dep-suc-khoe,272284946,"Vitamin E Mỹ Kirkland Signature giúp đẹp da, tóc, làm chậm quá trình lão hóa, chậm nhăn da, tốt cho tim mạch, hỗ trợ sức khỏe sinh sản- OZ Slim Store",465000,1000000,535000,54
TIKI,lam-dep-suc-khoe,174854281,"Combo 20 Gói khẩu trang Bông Bạch Tuyết KF94 Trắng (10 cái/gói)",400000,400000,0,0
TIKI,lam-dep-suc-khoe,112106515,"Máy tăm nước cầm tay FAIRYWILL FW-5020E máy tăm nước chính hãng Mỹ vệ sinh răng miệng cao cấp Thiết kế nhỏ gọn Sạc bằng USB Dễ mang đi du lịch Hàng Chính Hãng",663000,677000,14000,2
TIKI,lam-dep-suc-khoe,59289658,"Miếng Dán Say Tàu Xe Say Sóng Say Tàu Máy Bay ( Hộp 10 miếng )",69000,102000,33000,32
TIKI,lam-dep-suc-khoe,35019646,"COMBO 10 MẶT NẠ 3W CLINIC 5 LOẠI DƯỠNG TRẮNG DA 7 NGÀY –CHIẾT XUẤT DƯA LEO, NHAU CỪU, ỐC SÊN , SỮA ONG CHÚA, NIACINAMIDE 3W CLINIC MASK SHEET 23ML/ MIẾNG",48000,48000,0,0
TIKI,lam-dep-suc-khoe,14422618,"Gối ngải cứu giảm đau xương khớp dùng lò vi sóng Hapaku",182000,198000,16000,8
TIKI,lam-dep-suc-khoe,270808580,"Bổ não Úc Healthy Care Ginkgo Biloba 2000, Giúp tăng tuần hoàn máu não, Cải thiện chức năng nhận thức, Trí nhớ, Giúp an thần và Giảm Stress - OZ Slim Store",249000,532000,283000,53
TIKI,lam-dep-suc-khoe,79411383,"Kem chống nắng Skin Aqua dưỡng da cho mặt khi hoạt động ngoài trời dạng gel Sunplay Skin Aqua Clear White Outdoor+ SPF50+ PA++++ 30g",103000,126000,23000,18
TIKI,lam-dep-suc-khoe,1192875,"Bút Kẻ Mắt Nét Siêu Mảnh Không Trôi Suri Waterproof Eyeliner Pen",78000,78000,0,0
TIKI,lam-dep-suc-khoe,251275874,"Gel bôi trơn KLY Gốc nước Thổ Nhĩ Kỳ",50000,55000,5000,9
TIKI,lam-dep-suc-khoe,135973753,"Kem Dưỡng Ẩm A-Derma Cho Viêm Da Cơ Địa & Da Khô Exomega Allergo Emollient Cream 200ml",539000,770000,231000,30
TIKI,lam-dep-suc-khoe,106082135,"Viên uống rau củ DHC Nhật Bản bổ sung chất xơ, giảm nổi mụn giảm nóng trong và làm đẹp da JN-DHC-VEG",265000,297330,32330,11
TIKI,lam-dep-suc-khoe,22052319,"Sữa rửa mặt cho nam Oxy sạch sâu giảm mụn kiểm soát nhờn dạng kem Oxy Total Anti Acne 100g",69000,86000,17000,20
TIKI,lam-dep-suc-khoe,11255782,"Kem bôi da Thuần Mộc 13g giảm bong tróc, mẩn ngứa, dị ứng da...",104000,104000,0,0
TIKI,lam-dep-suc-khoe,72514796,"4 Bánh Xà phòng cục Dove Mỹ White Beauty 106g dưỡng trắng da ",116000,116000,0,0
TIKI,lam-dep-suc-khoe,142762405,"Sữa dưỡng thể Vaseline dưỡng trắng da 725ml",155000,155000,0,0
TIKI,lam-dep-suc-khoe,2738479,"Bộ 2 Hộp Silcot Bông Trang Điểm (bông tẩy trang) Nhật Bản Cao Cấp (66 Miếng/Hộp)",73900,94000,20100,21
TIKI,lam-dep-suc-khoe,2870185,"Kem dưỡng làm liền sẹo, tái tạo da Epitheliale A.H DUO Ultra Repairing Cream A-Derma 40ml",313000,497000,184000,37
TIKI,lam-dep-suc-khoe,7979047,"Bột tẩy trắng răng Eucryl 50g (Chính hãng)",45000,45000,0,0
TIKI,lam-dep-suc-khoe,130774948,"Kem dưỡng trắng da toàn thân Yococi giúp da trắng mịn, ngăn ngừa lão hoá White Perfect Body Lotion",165000,300000,135000,45
TIKI,lam-dep-suc-khoe,102131367,"Nước Hồng Sâm Won KGC Cheong Kwan Jang 15 Gói 70ml",522000,580000,58000,10
TIKI,lam-dep-suc-khoe,270879502,"Vitamin B Kirkland Super B-Complex tăng khả năng nấp thụ, chuyển hóa năng lượng, tăng cường hệ miễn dịch, giảm căng thẳng - QuaTangMe Extaste",685000,1370000,685000,50
TIKI,lam-dep-suc-khoe,1600057,"Combo 6 Băng Vệ Sinh Diana Super Night 35cm (Gói 3 Miếng)",106000,126000,20000,16
TIKI,lam-dep-suc-khoe,653804,"Lưỡi Dao Cạo Gillette Vector 4",50000,50000,0,0
TIKI,lam-dep-suc-khoe,108693621,"Gel chống nắng dưỡng ẩm Hada Labo Koi-Gokujyun Perfect Uv Gel (Sunscreen) SPF50+ PA++++ 50g",279000,280000,1000,0
TIKI,lam-dep-suc-khoe,453901,"Nước Súc Miệng Ngăn Ngừa Vôi Răng Listerine Tartar Protection (750ml) - 8850007811695",187000,187000,0,0
TIKI,lam-dep-suc-khoe,136029472,"Combo 30 bàn chải đánh răng Sunree",149000,149000,0,0
TIKI,lam-dep-suc-khoe,170404655,"Combo 5 Hộp Khẩu trang Bông Bạch Tuyết KF94 4 lớp trắng (10 cái/hộp)",100000,100000,0,0
TIKI,lam-dep-suc-khoe,118536461,"Nước Tẩy Trang Dành Cho Mọi Loại Da Oribe Bi-Phase Makeup Removal 200g",167000,210000,43000,20
TIKI,lam-dep-suc-khoe,45150752,"Xịt mũi viêm xoang thảo dược Rohto Nosewash 35ml",48600,58000,9400,16
TIKI,lam-dep-suc-khoe,26114143,"Viên Uống Vitamin Tổng Hợp DHC Multi Vitamin Nhật Bản",85000,90000,5000,6
TIKI,lam-dep-suc-khoe,67661317,"Nước Nhỏ Mắt SANCOBA Dành Cho Người Cận Thị 5ml NHẬT BẢN",42000,42000,0,0
TIKI,lam-dep-suc-khoe,114682899,"Mật Ong Nguyên Chất Duy Anh Bee 1400g",194000,194000,0,0
TIKI,lam-dep-suc-khoe,35239920,"Bàn chải điện Xiaomi Shell DR-BEI Sonic BET-C01- Hàng Nhập Khẩu",419000,469000,50000,11
TIKI,lam-dep-suc-khoe,9848824,"Nhiệt kế kẹp nách Omron MC-246",97000,128000,31000,24
TIKI,lam-dep-suc-khoe,270185520,"Tinh Dầu Nguyên Chất 24Care 50ml - Tinh Dầu Xông Thơm Phòng Giúp Giảm Căng Thẳng, Thư giãn, Đuổi Muỗi và Khử Mùi - Tinh dầu Sả Chanh/ Cam Ngọt/ Oải hương/ Ngọc Lan Tây/ Tràm Trà/ Bưởi Ngọt/ Vỏ Quế",215000,215000,0,0
TIKI,lam-dep-suc-khoe,63189246,"Combo 2 Xịt khử mùi Charming/Sensation/Magic/Delightful/Romantic 150ml/Chai",171000,220000,49000,22
TIKI,lam-dep-suc-khoe,12478871,"Gel Rửa Mặt và Tắm Cho Da Đang Bị Kích Ứng A-Derma Shower Gel Hydra-Protective (200ml)",265000,408000,143000,35
TIKI,lam-dep-suc-khoe,149969411,"Combo Hỗ Trợ Ngăn Ngừa Các Triệu Chứng Của Trĩ Giúp Co Búi Trĩ Dân Khang Trimax ",273000,339000,66000,19
TIKI,lam-dep-suc-khoe,250020365,"Máy xông tinh dầu phòng ngủ tạo ẩm phun sương khuếch tán tinh dầu làm thơm phòng, khử mùi nhà vệ sinh trụ tròn - Hàng chính hãng Vinbuy",225000,450000,225000,50
TIKI,lam-dep-suc-khoe,72042163,"Khẩu Trang Y Tế 4 Lớp Nam Anh (Hộp 50 Cái - Màu Đen)",24000,35000,11000,31
TIKI,lam-dep-suc-khoe,187597380,"[Combo bộ 2] -  Hỗ Trợ Trị Sẹo Actiscar làm mờ sẹo Lồi, Sẹo Lõm, Sẹo Rỗ, Sẹo Thâm Lâu Năm",620000,659000,39000,6
TIKI,lam-dep-suc-khoe,76786308,"Tinh Dầu Xông Phòng HOA HỒNG TIDAMO 50ML - Tinh Dầu Hoa Hồng Cao Cấp Nhập Khẩu Tạo Hương Thơm Thư Giãn, Kích Thích Cảm Giác Lãng Mạn, Giải Tỏa Mệt Mõi",98000,230000,132000,57
TIKI,lam-dep-suc-khoe,136855309,"Dầu gội nam Bergami hương nước hoa Shocking Man - Hương nước hoa nam tính - Lịch lãm - Sạch gàu vượt trội",154000,239000,85000,36
TIKI,lam-dep-suc-khoe,8142221,"Kềm Cắt Móng Thép Không Gỉ Kềm Nghĩa M-01",170200,185000,14800,8
TIKI,lam-dep-suc-khoe,14924192,"Lăn khử mùi giảm tiết mồ hôi Etiaxil Deodorant Anti-transpirant 48H Roll On 50ml ",249000,289000,40000,14
TIKI,lam-dep-suc-khoe,877332,"Combo 5 Giấy Thấm Dầu Mayan Than Hoạt Tính (100 Tờ)",144000,175000,31000,18
TIKI,lam-dep-suc-khoe,73841542,"Dầu gội giảm gàu, rụng tóc dành cho da dầu Vichy Dercos Anti-Dandruff DS (200mL)",311000,415000,104000,25
TIKI,lam-dep-suc-khoe,185077932,"Gôm xịt tóc nam nữ BRITISH M Hard Tailor Spray giữ nếp, dễ dàng đổi kiểu 80ml",167400,167400,0,0
TIKI,lam-dep-suc-khoe,44106900,"Máy tăm nước Panasonic cầm tay dùng pin sạc EW1211 - Hàng Chính Hãng",1899000,2200000,301000,14
TIKI,lam-dep-suc-khoe,104655988,"Combo SÁNG DA - MỜ THÂM DHC Nhật Bản gồm viên uống vitamin C và viên uống trắng da 30 ngày JN-DHC-CB1",340000,381480,41480,11
TIKI,lam-dep-suc-khoe,67088623,"Máy Xông Tinh Dầu Vân Gỗ 550ML Chuyên Dụng Cho Phòng Lớn Có Remote Điều Khiển Từ Xa Kèm Đèn LED Thay Đổi Màu Cực Đẹp",224000,528000,304000,58
TIKI,lam-dep-suc-khoe,108535183,"Bao cao su Sagami Are Are - Có gai - Hộp 10 chiếc",115000,160000,45000,28
TIKI,lam-dep-suc-khoe,194040396,"Bộ 2 Nước súc miệng cho răng nhạy cảm Listerine Total Care Sensitive Soothing Taste 750ml/chai",374000,374000,0,0
TIKI,lam-dep-suc-khoe,74561072,"Tinh dầu Sả Chanh Nguyên Chất Nhập Khẩu 10ML - Tinh dầu Xông Phòng Sả Chanh (Lemongrass) Giúp Bảo Vệ Sức Khỏe, Kháng Khuẩn, Đuổi Muỗi Và Thư Giãn Tinh Thần",29000,76000,47000,62
TIKI,lam-dep-suc-khoe,75409136,"Tinh Dầu Lavender Nguyên Chất Nhập Khẩu 50ML (Oải Hương), Tinh Dầu Xông Phòng Oải Hương Giúp Thư giản, Khử Trùng Và Bảo Vệ Sức Khỏe, Sử Dụng Với Máy Xông Tinh Dầu Cho Gia Đình Và Văn Phòng",98000,296000,198000,67
TIKI,lam-dep-suc-khoe,3718831," Nước Hồng Sâm Linh Chi KGS Hàn Quốc hộp 10 chai",189999,189999,0,0
TIKI,lam-dep-suc-khoe,190843443,"Máy massage đeo tay Phú Quý (tặng kèm 1 bộ than)",519000,519000,0,0
TIKI,lam-dep-suc-khoe,10640154,"Sữa rửa mặt kiểm soát nhờn ngăn ngừa mụn dạng gel Acnes Oil Control Cleanser 100g",56300,70000,13700,20
TIKI,lam-dep-suc-khoe,172120367,"Thuốc nhỏ mắt Eyemiru 40EX giảm viêm, ngứa mắt (Hộp 1 lọ 15ml)",74000,74000,0,0
TIKI,lam-dep-suc-khoe,121482721,"Combo Dầu gội, Dầu xả, Kem ủ & Serum TRESEMME Keratin Smooth Dưỡng tóc vào nếp suôn mượt với công thức Hydrolyzed Keratin 640g, 620g, 180ml, 97ml",527000,836000,309000,37
TIKI,lam-dep-suc-khoe,73276050,"Nước Tẩy Trang Bí Đao Cocoon 500ml",295000,295000,0,0
TIKI,lam-dep-suc-khoe,165091719,"Viên Uống DHC Biotin Ngăn Rụng Tóc Sustained Release Biotin 30 Ngày (30 Viên)",135000,160000,25000,16
TIKI,lam-dep-suc-khoe,7980446,"Combo kem đánh răng 62g và bột tẩy trắng răng Eucryl 50g (Chính hãng)",109000,109000,0,0
TIKI,lam-dep-suc-khoe,21038056,"Băng Vệ Sinh Diana Băng Đêm Quần Size S-M-1807",30900,30900,0,0
TIKI,lam-dep-suc-khoe,185940709,"[SIZE DU LỊCH] Nước tẩy trang Sắc Ngọc Khang 30ml giúp làm sạch da bụi bẩn, bã nhờn, ngăn ngừa mụn hiệu quả",25000,30000,5000,17
TIKI,lam-dep-suc-khoe,12376539,"Xịt khoáng dưỡng ẩm trà xanh innisfree Green Tea Mist 150ml",308000,350000,42000,12
TIKI,lam-dep-suc-khoe,85396315,"Thực phẩm chức năng bổ sung cho Xương Khớp. Kirkland Glucosamine HCl 1500mg with MSM (375 Viên) - Mỹ",555000,560000,5000,1
TIKI,lam-dep-suc-khoe,70771723,"Nhiệt kế điện tử hồng ngoại đo trán không chạm Yamada - đo nhanh 1 giây, cảnh báo sốt, màn hình 3 màu đèn, đo sữa, nước tắm, nhiệt độ phòng",399000,399000,0,0
TIKI,lam-dep-suc-khoe,71200200,"Viên tinh nghệ mật ong (MS) -250g",159000,160000,1000,1
TIKI,lam-dep-suc-khoe,120318503,"Khẩu trang 5d mask Nam Anh (Famapro) - Hộp 10 cái",9900,18000,8100,45
TIKI,lam-dep-suc-khoe,8211882,"Nhíp Vỉ Giấy N-404 - Kềm Nghĩa",40480,44000,3520,8
TIKI,lam-dep-suc-khoe,13415779,"Nước Súc Miệng Thái Dương Hương Bạc Hà (500ml)",35000,35000,0,0
TIKI,lam-dep-suc-khoe,6398571,"Kem phục hồi dịu da và kháng khuẩn Dermalibour + Repairing Cream A-Derma 50ml",250000,417000,167000,40
TIKI,lam-dep-suc-khoe,70661243,"Gel rửa mặt tạo bọt làm sạch & giảm nhờn cho da dầu nhạy cảm La Roche-Posay Effaclar Purifying Foaming Gel (400ml)",399000,585000,186000,32
TIKI,lam-dep-suc-khoe,73532408,"Gel Bôi Trĩ Giúp Co Búi Trĩ, Hỗ Trợ Giảm Sưng Đỏ Và Ngứa Rát Hậu Môn Do Trĩ Trimaxgel 20g - Nguyên Liệu Nhập Khẩu Từ Châu Âu",106000,129000,23000,18
TIKI,lam-dep-suc-khoe,55614663,"Kem Nền Che Khuyết Điểm Kiềm Dầu Chống Nắng Dưỡng Da Ngăn Ngừa Lão Hóa Công Nghệ Nano Vàng Cellkey-Scien Multi Action BB Cream (30ml)",612000,680000,68000,10
TIKI,lam-dep-suc-khoe,8211888,"Nhíp Vỉ Giấy N-409 - Kềm Nghĩa",36800,40000,3200,8
TIKI,lam-dep-suc-khoe,577147,"Dầu Gội Hỗ Trợ Trị Gàu Stanhome Balance Shampoo 200ml - 07482",360000,379000,19000,5
TIKI,lam-dep-suc-khoe,16107344,"BỘ 10 MẶT NẠ LÔ HỘI DABO FIRST SOLUTION MASK PACK ALOEVERA",89000,89000,0,0
TIKI,lam-dep-suc-khoe,14708536,"Bộ máy đo đường huyết Safe Accu tặng 1 hộp 50 que thử và hộp 50 kim chích máu",237000,299000,62000,21
TIKI,lam-dep-suc-khoe,108535211,"Bao cao su Sagami Tight Fit - Thiết kế lượn sóng - Hộp 12 chiếc",110000,160000,50000,31
TIKI,lam-dep-suc-khoe,55622025,"Nước Hoa Hồng Kiềm Dầu Kiểm Soát Bã Nhờn Cân Bằng Độ Ẩm Da Dầu Mụn Nhạy Cảm Dewytree The Clean Lab AC DEW Calamine Toner 200ml",391000,460000,69000,15
TIKI,lam-dep-suc-khoe,53061315,"Combo 10 Túi mặt nạ giấy dưỡng trắng da - mặt na dưỡng trắng da chiết xuất Than Hoạt Tính 3w Clinic Hàn Quốc 23ml x 10",56000,56000,0,0
TIKI,lam-dep-suc-khoe,24161391,"Dầu gội ngăn ngừa gàu Davines Naturaltech Purifying shampoo 250ml",262000,285000,23000,8
TIKI,lam-dep-suc-khoe,118959851,"Gel rửa mặt tạo bọt cho da hỗn hợp và da dầu Bioderma Sebium Gel Moussant dạng tuýp - 200ml",277000,325000,48000,15
TIKI,lam-dep-suc-khoe,196472716,"Tinh Dầu Dưa Hấu Homer 100ML - Tinh Dầu Xông Thơm Phòng, Thư Giãn Khử Mùi - Tinh Dầu Trái Cây Thiên Nhiên",69000,69000,0,0
TIKI,lam-dep-suc-khoe,70664831,"Nước Tẩy Trang Làm Sạch Sâu & Kiểm Soát Bã Nhờn Cho Da Dầu Nhạy Cảm La Roche-Posay Micellar Water Ultra Oily Skin 200ml",315000,420000,105000,25
TIKI,lam-dep-suc-khoe,114778830,"[Chính Hãng] Combo 2 Bàn Chải Đánh Răng Điện Zenyum Sonic - 2P - Bàn Chải Điện HOT - Công Nghệ Singapore",2299000,3000000,701000,23
TIKI,lam-dep-suc-khoe,196851276,"Tinh Dầu Khóm Homer 100ml- Tinh Dầu Xông Thơm Phòng, Thư Giãn Khử Mùi- Tinh Dầu Trái Cây Thiên Nhiên",69000,69000,0,0
TIKI,lam-dep-suc-khoe,190119235,"Vaseline Gluta-Hya Dưỡng Thể Nâng Tông Tức Thì Gấp 4 Lần 300ML",139000,190000,51000,27
TIKI,lam-dep-suc-khoe,1313903,"Dung dịch dưỡng trắng da chống thâm nám Melano CC Whitening Lotion 170ml",190000,300000,110000,37
TIKI,lam-dep-suc-khoe,38735034,"Sáp vuốt tóc Kevin Murphy Rough Rider - Travel Size 30gram",318000,318000,0,0
TIKI,lam-dep-suc-khoe,8142287,"Kềm Cắt Da Thép Chuyên Dụng Kềm Nghĩa D-18",73600,80000,6400,8
TIKI,lam-dep-suc-khoe,16631908,"Xà Phòng Rửa Mặt Và Giảm Mụn Acne-Aid Bar 100g",76000,96000,20000,21
TIKI,lam-dep-suc-khoe,196855083,"Tinh Dầu Me Homer 100ml - Tinh Dầu Xông Thơm Phòng, Thư Giãn Khử Mùi - Tinh Dầu Trái Cây Thiên Nhiên",69000,69000,0,0
TIKI,lam-dep-suc-khoe,73351823,"Sáp vuốt tóc BY VILAIN DYNAMITE CLAY 65 ml",419000,419000,0,0
TIKI,lam-dep-suc-khoe,103376023,"Tinh Dầu Thiên Nhiên Nguyên Chất HOMER Sả Chanh/ Quế/ Oải hương/ Bưởi/ Cam/ Hoa Lài/ Quýt/ Tràm Huế/ Hoa Hồng/ Lavender/ Ngọc Lan Tây/ Tràm Trà/ Sả Java/ Trà Xanh/ Cà Phê/ Chanh (20ml)",66000,66000,0,0
TIKI,lam-dep-suc-khoe,217174306,"[+Tặng mũ trùm] Kem ủ tóc Collagen Karseell Maca phục hồi siêu mượt 100ml/500ml",47000,47000,0,0
TIKI,lam-dep-suc-khoe,22293001,"Combo sữa rửa mặt kiểm soát bã nhờn chiết xuất từ than hoạt tính , sửa rữa mặt ngăn ngừa mụn, phục hồi da chiết xuất từ trà xanh, sửa rữa mặt làm sáng mịn da chiết xuất từ lúa mạch 3W CLINIC ",87000,87000,0,0
TIKI,lam-dep-suc-khoe,196559916,"Tinh Dầu Hoa Bưởi Homer 100ml - Chính Hãng, Đạt Chuẩn Kiểm Định Cao Cấp - Tinh Dầu Xông Thơm Phòng, Thư Giãn, Khử Mùi hiệu quả",149000,149000,0,0
TIKI,lam-dep-suc-khoe,115960176,"Tinh bột nghệ nhiều curcumin  HNT 500g - Đã được kiểm nghiệm an toàn chất lượng thực phẩm- dùng khi, dưỡng da, đau dạ dày",249000,249000,0,0
TIKI,lam-dep-suc-khoe,191683087,"Son Kem Lì Bbia Last Velvet Lip Tint ASIA EDITION Version 2 (6 Màu) 5g Bbia Official Store",135000,290000,155000,53
TIKI,lam-dep-suc-khoe,141354715,"Dầu gội gừng Weilaiya cao cấp 400ml - trị rụng tóc, kích thích mọc tóc",260000,269000,9000,3
TIKI,lam-dep-suc-khoe,77924648,"Serum (Tinh Chất) Vitamin C Zakka Naturals GlowFruit+ Brightening 20g",490000,490000,0,0
TIKI,lam-dep-suc-khoe,174071718,"Sữa rửa mặt Hada Labo cho da dầu mụn, da nhạy cảm Hada Labo Acne Care Calming Cleanser 80g",81900,95000,13100,14
TIKI,lam-dep-suc-khoe,44140593,"MẶT NẠ THẢI ĐỘC HỖ TRỢ TRỊ MỤN TẬN GỐC THAN HOẠT TÍNH, BÙN KHOÁNG DOUBLE DETOX MASK (20 GR) LÀM DỊU MỤN ĐỎ, LÀM SẠCH SÂU, THẢI ĐỘC DA, TRẮNG DA, MỜ NÁM.",315000,315000,0,0
TIKI,lam-dep-suc-khoe,185812640,"Lăn Khử Mùi Perspirex (Strong / Original / Comfort) Roll-On Chính Hãng",310000,310000,0,0
TIKI,lam-dep-suc-khoe,39180106,"Tinh chất chống lão hóa da The Ordinary Retinol 1% in Squalane 30ml",349000,349000,0,0
TIKI,lam-dep-suc-khoe,3490097,"Tinh chất thu nhỏ lỗ chân lông Paula's Choice 10% Niacinamide Booster 20ml",1610000,1790000,180000,10
TIKI,lam-dep-suc-khoe,270549484,"Mần đậu nành Healthy Care Super Lecithin Úc Tăng cường chức năng gan khỏe mạnh, nâng cao sức khỏe, sắc đẹp từ bên trong - QuaTangMe Extaste",316000,632000,316000,50
TIKI,lam-dep-suc-khoe,11254935,"Gel dưỡng trắng da Shiseido White Lucent Brightening Gel Cream 50mL",1850000,1850000,0,0
TIKI,lam-dep-suc-khoe,176254169,"Nhụy hoa nghệ tây saffron Kingdom Herb chính hãng loại super negin thượng hạng hộp 1 gram (tặng bình thuỷ tinh cao cấp)",278000,539000,261000,48
TIKI,lam-dep-suc-khoe,67242465,"Kem Dưỡng Mắt Tích Hợp Máy Rung Massage JOMTAM Hỗ Trợ Giảm Quầng Thâm Bọng Mắt",59000,95000,36000,38
TIKI,lam-dep-suc-khoe,30157357,"Nước bí đao cân bằng da (Winter melon toner) Cocoon 140ml",156000,195000,39000,20
TIKI,lam-dep-suc-khoe,73607516,"Sữa Rửa Mặt Dịu Nhẹ Cetaphil Gentle Skin Cleanser 500ml",338000,376000,38000,10
TIKI,lam-dep-suc-khoe,272361986,"100 Viên Nến Tealight Sáp Cọ 4 giờ Lorganic An Toàn Sức Khỏe/ Dùng kết hợp đèn xông và tinh dầu/ Khử mùi và đuổi côn trùng hiệu quả",115000,170000,55000,32
TIKI,lam-dep-suc-khoe,118124169,"Viên uống WIT bổ mắt (30 viên)",330000,330000,0,0
TIKI,lam-dep-suc-khoe,152015621,"Cho máy Oral B Braun Cross Action EB-50A, Set 4 cái/ vỉ, Bộ 4 đầu bàn chải đánh răng điện đánh tan mảng bám. Tặng kèm móc khóa – Minh House",155000,155000,0,0
TIKI,lam-dep-suc-khoe,9858922,"Máy khuếch tán tinh dầu giọt nước lớn gỗ nâu Lorganic FX2023 + tinh dầu sả chanh + tinh dầu cam Lorganic (10ml x2)/ Phun sương sóng siêu âm.",300000,550000,250000,45
TIKI,lam-dep-suc-khoe,161256063,"Sữa tắm cho nam sạch sâu, khử mùi cơ thể Oxy Deep Shower",60900,74000,13100,18
TIKI,lam-dep-suc-khoe,86539325,"Combo 6 Băng vệ sinh thảo dược Doctor Care, BVS ban ngày 24cm siêu khô thoáng cả ngày dài",168500,198000,29500,15
TIKI,lam-dep-suc-khoe,284465,"Thuốc nhuộm dưỡng tóc phủ bạc thảo dược Bigen Conditioner Thương hiệu Nhật Bản 80ml dạng kem - BHCC",165000,188000,23000,12
TIKI,lam-dep-suc-khoe,114458769,"Máy nâng cơ mặt, Giảm nhăn, Tăng sinh collagen, Công nghệ Nhật Bản 2021 Cổ thiên nga",820000,820000,0,0
TIKI,lam-dep-suc-khoe,73341539,"Tinh Dầu BẠC HÀ Cao Cấp TIDAMO 10ML - Tinh Dầu Bạc Hà Nguyên Chất Nhập Khẩu Sử Dụng Với Máy Xông Tinh Dầu Giúp Bảo Vệ Sức Khỏe, Kháng Khuẩn, Thư Giãn Tinh Thần và Xua Đuổi Côn Trùng",29000,76000,47000,62
TIKI,lam-dep-suc-khoe,876442,"Tẩy Trang Bioderma Sensibio H2O (500ml)",389000,439000,50000,11
TIKI,lam-dep-suc-khoe,14773441,"Combo 2 Kem bôi da Thuần Mộc 13g dưỡng ẩm da, giảm bong tróc, mẩn ngứa",210000,210000,0,0
TIKI,lam-dep-suc-khoe,131504691,"Bột nhuộm tóc dược liệu màu đen Sao Thái Dương hộp 5 gói",90000,90000,0,0
TIKI,lam-dep-suc-khoe,77749869,"Tinh Dầu Xông Phòng BẠC HÀ 50ML + Tinh Dầu Treo Phòng Treo Xe ô tô Bạc Hà (Peppermint) - Tinh Dầu Bạc Hà TIDAMO Nguyên Chất Giúp Bảo Vệ Sức Khỏe, Kháng Khuẩn, Thư Giãn Tinh Thần Và Xua Đuổi Côn Trùng",88000,256000,168000,66
TIKI,lam-dep-suc-khoe,12478881,"Dầu Gội hỗ trợ điều trị Gàu Mảng, Vảy Nến Ducray Kertyol P.S.O Shampoo (125ml)",216000,350000,134000,38
TIKI,lam-dep-suc-khoe,155114275,"Lăn Khử Mùi Đá Khoáng Dạng Sáp Cho Mọi Loại Da Deonatulle Soft Stone Double Deodorant 20g",205620,298000,92380,31
TIKI,lam-dep-suc-khoe,131194676,"Son Lì Dưỡng Nhẹ Môi Luxury Mộc An Không Chứa Chì Giúp Dưỡng Hồng Bền Màu 4g",169000,200000,31000,16
TIKI,lam-dep-suc-khoe,88253798,"Set 2 gói băng vệ sinh LAURIER ban đêm 30cm x 9 miếng",88000,88000,0,0
TIKI,lam-dep-suc-khoe,101982527,"Khẩu trang vải 3 lớp kháng khuẩn, chống bụi, chống nắng, kháng giọt bắn NOVELTY - hàng chính hãng - Thương hiệu thuộc Tổng công ty May Nhà Bè",33600,42000,8400,20
TIKI,lam-dep-suc-khoe,10305259,"Thuốc nhuộm dưỡng tóc phủ bạc thảo dược Bigen Silk Touch Thương hiệu Nhật Bản Sắc Màu trẻ trung 80ml dạng kem - BST 8C",196000,216000,20000,9
TIKI,lam-dep-suc-khoe,37651735,"Thực phẩm bổ sung Vitamin của Mỹ - ONE A DAY WOMEN 50+ Healthy Advantage 300 viên",625000,625000,0,0
TIKI,lam-dep-suc-khoe,55891615,"Bigsize - Kem ủ trắng toàn thân Truesky Whitening Body Cream chiết xuất rễ cây cam thảo 200g",139000,250000,111000,44
TIKI,lam-dep-suc-khoe,91257464,"Combo 6 Băng vệ sinh hàng ngày  thảo dược Doctor Care 16 cm siêu khô thoáng cả ngày dài",143000,168000,25000,15
TIKI,lam-dep-suc-khoe,48594251,"Essence Chống Nắng Màng Nước Dưỡng Ẩm Biore UV Aqua Rich Watery Essence SPF50+/PA++++ 85G",259000,259000,0,0
TIKI,lam-dep-suc-khoe,34151280,"Nhiệt Kế Điện Tử Microlife MT 550",188000,210000,22000,10
TIKI,lam-dep-suc-khoe,214604822,"Miếng dán kích mí trong suốt Suri tặng kèm móc khoásuri",45000,45000,0,0
TIKI,lam-dep-suc-khoe,186291963,"Gối Chườm Nóng Thảo Dược Hapaku - Làm Nóng Bằng Điện",919000,945000,26000,3
TIKI,lam-dep-suc-khoe,13884713,"Dầu Gội Hoa Bưởi Thorakao 500ml",47000,47000,0,0
TIKI,lam-dep-suc-khoe,161490393,"Dung dịch vệ sinh phụ nữ đũa thần inner OZO Feelex Care",77000,85000,8000,9
TIKI,lam-dep-suc-khoe,50737117,"Sáp Vuốt Tóc Apestomen Volcanic Clay V4 + Lược Trifecta Comb",249000,249000,0,0
TIKI,lam-dep-suc-khoe,117336427,"Máy tăm nước cầm tay FAIRYWILL FW-5020E Bản Màu Trắng Thiết kế nhỏ gọn Sạc bằng USB Dễ mang đi du lịch Hàng Chính Hãng",663000,677000,14000,2
TIKI,lam-dep-suc-khoe,83202928,"Bộ 5 Bàn chải đánh răng Colgate than hoạt tính kháng khuẩn SlimSoft Charcoal mềm mảnh",135000,153000,18000,12
TIKI,lam-dep-suc-khoe,94146543,"Serum Dưỡng Mày FEG EyeBrow Enhancer 3ml",280000,280000,0,0
TIKI,lam-dep-suc-khoe,1325531,"Combo 10 Cặp Nút Tai Chống Ồn 3M 1100 - Cam, Nút bịt tai chống ồn khi đi máy bay, làm việc trong xưởng in, ôn thi",40000,40000,0,0
TIKI,lam-dep-suc-khoe,196463350,"Tinh Dầu Nho Homer 100ml - Xông Thơm Phòng, Thư Giãn Khử Mùi - Tinh Dầu Trái Cây Thiên Nhiên",45000,45000,0,0
TIKI,lam-dep-suc-khoe,10597698,"Thực Phẩm Chức Năng CumarGold Kare - Hỗ trợ điều trị ung thư",390000,390000,0,0
TIKI,lam-dep-suc-khoe,188127813,"Nước uống collagen tổ yến giúp đẹp da, tăng cường sức khỏe Blossomy Premium lốc 10 chai x 50ml",739000,945000,206000,22
TIKI,lam-dep-suc-khoe,12084512,"Kem Che Khuyết Điểm Giảm Mụn Và Vết Thâm Eucerin ProAcne Correct and Cover Stick (2g)",333000,490000,157000,32
TIKI,lam-dep-suc-khoe,205073081,"Gel bôi trơn mát lạnh - Shell Cooling - Chai 100ml",220800,240000,19200,8
TIKI,lam-dep-suc-khoe,100021983,"Khẩu trang người lớn cao cấp MAYAN PM2.5 3D MASK, gói 5 chiếc",24000,24000,0,0
TIKI,lam-dep-suc-khoe,17595716,"Tinh dầu gỗ thông đen  Lorganic Pine black 10ml/ Hương thơm ấm nồng/ Tinh dầu thiên nhiên nguyên chất xông phòng/ Thư giãn tinh thần/ Thích hợp dùng với đèn xông và máy khuếch tán.",45000,80000,35000,44
TIKI,lam-dep-suc-khoe,183737004,"Máy Triệt Lông Băng Lạnh Trẻ Hóa Da Halio IPL Cooling Hair Removal Device 999999 Xung Ánh Sáng",3700000,4000000,300000,8
TIKI,lam-dep-suc-khoe,631952,"Seum VItamin C 10% dưỡng trắng mờ thâm sạm Acnes Lab C10 serum 15ml",310000,365000,55000,15
TIKI,lam-dep-suc-khoe,77650571,"MÁY KHUẾCH TÁN TINH DẦU TRỤ TRONG 500 ML - MÁY XÔNG TINH DẦU PHUN SƯƠNG CHÍNH HÃNG KRISHNA - TẶNG KÈM REMOTE - MÁY XÔNG TINH DẦU SIÊU ÂM PHUN SƯƠNG CHUYÊN DỤNG CHO KHÔNG GIAN LỚN - ĐÈN LED 7 MÀU TRANG TRÍ  RẤT ĐẸP",270000,270000,0,0
TIKI,lam-dep-suc-khoe,272919114,"Khẩu Trang KF94 Người Lớn Tenamyd Chính Hãng",100000,125000,25000,20
TIKI,lam-dep-suc-khoe,162196430,"Sữa Rữa Mặt Laneige Water Bank Blue HA Cleansing Foam 150g",505000,600000,95000,16
TIKI,lam-dep-suc-khoe,91753273,"hộp 10 chiếc Bao cao su SuperMen có gai và ngăn ngừa xuất tinh sớm , nhập khẩu , chất bôi trơn tốt ",55000,57000,2000,4
TIKI,lam-dep-suc-khoe,88041250,"Combo 10 Mặt nạ tế bào gốc nhau thai cừu Rwine Beauty Stem Cell Placenta Mask",120000,240000,120000,50
TIKI,lam-dep-suc-khoe,271447973,"Bổ não Úc Healthy Care Ginkgo Biloba Hỗ trợ các vấn đề tuần hoàn não, Cải Thiện Trí Nhớ, lưu thông máu, Tăng khả năng nhận thức - Massel Official",262000,532000,270000,51
TIKI,lam-dep-suc-khoe,118090131,"Bộ 2 Viên Sủi Bổ Sung Vitamin C, D, Và Kẽm Redoxon Triple Action 10 Viên",170000,170000,0,0
TIKI,lam-dep-suc-khoe,8142225,"Kềm Cắt Móng Thép Chuyên Dụng Kềm Nghĩa M-555",96600,105000,8400,8
TIKI,lam-dep-suc-khoe,112289302,"Mặt Nạ Ngủ Cho Môi Laneige Lip Sleeping Mask Berry EX 20g",375000,500000,125000,25
TIKI,lam-dep-suc-khoe,7609680,"Kéo Cắt Tỉa Lông Mũi Đầu Tròn Kềm Nghĩa KM 604- Thép Không Gỉ Cao Cấp - Thiết Kế Nhỏ - Gọn - Nhẹ - An toàn",46920,51000,4080,8
TIKI,lam-dep-suc-khoe,271617029,"Kẽm hỗ trợ trị mụn, làm đẹp da mụn Puritan'S Pride Premium Zinc For Acne Mỹ gồm kẽm và Vitamin C, B-6, A và E - OZ Slim Store",292000,624000,332000,53
TIKI,lam-dep-suc-khoe,1218467,"Thực Phẩm Chức Năng Thuốc hỗ trợ Giảm Cân Học Viện Quân Y Slimtosen Extra (100 Viên)",170000,170000,0,0
TIKI,lam-dep-suc-khoe,55136157,"Sữa Rữa Mặt SIMPLE Kind To Skin Dạng Gel Cho Da Nhạy Cảm UK",199000,199000,0,0
TIKI,lam-dep-suc-khoe,50326501,"Combo 2 Xịt toàn thân Romano Attitude nồng ấm cá tính 150ml",159000,206000,47000,23
TIKI,lam-dep-suc-khoe,176098197,"Sữa tắm mụn lưng ELDAS, sữa tắm giảm viêm nang lông, tinh chất TRÀM TRÀ KHỔ QUA diệt khuẩn ngăn ngừa mụn cơ thể 550ml",109000,189000,80000,42
TIKI,lam-dep-suc-khoe,166084645,"KEM BODY COLLAGEN X3 WHITENING BODY CREAM MIX SAFFRON",99000,175000,76000,43
TIKI,lam-dep-suc-khoe,186094161,"Bọt vệ sinh nam giới Oniiz Dung dịch vệ sinh nam tạo bọt Amorous (Hương Đam Mê) 100ml",120000,120000,0,0
TIKI,lam-dep-suc-khoe,272043408,"Mầm đậu nành Úc Healthy Care Super Lecithin 1200mg tăng cường chức năng gan khỏe mạnh, nâng cao sức khỏe, sắc đẹp từ bên trong - OZ Slim Store",295000,632000,337000,53
TIKI,lam-dep-suc-khoe,58173357,"Kem Body Mềm Dưỡng Trắng Da Acosmetics 250G",175000,175000,0,0
TIKI,lam-dep-suc-khoe,185591376,"Tinh chất dưỡng tóc, ngăn rụng tóc 50 Megumi Hair Essence 30ml",134000,165000,31000,19
TIKI,lam-dep-suc-khoe,161029307,"Máy massage đầu gối không dây thông minh CTFAST: Công nghệ mát xa rung kết hợp nhiệt hồng ngoại, hỗ trợ điều trị đau khớp gối, pin sạc 6000mAh, chất liệu dễ dàng vệ sinh",699000,749000,50000,7
TIKI,lam-dep-suc-khoe,50926033,"Nước Hoa Hồng Ý Dĩ HATOMUGI 500ml",99000,240000,141000,59
TIKI,lam-dep-suc-khoe,214661875,"Gel rửa mặt ngăn ngừa mụn Nerman Nano Curcumin 60s Fresh dành riêng cho nam làm sạch sâu, ngăn ngừa vi khuẩn gây mụn (100ml)",99000,178000,79000,44
TIKI,lam-dep-suc-khoe,113714799,"Viên kẹo ngậm ho bạc hà Eucatana hộp 24 viên, kẹo ngậm bạc hà tiêu đờm, giảm đau họng",39000,39000,0,0
TIKI,lam-dep-suc-khoe,694481,"Tinh Dầu Vỏ Quế Nguyên Chất Lorganic (10ml)",40000,80000,40000,50
TIKI,lam-dep-suc-khoe,126945359,"Bao cao su LifeStyles Fantasy Gân Ngang, Nhiều Gel Bôi Trơn tăng Khoái Cảm - Hộp 12 bao",95040,135000,39960,30
TIKI,lam-dep-suc-khoe,411327,"Nước Xịt Khoáng Dưỡng Da Vichy 150ml - 100829485",173000,205000,32000,16
TIKI,lam-dep-suc-khoe,177315583,"Combo 5 Gói Khẩu trang Bông Bạch Tuyết KF94 4 lớp - Đen (10 cái/gói)",100000,100000,0,0
TIKI,lam-dep-suc-khoe,123582725,"Serum Dưỡng Ẩm Phục Hồi Da GoodnDoc Hydra B5 - Serum B5 GoodnDoc 30ml",370000,375000,5000,1
TIKI,lam-dep-suc-khoe,157271444,"Kem dưỡng trắng da mặt Truesky Whitening Face Cream chiết xuất sữa ong chúa 20g",115000,170000,55000,32
TIKI,lam-dep-suc-khoe,197416463,"Combo Bao cao su Durex Fetherlite Ultima Hộp 12 bao và Hộp 3 bao",282000,379000,97000,26
TIKI,lam-dep-suc-khoe,166764904,"Nước muối sinh lý Vĩnh Phúc Natriclorid 0.9% (500ml)",9500,9500,0,0
TIKI,lam-dep-suc-khoe,10117454,"Nước Gội Đầu Bồ Kết Và Vỏ Bưởi Mộc Nhu Hỗ Trợ Trị Rụng Tóc Trị Gàu 300ml",169000,169000,0,0
TIKI,lam-dep-suc-khoe,271408234,"Hỗ trợ mọc tóc Natrol Biotin Beauty giúp tóc mọc nhanh dài, dày hơn,   làn da rạng rỡ và móng tay chắc khỏe - Massel Official",336000,682000,346000,51
TIKI,lam-dep-suc-khoe,43822645,"Tinh Chất Dưỡng Trắng Da Giảm Thâm Nám Eucerin Double Bosster Serum (30ml)",1094000,1459000,365000,25
TIKI,lam-dep-suc-khoe,43763060,"Kem bôi da Thuần Mộc Thanh Mộc Hương combo 2 Hộp",210000,210000,0,0
TIKI,lam-dep-suc-khoe,20470519,"Băng vệ sinh ban ngày Laurier có cánh -Hàng nội địa Nhật nhập khẩu",92000,92000,0,0
TIKI,lam-dep-suc-khoe,104799777,"Nhíp Inox Đầu Xéo Nhổ Lông Mày Cao Cấp Kềm Nghĩa N.425",19320,21000,1680,8
TIKI,lam-dep-suc-khoe,16279231,"Dầu gội cao cấp Romano Classic cổ điển lịch lãm tóc chắc khỏe 900gr",234000,234000,0,0
TIKI,lam-dep-suc-khoe,196857071,"Tinh Dầu Táo Xanh Homer 100ml - Tinh Dầu Xông Thơm Phòng, Thư Giãn Khử Mùi - Tinh Dầu Trái Cây Thiên Nhiên",79000,79000,0,0
TIKI,lam-dep-suc-khoe,75409313,"Tinh Dầu Lavender Cao Cấp Nhập Khẩu 10ML, Tinh Dầu Xông Phòng Oải Hương Giúp Thư giản, Khử Trùng Và Bảo Vệ Sức Khỏe, Sử Dụng Với Máy Xông Tinh Dầu Cho Gia Đình Và Văn Phòng",34000,116000,82000,71
TIKI,lam-dep-suc-khoe,73609586,"Máy xông tinh dầu VINBUY bầu tiên, máy phun sương tạo ẩm, máy xông tinh dầu phòng ngủ, spa, tự động, chuyên dụng phòng lớn led 07 màu - Hàng chính hãng",225000,400000,175000,44
TIKI,lam-dep-suc-khoe,71161537,"[ MUA 1 TẶNG 1] Viên ăn ngon Multi Vitamin Plus hộp 30 viên_ Hỗ trợ cải thiện biếng ăn, cải thiện cân nặng, giúp ăn ngon ngủ ngon, tăng cường sức đề kháng",460000,460000,0,0
TIKI,lam-dep-suc-khoe,160762447,"Tinh Dầu Oải Hương Treo Phòng, Treo Xe ô tô (Lavender) Chính Hãng TIDAMO Giúp Thơm Thư giản, Kháng Khuẩn Và Bảo Vệ Sức Khỏe",34000,76000,42000,55
TIKI,lam-dep-suc-khoe,161234656,"Tinh chất làm mờ thâm nám và đều màu da tối ưu Paula's Choice Clinical Discoloration Repair Serum 30ml 8040",1439000,1599000,160000,10
TIKI,lam-dep-suc-khoe,196857628,"Tinh Dầu Kiwi Homer 100ml - Tinh Dầu Xông Thơm Phòng, Thư Giãn Khử Mùi - Tinh Dầu Trái Cây Thiên Nhiên",79000,79000,0,0
TIKI,lam-dep-suc-khoe,270845561,"Collagen Type 1,2,3 Youtheory Mỹ tăng độ đàn hồi da, đẹp tóc, móng, duy trì sức khỏe sụn, gân, dây chằng, khớp - QuaTangMe Extaste",598000,1196000,598000,50
TIKI,lam-dep-suc-khoe,196562071,"Tinh Dầu Linh Lan Homer 100ml - Chính Hãng, Đạt Chuẩn Kiểm Định Cao Cấp - Tinh Dầu Xông Thơm Phòng, Thư Giãn, Khử Mùi hiệu quả",129000,129000,0,0
TIKI,lam-dep-suc-khoe,75946733,"Combo Cà phê đắk lắk Tẩy da chết Body cocoon 200ml + Tẩy da chết Mặt cocoon 150ml",210000,210000,0,0
TIKI,lam-dep-suc-khoe,273457539,"Đệm Massage Toàn Thân VP-N20D - Máy Massage Chất Liệu Da Cao Cấp, Công Nghệ Massage Hiện Đại 10 Điểm Rung Kết hợp Nhiệt Hồng Ngoại Và Bi Massage Cổ VaI, Gáy",1599000,1999000,400000,20
TIKI,lam-dep-suc-khoe,169812757,"Sữa chống nắng mỏng nhẹ lâu trôi giúp bảo vệ da tối ưu khỏi tia UVA dài La Roche-Posay Anthelios Uvmune 400 Invisible Fluid 50ml",399000,560000,161000,29
TIKI,lam-dep-suc-khoe,86530110,"Mặt Nạ Ngủ Thạch Chứa Collagen YANJIAYI Giúp Săn Chắc và Nâng Cơ Mặt Hộp 20c - Chính Hãng",29000,29000,0,0
TIKI,lam-dep-suc-khoe,73517801,"Kem Dưỡng Trắng Da Chống Nắng Ban Ngày Oribe Chống Lão Hóa Mờ Thâm Nám Dưỡng Ẩm 30g",245000,320000,75000,23
TIKI,lam-dep-suc-khoe,214691217,"Nước hoa nam chính hãng Nerman - hương thơm nhẹ nhàng, tinh tế thu hút nữ giới, phù hợp đi hẹn hò, đi chơi, đi làm lưu hương tới 8h 10ml",109000,218000,109000,50
TIKI,lam-dep-suc-khoe,143222291,"Kem Đánh Răng Crest 3D White Advanced 147gr",139000,139000,0,0
TIKI,lam-dep-suc-khoe,108535195,"Bao cao su Sagami Feel Long - Có gai nhỏ - Hộp 10 chiếc",95000,120000,25000,21
TIKI,lam-dep-suc-khoe,22052322,"Sữa rửa mặt cho nam Oxy sạch sâu giảm nhờn dạng kem có hạt massage Oxy Deep Wash 100g",69900,86000,16100,19
TIKI,lam-dep-suc-khoe,160534770,"Kem Đa Năng Lucas Papaw Ointment 25g(Hàng nội địa Úc)",128000,185000,57000,31
TIKI,lam-dep-suc-khoe,76369248,"Tinh Dầu Ngọc Lan Tây Nguyên Chất 50ML TIDAMO (Ylang Ylang) - Tinh Dầu Cao Cấp Nhập Khẩu Từ Ấn Độ, Xông Hương Thơm Phòng, Thư Giãn, Nâng Cao Sức Khỏe - Kiểm Nghiệm Chất Lượng Tại Trung Tâm Quatest 3",84000,256000,172000,67
TIKI,lam-dep-suc-khoe,12107948,"Nước Hoa Nam Versace Eros - Eau De Toilette (100ml)",1429000,2399000,970000,40
TIKI,lam-dep-suc-khoe,51420955,"Kem chống lão hóa chuyên sâu chứa Retinol và Bakuchiol- 8015",1499000,1699000,200000,12
TIKI,lam-dep-suc-khoe,15456663,"Titan Gel phiên bản Gold giới hạn giúp tăng kích thước, kéo dài thời gian, tăng ham muốn cho nam giới (hàng chuẩn Nga)",290000,290000,0,0
TIKI,lam-dep-suc-khoe,82721609,"Máy Tăm Nước Không Dây LocknLock Cordless Oral Irrigator ENR156BLU - Màu Xanh Da Trời",669000,1200000,531000,44
TIKI,lam-dep-suc-khoe,68553320,"Tinh bột nghệ nguyên chất Beemo - Đắp mặt, điều trị dạ dày đau bao tử, làm viên tinh nghệ mật ong",69000,105000,36000,34
TIKI,lam-dep-suc-khoe,62758138,"Kem dưỡng giúp làm dịu, làm mượt, làm mát & phục hồi da phù hợp cho trẻ em La Roche-Posay Cicaplast Baume B5 100ml",498000,665000,167000,25
TIKI,lam-dep-suc-khoe,77543516,"Son lì Bbia Last Powder Lipstick 3.5g ( 6 màu )",148000,290000,142000,49
TIKI,lam-dep-suc-khoe,190641510,"Sữa Rửa Mặt Dịu Nhẹ Cho Da Dầu CeraVe Foaming Cleanser 236ml",280000,340000,60000,18
TIKI,lam-dep-suc-khoe,71925436,"Mặt nạ ngủ dạng thạch Collagen nâng cơ chính hãng YANJIAYI (Hộp 20 gói)",29000,29000,0,0
TIKI,lam-dep-suc-khoe,11239286,"Gel tẩy da chết Arrahan Lemon White Peeling Gel (180ml)",61900,61900,0,0
TIKI,lam-dep-suc-khoe,196560436,"Tinh Dầu Hoa Mộc Lan Homer 100ml - Chính Hãng, Đạt Chuẩn Kiểm Định Cao Cấp - Tinh Dầu Xông Thơm Phòng, Thư Giãn, Khử Mùi hiệu quả",119000,119000,0,0
TIKI,lam-dep-suc-khoe,8294948,"Thực phẩm chức năng Viên uống bổ sung Collagen Youtheory (Collagen Type 1-2-3) 390 Viên",585000,585000,0,0
TIKI,lam-dep-suc-khoe,192325645,"Viên uống WIT bổ mắt (60 viên)",590000,590000,0,0
TIKI,lam-dep-suc-khoe,11954438,"Dung Dịch Vệ Sinh Phụ Nữ Kháng Khuẩn Khử Mùi Oriss Làm Sạch Dịu Nhẹ Chiết Xuất Lá Trầu Không Cân Bằng pH - 150ml",50000,63000,13000,21
TIKI,lam-dep-suc-khoe,105622045,"Bộ 3 Bao Cao Su Durex Fetherlite – Hộp 12 bao",576000,804000,228000,28
TIKI,lam-dep-suc-khoe,94474520,"Cây Lấy Khóe Đầu Nhọn Inox Hỗ Trợ Móc Khóe và Vệ Sinh Khóe KỀM NGHĨA",7360,8000,640,8
TIKI,lam-dep-suc-khoe,273010004,"Hỗ trợ giảm đau nhức xương khớp Schiff Move Free Mỹ nâng cao sức khỏe khớp, sụn và xương, tăng khả năng vận động linh hoạt thoải mái-QuaTangMe Extaste",831000,1662000,831000,50
TIKI,lam-dep-suc-khoe,66786807,"Trunature Ginkgo Biloba 340 Viên hàng Mỹ - Mẫu 2020",465000,465000,0,0
TIKI,lam-dep-suc-khoe,107144886,"[CHÍNH HÃNG] Khẩu trang y tế trẻ em quai vải Famapro 5D Mask Kid - Bé Dưới 10 Tuổi [ HỘP",8900,8900,0,0
TIKI,lam-dep-suc-khoe,149425187,"Sữa tắm trắng da cánh hoa hồng Damask Weilaiya Grand Rose Extracts Whitening Shower Gel 450ml",299000,299000,0,0
TIKI,lam-dep-suc-khoe,96271731,"Máy xông tinh dầu siêu âm công nghệ hiện đại  - Chế độ phun mạnh - Khuếch tán tinh dầu trong không gian rộng - Hoạt động liên tục 18h",220000,360000,140000,39
TIKI,lam-dep-suc-khoe,56986002,"Dầu Gội Tăng Cường Dưỡng Chất Giúp Giảm Rụng Tóc Vichy Dercos Energising Shampoo Hairloss 200ml ( Mẫu mới)",311000,415000,104000,25
TIKI,lam-dep-suc-khoe,16344389,"Dầu gội tím khử ánh vàng cho tóc trắng bạch kim Elgon Silver Colorcare Silver shampoo Italy 300ml",320000,320000,0,0
TIKI,lam-dep-suc-khoe,36385805,"Mỡ Trăn N'store Nguyên Chất Triệt Lông Vĩnh Viễn, Giảm Bỏng Da, Dưỡng Da, Ngăn Ngừa Rạn Nứt Da (1 Chai 100ML)",90000,90000,0,0
TIKI,lam-dep-suc-khoe,185096114,"Kem Xoá Mờ Sẹo Actiscar, Mờ Sẹo Lồi, Sẹo Lõm, Sẹo Thâm, Sẹo Rỗ lâu năm 20g",369000,379000,10000,3
TIKI,lam-dep-suc-khoe,135349213,"Túi trườm nóng bụng kinh nguyệt PUHA 350ml, túi chườm ấm bụng cho bạn nữ giảm đau",149000,149000,0,0
TIKI,lam-dep-suc-khoe,694391,"Tinh Dầu Sả Chanh Lorganic Hương Thơm Thiền Tịnh (50ml)",115000,195000,80000,41
TIKI,lam-dep-suc-khoe,186516401,"Gối Chườm Nóng Thảo Mộc Đa Năng Hapaku Giảm Đau Mỏi Cổ Vai Gáy, Lưng Hông, Giúp Ngủ Ngon Hơn, Gối Thảo Mộc Đa Năng - Size Lớn",335000,389000,54000,14
TIKI,lam-dep-suc-khoe,272283366,"Glucosamine 1500mg Kirkland Signature Mỹ Giảm đau nhức xương khớp, tạo chất nhầy bôi trơn khớp, hỗ trợ vận động linh hoạt hiệu quả - OZ Slim Store",685000,1370000,685000,50
TIKI,lam-dep-suc-khoe,131504615,"Dầu gội dược liệu Thái Dương 7 200ml / 480ml / 1100ml",100000,100000,0,0
TIKI,lam-dep-suc-khoe,191319822,"Dầu gội sạch gàu Mochi Medical Nhật Bản. Sạch gàu, sạch ngứa trong 2 tuần",99000,99000,0,0
TIKI,lam-dep-suc-khoe,178302264,"Sáp tạo kiểu tóc giữ nếp lâu vượt trội Restyleable Clay Wax 68g/hộp",74000,82000,8000,10
TIKI,lam-dep-suc-khoe,59078477,"Máy Xông Khí Dung Omron NE-C106",725000,1083000,358000,33
TIKI,lam-dep-suc-khoe,140628020,"Xịt Chống Nắng Bảo Vệ Da Tối Ưu Summer SUN Spray SPF 50 PA++++ 100ml",133000,231000,98000,42
TIKI,lam-dep-suc-khoe,2579159,"Máy đo huyết áp tự động bắp tay Omron JPN600",1895000,2105000,210000,10
TIKI,lam-dep-suc-khoe,257857032,"Đầu Bàn Chải Điện LocknLock ENR546BLK (4pcs) - Màu Đen",116000,252000,136000,54
TIKI,lam-dep-suc-khoe,74853177,"Tinh Dầu Xông Phòng Cam Ngọt Cao Cấp (ORANGE) - Tinh dầu Cam Nguyên Chất Sử Dụng Với Máy Khuếch Tán Tinh Dầu Giúp Thư Giãn Tinh Thần, Khử Mùi, Xua Đuổi Côn Trùng",38000,76000,38000,50
TIKI,lam-dep-suc-khoe,562334,"Xịt Ngăn Mùi Toàn Thân Romano Gentleman 150ml",83000,103000,20000,19
TIKI,lam-dep-suc-khoe,10122631,"Nước Đông Trùng Hạ Thảo Hector Sâm ( Hộp 10 chai ) - Bổ Sung Năng Lượng, Tăng Cường Sinh Lý Và Sinh Lực Cho Người Làm Việc Cường Độ Cao, Chơi Thể Thao",427000,450000,23000,5
TIKI,lam-dep-suc-khoe,28342176,"Nhiệt Kế Điện Tử Đo Tai, Trán Beurer Ft65 + Tặng Đèn Soi Tai",749000,1108000,359000,32
TIKI,lam-dep-suc-khoe,52853259,"TPBVSK hỗ trợ Tăng Chiều Cao NuBest Tall Cho Độ Tuổi Từ 5-20",926500,1450000,523500,36
TIKI,lam-dep-suc-khoe,56918293,"Son Dưỡng Dầu Dừa Bến Tre Cocoon ",32000,32000,0,0
TIKI,lam-dep-suc-khoe,104558007,"Dầu Dừa Tinh Khiết Vietcoco Dưỡng Mi 10ml",28000,28000,0,0
TIKI,lam-dep-suc-khoe,15863570,"Dầu gội kích thích mọc tóc Obsidian Orzen Loss Control shampoo 320ml",287000,287000,0,0
TIKI,lam-dep-suc-khoe,76217766,"Xịt mọc tóc nhanh tinh dầu vỏ bưởi Tabaha 120ml dành cho Nam giới bị rụng tóc, tóc thưa",80000,80000,0,0
TIKI,lam-dep-suc-khoe,23591172,"KEM ĐÁNH RĂNG SENSIKIN NGĂN NGỪA Ê BUỐT 75ML",139000,139000,0,0
TIKI,lam-dep-suc-khoe,104288718,"Viên uống trắng da DHC Nhật Bản dưỡng ẩm và làm mịn da thực phẩm chức năng 30 ngày JN-DHC-ADL30",199000,274890,75890,28
TIKI,lam-dep-suc-khoe,40888300,"Dầu Gội Cặp Weilaiya Thảo Dược Mọc Tóc Hỗ Trợ Trị Gàu Dưỡng Tóc, Đen Tóc Cho Tóc Nhuộm Tinh Chất Gừng Cao Cấp Chiết Xuất 100% Từ Thiên Nhiên Không Chứa Sunfat Tạo Bọt (Gội: 400ml- Xả: 250ml)- Sản Phẩm Chính Hãng",510000,510000,0,0
TIKI,lam-dep-suc-khoe,76169379,"[HỘP - FAMAPRO 5D BABY] - Khẩu trang y tế trẻ em kháng khuẩn 3 lớp Famapro 5D Baby (10 cái/ hộp) - COMBO 3 HỘP",26500,26500,0,0
TIKI,lam-dep-suc-khoe,907532,"Bộ sản phẩm rửa mũi tiện dụng Rohto NoseWash (1 bình vệ sinh mũi Easy Shower + 1 chai dung dịch 400ml)",77900,95000,17100,18
TIKI,lam-dep-suc-khoe,176098213,"Sữa rửa mặt tinh chất TRÀM TRÀ tự nhiên cho da mụn giảm nhờn trắng da 100ml",58000,109000,51000,47
TIKI,lam-dep-suc-khoe,158018228,"Tinh Dầu Hoa Nhài TIDAMO 50ML Nhập Khẩu, Có Kiểm Nghiệm, Hương Thơm Dịu Nhẹ Quý Phái - Tinh Dầu Hoa Lài (Jasmine) Xông Thơm Phòng, Thư Giãn và Tốt Cho Sức Khỏe",88000,256000,168000,66
TIKI,lam-dep-suc-khoe,119706866,"Sữa tắm dưỡng ẩm cho viêm da cơ địa Cetaphil Pro AD Derma Wash 295ml",480000,480000,0,0
TIKI,lam-dep-suc-khoe,139947502,"[COMBO 3 HỘP - FAMAPRO 4D KIDS] - Khẩu trang trẻ em kháng khuẩn cao cấp Famapro 4D KIDS tiêu chuẩn KF94 (10 cái/ hộp)",30000,45000,15000,33
TIKI,lam-dep-suc-khoe,71512916,"Dầu gội thảo dược gừng dừa Cocayhoala hỗ trợ trị gàu, hết ngứa, dung tích 440g-95% thành phần từ gừng tươi hữu cơ còn nguyên xơ gừng, hỗ trợ trị rụng tóc, kích thích mọc tóc vượt trội, an toàn cho mẹ bầu mẹ sau sinh",349000,490000,141000,29
TIKI,lam-dep-suc-khoe,20832207,"Can Nước rửa tay khử mùi Mr.Fresh 5L Hương Dâu",162000,162000,0,0
TIKI,lam-dep-suc-khoe,105631257,"Bộ 3 Bao Cao Su Durex Sensual Strawberry - Hộp 3 chiếc",119000,153000,34000,22
TIKI,lam-dep-suc-khoe,3598571,"Bộ 10 gói mặt nạ dưỡng ẩm da chiết xuất nha đam 3W Clinic Fresh Aloe Mask Sheet 23ml X 10",50000,50000,0,0
TIKI,lam-dep-suc-khoe,185881834,"Serum Mụn Oriskin GenZ White Acne Loại Sạch Mụn Viêm, Trứng Cá Và Mụn Đầu Đen 15ml, Tặng Kèm Vòng Tay May Mắn",249000,249000,0,0
TIKI,lam-dep-suc-khoe,409945,"Thực Phẩm Chức Năng Viên Uống Sữa Ong Chúa Costar Royal Jelly 1450mg - Hộp 365 Viên",490000,490000,0,0
TIKI,lam-dep-suc-khoe,11197614,"Tinh chất làm mềm, mượt và sáng da body 10% AHA - Paula's Choice Skin Revealing Body Lotion 10% AHA",835000,950000,115000,12
TIKI,lam-dep-suc-khoe,174222507,"Đệm, Ghế Massage Cao Cấp KingTech KC-500s - Máy Mát Xa Lưng Chế Độ 3D Chuyên Sâu, Kết Hợp Tính Năng Nhiệt Hồng Ngoại - Hàng Chính Hãng",1800000,3200000,1400000,44
TIKI,lam-dep-suc-khoe,114778819,"[Chính Hãng] Bộ Bàn Chải Đánh Răng Điện Zenyum Sonic & 3 Đầu Thay Thế - Công Nghệ Singapore - Màu Đen",1459000,1849000,390000,21
TIKI,lam-dep-suc-khoe,158856083," Đệm xông chườm ngải cứu đa năng giúp giảm đau mỏi (Tặng 3 điếu ngải)",299500,299500,0,0
TIKI,lam-dep-suc-khoe,79411382,"Kem chống nắng Skin Aqua cho da nhạy cảm dạng gel dùng hàng ngày Sunplay Skin Aqua Mild Care Gel SPF50+ PA+++ 25g",102000,125000,23000,18
TIKI,lam-dep-suc-khoe,147967099,"DATE XA Sữa Tắm Double Rich hương hoa tự nhiên Hàn Quốc - 800g - Hương Hoa Iris Dreamy Romance",139000,139000,0,0
TIKI,lam-dep-suc-khoe,58676878,"Combo 2 Lăn khử mùi trắng da Enchanteur Charming 50ml/ Chai",139000,184000,45000,24
TIKI,lam-dep-suc-khoe,37975485,"Tinh Chất cho da nhạy cảm Skin1004 Madagascar Centella Asiatica Ampoule 100ml",309000,500000,191000,38
TIKI,lam-dep-suc-khoe,37432011,"Mặt Nạ Đất Sét Kiehl’s Rare Earth Pore Cleansing Masque 125ml",720000,720000,0,0
TIKI,lam-dep-suc-khoe,123929183,"[Đo nhanh , Chính Xác Trong 1 Giây] Nhiệt kế hồng ngoại đo trán Microlife FR1MF1 - Thương Hiệu Thụy Sĩ ",784000,784000,0,0
TIKI,lam-dep-suc-khoe,125582323,"Dầu Gội OGX Chiết Xuất Hoa Anh Đào/ Bạch Đàn Bạc Hà - Dung Tích 385ml",295000,295000,0,0
TIKI,lam-dep-suc-khoe,71989770,"Sữa rửa mặt dạng Gel Decumar Clean Advanced 50gr hoàn toàn mới kiểm soát nhờn mụn",77000,77000,0,0
TIKI,lam-dep-suc-khoe,4424813,"Thực Phẩm Chức Năng Tảo Xoắn Spirulina Nhật Bản Hộp 2200 Viên",332382,332382,0,0
TIKI,lam-dep-suc-khoe,172800186,"Máy Massage Cổ SKG G7-PRO",2968000,4590000,1622000,35
TIKI,lam-dep-suc-khoe,122225120,"DẦU GỘI PASIORI TM COLLAGEN & BIOTIN TRẮNG PHỤC HỒI, MỀM MƯỢT NGĂN GÃY RỤNG TÓC ITALY 1000ML [MẪU MỚI]",189000,195000,6000,3
TIKI,lam-dep-suc-khoe,16441917,"Son Gạo Hương Dâu ",81000,90000,9000,10
TIKI,lam-dep-suc-khoe,37405722,"Cà Phê Xanh Hỗ Trợ Giảm Cân Thiên Nhiên Việt (Hộp 10 Gói)",130000,130000,0,0
TIKI,lam-dep-suc-khoe,42785265,"Tinh Chất Dưỡng The Ordinary Hyaluronic Acid 2 % + B5 (60ml)",589000,589000,0,0
TIKI,lam-dep-suc-khoe,116244839,"Máy Massage Cao Cấp KINGTECH ST-502B - Giúp Tuần Hoàn, Giảm Đau Mỏi - Mát xa Thư Giãn Bàn Và Bắp Chân Tích Hợp Nhiệt Kèm Điều Khiển Cầm Tay - Quà Tặng Ý Nghĩa Cho Người Thân",2107000,3350000,1243000,37
TIKI,lam-dep-suc-khoe,12478857,"Kem Làm Mềm Da, Dịu Kích Ứng A-Derma Cho Da Khô Đến Rất Khô Exomega Control Emollient Cream (50ml)",199000,317000,118000,37
TIKI,lam-dep-suc-khoe,35933597,"Sữa Rửa Mặt Làm Sạch Và Giảm Mụn Acne-Aid Liquid Cleanser 100ml",148000,175000,27000,15
TIKI,lam-dep-suc-khoe,102108970,"Viên Nghệ Mật Ong Cao Cấp HNT 300g – Viên Tinh Bột Nghệ Mật Ong Tự Nhiên – 100% Nguyên Liệu Tụ Nhiên – Hoàn Toàn An Toàn Cho Sức Khỏe -  Sản Phẩm Chính Hãng – Uy Tín",169000,169000,0,0
TIKI,lam-dep-suc-khoe,12219979,"Tảo Xoắn Spirulina nội địa Nhật Bản (2200 viên)",359000,359000,0,0
TIKI,lam-dep-suc-khoe,148812247,"Serum INOD Huyền Phi Khử mùi hôi nách, hôi chân Tặng Kèm Gội (Xả) Mini Weilaiya Ngẫu Nhiên",191000,191000,0,0
TIKI,lam-dep-suc-khoe,12242241," Trà ổi giảm cân Orihiro Nhật Bản (60 gói) tặng gói trà sữa hoặc cafe ngẫu nhiên",127000,146160,19160,13
TIKI,lam-dep-suc-khoe,55086997,"Serum Dưỡng Mi Dài Dày Khỏe FEG Eyelash Enhancer 3ml",219000,219000,0,0
TIKI,lam-dep-suc-khoe,74763869,"Bao cao su Ritex Longtime - kéo dài thời gian bằng vòng đôi cao su, hộp 3 chiếc",80000,80000,0,0
TIKI,lam-dep-suc-khoe,46778967,"Bao Cao Su Okamoto 0.01 Zero Zero One Siêu Mỏng, Truyền Nhiệt Tốt, Cực Kì Dẽo Dai Hộp 4 Chiếc",159000,159000,0,0
TIKI,lam-dep-suc-khoe,442980,"Dầu Gội Dove Phục Hồi Hư Tổn (900g) - 21062569",179000,179000,0,0
TIKI,lam-dep-suc-khoe,184444737,"Sữa rửa mặt dịu nhẹ Pharmacity Sensitive Skin Cleanser (500ml)",262000,262000,0,0
TIKI,lam-dep-suc-khoe,126945372,"Bao Cao Su LifeStyles Classic Thiết Kế Mỏng, Ôm sát vừa vặn, Nhiều Gel Bôi Trơn - Hộp 3 bao",27840,35000,7160,20
TIKI,lam-dep-suc-khoe,72556249,"Viên uống DHC Bổ Sung Vitamin E Nhật Bản 20 Ngày",99000,110000,11000,10
TIKI,lam-dep-suc-khoe,270988813,"Vitamin C Puritan's Pride with Bioflavonoids & Rose Hips -1000mg tăng sức đề kháng, làm đẹp da - QuaTangMe Extaste",355000,710000,355000,50
TIKI,lam-dep-suc-khoe,172111067,"DẦU GỘI TÍM ELGON COLOR CARE SILVER SHAMPOO KHỬ ÁNH VÀNG CHO TÓC BẠCH KIM",315000,330000,15000,5
TIKI,lam-dep-suc-khoe,117927020,"1 Bộ Kit test nhanh COVID Humasis Covid-19 Ag Test CHÍNH HÃNG",35000,35000,0,0
TIKI,lam-dep-suc-khoe,553383,"Kem Tẩy Lông Chiết Xuất Bơ Cleo Dành Cho Da Nhạy Cảm 50g, an toàn, không đau và đạt hiệu quả nhanh chóng",73000,100000,27000,27
TIKI,lam-dep-suc-khoe,284609,"Thuốc nhuộm dưỡng tóc phủ bạc thảo dược Bigen Speedy Thương hiệu Nhật Bản 80ml dạng kem - BSCC",215000,235000,20000,9
TIKI,lam-dep-suc-khoe,105515020,"Gel Bí Đao Rửa Mặt Cocoon 310ml",236000,295000,59000,20
TIKI,lam-dep-suc-khoe,24457200,"Xà Bông Cục Lifebuoy 90g Matcha & Khổ Qua Từ Thiên Nhiên Giúp Bảo Vệ Khỏi 99.9% Vi Khuẩn Gây Bệnh",17000,17000,0,0
TIKI,lam-dep-suc-khoe,4485287,"Vớ/tất y khoa gối hỗ trợ điều trị suy giãn tĩnh mạch chân JOBST Relief chuẩn áp lực 20-30mmHg",640000,700000,60000,9
TIKI,lam-dep-suc-khoe,92159205,"Combo Bao cao su Durex Pleasuremax Hộp 12 Bao và hộp 3 bao",251000,335000,84000,25
TIKI,lam-dep-suc-khoe,58452001,"Viên Sủi FOFLUU Giảm Cảm Lạnh Tăng Sức Đề Kháng Giảm Các Triệu Chứng Ho Sốt Hắt Xì ( Hộp 20 viên sủi vị trái cây )",99000,141000,42000,30
TIKI,lam-dep-suc-khoe,195899280,"Bao cao su nam Feelex 2 in 1 gân gai hương dâu nhiều gel bôi trơn",119000,119000,0,0
TIKI,lam-dep-suc-khoe,127152384,"Kem đánh răng trắng răng Eucryl Anh Quốc Giúp răng trắng sáng bền lâu , sạch bóng và thơm mát cả nhà - OZ Slim Store - 62g/tuýt",177000,354000,177000,50
TIKI,lam-dep-suc-khoe,72917546,"Combo 2 chai Eucerin Xịt Dưỡng Ẩm Cho Da Nhạy Cảm Hyaluron Mist Spray 150ml",376000,538000,162000,30
TIKI,lam-dep-suc-khoe,191726092,"Sữa tắm Bioré Dưỡng Ẩm Đủ Hương 530g",102000,102000,0,0
TIKI,lam-dep-suc-khoe,175097284,"Kem đánh răng Sensodyne Rapid Action Whitening 100g",98000,100000,2000,2
TIKI,lam-dep-suc-khoe,96709378,"Viên nang mềm Nano curcumin Cumargold new 150 mg cùng gừng chuẩn hóa hỗ trợ cải thiển trào ngược, viêm loét dạ dày tá tràng",275000,275000,0,0
TIKI,lam-dep-suc-khoe,171873291,"Bộ đôi sản phẩm Siêu Nghệ Decumar Advanced sạch các loại mụn và sáng da sau 2 tuần sử dụng",182000,182000,0,0
TIKI,lam-dep-suc-khoe,8094477,"Túi Chườm Lạnh Greetmed",48000,48000,0,0
TIKI,lam-dep-suc-khoe,71909258,"Nước Hoa Hồng Cho Da Mụn La Roche Posay Effaclar Astringent Lotion 200ml",341000,455000,114000,25
TIKI,lam-dep-suc-khoe,107974748,"Glucosamine 1500mg Kirkland Signature Mỹ Giảm đau nhức xương khớp và Hỗ trợ sự vận động linh hoạt hiệu quả - OZ Slim Store 375 Viên/Hộp",637000,1370000,733000,54
TIKI,lam-dep-suc-khoe,52639277,"[Combo 3 Tặng 1 Cho Độ Tuổi Từ 5-20] TPBVSK hỗ trợ Tăng Chiều Cao NuBest Tall",2616000,4350000,1734000,40
TIKI,lam-dep-suc-khoe,117928045,"Combo 2 Kit Test Covid 19 Tại Nhà Humasis Hàn Quốc - Hàng Nhập Khẩu chính ngạch",70000,70000,0,0
TIKI,lam-dep-suc-khoe,7727627,"Đắp mặt nạ lô hội DABO Hàn quốc trắng da hỗ trợ điều trị mụn",45000,45000,0,0
TIKI,lam-dep-suc-khoe,76656992,"Tinh dầu ngủ ngon Vemoda Sleep Easy. Tinh dầu xông phòng giúp thư giãn, làm thơm phòng",239000,239000,0,0
TIKI,lam-dep-suc-khoe,74551654,"Cho máy Philips Sonicare, Bộ 4 đầu bàn chải đánh răng điện HX-6014, dòng máy HX3, HX6, HX7, HX8, HX9, R, FlexCare +, FlexCare, HealthyWhite, HydroClean, EasyClean, DiamondClean-Phá tan mảng bám, cho răng sáng bóng",125000,125000,0,0
TIKI,lam-dep-suc-khoe,70441032,"Dao cạo râu 2 lưỡi Tiger We're Men (24 cây/ vỉ)- xài 1 lần tiện lợi mang lên máy bay đi du lịch được, 2 lưỡi dao sắt bén, không gỉ sét",99000,99000,0,0
TIKI,lam-dep-suc-khoe,73921463,"Dầu gội tím khử vàng chăm sóc và làm sáng màu tóc RRline Therapy Sliver Shampoo 350ml",170000,178698,8698,5
TIKI,lam-dep-suc-khoe,167129299,"Máy đo huyết áp điện tử bắp tay Sinocare BA-801 Đức + Tặng bộ đổi nguồn ( Adapter )",320000,320000,0,0
TIKI,lam-dep-suc-khoe,173758897,"Dầu Gội Vichy Giảm Tình Trạng Bong Tróc Cho Da Đầu Gàu Và Ngứa Dercos PSOlution Keratoreducing Treatment Shampoo 200ml",312000,390000,78000,20
TIKI,lam-dep-suc-khoe,271474715,"Bổ gan Puritan's Pride Milk Thistle Extract 1000mg Mỹ hỗ trợ giúp gan khỏe hơn, tăng sức đề kháng, hỗ trợ giải độc gan, giảm mụn - Massel Official",276000,562000,286000,51
TIKI,lam-dep-suc-khoe,105738501,"Tinh Dầu Sả Chanh Nguyên Chất TIDAMO, Tự Chọn Dung Tích | Chính Hãng, Có Kiểm Nghiệm | Tinh Dầu Xông Phòng Cao Cấp 100% Thiên Nhiên, An Toàn Cho Trẻ, Khử Mùi, Kháng Khuẩn, Đuổi Muỗi, Giải Cảm",5950,14000,8050,58
TIKI,lam-dep-suc-khoe,51544486,"Son Ngọc Cỏ Mềm",267000,290000,23000,8
TIKI,lam-dep-suc-khoe,133878592,"Combo 2 Lít Mật Ong Hoa Cà Phê Nguyên Chất DTFood",130000,145000,15000,10
TIKI,lam-dep-suc-khoe,172242077,"Tinh dầu thiên nhiên LORITA - Tinh dầu Việt Nam nguyên chất 100% nhiều mùi hương, dung tích - Mùi thơm tự nhiên dễ chịu, giúp tỉnh táo, thoải mái, giảm đau nhức",31000,45000,14000,31
TIKI,lam-dep-suc-khoe,159501937,"Tẩy tế bào chết da mặt Truesky Orange Peeling Gel dạng gel chiết xuất cam 50g",65000,100000,35000,35
TIKI,lam-dep-suc-khoe,94118366,"Combo 6 Băng vệ sinh thảo dược Glamiss Cool BVS ban ngày 24cm siêu khô thoáng cả ngày dài",127000,150000,23000,15
TIKI,lam-dep-suc-khoe,13452390,"Dầu Gội Dược Liệu Hỗ Trợ Trị Chấy Aladin (30g)",53000,60000,7000,12
TIKI,lam-dep-suc-khoe,22493668," La Roche-Posay Tinh Chất Phục Hồi Giúp Da Săn Chắc Hyalu B5 Serum 30ml",779000,795000,16000,2
TIKI,lam-dep-suc-khoe,58811954,"Nhiệt Kế Điện Tử OMRON MC-343F - Đo Nhiệt Độ Ở Miệng và Nách",196000,198000,2000,1
TIKI,lam-dep-suc-khoe,57666220,"Kem Phục Hồi Da, Lành Sẹo, Chống Nhiễm Khuẩn Avène Cicalfate Cream 15ml",174000,249000,75000,30
TIKI,lam-dep-suc-khoe,135029881,"Tinh chất dưỡng ẩm Neutrogena Hydro Boost Activating Essence Lotion 150ml",480000,480000,0,0
TIKI,lam-dep-suc-khoe,247998045,"Sữa tắm hương hoa sen Tesori D’ Oriente Lotus Flower 500ml + Móc khóa",219000,219000,0,0
TIKI,lam-dep-suc-khoe,172120332,"Thuốc nhỏ mắt Refresh Tears làm dịu mắt, giảm kích ứng và khô mắt (15ml)",66000,66000,0,0
TIKI,lam-dep-suc-khoe,10976986,"Dung dịch vệ sinh Saforelle Gentle Cleansing Care (250ml)",211000,235000,24000,10
TIKI,lam-dep-suc-khoe,15830160,"Máy Tỉa Lông Mũi Xiaomi HN1 - Hàng Nhập Khẩu",254000,262500,8500,3
TIKI,lam-dep-suc-khoe,58654956,"Mật ong nguyên chất Duy Anh Bee 700g",131000,131000,0,0
TIKI,lam-dep-suc-khoe,191365681,"Combo 2 Sữa dưỡng thể chống nắng và dưỡng sáng SPF24 PA++VASELINE Healthy Bright Sun + Pollution Protection 350ML/chai",300000,300000,0,0
TIKI,lam-dep-suc-khoe,43162128,"Nước hoa nữ cao cấp chính hãng Jile Daisy 50ml (Chance) với hương thơm nồng nàng, quý phái",325000,480000,155000,32
TIKI,lam-dep-suc-khoe,176789242,"Máy Massage Mắt Cao Cấp KLC công nghệ nhiệt hồng ngoại, phát nhạc MP3, giúp dễ ngủ giảm stress",3568000,3568000,0,0
TIKI,lam-dep-suc-khoe,55267101,"Bio - Oil Giảm rạn da và làm mờ sẹo 25ml",92000,117000,25000,21
TIKI,lam-dep-suc-khoe,94995460,"Dưỡng Kích Màu Môi GABRY CHERRY BLOSSOM ESSENCE  ( Dưỡng Sau Xăm Môi)",65000,95000,30000,32
TIKI,lam-dep-suc-khoe,8142293,"Kềm Cắt Da Thép Chuyên Dụng Kềm Nghĩa D-205",59800,65000,5200,8
TIKI,lam-dep-suc-khoe,8142283,"Kềm Cắt Da Thép Chuyên Dụng Kềm Nghĩa D-555",100000,100000,0,0
TIKI,lam-dep-suc-khoe,119285508,"Gel Bôi Mụn Viên,Mụn Ẩn KLENZIT C Tuýp 15g",165000,185000,20000,11
TIKI,lam-dep-suc-khoe,36779625,"Kem Mờ Sẹo Gentacin của Nhật 10g - Hỗ trợ trị sẹo lồi sẹo lõm",49000,49000,0,0
TIKI,lam-dep-suc-khoe,132366446,"SPECIAL COMBO gội xả bưởi không sulfate giảm gãy rụng tóc Cocoon (tặng 1 nước dưỡng tóc tinh dầu bưởi Cocoon 140ml)",460000,460000,0,0
TIKI,lam-dep-suc-khoe,37141416,"Viên Uống Phòng Ngừa Đột Quỵ, Bổ Não Nattokinase 3000FU Natto Ichou Genki Fami Nhật Bản",711000,830000,119000,14
TIKI,lam-dep-suc-khoe,118520833,"Bàn chải đánh răng điện Fairywill P11- phiên bản nâng cấp với trục truyền lực bằng thép, 8 đầu bàn chải đi kèm",595000,1200000,605000,50
TIKI,lam-dep-suc-khoe,57377257,"Mật ong nguyên chất Beemo, mật ong hoa cà phê từ thiên nhiên - Làm đẹp,hỗ trợ giảm cân, hỗ trợ điều trị ho, gia vị",65000,82000,17000,21
TIKI,lam-dep-suc-khoe,81897334,"Kem dưỡng giúp sáng da, mờ thâm nám ban đêm Vichy LIFTACTIV COLLAGEN SPECIALIST NIGHT",873000,1165000,292000,25
TIKI,lam-dep-suc-khoe,55893367,"Bigsize - Bộ tắm trắng toàn thân Truesky gồm 1 kem ủ trắng toàn thân 200g và 1 kem dưỡng trắng toàn thân 200g",225000,450000,225000,50
TIKI,lam-dep-suc-khoe,70383861,"Combo 4 bịch dao cạo râu 3 lưỡi Tiger We're Men (5 cây/ bịch) - xài 1 lần tiện lợi mang lên máy bay đi du lịch được, 3 lưỡi dao kép  sắt bén, không gỉ sét",99000,99000,0,0
TIKI,lam-dep-suc-khoe,100158366,"Kem Chống Nắng Thiên Nhiên Thấm Nhanh An Toàn Cho Da Hây Hây SPF 40, PA ++ Cỏ Mềm 60g",234000,260000,26000,10
TIKI,lam-dep-suc-khoe,162978700,"Viên bổ sung vitamin tổng hợp và khoáng chất Berocca Performance (Tuýp 10 viên)",75000,75000,0,0
TIKI,lam-dep-suc-khoe,11861302,"Viên Uống Hỗ Trợ Điều Trị Bệnh Suy Giãn Tĩnh Mạch Vascovein (Hộp 30 viên), Chiết Xuất Từ Hạt Dẻ Ngựa - Nguyên Liệu Nhập Khẩu Châu Âu ",208000,215000,7000,3
TIKI,lam-dep-suc-khoe,94118478,"Combo 6 Băng vệ sinh ban đêm Doctor Care tinh chất thảo dược 33.8cm siêu thấm hút",92000,108000,16000,15
TIKI,lam-dep-suc-khoe,85779614,"Viên uống hỗ trợ giấc ngủ Nature's Bounty Super Strength Melatonin 5mg 60 viên (Cam Kết Chính Hãng)",165000,175000,10000,6
TIKI,lam-dep-suc-khoe,77150777,"Tinh Dầu Xông Phòng VỎ BƯỞI Nguyên Chất Nhập Khẩu - Tinh dầu Bưởi TIDAMO Giúp Bảo Vệ Sức Khỏe, Kháng Khuẩn,Thư Giãn Tinh Thần và Khử Mùi Hiệu Quả",26000,88000,62000,70
TIKI,lam-dep-suc-khoe,84225555,"Lăn khử mùi cho nách - chân, mồ hôi tay, thâm nách Kwangdong Sweatclor 30ml",139000,145000,6000,4
TIKI,lam-dep-suc-khoe,568256,"Lăn Nách Dành Cho Nữ Aquaselin Insensitive Women Antiperspirant For Increased Perspiration 50ml - 3934",288900,361125,72225,20
TIKI,lam-dep-suc-khoe,72711795,"Kem dưỡng trắng dạng gel Hada Labo Koi-Gokujyun Whitening Perfect Gel 100g",400000,405000,5000,1
TIKI,lam-dep-suc-khoe,68427702,"Kem Nhuộm Dưỡng Tóc Phủ Bạc L'Oreal Paris Excellence Crème 172ml",190902,190902,0,0
TIKI,lam-dep-suc-khoe,71355851,"Bộ dầu gội thảo dược gừng dừa Cocayhoala hỗ trợ trị gàu, giảm nấm ngứa, dung tích 440g/chai- 95% thành phần từ gừng tươi hữu cơ còn nguyên xơ gừng, hỗ trợ trị rụng tóc, kích thích mọc tóc vượt trội",490000,645000,155000,24
TIKI,lam-dep-suc-khoe,10579630,"Cao Gừng Tan Mỡ Thiên Nhiên Việt  (250g) Tặng Kèm Thước Dây An Nhiên",233000,233000,0,0
TIKI,lam-dep-suc-khoe,131504643,"Dầu gội dược liệu Thái Dương 3 dung tích 200ml/480ml",60000,60000,0,0
TIKI,lam-dep-suc-khoe,68267208,"Combo 2 Xịt toàn thân Romano ngăn mồ hôi và mùi cơ thể 150ml x 2 Gentleman",159000,206000,47000,23
TIKI,lam-dep-suc-khoe,69174556,"Đầu Bàn Chải Điện Portable Electric Toothbrush Heads ENR536WHT (2pcs) - Màu Trắng",42900,84000,41100,49
TIKI,lam-dep-suc-khoe,7967603,"Dầu Gội Head & Shoulders Ngăn Rụng Tóc (625ml)",149000,149000,0,0
TIKI,lam-dep-suc-khoe,162116326,"Máy tăm nước cầm tay FAIRYWILL F30 siêu phẩm mới ra Dung tích 300ml Sạc nhanh 4 tiếng Thời gian sử dụng lên tới 70 ngày Tặng kèm 6 đầu tăm - Hàng Chính Hãng",863000,899000,36000,4
TIKI,lam-dep-suc-khoe,10678629,"Kem Chống Nắng Da Dầu Bioderma Photoderm AKN Mat SPF 30 (40ml)",345000,485000,140000,29
TIKI,lam-dep-suc-khoe,155099959,"Serum Mờ Thâm Trắng Da Kiềm Dầu Se Khít Lỗ Chân Lông  Oriskin O’vita Light Serum 30ml",175000,175000,0,0
TIKI,lam-dep-suc-khoe,184518312,"Collagen HeiHwa Dạng nước 1.500mg Collagen Tripeptide nhập khẩu từ Hàn Quốc, hấp thu nhanh giúp đẹp - Hộp 5 chai 30ML",450000,450000,0,0
TIKI,lam-dep-suc-khoe,72133478,"Viên uống DHC Bổ sung Vitamin C Nhật Bản 30 ngày (60 viên/ gói)",85000,105000,20000,19
TIKI,lam-dep-suc-khoe,114778826,"[Chính Hãng] Bộ Bàn Chải Đánh Răng Điện ZenyumSonic T11 & 3 Đầu Thay Thế TB14A - Hồng San Hô - Công Nghệ Singapore",1459000,1849000,390000,21
TIKI,lam-dep-suc-khoe,54415583,"Bột lá nhuộm tóc thiên nhiên OGATIC Màu Nâu- 50g ( Bao Bì Mới)",96000,150000,54000,36
TIKI,lam-dep-suc-khoe,51398122,"Serum Trắng Da Mờ Nám Tàn Nhang Chống Lão Hóa Oribe - Vi Tảo Lục và Tinh Dầu Thông Trắng Nhật Bản (Dạng Viên, Hộp 36 Viên)",313000,380000,67000,18
TIKI,lam-dep-suc-khoe,260804538,"Khẩu Trang Y Tế 4 Lớp Tenamyd Chính Hãng",27200,34000,6800,20
TIKI,lam-dep-suc-khoe,3818443,"Son dưỡng ẩm không mùi, hỗ trợ trị thâm, lẻ môi DHC Nhật Bản",169000,199000,30000,15
TIKI,lam-dep-suc-khoe,190645318,"Sữa Rửa Mặt Dịu Nhẹ Cho Da Khô CeraVe Hydrating Cleanser 88ml",136000,165000,29000,18
TIKI,lam-dep-suc-khoe,20363893,"CÂN SỨC KHỎE NHƠN HÒA CHÍNH HÃNG( ĐƯỢC CHỌN MÀU)",410000,410000,0,0
TIKI,lam-dep-suc-khoe,76406994,"Combo 2 Tinh Dầu Sả Chanh 50ML + Tinh Dầu Cam Ngọt 50ML (Lemongrass + Orange) - Tinh Dầu TIDAMO Cao Cấp Nhập Khẩu Giúp Thư Giãn, Đuổi Muỗi Và Thơm Phòng",148000,396000,248000,63
TIKI,lam-dep-suc-khoe,41221033,"Bộ 5 hộp bao cao su Storm hương dâu | Hộp 10 cái",87400,95000,7600,8
TIKI,lam-dep-suc-khoe,192305641,"Đầu tăm nước thay thế và phụ kiện dây sạc cho máy tăm nước h2ofloss",11000,25000,14000,56
TIKI,lam-dep-suc-khoe,174440849,"Viên giải rượu Nam Dược (VIÊN BYESAY) tăng cường chức năng giải độc bảo vệ gan 5 hộp x 6 viên",115000,115000,0,0
TIKI,lam-dep-suc-khoe,3950327,"Kem Chống Nắng Kiểm Soát Nhờn cho Da Dầu Eucerin Sun Gel-Creme Oil Control Dry Touch SPF 50 (50 ml)",549000,549000,0,0
TIKI,lam-dep-suc-khoe,129438174,"Viên Hồng Sâm Nhung Linh Chi Đông Trùng Hạ Thảo 120 Viên",819000,880000,61000,7
TIKI,lam-dep-suc-khoe,184597199,"Gối massage đa năng CTFAST 016: Máy mát xa toàn thân nhiệt hồng ngoại 3D mô phỏng bàn tay con người - Chuyên sâu giảm đau cổ, vai, gáy, lưng..Dễ dàng sử dụng tại nhà, văn phòng, ô tô - Quà tặng ý nghĩa cho người thân",699000,950000,251000,26
TIKI,lam-dep-suc-khoe,545471,"Combo 2 Sữa Rửa Mặt Chiết Xuất Từ Trà Xanh 3W Clinic Green Tea Foam Cleansing (100ml)",45500,89000,43500,49
TIKI,lam-dep-suc-khoe,68491719,"Dầu xả ngăn rụng tóc, dưỡng tóc 50 Megumi Hair Fall Control Conditioner",138000,170000,32000,19
TIKI,lam-dep-suc-khoe,24786879,"Tinh Chất Tẩy Da Chết Và Làm Sáng Da The Ordinary Lactic Acid 5% + HA 30ml",319000,319000,0,0
TIKI,lam-dep-suc-khoe,195574353,"Bao cao su Feelex Invisible siêu mỏng, nhiều gel bôi trơn, hương thơm nhẹ",47000,49000,2000,4
TIKI,lam-dep-suc-khoe,19735579,"Viên uống hỗ trợ ngủ ngon, giảm căng thẳng, mệt mỏi Doppelherz Aktiv Anti Stress (Hộp 30 viên)",329000,329000,0,0
TIKI,lam-dep-suc-khoe,20590777,"Tăm Bông Diva Dạng Hộp Tròn - 200 Que",19900,19900,0,0
TIKI,lam-dep-suc-khoe,131534020,"Túi sưởi chườm nóng lạnh ê buốt đau nhức chân tay",89000,89000,0,0
TIKI,lam-dep-suc-khoe,49173310,"Dầu hấp ủ tóc Collagen BOSECHER Bamboo Charcoal Treatment (Phủ lụa siêu mượt) 500ml",182000,188000,6000,3
TIKI,lam-dep-suc-khoe,180379990,"Thuốc nhỏ mắt V.Rohto Cool làm dịu mắt, giúp giảm mỏi mắt (12ml)",54000,54000,0,0
TIKI,lam-dep-suc-khoe,16375148,"[Mua 2 tặng 1] Dụng cụ cạo sạch lưỡi PIERROT Tây Ban Nha",45000,53000,8000,15
TIKI,lam-dep-suc-khoe,36014642,"Tinh dầu Unique Serum dưỡng tóc khô hư tổn 125ml - Chính hãng",114000,114000,0,0
TIKI,lam-dep-suc-khoe,118124183,"Viên uống OTIV bổ não (30 viên)",330000,330000,0,0
TIKI,lam-dep-suc-khoe,1581117,"Bộ Giác Hơi Không Dùng Lửa Duy Thành YGH05 (6 ống giác)",186000,186000,0,0
TIKI,lam-dep-suc-khoe,171564938,"Kem chống nắng vật lý Skin Aqua kiềm dầu, dạng sữa dùng hàng ngày Sunplay Skin Aqua Mineral Defense Oil Clear Milk SPF50+ PA++++ 25g",105000,139000,34000,24
TIKI,lam-dep-suc-khoe,104468931,"[Combo 5 HỘP - PERFETTA ULTRA] - Khẩu Trang Y Tế Chất Lượng Cao, Kháng Khuẩn, Chống Bụi Mịn PM 2.5, Màu Trắng, 4 Lớp, Bảo Vệ Tối Ưu, Đóng Gói Từng Cái - (35 cái/ hộp)",225000,225000,0,0
TIKI,lam-dep-suc-khoe,191365631,"Combo 2 Sữa dưỡng thể dưỡng sáng da tức thì VASELINE Healthy Bright Instant Radiance 350ML/chai",195000,300000,105000,35
TIKI,lam-dep-suc-khoe,204850410,"Bao cao su Feel 4 in 1 - Kéo dài thời gian hộp 12 cái",70000,70000,0,0
TIKI,lam-dep-suc-khoe,136126144,"Son Kem Nhung Lì Mượt Không Silicone Cỏ Mềm Màu Đẹp An Toàn Từ Thiên Nhiên 3ml",144000,160000,16000,10
TIKI,lam-dep-suc-khoe,2464245,"Bàn chải chà gót chân bằng đá san hô nội địa Nhật Bản",44000,45000,1000,2
TIKI,lam-dep-suc-khoe,190323087,"Thảo mộc hỗ trợ giảm cân Slimming care x3 hiệu quả sau 1 liệu trình sử dụng",528000,671000,143000,21
TIKI,lam-dep-suc-khoe,89817284,"Bộ 2 chai Dung Dịch Vệ Sinh Phụ nữ Lactacyd Soft & Silky Dưỡng Ẩm 250ml/chai",163000,176000,13000,7
TIKI,lam-dep-suc-khoe,45537667,"Kem Hỗ Trợ Giảm Thâm Da Vùng Nách, Dưới Chân, Đầu Gối, Khuỷu Tay ELAIMEI",65000,65000,0,0
TIKI,lam-dep-suc-khoe,193583708,"Sữa tắm dưỡng thể Dove Invigorating Da bóng mịn thơm mát với dầu bơ và hoa cúc Calendular 900g",168000,226000,58000,26
TIKI,lam-dep-suc-khoe,36767757,"[+Tặng mũ trùm] TINH DẦU DƯỠNG TÓC NASHI ARGAN OIL 30ML",276000,285000,9000,3
TIKI,lam-dep-suc-khoe,8708414,"Sữa Rửa Mặt Cho Da Dầu, Mụn Uriage Hyseac Cleansing Gel",355000,395000,40000,10
TIKI,lam-dep-suc-khoe,191365680,"Combo 2 Gel dưỡng thể dưỡng sáng mát lạnh Vaseline Fresh & Bright 350ML/chai",195000,300000,105000,35
TIKI,lam-dep-suc-khoe,68281783,"Combo 2 Lăn khử mùi Romano kháng khuẩn & khô thoáng cả ngày 50mlx2 Gentleman",136000,136000,0,0
TIKI,lam-dep-suc-khoe,76121688,"Combo 2 Tinh Dầu Sả Chanh 100ML + Tinh Dầu Vỏ Quế 100ML Nguyên Chất Nhập Khẩu - Tinh Dầu TIDAMO Xông Phòng Giúp Thư Giãn, Thơm Phòng, Bảo Vệ Sức Khỏe và Đuổi Muỗi",328000,656000,328000,50
TIKI,lam-dep-suc-khoe,63159336,"Kem Hỗ Trợ Giảm Sẹo Dermatix Ultra 7g",195000,250000,55000,22
TIKI,lam-dep-suc-khoe,102751945,"Dầu gội Head&shoulders Clinical Strength Proven Relief 400ml - USA",299000,299000,0,0
TIKI,lam-dep-suc-khoe,270105060,"Tinh Dầu Sả Chanh Nguyên Chất 24Care 10ml - Tinh Dầu Xông Thơm Phòng Thư Giãn, Đuổi Muỗi, Khử Mùi - Tinh dầu Bạc Hà/ Cam Ngọt/ Oải hương/ Ngọc Lan Tây/ Tràm Trà/ Bưởi Ngọt/ Vỏ Quế",65000,65000,0,0
TIKI,lam-dep-suc-khoe,19550931,"Dưỡng chất giúp cải thiện và làm sáng da La Roche Posay Pure Vitamin C10 Serum 30ml",779000,795000,16000,2
TIKI,lam-dep-suc-khoe,270698587,"Mầm đậu nành Úc Healthy Care Super Lecithin 1200mg tăng cường chức năng gan khỏe mạnh, nâng cao sức  khỏe, sắc đẹp từ bên trong - Massel Official",316000,632000,316000,50
TIKI,lam-dep-suc-khoe,74559065,"Máy Khuếch Tán Tinh Dầu Cao Cấp Chính Hãng Tặng 3 Chai Tinh Dầu Sả Chanh + Bạc Hà + Quế. Máy Xông Tinh Dầu Chuyên Dụng Có Remote Điều Khiển Từ Xa, Đèn LED Trang Trí, Xông Tinh Dầu và Phun Sương Tạo Ẩm",284000,656000,372000,57
TIKI,lam-dep-suc-khoe,161256062,"Dầu gội cho nam sạch sâu giảm ngứa Oxy Deep Shampoo",60900,74000,13100,18
TIKI,lam-dep-suc-khoe,32028281,"Tinh Chất Dưỡng Trắng Mờ Thâm Nám The Ordinary Alpha Arbutin 2% + HA 30ml",299000,348000,49000,14
TIKI,lam-dep-suc-khoe,129916649,"Mặt nạ khô MEDiCARE 25 miếng",35000,35000,0,0
TIKI,lam-dep-suc-khoe,10795699,"Serum Chống Nắng Dưỡng Thể Kháng Bụi - Dưỡng Ẩm Vượt Trội Biore (150ml)",216000,216000,0,0
TIKI,lam-dep-suc-khoe,19901331,"Viên uống Vitamin tổng hợp tăng cường sức khỏe đề kháng Doppelherz Aktiv A-Z Depot (Hộp 30 viên)",339000,339000,0,0
TIKI,lam-dep-suc-khoe,55840696,"Máy Triệt Lông Vĩnh Viễn Qmele V301-G có màn hình LCD 500.000 Xung",1549000,1549000,0,0
TIKI,lam-dep-suc-khoe,38145103," TẨY TẾ BÀO CHẾT CHIẾT XUẤT QUẾ HỒI & CAFE ",86000,86000,0,0
TIKI,lam-dep-suc-khoe,53224806,"Thiên Môn Bổ Phổi Dược Bình Đông – Chai 90ml dành cho Trẻ em – Giảm ho nhanh chóng, Bổ phổi thật hay",43000,44000,1000,2
TIKI,lam-dep-suc-khoe,10404960,"Combo 2 hộp (hộp/1gr) saffron Kingdom Herb, nhụy hoa nghệ tây Iran chính hãng super negin thượng hạng (Tặng táo đỏ Tân Cương 10g và bình nước thủy tinh)",528000,1029000,501000,49
TIKI,lam-dep-suc-khoe,13566934,"Sữa dưỡng da chống lão hóa ban ngày Shiseido Benefiance Wrinkle Smoothing Day Emulsion SPF 30 PA+++ 75ml",1750000,1750000,0,0
TIKI,lam-dep-suc-khoe,31265214,"Đèn Hồng Ngoại Bayoka - Việt Nam ( Kèm bóng 250W)",390000,390000,0,0
TIKI,lam-dep-suc-khoe,140543197,"Serum dưỡng trắng da mặt Yococi giúp phục hồi sáng da, căng bóng ngăn ngừa lão hóa se khít lỗ chân lông White Perfect Face Serum 20ml",192500,350000,157500,45
TIKI,lam-dep-suc-khoe,27656215,"Nhiệt Kế Hồng Ngoại Đo Tai Và Trán Fr1mf1 + Tặng Đèn Soi Tai",835000,835000,0,0
TIKI,lam-dep-suc-khoe,63900730,"Máy Khuếch Tán Tinh Dầu Chuyên Dụng Cho Gia Đình Và Văn Phòng, Máy Phun Sương Siêu Âm Khuếch Tán Tinh Dầu Tích Hợp Đèn Led 7 Màu Trang Trí Phòng Cực Đẹp",153000,356000,203000,57
TIKI,lam-dep-suc-khoe,2573465,"Dầu dừa ép lạnh tinh khiết Coco-Secret 100 ml",65000,65000,0,0
TIKI,lam-dep-suc-khoe,3598467,"Bộ 10 gói mặt nạ dưỡng da 3W Clinic Fresh Red Ginseng Mask Sheet 23ml X 10",48500,48500,0,0
TIKI,lam-dep-suc-khoe,248781518,"Vitatree Keo Ong Super Propolis Spray Complex Giúp Tăng Cường Hệ Miễn Dịch Chống Vi Khuẩn, Viêm Họng - Nướu Và Giảm Ho, Cảm Lạnh, Nhanh Lanh Vết Thương - QuaTangMe Extaste",136000,272000,136000,50
TIKI,lam-dep-suc-khoe,130780886,"Viên Serum Dưỡng Tóc Ellips Hair Vitamin Giúp Phục Hồi Tóc, Nuôi Dưỡng Tóc Óng Mượt (Vỉ 6 Viên)",21000,35000,14000,40
TIKI,lam-dep-suc-khoe,149932538,"[Chính hãng] Trà tiêu mỡ bụng Genpi Orihiro của Nhật 60 gói/ bịch",220000,220000,0,0
TIKI,lam-dep-suc-khoe,48485617,"Kem Dưỡng Trắng, Tái Tạo Da, Hỗ Trợ Giảm Thâm Mụn, Nám Da Dr.Jart+ V7 Toning Light 50ml ( phiên bản mới)",425000,449000,24000,5
TIKI,lam-dep-suc-khoe,172906093,"Gel Vệ Sinh Nam X2 Manly Giúp Trẻ Hóa Cậu Nhỏ- Hương Nước Hoa Quyến Rũ Cocayhoala 150g",150000,200000,50000,25
TIKI,lam-dep-suc-khoe,70766055,"Muối tắm tẩy tế bào chết body Felina Home Spa 500g từ hạt muối hồng Himalaya thanh khiết giúp da sạch sâu, sáng mịn",109000,180000,71000,39
TIKI,lam-dep-suc-khoe,653823,"Bọt Cạo Râu Gillette Hương Bạc Hà (175g)",79000,84000,5000,6
TIKI,lam-dep-suc-khoe,8142289,"Kềm Cắt Da Thép Chuyên Dụng Kềm Nghĩa D-666",86000,86000,0,0
TIKI,lam-dep-suc-khoe,50253691,"Bọt vệ sinh phụ nữ Mây Hồng Cỏ Mềm Giảm Viêm Ngứa Chiết Xuất Thiên Nhiên Từ Trầu Không An Toàn Dịu Nhẹ Cho Cả Mẹ Bầu 150ml",156000,170000,14000,8
TIKI,lam-dep-suc-khoe,54486828,"Dầu gội phục hồi và giữ màu tóc nhuộm L'oreal Serie Expert Resveratrol  Vitamino color radiance shampoo 500ml [ Mới Chĩnh Hãng ]",446000,460000,14000,3
TIKI,lam-dep-suc-khoe,50699277,"Kem Dưỡng Ẩm Giảm Bọng Mắt Bioderma Sensibio Eye - 15ml",328000,385000,57000,15
TIKI,lam-dep-suc-khoe,5532635,"Viên uống tăng cường thị lực, chống mỏi mắt Doppelherz Aktiv Eye Vital (Hộp 30 viên)",339000,339000,0,0
TIKI,lam-dep-suc-khoe,2336181,"Thực Phẩm Chức Năng  Viên Uống Bổ Gan, Thải Độc Gan Swisse Liver Detox Úc (120 Viên)",455000,568750,113750,20
TIKI,lam-dep-suc-khoe,7280161,"Kềm cắt da thép không gỉ D-03 (14)",175000,175000,0,0
TIKI,lam-dep-suc-khoe,162713234,"Dầu gội sạch gàu, hết ngứa da đầu Selsun",59000,59000,0,0
TIKI,lam-dep-suc-khoe,115255604,"Dầu Gội Bồ Kết Thảo Mộc the FleurA, Hỗ Trợ Mọc Tóc, Bồ Kết Cô Đặc Sạch Gàu, Nấm, Ngứa, Ngăn Rụng Tóc, Phục Hồi Tóc Hư Tổn",149000,210000,61000,29
TIKI,lam-dep-suc-khoe,159887686,"Collagen bổ sung Vitamin C tăng khả năng chống oxy hóa Lá House Pure Amino Collagen C+ (6.5g*30gói)",1350000,1350000,0,0
TIKI,lam-dep-suc-khoe,127127300,"Kem Đánh TrắngRăng Eucryl 62g Anh Quốc - Bí Quyết Cho Hàm Răng Sáng Bóng, Thơm Mát",106000,212000,106000,50
TIKI,lam-dep-suc-khoe,157084566,"Dụng cụ massage đầu cầm tay, giúp thư giãn, giảm stress, giảm đau đầu - Màu ngẫu nhiên",19000,29000,10000,34
TIKI,lam-dep-suc-khoe,3928991,"Tinh Chất Dưỡng Mi DHC Eyelash Tonic (6.5ml)",285000,350000,65000,19
TIKI,lam-dep-suc-khoe,169585264,"Obagi Retinol 1.0 (28g)",1230000,1750000,520000,30
TIKI,lam-dep-suc-khoe,15944204,"Xịt khử mùi nước hoa Enchanteur Charming nồng nàn duyên dáng ngăn mồ hôi & mùi cơ thể 150ml",86000,110000,24000,22
TIKI,lam-dep-suc-khoe,77673975,"Optibac Probiotics for women 90 viên - men vi sinh chính hãng Anh khắc phục hiệu quả viêm nhiễm, nấm ngứa phụ khoa (mẫu mới)",1150000,1461250,311250,21
TIKI,lam-dep-suc-khoe,171124536,"CAO SAO VÀNG (Hộp 20 g) -Dùng khi nhức đầu, sổ mũi, đau bụng, say tàu xe, côn trùng đốt - Hàng chính hãng OPC",44600,44600,0,0
TIKI,lam-dep-suc-khoe,196869296,"Gối Massage Nhiệt Hồng Ngoại VISPO VP-G23 - 4 Bi Xoay Chuyên Dùng Cho Cổ, Vai, Gáy, Thắt Lưng Sử Dụng Tại Nhà, Văn Phòng Hoặc Trên Ô tô",659000,1290000,631000,49
TIKI,lam-dep-suc-khoe,204340766,"Combo 3 Tinh Dầu LORGANIC / Nhiều Mùi Hương / Xông Phòng Thư Giãn, Đuổi Muỗi 10m / Sả Chanh, Oải Hương Lavender, Ngọc Lan Tây, Hương Thảo, Stress Relief, Quyến Rũ Sensualy (10ml)",115000,195000,80000,41
TIKI,lam-dep-suc-khoe,190641512,"Sữa Rửa Mặt Dịu Nhẹ Cho Da Dầu CeraVe Foaming Cleanser 88ml",131000,155000,24000,15
TIKI,lam-dep-suc-khoe,51048821,"Tinh chất The Ordinary Retinol 0.2% In Squalane",319000,319000,0,0
TIKI,lam-dep-suc-khoe,68617503,"Papulex Sữa Rửa Mặt Papulex Ngăn Ngừa & Giảm Mụn Trứng Cá Moussant Soap Free Cleansing Gel 150ml",361000,380000,19000,5
TIKI,lam-dep-suc-khoe,105629974,"Bộ 2 gel bôi trơn Durex K-Y Jelly 50g",164000,196000,32000,16
TIKI,lam-dep-suc-khoe,171574158,"Xịt chống muỗi hương cam Soffell (80ml)",36000,36000,0,0
TIKI,lam-dep-suc-khoe,57715384,"Nước Hoa MIni VERSACE EROS FOR MEN Phong Độ Nam Giới 5ml Ý",147000,299000,152000,51
TIKI,lam-dep-suc-khoe,116480061,"Viên Giấp Cá Dân Khang Giảm Táo Bón Và Trĩ Nội Trĩ Ngoại Hộp 3 vỉ x 10 viên",84500,105000,20500,20
TIKI,lam-dep-suc-khoe,153612336,"Nước hoa nữ Versace Eros Pour Femme Eau De Parfum",228000,409000,181000,44
TIKI,lam-dep-suc-khoe,92560200,"Xịt khử mùi dưỡng trắng hương nước hoa Refre Whitening Perfume In Love - Hương Tình Yêu 30ml",51400,62000,10600,17
TIKI,lam-dep-suc-khoe,52779805,"Mặt Nạ Ngủ Cho Môi Laneige Lip Sleeping Mask Apple Lime EX 20g",375000,500000,125000,25
TIKI,lam-dep-suc-khoe,12063335,"Xịt Khử Mùi Hàng Ngày Etiaxil Déodorant Anti-Transpirant 48h Anti-Traces Blanches & Jaunes 100ml",249000,289000,40000,14
TIKI,lam-dep-suc-khoe,74547395,"Kem Chống Nắng Không Màu Kiểm Soát Dầu La Roche-Posay Anthelios XL Dry Touch Gel-Cream SPF 50+ UVB & UVA (50ml) - TẶNG MÓC KHÓA",441000,450000,9000,2
TIKI,lam-dep-suc-khoe,58519309,"Kem bôi da Thuần Mộc Thanh Mộc Hương mẫu mới - Tặng Kèm Cột Tóc Tai Thỏ Màu Ngẫu Nhiên",104000,104000,0,0
TIKI,lam-dep-suc-khoe,48190464,"VIÊN TINH NGHỆ MẬT ONG SỮA CHÚA HONEYLAND 250G/HŨ",251000,389000,138000,35
TIKI,lam-dep-suc-khoe,87446824,"Mặt Nạ Nghệ Hưng Yên Cocoon 30ml",145000,145000,0,0
TIKI,lam-dep-suc-khoe,198769926,"[HỘP - FAMAPRO 5D DÂY VẢI] - Khẩu trang y tế kháng khuẩn 3 lớp Famapro 5D Mask dây vải (10 cái/ hộp)",10900,10900,0,0
TIKI,lam-dep-suc-khoe,7939532,"Sữa Rửa Nam Ngăn Ngừa Mụn Trắng Da Dabo Black Force (120ml)",105000,105000,0,0
TIKI,lam-dep-suc-khoe,203790754,"Combo 3 Tinh Dầu LORGANIC / Nhiều Mùi Hương / Xông Phòng Thư Giãn, Đuổi Muỗi 10m / Sả Chanh, Quế, Bạc Hà, Oải Hương Lavender, Tràm, Ngọc Lan Tây, Hương Thảo, Stress Relief, Sensual, Cam, Vỏ Bưởi, Bạch Đàn Chanh, Bưởi Chùm, Gỗ Thông (10ml)",99000,198000,99000,50
TIKI,lam-dep-suc-khoe,118896560,"Nến thơm tinh dầu cao cấp không khói an toàn Candle Cup - JASMINT/HOA NHÀI - S - 100G (KG NẮP)",120000,120000,0,0
TIKI,lam-dep-suc-khoe,46709654,"Son Dưỡng VASELINE LIP THERAPY Trị Thâm Môi 7g USA",65000,65000,0,0
TIKI,lam-dep-suc-khoe,192418945,"Mặt nạ tay dưỡng da tay Mèo, làm trắng da bổ sung collagen cải thiện nếp nhăn, tẩy tế bào chết",11000,11000,0,0
TIKI,lam-dep-suc-khoe,159887702,"Collagen làm giảm nguy cơ lão háo da Lá House Gluta Q10 (6.5g*30gói)",2450000,2450000,0,0
TIKI,lam-dep-suc-khoe,101947387,"Cho máy Oral B Braun, bộ 4 Đầu Bàn Chải đánh răng điện thay thế MIHOCO EB18-P New   ,  phá tan mảng bám, cho răng trắng sáng",125000,125000,0,0
TIKI,lam-dep-suc-khoe,205073657,"Gel bôi trơn hậu môn nóng ấm - Shell Supermen Warming - Chai 90ml",349600,380000,30400,8
TIKI,lam-dep-suc-khoe,195454530,"Khẩu trang trẻ em KF94 4D mask An Tâm cho bé trên 4-10 tuổi 4 lớp kháng khuẩn chống bụi mịn in hình dễ thương túi 10 cái",7500,12000,4500,38
TIKI,lam-dep-suc-khoe,16180578,"Sữa Rửa Mặt Dịu Nhẹ Cho Da Nhạy Cảm Physiogel Daily Moisture Therapy Dermo-Cleanser 150ml",141000,200000,59000,30
TIKI,lam-dep-suc-khoe,23079049,"Combo 3 Hộp Tăm Bông Diva - 200 Que/Hộp",59000,59000,0,0
TIKI,lam-dep-suc-khoe,162767278,"Hộp 30 Chiếc Bàn Chải Đánh Răng Than Tre Hoạt Tính Hàn Quốc - Hàng Chuẩn Loại 1",99000,99000,0,0
TIKI,lam-dep-suc-khoe,190881603,"Khẩu trang y tế 4 lớp, lẻ 10 cái, 1 hộp 50 cái, kháng khuẩn, kháng virus Corona chuyên dụng cho bệnh viện, nhiều màu",6000,6000,0,0
TIKI,lam-dep-suc-khoe,41967584,"Viên uống Sắc Ngọc Khang Vi tảo lục (60 viên) giúp trẻ hóa làn da xua tan vết nám, hỗ trợ cân bằng nội tiết tố, bổ huyết, điều kinh, hỗ trợ giảm các triệu chứng tiền mãn kinh",240000,280000,40000,14
TIKI,lam-dep-suc-khoe,52249427,"Bioré Sữa Chống Nắng Bảo Vệ Hoàn Hảo DƯỠNG ẨM Biore UV SPF50+/PA+++ 25ML",54000,70000,16000,23
TIKI,lam-dep-suc-khoe,271444292,"Sụn vi cá mập Úc Healthy Care Shark Cartilage 750mg tăng sức khỏe xương khớp, cơ bấp, tăng chức năng vận động - Massel Official",430000,874000,444000,51
TIKI,lam-dep-suc-khoe,20115822,"Thực phẩm bảo vệ sức khỏe Viên uống làm đẹp da DHC Collagen Nhật Bản",165000,195000,30000,15
TIKI,lam-dep-suc-khoe,41588397,"Đai Chống Gù Lưng Điều Chỉnh Cột Sống Cho Người Lớn Aolikes",145000,145000,0,0
TIKI,lam-dep-suc-khoe,114616457,"Bàn chải silicon gội đầu massage cho trẻ em và người lớn- Dụng cụ chà lưng, tay chân tạo bọt silicon mềm mại",49000,49000,0,0
TIKI,lam-dep-suc-khoe,58837639,"DẦU GỘI CHO TÓC DẦU DERCOS OIL CONTROL VICHY 200ml",332000,415000,83000,20
TIKI,lam-dep-suc-khoe,185924212,"Hộp Mặt Nạ Nén Maycreate Silk Mask 100 Miếng",105000,150000,45000,30
TIKI,lam-dep-suc-khoe,160549677,"Combo 5 Set Minisize Dầu gội xả phục hồi đa tầng Nấm Truffle Weilaiya - Hương nước hoa",145000,200000,55000,28
TIKI,lam-dep-suc-khoe,75640683,"Viên Uống Giảm Căng Thẳng Lo Âu Chăm Sóc Giấc Ngủ Fostress Hộp 3 Vỉ x 10 Viên",135000,139000,4000,3
TIKI,lam-dep-suc-khoe,60185869,"Mật ong nguyên chất  (MS ) - (1350g) - Mật ong rừng hoa cà phê",145000,145000,0,0
TIKI,lam-dep-suc-khoe,140318094,"Viên uống sáng da glutathione D-na Whitening Supplement (60 Viên)",879000,990000,111000,11
TIKI,lam-dep-suc-khoe,107254773,"Viên uống ORIHIRO BBB Best Beauty Body  300 viên/hộp",475000,750000,275000,37
TIKI,lam-dep-suc-khoe,181919679,"Bao cao su Tâm Thiện Chí Four In Love",60000,105000,45000,43
TIKI,lam-dep-suc-khoe,46980003,"Bàn Chải Điện Chải Răng Sử Dụng Sạc Clear Sonic Boorui",159000,189000,30000,16
TIKI,lam-dep-suc-khoe,58957414,"Sữa chống nắng dành cho da nhạy cảm Shiseido GSC The Perfect Protector S 50ml",1150000,1150000,0,0
TIKI,lam-dep-suc-khoe,58800808,"Chai Xịt Nóng Hỗ Trợ Giảm Nhanh Đau Nhức Cơ Xương Khớp, Sưng Bong Gân Bầm Tím Bách Linh Diệu - Chai 50 ml",79000,123000,44000,36
TIKI,lam-dep-suc-khoe,134390487,"Đệm Massage Toàn Thân - Máy Massage Kết Hợp Túi Khí Và Gối Massage Nhiệt Hồng Ngoại Giúp Thư Giãn, Giảm Đau Cơ Thể - Nệm Mát Xa Đa Năng Cao Cấp",1899000,2590000,691000,27
TIKI,lam-dep-suc-khoe,270732047,"Xịt họng keo Ong Úc Vitatree Super Propolis Spray Complex with Honey Giúp bổ sung kháng khuẩn tự nhiê, Giảm đau rát viêm họng, ho, nhiệt lỡ miệng - Massel Official",334000,668000,334000,50
TIKI,lam-dep-suc-khoe,143786928,"Combo 2 Tinh Dầu Oải Hương 50ML + Tinh Dầu Bạc Hà 50ML Nguyên Chất Chính Hãng TIDAMO, Xông Thơm Phòng Giúp Thư Giãn và Nâng Cao Sức Khỏe, Rất Tốt Khi Sử Dụng Với Máy Xông Tinh Dầu",218000,436000,218000,50
TIKI,lam-dep-suc-khoe,177317341,"Combo 10 Hộp Khẩu trang Bông Bạch Tuyết KF94 4 lớp - Đen (10 cái/hộp)",200000,200000,0,0
TIKI,lam-dep-suc-khoe,8093197,"Nước Xịt Khoáng Dưỡng Da Vichy 50ml M5030803",161700,165000,3300,2
TIKI,lam-dep-suc-khoe,109135923,"[Combo 5 - PERFETTA CHILDREN] - Khẩu Trang Y Tế Trẻ Em Chất Lượng Cao, Kháng Khuẩn, Chống Bụi Mịn, Màu",210000,250000,40000,16
TIKI,lam-dep-suc-khoe,176043674,"SPECIAL DEAL cà phê Đắk Lắk làm sạch da chết cơ thể Cocoon 600ml (Tặng tẩy da chết môi cà phê Đắk Lắk Cocoon 5g)",325000,325000,0,0
TIKI,lam-dep-suc-khoe,81403593,"Nước uống làm đẹp Collagen Adiva (14 lọ x30ml/ Hộp )",689000,811000,122000,15
TIKI,lam-dep-suc-khoe,55785614,"Kem Dưỡng Trắng Da Ban Đêm 4K PLUS Chiết Xuất Nhân Sâm THÁI LAN",149000,149000,0,0
TIKI,lam-dep-suc-khoe,24828338,"Gel ngừa mụn diệt khuẩn Floslek Pharma Antibacterial Intense Gel 20ml",207000,329000,122000,37
TIKI,lam-dep-suc-khoe,38246155,"Kem Dưỡng Ẩm Trẻ Hoá Da Hạt Ý Dĩ Hatomugi Naturie Nhật Bản 180g",170000,205758,35758,17
TIKI,lam-dep-suc-khoe,194041238,"Nước súc miệng cho răng nhạy cảm Listerine Total Care Sensitive Soothing Taste - Dung tích 250ml - 750ml",82000,82000,0,0
TIKI,lam-dep-suc-khoe,55056170,"Son Môi An Toàn Cho Bé - Son Búp Bê Cỏ Mềm",144000,160000,16000,10
TIKI,lam-dep-suc-khoe,48290415,"Kem chống nắng Skin1004 Madagascar Centella Air-fit Suncream Plus 50ml",199000,199000,0,0
TIKI,lam-dep-suc-khoe,189595821,"Ghế massage trị liệu toàn thân KAGAWA K28 PRO [FULL QUÀ TẶNG] công nghệ mát xa nhiệt hồng ngoại tân tiến giúp thư giãn, giảm stress tại nhà",8860000,18500000,9640000,52
TIKI,lam-dep-suc-khoe,128569889,"Dung dịch vệ sinh Intima Ziaja 200ml",82000,158000,76000,48
TIKI,lam-dep-suc-khoe,118896394,"Combo 2 Chai Dầu gội đầu OGX - Dung Tích 385mlx2",590000,590000,0,0
TIKI,lam-dep-suc-khoe,12084554,"Kem dưỡng trắng da ban đêm Eucerin UltraWHITE+ SPOTLESS Night (50ml)",655000,655000,0,0
TIKI,lam-dep-suc-khoe,73772610,"Saffron Kingdom Herb nhụy hoa nghệ tây Iran hộp 0.2 gram, hàng chính hãng super negin thượng hạng (Tặng bình nước thủy tinh)",74000,155000,81000,52
TIKI,lam-dep-suc-khoe,131504590,"Kem đánh răng dược liệu Sao Thái Dương 150g",72000,72000,0,0
TIKI,lam-dep-suc-khoe,173761453,"Combo dưỡng mi FEG Plus Stem Cells - Phiên bản tế bào gốc, dài mi nhanh, không chứa Prostaglandins gây thâm mắt (5ml/lọ)",600000,600000,0,0
TIKI,lam-dep-suc-khoe,51095498,"Kem mắt chống lão hóa The INKEY List Retinol Eye Cream 15ml",399000,399000,0,0
TIKI,lam-dep-suc-khoe,77026005,"Dầu Gội Thảo Dược Bồ Kết Tóc Mây Ngăn Ngừa Tóc Gãy Rụng An Toàn Từ Thiên Nhiên Không Chứa Hóa Chất Giảm Gàu Và Ngứa Da Đầu Cỏ Mềm 300g",299000,325000,26000,8
TIKI,lam-dep-suc-khoe,89753515,"DUNG DỊCH VỆ SINH PHỤ NỮ HANA SOFT SILK HANAYUKI",115000,118000,3000,3
TIKI,lam-dep-suc-khoe,71712755,"Nước Hoa Mini Nam Versace Pour Homme 5ml",193000,389000,196000,50
TIKI,lam-dep-suc-khoe,58673652,"Combo 2 Lăn khử mùi nước hoa Enchanteur Charming 50ml/ Chai",133000,174000,41000,24
TIKI,lam-dep-suc-khoe,116189274,"Kìm cắt móng tay, móng chân, kìm cắt da chết bằng thép không gỉ siêu sắc  tặng kèm thanh nạy móng (mầu sắc ngẫu nhiên)",77000,79000,2000,3
TIKI,lam-dep-suc-khoe,136690839,"Dầu Gội Head & Shoulder",191000,239000,48000,20
TIKI,lam-dep-suc-khoe,241982269,"Máy mát xa cổ cao cấp, có chườm nóng - 4 đầu tiếp xúc, 6 chế độ massage khác nhau, 9 cường độ massage - Màu Trắng",142500,142500,0,0
TIKI,lam-dep-suc-khoe,24862534,"Tinh Chất Tế Bào Gốc Tái Tạo Phục Hồi Trẻ Hoá Da Cấp Ẩm Dưỡng Trắng Chống Lão Hoá Cellkey-Scien White Serum 30ml",790500,930000,139500,15
TIKI,lam-dep-suc-khoe,15262824,"Tinh dầu dưỡng tóc Nashi Argan Oil - trattamento di bellezza per tutti i tipi di capello 100ml",698000,720000,22000,3
TIKI,lam-dep-suc-khoe,8142233,"Kềm Cắt Móng Thép Chuyên Dụng Kềm Nghĩa M-306",63480,69000,5520,8
TIKI,lam-dep-suc-khoe,119988682,"Uốn mi cong thân nhựa cao cấp KAI màu hồng kèm miếng đệm thay thế",135000,152000,17000,11
TIKI,lam-dep-suc-khoe,166389092,"Sữa tắm gội Romano cho nam 2 trong 1 Gentleman 180g",56000,65000,9000,14
TIKI,lam-dep-suc-khoe,188964498,"SPECIAL COMBO 2 chai Nước Dưỡng Tóc Tinh Dầu Bưởi Cocoon 140ml - tặng Serum Sachi phục hồi tóc Cocoon 70ml",330000,330000,0,0
TIKI,lam-dep-suc-khoe,177516306,"Set 5 Son Kem Lì Thỏ LEADUU lâu trôi mềm mịn",74000,125000,51000,41
TIKI,lam-dep-suc-khoe,12084494,"Nước Tẩy Trang Eucerin Hỗ Trợ Trị Mụn Làm Trắng Da (200ml)",244000,349000,105000,30
TIKI,lam-dep-suc-khoe,71669650,"Tinh chất kháng mụn mờ thâm The INKEY List Niacinamide 30ml",329000,329000,0,0
TIKI,lam-dep-suc-khoe,13778270,"Tinh chất kích thích mọc tóc L’Oréal Serioxyl Denser Hair 90ml",951000,980000,29000,3
TIKI,lam-dep-suc-khoe,73574991,"Dego Pharma - Dầu gội sạch vảy gàu mảng trắng, hết ngứa chiết xuất thiên nhiên từ vỏ cây Zizyphus, sản xuất theo tiêu chuẩn và dưới sự giám sát của công ty dược phẩm Châu Âu (80ml)",190000,390000,200000,51
TIKI,lam-dep-suc-khoe,2254547,"Viên uống điều hòa nội tiết tố nữ, nuôi dưỡng da Solgar Dầu Anh Thảo Evening Primrose Oil 1300 mg - NHẬP KHẨU USA",814909,981818,166909,17
TIKI,lam-dep-suc-khoe,272918313,"Omega 3-6-9 Úc Healthy Care Ultimate 1000mg Tạo sức khỏe cho tim, não, khớp, mắt và cải thiện da khô - QuaTangMe Extaste",496000,992000,496000,50
TIKI,lam-dep-suc-khoe,77749623,"Tinh Dầu Quế 50ML + Tinh Dầu Quế Treo Xe ô Tô Treo Phòng Gia Đình (Cinnamon) - Tinh Dầu Vỏ Quế Nguyên Chất Xông Phòng Giúp Bảo Vệ Sức Khỏe, Kháng Khuẩn Và Thư Giãn Tinh Thần",88000,256000,168000,66
TIKI,lam-dep-suc-khoe,12478891,"Gel Rửa Mặt Cho Da Mụn Ducray Keracnyl Gel Innova Myrtacine (200ml)",299000,461000,162000,35
TIKI,lam-dep-suc-khoe,68188298,"Khẩu Trang Y Tế 5D Trẻ Em Nam Anh - Hộp 10 cái",9900,18000,8100,45
TIKI,lam-dep-suc-khoe,98675681,"Hộp Khẩu Trang 2D Trẻ Em 3 Lớp ANYGUARD Chính Hãng - Lọc 99% Vi Khuẩn - Họa Tiết Cá - Dành Cho Bé Từ 2 Đến 4 tuổi (Hộp 50 cái) - Đạt Tiêu Chuẩn QCVN 01:2017/BTC, ISO 9001:2015, ISO 13485:2016",124852,127400,2548,2
TIKI,lam-dep-suc-khoe,271570469,"Canxi cho người lớn Kirkland Calcium thêm: Mange, Kẽm, Vitamin B6, D, B6 giúp giảm đau nhức xương khớp, phòng loãng xương, ngủ ngon - Massel Official",588000,1196000,608000,51
TIKI,lam-dep-suc-khoe,83423219,"Khẩu trang y tế 4 lớp kháng khuẩn May 10 chính hãng",35000,35000,0,0
TIKI,lam-dep-suc-khoe,14336296,"Combo 2 hộp nước uống vị hồng sâm Hàn Quốc 10 chai x 100ml",154000,154000,0,0
TIKI,lam-dep-suc-khoe,51287418,"Thuốc nhuộm phủ bạc Bigen Milky nhập khẩu Nhật Bản, nhuộm tóc bạc hoàn toàn, nhuộm dễ tại nhà 80ml dạng kem - BSL Số 6 Nâu Đen",226000,246000,20000,8
TIKI,lam-dep-suc-khoe,76184280,"Bộ bao da dụng cụ 16 món cắt móng",59000,61000,2000,3
TIKI,lam-dep-suc-khoe,270687455," Dung dịch vệ sinh phụ khoa cao cấp Femfresh giúp làm sạch thơm, kháng viêm, kháng khuẩn, phòng viêm nhiễm cho cả nữ và nam - QuaTangMe Extaste",133000,272000,139000,51
TIKI,lam-dep-suc-khoe,26096771,"Thực phẩm bảo vệ sức khỏe Maxxhair New hộp 30 viên- Bổ sung Vitamin và khoáng chất giúp tăng cường sức khỏe của tóc; giúp tóc mọc nhanh, chắc khỏe, suôn mượt và bóng đẹp, ngăn ngừa rụng tóc, đồng thời giúp thải độc do ảnh hưởng của các hóa chất sử dụng ch",226000,226000,0,0
TIKI,lam-dep-suc-khoe,41263241,"Vitamin tổng hợp cho bà bầu Pregnacare Max 84 viên",425000,531250,106250,20
TIKI,lam-dep-suc-khoe,157208662,"Túi Refill Cà phê Đắk Lắk làm sạch da chết cơ thể Cocoon cho làn da mềm mại & rạng rỡ 600ml",234000,234000,0,0
TIKI,lam-dep-suc-khoe,178559962,"Xà Bông Nghệ MELA Thiên Nhiên, Làm Sạch Da Sáng Khoẻ, Tẩy Da Chết Thoáng Lỗ Chân Lông Hỗ Trợ Giảm Mụn Lưng - ML05",80000,80000,0,0
TIKI,lam-dep-suc-khoe,36768495,"Bàn chải thông minh Xiaomi Mijia T100 - Hàng nhập khẩu",158000,208000,50000,24
TIKI,lam-dep-suc-khoe,50698010,"Serum dưỡng trắng da, mờ đốm nâu, đều màu da - Vitamin C, Vitamin E, Bisabolol - NNO VITE Mega We Care (30 viên)",345000,360000,15000,4
TIKI,lam-dep-suc-khoe,45033442,"Máy phun tinh dầu phòng ngủ Thiên Ý Tạo Ẩm Khuếch Tán Tinh Dầu Kèm Đèn Ngủ,  không gây ồn, tặng kèm điều khiển từ xa và tinh dầu sả chanh Kobi",325000,652000,327000,50
TIKI,lam-dep-suc-khoe,31494288,"The Ordinary Caffeine Solution 5% + EGCG - Thần Dược Giải Quyết Mọi Vấn Đề Của Mắt 30ml",339000,339000,0,0
TIKI,lam-dep-suc-khoe,114467695,"Combo Dầu Gội X-Men Nước hoa Fire 650G và Sữa Tắm X-Men Nước hoa Fire 650G",382000,382000,0,0
TIKI,lam-dep-suc-khoe,184767648,"Tinh dầu thiên nhiên treo xe hơi, tủ áo Lorganic, hương thơm thiền tịnh",25000,45000,20000,44
TIKI,lam-dep-suc-khoe,40769633,"Dầu gội hỗ trợ trị gàu ALCORAL 60ml",52900,68000,15100,22
TIKI,lam-dep-suc-khoe,2869347,"La Roche-Posay - Gel Rửa Mặt Tạo Bọt Cho Da Dầu Nhạy Cảm Effaclar Purifying Foaming Gel 200ml",307000,410000,103000,25
TIKI,lam-dep-suc-khoe,150285632,"[HỘP - FAMAPRO VN95 KIDS] - Khẩu trang y tế trẻ em kháng khuẩn 4 lớp Famapro VN95 KIDS đạt chuẩn N95 (10 cái/ hộp)",23000,23000,0,0
TIKI,lam-dep-suc-khoe,193916624,"Bộ 4 đầu thay thế máy tăm nước Lock&Lock ENR126WHT_RB - Hàng chính hãng - JoyMall",102300,186000,83700,45
TIKI,lam-dep-suc-khoe,77655821,"MÁY KHUẾCH TÁN TINH DẦU CỔ CAO MODEL 4G CAO CẤP CHUYÊN DỤNG - MÁY XÔNG TINH DẦU PHUN SƯƠNG, GIÚP TỎA HƯƠNG TINH DẦU, THƯ GIẢN, THÍCH HỢP DÙNG CHO PHÒNG LỚN - TẶNG KÈM REMOTE",286000,286000,0,0
TIKI,lam-dep-suc-khoe,13415841,"Sữa Rửa Mặt Nghệ Thái Dương (90g)",35000,40000,5000,13
TIKI,lam-dep-suc-khoe,78021090,"Hộp 10 miếng mặt nạ dưỡng trắng và ngừa lão hoá Truesky Integrated Mask chiết xuất hoa hồng đá 25g/miếng",159000,250000,91000,36
TIKI,lam-dep-suc-khoe,116583499,"Mật Ong Nguyên Chất Hoa Vải Cvdbeheoney loại 90ml(125g) ",15000,15000,0,0
TIKI,lam-dep-suc-khoe,76120881,"Combo 2 Tinh Dầu Sả Chanh + Tinh Dầu Vỏ Quế TIDAMO Nguyên Chất Nhập Khẩu - Tinh Dầu Xông Phòng Cao Cấp Giúp Thư Giãn, Thơm Phòng, Bảo Vệ Sức Khỏe và Đuổi Muỗi (2 chai 10ML)",56000,118000,62000,53
TIKI,lam-dep-suc-khoe,29345245,"Dầu gội Paul Mitchell Tea Tree Special shampoo trà xanh bạc hà ngăn gàu kháng khuẩn Mỹ 300ml",437000,450000,13000,3
TIKI,lam-dep-suc-khoe,58105443,"HỘP 30 CHIẾC BÀN CHẢI ĐÁNH RĂNG THAN TRE HOẠT TÍNH",139000,139000,0,0
TIKI,lam-dep-suc-khoe,52139397,"Combo 3 Tinh dầu SENSELAB nhập khẩu Ấn Độ: Tinh Dầu Sả Chanh (10ml) + Tinh Dầu Oải Hương (10ml) + Tinh Dầu Bạc Hà (10ml) - Tinh dầu thiên nhiên nguyên chất",75000,150000,75000,50
TIKI,lam-dep-suc-khoe,63042665,"SERUM NGỪA MỤN THÂM - MỜ SẸO 25ML - MOC",270000,270000,0,0
TIKI,lam-dep-suc-khoe,185817287,"Xịt Thơm Miệng MEXI Quyên Lara - Giúp Hơi Thở Thơm Mát, Hết Hôi Miệng, Giảm Tình Trạng Viêm Lợi, Viêm Chân Răng, Dung Tích 15ml",119000,230000,111000,48
TIKI,lam-dep-suc-khoe,149975014,"Hộp Quà Tặng Tinh Dầu TOKI MORI Cao Cấp, Xuất Khẩu Nhật Bản 6x10ml, Nguyên Chất Thiên Nhiên - Cam Ngọt, Bạc Hà, Sả Chanh, Vỏ Quế, Tràm Gió, Vỏ Bưởi",260000,499000,239000,48
TIKI,lam-dep-suc-khoe,878391,"Tỏi Đen Kim Cương Đông Á - Tỏi Đen Cô Đơn (Túi 200g)",230000,230000,0,0
TIKI,lam-dep-suc-khoe,34315208,"Dao Cạo Râu 4 Lưỡi Dorco Pace 4 FRA 1001-PT",135000,135000,0,0
TIKI,lam-dep-suc-khoe,1754691,"Dung dịch vệ sinh khử mùi phụ khoa nam giới SERENYS - 100ml",129000,129000,0,0
TIKI,lam-dep-suc-khoe,53686030,"Gel vệ sinh phụ nữ X2 Nano Nghệ Cocayhoala Giảm Mùi Hôi - Giảm Ngứa - Giảm Khí Hư 150ml",209000,330000,121000,37
TIKI,lam-dep-suc-khoe,8142295,"Kềm Cắt Da Thép Chuyên Dụng Kềm Nghĩa D-23",60000,60000,0,0
TIKI,lam-dep-suc-khoe,89839177,"Bộ Dung Dịch Vệ Sinh Phụ Nữ Lactacyd Soft & Silky Dưỡng Ẩm 250ml + Odor Fresh Ngăn Mùi 24H 150ml",137000,147000,10000,7
TIKI,lam-dep-suc-khoe,180322040,"Dầu chăm sóc da từ Thiên Nhiên giúp giảm rạn dạ, mờ sẹo cho da nhạy cảm - BIO-OIL SKINCARE OIL (NATURAL) (chai 60ml)",230000,250000,20000,8
TIKI,lam-dep-suc-khoe,148824107,"Serum sâu răng hôi miệng INOD Huyền Phi Tặng Kèm Gội (Xả) Mini Weilaiya Ngẫu Nhiên",182000,182000,0,0
TIKI,lam-dep-suc-khoe,35787205,"Combo 6 Băng Vệ Sinh Whisper Ultra Clean Siêu Mỏng Có Cánh Ngày Vừa 24cm (Gói 10 Miếng) ",165000,165000,0,0
TIKI,lam-dep-suc-khoe,121322953,"Chai xịt diệt khuẩn Nano Bạc AHT - dùng rửa tay, phun khử khuẩn toàn thân",137500,137500,0,0
TIKI,lam-dep-suc-khoe,160299522,"Serum Kiểm Soát Dầu Mụn Cho Da Láng Mịn INNISFREE Retinol Cica Repair Ampoule 30mL",747000,900000,153000,17
TIKI,lam-dep-suc-khoe,74854269,"Tinh Dầu Vỏ Quế Nguyên Chất Nhập Khẩu Ấn Độ 100ML. Tinh Dầu Quế Cao Cấp Để Xông Phòng Kháng Khuẩn, Phòng Tránh Cảm Cúm - Dùng Với Máy Khuếch Tán Tinh Dầu",148000,396000,248000,63
TIKI,lam-dep-suc-khoe,8756585,"Combo 5 Bông tẩy trang Ipek 130 miếng (Thổ Nhĩ Kì)",134000,134000,0,0
TIKI,lam-dep-suc-khoe,14695045,"Xà Phòng hỗ trợ Trị Thâm Nách Pelican nội địa Nhật Bản",116000,139860,23860,17
TIKI,lam-dep-suc-khoe,3045839,"Tinh bột nghệ Quê Việt - 100% nghệ đỏ nguyên chất, hàm lượng curmim cao.",237000,395000,158000,40
TIKI,lam-dep-suc-khoe,271441960,"Dung dịch vệ sinh phụ khoa cao cấp Femfresh giúp kháng khuẩn, làm sạch, khử mùi, tạo hương thơm mát cả ngày, cho cả nữ và nam - Massel Official",136000,272000,136000,50
TIKI,lam-dep-suc-khoe,37880214,"phấn trang điểm trắng da twoway cake",153000,153000,0,0
TIKI,lam-dep-suc-khoe,14455274,"Bột rắc tạo kiểu tóc Schwarzkopf OSiS+ Dust It Mattifying Volume Powder 10g",310000,310000,0,0
TIKI,lam-dep-suc-khoe,125874560,"Túi chườm cao su nước NÓNG , LẠNH ĐA NĂNG",49000,69000,20000,29
TIKI,lam-dep-suc-khoe,14423069,"Tấm thảo dược thay thế của đai chườm vai cắm điện - Hapaku",141000,148000,7000,5
TIKI,lam-dep-suc-khoe,39089019,"Sữa Dưỡng Ẩm Toàn Thân Và Da Mặt Cetaphil Moisturizing Lotion (200ml)",288500,400000,111500,28
TIKI,lam-dep-suc-khoe,138181029,"Viên nang mềm hồng sâm hàn quốc",488000,488000,0,0
TIKI,lam-dep-suc-khoe,187606879,"Combo Kem Rửa Mặt Tẩy Da Chết Tế Bào Gốc Thực Vật Kiềm Dầu Làm Sạch Sâu Dưỡng Ẩm Da Dầu Mụn Nhạy Cảm Cellkey-Scien 230ml",620500,730000,109500,15
TIKI,lam-dep-suc-khoe,33600476,"Máy Tạo Kiểu Râu Philips BT1214	",1098250,1098250,0,0
TIKI,lam-dep-suc-khoe,50699275,"Kem Se Nhỏ Lỗ Chân Lông Bioderma Sebium Pore Refiner - 30ml",413000,485000,72000,15
TIKI,lam-dep-suc-khoe,162196352,"Kem Dưỡng Ẩm Dành Cho Da Dầu Và Da Hỗn Hợp Laneige Water Bank Blue HA Cream Oily 50ml",990000,1100000,110000,10
TIKI,lam-dep-suc-khoe,119251241,"Sữa rửa mặt dịu lành cho da nhạy cảm Cetaphil Gentle Skin Cleanser 250ml",300000,300000,0,0
TIKI,lam-dep-suc-khoe,125722009,"Combo bếp đốt thảo mộc bồ kết + 500gr sả + 10 viên nến",125000,125000,0,0
TIKI,lam-dep-suc-khoe,271613379,"Sbody Green Coffee Hỗ Trợ Giảm Cân  - 100% Thiên Nhiên - Cà Phê Xanh Hỗ Trợ Giảm Cân AN TOÀN & HIỆU QUẢ (Hộp 12 gói /180G)",550000,550000,0,0
TIKI,lam-dep-suc-khoe,270846005,"Canxi 600mg và Vitamin D3 Kirkland cho xương và răng - QuaTangMe Extaste",531000,1080000,549000,51
TIKI,lam-dep-suc-khoe,25442377,"Son kem lì Bbia Last Velvet Lip Tint - 17 More Pleasant 5g (Màu cam san hô)",140000,290000,150000,52
TIKI,lam-dep-suc-khoe,24752546,"Sáp Dưỡng Ẩm Vaseline 100% Pure Petroleum Jelly 368g",145000,145000,0,0
TIKI,lam-dep-suc-khoe,147731249,"Hỗ trợ giảm đau nhức xương khớp Move Free Ultra 3xTriple Action Mỹ  phòng loãng xương, tăng trưởng và hồi phục sụn, tăng chất nhầy khớp - Massel Official 75Viên/Hộp",818000,1662000,844000,51
TIKI,lam-dep-suc-khoe,172120328,"Thuốc nhỏ mắt VRohto Vitamin hỗ trợ cải thiện thị lực, giảm viêm, ngứa, mỏi mắt (Lọ 13ml)",52000,52000,0,0
TIKI,lam-dep-suc-khoe,68577434,"TINH CHẤT VITAMIN C TRẮNG DA, CẤP NƯỚC, PHỤC HÔI DA  300SKIN HYALURONIC ACID SERUM 50ML ",295000,295000,0,0
TIKI,lam-dep-suc-khoe,52485981,"Son Dưỡng Môi Vaseline Stick 4.8g",67000,71000,4000,6
TIKI,lam-dep-suc-khoe,116409375,"Dầu Xả Ogx Biotin & Collagen Conditioner 385ml",295000,295000,0,0
TIKI,lam-dep-suc-khoe,140537916,"Kem mụn thịt mụn gạo Tsububoron Nhật Bản/Kem xóa nốt ruồi Tsubuporon 20g - Nhật Bản",269000,269000,0,0
TIKI,lam-dep-suc-khoe,56404021,"Kem Ngừa Đồi Mồi Và Dưỡng Trắng Da Tay KPEM 50ml NGA",109000,115000,6000,5
TIKI,lam-dep-suc-khoe,100042711,"[CHÍNH HÃNG] Khẩu trang y tế kháng khuẩn 3 lớp Famapro 5D quai vải [ HỘP",9900,9900,0,0
TIKI,lam-dep-suc-khoe,159849436,"Tăm bông người lớn Pharmacity",12000,12000,0,0
TIKI,lam-dep-suc-khoe,12107911,"Nước Hoa Nữ Versace Bright Crystal - Eau De Toilette (30ml)",890000,1799000,909000,51
TIKI,lam-dep-suc-khoe,26115743,"Viên Uống Hỗ Trợ Giảm Cân Bổ Sung Dầu Dừa DHC FORSKOHLII SOFT CAPSULE",395000,450000,55000,12
TIKI,lam-dep-suc-khoe,113737706,"Glucosamine Mỹ Schiff Move Free Joint Health Advanced Glucosamine + Chondroitin - Giảm các triệu chứng đau nhức xương khớp hiệu quả - Massel Official -200 Viên",940000,1880000,940000,50
TIKI,lam-dep-suc-khoe,105626104,"Bộ 4 Bao Cao Su Durex Jeans - Hộp 3 Bao ",144000,196000,52000,27
TIKI,lam-dep-suc-khoe,180223850,"Dầu chăm sóc da giúp cải thiện rạn da, mờ sẹo và đều màu da - BIO-OIL SKINCARE OIL (chai 60ml)",195000,205000,10000,5
TIKI,lam-dep-suc-khoe,166766373,"Thuốc nhỏ mắt Pharmacity Eye Drops xuất xứ Anh Quốc (10ml)",39200,49000,9800,20
TIKI,lam-dep-suc-khoe,194487212,"Kem dưỡng ẩm làm sáng chống nắng cho da innisfree Cherry Blossom Glow Skin-Fit Tone-Up Cream SPF 50+PA++++ 50ml",502000,570000,68000,12
TIKI,lam-dep-suc-khoe,72049088,"Kem chống nắng Decumar Advaced Sunblock hoàn toàn mới 50g",175000,175000,0,0
TIKI,lam-dep-suc-khoe,16214309,"Tắm gội 2 trong 1 Romano Force mạnh mẽ tự tin phiên bản Deluxe nhanh chóng tiện dụng 650gr",150000,191000,41000,21
TIKI,lam-dep-suc-khoe,26115341,"Viên uống Làm Đẹp Da DHC Collagen Nhật Bản",161000,195000,34000,17
TIKI,lam-dep-suc-khoe,178561374,"Muối tẩy tế bào chết làm sạch da đầu Dr.FORHAIR Sea Salt Scaler 50g",139000,149000,10000,7
TIKI,lam-dep-suc-khoe,171564936,"Gel Chống Nắng Vật Lý Bảo Vệ Da Dưỡng Ẩm Sunplay Skin Aqua Mineral Defense Moisture Gel SPF35+  PA++++ 25g",97000,97000,0,0
TIKI,lam-dep-suc-khoe,14245533,"Nước uống Collagen làm trắng da Pure White Nhật Bản ",455700,455700,0,0
TIKI,lam-dep-suc-khoe,4423591,"Thực Phẩm Chức Năng Tinh Chất Hàu Tươi Nhật Bản Orihiro 120 Viên",319000,352800,33800,10
TIKI,lam-dep-suc-khoe,15778022,"Bột rửa mặt Thảo mộc TAP TAP Từ Bột Đậu Đỏ Trà Xanh Yến Mạch Cám Gạo Giảm Mụn Ẩn Mụn Cám Mụn Đầu Đen An Toàn Từ Thiên Nhiên Cỏ Mềm 50g",83000,90000,7000,8
TIKI,lam-dep-suc-khoe,73674536,"Máy Khuếch Tán Tinh Dầu Tặng Kèm Tinh Dầu Sả Chanh Cao Cấp - Máy Xông Tinh Dầu Có Remote Điều Khiển Từ Xa, Dung Tích Lớn Chuyên Dụng Cho Phòng Rộng",299000,598000,299000,50
TIKI,lam-dep-suc-khoe,114129415,"Combo 2 Sáp khử mùi trắng da Enchanteur Sensation 40g/chai",151000,184000,33000,18
TIKI,lam-dep-suc-khoe,14758377,"Thực phẩm bổ sung: KIRKLAND SIGNATURE VITAMIN E 400 I.U",370000,370000,0,0
TIKI,lam-dep-suc-khoe,173564760,"Combo 4 hộp ALIPAS tăng cường sinh lý nam 30 viên tặng 1 hộp 15 viên",3000000,3380000,380000,11
TIKI,lam-dep-suc-khoe,3705851,"Combo 2 Tuýp Kem Đánh Răng Lô Hội Forever Bright Toothgel 130g/tuýp",285000,380000,95000,25
TIKI,lam-dep-suc-khoe,190472560,"Khẩu trang trẻ em 5D An Tâm, trẻ em 0-10 tuổi, kháng khuẩn, kháng virus, ôm vừa mặt,chứng nhận tiêu chuẩn sản phẩm",6900,6900,0,0
TIKI,lam-dep-suc-khoe,186271173,"Khẩu trang y tế 4D (KF94) NPCARE Hope Xanh  hy vọng (H/10c)",30000,30000,0,0
TIKI,lam-dep-suc-khoe,877310,"Combo 5 Miếng Dán hỗ trợ điều trị Mụn Mayancare 12 Miếng (1.0cm)",144000,175000,31000,18
TIKI,lam-dep-suc-khoe,25442104,"Gel chì kẻ mắt Bbia Last Auto Gel Eyeliner Slim 0.1g (5 màu)",135000,230000,95000,41
TIKI,lam-dep-suc-khoe,58667454,"Combo 2 Sữa tắm hương nước hoa Enchanteur Sensation 650gr/ Chai",304000,392000,88000,22
TIKI,lam-dep-suc-khoe,548296,"Xịt Khoáng Giúp Làm Sạch Và Dịu Da La Roche-Posay Serozinc (150ml)",259000,395000,136000,34
TIKI,lam-dep-suc-khoe,55607446,"Combo 3 Xà Phòng Cám Gạo Dưỡng Trắng Giảm Mụn Thâm Jam THÁI LAN",49000,49000,0,0
TIKI,lam-dep-suc-khoe,192988869,"300 cái khẩu trang KF94 - 4D Hoa Tuyết An Tâm, khẩu trang có giấy phép bộ y tế cấp",8500,8500,0,0
TIKI,lam-dep-suc-khoe,126689830,"Viên Uống Phụ Khoa- Men Vi Sinh Vùng Chữ Y LAVIMA BIOTIC",210000,210000,0,0
TIKI,lam-dep-suc-khoe,7541267,"Set 2 Dao Cạo Lông Mày Kai 01-158",44100,52920,8820,17
TIKI,lam-dep-suc-khoe,272919105,"Khẩu Trang Trẻ Em Tenamyd Chính Hãng",100000,125000,25000,20
TIKI,lam-dep-suc-khoe,116522296,"HÀNG CHÍNH HÃNG- Cân điện tử Camry EB5681, trọng tải tối đa 150kg- Thiết kế sang trọng, hiện đại",179000,179000,0,0
TIKI,lam-dep-suc-khoe,8142273,"Kềm Cắt Da Thép Không Gỉ Kềm Nghĩa D-04(14)",175000,175000,0,0
TIKI,lam-dep-suc-khoe,68554897,"Gel Rửa Mặt La Roche-Posay Hỗ Trợ Giảm Mụn Cho Mặt & Toàn Thân Effaclar Micro-Peeling Purifying Gel 50Ml",44000,70000,26000,37
TIKI,lam-dep-suc-khoe,177315380,"Khẩu trang Bông Bạch Tuyết KF94 4 lớp - Đen (10 cái/gói)",20000,20000,0,0
TIKI,lam-dep-suc-khoe,15194434,"Sáp vuốt tóc Apestomen Nitro Wax",249000,249000,0,0
TIKI,lam-dep-suc-khoe,63690465,"Combo 3 Hộp Bột Lá Nhuộm Tóc Ogatic Màu Nâu",280000,450000,170000,38
TIKI,lam-dep-suc-khoe,95738221,"Sữa dưỡng thể Vaseline xanh lá Total Moisture Aloe Fresh Hydrating Body Lotion 725ml mẫu mới",143000,143000,0,0
TIKI,lam-dep-suc-khoe,58488552,"Tinh Dầu Hoa Anh Thảo Blackmores Evening Primrose Oil 190 viên - mẫu 2020",500000,500000,0,0
TIKI,lam-dep-suc-khoe,198102288,"Lăn khử mùi Perspirex Strong: khử mùi hôi nách và ngăn tiết mồ hôi loại mạnh",290000,290000,0,0
TIKI,lam-dep-suc-khoe,113843414,"Máy Cạo Lông / Máy Tẩy Lông Không Dây Đời Mới Pin Lithium Tích Điện - Có Thời Gian Sử Dụng Liên Tục Trong 1 Giờ - Sạc Điện Bằng Cáp USB (Đã Bao Gồm) - Hàng Chính Hãng",182000,219000,37000,17
TIKI,lam-dep-suc-khoe,1628057,"Lăn khử mùi và giúp khô thoáng vùng da dưới cánh tay 48h Vichy 50ml",235000,255000,20000,8
TIKI,lam-dep-suc-khoe,158222388,"Viên uống đẹp da Collagen Sắc Ngọc Khang 120 viên thế hệ mới giúp sáng da, giảm nếp nhăn - đốm nâu, nuôi dưỡng và làm đẹp da , tóc, móng",620000,680000,60000,9
TIKI,lam-dep-suc-khoe,100265407,"Cao Gừng Nghệ Đỏ Thanh Lăn Tan Mỡ 180ml",105000,105000,0,0
TIKI,lam-dep-suc-khoe,71056691,"Gel rửa mặt tạo bọt cho da nhạy cảm Bioderma Sensibio Gel Moussant - 45ml",135000,135000,0,0
TIKI,lam-dep-suc-khoe,198324072,"Dầu gội Matrix gội là đen - gội là nâu",27000,27000,0,0
TIKI,lam-dep-suc-khoe,270549724,"Xịt keo Ong Vitatree Super Propolis Spray Complex tăng sức đề kháng, kháng khuẩn, nấm, giảm viêm họng, ho, nhiệt miệng - QuaTangMe Extaste",136000,272000,136000,50
TIKI,lam-dep-suc-khoe,55789949,"Sữa Rửa Mặt Gạo CIVIC Rice Milk 180ml THÁI LAN",39000,39000,0,0
TIKI,lam-dep-suc-khoe,4354111,"Bột lá nhuộm tóc màu Nâu Đỏ Lá Móng Ogatic 50gr thảo dược",96000,150000,54000,36
TIKI,lam-dep-suc-khoe,548110,"Sữa Tắm L'amont En Provence Cherry Blossom Shower Gel Hương Hoa Anh Đào Chai 500ml ",99000,149000,50000,34
TIKI,lam-dep-suc-khoe,193525452,"Tẩy da chết Dove Exfoliating Body Polish bản Mỹ 298g",195000,195000,0,0
TIKI,lam-dep-suc-khoe,118124195,"Viên uống RITANA trắng da mờ sạm nám với L-Glutathion, Sakura, Pomegranate, P.Leucotomos, collagen (30 viên)",330000,330000,0,0
TIKI,lam-dep-suc-khoe,158762711,"Combo hoàn hảo Oniiz - Bọt vệ sinh nam giới dung dịch tạo bọt mịn 100ml & Nước hoa nam giới THE PARIS & THE MIAMI 10ml",299000,299000,0,0
TIKI,lam-dep-suc-khoe,20315732,"Nước súc miệng cai thuốc lá Thanh Nghị - Chai 400ml",225000,400000,175000,44
TIKI,lam-dep-suc-khoe,58916813,"Lăn Khử Mùi ETIAXIL Détranspirant Traitement Aisselles Peaux Normales 15ml (Dành Cho Da Thường) + Tặng 1 Móc Khóa Nhựa 2 Mặt",249000,320000,71000,22
TIKI,lam-dep-suc-khoe,74465822,"	 Nước Hoa Hồng Dr.Pepti+ Dưỡng Da Căng Bóng  Centella Toner (180ml )",315000,350000,35000,10
TIKI,lam-dep-suc-khoe,82040987,"Bột tiệt trùng cốc nguyệt san Lincare đánh bay 99,9% vi khuẩn, tẩy ố và khử khuẩn siêu tốc (Hộp 12 gói x 2g)",149000,149000,0,0
TIKI,lam-dep-suc-khoe,270813246,"Vitamin cho bà bầu Prenatal Folic Acid+ DHA Nature Made giúp mẹ khỏe, bé phát triển não bộ, hệ thần kinh và thể lực - QuaTangMe Extaste",925000,1880000,955000,51
TIKI,lam-dep-suc-khoe,73207101,"Mật ong nguyên chất - Mật hoa cafe (1L)",111000,111000,0,0
TIKI,lam-dep-suc-khoe,66618934,"Natureine AQUA PEEL Moisture Peeling Gel - Chai 30ml - Gel tẩy tế bào da chết, cấp ẩm Nhật Bản - Chính Hãng",90000,120000,30000,25
TIKI,lam-dep-suc-khoe,74308679,"Máy Đo Đường Huyết Safe Accu Chính Hãng Sinocare Tặng Kèm 50 Que Thử+50 Kim Chích Máu",239000,239000,0,0
TIKI,lam-dep-suc-khoe,59476479,"Bao cao su Liebe kéo dài thời gian, gai nổi lớn - Hộp 12 cái",36800,40000,3200,8
TIKI,lam-dep-suc-khoe,22653543,"Gôm xịt tóc giữ nếp cứng Schwarzkopf OSiS + 3 Session Extreme Hold Hairspray 300ml",310000,310000,0,0
TIKI,lam-dep-suc-khoe,249029146,"Viên Uống Ăn Ngủ Ngon Dân Khang",104000,155000,51000,33
TIKI,lam-dep-suc-khoe,177518984,"Saffron mật ong Kingdom Herb chính hãng thượng hạng nguyên chất 100% hộp 311g (tặng que lấy mật và bình thuỷ tinh)",321000,629000,308000,49
TIKI,lam-dep-suc-khoe,73237382,"Dầu gội Head&Shoulders Bạc hà 1800ml",319000,319000,0,0
TIKI,lam-dep-suc-khoe,89931480,"Bộ 3 chai Dung Dịch Vệ Sinh Phụ Nữ Lactacyd Odor Fresh Ngăn Mùi 24H 250ml/chai",221000,267000,46000,17
TIKI,lam-dep-suc-khoe,142904041,"Tinh Chất Phục Hồi, Cấp Ẩm Smas Pro Vitamin B5 Hydra Serum 120ml",439000,459000,20000,4
TIKI,lam-dep-suc-khoe,87378418,"Kissing Spray Juicy Kiss vị Đào chai 20ml - LOLI & THE WOLF, Tặng Kèm Mút Rửa Mặt",139000,139000,0,0
TIKI,lam-dep-suc-khoe,603955,"Kem Tẩy Lông Chiết Xuất Bơ Cleo Dành Cho Da Nhạy Cảm 25g, an toàn, không đau và đạt hiệu quả nhanh chóng",49000,60000,11000,18
TIKI,lam-dep-suc-khoe,10858345,"Tinh bột nghệ vàng An Bình",245000,245000,0,0
TIKI,lam-dep-suc-khoe,559924,"Tinh Chất Serum Làm Trắng Da Dew&Dew 24k Gold Collagen Serum Whitening - DEW&DEW01 - 50ml",146300,230000,83700,36
TIKI,lam-dep-suc-khoe,77014770,"Kem Bôi Trơn Khi Quan Hệ Của Nhật Bản Sagami 60g - Không Mùi Không Vị - Gốc Nước Dễ Rửa Sạch - Tặng Kèm Gel Jex Nhật - Hàng Chính Hãng 100% - Che Tên Sản Phẩm",250000,250000,0,0
TIKI,lam-dep-suc-khoe,75551920,"Viên Uống Giữ Ẩm Cấp Nước DHC Hyaluronic Acid",299000,350000,51000,15
TIKI,lam-dep-suc-khoe,113083508,"Máy Đo Nhiệt Kế Kachi JXB-315 Cảm Biến Hồng Ngoại có chứng nhận FDA Mỹ",791000,799000,8000,1
TIKI,lam-dep-suc-khoe,9979100,"Combo 10 Gói Mặt Nạ Chiết Xuất Lựu 3W Clinic Fresh Pomeranate Mask Sheet (23ml x 10)",55000,55000,0,0
TIKI,lam-dep-suc-khoe,54418197,"Bột lá nhuộm tóc OGATIC 50g ( Bao Bì Mới)- Đen tự nhiên",96000,150000,54000,36
TIKI,lam-dep-suc-khoe,145177161,"Dầu massage body Sả Gừng giảm cảm giác mệt mỏi vai gáy, lưng, đầu gối Tinh Dầu 100 200ml",180000,180000,0,0
TIKI,lam-dep-suc-khoe,24503369,"Gậy chống batoong 1 chân xếp gọn Lucass Y597",195000,230000,35000,15
TIKI,lam-dep-suc-khoe,491312,"Bông Tẩy Trang Jomi 80 Miếng/Túi",19000,25000,6000,24
TIKI,lam-dep-suc-khoe,141367783,"Dầu gội gừng hà thủ ô Weilaiya 400ml - Nuôi dưỡng và phục hồi hư tổn cho mái tóc",265000,265000,0,0
TIKI,lam-dep-suc-khoe,17912240,"Kem dưỡng da, làm mờ sẹo Klirvin Cream Nga (25g/Tuýp)",45000,45000,0,0
TIKI,lam-dep-suc-khoe,267098650,"Xịt Chống Nắng Dạng Phun Sương Kiểm Soát Dầu La Roche-Posay Anthelios Invisible Fresh Mist SPF 50+ UVB & UVA (75ml)",499000,575000,76000,13
TIKI,lam-dep-suc-khoe,25202449,"Avène Kem Dưỡng Da Làm Dịu Cơn Ngứa Tức Thời XeraCalm AD Lipid-Replenishing Cream 200ml",702000,739000,37000,5
TIKI,lam-dep-suc-khoe,196889653,"Máy Massage Cầm Tay VinBuy - 6 Cấp Độ, Hỗ Trợ Mát Xa Chuyên Sâu, Giảm Đau Cơ, Cứng Khớp - Quà Tặng Cho Sức Khỏe",435000,850000,415000,49
TIKI,lam-dep-suc-khoe,204877913,"Cân sức khỏe Life360",170000,290000,120000,41
TIKI,lam-dep-suc-khoe,193088012,"Máy massage chân 3in1 Xiaomi ZMZ-X5 (Bồn ngâm chân thông minh HITH X5) - Hàng Chính Hãng",2285000,2285000,0,0
TIKI,lam-dep-suc-khoe,11891804,"Thực phẩm chức năng bảo vệ hệ tiêu hóa - Men vi sinh USANTIBIOPRO FORT MDP dạng nước - Hộp 20 ống x 5ml",150000,150000,0,0
TIKI,lam-dep-suc-khoe,127153070,"Bột Trắng Răng Eucryl Tooth Powder Nhập Khẩu Anh Quốc (50g) - Massel Official",105000,212000,107000,50
TIKI,lam-dep-suc-khoe,192203142,"Máy chống ngáy ngủ bằng xung điện CTFAST, hỗ trợ giảm ngủ ngáy và giúp điều hòa nhịp thở, thiết kế nhỏ gọn phù hợp với mọi người đem lại giấc ngủ trọn vẹn, hiệu quả sau 2 tháng sử dụng",270000,329000,59000,18
TIKI,lam-dep-suc-khoe,15402733,"Gel rửa mặt trắng sáng, trẻ hóa da ISIS Pharma Neotone Gel 150ml",454000,468000,14000,3
TIKI,lam-dep-suc-khoe,5136595,"Sữa rửa mặt Fixderma Non Drying Cleanser (60g)",169000,205000,36000,18
TIKI,lam-dep-suc-khoe,6493141,"Xịt thơm miệng Beauty Formulas Fresher Breath Spray 15ml - hương bạc hà ​​​​​​​",82000,82000,0,0
TIKI,lam-dep-suc-khoe,5744713,"Đèn Hồng Ngoại TNE Lamp",349000,349000,0,0
TIKI,lam-dep-suc-khoe,6312781,"Nước rửa tay khử mùi Mr.Fresh 5L Hương Táo",162000,162000,0,0
TIKI,lam-dep-suc-khoe,115129321,"SỮA DƯỠNG THỂ CHỐNG NẮNG, DƯỠNG ẨM VÀ LÀM SÁNG DA HATOMUGI SPF50+ PA",105000,105000,0,0
TIKI,lam-dep-suc-khoe,179158883,"Máy đo đường huyết OneTouch Select Plus Simple",1000000,1000000,0,0
TIKI,lam-dep-suc-khoe,186267943,"Bộ đai chườm nóng thảo dược giảm đau khuỷu tay dùng điện - Hapaku",539000,539000,0,0
TIKI,lam-dep-suc-khoe,16392632,"Xà Bông Tắm Và Rửa Mặt Trà Xanh Mát Lạnh Sảng Khoái An Toàn Từ Thiên Nhiên Cỏ mềm 90g",123000,130000,7000,5
TIKI,lam-dep-suc-khoe,87703885,"Combo 4 gói (360 cây) tăm chỉ nha khoa Okamura (90 cây/gói)",179000,179000,0,0
TIKI,lam-dep-suc-khoe,2775371,"Bao Cao Su Sagami Xtreme White (3 Cái / Hộp)",23000,23000,0,0
TIKI,lam-dep-suc-khoe,118124179,"Viên uống ANGELA GOLD tăng cường sinh lý nữ với Lepidium Meyenii, P.Leucotomos (60 viên)",720000,720000,0,0
TIKI,lam-dep-suc-khoe,96309591,"Dầu gội khô Batiste dry shampoo 200ml TẶNG mặt nạ Sexylook (Nhập khẩu)",138600,198000,59400,30
TIKI,lam-dep-suc-khoe,33229675,"Nẹp ngón tay kín United Medicare (E01)",120000,150000,30000,20
TIKI,lam-dep-suc-khoe,68819486,"Tinh Dầu Xịt Bưởi Vijully Hỗ Trọ Kích Thích Mọc Tóc Chai 150ml(Mẫu mới)",109000,115000,6000,5
TIKI,lam-dep-suc-khoe,186192786,"Combo Tẩy Da Chết Và Gel Dưỡng Trắng Giảm Thâm Nách, Mông, Bikini Rewhitez Hương Nước Hoa Ngọt Ngào Happiness Tuýp 50g",365000,423000,58000,14
TIKI,lam-dep-suc-khoe,78498187,"Dụng Cụ Cạo Lưỡi Người Lớn Sản Xuất Tại Thụy Sĩ Trisa Double Action - Hồng",84000,110000,26000,24
TIKI,lam-dep-suc-khoe,176098208,"Nước tẩy trang da dầu mụn ELDAS, tinh chất TRÀM TRÀ, sạch sâu không cồn thẩm thấu nhanh giảm kích ứng ELDAS 250ml",89000,150000,61000,41
TIKI,lam-dep-suc-khoe,63496813,"Serum hỗ trợ trị mụn Detox Blanc Peel Acnes Blanc 40ml (Serum H cho da nhiều mụn)",190000,190000,0,0
TIKI,lam-dep-suc-khoe,79316295,"Băng cá nhân MONOPLAST (Hộp 100 miếng)",54000,60000,6000,10
TIKI,lam-dep-suc-khoe,162844540,"Cao Nám Insam DR CELL 20g",855000,950000,95000,10
TIKI,lam-dep-suc-khoe,442830,"Cân Điện Tử Mặt Kính Beurer GS 14",425000,425000,0,0
TIKI,lam-dep-suc-khoe,68659707,"KHẨU TRANG Y TẾ KOREA, 04 LỚP",30000,30000,0,0
TIKI,lam-dep-suc-khoe,5136667,"Gel làm mờ sẹo Fixderma Scar gel (15ml)",188000,278000,90000,32
TIKI,lam-dep-suc-khoe,8142305,"Bấm Móng Kềm Nghĩa B-904",53000,53000,0,0
TIKI,lam-dep-suc-khoe,8142267,"Kềm Cắt Da Thép Không Gỉ Kềm Nghĩa D-09(16)",175000,175000,0,0
TIKI,lam-dep-suc-khoe,169815915,"Kem chống nắng dạng gel giúp giảm mụn kiểm soát bóng nhờn và thu nhỏ lỗ chân lông La Roche-Posay Anthelios Oil Correct 50ml",385000,550000,165000,30
TIKI,lam-dep-suc-khoe,694387,"Tinh Dầu Bạc Hà Lorganic (10ml)",45000,90000,45000,50
TIKI,lam-dep-suc-khoe,111223249,"Khăn Lau SÁT KHUẨN BỀ MẶT SARAYA SARACIDE SANITIZING WIPES - Hộp 80 cái (Sử dụng trong Y TẾ và SINH HOẠT hằng ngày, Phân loại TTBYT: 421/190000031/PCBPL-BYT)",216000,216000,0,0
TIKI,lam-dep-suc-khoe,70509100,"Kem A313 Pommade Retinol Cream Ngừa Mụn, Chống Lão Hóa, Hỗ Trợ Giảm Nếp Nhăn 50g (Bản nội địa không dùng cho phụ nữ có bầu)",285000,293000,8000,3
TIKI,lam-dep-suc-khoe,175106243,"Xịt Khử Mùi Nam Body Mist Nam Gatsby Perfume Body Spray - Tặng móc khoá chính hãng",119000,119000,0,0
TIKI,lam-dep-suc-khoe,170066632,"Combo 3 Gói Khẩu trang Bông Bạch Tuyết Trẻ Em bé 2 lớp cho trẻ từ 1 - 5 tuổi (8 cái/gói)",94500,94500,0,0
TIKI,lam-dep-suc-khoe,69064268,"Bồn ngâm chân massage cao cấp USA 6 con lăn tự động, vòi phun massage, Serenelife SLIFTSP12 nhập khẩu ",2155000,3200000,1045000,33
TIKI,lam-dep-suc-khoe,878387,"Tỏi Kim Cương Đông Á - Tỏi Đen Cô Đơn - Hộp 200g",270000,390000,120000,31
TIKI,lam-dep-suc-khoe,205080744,"Viên uống tăng cường sinh lý nam giới Powergra (Super Gold Magic) - Vỉ 3 viên",506000,550000,44000,8
TIKI,lam-dep-suc-khoe,114778801,"[Chính Hãng] Bàn Chải Đánh Răng Điện Zenyum Sonic T11 - Màu Đen Matte - Công Nghệ Singapore",1159000,1500000,341000,23
TIKI,lam-dep-suc-khoe,8211890,"Dũa Móng Giấy DG-402A - Kềm Nghĩa",27600,30000,2400,8
TIKI,lam-dep-suc-khoe,7222191,"Kem dưỡng ẩm cho da nhạy cảm và lão hóa RESIST ANTI-ANGING CLEAR SKIN HYDRATOR 50 ml",919000,1050000,131000,12
TIKI,lam-dep-suc-khoe,158744112,"Tăm bông thân giấy Pharmacity",17000,17000,0,0
TIKI,lam-dep-suc-khoe,164941170,"Gel Bôi Trơn Sagami Original (60g) - Trong Suốt - Không Màu - Không Mùi - 100% Nhập Khẩu Nhật Bản - Che Tên Sản Phẩm",169000,279000,110000,39
TIKI,lam-dep-suc-khoe,102767167,"Viên uống chống nắng PIOME SUN",800000,800000,0,0
TIKI,lam-dep-suc-khoe,7722302,"Combo 10 đắp mặt nạ hàn quốc trắng da hỗ trợ điều trị mụn BENEW ( 22ml/ gói) MIX VỊ NGẪU NHIÊN",95000,95000,0,0
TIKI,lam-dep-suc-khoe,2984005,"Dầu Gội Xả Hoa Bưởi Thorakao (400ml)",69000,69000,0,0
TIKI,lam-dep-suc-khoe,55461727,"Kem Dưỡng Sáng Da Laneige Radian-C Cream 50ml",967000,1200000,233000,19
TIKI,lam-dep-suc-khoe,933535,"Bao Cao Su Tâm Thiện Chí Guardian Gia Đình (Hộp 144 Cái)",145000,150000,5000,3
TIKI,lam-dep-suc-khoe,175779580,"Sữa Chống Nắng Dưỡng Da Shiseido Urban Environment Triple Beauty Suncare EmulsionSPF50+ PA++++ 30ml",1250000,1250000,0,0
TIKI,lam-dep-suc-khoe,113827043,"Bộ lấy ráy tai đa năng 6 món Cao cấp bằng thép không rỉ KitAcoom, hàng nhập khẩu cao cấp có hộp đựng",37199,39999,2800,7
TIKI,lam-dep-suc-khoe,13566978,"Kem dưỡng da chống lão hóa giàu ẩm Shiseido Benefiance Wrinkle Smoothing Cream Enriched 50ml",1850000,1850000,0,0
TIKI,lam-dep-suc-khoe,74309093,"ComBo (30 Chiếc) Khẩu Trang Trẻ Em Hàn Quốc Form 2D Anyguard Chính Hãng - Quai Đeo Siêu Đàn Hồi (10 gói) - 베이비 마스크 - Face Mask For Kids - ISO 9001:2015, ISO 13485:2016, QCVN 01:2017/BTC",73000,74900,1900,3
TIKI,lam-dep-suc-khoe,73317762,"Nước xịt dưỡng tóc tinh dầu bưởi pomelo cocoon 140ml + Serum mọc tóc pomelo bồ kết herbario 30ml",350000,350000,0,0
TIKI,lam-dep-suc-khoe,169956184,"Glutathione 600 - Viên Uống Trắng Da Glutathione Dr.Lacir :Đẹp Da, Mờ Nám, Cân Bằng Nội Tiết Tố (Chính Hãng Dr Lacir)",580000,580000,0,0
TIKI,lam-dep-suc-khoe,36158816,"Kem ủ trắng toàn thân Truesky Whitening Body Cream chiết xuất rễ cây cam thảo 100g",98000,160000,62000,39
TIKI,lam-dep-suc-khoe,63597395,"Kem dưỡng da nhập khẩu ÚC Redwin Cream with Vitamin E 300g",95000,148000,53000,36
TIKI,lam-dep-suc-khoe,55615086,"Kem Dưỡng Ẩm Trắng Da Ban Đêm Tế Bào Gốc Phục Hồi Trẻ Hoá Da Và Chống Lão Hoá Cellkey-Scien White Cream (30g)",833000,980000,147000,15
TIKI,lam-dep-suc-khoe,8094768,"Nước Cân Bằng Giàu Khoáng Dành Cho Da Nhạy Cảm La Roche-Posay Soothing Lotion Sensitive Skin - 200ml",370000,585000,215000,37
TIKI,lam-dep-suc-khoe,6884515,"Sữa rửa mặt dạng bùn Trà tràm – Naruko Tea Tree Purifying Clay Mask and Cleanser in 1 (120g)",239000,239000,0,0
TIKI,lam-dep-suc-khoe,522617,"Kem Làm Giảm Mụn Và Loại Bỏ Dầu Cho Da SVR Sebiaclear Active Tuýp 40ml - SAC",290000,475000,185000,39
TIKI,lam-dep-suc-khoe,12084544,"Tinh chất hỗ trợ làm mờ thâm nám Eucerin UltraWHITE+ SPOTLESS SPOT CORRECTOR (5ml)",495000,670000,175000,26
TIKI,lam-dep-suc-khoe,911335,"Sữa Rửa Mặt Dưỡng Ẩm, Làm Sạch Sâu Chiết Xuất Hoa Cúc - Oribe Facial Cleanser 100g",88000,125000,37000,30
TIKI,lam-dep-suc-khoe,3950339,"Sữa Dưỡng Thể Cho Da Nhạy Cảm Eucerin pH5 Skin Protection Lotion (250 ml) (Không Mùi)",156000,231000,75000,32
TIKI,lam-dep-suc-khoe,104051298,"Bộ Dầu Gội Và Xả OGX Thick And Full Biotin & Collagen Của Mỹ 385ml, giảm xơ rối, gãy, rụng, cho tóc dày và suôn mượt",395000,395000,0,0
TIKI,lam-dep-suc-khoe,5812635,"Phấn chống lão hóa mới màu da Phấn Nụ Hoàng Cung",135000,180000,45000,25
TIKI,lam-dep-suc-khoe,156193998,"Combo 3 Bộ Kit Test Covid 19 Tại nhà HUMASIS Hàn Quốc (Chính hãng)",105000,105000,0,0
TIKI,lam-dep-suc-khoe,9849188,"Máy xông khí dung Omron NE-C101",789000,1250000,461000,37
TIKI,lam-dep-suc-khoe,131504789,"Dầu xả dược liệu Thái Dương 3 200ml/ 600ml/ 1100ml",60000,60000,0,0
TIKI,lam-dep-suc-khoe,50326939,"Kem Dưỡng Ngăn Lão Hóa, Sáng Da Vichy Collagen Liftactiv Collagen Specialist Chuyên Biệt (50ml)",873000,1165000,292000,25
TIKI,lam-dep-suc-khoe,184773476,"Gối Massage Đa Năng VISPO VP-G22 - Máy Mát xa Toàn Thân Nhiệt Hồng Ngoại - Chuyên Sâu Cho Cổ, Vai Gáy, Lưng Dưới, Đùi, Chân - Sử Dụng Tại Nhà, Văn Phòng, Trên Ô Tô",1050000,1050000,0,0
TIKI,lam-dep-suc-khoe,137005295,"Kem Dưỡng Phục Hồi Da Rau Má GoodnDoc Centella Repair Cream 50ml",385000,389000,4000,1
TIKI,lam-dep-suc-khoe,460539,"Dầu Gội Đầu Clear Men Cool Sport Dầu Gội Bạc Hà Mát Lạnh Cực Đỉnh Suốt Ngày Dài Đánh Bay Gàu, Ngứa & Vi Khuẩn 900g",169000,169000,0,0
TIKI,lam-dep-suc-khoe,4354043,"Bột lá nhuộm tóc màu Đen Ogatic 50gr thảo dược",105000,105000,0,0
TIKI,lam-dep-suc-khoe,150310982,"Viên Uống Sáng Mắt Flopti Eye Giảm Khô Mắt, Mờ Mắt, Mỏi Mắt Hộp 30 viên",274000,355000,81000,23
TIKI,lam-dep-suc-khoe,51551162,"Son Dưỡng Táo Hữu Cơ Cỏ Mềm",110000,120000,10000,8
TIKI,lam-dep-suc-khoe,10082226,"Dầu Gội Đen Tóc Thảo Dược LICH 5",206000,234000,28000,12
TIKI,lam-dep-suc-khoe,84593352,"Que thử đường huyết On-call plus (25 que/hộp)",153000,230000,77000,33
TIKI,lam-dep-suc-khoe,1860269,"Kem Dưỡng Trắng Da Và Se Khít Lỗ Chân Lông Zoley 10g",89000,150000,61000,41
TIKI,lam-dep-suc-khoe,88223765,"Viên uống Collagen Sắc Ngọc Khang thế hệ mớI Hộp 60 viên giúp sáng da, giảm nếp nhăn - đốm nâu, nuôi dưỡng và làm đẹp da , tóc, móng",356000,390000,34000,9
TIKI,lam-dep-suc-khoe,8639764,"Kem dưỡng ngăn ngừa nứt gót chân Kpem Cream for Carcks in the feet 50ml",45000,45000,0,0
TIKI,lam-dep-suc-khoe,178560001,"Combo Xà Bông + Sữa Rửa Mặt Nghệ MELA Thiên Nhiên, Làm Sạch Tẩy Da Chết Thoáng Lỗ Chân Lông Giảm Mụn - ML18",260000,260000,0,0
TIKI,lam-dep-suc-khoe,275396880,"Goodhealth Oyster Plus Tinh Chất Hàu 60 Viên - Tăng Cường Sinh Lý - Cải Thiện Chất Lượng Tinh Trùng - Hàng Chính Hãng New Zealand",387000,395000,8000,2
TIKI,lam-dep-suc-khoe,1362447,"Sữa Rửa Mặt Cetaphil Gentle Skin Cleaner (500ml) - 8394107341305,9318637069637",328000,419000,91000,22
TIKI,lam-dep-suc-khoe,164075481,"An Trĩ Vương Hỗ Trợ Cải Thiện Táo Bón Giúp Thanh Nhiệt, Giải Độc Có Thể Sử Dụng Cho Phụ Nữ Có Thai Hộp 30 Viên",185000,185000,0,0
TIKI,lam-dep-suc-khoe,76134019,"[HỘP - FAMAPRO MAX KID] - khẩu trang y tế trẻ em kháng khuẩn 3 lớp Famapro Max Kid (50 cái/ hộp) - 1 HỘP",24000,36000,12000,33
TIKI,lam-dep-suc-khoe,150269406,"Bộ Dưỡng Trắng Da Tế Bào Gốc Phục Hồi Trẻ Hoá Da Và Chống Lão Hoá Cellkey-Scien Repair System White Set (60ml)",1581000,1860000,279000,15
TIKI,lam-dep-suc-khoe,52053647,"Combo 02 Dầu Gội Ngăn Ngừa Gàu Clear Mát Lạnh Bạc Hà",473000,473000,0,0
TIKI,lam-dep-suc-khoe,186271043,"Khẩu trang y tế 4D (KF94) NPCARE Dreamy Tím (H/10c)",30000,30000,0,0
TIKI,lam-dep-suc-khoe,42953037,"Bột Tạo Phồng Apestomen Volcanic Clay Ash 25g",249000,249000,0,0
TIKI,lam-dep-suc-khoe,39607755,"Kem ủ phục hồi tóc Olaplex Hair Perfector No.3 chính hãng Mỹ 100ml",572000,590000,18000,3
TIKI,lam-dep-suc-khoe,837895,"Nước Hoa Hồng Sắc Ngọc Khang MNH01 (145ml)",119000,120000,1000,1
TIKI,lam-dep-suc-khoe,56416336,"Serum Men Bia Trắng Da, Se Khít Lỗ Chân Lông 300SKIN Galactomyces Beer Extract Serum 50ml",176300,295000,118700,40
TIKI,lam-dep-suc-khoe,94474533,"Kềm Cắt Da Thép Chuyên Dụng Mạ Vàng KỀM NGHĨA D.777",90000,90000,0,0
TIKI,lam-dep-suc-khoe,5925677,"Miếng dán tẩy lông Beauty Formulas Wax Strips Legs and Body - hộp 20 miếng",157000,157000,0,0
TIKI,lam-dep-suc-khoe,50700392,"Nước hoa hồng Dưỡng Ẩm Và Làm Dịu Da Bioderma Sensibio Tonique",369000,435000,66000,15
TIKI,lam-dep-suc-khoe,86018845,"Ghế bô-xe tắm-xe lăn-ghế ngồi 4 chức năng trong 1",1430000,1430000,0,0
TIKI,lam-dep-suc-khoe,167019461,"Kem Face Collagen X3 dưỡng Trắng da - Ngừa mụn - Nám",135000,195000,60000,31
TIKI,lam-dep-suc-khoe,44073861,"Dầu Gội Tresemmé Keratin Smooth Tinh Dầu Argan Và Keratin Vào Nếp Suôn Mượt (640g)",149000,149000,0,0
TIKI,lam-dep-suc-khoe,80468377,"Dầu dừa tinh khiết mỹ phẩm Vietcoco 130ml",82000,82000,0,0
TIKI,lam-dep-suc-khoe,75380136,"Mẫu mới - Tinh chất dưỡng The Ordinary Alpha Arbutin 2% + HA 30ml  ",341000,348000,7000,2
TIKI,lam-dep-suc-khoe,4704655,"Vớ/tất y khoa đùi Hỗ Trợ Điều Trị suy giãn tĩnh mạch chân JOBST Relief chuẩn áp lực 20-30mmHg",989000,989000,0,0
TIKI,lam-dep-suc-khoe,58473464,"Dầu Dưỡng Tóc RAIP R3 Argan Hair Oil Phục Hồi Tóc Hư Tổn. Tặng Gel Móc Khóa 30ml",139000,139000,0,0
TIKI,lam-dep-suc-khoe,108535241,"Bao cao su Sagami Super Dot 009 - Có gai nhỏ - Dày - Hộp 10 chiếc",95000,120000,25000,21
TIKI,lam-dep-suc-khoe,156957796,"[HCM] Bộ kit FLOWFLEX ACON MỸ test nhanh COVID19 tại nhà, nhập chính hãng được BYT công nhận xuất VAT khi khách yêu cầu",56000,56000,0,0
TIKI,lam-dep-suc-khoe,184216691,"Kem Nền Siêu Mịn Lâu Trôi BB Benew ốc sên Cream Cao Cấp Hàn Quốc ( 50ml)",179000,199000,20000,10
TIKI,lam-dep-suc-khoe,56252523,"(Package mới) Kem dưỡng Simple Kind To Skin Hydrating Light Moisturizer - Thường 125ml",159000,159000,0,0
TIKI,lam-dep-suc-khoe,58407534,"Hộp 50 que thử đường huyết dùng cho máy đo đường huyết OGCare",305000,455000,150000,33
TIKI,lam-dep-suc-khoe,145839587,"Bàn Chải Đánh Răng Điện sóng âm Kachi Sonic MK309",699000,900000,201000,22
TIKI,lam-dep-suc-khoe,58678128,"Dầu Cá Blackmores Oudourless Fish Oil 1000 Mg Hộp 400 Viên không tanh chính hãng Úc mẫu mới 2020",650000,650000,0,0
TIKI,lam-dep-suc-khoe,73784845,"[MUA 1 TẶNG 1] Sữa rửa mặt tạo bọt dịu nhẹ, kiềm dầu, cân bằng độ ẩm, ngừa mụn Rainbow L'affair Multi-Care V5 Facial Foaming Cleanser 150ml",175000,350000,175000,50
TIKI,lam-dep-suc-khoe,118090109,"Viên Sủi Bổ Sung Vitamin C, D, Và Kẽm Redoxon Triple Action 10 Viên",85000,85000,0,0
TIKI,lam-dep-suc-khoe,145221424,"Bộ 6 Khẩu trang dành cho bé Unicharm 3D Mask Kid (Ngăn được bụi mịn PM2.5) gói 5 miếng",149000,149000,0,0
TIKI,lam-dep-suc-khoe,181687259,"Viên Uống DHC Melilot Hỗ Trợ Thon Chân 60 Ngày (120 Viên)",550000,650000,100000,15
TIKI,lam-dep-suc-khoe,95934490,"Combo 16 gói Băng Vệ Sinh Quần Peppy Shana Siêu Thấm Free Size (32 miếng)",251000,456000,205000,45
TIKI,lam-dep-suc-khoe,270813315,"Vitamin cho bà bầu Prenatal Folic Acid+ DHA Nature Made giúp mẹ khỏe, bé phát triển não bộ, hệ thần kinh và thể lực - QuaTangMe Extaste",925000,1880000,955000,51
TIKI,lam-dep-suc-khoe,270808501,"Xịt họng keo Ong Úc Vitatree Super Propolis Spray Complex with Honey 15+ Giúp bổ sung kháng khuẩn tự nhiê, Giảm đau rát viêm họng, ho, nhiệt lỡ miệng - OZ Slim Store",136000,272000,136000,50
TIKI,lam-dep-suc-khoe,154262538,"Viên uống chống nắng UV Screen Rejuvicare - hộp 30 viên ",119800,119800,0,0
TIKI,lam-dep-suc-khoe,389688,"Gel Bôi Trơn Cao Cấp Sagami Original (60g)",165000,210000,45000,21
TIKI,lam-dep-suc-khoe,105042382,"Tinh chất giảm thâm nám và dưỡng sáng da Eucerin Spotless Brightening Booster Serum",1061000,1459000,398000,27
TIKI,lam-dep-suc-khoe,157027735,"Combo 4 Miếng Dán Dùng Cho Máy Massage Xung Điện PEAFLO",35000,45000,10000,22
TIKI,lam-dep-suc-khoe,53653425,"Dầu gội thảo dược HÀ THỦ Ô Chiết xuất từ 6 loại thảo dược - Cân Bằng Sắc Tố Melanin Khỏi lo bạc tóc rụng tóc Cocayhoala 300g",220000,300000,80000,27
TIKI,lam-dep-suc-khoe,94118574,"Băng vệ sinh ban đêm Doctor Care chiết suất thảo dược 33.8cm the mát sảng khoái",16000,18000,2000,11
TIKI,lam-dep-suc-khoe,175167955,"Dầu Gội Sạch Gàu An Toàn Cân Bằng Dầu Nhờn Cỏ Mềm 250ml",207000,225000,18000,8
TIKI,lam-dep-suc-khoe,8098630,"Kem Giảm Mụn, Thâm Mụn, Sẹo Mụn White Doctors Acne Pro",230000,380000,150000,39
TIKI,lam-dep-suc-khoe,178832745,"Cây Lăn Mặt Massage Mặt Bằng Đá Cẩm Thạch ",35000,35000,0,0
TIKI,lam-dep-suc-khoe,85660175,"Sữa Rửa Mặt Nghệ Hưng Yên Cocoon 140ml",195000,195000,0,0
TIKI,lam-dep-suc-khoe,10685635,"Cao Gừng Tan Mỡ Thiên Nhiên Việt (200g) Tặng Kèm Đai Nịt Bụng Cao Cấp An Nhiên",299000,299000,0,0
TIKI,lam-dep-suc-khoe,7240315,"Bộ 10 Gói Mặt Nạ Tuyết Dưỡng Trắng Da 3W Clinic Fresh White Mask Sheet (23ml X 10)",55000,55000,0,0
TIKI,lam-dep-suc-khoe,14901584,"Máy Xông Khí Dung OMRON NE-C803 - Trị Liệu Hô Hấp - Trọng Lượng Nhẹ 180g",1100000,1350000,250000,19
TIKI,lam-dep-suc-khoe,73400011,"Bàn chải kẽ răng SGS loại L nhập khẩu Hàn Quốc",50000,100000,50000,50
TIKI,lam-dep-suc-khoe,56244724,"Nước Hồng Sâm Baby SangA Hàn Quốc Hộp 30 gói",355000,355000,0,0
TIKI,lam-dep-suc-khoe,128213146,"PT CARE | Nước súc miệng Kin Gingival Viêm Nướu, B5, Sensikin Ê Buốt, Fluor Kin Trẻ Em, Ortho Kin Niềng Răng Chỉnh Nha",150000,150000,0,0
TIKI,lam-dep-suc-khoe,78510217,"Combo 3 Tinh Dầu Oải Hương + Tinh Dầu Bạc Hà + Tinh Dầu Cam Ngọt Nguyên Chất - Tinh Dầu TIDAMO Cao Cấp Xông Phòng Giúp Thư Giãn, Thơm Phòng Và Nâng Cao Sức Khỏe (3 chai 10ML)",84000,236000,152000,64
TIKI,lam-dep-suc-khoe,74215409,"Túi chườm nóng lạnh MOHI - Chính hãng- Giao mẫu ngẫu nhiên",26680,29000,2320,8
TIKI,lam-dep-suc-khoe,158100770,"Tinh Dầu Hoa Nhài Treo Phòng, Treo Xe Hơi Tạo Hương Thơm Dịu Nhẹ Quý Phái - Tinh Dầu Hoa Lài TIDAMO (Jasmine) Nhập Khẩu, Có Kiểm Nghiệm Giúp Thơm Phòng, Thư Giãn và Tốt Cho Sức Khỏe",44000,128000,84000,66
TIKI,lam-dep-suc-khoe,520953,"Dao Cạo Râu Gillette Super Click",16000,16000,0,0
TIKI,lam-dep-suc-khoe,186370235,"Kem Body Lục Tảo Luxury Body Cream Dưỡng Trắng Da SOO YOUNG (250g)",105000,210000,105000,50
TIKI,lam-dep-suc-khoe,137672666,"Sữa rửa mặt tẩy tế bào da chết ngừa mụn St.Ives Hoa Hồng & Lô Hội 170g",134000,149000,15000,10
TIKI,lam-dep-suc-khoe,128633299,"Phấn Phủ Dạng Nén Kiềm Dầu The Saem Saemmul Perfect Pore Pact (12g)",240000,240000,0,0
TIKI,lam-dep-suc-khoe,173836553,"Bao cao su Safefit 4in1 hộp 12 cái tặng hộp 3 cái",100000,100000,0,0
TIKI,lam-dep-suc-khoe,54141246,"Tinh dầu hoa Lài (nhài) 100ml Mộc Mây - tinh dầu nguyên chất 100% từ thiên nhiên - chất lượng và mùi hương vượt trội",299000,299000,0,0
TIKI,lam-dep-suc-khoe,522736,"Sữa Rửa Mặt Tẩy Tế Bào Chết SVR Sebiaclear Gel Moussant Tuýp 200ml - SGM",235000,239000,4000,2
TIKI,lam-dep-suc-khoe,21602792,"Dầu gội suôn mượt cho tóc khô L'oreal Hair Spa Deep Nourishing shampoo 600ml",183000,189000,6000,3
TIKI,lam-dep-suc-khoe,10131586,"Combo 4 Hộp Viên Uống Đạm Tăng Cân AVITA Dành Cho Người Gầy, Giúp Tăng Cường Sức Đề Kháng, Nâng Cao Thể Trạng, An Toàn Hiệu Quả 60 Viên/Hộp",648000,792000,144000,18
TIKI,lam-dep-suc-khoe,131504612,"Sữa rửa mặt nghệ sạch mụn, ngừa vết thâm Thái Dương 90g",40000,40000,0,0
TIKI,lam-dep-suc-khoe,26350332,"Xịt Khoáng Khử Clo Sau Khi Bơi SwimRinse",160000,160000,0,0
TIKI,lam-dep-suc-khoe,1022207,"Que Thử Đường Huyết Accu-Chek Instant 25",259000,399000,140000,35
TIKI,lam-dep-suc-khoe,84596223,"Kim chích máu máy đo đường huyết Acon On-call (100 kim / hộp)",39000,69000,30000,43
TIKI,lam-dep-suc-khoe,95067213,"Chai xịt diệt khuẩn Nano bạc AHT trà trắng dùng rửa tay, xịt màn hình, vệ sinh phòng ngủ",76700,76700,0,0
TIKI,lam-dep-suc-khoe,4423229,"Nước rửa tay Premium Hand Soap Mr Fresh Hàn Quốc 5L",160000,160000,0,0
TIKI,lam-dep-suc-khoe,68698970,"Nước Súc Miệng Cai Thuốc Lá Xuân Vinh 400ml - Làm mất cảm giác thèm thuốc, ngăn ngừa các bệnh về răng miệng, thành phần thiên nhiên, an toàn + Tặng kèm móc khoá CLĐ",189000,320000,131000,41
TIKI,lam-dep-suc-khoe,7805771,"Thực Phẩm Chức Năng Tảo Tăng Chiều Cao Shinshin Kakumei Nhật Bản",399000,399000,0,0
TIKI,lam-dep-suc-khoe,146086160,"Dầu Tắm Gội Dapper Dan Hair & Body Shampoo 300ml",330000,330000,0,0
TIKI,lam-dep-suc-khoe,176098198,"Combo Sữa tắm mụn lưng ELDAS diệt khuẩn ngừa mụn 24 giờ &amp; Sữa rửa mặt Eldas mờ thâm da sáng mịn đều màu",175000,185000,10000,5
TIKI,lam-dep-suc-khoe,7146751,"Combo 5 hộp dầu gội thảo dược đen tóc TOSMEDY – Đen tóc không đen da đầu",119000,119000,0,0
TIKI,lam-dep-suc-khoe,178297539,"Sáp tạo kiểu tóc giữ nếp tự nhiên Romano Restyleable Matte Wax 68g/hộp ",74000,82000,8000,10
TIKI,lam-dep-suc-khoe,188127814,"Nước uống collagen thảo dược giúp đẹp da, hỗ trợ ngủ ngon Blossomy Premium lốc 10 chai x 50ml",737000,945000,208000,22
TIKI,lam-dep-suc-khoe,636922,"Bao Cao Su 4 in 1 Gân, Gai, Mỏng, Kéo Dài Quan Hệ Azodra (12 Gói)",68000,68000,0,0
TIKI,lam-dep-suc-khoe,162169413,"Bột nghệ uống liền Set 2 gói 16g Honimore - thơm ngon - đẹp da - tăng cường sức khoẻ",11760,12000,240,2
TIKI,lam-dep-suc-khoe,76182173,"Chống nắng dạng thỏi Shiseido GSC Clear Suncare Stick SPF50+ 20G",780000,780000,0,0
TIKI,lam-dep-suc-khoe,134821636,"Bông phấn,mút phấn trang điểm vuông nhỏ tiện lợi và dễ sử dụng Nhật 727 SDS Sponge",44000,90000,46000,51
TIKI,lam-dep-suc-khoe,26710011,"Combo 10 Túi mặt nạ giấy dưỡng ẩm -Mặt nạ dưỡng da chiết xuất từ lô hội 3W Clinic Hàn Quốc 23mlx10",52000,52000,0,0
TIKI,lam-dep-suc-khoe,217007520,"Trắng da Glutathione Puritan’s Pride L-Glutathione 500mg Hỗ trợ trắng da, Giảm nám, tàn nhang, Thải độc , Tăng hệ miễn dịch - QuaTangMe Extaste",464000,944000,480000,51
TIKI,lam-dep-suc-khoe,179792021,"Dầu chăm sóc da giúp cải thiện rạn da, mờ sẹo và đều màu da - BIO-OIL SKINCARE OIL (chai 25ml)",98000,110000,12000,11
TIKI,lam-dep-suc-khoe,31894793,"Tinh Chất Hỗ Trợ Giảm Mụn & Giảm Thâm The Ordinary Niacinamide 10% + Zinc 1% 30ml",228000,350000,122000,35
TIKI,lam-dep-suc-khoe,25440933,"Kẻ mắt nước Bbia Last Pen Eyeliner 0.6g (5 màu)",109000,200000,91000,46
TIKI,lam-dep-suc-khoe,11961980,"Sữa rửa mặt nghệ nano NeoCleanser",158000,158000,0,0
TIKI,lam-dep-suc-khoe,33605570,"Kem Chống nắng cho da mụn, bị mụn trứng cá Eucerin Sun Gel-Creme oil control Dry Touch SPF50+ 50ml + tặng máy massage mặt ion",466650,549000,82350,15
TIKI,lam-dep-suc-khoe,553392,"Kem tẩy lông Chiết Xuất Bơ Cleo dạng sữa dành cho vùng tay chân dành cho mọi loại da 90ml, an toàn, không đau và đạt hiệu quả nhanh chóng",109000,165000,56000,34
TIKI,lam-dep-suc-khoe,107443285,"Serum Xóa Mụn V9Queen, Giúp Mờ Thâm Nám Dưỡng Trắng Da 20ml",159000,159000,0,0
TIKI,lam-dep-suc-khoe,75933856,"Chì Kẻ Mày 2in1 NoVo Makeup Seduce (Kẻ Mày + Kẻ Mắt)",72000,85000,13000,15
TIKI,lam-dep-suc-khoe,191365627,"Combo 2 Sữa dưỡng thể với thành phần ngừa lão hóa dưỡng sáng VASELINE Healthy Bright Perfect Youth 350ML/chai",300000,300000,0,0
TIKI,lam-dep-suc-khoe,67195678,"Trà Genpi Orihiro 60 gói/túi",155000,300000,145000,48
TIKI,lam-dep-suc-khoe,68494645,"Son dưỡng có màu tự nhiên LipIce Sheer Color Q Mojito Mint 2.4g (Hồng Tự Nhiên) 2.4g",73900,82500,8600,10
TIKI,lam-dep-suc-khoe,33606827,"Kem giảm thiểu tế bào chết Paula’s Choice Skin Perfecting 2% BHA Gel Exfoliant 100ml",855000,949000,94000,10
TIKI,lam-dep-suc-khoe,132081621,"Mặt Nạ Ngủ Phục Hồi Laneige Cica Sleeping Mask EX",300000,320000,20000,6
TIKI,lam-dep-suc-khoe,91947719,"Mặt Nạ Ngủ Môi Zozu Dưỡng Ẩm Chống khô & nứt nẻ môi hiệu quả",49000,49000,0,0
TIKI,lam-dep-suc-khoe,32518505,"Gel Bí Đao Rửa Mặt Cocoon (140ml)",195000,195000,0,0
TIKI,lam-dep-suc-khoe,104745477,"Tăng Cường Sinh Lý Nam Supo Maca Genki Fami Nhật Bản, Chiết Xuất Nhân Sâm, Baba, Hàu Biển - Hộp 90 viên",711000,830000,119000,14
TIKI,lam-dep-suc-khoe,13769238,"Combo 2 Hộp Tảo Xoắn Spirulina Nội Địa Nhật Bản 2200 Viên",715000,715000,0,0
TIKI,lam-dep-suc-khoe,94087656,"Sâm Nhung Bổ Thận TW2 - Không Lo Thận Yếu, Đau Lưng, Tiểu Đêm - Giúp Bổ Thận Tráng Dương - Tăng Cường Sinh Lực - Bổ Thận TW3 Lọ 30 Viên ",53900,55000,1100,2
TIKI,lam-dep-suc-khoe,179980123,"Sữa Tắm Lifebuoy Detox Sạch Sâu Bảo Vệ Khỏi Vi Khuẩn Gây Mùi Cơ Thể Than Hoạt Tính & Cám gạo Chiết Xuất Thiên Nhiên Chai 800G",190000,234000,44000,19
TIKI,lam-dep-suc-khoe,59148842,"Gói Hỗn Hợp Muối Rửa Mũi Xoang Người Lớn- NeilMed SinusRinse Adult 50 Sachets  - Xuất xứ Mỹ.( Hộp 50 gói)",296000,296000,0,0
TIKI,lam-dep-suc-khoe,195822471,"Tăng cân AVITA Medivistar Pharma (Liệu Trình 3 Hộp) cho người gầy yếu, không tích nước, hộp 60 viên",188000,198000,10000,5
TIKI,lam-dep-suc-khoe,24989322,"Mỡ Trăn N'store Triệt Lông, Trị Bỏng, Làm Mờ Rạn Da, Trị Mụn - Se Khít Lỗ Chân Lông, Lành Sẹo, Nhả Nắng, Nhanh Lành Các vết Dị Ứng(hũ 75gr)",90000,90000,0,0
TIKI,lam-dep-suc-khoe,84783740,"BÌNH RỬA MŨI WATER PULSE TẶNG KÈM 30 GÓI MUỐI SEAKIT",155000,155000,0,0
TIKI,lam-dep-suc-khoe,270794747,"Collagen +C nước lựu Mỹ Neocell tạo sức khỏe và vẻ đẹp từ bên trong cho da, tóc, móng, xương khớp, tim mạch và tăng hệ miễn dịch - QuaTangMe Extaste",896000,1822000,926000,51
TIKI,lam-dep-suc-khoe,248788942,"Vitamin tổng hợp cho người dưới 50 tuổi Kirkland Multivitamin tăng cường sức đề kháng, tăng sức khỏe tổng thể, giảm mệt mỏi - Massel Official",681000,1384000,703000,51
TIKI,lam-dep-suc-khoe,149354889,"Son Dưỡng Hồng Môi Giảm Thâm Môi Siêu Dưỡng Vitamin E Cỏ Mềm 3,6g",106000,120000,14000,12
TIKI,lam-dep-suc-khoe,129727672,"Collagen nước lựa đỏ Neocell Collagen +C Mỹ Tạo sức khỏe cùng đẹp  từ  bên  trong  cho  da,  tóc,  móng,  xương  khớp - Massel Official – 473ml/chai",776000,1822000,1046000,57
TIKI,lam-dep-suc-khoe,114465611,"Máy Massage Tay Cao Cấp KingTech -  Mát xa Trị Liệu Không Dây Tích Hợp Nhiệt, Lực Nén Túi Khí 6 Cấp Độ - Giúp Thư Giãn, Giảm Mỏi Khớp Ngón, Lòng Bàn Tay, - Quà Tặng Cho Người Thân",1376000,2200000,824000,37
TIKI,lam-dep-suc-khoe,45900941,"Sữa rửa mặt không có xà phòng và hỗ trợ giảm thiểu tế bào chết SEBIACLEAR Gel Moussant SVR 400ml",335000,339000,4000,1
TIKI,lam-dep-suc-khoe,77323883,"Kẻ mắt Never Die Brush Eyeliner 0.4g ( 2 màu)",140000,290000,150000,52
TIKI,lam-dep-suc-khoe,142782013,"Mặt Nạ Dưỡng Ẩm Da Chân Hương Bơ Cao Cấp - Hãng Bioaqua - Dưỡng Ẩm, Phục Hồi Da Chân",10000,10000,0,0
TIKI,lam-dep-suc-khoe,106503532,"Đai lưng cột sống trị thoát vị đĩa đệm dạng lưới cao cấp- Đại định hình cột sống chống cong vẹo lưng",287000,299000,12000,4
TIKI,lam-dep-suc-khoe,159017142,"Băng cá nhân Pharmacity Plaster 72x18mm (Hộp 10 miếng)",8000,10000,2000,20
TIKI,lam-dep-suc-khoe,36158812,"Kem dưỡng trắng da toàn thân Truesky Whitening Body Lotion chiết xuất lựu 100g",109000,170000,61000,36
TIKI,lam-dep-suc-khoe,32236260,"Kem dưỡng ban đêm Sắc Ngọc Khang dưỡng sáng và mờ thâm nám 10g",110000,149000,39000,26
TIKI,lam-dep-suc-khoe,145626897,"Cốc tạo bọt sữa rửa mặt, sữa tắm nhỏ gọn thời trang tiện lợi",34000,35000,1000,3
TIKI,lam-dep-suc-khoe,92559229,"Lăn khử mùi chiết xuất thiên nhiên Refre Natural Woody – Hương Gỗ 40ml",53900,65000,11100,17
TIKI,lam-dep-suc-khoe,46822212,"Sơn dưỡng nền móng tay Felina CD001",49000,70000,21000,30
TIKI,lam-dep-suc-khoe,175193742,"Súng massage Booster M2 cảm ứng thông minh 6 đầu cắm",1400000,2000000,600000,30
TIKI,lam-dep-suc-khoe,77779979,"Cốc nguyệt san BeUcup siêu mềm - xóa tan nỗi lo ngày "đèn đỏ"",349000,349000,0,0
TIKI,lam-dep-suc-khoe,73247612,"Máy Khuếch Tán Tinh Dầu Và Tinh Dầu Sả Chanh TIDAMO Cao Cấp - Máy Xông Tinh Dầu Chuyên Dụng Cho Phòng Lớn, Có Remote Điều Khiển Từ Xa và Đèn LED Biến Đổi Màu Cực Đẹp",298000,596000,298000,50
TIKI,lam-dep-suc-khoe,4152277,"5 Cặp Nút bịt tai chống ồn 3M 1290",80000,80000,0,0
TIKI,lam-dep-suc-khoe,112102855,"Bàn chải đánh răng điện FAIRYWILL E11 chính hãng Mỹ Công nghệ làm sạch bằng sóng siêu âm 8 đầu thay thế Hàng Chính Hãng",628000,689000,61000,9
TIKI,lam-dep-suc-khoe,10966796,"Dung dịch vệ sinh Saforelle Gentle Cleansing Care (100ml)",119000,139000,20000,14
TIKI,lam-dep-suc-khoe,194103280,"Ghế massage toàn thân Cao Cấp con lăn 4D di chuyển Toshiko T9, dòng ghế điều khiển bằng giọng nói, bảng điều khiển tiếng Việt, đa dạng các bài massage từng vùng, con lăn 4D di chuyển theo chiều dài cơ thể",19790000,35000000,15210000,43
TIKI,lam-dep-suc-khoe,73953901,"Viên Uống Hương Hoa Hồng DHC Bulgarian Rose Capsule 20 Ngày",405000,475000,70000,15
TIKI,lam-dep-suc-khoe,77745077,"COMBO 3 Chai Sữa Tắm Dê ASOHA",120000,120000,0,0
TIKI,lam-dep-suc-khoe,146728847,"Nước Hoa Hồng chiết xuất tía tô Perrila Natural Skin Lotion Nhật Bản ( chai 500ml)",85000,85000,0,0
TIKI,lam-dep-suc-khoe,188728812,"Bút kẻ mắt dạng lỏng không lem không trôi NOVO thiết kế vân kim cương",72000,125000,53000,42
TIKI,lam-dep-suc-khoe,162979447,"Sữa rửa mặt dịu nhẹ cho mọi loại da Cetaphil Gentle Skin Cleanser",331010,419000,87990,21
TIKI,lam-dep-suc-khoe,19800281,"Gel hỗ trợ trị mụn lưng For Back dạng xịt Pelican - Chai 100ml",118000,157500,39500,25
TIKI,lam-dep-suc-khoe,193736472,"Máy tăm nước cầm tay Enpis SS66 vệ sinh răng miệng chống nước cao cấp 3 chế độ bảo vệ nướu - Hàng Chính Hãng",288000,288000,0,0
TIKI,lam-dep-suc-khoe,14926439,"Xịt Khử Mùi Etiaxil Déodorant Anti-Transpirant 48h Anti-Traces Blanches & Jaunes 100ml",249000,289000,40000,14
TIKI,lam-dep-suc-khoe,1815277,"Máy tăm nước du lịch Procare KHD13",1600000,1600000,0,0
TIKI,lam-dep-suc-khoe,155061543,"Tinh chất dưỡng trắng và ngăn ngừa lão hoá da mặt Truesky Whitening Face Serum chiết xuất quả lựu 20ml",145000,250000,105000,42
TIKI,lam-dep-suc-khoe,242630430,"Dầu gội đầu ngăn rụng tóc kích thích mọc tóc Dr.FORHAIR Folligen Plus Shampoo 500ml",460000,460000,0,0
TIKI,lam-dep-suc-khoe,19896312,"Kem ủ tóc siêu mượt Collagen DIVA Cosmetics Double Treatment 500ml",173000,178000,5000,3
TIKI,lam-dep-suc-khoe,132837279,"Dermarium Rescuer - Kem dưỡng phục hồi 50ml",380000,380000,0,0
TIKI,lam-dep-suc-khoe,94118705,"Combo 6 Băng vệ sinh ban đêm Glamiss Cool thảo dược  33.8cm siêu mát siêu khô thoáng",81000,96000,15000,16
TIKI,lam-dep-suc-khoe,90143270,"Tinh Dầu Hoa Lài Nguyên Chất TIDAMO, Tự Chọn Dung Tích | Có Kiểm Nghiệm Chất Lượng | Sử Dụng Với Máy Xông Tinh Dầu Xông Thơm Phòng Giúp Bảo Vệ Sức Khỏe Và Thư Giãn Tinh Thần",57800,98000,40200,41
TIKI,lam-dep-suc-khoe,159786756,"Combo 03 hộp Nước uống đẹp da The Collagen Shiseido EXR (Hộp 10 chai x 50mL)",2096000,2096000,0,0
TIKI,lam-dep-suc-khoe,170066578,"Combo 3 Hộp Tăm bông Bông Bạch Tuyết (200 que/hộp tròn)",69000,69000,0,0
TIKI,lam-dep-suc-khoe,50618604,"Bao cao su Okamoto 0.01 Hydro Polyurethane (PU). Bao cao su Nhật Bản siêu mỏng chỉ 0.01mm bằng 1/6 độ dày sợi tóc, cho cảm nhận truyền nhiệt nhanh (Hộp 4 Cái) ",159000,159000,0,0
TIKI,lam-dep-suc-khoe,6522947,"Mật Ong Hoa Nhãn hũ 480g",139000,139000,0,0
TIKI,lam-dep-suc-khoe,40871895,"Kem hỗ trợ giảm gân tay chống lão hoá da tay - Kem trẻ hoá hết nhăn da tay KPEM 100ml",165000,185000,20000,11
TIKI,lam-dep-suc-khoe,116189210,"Kìm cắt móng tay, móng chân, kìm cắt da chết bằng thép không gỉ siêu sắc  Tặng Kèm Thanh Nạy Móng ( giao mầu ngẫu nhiên)",68000,79000,11000,14
TIKI,lam-dep-suc-khoe,81419552,"Combo 2 Hộp Nước Uống Làm Đẹp Collagen ADIVA Tem Trắng (14Chai/ Hộp)- Giúp Làn Da Săn Chắc, Ảm Mịn Và Căng Bóng",1459000,1622000,163000,10
TIKI,lam-dep-suc-khoe,10131464,"Combo 3 Hộp Viên Uống Tăng Cân AVITA Dành Cho Người Gầy Giúp Nâng Cao Thể Trạng, Tăng Cường Sức Khỏe, Bồi Bổ Cơ Thể 60 Viên/Hộp",488000,594000,106000,18
TIKI,lam-dep-suc-khoe,73547434,"Thực phẩm bảo vệ sức khỏe INNERB AQUA RICH DOUBLEUP (giúp giữ ẩm da sáng mịn từ Axit Hyaluronic) lọ 56 viên",520000,945000,425000,45
TIKI,lam-dep-suc-khoe,49548212,"Thực phẩm bảo vệ sức khỏe Nattokinase Jintan Nhật Bản, hỗ trợ điều trị đột quỵ, tai biến, hộp 60 gói",1268000,1847000,579000,31
TIKI,lam-dep-suc-khoe,911333,"Sữa Rửa Mặt Dưỡng Ẩm, Làm Sạch Sâu Chiết Xuất Hoa Cúc - Oribe Facial Cleanser 50g",49000,75000,26000,35
TIKI,lam-dep-suc-khoe,178725018,"Đai Lưng Olumba Orbe Cao Cấp Hỗ Trợ Cột Sống, Thoát Vị Đĩa Đệm",289000,399000,110000,28
TIKI,lam-dep-suc-khoe,389659,"Bao Cao Su Sagami Xtreme Feel Long (Hộp 10 Cái)",52000,99000,47000,47
TIKI,lam-dep-suc-khoe,77118796,"Tinh Chất Revival B3 Zakka Naturals Hỗ Trợ Mờ Thâm Đỏ Và Sáng Đều Màu Da 30ml",680000,680000,0,0
TIKI,lam-dep-suc-khoe,270988940,"Nước hoa hồng Dear Klairs Supple Preparation Facial Toner  - QuaTangMe Extaste",361000,722000,361000,50
TIKI,lam-dep-suc-khoe,7812224,"Kem đánh răng tẩy trắng Eucryl",45000,45000,0,0
TIKI,lam-dep-suc-khoe,67110418,"Thực phẩm bổ sung Tăng cường tuần hoàn não Trunature Ginkgo Biloba 340 Viên (Mẫu mới) - Nhập khẩu Mỹ",469000,469000,0,0
TIKI,lam-dep-suc-khoe,13728683,"Thuốc nhuộm tóc tạo bọt Beautylabo – Whip Hair Color Nhật Bản",179000,249000,70000,28
TIKI,lam-dep-suc-khoe,14694443,"Sáp vuốt tóc nam Tigi Bed Head Matte Separation Workable Wax",378000,390000,12000,3
TIKI,lam-dep-suc-khoe,73210835,"Hà thủ ô đỏ lâu năm, Viên Hoàn mềm hỗ trợ giảm tóc bạc, giảm rụng tóc, kích thích mọc tóc, tăng cường sức khoẻ - Hộp 60 viên",1500000,1500000,0,0
TIKI,lam-dep-suc-khoe,72040789,"Serum Nghệ Đỏ Nano ABERA - Đánh bật mọi loại thâm",259000,259000,0,0
TIKI,lam-dep-suc-khoe,174848651,"Ghế massage toàn thân Kagawa K16 đa chức năng, công nghệ quét AI thông minh, tự động dò tìm huyệt đạo",17180000,27000000,9820000,36
TIKI,lam-dep-suc-khoe,43184504,"KEM ĐÁNH RĂNG WHITE & WHITE LION NHẬT BẢN",58000,70000,12000,17
TIKI,lam-dep-suc-khoe,6293541,"Thực Phẩm Bảo Vệ Sức Khỏe Diệp lục Collagen (Green Collagen Powder)",249000,249000,0,0
TIKI,lam-dep-suc-khoe,52347336,"Mặt nạ bí đao Cocoon 30ml",145000,145000,0,0
TIKI,lam-dep-suc-khoe,123202562,"Bút Kẻ Mày Phẩy Sợi VACOSI - REALBROW TATTOO PEN",95200,112000,16800,15
TIKI,lam-dep-suc-khoe,157198774,"Kem Che Khuyết Điểm Lâu Trôi the SAEM Cover Perfection Fixealer 6.5g",130000,130000,0,0
TIKI,lam-dep-suc-khoe,135649448,"Glucosamine Úc Healthy Care HCL 1500mg Hỗ trợ giảm đau nhức xương khớp, tăng trưởng và hồi phục sụn, sản xuất chất nhầy cho khớp - Massel Official - 400Viên/Hộp",728000,1456000,728000,50
TIKI,lam-dep-suc-khoe,72078387,"Viên Uống Cân Bằng Nội Tiết Tố Nữ Zlove - Se Khít Cô Bé Hiệu Quả, Hết Khô Hạn, Tăng Ham Muốn",779000,969000,190000,20
TIKI,lam-dep-suc-khoe,8211858,"Sủi Da S-506 - Kềm Nghĩa",59800,65000,5200,8
TIKI,lam-dep-suc-khoe,270990158,"Đai chống gù United Medicare (C15)",590000,700000,110000,16
TIKI,lam-dep-suc-khoe,162196432,"Sữa Dưỡng Dành Cho Da Dầu Và Da Hỗn Hợp Laneige Water Bank Blue HA Emulsion Oily 120ml",656000,820000,164000,20
TIKI,lam-dep-suc-khoe,32724902,"Combo Viên uống DHC Trị mụn - Mờ thâm (Kẽm ZinC+VitaminC)",358000,410000,52000,13
TIKI,lam-dep-suc-khoe,12084506,"Tinh Chất Hỗ Trợ Trị Mụn, Mờ Vết Thâm, Tái Tạo Da, Ngăn Ngừa Mụn Eucerin (40ml)",362000,490000,128000,26
TIKI,lam-dep-suc-khoe,176812031,"Kem Giảm Ngứa Và Mẩn Đỏ Bepanthen Itch Relief Cream 20G",180000,180000,0,0
TIKI,lam-dep-suc-khoe,67195661,"Viên uống dầu gan cá mập 360 viên",475000,900000,425000,47
TIKI,lam-dep-suc-khoe,1321075,"Hoạt huyết Minh Não Khang (Hộp 3 vỉ x 10 viên)",75000,75000,0,0
TIKI,lam-dep-suc-khoe,73222965,"Bộ đôi thực phẩm bảo vệ sức khỏe INNERB AQUA RICH DOUBLEUP (giúp giữ ẩm da sáng mịn từ Axit Hyaluronic) lọ 56 viên",1040000,1890000,850000,45
TIKI,lam-dep-suc-khoe,70738568,"Gel rửa mặt và tắm Effaclar Micro -Peeling Purifying La Roche Posay 400ml",358000,495000,137000,28
TIKI,lam-dep-suc-khoe,106366570,"Máy đo huyết áp Omron HEM-7600T",2935000,4815000,1880000,39
TIKI,lam-dep-suc-khoe,52661901,"Máy làm sạch bằng sóng siêu âm Xiaomi ERACLEAN GA01 - Hàng Nhập Khẩu",499000,738000,239000,32
TIKI,lam-dep-suc-khoe,81500297,"Combo 2 Chai Xịt Nano Bạc Vệ Sinh Mũi Người Lớn Nano Ocean Gold Chai 70 ml",25000,36000,11000,31
TIKI,lam-dep-suc-khoe,59473854,"Nước súc họng miệng nano bạc PlasmaKare giảm rát họng, dịu cơn ho, phòng tái phát VlÊM họng chai 250ml",135000,135000,0,0
TIKI,lam-dep-suc-khoe,74011705,"Que Thử Đường Huyết Safe Accu Chính Hãng Sinocare 50 Que + 50 Kim Chích Máu",157000,289000,132000,46
TIKI,lam-dep-suc-khoe,14423714,"Tấm thảo dược thay thế của đai chườm đầu gối cắm điện - Hapaku",118000,128000,10000,8
TIKI,lam-dep-suc-khoe,174238411,"Viên đặt se khít Pure Love Inner Clear Feminine Cleanser làm hồng và se khít hộp 8 viên DR937-8",298000,298000,0,0
TIKI,lam-dep-suc-khoe,76368399,"Tinh Dầu Ngọc Lan Tây  Nguyên Chất TIDAMO (Ylang Ylang) - Tinh Dầu Cao Cấp Nhập Khẩu Từ Ấn Độ, Xông Hương Thơm Phòng, Thư Giãn, Nâng Cao Sức Khỏe - Kiểm Nghiệm Chất Lượng Tại Trung Tâm Quatest 3",57000,114000,57000,50
TIKI,lam-dep-suc-khoe,92560202,"Xịt khử mùi chiết xuất thiên nhiên Refre Natural Rosa Magnolia Hồng Mộc Lan 30ml",53900,65000,11100,17
TIKI,lam-dep-suc-khoe,162196348,"Nước Cân Bằng Dưỡng Ẩm Dành Cho Da Dầu Và Da Hỗn Hợp Laneige Water Bank Blue HA Toner Oily 160ml",629000,770000,141000,18
TIKI,lam-dep-suc-khoe,126945313,"Combo bao cao su LifeStyles Love Time 3 bao + 1 hộp bao cao su Lifetysles MIxed Berry 3 bao",78000,108000,30000,28
TIKI,lam-dep-suc-khoe,10795790,"Dầu Tẩy Trang Biore Make Up Remover Perfect Oil (150ml)",159000,159000,0,0
TIKI,lam-dep-suc-khoe,118053841,"Máy Xông Tinh Dầu Cao Cấp Ánh Sáng 3D + Tinh Dầu Sả Chanh 10ml/ Máy Khuếch Tán Siêu Âm, Chuyên Dụng Xông Tinh Dầu Thơm Phòng, Tạo Ẩm",338300,796000,457700,58
TIKI,lam-dep-suc-khoe,42231565,"Kem mắt Simple Revitalising Eye Soothing Eye Balm (15ml)",150000,150000,0,0
TIKI,lam-dep-suc-khoe,116804147," Tinh dầu hoa anh thảo Careline Evening Primrose Oil 60v",406000,450000,44000,10
TIKI,lam-dep-suc-khoe,191955983,"Máy Xông Khí Dung Mũi Họng OMRON NE-C101",789000,930000,141000,15
TIKI,lam-dep-suc-khoe,46801832,"NƯỚC CHÙI SƠN MÓNG TAY CAO CẤP FELINA - HƯƠNG NƯỚC HOA 100ML",46000,70000,24000,34
TIKI,lam-dep-suc-khoe,25861909,"Keo xịt giữ nếp tóc siêu cứng siêu bền TIGI BedHead Hard Head Hard Hold Hair Spray 385ml",396000,408000,12000,3
TIKI,lam-dep-suc-khoe,52663127,"Trà lá ổi hỗ trợ giảm cân, đốt mỡ Orihiro 60 gói",155000,300000,145000,48
TIKI,lam-dep-suc-khoe,3928875,"Dầu Tẩy Trang DHC Deep Cleansing Oil (SS) (70ml)",245000,299000,54000,18
TIKI,lam-dep-suc-khoe,171865309,"Bộ dụng cụ ráy tai bằng thép không gỉ cao cấp 8 món kèm hộp đựng kiêm móc khóa- Dụng cụ ráy tai thông minh cho người lớn và trẻ em",49000,49000,0,0
TIKI,lam-dep-suc-khoe,273217802,"Combo Máy khuếch tán/ máy xông tinh dầu Bí Ngô Lorganic FX2026 + tinh dầu sả chanh + tinh dầu cam Lorganic (10ml x2)",285000,400000,115000,29
TIKI,lam-dep-suc-khoe,58453672,"Viên Uống Cà Gai Leo Thanh Nhiệt Giải Độc Gan Tăng Cường Chức Năng Gan FOGAN - Hộp 20 viên",93000,123000,30000,24
TIKI,lam-dep-suc-khoe,178034213,"Máy Massage Booster Lightsaber AI Inside - 6 Đầu Massage – 4 mức độ - Công Suất 126W",1770000,3000000,1230000,41
TIKI,lam-dep-suc-khoe,51659540,"Cao ống Atiso Ladophar không đường Hộp 10 ống 10ml Giúp mát gan, lợi mật, hỗ trợ tăng cường chức năng gan, giúp cải thiện quá trình tiêu hóa do chức năng gan kém tặng 1 túi trà",68000,68000,0,0
TIKI,lam-dep-suc-khoe,131504658,"Kem nghệ dưỡng da 20g - Sao Thái Dương",20000,20000,0,0
TIKI,lam-dep-suc-khoe,58805505,"Vớ y khoa đùi JOBST UltraSheer - Siêu Mỏng hỗ trợ điều trị giãn tĩnh mạch chân",1750000,1800000,50000,3
TIKI,lam-dep-suc-khoe,88992426,"Combo Mật ong rừng Cao Nguyên - 100% mật ong chín Honimore 990g",221000,328000,107000,33
TIKI,lam-dep-suc-khoe,177518334,"Serum Collagen X3 xóa thâm nám căng bóng da ",60000,80000,20000,25
TIKI,lam-dep-suc-khoe,164075756,"Gel An Trĩ Vương Vinh Gia Giúp Chăm Sóc Làm Mát, Dịu Da Dùng Khi Bị Trĩ, Táo Bón, Nứt Kẽ Hậu Môn Tuýp 20g",96000,96000,0,0
TIKI,lam-dep-suc-khoe,23887072,"Gel Mềm Livegain Premium Hair Glaze 450ml Hàn Quốc",220000,220000,0,0
TIKI,lam-dep-suc-khoe,113507830,"Khẩu trang y tế kháng khuẩn 3 lớp Famapro 5D quai vải [ Hộp 10 cái",9900,18000,8100,45
TIKI,lam-dep-suc-khoe,74362942,"Tinh Dầu Hoa Lài Kobi - Tinh Dầu Thiên Nhiên Nguyên Chất, Tinh Dầu Xông Phòng, Giúp Giảm Stress, Xua Đuổi Côn Trùng Và Khử Mùi Hiệu Quả, Thích Hợp Dùng Với Đèn Xông Và Máy Khuếch Tán Tinh Dầu (5ml)",29000,50000,21000,42
TIKI,lam-dep-suc-khoe,58659354,"Vitamin bầu bú Blackmores Pregnancy & Breastfeeding Gold mẫu mới 180 viên chính hãng Úc",635000,645000,10000,2
TIKI,lam-dep-suc-khoe,33606794,"Gel dưỡng ẩm ban đêm cho da mềm mịn Paula’s Choice Skin Balancing Invisible Finish Moisture Gel 60ml",810000,899000,89000,10
TIKI,lam-dep-suc-khoe,20532385,"TRỌN BỘ MÁY XÔNG KHÍ DUNG NEB EASY",475000,665000,190000,29
TIKI,lam-dep-suc-khoe,94118573,"Combo 2 Băng vệ sinh hàng ngày Doctor Care tinh chất  thảo dược  16 cm",48500,56000,7500,13
TIKI,lam-dep-suc-khoe,67883500,"Khẩu trang y tế 4 lớp Hynam than hoạt tính (50 cái/ hộp)-Kháng khuẩn, chống bụi mịn, ngăn ngừa bệnh hô hấp",55000,55000,0,0
TIKI,lam-dep-suc-khoe,147688741,"Khẩu trang y tế 4D (KF94) NPCARE Coffee (H/10c)",30000,30000,0,0
TIKI,lam-dep-suc-khoe,79245520,"Dầu xả siêu dưỡng & phục hồi tóc Salon Link Repair & Protect Extra (1000ml)",180000,220000,40000,18
TIKI,lam-dep-suc-khoe,174445739,"[COMBO 2 HỘP] Viên uống chống nắng UV Screen Rejuvicare - 30 viên/ hộp ",227620,227620,0,0
TIKI,lam-dep-suc-khoe,75827799,"Combo 2 Tinh Dầu Sả Chanh 100ML + Tinh Dầu Bạc Hà 100ML TIDAMO - Tinh Dầu Thiên Nhiên Nguyên Chất Giúp Thư Giãn, Đuổi Muỗi, Thơm Phòng và Nâng Cao Sức Khỏe - Thích Hợp Dùng Với Máy Xông Tinh Dầu",248000,656000,408000,62
TIKI,lam-dep-suc-khoe,194808793,"Viên Thảo Mộc Ăn Ngon Sâm Nhung Plus Giúp Ăn Ngon Ngủ Sâu Cải Thiện Hệ Tiêu Hoá Hỗ Trợ Tâng Cân An Toàn Hiệu Quả",500000,500000,0,0
TIKI,lam-dep-suc-khoe,24498383,"Gậy chống 4 chân thấp Lucass B924 hỗ trợ đi lại cho người già, khả năng đi lại kém, chất liệu inox chắc chắn",174000,174000,0,0
TIKI,lam-dep-suc-khoe,2577737,"Dầu dừa ép lạnh tinh khiết Coco-Secret 500 ml",148000,148000,0,0
TIKI,lam-dep-suc-khoe,201580274,"Tinh Dầu Xông Phòng Thư Giãn, Đuổi Muỗi 10ml LORGANIC Sả Chanh, Quế, Bạc Hà, Oải Hương Lavender, Tràm, Ngọc Lan Tây, Hương Thảo, Stress Relief, Sensual, Cam, Vỏ Bưởi, Bạch Đàn Chanh, Bưởi Chùm, Hoắc Hương, Long Não, Pơ Mu, Thông Đen",20000,40000,20000,50
TIKI,lam-dep-suc-khoe,162168799,"Bột nghệ uống liền Set 2 gói Honimore 16g - thơm ngon - đẹp da - tăng cường sức khoẻ",12000,20000,8000,40
TIKI,lam-dep-suc-khoe,185877587,"Serum Mờ Thâm Trắng Da Kiềm Dầu Se Khít Lỗ Chân Lông Oriskin O’vita Light Serum 30ml, Tặng Kèm Băng Đô Thời Trang Ngẫu Nhiên",352000,352000,0,0
TIKI,lam-dep-suc-khoe,9856643,"Combo 3 Bông Tẩy Trang Jomi (120 Miếng/Túi)",82000,124000,42000,34
TIKI,lam-dep-suc-khoe,5136671,"Kem dưỡng ẩm Fixderma Multi-Active Moisturizing Lotion (150ml)",245000,338000,93000,28
TIKI,lam-dep-suc-khoe,2789887,"Đèn Gù Khám Bệnh Và Chiếu Tia Hồng Ngoại Chân Cao TNE (1.7m)",670000,670000,0,0
TIKI,lam-dep-suc-khoe,185752417,"Tâm Hoa Đán - Diệp lục cần tây",175000,175000,0,0
TIKI,lam-dep-suc-khoe,94118702,"Combo 2 Băng vệ sinh thảo dược Glamiss Cool ban ngày 24cm siêu mát siêu khô thoáng",43500,48000,4500,9
TIKI,lam-dep-suc-khoe,52396546,"Dao Cạo Râu Gillette Cán Vàng Super Thin Ii 3 Gói Bộ 5 Cây Tặng 1",99000,99000,0,0
TIKI,lam-dep-suc-khoe,56372299,"Đai chống gù lưng chính hãng GoodFit GF711P",149000,250000,101000,40
TIKI,lam-dep-suc-khoe,166767578,"Nước biển sâu xịt sạch thông mũi Xisat (75ml)",32000,32000,0,0
TIKI,lam-dep-suc-khoe,270863163,"Mật Ong MGO 100+ Manuka Honey New Zealand - QuaTangMe Extaste",496000,992000,496000,50
TIKI,lam-dep-suc-khoe,32544728,"KEM ĐÁNH RĂNG 100% THẢO MỘC DOCTOR V 85g  - Cam Kết 99% Hết Ê Buốt Răng - Sản Phẩm Có Thể Sử Dụng Cho Phụ Nữ Sau Khi Sinh, Người Ăn Chay, Trẻ Em Từ 6 Tuổi Trở Lên, Nguồn Gốc Thành Phần Tự Nhiên.",245000,245000,0,0
TIKI,lam-dep-suc-khoe,272253016,"Collagen Youtheory Mỹ Type 1,2,3 hỗ trợ tăng sức khỏe và làm chậm quá trình lão hóa cho da, tóc, móng, sụn, gân, dây chằng, khớp - OZ Slim Store",598000,1196000,598000,50
TIKI,lam-dep-suc-khoe,152534326,"Miếng Dán Mụn Cóc Loại Bỏ Mụn Cóc Tại Nhà An Toàn Corn Removal Plaster ( Hộp 6 miếng )",53000,75000,22000,29
TIKI,lam-dep-suc-khoe,42895880,"Serum HA Plus 300ml - Cấp Nước, Dưỡng Ẩm, Căng Bóng Da, Mờ Nếp Nhăn ( Hàng Chính Hãng)",639000,639000,0,0
TIKI,lam-dep-suc-khoe,170066670,"Combo 3 Hộp Khẩu trang Bông Bạch Tuyết 4 lớp xanh (50 cái/hộp)",211500,211500,0,0
TIKI,lam-dep-suc-khoe,151576667,"Dung dịch vệ sinh Phụ Nữ Hanayuki màu hồng VB Soft Silk - ddvs Hana phiên bản mới",115000,119000,4000,3
TIKI,lam-dep-suc-khoe,196003161,"Son tint lì dạng thỏi Flawsome Sunny Matte Tint (3g) Đỏ Nâu",178000,220000,42000,19
TIKI,lam-dep-suc-khoe,68174057,"Máy Xông Tinh Dầu Cao Cấp Chuyên Dụng Khuếch Tán Tinh Dầu Và Tạo Độ Ẩm Cho Gia Đình Và Văn Phòng",236300,537000,300700,56
TIKI,lam-dep-suc-khoe,72843416,"Set 3 Cây Son Kem Lì Herorange Fluffy Lip Glaze",43000,75000,32000,43
TIKI,lam-dep-suc-khoe,151995278,"Aknicare Kem Giảm Nhờn Mụn Fast Creamgel 30ml",485000,693000,208000,30
TIKI,lam-dep-suc-khoe,17599448,"Tinh dầu bạch đàn chanh Lorganic  Eucalyptus citriodora 50ml/ Tinh dầu thiên nhiên nguyên chất.",115000,200000,85000,43
TIKI,lam-dep-suc-khoe,157061379,"Kem nám và tàn nhang ban đêm Truesky Melasma Cream chiết xuất tảo biển 20g",145000,220000,75000,34
TIKI,lam-dep-suc-khoe,127315789,"Khẩu trang y tế trẻ em N95 Pro Mask  [ Hộp 20 cái ] màu trắng, xanh, hồng ... 5 lớp kháng khuẩn, chống bụi siêu mịn PM2.5, đạt chứng chỉ ISO13485, CE, FDA",55000,55000,0,0
TIKI,lam-dep-suc-khoe,35230058,"Tinh chất kháng mụn, lão hoá Retinol The Ordinary Granactive Retinoid 2% Emulsion / Squalane",399000,399000,0,0
TIKI,lam-dep-suc-khoe,152410324,"[ Tặng Bông tẩy trang 80 miếng ] Kem dưỡng da tay chiết xuất thiên nhiên hương Mâm Xôi, Kẹo Ngọt, Dừa - Tracemoon-75ml",98000,131000,33000,25
TIKI,lam-dep-suc-khoe,22472904,"Nhuộm phủ bạc SEVEN EIGHT Hair Color (40g + 40g) Nhật Bản",130000,130000,0,0
TIKI,lam-dep-suc-khoe,270794379,"Dầu Gội Đầu OGX - Massel Official",306000,612000,306000,50
TIKI,lam-dep-suc-khoe,74973941,"Serum Sáng Da Lactic Acid 10%+ HA - The Ordinary",260000,350000,90000,26
TIKI,lam-dep-suc-khoe,90752734,"Nước uống làm đẹp Collagen ADIVA Gold (14 lọ x 30ml /hộp)",849000,998000,149000,15
TIKI,lam-dep-suc-khoe,25443632,"Son kem lì Bbia Last Velvet Lip Tint - 24 Trendy Note 5g (màu hồng đất ánh cam nhẹ)",140000,290000,150000,52
TIKI,lam-dep-suc-khoe,139139686,"Kẹo ngậm gừng Vietnat hỗ trợ tiêu hóa giảm cảm cúm - hộp 100 viên",58000,58000,0,0
TIKI,lam-dep-suc-khoe,25441260,"Son kem lì Bbia Last Velvet Lip Tint - 20 More Mature 5g (Màu hồng đỏ đất)",140000,290000,150000,52
TIKI,lam-dep-suc-khoe,43689370,"Men vi sinh Bifina Nhật Bản, Loại R 60 gói- Cải thiện tình trạng táo bón,tiêu chảy,đầy hơi",996000,1416000,420000,30
TIKI,lam-dep-suc-khoe,138381124,"Tinh bột nghệ nguyên chất -  hữu cơ - sử dụng cho - đau dạ dày,  phụ nữ sau sinh -  HNT 100G",69000,69000,0,0
TIKI,lam-dep-suc-khoe,95150406,"Dầu massage body oải hương dành cho Gia Đình - Dưỡng da, thư giãn 200ml",157000,157000,0,0
TIKI,lam-dep-suc-khoe,190508053,"Dụng Cụ Massage Đa Năng Cao Cấp KingTech - Hỗ Trợ Mát Xa Cổ, Vai, Gáy - Tiện Dụng, Nhẹ Nhàng - Chính Hãng",122000,200000,78000,39
TIKI,lam-dep-suc-khoe,121161575,"Bông Tắm Tạo Bọt Cao Cấp - Hàng Nhập Khẩu Cao Cấp - Bông Mền Mịn",55000,55000,0,0
TIKI,lam-dep-suc-khoe,13576249,"Kem ngăn ngừa & giảm rạn da Cocoa Butter Formula Massage Cream For Stretch Marks - Palmer's (125ml)",331500,390000,58500,15
TIKI,lam-dep-suc-khoe,115935576,"Nước tẩy trang và làm sạch dành cho da hỗn hợp dầu, mụn Bioderma sebium h20 500ml TẶNG 2 bông tẩy trang Jomi (Nhập khẩu)",420000,525000,105000,20
TIKI,lam-dep-suc-khoe,152097278,"Combo 4 bông gói tẩy trang ipek 150 miếng (4x150 miếng)",111600,111600,0,0
TIKI,lam-dep-suc-khoe,76168172,"[HỘP - FAMAPRO 5D MASK] - Khẩu trang y tế kháng khuẩn 3 lớp Famapro 5D Mask (10 cái/ hộp) - COMBO 3 HỘP",29700,54000,24300,45
TIKI,lam-dep-suc-khoe,115255568,"Serum Lăn Khử Mùi The Fleura Dưỡng Da Sáng Mịn, Ngăn Mồ Hôi, Khử Mùi Hôi Nách Tinh Chất Thiên Nhiên",89000,175000,86000,49
TIKI,lam-dep-suc-khoe,184449675,"Viên bổ sung vitamin E Enat 400IU (Hộp 3 vỉ x 10 viên)",120000,120000,0,0
TIKI,lam-dep-suc-khoe,194026883,"Son dưỡng môi cao cấp Tom Ford Z09 Soleil Lip Blush Limited",950000,950000,0,0
TIKI,lam-dep-suc-khoe,25622340,"Dung Dịch Vệ Sinh Phụ Nữ Sebamed SSS04C Ph3.8 (200ml)",264000,330000,66000,20
TIKI,lam-dep-suc-khoe,107970675,"Sữa rửa tay dưỡng ẩm Mr.Fresh 500ml cao cấp (3 mùi hương) - công nghệ Hàn Quốc",35000,35000,0,0
TIKI,lam-dep-suc-khoe,155398602,"Dầu Gội Phục Hồi Đa Tầng Nấm Truffle Weilaiya - Tặng mini dầu xả gừng ",440000,440000,0,0
TIKI,lam-dep-suc-khoe,413646,"Dầu gội giúp giảm gàu dành cho da đầu dầu và ngứa Vichy 200ml",311000,415000,104000,25
TIKI,lam-dep-suc-khoe,114690256,"Tinh dầu tỏi Garlic Oil Puritan's Pride Mỹ giúp tăng sức đề kháng, giảm lượng cholesterol, phòng xơ vữa mạch, cao huyết áp - OZ Slim Store-100viên/lọ",219000,438000,219000,50
TIKI,lam-dep-suc-khoe,4494843,"Máy Rửa Mặt Halio Facial Cleansing & Massaging Device Sóng Âm Dành Cho Mọi Loại Da",554000,850000,296000,35
TIKI,lam-dep-suc-khoe,171434490,"Dầu tắm giúp làm sạch, làm dịu và dưỡng ẩm dành cho da khô, da nhạy cảm Atoderm Huile De Douche 1L",464000,545000,81000,15
TIKI,lam-dep-suc-khoe,148940466,"Serum giúp ngăn ngừa & giảm thâm nám đốm nâu Vichy LiftActiv B3 Dark Spot Serum 30ml",945700,965000,19300,2
TIKI,lam-dep-suc-khoe,10131385,"Combo 2 Hộp Viên Uống Tăng Cân AVITA Dành Cho Người Gầy Yếu, Giúp Tăng Sức Đề Kháng, Bồi Bổ Sức Khỏe Không Tích Nước, 60 Viên/Hộp",358000,396000,38000,10
TIKI,lam-dep-suc-khoe,553373,"Kem Tẩy Lông Chiết Xuất Bơ Cleo Dành Cho Da Thường 50g, an toàn, không đau và đạt hiệu quả nhanh chóng",73000,100000,27000,27
TIKI,lam-dep-suc-khoe,3685577,"Nhiệt kế điện tử đo trán Omron MC 720 - Số 1 Nhật Bản",865000,1020000,155000,15
TIKI,lam-dep-suc-khoe,75801671,"Tinh chất collagen hỗ trợ đặc trị bọng mắt và quầng thâm ",299000,299000,0,0
TIKI,lam-dep-suc-khoe,75400788,"Combo Máy Khuếch Tán Tinh Dầu/ Máy Xông Tinh Dầu + Tinh Dầu Sả Chanh Nguyên Chất 10ML/ Chuyên Dụng Xông Tinh Dầu Gia Đình, Văn Phòng, Có Remote Điều Khiển và Đèn LED Biến Đổi Màu",270300,636000,365700,58
TIKI,lam-dep-suc-khoe,150559328,"Tinh Dầu Bạc Hà Homer - Tinh Dầu Xông Thơm Phòng, Thư Giãn, Khử Mùi - Tinh dầu Sả Chanh/ Vỏ Quế/ Cam Ngọt/ Oải hương/ Ngọc Lan Tây/ Tràm Trà/ Bưởi Ngọt",75000,75000,0,0
TIKI,lam-dep-suc-khoe,100321662,"Phấn Nước Sunisa kèm chổi tán kem kiềm dầu,che khuyết điểm,chống nước 20gram (Tặng kèm bảng phấn mắt)",69000,70000,1000,1
TIKI,lam-dep-suc-khoe,187337127,"Sữa chống nắng cho da dầu, mụn URIAGE HYSÉAC SPF50+ UVB+UVA FLUIDE 50ml",577500,577500,0,0
TIKI,lam-dep-suc-khoe,74745036,"Viên uống tinh chất hàu tươi tỏi nghệ Orihiro 180 viên",415000,750000,335000,45
TIKI,lam-dep-suc-khoe,155366856,"Sữa rửa mặt sáng da và dưỡng ẩm Truesky Glutathione Cleanser chiết xuất sữa dê 50g",62000,100000,38000,38
TIKI,lam-dep-suc-khoe,91608006,"Combo Sạch Mụn Thâm Dưỡng Da Sáng Mịn NAM (Sữa Rửa Mặt 120 ml - Serum Dưỡng 20 ml - Gel Mụn 15 ml)",387000,660000,273000,41
TIKI,lam-dep-suc-khoe,175813162,"Serum dưỡng trắng da Bora Niacinamide lọ 30ml",449000,449000,0,0
TIKI,lam-dep-suc-khoe,150565126,"Tinh Dầu Sả Chanh Homer 100ML - Tinh Dầu Xông Thơm Phòng, Thư Giãn, Khử Mùi - Tinh dầu Bạc Hà/ Cam Ngọt/ Oải hương/ Ngọc Lan Tây/ Tràm Trà/ Bưởi Ngọt/ Vỏ Quế",65000,65000,0,0
TIKI,lam-dep-suc-khoe,3928217,"Kềm Cắt Móng Thép 501 Kềm Nghĩa",100280,109000,8720,8
TIKI,lam-dep-suc-khoe,86285710,"Băng cá nhân Zilgo hộp 102 miếng",39000,39000,0,0
TIKI,lam-dep-suc-khoe,522730,"Nước Làm Sạch Da, Tẩy Trang Và Loại Bỏ Dầu SVR Sebiaclear Eau Micellaire Chai 400ml - SEM",325000,339000,14000,4
TIKI,lam-dep-suc-khoe,147420064,"Son dưỡng cho nam Nerman dưỡng ẩm môi, giảm nứt nẻ mùa đông, không bết dính, hỗ trợ mờ thâm Men in Black 4g",129000,198000,69000,35
TIKI,lam-dep-suc-khoe,71925351,"Set son 2 tầng HengFang (5 sáp & 5 kem)",172000,350000,178000,51
TIKI,lam-dep-suc-khoe,118797341,"Tinh Chất Hồng Sâm Pha Sẵn KGC Choeng Kwan Jang Everytime Balance 30 Gói",1612000,1750000,138000,8
TIKI,lam-dep-suc-khoe,108535207,"Bao cao su Sagami 002 Extra - Nhiều gel - Siêu mỏng - Non Latex - Hộp 3 chiếc",142000,180000,38000,21
TIKI,lam-dep-suc-khoe,176039973,"Viên uống trắng da Triple White Glutathione 1200 mg ( Hàng Nhập Khẩu Mỹ )",637000,650000,13000,2
TIKI,lam-dep-suc-khoe,43252722,"Chì Xé Kẻ Lông Mày Cao Cấp Comestic Art Eyebrown Pencil",39000,39000,0,0
TIKI,lam-dep-suc-khoe,84376854,"Combo 5 Bông tẩy trang Jomi 120 miếng/gói",158000,207000,49000,24
TIKI,lam-dep-suc-khoe,75840487,"Viên Uống Phát Triển Chiều Cao Bổ Sung Canxi Xương Chắc Khỏe CALCIUM MILK ( Hộp 60 viên )",195000,258000,63000,24
TIKI,lam-dep-suc-khoe,389657,"Bao Cao Su Sagami Xtreme Feel Up - Hộp 10 Gói",82800,90000,7200,8
TIKI,lam-dep-suc-khoe,75336610,"Máy massage mặt – Máy massage mặt đa năng 5 IN 1 - Máy điện di tinh chất - Máy đẩy tinh chất - MASSAGE MẶT + LÀM SẠCH + TRẺ HÓA – Pin 1200mA - Chăm sóc da mặt đa năng- HDSD Tiếng Việt",299000,494000,195000,39
TIKI,lam-dep-suc-khoe,25441649,"Son kem lì Bbia Last Velvet Lip Tint - 19 More Dazzling 5g (Màu đỏ ánh hồng cánh sen)",140000,290000,150000,52
TIKI,lam-dep-suc-khoe,77036451,"MÁY XÔNG TINH DẦU CAO CẤP TRỤ TRÒN CÔNG SUẤT LỚN GIÚP KHUẾCH TÁN, TỎA HƯƠNG TINH DẦU, TẠO ĐỘ ẨM, XÔNG PHÒNG, TẶNG KÈM ĐIỀU KHIỂN TỪ XA, ĐÈN LED 7 MÀU, THÍCH HỢP CHO PHÒNG NGỦ, PHÒNG KHÁCH, SPA, NHÀ HÀNG, KHÁCH SẠN",245000,245000,0,0
TIKI,lam-dep-suc-khoe,41314807,"Sửa Rửa Mặt Ý Dĩ Hatomugi Naturie nội địa Nhật Bản 130g làm sạch nhờn, làm sáng da, mờ thâm mụn [ Được Mask 3W Clinic ]",59000,59000,0,0
TIKI,lam-dep-suc-khoe,119252665,"Kem dưỡng ẩm Cetaphil Moisturizing Cream 50g",256000,256000,0,0
TIKI,lam-dep-suc-khoe,8142219,"Kềm Cắt Móng Thép Không Gỉ Kềm Nghĩa M-03",170200,185000,14800,8
TIKI,lam-dep-suc-khoe,70660646,"Dầu Gội OGX Thick Full Biotin & Collagen Shampoo 385ml",199000,199000,0,0
TIKI,lam-dep-suc-khoe,17954891,"Dung dịch vệ sinh phụ nữ và cốc nguyệt san Lincare Rose",79000,79000,0,0
TIKI,lam-dep-suc-khoe,137567893,"Kem che khuyết điểm cho nam BB Cream Invisible 3in1 - Chống nắng SPF 45+, che khuyết điểm, dưỡng ẩm Nerman 50g",234000,330000,96000,29
TIKI,lam-dep-suc-khoe,170066840,"Combo 3 Hộp Khẩu trang Bông Bạch Tuyết 3 lớp xanh (50 cái/hộp)",177000,177000,0,0
TIKI,lam-dep-suc-khoe,87895918,"KEM BÔI NẤM HẮC LÀO LANG BEN NIROZIL – TIÊU DIỆT VI KHUẨN VÀ NẤM GÂY BỆNH TRÊN DA - GIÚP LÀM DỊU MÁT DA KHI BỊ NGỨA NGÁY KHÓ CHỊU – TUÝP 10 GAM",48000,50000,2000,4
TIKI,lam-dep-suc-khoe,16214220,"Tắm gội 2 trong 1 Romano Classic cổ điển lịch lãm phiên bản Deluxe nhanh chóng tiện dụng 650gr",150000,191000,41000,21
TIKI,lam-dep-suc-khoe,105085139,"Nấm Xích Linh Chi Nhật - Cắt lát - Hộp 100g - Linh Chi Vina",110000,110000,0,0
TIKI,lam-dep-suc-khoe,48563739,"Máy tẩy lông đa năng 2in1 Kemei KM-2668 chuyên dụng 2 đầu thay thế nhổ lông và cạo lông toàn thân sử dụng pin sạc tiện lợi",408000,429000,21000,5
TIKI,lam-dep-suc-khoe,1796487,"Nước Hoa Hồng cho Da Mụn Eucerin Pro ACNE Solution Toner (200ml)",264000,389000,125000,32
TIKI,lam-dep-suc-khoe,49304291,"Tinh Chất cho da nhạy cảm Skin1004 Madagascar Centella Asiatica Ampoule 55ml",209000,209000,0,0
TIKI,lam-dep-suc-khoe,146491933,"Máy Massage Giác Hơi, Cạo Gió Điện Tử",180000,180000,0,0
TIKI,lam-dep-suc-khoe,162144054,"Sữa Rửa Mặt Tạo Bọt Tơ Tằm Sạch Thoáng Không Khô Da Cỏ Mềm 150ml",95000,95000,0,0
TIKI,lam-dep-suc-khoe,52779807,"Mặt Nạ Ngủ Cho Môi Laneige Lip Sleeping Mask Grapefruit EX 20g",375000,500000,125000,25
TIKI,lam-dep-suc-khoe,72314141," CỌ LƯNG XUẤT NHẬT LOẠI DÀI tặng kèm bông tắm kỳ ghét ( giao mầu ngẫu nhiên )",55000,55000,0,0
TIKI,lam-dep-suc-khoe,53016082,"Dermato 200 - Giải Pháp Ngăn Ngừa Rụng Tóc - Nấm Da Đầu - Tóc Hư Tổn",401800,410000,8200,2
TIKI,lam-dep-suc-khoe,101627610,"Son Dưỡng Môi, Làm Hồng và Mềm Mại Môi Cho Mẹ Bầu Wonmom ( Màu Đỏ, Cam, Hồng )",130000,150000,20000,13
TIKI,lam-dep-suc-khoe,1419777,"Kem Dưỡng Chống Khô Da Avène Cold Cream (100ml)",424150,499000,74850,15
TIKI,lam-dep-suc-khoe,42953711,"Canxi Osteocare nước",321000,321000,0,0
TIKI,lam-dep-suc-khoe,77112106,"Viên Uống Bổ Não DHC Nhật Bản Bổ Sung DHA",315000,375000,60000,16
TIKI,lam-dep-suc-khoe,75540593,"Tinh dầu dưỡng tóc OGX Argan Oil Of Morocco",280000,280000,0,0
TIKI,lam-dep-suc-khoe,48186318,"Tinh bột nghệ nguyên chất Vinafruits",99000,99000,0,0
TIKI,lam-dep-suc-khoe,159886869,"Kem dưỡng ngày trắng da, làm sáng da,làm mờ dấu hiệu lão hóa da Lá House Herbal White DD Cream SPF 60PA+++ 10ml/30ml",445000,445000,0,0
TIKI,lam-dep-suc-khoe,186299514,"Túi chườm nóng thảo dược giảm đau vai gáy dùng lò vi sóng - Hapaku",545000,569000,24000,4
TIKI,lam-dep-suc-khoe,115149710,"Miếng dán thải độc bàn chân To Plan 30 miếng Nhật Bản (Kendo)",330000,330000,0,0
TIKI,lam-dep-suc-khoe,39301439,"Đai Chống Gù Lưng Cho Người Lớn miDoctor - Loại Cao Cấp mi03",169000,169000,0,0
TIKI,lam-dep-suc-khoe,525403,"Sữa Tắm Romano Attitude 650g",148000,186000,38000,20
TIKI,lam-dep-suc-khoe,54032161,"Dung dịch chấm mụn bí đao Cocoon 5ml",125000,125000,0,0
TIKI,lam-dep-suc-khoe,171725362,"Thực Phẩm Bảo Vệ Sức Khỏe Thiên Sư - Viên Dưỡng Nhan - Điều hòa khí huyết, điều hòa tử cung, Chăm sóc buồng trứng của bạn, đẩy lùi dấu vết thời gian",790000,790000,0,0
TIKI,lam-dep-suc-khoe,2626717,"Hộp 8 Miếng Mặt Nạ Kiểm Soát Dầu Và Mụn Naruko Tràm Trà (Bản Đài) - Tea Tree Shine Control And Blemish Clear Mask",299000,299000,0,0
TIKI,lam-dep-suc-khoe,195304607,"Bao cao su siêu siêu mỏng Powermen điệp viên tàng hình INVI 0.03mm, ngăn ngừa xuất tinh sớm Hộp 3 bcs (SSU3)",75000,75000,0,0
TIKI,lam-dep-suc-khoe,14850159,"Dầu gội cho tóc dầu L'oreal Serie Expert Citramine Pure Resource Oil Controlling Purifying shampoo",420000,440000,20000,5
TIKI,lam-dep-suc-khoe,136855420,"Sữa tắm nam Bergami hương nước hoa Shocking Man",152000,239000,87000,36
TIKI,lam-dep-suc-khoe,20866305,"Dầu massage hương sả chanh 410ml",87000,89000,2000,2
TIKI,lam-dep-suc-khoe,59149307,"Viên Kẹo Ngậm Hỗ Trợ Giảm Đau Giảm Viêm Giảm Sưng Phù Nề KOTAS FRANCE (Hộp 20 viên)",39000,58000,19000,33
TIKI,lam-dep-suc-khoe,45818013,"Ghế kê chân vệ sinh SQUATPRO Model 20120 Loại Lớn cao 21cm, giúp đi vệ sinh đúng chuẩn, kích thích cho đường tiêu hóa - Hàng chính hãng - Màu",79000,79000,0,0
TIKI,lam-dep-suc-khoe,58668720,"Combo 2 Sữa tắm hương nước hoa Enchanteur Romantic 650gr/ Chai",392000,392000,0,0
TIKI,lam-dep-suc-khoe,653805,"Bọt Cạo Râu Gillette Hương Chanh (175g)",77900,84000,6100,7
TIKI,lam-dep-suc-khoe,24786380,"Tinh Chất Tẩy Tế Bào Chết Và Cấp Nước The Ordinary Lactic Acid 10% + HA 30ml",319000,319000,0,0
TIKI,lam-dep-suc-khoe,183363969,"Máy xông tinh dầu công nghiệp Oilmart công suất lớn cho Spa, Khách sạn, Nhà hàng, Karaoke, Cửa hàng",1790000,1790000,0,0
TIKI,lam-dep-suc-khoe,96182490,"Combo Mật ong rừng sữa ong chúa Honimore 500g và mật ong rừng nguyên chất Honimore 360g - Giúp đẹp da, tăng cường sức đề kháng",240000,357000,117000,33
TIKI,lam-dep-suc-khoe,190645315,"Sữa Rửa Mặt Dịu Nhẹ Cho Da Khô CeraVe Hydrating Cleanser 236ml",262000,330000,68000,21
TIKI,lam-dep-suc-khoe,442362,"Nhiệt Kế Điện Tử Dạng Bút Microlife MT500",97000,159000,62000,39
TIKI,lam-dep-suc-khoe,41299268,"Tăng khả năng thụ thai Pregnacare him & her conception 60 viên",425000,425000,0,0
TIKI,lam-dep-suc-khoe,58807834,"Đai chống gù lưng, đai nẹp lưng chống gù GoodFit thiết kế hình chữ Y, dây đai tùy chỉnh GF712P",199000,250000,51000,20
TIKI,lam-dep-suc-khoe,184449858,"Xịt chống muỗi hương hoa oải hương Remos Lavender (60ml)",34000,39000,5000,13
TIKI,lam-dep-suc-khoe,23576165,"KEM ĐÁNH RĂNG KIN B5 LÀM SẠCH MẢNG BÁM VÀ PHỤC HỒI NƯỚU RĂNG 125ML",180000,180000,0,0
TIKI,lam-dep-suc-khoe,469250,"Dầu Gội Head & Shoulders Bạc Hà Làm Sạch Gàu (625ml)",156000,179000,23000,13
TIKI,lam-dep-suc-khoe,73855531," Kem Trẻ Hóa Làm Hồng Vùng Kín GigaWhite V1 Từ Nuwhite Mibiti Prudente 5ml",660000,660000,0,0
TIKI,lam-dep-suc-khoe,90899040,"Nước Hồng Sâm Won KGC Cheong Kwan Jang 30 Gói 70ml",894000,970000,76000,8
TIKI,lam-dep-suc-khoe,2493543,"Dầu Dừa Lên Men Tách Lạnh Tinh Khiết VietHealthy 300ml",155000,155000,0,0
TIKI,lam-dep-suc-khoe,270548772,"Sụn vi cá mập Healthy Care Shark Cartilage Tăng cường sức khỏe xương khớp, Tăng chức năng vận động - QuaTangMe Extaste",437000,874000,437000,50
TIKI,lam-dep-suc-khoe,177564220,"Serum hôi nách INOD Huyền Phi 5ml tác dụng triệt hôi nách, hôi chân , mồ hôi tay chân vĩnh viên",170000,170000,0,0
TIKI,lam-dep-suc-khoe,91760415,"Bao cao su Powermen Siêu siêu mỏng 0.03 mm, chống xuất tinh sớm Hộp 9 BCS - che tên khi giao hàng",60000,60000,0,0
TIKI,lam-dep-suc-khoe,109510910," Nước Xịt Khoáng Dưỡng Da Avene Thermal Spring Water 300ml (Tặng băng đô mèo xinh xắn màu sắc ngẫu nhiên)",299000,399000,100000,25
TIKI,lam-dep-suc-khoe,272254282,"Collagen Youtheory Mỹ Type 1,2,3 hỗ trợ tăng sức khỏe và làm chậm quá trình lão hóa cho da, tóc, móng, sụn, gân, dây chằng, khớp - OZ Slim Store",598000,1196000,598000,50
TIKI,lam-dep-suc-khoe,20058011,"Lăn Cầu Gai Đôi Lớn - Diện Chẩn Loại 1",207000,207000,0,0
TIKI,lam-dep-suc-khoe,52006149,"Khẩu trang (Combo 02) - Khẩu trang than hoạt tính NeoVision NeoMask NC95, chuẩn N95 (Thun qua gáy-Có hộp) - Chống bụi siêu mịn PM2.5, lọc khuẩn BFE >95% (Được cấp bởi Nelson Lab), kháng khuẩn, chống giọt bắn có thể giặt tái sử dụng",148800,160000,11200,7
TIKI,lam-dep-suc-khoe,179795085,"Dầu Gội Phủ Bạc SIN HAIR Nhật Bản 500ml (Màu Đen) Chiết Xuất 100% Thảo Dược Thiên Nhiên, Tặng Kèm Lược Chải Tóc",259000,259000,0,0
TIKI,lam-dep-suc-khoe,2449609,"Combo tinh dầu sả chanh Lorganic (50ml) +tinh dầu sả chanh Lorganic treo xe hơi, tủ áo  (10ml) / Tinh dầu thiên nhiên nguyên chất/ Hương thơm thiền tịnh/ Thích hợp dùng với đèn xông và máy khuếch tán.",145000,285000,140000,49
TIKI,lam-dep-suc-khoe,19404081,"Kem đánh răng SENSODYNE Cool Gel - mát lạnh (100g)",61000,74000,13000,18
TIKI,lam-dep-suc-khoe,118899755,"Lược Phủ bạc Hắc Nhân Sâm Hàn Quốc - MÀU NÂU - Làm nâu tóc bạc màu tự nhiên, không gây dị ứng, kích ứng da đầu.",350000,350000,0,0
TIKI,lam-dep-suc-khoe,5136723,"Gel chống nắng Fixderma Shadow SPF 30+ Gel (75g)",198000,273000,75000,27
TIKI,lam-dep-suc-khoe,7264165,"Kềm bộ thép không gỉ MD-33",386400,420000,33600,8
TIKI,lam-dep-suc-khoe,35363516,"Tinh chất làm mờ thâm mụn mạnh The Ordinary Ascorbyl Glucoside Solution 12% ",499000,499000,0,0
TIKI,lam-dep-suc-khoe,13737235,"Tinh dầu dưỡng tóc Loreal Serie Expert Absolut Repair Double Serum for sealing split ends for very damaged hair 50ML",464000,478000,14000,3
TIKI,lam-dep-suc-khoe,55102731,"Tinh dầu Cà Phê (Coffee) 100ml Mộc Mây - tinh dầu thiên nhiên nguyên chất 100% - chất lượng và mùi hương vượt trội",259000,259000,0,0
TIKI,lam-dep-suc-khoe,126945352,"Bộ 2 Hộp Bao Cao Su LifeStyles Zero Super Thin Siêu Mỏng Cao Cấp Hộp 12 bao",358000,420000,62000,15
TIKI,lam-dep-suc-khoe,144520770,"Máy đo nghe tim thai cá nhân Jumper 100E (Chứng nhận FDA Hoa Kỳ)",1875000,1875000,0,0
TIKI,lam-dep-suc-khoe,69225584,"Combo 2 Bông tắm tròn Venus BR47-Tạo bọt nhiều, tấy da chết, thẩm thấu sữa tắm nhiều,massge thư giãn (Giao màu ngẫu nhiên)",38400,38400,0,0
TIKI,lam-dep-suc-khoe,107254998,"Trà diếp cá Orihiro hỗ trợ thanh nhiệt, thải độc 60 gói/túi",150000,300000,150000,50
TIKI,lam-dep-suc-khoe,117147635,"Sữa rửa mặt Simple giúp da sạch thoáng & không chứa xà phòng 150ml [CHÍNH HÃNG ĐỘC QUYỀN]",96000,132000,36000,27
TIKI,lam-dep-suc-khoe,77734973,"Viên Uống Hỗ Trợ Bệnh Trĩ Nội, Trĩ Ngoại - Ngăn Ngừa Đau Rát, Chảy Máu - Tottri - Cobutri - Ultratin Fort Hộp 30 Viên",70000,80000,10000,13
TIKI,lam-dep-suc-khoe,80591971,"Máy cạo râu khô và ướt cao cấp Philips Norelco S5355/82 tích hợp đầu cạo linh hoạt theo 5 hướng cạo nhanh và sát - Hàng Nhập Khẩu",2682000,2682000,0,0
TIKI,lam-dep-suc-khoe,127152446,"Bột trắng răng, Kem đánh răng trắng răng Eucryl Anh Giúp răng trắng sáng bền lâu , sạch bóng và thơm mát cả nhà - OZ Slim Store -2x62g/tuýt, 50g/hộp",247000,494000,247000,50
TIKI,lam-dep-suc-khoe,89858782,"Bộ Dung Dịch Vệ Sinh Phụ Nữ Lactacyd Soft & Silky Dưỡng Ẩm 250ml + Pro Sensitive Cho Da Nhạy Cảm 250ml",176000,190000,14000,7
TIKI,lam-dep-suc-khoe,20637533,"Sensodyne Gentle Whitening - giúp làm trắng răng tự nhiên",74100,86000,11900,14
TIKI,lam-dep-suc-khoe,170066649,"Bông tẩy trang làm sạch da Bạch Tuyết Calla Mềm Mịn 1Kg",265000,265000,0,0
TIKI,lam-dep-suc-khoe,35594360,"Sữa Rửa Mặt Dưỡng Ẩm Ohui Miracle Moisture Cleansing Foam 80ml",183000,370000,187000,51
TIKI,lam-dep-suc-khoe,31264730,"Nước hoa khô À PARIS Cỏ Mềm",184000,200000,16000,8
TIKI,lam-dep-suc-khoe,30159868,"Gel bí đao rửa mặt Cocoon (Winter melon cleanser) 140ml",150000,150000,0,0
TIKI,lam-dep-suc-khoe,159971125,"Khẩu trang y tế 4D (KF94) NPCARE Sharing Love (H/10c)",30000,30000,0,0
TIKI,lam-dep-suc-khoe,167136662,"Máy đo huyết áp có giọng nói Tiếng Việt Sinocare BA 801",270000,270000,0,0
TIKI,lam-dep-suc-khoe,99834439,"Guasha Thạch Anh Hồng (rose quartz) - Sản phẩm cho sức khỏe của bạn",199000,199000,0,0
TIKI,lam-dep-suc-khoe,76222795,"Combo Máy Khuếch Tán Tinh Dầu TIDAMO + 3 Chai Tinh dầu: Sả chanh + Bạc Hà + Vỏ Quế - Máy Xông Tinh Dầu Có Remote Điều Khiển Từ Xa Chuyên Dụng Xông Tinh Dầu Cho Phòng Rộng",292400,668000,375600,56
TIKI,lam-dep-suc-khoe,7412327,"Sủi Da S-508",59800,65000,5200,8
TIKI,lam-dep-suc-khoe,1257109,"Kem Đánh Răng Than Hoạt Tính P/S (180g)",28000,28000,0,0
TIKI,lam-dep-suc-khoe,167939621,"Bao Cao Su Size Nhỏ Kéo Dài Thời Gian Power Men Longer Extra Dots (H12) - Gai Nhỏ Li Ti - Che Tên Sản Phẩm",140000,140000,0,0
TIKI,lam-dep-suc-khoe,114379026,"Hỗ trợ trị mụn Zinc For Acne Skin Formula Puritan's Pride Mỹ - Làm đẹp, Tăng sức đề kháng - Massel Official  - 100v",307000,624000,317000,51
TIKI,lam-dep-suc-khoe,3950303,"Kem Chống Nắng Trang Điểm Eucerin Sun Creme Face-Tinted CC Cream SPF50+ (50 ml)",359000,500000,141000,28
TIKI,lam-dep-suc-khoe,73211975,"Dầu gội vỏ bưởi & Bồ kết 300ml sạch da đầu gàu, kích thích mọc tóc, giảm rụng tóc",202500,225000,22500,10
TIKI,lam-dep-suc-khoe,877400,"Combo 5 Giấy Thấm Dầu Mayan (200 Tờ / Gói)",144000,175000,31000,18
TIKI,lam-dep-suc-khoe,174449729,"Trà Cà Gai Leo Mộc Can, Trà túi lọc mát gan giải độc gan hạn chế tổn thương tế bào gan 1 hộp 15 túi lọc",90000,90000,0,0
TIKI,lam-dep-suc-khoe,105788342,"Kem Chống Nắng Dành Cho Da Khô Nhạy Cảm La Roche-Posay Anthelios Hydrating Cream SPF50+ 50ml (Tặng băng đô mèo xinh xắn)",439000,550000,111000,20
TIKI,lam-dep-suc-khoe,101870040,"VIÊN UỐNG DẦU CÁ OMEGA 369 PLUS - GIÚP BỔ SUNG TINH CHẤT DẦU CÁ OMGA 3, DẦU GẤC, VITAMIN E, DẦU HOA ANH THẢO GIÚP SÁNG MẮT ĐẸP DA, TỐT CHO TIM MẠCH – LỌ 100 VIÊN",70000,90000,20000,22
TIKI,lam-dep-suc-khoe,205811873,"Bao cao su Shell Performax 6 in 1 - Kéo dài thời gian - Hộp 10 cái",165600,180000,14400,8
TIKI,lam-dep-suc-khoe,188712838,"Bộ Dầu Gội Và Xả bưởi the Cocoon cung cấp dưỡng chất giúp tóc mềm và giảm gãy rụng 310ml",340000,340000,0,0
TIKI,lam-dep-suc-khoe,178561489,"Tinh chất xịt dưỡng tóc kích thích mọc tóc giảm rụng tóc Dr.FORHAIR Folligen Tonic Original 120ml",319000,319000,0,0
TIKI,lam-dep-suc-khoe,26710798,"Combo 10 Túi Mặt nạ dưỡng da - Mặt nạ giấy chiết xuất từ nhân sâm đỏ 3W CLINIC Hàn Quốc 23mlx10",48600,48600,0,0
TIKI,lam-dep-suc-khoe,76777458,"Tinh Dầu Xông Phòng TRẦM HƯƠNG TIDAMO 100ML - Tinh Dầu Trầm Hương Cao Cấp Từ Thiên Nhiên Giúp Bảo Vệ Sức Khỏe, Thư Giãn Và Tĩnh Lặng Tinh Thần - Kiểm Nghiệm Chất Lượng Tại Trung Tâm Quatest 3",198000,456000,258000,57
TIKI,lam-dep-suc-khoe,35232336,"Kem dưỡng ẩm The Ordinary Natural Moisturizing Factors + HA 100ml",439000,439000,0,0
TIKI,lam-dep-suc-khoe,143226675,"Máy Mài Mini - Máy Mài Móng Cầm Tay Mini",99000,99000,0,0
TIKI,lam-dep-suc-khoe,26752460,"Hộp 20 miếng dán mắt 3M Nexcare 1539 hỗ trợ nhược thị cho trẻ cỡ lớn, sản xuất Canada",110000,110000,0,0
TIKI,lam-dep-suc-khoe,115011924,"Combo 2 Sữa Tắm L'amont En Provence Hoa Anh Đào và Hoa Hồng 1000ml/chai",299000,299000,0,0
TIKI,lam-dep-suc-khoe,66528802,"Tinh dầu treo xe ô tô sả chanh cao cấp, để xe hơi, thơm phòng",65000,69000,4000,6
TIKI,lam-dep-suc-khoe,248764477,"Toner (Nước Cân Bằng) Cho Da Dầu Mụn Viêm Fairy Water Dermarium",150000,150000,0,0
TIKI,lam-dep-suc-khoe,76795851,"Sữa Rửa Mặt NAM Giúp Dưỡng Ẩm Sạch Nhờn Ngừa Mụn",119000,190000,71000,37
TIKI,lam-dep-suc-khoe,161409434,"Kem giảm thâm nách và khử mùi Cléo 35g 6in1 chiết xuất thiên nhiên",186000,250000,64000,26
TIKI,lam-dep-suc-khoe,40668630,"Bộ Đổi Nguồn Dùng Cho Máy Đo Huyết Áp Omron - Ac Adapter (Bộ Thường)",107000,107000,0,0
TIKI,lam-dep-suc-khoe,5136631,"Kem sáng da Fixderma Skarfix Plus Cream (15g)",178000,246000,68000,28
TIKI,lam-dep-suc-khoe,147805882,"Đầu bàn chải đánh răng điện Philips Sonicare C2 HX9021",305000,305000,0,0
TIKI,lam-dep-suc-khoe,22653740,"Sáp tạo kiểu tóc Nam Schwarzkopf Professional OSiS+ 3 Thrill Fiber Gum chính hãng 100ml",276000,290000,14000,5
TIKI,o-to-xe-may-xe-dap,105328503,"Mũ Bảo Hiểm 1/2 Chita CT31 - Nhiều màu",182000,260000,78000,30
TIKI,o-to-xe-may-xe-dap,102387065,"Đèn xe đạp thể thao KIOTOOL siêu sáng có còi pin sạc usb led T6 chống nước - Đèn còi xe đạp có 3 chế độ sáng còi to",84000,84000,0,0
TIKI,o-to-xe-may-xe-dap,3665433,"Dung dịch chống bám nước kính xe 3M Glass Coat Windshield 3M 08889 LT 200ml",151000,159000,8000,5
TIKI,o-to-xe-may-xe-dap,50819880,"Bơm xe đạp, xe máy xách tay siêu nhẹ, áp suất 120 PSI, thân hợp kim siêu bền, hỗ trợ cả van Mỹ và van Pháp, bơm được cho tất cả các loại xe đạp bao gồm xe đua, xe địa hình, xe đạp đường trường, thương hiệu Wheel Up - Hàng chính hãng ",95000,95000,0,0
TIKI,o-to-xe-may-xe-dap,147969040,"[VIDEO]- Tấm lưới đệm ghế cho văn phòng, học sinh 40x40cm- Đệm tựa lưng ghế cho xe ôtô, tàu",45000,45000,0,0
TIKI,o-to-xe-may-xe-dap,96616121,"Tinh Dầu Treo Xe Hơi, Treo Phòng Gia Đình| Tự Chọn Mùi, Nguyên Chất,Có Kiểm Định Chất Lượng| Tinh Dầu TIDAMO Khử Mùi Xe Hơi, Thơm Phòng, Thư Giản Tinh Thần",54400,88000,33600,38
TIKI,o-to-xe-may-xe-dap,1254583,"Dung Dịch Chống Bám Nước Trên Kính Xe 3M Glass Coat Windshield 3M 08889 (200ml)",148000,148000,0,0
TIKI,o-to-xe-may-xe-dap,107234723,"Mũ bảo hiểm xe đạp trẻ em Protec SMILE W024, nón bảo hiểm siêu nhẹ tiêu chuẩn Châu Âu, có đèn hậu an toàn, họa tiết đẹp, ấn tượng cho cả bé trai và bé gái",335000,438000,103000,24
TIKI,o-to-xe-may-xe-dap,892527,"Dung Dịch Tẩy Keo, Nhựa Đường 3M 08987 (425 g)",155000,155000,0,0
TIKI,o-to-xe-may-xe-dap,2250775,"Bộ Combo Vệ Sinh Dưỡng Sên Xe Máy Thunder (Giao màu ngẫu nhiên)",112000,112000,0,0
TIKI,o-to-xe-may-xe-dap,110646106,"Bơm xe đạp xe máy Kiotool chuyên dụng ống to nhanh đầy hơi bơm nhẹ  có đầy đủ phụ kiện bơm bóng đá thú nhún bơm phao bơi",125000,125000,0,0
TIKI,o-to-xe-may-xe-dap,77281216,"Tinh Dầu Trầm Hương Cao Cấp Treo Xe Ô Tô, Treo Tủ Quần Áo, Treo Phòng Gia Đình - Tinh Dầu Trầm Hương TIDAMO (Agarwood) Giúp Khử Mùi, Kháng Khuẩn Và Thư Giãn Tinh Thần",58000,116000,58000,50
TIKI,o-to-xe-may-xe-dap,219138799,"Ô che nắng ô tô gấp gọn, tấm che nắng kính lái ô tô xe hơi chống nóng kính trước chống tia cực tím UPF 50+ TÂM LUÂN Chổi lau tẩm dầu - Hàng chính hãng",209000,300000,91000,30
TIKI,o-to-xe-may-xe-dap,892525,"Chai Xịt Chăm Sóc Và Bảo Vệ Nội Thất Ô Tô 3M 39040 (473ml)",266000,273000,7000,3
TIKI,o-to-xe-may-xe-dap,72637459,"Bơm xe máy - Bơm xe đạp chân - Bơm đạp chân 2 ống đa năng - Bơm hơi đạp chân mini Xe Đạp, Xe Máy, Xe Ô tô, Xe Hơi Đa Năng Dễ Dàng Xếp Gọn thân hợp kim siêu bền, hỗ trợ cả van Mỹ và van Pháp Thương hiệu KIOTOOL",225000,225000,0,0
TIKI,o-to-xe-may-xe-dap,42758063,"Bộ 4 Tấm Chắn Nắng Ô Tô Xe Hơi Phản Quang, Tấm Che Nắng Ô Tô Cách Nhiệt Chống Thấm, Kích Thước Tiêu Chuẩn Phù Hợp Với Tất Cả Các Loại Kính Xe",32000,43000,11000,26
TIKI,o-to-xe-may-xe-dap,171125391,"Combo 2 Móc Dán Treo Đồ Xe Hơi, Ô Tô - Dính Siêu Chắc - Nhựa ABS Siêu Bền - Treo Cáp Sạc, Chìa Khóa, Túi Xách",26000,26000,0,0
TIKI,o-to-xe-may-xe-dap,167209871,"Tấm che nắng kính lái xe hơi, bạt chắn nắng cách nhiệt cho ô tô - Hàng Chính Hãng",96000,110000,14000,13
TIKI,o-to-xe-may-xe-dap,84132267,"Thùng rác mini có nắp, hộp đựng rác có chốt cài treo thành cửa treo lưng ghế ô tô, xe hơi- Hàng chính hãng",87000,87000,0,0
TIKI,o-to-xe-may-xe-dap,176731581,"Xe máy điện VinFast Feliz S",27000000,27000000,0,0
TIKI,o-to-xe-may-xe-dap,28035643,"Bạt Phủ Ô Tô Tráng Nhôm Phủ Nano Chống Nắng, Bạt Trùm Xe Hơi Cách Nhiệt Cao Cấp, Hàng Chính Hãng",345000,490000,145000,30
TIKI,o-to-xe-may-xe-dap,270483515,"Bộ 2 Gương cầu lồi ô tô Hàng Xuất Khẩu Mỹ, tráng bạc dày công nghệ gương Bỉ TÂM LUÂN Chổi lau tẩm dầu - Hàng chính hãng",58000,100000,42000,42
TIKI,o-to-xe-may-xe-dap,184080370,"Bơm Xe Đạp , Bơm Xe Máy Nhỏ Gọn Mini KIOTOOL Xách Tay Siêu Nhẹ, Áp Suất 120 PSI Hỗ Trợ Cả Van Mỹ và Van Pháp - Hàng Chính Hãng",78000,78000,0,0
TIKI,o-to-xe-may-xe-dap,225171842,"Máy Bơm Ô tô, Xe hơi Đa Năng Michelin 12266 - Hàng Chính Hãng",981000,981000,0,0
TIKI,o-to-xe-may-xe-dap,72557905,"Bơm Đạp Chân  Xe Đạp, Xe Máy, Xe Ô tô, Xe Hơi Đa Năng Dễ Dàng Xếp Gọn Và Sử Dụng Kèm 3 Chốt Chân Lỗ bơm bóng và thú nhún  thương hiệu bơm xe KIOTOOL",195000,195000,0,0
TIKI,o-to-xe-may-xe-dap,77280988,"Tinh Dầu Vỏ Quế Nguyên Chất Treo Xe Ô Tô, Treo Tủ Quần Áo, Treo Phòng Gia Đình - Tinh Dầu Quế TIDAMO (Cinnamon) Cao Cấp Nhập Khẩu Giúp Khử Mùi, Kháng Khuẩn Và Thư Giãn Tinh Thần",58000,116000,58000,50
TIKI,o-to-xe-may-xe-dap,82672362,"Phiếu Mua Xe Máy Honda HEAD Hồng Hạnh",5000000,5000000,0,0
TIKI,o-to-xe-may-xe-dap,130211300,"Đèn Pha Led Xe Đạp Thể Thao San01 Siêu Sáng Gắn Ghi Đông Siêu Sáng Có Sạc Điện",54000,54000,0,0
TIKI,o-to-xe-may-xe-dap,76474280,"Tinh Dầu CAM NGỌT Treo Xe Ô Tô, Treo Tủ Quần Áo, Treo Phòng Gia Đình - Tinh Dầu Cam Nguyên Chất TIDAMO Giúp Khử Mùi, Kháng Khuẩn Và Thư Giãn Tinh Thần",48000,96000,48000,50
TIKI,o-to-xe-may-xe-dap,194033373,"Mũ bảo hiểm nửa đầu NON CAMRY CR04 thời trang, nhiều màu sắc trẻ trung, lưỡi trai mềm cá tính- Hàng chính hãng",155000,205000,50000,24
TIKI,o-to-xe-may-xe-dap,3642617,"Khăn lau xe đa năng 3M 50400VL",67000,77000,10000,13
TIKI,o-to-xe-may-xe-dap,7101469,"Mũ bảo hiểm 1/2 CHITA CT30",210000,300000,90000,30
TIKI,o-to-xe-may-xe-dap,187642488,"Mũ bảo hiểm nửa đầu có họa tiết SRT ASA 05 kèm kính phi công, kính UV thời trang, cá tính- Hàng chính hãng",145000,260000,115000,44
TIKI,o-to-xe-may-xe-dap,184476149,"Chai xịt diệt khuẩn khử mùi ô tô xe khách bằng nano bạc Nano Reiwa 430ml hương quế dịu nhẹ, được chứng nhận viện Pasteur an toàn cho trẻ em - Hàng chính hãng",89100,99000,9900,10
TIKI,o-to-xe-may-xe-dap,76474213,"Tinh Dầu Sả Chanh Treo Xe Ô Tô, Treo Tủ Quần Áo, Treo Phòng Gia Đình - Tinh Dầu Sả Chanh Nguyên Chất TIDAMO Giúp Khử Mùi, Kháng Khuẩn Và Thư Giãn Tinh Thần",54000,108000,54000,50
TIKI,o-to-xe-may-xe-dap,109580095,"Nước rửa kính lái chuyên dụng ô tô [5 Lít]",199000,235000,36000,15
TIKI,o-to-xe-may-xe-dap,156224243,"Tấm Lưới Đệm Tựa Lưng, Đệm Ghế Ô Tô, Ghế Văn Phòng - Matxa Thư Giãn Cột Sống Chống Mỏi Lưng - Hangf Loại 1 Chính Hãng MINIIN",59000,59000,0,0
TIKI,o-to-xe-may-xe-dap,134505835,"Can Phun Khói Nano Bạc Diệt Khuẩn Khử Mùi Ô TÔ, Nhà Cửa Nano Reiwa (Hàng chính hãng)",390202,528000,137798,26
TIKI,o-to-xe-may-xe-dap,68758301,"Bơm hợp kim nhôm loại đạp chân dùng cho xe đạp, xe máy, ô tô, có đồng hồ báo áp suất nhỏ gọn vừa cốp xe thương hiệu Kiotool hàng chính hãng",135000,135000,0,0
TIKI,o-to-xe-may-xe-dap,51511284,"Nước Châm Kính Ô Tô OUFU AF-1205 2l",50000,59000,9000,15
TIKI,o-to-xe-may-xe-dap,171871473,"Chai Xịt Dưỡng Sên Voltronic IX50 Chính Hãng Nhập Khẩu Đức",280000,280000,0,0
TIKI,o-to-xe-may-xe-dap,21076785,"Bảng số điện thoại gắn taplo ô tô, xe hơi",9000,9000,0,0
TIKI,o-to-xe-may-xe-dap,71537490,"Máy Khuếch Tán Tinh Dầu Xe Hơi Cao Cấp và Chuyên Dụng, Máy Xông Tinh Dầu Dùng Điện USB Trên Xe ô tô, Đèn LED Cực Đẹp, Không Dùng Lõi Bông",198000,456000,258000,57
TIKI,o-to-xe-may-xe-dap,77917419,"Bơm xe máy KIO-02 Phiên bản Xanh - Bơm xe đạp chân - Bơm đạp chân 2 ống đa năng - Bơm hơi đạp chân mini Xe Đạp, Xe Máy, Xe Ô tô, Xe Hơi Đa Năng Dễ Dàng Xếp Gọn thân hợp kim siêu bền, hỗ trợ cả van Mỹ và van Pháp Thương hiệu KIOTOOL",225000,225000,0,0
TIKI,o-to-xe-may-xe-dap,122437266,"Đệm lót yên sau xe đạp Kiotool êm ái  bền đẹp không thấm nước",44000,44000,0,0
TIKI,o-to-xe-may-xe-dap,69139354,"Phủ nano kính xe ô tô 3M 200Ml (Tặng kèm khăn + găng tay Nilong)",180000,180000,0,0
TIKI,o-to-xe-may-xe-dap,6866413,"Keo dán đa năng siêu dính Scotch-Weld 20g 3M PR100",108000,108000,0,0
TIKI,o-to-xe-may-xe-dap,75337304,"Yên xe đạp thể thao , Carbon siêu êm , Chính hãng Shengxin , da PU cao cấp - Tặng kèm chuông",109000,109000,0,0
TIKI,o-to-xe-may-xe-dap,74858683,"Mũ Bảo Hiểm 1/2 Đầu Napoli Haley N120 Nhiều Màu - Freesize 54cm – 58cm",176000,299000,123000,41
TIKI,o-to-xe-may-xe-dap,72103308,"Đệm Yên Xe Đạp Thể Thao Đàn Hồi Mềm Dày Thoáng Khí Cao Cấp Giúp Êm Mông Thoải Mái (Bản Nâng Cấp) Chống Trượt, Siêu Êm Có Lỗ Rãnh Thoát (Thân Rộng) Mai Lee",96235,101300,5065,5
TIKI,o-to-xe-may-xe-dap,272128944,"Kem đánh bóng sơn xe ô tô (Car Cream) Karshine 110g KA-CC110",42000,42000,0,0
TIKI,o-to-xe-may-xe-dap,74448331,"Bạt Xe Máy KhoNCC Vải Dù",139000,188000,49000,26
TIKI,o-to-xe-may-xe-dap,50392581,"Mũ Bảo Hiểm Royal M139 Kính Âm",530000,560000,30000,5
TIKI,o-to-xe-may-xe-dap,51058763,"Combo 4 Tấm Chắn Nắng Ô TÔ Núm Hít Cực Rẻo Hút Chắc Hàng Dầy Đẹp",47491,49990,2499,5
TIKI,o-to-xe-may-xe-dap,57983642,"Dung Dịch Vệ Sinh Sên / Xích Voltronic IX69-K Chain Cleaner 600ml",185000,185000,0,0
TIKI,o-to-xe-may-xe-dap,94715515,"Máy Xông Tinh Dầu Xe Hơi | Có Pin Tích Điện, Vỏ Kim Loại Nguyên Khối, Nút Cảm Ứng, Phun Tinh Dầu Trực Tiếp | Kèm Tinh Dầu (Tùy Chọn)",384000,1196000,812000,68
TIKI,o-to-xe-may-xe-dap,115651541,"Túi thơm cà phê TTAUTO 100% hạt nguyên chất khử mùi trên ô tô, tủ đồ, văn phòng",50000,50000,0,0
TIKI,o-to-xe-may-xe-dap,79410919,"Yên xe đạp thể thao , Yên xe đạp siêu êm , Chính hãng Sengxin , da PU cao cấp - Tặng kèm chuông 04",189000,189000,0,0
TIKI,o-to-xe-may-xe-dap,158716928,"Mũ bảo hiểm GRO 3/4 đầu ST06 (T818) hai mẫu kính, thiết kế phong cách trẻ trung, nhiều màu, thời trang cho nam và nữ- Hàng chính hãng",269000,480000,211000,44
TIKI,o-to-xe-may-xe-dap,174217849,"Nano chống tụ nước kính ô tô senfineco 9945",200000,200000,0,0
TIKI,o-to-xe-may-xe-dap,184591748,"Túi xe đạp Kiotool treo gắn sườn xe chống nước cao cấp",115000,115000,0,0
TIKI,o-to-xe-may-xe-dap,109123711,"Bạt Phủ Áo Trùm Xe Máy Vải Dù Che Mưa Nắng Thời Tiết Khắc Nghiệt Loại Lớn Cho Dòng Xe Tay Ga - Xe Số Thông Dụng",136000,220000,84000,38
TIKI,o-to-xe-may-xe-dap,3770565,"Chai xịt bôi trơn bảo dưỡng sên/ xích xe máy Thunder Chain Lube 400ml",52500,52500,0,0
TIKI,o-to-xe-may-xe-dap,1389309,"Máy Bơm Ô tô, Xe hơi Đa Năng Michelin 12266 - Hàng Chính Hãng",1069000,1069000,0,0
TIKI,o-to-xe-may-xe-dap,3217923,"Mũ bảo hiểm nửa đầu GRS A33k",275000,275000,0,0
TIKI,o-to-xe-may-xe-dap,140575066,"Đèn Xe Đạp Năng Lượng Mặt Trời | Đèn Hậu Xe Đạp Giant , Xe Đạp Thể Thao , Xe Đạp MTB | Đèn Solar Energy Hàng Chính Hãng",53000,53000,0,0
TIKI,o-to-xe-may-xe-dap,184987595,"[An Toàn] Lót Bọc Chân Chống Xe Máy KhoNCC Hàng Chính Hãng - Cao Su Chống Trầy Nền Nhà - Kèm 2 Dây Rút - Chất Liệu Dày Dặn Bền Đẹp - KK-BCCXM",3000,6000,3000,50
TIKI,o-to-xe-may-xe-dap,58244258,"Bơm lốp ô tô xiaomi 70mai midrive TP03 , Bơm lốp đa năng  , Bơm lốp mini - Hàng nhập khẩu",625000,625000,0,0
TIKI,o-to-xe-may-xe-dap,193567295,"Bơm xe máy xe đạp nhỏ gọn Kiotool đầu van đa năng",79000,79000,0,0
TIKI,o-to-xe-may-xe-dap,20586643,"Chai Xịt Chống Chuột - Đuổi Chuột Cho Xe Ô tô - Xe máy Liqui Moly Marten Spray 1515 (200ml)",137000,159000,22000,14
TIKI,o-to-xe-may-xe-dap,3668317,"Dung dịch dưỡng da, nội thất 3M 39040LT",151000,165000,14000,8
TIKI,o-to-xe-may-xe-dap,31513611," Kem đánh bóng kim loại đa dụng inox, đồng, .... Autosol Metal Polish 75ml",80000,80000,0,0
TIKI,o-to-xe-may-xe-dap,1219669,"Dung Dịch Chống Bám Nước Trên Kính Xe 3M (200ml)",185000,185000,0,0
TIKI,o-to-xe-may-xe-dap,196009852,"Băng keo cường lực 3M 5952 dài 4.5m",65000,65000,0,0
TIKI,o-to-xe-may-xe-dap,165996775,"Mũ bảo hiểm nửa đầu SRT ASA-05, nón bảo hiểm 1/2 đầu cao cấp kèm kính UV, phi công freesize 55-61cm, nhiều màu, cá tính - Hàng Chính Hãng",159000,230000,71000,31
TIKI,o-to-xe-may-xe-dap,65475914,"NƯỚC RỬA XE KHÔNG CHẠM KC06 [5 Lít]",329000,349000,20000,6
TIKI,o-to-xe-may-xe-dap,115599472,"Mũ Bảo Hiểm Nửa Đầu Protec Rosa RLW Đơn Màu - Size L",235000,318000,83000,26
TIKI,o-to-xe-may-xe-dap,32833612,"Mũ Bảo Hiểm GRS A737K",279000,279000,0,0
TIKI,o-to-xe-may-xe-dap,193579409,"Dầu nhớt tra xích xe đạp Kiotool 60 ml",22000,22000,0,0
TIKI,o-to-xe-may-xe-dap,49472693,"Nón bảo hiểm 3/4 kính âm Royal M139 Đen nhám cao cấp Lót tháo rời, che hết mặt",530000,700000,170000,24
TIKI,o-to-xe-may-xe-dap,146241256,"Bọc khóa smartkey dành cho Honda PCX, Sh và Sh mode 2021- 2022",69000,69000,0,0
TIKI,o-to-xe-may-xe-dap,270677877,"Khăn lau ô tô đa năng microfiber xám không để lại bụi vải, không để lại vệt nước, khổ to, không phai màu TÂM LUÂN Chổi lau tẩm dầu - Hàng chính hãng",34000,50000,16000,32
TIKI,o-to-xe-may-xe-dap,155753486,"Nước Rửa Kính Đậm Đặc Liqui Moly 250ml Tỉ Lệ 1:100 Dùng Cho Ô Tô",149000,149000,0,0
TIKI,o-to-xe-may-xe-dap,107458507,"Bạt phủ xe ô tô cao cấp, cho xe ôtô 4 chỗ đến 7 chỗ, phản quang,chống nóng, chống nước, có khóa kéo cánh cửa",241000,254000,13000,5
TIKI,o-to-xe-may-xe-dap,22974266,"Bộ 4 chai keo dán đa năng siêu dính nhanh khô - loại no run gel (không chảy) dạng sệt 3M Scotch Super Glue AD113 2g",81000,83165,2165,3
TIKI,o-to-xe-may-xe-dap,160907624,"[An Tâm] Khóa Đĩa Chống Trộm KhoNCC Hàng Chính Hãng Cho Xe Máy, Xe Đạp - Cốt Thép Không Gỉ Chống Trộm Cắt - KPD-KX-JinKu-3875 (Màu ngẫu nhiên)",79000,118000,39000,33
TIKI,o-to-xe-may-xe-dap,48884880,"Chân Đế Gắn Đèn Pin Vào Xe Đạp Xoay 360 Độ Gắn Đầu Phía Trước Ghi Đông Xe Đạp Cao Cấp Mai Lee (Không Kèm Đèn Pin)",82840,87200,4360,5
TIKI,o-to-xe-may-xe-dap,38357272,"Nước Rửa Xe Không Chạm Ekokemika Italy Bio 45 - (1l) - Hàng Chính Hãng",245000,245000,0,0
TIKI,o-to-xe-may-xe-dap,176733663,"Xe máy điện VinFast Klara S (2022)",35000000,35000000,0,0
TIKI,o-to-xe-may-xe-dap,7295755,"Nước rửa xe đậm đặc Sonax Gloss Shampoo 314300 1L  ",149000,149000,0,0
TIKI,o-to-xe-may-xe-dap,164554380,"Giá để chân sau xe đạp Kiotool chịu tải gấp gọn bộ 2 chiếc",35000,35000,0,0
TIKI,o-to-xe-may-xe-dap,3262161,"Mũ Bảo Hiểm GRS A966 kính giấu, tháo lót",351000,369000,18000,5
TIKI,o-to-xe-may-xe-dap,178114569,"Đèn Led hậu xe đạp - Sạc USB - Chống nước - Đèn hậu xe đạp giant, xe đạp thể thao, xe đạp MTB",77000,77000,0,0
TIKI,o-to-xe-may-xe-dap,28108147,"Băng keo cường lực dán đồ chơi xe hơi 3M 4229P 20mmx10m (Đỏ)",122000,130000,8000,6
TIKI,o-to-xe-may-xe-dap,76379559,"[Loại Lớn - Dày] Xe Tay Ga Lớn - SH150i <2m05 - Xanh Đen",159000,248000,89000,36
TIKI,o-to-xe-may-xe-dap,58618778,"Bình Xịt Vệ Sinh Ghế Da Ô Tô - Đồ Da Flamingo",44460,46800,2340,5
TIKI,o-to-xe-may-xe-dap,164554217,"Kệ Yên Sau Gác Ba Ga  Kiotool Gắn Thêm Phía Sau Cho Xe Đạp Vào Cốt Yên cho xe đạp địa hình và leo núi",245000,245000,0,0
TIKI,o-to-xe-may-xe-dap,48905443,"Máy sạc bình ắc quy cho ô tô xe máy Bosch C3 - Hàng chính hãng",1595000,2658000,1063000,40
TIKI,o-to-xe-may-xe-dap,178082163,"Chai xịt phục hồi nhựa nhám, nhựa đen, dưỡng đen dàn nhám Sprayking Plastic Shine 400ml, dàn áo phai màu",50000,50000,0,0
TIKI,o-to-xe-may-xe-dap,63818025,"Chai xịt chống chuột, đuổi chuột chuyên dụng 3M 3M-RRC tặng kèm 1 lá thơm mùi ngẫu nhiên",166000,175000,9000,5
TIKI,o-to-xe-may-xe-dap,48905197,"Máy sạc bình ắc quy cho ô tô xe máy Bosch C7 - Hàng chính hãng",2509000,4181000,1672000,40
TIKI,o-to-xe-may-xe-dap,36273203,"NƯỚc RỬa KÍnh Ô TÔ TẠo HiỆu Ứng Nano XuẤt XỨ ChÂu Âu, HƯƠng Hoa OẢi HƯƠng Xglass Lavanda (3.2l) - Hàng Chính Hãng",145000,145000,0,0
TIKI,o-to-xe-may-xe-dap,183562223,"Mũ Bảo Hiểm Xe Đạp Sợi Cacbon Siêu Nhẹ Chống Va Đập Điều Chỉnh Kích Thước Đại Nam Sport",196000,300000,104000,35
TIKI,o-to-xe-may-xe-dap,128935254,"Mũ Bảo Hiểm Nửa Đầu Kính Ẩn ANDES 181 - Nhiều Màu - Cao Cấp",389000,389000,0,0
TIKI,o-to-xe-may-xe-dap,78017031,"Máy sạc bình ắc quy 12V có chức năng khử sunfat sạc từ 4-100Ah TIANYE thông minh tự ngắt khi đầy dòng sạc 6A sạc bình ắc quy 12V sạc bình ắc quy ô tô sạc bình ắc quy xe máy(Vàng)",175000,175000,0,0
TIKI,o-to-xe-may-xe-dap,106225531,"Khăn Lau Xe Rửa Xe OTO Xe Máy Siêu Thấm Đa Năng, Khăn Lau Nội Thất Xe Hơi Xe Máy Sợi Siêu Mịn",55000,55000,0,0
TIKI,o-to-xe-may-xe-dap,5483493,"Dung dịch vệ sinh nội thất xe Sonax 321200 500ml",179000,190000,11000,6
TIKI,o-to-xe-may-xe-dap,10152416,"Giá Đỡ Điện Thoại Gắn Trên Cửa Gió Điều Hòa Ô Tô Baseus SUYL-D01",249499,249499,0,0
TIKI,o-to-xe-may-xe-dap,16287857,"Dung DỊch Rửa Xe Không Chạm Bio 30 - (1l) - Hàng Chính Hãng",150000,150000,0,0
TIKI,o-to-xe-may-xe-dap,56318825,"Mũ bảo hiểm Chita 1/2 - CT6B1 Nón cặp Tem chìa khóa",182000,260000,78000,30
TIKI,o-to-xe-may-xe-dap,147080186,"Miếng mút rửa xe bọt biển tạo bọt, siêu mịn  3M",58800,60000,1200,2
TIKI,o-to-xe-may-xe-dap,178832716,"Bơm xe đạp cầm tay mini treo xe LC - Hợp kim nhôm - Xách tay siêu nhẹ - hỗ trợ van Mỹ và van Pháp",149000,149000,0,0
TIKI,o-to-xe-may-xe-dap,192117424,"Xà bông rửa xe siêu bọt 3M Car Wash With Wax PN39000W- 1Lít",165000,205000,40000,20
TIKI,o-to-xe-may-xe-dap,73521963,"Bộ Gối Tựa Đầu, Lưng Ô Tô 100% Cao Su Non Đặc Biệt Bọc Da Cao Cấp XG-NNSM01",263000,324000,61000,19
TIKI,o-to-xe-may-xe-dap,116768956,"Chai xịt tẩy nội thất ghế da, nỉ ô tô - văn phòng FOAM CLEANER",52000,58000,6000,10
TIKI,o-to-xe-may-xe-dap,173671769,"Mũ Bảo Hiểm 3/4 HPro HP04 - Giao Nhanh - Hàng Chính Hãng",262000,320000,58000,18
TIKI,o-to-xe-may-xe-dap,56197070,"Bảng Ghi Số Điện Thoại Ô Tô, Thẻ Đỗ Xe Hiển Thị Số Điện Thoại Gắn Taplo Xe Hơi,Ô Tô Tiện Lợi",8500,8500,0,0
TIKI,o-to-xe-may-xe-dap,137001339,"[Tặng Chuông Xe Đạp Bọ Rùa Ngộ Nghĩnh] Mũ Bảo Hiểm Xe Đạp Trẻ Em, Nón Bảo Hiểm Chơi Thể Thao, Trượt Patin Cao Cấp Protec Smile W024 - Hàng Chính Hãng",335000,438000,103000,24
TIKI,o-to-xe-may-xe-dap,52696657,"Bộ 4 miếng nẹp bước chân chống trơn trượt, trày xước xe ô tô, xe hơi cao cấp",118000,118000,0,0
TIKI,o-to-xe-may-xe-dap,129228638,"Bơm xe máy đạp chân Kiotool KP02 Bassic loại 2 xi lanh - Đồ bơm xe máy xe đạp ô tô nhỏ gọn áp lực lớn 8 bar có thể  đút cốp xe máy",224000,224000,0,0
TIKI,o-to-xe-may-xe-dap,10713805,"Bảng Số Điện Thoại Trên Ô Tô Baseus ACNUM-01",269000,269000,0,0
TIKI,o-to-xe-may-xe-dap,92982560,"Nệm giường hơi cho xe ô tô, xe hơi 5, 7 chỗ cao cấp, tiện dụng có thành chắn an toàn cho trẻ nhỏ kèm theo bơm điện 12V",590000,590000,0,0
TIKI,o-to-xe-may-xe-dap,35292967,"Combo 10 giá móc treo đa năng gắn tựa đầu treo đồ vật sau ghế ô tô, xe hơi ",63000,63000,0,0
TIKI,o-to-xe-may-xe-dap,55994496,"Combo 2 Khăn Lau Xe Ô Tô Siêu Thấm, Khăn Lau Đa Năng Chất Liệu Microfiber 2 Chiếc - Hàng Chính Hãng",71000,100000,29000,29
TIKI,o-to-xe-may-xe-dap,28467118,"NƯỚC RỬA XE BỌT TUYẾT ĐẬM ĐẶC - PH CÂN BẰNG - NHIỀU BỌT 3M CAR WASH SHAMPOO 1 LIT 305860",170000,175000,5000,3
TIKI,o-to-xe-may-xe-dap,196923505,"Yên xe đạp . yên béo cực êm , chính hãng ShengXin 02",199000,199000,0,0
TIKI,o-to-xe-may-xe-dap,135442235,"Máy Hút Bụi Cầm Tay Mini Không Dây Deli - Làm Sạch Cho Ô Tô, Đồ Dùng Trong Gia Đình - Nhỏ Gọn, Dễ Sử Dụng - Hàng Chính Hãng DL8080 DL8081",219000,358000,139000,39
TIKI,o-to-xe-may-xe-dap,1254679,"Bình Xịt Bảo Dưỡng Dây Curoa Liqui Moly V-Belt Spray 4085 (400ml)",259000,259000,0,0
TIKI,o-to-xe-may-xe-dap,204280857,"Dây treo xe ô tô tượng Phật Quan Âm bằng gỗ cao cấp của nhà HÀ XÁ",700000,700000,0,0
TIKI,o-to-xe-may-xe-dap,15343372,"Ví Da Đựng Giấy Tờ Ô Tô Theo Hãng Xe",24000,55000,31000,56
TIKI,o-to-xe-may-xe-dap,166059231,"Tem chữ 150 150i dành cho xe Honda Sh 2020-2022",99000,99000,0,0
TIKI,o-to-xe-may-xe-dap,3522761," Sáp thơm ô tô hương cà phê AREON Ken Coffee - NHẬP KHẨU BULGARIA",265000,265000,0,0
TIKI,o-to-xe-may-xe-dap,57912349,"Dung dịch xóa xước, đánh bóng và bảo vệ sơn xe ô tô, xe hơi 3 trong 1 Sonax Wax 250 ml 202100",260000,260000,0,0
TIKI,o-to-xe-may-xe-dap,108695117,"DUNG DỊCH RỬA XE BỌT TUYẾT [5 Lít]",199000,249000,50000,20
TIKI,o-to-xe-may-xe-dap,124926007,"[Bóng lốp] Dung dịch phục hồi làm bóng lốp, chăm sóc lốp, phục hồi nhựa nhám lốp ô tô, xe máy Nanoka 3,6L",190000,219000,29000,13
TIKI,o-to-xe-may-xe-dap,75337440,"Yên xe đạp thể thao , Carbon siêu êm , Chính hãng Sengxin , da PU cao cấp - Tặng kèm chuông 02",199000,199000,0,0
TIKI,o-to-xe-may-xe-dap,7124931,"Chai xịt tăng độ bóng sơn ô tô 3M 39034 (Hàng Mỹ)",265000,285000,20000,7
TIKI,o-to-xe-may-xe-dap,7255931,"Mũ bảo hiểm nửa đầu lưỡi trai GRS A760",252000,265000,13000,5
TIKI,o-to-xe-may-xe-dap,5483535,"Dung dịch rửa kính đậm đặc Sonax Clear View 1:100 371141 250ml",165000,165000,0,0
TIKI,o-to-xe-may-xe-dap,1254673,"Nước Rửa Kính Xe Ô Tô Đậm Đặc Liqui Moly 1519 (250ml)",153000,159000,6000,4
TIKI,o-to-xe-may-xe-dap,25154631,"Bảng ghi số điện thoại, biển số xe gắn trên ô tô Ugreen 50722 chính hãng",236000,236000,0,0
TIKI,o-to-xe-may-xe-dap,196923892,"Yên xe đạp , yên xe đạp thể thao XD10",129000,129000,0,0
TIKI,o-to-xe-may-xe-dap,100263960,"Dây Thun Hành Lý Xe Đạp Leo Núi 3 Dây Cố Định Buộc Hàng Co Giãn 68cm Trang Trí Xe Đạp",39000,47000,8000,17
TIKI,o-to-xe-may-xe-dap,164458921,"Bọc khóa smartkey dành cho Honda Lead, Airblade, Vision 2022, Vario 160, Winner X Bezen Classic",59000,59000,0,0
TIKI,o-to-xe-may-xe-dap,72109275,"Kem Đánh Bóng Xóa Trầy Xước Sơn Ô tô - Xe Máy Cana Car Cream 100g - đánh bóng bề mặt kim lọai, đồ gỗ, mặt đá",41000,41000,0,0
TIKI,o-to-xe-may-xe-dap,56733989,"Mũ Bảo Hiểm Xe Đạp Người Lớn, Nón Bảo Hiểm Xe Đạp Tiêu Chuẩn Châu Âu, Thời Trang, An toàn, Năng Động Protec Win 002 - Hàng Chính Hãng",395000,498000,103000,21
TIKI,o-to-xe-may-xe-dap,122437009,"Chuông xe đạp la bàn Kiotool nhôm hợp kim chắc chắn tiếng to",25000,25000,0,0
TIKI,o-to-xe-may-xe-dap,23298449,"DƯỠNG SÊN/XÍCH MOTUL MC CARE C2 CHAIN LUBE ROAD - Hàng Chính Hãng",150000,150000,0,0
TIKI,o-to-xe-may-xe-dap,48890257,"Thanh Gạt mưa Bosch Aerotwin - Hàng chính hãng",385000,618000,233000,38
TIKI,o-to-xe-may-xe-dap,21744637,"DƯỠNG SÊN/XÍCH MOTUL MC CARE C4 CHAIN LUBE FACTORY LINE",269000,269000,0,0
TIKI,o-to-xe-may-xe-dap,19943711,"Chai xịt tẩy rửa nội thất ô tô - Bình xịt rửa nội thất FOAM",52000,56800,4800,8
TIKI,o-to-xe-may-xe-dap,34156069,"Bộ 2 Đèn Hậu LED Cảnh Báo Gắn Phía Sau Xe Đạp Giúp Đạp Xe An Toàn Ban Đêm 4 chế độ sáng (Đèn Đỏ và Xanh) Mai Lee - Hàng chính hãng",56050,59000,2950,5
TIKI,o-to-xe-may-xe-dap,73715841,"Mũ Bảo Hiểm Nửa Đầu RONA Haly Luxury",143000,250000,107000,43
TIKI,o-to-xe-may-xe-dap,57837428,"Móc Treo, Giá Đỡ Treo Xe Đạp Dựng Đứng Lên Tường, Vách Tường Siêu Chắc Xoay 180 Độ Cho Xe Đạp Đua, Xe Đạp Địa Hình Leo Núi Mai Lee",65550,69000,3450,5
TIKI,o-to-xe-may-xe-dap,96908815,"Thùng Rác Mini Để Trên Xe Ô Tô, Hộp chứa Rác Đa Năng Văn Phòng tiện dụng đơn giản gọn nhẹ chất liệu bền bỉ dày dặn",56041,58990,2949,5
TIKI,o-to-xe-may-xe-dap,58570850,"Yên xe đạp - Chất liệu cao cấp - Siêu bền - Tặng kèm chuông YX 09",169000,169000,0,0
TIKI,o-to-xe-may-xe-dap,190707557,"Bộ 3 Cây Móc Lốp Xe Đạp, Nạy Vỏ Xe Đạp Bằng Kim Loại Cao Cấp Nhỏ Gọn",18000,18000,0,0
TIKI,o-to-xe-may-xe-dap,2371205,"Sáp thơm ô tô Aroma Car Organic 40g - Black  Coffee ( Cà phê)",225000,225000,0,0
TIKI,o-to-xe-may-xe-dap,85804967,"Bọc vô lăng cho mọi dòng xe - bọc vô lăng xe ô tô siêu khít",79000,96494,17494,18
TIKI,o-to-xe-may-xe-dap,3665771,"Dầu bôi trơn chống rỉ sét đa năng 3M 5-W",79000,79000,0,0
TIKI,o-to-xe-may-xe-dap,180867688,"Bộ 4 Móc Dán Treo Đồ Nội Thất Hatsu - Treo Cáp Sạc, Chìa Khóa, Túi Xách Xe Hơi, Ô Tô Cao Cấp - Chịu Lực Mạnh Mẽ - Nhựa ABS  - Còn Có Thể Dùng Cho Treo Vật Dụng Trong Nhà",68000,68000,0,0
TIKI,o-to-xe-may-xe-dap,68888307,"Chuông Xe Đạp Thể Thao Địa Hình Mini Bằng Đồng Âm Thanh Vang 90-100dB Gắn Ghi Đông Xe Đạp Mai Lee (Loại Cơ Bản)",29000,29000,0,0
TIKI,o-to-xe-may-xe-dap,84870118,"Chai xịt dưỡng bóng sơn và bóng da, làm đen nhựa nhám Pallas Wax 120ml tăng độ bóng, nổi bật màu sắc, chống bám bụi",35000,35000,0,0
TIKI,o-to-xe-may-xe-dap,44128872,"Bộ Đèn Pha Trước Xe Đạp Có Sạc USB Siêu Sáng Cao Cấp Chống Nước và Đèn Hậu Phía Sau Dành Cho Xe Đạp Địa Hình, Xe Đạp Thể Thao Giúp Đạp Xe An Toàn Ban Đêm - Hàng Chính Hãng",333450,351000,17550,5
TIKI,o-to-xe-may-xe-dap,176734572,"Xe máy điện VinFast Vento S",50000000,50000000,0,0
TIKI,o-to-xe-may-xe-dap,10585102,"Nhớt Liqui Moly 10W40 MB Scooter dành cho xe ga",220000,220000,0,0
TIKI,o-to-xe-may-xe-dap,120294321,"Keo Dán Đa Năng Siêu Dính 3M PR100 Scotch-Weld Plastic & Rubber Instant Adhesive 20g",129000,129000,0,0
TIKI,o-to-xe-may-xe-dap,273829007,"Khăn lau ô tô chuyên dụng đa năng microfiber, siêu thấm, khổ to, không để lại bụi vải TÂM LUÂN Chổi lau tẩm dầu - Hàng chính hãng",26000,40000,14000,35
TIKI,o-to-xe-may-xe-dap,3261211,"Mũ bảo hiểm nửa đầu GRS A737K",279000,279000,0,0
TIKI,o-to-xe-may-xe-dap,68480273," Chai xịt bảo dưỡng sên Megacools Chain Lube 300ml - dưỡng sên xích, sên trần, sên phốt cao su xe máy",75000,75000,0,0
TIKI,o-to-xe-may-xe-dap,117598706,"Nước làm mát động cơ xe ô tô (màu xanh) Maxcool Standard 4L, 1L, 0,5 lít",22000,22000,0,0
TIKI,o-to-xe-may-xe-dap,74559668,"Máy Hút Bụi Cầm Tay Sạc Pin VIVU LIFE 120W - Lực Hút 3200PA - 7 Chi Tiết Trong 1 - Nguồn Sạc Adapter - Hàng Chính Hãng",299000,349000,50000,14
TIKI,o-to-xe-may-xe-dap,101497305,"Giỏ Xe Đạp Gắn Trước Có Thể Gập Gọn Chất Liệu Kim Loại Kích Thước 33x20x20cm Mai Lee",132050,139000,6950,5
TIKI,o-to-xe-may-xe-dap,133783245,"Đèn Mini cảnh bảo an toàn - Thiết Kế Nhỏ Gọn Tiện Dụng - Đèn Cảnh Báo Gắn Đuôi Xe Đạp, Phụ kiện bánh xe đạp ",32000,32000,0,0
TIKI,o-to-xe-may-xe-dap,102409936,"Combo 4 tấm che nắng cửa bên ô tô, che nắng bạc phản quang - núm hút chân không",37000,39000,2000,5
TIKI,o-to-xe-may-xe-dap,53308205,"Hộp Túi Treo Khung Gắn Sườn Trước Xe Đạp Có Giá Đỡ Đựng Điện Thoại Màn Hình Cảm Ứng Dưới 6.5 Inch Chống Thấm Nước Mai Lee Cycling - Hàng Chính Hãng",194560,204800,10240,5
TIKI,o-to-xe-may-xe-dap,73519339,"Nhớt Xe Tay Ga Mobil Super Moto Scooter 10W-40 Tiêu Chuẩn JASO MB API SL (0.8L) - Hàng Chính Hãng",99000,99000,0,0
TIKI,o-to-xe-may-xe-dap,3668285,"Dung dịch chống bán nước kính lái 3M 08889LT",175000,175000,0,0
TIKI,o-to-xe-may-xe-dap,127785019,"Chổi lau xe ô tô có tẩm dầu chuyên dụng quét bụi, bảo vệ sơn xe TÂM LUÂN Chổi lau tẩm dầu - Hàng chính hãng",329000,400000,71000,18
TIKI,o-to-xe-may-xe-dap,44254985,"Dung dịch chống bám nước trên kính xe Karshine KA-RO150",95000,95000,0,0
TIKI,o-to-xe-may-xe-dap,68480340,"Bộ 3 sp Chai xịt vệ sinh sên xe máy TS-40 450ml, chai xịt dưỡng sên Thunder Chain Lube 400ml và bàn chải vệ sinh sên",125000,125000,0,0
TIKI,o-to-xe-may-xe-dap,164057610,"Găng Tay Lật Mở Đầu Ngón Tay  Bigbull Extremely thời Trang | Găng Tay Đi Phượt, Bao Tay Chạy Xe Máy, Xe Đạp, Xe Hơi | Bao Tay Có Thể Lật Mở Ngón tay Để Sử Dụng Điện Thoại Tiện Lợi ",75000,75000,0,0
TIKI,o-to-xe-may-xe-dap,6077835,"Khoá Đĩa Việt Tiệp",139000,139000,0,0
TIKI,o-to-xe-may-xe-dap,68415041,"Nước Hoa Ô Tô Cao Cấp Bullsone Grasse Diffuser Grapefruit & Peony",272391,396000,123609,31
TIKI,o-to-xe-may-xe-dap,23835075,"Bộ 2 miếng che nắng cho ô tô Michelin MI-CWS (36 x 45cm)",60000,65000,5000,8
TIKI,o-to-xe-may-xe-dap,21569960,"Bộ 2 Tấm Che Chắn Nắng Ô Tô Cao Cấp",19949,20999,1050,5
TIKI,o-to-xe-may-xe-dap,54675275,"Máy lọc không khí và khử mùi xe hơi Michelin ML-19 - Hàng chính hãng",1146000,1199000,53000,4
TIKI,o-to-xe-may-xe-dap,100483860,"Bộ Chia Tẩu Sạc Trên Xe Ô Tô 12 V-24V Tích Hợp 2 Cổng USB Sạc Nhanh Công Suất 100W Hàng Chính Hãng Baseus",188000,188000,0,0
TIKI,o-to-xe-may-xe-dap,77711451,"Bơm đạp chân đa năng 2 piston - Bơm hơi dùng cho ô tô, xe máy, bơm phao, bóng",215000,215000,0,0
TIKI,o-to-xe-may-xe-dap,48343083,"Mũ Bảo Hiểm 3/4 Napoli SH Free Size - Kem Lót Nâu",252000,359000,107000,30
TIKI,o-to-xe-may-xe-dap,13326068,"Bộ 2 Gối Tựa Đầu Ô Tô - Gối Chống Mỏi Cổ Trên Xe Hơi AZONE",102000,125000,23000,18
TIKI,o-to-xe-may-xe-dap,168800870,"Bộ 6 miếng vá xe đạp không cần dán keo (vá lạnh)",25000,25000,0,0
TIKI,o-to-xe-may-xe-dap,35878236,"Nước Rửa Xe Sumo 1000 ml Mới Chai Vuông Rửa Xe Chuyên Dụng Bảo Vệ Màu Sơn Chăm Sóc Xe Ô tô Mô tô Tay Ga Gắn Máy Bóng Loáng Như Mới Chống Gỉ Sét Hàng Việt Nam Chất Lượng Cao",54900,54900,0,0
TIKI,o-to-xe-may-xe-dap,95470617,"Ví đựng giấy tờ xe ô tô dành cho hãng xe Toyota",25000,25000,0,0
TIKI,o-to-xe-may-xe-dap,152556216,"Đèn xe đạp siêu sáng cảm biến thông minh, chống nước Rhino L101 tự động điều chỉnh độ sáng theo môi trường, pin sạc, 4 chế độ sáng, pin từ 4-8 tiếng - Hàng chính hãng",151000,159000,8000,5
TIKI,o-to-xe-may-xe-dap,177310118,"Bông tiêu âm, tấm cách âm chống ồn cho ô tô sàn xe thùng loa phòng karaoke studio kích thước 50x80cm",71000,71000,0,0
TIKI,o-to-xe-may-xe-dap,51267437,"Bộ chia tẩu sạc dùng cho ô tô, xe hơi nhãn hiệu Hoco Z28 với 2 lỗ tẩu sạc kết hợp  2 cổng USB, Đầu vào: DC12 - 24V, Tổng đầu ra 2 cổng USB: DV5V/3.1A Max, Đầu ra 2 lỗ tẩu sạc: 80W Max",169000,169000,0,0
TIKI,o-to-xe-may-xe-dap,8438370,"Nón bảo hiểm nửa đầu có kính Sunda 136A mẫu mới",233000,275000,42000,15
TIKI,o-to-xe-may-xe-dap,43719788,"Miếng Tựa Lưng Ghế Hạt Gỗ - Miếng Tựa Lưng Ghế Ô Tô, Xe Hơi - Hàng Chính Hãng miDoctor - Màu Gỗ Ngẫu Nhiên",93000,93000,0,0
TIKI,o-to-xe-may-xe-dap,208211928,"Mũ bảo hiểm lỗ thông gió chính hãng NÓN SƠN TG-ĐN052",324000,650000,326000,50
TIKI,o-to-xe-may-xe-dap,1254625,"Chai Xịt Đánh Bóng Nhanh 3M Gloss Enhancer 39034LT (400ml)",150000,157000,7000,4
TIKI,o-to-xe-may-xe-dap,127238506,"Thùng rác trên xe ô tô, loại nhỏ gắn cửa xe, gắn ghế sau",57950,61000,3050,5
TIKI,o-to-xe-may-xe-dap,162227264,"Ắc quy khô miễn bảo dưỡng Đồng Nai PTZ5L | 12V - 4Ah",248000,248000,0,0
TIKI,o-to-xe-may-xe-dap,785157,"Mũ Bảo Hiểm 1/2 Đầu Napoli NS-N088-BLACK - Đen",155000,199000,44000,22
TIKI,o-to-xe-may-xe-dap,169885717,"[Vải Dù Dày Nặng 1kg3]Bạt Phủ - Áo Trùm Xe Máy Cao Cấp Vải Dù 2 Mặt Che Nắng, Mưa Giữ Xe Luôn Như Mới Vừa Tất Cả Loại Xe",135000,135000,0,0
TIKI,o-to-xe-may-xe-dap,75490727,"Đèn LED Xi Nhan Không Dây Rẽ Trái Phải Gắn Đuôi Xe Đạp Điều Khiển Không Dây Từ Xa Sạc Điện USB Mai Lee",236550,249000,12450,5
TIKI,o-to-xe-may-xe-dap,172167246,"Nước rửa kính đậm đặc Senfineco Windschield Cleaner 9964",48000,48000,0,0
TIKI,o-to-xe-may-xe-dap,131531524,"Bọc yên xe đạp thể thao HT-SPORTS bọc silicone dày êm thoáng khí, có phản quang đi đêm tặng kèm bọc mưa",99000,99000,0,0
TIKI,o-to-xe-may-xe-dap,34585636,"Cặp Đèn Xinhan Led L14 Gắn Vario , WINNER X và mọi loại xe máy BẢO LONG RACING",55000,55000,0,0
TIKI,o-to-xe-may-xe-dap,142783294,"Đèn Hậu Xe Đạp - Đèn Led Nháy Tín Hiệu Gắn Xe Đạp Giant Xe Đạp Thể Thao MTB Địa Hình Cảnh Báo An Toàn Trong Đêm Với 3 Chế Độ Sáng",61000,61000,0,0
TIKI,o-to-xe-may-xe-dap,7982124,"Bộ 4 Tấm Che Nắng Ô Tô",37000,38000,1000,3
TIKI,o-to-xe-may-xe-dap,35390547,"Bảng Số Điện Thoại, Kiêm Giá Đỡ Điện Thoại Trên Taplo Xe Hơi, Ô Tô  BSDT-Z1",25000,25000,0,0
TIKI,o-to-xe-may-xe-dap,68480278,"[Mẫu Mới] Motul Scooter 10W40 800ml tặng Motul Gear Oil 80W90 120ml nhớt hợp số nhớt máy xe tay ga",149000,149000,0,0
TIKI,o-to-xe-may-xe-dap,69360356,"Đèn Pha Xe Đạp Chiếu Sáng Cao Cấp Chống Nước Gắn Ghi-Đông Siêu Sáng Sạc Điện Type-C Có Đồng Hồ Hiển Thị Thời Gian Lượng Pin Có Hỗ trợ Sạc Khẩn Cấp C30ML Mai Lee - Combo A",331455,348900,17445,5
TIKI,o-to-xe-may-xe-dap,529456,"Xi Đánh Bóng Cana 100G",38000,39000,1000,3
TIKI,o-to-xe-may-xe-dap,77580607,"Bọc vô lăng da vân carbon cao cấp TTAUTO cho xe ô tô 4 đến 7 chỗ (Đen)",250000,250000,0,0
TIKI,o-to-xe-may-xe-dap,52337956,"Bộ kích điện xe ô tô khẩn cấp Xiaomi , Tích hợp pin dự phòng 11100 mAh - 70Mai Midrive PS01 - Hàng Nhập Khẩu",1150000,1189000,39000,3
TIKI,o-to-xe-may-xe-dap,186124514,"Mũ bảo hiểm Fullface 2 kính GRO ST11 thời trang, cá tính- Hàng chính hãng",369000,369000,0,0
TIKI,o-to-xe-may-xe-dap,20918089,"Bộ Combo Dưỡng sên Thunder Chain Lube 400ml, Vệ sinh sên MC-40 400ml tặng bàn chải chà sên 3D",112000,112000,0,0
TIKI,o-to-xe-may-xe-dap,45555276,"Nước Hoa Grasse L'Esterel - Bulgarian Rose Bullsone HQST30 (110ml)",264914,396000,131086,33
TIKI,o-to-xe-may-xe-dap,11715049,"Nước hoa kẹp cửa gió điều hòa Areon Platinum Car Lux",315000,315000,0,0
TIKI,o-to-xe-may-xe-dap,168461723,"Mũ Bảo Hiểm HCKT M15 Chuyên Dùng Cho CA,  Hàng Cao Cấp Chính Hãng KitAcoom",305999,359999,54000,15
TIKI,o-to-xe-may-xe-dap,85752639,"Đèn Báo Xi Nhan Rẽ Trái Phải Gắn Đuôi Cho Xe Đạp Với LED SMD Cao Cấp Và Remote Điều Khiển Từ Xa Không Dây Sạc USB Chống Nước Mai Lee",198550,209000,10450,5
TIKI,o-to-xe-may-xe-dap,87393586,"Túi xe đạp cao cấp,túi treo sườn xe đạp chống nước bọc cảm ứng phù hợp với mọi dòng xe - Thương Hiệu KIOTOOL",75000,75000,0,0
TIKI,o-to-xe-may-xe-dap,186743659,"[1 chiếc] Gương Xe Đạp Chiếu Hậu Giá rẻ 8 cm Cho Xe Đạp Thể Thao Địa Hình 360 Độ Giúp Đạp Xe An Toàn Mai Lee",26980,28400,1420,5
TIKI,o-to-xe-may-xe-dap,31705542,"Búa Thoát Hiểm Cho Xe Ô Tô, Xe Hơi R7116",155000,155000,0,0
TIKI,o-to-xe-may-xe-dap,49195399,"Bộ 2 Chai Dung Dịch Tẩy Keo, Nhựa Đường 3M 08987 (425 g)",280000,280000,0,0
TIKI,o-to-xe-may-xe-dap,128957380,"Bộ Dụng Cụ 2 Bàn Chải Vệ Sinh Sên / Xích / Líp Xe Đạp Tiện Dụng",45000,45000,0,0
TIKI,o-to-xe-may-xe-dap,6974859,"Nước Rửa Xe Không Chạm Ekokemika Bio 25 (5L) - Hàng Chính Hãng",550000,550000,0,0
TIKI,o-to-xe-may-xe-dap,68611487,"Túi Tam Giác Treo Sườn Xe Đạp Chống Nước Treo Khung Xe Đa Năng Chứa Đồ Cá Nhân Mai Lee",113050,119000,5950,5
TIKI,o-to-xe-may-xe-dap,189632921,"Băng Keo 2 Mặt Dán Phụ Kiện Oto Xe Máy - Keo Nano Đỏ Siêu Dính",20000,20000,0,0
TIKI,o-to-xe-may-xe-dap,11959155,"Bảng số điện thoại trên ô tô nhãn hiệu Baseus ACNUM-01",264499,264499,0,0
TIKI,o-to-xe-may-xe-dap,59557653,"Khăn lau ô tô chuyên dụng chống trầy xước Microfiber 3M 30x30cm Nhiều màu sắc",14700,14700,0,0
TIKI,o-to-xe-may-xe-dap,1254603,"Đất Sét Tẩy Bụi Sơn 3M Perfect It III Cleaner Clay 38070 - Xanh",468000,480000,12000,3
TIKI,o-to-xe-may-xe-dap,74441824,"Bộ Dụng Cụ Vá Săm Lốp Xe Đạp Có Săm 11 Miếng Du Lịch Tiện Dụng Sử Dụng Khẩn Cấp Cho Xe Đạp Mai Lee",51205,53900,2695,5
TIKI,o-to-xe-may-xe-dap,165597765,"Bọc khóa smartkey dành cho Honda Lead, Airblade, Vision 2018-2020, Vario 150, Bezen Classic",59000,59000,0,0
TIKI,o-to-xe-may-xe-dap,122437189,"Chân Chống Xe Đạp Thể Thao Kiotool Thay đổi kích thước phù hợp với mọi dòng xe đạp địa hình",65000,65000,0,0
TIKI,o-to-xe-may-xe-dap,91648881,"Đèn Led Gắn Tăm Căm Xe Đạp Trang Trí Đẹp Mắt Với Pin Cr2032 (bên trong) MaiLee",25555,26900,1345,5
TIKI,o-to-xe-may-xe-dap,189535971,"Miếng dán PPF TPU hõm cửa xe ô tô chống xước tự hồi phục",110000,110000,0,0
TIKI,o-to-xe-may-xe-dap,104469261,"Đèn Pha Trước Xe Đạp NX3 Có Sạc USB Siêu Sáng Cao Cấp Chống Nước Dành Cho Xe Đạp Địa Hình, Xe Đạp Thể Thao Giúp Đạp Xe An Toàn Ban Đêm",246050,259000,12950,5
TIKI,o-to-xe-may-xe-dap,53708717,"Combo Đèn Pha Xe Đạp LED Q5 Gắn Phía Trước Có Sạc USB Chống Nước Mini Siêu Sáng (Kèm Chân Đế Gắn Đèn Pin) Và Đèn LED Cảnh Báo Sau Xe Đạp 4 chế độ Mai Lee - Đèn Q5+ Led Xanh",110770,116600,5830,5
TIKI,o-to-xe-may-xe-dap,95306035,"Xe đạp địa hình Thống Nhất MTB 26-07 (Tặng kèm chắn bùn trước và sau) - Hàng chính hãng",3414510,3449000,34490,1
TIKI,o-to-xe-may-xe-dap,56650569,"Mũ Bảo Hiểm ¾ Napoli Sh2 Ruby Thời Thượng Nhiều Màu Cá Tính",247500,247500,0,0
TIKI,o-to-xe-may-xe-dap,75705805,"Combo bảo dưỡng sên Megacools rửa sên 500ML+dưỡng sên 300ml  tặng bàn chải vệ sinh sên",165000,165000,0,0
TIKI,o-to-xe-may-xe-dap,38510294,"Bộ 2 Gương Chiếu Hậu Tròn Lớn Cho Xe Đạp Thể Thao Địa Hình Xoay 360 Độ Giúp Đạp Xe An Toàn - Hàng Chính Hãng",75050,79000,3950,5
TIKI,o-to-xe-may-xe-dap,36601741,"Chai xịt tẩy rửa, bôi trơn và chống rỉ sét 310g 3M 5W",60000,60000,0,0
TIKI,o-to-xe-may-xe-dap,136265463,"Nhớt Xe Số Motul 3000 Plus 4t 20w50 20x0.8l",105000,105000,0,0
TIKI,o-to-xe-may-xe-dap,16330403,"Mũ bảo hiểm 1/2 đầu Napoli nón kết tem caro cao cấp có mút xốp loại EPS giảm xung chấn Freesize 56-60cm - Bảo hành 12 tháng",151000,259000,108000,42
TIKI,o-to-xe-may-xe-dap,2646875,"Nước Rửa Xe Mẫu Mới Sumo Wash & Wax (1L)",69000,69000,0,0
TIKI,o-to-xe-may-xe-dap,5172187,"Dung dịch vệ sinh và làm trong kính lái Sonax Xtreme Clear View 1:100 NanoPro 271141 250ml",200000,200000,0,0
TIKI,o-to-xe-may-xe-dap,118297639,"Nâng cổ xe đạp địa hình bằng hợp kim nhôm",149000,149000,0,0
TIKI,o-to-xe-may-xe-dap,1254631,"Chai Vệ Sinh Động Cơ Và Hệ Thống Phun Xăng Cao Cấp Bluechem Fuel System Cleaner (250ml)",258000,265000,7000,3
TIKI,o-to-xe-may-xe-dap,2050479,"Băng keo cường lực siêu dính 3M  4229P-20 20mm x10m",155000,155000,0,0
TIKI,o-to-xe-may-xe-dap,41502149,"Chai xịt chăm sóc và bảo dưỡng nội thất ô tô 3M 39040LT tặng khăn lau ô tô chuyên dụng 3M màu ngẫu nhiên",168000,168000,0,0
TIKI,o-to-xe-may-xe-dap,58911643,"2 túi thơm cà phê khử mùi, treo xe hơi (130gram x 2)",52000,52000,0,0
TIKI,o-to-xe-may-xe-dap,3871403,"Băng keo cường lực 3M 5952-5 size 12mmx5m",75000,75000,0,0
TIKI,o-to-xe-may-xe-dap,107337725,"Nước Hoa Ô Tô Chính Hãng Nhập Khẩu Khử Mùi Xe Hơi Cao Cấp ETONNER E1701D (60ml)",1200000,1200000,0,0
TIKI,o-to-xe-may-xe-dap,131590590,"Miếng Dán Bảo Vệ Sườn Xe Đạp - Khung Xe Đạp - Chống Trầy Xước -  Chống Thấm Nước",27000,27000,0,0
TIKI,o-to-xe-may-xe-dap,76132671,"Bình Xịt Làm Bóng Dàn Áo Lube71 Wink",200000,200000,0,0
TIKI,o-to-xe-may-xe-dap,71149087,"Miếng Đệm Lót Bao Yên Xe Đạp Rộng Cao Cấp Với Mút Mềm Foam Đàn Hồi, Bao Yên Silicon Gel Cho Xe Đạp Thể Thao Địa Hình MTB, Xe Đạp Leo Núi",129390,136200,6810,5
TIKI,o-to-xe-may-xe-dap,192807451,"Dụng cụ vệ sinh sên / xích xe đạp cao cấp Hatsu FL14- Kiêm Dụng Cụ Tra Nhớt Sên/Xích - dòng cao cấp - hàng chính hãng",165000,165000,0,0
TIKI,o-to-xe-may-xe-dap,68524327,"Chân đế kẹp đèn pin, đèn pha gắn ghi đông cho Xe Đạp (chất liệu Nhựa ABS, không kèm đèn pin) chắc chắn, xoay 360 độ dễ dàng lắp đặt Mai Lee",8550,9000,450,5
TIKI,o-to-xe-may-xe-dap,63860106,"Khánh Liên Hoa Trang Trí Xe Hơi , Dây Treo Sen Gỗ Hoàng Dương Trang Trí Ô Tô",240000,240000,0,0
TIKI,o-to-xe-may-xe-dap,2589483,"Chai Xịt Rửa Sên Xe Máy Thunder MC-40 (400ml)",53000,53000,0,0
TIKI,o-to-xe-may-xe-dap,171502562,"Combo 2 Móc Treo Đồ Chữ S Gắn Sau Ghế Ô Tô Xe Hơi Tiện Lợi - Chịu Lức Đến 20 KG",32000,32000,0,0
TIKI,o-to-xe-may-xe-dap,82396214,"Chai Xịt Chống Rỉ, Chống Ẩm Bảo Dưỡng WD-40 Multi-Use 70ml",50000,50000,0,0
TIKI,o-to-xe-may-xe-dap,11741161,"Chổi Lau Xe  Ô Tô Sợi Dầu,  Điều Chỉnh Được Độ Dài - Tròn ( Có Túi Đựng )",47000,54000,7000,13
TIKI,o-to-xe-may-xe-dap,153960176,"Bọc khóa smartkey dành cho Honda SH, SHmode mode, PCX Bezen Armor",79000,79000,0,0
TIKI,o-to-xe-may-xe-dap,25191981,"Súc béc xăng vệ sinh ô tô 300ml",160000,160000,0,0
TIKI,o-to-xe-may-xe-dap,107075129,"Ống Nâng Tay Lái Xe Đạp Bằng Nhôm Cao 12cm Phù hợp Ống trong phi 28,6mm Điều Chỉnh Độ Cao Ghi Đông Xe Đạp MaiLee",149000,169000,20000,12
TIKI,o-to-xe-may-xe-dap,31847215,"Dầu Bôi Trơn Chống Rỉ Sét Làm Sạch Thẩm Thấu Chống Ẩm Bảo Vệ WD-40 (412ml)",130000,130000,0,0
TIKI,o-to-xe-may-xe-dap,120294732,"Chai Xịt Bảo Dưỡng Và Phủ Bóng Lốp Xe 3M 39042 LT Tire Dressing 400ml ",185000,185000,0,0
TIKI,o-to-xe-may-xe-dap,34701184,"Chai xịt vệ sinh máy điều hòa (máy lạnh) Sandokkaebi 330ml nhập khẩu trực tiếp từ Hàn Quốc",95000,95000,0,0
TIKI,o-to-xe-may-xe-dap,82458195,"Flash Sale Khay Để Đồ Chèn Khe Ghế Ô Tô, Giá Để Đồ Chèn Khe Ghế, Hộp Đựng Đồ Xe Ô Tô, Bọc Da PU Cao Cấp",125000,125000,0,0
TIKI,o-to-xe-may-xe-dap,58877049,"Bình Xịt Dưỡng Bóng Lốp Ô Tô Flamingo (500ml)",80655,84900,4245,5
TIKI,o-to-xe-may-xe-dap,162217847,"Ắc quy khô miễn bảo dưỡng Đồng Nai PTX5L | 12V - 3,5Ah",234000,234000,0,0
TIKI,o-to-xe-may-xe-dap,146663540,"Thảm taplo da vân cacbon cho xe Honda City 2016-2020",190000,195000,5000,3
TIKI,o-to-xe-may-xe-dap,87534113,"Bộ Dụng Cụ Sửa Chữa Xe Đạp Di Động Bơm Lốp Đa Năng Mini Và Vá Săm Xe Đạp Gắn Sườn Xe (Dạng Bình Nước) MaiLee",293550,309000,15450,5
TIKI,o-to-xe-may-xe-dap,64043014,"NƯỚC RỬA XE KHÔNG CHẠM CHUYÊN DỤNG  [1 Lít] ",99000,109000,10000,9
TIKI,o-to-xe-may-xe-dap,74429077,"[Tặng Bộ Đồ Bảo Hộ 6 Món Cho Bé] Mũ Bảo Hiểm Xe Đạp Trẻ Em, Nón Bảo Hiểm Chơi Thể Thao, Trượt Patin Cao Cấp Protec Smile W024 - Hàng Chính Hãng",345000,438000,93000,21
TIKI,o-to-xe-may-xe-dap,19737606,"Túi tam giác gắn sườn xe đạp (size L gắn được bình nước)",125000,125000,0,0
TIKI,o-to-xe-may-xe-dap,126707966,"Dung dịch phun khói khử mùi ô tô xe hơi Nano Xclean For Horeca 5 Lít Dùng Cho Máy Phun Khói Khử Khuẩn-Diệt Khuẩn Khử Mùi Nhà Hàng, khách sạn, karaoke, ô tô, Bếp-Nano Bạc AHTC",475200,792000,316800,40
TIKI,o-to-xe-may-xe-dap,186260830,"Săm Xe Đạp 27x1 3/8 (37-630) , Ruột Xe Đạp 27x1 3/8 CASUMINA",65000,65000,0,0
TIKI,o-to-xe-may-xe-dap,128123890,"Bộ 2 Vè che mưa gương chiếu hậu ô tô hạn chế nước mưa đọng vào gương, gia tăng tầm nhìn TÂM LUÂN Chổi lau tẩm dầu - Hàng chính hãng",20000,50000,30000,60
TIKI,o-to-xe-may-xe-dap,92047685,"Mũ Bảo Hiểm ¾ Napoli Sh2 Ruby Xanh Mint Free Size 55-58cm",252000,359000,107000,30
TIKI,o-to-xe-may-xe-dap,14656137,"Nhớt Xe Số Motul H-Tech 100 4T 10W40 12x1l Vn (1L)",209000,209000,0,0
TIKI,o-to-xe-may-xe-dap,125425768,"Mũ Bảo Hiểm Nửa Đầu Kính Ẩn ANDES 139 - Nhiều Màu",370000,440000,70000,16
TIKI,o-to-xe-may-xe-dap,53708171,"Đèn Pha Gắn Phía Trước Xe Đạp Siêu Sáng Sạc Điện USB Chống Nước (Bản Nâng Cấp Kèm Chân Đế Trượt) Mai Lee",110200,116000,5800,5
TIKI,o-to-xe-may-xe-dap,55129703,"Mũ Bảo hiểm nửa đầu Bulldog Pug đủ màu",679000,679000,0,0
TIKI,o-to-xe-may-xe-dap,108937941,"Nón bảo hiểm Royal M139 Kính Âm Trơn Sành Điệu, Trẻ Trung, Thời Thượng",700000,700000,0,0
TIKI,o-to-xe-may-xe-dap,16279248,"Dung DỊch Rửa Xe Không Chạm Bio 20 - (1l) - Hàng Chính Hãng",115000,115000,0,0
TIKI,o-to-xe-may-xe-dap,16147531,"Mũ Bảo Hiểm Nửa Đầu Có Kính SUNDA 136A",275000,275000,0,0
TIKI,o-to-xe-may-xe-dap,90326089,"Ba lô Treo Trước Xe Đạp Gắn Ghi Đông Xe Đạp Cho Du Lịch Đạp Xe Cất Trữ Phụ Kiện MaiLee ",217550,229000,11450,5
TIKI,o-to-xe-may-xe-dap,50255242,"Nón bảo hiểm 3/4 kính âm Royal M139 Vàng Cam Nhám tem V7 Cafe Racer cao cấp Lót tháo rời, che hết mặt",510000,510000,0,0
TIKI,o-to-xe-may-xe-dap,53550107,"Đèn Pin Gắn Phía Trước Cho Xe Đạp Siêu Sáng Q5 Phóng Zoom To, Nhỏ Có Sạc Điện USB Chống Nước (kèm Chân Đế Gắn Đèn Pha) Giúp Đạp Xe Ban Đêm Mai Lee",87400,92000,4600,5
TIKI,o-to-xe-may-xe-dap,83347589,"Lót nón bảo hiểm 3/4 Royal M139 gồm 1 lót và 2 ốp tai phiên bản mới",80000,150000,70000,47
TIKI,o-to-xe-may-xe-dap,13860493,"Hệ thống cảm biến đo áp suất lốp năng lượng mặt trời cho ô tô Michelin 4834",1559000,1599000,40000,3
TIKI,o-to-xe-may-xe-dap,176450514,"Chai xịt dạng bọt làm sạch bảo vệ khoang máy động cơ ô tô chuyên dụng Liqui Moly 21277 - Chống oxy hóa và ăn mòn, chống tĩnh điện, dùng được nhiều bề mặt, không để lại vết ố",161000,165000,4000,2
TIKI,o-to-xe-may-xe-dap,10116626,"Chai xịt vệ sinh hệ thống điều hòa ô tô 3M 3M-ACC (250ml)",159000,163000,4000,2
TIKI,o-to-xe-may-xe-dap,84883244,"Nón Bảo Hiểm Xe Đạp Thể Thao Hiện Đại, Siêu Phẩm Mũ Bảo Hiểm Xe Đạp Sang Trọng Protec Win 069, Size L Cho Vòng Đầu Từ 58 - 61cm - Hàng Chính Hãng",599000,780000,181000,23
TIKI,o-to-xe-may-xe-dap,32135232,"Sạc bình ắc quy 12V 2A tự ngắt khi đầy 4-20Ah (Đen)",74999,74999,0,0
TIKI,o-to-xe-may-xe-dap,147855004,"Chổi Lau Xe Ô Tô, Xe Tải Xe Khách Làm Bằng Sợi Quang Dầu, Điều Chỉnh Được Độ Dài – Bộ Chổi Lau Bụi Xe Ô Tô Kèm Túi Đựng Cao Cấp Chính Hãng Dododios",85000,85000,0,0
TIKI,o-to-xe-may-xe-dap,32979033,"Bình dầu tay thắng BẢO LONG RACING",45000,45000,0,0
TIKI,o-to-xe-may-xe-dap,8090579,"Nước Rửa Kính FOCAR Screen Wash 2.75L",90000,119000,29000,24
TIKI,o-to-xe-may-xe-dap,14656147,"Nhớt Xe Tay Ga Motul Scooter Power Le 4t 5w40 20x0.8l Vn (800ml)",165000,165000,0,0
TIKI,o-to-xe-may-xe-dap,59355732,"Máy lọc không khí thông minh dùng trên xe hơi FujiE AP100",561000,1700000,1139000,67
TIKI,o-to-xe-may-xe-dap,70815706,"Lót ghế và tựa lưng hạt gỗ ô tô văn phòng massage cao cấp chống nóng hiệu quả",331000,348000,17000,5
TIKI,o-to-xe-may-xe-dap,186621755,"Vietmap AP1 Máy lọc Không khí ô tô - Khử mùi iON -Diệt khuẩn- Lọc bụi PM2.5 - Tận hưởng cuộc sống xanh - Hàng Chính Hãng",1660000,1660000,0,0
TIKI,o-to-xe-may-xe-dap,118089405,"Bộ 2 đèn led gắn van bánh xe đạp, xe máy",24200,24200,0,0
TIKI,o-to-xe-may-xe-dap,83347203,"Nón bảo hiểm ANDES 109 có kính đi xe máy chính hãng",447000,500000,53000,11
TIKI,o-to-xe-may-xe-dap,884776,"Nón Bảo Hiểm Lưỡi Trai 1/2 Đầu Tem V2 Xanh Lá Napoli N077-V2XL-LT",147000,299000,152000,51
TIKI,o-to-xe-may-xe-dap,50386528,"Bộ 2 phụ gia xăng 33017 và nhớt 33027 cao cấp cho xe máy Bluechem - 33017_33027",155000,155000,0,0
TIKI,o-to-xe-may-xe-dap,67632864,"Màn rèm che nắng hít nam châm dán cửa ô tô xe hơi, rèm vải dầy 2 lớp cản sáng mẫu hoạt hình dễ thương - Hàng chính hãng",128000,128000,0,0
TIKI,o-to-xe-may-xe-dap,87706942,"Thùng nhựa đựng đồ cho cốp xe ô tô có thể gấp xếp gọn có chốt gài | 30L + 55L + túi chống nước",151000,185000,34000,18
TIKI,o-to-xe-may-xe-dap,105328552,"Combo 2 can Nước rửa xe bọt tuyết chuyên dụng Car Shampoo 5L cho ô tô xe máy",255000,255000,0,0
TIKI,o-to-xe-may-xe-dap,34845206,"Nước rửa xe bọt tuyết Car Shampoo 5 lít cho ô tô xe máy ",145000,145000,0,0
TIKI,o-to-xe-may-xe-dap,95071251,"Kẹp Gắn Đèn Pin ML10 Xe Đạp Gắn Ghi Đông Tay Lái Xoay 360 Độ Chắc Chắn Mai Lee (không kèm đèn pin)",56050,59000,2950,5
TIKI,o-to-xe-may-xe-dap,20845674,"Khóa dây Master Lock 8143",125000,125000,0,0
TIKI,o-to-xe-may-xe-dap,74912599,"Megacools Ultra Lube MOLY WAX 300ml - Xịt bảo dưỡng sên siêu cao cấp, chống vắng, chống rít,chống kêu sên",80000,80000,0,0
TIKI,o-to-xe-may-xe-dap,55193006,"Mũ bảo hiểm 3/4 Bulldog POM",1099000,1099000,0,0
TIKI,o-to-xe-may-xe-dap,51697825,"Lọ Xịt Khử Mùi Nội Thất Ô Tô Hương Cà Phê Hàn Quốc",56000,63000,7000,11
TIKI,o-to-xe-may-xe-dap,22477937,"Bộ Chia tẩu sạc, Adapter Sạc Huyndai HY - I0 Cao cấp",114000,129500,15500,12
TIKI,o-to-xe-may-xe-dap,87457129,"Giá Treo Bình Nước Xe Đạp Có Điều Chỉnh Tiện Lợi Cho Xe Đạp Thể Thao, MTB (Không kèm ốc vít) MaiLee",56050,59000,2950,5
TIKI,o-to-xe-may-xe-dap,115935630,"Bộ 2 Ty Gác Chân Sau Xe Đạp Chất Liệu Nhôm (đường kính lỗ 1cm) cho xe đạp MTB, xe địa hình chống trượt, chắc chắn Mai Lee",75050,79000,3950,5
TIKI,o-to-xe-may-xe-dap,141582530,"Máy hút bụi cao cấp cho ô tô nguồn 12v Michelin ML204 - độ ồn thấp, máy gọn nhẹ, nhiều đầu hút, công xuất cao",799000,799000,0,0
TIKI,o-to-xe-may-xe-dap,22084392,"CHAI XỊT DƯỠNG LÀM BÓNG VÀ BẢO VỆ BỀ MẶT GỖ, NHỰA, CAO SU, DA NỘI THẤT XE SONAX 380041 300ML",210000,210000,0,0
TIKI,o-to-xe-may-xe-dap,53351883,"Kính mũ bảo hiểm SUNDA CA-110 loại dài gắn cho các mũ có 3 khuy bấm trên đầu",99000,129000,30000,23
TIKI,o-to-xe-may-xe-dap,56629175,"Máy Đo Chất Lượng Pin - Ác Quy - YR1035+ Nguồn 0-100V Kiểm Tra Dòng Xả Pin Ác Quy Chính Xác 99.9%",949000,949000,0,0
TIKI,o-to-xe-may-xe-dap,35965768,"Giá đỡ bình nước xe đạp Jett",90000,90000,0,0
TIKI,o-to-xe-may-xe-dap,34584716,"Nhớt xe tay ga Repsol Moto Scooter 5w40 1L",179000,179000,0,0
TIKI,o-to-xe-may-xe-dap,119719201,"Ắc Quy LONG WP5-6 6V-5AH Bình ắc quy khô 6V cho xe điện trẻ em ,đèn khẩn cấp,quạt sạc",130000,130000,0,0
TIKI,o-to-xe-may-xe-dap,85170993,"Nhớt xe số cao cấp Repsol Moto MXR 7 4T 10W40 1L (Mẫu Mới}",119000,119000,0,0
TIKI,o-to-xe-may-xe-dap,119308981,"Sáp thơm khử mùi giảm SAY XE ô tô Hando 230g",49000,49000,0,0
TIKI,o-to-xe-may-xe-dap,54680124,"Hộp tỳ tay theo xe dành cho xe Mitsubishi Xpander",331550,349000,17450,5
TIKI,o-to-xe-may-xe-dap,151685056,"Bạt trùm che phủ xe ô tô Honda CITY chuẩn 3 Lớp Cao Cấp Chống Nắng Nóng Nước Mưa Cháy Chống Bụi",292600,308000,15400,5
TIKI,o-to-xe-may-xe-dap,56255757,"Quạt Sắt 4 Cánh Mini Có Kẹp Treo Xe Ô Tô Siêu Chắc Chắn SDLG",249000,249000,0,0
TIKI,o-to-xe-may-xe-dap,52980205,"Bình xịt vệ sinh máy điều hòa Mr Mckenic Air-Conditioner Cleaner",139000,159500,20500,13
TIKI,o-to-xe-may-xe-dap,1254737,"Dung Dịch Trùng Tu Phục Hồi Động Cơ Liqui Moly Cera Tec 3721 (300ml)",430000,430000,0,0
TIKI,o-to-xe-may-xe-dap,54675288,"Dung dịch vệ sinh vải, da Michelin Fabric Cleaner 31425 - 650ml - Hàng chính hãng",134000,160000,26000,16
TIKI,o-to-xe-may-xe-dap,14350394,"Túi treo ghế ô tô",179000,188000,9000,5
TIKI,o-to-xe-may-xe-dap,74568066,"Dây Quấn Ghi Đông Xe Đạp Cuộc (2 Cuộn/ bộ) Giả Vân Carbon Chống Nước Mai Lee",92150,97000,4850,5
TIKI,o-to-xe-may-xe-dap,76204670,"Tinh dầu thơm pha nhớt xe 2 thì - Phụ gia pha nhớt xe Yazz , Xipo , Novaa Green Networks Group",139000,139000,0,0
TIKI,o-to-xe-may-xe-dap,189556560,"Nước rửa kính ô tô siêu sạch đậm đặc INOCY bình 2L",39000,39000,0,0
TIKI,o-to-xe-may-xe-dap,172167236,"vệ sinh kim phun dầu diesel Senfineco 9985",190000,190000,0,0
TIKI,o-to-xe-may-xe-dap,22754498,"Bộ 2 Lò Xo Hỗ Trợ Nâng Cốp Cho Xe Ô Tô Sedan - Giao Màu Ngẫu Nhiên",49000,49000,0,0
TIKI,o-to-xe-may-xe-dap,135642277,"Ví đựng giấy tờ ô tô Honda Da Cao Cấp, Ví da đựng giấy tờ xe ô tô",145000,149000,4000,3
TIKI,o-to-xe-may-xe-dap,787926,"Mũ Bảo Hiểm GRS A102K - Xanh Nhám Line Xanh",279000,279000,0,0
TIKI,o-to-xe-may-xe-dap,3856963,"Kính Bulldog Eagle",179000,179000,0,0
TIKI,o-to-xe-may-xe-dap,192340025,"gương cầu lồi cho xe ô tô, Bộ 2 Gương Cầu Lồi Tràn Viền Xoay 360 độ Gắn Cho Kính Gương Chiếu Hậu Tránh Điểm Mù Cho Xe Hơi, Xe Ô tô - Hàng Chính Hãng dododios",40000,40000,0,0
TIKI,o-to-xe-may-xe-dap,155100353,"Mũ Bảo Hiểm B'color Nửa Đầu Màu Đen Có Chữ Noise Loại Nửa Đầu Kèm Kính Thời Trang",185000,280000,95000,34
TIKI,o-to-xe-may-xe-dap,32371106,"Công Tắc Mở Cốp Hậu Dành Cho Huyndai I10 Grand - Kia Morning",69000,69000,0,0
TIKI,o-to-xe-may-xe-dap,84870178,"Kem phủ bóng PALLAS NANO Polish Cream 250g - dùng đánh bóng xe máy, ô tô, bóng nhựa, da, simili, hạn chế bám bụi",49000,49000,0,0
TIKI,o-to-xe-may-xe-dap,101778165,"Đế cao su bọc chân chống cổ dê loại tốt, đế dày, nhựa siêu bền",12000,12000,0,0
TIKI,o-to-xe-may-xe-dap,42662455,"Bảng Hiện Số Điện Thoại Khi Đỗ Xe Ôtô",31000,40000,9000,23
TIKI,o-to-xe-may-xe-dap,3690167,"Thiết bị kiểm tra Acquy 12V ANSMANN - Hàng Nhập Khẩu",298000,298000,0,0
TIKI,o-to-xe-may-xe-dap,93884213,"Túi Xe Đạp Treo Sườn Xe Dài 1 Ngăn ML02 Chống Nước Vải Oxford Chống Mài Mòn MaiLee",113050,119000,5950,5
TIKI,o-to-xe-may-xe-dap,48563549,"Bộ Chốt Khóa Dây An Toàn 4S dành cho ô tô Logo theo xe",55000,55000,0,0
TIKI,o-to-xe-may-xe-dap,71100674,"Hộp để đồ đa năng gấp gọn để cốp sau ô tô, xe hơi cao cấp dung tích 30 lít",168000,168000,0,0
TIKI,o-to-xe-may-xe-dap,192738336,"Thảm Taplo Da Cacbon XPANDER đời 2019-2022 cao cấp, chống nóng chống trơn trượt",203000,208000,5000,2
TIKI,o-to-xe-may-xe-dap,53505348,"BAO DA CHÌA KHOÁ FORD EXPLORER - CHÍNH HÃNG KHẮC TÊN",400000,400000,0,0
TIKI,o-to-xe-may-xe-dap,52197854,"Nước rửa kính lái đậm đặc tỉ lệ 1:100 Liqui Moly 1519 - Tặng kèm 1 khăn lau chuyên dụng 3M",190000,195000,5000,3
TIKI,o-to-xe-may-xe-dap,73519197,"Nhớt Xe Số 4T Mobil Super Moto 20W-50 Tiêu Chuẩn JASO MA2 API SL (0.8L) - Hàng Chính Hãng",85000,85000,0,0
TIKI,o-to-xe-may-xe-dap,171651830,"Máy bơm lốp mini đa năng tự ngắt Michelin 3321 - Bơm xe đạp, xe máy, ô tô, bóng, xe hơi 4 bánh, có đèn LED, nhỏ gọn, thông minh, sạc Micro USB",855000,855000,0,0
TIKI,o-to-xe-may-xe-dap,801350,"Máy Lọc Không Khí Cho Xe Hơi Sharp IG-GC2E-N - Vàng - Hàng Chính Hãng",2250000,2250000,0,0
TIKI,o-to-xe-may-xe-dap,25708089,"Chai vệ sinh làm sạch ghế da, vải nỉ ô tô Gold Class 650ml",80000,80000,0,0
TIKI,o-to-xe-may-xe-dap,100279543,"Thanh gạt mưa Bosch Aerotwin Plus - Hàng Chính Hãng",460000,686000,226000,33
TIKI,o-to-xe-may-xe-dap,122436826,"Chắn bùn xe đạp thể thao Kiotool trước sau đầy đủ phụ kiện chắc chắn",45000,45000,0,0
TIKI,o-to-xe-may-xe-dap,197748586,"Dầu Nhớt Voltronic XM Scooter Ultimate 800ml",390000,390000,0,0
TIKI,o-to-xe-may-xe-dap,48290597,"Bộ kích nổ ô tô, xe hơi kiêm pin sạc dự phòng nhãn hiệu Baseus cao cấp CRJS01-01 - Hàng Nhập Khẩu",1399999,1399999,0,0
TIKI,o-to-xe-may-xe-dap,141772466,"Máy bơm lốp xe hơi kỹ thuật số thông minh Baseus Mini Air Compressor 12V 150PSI (hàng chính hãng)",525899,525899,0,0
TIKI,o-to-xe-may-xe-dap,1378109,"Dung Dịch Tẩy Và Làm Sạch Đánh Bóng Inox 3M Stainless Steel Cleaner & Polish 126080 (600g)",258000,275000,17000,6
TIKI,o-to-xe-may-xe-dap,57842174,"Ốp Nắp Bình Xăng Mạ Crom Chống Xước Trang Trí Bảo Vệ Ô Tô - Kia Carens",129000,129000,0,0
TIKI,o-to-xe-may-xe-dap,115599656,"Nón Bảo Hiểm 1/2 Đầu Có Kính Protec VIC, Size Lớn, Độ Che Phủ Sâu Hơn",345000,398000,53000,13
TIKI,o-to-xe-may-xe-dap,111411789,"Băng keo 2 mặt cường lực 3M 4229P dài 10M băng keo siêu dính chịu nước, nhiệt dán được trên nhiều loại chất liệu - XSAFE",49000,49000,0,0
TIKI,o-to-xe-may-xe-dap,53824535,"CHAI XỊT VỆ SINH LÀM SẠCH VÀ TRONG KÍNH LÁI CAO CẤP SONAX CLEAR GLASS 338241 500ML",180000,180000,0,0
TIKI,o-to-xe-may-xe-dap,50348260,"Mũ bảo hiểm Chita 3/4 - CT1 Nón cặp size M",294000,420000,126000,30
TIKI,o-to-xe-may-xe-dap,87392058,"Túi xe đạp cao cấp,túi treo sườn xe đạp chống nước bọc cảm ứng phù hợp với mọi dòng xe Thương hiệu KIOTOOL",65000,65000,0,0
TIKI,o-to-xe-may-xe-dap,74689554,"24 Miếng Vá Săm Lốp Xe Đạp Dự Phòng Tự Vá Tại Nhà (Gồm Keo) Mai Lee",36100,38000,1900,5
TIKI,o-to-xe-may-xe-dap,74404344,"Lá Thơm Areon Treo Ô Tô Hương Táo Quế (Nhẹ Dịu, Tươi Mát, Chống Say Xe )",55000,55000,0,0
TIKI,o-to-xe-may-xe-dap,1237331,"Chai Xịt Bóng Da, Bóng Gỗ Toyo (500ml)",67000,69000,2000,3
TIKI,o-to-xe-may-xe-dap,104191669,"Đèn Đuôi Xe Đạp Cảnh Báo Phía Sau Cho Xe đạp Sạc Điện USB Chống Nước Trang Trí",103455,108900,5445,5
TIKI,o-to-xe-may-xe-dap,38649410,"Thảm sàn, lót sàn cao su không mùi Cao cấp dành cho xe Hyundai Grand i10",501600,528000,26400,5
TIKI,o-to-xe-may-xe-dap,158021789,"Bộ 2 gương lồi tràn viền xoay 360 độ gắn cho kính gương chiếu hậu tránh điểm mù cho xe Hơi, Xe Ô tô - Hàng nhập khẩu",89000,89000,0,0
TIKI,o-to-xe-may-xe-dap,38716521,"Thảm sàn, lót sàn cao su không mùi Cao cấp dành cho xe KIA Morning 2012-2019",447000,458000,11000,2
TIKI,o-to-xe-may-xe-dap,75331538,"Phuộc Sau Gắn CLICK, VARIO, VISION 330mm 01M0169Y, 01M0169R, 01M0169B Hiệu RCB",1300000,1300000,0,0
TIKI,o-to-xe-may-xe-dap,100989205,"Bộ 5 Tem Cảnh Báo Dán Xe Máy, Sticker Dán Nón Bảo Hiểm Chống Thấm Nước Green Networks Group",12000,12000,0,0
TIKI,o-to-xe-may-xe-dap,21928435,"Mũ Bảo Hiểm Fullface Royal M136",349000,349000,0,0
TIKI,o-to-xe-may-xe-dap,154234336,"Nhớt Motul GP Power 800ml Cho Xe Máy Số Và Côn Tay ",115000,115000,0,0
TIKI,o-to-xe-may-xe-dap,74987084,"Bộ 08 Miếng Dán Chống Xước Cao Cấp Bảo Vệ Tay Nắm Và Hõm Cửa Xe Ô Tô",59000,59000,0,0
TIKI,o-to-xe-may-xe-dap,183268561,"Xe Đạp Điện DK Sparta",15400000,15400000,0,0
TIKI,o-to-xe-may-xe-dap,4643829,"Mũ Bảo Hiểm 3/4 Napoli SH (Size L) - Đen Lót Nâu",251000,251000,0,0
TIKI,o-to-xe-may-xe-dap,74172634,"Đèn trợ sáng xe máy L4 L4X L6 L6X L9X Cr.ee(1 Đèn ) Green Networks Group",79000,79000,0,0
TIKI,o-to-xe-may-xe-dap,46235477,"Giá đỡ gối đệm kê ngủ tựa đầu 2 bên gắn xe hơi, ô tô, giá có thể điều chỉnh độ cao thấp phù hợp cho người lớn và trẻ em",429000,429000,0,0
TIKI,o-to-xe-may-xe-dap,72642551,"Bơm xe máy  - Bơm xe đạp chân - Bơm đạp chân 2 ống đa năng - Bơm hơi đạp chân mini cho ô tô, xe máy, xe đạp, bơm bóng, phao bơi",179000,179000,0,0
TIKI,o-to-xe-may-xe-dap,136191275,"Nhớt Xe Tay Ga Motul Scooter Le 4t 10w40 20x",109000,109000,0,0
TIKI,o-to-xe-may-xe-dap,147084619,"Bình xịt vệ sinh ghế nỉ  ô tô, vệ sinh sofa nỉ",66000,68000,2000,3
TIKI,o-to-xe-may-xe-dap,62874426,"NƯỚC RỬA KÍNH Ô TÔ CHUYÊN DỤNG [5 Lít] ",209000,229000,20000,9
TIKI,o-to-xe-may-xe-dap,53640184,"Tấm lót và ghế tựa lưng hạt gỗ có chống trựơt  xe ô tô ",329650,347000,17350,5
TIKI,o-to-xe-may-xe-dap,94702864,"Khử mùi xe ô tô, khử mùi xe hơi nano bạc Nano Xclean For Car 500ML AHT Corp - chai xịt diệt khuẩn khử mùi ô tô, mùi hải sản, mùi ẩm mốc, mùi hôi khó chịu không gian nội thất xe ô tô - công nghệ nano an toàn, thân thiện",99000,165000,66000,40
TIKI,o-to-xe-may-xe-dap,1254635,"Dung Dịch Vệ Sinh Hệ Thống Xăng Cho Mô Tô Xe Máy Bluechem Fuel Sysem Cleaner (50ml)",85000,85000,0,0
TIKI,o-to-xe-may-xe-dap,41340342,"NẸP CACBON CHỐNG XƯỚC BẬC LÊN XUỐNG XE Ô TÔ [BẢN 5CMX2.5M]",68000,69500,1500,2
TIKI,o-to-xe-may-xe-dap,145016692,"Mũ Bảo Hiểm Nửa Đầu Màu Đen Họa Tiết Cặp Đôi Kèm Kính Thời Trang Chính Hãng B'COLOR Combo 2 Mũ",339000,560000,221000,39
TIKI,o-to-xe-may-xe-dap,53265128,"Bảng số điện thoại dạ quang trên ô tô, xe hơi nhãn hiệu Baseus cao cấp ACNUM-B0S",98499,98499,0,0
TIKI,o-to-xe-may-xe-dap,91471480," Túi đeo hông chống nước đi xe máy GIVI RWB04",448000,448000,0,0
TIKI,o-to-xe-may-xe-dap,1254639,"Dung Dịch Súc Rửa Động Cơ Cho Mô Tô Xe Máy Bluechem Oil System Cleaner (50ml)",74000,79000,5000,6
TIKI,o-to-xe-may-xe-dap,80624447,"Bơm xe đạp 160PSI/11KG GF-31PV nhôm xi bóng, van thông minh - GIYO Đài Loan",500000,500000,0,0
TIKI,o-to-xe-may-xe-dap,51511288,"Chai Xịt Vệ Sinh Ghế Da Nội Thất Ô Tô OUFU AF-1101 720ml",42000,43000,1000,2
TIKI,o-to-xe-may-xe-dap,7125675,"Chai xịt bảo dưỡng lốp ô tô 3M 39042 (Hàng Mỹ)",273000,305000,32000,10
TIKI,o-to-xe-may-xe-dap,49543124,"Dung Dịch Tẩy Ố, Tẩy Nano Kính Ô Tô Glaco Compound Roll On G-47T Soft99 Japan 100ml",310000,310000,0,0
TIKI,o-to-xe-may-xe-dap,52322221,"Thiết Bị Định Vị GPS GF-09 Dành Cho Xe Hơi Người Cao Tuổi Trẻ Nhỏ Tự Động Gửi Báo Động Cho Bạn",385000,385000,0,0
TIKI,o-to-xe-may-xe-dap,10120303,"Nước hoa kẹp cửa gió điều hòa ô tô AREON VANI (NEW) - NHẬP KHẨU BULGARIA",256000,256000,0,0
TIKI,o-to-xe-may-xe-dap,72189654,"Bảng số điện thoại dùng trên xe hơi Baseus All Metal Temporary Parking Number Plate Series 2 (Dual-number Version) - Hàng chính hãng",249899,249899,0,0
TIKI,o-to-xe-may-xe-dap,58362173,"Đèn hậu nhấp nháy phanh chớp liên tục gắn cho mọi loại xe ( Đầu Trong ) Green Networks Group",69000,69000,0,0
TIKI,o-to-xe-may-xe-dap,184414971,"Túi Smilebox đựng thẻ, tiền, mắt kính, giấy tờ xe treo tấm chắn nắng của ô tô, xe hơi nhiều ngăn",159000,159000,0,0
TIKI,o-to-xe-may-xe-dap,107353581,"[CHÍNH HÃNG] 2 CHAI 500ML: XWash - Xịt tẩy rửa, khử mùi nội thất ô tô KHÔNG HÓA CHẤT - Tặng khăn lông cừu cao cấp",799000,799000,0,0
TIKI,o-to-xe-may-xe-dap,92084838,"Led Đuôi Sau Xe Đạp BK820 100Lumens Led COB 4 Chế Độ Có Đèn Phanh Cảm Biến Thông Minh Gia Tốc Sạc USB Chống Nước và Bụi Bẩn Cho Xe Đạp Thể Thao MaiLee",217550,229000,11450,5
TIKI,o-to-xe-may-xe-dap,83347621,"Nón bảo hiểm 3/4 ROYAL M139 có kính âm V5 ĐEN",550000,730000,180000,25
TIKI,o-to-xe-may-xe-dap,529457,"Xi Đánh Bóng Cana 220G",53000,78000,25000,32
TIKI,o-to-xe-may-xe-dap,5485879,"Chai xịt bóng nhanh dùng cho sơn bóng, sơn mờ, wrap Sonax Xtreme Brilliant Shine Detailer 287400 750ml",229000,240000,11000,5
TIKI,o-to-xe-may-xe-dap,35129432,"Thảm Nhựa Lót Cốp Sau Dành Cho Xe Ô Tô Honda City",294000,302000,8000,3
TIKI,o-to-xe-may-xe-dap,78290547,"Cục nhôm đôn nâng phuộc sau xe máy Green Networks Group ( 1 Cặp )",59000,59000,0,0
TIKI,o-to-xe-may-xe-dap,45555300,"Bộ 2 Sáp Thơm Cà Phê Mocha Grasse L'Esterel Bullsone HQST17CA (130g)",180000,180000,0,0
TIKI,o-to-xe-may-xe-dap,1565453,"Chai xịt tăng độ bóng sơn ô tô 3M 39034 LT 3M Gloss Enhancer 400ml",175000,175000,0,0
TIKI,o-to-xe-may-xe-dap,174055633,"Máy hút bụi cầm tay mini không dây hàng chính hãng DELIYA , hút bụi giường, ô tô lực hút 9000PA hút liên tục 30phút",284000,299000,15000,5
TIKI,o-to-xe-may-xe-dap,114984646,"Mũ bảo hiểm xe đạp người lớn, nón bảo hiểm xe đạp Protec Win 002 tiêu chuẩn Châu Âu, thời trang, cá tính, an toàn- Hàng Chính Hãng",375000,479000,104000,22
TIKI,o-to-xe-may-xe-dap,194788781,"Bộ kích điện xe ô tô khẩn cấp Xiaomi 70Mai 11100 mAh- kích điện oto-Cứu hộ xe hơi Car Jump Starter",1139000,1800000,661000,37
TIKI,o-to-xe-may-xe-dap,41296396,"Bình chữa cháy Mini cho ô tô FMS-25 1000ml",107000,128000,21000,16
TIKI,o-to-xe-may-xe-dap,17039165,"Lá Thơm Xe AREON BLUE CRYSTAL - Pha Lê Xanh (Nam tính)",60000,60000,0,0
TIKI,o-to-xe-may-xe-dap,97446123,"Nước Rửa Xe Sáng Bóng 3M 10 Lít",579000,579000,0,0
TIKI,o-to-xe-may-xe-dap,19356014,"Dung Dịch Dưỡng Và Làm Bóng Lốp Ekokemika Blackbrill (5L) - Hàng Chính Hãng",380000,380000,0,0
TIKI,o-to-xe-may-xe-dap,147975283,"VÍ DA Ô TÔ ĐỰNG ĐĂNG KIỂM, GIẤY TỜ Ô TÔ CAO CẤP - BÓP ĐỰNG GIẤY TỜ XE HƠI",25000,25000,0,0
TIKI,o-to-xe-may-xe-dap,69191447,"Bộ Vè Chắn Bùn Leo Núi Thể Thao Siêu Dẻo Mềm Chống Gãy 2 in 1 (Trước Và Sau) Cho Xe Đạp Địa Hình, MTB Tích Hợp Đèn Led Đuôi Cảnh Báo Phía Sau Màu Đỏ Mai Lee",141550,149000,7450,5
TIKI,o-to-xe-may-xe-dap,49324632,"Nón bảo hiểm 3/4 Royal M139 Design V10 Đen Bóng",550000,730000,180000,25
TIKI,o-to-xe-may-xe-dap,1254727,"Dung Dịch Vệ Sinh Máy Carbon Cleaner Liqui Moly 4T Additive Shooter 7916 (80ml)",83000,85000,2000,2
TIKI,o-to-xe-may-xe-dap,139289852,"Lốp(vỏ) DPLUS 80/90-16 Dành cho Trước SH Mode, Sau NouvoLX, Sirius...CÔNG NGHỆ NHÂTJIS",380000,380000,0,0
TIKI,o-to-xe-may-xe-dap,76029583,"Mũ Bảo Hiểm 1/2 Bulldog Pug - Hàng Chính Hãng",679000,679000,0,0
TIKI,o-to-xe-may-xe-dap,49548335,"Sáp Vệ Sinh Và Phủ Bóng Sơn Xe Ô Tô Màu Trắng White SOFT99 Wax W-3",292500,390000,97500,25
TIKI,o-to-xe-may-xe-dap,41934078,"Máy lọc không khí ô tô iMediCare iAP-3A",3350000,3350000,0,0
TIKI,o-to-xe-may-xe-dap,122831451,"Vè che mưa đen dày dành cho Xpander 2019-2020-2021",295000,327000,32000,10
TIKI,o-to-xe-may-xe-dap,73873352,"Dụng Cụ Bảo Dưỡng Kiểm Tra Sên Xích Xe Đạp, Đo Độ Mòn Xích, Vam Sên Cắt Tháo Mắt Sên Và Kềm Cắt Dây Xích Chuyên Dụng Cho Xe Đạp Mai Lee (3 món)",189050,199000,9950,5
TIKI,o-to-xe-may-xe-dap,156403858,"Bạt Phủ Áo Trùm Xe Máy Vải Dù Che Mưa Nắng Thời Tiết Khắc Nghiệt Loại Lớn Cho Dòng Xe Tay Ga - Xe Số Thông Dụng MINIIN",132000,132000,0,0
TIKI,o-to-xe-may-xe-dap,101995996,"Đèn Đuôi Led Xe Đạp BK880 Chống Nước Siêu Sáng Nhiều Chế Độ Sáng Sạc Điện USB (Bản Nâng Cấp) 2 Phiên Bản MaiLee",217550,229000,11450,5
TIKI,o-to-xe-may-xe-dap,124385359,"Bệ Tỳ Tay Xpander Và Xpander Cross Mẫu Bệ Thấp Tiện Lợi Loại I",267000,328000,61000,19
TIKI,o-to-xe-may-xe-dap,22373460,"Bộ chia Tẩu sạc ô tô, Xe hơi cao cấp Đa năng Huyndai HY - I6",123000,123000,0,0
TIKI,o-to-xe-may-xe-dap,49659573,"Vè Che Mưa Chỉ Mạ Cho Xe Kia Soluto",315000,322900,7900,2
TIKI,o-to-xe-may-xe-dap,38482476,"Mũ Bảo Hiểm Xe Đạp Trẻ Em Protec SMILE Họa Tiết CapTain America Có Vòng Điều Chỉnh Đầu, Có Đèn Chiếu Hậu An Toàn Phía Sau",345000,438000,93000,21
TIKI,o-to-xe-may-xe-dap,164430657,"Mỡ bôi trơn dạng xịt Grease Spray Bosny",95000,120000,25000,21
TIKI,o-to-xe-may-xe-dap,13959388,"Sơn Phủ Gầm Wurth 0892075200 (1L)",239000,239000,0,0
TIKI,o-to-xe-may-xe-dap,117219775,"Bộ Dưỡng Sên Xe Máy Maxima Chain Guard Và Chai Rửa Sên Voltronic IX69 Kèm Bàn Chải 3 Mặt Tiện Dụng",35000,35000,0,0
TIKI,o-to-xe-may-xe-dap,153937726,"COMBO Nẹp bước chân và ốp chống trầy cốp Honda CRV, CR-V vân Carbon",1449000,1486000,37000,2
TIKI,o-to-xe-may-xe-dap,8512185,"Mũ 3/4 Bulldog Heli Carbon",2600000,2600000,0,0
TIKI,o-to-xe-may-xe-dap,108968070,"Xịt dưỡng cao su, gioăng cửa ô tô Silicone Spray Senfineco 9990",210000,210000,0,0
TIKI,o-to-xe-may-xe-dap,33227275,"Băng keo 2 mặt chịu nhiệt dán linh kiện điện tử 3M khổ 6mm x 50m 9448A",89000,89000,0,0
TIKI,o-to-xe-may-xe-dap,85800972,"Ốp bao da chìa khoá huyndai các loại - i10 tucson elantra kona acent santafe solaiti Bảo Hành Uy Tín Lỗi 1 Đổi 1",148000,164499,16499,10
TIKI,o-to-xe-may-xe-dap,85368098,"Nệm Giường hơi để xe ô tô- nệm hơi xe hơi-Đệm xe hơi vải nhung",348000,348000,0,0
TIKI,o-to-xe-may-xe-dap,38148090,"Bộ 4 Miếng Dán Gương Kính Bên Ô Tô Chống Nước Chống Lóa Gồm 2 Miếng Elip 150x100mm Và 2 Miếng Chữ Nhật 200x160mm",49000,49000,0,0
TIKI,o-to-xe-may-xe-dap,48563503,"Ví Da Đựng Đăng Kiểm, bảo hiểm, Giấy Tờ Cho Ô tô in Logo Honda",25000,25000,0,0
TIKI,o-to-xe-may-xe-dap,54476107,"Nón bảo hiểm 3/4 kính âm Royal M139 Đỏ Đô Nhám cao cấp Lót tháo rời, che hết mặt",489000,489000,0,0
TIKI,o-to-xe-may-xe-dap,9834560,"Dầu nhớt tổng hợp dành cho xe côn Liqui Moly Synth Street  Race10W40 ",330000,330000,0,0
TIKI,o-to-xe-may-xe-dap,22230660,"DUNG DỊCH BẢO VỆ VÀ TĂNG CƯỜNG ĐỘ BÓNG  Sealing Wax Protection",859000,859000,0,0
TIKI,o-to-xe-may-xe-dap,88025790,"Ốp hõm và tay nắm cửa dành cho Ecosport",177000,186480,9480,5
TIKI,o-to-xe-may-xe-dap,50415606,"Hộp tỳ tay ô tô dành cho Mitsubishi Xpander tích hợp 7 cổng USB ( DUSB-EXPD )",359000,378000,19000,5
TIKI,o-to-xe-may-xe-dap,53450914,"Bảng số điện thoại dạ quang ACNUM-B0S gắn taplo ô tô, xe hơi nhãn hiệu Baseus - Hàng Nhập Khẩu",98499,98499,0,0
TIKI,o-to-xe-may-xe-dap,180985971,"Máy bơm lốp xe máy, ô tô- siêu tốc tự ngắt Michelin 12314 -12V- 360W",1699000,1699000,0,0
TIKI,o-to-xe-may-xe-dap,135464990,"Combo 3 chai Sprayking Dưỡng nhám,Rửa sên và dưỡng sên 400ML",139000,139000,0,0
TIKI,o-to-xe-may-xe-dap,38164829,"Kem Đánh Bóng Và Bảo Vệ Sơn Xe Màu Đen Sonax Polish & Wax Color Black 296141 250ml",180000,180000,0,0
TIKI,o-to-xe-may-xe-dap,136187475,"RÈM CHE NẮNG NAM CHÂM CHO XE TOYOTA FORTUNER 2008-2015",242000,248000,6000,2
TIKI,o-to-xe-may-xe-dap,3121057,"Dung Dịch Làm Sạch Mâm Vành SONAX Rim Cleaner 429200 (500ml)",190000,190000,0,0
TIKI,o-to-xe-may-xe-dap,1378139,"Paste Đánh Bóng 1 Bước Nhanh Chóng 3M Polish Finishing Material 81235 (1L)",620000,620000,0,0
TIKI,o-to-xe-may-xe-dap,50385956,"Bộ 3 phụ gia thay định kì bao gồm nhớt 33017, xăng 33027, nano 33047 cao cấp cho xe máy Bluechem - 33017_33027_33047",252000,259000,7000,3
TIKI,o-to-xe-may-xe-dap,177642752,"Găng tay nam mùa đông cảm ứng điện thoại lót lông cực ấm, lòng bàn tay chống trượt cao cấp - Phong cách nam tính GTN68",278000,278000,0,0
TIKI,o-to-xe-may-xe-dap,1254567,"Chất Tấy Rửa, Bôi Trơn, Chống Rỉ Sét 3M 5 Way (400ml)",85000,85000,0,0
TIKI,o-to-xe-may-xe-dap,81794754,"Sơn Xịt Phủ Gầm Chống Ồn Chống Rỉ Sét Flamingo F021 500ml - Hãng Phân Phối Chính Thức",110000,118990,8990,8
TIKI,o-to-xe-may-xe-dap,35736205,"NANO SEALANT DẠNG XỊT BẢO VỆ LÀM MỚI SƠN MỜ CHEMICAL GUYS METICULOUS MATTE DETAILER 16OZ",650000,650000,0,0
TIKI,o-to-xe-may-xe-dap,2841255,"Bộ sạc Acquy đa năng ANSMANN ALCT 6-24V - Hàng Nhập Khẩu",2145000,2145000,0,0
TIKI,o-to-xe-may-xe-dap,26017460,"Bộ 2 ốp gương theo xe Vios 2019",214000,243000,29000,12
TIKI,o-to-xe-may-xe-dap,153941749,"Thảm sàn, lót sàn cao su 3D cho Toyota Innova 2016-2019",835000,856000,21000,2
TIKI,o-to-xe-may-xe-dap,51268717,"Móc khóa da bò đa năng",75000,75000,0,0
TIKI,o-to-xe-may-xe-dap,41862396,"Lót Cốp Nhựa TPO Cao Cấp Dành Cho Hyundai Accent 2018/2020",343000,352000,9000,3
TIKI,o-to-xe-may-xe-dap,197926157,"Khóa Xe Đạp Khóa Mật Khẩu Xe Đạp Chống Trộm - Khóa dây 4 số bảo mật - Dây Xích Khóa Xe Đạp, Phụ Kiện Xe Đạp",55000,55000,0,0
TIKI,o-to-xe-may-xe-dap,84870095,"Dung Dịch Rửa Lốc Máy Siêu Mạnh, Tẩy Khoang Máy, Đầu Bò PALLAS 500ml",39000,39000,0,0
TIKI,o-to-xe-may-xe-dap,181565325,"Thùng giữa givi G12N kèm bát gắn cho xe Jupiter RC",750000,750000,0,0
TIKI,o-to-xe-may-xe-dap,12035264,"Bộ chia tẩu sạc ô tô nhãn hiệu Hoco Z28",153000,170000,17000,10
TIKI,o-to-xe-may-xe-dap,7005929,"Bộ 3 sản phẩm xịt bảo dưỡng nội thất 39040, bảo dưỡng lốp 39042 và tăng độ bóng sơn 39034 3M COMBO-3DD-USA",877000,899000,22000,2
TIKI,o-to-xe-may-xe-dap,99275571,"Tấm Chắn Nắng, Chống Nóng Ngoài Kính Lái Ô Tô 3 Lớp, Tráng Bạc Cỡ Lớn 118cm x 148cm, Có Trùm Gương - Hàng chính hãng",111000,190000,79000,42
TIKI,o-to-xe-may-xe-dap,36068156,"Vè Che Mưa Dành Cho Xe Ô Tô Innova 2018",287500,287500,0,0
TIKI,o-to-xe-may-xe-dap,95222640,"LÓT CỐP NHỰA DÀNH CHO XE KIA RIO SEDAN 2014-2019",328000,328000,0,0
TIKI,o-to-xe-may-xe-dap,72880242,"Tẩu sạc ô tô nhãn hiệu Hyundai HY-10 công suất 80W, một đầu chia tẩu và 3 cổng usb - Hàng nhập khẩu",101000,124000,23000,19
TIKI,o-to-xe-may-xe-dap,11221458,"Lốp Xe Piago Vespa LX DPLUS",450000,450000,0,0
TIKI,o-to-xe-may-xe-dap,169343320,"Bộ 2 Chốt ngắt tiếng kêu, chốt cài dây an toàn Ô tô Mazda",72000,74000,2000,3
TIKI,o-to-xe-may-xe-dap,36160831,"Combo 02 Chai xịt vệ sinh máy điều hòa (máy lạnh) Sandokkaebi 330ml nhập khẩu trực tiếp từ Hàn Quốc",189000,189000,0,0
TIKI,o-to-xe-may-xe-dap,66205480,"NƯỚC RỬA XE BỌT TUYẾT CHUYÊN DỤNG BT01 [1Lít]",89000,99000,10000,10
TIKI,o-to-xe-may-xe-dap,194961832,"[COMBO 2 CHIẾC] Tấm Lưới Tựa Lưng Cho Văn Phòng , Học Sinh - Đệm Ghế Lưng Cho Tài Xế, Lái Xe Hỗ Trợ Cột Sống, Giảm Nhức Mỏi- Chính Hãng GROFA",59000,59000,0,0
TIKI,o-to-xe-may-xe-dap,6349635,"Mũ Bảo Hiểm 3/4 M139 - Cam Tem (Size",549000,549000,0,0
TIKI,o-to-xe-may-xe-dap,118235411,"Bố Thắng Trước Ford Transit (2000-2006) - Bosch BP 4047",254000,254000,0,0
TIKI,o-to-xe-may-xe-dap,117597712,"COMBO 2 Bình xịt dưỡng bóng lốp xe ô tô, xe máy Flamingo Tire Shine 500ml",183000,193000,10000,5
TIKI,o-to-xe-may-xe-dap,14643363,"Rèm che nắng ô tô 6 tấm cao cấp gấp gọn tiện lợi",96000,98000,2000,2
TIKI,o-to-xe-may-xe-dap,83809831,"Bao da chìa khóa Ducati Diavel 1260S - CHÍNH HÃNG KHACTEN.COM",400000,400000,0,0
TIKI,o-to-xe-may-xe-dap,186161140,"Bộ ốp nẹp sườn Xpander 2018-2019-2020-2021-2022 mạ crom trang trí làm đẹp xe",449000,449000,0,0
TIKI,o-to-xe-may-xe-dap,111361008,"Nẹp Chân Kính Inox Dành Cho Xe VIOS 2019 2020 2021 - chất liệu inox - 6 chi tiết",204000,209000,5000,2
TIKI,o-to-xe-may-xe-dap,94519656,"Chai xịt vệ sinh hệ thống điều hòa ô tô 3M AIR CONDITIONER CLEANER FOAM 89227 - Bình xịt vệ sinh làm sạch bụi bẩn và khử mùi hệ thống điều hòa",185000,185000,0,0
TIKI,o-to-xe-may-xe-dap,35736730,"NƯỚC RỬA CHUYÊN CHO XE SƠN ĐẶC BIỆT CHEMICAL GUYS METICULOUS MATTE AUTO WASH FOR SATIN FINISH (16 OZ)",550000,550000,0,0
TIKI,o-to-xe-may-xe-dap,186161147,"Bộ ốp tapli CR-V, CRV 2018-2019-2020-2021-2022 vân Titan chống xước va đập khi mở cửa và làm đẹp xe",479000,479000,0,0
TIKI,o-to-xe-may-xe-dap,511348,"Che Chống Nắng Phản Quang Tròn Hando",62000,62000,0,0
TIKI,o-to-xe-may-xe-dap,141955901,"Chốt dây an toàn ô tô các hãng bằng hợp kim mạ inox,Chốt cài dây an toàn ô tô các hãng xe,Chốt cửa an toàn ô tô hữu ích",37000,37000,0,0
TIKI,o-to-xe-may-xe-dap,177300390,"Bộ ty thủy lực chống cốp sau Ford Escape mở cốp tự động",265050,265050,0,0
TIKI,o-to-xe-may-xe-dap,93219570,"DUNG DỊCH LÀM SẠCH LAZANG - 1 LÍT",173000,173000,0,0
TIKI,o-to-xe-may-xe-dap,11487635,"Tinh dầu treo xe hơi hương dưa hấu – Areon Fresco Watermelon (Dịu nhẹ)",200000,200000,0,0
TIKI,o-to-xe-may-xe-dap,34961418,"Thảm Nhựa Lót Cốp Sau Dành Cho Xe Ô Tô Xpander",239000,239000,0,0
TIKI,o-to-xe-may-xe-dap,9802835,"Bộ 4 ốp tay cửa chống xước và trang trí xe Mazda 2, Mazda 3, Mazda 6 và CX-5",184000,188500,4500,2
TIKI,o-to-xe-may-xe-dap,1254641,"Dung Dịch Tăng Chỉ Số Octan Cho Xăng Bluechem Octane Booster (250ml)",250000,250000,0,0
TIKI,o-to-xe-may-xe-dap,52110029,"Phụ gia xúc béc dầu cao cấp Liqui Moly 1806 - Tặng kèm 1 khăn lau chuyên dụng 3M",225000,225000,0,0
TIKI,o-to-xe-may-xe-dap,118085211,"Bố Thắng (Bố Càng Sau) Ford Transit (-2006) - Bosch BP 1542",637000,637000,0,0
TIKI,o-to-xe-may-xe-dap,177309832,"Ốp viền đèn gầm trước xe Innova 2013-2014-2015-2016 mạ Crom chống trầy trang trí làm đẹp xe",195000,195000,0,0
TIKI,o-to-xe-may-xe-dap,140217822,"Đệm hơi ô tô tiện dụng phiên bản mới cao cấp từ 4 đến 7 chỗ - nệm hơi, giường hơi xe hơi",415000,415000,0,0
TIKI,o-to-xe-may-xe-dap,28948798,"Túi đựng đồ cao cấp treo sau ghế ô tô - Hàng nhập khẩu",151000,155000,4000,3
TIKI,o-to-xe-may-xe-dap,58570827,"Ốp Nắp Bình Xăng Cacbon Chống Xước Trang Trí Bảo Vệ Ô Tô-Ranger 2016-2020",141000,145000,4000,3
TIKI,o-to-xe-may-xe-dap,132820357,"Dù Che Kính Lái Ô Tô- Chống Nắng, Bảo Vệ Nội Thất Xe Hơi",73981,73981,0,0
TIKI,o-to-xe-may-xe-dap,188705625,"Sơn xịt phủ gầm xe hơi ô tô chống rỉ mọt bảo vệ gầm xe, flamingo rubberized undercoat F021 hàng chính hãng",117600,117600,0,0
TIKI,o-to-xe-may-xe-dap,23944229,"Decal Tem Chữ Discovery 3D Kim Loại Dán Trang Trí Ô Tô - màu Crom",71000,81000,10000,12
TIKI,o-to-xe-may-xe-dap,54779162,"Chai xịt làm bóng và bảo dưỡng lốp xe ô tô Sonax 235300 dung tích 400 ml",321000,321000,0,0
TIKI,o-to-xe-may-xe-dap,144324725,"(HÀNG ĐẸP) Dù Che Nắng Ô Tô Cao Cấp, Dù Che Kính Lái Xe Hơi (Tặng BAO DA) - Chống Nắng, Bảo Vệ Nội Thất",98978,98978,0,0
TIKI,o-to-xe-may-xe-dap,54476251,"Nón bảo hiểm 3/4 kính âm Royal M139 Vàng Cam cao cấp Lót tháo rời, che hết mặt",489000,489000,0,0
TIKI,o-to-xe-may-xe-dap,41293830,"Bộ ốp tay nắm hõm cửa VINFAST FADIL 2019/2020",130000,136800,6800,5
TIKI,o-to-xe-may-xe-dap,108246627,"Sáp thơm xe Yankee Candle - Beach Walk",199000,279000,80000,29
TIKI,o-to-xe-may-xe-dap,9883125,"Túi yên xe đạp Lezyne Energy Caddy",299000,299000,0,0
TIKI,o-to-xe-may-xe-dap,42504433,"Dầu hộp số tự động Trợ lực tay lái Kixx ATF DX VI 1L",160000,160000,0,0
TIKI,o-to-xe-may-xe-dap,150929607,"Xe đạp Thống Nhất mini New 26-Hàng chính hãng",2324520,2348000,23480,1
TIKI,o-to-xe-may-xe-dap,155288114,"Nhớt Xe Máy Motul GP Power 10W40 API SL JASO MA2 Chai 800ml Chính Hãng ",115000,115000,0,0
TIKI,o-to-xe-may-xe-dap,892513,"Chai Xịt Bảo Dưỡng Lốp Xe Ô Tô 3M 39042 LT 3M Tire Dressing (400ml)",151000,160000,9000,6
TIKI,o-to-xe-may-xe-dap,49451282,"Máy lọc không khí ô tô Airshot Road | Sản phẩm chính hãng Hàn Quốc | Sử dụng công nghệ đèn LED UV khử trùng mạnh mẽ",1399000,1700000,301000,18
TIKI,o-to-xe-may-xe-dap,53247443,"Máy bơm lốp ô tô, xe hơi tự ngắt Michelin 4398ML (12266) động cơ mạnh mẽ 180W cho áp suất tối đa 150PSI, tốc độ bơm nhanh 35l/phút",1039000,1039000,0,0
TIKI,o-to-xe-may-xe-dap,12207786,"Mũ bảo hiểm 3/4 Asia M115 kính gương",296000,296000,0,0
TIKI,o-to-xe-may-xe-dap,38151399,"KHÓA DÂY XE ĐẠP MASTERLOCK 8126EURD",137000,150000,13000,9
TIKI,o-to-xe-may-xe-dap,72575483,"[Mẫu Mới] Nhớt cao cấp cho xe tay ga đời mới Motul Scooter Power LE 5W40 800ml tặng nhớt hộp số Motul Gear 80W90 120ml",209000,209000,0,0
TIKI,o-to-xe-may-xe-dap,96989743,"Ô che nắng, chắn tia UV kính lái ô tô đa năng - Chất liệu: (vải dù) keo bạc titan - Kích thước: 80x145cm",71000,94000,23000,24
TIKI,o-to-xe-may-xe-dap,172948758,"BAO DA MÓC CHÌA KHÓA",161018,161018,0,0
TIKI,o-to-xe-may-xe-dap,53131824,"Kem dưỡng ghế da Sonax 291141-250ml",200000,220000,20000,9
TIKI,o-to-xe-may-xe-dap,88921228,"Decal phản quang 3M serie 983 (1 mét lẻ) - Phản quang cho xe ô tô",60000,60000,0,0
TIKI,o-to-xe-may-xe-dap,54749509,"Bọc vô lăng ô tô Tặng Bảng Số Điện Thoại - Bọc vô lăng Xe Hơi",65000,80000,15000,19
TIKI,o-to-xe-may-xe-dap,1246035,"Nước Hoa Ô Tô Bullsone Grasse Aqua Wave (110ml)",272391,300000,27609,9
TIKI,o-to-xe-may-xe-dap,73795218,"Tay Càng Chống Mỏi, Tay Càng Nghỉ Gắn Ghi Đông Xe Đạp Thể Thao Đua Hợp Kim Nhôm Trọng Lượng Nhẹ (Dài 34cm) Mai Lee",202255,212900,10645,5
TIKI,o-to-xe-may-xe-dap,173853680,"Keo Xịt Đa Năng 3M Super 77 - 375g",151000,165000,14000,8
TIKI,o-to-xe-may-xe-dap,98029901,"Tấm Chắn Nắng Ô Tô - Tấm Che Nắng Ô Tô Xốp Bạc Dày Dặn",30000,32000,2000,6
TIKI,o-to-xe-may-xe-dap,50693882,"Combo Mũ Bảo Hiểm 3/4 Đầu Napoli SH1 Kèm Kính UV400 - Nón Bảo Hiểm Phượt Napoli Mẫu Mới 2020",295000,399000,104000,26
TIKI,o-to-xe-may-xe-dap,191930932,"Bóng đèn pha xe môtô Philips 200 M5 11163 UEM X1",181000,220000,39000,18
TIKI,o-to-xe-may-xe-dap,31897046,"KEM XÓA XƯỚC CHO BỀ MẶT SƠN, NHỰA, KÍNH AUTOSOL SCRATCH REMOVER #1300 75ML",179000,179000,0,0
TIKI,o-to-xe-may-xe-dap,47353118,"Đèn Led Gắn Van Xe Đạp,Xe Máy,Ô Tô Kiểu 5 BÓNG LED",34000,39900,5900,15
TIKI,o-to-xe-may-xe-dap,179807210,"Máy Hút Bụi Cầm Tay Không Dây Sử Dụng Pin Sạc Cho Ô Tô và Trong Gia Đình, Máy Hút Bụi Ô Tô Công Suất Lớn – Hàng Chính Hãng VinBuy",295000,450000,155000,34
TIKI,o-to-xe-may-xe-dap,1176187,"Vệ Sinh Thắng Đĩa, Máy, Sên Không Phốt Liqui Moly 3318 (500ml)",108000,119000,11000,9
TIKI,o-to-xe-may-xe-dap,178058023,"Bơm xe đạp bơm xe máy XT02 - ống bơm đa năng gia dụng dài đến 58cm áp suất 150PSI - Hỗ trợ van Mỹ và van Pháp",92000,92000,0,0
TIKI,o-to-xe-may-xe-dap,44957436,"Nón Bảo Hiểm Trẻ Em 1/2 Đầu Có Kính Protec Kitty, Họa Tiết Captain American - Hàng Chính Hãng",385000,442000,57000,13
TIKI,o-to-xe-may-xe-dap,181958749,"Máy lọc không khí ô tô xiaomi Eraclean CW-C02 - Hàng nhập khẩu",935000,1189000,254000,21
TIKI,o-to-xe-may-xe-dap,192890966,"CỤM GIÁ ĐỂ HÀNG JUPITER FINN",199000,199000,0,0
TIKI,o-to-xe-may-xe-dap,71945862,"Nước rửa khoang máy, gầm xe, mâm xe ô tô, mô tô, xe máy [Bình xịt 511ml]",99000,129000,30000,23
TIKI,o-to-xe-may-xe-dap,117598477,"Nước làm mát động cơ xe ô tô màu xanh Esna Coolant",19000,19000,0,0
TIKI,o-to-xe-may-xe-dap,107980194,"Đèn led trần, led cốp, đèn đọc sách cho xe hơi ô tô Green Networks Group ( 1 Đèn )",29000,29000,0,0
TIKI,o-to-xe-may-xe-dap,189946571,"Tấm tựa lưng ghế ô tô, tấm tựa lưng đa năng cho ghế ô tô hoặc ghế văn phòng - Hàng chính hãng ",55000,100000,45000,45
TIKI,o-to-xe-may-xe-dap,173463497,"Móc treo xe đạp lên tường MTR02, giá treo xe đạp 2 móc đỏ siêu chắc chắn  (kèm ốc vít) Mai Lee ",113050,119000,5950,5
TIKI,o-to-xe-may-xe-dap,3818435,"Chai Xịt Vệ Sinh Sên Cực Sạch Lube71 Wow Spray 600ml",189000,189000,0,0
TIKI,o-to-xe-may-xe-dap,47990530,"Ví đựng giấy tờ xe hơi, ô tô cao cấp VD-01",25000,25000,0,0
TIKI,o-to-xe-may-xe-dap,102654782,"Ô Che Nắng Kính Lái Xe Ô Tô Cao Cấp – Bảo Vệ Nội Thất Ô Tô – Dù Che Nắng Kính Lái Xe Hơi – Chống Tia UV",78000,118000,40000,34
TIKI,o-to-xe-may-xe-dap,97972878,"Thùng Rác Oto Mini, Hộp chứa Rác Xe Hơi Dễ Thương màu đen",63000,70000,7000,10
TIKI,o-to-xe-may-xe-dap,89473525,"Nhớt Động Cơ Xe Máy Fuchs Silkolene 10W40 JASO MA2 API SM&SN",270000,270000,0,0
TIKI,o-to-xe-may-xe-dap,91973091,"Gối tựa cổ cao su non trên ô tô bảo vệ cổ, lưng, cột sống khi lái xe -Gối tựa cổ cao su non trên ô tô bảo vệ cổ, lưng",190000,190000,0,0
TIKI,o-to-xe-may-xe-dap,208211939,"Mũ bảo hiểm lỗ thông gió chính hãng NÓN SƠN TG-TR002",324000,650000,326000,50
TIKI,o-to-xe-may-xe-dap,35930998,"Khung Gắn Biển Số ( Khung, Viền, Kính, Ốc Gắn ) Cho Tất Cả Loại Xe STĐA Hoàng Long - Hàng Cao Cấp",36000,36000,0,0
TIKI,o-to-xe-may-xe-dap,271370123,"Xe đạp địa hình Thống Nhất MTB26-05 đen mờ - Hàng chính hãng",3356100,3390000,33900,1
TIKI,o-to-xe-may-xe-dap,68564784,"Bộ 2 Gương xe đạp, xe đạp điện cao cấp (kèm chốt gắn ghi-đông lỗ 8mm) xoay 360 độ chắc chắn, gương phẳng, góc lớn giúp đạp xe an toàn Mai Lee",141550,149000,7450,5
TIKI,o-to-xe-may-xe-dap,35911745,"Bộ 4 Khăn lau xe hơi, ô tô, xe máy đa năng chuyên dụng cao cấp siêu thấm hút nước mạnh giúp vệ sinh chăm sóc ô tô/ xe máy sạch sẽ - Hàng chính hãng",84550,89000,4450,5
TIKI,o-to-xe-may-xe-dap,82459827,"Đèn Hậu Xe Đạp 3 Bóng Đèn Sau Xe Đạp Giúp Cảnh Báo Đạp Xe/Chạy Bộ Ban Đêm Sạc USB Mai Lee",94050,99000,4950,5
TIKI,o-to-xe-may-xe-dap,16094270,"Bộ vá lụi (vá ngoài) dùng cho lốp không xăm xe hơi và xe máy",18090,18090,0,0
TIKI,o-to-xe-may-xe-dap,25454895,"Bộ 2 miếng dán chống nước gương chiếu hậu xe hơi",49000,50000,1000,2
TIKI,o-to-xe-may-xe-dap,72333316,"Máy Khuếch Tán Tinh Dầu Xe Hơi Cao Cấp và Chuyên Dụng, Máy Xông Tinh Dầu Dùng Điện USB Trên Xe ô tô, Đèn LED Cực Đẹp, Không Dùng Lõi Bông",278000,556000,278000,50
TIKI,o-to-xe-may-xe-dap,125010167,"Nhớt Hộp Số Nhớt Láp Xe Tay Ga Motul Scooter Gear Oil Plus 120ml",55000,55000,0,0
TIKI,o-to-xe-may-xe-dap,45557646,"Đệm Ngồi Cao Cấp Bullsone (43 x 41.5 x 2.5 cm)",2091536,2500000,408464,16
TIKI,o-to-xe-may-xe-dap,95548201,"Rèm che nắng cửa xe ô tô xe hơi rèm lụa hít nam châm mẫu mới cao cấp",121000,157000,36000,23
TIKI,o-to-xe-may-xe-dap,177479143,"Mũ bảo hiểm 1/2 đầu Napoli N088 New vòng đầu từ 54 -57cm chất liệu nhựa ABS, xốp EPS giảm xung chấn cực tốt",151000,229000,78000,34
TIKI,o-to-xe-may-xe-dap,74418639,"Bộ Móc Treo Xe Đạp Giúp Nâng Xe Đạp/ Vật Dụng Treo Lên Trần Nhà Gọn Gàng Với Móc Dây Ròng Rọc Polly Mai Lee",179550,189000,9450,5
TIKI,o-to-xe-may-xe-dap,143292192,"Túi Treo Xe Đạp Thể Thao B-Soul01 40cm - Túi Đeo Xe Đạp Địa Hình Chống Nước - Phụ Kiện Xe Đạp Chính Hãng",112000,112000,0,0
TIKI,o-to-xe-may-xe-dap,3172271,"Chai Xịt Bôi Trơn Sên Chống Văng Tơ Nhện Spider Spray 600ml",220000,220000,0,0
TIKI,o-to-xe-may-xe-dap,72796216,"Dầu Bôi Trơn Tra Sên Xích Xe Đạp Cho Xe Đạp Leo Núi, Xe Đạp Thể Thao Giúp Làm Sạch Xích, Chống Ăn Mòn, Bám Bụi, An Toàn Môi Trường 60ml",92150,97000,4850,5
TIKI,o-to-xe-may-xe-dap,208206856,"Mũ bảo hiểm lỗ thông gió chính hãng NÓN SƠN TG-XM151",324000,650000,326000,50
TIKI,o-to-xe-may-xe-dap,1254663,"Dung Dịch Vệ Sinh Ghế Da Ghế Nỉ Liqui Moly 1539 (300ml)",171000,175000,4000,2
TIKI,o-to-xe-may-xe-dap,94421463,"Máy phun sương tạo ẩm, xông tinh dầu trên xe ô tô, xe hơi nhãn hiệu Baseus DHSG-OG Công suất: 5W - Hàng nhập khẩu",359399,359399,0,0
TIKI,o-to-xe-may-xe-dap,177830682,"Chắn bùn xe đạp Kiotool Touring, Fixed, 700c",45000,45000,0,0
TIKI,o-to-xe-may-xe-dap,88993365,"Bơm Xe Đạp Mini 100Psi Kèm Khung Gắn Sườn Xe Nhiều Đầu Bơm Tiện Lợi, Lõi Khung Nhôm Kim Loại Trọng Lượng Nhẹ MaiLee",115900,122000,6100,5
TIKI,o-to-xe-may-xe-dap,1254773,"Kem Xóa Vết Xước Sơn Xe Hơi Liqui Moly Kratzer Stop 2320 (200ml)",215000,215000,0,0
TIKI,o-to-xe-may-xe-dap,181908818,"Xe đạp Thống Nhất thể thao M26-01 - Hàng chính hãng",3513510,3549000,35490,1
TIKI,o-to-xe-may-xe-dap,11204849,"Túi treo đầu xe máy mẫu mới siêu bền",189000,189000,0,0
TIKI,o-to-xe-may-xe-dap,58400468,"Kính thay cho nón bảo hiểm kính âm Royal M139 - Chỉ có kính",80000,150000,70000,47
TIKI,o-to-xe-may-xe-dap,182456852,"Túi than hoạt tính TTAUTO 100% từ gáo dừa Bến Tre khử mùi diệt khuẩn trên ô tô, tủ đồ, phòng tắm - Túi 150 Gram",65000,65000,0,0
TIKI,o-to-xe-may-xe-dap,33388584,"Cặp Phuộc kiểu Lò Xo Màu dành cho Wave,Dream BẢO LONG RACING",360000,360000,0,0
TIKI,o-to-xe-may-xe-dap,176419459,"BẠT TRÙM / TẤM PHỦ TẤT CẢ CÁC LOẠI XE MÁY KÍCH THƯỚC 220x115cm, LÀM TỪ VẢI DÙ 2 DA CAO CẤP ,BỀN ĐẸP, CHỐNG MƯA NẮNG",130000,130000,0,0
TIKI,o-to-xe-may-xe-dap,96653083,"10m Cuộn nẹp viền cao su chữ U lõi thép chống xước ,va đập viền cửa ô tô",104000,109990,5990,5
TIKI,o-to-xe-may-xe-dap,182830496,"Thảm taplo xe ô tô da carbon Tâm Luân chống nắng và chống nóng không thấm nước (26 dòng xe - đời xe)",171000,300000,129000,43
TIKI,o-to-xe-may-xe-dap,48887218,"Combo Xịt Dưỡng sên Thunder Chain Lube 400ml, Vệ sinh sên MC-40 400ml tặng bàn chải chà sên 3D",117000,117000,0,0
TIKI,o-to-xe-may-xe-dap,55776431,"Miếng Lót Ghế Tản Nhiệt",232000,318000,86000,27
TIKI,o-to-xe-may-xe-dap,3151283,"Nước Rửa Kính Ô Tô Focar Screen Wash (2.75L)",91000,119000,28000,24
TIKI,o-to-xe-may-xe-dap,34155820,"Đèn 5 LED Cảnh báo sau Xe Đạp giúp đạp xe an toàn ban đêm 4 chế độ sáng (Đèn Đỏ) Mai Lee - Hàng chính Hãng",25650,27000,1350,5
TIKI,o-to-xe-may-xe-dap,18003080,"Kính rời mũ bảo hiểm GRS",99000,119000,20000,17
TIKI,o-to-xe-may-xe-dap,48303234,"Mũ Bảo Hiểm 3/4 Napoli SH1 Free Size 5-58 cm - Nâu Lót Nâu - Bảo hành 12 tháng",261000,359000,98000,27
TIKI,o-to-xe-may-xe-dap,71542488,"Máy xông tinh dầu xe ô tô vân gỗ cao cấp chuyên dụng, Máy khuếch tán tinh dầu xe hơi lan tỏa hương thơm, khử mùi và trang trí cho xe",278000,556000,278000,50
TIKI,o-to-xe-may-xe-dap,272129048,"Kem đánh bóng sơn xe ô tô (Car Cream) Karshine 250g KA-CC250",69000,69000,0,0
TIKI,o-to-xe-may-xe-dap,68877509,"Dụng Cụ Kìm (Kềm) Cắt Mở Đóng Dây Sên Xích Xe Đạp Thể Thao Mini Tiện Lợi Nhanh Chóng Mai Lee",46550,49000,2450,5
TIKI,o-to-xe-may-xe-dap,72555849,"Cuộn Đề Can (Decal) Phản Quang Dán Trang Trí Viền Thân Xe Đạp, Xe Máy, Ô tô An Toàn Ban Đêm Nổi Bật (8 mét) Mai Lee",25650,27000,1350,5
TIKI,o-to-xe-may-xe-dap,74083498,"Cảo Xích Xe Đạp Giúp Tháo Mở Cảo Cắt Mắt Dây Sên Xe Đạp Nhỏ Gọn, Tiện Lợi Mai Lee",94050,99000,4950,5
TIKI,o-to-xe-may-xe-dap,105525660,"Nón bảo hiểm xe đạp có kính Protec Win 018, nón bảo hiểm chơi thể thao ngoài trời tiêu chuẩn châu âu, kính mát, chống tia UV",489000,568000,79000,14
TIKI,o-to-xe-may-xe-dap,35457234,"Dung Dịch Tẩy Nhựa Đường, Keo Băng Dính SONAX Tar remover 334200 (300ml)",170000,170000,0,0
TIKI,o-to-xe-may-xe-dap,25933443,"Bộ 2 Gối Tựa Đầu Ô Tô - Gối Chống Mỏi Cổ Trên Xe Hơi AZONE - Màu Chỉ Đỏ",102000,150000,48000,32
TIKI,o-to-xe-may-xe-dap,196381326,"Mũ bảo hiểm lưỡi trai loại nón kết Napoli N08 size 56-59 cm",147000,259000,112000,43
TIKI,o-to-xe-may-xe-dap,172948856,"BỘ CHẮN BÙN SAU XE NVX 155",199000,199000,0,0
TIKI,o-to-xe-may-xe-dap,34531222,"Bộ Hộp Dụng Cụ Vá Lốp Xe Lốp Không Săm Vá Lụi (vá ngoài) Bằng Thép Không Gỉ Cho Xe Oto, Xe Hơi Và Xe Máy Mai Lee - Hàng Chính Hãng",122550,129000,6450,5
TIKI,o-to-xe-may-xe-dap,111362293,"Thảm lót sàn cao su không mùi dành cho Kia Cerato 2019 2020",476000,488000,12000,2
TIKI,o-to-xe-may-xe-dap,71075907,"Bộ Dụng Cụ Chùi Chải Vệ Sinh Sên Xích Nhông Đĩa Cho Xe Đạp Thể Thao, Địa Hình (Kèm nước rửa tẩy rửa vệ sinh sên xích) Vệ Sinh Xích Líp Mai Lee",151050,159000,7950,5
TIKI,o-to-xe-may-xe-dap,987019,"Dầu Bôi Trơn Chống Rỉ Sét WD-40 840531 (300ml)",104000,104000,0,0
TIKI,o-to-xe-may-xe-dap,58545007,"Combo rửa sên WillF1 Chain Cleaner 500ml, Dưỡng sên WillF1 Chain Lube 400ml Tặng kèm bàn chải vệ sinh sên 3D",119000,119000,0,0
TIKI,o-to-xe-may-xe-dap,85117078,"Nón Bảo Hiểm Xe Đạp Cao Cấp Protec Win 066, Siêu Phẩm Phượng Hoàng Lửa, Mạnh Mẽ, Cá Tính - Hàng Chính Hãng",485000,569000,84000,15
TIKI,o-to-xe-may-xe-dap,1254601,"Khăn Lau Xe Hơi 3M Perfect-It Super Soft Microfiber PN05400 (32 x 36 cm)",54000,54000,0,0
TIKI,o-to-xe-may-xe-dap,111589429,"Nón bảo hiểm trẻ em 1/2 đầu Protec Kitty, họa tiết siêu anh hùng Captain American",325000,358000,33000,9
TIKI,o-to-xe-may-xe-dap,145658918,"Nón bảo hiểm 3/4 Royal M125K thiết kế nhỏ gọn, nhiều màu sắc, phù hợp mọi độ tuổi, hàng chính hãng - M",490000,490000,0,0
TIKI,o-to-xe-may-xe-dap,25969322,"Mũ bảo hiểm nửa đầu Bulldog Gang",598000,598000,0,0
TIKI,o-to-xe-may-xe-dap,59441423,"Kính rời dành cho Mũ bảo hiểm 3/4 - CHITA",105000,150000,45000,30
TIKI,o-to-xe-may-xe-dap,37874087,"Cần số Xi 7 Màu Titan cho Exciter 150 Cao Cấp Siêu Thị Đức Anh",68000,68000,0,0
TIKI,o-to-xe-may-xe-dap,72722988,"Dụng Cụ Vệ Sinh Lau Chùi Bảo Dưỡng Xe Đạp Gồm Chổi Lau Sên Xích, Chổi Cọ Lốp, Găng Tay Vải (Nhiều Món) Giúp Lau Chùi Vệ Sinh Nhanh Chóng",141550,149000,7450,5
TIKI,o-to-xe-may-xe-dap,68442580,"Nệm hơi xe ô tô Nhà của Mẹ cao cấp chất liệu vải nhung kích thước 140 x 90 x 50 cm - Màu sắc giao ngẫu nhiên",356000,420000,64000,15
TIKI,o-to-xe-may-xe-dap,59436625,"Đèn Đuôi LED Xe Đạp Thông Minh Cảnh Báo Ban Đêm Có Cảm Biến Chuyển Động Và Báo Đèn Khi Phanh Xe Chống Nước Sạc Điện USB MAILEE - Hàng Chính Hãng",246050,259000,12950,5
TIKI,o-to-xe-may-xe-dap,646560,"Khóa Thắng Đĩa Master Lock 8303 EURDPS+",489000,489000,0,0
TIKI,o-to-xe-may-xe-dap,63861428,"Khánh Phật Tọa Liên Hoa Trang Trí Xe Hơi , Dây Treo Phật Sen Gỗ Hoàng Dương Trang Trí Ô Tô",215000,215000,0,0
TIKI,o-to-xe-may-xe-dap,171871414,"Nón bảo hiểm xe đạp trẻ em Protec SMILE cho bé trai từ 1-12 tuổi, họa tiết mạnh mẽ, năng động, có đèn hậu an toàn- Hàng chính hãng",335000,438000,103000,24
TIKI,o-to-xe-may-xe-dap,50512779,"Nón bảo hiểm 3/4 kính âm Royal M139 Xanh Mực Nhám cao cấp Lót tháo rời, che hết mặt",499000,499000,0,0
TIKI,o-to-xe-may-xe-dap,34513035,"Đèn LED Cảnh báo sau Xe Đạp giúp đạp xe an toàn ban đêm 4 chế độ sáng (Đèn Xanh) Mai Lee - Hàng chính hãng",18050,19000,950,5
TIKI,o-to-xe-may-xe-dap,41195385,"Xịt khử mùi hôi Tinh dầu xá xị 100ml",110000,110000,0,0
TIKI,o-to-xe-may-xe-dap,102445310,"Hộp đựng khăn giấy chất liệu da trên ô tô và bàn làm việc,kèm bảng số điện thoại",139990,139990,0,0
TIKI,o-to-xe-may-xe-dap,106680580,"Đèn Hậu Phía Sau Cảnh báo an toàn Đuôi Xe Đạp DC918 Sạc USB Có Thể Sạc Lại MaiLee",24900,28000,3100,11
TIKI,o-to-xe-may-xe-dap,92133666,"Ví đựng giấy tờ xe ô tô Hyundai Da Cao Cấp, Ví da đựng giấy tờ xe ô tô - OTOALO",25000,25000,0,0
TIKI,o-to-xe-may-xe-dap,95548246,"Thùng đựng đồ cốp sau ô tô 56 lít, tặng kèm túi lót chứa nước bên trong",144000,144000,0,0
TIKI,o-to-xe-may-xe-dap,174121364,"Chai xịt khử mùi - diệt khuẩn 3M Air Freshener Spray 38660 200ml",202000,207000,5000,2
TIKI,o-to-xe-may-xe-dap,75554546,"Kẹp Đèn Pin Xe Đạp, Kẹp Giữ Đèn Pin Gắn Ghi Đông Cho Xe Đạp Thể Thaom Leo Núi Lắp Đặt Dễ Dàng Mai Lee",37050,39000,1950,5
TIKI,o-to-xe-may-xe-dap,99463625,"Ô Che Nắng Kính Lái Xe Ô tô - Bảo vệ nội thất ô tô - Dù che nắng kính lái xe hơi - chống tia UV",84000,98000,14000,14
TIKI,o-to-xe-may-xe-dap,71150931,"Chổi Quét Bụi Ô TÔ Đa Năng NB 64cm",170000,174000,4000,2
TIKI,o-to-xe-may-xe-dap,52318177,"Bảng số điện thoại trên ô tô nhãn hiệu Baseus ACNUM - Hàng nhập khẩu",266000,280000,14000,5
TIKI,o-to-xe-may-xe-dap,97822196,"Ô che nắng, kiêm chắn nắng kính lái ô tô đa năng 2 trong 1. Chống nắng nóng và tia UV MÃ ZYS",81690,81690,0,0
TIKI,o-to-xe-may-xe-dap,118180539,"Khóa Dây Xe Đạp 5 Số Mật Mã Dây Cáp Lõi Sợi Thép Bọc PVC Dài 120cm (kèm pát đế gắn cốt yên) (mật khẩu mặc định 00000) Mai Lee",132050,139000,6950,5
TIKI,o-to-xe-may-xe-dap,11503718,"CHAI XỊT BỌT TUYẾT VỆ SINH NÓN BẢO HIỂM, YÊN, RỬA XE KHÔ NHANH CHÓNG LUBE71 WELL FOAM SPRAY 600ML",230000,230000,0,0
TIKI,o-to-xe-may-xe-dap,7371421,"Cặp 2 cái ruột xe đạp 24 X 1.75/2.125 AV35mm",120000,120000,0,0
TIKI,o-to-xe-may-xe-dap,26293637,"CHAI XỊT VỆ SINH CẢM BIẾN OXY, CẢM BIẾN GIÓ LIQUI MOLY AIR FLOW SENSOR CLEANER 4066 200ML",197000,197000,0,0
TIKI,o-to-xe-may-xe-dap,176969649,"Vỏ chai đựng tinh dầu lục lăng TTAUTO 8ml treo xe ô tô, phòng ngủ, tủ quần áo, nhà vệ sinh",18000,18000,0,0
TIKI,o-to-xe-may-xe-dap,89580999,"Đèn Xe Đạp Đuôi Led Nhấp Nháy Chớp Vuông Gắn Sau Xe Đạp, Gắn Mũ Bảo Hiểm MaiLee",113050,119000,5950,5
TIKI,o-to-xe-may-xe-dap,176147612,"Túi than hoạt tính TTAUTO 100% từ gáo dừa Bến Tre khử mùi diệt khuẩn trên ô tô, tủ đồ, phòng tắm - Túi 100 Gram",50000,50000,0,0
TIKI,o-to-xe-may-xe-dap,198126634,"Xe máy điện VinFast EVO 200",18000000,18000000,0,0
TIKI,o-to-xe-may-xe-dap,785183,"Mũ Bảo Hiểm 1/2 Đầu Napoli NS-N088 màu trắng nhám Freesize 54 -57 cm - Bảo hành 12 tháng",155000,250000,95000,38
TIKI,o-to-xe-may-xe-dap,176825442,"Xe máy điện VinFast Theon S",63000000,63000000,0,0
TIKI,o-to-xe-may-xe-dap,1378161,"Mỡ Bò Nước Dạng Xịt Bôi Trơn Chịu Nhiệt Wurth Hhs 2000 (500ml)",175000,175000,0,0
TIKI,o-to-xe-may-xe-dap,171125271,"Mũ Bảo Hiểm 3/4 Đầu Royal M139 Kính Âm Thời Thượng Tiện Nghi",700000,700000,0,0
TIKI,o-to-xe-may-xe-dap,275508038,"Xe đạp Thống Nhất mini New 24, 26 inch - Phù hợp với người cao từ 1m35 trở lên",2206710,2229000,22290,1
TIKI,o-to-xe-may-xe-dap,119718975,"Bình Ắc Quy Khô LONG 12V-9AH WP1236W dùng cho ups, lưu điện cửa cuốn, lưu điện máy tính, loa kéo",339000,339000,0,0
TIKI,o-to-xe-may-xe-dap,189588928,"Tủ lạnh ô tô Kemin K9A - 9L Chính Hãng- Dùng ở nhà và ô tô - Hai chiều nóng lạnh",1093000,1350000,257000,19
TIKI,o-to-xe-may-xe-dap,84870183,"Combo chai vệ sinh sên Megacools 500ml và xịt bảo dưỡng sên Megacools 300ml tặng bàn chải 3D cao cấp",165000,165000,0,0
TIKI,o-to-xe-may-xe-dap,53296107,"Bảng Hiển Thị Số Điện Thoại Gắn Trên Taplo Xe Ô TÔ  Giúp Người Đi Đường Dễ Dàng Liên Hệ Với Bạn Khi Cần Thiết",10000,10000,0,0
TIKI,o-to-xe-may-xe-dap,91474483,"Rổ hông xe Winner Exciter 135 150 155 Wave Sirius Jupiter Fi RSX Blade Green Networks Group ( 1 cái )",39000,39000,0,0
TIKI,o-to-xe-may-xe-dap,68229894,"Máy phun sương tạo ẩm, xông tinh dầu mini dùng cho xe hơi Baseus Time Aromatherapy Humidifier (75ml , Alloy Air Humidifier Aroma for Car) - Hàng chính hãng",352000,352000,0,0
TIKI,o-to-xe-may-xe-dap,71105002,"Thanh Mở Rộng Gắn Ghi Đông Xe Đạp Thể Thao Địa Hình Đa Chức Năng Dùng Gắn Cho Phụ Kiện Đồ Chơi Xe Đạp (Loại dài 2 nhánh đỡ chắc chắn) Mai Lee",99750,105000,5250,5
TIKI,o-to-xe-may-xe-dap,12064795,"Miếng tựa lưng ghế hạt gỗ massage cao cấp",104000,115000,11000,10
TIKI,o-to-xe-may-xe-dap,87789165,"Ghế Yên Sau Xe Đạp Rời Cho Trẻ Gắn Baga sau Xe Đạp SADDLE SD-01 Có Tựa Lưng, khung sắt, đệm da PU -  Mai Lee",113525,119500,5975,5
TIKI,o-to-xe-may-xe-dap,66740494,"DUNG DỊCH RỬA KHOANG MÁY, MÂM XE, KHUNG GẦM Ô TÔ KM20  [5 Lit]",331000,349000,18000,5
TIKI,o-to-xe-may-xe-dap,127792464,"Bộ 4 Decal phản quang OPEN dán cửa oto cảnh báo an toàn, chống va chạm TÂM LUÂN Chổi lau tẩm dầu - Hàng chính hãng",17000,30000,13000,43
TIKI,o-to-xe-may-xe-dap,14656151,"Nhớt Xe Tay Ga Motul Scooter Expert Le 10w40 20x0.8l Vn (800ml)",119000,119000,0,0
TIKI,o-to-xe-may-xe-dap,105525662,"Mũ bảo hiểm xe đạp thể thao Protec Win 037, tiêu chuẩn Châu Âu, an toàn, mạnh mẽ, vòng đầu từ 57-62cm",375000,459000,84000,18
TIKI,o-to-xe-may-xe-dap,153468318,"Xe đạp gấp 20 icnh, chính hãng Phượng Hoàng",3550000,3550000,0,0
TIKI,o-to-xe-may-xe-dap,132026986,"COMBO 2 chai xịt bọt tẩy vệ sinh nội thất xe ô tô đa năng Flamingo 650ml",123000,126000,3000,2
TIKI,o-to-xe-may-xe-dap,51009122,"Nón bảo hiểm Royal kính âm M139 xanh lính",530000,700000,170000,24
TIKI,o-to-xe-may-xe-dap,58066078,"Đèn Pha LED Bi Cầu Mini Y6D 36W Chống Chói Mắt Green Networks Group ( 1 Bóng )",349000,349000,0,0
TIKI,o-to-xe-may-xe-dap,208206909,"Mũ bảo hiểm lỗ thông gió chính hãng NÓN SƠN TG-HG359",324000,650000,326000,50
TIKI,o-to-xe-may-xe-dap,100256806,"Xe đạp Thống Nhất GN 06-24 - Hàng chính hãng",2108700,2130000,21300,1
TIKI,o-to-xe-may-xe-dap,34257783,"Bơm Đa Năng Điện Tử Xiaomi Portable Electric Air Compressor  DZN4006GL - Hàng chính hãng",799000,899000,100000,11
TIKI,o-to-xe-may-xe-dap,139948369,"Khoá dây xe đạp xe máy 4 số chống trộm",50000,50000,0,0
TIKI,o-to-xe-may-xe-dap,49262400,"Nón bảo hiểm nguyên đầu (Fullface) Royal M136",349000,349000,0,0
TIKI,o-to-xe-may-xe-dap,145780366,"Bơm xe đạp xe máy xe hơi đạp chân di động có đồng hồ đo áp suất",129000,129000,0,0
TIKI,o-to-xe-may-xe-dap,57520399,"Bộ kích bình ắc quy dùng cho xe ô tô Baseus Super Energy Car Jump Starter",1299999,1299999,0,0
TIKI,o-to-xe-may-xe-dap,143225953,"Bơm hợp kim nhôm loại đạp chân dùng cho xe đạp, xe máy, ô tô tặng kèm kim bơm banh và bơm thú hơi - Bơm đa năng",139000,139000,0,0
TIKI,o-to-xe-may-xe-dap,10704407,"Bộ Combo bảo dưỡng sên Thunder 400ml, rửa sên TS-40 450ml tặng kèm bản chải chà sên",119000,119000,0,0
TIKI,o-to-xe-may-xe-dap,118297778,"Bọc yên xe đạp GIANT loại dầy (Chính Hãng)",352800,352800,0,0
TIKI,o-to-xe-may-xe-dap,2430315,"Súc Rửa Động Cơ Xe Máy Liqui Moly 7901 (80ml)",70000,79000,9000,11
TIKI,o-to-xe-may-xe-dap,76106000,"SPRAYKING combo vệ sinh sên , dưỡng sên , dưỡng nhám",139000,139000,0,0
TIKI,o-to-xe-may-xe-dap,1237293,"Chai Xịt Chống Rỉ, Chống Ẩm Bảo Dưỡng WD-40 (191ml)",85000,85000,0,0
TIKI,o-to-xe-may-xe-dap,162592103,"Ắc quy Đèn sạc JP PA 6-4.5 | 6V - 4,5Ah",113000,113000,0,0
TIKI,o-to-xe-may-xe-dap,109015505,"Nón bảo hiểm fullface M138B Thời Trang, Cá tính",760000,760000,0,0
TIKI,o-to-xe-may-xe-dap,176147975,"COMBO Mũ Bảo Hiểm 1/2 Napoli Haley N120 Kèm Kính Phi Công ( 55-58cm) - Bảo hành 12 tháng",231000,299000,68000,23
TIKI,o-to-xe-may-xe-dap,54675284,"Dung dịch vệ sinh buồng lái Michelin Dash & Trim cleaner 31463 - 650ml - Hàng chính hãng",145000,160000,15000,9
TIKI,o-to-xe-may-xe-dap,4697159,"Máy Lọc Không Khí Ô TÔ BONECO P50 màu Trắng Khử mùi thuốc lá hiệu quả - Hàng Nhập Khẩu",2717000,2860000,143000,5
TIKI,o-to-xe-may-xe-dap,89402958,"Xích xe đạp - sên xe đạp - Chất liệu cao cấp",79000,79000,0,0
TIKI,o-to-xe-may-xe-dap,89424377,"Nhớt xe số và xe tay côn Repsol Racing 10W-40",270000,270000,0,0
TIKI,o-to-xe-may-xe-dap,58523167,"Bình Xịt Vệ Sinh Điều Hòa Ô Tô - Flamingo",109000,112000,3000,3
TIKI,o-to-xe-may-xe-dap,5757605,"Mũ bảo Hiểm Royal M139 Kính Âm",530000,700000,170000,24
TIKI,o-to-xe-may-xe-dap,129147873,"Miếng Phản Quang Cảnh Báo Dành Cho Xe Đạp - Xe Đạp Spoke Plsatic Ống Kính Phản Quang Bánh Xe - Vành Phản Xạ Cảnh Báo An Toàn ",15000,15000,0,0
TIKI,o-to-xe-may-xe-dap,54675045,"Dung Dịch Làm Sạch & Bảo Dưỡng Da  Michelin Leather Cleaner 32187-250Ml Hàng Chính Hãng",166000,170000,4000,2
TIKI,o-to-xe-may-xe-dap,34623929,"Kính chiếu hậu Ya Z dành cho các loại xe máy (gương Yaz) BẢO LONG RACING",46000,46000,0,0
TIKI,o-to-xe-may-xe-dap,112866031,"Đèn Xe Đạp Có Còi T6 350lumens (nút chạm cảm ứng) Pin 2000mAh Còi âm thanh lớn 140dB MaiLee",198550,209000,10450,5
TIKI,o-to-xe-may-xe-dap,11506461,"Bơm MICHELIN 4398ml 12266 bơm ô tô, xe hơi mini tự ngắt",1069000,1069000,0,0
TIKI,o-to-xe-may-xe-dap,31609929,"Máy khử mùi, lọc không khí trên xe ô tô cao cấp Philips GP7101 - Hàng chính hãng",3763000,3763000,0,0
TIKI,o-to-xe-may-xe-dap,54719657,"Mũ Bảo Hiểm Trẻ Em 1/2 Đầu Có Kính Họa Tiết Siêu Anh Hùng Marvel CapTain American, An Toàn, Thời Trang, Nhẹ Nhàng, Chắc Chắn Protec Kitty - Hàng Chính Hãng",385000,442000,57000,13
TIKI,o-to-xe-may-xe-dap,143225978,"Giá Đỡ Bình Nước Xe Đạp, Lồng Đựng Chai Nước Gắn Khung Xe Đạp Thể Thao Chắc Chắn",25000,25000,0,0
TIKI,o-to-xe-may-xe-dap,14756331,"Bọc vô lăng ô tô - Bọc vô lăng cao cấp - Bọc vô lăng",57000,71000,14000,20
TIKI,o-to-xe-may-xe-dap,35841278,"Mũ bảo hiểm nửa đầu SUNDA 135D kính râm nhẹ có thể giấu vào trong thân mũ, tác dụng chống tia uv, chống chói, lớp lót mũ tháo giặt, có 4 lỗ thông gió trên mũ, kiểu dáng gọn nhẹ thời trang - hàng chính hãng SUNDA",365000,365000,0,0
TIKI,o-to-xe-may-xe-dap,157146564,"Bao Da Chìa Khóa Dành Cho Xe Ford Ecosport, Focus, Fiesta Da Thật Mẫu Chìa Thông Minh",121600,128000,6400,5
TIKI,o-to-xe-may-xe-dap,275423187,"Khăn lau ô tô chuyên dụng Microfiber 3M 36x36cm",36000,39000,3000,8
TIKI,o-to-xe-may-xe-dap,134362466,"Đèn đuôi nhấp nháy đèn cảnh báo sau cho xe đạp thể thao siêu sáng, chống nước",29000,29000,0,0
TIKI,o-to-xe-may-xe-dap,33279105,"Bao da chìa khóa cao cấp dành cho xe Mitsu Xpander kèm móc khóa mẫu RO",121000,137500,16500,12
TIKI,o-to-xe-may-xe-dap,56720792,"Combo 2 Bóng Đèn Halogen Tăng Sáng 150% OSRAM Night Breaker Laser H4 12V 60/55W",968000,968000,0,0
TIKI,o-to-xe-may-xe-dap,116828251,"Khóa Số Xe Đạp 4 Số Mật Mã Vỏ PVC Bọc Lõi Thép (dạng tròn cứng) (mật khẩu mặc định 0000) Mai Lee",63650,67000,3350,5
TIKI,o-to-xe-may-xe-dap,90836292,"Nón bảo hiểm 3/4 Royal XH 01 cao cấp Lót tháo rời, che hết mặt",389000,389000,0,0
TIKI,o-to-xe-may-xe-dap,139578655,"Nước rửa kính và vệ sinh kính xe ô tô đa năng TH CLEAN can 2.5 Lít",46541,48990,2449,5
TIKI,o-to-xe-may-xe-dap,11949113,"Bọc vô lăng cao cấp ô tô mẫu VL011",83600,88000,4400,5
TIKI,o-to-xe-may-xe-dap,149238728,"Găng tay phượt, găng tay đi xe máy - Hàng chính hãng",56000,60000,4000,7
TIKI,o-to-xe-may-xe-dap,4364449,"Cặp 2 vỏ xe đạp xếp 700x23C không talon SA-205 DELI-TIRE ULTRA FLEX PRO",399000,399000,0,0
TIKI,o-to-xe-may-xe-dap,35895193,"Thảm Lót Sàn Cao Su Theo Dành Cho Ô Tô Toyota Fortuner",694000,788000,94000,12
TIKI,o-to-xe-may-xe-dap,127677589,"Đèn led cảnh báo mở cửa ô tô chống va chạm, gắn cửa xe TÂM LUÂN Chổi lau tẩm dầu - Hàng chính hãng",62000,100000,38000,38
TIKI,o-to-xe-may-xe-dap,146370320,"Bọc khóa smartkey dành cho Honda Airblade AB, Lead, Vision, Vario 150- Bezen Armor",89000,89000,0,0
TIKI,o-to-xe-may-xe-dap,153941683,"Túi da đựng đồ đa năng treo sau ghế Ô tô, Xe hơi – Tích hợp bàn ăn tiện lợi",249000,249000,0,0
TIKI,o-to-xe-may-xe-dap,69218770,"Bọc Vô Lăng Ô Tô Size 38 Bằng Da PU Cao Cấp VERSION 1",90000,95000,5000,5
TIKI,o-to-xe-may-xe-dap,14506990,"Máy bơm lốp  ô tô, xe hơi STEEL MATE cài đặt được thông số bơm, tự ngắt khi đủ áp - Hàng nhập khẩu",435000,435000,0,0
TIKI,o-to-xe-may-xe-dap,176417606,"[Vải Dù Dày Nặng 1kg]Bạt Phủ - Áo Trùm Xe Máy Cao Cấp Vải Dù 2 Mặt Che Nắng, Mưa Giữ Xe Luôn Như Mới Vừa Tất Cả Loại Xe",130000,130000,0,0
TIKI,o-to-xe-may-xe-dap,45188578,"Đèn Led Xe Đạp, Đèn Hậu Cảnh Báo Xe Đạp Gắn Phía Sau Siêu Sáng Có Sạc Điện USB Chống Nước Giúp Đạp Xe An Toàn Ban Đêm 3 Màu Nhiều Chế Độ - Hàng Chính Hãng",110200,116000,5800,5
TIKI,o-to-xe-may-xe-dap,73398588,"Nhớt động có Total Quartz 5000 10W40 (4 lít) - Dầu nhớt Total",379000,379000,0,0
TIKI,o-to-xe-may-xe-dap,83348129,"Nón bảo hiểm 3/4 ROYAL M139 có kính âm V5 TRẮNG",532000,730000,198000,27
TIKI,o-to-xe-may-xe-dap,40567862,"Thảm sàn, lót sàn cao su không mùi Cao cấp dành cho xe Toyota Vios 2014-2019",435100,458000,22900,5
TIKI,o-to-xe-may-xe-dap,178089164,"Chai xịt tẩy rửa hợp kim nhôm, tẩy lốc máy, đầu bò, dàn chân xe máy, xịt sên SprayKing REPAIR 1000ml",65000,65000,0,0
TIKI,o-to-xe-may-xe-dap,24865306,"Mũ bảo hiểm GRS A368K",369000,369000,0,0
TIKI,o-to-xe-may-xe-dap,46578885,"Nước Rửa Xe Không Chạm Đặc Biệt T-rex 80 Ekokemika - (1l) - Hàng Chính Hãng",208000,208000,0,0
TIKI,o-to-xe-may-xe-dap,72640260,"Mắt Kính Xe Đạp Thể Thao Phân Cực Chống Ánh Nắng (5 Mắt Kính) Chống Tia UV Cực Tím Ánh Nắng UV400 (Kèm hộp và phụ kiện, gọng phụ cho kính cận) Đạp Xe, Thể Thao Ngoài Trời, Câu Cá Mai Lee",189050,199000,9950,5
TIKI,o-to-xe-may-xe-dap,72623540,"Nón bảo hiểm 3/4 kính âm Royal M139 Đen vân carbon cao cấp Lót tháo rời, che hết mặt",499000,499000,0,0
TIKI,o-to-xe-may-xe-dap,3587625,"Xà phòng rửa xe 3M can 10L",495000,495000,0,0
TIKI,o-to-xe-may-xe-dap,108925554,"Nón bảo hiểm 3/4 cao cấp Royal M20C Thời trang, Cá tính, Bảo hành chính hãng 12 tháng",550000,550000,0,0
TIKI,o-to-xe-may-xe-dap,119719081,"Ắc quy khô GS GTZ5S 3,5Ah Wave RS Rsx Rsv S, Nouvo456, Airblade110, Hayate X-Bike SKY Exciter Luvias Cub acquy Yuasa",310000,310000,0,0
TIKI,o-to-xe-may-xe-dap,1176295,"Chai Phục Hồi, Làm Mới Nhựa Ngoài Liqui Moly 1552 (250ml)",209000,219000,10000,5
TIKI,o-to-xe-may-xe-dap,73802977,"Giá Bình Nước Xe Đạp Siêu Nhẹ Gắn Khung Cho Xe Đạp Leo Núi, Thể Thao Giá Rẻ Bằng Nhựa Chất Lượng Cao Mai Lee",42655,44900,2245,5
TIKI,o-to-xe-may-xe-dap,135111875,"Bảng ghi số trên ô tô tự động phát sáng khi trời tối, miếng hít dính chắc chắn TÂM LUÂN Chổi lau tẩm dầu - Hàng chính hãng",22000,40000,18000,45
TIKI,o-to-xe-may-xe-dap,1237305,"Chai Xịt Dưỡng Sên Thunder Chain Lube (400ml)",52500,52500,0,0
TIKI,o-to-xe-may-xe-dap,85805399,"Thảm lót sàn ô tô - thảm sàn xe 4-5 chỗ cao su loại 1",263000,263000,0,0
TIKI,o-to-xe-may-xe-dap,48246569,"Búa Thoát Hiểm Thông Minh Chuyên Dụng Cho Ô Tô",105000,105000,0,0
TIKI,o-to-xe-may-xe-dap,158492480,"Nón bảo hiểm nửa đầu Gro ST04 phong cách, màu sắc trẻ trung cho nam nữ,  hai mẫu kính an toàn, thời trang- Hàng chính hãng",245000,335000,90000,27
TIKI,o-to-xe-may-xe-dap,50456405,"Bảng Số Điện Thoại Gắn Taplo Ô Tô Đa Năng ",24000,30890,6890,22
TIKI,o-to-xe-may-xe-dap,130287501,"Chống Xe Đạp Thể Thao - Xe Đạp Đường Phố Soldier - Chất Liệu Nhôm Chắc Chắn - Kiểu Dáng Hiện Đại (tặng kèm lục giác để lắp sản phẩm)",78000,78000,0,0
TIKI,o-to-xe-may-xe-dap,1378123,"Găng Tay Chống Cắt 3M Cấp Độ 5 Cut Resistant Gloves",120000,126000,6000,5
TIKI,o-to-xe-may-xe-dap,206623766,"Thảm lót sàn ô tô KATA cho xe Hyundai Creta (2022-2023) - Khít với sàn xe, Chống trơn, Không mùi, Không ẩm mốc",1990000,1990000,0,0
TIKI,o-to-xe-may-xe-dap,54566742,"Chân chỗng xe đạp - Tặng kèm chuông CC01",64900,64900,0,0
TIKI,o-to-xe-may-xe-dap,111589469,"Nón Bảo Hiểm Trẻ Em Nửa Đầu Protec KITTY, Họa Tiết Nữ Hoàng Băng Giá Elsa xinh xắn, Siêu Thoáng Khí",325000,358000,33000,9
TIKI,o-to-xe-may-xe-dap,58566956,"Bộ bao tay xe máy kiểu Exciter Green Networks Group",55000,55000,0,0
TIKI,o-to-xe-may-xe-dap,58206719,"Chai vá lốp xe khẩn cấp Michelin 92423 / W32699 tặng kèm 1 móc khóa",289000,289000,0,0
TIKI,o-to-xe-may-xe-dap,135798515,"Gối Tựa Lưng Ghế Văn Phòng, Ghế Ô Tô Bằng Cao Su Non Giảm Đau Mỏi Lưng Icaroom",375000,375000,0,0
TIKI,o-to-xe-may-xe-dap,11787164,"Bọc vô lăng cao cấp ô tô mẫu VL012",90250,95000,4750,5
TIKI,o-to-xe-may-xe-dap,78895833,"Đệm lót ghế ô tô hạt gỗ Pơ Mu 100% tự nhiên tựa lưng massage trên ô tô - Dạng Cài Đàn - Kích thước: 1,25x0,46m - Trọng lượng: 2,7Kg - Mã: PM-D",237405,249900,12495,5
TIKI,o-to-xe-may-xe-dap,1176327,"Dầu Bôi Trơn Đa Năng Liqui Moly 3305 (500ml)",122000,127000,5000,4
TIKI,o-to-xe-may-xe-dap,75831153,"Phục hồi nhựa nhám SPRAYKING - Chất lượng cao",50000,50000,0,0
TIKI,o-to-xe-may-xe-dap,53772645,"Nẹp U Lõi Thép Gioăng Cao Su CHữ U Lõi Thép - Nẹp U Viền Cửa Xe Chống Va Đập Cuộn 15m",104000,115000,11000,10
TIKI,o-to-xe-may-xe-dap,74174845,"Khóa xe đạp, xe máy Việt-Tiệp | Mã SP: 07311",78000,78000,0,0
TIKI,o-to-xe-may-xe-dap,52114119,"Bạt Phủ Xe Ô tô 7 chỗ Innova, Bạt Che Xe, Trùm Xe Hơi ",307800,324000,16200,5
TIKI,o-to-xe-may-xe-dap,20531183,"Bọc vô lăng ô tô - Bọc vô lăng ",65000,67000,2000,3
TIKI,o-to-xe-may-xe-dap,111463541,"BAO CHÌA KHÓA CACBON XE MAZDA CX5, MAZDA 3, MAZDA 6",190000,195000,5000,3
TIKI,o-to-xe-may-xe-dap,147975332,"TỰA LƯNG LÓT GHẾ Ô TÔ, XE HƠI HẠT GỖ CHỐNG NÓNG, TRƯỢT VÀ MASSAGE CAO CẤP",243000,284000,41000,14
TIKI,o-to-xe-may-xe-dap,50779989,"Túi Da Xịn Đựng Đăng Kiểm, Giấy Tờ dành cho xe Mazda",25000,25000,0,0
TIKI,o-to-xe-may-xe-dap,10152418,"Giá Đỡ Điện Thoại Gắn Trên Cửa Gió Điều Hòa Ô Tô Baseus SUYL-01",160000,160000,0,0
TIKI,o-to-xe-may-xe-dap,56066025,"Nẹp carbon chống xước bậc lên xuống cửa xe ô tô loại 7cm x 250cm",72000,74000,2000,3
TIKI,o-to-xe-may-xe-dap,126725195,"Combo 2 chai xịt diệt khuẩn khử mùi ô tô, xe hơi Nano Xclean For Car 500ml-Khử mùi Hải Sản, ẩm mốc-Vệ sinh, khử mùi nội thất-Nano Bạc AHT Corp",177000,330000,153000,46
TIKI,o-to-xe-may-xe-dap,145148997,"Xịt dưởng đen bóng lốp ô tô, xe máy can 4.5 lít",169100,178000,8900,5
TIKI,o-to-xe-may-xe-dap,188964502,"Chai xịt diệt khuẩn khử mùi ô tô xe khách bằng nano bạc Nano Reiwa 100ml được chứng nhận viện Pasteur an toàn cho trẻ em - Hàng chính hãng - Sả Chanh",49280,70400,21120,30
TIKI,o-to-xe-may-xe-dap,514210,"Nước Rửa Kính Chống Bám Nước FORMULA 1 - TRF1615807 - 710Ml",160000,185000,25000,14
TIKI,o-to-xe-may-xe-dap,67893019,"Túi treo đồ có khay bàn ăn xếp gọn móc sau ghế ô tô, xe hơi kiểu mẫu hoạt hình dễ thương cho trẻ em- Hàng chính hãng",295000,295000,0,0
TIKI,o-to-xe-may-xe-dap,208212997,"Mũ bảo hiểm lỗ thông gió NÓN SƠN chính hãng TG-XM151",324000,650000,326000,50
TIKI,o-to-xe-may-xe-dap,2185043,"Nón Bảo Hiểm Giro Isode",1100000,1100000,0,0
TIKI,o-to-xe-may-xe-dap,171695667,"Hộp Tỳ Tay Theo Xe Grand I10 cao cấp loại 1 - dùng cả bản hatchback và sedan",365750,385000,19250,5
TIKI,o-to-xe-may-xe-dap,26425278,"Mỡ bò xịt khô Wurth HHS Drylube 400ml 08931066 Adhesive Lubricant HHS Drylube",291000,291000,0,0
TIKI,o-to-xe-may-xe-dap,54626236,"Dầu nhớt Mobil 5W30 EP 946ml - Chính hãng Mobil nhập khẩu từ Mỹ",295000,295000,0,0
TIKI,o-to-xe-may-xe-dap,31843672,"Dầu Bôi Trơn Chống Rỉ Sét Làm Sạch Thẩm Thấu Chống Ẩm Bảo Vệ WD-40 (300ml)",100000,100000,0,0
TIKI,o-to-xe-may-xe-dap,52110803,"Phụ gia nhớt súc rửa động cơ cao cấp Liqui Moly 2427 - Tặng kèm 1 khăn lau chuyên dụng 3M",249000,249000,0,0
TIKI,o-to-xe-may-xe-dap,154173062,"Lót cốp dành cho xe Honda City 2021 không mùi, chất liệu TPO cao cấp",307000,315000,8000,3
TIKI,o-to-xe-may-xe-dap,54056877,"Nón bảo hiểm 3/4 Bulldog Perro 4U cao cấp Chính hãng, Lót tháo rời, Tặng khóa số chống trộm, túi xách và balo rút Bulldog",899000,899000,0,0
TIKI,o-to-xe-may-xe-dap,124605012,"Phụ Gia Tăng Chỉ Số Octan cho Xăng Bluechem Octane Booster 250ml",245000,245000,0,0
TIKI,o-to-xe-may-xe-dap,178089418,"Sprayking Super Wash 1L nước rửa xe tạo bọt tuyết, xà phòng rửa xe siêu sáng bóng ",69000,69000,0,0
TIKI,o-to-xe-may-xe-dap,75982771,"Bộ gù chống đổ Trước Sau xe máy - Combo Gù chống đổ Trước và Gù chống đổ Sau Green Networks Group",159000,159000,0,0
TIKI,o-to-xe-may-xe-dap,96615231,"Bơm xe đạp xe máy 180psi/12kg GIYO 2730 thân thép đồng hồ siêu to",440000,440000,0,0
TIKI,o-to-xe-may-xe-dap,127123702,"Mỡ Bò Chống Nước Maxima WaterProof Grease 454g Đa Năng Chịu Nhiệt Độ Và Áp Suất Cao",280000,280000,0,0
TIKI,o-to-xe-may-xe-dap,83347924,"Kính thẳng gắn nón bảo hiểm 3/4 Royal có 3 nút bấm",130000,325000,195000,60
TIKI,o-to-xe-may-xe-dap,83347244,"Nón bảo hiểm 3/4 ROYAL M139 có kính âm màu ĐỎ ĐÔ",530000,700000,170000,24
TIKI,o-to-xe-may-xe-dap,18003631,"Thùng, hộp đựng đồ co giãn trên Ô tô, Xe hơi - thể tích 40L",320000,320000,0,0
TIKI,o-to-xe-may-xe-dap,801326,"Máy Lọc Không Khí Cho Xe Hơi Sharp IG-GC2E-B - Đen - Hàng chính hãng",2109000,2190000,81000,4
TIKI,o-to-xe-may-xe-dap,10713827,"Túi Đựng Đồ Cốp Sau Ô Tô DC-TDD – Hàng Nhập Khẩu",125000,125000,0,0
TIKI,o-to-xe-may-xe-dap,29568534,"Cần số 2 chiều gắn xe Winner X BẢO LONG RACING",75000,75000,0,0
TIKI,o-to-xe-may-xe-dap,13850031,"Thùng Đựng Đồ Co Giãn 40L Cho Ô Tô - Thùng đựng đồ co giãn cho xe ô tô",310000,318000,8000,3
TIKI,o-to-xe-may-xe-dap,93027827,"Nước làm mát Prestone Honda AF6300 - Nước làm mát Prestone nhập khẩu từ Mỹ",459000,459000,0,0
TIKI,o-to-xe-may-xe-dap,195249283,"Meguiar's Xịt khử mùi, diệt khuẩn nội thất xe hơi Mùi hương nam tính - Air Refesher - Black Chrome Scent - G181302, 57 g",410000,410000,0,0
TIKI,o-to-xe-may-xe-dap,84882531,"Nón Bảo Hiểm Xe Đạp Có Kính Protec Win 018, Mũ Bảo Hiểm Xe Đạp Tiêu Chuẩn Châu Âu, Kính Mát, Chống Nắng, Chống Tia UV - Hàng Chính Hãng",495000,568000,73000,13
TIKI,o-to-xe-may-xe-dap,104799820,"Chai xịt bảo dưỡng cao su, ron cửa và lốp xe ô tô nhãn hiệu Sonax 340200 dung tích 300 ml - Hàng Chính Hãng",252000,252000,0,0
TIKI,o-to-xe-may-xe-dap,14563208,"Nón bảo hiểm ¾ GRS A318K kính dài",580000,580000,0,0
TIKI,o-to-xe-may-xe-dap,50226569,"Dung dịch nano bảo vệ động cơ xe máy BLUECHEM BC33047",105000,105000,0,0
TIKI,o-to-xe-may-xe-dap,1176233,"Bình Súc Béc Xăng Liqui Moly 1803 (300ml)",165000,169000,4000,2
TIKI,o-to-xe-may-xe-dap,102057427,"Bọc vô lăng TTAUTO cho xe ô tô từ 4 đến 7 chỗ chất liệu da vân carbon cao cấp có logo MITSUBISHI (Đen)",250000,250000,0,0
TIKI,o-to-xe-may-xe-dap,119719000,"Sạc Ắc Quy Tự Động AST 10A 12V, Bộ sạc bình ắc quy từ 3ah - 200ah, sạc bình ắc quy cho xe máy đến ô tô",1181000,1181000,0,0
TIKI,o-to-xe-may-xe-dap,83346764,"Nón bảo hiểm 3/4 ROYAL M139 có kính âm V10 TRẮNG",550000,730000,180000,25
TIKI,o-to-xe-may-xe-dap,85804603,"Bạt Che Phủ Xe Ô Tô Cao Cấp 3 Lớp Chống Nắng Nóng Chống Nước Chống xước",273000,334500,61500,18
TIKI,o-to-xe-may-xe-dap,115079434,"Lót cốp dành cho xe  Mazda CX-5 2018-2021 không mùi, chất liệu TPO cao cấp",317300,334000,16700,5
TIKI,o-to-xe-may-xe-dap,190463822,"Săm Ruột Xe Đạp 20x1.75 (47 - 406) CASUMINA",59000,59000,0,0
TIKI,o-to-xe-may-xe-dap,92552880,"Phụ Gia Dầu VOLTRONIC D12 DIESEL MULTIREINIGER (300ml) - Hàng Chính Hãng",333000,333000,0,0
TIKI,o-to-xe-may-xe-dap,41230340,"RÈM CHE NẮNG KÍNH LÁI XE Ô TÔ TỰ CUỐN CAO CẤP",121000,121000,0,0
TIKI,o-to-xe-may-xe-dap,52614788,"Khóa u siêu chống cắt chính hãng ABUS - CHLB Đức tặng khóa tủ cá nhân",455000,519000,64000,12
TIKI,o-to-xe-may-xe-dap,49543118,"Phủ Nano Kính Ô Tô Đa Năng Glaco Blave G-100 Soft99 Japan",179250,239000,59750,25
TIKI,o-to-xe-may-xe-dap,31962521,"Thảm sàn, lót sàn cao su 3D không mùi Cao cấp dành cho xe Ford Everest 2016-2019",668000,685000,17000,2
TIKI,o-to-xe-may-xe-dap,31139580,"Gạt mưa Bosch Advantage Chevrolet Cruze 24" - 18" (Đen)",251000,251000,0,0
TIKI,o-to-xe-may-xe-dap,65466769,"Gía đỡ điện thoại gắn taplo hoặc kính lái ô tô nhãn hiệu Baseus SUYL-JY01 - Khóa, mở tự động",317000,325000,8000,2
TIKI,o-to-xe-may-xe-dap,41507312,"Chai xịt bảo dưỡng lốp ô tô 3M 39042LT tăng khăn lau ô tô chuyên dụng 3M màu ngẫu nhiên",215000,215000,0,0
TIKI,o-to-xe-may-xe-dap,24453956,"Bảng số điện thoại gắn táp lô ô tô kiêm giá để điện thoại (Màu ngẫu nhiên)",17000,17000,0,0
TIKI,o-to-xe-may-xe-dap,153941018,"Thảm sàn, lót sàn cao su 3D cho Hyundai Santafe 2019",605000,688000,83000,12
TIKI,o-to-xe-may-xe-dap,1237155,"Nhớt Hộp Số Liqui Moly 80W90 (150ml)",141000,145000,4000,3
TIKI,o-to-xe-may-xe-dap,109023254,"Đệm Gel Lót Ghế Văn Phòng, Lót yên xe máy xe ô tô Thoáng Khí Siêu mềm",195000,195000,0,0
TIKI,o-to-xe-may-xe-dap,35372429,"Cảng sau civi cho Wave A 100,WAVE A 110,WINNER,EXCITER 135,EXCITER 150,AXELO,WAVE BLADE,WAVE S110,SIRIUS BẢO LONG RACING",105000,105000,0,0
TIKI,o-to-xe-may-xe-dap,24085827,"Túi Da Xịn Đựng Đăng Kiểm, Giấy Tờ Cho Ô tô logo Hyundai",25000,25000,0,0
TIKI,o-to-xe-may-xe-dap,23354943,"ĐÁNH BÓNG BƯỚC 3 CAO CẤP 3M 06068 PERFECT-IT EX ULTRAFINE MACHINE POLISH, 1 QUART (946ML)",620000,620000,0,0
TIKI,o-to-xe-may-xe-dap,126097513,"Lót cốp nhựa ô tô cho dòng xe mazda 3D CX5 2019+",304950,321000,16050,5
TIKI,o-to-xe-may-xe-dap,122830493,"Bộ 4 miếng cao su dán cánh cửa xe Chống va đập Logo SPORT",77000,79000,2000,3
TIKI,o-to-xe-may-xe-dap,51574367,"Keo vá lốp (Super Valkarn) thương hiệu Maruni - Nhật Bản (lọ 200cc)",200000,200000,0,0
TIKI,o-to-xe-may-xe-dap,172068762,"Thảm taplo ô tô để đồ đa năng chống trượt kiêm giá đỡ và bảng ghi số điện thoại mẫu mới loại tốt siêu đẹp",70000,70000,0,0
TIKI,o-to-xe-may-xe-dap,1176131,"Nhớt Xe Máy 4T Synth 10W50 Race Liqui Moly 1502 (1L)",330000,330000,0,0
TIKI,o-to-xe-may-xe-dap,55323617,"Mũ Bảo Hiểm Trẻ Em 1/2 Đầu Có Kính Protec Kitty Họa Tiết Nữ Hoàng Băng Giá Frozen Thời Trang, An Toàn, Chất Lượng - Hàng Chính Hãng - Màu Xanh",385000,442000,57000,13
TIKI,o-to-xe-may-xe-dap,12289770,"Bộ chia tẩu sạc Huyndai HY-29",155000,155000,0,0
TIKI,o-to-xe-may-xe-dap,4280917,"Bàn chải vệ sinh sên xe máy Cao cấp 3D",25000,25000,0,0
TIKI,o-to-xe-may-xe-dap,36278697,"Nước Rửa Kính ô Tô Xuất Xứ Châu Âu Xglass Hương Bạc Hà (3.2l) - Hàng Chính Hãng",145000,145000,0,0
TIKI,o-to-xe-may-xe-dap,97979802,"Bọc da vô lăng ô tô thể thao loại tốt bám tay thiết kế đẹp mắt phù hợp các loại xe phổ thông",122000,128690,6690,5
TIKI,o-to-xe-may-xe-dap,32322882,"Bộ chia tẩu sạc ô tô USB Huyndai HY36 loại tốt - Hàng nhập khẩu",71000,81000,10000,12
TIKI,o-to-xe-may-xe-dap,57109174,"Mỡ cao cấp Mobilgrease XHP 222 - nhập khẩu từ Mỹ",139000,139000,0,0
TIKI,o-to-xe-may-xe-dap,142904077,"DUNG DỊCH VỆ SINH NỘI THẤT Ô TÔ H25 (5 Lit)",369000,379000,10000,3
TIKI,o-to-xe-may-xe-dap,70838439,"Combo đèn led trước sau cho xe đạp Jett Blazers",199000,199000,0,0
TIKI,o-to-xe-may-xe-dap,114744998,"Combo 2 Lưỡi Gạt Mưa Loại A VIAIR R15 (22 Inch/550 mm)",71000,83000,12000,14
TIKI,o-to-xe-may-xe-dap,5483523,"Xịt khử mùi xe hơi Sonax SmokeEx 292241 500ml",220000,220000,0,0
TIKI,o-to-xe-may-xe-dap,1254755,"Chai Xịt Tẩy Gỉ Sét, Bôi Trơn Đa Năng Liqui Moly Multi-Spray Plus 7 3305 (500ml)",128000,155000,27000,17
TIKI,o-to-xe-may-xe-dap,69611729,"Cuộn Phản Quang 2 Màu Đỏ Trắng Bóc Dán Cho Xe Tải, Xe Container, Xe Hơi, Xe Ô tô Dài 45 Mét/ Cuộn Giúp An Toàn Ban Đêm Mai Lee",170050,179000,8950,5
TIKI,o-to-xe-may-xe-dap,62747178,"Mũ Bảo Hiểm Nửa Đầu Có Kính Cao Cấp Protec Hiway Họa Tiết Đen Xanh Tem Hình COOL Ngầu (Mẫu Mới) - Hàng Chính Hãng",375000,498000,123000,25
TIKI,o-to-xe-may-xe-dap,151681304,"Bạt trùm che phủ xe ô tô Toyota Corolla Cross Cao Cấp 3 Lớp Chống Nắng Nóng Chống Nước Chống xước",242250,255000,12750,5
TIKI,o-to-xe-may-xe-dap,71549306,"Khăn Lau Xe Ô Tô Đa Năng Cỡ Đại Siêu Thấm Kích Thước 30cm x 40cm, Khăn Lau Đa Năng Chất Liệu Microfiber Chính Hãng miDoctor",37000,50000,13000,26
TIKI,o-to-xe-may-xe-dap,38993920,"Thảm lót sàn ô tô T25.3 50x150 cm, Thảm Lót Cốp Ô Tô",121000,134000,13000,10
TIKI,o-to-xe-may-xe-dap,128543422,"Giá Đỡ Bình Nước Xe Đạp Siêu Bền",19000,19000,0,0
TIKI,o-to-xe-may-xe-dap,10007167,"Chai dưỡng sên, xịt sên Liqui Moly 1508 250ml",212000,212000,0,0
TIKI,o-to-xe-may-xe-dap,117927078,"BIOION AIR SANITIZER AEROSOL REFILL - Bình Xịt Khử Khuẩn, Khử Mùi (Dùng cho máy xịt tự động RX900) 250ML",125000,125000,0,0
TIKI,o-to-xe-may-xe-dap,180292386,"Máy bơm lốp ô tô xe máy cao cấp FIXTEC FATG0001 có đồng hồ đo áp suất, dùng cho máy nén khí",189000,189000,0,0
TIKI,o-to-xe-may-xe-dap,124385409,"Vè Che Mưa Ô Tô SUZUKI XL7 Ertiga Chỉ Inox ",358000,367000,9000,2
TIKI,o-to-xe-may-xe-dap,19899873,"Bộ Rèm Chắn Nắng Nam Châm dành cho xe KIA Morning 2012-2019",253000,259700,6700,3
TIKI,o-to-xe-may-xe-dap,113352117,"Nước Hoa Ô Tô Cao Cấp Etonner E1801D 60ml thiết kế để taplo xe sang trọng, phù hợp với nhiều dòng xe.",980000,980000,0,0
TIKI,o-to-xe-may-xe-dap,75709451,"Dưỡng bóng dàn áo ,kim loại MEGACOOLS SiO2 Slick WAX 250ml, dễ sử dụng, an toàn, hiệu quả cao",104000,104000,0,0
TIKI,o-to-xe-may-xe-dap,116057963,"Thảm Taplo Da Carbon xe Mitsu Xpander 2018 2019 2020 cao cấp",261000,268000,7000,3
TIKI,o-to-xe-may-xe-dap,27883304,"Quạt Đôi Mini 12V Xoay 360 Dành Cho Xe Ô Tô",89000,89000,0,0
TIKI,o-to-xe-may-xe-dap,95306007,"Xe đạp địa hình Thống Nhất MTB 24-04 - Hàng chính hãng - Màu",3217500,3250000,32500,1
TIKI,o-to-xe-may-xe-dap,8134255,"Xe Máy Yamaha NVX 155 - Phiên Bản DOXOU",51700000,51700000,0,0
TIKI,o-to-xe-may-xe-dap,102511519,"Giá đỡ điện thoại hút chân không gắn kính hoặc táp lô ô tô Baseus SUYL-TK01 Tank gravity car mount holder with suction base - Hàng chính hãng",351000,360000,9000,3
TIKI,o-to-xe-may-xe-dap,57986998,"Nhớt Động Cơ Xe Máy Fuchs Silkolene 10W40 JASO MA2 API SM&SN 1 Lít",270000,270000,0,0
TIKI,o-to-xe-may-xe-dap,157936018,"XE ĐẠP THỂ THAO FORNIX FR307",3217000,3217000,0,0
TIKI,o-to-xe-may-xe-dap,183313404,"Xe Ga 50cc DK Roma SX",23900000,23900000,0,0
TIKI,o-to-xe-may-xe-dap,177301126,"Nẹp bước chân trong TITAN ô tô Vinfast Lux A 2.0 2020-2021-2022 chống trầy bảo vệ trang trí xe",288000,288000,0,0
TIKI,o-to-xe-may-xe-dap,43177224,"Xe Đạp Điện Osakar Star",13500000,13500000,0,0
TIKI,o-to-xe-may-xe-dap,113125263,"Xe đạp thể thao Thống Nhất MTB24-03 (Phù hợp với người cao từ 1m40 đến 1m55)",2366100,2390000,23900,1
TIKI,o-to-xe-may-xe-dap,186162539,"Thảm taplo cho Transit 2014-2015-2016-2017-2018-2019-2020-2021-2022 chống nắng nóng làm mát xe mở rộng tầm nhìn",195000,195000,0,0
TIKI,o-to-xe-may-xe-dap,1510677,"Chai Vá Lốp Xe Khẩn Cấp Michelin 92423 (500ml)",259000,259000,0,0
TIKI,o-to-xe-may-xe-dap,162581887,"Máy bơm lốp ô tô Tâm Luân động cơ DÂY ĐỒNG, chip chống quả tải và ngắn mạch, máy bơm lốp xe ô tô công suất 120w, máy bơm ô tô 12V",175000,300000,125000,42
TIKI,o-to-xe-may-xe-dap,117221161,"Xe đạp Thống Nhất GN06-26 - Hàng chính hãng",2168100,2190000,21900,1
TIKI,o-to-xe-may-xe-dap,1254595,"Chai Xịt Chăm Sóc Da, Nội Thất Ô Tô- 3M Leather & Vinyl Restorer PN39040 (473ml) - Đen",310000,310000,0,0
TIKI,o-to-xe-may-xe-dap,23291784,"Súng bơm lốp xe ô tô dùng khí Total TAT11601",186000,186000,0,0
TIKI,o-to-xe-may-xe-dap,174134202,"Xe đạp địa hình Thống Nhất SLX 27,05-1 - Hàng chính Hãng (Kèm khóa dây mã số và chắn bùn trước sau)",6682500,6750000,67500,1
TIKI,o-to-xe-may-xe-dap,274362517,"Bình Ắc quy khô GS GTZ5S E 3,5Ah, GTZ5S-H 4AH Wave RS Rsx Rsv S, Nouvo456, Airblade110, Hayate X-Bike SKY Exciter Luvias Cub",290000,290000,0,0
TIKI,o-to-xe-may-xe-dap,118298199,"Xe đạp đường phố Giant Ineed Latte 2021",10300000,10300000,0,0
TIKI,o-to-xe-may-xe-dap,162590572,"Ắc quy khô miễn bảo dưỡng Đồng Nai PTZ6HL | 12V - 6Ah",262000,262000,0,0
TIKI,o-to-xe-may-xe-dap,274608436,"Miếng Đệm Hạt Gỗ PaKaSa Massage Ghế Ô TÔ , Xe Hơi , Ghế Văn Phòng KT 45 x 45 cm - Chính Hãng",154700,228000,73300,32
TIKI,o-to-xe-may-xe-dap,134368319,"Xe Máy Điện YADEA M6I",17990000,17990000,0,0
TIKI,o-to-xe-may-xe-dap,86284720,"Xe đạp thể thao khung nhôm 27,5" 21 speed",3695500,3890000,194500,5
TIKI,o-to-xe-may-xe-dap,98678475,"Xe đạp địa hình Thống Nhất trẻ em MTB 20-04 (Dành cho bé từ 5 đến 10 tuổi) - Hàng chính hãng",2573010,2599000,25990,1
TIKI,o-to-xe-may-xe-dap,191356034,"Xe Đạp Thể Thao Gấp Gọn FS Bike NS-001 Vành 26inch 24 Tốc Độ Nhập Khẩu Đại Nam Sport + Tặng Mũ Bảo Hiểm,Khóa Chống Trộm Và Chắn Bùn",4925000,5000000,75000,2
TIKI,o-to-xe-may-xe-dap,113674535,"Combo Nhớt Liqui Moly 10W-40 Scooter MB Formula 800ML+ Hộp số liqui 150ML  dành cho xe ga",345000,345000,0,0
TIKI,o-to-xe-may-xe-dap,173539685,"Xe Ga 50CC Roma SX",21000000,21000000,0,0
TIKI,o-to-xe-may-xe-dap,52987923,"Bộ 2 Bọc Cầm Tay Lái Xe Đạp Cao Su Chống Trơn Trượt (phi 2.2 cm) Dễ Dàng Lắp Đặt Cho Xe Đạp Địa Hình Mai Lee",110770,116600,5830,5
TIKI,o-to-xe-may-xe-dap,7923502,"Lốp Xe Máy 80/90-17 Không Ruột",360000,360000,0,0
TIKI,o-to-xe-may-xe-dap,55709275,"Kính chắn gió mũ bảo hiểm Sunda",89000,89000,0,0
TIKI,o-to-xe-may-xe-dap,136191331,"Nhớt Xe Số Motul 3100 Gold 4t 10w40 20x0.8l Vn",119000,119000,0,0
TIKI,o-to-xe-may-xe-dap,74643387,"Đèn led Bi cầu H4 Mini siêu sáng cos vàng pha trắng (loại rẻ , không BH ) Green Networks Group",89000,89000,0,0
TIKI,o-to-xe-may-xe-dap,8315863,"Mũ Bảo Hiểm Nửa Đầu GRS A760K",341000,359000,18000,5
TIKI,o-to-xe-may-xe-dap,137672159,"Keo dán đa năng Scotch 3M siêu dính, siêu bền, keo trong suốt tính thẩm mỹ cao, keo loãng mau khô, dễ sử dụng AD113",30000,35000,5000,14
TIKI,o-to-xe-may-xe-dap,117798789,"MŨ BẢO HIỂM 1/2 ĐEN THỜI TRANG, AN TOÀN, PHONG CÁCH B'COLOR KÍNH PHI CÔNG",179000,300000,121000,40
TIKI,o-to-xe-may-xe-dap,108883595,"Đèn xi nhan LED T10 đúc sứ - xi nhan demi cho xe máy T10 6 Led ( 6smd 3030 ) DC 12V Green Networks Group ( 1 Đèn )",25000,25000,0,0
TIKI,o-to-xe-may-xe-dap,47301111,"BÌNH TẠO BỌT TUYẾT CẦM TAY EPOCA TEC TWO 2000ml  MADE IN ITALY",579000,579000,0,0
TIKI,o-to-xe-may-xe-dap,168067539,"Mũ bảo hiểm nửa đầu RONA hali viền bạc chính hãng, nón bảo hiểm freesize cho nam và nữ",123500,200000,76500,38
TIKI,o-to-xe-may-xe-dap,6651669,"Mũ bảo hiểm 3/4 đầu Napoli SH1 trắng lót hồng Freesize 55-58 cm - Bảo Hành 12 tháng",265000,359000,94000,26
TIKI,o-to-xe-may-xe-dap,895815,"Thùng Bold Givi B32N (32L) - Tặng Đế MP60N ",1280000,1280000,0,0
TIKI,o-to-xe-may-xe-dap,58554413,"Khoá phanh đĩa Việt-Tiệp | Mã SP: 06972",149500,149500,0,0
TIKI,o-to-xe-may-xe-dap,119719101,"Ắc quy khô GLOBE WP5-6 6V-5AH Bình ắc quy khô 6v cho xe điện trẻ em ,đèn khẩn cấp,quạt sạc",140000,140000,0,0
TIKI,o-to-xe-may-xe-dap,147763773,"Tay nắm xe đạp thể thao Kiotool có sừng chống mỏi , trơn tay",75000,75000,0,0
TIKI,o-to-xe-may-xe-dap,118297628,"Xe đạp thể thao nữ GIANT LIV ALIGHT 2 2021",10050000,10050000,0,0
TIKI,o-to-xe-may-xe-dap,60149147,"Áo Mưa Bộ Givi PRS04 Vàng Neon Hàng Chính Hãng",1874000,1874000,0,0
TIKI,o-to-xe-may-xe-dap,8148607,"Quần đệm đạp xe Jett UnderAlls",525000,525000,0,0
TIKI,o-to-xe-may-xe-dap,172167206,"vệ sinh kim phun xăng Senfineco 9986",190000,190000,0,0
TIKI,o-to-xe-may-xe-dap,91297584,"Bộ dụng cụ sửa xe đạp mini đa dụng Crankbrothers M17 multi-tools",799000,799000,0,0
TIKI,o-to-xe-may-xe-dap,10007194,"Chai dưỡng sên, xịt sên liqui 1591 400mL",275000,275000,0,0
TIKI,o-to-xe-may-xe-dap,23485532,"Mũ bảo hiểm nam nữ nửa đầu Sunda 136 cao cấp có kính âm nhiều màu",275000,275000,0,0
TIKI,o-to-xe-may-xe-dap,197264187,"Gạt mưa ô tô silicon Tâm Luân, KHÔNG XƯƠNG - Thân mềm, gạt sạch - không tiếng ồn - độ bền cao - không bị oxi hoá, độ bền lên đến 10 năm",67000,100000,33000,33
TIKI,o-to-xe-may-xe-dap,172948836,"BỘ CHẮN BÙN SAU EXCITER 155",199000,199000,0,0
TIKI,o-to-xe-may-xe-dap,55059741,"Ắc quy Vision CP1270 12V 7Ah",339200,339200,0,0
TIKI,o-to-xe-may-xe-dap,89877588,"Bộ 2 Thanh Nạy Móc Lốp Xe Đạp Giúp Vá Lốp Săm Xe Đạp Chất Liệu Thép Không Gỉ (dài 12cm) MaiLee",25650,27000,1350,5
TIKI,o-to-xe-may-xe-dap,3261751,"Mũ bảo hiểm nửa đầu GRS A966K - 2 Lớp kính - Tháo được lót",459000,459000,0,0
TIKI,o-to-xe-may-xe-dap,194372826,"THANH GIỮ ỐNG PHANH",126655,126655,0,0
TIKI,o-to-xe-may-xe-dap,142871128,"Bộ vá xe bằng tay nhanh cho vỏ không ruột STOP&GO 1000 nhập khẩu Mỹ",900000,900000,0,0
TIKI,o-to-xe-may-xe-dap,33392037,"Phuộc BULL FIRE 2 lò xo dành cho Wave,Dream BẢO LONG RACING",365000,365000,0,0
TIKI,o-to-xe-may-xe-dap,72749902,"Kính chiếu hậu dành cho dòng xe Air Blade 2016-2019 Green Networks Group ( 1 Cặp )",99000,99000,0,0
TIKI,o-to-xe-may-xe-dap,109310799,"Đèn xi nhan demi thủy tinh T10 12V ô tô xe máy Green Networks Group ( 1 Cái )",15000,15000,0,0
TIKI,o-to-xe-may-xe-dap,68565448,"Đèn đuôi nhấp nháy đèn cảnh báo sau cho xe đạp thể thao màu đỏ A02 siêu sáng, chống nước, thời gian sáng lên đến 200h Mai Lee",135850,143000,7150,5
TIKI,o-to-xe-may-xe-dap,136187531,"RÈM CHE NẮNG NAM CHÂM CHO XE TOYOTA CROSS.",224000,248000,24000,10
TIKI,o-to-xe-may-xe-dap,48039658,"CHÚ CHÓ ĐEN TRẮNG THAN HOẠT TÍNH KHỬ MÙI & TRANG TRÍ TAPLO Ô TÔ LOẠI LỚN 28CM X 21CM",212000,229000,17000,7
TIKI,o-to-xe-may-xe-dap,202329754,"Bình Ắc Quy Khô WTZ5S 12V,4.2Ah/WTD 4V,3.5Ah hiệu GLOBE Cho Xe WAVE RS100/ WAVE RS 110/ AIRBLADE/ EXCITER 135",250000,250000,0,0
TIKI,o-to-xe-may-xe-dap,54784099,"Chai xịt làm sạch và bảo dưỡng nhựa trong và ngoài xe Sonax 380041 dung tích 300ml",200000,200000,0,0
TIKI,o-to-xe-may-xe-dap,10397229,"Dung Dịch Rửa Xe Không Chạm Ekokemika Bio 35 (5L) - Hàng Chính Hãng",855000,855000,0,0
TIKI,o-to-xe-may-xe-dap,192398261,"Gương cầu lồi ô tô dán trên gương chiếu hậu tăng góc nhìn chống nước - Gương mini chống điểm mù oto xe hơi, Gương Cầu Lồi Ô Tô Xe Hơi Chiếu Hậu Chống Điểm Mù Cho Xe",35000,35000,0,0
TIKI,o-to-xe-may-xe-dap,114745004,"Combo 2 Lưỡi Gạt Mưa Loại A VIAIR R15 (16 Inch/400 mm)",56000,66000,10000,15
TIKI,o-to-xe-may-xe-dap,7543321,"Mũ Bảo Hiểm 3/4 Đầu Royal M139 Design",550000,730000,180000,25
TIKI,o-to-xe-may-xe-dap,128710000,"Chuông Xe Đạp Kim Loại Âm Thanh Lớn Lắp Mọi Dòng Xe",59000,59000,0,0
TIKI,o-to-xe-may-xe-dap,1229357,"Mũ Bảo Hiểm Phong Cách Thể Thao Kính Gương Asia M115 KK",320000,320000,0,0
TIKI,o-to-xe-may-xe-dap,191444540,"Xe đạp thời trang nữ Giant Momentum Ineed Latte 24/26 2023",10950000,10950000,0,0
TIKI,o-to-xe-may-xe-dap,119719091,"Bình ắc quy khô cho xe máy Dream, Wave, Future, Sirius, Jupiter, Taurus, Mio GS GT6A (12V - 6AH)",330000,330000,0,0
TIKI,o-to-xe-may-xe-dap,2453873,"Chai xịt dưỡng sên/xích Repsol 400ml",144000,144000,0,0
TIKI,o-to-xe-may-xe-dap,78971181,"Combo dưỡng sên chống văng Megacools Chain Lube Ultra MOLY WAX 300ml +vệ sinh sên 500ml Penetrate tặng bàn chải chải",169000,169000,0,0
TIKI,o-to-xe-may-xe-dap,23427653,"Dây Câu Bình Ắc Quy Ô Tô 2000A Dài 4M",125000,125000,0,0
TIKI,o-to-xe-may-xe-dap,54814572,"Móc treo đồ đa năng, giá đỡ điện thoại gắn lưng ghế ô tô",40000,45000,5000,11
TIKI,o-to-xe-may-xe-dap,118299286,"Xe đạp GIANT ESCAPE 1 2022",13150000,13150000,0,0
TIKI,o-to-xe-may-xe-dap,155282733,"Nhớt Xe Ga Motul Scooter Power 5W40 MB Chai 800ml Chính Hãng",165000,165000,0,0
TIKI,o-to-xe-may-xe-dap,195918317,"Xịt Rửa Sên Voltronic IX69 800ML",210000,210000,0,0
TIKI,o-to-xe-may-xe-dap,22210236,"Bộ dụng cụ sửa chữa xe đạp mini 15 in 1 đa năng tiện lợi Mai Lee - Hàng chính hãng",37050,39000,1950,5
TIKI,o-to-xe-may-xe-dap,69246611,"Bơm Xe Đạp Mini Treo Xe Gắn Khung Sườn Có Đế Gắn Sử Dụng Khẩn Cấp 120Psi 8 Bar Siêu Nhẹ Xy Lanh Lõi Nhôm (Kèm 2 Đầu Bơm) Mai Lee",80275,84500,4225,5
TIKI,o-to-xe-may-xe-dap,162250600,"Ắc quy khô miễn bảo dưỡng Đồng Nai PTZ6L ISS dành cho xe có Idling Stop | 12V - 6Ah",304000,304000,0,0
TIKI,o-to-xe-may-xe-dap,172949797,"MŨ BH 1/2 KIỂU 2 FREE SIZE",507600,507600,0,0
TIKI,o-to-xe-may-xe-dap,135572233,"Máy khử mùi, lọc không khí dạng cốc trên xe ô tô Philips GP3601 công nghê SaniFiler Plus - HÀNG NHẬP KHẨU",1913000,1913000,0,0
TIKI,o-to-xe-may-xe-dap,177134832,"Máy Hút Bụi Cầm Tay Không Dây Đa Năng, Lực Hút 9000Pa, Pin 4000 mAh, Máy Hút Bụi Giường Nệm, Ô Tô, Máy Tính - HÀNG CHÍNH HÃNG",299000,299000,0,0
TIKI,o-to-xe-may-xe-dap,58213358,"CẦN GẠT MƯA 3 KHÚC Ô TÔ CAO CẤP DENSO JANPAN",260000,260000,0,0
TIKI,o-to-xe-may-xe-dap,72841292,"Bộ tay thắng tay côn 6 số kèm bao tay xe máy gù pha lê cho xe Winner 150 Green Networks Group",199000,199000,0,0
TIKI,o-to-xe-may-xe-dap,52123157,"Chai xịt chống chuột, đuổi chuột Liqui Moly 1515 - Tặng kèm 1 khăn lau chuyên dụng 3M (màu ngẫu nhiên)",198000,198000,0,0
TIKI,o-to-xe-may-xe-dap,232014,"Mũ Bảo Hiểm Nửa Đầu Có Kính GRS A737K Nhám",279000,279000,0,0
TIKI,o-to-xe-may-xe-dap,170065040,"Nón Thể Thao POC 01 FREESIZE Đủ Màu",850000,850000,0,0
TIKI,o-to-xe-may-xe-dap,2050471,"Băng keo cường lực 3M siêu dính 4229P-12 12mm x10m",70000,136000,66000,49
TIKI,o-to-xe-may-xe-dap,11423248,"Bao da chìa khóa xe Hyundai Tucson, Elantra, I10 bản chìa thông minh - kèm móc khóa",115000,118000,3000,3
TIKI,o-to-xe-may-xe-dap,13645371,"Mũ bảo hiểm nửa đầu Protec Rosa không kính RLW - Hàng Chính Hãng",235000,245000,10000,4
TIKI,o-to-xe-may-xe-dap,99350747,"Bộ kích nô acquy kiêm sạc dự phòng 12000mAh Baseus CRJS03-01 - HÀNG CHÍNH HÃNG ",1224699,1224699,0,0
TIKI,o-to-xe-may-xe-dap,2089717,"Mũ Bảo Hiểm Royal Fullface M136 - Đen Nhám (Size",349000,349000,0,0
TIKI,o-to-xe-may-xe-dap,12042205,"Máy khử mùi, lọc không khí trên xe ô tô Philips GP3201 - Hàng Nhập Khẩu",1764000,1764000,0,0
TIKI,o-to-xe-may-xe-dap,107458302,"Bộ Áo Ghế Hạt Gỗ Massage Cao Cấp- Chống Nóng, Trượt Dùng Cho Ô tô, Xe hơi, Văn phòng",316000,388990,72990,19
TIKI,o-to-xe-may-xe-dap,77718739,"TAY NẮM XE ĐẠP - BỌC TAY NẮM XE ĐẠP - Tay cầm ghi đông xe đạp thể thao bằng cao su cao cấp cực chắc và êm  TL 01",29000,29000,0,0
TIKI,o-to-xe-may-xe-dap,34321151,"Pô ahm 7 Màu + Cổ lon gắn Sirius, wave, dream BẢO LONG RACING",205000,205000,0,0
TIKI,o-to-xe-may-xe-dap,52472103,"Dây Curoa Tổng Ford Transit (2001-2006) - Bosch 7PK2875",372000,372000,0,0
TIKI,o-to-xe-may-xe-dap,54160152,"Giường đệm, nệm hơi thông minh du lịch cho ôtô, xe hơi + Kèm bơm điện, vòi bơm đa năng",304000,364000,60000,16
TIKI,o-to-xe-may-xe-dap,95509657,"Ty Kẹp Trục, Khóa Mở Nhanh Trục Xiên Bánh Xe Đạp (2 Cái) Mai Lee",46550,49000,2450,5
TIKI,o-to-xe-may-xe-dap,55638163,"Combo Đèn Pha Trước Cho Xe Đạp Siêu Sáng Sạc Được USB Chống Nước (Kèm Chân Đế Trượt) Và Đèn Hậu Cảnh Báo (Màu Đỏ) Xe Đạp Led Gắn Đuôi Phía Sau Mai Lee",132050,139000,6950,5
TIKI,o-to-xe-may-xe-dap,10640589,"Đồng hồ đo tốc độ xe đạp không dây 548C",150000,150000,0,0
TIKI,o-to-xe-may-xe-dap,119719097,"Bình Ắc Quy Khô Xe Máy GLOBE WTZ6V 12V6AH dùng cho NOZZA, AirBlade, SH MODE, SH Việt Nam",350000,350000,0,0
TIKI,o-to-xe-may-xe-dap,31522404,"Nhớt Tổng Hợp Cao Cấp Cho Ô Tô Kixx G1 5W-30 API SN/GF-5/RC/SF Thùng Thiếc 4 Lít",540000,540000,0,0
TIKI,o-to-xe-may-xe-dap,1565461,"Bộ 3 Sản Phẩm Chăm Sóc Xe Hơi Chuyên Dụng 3M: Chai Xịt Bảo Dưỡng Lốp Xe LT 39042 - Dung Dịch Chống Bám Nước Trên Kính Xe 3M Glass Coat Windshield LT 08889 - Khăn Lau Xe Hơi 3M Perfect-It Super Soft Microfiber PN05400 (32 x 36 cm)",414000,425000,11000,3
TIKI,o-to-xe-may-xe-dap,134527132,"Chai xịt Khử mùi ô tô Clean Shu! Shu! 500mL nước ion kiềm tẩy rửa, diệt khuẩn từ Nhật Bản",295000,295000,0,0
TIKI,o-to-xe-may-xe-dap,158886987,"[Loại To - Tốt] Áo Bạt Phủ Trùm Xe Máy Cỡ Lớn KhoNCC Hàng Chính Hãng - To Dày Bền Mát - Dòng Xe Vario, Exciter, SH Mode các loại - KQL-C3-VRO (Nhiều Màu)",169000,238000,69000,29
TIKI,o-to-xe-may-xe-dap,7139355,"Máy Lọc Không Khí Ô TÔ Cao Cấp BONECO P50 Ion âm lớn, Khuếch Tán/ Xông Tinh Dầu, Dùng Cho Xe Hơi/Xe Đẩy Em Bé/Bàn Làm Việc - Hàng Nhập Khẩu",2717000,2860000,143000,5
TIKI,o-to-xe-may-xe-dap,192268403,"Xịt Dưỡng Sên Không Văng Senfineco Chain Lube Extreme 9941 650ml Chính Hãng",390000,390000,0,0
TIKI,o-to-xe-may-xe-dap,56720709,"Bóng Đèn Halogen OSRAM Original H4 12V 60/55W",86000,101000,15000,15
TIKI,o-to-xe-may-xe-dap,69061204,"Đèn Pha, Đèn Pin Xe Đạp T6 Siêu Sáng Gắn Ghi Đông Sạc Điện Micro USB Với 2 Bóng Phụ Màu Đỏ Cảnh Báo An Toàn Ban Đêm Chống Nước Mai Lee",160550,169000,8450,5
TIKI,o-to-xe-may-xe-dap,34600406,"CÀNG THẮNG KIỂNG ĐÙM TRƯỚC SAU XE MÁY (2 cái) BẢO LONG RACING",65000,65000,0,0
TIKI,o-to-xe-may-xe-dap,184467925,"Quạt đôi mini USB KEMIN ST Chính hãng-1 Đa Năng Xoay 360 độ - Để bàn làm việc và ô tô",411000,450000,39000,9
TIKI,o-to-xe-may-xe-dap,31142621,"Bộ 2 cây gạt mưa Bosch dành cho ô tô Chevrolet Spark Advantage 22" 14"",227000,227000,0,0
TIKI,o-to-xe-may-xe-dap,68763501,"Túi Treo Sườn Xe Đạp Dài K-01ML Phom Mềm Gắn Sườn Xe,  vải Oxford chống mài mòn, chống Nước, 1 Ngăn - Mai Lee",103550,109000,5450,5
TIKI,o-to-xe-may-xe-dap,83604340,"Gương Cầu Tròn Chiếu Hậu Xoay 360 Độ Kính Cao Cấp Cho Xe Hơi, Phụ Kiện Cho Ô tô, Mở Rộng Tầm Nhìn Tối Đa, Quan Sát Dễ Dàng Theo Nhiều Góc Độ, Giúp Lái Xe Chỉnh Hướng Thuận Tiện, Có Hai Màu Tùy Chọn, Phát Hiện Vật Cản Trong Các Điểm Mù, Dùng Được Cho Nhiều",47000,49000,2000,4
TIKI,o-to-xe-may-xe-dap,89945425,"Chắn Nắng Ô Tô Lên Xuống Theo Cửa Kính - Rèm Che Nắng Ô Tô Thông Minh Tiện Lợi 206057 - màu kem",93000,98000,5000,5
TIKI,o-to-xe-may-xe-dap,10136993,"Dung Dịch Rửa Xe Không Chạm Ekokemika Bio 20 (5L) - Hàng Chính Hãng",450000,450000,0,0
TIKI,o-to-xe-may-xe-dap,139509379,"Nẹp chống xước cửa ô tô, Nẹp cửa bảo vệ bước chân cửa xe oto Mazda 2 3 6 CX3 CX5 CX8 BT50",141000,145000,4000,3
TIKI,o-to-xe-may-xe-dap,59548158,"Gương chiếu hậu Exciter 150 Kiểu Sakura Green Networks Group",109000,109000,0,0
TIKI,o-to-xe-may-xe-dap,74960286,"Gương Kính Chiếu Hậu Xe Đạp GXD-ML03 cho xe đạp có lỗ tay cầm phi 18-22mm xoay 360 Độ giúp quan sát phía sau xe đạp  (Mặt Gương Cầu Lồi) - Mai Lee",94050,99000,4950,5
TIKI,o-to-xe-may-xe-dap,115599455,"Nón Bảo Hiểm Nửa Đầu Protec Rosa RLW Phối Màu",315000,378000,63000,17
TIKI,o-to-xe-may-xe-dap,145827480,"Nón bảo hiểm 3/4 Royal M20K Thời trang, Cá tính - Hàng chính hãng - Bảo hành 12 tháng",520000,520000,0,0
TIKI,o-to-xe-may-xe-dap,119719084,"Bình Ắc Quy Khô Globe WP15-12SE 12V15AH, dùng cho loa kéo, bình phun thuốc, ups, xe đạp điện",490000,490000,0,0
TIKI,o-to-xe-may-xe-dap,20576742,"Đèn LED Hậu Gắn Phía Sau Xe Đạp Tròn Chống Nước Sạc USB Với 5 Chế Độ Cảnh Báo An Toàn Đạp Xe Ban Đêm Mai Lee - Hàng chính hãng",103550,109000,5450,5
TIKI,o-to-xe-may-xe-dap,71102314,"Hộp đựng đồ đa năng gấp gọn để cốp sau ô tô dung tích 55 lít",215000,238000,23000,10
TIKI,o-to-xe-may-xe-dap,46083673,"Mũ Bảo Hiểm Trẻ Em 1/2 Đầu Có Kính Protec Kitty, Họa Tiết Minion, An Toàn, Thời Trang - Hàng Chính Hãng",385000,442000,57000,13
TIKI,o-to-xe-may-xe-dap,38354744,"NƯỚc RỬa Xe KhÔng ChẠm VÀ RỬa Khoang ĐỘng CƠ Ekokemika Italy Bio 45 - (5l) - Hàng Chính Hãng",1050000,1050000,0,0
TIKI,o-to-xe-may-xe-dap,53223126,"Tẩu sạc nhanh đa năng cổng usb và type C dùng trên ô tô Baseus CCALL-AS01 Công suất 30W - hàng nhập khẩu ",158899,158899,0,0
TIKI,o-to-xe-may-xe-dap,55636937,"Đèn Hậu Xe Đạp Cảnh Báo Gắn Cốt Yên 2 Màu Cảnh Báo Sáng Cùng Lúc (Đỏ Trắng) Sạc Điện USB Nhiều Chế Độ Chống Nước Giúp Đạp Xe An Toàn Ban Đêm Mai Lee ",28400,28400,0,0
TIKI,o-to-xe-may-xe-dap,57316562,"Bạt Trùm Xe Máy , Áo Trùm Xe Che Nắng Mưa, Tấm Phủ Che Nắng Xe Máy Đa Năng Vải Dù Siêu Dày, Hàng Việt Nam, Có Túi Đựng Và Lựa Chọn Màu Sắc Đa Dạng",125000,125000,0,0
TIKI,o-to-xe-may-xe-dap,115958741,"Phụ Gia Nhớt VOLTRONIC E59 Phủ Sứ Động Cơ Có Chiết Lẻ Bảo Vệ Động Cơ Vận Hành Êm Ái",36000,36000,0,0
TIKI,o-to-xe-may-xe-dap,62835460,"NƯỚC RỬA XE KHÔNG CHẠM Ô TÔ B08 [Can 5 Lít] ",379000,399000,20000,5
TIKI,o-to-xe-may-xe-dap,162765993,"Bao chìa khóa bằng TPU, ốp chìa khóa, móc khóa ô tô dùng riêng cho xe Mazda 2, Mazda 3, CX5, CX8",192000,218000,26000,12
TIKI,o-to-xe-may-xe-dap,72026298,"Hộp đựng khăn giấy kiêm bảng số điện thoại và đồng hồ cao cấp đặt taplo ô tô, xe hơi TB-6137",195000,205000,10000,5
TIKI,o-to-xe-may-xe-dap,59481654,"Bộ Đầu đèn xe Wave Thái 110 Cao Cấp Green Networks Group",219000,219000,0,0
TIKI,o-to-xe-may-xe-dap,162226604,"Ắc quy khô miễn bảo dưỡng Đồng Nai PTX6HL | 12V - 5Ah",255000,255000,0,0
TIKI,o-to-xe-may-xe-dap,119719065,"Bình Ắc Quy Khô GLOBE WP20-12IE 12V - 20Ah, ắc quy dùng cho loa kéo, lưu điện",850000,850000,0,0
TIKI,o-to-xe-may-xe-dap,7167229,"Dung dịch vệ sinh buồng đốt Liqui Moly 4T Additive Shooter 80ML",90000,90000,0,0
TIKI,o-to-xe-may-xe-dap,58481039,"Mũ Bảo Hiểm Nửa Đầu Có Kính Protec Hiway Mẫu Mới Họa Tiết Trắng Xanh Hình Số 8 - Hàng Chính Hãng",375000,498000,123000,25
TIKI,o-to-xe-may-xe-dap,174315749,"Dầu nhớt xe số Castrol Power 1 4T 10W-40, 1 Lít",160000,160000,0,0
TIKI,o-to-xe-may-xe-dap,53089368,"Bộ 2 Đèn LED Gắn Phía Sau Cảnh Báo Ban Đêm Có Sạc Điện USB Chống Nước Cho Xe Đạp Giúp Đạp Xe An Toàn 4 Chế Độ Sáng (Đèn Đỏ và Xanh) Mai Lee",56050,59000,2950,5
TIKI,o-to-xe-may-xe-dap,68571431,"Dụng cụ cân, rút căm vành bánh xe đạp/ xe máy, lên vành siết lại tăng nan hoa, căm bánh xe Mai Lee",8550,9000,450,5
TIKI,o-to-xe-may-xe-dap,161904035,"Dầu nhớt xe máy MOTUL 300V FACTORY LINE ROAD RACING 10W40 1L",439000,439000,0,0
TIKI,o-to-xe-may-xe-dap,16717549,"Quần đạp xe Jett Pro Short",899000,899000,0,0
TIKI,o-to-xe-may-xe-dap,73682418,"Găng Tay Bao Tay Xe Đạp Nửa Ngón Hở Chống Trơn Trượt Với Thiết Kế Thoáng Khí, Hút Mồ Hôi, Đàn Hồi Chống Sốc Cho Xe Đạp Thể Thao MTB, Địa Hình",170050,179000,8950,5
TIKI,o-to-xe-may-xe-dap,98599313,"Bọc vô lăng TTAUTO cho xe ô tô từ 4 đến 7 chỗ chất liệu da vân carbon cao cấp có logo TOYOTA (Đen)",250000,250000,0,0
TIKI,o-to-xe-may-xe-dap,1254725,"Phụ Gia Tăng Tốc Tăng Cường Sức Mạnh Động Cơ Liqui Moly Speed Additive Shooter 7915 (80ml)",71000,73000,2000,3
TIKI,o-to-xe-may-xe-dap,45312930,"Bóng đèn Halogen Bosch H11 12V 55W 0986AL1530HZT",165000,165000,0,0
TIKI,o-to-xe-may-xe-dap,72036810,"Hộp đựng khăn giấy kiêm bảng số điện thoại và đồng hồ cao cấp trang trí và để taplo ô tô - Kích thước:11.5x4x21cm",170000,208000,38000,18
TIKI,o-to-xe-may-xe-dap,57667416,"Bộ nâng kích gầm điện, kiêm máy bơm lốp và máy siết ốc ô tô, xe hơi đa năng 3 trong 1 TY-155EHJS",2689000,2689000,0,0
TIKI,o-to-xe-may-xe-dap,1219665,"Dung Dịch Tẩy Nhựa Đường Đa Năng 3M General Purpose Adhesive Cle",164000,164000,0,0
TIKI,o-to-xe-may-xe-dap,7367429,"Cặp 2 cái ruột xe đạp 700 x 19/23C FV60mm DELI-TIRE",129000,129000,0,0
TIKI,o-to-xe-may-xe-dap,49112400,"Chuông Xe Đạp 2 Tiếng | Hợp Kim Kẽm | Phụ Kiện Xe Đạp ",56000,56000,0,0
TIKI,o-to-xe-may-xe-dap,87726820,"pedal xe đạp - Bàn đạp xe đạp kim loại",129000,129000,0,0
TIKI,o-to-xe-may-xe-dap,1176185,"Chai Vệ Sinh Sên Có Phốt Liqui Moly 1602 (500ml)",165000,169000,4000,2
TIKI,o-to-xe-may-xe-dap,47799604,"Đèn Pha LED Xe Đạp Siêu Sáng Chống Nước Có Sạc Điện USB Kèm Giá Đỡ Điện Thoại Và Còi Xe Đạp T6, Hỗ Trợ Sạc Lại Điện Thoại Khẩn Cấp Giúp Đạp Xe An Toàn Ban Đêm - Hàng Chính Hãng",203300,214000,10700,5
TIKI,o-to-xe-may-xe-dap,13415036,"Máy Bơm Lốp Đa Năng MICHELIN 4398ML",1023000,1049000,26000,2
TIKI,o-to-xe-may-xe-dap,134918097,"Miếng Lưới Tựa Lưng Ghế Bằng Hạt Gỗ Cao Cấp Cho Ô Tô, Xe Hơi Xe Tải Chính Hãng Amalife – Khung Tựa Lưng Ghế Hạt Gỗ Giao Màu Gỗ Sẫm Ngẫu Nhiên",75000,75000,0,0
TIKI,o-to-xe-may-xe-dap,168736322,"Mũ bảo hiểm xe máy 1/2 RONA haly viền bạc kèm kính phi công viền đồng cao cấp chính hãng",237000,420000,183000,44
TIKI,o-to-xe-may-xe-dap,186162716,"Vè mưa Xpander 2018-2019-2020 vè chỉ inox che mưa bảo vệ xe",369000,369000,0,0
TIKI,o-to-xe-may-xe-dap,189542413,"KIA K5 2022 PPF TPU đèn chiếu sáng chống xước tự hồi phục STARFILM",400000,400000,0,0
TIKI,o-to-xe-may-xe-dap,139508309,"Thảm lót sàn xe ô tô 2 chỗ và xe tảikích thước 150cm x 60cm",147000,155000,8000,5
TIKI,o-to-xe-may-xe-dap,36300673,"Túi treo đồ trên ô tô kiêm giá để đồ bằng da",161000,178000,17000,10
TIKI,o-to-xe-may-xe-dap,50693798,"Nón bảo hiểm Royal M139 kính âm V10 trắng line vàng",550000,730000,180000,25
TIKI,o-to-xe-may-xe-dap,139289858,"Lốp(Vỏ) DPLUS 90/90-14 Dành cho Sau xe Vision, AirBlade Hàng Chính Hãng",380000,380000,0,0
TIKI,o-to-xe-may-xe-dap,47271718,"Đệm Giường Hơi Ô Tô Cao Cấp, Đệm hơi xe SUV M168 7 chỗ 175x130CM phủ 2 hàng ghế tạo giường rộng rãi",790000,790000,0,0
TIKI,o-to-xe-may-xe-dap,51515009,"Mũ Bảo Hiểm Trẻ Em Nửa Đầu Có Kính Protec Kitty, Họa Tiết Đội Trưởng Mỹ, An Toàn, Chắc Chắc, Thời Trang - Hàng Chính Hãng",385000,442000,57000,13
TIKI,o-to-xe-may-xe-dap,70668706,"Gối tựa đầu bộ 2 gối dùng trên ô tô hoặc ghế tựa văn phòng chất liệu da thoáng khí",95000,95000,0,0
TIKI,o-to-xe-may-xe-dap,182834317,"Đèn LED xi nhan xe đạp điều khiển từ xa WB01, cổng sạc USB - Pin 500mAH - khả năng đi mưa cực tốt",299000,299000,0,0
TIKI,o-to-xe-may-xe-dap,72957669,"Ốp đĩa sên kiểng dành cho Exciter 150 Green Networks Group",119000,119000,0,0
TIKI,o-to-xe-may-xe-dap,24202042,"Bộ Chốt Khóa Dây An Toàn 4S dành cho ô tô Logo Honda ",78000,78000,0,0
TIKI,o-to-xe-may-xe-dap,58877301,"Bình Xịt Dưỡng Bóng Nội Thất Ô Tô Vị Cafe - Flamingo",51000,65000,14000,22
TIKI,o-to-xe-may-xe-dap,83347934,"Nón bảo hiểm 3/4 ROYAL M139 có kính âm màu ĐEN NHÁM",530000,700000,170000,24
TIKI,o-to-xe-may-xe-dap,95212833,"Lõi lọc thay thế máy lọc không khí và khử mùi Michelin ML-19",184000,189000,5000,3
TIKI,o-to-xe-may-xe-dap,68479793," Combo chai bảo dưỡng sên Megacools Chain Lube 300ml và xịt vệ sinh sên Megacools tặng bàn chải 3D",150000,150000,0,0
TIKI,o-to-xe-may-xe-dap,68480083," Chai xịt vệ sinh sên Megacools FULL PENETRATE dầu chống rỉ sét, chống rò rỉ mạch điện, tẩy rửa dầu mỡ",65000,65000,0,0
TIKI,o-to-xe-may-xe-dap,83346613,"Nón bảo hiểm 3/4 ROYAL M139 có kính âm màu VÀNG NGHỆ BÓNG",530000,540000,10000,2
TIKI,o-to-xe-may-xe-dap,10762741,"Phiếu Mua Xe Máy Yamaha Việt Nhật",20000000,20000000,0,0
TIKI,o-to-xe-may-xe-dap,101950004,"Bao da, ốp móc chìa khóa  dành cho TOYOTA Corolla Cross cam kết da thật siêu bền, có logo kim loại nổi",126000,128990,2990,2
TIKI,o-to-xe-may-xe-dap,58546049,"Chai xịt dưỡng sên xe máy WILLF1 Chain Lube 400ml Chuyên dùng cho moto/ xe máy sên trần",58000,58000,0,0
TIKI,o-to-xe-may-xe-dap,199519990,"Bình Ắc Quy Khô Globe WP12-12 12V12AH, Dùng Cho Loa Kéo, Bình Phun Thuốc, UPS, Xe Đạp Điện",470000,470000,0,0
TIKI,o-to-xe-may-xe-dap,52850887,"Gối tựa đầu xe ô tô cao cấp bảo vệ cổ, lưng, cột sống khi lái xe",195000,195000,0,0
TIKI,o-to-xe-may-xe-dap,121059177,"Bảng Điện Thoại Trên Ô Tô 5 Trong 1( Nhiều Tiêch Ích) - Hàng Nhập Khẩu",79000,110000,31000,28
TIKI,o-to-xe-may-xe-dap,85644001,"Khóa Xe Đạp Thắng Đĩa Chống Trộm 2 Chìa Cho Xe Đạp/ Xe Đạp Điện An Toàn Mai Lee",69000,79000,10000,13
TIKI,o-to-xe-may-xe-dap,884792,"Nón Bảo Hiểm Lưỡi Trai 1/2 Đầu Tem V2 Xanh Dương Napoli N077-V2XD-LT",147000,299000,152000,51
TIKI,o-to-xe-may-xe-dap,73802154,"Mũ Bảo Hiểm 1/2 Đầu Có Kính Size Lớn Protec VIC, Mẫu Kính Mới, An Toàn, Chắc Chắn, Thời Trang - Hàng Chính Hãng",325000,398000,73000,18
TIKI,o-to-xe-may-xe-dap,190132786,"Đèn xe đạp độ sáng cao XTE BL22.24 - Cảm biến ánh sáng tự động - Đèn Led pin 2000mAH - Có còi hoặc không còi - Hàng chính hãng",199000,199000,0,0
TIKI,o-to-xe-may-xe-dap,160437253,"Dây chun buộc xe đạp Giant Ineed Latte (Chính Hãng)",690000,690000,0,0
TIKI,o-to-xe-may-xe-dap,10713844,"Thảm Lót Sàn Cao Su Chống Trượt Cao Cấp DC-LS01",221000,258000,37000,14
TIKI,o-to-xe-may-xe-dap,7295929,"Chai khử mùi làm sạch dàn lạnh dạng hơi Sonax Car A/C Cleaner 100ml 323100",199000,250000,51000,20
TIKI,o-to-xe-may-xe-dap,153941466,"Thảm sàn, lót sàn cao su 3D cho Mitsubishi Xpander",692000,786000,94000,12
TIKI,o-to-xe-may-xe-dap,76543690,"Túi Treo Sườn Xe Đạp Thể Thao Cảm Ứng Chống Nước Tặng Kèm Túi Chùm Mưa",69000,69000,0,0
TIKI,o-to-xe-may-xe-dap,114745008,"Combo 2 Lưỡi Gạt Mưa Loại A VIAIR R15 (26 Inch/650 mm)",92000,108000,16000,15
TIKI,o-to-xe-may-xe-dap,45155310,"Bulldog POM",1099000,1099000,0,0
TIKI,o-to-xe-may-xe-dap,83347542,"Nón bảo hiểm ANDES 109 gắn lưỡi trai chính hãng",361000,440000,79000,18
TIKI,o-to-xe-may-xe-dap,22057374,"Dung dịch dưỡng ĐEN BÓNG LỐP XE FOCAR Tire Care can 20L Tiết kiệm",918000,942000,24000,3
TIKI,o-to-xe-may-xe-dap,73792238,"Bình xăng bông mai ND gắn cho nhiều dòng xe Green Networks Group",299000,299000,0,0
TIKI,o-to-xe-may-xe-dap,31530656,"Dầu nhớt bán tổng hợp Kixx G SL 10W40 thiếc 4 Lít",480000,480000,0,0
TIKI,o-to-xe-may-xe-dap,14185709,"Tem dán sườn xe ô tô, Tem dán ô tô",16000,16500,500,3
TIKI,o-to-xe-may-xe-dap,162532999,"Lót Cốp Nhựa Xe Mazda Cx5 Chất Liệu Nhựa TPO Dẻo Ko Mùi",339000,348000,9000,3
TIKI,o-to-xe-may-xe-dap,100264792,"[Nontrum_vn]Mũ bảo hiểm 3/4 Royal M139 xanh ngọc bóng",530000,700000,170000,24
TIKI,o-to-xe-may-xe-dap,42972931,"Bộ 4 miếng thảm lót sàn ô tô T25.7 , Thảm sàn xe hơi 7 chỗ DIY",318000,335000,17000,5
TIKI,o-to-xe-may-xe-dap,58624491,"Mũ Bảo Hiểm 3/4 Bulldog Heli Carbon 2020",2600000,2600000,0,0
TIKI,o-to-xe-may-xe-dap,68480363,"Nhớt cao cấp xe tay ga Motul Scooter Power LE 5W40 800ml tặng Cao su lót chân chống xe máy",169000,169000,0,0
TIKI,o-to-xe-may-xe-dap,125171996,"Dây Câu Kích Bình Ắc Quy Cứu Hộ Ô Tô xe Hơi 2000AMP Dài 4 Mét - Dây Sạc Bình Ắc Quy Lõi Đồng To Loại Tốt",120000,120000,0,0
TIKI,o-to-xe-may-xe-dap,84322507,"tựa lưng lưới đan hạt gỗ cho ghế ô tô và văn phòng chống mỏi lưng",86000,95000,9000,9
TIKI,o-to-xe-may-xe-dap,7359743,"Cặp 2 cái ruột xe đạp 700 19/23C FV80mm DELI-TIRE",149000,149000,0,0
TIKI,o-to-xe-may-xe-dap,37855425,"Bộ 3 món Đũa Thắng Càng Thắng Kiểng trước sau gắn Xe máy SIÊU THỊ ĐỨC ANH ( MÀU XANH)",99000,99000,0,0
TIKI,o-to-xe-may-xe-dap,73174485,"Bô kích nâng gầm xe ô tô, xe hơi 2T - Kích chữ A đầu bám xoay 360 độ",268000,268000,0,0
TIKI,o-to-xe-may-xe-dap,11944757,"Lốp Xe Tay Ga Lead, SCR 90/90-12 TL Hãng DPLUS",370000,370000,0,0
TIKI,o-to-xe-may-xe-dap,119624961,"Chốt cài khóa dây an toàn trên ô tô bằng thép có thương hiệu xe 1 chiếc",39000,41000,2000,5
TIKI,o-to-xe-may-xe-dap,107186568,"Carlinkit 2.0 U2W Plus 2021 - Apple Carplay không dây cho xe Suzuki màn hình nguyên bản",1950000,1950000,0,0
TIKI,o-to-xe-may-xe-dap,193898701,"Tay côn bên trái YAMAHA",894437,894437,0,0
TIKI,o-to-xe-may-xe-dap,7735709,"Lốp Xe Máy 70/90-17 Không Ruột",340000,340000,0,0
TIKI,o-to-xe-may-xe-dap,51709901,"Nón bảo hiểm 3/4 Royal kính am M139 đỏ đô",530000,700000,170000,24
TIKI,o-to-xe-may-xe-dap,91830470,"Led Đuôi Chớp Nhấp Nháy Xe Đạp BK400 100 Lumens Độ Sáng Cao 6 Chế Độ Sạc Điện USB MaiLee",151050,159000,7950,5
TIKI,o-to-xe-may-xe-dap,85741762,"Ngăn chứa đồ tiện dụng tích hợp Dock sạc USB dùng trên xe hơi Baseus Deluxe Metal Armrest Console Organizer(2 USB charging port, Cup holder for Car)",350000,350000,0,0
TIKI,o-to-xe-may-xe-dap,158307896,"Mũ Bảo Hiểm Nửa Đầu B'color  Màu Trắng Họa Tiết Hình Gấu Kèm Kính Thời Trang",185000,240000,55000,23
TIKI,o-to-xe-may-xe-dap,73432124,"Mũ Bảo Hiểm 3/4 RONA R8 Freesize Vòng Đầu 55-59cm - Hàng Chính Hãng - Màu",217550,480000,262450,55
TIKI,o-to-xe-may-xe-dap,178096156,"Mũ bảo hiểm 1/2 đầu có kính cao cấp Protec Hiway họa tiết đen đeo kính, mẫu mới, an toàn, thời trang - Hàng chính hãng",355000,498000,143000,29
TIKI,o-to-xe-may-xe-dap,88011471,"Nhớt xe số cao cấp Mobil Super 4T 20W50 1L - Nhập khẩu Singapore",99000,99000,0,0
TIKI,o-to-xe-may-xe-dap,71147885,"Mũ Bảo Hiểm Nửa Đầu Protec IM01 Họa Tiết Thể Thao, Siêu nhẹ, An toàn - Hàng Chính hãng",555000,610000,55000,9
TIKI,o-to-xe-may-xe-dap,45400251,"Dầu Động Cơ CASTROL MAGNATEC 5W30 API SP, can 4 LÍT",900000,900000,0,0
TIKI,o-to-xe-may-xe-dap,1254621,"Chai Xịt Chăm Sóc Lốp Phục Hồi Cao Su 3M Tire Dressing PN39042LT (400ml) - Đen",136000,136000,0,0
TIKI,o-to-xe-may-xe-dap,76215904,"Ốp, bọc bảo vệ chìa khóa xe Toyota Corolla Cross vân Carbon kèm móc đeo",253000,259000,6000,2
TIKI,o-to-xe-may-xe-dap,51538568,"Bao da bọc, bảo vệ chìa khóa dành cho xe Mazda 3 2020 kèm móc đeo",126000,129000,3000,2
TIKI,o-to-xe-may-xe-dap,101949981,"Phụ kiện, đồ chơi ô tô xe suzuki XL7",115000,121000,6000,5
TIKI,o-to-xe-may-xe-dap,108176003,"Đèn led trần đèn cốp xe hơi ô tô dạng tấm Green Networks Group ( 1 cái )",33000,33000,0,0
TIKI,o-to-xe-may-xe-dap,1580553,"Chai Xịt Tăng Độ Bóng Sơn 3M 39034 (473ml)",263000,285000,22000,8
TIKI,o-to-xe-may-xe-dap,112097162,"Bộ ốc dàn áo xe Future 125 Green Networks Group",149000,149000,0,0
TIKI,o-to-xe-may-xe-dap,87912181,"Keo dán ống nhựa Bình Minh 25g 50g 100g",14000,14000,0,0
TIKI,o-to-xe-may-xe-dap,12912527,"Giá đỡ điện thoại ô tô Baseus hút nam châm SUGENT-NT0V - Hàng Nhập Khẩu",179000,179000,0,0
TIKI,o-to-xe-may-xe-dap,41400849,"Chai xịt tăng độ bóng sơn ô tô 3M 39034 (Hàng Mỹ) tặng kèm khăn lau ô tô chuyên dụng 3M màu ngẫu nhiên",283000,283000,0,0
TIKI,o-to-xe-may-xe-dap,181997844,"Hộp đựng đồ xếp gọn 2 ngăn 50L.50cm x 34cm x 31cm-nhãn hiệu Macsim màu xanh lá,xanh dương,vàng",1400000,1400000,0,0
TIKI,o-to-xe-may-xe-dap,142871368,"Cục chân kính thay thế - Phụ kiện thay thế giá đỡ điện thoại BIKERSOUL MAGFIT cho xe máy ",70000,70000,0,0
TIKI,o-to-xe-may-xe-dap,26670356,"Bộ 3 món Đũa Thắng Càng Thắng Kiểng trước sau gắn Xe máy (MÀU ĐỎ)",140000,140000,0,0
TIKI,o-to-xe-may-xe-dap,10320972,"Combo 2 can nước rửa kính ô tô Focar Screen Wash 2.75L",187000,210000,23000,11
TIKI,o-to-xe-may-xe-dap,84870048,"Nước rửa xe bọt tuyết siêu bóng Pallas 1.5L - Pha nước tỷ lệ 1/50",89000,89000,0,0
TIKI,o-to-xe-may-xe-dap,142439136,"Xịt bóng lốp, dưỡng lốp ô tô TH CLEAN VIỆT NAM chai 500ml",66000,68000,2000,3
TIKI,o-to-xe-may-xe-dap,54674775,"Lọ nước hoa oto Michelin dạng treo hương Vanilla 5ml 87848 - Hàng chính hãng",77000,79000,2000,3
TIKI,o-to-xe-may-xe-dap,31140559,"Gạt mưa Bosch Advantage Ford Transit 26" - 22" (Đen)",298000,298000,0,0
TIKI,o-to-xe-may-xe-dap,50696213,"Nón bảo hiểm Royal kính âm M139 tem V7",550000,730000,180000,25
TIKI,o-to-xe-may-xe-dap,56699147,"Nhớt Hộp Số Repsol Moto Gear Oil 80w90 – 120ml",49000,49000,0,0
TIKI,o-to-xe-may-xe-dap,190635585,"Thùng giữa Givi G10N kèm bát gắn cho xe Winner X 2022, thùng giữa Winner X V3",698000,698000,0,0
TIKI,o-to-xe-may-xe-dap,91390615,"Giá Móc Treo Xe Đạp Lên Tường Cao Cấp Có Điều Chỉnh Max 25kg Tiết Kiệm Không Gian MaiLee",692550,729000,36450,5
TIKI,o-to-xe-may-xe-dap,153941231,"Hộp đựng khăn giấy trên Ô tô, Xe hơi 3 trong 1",219000,268000,49000,18
TIKI,o-to-xe-may-xe-dap,59212419,"Đèn led trợ sáng 6 bóng đôi Green Networks Group",139000,139000,0,0
TIKI,o-to-xe-may-xe-dap,23451640,"Bộ 4 Đèn Led Gầm Ghế Trang Trí Nội Thất Ô Tô Màu Xanh Dương",82900,82900,0,0
TIKI,o-to-xe-may-xe-dap,1176183,"Chai Xịt Bôi Trơn, Bảo Dưỡng Sên White Grease Liqui Moly 1591 (400ml)",283000,283000,0,0
TIKI,o-to-xe-may-xe-dap,160377357,"Máy lọc không khí PANASONIC dành cho Ô tô F-GPT01A-K - Hàng chính hãng",3200000,3200000,0,0
TIKI,o-to-xe-may-xe-dap,1254707,"Nước Làm Mát Động Cơ Xe Loại Màu Đỏ Cao Cấp Liqui Moly Coolant 6924 (1L)",175000,175000,0,0
TIKI,o-to-xe-may-xe-dap,106809148,"Nước Hoa Ô Tô Xe Hơi Nhập Khẩu Chính Hãng Cao Cấp ETONNER Khử Mùi Ô Tô E1801A (60ml)",980000,980000,0,0
TIKI,o-to-xe-may-xe-dap,767076,"Kem Lấp Vết Xước Chi Tiết Nhựa Plastic Cleaner Soft99 VC-ADR-08 (50g)",220000,220000,0,0
TIKI,o-to-xe-may-xe-dap,157146577,"Bao Da Chìa Khóa Dành Cho Xe Mitsubishi Xpander, Outlander, Attrage, Mirage (Da Thật) Logo 3D",128000,135000,7000,5
TIKI,o-to-xe-may-xe-dap,101687155,"Nước rửa kính ô tô công nghệ nano Italy XGLASS Lemon 3.2L",145000,145000,0,0
TIKI,o-to-xe-may-xe-dap,206781486,"Thảm lót sàn ô tô KATA cho xe Honda Civic (2022 - 2023) - Khít với sàn xe, Chống thấm, Không mùi, Không ẩm mốc",1990000,1990000,0,0
TIKI,o-to-xe-may-xe-dap,98694667,"Bọc vô lăng TTAUTO cho xe ô tô từ 4 đến 7 chỗ chất liệu da vân carbon cao cấp có logo FORD (Đen)",250000,250000,0,0
TIKI,o-to-xe-may-xe-dap,71147991,"Thanh Đỡ Chân Đế Mở Rộng Ngang Gắn Trước Ghi Đông Xe Đạp Đa Năng Thêm Chỗ Để Gắn Phụ Kiện Đồ Chơi Xe Đạp (Loại ngắn 1 nhánh đỡ) Mai Lee",70300,74000,3700,5
TIKI,o-to-xe-may-xe-dap,207406651,"Thảm lót sàn ô tô KATA cho xe Hyundai Tucson (2022 - 2023) - Khít với sàn xe, Chống trơn, Không mùi, Không ẩm mốc",1990000,1990000,0,0
TIKI,o-to-xe-may-xe-dap,74044777,"Chai Xịt Làm Bóng, Mờ Vết Xước Vỏ Xe Nhựa, Kim Loại, Sơn Ipone Cleaner Polish (250ml) - Hàng Chính Hãng",160000,160000,0,0
TIKI,o-to-xe-may-xe-dap,54306886,"Nón bảo hiểm 3/4 kính âm Royal M139 Trắng ngọc trai cao cấp Lót tháo rời, che hết mặt",499000,499000,0,0
TIKI,o-to-xe-may-xe-dap,133811196,"Khóa Đĩa xe máy Abus 303 màu đỏ đen - hình thật",512000,539000,27000,5
TIKI,o-to-xe-may-xe-dap,184410770,"Khóa Xe Đạp Dây Cáp Dài 1m Chống Trộm,An Toàn,Chắc Chắn ĐN Đại Nam Sport",78000,120000,42000,35
TIKI,o-to-xe-may-xe-dap,83346899,"Nón bảo hiểm 3/4 ROYAL M139 có kính âm VÂN CARBON",499000,499000,0,0
TIKI,o-to-xe-may-xe-dap,101950017,"Bộ ốp tay nắm cửa, hõm cửa dành cho Toyota Corolla Cross mạ Crom",269000,298000,29000,10
TIKI,o-to-xe-may-xe-dap,111463422,"Thảm Taplo xe Toyota Altis (2009-2014), (2015-2020) da vân Carbon cao cấp",189000,234000,45000,19
TIKI,o-to-xe-may-xe-dap,5485501,"Kem dưỡng ghế da Sonax 291141 250ml",220000,220000,0,0
TIKI,o-to-xe-may-xe-dap,37688394,"Bộ pin sạc dự phòng kích nổ ắc quy xe ô tô, xe máy 12V Baseus CRJS01 8000mAh",1345000,1345000,0,0
TIKI,o-to-xe-may-xe-dap,94282825,"Lót Ghế Ô Tô Hạt Gỗ Cao Cấp Chống Nóng, Chống Trơn Trượt, Hạt Gỗ Massage Cao Cấp",352000,370523,18523,5
TIKI,o-to-xe-may-xe-dap,59206514,"Tem dán trang trí xe máy kiểu King Đra g ( Kiểu Đa Dạng Ngẫu Nhiên ) Green Networks Group",55000,55000,0,0
TIKI,o-to-xe-may-xe-dap,18012417,"Mũ bảo hiểm 3/4 có kính SUNDA 621",479000,479000,0,0
TIKI,o-to-xe-may-xe-dap,99199506,"Bọc Tay Lái Sừng Trâu Nắm Ghi Đông Xe Đạp Chất Liệu Cao Su TPR Cho Xe Đạp Thể Thao Địa Hình MTB (Đường kính 2.2cm) Mai Lee",198550,209000,10450,5
TIKI,o-to-xe-may-xe-dap,87896383,"Mũ Bảo Hiểm ¾ NAPOLI, Hai Kính  Đẹp",350000,350000,0,0
TIKI,o-to-xe-may-xe-dap,25970929,"PHỄU CHÂM XĂNG DẦU CHO XE Ô TÔ , XE GẮN MÁY",35000,35000,0,0
TIKI,o-to-xe-may-xe-dap,72843138,"Dưỡng sên và vệ sinh sên ArrowSP tặng kèm bàn chải vệ sinh sên cao cấp",135000,135000,0,0
TIKI,o-to-xe-may-xe-dap,49241132,"Bảng để lại số điện thoại trên ô tô khi đỗ xe",8500,8500,0,0
TIKI,o-to-xe-may-xe-dap,119719075,"Bình ắc quy Globe WP5S-3BP 12V 6Ah dành cho xe Dream, Wave, Viva, Jupiter, Sirius",310000,310000,0,0
TIKI,o-to-xe-may-xe-dap,35222171,"DUNG DỊCH VỆ SINH NỘI THẤT GHẾ DA CHEMICAL GUYS LEATHER CLEANER 16OZ",550000,550000,0,0
TIKI,o-to-xe-may-xe-dap,45121260,"Bộ Khánh Ngọc phật di lặc phong thủy treo trên ô tô, xe hơi PT-05",99000,99000,0,0
TIKI,o-to-xe-may-xe-dap,53653174,"Thảm Lót Sàn Cao Su Dành Cho Suzuki Swift",564000,578000,14000,2
TIKI,o-to-xe-may-xe-dap,172167257,"Xịt Khử Mùi Nội Thất Điều Hòa Ô Tô Senfinecon Aircon Fresh and Clean 9980 Hương Chanh Nhẹ Nhàng Dễ Chịu 200ml",190000,190000,0,0
TIKI,o-to-xe-may-xe-dap,25142530,"Combo Gioăng Cao Su Chống Ồn, Chống Thoát Khí Điều Hòa Chữ P + Dung Môi Tăng Kết Dính Cho Ô Tô",66000,69000,3000,4
TIKI,o-to-xe-may-xe-dap,101972201,"CHẮN NẮNG NAM CHÂM THEO DÀNH CHO XE GRAND I10 cộc - HATCHBACK",250000,256000,6000,2
TIKI,o-to-xe-may-xe-dap,39307432,"Lót sàn cao su ống hạt mít (Cắt theo xe)",226000,238000,12000,5
TIKI,o-to-xe-may-xe-dap,1219677,"Găng Tay Bảo Vệ Cao Cấp 3M Gloves Xl",59000,72000,13000,18
TIKI,o-to-xe-may-xe-dap,25059582,"Mũ bảo hiểm ba phần tư GRS A370K - dành cho người có vòng đầu hơi lớn hoặc lớn",449000,449000,0,0
TIKI,o-to-xe-may-xe-dap,59214044,"Giường Hơi, Nệm Hơi Ô Tô Tiện Dụng Cao Cấp PHIÊN BẢN MỚI (vải nhung, chân đệm rời, có tựa lưng, có thanh chặn trẻ em)",620000,620000,0,0
TIKI,o-to-xe-may-xe-dap,122831605,"Tấm chắn nắng tròn xốp dày dặn cho xe ô tô - có miếng nút cố định- CHE NẮNG XE Ô TÔ",25000,25000,0,0
TIKI,o-to-xe-may-xe-dap,133783014,"Mũ bảo hiểm 3/4 Royal M268 chính hãng có 2 kính",440000,680000,240000,35
TIKI,o-to-xe-may-xe-dap,188707103,"Bọt tẩy vệ sinh khử trùng điều hoà xe hơi, xịt khử mùi điều hoà dàn lạnh, vệ sinh dàn máy lạnh ô tô Flamingo 500ml",99000,99000,0,0
TIKI,o-to-xe-may-xe-dap,10857220,"Dung Dịch Làm Sạch và Trong Kính Sonax Xtreme Glass Clear NanoPro 500ml 238241",280000,280000,0,0
TIKI,o-to-xe-may-xe-dap,82458984,"Nệm Hơi Chân Rời Tiện Dụng Hàng Nhập Khẩu, Phù Hợp Mọi Loại Xe 4 Chỗ, 5 Chỗ, 7 Chỗ",515000,515000,0,0
TIKI,o-to-xe-may-xe-dap,7543371,"Mũ Bảo Hiểm 3/4 Đầu Royal M139",530000,700000,170000,24
TIKI,o-to-xe-may-xe-dap,10047474,"Chai xịt bảo dưỡng - bôi trơn sên xích TS-50 300ml ",65000,65000,0,0
TIKI,o-to-xe-may-xe-dap,134729634,"Ví đựng giấy tờ xe ô tô Honda Da Cao Cấp, Ví da đựng giấy tờ xe ô tô",25000,25000,0,0
TIKI,o-to-xe-may-xe-dap,58137497,"KÈN Ô TÔ CHỐNG NƯỚC CAO CẤP DENSO",650000,650000,0,0
TIKI,o-to-xe-may-xe-dap,83347560,"Nón bảo hiểm 3/4 ROYAL M139 có kính âm màu XANH LÍNH NHÁM",530000,700000,170000,24
TIKI,o-to-xe-may-xe-dap,92453804,"Túi Vá Săm Lốp Xe Đạp Sửa Chữa Đa Năng 10 in 1 Mini Khẩn Cấp (Bản nâng cấp có túi và Thanh nạy bằng kim loại) MaiLee",56050,59000,2950,5
TIKI,o-to-xe-may-xe-dap,113378376,"Túi Treo Xe Đạp Form Cứng Dài Chất Liệu EVA 1 Lít Chống Thấm Nước Chứa Vật Dụng Cá Nhân Đạp Xe Cycling MaiLee",198550,209000,10450,5
TIKI,o-to-xe-may-xe-dap,188629341,"Vỏ Xe Đạp 20x1.95 , Lốp Xe Đạp 20x1.95 , Săm Vỏ Ruột Lốp Xe Đạp 20x1.95",89000,89000,0,0
TIKI,o-to-xe-may-xe-dap,93763298,"Kem Đánh Bóng Xóa Trầy Xước Sơn Ô tô - Xe Máy Cana Car Cream 100g - 220g",47000,47000,0,0
TIKI,o-to-xe-may-xe-dap,42776753,"Set 2 Lò Xo Mở Cốp Tự Động Cho Ôtô Tiện Dụng",81000,83500,2500,3
TIKI,o-to-xe-may-xe-dap,72217709,"[1 chiếc] Đèn Trang Trí Cho Xe Đạp Trẻ Em Gắn Moay-Ơ Trục Giữa Xe Đạp Với 7 Màu RBG 18 Chế Độ Sáng Khác Nhau Sạc Điện USB (Đường Kính Phù hợp dưới 32mm) Mai Lee",141550,149000,7450,5
TIKI,o-to-xe-may-xe-dap,42596482,"Phuộc ( 2 CÁI ) kiểu 1 Lò Xo cao cấp Màu dành cho xe Sirius,Jupiter... ( vàng ) cao cấp",365000,365000,0,0
TIKI,o-to-xe-may-xe-dap,189533605,"Mazda Cx5 Premium 2018-2022 PPF TPU chống xước tự hồi phục STAR FILM",450000,450000,0,0
TIKI,o-to-xe-may-xe-dap,72045750,"Nhớt động cơ Ô TÔ cao cấp Wolver Super Dynamic 10W40 4L SL/CF - Nhập Khẩu Đức",699000,699000,0,0
TIKI,o-to-xe-may-xe-dap,6755167,"Vỏ Xe DPLUS 80/90-14",340000,340000,0,0
TIKI,o-to-xe-may-xe-dap,177301064,"Vè mưa Vios 2014-2015-2016-2017 vè đen che mưa bảo vệ trang trí xe",238000,244000,6000,2
TIKI,o-to-xe-may-xe-dap,81694155,"THẢM TAPLO DA VÂN CARBON CAO CẤP DÀNH CHO XE MAZDA CX5 2018 - 2020",244000,249900,5900,2
TIKI,o-to-xe-may-xe-dap,57984248,"SẠC KÍCH BÌNH Ô TÔ KHẨN CẤP ACE PLUS J377",2199000,2199000,0,0
TIKI,o-to-xe-may-xe-dap,136187490,"RÈM CHE NẮNG NAM CHÂM CHO XE TOYOTA INNOVA 2008-2015",242000,248000,6000,2
TIKI,o-to-xe-may-xe-dap,70512028,"Dung Dịch Súc Béc Xăng Senfineco 9986 – 300ML",190000,190000,0,0
TIKI,o-to-xe-may-xe-dap,5485775,"Chai xịt đánh bóng nhanh Sonax High Speed Wax 288200 500ml",229000,240000,11000,5
TIKI,o-to-xe-may-xe-dap,42347550,"Bộ 4 miếng dán chống đọng nước kính hông và gương chiếu hậu ô tô, xe hơi cao cấp DC150",49000,49000,0,0
TIKI,o-to-xe-may-xe-dap,53408573,"Combo ốp chìa khóa 360 độ cho xe Mazda CX-8, Mazda CX-5, Mazda 6, Mazda 2, Mazda 3... Silicon phủ gương kèm móc đeo INOX",179000,188000,9000,5
TIKI,o-to-xe-may-xe-dap,117597789,"COMBO nước làm mát động cơ xe ô tô màu xanh Esna 4L + Súc két nước 300ml",229000,229000,0,0
TIKI,o-to-xe-may-xe-dap,186692563,"Thảm Taplo dành cho xe Toyota Raize 2021 chất liệu Nhung, da Carbon, da vân gỗ",198000,208000,10000,5
TIKI,o-to-xe-may-xe-dap,9735470,"Chai Xịt Vệ Sinh Vành - Mâm Xe Sonax FelgenReiniger Gel 500ml 429200",199000,199000,0,0
TIKI,o-to-xe-may-xe-dap,167393831,"Trang Trí Taplo Xe ô tô Vừa Là Giá Đỡ Điện Thoại Mô Hình Nhân Vật Gấu Tên Kaws Sang Trọng - Phụ Kiện Trang Trí  Taplo Xe Hơi Cao Cấp",115000,115000,0,0
TIKI,o-to-xe-may-xe-dap,35153788,"Baga Inox loại 10ly Xi Titan gắn WINNER X cao cấp STĐA",89000,89000,0,0
TIKI,o-to-xe-may-xe-dap,142870535,"Mút đệm vải lót thay thế cho mũ nón bảo hiểm Zeus 613",200000,200000,0,0
TIKI,o-to-xe-may-xe-dap,8005980,"Lốp Xe Máy SH 120/80-16 TL DPLUS",730000,730000,0,0
TIKI,o-to-xe-may-xe-dap,90192967,"Túi Treo Phía Trước Xe Đạp Gắn Ghi Đông Dung Tích Lớn 5 Lít Có Mặt Cảm Ứng Điện Thoại 6.5 inch MaiLee",227050,239000,11950,5
TIKI,o-to-xe-may-xe-dap,108465819,"Bình Vệ Sinh Ghế Da - Nội Thất Ô Tô Flamingo F002 650ml HÃNG PHÂN PHỐI CHÍNH THỨC",51000,56990,5990,11
TIKI,o-to-xe-may-xe-dap,22372390,"Miếng đệm bảo vệ giày khi móc số Scoyco FS02",150000,150000,0,0
TIKI,o-to-xe-may-xe-dap,91979788,"Mũ Bảo Hiểm ¾ Napoli SH2 Ruby Kem bóng lót nâu - Free Size (55-58cm)",252000,359000,107000,30
TIKI,o-to-xe-may-xe-dap,73313209,"Băng keo cường lực siêu dính gắn nội thất ô tô 3M GT7108",165000,165000,0,0
TIKI,o-to-xe-may-xe-dap,1254627,"Chai Súc Rửa Động Cơ Cao Cấp Bluechem Oil System Cleaner (250ml)",243000,249000,6000,2
TIKI,o-to-xe-may-xe-dap,47198297,"Mũ Bảo Hiểm 1/2 Đầu Không Kính Protec Rosa, An Toàn, Thời Trang, Màu Đen Bóng - Hàng Chính Hãng (size L)",235000,318000,83000,26
TIKI,o-to-xe-may-xe-dap,114209713,"Bộ 4 cái nấm vá cao cấp PW-4007 Maruni - Nhật bản (kích cỡ 7x40mm)",150000,150000,0,0
TIKI,o-to-xe-may-xe-dap,133650961,"Thùng đựng nhựa/ hộp đừng đồ kéo dã ngoại cốp ô tô",488000,488000,0,0
TIKI,o-to-xe-may-xe-dap,151686473,"Bạt trùm che phủ xe ô tô Mazda 3 3 Lớp Cao Cấp Chống Nắng Nóng Chống Nước Chống Cháy Chống Bụi",414000,425000,11000,3
TIKI,o-to-xe-may-xe-dap,174222415,"ỐP PÔ (ĐEN MỜ)",279000,279000,0,0
TIKI,o-to-xe-may-xe-dap,162208823,"Bộ 04 Chắn Bùn Xe Ô Tô Mitsubishi Xpander - Đẹp",197000,202000,5000,2
TIKI,o-to-xe-may-xe-dap,764562,"Sáp Phủ Chống Thấm Nước Đánh Bóng Sơn Xe Authentic Premium E Soft99 VC-ADR-01",487500,650000,162500,25
TIKI,o-to-xe-may-xe-dap,153940493,"Thảm sàn, lót sàn cao su 3D cho Honda City 2015-2021",374000,425000,51000,12
TIKI,o-to-xe-may-xe-dap,142489341,"Đồng hồ đo tốc độ xe đạp thể thao SD-548B Hiển Thị LCD, 14 chức năng, có dây (dòng phổ thông), dễ dàng lắp đặt - Mai Lee",61655,64900,3245,5
TIKI,o-to-xe-may-xe-dap,21240305,"Bộ Ốp bậc, Nẹp bước chân Titan dành cho xe Mazda 3",219000,219000,0,0
TIKI,o-to-xe-may-xe-dap,58935495,"MIẾNG DÁN CHỐNG TRẦY CỬA XE Ô TÔ CHỮ " SPORTS" DÙNG CHUNG CHO CÁC DÒNG XE",83000,85000,2000,2
TIKI,o-to-xe-may-xe-dap,165704052,"Thảm Lót Sàn Cao Su tổ ong cho Xe Hyundai Accent 2018-2021- Sàn Cao Su Đúc Accent không Mùi cao cấp",476000,488000,12000,2
TIKI,o-to-xe-may-xe-dap,176687594,"Baga Givi HRV Winner 150, baga HRV Winner V1",972000,972000,0,0
TIKI,o-to-xe-may-xe-dap,56720741,"Bóng Đèn Halogen OSRAM Original H11 12V 55W",275000,323000,48000,15
TIKI,o-to-xe-may-xe-dap,111361802,"Ốp Bậc Xe Suzuki XL7, XL-7 2020 2021 Mẫu TiTan Tặng Kèm Keo Tăng Dính",204000,215000,11000,5
TIKI,o-to-xe-may-xe-dap,141917443,"Combo 4 miếng che nắng tròn tráng bạc bên trong ô tô hàng cao cấp chống nắng , nóng có miếng hút",36000,42000,6000,14
TIKI,o-to-xe-may-xe-dap,157662233,"Xe đạp GIANT XTC 800 2022",17250000,17250000,0,0
TIKI,o-to-xe-may-xe-dap,884802,"Nón Bảo Hiểm Lưỡi Trai 1/2 Đầu Tem V2 Màu Đỏ Napoli N077-V2ĐỎ-LT - Size đầu  55 -58 cm",151000,299000,148000,49
TIKI,o-to-xe-may-xe-dap,141962434,"Rèm Che Nắng Xe BeiJing X7 Hàng Loại 1 Mr Ô Tô",540000,540000,0,0
TIKI,o-to-xe-may-xe-dap,72301640,"Hộp đựng khăn giấy bọc da cao cấp có gắn mặt đồng hồ dùng trên ô tô",191000,201000,10000,5
TIKI,o-to-xe-may-xe-dap,186162812,"Thảm nhựa lót cốp cho I10 sedan 2014-2015-2016-2017-2018-2019-2020-2021 nhựa dẻo dày dặn đàn hồi tốt",281000,288000,7000,2
TIKI,o-to-xe-may-xe-dap,132781178,"LOGO CÁNH CHIM 3D KIM LOẠI CHO XE Ô TÔ XE HƠI SÁNG BÓNG SANG TRỌNG",33000,33000,0,0
TIKI,o-to-xe-may-xe-dap,30699308,"Thảm sàn, lót sàn cao su 3D không mùi Cao cấp dành cho xe Hyundai Santafe 2019",697000,715000,18000,3
TIKI,o-to-xe-may-xe-dap,177921418,"Phiếu Mua Xe Máy Honda Hùng Chung Nghĩa 2",32000000,32000000,0,0
TIKI,o-to-xe-may-xe-dap,96012076,"Ví đựng giấy tờ xe ô tô dành cho hãng xe Nissan",37000,38000,1000,3
TIKI,o-to-xe-may-xe-dap,114985753,"Lót cốp dành cho xe Kia Cerato 2019 - 2021 không mùi, chất liệu TPO cao cấp",331000,339000,8000,2
TIKI,o-to-xe-may-xe-dap,49864991,"Vỏ / Lốp xe đạp không gấp Schwalbe Rapid Rob Tire 27.5" x 2.25 (57-584)",390000,390000,0,0
TIKI,o-to-xe-may-xe-dap,81694217,"THẢM TAPLO DA VÂN CARBON DÀNH CHO KIA SELTOS",233000,238490,5490,2
TIKI,o-to-xe-may-xe-dap,98030778,"Miếng Dán Chống Bám Nước Gương Chiếu Hậu Ô Tô",29000,29000,0,0
TIKI,o-to-xe-may-xe-dap,95226352,"Nước Làm Mát Prestone AF6700 (3.78 lít) - Nước làm mát Prestone nhập khẩu từ Mỹ chuyên dùng cho dòng xe Ford*, GM*, Chrysler*",459000,459000,0,0
TIKI,o-to-xe-may-xe-dap,114856819,"Mũ bảo hiểm xe đạp người lớn, nón bảo hiểm xe đạp tiêu chuẩn Châu Âu Protec Win 002 màu mới năng động, trẻ trung, cá tính",395000,478000,83000,17
TIKI,o-to-xe-may-xe-dap,186161747,"Thảm nhựa lót cốp cho Vinfast Lux A 2.0 2020-2021-2022 nhựa dẻo dày dặn đàn hồi tốt",281000,288000,7000,2
TIKI,o-to-xe-may-xe-dap,66617233,"Tẩu sạc nhanh 2 cổng cho điện thoại trên Ô tô/Xe hơi XIAOMI Mi 37W Dual-Port Car Charger Black GDS4147GL - Hàng Chính Hãng",198000,198000,0,0
TIKI,o-to-xe-may-xe-dap,20331003,"Bộ Rèm Chắn Nắng Nam Châm dành cho xe Toyota Vios 2014-2018",229000,235000,6000,3
TIKI,o-to-xe-may-xe-dap,71958300,"Gù chống đổ sau kiểu Z1OOO giúp hạn chế trầy xước cho xe máy Exciter, Winner Green Networks Group",139000,139000,0,0
TIKI,o-to-xe-may-xe-dap,28142286,"Giá Treo Xe Đạp Feedback Sports Velo Wall Rack 2D",1400000,1400000,0,0
TIKI,o-to-xe-may-xe-dap,76406136,"Máy Hút Bụi Xiaomi Vacuum Cleaner Mini (BHR4562GL) - Hàng Chính Hãng",1340000,1340000,0,0
TIKI,o-to-xe-may-xe-dap,127803133,"Túi treo đồ sau ghế ô tô Tâm Luân có lớp cách nhiệt, khoang đồ rộng, chất liệu vải vinylon TÂM LUÂN Chổi lau tẩm dầu - Hàng chính hãng",75000,100000,25000,25
TIKI,o-to-xe-may-xe-dap,31140597,"Gạt mưa Bosch Advantage Honda City 26" 14" (Đen)",270000,270000,0,0
TIKI,o-to-xe-may-xe-dap,110146493,"Móc Treo Đồ Gắn Sau Ghế Ô Tô Xe Hơi Tiện Lợi Giá Rẻ (loại tốt, giá tiền 1 cặp) ",9900,9900,0,0
TIKI,o-to-xe-may-xe-dap,4677439,"Bộ pha đèn xe Win 100",199000,199000,0,0
TIKI,o-to-xe-may-xe-dap,2378255,"Vệ Sinh Xăng VOLTRONIC G20 VALVE & INJECTOR CLEANER (300ml)",299000,299000,0,0
TIKI,o-to-xe-may-xe-dap,112587887,"Bộ 4 Rèm Che Nắng Huyndai Accent 2021 2022 - Che Nắng Nam Châm Accent 2021/2022",322050,339000,16950,5
TIKI,o-to-xe-may-xe-dap,95470531,"Ví đựng giấy tờ xe ô tô dành cho hãng xe Kia",25000,25000,0,0
TIKI,o-to-xe-may-xe-dap,51909068,"KẸP ẮC QUY CHUYỂN ĐỔI SANG TẨU 12V TRÊN Ô TÔ",25000,25000,0,0
TIKI,o-to-xe-may-xe-dap,42694494,"Lót Cốp Nhựa TPO Cao Cấp Dành Cho Santafe 2019/2020",281000,288000,7000,2
TIKI,o-to-xe-may-xe-dap,49549712,"Chai Dung Dịch Lấp Vết Xước Mâm Xe Ô Tô Wheel Touch Up Paint Silver W-62 SOFT99 Japan 12ml",150000,200000,50000,25
TIKI,o-to-xe-may-xe-dap,143656317,"Mũ Bảo Hiểm Nửa Đầu Họa Tiết Cặp Đôi Màu Trắng Kèm Kính Thời Trang Chính Hãng B'COLOR",195000,260000,65000,25
TIKI,o-to-xe-may-xe-dap,192288771,"Miếng Dán Nẹp Cố Định Thảm Trải Sàn Oto",25000,25000,0,0
TIKI,o-to-xe-may-xe-dap,73633334,"Thảm lót sàn ô tô/thảm sàn cao su dành cho ô tô 4-5 chỗ",217000,228000,11000,5
TIKI,o-to-xe-may-xe-dap,169311351,"Phủ nano kính, chống bám nước trên kính ô tô Soft99 Glaco Roll On Max 10363 300ml",225000,300000,75000,25
TIKI,o-to-xe-may-xe-dap,15186836,"Gạt mưa cho xe ô tô Bosch AeroTwin 26 inch – 650mm",340000,340000,0,0
TIKI,o-to-xe-may-xe-dap,129575444,"COMBO nước làm mát xe ô tô màu xanh Maxcool Can 4 Lít + 1 lít",139000,139000,0,0
TIKI,o-to-xe-may-xe-dap,28753036,"Nón Bảo Hiểm Andes 3S139 Lót Tháo Rời",370000,440000,70000,16
TIKI,o-to-xe-may-xe-dap,98675166,"Xe Máy SYM PASSING 50",24800000,24800000,0,0
TIKI,o-to-xe-may-xe-dap,36025030,"Thảm sàn cao su dành cho ô tô MAZDA 2",640000,656000,16000,2
TIKI,o-to-xe-may-xe-dap,77870719,"Phụ gia nhớt động cơ MOS2 Liqui Moly 2500",282000,289000,7000,2
TIKI,o-to-xe-may-xe-dap,143752664,"Thùng chứa đựng đồ đa năng có thể gấp gọn tiện dụng để cốp ô tô  xe hơi dung tích 56L",200000,227000,27000,12
TIKI,o-to-xe-may-xe-dap,10230827,"Bộ 02 tấm Màn che nắng phim cách nhiệt dán trực tiếp kính bên xe hơi, ô tô",39000,39900,900,2
TIKI,o-to-xe-may-xe-dap,119719079,"Ắc Quy Lưu Điện OUTDO OT2.2-12 (12V - 2.2AH) - Bình Ắc Quy 12V",277000,277000,0,0
TIKI,o-to-xe-may-xe-dap,66927978,"Bộ vè mưa đen Thái cao cấp dành cho xe Toyota Fortuner đời 2013 - 2015",283000,290000,7000,2
TIKI,o-to-xe-may-xe-dap,68478859,"Bình ắc quy UPS siêu nhỏ EAGLE 12V - 3.3Ah (EG3.3-12)",284000,284000,0,0
TIKI,o-to-xe-may-xe-dap,67730163,"Ngăn chứa đồ tiện dụng tích hợp Dock sạc  dùng trên xe hơi Baseus Deluxe Metal Armrest Console Organizer(2 USB charging port, Cup holder for Car)Hàng nhập khẩu",400000,410000,10000,2
TIKI,o-to-xe-may-xe-dap,94530408,"Vỏ khuếch tán tinh dầu đa năng gắn trên Ô Tô Máy Lạnh Cánh Quạt giúp khuếch tán tinh dầu VEMODA",33000,33000,0,0
TIKI,o-to-xe-may-xe-dap,70781040,"Đèn sau led gắn được cho xe đạp và nón bảo hiểm Jett Marz",99000,99000,0,0
TIKI,o-to-xe-may-xe-dap,16981545,"Dung Dịch Làm Sạch Khoang động Cơ Ekokemika Bio 35 - (1l) - Hàng Chính Hãng",179000,179000,0,0
TIKI,o-to-xe-may-xe-dap,57668023,"Bộ nâng kích gầm điện ô tô, xe hơi công suất 120W, điện áp 12V, tải trọng 3000 kg TY-42EJ",1596000,1596000,0,0
TIKI,o-to-xe-may-xe-dap,111363919,"Thảm Taplo Da Carbon Dành Cho Xe Mitsu Attrage 2018 2019 2020 2021",218000,248000,30000,12
TIKI,o-to-xe-may-xe-dap,68142901,"Thùng đựng đồ Ô Tô để cốp có thể gập gọn có nắp đậy, dùng để đựng đồ chơi trẻ em, đồ đi chợ, siêu  thị, đồ chơi khi đi dã ngoại hay pic nic để xe bạn gọn gàng hơn khi di chuyển - dung tích55L",222000,288000,66000,23
TIKI,o-to-xe-may-xe-dap,13567608,"Bộ 4 miếng dán chống va đập trầy xước cửa xe",24900,24900,0,0
TIKI,o-to-xe-may-xe-dap,165245165,"Mũ bảo hiểm 1/2 Royal M156K thiết kế nhỏ gọn, nhiều màu sắc, phù hợp mọi độ tuổi",400000,400000,0,0
TIKI,o-to-xe-may-xe-dap,873494,"Bút lấp vết xước sơn ô tô, xe máy màu đen Kizu Pen Black BP-61 Soft99",165000,220000,55000,25
TIKI,o-to-xe-may-xe-dap,75709076,"Dưỡng nhựa nhám Megacools MO + SHINE chống nắng, bảo vệ, phục hồi nhựa nhám,da yên nội thất xe 150ML",82000,82000,0,0
TIKI,o-to-xe-may-xe-dap,90981002,"ĐÈN LED HẮT GẦM XE Ô TÔ - CẢM ỨNG NHẠC",185000,185000,0,0
TIKI,o-to-xe-may-xe-dap,141201977,"Thanh Gạt Nước Sau Vinfast Lux SA, Ford Everest (2017-2022) - Bosch H301",202000,202000,0,0
TIKI,o-to-xe-may-xe-dap,1378107,"Dung Dịch Tẩy Và Làm Sạch Đánh Bóng Inox 3M Stainless Steel Cleaner & Polish 10Oz (283g)",195000,195000,0,0
TIKI,o-to-xe-may-xe-dap,3855991,"Kính Bulldog Bubble",199000,199000,0,0
TIKI,o-to-xe-may-xe-dap,142872063,"Găng tay dài ngón Pro-Biker",135000,135000,0,0
TIKI,o-to-xe-may-xe-dap,75002722,"DUNG DỊCH PHỦ GẦM BẢO VỆ GẦM XE Ô TÔ VỚI CHẤT CHỐNG ĂN MÒN ANTICRO HIỆU Senfineco 9975, 650ml (anticor Underbody protection)",290000,290000,0,0
TIKI,o-to-xe-may-xe-dap,107458102,"Tấm che nắng cánh cửa ô tô - cao su non cửa bên ô tô - Tự hút không cần đế hích",47000,49000,2000,4
TIKI,o-to-xe-may-xe-dap,58684955,"Lõi Lọc Cho Máy Lọc Không Khí AIR-Q Pure Aria Q58-I",153000,180000,27000,15
TIKI,o-to-xe-may-xe-dap,136187541,"RÈM CHE NẮNG NAM CHÂM CHO XE MITSUBISHI ATTRAGE",224000,248000,24000,10
TIKI,o-to-xe-may-xe-dap,68826518,"Ốp Chống Trầy Cốp Ngoài Nhựa Đen Dành Cho Ô Tô Innova 2017-2020 Mẫu 1",365000,365000,0,0
TIKI,o-to-xe-may-xe-dap,21025783,"Bộ Gối Đầu Và Tựa Lưng Cao Su Non Trên Xe Hơi Cao Cấp Lucky Bobi AZONE",235000,235000,0,0
TIKI,o-to-xe-may-xe-dap,21382484,"Túi Treo đồ trên ô tô, tấm da để đồ sau ghế ô tô  LT110",239000,239000,0,0
TIKI,o-to-xe-may-xe-dap,884804,"Nón Bảo Hiểm Lưỡi Trai 1/2 Đầu Tem V2 Màu Trắng Napoli N077-V2TR-LT",151000,299000,148000,49
TIKI,o-to-xe-may-xe-dap,174312261,"Dầu nhớt xe số Castrol Power 1 Ultimate 4T 10W-30 1Lit",185000,185000,0,0
TIKI,o-to-xe-may-xe-dap,36861623,"Thảm da Taplo vân carbon Cao cấp dành cho xe Vinfast Fadil",180000,184503,4503,2
TIKI,o-to-xe-may-xe-dap,142869747,"Găng tay da chính hãng LS2 Rust Man đi xe máy",1200000,1200000,0,0
TIKI,o-to-xe-may-xe-dap,186818218,"Túi gắn gọc yên xe đạp GIANT 063 chống thấm nước, tích hợp đèn hậu và túi đựng bình nước",390000,390000,0,0
TIKI,o-to-xe-may-xe-dap,149425217,"[ MAZDA CX 5 ] Bạt Phủ xe ô tô Mazda cx5 áo trùm che phủ xe 4 chỗ đến 7 chỗ, 2 lớp chống nóng mưa xước sơn BPX",366000,366000,0,0
TIKI,o-to-xe-may-xe-dap,68326495,"Túi treo đầu xe đạp nhiều ngăn Goinglink GN01 (Đen) - tặng kèm bọc túi chống nước",150000,198000,48000,24
TIKI,o-to-xe-may-xe-dap,74045376,"Chai Xịt Làm Bóng, Mờ Vết Xước Vỏ Xe Nhựa, Kim Loại, Sơn Ipone Cleaner Polish (100ml) - Hàng Chính Hãng",120000,120000,0,0
TIKI,o-to-xe-may-xe-dap,102445525,"️ĐỦ HÃNG️Bọc Vô Lăng D Cut Cacbon Phối Da Thoáng Khí Kèm Sọc  Đỏ Thể Thao",125000,138998,13998,10
TIKI,o-to-xe-may-xe-dap,195245574,"BÀN ĐẠP GIANT – HILL CARBON",890000,890000,0,0
TIKI,o-to-xe-may-xe-dap,37120616,"Bộ Ốp bậc cửa, Nẹp bước chân Titan dành cho xe KIA Soluto",150000,166400,16400,10
TIKI,o-to-xe-may-xe-dap,107177419,"Hàng Cao Cấp Chính Hãng Nước Hoa Ô Tô Xe Hơi Nhập Khẩu ETONNER Khử Mùi E1801G (60ml)",980000,980000,0,0
TIKI,o-to-xe-may-xe-dap,190863497,"GIỎ XE ĐẠP ĐIỆN THÉP CACBON HOMESHEEL",319000,420000,101000,24
TIKI,o-to-xe-may-xe-dap,50710153,"Bạt Phủ Ô Tô 4 Chỗ - 7 Chỗ - Bán Tải - Bạt Phủ Trùm Xe Ô Tô + Quà Tặng Túi Thơm Hình Cây Thông Treo Xe",239000,295000,56000,19
TIKI,o-to-xe-may-xe-dap,153941033,"Thảm sàn, lót sàn cao su 3D cho Toyota Fotuner 2017-2019",768000,788000,20000,3
TIKI,o-to-xe-may-xe-dap,59509368,"Ví Da Đựng Đăng Kiểm, bảo hiểm, Giấy Tờ Cho Ô tô",25000,25000,0,0
TIKI,o-to-xe-may-xe-dap,30034916,"Bảng số dạ quang Moonlight Box Series Temporary Parking Number Plate dùng cho xe hơi ( Nam châm, hợp kim nhôm cao cấp) - Hàng Chính Hãng",109000,114500,5500,5
TIKI,o-to-xe-may-xe-dap,101972212,"BỘ 4 CHẮN BÙN DÀNH CHO BÁNH XE CITY 2014-2020",154000,158000,4000,3
TIKI,o-to-xe-may-xe-dap,1254629,"Nano Bảo Vệ Động Cơ Cao Cấp Bluechem Nano Engine Super Protection (250ml)",346000,355000,9000,3
TIKI,o-to-xe-may-xe-dap,185188310,"Vệ sinh kim phun buồng đốt cao cấp cho máy xăng SENFINECO 9997",320000,320000,0,0
TIKI,o-to-xe-may-xe-dap,41457537,"Chai xịt chăm sóc và bảo dưỡng nội thất ô tô 3M 39040 (Hàng Mỹ) tặng kèm khăn lau ô tô chuyên dụng 3M màu ngẫu nhiên",300000,300000,0,0
TIKI,o-to-xe-may-xe-dap,97990882,"Thảm Lót Sàn Ô Tô Vinfast Lux A 2.0 - Phiên Bản KATA Pro viền ép nhiệt",2990000,2990000,0,0
TIKI,o-to-xe-may-xe-dap,152738354,"Mũ bảo hiểm 3/4 size XL Royal M139 - Hàng chính hãng - Xanh tím ",499000,499000,0,0
TIKI,o-to-xe-may-xe-dap,171693017,"Lót cốp dành cho Hyundai i10 Hatchback 2021 - 2022 chất liệu TPO cao cấp",327000,335000,8000,2
TIKI,o-to-xe-may-xe-dap,141917366,"Bạt Che Phủ Xe Suzuki XL7 Cao Cấp(Phiên bản 2021)",428000,439000,11000,3
TIKI,o-to-xe-may-xe-dap,24765495,"Gối tựa lưng xe ô tô , xe hơi V2 chất liệu cao su non cao cấp.",269000,290000,21000,7
TIKI,o-to-xe-may-xe-dap,51112351,"BÌNH PHUN NƯỚC RỬA Ô TÔ XE MÁY TẠO ÁP LỰC CẦM TAY EPOCA VITON MADE IN ITALY",399000,399000,0,0
TIKI,o-to-xe-may-xe-dap,171696637,"Hộp Tỳ Tay Cao Cấp Xịn Cho Xe Vinfast Fadil Loại 1 hàng đắt",430000,488000,58000,12
TIKI,o-to-xe-may-xe-dap,177335745,"Tinh Dầu Vỏ Quế TTAUTO Treo Xe ô tô, Treo Tủ Quần Áo, Treo Phòng Giúp Khử Mùi, Thơm Phòng, Thư Giãn Tinh Thần, Chống Say Xe Hiệu Quả",55000,55000,0,0
TIKI,o-to-xe-may-xe-dap,116407620,"THẢM TAPLO DA VÂN CARBON CAO CẤP XE XPANDER",281000,288000,7000,2
TIKI,o-to-xe-may-xe-dap,155656499,"Baga Cặp Hông Givi SBL Cho Xe WINNER 150/WINNER X Chắc Chắn Dùng Lắp Thùng Hông Hàng Chính Hãng",1265000,1265000,0,0
TIKI,o-to-xe-may-xe-dap,106053928,"Tẩu sạc ô tô mở rộng, sạc nhanh công suất cao Baseus 120w 2 cổng U+C- Hàng chính hãng",255000,268000,13000,5
TIKI,o-to-xe-may-xe-dap,65468676,"NƯỚC VỆ SINH NỘI THẤT Ô TÔ [ Bình xịt 511ml ]",109000,119000,10000,8
TIKI,o-to-xe-may-xe-dap,178787766,"Bọc yên xe đạp GIANT loại to, dày (Hàng chính hãng)",390000,390000,0,0
TIKI,o-to-xe-may-xe-dap,1254645,"Vệ Sinh Họng Bướm Ga Bluechem Throttle Body Cleaner (280ml)",170000,170000,0,0
TIKI,o-to-xe-may-xe-dap,10676797,"Gel nano bảo dưỡng và phục hồi nhựa không sơn Sonax Xtreme Plastic Restorer Gel 250ml",289000,289000,0,0
TIKI,o-to-xe-may-xe-dap,16567363,"Bể rửa siêu âm rửa kim phun xăng điện tử",2106000,2106000,0,0
TIKI,o-to-xe-may-xe-dap,76055377,"3 Bộ Khóa Nối Mắt Xích Xe Đạp Master Link 6/7/8S - 9S - 10S Mai Lee",19000,19000,0,0
TIKI,o-to-xe-may-xe-dap,115251224,"Ô Che Nắng Kính Lái Ô Tô Cao Cấp",106000,109000,3000,3
TIKI,o-to-xe-may-xe-dap,34716708,"Gương Gắn Kính Quan Sát Ghế Sau Xe Ô Tô",65000,65000,0,0
TIKI,o-to-xe-may-xe-dap,171695212,"Lót cốp nhựa dẻo cho xe Honda City 2014 đến 2021",344000,362000,18000,5
TIKI,o-to-xe-may-xe-dap,102163945,"Pin thay thế Remote Smartkey ôtô, xe máy, thiết bị y tế Mã Cr2032",30000,30000,0,0
TIKI,o-to-xe-may-xe-dap,5945627,"Ốp vỏ chìa khóa xe Hyundai Elantra , Tucson, Grand i10",137000,155500,18500,12
TIKI,o-to-xe-may-xe-dap,177310940,"Bộ ốp bậc cửa trong ngoài nẹp bước chân Innova 2017-2018-2019-2020-2021-2022 Inox chống trầy trang trí xe",149000,149000,0,0
TIKI,o-to-xe-may-xe-dap,65372761,"LÓT CỐP XE FORTUNER phù hợp các đời xe",300000,308000,8000,3
TIKI,o-to-xe-may-xe-dap,122831855,"Lót Cốp Nhựa Dẻo Theo Xe dành cho Suzuki XL7 2020-2021, XL-7 Cao Cấp Chống Nước",254000,261000,7000,3
TIKI,o-to-xe-may-xe-dap,3008211,"Móc treo đồ sau ghế trên ô tô",13200,13200,0,0
TIKI,o-to-xe-may-xe-dap,48165324,"Mỡ bò bôi trơn chịu nhiệt dạng chai xịt Liqui Moly Tacky Lube-Spray 2518 400ml",200000,225000,25000,11
TIKI,o-to-xe-may-xe-dap,101908125,"Thú bông nhồi than hoạt tính khử mùi, thú bông  ngủ dễ thương trang trí taplo ô tô, xe hơi, bàn làm việc",237000,249000,12000,5
TIKI,o-to-xe-may-xe-dap,76694931,"Baga cảng sau Inox xe Wave RSX RS S110 Sirius Wave Alpha Green Networks Group",159000,159000,0,0
TIKI,o-to-xe-may-xe-dap,5560723,"Combo Bộ nạy lốp xe đạp Zefal 3 màu",50000,50000,0,0
TIKI,o-to-xe-may-xe-dap,53229205,"BỌC CHÌA KHOÁ VESPA - CHÍNH HÃNG KHẮC TÊN",200000,200000,0,0
TIKI,o-to-xe-may-xe-dap,188318718,"Gương Cầu Lồi Chiếu Hậu Chống Điểm Mù Cho Ô Tô Xe Hơi  - Hàng Chính Hãng",73675,130000,56325,43
TIKI,o-to-xe-may-xe-dap,21572351,"Mũ bảo hiểm doraemon đáng yêu 3D kèm chong chóng",129000,129000,0,0
TIKI,o-to-xe-may-xe-dap,94678616,"Gối tựa đầu ô tô chất cao su non đúc nguyên khối bọc da cao cấp cho xe hơi ghế văn phòng siêu đàn hồi",178000,193000,15000,8
TIKI,o-to-xe-may-xe-dap,22245407,"Tẩy ố mốc kính xe hơi WAXCO 250ml",240000,240000,0,0
TIKI,o-to-xe-may-xe-dap,136201394,"Thùng đựng đồ ô tô - thùng đựng đồ gấp gọn đa năng 56 lít cao cấp",265000,265000,0,0
TIKI,o-to-xe-may-xe-dap,102096409,"Bọc vô lăng TTAUTO cho xe ô tô từ 4 đến 7 chỗ chất liệu da vân carbon cao cấp có logo MAZDA (Đen)",250000,250000,0,0
TIKI,o-to-xe-may-xe-dap,195666641,"Dung dịch vệ sinh và làm trong kính lái đậm đặc 1:100 Sonax 271141 250ml- tặng 1 khăn lau 3M màu ngẫu nhiên - rửa đèn pha XENON, đèn Plastic, tẩy vết côn trùng, các hạt nano làm trong kính, bảo vệ kính, không tạo vết sau khi gạt nước",228000,228000,0,0
TIKI,o-to-xe-may-xe-dap,35594858,"Kính chiếu hậu Tròn Rizoma 1 cái bên trái BẢO LONG RACING",105000,105000,0,0
TIKI,o-to-xe-may-xe-dap,38269623,"KHÓA DÂY XE ĐẠP MASTERLOCK 8228EURD",388000,428000,40000,9
TIKI,o-to-xe-may-xe-dap,49745372,"Cần gạt nước mưa xương mềm Bosch AEROFIT và Evolution dùng cho xe 4 -5 đến 7 chỗ kích thước 14 inch đến 26 inch",205000,205000,0,0
TIKI,o-to-xe-may-xe-dap,106053846,"Tẩu sạc ô tô nối dài, mở rộng, sạc nhanh công suất cao Baseus 120w 3 cổng U+U+C- Hàng chính hãng",425000,425000,0,0
TIKI,o-to-xe-may-xe-dap,2050493,"Băng keo cường lực siêu dính 3M 4229P-24 24mm x 10m",180000,180000,0,0
TIKI,o-to-xe-may-xe-dap,115720891,"Miếng Lót Ghế Chống Nóng Lưng, Đệm Lót Ghế Xe Hơi, Ôtô, 2 Mặt Lưới Trúc Massage Lưng, Chống Mỏi, Chống Nóng Hiệu Quả",130000,130000,0,0
TIKI,o-to-xe-may-xe-dap,22975262,"DUNG DỊCH VỆ SINH HỆ THỐNG DÀN LẠNH - ĐIỀU HÒA Ô TÔ 3M AIR CONDITIONER CLEANER FOAM 250ML",162000,162000,0,0
TIKI,o-to-xe-may-xe-dap,102446029,"Hộp Đựng Khăn Giấy Trên ô Tô Có Đồng Hồ Và Bảng Số điện Thoại Cao Cấp (Kèm Video thực tế)",233000,245000,12000,5
TIKI,o-to-xe-may-xe-dap,118299027,"Giá đỡ điện thoại xe đạp GIANT bằng nhôm nhẹ (Chính Hãng)",290000,290000,0,0
TIKI,o-to-xe-may-xe-dap,119719132,"MÁY SẠC ẮC QUY ROBOT TĂNG GIẢM 20A (12V-24V, DÂY ĐỒNG)",1951000,1951000,0,0
TIKI,o-to-xe-may-xe-dap,19560263,"Rèm che nắng kính lái ô tô cao cấp QL-70 dùng cho xe Sedan và SUV",133000,153200,20200,13
TIKI,o-to-xe-may-xe-dap,172948920,"MÓC TREO ĐỒ EXCITER",365237,365237,0,0
TIKI,o-to-xe-may-xe-dap,52170044,"THẢM TAPLO TOYOTA INNOVA Đời",185000,194500,9500,5
TIKI,o-to-xe-may-xe-dap,135008806,"Vệ sinh tẩy dầu nhớt sên líp xe đạp BIO DEGRASER 1 lít  ZEFAL",399000,399000,0,0
TIKI,o-to-xe-may-xe-dap,25555995,"Gối tựa đầu xe hơi, ô tô  chất liệu cao su non cao cấp V2",149000,149000,0,0
TIKI,o-to-xe-may-xe-dap,71675262,"Bộ 8 Ốp Tay Nắm Hõm Cửa Dành Cho Xe Ô Tô City 2015 2016 2017 2018 2019 2020 Vân Cacbon",298000,306000,8000,3
TIKI,o-to-xe-may-xe-dap,49926935,"Tinh Dầu Bạc Hà KOBI 30ml Nguyên Chất Tặng Kèm Vỏ Lọ Treo Khuếch Tán Tinh Dầu Siêu Tiện Dụng, Dùng Treo Xe Hơi, Treo Phòng, Treo Tủ Quần Áo, Giúp  Xua Đuổi Côn Trùng Và Khử Mùi Hiệu Quả",126000,220000,94000,43
TIKI,o-to-xe-may-xe-dap,14340750,"Bộ 2 gương chiếu hậu toàn cảnh cho ô tô Baseus Full-Vision Blind-Spot Car Miror - Hàng nhập khẩu.",84000,89000,5000,6
TIKI,o-to-xe-may-xe-dap,56653876,"Đèn Led Xoay Chớp Cảnh Báo To Nhỏ Có Dây Cắm Tẩu Sạc Dành Chô Ô Tô 12-24V",265000,265000,0,0
TIKI,o-to-xe-may-xe-dap,141503321,"Mũ bảo hiểm 3/4 có kính BULLDOG Pom tặng khóa chống trộm - Hàng Chính Hãng",1099000,1099000,0,0
TIKI,o-to-xe-may-xe-dap,141917337,"Bạt Phủ xe Ô Tô Mitsubishi Xpander Chỗ Vải Dù OXFORD Siêu Bền, Bạt Trùm Xe Hơi Chống Nắng Mưa Bảo Vệ Xe",228000,263000,35000,13
TIKI,o-to-xe-may-xe-dap,3151311,"Dung Dịch Dưỡng Đen Bóng Lốp Ô Tô Focar Tire Care (500ml)",167000,175000,8000,5
TIKI,o-to-xe-may-xe-dap,22011064,"Bộ 2 Chốt Khóa An Toàn Logo ToYoTa",71000,73000,2000,3
TIKI,o-to-xe-may-xe-dap,107356218,"Túi treo sườn xe đạp, túi treo xe đạp cảm ứng chống thấm nước tiện dụng",150000,150000,0,0
TIKI,o-to-xe-may-xe-dap,85804985,"Thảm Taplo Da Vân Carbon Cao Cấp Cho Xe Ô Tô Toyota Corolla Cross - thảm da loại 1",242000,248000,6000,2
TIKI,o-to-xe-may-xe-dap,4405935,"Ruột xe đạp Schwalbe 27.5+ SV40 (54/75-584)",250000,250000,0,0
TIKI,o-to-xe-may-xe-dap,10279824,"Nón Bảo Hiểm Giro Fixture",1200000,1200000,0,0
TIKI,o-to-xe-may-xe-dap,84441760,"Combo 2 ruột săm xe đạp 26x1.75/2.125 FV 43mm (van Pháp) DELI-TIRE",140000,140000,0,0
TIKI,o-to-xe-may-xe-dap,13373117,"Mũ Bảo Hiểm Royal M139T V10",550000,730000,180000,25
TIKI,o-to-xe-may-xe-dap,120338569,"Bộ khẩu thông minh mở siết ốc và bugi 40 chi tiết ",95000,95000,0,0
TIKI,o-to-xe-may-xe-dap,57475488,"Gạt Mưa Ô Tô Blaupunkt Premium  Chính Hãng 20"/500mm ",159600,168000,8400,5
TIKI,o-to-xe-may-xe-dap,88021118,"Chai xịt vệ sinh sên, bôi trơn, chống rỉ đa năng SPARKO X5 400ml",69000,69000,0,0
TIKI,o-to-xe-may-xe-dap,68081900,"THẢM TAPLO SUZUKI XL7 CHẤT LIỆU NHUNG MỊN 3 LỚP CHỐNG TRƯỢT CAO CẤP",243000,249000,6000,2
TIKI,o-to-xe-may-xe-dap,19374938,"Ốp Tay và Hõm Cửa mạ Crom dành cho xe Mazda 6",126000,133000,7000,5
TIKI,o-to-xe-may-xe-dap,59307420,"Chân chống xe đạp bắt hai ốc sau trên ống sên 2-bolts direct mount Jett ",299000,299000,0,0
TIKI,o-to-xe-may-xe-dap,34480150,"Nẹp viền chống va đập , ốp viền cửa ô tô gioăng cao su cuộn dài 5m",59000,62000,3000,5
TIKI,o-to-xe-may-xe-dap,25914840,"Ví đựng giấy tờ ô tô có logo theo xe,logo hyundai",24000,59000,35000,59
TIKI,o-to-xe-may-xe-dap,6771743,"Nón bảo hiểm 3/4 (Openface) Royal M139 Tem V5",550000,730000,180000,25
TIKI,o-to-xe-may-xe-dap,46105817,"[Tặng Lá Thơm] Che Nắng Ô Tô Cuộn Thông Minh CIND V-73 (73X55 cm)",157000,185000,28000,15
TIKI,o-to-xe-may-xe-dap,111463526,"Bao da chìa khóa xe MAZDA 2, MAZDA 3, MAZDA 6, MAZDA CX5 2018 2019 2020 2021",139000,139000,0,0
TIKI,o-to-xe-may-xe-dap,63178780,"Keo vá lốp (Super Valkarn) thương hiệu Maruni - Nhật bản (Lọ 100cc)",135000,135000,0,0
TIKI,o-to-xe-may-xe-dap,20157540,"Dụng cụ kiểm tra hơi lốp xe ô tô Total TTAC1406",450000,450000,0,0
TIKI,o-to-xe-may-xe-dap,50228200,"Phụ gia vệ sinh cảm biến oxy và bầu lọc khí thải catalytic Bluechem BC33230E",265000,265000,0,0
TIKI,o-to-xe-may-xe-dap,136187839,"RÈM CHE NẮNG NAM CHÂM CHO XE MAZDA CX5 2018-2021 ",242000,248000,6000,2
TIKI,o-to-xe-may-xe-dap,98823121,"Bộ kích nguồn dùng cho xe ô tô Baseus LV631-PR- Hàng chính hãng",1399899,1399899,0,0
TIKI,o-to-xe-may-xe-dap,97977863,"Thùng Rác Mini Cho Xe ô Tô màu đen sang trọng nhỏ gọn thông minh tiện lợi thùng rác VP",56000,63000,7000,11
TIKI,o-to-xe-may-xe-dap,194195137,"Xe địa hình bánh 26 khung nhôm VICKY VIC660 - Hàng chính hãng",3950100,3990000,39900,1
TIKI,o-to-xe-may-xe-dap,59210353,"Bộ 4 móc treo đồ tiện dụng trên xe OTOS-4C",31900,31900,0,0
TIKI,o-to-xe-may-xe-dap,56219089,"Bugi Xe Máy Chân Côn Bosch Cho Honda Sh (Ý) PSi @ Dylan Air Blade 110 Click 110",39000,39000,0,0
TIKI,o-to-xe-may-xe-dap,35129041,"Thảm Nhựa Lót Cốp Sau Dành Cho Xe Ô Tô Santafe 2019",300000,300000,0,0
TIKI,o-to-xe-may-xe-dap,84102728,"Bộ Kích Nâng Gầm Điện Kiêm Máy Bơm Lốp Và Máy Bắn Ốc Cho Ô Tô Đa Năng 4 Trong 1 Cao Cấp ROGTZ - Hàng Chính Hãng",2769000,2990000,221000,7
TIKI,o-to-xe-may-xe-dap,72967578,"Khóa dây xe đạp mã số chính hãng Abus - CHLB Đức",130000,143000,13000,9
TIKI,o-to-xe-may-xe-dap,48356289,"Nón Bảo Hiểm Giro Agilis",1850000,1850000,0,0
TIKI,o-to-xe-may-xe-dap,83346495,"Nón bảo hiểm 3/4 ROYAL M20C vàng nghệ bóng",342000,550000,208000,38
TIKI,o-to-xe-may-xe-dap,173556167,"Xe Máy Honda Winner X - Phiên Bản Đặc Biệt 2024",38935000,38935000,0,0
TIKI,o-to-xe-may-xe-dap,7971957,"Mũ Bảo Hiểm 1/2 Andes 3S109",370000,440000,70000,16
TIKI,o-to-xe-may-xe-dap,8561268,"Bộ 2 Gạt Mưa Bosch Aerotwin 24"-18" Cho Mazda 6",704000,704000,0,0
TIKI,o-to-xe-may-xe-dap,169130640,"Mỡ Bò Ráp Máy Maxima Assembly Grease 454gram Chính Hãng Nhập USA",400000,400000,0,0
TIKI,o-to-xe-may-xe-dap,73748596,"Đèn cảng 8 bóng lồi pha led sáng trắng dành cho mô tô, xe máy ,xe bán tải , xe lôi Green Networks Group",199000,199000,0,0
TIKI,o-to-xe-may-xe-dap,177301748,"Vè mưa Chevrolet Spark vè đen che mưa bảo vệ trang trí xe",251000,251000,0,0
TIKI,o-to-xe-may-xe-dap,109263788,"Mặt nạ xe SH 150 đời 2020 kiểu 3 sọc xi Green Networks Group",199000,199000,0,0
TIKI,o-to-xe-may-xe-dap,32593811,"Lốp Xe Điện 300-10 Không Dùng Săm",240000,240000,0,0
TIKI,o-to-xe-may-xe-dap,119719077,"Bình ắc quy khô GLOBE WP7A-BS 12V-7AH ắc quy lùn thấp dành cho xe máy Atila, Spacy ,Vespa, Zip, Môtô",440000,440000,0,0
TIKI,o-to-xe-may-xe-dap,74541648,"Meguiar's Combo tự phủ bóng Ceramic tại nhà (4 sản phẩm)",1100000,1100000,0,0
TIKI,o-to-xe-may-xe-dap,172042500,"Bộ 4 Khăn lau ô tô Cao Cấp đa năng không để lại bụi vải, không để lại vệt nước, không phai màu (2 cái 30x30 + 2 cái 30x60)- Hàng chính hãng",76000,76000,0,0
TIKI,o-to-xe-may-xe-dap,160589459,"Vè che mưa dành cho xe Ford Everest",320000,328000,8000,2
TIKI,o-to-xe-may-xe-dap,146563103,"Bạt trùm xe loại tốt oto 4 chỗ City, Accent, Mazda 2, Vios",355000,364000,9000,2
TIKI,o-to-xe-may-xe-dap,82103339,"Bạt phủ xe ô tô, xe hơi chất liệu Oxford - Bạt trùm xe ô tô dày 3 lớp",248000,261282,13282,5
TIKI,o-to-xe-may-xe-dap,41379905,"Xịt phòng khử mùi, đuổi côn trùng Tinh dầu xá xị (Combo 1 chai xịt 100ml và 1 lọ treo xe)",175000,175000,0,0
TIKI,o-to-xe-may-xe-dap,72921928,"Máy lọc không khí trên xe ô tôm, xe hơi cao cấp Philips GP9101 cảm biến thông minh 6 màu AQI - Hàng nhập khẩu",10102000,10102000,0,0
TIKI,o-to-xe-may-xe-dap,88003230,"Bơm mini đạp chân - Bơm đa năng - Bơm được xe đạp, xe máy, các loại bóng, phao",79000,79000,0,0
TIKI,o-to-xe-may-xe-dap,107366127,"Kẹp Sáp Thơm Cửa Gió Điều Hoà Khử Mùi Xe Ô Tô Cao Cấp Chính Hãng ETONNER N1831B Màu Đen",550000,550000,0,0
TIKI,o-to-xe-may-xe-dap,52335922,"Bảng số điện thoại kí tự số phản quang gắn taplo ô tô RM-131Z",17000,17000,0,0
TIKI,o-to-xe-may-xe-dap,114744999,"Gạt Mưa Không Xương VIAIR 323 (14 Inch/350 mm)",50000,59000,9000,15
TIKI,o-to-xe-may-xe-dap,25002938,"Ghé ngồi phụ  an toàn cho bé trên xe hơi, xe ô tô",275000,275000,0,0
TIKI,o-to-xe-may-xe-dap,55144895,"Ốp Trang Trí Gương Chiếu Hậu Mạ Crom Cho Xe Morning 2012-2019",215000,220900,5900,3
TIKI,o-to-xe-may-xe-dap,181772500,"Bạt Phủ Ô Tô VINFAST FADIL, LUX A 2.0, LUX SA 2.0, Chất Liệu Bạt Tráng Nhôm 3 lớp,  có phản quang",267000,328000,61000,19
TIKI,o-to-xe-may-xe-dap,100544296,"Dụng Cụ Mài, Sửa Chữa Làm Sạch Cần Gạt Nước Mưa Cho Xe Hơi ( Windshield Wiper Blade Repair )  Hàng Chính Hãng Baseus",127770,150000,22230,15
TIKI,o-to-xe-may-xe-dap,67271649,"Thảm chống nắng Taplo Nhung dành Cho xe Vinfast Fadil form 2019-2020",184000,188500,4500,2
TIKI,o-to-xe-may-xe-dap,1176329,"Mỡ Bò Nước Liqui Moly 2518 (400ml)",219000,225000,6000,3
TIKI,o-to-xe-may-xe-dap,56419282,"Nước Rửa Kính Ô Tô  Xglass Nano Thương Hiệu Ekokemika - Hàng Chính Hãng",62000,62000,0,0
TIKI,o-to-xe-may-xe-dap,35507945,"Sillicon Chống Kêu Cánh Cửa SONAX Silicone Spray 348300 (400 ml)",280000,280000,0,0
TIKI,o-to-xe-may-xe-dap,49989310,"Bộ Rèm Chắn Nắng Nam Châm Theo Xe Dành Cho Các Dòng Xe Ô Tô Kia",261000,261000,0,0
TIKI,o-to-xe-may-xe-dap,1338791,"Bảo Dưỡng Màu Đen Và Bóng Vỏ Xe FORMULA 1 615258 680ml",188000,221000,33000,15
TIKI,o-to-xe-may-xe-dap,116192113,"Tẩu sạc ô tô nối dài, mở rộng, sạc nhanh công suất cao Baseus 120w 4 cổng 2U+2C - 4 Port Baseus Share Together Extention Car Charger 120W (Extention up to 4 Port * 30W, QC/ PD/PPS Fast Charging)",351000,369500,18500,5
TIKI,o-to-xe-may-xe-dap,186634331,"Tinh Dầu Sả Chanh Treo Xe Hương Tự Nhiên Thư Giãn Tinh Thần, Tập Trung Lái Xe Hapaku",139000,139000,0,0
TIKI,o-to-xe-may-xe-dap,128588905,"Bố Thắng Trước Mitsubishi Pajero V33, V43, V45, V46, Lancer EX / Evolution - Bosch BP 5910",251000,251000,0,0
TIKI,o-to-xe-may-xe-dap,19749769,"Bộ 4 miếng dán chống đọng nước kính hông và gương chiếu hậu ô tô",49000,49000,0,0
TIKI,o-to-xe-may-xe-dap,147422705,"Thảm da Taplo vân carbon Cao cấp dành cho xe Toyota Vios 2019-2020-2021",174000,198000,24000,12
TIKI,o-to-xe-may-xe-dap,114744984,"Combo 2 Lưỡi Gạt Mưa Loại A VIAIR R15 (18 Inch/450 mm)",59000,69000,10000,14
TIKI,o-to-xe-may-xe-dap,195664634,"Kem đánh bóng, xóa xước và bảo vệ sơn xe ô tô 3in1 Sonax 202100 250ml - Tặng 1 khăn lau 3M màu ngẫu nhiên - phục hồi sơn cũ, xóa vết xước nhỏ và bảo vệ sơn xe toàn diện",288000,288000,0,0
TIKI,o-to-xe-may-xe-dap,54569497,"Túi đựng đồ treo khung xe đạp - tặng kèm chuông - T01",75000,75000,0,0
TIKI,o-to-xe-may-xe-dap,117975008,"Dây Curoa Cam (111XR17) Chevrolet Aveo 1.5, Daewoo Gentra, Lanos - Bosch 1082",249000,249000,0,0
TIKI,o-to-xe-may-xe-dap,93016113,"Nhớt động cơ Mobil 0W20 - Dầu nhớt Mobil nhập khẩu từ Mỹ",285000,285000,0,0
TIKI,o-to-xe-may-xe-dap,150385770,"Ốp bậc cốp, chống trầy cốp TOYOTA VIOS 2021 mẫu titan",200000,245000,45000,18
TIKI,o-to-xe-may-xe-dap,34317804,"LỌC GIÓ (Pô e) Trụ dành cho Exciter,Winner,Raider và các loại xe BẢO LONG RACING",125000,125000,0,0
TIKI,o-to-xe-may-xe-dap,76838460,"Vỉ miếng vá MU dùng cho lốp không săm thương hiệu Maruni - Sản xuất tại Nhật Bản",75000,75000,0,0
TIKI,o-to-xe-may-xe-dap,190855283,"Xe đạp đường phố Thống Nhất GN05-26 - Hàng chính hãng",2326500,2350000,23500,1
TIKI,o-to-xe-may-xe-dap,58616151," Chắn bùn xe Toyota Innova đời từ 2017-2019",185000,190000,5000,3
TIKI,o-to-xe-may-xe-dap,125735999,"Gối Tựa Đầu Cao Su Non Bọc Da CIND G003 Màu Kem",213000,251000,38000,15
TIKI,o-to-xe-may-xe-dap,49892166,"Tấm, miếng lót massage ghế xe ô tô,xe hơi, ghế văn phòng hạt gỗ tròn hương cao cấp 45x45 tạo cảm giác thoải mái khi ngồi chống mệt mỏi-DL01",115721,214000,98279,46
TIKI,o-to-xe-may-xe-dap,91118300,"Khung Giá Treo Xe Đạp Kẹp Sườn Xe Xếp Gọn Lên Tường Tiết Kiệm Không Gian (Max 20 kg) MaiLee",358150,377000,18850,5
TIKI,o-to-xe-may-xe-dap,102096621,"Bọc vô lăng TTAUTO cho xe ô tô từ 4 đến 7 chỗ chất liệu da vân carbon cao cấp có logo KIA (Đen)",250000,250000,0,0
TIKI,o-to-xe-may-xe-dap,58168281,"Nhớt Mobil super 10W40 (4.73 lít) - Nhớt Mobil nhập khẩu từ Mỹ",550000,550000,0,0
TIKI,o-to-xe-may-xe-dap,36020975,"Thảm lót sàn cao su dành cho ô tô Grand I10",430000,488000,58000,12
TIKI,o-to-xe-may-xe-dap,91751141,"Dung dịch chống bám nước trên kính xe 3M 08889LT Glass Coat Windshield (200ml) - Chống đọng nước trên gương kính đi mưa",185000,185000,0,0
TIKI,o-to-xe-may-xe-dap,172167205,"Phụ gia vệ sinh và dưỡng nhựa khoang lái Senfineco 9989",290000,290000,0,0
TIKI,o-to-xe-may-xe-dap,143225962,"Yên Xe Đạp, Đệm Yên Xe Đạp Thể Thao Siêu Êm, Chống Nước Có Đèn Phản Quang Ban Đêm",129000,129000,0,0
TIKI,o-to-xe-may-xe-dap,31569208,"Bình Dầu rời bonamiciracing BẢO LONG RACING",65000,65000,0,0
TIKI,o-to-xe-may-xe-dap,188634601,"Vỏ Lốp Xe Đạp 27x1 3/8 (37 - 630) Cho Xe Đạp Phổ Thông",89000,89000,0,0
TIKI,o-to-xe-may-xe-dap,186161663,"Ốp bậc cửa nẹp bước chân TITAN ô tô Mazda 3 2020-2021-2022 chống trầy bảo vệ xe",155000,155000,0,0
TIKI,o-to-xe-may-xe-dap,102629389,"Mạch Hazarad 2021 ( đèn ưu tiên ) cho các dòng xe - Mạch chớp xi nhan Hazard 2021 Green Networks Group ( 1 cái )",59000,59000,0,0
TIKI,o-to-xe-may-xe-dap,82459437,"Gối tựa lưng cao su non",290000,290000,0,0
TIKI,o-to-xe-may-xe-dap,189730260,"nhớt mobil 1",299000,299000,0,0
TIKI,o-to-xe-may-xe-dap,72655587,"Bộ 2 Móc Treo Đồ Sau Ghế Ô Tô Màu Đen Tiện Lợi",9000,9000,0,0
TIKI,o-to-xe-may-xe-dap,45876767,"Chổi quét bụi chăm sóc ô tô tĩnh điện Ihomeda ( 1 cán + 4 bông lau)",60000,60000,0,0
TIKI,o-to-xe-may-xe-dap,158849950,"COMBO NƯỚC RỬA XE KHÔNG CHẠM BIO 45-1L VÀ BÓNG LỐP BLACKBRILL -1L",339000,339000,0,0
TIKI,o-to-xe-may-xe-dap,37675583,"Phim Đề Can Dán Đèn Xe Ô Tô Tạo Màu Sắc Chống Xước 30x60cm Đen Nhạt",59000,59000,0,0
TIKI,o-to-xe-may-xe-dap,163148876,"Máy Hút Bụi Ô Tô Cầm Tay Không Dây Mini LEKIMA LCW-5000, Hút Bụi Ô Tô Sofa Giường Nệm Dùng Cho Gia Đình - Hàng Nhập Khẩu",373000,373000,0,0
TIKI,o-to-xe-may-xe-dap,154493900,"Tem Chữ Sports 3D Thể Thao Hợp Kim Nhôm Dán Trang Trí Ô Tô Xe Hơi",33000,34000,1000,3
TIKI,o-to-xe-may-xe-dap,10152406,"Giá Đỡ Điện Thoại Gắn Taplo Baseus SUYL-XP01",189000,189000,0,0
TIKI,o-to-xe-may-xe-dap,102446048,"Ví đựng giấy tờ xe in logo dành cho oto",23000,24000,1000,4
TIKI,o-to-xe-may-xe-dap,17039326,"Lá Thơm Xe Ô tô Areon Gold Amber",60000,60000,0,0
TIKI,o-to-xe-may-xe-dap,19253638,"Bọc vô lăng sợi carbon logo Chev",128000,131500,3500,3
TIKI,o-to-xe-may-xe-dap,24250942,"Đồng Hồ Mini Gắn Kính Xe Máy",79000,79000,0,0
TIKI,o-to-xe-may-xe-dap,67078643,"Bộ Ốp tay nắm cửa Mạ crom dành cho xe Kia Sedona 2016-2019",185000,190000,5000,3
TIKI,o-to-xe-may-xe-dap,73632753,"Cầu chì xe hơi ô tô loại 7.5W 10W 15W 20W 25W 30W 35W gắn cho dòng xe hơi Green Networks Group ( 1 Con )",30000,30000,0,0
TIKI,o-to-xe-may-xe-dap,117597919,"Bình xịt vệ sinh dàn lạnh điều hòa ô tô Bluechem Air Conditioner Cleaner 250ml",249000,249000,0,0
TIKI,o-to-xe-may-xe-dap,32970127,"Băng keo cường lực 3M 4229P (Đỏ) 24mmx10m",135000,142000,7000,5
TIKI,o-to-xe-may-xe-dap,12247625,"Ốp nhựa carbon, bọc bảo vệ chìa khóa xe Ford Everest 2018, Ranger 2018 kèm móc đeo INOX",199000,199000,0,0
TIKI,o-to-xe-may-xe-dap,177640677,"Cọ SGCB Vệ Sinh Rửa Mâm Xe Ô Tô và Mô Tô Size M SGGD018",89000,89000,0,0
TIKI,o-to-xe-may-xe-dap,102654157,"Đèn Led Gầm Ghế Ô Tô Loại 12 Mắt Có Điều Khiển Cao Cấp",165000,165000,0,0
TIKI,o-to-xe-may-xe-dap,24799482,"Máy Phát Nhạc Bluetooth MP3/SD/USB/ID3/Radio 60Wx4 Loại 1 Nút Vặn",320000,320000,0,0
TIKI,o-to-xe-may-xe-dap,68842349,"Che sên Carte cho xe Dream Wave Green Networks Group",69000,69000,0,0
TIKI,o-to-xe-may-xe-dap,37665227,"Bộ Vè Che Mưa Cao Cấp Cho xe Kia Sorento",262000,275900,13900,5
TIKI,o-to-xe-may-xe-dap,176592733,"Giá đựng bình nước xe đạp thể thao hợp kim nhôm Bikeboy B008-1",35000,65000,30000,46
TIKI,o-to-xe-may-xe-dap,11455717,"Bao da chìa khóa xe Toyota Altis, Fortuner 2016-2018 bản chìa gập - kèm móc khóa",122550,129000,6450,5
TIKI,o-to-xe-may-xe-dap,11596347,"Nước hoa kẹp cửa gió hương Spring Bouquet – Hoa Anh Đào (Dịu nhẹ)",256000,256000,0,0
TIKI,o-to-xe-may-xe-dap,98046153,"Ví Da Đựng Giấy Tờ Đăng Kiểm Xe Ô tô Logo HUYNDAI",25000,25000,0,0
TIKI,o-to-xe-may-xe-dap,104193131,"Gối tựa đầu ô tô Alcantara nhãn hiệu Macsim mã HR54AL",2400000,2400000,0,0
TIKI,o-to-xe-may-xe-dap,125803900,"Ắc quy Vision 6FM55-X 12V 55Ah",2260000,2260000,0,0
TIKI,o-to-xe-may-xe-dap,186162366,"Ốp chống trầy cốp trong INOX dành cho xe Vinfast Lux A 2020-2021-2022",279000,279000,0,0
TIKI,o-to-xe-may-xe-dap,58136902,"KÈN Ô TÔ CAO CẤP DENSO",550000,550000,0,0
TIKI,o-to-xe-may-xe-dap,68821825,"ỐP Viền Đèn Gầm Trước Xe Mạ Crom Dành Cho Xe Fortuner 2012-2016",190100,190100,0,0
TIKI,o-to-xe-may-xe-dap,35170764,"XÀ BÔNG RỬA XE TĂNG BÓNG ĐẬM ĐẶC CHEMICAL GUYS CITRUS WASH AND GLOSS 473ML",550000,550000,0,0
TIKI,o-to-xe-may-xe-dap,90520519,"Thanh gạt nước rửa xe hơi oto , lau kính nhà tắm lưỡi silicone siêu dẻo hàng cao cấp GM001",55000,75000,20000,27
TIKI,o-to-xe-may-xe-dap,42493295,"BỘ ỐP TAY CỬA MẠ VÂN CACBON DÀNH CHO XE MITSUBISHI XPANDER 2018-2019",180000,185000,5000,3
TIKI,o-to-xe-may-xe-dap,23347409,"Combo 10 viên sủi nước rửa kính ô tô Tặng 2 khăn lau ô tô siêu thấm",37000,37000,0,0
TIKI,o-to-xe-may-xe-dap,194807022,"Lọc gió động cơ Mercedes GLC 250 2015-2022",340000,340000,0,0
TIKI,o-to-xe-may-xe-dap,194845991,"Bộ 4 chắn bùn theo xe Toyota Veloz",261000,268000,7000,3
TIKI,o-to-xe-may-xe-dap,26254245,"Hộp tỳ tay ô tô dùng cho xe Toyota Rush và Toyota Avanza JDZX-RUSH",317000,325000,8000,2
TIKI,o-to-xe-may-xe-dap,196009509,"COMBO 2 Miếng Dán Chống Nước Gương Kính Ô tô Xe Máy Bộ Dán NANO Chống Mưa Mờ Kính - Hàng Loại 1 - Chính Hãng MINIIN",31080,44400,13320,30
TIKI,o-to-xe-may-xe-dap,92133031,"Bọc Vô Lăng Da dành cho Xe Suzuki Ertiga Lót Cao Su Non Cao Cấp Chống Trượt Tay",141000,145000,4000,3
TIKI,o-to-xe-may-xe-dap,21708949,"Bộ Dụng Cụ Mở Nội Thất Xe Ô Tô 12 Chi Tiết",59000,59000,0,0
TIKI,o-to-xe-may-xe-dap,153942407,"Bộ vè che mưa Hyundai Elantra 2016-2019 chỉ mạ Crom cao cấp",376000,386000,10000,3
TIKI,o-to-xe-may-xe-dap,119308580,"Túi hạt Cafe treo xe ô tô Hando 100g",75000,75000,0,0
TIKI,o-to-xe-may-xe-dap,195783394,"Chai xịt làm sạch bảo vệ khoang máy động cơ ô tô chuyên dụng Sonax 543200 500ml - tặng 1 khăn 3M màu ngẫu nhiên - Chống oxy hóa và ăn mòn, chống tĩnh điện, dùng được nhiều bề mặt, không để lại vết ố",238000,238000,0,0
TIKI,o-to-xe-may-xe-dap,152646935,"THẢM LÓT SÀN CAO SU ĐÚC DÙNG CHO XE FORD RANGER",476000,488000,12000,2
TIKI,o-to-xe-may-xe-dap,68745498,"Repsol Racing 10W40 1L - Nhớt tổng hợp 100% dành cho xe máy số, xe mô tô PKL",249000,249000,0,0
TIKI,o-to-xe-may-xe-dap,53006013,"Ắc Quy Motor Toplite YT12B 12V-10Ah",2062000,2062000,0,0
TIKI,o-to-xe-may-xe-dap,54674788,"Nước hoa oto Michelin gắn cửa thông gió mùi Coconut 32057 - Hàng chính hãng",109000,150000,41000,27
TIKI,o-to-xe-may-xe-dap,56730958,"Mũ Bảo Hiểm Xe Đạp Trẻ Em, Mũ Bảo Hiểm Chơi Thể Thao, Trượt Patin Trẻ Em Cao Cấp Protec SMILE 024 Họa Tiết Hello Kitty Dễ Thương - Hàng Chính Hãng",345000,438000,93000,21
TIKI,o-to-xe-may-xe-dap,51703757,"Hộp tỳ tay ô tô, xe hơi dùng cho xe Chevrolet Spark cao cấp JDZX-SPNK-D, kích thước đường kính đế ốp vào:  6.6cm, chất liệu sản phẩm : Nhựa ABS + da PU cao cấp, tích hợp khoang chứa đồ và ngăn để chai nước",320000,328000,8000,2
TIKI,o-to-xe-may-xe-dap,172167234,"phụ gia vệ sinh kim phun, buồng đốt máy dầu Senfineco 9916",490000,490000,0,0
TIKI,o-to-xe-may-xe-dap,28294625,"Nhớt bảo dưỡng sên cao cấp Zefal Nano Ceramic Extra 120ml",270000,270000,0,0
TIKI,o-to-xe-may-xe-dap,71142226,"Hộp để đồ đa năng gấp gọn cốp sau ô tô dung tích 55 lít, Kích thước: Sâu x Rộng x Cao (52cm x 35cm x 28cm), Màu đen, KM309-55",222311,222311,0,0
TIKI,o-to-xe-may-xe-dap,179232323,"Vè Che Mưa Hyundai I10 2021 2022 Hatback Xe Cộc",291000,298000,7000,2
TIKI,o-to-xe-may-xe-dap,54675286,"Dung dịch vệ sinh ngoại thất Michelin Fast Shine Wax 31951 - 650ml - Hàng chính hãng",156000,160000,4000,3
TIKI,o-to-xe-may-xe-dap,52229166,"Chai xịt bọt vệ sinh ghế da, nỉ hương chanh Liqui Moly 1539 - Tặng kèm 1 khăn lau chuyên dụng 3M",218000,218000,0,0
TIKI,o-to-xe-may-xe-dap,95573128,"10 Miếng dán phản quang phát sáng ban đêm cho xe ô tô giảm thiểu nguy cơ tai nạn ban đêm, miếng dán bằng nhựa và bằng decal phù hợp với mặt phẳng và mặt cong trên ô tô",29989,29989,0,0
TIKI,o-to-xe-may-xe-dap,58409086,"Combo 2 Bóng Đèn Sau 1 Tim OSRAM Original P21W 12V 21W (Chân Thẳng)",43000,51000,8000,16
TIKI,o-to-xe-may-xe-dap,49520192,"Đất Sét Chuyên Dụng Tẩy Bụi Kim Loại, Bột Sắt Ô Tô Smooth Egg Clay Bar W-513 Soft99 120g",187500,250000,62500,25
TIKI,o-to-xe-may-xe-dap,49113866,"Phụ Kiện Xe Đạp | Đèn Xe Đạp Kết Hợp Còi 7588 | Sạc USB Chống Nước |Độ Sáng 250 Lumen - Âm Vang Còi 140dB | Pin 1200 mah | Sáng Tối Đa 5 Giờ",109000,109000,0,0
TIKI,o-to-xe-may-xe-dap,11309656,"Bảng số điện thoại gắn táp lô ô tô khi đỗ xe CS",28500,28500,0,0
TIKI,o-to-xe-may-xe-dap,88737694,"Đệm cao su chống trầy gắn cửa dùng cho xe hơi Baseus Airbag Bumper Strip (bộ 4 cái, Trong suốt) - Hàng Chính Hãng",116119,116119,0,0
TIKI,o-to-xe-may-xe-dap,13295898,"Ghế Ngồi Phụ Dày Đa Năng Trên Xe Hơi, Ô Tô Bảo Vệ An Toàn Cho Bé AZONE",260000,350000,90000,26
TIKI,o-to-xe-may-xe-dap,81185355,"Túi trùm hàng hóa sau xe máy, Túi trùm chuyên dụng cho hàng hóa 80X80",150000,150000,0,0
TIKI,o-to-xe-may-xe-dap,127192045,"Nệm hơi ô tô xe hơi cao cấp loại 1 mặt nhung thoáng mát đế rời đi kèm bơm điện và bộ gối - Ghi Nhung",330000,338000,8000,2
TIKI,o-to-xe-may-xe-dap,38603722,"Bộ 4 chiếc nẹp chống va đập cánh cửa ô tô, xe hơi cao cấp BH-238-D",71000,75000,4000,5
TIKI,o-to-xe-may-xe-dap,122831827,"Combo 4 tấm che nắng ô tô",46000,47000,1000,2
TIKI,o-to-xe-may-xe-dap,50941445,"Vỏ / Lốp xe đạp loại gấp Schwalbe Lugano II Tire 700 x 28C (28-622)",575000,575000,0,0
TIKI,o-to-xe-may-xe-dap,786870,"Mũ Bảo Hiểm GRS A33K - Xanh Than Nhám",275000,275000,0,0
TIKI,o-to-xe-may-xe-dap,136187561,"RÈM CHE NẮNG NAM CHÂM CHO XE MITSUBISHI OUTLANDER",242000,248000,6000,2
TIKI,o-to-xe-may-xe-dap,72036345,"Bộ Khánh treo kính hậu Ngọc Bội Đá cẩm Thạch, Thiết kế Phong Thủy cho xe hơi, Xe Tải, Kèm hộp gấm lót Nhung nỉ",170000,179000,9000,5
TIKI,o-to-xe-may-xe-dap,89624314,"Túi Gắn Gác Yên Sau Xe Đạp Gác Yên Vân Carbon Cao Cấp Chất Liệu EVA MaiLee",208050,219000,10950,5
TIKI,o-to-xe-may-xe-dap,65389393,"Bộ chắn bùn xe Toyota Innova 2017-2019",180000,185000,5000,3
TIKI,o-to-xe-may-xe-dap,119067556,"Lọc nhiên liệu Mitsubishi - 32A6201020M - dùng cho xe nâng dầu",397000,397000,0,0
TIKI,o-to-xe-may-xe-dap,51697518,"Bạt Che Phủ Xe TOYOTA CAMRY Cao Cấp",311000,318945,7945,2
TIKI,o-to-xe-may-xe-dap,118298126,"Quần đạp xe ngắn GIANT UNDIES",735000,735000,0,0
TIKI,o-to-xe-may-xe-dap,186162639,"Ốp chống trầy cốp ngoài nhựa đen Fortuner 2017-2018-2019-2020-2021-2022 mẫu 1 chống xước trang trí xe",330000,338000,8000,2
TIKI,o-to-xe-may-xe-dap,165036810,"Lưới Lót Ghế Tựa Lưng Đan Hạt Gỗ Cao Cấp Trên Xe Ô Tô L2750",207000,207000,0,0
TIKI,o-to-xe-may-xe-dap,57007867,"Bộ rèm che nắng nam châm dành cho Mitsubishi Attrage thế hệ mới",252000,258600,6600,3
TIKI,o-to-xe-may-xe-dap,122831260,"Bộ vè Che Mưa Chỉ Inox Cao Câp dành cho Suzuki XL7 2020-2021",333000,378990,45990,12
TIKI,o-to-xe-may-xe-dap,11203861,"Combo 2 Gối Tựa Đầu Xe Hơi",76995,76995,0,0
TIKI,o-to-xe-may-xe-dap,172167250,"Phụ gia nhớt cao cấp bảo vệ động cơ Senfineco 9910",290000,290000,0,0
TIKI,o-to-xe-may-xe-dap,6501581,"Bạt phủ ô tô cách nhiệt cao cấp, bạt trùm xe hơi, chống nóng, chống nước vân 3D",238000,250000,12000,5
TIKI,o-to-xe-may-xe-dap,68562808,"Lõi Lọc Không Khí Blaupunkt - Lõi Lọc Thay Thế Của Máy Lọc Không Khí AP2.0",494000,520000,26000,5
TIKI,o-to-xe-may-xe-dap,1254659,"Kem Dưỡng Ghế Da Liqui Moly 1554 (250ml)",239000,245000,6000,2
TIKI,o-to-xe-may-xe-dap,49662730,"Bộ vè che mưa dành cho xe  Huyndai Kona viền chỉ mạ Crom cao cấp",338000,347000,9000,3
TIKI,o-to-xe-may-xe-dap,49525743,"Bút Lấp Vết Xước Ô Tô Kizu Pen Gun Metallic BP-60 Soft99 (7g) - Màu Nòng Súng",165000,220000,55000,25
TIKI,o-to-xe-may-xe-dap,195741378,"Nước hoa ô tô ETONNER cao cấp, Nước hoa xe hơi chính hãng thương hiệu Pháp",98000,98000,0,0
TIKI,o-to-xe-may-xe-dap,150783869,"Giá Đỡ Bình Nước Xe Đạp Siêu Nhẹ Gắn Cho Xe Đạp Thể Thao",25000,25000,0,0
TIKI,o-to-xe-may-xe-dap,117598599,"Ốp móc chìa khóa cacbon cao cấp cho xe Ranger XLS, Focus, Mazda BT50",232000,238000,6000,3
TIKI,o-to-xe-may-xe-dap,12481352,"Keo gắn chịu nhiệt dùng hàn đắp ống xả ô tô xe máy K2 mefix",191000,201000,10000,5
TIKI,o-to-xe-may-xe-dap,96653092,"Hàng Mới  Gioăng cao su chữ Z - Chống bụi , chống thoát nước chống ồn dành cho xe hơi Cuộn 10m",142000,157990,15990,10
TIKI,o-to-xe-may-xe-dap,43368794,"Thảm Lót Sàn Cao Su Dành Cho Chevrolet Spark 2013/2019",437000,484000,47000,10
TIKI,o-to-xe-may-xe-dap,95329297,"Kính chiếu hậu tai mèo phù hợp với các loại xe thông dụng hiện nay (giá 1 đôi) Green Networks Group",39000,39000,0,0
TIKI,o-to-xe-may-xe-dap,66676588,"Chai Xịt, Bôi Trơn Sên Chống Văng Thunder Chain Lube 2020 (400ml)",55000,55000,0,0
TIKI,o-to-xe-may-xe-dap,49030462,"Tẩy rửa vệ sinh xe đạp ZÉFAL BIKE WASH (1 LÍT)",300000,300000,0,0
TIKI,o-to-xe-may-xe-dap,43129964,"Dung dịch làm sạch hệ thống xăng Sonax 515100 Fuel system cleaner 250ml",170000,170000,0,0
TIKI,o-to-xe-may-xe-dap,93364310,"(Hàng chính hãng) Bộ kích oto-Cứu hộ xe hơi Baseus Car Jump Starter dung lượng pin 12000mAh sạc đầy được 50 lần kích công suất 1000A kiêm pin dự phòng tích hợp màn hình kỹ thuật số, được kiểm tra chất lượng nghiêm ngặt.",1803000,1803000,0,0
TIKI,o-to-xe-may-xe-dap,94025483,"TẨU SẠC NHANH OTO PHÁT NHẠC  HOCO E51 FM/BLUETOOTH- 2 SẠC USB/ 1 TYPE C PD 18W/ HỖ TRƠ THẺ NHỚ TF-BẢO HÀNH CHÍNH HÃNG.",299000,299000,0,0
TIKI,o-to-xe-may-xe-dap,111361305,"Ốp Chìa Khóa Silicon Tráng Gương Dành Cho Xe CAMRY 2019 2020 2021 - kèm móc treo",183000,188000,5000,3
TIKI,o-to-xe-may-xe-dap,72892712,"Bi nồi STB RRGS cho xe 125cc 150cc hãng Honda, làm từ sợi cacbon, giảm thiểu được hiện tượng móp bi",210000,210000,0,0
TIKI,o-to-xe-may-xe-dap,134501702,"Bộ Chổi Xẻng Quét Bụi Bàn Thờ , Bàn Phím Và Nội Thất Ô Tô Mini - PaKaSa ( Màu ngẫu nhiên )",29000,58000,29000,50
TIKI,o-to-xe-may-xe-dap,37874082,"Bộ dây câu bình ắc quy ô tô, xe hơi dài 4m dòng 2000A (2000AMP)",99000,99000,0,0
TIKI,o-to-xe-may-xe-dap,68368649,"Bình ắc quy UPS siêu nhỏ EAGLE 6V - 1.3Ah (EG1.3-6)",113000,113000,0,0
TIKI,o-to-xe-may-xe-dap,31142486,"Gạt mưa Bosch Advantage Mitsubishi Zinger Đời 2016 24" - 14" (Đen)",239000,239000,0,0
TIKI,o-to-xe-may-xe-dap,55642163,"Bóng Đèn Tăng Sáng Bosch H7 12V 55W Gigalight Plus +120% (Hộp 2 Bóng)",483000,483000,0,0
TIKI,o-to-xe-may-xe-dap,53027009,"Đệm tựa lưng massage cho tài xế, đệm tựa lưng tre, đệm tựa lưng trúc",193000,224000,31000,14
TIKI,o-to-xe-may-xe-dap,177300871,"1 chiếc ty thủy lực nâng nắp capo Xpander 2018-2019-2020-2021-2022 đủ phụ kiện ốc và pát",199405,199405,0,0
TIKI,o-to-xe-may-xe-dap,787264,"Mũ Bảo Hiểm GRS A102K - Đỏ Line Đen",279000,279000,0,0
TIKI,o-to-xe-may-xe-dap,181566039,"Thùng giữa Givi G12N kèm bát gắn cho xe Wave RSX",750000,750000,0,0
TIKI,o-to-xe-may-xe-dap,62319575,"Bình Phun Sương Cầm Tay Epoca Trung Tính Made In Italy - Hàng Chính Hãng",329000,329000,0,0
TIKI,o-to-xe-may-xe-dap,116899885,"Sơn SAMURAI KUROBUSHI Y3* MÀU BẠC KIM LOẠI chính hãng - Sơn phun xe máy SAMURAI SÀI GÒN",75000,75000,0,0
TIKI,o-to-xe-may-xe-dap,85804119,"Bạt Che Phủ Xe dành cho Toyota Innova Cao Cấp (bạt 3 lớp Tráng Nhôm, chống xước)",310000,318000,8000,3
TIKI,o-to-xe-may-xe-dap,179232257,"Lót cốp, khay cốp nhựa Suzuki XL7 cao cấp không mùi, dễ dàng vệ sinh",281000,288000,7000,2
TIKI,o-to-xe-may-xe-dap,7213479,"Nón Bảo Hiểm Giro Cormick ",1250000,1250000,0,0
TIKI,o-to-xe-may-xe-dap,164792937,"Chữ Nổi Xpander Gắn Nắp Caplo Trang Trí Cho Xế Yêu",112000,118000,6000,5
TIKI,o-to-xe-may-xe-dap,111463554,"Thảm taplo xe Kia Cerato 2019 2020 2021 chất liệu da vân carbon cao cấp",232741,244990,12249,5
TIKI,o-to-xe-may-xe-dap,32835722,"AirBlade 125 (2016-2019) Full Món 6 Carbon (Ốp pô + Pô E + Két nước + Mỏ Dè + Thảm Lót Carbon)",250000,250000,0,0
TIKI,o-to-xe-may-xe-dap,11217175,"Nước Hoa Xe Hơi Hương Red (Dịu Nhẹ - 50ml - Dạng Xịt)",440000,440000,0,0
TIKI,o-to-xe-may-xe-dap,68196185,"Ắc quy xe máy Eagle Thái Lan EG-YTX7L-BS (12V-7Ah)",560000,560000,0,0
TIKI,o-to-xe-may-xe-dap,117598560,"Súc rửa két nước làm mát xe ô tô Bluechem Radiator Flush 300ml",159000,159000,0,0
TIKI,o-to-xe-may-xe-dap,69446917,"Ốp Tay Cửa - Ốp Hõm Cửa (Chén cửa) Dành Cho Xe Toyota Vios 2019",145000,153000,8000,5
TIKI,o-to-xe-may-xe-dap,139507974,"Nẹp CHỐNG XƯỚC CỬA XE Ô TÔ XE HƠI CHẤT LIỆU CAO SU",120000,126000,6000,5
TIKI,o-to-xe-may-xe-dap,162533389,"Vè Che Mưa Dành Cho Xe CAMRY 2003-2007 nhựa đen, có vi deo và hình ảnh sản phẩm thật",232000,263000,31000,12
TIKI,o-to-xe-may-xe-dap,92547679,"Bọc vô lăng TTAUTO cho xe ô tô từ 4 đến 7 chỗ chất liệu da vân carbon cao cấp có logo BMW (Đen)",250000,250000,0,0
TIKI,o-to-xe-may-xe-dap,100431898,"Combo 2 Lon Nhớt xe máy tổng hợp toàn phần 100% BCP - SAE 10W40-API SN-JASO MA2 (0.8L-1L) - Tặng 1 chai cùng loại",576000,576000,0,0
TIKI,o-to-xe-may-xe-dap,49781069,"Bộ ốp chống trầy Cốp INOX dành cho xe Mazda 3 2020 - Bên trong",254000,260500,6500,2
TIKI,o-to-xe-may-xe-dap,151684854,"Bạt trùm che phủ xe ô tô Toyota Cross Cao Cấp 3 Lớp Chống Nắng Nóng Chống Nước Chống xước",242250,255000,12750,5
TIKI,o-to-xe-may-xe-dap,72781939,"Bộ 2 Băng Quấn Silicon Ghi Đông Tay Cầm Chống Trơn Trượt Cho Xe Đạp Đua Thể Thao Đường Trường Thiết Kế Ba Chiều Tổ Ong Siêu Nhẹ Thoáng Khí Hút Mồ Hôi Cao Cấp Mai Lee",132050,139000,6950,5
TIKI,o-to-xe-may-xe-dap,90510254,"Dụng cụ kiểm  tra lốp xe Ô tô  dùng pin  Lithium 20v ingco CACLI2002px ",1382000,1382000,0,0
TIKI,o-to-xe-may-xe-dap,33392734,"Cảng Lướt Gió Sơn airbrush Gắn Exciter 150 BẢO LONG RACING",120000,120000,0,0
TIKI,o-to-xe-may-xe-dap,181217322,"Bộ 5 Cọ Quét Vệ Sinh Nội Thất Khe Hở Xe Hơi Đa Năng",75000,75000,0,0
TIKI,o-to-xe-may-xe-dap,117597821,"Nước hoa ô tô cao cấp chính hãng Areon kẹp cửa gió điều hòa hương Platinum",279000,279000,0,0
TIKI,o-to-xe-may-xe-dap,104804009,"Dung dịch xịt khử mùi xe ô tô Sonax SmokeEx 500ml",210000,210000,0,0
TIKI,o-to-xe-may-xe-dap,75964101,"Cuộn Dây Hơi rút tự động 6.5mm X 10mm 10M Omatools DOM1200522.010",990000,990000,0,0
TIKI,o-to-xe-may-xe-dap,12289780,"Tẩu sạc Hyundai HY-10 - Màu Đen",132000,135000,3000,2
TIKI,o-to-xe-may-xe-dap,147966025,"Móc Treo Đồ Tiện Dụng Sau Ghế Ôtô, Móc Nhựa Treo Đồ Đa Năng Trong Xe Hơi, Giá Rẻ, Tiết Kiệm Không Gian. TakyHome 9711",20900,20900,0,0
TIKI,o-to-xe-may-xe-dap,189534709,"Toyota Cross PPF TPU chống xước tự hồi phục STAR FILM",500000,500000,0,0
TIKI,o-to-xe-may-xe-dap,88027145,"Bộ ốp hõm và tay nắm cửa Dành Cho Hyundai I10",185000,194490,9490,5
TIKI,o-to-xe-may-xe-dap,33549763,"Máy hút bụi cầm tay xe hơi Hoco PH16 - Hàng chính hãng",799000,799000,0,0
TIKI,o-to-xe-may-xe-dap,15508310,"Bộ Kích Nâng Gầm Xe Hơi Bằng Điện RCGTZ MHG01 + Súng Tháo Đai Ốc + Bơm Cao Cấp AZONE - Hàng Chính Hãng",1950000,2105000,155000,7
TIKI,o-to-xe-may-xe-dap,105247672,"Tẩu sạc trên ô tô hỗ trợ sạc nhanh 18w Hoco Z39 - Hàng Chính Hãng",149000,149000,0,0
TIKI,o-to-xe-may-xe-dap,872482,"Bọt Biển Wash Sponge Pro Soft99 C-96",99000,99000,0,0
TIKI,o-to-xe-may-xe-dap,111463544,"Thảm taplo da vân carbon Tucson 2019-2020",233000,239000,6000,3
TIKI,o-to-xe-may-xe-dap,133820225,"Bạt phủ xe ô tô 7 chỗ có 3 lớp cao cấp , bạt phủ trùm xe hơi dòng Innova, Ecosport, Crv, CX5, Tucson, Santafe, Carens",234000,299000,65000,22
TIKI,o-to-xe-may-xe-dap,50378157,"Bộ ốp gương chiếu hậu dành cho xe Toyota Wigo",201000,206500,5500,3
TIKI,o-to-xe-may-xe-dap,147697050,"Khăn Lau Xe Hơi Ô Tô Microfiber Cao Cấp Mifan - Mật độ 600 gsm - Siêu Thấm, Không rụng lông, Không phai màu",29000,29000,0,0
TIKI,o-to-xe-may-xe-dap,35767782,"NẸP SƯỜN MẠ CROM XE MITSUBISHI XPANDER 2018-2019",456000,518000,62000,12
TIKI,o-to-xe-may-xe-dap,162533230,"BỘ 4 VÈ CHE MƯA CHO XE TOYOTA VIOS, HÀNG CHỈ TRÁNG GƯƠNG CAO CẤP, BỌC HỘP UY TÍN",302000,318000,16000,5
TIKI,o-to-xe-may-xe-dap,172167210,"phụ gia vệ sinh kim phun, buồng đốt Senfineco 9997",320000,320000,0,0
TIKI,o-to-xe-may-xe-dap,7028857,"Bộ 2 chai keo dán đa năng siêu dính Scotch-Weld 20g 3M PR100",280000,280000,0,0
TIKI,o-to-xe-may-xe-dap,100352048,"Búa Phá Kính Xe Hơi Cắt Dây An Toàn Hàng Chính Hãng Baseus",122500,200000,77500,39
TIKI,o-to-xe-may-xe-dap,174302493,"Nước làm mát Castrol Radicool SF Premix 500ml",65000,65000,0,0
TIKI,o-to-xe-may-xe-dap,7295917,"Chai xịt rửa vệ sinh động cơ máy xe Sonax Engine Cold Cleaner 500ml",216000,216000,0,0
TIKI,o-to-xe-may-xe-dap,56968104,"Thảm Lót Ghế Xe Ô Tô Văn Phòng Lưới Trúc Thoát Khí",75000,75000,0,0
TIKI,o-to-xe-may-xe-dap,19275462,"Bộ Rèm Chắn Nắng Nam Châm dành cho xe Mazda 6",239000,245300,6300,3
TIKI,o-to-xe-may-xe-dap,15212889,"Hộp tỳ tay xe hơi Hyundai i10 tích hợp 3 cổng USB - Hàng nhập khẩu",479000,479000,0,0
TIKI,o-to-xe-may-xe-dap,139289840,"Lốp(vỏ) DPLUS 100/90-10 Dành cho Trước, sau xe Attila, Venus, SCR, Lead(sau) CHÍNH HÃNG",349000,349000,0,0
TIKI,o-to-xe-may-xe-dap,53761740,"Mỡ Bôi Trơn Xích Mannol Chain Lube",180000,180000,0,0
TIKI,o-to-xe-may-xe-dap,26957437,"Khóa chữ U Yale YUL1/12/20/1",650000,650000,0,0
TIKI,o-to-xe-may-xe-dap,153938279,"Bộ rèm che nắng Hyundai Accent 2018-2019",300000,308000,8000,3
TIKI,o-to-xe-may-xe-dap,3702755,"Dây Cáp Thép Kéo Xe, Cứu Hộ Xe 4M - 5 Tấn (10Mm)",130000,130000,0,0
TIKI,o-to-xe-may-xe-dap,51968156,"Bạt Phủ Ô Tô Vios Đường May Kép Trần 2 Lần Chỉ Chắc Chắn Bạt Trùm Xe Hơi Chất Liệu Vải Dù Chống Nắng Mưa",278000,285500,7500,3
TIKI,o-to-xe-may-xe-dap,155130168,"Thảm lót sàn xe ô tô Kia Sorento 2021 -(3 hàng ghế) Nhãn hiệu Macsim chất liệu nhựa TPV cao cấp màu đen",1990000,1990000,0,0
TIKI,o-to-xe-may-xe-dap,173187619,"Săm xe đạp Giant 24x1.25",150000,150000,0,0
TIKI,o-to-xe-may-xe-dap,103964332,"Máy Bơm Hơi Xe Hơi Thông Minh Nhiều Chế Độ Baseus Air Compressor 12V Dung Tích Pin 2400mah - Hàng Chính Hãng Baseus",873000,919000,46000,5
TIKI,o-to-xe-may-xe-dap,153936533,"BỘ SẢN PHẨM Nẹp bước chân và ốp chống trầy cốp Hyundai Santafe 2021 - Mẫu vân Carbon",1549000,1589000,40000,3
TIKI,o-to-xe-may-xe-dap,162766101,"{BẠT DÀY NẶNG} áo trùm xe, bạt phủ ô tô, bạt che nắng mưa DÀY 3 LỚP, DANH2H CHO XE MITSUBISHI XPANDER",318000,326000,8000,2
TIKI,o-to-xe-may-xe-dap,177484873,"Tinh Dầu Bạch Đàn Chanh TTAUTO Treo Xe ô tô, Treo Tủ Quần Áo, Treo Phòng Giúp Khử Mùi, Thơm Phòng, Thư Giãn Tinh Thần, Chống Say Xe Hiệu Quả",55000,55000,0,0
TIKI,o-to-xe-may-xe-dap,116017482,"combo 3 Chai Xịt Bọt Đa Năng Vệ Sinh Ghế Da Nội Thất Ô Tô Foam Cleaner Màu Vàng 650ml camel hương chanh",109000,118000,9000,8
TIKI,o-to-xe-may-xe-dap,72655376,"Ốp Gương Chiếu Hậu Dành Cho Ô Tô City 2016 2017 2018 2019 2020 Vân Cacbon",296000,328000,32000,10
TIKI,o-to-xe-may-xe-dap,96447010,"Sơn SAMURAI KUROBUSHI H196** MÀU TRẮNG NGỌC TRAI chính hãng - SƠN PHUN XE MÁY SAMURAI SÀI GÒN",90000,90000,0,0
TIKI,o-to-xe-may-xe-dap,111463028,"Ốp Nắp Bình Xăng Xe Mitsubishi Attrage 2020 - 2021 Mạ Crom",97000,98990,1990,2
TIKI,o-to-xe-may-xe-dap,35129467,"Thảm Nhựa Lót Cốp Sau Dành Cho Xe Ô Tô Fortuner 2009-2019",279000,286000,7000,2
TIKI,o-to-xe-may-xe-dap,107458202,"Thùng nhựa đựng đồ cho cốp xe ô tô có thể gấp xếp gọn có chốt gài | 30L + 55L + túi chống nước",185000,185000,0,0
TIKI,o-to-xe-may-xe-dap,97974613," MÓC TREO ĐỒ TRÊN Ô TÔ",12511,12511,0,0
TIKI,o-to-xe-may-xe-dap,23454393,"Bộ nẹp viền chân kính INOX dành cho xe Toyota Hilux Revo",276000,283000,7000,2
TIKI,o-to-xe-may-xe-dap,155011138,"Tấm lót cốp nhựa đen dẻo theo xe Attrage 2018-2019-2020-2021 nhựa TPO cao cấp",269000,305000,36000,12
TIKI,o-to-xe-may-xe-dap,19476389,"Kem vệ sinh bảo dưỡng đồ dùng bằng da Astonish ",149000,149000,0,0
TIKI,o-to-xe-may-xe-dap,50416335,"Hộp tỳ tay dành cho ô tô Vinfast Fadil",314000,384000,70000,18
TIKI,o-to-xe-may-xe-dap,141962531,"Rèm Che Nắng Xe Xpander Cross Hàng Loại 1 MR Ô TÔ",540000,540000,0,0
TIKI,o-to-xe-may-xe-dap,2285875,"Chai xịt bảo dưỡng lốp xe 3M 39042 - hàng nhập khẩu từ Mỹ",307000,315000,8000,3
TIKI,o-to-xe-may-xe-dap,177298706,"Ốp chống trầy cốp CX8, CX-8 2019-2020-2021-2022 thép không gỉ vân Cacbon bảo vệ xe chống va đập",202000,248000,46000,19
TIKI,o-to-xe-may-xe-dap,56415852,"Dung Dịch Bôi Trơn Chống Rỉ Sét Muc Off MO-94, 750ml ",300000,300000,0,0
TIKI,o-to-xe-may-xe-dap,140105250,"Bình xịt bóng da, gỗ, nội thất ô tô Toyo",67000,69000,2000,3
TIKI,o-to-xe-may-xe-dap,95222685,"Bao da chìa khóa cacbon xe Mazda 6",183000,188000,5000,3
TIKI,o-to-xe-may-xe-dap,136187825,"RÈM CHE NẮNG NAM CHÂM CHO XE FORD ECOSPORT",248000,248000,0,0
TIKI,o-to-xe-may-xe-dap,135418080,"Toyota Corolla Cross 2020-2021: Bộ 4 miếng chắn bùn nhựa đen dẻo theo xe kèm ốc vít",219000,225000,6000,3
TIKI,o-to-xe-may-xe-dap,145726097,"Bộ Ốp Chân Phanh - Chân Ga Dành Cho Xe TOYOTA VIOS",212800,224000,11200,5
TIKI,o-to-xe-may-xe-dap,22033181,"Gối  Da Tựa Lưng Massage Rung Thư Giãn Trên Xe Ô Tô",169000,169000,0,0
TIKI,o-to-xe-may-xe-dap,195106618,"Lọc gió điều hòa cho Mazda BT-50 2011-2021 than hoạt tính",290000,290000,0,0
TIKI,o-to-xe-may-xe-dap,155759879,"Phụ gia làm sạch hệ thống dầu Sonax 518100 -Hàng Chính Hãng",212000,212000,0,0
TIKI,o-to-xe-may-xe-dap,42693870,"Lót Cốp Nhựa TPO Cao Cấp Dành Cho Xe Rush 2018/2020",324000,368000,44000,12
TIKI,o-to-xe-may-xe-dap,186161738,"Bộ 2 móc treo đồ sau ghế ô tô màu đen tiện lợi",5000,5000,0,0
TIKI,o-to-xe-may-xe-dap,58545811,"Chai xịt rửa sên xe máy/ moto WILLF1 Chain Cleaner 500ml",65000,65000,0,0
TIKI,o-to-xe-may-xe-dap,186162806,"Ốp chống trầy cốp ngoài nhựa đen cho Fortuner 2009-2010-2011-2012-2013-2014-2015 phản quang trang trí bảo vệ xe",360000,360000,0,0
TIKI,o-to-xe-may-xe-dap,144934540,"Mũ Bảo Hiểm Nửa Đầu Màu Vàng Họa Tiết Kèm Kính Thời Trang Chính Hãng B'COLOR",195000,300000,105000,35
TIKI,o-to-xe-may-xe-dap,3121045,"Đánh bóng làm sáng bề mặt sơn Sonax Car Polish 300100 (250ml)",160000,160000,0,0
TIKI,o-to-xe-may-xe-dap,12289766,"Tẩu sạc Hyundai HY-36",84000,84000,0,0
TIKI,o-to-xe-may-xe-dap,171706201,"Bộ ốp tay và lõm, nắp xăng mạ chrome cao cấp cho Toyota Rush",889000,889000,0,0
TIKI,o-to-xe-may-xe-dap,92133925,"Ví đựng giấy tờ xe dành cho ô tô Vinfast Da Cao Cấp, Ví da đựng giấy tờ xe ô tô ",25000,25000,0,0
TIKI,o-to-xe-may-xe-dap,51511292,"Chai Xịt Tẩy Vết Bẩn Nhựa Đường OUFU AF-1108 450ml",59000,69000,10000,14
TIKI,o-to-xe-may-xe-dap,19462334,"CARBON ĐEN",145000,145000,0,0
TIKI,o-to-xe-may-xe-dap,2549139,"Phụ Gia Làm Sạch Động Cơ BCP Engine Flush 100ml",75000,75000,0,0
TIKI,o-to-xe-may-xe-dap,29325544,"Búa Thoát Hiểm Đa Năng Cao Cao Cấp Thép Không Gỉ",109000,109000,0,0
TIKI,o-to-xe-may-xe-dap,787658,"Mũ Bảo Hiểm GRS A102K - Xanh Nhám Line Đen",234999,234999,0,0
TIKI,o-to-xe-may-xe-dap,110151383,"Nước hoa xe hơi cao cấp Etonner Car Perfume Spare dòng nước hoa của Pháp, kết hợp giữa nét thanh lịch, lựa chọn hoàn hảo cho không gian nội thất nhiều dòng xe",686000,686000,0,0
TIKI,o-to-xe-may-xe-dap,45329748,"Máy lọc không khí ô tô ion âm Airvita Carvita 5S diệt khuẩn, khử mùi, khử khí độc | TOP 1 Hàn Quốc, Nhập khẩu chính hãng",792000,990000,198000,20
TIKI,o-to-xe-may-xe-dap,49178692,"Mũ Bảo Hiểm Xe Đạp Trẻ Em Protec SMILE Họa Tiết Đội Trưởng Mỹ Có Vòng Điều Chỉnh Đầu, Có Đèn Chiếu Hậu An Toàn Phía Sau - Màu Đỏ",345000,438000,93000,21
TIKI,o-to-xe-may-xe-dap,122831926,"ỐP NỘI THẤT DÀNH CHO XPANDER 2018, 2019,2020 7 CHI TIẾT ",336000,345000,9000,3
TIKI,o-to-xe-may-xe-dap,18009964,"Bộ rèm che nắng dành cho Kia Morning thế hệ mới",281000,288000,7000,2
TIKI,o-to-xe-may-xe-dap,54634549,"Dung dịch vệ sinh kim phun xăng điện tử Wurth LBW 400 Fuel Injection and Valve Cleaner 330ml 089356091",185000,185000,0,0
TIKI,o-to-xe-may-xe-dap,173698089,"Bình xịt tẩy nấm mốc Astonish C1120 750ml tẩy cực mạnh tiêu diệt hoàn toàn nấm mốc mọi vết ố bẩn do nấm mốc gây ra tẩy nấm mốc trên tường nhà phòng tắm nhà bếp khung cửa vách kính ron cao su",159000,159000,0,0
TIKI,o-to-xe-may-xe-dap,57726183,"Thanh Gạt Mưa Cao Cấp Bosch Aerotwin 28 inch - 700mm",395000,395000,0,0
TIKI,o-to-xe-may-xe-dap,16918302,"Bộ Chia Tẩu Ô Tô 2 Ổ Và 2 Cổng Usb Có Dây AIR-Q PZ-711",339000,339000,0,0
TIKI,o-to-xe-may-xe-dap,149403765,"Tinh dầu treo xe ô tô Purevess - giúp khử mùi xe hơi, làm thơm phòng, thư giãn, đuổi muỗi (8 mùi chọn lựa)",80000,80000,0,0
TIKI,o-to-xe-may-xe-dap,113406184,"Thảm cao su dành cho Ford Focus- hàng cao cấp Bộ Thảm Lót Sàn Cao Su Đúc Cho Ô Tô Ford Focus 2012-2018 - TB",669750,705000,35250,5
TIKI,o-to-xe-may-xe-dap,1246041,"Chất Vệ Sinh Keo Tẩy Nhựa Đường Bullsone (420ml)",123911,170000,46089,27
TIKI,o-to-xe-may-xe-dap,141962176,"Rèm Che Nắng Xe Toyota Innova 2016-2020 Hàng Chuẩn Xịn Loại 1 ",540000,540000,0,0
TIKI,o-to-xe-may-xe-dap,35539825,"Nhũ Dịch Làm Sạch Và Bảo Quản Nhựa Trong, Ngoài Xe SONAX Trim Protectant high gloss finish (sprayer) 380041 (300 ml)",284000,284000,0,0
TIKI,o-to-xe-may-xe-dap,52887810,"2 Lon nhớt xe máy dành cho xe số 800mL-API SL-SAE 15W40-JASO MA2-Công thức cải tiến - mùi dâu, màu đỏ - Tặng vệ sinh buồng đốt",400000,400000,0,0
TIKI,o-to-xe-may-xe-dap,50347742,"Bộ vè che mưa ABS cao cấp dành cho xe Toyota Wigo",213000,241500,28500,12
TIKI,o-to-xe-may-xe-dap,111463108,"XL7, Chống trầy cốp trong và ngoài SUZUKI XL7",427000,449000,22000,5
TIKI,o-to-xe-may-xe-dap,59152086,"Thảm chống nóng taplo xe toyota fortuner đời 2009 đến 2016 thảm nhung 3 lớp đế chống trơn",242000,248000,6000,2
TIKI,o-to-xe-may-xe-dap,177311243,"Bộ 4 rèm chắn nắng nam châm Ertiga 2019-2020 khung cố định chống tia UV",268000,268000,0,0
TIKI,o-to-xe-may-xe-dap,184801036,"Sơn xịt Samurai Kurobushi - 2K07 SƠN ĐEN SẦN, PHỦ GẦM XE (400ml)",230000,230000,0,0
TIKI,o-to-xe-may-xe-dap,174550058,"KIA K5 2022 PPF TPU Trụ bóng chống xước tự hồi phục STARFILM",489000,489000,0,0
TIKI,o-to-xe-may-xe-dap,6510427,"Ốp vỏ chìa khóa cacbon xe Accent 2018",149000,149000,0,0
TIKI,o-to-xe-may-xe-dap,143186217,"Bình Xịt Bọt Vệ Sinh Điều Hòa Ô Tô Flamingo F020 500ml ",125000,128000,3000,2
TIKI,o-to-xe-may-xe-dap,177309864,"Ốp chống trầy cốp Outlander 2016-2017-2018-2019-2020-2021-2022 inox sáng bóng bảo vệ xe chống va đập",198000,208000,10000,5
TIKI,o-to-xe-may-xe-dap,68833841,"Bộ Chắn Bùn Dành Cho Xe Ô Tô Camry 2019-2020",151000,172000,21000,12
TIKI,o-to-xe-may-xe-dap,73466771,"Súc Béc Dầu Senfineco 9985 Diesel Jet Cleaner 300ML",190000,190000,0,0
TIKI,o-to-xe-may-xe-dap,158854867,"Rèm Che Nắng Xe Kia K3 2021-2022  Hàng Loại 1. Cam Kết Vải Dày Dặn, Chuẩn Khít Theo Xe",359000,368000,9000,2
TIKI,o-to-xe-may-xe-dap,38380809,"Nước Rửa Kính ô Tô Xuất Xứ Châu Âu Xglass Thương Hiệu Ekokemika Hương Xả Chanh - (1l) - Hàng Chính Hãng",55000,55000,0,0
TIKI,o-to-xe-may-xe-dap,152097720,"Ốp Hõm Cửa, Chén Cửa Xe VIOS 2021 Mạ Crom",144000,164000,20000,12
TIKI,o-to-xe-may-xe-dap,141962569,"Rèm Che Nắng Xe BMW 218i 5 chỗ Hàng Loại 1 MR Ô TÔ",540000,540000,0,0
TIKI,o-to-xe-may-xe-dap,184801034,"Sơn xịt Samurai Kurobushi -  2K08 Màu đen  (400ml)",230000,230000,0,0
TIKI,o-to-xe-may-xe-dap,53515753,"BAO DA CHÌA KHOÁ XE RAPTOR - CHÍNH HÃNG KHẮC TÊN",400000,400000,0,0
TIKI,o-to-xe-may-xe-dap,11616844,"Ốp nhựa carbon lót silicon bọc, bảo vệ chìa khóa xe Mercedes kèm móc đeo INOX",179000,188000,9000,5
TIKI,o-to-xe-may-xe-dap,177334661,"Tinh Dầu Bạc Hà TTAUTO Treo Xe ô tô, Treo Tủ Quần Áo, Treo Phòng Giúp Khử Mùi, Thơm Phòng, Thư Giãn Tinh Thần, Chống Say Xe Hiệu Quả",55000,55000,0,0
TIKI,o-to-xe-may-xe-dap,144411235,"Tay Nắm,Hõm Cửa Xe Suzuki XL7 2021 Mạ Crom Cao Cấp",278000,285000,7000,2
TIKI,o-to-xe-may-xe-dap,141962471,"Rèm Che Nắng Xe Honda HRV 2016-2021 Hàng Loại 1 MR Ô TÔ",540000,540000,0,0
TIKI,o-to-xe-may-xe-dap,163871230,"Bạt phủ ô tô Toyota Camry thương hiệu Macsim sử dụng trong nhà và ngoài trời chất liệu Polyester - màu đen và màu ghi",2400000,2400000,0,0
TIKI,o-to-xe-may-xe-dap,59048922,"Combo 10 Bóng Đèn Chân Ghim Trung 1 Tim OSRAM Original T15 WY16W 12V 16W Màu Vàng",271000,319000,48000,15
TIKI,o-to-xe-may-xe-dap,32608964,"Thảm da Taplo vân carbon Cao cấp dành cho xe KIA Rio",217000,223000,6000,3
TIKI,o-to-xe-may-xe-dap,96002929,"Ví đựng giấy tờ xe ô tô dành cho hãng xe Mitsubishi",26000,38000,12000,32
TIKI,o-to-xe-may-xe-dap,188703713,"Xịt dưỡng nội thất ghế da Flamingo leather polish F029 loại cao cấp hàng chính hãng",126400,126400,0,0
TIKI,o-to-xe-may-xe-dap,169483102,"Trọn bộ cần gạt nước mưa ô tô Nano Silicon MS cho xe Audi A3 2014 -2018",950000,950000,0,0
TIKI,o-to-xe-may-xe-dap,271062846,"Vỉ miếng vá săm hình Oval Maruni - Sản xuất tại Nhật Bản",80000,80000,0,0
TIKI,o-to-xe-may-xe-dap,155049207,"SKF Phớt chắn dầu 30x52x7 ( Phớt lò xo CHÍNH HÃNG SKF 100%)",35000,35000,0,0
TIKI,o-to-xe-may-xe-dap,7376527,"Cặp 2 cái ruột xe đạp 16 x 1.75/2.125 AV35mm DELI-TIRE",100000,100000,0,0
TIKI,o-to-xe-may-xe-dap,141917579,"BẠT PHỦ XE Ô TÔ TRÁNG BẠC CAO CẤP - HUYNDAI I10, KIA MORNING",370000,379000,9000,2
TIKI,o-to-xe-may-xe-dap,41070419,"Lót Cốp Nhựa TPO Cao Cấp Dành Cho Xe Ford Focus - Bản Hatbach",385000,394500,9500,2
TIKI,o-to-xe-may-xe-dap,103093374,"Giá Đỡ Điện Thoại Cảm Biến Tự Mở Tích Hợp Sạc Không Dây Tốc Độ Cao Ô Tô Xe Hơi - MTA-09 Hàng Chính Hãng Black",299000,299000,0,0
TIKI,o-to-xe-may-xe-dap,141962467,"Rèm che nắng xe Ford Ecosport Loại 1 Mr Ô Tô",540000,540000,0,0
TIKI,o-to-xe-may-xe-dap,185923361,"Chai xịt bọt Vệ sinh khử mùi hôi Điều Hoà Flamingo loại 500ml F020 cho Ô tô và phòng ngủ",95000,95000,0,0
TIKI,o-to-xe-may-xe-dap,172487785,"Thảm lót sàn xe ô tô NISSAN X- trail 2013- đến nay Nhãn hiệu Macsim 3W chất liệu nhựa TPE đúc khuôn cao cấp - màu đen.,",3500000,3500000,0,0
TIKI,o-to-xe-may-xe-dap,66855140,"Bộ ốp ABS trang trí viền đèn dành cho KIA Morning 2012-2020",210400,210400,0,0
TIKI,o-to-xe-may-xe-dap,1338363,"Bạt Phủ Ô Tô CIND CD-502 7 Chỗ Size S-D 1 Lớp PP",252000,296000,44000,15
TIKI,o-to-xe-may-xe-dap,46181271,"LÓT CỐP NHỰA TPO DÀNH CHO XE HONDA CIVIC-2019",291000,298000,7000,2
TIKI,o-to-xe-may-xe-dap,177299333,"Vè mưa Fadil 2019-2021 chỉ inox cao cấp bảo vệ xe",339000,348000,9000,3
TIKI,o-to-xe-may-xe-dap,197529721,"Túi treo xe đạp tam giác kháng nước eXtreme TX101 túi xe đạp đựng điện thoại, ví tiền, chai nước",87500,175000,87500,50
TIKI,o-to-xe-may-xe-dap,163871256,"Bạt phủ dành cho Vinfas Lux A thương hiệu macsim- màu đen và màu ghi - bạt phủ trong nhà và ngoài trời",2200000,2200000,0,0
TIKI,o-to-xe-may-xe-dap,138154751,"Tượng chú tiểu phong thủy,bộ 4 tượng tứ không trang trí xe ô tô",68000,68000,0,0
TIKI,o-to-xe-may-xe-dap,37672037,"ỐP HÕM CỬA MẠ CROM CHO XE HONDA CITY 2018-2019",180000,184480,4480,2
TIKI,o-to-xe-may-xe-dap,155041998,"Phớt chắn dầu SKF 22x40x7 (Phớt lò xo HÀNG CHÍNH HÃNG SKF 100% )",28000,28000,0,0
TIKI,o-to-xe-may-xe-dap,50413565,"Hộp tỳ tay ô tô Mitsubishi Xpander cao cấp tích hợp 3 cổng USB XPD-NK",312000,328000,16000,5
TIKI,o-to-xe-may-xe-dap,143861344,"Chai Xịt Làm Bóng Da, Bóng Gỗ Toyo 500ml",89000,89000,0,0
TIKI,o-to-xe-may-xe-dap,54115287,"Đệm, giường hơi trên ô tô, xe hơi kèm gối + tặng kèm bơm A1SKY",440000,440000,0,0
TIKI,o-to-xe-may-xe-dap,6895689,"Ốp vỏ chìa khóa cacbon cho xe Ford Ranger 2018",139600,139600,0,0
TIKI,o-to-xe-may-xe-dap,31067986,"Gạt mưa Bosch Advantage Ford Escape 20" - 18" (Đen)",220000,220000,0,0
TIKI,o-to-xe-may-xe-dap,53645558,"CHAI XỊT SILICON BÔI TRƠN BẢO DƯỠNG CAO SU, NHỰA CAO CẤP LIQUI MOLY SILICON-SPRAY 3310 300ML",200000,200000,0,0
TIKI,o-to-xe-may-xe-dap,125909838,"VÈ CHE MƯA dành cho xe SANTAFE INOX CAO CẤP 2019-2020-2021 CAO CẤP",422750,445000,22250,5
TIKI,o-to-xe-may-xe-dap,74610750,"Rổ trước 3 lỗ dành cho Wave đời đầu , wave100 (1 lỗ trên 2 lỗ dưới) Green Networks Group",109000,109000,0,0
TIKI,o-to-xe-may-xe-dap,115317369,"Ốp Nắp Xăng Dành Cho Toyota Corolla Cross Cao Cấp",105000,108000,3000,3
TIKI,o-to-xe-may-xe-dap,195249416,"Meguiar's Dưỡng lốp (vỏ xe) dạng gel - Endurance Tire Gel, G7516, 473 ml",495000,495000,0,0
TIKI,o-to-xe-may-xe-dap,3935845,"Nước hoa ô tô cao cấp Hàn Quốc A50 65ml Hương Thơm Dễ Chịu",139000,139000,0,0
TIKI,o-to-xe-may-xe-dap,177301141,"Bộ ốp bậc cửa trong ngoài nẹp bước chân Suzuki XL7 2020 vân Titan chống trầy trang trí xe",159000,159000,0,0
TIKI,o-to-xe-may-xe-dap,177299472,"Bộ 4 rèm chắn nắng nam châm Cerato 2015-2016-2017-2018 khung cố định chống tia UV",268000,268000,0,0
TIKI,o-to-xe-may-xe-dap,173766786,"Phớt chắn dầu SKF 50X90X10 HMSA10 RG",105000,105000,0,0
TIKI,o-to-xe-may-xe-dap,189035242,"Lọc gió điều hòa Toyota RAV-4 2009-2022 than hoạt tính",254000,260000,6000,2
TIKI,o-to-xe-may-xe-dap,119719046,"Bình Ắc Quy Khô OUTDO UTX9A-BS (12V - 9AH) Spacy, Attila Victoria, Elizabeth, Majesty, Vespa Lx 150cc",557000,557000,0,0
TIKI,o-to-xe-may-xe-dap,141962600,"Rèm Che Nắng Xe Honda City 2015-2020 Loại 1 MR Ô TÔ",540000,540000,0,0
TIKI,o-to-xe-may-xe-dap,98822765,"Tẩu sạc nhanh công suất cao 40W Baseus LV908- Hàng chính hãng",270000,270000,0,0
TIKI,o-to-xe-may-xe-dap,154895687,"Phớt chắn dầu SKF 20x47x7 ( Phớt lò xo  HÀNG CHÍNH HÃNG SKF 100% )",33000,33000,0,0
TIKI,o-to-xe-may-xe-dap,172167215,"Sản phẩm dưỡng da ô tô Senfineco 9955 ",220000,220000,0,0
TIKI,o-to-xe-may-xe-dap,116207594,"Bộ ốp tay nắm hõm cửa xe Mazda CX-5, CX5 2018-2020 nhựa ABS cao cấp mạ Crom sáng bóng",328000,328000,0,0
TIKI,o-to-xe-may-xe-dap,50934874,"Bạt Phủ xe Ô Tô Kia RIO Sedan KT_4.365 x 1.720 x 1.455 mm",291000,298000,7000,2
TIKI,o-to-xe-may-xe-dap,19892043,"Bộ vè che mưa ABS cao cấp dành cho xe Toyota Yaris 2018-2019",249900,249900,0,0
TIKI,o-to-xe-may-xe-dap,11585678,"Nước Hoa Ô Tô Dạng Xịt L&D Elite Class One Billion",112000,132000,20000,15
TIKI,o-to-xe-may-xe-dap,141962579,"Rèm Che Nắng Xe Toyota Yaris 2014-2018 Hàng Loại 1 MR Ô TÔ",540000,540000,0,0
TIKI,o-to-xe-may-xe-dap,116057220,"Đệm Ngồi 3D Thoáng Khí Đột Phá Mới MAGIC CUSHION Thoáng Khí Tuần Hoàn Cho Người Ngồi Lâu",210000,210000,0,0
TIKI,o-to-xe-may-xe-dap,177300947,"Ốp gương Attrage 2015-2016-2017-2018-2019-2020-2021-2022 hở đèn mạ crom bảo vệ chống trầy xe",239000,239000,0,0
TIKI,o-to-xe-may-xe-dap,49193040,"Bạt phủ kính lái chống nóng ô tô ",55000,55000,0,0
TIKI,o-to-xe-may-xe-dap,56252418,"Bộ Khung Biển Số Ô Tô Inox Trước Sau Kèm Mica Đủ Pát Và Ốc",190000,190000,0,0
TIKI,o-to-xe-may-xe-dap,43330933,"Đế giữ điện thoại tích hợp sạc không dây Baseus Light Electric Holder Wireless Charger 15W (Cảm biến tự động) - Hàng chính hãng",529679,529679,0,0
TIKI,o-to-xe-may-xe-dap,109681601,"Dầu Động Cơ Xe Máy Petromerica 4T Bán Tổng Hợp PLUS 10W-40 cho xe tay ga",155000,155000,0,0
TIKI,o-to-xe-may-xe-dap,181566821,"Thùng giữa Givi G12N kèm bát gắn cho xe Future 1, Future đời đầu",750000,750000,0,0
TIKI,o-to-xe-may-xe-dap,57475515,"Gạt Mưa Ô Tô Chính Hãng Blaupunkt Premium  24"/600mm",175750,185000,9250,5
TIKI,o-to-xe-may-xe-dap,162533421,"Bộ vè che mưa đen dành cho xe Hyundai Elantra 2010-2015 chất liệu DÀY và BỀN",286000,293000,7000,2
TIKI,o-to-xe-may-xe-dap,168274022,"Lưỡi trai RONA gắn mũ bảo hiểm nửa đầu và mũ 3/4",38000,100000,62000,62
TIKI,o-to-xe-may-xe-dap,74219329,"Xe điện drift 3 bánh Homesheel thế hệ mới D1 USA  Màu xanh cam lửa- Hàng chính hãng",4991340,6087000,1095660,18
TIKI,o-to-xe-may-xe-dap,136187505,"RÈM CHE NẮNG NAM CHÂM CHO XE TOYOTA INNOVA 2016-2020",242000,248000,6000,2
TIKI,o-to-xe-may-xe-dap,157662189,"Xe đạp đua GIANT PROPEL ADV SL 1 D 2022 (Group điện SRAM Force eTap AXS)",176800000,176800000,0,0
TIKI,o-to-xe-may-xe-dap,110288128,"Xe Đạp Thể Thao Địa Hình Ngoài Trời XT300 Khung Nhôm 27 Tốc Độ Vành 26 Inch Nhập Khẩu + Kèm Chắn Bùn Và Giá Đựng Bình Nước",5318000,8000000,2682000,34
TIKI,o-to-xe-may-xe-dap,94587499,"Dù che kính lái khi đỗ xe cách nhiệt chống nắng trên ô tô có thể xếp gọn (size lớn che được toàn kính lái)",73836,73836,0,0
TIKI,o-to-xe-may-xe-dap,1254665,"Phụ Gia Súc Béc Dầu Cao Cấp Liqui Moly Super Diesel Additive 1806 (250ml)",190000,190000,0,0
TIKI,o-to-xe-may-xe-dap,180509826,"Bộ 4 miếng dán cửa xe ô tô chống trầy Baseus Streamlined Car Door Bumper Strip (2 x Thin Ones + 2 x Thick Ones) - Hàng Chính Hãng",199499,199499,0,0
TIKI,o-to-xe-may-xe-dap,16757271,"Nhớt 2 thì Oshima 2T 1 lít",150000,150000,0,0
TIKI,o-to-xe-may-xe-dap,197578218,"Xe đạp địa hình Thống Nhất M27-01 - Hàng chính hãng",2960100,2990000,29900,1
TIKI,o-to-xe-may-xe-dap,183351855,"Xe Mô Tô Honda CB1000R 2022",510500000,510500000,0,0
TIKI,o-to-xe-may-xe-dap,187746220,"Xe Máy Điện DK Roma Lite",19390000,19390000,0,0
TIKI,o-to-xe-may-xe-dap,188272184,"Xe Ga 50cc DK Crea Mono",23400000,23400000,0,0
TIKI,o-to-xe-may-xe-dap,161957855,"XE ĐẠP ĐỊA HÌNH FORNIX FN26",4490000,4490000,0,0
TIKI,o-to-xe-may-xe-dap,31565858,"Cặp Phuộc kiểu 1 Lò Xo Màu dành cho xe Sirius,Jupiter",359000,359000,0,0
TIKI,o-to-xe-may-xe-dap,118297635,"Xe đạp gấp GIANT ITHINK CONWAY 16",6050000,6050000,0,0
TIKI,o-to-xe-may-xe-dap,136335938,"Xe đạp cho học sinh sinh viên Wiibike Summer truyền thống dáng City Bike 24inch 26inch trẻ trung, phong cách cho nam nữ, hàng chính hãng chất lượng cao siêu bền",3990000,3990000,0,0
TIKI,o-to-xe-may-xe-dap,106003625,"Yamaha R1M ",1250000000,1250000000,0,0
TIKI,o-to-xe-may-xe-dap,173882924,"Xe Máy Điện Nijia Venus",15000000,15000000,0,0
TIKI,o-to-xe-may-xe-dap,194083937,"Bình Đun Nước Điện Tử Ô Tô 12V Chính Hãng Kemin G350 350ml",713000,750000,37000,5
TIKI,o-to-xe-may-xe-dap,142872396,"Kính Mũ Zeus 613",200000,200000,0,0
TIKI,o-to-xe-may-xe-dap,95306014,"Xe đạp Thống Nhất GN 06-20 (Dành cho trẻ từ 5 - 10 tuổi)",1801800,1820000,18200,1
TIKI,o-to-xe-may-xe-dap,114399527,"Xe Ga Kymco Hermosa 50",26200000,26200000,0,0
TIKI,o-to-xe-may-xe-dap,77750383,"XE ĐẠP ĐIỆN LIXI TRÁI NHO PRO MAX",10400000,10400000,0,0
TIKI,o-to-xe-may-xe-dap,193513020,"Xe Đạp Thể Thao Địa Hình NS-06 Vành 26inch 24 Tốc Độ Đại Nam Sport Nhập Khẩu + Tặng Mũ Bảo Hiểm,Khóa Dây Và Chắn Bùn",4925000,5000000,75000,2
TIKI,o-to-xe-may-xe-dap,183355133,"Xe Mô Tô Honda Rebel 1100 phiên bản 2022 DCT",529500000,529500000,0,0
TIKI,o-to-xe-may-xe-dap,118299356,"Xe Đạp GIANT ESCAPE 2 2022",10500000,10500000,0,0
TIKI,o-to-xe-may-xe-dap,173519851,"Xe máy Honda Lead Phiên bản Đặc biệt",42535000,42535000,0,0
TIKI,o-to-xe-may-xe-dap,117803099,"Mũ Bảo Hiểm Nửa Đầu Màu Đen Nhám Kèm Kính Thời Trang Chính Hãng B'COLOR",169000,280000,111000,40
TIKI,o-to-xe-may-xe-dap,6085025,"Mũ bảo hiểm Fullface Asia MT136 (Size L) - Đen nhám",355000,355000,0,0
TIKI,o-to-xe-may-xe-dap,191620821,"Xe đạp khung tre HayBike BamBoo",15000000,15000000,0,0
TIKI,o-to-xe-may-xe-dap,124966199,"Nhớt Cao Cấp Dành Cho Xe Số Motul 7100 4T 10W50 Có Chiết Lẻ",270000,270000,0,0
TIKI,o-to-xe-may-xe-dap,138029832,"Xe đạp địa hình GIANT ATX 610 NJ 2021",8300000,8300000,0,0
TIKI,o-to-xe-may-xe-dap,155287766,"Nhớt Xe Máy Motul 3100 Silver 10W40 JASO MA2 Chai 800ml Chính Hãng",130000,130000,0,0
TIKI,o-to-xe-may-xe-dap,75455254,"Xe đạp điện gấp gọn Homesheel Airwheel R6 - Màu trắng",13990000,16663500,2673500,16
TIKI,o-to-xe-may-xe-dap,127790809,"Xe đạp trợ lực điện Wiibike Summer 36V - City",7990000,7990000,0,0
TIKI,o-to-xe-may-xe-dap,58857504,"Xe máy Yamaha Grande Hybrid Premium - Bản Đặc Biệt (6 màu)",52000000,52000000,0,0
TIKI,o-to-xe-may-xe-dap,182806162,"Xe máy điện DK Bike New Gogo New 2022",19300000,19300000,0,0
TIKI,o-to-xe-may-xe-dap,162593214,"Hộp đựng đồ xếp gọn kích thước 52,5 cm x 36 cm x 34 cm  hộp đựng đồ trong cốp ô tô nhãn hiệu Macsim 3W chất liệu PP cao cấp màu xanh",1200000,1200000,0,0
TIKI,o-to-xe-may-xe-dap,105752159,"Công tắc xi nhan tích hợp Hazard ( Đèn ưu tiên ) Green Networks Group",59000,59000,0,0
TIKI,o-to-xe-may-xe-dap,3668281,"Khau lau xe chuyên dụng 3M 50400",79000,79000,0,0
TIKI,o-to-xe-may-xe-dap,58850650,"Combo 2 Bóng Đèn Halogen Tăng Sáng 150% OSRAM Night Breaker Laser H1 12V 55W",704000,704000,0,0
TIKI,o-to-xe-may-xe-dap,160428099,"Xe đạp địa hình Thống Nhất SLX 26-01 - Hàng chính Hãng ( Tặng khóa dây mã số và chắn bùn trước sau )",6582510,6649000,66490,1
TIKI,o-to-xe-may-xe-dap,11880813,"Cặp lốp xe Yamaha Exciter 135 hãng DPLUS cỡ 70/90-17 và 100/70-17 D355",790000,790000,0,0
TIKI,o-to-xe-may-xe-dap,136336652,"XE ĐẠP ĐƯỜNG PHỐ TOURING LIV ALIGHT 2 DD CITY DISC – PHANH ĐĨA BÁNH 700C – 2022",13590000,13590000,0,0
TIKI,o-to-xe-may-xe-dap,12635319,"Mũ Bảo Hiểm Royal M139 Đen Nhám Kính Âm",499000,499000,0,0
TIKI,o-to-xe-may-xe-dap,100103897,"VIETMAP HUD H1X - Màn Hình Hiển Thị Thông Tin - Phụ Kiện Ô tô",1890000,1890000,0,0
TIKI,o-to-xe-may-xe-dap,22957182,"Xe Máy Honda WinnerX - Phiên Bản Đen Mờ - Phanh ABS - Đen Vàng Đồng",50060000,50060000,0,0
TIKI,o-to-xe-may-xe-dap,96660712,"XE ĐẠP ĐIỆN CAP AS",15500000,15500000,0,0
TIKI,o-to-xe-may-xe-dap,31239782,"Mũ Bảo Hiểm Royal 3/4 kính âm",530000,700000,170000,24
TIKI,o-to-xe-may-xe-dap,98254678,"Xe Máy Yamaha MT15 Phiên Bản Mới - Chính Hãng Bảo Hành 3 Năm",69000000,69000000,0,0
TIKI,o-to-xe-may-xe-dap,25363936,"Xe đạp gấp Phoenix PIC20RFD",2641000,2780000,139000,5
TIKI,o-to-xe-may-xe-dap,55085028,"Bóng Đèn Xenon Bosch H4 12V 60/55W Xenon Silver (Vỉ 1 Bóng)",205000,205000,0,0
TIKI,o-to-xe-may-xe-dap,183497285,"Xe Mô Tô Honda Gold Wing phiên bản 2022",1231500000,1231500000,0,0
TIKI,o-to-xe-may-xe-dap,74003088,"Xe Máy Yamaha Exciter 150 limited (4 màu )",46000000,46000000,0,0
TIKI,o-to-xe-may-xe-dap,160437248,"Xe đạp GIANT ESCAPE 2 CITY DISC 2022 (Bản Quốc Tế)",13790000,13790000,0,0
TIKI,o-to-xe-may-xe-dap,142397205,"Yamaha Grande blue Core hybrid phiên bản giới hạn",53100000,53100000,0,0
TIKI,o-to-xe-may-xe-dap,95306057,"Xe đạp Thống Nhất Nữ Neo 20-03 (Dành cho bé gái từ 5 - 10 tuổi) - Màu",1970100,1990000,19900,1
TIKI,o-to-xe-may-xe-dap,197069724,"Xe Máy Điện DK Crea Mono",20200000,20200000,0,0
TIKI,o-to-xe-may-xe-dap,114399599,"Xe Máy KYMCO KPIPE 50cc",23400000,23400000,0,0
TIKI,o-to-xe-may-xe-dap,129575222,"XE ĐẠP GẤP FORNIX F160",4876000,5490000,614000,11
TIKI,o-to-xe-may-xe-dap,197744376,"Phiếu mua hàng của  Motoplex Hà Nội",5000000,5000000,0,0
TIKI,o-to-xe-may-xe-dap,118298511,"Xe đạp thể thao GIANT ATX 720 2022",11400000,11400000,0,0
TIKI,o-to-xe-may-xe-dap,155103068,"Mũ Bảo Hiểm B'color Loại Nửa Đầu Màu Đen Có Chữ Rock Roll Kèm Kính Thời Trang",185000,280000,95000,34
TIKI,o-to-xe-may-xe-dap,114399773,"Xe máy điện Yadea S3",20990000,20990000,0,0
TIKI,o-to-xe-may-xe-dap,71150937,"Hộc đựng đồ phía trước xe Winner X Green Networks Group",109000,109000,0,0
TIKI,o-to-xe-may-xe-dap,107458464,"Thùng đựng đồ gấp gọn Vali kéo đa năng - Dùng trên ô tô, đi siêu thị, di chuyển đồ nặng",473000,485000,12000,2
TIKI,o-to-xe-may-xe-dap,73420083,"Nệm hơi vải nhung cao cấp có vân lướt sóng cho xe ô tô 7 chỗ, có ô để đồ. Tặng kèm bộ bơm hơi và bộ vá",520000,520000,0,0
TIKI,o-to-xe-may-xe-dap,119719160,"Bình Ắc Quy Cho UPS GLOBE WP7.5-12 Khô 12V - 7.5AH",289000,289000,0,0
TIKI,o-to-xe-may-xe-dap,161904001,"Dầu nhớt xe máy MOTUL 3100 GOLD 4T 10W40",120000,120000,0,0
TIKI,o-to-xe-may-xe-dap,171580274,"Xe đạp Thống Nhất TN Nữ - Hàng chính hãng",2326500,2350000,23500,1
TIKI,o-to-xe-may-xe-dap,190641790,"Nhớt Xe Tay Ga Nhập Khẩu Chính Hãng Fuchs Max Scoot Silkolene 10W30 800ml ",120000,120000,0,0
TIKI,o-to-xe-may-xe-dap,179685838,"COMBO 1 CẶP VỎ LỐP XE MÁY AIRBLADE, VISION HÃNGH DPLUS GAI CITY GRIP PRO",900000,900000,0,0
TIKI,o-to-xe-may-xe-dap,143112190,"Bộ 25 nấm cao su vá vỏ Stop&Go vá các loại vỏ không ruột cho xe ô tô, moto, xe máy",250000,250000,0,0
TIKI,o-to-xe-may-xe-dap,139948312,"Đèn Pha Xe Đạp Thể Thao Siêu Sáng Có Còi - Đèn Led Chống Nước Sạc USB Tiện Lợi",219000,219000,0,0
TIKI,o-to-xe-may-xe-dap,97978443,"【Có sẵn hàng】BÔNG TIÊU ÂM CHỐNG ỒN CHO XE Ô TÔ",79000,79000,0,0
TIKI,o-to-xe-may-xe-dap,165966976,"Mũ Bảo Hiểm 3/4 Đầu Royal M268 2 Kính Thời Thượng, Tiện Nghi",440000,680000,240000,35
TIKI,o-to-xe-may-xe-dap,174369645,"Dầu nhớt xe số Castrol Power 1 4T 10W-40, 800ml",126000,126000,0,0
TIKI,o-to-xe-may-xe-dap,172948848,"BỘ NẮP VAN LỐP XE TYPE 1 EXCITER 155",34363,34363,0,0
TIKI,o-to-xe-may-xe-dap,194110103,"Mũ bảo hiểm 1/2 đầu SRT_001 đủ màu, Freesize 55-58cm - Bảo hành 12 tháng",123000,180000,57000,32
TIKI,o-to-xe-may-xe-dap,185776872,"Xe Máy Điện DK Roma Si 2022 - Xanh Rêu",24300000,24300000,0,0
TIKI,o-to-xe-may-xe-dap,119330685,"VIETMAP HUD H1N - Màn Hình Hiển Thị Thông Minh - Phụ Kiện Ô tô (bản không có TPMS)",2590000,2590000,0,0
TIKI,o-to-xe-may-xe-dap,150158225,"Xe đạp trẻ em mini cỡ bánh 22 Vicky VM22",2366100,2390000,23900,1
TIKI,o-to-xe-may-xe-dap,132829080,"Exciter 155 VVA Phiên bản 60 năm Yamaha tranh tài MotoGP",60000000,60000000,0,0
TIKI,o-to-xe-may-xe-dap,98654037,"Xe đạp mini Thống Nhất Autumn LD 24-01 - Hàng chính hãng",2465100,2490000,24900,1
TIKI,o-to-xe-may-xe-dap,80034857,"[COMBO] Máy Lọc Không Khí đa năng & Lõi lọc thay thế - Lọc không khí và khử mùi hiệu quả",899000,899000,0,0
TIKI,o-to-xe-may-xe-dap,186635024,"Phuộc Ohlins chính hãng HO 913 dành cho xe CB650-CBR650R",19490000,19490000,0,0
TIKI,o-to-xe-may-xe-dap,76480195,"Thảm Lót Sàn Ô Tô KATA Cho Xe Toyota Corolla Cross - Hàng Chính Hãng",1990000,1990000,0,0
TIKI,o-to-xe-may-xe-dap,62643037,"Máy bơm lốp xe ô tô mini tự động Xiaomi 70mai Air Compressor Midrive TP01 - Hàng Nhập Khẩu",1049000,1089000,40000,4
TIKI,o-to-xe-may-xe-dap,206110956,"Thảm Lót Sàn Ô Tô KATA  Cho Xe Toyota Raize (2021 - 2023) - Hàng Chính Hãng không mùi, khít sàn, dễ vệ sinh",1990000,1990000,0,0
TIKI,o-to-xe-may-xe-dap,152299760,"( Trả góp 0%) Xe PKL Moto Guzzi - V7 Special - Nhập Ý - Xanh Đậm | Ghi Bóng",405000000,405000000,0,0
TIKI,o-to-xe-may-xe-dap,58850658,"Combo 2 Bóng Đèn Halogen Tăng Sáng 150% OSRAM Night Breaker Laser H11 12V 55W",1391000,1637000,246000,15
TIKI,o-to-xe-may-xe-dap,173885728,"Xe Máy Điện Vespa Valerio SP",15500000,15500000,0,0
TIKI,o-to-xe-may-xe-dap,25729423,"Mũ Bảo Hiểm 3/4 Kính Âm M139",489000,489000,0,0
TIKI,o-to-xe-may-xe-dap,142871848,"Mũ nón bảo hiểm 3/4 có 2 kính Yohe 878 Đen Bóng",1300000,1300000,0,0
TIKI,o-to-xe-may-xe-dap,97541360,"XE ĐẠP ĐIỆN ADIMAN X1 48V-15A",12450000,12450000,0,0
TIKI,o-to-xe-may-xe-dap,73744501,"Nhớt Total Quartz 7000 10W40 (4 lít) - Dầu nhớt Total - Nhớt động cơ xăng ",499000,499000,0,0
TIKI,o-to-xe-may-xe-dap,68438595,"Ắc quy Năng lượng, Viễn Thông, Công Nghiệp Eagle 12V - 200AH (EG200-12)",7939000,7939000,0,0
TIKI,o-to-xe-may-xe-dap,189471274,"Tủ lạnh ô tô Kemin K20 - 20L Chính hãng",3515000,3700000,185000,5
TIKI,o-to-xe-may-xe-dap,100990043,"MÁY BƠM LỐP Ô TÔ TỰ NGẮT TOMORI 12V AC-01 (Bảo hành 12 tháng)",429000,429000,0,0
TIKI,o-to-xe-may-xe-dap,10006580,"Chai vệ sinh sên Liqui Moly 1602 500ml",165000,169000,4000,2
TIKI,o-to-xe-may-xe-dap,129734432,"Gối tựa đầu ô tô cao cấp loại dài xuống vai",184000,184000,0,0
TIKI,o-to-xe-may-xe-dap,1378101,"Chai Xịt Bọt Rửa Xe Không Cần Nước Và Làm Bóng Nhanh 3M Waterless Wash & Wax 39110 (453g)",153000,153000,0,0
TIKI,o-to-xe-may-xe-dap,95306021,"Xe đạp Thống nhất nữ LD 24-02 - Hàng chính hãng - màu",2366100,2390000,23900,1
TIKI,o-to-xe-may-xe-dap,126252700,"[FREESHIP] XE ĐẠP ĐỊA HÌNH MTB GIANT ATX 27.5 – BÁNH 27.5 INCHES – 2021",8490000,8490000,0,0
TIKI,o-to-xe-may-xe-dap,785205,"Mũ Bảo Hiểm 1/2 Đầu Napoli NS-N088 đỏ đô Freesize 54 -57 cm - Bảo hành 12 tháng",155000,250000,95000,38
TIKI,o-to-xe-may-xe-dap,45555291,"Nước Hoa Cao Cấp Grasse L'Esterel - White Lily Musk Bullsone HQST31 (110ml)",278800,396000,117200,30
TIKI,o-to-xe-may-xe-dap,121534541,"Màn hình LED Divoom Pixoo Max 32x32 pixel tích hợp App nhiều tính năng, có thể trang trí treo xe ô tô/ treo tường/ bàn - HÀNG CHÍNH HÃNG",1590000,2200000,610000,28
TIKI,o-to-xe-may-xe-dap,194405724,"HEO PHANH DẦU TRƯỚC EXCITER 155",932727,932727,0,0
TIKI,o-to-xe-may-xe-dap,117071951,"Carlinkit 2.0 U2W Plus 2021 - Apple Carplay không dây cho xe VinFast màn hình nguyên bản",1850000,1850000,0,0
TIKI,o-to-xe-may-xe-dap,119719069,"Ắc Quy LONG WP7.2-12 12V 7.2 AH Dùng Cho Lưu Điện Cửa Cuốn, UPS, Bình Thuốc Sâu",299300,299300,0,0
TIKI,o-to-xe-may-xe-dap,114300574,"Bơm xe đạp GIYO 2530 Áp suất 180PSI/12KG đầu bơm thông minh thân thép",470000,470000,0,0
TIKI,o-to-xe-may-xe-dap,42692737,"Lót Cốp Nhựa TPO Cao Cấp Dành Cho MITSUBISHI OUTLANDER 2016/2020",346000,355000,9000,3
TIKI,o-to-xe-may-xe-dap,183052339,"Xe Đạp Điện DK Tron V",13800000,13800000,0,0
TIKI,o-to-xe-may-xe-dap,111362655,"Nẹp Chân Kính + Viên Cong Kính Inox Xe Ertiga 2019 2020",187000,229000,42000,18
TIKI,o-to-xe-may-xe-dap,176681284,"Nhớt Xe Máy Liqui Moly 3036 Motobike 4T 10W40 Formular 800ml",200000,200000,0,0
TIKI,o-to-xe-may-xe-dap,141503231,"Khăn trùm ninja Bulldog - Hàng Chính Hãng",89000,89000,0,0
TIKI,o-to-xe-may-xe-dap,77851655,"XE MÁY ĐIỆN OSAKAR NISPA SV LIMITED",18950000,18950000,0,0
TIKI,o-to-xe-may-xe-dap,8090597,"Dung dịch Đen & Bóng Lốp FOCAR Tire Care 500ML",171000,175000,4000,2
TIKI,o-to-xe-may-xe-dap,44306247,"Xà bông rửa xe đậm đặc Karshine KA-RX1100 1100ml",75000,79000,4000,5
TIKI,o-to-xe-may-xe-dap,970556,"Thùng Givi B27N Clack (27L) - Tặng Đế MP60N",959000,959000,0,0
TIKI,o-to-xe-may-xe-dap,145302039,"Nón bảo hiểm xe đạp POC P01 chính hãng - Helmets 4U",850000,850000,0,0
TIKI,o-to-xe-may-xe-dap,189473241,"Tủ lạnh ô tô Kemin K15 - 15L Chính hãng",3400000,3400000,0,0
TIKI,o-to-xe-may-xe-dap,165788336,"Bơm Xe Đạp Cầm Tay Deli Cao Cấp - Siêu Nhẹ, Nhỏ Gọn, Tiện Lợi, Dễ Dàng Di Chuyển - Áp Suất Cao - DL880006",142000,142000,0,0
TIKI,o-to-xe-may-xe-dap,178787759,"BÌNH NƯỚC XE ĐẠP GIANT NE RIDE UNLEASHED 600CC",160000,160000,0,0
TIKI,o-to-xe-may-xe-dap,162259596,"Ắc quy khô miễn bảo dưỡng Đồng Nai PTZ7A | 12V - 7Ah",413000,413000,0,0
TIKI,o-to-xe-may-xe-dap,174314587,"Dầu nhớt xe tay ga Castrol Power 1 Scooter 0,8L (800ML)",160000,160000,0,0
TIKI,o-to-xe-may-xe-dap,53505835,"BAO DA CHÌA KHOÁ VINFAST LUX - CHÍNH HÃNG KHẮC TÊN",400000,400000,0,0
TIKI,o-to-xe-may-xe-dap,12256194,"Ốp chìa khóa carbon bọc, bảo vệ chìa khóa xe Honda Civic, City, CRv…kèm móc đeo INOX",139555,146900,7345,5
TIKI,o-to-xe-may-xe-dap,56418216,"Nước Rửa Kính Ô Tô  Xglass Classic Thương Hiệu Ekokemika - Hàng Chính Hãng",65000,65000,0,0
TIKI,o-to-xe-may-xe-dap,51546166,"BỘ 2 MIẾNG ỐP CHÂN GA CHÂN PHANH INOX XE SỐ TỰ ĐỘNG",72000,74000,2000,3
TIKI,o-to-xe-may-xe-dap,13772793,"CERAMIC WAX MEGUIARS - G190526 - 768ML",690000,690000,0,0
TIKI,o-to-xe-may-xe-dap,44067112,"Kẹp điện thoại kiêm sạc không dây ô tô Xiaomi GDS4127GL 20W - Hàng Chính Hãng",945000,945000,0,0
TIKI,o-to-xe-may-xe-dap,10007250,"Chai vệ sinh thắng đĩa, phanh, dầu mỡ Liqui Moly 3318 500mL",114000,119000,5000,4
TIKI,o-to-xe-may-xe-dap,150735868,"Exciter 155 VVA Phiên bản cao cấp màu mới",52500000,52500000,0,0
TIKI,o-to-xe-may-xe-dap,162592165,"Ắc quy UPS JP PA 12-7.2 | 12V - 7,2Ah",262000,262000,0,0
TIKI,o-to-xe-may-xe-dap,12055594,"Lốp Xe Máy Honda Wave S,RS, Futurel Loại dùng ruột Hãng DRC",230000,230000,0,0
TIKI,o-to-xe-may-xe-dap,1254733,"Súc Rửa Động Cơ Liqui Moly Motorbike Engine Flush 1657 (250ml)",180000,180000,0,0
TIKI,o-to-xe-may-xe-dap,125838232,"Hộp Tỳ Tay Xe Dùng Chung Cho Các Loại Xe Ô TÔ 7 Cổng USB",336000,345000,9000,3
TIKI,o-to-xe-may-xe-dap,85804968,"Ví đựng giấy tờ dành cho xe ô tô toyota camry vios inova",25000,25000,0,0
TIKI,o-to-xe-may-xe-dap,124385370,"Lót Cốp Nhựa Xe Mitsubishi Attrage 2016-2021 Nhựa TPO Cao Cấp Không Mùi",328000,336000,8000,2
TIKI,o-to-xe-may-xe-dap,986907,"Chai Xịt Vệ Sinh Sên Xích WD-40 Chain Lube 351020 (360ml)",175000,175000,0,0
TIKI,o-to-xe-may-xe-dap,66741767,"Dung dịch dưỡng bóng lốp Flamingo 650 ml dạng bọt",76000,76000,0,0
TIKI,o-to-xe-may-xe-dap,173517773,"Xe máy Honda Lead Phiên bản Tiêu Chuẩn",38935000,38935000,0,0
TIKI,o-to-xe-may-xe-dap,49548350,"Chai Xịt Phủ Bóng, Phủ Nano Chống Bám Nước Đa Năng Rain Drop SOFT99 W-526",240000,240000,0,0
TIKI,o-to-xe-may-xe-dap,122829840,"Ốp Bậc cửa trong Honda CRV Titan Cao cấp - Hàng Chính Hãng",334990,334990,0,0
TIKI,o-to-xe-may-xe-dap,155830271,"Lót cốp  dành cho Ford Ecosport 2014 - 2017 chất liệu TPO cao cấp",315000,323000,8000,2
TIKI,o-to-xe-may-xe-dap,193912046,"BỘ TAY PHANH",319091,319091,0,0
TIKI,o-to-xe-may-xe-dap,97990722,"Thảm Lót Sàn Ô Tô Mazda CX5 (2018 - 2022) - Phiên Bản KATA Pro viền ép nhiệt",2990000,2990000,0,0
TIKI,o-to-xe-may-xe-dap,11444251,"Nước hoa kẹp cửa gió hương Platinum (Nam tính – Nhẹ)",256000,256000,0,0
TIKI,o-to-xe-may-xe-dap,27857624,"NƯỚC LÀM MÁT ĐỘNG CƠ XE LOẠI MÀU ĐỎ PHA SẴN CAO CẤP LIQUI MOLY COOLANT 6924 1000ML",189000,189000,0,0
TIKI,o-to-xe-may-xe-dap,158119268,"Hộp tỳ tay Hyundai i10 có usb theo phom xe",357000,366000,9000,2
TIKI,o-to-xe-may-xe-dap,7970095,"Xe Máy Yamaha Janus Bản Đặc Biệt - Xanh cô ban",35500000,35500000,0,0
TIKI,o-to-xe-may-xe-dap,17893166,"Găng tay Kawasaki Cụt Ngón",85000,85000,0,0
TIKI,o-to-xe-may-xe-dap,24842079,"Túi treo đồ trên ô tô kiêm giá để đồ bằng da màu đen",144000,164000,20000,12
TIKI,o-to-xe-may-xe-dap,2006189,"Lót Ghế Làm Mát Lưng Trên Ô Tô Lifepro L261-CS (Ghi)",790000,790000,0,0
TIKI,o-to-xe-may-xe-dap,67363891,"Kính chiếu hậu xe Cub 81 chân 8 ly Green Networks Group",89000,89000,0,0
TIKI,o-to-xe-may-xe-dap,149248441,"Bộ Đèn Led Màu Sắc PTA Gắn Van Xe Đạp, Xe Máy",19000,19000,0,0
TIKI,o-to-xe-may-xe-dap,58210510,"Bọc vô lăng, bọc vô lăng da vương miện, chất liệu da PU cao cấp",190000,205000,15000,7
TIKI,o-to-xe-may-xe-dap,184907371,"Mũ bảo hiểm nửa đầu Rona Haly viền bạc chính hãng",120000,200000,80000,40
TIKI,o-to-xe-may-xe-dap,58376561,"Tẩu sạc oto hoco z36 2 cổng sạc 2.4A - củ sạc xe hơi cao cấp cốc sạc ô tô chống cháy nổ giao mầu ngẫu nhiên - hàng chính hãng",110000,110000,0,0
TIKI,o-to-xe-may-xe-dap,57911564,"Cặp tay thắng và tay côn theo xe WINNER, WINNER X màu đen Green Networks Group",79000,79000,0,0
TIKI,o-to-xe-may-xe-dap,57917191,"Cặp tay thắng và tay côn theo xe EXCITER 135,150 Greennetworks",89000,89000,0,0
TIKI,o-to-xe-may-xe-dap,1510685,"Dung Dịch Vệ Sinh Bánh Mâm Michelin Wheel Cleaner 1047 (600ml)",144000,144000,0,0
TIKI,o-to-xe-may-xe-dap,13376734,"Nệm hơi ô tô phủ nhung cao cấp tặng kèm bơm điện và 2 gối hơi PN-90",430000,430000,0,0
TIKI,o-to-xe-may-xe-dap,95939283,"Rèm che nắng kính lái ô tô",109859,109859,0,0
TIKI,o-to-xe-may-xe-dap,189509033,"Honda City RS 2022 PPF TPU chống xước tự hồi phục STAR FILM",300000,300000,0,0
TIKI,o-to-xe-may-xe-dap,55209763,"Bóng Đèn Tăng Sáng Bosch 9005 (HB3) 12V 65W Sportec Bright 4000K (Hộp 2 Bóng)",581000,581000,0,0
TIKI,o-to-xe-may-xe-dap,50227727,"Phụ gia nhớt vệ sinh động cơ xe máy Bluechem 33017",77000,79000,2000,3
TIKI,o-to-xe-may-xe-dap,102056927,"Bọc vô lăng TTAUTO cho xe ô tô từ 4 đến 7 chỗ chất liệu da vân carbon cao cấp có logo NISSAN (Đen)",250000,250000,0,0
TIKI,o-to-xe-may-xe-dap,58570549,"Ốp Trang Trí Gương Chiếu Hậu Cacbon Cho Xe-Ranger 2016-2020",227000,232500,5500,2
TIKI,o-to-xe-may-xe-dap,171116935,"(Trả góp 0%) Xe máy Vespa Primavera 125 ABS",75099000,75099000,0,0
TIKI,o-to-xe-may-xe-dap,74542996,"Meguiar's Mút dưỡng chuyên dụng màu vàng, đường kính 11 cm",33000,33000,0,0
TIKI,o-to-xe-may-xe-dap,41012532,"Dầu nhờn khô, tác dụng cao WD-40 Specialist High Performance Dry Lube 360ml",175000,175000,0,0
TIKI,o-to-xe-may-xe-dap,6579497,"Mũ bảo hiểm 3/4 giấu kính Sunda 388",541000,569000,28000,5
TIKI,o-to-xe-may-xe-dap,125838217,"Đồ Chơi Xe Bán Tải Ranger Ốp Viền Đèn Pha Hậu 2016-2021 đen nhám",243000,256000,13000,5
TIKI,o-to-xe-may-xe-dap,872648,"Chai Phủ Bóng, Chống Bám Nước Nhanh Smooth Egg Hydro Flash Soft99 W-521",224250,299000,74750,25
TIKI,o-to-xe-may-xe-dap,125887860,"PWE-S800 Loa sub gầm ghế kích thước 8 inch thương hiệu Alpine chính hãng",7500000,7500000,0,0
TIKI,o-to-xe-may-xe-dap,35576676,"Combo 5 món sơn carbon (Ốp pô + Pô E + Két nước + Mỏ Dè trước, sau ) AirBlade 125 (2016-2019)",178000,178000,0,0
TIKI,o-to-xe-may-xe-dap,141917379,"Bộ Ốp Tay Nắm Và Hõm Cửa Vân Carbon Cho Xe Ô Tô - Ford Ranger 2015 - 2021",195000,205000,10000,5
TIKI,o-to-xe-may-xe-dap,25434872,"Cặp 2 cái ruột xe đạp, săm xe đạp DELI TIRE 27.5x1.75/2.125 Van Pháp 43mm ",129000,129000,0,0
TIKI,o-to-xe-may-xe-dap,71672524,"Ăng ten bắt sóng vây cá mập gắn trần ô tô, tăng cường thu sóng radio, sóng GPS, sóng di động, tự lắp đặt dễ dàng tại nhà chỉ với một vài thao tác",99000,99000,0,0
TIKI,o-to-xe-may-xe-dap,1254765,"Dầu Phuộc Nhún Xe Liqui Moly Motorbike Fork Oil 10W Medium 1506 (500ml)",225000,225000,0,0
TIKI,o-to-xe-may-xe-dap,178034677,"Nước rửa xe tạo bọt tuyết, xà phòng rửa xe siêu sáng bóng Sprayking Super Wash 1000ml, mùi hương thơm mát, dễ chịu",69000,69000,0,0
TIKI,o-to-xe-may-xe-dap,26668994,"Túi da để đồ sau lưng ghế xe ô tô 6 ngăn",185000,195000,10000,5
TIKI,o-to-xe-may-xe-dap,1899623,"Combo 3 Chai Phụ Gia Làm Sạch Buồng Đốt BCP S-Ultra 60ML (Tặng 1 Chai Cùng Loại)",220000,220000,0,0
TIKI,o-to-xe-may-xe-dap,53611204,"Ốp, bọc chìa khóa silicon màu tráng gương bảo vệ chìa khóa cho xe Toyota Fortuner, Corolla Altis, Innova, Hilux, Yaris…kèm móc đeo INOX",197000,218000,21000,10
TIKI,o-to-xe-may-xe-dap,173622523,"Quạt máy đôi lắp ô tô xoay 360 tiện ích gắn taplo xe hơi , xe tải, văn phòng cao cấp mẫu mới loại tốt gió mạnh, phụ kiện ô tô",195000,195000,0,0
TIKI,o-to-xe-may-xe-dap,37402255,"BỘ NẸP VIỀN CONG KÍNH INOX XE HYUNDAI i10 SEDAN-2019",335000,343980,8980,3
TIKI,o-to-xe-may-xe-dap,172360415,"Bạt trùm xe máy RANDO chính hãng, cao cấp",199000,199000,0,0
TIKI,o-to-xe-may-xe-dap,2050631,"Băng keo cường lực siêu mỏng 3m khổ 10mm x 33m VHB 5915-10",219000,219000,0,0
TIKI,o-to-xe-may-xe-dap,177311333,"Vè mưa Civic 2006-2007-2008 vè đen che mưa bảo vệ trang trí xe",289000,289000,0,0
TIKI,o-to-xe-may-xe-dap,177301078,"Ốp gương Vios 2014-2015-2016-2017 mạ crom bảo vệ chống trầy trang trí làm đẹp xe",222000,228000,6000,3
TIKI,o-to-xe-may-xe-dap,42687611,"Combo 2 Trang Trí Bọc Dây An Toàn FOCUS F-X01A Màu Kem",115000,135000,20000,15
TIKI,o-to-xe-may-xe-dap,111362635,"Thảm Taplo Da Carbon Dành Cho Xe Honda City 2021 Chất Liệu Da Cao Cấp",223000,229000,6000,3
TIKI,o-to-xe-may-xe-dap,195343801,"Khóa dây xe đạp cao cấp Yale YCL1- khóa xe chống trộm của Mỹ",650000,650000,0,0
TIKI,o-to-xe-may-xe-dap,47963741,"Túi Treo Đồ Sau Ghế Da Cao Cấp có bàn ăn gấp gọn dành cho xe ô tô - Các ngăn chứa thiết kế thông minh tiện lợi - Màu Be - PHÙ HỢP VỚI TẤT CẢ CÁC LOẠI XE",193000,198000,5000,3
TIKI,o-to-xe-may-xe-dap,86292251,"Xe đạp thể thao phượng hoàng khung nhôm 29" 21 speed",3752500,3950000,197500,5
TIKI,o-to-xe-may-xe-dap,186161257,"Thảm taplo Grand I10 2014-2015-2016-2017-2018-2019-2020-2021-2022 chống nắng nóng làm mát xe mở rộng tầm nhìn",195000,195000,0,0
TIKI,o-to-xe-may-xe-dap,70023785,"Nắp chụp van vòi CNC titan trang trí xe máy ( Kiểu Ngẫu Nhiên ) Green Networks Group",79000,79000,0,0
TIKI,o-to-xe-may-xe-dap,7970759,"Xe Máy Yamaha Janus Bản Tiêu Chuẩn 2019 - Đỏ",31500000,31500000,0,0
TIKI,o-to-xe-may-xe-dap,32191002,"Thanh gạt mưa Bosch AeroTwin 22 inch - 550mm",387000,387000,0,0
TIKI,o-to-xe-may-xe-dap,163870964,"Thảm lót cốp xe ô tô MAZDA 3 (HATCHBACK) 2014-2017 nhãn hiệu Macsim chất liệu TPV cao cấp màu đen (196)",1800000,1800000,0,0
TIKI,o-to-xe-may-xe-dap,138288591,"Xe Ga SYM ELITE 50CC - Cao Cấp",24300000,24300000,0,0
TIKI,o-to-xe-may-xe-dap,74220285,"Xe điện drift 3 bánh Homesheel thế hệ mới D1 USA màu đen sấm sét - Hàng chính hãng",4990000,4990000,0,0
TIKI,o-to-xe-may-xe-dap,99834121,"VÍ DA ĐỰNG ĐĂNG KIỂM, GIẤY TỜ Ô TÔ XE HƠI CAO CẤP - LOGO VIP",25000,25000,0,0
TIKI,o-to-xe-may-xe-dap,59284326,"Bộ 8 Ốp Tay Nắm Và Hõm Cửa Mạ Crom Chống Trầy Xước Cho Ô Tô Hilux Revo",273000,279500,6500,2
TIKI,o-to-xe-may-xe-dap,72628561,"Bộ Ốp Hõm Tay Nắm Cửa Mạ Crom Dành Cho xe Rondo",270000,277000,7000,3
TIKI,o-to-xe-may-xe-dap,195249332,"Meguiar's Khăn lau khô Microfiber siêu thấm hút nước - Water magnet drying towel - X2000EU - 55 x 76 cm",400000,400000,0,0
TIKI,o-to-xe-may-xe-dap,58570743,"Ốp Mang Cá Vân Cacbon  - Ranger 2016-2020",279500,279500,0,0
TIKI,o-to-xe-may-xe-dap,133786552,"DUNG DỊCH LÀM SẠCH GHẾ DA, NỘI THẤT TEXIL -1L",144000,144000,0,0
TIKI,o-to-xe-may-xe-dap,206781567,"Thảm lót sàn ô tô KATA cho xe Honda Civic (2016- 2021) - Khít với sàn xe, Chống thấm, Không mùi, Không ẩm mốc",1990000,1990000,0,0
TIKI,o-to-xe-may-xe-dap,118300021,"Xe đạp GIANT INEED STREET",9490000,9490000,0,0
TIKI,o-to-xe-may-xe-dap,147050260,"Xe Máy Yamaha Latte - Smart Key ( Phiên bản giới hạn)",39800000,39800000,0,0
TIKI,o-to-xe-may-xe-dap,95306030,"Xe đạp Trẻ em Thống Nhất kiểu HQ 16-03 (Dành cho trẻ từ 4 - 7 tuổi) - Hàng chính hãng",1470150,1485000,14850,1
TIKI,o-to-xe-may-xe-dap,100103977,"VIETMAP HUD H1AS - Hud Dẫn Đường CẢNH BÁO Camera- Giao Thông- Báo Tốc độ- Kết Nối Cảm Biến Áp Suất Lốp- Hàng Chính Hãng",3590000,3590000,0,0
TIKI,o-to-xe-may-xe-dap,45555262,"Nước Đánh Bóng Sơn Bullsone HQCT13 (550ml) - Hàng Chính Hãng",128000,159000,31000,19
TIKI,o-to-xe-may-xe-dap,181565776,"Thùng givi G12N kèm bát gắn cho xe Winner X V3, Winner X 2022",750000,750000,0,0
TIKI,o-to-xe-may-xe-dap,49990214,"Vỏ / Lốp xe đạp không gấp Schwalbe Lugano II Tire 700 x 25C (25-622)",325000,325000,0,0
TIKI,o-to-xe-may-xe-dap,196205323,"Túi tanklock givi ST602B gắn cho xe motor, xe phân khối lớn, túi gắn bình xăng givi ST602B",1750000,1750000,0,0
TIKI,o-to-xe-may-xe-dap,3692997,"Xtreme polymer lai bảo vệ mặt sơn Sonax xtreme protect và shine 222100 210ml",280000,280000,0,0
TIKI,o-to-xe-may-xe-dap,118298435,"Tay nắm GIANT GBT-5",244020,244020,0,0
TIKI,o-to-xe-may-xe-dap,71963701,"Thùng đi phượt GIVI E43NTL - Monolock Top Case Dung tích lớn 43Lít dùng cho tất cả các dòng xe",1699000,1699000,0,0
TIKI,o-to-xe-may-xe-dap,75453598,"Xe Điện Scooter Gấp Gọn Thông Minh Homesheel Scooter X8",10493540,12797000,2303460,18
TIKI,o-to-xe-may-xe-dap,187046188,"Xe đạp đường phố GIANT ESCAPE R3 MS 2022 (Nội địa Nhật Bản)",11590000,11590000,0,0
TIKI,o-to-xe-may-xe-dap,184696380,"Thùng givi E43NTL_ADV gắn cho xe máy điện Datbike Weaver 200, bộ thùng đã bao gồm baga ",2980000,2980000,0,0
TIKI,o-to-xe-may-xe-dap,118299608,"Xe đạp GIANT INEED HUNTER 1.0 D 2022",10050000,10050000,0,0
TIKI,o-to-xe-may-xe-dap,198035750,"Aprilia SRGT 200 - Xe ga đa địa hình 174cc | Thương hiệu Aprilia của Ý thuộc tập đoàn Piaggio Việt Nam",97000000,97000000,0,0
TIKI,o-to-xe-may-xe-dap,118297804,"Xe đạp Giant ATX 660 2022",9190000,9190000,0,0
TIKI,o-to-xe-may-xe-dap,119719095,"Bình ắc quy khô GS GT5A 12V-5Ah cho xe máy Dream, Wave, Future, Sirius, Jupiter, Taurus, Mio",290000,290000,0,0
TIKI,o-to-xe-may-xe-dap,162540390,"Ắc quy khô miễn bảo dưỡng Đồng Nai CMF 55B24LS | 12V - 52Ah",1258000,1258000,0,0
TIKI,o-to-xe-may-xe-dap,193229754,"Xe đạp điện cho học sinh nữ Wiibike Mira Pro 36V Xe đạp Trợ lực điện dáng xe mini Nhật công suất 350W tốc độ tối đa 35Km/h an toàn cho học sinh, người già",10990000,10990000,0,0
TIKI,o-to-xe-may-xe-dap,34480840,"Bộ ốc proti xi mạ titan gắn dàn áo các loại xe máy,moto (6ly 2 phân) BẢO LONG RACING",72000,72000,0,0
TIKI,o-to-xe-may-xe-dap,194130741,"Xe đạp trợ lực điện gấp gọn Fiido X",34500000,34500000,0,0
TIKI,o-to-xe-may-xe-dap,173519799,"Xe máy Honda Lead Phiên bản Cao Cấp",41535000,41535000,0,0
TIKI,o-to-xe-may-xe-dap,7151749,"Xe Đạp Điện Osakar A8",12500000,12500000,0,0
TIKI,o-to-xe-may-xe-dap,158886121,"[ CHỈ GIAO TẠI HÀ NỘI ] HONDA WINNER X ĐẶC BIỆT",41500000,41500000,0,0
TIKI,o-to-xe-may-xe-dap,69465877,"Bộ Pin Sạc Dự Phòng Cho Đèn Pha Xe Đạp 8.4V 13800mAh Pin Lithium 4x16850 Dung Lượng Lớn 2 Ngõ Ra USB/ DC Sạc qua Ngõ DC (Không kèm adapter sạc DC) Mai Lee",284050,299000,14950,5
TIKI,o-to-xe-may-xe-dap,206319551,"( Trả góp 0%) Xe PKL Moto Guzzi V7 Stone 2022 -  Nhập Ý - Đen | Vàng | Cam | Ghi",385000000,385000000,0,0
TIKI,o-to-xe-may-xe-dap,99045565,"Bình xịt vệ sinh điều hòa ô tô, vệ sinh dàn lạnh, bình xịt vệ sinh Flamingo",123000,185802,62802,34
TIKI,o-to-xe-may-xe-dap,118298265,"Xe đạp Giant IRIDE CX 2022",8300000,8300000,0,0
TIKI,o-to-xe-may-xe-dap,12222749,"Xe Máy Yamaha Grande 2019 (Bản Đặc Biệt)",52000000,52000000,0,0
TIKI,o-to-xe-may-xe-dap,92137044,"Nhớt xe số đời mới cao cấp Motul 5100 4T 10W30 công nghệ Ester tổng hợp 100% API SM, MA2 - dùng đường phố đường trường xe đời mới NKLUBE",143000,143000,0,0
TIKI,o-to-xe-may-xe-dap,75356740,"XE MÁY YAMAHA EXCITER 155 VVA - BẢN TIÊU CHUẨN ( 3 )",46000000,46000000,0,0
TIKI,o-to-xe-may-xe-dap,36536179,"Máy bơm lốp xe đạp, xe máy, mô tô siêu tốc MICHELIN 12320 dùng pin",900000,900000,0,0
TIKI,o-to-xe-may-xe-dap,121258698,"Xe đạp đôi Thống Nhất cỡ 26 - Hàng chính hãng",3811500,3850000,38500,1
TIKI,o-to-xe-may-xe-dap,73722526,"Máy lọc không khí ô tô Michelin ML-19, loại bỏ 99,9% vi khuẩn và hạt lơ lửng trong không khí",1559000,1559000,0,0
TIKI,o-to-xe-may-xe-dap,74691140,"Nẹp Cốp Sau Bảo Vệ Phần Sơn Ngoài Dành Cho Xe Toyota Fortuner 2020 - 2021",525000,538000,13000,2
TIKI,o-to-xe-may-xe-dap,174626697,"ắc quy khô miễn bảo dưỡng đồng nai CMF 55b24ls (52ah)",1220000,1220000,0,0
TIKI,o-to-xe-may-xe-dap,192978862,"Xe đạp trợ lực điện gấp gọn Fiido D11",19690000,19690000,0,0
TIKI,o-to-xe-may-xe-dap,118299978,"Xe đạp thể thao nữ GIANT LIV MEME 2 2021",9200000,9200000,0,0
TIKI,o-to-xe-may-xe-dap,178787771,"Xe đạp đường phố dáng nữ Giant Momentum Ineed Dandy N3 2021",12700000,12700000,0,0
TIKI,o-to-xe-may-xe-dap,118300012,"Xe đạp touring Momentum TROOPER 5100 2021",15700000,15700000,0,0
TIKI,o-to-xe-may-xe-dap,159436465,"XE ĐẠP TRẺ EM FORNIX MX20",2802000,2990000,188000,6
TIKI,o-to-xe-may-xe-dap,142871669,"Áo khoác giáp bảo hộ LS2 ALBA MAN chạy xe máy, moto",2690000,2690000,0,0
TIKI,o-to-xe-may-xe-dap,150931825,"Xe đạp địa hình bánh 22 Vicky
 VIC122",2366100,2390000,23900,1
TIKI,o-to-xe-may-xe-dap,85236188,"Bộ 8 miếng ốp bậc cửa trong ngoài chống trầy xước xe Toyota corolla cross",515000,527990,12990,2
TIKI,o-to-xe-may-xe-dap,178095991,"Mũ bảo hiểm 1/2 đầu có kính cao cấp Protec Hiway họa tiết trắng số 8, mẫu mới, an toàn, thời trang - Hàng chính hãng",379000,498000,119000,24
TIKI,o-to-xe-may-xe-dap,196241528,"Tẩy ố Nanoka Pro Clean 250ml[ HÀNG CHÍNH HÃNG]- Technology of USA",99000,99000,0,0
TIKI,o-to-xe-may-xe-dap,148883210,"Xe đạp mini bánh 26 Vicky 
VM26",2267100,2290000,22900,1
TIKI,o-to-xe-may-xe-dap,12913557,"Mũ Bảo Hiểm Fullface Chính Hãng ROYAL M136",349000,349000,0,0
TIKI,o-to-xe-may-xe-dap,74749464,"Đầu đèn pha led bi cầu mắt cú xe sirius ( 4 chế độ ) chớp trắng , cos pha trắng , led màu Green Networks Group",359000,359000,0,0
TIKI,thoi-trang-nu,82700777,"Bộ 5 Quần lót nữ O2 Cotton Ép Không Đường May, chất liệu thoáng mát thương hiệu BAW QLN14",139000,149000,10000,7
TIKI,thoi-trang-nu,82700818,"BỘ 5 QUẦN LÓT LỤA LẠNH FABIC CẠP CAO KHÁNG KHUẨN KHÔNG LỘ VIỀN CAO CẤP thương hiệu BAW QLN16",139000,199000,60000,30
TIKI,thoi-trang-nu,106002718,"Hộp 5 Đôi 10 Miếng Dán Ti, Dán Ti Silicon Sử Dụng Nhiều Lần Dính Cực Chắc DT01",129000,159000,30000,19
TIKI,thoi-trang-nu,82700848,"Bộ 5 Quần Lót Cotton 365 không hăn chống HPV 10 màu big size đến 65kg cạp vừa thương hiệu Baw QLN17",149000,199000,50000,25
TIKI,thoi-trang-nu,82700793,"Bộ 5 Quần Lót Cotton Không Đường May thương hiệu BAW Kháng Khuẩn Thoáng Mát Màu Sắc Tùy Chọn Cho Nữ QLN15",139000,199000,60000,30
TIKI,thoi-trang-nu,186677676,"Quần Lót Nữ, quần lót Ren nữ Cao Cấp Mềm Mịn, Quần Lót Nữ Co Dãn Tốt Thoáng Mát VILADY 2026",25000,45000,20000,44
TIKI,thoi-trang-nu,177320879,"Miếng Dán Cố Định Quần Áo, Miếng Băng Dính 2 Mặt Thời Trang Cố Định Quần Áo, Dán Kín Khe Hở Ngực LYPK003",24000,29000,5000,17
TIKI,thoi-trang-nu,74855108,"Combo 10 Quần Lót Nữ Cotton Thái Siêu Mịn, Kháng khuẩn BLAZEL - Chất Liệu Thấm Hút Và Co Giãn 4 Chiều Tốt (Nhiều Màu)  - Hàng Chính Hãng",99000,99000,0,0
TIKI,thoi-trang-nu,95312684,"Combo 2 bộ (4 dây) dây áo ngực bản dẹt có thể điều chỉnh tiện lợi LYPK02",17000,18000,1000,6
TIKI,thoi-trang-nu,132171331,"Áo Lót Nữ, Áo Ngực Dán Cài Trước, Áo Ngực Dán Xòa Đệm Thông Hơi Sexy Quyến Rũ Thương Hiệu Baw MS2",99000,159000,60000,38
TIKI,thoi-trang-nu,178062830,"Cặp Miếng Dán Ngực Miley Lingerie GSB0100",15000,25000,10000,40
TIKI,thoi-trang-nu,193345737,"Đồ Bộ Pyjama, Đồ mặc nhà nữ Lụa Pháp cao cấp, mềm mịn, thoáng mát - HW1004 - RELAX",795000,795000,0,0
TIKI,thoi-trang-nu,171760300,"Bộ đồ Pyjama nữ, đồ mặc nhà VILADY - B106 kiểu quần đùi tay ngắn họa tiết lá xanh, chất liệu lụa Pháp (lụa latin) cao cấp",482000,499000,17000,3
TIKI,thoi-trang-nu,173015547,"Váy ngủ nữ, váy lụa 2 dây VILADY - V127 dáng suông màu xanh rêu, chất liệu lụa Pháp cao cấp ( lụa latin)",153000,250000,97000,39
TIKI,thoi-trang-nu,73243081,"Áo Lót Không Gọng Đệm Mỏng LOIRE BRFC13 thiết kế Đệm Liền",189000,189000,0,0
TIKI,thoi-trang-nu,83907537,"Áo Ngực Lụa Sữa Tàng Hình Không Gọng Đệm Mỏng Chống Hở Viền Phong Cách Nhật Bản Ôm Trọn Ngực Thương Hiệu Baw mã AN11",69000,89000,20000,22
TIKI,thoi-trang-nu,187657697,"Quần Ghen Nịt Bụng, Quần Lót Đùi Mặc Váy Có Khuy Nịt Bụng Ôm Bụng Dưới, Quần Lót Su Cạp Cao Giảm Eo Và Mỡ Bụng Sau Sinh QG13",119000,119000,0,0
TIKI,thoi-trang-nu,106765137,"Áo Ngực Đúc Su Không Gọng Xuất Nhật đệm mỏng chống ung thư Thương Hiệu Baw mã AN031",129000,159000,30000,19
TIKI,thoi-trang-nu,165193110,"Quần Ghen Định Hình, Quần Gen Nịt Bụng Dưới Su Pha Ren Có Móc Cài Và Size, Quần Ghen Cạp Cao Siêu Giảm Eo Và Mỡ Bụng Sau Sinh QG5",129000,189000,60000,32
TIKI,thoi-trang-nu,172998034,"Váy ngủ nữ, váy lụa 2 dây VILADY - V129 dáng suông màu ĐEN huyền bí, chất liệu lụa Pháp cao cấp ( lụa latin)",179000,250000,71000,28
TIKI,thoi-trang-nu,146635373,"Áo sơ mi nữ form rộng kiểu tay lỡ cổ tròn NeSa Shop, chất liệu Đũi tơ thấm hút mồ hôi, áo sơ mi nữ nhiều màu, SMH.34",144000,219000,75000,34
TIKI,thoi-trang-nu,95877962,"Quần ngắn ngủ nữ, thun cotton, thoáng mát, mặc nhà, đi chơi, ống rộng, lưng thun, co dãn, họa tiết đa dạng",18000,59000,41000,69
TIKI,thoi-trang-nu,172926829,"Váy ngủ nữ, váy 2 dây lụa VILADY - V128 dáng suông màu đỏ đô  chất liệu lụa Pháp cao cấp",179000,250000,71000,28
TIKI,thoi-trang-nu,84446029,"Áo Ngực Không Dây Nâng Ngực dành cho áo ống, kèm dây trong dành cho áo hở lưng thương hiệu BAW mã AN16",129000,159000,30000,19
TIKI,thoi-trang-nu,70816541,"COMBO 5 quần đùi nữ May 10, quần mặc nhà, quần ngủ",135000,135000,0,0
TIKI,thoi-trang-nu,97758054,"Áo lót không gọng nâng ngực cao cấp, Áo lót nhún nơ thông hơi không gọng sexy thương hiệu BAW TN741",99000,159000,60000,38
TIKI,thoi-trang-nu,180347781,"Combo 2 quần lót lọt khe ren hở mông, quần chip nữ, quần lót nữ sexy hở đáy đầy cám dỗ LYEQ073 (MÀU NGẪU NHIÊN)",58000,86000,28000,33
TIKI,thoi-trang-nu,106782807,"Áo Lót Nữ, Áo Ngực Dán Cài Trước, Áo Ngực Dán Đệm Bàn Tay Sexy Quyến Rũ Thương Hiệu Baw MS1",119000,159000,40000,25
TIKI,thoi-trang-nu,55042458,"Đồ Bơi Nữ Hai Mảnh Đa Năng AT168 MayHomes Áo Bơi Nữ Và Quần Bơi Short Nữ",160050,165000,4950,3
TIKI,thoi-trang-nu,193920267,"Áo Lót Dán Nâng Ngực Silicon - Áo Bra Dán Ngực Silicon Cài Trước Không Gọng Hình Bàn Tay",54000,55000,1000,2
TIKI,thoi-trang-nu,21164740,"Váy ngủ lưới phối ren sexy, kèm quần lót lọt khe VN04, Freesize",35000,35000,0,0
TIKI,thoi-trang-nu,82695200,"Bộ 5 Quần Lót Su đúc viền sóng Vanvene cạp vừa không hằn viền lót may chắc chắn đủ size thương hiệu BAW QLN02",149000,199000,50000,25
TIKI,thoi-trang-nu,1752845,"Bộ 10 Quần Lót Nữ Modal Miley Lingerie - Giao Màu Ngẫu Nhiên - Size",379000,379000,0,0
TIKI,thoi-trang-nu,11339281,"Combo 5 Quần Nữ Ren Ép Bông Miley Lingerie Lily Flower - S",198000,198000,0,0
TIKI,thoi-trang-nu,88000356,"Combo 10 Quần Lót Nữ Su Thông Hơi không đường may, hàng đẹp loại xịn thương hiệu Baw, nhiều màu, vải thun lạnh, thông hơi, co giãn đàn hồi tốt, thấm hút tốt, phù hợp mọi lứa tuổi",179000,189000,10000,5
TIKI,thoi-trang-nu,42712220,"Quần Jean Nữ Lưng Cao AAA JEANS",429000,429000,0,0
TIKI,thoi-trang-nu,193345618,"Đồ Bộ Pyjama, Đồ mặc nhà nữ Lụa Pháp cao cấp, mềm mịn, thoáng mát - HW1003 - RELAX",795000,795000,0,0
TIKI,thoi-trang-nu,84721263,"Áo Thun Nữ Trắng Tay Ngắn Cổ Tròn Aaa Jeans Vải Modal",189000,189000,0,0
TIKI,thoi-trang-nu,108365031,"Áo Khoác Hoodie Nam Nữ Chú Chó Tâm Sự Siêu Cute Có Dây Kéo -Chất Nỉ Ngoại UNisex thoitrangsihienlinh",97000,97000,0,0
TIKI,thoi-trang-nu,72298386,"COMBO 4 Quần Lót Su Đúc LOIRECHIC QSD04 Không Viền May + Mỏng Nhẹ Thoải Mái",295000,295000,0,0
TIKI,thoi-trang-nu,97705793,"Áo Lót Đúc Su Siêu Nâng Ngực Tạo Khe Quyến Rũ, Áo Lót Su Không Gọng Không Đường May Thương Hiệu BAW Mã AN37",89000,159000,70000,44
TIKI,thoi-trang-nu,172917864,"Váy ngủ nữ, váy lụa cao cấp VILADY - V119 kiểu cổ V tay lỡ phối viền màu San hô, chất liệu lụa Pháp ( lụa latin)",283000,420000,137000,33
TIKI,thoi-trang-nu,82874281,"Áo Ngực Đúc Su Không Gọng Xuất Nhật đệm mỏng chống ung thư Thương Hiệu Baw mã AN03",99000,159000,60000,38
TIKI,thoi-trang-nu,74342785,"Áo Lót Nữ Không Gọng Nâng ngực nhẹ LOIRECHIC BRFC02 Kẻ Caro",189000,189000,0,0
TIKI,thoi-trang-nu,83757503,"Bộ 10 Quần Lót Su không đường may thương hiệu BAW hàng loại 1  QLNTOP1",179000,179000,0,0
TIKI,thoi-trang-nu,182148167,"Váy ngủ bodysuit ren cổ yếm xẻ đáy sexy gợi cảm Q530 - Đầm ngủ nữ bodysuit quyến rũ - Đồ ngủ nữ",119000,180000,61000,34
TIKI,thoi-trang-nu,51033486,"Combo 5 Chiếc Quần Lót Nữ Không Đường May Thời Trang iBasic V188, Mềm Mịn, Thoáng Mát - Hàng Chính Hãng",325000,445000,120000,27
TIKI,thoi-trang-nu,36904256,"Bikini Hai Mảnh Đồ Bơi Tay Dài Che Nắng MHAT045 MayHomes Form Chuẩn Thun Bốn Chiều Co Giãn Tốt",259000,259000,0,0
TIKI,thoi-trang-nu,95142133,"Combo 2 Bộ Dây Áo Ngực Trong Suốt Sợi  Bún, Điều Chỉnh Tùy Ý LYPK01",35000,38000,3000,8
TIKI,thoi-trang-nu,166530485,"Áo Ngực Không Gọng Chất Liệu Ren Cao Cấp, Áo Lót Bra Ren Mềm Mẫu Mới Siêu Đẹp Thương Hiệu Baw mã BA1",159000,159000,0,0
TIKI,thoi-trang-nu,84574514,"Áo Ngực Cài Trước Siêu Nâng Ngực Tạo Khe sexy quyến rũ thương hiệu BAW mã AN28",99000,159000,60000,38
TIKI,thoi-trang-nu,109687196,"Áo Lót Teen, Áo Bra Học Sinh Màu Trắng Atuner ANT08 Chất Liệu Cotton Kèm Lưới Thoáng Khí",109000,139000,30000,22
TIKI,thoi-trang-nu,73250348,"Đồ Bơi Nữ Hai Mảnh Kín Đáo Áo Bơi Tay Ngắn Quần Bơi Dạng Váy AT200 MayHomes",139000,168000,29000,17
TIKI,thoi-trang-nu,106750367,"Áo Lót Nữ, Áo Lót Đúc Su Đệm Dày Siêu Nâng Ngực Tạo Khe Quyến Rũ, Áo Ngực Su Bàn Tay Không Gọng Không Đường May Thương Hiệu BAW Mã AN371",129000,159000,30000,19
TIKI,thoi-trang-nu,111646610,"Chân váy công sở xếp ly đính khuy 3 màu xinh xắn",75000,75000,0,0
TIKI,thoi-trang-nu,106756612,"Áo Lót Nữ, Áo Lót Đúc Su Đệm Dày Siêu Nâng Ngực Tạo Khe Quyến Rũ, Áo Ngực Su Thương Hiệu BAW Mã AN373",129000,193500,64500,33
TIKI,thoi-trang-nu,181102211,"[MIỄN PHÍ LÓT LINER] Đai Nịt Bụng Latex "Thế Hệ Mới" - Hàng Đặc Che Mỡ Lưng, Định Hình Eo VITA LATEX Cao Cấp. Tặng Kèm Thước Dây",569000,569000,0,0
TIKI,thoi-trang-nu,144324230,"Quần tây nữ Hiền Trần BOUTIQUE lưng cạp cao âu công sở đẹp màu đen đồ đi học form chuẩn tôn dáng",150000,350000,200000,57
TIKI,thoi-trang-nu,70738824,"Combo 5 Quần Lót Nữ Cotton Flexi Miley Lingerie - Giao màu ngẫu nhiên",199000,395000,196000,50
TIKI,thoi-trang-nu,169831933,"Áo quây/áo ngực nữ không dây/áo lót quây dây/áo ngực mặc váy cúp ngực nâng ngực, dây lưng mảnh cá tính khoe lưng trần gợi cảm và năng động (kèm quai/dây áo ngực trong) LYEA027",112000,119900,7900,7
TIKI,thoi-trang-nu,83812939,"Áo Ngực không dây nâng ngực chống tụt dây rút loại 1, cúp ren sexy quyến rũ thương hiệu Baw mã AN07",119000,159000,40000,25
TIKI,thoi-trang-nu,146222727,"Áo polo nữ ADINO màu trắng phối viền xẻ lai vải cotton co giãn dáng slimfit trẻ trung APN02",139000,278000,139000,50
TIKI,thoi-trang-nu,59205628,"COMBO 5 ÁO LÁ DÀI THUN LỤA DÀNH CHO HỌC SINH",116000,125000,9000,7
TIKI,thoi-trang-nu,163477532,"Quần Đùi Nữ New Design, Quần Short Nữ Cạp Chun, Vải Lụa Mịn, Thoáng Mát ,Mặc Thoải Mái Nhiều Màu ( 40-65 kg) QA0003",39000,69000,30000,43
TIKI,thoi-trang-nu,105657199,"Quần Lót Nữ, Quần Gen Nịt Bụng Eo Thon, Quần Ghen Chống Cuộn Cạp Cao Giảm Eo Và Mỡ Bụng Sau Sinh QG3",99000,129000,30000,23
TIKI,thoi-trang-nu,82704606,"Bộ 3 Quần Lót Nữ Cạp Cao, quần gen bụng giảm mỡ mang cảm giác thoải mái dễ chịu khi hoạt động mạnhthương hiệu BAW QLN28",129000,199000,70000,35
TIKI,thoi-trang-nu,111694609,"Áo sơ mi nữ cộc tay dáng cánh dơi cá tính",79000,79000,0,0
TIKI,thoi-trang-nu,166532192,"Áo Ngực Nữ, Áo Cúp Ngực, Áo Ngực Không Dây Chống Tụt, Áo Lót Mặc Váy Hở Vai Hàng Cao Cấp Thương Hiệu Baw CN02",129000,159000,30000,19
TIKI,thoi-trang-nu,190538075,"Đầm ngủ, Váy ngủ lụa Pháp (Lụa Latin) thiết kế 2 dây chéo lưng phối ren cao cấp VILADY - V147 (Màu Trắng gạo)",279000,479000,200000,42
TIKI,thoi-trang-nu,167957548,"Combo 2 quần lót nữ, quần lót tam giác ren thêu hoa xuyên thấu lọt khe quyến rũ hấp dẫn ( màu ngẫu nhiên) LYEQ043",73000,78000,5000,6
TIKI,thoi-trang-nu,146365730,"Đai Nịt Bụng Vita Latex "Thế Hệ Mới" Cao Cấp Che Mỡ Lưng, Định Hình Eo",599000,599000,0,0
TIKI,thoi-trang-nu,145289939,"Chân Váy Dài Lưng Cao New Design ,Thiết Kế Dài 62cm, Phối Nút Phong Cách Váy Công Sở,  Chất Vải Tốt Co Giãn Nhẹ CV19",179000,349000,170000,49
TIKI,thoi-trang-nu,82700771,"Bộ 5 Quần Lót Đúc Su Ren, chất Su phối ren thoáng mát thương hiệu BAW QLN013",199000,199000,0,0
TIKI,thoi-trang-nu,166531902,"Áo Ngực Nữ, Áo ngực không dây, Áo ngực dây lưng trong có dây rút và bàn tay cúp ngang chống tụt mang đầm hở lưng cúp ngực thương hiệu Baw CT01",139000,159000,20000,13
TIKI,thoi-trang-nu,102121667,"Bộ Đồ Ngủ Nữ Lụa Satin Có Mút Ngực Phối Ren Cao Cấp, Bộ Đồ Ngủ Nữ, Bộ Đồ Ngủ Nữ 2 dây, Đồ Ngủ Gợi Cảm, Đồ Ngủ Sexy, Đồ Ngủ Lụa Mặc Nhà 2 Dây Phối Ren Sexy Quyến Rũ Thương Hiệu Baw Mã DN29 (hình thật shop tự chụp)",199000,199000,0,0
TIKI,thoi-trang-nu,189181218,"Đầm 8 mảnh phối bèo cổ dễ thương-D029",199000,390000,191000,49
TIKI,thoi-trang-nu,97033776,"Áo hoodie có dây kéo in chữ missout thời trang, Áo Khoác Nỉ Bông Loại 1 Missout, Áo Khoác Nỉ Bông Loại 1 Missout, Áo khoác Hoodie dây kéo chất nỉ ngoại form rộng có mũ",99000,99000,0,0
TIKI,thoi-trang-nu,151898685,"áo khoác nỉ nữ NÓN 2 LỚP phong cách cực cute THÊU GẤU HOT TREND 2022, áo khoác Nỉ kéo khoá thêu hình gấu 2 nón, Áo Khoác Nỉ Khoá Kéo Hình Gấu Unisex Mặc Ấm, Áo KHOÁC NỈ thêu Gấu CHẤt nỉ cotton dày dặn có lót lông",109000,109000,0,0
TIKI,thoi-trang-nu,181247408,"Quần Legging Lửng Siêu Co Giãn Thoáng Mát Nâng Mông Siêu Hót Siêu Đẹp Ngố Nữ Cạp Cao Vải Cotton Cao Cấp",185000,185000,0,0
TIKI,thoi-trang-nu,180590012,"Đầm nữ dự tiệc màu trắng dáng xòe cổ V",300000,300000,0,0
TIKI,thoi-trang-nu,95014142,"Áo thun nữ trơn Gold Rhino cao cấp, 2 màu Trắng / Đen, hàng xuất khẩu Nhật Bản, 100% cotton chất xịn, áo phông nữ trơn mềm mịn, thấm hút mồ hôi, kháng khuẩn, khử mùi hôi triệt để - Hàng chính hãng - Đen",179000,350000,171000,49
TIKI,thoi-trang-nu,160819392,"Bồ đồ lót, Set nội y ren xuyên thấu, không gọng mỏng, nhẹ, thêu hoa đầy nữ tính và gợi cảm LYEB024",64000,69000,5000,7
TIKI,thoi-trang-nu,102508214,"Áo Chống Nắng Dáng Ngắn Có Túi Cuộn Atuner AT 029, Vải Cotton, Mỏng Nhẹ, Thông Hơi, Chống Tia UV",79000,149000,70000,47
TIKI,thoi-trang-nu,72204483,"Áo Lót Chống Tụt  Đệm Mỏng LOIRECHIC BRQ02 Dây Đầm Có Viền Cao Su Tặng kèm dây áo",195000,195000,0,0
TIKI,thoi-trang-nu,58255254,"Combo 4 Quần Lót Nữ Lưng Cao Modal Phối Ren Active Miley Lingerie FDS0125-0225-0925-1225 - Giao màu ngẫu nhiên",205000,380000,175000,46
TIKI,thoi-trang-nu,216199950,"Áo Hoodie Kéo Khóa Siêu Sang, Giá Tận Gốc, áo khoác hoodie nỉ nam nữ chất thun nỉ mềm mịn from rộng (có khóa kéo), Áo khoác Hoodie Nam Nữ form rộng - Basic Oversize Zip, Aó hoodie nam , áo hoodie nữ , áo khoác áo hoodie cặp đôi nam nữ mặc",100000,100000,0,0
TIKI,thoi-trang-nu,176184092,"Váy ngủ ren hai dây sexy gợi cảm BT0157 - Đầm ngủ nữ xuyên thấu quyến rũ - Đồ ngủ nữ mạc nhà - Váy ngủ nữ",99000,160000,61000,38
TIKI,thoi-trang-nu,28390948,"Quần tây nữ công sở kiểu quần tây dáng đứng GOTI 3089",183000,183000,0,0
TIKI,thoi-trang-nu,154135275,"Quần Đùi Nữ Mặc Nhà Chất vải Lụa Hàn Quốc ,Mịn ,Mặc Mát, Hàng Thiết kế Cao Cấp (45-65kg)  Nhiều Màu New design  QA0003",42000,79000,37000,47
TIKI,thoi-trang-nu,97685241,"Áo Lót Đúc Su Siêu Nâng Ngực Tạo Khe Quyến Rũ, Áo Lót Su Không Gọng Không Đường May Thương Hiệu BAW Mã AN36",89000,159000,70000,44
TIKI,thoi-trang-nu,1818717,"Áo Ngực Triumph Maxi M039 LZ-VN - Màu Da (Size",520000,520000,0,0
TIKI,thoi-trang-nu,172920086,"Váy ngủ nữ, váy lụa cao cấp VILADY - V120 màu Đen quý phái, kiểu cổ V tay lỡ phối viền, chất liệu lụa Pháp ( lụa latin)",259000,420000,161000,38
TIKI,thoi-trang-nu,192801978,"Áo ngực có gọng mút vừa demi daily iBasic BRAW087",199000,199000,0,0
TIKI,thoi-trang-nu,170831596,"Quần Jean Nữ, Quần Jean Nữ Lưng Cao, Quần Jean Nữ Siêu Hack Dáng thương hiệu Chandi, Jean Nữ co dãn tôn dáng phụ nữ eo thon mẫu KV671",350000,350000,0,0
TIKI,thoi-trang-nu,225303615,"Cuộn Dán Ngực Miếng Dán Nâng Ngực Tạo Được Nhiều Kiểu Nâng Ngực Đa Năng",44000,44000,0,0
TIKI,thoi-trang-nu,121258407,"Áo polo nữ màu trắng phối viền chìm ADINO vải cotton polyester mềm dáng slimfit công sở hơi ôm trẻ trung APN03",159000,318000,159000,50
TIKI,thoi-trang-nu,111058227,"Quần Lót Nữ, Bộ 5 Quần Lót Nữ Cotton Mềm Mịn, Quần Lót Nữ Kháng Khuẩn, Quần Lót Nữ Co Giãn Tốt Thương Hiệu Baw Mã QLN03000",129000,129000,0,0
TIKI,thoi-trang-nu,13745082,"Bộ 10 Quần Lót Nữ Thun Lạnh Fashion Miley Lingerie - BMS_01 - Giao Màu Ngẫu Nhiên",299000,329000,30000,9
TIKI,thoi-trang-nu,82875023,"Áo Ngực Su Đệm Dày Nâng Ngực Tạo Khe Siêu Quyến Rũ Thương Hiệu Baw mã AN04",89000,159000,70000,44
TIKI,thoi-trang-nu,82865098,"Áo Ngực Su Hình Lá Nâng Ngực Không Gọng Đệm 3cm Tạo Khe Quyến Rũ Thương Hiệu Baw mã AN02",159000,159000,0,0
TIKI,thoi-trang-nu,82698680,"Bộ 5 Quần Lót Nữ Cotton gân tăm kháng khuẩn thương hiệu BAW hoạ tiết viền ren sexy điệu đà QLN04",129000,208500,79500,38
TIKI,thoi-trang-nu,106987516,"Áo Khoác bomber dù Gió Angel Land Cặp Nam Nữ Form Unisex siêu xinh- Bomber jackets thoitrangsihienlinh",100000,100000,0,0
TIKI,thoi-trang-nu,13894753,"Áo khoác nữ thoát nhiệt Nhật Bản GOKING, 100% cotton siêu thoáng mát, thấm hút mồ hôi, khử mùi, kháng khuẩn, chống UV, chống nắng nhẹ",275000,275000,0,0
TIKI,thoi-trang-nu,97676376,"Bộ 5 Quần Lót Nữ Cotton Lót May Chống Viêm, Quần Chip Nữ Kháng Khuẩn Cao Cấp Thương Hiệu BAW NT722",149000,199000,50000,25
TIKI,thoi-trang-nu,70662805,"Combo 8 Quần Lót Nữ Cotton Flexi Miley Lingerie - Giao màu ngẫu nhiên",256000,632000,376000,59
TIKI,thoi-trang-nu,55279177,"Đồ Bơi Cặp Đồ Bơi Tay Dài Che Nắng Đi Biển AT172 MayHomes Long Sleeve Couple Swimsuits",270750,285000,14250,5
TIKI,thoi-trang-nu,172666766,"Váy ngủ nữ, váy 2 dây quyến rũ VILADY - V118 kiểu cổ đổ sang chảnh màu đen, chất liệu Lụa Pháp (lụa latin) cao cấp",239000,390000,151000,39
TIKI,thoi-trang-nu,107540897,"ĐẦM ELIZABET MẪU MỚI SANG CHẢNH CÓ HAI MÀU",165000,165000,0,0
TIKI,thoi-trang-nu,140212788,"Áo khoác blazer, áo vest nữ kiểu Hàn Quốc tay lỡ, chất vải đẹp, nhiều màu - Thời trang công sở WFstudios",345000,345000,0,0
TIKI,thoi-trang-nu,73929481,"Áo thun unisex tay lỡ form rộng - Áo phông trái bơ",79000,79000,0,0
TIKI,thoi-trang-nu,82916256,"Bộ 5 Quần Lót Ren cao cấp cạp chéo thương hiệu BAW NT12",129000,149000,20000,13
TIKI,thoi-trang-nu,42735160,"Combo 2 Quần Bầu Đùi Mặc Trong Váy Cạp Chéo Ren Chân Cao Cấp - 5Star",75000,75000,0,0
TIKI,thoi-trang-nu,171929698,"Combo 2 quần lót nữ, quần lọt khe, quần lót tam giác ren lưới xuyên thấu sexy, đính nơ xinh xắn ( màu ngẫu nhiên) LYEQ052",73000,78000,5000,6
TIKI,thoi-trang-nu,166537332,"Chân Váy Nữ, Chân Váy Ngắn Dập Ly Xòe Tầng Có Lót Quần Trong Cao Cấp Thương Hiệu Baw CV01",219000,219000,0,0
TIKI,thoi-trang-nu,165211929,"Áo Lót Nữ, Áo Ngực Đúc Su Không Gọng Xuất Nhật đệm bàn tay thông hơi siêu nâng ngực, áo lót chống ung thư Thương Hiệu Baw mã AN039",99000,129000,30000,23
TIKI,thoi-trang-nu,172665283,"Váy ngủ nữ, váy 2 dây quyến rũ VILADY - V117 màu đỏ thiết kế cổ đổ sang chảnh sexy, chất liệu lụa Pháp (lụa latin) cao cấp",227000,390000,163000,42
TIKI,thoi-trang-nu,86881186,"( HÀNG SẴN) Váy Đầm Nữ Trung Niên Dáng Suông Thời Trang VH88 - Hàng Quảng Châu Cao Cấp(Ảnh thật cuối hình)",365000,365000,0,0
TIKI,thoi-trang-nu,197830004,"Bộ Cọ Rửa Bình Sữa Và Núm Ti 360 Độ Đa Năng Cao Cấp Cho Bé Siêu Tiện Dụng",29000,29000,0,0
TIKI,thoi-trang-nu,82704547,"Bộ 5 Quần Lót Cotton Gân Tăm Không Đường May Kháng Khuẩn thương hiệu BAW QLN27",139000,199000,60000,30
TIKI,thoi-trang-nu,181247667,"Quần Legging Cạp Siêu Cao Siêu Co Giãn Chất Đẹp Hàng Loại 1 Nâng Mông Tôn Dáng Dấu Bụng",225000,225000,0,0
TIKI,thoi-trang-nu,186677617,"Quần Lót Nữ, quần lót Ren nữ Cao Cấp Mềm Mịn, Quần Lót Nữ Co Dãn Tốt Thoáng Mát VILADY 5516",42000,45000,3000,7
TIKI,thoi-trang-nu,78032841,"Áo Lót Cho Phụ Nữ Trung Niên Azuno Az400 Cao Cấp Chất Liệu Cotton Không Gọng Nâng Ngực",65000,85000,20000,24
TIKI,thoi-trang-nu,167598351,"Quần lót cotton nữ đúc su thun lạnh trơn không đường may mặc trong váy dễ thương Q1",20000,22500,2500,11
TIKI,thoi-trang-nu,97708021,"Áo Ngực Không Gọng Chất Liệu Cotton Cao Cấp, Áo Lót Bra Không Gọng dây mảnh Thương Hiệu Baw mã NT730",159000,159000,0,0
TIKI,thoi-trang-nu,146635392,"Áo sơ mi váy dáng dài, chất liệu đũi mềm mịn, áo váy nữ, form dài rộng kiểu Hàn Quốc, NeSa Shop AKH.35",139000,229000,90000,39
TIKI,thoi-trang-nu,51020524,"ÁO LÁ THUN LẠNH NHIỀU SIZE",29000,36000,7000,19
TIKI,thoi-trang-nu,193904238,"Miếng Dán Ngực Silicon Hình Hoa Siêu Chắc Chắn Tiện Lợi Cho Phái Đẹp Hàng Chính Hãng",12000,13000,1000,8
TIKI,thoi-trang-nu,1921261,"Áo Ngực Triumph D179 LZ-VN - Da (Size",240900,240900,0,0
TIKI,thoi-trang-nu,169325905,"Đầm trung niên cao cấp form suông thiết kế màu xanh đen - TTV902 - TTV Store",445000,445000,0,0
TIKI,thoi-trang-nu,74163057,"Combo 3 Quần Lót Nữ Ren Hoa, Phối Lưới Cao Cấp Atuner QL016, Quần Lót Nữ Gợi Cảm, Ngọt Ngào - Hàng Chính Hãng",169000,225000,56000,25
TIKI,thoi-trang-nu,57942548,"Đồ Bơi Tay Dài Chống Nắng Lưng Áo Cao Váy Xòe AT188 MayHomes, Thun Lạnh Co Giãn Tốt, Bền Chắc",249000,249000,0,0
TIKI,thoi-trang-nu,176881225,"Đồ Bơi Nữ Tay Dài Quần Ôm Thân Tôn Dáng AT221 MayHomes Long Sleeves And Long Pants Women Swimwear Set With UPF 50 Sun Protection",341050,359000,17950,5
TIKI,thoi-trang-nu,181247581,"Quần Legging Cạp Cao Chéo Lót Lông Mùa Đông Nâng Ôm Mông Dấu Bụng được may bang tay Hàng Loại 1 KALAA",235000,285000,50000,18
TIKI,thoi-trang-nu,90174963,"COMBO 5 quần đùi nữ May 10, quần mặc nhà, quần ngủ 2XL",135000,135000,0,0
TIKI,thoi-trang-nu,84487723,"Áo Ngực Bra 3 dây cotton có đệm mặc thoáng mát thương hiêu BAW mã AN18",159000,159000,0,0
TIKI,thoi-trang-nu,979203,"Combo 5 Quần Lót Nữ Modern Brief Miley Lingerie BC042 - Màu Ngẫu Nhiên",188000,188000,0,0
TIKI,thoi-trang-nu,72225788,"Áo Ngực Sớ Gỗ Không Gọng Lưng Logo Sporty Chic Miley Lingerie BRW",189000,189000,0,0
TIKI,thoi-trang-nu,9982241,"Áo khoác nữ thoát nhiệt Nhật Bản Goking, 6 túi to tiện dụng, vải thun 100% cotton mỏng nhẹ thoáng mát, thấm hút mồ hôi. Áo chống nắng hàng hiệu cao cấp",275000,275000,0,0
TIKI,thoi-trang-nu,97732361,"Bộ 5 Quần Lót Nữ Cotton Lót May Chống Viêm, Quần Chip Nữ Kháng Khuẩn Cao Cấp Thương Hiệu BAW NT737",149000,199000,50000,25
TIKI,thoi-trang-nu,42869288,"Combo 2 Quần Lót Nữ Mặc Trong Váy Có Túi Bên - 5Star",78000,78000,0,0
TIKI,thoi-trang-nu,92145164,"Đồ Bơi Nữ Hai Mảnh Kiểu Váy Tay Dài Dành Cho Cân Nặng 37Kg-50Kg AT216 MayHomes Chất Liệu Thun Poly",188000,188000,0,0
TIKI,thoi-trang-nu,176021615,"Áo bralette ren iBasic BRAY042",199000,359000,160000,45
TIKI,thoi-trang-nu,105343063,"Quần Lót Nữ, Bộ 5 Quần Lót Nữ Lụa Phối Ren Cao Cấp Mềm Mịn, Quần Lót Nữ Kháng Khuẩn, Quần Lót Nữ Co Dãn Tốt Thoáng Mát Thương Hiệu Baw Mã QLN2606",169000,199000,30000,15
TIKI,thoi-trang-nu,101132256,"Áo lót liner corset chuẩn",43000,43000,0,0
TIKI,thoi-trang-nu,13893263,"Áo khoác nữ thoát nhiệt Nhật Bản GOKING, 6 túi to tiện dụng. Áo chống nắng nhẹ, vải thun 100% cotton thoáng mát, thấm hút mồ hôi",275000,275000,0,0
TIKI,thoi-trang-nu,73487627,"Đồ Bơi Nữ Hai Mảnh Bigsize Kèm Áo Lưới AT198 MayHomes Cho Cân Nặng 67Kg-85Kg",189050,199000,9950,5
TIKI,thoi-trang-nu,34316617,"Siêu giảm giá. Áo phông trơn GOKING form ôm đẹp cho nữ, chất liệu thun 100% cotton siêu thoáng mát. Áo phông nữ hàng hiệu cao cấp",99000,99000,0,0
TIKI,thoi-trang-nu,107036163,"Đồ Lam Đi Chùa # Mẫu Thun Phối",152150,152150,0,0
TIKI,thoi-trang-nu,189737693,"Quần Lót Lọt Khe Su Đúc Không Đường May Không Lộ Viền Gợi Cảm Quyến Rũ Sexy Q7",22000,22500,500,2
TIKI,thoi-trang-nu,68201195,"Áo Ngực Nữ Cotton Không Gọng Miley Lingerie - Màu Trắng Kem BRW02115",199000,290000,91000,31
TIKI,thoi-trang-nu,105192727,"Dây áo trong suốt - Dây vai trong áo ngực nữ Triumph",35000,40000,5000,13
TIKI,thoi-trang-nu,116577315,"Quần ống rộng nữ, quần culottes nữ chất đũi chun lưng cúc khóa dáng lỡ",65000,65000,0,0
TIKI,thoi-trang-nu,107056436,"Áo ngực ren có gọng mút dày demi cài trước iBasic VA149",214000,279000,65000,23
TIKI,thoi-trang-nu,109224752,"Jumpsuit (Áo Liền Quần) Lụa Cổ Tròn Tay Ngắn Sang Trọng",199000,390000,191000,49
TIKI,thoi-trang-nu,97755383,"Áo lót phối ren đệm dày siêu nâng ngực, áo ngực tạo khe quyến rũ thương hiệu BAW NT740",99000,159000,60000,38
TIKI,thoi-trang-nu,172671066,"Bộ đồ ngủ nữ 2 dây mặc nhà dễ thương VILADY - B111 kiểu 2 dây quần cộc màu trắng gạo mềm mát, chất liệu Lụa Pháp ( lụa latin) cao cấp",190000,249000,59000,24
TIKI,thoi-trang-nu,175151515,"Váy ngủ choàng kimono in hoa cao cấp Q418 - Áo choàng ngủ sexy gợi cảm - Đầm ngủ nữ - Đồ ngủ mạc nhà",129000,190000,61000,32
TIKI,thoi-trang-nu,146636028,"Áo kiểu nữ đẹp, chất liệu Đũi, vải mềm mát, thấm mồ hôi, áo kiểu form rộng, áo kiểu nữ Hàn Quốc NeSa Shop. AKH.46",139000,229000,90000,39
TIKI,thoi-trang-nu,98290860,"Quần lót nữ lưng cao không đường may iBasic V189",77000,89000,12000,13
TIKI,thoi-trang-nu,118017395,"Đồ Lam Đi Chùa# Lãnh Tụ Nam Nữ # Đồ Bộ Nam Nữ # Quần Áo Nam Nữ",166578,166578,0,0
TIKI,thoi-trang-nu,72093578,"Áo Ngực Không Gọng Đệm Mỏng LOIRECHIC BRTS14 chất liệu Su Đúc Đệm liền",325000,325000,0,0
TIKI,thoi-trang-nu,84544893,"Áo Lót Bra Ren Cao Cấp mẫu mới 2021 có móc cài thay đổi kích cỡ thương hiêu BAW mã AN21",159000,159000,0,0
TIKI,thoi-trang-nu,136240916,"Combo 3 cặp dán ti/ ngực silicon siêu mềm, chắc chắn, sử dụng nhiều lần",81000,87000,6000,7
TIKI,thoi-trang-nu,68628797,"Combo 10 Quần Lót Nữ Modal Phối Ren Trước Remix - Giao Màu Ngẫu Nhiên FCM04",449000,790000,341000,43
TIKI,thoi-trang-nu,97719473,"Áo Lót Đúc Su Bàn Tay Siêu Nâng Ngực Tạo Khe Quyến Rũ, Áo Lót Su Kẻ Sọc Thông Hơi Không Gọng Không Đường May Thương Hiệu BAW Mã AN38",89000,159000,70000,44
TIKI,thoi-trang-nu,48357722,"Váy ngủ lưới phối ren xẻ tà trước sexy kèm quần lót lọt khe VN16, Đồ lót đồ ngủ gợi cảm, Freesize",90000,90000,0,0
TIKI,thoi-trang-nu,87671213," Áo Khoác Nữ 6 Túi Chống Nắng Cao Cấp Vải Thun Cotton (Li01M) [ 40-80kg",163000,163000,0,0
TIKI,thoi-trang-nu,67381250,"Váy ngủ 2 dây liền thân ôm sát xẻ đáy gợi cảm",80000,80000,0,0
TIKI,thoi-trang-nu,101278887,"COMBO 5  ÁO LÁ  HỌC SINH CẤP 1 HOẶC CẤP 2 .(40KG-77KG)",151200,151200,0,0
TIKI,thoi-trang-nu,1921295,"Áo Ngực Triumph D151 VV-VN - Da Sậm (Size",239000,299000,60000,20
TIKI,thoi-trang-nu,7162313,"Quần Độn Mông Su Cao Cấp 135 - 5Star",56000,56000,0,0
TIKI,thoi-trang-nu,167906833,"Bikini Tay Dài Dễ Thương Hot Trending AT218 MayHomes Đồ Bơi Hai Mảnh Long Sleeves Women Swimwear Set",237500,250000,12500,5
TIKI,thoi-trang-nu,1921281,"Áo Ngực Triumph D151 CS-VN - Da (Size",239000,299000,60000,20
TIKI,thoi-trang-nu,197010897,"Quần lót ren lọt khe sexy gợi cảm 5 màu 02",15000,15000,0,0
TIKI,thoi-trang-nu,118026606,"Đồ Lam Đi Chùa # Áo Tràng Phật Tử Vải Đài Loan Cao Cấp# Nam Nữ",360000,360000,0,0
TIKI,thoi-trang-nu,84824248,"Áo Lót Dán Silicon- Miếng Dán Ngực Hình Xoài Chữ U Dán 1/2 Ngực Gom Ngực Tạo Khe B416",37000,37000,0,0
TIKI,thoi-trang-nu,7166595,"Bộ 4 Quần Lót Cotton Cho Bà Bầu Mềm Mịn (Đủ mầu) -5Star",88000,88000,0,0
TIKI,thoi-trang-nu,82880654,"Áo Ngực Không Gọng, Áo Lót Bra Không Gọng dây mảnh Thương Hiệu Baw mã AN05",99000,159000,60000,38
TIKI,thoi-trang-nu,68196229,"Váy Ngủ Ren Sexy Tặng Kèm Quần Chip  Lọt Khe",39000,39000,0,0
TIKI,thoi-trang-nu,19646743,"Áo khoác ren tà ngắn 06 C107",149000,149000,0,0
TIKI,thoi-trang-nu,101949563,"Quần lót nữ JONES cotton  ren 002",12000,12000,0,0
TIKI,thoi-trang-nu,27880579," Áo Ngực Triumph D151 CS-VN - Da",189000,189000,0,0
TIKI,thoi-trang-nu,192303246,"Quần Độn Mông Hông Thông Hơi Cao Cấp Không Viền Mặc Váy Áo Dài 2 Màu Da Đen Đúc Su Hàng Loại 1",165000,165000,0,0
TIKI,thoi-trang-nu,143362784,"Áo khoác nỉ CERTAIN kéo khóa (ảnh thật), Áo Khoác hoodie Mũ Nỉ CERTAIN from rộng unisex ulzzang phong cách hàn quốc, Áo khoác nỉ, áo kiểu dáng hoodie form rộng cho nam nữ in chữ đẹp",99000,99000,0,0
TIKI,thoi-trang-nu,84558773,"Áo khoác Hoodie Nỉ Lót Bông FUNNY Unisex, Áo khoác nỉ hoodie Funny unisex liền mũ, Áo hoodie cừu funny day , Áo hoodie nam nữ dáng tay phồng, form rộng in hình chú cừu xinh xắn, Hoodie cừu Dáng tay bồng mặc lên xinh xĩu, Áo hoodie cừu",100000,100000,0,0
TIKI,thoi-trang-nu,83857418,"Áo khoác Hoodies tay phồng, Áo Hoodie Nỉ ERON, Áo Khoác Hoodie Nỉ In Chữ ERON Form Rộng 2 Màu Hồng Xanh Siêu, Áo hoodie nam / áo hooodie nữ / áo hoodie form rộng / áo khoác nam có nón trùm đầu / áo hoodie cặp đôi / áo khoác cặp đôi",100000,100000,0,0
TIKI,thoi-trang-nu,141835496,"Áo thun tay lỡ form rộng unisex - Áo phông nam nữ oversize - T shirt The Band",79000,125000,46000,37
TIKI,thoi-trang-nu,83757870,"Quần Lót Nữ Su không đường may thương hiệu Baw hàng loại 1 LOT1",25000,25000,0,0
TIKI,thoi-trang-nu,124489980,"Đồ ngủ sexy / Yếm ngủ không mút ngực, chất liệu phi mềm, kèm quần ren gợi cảm",59000,59000,0,0
TIKI,thoi-trang-nu,59180714,"Quần lót lọt khe nữ buộc dây quyến rũ - Đen",29000,29000,0,0
TIKI,thoi-trang-nu,169628004,"Đồ Bơi Nữ Một Mảnh Ôm Thân Khỏe Khoắn ATI86 MAYHOMES Tay Dài Che Nắng, Long-Sleeve Rashguard, UV Protection",218000,255000,37000,15
TIKI,thoi-trang-nu,120553436,"Bộ Đồ Ngủ Lụa 2 Dây Bèo Nhún Xẻ Cao Cách Điệu BDN07",399000,399000,0,0
TIKI,thoi-trang-nu,118015056,"Đồ Lam Đi Chùa # Thun Bà Lai Lắc Sen # Đồ Bộ Nữ # Quần Áo Nữ",186000,186000,0,0
TIKI,thoi-trang-nu,177272170,"Đồ bộ nữ quần ống suông áo sơ mi 2 túi sang trọng",148500,165000,16500,10
TIKI,thoi-trang-nu,124874229,"Có size đến 85kg-Đồ bộ mặc ở nhà cho nữ quần dài co giãn thoáng mát",99000,99000,0,0
TIKI,thoi-trang-nu,108314567,"Quần Lót Nữ, Bộ 5 Quần Lót Nữ Phối Ren Cao Cấp Mềm Mịn, Quần Lót Nữ Kháng Khuẩn, Quần Lót Nữ Co Giãn Tốt Thương Hiệu Baw Mã QLN032",149000,199000,50000,25
TIKI,thoi-trang-nu,74389326,"Áo Ngực Nâng Ngực Ren Nữ Mút Dày 4cm Active Miley Lingerie - Trắng Kem BRL14001",225000,350000,125000,36
TIKI,thoi-trang-nu,119125984,"Quần Ống Rộng Sapphire Blue Aaa Jeans",449000,449000,0,0
TIKI,thoi-trang-nu,182148354,"Đầm ngủ body hai dây xuyên thấu kèm mút ngực sexy cao cấp Q305 - Váy ngủ ôm body sexy gợi cảm - Đồ ngủ nữ",129000,190000,61000,32
TIKI,thoi-trang-nu,116575084,"Quần ống rộng nữ,quần ống suông nữ chun lưng cúc khóa chất đũi kiểu hàn quốc",69000,69000,0,0
TIKI,thoi-trang-nu,104908173,"chân váy A dáng dài xếp ly phối 3 khuy chất tuyết mưa",115000,115000,0,0
TIKI,thoi-trang-nu,136091102,"váy trễ vai trắng tay bồng dáng dài, đầm trễ vai tiểu thư dự tiệc màu trắng điệu đà",90000,90000,0,0
TIKI,thoi-trang-nu,122437275,"Quần lót ren gợi cảm sexy siêu mỏng xuyên thấu",35000,35000,0,0
TIKI,thoi-trang-nu,51580298,"Áo Sơ Mi Nữ Sọc Công Sở Cao Cấp",157000,157000,0,0
TIKI,thoi-trang-nu,124489767,"Đầm ngủ, váy ngủ phi không mút 2 dây viền ren 2 bên sexy quyến rũ 834",56000,56000,0,0
TIKI,thoi-trang-nu,125502044,"Áo Khoác Thun Nỉ Bông Tay Dài Chống Nắng Sunday Nam nữ Cặp HOT RẺ ĐẸP Áo Hoodie Unisex kiểu Hàn Quốc Rộng Couple Jackets [ẢNH THẬT]Ư - HIÊN LINH SHOP ÁO KHOÁC HOODIE NỈ BÔNG",100000,100000,0,0
TIKI,thoi-trang-nu,87670396," Áo Khoác Nữ Chống Nắng Cao Cấp 6 Túi USSA [40-80kg",159000,159000,0,0
TIKI,thoi-trang-nu,113256243,"Quần ống rộng thô đũi cạp cao",71250,71250,0,0
TIKI,thoi-trang-nu,73166774,"COMBO 3 Quần Lót Su Đúc Không Đường May LOIRECHIC QSD03 Thoải Mái",270000,270000,0,0
TIKI,thoi-trang-nu,122351619,"Quần Jeans Dài Nữ Giordano 05419038",790000,790000,0,0
TIKI,thoi-trang-nu,72568681,"Đồ Bơi Nữ Hai Mảnh Họa Tiết Sọc Trắng Xinh AT195 MayHomes One Size, Kiểu Dáng Thể Thao",158860,169000,10140,6
TIKI,thoi-trang-nu,168356585,"Đồ Bơi Nữ Hai Mảnh Cute Tôn Dáng Kiểu Croptop AT220 MayHomes Áo Tắm Women Swimwear Set",237500,250000,12500,5
TIKI,thoi-trang-nu,193909439,"Hộp 10 Miếng Dán Ngực Silicon Siêu Tiện Lợi Tái Sử Dụng Nhiều Lần",54000,54000,0,0
TIKI,thoi-trang-nu,177078253,"Bikini Tay Dài Hai Mảnh Năng Động Trẻ Trung A158T MayHomes Áo Croptop Thun Lạnh Co Giãn Không Phai Màu",225000,255000,30000,12
TIKI,thoi-trang-nu,84544002,"Áo Lót Bra Satin Bóng Trơn Dây Mảnh cao cấp thương hiệu BAW mã AN20",59000,89000,30000,34
TIKI,thoi-trang-nu,85705020,"Áo Chống Nắng Nữ Cotton Laroma| UPF50+ | Vải Thơm | Làm Mát | Thời Trang | Đa Dụng",349000,349000,0,0
TIKI,thoi-trang-nu,73274182,"Áo Quây Nâng Ngực Chống Tụt Tặng Kèm Dây Trong LOIRECHIC BRQ06",349000,349000,0,0
TIKI,thoi-trang-nu,174131331,"Quần Bò Nữ Cạp Cao Ôm Dáng Skinny Xanh Đậm Aaa Jeans",429000,429000,0,0
TIKI,thoi-trang-nu,181247126,"Quần Lót Độn Mông Hông Thông Hơi Siêu Thoáng Mát Mềm Mại 2IN1 Sexy Quyễn Rũ",149000,149000,0,0
TIKI,thoi-trang-nu,177266853,"Bikini Hai Mảnh Họa Tiết Hoa Nhí AT223 MayHomes Đồ Bơi Nữ Thun Lạnh Co Giãn Tốt Two-Piece Swimwear",235600,248000,12400,5
TIKI,thoi-trang-nu,74444966,"Áo Lót Nữ, Áo Bra Ren Su Đúc Azuno AZB85 Quai Bản To Mặc Mùa Hè Cực Mát, Thoải Mái",39000,61000,22000,36
TIKI,thoi-trang-nu,155351222,"Váy/đầm ngủ ren lưới mềm mại, cao cấp,  khoét ngực sâu đầy quyến rũ, gợi cảm LYEN015",176000,189000,13000,7
TIKI,thoi-trang-nu,86967442,"Quần Jean Nữ Lưng Cao thương hiệu Chandi, chất jean cotton co dãn tôn dáng phụ nữ eo thon mẫu KV617",299000,299000,0,0
TIKI,thoi-trang-nu,144933174,"Áo Hoodie Nam Nữ Unisex , Áo nỉ Sweater có Mũ 2 lớp cao cấp chui đầu Form Rộng Chất Liệu Nỉ Bông Trơn Nhiều Màu",95000,95000,0,0
TIKI,thoi-trang-nu,145290257,"Chân váy bút chì - Váy công sở cao cấp có túi form chuẩn dáng đẹp",179000,299000,120000,40
TIKI,thoi-trang-nu,84532478,"Áo Lót Bra dây chất liệu ren hoa lá siêu hót sang chảnh cho mùa hè thương hiệu BAW mã AN19",159000,159000,0,0
TIKI,thoi-trang-nu,124489754,"Đồ ngủ sexy nữ Đồ ngủ hai dây có mút ngực chất phi hai dây chất mịn quyến rũ, 5",80000,80000,0,0
TIKI,thoi-trang-nu,173630073,"Váy ngủ sexy BT0060 -  váy ngủ, đầm ngủ nữ hai dây - Đồ ngủ mặc nhà",79000,120000,41000,34
TIKI,thoi-trang-nu,83765673,"Áo Ngực, Áo Lót Bra thiết kế khóa cài trước với đệm mút hình bàn tay có thể nâng đỡ ngực độc đáo quyến rũ Thương Hiệu Baw mă AN06",159000,159000,0,0
TIKI,thoi-trang-nu,51407838,"Đầm Suông Trung Niên Kiểu Đầm Suông BigSize In Hoa Lá Cột Eo GOTI 3285",298900,298900,0,0
TIKI,thoi-trang-nu,116827792,"Quần mặc trong váy chất liệu cotton phối ren, nâng mông quyến rũ LYEQ021",55000,59000,4000,7
TIKI,thoi-trang-nu,52052476,"Set Đồ Bơi Tay Dài Ba Chi Tiết AT154 MayHomes, Form Sport, Thun Co Giãn, Bền Chắc, Không Phai Màu",224000,256000,32000,13
TIKI,thoi-trang-nu,97819163,"Cosplay công chúa baby doll  váy ngủ sexy",213400,213400,0,0
TIKI,thoi-trang-nu,84439625,"Quần Độn Mông Và Hông Thông Hơi Cao Cấp Xuất Nhật - 5STAR",75000,75000,0,0
TIKI,thoi-trang-nu,171020678,"Quần Jean Nữ, Quần Jean Nữ Lưng Cao, Quần Jean Nữ Siêu Hack Dáng thương hiệu Chandi, Jean Nữ co dãn tôn dáng phụ nữ eo thon mẫu KV60",350000,350000,0,0
TIKI,thoi-trang-nu,82905115,"Bộ 5 Quần Lót Đùi, quần mặc váy nâng mông, kháng khuẩn thương hiệu BAW NT03",149000,199000,50000,25
TIKI,thoi-trang-nu,40939641,"ÁO VEST BLAZER PHỐI SỌC",189000,189000,0,0
TIKI,thoi-trang-nu,82704419,"Combo 3 Quần Lót Nữ Cotton Nọt Ne Màu Trơn Gợi Cảm Cho Nữ Size thương hiệu BAW QLN22",99000,133500,34500,26
TIKI,thoi-trang-nu,146230660,"Áo polo nữ ADINO màu xanh đen phối viền xẻ lai vải cotton co giãn dáng slimfit trẻ trung APN02",139000,278000,139000,50
TIKI,thoi-trang-nu,3146305,"Quần Lót Triumph Blissy D10 Midi - Da (Size",60500,60500,0,0
TIKI,thoi-trang-nu,102007836,"Áo lót ren có gọng không đệm có size lớn",90000,90000,0,0
TIKI,thoi-trang-nu,185867063,"Bộ quần áo ngắn cho mẹ Xanh golf đũi xước - AICDMEI3QI1X - AIN Closet",325000,415000,90000,22
TIKI,thoi-trang-nu,119398079,"Chân váy xòe sang chảnh - CV01",140000,140000,0,0
TIKI,thoi-trang-nu,83159474,"Quần Kaki Basic Pants Unisex Nữ Cá Tính-Thời Trang PONIVA",88000,88000,0,0
TIKI,thoi-trang-nu,55826853,"Đồ Bơi Nữ 1 Mảnh Tay Dài Đen Phối Trắng AT182 MayHomes Chất Liệu Cao Cấp, Bền Đẹp",220000,249000,29000,12
TIKI,thoi-trang-nu,55213894,"Đồ Bơi Nữ Hai Mảnh Tôn Dáng Trẻ Trung AT185 MayHomes, Áo Bơi Lưng Cao, Quần Bơi Váy Xòe",155000,179000,24000,13
TIKI,thoi-trang-nu,174249107,"Đầm maxi 2 dây dáng dài rộng chun ngưc, váy 2 dây đi biển bầu bí thoải mái",97000,97000,0,0
TIKI,thoi-trang-nu,96288468,"Váy ngủ xuyên thấu ngực nơ quyến rũ",98000,98000,0,0
TIKI,thoi-trang-nu,166412420,"Áo Khoác Sơmi Nhung Tăm Form Siêu Xinh Thêu Chữ 1 Túi Mịn Đẹp, Áo khoác nhung sơ mi Nữ quốc dân From rộng tay bó ,chất nhung gân vải dày thoáng mát cực đẹp",160000,160000,0,0
TIKI,thoi-trang-nu,101125840,"Áo lót liner mặc trong đai latex chống hằn ngứa, thấm hút mồ hôi tốt",39500,39500,0,0
TIKI,thoi-trang-nu,118017979,"Đồ Lam Đi Chùa # Lãnh Tụ # Nam Nữ # Đồ Bộ Nam Nữ # Quần Áo Nam Nữ",204000,204000,0,0
TIKI,thoi-trang-nu,44150035,"Áo Ngực Nữ Không Gọng Full Ren Miley Lingerie",205000,315000,110000,35
TIKI,thoi-trang-nu,49481152,"Đồ Bơi Một Mảnh Tay Dài Liền Thân Kiểu Dáng Thể Thao AT148 MayHomes Thun Co Giãn Tốt",225000,255000,30000,12
TIKI,thoi-trang-nu,72461469,"Set Đồ Bơi Tươi Trẻ Kiểu Dáng Thể Thao AT192 MayHomes One Size, Đa Năng Và Tiện Dụng",172050,185000,12950,7
TIKI,thoi-trang-nu,176293265,"Bộ độ mặc nhà trung niên Tole (lanh) Vicci BGD.08 áo cộc tay phối quần dài lưng thun in họa tiết",180000,309000,129000,42
TIKI,thoi-trang-nu,177267838,"Bikini Hai Mảnh Gợi Cảm Phong Cách Korea AT224 MayHomes Đồ Bơi Nữ Women Two-Piece Swimwear",222130,229000,6870,3
TIKI,thoi-trang-nu,175154530,"Đồ Bơi Hai Mảnh Nữ Tươi Trẻ Họa Tiết Cá Tính ATI60 MayHomes Pretty And Young Pattern Swimset For Women",139000,159000,20000,13
TIKI,thoi-trang-nu,162562861,"Áo nâng ngực Boya mút dày 5cm siêu dẩy phối ren , Áo ngực BoYa ren mút dày siêu đẩy,siêu nâng tạo khe",138600,138600,0,0
TIKI,thoi-trang-nu,181485749,"Áo Polo Nữ Dáng Ôm Slim Fit Vải Pique Cao Cấp Aaa Jeans",349000,349000,0,0
TIKI,thoi-trang-nu,172959928,"Váy ngủ nữ lụa hở lưng sexy Q60 - Đầm ngủ nữ quyến rũ - Đồ ngủ mạc nhà",149000,210000,61000,29
TIKI,thoi-trang-nu,196157619,"Váy ngủ bodysuit xuyên thấu hở lưng phối nơ sexy gợi cảm P69 - Đầm ngủ nodysuit quyến rũ - Đồ ngủ nữ sexy",109000,199000,90000,45
TIKI,thoi-trang-nu,107056472,"Áo ngực mút mỏng không gọng iBasic VA029",229000,259000,30000,12
TIKI,thoi-trang-nu,176771899,"Đồ Bơi Nữ Một Mảnh Liền Thân Hở Lưng Dễ Thương ATI26 MAYHOMES One-Piece Swimwear With Backless Top",151000,176000,25000,14
TIKI,thoi-trang-nu,182841437,"Đồ ngủ bigsize nữ, Đồ ngủ sexy 2 dây ren nude không mút, chất phi mịn quyến rũ mã 400",54000,54000,0,0
TIKI,thoi-trang-nu,91970158,"Áo lót ren đệm mỏng quả to 198 dành cho người béo, nâng ngực quai áo bản to",89240,89240,0,0
TIKI,thoi-trang-nu,83160308,"Áo Sơ Mi Nữ Dài Tay Công Sở Thời Trang PONIVA",157000,157000,0,0
TIKI,thoi-trang-nu,141260181,"Đồ bộ nữ Unisex SB63 in hình khủng long nhỏ, set bộ gồm áo thun nữ form rộng tay lỡ Unisex kèm quần short cartoon, Đồ Bộ Hoạt Hình Unisex chú vịt, Set Cartoon, đồ bộ hoạt hình khủng long đang suy nghĩ Nam Nữ Đều Mặc Được",99000,99000,0,0
TIKI,thoi-trang-nu,103407058,"quần ống suông lưng cao 1 khuy khóa trước chất tuyết mưa xinh xăn",85000,85000,0,0
TIKI,thoi-trang-nu,46818917,"Bộ đồ lót nâng ngực cúp nửa ngực cài trước",170000,170000,0,0
TIKI,thoi-trang-nu,124240293,"Áo ba lỗ nữ hàng Quảng Châu Cao Cấp -Áo Croptop Sát Nách Mongtoghi lạnh hàng xuất xịn siêu co dãn",39000,39000,0,0
TIKI,thoi-trang-nu,118126647,"sơ mi lụa trung niên cao cấp_áo trung niên tay phối họa tiết_áo sơ mi sang trọng thanh lịch mẫu mới cho bà cho mẹ",262000,262000,0,0
TIKI,thoi-trang-nu,136091271,"Aó sơ mi nữ,áo sơ mi nữ dài tay phom rộng chất nhung tăm nhiều màu cá tính",99000,99000,0,0
TIKI,thoi-trang-nu,131245085,"Áo Khoác Nỉ Hoodie Zip Form Rộng Nam Nữ Unisex",100000,100000,0,0
TIKI,thoi-trang-nu,176021609,"Áo bralette không gọng satin iBasic BRAY044",199000,299000,100000,33
TIKI,thoi-trang-nu,196156173,"Quần baggy nữ lưng chun Hiền Trần BOUTIQUE, quần baggy vải công sở cạp cao dáng chuẩn thanh lịch",181000,350000,169000,48
TIKI,thoi-trang-nu,107056518,"Áo ngực có gọng mút vừa phối ren iBasic VA086",199000,239000,40000,17
TIKI,thoi-trang-nu,176534606,"Chân Váy Xòe New Design Dáng Midi Dài Qua Gối Duyên dáng",199000,329000,130000,40
TIKI,thoi-trang-nu,121258680,"Áo polo nữ màu hồng phối viền chìm ADINO vải cotton polyester mềm dáng slimfit công sở hơi ôm trẻ trung APN03",159000,318000,159000,50
TIKI,thoi-trang-nu,116244653,"Quần ống rộng nữ,quần culottes nữ lưng cao khóa sườn vải tuyết mưa nhiều màu",89000,89000,0,0
TIKI,thoi-trang-nu,51489130,"Quần lót nữ Triumph Simply Everyday Basic Hipster 2526 cạp cao gen nhẹ",129500,259000,129500,50
TIKI,thoi-trang-nu,87384766,"Bộ 5 Quần Lót Nữ vải su viền ren mềm mại xuyên thấu gợi cảm 5 màu lựa chọn Onesize 40-60kg thương hiệu BAW NT102",199000,199000,0,0
TIKI,thoi-trang-nu,101118216,"Áo Lót Liner Mặc Trong Đai Nịt Bụng Latex - chống bẩn , chống nóng ngứa",39500,39500,0,0
TIKI,thoi-trang-nu,118023454,"Đồ Lam Đi Chùa # Xéo Tim 3Nút # Quần Áo Nữ # Đồ Bộ Nữ",186000,186000,0,0
TIKI,thoi-trang-nu,89479706,"Áo Bra Mặc Đồ Hở Lưng, Lưng Sâu Siêu Đẹp",142000,142000,0,0
TIKI,thoi-trang-nu,57721951,"Váy ngủ 2 dây lụa satin siêu quyến rũ - Trắng",85000,85000,0,0
TIKI,thoi-trang-nu,130452530,"Áo giữ nhiệt nữ, áo thun dài tay thu đông cho nữ cổ cao màu đen ấm áp",35000,35000,0,0
TIKI,thoi-trang-nu,127994807,"Quần ống rộng nữ chất đũi xước hàn quần đũi ống rộng cạp khóa khuy trước chun sau co giãn thoải mái Banamo Fashion 921",73000,73000,0,0
TIKI,thoi-trang-nu,183558599,"Đầm suông kẻ sọc cổ sơ mi Linen kèm đai thắt eo, chất vải linen tự nhiên, thời trang phong cách Hàn Da73",199000,199000,0,0
TIKI,thoi-trang-nu,181783513,"Combo 2 quần lọt khe ren hở mông, quần chip nữ, quần lót nữ sexy không đáy gợi cảm LYEQ074 ( MÀU NGẪU NHIÊN)",73000,84000,11000,13
TIKI,thoi-trang-nu,93311803,"HOT HIT- Quần ống rộng giả váy lửng chất đũi",65000,65000,0,0
TIKI,thoi-trang-nu,104843143,"Combo 2 quần lót ren lưới sexy đính nơ 2 bên xinh xắn (màu ngẫu nhiên) LYEQ022 - M",110000,118000,8000,7
TIKI,thoi-trang-nu,106987617,"Áo Khoác Nỉ Bông Ngoại Cardigan Reception F Unisex Nam Nữ Couple Mặc Cute Bomber Jackets Thoitrangteenthienha",97000,97000,0,0
TIKI,thoi-trang-nu,85399288," Quần Vải Nữ ️SALE️ Culottes Ống Suông siêu cao khóa trước 2 khuy chất tuyết mưa nhập khẩu cao cấp",76700,76700,0,0
TIKI,thoi-trang-nu,52093685,"đầm hoa nhí xoè hoạ tiết hoa yêu lắm duyên dáng dễ  thương",238000,238000,0,0
TIKI,thoi-trang-nu,87671094,"Áo Khoác 6 Túi Nữ Chống Nắng Cotton Cao Cấp (ad01)",170000,170000,0,0
TIKI,thoi-trang-nu,21125223,"Áo Ngực Nữ Cotton Không Gọng Miley Lingerie BRW09015",199000,290000,91000,31
TIKI,thoi-trang-nu,177964263,"Áo Khoác Hoodie Dây Kéo Local Brand Sadboiz Chữ 7 Màu Nam Nữ Unisex, Áo Khoác Hoodie Dây Kéo Local Brand Sadboiz Chữ 7 Màu Nam Nữ Unisex, Áo khoác nỉ hoodie sadboiz signature , tee local brand basic sadboy sad cry form rộng unisex nam nữ ulzzang",99000,99000,0,0
TIKI,thoi-trang-nu,97683758,"Bộ 3 Quần Mặc Váy Chất Liệu Cotton Tinh Tế Lót May Chống Viêm, Quần Chip Nữ Kháng Khuẩn Cao Cấp Thương Hiệu BAW NT726",109000,199000,90000,45
TIKI,thoi-trang-nu,96025083,"Quần Lót Nữ Cao Cấp Cạp Cao Che Khuyết Điểm BIG SIZE đến 60kg 8889",45000,45000,0,0
TIKI,thoi-trang-nu,134333282,"Đầm sơ mi nữ công sở ARCTIC HUNTER AH52",199000,199000,0,0
TIKI,thoi-trang-nu,117083915,"Áo khoác nữ cardigan thun nỉ ngoại logo thêu sắc nét phong cách Hàn quốc,Áo Khoác Cardigan Hàn Quốc Thêu Sắc Nét -Chất NỈ Ngoại Form Unisex Nam Nữ Mặc Cặp",102000,102000,0,0
TIKI,thoi-trang-nu,190153247,"Áo Khoác Hoodie Zip Cinder Basic Kéo Khóa, Áo Hoodie Zip Nam Nữ Form Rộng In Lụa Cao Cấp, Local Brand",105000,105000,0,0
TIKI,thoi-trang-nu,36061260,"Áo Len Nữ Áo Cardigan Áo Khoác Nhẹ MAY_ALN025 MayHomes - Tím",145000,145000,0,0
TIKI,thoi-trang-nu,181569207,"Bộ đồ Pyjama nữ, đồ mặc nhà lụa VILADY - B140 Quần Dài Tay Cộc Họa Tiết Con sò Màu Xanh Rêu, chất liệu lụa Pháp (lụa latin)",511000,550000,39000,7
TIKI,thoi-trang-nu,115898007,"Áo trắng baby Tusca blouse Gem Clothing SP060434",390000,390000,0,0
TIKI,thoi-trang-nu,74309403,"Quần jean nữ Lưng Cao Julido Store, chất jean co dãn 4 chiều ống ôm chân mẫu MH02",159000,299000,140000,47
TIKI,thoi-trang-nu,174099140,"Đồ bộ pijama lụa, đồ mặc nhà nữ VILADY - B124 kiểu quần dài tay cộc họa tiết trơn, chất liệu lụa Pháp (lụa latin) cao cấp - Màu đỏ",334000,500000,166000,33
TIKI,thoi-trang-nu,185204002,"Đồ Bơi Nữ Hai Mảnh Tiện Lợi Và Kín Đáo AT21O MayHomes Women 2-Piece Swimwear",148000,168900,20900,12
TIKI,thoi-trang-nu,149366269,"Áo bra/lót/ngực không gọng, ren hoa, có đệm mỏng nhẹ nâng ngực tạo khe gợi cảm LYEA022",92000,99000,7000,7
TIKI,thoi-trang-nu,104369832,"Đồ bộ nữ cộc tay - Đồ bộ mặc nhà - Đồ ngủ mặc nhà nữ - Đồ bộ nữ lửng - Set bộ đũi mặc nhà nữ Vicci BDT.85 họa tiết tim",135000,269000,134000,50
TIKI,thoi-trang-nu,105699692,"Áo Khoác Hoodie Nam Nữ Chú Chó Tâm Sự Siêu Cute Có Dây Kéo -Chất Nỉ Ngoại UNisex thoitrangsihienlinh",103000,103000,0,0
TIKI,thoi-trang-nu,176534607,"Quần Đùi Nữ Mặc Nhà New Design Quần Short Nữ ,Vải Satin, Mịn ,Thoáng  Mát, Nhiều Màu Big Size (45-65kg) Mặc Thoải Mái QA0004",45000,79000,34000,43
TIKI,thoi-trang-nu,49743435,"Bộ Đồ Bơi Đi Tắm Biển Nữ Bikini 2 Mảnh Cực HOT - Hàng Chính Hãng",187000,187000,0,0
TIKI,thoi-trang-nu,84705111,"Quần Lót Cotton Bà Bầu siêu co giãn thoáng mát thương hiệu BAW mã QLN58",149000,159000,10000,6
TIKI,thoi-trang-nu,99418865,"áo lót nữ  Freeship từ 50k áo lót mút mỏng ren mền- áo ngực ren không gọng",52800,52800,0,0
TIKI,thoi-trang-nu,36774674,"Quần thun dài nữ sọc hông lưới thông hơi Phúc An 3016",109000,109000,0,0
TIKI,thoi-trang-nu,194961338,"Áo sad boiz ripped signature long sleeve Áo thun tay dài sadboiz RIPPED SIGNATURE chất cotton, Áo Thun Tay Dài Cá Tính SADBOIZ RIPPED SIGNATURE LONG SLEEVE , Sweater Nam Nữ Unisex Form Rộng",89000,89000,0,0
TIKI,thoi-trang-nu,180995048,"Đồ bơi nữ 2 mảnh cao cấp QB02 - Đồ bơi bikini nữ sexy - Đồ bơi đi biển",149000,220000,71000,32
TIKI,thoi-trang-nu,117734638,"Quần short nữ,quần đùi giả váy chất đũi sang,xịn,mịn kiểu hàn 3 màu",60000,60000,0,0
TIKI,thoi-trang-nu,101949408,"Quần lót nữ Jones thun  lạnh ren 001",17000,17000,0,0
TIKI,thoi-trang-nu,146773059,"(Big size) chân váy dài phối kẻ C022",170000,170000,0,0
TIKI,thoi-trang-nu,68525681,"ÁO KHOÁC HOODIE UNISEX FORM RỘNG NỈ KÉO KHÓA DÂY RÚT",94000,94000,0,0
TIKI,thoi-trang-nu,118023023,"Đồ Lam Đi Chùa # Mẫu Nơ Và Sẫm Tàu# Đồ Bộ Nữ # Quần Áo",156241,156241,0,0
TIKI,thoi-trang-nu,58240379,"áo len nữ, áo len mác",199000,199000,0,0
TIKI,thoi-trang-nu,96516090,"Áo Khoác Bomber Bóng Chày Nam Nữ Hàng Chất Lượng",93000,93000,0,0
TIKI,thoi-trang-nu,34592981,"Áo Sơ Mi Sọc Hana",119000,119000,0,0
TIKI,thoi-trang-nu,182756891,"Bộ Pyjama nữ, đồ mặc nhà VILADY-B113 kiểu quần đùi tay cộc họa tiết Bông, chất liệu lụa Pháp cao cấp",315000,450000,135000,30
TIKI,thoi-trang-nu,179413819,"Áo sơ mi nữ, kín đáo phong cách Hàn Quốc đũi mềm mịn,màu sắc thanh nhã,có size đến 90kg ( mã A25)",158000,158000,0,0
TIKI,thoi-trang-nu,140921150,"Đồ bộ mặc nhà,đồ bộ mặc nhà đẹp, đồ bộ mặc nhà cao cấp, chất đũi lạnh",191250,191250,0,0
TIKI,thoi-trang-nu,108508923,"Áo croptop dài tay siêu tôn vòng 2",75000,75000,0,0
TIKI,thoi-trang-nu,165206570,"Áo Ngực Không Gọng Chất Liệu Ren Cao Cấp, Áo Lót Bra Ren Mềm Mẫu Mới Siêu Đẹp Thương Hiệu Baw mã NT71",99000,159000,60000,38
TIKI,thoi-trang-nu,7301977,"Chân Váy Dập Li MS0306V",65000,130000,65000,50
TIKI,thoi-trang-nu,190509291,"Áo lót nữ nâng ngực tạo khe, cúp ngang có gọng Triumph 695-025 đệm mút vừa giúp nâng và định hình ngực tối đa, dây vai có thể tháo rời",629000,799000,170000,21
TIKI,thoi-trang-nu,132928231," CHÂN VÁY CARO XẾP LY NÚT",138000,138000,0,0
TIKI,thoi-trang-nu,195708587,"Đầm Hoa Trung Niên đẹp Che Bụng VH64 - Hàng Quảng Châu Cao Cấp",355000,355000,0,0
TIKI,thoi-trang-nu,79445330,"Đồ Ngủ Body Sexy Cosplay Thư Ký Gợi Cảm Vải Mịn Hai Dây Có Kèm Dây Kẹp Tất Và Tất Màu Đen Sexy Women Stockings Transparent Exposed Nipple Mesh Brave Man Mã BCS21 15 8022 12",119000,119000,0,0
TIKI,thoi-trang-nu,72515929,"COMBO 5 QUẦN LỌT KHE REN MỀM DÀNH CHO NỮ 8001",140000,140000,0,0
TIKI,thoi-trang-nu,188835606,"Đầm linen nữ dáng suông không tay, Váy suông đuôi cá chất đũi thoáng mát Đũi Việt DV38",229000,229000,0,0
TIKI,thoi-trang-nu,189337830,"COMBO 4 QUẦN MW COTTON CẠP CAO",156000,156000,0,0
TIKI,thoi-trang-nu,6535821,"Quần Lót Nữ - Quần Đùi Mặc Trong Váy Su Thông Hơi",28000,30000,2000,7
TIKI,thoi-trang-nu,168505953,"Bộ Đồ Bơi Nữ Bikini 2 Mảnh ATI61 MAYHOMES Set Áo Và Short, One Size, Kiểu Dáng Thể Thao",130000,155000,25000,16
TIKI,thoi-trang-nu,31603612,"Crazy sales. Áo thun nữ GOKING in hình dễ thương, áo phông thoát nhiệt Nhật Bản 100 cotton thoáng mát, thấm hút mồ hôi, đánh bay cơn nóng mùa hè",111000,111000,0,0
TIKI,thoi-trang-nu,192222724,"Áo thun nữ cổ tim tay dài vải cotton đẹp, dễ mặc dễ phối đồ, mặc bốn mùa",109000,129000,20000,16
TIKI,thoi-trang-nu,10576055,"Quần tây công sở_Q02",239000,239000,0,0
TIKI,thoi-trang-nu,84709814,"Áo Thun Nữ Aaa Jeans Cao Cấp Organic Cotton",249000,249000,0,0
TIKI,thoi-trang-nu,102944214,"(286) áo lót cotton thái mỏng ko gọng",29000,31000,2000,6
TIKI,thoi-trang-nu,185712822,"Áo khoác hoodie zip XÁM form rộng nam nữ vải nỉ lót bông thêu chữ CHAOS",102000,102000,0,0
TIKI,thoi-trang-nu,166533565,"Quần Độn Mông Nữ, Quần Độn Mông Lưng Ren Thông Hơi Siêu Thoáng Mát Mềm Mại Thương Hiệu Baw DM01",129000,189000,60000,32
TIKI,thoi-trang-nu,51714933,"Áo Sơ Mi Nữ Tay Dài Công Sở",175000,175000,0,0
TIKI,thoi-trang-nu,67911260,"CHÂN VÁY HOA NHÍ TIGOON DỊU DÀNG - Hoa Vàng - S",136000,136000,0,0
TIKI,thoi-trang-nu,195915771,"Aó kiểu nữ - họa tiết thêu, chất đũi (SP18)",151000,151000,0,0
TIKI,thoi-trang-nu,109358525,"Áo Khoác Nhung THIFU FASHION Nhung Gân Mềm Mịn Tay Phồng, Mặt Lưng Trơn Dây Kéo Khoen Tròn",148000,148000,0,0
TIKI,thoi-trang-nu,91753598,"Áo Khoác Bomber 2020 Nỉ ULLANG",103000,103000,0,0
TIKI,thoi-trang-nu,48094460,"Áo sơ mi đũi nữ cổ V có túi Đũi Việt DVSM172",169000,169000,0,0
TIKI,thoi-trang-nu,193180698,"Áo hoodie The White",105000,105000,0,0
TIKI,thoi-trang-nu,30704368,"quần tây nữ cao cấp hàng nhập",135000,135000,0,0
TIKI,thoi-trang-nu,139604282,"Áo Phông Nữ In Slogan Giordano 05394366",290000,290000,0,0
TIKI,thoi-trang-nu,128123093,"Áo khoác bomber unisex thu đông nam nữ deepen 3 màu năng động,trẻ trung",160000,160000,0,0
TIKI,thoi-trang-nu,32380868,"Áo len nữ trơn ôm dáng Haint Boutique Al31",161000,161000,0,0
TIKI,thoi-trang-nu,187490456,"Đầm suông linen cổ V túi hộp thắt eo màu nâu, thời trang phong cách Hàn Da72",279000,279000,0,0
TIKI,thoi-trang-nu,95508445,"Đầm Hoa Bèo Lai Ngực Cột Nơ Tiểu Thơ",188100,188100,0,0
TIKI,thoi-trang-nu,19721985,"Áo khoác ren tà ngắn 08 C009",178000,178000,0,0
TIKI,thoi-trang-nu,146229379,"Áo polo nữ ADINO màu đỏ phối viền xẻ lai vải cotton co giãn dáng slimfit trẻ trung APN02",139000,278000,139000,50
TIKI,thoi-trang-nu,3647381,"Chân váy bút chì nữ cv02",250000,250000,0,0
TIKI,thoi-trang-nu,102121875,"Bộ Đồ Ngủ Nữ Lụa Satin Có Mút Ngực Phối Ren Cao Cấp, Bộ Đồ Ngủ Nữ, Bộ Đồ Ngủ Nữ 2 dây, Đồ Ngủ Gợi Cảm, Đồ Ngủ Sexy, Đồ Ngủ Lụa Mặc Nhà 2 Dây Phối Ren Sexy Quyến Rũ Thương Hiệu Baw Mã DN30 (hình thật shop tự chụp)",129000,199000,70000,35
TIKI,thoi-trang-nu,119671674,"Bộ Đồ thú khủng long hồng liền thân lông mịn Pijama dành Cho Người Lớn và Trẻ Em kiểu dáng Động Vật Hoạt Hình Cosplay",259000,259000,0,0
TIKI,thoi-trang-nu,176545246,"Đồ bơi nữ từ 35-60kg, chất polyester - Áo bơi tay dài cho bé phát triển bơi lâu mà không sợ lạnh",319000,419000,100000,24
TIKI,thoi-trang-nu,81803351,"Đầm Mặc Nhà Cotton Lụa Nature Wind Miley Lingerie - Họa tiết Hoa Vàng",159000,350000,191000,55
TIKI,thoi-trang-nu,74883655,"Đồ ngủ lưới Sexy gợi cảm Đồ Cosplay xuyên thấu",100000,100000,0,0
TIKI,thoi-trang-nu,47890194,"Bộ đồ lót ren áo siêu nâng ngực sexy",160000,160000,0,0
TIKI,thoi-trang-nu,107154323,"Váy ngủ đẹp dễ thương ren 2 dây Sexy gợi cảm - Đỏ",35000,35000,0,0
TIKI,thoi-trang-nu,177682084,"Đồ Bơi Hai Mảnh Bikini Dễ Thương Thiết Kế Đơn Giản Và Tiện Lợi ATZ99 MayHomes Nhiều Mẫu",92000,109000,17000,16
TIKI,thoi-trang-nu,107043044,"ĐỒ LAM ĐI CHÙA # ĐỒ ĐI CHÙA # PHÁP PHỤC PHẬT GIÁO #LA HÁN",96000,96000,0,0
TIKI,thoi-trang-nu,2085839,"Áo Ngực Triumph Maxi 819 (HQ-VN) - Da (Size",399000,399000,0,0
TIKI,thoi-trang-nu,175167031,"Đồ Bơi Nữ Một Mảnh Sắc Màu Kiểu Váy Xòe Dễ Thương ATI31 MayHomes One-Piece Colorful Swimwear",158000,179000,21000,12
TIKI,thoi-trang-nu,102939016,"(6530)quần mặc trong váy ko lằn mông ,thông hơi ,thoáng mát",28000,30000,2000,7
TIKI,thoi-trang-nu,100747052," Set Bộ Đồ Lót Nội Y Sexy Cao Cấp Cho Nữ LUPERI NY820",325000,325000,0,0
TIKI,thoi-trang-nu,175173030,"Đồ Bơi Nữ Một Mảnh Kín Đáo Kiểu Váy Thể Thao ATI32 MayHomes Women One-Piece Swimwear",156000,179000,23000,13
TIKI,thoi-trang-nu,90642830,"Quần tây nữ vải co giãn QT01",149000,149000,0,0
TIKI,thoi-trang-nu,176775679,"Đồ Bơi Nữ Một Mảnh Kiểu Váy Hoa Hở Lưng Gợi Cảm ATI27 MayHomes One-Piece Swimwear With Backless Top",147000,174000,27000,16
TIKI,thoi-trang-nu,83685398,"Áó Giảm Béo Vùng Lưng, Vai, Bắp Tay Cho Bạn, Đai nit giảm mỡ vùng lưng, vai, bắp tay",175000,175000,0,0
TIKI,thoi-trang-nu,174379848,"Áo Thun Cá Sấu Nữ Có Cổ -Màu Xanh Đen(45-75kg)",96000,96000,0,0
TIKI,thoi-trang-nu,190738181,"Đồ Bơi Nữ Một Mảnh Ôm Thân Tôn Dáng Có Size Lớn AT229 MayHomes Bigsize One-Piece Swimsuits",179550,189000,9450,5
TIKI,thoi-trang-nu,72639866,"Aó định hình sau hút mỡ cánh tay Aó gen vai cánh tay áo nịt bắp tay",550000,550000,0,0
TIKI,thoi-trang-nu,146574315,"Quần bầu cạp chéo - Thoải mái hơn, tiện lợi hơn",74340,74340,0,0
TIKI,thoi-trang-nu,130841654,"Áo khoác nữ, áo cardigan len phối ren xinh xắn K02",169000,169000,0,0
TIKI,thoi-trang-nu,146773062,"Chân váy xếp ly có quần trong (BIG SIZE) C001",180000,180000,0,0
TIKI,thoi-trang-nu,118022777,"Đồ Lam Đi Chùa # Mẫu La Hán # Đồ Bộ Nam Nữ # Quần Áo Nam Nữ",201000,201000,0,0
TIKI,thoi-trang-nu,16239211,"Áo ngực nữ không gọng nâng ngực hàng xuất Nhật",52800,52800,0,0
TIKI,thoi-trang-nu,128287091,"Áo khoác sweater nỉ ngoại in khủng long unisex ulzzang nam nữ",85000,85000,0,0
TIKI,thoi-trang-nu,193639435,"Áo kiểu hoa nhí Ceri Top Gem Clothing SP060629",470000,470000,0,0
TIKI,thoi-trang-nu,146276974,"Quần lót nâng mông thật tự nhiên Quần định hình nâng mông",120000,120000,0,0
TIKI,thoi-trang-nu,146511096,"ÁO HOODIE NỮ BÒ SỮA THỜI TRANG MẪU MỚI THỊNH HÀNH B.BY",83000,83000,0,0
TIKI,thoi-trang-nu,185977874,"Đầm suông linen cổ V thắt eo 2 màu,thời trang nữ phong cách trẻ trung Haint Boutique Hb72",299000,299000,0,0
TIKI,thoi-trang-nu,103498666,"quần ống rộng cúc khóa chun lưng kiểu nhật mềm mát",69000,69000,0,0
TIKI,thoi-trang-nu,4153363,"Áo khoác nữ cổ chui hoodie Phúc An",107100,107100,0,0
TIKI,thoi-trang-nu,73722483,"Áo ngực nữ cúp ngang Elegant Miley Lingerie BRM04002 - Màu đỏ đô",205000,315000,110000,35
TIKI,thoi-trang-nu,82129940,"Đồ bơi liền thân nữ cutout xanh rêu lạ mắt, bikini một mảnh sexy quyến rũ, hàng chuẩn chất đẹp | KT077",420000,420000,0,0
TIKI,thoi-trang-nu,176797644,"Đồ Bơi Nữ Một Mảnh Kiểu Dáng Xinh Họa Tiết Da Beo Trắng Đen ATI34 MayHomes Women One-Piece Swimwear",148000,175000,27000,15
TIKI,thoi-trang-nu,89571725,"GOTI - Quần Trung Niên Nữ Cao Cấp Lưng Thun Kiểu Quần Tây Trung Niên Ống Ôm Có Size Lớn 3Q12",189000,189000,0,0
TIKI,thoi-trang-nu,113050911,"Áo khoác nữ Áo khoát nữ kaki chống nắng CHAO KIOS đẹp cá tính hàng rất đẹp-A114",156450,156450,0,0
TIKI,thoi-trang-nu,167543231,"(HÀNG SẴN) Áo Khoác Dạ Mùa Xuân Ngắn Giản Dị AD54 - Hàng Quảng Châu Cao Cấp",275000,275000,0,0
TIKI,thoi-trang-nu,89479442,"Miếng dán Ngực tiện lợi (1 cặp)",14000,14000,0,0
TIKI,thoi-trang-nu,73675168,"Gen nịt bắp đùi giảm mỡ, gen định hình bắp đùi sau hút mỡ,Gen nịt bắp chân(hút mỡ bắp chân)",588000,588000,0,0
TIKI,thoi-trang-nu,195113770," Váy Đầm Dự Tiệc Thời Trang Cho Mẹ VH21 - Hàng Quảng Châu Cao Cấp",355000,355000,0,0
TIKI,thoi-trang-nu,176710545,"Đồ Bơi Nữ Hai Mảnh Kiểu Dáng Thể Thao Đa Năng ATO67 MayHomes Set Áo Và Short Women Swimwear",123000,155000,32000,21
TIKI,thoi-trang-nu,54443067," Bộ ĐồLót Ren Nữ Không Gọng Nâng Ngực Đệm Mỏng Azuno DL01  Phong Cách Sexy Dây Đôi Không Giãn Không Quăn Sau Khi Dùng Lâu",97000,104000,7000,7
TIKI,thoi-trang-nu,67525224,"Áo Khoác Hoodie HEART Unisex 2 màu Trắng Đen",103000,103000,0,0
TIKI,thoi-trang-nu,197894187,"Miếng Dán Ngực Silicon Hộp 5 Cặp Miếng Dán Ngực Siêu Dính Tái Sử Dụng Nhiều Lần H02",13500,15000,1500,10
TIKI,thoi-trang-nu,117177201,"Bộ cotton sơ sinh bác sỹ dài hiệu - BBC27",75000,75000,0,0
TIKI,thoi-trang-nu,68482611,"Set 2 Quần Đùi Mặc Váy Gen Bụng - Trong Túi Zip Mã FLQ25 - Giao màu ngẫu nhiên",54000,54000,0,0
TIKI,thoi-trang-nu,132128724,"Đồng phục đồ đi biển team building hội nhóm gia đình nam nữ trẻ em nổi bật đủ áo và quần DDB88 | SG",99000,99000,0,0
TIKI,thoi-trang-nu,155191951,"Bigsize - Quần Baggy Jean BIGSIZE - LƯNG CAO - PHOM TO DÀI - Xanh Jean Trơn",225000,225000,0,0
TIKI,thoi-trang-nu,134476336,"Đồ lót nữ Sexy Set ngủ lông tai mèo Cosplay",114700,114700,0,0
TIKI,thoi-trang-nu,195525203,"Áo Sơ Mi Cotton Lụa Dài Tay Cho Mẹ SM95 - Hàng Quảng Châu Cao Cấp",165000,165000,0,0
TIKI,thoi-trang-nu,100021057,"GOTI ÁO TRUNG NIÊN NỮ- ÁO LỤA TRUNG NIÊN CHE BỤNG - ÁO KIỂU TRUNG NIÊN CỔ PHỐI REN KIỂU ÁO TẶNG MẸ U60 3A16",219000,219000,0,0
TIKI,thoi-trang-nu,2838919,"Váy đầm lanh (tole) Thái 3D Vicci TVN004.3 thiết kế tay ngắn dáng đuôi cá suông nhẹ phối họa tiết hoa nền xanh nâu phù hợp mặc nhà, đi chơi",149500,299000,149500,50
TIKI,thoi-trang-nu,113332193,"váy suông nữ ,đầm suông nữ sát nách dáng dài chất đũi 3 màu xinh xắn",80000,80000,0,0
TIKI,thoi-trang-nu,117105650,"áo khoác nỉ hoodie Unisex phong cách Hàn SOMEDAY, áo khoác nam nữ có túi from rộng ulzzang có khoá kéo, ÁO KHOÁC CHỐNG NẮNG CÓ MŨ - ÁO KHOÁC HOODIE NAM NỮ ULZZANG COUPLE",100000,100000,0,0
TIKI,thoi-trang-nu,81187228,"Áo Thun Trắng Ngắn Tay Cổ Tròn Đủ Size",49000,49000,0,0
TIKI,thoi-trang-nu,54869790,"Váy ngủ 2 dây, đầm mặc nhà nữ DV18",220000,220000,0,0
TIKI,thoi-trang-nu,118027106,"Đồ Lam Đi Chùa # Cổ Tàu Viền # Đồ Bộ # Quần Áo Nữ",186000,186000,0,0
TIKI,thoi-trang-nu,168092538,"Đồ Bơi Hai Mảnh Thể Thao Trẻ Trung AT219 Áo Tắm Đa Năng Women Short Swimwear Set For Swimming And Sports",242250,255000,12750,5
TIKI,thoi-trang-nu,150693634,"(HÀNG SẴN) Áo Thun Len Mềm Đẹp Co Giãn Lịch Sự SM79 - Hàng Quảng Châu Cao Cấp",245000,245000,0,0
TIKI,thoi-trang-nu,55023823,"Set Đồ Bơi 3 Mảnh Rực Rỡ Nắng Hè AT167 MayHomes Bộ Đồ Áo Bơi Nữ, Quần Bơi Nữ Và Váy Bơi Nữ",155820,159000,3180,2
TIKI,thoi-trang-nu,98065619,"[HCM] (40-56kg, P5) Đồ bộ TNQN chất LATIN in 3D. Đồ bộ đùi LATIN nữ. Đồ bộ LATIN mặc nhà. Đồ bộ mặc ngủ LATIN. Đồ bộ pizama/pijama/pyjma TNQN LATIN. Đồ bộ LATIN cao cấp nữ. Đồ bộ LATIN đùi nữ. (PIJAMA/PIZAMA/PYJAMA). LATIN2TNQN",155000,155000,0,0
TIKI,thoi-trang-nu,187763074,"Áo thun nữ cổ tròn Novelty màu tím in họa tiết NATWMDMCSR200064N",129000,355000,226000,64
TIKI,thoi-trang-nu,3074923,"Váy đầm lanh (tole) Vicci TVN004.7 vải xước họa  tiết hoa nền nâu (Size",164500,299000,134500,45
TIKI,thoi-trang-nu,119670887,"Bộ Đồ thú Khủng Long xanh liền thân lông mịn Pijama dành Cho Người Lớn và Trẻ Em kiểu dáng Động Vật Hoạt Hình Cosplay",247000,247000,0,0
TIKI,thoi-trang-nu,192296950,"Quần độn mông su mềm mịn, thật mông, không lộ, đệm liền không xô dịch mút cao cấp",165000,165000,0,0
TIKI,thoi-trang-nu,165937425,"Áo Khoác Bomber Dù Nam, Nữ 2 Lớp - Mát Mẻ, Chống Nắng Siêu Hot",108000,108000,0,0
TIKI,thoi-trang-nu,183558713,"Đầm sơ mi nữ kẻ caro, Đầm đũi nữ ngắn tay, dáng dài phong cách công sở ARCTIC HUNTER AH73",199000,199000,0,0
TIKI,thoi-trang-nu,106753082,"Áo Lót Nữ, Áo Lót Đúc Su Đệm Dày Siêu Nâng Ngực Tạo Khe Quyến Rũ, Áo Ngực Su Bàn Tay Không Gọng Không Đường May Thương Hiệu BAW Mã AN372",109000,129000,20000,16
TIKI,thoi-trang-nu,102262050," [ Ảnh Thật ] Áo khoác cardigan nam nữ kiểu bomber Summer Unisex Ulzzang chất nỉ bông cao cấp - Áo Khoác Thiên Hà",87000,87000,0,0
TIKI,thoi-trang-nu,85400189,"Quần lót nữ cotton du lịch Etravel dùng một lần",117000,129000,12000,9
TIKI,thoi-trang-nu,107036343,"Set đồ lam đi chùa cách tân thêu tay phồng có đính hạt",263000,263000,0,0
TIKI,thoi-trang-nu,97537678,"Chân váy chữ A ngắn xẻ trước kèm quần trong 3 màu",62000,62000,0,0
TIKI,thoi-trang-nu,146636313,"Áo sơ mi nữ kiểu tay lỡ NeSa, chất liệu Đũi tơ thấm mồ hôi, áo kiểu form rộng phong cách Hàn Quốc, AKH.45",139000,229000,90000,39
TIKI,thoi-trang-nu,81186470,"Áo Thun Xanh Ngọc Vải Dày Đủ Size",24000,24000,0,0
TIKI,thoi-trang-nu,97606021,"Đồ Ngủ Hai Dây Lụa Satin Cao Cấp Sexy Quyến Rũ Thương Hiệu Baw, Chất Liệu Lụa Mát Mịn Nhẹ Nhàng Cực Kỳ Lôi Cuốn NT707 (hình thật shop tự chụp)",99000,169000,70000,41
TIKI,thoi-trang-nu,77152815,"Đầm ngủ lụa sexy quyến rũ gợi cảm tặng kèm quần chip lọt khe",178000,178000,0,0
TIKI,thoi-trang-nu,42737728,"Bộ Áo Ngực Và Quần Lót Nữ Ren Không Gọng Miley Lingerie BRL_FLS_03",249000,385000,136000,35
TIKI,thoi-trang-nu,9670279,"Áo khoác nữ 4 túi dây kéo Phúc An 4045 size M",190000,190000,0,0
TIKI,thoi-trang-nu,97586335,"Đồ Ngủ Hai Dây Lụa Satin Sexy Quyến Rũ Thương Hiệu Baw, Chất Liệu Lụa Mát Mịn Nhẹ Nhàng Cực Kỳ Lôi Cuốn NT701 (hình thật shop tự chụp)",89000,169000,80000,47
TIKI,thoi-trang-nu,114317990,"Áo khoác bomber dù unisex form rộng 2 lớp 23 nam nữ",88000,88000,0,0
TIKI,thoi-trang-nu,140213462,"Áo hai dây nữ lụa cao cấp, mát, mịn, không nhăn - AD01 - wfstudios",150000,150000,0,0
TIKI,thoi-trang-nu,112250895,"Sét Đồ Bộ Thể Thao Nam Nữ Mặc Nhà Phong Cách Ulzzang Unisex, Freesize Chất Cotton Không Phai, Đồ bộ mặc nhà dạo phố chất thun cotton I LIKE tay phối raplang trẻ trung năng động, Set đồ bộ nữ chất thun cotton co giản thoáng mát",99000,99000,0,0
TIKI,thoi-trang-nu,97709959,"Áo Ngực Không Gọng Chất Liệu Ren Cao Cấp, Áo Lót Bra Không Gọng dây mảnh Thương Hiệu Baw mã NT731",159000,159000,0,0
TIKI,thoi-trang-nu,162089271,"Áo Chống Nắng Nữ 2 Lớp Laroma| UPF50+ | Vải Thơm | Làm Mát | Thời Trang | Đa Dụng",319000,319000,0,0
TIKI,thoi-trang-nu,107352272,"Quần ống rộng nữ, quần ống suông đũi Gu chun lưng chất mát",69000,69000,0,0
TIKI,thoi-trang-nu,182100187,"Áo ngực có gọng mút vừa T-Shirt smothie iBasic BRAW130",279000,299000,20000,7
TIKI,thoi-trang-nu,87582606,"Áo Lót Mút Mỏng Vừa Màu Trơn Habpy Lady By Sabina HBXLP0004",229000,383000,154000,40
TIKI,thoi-trang-nu,96994606,"Váy ngủ ren hoa xuyên thấu thoáng mát+ Quần lót sexy",65000,65000,0,0
TIKI,thoi-trang-nu,116965781,"Cặp Miếng Dán Ngực Giấy Mỏng Tiện Lợi Loirechic MD08",5000,5000,0,0
TIKI,thoi-trang-nu,82914112,"Bộ 5 Quần Lót Su Viền Lượn Sóng Không Viền Mẫu mới 2021 thương hiệu BAW NT10",129000,199000,70000,35
TIKI,thoi-trang-nu,72207184,"Áo Ngực Không Gọng LOIRECHIC BRTS19 Đệm Mỏng",315000,315000,0,0
TIKI,thoi-trang-nu,182993124,"Đồ Bơi Nữ Tay Dài Quần Dài Ôm Thân Khoe Dáng AT227 MayHomes Long Sleeves And Long Pants Women Swimwear With UPF 50 Sun Protection",332500,350000,17500,5
TIKI,thoi-trang-nu,89560821,"Áo Khoác bomber summer, ÁO BOMBER NỈ IN CHỮ SUMMER, Áo Khoác Bomber Unisex, áo cardigan bomber phối màu, Áo cardigan nữ , áo cardigan nam , áo khoác cardigan nam nữ mặc vải nỉ ngoại chống nắng chống lạnh tốt",95000,95000,0,0
TIKI,thoi-trang-nu,124490062,"Đồ ngủ sexy nữ Đồ ngủ 2 dây ren nude không mút, chất phi mịn quyến rũ 400",56000,56000,0,0
TIKI,thoi-trang-nu,73278835,"Combo 10 Quần Lót Nữ Modal Trơn Comfort BCS-04 - Giao màu ngẫu nhiên",399000,790000,391000,49
TIKI,thoi-trang-nu,116206931,"Quần ống rộng nữ,quần ống suông nữ lưng cao dáng dài 1 khuy chất tuyết mưa dày dặn",85000,85000,0,0
TIKI,thoi-trang-nu,49293177,"Áo Tắm Hai Mảnh Cá Tính AT146 MayHomes Thun Co Giãn, Không Phai Màu",226000,259000,33000,13
TIKI,thoi-trang-nu,109190787,"Đầm xòe đỏ kết hoa trắng-MS0605D",99000,190000,91000,48
TIKI,thoi-trang-nu,161556077,"Choàng Chống Nắng Nữ 2 Lớp Laroma| UPF50+ | Vải Thơm | Làm Mát | Thời Trang | Đa Dụng",419000,419000,0,0
TIKI,thoi-trang-nu,84437281,"áo sweater nữ in quả địa cầu , áo hoodie nữ, áo thun tay dài form rộng ,áo sweater nam nữ đều mặc được, áo chui đầu, áo khoác nữ chống nắng chống lạnh tốt",92000,92000,0,0
TIKI,thoi-trang-nu,145289760,"Chân Váy Công Sở New Design Thiết Kế Dáng Váy chữ A, Dài Qua Gối ,Phối Nút, Phom Chuẩn Tôn Dáng Sang Trọng Vải Tốt co Giãn, Màu Đen CV0066",179000,299000,120000,40
TIKI,thoi-trang-nu,59205406,"COMBO 5 ÁO LÁ NGẮN THUN LỤA MẶT TRƯỚC 2 LỚP DÀNH CHO HỌC SINH",91000,110000,19000,17
TIKI,thoi-trang-nu,109137583,"ÁO HOODIE NỮ IHAN FORM RỘNG CHẤT NỈ NGOẠI DÀY DẶN THOÁNG MÁT, ÁO KHOÁC HOODIE ULZZANG PHONG CÁCH CÁ TÍNH, Aó hoodie nam , áo hoodie nữ , áo khoác áo hoodie cặp đôi nam nữ mặc",100000,100000,0,0
TIKI,thoi-trang-nu,74342823,"Quần jean nữ co dãn Julido Store, lưng cao mẫu mới màu đen JD8888",159000,250200,91200,36
TIKI,thoi-trang-nu,179412723,"Áo khoác vest blazer nữ phong cách hàn quốc 2 túi chất đũi xước cao cấp ( mã SP11)",190000,190000,0,0
TIKI,thoi-trang-nu,130867193,"Áo khoác hoodie trơn xanh form rộng/Nam nữ unisex Jaystoree",93000,93000,0,0
TIKI,thoi-trang-nu,118014408,"Đồ Lam Đi Chùa# Một Nút Nơ Phối # Quần Áo Nữ # Đồ Bộ Nữ",186000,186000,0,0
TIKI,thoi-trang-nu,76563546,"Váy ngủ lụa phối ren xẻ tà cao cấp ĐỦ MÀU ĐỦ SIZE",176000,176000,0,0
TIKI,thoi-trang-nu,108329137,"Áo Lót Nữ, Combo 2 Áo Lót Đúc Su Đệm Mỏng Phối Ren Siêu Quyến Rũ, Áo Ngực Su Không Gọng Không Đường May Thương Hiệu BAW Mã AN3721",99000,159000,60000,38
TIKI,thoi-trang-nu,179417985,"Áo trung niên nữ cổ tròn chất đũi dáng rộng, họa tiết thêu độc đáo. R4",185000,185000,0,0
TIKI,thoi-trang-nu,99219054,"Quần âu nữ công sở Hiền Trần BOUTIQUE vải trượt Thái mềm mại, co giãn, tôn dáng chuẩn VNXK",213000,350000,137000,39
TIKI,thoi-trang-nu,124489997,"Đồ ngủ sexy nữ Đồ ngủ hai dây có mút ngực, cột nơ chất phi hai dây chất mịn quyến rũ",56000,56000,0,0
TIKI,thoi-trang-nu,110896759,"Quần ống rộng nữ vải đũi cạp cao 2 cúc suông dài tôn dán chun sau co dãn thoải mái Thời trang BANAMO sớ đũi 2khuy 922",89000,89000,0,0
TIKI,thoi-trang-nu,55211860,"Đồ Bơi Cặp Đồ Bơi Tay Dài Chống Nắng Kiểu Hàn Quốc AT173 MayHomes Đồ Bơi Nam Nữ",254000,288000,34000,12
TIKI,thoi-trang-nu,172677701,"Váy ngủ nữ, váy 2 dây lụa mềm quyến rũ VILADY - V121 thiết kế siêu sang màu Trắng gạo, chất liệu lụa Pháp ( lụa latin) cao cấp",372000,400000,28000,7
TIKI,thoi-trang-nu,84119398,"Quần lót giấy mặc 1 lần KACHOO, 5 cái/bịch,thoáng mát, tiện lợi khi đi du lịch hay những ngày ấy",25870,25870,0,0
TIKI,thoi-trang-nu,169833290,"Áo quây/áo ngực nữ không dây/áo lót quây dây/áo ngực mặc váy cúp ngực nâng ngực, dây lưng mảnh cá tính khoe lưng trần gợi cảm và năng động (kèm quai/dây áo ngực trong) LYEA028",120000,129000,9000,7
TIKI,thoi-trang-nu,107393162,"Bộ Đồ Pijama Nữ Mặc Nhà, Quần Áo Ngủ Nữ Ngắn Tay Azuno BN196 Chất Liệu Cotton Lụa Cho Mùa Hè",275000,275000,0,0
TIKI,thoi-trang-nu,62360188,"Quần Jeans Pha Sợi Cà Phê Aaa Jeans Dáng Skinny lưng cao  - UCSD COFFEE",549000,549000,0,0
TIKI,thoi-trang-nu,98604901,"Quần gen bụng/ định hình body lưng vừa chống cuộn, nâng mông, mềm mịn cho nữ LYEQ015",185000,199000,14000,7
TIKI,thoi-trang-nu,182995569,"Đồ Bơi Hai Mảnh Nữ Tay Dài Quần Dài Họa Tiết Lovely Và Hoa Xinh AT228 MayHomes Long Sleeves And Long Pants Women Swimwear With UPF 50 Sun Protection",280250,295000,14750,5
TIKI,thoi-trang-nu,165106956,"Combo 2 quần lót ren nữ sexy cạp thấp, dây hông mảnh đầy gợi cảm ( màu ngẫu nhiên) LYEQ051",80000,86000,6000,7
TIKI,thoi-trang-nu,87642260,"Áo Lót Mút Mỏng Vừa Phối Ren Habpy Lady By Sabina HBXLP0001",229000,383000,154000,40
TIKI,thoi-trang-nu,108896350,"Quần Tây nữ ống loe chất liệu tuyết mưa sang chảnh",80000,80000,0,0
TIKI,thoi-trang-nu,84471379,"Áo khoác hoodie chống nắng 123SHOP dành cho nam nữ Thuê Trái Tim, Nỉ ngoại form rộng Có Dây Kéo unisex ulzzang",100000,100000,0,0
TIKI,thoi-trang-nu,4426799,"Quần thun dài nữ jogger Phúc An 3008_den",99000,99000,0,0
TIKI,thoi-trang-nu,143306359,"Váy/đầm ngủ 2 dây sexy, ren hoa voan mỏng quyến rũ LYEN003",78000,99000,21000,21
TIKI,thoi-trang-nu,195549407,"Đầm xòe phối hoa ngực quyến rũ D025- Lady fashion",210000,390000,180000,46
TIKI,thoi-trang-nu,169307799,"Quần baggy nữ Hiền Trần BOUTIQUE ống đứng, phom dáng Hàn Quốc màu đen xám, đồ công sở đi học",181000,350000,169000,48
TIKI,thoi-trang-nu,192650522,"YU CHERRY | Áo Pattern Flying Off Top YA416",390000,390000,0,0
TIKI,thoi-trang-nu,68939197,"Áo Thu Trắng Đủ Size Cho Mọi Lứa Tuổi",37000,37000,0,0
TIKI,thoi-trang-nu,72556311,"Áo Ngực Nữ Không Gọng Cotton Lụa Flexi Miley Lingerie BRC",199000,290000,91000,31
TIKI,thoi-trang-nu,49905157,"Combo 5 Dây Nối Áo Ngực 3 Móc Co Giãn Tiện Dụng",29000,40000,11000,28
TIKI,thoi-trang-nu,83033277,"Áo Ngực Quai Trong Đệm Dày Mặc Đầm Hở Lưng Hở Vai",125000,125000,0,0
TIKI,thoi-trang-nu,77157563,"Gen nịt bụng siêu định hình siêu thoáng khí ",99000,100000,1000,1
TIKI,thoi-trang-nu,93100635,"ÁO LÁ HỌC SINH COTTON TĂM 2 LỚP MÚT MỎNG 007",31000,33000,2000,6
TIKI,thoi-trang-nu,3579913,"Áo Ngực Triumph Sloggi ZERO WHU - Da (Size",589000,589000,0,0
TIKI,thoi-trang-nu,82704480,"Bộ 5 Quần Lót Ren Sexy quyến rủ thương hiệu BAW, đính nơ xì teen mẫu QLN25",149000,199000,50000,25
TIKI,thoi-trang-nu,73785311,"Quần lót lọt khe ren + kẹp tất sexy",35000,35000,0,0
TIKI,thoi-trang-nu,73528213,"Áo Lót Mút Dày Siêu Nâng Ngực Màu Trơn Basic Doomm Doomm By Sabina SBA7998",359000,579000,220000,38
TIKI,thoi-trang-nu,67279949,"Quần short nữ kiểu mới chất đũi chun",39000,39000,0,0
TIKI,thoi-trang-nu,113786017,"Áo sơ mi đũi nữ dài tay kẻ sọc trẻ trung S05",159000,159000,0,0
TIKI,thoi-trang-nu,70087428,"Áo Sơ Mi Nữ Trơn Dài Tay Công Sở CV088 Chất Kate Mềm Mịn Chuẩn Form Thời trang nữ cao cấp",138000,138000,0,0
TIKI,thoi-trang-nu,179418140,"áo đũi nữ thanh lịch trẻ trung sang trọng cho phái nữ(SP15)",173910,173910,0,0
TIKI,thoi-trang-nu,32214212,"Bộ 10 quần lót su đúc TRƠN không lộ viền cao cấp",140840,140840,0,0
TIKI,thoi-trang-nu,167461360,"Đồ bơi bigsize nữ, áo tắm cộc tay cùng quần boxer cho người béo mập, mẫu thể thao khỏe khoắn, chất đẹp phom đẹp | KT110",480000,480000,0,0
TIKI,thoi-trang-nu,87534240,"Bikini dài tay, đồ bơi nữ dáng thể thao dài tay, quần đùi sooc khỏe khoắn",269000,269000,0,0
TIKI,thoi-trang-nu,121253282,"Áo Lót Nữ, Áo Lót Su Nước Đệm Mỏng Không Gọng Nâng Ngực, Áo Ngực Su Chất Su Mỏng Mát Mịn Thương Hiệu BAW Mã ANN1",99000,159000,60000,38
TIKI,thoi-trang-nu,147043717,"váy len suông dài tay bo tay,đầm suông nữ len gân dáng dài thu đông 3 màu cá tính",85000,85000,0,0
TIKI,thoi-trang-nu,102743436,"Áo khoác DirtyCoins Print Cardigan, ÁO KHOÁC CARDIGAN BẢN PHỐI TƯƠI TRẺ LẪN HOÀI NIỆM CHO GEN Z, Áo cardigan nữ phong cách hàn quốc xinh xắn, áo khoác thu đông nữ chất liệu gân form rộng, vải đẹp không xù",99000,99000,0,0
TIKI,thoi-trang-nu,96990192,"Quần lót lọt khe tua rua chuỗi ngọc sexy",29000,29000,0,0
TIKI,thoi-trang-nu,46654253,"Bikini Hai Mảnh Hoa Hồng Trẻ Trung Dễ Thương AT143 MayHomes",227050,239000,11950,5
TIKI,thoi-trang-nu,66487798,"Đồ lót liền thân sexy Đồ ngủ ren gợi cảm",45000,45000,0,0
TIKI,thoi-trang-nu,182308585,"ĐẦM HOA PHỐI DẬP LY TAY LỒNG ĐÈN - DAM 0019",225000,398000,173000,43
TIKI,thoi-trang-nu,116384748,"Áo thun nữ cộc tay phối màu in số 11 phong cách hàn quốc phom rộng",59000,59000,0,0
TIKI,thoi-trang-nu,151425630,"váy trễ vai trắng tay bồng dáng dài, đầm trễ vai tiểu thư dự tiệc màu trắng điệu đà",80000,80000,0,0
TIKI,thoi-trang-nu,108431580,"Combo 2 quần lót ren  che mông, lọt khe siêu quyến rũ LYEQ031",73000,78000,5000,6
TIKI,thoi-trang-nu,155833290,"Hộp 7 cái quần lót nữ thun lạnh iBasic V110",324000,343000,19000,6
TIKI,thoi-trang-nu,36574256,"1 Quần tây công sở ống suông rộng, ống đứng, dạng cullotes sang trọng, nữ tính",280000,280000,0,0
TIKI,thoi-trang-nu,145575873,"Áo khoác blazer, áo vest nữ kiểu Hàn Quốc tay lỡ, chất vải đẹp, nhiều màu Blz02 - Thời trang công sở WFstudios",361000,361000,0,0
TIKI,thoi-trang-nu,122483987,"Đầm Hàn Quốc xuất khẩu cao cấp Bigsize May 10 mã 050221353XKT",156000,156000,0,0
TIKI,thoi-trang-nu,134231076,"Đồ bơi nữ có đệm mút dài tay liền thân kín đáo chống nắng đi biển thanh lịch",199000,199000,0,0
TIKI,thoi-trang-nu,141087603,"Áo giữ nhiệt nữ thu đông cổ lọ vải cotton co giãn nhiều màu cá tính",28000,28000,0,0
TIKI,thoi-trang-nu,105278580,"Set/Bộ đồ lót ren cúp tam giác, không gọng, khóa cài trước LYEB020",151000,162000,11000,7
TIKI,thoi-trang-nu,121327541,"Quần lót nữ thun lạnh iBasic PANW130",49000,49000,0,0
TIKI,thoi-trang-nu,143861102,"Quần lót nữ thun lạnh iBasic V199-3",49000,69000,20000,29
TIKI,thoi-trang-nu,25975275,"Áo khoác da cá GOKING 6 túi, form unisex cho nữ nam, trẻ em. Chống lạnh, giữ ấm, chống nắng, chống tia UV. Hàng hiệu vnxk",281000,281000,0,0
TIKI,thoi-trang-nu,55023696,"Đồ Bơi Nữ Hai Mảnh Form Xinh Họa Tiết Chessboard AT178 MayHomes",135000,159000,24000,15
TIKI,thoi-trang-nu,112193938,"áo sơ mi nữ dài tay vạt tôm chất đũi nhiều màu",89000,89000,0,0
TIKI,thoi-trang-nu,111043184,"Quần Lót Nữ, Bộ 5 Quần Lót Ren Nữ Cao Cấp Mềm Mịn Hàng Thương Gia, Quần Lót Nữ Kháng Khuẩn, Quần Lót Nữ Co Giãn Tốt Thương Hiệu Baw Mã QLN8813",199000,199000,0,0
TIKI,thoi-trang-nu,106874190,"Quần Lót Nữ, Quần Gen Nịt Bụng Eo Thon, Quần Ghen Cạp Cao Giảm Eo Và Mỡ Bụng Sau Sinh QG21",129000,129000,0,0
TIKI,thoi-trang-nu,165205422,"Quần Lót Nữ, Quần Gen Nịt Bụng Eo Thon, Quần Ghen Chống Cuộn Cạp Cao Giảm Eo Và Mỡ Bụng Sau Sinh QG6",99000,129000,30000,23
TIKI,thoi-trang-nu,137666729,"Áo Sơ Mi Nhung Gân Mặt Cười Form Rộng Unisex Nam Nữ Phong Cách Hàn Quốc Ulzzang",136000,136000,0,0
TIKI,thoi-trang-nu,176784406,"Đồ Bơi Hai Mảnh Nữ Kiểu Dáng Sport Đa Năng ATO43 MayHomes Two-Piece Swimwear",138000,165000,27000,16
TIKI,thoi-trang-nu,84551549,"Áo Lót Bra Lụa Bóng 8 nấc cài nâng ngực siêu sexy thương hiệu BAW mã AN24",69000,99000,30000,30
TIKI,thoi-trang-nu,190300053,"Váy sơ mi dáng dài , Đầm nữ form suông , tay lỡ , chất đũi mềm mát DVDA161",299000,299000,0,0
TIKI,thoi-trang-nu,145290025,"Chân Váy Công Sở New Design Thiết Kế Dáng Váy chữ A, Dài Qua Gối , Tôn Dáng Sang Trọng, Vải Tốt co Giãn CV0053",179000,333000,154000,46
TIKI,thoi-trang-nu,83857402,"áo khoác hoodie cặp đôi, combo 2 cái, Áo khoác hoodie Chống Rét Cho Nam nữ Cho Cặp Đôi in hình WIND Chất Nỉ Unisex Form rộng Có 4 Màu Ulzzang, Áo Khoác hoodie FTITOH Họa Tiết Hoạt Hình Unisex",185000,185000,0,0
TIKI,thoi-trang-nu,43996362,"Sét 4 quần lót nữ ren thêu hoa",99000,99000,0,0
TIKI,thoi-trang-nu,107035770,"Bộ Đi Lễ Chùa - Đồ Lam Nữ Đi Chùa Đẹp Cao Cấp Trang Nhã Trang Phục Truyền Thống 2021 Dành Cho Phật Tử - AL009",228000,228000,0,0
TIKI,thoi-trang-nu,169191209,"Combo 2 quần lót xuyên thấu, quần lót nữ, quần lọt khe nữ cột dây hở đáy sexy và hư hỏng ( màu ngẫu nhiên) LYEQ047 ",83000,89000,6000,7
TIKI,thoi-trang-nu,74864797,"Áo Lót Nữ Không Gọng Nâng ngực nhẹ LOIRECHIC BRFC02 Kẻ Caro",189000,189000,0,0
TIKI,thoi-trang-nu,91249750,"Áo khoác hoodie basic nam nữ SmileZ dáng unisex form rộng chất nỉ bông chống nắng tốt",100000,100000,0,0
TIKI,thoi-trang-nu,69175339,"Quần short kaki nữ GOKING, lưng thun và dây rút co giãn thoải mái. Túi sâu rộng bỏ điện thoại",185000,185000,0,0
TIKI,thoi-trang-nu,106685195,"Áo dài trắng học sinh 2 tà lụa nhật / áo dài nữ sinh / áo dài truyền thống",180000,180000,0,0
TIKI,thoi-trang-nu,26165644,"Áo sơ mi công sở kiểu áo sơ mi đơn giản tay lỡ cổ V GOTI 3084",219000,219000,0,0
TIKI,thoi-trang-nu,160796434,"Combo 2 Quần Lót Lọt Khe Phối Ren Hở Đáy Đính Hạt Ngọc Trai Gợi Cảm Cho Nữ (màu ngẫu nhiên) LYEQ059",63000,68000,5000,7
TIKI,thoi-trang-nu,84551050,"Áo Lót Bra Ren không dây siêu hot thương hiệu BAW mã AN23",89000,159000,70000,44
TIKI,thoi-trang-nu,36577792,"Corset inside - Áo lót mặc trong gen nịt bụng",65000,65000,0,0
TIKI,thoi-trang-nu,128276501,"Quần kaki nam nữ chất đẹp, co giãn",189000,189000,0,0
TIKI,thoi-trang-nu,167951497,"Đồ ngủ bigsize/ Đồ ngủ gợi cảm sexy có mút ngực cột dây sau lưng mã 3",61000,61000,0,0
TIKI,thoi-trang-nu,103359268,"Quần lọt khe nữ – Quần lọt khe ren sexy C10 - Quần chíp ren sexy - Quần lót lọt khe nữ sexy - Quần lót nữ lọt khe xẻ dáy",30000,30000,0,0
TIKI,thoi-trang-nu,172693435,"Váy ngủ nữ, váy 2 dây lụa mềm quyến rũ VILADY - V123 màu đen huyền bí, thiết kế siêu sang, chất liệu lụa Pháp ( lụa latin) cao cấp",372000,400000,28000,7
TIKI,thoi-trang-nu,77123173,"Combo 2 Quần Lót Nữ Không Đường May Phối Ren Mềm Mịn Quyến Rũ ( màu ngẫu nhiên) LYEQ006",91000,98000,7000,7
TIKI,thoi-trang-nu,98599085,"Quần gen bụng/ định hình body lưng cao chống cuộn, nâng mông, mềm mịn cho nữ LYEQ-015",222000,239000,17000,7
TIKI,thoi-trang-nu,141260416,"váy suông nữ,đầm suông nữ cổ V dáng dài xẻ tà 3 màu siêu xinh",89000,89000,0,0
TIKI,thoi-trang-nu,111695417,"Áo sơ mi nữ dài tay vạt tôm chất đũi nhẹ, thoáng mát nhiều màu",95000,95000,0,0
TIKI,thoi-trang-nu,152494664,"Áo thun Teeworld Saigonese Cô Ba Version 2 Form Rộng Nam Nữ Unisex",299000,299000,0,0
TIKI,thoi-trang-nu,93828649," Áo Khoác Bomber Nỉ 199 Chất Nỉ Bông Mịn Đẹp Form rộng Unisex Nam Nữ Couple",93000,93000,0,0
TIKI,thoi-trang-nu,28700363,"Áo sơ mi nữ cổng sở kiểu áo cột nơ cổ chữ v tay lật GOTI 3091",229000,229000,0,0
TIKI,thoi-trang-nu,103357147,"Quần lọt khe nữ – Quần lọt khe ren sexy C23 - Quần chíp ren sexy - Quần lót lọt khe nữ sexy - Quần lót nữ lọt khe xẻ dáy",21000,21000,0,0
TIKI,thoi-trang-nu,59470004,"Quần Đùi Lót Nữ Mặc Trong Chân Váy Dài 32cm Miley Lingerie - Màu Đen FDS0116",65000,88000,23000,26
TIKI,thoi-trang-nu,124874010,"Đồ bộ nữ mặc ở nhà bộ lửng co giãn thoáng mát",88000,88000,0,0
TIKI,thoi-trang-nu,140458206,"Áo khoác nữ form rộng hoodie có mũ trơn tay bồng có khóa kéo phong cách Hàn Quốc Áo khoác nữ mùa đông YiiL K01",114000,114000,0,0
TIKI,thoi-trang-nu,89611971,"Áo Chống Nắng Nữ  Atuner MN001 Dáng Ngắn, Thông Hơi, Ngăn Chặn Tia UV- Hàng Chính Hãng",259000,499000,240000,48
TIKI,thoi-trang-nu,187048171,"Bộ đồ bơi bikini nữ 2 mảnh kín đáo đi tắm biển, đi tập yoga, đi tập gym tay dài - B.43",166000,179000,13000,7
TIKI,thoi-trang-nu,90070163,"Áo khoác nhung nữ , áo khoác nữ kiểu croptop vải nhung túi hộp , hàng chuẩn shop",165000,165000,0,0
TIKI,thoi-trang-nu,181247693,"Quần Legging Nữ Dài Cạp Cao Đẹp Cao Cấp PINKAHA Nâng Mông Vải Thun Cotton Siêu Co Giãn 4 Chiều Ôm Sát",185000,285000,100000,35
TIKI,thoi-trang-nu,99698447,"Áo Ngực Không Gọng Chất Liệu Ren Cao Cấp, Áo Lót Bra Ren Mềm Cao Cấp Không Gọng dây mảnh Thương Hiệu Baw mã NT7",159000,159000,0,0
TIKI,thoi-trang-nu,134389408,"Áo Khoác Hoodie Nỉ Bông SHINING MOON Dây Kéo Form Rộng Unisex Nam Nữ Phong Cách Hàn Quốc Ulzzang KUN",96000,96000,0,0
TIKI,thoi-trang-nu,82704404,"Bộ 5 Quần Lót Nữ Cotton tăm tre đính nơ gân 2 mặt siêu thấm hút mồ hôi thương hiệu BAW QLN20",139000,139000,0,0
TIKI,thoi-trang-nu,104791485,"Quần lót nữ thái lan 702 – Lưng cao, thun lạnh- Form L",40000,40000,0,0
TIKI,thoi-trang-nu,97819167,"Cosplay Học Sinh Sexy - Đồ Lót Cosplay Học Sinh - Set đồ ngủ cosplay học sinh",124000,124000,0,0
TIKI,thoi-trang-nu,83832124,"Áo Ngực, Áo Lót cho con bú chống chảy xệ, Áo Ngực cho mẹ bầu siêu hot thương hiệu Baw mã AN08",89000,129000,40000,31
TIKI,thoi-trang-nu,82642292,"Áo Sơ Mi Nữ Dài Tay Công Sở Thời Trang PONIVA",157000,157000,0,0
TIKI,thoi-trang-nu,138755296,"Áo Thun Nữ Cổ Tim Tay ngắn , Trẻ Trung, Mẫu Mới nhất",79000,79000,0,0
TIKI,thoi-trang-nu,75581340,"Combo 10 Quần Lót Nữ Su Thun Lạnh Julido Store, Quần Sịp nữ đúc Su không đường viền được yêu thích A1",179000,179000,0,0
TIKI,thoi-trang-nu,58027810,"Set Đồ Bơi 2 Chi Tiết Form Sport AT190, Thoải Mái Và Tiện Dụng",126000,149000,23000,15
TIKI,thoi-trang-nu,183921232,"Quần gen bụng mặc váy nâng mông nữ co dãn 4 chiều cao cấp",84500,84500,0,0
TIKI,thoi-trang-nu,85705352,"Choàng Chống Nắng Nữ Cotton Laroma| UPF50+ | Vải Thơm | Làm Mát | Thời Trang | Đa Dụng",459000,459000,0,0
TIKI,thoi-trang-nu,73238895,"Áo Cardigan Nữ Duyên Dáng ALN040 MayHomes Áo Khoác Kiểu Nhẹ Và Cute",145700,155000,9300,6
TIKI,thoi-trang-nu,1921045,"Áo Ngực Triumph Maxi M025 JN-TL - Da (Size",629000,799000,170000,21
TIKI,thoi-trang-nu,96061253,"Quần Lót Nữ gợi cảm quần chíp nữ đồ lót sexy chất liệu ren thêu cao cấp 1136",35000,38000,3000,8
TIKI,thoi-trang-nu,180994575,"Bộ đồ bơi nữ 3 mảnh cao cấp QB03 - Đồ bơi nữ sexy gợi cảm - Đồ bơi bikini",149000,210000,61000,29
TIKI,thoi-trang-nu,38840285,"Combo 10 quần lót tàng hình trộn màu sexy cho phái nữ",200000,215000,15000,7
TIKI,thoi-trang-nu,165205923,"Quần Ghen Định Hình, Quần Ghen Nữ Su Lạnh Cạp Cao Có Chiết Eo Chống Cuộn Siêu Giảm Eo Thương Hiệu Baw QG07",129000,189000,60000,32
TIKI,thoi-trang-nu,46250423," Áo Ngực Nữ Có Gọng Mút Vừa Miley Lingerie Sporty Chic",205000,315000,110000,35
TIKI,thoi-trang-nu,117032561,"Dây Áo Ngực Trong Suốt Loirechic DT02",20000,20000,0,0
TIKI,thoi-trang-nu,180102611,"Đầm suông trung niên, đầm linen dáng suông ĐŨI VIỆT thời trang thương hiệu chính hãng D60",249000,249000,0,0
TIKI,thoi-trang-nu,102504815,"Quần Jean Nữ, Quần Jean Nữ Lưng Cao, Quần Jean Nữ Siêu Hack Dáng thương hiệu Chandi, Jean Nữ co dãn tôn dáng phụ nữ eo thon mẫu KVK11",159000,299000,140000,47
TIKI,thoi-trang-nu,84685068,"Bộ 5 Quần Lót Su Phối Ren sexy quyến rũ thương hiệu BAW mã QLN51",199000,199000,0,0
TIKI,thoi-trang-nu,117573855,"set đồ nữ chất đũi,bộ đồ nữ hè áo yếm quần đùi chât đũi xinh xắn",99000,99000,0,0
TIKI,thoi-trang-nu,146228143,"Áo polo nữ ADINO màu vàng phối viền xẻ lai vải cotton co giãn dáng slimfit trẻ trung APN02",139000,278000,139000,50
TIKI,thoi-trang-nu,192934185,"Đồ Bộ Nữ New Design Chất Lụa Satin Mịn  Mặc Mát  Nhiều Màu, Freesize (40 - 65kg) Quần Đùi Áo Hai Dây CB0001",249000,249000,0,0
TIKI,thoi-trang-nu,148963418,"Áo bra/lót  2 dây phối ren, mút mỏng dùng hàng ngày cho nữ LYEA018",111000,119000,8000,7
TIKI,thoi-trang-nu,45468948," Quần lót nữ lọt khe dây hạt - đỏ",29000,29000,0,0
TIKI,thoi-trang-nu,113334161,"váy suông nữ,váy cộc tay cổ đính nơ dáng dài đuôi cá",98000,98000,0,0
TIKI,thoi-trang-nu,74421501,"ÁO LÓT NỮ MỎNG CÓ GỌNG CÀI TRƯỚC VIỀN REN",87000,102000,15000,15
TIKI,thoi-trang-nu,7159565,"Bộ 2 Quần Gen Bụng Sau Sinh Hàn Quốc Làm Eo Thon (Da + Đen) - 5Star",85000,85000,0,0
TIKI,thoi-trang-nu,76692477,"Áo Lót Cúp Ngực Chống Tuột LOIRECHIC BRQ12",325000,325000,0,0
TIKI,thoi-trang-nu,109125528,"Combo 2 quần lót ren lọt khe hình bướm cực kì quyến rũ, gợi cảm LYEQ033",73000,78000,5000,6
TIKI,thoi-trang-nu,103432350,"Quần ống rộng suông kiểu nhật, mặc mát lạnh trong ngày hè",69000,69000,0,0
TIKI,thoi-trang-nu,38233264," Quần lót ren lọt khe buộc dây - Đỏ tím",29000,29000,0,0
TIKI,thoi-trang-nu,145290013,"Chân Váy Công Sở  New Design Thiết Kế 2 Tầng Váy Xòe Tôn Dáng Midi Che Khuyết Điểm, Vải Tốt Màu Đen Co Giãn Mặc Mát",199000,328000,129000,39
TIKI,thoi-trang-nu,118126502,"Bộ đồ lửng thun lạnh trung niên nữ cao cấp_ bộ đồ nữ mặc nhà",158000,158000,0,0
TIKI,thoi-trang-nu,83489669,"COMBO 2 QUẦN LÓT REN NƠ XUYÊN THẤU SEXY ( màu ngẫu nhiên) LYEQ008",54000,58000,4000,7
TIKI,thoi-trang-nu,178787824,"Bikini cho người lớn tuổi, đồ bơi trung niên trang nhã, bộ bơi đi biển đẹp cho các mẹ các bà, quần rời V0062",199000,199000,0,0
TIKI,thoi-trang-nu,185005658,"Áo lá học sinh cấp 1 cấp 2 cao cấp áo ngực trẻ em tuổi mới lớn dậy thì chất cotton mềm mại thoáng mát Lá Bralette A23",39000,39000,0,0
TIKI,thoi-trang-nu,134020411,"Set Váy Ngủ Ren Áo Choàng Ngủ Sexy 3 Chi Tiết",179000,179000,0,0
TIKI,thoi-trang-nu,119104221,"Dây áo ngực trong suốt sợi bún - sợi phở siêu bền",9000,9000,0,0
TIKI,thoi-trang-nu,74532262,"Combo 3 Quần Lót Nữ Bikini Melange Active Miley Lingerie - Vàng, Da và Trắng Kem FCB0300-0900-1400",179000,285000,106000,37
TIKI,thoi-trang-nu,160897585,"Áo kiểu nữ form rộng fullsize M đến 2XL, áo đũi nữ thêu hoa họa tiết dễ mix đồ Haint Boutique ALe17",159000,159000,0,0
TIKI,thoi-trang-nu,104792356,"Quần lót nữ thái lan  5134  – big size, Chất cotton mềm mại",35000,35000,0,0
TIKI,thoi-trang-nu,128523060,"Quần áo dài nữ ống suông chất liệu lụa mỹ cao cấp",100000,100000,0,0
TIKI,thoi-trang-nu,180923786,"Bộ đồ mặc nhà nữ lanh (tole) Vicci BN181 thiết kế áo tay ngắn nhún bèo cách điệu phối quần lửng in họa tiết",145000,269000,124000,46
TIKI,thoi-trang-nu,185006832,"Áo bra nữ học sinh cấp 2 cấp 3 chất cotton trơn cao cấp mềm mại thoáng mát kiểu dáng thể thao Lá Bralette A24 áo ngực học sinh",49000,49000,0,0
TIKI,thoi-trang-nu,181991402,"Áo sơ mi nữ Đũi Việt thiết kế cổ V thời trang ALE12",159000,159000,0,0
TIKI,thoi-trang-nu,69932425,"Quần jogger kaki nữ line to, phản quang khi chụp flash, kèm hình thật",89000,89000,0,0
TIKI,thoi-trang-nu,116407392,"váy suông nữ, đầm suông cộc tay in chữ cest chic phom rộng 4 màu",75000,75000,0,0
TIKI,thoi-trang-nu,73244551,"Áo Ngực Đệm Dày Chữ U Mặc Đầm Hở Lưng LOIRECHIC BRL04",325000,325000,0,0
TIKI,thoi-trang-nu,109981854,"Váy mặc nhà, váy ngủ 2 dây hình hạc độc đáo V27",169000,169000,0,0
TIKI,thoi-trang-nu,170487504,"Quần legging nữ Hiền Trần BOUTIQUE nâng mông lưng cạp cao vải thun dày dặn đùi ngố lửng ôm body bó mặc nhà tập gym yoga",116000,170000,54000,32
TIKI,thoi-trang-nu,142717766,"Áo khoác hoodie chống nắng dành cho nam nữ Thêu Trái Tim, Nỉ ngoại form rộng Có Dây Kéo unisex ulzzang",97000,97000,0,0
TIKI,thoi-trang-nu,84077317,"Đồ bơi áo tắm cho người trung tuổi, dáng váy quần sooc đùi dài, tôn dáng tránh lộ bụng, bikini trung niên cho mẹ cho bà size lớn | KT007",350000,350000,0,0
TIKI,thoi-trang-nu,87616279,"Áo Lót Không Gọng Mút Dày Siêu Nâng Ngực Màu Trơn Habpy Lady By Sabina HBXLP0005",229000,383000,154000,40
TIKI,thoi-trang-nu,170154797,"Áo Bơi Nữ Tay Dài - Sea Foam Sobie",430000,430000,0,0
TIKI,thoi-trang-nu,131419223,"áo kiểu nữ chất đũi - hàng VNXK (A17)",142000,142000,0,0
TIKI,thoi-trang-nu,182479802,"Quần nữ ống rộng, dài, chất liệu Đũi mát, vải mềm mịn, form rộng, thoải mái, phong cách trẻ trung QKH.51",139000,259000,120000,46
TIKI,thoi-trang-nu,16171715,"Áo Ngực Thể Thao Seamless, Áo Ngực Tập Yoga Thời Trang Cao Cấp, Cá Tính, Co Giãn Tốt, Ôm Gọn Vòng 1 Khi Vận Động Ibasic IBX019 - Hàng Chính Hãng",169000,199000,30000,15
TIKI,thoi-trang-nu,117032496,"Áo Lót Không Gọng Su Đúc Đệm Mỏng Mát Lạnh Loirechic BRDE64",325000,325000,0,0
TIKI,thoi-trang-nu,179417429,"Set đồ nữ mặc nhà dáng suông thoải mái tôn dáng siêu đẹp ( SP14)",250000,250000,0,0
TIKI,thoi-trang-nu,184518602,"Quần lót nữ lọt khe ren hình con bướm sexy Q405 - Quần lọt khe nữ gợi cảm - Quần chip nữ - Quần lót nữ - Freesize 45kg - 57kg - Đỏ",50000,99000,49000,49
TIKI,thoi-trang-nu,14435891,"Chân váy ôm xếp pilly – MS0305CV ( có lớp lót)",65000,125000,60000,48
TIKI,thoi-trang-nu,128302215,"Bộ đồ ngủ 2 dây chất phi bóng mềm mịn có mút ngực viền ren hai bên mã 5",58000,58000,0,0
TIKI,thoi-trang-nu,92387305,"Đồ bộ bigsize - Đồ bộ trung niên - Bộ đồ trung niên mặc nhà bigsize Vicci DGD.02  thiết kế áo cộc quần dài chất liệu đũi cao cấp (dành cho người béo)",150000,299000,149000,50
TIKI,thoi-trang-nu,52045769,"Đồ Bơi Tay Dài Liền Thân Kiểu Dáng Thể Thao AT153 MayHomes Thun Co Giãn Tốt, Thiết Kế Một Mảnh, Áo Ngực Rời, Gợi Cảm",217000,246000,29000,12
TIKI,thoi-trang-nu,113543251,"GOTI - ÁO KIỂU GIẤU BỤNG BIGSIZE DẠNG ÁO SƠ MI QUÝ BÀ ĐÍNH NÚT - ÁO KIỂU THỜI TRANG U50-60 CHO NGƯỜI MẬP 3A01",179000,179000,0,0
TIKI,thoi-trang-nu,116574971,"Quần sooc nữ,quần đùi nữ ống rộng chun lưng khóa trước chất kaki nhiều màu",65000,65000,0,0
TIKI,thoi-trang-nu,103437019,"Quần ống rộng vải đũi siêu Hot chất dày dặn ko bai dão ko xù lông và ko mỏng nha",66000,66000,0,0
TIKI,thoi-trang-nu,138749319,"Áo Thun Nữ Cổ Tim Tay ngắn , Trẻ Trung, Mẫu Mới nhất",89000,99000,10000,10
TIKI,thoi-trang-nu,186105036,"Áo 2 Dây New Design Thiết Kế Cổ V Gợi Cảm, Kiểu Áo Nữ Hiện Đại , Vải Lụa Hàn Quốc Trơn, Nhiều Màu, Mịn ,Thoáng Mát  AO0002",119000,199000,80000,40
TIKI,thoi-trang-nu,104793592,"Áo lót Bra vải cotton Thái Lan vải  B.1134 – Form Cup A, không gọng",65000,65000,0,0
TIKI,thoi-trang-nu,72973435,"Áo lót trơn không gọng mút đệm vừa cotton thêu vân hoa cúc",78000,78000,0,0
TIKI,thoi-trang-nu,67151410,"Áo Sơ Mi Nữ Ngắn Tay Công Sở Phối Viền Màu Đẹp",157000,157000,0,0
TIKI,thoi-trang-nu,177204918,"Bộ Bikini Cô gái gợi cảm",39000,39000,0,0
TIKI,thoi-trang-nu,33787385,"Quần Legging dáng dài 4 túi giả bò",99500,199000,99500,50
TIKI,thoi-trang-nu,84749445,"Áo Khoác Hoodie Nỉ Ngoại Tai Thỏ dành cho nữ",101000,101000,0,0
TIKI,thoi-trang-nu,102124106,"Áo lót trơn không gọng mút mỏng cài sau trẻ trung",78000,78000,0,0
TIKI,thoi-trang-nu,101278726,"Combo 3 BỊCH QUẦN LÓT GIẤY VẢI COTTON Mỗi bịch 6 cái (42-80 Kg )",97440,97440,0,0
TIKI,thoi-trang-nu,66897847,"ÁO KHOÁC KAKI THỜI TRANG NỮ AK61120",450000,450000,0,0
TIKI,thoi-trang-nu,7249713,"Đầm ngủ sexy MM MS354",80000,80000,0,0
TIKI,thoi-trang-nu,144236336,"COMBO 5 ÁO LÓT VẢI KHÔNG GỌNG KHÔNG MÚT (SIZE 32-42)",126000,155000,29000,19
TIKI,thoi-trang-nu,97819131,"Cosplay Sườn Xám - Bộ đồ cosplay sườn xám nhung hở vai sexy gợi cảm - Set sườn xám thêu hoạ tiết",117000,117000,0,0
TIKI,thoi-trang-nu,12710511,"Quần Legging Vicci Cao Cấp Màu Đen Vân Xước Cạp Cao 11P",224500,449000,224500,50
TIKI,thoi-trang-nu,85902335,"Quần Lót Mềm Giấu Đường May Phối Ren Cho Nữ - Quần lót xẻ dáy sexy - quần lót lọt khe C53",34320,34320,0,0
TIKI,thoi-trang-nu,107040848,"Đồ Lam Đi Chùa # La Hán Nam - đồ phật tử",206000,206000,0,0
TIKI,thoi-trang-nu,115872905,"Quần short kaki ống rộng mốt mới 2021",65000,65000,0,0
TIKI,thoi-trang-nu,107124545,"Quần ống rộng nữ cúc khoá kiểu nhật dáng lỡ chất đũi",60000,60000,0,0
TIKI,thoi-trang-nu,118023217,"ĐỒ LAM ĐI CHÙA # Lãnh Tụ Phối Nam # Đồ Bộ Nam Nữ # Quần Áo Nam Nữ",196000,196000,0,0
TIKI,thoi-trang-nu,76045124,"Chân váy vải mềm mại dễ thương free size VAY19",185000,185000,0,0
TIKI,thoi-trang-nu,107039134,"SET ĐỒ LAM ĐI CHÙA CAO CẤP SS1",248000,248000,0,0
TIKI,thoi-trang-nu,83685898,"Đai quấn giảm mỡ bắp tay",134900,134900,0,0
TIKI,thoi-trang-nu,130866362,"Quần sọc caro XANH ống suông ️ Nam nữ unisex Quần baggy caro Jaystoree",100000,100000,0,0
TIKI,thoi-trang-nu,163564486,"Quần Legging Nữ Cao Cấp LUPERI LP516 Siêu Co Giãn Nâng Mông Bền Màu vải dày dài đẹp siêu co giãn",355000,355000,0,0
TIKI,thoi-trang-nu,3075099,"Bộ mặc nhà lanh (tole) Vicci BNXT.078.1 vải Thái 3D cao cấp họa tiết hoa đỏ nền trắng (Size",174500,349000,174500,50
TIKI,thoi-trang-nu,104792323,"Quần lót thái lan 262 , chất thun lạnh, co giản 4 chiều, size lớn",35000,35000,0,0
TIKI,thoi-trang-nu,178071097,"2 Cặp Miếng Dán Ngực Miley Lingerie",45000,100000,55000,55
TIKI,thoi-trang-nu,84821649,"Quần Lót Đúc Chống Lộ Viền Chống Cuộn Chống Lọt Khe Kháng Khuẩn Ôm Full Vòng 3 Cao Cấp P427",55000,55000,0,0
TIKI,thoi-trang-nu,104105306,"Áo Khoác Dù 7ZIA Ulzzang Nam Nữ Unisex Form Rộng Bomber Jacket",100000,100000,0,0
TIKI,thoi-trang-nu,125400909,"ÁO DÀI CÁCH TÂN LỤA HOA ĐÀO 3D - AD23",340000,340000,0,0
TIKI,thoi-trang-nu,177188693,"Quần đũi nữ ống rộng dài lưng cao chun sau vải đũi nhật dáng dài đẹp Q118",69000,69000,0,0
TIKI,thoi-trang-nu,11447496,"Sơ mi nữ vải đũi, tay dài có túi Haint Boutique S172",179000,179000,0,0
TIKI,thoi-trang-nu,84552947,"Bộ Đồ Lót (Gồm Quần + Áo Đúc Su Trơn) Cài Trước Không Gọng mẫu mới dây lưới cao cấp thương hiệu BAW mã AN26",119000,199000,80000,40
TIKI,thoi-trang-nu,58686358,"Áo len nữ dệt kim phối màu thời trang ALN07",149000,149000,0,0
TIKI,thoi-trang-nu,107037750,"SET ĐỒ LAM ĐI CHÙA CAO CẤP SS2",259000,259000,0,0
TIKI,thoi-trang-nu,6459121,"Váy ngủ, đầm ngủ sexy ren mềm kèm áo choàng cao cấp HERA",162000,162000,0,0
TIKI,thoi-trang-nu,118126172,"Bộ đồ mặc nhà trung niên nữ _ Bộ đồ thun lạnh mềm mịn_Bộ đồ cho mẹ mẫu mới",104000,104000,0,0
TIKI,thoi-trang-nu,161209448,"BIGSIZE 50-140KG Quần Lót Chống Tràn Nguyệt San Bigsize",68000,68000,0,0
TIKI,thoi-trang-nu,118099916,"Quần lót nữ lọt khe ren không đáy hở đũng sexy",29000,29000,0,0
TIKI,thoi-trang-nu,181712764,"Áo croptop Hiền Trần BOUTIQUE cổ vuông cộc tay vải thun ôm body crotop nữ cotton co giãn tốt",163000,230000,67000,29
TIKI,thoi-trang-nu,179414178,"Quần ống rộng chất đũi xước có size tới 85kg SP7",158000,158000,0,0
TIKI,thoi-trang-nu,69991534,"Áo Lót Ngực Bigsize Có Gọng Cho Chị Em Quả Ngực To",162000,162000,0,0
TIKI,thoi-trang-nu,111620794,"Đồ mặc nhà quần lửng COTTON 5007",292000,292000,0,0
TIKI,thoi-trang-nu,21029987,"Quần jean thun nữ",330000,330000,0,0
TIKI,thoi-trang-nu,84826649,"Áo Lót Bralette SepSweet lụa mỏng mềm mịn B048",132000,132000,0,0
TIKI,thoi-trang-nu,146280689,"Đai Nịt Bụng Vita Latex "Thế Hệ Mới" cao cấp che mỡ lưng, định hình eo - Kèm Lót Liner",599000,599000,0,0
TIKI,thoi-trang-nu,55959625,"Áo ren lưới đi biển thời trang, mặc ngoài bikini, croptop, dáng lửng tay lỡ xinh xắn, mẫu cao cấp mới 2020 | AR003",240000,240000,0,0
TIKI,thoi-trang-nu,108412530,"Quần tây nữ Hiền Trần BOUTIQUE chất vải cao cấp 3 màu, âu công sở mặc tôn dáng",181000,350000,169000,48
TIKI,thoi-trang-nu,110801615,"Đầm dự tiệc bo eo cánh dơi sang trọng - nhiều size, form dáng chuẩn thích hợp mặc đi làm, đi tiệc",250000,250000,0,0
TIKI,thoi-trang-nu,117003535,"Bộ Đồ Ngủ Nữ Mùa Hè Cao Cấp Loirechic BHDN05",365000,365000,0,0
TIKI,thoi-trang-nu,106771166,"Áo Lót Nữ, Áo Bra Không Dây Không Gọng Cực Êm, Bra Nữ Đệm Bàn Tay Nâng Ngực Siêu Quyến Rũ thương hiệu Baw ABR1 (tặng kèm dây trong)",99000,159000,60000,38
TIKI,thoi-trang-nu,176200238,"Váy ngủ ren hai dây nút cài xẻ trước kèm chip lọt khe gợi cảm Q438 - Đầm ngủ nữ xuyên thấu quyến rũ - Đồ ngủ sexy",129000,190000,61000,32
TIKI,thoi-trang-nu,51507409,"Quần lót hình bướm lọt khe sexy",25000,25000,0,0
TIKI,thoi-trang-nu,134390163,"Áo Sơ Mi Nhung Gân Mặt Cười Form Rộng Unisex Nam Nữ Phong Cách Hàn Quốc Ulzzang",137000,137000,0,0
TIKI,thoi-trang-nu,107036659,"Đồ Lam Nữ Đi Chùa - Bộ Đi Lễ Chùa 2AL018 Trang Nhã Thêu Cá Ngọc Xinh Lung Linh Dành Cho Phật Tử 4.8",197000,197000,0,0
TIKI,thoi-trang-nu,132700179,"Áo Sweater nỉ in chữ Hàn Quốc- Nỉ ngoại dài tay dáng rộng Ulzzang, Áo Nỉ Sweater Chữ Nhật Sô-cô-la Form To Thụng - Áo Nỉ Nam Nữ, áo chui đầu tay dài gấu quần unisex, áo khoác hoodie nam nữ",99000,99000,0,0
TIKI,thoi-trang-nu,57709128,"Quần lót ren hoa lọt khe thời trang nữ tính - Đỏ",25000,25000,0,0
TIKI,thoi-trang-nu,178519381,"Quần lót nữ lọt khe dây phối ren bèo sexy QL8014 - Quần chip lọt khe nữ - Quần lót nữ - Quần chip nữ",29000,50000,21000,42
TIKI,thoi-trang-nu,73588007,"Áo ngực nữ Triumph 2505 có gọng, mút mỏng, bản lưng to định hình ôm nâng đẩy ngực",745000,1199000,454000,38
TIKI,thoi-trang-nu,57318339,"Đầm Dạ Hội Trọng MS 122",339440,339440,0,0
TIKI,thoi-trang-nu,74309526,"Quần jean nữ Lưng Cao Julido Store, chất jean co dãn 4 chiều ống ôm chân mẫu MH03",159000,299000,140000,47
TIKI,thoi-trang-nu,192224123,"Áo thun nữ cổ tim tay dài vải cotton đẹp, dễ mặc dễ phối đồ, mặc bốn mùa",99000,99000,0,0
TIKI,thoi-trang-nu,192781082,"YU CHERRY | Đầm Ruffle Neck Tank Dress YD147",395000,395000,0,0
TIKI,thoi-trang-nu,43951059,"Áo len nữ thời trang kiểu dáng Hàn Quốc",149000,149000,0,0
TIKI,thoi-trang-nu,146957711,"Quần Jean Nữ Ống Rộng Lưng Cao Aaa Jeans",449000,449000,0,0
TIKI,thoi-trang-nu,174891426,"Váy ngủ bodysuit ren sexy cao cấp Q426 - Đồ ngủ bodysuit hở đáy gợi cảm - Đầm ngủ bodysuit nữ - Bodysuit ren quyến rũ",89000,150000,61000,41
TIKI,thoi-trang-nu,104795185,"Set/Bộ Đồ Lót Một Mảnh Vải Nhung Cài Trước Thiết Kế Quyến Rũ, Gợi Cảm LYEB018",185000,199000,14000,7
TIKI,thoi-trang-nu,134799309,"Áo khoác nỉ hoodie sadboiz signature , tee local brand basic sadboy sad cry form rộng unisex nam nữ ulzzang TTUN STORE",105000,105000,0,0
TIKI,thoi-trang-nu,84821702," Quần Lót Chất Mềm Mát Lạnh Co Giãn Nhiều P047",35000,35000,0,0
TIKI,thoi-trang-nu,101949464,"Combo 5 quần lót nữ   Jones 003 cotton 100",45000,45000,0,0
TIKI,thoi-trang-nu,115832954,"áo thun nữ,áo phông nữ cộc tay phối màu in số 11 dáng rộng giấu quần năng động",63000,63000,0,0
TIKI,thoi-trang-nu,13862233,"Áo khoác nữ thoát nhiệt Nhật Bản Goking 6 túi, áo chống nắng nhẹ, thấm hút mồ hôi, thoải mái vận động",275000,275000,0,0
TIKI,thoi-trang-nu,38529529,"Đồ Bơi Nữ Hai Mảnh Kiểu Thể Thao AT031 MayHomes",128000,155000,27000,17
TIKI,thoi-trang-nu,172922829,"Bộ đồ Pyjama, đồ mặc nhà nữ VILADY - B107 kiểu tay ngắn quần dài họa tiết VẰN thanh lịch chất liệu lụa Pháp cao cấp (lụa latin)",464000,499000,35000,7
TIKI,thoi-trang-nu,92018956," Móc nối áo ngực    Miếng nới rộng áo ngực",2600,2600,0,0
TIKI,thoi-trang-nu,172024147,"Đồ bộ pyjama nữ, đồ mặc nhà VILADY - B115 kiểu tay dài quần dài họa tiết lá xanh, chất liệu lụa Pháp ( lụa latin) siêu mát",363000,550000,187000,34
TIKI,thoi-trang-nu,110872343,"quần ống rộng nữ, quần ống suông G..U chất đũi 3 màu",65000,65000,0,0
TIKI,thoi-trang-nu,186693795,"ĐẦM HOA TIỂU THƯ CỔ SEN PHỐI VIỀN REN – M04",199000,390000,191000,49
TIKI,thoi-trang-nu,74421965,"Áo Lót Không Gọng Mút Đệm Vừa Thời Trang Pretty Perfect By Sabina SBU8510",229000,609000,380000,62
TIKI,thoi-trang-nu,111005927,"Quần Lót Nữ, Bộ 5 Quần Lót Nữ Thun Lạnh Phối Ren Cao Cấp Mềm Mịn Hàng Thương Gia, Quần Lót Nữ Kháng Khuẩn, Quần Lót Nữ Co Giãn Tốt Thương Hiệu Baw Mã QLN888",169000,199000,30000,15
TIKI,thoi-trang-nu,174897065,"Váy ngủ lụa cổ V đan dây hông cao cấp Q407 - Đầm ngủ 2 dây sexy gợi cảm - Đồ ngủ lụa quyến rủ - Đồ ngủ mạc nhà",96600,138000,41400,30
TIKI,thoi-trang-nu,175551986,"ĐẦM HỌA TIẾT SAO PHỐI DẬP LY - DAM02",225000,390000,165000,42
TIKI,thoi-trang-nu,187824717,"Áo Lót có Gọng Nâng Ngực Loirechic BRPU110",315000,315000,0,0
TIKI,thoi-trang-nu,166466133,"Bộ đồ lót/set đồ lót/ bộ quần áo lót/đồ lót thể thao không gọng chất cotton mềm mại thoải mái cho bạn nữ LYEB025",129000,139000,10000,7
TIKI,thoi-trang-nu,129557861,"Đồ bộ nữ mặc nhà, Đồ ngủ nữ áo cánh tiên quần cạp chun vải đũi xước mềm mịn siêu xinh (FREESIZE cho nữ từ 40kg - 60kg)",49000,49000,0,0
TIKI,thoi-trang-nu,73862702,"ÁO LÓT NỮ REN MÚT DÀY 2CM DÂY TRƠN NÂNG NGỰC 024B",113000,122000,9000,7
TIKI,thoi-trang-nu,130865785,"Áo hoodie nỉ bông form rộng HAPPY ️/Nam nữ unisex/Jaystoree",96000,96000,0,0
TIKI,thoi-trang-nu,51526856,"Quần lót ren nữ thanh lịch sexy mềm mại",25000,25000,0,0
TIKI,thoi-trang-nu,78629416,"Áo kiểu peplum cổ tim phối nơ sang trọng thích hợp mặc đi làm hoặc dạo phố - M",180000,180000,0,0
TIKI,thoi-trang-nu,103797449,"Quần Lót Chống Tràn Nguyệt San Trơn Cotton Thoáng Khí Cạp Vừa P471",42000,42000,0,0
TIKI,thoi-trang-nu,131177375,"Áo khoác len nữ, áo cardigan len thiết kế phối ren mẫu mới thu đông AH02",199000,199000,0,0
TIKI,thoi-trang-nu,84819925,"Quần Lót Cạp Cao Ren Mềm Không Lộ Viền Cao Cấp P361",75000,75000,0,0
TIKI,thoi-trang-nu,83857592,"ÁO KHOÁC HOODIE PURBSSO tay phồng nhúng, Áo Hoodie Nỉ Bông Unisex PURBSSO [ FREESHIP ] form nam nữ unisex,hoodie PURBSO, Áo hoodie nam / áo hooodie nữ / áo hoodie form rộng / áo khoác nam có nón trùm đầu / áo hoodie cặp đôi / áo khoác cặp đôi",100000,100000,0,0
TIKI,thoi-trang-nu,194498328,"Váy len body chiết eo, Đầm xinh dáng ôm chất liệu len dệt kim cao cấp- VL01",289000,289000,0,0
TIKI,thoi-trang-nu,108915738,"Áo Lót Thể Thao Màu Trơn Thời Trang Basic Sport By Sabina SBB1204",159000,383000,224000,58
TIKI,thoi-trang-nu,114056192,"Áo khoác nỉ nữ cao cấp/ Áo khoác hoodie form rộng in hoạ tiết dễ thương khoá kéo nhiều màu thời trang teen hè",97000,97000,0,0
TIKI,thoi-trang-nu,67140446,"Áo Sơ Mi Nữ Dài Tay Phối Họa Tiết Star Thanh Lịch",89000,89000,0,0
TIKI,thoi-trang-nu,179765132,"Combo 2 quần lót nữ, quần lót tam giác, quần lót nữ ren mềm mịn đính nơ sau mông xinh xắn, gợi cảm LYEQ072 ( MÀU NGẪU NHIÊN)",83000,89000,6000,7
TIKI,thoi-trang-nu,118026605,"Đồ Lam Đi Chùa # Lãnh Tụ Phối # Đồ Bộ Nam Nữ # Quần Áo",102000,102000,0,0
TIKI,thoi-trang-nu,190155812,"Quần jean nữ boyfriend baggy trơn dài đen và trắng co giãn HQJEANS",350000,350000,0,0
TIKI,thoi-trang-nu,107154707,"Quần lót ren nữ xuyên thấu gợi cảm",25000,25000,0,0
TIKI,thoi-trang-nu,148640744,"Quần đùi bầu cạp chéo Mặc ngủ và mặc trong váy cho bà bầu mùa hè (Hàng đẹp, cao cấp)",35000,35000,0,0
TIKI,thoi-trang-nu,98807520,"Áo phông ngắn tay, áo thun nữ cộc tay Vicci AP.01.6 chất liệu cotton vân gỗ in hoạ kẻ",84000,168000,84000,50
TIKI,thoi-trang-nu,14815845,"Chân Váy Xòe Phối Nút",135000,135000,0,0
TIKI,thoi-trang-nu,52172650," Đồ ngủ Sexy kiểu áo sơ mi che quần quyến rũ - Màu da",75000,75000,0,0
TIKI,thoi-trang-nu,113933468,"váy suông nữ - đầm suông sát nách dáng dài 3 màu chất đũi",89000,89000,0,0
TIKI,thoi-trang-nu,176156760,"Quần jean nữ ống rộng gài eo cạp cao phong cách Hàn Quốc thời trang Banamo Fashion quần jean nữ cài eo 969",149000,149000,0,0
TIKI,thoi-trang-nu,176212596,"Bộ đồ lửng mặc nhà tole (lanh) Vicci BN93 thiết kế áo sát nách peplum phối quần lửng in họa tiết",135000,269000,134000,50
TIKI,thoi-trang-nu,108915574,"Áo Lót Thể Thao Màu Xám Viền Sọc Xám Trắng Thời Trang Basic Sport By Sabina SBB1201",383000,383000,0,0
TIKI,thoi-trang-nu,175810444,"Đồ bộ pijama lụa, đồ mặc nhà nữ Vilady - B137  kiểu đồ bộ ngắn họa tiết hình học siêu dễ thương, chất liêu lụa Pháp ( lụa latin) cao cấp - Màu hồng",419000,450000,31000,7
TIKI,thoi-trang-nu,179930716,"Đồ Bộ Nữ, Đồ Bộ Nữ Mặc Nhà, Đồ Bộ Nữ Thun Cotton Siêu Đẹp, Đồ Bộ Ngủ Nữ, Đồ Bộ Nữ lửng, Đồ Ngủ Nữ Thoáng Mát ( hình thật shop tự chụp), đồ bộ thể thao nam nữ, đồ bộ unisex ulzzang hàn quốc",99000,99000,0,0
TIKI,thoi-trang-nu,180924959,"Bộ đồ mặc nhà nữ lanh (tole) Vicci BN10 thiết kế tay ngắn xẻ cách điệu phối quần lửng in họa tiết",145000,269000,124000,46
TIKI,thoi-trang-nu,177264017,"Bikini Hai Mảnh Tôn Dáng Dễ Thương AT222 MayHomes Đồ Bơi Nữ Two-Piece Swimwear",235600,248000,12400,5
TIKI,thoi-trang-nu,56263154,"Áo Tắm Một Mảnh Carô AT1O5 MayHomes Bikini Một Mảnh Váy Xòe",144000,165000,21000,13
TIKI,thoi-trang-nu,112764875,"ĐAI NỊT BỤNG (GEN SIẾT GIẢM EO) GILE LATEX THÔNG HƠI HI LẠP DÀI 29cm (giải pháp giành cho những bạn có nhiều mỡ lưng)",330000,330000,0,0
TIKI,thoi-trang-nu,56343693,"Đầm Hoa Dễ Thương Phong Cách Retro DN077 MayHomes, Thời Trang, Dịu Dàng",137000,165000,28000,17
TIKI,thoi-trang-nu,121244310,"Áo polo nữ màu xanh biển nhạt phối viền chìm ADINO vải cotton polyester mềm dáng slimfit công sở hơi ôm trẻ trung APN03",159000,318000,159000,50
TIKI,thoi-trang-nu,175194995,"Đồ Bơi Nữ Hai Mảnh Dễ Thương Xuân Hè ATO98 MayHomes Pretty Two-Piece Swimwear",150000,175000,25000,14
TIKI,thoi-trang-nu,90655330,"Quần lót G-String Sexy đẹp xuyên thấu",29000,29000,0,0
TIKI,thoi-trang-nu,112764896,"Áo lót corset Liner ( Áo lót mặc trong gen bụng cao cấp chống hằn ngứa)",45000,45000,0,0
TIKI,thoi-trang-nu,177726628,"Đồ Bơi Nữ Một Mảnh Họa Tiết Chú Voi Xinh AT076 MAYHOMES Kiểu Hở Lưng Dây Đan Chéo",150000,175000,25000,14
TIKI,thoi-trang-nu,74039214,"Combo 5 Quần Lót Nữ Thun Lạnh Phối Ren Atuner QL012, Hàng Đẹp, Co Giãn Đàn Hồi Tốt - Hàng Chính Hãng",170000,340000,170000,50
TIKI,thoi-trang-nu,49932590,"Đầm Suông Cho Người Mập Từ 42-83Kg Kiểu Đầm Suông Voan Trung Niên Big SIze  GOTI 3112",259000,259000,0,0
TIKI,thoi-trang-nu,172296304,"Set áo choàng kèm váy ngủ 2 dây gợi cảm VILADY - S109 kiểu tay dài phối ren bo gấu xinh Sexy chất liệu lụa Pháp (lụa latin) cao cấp",325000,500000,175000,35
TIKI,thoi-trang-nu,53118531,"Áo Công Sở Nữ Kiểu Áo Sơ Mi Tay Bo Đơn Giản GOTI 3119",199000,199000,0,0
TIKI,thoi-trang-nu,105650039,"Áo Lót Có Gọng Viền Đen Nâng Ngực Lorechic BRNC61",199000,199000,0,0
TIKI,thoi-trang-nu,183560785,"Đầm sơ mi linen nữ form suông, dáng dài phong cách vitage ARCTIC HUNTER AH75",249000,249000,0,0
TIKI,thoi-trang-nu,144191819,"Áo lót nữ cotton không gọng đệm mỏng cao cấp, áo bra nữ sinh chất mềm mại thoáng mát",120000,120000,0,0
TIKI,thoi-trang-nu,52582123,"COMBO 10 QUẦN BÔNG ÉP CAO CẤP 028",220000,220000,0,0
TIKI,thoi-trang-nu,68119208,"Sét Đồ Bộ Nữ Thời Trang",143100,159000,15900,10
TIKI,thoi-trang-nu,125021416,"(HÀNG SẴN) Đầm Trung Niên Phối Tay Ren Sang Trọng VH58 - Hàng Quảng Châu Cao Cấp",295000,295000,0,0
TIKI,thoi-trang-nu,52288502,"Quần ống sớ, quần nữ dáng suông ống rộng khóa sườn Haint Boutique Qt19",159000,159000,0,0
TIKI,thoi-trang-nu,174843854,"Áo thun Teeworld Saigon Traffic T-shirt Trắng Đen Form Rộng Unisex Nam Nữ",339000,339000,0,0
TIKI,thoi-trang-nu,68537466,"Áo kiểu tay dài phối nút hoạ tiết kẻ sọc cho phái nữ",159000,159000,0,0
TIKI,thoi-trang-nu,55320846,"Áo Ngực Áo Lót Không Gọng Thoải Mái Đệm Mỏng LOIRECHIC BRFC13",189000,189000,0,0
TIKI,thoi-trang-nu,57982432,"Quần Lót Nữ Xuyên Thấu Co Dãn Siêu Mỏng - Quần Lót Nữ Không May Viền Thoáng Mát Không Lộ Viền Quần",25000,25000,0,0
TIKI,thoi-trang-nu,33610039,"Áo khoác thun da cá GOKING 6 túi, form unisex cho nữ nam, trẻ em. Chống lạnh, giữ ấm, chống nắng, chống tia UV. Hàng hiệu Việt Nam xuất khẩu",281000,281000,0,0
TIKI,thoi-trang-nu,166389351,"Đồ Bộ Nữ, Đồ Bộ Nữ Mặc Nhà, Đồ Bộ Nữ Thun Cotton Hình Gấu Siêu Sang, Đồ Bộ Ngủ Nữ, Đồ Bộ Nữ Dài, Đồ Ngủ Nữ Thoáng Mát Thương Hiệu Baw MN10 ( hình thật shop tự chụp)",99000,169000,70000,41
TIKI,thoi-trang-nu,84471450,"Áo khoác hoodie Chống Rét 123SHOP Cho Nam nữ Cho Cặp Đôi in hình Tàu vũ trụ Chất Nỉ Unisex  Form rộng Có 2 Màu Ulzzang",100000,100000,0,0
TIKI,thoi-trang-nu,148640368,"Áo lót bầu- áo lót cho con bú chống chảy xệ mặc bầu và sau sinh AL06",66000,66000,0,0
TIKI,thoi-trang-nu,125802234,"Áo Sweater tay dài gấu hello starry SKY from rộng quảng châu, ÁO Hoodie HELLO unisex ulzzang, Áo Nỉ Sweater Gấu Hello Siêu Xinh Áo Nỉ Dáng Rộng Hot Hit",99000,99000,0,0
TIKI,thoi-trang-nu,100757017,"Quần Lót Nữ Ren Cạp Vừa Luperi SP730 Dáng Bikini Mềm Mịn, Co Giãn, Không Lằn Mông, Kháng Khuẩn, Khử Mùi Tốt",66000,66000,0,0
TIKI,thoi-trang-nu,31597593,"Siêu giảm giá. Áo thun nữ thoát nhiệt Nhật Bản Goking, form ôm eo, chất liệu tự nhiên 100% cotton thấm hút mồ hôi tốt. Áo phông trơn nữ hàng hiệu cao cấp",99000,99000,0,0
TIKI,thoi-trang-nu,107335982,"Áo Hoodie Nỉ Bông Rubso - Form rộng Unisex Nam Nữ Couple cực xinh cho cặp đôi",110000,110000,0,0
TIKI,thoi-trang-nu,146225246,"Áo polo nữ ADINO màu đen phối viền xẻ lai vải cotton co giãn dáng slimfit trẻ trung APN02",139000,278000,139000,50
TIKI,thoi-trang-nu,109137576,"Combo 3 quần lót nữ bikini phối ren iBasic V122",175000,207000,32000,15
TIKI,thoi-trang-nu,109916319,"Quần Lót Lụa Sữa Phối Ren Phong Cách Nhật Bản Mới Mát Lạnh Cho Mua Hè (WL47)",45000,45000,0,0
TIKI,thoi-trang-nu,72295267,"Áo Lót Không Gọng LOIRECHIC BRTS33 Đệm Mỏng Nâng Ngực Push-up",325000,325000,0,0
TIKI,thoi-trang-nu,105651090,"Quần Ghen Nịt Bụng, Quần Gen Nịt Bụng Dưới Móc Cài Tùy Điều Chỉnh, Quần Ghen Cạp Cao Giảm Eo Và Mỡ Bụng Sau Sinh QG1",109000,189000,80000,42
TIKI,thoi-trang-nu,108243342,"Quần lót nữ không đường may iBasic V109",114000,159000,45000,28
TIKI,thoi-trang-nu,72938904,"ÁO NGỰC BIG SIZE MỎNG REN HOA HỒNG 3011",82000,88000,6000,7
TIKI,thoi-trang-nu,85904779,"Quần lót lọt khe nữ C56 – Quần lọt khe ren sexy - Quần chíp ren sexy - Quần lót lọt khe nữ sexy - Quần lót nữ xẻ dáy",31200,31200,0,0
TIKI,thoi-trang-nu,106944933,"Áo ngực/ bra, croptop thể thao phối ren hoa có đệm mút LYEA017",111000,119000,8000,7
TIKI,thoi-trang-nu,167529638,"Áo Khoác Nỉ Hoodie Sunday Knn04 Cotton Unisex Nam Nữ Đều Mặc Được Thích Hợp Đi Học, Đi Làm, Đi Chơi",105000,105000,0,0
TIKI,thoi-trang-nu,105656761,"Quần Lót Nữ, Quần Gen Nịt Bụng Eo Thon, Quần Ghen Cạp Cao Giảm Eo Và Mỡ Bụng Sau Sinh QG2",99000,129000,30000,23
TIKI,thoi-trang-nu,85184191,"Đồ bơi nữ dài tay, chân váy may liền quần sooc đùi kín đáo, size từ 43 đến 68kg, chất thun bơi cao cấp dày đẹp | KT025",450000,450000,0,0
TIKI,thoi-trang-nu,130883910,"Áo trễ vai bánh bèo tiểu thư, áo trắng trần trễ vai",69000,69000,0,0
TIKI,thoi-trang-nu,114055937,"Đồ mặc nhà nữ dạng đùi tay lỡ in hình thỏ hồng dơ tay dễ thương, Đồ bộ mặc nhà cao cấp quần đùi cực dễ thương",106000,106000,0,0
TIKI,thoi-trang-nu,105637918,"Áo Lót Có Gọng Đệm Dày Push up  Loirechic BRNC60",199000,199000,0,0
TIKI,thoi-trang-nu,3267183,"Váy ngủ sexy ren",109000,109000,0,0
TIKI,thoi-trang-nu,117762251,"quần ống rộng nữ ,quần ống rộng culottes dáng dài khóa sườn chất vải co giãn",85000,85000,0,0
TIKI,thoi-trang-nu,63206983,"Đồ ngủ cosplay hồ ly gợi cảm",125000,125000,0,0
TIKI,thoi-trang-nu,68778242,"Đầm Váy Trung Niên Dáng Dài Dạng Đầm Suông Phối 3 Nút In Hoa - Thời Trang Trung Niên Nữ GOTI 3288D",311000,311000,0,0
TIKI,thoi-trang-nu,89579707,"Quần ống rộng vải công sở dày đẹp QT23",179000,179000,0,0
TIKI,thoi-trang-nu,114538960,"Đầm body khoét ngực dây rút 2 bên hông chất zip cotton cá tính",89000,89000,0,0
TIKI,thoi-trang-nu,51033605,"Combo 3 Chiếc Quần Lót Nữ Thời Trang Không Đường May iBasic V188, Mềm Mịn, Thoáng Mát - Hàng Chính Hãng",199000,207000,8000,4
TIKI,thoi-trang-nu,179413944,"Áo trung niên nữ cổ tròn thêu họa tiết tay áo, chất đũi mát mịn (SP19)",159000,159000,0,0
TIKI,thoi-trang-nu,100744712,"Quần Lót Nữ Cotton Nhập Khẩu Cạp Vừa Luperi SP729 Dáng Bikini Mềm Mịn, Co Giãn, Không Lằn Mông, Kháng Khuẩn, Khử Mùi Tốt",52000,52000,0,0
TIKI,thoi-trang-nu,172026400,"Đồ bộ pyjama nữ, đồ mặc nhà cao cấp VILADY - B103 kiểu cổ V tay dài quần dài họa tiết chấm Bi màu hồng, chất liệu lụa Pháp ( lụa latin) siêu mát",363000,550000,187000,34
TIKI,thoi-trang-nu,108262830,"Combo 2 quần lót  ren xuyên thấu, cột dây, đính hoa phía trước gợi cảm LYEQ030( màu ngẫu nhiên)",73000,78000,5000,6
TIKI,thoi-trang-nu,111924833,"Chân váy chữ A lưng cao chất liệu kaki phong cách hàn quốc cá tính",89000,89000,0,0
TIKI,thoi-trang-nu,96132235,"COMBO 5 QUẦN THUN LẠNH PHỐI REN DÂY EO 1712",140000,150000,10000,7
TIKI,thoi-trang-nu,74301197,"Quần Lót Nữ Lọt Khe Sexy Melange Cao Cấp Có Sườn Active Miley Lingerie FMS-57",49000,110000,61000,55
TIKI,thoi-trang-nu,127583939,"Áo thun Polo trơn nữ có cổ Phúc An 4054 có size lớn (big size)",120000,120000,0,0
TIKI,thoi-trang-nu,171069929,"Chân váy xòe lưới 3 lớp cá tính phong cách nữ mặc cùng mọi kiểu áo WhiteAnt 110333",785000,785000,0,0
TIKI,thoi-trang-nu,107038159,"ĐỒ LAM ĐI CHÙA # ĐỒ ĐI CHÙA # PHÁP PHỤC PHẬT GIÁO # chéo nhật viền to s11",189000,189000,0,0
TIKI,thoi-trang-nu,113238546,"áo blazer nữ áo vest nữ dáng suông rộng chất vải cao cấp kiểu hàn quốc",155000,155000,0,0
TIKI,thoi-trang-nu,180247331,"Đầm suông nữ Đũi Việt dáng dài 2 túi sườn, đầm form rộng cổ sơ mi phong cách cá tính thời trang thương hiệu chính hãng DV61",299000,299000,0,0
TIKI,thoi-trang-nu,182707555,"ĐẦM XÒE HOA NHÍ NHÚN NGỰC PHỐI 3 HẠT NGỌC – DAM 0021",225000,395000,170000,43
TIKI,thoi-trang-nu,52059428,"Sét 10 quần lót nữ BIG SIZE Thun cotton Cạp cao ren trước Hàng Việt Nam(Từ 60kg đến 100kg)",232000,232000,0,0
TIKI,thoi-trang-nu,138754619,"Áo Thun Nữ Cổ Tim Tay ngắn , Trẻ Trung, Mẫu Mới nhất",89000,99000,10000,10
TIKI,thoi-trang-nu,71311806,"Gen Nịt Bụng Siêu Đốt Mỡ - Đai Nịt Bụng Sau Sinh Lấy Lại Vóc Dáng Nhanh Chóng",326000,350000,24000,7
TIKI,thoi-trang-nu,185920551,"Váy sơ mi nữ dáng dài chất liệu đũi mềm mát, thời trang hè nữ ARCTIC HUNTER AH162",299000,299000,0,0
TIKI,thoi-trang-nu,145289718,"Chân váy công sở NEW DESIGN dáng midi dài qua gối sang trọng vải kaki thun co giãn",179000,299000,120000,40
TIKI,thoi-trang-nu,10679661,"Đầm suông cổ sơ mi Haint Boutique",199000,199000,0,0
TIKI,thoi-trang-nu,72294646,"Áo Ngực Ren Không Gọng LOIRECHIC BRR29 Đệm Mỏng  FREESIZE",179000,179000,0,0
TIKI,thoi-trang-nu,139603365,"Áo Sơ Mi Tay Dài Nữ Giordano 05340038",498000,940000,442000,47
TIKI,thoi-trang-nu,104105147,"Áo Khoác Hoodie nữ Tai gấu SmileZ Dáng Unisex Form Rộng chất nỉ bông chống nắng tốt",101000,101000,0,0
TIKI,thoi-trang-nu,75444931,"Set Đồ Bơi Ba Chi Tiết Đồ Bơi Nữ Tay Dài Quần Dài Màu Hồng Đen Chủ Đạo AT205 MayHomes Black-Pink Colored Long Sleeves And Long Pants Women Swimwear Set, UPF 50 Sun Protection",379050,399000,19950,5
TIKI,thoi-trang-nu,174491299,"Váy ngủ bodysuit ren thắt nơ sexy BT0107 -  Bộ Đồ Ngủ Liền Thân Bodysuit - Đầm bodysuit - Đồ ngủ mặc nhà",99000,190000,91000,48
TIKI,thoi-trang-nu,101773748,"Đầm khiêu vũ siêu đẹp, váy nhảy Zumba cho vũ đoàn, nhảy Latin hiện đại M2908",290000,290000,0,0
TIKI,thoi-trang-nu,166463225,"Đồng phục đoàn viên thanh niên Việt Nam dành cho nữ có chiết 4 ben eo, tay dài và tay ngắn, thêu logo cờ đỏ sao vàng",126000,194000,68000,35
TIKI,thoi-trang-nu,168469880,"Váy ngủ nữ hai dây ren xẻ sau Q27 - Đầm ngủ hai dây sexy - Đồ ngủ hai dây gợi cảm",99000,140000,41000,29
TIKI,thoi-trang-nu,84119526,"Quần lót cotton XXL (Combo 5 cái) mặc 1 lần ,có thể giặt tái sử dụng, dùng du lịch, mẹ sau sinh hoặc trong những ngày ấy",31000,31000,0,0
TIKI,thoi-trang-nu,98157717,"Áo khoác dù 2 lớp chống nắng form rộng áo khoác đôi nam nữ Unisex đẳng cấp KMG",94000,94000,0,0
TIKI,thoi-trang-nu,192712266,"YU CHERRY | Áo nữ hai dây thiết kế như cánh hồng nở rộ Rosie Cami Top YA388",255000,255000,0,0
TIKI,thoi-trang-nu,74903756,"Váy lụa ren ngực 2 dây Quảng Châu cao cấp",139000,139000,0,0
TIKI,thoi-trang-nu,155390408,"Bikini Đồ bơi nữ có tay khóa kéo màu ĐEN FORM SHORT sành điệu kín đáo co dãn thoải mái",179000,179000,0,0
TIKI,thoi-trang-nu,195515821,"Đầm Cổ V Nút Ngọc Tay Dài màu Kem Thơ Nhẹ Nhàng",300000,300000,0,0
TIKI,thoi-trang-nu,83034305,"Quần Gen Cạp Cao Nịt Bụng Satin",195000,195000,0,0
TIKI,thoi-trang-nu,193044495,"Váy ngủ ôm body phối nơ kèm mũ sexy P22 - Đầm ngủ nữ quyến rũ - Đồ ngủ mặc nhà",179000,290000,111000,38
TIKI,thoi-trang-nu,119285154,"Combo 3 áo lót học sinh không mút phối ren iBasic VA107",415000,477000,62000,13
TIKI,thoi-trang-nu,113056751,"quần nữ đùi  quần short giả váy chất đũi 3 màu năng động",62000,62000,0,0
TIKI,thoi-trang-nu,179412146,"Đồ bộ trung niên nữ - Bộ trung niên cho bà,cho mẹ,chất đũi mát mịn,full size đến 90kg - Mã T43",255000,255000,0,0
TIKI,thoi-trang-nu,91314380," Quần culottes dáng dài siêu hách chân dài 97cm Quần ống suônh dáng rộng",85000,85000,0,0
TIKI,thoi-trang-nu,138490937,"Áo khoác cardigan nữ nỉ bông hàng quảng châu siêu đẹp in 3D khoác chống nắng 3D CDG CHỮ FULL - CANDA 3440",93000,93000,0,0
TIKI,thoi-trang-nu,73529278,"Áo Lót Mút Mỏng Bản Dây Áo Lớn Phù Hợp Người Ngực To Màu Trơn Perfect Bra by Sabina SBD4100",179000,560000,381000,68
TIKI,thoi-trang-nu,101302058,"Bộ đồ nữ mặc nhà trung niên cho các bà, các mẹ - Bộ đồ ngủ lanh (tole) - Bộ mặc nhà trung niên vải lanh (tole) Vicci BGD.082 áo cộc tay phối quần dài in hoạ tiết",180000,309000,129000,42
TIKI,thoi-trang-nu,121245030,"Áo polo nữ màu xanh bích đậm phối viền chìm ADINO vải cotton polyester mềm dáng slimfit công sở hơi ôm trẻ trung APN03",159000,318000,159000,50
TIKI,thoi-trang-nu,124689783,"Áo Khoác Nữ Form Rộng Thêu Vải Nhung Gân Phong Cách",160000,160000,0,0
TIKI,thoi-trang-nu,66711697,"Áo Len Nữ Kiểu Choàng Vai Mẫu Mới Korea ALN034 MayHomes Thời Trang Bốn Mùa",191350,215000,23650,11
TIKI,thoi-trang-nu,118030200,"Đồ Lam Đi Chùa # Tim Phối # Đồ Bộ Nữ Mẹ Và Bé # Quần Áo Bé Gái",100000,100000,0,0
TIKI,thoi-trang-nu,59469216,"Quần Đùi Lót Nữ Mặc Trong Chân Váy Dài 25.5cm Miley Lingerie - Màu Đen FDS0106",60000,69000,9000,13
TIKI,thoi-trang-nu,47117757,"Áo len nữ thời trang chất co dãn dày dặn",149000,149000,0,0
TIKI,thoi-trang-nu,97809494,"Đồ bộ mặc ở nhà nữ - đồ bộ lửng nữ quần đen áo màu in hình hoa cúc siêu hot thun cotton loại 1 mát mịn size từ 40-63kg",99000,99000,0,0
TIKI,thoi-trang-nu,65794821,"COMBO 5 QUẦN THUN TRƠN NHIỀU SIZE 073",102000,115000,13000,11
TIKI,thoi-trang-nu,110868416,"Quần ống rộng quần ống suông culottes cúc khoá chun lưng dáng lửng kiểu Nhật",52000,52000,0,0
TIKI,thoi-trang-nu,101092925,"Đai nịt bụng chuẩn Hy Lạp - Gen định hình latex eo thon",245000,245000,0,0
TIKI,thoi-trang-nu,115343478,"Quần lót nữ, quần chíp nữ phối ren",11603,11603,0,0
TIKI,thoi-trang-nu,181920231,"Đầm linen nữ thiết kế cổ V có túi, mix phong cách sơ mi thời trang, đầm đũi chất lượng cao AH72",299000,299000,0,0
TIKI,thoi-trang-nu,117400537,"Quần đùi nữ, quần sooc nữ ống rộng chun lưng chất đũi nhiều màu",45000,45000,0,0
TIKI,thoi-trang-nu,190538121,"Đầm ngủ, Váy ngủ lụa Pháp (Lụa Latin) thiết kế 2 dây chéo lưng phối ren cao cấp VILADY - V148 (Màu Đen)",445000,479000,34000,7
TIKI,thoi-trang-nu,73461928,"Áo len nữ cadigan Hàn Quốc có mũ",179000,179000,0,0
TIKI,thoi-trang-nu,192710505,"YU CHERRY | Áo Kimo Baby Top YA399",320000,320000,0,0
TIKI,thoi-trang-nu,59469566,"Quần Đùi Lót Nữ Mặc Trong Chân Váy Dài 32cm Miley Lingerie - Màu Beige FDS0916",75000,150000,75000,50
TIKI,thoi-trang-nu,70211524,"Áo Khoác Nữ Phối 2 Màu Thêu Mèo",89000,89000,0,0
TIKI,thoi-trang-nu,24030500,"Bộ 5 quần lót nữ basic Comfort Modal MILEY LINGERIE - Màu ngẫu nhiên",188000,188000,0,0
TIKI,thoi-trang-nu,193886819,"Váy nhảy khiêu vũ Latin người lớn, đầm khiêu vũ siêu đẹp cho nhóm nhảy vũ đoàn D1821",290000,290000,0,0
TIKI,thoi-trang-nu,179170927,"Đồ bơi nữ tay dài quần dài 3 mảnh",270000,270000,0,0
TIKI,thoi-trang-nu,74344688,"Quần yếm nữ Julido Store, mẫu yếm dài theo xu hướng mới nhất YD01",279000,279000,0,0
TIKI,thoi-trang-nu,117927674,"Quần Tây nữ ống loe chất liệu tuyết mưa dày dặn",80000,80000,0,0
TIKI,thoi-trang-nu,58925155,"Chân váy jean thiết kế ngang gối 06 C001",279000,279000,0,0
TIKI,thoi-trang-nu,185903499,"Áo bra nữ kiểu thể thao dành cho học sinh cấp 1 cấp 2 cấp  3 chất cotton trơn mềm mại thoáng mát có mút mỏng Lá Bralette A27",48000,48000,0,0
TIKI,thoi-trang-nu,185866934,"Bộ quần áo lửng cho mẹ Kem xước - AICDMEZX6PXK - AIN Closet",335000,430000,95000,22
TIKI,thoi-trang-nu,155269928,"Bộ Đồ Ngủ Lụa Basic Dáng Dài Thoải Mái Loirechic LPD06",565000,565000,0,0
TIKI,thoi-trang-nu,84694111,"Quần Lót Ren Lưới Công Chúa Siêu Điệu thương hiệu BAW mã QLN53",149000,223500,74500,33
TIKI,thoi-trang-nu,177189072,"Quần short nữ ống rộng lưng cao đẹp cạp chun sau Q053 Quần ống rổng lửng nữ",50000,50000,0,0
TIKI,thoi-trang-nu,102382933," QUẦN LÓT NỮ,QUẦN LÓT REN THÊU HOA CAO CẤP",35000,38000,3000,8
TIKI,thoi-trang-nu,140212881,"Set áo vest blazer nữ ngắn tay 2 túi hàng thiết kế cao cấp - SV04 - WFstudios",476000,476000,0,0
TIKI,thoi-trang-nu,11876096,"Đầm suông dự tiệc bigsize kiểu đầm suông cho người mập từ 42-85Kg phối voan kim sa màu Đen, Xanh, Đỏ Đô GOTI373",299000,299000,0,0
TIKI,thoi-trang-nu,188574732,"Áo Thun Trơn Couple TX Cổ Tròn Basic Nữ  WTS 2132",139000,139000,0,0
TIKI,thoi-trang-nu,171439414,"Combo 2 quần lót nữ, quần lọt khe, quần lót tam giác ren xuyên thấu, dây mảnh ngang hông đính nơ quyến rũ và gợi cảm ( màu ngẫu nhiên) LYEQ050",54000,58000,4000,7
TIKI,thoi-trang-nu,118029433,"ĐỒ LAM ĐI CHÙA # Thun Bà Lai# Đồ Bộ Nữ # Quần Áo # Trung Niên# Nhiều Màu# Big Size",194000,194000,0,0
TIKI,thoi-trang-nu,56671497,"Váy ngủ lụa ren 2 dây sexy gợi cảm",177000,177000,0,0
TIKI,thoi-trang-nu,173206437,"Quần ống rộng Hiền Trần BOUTIQUE lưng cạp cao 2 cúc baggy vải nữ dài suông loe culottes màu đen",213000,350000,137000,39
TIKI,thoi-trang-nu,104792309,"Quần lót siêu khủng Thái lan Big size, chất thun lạnh  776",38000,38000,0,0
TIKI,thoi-trang-nu,146520912,"Váy khiêu vũ tua rua 3 tầng bằng một màu nhảy Latin siêu đẹp",160000,160000,0,0
TIKI,thoi-trang-nu,185004501,"Bộ quần áo lửng cho mẹ Tím Lavender đũi xước - AICDMEQ5RT5K - AIN Closet",310000,430000,120000,28
TIKI,thoi-trang-nu,67437925,"Đầm dây trắng đan eo Phoebe Dress Gem Clothing SP006188",520000,520000,0,0
TIKI,thoi-trang-nu,84822062,"Áo Lót Quây Không Dây Cài Trước Nâng Ngực Chống Tụt Kèm Đệm Hơi B439",276000,276000,0,0
TIKI,thoi-trang-nu,79592543,"Áo ngực cotton/bra không gọng nâng đẩy nhẹ nhàng mang lại cảm giác thoải mái, dễ chịu LYEA010",92000,99000,7000,7
TIKI,thoi-trang-nu,134388442,"Áo Khoác Bomber Nỉ Bông Jemcloset Ray Tay Dài Form Rộng Unisex Nam Nữ Ulzzang KUN",100000,100000,0,0
TIKI,thoi-trang-nu,47420560,"Váy Ngủ Sexy Gợi Cảm Voan Mỏng Trong Suốt",122000,122000,0,0
TIKI,thoi-trang-nu,103431559,"Quần ống rộng nữ 1 cúc trước chất tuyết mưa nhiều màu tự nhiên",85000,85000,0,0
TIKI,thoi-trang-nu,108916840,"Áo Lót Không Gọng Mút Mỏng Vừa Cup Ngang Dây Lưng Không Viền May Màu Trơn Pretty Perfect By Sabina SBU8014",159000,579000,420000,73
TIKI,thoi-trang-nu,130997641,"Áo cardigan len nữ Hàn Quốc dáng ngắn, cổ chữ V, chất len dày dặn",169000,169000,0,0
TIKI,thoi-trang-nu,185004855,"Đầm cho mẹ họa tiết Cherry nhì đỏ organza ánh nhũ - AICDMEB3OG6W - AIN Closet",355000,440000,85000,19
TIKI,thoi-trang-nu,104792372,"Đồ lót Thái | Áo ngực có gọng, không có mút - Áo lót thái lan Siterhood #10030",83000,89000,6000,7
TIKI,thoi-trang-nu,105378804,"Quần Lót Nữ, Bộ 5 Quần Lót Nữ Su Phối Ren Cao Cấp Mềm Mịn, Quần Lót Nữ Kháng Khuẩn, Quần Lót Nữ Co Dãn Tốt Thoáng Mát Thương Hiệu Baw Mã QLN0302",199000,199000,0,0
TIKI,thoi-trang-nu,110900538,"Quần ống rộng nữ cạp khóa chất tuyết mưa quần tây ống rộng khuy trước cạp cao Banamo Fashion 933",103000,103000,0,0
TIKI,thoi-trang-nu,114974220,"áo thun nữ - áo phông cộc tay phom rộng in số 11 phong cách hàn quốc",65000,65000,0,0
TIKI,thoi-trang-nu,74539232,"Áo Lót Mút Vừa Nâng Ngực Chỉnh 7 Kiểu Dây Soft Doomm 7 Ways Màu Da Hoặc Màu Đen By Sabina SBH4004",159000,579000,420000,73
TIKI,thoi-trang-nu,85373011,"Áo Khoác Bomber Unisex Chất Nhung Tăm Tay Bo Chun Form Rộng Phối 2 Màu Thêu Deep End Nam Nữ Ulzzang, Labibi",162000,162000,0,0
TIKI,thoi-trang-nu,77118687,"Combo 2 Quần Lót Nữ Lọt Khe( màu ngẫu nhiên) Không Đường May Phối Ren Sexy LYEQ007",72000,77500,5500,7
TIKI,thoi-trang-nu,150567768,"Bikini dài tay 2 mảnh QUEEN BIKINI, Đồ bơi nữ Quảng Châu kín đáo BIK26",220000,220000,0,0
TIKI,thoi-trang-nu,58056905,"Áo Croptop Ngắn Tay Với Thiết Kế Ôm Dáng Gợi Cảm Dành Cho Nữ",52000,52000,0,0
TIKI,thoi-trang-nu,150553681,"Đồ ngủ sexy / Yếm ngủ dập ly không mút ngực, chất liệu phi mềm, kèm quần ren gợi cảm",59000,59000,0,0
TIKI,thoi-trang-nu,87670360," Áo Khoác Nữ Chống Nắng Toàn Thân Thêu Hoa Cúc _ Freeship Xtra",109000,109000,0,0
TIKI,thoi-trang-nu,103875289,"Váy body khoét ngực dây rút bên hông chất cotton",85000,85000,0,0
TIKI,thoi-trang-nu,122759422,"Áo Khoác nỉ Hoodie nữ cute phong cách Hàn Quốc mùa đông 2020 KN4",93000,93000,0,0
TIKI,thoi-trang-nu,178100560,"Quần jean nữ Lưng Cao Julido Store, chất jean co dãn 4 chiều ống ôm chân mẫu Ms504",159000,259000,100000,39
TIKI,thoi-trang-nu,183920274,"Áo khoác nam nữ Hoodie nỉ trơn Basic in chữ màu form rộng tay bồng khóa kéo có mũ Ulzzang giá rẻ couple",98000,98000,0,0
TIKI,thoi-trang-nu,84826692," Quần Lót Siêu Mềm Mịn Cao Cấp P041",60000,60000,0,0
TIKI,thoi-trang-nu,87670832," Áo Khoác Nữ Chống Nắng Cao Cấp 6 Túi Viền Sọc Caro",164000,164000,0,0
TIKI,thoi-trang-nu,146635396,"Áo sơ mi nữ phom rộng dài tay, chất liệu Đũi tơ mềm mịn, sơ mi nữ kiểu tà lệch NeSa Shop SMH.31",139000,229000,90000,39
TIKI,thoi-trang-nu,165206619,"Áo Ngực Nữ, Áo Bra Trắng Học Sinh Cotton Có Đệm Mặc Thoáng Mát Thương Hiêu BAW mã AHS1",59000,59000,0,0
TIKI,thoi-trang-nu,131417895,"áo kiểu nữ - chất liệu đũi xước tơ phù hợp cho mọi lứa tuổi đến dưới 85kg (A25)",149000,149000,0,0
TIKI,thoi-trang-nu,73825077,"Gen bắp tay lưng & nách Aó định hình sau hút mỡ cánh tay Aó gen vai cánh tay áo nịt bắp tay",550000,550000,0,0
TIKI,thoi-trang-nu,103358990,"Quần chíp sexy Quần lót ren nữ C52 siêu gợi cảm xuyên thấu",32000,32000,0,0
TIKI,thoi-trang-nu,186862741,"Quần đùi cho mẹ Đen chéo Hàn - AICDMEIEXNEP - AIN Closet",205000,260000,55000,21
TIKI,thoi-trang-nu,100373912,"Quần lót độn mông chất su thông thoáng cạp cao che bụng - M",70000,140000,70000,50
TIKI,thoi-trang-nu,164272245,"Quần lót nữ gel bụng cao cấp LUPERI SP109 cạp cao nâng mông hiệu quả co giãn đa chiều khử mùi",99000,99000,0,0
TIKI,thoi-trang-nu,179211210,"Áo sơ mi nữ Hiền Trần BOUTIQUE dài tay form rộng kiểu sơmi màu trắng xanh thời trang công sở đi học",181000,299000,118000,39
TIKI,thoi-trang-nu,57003788," Đầm Xoè Hoa Cúc Nổi Cổ Bèo Dễ Thương",240000,240000,0,0
TIKI,thoi-trang-nu,111874366,"Chân váy nữ chữ a ngắn xẻ trước kèm quần trong vải tuyết mưa",70000,70000,0,0
TIKI,thoi-trang-nu,122349416,"Quần Lửng Nữ Giordano Khaki Capri 05420256",419000,540000,121000,22
TIKI,thoi-trang-nu,84824090," Quần Lót Cạp Cao Chất Lạnh Không Lộ Viền P365",69000,69000,0,0
TIKI,thoi-trang-nu,128676322,"combo 5 Quần lót cạp cao gen bụng nâng mông _kháng khuẩn hàng xuất nhật",111000,111000,0,0
TIKI,thoi-trang-nu,43872772,"Quần lót lọt khe buộc dây - trắng",29000,29000,0,0
TIKI,thoi-trang-nu,16294671,"Combo 10 Quần Lót Nữ  Cotton Nhật Lưng Cao",255000,255000,0,0
TIKI,thoi-trang-nu,125244396,"QUẦN ÁO DÀI - Q01",140000,140000,0,0
TIKI,thoi-trang-nu,97998034,"BỘ MẶC NHÀ HÌNH TRÁI CÂY - BỘ NGỦ HỌA TIẾT HOA QUẢ, BỘ NGỦ NGẮN TAY HÌNH TRÁI BƠ MẶC MÙA HÈ, Bộ đồ ngủ thun nam nữ cộc tay QUẢ BƠ, đồ bộ in trái bơ,  bộ đồ quả bơ, ĐỒ BỘ MẶC NHÀ FORM RỘNG / BỘ QUẦN ÁO NỮ / ĐỒ BỘ NỮ THUN COTTON",99000,99000,0,0
TIKI,thoi-trang-nu,66444265,"Keo Dán Ngực Vải Nude Chống Nước Tomboy SB Trans",80000,80000,0,0
TIKI,thoi-trang-nu,179526492,"Quần jean nữ Lưng Cao Julido Store, chất jean co dãn 4 chiều ống ôm chân mẫu Ms615",159000,259000,100000,39
TIKI,thoi-trang-nu,145081215,"Áo khoác bomber unisex CLOSET , áo khoác nỉ thu đông nam nữ phối tàn lạ mắt",95000,95000,0,0
TIKI,thoi-trang-nu,74539336,"Áo Sơ Mi Nữ Trơn Dài Tay Cổ Trắng Mẫu JD698 Thời Trang Công Sở Trẻ Trung, Thanh Lịch",163000,163000,0,0
TIKI,thoi-trang-nu,74643137,"Áo Khoác Cánh Dơi Form Rộng Unisex Nam Nữ Kiểu Trơn Khóa Tròn Có Dây Rút Tone Màu Pastel Nhẹ Nhàng Nhiều Lựa Chọn",92000,92000,0,0
TIKI,thoi-trang-nu,190539181,"Bộ Đồ Pijama Nữ, đồ bộ Mặc Nhà Quần đùi tay cộc VILADY B153 Chất liệu Lụa Pháp (Lụa Latin) cao cấp Họa tiết lạ mắt",419000,450000,31000,7
TIKI,thoi-trang-nu,130875010,"Đầm nữ body len rút dây hông, váy len body cổ tròn sát nách màu nâu lạ mắt",92000,92000,0,0
TIKI,thoi-trang-nu,167951534,"Bộ ngủ sexy quyến rũ có mút ngực mã 5",54000,54000,0,0
TIKI,thoi-trang-nu,118030268,"Đồ Mặc Đi Chùa # La Hán Tăng # Đồ Thầy",324000,324000,0,0
TIKI,thoi-trang-nu,118024542,"Đồ Lam Đi Chùa # Cổ Tàu # Quần Áo Nữ # Đồ Bộ Nữ",187000,187000,0,0
TIKI,thoi-trang-nu,84471313,"Áo khoác hoodie Chống Rét Cho Nam nữ Cho Cặp Đôi in hình WIND Chất Nỉ Unisex  Form rộng Có 4 Màu Ulzzang",99000,99000,0,0
TIKI,thoi-trang-nu,107443703,"Quần áo dài nữ ống suông chất liệu phi bóng",70000,70000,0,0
TIKI,thoi-trang-nu,171556670,"Quần Jean Nữ, Quần Jean Nữ Lưng Cao, Quần Jean Nữ Siêu Hack Dáng thương hiệu Chandi, Jean Nữ co dãn tôn dáng phụ nữ eo thon mẫu KVK609",159000,250000,91000,36
TIKI,thoi-trang-nu,97579700,"Đồ Ngủ Hai Dây Phối Ren Sexy Quyến Rũ Có Mút Ngực Thương Hiệu Baw, Chất Liệu Lụa Satin Mát Mịn DN2 (hình thật shop tự chụp)",89000,169000,80000,47
TIKI,thoi-trang-nu,179420557,"Áo vest khoác ngoài phong cách hàn quốc có size tới 85kg ( mã SP11)",192000,192000,0,0
TIKI,thoi-trang-nu,193887098,"Đầm khiêu vũ, váy nhảy Latin cho vũ đoàn, trang phục nhóm nhảy M2801",290000,290000,0,0
TIKI,thoi-trang-nu,101949462,"Combo 10quần 10màu siêu sốc",140000,140000,0,0
TIKI,thoi-trang-nu,172175772,"Váy ngủ lụa hai dây sexy gợi cảm Q131 - Đầm ngủ nử - Đồ ngủ mặc nhà - Váy ngủ lụa cao cấp",149000,240000,91000,38
TIKI,thoi-trang-nu,121237116,"Quần lót lọt khe hở đáy gợi cảm cho nữ",35000,35000,0,0
TIKI,thoi-trang-nu,197529282,"Áo hoodie nam nữ, áo nỉ hoodie hót nhất 2023, Áo Khoác Hoodie agob  Áo Hoodie Zip Nam Nữ Form Rộng Nỉ Có Dây Kéo Trắng Đen Xám Xanh Lá Local Brand Cặp Đôi, áo hoodie A glimpse of beauty màu xanh hot trend",100000,100000,0,0
TIKI,thoi-trang-nu,87623305,"Áo Lót Mút Vừa Nâng Ngực Không Gọng Phối Ren Habpy Lady By Sabina HBXLP0002",159000,383000,224000,58
TIKI,thoi-trang-nu,56333616,"Áo đũi lụa sát nách Vicci cao cấp nhiều màu",75000,149000,74000,50
TIKI,thoi-trang-nu,103431852,"Quần baggy cạp cao chuẩn mốt cực tôn dáng, quần ống rộng chất vải dày mịn cần sắm gấp - video shop tự quay",89000,89000,0,0
TIKI,thoi-trang-nu,84821027," Quần Lót Nữ Dạng Quần Đùi Chất Băng Lụa Kháng Khuẩn P345",50000,50000,0,0
TIKI,thoi-trang-nu,102097129,"Áo lót trơn gọng đệm dày nâng ngực cúp quả xoài truyền thống",110000,110000,0,0
TIKI,thoi-trang-nu,72900314,"Áo Khoác Jean Nữ Trơn Màu Xanh Đậm Nhạt Aaa Jeans",699000,699000,0,0
TIKI,thoi-trang-nu,91250025,"Áo khoác hoodie nam nữ Banawa dáng unisex form rộng có dây kéo chất nỉ bông chống nắng tốt",102000,102000,0,0
TIKI,thoi-trang-nu,103918488,"Áo sơ mi nữ công sở cơ bản Hb13",159000,159000,0,0
TIKI,thoi-trang-nu,67437773,"Đầm dây xanh dương Thaw Dress Gem Clothing SP001103",510000,510000,0,0
TIKI,thoi-trang-nu,73509325,"Quần lót nữ lọt khe bướm sexy - Tím",25000,25000,0,0
TIKI,thoi-trang-nu,192812015,"YU CHERRY | Đầm Cami Long Dress YD125",420000,420000,0,0
TIKI,thoi-trang-nu,140922222,"Áo Hoodie TIẾNG NHẬT Form rộng Unisex Nam Nữ Couple Chất Nỉ Bông Mịn In Đẹp Không Phai Tróc,  Áo Hoodie Dáng Rộng In Chữ Phong Cách Harajuku Nhật Bản",100000,100000,0,0
TIKI,thoi-trang-nu,108364902,"Áo Khoác Cardigan Hàn Quốc Thêu Sắc Nét -Chất NỈ Ngoại Form Unisex Nam Nữ Mặc Cặp thoitrangsihienlinh",90000,90000,0,0
TIKI,thoi-trang-nu,110964563,"áo sơ mi nữ dài tay vạt tôm chất đũi kiểu hàn xinh xắn",90000,90000,0,0
TIKI,thoi-trang-nu,73753528,"Áo khoác chống nắng nữ có nón thời trang",356000,356000,0,0
TIKI,thoi-trang-nu,73421344,"Bộ đồ lót lọt khe ren quyến rũ Sexy hở đáy",39000,39000,0,0
TIKI,thoi-trang-nu,114434261,"Áo Khoác nỉ Nam Nữ Áo Hoodie Có Dây Kéo - Unisex Khoác Chống Nắng Mặc Cười Cute -THOITRANGSIHIENLINH",107000,107000,0,0
TIKI,thoi-trang-nu,108357238,"Đồ Ngủ Nữ, Đồ Ngủ Nữ Lụa Satin Cổ Yếm Phối Ren Cao Cấp Sexy Quyến Rũ Thương Hiệu Baw, Chất Liệu Lụa Mát Mịn Nhẹ Nhàng Cực Kỳ Lôi Cuốn NT73 (hình thật shop tự chụp)",99000,169000,70000,41
TIKI,thoi-trang-nu,97651871,"Combo 2 quần lót su không viền, lưng cao phối ren sexy( màu ngẫu nhiên) LYEQ012 - M",110000,118000,8000,7
TIKI,thoi-trang-nu,36028190,"Áo Len Nữ Cardigan Áo Khoác Len Kiểu Hàn Quốc Thêu Hoa ALN020 MayHomes Thời Trang Thu Đông",188100,198000,9900,5
TIKI,thoi-trang-nu,189552784,"Chân váy khiêu vũ tua rua 3 tầng nhọn nhảy DanceSport siêu đẹp",165000,165000,0,0
TIKI,thoi-trang-nu,113257265,"Áo thun cờ đỏ sao vàng Việt Nam hàng tốt cao cấp",65000,65000,0,0
TIKI,thoi-trang-nu,58432849,"Bộ bơi nữ áo cộc tay, quần sooc đùi thể thao, đệm tròn dễ mặc, chất thun co giãn, dáng năng động, dấu bụng tốt | KT069",290000,290000,0,0
TIKI,thoi-trang-nu,181692140,"Áo phông nữ Hiền Trần BOUTIQUE cổ vuông cộc tay form đẹp thun trơn co giãn tốt màu đen trắng thời trang basic",176000,230000,54000,23
TIKI,thoi-trang-nu,20911005,"Đồ Bay Nữ Phối Ren",350000,350000,0,0
TIKI,thoi-trang-nu,112851354,"Áo ngực học sinh",28000,31000,3000,10
TIKI,thoi-trang-nu,132133729,"Đồ đi biển nam nữ set nguyên bộ gồm áo thun và quần short có thể mặc gia đình hội nhóm hay cặp đôi DDB46 | DONGPHUCSG",99000,99000,0,0
TIKI,thoi-trang-nu,95059744," Áo khoác nỉ unisex form rộng Nỉ Trơn nam nữ phong cách ulzzang Wind",103000,103000,0,0
TIKI,thoi-trang-nu,109915498,"Quần Lót Lụa Satin Loại 1 Thêu Chữ Love you Gợi Cảm Mềm Mát (WL49)",50000,50000,0,0
TIKI,thoi-trang-nu,113926163,"áo sơ mi nữ áo sơ mi dài tay vạt tôm nhiều màu chất đũi",90000,90000,0,0
TIKI,thoi-trang-nu,127352815,"Áo Hoodie Nam Nữ Nỉ Bông Dày Dặn Hàng QC Áo Khoác Hoodie Nỉ Couple Đôi SWEATER in PHỒNG HAPPY",96000,96000,0,0
TIKI,thoi-trang-nu,1818793,"Áo Ngực Triumph Sloggi ZERO WHU 04-TL - Đen (Size",588000,989000,401000,41
TIKI,thoi-trang-nu,87670369," Áo Khoác Nữ Chống Nắng 3 trong 1 ( miễn ship)",99000,99000,0,0
TIKI,thoi-trang-nu,148000166,"quần ống loe nữ cạp cao dáng dài legging, quần tây ống loe nữ ôm vải mềm lưng chun cá tính",82000,82000,0,0
TIKI,thoi-trang-nu,103358352,"Quần lót nữ nhiều màu C8 -dáng lót lọt khe",32000,32000,0,0
TIKI,thoi-trang-nu,190641779,"ĐẦM CS XANH KHÁNH LINH PHỐI HOA – M015",179000,310000,131000,42
TIKI,thoi-trang-nu,190669492,"ĐẦM SUÔN LINE KHÁNH LINH PHỐI TÚI – M016",229000,410000,181000,44
TIKI,thoi-trang-nu,187659198,"Áo Ngực Không Gọng Chất Liệu Ren Cao Cấp, Áo Lót Bra Ren Mềm Kèm Mút Ngực Mẫu Mới Siêu Đẹp Thương Hiệu Baw Mã ANM14",159000,159000,0,0
TIKI,thoi-trang-nu,179420435,"Áo đũi nữ thêu họa tiết sao - trẻ trung năng động - cổ tàu thích hợp cả đi chơi và đi làm (SP18)",188000,188000,0,0
TIKI,thoi-trang-nu,93088595,"ÁO LÓT NỮ MỎNG CÀI SAU 2 MÓC NHIỀU SIZE 286",28000,31000,3000,10
TIKI,thoi-trang-nu,83616582,"Áo chống nắng toàn thân nữ vải bò Jean 2 lớp dài kín chân - ao chong nang toan than nu vai bo 2 lop",349000,349000,0,0
TIKI,thoi-trang-nu,84822969,"Quần Độn Mông Và Hông Mặc Trong Váy Vải Lưới Thoáng Mát Nâng Mông Định Hình D171",120000,120000,0,0
TIKI,thoi-trang-nu,161466907,"Bộ đồ ngủ họa tiết iBasic HOMY030",139000,299000,160000,54
TIKI,thoi-trang-nu,87216945,"Áo khoác cổ sơ mi kaki nhung oversize",172000,172000,0,0
TIKI,thoi-trang-nu,85668736,"Quần lót lọt khe nữ eo thấp môi quần",29000,29000,0,0
TIKI,thoi-trang-nu,138750305,"Áo phông Nữ Cổ Tim Tay ngắn , Trẻ Trung, Mẫu Mới nhất",89000,99000,10000,10
TIKI,thoi-trang-nu,154414738,"Váy khiêu vũ 3 tầng chéo tua rua nhảy Latin cực đẹp",170000,170000,0,0
TIKI,thoi-trang-nu,104791604,"Quần lót nữ thái lan #828 – Chất thun lạnh - giao màu ngẫu nhiên",26000,32000,6000,19
TIKI,thoi-trang-nu,130655631,"Quần Lót Nữ Xuyên Thấu Siêu Mỏng Không Viền Ren Hoa Quyến Rũ XTRH02 Freesize Dưới 65Kg",25000,25000,0,0
TIKI,thoi-trang-nu,46636436,"Áo Khoác Nữ Thun Lạnh Có Túi Trong Và Tay Xỏ Ngón Phúc An 4034",180000,180000,0,0
TIKI,thoi-trang-nu,191144966,"Bộ đồ bơi  nữ 2 mảnh quần đùi dáng thể thao năng động đi biển, đi bơi dễ vận động và kín đáo V0074",169000,169000,0,0
TIKI,thoi-trang-nu,125021985,"(HÀNG SẴN) Đầm Len Công Sở Trung Niên Lịch Sự AL57 - Hàng Quảng Châu Cao Cấp",289000,289000,0,0
TIKI,thoi-trang-nu,51280939,"Bộ đồ lót ren nâng ngực viền voan sọc",180000,180000,0,0
TIKI,thoi-trang-nu,112073124,"váy suông nữ mùa hè,váy suông sát nách in chữ pore mặc hè thoáng mát",75000,75000,0,0
TIKI,thoi-trang-nu,82298487," Áo Khoác Sweater Nỉ Nữ In Hình Café Free Size 70kg AK108 3 Màu Áo Khoác Nỉ Nữ",99000,99000,0,0
TIKI,thoi-trang-nu,26427035,"Dây áo ngực bra cao cấp đính đá hạt dùng cho áo hở cổ DA13",176000,176000,0,0
TIKI,thoi-trang-nu,32894036," Áo Sơ Mi Nữ Kiểu Cổ Thắt Nơ Tay Phối Lưới Chấm Bi GT534",232000,232000,0,0
TIKI,thoi-trang-nu,67281966,"Quần ống rộng kéo dài chân",99000,99000,0,0
TIKI,thoi-trang-nu,178329620,"Chân Váy Công Sở New Design Thiết Kê  Dáng Váy Xếp Ly Dài Qua Gối Ôm Body , Phối Nút Kiểu Mới, Vải Tốt Co Giãn CV0073",179000,339000,160000,47
TIKI,thoi-trang-nu,73528648,"Áo Lót Mút Đệm Mỏng Vừa Màu Trơn Thời Trang Sixnature By Sabina SBS2200",159000,579000,420000,73
TIKI,thoi-trang-nu,73514390,"Váy ngủ sexy ren gợi cảm - Hồng",35000,35000,0,0
TIKI,thoi-trang-nu,103357280,"Váy ngủ sexy cosplay người hầu gái G64 siêu gợi cảm quyến rũ",150000,150000,0,0
TIKI,thoi-trang-nu,114587820,"Chân váy ngắn chữ A lưng cao phong cách hàn quốc 3 màu chất kaki",97000,97000,0,0
TIKI,thoi-trang-nu,194406809,"Quần lót nữ mặc váy không đường may bonding iBasic V187",89000,99000,10000,10
TIKI,thoi-trang-nu,5925325,"Combo quần mặc trong váy",64000,69000,5000,7
TIKI,thoi-trang-nu,97446606,"Áo phông ngắn tay, áo thun nữ cộc tay Vicci AP.01.5 chất liệu cotton vân gỗ in hoạ tiết cô gái",84000,168000,84000,50
TIKI,thoi-trang-nu,6640013,"Quần Độn Mông Đúc Dạng Đùi Nâng Mông Cao Cấp",75000,75000,0,0
TIKI,thoi-trang-nu,58324854,"Bộ đồ pijama nữ quần dài và áo tay dài C093",146000,157000,11000,7
TIKI,thoi-trang-nu,192191718,"Đầm Trung Niên Sang Trọng Cao Cấp, Dáng Suông Hoa Tay Lỡ, Kèm Dây Thắt Eo, Chất Linen Mát ARCTIC HUNTER AH181",320000,320000,0,0
TIKI,thoi-trang-nu,162047969,"Quần ống loe lưng cao 2 cúc chất vải trượt Thái co giãn nhẹ, tạo dáng sành điệu công sở tôn dáng ống vẩy nữ - M",213000,350000,137000,39
TIKI,thoi-trang-nu,118027755,"Đồ Lam Đi Chùa # La Hán Nam Nữ # Đồ Bộ Nam Nữ # Quần Áo Nam Nữ",211000,211000,0,0
TIKI,thoi-trang-nu,85902127,"Quần lót nữ ren sexy hàn quốc kháng khuẩn C34 - quần lót đúc vic phối ren - Quần lót nữ sexy tam giác – Quần lót lọt khe",31200,31200,0,0
TIKI,thoi-trang-nu,59161667,"Chân váy xòe công chúa họa tiết lông vũ dễ thương VAY74 free size",217000,217000,0,0
TIKI,thoi-trang-nu,70933997,"Áo len nữ dài tay cổ tròn mẫu mới siêu đẹp Haint Boutique al46",189000,189000,0,0
TIKI,thoi-trang-nu,118022753,"Đồ Lam Đi Chùa # Bà Lai 2 Túi Áo # Đồ Bộ # Quần Áo Nữ",157000,157000,0,0
TIKI,thoi-trang-nu,58668155,"Aó lót ren Triumph D 337 WHU - Màu hồng da - có gọng , mút dầy , mút có thể tháo rời",799000,799000,0,0
TIKI,thoi-trang-nu,98254103,"Áo Lót Đệm Mỏng Cho Bé Gái Màu Trắng Cool Teen By Sabina SBC441WH",344000,344000,0,0
TIKI,thoi-trang-nu,173863802,"Combo 5 quần lót nữ mặc váy không đường may bonding iBasic V187",425000,495000,70000,14
TIKI,thoi-trang-nu,93313414,"Quần Ống Rộng Lưng Cao chất cát hàn",89000,89000,0,0
TIKI,thoi-trang-nu,192781555,"YU CHERRY | Đầm Mina Cami Dress YD146",350000,350000,0,0
TIKI,thoi-trang-nu,37126497,"( 10 cái ) quần lót nữ Su đúc không đường may, hàng đẹp loại xịn W19_503",141400,141400,0,0
TIKI,thoi-trang-nu,89479722," ÁO LOT NGỰC MÓC TRƯỚC BIGSIZE",182000,182000,0,0
TIKI,thoi-trang-nu,67225104,"Quần tây baggy công sở bigsize lưng thun nữ",149000,149000,0,0
TIKI,thoi-trang-nu,89479713," Băng Dính Cố Định Vị Trí Áo (fashion tape)",23570,23570,0,0
TIKI,thoi-trang-nu,75840441,"Áo Khoác Nữ Chống Nắng , Chống Nước Kiểu Dáng Thể Thao Năng Động Kèm Túi Đựng - FMHN004",95000,179000,84000,47
TIKI,thoi-trang-nu,182729631,"Đầm suông linen tay lỡ cổ phát V, chất vải linen tự nhiên mềm mát, thời trang cho phái nữ Da78",299000,299000,0,0
TIKI,thoi-trang-nu,178229107,"Váy ngủ ren tà dài đan chéo ngực sexy cao cấp Q505 - Đầm ngủ nữ 2 dây quyến rũ - Đồ ngủ nữ gợi cảm sexy",119000,180000,61000,34
TIKI,thoi-trang-nu,72606150,"Váy ngủ lụa xẻ người dây buộc hông",124000,124000,0,0
TIKI,thoi-trang-nu,57726141,"Đồ bộ nữ chất liệu cotton quần caro áo thiêu chứ 1141",99000,99000,0,0
TIKI,thoi-trang-nu,92055188," Bra / Áo Lá Học Sinh Hai Lớp Xuất Đông Âu ( AL : 193 ) Hàng Loại Đẹp",26000,26000,0,0
TIKI,thoi-trang-nu,83159018,"Áo Sơ Mi Nữ Ngắn Tay Hai Màu Xanh Trắng",157000,157000,0,0
TIKI,thoi-trang-nu,74441778,"Áo Ngực Nữ Không Gọng Thun Lạnh Mút Mỏng Hoa Văn Active Miley Lingerie - Màu Xanh BRM07015",210000,470000,260000,55
TIKI,thoi-trang-nu,169459230,"Đầm ngủ váy ba lỗ sườn xám cách tân sang chảnh",144000,144000,0,0
TIKI,thoi-trang-nu,191756961,"[ĐẸP CHẤT] Đầm yếm jean dài cài nút xẻ tà dáng suông mềm mại năng động C082",279000,279000,0,0
TIKI,thoi-trang-nu,179412988,"Áo kiểu nữ ngắn tay in hình phong cách Retro,bốn màu siêu đẹp,siêu sang - Mã A17",166470,166470,0,0
TIKI,thoi-trang-nu,92159061,"Set 3 món đồ bơi nữ tay dài quần dài kèm quần đùi bơi rời - TK2165",437000,437000,0,0
TIKI,thoi-trang-nu,63129705,"Quần lót kháng khuẩn ren sọc trẻ trung",50000,50000,0,0
TIKI,thoi-trang-nu,112052377,"(HÀNG HOT TEEN) VÁY ĐŨI SUÔNG DÁNG MAXI FULL MÀU HÀNG CHUẨN NHƯ HÌNH CÓ ẢNH THẬT",78700,78700,0,0
TIKI,thoi-trang-nu,17041690,"Áo khoác đi nắng chống bui, khóa kéo che cổ Phúc An DN0001",143100,143100,0,0
TIKI,thoi-trang-nu,174219974,"Quần nữ dáng suông, lưng bo chun thoải mái, chất đũi mặc mát Đũi Việt DV38",169000,169000,0,0
TIKI,thoi-trang-nu,185004745,"Quần đùi mẹ Nâu cà phê chéo Hàn - AICDMEVKF3HT - AIN Closet",205000,260000,55000,21
TIKI,thoi-trang-nu,197191834,"Áo hoodie in chữ YE MUST BE BORN AGAIN KANYE cho nam và nữ, ÁO HOODIE NỈ IN CHỮ YE MUST BORN FORM RỘNG UNISEX NAM NỮ, Áo hoodie in chữ YE MUST BE BORN AGAIN KANYE cho nam và nữ",100000,100000,0,0
TIKI,thoi-trang-nu,196205490,"Chân Váy Nữ New Design Thiết kế Dáng Váy Đắp Tà Chéo ,Phom chữ A Trẻ Trung, Dài 63cm ,Thanh Lịch Công Sở ,,Chất Vải Tốt Co Giãn (3 Màu )CV0083",179000,274000,95000,35
TIKI,thoi-trang-nu,128158907,"Quần lót lọt khe Full lưới Sexy kiểu dáng độc đáo siêu co giãn",35000,35000,0,0
TIKI,thoi-trang-nu,73200262,"Áo Kiểu Nữ Hàn Quốc Dạng Áo Kiểu Tay Lỡ Phối Màu - Nhiều Màu GOTI 3A03",219000,219000,0,0
TIKI,thoi-trang-nu,192710205,"Áo Hoodie nỉ bông thêu sadboiz màu ĐEN / Nam nữ unisex",100000,100000,0,0
TIKI,thoi-trang-nu,179417238,"Quần short nữ ống rộng cá tính, quần đùi nữ ống rộng chất đũi mát siêu đẹp Y1",175000,175000,0,0
TIKI,thoi-trang-nu,143148359,"ĐẦM XÒE VOAN DỰ TIỆC THẮT NƠ EO SIÊU XINH",123000,123000,0,0
TIKI,thoi-trang-nu,76541904,"Quần lót lọt khe nữ dễ thương ren buộc dây",25000,25000,0,0
TIKI,thoi-trang-nu,63585201,"Chân váy xòe vải cotton không nhăn họa tiết trái tim VAY81",189000,189000,0,0
TIKI,thoi-trang-nu,158129574,"Váy/đầm ngủ chất liệu ren voan mềm mịn, cao cấp, xẻ tà trước đầy gợi cảm LYEN008",110000,118000,8000,7
TIKI,thoi-trang-nu,25964805,"Quần lót lọt khe sexy nữ chất liệu ren thiết kế xẻ đáy quyến rũ gợi cảm - Màu hồng",25000,25000,0,0
TIKI,thoi-trang-nu,110757056,"chân váy nữ có túi kiểu hàn 3 màu kiểu hàn quốc",89000,89000,0,0
TIKI,thoi-trang-nu,7150525,"Quần Độn Mông Đúc Dạng Đùi Nâng Mông Cao Cấp - 5Star",72000,72000,0,0
TIKI,thoi-trang-nu,113571105,"Set đồ nữ đũi, bộ đồ nữ hè áo yếm quần short cá tính",89000,89000,0,0
TIKI,thoi-trang-nu,103358919,"Váy ngủ quảng châu cao cấp – Váy ngủ sexy ren G7 – Váy ngủ gợi cảm – Đầm ngủ ren hoa – Đồ ngủ sexy – Váy ngủ sexy",95000,95000,0,0
TIKI,thoi-trang-nu,186862647,"Bộ quần áo lửng cho mẹ họa tiết Sọc xám linen cotton - AICDMESQPMZ0 - AIN Closet",310000,430000,120000,28
TIKI,thoi-trang-nu,33694112,"Áo len nữ freesize tay ngắn 15",129000,129000,0,0
TIKI,thoi-trang-nu,35976449,"Áo Len Nữ Cardigan Nhẹ Bốn Mùa ALN002 MayHomes Kiểu Cánh Dơi",112000,145000,33000,23
TIKI,thoi-trang-nu,57400785,"Bộ đồ bơi bikini 2 mảnh nữ phong cách Hàn xinh xắn, chất bơi thun lạnh Lycra cao cấp, dáng dễ mặc, kín đáo mà vẫn quyến rũ | KT047",480000,480000,0,0
TIKI,thoi-trang-nu,167561204,"Quần đùi pyjama nữ ngắn lụa Satin hoạ tiết icon iBasic HOMW028B",99000,199000,100000,50
TIKI,thoi-trang-nu,177200535,"Quần baggy nữ cạp chun cao cấp chất đũi thoáng mát Q140",69000,69000,0,0
TIKI,thoi-trang-nu,58327731,"Đầm suông nữ xếp từng phối ren form rộng đủ size AH10",179000,179000,0,0
TIKI,thoi-trang-nu,137669568,"Áo Sơ Mi Nhung Gân Tăm Phong Cách Retro Hàn Quốc Form Rộng Unisex Nam Nữ Ulzzang",152000,152000,0,0
TIKI,thoi-trang-nu,108507753,"Quần baggy nữ công sở gấu bằng chất tuyết mưa",75000,75000,0,0
TIKI,thoi-trang-nu,51731179,"Đồ ngủ cosplay nữ phi công sexy gợi cảm",128900,128900,0,0
TIKI,thoi-trang-nu,146773109,"(Big size) Chân váy xòe dài có túi",129000,129000,0,0
TIKI,thoi-trang-nu,179417337,"Áo sơ mi nữ cổ tàu thêu họa tiết đáng yêu Thời trang Jolly 2022 (SP18)",189000,189000,0,0
TIKI,thoi-trang-nu,67992226,"ĐẦM BI TAY PHỒNG LENA",163000,163000,0,0
TIKI,thoi-trang-nu,193152975,"Quần lót nữ dáng Bikini gợi cảm chất liệu cotton Mỹ ONOFF - 16UJ23A034",79000,79000,0,0
TIKI,thoi-trang-nu,185096001,"Áo lót học sinh 2 dây mút mỏng dành cho học sinh tiểu học trung học cơ sở chất cottton tăm mềm mại thoáng mát Lá Bralette A26",38000,38000,0,0
TIKI,thoi-trang-nu,61494413,"Đầm Ngắn Dễ Thương Nơ Trắng Và Viền Tay DN087 MayHomes Kiểu Dáng Thời Trang",138000,169000,31000,18
TIKI,thoi-trang-nu,146785126,"(BIG SIZE) Quần ống suông dài",180000,180000,0,0
TIKI,thoi-trang-nu,91754247,"Áo HOODIE HEART DÂY KÉO UNISEX, Áo Khoác Nỉ Bông Dây Kéo HEART Thêu Trái Tim Unisex , Áo khoác hoodie chống nắng dành cho nam nữ Thêu Trái Tim, Nỉ ngoại form rộng Có Dây Kéo unisex ulzzang",100000,100000,0,0
TIKI,thoi-trang-nu,185004783,"Bộ quần áo lửng cho mẹ Nâu xước - AICDMEUVNTQJ - AIN Closet",335000,430000,95000,22
TIKI,thoi-trang-nu,119420030,"Áo ngực tạo khe chữ U 8867",66930,66930,0,0
TIKI,thoi-trang-nu,141529954,"váy suông nữ, đầm suông dài tay cổ tim xẻ tà chất len gân 2 màu",125000,125000,0,0
TIKI,thoi-trang-nu,87453112,"ÁO KHOÁC SƠ MI CARO NAM NỮ / ÁO SƠ MI NỮ / ÁO SƠ MI SỌC CARO / ÁO KHOÁC SƠ MI",104000,104000,0,0
TIKI,thoi-trang-nu,125777168,"Bộ bơi váy tay ngắn (35_65kg)",211000,211000,0,0
TIKI,thoi-trang-nu,35539631,"set 5  Quần Lót Nữ Nhật Lưng Cao nt3 màu ngẫu nhiên ",80995,80995,0,0
TIKI,thoi-trang-nu,174550945,"Áo Thun Cá Sấu Nam Nữ Thời Trang Cao Cấp 40kg-80kg (MS08)",100000,100000,0,0
TIKI,thoi-trang-nu,87720310,"Bộ đồ lót liền thân gợi cảm cho nữ",75000,75000,0,0
TIKI,thoi-trang-nu,73279950,"Quần Lót Không Viền Su Đúc Thoải Mái Loire QSD04",89000,89000,0,0
TIKI,thoi-trang-nu,196157382,"Váy ngủ bodysuit ren hở lưng sexy gợi cảm P68 - Đầm ngủ bodysuit quyến rũ - Đồ ngủ nữ sexy",129000,199000,70000,35
TIKI,thoi-trang-nu,114538231,"Quần ống rộng dáng xuông cullotes cạp liền xuốt eo khóa trước chất cao cấp",85000,85000,0,0
TIKI,thoi-trang-nu,179413068,"Quần ống rộng chất đũi xước Nhật hàng thiết kế cao cấp ( Mã SP5)",185000,185000,0,0
TIKI,thoi-trang-nu,47308948,"Váy ngủ xuyên thấy sexy tặng kèm quần chíp MS001",39000,39000,0,0
TIKI,thoi-trang-nu,169347867,"Áo Khoác Dù BOMBER 7ZIA Ulzzang Nam Nữ Unisex Form Rộng Vải 2 Lớp Ulzzang",100000,100000,0,0
TIKI,thoi-trang-nu,25964812,"Quần lót nữ lọt khe xẻ đáy - Màu tím",29000,29000,0,0
TIKI,thoi-trang-nu,179418058,"Áo sơ mi cổ trụ tay lỡ dáng xuông thời trang Hàn Quốc ( mã A25)",186000,186000,0,0
TIKI,thoi-trang-nu,173858351,"Bộ thể thao nữ chất liệu cotton cao cấp thoáng mát ko bai xù phù hợp thời tiết mùa hè Us 003, Bộ cộc tay nữ siêu đẹp kiểu dáng trẻ trung, chất vải thoáng mát, thấm hút mồ hôi, phù hợp mặc đi chơi dã ngoại",109000,109000,0,0
TIKI,thoi-trang-nu,7778560,"Áo ngực nữ cúp ngang Miley Lingerie BRM09102",205000,315000,110000,35
TIKI,thoi-trang-nu,125021753,"(HÀNG SẴN) Áo Sơ Mi Ren Ngắn Tay Cổ Trụ Phong Cách hàn Quốc SM52 - Hàng Quảng Châu Cao Cấp",225000,225000,0,0
TIKI,thoi-trang-nu,185384313,"Đầm Linen nữ cổ V rút eo 2 túi phong cách công sở Đũi Việt Dv160",249000,249000,0,0
TIKI,thoi-trang-nu,1921271,"Áo Ngực Triumph D179 GT-VN - Trắng (Size",279000,369000,90000,24
TIKI,thoi-trang-nu,91663893,"Đồ bộ bigsize - Đồ bộ trung niên - Bộ đồ trung niên mặc nhà bigsize Vicci DGN.03 thiết kế áo cộc quần dài chất liệu đũi cao cấp (dành cho người béo)",175000,329000,154000,47
TIKI,thoi-trang-nu,94081677,"Quần ống rộng nữ,quần ống suông lửng giả váy chất đũi duyên dáng",70000,70000,0,0
TIKI,thoi-trang-nu,177189499,"Quần ống rộng lửng nữ lưng cao vải tuyết mưa Hàn Quốc cao cấp Doloxi Q143",100000,100000,0,0
TIKI,thoi-trang-nu,52461347,"Chân váy xòe Zarha sang trọng",185000,185000,0,0
TIKI,thoi-trang-nu,187009117,"Quần lót lọt khe nữ siêu Sexy Briefs nâng mông",45000,45000,0,0
TIKI,thoi-trang-nu,137524599,"Áo khoác,bomber gió chữ R trắng in hình họa tiết cực nổi nam nữ mặc cực chất, Áo Khoác Bomber Nam Thời trang, Áo Bomber Nam Nữ Phối Tay Chữ R Gió Thu Đông Unisex, Áo gió BOMBER",110000,110000,0,0
TIKI,thoi-trang-nu,85905324,"Quần lót lọt khe nữ Dây sexy C51",33000,33000,0,0
TIKI,thoi-trang-nu,61473743,"Áo thun nữ wash Nhật Bản thương hiệu GOKING, 100% cotton thấm hút mồ hôi",155000,155000,0,0
TIKI,thoi-trang-nu,148637575,"Áo Lót Nữ - Áo Ngực Nữ đúc su không gọng mềm mại kháng khuẩn",47000,47000,0,0
TIKI,thoi-trang-nu,118022325,"Đồ Lam Đi Chùa # Bà Lai Nhật Vải Hàn Quốc # Đồ Bộ Nữ # Quần Áo Nữ",468000,468000,0,0
TIKI,thoi-trang-nu,172312344,"Bộ đồ nữ mặc nhà trung niên cho các bà, các mẹ Vicci BTN.26, thiết kế áo cộc tay quần lửng, chất liệu thun Nhật mềm mịn, thoáng mát",154500,309000,154500,50
TIKI,thoi-trang-nu,8068749,"Áo Khoác Nữ Xỏ Ngón Comfort Phúc An 4034 Màu",180000,180000,0,0
TIKI,thoi-trang-nu,103079663,"[ĐẸP ĐỘC] Chân váy jean ngang gối 08 phối dây xích lưng cá tính C101 Cỏ Boutique",274000,295000,21000,7
TIKI,thoi-trang-nu,185867089,"Bộ quần áo lửng cho mẹ họa tiết Xanh rêu lụa - AICDMEQB5DGH - AIN Closet",335000,430000,95000,22
TIKI,thoi-trang-nu,185684218,"Đồ bộ ngủ bigsize không mút 2 dây phối ren lưng mã 376",50000,50000,0,0
TIKI,thoi-trang-nu,72337537,"Áo khoác nữ",99000,99000,0,0
TIKI,thoi-trang-nu,86882422,"(HÀNG SẴN) Đầm Hoa Trung Niên Che Bụng Cho Mẹ VH52 - Hàng Quảng Châu Cao Cấp",375000,375000,0,0
TIKI,thoi-trang-nu,58896936,"Combo 5 Quần lót nữ O2 Cotton Ép Không Đường May",112520,112520,0,0
TIKI,thoi-trang-nu,157414523,"ÁO KHOÁC NỈ DÂY KHOÁ KÉO, ÁO KHOÁC HOODIES NỮ CHẤT THUN NỈ MỀM CÓ NÓN PHỐI CHỮ IN SIÊU HOT",110000,110000,0,0
TIKI,thoi-trang-nu,173758811,"Váy ngủ lụa ren hông cao cấp Q09 - Váy ngủ 2 dây - Đầm ngủ sexy gợi cảm - Đồ ngủ mạc nhà",139000,180000,41000,23
TIKI,thoi-trang-nu,106366427,"quần legging cạp cao gen bụng siêu tôn dáng",79000,79000,0,0
TIKI,thoi-trang-nu,143117503,"Áo lót nữ cotton không gọng đệm mỏng cao cấp, áo lót nữ sinh",105000,105000,0,0
TIKI,thoi-trang-nu,34589122,"Đai sinh nhiệt giảm mỡ bụng Hot Belt cao cấp, size XL",96000,99000,3000,3
TIKI,thoi-trang-nu,99280793,"Áo Lót Mút Mỏng Kèm Miếng Mút Rời Màu Hồng Nhạt Fashion Maggie Mae By Sabina SBT1074PL",315000,619000,304000,49
TIKI,thoi-trang-nu,142995282,"Áo Trung Niên Size Lớn Form Rộng Dạng Áo Sơ Mi Trung Niên Kiểu Nữ Cho Mẹ U50 U60 In Hoa Đẹp Cao Cấp Nhiều Mẫu GOTI 3A26",235000,235000,0,0
TIKI,thoi-trang-nu,105673810,"Đầm xoè nữ kẻ sọc, đầm vải thun co giãn 4 chiều D83",149000,149000,0,0
TIKI,thoi-trang-nu,169483875,"Đồ ngủ hóa trang cosplay người nhện spider man anime khóa kéo mở đũng",168000,280000,112000,40
TIKI,thoi-trang-nu,116384364,"Áo vest blazer nữ cộc tay chất mát dáng rộng 2 khuy cá tính",119000,119000,0,0
TIKI,thoi-trang-nu,16261633,"Quần độn mông, gen bụng Thái Lan cao cấp - 5Star",82000,82000,0,0
TIKI,thoi-trang-nu,103481068,"quần ống suông dáng dài eo thon khóa sườn chất tuyết mưa nhiều màu",115000,115000,0,0
TIKI,thoi-trang-nu,176687766,"Đồ Bơi Hai Mảnh Họa Tiết Sọc Kèm Váy Ren ATO54 MayHomes Women Two-Piece Swimwear",151000,177000,26000,15
TIKI,thoi-trang-nu,90933627,"Áo lót cao cấp trơn su đúc mềm mại nâng ngực viền răng cưa",138000,138000,0,0
TIKI,thoi-trang-nu,131418507,"Áo phao gile nam nữ siêu ấm,trẻ trung và năng động full size (KN4)",199000,199000,0,0
TIKI,thoi-trang-nu,108930438,"Bộ Đồ Pijama Mặc Nhà Ngắn Tay Azuno BN2706 Chất Liệu Cotton Lụa Nhẹ Mát Cho Mùa Hè",290000,290000,0,0
TIKI,thoi-trang-nu,106991359,"Áo dài trắng học sinh 4 tà lụa nhật / áo dài nữ sinh / áo dài truyền thống",220000,220000,0,0
TIKI,thoi-trang-nu,127807880,"Full sét MERRY cưng xỉu , sét bộ đùi mới toanh diện hè bao chuẩn lun đây nè, form to rộng chuẩn đẹp lắm nhé, Set đồ bộ from rộng sang chảnh, đồ bộ thể thao nữ unisex ulzzang, bộ đồ mặc nhà nữ rộng thoải mái chất mát",99000,99000,0,0
TIKI,thoi-trang-nu,58329345,"ÁO SƠ MI NỮ ĐŨI VIỆT, ÁO ĐŨI NỮ KẺ CARO DVSM02",159000,159000,0,0
TIKI,thoi-trang-nu,167543332,"(HÀNG SẴN) Áo Sơ Mi Nữ Cotton Thêu Tay Họa Tiết SM150 - Hàng Quảng Châu Cao Cấp",245000,245000,0,0
TIKI,thoi-trang-nu,103026406,"Quần nữ ống rộng lưng thun chất liệu đũi",129000,129000,0,0
TIKI,thoi-trang-nu,125172289,"Áo Khoác Nỉ Bông Chống Nắng Thêu STR Hàn Quốc Nam NữFRESHIP RẺ ĐẸP, Áo Hoodie Kiểu Thun Tay Dài Unisex Couple Jackets",108000,108000,0,0
TIKI,thoi-trang-nu,136818293,"Bộ 2 miếng Mút đệm, Mút lót độn ngực hình tròn( dày 3cm ) dành cho Bra, Bikini, Đồ tập Yoga, Gym",53000,55000,2000,4
TIKI,thoi-trang-nu,143687625,"GOTI - Áo Sơ Mi Công Sở Nữ Kiểu Áo Nữ Hàn Quốc Cổ Chữ V Kèm Phụ Kiện Ở Cổ - THỜI TRANG CÔNG SỞ 3A25",169000,169000,0,0
TIKI,thoi-trang-nu,301787,"Áo Khoác Nỉ Unisex Phúc An - Xám Đậm",160000,160000,0,0
TIKI,thoi-trang-nu,10730888,"Quần Lót Nữ Smoggi Shine Mini Triumph - Trắng (Size",115000,139000,24000,17
TIKI,thoi-trang-nu,89560764,"Áo khoác BOMBER DÙ 2 LỚP 5426 CÓ 3 MÀU, áo khoác dù nam nữ BOMBER nút bấm Thêu 5426, Áo Khoác Dù Bomber Nam Nữ Cao Cấp Thêu 5426 Kiểu Dáng Bóng Chày Phong Cách Hàn Quốc, ÁO KHOÁC NAM NỮ PHONG CÁCH BOMBER NÚT BẤM THỜI TRANG 5426",99000,99000,0,0
TIKI,thoi-trang-nu,155268951,"Quần gen bụng sau sinh cao cấp chấn liệu co dãn 4 chiều thoáng mát",84500,84500,0,0
TIKI,thoi-trang-nu,191124759,"Áo khoác hoodie nữ OUTERITY full zip vải nỉ có mũ nón form rộng ulzzang dễ thương hợp thời trang",105000,105000,0,0
TIKI,thoi-trang-nu,195124820,"Áo Cúp Ngực, Áo ngực, Áo Quây Chống Tụt Không Dây Nâng Đẩy Ngực Quyến rũ LYEA038",108000,116000,8000,7
TIKI,thoi-trang-nu,50677722,"Combo 5 QUẦN LÓT Đùi NỮ MẶC VÁY MÃ 2019",181390,181390,0,0
TIKI,thoi-trang-nu,118014158,"Đồ Lam Đi Chùa # Nhật Nơ Thêu Hoa Cúc # Đồ Bộ Nữ # Quần Áo Nữ",198000,198000,0,0
TIKI,thoi-trang-nu,97819193,"Váy ngủ 2 dây xuyên thấu - Set đầm ngủ sexy thêu hoa gợi cảm",124000,124000,0,0
TIKI,thoi-trang-nu,93181829,"[HCM] (65-85kg) Đồ bộ satin bigsize nữ. Đồ bộ lụa hàn bigsize nữ. Đồ bộ bigsize satin. Đồ bộ bigsize lụa hàn. Đồ bộ nữ từ 70kg trở lên. Đồ bộ pijama TNQD. Đồ bộ pyjama TNQD. Đồ bộ pizama TNQD. Đồ bộ mặc ngủ nữ. Đồ bộ mặc nhà nữ. Đồ bộ TNQD",165000,165000,0,0
TIKI,thoi-trang-nu,75353174,"Gen định hình bắp tay vai gen giảm mỡ bắp tay",185000,185000,0,0
TIKI,thoi-trang-nu,101749109,"Đồ bộ nữ cộc tay - Đồ bộ mặc nhà - Đồ ngủ mặc nhà nữ - Đồ bộ nữ lửng - Set bộ đũi mặc nhà nữ Vicci BDT.01 phối hoạ tiết tim",135000,269000,134000,50
TIKI,thoi-trang-nu,107039383,"Đồ Lam Đi Chùa # Mẫu Sông Ngư Lụa Cao Cấp",203000,203000,0,0
TIKI,thoi-trang-nu,176082103,"Đồ bơi liền thân quần váy nữ, có mẫu dài tay, khóa kéo trước phong cách thể thao, áo sẵn đệm ngực, chất thun bơi dầy mát lạnh | KT072",390000,390000,0,0
TIKI,thoi-trang-nu,84820860,"Quần Độn Hông Ren Miếng Độn Rời Siêu Thoáng, Quần Mặc Trong Váy Lưới D373",144000,144000,0,0
TIKI,thoi-trang-nu,141123982,"đầm nữ dài maxi dáng ulzang hàn quốc cá tính ( không kèm áo)",94000,94000,0,0
TIKI,thoi-trang-nu,55650411,"Đầm Nữ Đầm Dự Tiệc Đầm Công Sở  Đầm Xòe Tay",195000,195000,0,0
TIKI,thoi-trang-nu,160993917,"Váy Công Sở Kẻ Dài Tay Dáng Suông Haint Boutique, Đầm Nữ Lệch Tà Kèm Dây Thắt Eo Cổ Sơ Mi D92",299000,299000,0,0
TIKI,thoi-trang-nu,2085851,"Áo Ngực Triumph Maxi 819 (7C-VN) - Xám Đen (Size",780000,780000,0,0
TIKI,thoi-trang-nu,24198767,"Quần Lót Nữ Ren Thêu Hoa Hồng Trước Cao Cấp",29000,29000,0,0
TIKI,thoi-trang-nu,186749768,"Đồ Bơi Nữ Hai Mảnh Tay Dài Chống Nắng Biển Xanh Áo Dài Tay Quần Lưng Cao Tươi Trẻ ATI87 MayHomes, Sun Protection UPF50+, Long-Sleeve Swimwear",234000,265000,31000,12
TIKI,thoi-trang-nu,95867719,"(MẶC NHƯ KHÔNG MẶC) Quần lót Nữ_Quần lót ren thun lạnh co giãn 4 chiều, không hằn vết SIÊU GỢI CẢM",165000,165000,0,0
TIKI,thoi-trang-nu,181714078,"Áo sơ mi nữ cộc tay xắn có túi màu trắng cá tính",75000,75000,0,0
TIKI,thoi-trang-nu,51280936,"Áo lót trơn bảng ren cao cấp chất mềm mịn",98000,98000,0,0
TIKI,thoi-trang-nu,52275183,"Áo Sơ Mi Nữ Dài Tay Kẻ Sọc Thời Trang",157000,157000,0,0
TIKI,thoi-trang-nu,161208804,"Quần lót cạp cao Bigsize (XL-6XL)",63000,63000,0,0
TIKI,thoi-trang-nu,25420783,"Bộ Quần Áo Nữ - Bd040519",299000,299000,0,0
TIKI,thoi-trang-nu,192337533,"YU CHERRY | Áo nữ Wrap Line Blazer YA390",325000,325000,0,0
TIKI,thoi-trang-nu,124630709,"Áo vest nữ, áo blazer nữ mỏng tay lỡ phong cách Hàn Quốc Ak05",199000,199000,0,0
TIKI,thoi-trang-nu,68418522,"Đầm ôm body 2 dây xoắn ngực",207000,207000,0,0
TIKI,thoi-trang-nu,186252222,"Váy Đầm Trung Niên Dáng Suông Form Rộng  Chất Linen Thoáng Mát Đũi Việt Dv165",299000,299000,0,0
TIKI,thoi-trang-nu,183078980,"(Local Brand Hot) Áo Thêu Varsity Jacket - Áo Khoác Bomber Thêu Cardigan 3 Màu BOIN LUCKY chữ A thêu cả áo Siêu đẹp Ocea",128000,128000,0,0
TIKI,thoi-trang-nu,190539038,"Bộ Đồ Pijama Nữ, đồ bộ Mặc Nhà Quần đùi tay cộc VILADY B152 Chất liệu Lụa Pháp (Lụa Latin) cao cấp Họa tiết Tim Bi Màu Hồng cam",419000,450000,31000,7
TIKI,thoi-trang-nu,148551676,"Quần legging giữ nhiệt nữ chất vải siêu co giãn 4 chiều cạp liền màu đen",65000,65000,0,0
TIKI,thoi-trang-nu,73515769,"Đồ bộ trung niên đẹp - Bộ đũi trung niên cao cấp - chất vải loại 1 - Không nhăn không xù khi giặt - Laddy_store",300000,300000,0,0
TIKI,thoi-trang-nu,100000804,"ÁO KIỂU TRUNG NIÊN SIZE LỚN DẠNG ÁO SƠ MI TRUNG NIÊN, THỜI TRANG U50-60, ÁO TẶNG MẸ TRUNG NIÊN 3A17",219000,219000,0,0
TIKI,thoi-trang-nu,119670228,"Bộ Đồ thú Khủng Long xanh liền thân lông mịn Pijama dành Cho Người Lớn và Trẻ Em kiểu dáng Động Vật Hoạt Hình Cosplay",242000,242000,0,0
TIKI,thoi-trang-nu,182783365,"Áo đũi nữ form rộng fullsize M đến 2XL họa tiết thêu dễ mix đồ ALE17",159000,159000,0,0
TIKI,thoi-trang-nu,196916610,"Áo khoác hoodie zip WINNER form rộng vải nỉ lót bông nam nữ chống nắng, Áo khoác nỉ Kill ( ảnh chụp tại shop), Áo khoác-Áo khoác hoodie zip nữ criminal chất nỉ bông 2 lớp dày dặn,áo khoác nữ zip",100000,100000,0,0
TIKI,thoi-trang-nu,13568062,"Sơ Mi Nữ Dài Tay",166400,166400,0,0
TIKI,thoi-trang-nu,161707218,"Quần lót nữ ONOFF sợi Microfiber siêu mảnh mát mịn, mỏng nhẹ 16UJ22A001",99000,99000,0,0
TIKI,thoi-trang-nu,168577620,"Áo Khoác Nỉ Khóa Zip Gấu Brown Phong Cách Hàn Quốc Unisex Nam Nữ Đều Mặc Được Form Rộng Knn32",110000,110000,0,0
TIKI,thoi-trang-nu,95253537,"Áo Khoác Dù 7ZIA Unisex Form Rộng Vải Dù Mero 2 Lớp",96000,96000,0,0
TIKI,thoi-trang-nu,78880034," Quần Lót Nữ Đẹp - Q1028",83000,83000,0,0
TIKI,thoi-trang-nu,109981893,"Váy ngủ nữ, váy mặc nhà họa tiết hình thỏ có 2 màu hồng và xanh V18",154800,154800,0,0
TIKI,thoi-trang-nu,161958734,"Bộ đồ lót bikini mỏng lọt khe sexy",35000,35000,0,0
TIKI,thoi-trang-nu,18012620,"Quần thun dài nữ jogger Phúc An 3011",99000,99000,0,0
TIKI,thoi-trang-nu,23239851,"[Chọn màu] Quần lót nữ ren xẻ đáy cực sexy nóng bỏng",35000,35000,0,0
TIKI,thoi-trang-nu,184683527,"Đầm linen hè nữ, Đầm suông nữ dáng dài kèm dây thắt eo Haint Boutique Da82",299000,299000,0,0
TIKI,thoi-trang-nu,165600199,"Quần lót nữ gợi cảm QL1690 - Quần lót nữ sexy",15000,30000,15000,50
TIKI,thoi-trang-nu,104510848,"ÁO CARDIGAN NỈ NGOẠI Thêu Puppy (HD1910 - Kèm Ảnh Thật)",95000,95000,0,0
TIKI,thoi-trang-nu,120858390,"Hình thật áo lá học sinh áo lót học sinh không mút chất liệu cotton cao cấp vải 2 lớp loại đẹp",33000,36000,3000,8
TIKI,thoi-trang-nu,184072273," Bikini Hai Mảnh Tay Dài Che Nắng Họa Tiết Bunny AT2O9 MayHomes Đồ Bơi Kiểu Korea Ôm Dáng, Long Sleeves Women Swimwear Set, UPF 50 Sun Protection",273600,288000,14400,5
TIKI,thoi-trang-nu,89347682,"Áo khoác bomber in hình unisex form rộng style ulzzang - Áo khoác bóng chày màu đen, nâu, xanh Nấm Store",104000,104000,0,0
TIKI,thoi-trang-nu,132112258,"Đồ đi biển nam nữ cặp đôi set nguyên bộ áo quần gia đình họa tiết hoa lá chất vải Kate Thái dày dặn BXV | DONGPHUCSG",69000,69000,0,0
TIKI,thoi-trang-nu,87616804,"Áo Lót Mút Mỏng Vừa Phối Ren Habpy Lady By Sabina HBXLP0003",159000,383000,224000,58
TIKI,thoi-trang-nu,71062419,"Combo 3 Chiếc Quần Lót Nữ Chân Ren ATUNER QL010, Cao Cấp, Họa Tiết Thời Trang, Mềm Mại, Thoáng Mát (Giao Màu Ngẫu Nhiên) - Hàng Chính Hãng",169000,237000,68000,29
TIKI,thoi-trang-nu,118085215,"Chân váy xòe caro phối nút sang trọng - nhiều size và màu, form dáng chuẩn thích hợp mặc đi làm, dạo phố",142450,185000,42550,23
TIKI,thoi-trang-nu,49524530,"Áo kiểu nữ cổ V đơn giản DV116",159000,159000,0,0
TIKI,thoi-trang-nu,193093307,"Áo bra áo ngực không gọng mút mỏng chất cotton tăm mềm mại thoáng mát Lá Bralette A29",49500,49500,0,0
TIKI,thoi-trang-nu,190320583,"Đầm linen suông dáng dài, Đầm sơ mi nữ ngắn tay kèm dây thắt eo nhiều màu lựa chọn ARCTIC HUNTER AH75",299000,299000,0,0
TIKI,thoi-trang-nu,58524619,"Bộ bơi bikini nữ 2 mảnh cao cấp gợi cảm, áo gọng mềm nâng đẩy dễ chịu, quần váy cách điệu xinh xắn, chất bơi Lycra siêu đẹp | KT046",480000,480000,0,0
TIKI,thoi-trang-nu,69165620,"Set 2 Quần Lót Gen Nịt Bụng Nâng Mông MN02",46800,46800,0,0
TIKI,thoi-trang-nu,130889360,"Áo khoác nữ cadigan len mỏng khoác ngoài chất liệu dệt kim cao cấp",72000,72000,0,0
TIKI,thoi-trang-nu,53705155,"Set Váy Ngủ Lưới Mỏng Ren Áo Choàng Ngủ Sexy 3 Chi Tiết Cao Cấp",137000,137000,0,0
TIKI,thoi-trang-nu,197551618,"Áo khoác gió nam nữ Studios Unabated chất dù 2 lớp form rộng ô vuông, ÁO KHOÁC UNIXEX FROM RỘNG CÁ TÍNH (MS ô vuông), Áo Khoác Dù LOGO   Nam Nữ Ulzzang Unisex",99000,99000,0,0
TIKI,thoi-trang-nu,119285172,"Combo 3 áo lót học sinh ngắn không mút iBasic VA111",175000,207000,32000,15
TIKI,thoi-trang-nu,97619158,"Đồ Ngủ Hai Dây Lụa Satin Cao Cấp Sexy Quyến Rũ Thương Hiệu Baw, Chất Liệu Lụa Mát Mịn Nhẹ Nhàng Cực Kỳ Lôi Cuốn NT708 (hình thật shop tự chụp)",89000,169000,80000,47
TIKI,thoi-trang-nu,86882405,"( HÀNG SẴN) Áo Thun Nữ Trung Niên Dài Tay Thanh Lịch SM09 - Hàng Quảng Châu Cao Cấp",175000,175000,0,0
TIKI,thoi-trang-nu,112228024,"Áo Khoác Hoodie MISS.OUT. Ulzzang Unisex - Áo Chống Nắng Chát Nỉ Bông Khoác Nữ rẻ Đẹp Siêu Hot - HIỀN LINH SHOP ÁO KHOÁC",93000,93000,0,0
TIKI,thoi-trang-nu,72018478,"Quần gen bụng định hình ren cao cấp mềm mại lưng xéo quần mặc váy",37000,40000,3000,8
TIKI,thoi-trang-nu,95474110," Đầm xoà dự tiệc lụa bi",137000,137000,0,0
TIKI,thoi-trang-nu,192717710,"YU CHERRY | Áo nữ Cindy Pattern Top YA350",305000,305000,0,0
TIKI,thoi-trang-nu,24552815,"Áo lót nâng ngực multiway 7 kiểu mặc (kèm dây tạo 7 kiểu)",69000,69000,0,0
TIKI,thoi-trang-nu,114847614,"Quần tây cạp cúc khoá chun lưng nhiều màu tuyêt mưa ( Giá sỉ + ảnh thật )",69000,69000,0,0
TIKI,thoi-trang-nu,129573733,"Áo Hoodie mắt chữ X siêu chất, Áo nỉ unisex ulzzang dày dặn, áo nỉ nam nữ đẹp, áo hoodie, áo đôi, Áo Marshmello hoodie dài tay mũ trùm đầu, Áo hoodie phản quang trẻ trung, năng động form dưới 70kg",125000,125000,0,0
TIKI,thoi-trang-nu,184135820,"Quần lót cotton quả dâu cute co dãn 4 chiều được chọn màu chọn mẫu Q4",20000,35000,15000,43
TIKI,thoi-trang-nu,105619777,"váy suông sát nách cổ tròn dáng dài 3 màu xinh xắn",89000,89000,0,0
TIKI,thoi-trang-nu,185867085,"Bộ quần áo ngắn cho mẹ Xanh mạ linen - AICDMEMIBLBV - AIN Closet",325000,415000,90000,22
TIKI,thoi-trang-nu,108423829,"Quần short nữ cạp cao nhiều màu chất tuyết mưa",70000,70000,0,0
TIKI,thoi-trang-nu,3075019,"Váy đầm lanh (tole) Vicci TVN004.12 vải xước họa  tiết hoa hoa nền tím (Size",164500,299000,134500,45
TIKI,thoi-trang-nu,32380112,"Áo len nữ ngắn tay trơn cổ tròn nhiều màu Haint Boutique Al15",129000,129000,0,0
TIKI,thoi-trang-nu,70492925,"QUẦN LÓT REN SEXY MÃ 2164",32000,32000,0,0
TIKI,thoi-trang-nu,141111369,"Áo len dài tay nữ FHULA thu đông, áo sweater phong cách hàn quốc",62000,62000,0,0
TIKI,thoi-trang-nu,77948739,"Áo sơ mi nữ ARCTIC HUNTER thiết kế cổ V kẻ sọc AH13",159000,159000,0,0
TIKI,thoi-trang-nu,6535769,"Quần Đùi Mặc Váy Cotton Phối Ren",19000,20000,1000,5
TIKI,thoi-trang-nu,174309468,"Váy ngủ lụa khoét ngực cao cấp Q140 -  Đầm ngủ lụa hai dây sexy - Váy ngủ nữ - Đồ ngủ mặc nhà",139000,210000,71000,34
TIKI,thoi-trang-nu,128125685,"set đồ nữ, bộ quần áo nữ thu đông áo dài tay, quần short 2 màu nâu, đen in chữ phong cách cá tính",140000,140000,0,0
TIKI,thoi-trang-nu,83033098,"Quần Gen Nịt Bụng Cạp Cao 3 Nấc Cài Chống Cuộn",195000,195000,0,0
TIKI,thoi-trang-nu,185466170,"ÁO SƠ MI KHOÁC NGOÀI NAM NỮ NHUNG TĂM GÂN FORM RỘNG , ÁO SOWMI UNISEX NHUNG GÂN MÀU BE",158000,158000,0,0
TIKI,thoi-trang-nu,146768705,"(BIG SIZE) Chân váy xếp ly kẻ cạp cao C045",180000,180000,0,0
TIKI,thoi-trang-nu,194115003,"Đầm Suông Đuôi Cá 2 Dây De Leah",725000,725000,0,0
TIKI,thoi-trang-nu,13672976,"Quần Lót Triumph Sloggi Zero Hipster Màu Da (86-VN)",245000,299000,54000,18
TIKI,thoi-trang-nu,192717821,"YU CHERRY | Áo nữ Wings Top YA343",280000,280000,0,0
TIKI,thoi-trang-nu,38705224,"Quần nữ kết dây sexy lọt khe gợi cảm - Màu hồng đậm ",25000,25000,0,0
TIKI,thoi-trang-nu,3706473,"Sơ mi công sở nữ phối kẻ tay sm150",159000,159000,0,0
TIKI,thoi-trang-nu,75372394,"Combo 2 quần lót su đúc cao cấp, lưng cao, không đường may và ôm sát vòng 3 của bạn LYEQ003",110000,118000,8000,7
TIKI,thoi-trang-nu,187659649,"Áo Ngực Không Gọng Chất Liệu Cotton Cao Cấp, Áo Bra  Mẫu Mới Siêu Đẹp Thương Hiệu Baw Mã ANM16",180000,180000,0,0
TIKI,thoi-trang-nu,26303961,"Quần jogger nữ mùa đông chất umi",80000,80000,0,0
TIKI,thoi-trang-nu,193212299,"YU CHERRY | Áo lụa nữ cổ V cách điệu tay dài, Cross Neck Ruff Top YA406",325000,325000,0,0
TIKI,thoi-trang-nu,3146275,"Quần Lót Trơn Triumph Blissy 09 Mini - Da (Size",60000,89000,29000,33
TIKI,thoi-trang-nu,185004475,"Bộ quần áo ngắn cho mẹ Vàng be đũi xước - AICDMEZVHZ51 - AIN Closet",325000,415000,90000,22
TIKI,thoi-trang-nu,126708854,"Váy ngủ lụa cao cấp, váy ngủ nữ, váy ngủ 2 dây, váy ngủ gợi cảm, váy ngủ sexy, đầm ngủ lụa mặc nhà 2 dây trơn",269000,269000,0,0
TIKI,thoi-trang-nu,107044156,"Đồ Lam Đi Chùa # Áo Tràng Phật Tử Vải Đài Loan Cao Cấp",360000,360000,0,0
TIKI,thoi-trang-nu,120147544,"GOTI - Áo Sơ Mi Quý Bà Voan Dáng Rộng Dáng Áo Kiểu Trung Niên Vạt Nhọn In Hoa - ÁO TRUNG NIÊN CAO CẤP 3A14",219000,219000,0,0
TIKI,thoi-trang-nu,84826234," Quần Lót Nữ Băng Lụa Không Hằn Không Đường May Kháng Khuẩn Thoáng Khí P395",37000,37000,0,0
TIKI,thoi-trang-nu,59200252,"Đồ Bơi Tay Dài Liền Thân Dạng Short BKN595",180000,180000,0,0
TIKI,thoi-trang-nu,69984675,"Áo lót Bigsize định hình nâng ngực Quả lớn (sz 34-44DE)",187000,187000,0,0
TIKI,thoi-trang-nu,75544734,"Đồ Bơi Nữ Hai Mảnh Tay Dài Chống Nắng Dễ Thương AT209 MayHomes Đồ Bơi Kiểu Hàn Quốc Ôm Thân, Long Sleeves Women Swimwear Set, UPF 50 Sun Protection",273600,288000,14400,5
TIKI,thoi-trang-nu,181714293,"Áo Thun Nữ Cao Cấp Organic Cotton Regular Fit Aaa Jeans",249000,249000,0,0
TIKI,thoi-trang-nu,76099517," Áo Cardigan Nữ Thời Trang Áo Khoác Len ALN042 MayHomes Áo Len Nữ Mẫu Mới",145700,155000,9300,6
TIKI,thoi-trang-nu,117902311,"Áo HOODIE KHÓA ZIP NAM NỮ CON MỰC Unisex hoodie,Áo HOODIE NỮ MÀU ĐỎ ĐEN DÁNG RỘNG VẢI DÀY ĐẸP Hoodie unisex,Áo Hoodie Zip In Hình Unisex - Hoodie Dây Kéo Dáng Rộng",118000,118000,0,0
TIKI,thoi-trang-nu,84823781," Quần Lót Cotton Cạp Cao Full Mông Kháng Khuẩn P377",52000,52000,0,0
TIKI,thoi-trang-nu,109982103,"Váy mặc nhà, váy ngủ nữ 2 dây họa tiết hình dâu 2 màu trắng và hồng V21",129000,129000,0,0
TIKI,thoi-trang-nu,82900703,"Áo Khoác Nỉ Bông Dây Kéo MISSOUT COLOR Form Rộng Unisex (Dây áo cùng màu)",102000,102000,0,0
TIKI,thoi-trang-nu,19554212,"Đồ bơi nữ cực xinh",500000,500000,0,0
TIKI,thoi-trang-nu,89479586,"Áo Lót BIGSIZE CUP E",241000,241000,0,0
TIKI,thoi-trang-nu,5868963,"Quần Độn Mông Su Dạng Đùi Mặc Trong Váy F222",75000,75000,0,0
TIKI,thoi-trang-nu,112193803,"áo sơ mi nữ cộc tay cánh dơi cá tính",79000,79000,0,0
TIKI,thoi-trang-nu,68357270,"Set Bộ Đồ Lót Sexy Kèm Dây Nịt Lưng Và Vớ Lưới",79900,79900,0,0
TIKI,thoi-trang-nu,179167727,"Quần gen bụng co dãn 4 chiều định hình chun chống cuộn cao cấp",67500,67500,0,0
TIKI,thoi-trang-nu,87714956,"Váy ngủ ren sexy cổ chữ V đan dây hông gợi cảm",75000,75000,0,0
TIKI,thoi-trang-nu,77565530,"Chân váy xếp ly nhỏ dáng xòe dễ thương free size VAY131",225000,225000,0,0
TIKI,thoi-trang-nu,184243433,"Quần lót nguyệt san MENE period panties A REVOLUTION FOR WOMEN Kiểu nữ tính bản vừa",480000,480000,0,0
TIKI,thoi-trang-nu,59058392,"Chân váy Nana xinh xắn, dài qua gối dễ mặc đi làm, dạo phố",180000,180000,0,0
TIKI,thoi-trang-nu,112250302,"SET BỘ ĐỒ NAM NỮ BÒ SỮA MOO HOẠT HÌNH NEW - PHỐI QUẦN ĐÙI BÒ SỮA MẶC ĐI CHƠI ĐI LÀM ĐỀU ĐƯỢC, Đồ Bộ Hoạt Hình Unisex BÒ SỮA – Aossi , Set Cartoon, Freesize, Thun Cotton, Nam Nữ Đều Mặc Được",99000,99000,0,0
TIKI,thoi-trang-nu,11448438,"Quần Legging Nữ Vicci Q.LG.Vic.Nhu - Xám (Size",174500,349000,174500,50
TIKI,thoi-trang-nu,260668871,"Set bơi nữ 4 chi tiết cao cấp, bộ bikini sang trọng & quần áo mặc ngoài cùng tone, chất thun lạnh Lycra siêu đẹp, tôn dáng | KT048",520000,520000,0,0
TIKI,thoi-trang-nu,74370724,"Áo thun unisex tay lỡ form rộng - Phông Athletic",79000,79000,0,0
TIKI,thoi-trang-nu,73386401,"Set ngủ Cosplay giúp việc 2 mảnh Caro",78000,78000,0,0
TIKI,thoi-trang-nu,133103978,"Đồ mặc nhà nữ thu đông cotton mịn đẹp 5131",384000,384000,0,0
TIKI,thoi-trang-nu,90064957,"Áo khoác dù nữ / áo khoác gió nữ / áo khoác nữ chống nắng chống lạnh vải dù 2 lớp mặc 2 mặt form dài",150000,150000,0,0
TIKI,thoi-trang-nu,152874886,"Quần baggy đi học đi làm đi chơi 1 khuy lệch chun sau 4 màu hottrend đen trắng xanh kem thời trang Banamo Fashion 8334",114000,114000,0,0
TIKI,thoi-trang-nu,34148555,"Đồ bộ ngủ nữ tay dài, quần dài",200000,200000,0,0
TIKI,thoi-trang-nu,44336042,"ÁO LÓT SU NỮ, MỀM, MỊN, THOÁNG MÁT SIÊU ĐẸP ALS01",69000,69000,0,0
TIKI,thoi-trang-nu,167652790,"Bộ đồ bơi đôi dài tay nam nữ khoá kéo đen lườn xanh 5 mảnh siêu xịn",550000,550000,0,0
TIKI,thoi-trang-nu,93046821,"Chân váy chữ A ngắn xẻ trước kèm quần trong vải tuyết mưa 3 màu",62000,62000,0,0
TIKI,thoi-trang-nu,84826202,"Áo Bralette Cotton Siêu Mỏng Dây Chéo Không Móc, Áo Lót Không Gọng Không Đệm Mềm Mịn Tự Nhiên Cá Tính B246",81000,81000,0,0
TIKI,thoi-trang-nu,176529912,"Áo khiêu vũ Latin co giãn thấm hút mồ hôi cực tốt mặc được 2 mặt siêu đẹp",150000,150000,0,0
TIKI,thoi-trang-nu,120421062,"Áo chống nắng toàn thân nữ vải bò Jean 2 lớp dài kín chân - ao chong nang toan than nu vai bo 2 lop",349000,349000,0,0
TIKI,thoi-trang-nu,146774437,"( Big size) Chân váy chữ A nhún có lót quần trong",160000,160000,0,0
TIKI,thoi-trang-nu,179547962,"Quần jean nữ Lưng Cao Julido Store, chất jean co dãn 4 chiều ống ôm chân mẫu Ms623",159000,259000,100000,39
TIKI,thoi-trang-nu,163803666,"Áo kiểu nữ M12",95000,95000,0,0
TIKI,thoi-trang-nu,76463862,"Áo Nịt Ngực Dây Kéo Trước Cao Cấp Dành Cho Tomboy SB Trans - Áo Lót Bó Ép Nịt Làm Nhỏ Ngực Tomboy Thể Thao Gym Thun Ba Lỗ Gen Thun Không Viền Dây Khóa Kéo Trước Bigsize Nguyễn Nguyên",299000,299000,0,0
TIKI,thoi-trang-nu,88769661,"Đồ bơi đôi nam nữ đi biển đẹp, phong cách trẻ trung, áo khoác khóa dài tay, quần sooc đùi thể thao, nữ có áo trong | BN021 | KT021",350000,350000,0,0
TIKI,thoi-trang-nu,107045620,"ĐỒ LAM ĐI CHÙA # ĐỒ ĐI CHÙA # PHÁP PHỤC PHẬT GIÁO #Vải Nhập",427000,427000,0,0
TIKI,thoi-trang-nu,39969258,"Quần lót nữ sexy - màu xanh",25000,25000,0,0
TIKI,thoi-trang-nu,192862109,"Quần jeans nữ suông đứng rách gối HQJeans mẫu mới nhất",350000,350000,0,0
TIKI,thoi-trang-nu,141678914,"Set 05 quần lót nữ BIG SIZE Thun cotton Cạp cao Hàng Việt Nam(Từ 60kg đến 90kg)",109200,109200,0,0
TIKI,thoi-trang-nu,87670677," Áo Chống Nắng 6 Túi Cao Cấp Vải Cotton (L02IM)",163000,163000,0,0
TIKI,thoi-trang-nu,81579779,"Quần Bơi Nữ Ngắn Quần Bơi Rời Short Thun Lạnh Co Giãn Tốt AT212 MayHomes Quần Short Đa Năng Thể Thao, Bơi Lội, GYM, Spa",120000,139000,19000,14
TIKI,thoi-trang-nu,125415293,"Áo Khoác dây kéo viền trắng/ Hoodie Zip WEST {màu Đen/ Xanh/ Hồng} Form rộng Unisex Nam/Nữ cực đẹp chất xịn",106000,106000,0,0
TIKI,thoi-trang-nu,103356842,"Quần Lọt Khe Nữ Ren SEXY C41 - Quần lót lọt khe cotton - Quần lọt khe siêu sexy - Quần lót xuất xịn",33000,33000,0,0
TIKI,thoi-trang-nu,212232443,"Đai Nịt Bụng Callalady Đai Định Hình Bụng Chống Cuộn Siết Eo Gen Bụng Giảm Mỡ Sau Sinh Dễ Sử Dụng Thông Thoáng Co Giãn",245000,245000,0,0
TIKI,thoi-trang-nu,112084786,"GOTI – Áo Kiểu Nữ Thời Trang Công Sở - Áo Sơ Mi Trắng Nữ Dáng Rộng Kiểu Áo Lụa Nữ Cao Cấp 3A10",229000,229000,0,0
TIKI,thoi-trang-nu,104793958,"Quần lót Thái lan 1406 - Free size Form XL - Quần chip bigsize, vải mềm mặc thoải mái",35000,35000,0,0
TIKI,thoi-trang-nu,185684232,"Đồ ngủ sexy nữ bigsize/ Đồ ngủ 2 dây viền ren đen không mút, chất phi mịn quyến rũ 382",52000,52000,0,0
TIKI,thoi-trang-nu,86881225,"( HÀNG SẴN) Áo Phao Nữ Ngắn Siêu Nhẹ Trung Niên Thanh Lịch AK112 - Hàng Quảng Châu Cao Cấp ( (Ảnh thật cuối hình)",325000,325000,0,0
TIKI,thoi-trang-nu,115707331,"Đầm body 2 dây, váy nữ body hở lưng màu đen cá tính",87000,87000,0,0
TIKI,thoi-trang-nu,83033887,"Quần Gen Bụng Cạp Cao Dáng Đùi Mặc Váy Chống Cuộn Chống Gập",180000,180000,0,0
TIKI,thoi-trang-nu,121748552,"Áo len nữ,áo len lưới mỏng ngắn tay thu đông AH30",199000,199000,0,0
TIKI,thoi-trang-nu,161207989,"Áo Lót Bigsize Không Đệm Không Gọng",234000,234000,0,0
TIKI,thoi-trang-nu,98079800,"Đồ bộ dạo phố mặc nhà nữ áo thêu chữ quần sọc caro thun cotton mát mịn trẻ trung năng động size từ 40-64kg",99000,99000,0,0
TIKI,thoi-trang-nu,161978910,"Bộ đồ lót đồ ngủ liền thân voan hoa xuyên thấu cao cấp sexy",198000,198000,0,0
TIKI,thoi-trang-nu,140425069,"Áo Khoác Nhung Gân JONEY Form Rộng Tay Dài Ulzzang",170000,170000,0,0
TIKI,thoi-trang-nu,74910955,"ĐẦM XÒE CỔ LỌ TAY DÀI THANH LỊCH SIZE TỪ 40-70KG",139200,174000,34800,20
TIKI,thoi-trang-nu,168005945,"Áo ren lưới thời trang đi biển lệch vai",250000,250000,0,0
TIKI,thoi-trang-nu,146636191,"Áo thun nam nữ form rộng, Áo phông tay lỡ, chất liệu thun cotton co giãn, áo unisex in hình Lá NeSa Shop",64000,129000,65000,50
TIKI,thoi-trang-nu,55121928,"Bikini Hai Mảnh Gợi Cảm AT066 MayHomes Đồ Bơi Hai Mảnh Dễ Thương",140000,159000,19000,12
TIKI,thoi-trang-nu,192850655,"YU CHERRY | Quần nữ Split Signature Pants YQ016",410000,410000,0,0
TIKI,thoi-trang-nu,83685729,"Đai giảm mỡ bắp đùi",145000,145000,0,0
TIKI,thoi-trang-nu,67040615,"ĐỒ BỘ THỂ THAO NỮ IN HÌNH TIM TN01",139000,139000,0,0
TIKI,thoi-trang-nu,73199857,"Đầm Ôm Dự Tiệc Nữ Kiểu Đầm Dáng Ôm Kèm Áo Khoác Ngắn Cổ Bẻ Thanh Lịch -  THỜI TRANG CÔNG SỞ NỮ CAO CẤP GOTI 3271S",329000,329000,0,0
TIKI,thoi-trang-nu,53642326,"Bộ Đồ Lót Hình Bướm Phối Ren Quần Lọt Khe Áo Bra Xuyên Thấu Sexy Quyến Rũ",8900,8900,0,0
TIKI,thoi-trang-nu,82502579,"ÁO CHỐNG NẮNG TOÀN THÂN CARDINA NỮ - BC6 - S",482000,499000,17000,3
TIKI,thoi-trang-nu,187017923,"Bộ đồ bơi bikini nữ hai mảnh kín đáo đi tắm biển giấu bụng - B.40",166000,179000,13000,7
TIKI,thoi-trang-nu,78892718,"Đầm dự tiệc cổ V bo eo sang chảnh thích hợp mặc đi tiệc, du lịch",280000,280000,0,0
TIKI,thoi-trang-nu,101281202,"Sét 5 ÁO LÁ HỌC SINH  loai cao cấp màu trắng",173250,173250,0,0
TIKI,thoi-trang-nu,80935515,"Áo Khoác Hoodie Chống Nắng Dành cho nam và nữ In Hình PUPPY Có 6 Màu, unisex nỉ ngoại form rộng ulzzang, Áo Khoác Hoodie 0707",103000,103000,0,0
TIKI,thoi-trang-nu,21129179,"Bộ 2 Áo Ngực Nữ Cotton Không Gọng Miley Lingerie BRW_02",429000,870000,441000,51
TIKI,thoi-trang-nu,193886657,"Áo kiểu nữ đẹp tay lỡ cổ tròn NeSa Shop, chất liệu Mango thấm hút mồ hôi, áo nữ đẹp nhiều màu, AKH.57",139000,229000,90000,39
TIKI,thoi-trang-nu,161208180,"Áo ngực cup ngang bigsize (36-44)",249000,249000,0,0
TIKI,thoi-trang-nu,110585936,"Quần ống rộng suông quần ống rộng lưng cao dáng dài khoá sườn chất tuyết mưa",82000,82000,0,0
TIKI,thoi-trang-nu,125021588,"Bộ Đồ Pijama Trung Niên Thun Mềm Đẹp AB32 - Hàng Quảng Châu Cao Cấp",265000,265000,0,0
TIKI,thoi-trang-nu,125022439,"(HÀNG SẴN) Áo Khoác Phao Nữ Ngắn Trẻ Trung Năng Động AK101 - Hàng Quảng Châu Cao Cấp",325000,325000,0,0
TIKI,thoi-trang-nu,13030138,"Bộ Đồ Lót Ren Miley Lingerie BRL12202_FLS1203",249000,385000,136000,35
TIKI,thoi-trang-nu,72902870,"Aó cardigan nữ , áo khoác cardigaN , áo khoác nữ form rộng túi vuông , vải nỉ ngoại chống nắng chống lạnh tốt",95000,95000,0,0
TIKI,thoi-trang-nu,51592298,"Quần lót phối ren hở mông",29000,29000,0,0
TIKI,thoi-trang-nu,91753538,"Áo Khoác Dù Có Mũ  In Hoạ Tiết Mèo Nhật Bản Kute, Form Unisex Cho Nam Nữ, Chất Liệu Dù Cao Cấp_Freesize Dưới 65kg",93000,93000,0,0
TIKI,thoi-trang-nu,175998206,"Áo khoác nỉ nam nữ form rộng đi học có dây kéo áo hoodie nữ form rộng có dây kéo",122000,122000,0,0
TIKI,thoi-trang-nu,66803444,"Áo Cardigan Nữ Họa Tiết Xinh Thời Trang Korea ALN037 MayHomes Mẫu Mới Mùa Xuân",168000,185000,17000,9
TIKI,thoi-trang-nu,118035480,"váy suông nữ,đầm suông nữ cộc tay mùa hè in hình con gấu xinh xắn",79000,79000,0,0
TIKI,thoi-trang-nu,93086199," váy suông nữ cộc tay in chữ cest chic nhiều màu",73000,73000,0,0
TIKI,thoi-trang-nu,113540625,"GOTI - ÁO KIỂU TRUNG NIÊN NỮ - ÁO SƠ MI TRUNG NIÊN PHỐI NÚT TAY LỠ - THỜI TRANG CHO MẸ U50 U60 3A01",239000,239000,0,0
TIKI,thoi-trang-nu,102055047,"Quần legging lửng Hiền Trần BOUTIQUE cạp chun vải cao cấp thun ngố nữ co giãn tốt dáng ôm",92000,120000,28000,23
TIKI,thoi-trang-nu,119090649,"Quần baggy nữ cạp cao 2 cúc HIền Trần BOUTIQUE mặc giấu bụng, tôn dáng",181000,350000,169000,48
TIKI,thoi-trang-nu,165015079,"Xã kho - Set đồ bộ ngắn xinh",150000,150000,0,0
TIKI,thoi-trang-nu,172486316,"Áo thun PT cổ tròn nữ",230000,230000,0,0
TIKI,thoi-trang-nu,152874901,"Set đồ bộ nữ quần short đũi và áo phông xanh cộc tay siêu xinh thời trang Banamo Fashion 111",75000,75000,0,0
TIKI,thoi-trang-nu,75398638," Đồ Bơi Nữ Một Mảnh Họa Tiết Thiên Nga AT089 MayHomes Dễ Thương",146850,165000,18150,11
TIKI,thoi-trang-nu,84825352,"Bộ Đồ Lót Bralette Ren Không Gọng Mút Mỏng Liền S219",231000,231000,0,0
TIKI,thoi-trang-nu,109846309,"Áo Khoác Bomber Nhung Gân Phối Màu Cực Xinh",156000,156000,0,0
TIKI,thoi-trang-nu,77155423,"Jumpsuit trơn sang trọng",230000,230000,0,0
TIKI,thoi-trang-nu,113534975,"Váy suông nữ cộc tay in chữ cest chic nhiều màu lựa chọn",89000,89000,0,0
TIKI,thoi-trang-nu,106011142,"Corset Áo lót mặc trong gen nịt bụng latex màu da",55000,55000,0,0
TIKI,thoi-trang-nu,91474288,"Áo Thun Ngắn Tay, Áo Phông Cộc Tay Nữ Vicci AP.01.1 chất liệu cotton vân gỗ phối hoạ tiết hình Xe đạp",84000,168000,84000,50
TIKI,thoi-trang-nu,1818843,"Áo Ngực Nữ Sinh Triumph T-shirt Bra 421 - Trắng (Size",279000,279000,0,0
TIKI,thoi-trang-nu,183554776,"Quần Lót Nữ Thun Cotton siêu co dãn Lưng Cao Phối Viền Ren Nơ Họa Tiết Hoa Văn Tinh Tế - Quần chip ôm gọn tôn dáng cạp c",15000,15000,0,0
TIKI,thoi-trang-nu,46473261,"Bộ đồ ngủ hình thú bò sữa 1907 liền thân lông mịn Pijama Động Vật Hoạt Hình cho trẻ em người lớn Cosplay",228000,228000,0,0
TIKI,thoi-trang-nu,51267703,"Đồ Bơi Hai Mảnh Tay Dài Tôn Dáng AT151 MayHomes Thun Lạnh Co Giãn Tốt Bền Đẹp",164000,198000,34000,17
TIKI,thoi-trang-nu,179417420,"Bộ mặc nhà nữ form rộng cạp chun . Chất đũi siêu mát,kín đáo,thanh nhã (T43)",252000,252000,0,0
TIKI,thoi-trang-nu,19277671,"Đồ bơi nữ tay dài",402000,402000,0,0
TIKI,thoi-trang-nu,69988346," Quần Mặc Váy Bigsize",64000,64000,0,0
TIKI,thoi-trang-nu,51018791,"COMBO 10 QUẦN COTTON TRƠN FORM CƠ BẢN",165000,165000,0,0
TIKI,thoi-trang-nu,111870033,"Quần ống rộng gân tăm cạp chun nơ",75000,75000,0,0
TIKI,thoi-trang-nu,115241175,"Quần lót đôi băng lụa kháng khuẩn thoáng khí mát lạnh cao cấp K120",69000,69000,0,0
TIKI,thoi-trang-nu,192711777,"YU CHERRY | Áo nữ Tweed Pin Top YA392",300000,300000,0,0
TIKI,thoi-trang-nu,172449931,"Áo thun PT cổ tròn nữ",230000,230000,0,0
TIKI,thoi-trang-nu,100975220,"Quần đùi mặc váy su trơn độn mông tạo dáng quyến rũ",75000,150000,75000,50
TIKI,thoi-trang-nu,74595957,"combo 2 áo, Áo hoodie đôi, hoodie cặp, áo hoodie nam , áo hoodie nữ , áo khoác áo hoodie cặp đôi nam nữ mặc đều được",190000,190000,0,0
TIKI,thoi-trang-nu,161960789,"Đồ lót phụ nữ áo tắm sọc không lưng buộc dây ba điểm hộp đêm cực kỳ hấp dẫn",45000,45000,0,0
TIKI,thoi-trang-nu,97481659,"SET BỘ THỜI TRANG NỮ MÙA HÈ MÁT MẺ",250000,250000,0,0
TIKI,thoi-trang-nu,161208529,"Áo Lót Bigsize Nâng Ngực Không Gọng Bản To Size 36 38 40 42 44 46",90210,90210,0,0
TIKI,thoi-trang-nu,75481444,"Đồ ngủ Cosplay cảnh sát quyến rũ gợi cảm",74100,78000,3900,5
TIKI,thoi-trang-nu,21387874,"Quần độn mông - hông - gen bụng 3in1",165000,165000,0,0
TIKI,thoi-trang-nu,71324722,"Đồ bộ mặc nhà WANNABE BSS05 đồ bộ quần sọt đắp bèo phối áo 2 dây crop top bèo tầng tạo độ phồng cho ngực",430000,430000,0,0
TIKI,thoi-trang-nu,104050175,"Quần Lengging Lửng Nữ Chất Thun Co Dãn 4 Chiều , Quần Ngố Chất Đẹp Dễ Phối Đồ Màu",79000,79000,0,0
TIKI,thoi-trang-nu,178577530,"Áo khoác RECORDS jacket dù 2 lớp unisex nam nữ (Ảnh thật/có sẵn), Áo khoác dù 2 lớp dài rộng y hình thời trang y hình  siêu đẹp dành cho các bạn trẻ",100000,100000,0,0
TIKI,thoi-trang-nu,87961625,"Quần Short Jean Nữ Thương Hiệu Chandi, Quần Sọt Nữ cao cấp mẫu mới hot trend mẫu NT320",220000,220000,0,0
TIKI,thoi-trang-nu,51261923,"Bộ Đồ thú Khủng Long hồng liền thân lông mịn Pijama dành Cho Người Lớn và Trẻ Em kiểu dáng Động Vật Hoạt Hình Cosplay Đầy Đủ Các Mẫu Mã Kích Cỡ nhiều màu đón giáng sinh HOT độc và lạ",219000,219000,0,0
TIKI,thoi-trang-nu,34590099,"Đai sinh nhiệt giảm mỡ bụng Hot Belt cao cấp, size XXL",80000,99000,19000,19
TIKI,thoi-trang-nu,36022492,"Áo Kiểu Nữ Áo Len Nữ Hai Dây Sọc Ngang Dễ Thương ALN021 MayHomes Ôm Thân Xinh Xắn",115000,149000,34000,23
TIKI,thoi-trang-nu,171008027,"Quần lót nữ - quần lọt khe báo 2227",50000,50000,0,0
TIKI,thoi-trang-nu,34346169,"Quần lót nữ xẻ đáy eo thấp - Đen đỏ",29000,29000,0,0
TIKI,thoi-trang-nu,5971343,"Quần Lót Độn Mông Tạo Dáng Gợi Cảm",55000,55000,0,0
TIKI,thoi-trang-nu,1921325,"Áo Ngực Triumph Corsina 01 HP CS-TL - Da (Size",319000,319000,0,0
TIKI,thoi-trang-nu,109231601,"Quần legging nâng mông gen bụng- cạp 6p",79000,79000,0,0
TIKI,thoi-trang-nu,40556816,"[Video SP Thật] Combo 5 Quần Lót Nữ Su Đúc Thông Hơi Viền Ren Cao Cấp Mã N13",71500,71500,0,0
TIKI,thoi-trang-nu,91639268," Áo Bomber Nỉ Bông BADGE Nam/Nữ Unisex",92000,92000,0,0
TIKI,thoi-trang-nu,98256327,"Áo Lót Đệm Mỏng Cho Bé Gái Màu Trắng Cool Teen By Sabina SBC442WH",344000,344000,0,0
TIKI,thoi-trang-nu,68716507,"Chân váy Midi công sở ARCTIC HUNTER Cv26",149000,149000,0,0
TIKI,thoi-trang-nu,102093936,"Áo sơ mi nữ Amazing, màu trắng, tay dài, vải KT silk, size từ 40-80kg",136000,209000,73000,35
TIKI,thoi-trang-nu,114617252,"Áo Chống Nắng 2 lớp Thun Thông Hơi kim cương Chống Tia UV GU",139000,139000,0,0
TIKI,thoi-trang-nu,48852396,"Áo cardigan len nữ 2 túi trước thời trang phong cách Hàn Quốc DV15",350000,350000,0,0
TIKI,thoi-trang-nu,105218414,"Chân váy xòe dài qua gối đắp tà sang trọng - nhiều size và màu, form dáng chuẩn thích hợp mặc đi làm, dự tiệc",185000,185000,0,0
TIKI,thoi-trang-nu,152838014,"Áo Khoác Dù 2 lớp S Nam Nữ Ulzzang Unisex Form Rộng",126000,126000,0,0
TIKI,thoi-trang-nu,43870399,"Quần lót ren lọt khe - đen",19000,19000,0,0
TIKI,thoi-trang-nu,207782653,"Bộ 2 Quần Độn Mông Đúc Dạng Đùi Nâng Mông Cao Cấp",150000,150000,0,0
TIKI,thoi-trang-nu,92023043,"Combo 5Quần lót nữ giúp nâng mông Mara vải lụa Pháp",110000,110000,0,0
TIKI,thoi-trang-nu,104907966,"váy body khoét ngực dây rút 2 bên hông chất zip",155000,155000,0,0
TIKI,thoi-trang-nu,15336917,"Váy ngủ ren sexy trễ vai (Tặng bộ đồ lót PĐ) Freesize AN17",65000,65000,0,0
TIKI,thoi-trang-nu,83616145,"Áo khoác nữ chống nắng toàn thân 3 lớp vải lanh nhung Nhật có khẩu trang dài phủ kín chân - ao chong nang nu",518700,518700,0,0
TIKI,thoi-trang-nu,153470671,"Áo Khoác Nỉ Form Rộng Dây Kéo in chử SOMEDAY, 2 màu đen-hồng, phong cách nhẹ nhàng cho các nàng bánh bèo",122000,122000,0,0
TIKI,thoi-trang-nu,82833837,"ÁO THUN - T-SHIRT BỤI #28 ÁO THUN UNISEX - ALL OR NOTHING",99000,199000,100000,50
TIKI,thoi-trang-nu,146573570,"Quần bầu Cạp Chéo Mèo (Có size đến 100kg)",86940,86940,0,0
TIKI,thoi-trang-nu,184686932,"Đầm linen suông trắng dài,ngắn tay kèm dây thắt eo Haint Boutique Da84",299000,299000,0,0
TIKI,thoi-trang-nu,74859517,"Bikini Sexy Quyến Rũ Gợi Cảm Tặng Kèm Tai Mèo Cosplay Đáng Yêu",65000,65000,0,0
TIKI,thoi-trang-nu,58562009,"BỘ THỜI TRANG NỮ THẮT EO BD20721",336000,336000,0,0
TIKI,thoi-trang-nu,13606102,"Quần đùi short mặc trong váy gân tăm",40000,40000,0,0
TIKI,thoi-trang-nu,187836344,"Quần Lót Nữ - Quần Lọt Khe Thể Thao Cyndie Kyle",35000,35000,0,0
TIKI,thoi-trang-nu,3745027,"Combo 3 Quần Lót Nữ Jobelli 1356 (Size",150000,150000,0,0
TIKI,thoi-trang-nu,106754313,"Quần short nữ chất đũi sần kiểu nhật nhiều màu",45000,45000,0,0
TIKI,thoi-trang-nu,14172789,"Áo ngực ren bralette không gọng Miley Lingerie Sporty Sexy BRL_01",205000,315000,110000,35
TIKI,thoi-trang-nu,148638889,"Áo lót bầu- áo lót cho con bú chống chảy xệ pha REN cao cấp AL08",82000,82000,0,0
TIKI,thoi-trang-nu,146774281,"(BIG SIZE) Chân váy xếp ly cạp cao có quần trong C040",180000,180000,0,0
TIKI,thoi-trang-nu,69458316,"Quần lót nữ thông hơi Corèle V lưng vừa 0249A nhiều màu",114500,229000,114500,50
TIKI,thoi-trang-nu,126210020,"Áo Sơ Mi Caro  Tay Bồng Form Rộng Nam Nữ Ullzang",102000,102000,0,0
TIKI,thoi-trang-nu,133899423,"Bộ đồ ngủ lụa pijamas Pink Stull tay lửng quần ngắn màu trắng/đen/đỏ đô/xanh cốm",385000,385000,0,0
TIKI,thoi-trang-nu,164545375,"Dù ai hối tới hối lui, ế thêm năm nữa vẫn vui như thường. Mã: LV9. Hãy tỏa sáng như kim cương, qua chiếc áo thun Goking siêu hot cho nam nữ trẻ em, áo phông cặp đôi, gia đình, đội nhóm",168000,168000,0,0
TIKI,thoi-trang-nu,192778469,"YU CHERRY | Đầm Hailey Dress YD150",430000,430000,0,0
TIKI,thoi-trang-nu,158722271,"┇☽Set đồ bộ dạo phố, quần dài kem áo cổ kiều nữ, chất thun cát hàn dày dặn, tôn dáng cực xinh, size 45-65kg",185000,185000,0,0
TIKI,thoi-trang-nu,24509494,"Bộ đồ ngủ nữ satin lụa",170000,170000,0,0
TIKI,thoi-trang-nu,186066372,"Bộ bơi đôi nam nữ dài tay, dáng thể thao trẻ trung cá tính, chất thun bơi lạnh cao cấp mịn mát | 020",380000,380000,0,0
TIKI,thoi-trang-nu,171759646,"Sét vest thời trang nữ áo blazer tay ngắn phối quần đùi đa dạng màu sắc (Xanh, Đỏ, Đen, Da)",145000,145000,0,0
TIKI,thoi-trang-nu,192340172,"Bralette Cotton Đệm Mỏng Họa Tiết Kẻ Caro Thoáng Mát Phong Cách Nhật Bản B497",149000,149000,0,0
TIKI,thoi-trang-nu,12710239,"Quần Legging Vicci Cao Cấp Màu Nhũ Cạp Cao 11P",224500,449000,224500,50
TIKI,thoi-trang-nu,141259256,"Áo trễ vai bánh bèo tiểu thư, áo trắng trần trễ vai màu trắng lạ mắt",75000,75000,0,0
TIKI,thoi-trang-nu,190806299,"Áo khoác hoodie vải nỉ co dãn, dày dặn mềm mịn form rộng Basic, Áo KHOÁC Hoodie RIPO Ulzzang Unisex Vải đẹp , không co rút , mềm mịn , hút mồ hôi cực nhanh, mặc siêu mát",99000,99000,0,0
TIKI,thoi-trang-nu,97819145,"Cosplay Hầu Gái Nhật Bản Sexy - Bộ Đồ Ngủ Cô Giúp Việc Quyến Rũ Gợi Cảm - Maid Cosplay Outfit",157000,157000,0,0
TIKI,thoi-trang-nu,87733605,"Quần lót cotton kháng khuẩn nhật bản kèm túi zịp",28000,28000,0,0
TIKI,thoi-trang-nu,85392984,"Quần ống suông cạp liền xuốt eo khóa trước xinh xắn",82000,82000,0,0
TIKI,thoi-trang-nu,187662142,"Đầm suông hè nữ cổ V chất linen mát thời trang hè cho nữ ARCTIC HUNTER AH164",259000,259000,0,0
TIKI,thoi-trang-nu,26225129,"Đồ bơi che khuyết điểm",280000,280000,0,0
TIKI,thoi-trang-nu,66823994,"Bộ đồ bơi thun lạnh kiểu dáng thể thao",188055,188055,0,0
TIKI,thoi-trang-nu,66704691,"Áo Len Cardigan Nữ Khóa Kéo Tay Bồng Họa Tiết Xinh Thời Trang Korea ALN036 MayHomes Mẫu Mới Đông Xuân",195960,213000,17040,8
TIKI,thoi-trang-nu,34561282,"Chân Váy Xếp Ly Kèm Belt Nana",138000,138000,0,0
TIKI,thoi-trang-nu,67911264,"CHÂN VÁY HOA NHÍ TIGOON DỊU DÀNG - Hoa Vàng - L",136000,136000,0,0
TIKI,thoi-trang-nu,190739881,"Đồ Bơi Nữ Một Mảnh Kín Đáo Tôn Dáng Có Size Lớn AT230 MayHomes Bigsize One-Piece Swimsuits",181440,189000,7560,4
TIKI,thoi-trang-nu,164961278,"Quần Lót Nữ, Bộ 5 Quần Lót Ren Nữ Cao Cấp Mềm Mịn Hàng Thương Gia, Quần Lót Nữ Kháng Khuẩn, Quần Lót Nữ Co Giãn Tốt Thương Hiệu Baw Mã QLN154",199000,199000,0,0
TIKI,thoi-trang-nu,37833320,"Set 10 Quần Lót Nữ Cotton Pulo Siêu Thoải Mái",106000,106000,0,0
TIKI,thoi-trang-nu,91475587,"Mẫu mới đầm xòe dự tiệc nhún bèo thắt eo duyên dáng đủ size từ 40-71kg",177000,177000,0,0
TIKI,thoi-trang-nu,14432854,"Miếng Dán Nhũ Hoa (12 Miếng) Nhật Bản",58500,58500,0,0
TIKI,thoi-trang-nu,177188953,"Quần short nữ ống rộng lưng cao mặc ở nhà Doloxi cạp chun vải đũi Q054",38000,38000,0,0
TIKI,thoi-trang-nu,127368560,"Quần đùi nữ mặc nhà, quần sooc nữ ống rộng chun lưng chất đũi 3 màu",45000,45000,0,0
TIKI,thoi-trang-nu,23618307,"Set Đồ Lót Và Áo Choàng Ren Mềm Mại, Sexy",120000,120000,0,0
TIKI,thoi-trang-nu,118043299,"áo lam đi chùa, đồ phật tử, hò tuyển thống nút thắt, thời trang nữ tay dài",192000,192000,0,0
TIKI,thoi-trang-nu,67545345,"Áo Sơ Mi Nữ Công Sở Ngắn Tay Phối Viền Nút Cao Cấp",157000,157000,0,0
TIKI,thoi-trang-nu,43181192,"CHÂN VÁY PHỐI NÚT SANG CHẢNH HELEN",138000,138000,0,0
TIKI,thoi-trang-nu,170498128,"Quần lót ren nữ sexy Corèle V.  02133A lưng vừa nhiều màu",130000,160000,30000,19
TIKI,thoi-trang-nu,103433177,"Quần ống rộng khóa sườn dáng dài éo thon, mặc cực mát, tôn dáng",85000,85000,0,0
TIKI,thoi-trang-nu,15778396,"Áo Sơ Mi Nữ Trắng",80000,80000,0,0
TIKI,thoi-trang-nu,105675753,"chân váy đuôi cá chất tuyết mưa lịch sự",89000,89000,0,0
TIKI,thoi-trang-nu,107153886,"Bộ đồ lót liền quần phối ren phong cách quyến rũ cho phái nữ - Tím",35000,35000,0,0
TIKI,thoi-trang-nu,189182050,"Đồ mặc nhà nữ quần đùi cotton cao cấp 8104",292000,292000,0,0
TIKI,thoi-trang-nu,172936035,"Quần short nữ Hiền Trần  BOUTIQUE cạp cao đùi ngắn chất vải Umi Hàn cao cấp co giãn khóa kéo tôn dáng đồ mặc nhà",153000,230000,77000,33
TIKI,thoi-trang-nu,58234428,"Đồ bộ mặc nhà pijama, lụa satin sang trọng",135000,135000,0,0
TIKI,thoi-trang-nu,84820931," Quần Lót Lọt Khe Cotton Allmix Girl Sport Cạp Nhỏ P277",36000,36000,0,0
TIKI,thoi-trang-nu,73435995,"Áo Lót Mút Dày Nâng Ngực Không Gọng Basic Doomm Non Wire By Sabina SBA2122",579000,579000,0,0
TIKI,thoi-trang-nu,73504366,"Đầm tay dài khoét eo nữ cá tính",182000,182000,0,0
TIKI,thoi-trang-nu,197192815,"Áo Khoác Dù Mis Floss Jacket Symbolic, Áo khoác dù unisex vải dù 2 lớp Aasics phong cách Ulzzang, áo khoác dù thể thao cổ sơ mi",99000,99000,0,0
TIKI,thoi-trang-nu,75353441,"Gen định hình giảm mỡ bắp tay",120000,120000,0,0
TIKI,thoi-trang-nu,78955023,"SET 5 QUẦN LÓT COTTON lụa thông hơi mềm mại phối viền ren xinh xắn (Giao Màu Ngẫu Nhiên)",111000,111000,0,0
TIKI,thoi-trang-nu,140921579,"Đồ bộ mặc nhà đẹp, chất lụa hàn",191250,191250,0,0
TIKI,thoi-trang-nu,57897410,"Bikini Tươi Trẻ Tay Dài Form Croptop AT073 MayHomes, Đồ Bơi Nữ Thun Lạnh",140000,159000,19000,12
TIKI,thoi-trang-nu,67956527,"Đầm ôm body đuôi cá phối ren duyên dáng size từ 40-71kg",119200,149000,29800,20
TIKI,thoi-trang-nu,192714118,"YU CHERRY | Áo nữ Pattern Spandex Shirt YA378",340000,340000,0,0
TIKI,thoi-trang-nu,55728548,"Mặt nạ hoá trang ren đính hoa bướm nhiều màu",54000,54000,0,0
TIKI,thoi-trang-nu,103357370,"Quần chip lọt khe nữ - quần lót lọt khe nữ sexy C1- quần lót nữ sexy - quần lót xẻ đáy nữ- quần lọt khe xẻ đáy",30000,30000,0,0
TIKI,thoi-trang-nu,185842933,"Hộp 10 miếng dán ngực Silicon dùng nhiều lần -  Hộp xanh - DNHX",9000,9000,0,0
TIKI,thoi-trang-nu,150213932,"Bộ đồ bảo hộ lao động kaki loại dày ngắn tay khóa kéo SHUNI 010B phong cách Hàn Quốc",239000,239000,0,0
TIKI,thoi-trang-nu,84820031," Bộ Đồ Lót Không Đệm Có Gọng Ren Hoa Quyến Rũ Mới S053",253000,253000,0,0
TIKI,thoi-trang-nu,107154392,"Set đồ lót sexy Bodysuit",45000,45000,0,0
TIKI,thoi-trang-nu,197192482,"Áo Hoodie oversize nam nữ BANUR COMMUNIT + HÌNH THẬT, Áo khoác hoodie camera phù nam nữ giá rẻ chất nỉ bông siêu đẹp",99000,99000,0,0
TIKI,thoi-trang-nu,88896253,"Bikini liền thân phối bèo ôm sát tôn dáng, áo tắm một mảnh sexy quyến rũ khoe khéo vòng một | KT088",250000,250000,0,0
TIKI,thoi-trang-nu,154491940,"[Có Sẵn + From Đẹp] Áo Khoác Da Croptop Đai Chéo Eo quyến rũ cá tính cho Nữ",450000,450000,0,0
TIKI,thoi-trang-nu,132127662,"Áo thun trơn màu cam nhạt phông unisex basic nam nữ cổ tròn thun cotton 4 chiều mềm mịn ATTCN | SG",50000,50000,0,0
TIKI,thoi-trang-nu,196780483,"Hộp 4 Cặp Dán Ngực Cực Chắc Sử Dụng Nhiều Lần",50000,50000,0,0
TIKI,thoi-trang-nu,51705859,"Bộ Đồ Mặc Nhà Hai Dây Quyến Rũ, Bộ Đồ Ngủ Satin Viền Ren Tinh Tế, Gợi Cảm iBasic HOMY015- Hàng Chính Hãng",269000,399000,130000,33
TIKI,thoi-trang-nu,66719318,"Áo Len Nữ Cổ Chui Thời Trang Mới Hàn Quốc ALN035 MayHomes Thời Trang Thu Đông",189050,199000,9950,5
TIKI,thoi-trang-nu,190794005,"Áo khoác da lộn 2 lớp lót dù có túi trong logo kasheng,  Áo Khoác Bomber Nữ Chữ H Kasheng, Áo khoác lửng croptop bomber thêu chữ kaki da lộn 2 lớp unisex ulzzang nam nữjin",156000,156000,0,0
TIKI,thoi-trang-nu,146504894,"ÁO KHOÁC NỈ BOMBER NAM NỮ PHONG CÁCH HÀN QUỐC CỰC ĐẸP HOTTREND DÀNH CHO CÁC BẠN TRẺ TKT",93000,93000,0,0
TIKI,thoi-trang-nu,184823350,"Áo Thun Andromeda Nam Nữ Phom Rộng Nhiều Màu Ngắn Tay Cổ Tròn",49000,49000,0,0
TIKI,thoi-trang-nu,132904089,"Đồ mặc nhà nữ thu đông cotton mịn đẹp 5119",384000,384000,0,0
TIKI,thoi-trang-nu,85301553," Áo Lót Nâng Ngực Multiway 7 Kiểu",64990,64990,0,0
TIKI,thoi-trang-nu,58366098,"Băng Keo Vải Dán Ngực Tomboy - Cuộn Băng Miếng Keo Dính Dán Nịt Định Hình Ngực Cho Tomboy Nguyễn Nguyên",57750,57750,0,0
TIKI,thoi-trang-nu,69994739,"Áo lót có gọng cho người ngực to",162000,162000,0,0
TIKI,thoi-trang-nu,121248942,"Bộ đồ ngủ lụa Pijamas thêu Pink Stull tay ngắn quần ngắn màu kem sữa",335000,335000,0,0
TIKI,thoi-trang-nu,177188447,"Quần tây nữ lưng cao đi học ống đứng 3 khuy đẹp cao cấp Hàn Quốc Q198",85000,85000,0,0
TIKI,thoi-trang-nu,116033776,"Đồ ngủ an phước váy ngủ đẹp kín đáo",136000,136000,0,0
TIKI,thoi-trang-nu,99220377,"Quần baggy nữ Hiền Trần BOUTIQUE cạp cao vải Vitex cao cấp quần công sở 4 cúc bấm sang trọng thanh lịch",213000,350000,137000,39
TIKI,thoi-trang-nu,54460547,"Quần jogger nữ 1 sọc dọc, hai túi trước có khóa kéo chống rớt đồ, bo lưng thun phù hợp nhiều cỡ bụng Phúc An 3017",71000,71000,0,0
TIKI,thoi-trang-nu,161208761,"COMBO 3 QUẦN CHIP LỌT KHE BIGSIZE",206000,206000,0,0
TIKI,thoi-trang-nu,72909404,"Áo Phông Hero Team Mèo Simmy",126500,126500,0,0
TIKI,thoi-trang-nu,81307260,"Đai nịt bụng Latex thông hơi 9 xương hàng nhập khẩu ITALIA",350000,350000,0,0
TIKI,thoi-trang-nu,118022966,"ĐỒ LAM ĐI CHÙA # Cổ Tàu Viền # Đồ Bộ # Rẻ Đẹp # Quần Áo Nữ",187000,187000,0,0
TIKI,thoi-trang-nu,193195591,"Áo Khoác Bomber Dù Kiểu Croptop Lửng 2 lớp Chữ S - Nút Bấm - tay Cánh Dơi Form Unisex HÀn Quốc Đẹp - Chống Nắng",92000,92000,0,0
TIKI,thoi-trang-nu,131417839,"Áo dạ nữ - kiểu dáng tay lỡ, trẻ trung, dễ mix đồ (N5)",259000,259000,0,0
TIKI,thoi-trang-nu,93048143,"quần short nữ đùi chất đũi sần nhẹ mát",39000,39000,0,0
TIKI,thoi-trang-nu,79724249,"Áo khoác dù nam nữ kiểu bomber",134000,134000,0,0
TIKI,thoi-trang-nu,183556742,"Đầm linen nữ dáng suông cổ trụ phối nút, đầm nữ chất chất linen mát kèm dây thắt eo Haint Boutique Da62",299000,299000,0,0
TIKI,thoi-trang-nu,186285081,"Set Áo Tanktop & Bra GNASH Unisex (Trắng/Đen)",87000,87000,0,0
TIKI,thoi-trang-nu,14956975,"Combo 10 quần lót nữ Su đúc hàng đẹp loại xịn ZSD001",150000,150000,0,0
TIKI,thoi-trang-nu,235885052,"Áo lót trơn không gọng mút đệm vừa cotton thêu vân gân lá",78000,78000,0,0
TIKI,thoi-trang-nu,189641794,"áo khoác chống nắng logo thê nón 2 lớp trùm qua đầu from rộng unisex ulzzang Nam Nữ  đều mặc được Phong Cách Hàn Quốc, Áo khoác unisex nỉ hoodie nam nữ dây kéo zip chống nắng logo",100000,100000,0,0
TIKI,thoi-trang-nu,192718019,"YU CHERRY | Đầm cổ yếm nữ, không tay thêu họa tiết đám mây Mimi Yem Dress YD160",445000,445000,0,0
TIKI,thoi-trang-nu,137524687,"Bomber, áo khoác Ar gió 2 lớp form rộng unisex cực chất, Áo Khoác Nữ, Áo Khoác Bomber AR Chất Nỉ Ngoại 2 Màu Đen/Trắng Fom To",110000,110000,0,0
TIKI,thoi-trang-nu,136200284,"Gen nịt bụng chống cuộn - đai nịt bụng sau sinh 6 nấc cài - G02",45000,45000,0,0
TIKI,thoi-trang-nu,126040378,"áo nữ hoạ tiết thêu - sang chảnh, siêu mát cho mùa hè (Q3)",159000,159000,0,0
TIKI,thoi-trang-nu,68196302,"Quần ống suông rộng culottes gân tăm mềm mát",69000,69000,0,0
TIKI,thoi-trang-nu,84824542,"Bralette Ren Lưới Lót Mỏng Siêu Thoáng B333",158000,158000,0,0
TIKI,thoi-trang-nu,155271469,"Áo ngực annie , mouse mỏng, bảo vệ dáng ngực. Mã BFA 3012- cài trước",147260,199000,51740,26
TIKI,thoi-trang-nu,95204897,"ÁO KHOÁC CARDIGAN NỮ THỜI TRANG CỰC ĐẸP DUYÊN DÁNG VIỆT HÀNG MỚI",93000,93000,0,0
TIKI,thoi-trang-nu,134381706,"quần ống rộng - thoải mái cho ngày hè, chất liệu đũi - Full size (H3)",139000,139000,0,0
TIKI,thoi-trang-nu,184245486,"Quần lót nguyệt san MENE period panties A REVOLUTION FOR WOMEN Kiểu thoải mái bản rộng",380000,380000,0,0
TIKI,thoi-trang-nu,132356100,"Combo 5 quần lót nữ su thông hơi không hằn (40kg-68kg)",122850,122850,0,0
TIKI,thoi-trang-nu,96990627,"Quần lót lọt khe nơ nhỏ xinh",29000,29000,0,0
TIKI,thoi-trang-nu,160217131,"Quần Jeans nữ baggy lưng cao Novelty MS694",312000,390000,78000,20
TIKI,thoi-trang-nu,155143626,"QUẦN ÁO DÀI - Q02",140000,140000,0,0
TIKI,thoi-trang-nu,26425331,"Dây áo ngực bra cao cấp đính đá hình nơ lấp lánh sang chảnh DA32",95000,95000,0,0
TIKI,thoi-trang-nu,23394234,"Áo Ngực Nữ Nâng Ngực D410 WHU Triumph E001879 - Màu Da (Size",399000,399000,0,0
TIKI,thoi-trang-nu,6388355,"Quần lót độn mông gen bụng cao cấp",82000,82000,0,0
TIKI,thoi-trang-nu,105326989,"Áo Sơ mi oversize caro vàng",99000,99000,0,0
TIKI,thoi-trang-nu,94902348,"Áo cổ nữ cổ V sang chảnh - nhiều size và màu, form dáng chuẩn thích hợp mặc đi làm, dự tiệc",148000,148000,0,0
TIKI,thoi-trang-nu,101281338,"Áo khoác nỉ thun coton da cá chống nắng cao cấp nhiều màu  MS02 Freesize 40- 56kg",193200,193200,0,0
TIKI,thoi-trang-nu,91512244,"Áo kiểu cổ V tay xẻ sang trọng - nhiều size và màu, form dáng chuẩn thích hợp mặc đi làm, dự tiệc",185000,185000,0,0
TIKI,thoi-trang-nu,124585912,"Áo kiểu nữ,áo đũi nhăn nữ trễ vai xinh xắn ALe26",199000,199000,0,0
TIKI,thoi-trang-nu,119670023,"Bộ Đồ thú Khủng Long xanh liền thân lông mịn Pijama dành Cho Người Lớn và Trẻ Em kiểu dáng Động Vật Hoạt Hình Cosplay",269000,269000,0,0
TIKI,thoi-trang-nu,80915097,"Quần lót nữ buộc dây gợi cảm quyến rũ",29000,29000,0,0
TIKI,thoi-trang-nu,36434705,"Áo Sơ Mi Nữ Ngắn Tay Màu Trắng N8919-01-01",198000,198000,0,0
TIKI,thoi-trang-nu,174550790,"Áo Thun Cá Sấu Nam Nữ Thời Trang Cao Cấp 40kg-80kg (MS06)",100000,100000,0,0
TIKI,thoi-trang-nu,77082358,"Đầm ngủ hoa thêu trong suốt sexy",78500,78500,0,0
TIKI,thoi-trang-nu,112463798,"Đồ bộ lửng cotton cao cấp mịn đẹp 5052",292000,292000,0,0
TIKI,thoi-trang-nu,176405795,"Áo Khoác Form Croptop Da Lộn ️ Áo Khoác Croptop Nhung Lì 2 Lớp Dày Dặn Form Nữ",169000,169000,0,0
TIKI,thoi-trang-nu,14815686,"Đầm Xòe Đính Ngọc",165000,165000,0,0
TIKI,thoi-trang-nu,7588679,"Combo 5 quần chip su hoa điều hòa, mịn mát (màu ngẫu nhiên)",135000,145000,10000,7
TIKI,thoi-trang-nu,273263755,"Áo thun nữ MXM in chữ M cổ tròn cotton 4 chiều form ôm body cực tôn dáng ( ANU003 )",83000,83000,0,0
TIKI,thoi-trang-nu,193645618,"Đai Nịt Bụng Latex 19 xương che mỡ lưng, giảm mỡ bụng VITA LATEX Cao Cấp",446000,446000,0,0
TIKI,thoi-trang-nu,132133758,"Áo đồng phục gia đình 3/4/5 người thun cotton mềm mịn mẫu cầu vồng màu trắng GD304T | SG",49000,49000,0,0
TIKI,thoi-trang-nu,70807369,"Váy ngủ 2 dây hở bụng cách tân mới",124000,124000,0,0
TIKI,thoi-trang-nu,116177932,"Áo phông nữ, áo thun cổ tim chất giấy siêu mát",47000,47000,0,0
TIKI,thoi-trang-nu,170886864,"Đồ bộ nữ,đồ ngủ mặc nhà lửng vải lụa mango BL 66 họa tiết chữ siêu cute size đại 58-65kg",141750,141750,0,0
TIKI,thoi-trang-nu,113066211,"Áo khoác nỉ, áo khoác hoodie nữ THÊU GẤU cực đẹp shopmap",104000,104000,0,0
TIKI,thoi-trang-nu,74219073,"Gen định hình sau hut mỡ đùi bắp tay bụng",1550000,1550000,0,0
TIKI,thoi-trang-nu,75636304,"Gen quấn nóng bắp đùi Đai gen định hình bắp tay",120000,120000,0,0
TIKI,thoi-trang-nu,8242926,"Quần Gen Bụng Có Thanh Chống Cuộn",57750,57750,0,0
TIKI,thoi-trang-nu,177189836,"Quần baggy nữ công sở cạp cao cúc lệch gấu bằng dáng đẹp cao cấp Hàn Quốc, Quần baggy nữ công sở cạp cao Q068",79000,79000,0,0
TIKI,thoi-trang-nu,196001667,"Bộ ngủ hai dây mảnh , set ngủ hai dây mát lạnh",85000,85000,0,0
TIKI,thoi-trang-nu,72613634,"Áo sơ mi nữ Linen Kẻ caro phối màu trẻ trung Đũi Việt DV175",149000,149000,0,0
TIKI,thoi-trang-nu,38122763,"Set thời trang 788881",250000,250000,0,0
TIKI,thoi-trang-nu,118017768,"Đồ Lam Đi Chùa # Nhật Nơ thêu # Đồ Bộ Nữ # Quần Áo Nữ",186000,186000,0,0
TIKI,thoi-trang-nu,107153946,"Set áo yếm kèm quần lót nữ chất mát gợi cảm",35000,35000,0,0
TIKI,thoi-trang-nu,26432284,"Dây áo ngực bra đính đá cao cấp dùng cho áo hở cổ - Váy dạ hội - Váy cưới DA04",96000,96000,0,0
TIKI,thoi-trang-nu,114415775,"( Ảnh Thật ) Áo khoác dù Swe chất dù cao cấp 2 lớp form rộng Unisex Nam nữ Couple đều mặc được - Áo khoác gió HL, Áo Khoác Bomber Dù Chất Dù 2 Lớp Form chuẩn Unisex Nam Nữ Couple",99000,99000,0,0
TIKI,thoi-trang-nu,148639723,"Quần bầu dài legging cạp chéo co giãn thoải mái hàng đẹp QB1111",75000,75000,0,0
TIKI,thoi-trang-nu,86138823,"Quần lót nữ Su đúc Thun lạnh Không đường may - Hàng loại 1 cao cấp - [Tặng kèm túi zip du lịch nhỏ xinh 10x15cm tiện lợi khi mua bộ 10 quần",25000,25000,0,0
TIKI,thoi-trang-nu,187511302,"Áo Hoodie Zip Nỉ Bông Sadboizvibes Nón 2 Lớp Unisex Freesize Nam Nữ",92000,92000,0,0
TIKI,thoi-trang-nu,3744899,"Combo 5 Quần Lót Nữ Jobelli 1261 (Size",245000,245000,0,0
TIKI,thoi-trang-nu,105708397,"Áo Lót Quây Ren Đệm Mỏng Có Gọng Quyến Rũ B474",189000,189000,0,0
TIKI,thoi-trang-nu,83844326,"Áo Lót Nữ Mút Dày Nền Sọc Xanh By Sabina SBA688GL",491000,491000,0,0
TIKI,thoi-trang-nu,134817893,"set đồ nữ thu đông dài tay quần jogger in chữ COSMOS 3 màu",120000,120000,0,0
TIKI,thoi-trang-nu,174295160,"Áo Khoác Dù Nam Nữ Unisex - Áo Khoác Jacket Bombers FOREST (có form rộng XL)",109000,109000,0,0
TIKI,thoi-trang-nu,141281473,"Áo khoác dù bomber unisex nam nữ cổ tròn siêu đẹp , chất hottrend hiện nay TRANG NEMO",91000,91000,0,0
TIKI,thoi-trang-nu,146575378,"Quần lót bầu cạp chéo cotton nhiều màu sắc QL001",13734,13734,0,0
TIKI,thoi-trang-nu,154477231,"Áo Cardigan Nỉ Bông Thêu Len Sợi Chữ R M513-Teen 888",117000,117000,0,0
TIKI,thoi-trang-nu,196522736,"MLB - Quần legging nữ Wms Classic Monogram Allover 3FLGM0124",500000,2690000,2190000,81
TIKI,thoi-trang-nu,174379927,"Áo Thun Cá Sấu Nữ Có Cổ -Màu ghi .(45-75kg)",96000,96000,0,0
TIKI,thoi-trang-nu,180590331,"Đầm ngủ phi lụa cao cấp WANNABE DNS50 váy ngủ hai dây cut-out lưng trang trí 4 dây hình chữ M khoe eo quyến rũ gợi cảm",350000,350000,0,0
TIKI,thoi-trang-nu,69994231,"Áo Lót Định Hình Ngực Bigsize 36-44DE",186900,186900,0,0
TIKI,thoi-trang-nu,77769472,"Áo Khoác Nhung Gân Kiểu Bomber Thêu Logo Xinh Xắn Trẻ Trung _Pha Lê SHop",159000,159000,0,0
TIKI,thoi-trang-nu,68458478,"Váy ngủ 2 dây ren mềm mại cổ điển",81000,81000,0,0
TIKI,thoi-trang-nu,43888702,"Sét quần lót áo ngực gợi cảm - đỏ",35000,35000,0,0
TIKI,thoi-trang-nu,51060928,"ÁO LÓT NỮ KHÔNG GỌNG NÂNG NGỰC HỌA TIẾT HÌNH CHIẾC LÁ",72600,72600,0,0
TIKI,thoi-trang-nu,177189936,"Quần lót nữ cotton nhật hình quả bơ cao cấp cute dễ thương đáng yêu Q010",14000,14000,0,0
TIKI,thoi-trang-nu,40799636,"Quần lót nữ sexy ren mỏng phía trước hở mông lọt khe - Màu trắng",18000,18000,0,0
TIKI,thoi-trang-nu,50599543,"Combo 10 Quần Lót Su Lượn Lưng Siêu Xịn Mềm Mịn 1033 - Giao Nhiều Màu Ngẫu Nhiên, Chất Vải Trơn, Mát Lạnh, Ôm Sát Cơ Thể, Phù Hợp Với Nhiều Loại Trang Phục",171690,171690,0,0
TIKI,thoi-trang-nu,154856291,"Quần Kẻ Sọc Caro Dáng Suông/ Quần ống rộng kẻ caro nam nữ 2 màu basic_Moonunisex",100000,100000,0,0
TIKI,thoi-trang-nu,195774050,"Quần lót nữ cotton cao cấp kháng khuẩn dành cho học sinh cấp 1 cấp 2 cấp 3 chất liệu mềm mại thoáng mát họa tiết dễ thương Lá Bralette Q31",39000,39000,0,0
TIKI,thoi-trang-nu,185353545,"Đầm bầu suông linen cổ tròn ngắn tay mặc hè, chất linen tự nhiên mềm mát Haint Boutique B84",279000,279000,0,0
TIKI,thoi-trang-nu,6601039,"Bộ 2 Quần Gen Bụng Sau Sinh Hàn Quốc Làm Eo Thon (Da + Đen)",88000,88000,0,0
TIKI,thoi-trang-nu,146573631,"Váy ngủ, váy mặc nhà cộc tay dáng suông chất cotton mềm mát họa tiết hoạt hình dễ thương (KHÔNG KÈM TÚI) V285",69300,69300,0,0
TIKI,thoi-trang-nu,183053124,"Áo Khoác Dù 2 lớp Form Rộng ACOVER màu TRẮNG Nam Nữ Unisex Áo Jacket dây kéo Ulzzang",125000,125000,0,0
TIKI,thoi-trang-nu,48106935,"Áo choàng ngủ nữ trắng trong suốt viền ren gợi cảm",63000,63000,0,0
TIKI,thoi-trang-nu,69992798,"Áo Dán Ngực Có Size Lớn",147000,147000,0,0
TIKI,thoi-trang-nu,188447749,"Quần lót gen bụng cạp cao Nhật bản",50000,50000,0,0
TIKI,thoi-trang-nu,53329582,"Combo 2 Gen Nịt Bụng Giảm Mỡ - Đai Nịt Bụng Sau Sinh Mã G01-2",75900,75900,0,0
TIKI,thoi-trang-nu,124239104,"Áo hai dây montergi 2 màu đen trăng siêm ôm siêu co dãn",39000,39000,0,0
TIKI,thoi-trang-nu,185684460,"Đầm ngủ bigsize, váy ngủ 2 dây phi mềm không mút quyến rũ phối ren đen",52000,52000,0,0
TIKI,thoi-trang-nu,192538177,"Đồ bộ nữ,đồ ngủ mặc nhà lửng 9 tấc vải lụa mango BL 53 họa tiết hoa nhí siêu cute size 47-60kg",149000,149000,0,0
TIKI,thoi-trang-nu,176685316,"váy mặc đẹp",212500,212500,0,0
TIKI,thoi-trang-nu,44524519,"Quần lọt khe đính hạt - hồng",25000,25000,0,0
TIKI,thoi-trang-nu,100515195,"Bikini tay dài áo croptop quần dài cạp cao viền chỉ trắng",360000,360000,0,0
TIKI,thoi-trang-nu,85372887,"Áo Khoác Dù Hai Lớp Unisex, Áo Khoác Bomber Form Rộng 2 Màu Trắng Đen 28 Nam Nữ Ulzzang, Labibi",102000,102000,0,0
TIKI,thoi-trang-nu,99418208,"quần lót nữ chất cotton, mền.combo 5 cái",53625,53625,0,0
TIKI,thoi-trang-nu,84750030,"SƠ MI KHOÁC NHUNG TĂM HÀN QUỐC (ảnh thật/sẵn)",152000,152000,0,0
TIKI,thoi-trang-nu,73484279,"Áo ngực đúc su không gọng, mút  đệm vừa 1,5 cm, , áo lót nữ  cao cấp không gọng siêu quyến rũ 4 mầu lựa chọn, áp chip thông hơi AS87",61000,61000,0,0
TIKI,thoi-trang-nu,77900321,"Áo sơ mi nữ công sở thiết kế tay dài chiết eo SM150",159000,159000,0,0
TIKI,thoi-trang-nu,73509674,"Quần Lọt quần chip Khe Nữ Ren Xẻ Đáy Freesize SEXY - Trắng",12000,12000,0,0
TIKI,thoi-trang-nu,107154996,"Quần Lót 2 người siêu co giãn quyến rũ cho cặp đôi",35000,35000,0,0
TIKI,thoi-trang-nu,160793150,"Combo 2 quần lót nữ ren lọt khe, dây hông mảnh trẻ trung, thoải mái, thoáng mát (màu ngẫu nhiên) LYEQ055",73000,78000,5000,6
TIKI,thoi-trang-nu,20908424,"Đầm Xòe Nữ Họa Tiết - Trắng (Size",390000,390000,0,0
TIKI,thoi-trang-nu,185592302,"Combo 2 quần lọt khe ren hở mông, quần chip nữ, quần lót nữ sexy không đáy, đính nơ to xinh xắn, gợi cảm LYEQ064 ( MÀU NGẪU NHIÊN)",65000,65000,0,0
TIKI,thoi-trang-nu,90333691,"Đầm váy hoa nữ cúc dọc ARCTIC HUNTER, đầm suông dạo phố nữ AH56",199000,199000,0,0
TIKI,thoi-trang-nu,174580442,"Quần lót nữ lọt khe ren hình con bướm sexy Q405 - Quần lọt khe nữ gợi cảm - Quần chip nữ - Quần lót nữ",50000,99000,49000,49
TIKI,thoi-trang-nu,135064532,"Áo khoác hoodie nỉ form rộng cho nữ áo hoodie zip trơn 1 màu xám sành điệu, áo khoác chống nắng unisex ulzzang phong cách hàn quốc",96000,96000,0,0
TIKI,thoi-trang-nu,194065187,"Đầm suông nữ ĐŨI VIỆT, đầm cổ tàu form rộng phong cách Nhật Bản chất đũi mềm mát, thời trang thương hiệu chính hãng DV80",249000,249000,0,0
TIKI,thoi-trang-nu,51022677,"COMBO 10 QUẦN THÔNG HƠI REN ỐNG 7633",175000,175000,0,0
TIKI,thoi-trang-nu,25325197,"Chân váy chữ A vải kaki cao cấp túi ngang free size mẫu mới nhiều mầu VAY22",185000,185000,0,0
TIKI,thoi-trang-nu,180972231,"Bộ đồ Pyjama nữ, đồ mặc nhà lụa VILADY - B141 kiểu tay cộc quần dài họa tiết Ziczac chất liệu lụa Pháp (lụa latin) - Màu đỏ",511000,550000,39000,7
TIKI,thoi-trang-nu,180396501,"Váy sơ mi dáng suông cổ V,Đầm sơ mi đũi túi ngực kèm dây thắt eo,phong cách mùa hè Hàn Quốc thương hiệu chính hãng Đũi Việt Dv72",350000,350000,0,0
TIKI,thoi-trang-nu,140563231,"Combo 5 Quần Lót Nữ Kháng Khuẩn Xuất Nhật Nâng Mông Lưng Cao Freesize (giao màu ngẫu nhiên)",122000,122000,0,0
TIKI,thoi-trang-nu,103888950,"Đầm xòe trắng dự tiệc cổ bẻ đính nút sang trọng, dáng đẹp GR186",165000,165000,0,0
TIKI,thoi-trang-nu,152565767,"quần ống loe nữ cạp cao dáng dài legging, quần tây ống loe nữ ôm vải mềm lưng chun co giãn",82000,82000,0,0
TIKI,thoi-trang-nu,93253519,"Jum cổ yếm phối trắng phong cách sang trọng",207000,207000,0,0
TIKI,thoi-trang-nu,57680983,"Chân váy voan mềm tung bay phong cách Vintage Châu Âu VAY66 free size",185000,185000,0,0
TIKI,thoi-trang-nu,125022180,"( HÀNG SẴN) Áo Khoác Dạ Nữ Đẹp Dáng Dài Thời Trang AD29 - Hàng Quảng Châu Cao Cấp",445000,445000,0,0
TIKI,thoi-trang-nu,135299123,"JUMPSUIT CỔ V JANY",189000,189000,0,0
TIKI,thoi-trang-nu,152560118,"áo sơ mi nữ form rộng tay dài kiểu hàn, áo sơ mi nữ trắng 1 túi basic điệu đà",69000,69000,0,0
TIKI,thoi-trang-nu,138143391,"quần ống rộng dáng jogger trái tim  chất thun trẻ trung cá tính",59000,59000,0,0
TIKI,thoi-trang-nu,110899035,"Quần baggy nữ khóa gấu quần tây nữ chất tuyết mưa cạp khuy trước chun sau khóa giọt lệ gấu quần dễ mặc Banamo 8321",113000,113000,0,0
TIKI,thoi-trang-nu,95992964,"Bộ đồ nữ mặc nhà trung niên cho các bà, các mẹ - Bộ đồ ngủ lanh (tole) - Bộ mặc nhà trung niên vải lanh (tole) Vicci BGD.082, thiết kế áo cộc tay phối quần dài in hoạ tiết (Màu 7-8-9-10-11)",180000,309000,129000,42
TIKI,thoi-trang-nu,14837844,"Đầm Elizabet Sang Chảnh",165000,165000,0,0
TIKI,thoi-trang-nu,57312346,"Váy ngủ 2 dây satin sexy kèm quần chip",65000,65000,0,0
TIKI,thoi-trang-nu,114415791,"Áo Khoác nỉ Nam Nữ Áo Hoodie Có Dây Kéo - Unisex Khoác Chống Nắng Mặc Cười Cute. Áo Khoác Hoodie Nam Nữ Có Dây Kéo",107000,107000,0,0
TIKI,thoi-trang-nu,40693537,"Quần lót nữ sexy lọt khe thêu bướm hở đũng sexy - Màu đỏ",29000,29000,0,0
TIKI,thoi-trang-nu,180322099,"Váy ngủ cosplay sườn xám thêu hoa sexy Q63 - Đồ ngủ sườn xám nữ quyến rũ - Đầm ngủ nữ gợi cảm",149000,210000,61000,29
TIKI,thoi-trang-nu,108917403,"Áo Lót Không Gọng Mút Vừa Nâng Ngực Tự Nhiên Tạo Khe Chữ V Mordern V Wireless By Sabina SBI1100",159000,579000,420000,73
TIKI,thoi-trang-nu,978217,"Combo 5 Quần Lót Nữ Modern Brief Miley Lingerie BC041 - Màu Ngẫu Nhiên",219000,395000,176000,45
TIKI,thoi-trang-nu,107038140,"ĐỒ LAM ĐI CHÙA # ĐỒ ĐI CHÙA # PHÁP PHỤC PHẬT GIÁO #Mẫu Nam",196000,196000,0,0
TIKI,thoi-trang-nu,90693929,"Bộ 5 Quần Lót ren công chúa chấm bi, Hàng xuất nhập thương hiệu Baw mẫu QLN01 (one size 40-60kg)",129000,189000,60000,32
TIKI,thoi-trang-nu,15980403,"Combo 10 quần lót nữ chất liệu cotton - Hàng Việt Nam",140000,150000,10000,7
TIKI,thoi-trang-nu,191433475,"Váy ngủ bodysuit liền thân xuyên thấu ren cao cấp Q415 - Đầm ngủ liền thân sexy gợi cảm - Đồ ngủ mặc nhà",99000,160000,61000,38
TIKI,thoi-trang-nu,152874519,"Quần JEAN ống rộng dáng suông cạp chéo chất đẹp thời trang Banamo Fashion 967",129000,129000,0,0
TIKI,thoi-trang-nu,144269633,"[ĐẸP ĐỘC] Chân váy jean ngang gối đính hoa 09, Chân váy thiết kế cao cấp, vải jean dày C020",279000,279000,0,0
TIKI,thoi-trang-nu,138456231,"Váy len suông dài tay bo, đầm suông thun len gân dáng dài thu đông 3 màu xinh xắn",105000,105000,0,0
TIKI,thoi-trang-nu,187804012,"Cosplay hóa trang sơ mi tay dài kèm chân váy sexy Q606 - Áo sơ mi kèm chân váy gợi cảm - Đồ ngủ nữ quyến rũ",139000,210000,71000,34
TIKI,thoi-trang-nu,84439427,"Quần Độn Mông Và Hông Thông Hơi Cạp Cao Xuất Nhật  MS66- 5STAR",95000,95000,0,0
TIKI,thoi-trang-nu,108243154,"Set/ bộ đồ lót  mút  vừa, không gọng, dây lưng lượn sóng, nâng ngực quyến rũ LYEB019",222000,239000,17000,7
TIKI,thoi-trang-nu,25964820,"Quần lót nữ lọt khe hình bướm gợi cảm",25000,25000,0,0
TIKI,thoi-trang-nu,167508015,"Áo Khoác Nam Nữ Nón 2 Lớp Thêu CERTAIN - Kiểu Hoodie Có Dây Kéo -Chống Nắng Thu Đông HIỀN LINH SHOP ÁO KHOÁC",100000,100000,0,0
TIKI,thoi-trang-nu,136581729,"Áo Khoác Nỉ in Couple Baby, Chất Nỉ Bông Mịn Đẹp Áo Khoác Hoodie Zip Unisex Nam Nữ, Áo Khoác Hoodie Nỉ Bông Dây Kéo Zip Baby FACE SMILE Form rộng Unisex Nam Nữ Cá Tính Ulzzang KUN",102000,102000,0,0
TIKI,thoi-trang-nu,160897698,"Áo đũi nữ form rộng fullsize M đến 2XL họa tiết thêu dễ mix đồ Đũi Việt DV17",159000,159000,0,0
TIKI,thoi-trang-nu,86049686,"Áo lá học sinh 2 dây - áo lá có mút không gọng áo lót cho bé gái tuổi dậy thì lớp 6 màu trắng màu đen màu xám màu hồng",30000,30000,0,0
TIKI,thoi-trang-nu,52519238,"Bộ đồ lót ren mỏng có gọng không đệm dây nơ",180000,180000,0,0
TIKI,thoi-trang-nu,137458757,"Set 10 chiếc quần lót kháng khuẩn nhăn đẹp ,thông hơi, co dãn 4 chiều cotton mát",115000,115000,0,0
TIKI,thoi-trang-nu,166412575,"Áo Hoodie Nỉ Bông 2 Nón In Gấu Unisex Siêu Xinh Form Freesize, Áo khoác  Hoodie Nỉ Bông  Nón 2 Lớp Form Rộng Unisex, Áo Khoác Nỉ Bông In Đẹp Form Nam Nữ Mặc Cặp",96000,96000,0,0
TIKI,thoi-trang-nu,147343833,"Váy ngủ Sexy xuyên thấu trong suốt thêu hoa quyến rũ",88000,88000,0,0
TIKI,thoi-trang-nu,68779861,"áo len nữ, áo len mác - tím",199000,199000,0,0
TIKI,thoi-trang-nu,181810400,"Bộ đồ Pyjama nữ, đồ mặc nhà lụa VILADY - B146 Quần Dài Tay Cộc Họa Tiết hình thoi, chất liệu lụa Pháp (lụa latin) - Màu ĐỎ ĐÔ",363000,550000,187000,34
TIKI,thoi-trang-nu,168313579,"Combo 2 quần lót nữ, quần lọt khe, quần lót tam giác ren xuyên thấu, dây mảnh đầy hấp dẫn và gợi tình ( màu ngẫu nhiên)  LYEQ045",73000,78000,5000,6
TIKI,thoi-trang-nu,135325574,"ÁO SƠ MI SANG TRỌNG ĐÍNH VAI CƯỜM",119000,119000,0,0
TIKI,thoi-trang-nu,147004119,"váy len suông dài tay bo tay,đầm suông nữ len gân dáng dài thu đông 3 màu siêu ấm",89000,89000,0,0
TIKI,thoi-trang-nu,46818599,"Bộ đồ lót ren áo siêu nâng ngực quyến rũ bảng vừa",160000,160000,0,0
TIKI,thoi-trang-nu,187315703,"Áo sơ mi nữ tay dài form rộng trơn trẻ trung nặng động vải lụa mềm mịn-MUD03",87000,210000,123000,59
TIKI,thoi-trang-nu,160795522,"Combo 2 quần lót nữ ren lọt khe đính 2 nơ xinh xắn, đáng yêu và quyến rũ (màu ngẫu nhiên) LYEQ056",64000,69000,5000,7
TIKI,thoi-trang-nu,179571729,"Set váy ngủ, đầm ngủ sexy ren hoa kèm áo choàng Q19 - Đầm ngủ nữ - Đồ ngủ mặc nhà",89000,150000,61000,41
TIKI,thoi-trang-nu,53090891,"Chân váy xếp ly dáng dài có đai chất vải không nhăn Free size (VAY36)",155000,155000,0,0
TIKI,thoi-trang-nu,171069984,"Chân Váy Midi Xếp Ly WHITE ANT Thiết Kế Dáng Xoè Nữ Tính, Chất Liệu Lụa Tre Bamboo Mềm Nhẹ Chống Nhăn 110303006",785000,785000,0,0
TIKI,thoi-trang-nu,73742576,"Quần lọt khe nữ - Tím",25000,25000,0,0
TIKI,thoi-trang-nu,68920020,"Áo thun tay dài nữ form rộng - Thêu chữ xẻ tà",99000,155000,56000,36
TIKI,thoi-trang-nu,91624408,"Đồ bộ nữ cộc tay - Đồ bộ mặc nhà - Đồ ngủ mặc nhà nữ - Đồ bộ nữ lửng - Set bộ đũi mặc nhà nữ Vicci BDT.01 áo cánh tiên quần lửng hoạ tiết hoa trắng",134500,269000,134500,50
TIKI,thoi-trang-nu,25693957,"Áo Bra su nữ thông hơi dây chéo cao cấp",89000,89000,0,0
TIKI,thoi-trang-nu,114466457,"Quần lót WANNABE QLT03 quần nữ lưng viền thun bản vừa dễ mặc",95000,95000,0,0
TIKI,thoi-trang-nu,171070162,"Áo Sơ Mi Nữ Công Sở Dài Tay WHITE ANT RHOMBUS SHIRT Thiết Kế Họa Tiết Cách Điệu, Chất Liệu Cupro Mềm Mịn 170300087",1585000,1585000,0,0
TIKI,thoi-trang-nu,79315305,"Áo Khoác Nữ Chống Nắng Chất Liệu Kaki Form Rộng Kiểu Hàn Quốc N02.05",131000,131000,0,0
TIKI,thoi-trang-nu,44580442,"Áo len nữ thêu hình kiểu dáng Hàn Quốc",179000,179000,0,0
TIKI,thoi-trang-nu,128276620,"Quần basic pants kaki nam nữ chất đẹp, co giãn",85000,85000,0,0
TIKI,thoi-trang-nu,107043740,"ÁO TRÀNG PHẬT TỬ ĐI CHÙA hoặc tu tại gia nam nữ - áo pháp choàng khi hành lễ vải kate giặt máy thoải mái",143000,143000,0,0
TIKI,thoi-trang-nu,80378068,"Quần CARO ỐNG SUÔNG NÂU - XÁM ĐEN - Nam Nữ unisex",112000,112000,0,0
TIKI,thoi-trang-nu,102738495,"Đầm váy Nữ Haint Boutique Tay Dài Dáng Suông - Váy Nữ thời Trang Phong Cách Hàn Quốc Hb48",199000,199000,0,0
TIKI,thoi-trang-nu,116593487,"Bộ đồ ngủ váy ngủ đẹp gợi cảm hai dây trẻ trung quyến rũ",132000,132000,0,0
TIKI,thoi-trang-nu,42117541,"Chân váy xếp ly dáng dài chấm bi cao cấp VAY30 Free size",178000,178000,0,0
TIKI,thoi-trang-nu,148068313,"áo sơ mi nữ form rộng tay dài kiểu hàn, áo sơ mi nữ trắng 1 túi basic điệu đà",69000,69000,0,0
TIKI,thoi-trang-nu,181569293,"Bộ đồ Pyjama nữ, đồ mặc nhà lụa VILADY - B142 kiểu Quần dài tay cộc họa tiết Ziczac chất liệu lụa Pháp (lụa latin) - Màu đen",511000,550000,39000,7
TIKI,thoi-trang-nu,180380160,"Váy ngủ bodysuit hai dây chéo lưng sexy Q524 - Đầm ngủ bodysuit nữ quyến rũ - Đồ ngủ nữ gợi cảm",129000,210000,81000,39
TIKI,thoi-trang-nu,71203912,"Váy xòe bồng 3 lớp hoa đen dễ thương VAY91 free size",195000,195000,0,0
TIKI,thoi-trang-nu,103431636,"Quần ống rộng hot trend 2021 khóa trước QUÀ TẶNG LÀ 1 GÓI XẢ VẢI NHÉ",89000,89000,0,0
TIKI,thoi-trang-nu,196093732,"Váy ngủ nữ, đầm ngủ, đồ mặc nhà dáng dài, đầm ngủ nữ 2 dây phối ren quyến rũ LYEN016",185000,199000,14000,7
TIKI,thoi-trang-nu,53203972,"Bộ đồ lót ren có gọng cực kì gợi cảm quyến rũ",170000,170000,0,0
TIKI,thoi-trang-nu,92385168,"Đồ bộ bigsize - Đồ bộ trung niên - Bộ đồ trung niên mặc nhà bigsize Vicci DGS.01 thiết kế áo cộc quần sớ chất liệu đũi cao cấp (dành cho người béo)",150000,299000,149000,50
TIKI,thoi-trang-nu,89479359," Áo lót cỡ lớn cho người có Ngực",239000,239000,0,0
TIKI,thoi-trang-nu,103358566,"Quần lót lọt khe nữ - quần lót sexy Feesize ( 40-55kg)",32000,32000,0,0
TIKI,thoi-trang-nu,41664061,"Áo Sơ Mi Nữ Công Sở",154000,154000,0,0
TIKI,thoi-trang-nu,47248427,"Bộ bơi 3 chi tiết, bikini kèm váy xuyên thấu, hot trend sexy quyến rũ | KT051",420000,420000,0,0
TIKI,thoi-trang-nu,146589501,"Áo len nữ chất len dày dặn, mềm mại phong cách Hàn Quốc",139000,139000,0,0
TIKI,thoi-trang-nu,83395210,"Áo sơ mi nữ Đũi Việt Thiết kế cổ V phối cúc SM51",159000,159000,0,0
TIKI,thoi-trang-nu,4193343,"Combo 5 quần lót nữ cotton cạp cao ghen bụng QL 8123-2 (Giao Màu Ngẫu Nhiên)",178000,178000,0,0
TIKI,thoi-trang-nu,96779045,"SIÊU SALE - Áo lót Boya ren mút mỏng có gọng BOYA 522B",105000,105000,0,0
TIKI,thoi-trang-nu,47868710,"Bộ đồ bơi cho nữ chân váy rời size từ 40kg đến 64kg",350000,350000,0,0
TIKI,thoi-trang-nu,73785598,"Quần lót lọt khe nữ + Kẹt tất sexy - Đen",35000,35000,0,0
TIKI,thoi-trang-nu,194498317,"Áo cardigan len, Áo khoác len nữ chất liệu len dệt kim mềm mịn, Dáng croptop hách dáng, trẻ trung, Cổ V dễ phối đồ phong cách thanh lịch",219000,219000,0,0
TIKI,thoi-trang-nu,194498314,"Áo khoác len nữ (MIỄN SHIP) Áo cadigan len đẹp, dáng croptop cổ V trẻ trung dễ phối đồ, chất liệu len dày mịn không xù lông",229000,229000,0,0
TIKI,thoi-trang-nu,170832064,"Quần Jean Nữ, Quần Jean Nữ Lưng Cao, Quần Jean Nữ Siêu Hack Dáng thương hiệu Chandi, Jean Nữ co dãn tôn dáng phụ nữ eo thon mẫu KV620",350000,350000,0,0
TIKI,thoi-trang-nu,8364799,"Chân váy jean xòe dài 2 nút C011",254000,273000,19000,7
TIKI,thoi-trang-nu,140212782,"Set áo vest blazer nữ + chân váy ngắn xếp ly - SV01 - WFStudios",549000,549000,0,0
TIKI,thoi-trang-nu,182605981,"Bộ Pyjama nữ, đồ mặc nhà VILADY- B139 Quần Dài Tay Cộc Họa Tiết Con sò Màu Đỏ Đô, chất liệu lụa Pháp",363000,550000,187000,34
TIKI,thoi-trang-nu,69984571,"Áo lót cỡ lớn cho người có Ngực",175000,175000,0,0
TIKI,thoi-trang-nu,125855697,"Áo khoác len cardigan nữ thiết kế ARCTIC HUNTER  AH15",349000,349000,0,0
TIKI,thoi-trang-nu,104518309,"VÁY NỮ XOÈ HOA TÍM TAY PHỒNG",250000,250000,0,0
TIKI,thoi-trang-nu,184694384,"Sét 4 Quần lót lọt khe nữ C30 – Com bo Quần lọt khe ren sexy - Quần lót lọt khe nữ ren sexy - Quần lót nữ lọt khe xẻ dáy",110000,110000,0,0
TIKI,thoi-trang-nu,118035493,"Đồ Lam Nữ Đi Chùa - Bộ Cổ Trụ Thêu Hạt Đính Ngọc Bội Tàu AL025",203000,203000,0,0
TIKI,thoi-trang-nu,66688656,"Quần ống rộng cạp chun Lamer  V64W20Q007 ( Nhiều màu)",299000,299000,0,0
TIKI,thoi-trang-nu,52093744,"ĐÂM DỰ TIÊC SANG CHẢNH MYMY",163000,163000,0,0
TIKI,thoi-trang-nu,51280919,"Bộ đồ lót có gọng đệm nâng ngực có size lớn big size đến 40",149000,149000,0,0
TIKI,thoi-trang-nu,46063860,"Đầm Suông Size Lớn Kiểu Đầm Suông Voan Xẻ Tà Đính Cườm GOTI 3112",259000,259000,0,0
TIKI,thoi-trang-nu,125392397,"Áo len nữ form rộng hoạ tiết kẻ ngang trẻ trung AH09",159000,159000,0,0
TIKI,thoi-trang-nu,184933492,"Đồ bơi nữ, đồ tắm biển dài tay quần ngố năng động, áo có đệm mút",214800,214800,0,0
TIKI,thoi-trang-nu,107035764,"Bộ Đi Lễ Chùa - Đồ Lam Nữ Đi Chùa Đẹp Cao Cấp Trang Nhã Vải Lụa Hoa Nổi 2021 Dành Cho Phật Tử AL002",197000,197000,0,0
TIKI,thoi-trang-nu,187278904,"Áo sơ mi nữ form rộng tay dài phồng hot trend hàn quốc trẻ trung thanh lịch vải lụa mềm mịn-MUD02",111000,230000,119000,52
TIKI,thoi-trang-nu,136014533,"JUMP LỮNG TRỄ VAI HARA",186000,186000,0,0
TIKI,thoi-trang-nu,160661035,"Quần Thể Thao Jogger nữ  cao cấp",245000,245000,0,0
TIKI,thoi-trang-nu,146365416,"Đai Nịt Bụng Vita Latex "Thế Hệ Mới" Cao Cấp Che mỡ Lưng, Định Hình Eo - Kèm Thanh Hạ Size",599000,599000,0,0
TIKI,thoi-trang-nu,29186362,"Áo len nữ phối màu trẻ trung Haint Boutique 07",149000,149000,0,0
TIKI,thoi-trang-nu,152560616,"Aó sơ mi nữ ,áo sơ mi dài tay oversize form rộng thêu hình mặt cười chất vải nhung tăm nhiều màu",99000,99000,0,0
TIKI,thoi-trang-nu,118035846,"Bộ Đi Lễ Chùa - Đồ Lam Nữ Đi Chùa Đẹp Cao Cấp Trang Nhã Bà Ba Gấm Nút Tàu 2021 Dành Cho Phật Tử AL020",211000,211000,0,0
TIKI,thoi-trang-nu,84824931," Bộ Đồ Lót Ren Có Gọng Không Đệm Siêu Mỏng S229",169000,169000,0,0
TIKI,thoi-trang-nu,101280528,"Áo ngực Boya ren không gọng, mút mỏng Hàng cao cấp việt nam 029L",115000,115000,0,0
TIKI,thoi-trang-nu,48114484,"Set áo yếm kèm quần lót nữ chất mát gợi cảm - nâu",35000,35000,0,0
TIKI,thoi-trang-nu,178333464,"Áo Bra ren 2 dây mảnh có thể điều chỉnh, miếng mút tháo dời, mềm mịn,thoáng mát| Bra ren bản to 2 lớp hàng cao cấp",125000,125000,0,0
TIKI,thoi-trang-nu,138148914,"Áo sơ mi nữ dài tay trắng đi học, đi làm cổ bẻ form rộng vừa, bo nhún cổ tay vải lụa mềm mát",72000,72000,0,0
TIKI,thoi-trang-nu,130471805,"Quần nỉ nữ ống bó chun thu đông xinh xắn DV03",99000,99000,0,0
TIKI,thoi-trang-nu,121747165,"Áo len nữ form rộng freesize dài tay hoạ tiết A09",149000,149000,0,0
TIKI,thoi-trang-nu,161207951,"Áo Lót Có Gọng Không Mút 60-120Kg",250800,250800,0,0
TIKI,thoi-trang-nu,108364701,"Áo khoác Hoodie Purbsso Tay Nhúng Phồng Kiểu Cánh Dơi _Form Nữ Unisex Nỉ Bông Ngoại thoitrangsihienlinh",100000,100000,0,0
TIKI,thoi-trang-nu,118027472,"Đồ Lam Đi Chùa # Lãnh Tụ Thêu Túi Áo # Quần Áo Nam # Đồ Bộ Nam",210000,210000,0,0
TIKI,thoi-trang-nu,187092194,"Bộ đồ bơi bikini kín đáo nữ hai mảnh đi tắm biển áo dài tay kèm váy - B34",166000,179000,13000,7
TIKI,thoi-trang-nu,97482335,"(Ảnh thật)Áo Khoác Nỉ Bông CARDIGAN CUBE Form Rộng Ulzzang thời trang teen hè",102000,102000,0,0
TIKI,thoi-trang-nu,185920228,"Đầm suông linen cổ V dáng suông rút eo, chất đũi mềm mát, thời trang công sở ARCTIC HUNTER AH160",299000,299000,0,0
TIKI,thoi-trang-nu,178606071,"Quần lót nữ 2 dây lọt khe sexy QL224 - Quần lọt khe nữ quyến rũ - Quần chip nữ - Quần lót nữ",25000,45000,20000,44
TIKI,thoi-trang-nu,107155613,"Váy ngủ xuyên thấu thoáng mát + Quần lót sexy",65000,65000,0,0
TIKI,thoi-trang-nu,27808122,"Sơ mi công sở nữ xanh trơn",149000,149000,0,0
TIKI,thoi-trang-nu,103357244,"Quần lót nữ nhiều màu C32 - Quần lót lọt khe - Quần lót nữ - Quần chíp nữ- Quần lót nữ gợi cảm - Quần lọt khe dây bướm",32000,32000,0,0
TIKI,thoi-trang-nu,182479191,"Áo sơ mi nữ ARCTIC HUNTER, áo sơ mi trắng công sở, cổ bèo thắt nơ tiểu thư, sang chảnh AH26",179000,179000,0,0
TIKI,thoi-trang-nu,81307328,"Áo ngực mút mỏng không gọng dành cho ngực to hàng Quảng Châu cao cấp",145000,145000,0,0
TIKI,thoi-trang-nu,103526017,"Quần lót JONES cotton phối ren 005",15400,15400,0,0
TIKI,thoi-trang-nu,93060435," váy suông nữ dáng dài cộc tay LA đan lưng 3 màu",85000,85000,0,0
TIKI,thoi-trang-nu,178069619,"Đầm Nữ Cổ Vuông Kiểu Dáng  Mới Thời Trang NORICK Cao Cấp",438000,438000,0,0
TIKI,thoi-trang-nu,100748453,"Quần Lót Nữ Tàng Hình Cạp Cao Luperi SP754 Không Đường May Mềm Mịn, Co Giãn, Không Lằn Mông, Kháng Khuẩn, Khử Mùi Tốt",95000,95000,0,0
TIKI,thoi-trang-nu,26423645,"Dây áo ngực bra cao cấp dùng cho váy quấy - Váy cưới - Áo hở cổ DA03",95000,95000,0,0
TIKI,thoi-trang-nu,38100729,"Áo Lót Bó Nịt Định Hình Ngực Tomboy Thể Thao Tập Gym Nữ Ba Lỗ Thun Trơn Gen Thun Có Viền Cài Hông Bigsize Nguyễn Nguyên",159000,159000,0,0
TIKI,thoi-trang-nu,118019227,"Đồ Lam Đi Chùa# CTân Thuyền Thêu# Đồ Bộ # Quần Áo Nữ # Vải Thun Co Giãn Không Nhăn",216000,216000,0,0
TIKI,thoi-trang-nu,52417249,"Áo Khoác Kaki Nữ Túi Hộp",167000,167000,0,0
TIKI,thoi-trang-nu,136106545,"Sét đồ bộ mặc nhà nam nữ tay phối raplang chất cotton mềm mịn thoáng mát phong cách nhẹ ,sang trọng freesize từ (45-68kg",97000,97000,0,0
TIKI,thoi-trang-nu,2085815,"Áo Ngực Triumph Maxi 280 (BW - Việt Nam) - Da (Size",449000,559000,110000,20
TIKI,thoi-trang-nu,171901606,"Áo Hoodie BASIC màu trơn Áo nỉ có mũ unisex nam nữ full size M L XL XXL",72450,72450,0,0
TIKI,thoi-trang-nu,44608436,"Áo Dài Cách Tân MS3",320000,320000,0,0
TIKI,thoi-trang-nu,118035847,"Đồ Lam Nữ Đi Chùa - Bộ Đi Lễ Chùa 2AL001 Trang Nhã Thêu Hoa Cổ Trụ Dành Cho Phật Tử",191000,191000,0,0
TIKI,thoi-trang-nu,73435212,"Áo Lót Mút Dày Nâng Ngực Không Gọng Màu Đen Habpy Lady By Sabina HBLP1006BK",159000,383000,224000,58
TIKI,thoi-trang-nu,164272053,"Quần Lót Nữ Cotton LUPERI SP717 Phối Ren Cạp Cao Định Hình Eo Thon Gọn Chất Liệu Mềm Mịn Co Giãn Kháng Khuẩn Khử Mùi",62000,62000,0,0
TIKI,thoi-trang-nu,118029360,"Đồ Lam Đi Chùa # Bà Lai Vải Gấm, Lụa Pháp Cao Cấp# Quần Áo Nữ # Đồ Bộ# Vải Mát",259000,259000,0,0
TIKI,thoi-trang-nu,107036266,"Đồ Lam Đi Chùa #Đồ Phật Tử #Pháp Phục Phật Giáo",207000,207000,0,0
TIKI,thoi-trang-nu,73503735,"Set áo và chân váy thời trang, cá tính",194000,194000,0,0
TIKI,thoi-trang-nu,192988437,"Váy Sơ Mi Thiết Kế Nhún Eo Thanh Lịch, Đầm Suông Linen Ngắn Tay Thời Trang Mùa Thu Đũi Việt",299000,299000,0,0
TIKI,thoi-trang-nu,17459625,"Quần Tây ôm cotton co giãn 4 chiều",199000,199000,0,0
TIKI,thoi-trang-nu,85028916,"Áo sơ mi nữ đũi Việt Thiết kế kẻ caro trẻ trung DV68",159000,159000,0,0
TIKI,thoi-trang-nu,146780351,"quần giả váy ( xả kho lẻ size)",50000,50000,0,0
TIKI,thoi-trang-nu,171209012,"Quần baggy nữ Hiền Trần BOUTIQUE đồ công sở lưng cạp cao đi học form dáng đẹp thanh lịch màu đen ghi",181000,350000,169000,48
TIKI,thoi-trang-nu,118022736,"Đồ Lam Đi Chùa # Bà Lai Vải Gấm Và Lụa Pháp Cao Cấp # Quần Áo Nữ # Đồ Bộ Nữ",257000,257000,0,0
TIKI,thoi-trang-nu,70087249,"Áo Sơ Mi Nữ Trơn Dài Tay Công Sở CV088 Chất Kate Mềm Mịn Chuẩn Form Thời trang nữ cao cấp",157000,157000,0,0
TIKI,thoi-trang-nu,195301257,"QUẦN SHORT CẠP CAO",279000,279000,0,0
TIKI,thoi-trang-nu,193924728,"Váy ngủ 2 dây hở lưng phối nơ ngực sexy gợi cảm P50 - Đầm ngủ nữ sexy quyến rũ - Đồ ngủ sexy",109000,160000,51000,32
TIKI,thoi-trang-nu,117084747,"Quần kaki nữ ống rộng sọc caro cá tính phong cách Hàn,lưng thun thoải mái năng động,Quần caro nữ ống suông rộng thoải mãi cá tính,Quần Dài Ống Rộng Họa Tiết Sọc Caro Phong Cách Hàn Quốc",103000,103000,0,0
TIKI,thoi-trang-nu,198460581,"Quần Lót Thông Hơi Kháng Khuẩn Mới P083",37000,37000,0,0
TIKI,thoi-trang-nu,28054422,"Váy ngủ 2 dây dáng dài",59000,59000,0,0
TIKI,thoi-trang-nu,75543906,"T-SHIRT BỤI #09 ÁO THUN UNISEX - SUNFLOWER OF SKULL",99000,469000,370000,79
TIKI,thoi-trang-nu,103058637,"Quần Dài Unisex Sọc 3 LINE COLOR Chất Thun - Quần Dài Thể Thao Nam Nữ Cực Xinh",76000,76000,0,0
TIKI,thoi-trang-nu,86415063,"Đầm lụa hoa dáng xòe cực nữ tính",194000,194000,0,0
TIKI,thoi-trang-nu,153765806,"COMBO 5 QUẦN NGUYÊN REN CẮT CAO 30196",107000,115000,8000,7
TIKI,thoi-trang-nu,51592612,"Quần lót lọt khe hình bướm Sexy cuốn hút - Màu trắng",46200,46200,0,0
TIKI,thoi-trang-nu,125022693,"(HÀNG SẴN) Bộ Đồ Trung Niên Tay Lỡ Phối Ren Sang Trọng AB12 - Hàng Quảng Châu Cao Cấp",185000,185000,0,0
TIKI,thoi-trang-nu,81186467,"Áo Thun Màu Be - Màu Nâu Nhạt vải Dày Đẹp",73000,73000,0,0
TIKI,thoi-trang-nu,123951611,"Quần sinh nhiệt nano giảm mỡ hàng loại 1 có hộp",44700,44700,0,0
TIKI,thoi-trang-nu,130265678,"Áo len nữ, áo len cổ cao ngắn tay nữ Al28",149000,149000,0,0
TIKI,thoi-trang-nu,128276406,"Áo sơ mi kaki nam chất đẹp, dày dặn",241500,241500,0,0
TIKI,thoi-trang-nu,146079134,"Đồ bộ nữ,đồ ngủ mặc nhà lửng 9 tấc vải lụa mango họa tiết hoa nhí siêu cưng size 47-60lg",152250,152250,0,0
TIKI,thoi-trang-nu,192989381,"Đầm Sơ Mi Tay Ngắn Thắt Eo Thời Trang Cho Nữ Phong Cách Công Sở Đũi Việt",299000,299000,0,0
TIKI,thoi-trang-nu,17462888,"Quần Tây ôm cotton co giãn 4 chiều",199000,199000,0,0
TIKI,thoi-trang-nu,44608550,"Áo Dài Cách Tân MS4",299000,299000,0,0
TIKI,thoi-trang-nu,72798865,"Quần jean nữ ống slim MESSI SJW-525-17",500000,500000,0,0
TIKI,thoi-trang-nu,193970413,"Quần lót nữ lụa tàng hình,đũng kháng khuẩn,co giãn 4 chiều,mềm mại,thoáng mát, không lộ viền cao cấp",41000,41000,0,0
TIKI,thoi-trang-nu,32998648,"Áo len lưới mẫu mới 2019",169000,169000,0,0
TIKI,thoi-trang-nu,20918913,"Đầm Nữ Maxi - Xanh Rêu (Free Size)",340800,340800,0,0
TIKI,thoi-trang-nu,198460338,"Quần Lót Băng Lụa Viền Ren Mát Lạnh Kháng Khuẩn Mới P197",35000,35000,0,0
TIKI,thoi-trang-nu,31259508,"Áo kiểu selyna sang trọng",189000,189000,0,0
TIKI,thoi-trang-nu,191124872,"Áo KHOÁC Hoodie THISISS Ulzzang Unisex",89000,89000,0,0
TIKI,thoi-trang-nu,23207108,"Quần lót nữ tam giác - Màu đen",25000,25000,0,0
TIKI,thoi-trang-nu,143813784,"Áo khoác dạ nữ 2 túi thu đông AH34",249000,249000,0,0
TIKI,thoi-trang-nu,22426318,"Gen nịt bụng 2 lớp sau sinh",65000,65000,0,0
TIKI,thoi-trang-nu,34536706,"Áo khoác cardigan nữ 2 túi trước Haint Boutique ak34",249000,249000,0,0
TIKI,thoi-trang-nu,174379901,"Áo Thun Cá Sấu Nữ Có Cổ - Đỏ Đô(45-75kg)",96000,96000,0,0
TIKI,thoi-trang-nu,104672710,"Sơ mi nữ Haint Boutique dáng suông dài rộng hot xinh HB165",250000,250000,0,0
TIKI,thoi-trang-nu,177960933,"Cuộn băng dán nâng ngực, keo vải dán ngực, băng dán vải nâng ngực và định hình KINESIOLOGY(10cm x 5m)",64020,64020,0,0
TIKI,thoi-trang-nu,187058112,"Áo thun tay lỡ form rộng - phông nam nữ cotton oversize - T shirt imagination dập nổi - 2N Unisex",125000,125000,0,0
TIKI,thoi-trang-nu,121755822,"Áo len nữ ,áo len cổ cao freesize AH08",199000,199000,0,0
TIKI,thoi-trang-nu,37818966,"Áo khoác len cardigan 2 túi cao cấp Haint Boutique 34.trắng kem",249000,249000,0,0
TIKI,thoi-trang-nu,182148608,"Áo Khoác Da Lộn Chữ MALE CAZE 2 Lớp Lót Dù Cao Cấp Kiểu Bomber Nút Bấm Rộng Unisex hàn Quốc - Nam Nữ Mặc Mùa Thu Đông",157000,157000,0,0
TIKI,thoi-trang-nu,173886079,"Combo 2 quần lót nữ, quần lót tam giác ren lưới xuyên thấu, co giãn thoải mái, thoáng mát LYEQ028 ( màu ngẫu nhiên)",73000,78000,5000,6
TIKI,thoi-trang-nu,160996572,"Váy Sơ Mi Thiết Kế Nhún Eo Thanh Lịch, Đầm Sơ Mi Công Sở Nữ Haint Boutique Da52",249000,249000,0,0
TIKI,thoi-trang-nu,184689521,"Đầm Linen Nữ nhúng eo Cổ Sơ Mi Đũi Việt DV158",299000,299000,0,0
TIKI,thoi-trang-nu,136019920,"ĐẦM VINTAGE TAY PHỒNG MYMY",159000,159000,0,0
TIKI,thoi-trang-nu,144874251,"Combo 2 váy/đầm ngủ chất liệu ren lưới gợi cảm, siêu mỏng thoáng khí LYEN005 ( màu ngẫu nhiên)",108000,108000,0,0
TIKI,thoi-trang-nu,166340207,"Áo thun Teeworld LOL T-shirt Trắng Đen Form Rộng Unisex Nam Nữ",259000,259000,0,0
TIKI,thoi-trang-nu,139060163,"Áo Giữ Nhiệt Nữ Cổ Cao LAROMA | Giữ Ấm - Siêu Co Dãn - Vải Thơm - Kháng Khuẩn",259000,349000,90000,26
TIKI,thoi-trang-nu,112251473,"ÁO CARDIGAN SWE, Áo Cardigan Đen Thun Nỉ Ngoại Họa Tiết Trái Tim Tay Bo Thun Ôm - Áo Khoác Len Tổng Hợp Chống Nắng Giữ Ấm Tốt, Áo Khoác bomber, Áo cardigan nữ , áo cardigan nam , áo khoác cardigan nam nữ mặc vải nỉ ngoại chống nắng chống lạnh tốt",95000,95000,0,0
TIKI,thoi-trang-nu,121397784,"Bộ Đồ Pijama Nữ Mặc Nhà Ngắn Tay Azuno BN0609 Chất Liệu Cotton Lụa Có Lót Ngực Tiện Lợi Cho Mùa Hè",275000,275000,0,0
TIKI,thoi-trang-nu,89689395,"VÁY LỤA TRẮNG CAO CẤP 2 LỚP PARTY ",1580000,1580000,0,0
TIKI,thoi-trang-nu,168422284,"Combo 2 quần lót nữ, quần lọt khe, quần lót tam giác ren xuyên thấu, dây thắt ngang hông quyến rũ và gợi cảm ( màu ngẫu nhiên) LYEQ046",91000,98000,7000,7
TIKI,thoi-trang-nu,145371138,"Chân váy chữ a xếp ly bên",137000,137000,0,0
TIKI,thoi-trang-nu,135513691,"Combo 2 áo ngực demi mút vừa ren iBasic VA086",379000,479000,100000,21
TIKI,thoi-trang-nu,191431390,"Váy ngủ bodysuit sexy liền thân gợi cảm Q702 - Đầm ngủ bodysuit dây đan chéo ngực quyến rũ - Đồ ngủ nữ mặc nhà sexy",129000,190000,61000,32
TIKI,thoi-trang-nu,13632242,"Combo 10 Quần lót nữ ren cao cấp",135000,135000,0,0
TIKI,thoi-trang-nu,147003905,"váy len suông dài tay bo tay,đầm suông nữ len gân dáng dài thu đông 3 màu ấp áp",85000,85000,0,0
TIKI,thoi-trang-nu,100257862,"Pijama Mặc Nhà , Đồ Bộ Ngủ Nữ Dài Tay Azuno BN2116 Chất Liệt Cotton Lụa Có Thể Mặc Mùa Hè",285000,306000,21000,7
TIKI,thoi-trang-nu,127307847,"Sét áo choàng ngủ +váy ngủ tặng kèm đai áo và quần chip ren Đủ Màu",780000,780000,0,0
TIKI,thoi-trang-nu,115891209,"Áo yếm Boho Top Gem Clothing SP060458",320000,320000,0,0
TIKI,thoi-trang-nu,178292335,"( ẢNH THẬT )Đầm Cổ Yếm Rớt Vai Tay Phồng Nhẹ Hottrend",260000,260000,0,0
TIKI,thoi-trang-nu,107039769,"Set bộ đi chùa cho nữ dịu dàng xinh xắn Adi",185000,185000,0,0
TIKI,thoi-trang-nu,175550297,"Đầm công sở nâu phối họa tiết-D11",175000,310000,135000,44
TIKI,thoi-trang-nu,176021614,"Áo ngực bralette ren mỏng dây chéo ngực iBasic BRAY045",99000,399000,300000,75
TIKI,thoi-trang-nu,174085415,"Đồ bộ pijama lụa, đồ mặc nhà nữ VILADY - B105 kiểu tay dài quần dài, hoạ tiết trơn phối viên ren quyến rũ, chất liệu lụa Pháp (lụa latin) cao cấp - Màu đỏ",363000,500000,137000,27
TIKI,thoi-trang-nu,70242077," Đầm dự tiệc ️",149000,149000,0,0
TIKI,thoi-trang-nu,174404184,"Váy ngủ lụa satin xẻ vạt sexy Q87 - Váy ngủ 2 dây - Đầm ngủ nữ quyến rũ - Đồ ngủ nữ - Đồ ngủ mặc nhà",149000,210000,61000,29
TIKI,thoi-trang-nu,103357621,"Quần lọt khe siêu mỏng ren lưới sexy - Quần lót cotton siêu mềm mại - Quần lót lọt khe nữ sexy C22- Quần lót ren sexy",24000,24000,0,0
TIKI,thoi-trang-nu,134387068,"Áo Hoodie Khóa Zip Nỉ Bông in MISSOUT Form Rộng Unisex Nam Nữ Ulzzang",92000,92000,0,0
TIKI,thoi-trang-nu,109594029,"GOTI - ĐẦM XÒE DỰ TIỆC NỮ KIỂU ĐẦM XÒE DỰ TIỆC ĐÍNH HẠT BẸT - ĐẦM DỰ TIỆC CAO CẤP NỮ 3308 3321",286200,286200,0,0
TIKI,thoi-trang-nu,59701610,"Combo 10 Quần Lót Nữ  Thun Lạnh  hàng Cao Cấp từ 40kg đến 72 kg",295000,295000,0,0
TIKI,thoi-trang-nu,76041955,"Chân váy xòe dáng dài vải mềm dễ thương free size VAY106",193000,193000,0,0
TIKI,thoi-trang-nu,180316314,"Đồ ngủ cosplay nữ dây cột sau sexy cao cấp Q516 - Váy ngủ cosplay nữ - Đầm ngủ nữ quyến rũ",129000,190000,61000,32
TIKI,thoi-trang-nu,180346569,"Chân Váy Công Sở New Design Thiết Kế Váy Xòe Dài Qua Gối Dáng Midi Phong Cách Hàn Quốc Trẻ Trung Chất Vải Tốt Co Giãn ,Thoáng Mát CV0076",199000,339000,140000,41
TIKI,thoi-trang-nu,145575891,"Áo khoác blazer, áo vest nữ kiểu Hàn Quốc tay lỡ, chất vải đẹp, nhiều màu Blz 03- Thời trang công sở WFstudios",360000,360000,0,0
TIKI,thoi-trang-nu,106335976,"QUẦN LÓT NỮ NHŨ CAO CẤP PINK PLAY PW017",42000,45000,3000,7
TIKI,thoi-trang-nu,197645466,"Áo ngực không mút bonding không đường may cup T-shirt BRAW034",359000,499000,140000,28
TIKI,thoi-trang-nu,133619862,"CHÂN VÁY CÁCH ĐIỆU THỜI TRANG",135000,135000,0,0
TIKI,thoi-trang-nu,68542333,"Bộ ngủ 2 dây quần đùi áo ren quyến rũ kèm bịt mắt",126650,149000,22350,15
TIKI,thoi-trang-nu,135315368,"SET BỘ SƠ MI ELIZ - M",188000,188000,0,0
TIKI,thoi-trang-nu,141101634,"Áo sơ mi nữ dài tay trắng đi học, đi làm cổ bẻ form rộng vừa, bo nhún cổ tay vải lụa",63000,63000,0,0
TIKI,thoi-trang-nu,117090796,"Áo Khoác Nỉ Fevents Nữ Nam Mặc HOT RẺ ĐẸP Áo Hoodie Có Dây Kéo - Form Rộng Unisex Khoác chống Nắng Cực Tốt Jacket",103000,103000,0,0
TIKI,thoi-trang-nu,29266649,"Đầm suông trung niên kiểu đầm suông bigsize in hoa sen xanh lá GOTI 1779",299000,299000,0,0
TIKI,thoi-trang-nu,135837305,"CHÂN VÁY CHỮ A ĐÍNH KHOEN SALA - S",138000,138000,0,0
TIKI,thoi-trang-nu,73435719,"Áo Lót Mút Mỏng Vừa Cup Ngang Không Gọng Màu Trơn Pretty Perfect By Sabina SBU8000",579000,579000,0,0
TIKI,thoi-trang-nu,141259095,"Áo giữ nhiệt nữ thu đông cổ lọ vải cotton co giãn nhiều màu",28000,28000,0,0
TIKI,thoi-trang-nu,72455126,"Áo cardigan nữ , áo cardigan nam , áo khoác cardigan nam nữ mặc vải nỉ ngoại chống nắng chống lạnh tốt",100000,100000,0,0
TIKI,thoi-trang-nu,100492945,"ĐẦM FORD PHỐI LƯỚI SAO XINH XẮN,ĐẦM THÍCH HỢP ĐI DỰ TIỆC,ĐI CHƠI...CHẤT LIỆU VÃI THOÁNG MÁT",119000,119000,0,0
TIKI,thoi-trang-nu,128287188,"Áo khoác sweater nỉ ngoại viền cổ unisex ulzzang nam nữ",99000,99000,0,0
TIKI,thoi-trang-nu,184058785,"Đầm ngủ nữ thun 2 dây họa tiết hoa văn iBasic 7916-1",139000,299000,160000,54
TIKI,thoi-trang-nu,73509052,"Quần lót lọt khe nữ sexy - Trắng",25000,25000,0,0
TIKI,thoi-trang-nu,154720259,"Combo 2 quần lót nữ ren lụa mềm mại, thắt nơ bên sườn đáng yêu, gợi cảm (màu ngẫu nhiên) LYEQ048",91000,98000,7000,7
TIKI,thoi-trang-nu,31688872,"Áo khoác gió cách nhiệt GOKING, form unisex cho nữ nam. Ngoài vải dù, trong lót vải cào cách nhiệt, chống nắng gió lạnh, giữ ấm cơ thể",235000,235000,0,0
TIKI,thoi-trang-nu,48149779,"Quần Lót Lưới Wannabe QL239",150000,150000,0,0
TIKI,thoi-trang-nu,165212534,"Áo Lót Nữ, Áo Lót Đúc Su Đệm Dày Siêu Nâng Ngực Tạo Khe Quyến Rũ, Áo Ngực Su Bàn Tay Không Gọng Không Đường May Thương Hiệu BAW Mã ANM15",129000,159000,30000,19
TIKI,thoi-trang-nu,48535810,"ÁO KHOÁC KAKI NỮ FORM RỘNG",167000,167000,0,0
TIKI,thoi-trang-nu,174651326,"[Cập Nhật] Váy Đầm Trung Niên Trung Niên Họa Tiết Cực Đẹp  - Dành Cho Các Quý Bà 2022 - Tuấn Tú Store",350000,350000,0,0
TIKI,thoi-trang-nu,171069906,"Áo Sơ Mi Nữ Công Sở Dài Tay WHITE ANT PAKER SHIRT Thiết Kế Ngực Họa Tiết Đông Dương, Chất Liệu Lụa Mềm Mịn 170300067",899500,899500,0,0
TIKI,thoi-trang-nu,134947010,"ÁO KHOÁT LỬNG SÀNH ĐIỆU",188000,188000,0,0
TIKI,thoi-trang-nu,72322033,"COMBO 4 Quần Lót Su Đúc QSD04 Không Viền May + Mỏng Nhẹ Thoải Mái",295000,295000,0,0
TIKI,thoi-trang-nu,138014943,"Áo khoác nỉ, áo kiểu dáng hoodie form rộng cho nữ chạy viền lạ mắt",100000,100000,0,0
TIKI,thoi-trang-nu,107042547,"Đồ Lam Đi Chùa Nam # Lãnh Tụ Nam",197000,197000,0,0
TIKI,thoi-trang-nu,21306397,"Áo Thun Nữ Hình TRIHAL | Chất Liệu Cotton 65/35 | Phong Cách Hàn Quốc",100000,100000,0,0
TIKI,thoi-trang-nu,167428382,"Quần Jean Nữ, Quần Jean Nữ Lưng Cao, Quần Jean Nữ Siêu Hack Dáng thương hiệu Chandi, Jean Nữ co dãn tôn dáng phụ nữ eo thon mẫu MS623",350000,350000,0,0
TIKI,thoi-trang-nu,147865820,"Đồ bơi nữ kín đáo QUEEN BIKINI Bikini 2 mảnh đi biển Quảng châu BIK26",179000,179000,0,0
TIKI,thoi-trang-nu,45842579,"Áo Lót Nữ Nâng Ngực Phối Ren Cao Cấp iBasic BRAW025 - Màu Da - Hàng Chính Hãng",150000,199000,49000,25
TIKI,thoi-trang-nu,69984109,"Bộ Đồ Lót Bigisize 50-120kg",233000,233000,0,0
TIKI,thoi-trang-nu,62797648,"Bộ đồ lót có gọng mút mỏng bảng ren mềm to",180000,180000,0,0
TIKI,thoi-trang-nu,186090724,"Váy ngủ cổ trang cổ yếm hở lưng kèm chân váy sexy cao cấp Q603 - Đầm ngủ cổ yếm gợi cảm quyến rũ - Đồ ngủ nữ",139000,210000,71000,34
TIKI,thoi-trang-nu,16154222,"Áo Khoác Nữ Măng Tô",450000,450000,0,0
TIKI,thoi-trang-nu,136085313,"Áo kiểu nữ dài tay chất tơ lụa sang trọng - mặc cùng chân váy, quần tây, jeans đi làm , đi tiệc",137750,145000,7250,5
TIKI,thoi-trang-nu,134818009,"Áo sơ mi nữ dài tay trắng đi học, đi làm cổ bẻ form rộng vừa, bo nhún cổ tay vải lụa mềm mát",68000,68000,0,0
TIKI,thoi-trang-nu,185940823,"Combo 3 Quần Lót Ren Nữ LOIRECHIC QBRL04",270000,270000,0,0
TIKI,thoi-trang-nu,55213859,"Áo Tắm Tay Dài Quần Bơi Lưng Cao ATI58 MayHomes, Kiểu Dáng Thể Thao, Chất Liệu Bền Đẹp",229000,259000,30000,12
TIKI,thoi-trang-nu,172764566,"Váy Ngủ Hai Dây Cổ Đổ Nữ VILADY chất liệu Lụa Pháp Cao Cấp Thiết Kế Cổ Đổ Sang Chảnh Màu Xanh rêu Sexy Quyến Rũ V116",363000,390000,27000,7
TIKI,thoi-trang-nu,123926214,"Pijama sau sinh thô đũi, đồ bộ mặc nhà ngắn tay mặc hè cực mát Azuno AZ2992",245000,341000,96000,28
TIKI,thoi-trang-nu,146637813,"Áo choàng kimono lụa satin iBasic SW055",519000,599000,80000,13
TIKI,thoi-trang-nu,90583918,"Áo kiểu nữ vải voan cổ V cách điệu - form dáng chuẩn, dễ mặc đi làm hoặc dự tiệc",175000,175000,0,0
TIKI,thoi-trang-nu,141096009,"Set váy yếm nữ 2 lớp cộc tay, đầm nữ dài maxi dáng ulzang hàn quốc điệu đà",95000,95000,0,0
TIKI,thoi-trang-nu,103118566,"Quần lót ren nữ sexy thoáng mát",29000,29000,0,0
TIKI,thoi-trang-nu,145289820,"Chân váy công sở chữ A, Dáng dài, thân trước tà đắp đính nơ duyên dáng, độ dài 62cm vải kaki thun co giãn thoáng mát",179000,299000,120000,40
TIKI,thoi-trang-nu,97534873," Áo khoác nữ Áo khoát nữ gió dù 2 lớp chống nắng in lưng cực hót bao chất-A148",103000,103000,0,0
TIKI,thoi-trang-nu,86989258,"Quần Jean Nữ Lưng Cao Siêu Hack Dáng, xu hướng mới nhất HD00",299000,299000,0,0
TIKI,thoi-trang-nu,153470267,"Áo Khoác Cardigan Chất Nỉ Ulzzang Unisex, Áo khoác nỉ varsity jacket Hot Trend Undertrap - Áo Bomber Jacket Nỉ UNDERTRAP chữ U, Áo khoác bomber jacket nam nữ hình in undertrap chất nỉ cotton cao cấp",95000,95000,0,0
TIKI,thoi-trang-nu,83857477,"Áo khoác hoodie thun nỉ ngoại in hoạt hình 3 ông già siêu đẹp, Áo Khoác Hoodie Nỉ [SIÊU COOL] Unisex Nam Nữ Form Rộng Cao Cấp Êm Ái Co Giãn Thoải Mái",100000,100000,0,0
TIKI,thoi-trang-nu,15778666,"Áo Sơ Mi Nữ Viền",141000,141000,0,0
TIKI,thoi-trang-nu,185919966,"Đầm Nữ Linen Cổ Đức Nhún Eo, Đầm Sơ Mi Nữ Dáng Dài đầm thiết kế Da162",299000,299000,0,0
TIKI,thoi-trang-nu,132992708,"Áo khoác nỉ trơn oversize phong cách ulzzang , áo hoodie nỉ mũ to form rộng, Áo khoác hoodie nỉ dây kéo form rộng unisex dấu quần hàn quốc, áo khoác chống nắng, áo khoác mùa thu đông",100000,100000,0,0
TIKI,thoi-trang-nu,165250858,"Combo 2 Quần Lót/Quần Chip Lọt Khe/Quần Lót Lọt Khe Nữ Đan Dây Hình Bướm Siêu Sexy Gợi Cảm ( màu ngẫu nhiên) LYEQ049",73000,78000,5000,6
TIKI,thoi-trang-nu,73622488,"ÁO KHOÁC DẠ NỮ XINH XẮN",550000,550000,0,0
TIKI,thoi-trang-nu,113956155,"váy suông - đầm suông nữ cộc tay in chữ blank phom rộng dáng dài",79000,79000,0,0
TIKI,thoi-trang-nu,108062479,"QUẦN ỐNG SUÔNG CHẤT ĐŨI XƯỚC NHẬT, QUẦN ỐNG RÔNG DÁNG LỬNG LƯNG THUN CẠP KHÓA THẬT",59000,59000,0,0
TIKI,thoi-trang-nu,165183995,"Quần lót nữ cao cấp QL2301 - Quần lót nữ sexy - Quần chíp nữ - Quần lọt khe",25000,40000,15000,38
TIKI,thoi-trang-nu,110181303,"Đồ cosplay sexy học sinh anime - Set váy ngủ nữ sinh gợi cảm",128000,128000,0,0
TIKI,thoi-trang-nu,169465046,"Đầm ngủ hai dây dáng suông Q47 - Váy ngủ dể thương dáng suông- Đồ ngủ mặc nhà sexy",119000,160000,41000,26
TIKI,thoi-trang-nu,58283807,"Đầm xòe nhún vai kết hạt trai thời trang a b c",99000,99000,0,0
TIKI,thoi-trang-nu,141260870,"Áo khoác nỉ kiểu dáng hoodie form nữ viền kẻ phom rộng 3 màu",98000,98000,0,0
TIKI,thoi-trang-nu,155283629,"Bộ Đồ Ngủ Lụa Tay Ngắn Basic Loirechic LPN07",465000,465000,0,0
TIKI,thoi-trang-nu,118022514,"Đồ Lam Đi Chùa # Bà Lai Lụa Pháp Cao Cấp # Quần Áo Nữ # Đồ Bộ Nữ",268000,268000,0,0
TIKI,thoi-trang-nu,177518934,"Đồ bơi nữ 2 mảnh, Bikini nữ kín đáo chất thun co giãn 4 chiều có đệm mút",179000,179000,0,0
TIKI,thoi-trang-nu,82033871,"Bộ bơi nữ 3 chi tiết chống nắng toàn thân, áo bơi dài tay + quần sooc đùi + quần bơi dài, chất thun bơi Lycra cao cấp | KT023",480000,480000,0,0
TIKI,thoi-trang-nu,115708252,"Đầm suông nữ, váy suông nữ cộc tay mùa hè in chú gấu chất cotton 2 màu",79000,79000,0,0
TIKI,thoi-trang-nu,145290096,"Chân váy công sở New Design dáng  A dài qua gối vải kaki thun co giãn",189000,299000,110000,37
TIKI,thoi-trang-nu,56625449,"Áo Lót Nữ, Áo Ngực Mút Kép Dày Siêu Nâng Ngực Chất Su Lụa Mềm Mát Anny Thái Lan 902",83000,83000,0,0
TIKI,thoi-trang-nu,146229717,"Áo polo nữ ADINO màu ghi phối viền xẻ lai vải cotton co giãn dáng slimfit trẻ trung APN02",139000,278000,139000,50
TIKI,thoi-trang-nu,105672979,"chân váy A dáng dài xẻ tà nhiều màu điệu đà",125000,125000,0,0
TIKI,thoi-trang-nu,77543589,"Váy ngủ sexy bó sát body hở lưng cosplay quyến rũ",90000,90000,0,0
TIKI,thoi-trang-nu,175821477,"Đồ bộ pijama lụa, đồ mặc nhà nữ VILADY - B133 kiểu quần đùi tay cộc mặc hè thoáng mát Họa tiết Lá tre, chất liệu lụa Mango cao cấp",325000,450000,125000,28
TIKI,thoi-trang-nu,52418277,"Quần lọt khe đính hạt ngọc sexy",25000,25000,0,0
TIKI,thoi-trang-nu,138124586,"váy suông nữ, đầm suông cổ V dáng dài xẻ tà 3 màu hot hit",85000,85000,0,0
TIKI,thoi-trang-nu,3008735,"Combo 5 quần lót thun lạnh MW QM2, Nhiều màu",107000,115000,8000,7
TIKI,thoi-trang-nu,101280311,"Đầm Kim Tuyến Trung Niên hàng cao cấp MS01  (55kg - 70kg)",294000,294000,0,0
TIKI,thoi-trang-nu,95851138,"Quần lọt khe nữ ren cao cấp sexy bướm xinh",35000,35000,0,0
TIKI,thoi-trang-nu,98555458,"Áo Hoodie Unisex - Áo Khoác Nỉ Nam Nữ MOON 2 Màu Cực Hot - LP.STORE",108000,108000,0,0
TIKI,thoi-trang-nu,155268118,"Quần Gen Bụng, Quần Mặc Trong Váy Siêu Co Dãn Cao Cấp",68500,68500,0,0
TIKI,thoi-trang-nu,107155601,"Quần lót ren nữ quyến rũ",25000,25000,0,0
TIKI,thoi-trang-nu,74564323,"Combo 3 Quần lót ren lưới nữ gợi cảm cạp chéo sexy co giãn tốt thoải mái mát mẻ - Hàng nhập QC",75000,75000,0,0
TIKI,thoi-trang-nu,146636219,"Đồ bộ trung niên tay ngắn cho Bà cho Mẹ, chất liệu Đũi mát mẻ, thấm hút mồ hôi, đồ bộ mặc nhà NeSa Shop ĐBH.27",185000,279000,94000,34
TIKI,thoi-trang-nu,150693473,"( HÀNG SẴN) Đầm Lụa Trung Niên Cách Tân Sang Trọng VH53 - Hàng Quảng Châu Cao Cấp",385000,385000,0,0
TIKI,thoi-trang-nu,38151898,"Áo len nữ dài tay ôm người Haint Boutique 31",149000,149000,0,0
TIKI,thoi-trang-nu,129566499,"Váy ngủ sexy, váy ngủ, đầm ngủ nữ hai dây vải lụa satin mềm mát cao cấp",49000,49000,0,0
TIKI,thoi-trang-nu,85800596,"Áo chống nắng nữ toàn thân vải Umi lạnh dày mịn mát che phủ kín chân chống nắng cực tốt mới 2021",174000,174000,0,0
TIKI,thoi-trang-nu,72604026,"Áo lót trơn không gọng đệm mỏng vừa cotton gân",86000,86000,0,0
TIKI,thoi-trang-nu,114434249,"Áo Thun Phản Quang Unisex Vui Lòng Đứng Xa Áo Phông Form rộng Chưa Có Bồ - Chất Cotton Dày Mịn T-shirt",98000,98000,0,0
TIKI,thoi-trang-nu,145575913,"Áo khoác blazer, áo vest nữ kiểu Hàn Quốc tay lỡ, chất vải đẹp, nhiều màu Blz04 - Thời trang công sở WFstudios",365000,365000,0,0
TIKI,thoi-trang-nu,31603723,"Crazy sales. Áo phông nữ thoát nhiệt Nhật Bản GOKING. Áo thun nữ in hình đẹp cá tính, thành phần 100 cotton thoáng mát, thấm hút mồ hôi, đánh bay cơn nóng mùa hè",111000,111000,0,0
TIKI,thoi-trang-nu,152183979,"Combo 2 quần lót nữ lọt khe ren lưới xuyên thấu, đính nơ xinh xắn, gợi cảm (màu ngẫu nhiên) LYEQ035",73000,78000,5000,6
TIKI,thoi-trang-nu,72562942,"Bộ đồ lót có gọng đệm vừa ôm nâng ngực thêu hoa viền đen",140000,140000,0,0
TIKI,thoi-trang-nu,162215179,"Combo 10 Quần Lót Nữ Lưng Cao Modal Phối Ren Miley Lingerie FDS_25 - Giao màu ngẫu nhiên",449000,1050000,601000,57
TIKI,thoi-trang-nu,82561520,"Bộ 5 Quần Lót Cotton dễ thương mềm mại tôn dáng, Hàng xuất nhập thương hiệu Baw mẫu QLN01",99000,163500,64500,39
TIKI,thoi-trang-nu,84471575,"Áo khoác hoodie Chống Rét Cho Nam nữ Cho Cặp Đôi nón tai thỏ Chất Nỉ Unisex  Form rộng Có 4 Màu Ulzzang",99000,99000,0,0
TIKI,thoi-trang-nu,132348655,"Combo 3 chiếc quần lót nữ thông hơi ATUNER QL014, họa tiết caro thời trang, mềm mại, thoáng mát (Giao Màu Ngẫu Nhiên) - Hàng Chính Hãng",169000,207000,38000,18
TIKI,thoi-trang-nu,67492167,"Áo kiểu nữ cổ vuông sang trọng",180000,180000,0,0
TIKI,thoi-trang-nu,196443208,"Áo khoác nỉ lót bông form rộng WORK unisex (nam nữ mặc được), Áo hoodie nỉ WORK ( ảnh thật chụp tại shop), ÁO HOODIE CHỮ WORK, Áo khoác nỉ cotton WORK, áo khoác hoodie zip chống nắng mặc ấm",100000,100000,0,0
TIKI,thoi-trang-nu,111061212,"Quần Sinh Nhiệt, Quần Đổ Mồ Hôi, Giảm Mỡ Bụng Cho Nữ, Tự Tin Khoe Vòng 2 Thương Hiêu Baw DTD1",89000,159000,70000,44
TIKI,thoi-trang-nu,51572500,"Áo Sơ Mi Nữ Cao Cấp Form Chuẩn",157000,157000,0,0
TIKI,thoi-trang-nu,145290253,"Chân Váy Cống Sở  New Design Thiết Kế Váy Chữ A ,Lệch Tà Phối Nút Có Túi Phong Cách Hàn Quốc, Vải Tốt ,Co Giãn  CV0021",179000,328000,149000,45
TIKI,thoi-trang-nu,96934472,"Sét Bộ Đồ Nam Nữ Mặc nhà, Đi Chơi Dạo Phố, Mặc Ở Nhà Chất Liệu Cotton Mềm Mịn Mát, Phong Cách Teen Hàn Quốc, đồ bộ in trứng mới về, đồ bộ mặc nhà mùa hè nam nữ",99000,99000,0,0
TIKI,thoi-trang-nu,181910068,"Đầm váy nữ chất liệu đũi mát cao cấp, thiết kế cổ trụ phối bèo vintage, thắt eo tôn dáng, đầm có túi xinh AH62",320000,320000,0,0
TIKI,thoi-trang-nu,93044209," váy 2 dây dáng suông chất đũi xước xinh xắn",77000,77000,0,0
TIKI,thoi-trang-nu,174898320,"Váy ngủ sexy xuyên thấu jumsuit gợi cảm Q416 - Bộ đồ ngủ cosplay bodysuit phối ren bèo - Đầm ngủ nữ - Đồ ngủ mạc nhà",129000,210000,81000,39
TIKI,thoi-trang-nu,105644470,"Quần Lót Nữ, Bộ 5 Quần Lót Nữ Gấm Phối Ren Cao Cấp Mềm Mịn, Quần Lót Nữ Kháng Khuẩn, Quần Lót Nữ Co Dãn Tốt Thoáng Mát Thương Hiệu Baw Mã QLN2609",129000,199000,70000,35
TIKI,thoi-trang-nu,78488593,"Chân váy jean xòe dài 2 nút màu xanh nhạt C011",254000,273000,19000,7
TIKI,thoi-trang-nu,135266798,"ÁO PEPLUM THẮT NƠ RUBY",109000,109000,0,0
TIKI,thoi-trang-nu,99679894,"Đồ Ngủ Hai Dây Phối Ren Sexy Quyến Rũ Có Mút Ngực Thương Hiệu Baw, Chất Liệu Lụa Satin Mát Mịn DN21 (hình thật shop tự chụp)",129000,169000,40000,24
TIKI,thoi-trang-nu,76257707,"áo sweater, áo hoodie, áo sweater nam, áo sweater nữ, áo sweater nam nữ đều mặc được, áo chui đầu, áo sweater in quả địa cầu",89000,89000,0,0
TIKI,thoi-trang-nu,84327535,"BỘ 5 Quần Lót chất cotton phối ren cao cấp kháng khuẩn thương hiệu BAW NT34",199000,199000,0,0
TIKI,thoi-trang-nu,169777244,"Áo sơ mi nữ form rộng tay dài kẻ caro Banamo Fashion Áo sơ mi kẻ 2 túi ngực unisex 3918",109000,109000,0,0
TIKI,thoi-trang-nu,83929561,"Áo Khoác Bomber Unisex Cúc, Áo Khoác Nam Nữ",108000,108000,0,0
TIKI,thoi-trang-nu,78020342,"Đầm nữ form rộng Đũi Việt kèm dây thắt eo DV132",199000,199000,0,0
TIKI,thoi-trang-nu,187021822,"Bộ đồ bơi, bikini tắm biển nữ kín đáo quần áo dài che nắng - B.38",278000,299000,21000,7
TIKI,thoi-trang-nu,34586773,"Đai sinh nhiệt giảm mỡ bụng Hot Belt cao cấp, size S",96000,99000,3000,3
TIKI,thoi-trang-nu,69983665,"Gen Toàn Thân Kèm Áo Lót Định Hình",264000,264000,0,0
TIKI,thoi-trang-nu,99220584,"Quần jogger nữ Hiền Trần BOUTIQUE dáng dài cạp chun dây buộc kiểu dáng trơn basic",213000,350000,137000,39
TIKI,thoi-trang-nu,74419727,"Combo 5 Quần Lót Nữ Ren Hoa Elegant Miley Lingerie FLS-03",255000,395000,140000,35
TIKI,thoi-trang-nu,68621645,"Combo 5 Quần Lót Nữ Modal Phối Ren Trước Remix - Giao Màu Ngẫu Nhiên FCM04",229000,250000,21000,8
TIKI,thoi-trang-nu,118026729,"Đồ Lam Đi Chùa# Vạt Hò Nút Cây # Quần Áo # Đồ Bộ # Vải Mát # Nam Nữ",211000,211000,0,0
TIKI,thoi-trang-nu,197574684,"Váy khiêu vũ tua rua dài tay phong cách trẻ trung siêu đẹp",330000,330000,0,0
TIKI,thoi-trang-nu,40648165,"Quần lót nữ sexy gợi cảm lọt khe - Màu đen trắng",35000,35000,0,0
TIKI,thoi-trang-nu,20623306,"Chân váy ren Tulle - Tutu xòe tròn dáng dài kim tuyến đính hạt cao cấp mẫu hot VAY11 Free size - Xanh",189000,189000,0,0
TIKI,thoi-trang-nu,101888836,"Set đồ lót liền thân siêu sexy Bodysuit",49000,49000,0,0
TIKI,thoi-trang-nu,178101993,"Quần jean nữ Lưng Cao Julido Store, chất jean co dãn 4 chiều ống ôm chân mẫu Ms3202",159000,279000,120000,43
TIKI,thoi-trang-nu,96991475,"Quần lót nữ ren nữ sexy thoáng mát",25000,25000,0,0
TIKI,thoi-trang-nu,122348783,"Quần Lửng Nữ Giordano Linen Capri 05420228",790000,790000,0,0
TIKI,thoi-trang-nu,59469041,"Quần Đùi Lót Nữ Mặc Trong Chân Váy Dài 25.5cm Miley Lingerie - Màu Beige FDS0906",60000,69000,9000,13
TIKI,thoi-trang-nu,63803817,"SET VEST NỮ SANG TRỌNG HIỆN ĐIỆN",390000,390000,0,0
TIKI,thoi-trang-nu,123917585,"Đồ Bộ Nữ Dài Tay, Pijama Mặc Nhà Cho Nữ Bigsize Azuno BN2111 Chất Liệu Cotton Lụa Có Thể Mặc Mùa Hè",294000,294000,0,0
TIKI,thoi-trang-nu,104202336,"Combo 2 quần lót nữ lưới phối ren trong suốt gợi cảm đính nơ xinh xắn LYEQ020",110000,118000,8000,7
TIKI,thoi-trang-nu,135289351,"ÁO CỔ TRÒN THẮT NƠ SAU LƯNG",115000,115000,0,0
TIKI,thoi-trang-nu,84822657," Quần Mặc Trong Váy Dáng Dài Cạp Cao Gen Bụng Thon Đùi Cao Cấp D379",92000,92000,0,0
TIKI,thoi-trang-nu,190538380,"Đầm ngủ, Váy ngủ lụa Pháp (Lụa Latin) cao cấp VILADY - V151, phối ren và ngực lưng, xẻ đùi 2 bên (Màu Đen)",445000,479000,34000,7
TIKI,thoi-trang-nu,138138967,"váy len body dáng dài cổ lọ, đầm body len tăm cổ cao thu đông",79000,79000,0,0
TIKI,thoi-trang-nu,109638449,"Áo khoác vest blazer nữ dáng suông 2 khuy chất vải cao cấp",172000,172000,0,0
TIKI,thoi-trang-nu,91530852,"Áo Khoác Cardigan, Sweater, Jacket END PAYCE Nữ Nam Chất Nỉ Unisex Form Rộng Ulzzang 2 Túi Viền Phối Đen Trắng, Áo khoác Cardigan END PAYCE Unisex - Áo khoác nữ Nỉ thun da cá Ulzzang, Áo Khoác Cardigan Ulzzang form thụng",99000,99000,0,0
TIKI,thoi-trang-nu,103742205,"Áo khoác hoodie Chống Nắng Cho Nam Nữ Và Cặp Đôi Có 3 Màu Chất Nỉ Unisex in hình WIND Form rộng Ulzzang",100000,100000,0,0
TIKI,thoi-trang-nu,13027878,"Bộ Đồ Lót nữ Sporty Chic Miley Lingerie BRC07002_FCB0700",295000,410000,115000,28
TIKI,thoi-trang-nu,115444847,"Áo Hoodie Nón Chui Trùm Đầu Nữ Nam Unisex Chất Vải Nỉ Poly Nam Nữ In Chữ, áo hooodie nam , áo hoodie nữ , áo hoodie cặp đôi, áo khoác hoodie form rộng vải pe chống nắng chống lạnh tốt",100000,100000,0,0
TIKI,thoi-trang-nu,192788548,"Áo lót nữ nâng ngực tạo khe Triumph 218-280 cúp chéo, có gọng, đệm mút vừa",449000,559000,110000,20
TIKI,thoi-trang-nu,58565533,"Áo ngực nữ Triumph 052HP không gọng,mút mỏng phối ren màu hồng phấn",399000,489000,90000,18
TIKI,thoi-trang-nu,167430064,"Quần Jean Nữ, Quần Jean Nữ Lưng Cao, Quần Jean Nữ Siêu Hack Dáng thương hiệu Chandi, Jean Nữ co dãn tôn dáng phụ nữ eo thon mẫu MS614",180000,350000,170000,49
TIKI,thoi-trang-nu,193367661,"Áo Khoác Dù SENTINIALS 2 Lớp Form Rộng Nam Nữ Unisex, Áo Gió Bomber Bóng Chày Chống Nắng Ulzzang",100000,100000,0,0
TIKI,thoi-trang-nu,107351969,"Quần ống rộng gân tăm dáng dáng nhiều màu",76000,76000,0,0
TIKI,thoi-trang-nu,105547448,"Combo 2 quần lót ( màu ngẫu nhiên) nữ ren gợi cảm đính kim cương, lưới siêu mỏng thoáng khí LYEQ027",86000,92000,6000,7
TIKI,thoi-trang-nu,116573790,"Quần ống rộng nữ ,quần ống suông nữ 2 khuy lưng cao chất tuyết mưa phom chuẩn ,y hình",99000,99000,0,0
TIKI,thoi-trang-nu,116575134,"Quần ống rộng nữ ,quần ống suông nữ dáng lửng kiểu hàn măc thoáng mát",60000,60000,0,0
TIKI,thoi-trang-nu,145557128,"Áo khoác hoodie trơn nam nữ form rộng Yinxx, áo nỉ hoodie zip unisex HDZ800",100000,100000,0,0
TIKI,thoi-trang-nu,134388787,"Áo Sơ Mi Nhung Gân Tăm Phong Cách Retro Hàn Quốc Form Rộng Unisex Nam Nữ Ulzzang",152000,152000,0,0
TIKI,thoi-trang-nu,122318789,"Chân váy bút chì công sở nữ Haint Boutique thiết kế chân váy len vân nổi dáng đuôi cá HB16",179000,179000,0,0
TIKI,thoi-trang-nu,55987281,"Quần đũi vải mềm dáng suông nữ Đũi Việt DV38",159000,159000,0,0
TIKI,thoi-trang-nu,117605306,"Áo khoác Kaki Nam Nữ Unisex - áo khoác Simple vải kaki tay dài form rộng",137000,137000,0,0
TIKI,thoi-trang-nu,77013970,"Áo Ngực Nâng Vừa Lưng Phối Ren Cánh Bướm Miley Lingerie BRM104",205000,315000,110000,35
TIKI,thoi-trang-nu,97362236,"ÁO LÓT NỮ REN KHÔNG ĐỆM MÚT CÓ GỌNG NÂNG NGỰC THOÁNG MÁT SEXY",36499,36499,0,0
TIKI,thoi-trang-nu,138123252,"váy body nữ, đầm ôm cổ lọ chất len tăm xinh xắn",69000,69000,0,0
TIKI,thoi-trang-nu,46636364,"Áo Khoác Nữ Chống Nắng Bụi Khóa Kéo Che Cổ Phúc An DN0001",159000,159000,0,0
TIKI,thoi-trang-nu,44233599,"Áo hoodie nữ",100000,100000,0,0
TIKI,thoi-trang-nu,119263254,"Chân váy nữ,chân váy chữ a lưng cao chất liệu kaki năng động",89000,89000,0,0
TIKI,thoi-trang-nu,68548641,"Chân váy len dáng dài Quảng Châu xẻ sau co giãn nhiều màu CV13",179000,179000,0,0
TIKI,thoi-trang-nu,176685323,"đồ bộ mặc nhà mẫu lửng, chất lụa hàn",225000,225000,0,0
TIKI,thoi-trang-nu,183559397,"Đầm linen dáng suông cổ sơ mi 2 túi đắp ARCTIC HUNTER, thời trang thương hiệu chính hãng AH74",299000,299000,0,0
TIKI,thoi-trang-nu,175416698,"Váy ngủ lụa cổ V ren hông dây yếm cao cấp Q440 - Váy ngủ lụa sexy - Đầm ngủ nữ gợi cảm - Đồ ngủ mạc nhà quyến rũ",119000,190000,71000,37
TIKI,thoi-trang-nu,17046982,"Đầm nữ suông dài freesize Haint Boutique b20",299000,299000,0,0
TIKI,thoi-trang-nu,38073664,"Áo Sơ Mi Công Sở Nữ Cổ Chữ v Vải Tở Nhung Xếp Ly Kèm Phụ Kiện GOTI 3099",229000,229000,0,0
TIKI,bach-hoa-online,133696713,"Dầu Đậu Nành Simply 1L / 2L / 5L",63900,68300,4400,6
TIKI,bach-hoa-online,10240037,"Thùng 48 Hộp Sữa Nestlé MILO Nước (180ml / Hộp)",356000,450000,94000,21
TIKI,bach-hoa-online,59504295,"Dầu Ăn Thượng Hạng Nhãn Hiệu Neptune Light",53500,66500,13000,20
TIKI,bach-hoa-online,15973974,"Thùng 48 Hộp Sữa Nestlé Milo Ít Đường (180ml/ Hộp)",346000,450000,104000,23
TIKI,bach-hoa-online,161409499,"Thùng 48 hộp sữa tươi tiệt trùng ít đường TH True Milk 180ml (180ml x 48)",459613,459613,0,0
TIKI,bach-hoa-online,12629696,"Thùng Sữa đậu nành Fami nguyên chất (200ml x 36 Hộp)",167000,184197,17197,9
TIKI,bach-hoa-online,272848014,"Hạt nêm rau củ Massel Úc 100% từ rau củ thảo mộc bảo vệ sức khỏe, dành cho ăn chay, ăn mặn, ăn kiêng và cho bé ăn dặm - QuaTangMe Extaste",93000,186000,93000,50
TIKI,bach-hoa-online,2454353,"Thùng 48 Hộp Sữa Chua Lên Men Tự Nhiên Yomost Vị Dâu (170ml/Hộp)",359000,448000,89000,20
TIKI,bach-hoa-online,2454355,"Thùng 48 Hộp Sữa Chua Lên Men Tự Nhiên Yomost Vị Cam (170ml/Hộp)",381000,448000,67000,15
TIKI,bach-hoa-online,54031205,"Mì Goreng Vị Đặc Biệt Indomie (85G X 40 Gói/Thùng)",219000,240000,21000,9
TIKI,bach-hoa-online,133682930,"Dầu Ăn Cái Lân 1L / 2L / 5L",37900,42400,4500,11
TIKI,bach-hoa-online,109403839,"Snack ăn kiêng gạo lứt ngũ cốc nguyên hạt GUfoods - Thanh đạm, Tiện lợi, Phù hợp Eat clean",32000,69000,37000,54
TIKI,bach-hoa-online,272198562,"Hạt nêm rau củ Massel Úc 100% từ rau củ thảo mộc bảo vệ sức khỏe, dành cho ăn chay, ăn mặn, ăn kiêng, và cho bé ăn dặm - Massel Official",70000,186000,116000,62
TIKI,bach-hoa-online,20112005,"Ngũ Cốc Calbee Frugra Nhật Bản (482g)",129000,158000,29000,18
TIKI,bach-hoa-online,85479195,"Cà phê Nguyên Chất Arabica Cầu Đất Rang Mộc Đặc Biệt, Ca Phe Hạt Pha Máy, Cafe Pha Phin Ngon Hậu Ngọt Thanh Từ Nông Trại Message Coffee",181000,230000,49000,21
TIKI,bach-hoa-online,12688145,"Thùng 24 lon cao Heineken Silver (330ml/lon)",460000,508000,48000,9
TIKI,bach-hoa-online,192876361,"Snack gạo lứt kẹp bơ hạt GUfoods (bơ điều / bơ đậu phộng) - Ăn kiêng, Ăn vặt healthy, Lành mạnh, Eat clean, Thực dưỡng",92000,199000,107000,54
TIKI,bach-hoa-online,2454359,"Thùng 48 Hộp Sữa Chua Lên Men Tự Nhiên Yomost Trái Lựu (170ml/Hộp)",359000,448000,89000,20
TIKI,bach-hoa-online,58811363,"Bánh gạo lứt nguyên hạt GUfoods (510g = 54 bánh) - Phù hợp ăn kiêng, Tập Gym, Eat clean",65000,139000,74000,53
TIKI,bach-hoa-online,142996124,"Hạt nêm rau củ Massel Úc 100% từ rau củ thảo mộc bảo vệ sức khỏe, dành cho ăn chay, ăn mặn, ăn kiêng, và cho bé ăn dặm - OZ Slim Store",93000,186000,93000,50
TIKI,bach-hoa-online,174247255,"Trung Nguyên Legend - Cà phê hòa tan G7 3in1 - Bịch 50 sachets x 16gr (gói vuông)",165000,196937,31937,16
TIKI,bach-hoa-online,2454357,"Thùng 48 Hộp Sữa Chua Lên Men Tự Nhiên Yomost Bạc Hà - Việt Quất (170ml/Hộp)",356000,362000,6000,2
TIKI,bach-hoa-online,51932016,"Cà Phê Phin Cầu Đất (Arabica & Robusta) Rang Xay Mộc Sạch Nguyên Chất Chuẩn Gu Người Việt - Túi 250Gr (Dạng Bột)",115000,120000,5000,4
TIKI,bach-hoa-online,52215446,"Thùng 24 lon Tiger Crystal lon cao (330ml/lon)",450000,450000,0,0
TIKI,bach-hoa-online,76045155,"Bún gạo lứt (đen / huyết rồng) ăn kiêng GUfoods - Dai ngon, Kết hợp đa dạng món, Eat clean, Thực dưỡng, Thuần chay",44900,75000,30100,40
TIKI,bach-hoa-online,179437521,"Hạnh Nhân Mỹ Rang Bơ Pams (50g/túi) Hạt Hạnh Nhân Giòn Thơm, Béo Bùi Vị Bơ, Thích Hợp Ăn Giảm Cân",20000,40000,20000,50
TIKI,bach-hoa-online,68006413,"Yến Mạch Cán Mỏng DK Harvest - Túi 500g, 1kg",15000,15000,0,0
TIKI,bach-hoa-online,91474073,"Cà phê hòa tan Nescafé 3in1 Cà Phê Sữa Đá 600G ( Bịch 25 Gói x 24g )",121000,138000,17000,12
TIKI,bach-hoa-online,65923404,"Trà Oolong Kim Tuyên Cầu Đất - Hộp 220Gr - Dalat Farm ",175000,190000,15000,8
TIKI,bach-hoa-online,23192253,"Thùng sữa đậu nành Fami Canxi Nguyên vị (200ml x 36 hộp)",174000,191329,17329,9
TIKI,bach-hoa-online,39702057,"Trung Nguyên Legend - Cà phê rang xay S Chinh phục - Bịch 500gr",77000,90515,13515,15
TIKI,bach-hoa-online,161409497,"Thùng 48 hộp sữa tươi tiệt trùng nguyên chất TH True Milk 110ml (110ml x 48)",292792,292792,0,0
TIKI,bach-hoa-online,7865974,"Thùng 24 Hộp Sữa Đậu Đen, Óc Chó, Hạnh Nhân Sahmyook Foods (140ml / Hộp)",236000,400000,164000,41
TIKI,bach-hoa-online,107548406,"Gạo Thơm Đặc Sản ST25 Neptune túi 5kg",209664,209664,0,0
TIKI,bach-hoa-online,98329162,"Thùng 24 Lon Nước Tăng Lực Sting Dâu (320ml/Lon)",196000,280000,84000,30
TIKI,bach-hoa-online,114809856,"Cà phê hòa tan NESCAFÉ Café Việt Cà phê đen đá (Túi 35 gói x 16g)",124000,137000,13000,9
TIKI,bach-hoa-online,58405538,"Trung Nguyên Legend - Cà phê rang xay I Khát vọng - Bịch 500gr",90000,106734,16734,16
TIKI,bach-hoa-online,140579521,"Bánh ăn sáng C'est Bon Sốt Kem Trứng Lava 8P",31000,42000,11000,26
TIKI,bach-hoa-online,98329082,"Thùng 24 Lon Nước Tăng Lực Sting Vàng (320ml/Lon)",182000,240000,58000,24
TIKI,bach-hoa-online,59514129,"Trung Nguyên Legend - Cà phê hòa tan G7 3in1 - Bịch 50 sticks x 16gr (gói dài)",165000,196937,31937,16
TIKI,bach-hoa-online,161409487,"Thùng 48 hộp sữa tươi tiệt trùng TOPKID kem vanilla tự nhiên TH True Milk 180ml (180ml x 48)",606000,624413,18413,3
TIKI,bach-hoa-online,183337321,"Dầu mè đen nguyên chất GUfoods - Lành mạnh, Phù hợp eat clean, Trộn salad, Cho bé ăn dặm",65000,139000,74000,53
TIKI,bach-hoa-online,51713363,"Trung Nguyên Legend - Cà phê hoà tan rang xay 3in1 Special Edition - Hộp 18 gói x 25gr",112000,141457,29457,21
TIKI,bach-hoa-online,17967602,"Hạt Chia Đen DK Harvest",69000,72000,3000,4
TIKI,bach-hoa-online,190254498,"Granola Siêu Hạt Smilenuts Gồm Hạnh Nhân, Nho khô, Óc Chó, Yến Mạch, Macca, Hạt điều, Mật ong _ Khối Lượng 500g",179000,195000,16000,8
TIKI,bach-hoa-online,161409519,"Thùng 48 hộp sữa tươi tiệt trùng nguyên chất TH True Milk 180ml (180ml x 48)",459613,459613,0,0
TIKI,bach-hoa-online,161454715,"Trung Nguyên Legend - Cà phê hoà tan rang xay 3in1 Classic - Bịch 50 gói x 17gr",159000,202599,43599,22
TIKI,bach-hoa-online,77152083,"Bánh gạo lứt mầm GUfoods (bánh mầm) - Giàu GABA tự nhiên, Hỗ trợ ăn kiêng, Thực dưỡng, Thuần chay",92000,199000,107000,54
TIKI,bach-hoa-online,68211446,"Bột ngũ cốc dinh dưỡng cao cấp 05 loại đậu & hạt ( không đường )  - MS - (500gr)",90000,95000,5000,5
TIKI,bach-hoa-online,58434660,"Trung Nguyên Legend - Cà phê sữa hòa tan G7 3in1 - Bịch 100 sticks x 16gr (gói dài)",295000,365738,70738,19
TIKI,bach-hoa-online,113080765,"Bộ 12 túi thức ăn mèo lớn Whiskas vị cá biển 80g",141000,150000,9000,6
TIKI,bach-hoa-online,53831590,"Dầu Gạo Lứt Simply 1L",64800,76300,11500,15
TIKI,bach-hoa-online,5439427,"Nước Yến Sào win'sNest Nhân Sâm (6 Lọ x 70 ml / Hộp) thích hợp cho người lớn và người bệnh trong quá trình hồi phục sức khỏe ",141000,279000,138000,49
TIKI,bach-hoa-online,17943792,"Câu Kỷ Tử Organic DK Harvest Loại Cao Cấp Nhập Khẩu - Khối Lượng 100g/200g - tác dụng tăng cường hệ miễn dịch",81000,89000,8000,9
TIKI,bach-hoa-online,133683743,"Dầu Đậu Nành Meizan  1L / 2L / 5L",53900,57600,3700,6
TIKI,bach-hoa-online,55625510,"Táo Đỏ Tân Cương Dried Jujube DK Harvest",68000,69000,1000,1
TIKI,bach-hoa-online,275466789,"Mật Ong Hoa Cafe Daklak TETE 1 Lít/ chai",49000,49000,0,0
TIKI,bach-hoa-online,54690900,"Trà Xanh Cầu Đất - Túi 150Gr (Green Tea) ",57000,60000,3000,5
TIKI,bach-hoa-online,68031130,"Cà phê bột Arabica Cầu Đất 500g nguyên chất 100% Coffee Tree  thơm nồng, vị nhẹ, gu tây",147000,299000,152000,51
TIKI,bach-hoa-online,609586,"Thùng 24 Hộp Sữa Đậu Đen, Óc Chó, Hạnh Nhân Sahmyook Foods (190ml / Hộp)",295000,450000,155000,34
TIKI,bach-hoa-online,133683792,"Dầu Ăn Meizan Gold 1L / 2L / 5L",45900,50900,5000,10
TIKI,bach-hoa-online,114809875,"Cà phê hòa tan kết hợp rang xay NESCAFÉ RED CUP 200g",162000,209000,47000,22
TIKI,bach-hoa-online,58444508,"Sữa Lúa Mạch Nestlé MILO Teen Protein Canxi (24 x 210ml)",235000,285000,50000,18
TIKI,bach-hoa-online,161409461,"Thùng 48 hộp sữa tươi tiệt trùng có đường TH True Milk 180ml (180ml x 48)",459613,459613,0,0
TIKI,bach-hoa-online,94901052,"Nước Yến Sào win'sNest Đường Phèn (6 lọ x 70 ml/ Lốc)",122000,290000,168000,58
TIKI,bach-hoa-online,66475968,"Trà Lài Cầu Đất Đặc Biệt - Hộp 110Gr (Trà hoa Nhài - Jasmine Tea) Dalat Farm ",87000,90000,3000,3
TIKI,bach-hoa-online,44805254,"Ngũ Cốc Trái Cây Calbee Nhật Bản",164000,198000,34000,17
TIKI,bach-hoa-online,21257333,"Khô Gà Lá Chanh Cay TeTe 500gram",75000,75000,0,0
TIKI,bach-hoa-online,52005682,"Bánh ăn sáng C'est bon gói lớn siêu tiết kiệm - 3 gói 85g",73000,73000,0,0
TIKI,bach-hoa-online,161409483,"Thùng 48 hộp sữa tươi tiệt trùng có đường TH True Milk 110ml (110ml x 48)",292792,292792,0,0
TIKI,bach-hoa-online,22597852,"1kg Khô gà lá chanh thượng hạng hiệu TETE",142000,142000,0,0
TIKI,bach-hoa-online,131386574,"HẠT CATSRANG - THỨC ĂN CHO MÈO MỌI LỨA TUỔI (TÚI",64700,79000,14300,18
TIKI,bach-hoa-online,52853562,"Combo 2 lon sữa bột Bonecare Calcimax+: dành cho người từ 18 tuổi trở lên bổ sung canxi phòng ngừa loãng xương, tim mạch và tiểu đường.",391000,779000,388000,50
TIKI,bach-hoa-online,147896557,"Mì rau củ GUfoods - Giàu chất xơ, Tự nhiên, Healthy, Thực dưỡng, Eat clean",65000,115000,50000,43
TIKI,bach-hoa-online,49070804,"Cơm Cháy TeTeFood Hương Vị Miền Núi Tây Nguyên 500 gram",54000,54000,0,0
TIKI,bach-hoa-online,94065338,"Táo Đỏ Khô Smile Nuts hộp 110g mùa mới, mềm xốp, ngọt tự nhiên",25000,35000,10000,29
TIKI,bach-hoa-online,54031197,"Mì Goreng Rendeng Vị Bò Cay Indomie (91G X 40 Gói/Thùng)",219000,240000,21000,9
TIKI,bach-hoa-online,86267511,"Cà phê Cầu Đất Blend Cao Cấp Nguyên Chất Rang Mộc 100% Kết Hợp Giữa Arabica Cầu Đất Và Robusta Honey Cho Vị Đắng Đầm Thơm Ngọt Hậu - Message Coffee",171000,200000,29000,15
TIKI,bach-hoa-online,141658361,"Bia Hơi Hà Nội - Thùng 24 lon 500ml",399000,448000,49000,11
TIKI,bach-hoa-online,13409453,"Thùng 48 Hộp Sữa Tươi Tiệt Trùng Dutch Lady Cô Gái Hà Lan Có Đường (48 x 110ml)",219000,315000,96000,30
TIKI,bach-hoa-online,7026507,"Cà phê hòa tan TCHIBO FAMILY - 100% Robusta - Vị đắng đậm đà - lọ 200g",236220,254000,17780,7
TIKI,bach-hoa-online,183688840,"Trà khổ qua rừng GUfoods - Thanh lọc cơ thể, Mát gan, Hỗ trợ đẩy lùi tiểu đường",92000,199000,107000,54
TIKI,bach-hoa-online,134971272,"CHÀ BÔNG GÀ CHẤT LƯỢNG THƯƠNG HIỆU SK FOOD - BỊCH 50G",25000,25000,0,0
TIKI,bach-hoa-online,55407453,"Trà Gạo Lứt Quê Việt - Giảm mỡ máu, giải độc gan, kiểm soát đường huyết, ngăn ngừa ung thư ( gạo lứt, đậu đen xanh lòng, đậu đỏ, kỷ tử, hoa nhài, cỏ ngọt)",168000,230000,62000,27
TIKI,bach-hoa-online,53831604,"Dầu Gạo Lứt Simply 2L",130000,149000,19000,13
TIKI,bach-hoa-online,50715631,"Trà atiso Ladophar gói 100 túi lọc artichoke Actiso Đà Lạt giúp mát gan thông mật lợi tiểu tặng 1 túi trà",85000,85000,0,0
TIKI,bach-hoa-online,151548613,"Bột Ngọt AJI-NO-MOTO® Hạt Nhỏ 5kg/Gói",293000,293000,0,0
TIKI,bach-hoa-online,161409463,"Thùng 48 hộp sữa tươi tiệt trùng TH True Milk HILO 180ml (180ml x 48)",491000,505181,14181,3
TIKI,bach-hoa-online,17148693,"Bột CaCao Nguyên Chất 100% DK Harvest",39000,39000,0,0
TIKI,bach-hoa-online,49246233,"THỨC ĂN CHO MÈO MỌI LỨA TUỔI CATSRANG 3KG",350500,420000,69500,17
TIKI,bach-hoa-online,68269446,"Bột ngũ cốc dinh dưỡng từ 18 loại  Đậu & Hạt cao cấp - MS ( 500gr)",125000,125000,0,0
TIKI,bach-hoa-online,140630666,"Nui gạo lứt / nui ngũ sắc GUfoods (Gói 500g) - Dai ngon, Tiện lợi, Healthy, Eat clean, Thực dưỡng, Thuần chay",46000,99000,53000,54
TIKI,bach-hoa-online,58406605,"Trung Nguyên Legend - Cà phê rang xay Sáng tạo 5 - Bịch 340gr",142000,180349,38349,21
TIKI,bach-hoa-online,22100933,"Hạt Chia Đen Hữu Cơ Smile Nuts Hộp 500g - Nhập khẩu từ Nam Mỹ (Hạt Chia sạch organic, cam kết chất lượng)",109000,150000,41000,27
TIKI,bach-hoa-online,247262742,"Hạt nêm Massel Úc 100% Từ Rau Củ, Hương vị Bò - Nấu ăn dặm cho bé, món chay, món mặn, ăn kiêng, phù hợp cho bữa ăn ngon và bảo vệ sức khỏe - Massel Official",93000,186000,93000,50
TIKI,bach-hoa-online,8157210,"Bánh Chocopie Hộp 12 Cái",54600,63000,8400,13
TIKI,bach-hoa-online,51966118,"Trà Lài Cầu Đất - Túi 150Gr (Trà Hoa Nhài - Jasmine Tea)",60000,60000,0,0
TIKI,bach-hoa-online,20697897,"Thùng 12 Hộp Sữa Đậu Đen, Óc Chó, Hạnh Nhân Sahmyook Foods (950ml/Hộp)",642000,990000,348000,35
TIKI,bach-hoa-online,16837581,"THÙNG 72 LỌ YẾN SÀO WIN'SNEST TỔ YẾN CHƯNG SẴN BỔ SUNG CANXI 20% (70ML/LỌ)",2202690,4319000,2116310,49
TIKI,bach-hoa-online,108970053,"Muối hồng Himalaya GUfoods (dạng hạt mịn) - Tự nhiên, Tinh khiết, Giàu khoáng chất",32000,59000,27000,46
TIKI,bach-hoa-online,20366824,"Trung Nguyên Legend - Cà phê hạt rang Success 1 - Bịch 1kg",259000,339625,80625,24
TIKI,bach-hoa-online,3170593,"Bột ngũ cốc Damtuh Hàn Quốc 900g hộp 50 gói-PP",236000,236000,0,0
TIKI,bach-hoa-online,5444345,"Nước Yến Sào win'sNest Đường Phèn ( 6 Lọ * 70 ml / Hộp) giúp bồi bổ sức khỏe tăng cường sức đề kháng, thích hợp cho mọi đối tượng và trẻ em từ 1 tuổi trở lên",132000,270000,138000,51
TIKI,bach-hoa-online,54031203,"Mì Goreng Rasa Iga Penyet Vị Sườn Indomie (80G X 40 Gói/Thùng)",219000,240000,21000,9
TIKI,bach-hoa-online,72926595,"Bánh Biscotti nguyên cám thuần chay GUfoods - Lành mạnh, Thơm ngon, Phù hợp Ăn kiêng, Eat clean",158000,339000,181000,53
TIKI,bach-hoa-online,51713342,"Trung Nguyên Legend - Cà phê rang xay Sức sống Nâu - Bịch 500gr",118000,134799,16799,12
TIKI,bach-hoa-online,73090608,"Rượu vang đỏ Úc Jacob's Creek Classic Shiraz 750ml 12.9% - 14.9% - Không hộp",280000,341000,61000,18
TIKI,bach-hoa-online,166438276,"Bánh Custas Kem Cốm Hà Nội 12P (276g)",56000,78100,22100,28
TIKI,bach-hoa-online,74854036,"Catsrang 5Kg Thức Ăn Hạt Cho Mèo Mọi Lứa Tuổi",440000,441999,1999,0
TIKI,bach-hoa-online,5981831,"Nước Yến Sào win'sNest Kids (6 Lọ x 70 ml / Lốc)",147950,269000,121050,45
TIKI,bach-hoa-online,68429315,"Hạt Hạnh Nhân Sống DK Harvest  Nhập Khẩu - Túi 500g, 1000g",159000,159000,0,0
TIKI,bach-hoa-online,44899954,"Hạnh Nhân Rang Mộc DK HARVEST Nhập Khẩu - Hàng loại 1 nguyên vị và không thêm phụ gia - 250g, 500g",84000,84000,0,0
TIKI,bach-hoa-online,154231134,"Đường Mía Thượng hạng",17600,17600,0,0
TIKI,bach-hoa-online,45803948,"Đặc sản Sóc Trăng - Gạo Thơm ST25 Túi 5Kg - Đạt Giải Gạo Ngon Nhất Thế Giới Năm 2019 tại Manila - OCOP 4 Sao",195000,195000,0,0
TIKI,bach-hoa-online,178475763,"Bánh Quy Yến Mạch Quaker 270g",62100,66000,3900,6
TIKI,bach-hoa-online,72544445,"Cát Vệ Sinh Đậu Phụ Cho Mèo ACROPET 5L - Hương Trà Xanh",97700,120000,22300,19
TIKI,bach-hoa-online,97933472,"Cát vệ sinh cho mèo Happycat 15L siêu khử mùi kháng khuẩn",102000,108000,6000,6
TIKI,bach-hoa-online,177336106,"Thùng Veyo Sữa hạt lên men tự nhiên Vị Đào Tiên Nhật (30hộp x 180ml)",197000,249075,52075,21
TIKI,bach-hoa-online,73569777,"Cà phê bột Robusta nguyên chất 100% 500gr  - Coffee Tree thơm ngon, đậm đà",87000,195000,108000,55
TIKI,bach-hoa-online,58899983,"Cà phê Robusta Honey nguyên chất rang mộc cafe pha phin - pha máy vị đắng đầm, hậu ngọt và hương thơm nồng từ Message Coffee",143000,190000,47000,25
TIKI,bach-hoa-online,56366146,"Trà Hoa Cúc Vàng Sấy Khô Nguyên Bông DK Harvest - Ngủ ngon sâu giấc, sáng mắt, thanh nhiệt",79000,92000,13000,14
TIKI,bach-hoa-online,50874054,"Natural Tỏi bột 60g Dh Foods - Bột tỏi nguyên chất",19900,19900,0,0
TIKI,bach-hoa-online,8083719,"Gạo Nhật Cao Cấp Taiyo - Dẻo Nhiều (5kg)",138000,138000,0,0
TIKI,bach-hoa-online,92710957,"Thức ăn mèo Whiskas vị cá thu túi 1.2kg",122500,125000,2500,2
TIKI,bach-hoa-online,2923763,"Gạo Thơm Lài Lotus Rice 5kg - Cơm mềm dẻo vừa - Chuẩn xuất khẩu",145000,145000,0,0
TIKI,bach-hoa-online,251998487,"Hạt mix 8 loại hạt dinh dưỡng (Hạt macca, óc chó vàng, óc chó đỏ, hồ đào, hạnh nhân, hạt dẻ cười, hạt điều, bí xanh)",229000,250000,21000,8
TIKI,bach-hoa-online,97551871,"Thùng 24 chai Nước Khoáng Kiềm Thiên Nhiên Vikoda 500ml",144000,144000,0,0
TIKI,bach-hoa-online,95738122,"Trà Xanh Hương Dứa Dalatfarm - Hộp 110Gr",87000,90000,3000,3
TIKI,bach-hoa-online,100002376,"Cà phê hạt Arabica Cầu Đất rang xay mộc nguyên chất - Túi 250Gr (Dạng Hạt)",139000,150000,11000,7
TIKI,bach-hoa-online,157600763,"Trung Nguyên Legend - Cà phê hoà tan rang xay 3in1 Classic - Hộp 21 gói x 17gr",84000,95872,11872,12
TIKI,bach-hoa-online,14507333,"Combo 2 Túi Táo Đỏ Khô Tân Cương Smile Nuts 500g",175000,252000,77000,31
TIKI,bach-hoa-online,190603077,"Thức ăn cho chó /  Pate Moochie dạng gói dành cho chó mọi lứa tuổi - gói 85gr",12500,25000,12500,50
TIKI,bach-hoa-online,74870030,"Hạt Dẻ Cười Mỹ Smile Nuts (215g - 500g) | 100% Nhập khẩu từ Mỹ, không tẩy trắng - Dẻ cười rang muối vừa ăn, thơm ngon, giòn rụm",119000,170000,51000,30
TIKI,bach-hoa-online,137786472,"Thức ăn khô cho mèo Hàn Quốc mọi lứa tuổi Catsrang All Life Stages Hộp nguyên Seal",58888,58888,0,0
TIKI,bach-hoa-online,166525080,"Bột cần tây hữu cơ nguyên chất sấy lạnh Dalahouse - Mẫu mới 2022 Hộp - Hỗ trợ giảm cân, cao huyết áp, ngăn chặn gia tăng mỡ trong máu",121500,121500,0,0
TIKI,bach-hoa-online,68838497,"Trân châu caramel Déli 1kg",54000,54000,0,0
TIKI,bach-hoa-online,5506013,"Ngũ Cốc Sấy Khô Calbee nội địa Nhật Bản 800g",137000,137000,0,0
TIKI,bach-hoa-online,8082641,"Đặc sản Tiền Giang - Gạo Quê Dẻo Vừa Đỗ Quyên (5kg) - OCOP 4 SAO",105000,112000,7000,6
TIKI,bach-hoa-online,31451473,"Nhân Hạt Óc Chó DK Harvest",79000,85000,6000,7
TIKI,bach-hoa-online,25412384,"Thùng 24 Chai Nước Tăng Lực Có Gas Warrior Vị Nho (330ml x 24 chai)",195000,250000,55000,22
TIKI,bach-hoa-online,92710924,"Thức ăn mèo whiskas vị cá biển túi 3kg",270750,285000,14250,5
TIKI,bach-hoa-online,58392902,"Trung Nguyên Legend - Cà phê G7 hòa tan đen ( không đường) - bịch 100 sachets 2gr",189000,226641,37641,17
TIKI,bach-hoa-online,51713351,"Trung Nguyên Legend - Cà phê hoà tan rang xay Passiona - Hộp 14 gói x 16gr",76000,86848,10848,12
TIKI,bach-hoa-online,114809866,"Nước tương MAGGI đậu nành đậm đặc 700ml",35000,40000,5000,13
TIKI,bach-hoa-online,54619544,"Cà phê Arabica Cầu Đất rang mộc sạch nguyên chất - Túi 250Gr (Dạng Bột)",145000,150000,5000,3
TIKI,bach-hoa-online,13409520,"Thùng 48 Hộp Sữa Uống Dutch Lady Cô Gái Hà Lan Có Đường Cao Khỏe (48X170ml)",340000,450000,110000,24
TIKI,bach-hoa-online,161409457,"Thùng 48 hộp sữa tươi tiệt trùng hương dâu TH True Milk 180ml (180ml x 48)",459613,459613,0,0
TIKI,bach-hoa-online,174101598,"Granola Siêu Hạt DK Harvest - 5 loại hạt ngũ cốc Giảm Cân Nướng Mật Ong, Không Đường - Trọng lượng 500g",125000,134000,9000,7
TIKI,bach-hoa-online,58395158,"Gạo thơm đặc sản ST24+ Sóc Trăng (Túi 5kg) - Intimex Group - Dẻo, thơm ngon, ngọt cơm",170000,170000,0,0
TIKI,bach-hoa-online,218749295,"Combo Bột Ngọt VEDAN",94500,105000,10500,10
TIKI,bach-hoa-online,2904963,"Gạo lứt đỏ hữu cơ cao cấp - ECOBA Huyết Rồng 1kg - Cơm mềm dễ ăn - Gạo lứt ăn kiêng",110000,110000,0,0
TIKI,bach-hoa-online,57118697,"Cà phê bột nguyên chất 100% Coffee Tree đặc biệt 500gr thơm ngon, đậm đà - Cà phê rang xay pha phin gu việt",129000,196000,67000,34
TIKI,bach-hoa-online,140579523,"Bánh Gạo Nướng An Vị Tự Nhiên (Gói 21 bánh)",31200,35000,3800,11
TIKI,bach-hoa-online,58448354,"Trung Nguyên Legend - Cà phê rang xay Chế phin 5 - Bịch 500gr",263000,292910,29910,10
TIKI,bach-hoa-online,16832052,"Yến sào cao cấp  win'sNest kids 20% tổ yến chưng sẵn dành cho trẻ em (3Lọ/ Lốc) hương vị vani sản phẩm thích hợp cho trẻ em từ 1 tuổi trở lên.",77000,185000,108000,58
TIKI,bach-hoa-online,136414743,"Bắp Mỹ Rang Bơ TETE Food (Nổ Hình Bướm) bắp nổ rap chiếu phim 400 gram",35000,35000,0,0
TIKI,bach-hoa-online,3812941,"Cà Phê Hòa Tan Davidoff Café  Fine Aroma D100F (100g)",246450,265000,18550,7
TIKI,bach-hoa-online,97572214,"Thức Ăn Cho Mèo Con - Catsrang Kitten",77000,92000,15000,16
TIKI,bach-hoa-online,67921481,"Trung Nguyên Legend - Creamer đặc có đường Brothers - Lon 390gr",29305,29305,0,0
TIKI,bach-hoa-online,23192245,"Thùng 10 Hộp Sữa đậu nành Fami Canxi (1000ml/Hộp)",219000,244159,25159,10
TIKI,bach-hoa-online,61470015,"Bột Cần Tây Sấy Lạnh Jan's mới 20 gói tiện dụng",210000,210000,0,0
TIKI,bach-hoa-online,55062018,"HẠT ĐIỀU RANG MUỐI XẾP HOA TÂN LỘC PHÁT HỘP 500G",87000,110000,23000,21
TIKI,bach-hoa-online,161409506,"Thùng 48 hộp sữa tươi tiệt trùng sôcôla nguyên chất TH True Milk 180ml (180ml x 48)",459613,459613,0,0
TIKI,bach-hoa-online,109185538,"Trà gạo lứt đậu đen thanh nhiệt GUfoods - Tự nhiên, Healthy, Thanh lọc cơ thể, Mát gan, Cải thiện giấc ngủ, Đa dạng hương vị",56000,119000,63000,53
TIKI,bach-hoa-online,57353210,"Combo 2 Hộp Bánh Quy OREO Mini Vị Socola 2x204g",105000,136000,31000,23
TIKI,bach-hoa-online,92778398,"Bánh Goute Hộp 8 Cái (316.8g)",51900,59000,7100,12
TIKI,bach-hoa-online,75482123,"Bột cần tây sấy lạnh Dalahouse 60g (20 gói tiện dụng)",135000,135000,0,0
TIKI,bach-hoa-online,73403669,"Hạt Macca Úc nứt vỏ Smile Nuts (215g - 500g) | 100% nhập khẩu từ Úc, giòn béo, thơm ngon",99000,128000,29000,23
TIKI,bach-hoa-online,73090602,"Rượu vang đỏ Úc Jacob's Creek Classic Carbernet Sauvignon 750ml 12.8% - 14.8% - Không hộp",280000,341000,61000,18
TIKI,bach-hoa-online,100274577,"Sữa tươi UHT Đà Lạt True Milk Ít Đường 180ml (Thùng 48 hộp)",371055,426500,55445,13
TIKI,bach-hoa-online,4345189,"Hạt Chia Úc Tím Absolute Organic Chia Seeds 1Kg",148900,148900,0,0
TIKI,bach-hoa-online,112585192,"Combo Whiskas mèo con 80g mix 2 vị (cá ngừ + cá thu) - 24 túi",276000,300000,24000,8
TIKI,bach-hoa-online,46095231,"Đặc sản Tiền Giang - Gạo Lứt VietGAP Vinh Hiển (2KG) - Chuẩn VietGAP và OCOP 4 SAO",55000,55000,0,0
TIKI,bach-hoa-online,70606907,"Nước yến sào win'sNest Junior 12% (4 hũ * 70 ml / Hộp) thích hợp cho mọi đối tượng, đặc biệt trẻ em biếng ăn",77000,195000,118000,61
TIKI,bach-hoa-online,175688119,"Combo 2 Túi Cà Phê Bột Truyền Thống Highlands Coffee 1Kg",538000,660000,122000,18
TIKI,bach-hoa-online,86600525,"Yến Mạch Oats Canada Nguyên Chất túi 1kg ( Cán Vỡ  )",60000,60000,0,0
TIKI,bach-hoa-online,17979040,"Gạo Thơm Thượng Hạng Nàng Sen 2kg - Thơm ngon dẻo nhiều - Chuẩn nhà hàng 5 sao",75000,75000,0,0
TIKI,bach-hoa-online,59178438,"Trung Nguyên Legend - Cà phê sữa hòa tan G7 3in1 gu mạnh - Hộp 12 gói x 25gr",67000,77806,10806,14
TIKI,bach-hoa-online,71979469,"Trà Oolong Kim Tuyên Cầu Đất - Túi 200Gr",150000,155000,5000,3
TIKI,bach-hoa-online,52227046,"Trà Oolong Tấm Cầu Đất - Túi 500Gr -  Nguyên liệu làm trà sữa tự pha chế trà sữa đài loan Dalat Farm",145000,150000,5000,3
TIKI,bach-hoa-online,142310525,"Cà Phê Phin Cầu Đất (Arabica & Robusta) Rang Mộc DalatFarm - Hộp 250Gr (Dạng Bột)",135000,140000,5000,4
TIKI,bach-hoa-online,105954003,"Bánh Quy Thập Cẩm LU Công Thức Pháp 180g",61000,78000,17000,22
TIKI,bach-hoa-online,52132671,"Cà phê Robusta Lâm Đồng rang mộc sạch nguyên chất - Túi 250Gr (Dạng Bột)",105000,110000,5000,5
TIKI,bach-hoa-online,86587383,"Yến Mạch Oats Canada Nguyên Chất túi 1kg ( Nguyên Hạt )",60000,60000,0,0
TIKI,bach-hoa-online,92710896,"Thức ăn mèo con Whiskas vị cá biển & sữa 1.1kg",125000,125000,0,0
TIKI,bach-hoa-online,16167916,"Táo Đỏ Khô Cao Cấp Smile Nuts Hộp 500g",89000,126000,37000,29
TIKI,bach-hoa-online,35848354,"Cà Phê Đen Hòa Tan Espresso KING COFFEE - Hộp 100 gói x 2.5g",272000,353200,81200,23
TIKI,bach-hoa-online,178285551,"Thùng 48 hộp thức uống từ sữa chua lên men tự nhiên hiệu Fristi 100ml",189000,190000,1000,1
TIKI,bach-hoa-online,89654610,"Granola Yến Mạch Mix Hạt Giảm Cân MFOOD Hủ 500g",92000,92000,0,0
TIKI,bach-hoa-online,56439395,"Sữa bột Wincofood GoldCare Canxi: dinh dưỡng ít béo ngừa tiểu đường, bổ sung canxi giúp xương chắc khỏe, MUFA, PUFA tốt cho tim mạch, phù hợp cho người từ 30 tuổi trở lên.",223000,369000,146000,40
TIKI,bach-hoa-online,179437505,"Hạt Dẻ Cười Nhập Khẩu Mỹ Pams(25g/túi) Hạt Dẻ Cao Cấp Không Tẩy Trắng, Béo Bùi, Không Mềm Yểu Hạt",20000,40000,20000,50
TIKI,bach-hoa-online,23889095,"Hạt Đậu Gà Chickpeas DK HARVEST nhập khẩu Nam Mỹ/ Ấn Độ 700g",82000,89000,7000,8
TIKI,bach-hoa-online,161409464,"Thùng 48 hộp sữa tươi tiệt trùng sôcôla nguyên chất TH True Milk 110ml (110ml x 48)",292792,292792,0,0
TIKI,bach-hoa-online,54693149,"Trà Đen Cầu Đất DalatFarm - Túi 250Gr (Hồng Trà - Black Tea nguyên liệu pha chế trà sữa trà đào)",57000,60000,3000,5
TIKI,bach-hoa-online,5205373,"Bánh Quy Thập Cẩm LU Công Thức Pháp",118000,166000,48000,29
TIKI,bach-hoa-online,17489504,"Lốc 6 Lon Nước Tăng Lực Có Gas Warrior Vị Dâu 325ml",56000,80000,24000,30
TIKI,bach-hoa-online,179377378,"Bánh ống gạo lứt ăn kiêng GUfoods (Vị đậu đỏ hạt sen / Vị mè) - Giòn tan, Dễ tiêu hóa, Thực dưỡng, Eat clean, Thuần chay",41000,89000,48000,54
TIKI,bach-hoa-online,7958074,"Thùng 72 lọ Nước Yến Sào win'sNest Đường Phèn (70 ml/lọ)",1603000,3240000,1637000,51
TIKI,bach-hoa-online,56863272,"Cà phê hạt nguyên chất Coffee Tree đặc biêt (1kg) gu đậm đắng thơm - Cà phê pha phin hoặc pha máy từ BMT hiệu Coffee Tree",265000,465000,200000,43
TIKI,bach-hoa-online,14000041,"Táo Đỏ Khô Tân Cương Smile Nuts Túi 500g",126000,126000,0,0
TIKI,bach-hoa-online,10409803,"Cà Phê Bột Truyền Thống Highlands Coffee (1kg)",320000,375000,55000,15
TIKI,bach-hoa-online,220671868,"Ngũ cốc bầu Lạc Lạc - 1 hộp - 5 khăn xô sơ sinh",299000,299000,0,0
TIKI,bach-hoa-online,57306363,"Cà phê hạt Arabica Cầu Đất nguyên chất 100% Coffee Tree 1kg thơm nồng, vị nhẹ, gu tây - Cà phê Đà Lạt tuyển chọn hoàn toàn trái chín rang công nghệ Châu Âu",277000,599000,322000,54
TIKI,bach-hoa-online,73570463,"Cà phê hạt Robusta nguyên chất 100% 1kg - Coffee Tree thơm ngon, đậm đà",275000,390000,115000,29
TIKI,bach-hoa-online,31959713,"Yến Sào Win'snest Tổ Yến Chưng Sẵn Nhân Sâm Không Đường 20% (6 Lọ/Hộp) thích hợp cho người lớn, người bệnh đang trong quá trình phục hồi sức khỏe, người ăn kiêng và tiểu đường. ",198000,389900,191900,49
TIKI,bach-hoa-online,15317806,"Bộ 2 Hộp Bột Baking Soda Đa Công Dụng 454g - Arm & Hammer Chính Hãng, Nhập Khẩu Từ Mỹ, Giúp Tẩy Tế Bào Chết, Làm Trắng Răng Hiệu Quả, Làm Bánh, Tẩy Rửa Nhà Bếp, Giày Dép, Sàn Nhà Nhanh, Hiệu Quả",80000,80000,0,0
TIKI,bach-hoa-online,112289039,"Thùng 24 lon bia Heineken Silver Coolpack 250ml/lon",346000,390000,44000,11
TIKI,bach-hoa-online,141651048,"NGŨ CỐC DINH DƯỠNG GRANOLA ( hũ 500gr )",165000,180000,15000,8
TIKI,bach-hoa-online,105954000,"Combo 5 Hộp Bánh Quế OREO Vị Socola 5x54g",60000,80000,20000,25
TIKI,bach-hoa-online,73322503,"Hạt Hạnh Nhân Mỹ Tách Vỏ Smile Nuts (265g - 500g) | Hạnh nhân nhập khẩu từ Mỹ, nướng mộc giòn rụm, thơm ngon",109000,167000,58000,35
TIKI,bach-hoa-online,1064970,"Trung Nguyên Legend - Cà phê rang xay Sáng tạo 8 - Hộp 500gr",549000,625121,76121,12
TIKI,bach-hoa-online,95649061,"Trà Sen Dalatfarm - Hộp 110Gr",87000,90000,3000,3
TIKI,bach-hoa-online,167632015,"WHISKAS Thức ăn cho mèo lớn dạng sốt vị cá ngừ và cá thịt trắng 80g (12 gói)",141000,150000,9000,6
TIKI,bach-hoa-online,75993911,"Hạt Dưa Không Phẩm Màu TeTe 500 gram",110000,110000,0,0
TIKI,bach-hoa-online,73661838,"Mix Nhân Hạt Khô Smile Nuts (255g - 500g) | Hạt Dinh Dưỡng đã tách vỏ gồm nhân óc chó, hạnh nhân tách vỏ và nhân hạt bí xanh",115000,139000,24000,17
TIKI,bach-hoa-online,65859588,"Trà Xanh Cầu Đất Dalat Farm - Phiên Bản Đặc Biệt Bà Tôi - Hộp 110Gr",87000,90000,3000,3
TIKI,bach-hoa-online,142310107,"Cà Phê Arabica Cầu Đất Rang Mộc DalatFarm - Hộp 250Gr",160000,170000,10000,6
TIKI,bach-hoa-online,73282190,"1Kg Nhân Hạt Bí Xanh Nhập Khẩu Cao Cấp Thương Hiệu SK FOOD ",165000,165000,0,0
TIKI,bach-hoa-online,27857250,"Thức ăn hạt cho mèo mọi lứa tuổi CATSRANG",52700,69000,16300,24
TIKI,bach-hoa-online,74911748,"Sữa bột Wincofood Canxi Bone & Joints 800g : Bổ sung Canxi - Collagen và đường ăn kiêng tốt cho cơ xương khớp, chống lão hóa và ngừa tiểu đường.",199000,379000,180000,47
TIKI,bach-hoa-online,73852079,"Bột Đậu Nành Rang Nguyên Chất Thơm Ngon DTFood 500g",49000,50000,1000,2
TIKI,bach-hoa-online,124069895,"Dầu Đậu Nành cao cấp Golden 5 lít",380000,380000,0,0
TIKI,bach-hoa-online,54031199,"Mì Goreng Pedas Vị Cay Nồng Indomie (79G X 40 Gói/Thùng)",219000,240000,21000,9
TIKI,bach-hoa-online,57353212,"Combo 2 Hộp Bánh Quy OREO Mini Vị Vani 2x204g",105000,146000,41000,28
TIKI,bach-hoa-online,57300896,"Cà phê bột 100% nguyên chất truyền thống số 2 (500gr) Coffee Tree gu vừa vị chuẩn truyền thống",229000,229000,0,0
TIKI,bach-hoa-online,167649715,"WHISKAS Thức ăn cho mèo con dạng hạt vị cá thu 450g",55000,55000,0,0
TIKI,bach-hoa-online,44901147,"Hạt Bí Xanh (Đã Tách Vỏ) Nhập Khẩu – DK Harvest - 100% nguyên chất và không ướp muối - 250g, 500g",49000,49000,0,0
TIKI,bach-hoa-online,62737129,"Trung Nguyên Legend - Cà phê phin giấy Vietnamese Blend - Hộp 10 gói x 10gr",128000,148334,20334,14
TIKI,bach-hoa-online,58451648,"Trung Nguyên Legend - Cà phê hoà tan rang xay 3in1 Cafe sữa đá - Hộp 9 gói x 25gr",75000,107775,32775,30
TIKI,bach-hoa-online,121020870,"Dầu ăn thượng hạng Ranee Golden 5 lít",321000,321000,0,0
TIKI,bach-hoa-online,58408425,"Trung Nguyên Legend - Cà phê rang xay Chế phin 4 - Bịch 500gr",221000,246077,25077,10
TIKI,bach-hoa-online,74245802,"Trung Nguyên Legend - Cà phê G7 hòa tan đen ( không đường) - hộp 15 gói 2gr",35000,40909,5909,14
TIKI,bach-hoa-online,177661425,"Bánh tráng cuốn ăn kiêng GUfoods (làm gỏi cuốn, chả giò...) - Dai ngon, Tự nhiên, Lành mạnh, Eat clean",32000,69000,37000,54
TIKI,bach-hoa-online,51713344,"Trung Nguyên Legend - Cà phê hòa tan G7 3in1 - Hộp 18 sticks x 16gr (gói dài)",69000,79061,10061,13
TIKI,bach-hoa-online,94762047,"Đặc Sản Phú Quốc - Nước Mắm Phú Quốc Khải Hoàn 43 Độ Đạm Chai Nhựa 500Ml - Ocop 5 Sao",99500,113000,13500,12
TIKI,bach-hoa-online,52010818,"Mực Xé Sợi Nước Cốt Dừa TETE Food 300 gram",109000,109000,0,0
TIKI,bach-hoa-online,167442378,"Cát Vệ Sinh KM  Siêu Khử Mùi Vón Cục (Công nghệ của Đức)",45000,46999,1999,4
TIKI,bach-hoa-online,56229677,"Chà Là Nguyên Cành DK Harvest Nhập khẩu Tunisia",169000,179000,10000,6
TIKI,bach-hoa-online,205885984,"Trà gạo lứt đậu đen  - (Thanh nhiệt, mát gan, lợi sữa, an thần và ngủ ngon ) - 500gr",110000,110000,0,0
TIKI,bach-hoa-online,153368833,"Bánh Tráng Bơ Hot Hit Siêu Phẩm Ăn Vặt ABI SNACK",28000,28000,0,0
TIKI,bach-hoa-online,11242951,"Trà atiso túi lọc Thái Bảo, Đà Lạt loại 100 túi/ gói",129000,134000,5000,4
TIKI,bach-hoa-online,176711415,"Lốc 6 lọ Yến sào win'sNest 20% tổ yến chưng sẵn nhân sâm ít đường  (420ml/6 lọ)",177000,379000,202000,53
TIKI,bach-hoa-online,176712665,"Lốc 6 lọ Yến sào win'sNest Kids (20%) Tổ yến chưng sẵn dành cho trẻ em (420ml/6 lọ)",177000,369000,192000,52
TIKI,bach-hoa-online,130199721,"Rượu vang hồng Jacob's Creek Classic Crisp Rosé 750ml 12.0% - Không hộp",280000,341000,61000,18
TIKI,bach-hoa-online,161494017,"Thùng 48 hộp sữa chua uống tiệt trùng TOPKID hương cam tự nhiên TH True Yogurt 110ml (110ml x 48)",248417,248417,0,0
TIKI,bach-hoa-online,136313304,"COMBO SIÊU TIẾT KIỆM - 2 Táo Đỏ Tân Cương Dried Jujube DK Harvest",135000,135000,0,0
TIKI,bach-hoa-online,61363239,"Cát Vệ Sinh Đậu Phụ Cho Mèo ACROPET 5L - Hương Lavender",92000,92000,0,0
TIKI,bach-hoa-online,126218728,"Cafe Hoà tan 3 in 1 Ngon (Bịch To 60 gói) Trần Quang",129000,129000,0,0
TIKI,bach-hoa-online,155923704,"Hạt Điều Rang Muối Bình Phước Nguyên Hạt Size A Cồ Hàng Loại 1 (500Gr)",134900,135000,100,0
TIKI,bach-hoa-online,3493689,"Trung Nguyên Legend - Cà phê hoà tan rang xay 3in1 Classic - Hộp 12 gói x 17gr",51000,58468,7468,13
TIKI,bach-hoa-online,114467212,"Thùng Fristi Hương Dâu 48x80ml",195000,195000,0,0
TIKI,bach-hoa-online,43184557,"Thức ăn hạt cho mèo Hàn Quốc Catsrang",52000,52000,0,0
TIKI,bach-hoa-online,39371818,"Hạt Hạnh Nhân Tách Vỏ Nướng Mộc Smile Nuts Hộp Giấy 500g - Hạnh nhân nhập khẩu từ Mỹ, nướng mộc giòn rụm, thơm ngon",209000,265000,56000,21
TIKI,bach-hoa-online,65848108,"Trà Xanh Cầu Đất Dalat Farm - Hộp 110Gr",87000,90000,3000,3
TIKI,bach-hoa-online,31959842,"Thùng 72 lọ Yến Sào win'sNest Tổ Yến Chưng Sẵn nhân sâm không đường lọ (70ml)",2315000,4679000,2364000,51
TIKI,bach-hoa-online,92710935,"Thức ăn mèo Whiskas vị cá ngừ túi 1.2kg",122500,125000,2500,2
TIKI,bach-hoa-online,7236511,"Bột nêm ngưu báng 200g TÂM MINH FOODS thuần chay không bột ngọt",44000,44000,0,0
TIKI,bach-hoa-online,59178781,"Trung Nguyên Legend - Cà phê hoà tan rang xay Cappuccino Hazelnut - Hộp 12 gói x 18gr",72000,85874,13874,16
TIKI,bach-hoa-online,14965906,"Thùng 24 Hộp Sữa Tươi Tiệt Trùng Giàu Canxi Meadow Fresh (200ml / Hộp)",396576,396576,0,0
TIKI,bach-hoa-online,66071570,"Trà Đen Nguyên Lá Đặc Biệt Dalat Farm - Hộp 100Gr",87000,90000,3000,3
TIKI,bach-hoa-online,134652859,"Trà hoa cúc túi lọc cao cấp",89000,89000,0,0
TIKI,bach-hoa-online,73552095,"Trà Lài Cầu Đất DalatFarm (dòng Đặc Biệt) - Túi 110Gr",70000,70000,0,0
TIKI,bach-hoa-online,48711026,"Đường Phèn Quảng Ngãi  3T FOOD Hạt Nhuyễn",68000,68000,0,0
TIKI,bach-hoa-online,186392533,"Snack Khoai Tây Nướng Tok (Hộp 10 Gói x 36,5g)",96000,125000,29000,23
TIKI,bach-hoa-online,58407832,"Trung Nguyên Legend - Cà phê rang xay Sáng tạo 1 - Bịch 340gr",78000,92553,14553,16
TIKI,bach-hoa-online,7958236,"Nước Yến Sào win'sNest Nhân Sâm (70 ml )",47000,47000,0,0
TIKI,bach-hoa-online,120497686,"Trà lúa mạch Itoen Nhật Bản 405g",99000,99000,0,0
TIKI,bach-hoa-online,137754572,"CÁT VỆ SINH HỮU CƠ CHO MÈO VÓN CỤC KHỬ MÙI VÀ VI TRÙNG CAT’S BEST ORIGINAL",147700,200000,52300,26
TIKI,bach-hoa-online,95586655,"Trà Sen Dalatfarm - Túi 150Gr",57000,60000,3000,5
TIKI,bach-hoa-online,6677811,"Gạo lứt đen hữu cơ cao cấp/ECOBA Huyền Mễ 1kg - Thơm ngon dẻo ngọt - Thanh lọc cơ thể",115000,115000,0,0
TIKI,bach-hoa-online,170726975,"Thanh ngũ cốc gạo lứt  Chà Bông / Thanh cốm năng lượng /hạt dinh dưỡng / (Hộp 180G x 7 thanh)Đồ ăn vặt Vườn Xanh Sạch 	",54000,60000,6000,10
TIKI,bach-hoa-online,31975427,"Nước dừa Dứa Vico Fresh hộp 1L",40000,40000,0,0
TIKI,bach-hoa-online,188551103,"Gạo Đặc Sản ST25 Trạng Nguyên – Dẻo nhiều, dai cơm, thơm dứa - Chuẩn HACCP, VietGAP",68000,68000,0,0
TIKI,bach-hoa-online,3243007,"Thùng 30 Mì Chay Lẩu Thái VIFON (65g / Gói)",144000,186000,42000,23
TIKI,bach-hoa-online,20470942,"SÔCÔLA ĐEN 85% ALLUVIA NGUYÊN CHẤT, ÍT ĐƯỜNG | DARK CHOCOLATE 85% LESS SUGAR",66000,66000,0,0
TIKI,bach-hoa-online,10371298,"Sữa bột Wincofood Bonecare Calcimax+ 850g dành cho người từ 18 tuổi trở lên bổ sung canxi - Collagen và đường Isomalt phòng ngừa loãng xương, giúp chống lão hóa đẹp da và ngừa tiểu đường.",226000,389000,163000,42
TIKI,bach-hoa-online,134971271,"1kg chà bông gà loại thượng hạng cho bữa ăn ngon hiệu SK FOOD",195000,195000,0,0
TIKI,bach-hoa-online,70528681,"Yến sào win'sNest tổ yến 25% chưng sẵn nguyên chất ít đường (4 lọ*70ml/ Hộp) thích hợp cho mọi đối tượng và trẻ từ 3 tuổi trở lên",138000,279000,141000,51
TIKI,bach-hoa-online,94700752,"Đặc Sản Phú Quốc - Nước Mắm Phú Quốc Khải Hoàn 43 Độ Đạm Chai Nhựa 1L - Ocop 5 Sao",182000,206000,24000,12
TIKI,bach-hoa-online,112585188,"Combo Whiskas mèo con 80g mix 2 vị (cá ngừ + cá thu) - 12 túi",139500,150000,10500,7
TIKI,bach-hoa-online,50740437,"Nước mắm Tỏi ớt Thanh Hà 500ml",66100,66100,0,0
TIKI,bach-hoa-online,50411237,"Trà Xanh Thượng Hạng Tân Cương Thái Nguyên Khánh Nga 100g",47000,47000,0,0
TIKI,bach-hoa-online,193717283,"Bột Cacao Sữa Dừa Heyday - Gói Tiện Lợi 20g - Bột cacao sữa dừa tự nhiên, thuần chay - Heyday Cacao",10000,10000,0,0
TIKI,bach-hoa-online,483310,"Dầu Hạt Cải Simply (1L / Chai)",60200,64500,4300,7
TIKI,bach-hoa-online,14968699,"Thùng 12 hộp Sữa tươi tiệt trùng nguyên kem Meadow Fresh 1L hàng New Zealand",521000,525240,4240,1
TIKI,bach-hoa-online,117092872,"Giấm gạo lên men Ajjinomoto 400ml",17000,24000,7000,29
TIKI,bach-hoa-online,67207109,"Thức Ăn Hạt Catsrang Cho Mèo Mọi Lứa Tuổi - 2Kg",243000,243000,0,0
TIKI,bach-hoa-online,72301784,"Bột gạo lứt - mè đen - hạt sen 500g - ( MS)",90000,90000,0,0
TIKI,bach-hoa-online,189183882,"Bột Ngọt VEDAN 1kg",59000,59000,0,0
TIKI,bach-hoa-online,73859726,"BÁNH PHỒNG TÔM CÀ MAU TETE 500GRAM",59000,59000,0,0
TIKI,bach-hoa-online,154698881,"Hà thủ ô sấy khô L'angfarm, 450g, bịch",162900,181000,18100,10
TIKI,bach-hoa-online,174502556,"[COMBO 3 HỘP] Kẹo ngậm Viacol thảo mộc Vietnat không đường giảm ho đau họng - 20 viên/ hộp",109000,109000,0,0
TIKI,bach-hoa-online,140465999,"Thức ăn cho mèo trưởng thành Me-O Cat Food Hộp 1kg",74444,74444,0,0
TIKI,bach-hoa-online,56834655,"1kg Bột Baking Soda Đa Công Dụng TETE",49000,49000,0,0
TIKI,bach-hoa-online,90059778,"Combo Detox thải độc - Bột rau củ hữu cơ sấy lạnh Dalahouse - Hộp 21 gói 7 loại rau củ, mỗi gói 3gr [Mẫu mới] - Hỗ trợ giảm cân, Thải độc, thanh lọc cơ thể",166500,166500,0,0
TIKI,bach-hoa-online,107078512,"Sữa tươi UHT Đà Lạt True Milk ít đường 110ml (Thùng 48 hộp)",254000,274400,20400,7
TIKI,bach-hoa-online,51571008,"Trà kỷ tử - Câu kỷ tử - Loại cao cấp (500gr)",129000,129000,0,0
TIKI,bach-hoa-online,145093462,"Cà Phê Trắng Truyền Thống 3 Trong 1 Aik Cheong Malaysia - White Coffee (15 Gói x 40g)",120000,145000,25000,17
TIKI,bach-hoa-online,2454325,"Thùng 48 Hộp Sữa Uống Dutch Lady Cô Gái Hà Lan Vị Dâu Cao Khỏe (48X170ml)",339000,450000,111000,25
TIKI,bach-hoa-online,5183193,"Nước tương ăn dặm giảm muối Nhật Bản 150ml ChiBi (Yamagen) cho bé từ 9 tháng tuổi",99000,99000,0,0
TIKI,bach-hoa-online,100275064,"Sữa tươi UHT Đà Lạt True Milk không đường 180ml (Thùng 48 hộp)",381000,426500,45500,11
TIKI,bach-hoa-online,104192734,"KHÔ GÀ LÁ CHANH TÂN LỘC PHÁT - BỊCH 40G",10800,12000,1200,10
TIKI,bach-hoa-online,116766566,"Bánh Goute Hạt dinh dưỡng hộp 8 gói (316.8g)",61000,62000,1000,2
TIKI,bach-hoa-online,83781963,"Combo 2 Hộp Bánh Dinh Dưỡng AFC Lúa Mì 2x172g",52900,71000,18100,25
TIKI,bach-hoa-online,20469816,"SÔCÔLA ĐEN 100% ALLUVIA NGUYÊN CHẤT KHÔNG ĐƯỜNG | EXTREME DARK CHOCOLATE 100% NO SUGAR",75000,75000,0,0
TIKI,bach-hoa-online,138489137,"Bột Diếp Cá Dalahouse Hộp 60g (mẫu mới) - 20 tuýp 3g tiện dụng - Hỗ trợ trĩ - Kháng viêm - Tiêu hóa tốt",120000,120000,0,0
TIKI,bach-hoa-online,58448473,"Trung Nguyên Legend - Cà phê rang xay Sáng tạo 4 - Bịch 340gr",130000,147642,17642,12
TIKI,bach-hoa-online,22198234,"Hạt Macca Úc Smile Nuts nứt vỏ thượng hạng hộp 454g - Australian Maccadiamia 454g",169000,240000,71000,30
TIKI,bach-hoa-online,74790102,"Dầu Cooking Nakydaco 5L",195000,230000,35000,15
TIKI,bach-hoa-online,73090604,"Rượu vang trắng Jacob's Creek Classic Chardonnay 750ml 11.9% - 13.9% - Không hộp",280000,341000,61000,18
TIKI,bach-hoa-online,58393302,"Trung Nguyên Legend - Cà phê hoà tan rang xay Cappuccino Mocha - Hộp 12 gói x 18gr ( có sữa)",72000,85874,13874,16
TIKI,bach-hoa-online,22829330,"Khô Gà Bơ Tỏi Thơm Mùi Tỏi TETE 500gram",75000,75000,0,0
TIKI,bach-hoa-online,56407789,"Combo 1 Cà Phê Hòa Tan Espresso KING COFFEE - Hộp 100 gói x 2.5g + Tặng 1 Cà Phê Sữa PLUS Hòa Tan 3in1 KING COFFEE - Hộp 10 gói x 20g",299400,403200,103800,26
TIKI,bach-hoa-online,2245153,"Bắp Rang Uncle Jax Vị Bơ Caramel Kiểu Chicago (80g)",21000,21000,0,0
TIKI,bach-hoa-online,131493503,"ANF-6FREE THỨC ĂN HẠT HỮU CƠ CHO MÈO LỚN",80000,80000,0,0
TIKI,bach-hoa-online,658751,"Đồ Ăn Cho Chó Con Vị Gà Và Trứng Pedigree (8kg)",448000,520000,72000,14
TIKI,bach-hoa-online,116741477,"Lốc 6 Hũ Mắm Kho Quẹt 120g/hũ",142200,142200,0,0
TIKI,bach-hoa-online,25165565,"Hạt lanh nâu DK HARVEST (nhập khẩu Canada) - 500g",82000,89000,7000,8
TIKI,bach-hoa-online,601765,"Bột Trà Xanh Matcha Hiệu Gold Cocoa Indochine (Hộp 10 Gói x 10g)",119000,199000,80000,40
TIKI,bach-hoa-online,140229111,"1 Hủ Muối chấm hảo hảo 120gram",19000,19000,0,0
TIKI,bach-hoa-online,110210574,"Nui Màu Tự Nhiên Fuma Macaroni 500g - Kèm Gói Nguyệt Quế HavaFoodies",45000,45000,0,0
TIKI,bach-hoa-online,35382934,"Combo 10 miếng lót chuồng, vệ sinh cho chó",24960,24960,0,0
TIKI,bach-hoa-online,10409796,"Thùng 24 Lon Cà Phê Sữa Highlands Coffee (235ml/Lon)",308000,360000,52000,14
TIKI,bach-hoa-online,127076265," Patê Cột Đèn Hải Phòng 150g - Đồ Hộp Hạ Long",27500,27500,0,0
TIKI,bach-hoa-online,52855014,"Combo 2 lon Sữa bột Bonecare xương và khớp 400g: dành cho người lớn bổ sung GLUCOSAMINE tạo dịch nhờn cho khớp, giúp phòng ngừa đau xương khớp, viêm khớp, đặc biệt là người bệnh xương và khớp.",248000,489000,241000,49
TIKI,bach-hoa-online,138956444,"[Combo 10 lọ] Nước Yến sào Khánh Hòa Sanest đóng lọ 70ml",352800,360000,7200,2
TIKI,bach-hoa-online,97551977,"Thùng 12 chai Nước Khoáng Kiềm Thiên Nhiên Vikoda 1.5L",156000,156000,0,0
TIKI,bach-hoa-online,8157213,"Bánh Custas Hộp 12 Cái (282g)",49000,73000,24000,33
TIKI,bach-hoa-online,107881916,"Trà gạo lứt xạ đen đậu đen (1kg) - hỗ trợ giảm cân - lợi sữa - ngủ ngon ( MS)",94500,95000,500,1
TIKI,bach-hoa-online,41067741,"Nho Khô Mix Không Hạt Smile Nuts Túi 250g - Nhập khẩu từ Chile, nho khô hỗn hợp gồm nho đen, nho đỏ và nho vàng (loại không hạt, trái to)",59000,82000,23000,28
TIKI,bach-hoa-online,136656459,"Trà tim sen túi lọc cao cấp, hộp quấn dây kraft",79000,79000,0,0
TIKI,bach-hoa-online,7316589,"Sữa bột Wincofood Bonecare dưỡng chất cho xương và khớp 400g dành cho người lớn phòng ngừa đau xương khớp, viêm khớp, đặc biệt là người bệnh xương và khớp.",137000,250000,113000,45
TIKI,bach-hoa-online,72508423,"Combo 2 gói NATURAL Gia Vị Nấu Bún Bò Huế Dh Foods",31400,31400,0,0
TIKI,bach-hoa-online,102123726,"KHÔ CÁ THIỀU TÂN LỘC PHÁT HŨ 200G",39000,49000,10000,20
TIKI,bach-hoa-online,16680747,"Yến sào cao cấp win'sNest tổ yến chưng sẵn đường phèn 20% (6 lọ/hộp) phù hợp cho mọi đối tượng và trẻ từ 1 tuổi trở lên giúp bồi bổ sức khỏe. ",196350,385000,188650,49
TIKI,bach-hoa-online,209334917,"Combo 3 hộp thanh hạt dinh dưỡng PLAY Natural & Healthy - Bánh hạt dinh dưỡng, bánh ăn kiêng giảm cân",260000,297000,37000,12
TIKI,bach-hoa-online,66993225,"Rượu Whisky Chivas Regal 12 (700ml) 39.7% - 40.3% - Kèm Hộp",709000,709000,0,0
TIKI,bach-hoa-online,7740597,"Chà Là khô nguyên cành Deglet Nour Tunisia hộp 500g",138000,210000,72000,34
TIKI,bach-hoa-online,109488207,"Đặc Sản Phan Thiết - Nước Mắm Tôm Biển Làng Chài Xưa Hồng Ngọc Đại Dương 125Ml/Chai",9000,29000,20000,69
TIKI,bach-hoa-online,57805039,"Combo 2 gói Natural Gia Vị Nấu Phở Bò Sài Gòn Dh Foods",33700,33700,0,0
TIKI,bach-hoa-online,181000510,"Đặc Sản Sóc Trăng - Bánh Pía Sóc Trăng Đậu Xanh Sầu Riêng Trứng Tân Huê Viên 600G, Bánh Pía Tân Huê Viên 5 Sao 1 Trứng",114660,117000,2340,2
TIKI,bach-hoa-online,99324784,"1KG CƠM GẠO LỨT SẤY RONG BIỂN GIÒN THƠM HIỆU SK FOOD",99000,99000,0,0
TIKI,bach-hoa-online,1987981,"Nước mắm truyền thống Lê Gia - Cốt đặc biệt 525ml",92000,95000,3000,3
TIKI,bach-hoa-online,161497171,"Thùng 48 hộp sữa chua uống tiệt trùng TOPKID hương dâu tự nhiên TH True Yogurt 110ml (110ml x 48)",234000,248417,14417,6
TIKI,bach-hoa-online,135321742,"Bột Matcha Trà Xanh Dalat Farm - Túi 110Gr",145000,150000,5000,3
TIKI,bach-hoa-online,92710891,"Bộ 12 túi thức ăn cho mèo Whiskas vị cá ngừ 80g",141000,150000,9000,6
TIKI,bach-hoa-online,190701491,"Cà Phê Cold Brew Arabica Cầu Đất DalatFarm - Túi 125 g",125000,130000,5000,4
TIKI,bach-hoa-online,161498328,"Thùng 48 hộp sữa chua uống tiệt trùng TOPKID hương dâu-chuối-lúa mạch tự nhiên TH True Yogurt 110ml (110ml x 48)",248417,248417,0,0
TIKI,bach-hoa-online,70567304," Gạo Lứt Đỏ Vinh Hiển - Gạo Lứt Đỏ Đóng Túi 1Kg Đạt Chuẩn Chất Lượng HACCP - Ngọt Cơm, Dinh Dưỡng ",42000,42000,0,0
TIKI,bach-hoa-online,95735106,"Trà Xanh Hương Dứa DalatFarm - Túi 150Gr",57000,60000,3000,5
TIKI,bach-hoa-online,116699818,"Thùng 24 chai Nước Khoáng Thiên Nhiên Có Ga Đảnh Thạnh 430ml",196800,196800,0,0
TIKI,bach-hoa-online,154698865,"Trà atisô túi lọc, 100 tép, bịch, mẫu truyền thống, Thái Bảo",107100,119000,11900,10
TIKI,bach-hoa-online,138101958,"Combo 2 Sản Phẩm Gạo  ST25 Túi 5Kg - Gạo Ông Cua, Đặc Sản Sóc Trăng",385000,385000,0,0
TIKI,bach-hoa-online,14934644,"Gạo Nhật hữu cơ cao cấp/ECOBA Sakura 1kg - Nấu cháo cho bé ăn dặm - Hạt tròn, cơm mềm dẻo ngọt - 100% Organic",112000,112000,0,0
TIKI,bach-hoa-online,146373242,"2 Hộp (1kg) Ngũ Cốc Granola Min Min _ Ngũ Cốc Hạt Ăn Liền Granloa Min Min (1hộp 500gr)",370000,370000,0,0
TIKI,bach-hoa-online,16685808,"Yến Sào cao cấp win'snest Tổ Yến Chưng Sẵn Không Đường 20% (6 Lọ/Hộp) thích hợp cho mọi đối tượng đặc biệt là người ăn kiêng và tiểu đường. ",177000,385000,208000,54
TIKI,bach-hoa-online,26039862,"Khô Heo Mix Tỏi Thơm Ngon Cay Cay TeTe Food 500 gram",92000,92000,0,0
TIKI,bach-hoa-online,73088749,"Rượu Whisky Chivas Regal 12 375ml 39% - 41% - không kèm hộp",383000,385000,2000,1
TIKI,bach-hoa-online,54807081,"Đặc Sản Đồng Tháp - Trà Tâm Sen Dk Harvest Giúp An Thần, Giảm Mất Ngủ 200G",135000,139000,4000,3
TIKI,bach-hoa-online,58409812,"Trung Nguyên Legend - Cà phê rang xay Chế phin 1 - Bịch 500gr",138000,153513,15513,10
TIKI,bach-hoa-online,126218819,"Cà phê Hoà tan 3 in 1 Goodmorning (bịch 24 gói x 20gr) Cafe sữa uống liền Trần Quang Coffee",55000,55000,0,0
TIKI,bach-hoa-online,166092597,"Bánh Dinh Dưỡng AFC Vị Caramel Flan Mỏng Giòn",41000,52000,11000,21
TIKI,bach-hoa-online,140579049,"Mì Hảo Hảo Hương vị Tôm Chua Cay (Thùng 30 gói)",141000,141000,0,0
TIKI,bach-hoa-online,45806849,"Bột cần tây nguyên chất Goce - 72g (24 gói x 3g)",114000,190000,76000,40
TIKI,bach-hoa-online,8157211,"Bánh Chocopie Hộp 12 Cái Vị CaCao",57000,66000,9000,14
TIKI,bach-hoa-online,90744761,"Combo 2 Túi Sữa Bột Nguyên Kem Hai Con Bò Đỏ (500g/túi)",92000,95000,3000,3
TIKI,bach-hoa-online,31917897,"Sữa Bột Abbott Ensure Gold HMB Hương Vani (850g)",900000,900000,0,0
TIKI,bach-hoa-online,195194378,"[Thêm Macca + Óc Chó] Granola Nướng Chậm 2 Lần DK Harvest - Ngũ Cốc Giảm Cân, Eat clean, Tạp gym - Trọng lượng 250g/500g",85000,94000,9000,10
TIKI,bach-hoa-online,72505895,"Muối Chấm Hoa Quả 110g Dh Foods",22700,22700,0,0
TIKI,bach-hoa-online,45812684,"Bột tía tô nguyên chất Goce - 72g (24 gói x 3g)",102000,170000,68000,40
TIKI,bach-hoa-online,105736344,"Gạo  ST25 Lúa Tôm Túi 5Kg - Cơm mềm dẻo, vị ngọt, thơm ",205000,205000,0,0
TIKI,bach-hoa-online,437763,"[Mua 1 Tặng 1 - Ngũ Cốc Ăn Sáng Vị Ngẫu Nhiên] Ngũ cốc ăn sáng KOKO KRUNCH DUO (Hộp 300g)",87900,93000,5100,5
TIKI,bach-hoa-online,181000365,"Đặc Sản Sóc Trăng - Bánh Pía Kim Sa Siêu Trứng Đậu Xanh Trứng Muối Đặc Biệt 300Gr, BáNh PíA TâN Huê ViêN Sóc Trăng",69580,71000,1420,2
TIKI,bach-hoa-online,165854443,"Hạt Dinh Dưỡng Tổng Hợp Mix 6 Loại Macca, Hạnh Nhân, Hạt Điều, Nhân Hạt Óc Chó, Hạt Bí, Nho Úc Pams",89000,168000,79000,47
TIKI,bach-hoa-online,109421347,"Trà Đen Hoa Trân Số 9",66764,66764,0,0
TIKI,bach-hoa-online,171057893,"Bánh Gạo Lứt Ăn Kiêng Giảm Cân DK Harvest (170g/18 bánh) - 3 Vị (Lứt Huyết Rồng, Yến Mạch, Lứt Tím Than)",42000,49000,7000,14
TIKI,bach-hoa-online,58405972,"Trung Nguyên Legend - Cà phê rang xay Sáng tạo 8 - Hộp 250gr",266000,315388,49388,16
TIKI,bach-hoa-online,134971253,"1kg Chà Bông Heo Thượng Hạng Dinh Dưỡng Cho Bữa Ăn Ngon Hiệu SK FOOD",250000,250000,0,0
TIKI,bach-hoa-online,37539445,"BỘT GẠO LỨT BROWN RICE (Túi 800GR)",110000,110000,0,0
TIKI,bach-hoa-online,3114745,"Thùng 24 Lon Cao Strongbow Vị Dâu Đỏ (330ml / Lon)",421000,499000,78000,16
TIKI,bach-hoa-online,37544685,"Nhân Hạt Óc Chó Đỏ DK Harvest",135000,155000,20000,13
TIKI,bach-hoa-online,706046,"Đồ Ăn Cho Mèo Trưởng Thành Me-O Vị Cá Ngừ (7kg)",435000,436999,1999,0
TIKI,bach-hoa-online,32499359,"Mật ong nguyên chất hoa rừng Tây Bắc Phúc Khang (720g) - Hàng Chính Hãng - Mật ong sạch đạt chuẩn xuất khẩu, không kháng sinh, không thuốc BVTV",90000,90000,0,0
TIKI,bach-hoa-online,158215242,"Kẹo Ngậm Đau Họng Ricola Shweizer Krauterzucker Chứa Hỗn Hợp 13 Loại Thảo Mộc Đem Đến Cảm Giác Dịu Nhẹ Và Thơm Mát Cho Vòm Miệng Và Cổ Họng - Massel Official",108000,216000,108000,50
TIKI,bach-hoa-online,138956349,"[Combo 10 lọ] Nước Yến sào Khánh Hòa Sanest Kids đóng lọ 62ml - 0161",350000,350000,0,0
TIKI,bach-hoa-online,100352556,"Trung Nguyên Legend - Cà phê rang xay Premium Blend - Lon 425gr",226000,251975,25975,10
TIKI,bach-hoa-online,114467215,"Thùng Fristi Hương Nho 48x80ml",195000,195000,0,0
TIKI,bach-hoa-online,272848313,"Hạt nêm rau củ Massel Úc 100% từ rau củ thảo mộc bảo vệ sức khỏe, dành cho ăn chay, ăn mặn, ăn kiêng và cho bé ăn dặm - QuaTangMe Extaste",93000,186000,93000,50
TIKI,bach-hoa-online,7850312,"Mật ong chanh Hàn Quốc 1kg",126000,129000,3000,2
TIKI,bach-hoa-online,68279855,"Sữa hạt thuần chay Orgagrain - Bổ sung đạm protein cho người ăn Chay - Sữa hạt 36 loại hạt và ngũ cốc tốt cho tim mạch và não bộ - Lon 900g ",850000,850000,0,0
TIKI,bach-hoa-online,2688453,"Bột cacao nguyên chất 100% Việt Nam - Dòng Origin thượng hạng túi giấy 500g - Heyday Cacao",198000,198000,0,0
TIKI,bach-hoa-online,22629360,"Hạt Quinoa (Diêm mạch) Trắng Smile Nuts hộp giấy 500g - White Quinoa Seed Smile Nuts 500g",95000,129000,34000,26
TIKI,bach-hoa-online,71952392,"(1KG) Hạt Điều Rang Muối Sạch Vỏ Chất Lượng Hiệu SK FOOD",185000,185000,0,0
TIKI,bach-hoa-online,48920694,"Nước mắm cá cơm Lê Gia- can 2l",89000,108000,19000,18
TIKI,bach-hoa-online,183335076,"Đặc Sản Sóc Trăng - Bánh In Đậu Xanh Sầu Riêng Tân Huê Viên Túi 10 Bánh 400G, Đặc Sản Bánh In Sóc Trăng Nhân Đậu Xanh, Sầu Riêng",66600,74000,7400,10
TIKI,bach-hoa-online,1065000,"Cà Phê Sữa G7 3in1 Trung Nguyên (100 Gói) - (Giao Ngẫu Nhiên)",330000,330000,0,0
TIKI,bach-hoa-online,68427800,"Nhân Hạt Điều Sống Nguyên Hạt Dùng Làm Sữa Hạt DK Harvest - Túi 500g, 1000g",159000,159000,0,0
TIKI,bach-hoa-online,45123568,"Hạt Diêm Mạch DK Harvest - Quinoa 300g, 500g",72000,79000,7000,9
TIKI,bach-hoa-online,114467211,"Thùng Fristi Hương Táo 48x80ml",192000,195000,3000,2
TIKI,bach-hoa-online,128112213,"Combo 02 thùng Bia Sapporo Premium - 24 lon 330ml ",730400,830000,99600,12
TIKI,bach-hoa-online,105551898,"Rong biển ăn liền vị Oliu (lốc 3 gói)",42000,45000,3000,7
TIKI,bach-hoa-online,105954006,"Combo 5 Hộp Bánh Quế OREO Vị Vani 5x54g",60000,80000,20000,25
TIKI,bach-hoa-online,106236891,"Hạt chia ăn kiêng GUfoods - Dồi dào chất xơ, Bổ sung Omega-3 hàng ngày, Eat clean, Keto, Thực dưỡng, Thuần chay",74000,149000,75000,50
TIKI,bach-hoa-online,140229054,"Mỳ Ly Modern ( Lẩu thái Tôm ) 65gr x 24 ly",202000,202000,0,0
TIKI,bach-hoa-online,107018202,"Bánh bông lan dinh dưỡng Quasure light dâu 126 gram Bibica - thực phẩm dành cho người ăn kiêng, tiểu đường",30711,35300,4589,13
TIKI,bach-hoa-online,50315554,"Chà Bông Heo Nguyên Chất DTfood 500g - Thơm ngon bổ dưỡng",160720,164000,3280,2
TIKI,bach-hoa-online,11306505,"Giấm táo hữu cơ Bragg",209000,209000,0,0
TIKI,bach-hoa-online,84795551,"Nhân Óc Chó Mỹ Sấy Không Muối LAFOOCO 300g Unsalted walnuts",107100,153000,45900,30
TIKI,bach-hoa-online,55065594,"1Kg Cơm Cháy Lắc Khô Gà Giòn Ngon Chất Lượng",119000,119000,0,0
TIKI,bach-hoa-online,102093898,"THÙNG 30 GÓI - MÌ MAMA HƯƠNG THỊT HEO BẰM 60G",240000,240000,0,0
TIKI,bach-hoa-online,43815521,"Chà Là Không Cành Tunisia Smile Nuts Hộp 500g - Dòng chà là Deglet Nour thịt mềm, dẻo, thoảng vị mật ong",129000,185000,56000,30
TIKI,bach-hoa-online,184861027,"Yến mạch tươi cán mỏng (cán dẹt) GUfoods - Ăn kiêng, Giàu chất xơ, Hỗ trợ giảm cân, Tập gym, Eat clean",26000,55000,29000,53
TIKI,bach-hoa-online,107018074,"Bánh Quy Quasure Light Sữa hộp 140 gram Bibica - thực phẩm dành cho người ăn kiêng, tiểu đường",30500,36300,5800,16
TIKI,bach-hoa-online,6956581,"Ngũ cốc hoa quả Calbee Furugura Nhật Bản gói 800g",136000,136000,0,0
TIKI,bach-hoa-online,2906923,"Gạo lứt nâu hữu cơ cao cấp/ECOBA Kim Mễ 1kg - Gạo lứt giảm cân - Cơm ngon mềm dẻo",102000,102000,0,0
TIKI,bach-hoa-online,73621685,"Trà Oolong (Ô long) Kim Tuyên Cầu Đất Dalat Farm - Túi 100Gr",82000,85000,3000,4
TIKI,bach-hoa-online,52795555,"Túi Gạo Meizan Nàng Thơm 5kg",114000,115320,1320,1
TIKI,bach-hoa-online,68607796,"Đậu đen xanh lòng rang sẵn - 1kg - (MS ) - Đậu đen xanh lòng hữu cơ - hạt nhỏ thuần chủng",119900,120000,100,0
TIKI,bach-hoa-online,55097144,"1Kg Khô Gà Lá Chanh Loại Ngon Thương Hiệu SK FOOD",145000,145000,0,0
TIKI,bach-hoa-online,106318911,"Bột sắn dây nguyên chất 500g TÂM MINH FOODS làm mát thanh lọc cơ thể",135000,135000,0,0
TIKI,bach-hoa-online,2596253,"Sốt Ướp Thịt BBQ 200gr Dh Foods",28100,28100,0,0
TIKI,bach-hoa-online,4424835,"Dầu Ăn Hoa Cải Ajinomoto Bổ Sung Omega 3 & 6 (1000G)",86500,86500,0,0
TIKI,bach-hoa-online,76366855,"1KG LẠP XƯỞNG TÔM ÍT MỠ THƠM NGON HIỆU TÂN LỘC PHÁT",117000,125000,8000,6
TIKI,bach-hoa-online,10409781,"Cà Phê Rang Xay Moka Highlands Coffee (200g)",90000,120000,30000,25
TIKI,bach-hoa-online,202797473,"Bánh Gấu Nhân Kem DTfood 1kg",65000,65000,0,0
TIKI,bach-hoa-online,59478426,"Bột pha trà sữa cao cấp Déli - 1kg - thơm, béo tự nhiên - chuyên dùng pha chế trà sữa",99000,104000,5000,5
TIKI,bach-hoa-online,58407240,"Trung Nguyên Legend - Cà phê rang xay Sáng tạo 3 - Bịch 340gr",114000,130192,16192,12
TIKI,bach-hoa-online,195711140,"Kỷ Tử Khô (Câu Kỷ Tử) Smilenuts túi 145g/225g _ Kỷ tử khô CAO CẤP quà tết 2023 _ Quý Mão thượng hạng , ngon ngọt quả lớn, đặc biệt có thể ăn trực tiếp, chứa nhiều chất chống oxy hóa, đẹp da, giàu Sắt và Vitamin C",110000,110000,0,0
TIKI,bach-hoa-online,36277572,"Giấm táo hữu cơ Organic Bragg (473ml)",209000,209000,0,0
TIKI,bach-hoa-online,138956271,"[Thùng 30 lon] Nước Yến sào Sanest Khánh Hòa đóng lon 190ml - Không đường 003",256000,264000,8000,3
TIKI,bach-hoa-online,10409797,"Thùng 24 Lon Cà Phê Sữa Highlands Coffee (185ml/Lon)",259000,312000,53000,17
TIKI,bach-hoa-online,1064974,"Cà Phê Chế Phin 1 Trung Nguyên (500g)",130000,130000,0,0
TIKI,bach-hoa-online,29253101,"Mirin ướp vị ngọt tự nhiên Hinode 400ml .",59000,59000,0,0
TIKI,bach-hoa-online,59256224,"Combo 5 gói thức ăn cho chó trưởng thành Ganador vị gà nướng Adult Roasted Chicken Flavor 400gr",84419,84419,0,0
TIKI,bach-hoa-online,49464252,"Đường Ăn Kiêng Tropicana Slim Stevia 125gr - Chiết Xuất Từ Lá Cỏ Ngọt Stevia 125g (50 x 2.5g)",82000,82000,0,0
TIKI,bach-hoa-online,121229323,"Gạo Thơm ST25 Túi 5Kg A An - Cơm mềm dẻo, thơm nhẹ, vị ngọt",159000,159000,0,0
TIKI,bach-hoa-online,68267196,"Ngũ cốc dinh dưỡng cao cấp  - MS - (1kg/2 gói) - Bột ngũ cốc tăng cân, lợi sữa - 18 loại đậu & hạt",245000,245000,0,0
TIKI,bach-hoa-online,56417254,"Muối Hồng Himalaya DK Harvest",89000,119000,30000,25
TIKI,bach-hoa-online,107018178,"Bánh bông lan Quasure light cốm 126 gram Bibica - thực phẩm dành cho người ăn kiêng, tiểu đường",33000,39300,6300,16
TIKI,bach-hoa-online,57695989,"Cà phê bột truyền thống số 1 (500gr) Coffee Tree 100% nguyên chất gu đậm hương nhẹ",127800,213000,85200,40
TIKI,bach-hoa-online,137755749,"Thức ăn cho mèo con và mèo trưởng thành Royal Canin Pháp Hộp 1kg",199000,199000,0,0
TIKI,bach-hoa-online,59197171,"Sữa Tiệt Trùng Có Đường VPMilk Grow+ Hộp 110ml (Thùng 48 Hộp)",233000,269400,36400,14
TIKI,bach-hoa-online,105910660,"Combo 2 Bánh Lát Khoai Tây SLIDE Vị Thịt Nướng 2x150g",77000,107000,30000,28
TIKI,bach-hoa-online,176292294,"Canh cải xoong nấu thịt ăn liền I-Soup 42g (túi 06 viên cho 06 khẩu phần ăn)-Công nghệ Nhật Bản",68000,68000,0,0
TIKI,bach-hoa-online,1064994,"Cà Phê Sữa G7 3in1 Trung Nguyên (Hộp 21 Gói) - (Giao Ngẫu Nhiên)",75000,75000,0,0
TIKI,bach-hoa-online,180365601,"Bánh Trung Thu Thập Cẩm Tân Dân Lợi - 200g/2 trứng muối - Date mới - Bao đổi trả",50000,50000,0,0
TIKI,bach-hoa-online,57304713,"Cà phê bột 100% nguyên chất truyền thống số 3 Coffee Tree 500gr thơm ngon, đậm đà, gu mạnh (Cà phê) ",111000,149000,38000,26
TIKI,bach-hoa-online,58209006,"Trà kỷ tử - Câu kỷ tử - Loại hạt to đều khô - Gói 200g",85000,85000,0,0
TIKI,bach-hoa-online,176630892,"Granola siêu Hạt &amp; Quả NOFA 600gr, Ngũ cốc giảm cân thêm Macca, Óc chó đỏ",41000,41000,0,0
TIKI,bach-hoa-online,89072249,"Hạt Điều Vỡ Đôi DK Harvest - Hạt Điều Sống Vỡ Đôi",71000,79000,8000,10
TIKI,bach-hoa-online,56345533,"CƠM GẠO LỨT RONG BIỂN TÂN LỘC PHÁT COMBO 2 HŨ - MỖI HŨ 500G",62000,79000,17000,22
TIKI,bach-hoa-online,62652057,"Hồng trà (trà đen) Déli - 500gr - chuyên dùng pha chế trà sữa, trà trái cây.",94000,94000,0,0
TIKI,bach-hoa-online,103786341,"Chè dưỡng nhan 12 vị - Chống  lảo hóa, giúp thanh nhiệt mùa hè - Gói 400gr",67000,67000,0,0
TIKI,bach-hoa-online,59256820,"Thức ăn cho chó trưởng thành Ganador vị gà nướng Adult Roasted Chicken Flavor 3kg",120896,120896,0,0
TIKI,bach-hoa-online,42116117,"COMBO SIÊU TIẾT KIỆM - 1 Hũ Hạt Hạnh Nhân DK Harvest 250g + 1 Hũ Hạt Óc Chó DK Harvest 200g",165000,249000,84000,34
TIKI,bach-hoa-online,646084,"Thức Ăn Mèo Vị Cá Biển Whiskas (3Kg) ",276000,350000,74000,21
TIKI,bach-hoa-online,116765900,"Thùng Sữa đậu nành Fami Canxi vị Phô Mai ( 200ml x 36 Hộp )",160000,207319,47319,23
TIKI,bach-hoa-online,127590999,"Combo 2 Hộp Bánh Solite Tầng Dinh Dưỡng Với Vị Cam Tươi Mới 2x238g",73000,87000,14000,16
TIKI,bach-hoa-online,3747383,"Đặc Sản Bình Thuận  - Nước Mắm Tĩn Cá Cơm Than Nhãn Đỏ 40N Chai Thủy Tinh (500Ml/Chai) Sánh Đặc Thịt Cá, Không Chất Bảo Quản - Ocop 4 Sao",165000,190000,25000,13
TIKI,bach-hoa-online,483311,"Dầu Hướng Dương Simply (1L / Chai)",67600,70099,2499,4
TIKI,bach-hoa-online,686706,"Bột Trà Xanh Yanoen Matcha Uji 30g",69000,69000,0,0
TIKI,bach-hoa-online,486865,"Đồ Ăn Cho Mèo Con Me-O Hương Vị Cá Biển (1.1Kg)",105999,108888,2889,3
TIKI,bach-hoa-online,68354084,"Cà phê G7 hòa tan Đen Bịch 100 gói( Không Đường Sữa) Trung Nguyên",230000,230000,0,0
TIKI,bach-hoa-online,73291856,"Combo 4 gói Bột ngọt AJI-NO-MOTO 454g",142000,142000,0,0
TIKI,bach-hoa-online,48276314,"Đặc Sản Bình Thuận  - Cặp 2 Chai Nước Mắm Tĩn Cá Cơm Than Nhãn Đỏ 40N (500Ml/Chai) - Ocop 4 Sao",330000,350000,20000,6
TIKI,bach-hoa-online,112047777,"Combo 5 gói Thức ăn cho chó trưởng thành Fib's 400g ",76999,76999,0,0
TIKI,bach-hoa-online,1064964,"Cà Phê Sáng Tạo 4 Trung Nguyên (340g)",140000,140000,0,0
TIKI,bach-hoa-online,1907359,"Trà Ôlong Tâm Châu Bao Nhôm 250gr",162500,162500,0,0
TIKI,bach-hoa-online,76694342,"Hà Thủ Ô Mật Ong Rừng Phúc Khang 300g (7 trong 1) - Làm đen tóc, giảm rụng tóc, kích thích mọc tóc; giúp ăn ngon, ngủ ngon, hũ thủy tinh cao cấp, dạng viên tiện lợi, vị ngọt dễ uống",171059,180000,8941,5
TIKI,bach-hoa-online,1064988,"Trung Nguyên Legend - Cà phê hòa tan G7 2in1 - Hộp 15 gói x 16gr",69000,79031,10031,13
TIKI,bach-hoa-online,58571664,"Nho Khô Mix Không Hạt Smile Nuts Túi 500g - Nhập khẩu từ Chile (nho khô hỗn hợp gồm nho đen, nho đỏ và nho vàng)",105000,133000,28000,21
TIKI,bach-hoa-online,99078139,"Lốc 8 Gói Mì Bò Hầm Ottogi 120g",72192,76800,4608,6
TIKI,bach-hoa-online,107018264,"Bột ngũ cốc Quasure light túi 400 gram Bibica - thực phẩm dành cho người ăn kiêng, người tiểu đường",74292,90600,16308,18
TIKI,bach-hoa-online,127220058,"Đặc Sản Phan Thiết - Mắm Nêm Pha Sẵn Cao Cấp Làng Chài Xưa, Nguyên Liệu Tươi, Thơm Ngon Đặc Biệt, Chai Thủy Tinh 300G",65000,90000,25000,28
TIKI,bach-hoa-online,170616316,"Thanh ngũ cốc gạo lứt Rong Biển / Thanh cốm năng lượng 180G /Hạt dinh dưỡng ( 7 Thanh ) Vườn Xanh Sạch",54000,60000,6000,10
TIKI,bach-hoa-online,109392347,"Đặc Sản Phan Thiết - Nước Mắm Tôm Biển Làng Chài Xưa 525Ml/Chai Hồng Ngọc Đại Dương 300 Năm Truyền Thống",45000,90000,45000,50
TIKI,bach-hoa-online,142671560,"Ngũ Cốc Dinh Dưỡng Min Min 29 Hạt Vị Truyền Thống _ Ngũ Cốc Bầu (1 hộp 500gr)",240000,240000,0,0
TIKI,bach-hoa-online,181000398,"Đặc Sản Sóc Trăng - Bánh Pía Đậu Xanh Sầu Riêng Trứng Muối Tân Huê Viên 320G, Bánh Pía Sóc Trăng Chính Hãng",78000,78000,0,0
TIKI,bach-hoa-online,437758,"Bánh Ăn Sáng Nestle Cflakes (275g)",65100,82000,16900,21
TIKI,bach-hoa-online,181000425,"Đặc Sản Sóc Trăng - Bánh Pía 2 Trứng Đậu Xanh Sầu Riêng Tân Huê Viên 580G, Bánh Pía Sóc Trăng Tân Huê Viên 2 Trứng Muối",102600,114000,11400,10
TIKI,bach-hoa-online,54349922,"Nho Khô Raisins 3 Màu Không Hạt DK Harvest (Hàng Nhập Khẩu Chile)  - Thơm ngon, vị ngọt tự nhiên, không pha trộn thêm đường hay chất tạo ngọt",72000,79000,7000,9
TIKI,bach-hoa-online,126937953,"[Combo 2 Hũ] Da heo cháy tỏi ớt giòn tan hiệu SK FOOD - mỗi hũ 100g",99000,99000,0,0
TIKI,bach-hoa-online,126218758,"Cà phê Hòa tan 3in1 Arabica cafe sữa uống liền (bịch 24 gói x 20gr) ca phe Trần Quang Việt Nam Coffee",67000,67000,0,0
TIKI,bach-hoa-online,67336524,"Yến Mạch Oats Canada Nguyên Chất túi 500g ( Nguyên Hạt )",60000,60000,0,0
TIKI,bach-hoa-online,154698844,"Cao atisô L'angfarm, 150g, hộp, mẫu hũ thuỷ tinh",127800,142000,14200,10
TIKI,bach-hoa-online,54512538,"Chè dây (Trà dây) - Gói 1kg",71000,71000,0,0
TIKI,bach-hoa-online,66712870,"KHÔ GÀ BƠ TỎI TÂN LỘC PHÁT COMBO 1KG - MỖI HŨ 500G",102000,104300,2300,2
TIKI,bach-hoa-online,204404539,"Bột Diếp Cá hữu cơ nguyên chất sấy lạnh Dalahouse - Hộp 20 gói nhỏ 3gr định lượng sẵn cho 1 lần sử dụng - Mát Gan, ngừa mụn, ngừa trĩ và táo bón. Hỗ trợ bảo vệ Phổi",109000,109000,0,0
TIKI,bach-hoa-online,49289523,"Thùng 48 hộp Cà phê Sữa Highlands Coffee Tetra pack (180ml /hộp)",422000,480000,58000,12
TIKI,bach-hoa-online,10690088,"Thùng 24 hộp Nước dừa xiêm VICO FRESH (330ml / hộp)",439000,439000,0,0
TIKI,bach-hoa-online,143947372,"Viên nhai Nexgard trị ve rận, bọ chét cho chó (1 viên) - 2-4kg",125000,125000,0,0
TIKI,bach-hoa-online,58410333,"Trung Nguyên Legend - Cà phê rang xay Gourmet Blend - Hộp 500gr",151000,172148,21148,12
TIKI,bach-hoa-online,53181616,"Trà Táo Đỏ Sấy Khô Mộc Sắc 100g",50000,55000,5000,9
TIKI,bach-hoa-online,147371751,"Viên nhai Nexgard trị ve rận, bọ chét cho chó (1 viên) - 25-50kg",285000,285000,0,0
TIKI,bach-hoa-online,138569338,"Bột Rau Má Dalahouse Hộp 60g (Mẫu mới gồm 20 tuýp 3g) Nguyên chất sấy lạnh - Mát gan giải độc",103500,115000,11500,10
TIKI,bach-hoa-online,56942135,"Gạo Nếp Sáp Vinh Hiển túi 1KG (dẻo dính, xôi thơm) Nếp sạch 3 KHÔNG",35000,35000,0,0
TIKI,bach-hoa-online,138956210,"[Combo 20 lọ] Nước Yến sào Sanvinest Khánh Hòa đóng lọ 70ml - Không đường 102",698000,720000,22000,3
TIKI,bach-hoa-online,143947377,"Viên nhai Nexgard trị ve rận, bọ chét cho chó (1 viên) - 10-25kg",179000,179000,0,0
TIKI,bach-hoa-online,174428346,"Bột Tía Tô Sấy Lạnh Nguyên Chất Dalahouse Hỗ Trợ Hạ Sốt, Thải Độc, Làm Sáng Da Giúp Cơ Thể Săn Chắc – Hàng Chính Hãng",108000,108000,0,0
TIKI,bach-hoa-online,117600114,"Tương ớt Mường Khương 500ml, Đặc sản Lào Cai, vị cay truyền thống, sản xuất thủ công, không chất bảo quản, phụ gia, hóa chất",43000,60000,17000,28
TIKI,bach-hoa-online,161409505,"Thùng 12 hộp sữa tươi tiệt trùng nguyên chất TH True Milk 1L (1L x 12)",472794,472794,0,0
TIKI,bach-hoa-online,43604178,"500gr táo đỏ khô cao cấp",67000,67000,0,0
TIKI,bach-hoa-online,57141102,"Coffee Tree truyền thống số 1 đậm đà, gu mạnh - Cà phê hạt nguyên chất 100%",237000,449000,212000,47
TIKI,bach-hoa-online,111422771,"Bơ hạt ăn kiêng GUfoods (bơ đậu phộng / bơ ca cao / bơ hạt điều / bơ hạnh nhân) - Tự nhiên, Lành mạnh, Eat clean",51000,99000,48000,48
TIKI,bach-hoa-online,66954836,"Nước mắm nhỉ Làng Chài Xưa xuất khẩu nhãn xanh thùng 6 chai thủy tinh 500ml cốt nhỉ đặc biệt vị dịu nhẹ gu Việt Kiều giới trẻ thành thị nước mắm nguyên chất sạch nước mắm nhĩ từ thùng lều gỗ 100% cá cơm tươi muối tinh khiết chuẩn xuất khẩu",259000,590000,331000,56
TIKI,bach-hoa-online,143947375,"Viên nhai Nexgard trị ve rận, bọ chét cho chó (1 viên) - 4-10kg",135000,135000,0,0
TIKI,bach-hoa-online,154698804,"Trà hoa cúc túi lọc Thái Bảo, 60 tép, hộp, mẫu pastel art",93600,104000,10400,10
TIKI,bach-hoa-online,69273975,"Combo 3 Cà Phê Sữa Hòa Tan 3IN1 KING COFFEE - Túi 50 gói x 24g",600000,600000,0,0
TIKI,bach-hoa-online,55395769,"Bột nêm ngưu báng 1kg thuần chay không bột ngọt TÂM MINH FOODS",198000,198000,0,0
TIKI,bach-hoa-online,1064998,"Cà Phê Sữa G7 3in1 Trung Nguyên (50 Gói)",165000,165000,0,0
TIKI,bach-hoa-online,6842717,"Thùng 72 lọ Nước Yến Sào win'sNest Kids (70ml/lọ)",1652400,3240000,1587600,49
TIKI,bach-hoa-online,272848393,"Hạt nêm rau củ Massel Úc 100% từ rau củ thảo mộc bảo vệ sức khỏe, dành cho ăn chay, ăn mặn, ăn kiêng và cho bé ăn dặm - QuaTangMe Extaste",93000,186000,93000,50
TIKI,bach-hoa-online,48920324,"Bột cacao nguyên chất 100% Việt Nam - Dòng Balanced phổ thông túi 500g -  Chuyên dùng làm bánh, pha chế cho quán cà phê - Heyday Cacao",159000,159000,0,0
TIKI,bach-hoa-online,7853522,"Combo 02 gói trà tân cương thượng hạng 500 gram",300000,300000,0,0
TIKI,bach-hoa-online,57805547,"Combo 2 gói Natural Gia Vị Nấu Phở Gà Dh Foods",31500,31500,0,0
TIKI,bach-hoa-online,3812951,"Cà Phê Hòa Tan Tchibo Gold T100G (100g)",172050,185000,12950,7
TIKI,bach-hoa-online,51713336,"Trung Nguyên Legend - Cà phê rang xay House Blend - Hộp 500gr",105000,128066,23066,18
TIKI,bach-hoa-online,50819822,"Natural Gừng bột 30g Dh Foods - Bột gừng nguyên chất 100%",17200,17200,0,0
TIKI,bach-hoa-online,20367638,"Trung Nguyên Legend - Cà phê hạt rang Success 2 - Bịch 1kg",468000,551518,83518,15
TIKI,bach-hoa-online,181361223,"Combo 2 Cà Phê Sữa Hòa Tan - Bịch 50 gói - Trung Nguyên Legend Classic (Gu mạnh, vị đắng đậm đà, ngọt bùi)",405400,405400,0,0
TIKI,bach-hoa-online,56889377,"Đặc sản An Giang - Gạo Thơm ST21 A AN Túi 5Kg - Gạo đặc sản Sóc Trăng - Thơm hoa lài nhẹ, cơm ngọt, rất dẻo, hạt cơm kết dính - OCOP 4 Sao",133900,133900,0,0
TIKI,bach-hoa-online,171656999,"Ensure Úc sữa cho người lớn Giúp hồi phục sức khỏe cho người gầy yếu, người suy dinh dưỡng, ốm dậy - QuaTangMe Extaste",1108000,2216000,1108000,50
TIKI,bach-hoa-online,68428418,"Hạt Bí Sống Dùng Làm Sữa DK Harvest nhập khẩu - Túi 500g, 1000g",95000,95000,0,0
TIKI,bach-hoa-online,108839282,"CƠM CHÁY LẮC KHÔ GÀ TÂN LỘC PHÁT COMBO 1KG - MỖI HŨ 500G",77000,89000,12000,13
TIKI,bach-hoa-online,15182824,"Combo 2 hộp Bột ngũ cốc Damtuh Hàn Quốc 50 gói x 18g",459000,459000,0,0
TIKI,bach-hoa-online,6003013,"Sữa bột Wincofood Goldcare Gain: dinh dưỡng thích hợp cho mọi đối tượng và trẻ em từ 1 tuổi trở lên giúp tăng cân hiệu quả",233000,369000,136000,37
TIKI,bach-hoa-online,270552508,"Sữa Milo Úc Nestle giàu dinh dưỡng giúp trẻ phát triển chiều cao và tăng cường sức khỏe - QuaTangMe Extaste",385000,770000,385000,50
TIKI,bach-hoa-online,85405382,"Cà Phê Decaf Cao Cấp Không Mất Ngủ, Cà Phê Tách Cafeine Phù Hợp Cho Người Bị Say Cafe Nguyên Chất - Gói 200 Gram - Bột",115000,179000,64000,36
TIKI,bach-hoa-online,139187018,"Pate Thịt hộp Meowow cho mèo| Giàu DHA và Omega-3 | Nhiều topping",25000,25000,0,0
TIKI,bach-hoa-online,42013191,"Hạt Điều Vỏ Lụa Rang Muối SVIET (1kg / Túi Hút Chân Không)",206000,206000,0,0
TIKI,bach-hoa-online,4529413,"Cát Vệ Sinh Hữu Cơ Vón Cục Cho Mèo Lông Dài Smart Pellets Cat's Best CBSP05L (2.5kg)",164700,200000,35300,18
TIKI,bach-hoa-online,54022437,"Combo 2 túi Hạt Bí Rang Trọng Nhân 500gr",179000,179000,0,0
TIKI,bach-hoa-online,125247963,"Hộp 6 thanh hạt dinh dưỡng Natural & Healthy - Thanh ngũ cốc thuần chay ăn sáng siêu dinh dưỡng",90000,99000,9000,9
TIKI,bach-hoa-online,57282097,"Gạo Lứt Tím Than Túi 1Kg - Gạo Ông Thọ - Thơm mềm dẻo, tốt cho sức khỏe",42000,42000,0,0
TIKI,bach-hoa-online,44805175,"Ngũ Cốc Trái Cây Calbee Ít Đường Nhật Bản 600g",157000,157000,0,0
TIKI,bach-hoa-online,73292060,"Combo 2 gói Bột ngọt AJI-NO-MOTO 1kg",140000,140000,0,0
TIKI,bach-hoa-online,59141672,"Gạo Nếp đặc sản Cái Hoa Vàng Vinh Hiển túi 1KG - Nếp sạch 3 KHÔNG",39000,39000,0,0
TIKI,bach-hoa-online,21842086,"Kem Sữa Đặc Ngôi Sao Phương Nam Vinamilk - Hộp Giấy 1284G Xanh Biển",68000,68000,0,0
TIKI,bach-hoa-online,152814947,"Bánh Tráng Sốt Me - Bánh Tráng Chấm Me ABI SNACK",29000,29000,0,0
TIKI,bach-hoa-online,105543190,"Combo Cafe bột Rang Xay Nguyên Chất Coffee Tree đặt biệt 100% Và Phin Cà Phê Màu Đỏ Cao Cấp thương hiệu Coffee Tree",140000,229000,89000,39
TIKI,bach-hoa-online,272102153,"Sữa dành cho người tiểu đường Glucerna Úc Bổ sung dinh dưỡng, cân bằng đường huyết, tạo sức khỏe tim, tiêu hóa, tăng sức khỏe chung - OZ Slim Store",1130000,2260000,1130000,50
TIKI,bach-hoa-online,219134711,"Xốt Bún Bò Huế HiXOT hũ 220gram, gia vị hoàn chỉnh, không cần nêm nếm",55000,55000,0,0
TIKI,bach-hoa-online,10690795,"Thùng 12 hộp Nước dừa xiêm VICOFRESH (1 lít/hộp)",630000,630000,0,0
TIKI,bach-hoa-online,63903916,"KHÔ GÀ XÉ LÁ CHANH TÂN LỘC PHÁT COMBO 2 HŨ - MỖI HŨ 300G",71100,79000,7900,10
TIKI,bach-hoa-online,77753411,"Trân châu đường đen 300g (10*30g)",35000,35000,0,0
TIKI,bach-hoa-online,47362814,"Trà khổ qua rừng sấy khô nguyên trái 250g - Trà khổ qua rừng hỗ trợ điểu trị tiểu đường - Quà tặng ý nghĩa cho người cao tuổi",90000,90000,0,0
TIKI,bach-hoa-online,3116645,"Gạo Thơm Lài Lotus Rice 2kg - Cơm mềm dẻo vừa - Chuẩn xuất khẩu",60000,60000,0,0
TIKI,bach-hoa-online,13724857,"Thùng Sữa Đậu Nành Famigo Đậu Đỏ Nếp Cẩm (200ml x 36 Hộp)",198000,252811,54811,22
TIKI,bach-hoa-online,8013693,"Thùng 30 Mì Gà Tím VIFON (75g / Gói)",184000,238000,54000,23
TIKI,bach-hoa-online,137469801,"Bột rau má sấy lạnh dalahouse, hỗ trợ thanh nhiệt - mát gan- giảm mụn hiệu quả. Mỗi ngày 1 ly rau má chia tay táo bón",103000,103000,0,0
TIKI,bach-hoa-online,114778894,"Thùng Fristi Hương Đào Tiên Nhật Bản 48x80ml",192000,195000,3000,2
TIKI,bach-hoa-online,484524,"Đồ Ăn Cho Mèo Con Whiskas Vị Cá Biển Và Sữa Dạng Túi 1.1 Kg",115000,140000,25000,18
TIKI,bach-hoa-online,2467249,"Muối tôm ớt kiểu Tây Ninh 120gr Dh Foods",22700,22700,0,0
TIKI,bach-hoa-online,10607653,"Muối Ớt Tây Ninh Mỹ Vân 450 g - TỰ HÀO CSSX ĐẦU TIÊN TẠI TÂY NINH",52000,52000,0,0
TIKI,bach-hoa-online,39221263,"HẠT HẠNH NHÂN NGUYÊN VỊ 500G - ĐÃ RANG",114900,114900,0,0
TIKI,bach-hoa-online,51239296,"Đặc Sản Phan Thiết - 1 Cặp 2 Chai 500Ml Nước Mắm Tôm Biển 45N",400000,700000,300000,43
TIKI,bach-hoa-online,20581831," Cà Phê Trung Nguyên Legend Cà phê sữa đá - (Hộp 9)",86000,86000,0,0
TIKI,bach-hoa-online,59418250,"CƠM GẠO LỨT RONG BIỂN THƯƠNG HIỆU TLP - 2 HŨ 1KG",109000,109000,0,0
TIKI,bach-hoa-online,55547368,"1 KG HẠT MACCA NỨT VỎ HÀNG NHẬP KHẨU CAO CẤP THƯƠNG HIỆU SK FOOD",269000,269000,0,0
TIKI,bach-hoa-online,62208201,"Hạt Dinh Dưỡng Hỗn Hợp 4 Loại Hạt Điều, Hạnh Nhân, Óc Chó, Hạt Dẻ Cười Có Muối LAFOOCO 270g",128700,143000,14300,10
TIKI,bach-hoa-online,77060395,"500Gr Yến mạch tươi nguyên chất Hafer Flocken loại cán dẹt - Nhập Khẩu Từ Đức",31900,31900,0,0
TIKI,bach-hoa-online,272799968,"BÁNH TRÁNG PHÔ MAI HOT SIÊU PHẨM ĂN VẶT ABI SNACK",28000,28000,0,0
TIKI,bach-hoa-online,173153272,"Sốt Me Chua Ngọt 200gr Dh Foods - gia vị chấm  và chế biến hải sản, các món nướng",26900,26900,0,0
TIKI,bach-hoa-online,108014199,"LẠP XƯỞNG HEO TÂN LỘC PHÁT COMBO 1KG - MỖI BỊCH 500G",139000,149000,10000,7
TIKI,bach-hoa-online,8157212,"Bánh Custas Hộp 20 Cái (470g)",98000,114000,16000,14
TIKI,bach-hoa-online,75622108,"[Combo 1Kg] 500G Đậu Phộng Rang Tỏi Ớt + 500G Đậu Phộng Da Cá Sấy ( Đậu Phộng Cốt Dừa) Thương Hiệu SK FOOD",109000,109000,0,0
TIKI,bach-hoa-online,127591003,"Combo 2 khay Solite bánh dinh dưỡng bông lan cuộn, giảm đường, vị lá dứa 2x360g",91000,115000,24000,21
TIKI,bach-hoa-online,118121010,"NGUYÊN LIỆU LÀM BÁNH TRUNG THU - NHÂN KHOAI MÔN 1KG - THÀNH LONG - VIỆT NAM",115500,115500,0,0
TIKI,bach-hoa-online,204820804,"Hạt macca Úc đã tách vỏ (loại 1 nguyên hạt), sấy giòn ăn liền hoặc làm sữa Nunuts ( nhân macca)",200000,200000,0,0
TIKI,bach-hoa-online,155163127,"CHAI XỊT KHỬ MÙI HÔI THÚ CƯNG, KHỬ MÙI HÔI NƯỚC TIỂU CHÓ MÈO, CÁT VỆ SINH CHÓ MÈO, XỊT THƠM MIỆNG THÚ CƯNG-NANO BẠC DIỆT KHUẨN KHỬ MÙI XCLEAN PET 100ML-NANO BẠC AHT CORP (AHTC)-AN TOÀN THÂN THIỆN CHO BOSS",49000,99000,50000,51
TIKI,bach-hoa-online,57812465,"Combo 5 gói Natural Gia vị nấu Bò Kho Dh Foods",29700,29700,0,0
TIKI,bach-hoa-online,49068607,"Gạo Nếp Cẩm - Gạo Ông Thọ Túi 1Kg - Thơm ngọt mềm dẻo, tốt cho sức khỏe",41000,41000,0,0
TIKI,bach-hoa-online,58409447,"Trung Nguyên Legend - Cà phê rang xay Chế phin 2 - Bịch 500gr",139000,176228,37228,21
TIKI,bach-hoa-online,48277254,"Đặc Sản Bình Thuận  - Thùng 6 Chai Nước Mắm Tĩn Nhãn Đỏ Độ Đạm 40N Tự Nhiên Chai 500Ml Nước Mắm Rin Nguyên Chất Truyền Thống Sạch Từ Cá Cơm Than Muối Tinh Khiết Sánh Đặc Thịt Cá Không Chất Bảo Quản - Ocop 4 Sao",990000,990000,0,0
TIKI,bach-hoa-online,76582330,"Tổ Yến Sào Tinh Chế (5 Tổ/40g/Hộp) (Tổ Yến làm sạch/Tổ Yến Sạch chế biến từ Tổ Yến Thô /Tổ Yến còn lông) Yến Sào Trung Nam",1795000,2100000,305000,15
TIKI,bach-hoa-online,97857514,"Combo 3 Natural Gia vị Lẩu Thái Dh Foods",40856,40856,0,0
TIKI,bach-hoa-online,59199813,"Quả táo đỏ thái lát - Loại cao cấp thơm ngon (500gr)",59000,59000,0,0
TIKI,bach-hoa-online,58911324,"cà phê Robusta Đắk Lắk 1kg",220000,220000,0,0
TIKI,bach-hoa-online,185965231,"Xương gặm làm sạch răng, thơm miệng cho chó",89000,89000,0,0
TIKI,bach-hoa-online,68778070,"Gạo Basmati India (Ấn Độ), chỉ số đường huyết (GI) thấp, tốt cho người bị tiểu đường, Túi 5kg",290000,290000,0,0
TIKI,bach-hoa-online,131182322,"[[Combo 2 Hũ] Thanh gạo lứt chà bông mỗi hũ 250g hiệu SK FOOD",95000,95000,0,0
TIKI,bach-hoa-online,183335080,"Đặc Sản Sóc Trăng - Bánh In Đậu Xanh Lá Dứa Tân Huê Viên Túi 10 Bánh 400G, Đặc Sản Bánh In Sóc Trăng Nhân Lá Dứa, Đậu Xanh",68080,74000,5920,8
TIKI,bach-hoa-online,166092594,"Combo 3 Hộp Bánh Dinh Dưỡng AFC Vị Caramel Flan Mỏng Giòn 3x109g",61000,87000,26000,30
TIKI,bach-hoa-online,174469215,"Trà dây thìa canh tiểu đường Mộc Can giúp giảm đường huyết ngăn ngừa những biến chứng của bênh tiểu đường hộp 25 túi lọc",69000,69000,0,0
TIKI,bach-hoa-online,21257903,"Chai xịt diệt ve bọ chét cho chó mèo Hantox spray",21000,21000,0,0
TIKI,bach-hoa-online,109576750,"Sữa Tiệt Trùng Ít Đường VPMilk Grow+ Hộp 110ml (Thùng 48 Hộp)",239766,269400,29634,11
TIKI,bach-hoa-online,24970815,"Lốc 6 Lon cao Strongbow vị Dâu đỏ (330ml x 6 Lon)",105000,120000,15000,13
TIKI,bach-hoa-online,82918481,"Trà Tim Sen( Tâm Sen) Nguyên Chất( Hũ 125gam)",92000,92000,0,0
TIKI,bach-hoa-online,63895932,"KHÔ BÒ DẠNG QUE TÂN LỘC PHÁT - HŨ 200G",71100,79000,7900,10
TIKI,bach-hoa-online,155772956,"Trà diệp hạ châu túi lọc L'angfarm, 25 tép, hộp, mẫu quấn dây kraft",52200,58000,5800,10
TIKI,bach-hoa-online,48636180,"Đường Phèn Quảng Ngãi 3T FOOD- Hạt vừa",68000,68000,0,0
TIKI,bach-hoa-online,161409517,"Thùng 48 hộp sữa tươi tiệt trùng TH True Milk Light Meal bổ sung ngũ cốc 180ml (180ml x 48)",566000,589110,23110,4
TIKI,bach-hoa-online,107018090,"Bánh Bông Lan Cuộn Hura Layer Cake 300 gam Bibica",40500,48500,8000,16
TIKI,bach-hoa-online,6006865,"Sữa bột Bonecare dưỡng chất cho xương và khớp dành cho người từ 30 tuổi trở lên phòng ngừa đau xương khớp, viêm khớp, đặc biệt là người bệnh xương và khớp",286000,449000,163000,36
TIKI,bach-hoa-online,142312193,"Bột Matcha Trà Xanh Dalat Farm - Hộp 110Gr",165000,170000,5000,3
TIKI,bach-hoa-online,7237703,"Canh rong biển ăn liền hộp 10 gói canh không bột ngọt nấu canh cho bé TÂM MINH FOODS",46000,46000,0,0
TIKI,bach-hoa-online,153407352,"Tắc xí muội Thanh Bình - Hộp 900gr",59000,59000,0,0
TIKI,bach-hoa-online,99321003,"Rong Biển Cháy Tỏi Ớt Thơm Ngon - Combo 2 Hũ Mỗi Hũ 100G HIỆU SK FOOD",75000,75000,0,0
TIKI,bach-hoa-online,107748954,"KHÔ BÒ MIẾNG TÂN LỘC PHÁT - BỊCH 100G",31500,35000,3500,10
TIKI,bach-hoa-online,84871268,"Sữa Oggi cho người gầy 900g - Tăng cân hiệu quả, tăng sức đề kháng",309000,309000,0,0
TIKI,bach-hoa-online,173153538,"Sốt Ướp Thịt Nướng - Mật Ong 200gr Dh Foods - gia vị ướp hoặc chấm các món thịt nướng, beefsteak",35000,35000,0,0
TIKI,bach-hoa-online,73099034,"NẤM ĐÔNG TRÙNG HẠ THẢO AN GIA SẤY THĂNG HOA (LOẠI II LỌ 20G)",360000,490000,130000,27
TIKI,bach-hoa-online,2592115,"Tiêu Đen Xay 45gr Dh Foods",21600,21600,0,0
TIKI,bach-hoa-online,17406693,"Ngăn phóng uế Fay Repell 400ml",89000,130000,41000,32
TIKI,bach-hoa-online,271585984,"Thùng 30 Phở Bò VIFON  (65g / Gói)",105000,136000,31000,23
TIKI,bach-hoa-online,57804902,"Combo 2 gói Natural Gia Vị Nấu Phở Bò Hà Nội Dh Foods",33756,33756,0,0
TIKI,bach-hoa-online,126218794,"Cà phê hòa tan 3 in 1 Goodmorning cafe sữa uống liền (bịch 24 gói x 20gr) Trần Quang Coffe",50000,52000,2000,4
TIKI,bach-hoa-online,99078087,"Combo 5 gói Mì Tương Đen Bắc Kinh Ottogi 83g",37130,39500,2370,6
TIKI,bach-hoa-online,175844048,"Đặc Sản Bến Tre - Kẹo Dừa Lá Dứa Ít Đường Du Thảo 400G, Kẹo Dừa Bến Tre, Kẹo Dừa Ít Ngọt",74100,78000,3900,5
TIKI,bach-hoa-online,70088755,"Hạt sen sấy khô (500gr)",120000,120000,0,0
TIKI,bach-hoa-online,270699432,"Sữa tăng chiều cao A2 nguyên kem full cream high in calcium phát triển xương, răng trẻ, chống loãng xương người lớn, tăng sức khỏe-QuaTangMe Extaste",511000,1022000,511000,50
TIKI,bach-hoa-online,5437399,"Thùng 24 Lon Cao Strongbow Vị Dark Fruit Dâu đen (330ml / Lon)",421000,480000,59000,12
TIKI,bach-hoa-online,58453178,"Trung Nguyên Legend - Cà phê hoà tan rang xay 3in1 Special Edition - Hộp 9 gói x 25gr",63000,72151,9151,13
TIKI,bach-hoa-online,4684161,"Bột ngũ cốc dinh dưỡng cao cấp Dr. B-Glucan (Dành cho người ăn kiêng hoặc tiểu đường) - hộp thiếc 750g",499000,499000,0,0
TIKI,bach-hoa-online,2431263,"Dầu Hướng Dương Simply (2L)",136600,136600,0,0
TIKI,bach-hoa-online,73832553,"Trà Gừng Hòa Tan Hùng Phát Hỗ Trợ Giải Cảm Lạnh Làm Ấm Cơ Thể Tốt Cho Hệ Tiêu Hóa Hộp 20 Gói",73000,73000,0,0
TIKI,bach-hoa-online,58389098,"Trung Nguyên Legend - Cà phê hoà tan rang xay Cappuccino Coconut - Hộp 12 gói x 18gr",72000,85874,13874,16
TIKI,bach-hoa-online,32499931,"3 chai Mật Ong Hoa Rừng Tây Bắc Xuất Khẩu",239000,239000,0,0
TIKI,bach-hoa-online,73642140,"NHÂN HẠT BÍ TÂN LỘC PHÁT COMBO 1KG - MỖI HŨ 500G",104490,116100,11610,10
TIKI,bach-hoa-online,89153053,"(COMBO 2 HŨ) CƠM CHÁY LẮC KHÔ GÀ ĐẬM VỊ - MỖI HŨ 300G",107100,119000,11900,10
TIKI,bach-hoa-online,59548756,"Thùng 24 Lon Bia Larue (330ml/lon)",263000,311000,48000,15
TIKI,bach-hoa-online,701964," Đồ Ăn Khô Cho Chó Trưởng Thành Hương Vị Thịt Bò Nướng SmartHeart (3kg)",171000,171000,0,0
TIKI,bach-hoa-online,25438346,"1KG ĐẬU PHỘNG CỐT DỪA SẤY GIÒN - 2 HŨ NHỰA 500G",67000,139000,72000,52
TIKI,bach-hoa-online,60854836,"Thịt heo chà bông Chà Chà - Thảo Nguyên Phát gói 150g",90000,90000,0,0
TIKI,bach-hoa-online,134662156,"Trà hà thủ ô túi lọc cao cấp",79000,79000,0,0
TIKI,bach-hoa-online,57448236,"Viên nấu Cà ri kiểu Nhật Kobe Bussan 200g - các vị",57000,57000,0,0
TIKI,bach-hoa-online,99477033,"MỰC CÁN TẨM VỊ TÂN LỘC PHÁT COMBO 2 HŨ - MỖI HŨ 200G",86000,89000,3000,3
TIKI,bach-hoa-online,117785864,"Cà phê AEROCO A8, gói 250g, pha phin, nguyên chất 100% rang mộc hậu vị ngọt thơm quyến rũ",99000,99000,0,0
TIKI,bach-hoa-online,19787087,"1kg Khô gà lá chanh thượng hạng cao cấp",245000,245000,0,0
TIKI,bach-hoa-online,75628424,"NHO SẤY KHÔ 3 MÀU CHILE SIÊU NGON TLP - HŨ 500G",44000,54450,10450,19
TIKI,bach-hoa-online,163716493,"Trà hoa cúc gạo lứt Quê Việt thanh nhiệt, ngủ ngon, điều hoà huyết áp hộp 600gr",178000,230000,52000,23
TIKI,bach-hoa-online,109391485,"Đặc Sản Phan Thiết - Nước Mắm Nhỉ Cá Cơm Than Làng Chài Xưa 525Ml (01 Chai) Sánh Đặc Thịt Cá 300 Năm Truyền Thống",38000,60000,22000,37
TIKI,bach-hoa-online,45812218,"Bột diếp cá nguyên chất Goce - 72g (24 gói x 3g)",102000,170000,68000,40
TIKI,bach-hoa-online,116591185,"Bún gạo lứt đen Cao Tuyền, đặc sản Cao Bằng, làm 100% từ gạo lứt, đỗ đen, vừng đen, an toàn sạch sẽ, không hóa chất ",27900,50000,22100,44
TIKI,bach-hoa-online,93709605,"Đặc Sản Phú Quốc - Hộp 6 Chai Thủy Tinh Nước Mắm Phú Quốc Khải Hoàn 40 Độ Đạm (520Ml X 6) - Ocop 5 Sao",449000,505000,56000,11
TIKI,bach-hoa-online,49095226,"Hạnh Nhân cắt lát DK Harvest (nhập khẩu) - tự nhiên, không tẩm ướp, rất tốt cho trí não và tim mạch",119000,130000,11000,8
TIKI,bach-hoa-online,153768302,"Kẹo ngậm đau họng Ricola Shweizer Krauterzucker tạo cảm giác dịu nhẹ và thơm mát miệng và cổ họng - QuaTangMe Extaste",108000,216000,108000,50
TIKI,bach-hoa-online,39327028,"Combo 2 Hộp Viên Hồng Sâm Linh Chi Nhung Hươu Hàn Quốc (Hộp 60 viên)",303800,310000,6200,2
TIKI,bach-hoa-online,181000364,"Đặc Sản Sóc Trăng - Bánh Pía Khoai Môn Sầu Riêng Trứng Muối 400G, Bánh Pía Sóc Trăng Tân Huê Viên Vị Truyền Thống",85260,87000,1740,2
TIKI,bach-hoa-online,41613299,"COMBO SIÊU TIẾT KIỆM 2 hũ Nam Việt Quất DK Harvest nhập khẩu - 200g",190000,199000,9000,5
TIKI,bach-hoa-online,137753154,"Thức ăn hạt cho mèo Natural Core C3 Bene 3012 | Thịt gà và Cá hồi | Tốt cho tiết niệu và tim mạch | Ngăn ngừa dị ứng | Chính hãng Hàn Quốc",247000,370000,123000,33
TIKI,bach-hoa-online,68199945,"Đậu đen xanh lòng rang mộc - 01kg - (MS) - Đậu đen xanh lòng 100% - hạt nhỏ thuần chủng",120000,150000,30000,20
TIKI,bach-hoa-online,67966062,"Hạt ngũ hoa - Loại hạt nhỏ (500gr)",89000,89000,0,0
TIKI,bach-hoa-online,125918701,"Tương ớt Cholimex 2.1kg",65000,65000,0,0
TIKI,bach-hoa-online,181373204,"Mật hoa dừa cô đặc Sokfarm dạng tuýp - Hành trang tiện lợi, nạp năng lượng tức thời, thay thế bữa ăn nhẹ không lo tăng cân, dùng được cho người tiểu đường",19000,19000,0,0
TIKI,bach-hoa-online,2468655,"Muối Ớt Xanh Tây Ninh 120gr Dh Foods",21600,21600,0,0
TIKI,bach-hoa-online,69210111,"Muối hồng Himalaya Nhập Khẩu Pakistan dạng mịn 500g - Dùng làm gia vị, Ngâm chân thải độc, Tẩy tế bào chết",40000,40000,0,0
TIKI,bach-hoa-online,189235215,"Thức ăn cho mèo / Pate Nekko Thạch Jelly Cho Mèo Mọi Lứa Tuổi - gói 70g",15800,20000,4200,21
TIKI,bach-hoa-online,118897372,"Rượu Vang Đỏ Úc GEORGE WYNDHAM BIN 888 750ml 13.5% - 14.8% Không hộp",399000,487000,88000,18
TIKI,bach-hoa-online,94901377,"Yến Sào win'sNest Nhân Sâm Nguyên Chất Ít Đường 20% (6 lọ x 70 ml/ Hộp) kèm túi xách",177000,390000,213000,55
TIKI,bach-hoa-online,98329147,"Lốc 6 Lon Nước Tăng Lực Sting Vàng (320ml/Lon)",49000,70000,21000,30
TIKI,bach-hoa-online,192920072,"Kẹo chanh muối gừng himalaya malaysia",86888,86888,0,0
TIKI,bach-hoa-online,89160943,"KHÔ GÀ LÁ CHANH VÀ KHÔ GÀ BƠ TỎI TLP (COMBO 1KG) - MỖI HŨ 500G",109000,119000,10000,8
TIKI,bach-hoa-online,273992080,"Sinh Tố VINA MỨT 1000ml - 10 Vị Trái Cây Tươi Tự Nhiên",75000,75000,0,0
TIKI,bach-hoa-online,50715634,"1KG 2 HŨ HẠT ĐIỀU VỠ RANG MUỐI THƠM NGON",115000,115000,0,0
TIKI,bach-hoa-online,106535760,"Cà Phê Hòa Tan Nescafé Latte Vị Sô Cô La (Hộp 10 Gói x 24g)",63000,80000,17000,21
TIKI,bach-hoa-online,73655139,"Cá Ngừ Ngâm Dầu Hướng Dương Hạ Long - 115/175g",42240,42240,0,0
TIKI,bach-hoa-online,90718669,"Combo 2 Hộp Bánh OREO Socola Pie 2x360g",115000,144000,29000,20
TIKI,bach-hoa-online,74278032,"Sữa hạt ngũ cốc 25 Green Nutri lon 750g",620000,620000,0,0
TIKI,bach-hoa-online,72331222,"Trà gạo lứt huyết rồng - đậu đen xanh lòng MS (01kg) - Thanh nhiệt, mát gan, lợi sữa",89000,89000,0,0
TIKI,bach-hoa-online,115248902,"Bộ 6 gói thức ăn cho chó lớn dạng sốt Pedigree vị gà, gan nướng và rau 80g",72000,72000,0,0
TIKI,bach-hoa-online,2119331,"Bột ngũ cốc Calsome",63000,70000,7000,10
TIKI,bach-hoa-online,16688374,"Yến Sào cao cấp win'snest Tổ Yến Chưng Sẵn Bổ Sung Canxi 20% (6 Lọ/Hộp) thích hợp cho người lớn bổ sung canxi và khoáng chất ngừa loãng xương, chống lão hóa.",175000,389000,214000,55
TIKI,bach-hoa-online,10190866,"Đồ Ăn Chó Trưởng Thành Giống Nhỏ Hương Vị Cừu Và Gạo SmartHeart Gold (3Kg)",270000,270000,0,0
TIKI,bach-hoa-online,59197175,"Sữa Ca Cao Mầm Lúa Mạch Đen – VPMilk Nutrimalt Hộp 110ml (Thùng 48 Hộp)",244000,269400,25400,9
TIKI,bach-hoa-online,66993226,"Rượu Whisky Imperial Blue 700ml 29,5% - Kèm Hộp",138000,138000,0,0
TIKI,bach-hoa-online,62735877,"Trung Nguyên Legend - Cà phê phin giấy Americano - Hộp 10 gói x 10gr",128000,148334,20334,14
TIKI,bach-hoa-online,85402992,"Đường ăn kiêng La Hán Quả Saraya Lakanto MonkFruit Vàng, 0 Calo, 0 tăng đường huyết, 0 biến đổi gen - 300g",254000,305000,51000,17
TIKI,bach-hoa-online,176292290,"Canh rong biển thịt gà ăn liền I-Soup 42g (túi 06 viên cho 06 khẩu phần ăn)-Canh sấy lạnh công nghệ Nhật Bản",68000,68000,0,0
TIKI,bach-hoa-online,127076464,"Thanh cơm gạo lứt chà bông 250g hiệu SK FOOD",65000,65000,0,0
TIKI,bach-hoa-online,176292291,"Canh kim chi thịt gà ăn liền I-Soup 66g (túi 06 viên cho 06 khẩu phần ăn)-Canh sấy lạnh công nghệ Nhật Bản",68000,68000,0,0
TIKI,bach-hoa-online,7773006,"Combo 02 gói trà xanh tân cương 500 gram - Trà tân cương đặc biệt",245000,245000,0,0
TIKI,bach-hoa-online,110976761,"Dầu ăn Sailing Boat Gold Plus 1L giàu Omega 3,6,9 và chất chống oxy hóa [FREESHIP]",43000,56800,13800,24
TIKI,bach-hoa-online,126939561,"[COMBO 2 HŨ] DA CÁ LẮC TRỨNG MUỐI GIÒN NGON - MỖI HŨ 200G HIỆU SK FOOD",99000,99000,0,0
TIKI,bach-hoa-online,179754715,"Yến Thị- Gói Đủ Vị Nhà Thị-30 % Yến- Yến Sào Nha Trang",295000,320000,25000,8
TIKI,bach-hoa-online,114821931,"Ngũ Cốc Ăn Sáng HONEY STARS (Hộp 150g)",68900,78000,9100,12
TIKI,bach-hoa-online,271830084,"Sữa tăng chiều cao A2 nguyên kem full cream high in calcium phát triển xương, răng ở trẻ, chống loãng xương ở người lớn, tăng sức khỏe - OZ Slim Store",511000,1022000,511000,50
TIKI,bach-hoa-online,99280864,"Cà phê bột Arabica Cầu Đất 500g nguyên chất 100% thơm nồng, vị nhẹ, gu tây TẶNG Phin Nhôm Pha Cà Phê Màu Đỏ Cao Cấp",181000,319000,138000,43
TIKI,bach-hoa-online,92710937,"Thức ăn mèo Whiskas vị cá biển túi 1.2kg",122500,125000,2500,2
TIKI,bach-hoa-online,588043,"Gạo Nhật Akira Rice 2Kg",62000,62000,0,0
TIKI,bach-hoa-online,56187931,"Cà Phê Hòa Tan 3IN1 KING COFFEE - Túi 45 gói x 16g",130000,130000,0,0
TIKI,bach-hoa-online,706045,"Đồ Ăn Cho Mèo Trưởng Thành Me-O Vị Hải Sản (7kg)",435000,436999,1999,0
TIKI,bach-hoa-online,147854895,"Trà Mãng Cầu Nguyễn Văn - 100% mãng cầu xiêm tươi sấy khô - Hộp 100 GRAM",131250,175000,43750,25
TIKI,bach-hoa-online,48564261,"Đậu Đen Xanh Lòng Rang Mộc_Cỏ Ngọt- Hà Thủ Ô 1KG (Mộc Thanh Trà) Có Túi Lọc",240000,240000,0,0
TIKI,bach-hoa-online,94745886,"Đặc Sản Phú Quốc - Hộp 2 Chai Thủy Tinh Nước Mắm Phú Quốc Khải Hoàn 40 Độ Đạm (520Ml X 2) - Ocop 5 Sao",159000,180000,21000,12
TIKI,bach-hoa-online,15058426,"Khô Gà Lá Chanh Thượng Hạng DTfood 1kg",162000,169000,7000,4
TIKI,bach-hoa-online,99078125,"Lốc 5 Gói Mỳ Jin Rong Biển Ottogi 120g",62228,66200,3972,6
TIKI,bach-hoa-online,137759080,"Thức ăn cho mèo Hàn Quốc Cats eye Kitten and Cat Hộp 1kg cho mèo trên 3 tháng tuổi ",88888,88888,0,0
TIKI,bach-hoa-online,54022812,"Combo 3 Túi Hạt Bí Rang Trọng Nhân 500gr",239000,239000,0,0
TIKI,bach-hoa-online,177265591,"Dầu hào Lee Kum Kee Panda Brand Oyster Sauce hiệu Gấu trúc với chiết xuất hào chọn lọc 11",46000,46000,0,0
TIKI,bach-hoa-online,161462918,"Thùng 24 chai nước uống sữa trái cây dâu tự nhiên TH True Juice Milk 300ml (300ml x 24)",247000,270994,23994,9
TIKI,bach-hoa-online,53224414,"Natural Nghệ bột 40gr Dh Foods - Bột nghệ nguyên chất 100%",16200,16200,0,0
TIKI,bach-hoa-online,50425577,"[MUA 1 TẶNG 1] Nước mắm truyền thống Phú Quốc Hồng Hạnh Cốt Nhỉ 40 độ đạm dung tích 500ML - Chấm sống tuyệt ngon, vẹn tròn dưỡng chất",97010,109000,11990,11
TIKI,bach-hoa-online,31975546,"Nước Dừa Xiêm VICO FRESH 1L",68000,68000,0,0
TIKI,bach-hoa-online,154698931,"Kẹo hương thập cẩm dẻo L'angfarm, 180g, bịch, mẫu túi bạc",23400,26000,2600,10
TIKI,bach-hoa-online,70815886,"Gạo Nếp Chùm Vinh Hiển túi 1Kg - Nếp Sạch 3 Không - Gạo nếp dẻo, thơm xôi mới thuộc thương hiệu Gạo Vinh Hiển",28000,28000,0,0
TIKI,bach-hoa-online,73110081,"Pa tê gan ngỗng hiệu Glavproduct, 90 g",35000,35000,0,0
TIKI,bach-hoa-online,137850728,"Thùng 24 chai Nước Khoáng Kiềm Thiên Nhiên Vikoda 350ml",120000,120000,0,0
TIKI,bach-hoa-online,155187416,"CHAI XỊT KHỬ MÙI HÔI THÚ CƯNG, KHỬ MÙI HÔI NƯỚC TIỂU CHÓ MÈO, CÁT VỆ SINH, KHAY, LỒNG, CHUỒNG CHÓ MÈO-XCLEAN PET 500ML-NANO BẠC AHT CORP (AHTC)",88000,148500,60500,41
TIKI,bach-hoa-online,145092303,"Trà Sữa Teh Tarik Vị Cổ Điển Aik Cheong Malaysia - Teh Tarik Classic 3 In 1 - 600g (15 Gói x 40g)",120000,145000,25000,17
TIKI,bach-hoa-online,138956315,"[Combo 30 lọ] Nước Yến sào Khánh Hòa Sanest đóng lọ 70ml",1048000,1080000,32000,3
TIKI,bach-hoa-online,63474688,"Đường đen Déli gói 1kg",70000,70000,0,0
TIKI,bach-hoa-online,207818898,"[MUA 1 TẶNG 1] SỮA CHAY SOYNA - SỮA HẠT BỔ SUNG PROTEIN CHO NGƯỜI ĂN CHAY- SỮA THỰC VẬT CAO CẤP SOYNA BỔ SUNG CANXI CHO XƯƠNG CHẮC KHỎE",485000,485000,0,0
TIKI,bach-hoa-online,189361532,"Pate cho mèo NEKKO GRAVY 70g",13920,20000,6080,30
TIKI,bach-hoa-online,161462742,"Thùng 24 chai nước uống sữa trái cây cam tự nhiên TH True Juice Milk 300ml (300ml x 24)",247000,270994,23994,9
TIKI,bach-hoa-online,77283146,"Trân châu thủy tinh Yoki 300g (10*30g)",35000,35000,0,0
TIKI,bach-hoa-online,51571077,"200gr Trà kỷ tử - Câu kỷ tử - Loại cao cấp",59000,59000,0,0
TIKI,bach-hoa-online,25436955,"1KG ĐẬU PHỘNG RANG TỎI ỚT THƠM NGON ( 2 HŨ 500G)",77000,90090,13090,15
TIKI,bach-hoa-online,178509637,"Yến Thị- Chưng Đường Phèn-Chưng Sẵn -30% YẾN-70ml",280000,320000,40000,13
TIKI,bach-hoa-online,29263873,"Nước dùng Dashi tảo bẹ Kombu Yamasa 500ml",118000,118000,0,0
TIKI,bach-hoa-online,3088445,"Cà Phê Cappuccino Aik Cheong Cafe Art (12 Gói x 25g)",119000,119000,0,0
TIKI,bach-hoa-online,21973771,"Thùng 48 Hộp Sữa dinh dưỡng Có đường Vinamilk ADM (110ml)",240000,240000,0,0
TIKI,bach-hoa-online,92523389,"Thức ăn chó Pedigree vị thịt bò & rau củ túi 1.5kg",106560,111000,4440,4
TIKI,bach-hoa-online,101150949,"Me Xí Muội Chua Cay DTFood cực ngon",48000,49000,1000,2
TIKI,bach-hoa-online,271615582,"Sữa Milo Nestle chính hãng nội địa Úc 1kg - Phát triển chiều cao, tràn đầy năng lượng - OZ Slim Store",385000,770000,385000,50
TIKI,bach-hoa-online,134515737,"Muối Chẩm Chéo Điện Biên 250g, đặc sản dân tộc Thái Mường Phăng, hũ to siêu ngon loại nhiều mắc khén thơm lừng",27000,35000,8000,23
TIKI,bach-hoa-online,273963048,"Si Rô VinaSyrup 750ml - 21 Vị Trái Cây Tự Nhiên",30000,30000,0,0
TIKI,bach-hoa-online,76681202,"Tổ Yến Sào Tinh Chế (3 Tổ/24g/Hộp) (Tổ Yến làm sạch/Tổ Yến Sạch chế biến từ Tổ Yến Thô /Tổ Yến còn lông) Yến Sào Trung Nam",1145000,1300000,155000,12
TIKI,bach-hoa-online,89624989,"Tương ớt Chilica 255g",42900,42900,0,0
TIKI,bach-hoa-online,99078142,"Combo 6 gói Mì Jin Cay Ottogi Mini (80g)",46812,49800,2988,6
TIKI,bach-hoa-online,81535492,"Sôcôla Thanh 13 Vị Schogetten - Hạt Dẻ - 100g",51150,55000,3850,7
TIKI,bach-hoa-online,20786906,"Socola Đen Hạnh Nhân Thanh Lớn 80 gram, Nguyên Chất, Đắng Vừa | Dark Chocolate Almond Alluvia",130000,130000,0,0
TIKI,bach-hoa-online,49375113,"200gr Trà nụ hoa tam thất - Cao Cấp",180000,180000,0,0
TIKI,bach-hoa-online,76688244,"Combo 2 sản phẩm Gạo Ông Thọ - Lứt Tím Than túi 1kg hút chân không cao cấp. Gạo sạch hữu cơ dinh dưỡng cho sức khỏe",84000,84000,0,0
TIKI,bach-hoa-online,41873724,"200gr Trà tim sen - Trà tâm sen",65000,65000,0,0
TIKI,bach-hoa-online,1988013,"Nước mắm Lê Gia- Cá cơm 650ml",38000,41000,3000,7
TIKI,bach-hoa-online,93525485,"Trà Thảo Mộc KingTea 500g Hỗ Trợ Đau Dạ Dày, Ổn Định Huyết Áp, Hạ Men Gan , Mỡ Máu Và Ngăn Ngừa Ung Thư Giúp Ngủ Ngon",149000,149000,0,0
TIKI,bach-hoa-online,97991452,"Muối Ớt Chanh Gừng Nha Trang 200gr Dh Foods",26800,26800,0,0
TIKI,bach-hoa-online,136605670,"Natural Sả bột 30gr Dh Foods",17200,17200,0,0
TIKI,bach-hoa-online,165028976,"Trà tâm sen cao cấp MS - (200g) - An thần, ngủ ngon giấc",110000,110244,244,0
TIKI,bach-hoa-online,58655945,"Trà Oolong ( Ô Long/ OLong) Thượng Hạng Nguyên Chất Vũ Gia (200gr/hũ)",330000,330000,0,0
TIKI,bach-hoa-online,94705188,"Đặc Sản Phú Quốc - Nước Mắm Phú Quốc Khải Hoàn 40 Độ Đạm Chai Nhựa 1 Lít - Ocop 5 Sao",142000,142000,0,0
TIKI,bach-hoa-online,2466781,"Muối ớt Tây Ninh 110gr Dh Foods",21060,21060,0,0
TIKI,bach-hoa-online,912613,"Kẹo Fres Barley (600g)",61000,61000,0,0
TIKI,bach-hoa-online,13135804,"Cà phê phin Minh An (Arabica & Robusta) Rang xay nguyên chất - Túi 500g",130000,150000,20000,13
TIKI,bach-hoa-online,59514285,"Trung Nguyên Legend - Cà phê hòa tan G7 3in1 - Hộp 21 gói x 16gr",77000,87545,10545,12
TIKI,bach-hoa-online,161524352,"Thùng 48 hộp sữa hạt óc chó TH True Nut 180ml (180ml x 48)",566000,589110,23110,4
TIKI,bach-hoa-online,74972222,"Gạo Mầm Vibigaba Hộp 1Kg - Ổn định đường huyết và huyết áp, làm chậm quá trình lão hóa và giúp hệ tiêu hóa khỏe mạnh",80000,80000,0,0
TIKI,bach-hoa-online,262979703,"Sữa bột Nestlé Milo Australia giúp bé phát triển chiều cao và cân năng, thông minh và sáng tạo năng động vượt trội - QuaTangMe Extaste",385000,770000,385000,50
TIKI,bach-hoa-online,167145110,"Rong biển cháy tỏi 100G / Không cay không ớt / Thương hiệu Vườn Xanh Sạch",54000,62000,8000,13
TIKI,bach-hoa-online,57302645,"Cà phê hạt 100% nguyên chất truyền thống số 2 Coffee Tree 1kg đậm đà, thơm ngon, gu vừa",265000,459000,194000,42
TIKI,bach-hoa-online,112318761,"Dầu Ăn Cao Cấp Sailing Boat Gold Plus 5L giàu Omega 3,6,9 và chất chống oxy hóa [FREESHIP]",212000,255000,43000,17
TIKI,bach-hoa-online,817122,"Đường Bắp Ăn Kiêng Sucralose Tropicana Slim (100g)",85000,85000,0,0
TIKI,bach-hoa-online,14980803,"Đậu lăng đỏ tách vỏ Red Lentils",27000,27000,0,0
TIKI,bach-hoa-online,55474726,"Combo 3 gói cà Phê Trung Nguyên Legend S Chinh Phục ( 500g / gói )",250000,250000,0,0
TIKI,bach-hoa-online,166093262,"Combo 3 Khay Bánh Quy Sôcôla Oreo Vị Vani 3x248.4g",82000,106000,24000,23
TIKI,bach-hoa-online,71091278,"Combo 3 Gói Bột Ngọt VEDAN 454g [ LM ]",105300,117000,11700,10
TIKI,bach-hoa-online,129059166," Patê Cột Đèn Hải Phòng 90g - Đồ Hộp Hạ Long",18500,18500,0,0
TIKI,bach-hoa-online,75400387,"MỰC SỢI HẤP NƯỚC DỪA TÂN LỘC PHÁT COMBO 2 HŨ - MỖI HŨ 200G",89100,99000,9900,10
TIKI,bach-hoa-online,24970817,"Lốc 6 Lon cao Strongbow vị Táo nguyên bản (330ml x 6 Lon)",105000,125000,20000,16
TIKI,bach-hoa-online,57829141,"Nhân Hạt Óc Chó Sống DK Harvest Dùng làm Sữa 1000g",329000,329000,0,0
TIKI,bach-hoa-online,117926521,"Tương ớt Mường Khương 250ml, đặc sản Lào Cai, cay thơm tự nhiên, ko hóa chất ",23500,30000,6500,22
TIKI,bach-hoa-online,177500430,"Viên tẩy sán dây, sán lá cho Chó Mèo - 1 viên/5kg",6888,6888,0,0
TIKI,bach-hoa-online,2984261,"Cà Phê Chế Phin 5 Trung Nguyên (500g) - (Giao Ngẫu Nhiên)",250000,250000,0,0
TIKI,bach-hoa-online,75986352,"Sữa Tiệt Trùng Có Đường VPMilk Grow+ Vị Dâu Hộp 110ml (Thùng 48 Hộp)",239766,269400,29634,11
TIKI,bach-hoa-online,172215453,"Hộp Gia Vị Tự Nhiên Dh Foods - Set 5 loại nguyên liệu chế biến thực phẩm - Natural Ớt Bột Hàn Quốc, Tiêu Đen Xay, Tỏi Bột, Nghệ Bột, Gừng Bột",88500,88500,0,0
TIKI,bach-hoa-online,3615517,"Vải Sấy Khô Vinafruits (500g)",99000,99000,0,0
TIKI,bach-hoa-online,72214567,"1Kg Hạnh Nhân Rang Bơ Nhập Khẩu Cao Cấp Thương Hiệu SK FOOD",189000,189000,0,0
TIKI,bach-hoa-online,118895063,"Rượu Vang Đỏ Úc GEORGE WYNDHAM BIN 868 750ml 13.8% - 14.8% Không hộp",430000,526000,96000,18
TIKI,bach-hoa-online,128321751,"Balo phi hành gia dành cho thú cưng chó mèo thương hiệu LEDO - Hàng chính hãng đủ màu",290000,290000,0,0
TIKI,bach-hoa-online,3493687,"Cà Phê Hòa Tan Sữa Đá Legend Trung Nguyên (9 Gói x 25g) - (Giao Ngẫu Nhiên)",86000,86000,0,0
TIKI,bach-hoa-online,68119473,"SỮA TĂNG CÂN Goodmilk calo gain dành cho người gầy lon 850g",320000,320000,0,0
TIKI,bach-hoa-online,56961702,"Combo 6 hộp nước yến sào win'sNest chưng sẵn đường phèn ( 6 Lọ * 70 ml / Hộp): giúp bồi bổ sức khỏe thích hợp cho mọi đối tượng và trẻ em  từ 1 tuổi trở lên",798000,1614000,816000,51
TIKI,bach-hoa-online,2467127,"Muối Tiêu Chanh 120gr Dh Foods ",23900,23900,0,0
TIKI,bach-hoa-online,154699008,"Trà tim sen túi lọc L'angfarm, 25 tép, hộp, mẫu quấn dây kraft",54000,60000,6000,10
TIKI,bach-hoa-online,23911778,"Macca nướng nứt vỏ DK HARVEST nhập khẩu Australia ( Có đồ tách vỏ)",92000,95000,3000,3
TIKI,bach-hoa-online,33531828,"Hạt Mix 3 Loại (Macca - Hạt Điều - Hạnh Nhân) DK Harvest nhập khẩu - hạt ngũ cốc dinh dưỡng, ăn vặt, giảm cân, eatclean, thực dưỡng",155000,179000,24000,13
TIKI,bach-hoa-online,72639516,"TRÀ ĐEN LỘC PHÁT / 1KG NGUYÊN LIỆU DÙNG PHA CHẾ ĐỒ UỐNG (Đồ uống) (Trà Lộc Phát) MẪU MỚI NHẤT",160000,160000,0,0
TIKI,bach-hoa-online,64249066,"BỘT NGŨ CỐC 5 LOẠI ĐẬU ( 01KG )",130000,130000,0,0
TIKI,bach-hoa-online,190740888,"Trà thảo mộc Quê Việt - Mát gan, ngủ ngon, giảm căng thẳng mệt mỏi, nguyên liệu hữu cơ - hộp 600g (20X30g)",187000,240000,53000,22
TIKI,bach-hoa-online,138956338,"[Combo 30 lọ]Nước Yến sào Sanvinest Khánh Hòa đóng lọ 70ml",1080000,1080000,0,0
TIKI,bach-hoa-online,5329363,"Gạo Mầm Vibigaba Cho Người Tiểu Đường, Giảm Cân - Hộp 1kg",74000,74000,0,0
TIKI,bach-hoa-online,271585990,"Thùng 18 Bánh Đa Cua HOÀNG GIA VIFON  (120g / Gói)",147000,190000,43000,23
TIKI,bach-hoa-online,20738755,"Socola Đen 70% Nguyên Chất Đắng Vừa Ít Ngọt 80 gram | Dark Chocolate 70%",110000,110000,0,0
TIKI,bach-hoa-online,160658295,"Bánh gạo lứt ăn kiêng Hello Rice, bánh gạo lức nguyên hạt 300gr/500gr",29000,29000,0,0
TIKI,bach-hoa-online,141114624,"Bơ thượng hạng Golden Margarine 80gr",12000,12000,0,0
TIKI,bach-hoa-online,75439551,"Rượu whisky Jameson 700ml 39.7% - 40.3% - Không hộp",419000,419000,0,0
TIKI,bach-hoa-online,183787567,"Rượu Mùi Jägermeister 35% 1x0.2L",224000,224000,0,0
TIKI,bach-hoa-online,74678885,"NHÂN HẠT MACCA TÁCH VỎ TÂN LỘC PHÁT - HỘP 250G",89100,99000,9900,10
TIKI,bach-hoa-online,54809429,"HẠT ĐIỀU RANG TỎI ỚT TÂN LỘC PHÁT COMBO 1KG - MỖI HŨ 500G",143100,159000,15900,10
TIKI,bach-hoa-online,3088449,"Chocolate Hòa Tan Aik Cheong Chocolate Cafe Art (15 Gói x 40g)",117000,117000,0,0
TIKI,bach-hoa-online,59200912,"Thức ăn cho chó trưởng thành Ganador vị thịt cừu & gạo Lamb & Rice 3 kg",150079,150079,0,0
TIKI,bach-hoa-online,109401421,"Đặc Sản Phan Thiết - Thùng 6 Chai Nước Mắm Nhỉ Cá Cơm Vàng Ruột Đỏ Làng Chài Xưa 525Ml/Chai Cá Ngon Vùng Nước Trồi 300 Năm Truyền Thống",240000,420000,180000,43
TIKI,bach-hoa-online,115250204,"Bộ 6 túi thức ăn cho chó lớn dạng sốt Pedigree vị bò nướng và rau củ 80g",67680,72000,4320,6
TIKI,bach-hoa-online,56108532,"Bột Phô Mai Cheese Gói 250g",55000,55000,0,0
TIKI,bach-hoa-online,138800731,"Combo Bột Rau Củ Thải Độc Dalahouse Hộp 63gr (Mẫu mới gồm 7 loại rau củ chia tuýp nhỏ) Sấy lạnh nguyên chất - Detox thanh lọc cơ thể",166500,185000,18500,10
TIKI,bach-hoa-online,177623695,"Nước Uống Ion Kiềm Cao Cấp Công nghệ Nhật Bản - Fujiwa Bổ Sung Vi Khoáng Và Tốt Cho Sức Khoẻ",133000,140000,7000,5
TIKI,bach-hoa-online,71214046,"HẠT CHIA HỮU CƠ NUNUTS - Hạt chia Organic mẩy, nở đều 500g, 1kg",95000,95000,0,0
TIKI,bach-hoa-online,85378571,"Bột cà phê enema (chỉ có nhân không rang) Viet Healthy 500g, dùng cho coffee enema thải độc đại tràng, gan, làm đẹp da..",169000,169000,0,0
TIKI,bach-hoa-online,7772904,"Trà xanh tân cương thái nguyên 500 gram - Trà tân cương đặc biệt",126500,126500,0,0
TIKI,bach-hoa-online,3498565,"Túi Hạt Chia Tím Organic Úc (1kg)",225400,230001,4601,2
TIKI,bach-hoa-online,38151252,"Ngũ Cốc Calbee Nhật Bản",135900,135900,0,0
TIKI,bach-hoa-online,181999214,"Xịt nấm ngứa, ve rận, ghẻ ngứa và viêm da cho chó mèo Fungikur (50ml)",115000,115000,0,0
TIKI,bach-hoa-online,161501211,"Thùng 48 hộp sữa hạt hạnh nhân TH True Nut 180ml (180ml x 48)",566000,589110,23110,4
TIKI,bach-hoa-online,2688941,"Heyday Bột Cacao Nguyên Chất Không Đường Việt Nam - Dòng Origin - Chứng Nhận UTZ - Hỗ Trợ Giảm Cân - Túi Giấy 250g",118000,118000,0,0
TIKI,bach-hoa-online,29098003,"Mì Somen Nhật Bản 200g",35000,35000,0,0
TIKI,bach-hoa-online,2984267,"Cà Phê  Sáng Tạo 4 Trung Nguyên (340g) - 2 gói",270000,270000,0,0
TIKI,bach-hoa-online,253205560,"Yến mạch Simply Granola Quaker - Ngũ cốc yến mạch ăn liền mật ong hạnh nhân",279000,279000,0,0
TIKI,bach-hoa-online,89890414,"Sữa bột Gold Care  - Đông Trùng Hạ Thảo - Nano Curcumin - Sữa Non",230000,230000,0,0
TIKI,bach-hoa-online,166322285,"Nước sốt Nhật Bản Teriyaki Cay - Dashi Lab - 340g/chai - chay mặn đều dùng được",96000,96000,0,0
TIKI,bach-hoa-online,176151045,"Ức gà cắt khúc - 180g - Đồ Hộp Hạ Long",28500,28500,0,0
TIKI,bach-hoa-online,165947096,"Hạnh Nhân Rang Bơ Pams, Nhập Khẩu Mỹ Vỏ Mỏng Chất Lượng, Không Cholesterol, Dùng Ăn Kiêng",109000,188000,79000,42
TIKI,bach-hoa-online,48564057,"Đậu Đen Xanh Lòng Rang Mộc 1KG (Hạt Rời) - Mộc Thanh Trà",150000,150000,0,0
TIKI,bach-hoa-online,125858381,"Xốt rang me Cholimex chai PET 280g",15000,15000,0,0
TIKI,bach-hoa-online,151778898,"Bột Ca Cao Nguyên Chất 100% - MS Cacao (500g)",99000,120000,21000,18
TIKI,bach-hoa-online,103789164,"Combo 2 gói chè dưỡng nhan 12 vị - Mỗi gói 400gr",125000,125000,0,0
TIKI,bach-hoa-online,118133869,"Ớt Bằm Chilica 212g",41900,41900,0,0
TIKI,bach-hoa-online,62907588,"Combo 6 Hộp Đường Ăn Kiêng Tropicana Slim No Calorie Sweetener Diabetics (50 x 2g)",468000,468000,0,0
TIKI,bach-hoa-online,165987710,"Nước Mắm Chay Trái Điều Vương Ngọc 500ml, nước mắm chay làm từ trái điều giàu dinh dưỡng, thơm ngon tự nhiên",30000,50000,20000,40
TIKI,bach-hoa-online,52337909,"COMBO 4kg - Gạo Hữu Cơ Trắng Nàng Hương -  Nàng MEKONG - 100% Organic",224000,224000,0,0
TIKI,bach-hoa-online,84795541,"HẠT ĐIỀU MẬT ONG 400g LAFOOCO Honey roasted cashew nuts",170100,189000,18900,10
TIKI,bach-hoa-online,50295630,"Combo 2 hộp Hạt Chia Đen Hữu Cơ Smile Nuts 500g - Nhập khẩu từ Nam Mỹ (Hạt Chia 100% Organic, hạt sáng, nở đều, không lẫn tạp chất)",188000,300000,112000,37
TIKI,bach-hoa-online,1083278,"Đặc Sản Thái Nguyên - Trà Móc Câu Đặc Biệt Lộc Tân Cương (100g) - Trà Thái Nguyên",72000,72000,0,0
TIKI,bach-hoa-online,20769618,"Sữa bột Suremilk Canxi Gold 800g",324000,324000,0,0
TIKI,bach-hoa-online,87021522,"Bột sắn dây cao cấp gói 500g - Sắn dây cho người ăn thực dưỡng - Bột được lắng lọc kỹ qua 18 lần nước, cho chất lượng bột mịn và nguyên chất nhất",150000,150000,0,0
TIKI,bach-hoa-online,580212,"Nước Ép Đào Và Trái Cây Hỗn Hợp Malee 1L (Thái Lan)",71400,71400,0,0
TIKI,bach-hoa-online,126520952,"Hạt Dinh Dưỡng Mix, Hiệu Mfood, Gồm 7 Loại Hạt Sấy Khô Óc Chó Đỏ, Óc Chó Vàng, Hạnh Nhân, Nho, Xoài Sấy, Bí Xanh, Điều",110000,110000,0,0
TIKI,bach-hoa-online,185965626,"Kem đánh răng Borammy cho thú cưng kèm bàn chải (Kem đánh răng cho chó mèo)",78210,78210,0,0
TIKI,bach-hoa-online,55133824,"KHÔ GÀ LÁ CHANH COMBO 1KG - MỖI HŨ 500G",107100,119000,11900,10
TIKI,bach-hoa-online,177844180,"Sữa 9 loại hạt Vinamilk Super Nut - Thùng 24 hộp 180ml",290000,290000,0,0
TIKI,bach-hoa-online,58837755,"Trà Bưởi Nguyên chất giàu Vitamin Sanga Hàn Quốc (Hộp 30 gói)Mẫu mới",340000,450000,110000,24
TIKI,bach-hoa-online,19513215,"Combo 2 Gói Bột Phô Mai Tornado Vị Truyền Thống (100g / Gói)",60760,62000,1240,2
TIKI,bach-hoa-online,152812697,"Da Heo Lắc Sốt Siêu Phẩm ABI SNACK",35000,35000,0,0
TIKI,bach-hoa-online,125265620,"Rượu Whisky Chivas Extra 13YO American Rye Cask 700ml 40% - Có hộp",846000,849000,3000,0
TIKI,bach-hoa-online,25166056,"Nam việt quất sấy DK HARVEST nhập khẩu Canada 200g",95000,99000,4000,4
TIKI,bach-hoa-online,70339267,"[Thùng 40 gói x 50gram] Cháo Sườn Non Yến Mạch Đậu Xanh - Yến Đại Phát, , thịt thật, yến mạch ngon, đậm đà hương vị",368000,368000,0,0
TIKI,bach-hoa-online,92710915,"Bộ 12 túi thức ăn mèo con Whiskas vị cá thu túi 80g/túi",139500,150000,10500,7
TIKI,bach-hoa-online,99465602,"MỰC CÁN TẨM VỊ TÂN LỘC PHÁT -HŨ 200G",45045,50050,5005,10
TIKI,bach-hoa-online,154698974,"Trà atisô túi lọc Thái Bảo, 60 tép, hộp, mẫu pastel art",69300,77000,7700,10
TIKI,bach-hoa-online,125483757,"Hạt Macca Nữ Hoàng Size 30-32 Pams 250g/hộp - Mắc ca Úc Giòn Béo, Thơm Ngon, không cần dùng khui hạt",141000,236000,95000,40
TIKI,bach-hoa-online,181000516,"Đặc Sản Sóc Trăng - Bánh Pía Sóc Trăng Đậu Xanh Sầu Riêng Trứng Tân Huê Viên 400G, Bánh Pía Tân Huê Viên 2 Sao 1 Trứng",94080,98000,3920,4
TIKI,bach-hoa-online,73373546,"Pate Gan Đặc Biệt Hạ Long - 100g",24000,24000,0,0
TIKI,bach-hoa-online,177479564,"Snack gạo lứt kẹp thơm GUfoods - Chua ngọt thơm ngon, Giàu chất xơ, Ăn vặt Healthy, Eat clean, Thuần chay",111000,239000,128000,54
TIKI,bach-hoa-online,67333093,"Yến Mạch Tươi Canada Nguyên Chất túi 1kg ( Nguyên Hạt )",55000,55000,0,0
TIKI,bach-hoa-online,155890433,"Hạt Điều Rang Muối Bình Phước Nguyên Hạt Size A Cồ - Hàng Loại 1 ( 01 kg-2 hộp)",269900,300000,30100,10
TIKI,bach-hoa-online,57806966,"Combo 5 gói Natural Gia Vị Nấu Cà Ri 10gr Dh Foods",29500,29500,0,0
TIKI,bach-hoa-online,72878779,"Bột ngũ cốc dinh dưỡng Goce - 180g (18 gói x 10g)",66000,110000,44000,40
TIKI,bach-hoa-online,34914469,"ĐẬU PHỘNG CỐT DỪA TÂN LỘC PHÁT COMBO 1KG - MỖI HŨ 500G",67500,75000,7500,10
TIKI,bach-hoa-online,57806741,"Combo 5 gói Natural Bột Gia Vị Ngũ Vị Hương 10gr Dh Foods",29600,29600,0,0
TIKI,bach-hoa-online,14968697,"Thùng 12 hộp Sữa tươi tiệt trùng ít béo Meadow Fresh 1L",350000,525240,175240,33
TIKI,bach-hoa-online,141808767,"Tỏi Bột Tự Nhiên Vipep Hũ Nhựa 70g",16000,16000,0,0
TIKI,bach-hoa-online,57828825,"Hạt Hạnh Nhân Sống DK Harvest Dùng làm Sữa Hạt",319000,319000,0,0
TIKI,bach-hoa-online,45211030,"500gr Trà long nhãn - Nhãn nhục sông mã",145000,145000,0,0
TIKI,bach-hoa-online,92710885,"Bộ 12 túi thức ăn mèo con Whiskas vị cá ngừ 80g",139500,150000,10500,7
TIKI,bach-hoa-online,92096095,"500G KHÔ HEO CHÁY TỎI LOẠI 1 TÂN LỘC PHÁT",67000,72000,5000,7
TIKI,bach-hoa-online,116273351,"Bún gạo lứt Cao Tuyền 500g, đặc sản Cao Bằng, thơm ngon, bổ dưỡng, tốt cho sức khỏe, làm từ 100% bột gạo lứt Huyết Rồng",26000,40000,14000,35
TIKI,bach-hoa-online,166497256,"Đặc Sản Kon Tum - Trái Khổ Qua Rừng Sấy Khô Thơm Ngon Hiệu Đặc Sản Và Dược Liệu Kon Tum (1Kg) - OCOP 3 Sao",320000,320000,0,0
TIKI,bach-hoa-online,35354610,"(COMBO 1KG) 2 HỘP HẠT ĐIỀU RANG MUỐI XẾP HOA ĐẸP HÀNG CHẤT LƯỢNG LOẠI 1",180000,190000,10000,5
TIKI,bach-hoa-online,2466655,"Muối tôm Tây Ninh 110g Dh Foods",21060,21060,0,0
TIKI,bach-hoa-online,153406924,"Đá Me Hạt Mềm Thanh Bình - Hộp 900g, tăng đề kháng, mát lạnh ngày hè, bổ sung Vitamin mùa dịch",61000,61000,0,0
TIKI,bach-hoa-online,55525135,"Mắm Cá Linh Sông Hương Foods Hũ 400g",81000,81000,0,0
TIKI,bach-hoa-online,107018234,"Kẹo sữa mềm Sumika 140 gram Bibica",15000,17500,2500,14
TIKI,bach-hoa-online,2472415,"Muối tôm Tây Ninh 60g Dh Foods",11900,11900,0,0
TIKI,bach-hoa-online,57303356,"Cà phê hạt 100% nguyên chất truyền thống số 3 Coffee Tree 1kg thơm ngon, đậm đà, gu mạnh",199000,459000,260000,57
TIKI,bach-hoa-online,127219275,"Đặc Sản Phan Thiết - Nước Mắm Chua Ngọt Cao Cấp Làng Chài Xưa, Nguyên Liệu Tươi, Thơm Ngon Đặc Biệt, Pha Sẵn Từ Chanh Tỏi Ớt Vị Đậm Đà Chai Thủy Tinh 300G",63000,90000,27000,30
TIKI,bach-hoa-online,117092876,"Nước tương Phú Sĩ 500ml",17700,38000,20300,53
TIKI,bach-hoa-online,57768021,"Trà cây xạ đen hòa bình - Gói 1kg",89000,89000,0,0
TIKI,bach-hoa-online,71936966,"Cà Phê Hữu Cơ Thải Độc Happy Life VN - Cà Phê Chuyên Dùng Cho Thải Độc Đại Tràng - Làm Enema  - Coffee Enema ( Túi 500Gr)",225000,250000,25000,10
TIKI,bach-hoa-online,153368584,"Da Cá Hoàng Kim - Da Cá Trứng Muối ABI SNACK",35000,35000,0,0
TIKI,bach-hoa-online,57657468,"Combo 2 gói Thức ăn cho mèo Minino Tuna Flavored 1.3kg/gói",159459,159459,0,0
TIKI,bach-hoa-online,116001998,"Đặc Sản Thái Nguyên - Trà Móc Câu Thái Nguyên 500Gram",120000,120000,0,0
TIKI,bach-hoa-online,140830825,"Trà Đen Phổ Sơn 500gr",80000,80000,0,0
TIKI,bach-hoa-online,270811530,"Vitamin tổng hợp cho bà bầu Prenatal Folic Acid+ DHA Nature Made giúp mẹ khỏe, thai nhi phát triển tốt (Mỹ) - OZ Slim Store",940000,1880000,940000,50
TIKI,bach-hoa-online,29090801,"Miso đỏ men gạo Koji Yamagen 500g",95000,95000,0,0
TIKI,bach-hoa-online,64021141,"1Kg Đậu Hà Lan Sấy Muối Thương Hiệu SK FOOD - 2 Hũ Pet",99000,99000,0,0
TIKI,bach-hoa-online,6956699,"Combo 2 gói Ngũ cốc hoa quả Calbee Furugura Nhật Bản (gói 800g x 2)",269000,269000,0,0
TIKI,bach-hoa-online,140229056,"Mì Đệ Nhất Thịt Bằm 83gr x 30 gói",249000,249000,0,0
TIKI,bach-hoa-online,58137457,"[Thùng 30 gói x 50gram] Cháo Tổ Yến Đậu Xanh Thịt Bằm - Yến Đại Phát , 4 gói gia vị, ăn liền, tiện lợi.",339000,339000,0,0
TIKI,bach-hoa-online,56965859,"Combo 6 hộp nước yến sào win'sNest nhân sâm (6 Lọ x 70 ml / Hộp) thích hợp cho người lớn và người bệnh trong quá trình hồi phục sức khỏe",763000,1675000,912000,54
TIKI,bach-hoa-online,107018189,"Bánh Lurich Crackers Rau Củ hộp giấy 180g - Bữa ăn phụ dinh dưỡng đầy năng lượng",21500,25600,4100,16
TIKI,bach-hoa-online,154228077,"Đường Biên Hòa Joy Stick 6g x 30 gói",26500,27000,500,2
TIKI,bach-hoa-online,145456923,"Thuốc xịt ve rận, bọ chét Vime Frondog cho chó mèo 250ml",99000,99000,0,0
TIKI,bach-hoa-online,127076507,"[Combo 2 Hũ] Thanh Gạo Lứt Ngũ Cốc Siêu Hạt Thơm Ngon SK FOOD - Mỗi Hũ 250g",150000,150000,0,0
TIKI,bach-hoa-online,181361299,"Combo 2 Hộp Cà Phê Sữa Đá Hòa Tan - Hộp 9 Gói - Trung Nguyên Legend - Ngọt, mùi nồng nàn, vị đậm",194040,215600,21560,10
TIKI,bach-hoa-online,58910120,"cafe LeeLong2 gu đậm (70 Robusta / 30 Arabica)",250000,250000,0,0
TIKI,bach-hoa-online,106540843,"Hạt quinoa (diêm mạch) 3 màu ăn kiêng GUfoods - Giảm cân, Eat clean, Giàu lợi ích sức khoẻ",78000,169000,91000,54
TIKI,bach-hoa-online,59300264,"Giảm Cân Ngũ Cốc Tăng Cơ Giàu Năng Lượng  Chocolate Đen - Super Power (Ohh - Granola) Tiêu Chuẩn FDA Hoa Kỳ, Hộp 250g",164000,164000,0,0
TIKI,bach-hoa-online,97358123,"Bột Kem Béo Thực Vật Frappe FR33 - LÚAVE - 1kg",125673,125673,0,0
TIKI,bach-hoa-online,55394120,"1KG - COMBO 2 BỊCH CƠM GẠO LỨT RONG BIỂN CHẤT LƯỢNG TÂN LỘC PHÁT",81081,90090,9009,10
TIKI,bach-hoa-online,154699183,"Trà gừng túi lọc L'angfarm, 25 tép, hộp, mẫu quấn dây kraft",45900,51000,5100,10
TIKI,bach-hoa-online,36772963,"Bánh Quy Bơ Danisa 200g (2 hộp)",138000,138000,0,0
TIKI,bach-hoa-online,183521310,"Vitamin cho chó mèo Borammy bổ sung dinh dưỡng cho thú cưng (180v)",69000,69000,0,0
TIKI,bach-hoa-online,629721,"Trà Chanh Mật Ong Hàn Quốc Korea Natural Food Honey Citron Tea (1Kg)",145000,145000,0,0
TIKI,bach-hoa-online,49011134,"Gia Vị Nấu Phở Minh Hà 100g",47800,47800,0,0
TIKI,bach-hoa-online,150850460,"[HCM][TẶNG KÈM TÚI QUÀ] Bánh quy bơ Danisa Size lớn Hộp 681g (date mới)(Bơ Vanilla)",209000,209000,0,0
TIKI,bach-hoa-online,2470763,"Muối tiêu 120gr Dh Foods ",22800,22800,0,0
TIKI,bach-hoa-online,161956958,"Nước mắm chay vương ngọc, đặc sản Tây Ninh, nước chấm từ quả thơm, đậu nành, không sử dụng phẩm màu thực phẩm",29000,50000,21000,42
TIKI,bach-hoa-online,170828216,"Kẹo chuối cuộn bánh tráng Thiện Mỹ -Túi 500g có gừng, đậu phộng, tắc, khóm ăn giòn thơm bánh tráng, dùng ngon hơn khi kết hợp với trà nóng",49000,49000,0,0
TIKI,bach-hoa-online,76040361,"Bột cần tây sấy lạnh nguyên chất Dalahouse 3g",25000,25000,0,0
TIKI,bach-hoa-online,119882260,"Thùng 30 gói mì gà sợi phở Gấu Đỏ 63g",120000,120000,0,0
TIKI,bach-hoa-online,52846332,"Trà Oolong Thuần đỏ Tâm Châu",185000,185000,0,0
TIKI,bach-hoa-online,102395696,"Nước Ép Berry Và Trái Cây Hỗn Hợp Malee 1L (Thái Lan)",76100,76100,0,0
TIKI,bach-hoa-online,57718579,"Bột dinh dưỡng Mộc Lan (hũ 500g)",111000,125000,14000,11
TIKI,bach-hoa-online,167646329,"WHISKAS Thức ăn cho mèo lớn dạng sốt vị cá ngừ và thịt gà 80g (12 gói)",141000,150000,9000,6
TIKI,bach-hoa-online,106381135,"Sữa Tươi Tiệt Trùng Giàu Canxi ít béo nhập khẩu Úc MEADOW FRESH 1L",60000,60000,0,0
TIKI,bach-hoa-online,273977859,"Si Rô CARISA 680g - 13 Vị Trái Cây",30000,30000,0,0
TIKI,bach-hoa-online,270645469,"Sữa dành cho người tiểu đường Glucerna Vanilla Abbott Úc Bổ sung đầy đủ dinh dưỡng và cân bằng đường huyết - QuaTangMe Extaste",1130000,2260000,1130000,50
TIKI,bach-hoa-online,125858372,"Xốt Bò Kho 90g",10500,10500,0,0
TIKI,bach-hoa-online,185948548,"Viên nhai bổ sung dinh dưỡng cho chó mèo - Bổ sung canxi, khoáng, đẹp lông da, vitamin, men tiêu hóa, cơ xương khớp",1300,1300,0,0
TIKI,bach-hoa-online,84866822,"Mắm tép Lê Gia chai 110g",10000,13000,3000,23
TIKI,bach-hoa-online,57149781,"Cốt Me Mikiri 250g (6 Hủ)",150000,150000,0,0
TIKI,bach-hoa-online,152700717,"Túi Bơ Bán Lẻ Không Kèm Bánh Tráng - Abi Snack Bánh Tráng Abi",10000,10000,0,0
TIKI,bach-hoa-online,167907988,"Gạo lứt rong biển / 300G / Cơm sấy rong biển/Ăn kiêng,ăn chay giảm cân hiệu quả/ Đồ ăn vặt Vườn Xanh Sạch",50000,56000,6000,11
TIKI,bach-hoa-online,92523373,"Thức ăn chó Pedigree vị thịt bò & rau củ 500g",33800,33800,0,0
TIKI,bach-hoa-online,13996007,"Nước mắm Phú Quốc Thanh Hà 35N - 520ml",99300,99300,0,0
TIKI,bach-hoa-online,10650652,"Đồ Ăn Cho Mèo Trưởng Thành Me-O Vị Cá Thu",435000,436999,1999,0
TIKI,bach-hoa-online,185964614,"Viên SPIRIT bổ sung dinh dưỡng canxi, vitamin, khoáng, dưỡng lông cho thú cưng - Chăm sóc sức khỏe cho chó mèo (160g)",78000,78000,0,0
TIKI,bach-hoa-online,116465905,"Nho khô Sunview Raisins Mỹ không hạt 3 màu Giàu Vitamin khoáng chất, Món ăn vặt tốt cho tim mạch (425g/hộp) - Massel Official",197000,394000,197000,50
TIKI,bach-hoa-online,161386787,"Thùng 24 chai nước gạo rang TH True Rice 300ml (300ml x 24)",333000,353445,20445,6
TIKI,bach-hoa-online,161493580,"Thùng 48 chai sữa chua uống tiệt trùng hương việt quất tự nhiên TH True Yogurt 180ml (180ml x 48)",363000,385223,22223,6
TIKI,bach-hoa-online,159095758,"Đạm thực vật và Superfoods hữu cơ Orgain hương Socola và Vani Organic Protein & Superfoods Orgain - Chocolate & Vanilla",920000,1162000,242000,21
TIKI,bach-hoa-online,8157209,"Bánh Chocopie Hộp 20 Cái",93200,100000,6800,7
TIKI,bach-hoa-online,142629191,"Ngũ Cốc Hạt Min Min Ăn Liền GRANOLA _ Ngũ Cốc Ăn Liền Min Min Vị Truyền Thống _ ngũ cốc mix hoa quả xấy(1 hộp 500Gr)",250000,250000,0,0
TIKI,bach-hoa-online,179926363,"Nước yến thật BRAND'S Đường Phèn",454000,454000,0,0
TIKI,bach-hoa-online,72206914,"1kg Hạt Dẻ Cười Nhập Khẩu Cao Cấp Thương Hiệu SK FOOD",339000,339000,0,0
TIKI,bach-hoa-online,1716065,"Sữa Tắm Cho Chó Lông Nâu Đỏ SOS (530ml)",76999,79999,3000,4
TIKI,bach-hoa-online,37969824,"Bột rau má nguyên chất Goce - 72g (24 gói x 3g)",90000,150000,60000,40
TIKI,bach-hoa-online,39088200," Hạt Mix Nuts 4 Loại (Dẻ Cười + Hạnh Nhân + Hạt Điều + Óc Chó Vàng + Macca )",155000,179000,24000,13
TIKI,bach-hoa-online,53256231,"Ngũ cốc lợi sữa Lạc Lạc (Hộp 30 gói)",269000,269000,0,0
TIKI,bach-hoa-online,57656396,"Thức ăn cho mèo con & mèo trưởng thành vị cá ngừ Minino Tuna Flavored 1,3kg",78791,78791,0,0
TIKI,bach-hoa-online,10677573,"Dầu hạt cải nguyên chất nội địa Nhật Bản ( Chai 1L)",89000,89000,0,0
TIKI,bach-hoa-online,181000389,"Bánh pía 4 trứng đậu xanh sầu riêng Tân Huê Viên 500g",121500,135000,13500,10
TIKI,bach-hoa-online,3812949,"Cà Phê Hòa Tan Tchibo Exclusive T100E (100g)",172050,185000,12950,7
TIKI,bach-hoa-online,54479685,"Quả la hán - La hán quả cao cấp không vỡ",39000,39000,0,0
TIKI,bach-hoa-online,67138521,"Đặc Sản Phan Thiết - NướC MắM Nhỉ Làng Chài Xưa Truyền Thống Nhãn Đỏ Chai Thủy Tinh 500Ml Cốt Nhỉ Đặc Biệt Vị Đậm Đà Gu Ông Bà Xưa Từ 100% Cá Cơm Tươi Không Chất Bảo Quản",75000,120000,45000,38
TIKI,bach-hoa-online,16551769,"Cà Phê Hạt Mộc Trung Nguyên Success 2 Túi 1Kg",510000,510000,0,0
TIKI,bach-hoa-online,13823894,"Combo 2 chai dầu Ăn Hoa Cải Ajinomoto (1000g) - Bổ Sung Omega 3 & 6 Nhật Bản",189000,189000,0,0
TIKI,bach-hoa-online,125785406,"Bio Rantel xổ giun sán chó mèo (hộp 10 viên)",54000,54000,0,0
TIKI,bach-hoa-online,141807969,"Hành Bột Tự Nhiên Vipep Hũ Nhựa 70g",20000,20000,0,0
TIKI,bach-hoa-online,55525085,"Mắm Tôm Chua Sông Hương Foods Hũ 430g",150000,150000,0,0
TIKI,bach-hoa-online,97429427,"Combo 3 gói Gia Vị Hủ Tiếu Barona 110g tươi ngon chuẩn vị không cần nêm nếm",49200,49200,0,0
TIKI,bach-hoa-online,175976666,"Hắc xì dầu Lee Kum Kee Premium Dark Soy Sauce (500ml/chai) loại đặc biệt đậm đặc",64000,64000,0,0
TIKI,bach-hoa-online,77659664,"Socola Đen Xoài Thanh Lớn 80 gram, Nguyên Chất, Đắng Vừa | Dark Chocolate Mango Alluvia",115000,115000,0,0
TIKI,bach-hoa-online,72630630,"Hạt diêm mạch 3 màu (đỏ + trắng + đen) DKHARVEST Mixed Quinoa - hàng nhập khẩu Úc",99000,119000,20000,17
TIKI,bach-hoa-online,19699204,"Nước mắm Khải Hoàn Phú Quốc 40 độ đạm 520ml thùng 6 chai",505000,505000,0,0
TIKI,bach-hoa-online,99077987,"Combo 5 gói Mì Yeul Cay Ottogi 120G",70500,75000,4500,6
TIKI,bach-hoa-online,109393115,"Đặc Sản Phan Thiết - Nước Mắm Chay 3 Trong 1 Làng Chài Xưa (01 Chai) 525Ml Trái Thơm Nấm Ngọt Đậu Nành 300 Năm Truyền Thống",49000,90000,41000,46
TIKI,bach-hoa-online,55674931,"1KG KHÔ GÀ BƠ TỎI ĐẶC BIỆT THƯƠNG HIỆU SK FOOD",145000,145000,0,0
TIKI,bach-hoa-online,1701839,"Xịt Xua Đuổi Fay Repell (200ml)",58000,58000,0,0
TIKI,bach-hoa-online,52144915,"Đường Mật Hoa Dừa Hữu Cơ Organic Coco Sugar",105000,135000,30000,22
TIKI,bach-hoa-online,58909985,"1kg cafe LeeLong3 hậu vị tròn đầy (50 Robusta / 50 Arabica)",260000,260000,0,0
TIKI,bach-hoa-online,53982128,"COMBO 4 HŨ RONG BIỂN CHÁY TỎI CAO CẤP TÂN LỘC PHÁT",87000,99000,12000,12
TIKI,bach-hoa-online,79112498,"Nước Mắm Tĩn Cá Cơm Vàng Ruột Đỏ Độ Đạm 60N Tự Nhiên Chai Thuỷ Tinh 250ml Nước Mắm Rin Nguyên Chất Truyền Thống Sạch Nước Mắm Nhỉ Từ Thùng Lều Gỗ Cốt Nhĩ Đặc Biệt Cá Cơm Vàng Ruột Đỏ Muối Tinh Khiết, Sánh Đặc Thịt Cá, Không Chất Bảo Quản",118000,180000,62000,34
TIKI,bach-hoa-online,79914918,"Combo 5+1 Bánh sữa Nguyên chất Long Thành Premium",250000,250000,0,0
TIKI,bach-hoa-online,67827561,"Sữa bột Wincofood Goldcare Gain: thích hợp cho mọi đối tượng và trẻ từ 1 tuổi trở lên giúp tăng cân và tăng cường thể lực",239850,369000,129150,35
TIKI,bach-hoa-online,7663699,"Nước Mắm Cá Cơm Hạnh Phúc 60 Độ Đạm (500ml) - [8935015716702]",180000,180000,0,0
TIKI,bach-hoa-online,1717785,"Thức Ăn Cho Mèo Con Royal Canin Kitten (2kg)",509999,509999,0,0
TIKI,bach-hoa-online,72679552,"Combo 3 Bánh Tráng Ớt Tây Ninh Tinh Nguyên (200g/gói)",45000,57000,12000,21
TIKI,bach-hoa-online,37549095,"TRÀ GẠO LỨT ĐẬU ĐEN RANG (800GR)",110000,110000,0,0
TIKI,bach-hoa-online,39235187,"COMBO 24 hộp SỮA BỘT PHA SẴN VINAMILK YOKO GOLD Hộp 110ml",268000,268000,0,0
TIKI,bach-hoa-online,49472732,"Nhân Hạt Điều Rang DK Harvest - 250g, 500g",110000,115000,5000,4
TIKI,bach-hoa-online,106381044,"Dầu Ăn Simply Đậu Nành 1L",60000,61000,1000,2
TIKI,bach-hoa-online,10409780,"Cà Phê Rang Xay Culi Highlands Coffee (200g)",90000,110000,20000,18
TIKI,bach-hoa-online,97857683,"Combo 3 Natural Gia Vị Tần Hầm Lẩu (Gia Vị tiềm) Dh Foods",95800,95800,0,0
TIKI,bach-hoa-online,142142607,"SỮA HẠT THỰC DƯỠNG SOYNA - SỮA SOYNA TỪ 10 LOẠI HẠT - BỔ SUNG CANXI - PROTEIN CHO NGƯỜI ĂN CHAY, NGƯỜI BỊ TÁI THÁO ĐƯỜNG, CHO MẸ BẦU, CHO TRẺ NHỎ TỪ 3 TUỔI. SỮA CANXI THỰC VẬT DỄ TIÊU HÓA, DỄ HẤP THỤ",275000,275000,0,0
TIKI,bach-hoa-online,71896076,"Bột Phô mai lắc Verozyme Malaysia - Cheese Taste Blaster túi 315G Nhập khẩu chính hãng Malaysia",128000,175000,47000,27
TIKI,bach-hoa-online,191002782,"Combo 4 hộp bánh Custas Orion vị kem trứng (282g x 4 hộp)",300000,300000,0,0
TIKI,bach-hoa-online,14790213,"Đậu gà trắng Chickpeas",24000,24000,0,0
TIKI,bach-hoa-online,49375139,"100gr Trà nụ hoa tam thất - Cao Cấp",99000,99000,0,0
TIKI,bach-hoa-online,62907585,"Combo 2 Hộp Đường Ăn Kiêng Tropicana Slim No Calorie Sweetener Diabetics (50 x 2g)",147000,147000,0,0
TIKI,bach-hoa-online,169652399,"Chanh muối trái Thanh Bình 900gr",37000,37000,0,0
TIKI,bach-hoa-online,196941649,"Granola thuần chay nướng mật dừa nước GUfoods (0% yến mạch; Mix siêu hạt mắc ca, nam việt quất, hạnh nhân, hạt điều, nho khô) - Dinh dưỡng, Tiện lợi, Thơm ngon, Giàu lợi ích sức khỏe",213000,459000,246000,54
TIKI,bach-hoa-online,16837558,"THÙNG 72 LỌ YẾN SÀO WIN'SNEST TỔ YẾN CHƯNG SẴN KHÔNG ĐƯỜNG 20% (70ML/LỌ)",2200650,4315000,2114350,49
TIKI,bach-hoa-online,5503699,"Hạt Nêm ngon ngọt tự nhiên, an toàn cho bé và gia đình Youki Nhật Bản 500g",229900,229900,0,0
TIKI,bach-hoa-online,53706414,"Hạt ngũ hoa",55000,55000,0,0
TIKI,bach-hoa-online,99078181,"Rong biển sấy mè rang vị truyền thống Ottogi 30g",34592,36800,2208,6
TIKI,bach-hoa-online,181978842,"Đặc Sản Sóc Trăng - Bánh Hạnh Nhân Hộp Giấy 300G, Bánh Hạnh Nhân Tân Huê Viên Sóc Trăng, Bánh Bột Đậu, BáNh KẹO ĂN VặT Sài Gòn",60760,62000,1240,2
TIKI,bach-hoa-online,73559847,"Trà Xanh Cầu Đất - Túi 110Gr",67000,70000,3000,4
TIKI,bach-hoa-online,73330911,"Da cá trứng muối 105g IRVINS - Small Salted Egg Fish Skin",201000,201000,0,0
TIKI,bach-hoa-online,155255740,"Tương ớt gói Cholimex 10g siêu tiện lợi (01 túi gồm 50 gói)",31000,31000,0,0
TIKI,bach-hoa-online,94426094,"Trà Xanh Túi Lọc Tân Cương Xanh - Trà túi lọc thượng hạng, dùng pha chế, tiện lợi dùng văn phòng, đi công tác",52500,52500,0,0
TIKI,bach-hoa-online,72506287,"Muối Ớt Sấy 110g Dh Foods",19980,19980,0,0
TIKI,bach-hoa-online,14977762,"Đậu hà lan xanh nguyên hạt Whole Green Peas",17000,17000,0,0
TIKI,bach-hoa-online,29263840,"Trân châu trắng Gaban 100g",135000,135000,0,0
TIKI,bach-hoa-online,178256483,"Muối Hồng Himalaya Xay Nhuyễn Vipep Hũ Nhựa 200g",25000,25000,0,0
TIKI,bach-hoa-online,140579038,"Mì Hảo Hảo Tôm Xào Chua Ngọt thùng 30 gói",145000,145000,0,0
TIKI,bach-hoa-online,20761487,"Socola Đen Vỏ Cam Thanh Lớn 80 gram, Nguyên Chất, Đắng Vừa | Dark Chocolate Orange Peel Alluvia",115000,115000,0,0
TIKI,bach-hoa-online,172657045,"Muối ớt Natas Hũ 90g-Muối Đa Năng",17000,17000,0,0
TIKI,bach-hoa-online,48717337,"Bột trứng muối Gumi Egg 100g",38000,38000,0,0
TIKI,bach-hoa-online,275466781,"Bắp Mỹ Rang Bơ, Bắp Nỗ Rạp Chiếu Phim TETE 1kg (Nổ Hình Nấm)  - 1kg",73000,73000,0,0
TIKI,bach-hoa-online,12414460,"Bịch Bông Atisô Sấy Khô L'angfarm (225g)",289000,294000,5000,2
TIKI,bach-hoa-online,72879677,"TINH BỘT BIẾN TÍNH DISTARCH PHOSPHATE (INS1412) I Gói 1kg",20000,20000,0,0
TIKI,bach-hoa-online,4681147,"Hộp Bột ngũ cốc dinh dưỡng cao cấp 22 Complete Nutrimix - Wheat Grass (Mầm lúa mì) - 750g",496000,496000,0,0
TIKI,bach-hoa-online,198197816,"Dâu tằm sấy dẻo ít đường Kentary - sấy nguyên vị chua chua ngọt ngọt - đồ ăn vặt healthy",121000,125000,4000,3
TIKI,bach-hoa-online,26027110,"Hạt Chia Shots hữu cơ Smile Nuts gói nhỏ tiện dụng (8g x 10 gói) - Organic Chia Seed Shots (8g x 10 bag) ",39000,47000,8000,17
TIKI,bach-hoa-online,192794665,"Combo 2 chai dầu ăn dinh dưỡng Ranee Cá Hồi 950ml (950ml/chai x 2 chai)",185900,185900,0,0
TIKI,bach-hoa-online,154698868,"Kẹo hương dâu tây L'angfarm, 350g, bịch, mẫu kraft 1 mặt trong",32400,36000,3600,10
TIKI,bach-hoa-online,179575858,"SHIN Cà Phê - Cà phê túi nhúng tiện lợi hộp 10 gói",70000,70000,0,0
TIKI,bach-hoa-online,136603719,"Natural Tiêu sọ xay Phú Quốc 80gr Dh Foods",90600,90600,0,0
TIKI,bach-hoa-online,101585635,"Tấm Thơm ( Tấm Gạo ST25 ) Ông Thọ 1Kg - Cơm mềm dẻo, nấu cơm ăn dặm cho bé, nấu cháo dinh dưỡng cho người già và trẻ nhỏ, cơm tấm gia đình",25000,25000,0,0
TIKI,bach-hoa-online,42989489,"Bột Chanh Gia Vị 400g (Chavi - Bao bì mới)",106000,106000,0,0
TIKI,bach-hoa-online,6956839,"Hạt Nêm Youki Nhật Bản 500g",209000,209000,0,0
TIKI,bach-hoa-online,20450548,"Socola Đen Dừa Nguyên Chất, Đắng Vừa | Dark Chocolate Coconut Alluvia",115000,115000,0,0
TIKI,bach-hoa-online,73622134,"Thịt Bò 2 Lát Hạ Long - 150g",25500,25500,0,0
TIKI,bach-hoa-online,187234731,"Đặc Sản Phan Thiết - [Lốc 10 Chai] Nước Mắm Tôm Biển Làng Chài Xưa Hồng Ngọc Đại Dương 125Ml/Chai 300 Năm Truyền Thống",87000,290000,203000,70
TIKI,bach-hoa-online,10229393,"Gạo Hữu Cơ Hoa Nắng - Vàng Lúa Chín 2kg",157460,157460,0,0
TIKI,bach-hoa-online,89763933,"Combo 2 Bịch Cà Phê Sữa NESCAFÉ Cà Phê Sữa Đá (Bịch 25 Gói x 24g)",228000,251000,23000,9
TIKI,bach-hoa-online,53306672,"Trà Kỷ Tử Sấy Khô Mộc Sắc 100g",60000,65000,5000,8
TIKI,bach-hoa-online,163716525,"Combo 2 hộp Trà hoa cúc gạo lứt Quê Việt + bình đựng nước thanh nhiệt, ngủ ngon, điều hoà huyết áp (2 hộp x 600gr/hộp)",327000,690000,363000,53
TIKI,bach-hoa-online,181000491,"Đặc Sản Sóc Trăng - Bánh Pía Kim Sa Tân Huê Viên Đậu Xanh Tan Chảy 480G, Bánh Pía Sóc Trăng Tan Chảy, Vị Bán Chạy",124460,127000,2540,2
TIKI,bach-hoa-online,110250734,"Set Chè Dưỡng Nhan Giải Nhiệt 12 Vị Thơm Ngon Bổ Dưỡng DTFood",49000,50000,1000,2
TIKI,bach-hoa-online,75621224,"NHO VÀNG SẤY KHÔ TÂN LỘC PHÁT COMBO 2 HŨ - MỖI HŨ 500G",77000,79500,2500,3
TIKI,bach-hoa-online,125918663,"Tương ớt Cholimex chai pet 270g",12400,12400,0,0
TIKI,bach-hoa-online,70666592,"Miso hữu cơ Marukome 375g",139000,139000,0,0
TIKI,bach-hoa-online,53315759,"Natural Điều đỏ bột 50gr - Bột điều đỏ nguyên chất 100%",18600,18600,0,0
TIKI,bach-hoa-online,20342342,"Cà phê Chế phin 4 Trung Nguyên 500gram",220000,220000,0,0
TIKI,bach-hoa-online,55525430,"Gạo Lứt Huyết Rồng (Gạo lứt đỏ) - Dùng thích hợp cho người tiểu đường tim mạch huyết áp - Trồng ở ruộng bậc thang ở núi rừng sơn la - Chăm bón tự nhiên",31000,31000,0,0
TIKI,bach-hoa-online,179794075,"Combo 3 gói Cà Phê Rang Xay Truyền Thống Highlands Coffee (200g)",196000,255000,59000,23
TIKI,bach-hoa-online,173299475,"Chai Xịt Ve Rận Chó Mèo Vime-Frondog 250ml",120000,120000,0,0
TIKI,bach-hoa-online,140579026,"Mì Ly Handy Chay Hảo Hảo Lẩu Nấm Thập cẩm (Thùng 24 ly × 66gr)",255000,255000,0,0
TIKI,bach-hoa-online,68115707,"(COMBO 2 HŨ) GÀ CHÀ BÔNG TÂN LỘC PHÁT (1KG) - DÙNG ĂN KÈM",117000,129000,12000,9
TIKI,bach-hoa-online,106521724,"Cà phê hòa tan Nescafé Latte sữa hạt vị hạnh nhân (Hộp 10 gói x 24g)",67900,80000,12100,15
TIKI,bach-hoa-online,7993014,"Đặc sản Tiền Giang - Gạo hương lài sữa Khổng Tước Nguyên (5Kg) - OCOP 4 SAO",125000,129000,4000,3
TIKI,bach-hoa-online,93318327,"Nước mắm nhĩ nguyên chất truyền thống Phú quốc Red Boat 40N",260000,260000,0,0
TIKI,bach-hoa-online,181114319,"Trà Sen Dalatfarm - Túi 110Gr",67000,70000,3000,4
TIKI,bach-hoa-online,175687051,"Combo 2 gói Cà Phê Rang Xay Truyền Thống Highlands Coffee (200g)",118000,170000,52000,31
TIKI,bach-hoa-online,191650671,"Hạt Điều Rang Củi Oh Smilenuts, Hạt Điều Nguyên Vị - Điều rang muối Bình Phước nguyên hạt còn vỏ lụa - Hạt Dinh Dưỡng Hũ 500g - Hạt điều Bình Phước loại 1",169000,224000,55000,25
TIKI,bach-hoa-online,145461787,"Combo 2 Gói Sữa Béo Nga New Milky Extra 1 Kg Hỗ Trợ Tăng Cân Dùng Được Cho Trẻ Từ Trên 3 Tuổi Và Người Gầy Ốm Hoặc Dùng Pha Trà Sữa, Cà Phê, Làm Bánh",196000,196000,0,0
TIKI,bach-hoa-online,34362534,"500gram Đậu Phộng tổi ớt Lac Rang Tỏi Ớt Hương Vị Bàn Nhậu Tete",69000,69000,0,0
TIKI,bach-hoa-online,1065004,"Cà Phê Cappuccino Hương Mocha Trung Nguyên (Hộp 12 Gói)",75000,75000,0,0
TIKI,bach-hoa-online,140843423,"Dầu Tắm Trị Bọ Chét, Ve, Ghẻ, Rận Chó Mèo Hanvet Hantox 200ml",29999,29999,0,0
TIKI,bach-hoa-online,179921782,"Nước yến thật BRAND'S Không Đường",439000,439000,0,0
TIKI,bach-hoa-online,154231129,"Đường Túi Biên Hòa Pure 500g",17380,17380,0,0
TIKI,bach-hoa-online,59178463,"Trung Nguyên Legend - Cà phê rang xay Sáng tạo 2 - Bịch 340gr",86000,107953,21953,20
TIKI,bach-hoa-online,168561896,"Cà phê Trần Quang NGON cafe sữa uống liền bịch 24 gói",58000,58000,0,0
TIKI,bach-hoa-online,66948978,"Đặc Sản Phan Thiết - NướC MắM Nhỉ Làng Chài Xưa Truyền Thống Nhãn Đỏ Thùng 6 Chai Thủy Tinh 500Ml Cốt Nhỉ Đặc Biệt Vị Đậm Đà Gu Ông Bà Xưa Nước Mắm Nguyên Chất Sạch Nước Mắm Nhĩ Từ Thùng Lều Gỗ 100% Cá Cơm Tươi Muối Tinh Khiết Không Chất Bảo Quản",410000,590000,180000,31
TIKI,bach-hoa-online,181000438,"Đặc Sản Sóc Trăng - Bánh Pía Chay Đậu Xanh Sầu Riêng Tân Huê Viên Lớn 500G, Bánh Pía Sóc Trăng Ăn Chay Không Trứng Muối",96600,105000,8400,8
TIKI,bach-hoa-online,184429270,"Bột gạo lứt nguyên chất Goce - 180g (18 gói x 10g)",72000,120000,48000,40
TIKI,bach-hoa-online,124084318,"Dầu ăn thượng hạng Ranee Golden 1 lít",69000,69000,0,0
TIKI,bach-hoa-online,189604485,"Cà phê phin giấy Robusta Lâm Đồng DalatFarm - Hộp 10 túi x 10 g",105000,110000,5000,5
TIKI,bach-hoa-online,46221303,"Trái cây sấy khô thập cẩm Huynh Đệ Tề Hùng 1kg ( 2 túi 500g)",126420,129000,2580,2
TIKI,bach-hoa-online,1820321,"Bột ngũ cốc dinh dưỡng Calsome hương Sô cô la",63000,70000,7000,10
TIKI,bach-hoa-online,55506812,"1Kg Đậu Hà Lan Sấy Muối Giòn Ngon Thương Hiệu SK FOOD",99000,99000,0,0
TIKI,bach-hoa-online,165947055,"Hạnh Nhân Mỹ Tách Vỏ Pams, Rang Nguyên Vị, Ăn Kiêng Giảm Cân, Ngũ Cốc Dinh Dưỡng Bà Bầu",135000,225000,90000,40
TIKI,bach-hoa-online,51860168,"Đặc sản An Giang - Gạo Hạt Ngọc Trời Thiên Long Túi 5Kg - Gạo thơm đặc sản - OCOP 4 Sao",125000,125000,0,0
TIKI,bach-hoa-online,181134349,"Cà Phê Robusta Lâm Đồng Rang Mộc Nguyên Chất- Hộp 250Gr (Dạng Bột)",120000,130000,10000,8
TIKI,bach-hoa-online,115250922,"Bộ 6 túi thức ăn cho chó lớn dạng sốt Pedigree vị gà 130g",107160,114000,6840,6
TIKI,bach-hoa-online,176491668,"Combo 2 chai dầu ăn Ranee Golden 2 lít (2 lít/chai x 2 chai)",270000,270000,0,0
TIKI,bach-hoa-online,146292090,"Ngũ cốc hạt ăn liền Granola Min Min, ngũ cốc dinh dưỡng dạng hạt ăn liền (hộp 500g)",190000,190000,0,0
TIKI,bach-hoa-online,70092877,"Hạt Điều Rang Muối Loại Vỡ Thương Hiệu SK FOOD - Combo 1Kg 2 Hũ",129000,129000,0,0
TIKI,bach-hoa-online,599733,"Trà Sữa Vị Trà Xanh Aik Cheong Matcha Café Art (12 Gói x 25g)",119000,119000,0,0
TIKI,bach-hoa-online,57893764,"Yến Mạch Cán Mỏng DK Harvest Nhập Khẩu Úc - 2kg",99000,119000,20000,17
TIKI,bach-hoa-online,3747989,"Đặc Sản Phan Thiết - Nước Mắm Tĩn Cá Cơm Than Nhãn Xưa 41N ( Tĩn Gốm 500Ml) Sánh Đặc Thịt Cá, Không Chất Bảo Quản",275000,320000,45000,14
TIKI,bach-hoa-online,21477025,"Bánh Mochi Nhân Khoai Môn Japanese Style Taro Mochi 210g",62000,62000,0,0
TIKI,bach-hoa-online,189586825,"Cà phê phin giấy Arabica Cầu Đất DalatFarm - Hộp 10 túi x 10 g",135000,150000,15000,10
TIKI,bach-hoa-online,44962467,"BỘT NGŨ CỐC 5 THỨ ĐẬU KHÔNG ĐƯỜNG VITAPRO (350 gr)",46000,46000,0,0
TIKI,bach-hoa-online,76747171,"Trà vằng túi lọc lợi sữa - Giảm mỡ bụng Wonmom",69000,69000,0,0
TIKI,bach-hoa-online,57524251,"Cà phê nguyên chất Arabica Cầu Đất, cafe mộc rang xay Beemo 500g - Đắng ít, chua thanh, thơm, hậu vị ngọt",159000,210000,51000,24
TIKI,bach-hoa-online,1717775,"Thức Ăn Cho Mèo Royal Canin Indoor 27 (1kg Chia)",235000,238999,3999,2
TIKI,bach-hoa-online,184432853,"Bột cải xoăn Kale nguyên chất Goce - 60g (20 gói x 3g)",132000,220000,88000,40
TIKI,bach-hoa-online,97377864,"Combo 3 gói Gia Vị Hoàn Chỉnh Barona - Bún Bò Huế 80g",47900,54000,6100,11
TIKI,bach-hoa-online,181978846,"Đặc Sản Sóc Trăng - Bánh Hạnh Nhân Trứng Muối 300G, Bánh Hạnh Nhân Tân Huê Viên Sóc Trăng, Bánh Bột Đậu Trứng Muối, Bánh Kẹo Ăn Vặt",67620,69000,1380,2
TIKI,bach-hoa-online,68141542,"HẠT ĐIỀU VỎ LỤA RANG MUỐI CAO CẤP THƯƠNG HIỆU SK FOOD - HỘP 500G",99000,99000,0,0
TIKI,bach-hoa-online,92710926,"Bộ 12 túi thức ăn cho mèo Whiskas vị cá thu 80g",141000,150000,9000,6
TIKI,bach-hoa-online,270844874,"Sữa dành cho người tiểu đường Entrust Milk Bổ sung đầy đủ dinh dưỡng, cân bằng đường huyết, phòng loãng xương - QuaTangMe Extaste",540000,1080000,540000,50
TIKI,bach-hoa-online,84795560,"Hạt Dinh Dưỡng Hằng Ngày LAFOOCO 175g Daily Nuts",72800,104000,31200,30
TIKI,bach-hoa-online,51654679,"Hạt điều rang muối nhân trắng bể nửa sviet 500g",96000,96000,0,0
TIKI,bach-hoa-online,180390962,"Kẹo Gum không đường Lotte Xylitol - Hương Blueberry Mint 130,5 g",77000,77000,0,0
TIKI,bach-hoa-online,138811552,"Bột củ dền Dalahouse Hộp 60gr (Mẫu mới gồm 20 tuýp tiện dụng) - Nguyên chất sấy lạnh - Organic giúp bổ máu - Đạt tiêu chuẩn Châu Âu",90000,100000,10000,10
TIKI,bach-hoa-online,85557163,"Combo 2 Lon Sữa Đặc Có Đường Creamer Premium Alphana nhập khẩu Malaysia Lon 500g Giàu Protein Vitamin A D3 B1 - Không Cholesterol - Nắp Khui Tiện Dụng",78000,78000,0,0
TIKI,bach-hoa-online,10230551,"Gạo Hữu Cơ Hoa Nắng - Gạo Lứt 2kg",158000,158000,0,0
TIKI,bach-hoa-online,50875434,"Natural Hạt điều đỏ 50g Dh Foods - Nguyên chất 100%",16000,16000,0,0
TIKI,bach-hoa-online,73667907,"Nhân Hạt Bí Xanh Smile Nuts (265g - 500g) | Nhân bí xanh đã nướng nguyên vị, hàng nhập khẩu 100",88000,108000,20000,19
TIKI,bach-hoa-online,68446800,"Đậu đen xanh lòng Rang sẵn - cỏ ngọt - hà thủ ô ( MS) -1kg",175000,200000,25000,13
TIKI,bach-hoa-online,105551873,"Rong biển nấu canh Hàn Quốc 25G & 50G",42000,42000,0,0
TIKI,bach-hoa-online,127219731,"Đặc Sản Phan Thiết - Nước Mắm Gừng Pha Sẵn Cao Cấp Làng Chài Xưa, Nguyên Liệu Tươi, Thơm Ngon Đặc Biệt Từ Gừng, Tỏi, Ớt Tươi, Chai Thủy Tinh 300G",63000,90000,27000,30
TIKI,bach-hoa-online,189234686,"Thức ăn cho mèo / Pate NEKKO Kitten dành cho Mèo con từ 1-12 tháng tuổi - gói 70g",13500,20000,6500,33
TIKI,bach-hoa-online,20282664,"Combo 2 Lon Sữa Đặc Có Đường Premium Alphana nhập khẩu Malaysia Mỗi Lon 1kg Không Cholesterol thành phần đạm cao 2.3%",138000,138000,0,0
TIKI,bach-hoa-online,57707845,"1 HỘP NƯỚC DỪA SEN VICO FRESH 330ML",11000,20000,9000,45
TIKI,bach-hoa-online,100899674,"Rong nho biển GREEN FOOD - Sea grapes - Giàu vitamin, khoáng chất và các axit amin (Hộp 200g gồm 10 gói 20G)",185000,185000,0,0
TIKI,bach-hoa-online,187187774,"Đặc Sản Phan Thiết - Muối Chanh Ớt Xiêm Xanh Cao Cấp Làng Chài Xưa, Nguyên Liệu Tươi, Thơm Ngon Đặc Biệt, Chai Thủy Tinh 300Gr",63000,90000,27000,30
TIKI,bach-hoa-online,125858376,"Sa tế tôm cholimex 450g",37000,37000,0,0
TIKI,bach-hoa-online,136061178,"SÂM BỔ KIỆN chính hãng an toàn hiệu quả của cty Thảo Mộc nam organic",289000,289000,0,0
TIKI,bach-hoa-online,6058837,"Combo Trà Chanh mật ong và Trà Gừng mật ong Hàn Quốc",346999,346999,0,0
TIKI,bach-hoa-online,138460477,"Sữa tắm SOS 530ml cho chó mèo",76999,79999,3000,4
TIKI,bach-hoa-online,484446,"Bánh Xương Chăm Sóc Răng Dành Cho Chó Nhỏ Pedigree-56g",32900,33000,100,0
TIKI,bach-hoa-online,181000452,"Đặc Sản Sóc Trăng - Bánh Pía Dừa Sầu Riêng Tân Huê Viên, Bánh Pía Mini Gói 12 Cái 480G, Bánh Pía Chay Đặc Sản Sóc Trăng",109250,115000,5750,5
TIKI,bach-hoa-online,92523371,"Thức ăn chó Pedigree vị thịt bò & rau củ túi 3kg",220000,220000,0,0
TIKI,bach-hoa-online,169445201,"Combo Mix 5 Vị Pate NEKKO Thức Ăn Cho Mèo Dạng Nước Sốt (Gravy) 70g x 5 gói - Yuni Pet Shop",100000,100000,0,0
TIKI,bach-hoa-online,72507692,"Natural Muối Himalaya Tiêu Chín Phú Quốc Lá Chanh - kèm cối xay gia vị tiện lợi",59100,59100,0,0
TIKI,bach-hoa-online,29253124,"Gia vị rắc cơm thịt bò Sukiyaki Marumiya 34g",49000,49000,0,0
TIKI,bach-hoa-online,2385955,"Muối Tôm Tây Ninh Tinh Nguyên (250g)",29900,35000,5100,15
TIKI,bach-hoa-online,51435969,"Ống uống Atiso Ladophar 6 hộp x 10 ống Giúp mát gan, lợi mật, hỗ trợ tăng cường chức năng gan, giúp cải thiện quá trình tiêu hóa tặng 1 túi trà",210000,210000,0,0
TIKI,bach-hoa-online,185964631,"Sữa tắm cho chó mèo Dorrikey 510ml",89000,89000,0,0
TIKI,bach-hoa-online,63558915,"Mật Ong Rừng Hoa Bạc Hà Daklak TETE 1 LÍT",129000,129000,0,0
TIKI,bach-hoa-online,11211353,"Tinh bột nghệ Ulnatech nghệ đỏ (tbn siêu hấp thu nano curcumin)",490000,490000,0,0
TIKI,bach-hoa-online,59197183,"Sữa Tiệt Trùng Có Đường VPMilk Grow+ Hộp 180ml (Thùng 48 Hộp)",368000,423100,55100,13
TIKI,bach-hoa-online,13409476,"Thùng 48 Hộp Sữa Uống Tiệt Trùng Dutch Lady Cô Gái Hà Lan Dâu (48 x 180ml)",390000,475000,85000,18
TIKI,bach-hoa-online,2454283,"Thùng 48 Hộp Sữa Tươi Tiệt Trùng Dutch Lady Cô Gái Hà Lan Có Đường (48X180ml)",325000,325000,0,0
TIKI,bach-hoa-online,89153755,"BÁNH GẤU NHÂN KEM 3 MÀU MÓN NGON TUỔI THƠ - HŨ 420G",63180,70200,7020,10
TIKI,bach-hoa-online,118328944,"Thùng Bia Sapporo Premium - 24 lon 330ml",365200,415000,49800,12
TIKI,bach-hoa-online,2984263,"Cà Phê Chế Phin 1 (500g) - 2 gói",260000,260000,0,0
TIKI,bach-hoa-online,68595800,"COMBO 24 HỘP Sữa Tươi Tiệt Trùng Vinamilk Có Chứa Tổ Yến - Hộp x 180ml",298000,298000,0,0
TIKI,bach-hoa-online,154698898,"Kẹo hương dâu tằm L'angfarm, 350g, bịch, mẫu kraft 1 mặt trong",32400,36000,3600,10
TIKI,bach-hoa-online,73852294,"Combo 2 Hộp Xí Muội Thái Lan DTFood (200g/Hộp)",93100,95000,1900,2
TIKI,bach-hoa-online,70602307,"Nước yến sào win'sNest Junior 12% ( 70ml ) thích hợp cho mọi đối tượng, đặc biệt trẻ em biếng ăn",51000,51000,0,0
TIKI,bach-hoa-online,177500113,"Sữa tắm SOS cao cấp cho chó mèo 530ml",76999,76999,0,0
TIKI,bach-hoa-online,153368757,"Bánh Tráng Sate Cay Vị Sốt Độc Quyền ABI SNACK",22000,22000,0,0
TIKI,bach-hoa-online,161524129,"Thùng 48 hộp sữa hạt mắc ca TH True Nut 180ml (180ml x 48)",537000,589110,52110,9
TIKI,bach-hoa-online,181000422,"Đặc Sản Sóc Trăng - Bánh Pía Thịt Lạp Tân Huê Viên 400G, Bánh Pía Nhân Măn, Bánh Pía Sóc Trăng Chính Hãng Túi 4 Bánh Bao Bì Riêng",83520,87000,3480,4
TIKI,bach-hoa-online,154698980,"Cỏ ngọt sấy khô, 225g, bịch",68400,76000,7600,10
TIKI,bach-hoa-online,2736445,"Trà Bồ Công Anh P&K - mát gan, giải độc, ngừa ung thư (50 túi lọc)",120000,120000,0,0
TIKI,bach-hoa-online,42053768,"Trà nụ hoa tam thất",135000,135000,0,0
TIKI,bach-hoa-online,484529,"Đồ Ăn Cho Mèo Lớn Whiskas Vị Cá Ngừ Túi 1.2 Kg",116000,140000,24000,17
TIKI,bach-hoa-online,701935,"Đồ Ăn Cho Chó Trưởng Thành Hương Vị Thịt Bò Nướng Classic Pets (20kg)",727000,727000,0,0
TIKI,bach-hoa-online,59496245,"Gạo Thơm ST24  Túi 5Kg ( A AN)",189000,189000,0,0
TIKI,bach-hoa-online,68554583,"Trà hắc kỷ tử - Kỷ tử đen (500gr)",235000,235000,0,0
TIKI,bach-hoa-online,23879027,"COMBO 4 HỘP CREAMER ĐẶC NGÔI SAO PHƯƠNG NAM XANH LÁ - HỘP GIẤY 380G",92000,92000,0,0
TIKI,bach-hoa-online,25200952,"Hạt Mix 8 loại hạt nhập khẩu DK HARVEST",155000,165000,10000,6
TIKI,bach-hoa-online,155764153,"Trà tim sen túi lọc Thái Bảo, 60 tép, hộp, mẫu pastel art",76500,85000,8500,10
TIKI,bach-hoa-online,108882784,"Sốt mè rang kewpie chai 180 ml / Nước chấm xốt mè rang Rong nho ",40000,40000,0,0
TIKI,bach-hoa-online,195192018,"Granola ăn kiêng yến mạch 5 loại hạt DK Harvest - Vị truyền thống, Hỗ trợ giảm cân, Ăn kiêng, Eatclean, Tạp gym - Túi 500g",125000,134000,9000,7
TIKI,bach-hoa-online,124069240,"Dầu Đậu Nành cao cấp Golden 2 lít",185000,185000,0,0
TIKI,bach-hoa-online,59106850,"Đặc Sản Phan Thiết - Nước Chấm Rong Biển Làng Chài Xưa Sea Sauce Chai Thủy Tinh 500Ml/Chai Làng Chài Xưa - Chay Mặn Đều Dùng Được",155000,195000,40000,21
TIKI,bach-hoa-online,1716053,"Sữa Tắm Cho Chó SOS - Khử Mùi Và Tạo Kiểu (530ml)",76999,79999,3000,4
TIKI,bach-hoa-online,8013692,"Thùng 30 Mì Chay Rau Nấm VIFON (65g / Gói)",144000,186000,42000,23
TIKI,bach-hoa-online,191309478,"Tinh Bột Củ Sen 100% Nguyên Chất - Cung cấp đầy đủ dưỡng chất cho cơ thể ( Hủ 100gr)",99000,99000,0,0
TIKI,bach-hoa-online,914862,"Cỏ Ngọt Sấy Khô L'angfarm (225g/bịch)",89000,89000,0,0
TIKI,bach-hoa-online,59202003,"Xí muội chua ngọt - Ô Mai Đào Không Hạt (200gr)",59000,59000,0,0
TIKI,bach-hoa-online,181115130,"CHÀ BÔNG CÁ HỒI HẢO HẠNG 120G",111000,111000,0,0
TIKI,bach-hoa-online,188321496,"Bơ Bretel 250g (bơ đồng tiền) - Pháp",195000,195000,0,0
TIKI,bach-hoa-online,171099820,"HẠT CHO MÈO IQ 500g",25000,25000,0,0
TIKI,bach-hoa-online,157251875,"Bún rau củ Nguyên Minh 300gr (bún khoai lang/chùm ngây/bí đỏ/mè đen/củ dền)",49000,49000,0,0
TIKI,bach-hoa-online,77544059,"MẬT TÁO ĐỎ THUẦN CHAY HỖ TRỢ BỔ MÁU ĐẸP DA (250ML)",198000,198000,0,0
TIKI,bach-hoa-online,72688883,"Trà lá sen Đồng Tháp Nguyên Chất - Combo 2 Bịch 500gam.",170000,170000,0,0
TIKI,bach-hoa-online,105172383,"Combo 6 Gói Aji-Quick® Bột Tẩm Khô Chiên Giòn 42g/Gói",37000,39000,2000,5
TIKI,bach-hoa-online,118146312,"Cà Phê Decaf Robusta tách 97% cafeine vị đắng nhẹ, thơm thích hợp với người dùng cà phê bị mất ngủ hay say cafe từ Message Coffee - Gói 200 Gram - Nguyên Hạt",115000,179000,64000,36
TIKI,bach-hoa-online,70745323,"Đậu Gà Trắng nhập khẩu Real Food(100g)",15000,15000,0,0
TIKI,bach-hoa-online,70689218,"Combo 3 gói Xốt Gia Vị Hoàn Chỉnh - Thịt Kho Tàu 80g",34560,38400,3840,10
TIKI,bach-hoa-online,194023184,"Măng ớt Hải Yêu 1kg, măng ớt mác mật Lạng Sơn, siêu thơm, siêu ngon, không phụ gia, chất bảo quản",37000,50000,13000,26
TIKI,bach-hoa-online,152695169,"Bánh Tráng Sốt Tomyum Đậm Đà Hương Vị Thái ABI SNACK",23000,23000,0,0
TIKI,bach-hoa-online,181377479,"Bột cần tây Dalahouse giúp giảm cân, thanh lọc cơ thể nguyên chất",121500,121500,0,0
TIKI,bach-hoa-online,216401083,"Trà Dưỡng Nhan 7 Vị Hộp 30 Túi Lọc x 10Gr Của Siêu Thị Thiên Nhiên Giúp Giảm Cân, Giữ Dáng, Đẹp Da",105000,150000,45000,30
TIKI,bach-hoa-online,181000363,"Đặc Sản Sóc Trăng - Bánh Pía Chà Bông Trứng Muối Tân Huê Viên 480G, Bánh Pía Mini Sóc Trăng [Túi 12 Bánh]",142100,145000,2900,2
TIKI,bach-hoa-online,77283156,"Trà sữa trân châu đường đen Yoki 400g",69000,69000,0,0
TIKI,bach-hoa-online,98807518,"MỰC SẤY KHÔ HẤP NƯỚC DỪA TÂN LỘC PHÁT HŨ 150G",56070,62300,6230,10
TIKI,bach-hoa-online,154698770,"Trà hà thủ ô túi lọc Thái Bảo, 60 tép, hộp, mẫu pastel art",76500,85000,8500,10
TIKI,bach-hoa-online,141734889,"Trà hoa ngũ cốc thảo mộc Brown Rice thanh nhiệt detox ngủ ngon giảm stress 500gr",100000,100000,0,0
TIKI,bach-hoa-online,175687484,"Combo 2 gói Cà Phê Rang Xay Culi Highlands Coffee (200g)",166000,220000,54000,25
TIKI,bach-hoa-online,49664783,"Trà tim sen - Cao cấp",90000,90000,0,0
TIKI,bach-hoa-online,55567060,"500G BÁNH GẠO TOPOKKI HÀN QUỐC",42000,42000,0,0
TIKI,bach-hoa-online,152815132,"Hỗ trợ giảm đau họng Ricola Shweizer Krauterzucker chứa 13 loại thảo mộc đem đến cảm giác dịu nhẹ cổ họng và thơm mát (dạng kẹo) - OZ Slim Store",108000,216000,108000,50
TIKI,bach-hoa-online,23084501,"COMBO TRÀ ATISÔ KHÔNG ĐƯỜNG VINAMILK VFRESH",140000,140000,0,0
TIKI,bach-hoa-online,271617966,"Thùng 24 Ly Mì Bò NGON NGON VIFON (60g / Ly)",87000,112000,25000,22
TIKI,bach-hoa-online,13715503,"Bột chiên gà giòn KFC Karaage túi 500G - Hàng nhập khẩu chính hãng Malaysia",56000,56000,0,0
TIKI,bach-hoa-online,58136661,"[Thùng 30 gói x 50gram] Cháo Tổ Yến Thịt Bằm - Yến Đại Phát, Yến thật, thịt thật, 4 gói gia vị, ăn liền, tiện lợi",384000,384000,0,0
TIKI,bach-hoa-online,73733859,"Mận Khô Smile Nuts hộp 315g | Nhập khẩu từ Chile (Khô tự nhiên trên cát nóng, giữ nguyên hương vị, khác biệt với loại sấy khô) | Chilean Prunes 315g",102000,136000,34000,25
TIKI,bach-hoa-online,75986346,"Sữa Tiệt Trùng Có Đường VPMilk Grow+ Vị Dâu Hộp 180ml (Thùng 48 Hộp)",383000,423100,40100,9
TIKI,bach-hoa-online,85090399,"Đường ăn kiêng La Hán Quả Saraya Lakanto MonkFruit Trắng, 0 Calo, 0 tăng đường huyết, 0 biến đổi gen - 180g",168000,205000,37000,18
TIKI,bach-hoa-online,109245487,"[Lốc (06) lon 330ml] Bia Black Đại Việt, Bia đen sản xuất theo luật bia tinh dòng của Bia Đức, không hóa chất, Bia việt dành cho người có gu",165000,165000,0,0
TIKI,bach-hoa-online,41401573,"Yến Sợi Cao Cấp Khánh Hòa Nest  ( Tổ Yến Sào Tinh Chế )",550000,550000,0,0
TIKI,bach-hoa-online,10409795,"Lốc 6 Lon Cà Phê Sữa Highlands Coffee (235ml/Lon)",90000,90000,0,0
TIKI,bach-hoa-online,273239458,"Bột Ngọt VEDAN 454g",34200,38000,3800,10
TIKI,bach-hoa-online,40798356,"Đặc sản Tiền Giang - Gạo Ngon Đặc Sản ST24 (2kg) - OCOP 4 SAO",65000,65000,0,0
TIKI,bach-hoa-online,98796201,"LẠP XƯỞNG TÔM COMBO 1KG - MỖI BỊCH 500G",115000,125000,10000,8
TIKI,bach-hoa-online,57799580,"Combo 2 hũ Ớt Bột Hàn Quốc 45gr Dh Foods",40900,40900,0,0
TIKI,bach-hoa-online,138811616,"Bột cải xoăn kale Dalahouse 60gr (Mẫu mới gồm 20 tuýp tiện dụng) - Nguyên chất sấy lạnh - Detox thanh lọc cơ thể - Đạt tiêu chuẩn Châu Âu",145000,145000,0,0
TIKI,bach-hoa-online,137847761,"Thức Ăn Cho Mèo Con Royal Canin Kitten 36",136999,139999,3000,2
TIKI,bach-hoa-online,73661212,"Cá Ngừ Cắt Khúc Ngâm Dầu Hạ Long - 115/175g",47300,47300,0,0
TIKI,bach-hoa-online,273842798,"Nho khô Sunview Raisins Mỹ không hạt 3 màu giàu Vitamin khoáng chất, tốt cho tim mạch (425g/hộp) - QuaTangMe Extaste",197000,394000,197000,50
TIKI,bach-hoa-online,174224329,"Ớt Bột Chỉ Thiên Tự Nhiên Vipep Hũ Nhựa 45g",10000,10000,0,0
TIKI,bach-hoa-online,190119255,"Gạo Hữu Cơ Hoa Nắng - Vàng Lúa Chín 1kg",79000,79000,0,0
TIKI,bach-hoa-online,4540123,"NHẬP KHẨU USA CHÍNH HÃNG - Viên uống ngừa loãng xương, hỗ trợ sức khỏe xương khớp Solgar Vitamin D3 1000 IU ",553745,553745,0,0
TIKI,bach-hoa-online,1055422,"Thuốc Xịt Hỗ Trợ Điều Trị Bọ Chét, Ve, Rận Chó Mèo Merial Frontline Spray (100ml)",162360,162360,0,0
TIKI,bach-hoa-online,73345804,"Cà phê hạt Rang Trung Nguyên( Espresso Bịch 500gam)",250000,250000,0,0
TIKI,bach-hoa-online,181000453,"Đặc Sản Sóc Trăng - Bánh Pía Kim Sa Đậu Đỏ 480G, BáNh PíA TâN Huê ViêN Sóc Trăng Không Sầu Riêng",116620,119000,2380,2
TIKI,bach-hoa-online,74824303,"Hộp 2 chai nước mắm truyền thống Phú Quốc Hồng Hạnh Siêu Hạng 35 độ đạm, dung tích 500ml- Chấm, kho đúng điệu",142800,170000,27200,16
TIKI,bach-hoa-online,56534930,"Trà xanh Sencha Yanoen 120g",119000,119000,0,0
TIKI,bach-hoa-online,183519696,"Viên nhai Spirit bổ sung canxi, khoáng, đẹp lông da, vitamin, men tiêu hóa cho chó mèo",1200,1200,0,0
TIKI,bach-hoa-online,167647995,"WHISKAS Thức ăn cho mèo lớn dạng sốt vị cá saba nướng 80g (12 gói)",141000,150000,9000,6
TIKI,bach-hoa-online,108151143,"Sốt mè rang/ Rong nho tách nước/Nước chấm mè rang kewpie  gói nhỏ 15ml / Combo rong nho 100G",38000,39000,1000,3
TIKI,bach-hoa-online,74038234,"Trà Ổi Hỗ Trợ Thanh Nhiệt Cơ Thể Da Đẹp Dáng Xinh Hộp 25 gói - Trà Hùng Phát",40000,40000,0,0
TIKI,bach-hoa-online,87130751,"Hạt Hạnh Nhân Rang Bơ DK Harvest Nhập Khẩu USA",94000,149000,55000,37
TIKI,bach-hoa-online,142703395,"[COMBO]2 Hộp (1Kg) Ngũ Cốc Bầu Dinh Dưỡng Min Min 29 Vị Hạt Truyền Thống _ Ngũ Cốc Min Min Dinh Dưỡng Cho Cả Gia Đình",420000,420000,0,0
TIKI,bach-hoa-online,171099308,"Thức ăn hạt mềm cho chó nhỏ Zenith 1.2kg",50000,50000,0,0
TIKI,bach-hoa-online,62734188,"Trung Nguyên Legend - Cà phê phin giấy Fusion Blend - Hộp 10 gói x 10gr",128000,148334,20334,14
TIKI,bach-hoa-online,174576462,"Thức Ăn Hạt Khô Cho Mèo Mọi Lứa Tuổi, Hạt Mèo Cat Eye Hàn Quốc Túi 1.5kg",89999,89999,0,0
TIKI,bach-hoa-online,179439737,"Viên nén chăm sóc sức khỏe đặc biệt cho chó mèo - Bổ sung canxi, vi lượng, men tiêu hóa, dưỡng lông",1000,1000,0,0
TIKI,bach-hoa-online,120523839,"Bún khô Cao Tuyền 500g, làm từ 100% gạo Đoàn Kết, đặc sản của người dân Cao Bằng",22500,30000,7500,25
TIKI,bach-hoa-online,271585906,"Thùng 30 Phở Chay Rau Nấm VIFON (65g / Gói)",105000,136000,31000,23
TIKI,bach-hoa-online,72294644,"Đặc Sản Phan Thiết - Nước Tương Cao Cấp Shiitake Chai 250 Ml Có Thành Phần Chính Từ Đậu Nành Và Nấm Ngọt Shiitake Nhật Bản",80000,120000,40000,33
TIKI,bach-hoa-online,72893050,"Bột trái nhàu nguyên chất Goce - 180g (18 gói x 10g)",72000,120000,48000,40
TIKI,bach-hoa-online,162195515,"Gia Vị Nướng Muối Ớt Barona 80g ướp ngon chuẩn vị không cần nêm nếm",11520,12800,1280,10
TIKI,bach-hoa-online,117785876,"Cà phê AEROCO Blend, gói 250g, pha phin, nguyên chất 100% rang mộc hậu vị ngọt thơm quyến rũ",135000,135000,0,0
TIKI,bach-hoa-online,72305795,"Mắm tôm ngon Lê Gia chai 110g",10000,13000,3000,23
TIKI,bach-hoa-online,249050779,"Sữa Ensure Úc cho người già, người gầy, người suy dinh dưỡng, người sau phẫu thuật, người mới ốm dậy - OZ Slim Store - Vanila (850g/lon)",1108000,2216000,1108000,50
TIKI,bach-hoa-online,154699113,"Cao ống atisô L'angfarm, 10 ống, hộp, mẫu antique",84000,89000,5000,6
TIKI,bach-hoa-online,54672598,"PROBISOL PETS Men tiêu hóa cho chó, mèo, Kích thích tiêu hóa, tăng đề kháng, Combo 10 gói, Sản phẩm Vemedim",66542,67900,1358,2
TIKI,bach-hoa-online,60839192,"Thịt heo chà bông Chà Chà - Thảo Nguyên Phát hũ 250g",169000,169000,0,0
TIKI,bach-hoa-online,273990155,"Si Rô CHANG THAI 1000ml - 16 Vị Trái Cây Tự Nhiên",62000,62000,0,0
TIKI,bach-hoa-online,73367360,"Thịt Heo 2 Lát Hạ Long - 150g",23500,23500,0,0
TIKI,bach-hoa-online,154492643,"Bột Gạo Lức Đậu Đỏ Mè Đen (Không Đường) Vitapro (350gr) Thơm Ngon Dinh Dưỡng, Hỗ Trợ Giảm Cân, Giảm Cholesterol – Hàng Chính Hãng",59000,59000,0,0
TIKI,bach-hoa-online,99078224,"Mì Tô Jin Cay Ottogi 110g",17860,19000,1140,6
TIKI,bach-hoa-online,73657025,"Salad Cá Ngừ San Juan Hạ Long - 175g",30420,30420,0,0
TIKI,bach-hoa-online,1717763,"Thức Ăn Chó Mèo Royal Canin Intense Hairball (400g)",146000,146000,0,0
TIKI,bach-hoa-online,105551893,"Rong biển cuộn cơm 10 lá Hàn Quốc ( 20g )",42000,45000,3000,7
TIKI,bach-hoa-online,75520763,"Nhân quả óc chó vàng Mỹ (Shelled Walnuts)",49000,49000,0,0
TIKI,bach-hoa-online,154699078,"Trà linh chi túi lọc Thái Bảo, 60 tép, hộp, mẫu pastel art",187200,208000,20800,10
TIKI,bach-hoa-online,147871438,"[ COMBO 3 HỘP ] Trà Mãng Cầu Nguyễn Văn - 100% mãng cầu xiêm tươi sấy khô - Hộp 100 GRAM",372750,525000,152250,29
TIKI,bach-hoa-online,93641049,"BIO-GREEN vi sinh xử lý nước ao hồ nuôi Cá Tôm bị ô nhiễm hoi thối. Cắt tảo xanh, tiêu nhớt đáy. Phân hủy cặn bã dư thừa làm trong sạch nguồn nước ",145000,145000,0,0
TIKI,bach-hoa-online,174501076,"[COMBO 3 HỘP] Kẹo ngậm Viasol húng chanh Vietnat giảm ho ấm họng - 100 viên/ hộp",150000,150000,0,0
TIKI,bach-hoa-online,173982784,"Sốt Mì Ý Phô Mai & Thảo Mộc Prego 290g (Thương Hiệu Mỹ - SX Malaysia)",46100,46100,0,0
TIKI,bach-hoa-online,54513683,"Chè dây cao bằng loại nhiều tuyết nhiều lá - Gói 500gr",59000,59000,0,0
TIKI,bach-hoa-online,94262367,"Sữa tắm Bio Care (450ml) diệt ve rận, bọ chét, khử mùi chó mèo",77000,77000,0,0
TIKI,bach-hoa-online,185965401,"Bọt rửa chân cho chó mèo Borammy 150ml (Dụng cụ làm sạch bàn chân cho thú cưng)",87120,87120,0,0
TIKI,bach-hoa-online,102392075,"Nước Ép Quýt Malee 1L (Thái Lan)",71400,71400,0,0
TIKI,bach-hoa-online,163716478,"Trà hoa cúc gạo lứt Quê Việt thanh nhiệt, ngủ ngon, điều hoà huyết áp 30gr",8600,9000,400,4
TIKI,bach-hoa-online,155256367,"Tương cà gói Cholimex 10g siêu tiện lợi (01 túi gồm 50 gói)",31000,31000,0,0
TIKI,bach-hoa-online,90331549,"Canh Miso ăn liền (Rong biển, đậu hũ, hành lá) Nagatanien Instant Miso Soup Ingredients (Wakame, Tofu, Green Onion) 100g",134000,134000,0,0
TIKI,bach-hoa-online,53406530,"Thùng 6 hộp  Miến Chua Cay Trùng Khánh  (108 Gram/hộp ) - chính hãng JUNJIE",88000,130000,42000,32
TIKI,bach-hoa-online,68533909,"Bột ca cao Beemo - Cacao nguyên chất, không đường, pha chế đồ uống, làm bánh, chế biến Chocolate",69000,105000,36000,34
TIKI,bach-hoa-online,45213011,"200g Trà long nhãn - Nhãn nhục",69000,69000,0,0
TIKI,bach-hoa-online,99855016,"BÁNH GẤU NHÂN MIX 3 VỊ TÂN LỘC PHÁT HŨ 250G",28800,32000,3200,10
TIKI,bach-hoa-online,140229082,"1 BLOCK Miến Phú Hương Yến Tiệc (6 vắt)",39000,39000,0,0
TIKI,bach-hoa-online,43133643,"1kg táo đỏ khô cao cấp",115000,115000,0,0
TIKI,bach-hoa-online,146494295,"Bột làm bánh pancake Morinaga 600g nội địa Nhật",90000,90000,0,0
TIKI,bach-hoa-online,154698784,"Khoai lang sấy dẻo L'angfarm, 300g, bịch, mẫu hút chân không",76500,85000,8500,10
TIKI,bach-hoa-online,174248005,"Trung Nguyên Legend - Cà phê hòa tan G7 3in1 - Bịch 20 sachets x 16gr (gói vuông)",69000,79531,10531,13
TIKI,bach-hoa-online,178107484,"Trà sữa thái xanh / Set nguyên liệu làm trà sữa  trân châu 10 - 12 ly trà sữa thơm ngon / Vườn Xanh Sạch ",57000,66000,9000,14
TIKI,bach-hoa-online,7664183,"Cà phê dừa ROCKCAFE (Túi 30 gói)",130000,130000,0,0
TIKI,bach-hoa-online,29279193,"Hạt lanh nâu Brown Flaxseeds",28000,28000,0,0
TIKI,bach-hoa-online,35527634,"Giấm Táo Hữu Cơ Bragg Nhập Khẩu Chính Hãng Từ Mỹ",210000,245000,35000,14
TIKI,bach-hoa-online,71953312,"Hạt Điều Rang Muối Sạch Vỏ Chất Lượng Hiệu SK FOOD - Hũ 500G",85000,85000,0,0
TIKI,bach-hoa-online,125918670,"Tương cà Cholimex 830g chai PET",30000,30000,0,0
TIKI,bach-hoa-online,29253142,"Gia vị rắc cơm 12 loại rau củ Ohmoriya 23g",49000,49000,0,0
TIKI,bach-hoa-online,263517040,"Rong Biễn Cháy Tỏi TETE 330 gram",99000,99000,0,0
TIKI,bach-hoa-online,126937903,"Da heo cháy tỏi ớt thơm ngon chất lượng SK FOOD - 100G",49000,49000,0,0
TIKI,bach-hoa-online,57701831,"KHÔ BÒ SỢI TÂN LỘC PHÁT - HŨ 500G",47000,59000,12000,20
TIKI,bach-hoa-online,48659516,"Đặc Sản Phan Thiết - Nước Mắm Chay Shiitake Chai 500Ml - Đậu Nành Và Nấm Ngọt Nhật Bản",157000,190000,33000,17
TIKI,bach-hoa-online,176491662,"Thùng dầu ăn Ranee Golden 5 lít (5 lít/chai x 4 chai)",1231000,1231000,0,0
TIKI,bach-hoa-online,35913328,"Cao Ống Atiso Không Đường Actiso mát gan giải độc - Hộp 10 ống 10ml Combo 3 hộp",209999,209999,0,0
TIKI,bach-hoa-online,135553903,"Mì ăn liền Siukay Hải Sản (Thùng 24 gói x 128 gram)",329000,329000,0,0
TIKI,bach-hoa-online,55427208,"Trà hoa cúc đường phèn",59000,59000,0,0
TIKI,bach-hoa-online,154698978,"Trà atisô túi lọc L'angfarm, 25 tép, hộp, mẫu quấn dây kraft",62100,69000,6900,10
TIKI,bach-hoa-online,170253419,"Combo 12 lọ Yến Sào Win'snest Tổ Yến Chưng Sẵn Nhân Sâm Không Đường 20% (70ml/ Lọ)",377000,739000,362000,49
TIKI,bach-hoa-online,107018100,"Kẹo Mút Welly hỗn hợp 396 gram Bibica",36000,43800,7800,18
TIKI,bach-hoa-online,1083284,"Đặc Sản Thái Nguyên - Trà Nõn Tôm Lộc Tân Cương (100g) - Trà Thái Nguyên",100000,100000,0,0
TIKI,bach-hoa-online,166000044,"Thứ ăn hạt CATSRANG Hàn Quốc - Túi ZIP chiết 1KG thức ăn cho mèo lớn, mèo con Catrang ",99999,99999,0,0
TIKI,bach-hoa-online,165853879,"Combo hạnh nhân Mỹ + Macca nhập khẩu Úc Pam's - Sấy chín giòn thơm, nguyên vị",229000,402000,173000,43
TIKI,bach-hoa-online,65476540,"500G KHÔ GÀ LÁ CHANH LOẠI CAO CẤP THƯƠNG HIỆU SK FOOD",99000,99000,0,0
TIKI,bach-hoa-online,141651020,"Hạt mix 5 loại hạt dinh dưỡng ( Hạt macca, quả óc chó vàng, quả óc chó đỏ, hạnh nhân, hạt điều )",289000,320000,31000,10
TIKI,bach-hoa-online,3243073,"Thùng 30 Mì Chính Hiệu Hai Tôm VIFON (75g / Gói)",159000,206000,47000,23
TIKI,bach-hoa-online,28263075,"Viên nang đông trùng hạ thảo Banikha chính hãng Thiên Phúc (Hộp 2 lọ x 30 viên)",745000,745000,0,0
TIKI,bach-hoa-online,144619353,"Cà Phê Trắng Ít Đường Aik Cheong Malaysia - White Coffee Less Sugar - 600g (15 gói x 40g)",145000,145000,0,0
TIKI,bach-hoa-online,76125047,"Pate gan Hạ Long - 150g",30000,30000,0,0
TIKI,bach-hoa-online,160641145,"Trà sencha hoa lài L'angfarm, 80g, hộp, mẫu stamp",94500,105000,10500,10
TIKI,bach-hoa-online,83898527,"Nước mắm truyền thống Lê Gia - Cốt đặc biệt chai 60ml Thương hiệu: Lê Gia ",16000,18000,2000,11
TIKI,bach-hoa-online,54798285,"Combo 3 túi Bún Tươi MeKong River 300g",68000,75000,7000,9
TIKI,bach-hoa-online,155828196,"Xốt ướp thịt nướng Cholimex - hũ thuỷ tinh 200g",23000,23000,0,0
TIKI,bach-hoa-online,11786352,"Trà Tam Diệp Thế Hệ 2 - Giảm Cân Hiệu Quả, An Toàn - Thương Hiệu Hùng Phát",110000,110000,0,0
TIKI,bach-hoa-online,56697899,"(Lá) Trà xanh Bancha Yanoen 120g",109000,109000,0,0
TIKI,bach-hoa-online,273019700,"Thùng 200 Mì Trẻ Em VIFON (20g / Gói)",54000,69000,15000,22
TIKI,bach-hoa-online,121361895,"Hạt Dổi nguyên hạt Doispice 25g chuẩn Hạt Dổi rừng Tây Bắc",55000,55000,0,0
TIKI,bach-hoa-online,198565731,"Hạt Chia Đen hữu cơ Nam Mỹ túi 500g - Chia Seeds Organic",92000,143000,51000,36
TIKI,bach-hoa-online,181978854,"Đặc Sản Sóc Trăng - Kẹo Gạo Lức Rong Biển Giòn Tan Tân Huê Viên 200G, Kẹo Gạo Lứt Sóc Trăng, Thanh Gạo Lức Rong Biển",57820,59000,1180,2
TIKI,bach-hoa-online,1012262,"Sữa Tắm Chó Mèo Trị Ve Ghẻ, Bọ Chét, Rận Tai Bio (500ml)",85000,85000,0,0
TIKI,bach-hoa-online,118135963,"Ớt Bằm Chilica Có Tỏi 212g",43900,43900,0,0
TIKI,bach-hoa-online,57360679,"Cà phê nguyên chất Robusta phối Arabica, cafe mộc rang xay Beemo 500g - Đắng vừa, chua nhẹ, thơm nồng nàn",155000,190000,35000,18
TIKI,bach-hoa-online,69254000,"TRÀ GẠO NHẬT RANG LỘC PHÁT - 0.5KG - NGUYÊN LIỆU DÙNG PHA CHẾ ĐỒ UỐNG - TRÀ SỮA (Trà Lộc Phát)",125000,125000,0,0
TIKI,bach-hoa-online,55897461,"Tặng 1 hũ thủy tinh cao cấp khi mua combo 2 gói Xốt muối Kim Chi Hàn Quốc Barona 180g",74000,74000,0,0
TIKI,bach-hoa-online,55524849,"Mắm Cá Lóc Sông Hương Foods Hũ 430g",125000,125000,0,0
TIKI,bach-hoa-online,102509486,"Trà dưỡng nhan - Giúp giảm cân, chống lảo hóa, giảm tress",99000,99000,0,0
TIKI,bach-hoa-online,140579525,"Kẹo Dẻo Boom Vị Trái Cây Hỗn Hợp 200g",41000,61000,20000,33
TIKI,bach-hoa-online,275176991,"Bột cỏ lúa mì hữu cơ sấy lạnh Dalahouse - Nguyên chất, không đường, Hỗ trợ thải độc Gan và Máu, Ngăn ngừa và hỗ trợ tiểu đường, Hỗ trợ tiêu hóa, giảm táo bón",121500,121500,0,0
TIKI,bach-hoa-online,181000484,"Đặc Sản Sóc Trăng - Bánh Pía Chay Môn Sầu Riêng Tân Huê Viên 400G, Bánh Pía Không Trứng Tân Huê Viên Sóc Trăng",73500,75000,1500,2
TIKI,bach-hoa-online,59202545,"Xí muội ngọt - Vị chua ngọt - Ô Mai Đào Không Hạt 500gr)",95000,95000,0,0
TIKI,bach-hoa-online,94418041,"Đường Đen MOLA 1.5 Kg - Pha Chế Sữa Tươi Trân Châu Đường Đen",90000,90000,0,0
TIKI,bach-hoa-online,138956327,"[Khay 30 lon] Nước Yến sào Khánh Hòa Sanest Kids đóng lon 190ml - 0162",256760,262000,5240,2
TIKI,bach-hoa-online,56643829,"Giảo Cổ Lam Shop Thảo Dược 500G - Giúp Giảm Cholesterol, Ngăn Ngừa Các Bệnh Về Tim Mạch",110000,110000,0,0
TIKI,bach-hoa-online,114538906,"[HCM] Nước Cốt Tắc Thai Lime 500ml",55000,55000,0,0
TIKI,bach-hoa-online,140579048,"Miến Phú Hương ( Sườn heo ) 58gr x 24 gói",285000,285000,0,0
TIKI,bach-hoa-online,19602743,"Vỏ bưởi sấy dẻo Nonglamfood hộp 200g | Healthy Snack | Tăng đề kháng tự nhiên | Trái cây sấy dẻo dinh dưỡng ăn liền | Ăn vặt giảm cân, giữ dáng, đẹp da",63000,73000,10000,14
TIKI,bach-hoa-online,58600700,"Gạo Nhật Japonica Túi 5Kg ( A An)  - Hạt tròn, cơm ngọt, rất dẻo, hạt cơm kết dính",135000,135000,0,0
TIKI,bach-hoa-online,27662732,"Combo 2 Hộp Bột Ngũ Cốc Dinh Dưỡng 22 Complete Nutrimix Wheat Grass 750g + Tặng 1 Hộp Giấy Complete Nutrimix",1274100,1274100,0,0
TIKI,bach-hoa-online,5531741,"Gạo Mầm Vibigaba Nghệ Cho Người Viêm Loét Dạ Dày, Tá Tràng, Viêm Gan - Hộp 1kg",79000,79000,0,0
TIKI,bach-hoa-online,178256512,"Muối Hồng Himalaya Xay Nhuyễn Vipep Hũ Nhựa 500g",45000,45000,0,0
TIKI,bach-hoa-online,130858000,"Sữa Bột Wincofood Goldcare Diacerna 850g: dinh dưỡng đặc biệt dành cho người đái tháo đường và tiền đái tháo đường giúp ổn định đường huyết.",391200,489000,97800,20
TIKI,bach-hoa-online,437760,"Bánh Ăn Sáng Nestle HN Stars (300g)",94900,114000,19100,17
TIKI,bach-hoa-online,157210054,"Bột sắn dây nguyên chất Thành Nhàn (500g)- 100% Sắn dây tự nhiên loại 1, an toàn, sạch sẽ không chất bảo quản",115000,150000,35000,23
TIKI,bach-hoa-online,109393386,"Đặc Sản Phan Thiết - Thùng 6 Chai Nước Mắm Nhỉ Cá Cơm Than Làng Chài Xưa 525Ml/Chai Sánh Đặc Thịt Cá 300 Năm Truyền Thống",216000,360000,144000,40
TIKI,bach-hoa-online,77752917,"Trà sữa vị truyền thống Yoki 200g",55000,55000,0,0
TIKI,bach-hoa-online,48141321,"Thùng (06 hộp) Mắm cá linh chưng - Antesco",309000,309000,0,0
TIKI,bach-hoa-online,181983943,"Combo 2 Nước yến thật BRAND'S Đường Phèn",907000,907000,0,0
TIKI,bach-hoa-online,125918726,"Tương ớt Cholimex  830g",30000,30000,0,0
TIKI,bach-hoa-online,92228113,"Bột Rau Má Quảng Thanh gói 100g sạch, an toàn, nói không với phẩm màu và phụ gia độc hại ",158400,176000,17600,10
TIKI,bach-hoa-online,181981053,"Combo 2 Nước cốt gà BRAND'S Vị Truyền Thống",303000,303000,0,0
TIKI,bach-hoa-online,58516787,"Ngũ cốc sữa chua trái cây và hạt dinh dưỡng ( 400gram )",69000,85000,16000,19
TIKI,bach-hoa-online,141061726,"Dầu ăn dinh dưỡng Ranee CÁ HỒI 950ml + tặng kèm 01 vá gỗ cao cấp",93000,93000,0,0
TIKI,bach-hoa-online,129355949,"Mạch nha Kim Hồng (Bà Tấn) 380g, đặc sản quảng ngãi, sản xuất 100% từ gạo nếp và mộng lúa, không chất phụ gia, bảo quản  ",48000,70000,22000,31
TIKI,bach-hoa-online,172319422,"Trà Hoa Sen Sấy Thăng Hoa- Tinh Hoa Thiên Nhiên Việt, Hộp Quà Cao Cấp, ĐV- Sen Đại Việt- Hộp 1 Bông 16g",220000,220000,0,0
TIKI,bach-hoa-online,85557521,"Combo 3 Lon Sữa Đặc Có Đường Creamer Premium Alphana nhập khẩu Malaysia Lon 500g Không Cholesterol - Giàu Vitamin A, B1, D3 - Nắp Khui Tiện Lợi",117000,117000,0,0
TIKI,bach-hoa-online,72874487,"Cà Phê Sữa G7 3in1 Trung Nguyên (100 Gói)-( Combo 2 Bịch)",660000,660000,0,0
TIKI,bach-hoa-online,68368550,"Đặc Sản Bình Thuận  - Combo 2 Chai 60Ml Nước Mắm Tĩn Mini Du Lịch 40N Đạm Tự Nhiên Nước Mắm Rin Nguyên Chất Truyền Thống Sạch Là Cốt Nhĩ Từ Cá Cơm Than Sánh Đặc Thịt Cá Không Chất Bảo Quản - Ocop 4 Sao",58000,90000,32000,36
TIKI,bach-hoa-online,57708325,"1 HỘP NƯỚC DỪA  DỨA VICO FRESH 330ML",12100,22000,9900,45
TIKI,bach-hoa-online,68059169,"Đặc Sản Phan Thiết - Combo 3 Chai Nước Mắm Nhỉ Làng Chài Xưa Xuất Khẩu Nhãn Xanh 500Ml + 3 Chai Làng Chài Xưa Nhãn Đỏ 500Ml Cốt Nhỉ Đặc Biệt Từ 100% Cá Cơm Tươi",349000,590000,241000,41
TIKI,bach-hoa-online,125918669,"Xốt ướp xá xíu Cholimex gói 70g",7500,7500,0,0
TIKI,bach-hoa-online,274914322,"Trà Sâm Hồng thượng hạng VG túi 500gram mát gan, giải độc - NPP Ehomepire",120000,120000,0,0
TIKI,bach-hoa-online,117327345,"Nước mắm Cá Nục Lê Gia",60000,72000,12000,17
TIKI,bach-hoa-online,250017267,"COMBO SỮA ĐẬU NÀNH VINAMILK SUPER NUT ĐẬU ĐỎ ÍT ĐƯỜNG 180ML",175000,175000,0,0
TIKI,bach-hoa-online,84795562,"Hạt Hạnh Nhân Mỹ Rang Không Muối Dinh Dưỡng 270g LAFOOCO Unsalted Almond",100100,143000,42900,30
TIKI,bach-hoa-online,14619691,"10 hũ nước yến sào Sanest không đường (70 ml/hũ)",375000,375000,0,0
TIKI,bach-hoa-online,174860595,"Xốt ướp đồ nướng vị xá xíu Lee Kum Kee Charsiu Sauce (240g/ hũ)",54000,54000,0,0
TIKI,bach-hoa-online,145472224,"Hộp Quà Sức Khoẻ (Trà Oolong - Trà Sen - Cà Phê Arabica)",480000,500000,20000,4
TIKI,bach-hoa-online,263104769,"Mix hạt dinh dưỡng siêu macca gồm 3 loại tách vỏ ( macca Úc, hạnh nhân Mỹ, hạt óc chó Mỹ) hạt ngũ cốc ăn liền có sấy giòn, tẩm mật ong và hạt làm sữa",135000,135000,0,0
TIKI,bach-hoa-online,134809025,"Thùng 48 Hộp Sữa SoCola Lúa Mạch KUN 180ml/hộp",273000,350000,77000,22
TIKI,bach-hoa-online,49186819,"Gạo Lứt Tím Than Túi 1Kg - Gạo Ông Thọ - Thơm  mềm dẻo, tốt cho sức khỏe",39000,39000,0,0
TIKI,bach-hoa-online,56222858,"Trà bồ công anh chính hãng hộp giấy loại du lịch ",150000,150000,0,0
TIKI,bach-hoa-online,99078114,"Combo 6 gói Mì Jin lẩu Thái Ottogi 115g",82908,88200,5292,6
TIKI,bach-hoa-online,73851585,"Bột Đậu Nành Rang Nguyên Chất Thơm Ngon DTFood 1kg (2 Hộp 500g)",87220,89000,1780,2
TIKI,bach-hoa-online,94761207,"Đặc Sản Phú Quốc - Hộp 6 Chai Thủy Tinh Nước Mắm Phú Quốc Khải Hoàn 43 Độ Đạm (205Ml/ Chai) - Ocop 5 Sao",278000,312000,34000,11
TIKI,bach-hoa-online,77749703,"Combo 2 Túi Cà Phê Sữa King Cofffee (50 gói x 20g)",400000,400000,0,0
TIKI,bach-hoa-online,6137027,"Mật Ong Hoa Xuyến Chi hũ 500g",298000,298000,0,0
TIKI,bach-hoa-online,145177159,"Đặc Sản Phan Thiết - Nước Mắm Chay Cao Cấp Làng Chài Xưa (Chai Nhựa 525Ml/Chai) Nấm Ngọt Shiitake Nhật Bản, Đậu Nành, Thơm Dứa",66000,150000,84000,56
TIKI,bach-hoa-online,127686733,"Xốt ướp thịt nướng Cholimex hũ thuỷ tinh 600g",55000,55000,0,0
TIKI,bach-hoa-online,70127635,"CÀ PHÊ XAY ĐẶC BIỆT LỘC PHÁT - PHA PHIN - 1KG - NGUYÊN LIỆU DÙNG PHA CHẾ ĐỒ UỐNG (Trà Lộc Phát)",240000,240000,0,0
TIKI,bach-hoa-online,181985905,"Combo 3 Nước cốt gà BRAND'S Vị Truyền Thống",454000,454000,0,0
TIKI,bach-hoa-online,20464717,"Socola Sữa 40% | Milk Chocolate 40% Alluvia",68000,68000,0,0
TIKI,bach-hoa-online,136332963,"COMBO SIÊU TIẾT KIỆM - 2 Hũ Đậu Gà Chickpeas DK HARVEST nhập khẩu Nam Mỹ/Ấn Độ 700g/Hũ",159000,159000,0,0
TIKI,bach-hoa-online,141843274,"Sả Bột Tự Nhiên Vipep Hũ Nhựa 40g",14000,14000,0,0
TIKI,bach-hoa-online,70939127,"Ngũ cốc sữa chua trái cây ( 400gram)",66000,80000,14000,18
TIKI,bach-hoa-online,53090085,"Trân châu sống Caramel truyền thống(1kg/bao), dùng kèm trà sữa. Trân châu dẻo dai thơm.",49000,49000,0,0
TIKI,bach-hoa-online,271585957,"Thùng 18 Phở Thịt Bò HOÀNG GIA VIFON có Gói Thịt Thật (120g / Gói)",147000,190000,43000,23
TIKI,bach-hoa-online,37545579,"BỘT GẠO LỨT MÈ ĐEN giảm cân đẹp da lợi sữa(500GR)",95000,95000,0,0
TIKI,bach-hoa-online,41540965,"COMBO SIÊU TIẾT KIỆM - 1 Hũ Yến Mạch Cán Dẹt Dk Harvest 450g + 1 Hũ Chia Đen Dk Harvest 500g",150000,170000,20000,12
TIKI,bach-hoa-online,140248505,"Sữa chua sấy thăng hoa I.Yaua túi 25g mix 05 vị (việt quất, sầu riêng, chuối, dâu và truyền thống)",39000,39000,0,0
TIKI,bach-hoa-online,68372373,"Combo 1 hũ chà bông heo TNP 100g và 1 gói chà bông heo TNP 150g",156000,156000,0,0
TIKI,bach-hoa-online,73122711,"500G ĐẬU HÀ LAN SẤY TỎI ỚT GIÒN NGON",40500,45000,4500,10
TIKI,bach-hoa-online,72301011,"Hạt Macca Nứt Vỏ Nhập Khẩu Bổ Dưỡng Thương Hiệu SK FOOD - Hũ 500G",155000,155000,0,0
TIKI,bach-hoa-online,1083280,"Đặc Sản Thái Nguyên - Móc Câu Đặc Biệt Lộc Tân Cương (250g) - Trà Thái Nguyên",176000,176000,0,0
TIKI,bach-hoa-online,20151310,"1kg cafe hạt LeeLong1 gu Mạnh chưa xay ( 85 Robusta/15 Arabica)",240000,240000,0,0
TIKI,bach-hoa-online,14709221,"Trà Shan Tuyết Cổ Thụ Tà Xùa Lộc Tân Cương (100gr)",119000,119000,0,0
TIKI,bach-hoa-online,141792921,"Gừng Bột Vipep 40g",15000,15000,0,0
TIKI,bach-hoa-online,68554507,"Trà hắc kỷ tử - Kỷ tử đen (200gr)",89000,89000,0,0
TIKI,bach-hoa-online,17460175,"Bánh quy Lady Finger Savoiardi Divella 400gr",165000,165000,0,0
TIKI,bach-hoa-online,119657297,"CÀ PHÊ BLAGU HẠT ĐÃ RANG, GURU 3 BLEND COLD BREW – SWEET COLD, MEDIUM ROAST, 250G",170000,170000,0,0
TIKI,bach-hoa-online,170253422,"Combo 12 lọ Yến sào cao cấp win'sNest tổ yến chưng sẵn dành cho trẻ em 20% (70 ml/ lọ)",377000,719000,342000,48
TIKI,bach-hoa-online,271585943,"Thùng 50 Cháo Thịt Gà VIFON có Gói Thịt Thật 27gr (70g / Gói)",119000,154000,35000,23
TIKI,bach-hoa-online,99077953,"Sốt Tokbokki Ottogi gói 1Kg",57340,61000,3660,6
TIKI,bach-hoa-online,87379850,"Bột Tía Tô Quảng Thanh gói 100g bổ phổi phế - Hỗ trợ bệnh gout, cảm cúm",182700,203000,20300,10
TIKI,bach-hoa-online,107369042,"Xí muội mặn có hạt (500gr)",115000,115000,0,0
TIKI,bach-hoa-online,181361329,"Combo 2 Hộp Cà Phê Sữa Hòa Tan - Legend Classic - Hộp 12 gói - Trung Nguyên Legend (Gu mạnh, vị đắng đậm đà)",105480,117200,11720,10
TIKI,bach-hoa-online,173291215,"DẦU DỪA TINH KHIẾT ORGANIC VIETCOCO, PET - 1 LIT",185000,185000,0,0
TIKI,bach-hoa-online,97358885,"Bột Cacao Đắng - LÚAVE - 0.5kg",118000,118000,0,0
TIKI,bach-hoa-online,94747329,"Đặc Sản Phú Quốc - Hộp 6 Chai Thủy Tinh Nước Mắm Phú Quốc Khải Hoàn 43 Độ Đạm (520Ml X 6) - Ocop 5 Sao",629000,698000,69000,10
TIKI,bach-hoa-online,22616083,"Nhân Óc Chó Smile Nuts hộp 286g - Óc chó nhập khẩu từ Chile (Chilean Walnut Kernel 286g)",139000,198000,59000,30
TIKI,bach-hoa-online,4546671,"Mì Udon Nhật Bản 200g",35000,35000,0,0
TIKI,bach-hoa-online,53268663,"Gạo Hạt Ngọc Trời Lứt Tím 1Kg",54000,54000,0,0
TIKI,bach-hoa-online,22475236,"Muối biển tinh khiết 500g",20000,20000,0,0
TIKI,bach-hoa-online,9842828,"Mật ong gừng Hàn Quốc Gavo 1kg",179000,189000,10000,5
TIKI,bach-hoa-online,206126895,"Nhân hạt óc chó đỏ Mỹ, hạt mới không hôi dầu, không chất bảo quản, hạt óc chó tách vỏ Nunuts",150000,150000,0,0
TIKI,bach-hoa-online,181366285,"Sữa Hạt Thuần Chay Soyna  Lon 400g - 11 loại hạt cao cấp từ hạt mắc ca, óc chó, ý dĩ, diên mạch - cung cấp dinh dưỡng cho người ăn chay trường, người dị ứng đạm sữa bò, người bị khó tiêu trào ngược dạ dày",275000,275000,0,0
TIKI,bach-hoa-online,42013180,"Hạt điều rang muối vỏ lụa SVIET",106000,106000,0,0
TIKI,bach-hoa-online,73360667,"Combo 6 lon Coca Nhật chai nhôm 300ml ( mẫu mới )",269000,269000,0,0
TIKI,bach-hoa-online,216401116,"Trà Dưỡng Tâm Hộp 30 Gói Túi Lọc x10gr Gồm Long Nhãn, Kỷ Tử, Táo Đỏ Của Siêu Thị Thiên Nhiên",105000,199000,94000,47
TIKI,bach-hoa-online,29253172,"Viên cà ri Golden Curry vị cay vừa 198g (8 viên)",79000,79000,0,0
TIKI,bach-hoa-online,53399070,"Natural Hạt Mắc Khén 15gr Dh Foods",17300,17300,0,0
TIKI,bach-hoa-online,59271101,"1KG HẠT ĐIỀU NGUYÊN RANG TỎI ỚT LOẠI CAO CẤP THƯƠNG HIỆU SK FOOD",109000,109000,0,0
TIKI,bach-hoa-online,58503630,"Mơ Trung Đông sấy lạnh không đường Kentary túi 200 gram - Trái cây sấy giúp giảm cân",160000,165000,5000,3
TIKI,bach-hoa-online,42676884,"Tương Ớt Gốc Việt Siracha",60000,60000,0,0
TIKI,bach-hoa-online,40742154,"Combo 5 hộp Gạo Hữu Cơ Hoa Nắng - Vàng Lúa Chín 2kg",720000,720000,0,0
TIKI,bach-hoa-online,141095821,"Thức Ăn Hạt Classic Pet Adult Cho Chó Trưởng Thành 400g",22000,22000,0,0
TIKI,bach-hoa-online,51102880,"Trà Gừng DRAGON",38000,38000,0,0
TIKI,bach-hoa-online,58336136,"SỮA BỔ SUNG CANXI -  GLUCOSE PLAN - Dinh dưỡng cho chế độ ăn đặc biệt giúp bổ sung canxi, chống loãng xương, tăng cường hệ tiêu hóa",535000,535000,0,0
TIKI,bach-hoa-online,115280887,"Bộ 6 túi thức ăn cho chó lớn dạng sốt Pedigree vị bò và rau củ 130g",107160,114000,6840,6
TIKI,bach-hoa-online,20447387,"Socola Đen Quế  Nguyên Chất, Đắng Vừa | Dark Chocolate Cinnamon Alluvia",66000,66000,0,0
TIKI,bach-hoa-online,2984271,"Cà Phê Sáng Tạo 5 Trung Nguyên (340g) - 2 gói",320000,320000,0,0
TIKI,bach-hoa-online,1012238,"Thuốc Phun Xịt Ve, Ghẻ, Bọ Chét Chó Mèo Hanvet Hantox Spray (300ml)",35000,35000,0,0
TIKI,bach-hoa-online,170107925,"Giấm táo hữu cơ Bragg 473ml & 946ml - Hàng Mỹ",230000,230000,0,0
TIKI,bach-hoa-online,45263525,"500gr Trà atiso đỏ",185000,185000,0,0
TIKI,bach-hoa-online,56669841,"Mật ong cao cấp xuất khẩu Hoa Xuyến Chi Phúc Khang Hũ (500g) - Hàng Chính Hãng  - Mật ong sạch, mật ong cao cấp đạt tiêu chuẩn xuất khẩu - Bồi bổ cơ thể, tăng sức đề kháng",129000,129000,0,0
TIKI,bach-hoa-online,51547360,"Đường la hán quả JC BLUEMOON Monk Fruit Classic Blend 500G",286000,286000,0,0
TIKI,bach-hoa-online,185965772,"Bánh thưởng cho chó Karamo Sumiho gói 100gr",13860,13860,0,0
TIKI,bach-hoa-online,46989885,"THÙNG 12 HỘP NƯỚC CỐT DỪA UHT VICO RICH 1L",870000,870000,0,0
TIKI,bach-hoa-online,100067285,"DẦU MÈ ĐEN ÉP LẠNH 350ml - Noom (tặng vòi nhấn)",390000,390000,0,0
TIKI,bach-hoa-online,48717265,"Bột xí muội Volcano 100g",35000,35000,0,0
TIKI,bach-hoa-online,51412075,"Thùng 12 hộp canh rong biển hộp 10 gói không bột ngọt - TÂM MINH FOODS",552000,552000,0,0
TIKI,bach-hoa-online,145506034,"TRÀ TRÁI KHỔ QUA RỪNG hũ 100g & hũ 120g - HƯƠNG SEN VIỆT",150000,150000,0,0
TIKI,bach-hoa-online,171259784,"Compo Tắc xí muội và Đá me hạt mềm Thanh Bình- Hộp 900g - Tăng đề kháng, giải nhiệt mùa hè, bổ sung Vitamin mùa dịch",120000,120000,0,0
TIKI,bach-hoa-online,68069074,"Mận Sơn La sấy dẻo Kentary 400gr, vị chua ngọt đậm đà - Giảm cholesterol xấu, tốt cho xương khớp, tim mạch - Trái cây sấy giảm cân, không GMO/Gluten/Chất bảo quản",184000,190000,6000,3
TIKI,bach-hoa-online,4681925,"Bột ngũ cốc dinh dưỡng cao cấp 22 dưỡng chất hiệu 22 Complete Nutrimix - Chia Seed (Hạt chia) - hộp thiếc 750g",496000,496000,0,0
TIKI,bach-hoa-online,76183708,"Pate cá hồi sốt phô mai kem Hạ Long - 90g [DATE T06/2024]",39600,39600,0,0
TIKI,bach-hoa-online,14657236,"Nhụy hoa nghệ tây Tashrifat Saffron Premium loại Negin sợi to (1 Grams)",204000,408000,204000,50
TIKI,bach-hoa-online,63246285,"Combo 1KG: 500G Đậu Hà Lan Sấy Muối - 500G Đậu Hà Lan Sấy Tỏi Ớt Thương Hiệu SK FOOD",89000,89000,0,0
TIKI,bach-hoa-online,104750207,"Cà phê hạt rang Coffilia - Nhẹ nhàng Sơn La gói 250g",195000,195000,0,0
TIKI,bach-hoa-online,1717869,"Thức Ăn Cho Chó Royal Canin Mini Adult (2kg)",399999,399999,0,0
TIKI,bach-hoa-online,154699165,"Thập cẩm sấy L'angfarm, dòng phổ thông, 450g, bịch, mẫu nhãn kẹp",90000,100000,10000,10
TIKI,bach-hoa-online,32380314,"COMBO 2 HŨ 1KG ĐẬU PHỘNG TỎI ỚT THƠM NGON (HŨ PET)",115000,115000,0,0
TIKI,bach-hoa-online,73720756,"Vải Thiều Nước Đường Hạ Long - 560g",72600,72600,0,0
TIKI,bach-hoa-online,15353730,"Khô Gà Lá Chanh Thượng Hạng DTfood (500g)",87000,89000,2000,2
TIKI,bach-hoa-online,48341360,"Combo 3 Hộp Trà Linh Chi (Hộp 20 Túi Lọc X 2gr) - Tăng Tuổi Thọ, Bồi Bổ Sức Khỏe  - Nguyên Thái Trang – Thảo Dược Thiên Nhiên",99000,99000,0,0
TIKI,bach-hoa-online,56107033,"Trà hoa cúc chi Kami sấy lạnh (50g) – Cải thiện thị lực, thanh nhiệt, giải độc cơ thể",120000,120000,0,0
TIKI,bach-hoa-online,76674062,"Bún Ốc Lý Tử Thất - Chính hãng Li ZiQi",72000,88000,16000,18
TIKI,bach-hoa-online,39313277,"Sốt/ Snack thưởng Ciao Churu cho mèo Hộp 50 thanh - mix 5 vị gà",435000,435000,0,0
TIKI,bach-hoa-online,107018635,"Tiêu Đen Xay Fadely (45g)",17900,20000,2100,11
TIKI,bach-hoa-online,56510470,"COMBO10- 1 Túi Đậu Gà trắng 1 Túi Đậu Lăng đỏ 1 Túi Đậu Hà lan xanh nguyên hạt và 1 Túi Đậu Cúc 500g",145000,145000,0,0
TIKI,bach-hoa-online,55656739,"Chà Là Nguyên Cành Smile Nuts hộp 250g - Dòng Chà Là Deglet Nour Nhập Khẩu Từ Tunisia (Chà là với thớ thịt mềm, dẻo, thoảng vị mật ong)",98000,145000,47000,32
TIKI,bach-hoa-online,106381120,"[Combo 3 chai] Dầu Đậu Nành Simply 2L",366000,366000,0,0
TIKI,bach-hoa-online,73636224,"Bò Sốt Vang Hạ Long - 175g",49000,49000,0,0
TIKI,bach-hoa-online,125858364,"Gia vị kho cá Cholimex - hũ thuỷ tinh 200g",20000,20000,0,0
TIKI,bach-hoa-online,196857767,"Dung dịch vệ sinh mắt cho chó mèo và bông lau mắt Borammy - Lọ nhỏ mắt loại bỏ bụi bẩn và vết ố vàng cho thú cưng",32000,32000,0,0
TIKI,bach-hoa-online,154698821,"Kẹo me cay L'angfarm, 300g, bịch, mẫu kraft 1 mặt trong",34200,38000,3800,10
TIKI,bach-hoa-online,69061414,"[MẪU MỚI - CHÍNH HÃNG] LỤC TRÀ LÀI LỘC PHÁT - 1KG - NGUYÊN LIỆU DÙNG PHA CHẾ ĐỒ UỐNG - TRÀ SỮA (Trà Lộc Phát)",160000,160000,0,0
TIKI,bach-hoa-online,121020714,"Dầu ăn thượng hạng Ranee Golden 2 lít",140000,140000,0,0
TIKI,bach-hoa-online,134809097,"Thùng 24 Túi Sữa Trái Cây Hương Nho KUN 110ml/túi",87100,120000,32900,27
TIKI,bach-hoa-online,59162968,"Thức ăn cho chó con Ganador vị Sữa và DHA - Puppy Milk with DHA 400gr",26000,26000,0,0
TIKI,bach-hoa-online,145123646,"Gạo Japonica Neptune 5kg",139000,144144,5144,4
TIKI,bach-hoa-online,59505951,"Thịt Khô Bò Loại Miếng Mềm Thương Hiệu SK FOOD - Hũ 250G",139000,139000,0,0
TIKI,bach-hoa-online,152695933,"BEST SELLER - BÁNH TRÁNG ABI SNACK",174000,174000,0,0
TIKI,bach-hoa-online,37137744,"Ngũ cốc Calbee vị Trái cây gói đỏ 800gr (Trái cây & các loại Hạt)",135000,135000,0,0
TIKI,bach-hoa-online,141099510,"Bơ thượng hạng Golden Margarine 200gr",24500,24500,0,0
TIKI,bach-hoa-online,72191805,"Thùng 48 Hộp Sữa Tươi Tiệt Trùng Vinamilk 100% Organic Không Đường 12 lốcx180ml-Mẫu mã mới",530000,530000,0,0
TIKI,bach-hoa-online,62723544,"KHÔ BÒ DẠNG CỤC TÂN LỘC PHÁT - HŨ 250G",80000,129000,49000,38
TIKI,bach-hoa-online,192917906,"Kẹo chanh muối himalaya malaysia",86888,86888,0,0
TIKI,bach-hoa-online,140229139,"Combo 10 gói Mì Lẩu Thái Tôm (1 gói 80gr)",99000,99000,0,0
TIKI,bach-hoa-online,86147390,"Nước tương hữu cơ Tamari và Teriyaki 200ml - PBFarm",108000,108000,0,0
TIKI,bach-hoa-online,5754769,"Combo 2 Hộp Chia Úc MFood 250g",90000,90000,0,0
TIKI,bach-hoa-online,140861988,"Xịt trị ve rận cho chó mèo Hantox Spray",27268,27268,0,0
TIKI,bach-hoa-online,1716077,"Sữa Tắm Cho Chó SOS - Phục Hồi Da, Lông (530ml)",76999,78888,1889,2
TIKI,bach-hoa-online,141291499,"Sữa non Anpha Lipid American 450g - 24h - Sữa Non Cao - Phòng ngừa tai biến - tốt cho tim mạch",485000,485000,0,0
TIKI,bach-hoa-online,47455914,"Trà Lipton Nhãn Vàng 100 gói x 2G",128000,128000,0,0
TIKI,bach-hoa-online,160642697,"Trà sencha hoa hồng L'angfarm, 86g, hộp, mẫu stamp",98100,109000,10900,10
TIKI,bach-hoa-online,599724,"Trà Sữa Aik Cheong Vị Classic 3 In 1 600G (40 G X 15 Gói) - [9556771000554]",117000,117000,0,0
TIKI,bach-hoa-online,2783849,"Thùng Fristi Hương Dâu 48x80ml",190000,190000,0,0
TIKI,bach-hoa-online,19652386,"Kẹo hồng sâm không đường hàn quốc",57000,57000,0,0
TIKI,bach-hoa-online,1715929,"Sữa Bột Cho Chó Mèo Bio Milk (100g)",34999,34999,0,0
TIKI,bach-hoa-online,187188571,"Đặc Sản Phan Thiết - Nước Chấm Cá Cơm Than Làng Chài Xưa Chai Nhựa Cao Cấp 1 Lít/Chai Đặc Biệt Thanh Dịu An Toàn Tiết Kiệm",42000,60000,18000,30
TIKI,bach-hoa-online,134971266,"[COMBO 2 HŨ] Chà Bông Heo Xù Thượng Hạng Mỗi Hũ 250G SK FOOD",150000,150000,0,0
TIKI,bach-hoa-online,99138532,"HẠT ĐIỀU RANG MUỐI VỠ TÂN LỘC PHÁT HŨ 500G",44100,49000,4900,10
TIKI,bach-hoa-online,128471926,"[CHÍNH HÃNG] Bột Cần Tây Sấy Lạnh Nguyên Chất  - Hỗ trợ giảm cân, giảm mỡ bụng, giảm mụn, giảm gút - Hộp 45gr",153000,240000,87000,36
TIKI,bach-hoa-online,7853177,"Trà tân cương thượng hạng 500 gram",155000,155000,0,0
TIKI,bach-hoa-online,128115713,"Combo 02 thùng Bia Sapporo Premium - 12 lon 500ml ",563200,640000,76800,12
TIKI,bach-hoa-online,55524540,"Cà Phê Đen Hòa Tan Espresso KING COFFEE - Hộp 15 gói x 2.5g",45900,59600,13700,23
TIKI,bach-hoa-online,73089745,"Rượu Vodka Absolut Vị vanilla 700ml 38% - 41% - Không kèm hộp",486000,486000,0,0
TIKI,bach-hoa-online,271617991,"Thùng 24 Ly Mì Lẩu Thái Tomyum NGON NGON VIFON (60g / Ly)",87000,112000,25000,22
TIKI,bach-hoa-online,10691690,"Thùng 12 hộp Nước dừa dứa VICO FRESH (1 lít / hộp)",630000,630000,0,0
TIKI,bach-hoa-online,20843221,"Thùng 24 Gói Mì Chay Rau Nấm Yomee 65g Hàng Xuất Khẩu Chất Lượng Cao Hương Vị Thơm Ngon",99000,99000,0,0
TIKI,bach-hoa-online,99078020,"Lốc 8 gói mì kim chi Ottogi 120g",72192,76800,4608,6
TIKI,bach-hoa-online,181000483,"Đặc Sản Sóc Trăng - Bánh Pía Chay Dứa Sầu Riêng Tân Huê Viên 400G, Bánh Pía Không Trứng Tân Huê Viên Sóc Trăng",68400,76000,7600,10
TIKI,bach-hoa-online,271585963,"Thùng 50 Cháo Nấm Đông Cô VIFON có Gói Nấm Thật 27gr (70g / Gói)",119000,154000,35000,23
TIKI,bach-hoa-online,136752214,"Pate gan gà 150g - Đồ Hộp Hạ Long",23000,23000,0,0
TIKI,bach-hoa-online,141755655,"Ngò Bột Tự Nhiên Vipep Hũ Nhựa 40g",12000,12000,0,0
TIKI,bach-hoa-online,127010796,"Khô gà lá chanh thơm ngon chất lượng hiệu SK FOOD - Hũ 300G",55000,55000,0,0
TIKI,bach-hoa-online,45817323,"Combo 3 gói Hạt nêm Nấm Vicook's 1KG/gói",240000,240000,0,0
TIKI,bach-hoa-online,54391656,"Thuốc mỡ bôi ngoài da trị ghẻ, xà mâu, viêm da cho chó, mèo Vemedim Diptivet - Tube 30g",21560,22000,440,2
TIKI,bach-hoa-online,165956323,"Hạt Dẻ Cười Không Tẩy Trắng Pams - Hạt Dẻ Nhập Khẩu Mỹ, Nhân Giòn Ngon, Dùng Ăn Kiêng Ăn Vặt",126000,192000,66000,34
TIKI,bach-hoa-online,59163883,"Cà Phê Nguyên Chất Baka - Robusta (Bì 500g)",100000,100000,0,0
TIKI,bach-hoa-online,154699080,"Trà hoa cúc túi lọc L'angfarm, 25 tép, hộp, mẫu quấn dây kraft",67500,75000,7500,10
TIKI,bach-hoa-online,55355952,"1Kg 2 Hũ Đậu Phộng Da Cá Nước Cốt Dừa Hiệu SK FOOD",89000,89000,0,0
TIKI,bach-hoa-online,120149810,"Miến Dẹt Khô Sợi Lớn Ottogi 400g",70876,75400,4524,6
TIKI,bach-hoa-online,59505497,"2 gói cây Lạc Tiên (mỗi gói 500G) - Cây Chùm Bao (Thân Già) Shop Thảo Dược - Chữa Tim Hồi Hộp, Hay Mất Ngủ",68000,68000,0,0
TIKI,bach-hoa-online,43822755,"Bột tỏi Toàn Gia 500g/gói",120000,120000,0,0
TIKI,bach-hoa-online,149531848,"Sữa Óc Chó Đậu Đen Hạnh Nhân Golden Health - Mẫu mới 2022",255000,255000,0,0
TIKI,bach-hoa-online,58705234,"Trà hoa cúc trắng - Trà bạch cúc (100gr)",99000,99000,0,0
TIKI,bach-hoa-online,98054803,"Bột Kem Béo Thực Vật MT35 Lúave",106036,106036,0,0
TIKI,bach-hoa-online,121361914,"Hạt Mắc Khén Doispice chuẩn loại 1 cực thơm đã làm sạch cậng và hạt đen 30g",30000,30000,0,0
TIKI,bach-hoa-online,157072340,"Trà Gạo Lứt Huyết Rồng Đậu Đen - Gừng Mật Ong Vitapro Thanh Lọc Cơ Thể, Hỗ Trợ Giảm Cân, Lợi Sữa, Ngủ Ngon – Hàng Chính Hãng",90000,90000,0,0
TIKI,bach-hoa-online,191767173,"Đặc Sản Sóc Trăng - Bánh Pía Chay Dứa Sầu Riêng Mini, Bánh Pía Không Trứng Tân Huê Viên 500G, Đặc Sản Sóc Trăng [Túi 12 Bánh]",121600,128000,6400,5
TIKI,bach-hoa-online,208120350,"Thùng Nước Mắm Nhỉ Bà Hai (6 Chai Thủy Tinh x 500ml)",68000,70000,2000,3
TIKI,bach-hoa-online,96407900,"Hạt chia shot Organic DK Harvest nhập khẩu (1 hộp 15 gói nhỏ) 15x6g",49000,49000,0,0
TIKI,bach-hoa-online,145466930,"Hộp Quà Bình An (Cà Phê Phin - Trà Lài Đặc Biệt - Trà Xanh)",360000,370000,10000,3
TIKI,bach-hoa-online,99078025,"Xốt Teriyaki Ottogi 2.25kg",172302,183300,10998,6
TIKI,bach-hoa-online,13423093,"Cát Vệ Sinh Kún Miu Hương Cà Phê Khử Mùi New X2 (8L)",45000,45000,0,0
TIKI,bach-hoa-online,116118654,"Bánh Mochi Yuki & Love Đài Loan, 210g - Vị Trà Xanh",66000,66000,0,0
TIKI,bach-hoa-online,151518475,"Combo 2 Bánh quy sữa Roma Marie Gold 240gX2",51000,51000,0,0
TIKI,bach-hoa-online,174464704,"Trà đinh lăng an thần ngủ ngon Mộc Can cải thiện tình trạng mất ngủ,khó ngủ ,ngủ không sâu giấc gói 25 túi lọc",90000,90000,0,0
TIKI,bach-hoa-online,59201430,"Ô mai Mơ - Xí muội mặn có hạt (200gr)",59000,59000,0,0
TIKI,bach-hoa-online,165947549,"Hạt Macca Úc Nứt Vỏ Pams [Tặng kèm khui hạt] Macca Hữu Cơ Nhập Khẩu Úc, Hạt A Size 25-28",219000,398000,179000,45
TIKI,bach-hoa-online,181797442,"Pate Ciao cho mèo mọi lứa tuổi",14000,14000,0,0
TIKI,bach-hoa-online,14422962,"Thức ăn cho chó Royal Canin Medium Adult 4kg",650000,650000,0,0
TIKI,bach-hoa-online,115247316,"Bột trà sữa truyền thống 3in1 Déli - 1kg ( 25 ly ) pha chế trà sữa tiện lợi, nhanh chóng",185000,190000,5000,3
TIKI,bach-hoa-online,109881757,"Thạch Viên Ngọc Trai Mật Ong 2.0kg - Hùng Chương",70278,70278,0,0
TIKI,bach-hoa-online,76682507,"Hà Thủ Ô Đỏ Chế Dạng Miếng 300g",380000,380000,0,0
TIKI,bach-hoa-online,43807302,"Tổ Yến Sào Khánh Hòa Nest - 50g ( Yến Tinh Chế )",2800000,2800000,0,0
TIKI,bach-hoa-online,76526881,"[HCM] Nước Cốt Chanh Thai Lime 500ml",55000,55000,0,0
TIKI,bach-hoa-online,177500597,"Thức ăn cho mèo Catsrang - 5kg",370000,374888,4888,1
TIKI,bach-hoa-online,174464638,"Bánh Karo bơ trứng giòn Richy 150g (10 gói x 15g) , HSD: 12 tháng, bánh Karo giòn, bánh ăn sáng ngon",44100,49000,4900,10
TIKI,bach-hoa-online,189604310,"Cà phê phin giấy Gu Người Việt DalatFarm - Hộp 10 túi x 10 g",115000,120000,5000,4
TIKI,bach-hoa-online,58836082,"Bột diếp cá sây lạnh Dalahouse - Hỗ trợ bệnh Trĩ, táo bón, thải độc cơ thể hoàn toàn tự nhiên",120000,120000,0,0
TIKI,bach-hoa-online,142320916,"1 set Trà sữa Trân châu đường đen Yoki 50g",12000,12000,0,0
TIKI,bach-hoa-online,163716501,"Combo 3 hộp trà gạo lứt + tặng cốc gốm sứ Bát Tràng cao cấp - Hộp 600g( 30gx 20 túi)",454000,660000,206000,31
TIKI,bach-hoa-online,271585939,"Thùng 30 Bánh Đa Cua VIFON (60g / Gói)",98000,126000,28000,22
TIKI,bach-hoa-online,116721309,"Thùng 24 chai Nước Khoáng Thiên Nhiên Có Ga Đảnh Thạnh Khoáng Chanh Muối 430ml",223200,223200,0,0
TIKI,bach-hoa-online,1507187,"Bột Phô Mai Tornado Vị Truyền Thống (100g / Gói)",35000,35000,0,0
TIKI,bach-hoa-online,55281817,"HẠT ĐIỀU RANG MUỐI XẾP HOA TÂN LỘC PHÁT COMBO  1KG - MỖI HỘP 500G",177000,179000,2000,1
TIKI,bach-hoa-online,174528891,"Dầu hào Lee Kum Kee Kum Chun Oyster Sauce (510g/chai)",37000,37000,0,0
TIKI,bach-hoa-online,77118744,"Hạt Điều Rang Không Muối Lafooco 450g",189000,210000,21000,10
TIKI,bach-hoa-online,58965697,"Kẹo dẻo trái cây không chất béo và gluten Black Forest Organic Gummy Bears 1.47Kg (Hộp 65 gói) - Nhập khẩu Mỹ",853000,1706000,853000,50
TIKI,bach-hoa-online,136190451,"Pate gan gà 90g - Đồ Hộp Hạ Long",15400,15400,0,0
TIKI,bach-hoa-online,1012268,"Sữa Cho Chó Mèo Bio (100g)",38888,38888,0,0
TIKI,bach-hoa-online,190743188,"Combo 2 hộp Trà thảo mộc Quê Việt + tặng bình nước- Mát gan, ngủ ngon, giảm căng thẳng mệt mỏi, nguyên liệu hữu cơ - hộp 600g (20X30g)",346000,389000,43000,11
TIKI,bach-hoa-online,73475974,"Nhân Óc Chó Smile Nuts Hộp (165g - 350g) | Nhập khẩu từ Chile, hàng được nhập quanh năm, luôn mới và thơm ngon",85000,114000,29000,25
TIKI,bach-hoa-online,204431124,"Combo 2 gói macca sấy nứt vỏ cao cấp Minh Quang (500g x 2) - Hạt dinh dưỡng cho bà bầu, trẻ em, làm sữa hạt, hỗ trợ làm đẹp - kèm đồ khui",255000,255000,0,0
TIKI,bach-hoa-online,138956237,"[Combo 10 lọ] Nước Yến sào Sanvinest Khánh Hòa dành cho trẻ em đóng lọ 62ml - 2011",343000,350000,7000,2
TIKI,bach-hoa-online,199952979,"Cà phê viên nén Carraro Hazenut Coffee - Tương thích với máy capsule Nespresso",92340,97200,4860,5
TIKI,bach-hoa-online,50130166,"Đặc Sản Phan Thiết - Nước Mắm Tĩn Tôm Biển Độ Đạm 45N Tự Nhiên Chai 500Ml Hồng Ngọc Đại Dương Nước Mắm Nguyên Chất Truyền Thống Sạch Cốt Nhĩ Đặc Biệt Từ Tôm Biển Tươi Không Chất Bảo Quản.",250000,350000,100000,29
TIKI,bach-hoa-online,116101899,"Bôt pha trà sữa Déli 1kg+ Hồng trà Déli 500gr+ Trân châu caramel Déli 1kg [COMBO nguyên liệu pha chế trên 40ly trà sữa trân châu] HSD: 12 tháng",242000,242000,0,0
TIKI,bach-hoa-online,10285584,"Máy Lọc Thác Nước Bể Cá",89000,89000,0,0
TIKI,bach-hoa-online,16690976,"Thùng 72 lọ Yến Sào Win'snest Kids Tổ Yến Chưng Sẵn Dành Cho Trẻ 20% (70 Ml/ Lọ)",2202690,4319000,2116310,49
TIKI,bach-hoa-online,81787154,"Gạo thơm thượng hạng - Nàng Sen Yêu Thương",195000,195000,0,0
TIKI,bach-hoa-online,66924594,"Rượu Vang Mật Ong Ladofoods Sweet Honey Wine 750ml 12% - Không Kèm Hộp",156000,190000,34000,18
TIKI,bach-hoa-online,76688612,"Bột Ngũ Cốc Nảy Mầm TAMI",164000,164000,0,0
TIKI,bach-hoa-online,138956289,"[Combo 30 lọ] Nước yến sào Sanvinest Khánh Hòa dành cho người cao tuổi đóng lọ 70ml",1048000,1080000,32000,3
TIKI,bach-hoa-online,59166250,"Thức ăn cho chó trưởng thành Ganador vị thịt cừu & gạo Lamb & Rice 400gr",20844,20844,0,0
TIKI,bach-hoa-online,272199557,"Hạt nêm rau củ Massel Úc 100% từ rau củ thảo mộc bảo vệ sức khỏe, dành cho ăn chay, ăn mặn, ăn kiêng, và cho bé ăn dặm - Massel Official",93000,186000,93000,50
TIKI,bach-hoa-online,73836097,"Trà Hoa Cúc Túi Lọc Hùng Phát Thanh Nhiệt Cơ Thể An Giấc Ngủ Ngon Hỗ Trợ Tim Mạch Hộp 25 Gói",40000,40000,0,0
TIKI,bach-hoa-online,140229136,"Hủ tiếu Nhịp sống Chay Nam Vang (Thùng 30 gói)",299000,299000,0,0
TIKI,bach-hoa-online,99078052,"Giấm Táo Ottogi can 2L",70218,74700,4482,6
TIKI,bach-hoa-online,72779239,"Combo 4 Bánh Tráng Siêu Mỏng Tây Ninh Tinh Nguyên (180g/bịch)",53900,68000,14100,21
TIKI,bach-hoa-online,19517171,"Bột Cỏ Lúa Mì Lematie (Túi Zip 100g)",200000,200000,0,0
TIKI,bach-hoa-online,94713001,"Đặc Sản Phú Quốc - Hộp 2 Chai Thủy Tinh Nước Mắm Phú Quốc Khải Hoàn 43 Độ Đạm (520Ml X 2) - Ocop 5 Sao",215000,243000,28000,12
TIKI,bach-hoa-online,57805943,"Combo 3 loại Natural Gia vị nấu phở Dh Foods",49500,49500,0,0
TIKI,bach-hoa-online,72867474,"Cà phê rang xay Chế Phin 5 Trung Nguyên -06 Bịch 500gam( Quà tặng Kèm - Lon sữa đặc)",1450000,1450000,0,0
TIKI,bach-hoa-online,872746,"Trà Xanh Sơn Tiệm B - Shan Tuyết Cổ Thụ (100g)",220000,220000,0,0
TIKI,bach-hoa-online,57695075,"Lá Vối Khô Shop Thảo Dược Gói 250G - Hỗ Trợ Giảm Mỡ Máu, Gout, Thanh Nhiệt, Lợi Tiểu, Đào Thải Độc Tố",40000,40000,0,0
TIKI,bach-hoa-online,51731937,"Trà thải độc diếp cá Dokudami Orihiro Nhật Bản túi 60 gói",109000,109000,0,0
TIKI,bach-hoa-online,51600753,"Nước cốt hoa Atiso đỏ BerryLand 500ml",32000,38000,6000,16
TIKI,bach-hoa-online,126085398,"Bột ngũ cốc dinh dưỡng Good Lady Singapore - Mầm lúa mì - 22 Nutrimix Complete Wheat Grass (750g)",639000,639000,0,0
TIKI,bach-hoa-online,50488055,"Trà Xanh Thượng Hạng  Tân Cương Thái Nguyên Khánh Nga 500g",140000,140000,0,0
TIKI,bach-hoa-online,484398,"Đồ Ăn Cho Chó Vị Thịt Bò Và Các Loại Rau Củ Pedigree Dạng Túi 1.5kg",109000,150000,41000,27
TIKI,bach-hoa-online,56738371,"CƠM GẠO LỨT RONG BIỂN TÂN LỘC PHÁT - HŨ 500G",42300,47000,4700,10
TIKI,bach-hoa-online,29936637,"Bột trà xanh Matcha Gold - túi 100g",149000,185000,36000,19
TIKI,bach-hoa-online,73089741,"Rượu Vodka Absolut Vị mâm xôi Raspberri 700ml 37% - 39% - Không kèm hộp",489000,489000,0,0
TIKI,bach-hoa-online,151554001,"Gói Hạt Nêm Aji-ngon® Gà 3kg/Gói",160000,160000,0,0
TIKI,bach-hoa-online,81550141,"Sôcôla Thanh 13 Vị Schogetten - Trắng - 100g",50220,54000,3780,7
TIKI,bach-hoa-online,57085425,"COMBO 2 HŨ CƠM GẠO LỨT RONG BIỂN THƠM NGON",85000,85000,0,0
TIKI,bach-hoa-online,73398472,"[Hộp quà ngang 5 lon x 190ml/ lon] Nước Yến Sào SkyNest 3% Tổ Yến thật, Giải khát nhanh gọn, Tốt cho sức khỏe",80000,80000,0,0
TIKI,bach-hoa-online,125858399,"Xốt cá chiên chai PET Cholimex 280g",20500,20500,0,0
TIKI,bach-hoa-online,77767785,"Combo 2 Túi Cà Phê Hòa Tan 3in1 King Coffee - Túi 45 gói x 16gam",260000,260000,0,0
TIKI,bach-hoa-online,1064956,"Cà Phê Gourmet Blend Trung Nguyên (500g)",165000,165000,0,0
TIKI,bach-hoa-online,138374191,"[VEGAN] XỐT PHỞ HiXOT hũ 220gram, gia vị hoàn chỉnh, không cần nêm nếm",55000,55000,0,0
TIKI,bach-hoa-online,16683912,"Combo Xốt gia vị hoàn chỉnh Barona: 1 gói Thịt Nướng Hàn Quốc (80gr) + 1 gói Thịt Nướng Ngũ Vị (80gr) + 1 gói Thịt Nướng Sả (80gr)",34560,38400,3840,10
TIKI,bach-hoa-online,104911554,"Combo Dashi Nhật Bản 2 chai 320g, 340g",247000,247000,0,0
TIKI,bach-hoa-online,160324612,"Bột Ngũ Cốc Hải Dung không đường 500g, gồm 6 loại hạt, sản xuất tự nhiên 100%, thơm ngon bổ dưỡng, tốt cho sức khỏe",60000,80000,20000,25
TIKI,bach-hoa-online,10190871,"Đồ Ăn Chó Trưởng Thành SmartHeart Power Pack (3Kg)",181400,181400,0,0
TIKI,bach-hoa-online,3678613,"Combo 2 hộp Sữa bột nguyên kem của NutiFood dinh dưỡng hàng ngày cho mọi người (900g/hộp)",370000,690000,320000,46
TIKI,bach-hoa-online,914850,"Trà Atisô Túi Lọc Mẫu Truyền Thống Thái Bảo (60 Tép / Hộp)",109000,109000,0,0
TIKI,bach-hoa-online,4668709,"Bột sữa trà xanh Matcha Milk 200g Nhật Bản",139000,139000,0,0
TIKI,bach-hoa-online,5444935,"Bột Tỏi Natas Hũ 65g-Bột Gia Vị Tiện Dụng",20000,20000,0,0
TIKI,bach-hoa-online,59279512,"Combo 2 Lon Sữa bột Suremilk Canxi 800g - Tặng 2 lọ yến Tranest",575000,575000,0,0
TIKI,bach-hoa-online,141734891,"Trà gạo lứt đậu đen hoa nhài hoa cúc detox thanh lọc giảm stress Brown Rice",80000,80000,0,0
TIKI,bach-hoa-online,117785869,"Đặc Sản Buôn Mê Thuột - Cà Phê Đặc Sản Aeroco A4, Hộp 250G, Pha Phin, Nguyên Chất 100% Rang Mộc Hậu Vị Ngọt Thơm Quyến Rũ",290400,290400,0,0
TIKI,bach-hoa-online,141367824,"NGŨ CỐC DINH DƯỠNG MIN MIN 29 HẠT - Ngũ Cốc Mẹ Bầu 1kg (2 hộp)",250000,250000,0,0
TIKI,bach-hoa-online,125918673,"Dầu hào chay Cholimex 350g",22000,22000,0,0
TIKI,bach-hoa-online,125918668,"Tương ớt Cholimex Sriracha 520g",23500,23500,0,0
TIKI,bach-hoa-online,55525024,"Mắm Ruốc Huế Sông Hương Foods Hũ 430g",63000,63000,0,0
TIKI,bach-hoa-online,77765375,"Combo 2 Hộp Cà Phê Đen Hòa Tan Espresso King Coffee(Hộp 100 gói x 2.5g)",700000,700000,0,0
TIKI,bach-hoa-online,199952624,"Cà Phê Viên Nén Carraro BRASILE Aluminum Mới - 10 viên - Tương thích với máy capsule Nespresso",91000,97200,6200,6
TIKI,bach-hoa-online,55038590,"Đặc Sản Phan Thiết - Combo 2 Bình Gốm Nước Mắm Tôm Biển 60N",800000,1600000,800000,50
TIKI,bach-hoa-online,35943408,"Miso Dashi Trộn Sẵn Marukome 375g",138000,138000,0,0
TIKI,bach-hoa-online,137153331,"Bột Hành Natas Hũ 60g-Bột Gia Vị Tiện Dụng",27000,27000,0,0
TIKI,bach-hoa-online,154189642,"Bột đậu xanh nguyên chất Hải Dung 500g (10 gói 50g), 100% đậu xanh tự nhiên, hỗ trợ thải độc, đẹp da, giảm cân, tốt cho sức khỏe",55000,70000,15000,21
TIKI,bach-hoa-online,182474365,"Đặc Sản Phan Thiết - Nước Mắm Nhỉ 40 Độ Đạm Làng Chài Xưa Chai Thủy Tinh 500Ml Ủ Chượp 2 Lần Không Chất Bảo Quản - Nước Mắm Tĩn",93000,150000,57000,38
TIKI,bach-hoa-online,33388334,"Xịt Xua Đuổi Vật Nuôi Fay Repell chống chó mèo cắn phá đồ",58000,58000,0,0
TIKI,bach-hoa-online,107367686,"Xí muội chua ngọt - Ô mai đào (500gr)",95000,95000,0,0
TIKI,bach-hoa-online,154698896,"Trà nụ vối túi lọc L'angfarm, 25 tép, hộp, mẫu quấn dây kraft",52200,58000,5800,10
TIKI,bach-hoa-online,120156053,"Bánh gạo Tokbokki Jin Ottogi nhiều vị gói 164g",35720,38000,2280,6
TIKI,bach-hoa-online,88820846,"Rau Má Uống Liền ORAMA có đường 10 gói - 15g mỗi gói - rau má tươi nguyên chất, tăng cường dinh dưỡng",76500,85000,8500,10
TIKI,bach-hoa-online,172174030,"[CHÍNH HÃNG] Rau Má Uống Liền Sấy Lạnh Nguyên Chất  - Mát gan, detox, giảm mụn, giảm cân, giải nhiệt - Hộp Ko Đường",88000,150000,62000,41
TIKI,bach-hoa-online,166480179,"Đặc Sản Kon Tum - Trái Sơn Tra Táo Mèo Khô Hiệu Đặc Sản Và Dược Liệu Kon Tum (1Kg) - OCOP 3 Sao",90000,90000,0,0
TIKI,bach-hoa-online,193589200,"Đậu Phộng Chiên Muối Viettinmart 500g",60000,60000,0,0
TIKI,bach-hoa-online,52493118,"Đậu đen xanh lòng Rang Mộc - Cỏ Ngọt - Hà Thủ Ô 500G (Hạt Rời) - Mộc Thanh Trà",96000,96000,0,0
TIKI,bach-hoa-online,75368561,"Hạt quinoa (diêm mạch) đen (Black Quinoa) Peru-Nam Mỹ",43000,43000,0,0
TIKI,bach-hoa-online,58635575,"Trà Oolong ( Ô Long/ OLong) Thượng Hạng Nguyên Chất Bảo Lộc Vũ Gia (400gr/hũ)",580000,580000,0,0
TIKI,bach-hoa-online,57356730,"KHÔ BÒ MIẾNG TÂN LỘC PHÁT - HŨ 150G",49500,55000,5500,10
TIKI,bach-hoa-online,193094530,"Rượu Lady Triệu DaLat Flowerbomb Gin 43% 1x200ml",326700,363000,36300,10
TIKI,bach-hoa-online,164557006,"Nước Yến sào Sanvinest Khánh Hòa đóng lọ 70ml",698000,698000,0,0
TIKI,bach-hoa-online,275091003,"[BIA ĐỨC_SINCE 1810] Combo 2 Thùng Bia Tươi Thầy Tu Zwick’l Naturtrüb Dunkel 6.7 ĐỘ - Bia Tươi Men Sống Thượng Hạng - Nhập Khẩu Chính Hãng",1039000,1039000,0,0
TIKI,bach-hoa-online,51841360,"Thùng cháo yến mạch gạo lứt ăn liền - TÂM MINH FOODS (50g x 30 gói)",330000,330000,0,0
TIKI,bach-hoa-online,56230327,"1Kg Quả Óc Chó Hàng Nhập Khẩu Cao Cấp Bổ Dưỡng - 2 Túi Zip",175000,175000,0,0
TIKI,bach-hoa-online,192926491,"Đường Maltodextrin DE 15-20% AMBUJA 1kg (chiết lẻ từ bao 25kg)-Ấn Độ",49000,49000,0,0
TIKI,bach-hoa-online,3497883,"Sữa bổ sung dinh dưỡng hàng ngày cho người trưởng thành Nuti Enplus Gold 900 Gr ",482000,630000,148000,23
TIKI,bach-hoa-online,188043089,"01 lon sữa Leanpro Thyro 900g - Dinh dưỡng cho người bệnh tuyến giáp, suy giáp",671564,671564,0,0
TIKI,bach-hoa-online,14693711,"Thức ăn cho mèo Royal Canin Indoor 27 400gr",133333,133333,0,0
TIKI,bach-hoa-online,177499829,"THỨC ĂN CHO CHÓ DOG MANIA dành cho mọi lứa tuổi túi 5kg",299999,299999,0,0
TIKI,bach-hoa-online,107018001,"Bánh Bông Lan Hura Deli Chocolate - Dừa 336g",54500,67800,13300,20
TIKI,bach-hoa-online,83645373,"Bột ngũ cốc nhân sâm Goce - 180g (18 gói x 10g)",75000,125000,50000,40
TIKI,bach-hoa-online,185964590,"Viên nén chăm sóc sức khỏe đặc biệt cho chó mèo - Bổ sung canxi, vi lượng, men tiêu hóa, dưỡng lông",1485,1485,0,0
TIKI,bach-hoa-online,69174535,"SIRO ĐƯỜNG ĐEN LOFACO - 2.5KG - NGUYÊN LIỆU DÙNG PHA CHẾ ĐỒ UỐNG - TRÀ SỮA (Trà Lộc Phát)",210000,210000,0,0
TIKI,bach-hoa-online,111198838,"LẠC RANG HÚNG LÌU KHANG HY 500g",60000,60000,0,0
TIKI,bach-hoa-online,162195527,"Xốt Gia Vị Hoàn Chỉnh Barona - Rô-Ti 80g",11520,12800,1280,10
TIKI,bach-hoa-online,141646053,"Mua 3 gói tặng 1gói Cà phê Rang xay Truyền thống Highlands Coffee 200g",311000,311000,0,0
TIKI,bach-hoa-online,56015072,"Trà gạo lứt đậu đen xanh lòng (1kg) - Hỗ trợ giảm cân ,thanh nhiệt, mát gan, lợi sữa",110000,130000,20000,15
TIKI,bach-hoa-online,107018017,"Bánh Dinh Dưỡng Mumsure 165 gam  bibica vị cam - Sản phẩm dinh dưỡng dành cho phụ nữ mang thai",32900,32900,0,0
TIKI,bach-hoa-online,184781821,"Xốt Gia Vị Hoàn Chỉnh Barona - Nướng BBQ",11520,12800,1280,10
TIKI,bach-hoa-online,13362625,"Nước Ép Vải Malee 1L (Thái Lan)",76100,76100,0,0
TIKI,bach-hoa-online,58911128,"cafe LeeLong5 gu dịu (15 Robusta / 85 Arabica)",290000,290000,0,0
TIKI,bach-hoa-online,9840084,"Mắm tôm Lê Gia can 4,8L",268800,268800,0,0
TIKI,bach-hoa-online,63271058,"Hạt dổi nếp - Rừng tây bắc (50gr)",99000,99000,0,0
TIKI,bach-hoa-online,1507193,"Combo 5 Bột Phô Mai Tornado Vị Truyền Thống (30g / Gói)",60000,60000,0,0
TIKI,bach-hoa-online,58947287,"Siro Pha Chế Vị Đào Đỏ Torani Classic Peach Syrup 750ml Mỹ",199800,199800,0,0
TIKI,bach-hoa-online,89248172,"Flor 500 For Fish – Kháng Sinh Trị Các Bệnh Nhiễm Trùng Trên Cá (gói 100g)",55000,55000,0,0
TIKI,bach-hoa-online,271585922,"Thùng 12 Tô Vifon Bánh Đa Cua (125g / Tô)",70000,90000,20000,22
TIKI,bach-hoa-online,147354773,"[Combo 10 lọ] Nước Yến sào Khánh Hòa Sanest Collagen đóng lọ 70ml - 770",352800,360000,7200,2
TIKI,bach-hoa-online,172161856,"[CHÍNH HÃNG] Bột Rau Má Uống Liền Quảng Thanh có đường 10 gói - 15g mỗi gói - rau má tươi nguyên chất, tăng cường dinh dưỡng",82000,135000,53000,39
TIKI,bach-hoa-online,124476601,"10 viên Sanpet tẩy sán dây, sán lá, giun tròn chó mèo",48999,48999,0,0
TIKI,bach-hoa-online,135390014,"MẬT DỪA NƯỚC ÔNG SÁU - 375g - MEKONG HOME",109000,109000,0,0
TIKI,bach-hoa-online,125858361,"Tương đen Cholimex 2,1kg",65000,65000,0,0
TIKI,bach-hoa-online,134286375,"(Combo 02 chai) Nước Mắm Tĩn Cá Cơm Vàng Ruột Đỏ Độ Đạm 60N Tự Nhiên Chai Thuỷ Tinh 250ml Nước Mắm Rin Nguyên Chất Truyền Thống Sạch Nước Mắm Nhỉ Từ Thùng Lều Gỗ Cốt Nhĩ Đặc Biệt Cá Cơm Vàng Ruột Đỏ Muối Tinh Khiết, Sánh Đặc Thịt Cá, Không Chất Bảo Quản",220000,360000,140000,39
TIKI,bach-hoa-online,117101347,"Combo 02 bánh mỳ hoa cúc Harrys Brioche Mini 210g",206000,206000,0,0
TIKI,bach-hoa-online,19910872,"Mắm Tép Ba Làng Thanh Hóa 1kg loại đặc biệt",139000,139000,0,0
TIKI,bach-hoa-online,76470616,"Bột cỏ lúa mì hữu cơ Dragon superfoods 150gr Wheat grass Dragon superfoods 150gr",310000,410000,100000,24
TIKI,bach-hoa-online,172632083,"Muối Sả Ớt Natas Hũ 60g-Muối Đa Năng",23000,23000,0,0
TIKI,bach-hoa-online,22881960,"1KG ĐẬU NÀNH SẤY GIÒN HIỆU TÂN LỘC PHÁT ( 2 HŨ PET)",99000,99000,0,0
TIKI,bach-hoa-online,2245159,"Bắp Rang Uncle Jax Vị Trà Xanh (70g)",21000,21000,0,0
TIKI,bach-hoa-online,181361249,"Combo 2 Hộp Cà Phê Rang Xay Pha Phin Premium Blend - Lon 425gr (Vị đậm, mùi thơm, cafein 1%)",453780,504200,50420,10
TIKI,bach-hoa-online,95101277,"2 Túi Trà Thảo Mộc Kingtea 500g Tặng 1 túi 200g - Tốt Cho Người Đau Dạ Dày, Ổn Định Huyết Áp, Hạ Men Gan , Mỡ Máu Và Ngăn Ngừa Ung Thư Giúp Ngủ Ngon",299000,299000,0,0
TIKI,bach-hoa-online,86803689,"Hạnh nhân sấy Hodi - NaVi hũ nhựa 250g",87000,87000,0,0
TIKI,bach-hoa-online,64216049,"Hộp quà Cà phê Sáng tạo 8 Trung Nguyên",1100000,1100000,0,0
TIKI,bach-hoa-online,129222561,"Mì Hảo Hảo Chay rau nấm (Thùng 30 gói x 74 gram)",141000,141000,0,0
TIKI,bach-hoa-online,138956329,"[Combo 20 lọ] Nước Yến sào Khánh Hòa Sanest đóng lọ 70ml",698000,720000,22000,3
TIKI,bach-hoa-online,166088529,"Combo 3 Đường đen nữ hoàng Biên Hòa 1kg/túi",165000,165000,0,0
TIKI,bach-hoa-online,2154977,"Nước Ép Cherry Và Hỗn Hợp Rau Quả Malee 1L (Thái Lan)",76100,76100,0,0
TIKI,bach-hoa-online,154187234,"Tặng Kèm Công Thức - Sốt Pesto Đặc Trưng Ý Divella 190g – Pesto Sauce",88000,88000,0,0
TIKI,bach-hoa-online,74195239,"Đường Erythritol 100% Tự Nhiên Không Calo 500G JC BLUEMOON",178000,178000,0,0
TIKI,bach-hoa-online,5444933,"Muối tôm Natas Hũ 70g-Muối Đa Năng",18000,18000,0,0
TIKI,bach-hoa-online,90111470,"Trà Diệp hạ châu ĐB dược liệu sạch chuẩn GACP, Mát gan, giải độc gan Hộp 20 túi lọc tiện lợi",60000,60000,0,0
TIKI,bach-hoa-online,193588547,"Bắp Sấy Hành Viettinmart 500g",70000,70000,0,0
TIKI,bach-hoa-online,128302707,"[CHÍNH HÃNG] Bột Lá Sen Quảng Thanh 100% Nguyên Chất Sấy Lạnh - Ngủ ngon, giảm mỡ máu, giảm cân  - Gói 100 gr",199000,290000,91000,31
TIKI,bach-hoa-online,111757171,"Muối Tôm Siêu Cay Fadely (65g)",11500,13000,1500,12
TIKI,bach-hoa-online,111188304,"LẠC RANG HÚNG LÌU KHANG HY 400g",48000,48000,0,0
TIKI,bach-hoa-online,166088561,"Combo_6_Lon Nước Mía Tắc Tự Nhiên MÍAHA dung tích 240ml/Lon",78000,78000,0,0
TIKI,bach-hoa-online,14980082,"Đậu Hà Lan vàng tách đôi Yellow Split Peas",22000,22000,0,0
TIKI,bach-hoa-online,26812103,"Tã giấy vệ sinh cho chó - dùng lót khay vệ sinh hoặc lót chuòng chó",32999,32999,0,0
TIKI,bach-hoa-online,169193258,"Thùng Sữa Hạt Vegemil Đậu Đen 190ml (16 Hộp/Thùng)",239000,280000,41000,15
TIKI,bach-hoa-online,155560912,"Combo 2 Loại Tương Ông Chà Và 10g (1 Hộp Tương Ớt Gói 10g Và 1 Hộp Tương Cà Gói 10g)",146000,146000,0,0
TIKI,bach-hoa-online,111779121,"Muối Hồng Tiêu Fadely (65g)",11500,13500,2000,15
TIKI,bach-hoa-online,86757015,"Trà tim sen sấy khô Cao Cấp gói 250G - Tốt cho người bị khó ngủ, mất ngủ kinh niên - Quà tặng cho người lớn tuổi - Nhập mã khuyến mãi khi mua từ 2 gói để tiết kiệm hơn",95000,95000,0,0
TIKI,bach-hoa-online,35606302,"BỘT SẮN DÂY NGUYÊN CHẤT MẸ KEN (1kg) (BÁN THEO MÙA)",175000,175000,0,0
TIKI,bach-hoa-online,24941640,"Combo 2 hủ gạo lứt cháy tỏi Dương Cát 300gr",127200,127200,0,0
TIKI,bach-hoa-online,8711440,"Combo 2 gói kẹo hồng sâm Hàn Quốc Kgs 300g",129000,129000,0,0
TIKI,bach-hoa-online,54282693,"Combo 12 hũ tiêu ngào đường đặc sản Phú Quốc",310000,310000,0,0
TIKI,bach-hoa-online,162735882,"Cà phê Rang Xay Arabica Cầu Đất 500g  - The Kaffeine Coffee",159000,159000,0,0
TIKI,bach-hoa-online,115273254,"Bộ 6 túi thức ăn cho chó lớn dạng sốt Pedigree vị gan nướng và rau 130g",107160,114000,6840,6
TIKI,bach-hoa-online,3630615,"Bàn cào móng cho mèo ",42999,42999,0,0
TIKI,bach-hoa-online,1717725,"Canxi Cho Chó Mèo Calcium Phosphorus Petag (50 Viên)",270000,270000,0,0
TIKI,bach-hoa-online,178034608,"SỮA CHUA DỪA SÁP SẤY KHÔ GIÒN TAN",73000,95000,22000,23
TIKI,bach-hoa-online,100287124,"Kẹo the Fres Apple Peach (xanh lá) Bịch 150g",19000,19000,0,0
TIKI,bach-hoa-online,153404093,"Trà Gừng Mật Ong Thanh Bình - Hộp 320g/20 gói, ấm bụng ngừa cảm cúm, tăng đề kháng, sản phẩm hỗ trợ tốt trong mùa dịch",51000,51000,0,0
TIKI,bach-hoa-online,76145335,"Trà Oolong (Ô Long/Olong) Cao Cấp Nguyên Chất Vũ Gia (200g/hũ)",250000,250000,0,0
TIKI,bach-hoa-online,59091309,"Combo 6 + TẶNG 1 Lọ cùng loại (7 lọ x 70ml Nước yến sào SkyNest Kid Gold 15% Tổ Yến cho trẻ nhỏ",364000,364000,0,0
TIKI,bach-hoa-online,2385977,"Muối Tôm Tây Ninh Tinh Nguyên (150g)",20900,24000,3100,13
TIKI,bach-hoa-online,1701837,"Xịt Khử Mùi Chuồng Trại Fay Deodor (350ml)",47997,47997,0,0
TIKI,bach-hoa-online,93949838,"Bánh Đa Nem Đa năng Hà Nội Xưa (ăn sống/cuộn nem)- Hàng xuất khẩu Nhật- 200G",27000,27000,0,0
TIKI,bach-hoa-online,197544241,"Khăn ướt đa năng cho chó mèo Borammy",29000,29000,0,0
TIKI,bach-hoa-online,94262405,"Sữa tắm Bio Lovely Pet (450ml) dưỡng lông chó mèo siêu mượt, khử mùi hôi",88000,88000,0,0
TIKI,bach-hoa-online,173534076,"Tinh Bột Nghệ Mộc Sắc Siêu Thị Thiên Nhiên Sấy Lạnh Nguyên Chất Tốt Cho Dạ Dày Nâng Cao Sức Khỏe, Tốt Cho Phụ Nữ Sau Sinh – Hàng Chính Hãng",160000,160000,0,0
TIKI,bach-hoa-online,154698853,"Kẹo hương thập cẩm dẻo L'angfarm, 350g, bịch, mẫu kraft 1 mặt trong",43200,48000,4800,10
TIKI,bach-hoa-online,99084276,"Combo Ngon miệng đưa cơm 2 chai 340g",187000,187000,0,0
TIKI,bach-hoa-online,145178134,"Đặc Sản Phan Thiết - [Mua 3 Tặng 3] Mua 3 Nước Tương Shiitake Tặng 3 Nước Mắm Shiitake Chai Nhựa Cao Cấp 525Ml Từ Nấm Ngọt Shiitake Và Đậu Nành Nhật Bản",360000,720000,360000,50
TIKI,bach-hoa-online,63999595,"Khô Bò Miếng Cay Mềm Thương Hiệu SK FOOD - Bịch 500G",340000,340000,0,0
TIKI,bach-hoa-online,173971619,"Sốt Mì Ý Cà Chua & Nấm Prego 300g (Thương Hiệu Mỹ - SX Malaysia)",46100,46100,0,0
TIKI,bach-hoa-online,6570263,"Dung dịch nhỏ mắt trị viêm mắt chó mèo genta drop 10ml",8999,8999,0,0
TIKI,bach-hoa-online,105358478,"Trà Hà Chúc Cascara hoa cúc - Hộp 50g",125000,125000,0,0
TIKI,bach-hoa-online,64000297,"1Kg Khô Bò Miếng Loại Cay Mềm Cao Cấp Thương Hiệu SK FOOD",499000,499000,0,0
TIKI,bach-hoa-online,148635468,"Gạo Lứt Tím đóng túi 1KG Vinh Hiển - Đạt chuẩn HACCP - Ngọt cơm, dinh dưỡng",47000,48000,1000,2
TIKI,bach-hoa-online,3528981,"Sữa bột giúp phòng ngừa loãng xương, xơ vữa động mạch và tiểu đường GIGO SURE Hồng sâm 900 Gr (JISENG)",245000,380000,135000,36
TIKI,bach-hoa-online,114197919,"[TÂM CHÂU] Trà Xanh Móc Câu Đặc Biệt 250G",75000,75000,0,0
TIKI,bach-hoa-online,14397805,"10 hũ nước Yến Sào Sanest Có Đường (70ml)",375000,375000,0,0
TIKI,bach-hoa-online,154698832,"Mận sấy dẻo L'angfarm, 300g, bịch, mẫu kraft 1 mặt trong",92700,103000,10300,10
TIKI,bach-hoa-online,76688320,"Combo 2 sản phẩm Gạo Ông Thọ - Lứt Ngọc Đỏ túi 1kg hút chân không cao cấp. Gạo sạch hữu cơ dinh dưỡng cho sức khỏe",71000,71000,0,0
TIKI,bach-hoa-online,110021941,"Combo 2 hộp khô bò Thu Ba miếng 500gr (tặng 1 gói 100gr trị giá 94K)",940000,940000,0,0
TIKI,bach-hoa-online,154699098,"Đậu hoà lan muối L'angfarm, 225g, bịch, mẫu kraft 1 mặt trong",35100,39000,3900,10
TIKI,bach-hoa-online,51498472,"Cà Phê Sữa Hòa Tan 3IN1 KING COFFEE - Túi 50 gói x 24g",210000,210000,0,0
TIKI,bach-hoa-online,106381086,"Thùng 24 lon Cà Phê sữa HIGHLANDS COFFEE 235ml",328000,333000,5000,2
TIKI,bach-hoa-online,106685390,"Bột socola đen ăn kiêng GUfoods - Eat Clean, Làm đẹp, Giảm cân",74000,159000,85000,53
TIKI,bach-hoa-online,161493652,"Thùng 48 hộp sữa chua uống tiệt trùng hương việt quất tự nhiên TH True Yogurt 180ml (180ml x 48)",374000,385223,11223,3
TIKI,bach-hoa-online,136186279,"CATSRANG -  Thức ăn cho mèo trưởng thành",150000,150000,0,0
TIKI,bach-hoa-online,33544809,"Hạt Mix 3 Loại (Óc chó - Hạt Macca - Hạnh Nhân)",155000,179000,24000,13
TIKI,bach-hoa-online,99077932,"Rong biển tẩm gia vị ăn liền Ottogi 12.6g (lốc 3 gói)",24440,26000,1560,6
TIKI,bach-hoa-online,25412380,"Thùng 24 Chai Nước Tăng Lực Có Gas Warrior Vị Dâu 330ml",195000,250000,55000,22
TIKI,bach-hoa-online,154699057,"Thập cẩm sấy L'angfarm, 400g, bịch, mẫu mawashi",85500,95000,9500,10
TIKI,bach-hoa-online,116391615,"Combo TRÀ HIBISCUS VÔ THƯỜNG giúp giảm cân và TRÀ LẠC TIÊN giúp ngủ ngon",160000,160000,0,0
TIKI,bach-hoa-online,190170723,"Thùng 72 lọ Yến sào wins'Nest 20% chưng sẵn nguyên chất nhân sâm ít đường (70ml/lọ)",2377000,4608000,2231000,48
TIKI,bach-hoa-online,146392461,"1 hộp(500g) Ngũ Cốc Lợi Sữa Min Min Care dạng lon- Chuyên Lợi Sữa và Phục Hồi Sức Khỏe Sau Sinh",270000,270000,0,0
TIKI,bach-hoa-online,70520632,"Nước Yến Sào win'sNest Đường Phèn 12% (6 Lọ * 70 ml / Hộp) Kèm túi xách",146000,310000,164000,53
TIKI,bach-hoa-online,68702947,"Hạt Bắp Nổ, Bắp Rang Bơ thơm ngon RealFood (100g, 500g, 1KG)",15000,15000,0,0
TIKI,bach-hoa-online,76450798,"Sữa Tiệt Trùng Ít Đường VPMilk Grow+ Hộp 180ml (Thùng 48 Hộp)",387000,423100,36100,9
TIKI,bach-hoa-online,116692791,"Thùng 24 chai Nước Khoáng Thiên Nhiên Có Ga Đảnh Thạnh Khoáng Chanh 430ml",223200,223200,0,0
TIKI,bach-hoa-online,893754,"Cà phê rang xay Rita Võ Cafe Culi 250g",95000,95000,0,0
TIKI,bach-hoa-online,126939471,"DA CÁ LẮC TRỨNG MUỐI GIÒN NGON - HŨ 200G HIỆU SK FOOD",69900,69900,0,0
TIKI,bach-hoa-online,52815089,"NƯỚC CỐT HẦM XƯƠNG HIROSHI - hàng nội địa Nhật Bản",265000,265000,0,0
TIKI,bach-hoa-online,61994470,"Combo Táo đỏ - Kỷ tử - Mỗi hủ 200gr",135000,135000,0,0
TIKI,bach-hoa-online,101824754,"THÙNG 30 GÓI - MÌ MAMA CHAY HƯƠNG RAU CỦ 60G",240000,240000,0,0
TIKI,bach-hoa-online,13558236,"Gia Vị Bò Kho Barona 80g ươp ngon chuẩn vị không cần nêm nếm - Combo",11520,12800,1280,10
TIKI,bach-hoa-online,74783875,"Bột Chanh Hòa Tan Chavi - Hộp 400gr",77000,77000,0,0
TIKI,bach-hoa-online,193927187,"Tinh Bột Củ Sen 100% Nguyên Chất - Cung cấp đầy đủ dưỡng chất cho cơ thể ( Hủ 500gr)",389000,389000,0,0
TIKI,bach-hoa-online,56643116,"Táo Mèo Khô Shop Thảo Dược Gói 500G - Táo mèo Tây Bắc sấy khô kỹ, Giúp giảm đầy Bụng, chướng Bụng, Kén Ăn, thích hợp cho ngâm... hoặc ngâm chung với chuối hột",35000,35000,0,0
TIKI,bach-hoa-online,125735739,"[Thùng 40 gói x 50gram] Cháo Tổ Yến Đậu Xanh Thịt Bằm - Yến Đại Phát 4 gói gia vị, ăn liền, tiện lợi, thơm ngon.",504000,504000,0,0
TIKI,bach-hoa-online,22978997,"Sữa Bột Nutifood Enplus Gold (900g)",475000,475000,0,0
TIKI,bach-hoa-online,107018221,"Bánh Jamy Nhân Mứt hộp 200 gram Bibica",23403,26900,3497,13
TIKI,bach-hoa-online,46212040,"500g Trà sơn mật hồng sâm",59000,59000,0,0
TIKI,bach-hoa-online,109662191,"Hạt diêm mạch hỗn hợp ba màu hữu cơ Sottolestelle 500g Organic Quinoa Tricolor",205000,205000,0,0
TIKI,bach-hoa-online,73209922,"Gạo Tấm Thơm 1Kg - Gạo Ông Thọ - Dẻo mềm, thơm nhẹ",25000,25000,0,0
TIKI,bach-hoa-online,2378741," Sữa cho người bị bệnh tiểu đường, đái tháo đường: Nutifood DiabetCare Gold 900 Gr",510000,510000,0,0
TIKI,bach-hoa-online,72077615,"Trà Dây Bstar Cho Người Viêm Loét Dạ Dày Tá Tràng 250Gram",181000,225500,44500,20
TIKI,bach-hoa-online,21221457,"Mật Ong Rừng Nhiệt Đới Honimore (1350g)",175000,280000,105000,38
TIKI,bach-hoa-online,195352293,"Thùng 24 chai nước uống sữa trái cây việt quất tự nhiên TH True Juice Milk 300ml (300ml x 24)",247000,270994,23994,9
TIKI,bach-hoa-online,105551909,"Mì rau củ mì cải bó xôi / Rau củ sạch / Khối lượng 200G /Duy Anh Food",36000,39000,3000,8
TIKI,bach-hoa-online,92092734,"(COMBO 1KG) KHÔ HEO CHÁY TỎI LOẠI NGON TLPFOOD ",137000,147000,10000,7
TIKI,bach-hoa-online,125735738,"[Thùng 40 gói x 50gram] Cháo Tổ Yến Thịt Bằm - Yến Đại Phát, 4 gói gia vị, ăn liền, tiện lợi, thơm ngon.",619000,619000,0,0
TIKI,bach-hoa-online,21561669,"Bánh Mochi Hỗn Hợp (Nhiều hương vị)  Mixed Mochi - Hộp 300g",138900,138900,0,0
TIKI,bach-hoa-online,50305975,"Trà Quế  giúp giảm cân, giúp lưu thông máu,tăng kháng thể, ổn định đường huyết, ngủ ngon, hơi thở thơm hương Quế Rừng Xanh- Quế rừng Trà Bồng Quảng Ngãi, món quà về sức khỏe và tinh thần",172000,172000,0,0
TIKI,bach-hoa-online,176445835,"Bánh que nướng giòn 4 vị GLICO Pretz (Combo 10 hộp - 3 khoai tây 3 BBQ Gà 2 Pizza 2 Bắp)",120000,120000,0,0
TIKI,bach-hoa-online,187203373,"Đặc Sản Phan Thiết - [Thùng 6 Chai - 3 Vị] Nước Mắm Nhỉ Làng Chài Xưa Cá Cơm Than, Tôm Biển, Cá Cơm Vàng Ruột Đỏ 525Ml/Chai Nhựa Cao Cấp",228000,440000,212000,48
TIKI,bach-hoa-online,55664405,"Mận Khô Smile Nuts hộp 350g - Nhập khẩu từ Chile (Khô tự nhiên trên cát nóng, giữ nguyên hương vị, khác biệt với mận sấy khô thông thường)",103000,170000,67000,39
TIKI,bach-hoa-online,71105403,"Lọc Thác RS 1000 Dành Cho Hồ Cá Cảnh",99999,99999,0,0
TIKI,bach-hoa-online,181665548,"Đặc sản Quảng Ninh - Can Rượu mơ Yên Tử - OCOP 5 Sao",363000,363000,0,0
TIKI,bach-hoa-online,77756225,"Gạo ST25 Túi 5Kg Ông Thọ  - Cơm Thơm, Dai, Mềm Dẻo, Vị Ngọt - Đạt giải gạo ngon nhất thết giới 2019 tại Manila",170000,170000,0,0
TIKI,bach-hoa-online,58213006,"Táo đỏ tân cương - Loại cao cấp trái to nhiều thịt hạt bé - Hủ 500gr",78000,78000,0,0
TIKI,bach-hoa-online,107018190,"Bánh quy rắc hạt Goody Chip 144g Bibica",20500,24600,4100,17
TIKI,bach-hoa-online,6002993,"Sữa bột Wincofood GoldCare Canxi :  bổ sung canxi giúp xương chắc khỏe, MUFA, PUFA tốt cho tim mạch, phù hợp cho người từ 30 tuổi trở lên.",232000,369000,137000,37
TIKI,bach-hoa-online,181000449,"Hộp quà tết bánh Pía Thượng Hạng 6 vị Tân Huê Viên, bánh pía Bách Vị gồm 6 loại khác nhau ",210700,215000,4300,2
TIKI,bach-hoa-online,58925645,"1 cặp 2 chai 650ml nước mắm Thịnh Phát Thịnh Vượng 43 độ đạm",220000,220000,0,0
TIKI,bach-hoa-online,20826558,"COMBO 7 hộp nước yến sào đường phèn Nhà Việt (42 hủ x 70ml) tặng thêm 6 lon nước yến",729000,729000,0,0
TIKI,bach-hoa-online,196149101,"Bánh Đậu Xanh Rồng Vàng Minh Ngọc A27 Trà Xanh",45000,45000,0,0
TIKI,bach-hoa-online,125858431,"Tương đen Phở Cholimex  2,1kg",60500,60500,0,0
TIKI,bach-hoa-online,199952406,"Cà phê viên nén Carraro CARRAMEL Aluminum -Tương thích với máy capsule Nespresso",91000,97200,6200,6
TIKI,bach-hoa-online,154699102,"Hạnh nhân rang muối biển L'angfarm, 275g, bịch, mẫu kraft 1 mặt trong",147600,164000,16400,10
TIKI,bach-hoa-online,162195553,"Xốt Gia Vị Hoàn Chỉnh BARONA - Canh chua 80g",11520,12800,1280,10
TIKI,bach-hoa-online,59580483,"Combo 2 Gói Trái Nhàu Sấy Khô Shop Thảo Dược ( Mỗi gói 500g ) - Chữa Nhứt Mỏi, Đau Lưng Và Hỗ Trợ Hệ Tiêu Hóa",130000,130000,0,0
TIKI,bach-hoa-online,186876361,"Đặc Sản Bến Tre - Combo 2 Bịch Kẹo Chuối Tươi Bến Tre, Kéo Chuối Miền Tây Túi 200G",68400,72000,3600,5
TIKI,bach-hoa-online,181980606,"Xương gặm làm sạch răng, mượt lông, bổ sung canxi cho chó Vegebones (Gói 60g)",25555,25555,0,0
TIKI,bach-hoa-online,19647294,"Thức Ăn Cho Mèo Me-O Adult Vị Cá Ngừ (350g)",26500,26999,499,2
TIKI,bach-hoa-online,119891566,"Mì 3 Miền Gold tôm chua cay đặc biệt gói 75g",135000,135000,0,0
TIKI,bach-hoa-online,161344592,"Thùng 24 chai nước cam tự nhiên TH True Juice 350ml (350ml x 24)",399000,424155,25155,6
TIKI,bach-hoa-online,152924968,"Rong biển xanh tẩm gia vị ăn liền Ottogi túi 4g x 3 gói",23500,25000,1500,6
TIKI,bach-hoa-online,1701995,"Viên Nhai Trị Ve, Ghẻ, Bọ Chét Nexgard Cho Chó 4 - 10kg",153000,153000,0,0
TIKI,bach-hoa-online,191948770,"Trà Atiso Gừng túi lọc Tâm Châu hộp 40G",38500,38500,0,0
TIKI,bach-hoa-online,178455020,"Đặc sản Tiền Giang - Combo 6 túi Gạo Lứt VietGAP 2kg tặng thêm 1 túi Lứt VietGAP 2kg - Đạt chuẩn VietGAP và OCOP 4 sao",329000,329000,0,0
TIKI,bach-hoa-online,69659858,"Bánh Tráng Tây Ninh Tinh Nguyên (200g)",13600,16000,2400,15
TIKI,bach-hoa-online,90589956,"Khô Heo Cháy Tỏi DTFood Đặc Biệt Thơm Ngon",96000,99000,3000,3
TIKI,bach-hoa-online,171668609,"Cà phê Cappuccino Coconut Trung Nguyên Legend - Hòa tan Dừa - Hộp 12 gói",77400,86000,8600,10
TIKI,bach-hoa-online,59202025,"Thức ăn cho chó trưởng thành Ganador vị thịt cừu & gạo Lamb & Rice 20kg",902499,971999,69500,7
TIKI,bach-hoa-online,113835077,"Mắm Cá Linh 430g",80000,80000,0,0
TIKI,bach-hoa-online,106381067,"Thùng Sữa Tươi Tiệt Trùng Nguyên Kem Nhập Khẩu ÚcMeadow Fresh 200ml - Thùng 24 Hộp",350000,350000,0,0
TIKI,bach-hoa-online,270556631,"Sữa Milo Úc Nestle và A2 nguyên kem Úc giàu dinh dưỡng giúp trẻ phát triển chiều cao và tăng cường sức tăng- QuaTangMe Extaste",839000,1678000,839000,50
TIKI,bach-hoa-online,107018122,"Bánh Ngũ Cốc Cracker GOOKA 160g – Thực phẩm dinh dưỡng Bibica",19500,22400,2900,13
TIKI,bach-hoa-online,154698910,"Nước cốt dâu tằm L'angfarm, 300ml, chai, mẫu antique",48600,54000,5400,10
TIKI,bach-hoa-online,89308769,"Vỏ bưởi sấy dẻo Nonglamfood túi 25g | Ăn vặt tốt cho sức khỏe | Healthy Snack | Ăn vặt văn phòng | Trái cây sấy dẻo dinh dưỡng ăn liền | Ăn vặt giảm cân & giữ dáng | Ăn vặt đẹp da",10000,15000,5000,33
TIKI,bach-hoa-online,56878722,"Hoa Đu Đủ Đực Shop Thảo Dược Hộp 250G - Hàng hiếm, sản lượng ít - Trà hoa đu đủ đực Hỗ Trợ Ngăn Ngừa Ung Thư, Viêm Loét Dạ Dày, Hỗ Trợ Hệ Tiêu Hóa, Giải Quyết Các Vấn Đề Về Hô Hấp",180000,180000,0,0
TIKI,bach-hoa-online,21497723,"Bánh Mochi Nhân Đậu Đỏ Japanese Style Red Bean Mochi (210g)",62000,62000,0,0
TIKI,bach-hoa-online,38058563,"EcoClean Aqua - Men Vi Sinh Xử Lý Nước Ao Nuôi Tôm, Cá - Gói 100g",99000,99000,0,0
TIKI,bach-hoa-online,181000514,"Đặc Sản Bến Tre - Bánh Pía Ít Đường Có Trứng Muối Tân Huê Viên 300G, Bánh Pía Ít Ngọt, Dành Cho Ăn Kiêng",94080,98000,3920,4
TIKI,bach-hoa-online,141646014,"[Combo 2 gói] Cà phê bột Truyền thống Highland Coffee 1kg",680000,680000,0,0
TIKI,bach-hoa-online,56447051,"COMBO08 - 1 Túi Đậu Gà trắng 1 Túi Đậu Lăng xanh và 1 Túi Đậu Hà lan xanh nguyên hạt 500g",95000,95000,0,0
TIKI,bach-hoa-online,181000451,"Đặc Sản Sóc Trăng - Bánh Pía Thịt Chà Bông Bò Tân Huê Viên 480G, Bánh Pía Mini Sóc Trăng [Túi 12 Bánh]",142100,145000,2900,2
TIKI,bach-hoa-online,52851207,"Combo 2 hộp cafe hòa tan sữa đá Legend Trung Nguyên ( 9 gói x 25g / hộp )",166000,166000,0,0
TIKI,bach-hoa-online,57753172,"Lược chải lông cho chó mèo có nút loại bỏ lông thừa",22000,22000,0,0
TIKI,bach-hoa-online,99078137,"Combo 6 gói Mì Không Gói Gia Vị Ottogi 110G",52452,55800,3348,6
TIKI,bach-hoa-online,54711125,"500G HẠT ĐIỀU RANG TỎI ỚT CỰC NGON TLP",54000,60000,6000,10
TIKI,bach-hoa-online,109325362,"Đông trùng hạ thảo 100g sấy nhiệt thượng hạng chính hãng JINDO",179000,179000,0,0
TIKI,bach-hoa-online,181361222,"Combo 2 Hộp Cà Phê Sữa Hòa Tan G7 3in1 Gu Mạnh X2 - Hộp 12 gói - Trung Nguyên Legend (Gu mạnh gấp đối)",140220,155800,15580,10
TIKI,bach-hoa-online,138194841,"Mắm Tép chưng thịt Vị Thanh loại đặc biệt 300ml, thơm ngon, sạch sẽ, ủ chượp thùng gỗ cùng muối tinh khiết",27000,40000,13000,33
TIKI,bach-hoa-online,152814384,"Khô Gà Xé Sợi - Khô Gà Xé Cay ABI SNACK",35000,35000,0,0
TIKI,bach-hoa-online,43807142,"Tổ Yến Sào Khánh Hòa Nest - 100g ( Yến Tinh Chế )",5500000,5500000,0,0
TIKI,bach-hoa-online,56172178,"Trà kỷ tử - Câu kỷ tử - Loại cao cấp - Gói 100gr",45000,45000,0,0
TIKI,bach-hoa-online,20134794,"SỮA DINH DƯỠNG VINAMILK ADM GOLD SÔCÔLA - LỐC 4 HỘP X 110ML",240000,240000,0,0
TIKI,bach-hoa-online,161040043,"[Lốc 5  Gói] Mì Tương Đen Bắc Kinh Ottogi 135gx5",60630,64500,3870,6
TIKI,bach-hoa-online,37476863,"Hạt kê hữu cơ đã bóc vỏ Markal 500g",145000,155000,10000,6
TIKI,bach-hoa-online,201687102,"Hạt Hạnh Nhân Rang Mộc HSaHa - Hạnh Nhân Tách Vỏ Mỹ Sấy Chín Nguyên Vị Ăn Liền, Mới, Giòn, Thơm Ngon",95000,120000,25000,21
TIKI,bach-hoa-online,11949159,"Long Nhãn Hưng Yên Mộc Sắc",110000,120000,10000,8
TIKI,bach-hoa-online,45327501,"Bột súp lơ nguyên chất Goce (Bông cải xanh) - 72g (24 gói x 3g)",114000,190000,76000,40
TIKI,bach-hoa-online,107668299,"MỰC SỢI HẤP NƯỚC DỪA TÂN LỘC PHÁT COMBO 1KG - MỖI HŨ 500G",293202,325780,32578,10
TIKI,bach-hoa-online,190852882,"Bánh Trung Thu Đậu Xanh Lá Dứa Hạt Dưa Tân Dân Lợi - 200g/2 trứng - Bao date mới - Bao ngon ",49000,49000,0,0
TIKI,bach-hoa-online,115660033,"TRÀ AHMAD ANH QUỐC - BÁ TƯỚC (100g) - Earl Grey - Chắt lọc sự tinh túy",79000,79000,0,0
TIKI,bach-hoa-online,54826036,"Combo 3 Túi Bánh Tráng Ba Màu MeKong River 22cm 300g",113000,123000,10000,8
TIKI,bach-hoa-online,49211520,"Hộp Mix 3 loại Hạt Quinoa (Diêm mạch) Smile Nuts 500g - Gồm Quinoa Trắng, Quinoa Đen và Quinoa Đỏ - Mixed Quinoa Seed Smile Nuts 500g",109000,129000,20000,16
TIKI,bach-hoa-online,49556280,"[ Date mới] 2 Hộp Bột Ngũ Cốc  Dinh Dưỡng BEONE 500G Chính Hãng Giúp Tăng Cân - Lợi Sữa - Bổ Sung Dinh Dưỡng",555000,555000,0,0
TIKI,bach-hoa-online,52461118,"Gạo Thơm ST25 Hộp 2Kg - Gạo An Toàn Từ Vùng Lúa Tôm",115000,115000,0,0
TIKI,bach-hoa-online,41772672,"1kg trà tim sen - Trà tâm sen",289000,289000,0,0
TIKI,bach-hoa-online,194103112,"Chùm ruột rim chua ngọt DTFood",67620,69000,1380,2
TIKI,bach-hoa-online,16608355,"Gừng Sấy Dẻo Sữa Ong Chúa Hương Sen Việt",35000,35000,0,0
TIKI,bach-hoa-online,53438788,"Cơm tự sôi ( cơm ăn liền ) - Bò Nấm",82000,95000,13000,14
TIKI,bach-hoa-online,271582906,"Thùng 18 Mì Thịt Bằm HOÀNG GIA VIFON (130gr / Gói)",124000,161000,37000,23
TIKI,bach-hoa-online,271585914,"Thùng 18 Bún Bò Huế HOÀNG GIA VIFON (120g / Gói)",147000,190000,43000,23
TIKI,bach-hoa-online,157203258,"[THÙNG 30 GÓI] Mì Tương Đen Bắc Kinh Ottogi 83g",220900,235000,14100,6
TIKI,bach-hoa-online,16552788,"Cà Phê Hạt Mộc Trung Nguyên Success 1 Túi 1Kg",300000,300000,0,0
TIKI,bach-hoa-online,14693531,"Thức ăn cho mèo Royal Canin Indoor 27 2kg",548888,548888,0,0
TIKI,bach-hoa-online,159969974,"Bánh canh ống gạo lứt Fuma 500gr ăn kiêng eatclean",45000,45000,0,0
TIKI,bach-hoa-online,106783014,"COMBO 2 CHAI MẬT HOA DỪA - SOKFRAM - 500gram - 100% MẬT HOA DỪA NGUYÊN CHẤT",245000,245000,0,0
TIKI,bach-hoa-online,83612645,"Hạt sen sấy giòn Hodi- NaVi hũ quai xách 400g",260000,260000,0,0
TIKI,bach-hoa-online,51841719,"TRÀ LÚA MẠCH KODA SHOTEN 510G - Hàng nội địa Nhật Bản",119000,119000,0,0
TIKI,bach-hoa-online,2473863,"Muối Tiêu Lá Chanh 50gr Dh Foods ",13100,13100,0,0
TIKI,bach-hoa-online,263041189,"Collagen Youtheory Mỹ chứa collagen, vitamin c, biotin… tạo sức khỏe và sắc đẹp - QuaTangMe Extaste",598000,1196000,598000,50
TIKI,bach-hoa-online,197381747,"Đậu hà lan xanh không biến đổi gen_ Dry Peas non GMO _ xuất xứ Canada",14250,15000,750,5
TIKI,bach-hoa-online,80974572,"Thùng 12 Hộp Sữa Tiệt Trùng Vinamilk Flex Không Lactose 1 Lít",415000,415000,0,0
TIKI,bach-hoa-online,912615,"Bánh Quy Bơ Danisa (200g)",69000,69000,0,0
TIKI,bach-hoa-online,167558863,"Bột Rau Má Nguyên Chất DTFood",69000,75000,6000,8
TIKI,bach-hoa-online,12320203,"Nước Uống Hồng Sâm 6 Năm Tuổi - Korea Red Ginseng Daeyoung Hàn Quốc (70 ml x 30 gói)",285000,285000,0,0
TIKI,bach-hoa-online,24140314,"COMBO 6 HỘP SỮA TƯƠI TIỆT TRÙNG VINAMILK 100% ÍT ĐƯỜNG - HỘP GIẤY 1L",230000,230000,0,0
TIKI,bach-hoa-online,32665429,"Đậu Gà Hữu Cơ Markal 500g (Mẫu mới)",137000,137000,0,0
TIKI,bach-hoa-online,136587394,"5 hộp Trà tam thất xạ đen Học viện quân y",250000,250000,0,0
TIKI,bach-hoa-online,51571133,"Trà hoa hồng - Loại cao cấp (500gr) ",169000,169000,0,0
TIKI,bach-hoa-online,19708879,"Địu Thú Cưng - Địu Chó Mèo Đủ màu (Tự Chọn) Có Size XL cho Chó Lớn",99999,99999,0,0
TIKI,bach-hoa-online,62224434,"Combo 4 Lon Sữa Đặc Có Đường Creamer Premium Alphana Malaysia Lon 1kg - Protein cao - Không Cholesterol",276000,276000,0,0
TIKI,bach-hoa-online,45777750,"HỖN HỢP NGŨ CÔC 16 LOẠI HẠT NHẬT BẢN-PREPARED MIX GRAINS 1KG",495000,495000,0,0
TIKI,bach-hoa-online,2112431,"Trà tam thất xạ đen Học Viện Quân Y (20 gói)",55000,55000,0,0
TIKI,bach-hoa-online,53148648,"Combo 2 gói cafe khát vọng I Trung Nguyên ( 500g / gói )",210000,210000,0,0
TIKI,bach-hoa-online,59201703,"Ô mai Mơ  - Xí muội mặn có hạt (500gr)",125000,125000,0,0
TIKI,bach-hoa-online,150850518,"[TẶNG KÈM TÚI QUÀ] Bánh quy bơ Danisa Size đại Hộp 908g (date mới)",289000,289000,0,0
TIKI,bach-hoa-online,46114705,"Bát ăn cao cấp cho chó mèo ( màu ngẫu nhiên )",10999,10999,0,0
TIKI,bach-hoa-online,135450952,"Gói Hạt Nêm Aji-ngon® Heo 2kg/Gói",119000,119000,0,0
TIKI,bach-hoa-online,141774712,"Thảo Quả Tự Nhiên Vipep Hũ Nhựa 35g",16000,16000,0,0
TIKI,bach-hoa-online,195334241,"Ngũ Cốc Ăn Kiêng Granola Original Mix Hạnh Nhân 300g Befresco",159000,159000,0,0
TIKI,bach-hoa-online,51713389,"Cà Phê Trung Nguyên Chế Phin",130000,130000,0,0
TIKI,bach-hoa-online,4878085,"Bánh quy trứng muối Đài Loan 500g",129000,129000,0,0
TIKI,bach-hoa-online,125858343,"Sa tế tôm XO Cholimex  100g",11700,11700,0,0
TIKI,bach-hoa-online,118300154,"Canh rong biển đậu hũ khô Nagaya (canh Miso) Nhật Bản 100g",135000,135000,0,0
TIKI,bach-hoa-online,191331128,"[ 10KG ] Thức ăn cho chó trưởng thành Ganador vị gà nướng - Ganador Adult Roasted Chicken Flavor  [ 10KG",380999,380999,0,0
TIKI,bach-hoa-online,197186696,"Bánh Quy Lady Finger Savoiardi Divella 400Gr Italia [ Nhập Khẩu Ý ]",153000,153000,0,0
TIKI,bach-hoa-online,99077835,"Combo 5 gói mì Jin hải sản vị tôm & mực Ottogi 120g",70500,75000,4500,6
TIKI,bach-hoa-online,187186913,"Đặc Sản Phan Thiết - MuốI ỚT Đỏ Chanh TắC Cao Cấp Làng Chài Xưa, Nguyên Liệu Tươi, Thơm Ngon Đặc Biệt, Chai Thủy Tinh 300Gr",63000,90000,27000,30
TIKI,bach-hoa-online,94728537,"Đặc Sản Phú Quốc - Hộp 6 Chai Thủy Tinh Nước Mắm Phú Quốc Khải Hoàn 40 Độ Đạm (205Ml X 6) - Ocop 5 Sao",213000,241000,28000,12
TIKI,bach-hoa-online,1507191,"Bột Phô Mai Tornado Vị Cay Gói (1kg / Gói)",220000,220000,0,0
TIKI,bach-hoa-online,29253126,"Viên cà ri Golden Curry vị mặn ngọt 198g (8 viên)",79000,79000,0,0
TIKI,bach-hoa-online,17902094,"Mixed Nuts 6 loại hạt  dinh dưỡng  còn vỏ ăn liền 500gr",200000,200000,0,0
TIKI,bach-hoa-online,99154257,"[Thùng 30 gói x 50gram] Cháo Tổ Yến Trẻ Em Cá Hồi Bí Đỏ - Yến Đại Phát, tiện lợi thơm ngon dinh dưỡng cao",369000,369000,0,0
TIKI,bach-hoa-online,52183799,"Sốt gà hầm xương Hirokishoko Nhật Bản - 500g",195000,195000,0,0
TIKI,bach-hoa-online,59417981,"HẠT ĐIỀU TÁCH VỎ LOẠI NGUYÊN HẠT LOẠI 1 NUNUTS (HŨ 250G)",99000,99000,0,0
TIKI,bach-hoa-online,53445651,"Muối Tôm Tây Ninh Tinh Nguyên (500g)",99000,99000,0,0
TIKI,bach-hoa-online,113835073,"Mắm Dưa Gang 400g",40000,40000,0,0
TIKI,bach-hoa-online,99884634,"Ngũ cốc (sữa hạt) dinh dưỡng cao cấp 22 loại hạt hiệu Good Lady - 22 Complete Nutrimix - Wheat Grass (Mầm lúa mì) - hộp thiếc 750g",522500,522500,0,0
TIKI,bach-hoa-online,54349298,"Hạt Ngò Tự Nhiên Vipep Hũ Nhựa 300g",55000,55000,0,0
TIKI,bach-hoa-online,72928330,"Trà An Thần Dễ Ngủ Trường Thọ - Trà Thảo Dược",70000,100000,30000,30
TIKI,bach-hoa-online,38041367,"Lốc 3 Hộp Sữa Hạt Hạnh Nhân ALMOND BREEZE VANILLA 180ml - Sản phẩm của TẬP ĐOÀN BLUE DIAMOND MỸ - Đứng đầu về sản lượng tiêu thụ tại Mỹ",76000,76000,0,0
TIKI,bach-hoa-online,57805305,"Combo 5 Gói Bột Phô mai Verozyme Malaysia Cheese Taste Blaster 30g/ gói - Thơm ngon tiện dụng bột lắc khoai lắc gà vô cùng tiện dùng cho gia đình bạn",103000,150000,47000,31
TIKI,bach-hoa-online,76470555,"Bột Maca hữu cơ Dragon superfoods 200gr Maca Powder Dragon superfoods 200gr",285000,380000,95000,25
TIKI,bach-hoa-online,96189960,"Trân châu đen hương/vị Cà phê(1kg/bao), dùng kèm trà sữa. Trân châu dẻo dai thơm",49000,49000,0,0
TIKI,bach-hoa-online,14423509,"Thức ăn cho mèo Royal Canin Urinary S/O Feline 1,5kg",479999,479999,0,0
TIKI,bach-hoa-online,176628693,"Granola siêu hạt NOFA 500g 90% hạt, nhiều Macca, Óc chó đỏ, Granola Ăn kiêng, Giảm cân",49000,49000,0,0
TIKI,bach-hoa-online,38049066,"Bột đậu xanh uống liền 360g",42500,42500,0,0
TIKI,bach-hoa-online,168946245,"Bột củ dền hữu cơ nguyên chất sấy lạnh Dalahouse - Thúc đẩy sức khỏe tim mạch, hỗ trợ giải độc gan, tăng cường thể lực",162000,162000,0,0
TIKI,bach-hoa-online,197745152,"Hạt Lanh Ấn Độ RealFood (100g, 500g, 1KG)",15000,15000,0,0
TIKI,bach-hoa-online,191331157,"[ 3KG ] Thức ăn cho chó con Ganador vị Trứng và Sữa - Ganador Egg and Milk [ 3KG",157583,157583,0,0
TIKI,bach-hoa-online,57800161,"Trà hoa đu đủ đực - Gói 1kg",399000,399000,0,0
TIKI,bach-hoa-online,104009363,"Combo 5 Gói Mì Spaghetti Ristorante 08 Divella ",175000,175000,0,0
TIKI,bach-hoa-online,58338629,"SỮA CHO NGƯỜI TIỂU ĐƯỜNG - GLUCOSE PLAN từ 8 LOẠI HẠT CAO CẤP - 800 Gram 1 hộp",465000,465000,0,0
TIKI,bach-hoa-online,174510533,"[COMBO 2 HỘP] Kẹo ngậm gừng Vietnat không đường hỗ trợ tiêu hóa giảm cảm cúm - 20 viên/ hộp",53200,53200,0,0
TIKI,bach-hoa-online,271582928,"Thùng 18 Mì Thịt Bò HOÀNG GIA VIFON (130gr / Gói)",124000,161000,37000,23
TIKI,bach-hoa-online,141848496,"Hạt Điều Màu Vipep 70gr",13000,13000,0,0
TIKI,bach-hoa-online,74814366,"Bột hạt Lanh nâu đã rang 500g",69100,69100,0,0
TIKI,bach-hoa-online,126527872,"Trứng cút Phá lấu ăn liền V.food ( gói 6 quả)",10000,10000,0,0
TIKI,bach-hoa-online,48201953,"Thùng (06 hộp) Cá Linh kho mía - Antesco",309000,309000,0,0
TIKI,bach-hoa-online,125858383,"Dầu hào Cholimex 820g",43000,43000,0,0
TIKI,bach-hoa-online,1083294,"Trà Lài Thượng Hạng Lộc Tân Cương (100g)",89000,89000,0,0
TIKI,bach-hoa-online,600286,"Nước Khoáng Thiên Nhiên Fiji (6 Chai x 500ml)",204000,204000,0,0
TIKI,bach-hoa-online,111751671,"Muối Sả Ớt Tinh Nguyên (90g)",13500,16000,2500,16
TIKI,bach-hoa-online,56339457,"250g Hạt Hạnh Nhân Lõi Đã Tách Vỏ Sấy Chín Thơm Ngon Hiệu SK FOOD",180000,180000,0,0
TIKI,bach-hoa-online,16344129,"Ngăn phóng uế Fay Repell 200ml",57000,57000,0,0
TIKI,bach-hoa-online,58958809,"Cây Chùm Bao (Thân Nhỏ) Shop Thảo Dược Gói 500G - Giúp An Thần Dễ Ngủ, Thanh Nhiệt Giải Độc",35000,35000,0,0
TIKI,bach-hoa-online,76180204,"Pate gan heo Hạ Long - 170g",34300,34300,0,0
TIKI,bach-hoa-online,8350134,"Hạt Kê Hữu Cơ Đã Bóc Vỏ Markal (500g)",145000,159000,14000,9
TIKI,bach-hoa-online,140218106,"Cà Phê Hữu Cơ Thải Độc Đại Tràng Gerson | Cà Phê Chuyên Dùng Thải Độc Đại Tràng Giúp Đại Tràng Sạch, Cải Thiện Hệ Tiêu Hóa, Giảm Cân, Sáng Da...(Gói 500gr)",204000,235000,31000,13
TIKI,bach-hoa-online,56404421,"COMBO03 1 Túi Đậu Gà trắng - 1 Túi Đậu Lăng đỏ và 1 Túi Đậu Hà lan xanh nguyên hạt 250g",61000,61000,0,0
TIKI,bach-hoa-online,63211386,"Cà Phê Phin Giấy Trung Nguyên Vietnamese Blend( Hộp 10 túi)",130000,130000,0,0
TIKI,bach-hoa-online,188057502,"Pate thịt gà Chicken Luncheon Meat Jean Floch 400g - Pháp",65000,65000,0,0
TIKI,bach-hoa-online,78913279,"COMBO 1kg (2 gói) 2 loại cà phê Culi Robusta RANG MỘC VÀ CÓ BƠ Phú Xuân Coffee - Cà phê bột rang xay pha phin",260000,260000,0,0
TIKI,bach-hoa-online,186269684,"Bột cacao sữa dừa tự nhiên, thuần chay – Lon 350g – Bộ sưu tập sản phẩm cacao "Thật" Heydaycacao",168000,168000,0,0
TIKI,bach-hoa-online,74857009,"Bột đậu gà chưa rang 250g",30000,30000,0,0
TIKI,bach-hoa-online,98704664,"Nước Dùng Happo Dashi Nhật Bản Cao Cấp (Vị đậm) - Dashi Lab - 340g/chai",118000,118000,0,0
TIKI,bach-hoa-online,108480843,"Combo 2 gói Gia Vị Nêm Sẵn Lẩu Thái Fadely (50g/gói)",13500,15800,2300,15
TIKI,bach-hoa-online,599727,"Trà Sữa Vị Gừng Aik Cheong Teh Tarik Halia 4 In 1 (15 Gói x 40g)",119000,119000,0,0
TIKI,bach-hoa-online,275583523,"[COMBO] 2 Túi 1KG Muối Hồng Himalaya Nhuyễn Read Food",41000,42000,1000,2
TIKI,bach-hoa-online,141651124,"Mixed Nuts 4 Loại Hạt Dinh Dưỡng Macca, Óc Chó, Hạnh Nhân, Hat Dẻ Cười chưa tách vỏ (hũ 500gr)",179000,200000,21000,11
TIKI,bach-hoa-online,1717777,"Thức Ăn Cho Mèo Royal Canin Indoor 27 (2kg)",539999,539999,0,0
TIKI,bach-hoa-online,190519666,"Bột Protein Shake hữu cơ vị cacao và vanilla Dragon Superfoods 500gr",680000,680000,0,0
TIKI,bach-hoa-online,168946746,"Bột cải bó xôi hữu cơ sấy lạnh Dalahouse - Nguồn Vitamin K,A,C, sắt, magie & Mangan cao giúp xương chắc khỏe, hỗ trợ tiêu hóa và hỗ trợ thị lực",130500,130500,0,0
TIKI,bach-hoa-online,247336548,"Trà gừng mật ong Ginfresh Ranong Tea",73000,73000,0,0
TIKI,bach-hoa-online,52044401,"Hạt Điều Rang Không Muối Cao Cấp Gold Cashew (Gói 454g) - Premium Roasted & Unsalted Cashew, Chuẩn hạt điều size WW240, Công nghệ rang không dầu, Không chất bảo quản, Không Cholesterol",199000,199000,0,0
TIKI,bach-hoa-online,148037581,"Mini Sốt Chao Nấm Hương đặc biệt 200ml - Mini Shiitake Bean Curd Sauce",20000,20000,0,0
TIKI,bach-hoa-online,149095106,"Kẹo Migita hương bạc hà gói 70g",6177,7100,923,13
TIKI,bach-hoa-online,51987095,"Đậu Đen Xanh Lòng Rang Mộc_Cỏ Ngọt _Hà Thủ Ô 500Gram (Túi Lọc 50GRAM)",130000,130000,0,0
TIKI,bach-hoa-online,2595265,"Tiêu sọ xay Phú Quốc 45gr Dh Foods",55200,55200,0,0
TIKI,bach-hoa-online,177577930,"Cà phê bột pha phin Paris 8 - Đậm, mạnh hương thơm đặc trưng lưu luyến [500gr]",71000,71000,0,0
TIKI,bach-hoa-online,155107514,"Nho Khô Chile 3 màu hộp 500gr",90000,100000,10000,10
TIKI,bach-hoa-online,188079905,"Pate thịt heo Luncheon Meat Jean Floch 400g - Pháp",65000,65000,0,0
TIKI,bach-hoa-online,99870715,"Ngũ cốc (sữa hạt) dinh dưỡng cao cấp 22 loại hạt hiệu Good Lady - 22 Complete Nutrimix - Chia Seed (Hạt chia) - hộp thiếc 750g",522500,522500,0,0
TIKI,bach-hoa-online,154698914,"Trà trinh nữ hoàng cung L'angfarm, 25 tép, hộp, mẫu quấn dây kraft",54000,60000,6000,10
TIKI,bach-hoa-online,4762545,"Cần câu mèo dây thép có chuông và lông vũ",13998,13998,0,0
TIKI,bach-hoa-online,70089522,"Trà mảng cầu xiêm (200gr)",99000,99000,0,0
TIKI,bach-hoa-online,2245147,"Bắp Rang Uncle Jax Vị Trà Xanh (160g)",39000,39000,0,0
TIKI,bach-hoa-online,102124538,"DA CÁ HỒI LẮC TRỨNG MUỐI TÂN LỘC PHÁT HŨ 200G",44100,49000,4900,10
TIKI,bach-hoa-online,155099752,"Hành thơm Hà Nội 165gr (hành khô phi sẵn)- Hàng xuất khẩu Nhật-Đảm bảo chất lương, ngon, giòn rụm",56000,56000,0,0
TIKI,bach-hoa-online,195805500,"Bánh Đậu Xanh Rồng Vàng Minh Ngọc A27 Khoai",45000,45000,0,0
TIKI,bach-hoa-online,154189665,"Bột đậu đen nguyên chất Hải Dung 500g, thơm ngon sánh mịn, giúp mát gan, đen tóc, khỏe xương khớp",69900,100000,30100,30
TIKI,bach-hoa-online,173125938,"Snack Bắp Ăn Liền Happy Tos Bắp Vị Phomai Cheddar Gói 160g - Nhập Khẩu Indonesia",27000,27000,0,0
TIKI,bach-hoa-online,107018057,"Kẹo Mút Welly hỗn hợp 594 gram Bibica",68000,68000,0,0
TIKI,bach-hoa-online,92067062,"BỘT MACA GELATINIZED HỮU CƠ PERU (GÓI 200G) NGUỒN THIÊN NHIÊN",295000,295000,0,0
TIKI,bach-hoa-online,56184995,"Yến Mạch Cán Mỏng Vỡ Đôi Mfood 500g / Túi",50000,50000,0,0
TIKI,bach-hoa-online,174016329,"Táo đỏ hữu cơ Hotan 500gr Organic Dried Hotan Jujube 500gr - Green Nature",310000,550000,240000,44
TIKI,bach-hoa-online,138956257,"[Combo 15 lọ] Nước yến sào Sanvinest Khánh Hòa dành cho người cao tuổi đóng lọ 70ml",524000,540000,16000,3
TIKI,bach-hoa-online,113835068,"Mắm Dưa Leo 400g",40000,40000,0,0
TIKI,bach-hoa-online,84774460,"Combo 02 Hộp Cà phê hòa tan G7 Trung Nguyên 3in1 Hộp 21 gói( Có TEM XÁC THỰC CHÍNH HÃNG)",150000,150000,0,0
TIKI,bach-hoa-online,70495139,"Xuyên Tiêu Tự Nhiên Vipep Hũ Nhựa 250g",176000,176000,0,0
TIKI,bach-hoa-online,52424856,"Cà phê hòa tan 3in1 - Sạch nguyên bản - Coffilia - Kết nối đam mê (12 gói)",75000,75000,0,0
TIKI,bach-hoa-online,173884627,"Combo 5 gói Gia vị Ướp (bao gồm gia vị ướp Ngũ vị hương, gia vị nấu Cà ri, gia vị nấu Bò Kho, gia vị Ướp thịt nướng, gia vị ướp thịt Chẩm Chéo)",42100,42100,0,0
TIKI,bach-hoa-online,21082370,"Rong Biển snack vụn giòn Trộn Cơm 50gr Good&well | Thuhienco - Combo 2 Gói | Ăn chay ăn kiêng",104000,104000,0,0
TIKI,bach-hoa-online,207954155,"Hạt dẻ cười Mỹ không tẩy trắng, vỏ màu ngà ngà vàng,ít muối,nhân ngọt tươi mới, giòn ngon, không hôi dầu NunutsMỹ",100000,100000,0,0
TIKI,bach-hoa-online,5444943,"Muối Tiêu Lá Chanh Natas Hũ 65g-Muối Đa Năng",22000,22000,0,0
TIKI,bach-hoa-online,50087857,"Mãng Cầu Sấy Dẻo 100 gr ",48000,48000,0,0
TIKI,bach-hoa-online,197333416,"Hạt chia không biến đổi gen hữu cơ Peru_Organic chia seeds non GMO from Peru",42750,45000,2250,5
TIKI,bach-hoa-online,181980787,"Kẹo ngậm Genat Chanh Sả (Túi 20 viên)",19760,20800,1040,5
TIKI,bach-hoa-online,181361263,"Combo 2 Hộp Cà Phê Phin Giấy Vietnameses Blend - Hộp 10 Túi - Trung Nguyên Legend (Vị truyền thống, hậu vị dịu)",267120,296800,29680,10
TIKI,bach-hoa-online,141735104,"Bột ngũ cốc 7 vị Brown Rice 500gr ( 5 loại đậu, gạo lứt, mè đen )",80000,80000,0,0
TIKI,bach-hoa-online,72880287,"TINH BỘT BIẾN TÍNH ACETYLATED DISTARCH PHOSPHATE (INS1414) I Gói 1kg",20000,20000,0,0
TIKI,bach-hoa-online,133580050,"Hạt Sen Nước Đường CANfresh 460g - Đồ Hộp Hạ Long",82300,82300,0,0
TIKI,bach-hoa-online,172028503,"Sốt chanh Chavi chấm hải sản, thịt nướng-chai 260g",26000,26000,0,0
TIKI,bach-hoa-online,48423441,"Máy Sấy lông cho Chó Mèo Chuyên dụng - Máy Sấy Công Suất Lớn 2800W",999999,999999,0,0
TIKI,bach-hoa-online,56110236,"500g Bột Phô Mai Cheese (2 gói 250g)",105000,105000,0,0
TIKI,bach-hoa-online,14982177,"Đậu gà nâu Brown Chickpeas",24000,24000,0,0
TIKI,bach-hoa-online,189831943,"Rượu Bols Peach Liqueur 17％ 1x0.7L",560000,560000,0,0
TIKI,bach-hoa-online,77677394,"Bộ 2 van khóa 2 đầu dây 6mm nối nhanh dùng lắp lọc nước, dàn tưới cây, bể thủy sinh, cá cảnh, bán cạn ",32000,45000,13000,29
TIKI,bach-hoa-online,121748574,"( 5kg ) cám (Stelllaa) 40% Đạm Nổi Cho Cá Koi, Cá Lóc cá diêu hồng cá rô phi cá chép mè cá trê 5kg Cám ( STELLLAA )",158888,158888,0,0
TIKI,bach-hoa-online,141757033,"Tiểu Hồi Tự Nhiên Vipep Hũ Nhựa 40g",13000,13000,0,0
TIKI,bach-hoa-online,72506430,"Muối Tôm Sấy 110g Dh Foods ",19900,19900,0,0
TIKI,bach-hoa-online,49307827,"Gạo Lứt Nhật Bản Koshihikari 1kg, Hữu Cơ Và Dinh Dưỡng Cao",80000,80000,0,0
TIKI,bach-hoa-online,57702152,"HẠT MACCA CAO CẤP CHẤT LƯỢNG TÂN LỘC PHÁT - HŨ 300G",62370,69300,6930,10
TIKI,bach-hoa-online,183503516,"Xịt thơm miệng cho chó mèo Fresh Friends 14ml",35000,35000,0,0
TIKI,bach-hoa-online,155259955,"Nước tương Hương Việt Hảo Vị 7ml (01 túi gồm 50 gói tiện lợi sử dụng)",23000,23000,0,0
TIKI,bach-hoa-online,196148872,"Bánh Đậu Xanh Rồng Vàng Minh Ngọc A27 Dừa",45000,45000,0,0
TIKI,bach-hoa-online,154699122,"Hạt macca L'angfarm, 850g, bịch, mẫu mawashi",335700,373000,37300,10
TIKI,bach-hoa-online,186267955,"Bột cacao sữa Classic - Đậm cacao, thơm vị sữa – Lon 350g - Bộ sưu tập sản phẩm cacao "Thật" Heyday Cacao",152000,152000,0,0
TIKI,bach-hoa-online,34913592,"ĐẬU HÀ LAN TỎI ỚT TÂN LỘC PHÁT COMBO 2 HŨ - MỖI HŨ 500G",81081,90090,9009,10
TIKI,bach-hoa-online,154698886,"Trà nhân trần túi lọc Thái Bảo, 60 tép, hộp, mẫu pastel art",62100,69000,6900,10
TIKI,bach-hoa-online,160644348,"Trà sencha hoa cúc L'angfarm, 82g, hộp, mẫu stamp",96300,107000,10700,10
TIKI,bach-hoa-online,195855433,"Bột chiên gà giòn KFC All in One | Túi 500G - Nguyên liệu thượng hạng nhập khẩu từ Malaysia",44000,60000,16000,27
TIKI,bach-hoa-online,188300653,"Dừa Sấy Giòn DTFood Vị Sữa 500G",50000,52000,2000,4
TIKI,bach-hoa-online,97357746,"Hạt Thủy Tinh Đào - Hùng Chương - 1kg",70278,70278,0,0
TIKI,bach-hoa-online,154698981,"Hạt điều vàng L'angfarm, 750g, bịch, mẫu mawashi",306000,358000,52000,15
TIKI,bach-hoa-online,14397474,"10 hũ Nước Yến Sào Sanest Kids (62ml)",369000,369000,0,0
TIKI,bach-hoa-online,117721604,"Thức ăn khô cho chó trưởng thành Classic Pets vị thịt bò",22000,22000,0,0
TIKI,bach-hoa-online,57883741,"Pate cho chó Smartheart Beef & Liver 400g (lon)",46000,46000,0,0
TIKI,bach-hoa-online,173391154,"Cà Phê Hạt Strong Blend",322960,322960,0,0
TIKI,bach-hoa-online,46782187,"Cà Phê Hòa Tan Cappuccino Vị Vani KING COFFEE - Hộp 12 gói x 20g",60700,78800,18100,23
TIKI,bach-hoa-online,55606287,"ĐẬU HÀ LAN MUỐI SẤY GIÒN NGON HIỆU SK FOOD - HŨ 500G",55000,55000,0,0
TIKI,bach-hoa-online,199957125,"Cà Phê Viên Nén Carraro Honduras Aluminum Mới - 10 viên - Tương thích với máy capsule Nespresso",90000,97200,7200,7
TIKI,bach-hoa-online,3585899,"Cà Phê Rang Xay Thunder No.3 Gu Việt Pha Phin/Pha Máy – 1864 CAFÉ trọng lượng tịnh 454g",182000,258000,76000,29
TIKI,bach-hoa-online,191530038,"Vỏ hạt mã đề (Psyllium husk) hữu cơ 150gr - Dragon Superfoods",265000,275000,10000,4
TIKI,bach-hoa-online,133462594,"CAT'S BEST ORIGINAL - CÁT HỮU CƠ CHO MÈO",245000,245000,0,0
TIKI,bach-hoa-online,69273238,"Chuối tiêu sấy dẻo không đường Kentary 200 gram, vị ngọt đậm đà - Ngừa thiếu máu và táo bón,  tốt cho sức khỏe thai nhi  - Trái cây sấy không đường, không GMO/Gluten/chất bảo quản",82000,85000,3000,4
TIKI,bach-hoa-online,14187700,"Trà Shan Tuyết Thượng Hạng 150g - Trà Đại Gia",140000,140000,0,0
TIKI,bach-hoa-online,193597581,"Bravecto diệt ghẻ, ve rận, bọ chét (chó 2 - 4,5kg)",395000,395000,0,0
TIKI,bach-hoa-online,54534527,"Sữa Bột Vinamilk Sure Prevent - Hộp Thiếc 900g (Mẫu mã mới)",615000,615000,0,0
TIKI,bach-hoa-online,271585858,"Thùng 50 Cháo Thịt Bò VIFON có Gói Thịt Thật 27gr  (70g / Gói)",119000,154000,35000,23
TIKI,bach-hoa-online,195503769,"Gạo ST24 Hữu Cơ Gạo A An Túi 2 Kg",89000,89000,0,0
TIKI,bach-hoa-online,109244201,"Combo 3 Gói Hạt Nêm Aji-ngon® 400g/Gói",83700,90000,6300,7
TIKI,bach-hoa-online,176431826,"Bánh que nhân kem mix 2 vị cookie & cream socola bạc hà GLICO Pejoy ( Happy Set E 10 hộp - 5 cookie và 5 Choco Mint)",200000,200000,0,0
TIKI,bach-hoa-online,2637801,"Cao hồng sâm 365 Hàn Quốc Daedong Korea Ginseng hộp 480g-PP",415000,415000,0,0
TIKI,bach-hoa-online,52585769,"Combo 2 gói trà lài Thượng hạng Tâm Châu (200g/gói)",185000,185000,0,0
TIKI,bach-hoa-online,113835089,"Mắm Cà Pháo 400g",50000,50000,0,0
TIKI,bach-hoa-online,58700641,"4 bịch Sữa Dinh Dưỡng Tăng Chiều Cao từ Óc chó Hạnh nhân Đậu đen hiệu Golden Health ",59000,59000,0,0
TIKI,bach-hoa-online,46613610,"Hạt dinh dưỡng hỗn hợp 7 loại hạt hữu cơ Sottolestelle 400g ",150000,150000,0,0
TIKI,bach-hoa-online,275357678,"Bánh tráng truyền thống 16cm - MEKONG RIVER",23200,26000,2800,11
TIKI,bach-hoa-online,2385949,"Muối Ớt Tây Ninh Tinh Nguyên (500g)",55000,55000,0,0
TIKI,bach-hoa-online,23259319,"Thức ăn hạt mèo con Royal Canin Kitten 10kg",2222222,2222222,0,0
TIKI,bach-hoa-online,154533194,"Bột Gạo Lức Mè Đen Vitapro 300gr, Thơm Ngon Uống Liền – Hàng Chính Hãng",41000,41000,0,0
TIKI,bach-hoa-online,52126484,"Mắm tép Lê Gia can 2l",145000,158000,13000,8
TIKI,bach-hoa-online,19911249,"Mắm Tép chưng thịt đặc biệt Tác Huy 1kg (Ba Làng Thanh Hóa)",69000,69000,0,0
TIKI,bach-hoa-online,11784908,"TRÀ TAM DIỆP - Giảm Cân Hiệu Quả An Toàn - Thương Hiệu Hùng Phát ",108000,108000,0,0
TIKI,bach-hoa-online,154699193,"Mứt nho L'angfarm, 200g, hũ, mẫu tobita",73800,82000,8200,10
TIKI,bach-hoa-online,73368171,"Pate Gan Hạ Long - 90g",22800,22800,0,0
TIKI,bach-hoa-online,22253986,"ĐẬU PHỘNG CỐT DỪA SẤY GIÒN 500G HŨ NHỰA",62370,69300,6930,10
TIKI,bach-hoa-online,108746049,"[ĂN BAO GHIỀN❤️]Bột Làm Kem Tươi THUCPHAM.COM Vị Dâu 1kg - Công Thức Độc Quyền Hương Vị Mới, Không Gắt, Không Hắc",95000,95000,0,0
TIKI,bach-hoa-online,14289257,"Nước giặt Layer Clean hương Poppy Coach 4L",185000,185000,0,0
TIKI,bach-hoa-online,74679015,"HẠT HẠNH NHÂN TÂN LỘC PHÁT - HỘP 250G",59000,59000,0,0
TIKI,bach-hoa-online,57358302,"Cao chè vằng Quảng Trị -  1kg được 50 miếng - Loại cao cấp giảm cân lợi sữa",245000,245000,0,0
TIKI,bach-hoa-online,43759001,"Trà Đinh lăng Cỏ ngọt Trường Ái (50 túi lọc) - Giúp ăn ngon, ngủ ngon, kéo dài tuổi thọ",75000,120000,45000,38
TIKI,bach-hoa-online,30740657,"Nước Cốt Chanh Chavi 100A",120000,120000,0,0
TIKI,bach-hoa-online,184634241,"Trà Cà gai leo Thái Hưng 25 túi lọc - Mát gan, giải độc, giải rượu, giảm mụn nhọt",49500,55000,5500,10
TIKI,bach-hoa-online,90022108,"Trà hoa hòe sấy khô cao cấp túi 250g - Hoa hòe giúp ổn định huyết áp, tốt cho người giãn tĩnh mạch, ngủ ngon, thanh nhiệt - sản phẩm đã được sao vàng cho mùi vị thơm dễ uống - Thích hợp làm quà tặng người cao tuổi",65000,65000,0,0
TIKI,bach-hoa-online,88821569,"Hộp Bột Diếp Cá Quảng Thanh gói nhỏ 15x3g - Thanh nhiệt, giải độc, cầm máu",99000,110000,11000,10
TIKI,bach-hoa-online,114973785,"TRÀ AHMAD ANH QUỐC - NO 1 (50g)",45000,45000,0,0
TIKI,bach-hoa-online,51575519,"Chuối sấy dẻo phủ Chocolate BerryLand",65000,70000,5000,7
TIKI,bach-hoa-online,7801820,"Tông Đơ Cắt Tỉa Lông  Thú Cưng - Codos CP 6800",444998,444998,0,0
TIKI,bach-hoa-online,117785865,"Cà phê hạt rang AEROCO A2 pha phin và pha máy, hộp 500g, nguyên chất 100% rang mộc hậu vị ngọt thơm quyến rũ",1000000,1000000,0,0
TIKI,bach-hoa-online,197193671,"Đầu sủi oxy Eheim Air Diffuser điều chỉnh bọt khí oxy mịn lớn nhỏ",138000,138000,0,0
TIKI,bach-hoa-online,71104777,"Lốc 6 Hũ Nước Yến Thật BRAND'S Đường Phèn 70ml",559000,559000,0,0
TIKI,bach-hoa-online,195300094,"Cây Cỏ Mực (Cỏ Nhọ Nồi) khô đóng gói 1kg",109000,109000,0,0
TIKI,bach-hoa-online,58567215,"Quả long nhãn - Nhãn nhục sông mã (1kg)",315000,315000,0,0
TIKI,bach-hoa-online,106188398,"Trà lá sen túi lọc TÂM MINH FOODS hạ mỡ máu giảm cân ngủ ngon hộp 20 gói",44000,44000,0,0
TIKI,bach-hoa-online,173125966,"Snack Bắp Ăn Liền Happy Tos Bắp Vị Cay Ngọt Gói 140g - Nhập Khẩu Indonesia",27000,27000,0,0
TIKI,bach-hoa-online,184118988,"Thức ăn cho mèo,Pate bổ sung dinh dưỡng Reflex Essential PLus 70g",22222,22222,0,0
TIKI,bach-hoa-online,47353494,"BỘT SẮN DÂY TA NGUYÊN CHẤT MẸ KEN GÓI 500GR",145000,145000,0,0
TIKI,bach-hoa-online,68221431,"Bột nghệ uống liền 160g Honimore 3 trong 1 -  10 gói Thơm ngon, dễ uống",51000,66250,15250,23
TIKI,bach-hoa-online,155561449,"Combo 2 Loại Tương Phở - Tương Ớt Chitas Ông Chà Và 270g và Tương Đen Phở Ông Chà Và 290g",70000,70000,0,0
TIKI,bach-hoa-online,58010029,"OMEGA SNACK - Hạt sacha inchi rang muối 120gram - Thực phẩm chay bổ sung Omega 3",79000,79000,0,0
TIKI,bach-hoa-online,29263834,"Trân châu đen Gaban 100g",155000,155000,0,0
TIKI,bach-hoa-online,155561955,"Hạt Điều Màu Ông Chà Và 220g (Annatto Seed)",44000,44000,0,0
TIKI,bach-hoa-online,176628753,"Hạt Macca Úc nứt vỏ NOFA 500g Tặng kèm khui hạt",55000,55000,0,0
TIKI,bach-hoa-online,57878814,"MIẾN MỘC HÀ NỘI 100% DONG SẠCH CÓ NGUỒN GỐC TỰ NHIÊN GÓI 500GRAM- Hàng xuất khẩu Nhật",53000,53000,0,0
TIKI,bach-hoa-online,104806850,"Combo 2 hộp cà phê hòa tan đen Coffilia",110000,110000,0,0
TIKI,bach-hoa-online,11228935,"Quả Ô Liu Gaea Xanh Nhồi Hạnh Nhân (295g)",125000,125000,0,0
TIKI,bach-hoa-online,176304275,"Bánh que mặn nướng giòn mix 2 vị khoai tây &amp; pizza GLICO Pretz (Combo Happy Set D - 5 khoai tây 5 pizza)",120000,120000,0,0
TIKI,bach-hoa-online,71737405,"Kẹo dừa sáp",45000,59000,14000,24
TIKI,bach-hoa-online,170823461,"Cà Phê Viên Nén Carraro RWANDA Aluminum- Tương thích với máy capsule Nespresso",92340,97200,4860,5
TIKI,bach-hoa-online,154699166,"Trà khổ qua túi lọc L'angfarm, 25 tép, hộp, mẫu quấn dây kraft",56700,63000,6300,10
TIKI,bach-hoa-online,10229536,"Gạo Hữu Cơ Hoa Nắng - Xanh Mạ Non 2kg",148000,148000,0,0
TIKI,bach-hoa-online,197193469,"Yến Thị- Gói yến dành cho bé-Yến kird bổ sung canxi, HMO-hũ 42ml- Yến sào Nha Trang",260000,280000,20000,7
TIKI,bach-hoa-online,56744472,"Dầu ăn gạo lứt quốc sản Nhật Bản Tsuno 600g (Hộp giấy)",149000,149000,0,0
TIKI,bach-hoa-online,97924494,"Thức ăn cho mèo trưởng thành Royal Canin FIt 32",138888,138888,0,0
TIKI,the-thao-da-ngoai,21947276,"Thảm Tập YoGa miDoctor +Bao Thảm Tập Yoga + Dây Thảm Tập Yoga",112000,112000,0,0
TIKI,the-thao-da-ngoai,58547423,"Túi đeo bụng chạy bộ chống nước, đai đeo điện thoại chạy bộ, túi đeo hông chạy bộ phản quang GoodFit GF106RB",116000,199000,83000,42
TIKI,the-thao-da-ngoai,16974932,"Kính bơi chống tia UV , Chống sương mù  , bảo vệ mắt YESURE Cleacco  - Hàng Chính Hãng",267000,404000,137000,34
TIKI,the-thao-da-ngoai,68399004,"Băng Bảo Vệ Đầu Gối Bó Cơ VN09, Băng Gối Thể Thao Cao Cấp VNS (1 Đôi)",128000,150000,22000,15
TIKI,the-thao-da-ngoai,32440826,"Thảm Yoga Định Tuyến miDoctor + Bao Đựng Thảm Yoga Định Tuyến + Dây Buộc Thảm Yoga",139000,139000,0,0
TIKI,the-thao-da-ngoai,66620428,"Xà Đơn Treo Tường Gắn Cửa Đa Năng Độ Dài Tùy Chỉnh Giúp Bạn Tập Gym, Tập Cơ Bụng, Cơ Vai, Cơ Xô 60-120Cm - Chính Hãng miDoctor (Màu Ngẫu Nhiên)",109000,109000,0,0
TIKI,the-thao-da-ngoai,66907970,"Xà Đơn Treo Tường Cleacco Làm Từ Ống Thép Và Nhựa PVC Với Nhiều Chức Năng Tập Luyện Khác Nhau",318000,459000,141000,31
TIKI,the-thao-da-ngoai,88216202,"Thanh xà đơn gắn cửa, xà đơn treo tường GoodFit chịu lực 200kg, chốt khóa an toàn chông trượt tập luyện tại nhà GF201PU",306000,599000,293000,49
TIKI,the-thao-da-ngoai,147672795,"Xà Đơn Treo Tường Gắn Cửa Đa Năng Độ Dài Tùy Chỉnh Giúp Bạn Tập Gym, Tập Cơ Bụng, Cơ Vai, Cơ Xô 60-120Cm - Chính Hãng dododios (Màu Ngẫu Nhiên)",129000,129000,0,0
TIKI,the-thao-da-ngoai,183500376,"Kính bơi chống sương mờ, chống UV, dây được làm 100% silicone mềm mại, thiết kế không trơn trượt, độ co giãn, độ bền thách thức thời gian, dành cho vận động viên chuyên nghiệp, kính bơi cận thị có độ - Chính hãng DODODIOS",96000,96000,0,0
TIKI,the-thao-da-ngoai,33395818,"Xà Đơn Treo Tường Gắn Cửa Đen Đỏ Chịu Lực 150kg Chính Hãng Đại Nam Sport + Kèm Găng Tay Tập Xà",110000,250000,140000,56
TIKI,the-thao-da-ngoai,97119072,"DÂY NHẢY TẬP THỂ DỤC CAO CẤP TẠI NHÀ LÕI THÉP ĐỘ BỀN CAO, TAY CẦM CHỐNG TRƯỢT – HÀNG CHÍNH HÃNG",26000,50000,24000,48
TIKI,the-thao-da-ngoai,25608349,"Thảm Yoga Định Tuyến 2 Lớp 6mm miDoctor + Bao Đựng Thảm Yoga Định Tuyến + Dây Buộc (Màu Ngẫu Nhiên)",139000,139000,0,0
TIKI,the-thao-da-ngoai,19751771,"Thảm Tập Yoga miDoctor + Bao Tập Thảm Yoga + Dây Buộc Thảm (Giao Màu Ngẫu Nhiên)",107000,107000,0,0
TIKI,the-thao-da-ngoai,165346320,"Dây Nhảy Đếm Số, Đo Calo, Khoảng Cách Cao Cấp Chính Hãng miDoctor - Kèm Bóng Xoay Cho Người Mới Bắt Đầu Tập",59000,59000,0,0
TIKI,the-thao-da-ngoai,57693595,"Bó gối, băng gối thể thao GoodFit dày dặn co giãn 4 chiều, bó gối bóng chuyền kèm dây quấn trợ lực chắc chắn GF511K",88000,150000,62000,41
TIKI,the-thao-da-ngoai,146502455,"[LOẠI XỊN TRẦN BÔNG] (FREE SHIP) Túi ngủ văn phòng cao cấp có trùm đầu, túi ngủ du lịch dã ngoại, túi ngủ mùa đông - Chính hãng dododios",207000,207000,0,0
TIKI,the-thao-da-ngoai,187619110,"Đèn Pin Đội Đầu Siêu Sáng US ARMY T6 Bóng Led,  Đa Chức Năng, Không Thấm Nước Dung Lượng Pin 5800 mAh Có Thể Sạc Lại Công Suất Đèn  10W- HÀNG CHÍNH HÃNG",145000,299000,154000,52
TIKI,the-thao-da-ngoai,68837035,"Băng Quấn Tay Boxing Glofit GBX009 ( 5m ), Băng Đa Quấn Tay Võ Thuật Cao Cấp Glofit ( Một Đôi )",140000,250000,110000,44
TIKI,the-thao-da-ngoai,42676831,"Quần bơi nam Boxer YESURE DEENYT  Chất liệu Superfine polyester cao cấp , chống thấm , nhanh khô form Fitness thời trang (Tặng kèm nón bơi + bịt tai silicon) - Hàng Chính Hãng",209000,323000,114000,35
TIKI,the-thao-da-ngoai,169749545,"Tất Chống Trượt Thể Thao VNSPORT - TCT01, Vớ Thể Thao Có Silicone Chống Trượt Giày Khi Chạy Nhảy Vận Động Ở Cường Độ Cao",35000,50000,15000,30
TIKI,the-thao-da-ngoai,103209829,"[TẶNG 3 CẦU] Vợt cầu lông cán liền cao cấp chính hãng Agnite -  Tặng hộp cầu nhựa và bao đựng - 2 chiếc - F2131",342000,770400,428400,56
TIKI,the-thao-da-ngoai,176626447,"Ngũ cốc giảm cân Granola NOFA không đường siêu hạt Ăn kiêng",139000,139000,0,0
TIKI,the-thao-da-ngoai,54876123,"Bộ 5 dây đàn hồi tập gym, dây đàn hồi  mini band tập yoga dây đàn hồi kháng lực cao cấp, dây đàn hồi tập thể dục Cleacco ( bộ 5 dây đủ màu trong 1 túi )",111000,201000,90000,45
TIKI,the-thao-da-ngoai,147389103,"Bao găng tay tập gym kết hợp quấn bảo vệ cổ tay Cleacco J55 - Hàng chính hãng BORO SPORT",111000,201000,90000,45
TIKI,the-thao-da-ngoai,74570153,"Tất thể thao nam nữ BENDU chính hãng",60000,60000,0,0
TIKI,the-thao-da-ngoai,50702715,"Tạ Tập Tay Nhựa VN Sportslink - Xanh",12000,17000,5000,29
TIKI,the-thao-da-ngoai,13853076,"Túi Ngủ Cao Cấp Văn Phòng + Đi Phượt GSTN02 (Hàng Xuất Khẩu)",210000,389000,179000,46
TIKI,the-thao-da-ngoai,59200054,"Dây nhảy lõi thép, tay cầm hợp kim nhôm, bền bỉ dẻo dai Cleacco",111000,201000,90000,45
TIKI,the-thao-da-ngoai,34240496,"Khung Nắn Chỉnh Cột Sống, Khung Định Hình Cột Sống, Chống Thoát Vị Đĩa Đệm, Đau Lưng, Vai Gáy, Dụng Cụ Hỗ Trợ Tập Lưng - Chính Hãng miDoctor",69000,69000,0,0
TIKI,the-thao-da-ngoai,67039784,"Băng Khớp Gối Glofit VN030 (Protect.Genu), Băng Trợ Lực Và Cố Định Đầu Gối, Hỗ Trợ Khớp Gối Trong Thể Thao Và Chấn Thương Vùng Gối (1 Chiếc)",350000,450000,100000,22
TIKI,the-thao-da-ngoai,55053644,"Kính bơi chống tia UV , Chống sương mù , bảo vệ mắt Cleacco - Hàng Chính Hãng",250000,404000,154000,38
TIKI,the-thao-da-ngoai,31575097,"Bộ đồ thể thao nam vải thun lạnh siêu mát, dáng thể thao, trẻ trung, năng động – FORMEN SHOP – FMCBTD095 - Quần đen Áo trắng - M",199000,350000,151000,43
TIKI,the-thao-da-ngoai,76747146,"Găng Tay Tập Gym Có Dây Quấn Trợ Lực Cổ Tay GVN001, Bao Tay Tập Gym Bảo Vệ Lòng Bàn Tay Và Cổ Tay",180000,250000,70000,28
TIKI,the-thao-da-ngoai,54896822,"Kính bơi chống sương mờ , chống UV Cleacco",111000,199000,88000,44
TIKI,the-thao-da-ngoai,186494607,"[Loại Cao Cấp - Giữ Nhiệt - Inox 304] bình lắc gym, bình lắc shaker, bình nước thể thao inox giữ nhiệt + kèm quả lắc Lò Xo - Hàng chính hãng DoDoDios",196000,196000,0,0
TIKI,the-thao-da-ngoai,57812878,"Đai đeo chạy bộ, túi đựng điện thoại đeo tay chạy bộ GoodFit chống nước, phản quang Goodfit GF201RA",124000,200000,76000,38
TIKI,the-thao-da-ngoai,36694065,"Quần Bơi  Lửng Cho Nam  Với Thiết Kế Vảy Cá Mập Yesure Chống Thấm Nước , Nhanh Khô Tặng Kèm Nón Bơi Vải chống nước",127000,242000,115000,48
TIKI,the-thao-da-ngoai,55205646,"Kính bơi cận CLEACCO độ cận từ 2 độ tới 7 độ chất liệu PC chống nước , chống tia UV , Chống sương mù , bảo vệ mắt - Hàng chính hãng",250000,404000,154000,38
TIKI,the-thao-da-ngoai,67446841,"Băng đô, băng trán thể thao headband thấm hút mồ hôi nam nữ GoodFit GF802SB",36000,69000,33000,48
TIKI,the-thao-da-ngoai,57708428,"Băng bảo vệ cổ chân, băng quấn cổ chân, mắt cá chân GoodFit mỏng nhẹ, miếng dán chắc chắn GF611A",89000,150000,61000,41
TIKI,the-thao-da-ngoai,94867193,"Khung Nắn Chỉnh Cột Sống, Khung Định Hình Cột Sống, Dụng Cụ Hỗ Trợ Thoát Vị Đĩa Đệm, Đau Mỏi Lưng, Đau Vai Gáy - Chính Hãng VinBuy",82000,160000,78000,49
TIKI,the-thao-da-ngoai,22197859,"Nón bơi cao cấp Yesure Cleacco chất liệu làm từ hợp chất Silicon dẻo , chống nước , chóng UV , mềm mại thoải mái khi đeo - Nhiều màu sắc",55000,120000,65000,54
TIKI,the-thao-da-ngoai,198119424,"SET 5 Dây thun tập gym mini band GoodFit GF911MB",9000,15000,6000,40
TIKI,the-thao-da-ngoai,57015948,"Đai Túi Chạy Bộ Thể Thao Đa Năng Có Vạch Phát Quang, Túi Để Chai Nước Hàng Chính Hãng Buffalo Sports BS03",89000,89000,0,0
TIKI,the-thao-da-ngoai,103735659,"Combo 2 Cuộn Băng Keo Vải Dán Cơ Thể Thao Cao Cấp Kinesiology Tape  (5cm x 5m) - Băng Keo Dán Cơ Chuyên Dụng Trong Thể Thao Phù Hợp Cho Mọi Lứa Tuổi Và Tất Cả Các Bộ Môn Thể Thao",140000,190000,50000,26
TIKI,the-thao-da-ngoai,171858800,"Dây nhảy thể lực CLEACCO trọng lượng nặng 400g , tay cầm kim loại đầm tay ( dùng trong Boxing, Muay Thai ) giúp  đốt cháy calo nhanh  + tặng kèm túi vải BORO SPORT",229000,336000,107000,32
TIKI,the-thao-da-ngoai,50707951,"Bộ 2 Tạ Tập Tay Nhựa VN Sportslink - Xanh",13000,24000,11000,46
TIKI,the-thao-da-ngoai,37407482,"Con Lăn Tập Cơ Bụng 4 Bánh Chính Hãng",92000,92000,0,0
TIKI,the-thao-da-ngoai,138896660,"Áo bra nữ thể thao Fitme Delta 2 dây nâng ngực hỗ trợ cho gym và yoga, chất liệu thun cao cấp thoáng khí",179000,179000,0,0
TIKI,the-thao-da-ngoai,108125514,"Xà Đơn Gắn Cửa, Treo Tường Bằng Thép Chịu Lực Có Thước Thăng Bằng Cao Cấp 2022 Tienphatsmart ( Bảo Hành 12 Tháng)",279000,558000,279000,50
TIKI,the-thao-da-ngoai,257859695,"BG Bộ xà đơn, xà kép đa năng cao 1m9 cao cấp đa năng Gym, lượng Kéo lên tại nhà dụng cụ tập thể dục phòng gym (hàng nhập khẩu)",1254000,2399000,1145000,48
TIKI,the-thao-da-ngoai,105312036,"Bao, Túi đựng Điện Thoại tới 6.5 Inch Đeo tay chạy bộ, Tập thể dục Rhino B121 Kháng nước, có thể cắm tai nghe",63000,80000,17000,21
TIKI,the-thao-da-ngoai,73861344,"Dây kháng lực đàn hồi Power Band",109000,109000,0,0
TIKI,the-thao-da-ngoai,138359762,"Áo croptop nữ Fitme Meta ba lỗ kiểu dáng ôm body tập gym yoga chất liệu thun cao cấp, thấm hút tốt",159000,159000,0,0
TIKI,the-thao-da-ngoai,273729614,"Bảng dụng cụ tập hít đất , tập chống đẩy theo màu sắc, mỗi màu sắc sẽ tương ứng với bài tập khác nhau tương ứng với nhóm cơ khác nhau, thiết kế từ nhựa ABS an toàn cho người dùng - Hàng Chính Hãng",189000,379000,190000,50
TIKI,the-thao-da-ngoai,75667664,"BAO TAY TẬP GYM, GĂNG TAY THỂ HÌNH - Lâm Sport - 1 CẶP - CÓ DÂY CUỘN CỔ TAY",37000,60000,23000,38
TIKI,the-thao-da-ngoai,148944414,"Găng Tay Tập GYM Da Bò  Hở Mu Bàn Tay Lifting Grips , Dây Kéo Lưng - Hàng chính hãng BORO SPORT",202000,449000,247000,55
TIKI,the-thao-da-ngoai,2282607,"Xăng Zippo (125ml)",90000,90000,0,0
TIKI,the-thao-da-ngoai,8073271,"Mũ bơi người lớn cao cấp Aolikes AL5010",61000,61000,0,0
TIKI,the-thao-da-ngoai,1374137,"Kính Bơi View V500S",295000,495000,200000,40
TIKI,the-thao-da-ngoai,273675300,"Đồ chơi cầu lông cho bé trai và bé gái, màu ngẫu nhiên ( có sẵn 2 quả cầu)+Tặng kèm hộp đựng bút hình hộp sữa- Bộ 2 vợt cầu lông trẻ em",114000,119000,5000,4
TIKI,the-thao-da-ngoai,56700930,"GIÀY ĐÁ BÓNG SÂN CỎ NHÂN TẠO THỂ THAO NAM PEACE PS1208",189000,300000,111000,37
TIKI,the-thao-da-ngoai,196938285,"Thảm trải dã ngoại đi picnic 200x200 cm trải sàn CLEACCO   , đi pinic thiết kế gấp gọn tiện lợi mang đi BORO SPORT - Hàng chính hãng",201000,336000,135000,40
TIKI,the-thao-da-ngoai,3941727,"Chai xịt làm nóng cơ Starbalm - Hà Lan 150ml",227000,360000,133000,37
TIKI,the-thao-da-ngoai,67112118,"Găng tay hở ngón, bao tay tập gym, tập đu xà nam nữ GoodFit đệm silicone chống trượt, vải đục lỗ thoáng khí GF202G - M",70000,129000,59000,46
TIKI,the-thao-da-ngoai,159495900,"Hộp đựng kính bơi unisex Zoggs Elite - 300810",195000,195000,0,0
TIKI,the-thao-da-ngoai,60716616,"Thảm Tập Yoga Định Tuyến TPE 2 Lớp – Chọn Màu – Chọn Độ Dày + Bao Thảm Tập Yoga + Dây Buộc Thảm Tập Yoga Chính Hãng miDoctor",149000,149000,0,0
TIKI,the-thao-da-ngoai,76403004,"Bộ cần câu cá - Cần carbon cao cấp - Kèm máy Kim loại HE Chính hãng - Tặng kèm nhiều phụ kiện",359000,359000,0,0
TIKI,the-thao-da-ngoai,137940270,"Kìm Bóp Tập Cơ Tay điều chỉnh từ 5 - 60kg Đếm Nhịp KitAcoom, Hàng Nhập Khẩu Chính Hãng Giao Màu Ngẫu Nhiên",129270,139000,9730,7
TIKI,the-thao-da-ngoai,57175986,"Băng quấn cổ định cổ tay khi tập luyện thể thao với chất liệu polyester phong cách thể thao mạnh mẽ Cleacco - Hàng chính hãng (Giao màu ngẫu nhiên)",74000,174000,100000,57
TIKI,the-thao-da-ngoai,6936677,"Combo đi phượt Chita CT1 - Goinglink cao cấp tiện dụng (Nón bảo hiểm, găng tay, khăn đa năng)",355000,355000,0,0
TIKI,the-thao-da-ngoai,138480707,"Quần legging nữ Fitme Zeta nâng mông cao cấp chất liệu dày dặn cạp cao chuyên tập gym và tập yoga",189000,189000,0,0
TIKI,the-thao-da-ngoai,89754166,"Kìm Bóp Tay, Dụng Cụ Tập Cơ Tay Cao Cấp, Kìm Tập Gym Bấm Số Tự Động (5-60 Kg) Hàng Cao Cấp Tay Cầm Dài ",39000,39000,0,0
TIKI,the-thao-da-ngoai,67271402,"Băng khuỷu tay hỗ trợ bảo vệ khuỷu tay, củi chỏ, vải co giãn đàn hồi, lớp silicon chống trượt thấm hút mồ hôi tốt Goodfit GF402E",89000,150000,61000,41
TIKI,the-thao-da-ngoai,13866304,"Quấn Nẹp Cổ Tay Bảo Vệ Hỗ Trợ Xương Ống Khớp Cổ Tay Khi Tập Gym, Chơi Thể Thao Pressure Adjustable Wrist Support AOLIKES YE-7937 (1 chiếc)",49000,49000,0,0
TIKI,the-thao-da-ngoai,59200785,"Dây kháng lực tập gym cao su tự nhiên, mức lực kéo phân theo từng màu, tiện lợi mang theo bất cứ đâu Cleacco",27000,79000,52000,66
TIKI,the-thao-da-ngoai,190125184,"Kính bơi người lớn cho nam, nữ chính hãng dododios tầm nhìn rộng 180 độ góc nhìn PANORAMA hạn chế sương mờ, cản tia UV",208000,208000,0,0
TIKI,the-thao-da-ngoai,33979580,"Kính Bơi Nam Nữ Cao Cấp miDoctor",88000,88000,0,0
TIKI,the-thao-da-ngoai,21316585,"Bộ 5 Dây Đàn Hồi Tập Gym Yoga, Dây Kháng Lực, Dây Đàn Hồi Tập Thể Dục- Hàng Chính Hãng",84500,84500,0,0
TIKI,the-thao-da-ngoai,57839415,"Bộ 2 vợt bóng bàn tặng kèm 3 bóng GoodFit, cốt vợt 7 lớp, mặt mút đàn hồi, chất lượng đạt chuẩn Goodfit GF001TS",179000,250000,71000,28
TIKI,the-thao-da-ngoai,55023453,"Dụng cụ hỗ trợ chống đẩy , hít đất tập thể thao tại nhà kèm bàng chỉ dẫn theo màu sắc tập trung các nhóm cơ chính - Kèm dây đàn hồi tập đa năng",281000,404000,123000,30
TIKI,the-thao-da-ngoai,149432550,"Vòng Lắc Eo Giảm Mỡ Bụng Ống Thép Bọc Mút Xốp - Tùy Chỉnh Độ Nặng - Chính Hãng miDoctor",159000,159000,0,0
TIKI,the-thao-da-ngoai,51420207,"Kính Bảo Vệ Chơi Thể Thao, Bóng Rổ, Bóng Đá Chống Sương Mù, Mồ Hôi Cao Cấp - Có Thể Lắp Mắt Kính Cận",99000,99000,0,0
TIKI,the-thao-da-ngoai,58342155,"Băng quấn cố chân, băng bảo vệ cổ chân, mắt cá chân GoodFit co giãn đàn hồi, đệm silicone chống trượt GF612A",90000,150000,60000,40
TIKI,the-thao-da-ngoai,195972019,"Bộ cần câu cá - cần câu cá  kèm máy câu 5000 - Tặng kèm nhiều phụ kiện BCC03",299000,299000,0,0
TIKI,the-thao-da-ngoai,40253876,"Con Lăn Tập Bụng 4 Bánh + Đệm Lót",95000,95000,0,0
TIKI,the-thao-da-ngoai,67211545,"Bộ cần câu cá - Cần carbon huter Man - Máy Deukio chính hãng - Tặng kèm 9 phụ kiện CC02",489000,489000,0,0
TIKI,the-thao-da-ngoai,57844141,"Vợt bóng bàn tặng kèm 3 bóng GoodFit cốt vợt 9 lớp đạt chuẩn chất lượng GF002TR",242000,375000,133000,35
TIKI,the-thao-da-ngoai,197637729,"Cần câu cá - Cần câu tay carbon siêu cứng - Tặng kèm nhiều phụ kiện DCH02",219000,219000,0,0
TIKI,the-thao-da-ngoai,50336846,"Thảm Tập YoGa Dày 8mm miDoctor CHỌN MÀU + Bao Thảm Tập Yoga + Dây Thảm Tập Yoga (Túi, Dây Giao Màu Ngẫu Nhiên)",145000,145000,0,0
TIKI,the-thao-da-ngoai,79787055,"Dây dù câu Lure - Dài 500m - Sire đủ - Từ 1.0 đến 8.0  Siêu bền siêu bạo lực - Chất liệu cao cấp - Bện 8 lõi",229000,229000,0,0
TIKI,the-thao-da-ngoai,31958771,"Đai chạy bộ thắt lưng chạy bộ Yesure có ngăn đựng nước và dải phản quang",22000,89000,67000,75
TIKI,the-thao-da-ngoai,102123766,"Bó gối thể thao, băng đầu gối, băng gối chạy bộ GoodFit dây đai đôi, đệm bảo vệ dày dặn GF521K",97000,179000,82000,46
TIKI,the-thao-da-ngoai,67248287,"Dây dù câu cá - Dài 500m - Siêu bạo lực - Siêu dai - DC03",199000,199000,0,0
TIKI,the-thao-da-ngoai,1814533,"Thực phẩm bổ sung Optimum Nutrition Gold Standard 100% Whey 2lb (907g)",860000,860000,0,0
TIKI,the-thao-da-ngoai,132171283,"Thảm Du Lịch Dã Ngoại Gấp Gọn Chống Thấm Nước 150 x 200cm - Thảm Gấp Gọn Du Lịch Đi Biển, Bạt Trải Picnic- Hàng Chính Hãng MINIIN",112000,129000,17000,13
TIKI,the-thao-da-ngoai,197638113,"Cần câu tay xanh Carbon siêu cứng - Tặng kèm nhiều phụ kiện DCH06",199000,199000,0,0
TIKI,the-thao-da-ngoai,70688127,"Cần câu tay - Carbon cao cấp - Độ cứng 6H - CT06 - Tặng kèm 8 phụ kiện  - Cần",299000,299000,0,0
TIKI,the-thao-da-ngoai,77774793,"Bảng Dụng Cụ Hít Đất Kèm Dây Kéo Đa Năng Cleacco Nhiều Bài Tập Theo Màu Sắc BORO SPORT",298000,404000,106000,26
TIKI,the-thao-da-ngoai,2794159,"Găng tay tập tạ viền cuốn Đại Nam Sport DNS112 - Màu Ngẫu nhiên",35000,70000,35000,50
TIKI,the-thao-da-ngoai,161237496,"Băng Gối Tập Yoga – Đệm Đầu Gối VN9066",150000,150000,0,0
TIKI,the-thao-da-ngoai,77720015,"Sữa bổ sung đạm dành cho người ăn chay từ đậu hà lan Pea Protein Isolate Myprotein không mùi 2.5kg  - NUTRITIONDEPOT",1280000,1280000,0,0
TIKI,the-thao-da-ngoai,128288201,"Bộ Dụng Cụ Chống Đẩy Đa Năng 3 Trong 1 Tích Hợp Tập Bụng,Dây Kéo Tay ",316000,600000,284000,47
TIKI,the-thao-da-ngoai,186582273,"Vợt cầu lông cán liền Agnite - Kèm bao đựng cao cấp - 2 chiếc - F2134",149000,279000,130000,47
TIKI,the-thao-da-ngoai,97518293,"Giày Thể Thao Cao Cấp Nam Biti's Hunter Layered Upper DSMH02800DEN (Đen)",895000,971000,76000,8
TIKI,the-thao-da-ngoai,103209807,"Hộp cầu lông Agnite 12 quả - Phù hợp thi đầu và luyện tập - Hàng chính hãng - F2202S",139000,219600,80600,37
TIKI,the-thao-da-ngoai,197263915,"Cặp vợt cầu lông cán liền quấn cao su Agnite - Họa tiết khỏe khoắn - Kèm bao vợt cao cấp và cầu lông - 2 chiếc - Hàng chính hãng - F2110",271000,610200,339200,56
TIKI,the-thao-da-ngoai,68260292,"Vỏ Trụ Đấm Bốc Tự Cân Bằng Cao Cấp – Kèm Bộ Bơm Hơi – Chính Hãng miDoctor – Trụ Đấm Bốc Tự Cân Bằng - mi01",169000,169000,0,0
TIKI,the-thao-da-ngoai,120423751,"Dây nhảy thể thao lõi thép cao cấp Rhino J501 tự động đếm số, tích hợp đo calo, quãng đường, độ dài dây tùy chỉnh - Dùng cho Muay | Boxing | Kickboxing - Hàng chính hãng",75000,79000,4000,5
TIKI,the-thao-da-ngoai,128869142,"[LOẠI XỊN TRẦN BÔNG] (FREE SHIP) Túi ngủ văn phòng du lịch cao cấp có trùm đầu - Chính hãng",168000,280000,112000,40
TIKI,the-thao-da-ngoai,97568965,"Con Lăn Tập Cơ Bụng Sáu Múi CLEACCO MAGIC SIX PACKS Khung Chắc Chắn , Chống Trượt Tải Trọng 150kg - Hàng Chính Hãng BORO SPORT",277000,431000,154000,36
TIKI,the-thao-da-ngoai,40778009,"Quần short nam thể thao thun lạnh cao cấp thoải mái, năng động, trẻ trung – FORMEN SHOP – FMPS094",99000,179000,80000,45
TIKI,the-thao-da-ngoai,58566151,"Dây mini band kháng lực tập gym, tập mông GoodFit GF912MB",64000,119000,55000,46
TIKI,the-thao-da-ngoai,77899679,"Sữa bổ sung đạm dành cho người ăn chay từ đậu hà lan Pea Protein Isolate Myprotein 1kg",570000,570000,0,0
TIKI,the-thao-da-ngoai,36302135,"Thảm Tập Yoga Định Tuyến Da PU Cao Cấp Chính Hãng miDoctor + Túi Đựng Thảm Tập Yoga + Dây Buộc Thảm Yoga Định Tuyến",366000,366000,0,0
TIKI,the-thao-da-ngoai,182819727,"Dây Nhảy Đếm Số, Quy Đổi Ra Calo, Khoảng Cách Chính Hãng Amalife - Kèm Bóng Xoay Cho Người Mới Bắt Đầu Tập",75000,75000,0,0
TIKI,the-thao-da-ngoai,71957055,"Dây nhảy lõi thép, dây nhảy thể dục, thể lực GoodFit chiều dài 3m, trục xoay 360 độ Goodfit GF901JR",139000,249000,110000,44
TIKI,the-thao-da-ngoai,31569928,"Quần short nam thể thao thun lạnh cao cấp thoải mái, năng động, trẻ trung – FORMEN SHOP – FMPS090",99000,189000,90000,48
TIKI,the-thao-da-ngoai,176623637,"Đai Treo Kéo Giãn Cột Sống Chữa Thoát Vị Đĩa Đệm Chính Hãng Đại Nam Sport Thế Hệ Mới",182000,400000,218000,55
TIKI,the-thao-da-ngoai,275453997,"Rule 1 Protein Isolate 5Lbs - Sữa tăng cơ Rule1 - Whey Protein R1",1590000,1590000,0,0
TIKI,the-thao-da-ngoai,58360279,"Băng cổ tay thấm mồ hôi GoodFit chất cotton mềm mại an toàn cho da GF303W",62000,99000,37000,37
TIKI,the-thao-da-ngoai,77037910,"Bộ cần câu Lure máy ngang chính hãng -  Cần Lure 2 ngọn -  tặng kèm ngọn cần + cước CL01",599000,599000,0,0
TIKI,the-thao-da-ngoai,10074563,"Sữa tăng cơ Impact Whey Protein Myprotein 2.5kg - Nutrition Depot",1590000,1590000,0,0
TIKI,the-thao-da-ngoai,56384512,"Bộ Dụng Cụ Hít Đất Chống Đẩy 9 in 1 – Dụng Cụ Chống Đẩy - Hít Đất - Chính Hãng miDoctor",199000,199000,0,0
TIKI,the-thao-da-ngoai,68282442,"Bó gối thể thao, băng đầu gối, băng bảo vệ đầu gối tập gym GoodFit co giãn 4 chiều, dệt 3D dày dặn GF518K",112000,149000,37000,25
TIKI,the-thao-da-ngoai,174597319,"Vòng Lắc Eo Giảm Mỡ Bụng Lõi Thép Không Gỉ Bọc Mút Xốp, Có Thể Điều Chỉnh Cân Nặng - Chính Hãng Amalife",167000,167000,0,0
TIKI,the-thao-da-ngoai,162167871,"Xe đạp tập thể dục thể thao, gym, fitness tại nhà Toshiko X9 - giúp tăng cơ, giảm mỡ hiệu quả",2470000,4990000,2520000,51
TIKI,the-thao-da-ngoai,112168798,"Khung nắn chỉnh cột sống - Đai kéo giãn cột sống cổ - Chống thoái hóa cột sống, Dụng Cụ Tập Lưng - Hàng nhập khẩu Chính Hãng KitAcoom ( Giao màu ngẫu nhiên)",89000,89000,0,0
TIKI,the-thao-da-ngoai,161237585,"Bó Gối Dài Chính Hãng, Băng Gối Dài Thể Thao Ôm Cơ Glofit VN030A | Long Knee Sleeves Glofit VN030A (1 Chiếc)",180000,290000,110000,38
TIKI,the-thao-da-ngoai,4686101,"Dây đàn hồi mini band,Bộ 5 dây đàn hồi tập gym tập yoga dây đàn hồi kháng lực cao cấp, dây đàn hồi tập thể dục BG ( bộ 5 dây đủ màu trong 1 túi ) hàng nhập khẩu",59000,70000,11000,16
TIKI,the-thao-da-ngoai,196152970,"Xà Đơn Treo Tường Gắn Cửa Đa Năng Chịu Lực Độ Dài Tùy Chỉnh Giúp Bạn Tập Gym, Tập Cơ Bụng, Cơ Vai, Cơ Xô 60-140Cm Cao Cấp Agnite - Hàng Chính Hãng - Tập Luyện Tại Nhà Tay Cầm Bọc Đệm Chống Trượt",119000,139000,20000,14
TIKI,the-thao-da-ngoai,73530013,"Băng cổ tay thấm mồ hôi thể thao nam nữ Boer 0230 Sports Bandage Aol (1 chiếc) - Băng thấm mồ hôi, cuốn cổ tay thể thao - Chạy bộ, đạp xe, bóng đá, bóng bàn, bóng chuyền, hoạt động ngoài trời - Hàng chính hãng",10000,19000,9000,47
TIKI,the-thao-da-ngoai,38419309,"Thảm Tập Yoga Định Tuyến Chính Hãng Amalife + Bao Thảm Tập Yoga Định Tuyến + Dây Buộc",125000,125000,0,0
TIKI,the-thao-da-ngoai,19696906,"Bộ Dây Ngũ Sắc miDoctor - Dây Ngũ Sắc Chính Hãng",85000,85000,0,0
TIKI,the-thao-da-ngoai,74537393,"Quần áo bóng rổ trẻ em chất thun siêu nhẹ mặc thoáng mát cao cấp",74000,74000,0,0
TIKI,the-thao-da-ngoai,96043669,"Tạ đeo chân tay chạy bộ thể thao",169000,169000,0,0
TIKI,the-thao-da-ngoai,192562929,"Kìm Tập Cơ Tay KUNOSPORT Loại Không Đếm Số",36000,50000,14000,28
TIKI,the-thao-da-ngoai,16764525,"Nón Bơi Vải PU Yesure Cleacco Cao Cấp",174000,174000,0,0
TIKI,the-thao-da-ngoai,147778093,"[HÀNG CAO CẤP - CHỐNG NỔ] Bóng Tập Yoga Cỡ Đại 65cm, 75cm - Bóng Tròn Yoga Cao Cấp - Hàng Chính Hãng dododios",140000,140000,0,0
TIKI,the-thao-da-ngoai,165341879,"Còi Đồng Thể Thao Cao Cấp US ARMY U889, Còi Đồng Huấn Luyện Viên, Trọng Tài Tiếng Kêu To Và Vang , Dùng Cho Hoạt Động Ngoài Trời Du Lịch, Đá Bóng- HÀNG CHÍNH HÃNG",115000,238000,123000,52
TIKI,the-thao-da-ngoai,67215716,"Dụng Cụ Bẻ Cổ Tay và Kìm Bóp Cơ Tay Lực Điều Chỉnh 5-60Kg Dùng Cho Mọi Lứa Tuổi (Màu ngẫu nhiên)",85000,170000,85000,50
TIKI,the-thao-da-ngoai,86999917,"Băng bảo vệ đầu gối Rhino P7720 (1 Đôi) Bó gối thể thao Đai bảo vệ đầu gối khớp gối Băng quấn đầu gối khớp gối hàng chính hãng dành cho cả nam và nữ",93000,105000,12000,11
TIKI,the-thao-da-ngoai,58293367,"Bao tay tập gym, găng tay hở ngón tập xà đơn nam nữ GoodFit đệm silicone chống trượt, mỏng nhẹ thoáng khí GF203G",179000,250000,71000,28
TIKI,the-thao-da-ngoai,90526759,"Xà Đơn Treo Tường Gắn Cửa Thế Hệ Mới 2021 Đầu Xà Hình Chữ Nhật Chịu Lực 250kg Đại Nam Sport + Kèm Găng Tay Tập Xa",212000,450000,238000,53
TIKI,the-thao-da-ngoai,175850022,"Kìm Bóp Tay, Kìm Tập Cơ Tay, Dụng Cụ Tập Cơ Tay Tập Gym Điều Chỉnh Lực 10-60kg Có Đếm",29000,58000,29000,50
TIKI,the-thao-da-ngoai,56387585,"Dụng Cụ Hít Đất Chống Đẩy – Đa Dạng 14 Bài Tập – Nhiều Nút 14 in 1 – Dụng Cụ Chống Đẩy Chính Hãng miDoctor",137000,137000,0,0
TIKI,the-thao-da-ngoai,52240862,"Giày Thể Thao Nam Biti's Hunter X DSMH02800TRG (Size",895000,971000,76000,8
TIKI,the-thao-da-ngoai,39079101,"Vỏ Bao Cát Đấm Bốc 3 Lớp Cao Cấp – 8 Phụ kiện – Vỏ Bao Đấm Boxing Chính Hãng Amalife, Trụ Đấm Bốc Treo",269000,269000,0,0
TIKI,the-thao-da-ngoai,51342947,"Kính Bơi Tráng Gương  kèm bịt tại cao cấp Cleaco chống sương mù , chống tia UV Hàng chính hãng - Tặng kèm nón bơi Silicon  ( Màu ngẫu nhiên )",255000,404000,149000,37
TIKI,the-thao-da-ngoai,71929064,"Mút ngực cho Áo tập Yoga Gym Hibi Sports MUT007 - Loại bầu siêu nâng - 1 cặp",32000,40000,8000,20
TIKI,the-thao-da-ngoai,59080455,"Giày Thể Thao Nam Biti's Hunter Street Mid Americano DSMH03600DEN Màu",701000,761000,60000,8
TIKI,the-thao-da-ngoai,103209746,"[TẶNG HỘP CẦU] Cặp vợt cầu lông cán liền nhôm carbon siêu nhẹ chính hãng Agnite -  Tặng hộp cầu nhựa và bao đựng - F2132",449000,932400,483400,52
TIKI,the-thao-da-ngoai,174086636,"Mút ngực định hình Oval cho Áo tập yoga gym Hibi Sports MUT009 - 1 cặp",32000,40000,8000,20
TIKI,the-thao-da-ngoai,147406452,"Xà Đơn Treo Tường Gắn Cửa Điều Chỉnh Độ Dài Linh Hoạt, Mẫu Mới Chất Liệu Thép Không Gỉ Chịu Lực 150kg, Tay Cầm Bọc Đệm PVC Chống Trượt - Chính hãng dododios",362000,362000,0,0
TIKI,the-thao-da-ngoai,193003821,"Dây kháng lực tập gym tập mông Cabasports",40000,40000,0,0
TIKI,the-thao-da-ngoai,180851207,"Găng tay cụt ngón da lộn Cao Cấp Hatsu Pearl Izumi | Găng tay đi phượt | Găng tay chạy xe máy, Xe Đạp Nửa Ngón Có Đệm Chống Sốc - Hàng chính hãng",83000,83000,0,0
TIKI,the-thao-da-ngoai,58211146,"Bó gối thể thao, băng đầu gối thủ môn, băng bảo vệ đầu gối tập gym GoodFit đệm silicone, thanh lò xo trợ lực GF515K",152000,249000,97000,39
TIKI,the-thao-da-ngoai,35367014,"Thảm Tập YoGa TPE Dày 6mm Gym miDoctor + Bao Thảm Tập Yoga + Dây Thảm Tập Yoga (Túi, Dây Giao Màu Ngẫu Nhiên)",125000,125000,0,0
TIKI,the-thao-da-ngoai,146417286,"Thảm tập gym, thể hình, thể dục tại nhà, chống trơn trượt, độ bám ma sát cao + túi đựng dễ dàng di chuyển + dây buộc thảm chuyên dụng - giao màu ngẫu nhiên - thảm dày 2 lớp - Chính hãng dododios",230000,230000,0,0
TIKI,the-thao-da-ngoai,146499071,"[LOẠI TỐT - HÀNG CAO CẤP] Thảm Tập Yoga 8mm, Tập Gym dộ dày 5-8mm 2 Lớp không mùi chống trơn trượt - Chính hãng dododios",118000,118000,0,0
TIKI,the-thao-da-ngoai,257855333,"Xà Đơn Treo Tường 60-150cm Gắn Cửa Đa Năng Độ Dài Tùy Chỉnh Giúp Bạn Tập Gym, Tập Cơ Bụng, Cơ Vai, Cơ Xô treo tường gắn cửa độ dài tùy chỉnh (hàng nhập khẩu)",88000,179000,91000,51
TIKI,the-thao-da-ngoai,16719308,"Quần Bơi Nam Thiết Kế Vảy Cá Mập Yesure Chống Thấm Nước , Nhanh Khô  Tặng Kèm Nón Bơi và Bịt Tai Silicon Cao Cấp",101000,201000,100000,50
TIKI,the-thao-da-ngoai,52508450,"Quần tập Yoga Gym dài nâng mông có 2 túi bên hông cho nữ Thiết kế cao cấp Hibi Sports Mã QD307",216000,270000,54000,20
TIKI,the-thao-da-ngoai,151506141,"Túi lưới đựng bóng AOLIKES A-TB002",37000,69000,32000,46
TIKI,the-thao-da-ngoai,170154837,"Đồ Bơi Liền Thân Tay Dài - Black Bodysuit",416000,520000,104000,20
TIKI,the-thao-da-ngoai,130743716,"Quả bóng đá ngoại hạng Anh 2020-2021 - Banh bóng đá da số 5 - Tặng bơm, túi rút, kim bơm và túi lưới",143000,215000,72000,33
TIKI,the-thao-da-ngoai,168467782,"Viên Muối Điện Giải GU Roctane Electrolyte Capsules - (50 viên/Hũ)",330000,330000,0,0
TIKI,the-thao-da-ngoai,28050767,"Đồ Chơi Bóng Rổ Trẻ Em Cho Bé Trụ Sắt Kèm 2 Bóng - Chính Hãng Amalife",255000,255000,0,0
TIKI,the-thao-da-ngoai,37989729,"Bộ 2 Vợt Bóng Bàn Chính Hãng Amalife + Túi Đựng Vợt Bóng Bàn + 3 Bóng",175000,175000,0,0
TIKI,the-thao-da-ngoai,127597034,"[Loại Tốt – Lõi Thép] Dây nhảy thể dục có thể điều chỉnh dây, Dây nhảy lõi thép, không bị rối dùng để tập thể dục độ dài 2.9m, hỗ trợ giảm cân – Chính hãng miDoctor",29000,29000,0,0
TIKI,the-thao-da-ngoai,20071943,"Viên Điện Giải GU Roctane Electrolyte Capsules - (50 viên / Hũ)",375000,375000,0,0
TIKI,the-thao-da-ngoai,21030046,"Găng Tay Boxing Trẻ Em Chính Hãng miDoctor - Găng Tay Đấm Bốc",99000,99000,0,0
TIKI,the-thao-da-ngoai,68726892,"BỘ ĐÔI TẠ NẶNG  20KG TẠ  MIẾNG NHỰA ĐEN CAO CẤP ĐA NĂNG ",459000,918000,459000,50
TIKI,the-thao-da-ngoai,104639197,"Gậy Bóng Chày Cải Tiến 2.0 Dài 81Cm – Thon Hơn – Nhẹ Hơn – Cứng Hơn – Chọn Màu - Kèm Túi Đựng Gậy Bóng Chày Chuyên Dụng Chính Hãng miDoctor",109000,109000,0,0
TIKI,the-thao-da-ngoai,1811811,"Thực phẩm bổ sung Optimum Nutrition Serious Mass 6lb (2.72kg)",1000000,1000000,0,0
TIKI,the-thao-da-ngoai,87380660,"Con Lăn Foam Roller Massage Gai 33cm - Ống Lăn Dãn Cơ Tập Gym, Yoga, Thể Hình miDoctor",99000,200000,101000,51
TIKI,the-thao-da-ngoai,37897909,"Gạch Tập Yoga Cao Cấp miDoctor (Gối Tập Yoga)",39000,39000,0,0
TIKI,the-thao-da-ngoai,3729941,"Quả bóng đá Động Lực Cơ bắp UCV 3.05 số 5 (Tiêu chuẩn thi đấu, Kèm kim bơm và lưới đựng bóng).",284500,284500,0,0
TIKI,the-thao-da-ngoai,35133837,"Thực phẩm bố sung Rule 1 Essential Amino 9, 345g - 30 servings",550000,550000,0,0
TIKI,the-thao-da-ngoai,64368802,"Bộ dụng cụ hít đất chống đẩy hướng dẫn tập luyện hít đất chống đẩy đúng cách, tập hít đất thích hợp cho cử tạ, tập gym",149500,299000,149500,50
TIKI,the-thao-da-ngoai,35231046,"Kìm Bóp Tay Tập Luyện Điều Chỉnh Lực (Từ 5-60kg)-Giao Màu Ngẫu Nhiên",37000,39000,2000,5
TIKI,the-thao-da-ngoai,186591339,"Vợt cầu lông siêu nhẹ khung carbon cao cấp Agnite - Kèm bao đựng cao cấp - 1 chiếc - Hàng chính hãng - F2115",329000,716400,387400,54
TIKI,the-thao-da-ngoai,10075672,"Sữa tăng cơ Impact Whey Protein Myprotein 1kg - Nutrition Depot",820000,980000,160000,16
TIKI,the-thao-da-ngoai,13787289,"Băng Quấn Cổ Tay Đàn Hồi Hỗ Trợ Khớp Cổ Tay Khi Chơi Thể Thao Sports Bandage AOLIKES YE-1535",26000,26000,0,0
TIKI,the-thao-da-ngoai,21731611,"[QUÀ TẶNG] Sữa tăng cơ Wheylabs Pro Standard Whey Protein hũ 5lbs (2.2kg) ( 73 lần dùng)",1440000,1450000,10000,1
TIKI,the-thao-da-ngoai,257866630,"Bộ 2 tạ tay lõi sắt bọc cao su, tạ tập tay cao su 1kg 2kg 3kg 4kg 5kg BG (hàng nhập khẩu)",152000,299000,147000,49
TIKI,the-thao-da-ngoai,11763808,"Kính Bơi Cận (CÓ THỂ LỆCH ĐỘ), Chống TRẦY, Chống UV, Chống Hấp Hơi",123000,123000,0,0
TIKI,the-thao-da-ngoai,272461062,"Sữa tăng cơ Rule 1 Whey Blend 9.9lb - 132-133 servings",2200000,2200000,0,0
TIKI,the-thao-da-ngoai,107233351,"Dây kháng lực tập gym cao su tự nhiên Rhino R101 mức lực kéo phân theo từng màu, Resistance Elastic Bands dây đàn hồi, kháng lực power band tập gym, dây cao su hỗ trợ lên xà",179000,179000,0,0
TIKI,the-thao-da-ngoai,58609689,"Băng khuỷu tay hỗ trợ bảo vệ khuỷu tay, củi chỏ có thanh lò xo cố định, dễ điều chỉnh Goodfit GF401E",89000,150000,61000,41
TIKI,the-thao-da-ngoai,21042939,"Vỏ Bao Cát Đấm Bốc 3 Lớp Cao Cấp – Vỏ Bao Cát Boxing Chính Hãng miDoctor, Trụ Đấm Bốc Treo",339000,339000,0,0
TIKI,the-thao-da-ngoai,58456464,"Băng đô thể thao headband GoodFit GF801SB",64000,89000,25000,28
TIKI,the-thao-da-ngoai,162168466,"Xe đạp tập thể dục trong nhà Toshiko X11, xe đạp thể thao có đồ hồ hiển thị quãng đường, calo tiêu thụ, giảm mỡ, săn chắc cơ thể",4380000,8200000,3820000,47
TIKI,the-thao-da-ngoai,190463928,"BG Bơm bóng cầm tay mini - Dụng cụ bơm bóng Yoga( hàng nhập khẩu)",8000,45000,37000,82
TIKI,the-thao-da-ngoai,91772617,"Xà Đơn Treo Tường Thông Minh Di Động Inox Không Cần Bắt Vít DNS011 Chịu Lực 150kg Đại Nam Sport + Kèm Găng Tay Tập Xà",118000,220000,102000,46
TIKI,the-thao-da-ngoai,272445794,"Thực phẩm tăng cơ Rule 1 Protein Isolate/ Hydrolysate 4.8-5.01lb tặng Rule 1 Shaker",1600000,1600000,0,0
TIKI,the-thao-da-ngoai,50737254,"Sữa Tăng Cân Mass Muscle Gainer Elite Labs SMEL253 (2.3kg)",1150000,1150000,0,0
TIKI,the-thao-da-ngoai,96362741,"Viên uống tăng cường sức bền Endurance BCAA Hammer Nutrition - Tổng hợp Protein, kéo dài thời gian tập luyện, chạy bộ",850000,850000,0,0
TIKI,the-thao-da-ngoai,57909247,"Combo 3 Sản Phẩm Xăng, Đá, Bấc Zippo",195000,195000,0,0
TIKI,the-thao-da-ngoai,193411542,"Áo bra tập yoga gym Hibi Sports BA508 kiểu cổ yếm ba lỗ, kèm mút ngực",199000,340000,141000,41
TIKI,the-thao-da-ngoai,793832,"Cặp Vợt Cầu Lông HT VHTTC - Tím ",316000,316000,0,0
TIKI,the-thao-da-ngoai,67359457,"Bó gối thể thao, băng đầu gối GoodFit đệm xốp dày dặn, co giãn 4 chiều GF517K",89000,129000,40000,31
TIKI,the-thao-da-ngoai,23630553,"Túi đai đeo bụng chạy bộ chống nước Rimix RM2202",148000,159000,11000,7
TIKI,the-thao-da-ngoai,23307420,"Quần bơi nam Vải dày đẹp - Quần bơi hè mẫu mới hot",55000,55000,0,0
TIKI,the-thao-da-ngoai,26025780,"Bộ Bảng Phóng Phi Tiêu An Toàn Cao Cấp và 6 Mũi Tiêu Có Móc Treo Cực Tiện",329000,329000,0,0
TIKI,the-thao-da-ngoai,57691713,"Găng tay tập gym nữ/nam hở ngón, bao tay tập Gym nữ/nam có quấn trợ lực cổ tay, đệm Silicone chống trượt GoodFit GF201G",179000,250000,71000,28
TIKI,the-thao-da-ngoai,52506460,"Quần tập Yoga Gym lửng trơn cho nữ Thiết kế cao cấp Hibi Sports mã QD403",208000,260000,52000,20
TIKI,the-thao-da-ngoai,274189228,"Đèn Pin Led Đội Đầu Essesa Mingray Sạc USB - Hàng Chính Hãng",90250,95000,4750,5
TIKI,the-thao-da-ngoai,161497905,"Bộ 2 Tạ Tay Nhựa Bát Giác 5kg REEFIT (2 tạ 5kg, tổng 10kg)",70000,70000,0,0
TIKI,the-thao-da-ngoai,67248388,"Dây dù câu cá cao cấp - Siêu bền - Siêu bạo lực - Siêu dai - Dài 100m DC03",149000,149000,0,0
TIKI,the-thao-da-ngoai,82956669,"Bình Nước Thể Thao Chất Liệu TriTan UZSPACE - BPA Free An Toàn Cho Sức Khỏe, Chịu nhiệt -20°C~96°C (500ml, 650ml, 1000ml)",250000,350000,100000,29
TIKI,the-thao-da-ngoai,134843549,"Gạch Tập Yoga Chọn Màu Chính Hãng Amalife Cao Cấp – Gối Tập Yoga Gạch Yoga Loại Nặng",39000,39000,0,0
TIKI,the-thao-da-ngoai,54624624,"Combo 1 xăng 1 đá zippo chính hãng Mỹ bao bì mới",150000,150000,0,0
TIKI,the-thao-da-ngoai,146490535,"THẢM TẬP YOGA, GYM 2 LỚP CAO CẤP CHỐNG TRƯỢT + TÚI ĐỰNG THẢM TẬP YOGA + DÂY BUỘC CHUYÊN DỤNG - CHÍNH HÃNG DODODIOS",151000,151000,0,0
TIKI,the-thao-da-ngoai,88074604,"Bao, Túi đựng Điện Thoại tới 6.5 Inch Đeo tay chạy bộ ,Tập thể dục Rhino B101 Kháng nước, chống thấm, có thể cắm tai nghe phù hợp điện thoại Samsung, Iphone, Sony, Xiaomi,... - Hàng chính hãng",85000,99000,14000,14
TIKI,the-thao-da-ngoai,173652019,"Dụng cụ chống đẩy, hít đất cao cấp đế chống trượt, chịu lực 300kg hàng chính hãng Goodfit GF301PU",135000,249000,114000,46
TIKI,the-thao-da-ngoai,58457607,"Bó gối thể thao, băng đầu gối, đai bảo vệ đầu gối tập gym GoodFit đệm bảo vệ dày dặn, silicone chống trượt GF516K",90000,129000,39000,30
TIKI,the-thao-da-ngoai,9840511,"Combo 5 cuộn cuốn cán vợt cầu lông, tennis chính hãng VS (màu ngẫu nhiên)",87000,87000,0,0
TIKI,the-thao-da-ngoai,133168110," Bình Nước Thể Thao Cao Cấp Đựng Nước Nóng Lạnh Dung Tích 750ml ",105000,105000,0,0
TIKI,the-thao-da-ngoai,896389,"Găng Tay Tập Tạ Có Cuốn Đại Việt Sport GT-HP",39000,120000,81000,68
TIKI,the-thao-da-ngoai,113662729,"Dây nhảy thể thao lõi thép cao cấp Rhino J101 tự động đếm số, tích hợp đo calo, quãng đường - Dùng cho Muay | Boxing | Kickboxing - Hàng chính hãng",75000,80000,5000,6
TIKI,the-thao-da-ngoai,275255877,"Bình Nước Thể Thao Gymlink G88 500ml Sportslink (Màu ngẫu nhiên)",95000,99000,4000,4
TIKI,the-thao-da-ngoai,57789702,"Set đồ tập Yoga Gym 8 dây Thiết kế cao cấp Hibi Sports Mã H101 - Áo bra 8 dây - Quần lưng cao phối lưới tôn dáng - Áo có mút nâng ngực",329000,420000,91000,22
TIKI,the-thao-da-ngoai,2282591,"Bộ 2 Bình Xăng Zippo (125ml)",195000,195000,0,0
TIKI,the-thao-da-ngoai,169549326,"Set đồ tập yoga gym Luxury Hibi Sports H145 4 dây đan VX, màu Đen và Tím Nhạt kèm mút ngực, vải cao cấp Hi Fabric",649000,950000,301000,32
TIKI,the-thao-da-ngoai,175146761,"Phao tập bơi liền thân cho bé 2-10 tuổi, Áo phao tập bơi trẻ em, Phao tay đỡ ngực bé trai bé gái - Chính hãng MINIIN (Giao họa tiết, mẫu ngẫu nhiên)",151000,175000,24000,14
TIKI,the-thao-da-ngoai,67455374,"Đai lưng tập gym, đai bảo vệ cột sống chống đau lưng thanh nẹp lò xo GoodFit GF722WS",224000,329000,105000,32
TIKI,the-thao-da-ngoai,147999789,"Băng quấn bó gối ( 1 cái ) bảo vệ đầu gối , khớp gối 2 trong 1 , Giúp tránh chấn thương , tăng khả năng vận động linh hoạt CLEACCO  - Hàng chính hãng BORO SPORT",106000,194000,88000,45
TIKI,the-thao-da-ngoai,274657967,"Bộ 3 dây kháng lực tập cơ mông đùi chân Hip Resistance bands Aolikes AL3604 3604 Chính Hãng",42000,42000,0,0
TIKI,the-thao-da-ngoai,274994099,"Bg Xe đạp tập thể dục trong nhà Mẫu Exercise Bike: YS02 (hàng nhập khẩu)",869000,1588000,719000,45
TIKI,the-thao-da-ngoai,52021481,"Giày Trượt Patin Trẻ Em Cougar 835L",699000,699000,0,0
TIKI,the-thao-da-ngoai,139948349,"Bình Nước Thể Thao Giữ Nhiệt 500ml INOX Không Gỉ Gắn Trên Xe Đạp / Ô tô / Xe Hơi Có Ống Hút",155000,155000,0,0
TIKI,the-thao-da-ngoai,253631355,"BG Con Lăn Massage Ống Lăn Dãn Cơ Foam Roller  Tập Gym, Yoga, Thể Hình,Đai Đeo Huấn Luyện Tập Đá Bóng,Thang dây tập luyện thể thao thể lực và tốc độ(hàng nhập khẩu)",54000,119000,65000,55
TIKI,the-thao-da-ngoai,91754469,"Con Lăn Tập Cơ Bụng Thế Hệ Mới Trợ Lực Bằng Lò Xo Kép Chính Hãng Đại Nam Sport + Kèm Tấm Thảm Lót",184000,550000,366000,67
TIKI,the-thao-da-ngoai,174257388,"Giày cầu lông Kawasaki k098 mẫu mới có 3 màu lựa chọn-tặng tất thể thao bendu chính hãng",1090000,1090000,0,0
TIKI,the-thao-da-ngoai,191375822,"Lều cắm trại tự bung , lều du lịch dã ngoại dành cho 3-5 người hoặc 6-8 người, chống thấm nước",945000,945000,0,0
TIKI,the-thao-da-ngoai,146996011,"Kính Thể Thao Bảo Vệ Mắt - Kính Chơi Thể Thao Cao Cấp dododios - Có Thể Thay Mắt Kính Cho Người Cận",29000,29000,0,0
TIKI,the-thao-da-ngoai,188915910,"Quần đùi nam ngắn chạy bộ Fasvin R21451.HN vải Dù Gió nhẹ mát tiện dụng thể thao hay mặc nhà",79000,138000,59000,43
TIKI,the-thao-da-ngoai,146553463,"Dây Ngũ Sắc Tập Gym Chính Hãng dododios - Bộ 5 Dây Ngũ Sắc Đàn Hồi Tập Thể Hình Đa Năng Tại Nhà",247000,247000,0,0
TIKI,the-thao-da-ngoai,189465174,"Xà Đơn Gắn Cửa FED-0228 | Kích thước 90-115cm (Chịu lực 400kg - Có chốt khóa an toàn khi gắn xà - Dễ dàng tháo lắp không cần khoan tường)",590000,690000,100000,14
TIKI,the-thao-da-ngoai,148937405,"Băng quấn bảo vệ cổ tay tập gym yoga street workout wrist tránh chấn thương cổ tay , tăng khả năng vận động CLEACCO - Hàng chính hãng  BORO SPORT",78000,154000,76000,49
TIKI,the-thao-da-ngoai,76181551,"Dây kéo lưng hỗ trợ tập deadlift cho người tập gym, dây kéo tạ, dây hỗ trợ lên xà - Lifting Straps",39000,39000,0,0
TIKI,the-thao-da-ngoai,91779988,"Thảm Tập Yoga Và Gym Chất Liệu Cao Cấp TPE 6mm 2 Lớp DNS012 Đại Nam Sport Chống Trơn+ Tặng Kèm Túi Và Dây Buộc",72000,250000,178000,71
TIKI,the-thao-da-ngoai,53598503,"Đá zippo chính hãng mỹ mẫu mới",45000,45000,0,0
TIKI,the-thao-da-ngoai,1815329,"Thực phẩm bổ sung Optimum Nutrition Gold Standard 100% Whey 5lb (2.27kg)",1640000,1640000,0,0
TIKI,the-thao-da-ngoai,43764552,"Găng Tay Tập Gym Glofit GFST004. Găng Tay Tập Gym Cao Cấp Cho Nam Nữ (Hàng Chính Hãng)",390000,490000,100000,20
TIKI,the-thao-da-ngoai,193549764,"Dây nhảy thể thao lõi thép cao cấp eXtreme DN101 tự động đếm số, tích hợp đo calo, quãng đường, độ dài dây tùy chỉnh, nhảy dây thể dục - Hàng chính hãng",78000,99999,21999,22
TIKI,the-thao-da-ngoai,708544,"Dây Nhảy Muay - Boxing - Kickboxing Sportslink (2m6)",114000,228000,114000,50
TIKI,the-thao-da-ngoai,33342224,"Mass Gainer Sữa tăng cơ Rule 1 Mass Gainer 2.6kg tặng gói thử Rule 1",700000,700000,0,0
TIKI,the-thao-da-ngoai,8490564,"Băng quấn cổ tay tập gym cao cấp AOLIKES HW-7937",39000,39000,0,0
TIKI,the-thao-da-ngoai,173699773,"Giày Thể Thao Nữ Biti's Hunter Core 3D Airmesh White DSWH08700 Màu Trắng",694000,789000,95000,12
TIKI,the-thao-da-ngoai,193459697,"Thảm Picnic Du Lịch Dã Ngoại Gấp Gọn Chống Thấm Nước 2m x 2m Agnite - Thảm Gấp Gọn Du Lịch Đi Biển, Bạt Trải Lều Màu Sắc Trendy Trẻ Trung Nhiều Kích Cỡ - Hàng Chính Hãng",75000,142200,67200,47
TIKI,the-thao-da-ngoai,163901763,"Bó gối thể thao Băng bảo vệ đầu gối chống chấn thương chống tuột chơi Đá Bóng Bóng rổ Tennis Bóng chuyền Gym Chạy bộ Đạp xe- Redikick",79000,129000,50000,39
TIKI,the-thao-da-ngoai,147917217,"Khung nắn chỉnh cột sống, hỗ trợ thoát vị đĩa đệm, thoái hóa, đau lưng, vai gáy (Giao màu ngẫu nhiên) - Định Hình Tư Thế Nằm/Ngồi Chuẩn - 10 Chấm Từ Trường Tác Động Sâu Vào Các Huyệt Đạo - Đẩy Lùi Đau Lưng, Thoát VỊ Đĩa Đệm - Hàng Cao Cấp",52000,52000,0,0
TIKI,the-thao-da-ngoai,39361385,"Găng Tay Có Móc Thép Nâng Tạ Weight Lifting Hook Aolikes (1 Đôi)",185000,185000,0,0
TIKI,the-thao-da-ngoai,92228061,"Quần tập Yoga Gym lửng dành cho nữ Hibi Sports QL404 - Quần lưng cao có túi",216000,270000,54000,20
TIKI,the-thao-da-ngoai,196470144,"Miếng đệm đầu gối, Bó gối tập Yoga chống chai đầu gối cho nữ",76000,79000,3000,4
TIKI,the-thao-da-ngoai,823556,"Cặp Vợt Cầu Lông Liên Hiệp Thành V9999 ",226000,226000,0,0
TIKI,the-thao-da-ngoai,175844529,"Giày bóng bàn, cầu lông CP045",263000,350000,87000,25
TIKI,the-thao-da-ngoai,173383146,"Tấm Bạt Thảm Dã Ngoại Picnic Du Lịch Trải Lót Lều Cắm Trại Chống Thấm Nước Cao Cấp Galaxy Store GSTL04 Xếp Gọn Nhẹ - Hàng Chính Hãng",199000,199000,0,0
TIKI,the-thao-da-ngoai,270650707,"Hộp 12 thanh năng lượng PLAY 2.0 vị macca và bơ đậu phộng – Thanh ngũ cốc dinh dưỡng PLAY Energy Bar",295000,360000,65000,18
TIKI,the-thao-da-ngoai,104721101,"Túi Đựng Giày Patin Centosy",150000,150000,0,0
TIKI,the-thao-da-ngoai,66496297,"Khăn Trải Thảm Tập Yoga Chính Hãng Kèm Túi Đựng - Nhiều Màu Phủ Hạt Cao su non Cao Cấp",99000,198000,99000,50
TIKI,the-thao-da-ngoai,100369028," Quần đùi nam Fasvin Q21450.HN short thể thao vải gió chun trơn mát co giãn 4 chiều",89000,170000,81000,48
TIKI,the-thao-da-ngoai,10131309,"Gậy thể dục dưỡng sinh bằng gỗ Sportslink",110000,146000,36000,25
TIKI,the-thao-da-ngoai,68065736,"[ HỮU ÍCH] Túi Chống Nước Rando Waterlock - Đa Dụng - OBNS-01",106000,106000,0,0
TIKI,the-thao-da-ngoai,188915512,"Quần Đùi Nam FASVIN Vải Gió Đẹp Hàng Nhà Máy Chất Lượng Cao Thể Thao Hay Mặc Nhà Q21475.HN",79000,158000,79000,50
TIKI,the-thao-da-ngoai,36306774,"Gậy Bóng Chày 28 inchs (71cm) Hợp Kim Cao Cấp - Kèm Túi Đựng Gậy Bóng Chày Chuyên Dùng - Chính Hãng miDoctor",89000,89000,0,0
TIKI,the-thao-da-ngoai,127834632,"Máy chạy Toshiko MC22 PRO, giúp tăng cơ, giảm mỡ, rèn luyện sức khỏe, bảo hành 3 năm tại nhà",6990000,7988000,998000,12
TIKI,the-thao-da-ngoai,89476853,"Bộ Cặp Tạ Tay 2kg Bọc Cao Su (Tổng 4kg) -Hàng Cao Cấp Chính Hãng",250000,500000,250000,50
TIKI,the-thao-da-ngoai,38306022,"Giày vải đinh Thượng đình đá bóng màu trắng BD16",104000,239000,135000,56
TIKI,the-thao-da-ngoai,44434176,"Máy chạy bộ cơ đa năng BG mẫu mới Treadmill SH306 5 in 1 thích hợp cho mọi lứa tuổi luyện tập (hàng nhập khẩu)",1798000,2999000,1201000,40
TIKI,the-thao-da-ngoai,190624069,"Tất bảo vệ ống đồng vớ băng ống chân có đệm chống chấn thương, chống tuột chơi Bóng đá Bóng rổ Gym Muay thái - Redikick",169000,250000,81000,32
TIKI,the-thao-da-ngoai,54549801,"Giày đá bóng chính hãng Kamito Quang Hải QH19 Premium Pack",562800,562800,0,0
TIKI,the-thao-da-ngoai,1599729,"Ghế Tập Bụng Cong Muse Màu Có Chốt Gập BG SU-118",535000,1099000,564000,51
TIKI,the-thao-da-ngoai,59272783,"Băng Quấn Bảo Vệ Cổ Chân, Mắt Cá Chân VNS-GF066, Một Đôi Cho Hai Cổ Chân Khỏe Mạnh",219000,219000,0,0
TIKI,the-thao-da-ngoai,192563328,"Dụng cụ tập cơ tay chữ U KUNO SPORT tập cơ tay cổ tay loại cao cấp dẻo dễ tập",120000,120000,0,0
TIKI,the-thao-da-ngoai,160224187,"Tất thể thao Redikick ICON Light Cushion Cotton Cổ cao Có đệm Thoáng khí Chống hôi chân vớ Bóng rổ Bóng đá Chạy bộ Gym, Cầu Lông, Tennis, Bóng chuyền",129000,150000,21000,14
TIKI,the-thao-da-ngoai,68543337,"Con Lăn Foam Roller Massage gai 33cm- Ống Lăn Dãn Cơ Tập Gym, Yoga, Thể Hình",119000,238000,119000,50
TIKI,the-thao-da-ngoai,26226256,"Bộ 2 Băng dán thun thể thao tự dính Sportslink",15000,31000,16000,52
TIKI,the-thao-da-ngoai,176678330,"Thước dây Cabasports TD001đo cơ thể vòng eo 150cm giá rẻ",4500,5000,500,10
TIKI,the-thao-da-ngoai,179753969,"Vợt Cầu Lông VAX8.",285000,285000,0,0
TIKI,the-thao-da-ngoai,113737657,"Bộ 2 tạ tay cao cấp 1.5Kg( Tổng 3kg/Đôi)-Màu Ngẫu Nhiên",179000,358000,179000,50
TIKI,the-thao-da-ngoai,21459921,"Bộ kit đi bơi bịt tai và bịt mũi  chất liệu Silicon cao cấp Yesure ( Giao màu ngẫu nhiên )",5000,29000,24000,83
TIKI,the-thao-da-ngoai,196470637,"MIẾNG ĐỆM ĐẦU GỐI, BÓ GỐI HỖ TRỢ TẬP YOGA, GYM Chính hãng Aolikes bảo vệ đầu gối cho nữ",75000,79000,4000,5
TIKI,the-thao-da-ngoai,132815390,"Quần Bơi Nữ 2 Lớp Layer Legging Women Sobie",365500,430000,64500,15
TIKI,the-thao-da-ngoai,146564564,"Bộ Đồ Chơi Bóng Rổ Cho Bé Thân Sắt (Đủ Phụ Kiện) Điều Chỉnh Chiều Cao Của Trụ – Bóng Rổ Trụ Sắt Cao Cấp Cho Trẻ Em – Chính Hãng Dododios ",290000,290000,0,0
TIKI,the-thao-da-ngoai,68595188,"Thảm Yoga Cao Su Định Tuyến PU (Tặng kèm Túi đựng Thảm Và Dây Buộc Thảm)",399000,798000,399000,50
TIKI,the-thao-da-ngoai,146396099,"[Loại Tốt - Cao Cấp] Thảm tập yoga định tuyến PU cao su tự nhiên chống trơn trượt thấm hút mồ hôi + Dây Buộc Thảm Yoga Chuyên Dụng + Túi Đựng Thảm Cao Cấp Có Quai Đeo - Chính hãng dododios",507000,507000,0,0
TIKI,the-thao-da-ngoai,6658395,"Xe đạp tập thể dục kết hợp tay chân tập luyện trong nhà BG",1648000,2999000,1351000,45
TIKI,the-thao-da-ngoai,193894336,"Tất Xỏ 5 Ngón Cổ Thuyền Thể Thao Aonijie E4824 - Thoáng Khí, Chống Phồng Rộp, Công Nghệ Coolmax",180000,180000,0,0
TIKI,the-thao-da-ngoai,118407659,"Giày Tennis Nam chuyên dụng Jogarbola JG-222064",719000,850000,131000,15
TIKI,the-thao-da-ngoai,186558666,"Vòng Treo Gymnastic Rings Hỗ Trợ Tập Dip Với Xà Đơn, GYM Ring Ngoài Trời (1 Đôi)",295000,295000,0,0
TIKI,the-thao-da-ngoai,193603480,"Giày Thể Thao Nam Biti's Hunter Core DSMH09400XNH (Xanh Nhớt)",636000,794000,158000,20
TIKI,the-thao-da-ngoai,105534641,"Bao, Túi đựng Điện Thoại tới 7 Inch Đeo tay chạy bộ, Tập thể dục Rhino B141 Kháng nước, có thể cắm tai nghe",87000,170000,83000,49
TIKI,the-thao-da-ngoai,76673066,"Băng Bảo Vệ Khớp Gối Thể Thao 360º VN017 | ATHLETE'S KNEE PROTECTOR ( 1 ĐÔI ). Phù hợp đá banh, chạy bộ, bóng chuyền, bóng rổ, cầu lông, leo núi, đạp xe, tập luyện thể hình, chấn thương đau nhức gối",290000,500000,210000,42
TIKI,the-thao-da-ngoai,52700173,"Quần tập Yoga Gym cho nữ dài trơn thiết kế cao cấp Hibi Sports Mã QD308",216000,270000,54000,20
TIKI,the-thao-da-ngoai,35813292,"Băng Đầu Gối ADIDAS",294000,304000,10000,3
TIKI,the-thao-da-ngoai,176403882,"Dây Đai Tập Yoga Sợi Cotton, Dây Kéo Tập Yoga - Hỗ Trợ Kéo Giãn Chân Tay, Uốn Người Tập Yoga, Giúp Bạn Có Một Cơ Thể Dẻo Dai",19000,38000,19000,50
TIKI,the-thao-da-ngoai,59375941,"Bình nước thể thao tập gym kết hợp bình lắc whey shaker chất liệu TRITAN  dung tích 800ml CLEACCO dòng SHOKE  dung tích 800ml- tặng bóng khuấy",147000,255000,108000,42
TIKI,the-thao-da-ngoai,89877527,"BĂNG BẢO VỆ KHỚP ĐẦU GỐI 360º VNSPORT - VN019 (Pro) - KNEE SUPPORT 360º VN019 PROFESSIONAL. Độc Quyền Tại VNSport - Hàng Cao Cấp Chính Hãng (1 Chiếc )",390000,490000,100000,20
TIKI,the-thao-da-ngoai,173372092,"Quần tập yoga gym Luxury Hibi Sports QD312 kiểu lưng cao, chất vải cao cấp Lu Fabric",349000,700000,351000,50
TIKI,the-thao-da-ngoai,57854981,"Set 30 quả bóng bàn 40mm 1 sao GoodFit GF003TB",89000,120000,31000,26
TIKI,the-thao-da-ngoai,77578726,"Găng Tay tập Gym Có dây Quấn Trợ Lực Cổ Tay VNS002 (WEIGHT LIFTING GLOVES), Găng Tay Tập Gym Cao Cấp Có Phủ Da Trên Mu bàn Tay, Chống Chai Sần Lòng Bàn Tay, Bảo Vệ Khớp Cổ Tay - M",350000,450000,100000,22
TIKI,the-thao-da-ngoai,794380,"Cầu Lông Ống A3 3 Trái OA3",72000,72000,0,0
TIKI,the-thao-da-ngoai,70675831,"Bóng Tập Yoga 65cm Cao Cấp Bóng Gai Tặng Bơm bóng và Bộ Kim bóng dự phòng Loại dày 2mm",115000,230000,115000,50
TIKI,the-thao-da-ngoai,141298963,"Bóng Chuyền Da Chính Hãng OMEGA2000 - Tặng bơm, kim bơm, túi lưới - Quả bóng chuyền tiêu chuẩn cho người mới tập",118000,159000,41000,26
TIKI,the-thao-da-ngoai,94156554,"Bộ Nút Bịt Tai Và Kẹp Mũi Silicon Chống Nước Khi Bơi Lội Chính Hãng Đại Nam Sport",21000,50000,29000,58
TIKI,the-thao-da-ngoai,161497492,"Bộ 2 Tạ Tay Nhựa Bát Giác 3kg REEFIT (2 tạ 3kg, tổng 6kg)",45000,45000,0,0
TIKI,the-thao-da-ngoai,146553543,"[Mall] Đai chống gù lưng cho người lớn nam nữ, cải thiện vóc dáng, có nẹp tăng cường hiệu quả - Chính hãng dododios",171000,171000,0,0
TIKI,the-thao-da-ngoai,38100602,"Bộ 5 Dây Đàn Hồi, Dây Kháng Lực Tập Gym Chính Hãng Amalife",85000,85000,0,0
TIKI,the-thao-da-ngoai,41225158,"Túi Đựng Thảm Tập Yoga Cao Cấp miDoctor",69000,69000,0,0
TIKI,the-thao-da-ngoai,72625214,"(Bộ 2 chiếc) Dây cuốn cổ tay cho người tập Gym, Băng Cổ Tay, Bảo Vệ Chấn Thương - Phụ Kiện Thể Thao - Sọc đỏ đen",35000,35000,0,0
TIKI,the-thao-da-ngoai,95278227,"THUN GIỮ CUỐN CÁN VỢT TENNIS BABOLAT (giao màu ngẫu nhiên )",37500,39000,1500,4
TIKI,the-thao-da-ngoai,102760833,"Xà Đơn Treo Tường Đa Năng Di Động 8 Trong 1 Chính Hãng  + Tặng Kèm Dây Đàn Hồi Đa Năng",1390000,2780000,1390000,50
TIKI,the-thao-da-ngoai,84881067,"Quần bơi chống nắng nữ SPEEDO - SOJ20023",373000,1065000,692000,65
TIKI,the-thao-da-ngoai,58897950,"Giày bóng rổ PEAK Streetball Master DA830551",849000,1090000,241000,22
TIKI,the-thao-da-ngoai,81610036,"Quần Đi Biển Nam SPEEDO - 8-124330001",565000,565000,0,0
TIKI,the-thao-da-ngoai,50771842,"Cặp Tạ Tay Cao Cấp Brosman",139000,139000,0,0
TIKI,the-thao-da-ngoai,67140999,"Con lăn massage cao cấp xốp đúc REXCHI Tập yoga, Xoa bóp, Phục hồi cơ bắp- Con lăn bọt xốp  tròn tập thể thao",179000,179000,0,0
TIKI,the-thao-da-ngoai,48067779," THÙNG BÓNG TENNIS WILSON (Thùng 18 lon Hộp 4 trái)",3699000,4090000,391000,10
TIKI,the-thao-da-ngoai,59350433,"Đèn sạc đội đầu chính hãng Roman siêu tiện dụng ELE2005",99000,99000,0,0
TIKI,the-thao-da-ngoai,209906218,"Băng Nẹp Gối H5 Có Nẹp Nhôm Hỗ Trợ Sau Mổ Dây Chằng Chéo Knee Pad Chính Hãng Aolikes (1 Chiếc)",205000,205000,0,0
TIKI,the-thao-da-ngoai,55052620,"Nón Bơi Vải PU Cleacco Cao Cấp, mềm mại, kiểu dáng năng động ,dành cho vận động viên chuyên nghiệp hoặc người có sở thích đi bơi mỗi ngày, màu sắc đa dạng - Hàng Chính Hãng BORO SPORT",109000,174000,65000,37
TIKI,the-thao-da-ngoai,186638779,"Túi Đeo Bụng Chạy Bộ Chống Nước Teement TM01, Đai Đeo Điện Thoại Chạy Bộ, Túi Đeo Hông Chạy Bộ Phản Quang -hàng Chính Hãng",75000,75000,0,0
TIKI,the-thao-da-ngoai,4693829,"Bộ 2 Tạ tay cao cấp Thái Lan 2Kg BG",218000,499000,281000,56
TIKI,the-thao-da-ngoai,170758139,"Tấm Trải Lều Cách Nhiệt Naturehike NH20FCD03",200000,200000,0,0
TIKI,the-thao-da-ngoai,3448501,"Bóng Rổ Zocker Số 6 - Cam (Size 6)",124000,225000,101000,45
TIKI,the-thao-da-ngoai,85095747,"Giày Bata Học Sinh Học Thể Dục Chạy Bộ Cao Cấp",249000,249000,0,0
TIKI,the-thao-da-ngoai,52250162,"Áo tập Yoga Gym Croptop cho nữ Hibi Sports Mã CR805 có mút nâng ngực bên trong",306000,340000,34000,10
TIKI,the-thao-da-ngoai,41333562,"GEL LÀM NÓNG STARBALM WARM GEL",170000,220000,50000,23
TIKI,the-thao-da-ngoai,708419,"Bao Tay Tập Yoga Chống Trượt Sportslink",40000,113000,73000,65
TIKI,the-thao-da-ngoai,189590439,"Combo 3 Đôi Tất Xỏ Ngón  Chạy Bộ Marathon Đạp Xe Leo Núi Aonijie E4801",480000,480000,0,0
TIKI,the-thao-da-ngoai,114011137,"Dây Kháng Lực Tập Mông MiniBand Chính Hãng Aolikes chất liệu Vải Polyeste Cotton",64000,64000,0,0
TIKI,the-thao-da-ngoai,195219114,"Quả cầu lông Hải Yến Bạc giá rẻ",130000,150000,20000,13
TIKI,the-thao-da-ngoai,89475796,"Xà đơn treo tường, gắn cửa 2021 điều chỉnh 72cm-110cm và 93cm-140cm nặng 2kg, 2.8kg -Mẫu TG02",175000,350000,175000,50
TIKI,the-thao-da-ngoai,17455523,"Đai Nẹp Nắn Ngón Chân Cái Correcting Belt Of Thumb AOLIKES YE-1051",119000,124000,5000,4
TIKI,the-thao-da-ngoai,1416813,"Giày Thượng Đình KK14-1 White",100000,105000,5000,5
TIKI,the-thao-da-ngoai,193334808,"Giày Bóng Đá Nam Biti's Hunter Football DSMH09600XDG (Xanh Dương)",716000,716000,0,0
TIKI,the-thao-da-ngoai,191219591,"Băng đeo trán chắn mồ hôi Cleacco BORO SPORT",20000,69000,49000,71
TIKI,the-thao-da-ngoai,95200430,"Kìm bóp tập cơ tay, kìm bóp tay GoodFit tùy chỉnh 5-60kg tập gym, tập lực tại nhà GF01E",71000,71000,0,0
TIKI,the-thao-da-ngoai,199049910,"Giày cầu lông Lining Soundwave II chính hãng AYTS016-2 màu trắng phối xanh mẫu mới dành cho nam",1400000,1400000,0,0
TIKI,the-thao-da-ngoai,68247320,"Bộ Tạ Tập Tay Đa Năng Điều Chỉnh 2 in 1 Kết Hợp Tạ Đẩy (40kg)",698000,1000000,302000,30
TIKI,the-thao-da-ngoai,33465886,"Găng Tay Tập GYM 4 Ngón Nửa Bàn Aolikes (1 Đôi) - L",125000,125000,0,0
TIKI,the-thao-da-ngoai,148749357,"Quần ngắn thể thao nam New Balance Impact Run 5 Inch - AMS01241 (form châu Á)",747000,995000,248000,25
TIKI,the-thao-da-ngoai,6425767,"Giày đá banh Prowin S50",169500,169500,0,0
TIKI,the-thao-da-ngoai,193334497,"Giày Bóng Đá Nam Biti's Hunter Football DSMH09600DOO (Đỏ)",573000,716000,143000,20
TIKI,the-thao-da-ngoai,6537327,"Sữa Whey Protein Hammer Nutrition 24 serving - Whey Isolate duy trì và phục hồi cơ nhanh chóng",1050000,1050000,0,0
TIKI,the-thao-da-ngoai,2467931,"Xe đạp tập thể dục trong nhà BG 8702 Plus (hàng nhập khẩu)",1798000,2699000,901000,33
TIKI,the-thao-da-ngoai,71887422,"Ván Trượt Đạt Chuẩn Thi Đấu Mặt Nhám Bánh Cao Su 80cm Chính Hãng Đại Nam Sport",191000,500000,309000,62
TIKI,the-thao-da-ngoai,148472871,"Nón bơi unisex Speedo Bubble - 8-709290001",295000,295000,0,0
TIKI,the-thao-da-ngoai,21025732,"Găng Tay Boxing Người Lớn miDoctor – Găng Tay Đấm Bốc Người Lớn Chính Hãng",163000,163000,0,0
TIKI,the-thao-da-ngoai,95280496,"CUỐN CỐT VỢT TENNIS VÀ CẦU LÔNG BABOLAT (giao màu ngẫu nhiên)",124000,124000,0,0
TIKI,the-thao-da-ngoai,147995504,"[Còn hàng] Máy chạy bộ đa năng tại nhà Toshiko MC33 PRO, chức năng nâng dốc tự động theo nhu cầu, kèm theo đai massage và thanh gập bụng, đồng hồ hiển thị thông số nhịp tim, calo tiêu thụ",9490000,14500000,5010000,35
TIKI,the-thao-da-ngoai,36385928,"Quần Thể Thao Nữ Tập Gym Yoga Lưng Cao Cao Cấp Amalife",95000,199000,104000,52
TIKI,the-thao-da-ngoai,176252287,"Giày Thể Thao Nam Biti's Hunter X Cut-Out DSMH08900DEN",855000,1069000,214000,20
TIKI,the-thao-da-ngoai,159496935,"Phao bơi trẻ em Zoggs - 301211 (3-6 tuổi)",195000,255000,60000,24
TIKI,the-thao-da-ngoai,161459742,"Bộ 2 tạ tay nhựa bát giác 2kg REEFIT (2 tạ 2kg, tổng 4kg)",28000,28000,0,0
TIKI,the-thao-da-ngoai,66740772,"giày đá bóng 3 sọc wika",119000,119000,0,0
TIKI,the-thao-da-ngoai,182580785,"Bộ Kính Bơi Tráng Bạc Chống Tia UV Có Bịt Tai Gắn Liền - Chọn Màu – Kính Bơi Cao Cấp Chống Nước Tặng Kèm Bịt Mũi, Kèm Bịt Tai Rời Chính Hãng Amalife",88000,88000,0,0
TIKI,the-thao-da-ngoai,192987140,"Thanh Tập Chống Gù Lưng, Gậy Tập Yoga Chống Gù Lưng Bằng Thép Không Gỉ - Hàng Loại 1 - Chính Hãng MINIIN",77280,110400,33120,30
TIKI,the-thao-da-ngoai,159728873,"Kính bơi trẻ em Zoggs Predator Junior - 311869",248000,495000,247000,50
TIKI,the-thao-da-ngoai,38413079,"Thảm Tập Yoga, Gym Amalife 2 Lớp + Túi Đựng Thảm Tập Yoga Dây Buộc Thảm Tập Yoga (Giao Màu Ngẫu Nhiên)",107000,107000,0,0
TIKI,the-thao-da-ngoai,68793197,"Bộ 5 Dây Ngũ Sắc Tập Thể Lực - Dụng Cụ Tập Gym(Móc Tròn)",75000,150000,75000,50
TIKI,the-thao-da-ngoai,164414622,"Băng Cánh Tay Thể Thao VNSPORT - VNS006 (1 Chiếc)",70000,90000,20000,22
TIKI,the-thao-da-ngoai,24701879,"Bộ Bóng Chày Mini Chính Hãng miDoctor - Giao Gậy Màu Ngẫu Nhiên",339000,339000,0,0
TIKI,the-thao-da-ngoai,272445160,"Mass Gainer Sữa tăng cân Rule 1 Mass Gainer 5.2kg tặng Rule 1 Shaker",1350000,1350000,0,0
TIKI,the-thao-da-ngoai,147798655,"Bộ Vỏ Bao Đấm Bốc Treo Tường 3 Lớp Cao Cấp – Chọn Size - Mua 1 Tặng 7 Phụ Kiện Tập Luyện Siêu Bền Tập Boxing, Tập MMA – Dây Quấn Dài – Chính Hãng Dododios",307000,307000,0,0
TIKI,the-thao-da-ngoai,146557207,"Vòng Lắc Eo, Vòng Lắc Eo Massage Giảm Mỡ Bụng, Giảm Béo Cao Cấp Hàng Chính Hãng dododios",163000,163000,0,0
TIKI,the-thao-da-ngoai,66640258,"Dụng Cụ Hít Đất Cầm Tay Cao Cấp Chính Hãng miDoctor – mi01 - Dụng Cụ Chống Đẩy Inox (Đường Kính Khung 22MM - Tải Trọng 100Kg)",88000,88000,0,0
TIKI,the-thao-da-ngoai,27849510,"Găng tay thủ môn có xương trợ lực WW (Giao màu ngẫu nhiên)",171000,400000,229000,57
TIKI,the-thao-da-ngoai,135434089,"[Loại Tốt – Lõi Thép] Dây nhảy thể dục có thể điều chỉnh dây, Dây nhảy lõi thép, không bị rối dùng để tập thể dục độ dài 2.9m, hỗ trợ giảm cân – Chính hãng Amalife",29000,29000,0,0
TIKI,the-thao-da-ngoai,102123704,"Đai cuốn bảo vệ đùi, khớp háng GoodFit GF502T",162000,250000,88000,35
TIKI,the-thao-da-ngoai,195776315,"Thực phẩm bổ sung Rule 1 BCAA 60 servings",650000,650000,0,0
TIKI,the-thao-da-ngoai,28000952,"Bộ 2 Băng Đai Quấn Cổ Chân Bảo Vệ Mắt Cá Chân, Khớp Cổ Chân Sport Ankle Protector AOLIKES YE-1527 - Hàng Chính Hãng",306000,499000,193000,39
TIKI,the-thao-da-ngoai,49874503,"Bộ 2 băng quấn mắt cá chân bảo vệ khớp cổ chân thể thao Sport Ankle Support AOLIKES YE-1520",114000,219000,105000,48
TIKI,the-thao-da-ngoai,189575665,"Nẹp ngón chân cái, nẹp bàn chân hỗ trợ định hình ngón chân GoodFit GF617A",64000,129000,65000,50
TIKI,the-thao-da-ngoai,190582205,"Bó gối quấn bảo vệ đầu gối GoodFit GF522K băng đầu gối thoáng khí để chơi thể thao, vận động",125000,199000,74000,37
TIKI,the-thao-da-ngoai,174825145,"Tạ Tập Tay 10kg - Bộ Tạ Tay Đa Năng Điều Chỉnh Cân Nặng - Bộ Tạ Tập Gym Tại Nhà - Kết Hợp Tạ Tay, Tạ Đẩy, Tạ Đòn - Phân loại (10kg) - Hàng Chính Hãng",399000,798000,399000,50
TIKI,the-thao-da-ngoai,119025361,"Chai, Hộp Chiết Dầu Gội Sữa Tắm Nước Rửa Tay Jodily Cao Cấp",45000,45000,0,0
TIKI,the-thao-da-ngoai,146628884,"Con lăn tập cơ bụng - Con lăn tập bụng 4 bánh tặng kèm thảm tập (Giao màu ngẫu nhiên) - Chính hãng dododios",118000,118000,0,0
TIKI,the-thao-da-ngoai,2156903,"Găng tay chống nắng xỏ ngón Aqua-X Let's Slim",33000,38000,5000,13
TIKI,the-thao-da-ngoai,103209753,"Dây nhảy thể dục sợi đan đếm số tự động Agnite - Chất lượng chuyên nghiệp siêu bền - Màu Hồng/ Xanh dương/ Xanh lá - F4111",49000,113400,64400,57
TIKI,the-thao-da-ngoai,160147228,"Quả cầu lông Hải Âu giá rẻ",94000,120000,26000,22
TIKI,the-thao-da-ngoai,273634436,"BG - Máy Chạy Bộ Trên Không Cỡ Lớn,Xe đạp thể thao, xe đạp gấp gọn người lớn tùy chỉnh độ nặng, tập thể dục tại nhà Chịu Lực Tốt Siêu Bền",1199000,2280000,1081000,47
TIKI,the-thao-da-ngoai,159501726,"Kẹp mũi bơi unisex Zoggs - 301653",155000,155000,0,0
TIKI,the-thao-da-ngoai,146728623,"Gối Gạch Tập Yoga Chọn Màu Chất Liệu EVA Mật Độ Cao Nặng 185 Gram Chính Hãng Dododios – Gối Tập Yoga Tập Gym Tập Thể Thao Cao Cấp",63000,63000,0,0
TIKI,the-thao-da-ngoai,33324575,"Găng Tay Tập GYM, Tập Thể Hình Gloves Aolikes (1 Đôi)",150000,150000,0,0
TIKI,the-thao-da-ngoai,114689747,"Túi đựng thảm yoga - Hàng chính hãng, giao màu ngẫu nhiên",16000,20000,4000,20
TIKI,the-thao-da-ngoai,72894899,"[Chính hãng] Nutrex Outlift Pre-Workout 20 Liều, Tăng Sức Mạnh Sức Bền, Năng Lượng Trước Tập, Citrulline, BCAA, Creatine, Beta-Alanine, Taurine",750000,750000,0,0
TIKI,the-thao-da-ngoai,57696898,"Tất bảo vệ ống đồng, bắp chân GoodFit GF601C",89000,150000,61000,41
TIKI,the-thao-da-ngoai,79199850,"1 Hộp Bóng Tennis  Championship (hộp  4 bóng)",199000,229000,30000,13
TIKI,the-thao-da-ngoai,38303053,"Giày vải đinh Thượng đình đá bóng màu đen BD16",111000,239000,128000,54
TIKI,the-thao-da-ngoai,114011155,"Dây cao su kháng lực tập mông miniband hỗ trợ tập mông - Độ mông trái đào",9000,9000,0,0
TIKI,the-thao-da-ngoai,16237279,"Vành Bóng Rổ + Lưới Size 30,35.40(Màu Cam)",141000,149000,8000,5
TIKI,the-thao-da-ngoai,3942105,"Gel làm lạnh Starbalm - Hà Lan 100ml",190000,190000,0,0
TIKI,the-thao-da-ngoai,155367696,"Quần thể thao nữ form lửng tập Yoga, Gym IBX IBX057P",199000,399000,200000,50
TIKI,the-thao-da-ngoai,159725236,"Kính bơi trẻ em Zoggs Phantom Elite Mirror Junior - 311591",223000,495000,272000,55
TIKI,the-thao-da-ngoai,164552238,"Khung Nắn Chỉnh Cột Sống, Khung Định Hình Cột Sống, Giảm Thoát Vị Đĩa Đệm, Đau Lưng, Vai Gáy, Dụng Cụ Hỗ Trợ Tập Lưng - Chính Hãng PaKaSa",99000,180000,81000,45
TIKI,the-thao-da-ngoai,15363751,"Áo Phao Cứu Hộ Thắng Lợi A86",60000,80000,20000,25
TIKI,the-thao-da-ngoai,189467850,"Giày đá bóng trẻ em PROWIN H21 KID Vàng chính hãng, giày đá banh cỏ nhân tạo đẹp - HK005",305000,305000,0,0
TIKI,the-thao-da-ngoai,61479584,"Máy câu cá AR - Kim loại - Siêu bền - Chất lượng cao cấp - Tặng kèm cước  MC09",269000,269000,0,0
TIKI,the-thao-da-ngoai,129035292,"Dây nhảy lõi thép Cao Cấp luyện tập thể lực  tự động đếm số - đếm giờ - tích hợp đo calo - quãng đường - Hàng Chính Hãng",125000,125000,0,0
TIKI,the-thao-da-ngoai,28735724,"Dụng cụ hỗ trợ tập lưng giúp giảm đau lưng FLO001",150000,285000,135000,47
TIKI,the-thao-da-ngoai,33338356,"Găng Tay Tập GYM Hở Mu Bàn Tay Lifting Grips Aolikes Pro AL7639",109000,109000,0,0
TIKI,the-thao-da-ngoai,77674140,"Băng quấn bảo vệ cổ tay AOLIKES YE-7930 Sport wrist protector",124000,209000,85000,41
TIKI,the-thao-da-ngoai,193137977,"Đai Cuốn Bảo Vệ Khuỷu Tay - Đai Dán Khuỷ Tay hỗ trợ tập gym - Màu đen - Hiệu SUNUGY",39000,39000,0,0
TIKI,the-thao-da-ngoai,192563145,"Băng quấn cổ tay KUNOSPORT bảo vệ trật khớp tay thể thao, băng quấn cổ tay xỏ ngón - KN16",105000,105000,0,0
TIKI,the-thao-da-ngoai,5199493,"Túi đeo hông thể thao GTXSports Sportslink",50000,66000,16000,24
TIKI,the-thao-da-ngoai,92083709,"BG Máy chạy bộ điện đơn năng Model M2 TREADMILL (hàng nhập khẩu)",3379000,5692000,2313000,41
TIKI,the-thao-da-ngoai,12282424,"Nón bơi mũ bơi Silicon che tai CQ (Dòng cao cấp)",47000,120000,73000,61
TIKI,the-thao-da-ngoai,141679006,"Quả cầu lông chính hãng thi đấu chuyên nghiệp giá rẻ trái cầu lông Hải Yến S70 ( 1 ống)",320000,350000,30000,9
TIKI,the-thao-da-ngoai,146685155,"DỤNG CỤ TẬP CƠ BỤNG TẠI NHÀ Có Đế Hút Chân Không Đa Năng Gập Bụng Giảm Mỡ, Dáng Chuẩn Eo Thon - Chính hãng dododios",96000,96000,0,0
TIKI,the-thao-da-ngoai,38436746,"Thảm Tập Yoga Định Tuyến Da PU Cao Cấp Amalife + Túi Đựng Thảm Tập Yoga Định Tuyến + Dây Buộc Thảm Tập Yoga Định Tuyến",359000,359000,0,0
TIKI,the-thao-da-ngoai,183728995,"Túi Đựng Đồ Bơi Tiện Lợi Size 42x32CM Kiểu Thời Trang Chống Thấm Nước TB002 MayHomes Màu Ngẫu Nhiên",45000,45000,0,0
TIKI,the-thao-da-ngoai,184415359,"Set đồ tập yoga gym Hibi Sports H142 quần lửng lưng cao, áo bra dây đan kèm mút ngực",442000,590000,148000,25
TIKI,the-thao-da-ngoai,273942102,"Thực phẩm tăng cơ Rule 1 Protein Isolate/Hydrolysate 9.8lb tặng bình lắc R1 Shaker",2970000,2970000,0,0
TIKI,the-thao-da-ngoai,26283817,"BÓNG TẬP GOLF - PGM Q008 (BEST SELLER) - MÀU VÀNG - 1 HỘP 10 QUẢ",126000,150000,24000,16
TIKI,the-thao-da-ngoai,10785162,"Lều 2 Người Phượt Cắm Trại Du Lịch Galaxy Store Tetragon 2PLE01 Hàng Xuất Khẩu Châu Âu (Màu Ngẫu Nhiên)",569000,920000,351000,38
TIKI,the-thao-da-ngoai,176166906,"Dây Nhảy FED XM0105 - Dây Nhảy Tăng Thể Lực Giúp Thân Hình Cân Đối Săn Chắc Và Đẹp - Hàng Chính Hãng",390000,450000,60000,13
TIKI,the-thao-da-ngoai,89477087,"Xà Đơn – Xà kép Đa Năng EX30 Bản Cao Cấp Tiêu Chuẩn Phòng Gym(Tặng Kìm Bóp Cơ Tay 5-60kg)",2790000,2790000,0,0
TIKI,the-thao-da-ngoai,8157257,"Combo Bộ ván trượt mặt nhám cao cấp + Bộ bảo hộ an toàn (Giao màu ngẫu nhiên)",312000,600000,288000,48
TIKI,the-thao-da-ngoai,75950830,"Bộ tạ miếng nhựa đen PVC 10KG đa năng thiết kế mới nhất Cao Cấp ",299000,299000,0,0
TIKI,the-thao-da-ngoai,76696769,"Thảm Fitness Yoga Adidas 10mm ADMT-11015",999000,1208000,209000,17
TIKI,the-thao-da-ngoai,104669374,"GIÀY ĐÁ BÓNG SÂN CỎ NHÂN TẠO PEACE PS1217",189000,300000,111000,37
TIKI,the-thao-da-ngoai,68976174,"Kìm Bóp Cơ Tay Điều Chỉnh Lực 5-60kg Cỡ To Đẹp Chắc Chắn",29000,29000,0,0
TIKI,the-thao-da-ngoai,75722804,"Túi Đấm Bốc Boxing Cho Trẻ Em Hình Người Nhện Đỏ Size Trung 37*18*18 cm, Kèm 2 Găng Tay Cho Bé, Bộ dụng cụ tập Boxing kèm 2 găng tay cho bé- Bộ đấm bốc trẻ em kèm găng tay",132000,139000,7000,5
TIKI,the-thao-da-ngoai,108480875,"Mã hàng KT1.HT – Xà đơn xếp Khánh Trình hai tầng dành cho cả trẻ em và người lớn",1820000,1820000,0,0
TIKI,the-thao-da-ngoai,54089240,"Quần legging nữ CLEACCO  tập gym, quần yoga chất vải Dệt thoáng mát , co giãn 4 chiều",119000,201000,82000,41
TIKI,the-thao-da-ngoai,254091226,"BỘ ĐÔI TẠ 30KG BG Tạ Tập Tay Đa Năng Điều Chỉnh 2 in 1 Kết Hợp Tạ Đẩy ( hàng nhập khẩu)",661000,999000,338000,34
TIKI,the-thao-da-ngoai,185966772,"Bộ Tăng Dã Ngoại Cắm Trại Lục Giác Naturehike NH16T012-S",1490000,1490000,0,0
TIKI,the-thao-da-ngoai,93289804,"Bộ Tạ Tay 3kg Bọc Cao Su Trơn Lõi Thép Cao Cấp Chính Hãng Đại Nam Sport (Tổng 6kg)-Giao Màu Ngẫu Nhiên",327000,550000,223000,41
TIKI,the-thao-da-ngoai,92533531,"Mũ Bơi Người Lớn,Nón Bơi Cho Nữ Tóc Dài Chất Liệu 100% Silicon Co giãn,Chống Nước,Thoải Mái Đại Nam Sport",61000,150000,89000,59
TIKI,the-thao-da-ngoai,20847679,"Bật lửa ZIPPO 207 –Bật lửa ZIPPO STREET CHROME",535000,535000,0,0
TIKI,the-thao-da-ngoai,62721597,"Kính bơi Cleacco Polycarbonate cao cấp chống sương mù , tia cực tím tặng kèm bịt tai và đệm mũi",252000,404000,152000,38
TIKI,the-thao-da-ngoai,89476448,"Bộ Tạ Loại 1kg bọc cao su (Tổng 2kg)",139000,278000,139000,50
TIKI,the-thao-da-ngoai,162042284,"Giàn Tạ Đa Năng Zasami Có xà đơn xà kép gồm 1 đòn tạ 1m5 - Lựa chọn mức tạ đĩa nhựa ngẫu nhiên",6649000,6890000,241000,3
TIKI,the-thao-da-ngoai,133772727,"Túi Ngủ Văn Phòng Du Lịch, Phượt Cá Nhân, Túi Ngủ Mùa Đông - 3 Lớp Cao Cấp - Gói Gọn Tiện Ích- Hàng Chính Hãng MINIIN",199000,199000,0,0
TIKI,the-thao-da-ngoai,173277026,"Giày Thể Thao Nam Biti's Hunter Core 3D-Airmesh Grey DSMH08700XAL (Xám)",590000,736000,146000,20
TIKI,the-thao-da-ngoai,271392535,"Viên Sủi GU ENERGY Hydration Drink Tabs - Ống 12 Viên - Bổ Sung Nước Và Điện Giải Khi Hoạt Động Thể Thao - Ống 12 viên",199000,199000,0,0
TIKI,the-thao-da-ngoai,10689279,"Thảm tập yoga định tuyến PU Liforme 4.2mm",3950000,4617000,667000,14
TIKI,the-thao-da-ngoai,158615618,"Bàn Xếp Gấp Gọn Du Lịch Và Dã Ngoại Dễ Mang Theo Khi Đi Cắm Trại Picnic Ăn Uống Cùng Gia Đình - Hàng Chính Hãng",512000,626000,114000,18
TIKI,the-thao-da-ngoai,57010114,"Lều 2 Lớp 4 - 5 Người Dã Ngoại Phượt Cắm Trại Galaxy Store GSL07 Chống Nước Tốt - Màu Ngẫu Nhiên",1071000,1950000,879000,45
TIKI,the-thao-da-ngoai,67539013,"Đai bảo vệ, cố định khớp vai có điều chỉnh GoodFit GF702S  - Phải",137000,199000,62000,31
TIKI,the-thao-da-ngoai,111859855,"Bộ 5 Dây Ngũ Sắc Đàn Hồi Tập Gym, Tập Thể Hình Đa Năng Tại Nhà Amalife ",88000,88000,0,0
TIKI,the-thao-da-ngoai,83783760,"Dụng cụ cầm tay đa năng Leatherman Free T4 (12 tools)",1950000,1950000,0,0
TIKI,the-thao-da-ngoai,173882833,"Bột Soy Protein Isolate Myprotein - Sữa bổ sung đạm từ đậu nành (túi 1kg) - Nutrition Depot Vietnam",820000,820000,0,0
TIKI,the-thao-da-ngoai,87094552,"Vợt Tennis Babolat PURE STRIKE LiTE 265gram 3rd Gen (101408)",4299000,4490000,191000,4
TIKI,the-thao-da-ngoai,794052,"Cặp Vợt Cầu Lông AAA VA18",157000,157000,0,0
TIKI,the-thao-da-ngoai,146763912,"Gối Ngủ Du Lịch Chất Liệu Memory Foam Mật Độ Cao - Gối Ngủ Văn Phòng Thông Minh Cao Cấp Chính Hãng Dododios – Kèm Túi Vải Nhung Đựng Gối Ngủ Chữ U Văn Phòng",396000,396000,0,0
TIKI,the-thao-da-ngoai,8493528,"Xà đơn gắn cửa cải tiến có chốt chống xoay (83cm-130cm) - Đen Xanh Dương",334000,344000,10000,3
TIKI,the-thao-da-ngoai,191073426,"Kính bơi người lớn nam nữ + Mũ Bơi - hãng chính hãng dododios - Mã 2030",185000,185000,0,0
TIKI,the-thao-da-ngoai,152074922,"Ghế Vớt Tạ đa năng Zasami ",560000,850000,290000,34
TIKI,the-thao-da-ngoai,159906214,"Áo bơi nữ Zoggs Quay - 462347",430000,859000,429000,50
TIKI,the-thao-da-ngoai,33257269,"Thảm Yoga Fitness Adidas 7mm",813000,839000,26000,3
TIKI,the-thao-da-ngoai,33454921,"Đai Lưng Mềm Tập GYM Valeo Bản To 15cm EVA-2",165000,165000,0,0
TIKI,the-thao-da-ngoai,58450152,"Dây kéo lưng tập gym Lifting Straps GoodFit GF731LS",110000,149000,39000,26
TIKI,the-thao-da-ngoai,148823403,"Bộ Đôi Găng Bao Tay Đấm Bốc Trẻ Em 5-13 Tuổi Cao Cấp – Găng Tay Tập Boxing MMA Trẻ Em Chính Hãng Dododios",129000,129000,0,0
TIKI,the-thao-da-ngoai,146370515,"Dụng Cụ Hít Đất Chống Đẩy Đa Năng 14 Bài Tập – Dụng Cụ Chống Đẩy 18 Lỗ - Chính Hãng dododios",170000,170000,0,0
TIKI,the-thao-da-ngoai,90527569,"Bộ 10 Nấm Chiến Thuật Bóng Đá,Cone Tập Luyện Thể Thao Chiều Cao 16cm DNS002 Chính Hãng Đại Nam Sport (Giao Màu Ngẫu Nhiên)",70000,99000,29000,29
TIKI,the-thao-da-ngoai,60229542,"Dây Câu Cá Leader Daiwa D-Fron 100% Fluoro Carbon Cuộn 100m Made In Japan",278000,278000,0,0
TIKI,the-thao-da-ngoai,274989790,"GẬY TẬP THỂ LỰC SWING - PGM SOFT SWING BAR - HGB011",345000,350000,5000,1
TIKI,the-thao-da-ngoai,195624120,"Dây nhảy thể dục lõi thép AOLIKES A-3201 Sport Jump Rope",91000,159000,68000,43
TIKI,the-thao-da-ngoai,76359754,"Găng Tay Thể Thao Glofit GFST012 Siêu Nhẹ, Siêu Thoáng (WORKOUT GLOVES)",350000,450000,100000,22
TIKI,the-thao-da-ngoai,36153673,"Giày đá banh, giày sân cỏ nhân tạo Mitre 181045 mẫu mới chính hãng giảm chấn hiệu quả, tăng ma sát với bóng",800000,800000,0,0
TIKI,the-thao-da-ngoai,159725676,"Dụng Cụ Hít Đất Hỗ Trợ Chống Đẩy Đa Năng 16 trong 1 - Bảng Chống Đẩy SP010 Chính Hãng miDoctor",150000,210000,60000,29
TIKI,the-thao-da-ngoai,88822152,"Lều 2 Lớp 4 - 5 Người Dã Ngoại Phượt Cắm Trại Galaxy Store GSL07 Chống Nước Tốt Kèm Quà Tặng - Hàng Chính Hãng (Màu Ngẫu Nhiên)",2000000,2000000,0,0
TIKI,the-thao-da-ngoai,74814137,"Cần câu tay Carbon Daiwa Dao chính hãng 39 (3m9), Dao 45 (4m5), Dao 54 (5m4), Dao 63 (6m3)",1981000,1981000,0,0
TIKI,the-thao-da-ngoai,20847671,"Bật lửa Zippo 352B –Bật lửa Zippo Venetian Brass",1050000,1050000,0,0
TIKI,the-thao-da-ngoai,191648646,"Dây giày thông minh phản quang 3 vạch LiveFit Lock Laces không cần buột I vừa với mọi loại giày I Chất liệu dây Nylon bền chắc với thời gian",99000,99000,0,0
TIKI,the-thao-da-ngoai,170758060,"Tăng Bạt Trải Dã Ngoại Naturehike NH15D004-X Thảm Dã Ngoại Đa Năng",195000,195000,0,0
TIKI,the-thao-da-ngoai,189589375,"Chăn Giữ Nhiệt Chăn Cứu Hộ Khẩn Cấp Aonijie A107",140000,140000,0,0
TIKI,the-thao-da-ngoai,6495813,"Bật Lửa Zippo 1935 Replica Brushed Chrome 1935.25",955000,955000,0,0
TIKI,the-thao-da-ngoai,86325863,"Vợt cầu lông ProKennex POWER PRO 707 chuyên tấn công chính hãng carbon chất lượng (1 cây) - ĐÃ CĂNG LƯỚI",1044000,1928000,884000,46
TIKI,the-thao-da-ngoai,161451921,"Bộ 2 vỏ tạ tay nhựa bát giác 5kg REEFIT (2 vỏ 5kg, tổng 10kg)",59000,59000,0,0
TIKI,the-thao-da-ngoai,74598632,"Dây tập Ngực, tập tay ToanAnh Model TA-8345",180000,180000,0,0
TIKI,the-thao-da-ngoai,114255361,"Dụng cụ tập hít đất Harbinger Push Up Pro_Black",1099000,1099000,0,0
TIKI,the-thao-da-ngoai,1694657,"Áo Hỗ Trợ Đốt Mỡ Giảm Cân Cho Nam Giới Sportslink SK Fitness (Size",89000,142000,53000,37
TIKI,the-thao-da-ngoai,14370033,"Bộ dây tập thể lực TRX P1 SUSPENSION THIENTRUONG",699000,699000,0,0
TIKI,the-thao-da-ngoai,178958676,"Đai bảo vệ khớp gối cao cấp WOSAWE bảo vệ đầu gối chống ngã khi chơi các môn thể thao mạo hiểm",175000,175000,0,0
TIKI,the-thao-da-ngoai,198328380,"đai chống gù lưng cho trẻ em Cân Nặng Từ 15kg Đến 40Kg mi04 - chính hãng DoDoDios",180000,180000,0,0
TIKI,the-thao-da-ngoai,172538266,"Bao Tay Tập Gym Có Đệm Tay Và Quấn Cổ Tay Chắc Chắn",145000,145000,0,0
TIKI,the-thao-da-ngoai,11488622,"Đai bảo vệ đầu gối ZAMST JK-1",1012000,1012000,0,0
TIKI,the-thao-da-ngoai,59142178,"Bộ nồi cắm trại 2-3 người Naturehike NH15T203-G",525000,525000,0,0
TIKI,the-thao-da-ngoai,40798649,"BÓNG TẬP YOGA GAI MÀU XANH DƯƠNG VNS017 (Tặng kèm bơm bóng và khóa van)",280000,380000,100000,26
TIKI,the-thao-da-ngoai,26287806,"Dây nhảy thể dục Sportslink 2.7m (Màu ngẫu nhiên)",50000,50000,0,0
TIKI,the-thao-da-ngoai,186392834,"Máy chạy bộ gấp gọn KingSmith R2 - Động cơ không chổi than vận hàng yên tĩnh - Hàng Chính Hãng",11890000,15500000,3610000,23
TIKI,the-thao-da-ngoai,90321741,"Băng đô Kpop, Bigbang, băng đô thể thao chặn mồ hôi siêu co giãn TB37",11570,11570,0,0
TIKI,the-thao-da-ngoai,6565249,"Giày đá bóng Prowin RX + tặng kèm tất bóng đá cao cổ",239000,249000,10000,4
TIKI,the-thao-da-ngoai,4956127,"Bóng đá Động Lực số 5 in sao UHV 2.03 (Tiêu chuẩn thi đấu)",550000,550000,0,0
TIKI,the-thao-da-ngoai,16257273,"Bật lửa Zippo  Clover High Polish Chrome Design 24699",1025000,1025000,0,0
TIKI,the-thao-da-ngoai,68484619,"Giày Bata Thể Thao Nam Nữ Cao Cấp",250000,250000,0,0
TIKI,the-thao-da-ngoai,70161865,"Bộ 6 dây kháng lực tập Gym ,dây đàn hồi Miniband đa năng tập Mông Đùi Chân, độ kháng lực cao Mã 02-RED",90000,180000,90000,50
TIKI,the-thao-da-ngoai,196597277,"Băng dán cơ thể thao Kinesiology Tape AOLIKES A-MT002",139000,199000,60000,30
TIKI,the-thao-da-ngoai,1632469,"Bóng Rổ 3×3 Molten B33T5000",969000,969000,0,0
TIKI,the-thao-da-ngoai,163876959,"Bó gối phòng ngừa 75580-DAY Actimove Mild Knee Support",387000,450000,63000,14
TIKI,the-thao-da-ngoai,114011066,"Dây đàn hồi kháng lực tập mông - Dây miniband chuyên tập mông - Độ mông trái đào (Combo)",48000,48000,0,0
TIKI,the-thao-da-ngoai,174610643,"Vòng Tập Kháng Lực  Yoga,Pilate Đường Kính 38cm Cao Cấp Đại Nam Sport",81000,200000,119000,60
TIKI,the-thao-da-ngoai,35346876,"Áo thể thao, đồ tập GYM nam ngắn tay 02",149000,149000,0,0
TIKI,the-thao-da-ngoai,174849218,"Đĩa Xoay Eo Tập Cơ Bụng, Dụng Cụ Tập Bụng Giảm Mỡ, Cải Thiện Tuần Hoàn Máu Amalife",33000,33000,0,0
TIKI,the-thao-da-ngoai,111177032,"VÒNG TẬP YOGA CAO CẤP SUNNY - BẢNG 20cm",416000,429000,13000,3
TIKI,the-thao-da-ngoai,183375288,"Túi đựng bình nước giữ nhiệt có dây đeo tiện ích - HENRYSA",29000,58000,29000,50
TIKI,the-thao-da-ngoai,197829587,"Posture Corrector for Women and Men - Invisible & Adjustable Upper Back Brace for Clavicle Support - Effective Straightener and Providing Pain Relief from Neck, Back, Shoulder - Đai chống gù lưng - Hàng chính hãng DoDoDios",85000,85000,0,0
TIKI,the-thao-da-ngoai,35148054,"Bộ Kính Bơi Cận View V510 (Đen) Và Nút Bơi Nhét Tai EP405 - Hàng Chính Hãng",510000,900000,390000,43
TIKI,the-thao-da-ngoai,85025758,"Quả bóng rổ cao su gerustar số 5",105000,105000,0,0
TIKI,the-thao-da-ngoai,12488652,"Bó gối đai dán có nẹp neoprene United Medicare (F12)",890000,1100000,210000,19
TIKI,the-thao-da-ngoai,1694261,"Băng Bảo Vệ Đầu Gối Khi Chơi Thể Thao Sportslink Litian Loại Dài - Màu Lính",59000,99000,40000,40
TIKI,the-thao-da-ngoai,195864929,"PUMA - Áo bra thể thao nữ ULTRAFORM Cropped Running 522150",1199000,1199000,0,0
TIKI,the-thao-da-ngoai,137442306,"Vòng Lắc Eo Giảm Mỡ Bụng Massage Bụng - Có Thể Thao Rời Mang Đi Tiên Lợi- Hàng Chính Hãng MINIIN",182000,185000,3000,2
TIKI,the-thao-da-ngoai,183064756,"Bóng đá Futsal AKpro AF3800",399000,399000,0,0
TIKI,the-thao-da-ngoai,51939035,"Bộ 2 đai bảo vệ đầu gối có lò xo hỗ trợ xương bánh chè Four spring Sport knee protector Aolikes YE-7618",297000,499000,202000,40
TIKI,the-thao-da-ngoai,197823202,"Vợt bóng bàn combo 2 chiếc tặng kèm 3 quả bóng và túi đựng - chính hãng dododios - Thiết kế chuẩn quốc tế",218000,218000,0,0
TIKI,the-thao-da-ngoai,144404437,"Găng Tay Aolikes A-112 | Găng Tay Tập Gym Thể Thao Nam Nữ Cao Cấp Chính Hãng",119000,119000,0,0
TIKI,the-thao-da-ngoai,144193795,"[MUA 1 TẶNG 1] ÁO THỂ THAO NỮ VINA AUTHENTIC CAO CẤP VNT04W CHẤT LƯỢNG, MỀM MẠI, CO GIẢN, CHUẨN FORM, HỢP THỜI TRANG",179000,179000,0,0
TIKI,the-thao-da-ngoai,95958825,"Phụ kiện thể thao Pk5001 băng chun bảo vệ khủy tay 1đôi",157000,157000,0,0
TIKI,the-thao-da-ngoai,141816705," Bình nước xe đạp thể thao 500ml Cách Nhiệt Có Ống Hút",165000,165000,0,0
TIKI,the-thao-da-ngoai,33421889,"Quấn Cổ Chân GYM Hỗ Trợ Tập Mông Chân Với Cáp Kickback Aolikes (1 Đôi)",99000,99000,0,0
TIKI,the-thao-da-ngoai,198334367,"đai chống gù lưng cho trẻ em cao cấp mi03  - Chính hãng DoDoDios",180000,180000,0,0
TIKI,the-thao-da-ngoai,36061857,"Giày đá bóng, giày sân cỏ nhân tạo Mitre 181045 mẫu mới chính hãng size",672000,672000,0,0
TIKI,the-thao-da-ngoai,5939557,"Đai bó cơ khuỷu tay khi chơi Tennis, golf, cầu lông, bóng bàn AOLIKES TC-7949",143000,219000,76000,35
TIKI,the-thao-da-ngoai,90527127,"Đai, túi đeo eo thể thao nam nữ Rhino B201 đựng vừa điện thoại 6.5 Inch và đa dạng các loại vật dụng, hàng chất lượng tiện dụng khi đi chơi, dã ngoại, hoạt động ngoài trời yoga, leo núi, chạy, đi bộ, đạp xe, tập gym, cầu lông",91000,128000,37000,29
TIKI,the-thao-da-ngoai,637014,"Bóng Tập Yoga Có Gai Sportslink (75cm) - Tím",159000,236000,77000,33
TIKI,the-thao-da-ngoai,193223227,"Kính bơi nam nữ tráng gương cao cấp có bịt tai - Kính bơi chống tia UV, chống sương mù thiết kế chống trơn trượt, co giãn - Hàng chính hãng D Danido",94000,150000,56000,37
TIKI,the-thao-da-ngoai,197835104,"Back Brace Posture Corrector for Women and Men - Adjustable Upper Back Brace Straightener for Posture and Clavicle Support - Upper Spine Support, Providing Pain Relief From Neck, Upper Back Corrector and Shoulder (25-50") - dododios đai chống gù lưng",63000,63000,0,0
TIKI,the-thao-da-ngoai,135849549,"Xà đơn treo tường, cửa điều chỉnh linh hoạt thế hệ mới 2022 chất liệu thép chống gỉ chịu lực lên tới 150kg, tay cầm có mút chống trơn trượt - giá rẻ nhất thị trường",365000,365000,0,0
TIKI,the-thao-da-ngoai,2282571,"Bộ 3 Xăng 2 Đá Zippo",380000,380000,0,0
TIKI,the-thao-da-ngoai,195968541,"Ba lô leo núi Sportslink - 68L",550000,690000,140000,20
TIKI,the-thao-da-ngoai,198326340,"đai chống gù lưng cho người lớn Cải Thiện Cột Sống Chống cong Vẹo Lưng - chính hãng DoDoDios - mi03 Màu Đen",196000,196000,0,0
TIKI,the-thao-da-ngoai,58166870,"Quần tập Yoga Gym ngắn dành cho nữ Hibi Sports QS203 - Quần lưng cao có túi",250000,250000,0,0
TIKI,the-thao-da-ngoai,35813362,"Thảm Yoga ADIDAS ADYG-10100",745000,769000,24000,3
TIKI,the-thao-da-ngoai,48596730,"Thảm Tập Yoga miDoctor + Dây Buộc Thảm Tập Yoga (Giao Màu Ngẫu Nhiên)",99000,99000,0,0
TIKI,the-thao-da-ngoai,68586440,"Tạ tập tay đẩy kết hợp,  tạ nam nữ tập gym tập thon tay Giá tốt Hàng Chuẩn(Chọn Lực Nặng Của Tạ 20kg ,30kg, 40kg Tùy chọn)",459000,918000,459000,50
TIKI,the-thao-da-ngoai,217386080,"Quấn bảo vệ cổ tay ️tập Gym - Đai Bảo Vệ Cổ Tay tập Gym cao cấp Aolikes",59000,59000,0,0
TIKI,the-thao-da-ngoai,127961908,"DÂY KHÁNG LỰC TẬP GYM POWERBAND CHÍNH HÃNG PROESCE HỖ TRỢ TẬP GYM, LÊN XÀ",39000,39000,0,0
TIKI,the-thao-da-ngoai,272445746,"Sữa tăng cơ Rule 1 Casein 55 servings - 1.87kg",1280000,1280000,0,0
TIKI,the-thao-da-ngoai,22523870,"Tất đá bóng Zocker Hygroscopic - Màu ngẫu nhiên ",69000,89000,20000,22
TIKI,the-thao-da-ngoai,74687213,"Combo Vòng yoga 33cm +2 gối yoga+1 Dây tập 1,83m Tiện Dụng (Bản Tiêu Chuẩn)",244500,489000,244500,50
TIKI,the-thao-da-ngoai,51437663,"Giày Bata Vải Trẻ Em Thể Thao Bình Minh",89000,89000,0,0
TIKI,the-thao-da-ngoai,272445135,"Sữa tăng cơ Rule 1 Protein Isolate/ Hydrolysate 1.9lb",700000,700000,0,0
TIKI,the-thao-da-ngoai,161913751,"Tạ Tay Nhựa 12kg Bát Giác REEFIT (1 cái)",84000,84000,0,0
TIKI,the-thao-da-ngoai,90527816,"Bộ 10 Nấm Lùn Chiến Thuật Bóng Đá,Cone Tập Luyện Cao 4.5cm Chính Hãng Đại Nam Sport (Giao Màu Ngẫu Nhiên)",56000,120000,64000,53
TIKI,the-thao-da-ngoai,77181605,"Nutrex EAA+ Hydration, Phục Hồi & Xây Dựng Cơ Bắp, Sức Mạnh, Sức Bền, Bổ Sung 8G Amino Axit Thiết Yếu + BCAA  + 1.5G Chất Điện Giải, 30 Lần Dùng",579000,579000,0,0
TIKI,the-thao-da-ngoai,2282579,"Bộ 2 Xăng 2 Đá Zippo",295000,295000,0,0
TIKI,the-thao-da-ngoai,812325,"Túi Đựng Cho Thảm Yoga Từ Sportslink (8mm) - Chấm Bi Đen",45000,60000,15000,25
TIKI,the-thao-da-ngoai,107457325,"CẦU LÔNG NHỰA 3 QUẢ-LIÊN HIỆP THÀNH",61000,61000,0,0
TIKI,the-thao-da-ngoai,3777699,"Tạ đĩa gang phi 27 loại 5 kg (quả)",145000,215000,70000,33
TIKI,the-thao-da-ngoai,192074633,"Ghế Xếp Thư Giãn Gấp Gọn Dã Ngoại Picnic SUMIKA K39, Thiết Kế Tựa Lưng, Vải Oxford",390000,570000,180000,32
TIKI,the-thao-da-ngoai,57655685,"Đai Chạy Bộ Đa Năng Hàng Chính Hãng",35000,35000,0,0
TIKI,the-thao-da-ngoai,27844774,"Khung Nắn Chỉnh Cột Sống, Khung Định Hình Cột Sống, Trị Thoát Vị Đĩa Đệm, Đau Lưng, Vai Gáy, Dụng Cụ Hỗ Trợ Tập Lưng - Chính Hãng Amalife - LƯỢN SÓNG",185000,185000,0,0
TIKI,the-thao-da-ngoai,132340643,"Vòng Lắc Eo Thông Minh Có Đồng Hồ Đếm Số Vòng- Giảm Mỡ Massage Bụng- Hàng Chuẩn Chính Hãng MINIIN",152000,199000,47000,24
TIKI,the-thao-da-ngoai,42054529,"Bình Lắc Shaker Inox Gym Có Giữ Nhiệt Chính Hãng",165000,165000,0,0
TIKI,the-thao-da-ngoai,19585135,"Kính Bơi Cận View V510",420000,720000,300000,42
TIKI,the-thao-da-ngoai,17405487,"Gậy bẻ tập cơ tay Cao cấp (Chọn lực nặng)",59500,119000,59500,50
TIKI,the-thao-da-ngoai,91097295,"Giày cầu lông Lefus L05 chính hãng dành cho nam và nữ, mẫu mới có 3 màu lựa chọn",459000,459000,0,0
TIKI,the-thao-da-ngoai,198326138,"đai chống gù lưng cao cấp mi01 - Chính hãng DoDoDios",285000,285000,0,0
TIKI,the-thao-da-ngoai,195967670,"Quần đá banh trẻ em Sportslink CPSports (Màu ngẫu nhiên)",38000,38000,0,0
TIKI,the-thao-da-ngoai,67237288,"Bộ Xà Đơn P90X Có Thêm Móc Để Treo Bao Cát (Tặng Kèm Kìm Bóp Cơ Tay Lực 5-60kg)- Xà Đơn Đa Năng Khoan Tường Có 6 Mút Tay Cầm Phiên Bản Cải Tiến Cao Cấp ",300000,600000,300000,50
TIKI,the-thao-da-ngoai,75764201,"Vòng Lắc Eo Ống Thép Mọc Mút Xốp Lắp Ghép Cao Cấp Chính Hãng Đại Nam Sport",177000,300000,123000,41
TIKI,the-thao-da-ngoai,106893083,"Áo thun nam cổ tròn tay ngắn, chất thun lạnh mềm mát, thấm hút mồ hôi, thoải mái vận động – FORMEN SHOP – FMTY002",79000,159000,80000,50
TIKI,the-thao-da-ngoai,184582915,"Quần đạp xe nữ đệm mông gel silicone Wosawe PL109 | Thoáng khí, êm ái, đàn hồi",179000,179000,0,0
TIKI,the-thao-da-ngoai,136765525,"Băng Bảo Vệ Cổ Chân 360º VNSPORT, Băng Cổ Chân Chuyên Dụng Phòng Các Chấn Thương Cổ Chân Cho Các Bộ Môn Thể Thao - Cầu Lông, Bóng Rổ, Bóng Chuyền, Chạy Bộ, Đạp Xe, Tennis, Leo Núi, Dã Ngoại (1 Đôi)",500000,700000,200000,29
TIKI,the-thao-da-ngoai,794352,"Cầu Lông Ống A Ngắn HT OAN",116000,116000,0,0
TIKI,the-thao-da-ngoai,174125346,"Bao Tay Dán Nhanh - BAO TAY TẬP GYM - Lâm Sport - Chất liệu thể thao - (1 CẶP)",34000,50000,16000,32
TIKI,the-thao-da-ngoai,195967744,"Áo đá banh trẻ em Sportslink CPSports (Màu ngẫu nhiên)",38000,38000,0,0
TIKI,the-thao-da-ngoai,144405151,"Đai bảo vệ khớp vai có điều chỉnh Aolikes chính hãng HJ-1697",120000,159000,39000,25
TIKI,the-thao-da-ngoai,115244909,"Giày Thể Thao Nam Biti's Hunter Street Z Collection High White DSMH06200TRG (Trắng)",652000,814000,162000,20
TIKI,the-thao-da-ngoai,34914037,"Đai Lưng Cứng Da Bò Tập GYM Valeo Lifting Belt (Có Lớp Đệm Êm)",295000,295000,0,0
TIKI,the-thao-da-ngoai,2362893,"Gậy leo núi hộp kim nhôm Eurofins Sportslink (65cm-135cm)",169000,242000,73000,30
TIKI,the-thao-da-ngoai,36102291,"Găng Tay Có Móc Hỗ Trợ Nâng Tạ Weight Lifting Hook Valeo (1 Đôi)",195000,195000,0,0
TIKI,the-thao-da-ngoai,59518594,"Đèn sạc đội đầu siêu sáng chính hãng Roman ELE2025",109000,109000,0,0
TIKI,the-thao-da-ngoai,52665589,"Giày Chạy Bộ Thể Thao Nam PEAK Feather Lite EW0127H",599000,1090000,491000,45
TIKI,the-thao-da-ngoai,113056592,"Quần thể dục 3 sọc cho nam, đồ thể thao nam nữ các cấp, vải thun co giãn, thương hiệu Amazing",81000,125000,44000,35
TIKI,the-thao-da-ngoai,147884190,"[CHÍNH HÃNG] Bình nước thể thao bằng inox 304, bình đựng nước thể thao có tấm lưới lọc, có thể dùng đựng nước ở văn phòng, công sở, trường học - Chính hãng dododios",185000,185000,0,0
TIKI,the-thao-da-ngoai,103209835,"Vợt cầu lông cán liền Agnite tặng kèm túi đựng vợt - 1 chiếc - F2133",329000,646200,317200,49
TIKI,the-thao-da-ngoai,4318165,"Đai Quấn Cổ Chân Bảo Vệ Mắt Cá Chân AOLIKES TC-7130",62000,62000,0,0
TIKI,the-thao-da-ngoai,141299015,"Banh bóng chuyền da Parabol VB3300 - Loại da mềm - Quả bóng chuyền dán size 5",127000,128000,1000,1
TIKI,the-thao-da-ngoai,4414611,"Bóng Rổ Zocker Số 7",129000,250000,121000,48
TIKI,the-thao-da-ngoai,178226148,"Combo 2 tạ tay nhựa đúc hoàn chỉnh - Tạ tay nhựa Việt Nam Sportslink",13000,20000,7000,35
TIKI,the-thao-da-ngoai,95200246,"Bình nước cứng thể thao, chạy bộ GoodFit dung tích 250ml GF03RA",23000,35000,12000,34
TIKI,the-thao-da-ngoai,161368303,"Giày Trượt Patin Trẻ Em, Giày Patin 4 Bánh Tặng Kèm Bảo Hộ cùng màu - Giày Batin khung hợp kim+ nhựa PP cứng chịu lực, chống mài mòn - Phù Hợp Cho Bé từ 5 tuổi trở lên",329000,329000,0,0
TIKI,the-thao-da-ngoai,203824404,"[Hộp 12 quả] Cầu lông chính hãng Agnite - lông ngỗng, lông vịt cao cấp - chắc chắn, chịu va đập, cầu bền đường bay ổn định",139000,214200,75200,35
TIKI,the-thao-da-ngoai,33393166,"Bộ Giày Trượt Patin Đại Nam Sport T20096 Bánh  Phát Sáng + Kèm bảo hộ (Chân,tay, mũ bảo hiểm)",370000,600000,230000,38
TIKI,the-thao-da-ngoai,51300180,"Ruột Zippo Gas Butane - Một Tia Lửa 65826",510000,510000,0,0
TIKI,the-thao-da-ngoai,51433824,"Giày Bata Vải Thể Thao Bình Minh",89900,89900,0,0
TIKI,the-thao-da-ngoai,170753798,"Mũ Rộng Vành Dã Ngoại Naturehike NH17M005-A",220000,220000,0,0
TIKI,the-thao-da-ngoai,20614763,"Hộp 12 Thanh Protein PLAY Vị Cacao ",600000,600000,0,0
TIKI,the-thao-da-ngoai,98032682,"Giảm rung Babolat phát ra tiếng kêu vi vu khi vung vợt, vung vợt càng nhanh , tiếng kêu càng lớn Vỉ : 2 cái 2 màu",159000,199000,40000,20
TIKI,the-thao-da-ngoai,117371966,"Bộ 5 dây ngũ sắc kháng lực tập Gym - Dây cao su kháng lực hỗ trợ tập toàn thân",245000,255000,10000,4
TIKI,the-thao-da-ngoai,54387636,"Bóng Tập Yoga, Bóng Yoga Tròn Cỡ Đại 65cm Cao Cấp - Chính Hãng (Hàng nhập khẩu)",139000,210000,71000,34
TIKI,the-thao-da-ngoai,198111491,"SET 3 dây tập gym, tập mông mini band GoodFit GF914MB",64000,99000,35000,35
TIKI,the-thao-da-ngoai,57789139,"Túi đeo hông, đai chạy bộ nhiều ngăn chống nước, có phản quang Goodfit GF102RB",118000,200000,82000,41
TIKI,the-thao-da-ngoai,104100270,"Thiết Bị Phục Hồi Chức Năng Zasami KZ cải tiến có đai giữ cố định người bệnh 3 trong 1 ",2750000,3590000,840000,23
TIKI,the-thao-da-ngoai,74606058,"Đai bảo vệ khớp gối chuyên dụng cho chấn thương, sau mổ GoodFit GF520K",249000,399000,150000,38
TIKI,the-thao-da-ngoai,91097364,"Giày cầu lông Lefus L1085 chính hãng dành cho nam và nữ, mẫu mới có 3 màu lựa chọn",458000,458000,0,0
TIKI,the-thao-da-ngoai,72757783,"Gạch Tập Yoga,Gối Yoga Họa Tiết Chính Hãng Cao Cấp (Chọn Màu)",69000,138000,69000,50
TIKI,the-thao-da-ngoai,48300581,"Giày đá bóng Zocker ZTF SPACE 2001 Silver",569000,750000,181000,24
TIKI,the-thao-da-ngoai,136540728,"Tạ tay cao su Brosman 1KG , 2KG , ... tạ đơn lõi gang đặc cao cấp hỗ trợ tập gym tại nhà",132000,140000,8000,6
TIKI,the-thao-da-ngoai,68500788,"Đèn sạc đội đầu có khả năng chống nước mưa chính hãng Roman ELE2019 - Thắp sáng liên tục đến 8 giờ sử dụng với 2 dòng ánh sáng ấm hoặc trắng",155000,155000,0,0
TIKI,the-thao-da-ngoai,181772164,"Đĩa xoay eo tập thể dục 360 độ bàn xoay tập cơ bụng cho eo thon tại nhà và phòng gym có hạt massage bàn chân, Đĩa Xoay Tập Eo - Bàn Xoay Tập Eo - Đĩa Xoay Eo Giảm Cân - Bàn Xoay Eo Tập Thể Dục Hiệu Quả, dụng cụ thể thao - Chính hãng dododios",63000,63000,0,0
TIKI,the-thao-da-ngoai,160745517,"Giày Chạy Bộ Nữ Biti's Hunter Running TIGER DSWH08300CAM (Cam)",785000,981000,196000,20
TIKI,the-thao-da-ngoai,58341210,"Khăn Trùm Mặt Che Nắng Đi Phượt Đa Năng Cao Cấp Vải Thoáng Khí, Mau Khô, Dễ Mặc Cho Nam Và Nữ Dành Cho Phượt Thủ - Mai Lee",67000,67000,0,0
TIKI,the-thao-da-ngoai,41825814,"GĂNG TAY THỂ THAO ADIDAS ADGB-1315",442000,456000,14000,3
TIKI,the-thao-da-ngoai,26106763,"Bộ 2 Vợt Bóng Bàn Chính Hãng miDoctor + Túi Đựng Vợt Bóng Bàn + 3 Bóng ",179000,179000,0,0
TIKI,the-thao-da-ngoai,198098454,"Vợt cầu lông ProKennex POWER PRO 709 chính hãng công thủ toàn diện (1 cây) - Tặng kèm quấn cán",1989000,1989000,0,0
TIKI,the-thao-da-ngoai,127947330,"Gậy Rung Đàn Hồi Tập Gym Tập Toàn Thân Cao Cấp Chính Hãng Đại Nam Sport",101000,200000,99000,50
TIKI,the-thao-da-ngoai,79445921,"Custom Ring -1 vòng cao su Babolat băng cán vợt màu ngẫu nhiên  (710026)",35000,35000,0,0
TIKI,the-thao-da-ngoai,96211952,"Đai điều chỉnh cột sống AOLIKES A-3106 Back Posture Corrector chống gù lưng",335000,489000,154000,31
TIKI,the-thao-da-ngoai,2431543,"Nón cổ động bóng đá các đội tuyển Sportslink - Brasil",47000,47000,0,0
TIKI,the-thao-da-ngoai,58625585,"Quần Tập GYM Nam Cao Cấp SZone SQ492",69000,69000,0,0
TIKI,the-thao-da-ngoai,75345767,"Banh Bóng Rổ Da Geru Star Federation - Size 7 - Tặng kèm Balo rút + Bơm tay + Kim Bơm + Túi lưới",379000,399000,20000,5
TIKI,the-thao-da-ngoai,132815026,"Áo Bơi Nam Tay Dài Grey Navy Sobie",365500,430000,64500,15
TIKI,the-thao-da-ngoai,188914638,"Quần Đùi Nam BIG SIZE FASVIN Từ 80 Đến 120KG Vải Gió Đẹp Hàng Nhà Máy Dùng Khi Thể Thao Hay Mặc Nhà D22173.HN",119000,238000,119000,50
TIKI,the-thao-da-ngoai,100367707,"Quần đùi Big Size thể thao nam Fasvin D20209.HN vải mềm mại co giãn thoải mái",169000,209000,40000,19
TIKI,the-thao-da-ngoai,195971277,"Quần dài nỉ trẻ em Sportslink CPSports - giao Ngẫu nhiên",99000,130000,31000,24
TIKI,the-thao-da-ngoai,87789122,"Balo cầu lông chính hãng ProKennex PRO21B01",612000,888000,276000,31
TIKI,the-thao-da-ngoai,185466935,"Khung Hỗ Trợ Tập Lưng, Nắn Chỉnh Cột Sống, Khung Định Hình Cột Sống, Hỗ Trợ Điều Trị Thoát Vị Đĩa Đệm, Đau Lưng, Vai Gáy - Chính Hãng Amalife",39900,39900,0,0
TIKI,the-thao-da-ngoai,95266785,"Giày Đá Bóng Zocker Space thế hệ mới 2021",569000,650000,81000,12
TIKI,the-thao-da-ngoai,156628745,"Cầu đá lông gà, Cầu đá ống tuyển trắng HD111 Sportslink",15000,21000,6000,29
TIKI,the-thao-da-ngoai,172456556,"Dây Nhảy Thể Lực Cao Cấp miDoctor Nặng 450g - Luyện Võ Thuật, Boxing, Muay Thái (Tặng Túi)",188800,188800,0,0
TIKI,the-thao-da-ngoai,120671885,"Xà Đơn Treo Tường 2022 Tích Hợp Giọt Nước Chỉnh Thăng Bằng Đại Nam Sport Thế Hệ Mới + Kèm Găng Tay Tập Xà",212000,550000,338000,61
TIKI,the-thao-da-ngoai,794378,"Cầu Lông Nhựa A Ngắn OAN6 - Giao Màu Ngẫu Nhiên",94000,94000,0,0
TIKI,the-thao-da-ngoai,88821679,"Lều 2 Người Phượt Cắm Trại Du Lịch Galaxy Store GSL03 Tetragon 2P Hàng Chính Hãng (Màu Ngẫu Nhiên) Kèm Quà Tặng",525000,599000,74000,12
TIKI,the-thao-da-ngoai,172095265,"Tấm Bạt Thảm Dã Ngoại Picnic Du Lịch Trải Lót Lều Cắm Trại Chống Thấm Nước Cao Cấp Galaxy Store GSTL03 Xếp Gọn Nhẹ - Hàng Chính Hãng (Màu Ngẫu Nhiên)",251000,500000,249000,50
TIKI,the-thao-da-ngoai,39065778,"Khăn rằn thời trang Cambodia Caro BlacknWhite 60x180cm (Trắng đen)",70000,70000,0,0
TIKI,the-thao-da-ngoai,45065546,"Băng dán cơ thể thao Kinesiology Tape 5cm*5m cao cấp Muscle bandage sticker AOLIKES YE-MT002",133000,199000,66000,33
TIKI,the-thao-da-ngoai,133933412,"[Combo] Xỏ Khuỷu Tay và Bó gối có miếng đệm bảo vệ - Hỗ trợ tập Yoga, Gym, chơi thể thao",119000,119000,0,0
TIKI,the-thao-da-ngoai,275127073,"Viên Đốt Mỡ Giảm Cân Hydroxycut Hardcore Elite/ Super Elite (100v-110v-120v) - Muscletech USA",493000,735000,242000,33
TIKI,the-thao-da-ngoai,544906,"Bảng Phi Tiêu Chuyên Nghiệp 45cm + 6 cây phi tiêu",400000,400000,0,0
TIKI,the-thao-da-ngoai,182813502,"Ghế gấp dã ngoại Naturehike NH20JJ027",830000,830000,0,0
TIKI,the-thao-da-ngoai,126504994,"Dây Tập Gym Tập Mông Mini Band Goodfit GF914MB",64000,99000,35000,35
TIKI,the-thao-da-ngoai,103209852,"[Hộp 6 quả] Cầu lông nhựa chính hãng Agnite - siêu bền - phù hợp tập luyện, chơi thể thao - F2212",69000,133200,64200,48
TIKI,the-thao-da-ngoai,68656523,"Máy Chạy Bộ Điện Gia Đình Nhỏ Gọn Màn Hình Điện Tử (Có Điều Khiển Remote Từ Xa)",3177000,5000000,1823000,36
TIKI,the-thao-da-ngoai,193043008,"Giày Thể Thao Nam Biti's",688000,765000,77000,10
TIKI,the-thao-da-ngoai,87714958,"Tạ Tay Lõi Sắt Bọc Nhựa đúc nguyên khối( Chọn Lực Nặng)/1 Chiếc",79000,158000,79000,50
TIKI,the-thao-da-ngoai,195961234,"Thảm Du Lịch Dã Ngoại Gấp Gọn Tiện Lợi, Có Quai Xách, Chống Thấm Nước, Bạt Tấm Trải Đi Biển, Thảm Chụp Ảnh- Hàng Chính Hãng",99000,159000,60000,38
TIKI,the-thao-da-ngoai,189594161,"Túi Đeo Hông Chạy Bộ Nhỏ Gọn Aonijie W8112 Chống Thấm Nước",349000,349000,0,0
TIKI,the-thao-da-ngoai,193411115,"Áo croptop tập Yoga Gym Hibi Sports CR815 kiểu 2 dây nhún bèo, Kèm mút ngực",199000,340000,141000,41
TIKI,the-thao-da-ngoai,112287409,"Khung giá giữ bình nước xe đạp thể thao Kiotool nhựa dẻo bền đẹp",35000,35000,0,0
TIKI,the-thao-da-ngoai,114230666,"Áo tập Yoga Gym dây phối trắng BA507 Hibi Sports - Có mút nâng ngực bên trong",196000,280000,84000,30
TIKI,the-thao-da-ngoai,72634963,"BG Bộ xà đơn, xà kép đa năng cao cấp CHINNING DIPPING - RED (hàng nhập khẩu)",1280000,2399000,1119000,47
TIKI,the-thao-da-ngoai,103209958,"Vợt cầu lông Agnite cho trẻ em - 2 chiếc - F2125",229000,466200,237200,51
TIKI,the-thao-da-ngoai,73109624,"Giàn tạ đa năng kết hợp xà đơn xà kép Zasami 8211 - Kèm 54kg tạ gang , đòn tạ 1m5, 1 găng tay tập tạ",6562000,9200000,2638000,29
TIKI,the-thao-da-ngoai,174612804,"Mutant Iso Surge 5Lbs  - Bổ sung Protein, hỗ trợ tăng Cơ, phục hồi Cơ, Zero Đường Lactose",1899500,1899500,0,0
TIKI,the-thao-da-ngoai,11604565,"Sữa tăng cơ tăng sức mạnh Nitro Tech 10lbs (~4.54kg) – Hương vị VANILLA -Bổ sung nguồn Protein chất lượng cao hỗ trợ phát triển cơ bắp to + dày, đồng thời bổ sung thêm Creatine giúp gia tăng sức bền hỗ trợ tập luyện - Hàng nhập khẩu chính hãng - Thương hi",3235000,4235000,1000000,24
TIKI,the-thao-da-ngoai,58209697,"Bó gối thể thao, băng đầu gối tập gym GoodFit đệm silicone, thanh lò xo trợ lực GF512K",195000,299000,104000,35
TIKI,the-thao-da-ngoai,164160832,"Giày cầu lông nam nữ KAWASAKI K176 mẫu mới có 2 màu lựa chọn - tặng tất thể thao bendu",1250000,1250000,0,0
TIKI,the-thao-da-ngoai,130978267,"Túi Ngủ Văn Phòng,Túi Ngủ Mùa Đông Dã Ngoại Nặng 1.6kg Dày Dặn Đại Nam Sport",296000,500000,204000,41
TIKI,the-thao-da-ngoai,77743551,"Bánh Protein Brownie Myprotein bổ sung năng lượng và Protein hộp 12 cái - Nutrition Depot Vietnam",680000,680000,0,0
TIKI,the-thao-da-ngoai,47323094,"VỎ ZIPPO SATIN CHROME CHÍNH HÃNG - KHÔNG KÈM RUỘT",415000,415000,0,0
TIKI,the-thao-da-ngoai,97678413,"Quần Thể Thao Gym Yoga Nữ Tôn Dáng Mông Đào Lưng Cao Co Giãn THoải Mái ,  Có Túi Hông Tiện Lợi Cleacco , đủ size  - Hàng Chính Hãng BORO SPORT",112000,255000,143000,56
TIKI,the-thao-da-ngoai,73894187,"GIÀY BÓNG BÀN, BÓNG CHUYỀN, CẦU LÔNG 002 ĐẲNG CẤP GIÀY VIỆT",245000,245000,0,0
TIKI,the-thao-da-ngoai,189490899,"Labrada Lean Body (1 gói ), Sữa Thay Thế Bữa Ăn, 40g Protein, 8G Chất Béo Tốt & Chất Xơ, 22 Vitamin và Khoáng Chất",64000,64000,0,0
TIKI,the-thao-da-ngoai,160492157,"Kính bơi trẻ em Zoggs Super Seal Junior - 305850 (6-14 tuổi)",255000,255000,0,0
TIKI,the-thao-da-ngoai,36319468,"Đai Lưng Mềm Tập GYM Aolikes Fitness AL-7983",155000,155000,0,0
TIKI,the-thao-da-ngoai,73753987," Túi Ngủ Naturehike NH19S015-D H150 Siêu Gọn Nhẹ Chỉ 800gram",350000,350000,0,0
TIKI,the-thao-da-ngoai,76528209,"Quần giữ nhiệt COMBAT PRO Quần Legging Nam tập Gym bóng đá bóng rổ SQ518",89000,89000,0,0
TIKI,the-thao-da-ngoai,178221433,"Tạ đĩa, tạ bánh gang Zasam lỗ tạ phi 27 với các mức tạ (  bánh )",58200,85000,26800,32
TIKI,the-thao-da-ngoai,66576225,"Ruột Zippo mới chính hãng USA – màu vàng KHÔNG KÈM VỎ ZIPPO",450000,450000,0,0
TIKI,the-thao-da-ngoai,113437146,"Ghế Xếp Câu Cá Dã Ngoại Naturehike NH16J001-J",360000,360000,0,0
TIKI,the-thao-da-ngoai,116571842,"Dây tập gym, tập mông mini band GoodFit GF913MB",113000,159000,46000,29
TIKI,the-thao-da-ngoai,186292834,"Xà Đơn Treo Tường Thế Hệ Mới FED-0228",499000,499000,0,0
TIKI,the-thao-da-ngoai,188916705,"Quần Đùi Nam Ngắn FASVIN Vải Gió Nhẹ Mát Có Khóa Túi Tiện Dụng Thể Thao Hay Mặc Nhà R21469.HN",99000,198000,99000,50
TIKI,the-thao-da-ngoai,182786646,"Xà Đơn,Xà kép Đa Năng EX30 Bản Cao Cấp Tiêu Chuẩn Phòng Gym(Tặng Bộ 5 Dây đàn Hồi Cao Cấp 11 chi tiết)Ảnh Thật chi tiết dưới mô tả",2950000,5900000,2950000,50
TIKI,the-thao-da-ngoai,71905148,"Ván Trượt Trẻ Em Mặt Nhám Kích Thước 60cm Cho Trẻ Dưới 10 Tuổi ,Chịu Lực 100kg (Màu Ngẫu Nhiên)",132000,300000,168000,56
TIKI,the-thao-da-ngoai,189573901,"[Loại Cao Cấp] Vòng Lắc Eo Ống Thép Mọc Mút Xốp Lắp Ghép Cao Cấp Chính Hãng DoDoDios - Vòng Lắc Eo Giảm Mỡ Bụng Ống Thép Bọc Mút Xốp - Tùy Chỉnh Độ Nặng",207000,207000,0,0
TIKI,the-thao-da-ngoai,186271128,"Ghế Xếp Gấp Gọn Đi Câu Cá Và Dã Ngoại Picnic Thiết Kế Tựa Lưng Ngồi Thư Giãn Chất Liệu Vải Oxford Dày Dặn Thoáng Khí - Hàng Chính Hãng",899000,999000,100000,10
TIKI,the-thao-da-ngoai,122446261,"Combo Giày Patin Trẻ Em Centosy Kid Pro (Giày + Bộ Bảo Hộ + Túi)",1650000,1650000,0,0
TIKI,the-thao-da-ngoai,69691703,"Băng đai quấn nẹp cổ tay có thanh kim loại hỗ trợ cố định cổ tay, vải chống trượt thoáng khí, hỗ trợ hồi phục chấn thương cổ tay Goodfit GF304W",89000,150000,61000,41
TIKI,the-thao-da-ngoai,20616624,"Hộp 12 Thanh Protein PLAY Vị Bơ Đậu Phộng",600000,600000,0,0
TIKI,the-thao-da-ngoai,116813717,"Dây nhảy có bộ đếm kỹ thuật số tiện dụng 2 in 1 Sportslink",100000,104000,4000,4
TIKI,the-thao-da-ngoai,174406926,"SÁCH HƯỚNG DẪN CHƠI GOLF "Love golf - Love life"",350000,350000,0,0
TIKI,the-thao-da-ngoai,66740355,"giày đá bóng vải chính hãng wika ULTRA 3, thương hiệu người việt",120000,120000,0,0
TIKI,the-thao-da-ngoai,77149840,"Quấn cốt Babolat UPTAKE nhiều màu - thay cho một vợt (671001 màu ngẫu nhiên)",159000,159000,0,0
TIKI,the-thao-da-ngoai,3188297,"Võng mùng, Túi ngủ Biệt Kích Mỹ Phối Mùng Chống Muỗi 2 lớp siêu bền Ánh Sao",200000,205000,5000,2
TIKI,the-thao-da-ngoai,189574232,"Băng gối thể thao có đệm xương bánh chè GoodFit GF523K bó gối dành cho Gym, bóng đá, cầu lông",81000,149000,68000,46
TIKI,the-thao-da-ngoai,189938605,"Túi Ngủ Cao Cấp Văn Phòng + Đi Phượt (Hàng Xuất Khẩu) - Túi Ngủ Dã Ngoại, Túi Ngủ Du Lịch - Chính hãng dododios",207000,207000,0,0
TIKI,the-thao-da-ngoai,126492821,"Dây Thun Đàn Hồi Tập Gym Mini Band Goodfit GF911MB",6000,15000,9000,60
TIKI,the-thao-da-ngoai,272444481,"Sữa tăng cơ Rule 1 Whey Blend 64-69 servings - 2.2kg tặng Rule 1 Shaker",1175000,1175000,0,0
TIKI,the-thao-da-ngoai,1812245,"Thực phẩm bổ sung Optimum Nutrition Platinum HydroWhey 3.5lb (1.59kg)",1610000,1610000,0,0
TIKI,the-thao-da-ngoai,4227213,"Bình Nước Thể Thao Chute Mag Camelbak (0.75L)",375000,375000,0,0
TIKI,the-thao-da-ngoai,43179685,"Bộ 2 băng quấn cổ tay,đeo cổ tay tập gym chơi thể thao LT6638 (Giao màu ngẫu nhiên)",87000,150000,63000,42
TIKI,the-thao-da-ngoai,57517299,"Băng trán thể thao nam, nữ thấm hút mồ hôi chuyên nghiệp REXCHI",45000,45000,0,0
TIKI,the-thao-da-ngoai,110570615,"Serious Mass 6Lbs - Sữa tăng cân cho người gầy, bổ sung đầy đủ thành phần dinh dưỡng",1079500,1079500,0,0
TIKI,the-thao-da-ngoai,57692545,"Băng quấn trợ lực khớp cổ tay tập gym, tập boxing GoodFit co giãn 4 chiều, khóa dán chắc chăn GF301W",112000,150000,38000,25
TIKI,the-thao-da-ngoai,152462911,"Áo ngực thể thao nữ iBX IBX122",159000,399000,240000,60
TIKI,the-thao-da-ngoai,23393547,"Kính bơi chuyên nghiệp từ Đức Aquafeel dòng "Leader Mirrored" siêu nhẹ (32g), 100% nhập khẩu từ Đức, đạt tiêu chuẩn chất lượng Châu Âu, thiết kế kiểu dáng dành cho thi đấu đỉnh cao, phù hợp cho cả nam và nữ - Free Size",1296000,1296000,0,0
TIKI,the-thao-da-ngoai,120461134,"Bộ Tạ Tay (6 in 1) Composite FED Kết hợp tạ đẩy(20 kg)Đa Năng Cao cấp --- hàng chính hãng.",1650000,1650000,0,0
TIKI,the-thao-da-ngoai,161452218,"Bộ 2 vỏ tạ tay nhựa bát giác 8kg REEFIT (2 vỏ 8kg, tổng 16kg)",98000,98000,0,0
TIKI,the-thao-da-ngoai,195192757,"Quần Jogger Nam Thể Thao Fasvin Bo Gấu Dáng Đẹp Vải Gió Co Giãn Tiện Dụng Đũi Chơi Hay Mặc Nhà DC20424.HN",189000,298000,109000,37
TIKI,the-thao-da-ngoai,124068115,"Dụng Cụ Hỗ Trợ Tập Cổ Tay Và Cơ Tay Cao Cấp Loại 1 Đại Nam Sport",70000,150000,80000,53
TIKI,the-thao-da-ngoai,793864,"Vợt Cầu Lông HT VHTD - Đỏ ",204000,204000,0,0
TIKI,the-thao-da-ngoai,184766241,"Giày Bata Học Sinh Học Thể Dục Chạy Bộ Cao Cấp Mẫu Mới",200000,200000,0,0
TIKI,the-thao-da-ngoai,28913854,"Giày bata Thượng đình trắng sọc xanh",105000,199000,94000,47
TIKI,the-thao-da-ngoai,149188865,"Túi Đựng Thảm Tập Yoga PU TPE Cao Cấp Vải Oxford Chống Nhăn Chống Ẩm  - Tặng Kèm Dây Buộc Thảm Yoga Chuyên Dụng Hàng Chính Hãng Dododios",85000,85000,0,0
TIKI,the-thao-da-ngoai,198098723,"Vợt cầu lông ProKennex POWER PRO 708 chính hãng công thủ toàn diện (1 cây) - Tặng kèm quấn cán",1068000,2088000,1020000,49
TIKI,the-thao-da-ngoai,81529969,"Quần Ngắn thể thao nam New Balance",672000,895000,223000,25
TIKI,the-thao-da-ngoai,193536174,"Giày Thể Thao Trung Cấp Nữ Biti's Êmbrace DSW066300HOD (Hồng đậm)",549000,549000,0,0
TIKI,the-thao-da-ngoai,66646093,"Dụng Cụ Tập Hít Đất Cầm Tay Thép Cứng Cao Cấp – Đen - mi02 - Dụng Cụ Chống Đẩy miDoctor (Đường Kính Khung 18MM)",72000,72000,0,0
TIKI,the-thao-da-ngoai,1811825,"Thực phẩm bổ sung Optimum Nutrition Serious Mass 12lb (5.44kg) Vanilla",1640000,1640000,0,0
TIKI,the-thao-da-ngoai,20629152,"Găng chống nắng chống tia UV- PGM XT002",92000,105000,13000,12
TIKI,the-thao-da-ngoai,148827659,"Bộ Đôi Găng Tay Đấm Bốc Cho Người Lớn Cao Cấp Freesize (10+11) Cho Người Từ 40 – 75Kg – Găng Bao Tay Tập Đấm Bốc Boxing MMA Hoa Văn Hổ Chính Hãng Dododios",229000,229000,0,0
TIKI,the-thao-da-ngoai,35131225,"Đai Lưng Có Xích Treo Tạ Dip Belt Valeo",255000,255000,0,0
TIKI,the-thao-da-ngoai,6559555,"Bật Lửa Zippo Armor Brushed Brass 168",870000,870000,0,0
TIKI,the-thao-da-ngoai,123491030,"Xe đạp thể dục toàn thân Airbike Sport - Hàng chính hãng",1599000,2990000,1391000,47
TIKI,the-thao-da-ngoai,130398012,"Gậy Gập Bẻ Tập Cơ Tay Tower Twister XB-1030",175000,231000,56000,24
TIKI,the-thao-da-ngoai,125525741,"Bộ 2 đai bảo vệ đầu gối AOLIKES YE-7901 hỗ trợ khớp gối Knee Support Braces",354000,489000,135000,28
TIKI,the-thao-da-ngoai,146494325,"Bộ 2 Vợt Bóng Bàn Phủ Carbon Cao Cấp Kèm 3 Quả Bóng Bàn – Combo 2 Vợt Bóng Bàn Tặng 3 Quả Bóng Cao Cấp Chính Hãng dododios",228000,228000,0,0
TIKI,the-thao-da-ngoai,56949916,"Băng Vải Đàn Hồi Đeo Cổ Tay Thấm Mồ Hôi Thể Thao- Băng đàn hồi Hỗ Trợ Khớp Cổ Tay Khi Chơi Thể Thao REXCHI",35000,35000,0,0
TIKI,the-thao-da-ngoai,73323934,"Xe đạp thể thao, xe đạp gấp gọn người lớn GoodFit tùy chỉnh độ nặng, tập thể dục tại nhà GF002MB",434000,899000,465000,52
TIKI,the-thao-da-ngoai,46567662,"Bình Nước Xe Đạp Thể Thao Camelbak Podium Dirt Series 620ml Có Nắp Đậy Chống Đất Cát",299000,299000,0,0
TIKI,the-thao-da-ngoai,95023415,"Kính Bơi Cận Thị Từ 2 Độ Tới 8 Độ Cleacco Dành Cho Người Cận Nam Nữ Dùng Được , Thấu Kính Trong HD Chống Sương Mờ - Hàng Chính Hãng",250000,404000,154000,38
TIKI,the-thao-da-ngoai,2282589,"Bộ 3 Sản Phẩm Xăng, Đá, Bấc Zippo",195000,195000,0,0
TIKI,the-thao-da-ngoai,74556782,"Giàn tạ đa năng 8210 Zasami kèm 50kg tạ gang , đòn tạ 1m5, 1 găng tay tập tạ ( Màu ngẫu nhiên )",4099000,4700000,601000,13
TIKI,the-thao-da-ngoai,71898962,"Sữa bổ sung đạm dành cho người ăn chay Vegan Blend Protein Myprotein vị Chocolate - Nutrition Depot Vietnam",920000,990000,70000,7
TIKI,the-thao-da-ngoai,147943549,"[Hàng Cao Cấp] Thảm Tập Yoga Định Tuyến Da PU Cao Cấp Chính Hãng dododios + Túi Đựng Thảm Tập Yoga + Dây Buộc Thảm Yoga Định Tuyến",507000,507000,0,0
TIKI,the-thao-da-ngoai,190512699,"Đai lưng cột sống thoáng khí, có thanh nẹp GoodFit GF725WS đai cột sống giảm chấn thương lưng, cột sống",222000,399000,177000,44
TIKI,the-thao-da-ngoai,57695061,"Kính bơi chống tia UV , Chống sương mù , bảo vệ mắt Cleacco, dây đeo được làm 100% silicone mềm mại, thoải mái tặng kèm nón bơi vải PU cao cấp Cleacco - Hàng chính hãng",329000,471000,142000,30
TIKI,the-thao-da-ngoai,182805036,"Bóng tập yoga có gai đường kính 75cm chịu lực 200kg(tặng bơm Bóng)",119000,238000,119000,50
TIKI,the-thao-da-ngoai,102566702,"Áo polo thể thao bendu 21av68 mẫu mới nhất 2021",499000,499000,0,0
TIKI,the-thao-da-ngoai,35147989,"Bộ Kính Bơi View V500S Và Nút Bơi Nhét Tai EP405 - Hàng Chính Hãng",388000,675000,287000,43
TIKI,the-thao-da-ngoai,69748679,"Dây quấn cổ tay có móc nâng tạ GoodFit GF732LS",179000,299000,120000,40
TIKI,the-thao-da-ngoai,178107558,"Khăn Trùm Đầu UPF 50+ Ninja Fullface Chống Nắng WU101 - Cản Tia Cực Tím - Thoáng Khí - Đàn Hồi | Phụ kiện đi phượt, chạy xe",85000,85000,0,0
TIKI,the-thao-da-ngoai,68821395,"Dụng Cụ Bẻ Cổ Tay Cao Cấp Hỗ Trợ Rèn Luyện Cơ Tay,Bắp Tay Hàng Đẹp Giá Tốt Lực Tập 25-30kg",69000,138000,69000,50
TIKI,the-thao-da-ngoai,146509394,"Bộ 5 Dây Đàn Hồi - 5 Dây Kháng Lực Tập Gym Tập Yoga Tập Thể Thao Cao Su Non Cao Cấp Chính Hãng dododios - Có Túi Đựng Cao Cấp Hướng Dẫn Sử Dụng, dây kháng lực tập bóng đá",107000,107000,0,0
TIKI,the-thao-da-ngoai,119985869,"Khăn thể thao POÊMY sọc gân, kích thước 36x78cm, siêu mềm mịn, thấm hút tốt, phù hợp sử dụng khi tập Gym, chạy bộ",85000,99900,14900,15
TIKI,the-thao-da-ngoai,21615864,"Ghế dã ngoại thư giãn gấp gọn thiết kế mới Version 3 YL06 dành cho cắm trại, du lịch NH18Y060-Z",949000,1009000,60000,6
TIKI,the-thao-da-ngoai,68793194,"Găng Tay Tập GYM Hở Mu Da Bò Wrist Guard Aolikes (1 Đôi)",185000,185000,0,0
TIKI,the-thao-da-ngoai,188916562,"Quần Đùi Nam FASVIN Vải Gió Nhẹ Mát Hàng Nhà Máy Chất Lượng Cao Thể Thao Hay Mặc Nhà Q22508.HN",89000,170000,81000,48
TIKI,the-thao-da-ngoai,94304318,"Quần leggings tập gym cho nam Hibi Sports M103 - Loại đùi không đường phối",224000,320000,96000,30
TIKI,the-thao-da-ngoai,160831813,"Dụng cụ day ấn huyệt mát xa hình đầu Trâu gỗ Bách Xanh (MH885) Chăm sóc sức khỏe cho gia đình",39000,39000,0,0
TIKI,the-thao-da-ngoai,639504,"Phao Tim Tập Bơi Sportslink PHAOTIM - Màu Ngẫu Nhiên",65000,113000,48000,42
TIKI,the-thao-da-ngoai,6623979,"Kìm bóp tay điều chỉnh lực SW ( 10-60kg)-Đại Nam Sport",48000,120000,72000,60
TIKI,the-thao-da-ngoai,161461541,"Tạ Tay Nhựa 3kg Bát Giác REEFIT (1 cái)",21000,21000,0,0
TIKI,the-thao-da-ngoai,72869927,"Bóng tập Yoga Nửa Gai + Nửa Trơn 3D -65cm Cao Cấp 1200Gram – Tặng kèm bơm( Hàng Cao Cấp Chính hãng)",119000,238000,119000,50
TIKI,the-thao-da-ngoai,5061787,"Túi chống nước Ocean Pack Sportslink",65000,119000,54000,45
TIKI,the-thao-da-ngoai,195557260,"Bếp Ga Dã Ngoại Mini Xếp Gọn Naturehike NH21RJ009",410000,410000,0,0
TIKI,the-thao-da-ngoai,162167458,"Giày Bóng Rổ Thời Trang Thể Thao PEAK Taichi Colorful 6371 E13747E",799000,1590000,791000,50
TIKI,the-thao-da-ngoai,100369483," Quần đùi nam Fasvin Q21461.HN vải gió chun co giãn mềm mại thoải mái vận động",99000,198000,99000,50
TIKI,the-thao-da-ngoai,58007243,"MỘT CẶP HEAD 5 INCH TENNIS WRISTBAND -BĂNG MỒ HÔI TAY (285065)Màu ngẫu nhiên",232000,279000,47000,17
TIKI,the-thao-da-ngoai,126071232,"Trụ Đấm Bốc FED - 8725 --- Hàng Chính Hãng",3380000,3380000,0,0
TIKI,the-thao-da-ngoai,3448467,"Bóng Rổ Zocker Số 5 - Cam (Size 5)",119000,200000,81000,41
TIKI,the-thao-da-ngoai,81609944,"Nón Bơi Silicone UNISEX SPEEDO",195000,195000,0,0
TIKI,the-thao-da-ngoai,14034657,"Đai Quấn Chân Tập Gym Hỗ Trợ Tập Chân, Mông, Đùi Leg Wight Training Foot Ring AOLIKES YE-7129",66000,109000,43000,39
TIKI,the-thao-da-ngoai,101651414," Đệm Hơi Liền Gối Một Người Naturehike Dành Cho Văn Phòng, Du Lịch, Dã Ngoại NH15Q002-D",480000,480000,0,0
TIKI,the-thao-da-ngoai,189591573,"Combo 3 Đôi Vớ Xỏ Ngón Thể Thao Chạy Bộ  Đạp Xe Leo Núi Aonijie E4802 Chất Liệu Coolmax  Thoáng Khí",524000,524000,0,0
TIKI,the-thao-da-ngoai,196232450,"Quả cầu lông Fuwin giá rẻ",76000,110000,34000,31
TIKI,the-thao-da-ngoai,143174055,"Banh bóng rổ Gentra 8500 PVC- size 7 – Quả bóng rổ da số 7 – Tặng bộ phụ kiện bơm mini, kim bơm, túi lưới, túi rút",134000,134000,0,0
TIKI,the-thao-da-ngoai,151676187,"CHÍNH HÃNG - ĐAI NẸP KHUỶU TAY NÂNG CAO Adv Sports Elbow - BONBONE NHẬT BẢN - Hỗ trợ chấn thương.",295000,450000,155000,34
TIKI,the-thao-da-ngoai,33399458,"Dây Kéo Lưng Trợ Lực Cổ Tay Tập Gym Bản Cải Tiến Aolikes Lifting Straps AL-7633 (1 Đôi) ",175000,175000,0,0
TIKI,the-thao-da-ngoai,162519554,"DÂY NHẢY CAO CẤP ADIDAS ADRP-13011",348000,359000,11000,3
TIKI,the-thao-da-ngoai,58723933,"ÁO SÁT NÁCH FITNESS THỂ THAO TẬP GYM - BÓNG RỔ CAO CẤP THUN LỖ KIM SZONE SA473",105000,105000,0,0
TIKI,the-thao-da-ngoai,112977692,"[MUA 1 TẶNG 1] Set bộ thể thao cầu lông nữ badminton NEW02, cao cấp, chất lượng, chuẩn form",299000,299000,0,0
TIKI,the-thao-da-ngoai,34910968,"Dây Treo Người Tập Bụng 6 Múi AB Traps Valeo (1 Đôi)",235000,235000,0,0
TIKI,the-thao-da-ngoai,70564866,"Đèn Pin Đội Đầu 3 Bóng Led, 04 Chức Năng, Pin Sạc 9800Mah, 18650 4.2V - Hàng Chính Hãng",155000,155000,0,0
TIKI,the-thao-da-ngoai,73173470,"Chai xịt chống mờ kính bơi, kính cận SAEKO - Chống bám hơi nước và sương mù AS04 - SHOP TOÀN CHÂU",135000,135000,0,0
TIKI,the-thao-da-ngoai,159730811,"Kính bơi trẻ em Zoggs Sonic Air Junior 2.0",198000,395000,197000,50
TIKI,the-thao-da-ngoai,126414776,"Kính bơi nữ Speedo Futura Biofuse Flexiseal - 8-11314B978",495000,495000,0,0
TIKI,the-thao-da-ngoai,69518151,"Dây Nhảy Thể Dục( Lõi Thép bện ) Dài 2,9m Cải Tiến Cao Cấp Dây Nặng Tay Cầm Chắc Chắn Đủ Màu Sắc",39000,78000,39000,50
TIKI,the-thao-da-ngoai,35324160,"Đệm Lót Mút Xốp Hỗ Trợ Gánh Tạ Squat Barbell Pad Valeo",125000,125000,0,0
TIKI,the-thao-da-ngoai,90526870,"Bộ Giày Trượt Patin Trẻ Em Người Lớn DNS906 Tăng Giảm Size Bánh Cao Su Phát Sáng Đại Nam Sport + Kèm Full Bộ Bảo Hộ",411000,800000,389000,49
TIKI,the-thao-da-ngoai,170752375,"Mũ Lưỡi Trai Chống Tia UV UPF50+ Naturehike NH18H009-T",180000,180000,0,0
TIKI,the-thao-da-ngoai,111509764,"Đai Nẹp Cố Định Khớp Cổ Tay Với 2 Thanh Nẹp Trên Dưới AOLIKES AL1671 1671 Cho Người Chấn Thương Bong Gân Cổ Tay",115000,115000,0,0
TIKI,the-thao-da-ngoai,177190834,"Con Lăn Foam Roller Massage Gai 33cm - Ống Lăn Dãn Cơ Tập Gym, Yoga, Thể Hình",109000,218000,109000,50
TIKI,the-thao-da-ngoai,184634737,"Găng tay tập gym, bao tay hở ngón bảo vệ bàn tay, có dây quấn trợ lực cổ tay BTFA01",28000,29000,1000,3
TIKI,the-thao-da-ngoai,16693919,"Áo phao tập bơi  Yesure Intex Step 2 tiện dụng dành cho bé 3-6 tuổi(<30 kg), chất liệu nhựa PVC màu cam bắt mắt an toàn cho bé, không thấm nước, dễ dàng vệ sinh - Hàng Chính Hãng Tặng kèm bịt tai Silicon chống nước",115000,201000,86000,43
TIKI,the-thao-da-ngoai,33348363,"Sữa tăng cơ Rule 1 Casein 28 servings - 952g tặng 1 gói thử hãng Rule 1 bất kì",700000,700000,0,0
TIKI,the-thao-da-ngoai,48696566,"Ống tay thun lạnh co giãn 4 chiều chống nắng và tia UV 3M PS2000",139000,139000,0,0
TIKI,the-thao-da-ngoai,2282593,"Bộ 4 Vỉ Đá Zippo",200000,200000,0,0
TIKI,the-thao-da-ngoai,78563386,"Balo Tennis Babolat PURE DRIVE 2021 (753089)",1990000,1990000,0,0
TIKI,the-thao-da-ngoai,115270977,"Dây Nhảy Tập Thể Dục Cao Cấp Tại Nhà Lõi Thép Cao Cấp, Viền Tay Cầm Hình Kim Cương Chính Hãng Cao Cấp KitAcoom",36270,39000,2730,7
TIKI,the-thao-da-ngoai,68604999,"Thực phẩm bổ sung Creatine không mùi Rule 1 Creatine Unflavored 150 servings - 750g",1530000,1530000,0,0
TIKI,the-thao-da-ngoai,9263020,"Combo xà đơn treo tường DNS  (KT 60-110cm) + Kìm bóp tay điều chỉnh lực",148000,350000,202000,58
TIKI,the-thao-da-ngoai,11020657,"Quần bơi nam boxer Deenyt A1807",165000,218000,53000,24
TIKI,the-thao-da-ngoai,147411482,"Đai quấn lưng tập gym bảo vệ lưng và cột sống lõi thép trợ lực bảo vệ giúp  tránh chấn thương hiệu quả HY008 - Hành chính hãng BORO SPORT",222000,350000,128000,37
TIKI,the-thao-da-ngoai,176530434,"Dây Thun Quấn Chân Gối Đa Năng Aolikes Dài 120cm (1 Chiếc)",55000,55000,0,0
TIKI,the-thao-da-ngoai,153610317,"TEE ĐỠ BÓNG GOLF - PGM - QT001",40000,40000,0,0
TIKI,the-thao-da-ngoai,164943026,"Tấm Chắn Gió Dã Ngoại 8 Tấm Naturehike NH15F008-B Hợp Kim Nhôm Gấp Gọn ",215000,215000,0,0
TIKI,the-thao-da-ngoai,144404607,"Dây Kéo Lưng Cải Tiến Aolikes AL-7633 | Quấn Cổ Tay Nâng Tạ, Đu Xà, Tập Gym Chính Hãng",149000,149000,0,0
TIKI,the-thao-da-ngoai,184235684,"Xà Đơn Treo Tường gắn Cửa Đa Năng PEAFLO",125000,190000,65000,34
TIKI,the-thao-da-ngoai,118007668,"Áo bó giữ nhiệt áo body áo tập gym AKKA co dãn 4 chiều",80000,95000,15000,16
TIKI,the-thao-da-ngoai,16256787,"Bật lửa Zippo Armor High Polish Chrome 167",835000,835000,0,0
TIKI,the-thao-da-ngoai,95938909,"Phụ kiện thể thao Bendu Pk6001 băng gối chun bảo vệ đầu gối (1đôi)",221000,221000,0,0
TIKI,the-thao-da-ngoai,57703479,"Combo 2 kẹp bịt mũi kèm 4 cái bịt tai ngăn nước đi bơi Legaxi",37000,37000,0,0
TIKI,the-thao-da-ngoai,160409520,"Giày đá bóng Dagger đã khâu Full Đế size từ 38 đến 43",250000,250000,0,0
TIKI,the-thao-da-ngoai,46607075,"Lưỡi lăng xê - Bộ 4 lưỡi - Ảnh thật sản phẩm LC02",89000,89000,0,0
TIKI,the-thao-da-ngoai,49374148,"Cước câu cá chuyên dụng - Chất lượng siêu bền - Cước dài 500m  CCH04",179000,179000,0,0
TIKI,the-thao-da-ngoai,6625365,"Khung bóng rổ thi đấu - có kèm lưới",129000,129000,0,0
TIKI,the-thao-da-ngoai,57780501,"Đai lưng tập gym GoodFit GF721WS",219000,300000,81000,27
TIKI,the-thao-da-ngoai,56902119,"Dụng cụ tập thể dục cho lưng, bụng có dây kéo lò xo đơn REXCHI( Màu ngẫu nhiên)",75000,75000,0,0
TIKI,the-thao-da-ngoai,101642318,"Đèn cắm trại ngoài trời Desert&Fox G-85 Rechargeable camping lantern",220000,369000,149000,40
TIKI,the-thao-da-ngoai,16510019,"Nẹp Định Vị Một Tay Giúp Luyện Chơi Golf PGM - JZQ006",199000,225000,26000,12
TIKI,the-thao-da-ngoai,1747449,"Phao Tay Trẻ Em Roll-Ups",29000,52000,23000,44
TIKI,the-thao-da-ngoai,10650902,"Khung Bóng Rổ + Lưới",162000,329000,167000,51
TIKI,the-thao-da-ngoai,176435316,"Túi lưới đựng bóng chuyên nghiệp sợi dù đan (giao màu ngẫu nhiên)",59000,77000,18000,23
TIKI,the-thao-da-ngoai,160449809,"Kính bơi bé trai Zoggs Superman Character - 382437",495000,555000,60000,11
TIKI,the-thao-da-ngoai,114011202,"Đai Lưng Mềm Lục Giác Hỗ trợ tập Gym Bản To 19.5cm",255000,255000,0,0
TIKI,the-thao-da-ngoai,69511948,"Dây Nhảy Thể Dục Dài 2,9m  Có Thể Điều Chỉnh Được Độ Dài Của Dây Hàng Đủ Màu Siêu Bền Đẹp",24500,49000,24500,50
TIKI,the-thao-da-ngoai,103744213,"BĂNG CHẶN MỒ HÔI ĐẦU HEAD (285085) Giao màu ngẫu nhiên",149000,149000,0,0
TIKI,the-thao-da-ngoai,186932334,"Bình Nước Camelbak Podium Chill 21OZ (620ml)",299000,299000,0,0
TIKI,the-thao-da-ngoai,73871478,"Túi tập gym XBAGS XB 6003 cho nam và nữ Túi đựng đồ thể thao cao cấp (Có ngăn đựng giày riêng)",239000,390000,151000,39
TIKI,the-thao-da-ngoai,2852275,"Combo Vớ tập yoga + Bao tay chống trượt Sportslink",95000,126000,31000,25
TIKI,the-thao-da-ngoai,148177023,"[LOẠI TỐT - ĐỊNH TUYẾN] Thảm tập Yoga định tuyến TPE cao cấp tặng kèm túi đựng - chống trơn trượt thấm hút mồ hôi tốt chính hãng DODODIOS - Dây Buộc Chuyên Dụng Tập Yoga",196000,196000,0,0
TIKI,the-thao-da-ngoai,273180663,"Sữa tăng cơ BPI Sports Iso HD 100% Pure Isolate Protein 2.2kg",1345000,1345000,0,0
TIKI,the-thao-da-ngoai,52377020,"Đai Bảo Vệ Khủy Tay Tập GYM, Chơi Thể Thao Elbow Support Có Lò  Xo Chịu Lực Aolikes 7946 (1 Chiếc)",115000,115000,0,0
TIKI,the-thao-da-ngoai,131029527,"Đai Quấn Cổ Tay BONBONE WRIST BANDAGE Cố Định Cổ Tay Phòng Tránh Chấn Thương Trong Thể Thao",189000,220000,31000,14
TIKI,the-thao-da-ngoai,167422301,"Vỏ bao đấm boxing dây dù không ruột 6 tấc đến 1m2",109000,109000,0,0
TIKI,the-thao-da-ngoai,183579598,"Nẹp định vị cổ tay giúp tập chơi Golf – PGM JZQ010",320000,320000,0,0
TIKI,the-thao-da-ngoai,106791443,"Áo thun nam cổ tròn tay ngắn, chất thun lạnh mềm mát, thấm hút mồ hôi, thoải mái vận động – FORMEN SHOP – FMTY001",49000,149000,100000,67
TIKI,the-thao-da-ngoai,271736780,"Thực phẩm bổ sung Impact Casein Myprotein (Protein Casein) - Hỗ trợ tăng cơ suốt đêm ngủ dài - Nutrition Depot VN",920000,920000,0,0
TIKI,the-thao-da-ngoai,145626179,"Ghế tập tạ đa năng Xuki, Giàn tạ đa năng kéo xô Xuki (không kèm tạ)",1745000,1980000,235000,12
TIKI,the-thao-da-ngoai,183333358,"Máy Chạy Bộ Gập Gọn Có Điều Khiển Từ Xa,Có Tay Vịn HC3001 Chống Rung,Chống Ồn Đại Nam Sport",3291000,7500000,4209000,56
TIKI,the-thao-da-ngoai,35717946,"Găng tay nửa ngón tập gym, tập tạ Aolikes AL113B (1 đôi)",145000,145000,0,0
TIKI,the-thao-da-ngoai,10412016,"Bộ 2 Đai Quấn Đầu Gối Thể Thao AOLIKES YE-7912",273000,559000,286000,51
TIKI,the-thao-da-ngoai,13771045,"Phấn chống Mồ hôi tay Victor chính hãng",250000,250000,0,0
TIKI,the-thao-da-ngoai,4281325,"Giàn tạ đa năng DV-2014 - Tặng kèm bao tay",2402000,2790000,388000,14
TIKI,the-thao-da-ngoai,25068523,"Tất Vớ Bóng Đá Bảo Vệ Ống Đồng Kiểu Legging Thoáng Khí Football Leg Guard Plate Socks YE-7968",133000,239000,106000,44
TIKI,the-thao-da-ngoai,189177178,"Giày cầu lông chính hãng Kawasaki K367 mẫu mới dành cho nam và nữ có 2 màu lựa chọn-tặng tất thể thao bendu",1680000,1680000,0,0
TIKI,the-thao-da-ngoai,161458870,"Bộ 2 tạ tay nhựa bát giác 1kg REEFIT (2 tạ 1kg, tổng 2kg)",16000,16000,0,0
TIKI,the-thao-da-ngoai,159482532,"Bịt tai unisex Zoggs Silicone - 300650",155000,155000,0,0
TIKI,the-thao-da-ngoai,90951513,"Cần câu cá Daiwa Phantom Catfish Cần 2 khúc máy đứng 2m1, 2m4, 2m7, 3m0",665000,665000,0,0
TIKI,the-thao-da-ngoai,163717105,"Bó gối thể thao Băng bảo vệ đầu gối có đệm chống chấn thương chơi Đá Bóng Bóng rổ Tennis Bóng chuyền Gym Chạy bộ - Redikick",129000,169000,40000,24
TIKI,the-thao-da-ngoai,2282573,"Bộ 4 Bình Xăng Zippo (125ml)",380000,380000,0,0
TIKI,the-thao-da-ngoai,81609916,"Nón Bơi Silicone UNISEX SPEEDO",195000,195000,0,0
TIKI,the-thao-da-ngoai,59292929,"Bình nước thể thao thân tháo rời tiện lợi chất liệu nhựa Cleacco",138000,255000,117000,46
TIKI,the-thao-da-ngoai,193330051," Giày Bóng Đá Nam Biti's Hunter Football DSMH09600CAM (CAM)",573000,716000,143000,20
TIKI,the-thao-da-ngoai,17615770,"Thảm Yoga miDoctor Dày 6mm + Bao Thảm Yoga +Dây Buộc Thảm Yoga (Giao màu ngẫu nhiên)",109000,109000,0,0
TIKI,the-thao-da-ngoai,195701219,"Áo croptop tập Yoga Gym Hibi Sports có tay CR816 kiểu xoắn nơ, Kèm mút ngực",199000,360000,161000,45
TIKI,the-thao-da-ngoai,74177441,"Băng bảo vệ đầu gối Reebok Knee Support - RRSU-1332ㅌ",356000,445000,89000,20
TIKI,the-thao-da-ngoai,170125513,"MLB - Giày thể thao Bigball Chunky Monogram 3ASHCM11N",3490000,3490000,0,0
TIKI,the-thao-da-ngoai,183535386,"[Loại Cao Cấp] dây nhảy thể lực, dây nhảy đếm số tự động tính calo, dây nhảy boxing, dây nhảy không dây - Hãng DODODIOS",31000,31000,0,0
TIKI,the-thao-da-ngoai,88269489,"Bộ Dụng Cụ Giúp Luyện Tập Cơ Cổ Tay, Cơ Bắp Tay To Khoẻ Wrist Arm Trainer Cao Cấp",295000,295000,0,0
TIKI,the-thao-da-ngoai,197517572,"Ghế Gấp Gọn, Ghế Xếp Giã Ngoại- Du Lịch-Cắm trại-Câu cá-YZ002",210000,210000,0,0
TIKI,the-thao-da-ngoai,119911424,"Dây nhảy thể dục cho bé Agnite - Dây lõi bông, cán gỗ an toàn cho bé - Xanh da trời/ Hồng- Hàng chính hãng - 18702",119000,225000,106000,47
TIKI,the-thao-da-ngoai,144446121,"Iso HD 2,3kg 100% Isolate tinh khiết - Sữa bổ sung Protein, hỗ trợ phục hồi, tăng Cơ cho người tập thể thao",1549500,1549500,0,0
TIKI,the-thao-da-ngoai,145860863,"Giày tennis mẫu mới Giày JOGARBOLA dành cho nam chuyên nghiệp giày thể thao nam siêu bền",1050000,1050000,0,0
TIKI,the-thao-da-ngoai,2282577,"Bộ 3 Bình Xăng Zippo (125ml)",300000,300000,0,0
TIKI,the-thao-da-ngoai,50872986,"Whey Protein tăng cơ giảm mỡ Prostar 100% Ultimate Nutrition - Whey Isolate cao cấp hấp thụ protein (Hũ 907g)",810000,900000,90000,10
TIKI,the-thao-da-ngoai,146259778,"Găng tay thủ môn Zocker Gloves Edwin ZGK E01",569000,679000,110000,16
TIKI,the-thao-da-ngoai,172307441,"Áo thun thể thao nam cổ tròn LADOS - 9073 - Vải thun mát mẻ co giãn, thoải mái, mặc đi chơi, tập gym, dạo phố",189000,189000,0,0
TIKI,the-thao-da-ngoai,255430373,"[Chính hãng] Labrada | Muscle Mass Gainer (5.4kg) Sữa Tăng Cân Tăng Cơ Bổ Sung 1265 Calo, 52g Protein & Vitamin",1750000,1750000,0,0
TIKI,the-thao-da-ngoai,141299052,"Bóng Chuyền Da PU Gentra 4600 - Tặng bơm, kim bơm, túi lưới - Quả bóng chuyền tiêu chuẩn thi đấu",175000,194000,19000,10
TIKI,the-thao-da-ngoai,67320997,"Bó gối thể thao, băng đầu gối đệm silicone, co giãn 4 chiều, thanh trợ lực lò xo GoodFit GF513K",110000,220000,110000,50
TIKI,the-thao-da-ngoai,70661377,"Bộ 2 Đòn Tạ Tay 35cm Bọc Cao Su Cao Cấp Đại Nam Sport",250000,500000,250000,50
TIKI,the-thao-da-ngoai,257861645,"Ghế tập bụng cong muse - Ghế Tập cơ Bụng, Máy tập bụng, Ghế tập lực , máy gập cơ bụng (hàng nhập khẩu)",555000,1040000,485000,47
TIKI,the-thao-da-ngoai,11559751,"[Hình Thật] Túi Ngủ Cao Cấp Văn Phòng + Đi Phượt Galaxy Store GSTN03 (Hàng Xuất Khẩu)",248000,450000,202000,45
TIKI,the-thao-da-ngoai,66164751,"Dây kéo đàn hồi 4 ống cao su tập thể dục REXCHI ( Màu Ngẫu Nhiên )- Hàng chính hãng",99000,99000,0,0
TIKI,the-thao-da-ngoai,72646135,"Giày bóng rổ PEAK Basketball DA920231",849000,1090000,241000,22
TIKI,the-thao-da-ngoai,102154941,"Thảm Tập Yoga TPE 2 Lớp PEAFLO Cao Cấp dày 6mm Kèm Túi",125000,125000,0,0
TIKI,the-thao-da-ngoai,109296346,"VỢT CẦU LÔNG PROKENNEX THUNDER 7003 CHẤT LƯỢNG CHÍNH HÃNG ĐÃ ĐAN LƯỚI TRỢ LỰC (1 cây) - Tặng kèm quấn cán",804000,1098000,294000,27
TIKI,the-thao-da-ngoai,80322921,"Thực phẩm bổ sung gia tăng sức bền và phục hồi cơ Myprotein Impact BCAA 250g – Nutrition Depot Vietnam",450000,470000,20000,4
TIKI,the-thao-da-ngoai,35544990,"Thảm Tập Yoga 2 Lớp 6mm + Gạch Tập Yoga + Bao Đựng Thảm Tập Yoga + Dây Thảm Tập Yoga miDoctor (màu ngẫu nhiên)",155000,155000,0,0
TIKI,the-thao-da-ngoai,192926552,"Băng quấn bảo vệ đầu gối AOLIKES A-1516 Sport Knee Protector",85000,159000,74000,47
TIKI,the-thao-da-ngoai,175775340,"Bộ Tạ Tay Điều Chỉnh Khóa Số Tự Động 24kg Cao Cấp TP Tienphatsmart",2099000,4198000,2099000,50
TIKI,the-thao-da-ngoai,103870517,"Giày Thể Thao Cao Cấp Nữ Biti's Hunter Layered Upper DSWH02800DEN (Đen)",831000,902000,71000,8
TIKI,the-thao-da-ngoai,46689768,"Vợt vớt cá -  Chất liệu inox cao cấp VVC01",129000,129000,0,0
TIKI,the-thao-da-ngoai,176079507,"Bình nước thể thao Kita Active, Bình nước Kita Fami, Bình nước Kita Slim - Chính hãng INOCHI",79500,79500,0,0
TIKI,the-thao-da-ngoai,188458594,"Gậy Trekking Leo Núi Gấp Gọn Naturehike NH17D001-Z",198000,198000,0,0
TIKI,the-thao-da-ngoai,6532091,"Thanh Whey Protein Hammer Bar - Cung cấp đầy đủ Protein và dinh dưỡng thay thế bữa ăn khi luyện tập, thi đấu (Thanh 50g)",780000,780000,0,0
TIKI,the-thao-da-ngoai,158902907,"Võng Đôi Dã Ngoại Siêu Nhẹ Chống Lật Naturehike NH21DC011",350000,350000,0,0
TIKI,the-thao-da-ngoai,75636087,"2 Hộp TENDOACTIVE - Thực phẩm Bảo vệ sức khỏe gân & dây chằng",765800,765800,0,0
TIKI,the-thao-da-ngoai,5885625,"Miếng đệm hỗ trợ bảo vệ đầu gối khi đá bóng, bóng chuyền, đi xe đạp AOLIKES TC-0217",172000,269000,97000,36
TIKI,the-thao-da-ngoai,135202423,"[LOẠI XỊN TRẦN BÔNG] (FREE SHIP) Túi ngủ văn phòng du lịch cao cấp có trùm đầu - Chính hãng Amalife",186000,186000,0,0
TIKI,the-thao-da-ngoai,185710016,"Huy chương thể thao chất lượng giá rẻ",20000,20000,0,0
TIKI,the-thao-da-ngoai,196155333,"Set đồ tập yoga gym Hibi Sports H152 áo bra phối V, lưng xoắn nơ, kèm mút ngực",496000,620000,124000,20
TIKI,the-thao-da-ngoai,42825377,"Quần bơi nam Boxer YESURE SOC Chất liệu polyester Spandex cao cấp , chống thấm , nhanh khô form Fitness thời trang (Tặng kèm nón bơi + bịt tai silicon)",139000,228000,89000,39
TIKI,the-thao-da-ngoai,173276837,"Giày Thể Thao Nam Biti's Hunter Core 3D-Airmesh Black DSMH08700DEN (Đen)",736000,736000,0,0
TIKI,the-thao-da-ngoai,8271204,"Máy chạy bộ tại chỗ Mini Stepper BG Máy Chạy Bộ Điện Gia Đình Nhỏ Gọn Màn Hình Điện Tử (hàng nhập khẩu)",675000,1199000,524000,44
TIKI,the-thao-da-ngoai,202413356,"Vợt cầu lông LIGHTSPORT GY-GUANGYU Khung Carbon Căng Cước Sẵn - Màu Đen",399000,399000,0,0
TIKI,the-thao-da-ngoai,118007740,"Giày đá bóng nam giày đá banh chính hãng AKKA SPEED 2",690000,690000,0,0
TIKI,the-thao-da-ngoai,57691365,"Xe đạp thể thao, máy đạp xe, xe đạp tập thể dục tại nhà GoodFit tùy chỉnh độ nặng, đồng hồ điện tử đo lường vòng đạp GF001PA",696000,1200000,504000,42
TIKI,the-thao-da-ngoai,6475717,"Bật Lửa Zippo Black Ice (Dark Chrome) With Zippo Logo 150ZL",990000,990000,0,0
TIKI,the-thao-da-ngoai,93924519,"GIÀY TENNIS CHÍ PHÈO CAO CẤP SIÊU ĐẸP,SIÊU ÊM",430000,430000,0,0
TIKI,the-thao-da-ngoai,1599417,"Giàn Xà Đơn,Xà Kép Thiết Bị Tập Luyện Máy Tập Tổng Hợp Tay Vai Bụng BG DB-001 CHIN- Đen (hàng nhập khẩu)",1798000,2999000,1201000,40
TIKI,the-thao-da-ngoai,275135948,"Bình Nước Xtend - Bình Lắc C4 - Hàng Cao Cấp",174000,250000,76000,30
TIKI,the-thao-da-ngoai,113737638,"Xà Đơn Gắn Cửa ,Treo Tường Cải Tiến mới + Có Nivo cân bằng xà(Mẫu Đầu Vuông Siêu To)- 022",259000,518000,259000,50
TIKI,the-thao-da-ngoai,33260595,"Thảm Yoga Training Fitness Adidas 10mm",1309000,1350000,41000,3
TIKI,the-thao-da-ngoai,193610017,"Giày Thể Thao Nữ Biti's Hunter Core DSWH09400DEN (Đen)",636000,794000,158000,20
TIKI,the-thao-da-ngoai,48583619,"Giày lội nước dã ngoại chống trượt PAN Goinglink M-1888",383000,383000,0,0
TIKI,the-thao-da-ngoai,161912607,"Tạ Tay Nhựa 10kg Bát Giác REEFIT (1 cái)",80000,80000,0,0
TIKI,the-thao-da-ngoai,41823253,"Gậy Bóng Chày Hợp Kim miDoctor – Chọn Size - Kèm Túi Đựng gậy Bóng Chày – Màu Ngẫu Nhiên",200000,200000,0,0
TIKI,the-thao-da-ngoai,33789344,"Bộ Ván trượt mặt nhám cỡ nhỏ trẻ em + Kèm bộ bảo hộ (Giao màu ngẫu nhiên)",226000,400000,174000,44
TIKI,the-thao-da-ngoai,107034349,"Vòng treo gỗ Gymnastic Rings Cleacco có vạch kẻ số , khóa cài thông minh tiện lợi , chắc chắn treo xà đơn , các bài tập dip rings , street workout , bảo hành 12 tháng - BORO SPORT",598000,799000,201000,25
TIKI,the-thao-da-ngoai,76753500,"Bảng Dụng Cụ Tập Hít Đất , Tập Chống Đẩy Theo Màu Sắc, Mỗi Màu Sắc Sẽ Tương Ứng Với Bài Tập Khác Nhau Thiết Kế Dày Nhiều Bài Tập - Hàng Chính Hãng BORO SPORT",389000,389000,0,0
TIKI,the-thao-da-ngoai,69307352,"Quần short nam thể thao đồ gym thun cotton 4 chiều, quần đùi nam mặc nhà thể thao cao cấp ShopN6 - QSB2 (Nhiều Màu)",59000,105000,46000,44
TIKI,the-thao-da-ngoai,194864438,"[Chính hãng] OstroVit BCAA Instant (400g) Hỗ trợ phục hồi - Chống dị hóa - Giảm đau nhứt cơ",399000,399000,0,0
TIKI,the-thao-da-ngoai,823454,"Cặp Vợt Cầu Lông AAA VA21",179000,179000,0,0
TIKI,the-thao-da-ngoai,153586369,"Quần Bơi Nữ Black Short Woman",212500,250000,37500,15
TIKI,the-thao-da-ngoai,91750863,"Máy Chạy Bộ,Máy Đi Bộ Trên Không Cỡ Lớn DNS008 Đại Nam Sport Chịu Lực 150kg Hàng Việt Nam Chất Lượng Cao",1093000,2000000,907000,45
TIKI,the-thao-da-ngoai,67240015,"Bộ Dây Cao Su Đàn Hồi Ngũ Sắc Tập Gym Tại Nhà Móc To (Tặng kèm Kìm Bóp Cơ Tay) Bộ Dây Kháng Lực Tập Thể Hình Ngẫu Nhiên Dành Cho Mọi Đối Tượng Dễ Dàng Sử Dụng Có Hướng Dẫn Đi Kèm",104500,209000,104500,50
TIKI,the-thao-da-ngoai,8582344,"Bộ 2 tạ nhựa tay 10kg",170000,170000,0,0
TIKI,the-thao-da-ngoai,2282609,"Bộ Đá Và Bấc Cho Bật Lửa Zippo",90000,90000,0,0
TIKI,the-thao-da-ngoai,52247278,"Áo tập Yoga Gym croptop 2 dây đan chéo Hibi Sports Mã CR806 có mút nâng ngực bên trong",182000,260000,78000,30
TIKI,the-thao-da-ngoai,103209960,"[TẶNG 3 CẦU + QUẤN CÁN] Vợt cầu lông siêu nhẹ Agnite tặng kèm hộp cầu và túi đựng vợt - 2 chiếc - F2136",229000,466200,237200,51
TIKI,the-thao-da-ngoai,195766336,"Giày Thể Thao Nam Biti's DSM075033TRG (Trắng)",612000,765000,153000,20
TIKI,the-thao-da-ngoai,74227688,"Bg Xe đạp tập thể dục trong nhà Mẫu YS02 RED mới 2021 (hàng nhập khẩu)",964000,1588000,624000,39
TIKI,the-thao-da-ngoai,103209804,"Vợt Cầu Lông Cán Liền Chính Hãng Agnite - Khung Carbon Cao Cấp - Kèm Túi Đựng Vợt - F2115",359000,790200,431200,55
TIKI,the-thao-da-ngoai,56332095,"Quần Đùi Gym Nam 2 Lớp - Lót Quần Legging, Quần Short Thể Thao, Quần Legging Nam Liền Quần Đùi Tập Gym Nam SZone SQ516",139000,139000,0,0
TIKI,the-thao-da-ngoai,179445531,"Túi đeo bụng, đai đeo điện thoại chạy bộ chính hãng Goodfit GF10X chống nước, phản quang, sức chứa lớn",116000,199000,83000,42
TIKI,the-thao-da-ngoai,52153257,"Tạ bánh, tạ miếng Nhựa Sportslink",24000,25000,1000,4
TIKI,the-thao-da-ngoai,163332350,"Gold Standard 100% Whey On 10lbs (4.54Kg) - Sữa Bổ Sung Protein Hỗ Trợ Tăng Cơ Optimum Nutrition",2920000,2920000,0,0
TIKI,the-thao-da-ngoai,97096149,"BỘ 4 DÂY KHÁNG LỰC TẬP MÔNG ĐÙI, DÂY MINIBAND TẬP GYM, FITNESS, YOGA, PILATES - HÀNH CHÍNH HÃNG ",45000,90000,45000,50
TIKI,the-thao-da-ngoai,120461140,"Bộ Tạ Tay Điều Chỉnh Đa Năng 4 IN 1 FED Tạ Gang Mã Niken loại 20kg---  hàng chính hãng",2480000,2480000,0,0
TIKI,the-thao-da-ngoai,193003854,"Máy Chạy Bộ Điện Tại Nhà Zasami KZ-CX1",6176000,9500000,3324000,35
TIKI,the-thao-da-ngoai,104109744,"Thiết Bị Phục Hồi Chức Năng Zasami KZ cải tiến có đai giữ cố định người bệnh 4 trong 1",3190000,4090000,900000,22
TIKI,the-thao-da-ngoai,57512141,"Máy câu cá Daiwa Strikeforce 2000",360000,360000,0,0
TIKI,the-thao-da-ngoai,161368191,"Vỏ tạ tay nhựa bát giác 5kg REEFIT (1 VỎ)",27000,27000,0,0
TIKI,the-thao-da-ngoai,273868091,"Sữa Tăng Cân Labrada Muscle Mass Gainer 12Lbs (5.4kg) - Labrada USA",1595000,1920000,325000,17
TIKI,the-thao-da-ngoai,655755,"Vớ Tập Yoga Chống Trượt Sportslink VOYOGA-XAM",54000,113000,59000,52
TIKI,the-thao-da-ngoai,21154902,"Nẹp bảo vệ ống đồng bóng đá các CLB - Giao mẫu mẫu nhiên (Free size)",57000,59000,2000,3
TIKI,the-thao-da-ngoai,14185418,"Xà đơn treo tường đa năng Đại Nam Sport DNS P90X - Kèm găng tay tập xà",308000,550000,242000,44
TIKI,the-thao-da-ngoai,49053197,"Lều Phượt Cắm Trại Du Lịch 4 Người Cao Cấp Galaxy Store Tetragon 4P-LE04 - Hàng Xuất Khẩu Châu Âu Loại 1",1500000,1500000,0,0
TIKI,the-thao-da-ngoai,36960619,"Bao Cát Đấm Bốc Nhồi Sẵn Đại Nam Sport Cao Cấp - Đủ Kích Thước (Màu Ngẫu Nhiên)",259000,700000,441000,63
TIKI,the-thao-da-ngoai,34672302,"Thảm Tập Yoga Siêu Mỏng 1.5mm - Manduka",1736000,1790000,54000,3
TIKI,the-thao-da-ngoai,164501976,"Máy Chạy Bộ Nhỏ Gọn Horizon TR3.0",12600000,18000000,5400000,30
TIKI,the-thao-da-ngoai,185981931,"Xô Nước Dã Ngoại Đa Năng Gấp Gọn Naturehike NH20SJ040",136000,136000,0,0
TIKI,the-thao-da-ngoai,45302993,"Bộ cần câu cá - cần câu kèm máy 4000 - Tặng kèm nhiều phụ kiện BCC02",289000,289000,0,0
TIKI,the-thao-da-ngoai,684736,"Combo 5 Khăn Đa Năng Sportslink Đi Phượt Sành Điệu ",53000,99000,46000,46
TIKI,the-thao-da-ngoai,123930474,"Dây nhảy thể dục siêu nhẹ, dây nhảy thể lực, thể thao GoodFit nhựa PVC bền bỉ, độ dài 3m tùy chỉnh Goodfit GF902JR",37000,69000,32000,46
TIKI,the-thao-da-ngoai,37933915,"Dụng Cụ Chống Đẩy Hít Đất, Chống Đẩy 9 in 1 Hướng Dẫn Luyện Tập Hít Đất Tại Nhà, Chống Đẩy Đúng Cách- Hàng Chính Hãng",97000,97000,0,0
TIKI,the-thao-da-ngoai,112067421,"Võng Dã Ngoại Siêu Nhẹ Naturehike NH17D012-C",419000,419000,0,0
TIKI,the-thao-da-ngoai,102391762,"Túi ngủ du lịch cắm trại dã ngoại Desert&Fox DF-S002 Ultralight Sleeping bags",325000,509000,184000,36
TIKI,the-thao-da-ngoai,155219849,"Ghế Xếp Gấp Gọn Ngồi Thư Giãn Dễ Mang Theo Đi Câu Và Dã Ngoại - Hàng Chính Hãng",544000,604000,60000,10
TIKI,the-thao-da-ngoai,73788584,"Bàn Dã Ngoại Gấp Gọn HỢP KIM NHÔM Naturehike NH19Z008-Z Siêu Nhẹ  Size Lớn",680000,680000,0,0
TIKI,the-thao-da-ngoai,76161211,"Băng Bảo Vệ Khớp Gối GFHX036 Glofit 2.0 Pro ( Knee Brace Glofit 2.0 Pro ) (1 Chiếc)",290000,390000,100000,26
TIKI,the-thao-da-ngoai,176079790,"Bình nước thể thao Kita Active 500ml - Bình Nước Du Lịch, Dã Ngoại - Bình Thể Thao Tập Gym Kita Active INOCHI",101400,101400,0,0
TIKI,the-thao-da-ngoai,68261565,"Bộ cần câu - Cần hutter Man cao cấp - Máy kim loại AR 5000 - Tặng kèm nhiều phụ kiện BCC5",549000,549000,0,0
TIKI,the-thao-da-ngoai,40348461,"Dây nhảy Aolikes AL3202 tặng kèm túi",115000,115000,0,0
TIKI,the-thao-da-ngoai,173891041,"Sữa tăng cơ Wheylabs Pro Standard Isolate Protein Hộp 2.27 kg (81 lần dùng) - Nutrition Depot",1590000,1790000,200000,11
TIKI,the-thao-da-ngoai,76450620,"Quần Gym Yoga Form Lửng Tạo Dáng Mông Đào Cleacco , Chất Liệu Co Giãn 4 Chiều , Thoải Mái , Dáng Đẹp - Hàng Chính Hãng BORO SPORT",147000,255000,108000,42
TIKI,the-thao-da-ngoai,58138078,"Kính bơi chống sương mù cho nữ View V820ASA - Hàng chính hãng",410000,715000,305000,43
TIKI,the-thao-da-ngoai,51398700,"Ruột Zippo Gas Butane Một Tia Lửa – Butane Lighter Insert Single Torch 65826",510000,510000,0,0
TIKI,the-thao-da-ngoai,109947268,"THẢM TẬP GYM, YOGA ADIDAS 8MM ADYG-10100 (TẶNG TÚI ĐỰNG THẢM)",745000,769000,24000,3
TIKI,the-thao-da-ngoai,166307753,"Cầu đá ống da cá HD111 Sportslink",17000,23000,6000,26
TIKI,the-thao-da-ngoai,137612106,"Thùng bóng tennis Wilson đỏ Championship 4 quả",3399000,3690000,291000,8
TIKI,the-thao-da-ngoai,135329450,"Platinum Hydro Whey 3.5lbs Dòng Whey Hydrolyzed Tinh Khiết Chính Hãng ON",1579000,1579000,0,0
TIKI,the-thao-da-ngoai,146996416,"Combo Dụng Cụ Hít Đất Cầm Tay Và Dây Nhảy Lõi Thép Có Thể Điều Chỉnh Dộ Dài Chống Rối – Bộ Dụng Cụ Chống Đẩy Kèm Dây Nhảy Lõi Thép Tập Gym Tập Thể Thao Cao Cấp Chính Hãng Dododios",151000,151000,0,0
TIKI,the-thao-da-ngoai,116664988,"Giày cầu lông Mira Lightning 19.1 Xanh Dương thể thao nam nữ chính hãng chất lượng- LI001",525000,525000,0,0
TIKI,the-thao-da-ngoai,194185467,"Giày Thể Thao Nam Biti's Hunter Core DSMH09900DEN",628000,785000,157000,20
TIKI,the-thao-da-ngoai,13884757,"Đai Miếng Đệm Đầu Gối Hỗ Trợ Bảo vệ Xương Bánh Chè, Giảm Đau Cho Khớp Gối Sport Damping Patella Belt AOLIKES YE-7919",85000,159000,74000,47
TIKI,the-thao-da-ngoai,137940505,"Kìm Bóp Tập Lực Tay Chữ A Bọc Xốp Tập Cơ, Ngón Tay Hiệu Quả KitAcoom Hàng Nhập Khẩu Chính Hãng  (Màu Ngẫu Nhiên)",83699,89999,6300,7
TIKI,the-thao-da-ngoai,12505834,"Bộ quần áo mưa Givi RRS06",779000,779000,0,0
TIKI,the-thao-da-ngoai,186209993,"Giày cầu lông Lining Thunder Lite chính hãng AYTS020-3 mẫu mới dành cho nam màu đỏ-tặng tất thể thao bendu",1350000,1350000,0,0
TIKI,the-thao-da-ngoai,20501021,"Bộ Vành bóng rổ + Quả bóng rổ (Kèm kim bơm và lưới)",212000,469000,257000,55
TIKI,the-thao-da-ngoai,53034472,"Dây cước câu cá Nhật Daiwa Justron (Giao màu ngẫu nhiên)",185000,185000,0,0
TIKI,the-thao-da-ngoai,86994990,"Găng Tay Chạy Xe Đạp Chuyên Nghiệp - GO GLOFIT, Dòng Găng Tay Cao Cấp Đa Năng Chính Hãng Glofit (1 Đôi)",350000,490000,140000,29
TIKI,the-thao-da-ngoai,197407221,"Ghế Picnic Dã Ngoại Gấp Gọn SUMIKA K39, Thiết Kế Tựa Lưng, Vải Oxford - Màu Đen",560000,560000,0,0
TIKI,the-thao-da-ngoai,49941680,"Combo Giày Patin Cougar 835LSG (4 Màu)",809000,809000,0,0
TIKI,the-thao-da-ngoai,104902506,"Xe Đẩy Dã Ngoại Gấp Gọn 90L NatureHike NH19PJ001",1780000,1780000,0,0
TIKI,the-thao-da-ngoai,102084018,"BÓNG ĐÁ FUTSAL MOLTEN TIÊU CHUẨN F9A1510-A",599000,599000,0,0
TIKI,the-thao-da-ngoai,57707239,"Quần Tập Gym Nam 2 Lớp Kết  Hợp Legging Chuyên Nghiệp - Quần Bóng Rổ - Quần Thể Thao Nam SZone SQ517",159000,159000,0,0
TIKI,the-thao-da-ngoai,93145574,"Quấn Cán Ngoài Vợt Tennis,  cầu lông Toalson Neo Quick X3 (Giao màu ngẫu nhiên)",139000,145000,6000,4
TIKI,the-thao-da-ngoai,158622142,"Ghế Xếp Thư Giãn Đi Câu, Ghế Gấp Dã Ngoại Và Du Lịch Cắm Trại Picnic Cùng Gia Đình - Hàng Chính Hãng",224000,249000,25000,10
TIKI,the-thao-da-ngoai,4189097,"Đèn Pin Đội Đầu Điện Quang ĐQ PFL12 (Pin Sạc 1W)",118939,148700,29761,20
TIKI,the-thao-da-ngoai,184640932,"Bóng rổ cao su Zocker số 3 - Bóng Rổ Trẻ Em Chính Hãng - Giá Rẻ - Bảo Hành 3 Tháng",114000,159000,45000,28
TIKI,the-thao-da-ngoai,144405053,"Băng Cuốn Cổ Chân Aolikes A-1527 | Đai Quấn Bảo Vệ Mắc Cá Chân Cao Cấp Chính Hãng",75000,75000,0,0
TIKI,the-thao-da-ngoai,84881216,"Quần bơi chống nắng nam SPEEDO - SOJ20021-BKWH",350000,875000,525000,60
TIKI,the-thao-da-ngoai,128544957,"Bộ 5 Dây Đa Năng Ngũ Sắc Đàn Hồi Kháng Lực Tập Gym , Fitness , Yoga, Rèn Luyện Sức Khoẻ Cho Nam Nữ  - Chất Lượng Hàng Loại 1- Hàng Chính Hãng MINIIN",114000,114000,0,0
TIKI,the-thao-da-ngoai,164222934,"Máy Tập Bụng Đa Năng Tích Hợp Máy Đi Bộ Đếm Bước Trên Không Đại Nam Sport",1028000,2000000,972000,49
TIKI,the-thao-da-ngoai,975182,"Sữa Tăng Cân Vị Chocolate Mass Muscle Gainer Vị  Elite Labs SMEL103 (9.09kg)",2900000,2900000,0,0
TIKI,the-thao-da-ngoai,53522506,"Bóng đá Molten F5A4900",1790000,1790000,0,0
TIKI,the-thao-da-ngoai,189474105,"Khăn rằn Campuchia/ khăn đi phượt Nomac du lịch, trekking - Hàng loại 1 vải dày- mềm -mịn kích thước lớn 170x60cm",48000,85000,37000,44
TIKI,the-thao-da-ngoai,8047964,"Sàn nhún, Đệm nhún lò xo BG Trampoline cao cấp Thái Lan (màu ngẫu nhiên) (hàng nhập khẩu)",746000,1348500,602500,45
TIKI,the-thao-da-ngoai,13891977,"Quấn Bảo Vệ Hỗ Trợ Khớp Cổ Tay Nam Nữ Khi Chơi Thể Thao Sport Pressure Wrist AOLIKES YE-7936",66000,119000,53000,45
TIKI,the-thao-da-ngoai,35147986,"Bộ Kính Bơi View V610 Và Nút Bơi Nhét Tai EP405 - Hàng Chính Hãng",388000,675000,287000,43
TIKI,the-thao-da-ngoai,72457656,"Xà Đơn Treo Tường Gắn Cửa Đỏ Đen Không Cần Bắt Vít Chịu Lực 150kg + Kèm Găng Tay Tập Xà",123000,250000,127000,51
TIKI,the-thao-da-ngoai,190864561,"Kính bơi người lớn nam nữ cao cấp, mắt kính bơi chính hãng dododios - D2030 - Kính bơi chống nước, chống mờ, chống tia UV Tặng kèm hộp đựng",92000,92000,0,0
TIKI,the-thao-da-ngoai,125448524,"Đai bảo vệ đầu gối chạy bộ AOLIKES YE-7901 thiết kế kiểu Nhật Bản Knee Support Braces",183000,299000,116000,39
TIKI,the-thao-da-ngoai,54893440,"Cần câu cá carrbon  Huntes Man - Kèm máy kim loại JX 4000 cao cấp - Tặng kèm 9 phụ kiện 003",279000,279000,0,0
TIKI,the-thao-da-ngoai,57774328,"Đai bảo vệ khớp vai, bảo vệ vai phòng tránh chấn thương GoodFit phục hồi chức năng vai GF701S",164000,250000,86000,34
TIKI,the-thao-da-ngoai,170694271,"XÀ ĐƠN ,XÀ KÉP GẮN TƯỜNG ĐA NĂNG [CÓ THANH NGANG + 6 TAY NẮM ] ,TẬP GYM , TREO BAO CÁT TẠI NHÀ SIÊU CHẮC",349000,698000,349000,50
TIKI,the-thao-da-ngoai,51300030,"Ruột Zippo Gas Butane - Hai Tia Lửa 65827",585000,585000,0,0
TIKI,the-thao-da-ngoai,176709410,"Combo 3 Dụng Cụ Hỗ Trợ Tập Yoga - 2 Gạch Tập Yoga Trơn, Không Họa Tiết + 1 Dây Đai Tập Yoga Sợi Cotton",99000,198000,99000,50
TIKI,the-thao-da-ngoai,61349261,"Máy câu cá DS - Kim loại cao cấp  - Tặng kèm cước - MC04",269000,269000,0,0
TIKI,the-thao-da-ngoai,7664831,"Giày Patin Cougar 835L",699000,699000,0,0
TIKI,the-thao-da-ngoai,35813239,"Băng Cổ Chân ADIDAS",245000,253000,8000,3
TIKI,the-thao-da-ngoai,111199067,"Mega Mass Pro 1350 12lbs (5.4kg) VitaXtrong Sữa Hỗ Trợ Tăng Cân Từ USA",1350000,1350000,0,0
TIKI,the-thao-da-ngoai,186105012,"Ghế Xếp Ngả Lưng Naturehike NH17T003-Y Điều Chỉnh Khung Nhôm",1890000,1890000,0,0
TIKI,the-thao-da-ngoai,51398698,"Ruột Zippo Tia Lửa Điện Plasma 65828",740000,740000,0,0
TIKI,the-thao-da-ngoai,639377,"Kính Bơi Trẻ Em Sportslink Balance KBBALANCE-DE",70000,73000,3000,4
TIKI,the-thao-da-ngoai,203897935,"Bộ Băng Quấn Bảo Vệ Cổ Tay Cleacco Street Workout Wrist Wraps , Tập gym , Thể dục dụng cụ , Yoga , thiết kế quấn đặc biệt giúp cổ tay linh hoạt , giảm chấn thương – Hàng chính hãng .BORO SPORT - Đen",64000,134000,70000,52
TIKI,the-thao-da-ngoai,110816328,"Vòng Lắc Eo Massage  Giảm Béo Cao Cấp Hàng Chính Hãng",159000,159000,0,0
TIKI,the-thao-da-ngoai,150331925,"Túi Đeo Hông Chạy Bộ, Đạp Xe, Dã Ngoại VNSPORT - VN3808, Túi Cao Cấp Chống Thấm Nước , Có 3 Ngăn Riêng Biệt Và Có Phản Quang, Thể Thao Và Rất Đẹp Cho Cả Nam Và Nữ",150000,250000,100000,40
TIKI,the-thao-da-ngoai,5056931,"Đai Lưng Gánh Tạ Tập Gym AOLIKES TC-7983",165000,165000,0,0
TIKI,the-thao-da-ngoai,36102514,"Băng Bảo Vệ Gối Tập GYM Aolikes Knee Pads A-7616 (1 Chiếc)",95000,95000,0,0
TIKI,the-thao-da-ngoai,141759193,"LƯỚI KHUNG VÀNH BÓNG RỔ CAO CẤP",24000,40000,16000,40
TIKI,the-thao-da-ngoai,86146474,"Bật Lửa Zippo Armor 169 Khắc Thiên Thần Và Đôi Cánh 5 Mặt – Zippo 169.Thienthan",1450000,1450000,0,0
TIKI,the-thao-da-ngoai,160748205,"Giày Chạy Bộ Nam Biti's Hunter Running BLACK DSMH08300DEN (Đen)",981000,981000,0,0
TIKI,the-thao-da-ngoai,172538203,"Con lăn Yoga Massage Bắp Tay, Bắp Chân Thư Giãn Cơ Và Giảm Mỡ Thừa Cho Cơ Thể",125000,125000,0,0
TIKI,the-thao-da-ngoai,114010908,"Quấn gối tập Gym Bảo vệ gối thể thao bản dài 1.8m",119000,119000,0,0
TIKI,the-thao-da-ngoai,172538194,"Con Lăn Tập Cơ Bụng 4 Bánh AB DOMINAL WHEEL Cao Cấp Tặng Kèm Thảm Lót",115000,115000,0,0
TIKI,the-thao-da-ngoai,66898443,"Ghế tập bụng đa năng gấp gọn Gymlink Pro-888",1198000,1198000,0,0
TIKI,the-thao-da-ngoai,86919830,"COMBO 6 HỘP BÓNG TENNIS CHAMPIONSHIP (HỘP 4 TRÁI)",1199000,1290000,91000,7
TIKI,the-thao-da-ngoai,33526828,"Dây câu, Cước câu cá SHIMANO 100m, Cước Nhật",49000,49000,0,0
TIKI,the-thao-da-ngoai,167526214,"Bó Gối Thể Thao Aolikes Kneepad Có Lò Xo Trợ Lực Và Dây Quấn Cố Định (1 Chiếc)",205000,205000,0,0
TIKI,the-thao-da-ngoai,76826930,"Cần câu cá Daiwa Crossfire, cần lure máy đứng 1m98 - 2m14",485000,485000,0,0
TIKI,the-thao-da-ngoai,175647502,"Dụng Cụ Bẻ Cổ Tay Hỗ Trợ Rèn Luyện Cơ Tay,Bắp Tay ,Hàng Đẹp Giá Tốt ,Lực Tập 25-30kg",69000,138000,69000,50
TIKI,the-thao-da-ngoai,22197509,"Áo Thể Thao Nữ COMET TEE W / FLOW URBAN CHIC L",920000,920000,0,0
TIKI,the-thao-da-ngoai,193515255,"Ghế Ngồi Câu Cá Xếp Gọn Ghế Dã Ngoại Picnic Du Lịch Cắm Trại Ngoài Trời Có Thể Gấp Gọn Kèm Túi Đựng Agnite - Nhiều màu sắc kích cỡ - VS901 VS902",149000,304200,155200,51
TIKI,the-thao-da-ngoai,4935927,"Bộ 2 tạ tay cao cấp Tập Gym BG 4kg",344000,799000,455000,57
TIKI,the-thao-da-ngoai,84992258,"Đai lưng tập thể hình cho Gymer Adidas ADGB-1225",690000,852000,162000,19
TIKI,the-thao-da-ngoai,47141169,"BÓNG TẬP GOLF THÔNG MINH - PGM GOLF SMART INFLATABLE BALL - JZQ012",236000,285000,49000,17
TIKI,the-thao-da-ngoai,185347015,"Giảm rung Babolat Flash Vibration - Vỉ X2 (700117)",174000,199000,25000,13
TIKI,the-thao-da-ngoai,54006084,"Bóng đá Molten F5A3555-K số 5",999000,999000,0,0
TIKI,the-thao-da-ngoai,117597571,"Xà đơn đa năng Pro Fitness Hanwei 881 điều chỉnh chiều cao",1680000,1750000,70000,4
TIKI,the-thao-da-ngoai,23731052,"Vợt Cầu Lông VS 7200 BLADE - Tặng kèm cước + quấn cán vợt -đen pha xanh",575000,899000,324000,36
TIKI,the-thao-da-ngoai,88822391,"Lều 4 Người Phượt Cắm Trại Du Lịch Dã Ngoại Cao Cấp Galaxy Store GSL05 Tetragon 4P - Hàng Chính Hãng (Màu Ngẫu Nhiên) Kèm Quà Tặng",876000,1450000,574000,40
TIKI,the-thao-da-ngoai,74227734,"Bg Xe đạp tập thể dục trong nhà Mẫu YS02 BLUE mới 2021 (hàng nhập khẩu)",898000,1599000,701000,44
TIKI,the-thao-da-ngoai,175467286,"Áo thun tay ngắn thể thao nam Under Armour Project Rock Training Dept - 1367123",795000,1135000,340000,30
TIKI,the-thao-da-ngoai,72870048,"Bóng tập Yoga Nửa Gai + Nửa Trơn 3D -75cm Cao Cấp – Tặng kèm bơm( Hàng Cao Cấp Chính hãng)",129000,258000,129000,50
TIKI,the-thao-da-ngoai,184592597,"Nẹp định vị hai tay hỗ trợ tập chơi Golf – PGM JZQ005",320000,320000,0,0
TIKI,the-thao-da-ngoai,133250545,"Phụ kiện đầu chuyển bình gas mini ipb adapter Campingmoon Z13M",210000,210000,0,0
TIKI,the-thao-da-ngoai,923109,"Găng Tay Tập Gym Có Cuốn Đại Việt Sport PKDV-GT007 (Size",140000,275000,135000,49
TIKI,the-thao-da-ngoai,24837007,"Võ phục Karate Taburo phong trào loại đẹp",295000,295000,0,0
TIKI,the-thao-da-ngoai,66089888,"Giày cầu lông, bóng bàn, bóng chuyền nam nữ mẫu mới 2020",297000,297000,0,0
TIKI,the-thao-da-ngoai,6603265,"Bật Lửa Zippo Made in the USA Emblem Brushed Chrome 200HD.H284",1345000,1345000,0,0
TIKI,the-thao-da-ngoai,53211717,"Tạ tập tay lục giác Pro-Care cao cấp",1497000,1784000,287000,16
TIKI,the-thao-da-ngoai,131497894,"Xà Đơn Treo Tường Gắn Cửa 2021 KT 115cm-160cm Có Chốt Chống Xoay Chịu Lực 300kg Đại Nam Sport",273000,500000,227000,45
TIKI,the-thao-da-ngoai,11259041,"Sữa WHEY PROTEIN Tăng Cơ Tăng sức mạnh Nitro Tech 4lbs (1.81kg) - NHIỀU MÙI VỊ - KÈM QUÀ TẶNG – Bổ sung nguồn Protein chất lượng cao hỗ trợ phát triển cơ bắp to + dày - Hàng chính hãng - Thương hiệu Muscletech USA",1495000,2195000,700000,32
TIKI,the-thao-da-ngoai,12412461,"Combo 2 băng cổ tay thể thao cao cấp thấm mồ hôi bảo vệ cổ tay VirgoJ5101",33000,39000,6000,15
TIKI,the-thao-da-ngoai,167422315,"Bộ 2 tạ tay cao su Reefit màu đen 7kg (gồm 2 cục)",789000,789000,0,0
TIKI,the-thao-da-ngoai,102087657,"[xả kho cắt mã, giảm giá cực sốc] Áo thể thao nam AVP06 TENNIS cao cấp, thời trang, chất vải mỏng nhẹ, thoáng mát, không phai màu, bai xù vải",109000,109000,0,0
TIKI,the-thao-da-ngoai,184489131,"Áo Bơi Nữ Tay Dài Black Befree Sobie",382500,450000,67500,15
TIKI,the-thao-da-ngoai,167422381,"Bộ 2 tạ tay cao su Reefit màu đen 9kg (gồm 2 cục)",1009000,1009000,0,0
TIKI,the-thao-da-ngoai,173195640,"Giày Thể Thao Nữ Biti's Hunter x THE BATMAN - MID-KNIGHT BLACK COLLECTION - Shadow edition DSWH09099DEN (Đen)",775000,1521000,746000,49
TIKI,the-thao-da-ngoai,138342962,"Thiết Bị Phục Hồi Chức Năng Zasami 4 Trong 1",2799000,3790000,991000,26
TIKI,the-thao-da-ngoai,151223146,"Áo thun trắng, đồng phục thể dục nam nữ các cấp, chất liệu thun cotton co giãn, hút mồ hôi tốt, big size tới 95kg",64000,99000,35000,35
TIKI,the-thao-da-ngoai,16936558,"Dây Đai Quấn Cổ Tay Kéo Lưng Nâng Tạ Tập Gym Sport Wrist Bands AOLIKES YE-7635 - Hàng Chính Hãng",143000,259000,116000,45
TIKI,the-thao-da-ngoai,73327285,"Cần câu cá Daiwa Tornado cần 2 khúc lure máy ngang 1m80, 1m98 khoen Fuji Pat Daiwa",1122000,1122000,0,0
TIKI,the-thao-da-ngoai,97587515,"Giày tennis, cầu lông, bóng chuyền size 38 đến 44",430000,430000,0,0
TIKI,the-thao-da-ngoai,118409000,"Giày Thể Thao Nữ Biti’s Hunter Jogging ActivGen DSWH07200DEN (Đen)",638000,638000,0,0
TIKI,the-thao-da-ngoai,179563004,"Dụng cụ tập cổ tay chất liệu thép Joerex cải tiến mới Sportslink",150000,198000,48000,24
TIKI,the-thao-da-ngoai,9996463,"Combo Khung Bóng Rổ + Bóng + Kim Bơm + Lưới",215000,399000,184000,46
TIKI,the-thao-da-ngoai,2282553,"Bật Lửa Zippo High Polished Chrome",715000,715000,0,0
TIKI,the-thao-da-ngoai,167422297,"Tạ tay bọc cao su 8kg Reefitmàu đen",449000,449000,0,0
TIKI,the-thao-da-ngoai,84881195,"Quần bơi chống nắng nam SPEEDO - SOJ20019",366000,1045000,679000,65
TIKI,the-thao-da-ngoai,108892525,"Quần ngắn thể thao nữ New Balance - WS01241BK (form Quốc tế)",1019000,1395000,376000,27
TIKI,the-thao-da-ngoai,33451941,"Đai Lưng Mềm Tập GYM Valeo Bản Bé Lifting Belt EVA-1",125000,125000,0,0
TIKI,the-thao-da-ngoai,110123012,"Đá Zippo chính hãng Mỹ",45000,45000,0,0
TIKI,the-thao-da-ngoai,100369682,"Quần đùi nam Fasvin Q20207.HN quần short thể thao vải gió chun chất lượng cao mềm mại thoáng mát không bai không xù",93000,170000,77000,45
TIKI,the-thao-da-ngoai,161454378,"Bộ 2 vỏ tạ tay nhựa bát giác 10kg REEFIT (2 vỏ 10kg, tổng 20kg)",120000,120000,0,0
TIKI,the-thao-da-ngoai,164823103,"Vỏ tạ miếng nhựa Reefit 10kg màu đen không ruột",65000,65000,0,0
TIKI,the-thao-da-ngoai,56103290,"BỘ LƯỚI TẬP SWING 3M - PGM GOLF SWING PRACTICE NET - LXW013",1195000,1245000,50000,4
TIKI,the-thao-da-ngoai,113142498,"Băng trán thấm mồ hôi chính hãng Aolikes No.2108",39900,39900,0,0
TIKI,the-thao-da-ngoai,192287136,"GẬY TẬP SWING GOLF - PGM HGB015-HBG016 Golf Swing Gar: 6 cấp lực luyện tập nhiều chế độ tại nhà",990000,990000,0,0
TIKI,the-thao-da-ngoai,114253231,"Phao Kẹp Chân Unisex SPEEDO - 8-01791B076",566000,595000,29000,5
TIKI,the-thao-da-ngoai,4935805,"Bộ 2 tạ tay  3kg cao cấp tập Gym BG (hàng nhập khẩu)",280000,599000,319000,53
TIKI,the-thao-da-ngoai,183781106,"Giày bóng đá phủi chính hãng Wika Ultra 2 cao cấp 2022 New",280000,280000,0,0
TIKI,the-thao-da-ngoai,51996063,"Bật Lửa Zippo 49181ZL – Zippo Mercury Glass Zippo Logo",790000,790000,0,0
TIKI,the-thao-da-ngoai,159026636,"Ghế Xếp Cắm Trại YL08 Naturehike NH20JJ027",880000,880000,0,0
TIKI,the-thao-da-ngoai,67876770,"Đai lưng tập gym, bảo vệ cột sống GoodFit GF723WS",207000,280000,73000,26
TIKI,the-thao-da-ngoai,172821723,"Quần bơi nam Boxer Desmiit S404",165000,218000,53000,24
TIKI,the-thao-da-ngoai,2282523,"Bật Lửa Zippo Replica 1941 Brushed Brass",1115000,1115000,0,0
TIKI,the-thao-da-ngoai,91207926,"Túi Bình Nước Thể Thao dẻo Chạy Bộ Đạp Xe Dạng Túi Tiện Lợi Mang Theo Rimix Dung Lượng 2 Lít - Hàng chính hãng BORO SPORT",119000,215000,96000,45
TIKI,the-thao-da-ngoai,196781064,"Băng Cổ Tay VNSPORT - VNS015, Băng Cuốn Cổ Tay Tập Gym, Băng Trợ Lực Cổ Tay (2 Chiếc)",119000,160000,41000,26
TIKI,the-thao-da-ngoai,178096203,"Phao lưng tập bơi trẻ em giữ an toàn đa màu sắc Sportslink",55000,73000,18000,25
TIKI,the-thao-da-ngoai,163738893,"Dây Quấn Bảo Vệ Cổ Tay Aolikes Chơi Thể Thao, Tập GYM An Toàn (1 Đôi)",120000,120000,0,0
TIKI,the-thao-da-ngoai,33064824,"Băng Nẹp H5 4 Lò Xo Knee Pads Aolikes Chính Hãng (1 Chiếc)",125000,125000,0,0
TIKI,the-thao-da-ngoai,51398704,"Ruột Zippo Gas Butane Hai Tia Lửa – Butane Lighter Insert Double Torch 65827",585000,585000,0,0
TIKI,the-thao-da-ngoai,16510378,"Găng Tay Chống Nắng - Chống Tia Uv Chơi Golf - PGM XT003",155000,195000,40000,21
TIKI,the-thao-da-ngoai,57690128,"Dụng Cụ Tập Cơ Bụng Có Đế Hút Chân Không Rexchi Đa Năng Tại Nhà (Giao màu ngẫu nhiên)",99000,99000,0,0
TIKI,the-thao-da-ngoai,144234790,"Túi Đựng Giày Patin 3 Ngăn Nhiều Màu Sắc Centosy 02 ",150000,150000,0,0
TIKI,the-thao-da-ngoai,160128711,"Phao bơi kẹp chân unisex Zoggs - 465206",345000,455000,110000,24
TIKI,the-thao-da-ngoai,71021210,"BĂNG ĐEO GIẢM ĐAU VÀ BẢO VỆ CÁNH TAY  BAND-IT USA",1219000,1290000,71000,6
TIKI,the-thao-da-ngoai,54846651,"Máy câu cá Daiwa CC80HSL (Máy tay trái)",1400000,1400000,0,0
TIKI,the-thao-da-ngoai,195739133,"Trụ Đấm Bốc,Trụ Boxing 8725 Kết Cấu Da PU 4 Lớp Siêu Bền Cao Cấp Đại Nam Sport + Găng Đấm Bốc",3086000,4500000,1414000,31
TIKI,the-thao-da-ngoai,13428954,"Chân Vịt Bơi Lặn Biển Dài 59-70cm Swim Fins",412000,412000,0,0
TIKI,the-thao-da-ngoai,3670065,"Nhét tai có dây đeo + kẹp mũi khi bơi NK03 Sportslink",29000,38000,9000,24
TIKI,the-thao-da-ngoai,95063708,"Bó bắp chân - Phụ kiện bảo vệ ống chân Hibi Sports A001",154000,220000,66000,30
TIKI,the-thao-da-ngoai,114254828,"Xà đơn treo tường kiêm hít đất BODY SCULPTURE - BB-268-B",495000,495000,0,0
TIKI,the-thao-da-ngoai,98822288,"Dụng cụ sinh tồn, thoát hiểm Baseus LV614 (CRSFH) búa phá kính & cắt dây an toàn- Hàng chính hãng",320000,320000,0,0
TIKI,the-thao-da-ngoai,7939100,"Gạch tập Yoga",150000,150000,0,0
TIKI,the-thao-da-ngoai,113675092,"Bóng tập gym Reebok Gym Ball - Grey - 65cm",561600,702000,140400,20
TIKI,the-thao-da-ngoai,186309108,"Thuyền Hơi 2 Người Cao Su Câu Cá,Dã Ngoại Cao Cấp YT097A Đại Nam Sport (Kèm 2 Mái Chèo + Bơm Tay + Dây Buộc)",616000,1200000,584000,49
TIKI,the-thao-da-ngoai,186534464,"[Cho Yogini Chuyên Nghiệp] Thảm tập yoga 2 lớp 8mm, 6mm Thế Hệ thảm 9.0 tặng kèm túi, thảm yoga định tuyến chất liệu cao su non TPE siêu bám, chống trượt, tập gym, thể dục tại nhà - Hàng chính hãng DoDoDios",151000,151000,0,0
TIKI,the-thao-da-ngoai,68613933,"MÁY MASSAGE BỤNG - TOÀN THÂN TOANANH HKA-14",2390000,2390000,0,0
TIKI,the-thao-da-ngoai,173220069,"Băng bảo vệ cổ tay, đầu gối, mắt cá chân khi tập Gym, chơi thể thao | Loại tự dính, co giãn, sử dụng linh hoạt",23000,23000,0,0
TIKI,the-thao-da-ngoai,49924641,"Combo Giày Patin Cougar 835L (3 Màu)",699000,699000,0,0
TIKI,the-thao-da-ngoai,113438609,"Bàn Nhôm Vân Gỗ Naturehike NH19Z003-D Điều Chỉnh Độ Cao",2150000,2150000,0,0
TIKI,the-thao-da-ngoai,168065471,"Giầy đá bóng siêu phủi Wika Ultra 3 đế TF ( giầy đá bóng đá banh WIKA sân cỏ nhân tạo ) - Đã khâu toàn bộ đế",139000,139000,0,0
TIKI,the-thao-da-ngoai,115827242,"Xe đạp tập thể dục trong nhà toàn thân AYOSUN AYS – 885X4 ( Chính Hãng )",4300000,4300000,0,0
TIKI,the-thao-da-ngoai,186218478,"Ghế tập tạ đa năng kết hợp giá đỡ tạ (CHƯA BAO GỒM TẠ)",1650000,3300000,1650000,50
TIKI,the-thao-da-ngoai,684578,"Dung Dịch Vệ Sinh Thảm Tập Yoga Sportslink Lavender Mint (100ml) (Màu Ngẫu Nhiên)",70000,93000,23000,25
TIKI,the-thao-da-ngoai,50219358,"Giày Tennis Chính Hãng Dành Cho Nam Nữ Mới Nhất",430000,430000,0,0
TIKI,the-thao-da-ngoai,271088208,"BG Máy chạy bộ SIDE STEPPER Hàng hot Máy Chạy Bộ Tại Chỗ máy tập cầm tay máy tập chạy bộ (hàng nhập khẩu)",675000,999000,324000,32
TIKI,the-thao-da-ngoai,196156359,"Tinh dầu xịt vệ sinh thảm yoga - YOGA MAT CARE - Vững yên - Hương thảo - 100ml - 100% thiên nhiên và hữu cơ - không hoá chất - không cồn",153000,180000,27000,15
TIKI,the-thao-da-ngoai,40195536,"Giày Cầu Lông Nam Nữ Chí Phèo",180000,180000,0,0
TIKI,the-thao-da-ngoai,134512164,"Xà Đơn Gắn Tường 2021 KT 72cm-105cm Tích Hợp Chốt Chống Xoay Chất Liệu Inox + Kèm Găng Tay Tập Xà",217000,400000,183000,46
TIKI,the-thao-da-ngoai,47322895,"Bật Lửa ZIPPO SAPPHIRE 20446 KHẮC HOA VĂN VENETIAN MARLBORO – ZIPPO 20446.VENMARL",955000,955000,0,0
TIKI,the-thao-da-ngoai,14901473,"Bình xịt chấn thương - Dùng trong thể thao 150ml",238000,238000,0,0
TIKI,the-thao-da-ngoai,174132822,"Bao Tay Cuộn Y - Bảo vệ cổ tay và tránh chấn thương - Thương Hiệu VN - Lâm Sport - (1 cặp)",47000,80000,33000,41
TIKI,the-thao-da-ngoai,183332144,"Cặp vợt tennis trẻ em Regail W150",279000,291000,12000,4
TIKI,the-thao-da-ngoai,33261373,"Băng Quấn Bảo Vệ Đầu Gối Tập GYM Aolikes Knee Wraps (1 Đôi)",165000,165000,0,0
TIKI,the-thao-da-ngoai,159604291,"Nón mũ bơi trẻ em Zoggs Character Silicone - 302731 (6-14 tuổi)",98000,195000,97000,50
TIKI,the-thao-da-ngoai,193894556,"Đai Chạy Bộ Túi Đeo Hông  Đựng Điện Thoại Thể Thao Aonijie W8108 Ngăn Rộng",432000,432000,0,0
TIKI,the-thao-da-ngoai,158900690," Đèn Treo Lều 4 chế độ sạc USB Naturehike D300 NH16D300-C",320000,320000,0,0
TIKI,the-thao-da-ngoai,177787552,"[Chính hãng] Evogen Super Huge (5.4KG), Sữa Tăng Cân, Tăng Cơ Nạc, 50G Whey Protein Cao Cấp, 22G EAA, 10G BCAA, 5G Leucine, Potent Evozyme | Nhập Khẩu USA",2099000,2099000,0,0
TIKI,the-thao-da-ngoai,6638985,"Bật Lửa Zippo Laughing Buddha 29626",1375000,1375000,0,0
TIKI,the-thao-da-ngoai,175875712,"Găng Tay Tập Gym Glofit - GFST017 | Workout Gloves",350000,450000,100000,22
TIKI,the-thao-da-ngoai,173228397,"Bộ 3 Dây Kháng Lực Tập Mông Trái Đào Mini Band – Dây Đàn Hồi Hỗ Trợ Tập Chân, Đùi, Mông Tập Gym Tập Thể Thao miniBand Cao Cấp Chính Hãng Dododios (Có Chọn Từng Dây)",74000,74000,0,0
TIKI,the-thao-da-ngoai,183501985,"Vợt tennis chuyên nghiệp khung sợi carbon siêu nhẹ Regail NDL-02 Sportslink",552000,575000,23000,4
TIKI,the-thao-da-ngoai,146939536,"VỢT TENNIS BABOLAT PURE AERO RAFA TEAM (285GR)- 101464",4899000,4999000,100000,2
TIKI,the-thao-da-ngoai,192718301,"[HÀNG NHẬP KHẨU] Bóng tập Yoga trơn cao cấp 65cm - Bóng Yoga tròn chống nổ - Hàng chính hãng D Danido",153000,250000,97000,39
TIKI,the-thao-da-ngoai,94700163,"Kính Bơi Trẻ Em CA958 Chống Tia UV,Chống Mờ,Chống Nước Tuyệt Đối Kiểu Dáng Mới Nhất",84000,180000,96000,53
TIKI,the-thao-da-ngoai,114205640,"Áo thun thể dục thương hiệu Amazing cho nam, cổ bẻ và cổ tròn, đồng phục thể thao cho học sinh nam nữ các cấp",64000,99000,35000,35
TIKI,the-thao-da-ngoai,156232887,"Dụng Cụ Hít Đất Chống Đẩy, Tập Cơ Bụng Chữ U, Dụng Cụ Tập Gym Tại Nhà Tiện Lợi - Hàng Loại 1 - Chính Hãng MINIIN",97000,109000,12000,11
TIKI,the-thao-da-ngoai,24109842,"Kính bơi chuyên nghiệp nhập khẩu từ Đức Aquafeel dòng "Glide Mirrored" siêu nhẹ, tiêu chuẩn Châu Âu, phù hợp để tập luyện và thi đấu dành cho Nam, Nữ, Trẻ em nhiều độ tuổi Freesize",962182,962182,0,0
TIKI,the-thao-da-ngoai,167422354,"Đòn tập tạ tay reefit hình thang (Reefit Sport)",589000,589000,0,0
TIKI,the-thao-da-ngoai,95862212,"Bóng Tạ Tập Thể Lực,Tập Gym,Tập Yoga 4kg Chất Liệu Cao Su Đặc Hàng Nhập Khẩu Đại Nam Sport",374000,700000,326000,47
TIKI,the-thao-da-ngoai,194084817,"Thảm trải lót lều - Tăng bạt dã ngoại đa năng 2 lớp NatureHike NH15D004-X",210000,210000,0,0
TIKI,the-thao-da-ngoai,130069842,"Móc khoá đa năng đi phượt",14000,14000,0,0
TIKI,the-thao-da-ngoai,129985933,"Vòng Treo Xà Đơn Trẻ Em , Hỗ Trợ Trẻ Em Đu Xà Tăng Chiều Cao Cleacco BORO SPORT",128000,215000,87000,40
TIKI,the-thao-da-ngoai,17610807,"Nẹp Cố Định Khớp Cổ Tay Bằng Tấm Thép An Toàn Metal Plate Support Wrist AOLIKES YE-1680 - Hàng Chính Hãng",125000,125000,0,0
TIKI,the-thao-da-ngoai,193155383,"Bộ 2 quấn bảo vệ cổ tay AOLIKES A-7936-2 Sport Pressure Wrist",105000,209000,104000,50
TIKI,the-thao-da-ngoai,191780175,"COMBO thể thao nam đẹp cao cấp LADOS - 7003 vải co giãn, tập gym, chạy bộ phong cách, năng động",399000,399000,0,0
TIKI,the-thao-da-ngoai,70638093,"BĂNG ĐẦU GỐI MUEllER GỌN NHẸ 58677",552000,590000,38000,6
TIKI,the-thao-da-ngoai,193748308,"Giày Thể Thao Nữ Biti's Hunter DSWH10100DEN",552000,690000,138000,20
TIKI,the-thao-da-ngoai,11395424,"Cặp vợt cầu lông trẻ em Sportslink SL6.2",150000,256000,106000,41
TIKI,the-thao-da-ngoai,16256876,"Bật lửa Zippo  1935 Replica Original",955000,955000,0,0
TIKI,the-thao-da-ngoai,32396000,"Combo Khung Bóng Rổ +Bóng rổ +Lưới màu cam size 40",239000,469000,230000,49
TIKI,the-thao-da-ngoai,2620263,"Combo 2 dây đai quấn bảo vệ cổ tay thể thao AOLIKES TC-7936",105000,189000,84000,44
TIKI,the-thao-da-ngoai,145571129,"Lều 1-2 Người Trong Nhà 3T Tại Chỗ Galaxy Store GSL13 - Hàng Chính Hãng (Màu Ngẫu Nhiên)",550000,1100000,550000,50
TIKI,the-thao-da-ngoai,186094247,"Gối Dã Ngoại Tự Bơm Hơi Naturehike NH20ZT006 Xếp Gon",230000,230000,0,0
TIKI,the-thao-da-ngoai,5344409,"Còi thể thao hợp kim nhôm Sportslink 4,6 * 0,9cm (Cái)",9000,11000,2000,18
TIKI,the-thao-da-ngoai,168586695,"Giày Thể Thao Nữ Biti's Hunter Core Festive 3D DSWH07800DEN",679000,849000,170000,20
TIKI,the-thao-da-ngoai,144404051,"Dây Miniband, Đàn Hồi Kháng Lực Tập Mông Aolikes Tự Do Điều Chỉnh Chu Vi | Mini Band Có Khoá A-3606",80000,80000,0,0
TIKI,the-thao-da-ngoai,148939446,"Băng quấn bụng và lưng , đai lưng bảo vệ cột sống tập gym thể thao chống chấn thương , đau lưng 2 dây nén  H11 CLEACCO  - Hàng chính hãng  BORO SPORT",212000,350000,138000,39
TIKI,the-thao-da-ngoai,142471864,"Tất Vớ Chuyên Dụng Đi Giày Patin Chơi Thể Thao Trẻ Em Và Người Lớn Màu Ngẫu Nhiên",40000,40000,0,0
TIKI,the-thao-da-ngoai,160138307,"Chân vịt bơi unisex Zoggs Long Blade Rubber - 465213 7-8 (size eu 41-42)",899000,1170000,271000,23
TIKI,the-thao-da-ngoai,58491414,"Bộ 4 vỉ Đá chuyên dùng bât lửa Zippo",180000,180000,0,0
TIKI,the-thao-da-ngoai,90573611,"[MUA 1 TẶNG 1] Áo Thun Thể Thao Nữ Vina Sport AVT03W",164000,164000,0,0
TIKI,the-thao-da-ngoai,184628555,"Đai bó gối thể thao, băng bảo vệ khớp gối khi tập gym, bóng rổ, nhảy có đệm silicon và 2 thanh đàn hồi BGFA04",83000,89000,6000,7
TIKI,the-thao-da-ngoai,169692232,"Thảm Tập Yoga Chất Liệu TPE 2 Lớp PaKaSa Dày 6 mm - Thảm Tập Gym , YoGa Chuyên Nghiệp - Hàng Cao Cấp - Chính Hãng",59000,118000,59000,50
TIKI,the-thao-da-ngoai,192712452,"Tất Vớ Cổ Ngắn Cao Cấp Thoáng Khí VNSPORT - VNS010 (1 Đôi) | Tất Cho Thể Thao Phù Hợp Cho Cả Nam Nữ",55000,70000,15000,21
TIKI,the-thao-da-ngoai,10398970,"Băng Thun Gối ORBE H2 (Size",145500,169000,23500,14
TIKI,the-thao-da-ngoai,253671281,"Combo Thảm Tập Yoga 6mm,Con Lăn Massage Ống Lăn Dãn Cơ Foam Roller BLUE- Bóng tập yoga size 65cm Tập Gym, Yoga, Thể Hình (hàng nhập khẩu)",44000,99000,55000,56
TIKI,the-thao-da-ngoai,58308529,"Bộ 2 Sản Phẩm Xăng+Đá Zippo",150000,150000,0,0
TIKI,the-thao-da-ngoai,58214063,"Đèn pin đội đầu Điện Quang ĐQ PFL16 R BLY WW (Pin sạc Lithium, Đen – Vàng, 2.5W, warmwhite)",115000,150600,35600,24
TIKI,the-thao-da-ngoai,161892490,"Tạ Tay Nhựa 6kg Bát Giác REEFIT (1 cái)",48000,48000,0,0
TIKI,the-thao-da-ngoai,161497659,"Bộ 2 Tạ Tay Nhựa Bát Giác 4kg REEFIT (2 tạ 4kg, tổng 8kg)",60000,60000,0,0
TIKI,the-thao-da-ngoai,84720030,"Thực phẩm tăng cơ Rule 1 R1 Protein Isolate/Hydrolysate 14-15 servings",400000,400000,0,0
TIKI,the-thao-da-ngoai,58473250,"Găng tay hở ngón, bao tay tập gym có đệm silicone chống trượt, vải đục lỗ thoáng khí Goodfit GF204G",120000,169000,49000,29
TIKI,the-thao-da-ngoai,95873415,"TÚI ZIPPO DA BÒ THẬT",99000,99000,0,0
TIKI,the-thao-da-ngoai,184282879,"Balo GIVI CIT03 chống mưa",1080000,1080000,0,0
TIKI,the-thao-da-ngoai,172319171,"Dây  nhảy thể dục điện tử  đếm số vòng , calo , đếm ngược đồng hồ led hiển thị chính xác , dây PVC lõi thép Cleacco  AT0117   - Hàng chính hãng BORO SPORT",138000,242000,104000,43
TIKI,the-thao-da-ngoai,2066903,"Viên sủi điện giải  -  Hammer  Nutrition Endurolytes Fizz Vị  Bưởi HM199",179000,179000,0,0
TIKI,the-thao-da-ngoai,144404148,"Băng Bảo Vệ Đầu Gối Aolikes A-7616 | Đai Dán Gối Khi Tập Gym Tập Thể Thao Cao Cấp Chính Hãng",90000,90000,0,0
TIKI,the-thao-da-ngoai,76537606,"Giày đá bóng Akka Speed 2 sân cỏ nhân tạo",580800,580800,0,0
TIKI,the-thao-da-ngoai,195334085,"Găng tay tập Gym Nam Nữ AOLIKES A-112 Fitness Breathable Gloves",181000,329000,148000,45
TIKI,the-thao-da-ngoai,167024677,"Giày lội nước Aztron Gemini II",550000,550000,0,0
TIKI,the-thao-da-ngoai,147422371,"Bộ Dụng Cụ Hít Đất Cầm Tay Và Dây Nhảy Lõi Thép Có Thể Điều Chỉnh Dộ Dài Chống Rối – Combo Dụng Cụ Chống Đẩy Kèm Dây Nhảy Lõi Thép Tập Gym Tập Thể Thao Cao Cấp Chính Hãng miDoctor",109000,109000,0,0
TIKI,the-thao-da-ngoai,189464298,"Xà Đơn Gắn Cửa FED-0228 | Kích thước 65-90cm (Chịu lực 400kg - Có chốt khóa an toàn khi gắn xà - Dễ dàng tháo lắp không cần khoan tường)",490000,590000,100000,17
TIKI,the-thao-da-ngoai,86146469,"Bật Lửa Zippo 150 Đen Bóng Black Ice Khắc Kỳ Lân Chiêu Tài 5 Mặt – Zippo 150.Kylan",1285000,1285000,0,0
TIKI,the-thao-da-ngoai,77149883,"Giảm rung Babolat Flag Damp (700033) Màu ngẫu nhiên ",59000,67000,8000,12
TIKI,the-thao-da-ngoai,34180453,"Tạ tay bọc caosu 1kg Brosman",75000,75000,0,0
TIKI,the-thao-da-ngoai,163876992,"Bó cổ chân thể thao, hở gót 75606-SPO Actimove Ankle Support",280000,320000,40000,13
TIKI,the-thao-da-ngoai,175143310,"Quần ngắn thể thao nam Under Armour HeatGear Pocket Long - 1361602-001",655000,655000,0,0
TIKI,the-thao-da-ngoai,103209754,"Quả bóng rổ số 5 họa tiết phá cách Agnite - Cao su chống bẩn, không mòn, bền, cho người chơi thể thao chuyên nghiệp - Hàng chính hãng - F1168",239000,466200,227200,49
TIKI,the-thao-da-ngoai,160786756,"Găng tay boxing unisex Venum Challenger 3.0 - VENUM-03525",1350000,1350000,0,0
TIKI,the-thao-da-ngoai,16510066,"Thảm Tập Swing PGM Golf Mat - DJD002 (1.5m x 1.5m)",1290000,1450000,160000,11
TIKI,the-thao-da-ngoai,1747245,"Băng đô buộc tóc thể thao",35000,47000,12000,26
TIKI,the-thao-da-ngoai,51101356,"Giày Bata Thượng Đình trắng sọc xanh tặng kèm tất đá bóng",100000,199000,99000,50
TIKI,the-thao-da-ngoai,16510010,"Nẹp Định Vị Cổ Tay Tập Chơi Golf PGM - JZQ010",199000,225000,26000,12
TIKI,the-thao-da-ngoai,54836651,"Bàn Dã Ngoại Gấp Gọn HỢP KIM NHÔM Naturehike NH19Z008-Z Siêu Nhẹ, Lắp Ráp Dễ Dàng",450000,450000,0,0
TIKI,the-thao-da-ngoai,52040314,"Máy Tập Đa năng New Six Pack Care mẫu mới model KM2017 (Hàng nhập khẩu)",898000,1599000,701000,44
TIKI,the-thao-da-ngoai,272461253,"Tăng năng lượng trước khi tập Rule 1 ROAR 315g - 30 servings tặng gói sample Rule 1 bất kỳ",550000,550000,0,0
TIKI,the-thao-da-ngoai,107325035,"Băng Cổ Tay Trợ Lực Thể Thao VNS022, Bảo Vệ Cổ Tay Phòng Các Chấn Thương Cổ Tay Trong Thể Thao, Hỗ Trợ Phục Hồi Chân Thương Cổ Tay, Tùy Chỉnh Độ Siết Cổ Tay ( 1 Đôi )",150000,180000,30000,17
TIKI,the-thao-da-ngoai,188914097,"Quần Đùi Nam Đi Bơi FASVIN S21463.HN Vải Gió Đẹp In Thăng Hoa Hàng Nhà Máy Chất Lượng Cao",169000,298000,129000,43
TIKI,the-thao-da-ngoai,58405491,"DỤNG CỤ MASSAGE CHÂN BẰNG GỖ 6 ĐẠI TOANANH TA-6Đ",259000,259000,0,0
TIKI,the-thao-da-ngoai,1953781,"Gạch Tập Yoga NA (300g)",105000,139000,34000,24
TIKI,the-thao-da-ngoai,176560566,"Cặp Tạ Đeo Chân,Tạ đeo cổ chân, cổ tay hỗ trợ tập thể thao, tập gym, chạy bộ,Tạ ôm chân hạt kim loại êm không đau(Bộ 2 Băng Tạ)",199000,398000,199000,50
TIKI,the-thao-da-ngoai,7392183,"Còi trọng tài bóng đá Molten DOLFIN F có dây",369000,369000,0,0
TIKI,the-thao-da-ngoai,47215855,"GƯƠNG TẬP PUTT GOLF - PGM GOLF PUTTER MIRROR - JZQ016",373000,385000,12000,3
TIKI,the-thao-da-ngoai,169366498,"Áo Thun Thể Thao Nữ Tập GYM YOGA Chạy Bộ Chất Liệu Co Giãn Tốt TTO01 MAYHOMES Women Sportswear T-Shirt",132000,155000,23000,15
TIKI,the-thao-da-ngoai,16528083,"Khăn Chống Nắng Kết Hợp Mũ PGM - WB001",245000,295000,50000,17
TIKI,the-thao-da-ngoai,117281855,"(COMBO 6 GÓI) GU Energy Gel Năng Lượng Chạy Bộ Vị Salted Caramel - Combo 6 Gói",230000,230000,0,0
TIKI,the-thao-da-ngoai,146399062,"Máy Câu Cá Daiwa Revros TG LT",1400000,1400000,0,0
TIKI,the-thao-da-ngoai,137671792,"Bộ Tạ Tay Đa Năng Điều Chỉnh 20kg Thiết Kế Mới Chính Hãng Đại Nam Sport + Tặng Găng Tay Tập Tạ",484000,690000,206000,30
TIKI,the-thao-da-ngoai,192562990,"Túi đeo bụng chạy bộ chống nước KUNOSPORT, đai đeo điện thoại chạy bộ phản quang cao cấp",25000,49000,24000,49
TIKI,the-thao-da-ngoai,69876728,"Đai bảo vệ đùi, bảo vệ khung chậu, bảo vệ khớp háng GoodFit GF501T",207000,350000,143000,41
TIKI,the-thao-da-ngoai,974980,"Viên uống giảm cân đốt mỡ Ultra Ripped Ultimate Nutrition - Chống oxy hóa và làm đẹp da (Lọ 90 Viên)",621000,690000,69000,10
TIKI,the-thao-da-ngoai,188066436,"Giày Tennis nam - Jogabola 222064",720000,850000,130000,15
TIKI,the-thao-da-ngoai,12635472,"Kính bơi tráng gương Fashy nhập khẩu từ Đức, tiêu chuẩn chất lượng Châu Âu dòng “Power Mirror” kiểu dáng thời trang, chống mờ, chống tia UV dành cho người lớn, trẻ em nhiều độ tuổi Freesize",677455,677455,0,0
TIKI,the-thao-da-ngoai,33234687,"Băng Nẹp H1 Cố Định Khớp Cổ Tay Tránh Chấn Thương Aolikes (1 Chiếc)",125000,125000,0,0
TIKI,the-thao-da-ngoai,157157100,"Giày địa hình WILDCROSS 2 Black L41453600",2178000,3630000,1452000,40
TIKI,the-thao-da-ngoai,106075700,"Giảm rung HEAD Pro Damp Jar Box  285525 Nhiều màu",69000,79000,10000,13
TIKI,the-thao-da-ngoai,55367303,"Găng Tay Boxing Bofit Everlast",165000,165000,0,0
TIKI,the-thao-da-ngoai,160313739,"Cọc Ghim Lều Naturehike Hợp Kim Nhôm 18cm (Bộ 8 cái)",85000,85000,0,0
TIKI,the-thao-da-ngoai,188916099,"Bộ Quần ÁoThể Thao Nam FASVIN AT22500.HN Hàng Nhà Máy Chất Liệu tốt Phom Dáng Đẹp",199000,398000,199000,50
TIKI,the-thao-da-ngoai,7003831,"Bộ khung và bóng rổ tiêu chuẩn - có kèm lưới khung,túi đựng bóng và kim bơm bóng",210000,229000,19000,8
TIKI,the-thao-da-ngoai,162986691,"Vợt Bóng Bàn Dán Sẵn Carbon Yinhe 07B Tặng Kèm Túi Vợt - Độ Bám Xoáy & Độ Nảy Tốt",495000,495000,0,0
TIKI,the-thao-da-ngoai,17041948,"Bình Nước Camelbak Podium Chill 24OZ (710ml)",350000,350000,0,0
TIKI,the-thao-da-ngoai,69851777,"MẶT NẠ CHỐNG NẮNG CHƠI GOLF - PGM Sun Protector Mask - WB003",161000,185000,24000,13
TIKI,the-thao-da-ngoai,263697615,"Bộ 2 Đai Bảo Vệ Khớp Đầu Gối Cao Cấp  AOLIKES YE-7907 Có Thanh Hợp Kim Nhôm Trợ Lực Sport Knee Protector - Hàng Chính Hãng",613000,1199000,586000,49
TIKI,the-thao-da-ngoai,17043350,"Bình Nước Xe đạp thể thao cách nhiệt Podium Dirt Series Chill 21 OZ Camelbak (620ml)",375000,375000,0,0
TIKI,the-thao-da-ngoai,133347196,"Phụ kiện dây nối dài bình gas mini Campingmoon Z21-70",320000,320000,0,0
TIKI,the-thao-da-ngoai,184650931,"Đệm quần đạp xe nam nữ WOSAWE | Đệm gel silicone lót trong quần đi xe đạp",84000,84000,0,0
TIKI,the-thao-da-ngoai,157030320,"Tất bóng đá dài thể thao nam nữ Mira Alula phụ kiện unisex cao cấp, vớ đá banh cotton chính hãng đẹp - TM001",79000,79000,0,0
TIKI,the-thao-da-ngoai,6472701,"Bật Lửa Zippo Black Matte with Zippo Logo And Border Slim 1618ZB",775000,775000,0,0
TIKI,the-thao-da-ngoai,114011284,"Quấn cổ chân tập Gym - Băng quấn bảo vệ cổ chân chơi thể thao",65000,65000,0,0
TIKI,the-thao-da-ngoai,127585794,"Bộ 2 ống tay chống nắng bảo vệ khủy tay AOLIKES A-7146 chống tia UV khi chơi thể thao Sport Arm Sleeve",114000,209000,95000,45
TIKI,the-thao-da-ngoai,24742127,"Kính Bơi Phoenix 204",85000,85000,0,0
TIKI,the-thao-da-ngoai,12307315,"Con Lăn tập bụng Thiên Trường 4 bánh 2019",290000,290000,0,0
TIKI,the-thao-da-ngoai,8136296,"Bộ đôi dây quấn cổ tay trợ lực nâng tạ chính hãng Aolikes AL7638",88000,88000,0,0
TIKI,the-thao-da-ngoai,197409528,"Dây kháng lực miniband tập mông đùi AOLIKES A-3604 Hip Resistance bands",85000,169000,84000,50
TIKI,the-thao-da-ngoai,60880474,"Dây dù câu cá siêu bền - Chất liệu FE bền bỉ , Mạnh mẽ - 100m - DC02",89000,89000,0,0
TIKI,the-thao-da-ngoai,68591677,"Vòng tập yoga 33 * 14 cm PU (Tặng Kèm túi đựng vòng) khung nhựa ABS chịu lực 300 kg bọc cao su Pu in hoa văn chống trơn trượt 100",249000,498000,249000,50
TIKI,the-thao-da-ngoai,69320831,"Bộ 5 Dây Kháng Lực Đàn Hồi Hỗ Trợ Tập Squat Hiệu Quả Tại Nhà( Tặng kèm túi đựng và Hướng Dẫn Sử Dụng+ Thước dây đo Vòng eo)",98000,196000,98000,50
TIKI,the-thao-da-ngoai,68595588,"Cặp Vợt Cầu Lông 507 (Giao Màu Ngẫu Nhiên)",139000,139000,0,0
TIKI,the-thao-da-ngoai,794104,"Cặp Vợt Cầu Lông AAA VAV ",149000,149000,0,0
TIKI,the-thao-da-ngoai,195189429,"[Hàng chính hãng – Thương hiệu Mỹ] Bình giữ nhiệt Elemental Iconic sport màu bạc 590ml, giữ nhiệt vượt trội, inox 304, FDA Hoa Kì, An toàn sức khỏe, có ống hút",799000,799000,0,0
TIKI,the-thao-da-ngoai,163876934,"Dây đai bảo vệ xương bánh chè (đầu gối) 75589-SPO Actimove Patella Strap",390000,450000,60000,13
TIKI,the-thao-da-ngoai,46582501,"Dây Tập Yoga Cotton The Yogis' Shop",120000,120000,0,0
TIKI,the-thao-da-ngoai,129260807,"Dụng Cụ Con Lăn Tập Cơ Bụng 4 Bánh Tăng Cơ Giảm Mỡ, Chịu Lực Tốt - Tặng Kèm Thảm Tập - Hàng Chính Hãng MINIIN",121000,164000,43000,26
TIKI,the-thao-da-ngoai,43842441," Cần câu cá chất liệu carbon cao cấp đen - Cần câu 3m6 - Tặng kèm 6 phụ kiện DCH 07",219000,219000,0,0
TIKI,the-thao-da-ngoai,88042590,"Bảo vệ khuỷu tay Rhino P7546 (1 Đôi) giảm chấn thương khi chơi thể thao, bóng đá, bóng rổ, bóng chuyền - Hàng chính hãng dành cho cả nam và nữ",91000,128000,37000,29
TIKI,the-thao-da-ngoai,24076280,"Thảm tập swing golf - PGM  (1M x 1,25M): Thế hệ mới, đàn hồi tốt, chịu lực cao",790000,900000,110000,12
TIKI,the-thao-da-ngoai,24155965,"giày Cầu Lông - Trắng Sọc Xanh - 42",245000,245000,0,0
TIKI,the-thao-da-ngoai,6558333,"Bật Lửa Zippo Armor High Polished Brass 169",945000,945000,0,0
TIKI,the-thao-da-ngoai,142427809,"Túi Hút Ẩm Khử Mùi Giày Dép Giày Patin Centosy Than Tre Hoạt Tính",89000,89000,0,0
TIKI,the-thao-da-ngoai,102577220,"Bộ Đôi Găng Tay Đu Xà Đơn, Bao Tay Tập Tạ, Tập Gym Hở Mu VALEO - Hàng Chính Hãng",229000,239000,10000,4
TIKI,the-thao-da-ngoai,176530260,"Đai Quấn Cổ Chân Có Dây Cố Định Giầy 4 Vị Trí Móc Hỗ Trợ Tập Chân Mông Với Cáp Tại Phòng GYM (1 Đôi)",145000,145000,0,0
TIKI,the-thao-da-ngoai,194463222,"Thảm Tập Yoga Định Tuyến TPE cao cấp tặng kèm túi đựng - Thảm yoga chống trượt chính hãng, Thảm Tập Yoga, Thảm Tập Gym Định Tuyến TPE dododios, Thảm Yoga Chống Trượt",151000,151000,0,0
TIKI,the-thao-da-ngoai,7698241,"Băng bảo vệ ngón tay khi chơi bóng rổ AOLIKES YE-1589",76000,109000,33000,30
TIKI,the-thao-da-ngoai,144404494,"Găng Tay Aolikes A-113 | Găng Tay Nam Nữ Tập Gym, Tập Thể Thao Chính Hãng",150000,150000,0,0
TIKI,the-thao-da-ngoai,164582218,"Máy Tập Gym Đa Năng Azaki GF150",1150000,1150000,0,0
TIKI,the-thao-da-ngoai,77719395,"Ống tay chống nắng thể thao AOLIKES YE-7945 bảo vệ khủy tay Sport protection elastic arm",85000,175000,90000,51
TIKI,the-thao-da-ngoai,119967834,"Bánh lái Aztron 9" FIN NYLON AC-F103",380000,380000,0,0
TIKI,the-thao-da-ngoai,195880195,"Kệ gỗ bida cao cấp để góc loại 8 lỗ - Làm bằng gỗ tư nhiên-Made in Vietnam",2599000,2599000,0,0
TIKI,the-thao-da-ngoai,169003100,"(COMBO 6 GÓI) Gel Năng Lượng Gu Energy Roctane Vị Strawberry Kiwi - Dâu Kiwi Combo 6 Gói",360000,360000,0,0
TIKI,the-thao-da-ngoai,19584972,"Nút Bơi Nhét Tai View EP405",115000,180000,65000,36
TIKI,the-thao-da-ngoai,144404715,"Găng Tay Tập Gym Lifting Aolikes HW-7639 | Strap Aolikes",129000,129000,0,0
TIKI,the-thao-da-ngoai,192918246,"Áo Thun Thể Thao Nam G-Motion Tee Giordano 01022216",440000,440000,0,0
TIKI,the-thao-da-ngoai,53031100,"Giày Trượt Patin CenTosy kid pro 1 Tặng Bộ Bảo Vệ Tay Chân",1650000,1650000,0,0
TIKI,the-thao-da-ngoai,189557762,"Túi Đeo Hông,Đai Đeo Chạy Bộ Tập Thể Dục Phản Quang Chống Thấm Nước Cao Cấp Đại Nam Sport",68000,150000,82000,55
TIKI,the-thao-da-ngoai,190708757,"Dây Đàn Hồi Tập Mông & Chân Zasami theo lực kéo",99000,285000,186000,65
TIKI,the-thao-da-ngoai,21551827,"Bó gối thể thao và chấn thương chỉnh hình cao cấp Actimove GenuMotion",1200000,1300000,100000,8
TIKI,the-thao-da-ngoai,180584846,"Gậy Bóng Chày Nhôm Thể Thao Dài 81cm 32 inch Nặng 1.2kg Cao Cấp Đại Nam Sport (Hàng Loại 1)",169000,250000,81000,32
TIKI,the-thao-da-ngoai,114254759,"Dụng cụ hỗ trợ khuỷu tay BODY SCULPTURE - BNS-3105E-B",125000,125000,0,0
TIKI,the-thao-da-ngoai,2282613,"Bấc Zippo",45000,45000,0,0
TIKI,the-thao-da-ngoai,7149245,"Đế Nam Châm Chuyên Dụng Zippo 142226",200000,200000,0,0
TIKI,the-thao-da-ngoai,4307227,"Đai Nẹp Cố Định Khớp Cổ Tay Cao Cấp AOLIKES TC-1676",95000,209000,114000,55
TIKI,the-thao-da-ngoai,41297385,"Đai Cố Định Đầu Gối Bonbone Thin PF Cross Belts ( free size)",675000,1000000,325000,33
TIKI,the-thao-da-ngoai,1916159,"Ván Trượt Thể Thao Mặt Nhám Đen",143000,143000,0,0
TIKI,the-thao-da-ngoai,76047504,"Bóng tập Yoga Bóng Yoga Tròn Cỡ Đại 65cm Cao Cấp BG (hàng nhập khẩu)",90000,189000,99000,52
TIKI,the-thao-da-ngoai,684687,"Kính Bơi Phoenix 203 - Đen + Tặng nón bơi (Giao màu ngẫu nhiên)",149000,149000,0,0
TIKI,the-thao-da-ngoai,98058931,"Giày chạy bộ thành phố SONIC 3 ACCELERATE HAWAIIAN OCEAN L40970100",2070000,3450000,1380000,40
TIKI,the-thao-da-ngoai,109654954,"Băng đô thể thao silicone AOLIKES YE-2113 chặn mồ hôi trán Sport sweat band",159000,159000,0,0
TIKI,the-thao-da-ngoai,133265811,"Phụ kiện dây nối dài bình gas mini Campingmoon Z17",300000,300000,0,0
TIKI,the-thao-da-ngoai,174849393,"Bộ Dây Đàn Hồi Ngũ Sắc Tập Gym Đa Năng  11chi tiết, gọn nhẹ có thể mang đi lại bất kỳ nơi đâu, không bị gò bó về không gian và thời gian - tặng kèm túi đựng và hướng dẫn(móc to)",110000,220000,110000,50
TIKI,the-thao-da-ngoai,135458995,"Lều Naturehike - Mongar dã ngoại siêu nhẹ 2 người NH17T007-M",3250000,3250000,0,0
TIKI,the-thao-da-ngoai,151661494,"Túi Trống Tập Gym, Túi Thể Thao VNSPORT VN8036",390000,450000,60000,13
TIKI,the-thao-da-ngoai,19791192,"Băng khuỷu tay tennis United Medicare (G14)",220000,300000,80000,27
TIKI,the-thao-da-ngoai,161212398,"Dây Kháng Lực Đeo Tay Hỗ Trợ Tập Ngực VNSPORT - VN102",250000,450000,200000,44
TIKI,the-thao-da-ngoai,113000579,"[MUA 1 TẶNG 1] Set bộ thể thao nam TENNIS NEWP06 cao cấp, chất lượng, chuẩn form, hàng chính hãng",309000,309000,0,0
TIKI,the-thao-da-ngoai,26149978,"Băng bảo vệ cánh tay thể thao cao cấp Futuro 80201 size S/M",160000,160000,0,0
TIKI,the-thao-da-ngoai,181712934,"Dụng Cụ Nhảy Dây Tập Thể Dục Chất Liệu PVC 2m7 Tùy Ý Điều Chỉnh Kích Thước - Chính Hãng",49000,78000,29000,37
TIKI,the-thao-da-ngoai,69465895,"Túi Đựng Gậy Tập Golf Có Chân Chống - PGM QIAB008",750000,1195000,445000,37
TIKI,the-thao-da-ngoai,1832031,"Dây Dù Dã Ngoại Loại Dày DDT79",74000,74000,0,0
TIKI,the-thao-da-ngoai,71196943,"Băng Cổ Tay PJ - Mã 633",35000,35000,0,0
TIKI,the-thao-da-ngoai,184578657,"Thảm tập Golf PGM Putting Trainer chất liệu nhựa - TL004",1050000,1050000,0,0
TIKI,the-thao-da-ngoai,74171306,"Dây đeo thảm yoga Reebok  Mat Carry Strap - RAYG-10024",300000,375000,75000,20
TIKI,the-thao-da-ngoai,133139522,"Quả bóng rổ Spalding Đà Nẵng Dragons Size 7- Tặng kim bơm bóng và túi lưới đựng bóng",400000,400000,0,0
TIKI,the-thao-da-ngoai,114011212,"Dây Kháng Lực Tập Mông ️MiniBand Chính Hãng Aolikes chất liệu vải polyeste cotton",65000,65000,0,0
TIKI,the-thao-da-ngoai,148000782,"[CHỌN MÀU] THẢM TẬP YOGA, GYM 2 LỚP+ TÚI ĐỰNG THẢM TẬP YOGA + DÂY BUỘC CHUYÊN DỤNG - CHÍNH HÃNG DODODIOS",174000,174000,0,0
TIKI,the-thao-da-ngoai,91834819,"Phao Tập Bơi Chính Hãng SWIMTRAINER Đỡ Lưng Chống Lật Cho Bé Từ 2 Tuổi Đến 6 Tuổi màu CAM",660000,660000,0,0
TIKI,the-thao-da-ngoai,176172294,"Bóng rổ Da Molten B7G3800-Q2Z số 7",999000,999000,0,0
TIKI,the-thao-da-ngoai,48888722,"Găng Tay Boxing BN 3.0 - Xanh",490000,490000,0,0
TIKI,the-thao-da-ngoai,177492654,"Bi sắt dùng tập luyện và thi đấu môn bi sắt chuyên nghiệp",850000,1037000,187000,18
TIKI,the-thao-da-ngoai,193006737,"Đai quấn bảo vệ đầu gối AOLIKES A-7912 spring sport knee support",162000,319000,157000,49
TIKI,the-thao-da-ngoai,194017511,"Ron cao su họng Group máy Breville 870 / 878 - Hàng chính hãng",220000,220000,0,0
TIKI,the-thao-da-ngoai,59524501,"Băng đô thể thao nam nữ tập gym - yoga bản to 6-8cm TB09 (chọn mẫu)",22000,22000,0,0
TIKI,the-thao-da-ngoai,138029690,"Băng Đầu Gối Silicon Thể Thao, Bó gối tập Gym 4 lò xo trợ lực Aolikes A-7618",99000,99000,0,0
TIKI,the-thao-da-ngoai,144404778,"Dây Mini Band Cao Su Kháng Lực Aolikes A-3601 | Dây Miniband Tập Mông Đùi, Bộ 6 Dây Giá Cực Shock",29000,29000,0,0
TIKI,the-thao-da-ngoai,3121031,"Bật Lửa Zippo Spectrum (Bảy Màu)",790000,790000,0,0
TIKI,the-thao-da-ngoai,16942870,"Đai Bảo Vệ Hỗ Trợ Khủy Tay, Cánh Tay Thể Thao Breathable Sport Elbow Support AOLIKES YE-7948 - Hàng Chính Hãng",143000,259000,116000,45
TIKI,the-thao-da-ngoai,70637181,"BĂNG KHỚP GỐI MUELLER 57927 (QUAI ĐEO DỆT ITB)",465000,499000,34000,7
TIKI,the-thao-da-ngoai,192766039,"Giày bóng đá Wika Ultra 4 sân phủi cao cấp 2023",229000,229000,0,0
TIKI,the-thao-da-ngoai,112987435,"[MUA 1 TẶNG 1] Set bộ Nữ Thể thao  - NEW12 Vina Authentic chất đẹp, chuẩn dáng, thấm hút mồ hôi",325000,325000,0,0
TIKI,the-thao-da-ngoai,170112507,"Giày bóng đá phủi chính hãng Wika 3 Sọc Trắng",182000,182000,0,0
TIKI,the-thao-da-ngoai,193512475,"Bộ 2 ống tay chống nắng bảo vệ khuỷu tay AOLIKES A-7146 Sport Arm Sleeve",114000,209000,95000,45
TIKI,the-thao-da-ngoai,144404222,"Dây Kháng Lực Miniband Tập Mông Aolikes A-3604",100000,100000,0,0
TIKI,the-thao-da-ngoai,1082740,"Găng Tay Boxing Trẻ Em BN BG-BN-CB (Size 6oz)",380000,380000,0,0
TIKI,the-thao-da-ngoai,107461390,"Phao bơi võng nước gấp gọn",99000,99000,0,0
TIKI,the-thao-da-ngoai,167422214,"Tạ bình vôi Reefit cao cấp 10kg",665000,665000,0,0
TIKI,the-thao-da-ngoai,193717009,"Combo thảm tập yoga 6mm 2 lớp + bóng tập yoga cao cấp (Kèm túi đựng thảm và bơm bóng) - Chính hãng dododios",563000,563000,0,0
TIKI,the-thao-da-ngoai,14643396,"Đai Quấn Lưng Aolike A7990 Bảo Vệ Cột Sống,Chống Thoát Vị Đĩa Đệm Chính Hãng Hàng Nhập Khẩu",191000,219000,28000,13
TIKI,the-thao-da-ngoai,196201889,"Bộ 2 nẹp định hình ngón chân cái AOLIKES A-1051 Correcting Belt Of Thumb",277000,389000,112000,29
TIKI,the-thao-da-ngoai,4495259,"Bóng tập Yoga có gai 85cm Sportslink",199000,328000,129000,39
TIKI,the-thao-da-ngoai,101628282,"Ghế đẩu xếp ba chân dã ngoại Desert&Fox DF-S089",105000,189000,84000,44
TIKI,the-thao-da-ngoai,114791362,"Hộp quả bóng bàn 3 banh Sportslink Bokai",39000,40000,1000,3
TIKI,the-thao-da-ngoai,1598305,"Băng Quấn Bảo Vệ Đầu Gối Liton Đại Nam Sport 807",77000,140000,63000,45
TIKI,the-thao-da-ngoai,71326851,"Giày đạp xe Giro Cadet",3550000,3550000,0,0
TIKI,the-thao-da-ngoai,141492589,"Dây nhảy thể thao lõi thép cao cấp Rhino J601 tự động đếm số, đếm giờ, tích hợp đo calo, quãng đường, độ dài dây tùy chỉnh - Dùng cho Muay | Boxing | Kickboxing - Hàng chính hãng",91000,115000,24000,21
TIKI,the-thao-da-ngoai,195304885,"TÚI CẦM TAY GOLF | NASON",750000,750000,0,0
TIKI,the-thao-da-ngoai,92321484,"Tạ Bình Vôi,Tạ Quai Xách 8kg Bằng Gang Đúc Nguyên Khối Hàng Việt Nam Chất Lượng Cao",358000,600000,242000,40
TIKI,the-thao-da-ngoai,181908884,"Quần ngắn thể thao nam Under Armour GOLF - DRIVE - 1364409-100",1950000,1950000,0,0
TIKI,the-thao-da-ngoai,151547372,"Găng đấm boxing Everlast 12oz",169000,169000,0,0
TIKI,the-thao-da-ngoai,196243422,"Dây Nhảy Thể Thao Thông Minh Xiaomi YMSR-P701- PRO (Yunmai Smart Rope) Hàng Chính Hãng",690000,690000,0,0
TIKI,the-thao-da-ngoai,119398317,"Bộ Dụng Cụ Hít Đất Chống Đẩy Đa Năng 14 trong 1 PUSH UP Tập Cơ Ngực Vai Tại Nhà",155430,212421,56991,27
TIKI,the-thao-da-ngoai,34593177,"Bình Lắc Thể Thao Inox TC Sport Food 750ml - Nhiều Màu - Không Giữ Nhiệt",139000,199000,60000,30
TIKI,the-thao-da-ngoai,16554855,"TÚI GOLF XÁCH TAY CAO CẤP PGM - YWB024",2386000,2485000,99000,4
TIKI,the-thao-da-ngoai,159824504,"Kính bơi bé trai Zoggs Batman Character - 382436",495000,555000,60000,11
TIKI,the-thao-da-ngoai,72866081,"Bảo Hộ Răng, Ngậm Răng thi đấu Boxing cao cấp, Chính Hãng BN, KHÔNG độc hại, KHÔNG mùi 100%, KHÔNG gây hạn chế đường thở",150000,150000,0,0
TIKI,the-thao-da-ngoai,86146116,"Bật Lửa Zippo 260 Khắc Cá Chép Vượt Vũ Môn Quan – Zippo 260.Cachepvmq",980000,980000,0,0
TIKI,the-thao-da-ngoai,165002455,"Bóng Tập Yoga - Bóng Tập Thể Hình Glofit GFY001 - Xanh Dương (Blue Yoga Ball)",390000,490000,100000,20
TIKI,the-thao-da-ngoai,16555046,"Túi Gậy Tập Golf Có Chân Chống - PGM Golf Stents Gun Bag - QIAB008",946000,985000,39000,4
TIKI,the-thao-da-ngoai,24836241,"Đai Hỗ Trợ Bảo Vệ Khớp Vai Cao Cấp Sport Shoulder Support AOLIKES YE-1693",210000,389000,179000,46
TIKI,the-thao-da-ngoai,3641905,"Đai Quấn Bảo Vệ Hỗ Trợ Khuỷu Tay AOLIKES TC-7946",143000,169000,26000,15
TIKI,the-thao-da-ngoai,195230432,"Bóng lặn unisex Zoggs Dive Ball (2Pcs Per Set) - 465358",269000,269000,0,0
TIKI,the-thao-da-ngoai,77913129,"Bình lắc Shaker Muscletech 600ml màu đen, bình nước thể thao  - New Version - Nutrition Depot",190000,190000,0,0
TIKI,the-thao-da-ngoai,96137626,"Bộ 2 miếng bảo vệ đầu gối khi tập- Miếng đệm đầu gối thể thao cho cả nam và nữ 1 cặp",149000,149000,0,0
TIKI,the-thao-da-ngoai,172338420,"Dây nhảy Beaded rope KAT - Dây nhảy thể thao chuỗi hạt - Dây nhảy chuỗi hạt , beaded rope dây nhảy chuyên dụng tập luyện tốc độ và kỹ năng, skill, tricks. jump rope - Cleacco BORO SPORT",106000,215000,109000,51
TIKI,the-thao-da-ngoai,10411186,"Bộ 2 Đai Quấn Cổ Chân Hỗ Trợ Bảo Vệ Mắt Cá Chân Chống Lật Cổ Chân Khi Chơi Thể Thao AOLIKES YE-7130",277000,389000,112000,29
TIKI,the-thao-da-ngoai,2031501,"Tạ Nhập Khẩu TNK 1Kg",75000,113000,38000,34
TIKI,the-thao-da-ngoai,195479117,"Combo 2 vợt cầu lông trẻ em và hộp 12 cầu AOLIKES A-8123-12CAU",441000,859000,418000,49
TIKI,the-thao-da-ngoai,145388835,"[MUA 1 TẶNG 1] VÁY THỂ THAO NỮ VNQVN05 VINA AUTHENTIC CAO CẤP, MỀM MẠI, CO GIẢN, HỢP THỜI TRANG, CHUẨN THƯƠNG HIỆU",129000,129000,0,0
TIKI,the-thao-da-ngoai,26283796,"BÓNG TẬP GOLF PGM - Q003 - MÀU TRẮNG - 1 HỘP 10 QUẢ",190000,190000,0,0
TIKI,the-thao-da-ngoai,6986329,"Dây đàn hồi tập thể hình Mini band Aolikes AL3603",59000,59000,0,0
TIKI,the-thao-da-ngoai,192909067,"TẠ TAY SẮT BỌC CAO SU PROCARE",85000,88000,3000,3
TIKI,the-thao-da-ngoai,2282565,"Bộ 3 Xăng 3 Đá Zippo",430000,430000,0,0
TIKI,the-thao-da-ngoai,69459778,"TÚI ĐỰNG GẬY TẬP GOLF - PGM QIAB010",545000,545000,0,0
TIKI,the-thao-da-ngoai,5191203,"Băng gối thể thao cao cấp Scondak HJ001 Sportslink (Cái)",49000,64000,15000,23
TIKI,the-thao-da-ngoai,195527630,"Găng tay tập gym hở mu AOLIKES A-7639 Sport Wrist Bands",201000,309000,108000,35
TIKI,the-thao-da-ngoai,167422345,"Bộ 2 tạ tay cao su Reefit 2.5kg màu đen (gồm 2 tạ 2.5kg, tổng 5kg)",325000,325000,0,0
TIKI,the-thao-da-ngoai,95204528,"Bộ 4 Cọc Cắm Lều Bạt Tăng Che Galaxy Store GSCL01 - Hàng Chính Hãng",84000,120000,36000,30
TIKI,the-thao-da-ngoai,33275662,"Đai Chống Gù Lưng Cải Thiện Cột Sống Nhập Khẩu Aolikes",135000,135000,0,0
TIKI,the-thao-da-ngoai,101650843," Nồi Treo Nấu Ăn 4L/ 4-6 Người Naturehike Dành Cho Du Lịch Ngoài Trời  NH17D021-G",420000,420000,0,0
TIKI,the-thao-da-ngoai,144405006,"Miếng đệm đầu gối tập GYM, Bóng đá, Trượt Patin, thể thao khác cho nữ chính hãng AOLIKES A-0210 ( 1 đôi)",99000,99000,0,0
TIKI,the-thao-da-ngoai,16554842,"Túi Hàng Không Golf - PGM Golf Air Package - HKB002 - Màu Đen",626000,645000,19000,3
TIKI,the-thao-da-ngoai,2610477,"Đai bảo vệ đầu gối hỗ trợ xương bánh chè AOLIKES TC-7929",143000,219000,76000,35
TIKI,the-thao-da-ngoai,51059867,"Giày Patin Cougar 787 (Tặng Bảo Vệ)",1210000,1210000,0,0
TIKI,the-thao-da-ngoai,195786598,"(Quà tặng không bán) Bình lắc shaker cup Optimum Nutrition Shaker (giao màu ngẫu nhiên)",500000,500000,0,0
TIKI,the-thao-da-ngoai,35508210,"Nón Thể Thao Xa Cap Fjord Blue - LC1151500",690000,690000,0,0
TIKI,the-thao-da-ngoai,74177121,"Băng bảo vệ khuỷu tay Reebok Elbow Support - RRSU-1352",356000,445000,89000,20
TIKI,the-thao-da-ngoai,2500603,"Băng Trán Thể Thao Cao Cấp AOLIKES (Màu",29900,29900,0,0
TIKI,the-thao-da-ngoai,114004223,"(COMBO 6 GÓI) GU Energy Gel Năng Lượng Hỗ Trợ Tăng Sức Bền Vị STRAWBERRY BANANA - Combo 6 Gói",230000,230000,0,0
TIKI,the-thao-da-ngoai,74794164,"[MUA 1 TẶNG 1] Áo Thun Thể Thao Nữ Vina Authentic  AVT06W Cầu Lông, Tennis, chất vải dệt jacka thấm hút mồ hôi tốt",179000,179000,0,0
TIKI,the-thao-da-ngoai,173885567,"Phao bơi xỏ chân tạo hình Thiên Nga có mái che DPZC5 Sportslink",190000,345000,155000,45
TIKI,the-thao-da-ngoai,167422245,"Dây Tập Kháng Lực Powerband Tập Toàn Thân Đa Năng Chính Hãng Reefit cao cấp",185000,185000,0,0
TIKI,the-thao-da-ngoai,174860109,"Phụ Kiện Xà đơn,2 Mút xà đơn cao su đầu hình lục giác,phụ kiện xà đơn(Bộ 2 miếng mút)",39500,79000,39500,50
TIKI,the-thao-da-ngoai,16178335,"Kính bơi Phoenix Hàn Quốc PN506 dành cho trẻ em, mầu xanh",110000,110000,0,0
TIKI,the-thao-da-ngoai,72291058,"Bộ Tập Luyện Hít Đất Chống Đẩy Đa Năng 20 Lỗ Đại Nam Sport + Kèm Găng Tay Tập Gym",179000,400000,221000,55
TIKI,the-thao-da-ngoai,188915646,"Áo POLO thể thao nam Fasvin PL21458.HN vải Askin cao cấp co giãn thoải mái",99000,379000,280000,74
TIKI,the-thao-da-ngoai,73894870,"GIÀY ĐÁ BANH VẢI CP004 MÀU ĐEN XANH LÁ MAY ĐẾ",150000,150000,0,0
TIKI,the-thao-da-ngoai,101454333,"Thảm ngủ du lịch, thảm dã ngoại ngoài trời Hewolf HW - 1892",450000,450000,0,0
TIKI,the-thao-da-ngoai,150873011,"Quần thể dục lưng thun nam nữ, dây rút, phối ba sọc, vải cotton hút mồ hôi, co giãn dễ vận động, Amazing",81000,125000,44000,35
TIKI,the-thao-da-ngoai,164165036,"GIÀY THỂ THAO GOLF NAM - PGM - XZ070 - Đinh tán bóng được cấp bằng sáng chế,  chống trượt - Dây giày xoay BOA thông minh, khung ngoài trên hiệu suất cao - Vải nylon chống thấm nước 1680D - Làm nên bước đi tự tin và sang trọng",2650000,2650000,0,0
TIKI,the-thao-da-ngoai,144404504,"Đai Dán Eo Nữ Aolikes HY-7980B | Đai Nịt Bụng Hỗ Trợ Tập Gym, Yoga Chính Hãng",139000,139000,0,0
TIKI,the-thao-da-ngoai,173867272,"Phao bơi tròn in hoạ tiết vòng xoắn Colorful Sportslink",75000,99000,24000,24
TIKI,the-thao-da-ngoai,35193484,"Gậy Putter Golf G300 - PGM TUG025",754000,785000,31000,4
TIKI,the-thao-da-ngoai,9848700,"Áo dã ngoại NOMAD SS SHIRT W Blush Pu - L37975900",768000,1280000,512000,40
TIKI,the-thao-da-ngoai,129069096,"Túi Nước Thể Thao 2L - Dùng Trong Chạy Bộ, Đạp Xe, Thể Thao Ngoài Trời",73000,73000,0,0
TIKI,the-thao-da-ngoai,166328768,"Thảm tập Yoga định tuyến Sportslink Zera TPE 2 lớp 8mm (Việt Nam Sản Xuất)",560000,702000,142000,20
TIKI,the-thao-da-ngoai,84880397,"Kính Bơi Trẻ em SPEEDO",599000,599000,0,0
TIKI,the-thao-da-ngoai,71160328,"Băng Gót Thể Thao PJ 4 chiều - Mã 954",65000,65000,0,0
TIKI,the-thao-da-ngoai,95064323,"Quần thể thao bendu nhẹ nhàng thoáng mát QB2002",107000,107000,0,0
TIKI,the-thao-da-ngoai,142262676,"[Siêu Sáng] Đèn Pin Đội Đầu KhoNCC Hàng Chính Hãng - 2 Chế Độ Ánh Sáng Cho Du Lịch, Đi Câu, Soi Sửa Chữa, Đồng Áng Hoặc Khi Cúp Điện - KDHS-5894-DDD50",89000,158000,69000,44
TIKI,the-thao-da-ngoai,86146376,"Bật Lửa Zippo 24096 Zippo Zl",800000,800000,0,0
TIKI,the-thao-da-ngoai,197365826,"Bộ 5 dây kháng lực đàn hồi tập đa năng tại nhà AOLIKES A-3909 Tension Rope",335000,689000,354000,51
TIKI,the-thao-da-ngoai,48462344,"BĂNG KHUỶU TAY MUELLER 70207",581000,663000,82000,12
TIKI,the-thao-da-ngoai,149459709,"Băng cổ tay chấn thương và thể thao Actimove ManuWrap",350000,450000,100000,22
TIKI,the-thao-da-ngoai,195192568,"Quần short thể thao nam Fasvin S22491.HN chất liệu cao cấp mềm mịn thoải mái",209000,229000,20000,9
TIKI,the-thao-da-ngoai,5739753,"Chai lăn làm nóng cơ (Roll-On Warm) Starbalm - Hà Lan 75ml",190000,190000,0,0
TIKI,the-thao-da-ngoai,181108051,"Con lăn tập gym unisex Triggerpoint Mini 12" - 21126",579000,579000,0,0
TIKI,the-thao-da-ngoai,643738,"Bảng Phi Tiêu Sportslink PT28.6CM (28.6cm)",115000,143000,28000,20
TIKI,the-thao-da-ngoai,253393489,"COMBO 02 Sản Phẩm Tập Yoga Tại Nhà  BG: Vòng tập Yoga 33x13 cm + Thảm tập 4mm (hàng nhập khẩu)",139000,299000,160000,54
TIKI,the-thao-da-ngoai,173786272,"Dây Cáp Thép Phi 6mm CHO CHẠY BỘ TRÊN KHÔNG ToanAnh - TA-L601 - 1 sợi",270000,270000,0,0
TIKI,the-thao-da-ngoai,2500879,"Găng tay thể hình bảo vệ cổ tay khi tập tạ, gym, bóng rổ AOLIKES (1 Đôi)",162000,259000,97000,37
TIKI,the-thao-da-ngoai,181108113,"Bóng unisex Triggerpoint Mobipoint - 203937",259000,259000,0,0
TIKI,the-thao-da-ngoai,195162842,"Túi đựng Điện Thoại chạy bộ tới 6.5 Inch Bao đeo tay chạy bộ ,Tập thể dục eXtreme TB101 Kháng nước, chống thấm, có jack cắm tai nghe phù hợp điện thoại - Hàng chính hãng",89500,179000,89500,50
TIKI,the-thao-da-ngoai,162978612,"Lưới Bóng Bàn DHS Chính Hãng - Bộ Cọc Lưới Chính Hãng DHS Cao Cấp -  Đầy Đủ Phụ Kiện",525000,525000,0,0
TIKI,the-thao-da-ngoai,33401060,"Găng Tay Tập GYM Lifting Grips Aolikes Pro Hở Mu Bàn Tay (1 Đôi) ",145000,145000,0,0
TIKI,the-thao-da-ngoai,170125122,"MLB - Giày thể thao Big Ball Chunky A 3ASHC101N-50BGS",2490000,2490000,0,0
TIKI,the-thao-da-ngoai,143175393,"Dây Nhảy Thể Dục Thể Thao 2.8M  Không Dây/Có Dây Điều Chỉnh Độ Dài 2 trong 1 Agnite - YOGA Gym, Hỗ Trợ Luyện Tập Thể Dục Tại Nhà, Giảm Cân , Phù Hợp Mọi Không Gian, Màu Sắc Đa Dạng - Hàng Chính Hãng - F4143",105000,196200,91200,46
TIKI,the-thao-da-ngoai,69898711,"KHAY ĐỰNG BÓNG GOLF CHỨA TỐI ĐA 100 BÓNG - PGM QK002 100 Balls Tray",340000,340000,0,0
TIKI,the-thao-da-ngoai,93289789,"Bộ Tạ Tay 2kg Bọc Cao Su Trơn Lõi Thép Cao Cấp Chính Hãng Đại Nam Sport (Tổng 4kg)-Giao Màu Ngẫu Nhiên",149000,400000,251000,63
TIKI,the-thao-da-ngoai,6704433,"Bật Lửa Zippo Three Monkeys Black Matte 29409",1300000,1300000,0,0
TIKI,the-thao-da-ngoai,47141679,"QUE ĐỊNH HƯỚNG TẬP GOLF - PGM PENDULUM PUTTING ROD - JZQ013",203000,225000,22000,10
TIKI,the-thao-da-ngoai,44926175,"Bó gối đai dán có nẹp neoprene -compact United Medicare F16",550000,650000,100000,15
TIKI,the-thao-da-ngoai,158577255,"Ghế xếp dã ngoại du lịch dã ngoại cắm trại gấp gọn tiện lợi Ghế du lịch gấp gọn có khay cốc, túi đựng, thư giãn nghỉ trưa, đi phượt - Hàng Chính Hãng",649000,950000,301000,32
TIKI,the-thao-da-ngoai,112128883,"Iso Pro 8lbs Dòng Whey Protein 100% Hydrolyzed 0 Đường Tinh Khiết Từ Vitaxtrong",2390000,2390000,0,0
TIKI,the-thao-da-ngoai,75767358,"Xà Đơn Treo Tường Đa Năng Di Động 8 Trong 1 Tập Luyện Tại Nhà Chính Hãng Đại Nam Sport + Kèm Găng Tay Tập Xà",1092000,2500000,1408000,56
TIKI,the-thao-da-ngoai,193925960,"Xe đạp tập thể dục trong nhà Toshiko Z11, xe đạp thể thao có đồ hồ hiển thị quãng đường, calo tiêu thụ, giảm mỡ, săn chắc cơ thể",4190000,9331000,5141000,55
TIKI,the-thao-da-ngoai,136240925,"Băng Trợ Lực Cổ Tay VNSPORT - GF066 , Băng Cổ Tay Tập Gym Kết Hợp Các Bộ Môn Thể Thao Trên Cạn, Băng Cuốn Cổ Tay Cao Cấp VNSPORT Rất Êm - Có Độ Co Giãn Đàn Hồi Cao ( 1 Đôi )",140000,160000,20000,13
TIKI,the-thao-da-ngoai,10075789,"Thực phẩm bổ sung tăng cường năng lượng và sức mạnh Myprotein Impact Creatine Không mùi 500g - Nutrition Depot VN",890000,990000,100000,10
TIKI,the-thao-da-ngoai,193413270,"Quần tập yoga gym Luxury Hibi Sports QD313 kiểu lưng cao tôn dáng, chất vải cao cấp Hi Fabric",420000,560000,140000,25
TIKI,the-thao-da-ngoai,77249138,"COMBO 3 VẼ LINE BÓNG - PGM GOLF BALL LINE MARKER - HXQ001",146000,150000,4000,3
TIKI,the-thao-da-ngoai,7964066,"Ghế tập bụng cong có chốt gập SIT UP model 119 mới BG (hàng nhập khẩu)",627000,999000,372000,37
TIKI,the-thao-da-ngoai,740796,"Bóng Tập Yoga Trơn Best Sport DK075XANH (75cm) - Xanh Dương + Tặng Kèm Bơm",149000,149000,0,0
TIKI,the-thao-da-ngoai,186590310,"Đèn bão đèn dầu cổ điển cắm trại dã ngoại Baby Special 276 Feuerhand - Chính hãng Đức",1400000,1400000,0,0
TIKI,the-thao-da-ngoai,185813147,"Ghế Xếp Du Lịch Phượt Dã Ngoại, Ghế Cắm Trại Di Động Ngoài Trời Siêu Nhẹ",249000,400000,151000,38
TIKI,the-thao-da-ngoai,100917107,"VỢT CẦU LÔNG PROKENNEX LASER 7Z POWER ĐẲNG CẤP, CHÍNH HÃNG ( VỢT CHƯA BAO GỒM LƯỚI)",7678000,7678000,0,0
TIKI,the-thao-da-ngoai,111560162,"Iso Pro 5lbs 100% Hydrolyzed Dòng Whey Protein Hỗ Trợ Tăng Cơ - Giảm Mỡ Chính Hãng VitaXtrong",1720000,1720000,0,0
TIKI,the-thao-da-ngoai,58918951,"Bộ Tạ Tập Tay 2 in 1 Kết Hợp Tạ Đẩy (20kg) Đa Năng ",530000,800000,270000,34
TIKI,the-thao-da-ngoai,68584884,"Tạ tập tay đẩy kết hợp, 20 KG tạ nam nữ tập gym tập thon tay",459000,918000,459000,50
TIKI,the-thao-da-ngoai,2282535,"Bật Lửa Zippo Replica 1941 Brushed Chrome",965000,965000,0,0
TIKI,the-thao-da-ngoai,108480848,"Mã hàng KT1.1518 – Xà đơn xếp Khánh Trình dành cho người tập từ 1m40 đến 1m80 và nặng dưới 120kg",1580000,1580000,0,0
TIKI,the-thao-da-ngoai,188875718,"[Hàng chính hãng – Thương hiệu Mỹ] Bình giữ nhiệt Elemental Iconic sport màu đen 590ml, giữ nhiệt vượt trội, inox 304, FDA Hoa Kì, An toàn sức khỏe",799000,799000,0,0
TIKI,the-thao-da-ngoai,38065102,"Găng Tay Boxing Trẻ Em Chính Hãng Amalife  - Găng Tay Đấm Bốc",99000,99000,0,0
TIKI,the-thao-da-ngoai,161454736,"Giày Thể Thao Nữ Biti's Hunter Street x VietMax | Bloomin' Central (1 ĐÔI GIÀY - 3 BIẾN THỂ) DSWH08400NAU (Phiên bản giới hạn Đồng xu cổ cho 999 đơn hàng đầu tiên)",1668000,1668000,0,0
TIKI,the-thao-da-ngoai,102401709,"GIÀY ĐÁ BÓNG SÂN CỎ NHÂN TẠO PEACE PS1216",289000,499000,210000,42
TIKI,the-thao-da-ngoai,189349963,"Giày đá bóng trẻ em Mira Pro KID Xanh Dương chính hãng, giày đá banh cỏ nhân tạo đẹp - PK002",345000,345000,0,0
TIKI,the-thao-da-ngoai,84204349,"Tấm Tăng Che Chống Nước Che Võng Che Lều Cắm Trại Lót Lều Dã Ngoại Phượt Picnic Đa Năng Cao Cấp Galaxy Store GSTC01S - Hàng Chính Hãng",346000,750000,404000,54
TIKI,the-thao-da-ngoai,74895602,"Cần câu cá Daiwa Crossfire X 702MHS - 2m13 cần lure máy đứng",651000,651000,0,0
TIKI,the-thao-da-ngoai,137672112,"Bộ Tạ Tay Đa Năng Điều Chỉnh 40kg Thiết Kế Mới Chính Hãng Đại Nam Sport + Tặng Găng Tay Tập Tạ",742000,1300000,558000,43
TIKI,the-thao-da-ngoai,192941702,"Giày Thể Thao Nam Hunter Core DSMH09900",657000,731000,74000,10
TIKI,the-thao-da-ngoai,77728978,"Giàn tạ đa năng kết hợp xà đơn xà kép Zasami 8211 ( chưa gồm  đòn và tạ ) ",4899000,7500000,2601000,35
TIKI,the-thao-da-ngoai,159648902,"Kính bơi trẻ em Zoggs Little Ripper - 304442",255000,255000,0,0
TIKI,the-thao-da-ngoai,6355379,"Dây nhảy thể dục tay cầm hợp kim nhôm cao cấp Aolikes AL3202",115000,115000,0,0
TIKI,the-thao-da-ngoai,179206622,"Giày cầu lông chính hãng Lining Thunder Lite AYTS020-1 mẫu mới màu trắng- tặng tất thể thao bendu",1350000,1350000,0,0
TIKI,the-thao-da-ngoai,78011804,"Thực phẩm bổ sung Myprotein Impact BCAA 2:1:1 500g - Phục hồi và phát triển cơ bắp tối ưu - Nutrition Depot Vietnam",720000,720000,0,0
TIKI,the-thao-da-ngoai,16256870,"Bật lửa Zippo Street Chrome Vintage with Slashes 267",680000,680000,0,0
TIKI,the-thao-da-ngoai,53515382,"Bóng rổ Molten BG3200",669000,669000,0,0
TIKI,the-thao-da-ngoai,43734943,"Cần câu tay -  Cần câu cá 3m6 cho người mới tập câu - Màu ngẫu nhiên  - Tặng kèm cước simano DCH08",119000,119000,0,0
TIKI,the-thao-da-ngoai,184235699,"Áo phao bơi Bbluv Naj",469800,540000,70200,13
TIKI,the-thao-da-ngoai,48303320,"Giày đá bóng Zocker ZTF SPACE 2001 Blue",569000,690000,121000,18
TIKI,the-thao-da-ngoai,81388421,"Dụng cụ cầm tay đa năng Leatherman Free T2 (8 tools)",1550000,1550000,0,0
TIKI,the-thao-da-ngoai,86145105,"Bật Lửa Vỏ Zippo Brushed Brass Chính Hãng - Không Kèm Ruột Zippo",525000,525000,0,0
TIKI,the-thao-da-ngoai,193619492,"Giày Thể Thao Nữ Biti's Hunter X DSWH09800KEL (Kem lợt)",653000,932000,279000,30
TIKI,the-thao-da-ngoai,68737991,"BỘ 30KG TẠ TAY 2in1 ,CAO CẤP ĐA NĂNG TIỆN DỤNG HÀNG ĐẸP GIÁ CHẤT ",599000,1198000,599000,50
TIKI,the-thao-da-ngoai,98151170,"18 HỘP BÓNG TENNIS  WILSON USOPEN  HỘP 4 TRÁI ",3690000,4090000,400000,10
TIKI,the-thao-da-ngoai,196826020,"Áo croptop ngắn tay tập Yoga Gym Hibi Sports CR814 kiểu basic, kèm mút ngực",360000,360000,0,0
TIKI,the-thao-da-ngoai,74630384,"PUMA - Quần legging nữ Feel It 7/8 517840",2230000,2230000,0,0
TIKI,the-thao-da-ngoai,188321934,"Giày chính hãng Mizuno Tennis Wave Exceed Tour 5 AC 61GA227040 màu đen mẫu mới dành cho nam-tặng tất thể thao bendu",3500000,3500000,0,0
TIKI,the-thao-da-ngoai,167422275,"Tạ tay cao su 5kg Reefit màu đen",279000,279000,0,0
TIKI,the-thao-da-ngoai,195865575,"PUMA - Áo polo nam thể thao ngắn tay Performance Training 521772",699000,999000,300000,30
TIKI,the-thao-da-ngoai,77911615,"Bình Lắc Shaker MyProtein 600ml màu trắng trong, bình nước thể thao - bi lắc bằng thép không gỉ, hòa tan bột dễ dàng",180000,180000,0,0
TIKI,the-thao-da-ngoai,132200701,"Đai Bó Gối Dài Aolikes A-7060 | Chân Chống Nặng, Bảo Vệ Gối, Giảm Chấn Thương Thể Thao Chính Hãng",95000,95000,0,0
TIKI,the-thao-da-ngoai,74511822,"Ván trượt Người Lớn Skateboard Mặt Nhám, Bánh Pu  Cỡ Đại 80x20+ Khung Hợp Kim Nhôm Chịu Lực(Nhiều Màu sắc)",299000,598000,299000,50
TIKI,the-thao-da-ngoai,94306627,"Quần thể thao 2 lớp tập gym cho nam Hibi Sports M101 - Lót trong bó cơ - Có túi trong",357000,550000,193000,35
TIKI,the-thao-da-ngoai,189349957,"Giày đá bóng trẻ em Mira Pro KID Đỏ chính hãng, giày đá banh cỏ nhân tạo đẹp - PK004",345000,345000,0,0
TIKI,the-thao-da-ngoai,174901354,"Áo thun tay ngắn thể thao nam Under Armour Streaker Run - 1361469-100",955000,955000,0,0
TIKI,the-thao-da-ngoai,160504900,"Kính bơi unisex Zoggs Bondi - 318815",255000,255000,0,0
TIKI,the-thao-da-ngoai,4419415," Bóng đá động lực FIFA Quality Pro UHV 2.07 Galaxy + Kèm kim bơm bóng  và lưới đựng bóng (đồng hành với V-league).",1850000,1850000,0,0
TIKI,the-thao-da-ngoai,17455054,"Băng đô chắn mồ hôi Just Fell Free (Dành cho hoạt động thể thao, tập yoga, gym)",79000,79000,0,0
TIKI,the-thao-da-ngoai,2872193,"Băng Trán Thể Thao Cao Cấp AOLIKES TC-2103",65000,65000,0,0
TIKI,the-thao-da-ngoai,73191201,"Con Lăn Tập Bụng Cleacco Tặng Kèm Thảm Mút Xốp Kê Gối BORO SPORT",102000,201000,99000,49
TIKI,the-thao-da-ngoai,2812943,"Áo Gió Thể Thao Nam Salomon Agile Jacket M - L39423900 Size",1440000,2400000,960000,40
TIKI,the-thao-da-ngoai,2030177,"Dây đai tập yoga sợi cotton LK25",45000,60000,15000,25
TIKI,the-thao-da-ngoai,2812359,"Quần Thể Thao Nữ Salomon Agile Short W - L40128200 Size",534000,890000,356000,40
TIKI,the-thao-da-ngoai,6593063,"Bật Lửa Zippo Slim Street Chrome 1607",535000,535000,0,0
TIKI,the-thao-da-ngoai,116665127,"Giày cầu lông Mira Lightning 19.1 Đỏ thể thao nam nữ chính hãng chất lượng - LI003",525000,525000,0,0
TIKI,the-thao-da-ngoai,164823067,"Bộ 2 tạ miếng nhựa Reefit 10kg màu đen có ruột (gồm 2 tạ 10kg)",175000,175000,0,0
TIKI,the-thao-da-ngoai,162478139,"Võng du lịch gấp gọn siêu nhẹ họa tiết Naturehike NH21DC004",489000,489000,0,0
TIKI,the-thao-da-ngoai,153633356,"Bật Lửa Zippo 49267 – Zippo Slim Iridescent",735000,735000,0,0
TIKI,the-thao-da-ngoai,114254173,"Thảm tập yoga YOGA/EXERCISE MAT BODY SCULPTURE - BB-8300DE-4MM-S (màu ngẫu nhiên)",295000,295000,0,0
TIKI,the-thao-da-ngoai,159853566,"Kính bơi trẻ em Zoggs Ripper Jnr - 461323",299000,309000,10000,3
TIKI,the-thao-da-ngoai,192736543,"Bật Lửa Zippo vỏ dày Armor đồng vàng phay CNC 360° vân sọc vuông – họa tiết 5 mặt",1250000,1250000,0,0
TIKI,the-thao-da-ngoai,58004254,"MỘT CẶP BĂNG THẤM MỒ HÔI TAY BABOLAT ( MÀU NGẪU NHIÊN )",199000,279000,80000,29
TIKI,the-thao-da-ngoai,8546365,"Áo thể thao Salomon Nữ Comet Plus SS Tee W - L40110600",576000,960000,384000,40
TIKI,the-thao-da-ngoai,155690374,"Máy Câu Cá Daiwa REVROS LT2500-XH",1000000,1000000,0,0
TIKI,the-thao-da-ngoai,102082368,"BÓNG ĐÁ FUTSAL MOLTEN F9A1510-LB",559000,559000,0,0
TIKI,the-thao-da-ngoai,2396575,"Áo Mưa Bộ Givi Rrs04",970000,970000,0,0
TIKI,the-thao-da-ngoai,102526125,"[GIÁ TỐT NHẤT] Bộ vòng xà tay Ring Dip -KHÁNH TRÌNH- Dụng cụ tập street workout",600000,600000,0,0
TIKI,the-thao-da-ngoai,68282694,"Bộ Tạ Tập Tay Đa Năng Điều Chỉnh 30kg  Kết Hợp Tạ Tay Và Tạ Đẩy - Đại Nam Sport",569000,1000000,431000,43
TIKI,the-thao-da-ngoai,107409302,"Giày tennis mẫu mới đẳng cấp siêu bền đẹp, êm ái, bám sân, thoáng khí",550000,550000,0,0
TIKI,the-thao-da-ngoai,70669052,"Bao Cát Đấm Bốc Nhồi Sẵn 3 Lớp Cao 120cm Đại Nam Sport Kèm Xích Treo + Găng Đấm Bốc Cao Cấp (Giao Màu Ngẫu Nhiên)",702000,1300000,598000,46
TIKI,the-thao-da-ngoai,794110,"Cặp Vợt Cầu Lông Cá Sấu Bông VCSB",145000,145000,0,0
TIKI,the-thao-da-ngoai,559369,"Dụng Cụ Tập Cơ Bụng Đa Năng Revoflex Xtreme HD-851",220000,291000,71000,24
TIKI,the-thao-da-ngoai,51996071,"Bật Lửa Zippo 49188 – Zippo Wolves Design 360° Black Ice",1405000,1405000,0,0
TIKI,the-thao-da-ngoai,195864640,"PUMA - Áo polo nam thể thao ngắn tay Performance Training 521772",699000,999000,300000,30
TIKI,the-thao-da-ngoai,162593222,"6 Quả Bóng Bàn Yinhe",90000,90000,0,0
TIKI,the-thao-da-ngoai,184858735,"Đèn Pin Đội Đầu 2 Bóng Siêu Sáng Q5 PaKaSa Kèm Sạc - Hàng Chính Hãng ",99000,118000,19000,16
TIKI,the-thao-da-ngoai,86145528,"Bật Lửa Zippo 29727 – Zippo Fusion Leaf High Polish Chrome",980000,980000,0,0
TIKI,the-thao-da-ngoai,72332625,"LÒ XO CỦA MÁY TẬP CƠ BỤNG SIX PACK CARE, MÁY TẬP BỤNG...TOANANH TA-01LX - 1 cái",98000,98000,0,0
TIKI,the-thao-da-ngoai,77242473,"BĂNG QUẤN BẢO VỆ NGÓN TAY CHƠI GOLF - PGM ZP005",466000,485000,19000,4
TIKI,the-thao-da-ngoai,83782806,"Chén ăn dã ngoại inox không rỉ Campingmoon S220",120000,120000,0,0
TIKI,the-thao-da-ngoai,16257217,"Bật lửa Zippo High Polish Chrome 250",755000,755000,0,0
TIKI,the-thao-da-ngoai,167019941,"Mái chèo Aztron SONIC Carbon 100 3-Section AC-P411 2022",4000000,4000000,0,0
TIKI,the-thao-da-ngoai,109650676,"Bộ 3 dây kháng lực loại dài AOLIKES A-3607-3 Resistance Bands",412000,809000,397000,49
TIKI,the-thao-da-ngoai,191652638,"Túi đeo hông chạy bộ PU cao cấp - Running Belt - WB1120",250000,250000,0,0
TIKI,the-thao-da-ngoai,2282541,"Bật Lửa Zippo Brushed Chrome Pipe",735000,735000,0,0
TIKI,the-thao-da-ngoai,1993097,"Xà Đơn Khoan Tường KenSport ZP5",650000,650000,0,0
TIKI,the-thao-da-ngoai,46625749,"Bình Nước Thể Thao Chute Mag Camelbak 750ml",375000,375000,0,0
TIKI,the-thao-da-ngoai,197627993,"Tăng sức mạnh cơ bắp Optimum Nutrition Micronized Creatine Powder 300g",460000,460000,0,0
TIKI,the-thao-da-ngoai,22099706,"Xà Đơn Cho Trẻ Em Và Người Lớn - Xà Đơn Xếp Khánh Trình KT1.HT",1820000,1820000,0,0
TIKI,the-thao-da-ngoai,195781103,"Đèn Pin Đội Đầu Cắm Trại TD-02 Naturehike NH00T002-D",395000,395000,0,0
TIKI,the-thao-da-ngoai,58398282,"Giày Đá Bóng Futsal Chí Phèo",336000,336000,0,0
TIKI,the-thao-da-ngoai,167011051,"MLB - Giày thể thao Bigball Chunky Monogram 3ASHCM11N",3490000,3490000,0,0
TIKI,the-thao-da-ngoai,6729547,"Bật Lửa Zippo Serenity Prayer Satin Chrome 28458",835000,835000,0,0
TIKI,the-thao-da-ngoai,768862,"Quần Short Thể Thao Nữ Just Feel Free H7570  - Trắng Đen",349000,349000,0,0
TIKI,the-thao-da-ngoai,170110906,"2 chiếc giày bóng đá phủi Wika 3 sọc đỏ 2022",182000,182000,0,0
TIKI,the-thao-da-ngoai,167422295,"Bộ 2 tạ tay cao su Reefit màu đen 5kg (gồm 2 cục)",560000,560000,0,0
TIKI,the-thao-da-ngoai,22246819,"Nón chạy bộ XA CAP URBAN CHIC",690000,690000,0,0
TIKI,the-thao-da-ngoai,162752557,"Giày Bata Thể Thao, Chạy Bộ, Cầu Lông, Bóng Bàn, Bóng Chuyền, Đá Bóng - Phong Cách Lính Bộ Đội",250000,250000,0,0
TIKI,the-thao-da-ngoai,173711103,"Phao Tay Bơi Xịn - siêu dày (30cm x 15cm)",57000,57000,0,0
TIKI,the-thao-da-ngoai,21120323,"Cần Câu 2 Khúc Máy Đứng Daiwa Sweepfire 702MFS 2m14",355000,355000,0,0
TIKI,the-thao-da-ngoai,2599093,"Đai quấn bảo vệ đầu gối thể thao AOLIKES TC-7912",162000,289000,127000,44
TIKI,the-thao-da-ngoai,6735109,"Bật Lửa Zippo Butterflies Spectrum Chrome 28442",880000,880000,0,0
TIKI,the-thao-da-ngoai,56855277,"Bộ đai lưng tập gym và dây kéo lưng quấn cổ tay YE-7983-7638 hỗ trợ nâng tạ - Hàng Chính Hãng",450000,669000,219000,33
TIKI,the-thao-da-ngoai,20847685,"Bật lửa Zippo 28886 –Bật lửa Zippo Neon Pink Matte",735000,735000,0,0
TIKI,the-thao-da-ngoai,198334313,"Đai bảo vệ đầu gối hỗ trợ xương bánh chè AOLIKES A-7928 Sport compression patella band",153000,259000,106000,41
TIKI,the-thao-da-ngoai,127834631,"[Trả góp 0% tới 12 tháng] Máy chạy bộ đa năng tại nhà Toshiko MC55, chức năng nâng dốc tự động theo nhu cầu, băng tải rộng, chống trơn trượt, kèm theo đai massage và thanh gập bụng, đồng hồ hiển thị thông số nhịp tim, calo tiêu thụ",9790000,10825000,1035000,10
TIKI,the-thao-da-ngoai,193268444,"Băng đầu gối, bó gối thể thao đàn hồi GoodFit GF518K",130000,130000,0,0
TIKI,the-thao-da-ngoai,121064335," Găng Tay Golf & Mark Bóng - PGM Gloves With Marker - ST021 thuận trái- Đeo tay phải- 1 chiếc",427000,445000,18000,4
TIKI,the-thao-da-ngoai,193279120,"Túi đeo hông chạy bộ LiveFit cao cấp - Running Belt - WB1028",300000,300000,0,0
TIKI,the-thao-da-ngoai,151501125,"Lưới bóng rổ tiêu chuẩn AOLIKES A-LQW01",57000,109000,52000,48
TIKI,the-thao-da-ngoai,21202248,"Bật Lửa Zippo Heart Thumbprints Brushed Chrome Chính Hãng Usa",775000,775000,0,0
TIKI,the-thao-da-ngoai,123829369,"Bộ Tạ Tay Đa Năng Điều Chỉnh 40Kg Composite  6 Trong 1 FED-130240 Cao Cấp",1953000,3000000,1047000,35
TIKI,the-thao-da-ngoai,2282603,"Bộ 3 Vỉ Bấc Zippo",150000,150000,0,0
TIKI,the-thao-da-ngoai,74891922,"Máy câu cá Daiwa Phantom",3902000,3902000,0,0
TIKI,the-thao-da-ngoai,20847667,"Bật lửa ZIPPO 205 –Bật lửa ZIPPO SATIN CHROME",570000,570000,0,0
TIKI,the-thao-da-ngoai,86144755,"Bật Lửa Zippo 204B 8 Ball Spider",910000,910000,0,0
TIKI,the-thao-da-ngoai,84085247,"Giày cầu lông kawasaki K366 chính hãng dành cho cả nam và nữ, chống trơn trượt, bảo hành 6 tháng size",1680000,1680000,0,0
TIKI,the-thao-da-ngoai,164823202,"BÓNG GOLF - PGM - Q007 - Lông xốp -  Bóng golf chơi trong nhà, tránh hỏng đồ vật khác -  Quả bóng golf có tuổi thọ cao, bạn có thể đánh ít nhất 2000 lần",15000,15000,0,0
TIKI,the-thao-da-ngoai,111153731,"Serious Mass 5.4Kg (12Lbs) - Sữa Tăng Cân, Tăng Cơ cho người Gầy, bổ sung đầy đủ thành phần dinh dưỡng",1699500,1699500,0,0
TIKI,the-thao-da-ngoai,25601791,"Bật Lửa Zippo 24894 Day Of The Dead Skull Lemon",830000,830000,0,0
TIKI,the-thao-da-ngoai,161344571,"Bộ 2 VỎ TẠ nhựa tay 2kg cao cấp REEFIT (1 cặp vỏ 1kg)",24000,24000,0,0
TIKI,the-thao-da-ngoai,146367830,"Bộ Dụng Cụ Hít Đất Chống Đẩy 9 in 1 – Dụng Cụ Chống Đẩy - Hít Đất - Chính Hãng dododios",228000,228000,0,0
TIKI,the-thao-da-ngoai,159243122,"Combo 2 quả bi lăn tay gỗ hương để mộc (Đủ size) Mát xa giúp dẻo tay, chống mỏi toàn diện",48000,48000,0,0
TIKI,the-thao-da-ngoai,50762131,"Sữa Tăng Cân Mass Muscle Gainer Elite Labs SMEL935 (4.62kg)",1900000,1900000,0,0
TIKI,the-thao-da-ngoai,22072208,"Bật Lửa Zippo Bald Eagle Polished Chrome Chính Hãng Usa",840000,840000,0,0
TIKI,the-thao-da-ngoai,73104949,"Giàn tạ đa năng kết hợp xà đơn xà kép Zasami 8215 - Kèm 50kg tạ gang, đòn 1m5 - tặng bộ tạ đeo chân",7421000,9500000,2079000,22
TIKI,the-thao-da-ngoai,6274109,"Bật Lửa Zippo Antique Silver Plate ",1825000,1825000,0,0
TIKI,the-thao-da-ngoai,197322385,"Kính bơi trẻ em Speedo HYDROPURE MIRROR GOG JU YELLOW/SILVER - 8-12671F277",395000,395000,0,0
TIKI,the-thao-da-ngoai,86297073,"[ đủ 5 màu ] GIÀY ĐÁ BÓNG SÂN CỎ NHÂN TẠO TUẤN ANH KAMITO TA11-AS",744000,744000,0,0
TIKI,the-thao-da-ngoai,22197647,"Áo Thể Thao Nữ COMET CLASSIC TEE W  BALSAM GREEN L",850000,850000,0,0
TIKI,the-thao-da-ngoai,155351135,"Thảm tập yoga unisex Body Sculpture - BB-8300DE-4MM",295000,295000,0,0
TIKI,the-thao-da-ngoai,136540899,"Tạ tay cao su Brosman 0,5kg , 1kg , 2kg , ... 5kg tạ đơn lõi gang đặc cao cấp hỗ trợ tập gym tại nhà",70000,70000,0,0
TIKI,the-thao-da-ngoai,197516760,"Lều cắm trại tự bung , lều du lịch dã ngoại dành cho 4-6 người, chống thấm nước -ZL053",2835000,2835000,0,0
TIKI,the-thao-da-ngoai,52328173,"Bộ tạ tay cao cấp đa năng điều chỉnh mới nhất có thanh nối tạ mẫu KIM LOẠI (hàng nhập khẩu)",833000,1699000,866000,51
TIKI,the-thao-da-ngoai,272617193,"Máy Chạy Bộ Thông Minh Xiaomi Mijia Gen 2 Kết Nối App Tốc Độ Tối Đa 15km/h Công Suất 750 W - Hàng Nhập Khẩu",11699000,23289000,11590000,50
TIKI,the-thao-da-ngoai,197516781,"Lều cắm trại tự bung , lều du lịch dã ngoại dành cho 6-8 người, chống thấm nước -ZL057",2920000,2920000,0,0
TIKI,the-thao-da-ngoai,1815343,"Thực phẩm bổ sung Optimum Nutrition Gold Standard 100% Whey 10lb (4.5kg)",2960000,2960000,0,0
TIKI,the-thao-da-ngoai,80969249,"Bộ cần câu cá Chính hãng - Cần carbon cao cấp - Siêu bền - Siêu bạo lực - Kèm máy Kim loại HE - Tặng kèm nhiều phụ kiện",399000,399000,0,0
TIKI,the-thao-da-ngoai,100258579,"Quần thể thao 1 lớp tập gym cho nam Hibi Sports M100 - Có túi 2 bên",199000,290000,91000,31
TIKI,the-thao-da-ngoai,77014596,"Bộ 2 Tạ Tay Điều Chỉnh Khóa Số Tự Động 24kg Cao Cấp ( Tặng Kèm Đôi Găng Tay Màu xanh ) Ảnh thật kèm khay đựng tạ 48kg/ 2 tạ",3750000,7500000,3750000,50
TIKI,the-thao-da-ngoai,159495781,"Nón mũ bơi unisex Zoggs Silicone Cap-Plain - 300772",155000,155000,0,0
TIKI,the-thao-da-ngoai,1786703,"Vợt Cầu Lông VS Turbo 125C",599000,599000,0,0
TIKI,the-thao-da-ngoai,118007843,"Giày đá bóng giày đá banh trẻ em chính hãng AKKA SPEED 2 TF",480000,480000,0,0
TIKI,the-thao-da-ngoai,134607409,"Xe Đạp Tập Thể Dục Mini Tháo Lắp Tại Nhà, Văn Phòng Chính Hãng GoodFit GF003MB",309000,599000,290000,48
TIKI,the-thao-da-ngoai,179407023,"Lều Cắm Trại Du Lịch Tự Bung Gập Gọn 3 Đến 4 Người Siêu Chống Nắng Và Mưa Đại Nam Sport + Kèm Tấm Phủ Nóc Lều",616000,1200000,584000,49
TIKI,the-thao-da-ngoai,120461135,"Bộ Tạ Tay (6 in 1) Composite FED Kết hợp tạ đẩy(40 kg)Đa Năng Cao cấp --- hàng chính hãng",2410000,2410000,0,0
TIKI,the-thao-da-ngoai,23271166,"Máy Câu Cá Daiwa STRIKEFORCE 4000-B - Máy Đứng",400000,400000,0,0
TIKI,the-thao-da-ngoai,188849043,"[Hàng chính hãng – Thương hiệu Mỹ] Bình giữ nhiệt Elemental Iconic sport màu đen camo 590ml, giữ nhiệt vượt trội, inox 304, FDA Hoa Kì, An toàn sức khỏe",899000,899000,0,0
TIKI,the-thao-da-ngoai,170729230,"BỘ TẠ TAY ĐA NĂNG KẾT HỢP TẠ ĐẨY 40KG MẪU MỚI",700000,1400000,700000,50
TIKI,the-thao-da-ngoai,76176146,"BĂNG TRÁN THỂ THAO ADIDAS ADYG-30222TL",325000,336000,11000,3
TIKI,the-thao-da-ngoai,185280735,"Ruột Zippo Gas Butane Lửa Vàng – Butane Lighter Insert- Yellow Flame – 65803",585000,585000,0,0
TIKI,the-thao-da-ngoai,48304038,"Giày đá bóng Zocker ZTF SPACE 2001 Black",569000,785000,216000,28
TIKI,the-thao-da-ngoai,189176923,"Giày cầu lông nam kawasaki chính hãng k568 mẫu mới màu xanh đủ size- tặng tất thể thao bendu",1970000,1970000,0,0
TIKI,the-thao-da-ngoai,40776507,"Áo thun nam cổ tròn tay ngắn, chất thun lạnh mềm mại, co giãn thoải mái – FORMEN SHOP – FMPS098",92000,179000,87000,49
TIKI,the-thao-da-ngoai,173124823,"Ghế gỗ gấp gọn mini,  ghế ban công ngoài trời, dã ngoại, du lịch GG-02",220000,220000,0,0
TIKI,the-thao-da-ngoai,119108148,"Gold Standard 100% Whey ON 5lbs - Sữa Tăng Cơ Với Dòng Protein Sạch Uy Tín Lâu Đời Tại Mỹ",1600000,1600000,0,0
TIKI,the-thao-da-ngoai,167750135,"Giày cầu lông Kawasaki k098 chính hãng mẫu mới đủ size dành cho cả nam và nữ - tặng tất thể thao bendu",1090000,1090000,0,0
TIKI,the-thao-da-ngoai,136540785,"Găng tay đấm bốc MMA Wolon hở ngón cao cấp chính hãng",375000,375000,0,0
TIKI,the-thao-da-ngoai,119407756,"Giày sneaker unisex Fila Oakmont TR - 1JM00801D-143",1197000,1995000,798000,40
TIKI,the-thao-da-ngoai,275324142,"[Thiết Kế Mới Vượt Trội] Xe Đạp Thể Dục Tại Nhà - Xe Tập Gym Tại Nhà - Kiểu dáng thể thao, Chất liệu cao cấp, Màn hình LED đa năng,  Khung Thép Chắc Chắc, Không Gây Tiếng Ồn",50000,50000,0,0
TIKI,the-thao-da-ngoai,179403715,"Lều Cắm Trại Du Lịch Tự Bung Gập Gọn 6-8 Người Siêu Chống Nắng,Mưa Đại Nam Sport + Kèm Nệm Chống Ẩm",1097000,2100000,1003000,48
TIKI,the-thao-da-ngoai,97598786,"Giày Đi Bộ Nữ Biti's Hunter Jogging Jade Black DSWH05300DEN (DEN)",588000,638000,50000,8
TIKI,the-thao-da-ngoai,142238354,"Mã hàng KT2.ĐT- Đai Treo Kéo Giãn Cột Sống Khánh Trình( Sản phẩm chưa bao gồm Khung Xà Đơn)- Sử dụng cùng Xà đơn để tập cho người bị thoái vị đĩa đêm",545000,545000,0,0
TIKI,the-thao-da-ngoai,43590869,"Vợt Tennis Babolat Pure STRIKE 100 300gram 3rd Gen 101400 - PR09",4290000,4490000,200000,4
TIKI,the-thao-da-ngoai,94779816,"Giày bóng chuyền Kumpoo KH-E23",563000,710000,147000,21
TIKI,the-thao-da-ngoai,21202252,"Bật Lửa Zippo Tree Of Life Antique Brass Chính Hãng Usa",1025000,1025000,0,0
TIKI,the-thao-da-ngoai,45304288,"Bộ cần câu cá carbon - cần câu kèm máy 3000 - Tặng kèm nhiều phụ kiện BCC11",279000,279000,0,0
TIKI,the-thao-da-ngoai,4693425,"Bộ tạ tay cao cấp đa năng điều chỉnh 15 kg - 20 kg - 30 kg mới nhất BG (hàng nhập khẩu)",1398000,1799000,401000,22
TIKI,the-thao-da-ngoai,74819068,"Thảm Tập Yoga PU Cao Su Tự Nhiên In Hình Hoa Văn Ấn Độ Chính Hãng Đại Nam Sport + Kèm Túi Và Dây Buộc",625000,1000000,375000,38
TIKI,the-thao-da-ngoai,48442281,"Giày bata vải Bình Minh chuyên dụng chạy bộ, cầu lông, bóng bàn, bóng chuyền, đá bóng",84900,84900,0,0
TIKI,the-thao-da-ngoai,86305317,"Vợt cầu lông Prokennex POWER PRO 706 - ĐÃ CĂNG LƯỚI",862000,1648000,786000,48
TIKI,the-thao-da-ngoai,66574565,"Bật lửa Zippo 88Th Anniversary Asia High Polish Plating –  Bản Mạ Vàng Kỷ Niệm 88 Năm Ra Đời Bật Lửa – ZA-2-147A",4100000,4100000,0,0
TIKI,the-thao-da-ngoai,103209805,"Cặp vợt cầu lông siêu nhẹ cán liền quấn dây cao su Agnite - Khung carbon cao cấp - 2 chiếc - Màu xanh neon - Kèm bao đựng - Hàng chính hãng - F2100",149000,279000,130000,47
TIKI,the-thao-da-ngoai,198113339,"Vợt cầu lông Prokennex DESTINY SPEED cao cấp chính hãng điều khiển thiên công (1 cây) - Tặng kèm quấn cán",2600000,3235000,635000,20
TIKI,the-thao-da-ngoai,37130152,"THẢM YOGA DU LỊCH PRO-LITE 1.5MM",824000,850000,26000,3
TIKI,the-thao-da-ngoai,22072732,"Bật Lửa Zippo Joined Forces Emblem Street Chrome Chính Hãng Usa",1000000,1000000,0,0
TIKI,the-thao-da-ngoai,101083439,"Giày cầu lông Lining AYZR002-1 chính hãng dành cho nam, đế kếp chống lật cổ chân - Tặng tất thể thao Bendu",2600000,2600000,0,0
TIKI,the-thao-da-ngoai,109227370,"Vợt cầu lông Prokennex VIPER 47 SPEED (1 cây) - Tặng kèm quấn cán",2744000,2988000,244000,8
TIKI,the-thao-da-ngoai,147020591,"Khung Lưng Nắn Chỉnh Cột Sống, Ngăn Ngừa Thoái Hóa Cột Sông, Thoát Vị Đĩa Đệm, Đau Lưng Ở Người Giá Và Dân Văn Phòng - Chính Hãng dododios",229000,229000,0,0
TIKI,the-thao-da-ngoai,1085792,"Kính Bơi View V200S ",285000,469000,184000,39
TIKI,the-thao-da-ngoai,180955641,"Bó gối tập Yoga,Miếng đệm đầu gối,chống chai đầu gối cho nữ",79000,158000,79000,50
TIKI,the-thao-da-ngoai,168953627,"Ghế tạ đa năng Zasami SGN 8611",1158000,1200000,42000,4
TIKI,the-thao-da-ngoai,55547184,"Bẳng Gối Tập Gym Chuyên Nghiệp Glofit-GFX0050 ( 1 cặp )",350000,450000,100000,22
TIKI,the-thao-da-ngoai,72081854,"Băng Keo Vải Dán Chấn Thương,Băng Keo Co Giãn Dán Cơ Bản 5cm Dài 5m (Giao Màu Ngẫu Nhiên)",46000,100000,54000,54
TIKI,the-thao-da-ngoai,58459883,"Bảo vệ ống đồng, gen nịt bắp chân GoodFit GF602C",154000,250000,96000,38
TIKI,the-thao-da-ngoai,168231314,"Máy câu cá AC kim loại siêu bền - Máy 3000/4000/5000 - Tặng kèm 1 cuộc cước 100m MC35",279000,279000,0,0
TIKI,the-thao-da-ngoai,164823074,"Tạ miếng nhựa Reefit 10kg màu đen có ruột",90000,90000,0,0
TIKI,the-thao-da-ngoai,125284613,"Máy chạy bộ KINGSPORT BK-8000 đa năng, thảm chạy rộng chống trơn, kèm đai massage và thanh gập bụng",10495000,13000000,2505000,19
TIKI,the-thao-da-ngoai,90960066,"Cần câu cá Daiwa Phantom Power SD Cần 2 khúc máy đứng 2m13, 2m44, 2m74, 3m05 khoen Fuji Alconite",1728000,1728000,0,0
TIKI,the-thao-da-ngoai,86146118,"Bật Lửa Zippo Armor 168 Khắc Hình Rồng Uốn Lượn 4 Mặt – Zippo 168.R4M",1285000,1285000,0,0
TIKI,the-thao-da-ngoai,170729232,"Bộ Tạ Tay Đa Năng 20kg Kết Hợp Tạ Đòn Tháo Lắp Điều Chỉnh Siêu Bền Thế Hệ Mới ",559000,1118000,559000,50
TIKI,the-thao-da-ngoai,168806965,"Ghế cong tập bụng Zasami SGC-8511",849000,1750000,901000,51
TIKI,the-thao-da-ngoai,59434252,"Combo bộ 2 vợt cầu lông AOLIKES YE-6631 và hộp 5 quả cầu cao cấp",421000,639000,218000,34
TIKI,the-thao-da-ngoai,103209850,"Vợt cầu lông siêu nhẹ Agnite - 2 chiếc - F2117",269000,538200,269200,50
TIKI,the-thao-da-ngoai,76175922,"BĂNG TRÁN THỂ THAO ADIDAS ADAC-16202",231000,239000,8000,3
TIKI,the-thao-da-ngoai,17042639,"Bình Nước Camelbak Podium Chill 21OZ (620ml)",299000,299000,0,0
TIKI,the-thao-da-ngoai,25659502,"Bật Lửa Zippo 29395 American Stamp On Flag High Polish Chrome",1025000,1025000,0,0
TIKI,the-thao-da-ngoai,87962285,"Băng bảo vệ đầu gối Rhino P7718 (1 Đôi) Bó gối thể thao Đai bảo vệ đầu gối khớp gối Băng quấn đầu gối khớp gối hàng chính hãng dành cho cả nam và nữ",91000,128000,37000,29
TIKI,the-thao-da-ngoai,195110771,"GIÀY ĐÁ BÓNG SÂN CỎ NHÂN TẠO PEACE PS1227",289000,499000,210000,42
TIKI,the-thao-da-ngoai,169546447,"Set đồ tập yoga gym Luxury Hibi Sports H145 4 dây đan VX, màu Tím kèm mút ngực, vải cao cấp Hi Fabric",950000,950000,0,0
TIKI,the-thao-da-ngoai,77015510,"Vợt Tennis Babolat PURE DRIVE LITE 2021 270gram (101443)",4190000,4490000,300000,7
TIKI,the-thao-da-ngoai,179949682,"Dụng Cụ Cắt Dã Ngoại Morakniv Companion (S)",500000,500000,0,0
TIKI,the-thao-da-ngoai,161495196,"Tạ Tay Nhựa 5kg Bát Giác REEFIT (1 cái)",39000,39000,0,0
TIKI,the-thao-da-ngoai,87094494,"Vợt Tennis Babolat Pure STRIKE TEAM 285gram 3rd Gen (101402)",4490000,4490000,0,0
TIKI,the-thao-da-ngoai,123824273,"Bộ Tạ Tay Đa Năng Điều Chỉnh 30Kg Composite  6 Trong 1 FED-130220 Cao Cấp Đại Nam Sport",1524000,3500000,1976000,56
TIKI,the-thao-da-ngoai,193605793,"Giày Thể Thao Nữ Biti's Êmbrace DSW066400XAM (Xám)",524000,568000,44000,8
TIKI,the-thao-da-ngoai,1599809,"Ghế Tập Bụng Cong Muse BG SU-160A (hàng nhập khẩu)",592000,999000,407000,41
TIKI,the-thao-da-ngoai,57837189,"TÚI ĐEO HÔNG ĐEO BỤNG CHẠY BỘ CHỐNG NƯỚC, DÂY ĐEO THOÁNG KHÍ DOPI DP2202 - Hàng Chính hãng, thích hợp cho các môn thể thao ngoài trời, có ngắn đựng điện thoại",148000,159000,11000,7
TIKI,the-thao-da-ngoai,7248403,"Bộ 2 tạ tay Thái Lan 1kg",169000,389000,220000,57
TIKI,the-thao-da-ngoai,5449993,"Vợt cầu lông APACS NANO 9900 new (Đen /đỏ) Tặng dây đan vợt TAAN",669000,669000,0,0
TIKI,the-thao-da-ngoai,23357443,"Găng tay thủ môn có xương trợ lực Đại Nam Sport (Giao màu ngẫu nhiên)",203000,350000,147000,42
TIKI,the-thao-da-ngoai,76110577,"THẢM THỂ DỤC ADIDAS 10mm ADMT-11015 (TẶNG KÈM TÚI ĐỰNG THẢM)",813000,839000,26000,3
TIKI,the-thao-da-ngoai,106119501,"Giày đá bóng JOGARBOLA KOHA 2103 mẫu mới cổ chun dành cho nam đủ size",885000,885000,0,0
TIKI,the-thao-da-ngoai,127600311,"Dây kháng lực tập gym, Power Band đa năng, hỗ trợ luyện tập thể dục, dây trợ lực tập gym Powerband Tập Toàn Thân, Dây kháng lực bằng cao su tự nhiên dùng khi tập thể hình, yoga, pilate – Chính hãng miDoctor",29000,29000,0,0
TIKI,the-thao-da-ngoai,14892888,"Con lăn massage tập yoga",109000,218000,109000,50
TIKI,the-thao-da-ngoai,197650377,"Lều 4 Người 2 Lớp 2.4m x 2.1m Chống Nước Lều Cắm Trại Cao Cấp Galaxy Store GSL3XT Màu Ngẫu Nhiên - Hàng Chính Hãng",1226000,2200000,974000,44
TIKI,the-thao-da-ngoai,135045929,"Bộ Dụng Cụ Sinh Tồn SOS Hộp Đỏ - PaKaSa",164000,214000,50000,23
TIKI,the-thao-da-ngoai,100225820,"GIÀY LEO NÚI X REVEAL W PHANTOM L40972900",1716000,2860000,1144000,40
TIKI,the-thao-da-ngoai,155880297,"Ống cầu lông 6 quả, chất liệu nhựa PE cao cấp Sportslink BK2135",45000,60000,15000,25
TIKI,the-thao-da-ngoai,66576131,"Ruột Zippo mới chính hãng USA – màu trắng KHÔNG KÈM VỎ ZIPPO",420000,420000,0,0
TIKI,the-thao-da-ngoai,164352885,"LỀU TỰ BUNG CAO CẤP 3 NGƯỜI CHÍNH HÃNG NATUREHIKE NH21ZP008",1495000,1495000,0,0
TIKI,the-thao-da-ngoai,5924607,"Giày Đá Bóng Prowin S50 + tặng kèm tất bóng đá cao cổ",189000,189000,0,0
TIKI,the-thao-da-ngoai,113439125,"Túi Ngủ Mùa Đông Naturehike U250 NH20MSD07 Dã Ngoại Cắm Trại",530000,530000,0,0
TIKI,the-thao-da-ngoai,159034223," Ghế Xếp Dã Ngoại Khung Nhôm Có Tựa Đầu YL10 Naturehike NH20JJ036",1200000,1200000,0,0
TIKI,the-thao-da-ngoai,46282872," Mũ chống nắng đi câu cá -  dã ngoại chống tia UV MCN01 Giao màu ngẫu nhiên ",138999,138999,0,0
TIKI,the-thao-da-ngoai,33278874,"Găng Tay Tập GYM, Thể Hình Aolikes Có Quấn Cổ Tay (1 Đôi)",125000,125000,0,0
TIKI,the-thao-da-ngoai,44098669,"Xà đơn gắn cửa màu xám Xanh (Chọn kích thước) -kèm giấy hướng dẫn sử dụng",119000,238000,119000,50
TIKI,the-thao-da-ngoai,193322282,"Giày Thể Thao Nam Biti's Hunter Core DSMH09400XAM (Xám)",794000,794000,0,0
TIKI,the-thao-da-ngoai,158902836," Đệm Hai Người Tự Bơm Hơi Kèm Gối Dã Ngoại Naturehike NH18Q010-D",880000,880000,0,0
TIKI,the-thao-da-ngoai,193708444,"Giày Thể Thao Nữ Bitis Hunter X DSWH07701NAU (Nâu)",932000,932000,0,0
TIKI,the-thao-da-ngoai,170842400,"BALO đựng vợt cầu lông Lining chính hãng ABSS079 có 3 màu lựa chọn",1645000,1645000,0,0
TIKI,the-thao-da-ngoai,157158284,"Giày địa hình SUPERCROSS 3 W Sirocco L41453300",2100000,3500000,1400000,40
TIKI,the-thao-da-ngoai,123815117,"Bộ Tạ Tay Đa Năng Điều Chỉnh 10Kg Composite  6 Trong 1 FED-130210 Cao Cấp Đại Nam Sport",927000,2000000,1073000,54
TIKI,the-thao-da-ngoai,8175968,"Xe đạp tập thể dục trong nhà BG 8702 sọc đen đỏ (hàng nhập khẩu)",1719000,2999000,1280000,43
TIKI,the-thao-da-ngoai,190741129,"Dây Đàn Hồi Tập Thể Lực Zasami theo lực kéo",183000,380000,197000,52
TIKI,the-thao-da-ngoai,57771965,"Giày Thể Thao Đa Năng: Giày Chạy Bộ,Bóng Chuyền,Bóng Rổ,Chạy Bộ ( Đã Khâu Toàn Bộ Đế )",245000,245000,0,0
TIKI,the-thao-da-ngoai,59161601,"Ghế Xếp Dã Ngoại cắm trại Nhỏ Gọn Naturehike NH18Y050-Z",899000,899000,0,0
TIKI,the-thao-da-ngoai,44818889,"Giày Cầu Lông, Giày Bóng Chuyền Bóng Bàn",245000,245000,0,0
TIKI,the-thao-da-ngoai,195472314,"Giày Thể Thao Nữ Biti's Hunter Core DSWH09400HOG",662000,849000,187000,22
TIKI,the-thao-da-ngoai,195193703,"Balo Du Lịch Thời Trang Unisex STARGO LIGERO",199000,440000,241000,55
TIKI,the-thao-da-ngoai,58547914,"Cần câu cá Daiwa Tornado 702MS (cần máy đứng 2m1) khoen Fuji Pat Daiwa",1122000,1122000,0,0
TIKI,the-thao-da-ngoai,4946001,"Bộ vợt cầu lông trẻ em AOLIKES TC-8123",210000,389000,179000,46
TIKI,the-thao-da-ngoai,47323104,"VỎ ZIPPO BRUSHED CHROME CHÍNH HÃNG - KHÔNG KÈM RUỘT",415000,415000,0,0
TIKI,the-thao-da-ngoai,93218269,"Quần leggings tập gym cho nam Hibi Sports M104 - Loại lửng 3/4 không túi",259000,370000,111000,30
TIKI,the-thao-da-ngoai,54690992,"Bóng đá ngoài trời DELTA 6699-5M size 5 chất liệu da TPU tổng hợp, chơi trên sân cỏ nhân tạo phù hợp sử dụng từ 12 tuổi trở lên",133000,139000,6000,4
TIKI,the-thao-da-ngoai,33199951,"Quả bóng chuyền Thăng Long thi đấu VB7000",585000,585000,0,0
TIKI,the-thao-da-ngoai,186210851,"Túi Ngủ Đôi Naturehike 2 Người Kèm Gối NH21MSD06",880000,880000,0,0
TIKI,the-thao-da-ngoai,109089596,"Bó gối thể thao loại dài AOLIKES A-7815 Elastic compression sports knee pads",153000,259000,106000,41
TIKI,the-thao-da-ngoai,21202256,"Bật Lửa Zippo Us Flag Polished Chrome Chính Hãng Usa",980000,980000,0,0
TIKI,the-thao-da-ngoai,77729446,"Giàn tạ đa năng kết hợp xà đơn xà kép Zasami 8215 (chưa bao gồm đòn và tạ ) - Tặng kèm 1 đôi găng tay tập tạ",5699000,10500000,4801000,46
TIKI,the-thao-da-ngoai,175950611,"Một Bộ 2 Tạ Tay 48kg ,mỗi bên 24kg Điều Chỉnh Khóa Số Tự Động ( Tổng 48kg)Loại Cao Cấp Có Khay đựng",3000000,6000000,3000000,50
TIKI,the-thao-da-ngoai,146621995,"Đai chống gù lưng nam nữ chất liệu cải tiến, nhẹ hơan, bền hơn, dễ sử dụng - Chính hãng dododios - DoNhatBan",63000,63000,0,0
TIKI,the-thao-da-ngoai,41772962,"Băng Quấn Bảo Vệ Cổ Tay GYM  Wrist Cao Cấp (1 Đôi)",95000,95000,0,0
TIKI,the-thao-da-ngoai,94621734,"Giày bóng chuyền, cầu lông Kumpoo KH-E23 mẫu mới dành cho nam và nữ đủ size 36-44 - màu trắng phối đỏ đen",599000,710000,111000,16
TIKI,the-thao-da-ngoai,153815256,"[Xả kho cắt mã giảm giá lên tới 50%] SET BỘ THỂ THAO NAM VNAMAVT03 VINA AUTHENTIC CO GIẢN, MỀM MẠI, THẤM HÚT MỒ HÔI, CHUẨN FORM",249000,249000,0,0
TIKI,the-thao-da-ngoai,143056416,"Bộ Gậy Golf Nữ PRGR SWEEP M-16 Full Set",40680000,40680000,0,0
TIKI,the-thao-da-ngoai,60238698,"Cần câu cá Daiwa Air X 662MFS 702MFS - 1m98 2m14 cần lure máy đứng",1115000,1115000,0,0
TIKI,the-thao-da-ngoai,179221021,"Sữa bổ sung đạm dành cho người ăn chay Vegan Blend Protein 1kg - Nutrition Depot",920000,990000,70000,7
TIKI,the-thao-da-ngoai,52039074,"Giày Trượt Patin Trẻ Em Flying eagle s5s plus",1925000,1925000,0,0
TIKI,the-thao-da-ngoai,186434053,"Quần đi biển nữ 2 lớp Sai Peng Sobie",234000,390000,156000,40
TIKI,the-thao-da-ngoai,68033875,"Xà Đơn Gắn Cửa Treo Tường Có Chốt An Toàn Màu Đỏ Đen Cao Cấp  Phiên Bản Cải Tiến Dùng Để Tập Chống Vẹo Cột Sống Và Tăng Chiều Cao(Chọn kích Thước)",225000,450000,225000,50
TIKI,the-thao-da-ngoai,171688701,"Vợt cầu lông Prokennex KINETIC EXTREME SPEED chính hãng cao cấp công thủ toàn diện (1 cây) - Tặng kèm quấn cán và túi vải Cabasports",4518000,4673000,155000,3
TIKI,the-thao-da-ngoai,132837747,"Bộ Tạ Tay Tháo Lắp 30kg Đa Năng FED730 Nhập Khẩu Chất Liệu Gang Mạ Niken",2266000,4500000,2234000,50
TIKI,the-thao-da-ngoai,164060960,"QUẢ BÓNG BÀN THI ĐẤU YINHE Y40+ – HỘP 6 QUẢ 3 SAO CHUẨN THI ĐẤU THẾ GIỚI",100000,100000,0,0
TIKI,the-thao-da-ngoai,113083540,"Xe Đạp Tập Thể Dục Air Bike ",1799000,1799000,0,0
TIKI,the-thao-da-ngoai,46582345,"Bình Nước Thể Thao Đa Chức Năng Camelbak Reign 1L (Chế độ phun mưa làm mát)",350000,350000,0,0
TIKI,the-thao-da-ngoai,152924376,"Balo cầu lông Kumpoo, túi đựng vợt Kumpoo cao cấp KB127",639000,850000,211000,25
TIKI,the-thao-da-ngoai,103209786,"Cặp vợt cầu lông cán liền quấn cao su siêu nhẹ Agnite - Kèm bao vợt cao cấp và cầu lông - 2 chiếc 2 màu - Hàng chính hãng - F2101",225000,489600,264600,54
TIKI,the-thao-da-ngoai,116665246,"Giày cầu lông Mira Lightning 19.1 Xám thể thao nam nữ chính hãng chất lượng - LI004",525000,525000,0,0
TIKI,the-thao-da-ngoai,163282461,"Ghế Tập Tạ, Ghế Tập Gym có Giá Đỡ Tạ Cỡ Đại Tiêu Chuẩn Phòng GYM Tại Nhà ( Không Kèm Đòn Tạ Và Bánh Tạ)",1650000,3300000,1650000,50
TIKI,the-thao-da-ngoai,16256856,"Bật lửa Zippo High Polish Brass Vintage with Slashes 270",790000,790000,0,0
TIKI,the-thao-da-ngoai,174279368,"Áo thun tay ngắn thể thao nam Under Armour GL Foundation - 1326849-001",529000,755000,226000,30
TIKI,the-thao-da-ngoai,93289725,"Bộ Tạ Tay 1kg Bọc Cao Su Trơn Lõi Thép Cao Cấp Chính Hãng Đại Nam Sport (Tổng 2kg)-Giao Màu Ngẫu Nhiên",117000,250000,133000,53
TIKI,the-thao-da-ngoai,257911182,"BG Sàn nhún lò xo cao cấp Trampoline Bật Nhảy Lò Xo Cho Trẻ Vui Chơi Phát Triển Vận Động An Toàn Cho Bé và Người Lớn- Hàng nhập khẩu",699000,1599000,900000,56
TIKI,the-thao-da-ngoai,740789,"Kìm Bóp Cơ Tay Điều Chỉnh Lực ThaiGiang 1309XAM",29000,58000,29000,50
TIKI,the-thao-da-ngoai,6925301,"Bật Lửa Zippo COTY 2018 29653",9380000,9380000,0,0
TIKI,the-thao-da-ngoai,14110636,"Băng Quấn Cổ Chân Hỗ Trợ Bảo Vệ Mắt Cá Chân, Khớp Cổ Chân Sport Ankle Protector AOLIKES YE-1527",162000,289000,127000,44
TIKI,the-thao-da-ngoai,4877555,"Bộ 2 Tạ tập tay nhựa VN 1kg Sportslink",13000,20000,7000,35
TIKI,the-thao-da-ngoai,58548593,"Cần câu cá Daiwa Crossfire 1m98 cần lure máy ngang 662 MHB-SD",455000,455000,0,0
TIKI,the-thao-da-ngoai,7068817,"Dây kháng lực tập cơ mông đùi Hip Resistance Bands AOLIKES YE-3603",27000,79000,52000,66
TIKI,the-thao-da-ngoai,33361044," Thực phẩm bố sung Rule Creatine Unflavored",410000,410000,0,0
TIKI,the-thao-da-ngoai,117578380,"Giàn Tạ Đa Năng Zasami Có xà đơn xà kép gồm 1 đòn tạ 1m5 - Lựa chọn mức tạ ngẫu nhiên",6199000,8200000,2001000,24
TIKI,the-thao-da-ngoai,173360294,"Giày Thể Thao Nữ Biti's Hunter X Cut-Out DSWH08900DEN (Đen)",815000,1019000,204000,20
TIKI,the-thao-da-ngoai,77711458,"Quấn cổ tay tập gym AOLIKES YE-7938 bảo vệ khớp tay Sport wrist support",85000,159000,74000,47
TIKI,the-thao-da-ngoai,194039745,"Thực phẩm bổ sung hỗ trợ tăng năng lượng và sức mạnh Myprotein Impact Creatine - Không mùi - Túi 250g",520000,620000,100000,16
TIKI,the-thao-da-ngoai,123819450,"Bộ Tạ Tay Đa Năng Điều Chỉnh 20Kg Composite  6 Trong 1 FED-130220 Cao Cấp Đại Nam Sport",1211000,2500000,1289000,52
TIKI,the-thao-da-ngoai,147051555,"Túi Tennis 2 ngăn Babolat PURE DRIVE 2021 X6 (751208)",1799000,2490000,691000,28
TIKI,the-thao-da-ngoai,59206346,"Kính Bơi Thời Trang Cao Cấp Tráng Gương Chống Tia UV Chống Hấp Hơi SKB101 Đa sắc",99000,99000,0,0
TIKI,the-thao-da-ngoai,53324038,"Cần câu cá - Cần tay carbon -CT13 ",199000,199000,0,0
TIKI,the-thao-da-ngoai,160748640,"Giày Chạy Bộ Nữ Biti's Hunter Running BLACK DSWH08300DEN (Đen)",785000,981000,196000,20
TIKI,the-thao-da-ngoai,114253798,"Băng siết cơ hông BODY SCULPTURE - BB-876A-B",175000,175000,0,0
TIKI,the-thao-da-ngoai,58177701,"Bóng đá Molten F5A5000-AC AFC Champions League",2590000,2590000,0,0
TIKI,the-thao-da-ngoai,85241870,"Băng dây chằn gối Mueller Jumper's KNEE STRAP 992",475000,490000,15000,3
TIKI,the-thao-da-ngoai,84987401,"Ghế tập thể hình đa năng Gymlink Strong GY-188",2238000,2307000,69000,3
TIKI,the-thao-da-ngoai,10797795,"Võng Mùng Galaxy Sport Dài 2m5 Ngủ Trong Nhà Phượt Du Lịch GSVM01 Hàng Xuất Khẩu",341000,410000,69000,17
TIKI,the-thao-da-ngoai,123493029,"Xe đạp tập thể dục spining Airbike Sport - Hàng chính hãng",1799000,1799000,0,0
TIKI,the-thao-da-ngoai,16256803,"Bật lửa Zippo Black Matte with Zippo Logo 218ZL",780000,780000,0,0
TIKI,the-thao-da-ngoai,103209782,"Dây nhảy tập thể dục Trong suốt Agnite chính hãng - Lõi nhựa PVC cao cấp - Dài 2.8m - Màu Hồng/Xanh dương/Xanh lá - F4122",28000,63000,35000,56
TIKI,the-thao-da-ngoai,583375,"Bộ 2 Tạ Tập Tay Nhựa VN 2kg Sportslink - Xanh",38000,38000,0,0
TIKI,the-thao-da-ngoai,6585597,"Bật Lửa Zippo Vàng Xước Bụi 207G",990000,990000,0,0
TIKI,the-thao-da-ngoai,35772549,"Dây Nhảy Thể Dục Adidas ADRP-11011",716000,739000,23000,3
TIKI,the-thao-da-ngoai,164823091,"Bộ 2 tạ miếng nhựa Reefit 5kg màu đen có ruột (gồm 2 tạ)",89000,89000,0,0
TIKI,the-thao-da-ngoai,51996699,"Bật Lửa Zippo 29789 – Zippo Black Ice Lighter & Pipe Insert",1235000,1235000,0,0
TIKI,the-thao-da-ngoai,16257233,"Bật lửa Zippo Armor Brush Chrome 162",735000,735000,0,0
TIKI,the-thao-da-ngoai,131022170,"Dụng cụ cầm tay đa năng Leatherman Crater C33Lx (2 tools)",940000,940000,0,0
TIKI,the-thao-da-ngoai,193446435,"Vợt cầu lông Prokennex KINETIC EXTREME PRO NEW cao cấp chính hãng tấn công mạnh mẽ (1 cây) - Tặng kèm quấn cán",4376000,5388000,1012000,19
TIKI,the-thao-da-ngoai,104551853,"Babolat Syntec Pro - quấn cốt đen (670051)",259000,259000,0,0
TIKI,the-thao-da-ngoai,93289910,"Bộ Tạ Tay 4kg Bọc Cao Su Trơn Lõi Thép Cao Cấp Chính Hãng Đại Nam Sport (Tổng 8kg)-Giao Màu Ngẫu Nhiên",468000,900000,432000,48
TIKI,the-thao-da-ngoai,85630162,"Xà Đơn Xà Kép Đa Năng Tập Gym DNS-Ẽ30 Chính Hãng Đại Nam Sport + Tặng Kèm Găng Tay Tập Xà",1953000,5000000,3047000,61
TIKI,the-thao-da-ngoai,170766866,"Bật Lửa Zippo 49866 – Zippo 90th Anniversary Limited Edition – Zippo 2022 Collectible Of The Year Asia – Gold Plated – Zippo Coty 2022 Asia",8250000,8250000,0,0
TIKI,the-thao-da-ngoai,91121777,"Ván Trượt Thể Thao Dài Mặt Nhám 80cm Bánh Cao Su Kiểu Dáng Mới Nhất  + Kèm Túi Đựng Ván",267000,700000,433000,62
TIKI,the-thao-da-ngoai,57987030,"BỘ 40KG TẠ BG MIẾNG NHỰA ĐEN CAO CẤP ĐA NĂNG ( hàng nhập khẩu)",622000,1599000,977000,61
TIKI,the-thao-da-ngoai,174219542,"Mũ bơi PU cao cấp Yingfa chống tia UV bảo vệ mắt",195000,195000,0,0
TIKI,the-thao-da-ngoai,103491899,"Áo thun nam cổ tròn tay ngắn, chất thun mè mềm mại, co giãn thoải mái – FORMEN SHOP – FMARD002",99000,210000,111000,53
TIKI,the-thao-da-ngoai,67135560,"Kẹo Singum Tăng Lực Thương Hiệu Onegum Xuất Sứ Pháp Bổ Sung Vitamin B3 B6 B12 Không Đường Giúp Tỉnh Táo Và Tăng Sức Bền Dùng Trong Các Môn Thể Thao",159000,159000,0,0
TIKI,the-thao-da-ngoai,148823693,"Quần ngắn thể thao nam New Balance Printed Accelerate 5 Inch - MS93188 (form Quốc tế)",672000,895000,223000,25
TIKI,the-thao-da-ngoai,191542762,"Ly, cốc uống nước Campingmoon S190 (210ml)",130000,130000,0,0
TIKI,the-thao-da-ngoai,60426248,"Giá Treo Đèn Naturehike Dã Ngoại Gấp Gọn NH20PJ001",295000,295000,0,0
TIKI,the-thao-da-ngoai,86146114,"Bật Lửa Zippo 236 Khắc Trò Chơi Game Of Thrones 5 Mặt – Zippo 236.Game",1175000,1175000,0,0
TIKI,the-thao-da-ngoai,1599479,"Máy Tập Cơ Bụng Đa Năng Cải Tiến New Six Pack Care  KM2017 (hàng nhập khẩu)",898000,1198500,300500,25
TIKI,the-thao-da-ngoai,112548706,"Đèn Pin Đội Đầu Headlamp Sạc USB - Chính Hãng PaKaSa",89250,144000,54750,38
TIKI,the-thao-da-ngoai,196517957,"Vợt cầu lông Prokennex KINETIC EXTREME PRO cao cấp chính hãng tấn công mạnh mẽ (1 cây) - Tặng kèm quấn cán",4798000,4798000,0,0
TIKI,the-thao-da-ngoai,45301865,"Bộ cần câu cá - cần câu kèm máy - Tặng kèm nhiều phụ kiện BCC01",299000,299000,0,0
TIKI,the-thao-da-ngoai,170771005,"Bật Lửa Zippo 49477 - Zippo Tumbled Brass",715000,715000,0,0
TIKI,the-thao-da-ngoai,116665024,"Giày cầu lông Mira Lightning 19.1 Đen thể thao nam nữ chính hãng chất lượng - LI002",525000,525000,0,0
TIKI,the-thao-da-ngoai,77116876,"Combo Giày Trượt Patin Bánh Cao Su Phát Sáng Gro Tăng Giảm Size Chính Hãng Đại Nam Sport + Kèm Bộ Bảo Hộ",479000,1000000,521000,52
TIKI,the-thao-da-ngoai,95663518,"Khung gánh tạ Gymlink Squat Rack G1704",1930000,2122000,192000,9
TIKI,the-thao-da-ngoai,78496599,"Áo tập Yoga - Gym Tanktop mặc ngoài Xẻ tà cột trước Hibi Sports TA708",216000,270000,54000,20
TIKI,the-thao-da-ngoai,68863227,"Băng Bảo Vệ Khớp Gối 360º VNSPORT - VN019, Hỗ Trợ Chấn Thương Gối, Bảo Vệ Dây Chằng Gối, Sụn Chêm, Bánh Chè Gối, Đau Nhức Khớp Gối, Thoái Hóa Khớp Gối",250000,350000,100000,29
TIKI,the-thao-da-ngoai,58545464,"Khung nâng đầu gối, trợ lực đầu gối PowerKnee chính hãng GoodFit GF519K",351000,499000,148000,30
TIKI,the-thao-da-ngoai,191820836,"Lều 4 Người 2 Lớp Chống Nước Cắm Trại Dã Ngoại  Trekking Cao Cấp Galaxy Store GSL4P02 Màu Ngẫu Nhiên - Hàng Chính Hãng",1300000,2500000,1200000,48
TIKI,the-thao-da-ngoai,86144931,"Bật Lửa Zippo 204B Steampunk Cat Brass Brush",1075000,1075000,0,0
TIKI,the-thao-da-ngoai,159729102,"Kính bơi unisex Zoggs Fusion Air - 320755",237000,595000,358000,60
TIKI,the-thao-da-ngoai,109661580,"Ván ôm lướt sóng Aztron ERIS Bodyboard 39 AB-100",1150000,1150000,0,0
TIKI,the-thao-da-ngoai,178481906,"Xe đạp tập thể dục trong nhà Yesoul C1H, Công nghệ kháng lực từ giúp xe vận hành không gây tiếng động,Tặng app tập luyện",6900000,6900000,0,0
TIKI,the-thao-da-ngoai,16256852,"Bật lửa Zippo Brushed Brass Solid 204",785000,785000,0,0
TIKI,the-thao-da-ngoai,53233376,"Cần tay 6H  - Cần câu cá carbon - Chất liệu cao cấp - Tặng kèm 7 phụ kiện CT13",299000,299000,0,0
TIKI,the-thao-da-ngoai,45292202,"Máy câu cá 4000 - Máy câu đứng chất lượng cao cấp - Máy 4000 MCH4",169000,169000,0,0
TIKI,the-thao-da-ngoai,161897222,"Tạ Tay Nhựa 8kg Bát Giác REEFIT (1 cái)",64000,64000,0,0
TIKI,the-thao-da-ngoai,74035977,"Con Lăn Phanh Tự Động Thông Minh Hỗ Trợ Tập Gym Lấy Lại Vóc Dáng Thon Gọn Hàng Chính Hãng",239000,478000,239000,50
TIKI,the-thao-da-ngoai,6556559,"Bật Lửa Zippo Classic Matte Cream 216",680000,680000,0,0
TIKI,the-thao-da-ngoai,66113341,"Máy câu cá - Chính hãng Deukio 2020 - Kim loại cao cấp AR - Tặng kèm cước - DK01",269000,269000,0,0
TIKI,the-thao-da-ngoai,113053919,"Bóng đá Paledas số 5 - Bóng đá chính hãng - Tặng balo rút + bơm tay + Kim bơm và túi lưới",123000,139000,16000,12
TIKI,the-thao-da-ngoai,133675767,"Đèn gas Campingmoon T-4",550000,550000,0,0
TIKI,the-thao-da-ngoai,1815367,"Thực phẩm bổ sung Optimum Nutrition Gold Standard 100% Casein 4lb (1.82kg)",1910000,1910000,0,0
TIKI,the-thao-da-ngoai,31568968,"Áo thun ba lỗ nam sát nách dáng thể thao, thấm hút mồ hôi, thoải mái vận động – FORMEN SHOP – FMTD095",99000,159000,60000,38
TIKI,the-thao-da-ngoai,23398371,"Con lăn tập cơ bụng 2 bánh cao cấp- Tặng kèm thảm lót gối(Khách chọn màu)",199000,398000,199000,50
TIKI,the-thao-da-ngoai,6529139,"Bật Lửa Zippo Armor Tumbled Brass 28496",875000,875000,0,0
TIKI,the-thao-da-ngoai,6528407,"Bật Lửa Zippo Replica 1935 ",1150000,1150000,0,0
TIKI,the-thao-da-ngoai,144894977,"Cần câu tay Handing Điếu Vương",258050,258050,0,0
TIKI,the-thao-da-ngoai,35772543,"Dây Nhảy Thể Dục Adidas ADRP-11017",193000,199000,6000,3
TIKI,the-thao-da-ngoai,49192290,"Máy câu cá - Máy kim loại - Tặng kèm cước MCC058",259000,259000,0,0
TIKI,the-thao-da-ngoai,59144114,"Giàn tạ đa năng Đại Việt 2014 kèm 50kg tạ gang , đòn tạ 1m5, 1 găng tay tập tạ",4199000,5700000,1501000,26
TIKI,the-thao-da-ngoai,126071230,"Ghế Tập Tạ Điều Chỉnh Đa Năng FED-XM0117 (Thép carbon dày 1.2mm) - Hàng Chính Hãng",2780000,2780000,0,0
TIKI,the-thao-da-ngoai,168558951,"Giày Thể Thao Nữ Biti's Hunter X Festive Armor Black DSWH07700DEN",815000,1019000,204000,20
TIKI,the-thao-da-ngoai,188899693,"[Hàng chính hãng – Thương hiệu Mỹ] Bình giữ nhiệt Elemental Iconic sport màu xám đốm 590ml, giữ nhiệt vượt trội, inox 304, FDA Hoa Kì, An toàn sức khỏe",849000,849000,0,0
TIKI,the-thao-da-ngoai,60418876,"Xẻng Dã Ngoại Đa Năng 8 In 1 Naturehike NH20GJ001",280000,280000,0,0
TIKI,the-thao-da-ngoai,172538162,"Dây Cáp Tricep Rope Bicep Hỗ Trợ Tập GYM Đầy Đủ Nhóm Cơ Cơ Tay Sau, Tay Trước, Lưng Xô",135000,135000,0,0
TIKI,the-thao-da-ngoai,114255582,"Áo thun thể dục thương hiệu Amazing cho nữ, cổ bẻ và cổ tròn, đồng phục thể thao cho học sinh nam nữ các cấp",64000,99000,35000,35
TIKI,the-thao-da-ngoai,114908106,"Áo tanktop tập Yoga mặc ngoài - kiểu 2 dây cổ yếm Hibi Sports TA709",159000,280000,121000,43
TIKI,the-thao-da-ngoai,164502011,"Máy Chạy Bộ Thông Minh Mỹ Horizon TR5.0",15400000,22000000,6600000,30
TIKI,the-thao-da-ngoai,293380,"Kìm Bóp Tay Thể Lực Chữ A FD1616 - Xám Phối Đen",55000,73000,18000,25
TIKI,the-thao-da-ngoai,10074351,"Sữa Tăng Cơ Impact Isolate Protein 2.5kg (100 lần dùng) -  Nutrition Depot",1890000,2290000,400000,17
TIKI,the-thao-da-ngoai,58803712,"Máy câu cá Daiwa StrikeForce 4000-B Chính Hãng",400000,400000,0,0
TIKI,the-thao-da-ngoai,16510282,"Bộ khung lưới Tập Swing Golf - PGM LXW001: 3M x 3M x 3M",5000000,5000000,0,0
TIKI,the-thao-da-ngoai,72296294,"Quần short nam thể thao thun lạnh cao cấp thoải mái, năng động, trẻ trung – FORMEN SHOP – FMPS135",99000,199000,100000,50
TIKI,the-thao-da-ngoai,75328088,"Áo Sát Nách Thể Thao Nam Tập Gym Get Fit Don't Quit - Chất Liệu Thun Lỗ Kim Cao Cấp SZone SA106",99000,99000,0,0
TIKI,the-thao-da-ngoai,147212447,"Vợt cầu lông Prokennex ARROW 17 AIR 7U - ĐÃ CĂNG LƯỚI",2408000,3500000,1092000,31
TIKI,the-thao-da-ngoai,90682883,"Thảm yoga định tuyến PU Liforme Rainbow Hope 4.2mm [TẶNG TÚI ĐỰNG THẢM + CHAI VỆ SINH THẢM 100ML]",4900000,5715000,815000,14
TIKI,the-thao-da-ngoai,114254304,"Túi bơi Unisex SPEEDO - 8-07407D713",178000,355000,177000,50
TIKI,the-thao-da-ngoai,59179634,"Bàn Nhôm Naturehike Gấp Gọn Bàn Dã Ngoại NH16Z016-S",1180000,1180000,0,0
TIKI,the-thao-da-ngoai,139830431,"Khăn Cổ Đa Năng VNSPORT - VNS005, Hàng Cao Cấp Chống Nắng, Chống Khói Bụi, Chống Tia Cực Tím, Giữ Ẩm Mặt Và Cổ Phù Hợp Cho Đi Xe Dã Ngoại",99000,150000,51000,34
TIKI,the-thao-da-ngoai,1598291,"Ván Trượt Mặt Nhám Bánh Cao Su Cỡ Lớn Đại Nam Sport (Giao Màu Ngẫu Nhiên)",217000,500000,283000,57
TIKI,the-thao-da-ngoai,91650623,"Máy Chạy Đi Bộ Điện Tập Thể Dục DNS-MK231 Nhỏ Gọn Màu Đen Có Điều Khiển Từ Xa Đại Nam Sport",4599000,8000000,3401000,43
TIKI,the-thao-da-ngoai,68662088,"Bộ Tạ Tay Điều Chỉnh Khóa Số Tự Động 24kg Cao Cấp (Hàng Nhập KHẩu)",1641000,3500000,1859000,53
TIKI,the-thao-da-ngoai,198185963,"Giày đá bóng Zocker Inspire Orange",569000,889000,320000,36
TIKI,the-thao-da-ngoai,22055881,"Xà Đơn Xếp Khánh Trình Dành Cho Người Cao Từ 1m40 - 1m80 Model KT1.1518 - Xà Đơn Tằng Chiều Cao- Xà Đơn Tập Stress Workout - Xà Đơn Hỗ Trợ Điều Trị Bệnh Xương Khớp - Thoái Hoá Cột Sống",1580000,1580000,0,0
TIKI,the-thao-da-ngoai,164047874,"Bộ Đồ Chơi Đấm Bốc Boxing Suit Cao Cấp Cho Bé Rèn Luyện Thể Lực - Hàng Loại 1 - Chính Hãng MINIIN",196000,199000,3000,2
TIKI,the-thao-da-ngoai,10932890,"Lều 5 Người Phượt Cắm Trại Du Lịch Cao Cấp Galaxy Store Eureka Tetragon 8 - Hàng Xuất Khẩu Loại 1 - Màu ngẫu nhiên",1313000,2500000,1187000,47
TIKI,the-thao-da-ngoai,135094136,"Cuộn cuốn cán vợt cầu lông, tennis VS chính hãng",20000,20000,0,0
TIKI,the-thao-da-ngoai,2180793,"Bật Lửa Zippo Vân Xước Chrome",535000,535000,0,0
TIKI,the-thao-da-ngoai,12126437,"Kính bơi trẻ em nhập khẩu từ Đức, thương hiệu Fashy dòng “Spark II” đạt tiêu chuẩn chất lượng Châu Âu, kính chống mờ, chống tia UV, size M dành cho bé trai, bé gái từ 6 tuổi trở lên",422182,422182,0,0
TIKI,the-thao-da-ngoai,166307646,"Băng bảo vệ cổ chân, mắt cá chân Sportslink SKDK-HJ036 (1 chiếc)",49000,79000,30000,38
TIKI,the-thao-da-ngoai,162735878,"DÂY NHẢY LÕI THÉP CAO CẤP ADIDAS ADRP-13511",930000,959000,29000,3
TIKI,the-thao-da-ngoai,113915313,"Ghế Gấp Gọn Du Lịch, Ghế Xếp Dã Ngoại - Giao Màu Ngẫu Nhiên - Hàng Nhập Khẩu",99000,149000,50000,34
TIKI,the-thao-da-ngoai,87728725,"Dây nhảy thể lực loại nặng AOLIKES YE-3203 Speed Jump Rope",201000,339000,138000,41
TIKI,the-thao-da-ngoai,55426315,"Máy câu cá AC kim loại siêu bền - Tặng kèm 1 cuộc cước 100m MC35",259000,259000,0,0
TIKI,the-thao-da-ngoai,176672648,"Gối Gạch Tập Yoga Chọn Màu Chất Liệu EVA Mật Độ Cao Nặng 185 Gram Chính Hãng – Gối Tập Yoga Tập Gym Tập Thể Thao Cao Cấp",39000,78000,39000,50
TIKI,the-thao-da-ngoai,49529003,"Máy câu cá Daiwa Crossfire New",695000,695000,0,0
TIKI,the-thao-da-ngoai,20346552,"Bóng Phản Xạ Treo Đầu miDoctor - Bóng Phản Xạ Chính Hãng",82000,82000,0,0
TIKI,the-thao-da-ngoai,155225245,"Giày địa hình WILDCROSS 2 W Delphinium - L41454400",2178000,3630000,1452000,40
TIKI,the-thao-da-ngoai,73787569,"Kính bơi trẻ em S5AOP có độ chính hãng SAEKO - Cho trẻ cận thị từ 1.5 đến 6 độ  - Nhiều màu sắc",385000,385000,0,0
TIKI,the-thao-da-ngoai,70766886,"Bóng Tập Yoga Trơn Massage Cao Cấp 65cm(Tặng kèm Bơm Và bộ Dụng Cụ Van Dự Phòng)",119000,238000,119000,50
TIKI,the-thao-da-ngoai,108908036,"GĂNG TAY ĐẤM BỐC ( BOXING ) BN C-01, Chính hãng, Mẫu mới 2021 SIÊU NGẦU ( cặp )",590000,590000,0,0
TIKI,the-thao-da-ngoai,103825907,"Xe đạp tập có ghế tựa lưng PF-56R Chính hãng Pro Fitness cho người già tập phục hồi chức năng",4656000,4850000,194000,4
TIKI,the-thao-da-ngoai,81570538,"Đai Lưng Tập Gym Glofit-GFHY002. Đai Lưng Tập Thể Hình Cao Cấp  (WEIGHT LIFTING BELT)",450000,550000,100000,18
TIKI,the-thao-da-ngoai,66619934,"Máy câu cá kim loại - Chính hãng DEUKIO 2020 - Tặng kèm cước DS01",299000,299000,0,0
TIKI,the-thao-da-ngoai,167002309,"Ván SUP bơm hơi Aztron Neptune 2.0 12'6" Touring AS-313D",13500000,13500000,0,0
TIKI,the-thao-da-ngoai,106034799,"Quần short gió, quần đùi nam thể thao, năng động, thoải mái hoạt động ngoài trời – FORMEN SHOP – FMARD001",89000,159000,70000,44
TIKI,the-thao-da-ngoai,58153520,"Kính Bơi Cận Trẻ Em View V740SOP Cho Trẻ Từ 6 đến 12 Tuổi - Hàng Chính Hãng 100% Sản Xuất Tại Nhật Bản",252000,450000,198000,44
TIKI,the-thao-da-ngoai,72543602,"GIÀY NAM NỮ CHƠI CẦU LÔNG, CHẠY BỘ",220000,220000,0,0
TIKI,the-thao-da-ngoai,6501933,"Bật Lửa Zippo Slim High Polished Chrome 1610",715000,715000,0,0
TIKI,the-thao-da-ngoai,15923115,"Quần dài Jogger thể thao nữ tập Gym 2 Sọc",80000,100000,20000,20
TIKI,the-thao-da-ngoai,1767263,"Giày Bóng Đá Sân Cỏ Nhân Tạo Nam Mitre 170501 - Xanh Dương (Size",588000,588000,0,0
TIKI,the-thao-da-ngoai,163166210,"Mặt Vợt Bóng Bàn DHS HURRICANE PRO LÓT CAM",855000,855000,0,0
TIKI,the-thao-da-ngoai,35813255,"Găng Tay Thể Thao ADIDAS SIZE - XXL - ADGB-12527",384000,384000,0,0
TIKI,the-thao-da-ngoai,46824092,"GĂNG TAY THỂ THAO ADIDAS ADGB-1321",419000,432000,13000,3
TIKI,the-thao-da-ngoai,2420979,"Tạ tay nhựa VN 10kg Sportslink (Xanh dương)",113000,113000,0,0
TIKI,the-thao-da-ngoai,59098396,"Máy Câu Cá Daiwa MG Z Chính Hãng",680000,680000,0,0
TIKI,the-thao-da-ngoai,134477119,"Túi trống đá bóng nam Mira Xanh Dương, phụ kiện balo thời trang thể thao chính hãng - TT001",199000,199000,0,0
TIKI,the-thao-da-ngoai,112022795,"Băng bảo vệ đầu gối lót silicone cao cấp hỗ trợ giảm chấn thương khi luyện tập Sportslink SKDK-HJ053 (1 chiếc)",210000,299000,89000,30
TIKI,the-thao-da-ngoai,101790252,"Quần thể thao 3 SỌC ống xuông Nam Nữ Unisex",107000,107000,0,0
TIKI,the-thao-da-ngoai,100417955,"Giày cầu lông, bóng chuyền Kumpoo KH-E23 phân phối chính hãng",563000,750000,187000,25
TIKI,the-thao-da-ngoai,108629379,"Bộ dây đàn hồi tập gym Rhino R102 dây đàn hồi mini band tập yoga dây đàn hồi kháng lực cao cấp tập thể dục - Hàng chính hãng Rhino Store",66000,118000,52000,44
TIKI,the-thao-da-ngoai,170755752,"Thùng Đựng Đồ Dã Ngoại Xếp Gọn Naturehike NH20SJ036",1180000,1180000,0,0
TIKI,the-thao-da-ngoai,119242105,"Dây nhảy thể dục, giảm cân Agnite - Dài 2.8m - Có thể điều chỉnh độ dài, Lõi bằng thép cao cấp - Màu Xám/ Đen - Hàng chính hãng - F4137",75000,135000,60000,44
TIKI,the-thao-da-ngoai,2282559,"Bình Đựng Xăng Di Động Zippo",530000,530000,0,0
TIKI,the-thao-da-ngoai,68540633,"Ván Trượt Cỡ Lớn Mặt Nhám Bánh Cao Su Đạt Chuẩn Thi Đấu 80cm (Giao Màu Ngẫu Nhiên)",257000,500000,243000,49
TIKI,the-thao-da-ngoai,6722171,"Bật Lửa Zippo Stamp Antique Brass 28994",1065000,1065000,0,0
TIKI,the-thao-da-ngoai,171574623,"Bộ Gậy Golf Callaway X Hot Full Set 2021 cho Nam",42940000,42940000,0,0
TIKI,the-thao-da-ngoai,75376410,"Ghế Tập Tạ Đa Năng P189 Mẫu 2021 Tích Hợp Nhiều Bài Tập Cơ Bụng,Cơ Vai,Cơ Tay,Cơ Lưng Eo Tienphatsmart Tặng  Bộ Dây Ngũ Sắc 11 Chi Tiết.",1100000,2200000,1100000,50
TIKI,the-thao-da-ngoai,158973314," Bếp Gas Mini Cắm Trại Siêu Nhỏ Gọn Naturehike NH21RJ003",280000,280000,0,0
TIKI,the-thao-da-ngoai,8128691,"Bộ đòn 1m5 - 50kg tạ (2 đĩa 10kg, 4 đĩa 5kg, 2 đĩa 3kg, 2 đĩa 2kg)",1849000,2150000,301000,14
TIKI,the-thao-da-ngoai,20847716,"Bật lửa ZIPPO 201FB –Bật lửa ZIPPO ANTIQUE BRASS",790000,790000,0,0
TIKI,the-thao-da-ngoai,155367679,"Quần thể thao legging dáng lửng IBX IBX062P",249000,499000,250000,50
TIKI,the-thao-da-ngoai,17470620,"Bộ dây kéo ngũ sắc tập gym(Kèm 12 chi tiết gồm cả dây số 8)",99500,199000,99500,50
TIKI,the-thao-da-ngoai,129241363,"Dụng cụ cầm tay đa năng Leatherman Signal (19 tools)",3500000,3500000,0,0
TIKI,the-thao-da-ngoai,176533448,"Set đồ tập yoga gym Luxury Hibi Sports H143, quần đùi lưng cao, màu Đen kèm mút ngực, vải cao cấp Lu Fabric",649000,1150000,501000,44
TIKI,the-thao-da-ngoai,32034898,"Máy Câu Cá Daiwa MG S",577000,577000,0,0
TIKI,the-thao-da-ngoai,73127967,"Dụng Cụ Hít Đất Chống Đẩy  Lõi Thép  Chịu Lực  Cleacco - Hàng Chính Hãng BORO SPORT",102000,188000,86000,46
TIKI,the-thao-da-ngoai,31976950,"Quần shorts thể thao nam 2 lớp không xuyên thấu 3 trong 1 - Gym - Bơi - Ngủ SQ469",99000,99000,0,0
TIKI,the-thao-da-ngoai,34184476,"Cặp tạ tay bọc caosu Brosman 2kg",280000,280000,0,0
TIKI,the-thao-da-ngoai,186742259,"Giày đá bóng nam cỏ nhân tạo MTC Faster Nhiều Màu cao cổ thể thao phong cách chính hãng - MF005",455000,455000,0,0
TIKI,the-thao-da-ngoai,112544231,"GĂNG TAY THỂ THAO ADIDAS ADGB-1315C (MẪU CŨ)",223000,230000,7000,3
TIKI,the-thao-da-ngoai,59306147,"Bộ 2 đai bó bảo vệ đầu gối AOLIKES YE-7909 có nẹp lò xo hỗ trợ dây chằng khớp gối Pressurized knee support - Hàng Chính Hãng",498000,899000,401000,45
TIKI,the-thao-da-ngoai,166874076,"Ván SUP bơm hơi Aztron Urono 2.0 11'6" Touring AS-312D",13000000,13000000,0,0
TIKI,the-thao-da-ngoai,23802217,"Túi đeo bụng chạy bộ phản quang, chống nước Rimix RM2204",139000,228000,89000,39
TIKI,the-thao-da-ngoai,2282527,"Bật Lửa Zippo Vintage Brushed Brass",845000,845000,0,0
TIKI,the-thao-da-ngoai,756673,"Vợt Cầu Lông Không Dây Winex Nanotec 9910 - Đỏ",990000,990000,0,0
TIKI,the-thao-da-ngoai,88979786,"Dụng cụ cầm tay đa năng Leatherman Wave Plus Silver (17 tools)",2990000,2990000,0,0
TIKI,the-thao-da-ngoai,162044726,"Giàn Tạ Đa Năng Zasami 8215 Có xà đơn xà kép gồm 1 đòn tạ 1m5 - Tặng kèm 1 đôi găng tay - Lựa chọn mức tạ ngẫu nhiên",7180000,9450000,2270000,24
TIKI,the-thao-da-ngoai,58530328,"Kính Bảo Vệ Chơi Thể Thao, Bóng Rổ, Bóng Đá Chống Sương Mù, Mồ Hôi Cao Cấp REXCHI",125000,125000,0,0
TIKI,the-thao-da-ngoai,146363178,"Giày Cầu Lông Cao Cấp",435200,435200,0,0
TIKI,the-thao-da-ngoai,144404379,"Đai hỗ trợ bảo vệ khớp vai Aolikes chính hãng HJ-1693",99000,99000,0,0
TIKI,the-thao-da-ngoai,152205180,"Quần ngắn thể thao nam LFC Board - A15035",495000,990000,495000,50
TIKI,the-thao-da-ngoai,168586689,"Đèn pin đeo đầu chính hãng Naturehike NH17G025-D",450000,450000,0,0
TIKI,the-thao-da-ngoai,104633663,"Giàn tạ đa năng KINGSPORT BK-399 Pro đa năng, khung sườn bằng thép Oval không rỉ, thiết kế ghế tự điều chỉnh tăng giảm với 7 cấp độ",26587000,35000000,8413000,24
TIKI,the-thao-da-ngoai,114255043,"Dụng cụ hỗ trợ cổ tay Harbinger Red Line WristWraps_Black-Red",399000,399000,0,0
TIKI,the-thao-da-ngoai,113438293,"Ghế Xếp Cắm Trại Naturehike NH19JJ004 Khung Nhôm",980000,980000,0,0
TIKI,the-thao-da-ngoai,197739066,"Lều cắm trại tự bung , lều du lịch dã ngoại dành cho 6-8 người, chống thấm nước -ZL039",3980000,3980000,0,0
TIKI,the-thao-da-ngoai,77158009,"Set Q007 BÓNG TẬP GOLF TRONG NHÀ - PGM 10 quả",50000,100000,50000,50
TIKI,the-thao-da-ngoai,68402314,"Ghế cafe, ghế câu cá thư giãn xếp gọn nhẹ VIMOS -86",185000,185000,0,0
TIKI,the-thao-da-ngoai,65505919,"Dụng Cụ Hít Đất 22in1- Dụng Cụ Chống Đẩy 20 lỗ – Cải Tiến Tháo Rời - Nhiều Nút, Nhiều Bài Tập Hơn Kèm Chống Trượt – mi03 - Chính Hãng miDoctor",199000,199000,0,0
TIKI,the-thao-da-ngoai,193287755,"Đai chạy bộ, Túi đeo hông chạy bộ LiveFit cao cấp - Running Belt - WB0924",250000,250000,0,0
TIKI,the-thao-da-ngoai,179951401,"Áo bơi chống nắng nữ Zoggs - 464001",358000,899000,541000,60
TIKI,the-thao-da-ngoai,114253531,"Con lăn tập gym unisex TriggerPoint - 350013",1099000,1099000,0,0
TIKI,the-thao-da-ngoai,26151300,"Băng bảo vệ cánh tay thể thao cao cấp Futuro 80202 size L/XL",160000,160000,0,0
TIKI,the-thao-da-ngoai,185917520,"Túi ngủ Naturehike LW180 NH21MSD09 gấp gọn siêu nhẹ túi ngủ cắm trại (mới)",470000,470000,0,0
TIKI,the-thao-da-ngoai,148823670,"Quần ngắn thể thao nam New Balance Q Speed Fuel 7 Inch - MS11280 (form Quốc tế)",972000,1295000,323000,25
TIKI,the-thao-da-ngoai,183332146,"Cặp vợt tennis trẻ em hợp kim cao cấp Regail W150 Sportslink",220000,291000,71000,24
TIKI,the-thao-da-ngoai,100321181,"Bao Da Bật Lửa Zippo Chuyên Dụng Da Cá Sấu Chất Lượng KEIO NIPPON",359000,359000,0,0
TIKI,the-thao-da-ngoai,23936971,"Ván bập bênh, Ván thăng bằng cho bé, Đồ chơi kỹ năng theo phương pháp giáo dục Montessori, Ván thăng bằng cho người lớn tập Yoga - Joy Roker Board - Gỗ Plywood cao su uốn cong  - Lau dầu thực vật",450000,650000,200000,31
TIKI,the-thao-da-ngoai,118007743,"Tất đá bóng, tất thể thao, vớ đá banh, tất dệt kim CAO CẤP AKKA PRO",50000,60000,10000,17
TIKI,the-thao-da-ngoai,12216822,"Lưới cầu lông luyện tập Hải Yến cao cấp",101000,199000,98000,49
TIKI,the-thao-da-ngoai,47318745,"Viên Uống NOW FOODS 7 Keto LeanGels 100mg Giúp Kiểm Soát Cân Nặng, Giảm Béo, Chuyển Hóa Chất Béo Lọ 60 Viên",1005000,1005000,0,0
TIKI,the-thao-da-ngoai,47322682,"Bật Lửa ZIPPO FATHER’S LOVE – ZIPPO FATHERLOVE",980000,980000,0,0
TIKI,the-thao-da-ngoai,68069887,"PUMA - Đầm mini ba lỗ Puma x Sue Tsai 578214",2230000,2230000,0,0
TIKI,the-thao-da-ngoai,68740960,"Tạ tay 2 in 1 kết hợp tạ đẩy (tạ đòn) loại 40KG",759000,1518000,759000,50
TIKI,the-thao-da-ngoai,141002363,"Lều Đơn Lều 1 Người Cắm Trại Dã Ngoại Gọn Nhẹ Chất Lượng Cao Galaxy Store GSL12 - Hàng Chính Hãng (Màu Ngẫu Nhiên)",1180000,1950000,770000,39
TIKI,the-thao-da-ngoai,147893339,"Dây kháng lực tập gym cao su tự nhiên, mức lực kéo phân theo từng màu, tiện lợi mang theo bất cứ đâu, Dây kháng lực Power Band đa năng, hỗ trợ luyện tập thể dục, tiện lợi tại nhà, văn phòng - Chính hãng dododios",40000,40000,0,0
TIKI,the-thao-da-ngoai,183785264,"Siêu phẩm giày đá banh đá bóng wika 3 sọc cao cấp giày đá banh có đinh được khâu full đế",160000,160000,0,0
TIKI,the-thao-da-ngoai,3669097,"Đai Quấn Bụng Bảo Vệ Cột Sống Thắt Lưng AOLIKES TC-1690",172000,259000,87000,34
TIKI,the-thao-da-ngoai,191572797,"Bộ quần áo mưa givi nữ EAS10",898000,898000,0,0
TIKI,the-thao-da-ngoai,96209320,"Bộ 2 đai bảo vệ khớp xương bánh chè AOLIKES YE-7928 Sport compression patella band",297000,389000,92000,24
TIKI,the-thao-da-ngoai,59156565,"Giá treo nồi dã ngoại cắm trại gấp gọn Naturehike NH17S00S-G",298000,298000,0,0
TIKI,the-thao-da-ngoai,189389699,"Giày đá bóng trẻ em PROWIN H21 KID Xanh Dương chính hãng, giày đá banh cỏ nhân tạo đẹp - HK002",305000,305000,0,0
TIKI,the-thao-da-ngoai,8128678,"Bộ đòn 1m5 - 40kg tạ ( 2 đĩa 10kg, 2 đĩa 5kg, 2 đĩa 3kg, 2 đĩa 2kg )",1496000,1950000,454000,23
TIKI,the-thao-da-ngoai,192741613,"Đôi giày đá bóng Wika Flash Chính Hãng siêu ôm chân",365000,365000,0,0
TIKI,the-thao-da-ngoai,125948845,"Tạ Bình Vôi,Tạ Quai Xách 6kg Bọc Cao Su Cao Cấp (Màu Ngẫu Nhiên)",341000,700000,359000,51
TIKI,the-thao-da-ngoai,9673344,"Quần bó thể thao NỮ INTENSITY MID TIGHT W - L40083000",1134000,1890000,756000,40
TIKI,the-thao-da-ngoai,14506768,"Bóng rổ Spalding NBA Team Los Angeles Lakers 83-510Z Outdoor size 7- Tặng kèm Kim bơm bóng và Túi lưới đựng bóng",199000,199000,0,0
TIKI,the-thao-da-ngoai,47104868,"Đai bảo vệ đầu gối thiết kế lò xo trợ lực khớp gối Sport Knee Pad AOLIKES YE-7908",181000,359000,178000,50
TIKI,the-thao-da-ngoai,109223906,"VỢT CẦU LÔNG ĐÃ ĐAN LƯỚI PROKENNEX ARROW 17 AIR 7U SIÊU NHẸ CHẤT LƯỢNG CHÍNH HÃNG (1 cây) - Tặng kèm quấn cán",2264000,3500000,1236000,35
TIKI,the-thao-da-ngoai,164502007,"Xe Đạp Thể Dục Tựa Lưng Trong Nhà Mỹ Horizon Comfort R-02",26950000,38500000,11550000,30
TIKI,the-thao-da-ngoai,179746082,"Giày chạy bộ Nữ PEAK Taichi 3.0 Water-Shield màu Trắng Be EW14628H",999000,1890000,891000,47
TIKI,the-thao-da-ngoai,144400265,"Xe Đạp Tập Thể Dục Tập Gym Tại Nhà MK294 Cao Cấp Đại Nam Sport + Tặng Máy Massage Xung Điện",3125000,5000000,1875000,38
TIKI,the-thao-da-ngoai,60234058,"Cần câu cá Daiwa Air X 662MFB 702MHFB - 1m98 2m14 cần lure máy ngang",1115000,1115000,0,0
TIKI,the-thao-da-ngoai,59157455,"Tấm chắn gió bếp ga dã ngoại xếp gọn Naturehike NH15F008-B",130000,130000,0,0
TIKI,the-thao-da-ngoai,97077369,"[MUA 1 TẶNG 1] Áo Thể Thao Nữ Áo Cầu Lông Nữ Cao Cấp Vina Authentic AVT06W",179000,179000,0,0
TIKI,the-thao-da-ngoai,186081571,"Bộ 4 Dây Gió Căng Lều Naturehike NH15A001-G",50000,50000,0,0
TIKI,the-thao-da-ngoai,25645422,"Bật Lửa Zippo 28807 - Bật Lửa Zippo Armor Dragon Eye Polished Chrome",2255000,2255000,0,0
TIKI,the-thao-da-ngoai,145842434,"Mùng chống muỗi dùng cho Võng dã ngoại Naturehike NH21DC00A",690000,690000,0,0
TIKI,the-thao-da-ngoai,180326580,"Dây nhảy thể dục siêu nhẹ, siêu bên, tùy chỉnh độ dài linh hoạt chính hãng Goodfit GF90XJR",37000,69000,32000,46
TIKI,the-thao-da-ngoai,191722966,"Giày thể thao chạy bộ nam Under Armour FLOW VELOCITI WIND 2 - 3024903",3077000,4395000,1318000,30
TIKI,the-thao-da-ngoai,183526047,"XÀ ĐƠN ,XÀ KÉP ĐA NĂNG THẾ HỆ MỚI 8IN1 CAO CẤP,TREO TƯỜNG CỰC CHẤT",1290000,2580000,1290000,50
TIKI,the-thao-da-ngoai,67056445,"Bóng rổ Gerustar Size 7 PU 2M Federation - Dán (Tặng Băng dán thể thao + Kim bơm + Lưới đựng)",379000,399000,20000,5
TIKI,the-thao-da-ngoai,72117469,"Vợt Tennis Babolat EVO DRIVE",3690000,3690000,0,0
TIKI,the-thao-da-ngoai,160779245,"Vợt Tennis Babolat Pure STRIKE TEAM 285gram 3rd Gen (101402)",4299000,4299000,0,0
TIKI,the-thao-da-ngoai,70838435,"Bộ 2 Đòn Tạ Tay 35cm Bọc Cao Su Cao Cấp Đại Nam Sport",249000,500000,251000,50
TIKI,the-thao-da-ngoai,35772501,"Cặp Tạ Đeo Tay Adidas 1kg ADWT-12228",697000,719000,22000,3
TIKI,the-thao-da-ngoai,92956844,"Quần leggings tập gym cho nam Hibi Sports M106 - Loại dài có 1 túi hông",294000,420000,126000,30
TIKI,the-thao-da-ngoai,6587717,"Bật Lửa Zippo Harley Davidson Motor Flag Street Chromre 29266",1770000,1770000,0,0
TIKI,the-thao-da-ngoai,55422962,"Bộ cần câu - Gồm cần carbon huntes Man - Kèm máy kim loại GF 5000 - Tặng 9 phụ kiện cm01",259000,259000,0,0
TIKI,the-thao-da-ngoai,198304567,"Đạm thực vật hữu cơ không chất làm ngọt - Organic Plant Protein Natural Unsweetened 720gr Orgain",1320000,1643000,323000,20
TIKI,the-thao-da-ngoai,72541263,"Balo Tennis Babolat PURE AERO 2021 (753094)",1648000,1979000,331000,17
TIKI,the-thao-da-ngoai,180330081,"Gậy bẻ tập cơ tay,Gậy lò xo bẻ tập cơ tay, cơ bụng lực(khách chọn lực bẻ phù hợp với sức của mình)20kg,30kg,40kg,50kg",59000,118000,59000,50
TIKI,the-thao-da-ngoai,31716264,"Vợt cầu lông Apacs DUAL 100 tặng kèm dây đan vợt+quấn cán vợt",1823000,1899000,76000,4
TIKI,the-thao-da-ngoai,118007818,"Tất đá bóng vớ đá banh thể thao dệt kim AKKA",30000,40000,10000,25
TIKI,the-thao-da-ngoai,154314245,"Thiết Bị Chơi Golf Mô Phỏng Cao Cấp Tại Nhà TMAX PUTTJOY: Nhỏ Gọn, App Chơi Golf Miễn Phí.",4680000,4680000,0,0
TIKI,the-thao-da-ngoai,20627330,"Võ phục Karate Taburo form Kata cao cấp",1250000,1250000,0,0
TIKI,the-thao-da-ngoai,58216699,"Đai quấn bụng bảo vệ cột sống AOLIKES YE-1690 định hình cơ bụng Sport waist protector - Hàng Chính Hãng",172000,259000,87000,34
TIKI,the-thao-da-ngoai,167422316,"Đòn tập tạ Reefit dài 1m8 (phi 25)",325000,325000,0,0
TIKI,the-thao-da-ngoai,159668059,"Dụng Cụ Hít Đất Hỗ Trợ Chống Đẩy Đa Năng 16 trong 1 - Bảng Chống Đẩy SP010 Chính Hãng Amalife",129000,129000,0,0
TIKI,the-thao-da-ngoai,47323026,"Bật Lửa ZIPPO XANH CHAMELEON LOGO KHẮC THUỐC LÁ 555 – ZIPPO 28129ZL.555",1065000,1065000,0,0
TIKI,the-thao-da-ngoai,189573356,"Băng nẹp ngón tay cái bảo vệ, hỗ trợ bong gân GoodFit GF305W nẹp cố định cổ tay thoáng khí",80000,129000,49000,38
TIKI,the-thao-da-ngoai,33277129,"Thảm Yoga Adidas 5mm ADYG-10500RS",1900000,2250000,350000,16
TIKI,the-thao-da-ngoai,35772512,"Gạch Yoga Adidas ADYG-20100FOAM",279000,288000,9000,3
TIKI,the-thao-da-ngoai,189591505,"Áo bơi chống nắng nữ Speedo SP TOP AF - 8-131891740",313000,695000,382000,55
TIKI,the-thao-da-ngoai,9883824,"Vợt Cầu lông APACS NANO 900 Power (Trắng/đen)",1247000,1299000,52000,4
TIKI,the-thao-da-ngoai,172372138," Xà đơn khoan tường đa năng Gymlink Wall Pull Up Bar GLS1009",1198000,1198000,0,0
TIKI,the-thao-da-ngoai,96202540,"Đai bảo vệ xương bánh chè đầu gối AOLIKES YE-7928 Sport compression patella band",153000,259000,106000,41
TIKI,the-thao-da-ngoai,166418131,"Ván SUP bơm hơi Aquatone Flame 12'6" Touring TS-313D",11300000,11300000,0,0
TIKI,the-thao-da-ngoai,186558681,"Khung Nắn Chỉnh Cột Sống Giảm Thoát Vị Đĩa Đệm Massage Lưng Doctor Spine",95000,95000,0,0
TIKI,the-thao-da-ngoai,88738351,"SET Dây Kháng Lực Tập Mông AOLIKES Có Quấn Cổ Chân Legs Pulley Strap Lifting Fitness",165000,165000,0,0
TIKI,the-thao-da-ngoai,192314029,"Quấn bảo vệ cổ tay tập gym AOLIKES A-1538 đàn hồi cao cấp Sport wrist protector",153000,289000,136000,47
TIKI,the-thao-da-ngoai,86145247,"Bật Lửa Zippo Bạc Giả Cổ 121Fb Khắc Hoa Mẫu Đơn 4 Mặt – Zippo 121Fb.Maudon",1335000,1335000,0,0
TIKI,the-thao-da-ngoai,155200226,"Ghế Xếp Gọn Thư Giãn Đi Câu Dã Ngoại Đa Năng - Hàng Chính Hãng",809000,899000,90000,10
TIKI,the-thao-da-ngoai,74854593,"Áo Giữ Nhiệt Thể Thao Nam - Áo Tập Gym Dài Tay Thun Mềm Mịn Co Giãn 4 Chiều SZone",99000,99000,0,0
TIKI,the-thao-da-ngoai,195201114,"[Hàng chính hãng – Thương hiệu Mỹ] Bình giữ nhiệt Elemental Iconic sport màu xanh lá 590ml, giữ nhiệt vượt trội, inox 304, FDA Hoa Kì, An toàn sức khỏe, có ống hút",799000,799000,0,0
TIKI,the-thao-da-ngoai,132815070,"Quần Cạp Cao Cosmo Tropical Sobie",168000,280000,112000,40
TIKI,the-thao-da-ngoai,174919092,"Quần ngắn thể thao nam Under Armour Speedpocket 5'' - 1361486-001",949000,1355000,406000,30
TIKI,the-thao-da-ngoai,114011454,"Băng Đô Chơi Thể Thao ️FREE SHIP️ Băng trán chơi thể thao Aolikes (1 Cái)",30000,30000,0,0
TIKI,the-thao-da-ngoai,118007649,"Túi trống thể thao balo trống túi tập gym AKKA CLIMA COOL",180000,180000,0,0
TIKI,the-thao-da-ngoai,148038979,"Đồ bơi một mảnh nữ Speedo Hero Hydrasuit - 8-127870001",740000,1849000,1109000,60
TIKI,the-thao-da-ngoai,159898189,"Giày bóng đã sân cỏ nhân tạo đinh TF bản to- công nghệ đinh mới nhất 2022",250000,389000,139000,36
TIKI,the-thao-da-ngoai,16510244,"Găng Tay Chống Nắng Chống Tia Uv - PGM XT004",257000,295000,38000,13
TIKI,the-thao-da-ngoai,70001813,"Băng bảo vệ cổ chân thể thao đàn hồi GoodFit GF614A",156000,199000,43000,22
TIKI,the-thao-da-ngoai,193442561,"Vợt cầu lông Prokennex KINETIC EXTREME SPEED NEW chính hãng cao cấp công thủ toàn diện (1 cây) - Tặng kèm quấn cán",4424000,5288000,864000,16
TIKI,the-thao-da-ngoai,183501993,"Vợt tennis chuyên nghiệp carbon siêu nhẹ Regail NDL-02",552000,575000,23000,4
TIKI,the-thao-da-ngoai,103209796,"Cặp vợt cầu lông siêu nhẹ quấn cao su Agnite - 2 chiếc màu khác nhau - Kèm túi bao cao cấp - Phù hợp thể thao vận động - F2108",165000,268200,103200,38
TIKI,the-thao-da-ngoai,59304205,"Bó bảo vệ khớp gối AOLIKES YE-7909 thiết kế nẹp lò xo hỗ trợ đầu gối Pressurized knee support - Hàng Chính Hãng",268000,389000,121000,31
TIKI,the-thao-da-ngoai,126882225,"Đầm bơi nữ Speedo Boom Logo SPL AF - 8-129373503",594000,1695000,1101000,65
TIKI,the-thao-da-ngoai,2282539,"Bật Lửa Zippo Vintage High Polish Chrome",785000,785000,0,0
TIKI,the-thao-da-ngoai,42657178,"Bộ Thảm Tập Yoga Định Tuyến 8mm 1 lớp TPE + Kèm túi và dây buộc thảm",349000,600000,251000,42
TIKI,the-thao-da-ngoai,2282595,"Bộ 2 Sản Phẩm Xăng, Đá Zippo",150000,150000,0,0
TIKI,the-thao-da-ngoai,110135649,"Bấc Zippo mẫu mới",42000,42000,0,0
TIKI,the-thao-da-ngoai,155367681,"Quần thể thao nữ legging dài IBX IBX063P",249000,499000,250000,50
TIKI,the-thao-da-ngoai,53497722,"Bóng chuyền Molten V5M4200",699000,699000,0,0
TIKI,the-thao-da-ngoai,181775832,"Túi ngủ Naturehike NH21MSD09",540000,540000,0,0
TIKI,the-thao-da-ngoai,187605112,"Giày chạy bộ nữ New Balance Cushioning - W880M12",2333000,3195000,862000,27
TIKI,the-thao-da-ngoai,32114111,"Bật Lửa Zippo 49054 – Zippo Armor High Polish Green Elegant Dragon",4140000,4140000,0,0
TIKI,the-thao-da-ngoai,86145112,"Bật Lửa Zippo 236 Khắc Mộc Đáy 2 Mặt 06 – Zippo 236.Mocday06",995000,995000,0,0
TIKI,the-thao-da-ngoai,33420908,"Băng Bảo Vệ Khủy Tay Hỗ Trợ Tập GYM, Tennis, Cầu Lông Aolikes Elbow Support AL-7948 (1 Đôi)",145000,145000,0,0
TIKI,the-thao-da-ngoai,67331342,"Ghế tập cơ bụng đa năng cao cấp 2 in1 SU-200",1399000,2599000,1200000,46
TIKI,the-thao-da-ngoai,92319233,"Tạ Bình Vôi,Tạ Quai Xách 6kg Bằng Gang Đúc Nguyên Khối Hàng Việt Nam Chất Lượng Cao",317000,500000,183000,37
TIKI,the-thao-da-ngoai,170689698,"Quần ngắn thể thao nam New Balance Q Speed Fuel 5 Inch - MS11281 (form Quốc tế)",972000,1295000,323000,25
TIKI,the-thao-da-ngoai,7018421,"Giày bóng đá Mitre chuyên nghiệp MT170501",521000,521000,0,0
TIKI,the-thao-da-ngoai,126082513,"Ván SUP bơm hơi Gladitor Pro Touring 11'2",12750000,12750000,0,0
TIKI,the-thao-da-ngoai,194104458,"Ống thở lặn unisex Zoggs Centre Line Snorkel - 465287",595000,595000,0,0
TIKI,the-thao-da-ngoai,162167838,"Giày Bóng Rổ Thời Trang Thể Thao PEAK Taichi Colorful 6371 E13757E",799000,1110000,311000,28
TIKI,the-thao-da-ngoai,8421441,"Áo Thể Thao NAM S-LAB SENSE TEE M - L40216800",2300000,2300000,0,0
TIKI,the-thao-da-ngoai,162087872,"Tarp Tấm Tăng Bạt Che Chống Nước Tia UV Lều Chữ A Cao Cấp Galaxy Store GTC03 - Hàng Chính Hãng",1040000,1500000,460000,31
TIKI,the-thao-da-ngoai,275323370,"Xe Đạp Tập Tại Nhà - Xe Đạp Tập Gym Tại Nhà - Thiết kế khung thép sang trọng và chắc chắn, Màn hình LED điện tử thông minh",99000,99000,0,0
TIKI,the-thao-da-ngoai,11493033,"Kính bơi cao cấp Kasup tích hợp bịt tai - KS5559 (Giao màu ngẫu nhiên)",109000,220000,111000,50
TIKI,the-thao-da-ngoai,146491450,"Cần Câu Cá Daiwa Bass X 722MHB Cần Lure Máy Ngang 2m18 Khoen Pat Fuji Sản Phẩm Chính Hãng Made In Việt Nam",1938000,1938000,0,0
TIKI,the-thao-da-ngoai,886682,"Khăn Bịt Mặt Đầu Lâu Đa Chức Năng Winwinshop88 KNMDL - Đen",14800,14800,0,0
TIKI,the-thao-da-ngoai,35772518,"Cặp Tạ Đeo Chân Adidas 2kg ADWT-12230",1173000,1210000,37000,3
TIKI,the-thao-da-ngoai,2812325,"Quần Thể Thao Nữ Salomon Agile Short W - L39271300 Size",534000,890000,356000,40
TIKI,the-thao-da-ngoai,97546086,"Băng bảo vệ gót chân LP SUPPORT LP944 (Kem) - Hàng chính hãng",168000,250000,82000,33
TIKI,the-thao-da-ngoai,52873162,"Bóng Đàn Hồi Mát Xa TRB COMBO PTP ",375000,375000,0,0
TIKI,the-thao-da-ngoai,83783112,"Đèn khò gas Campingmoon MT-3955",637000,637000,0,0
TIKI,the-thao-da-ngoai,102579554,"Quần đùi QB2008 hàng chính hãng bendu mẫu mới 2021",255000,255000,0,0
TIKI,the-thao-da-ngoai,77728665,"Giàn tạ đa năng kết hợp xà đơn xà kép Zasami 8211 ( chưa gồm  đòn và tạ ) ",4899000,7500000,2601000,35
TIKI,the-thao-da-ngoai,35508161,"Dụng Cụ Leo Núi SeNSe Ultra Foldable Poles BK - L40561100",3960000,3960000,0,0
TIKI,the-thao-da-ngoai,162984453,"KEO DÁN VỢT BÓNG BÀN HAIFU 2021 – KEO QUỐC DÂN CỦA GIỚI BÓNG BÀN",75000,75000,0,0
TIKI,the-thao-da-ngoai,58326197,"Cần câu lure - Bộ cần câu kèm máy kim loại cao cấp 2m4 - Tặng kèm 1 ngọn cần và kèm cước BCL02",359900,359900,0,0
TIKI,the-thao-da-ngoai,73994427,"Ghế tập Gym đa năng DDS-1201 ",2125000,2125000,0,0
TIKI,the-thao-da-ngoai,6492713,"Bật Lửa Zippo Slim Spectrum 20493",790000,790000,0,0
TIKI,the-thao-da-ngoai,25650489,"Bật Lửa Zippo 1607 Slim Street Chrome",535000,535000,0,0
TIKI,the-thao-da-ngoai,24732946,"Võ phục Karate Taburo phong trào loại tốt",275000,275000,0,0
TIKI,the-thao-da-ngoai,45320401,"Thảm Yoga du lịch PRO-CARE",921000,950000,29000,3
TIKI,the-thao-da-ngoai,170110513,"Combo bộ quần áo thể thao bóng đá Bulbal chính hãng Trắng",209000,209000,0,0
TIKI,the-thao-da-ngoai,25650155,"Bật Lửa Zippo 1618 Slim Black Matte",660000,660000,0,0
TIKI,the-thao-da-ngoai,101852330,"Bộ 4 Dây Kháng Lực Miniband SP091 Tập Mông,Chân Và Yoga Cho Nam, Nữ Đại Nam Sprort (Hàng Loại 1)",93000,180000,87000,48
TIKI,the-thao-da-ngoai,186208323,"Ba lô tennis Djokovic Backpack 2022(283302)",1599000,1690000,91000,5
TIKI,the-thao-da-ngoai,170842449,"Túi vợt thể thao cầu lông Lining chính hãng ABJS023 có 2 màu lựa chọn",1500000,1500000,0,0
TIKI,the-thao-da-ngoai,198462601,"Giày cầu lông nam Lining chính hãng AYTS016-5 mẫu mới màu đen vàng trẻ trung năng động-tặng tất thể  thao bendu",1500000,1500000,0,0
TIKI,the-thao-da-ngoai,193234650,"Áo T-Shirt Có Tay Chạy Bộ Make It Move AONIJIE",399000,399000,0,0
TIKI,the-thao-da-ngoai,38062513,"Găng Tay Boxing Người Lớn Amalife – Găng Tay Đấm Bốc Người Lớn Chính Hãng",229000,229000,0,0
TIKI,the-thao-da-ngoai,3871827,"Bộ đôi đai cuốn bảo vệ đầu gối Aolikes AL0219",91000,91000,0,0
TIKI,the-thao-da-ngoai,71959100,"Vợt Tennis Babolat Evo Drive Lite Strung",3617000,3790000,173000,5
TIKI,the-thao-da-ngoai,21381493,"Dây kéo lò so tummy trimmer",29000,29000,0,0
TIKI,the-thao-da-ngoai,20847669,"Bật lửa ZIPPO 250 –Bật lửa ZIPPO HIGH POLISHED CHROME",715000,715000,0,0
TIKI,the-thao-da-ngoai,195520856,"Đai chạy bộ, Túi đeo hông chạy bộ LiveFit cao cấp - Running Belt - WB09",250000,250000,0,0
TIKI,the-thao-da-ngoai,147024330,"Túi vợt cầu lông chính hãng thể thao 2 ngăn lớn PROKENNEX PRO22B51",843000,1200000,357000,30
TIKI,the-thao-da-ngoai,173689647,"Mẫu giày bóng đá phủi chính hãng Wika QH19NEO 2022",450000,450000,0,0
TIKI,the-thao-da-ngoai,51996833,"Bật Lửa Zippo 29860 – Zippo Armor James Bond 007 High Polish Brass",2665000,2665000,0,0
TIKI,the-thao-da-ngoai,4782009,"Còi nhựa thể thao Sportslink (Cái) - Màu ngẫu nhiên",15000,15000,0,0
TIKI,the-thao-da-ngoai,94349592,"Áo tập gym nam Hibi Sports T102 - Phối màu chéo, form ôm vừa, kiểu ngắn tay",199000,340000,141000,41
TIKI,the-thao-da-ngoai,89477426,"Bộ cặp tạ tay  4kg bọc cao su (Tổng 8kg)- Màu ngẫu nhiên",450000,900000,450000,50
TIKI,the-thao-da-ngoai,77712100,"Bộ 2 băng quấn cổ tay tập gym AOLIKES YE-7938 Sport wrist support",153000,229000,76000,33
TIKI,the-thao-da-ngoai,82979179,"Giày Cầu Lông, Giày Bóng Bàn, Giày Bóng Chuyền",323000,323000,0,0
TIKI,the-thao-da-ngoai,98058866,"GIÀY CHẠY BỘ ĐỊA HÌNH SENSE RIDE 4 BLACK L41378100",2280000,3800000,1520000,40
TIKI,the-thao-da-ngoai,177626346,"Con Lăn Massage Foam Gai Dẹt 45x14 cm Ống Lăn Giãn Cơ Tập Yoga, Gym",179000,358000,179000,50
TIKI,the-thao-da-ngoai,198185938,"Giày đá bóng Zocker INSPIRE Green",659000,889000,230000,26
TIKI,the-thao-da-ngoai,186741210,"Giày Chạy Bộ Trẻ Em PEAK Running Galaxy EK1468H",799000,1490000,691000,46
TIKI,the-thao-da-ngoai,94302015,"Quần leggings tập gym cho nam Hibi Sports M105 - Loại lửng 3/4 có túi",273000,390000,117000,30
TIKI,the-thao-da-ngoai,66403958,"Bật lửa Zippo VE/VJ 75th Anniversary Collectible Steel Case – Zippo Victory in Europe & Japan Collectible Lighter – Zippo 49264",3520000,3520000,0,0
TIKI,the-thao-da-ngoai,74855485,"GIÀY CHẠY BỘ ĐỊA HÌNH SENSE RIDE 4 W BRICK DUST L41305500",2280000,3800000,1520000,40
TIKI,the-thao-da-ngoai,170110061,"Cặp giày bóng đá phủi thể thao chính hãng Wika Army Xanh siêu Hot",300000,300000,0,0
TIKI,the-thao-da-ngoai,48557009,"MÁY CÂU CÁ SHIMANO FX 4000 ",400000,400000,0,0
TIKI,the-thao-da-ngoai,100429084,"Giày bóng chuyền nam nữ chuyên dụng kumpoo KH-E23",563000,750000,187000,25
TIKI,thoi-trang-nam,124635780,"Áo sơ mi nam trơn tay dài cao cấp Lados - 779 chất kate lụa mềm mát, thấm hút mồ hôi",139000,235000,96000,41
TIKI,thoi-trang-nam,31638135,"Combo 4 quần lót nam Boxer sợi cạp 1cm sợi tre tự nhiên mềm mịn thấm hút mồ hôi, co giãn 4 chiều MRM Manlywear - Màu ngẫu nhiên",245000,340000,95000,28
TIKI,thoi-trang-nam,31637590,"Combo 4 quần lót nam tam giác Bamboo Organic mềm mịn thoáng mát thấm hút mồ hôi - MRM Manlywear - Màu Ngẫu Nhiên",239000,340000,101000,30
TIKI,thoi-trang-nam,67538621,"Combo 5 quần ĐÙI May 10 giao màu ngẫu nhiên",135000,135000,0,0
TIKI,thoi-trang-nam,172210350,"Hộp 4 quần boxer nam thun lạnh, quần lót nam co dãn 4 chiều- Formen Shop- FMQS017",169000,280000,111000,40
TIKI,thoi-trang-nam,99958075,"Quần đùi short gió nam thể thao Basic trẻ trung năng động, thoáng mát co giãn 4 chiều MRM Manlywear",119000,199000,80000,40
TIKI,thoi-trang-nam,164338704,"Áo Thun Nam Ngắn Tay 8 Màu Thiết Kế Thời Trang Cao Cấp AVIANO",129000,258000,129000,50
TIKI,thoi-trang-nam,99968881,"Set 2 quần đùi nam, quần Short Gió nam thể thao Basic trẻ trung năng động, thoáng mát co giãn 4 chiều MRM Manlywear",245000,399000,154000,39
TIKI,thoi-trang-nam,99183754,"Áo Polo Nam cổ bẻ TSIMPLE thun có cổ tay lỡ vải cá sấu cotton phong cách trẻ trung, chuẩn form, nhiều màu",170000,170000,0,0
TIKI,thoi-trang-nam,49165591,"Đồ bơi cho nam quần lửng",299000,299000,0,0
TIKI,thoi-trang-nam,99156609,"Áo Thun Nam cổ tròn TSIMPLE áo phông trơn basic tay ngắn vải cotton co giãn, dày dặn , form chuẩn nhiều màu",113000,113000,0,0
TIKI,thoi-trang-nam,52184516,"Combo 3 quần lót nam Boxer sợi Organic mềm mịn thoáng mát co giãn 4 chiều MRM Manlywear ( TẶNG Đôi Tất Nam Cao Cấp Giao Ngẫu Nhiên)",189000,285000,96000,34
TIKI,thoi-trang-nam,99325284,"Áo Thể Thao Nam TSIMPLE thun nam tập gym ngắn tay vải thun lạnh thoáng mát, co giãn, chuẩn form nhiều màu",113000,113000,0,0
TIKI,thoi-trang-nam,162033134,"Combo 5 quần đùi nam mặc nhà Cotton thoải mái thoáng mát Họa Tiết Ngẫu Nhiên - JAMANO",229000,350000,121000,35
TIKI,thoi-trang-nam,82819910,"Áo Polo nam cổ bẻ ngắn tay, chất liệu vải cá sấu cotton cao cấp, trẻ trung, năng động – FORMEN SHOP – FMPS150",159000,219000,60000,27
TIKI,thoi-trang-nam,111972654,"Quần Túi Hộp Tháo Ống US ARMY U880 Chuyên Phượt Chất Vải Gió Cao Cấp Mau Khô Ống Có Thể Tháo Rời Làm Quần Short -HÀNG CHÍNH HÃNG",337000,699000,362000,52
TIKI,thoi-trang-nam,160393397,"Áo thun polo nam ngắn tay, chất thun vải mềm mịn, thiết kế phần bo tay và cổ áo phối màu độc lạ - FORMEN SHOP - FMPS176",179000,250000,71000,28
TIKI,thoi-trang-nam,176250783,"Áo thun nam Cotton Compact Premium trẻ trung năng động thấm hút mồ hôi co giãn 4 chiều MRM Manlywear",139000,249000,110000,44
TIKI,thoi-trang-nam,22492292,"Áo polo nam ngắn tay có cổ ( TẶNG QUẦN LÓT NAM CAO CẤP ) , Combo 2 áo, DokaFashion regular fit chuẩn hàng xuất, áo phông thun polo nam tay ngắn – EZ235",159000,285000,126000,44
TIKI,thoi-trang-nam,126700166,"Quần Jean nam basic cao cấp LADOS - 4035 form slimfit, vải đẹp",500000,500000,0,0
TIKI,thoi-trang-nam,87981660,"Combo 2 áo ba lỗ nam, áo 3 lỗ nam, sợi cotton mềm mịn, thấm hút mồ hôi tốt, thoáng mát, mặc thoải mái JAMANO",149000,198000,49000,25
TIKI,thoi-trang-nam,95052893,"Quần short nam big size quần sọt nam thể thao chống nóng quần đùi nam mặc nhà quần thun nam cotton 4 chiều co giãn cao cấp WSB2",69000,115000,46000,40
TIKI,thoi-trang-nam,125800026,"Áo khoác dù 2 mặt chống Nước LADOS - 2027 , Form đẹp, chống nắng, chống nước tốt",379000,379000,0,0
TIKI,thoi-trang-nam,88011606,"Quần Sịp Nam Quần Lót Nam ( từ 40kg đến 100kg )  Dokafashion Sợi Cotton Mềm Mịn Siêu Thoáng Mát, Co Giãn 4 Chiều Cao Cấp EZQLH01",23000,49000,26000,53
TIKI,thoi-trang-nam,99329103,"Quần Thể Thao Nam TSIMPLE, quần short tập gym vải thun lạnh thoáng mát, co giãn, chuẩn form nhiều màu",113000,113000,0,0
TIKI,thoi-trang-nam,176251118,"Combo 2 Áo thun nam Cotton Compact Premium trẻ trung thấm hút mồ hôi, co giãn 4 chiều MRM Manlywear",279000,499000,220000,44
TIKI,thoi-trang-nam,154298071,"Combo 2 quần đùi nam, quần Short Gió nam thể thao Họa Tiết Rằn Ri trẻ trung năng động, thoáng mát co giãn 4 chiều MRM Manlywear",259000,399000,140000,35
TIKI,thoi-trang-nam,14694284,"Áo khoác nam 2 lớp GOKING, vải dù ấm áp, cản gió hiệu quả, thích hợp đông và thu đông (Màu xanh đen)",235000,235000,0,0
TIKI,thoi-trang-nam,76537581,"Quần Jean Nam Đen Trơn cao cấp thương hiệu Chandi, phong cách tôn dáng nam tính chất jean co dãn Mẫu J20",169000,280000,111000,40
TIKI,thoi-trang-nam,110704393,"Combo 2 quần đùi nam Cotton mặc nhà thoải mái thoáng mát JAMANO- MÀU NGẪU NHIÊN",99000,140000,41000,29
TIKI,thoi-trang-nam,163149118,"Áo Sơ Mi Trơn Vải Lụa Tay Ngắn Cho Nam LADOS - 8069",199000,199000,0,0
TIKI,thoi-trang-nam,74536479,"Áo khoác nam áo gió vải dù ( Tặng quần lót hàng hiệu ) DOKA STORE cao cấp 2 lớp chống nắng tia UV và chống nước khoát phong cách Hàn Quốc DF20",145000,149000,4000,3
TIKI,thoi-trang-nam,75329276,"Áo Polo Nam( Tặng 1 quần lót thái ) Pique Basic Co Giãn Thoáng Khí thương hiệu Doka, combo 2 áo - DBM215",139000,239000,100000,42
TIKI,thoi-trang-nam,193504415,"Combo 2 Áo thun thể thao nam MRM Active Pro thấm hút mồ hôi tốt co dãn thoải mái vận động",219000,399000,180000,45
TIKI,thoi-trang-nam,114571809,"Quần Sịp Nam Cao Cấp, Quần Lót Nam Thun Lạnh, Hộp 4 Sịp Đùi Nam Vải Sợi Tự Nhiên Thun Lạnh, Thoáng Khí, Co Giãn 4 Chiều, Không Phai Màu, Không Xù Lông, Thấm Hút Mồ Hôi, Thoát Hơi Và Kháng Khuẩn Rất Tốt",128000,128000,0,0
TIKI,thoi-trang-nam,52720544,"Quần Lót Nam Thun lạnh 4 chiều cao cấp màu ngẫu nhiên",26000,30000,4000,13
TIKI,thoi-trang-nam,52189164,"Combo 3 quần lót nam sợi cotton Organic mềm mịn thoáng mát co giãn 4 chiều MRM Manlywear (TẶNG Đôi Tất Nam Cao Cấp màu ngẫu nhiên)",189000,255000,66000,26
TIKI,thoi-trang-nam,79435123,"Áo chống nắng nam cao cấp, thông hơi, chống nắng, chống tia UV, chống bám bụi – FORMEN SHOP – FMTHT024",123000,215000,92000,43
TIKI,thoi-trang-nam,71985742,"Áo khoác dù UV mẫu mới 2024 ( Tặng 1 áo khoác kaki ) - Áo Khoác Chống Nắng đến 98% Chống Thấm Nước Có Túi Trong Kèm Túi Khóa Kéo Phong Cách Trẻ Trung",149000,298000,149000,50
TIKI,thoi-trang-nam,109403033,"Áo khoác gió nam nữ Goking, ngoài vải dù, trong lót lưới. 3 túi tiện dụng. Mã akg.goking4",225000,225000,0,0
TIKI,thoi-trang-nam,16712370,"Áo Khoác Kaki Nam Hai Lớp Simple Cao Cấp ShopN6-KK35",189000,245000,56000,23
TIKI,thoi-trang-nam,103076103,"áo ba lỗ nam, áo 3 lỗ nam sợi cotton Organic mềm mịn siêu thoáng mát thấm hút mồ hôi JAMANO",79000,99000,20000,20
TIKI,thoi-trang-nam,56873562,"Quần lót nam cao cấp thun lạnh (Dành cho các bạn từ 47-85kg), Co giãn 4 chiều cực tốt",27000,49000,22000,45
TIKI,thoi-trang-nam,126146318,"Áo sơ mi nam trơn không nhăn LADOS - 523, Chất vải mềm mát, thấm hút mồ hôi tốt, form slimfit",179000,179000,0,0
TIKI,thoi-trang-nam,35087712,"Quần lót nam thun lạnh không đường may, sịp nam tam giác cao cấp chất liệu thoáng mát, mềm mịn QLW606",85000,135000,50000,37
TIKI,thoi-trang-nam,56614642,"Combo 5 quần sịp boxer chất cotton mềm mịn, thoải mái",182000,245000,63000,26
TIKI,thoi-trang-nam,107186342,"Quần Tây Âu Nam Co Giãn Nhẹ Dáng Ôm, Quần Nam Công Sở Lịch Sự Phù Hợp Mọi Hoàn Cảnh Thương Hiệu Chandi Mã NT334",179000,299000,120000,40
TIKI,thoi-trang-nam,68573034,"Quần Bơi Nam Boxer Có Túi CLEACCO DEENYT Chất Liệu Nylon Cao Cấp , Chống Thấm , Nhanh Khô Form Fitness Thời Trang (Tặng kèm nón bơi + bịt tai silicon) - Hàng Chính Hãng",204000,323000,119000,37
TIKI,thoi-trang-nam,117031543,"Áo thun Teeworld ỦA Version 2 T-Shirt Nam Nữ Form Rộng Unisex",299000,299000,0,0
TIKI,thoi-trang-nam,47811534,"Quần shorts thể thao nam dạng sọt sport đùi chất thun lạnh 4 chiều cao cấp phù hợp tập gym hay mặc nhà có màu trắng và đen DUI-P101",75000,115000,40000,35
TIKI,thoi-trang-nam,20518115,"Quần Kaki Nam Khatoco Q2M468R1-VNMA017-1908-1- Xanh Rêu Đậm",161000,468000,307000,66
TIKI,thoi-trang-nam,75355716,"Quần Jean Nam Xanh phối Bạc Julido, ống Côn thời trang hàn quốc co dãn 4 chiều KVS9",169000,250000,81000,32
TIKI,thoi-trang-nam,111560211,"Quần Túi Hộp Nam Kaki Thời Trang Phong Cách Thể Thao US678 Chất Vải Kaki Cao Cấp Phong Cách Lính- HÀNG CHÍNH HÃNG",317000,658000,341000,52
TIKI,thoi-trang-nam,172120459,"Bộ 4 quần đùi nam, quần short mặc nhà kate caro nhiều màu , mềm mịn  - FORMEN SHOP- FMTT002",139000,160000,21000,13
TIKI,thoi-trang-nam,121252846,"Quần Boxer Nam sợi thun lạnh kháng khuẩn, Quần Lót Nam co giãn 4 chiều thấm hút mồ hôi cực tốt thương hiệu BAW (combo 3 màu ngẫu nhiên) NH79",149000,189000,40000,21
TIKI,thoi-trang-nam,126701222,"Quần tây cao cấp dài LADOS - 1327 - Hàng chất lượng ( ẢNH THẬT) chất dày dặn co giãn nhẹ thoải mái",350000,350000,0,0
TIKI,thoi-trang-nam,54713517,"Áo hoodie trơn màu đen thời trang trẻ trung, năng động - FORMENSHOP - FM5GV016",139000,250000,111000,44
TIKI,thoi-trang-nam,76166657,"Quần khaki nam không ply ống ôm xanh dương pha tím nhạt Khatoco Q2M528S0-CNMA006-2006-0",189000,528000,339000,64
TIKI,thoi-trang-nam,22490714,"Áo thun nam cổ bẻ ( Tặng 1 ví da nam hàng hiệu ) vải cá sấu, Combo 2 áo – EZ212",199000,285000,86000,30
TIKI,thoi-trang-nam,75628604,"Áo khoác dù nam, áo gió nam cao cấp, chống nắng, chống bám bụi – FORMEN SHOP – FMHN005",99000,209000,110000,53
TIKI,thoi-trang-nam,57800471,"Áo Khoác Dù Nam Hai Lớp Chống Nước Có Nón Áo Khoác Nam Dày Dặn Đi Phượt Cao Cấp AD54 - ShopN6 (Nhiều Màu)",179000,179000,0,0
TIKI,thoi-trang-nam,182968034,"quần lót nam relax uderwear cotton cao cấp chính hãng siêu xịn, quần sịp nam rl003",63000,63000,0,0
TIKI,thoi-trang-nam,81209773,"Quần Bò Nam cao cấp thương hiệu Chandi, chất jean co dãn Hot Trend mã MR9041",169000,169000,0,0
TIKI,thoi-trang-nam,191452803,"Quần Đùi Nam cao cấp chất Cotton dày dặn thoáng mát đủ màu Big size mùa hè QD03 - PROMAN",120000,120000,0,0
TIKI,thoi-trang-nam,55411656,"Quần Bơi Nam Dáng Đùi Cao Cấp SZone SQB105 Vải Mềm Mại Co Giãn Cực Tốt Phong Cách Chuyên Nghiệp",55000,55000,0,0
TIKI,thoi-trang-nam,20733222,"Áo khoác gió cách nhiệt GOKING có mũ, form unisex cho nam nữ. Ngoài vải dù, trong lót vải cào cách nhiệt. 3 túi to rộng, phối viền siêu đẹp",225000,225000,0,0
TIKI,thoi-trang-nam,87940800,"Quần Kaki Nam cao cấp thương hiệu Chandi, chất kaki co giãn xu hướng mã NT300-MÀU ĐEN",169000,239000,70000,29
TIKI,thoi-trang-nam,33610954,"Áo khoác da cá GOKING 6 túi, form unisex cho nam nữ, trẻ em. Chống lanh, giữ ấm, chống nắng, chống tia UV",280000,280000,0,0
TIKI,thoi-trang-nam,31638205,"Combo 4 quần lót nam cạp 1cm sợi tre Bamboo tự nhiên mềm mịn thấm hút mồ hôi - Màu Ngẫu nhiên",219000,300000,81000,27
TIKI,thoi-trang-nam,104192739,"Quần Boxer Nam sợi thun lạnh thông hơi kháng khuẩn, Quần Lót Nam co giãn 4 chiều thấm hút mồ hôi cực tốt thương hiệu BAW (combo 3 màu ngẫu nhiên) NT7986",129000,199000,70000,35
TIKI,thoi-trang-nam,11203758,"Combo 4 Quần Lót Đùi Nam Thông Hơi Thoáng Mát (Giao Màu Ngẫu Nhiên)",85000,85000,0,0
TIKI,thoi-trang-nam,68202834,"Combo 2 áo ba lỗ nam, áo sát nách nam,sợi cotton cao cấp mềm mịn, thấm hút mồ hôi, siều thoáng mát, co giãn 4 chiều Mrm Manlywear - MM",239000,310000,71000,23
TIKI,thoi-trang-nam,107801368,"Combo 2 quần đùi nam May 10 phiên bản có túi 2 bên, màu ngẫu nhiên",119000,119000,0,0
TIKI,thoi-trang-nam,71909603,"Áo hoodie nam nữ form rộng Unisex một màu in hoạt hình cá tính Hàn Quốc – FORMEN SHOP – FMGV034",105000,199000,94000,47
TIKI,thoi-trang-nam,110938120,"Áo Phông Nam Lính Mỹ (2 Màu), Chất Liệu Mềm Mại, Thoáng Mát, Chống Nhăn, Phom Dáng Xuông Trẻ Trung, Năng Động (U289)-HÀNG CHÍNH HÃNG",232000,499000,267000,54
TIKI,thoi-trang-nam,22761075,"Áo thun nam cổ bẻ ( Tặng 1 dây nịt da ) combo 3 áo  vải cá sấu - EZ334",269000,399000,130000,33
TIKI,thoi-trang-nam,43333663,"Combo 2 áo ba lỗ nam/áo 3 lỗ nam, sợi cotton mềm mịn siêu thoáng mát, thấm hút mồ hôi cực tốt, co giãn 4 chiều MRM FASHION -MM",219000,250000,31000,12
TIKI,thoi-trang-nam,98380938,"Quần đùi nam cotton mặc nhà iBasic SHM003",130000,159000,29000,18
TIKI,thoi-trang-nam,88011112,"Quần short nam Dokafashion thể thao cao cấp năng động cá tính EZQT01",58800,80000,21200,27
TIKI,thoi-trang-nam,193492866,"Áo thun thể thao nam MRM Active Pro thấm hút mồ hôi tốt co dãn thoải mái vận động",109000,199000,90000,45
TIKI,thoi-trang-nam,54762494,"Áo sơ mi nam tay ngắn form ôm caro Khatoco A1MN438S1-CNCR015-2102-N",291000,438000,147000,34
TIKI,thoi-trang-nam,72513159,"Áo khoác dù nam , áo khác dù nữ , áo khoác gió , áo khoác cặp đôi nam nữ mặc vải dù 2 lớp",90000,90000,0,0
TIKI,thoi-trang-nam,104904605,"Quần short nam big size quần sọt nam thể thao quần đùi nam mặc nhà quần thun nam cotton 4 chiều co giãn cao cấp ShopN6 - TSB2",59000,90000,31000,34
TIKI,thoi-trang-nam,114446808,"Quần tây nam màu xanh đen, ống đứng, không ly, đồng phục học sinh, công sở, thương hiệu Amazing, có size 100kg",224000,341000,117000,34
TIKI,thoi-trang-nam,58362412,"Áo khoác da cá GOKING 6 túi cho nam nữ, form unisex. Chống lanh, giữ ấm, chống nắng, chống tia UV hiệu quả",280000,280000,0,0
TIKI,thoi-trang-nam,105725699,"Quần Kaki Nam Kiểu Dáng Hàn Quốc Ống Côn Phong Cách Thể Thao",86000,86000,0,0
TIKI,thoi-trang-nam,117059903,"Áo thun Teeworld Ủa em Tay Lỡ Nam Nữ Form Rộng Unisex",299000,299000,0,0
TIKI,thoi-trang-nam,56742918,"Bộ 4 áo thun nam cổ bẻ cao cấp ( Tặng 1 dây nịt da ) DokaFashion, chất liệu thun cá sấu 4 chiều ngoại nhập - Trắng, Đỏ đô, Xám đậm, Đen",348500,571000,222500,39
TIKI,thoi-trang-nam,48048978,"Áo sơ mi caro Unisex nam nữ form rộng mẫu mới - MT01",92000,92000,0,0
TIKI,thoi-trang-nam,34148419,"Combo 3 Quần Lót Nam Boxer Cạp 1cm Bamboo Mix Màu Thương Hiệu MRM Manlywear",185000,255000,70000,27
TIKI,thoi-trang-nam,86988226,"Quần Jogger Nam thể thao túi hộp thương hiệu Chandi, chất kaki bo chân xu hướng mới nhất CD5",150000,299000,149000,50
TIKI,thoi-trang-nam,186743939,"[Size đến 5XL] Áo sơ mi kaki nam chất vải đẹp, dày dặn, màu siêu đẹp",259000,259000,0,0
TIKI,thoi-trang-nam,54711023,"Quần Bơi Nam Thiết Kế Vảy Cá Mập Cleacco Chống Thấm Nước , Nhanh Khô Tặng Kèm Nón Bơi và Bịt Tai Silicon Cao Cấp",119000,201000,82000,41
TIKI,thoi-trang-nam,17912482,"Áo khoác nam chống nắng gió thu đông Doka (DBLS102) chất liệu dù giữ ấm cao cấp màu đen , màu xanh đen , màu xanh rêu",139000,229000,90000,39
TIKI,thoi-trang-nam,118019766,"Đồ Lam Đi Chùa # Lãnh Tụ Nam #Đồ Bộ #Quần Áo Nam",186000,186000,0,0
TIKI,thoi-trang-nam,42899542,"Áo ba lỗ nam/ 3 lỗ nam cao cấp, sợi cotton mềm mịn siêu thoáng mát, thấm hút mồ hôi cực tốt, co dãn 4 chiều MRM FASHION",109000,125000,16000,13
TIKI,thoi-trang-nam,56993008,"Áo hoodie nam nữ form rộng Unisex một màu cá tính Hàn Quốc – FORMEN SHOP – FM14GV016 - KEM - L",139000,190000,51000,27
TIKI,thoi-trang-nam,22760941,"Combo 3 Áo thun nam cổ bẻ  ( Tặng 1 áo thun cổ tròn hàng hiệu ) vải cá sấu - EZ338",269000,398000,129000,32
TIKI,thoi-trang-nam,73219234,"Áo Khoác Nam Áo Khoác Kaki Nam Big Size Cổ Cao Hai Lớp Chống Nắng Chống Lạnh Hàn Quốc Cao Cấp AK35 - ShopN6 (Nhiều Màu)",169000,169000,0,0
TIKI,thoi-trang-nam,84826006,"Quần Lót Nam- Sịp Lụa Nam Trơn Không Đường May Mỏng Mát K176",69000,69000,0,0
TIKI,thoi-trang-nam,107411611,"Áo thun Nam Nữ Vonesa, áo phông Unisex Nam Nữ có Size từ 25-84kg B9",30000,30000,0,0
TIKI,thoi-trang-nam,163543524,"Bộ Thể Thao Nam Ngắn Tay Phối 3 Màu Cao Cấp Thiết Kế Thời Trang AVIANO",219000,430000,211000,49
TIKI,thoi-trang-nam,11345710,"Quần kaki nam sống suông thời trang VICERO",239000,350000,111000,32
TIKI,thoi-trang-nam,162817668,"Sơ Mi Nam Ngắn Tay Công Sở Trung Niên Thương Hiệu Anton Vải Sợi Tre Xanh Dương Họa Tiết In GD561",265000,325000,60000,18
TIKI,thoi-trang-nam,126209464,"Quần kaki dài nam chất vải cotton có giãn siêu đẹp LADOS - 4032 thiết kế tôn dáng trẻ trung",379000,379000,0,0
TIKI,thoi-trang-nam,117083556,"Áo khoác dù nam bomber 2 lớp thoáng mát thêu logo TM cá tính năng động,Áo khoác dù nam , áo khoác gió nam , áo bomber dù 2 lớp - Đen,XL",100000,100000,0,0
TIKI,thoi-trang-nam,14995599,"Combo 3 Chiếc Quần Lót Nam Boxer Cao Cấp Aristino ABX 16 15",325000,405000,80000,20
TIKI,thoi-trang-nam,99994626," QUẦN ÁO THỂ THAO NAM    BỘ HÈ CHO NAM NỮ IN CHỮ FULUA ĐỒ CẶP ĐÔI 2020",96000,96000,0,0
TIKI,thoi-trang-nam,163031972,"Áo Sơ Mi Nam Công Sở Trung Niên Thương Hiệu Anton Dài Tay Công Sở Vải Cotton Xanh Dương -A14",225000,280000,55000,20
TIKI,thoi-trang-nam,7925353,"Quần Lót Nam KENDO TOGO Classic",35000,70000,35000,50
TIKI,thoi-trang-nam,150568002,"Bộ Quần Áo Thể Thao Nam TSIMPLE tập gym vải thun lạnh thoáng mát co giãn tôn dáng chuẩn form MSSBHP2",215000,215000,0,0
TIKI,thoi-trang-nam,186133766,"Quần Short Kaki Nam US ARMY, Quần Túi Hộp Nam Phong Cách Lính Chất Liệu KaKi Cao Cấp, Kiểu Dáng Trẻ Trung Năng Động -HÀNG CHÍNH HÃNG",278000,598000,320000,54
TIKI,thoi-trang-nam,179216239,"Combo 3 quần lót boxer trơn, chất thun mềm mịn thấm hút mồ hôi tốt, co giãn tốt,  - FORMEN SHOP - FMQS018",99000,250000,151000,60
TIKI,thoi-trang-nam,22610869,"Combo 3 Áo Thun nam HÀNG HIỆU đa phong cách -  ĐB3QC16 (Chọn Màu)- Vải thun cotton có điểm đặc biệt, thân thiện với làn da, co giãn và khả năng thấm hút tốt",189000,300000,111000,37
TIKI,thoi-trang-nam,172129052,"Quần âu nam công sở TUTO5 quần tây đen dài đẹp ống rộng suông Slimfit kiểu dáng Hàn quốc cao cấp đen, xám tím QDT01",449000,449000,0,0
TIKI,thoi-trang-nam,172305521,"Áo thun polo nam thể thao LADOS - 9080 có cổ bẻ, vải thun lạnh, phông rộng",249000,249000,0,0
TIKI,thoi-trang-nam,162148842,"Áo sơ mi nam công sở trung niên dài tay trắng thương hiệu Anton- XA12",225000,325000,100000,31
TIKI,thoi-trang-nam,154292862,"Quần đùi short gió nam thể thao Họa Tiết Rằn Ri trẻ trung năng động, thoáng mát co giãn 4 chiều MRM Manlywear",129000,199000,70000,35
TIKI,thoi-trang-nam,100897235,"Bộ Quần Áo Nam Thể Thao Viền Tay Cao Cấp thời Trang ZERO",209000,300000,91000,30
TIKI,thoi-trang-nam,42424755,"Quần Jogger Nam Thể Thao - Quần Nỉ Nam Lót Lông Cao Cấp Chính Hãng",178000,215000,37000,17
TIKI,thoi-trang-nam,20464385,"Combo 3 quần lót nam brief iBasic PANM077 - Đen/Xám/Xanh",189000,297000,108000,36
TIKI,thoi-trang-nam,112086654,"Quần Túi Hộp Nam Lính Mỹ US ARMY U768 Cao Cấp, Chất Liệu Vải Kaki,Bền Màu, Ống Rộng Phong Cách, Thiết kế Túi Hộp- HÀNG CHÍNH HÃNG",483000,1000000,517000,52
TIKI,thoi-trang-nam,47207912,"Áo sơ mi nam tay ngắn vải Oxford cao cấp phù hợp công sở trắng ND014",219000,219000,0,0
TIKI,thoi-trang-nam,90979601,"Áo Khoác Dù Nam chống nước ( TẶNG QUẦN LÓT HÀNG HIỆU ) Dokafashion Cao Cấp 2 Lớp Vải Dù Ấm Áp Cản Gió Đi Nắng, Chống Nước EZDS23",147000,209000,62000,30
TIKI,thoi-trang-nam,181114097,"Quần jean nam co giãn cao cấp trơn Lados-4068 Form slimfit chuẩn, thoải mái, không xù lông, ra màu",519000,519000,0,0
TIKI,thoi-trang-nam,52344373,"Áo Sơ Mi Nam Dài Tay Kẻ Caro Phong Cách Unisex Thời Trang PONIVA Mẫu Mới Hot Trend",157000,157000,0,0
TIKI,thoi-trang-nam,74531596,"Quần khaki nam 1 ply ống đứng màu da bò Khatoco Q2M468R1-VNMA016-1908-1",161000,468000,307000,66
TIKI,thoi-trang-nam,34911128,"Hộp 4 chiếc quần sịp đùi nam thông hơi CAO CẤP kèm hộp",103992,103992,0,0
TIKI,thoi-trang-nam,83616147,"Quần ngủ nam có miếng lót nâng đỡ - vải lỗ thoáng mát - quần lót 2in1 cao cấp - quan ngu nam co lot trong",88900,88900,0,0
TIKI,thoi-trang-nam,14064627,"Combo 2 Áo phông ba lỗ thoát nhiệt Nhật Bản , áo lót nam hàng hiệu cao cấp xuất khẩu",238000,238000,0,0
TIKI,thoi-trang-nam,87941257,"Quần Bò Nam cao cấp thương hiệu Chandi, chất jean co dãn mẫu mới nhất mã NT301",169000,299000,130000,43
TIKI,thoi-trang-nam,91009116,"Quần Kaki Ống Suông Unisex Nam Nữ  Kiểu quần Baggy nam nữ mềm co dãn",76000,76000,0,0
TIKI,thoi-trang-nam,110309352,"ÁO LÓT TAY NGẮN COTTON CATRIO LÀ ÁO THUN, ÁO PHÔNG, ÁO NGẮN TAY CỦA NAM TỪ 50KG ĐẾN 83KG thuộc đồ mặc đi ngủ, mặc ở nhà, mặc lót bên trong áo sơ mi, vải 100% cotton an toàn",65000,65000,0,0
TIKI,thoi-trang-nam,164756938,"Áo thun nam Polo có cổ ngắn tay Atuner ATN01 (4 Màu) trẻ trung, năng động, áo phông nam cao cấp chất liệu mềm mịn, siêu thấm hút mồ hôi, thoáng mát – Hàng chính hãng",145000,229000,84000,37
TIKI,thoi-trang-nam,174029817,"ÁO SƠ MI KAKI NAM NỮ",259000,259000,0,0
TIKI,thoi-trang-nam,81141012,"Quần Jean Nam cao cấp chất bò siêu co dãnThương Hiệu Chandi, form đứng dáng đẹp mẫu mới siêu hot MR9031",159000,169000,10000,6
TIKI,thoi-trang-nam,78924987,"Quần Jean Nam đẹp dẫn đầu xu hướng Thương Hiệu Chandi , mẫu mới form đẹp tôn dáng không quá ôm mẫu MR9007",169000,250000,81000,32
TIKI,thoi-trang-nam,97809476,"áo khoác dù chữ Seven zia, áo khoác dù chữ S, áo khoác bomber chữ S tay phối, Áo khoác dù nam nữ mặc / áo khoác gió nam nữ mặc / áo khoác dù kiểu bomber / áo khoác cặp đôi / áo khoác form rộng unisex ullzang",99000,99000,0,0
TIKI,thoi-trang-nam,82940840,"Hộp 3 quần lót 5D nam cao cấp 3A-Quần lót nam boxer kháng khuẩn cao cấp",79000,79000,0,0
TIKI,thoi-trang-nam,43333515,"Combo 2 Áo Thun 3 Lỗ Nam Body, Sợi Cotton Mềm Mịn Siêu Thoáng Mát, Thấm Hút Mồ Hôi Cực Tốt, Co Giãn 4 Chiều MRM FASHION Cùng Màu",189000,250000,61000,24
TIKI,thoi-trang-nam,114144333,"Quần đùi MAY 10 loại mở moi, có cúc cài thuận tiện (giao màu ngẫu nhiên)",45000,45000,0,0
TIKI,thoi-trang-nam,110477285,"Quần tây nam Novelty 0Ply 1804530 màu xám nhạt",259000,449000,190000,42
TIKI,thoi-trang-nam,103546447,"Quần baggy nam nữ kaki unisex, quần baggy kaki nam nữ",79000,79000,0,0
TIKI,thoi-trang-nam,67516317,"Áo Khoác Kaki Nam Áo Khoác Nam Hai Lớp FS Chống Nắng Chống Lạnh Cao Cấp KK46 - ShopN6 (Nhiều Màu)",189000,240000,51000,21
TIKI,thoi-trang-nam,125777295,"Bộ bơi nam 408(30_100kg)",209000,209000,0,0
TIKI,thoi-trang-nam,193993947,"Quần Jean nam Leman màu đen rách gối JD20 - Slim Form",549000,549000,0,0
TIKI,thoi-trang-nam,73214429,"Áo Khoác Nam Áo Khoác Dù Nam Nữ Hai Lớp Chống Nước Chống Nắng Chống Gió Phối Nón Cao Cấp QD54 - ShopN6 (Nhiều Màu)",189000,189000,0,0
TIKI,thoi-trang-nam,134757633,"Áo Sơ Mi Form Rộng GIẤU NÚT Tay Dài Hàn Quốc Áo Unisex Nam Nữ Vải Lụa Mềm Mịn Thoáng Mát Ít Nhăn - SMD02",93000,210000,117000,56
TIKI,thoi-trang-nam,147570724,"Áo sơ mi trắng tay dài, đồng phục học sinh nam, chất vải KT Silk mềm mại, size từ 20-95kg",104000,161000,57000,35
TIKI,thoi-trang-nam,71153488,"Quần jean nam co dãn 4 chiều QJ050 Julido Store, phong cách thời trang hiện đại mẫu mới  TOP1",169000,199000,30000,15
TIKI,thoi-trang-nam,130167692,"Quần Kaki Baggy Nam Nữ KAKI Ống Suông Unisex - Kiểu quần kaki đen và kem",89000,89000,0,0
TIKI,thoi-trang-nam,194038540,"Áo Khoác Dù Nam Couple TX Thoáng Khí MOP 1022",649000,649000,0,0
TIKI,thoi-trang-nam,193993541,"Quần Jean nam Leman xanh đậm rách JD19 - Slim Form",549000,549000,0,0
TIKI,thoi-trang-nam,85087452,"Áo sơ mi nam ngắn tay vải chống nhăn",108000,108000,0,0
TIKI,thoi-trang-nam,73335809,"Áo Khoác Nam Big Size Áo Khoác Dù Nam Cổ Cao Chống Lạnh Chống Gió Chống Nắng Tia UV Cao Cấp Nam Tính Hàn Quốc QM19 - ShopN6 (Nhiều Màu)",169000,255000,86000,34
TIKI,thoi-trang-nam,81513561,"Quần Kaki Nam Chất Cao Cấp Siêu nhẹ Dáng Âu ZERO Phong Cách Công Sở",200000,370000,170000,46
TIKI,thoi-trang-nam,176663149,"Áo khoác dù cách nhiệt GOKING cho nam nữ, áo khoác gió hàng hiệu Việt Nam cao cấp, chống gió lạnh, giữ ấm cơ thể",222000,222000,0,0
TIKI,thoi-trang-nam,193987820,"Quần Jean nam Leman xanh mài xước trơn JD15 - Slim Form Tôn Dáng",549000,549000,0,0
TIKI,thoi-trang-nam,7170169,"Bộ 5 Quần Sịp Tam Giác Nam Nhật Bản (Nhiều mầu) - 5Star",100000,100000,0,0
TIKI,thoi-trang-nam,178107571,"Quần tây học sinh việt tiến cấp 2 - 3",166000,166000,0,0
TIKI,thoi-trang-nam,90483633,"Combo 5 Áo thun nam ngắn tay cổ tim cotton thoáng mát FREEMAN TSF315",495000,495000,0,0
TIKI,thoi-trang-nam,24038276,"Áo ba lỗ cổ vuông nam phong cách Hàn Quốc",50000,50000,0,0
TIKI,thoi-trang-nam,189472256,"Áo Thun Nam Nữ Cao Cấp , Chất Cotton Thoáng Mát, Dày Dặn, Thấm Hút Mồ Hôi, Co Giãn Tốt, Phom Chuẩn, Thiết Kế Tinh Tế, Trẻ Trung, Năng Động, Áo Thun Polo Cotton Tay Ngắn Cổ Bẻ Thời Trang Công Sở Cho Nam, Nữ",250000,250000,0,0
TIKI,thoi-trang-nam,84826648,"Quần Sịp Lưới Nam Mỏng Mát Sexy K165",69000,69000,0,0
TIKI,thoi-trang-nam,196596356,"Combo 3 Quần lót nam Freeman chất liệu cotton TC dành cho học sinh từ 30 đến 40kg BO303",147000,147000,0,0
TIKI,thoi-trang-nam,115981814,"Áo Khoác Dù Nam Nữ TMS Áo Khoác Gió Phối 2 Màu Couple Cực Đẹp Rẻ - Bomber Jacket (Video Ảnh Thật)",96000,96000,0,0
TIKI,thoi-trang-nam,94851482,"Quần Bò Nam cao cấp thương hiệu Chandi, chất jean co dãn mẫu mới MA86",169000,299000,130000,43
TIKI,thoi-trang-nam,163712959,"Áo Sơ Mi Nam Công Sở Trung Niên Thương Hiệu Anton Dài Tay Vải Cotton Xanh Đậm Trơn Có Túi - A13",225000,280000,55000,20
TIKI,thoi-trang-nam,114193983,"Quần dài thể thao nam Jogger 3 sọc ống bo trẻ trung năng động Micado",59000,110000,51000,46
TIKI,thoi-trang-nam,75355767,"Quần Jean Nam co dãn 4 chiều Julido, dáng Skinny ống côn mẫu mới 2023 WW002",169000,299000,130000,43
TIKI,thoi-trang-nam,102122394,"Combo 4 Quần lót boxer nam - Quần sịp đùi su đúc lụa sữa cao cấp không đường may Micado",149000,280000,131000,47
TIKI,thoi-trang-nam,167431552,"Quần Bò Nam cao cấp thương hiệu Chandi, chất jean co dãn mẫu mới nhất MS27",169000,300000,131000,44
TIKI,thoi-trang-nam,72641169,"Quần thể thao nam TinoFun mã TT57 thể dục jogger kiểu thun trơn bó ống đẹp dài co giãn mùa hè thu",96000,96000,0,0
TIKI,thoi-trang-nam,42645558,"Quần kaki ống xuông nam nữ",88000,88000,0,0
TIKI,thoi-trang-nam,73330264,"Áo Khoác Nam Big Size Áo Khoác Dù Dày Nam Trơn Hai Lớp Chống Lạnh Chống Nắng Chống Gió Cao Cấp QD34 - ShopN6 (Nhiều Màu)",159000,255000,96000,38
TIKI,thoi-trang-nam,178058234,"Áo thun nam có cổ trơn cao cấp LADOS-9084 vải poli siêu mát mẻ, thấm hút mồ hôi tốt, form đẹp",199000,199000,0,0
TIKI,thoi-trang-nam,78945617,"Quần Jean Nam cao cấp co dãn 4 chiều Thương Hiệu Chandi, phong cách hàn quốc trẻ trung cá tính MR9019",169000,299000,130000,43
TIKI,thoi-trang-nam,183718179,"Áo sơ Mi, Áo sơ Mi Nam cổ Vest, dài tay, mới lạ và sang trọng. Chất liệu Cotton cao cấp, nhẹ, mát mẻ, thấm mồ hôi, không nhăn, không nhàu,mã N34",199000,199000,0,0
TIKI,thoi-trang-nam,193988328,"Quần Jean nam Leman xanh trơn JD16 - Slim Form",549000,549000,0,0
TIKI,thoi-trang-nam,109545851,"Quần đùi nam xuất khẩu mặc nhà, quần đùi nam, quần short, quần sọc nam vải kate cotton 100% thương hiệu Fezzio",64500,129000,64500,50
TIKI,thoi-trang-nam,100897026,"Bộ Mặc Nhà Nam Mùa Hè Mát Mẻ Cao Cấp Thời Trang ZERO",209000,300000,91000,30
TIKI,thoi-trang-nam,133810672,"Áo Khoác Nam Trung Niên Chất Đẹp Không Nhăn Mẫu Mới",450000,450000,0,0
TIKI,thoi-trang-nam,121622214,"Áo khoác dù 2 mặt 2 lớp chống trượt nước Lados - 2015 form unisex trẻ trung đơn  dễ phối",399000,399000,0,0
TIKI,thoi-trang-nam,89264090,"Áo khoác bomber nam nữ kaki oversize Áo bomber form rộng Áo khoác bóng chày Candle unisex - Gin Store",98000,98000,0,0
TIKI,thoi-trang-nam,98642412,"Áo thun Teeworld Saigonese Cô Ba Form Rộng Nam Nữ Unisex",299000,299000,0,0
TIKI,thoi-trang-nam,163716292,"Bộ bơi nam khóa kéo size lớn, quần áo bơi bigsize cho nam giới, chất thun bơi lạnh Hàn dầy dặn, dáng thể thao mạnh mẽ | BN016",480000,480000,0,0
TIKI,thoi-trang-nam,111670297,"Quần Nam Kaki Basic Dáng Baggy Trơn Màu Phong Cách Trẻ Trung Thời Trang Zenkonu QUAN NAM 1000060V1",97000,97000,0,0
TIKI,thoi-trang-nam,51714411,"Áo khoác dù dày nam 2 lớp chống nắng gió lạnh cao cấp ShopN6 - KAD46 (Nhiều Màu)",159000,249000,90000,36
TIKI,thoi-trang-nam,168224742,"[COMBO 3 QUẦN] Quần Lót Nam Boxer Thun Lạnh Lados 4116 - Thun lụa co giãn, dai, thoáng mát, thấm hút mồ hôi tốt",180000,180000,0,0
TIKI,thoi-trang-nam,176789430,"Áo bơi nam dài tay 402",144000,144000,0,0
TIKI,thoi-trang-nam,110139205,"Áo Gile Nam Lính Mỹ U869 Phong Cách US ARMY - HÀNG CHÍNH HÃNG",343000,369000,26000,7
TIKI,thoi-trang-nam,102473213,"Quần Sọt Nam, Quần Short Tây Âu Nam Co Giãn Nhẹ Dáng Ôm, Quần Ngố Nam Công Sở Lịch Sự Phù Hợp Dạo Phố Du Lịch Thương Hiệu Chandi Mã TA11",139000,220000,81000,37
TIKI,thoi-trang-nam,191926050,"Quần đùi nam thể thao vải gió siêu nhẹ, quần short nam vải gió cao cấp QD01 - PROMAN",49000,49000,0,0
TIKI,thoi-trang-nam,75984007,"Quần baggy nam Amazing, chất liệu kaki, lưng thun có giây rút, form ôm Unisex, tôn dáng đẹp, trẻ trung-02",253000,385000,132000,34
TIKI,thoi-trang-nam,184910578,"Viettien - Quần kaki nam màu be không ly 6R6008 regular",785000,785000,0,0
TIKI,thoi-trang-nam,45818196,"Quần Short Đùi Nam Boxer Tập Gym Mặc Ngủ Super Body New Colour",99000,99000,0,0
TIKI,thoi-trang-nam,184981886,"Combo 3 Quần Lót Nam RLTK037 - quần sịp nam thoáng mát mềm mại cao cấp, co giãn tốt, ôm gọn - RELAX",225000,225000,0,0
TIKI,thoi-trang-nam,4426117,"Quần Dài Jogger Nam Phối Sọc 1041_xanh",95000,95000,0,0
TIKI,thoi-trang-nam,73161713,"áo hoodie nam nữ",100000,100000,0,0
TIKI,thoi-trang-nam,94659387,"Quần Lót Nam- Sịp Cotton Cạp To Mềm Mại Thoáng Khí K465",55000,55000,0,0
TIKI,thoi-trang-nam,82646137,"Áo Sơ Mi Nam Ngắn Tay Phối Caro",163000,163000,0,0
TIKI,thoi-trang-nam,160417810,"quần lót nam relax cotton siêu xin cao cấp chính hãng, quần sịp nam relax underwear rltk48 - M",92000,92000,0,0
TIKI,thoi-trang-nam,197170229,"Áo khoác nam unisex cổ đứng vải dù 2 lớp phối màu độc lạ họa tiết chữ HEBFN đi mưa,cản gió,chống nắng, Áo khoác dù nam nữ màu 3 sọc chất liệu dù gió 2 lớp cao cấp dáng from bóng chày bomber đẹp",95000,95000,0,0
TIKI,thoi-trang-nam,192564455,"Quần lót nam tam giác thun cotton iBasic PANM045",67000,79000,12000,15
TIKI,thoi-trang-nam,117583109,"ÁO KHOÁC DÙ DÀY NAM PHONG CÁCH HÀN QUỐC",169000,169000,0,0
TIKI,thoi-trang-nam,90961454,"Combo 3 Quần Lót Nam Cotton Mềm Mịn Siêu Thoáng Mát, Co Giãn 4 Chiều Cao Cấp Dokafashion EZQLH03",55000,109000,54000,50
TIKI,thoi-trang-nam,55163582,"Quần Bơi Nam Họa Tiết Cá Tính AT171 MayHomes Thun Lạnh Co Giãn Tốt, Mạnh Mẽ Cá Tính",107000,129000,22000,17
TIKI,thoi-trang-nam,138750990,"Áo Phông Nam cổ tim Chất cotton mềm Mịn Dáng Ôm Nhẹ Thời Trang",89000,99000,10000,10
TIKI,thoi-trang-nam,4382605,"Quần Dài Jogger Nam Phối Sọc 1041",95000,95000,0,0
TIKI,thoi-trang-nam,196313090,"Áo khoác dù chống nắng nam, túi khóa kéo, nón có thể tách rời tiện lợi - FORMENSHOP - FMTHT050",159000,300000,141000,47
TIKI,thoi-trang-nam,75716217,"Áo Sơ Mi Nam Titishop SM1275",69000,69000,0,0
TIKI,thoi-trang-nam,183682463,"ÁO LÓT NGẮN TAY CATRIO là áo phông trắng, áo thun ngắn tay cho bố, ông, người trung tuổi, vải 100̀% cotton mặc lót bên trong áo sơ mi, mặc ở nhà, đi ngủ",65000,65000,0,0
TIKI,thoi-trang-nam,188916571,"Tất nam cổ trung Fasvin mềm mịn co giãn tốt TN21902.HN",19000,36000,17000,47
TIKI,thoi-trang-nam,171451574,"Quần Sọt Nam, Quần Short Tây Âu Nam Co Giãn Nhẹ Dáng Ôm, Quần Ngố Nam Lịch Sự Phù Hợp Dạo Phố Du Lịch Thương Hiệu Chandi Mã TA19",129000,139000,10000,7
TIKI,thoi-trang-nam,57758774,"Quần short nam có Big Size 115kg lưng thun co giãn 4 chiều ,quần đùi nam thể thao cao cấp ShopN6 - QSB1 (sọc ngẫu nhiên)",59000,105000,46000,44
TIKI,thoi-trang-nam,179163530,"(big size<130kg) Áo sơ mi nam tay dài big size màu đen",185000,185000,0,0
TIKI,thoi-trang-nam,7189521,"Bộ 2 Quần Boxer Đúc Nam Nhật Bản - 5Star",85000,85000,0,0
TIKI,thoi-trang-nam,66845263,"Quần jean nam chất jean xịn Julido, Phối xước mẫu mới form đẹp tôn dáng không quá ôm mẫu QJ113",169000,299000,130000,43
TIKI,thoi-trang-nam,163552063,"Áo Thun Nam PoLo Ngắn Tay Có Cổ Kiểu Dáng Thời Trang Cao Cấp AVIANO",129000,258000,129000,50
TIKI,thoi-trang-nam,89631305,"ÁO SƠ MI CARO ĐỦ MÀU NAM NỮ",92000,92000,0,0
TIKI,thoi-trang-nam,71114262,"Áo sơ mi nam TUTO5 Slim fit Oxford công sở trơn tay dài đẹp kiểu dáng Hàn quốc trẻ trung cotton chống nhăn cao cấp SMT01",199000,199000,0,0
TIKI,thoi-trang-nam,178577763,"Áo khoác bóng chày form rộng vải dù cao cấp ️Áo Khoác Dù 2 Lớp PENTA.Q Ulzzang Nam Nữ Unisex Form Rộng Bomber Jacket",100000,100000,0,0
TIKI,thoi-trang-nam,15992824,"Áo Khoác Nam Áo Khoác Dù Nam Cao Cấp-AD27",159000,270000,111000,41
TIKI,thoi-trang-nam,125784347,"Quần bơi lững nam 881(30-100kg)",60000,60000,0,0
TIKI,thoi-trang-nam,179161990,"(big size < 130kg) sơ mi nam tay dài màu xanh đen big size",185000,185000,0,0
TIKI,thoi-trang-nam,109956995,"QUẦN KAKI NAM MÀU ĐEN TÚI MỸ VIỀN",150000,150000,0,0
TIKI,thoi-trang-nam,68630251,"Quần bơi nam Lan Hạnh 50123-DE0103",238000,238000,0,0
TIKI,thoi-trang-nam,164011222,"Áo Sơ Mi Nam Công Sở Trung Niên Dài Tay Thương Hiệu Anton màu Nâu Đậm Vải Cotton - YAC128",213000,215000,2000,1
TIKI,thoi-trang-nam,62327643,"Quần jean nam co dãn Julido, chất bò form đứng Skiny không quá ôm dáng đẹp mẫu LKL01",169000,299000,130000,43
TIKI,thoi-trang-nam,178785868,"Áo phông nam phong cách Hàn Quốc mã TX20",259000,259000,0,0
TIKI,thoi-trang-nam,141109930,"Quần jogger unisex thể thao, quần ống rộng kiểu dáng jogger mặc nhà nam nữ vải TỔ ONG 3 màu năng động",83000,83000,0,0
TIKI,thoi-trang-nam,67734872,"Áo sơ mi nam trắng trơn Julido, chất lụa không bai nhão không xù lông tôn dáng ôm form mẫu TOP",119000,199000,80000,40
TIKI,thoi-trang-nam,174301048,"Quần Kaki Nam Ống Suông Cao Cấp Chất Liệu Co Dãn Dáng Âu Phong Cách Công Sở Thương Hiệu CHANDI JK1",169000,229000,60000,26
TIKI,thoi-trang-nam,106714415,"Combo 3 quần đùi nam May 10 loại có túi 2 bên",195000,195000,0,0
TIKI,thoi-trang-nam,3714997,"Combo 5 Quần Lót Boxer Nam Freeman 6516-CB5-L (Size",425000,425000,0,0
TIKI,thoi-trang-nam,113233457,"Quần đùi nam xuất khẩu, quần đùi mặc nhà chất kate cotton cao cấp  thương hiệu Fezzio",42500,85000,42500,50
TIKI,thoi-trang-nam,110948866,"Quần đùi nam chất kate cotton thương hiệu Fezzio chính hãng",64500,129000,64500,50
TIKI,thoi-trang-nam,62325784,"Quần short nam trắng trơn chất bò co dãn Julido, dáng đứng form đẹp mẫu mới KK04",139000,220000,81000,37
TIKI,thoi-trang-nam,66683004,"Áo Khoác Nam Vải Kaki 2 Lớp Mặc Bốn Mùa Kiểu Dáng Thời Trang",464000,499000,35000,7
TIKI,thoi-trang-nam,107338883,"Áo thun Nam Nữ Vonesa, áo phông Unisex Nam Nữ có Size từ 25-84kg B7",40000,40000,0,0
TIKI,thoi-trang-nam,53537690,"Quần jeans nam co dãn , quần bò nam kiểu trơn dáng vừa không bó sát thiết kế trẻ trung đơn điệu phá cách gồm 5 kích thước (28-32) Julido mẫu QJNM01 - Màu xanh đen",169000,279000,110000,39
TIKI,thoi-trang-nam,181113990,"Áo polo nam có cổ cao cấp LADOS-9089 thêu đầu hươu, phối 2 màu trắng đen sang trọng, thoáng khí siêu mát mẻ",318000,318000,0,0
TIKI,thoi-trang-nam,75945178,"áo hoodie hoạt hình, áo hoodie cute, áo hoodie han quốc, áo hoodie cá tính, áo hoodie nam nữ, áo hoodie nữ, áo hoodie nam, áo hoodie ulzzang, áo hoodie unisex",100000,100000,0,0
TIKI,thoi-trang-nam,83489010,"Áo Khoác Nam, Khoác Dù Nam 2 lớp phối nón thời trang hàn quốc trẻ trung cuốn hút Thương Hiệu Chandi chất liệu thấm hút mồ hôi dày dặn mặc thoáng mát mẫu M123",299000,299000,0,0
TIKI,thoi-trang-nam,176789536,"Áo bơi tay ngắn nam 401",119000,119000,0,0
TIKI,thoi-trang-nam,74554228,"Áo Khoác Big Size Áo Khoác Dù Dày Bomber Nam Nữ Chống Nắng Chống Lạnh Chống Gió Lót Nỉ Hai Lớp Hàn Quốc Cao Cấp QD66 - ShopN6",143000,235000,92000,39
TIKI,thoi-trang-nam,31594559,"Áo khoác da cá GOKING 6 túi, form unisex cho nam nữ, trẻ em. Áo chống lạnh, giữ ấm, chống nắng. Hàng hiệu cao cấp vnxk",295000,295000,0,0
TIKI,thoi-trang-nam,196603717,"Quần tây nam 0Ply Novelty màu đen Regular fit NQTMMDNTRR2202880",399000,479000,80000,17
TIKI,thoi-trang-nam,20735027,"Áo khoác gió cách nhiệt GOKING có mũ, form unisex cho nam nữ. Ngoài vải dù, trong lót vải cào cách nhiệt. 3 túi to rộng. Chống nắng gió lạnh",255000,255000,0,0
TIKI,thoi-trang-nam,98986504,"Áo thun Teeworld Sài Gòn - Everything you need to know Form Rộng Unisex Nam Nữ",299000,299000,0,0
TIKI,thoi-trang-nam,72747384,"Áo khoác dù nam form rộng",127900,127900,0,0
TIKI,thoi-trang-nam,174024710,"Quần Short Jean nam Leman xanh trơn JL07 - Slim straight Form",459000,459000,0,0
TIKI,thoi-trang-nam,90078837,"Đồ bộ nam ba lỗ GINE EBMIN chất vải cao cấp, Bộ Áo Thun Cotton Sát Nách Dáng Rộng Phong Cách Hip-hop Cho Nam, Set Đồ Bộ Thể Thao Unisex Nam Nữ Vải Thun Lạnh, ĐỒ BỘ NAM ÁO THUN BA LỖ QUẦN ĐÙI, NGUYÊN BỘ ĐỦ SẮC MÀU, CHẤT THUN LẠNH MÁT, BỘ QUẦN ÁO THỂ THAO 3",99000,99000,0,0
TIKI,thoi-trang-nam,195192891,"Quần Gió Nam Thể Thao FASVIN Vải Gió Đẹp Hàng Nhà Máy Chất Lượng Cao Dùng Khi Thể Thao Hay Mặc Nhà DC20423.HN",179000,298000,119000,40
TIKI,thoi-trang-nam,160407346,"Viettien - Quần dài kaki nam màu xám sáng có 1ly regular 6Q6051",630000,630000,0,0
TIKI,thoi-trang-nam,174001966,"Quần Jean nam Leman xanh trơn JD03 - Slim Form",549000,549000,0,0
TIKI,thoi-trang-nam,163896997,"Áo Sơ Mi Nam Trắng Trơn Dài Tay Công Sở Trung Niên Thương Hiệu Anton Vải Nano Chống Nhăn - SRD05",295000,355000,60000,17
TIKI,thoi-trang-nam,13677604,"Áo khoác nam không bo lai Phúc An 2026",195000,195000,0,0
TIKI,thoi-trang-nam,74385119,"Áo Khoác Nam Big Size Áo Khoác Dù Nam Hai Lớp Cổ Cao Chống Nắng Chống Lạnh Chống Gió Chống Tia UV Hàn Quốc Cao Cấp QD62 - ShopN6 (Nhiều Màu)",135000,240000,105000,44
TIKI,thoi-trang-nam,193976862,"Quần Jean nam Leman xanh mài rêu JD12 - Slim Form",549000,549000,0,0
TIKI,thoi-trang-nam,196207027,"Áo thun Teeworld Sài Gòn Retro Nam Nữ Trắng Đen Form Rộng Unisex",359000,359000,0,0
TIKI,thoi-trang-nam,193322207,"Quần lót nam cotton Mỹ kháng khuẩn khử mùi thoáng khí dáng trungk ONOFF -18UO23A018",89000,89000,0,0
TIKI,thoi-trang-nam,138748071,"Áo phông nam tay dài mặc thu đông, giữ nhiệt, chất cotton co giãn, áo dài tay dáng ôm cao cấp",99000,99000,0,0
TIKI,thoi-trang-nam,101656788,"Áo Măng Tô Kaki Nam Dáng Dài Áo Khoác Nam Kaki Dáng Dài Sans20 Sans Shop",1090000,1090000,0,0
TIKI,thoi-trang-nam,190154616,"Quần kaki dài nam việt tiến màu xám sáng có 1ly và không ly 6R6013 - 6R6012 Regular",785000,785000,0,0
TIKI,thoi-trang-nam,59556296,"Combo 3 Chiếc Quần Lót Nam Cao Cấp Aristino ABF01807 Chất liệu Cotton Chitosan Thuần Khiết (Giao Màu Ngẫu Nhiên) - Hàng Chính Hãng",255000,315000,60000,19
TIKI,thoi-trang-nam,84872072,"Set đồ bơi nam full 5 chi tiết kèm túi đựng, Quần bơi da cá + Kính bơi + Mũ + Bịt tai + Kẹp mũi, hàng xịn đẹp chuẩn | BN009",320000,320000,0,0
TIKI,thoi-trang-nam,100868615,"Áo sơ mi FLANNEL kẻ caro Unisex phong cách streetswear, Kẻ Caro Nam Nữ Form rộng Phong Cách, Áo Sơ Mi Khoác Ngoài Cao Cấp Siêu Đẹp, Áo khoác sowmi unisex form rộng CARO nam nữ phong cách ulzzang",95000,95000,0,0
TIKI,thoi-trang-nam,130029611,"Áo Hoodie Nỉ Nam Nữ From Rộng Unisex In Dạ Quang Phát Sáng Hình Gấu Cực Hot Chất Nỉ Ngoại Dày Dặn (bear)",109000,109000,0,0
TIKI,thoi-trang-nam,34148045,"Combo 3 quần lót nam tam giác Bamboo organic mềm mịn thoáng mát MRM Manlywear - Màu Ngẫu Nhiên",179000,240000,61000,25
TIKI,thoi-trang-nam,31202048,"Quần tây nam không ply ống đứng Khatoco Q1M528R0-CNMA032-2105-0",351000,528000,177000,34
TIKI,thoi-trang-nam,183734155,"Quần kaki dài nam việt tiến màu xám có 1ly 6R6025 Regular",665000,665000,0,0
TIKI,thoi-trang-nam,52198192,"Combo 3 Quần Lót Nam Quần Sịp Nam Sợi Cotton Cao Cấp MRM FASHION 1 Màu TẶNG Đôi Tất Nam Cao Cấp",189000,255000,66000,26
TIKI,thoi-trang-nam,118900403,"Áo sơ mi nam tay dài ADINO màu xanh than vải sợi sồi modal dáng slimfit trẻ trung S305",279000,350000,71000,20
TIKI,thoi-trang-nam,197675716,"Áo sơ mi nam dài tay màu đen dáng suông May 10 mã 010122912L2",295000,295000,0,0
TIKI,thoi-trang-nam,105735946,"Quần Kaki Nam Kiểu Dáng Hàn Quốc Ống Côn Phong Cách Thể Thao Kết Hợp giày Sneaker cực đẹp",85000,85000,0,0
TIKI,thoi-trang-nam,138381315,"Áo thun dài tay nam giữ nhiệt co giãn mặc lót chơi thể thao, đá bóng Micado",39000,60000,21000,35
TIKI,thoi-trang-nam,15137091,"Áo Khoác Dù Nam  2 Lớp Chống Tia Cực Tím Khói Bụi Cao Cấp SM19",149000,265000,116000,44
TIKI,thoi-trang-nam,87094676,"Bộ bơi đôi dài tay Nam và Nữ, set 3 chi tiết quần dài chống nắng, đồ bơi cho couple, có size nhỏ cho bé mặc đồ gia đình | KT022 | BN022",520000,520000,0,0
TIKI,thoi-trang-nam,6927817,"Quần thun dài jogger nam Phúc An 1011 màu xám",82800,82800,0,0
TIKI,thoi-trang-nam,181566777,"Áo sơ mi nam sọc tay ngắn dáng ôm body chuẩn form nhiều màu sắc - MON01",111000,250000,139000,56
TIKI,thoi-trang-nam,35593659,"Combo 5 Quần Lót Nam Boxer Thời Trang Aristino ABX 16 03",469000,625000,156000,25
TIKI,thoi-trang-nam,71171098,"Áo thun nam cổ bẻ vải cá sấu thời trang SITAKI cao cấp ATN09",125000,125000,0,0
TIKI,thoi-trang-nam,85086748,"Áo sơ mi nam cổ trụ dài tay",159000,159000,0,0
TIKI,thoi-trang-nam,101861199,"Quần Baggy Nam Nữ Kaki Ống Suông Unisex",85000,85000,0,0
TIKI,thoi-trang-nam,78503787,"Quần Short Jean Nam co dãn kiểu dáng trẻ trung đơn giản thêu họa tiết Thương Hiệu Chandi, quần sọt mẫu hot nhất HD219",150000,299000,149000,50
TIKI,thoi-trang-nam,68938308,"Áo  Sơ Mi Nam Vải Lụa Thái Không Nhăn Dài Tay Nhiều Màu",157000,157000,0,0
TIKI,thoi-trang-nam,186358872,"Áo Sơ Mi nam tay dài sọc nhỏ NSMMSNMTCC212798D",329000,329000,0,0
TIKI,thoi-trang-nam,174037915,"Áo thun cotton in họa tiết LADOS - 9076, vải cotton mát, có thể mặc nhóm, mặc cặp",339000,339000,0,0
TIKI,thoi-trang-nam,57979142,"Quần Thun Nam Dài Vải Thun Nỉ",75000,75000,0,0
TIKI,thoi-trang-nam,82643340,"Quần Sọt Kaki Nam Túi Hộp Phối Họa Tiết Lính",188000,188000,0,0
TIKI,thoi-trang-nam,7823134,"Bộ 3 Quần Boxer Đúc Nam Nhật Bản (Nhiều màu) - 5Star",120000,120000,0,0
TIKI,thoi-trang-nam,151843234,"áo Hoodie nỉ WZSOFF màu đen xám unisex ảnh thật SSSTore ( nam nữ mặc đều được )",120000,120000,0,0
TIKI,thoi-trang-nam,75721837,"Áo Sơ Mi Nam Titishop SM1314",69000,69000,0,0
TIKI,thoi-trang-nam,30768234,"Áo sơ mi nam cổ trụ chui đầu dài tay kẻ sọc trắng đen",159000,159000,0,0
TIKI,thoi-trang-nam,124863665,"OWEN - Áo sơ mi trắng dài tay Owen chất sồi siêu mềm mịn (Regularfit / Slimfit)",420000,420000,0,0
TIKI,thoi-trang-nam,156199686,"Combo 4 quần lót nam Briefs Mr Mitas Basics viền êm ái",159000,299000,140000,47
TIKI,thoi-trang-nam,54762609,"Quần kaki nam 1 ply Khatoco Q2M528R1-INMA003-2106-1",189000,528000,339000,64
TIKI,thoi-trang-nam,186293187,"Áo Sơ Mi nam tay dài caro nhỏ NSMMCNMTCC210246D",199000,319000,120000,38
TIKI,thoi-trang-nam,192413381,"Quần short đùi nam cao cấp TC với thiết kế logo thêu bền đẹp, chất cotton co dãn tốt, năng động, thể thao,thời trang-362",450000,450000,0,0
TIKI,thoi-trang-nam,10776493,"Áo thun trơn basic, form unisex cho nam nữ. Áo phông hàng hiệu Goking, quà tặng cao cấp cho gia đình, cặp đôi, lớp nhóm, doanh nghiệp, người nước ngoài",138000,138000,0,0
TIKI,thoi-trang-nam,140579763,"QUẦN KAKI NAM NỮ CHẤT VẢI DÀY",229000,229000,0,0
TIKI,thoi-trang-nam,114056064,"Quần jogger 2 da cao cấp in hoạ tiết unisex nam nữ có dây rút ống thời trang Hàn",99000,99000,0,0
TIKI,thoi-trang-nam,189467654,"Quần Jeans nam dáng regular fit 6Q7092 - thương hiệu Viettien",645000,645000,0,0
TIKI,thoi-trang-nam,98023604,"ĐỒ BỘ NAM MẶC Ở NHÀ, ĐI CHƠI ÁO BA LỖ IN CHỮ OFF CHẤT THUN LẠNH, QUẦN KAKI TÚI KHÓA, LÊN FORM CỰC ĐẸP, ĐỒ BỘ MẠC NHÀ SÁT NÁCH CHỮ OFF, BỘ ĐỒ THỂ THAO SÁT NÁCH, BỘ ĐỒ ĐÔI NAM NỮ,  BỘ ĐỒ NAM NỮ",115000,115000,0,0
TIKI,thoi-trang-nam,192367917,"Quần short đùi nam cao cấp TC với thiết kế họa tiết logo thêu, kết hợp phần sọc bên hông quần tạo điểm nhấn, chất cotton mát, co dãn, phong cách trẻ trung, năng động, thể thao-364",450000,450000,0,0
TIKI,thoi-trang-nam,181785318,"Áo bay dài tay màu cỏ úa - vàng cốm, áo lao động, áo tập QS loại đẹp",130000,130000,0,0
TIKI,thoi-trang-nam,177750772,"Bộ bơi nam 3 chi tiết quần áo dài tay chống nắng cao cấp",460000,460000,0,0
TIKI,thoi-trang-nam,34158949,"Áo Sơ Mi Nam Sọc Trắng",99000,99000,0,0
TIKI,thoi-trang-nam,137912762,"Áo Sơ Mi Nam Dài Tay Caro MR265 Thời Trang PONIVA Thiết Kế Nam Tính Lịch Lãm Hàng Chất Lượng XNK",169000,169000,0,0
TIKI,thoi-trang-nam,76558432,"Quần Short khaki nam Novelty 0Ply 1813830",295000,295000,0,0
TIKI,thoi-trang-nam,85086742,"Áo sơ mi nam cổ trụ dài tay sọc đẹp",159000,159000,0,0
TIKI,thoi-trang-nam,129297930,"quần short đũi nam trung niên ống suông đũng dài chất đẹp không nhăn không nhàu",199000,199000,0,0
TIKI,thoi-trang-nam,186290944,"Áo Sơ Mi nam sọc caro tím trắng dài tay NSMMCLMTCR212807D",299000,329000,30000,9
TIKI,thoi-trang-nam,48427720,"Quần Lót Nam Boxer Body Thể Thao Cam Đen 5969",69000,69000,0,0
TIKI,thoi-trang-nam,170726691,"Viettien - Áo sơ mi nam ngắn tay vạt bầu chấm bi 1Q1180 regular",490000,490000,0,0
TIKI,thoi-trang-nam,50614559,"Combo 4 Sịp Đúc Nam Lụa Sữa Cao Cấp Vải Siêu Mát thiết kế U Lồi phía trước mặc Thoải Mái Dễ Chịu - Nhiều Size Nhiều Màu để lưa chọn",319000,319000,0,0
TIKI,thoi-trang-nam,114285672,"Hộp 5 cái quần lót tam giác thông hơi nam - Sịp lưới nam thoáng mát",86600,86600,0,0
TIKI,thoi-trang-nam,105275706,"Áo Thun Nam Polo Có Cổ Tay Ngắn Trơn Cao Cấp ZERO 5 Màu Hàn Quốc",189000,300000,111000,37
TIKI,thoi-trang-nam,186190450,"Áo thun Polo melange dệt chìm xương cá không túi xanh coban NATMMTMCSR210108N",299000,379000,80000,21
TIKI,thoi-trang-nam,54446837,"Quần dài nam thể thao GOKING, lưng thun và dây rút co giãn thoải mái. Hàng hiệu cao cấp xuất khẩu",225000,225000,0,0
TIKI,thoi-trang-nam,67294572,"Áo Sơ Mi Nam Dài Tay Vải Lụa Chống Nhăn",109000,109000,0,0
TIKI,thoi-trang-nam,97823540,"Áo Khoác Big Size Áo Khoác Dù Nam Có Cổ Trụ Chống Nắng Chống Nóng Chống Lạnh Chống Gió 2 Lớp Phối Logo Sọt Thời Trang Nam Tính Hàn Quốc Giá Tốt AD70",169000,169000,0,0
TIKI,thoi-trang-nam,67723876,"Quần jean nam chất jean xịn Julido, Phối rách mẫu mới form đẹp tôn dáng không quá ôm mẫu Top09",169000,279000,110000,39
TIKI,thoi-trang-nam,30031323,"Quần Tây Nam Không Ply Ống Ôm xám đậm Khatoco Q1M528S0-CNMA006-2007-0",189000,528000,339000,64
TIKI,thoi-trang-nam,169120359,"Combo 5 quần sịp nam, kiểu dáng ôm mông chất thun cotton thấm hút co giãn tốt - FORMEN SHOP - FM5QS005",134000,245000,111000,45
TIKI,thoi-trang-nam,138748093,"Áo thun nam cổ tim ngắn tay đẹp nhiều màu đủ size ( có size lớn cho người 100 kg )",79000,79000,0,0
TIKI,thoi-trang-nam,74279633,"Quần jean nam đen trơn Julido Store, chất jean co dãn 4 chiều tôn dáng nam tính BC20",169000,279000,110000,39
TIKI,thoi-trang-nam,68918584," Áo thun phối tay Cali",79000,125000,46000,37
TIKI,thoi-trang-nam,138748934,"Áo thun nam tay dài mặc thu đông, giữ nhiệt, chất cotton co giãn, áo dài tay dáng ôm cao cấp",85000,85000,0,0
TIKI,thoi-trang-nam,62755202,"Quần jean nam cao cấp chất bò siêu co dãn Julido, form đứng dáng đẹp mẫu MM07",169000,279000,110000,39
TIKI,thoi-trang-nam,176599682,"Quần kaki Nam Cao Cấp, Quần jogger kaki nam Chuẩn Hàng Xuất - QJKN01",97000,97000,0,0
TIKI,thoi-trang-nam,111477677,"Áo Sơ Mi Nam Ngắn Tay Kiểu Dáng Cơ Trưởng U886 Thời Trang Hàn Quốc Chất Cotton Pha Lụa Mềm Mại, Thoáng Mát, Chống Nhăn, Trẻ Trung, Năng Động- HÀNG CHÍNH HÃNG",213000,458000,245000,53
TIKI,thoi-trang-nam,151922857,"Áo khoác Cardigan Unisex Nam Nữ Thêu gấu - Chất Nỉ Bông Ngoại Mềm Mịn Bomber Cardigan, áo cardigan phối viền, áo cardigan phối 2 túi đẹp, áo khoác cardigan chống nắng, mặc ấm màu thu đông dễ phối đồ",95000,95000,0,0
TIKI,thoi-trang-nam,128276418,"Quần jogger kaki nam nữ chất đẹp, co giãn",90000,90000,0,0
TIKI,thoi-trang-nam,35193606,"[FREEMAN] Combo 5 quần lót nam 6034",195000,195000,0,0
TIKI,thoi-trang-nam,85086740,"Áo sơ mi nam màu trắng ngắn tay vải chống nhăn",108000,108000,0,0
TIKI,thoi-trang-nam,132097555,"Áo Đồng Phục Đầu Bếp Màu Đen Tay Ngắn",97000,97000,0,0
TIKI,thoi-trang-nam,81159816,"Quần Jean Nam cao cấp chất bò siêu co dãnThương Hiệu Chandi, form đứng dáng đẹp mẫu mới siêu hot MR9034",299000,299000,0,0
TIKI,thoi-trang-nam,61393910,"Siêu giảm giá. Áo thun wash Nhật Bản thương hiệu GOKING không đụng hàng cho nam nữ, áo cặp đôi siêu đẹp",99000,99000,0,0
TIKI,thoi-trang-nam,74767209,"Áo sơ mi nam tay dài trắng công sở vải oxford cao cấp ND02",229000,229000,0,0
TIKI,thoi-trang-nam,161413668,"Bộ Quần Áo Thể Thao Nam Thời Trang Thiết Kế Cao Cấp Kiểu Dáng ZERO",219000,430000,211000,49
TIKI,thoi-trang-nam,115453581,"Quần Kaki Nam Lính Mỹ USARMY U629 Cao Cấp, Kiểu Dáng Quần Túi Hộp Phong Cách Cực Ngầu -HÀNG CHÍNH HÃNG",530000,1139000,609000,53
TIKI,thoi-trang-nam,76232986,"ÁO CHÔNG NẮNG NAM, CHẤT LIỆU VẢI THÔNG HƠI, CÓ MŨ, TAY DÀI CHE KÍN BÀN TAY",250000,250000,0,0
TIKI,thoi-trang-nam,164344210,"Áo PoLo Nam Ngắn Tay 7 Màu Thiết Kế Phong Cách Thời Trang Cao Cấp AVIANO",189000,360000,171000,48
TIKI,thoi-trang-nam,14847948,"Áo thun nam thoát nhiệt Nhật Bản GOKING siêu thoáng mát, áo phông nam cao cấp thấm hút mồ hôi, mặc như không mặc",119000,119000,0,0
TIKI,thoi-trang-nam,112099693,"Áo Sơ Mi Dài Tay Lính Mỹ U458 US ARMY, Chất Liệu Vải Kaki Cao Cấp Thiết Kế Túi Hộp Phong Cách Loại Xịn- HÀNG CHÍNH HÃNG",372000,800000,428000,54
TIKI,thoi-trang-nam,107453690,"OWEN - Áo sơ mi trắng OWEN chất Nano không nhăn (REGULAR/SLIM)",580000,580000,0,0
TIKI,thoi-trang-nam,23296068,"Quần Lót BOXER Nam",199000,199000,0,0
TIKI,thoi-trang-nam,70937555,"Áo khoác kaki nam 2 lớp thời trang SITAKI cao cấp AKK18",175000,175000,0,0
TIKI,thoi-trang-nam,141259191,"Quần jogger unisex thể thao, quần ống rộng kiểu dáng jogger mặc nhà nam nữ vải TỔ ONG 3 màu năng động",80000,80000,0,0
TIKI,thoi-trang-nam,114323545,"Áo Khoác Dù Nam Nữ Kiểu Bomber Thêu TM 21 Unisex Form Rộng",96000,96000,0,0
TIKI,thoi-trang-nam,98902559,"Quần lót nam đùi ngắn cotton iBasic PANM078",81000,119000,38000,32
TIKI,thoi-trang-nam,56903242,"Quần Short Nam Kaki Phong Cách Thời Trang VICERO",159000,298000,139000,47
TIKI,thoi-trang-nam,122559240,"Quần đùi đũi nam,quần short nam mát mẻ QD06",149000,149000,0,0
TIKI,thoi-trang-nam,163553232,"Áo Phông Nam PoLo Ngắn Tay 4 Màu Kiểu Dáng Thời Trang Cao Cấp AVIANO",129000,258000,129000,50
TIKI,thoi-trang-nam,76538210,"Áo Sơ Mi Nam Trắng Trơn cao cấp lụa không nhắn thương hiệu Chandi, Dáng ôm phong cách trẻ trung Mẫu A1111",119000,220000,101000,46
TIKI,thoi-trang-nam,177309367,"Combo 2 quần đùi nam mở moi May 10 - màu ngẫu nhiên",90000,90000,0,0
TIKI,thoi-trang-nam,168994241,"Áo sơ mi nam Novelty ngắn tay trơn màu 171140N vạt ngang",375200,469000,93800,20
TIKI,thoi-trang-nam,161455980,"Áo Thun Nam PoLo Phối Màu Kẻ Chéo Cao Cấp Thời Trang ZERO",189000,360000,171000,48
TIKI,thoi-trang-nam,145757423,"Quần Tây Nam Oscar Slim Fit - OCMPKSE 012 - GRY",449000,1290000,841000,65
TIKI,thoi-trang-nam,56041700,"Quần bơi nam cao cấp, đồ bơi nam boxer đẹp",180000,220000,40000,18
TIKI,thoi-trang-nam,13690239,"Áo Khoác Da Nam Đen Black Leather ShopN6 Cao Cấp AKD21",269000,299000,30000,10
TIKI,thoi-trang-nam,105231685,"đồ bộ thể thao mặc nhà, đồ bộ dạo phố chất thun thoáng mát, set bộ thể thao unisex ulzzang phong cách hàn quốc, đồ bộ hàn quốc, đồ bộ nam nữ, BỘ ĐỒ NAM / BỘ ĐỒ NỮ / BỘ QUẦN ÁO NAM /BỘ QUẦN ÁO THỂ THAO BỘ ĐỒ NAM NỮ",99000,99000,0,0
TIKI,thoi-trang-nam,171049945,"Quần Bò Nam cao cấp thương hiệu Chandi, chất jean co dãn mẫu mới nhất MD22",180000,350000,170000,49
TIKI,thoi-trang-nam,73332663,"Áo Khoác Nam Big Size Áo Khoác Dù Nam Dày Hai Lớp Cổ Cao Chống Nắng Tia Uv Chống Gió Chống Lạnh Hàn Quốc Cao Cấp QD28 - ShopN6 (Nhiều Màu)",179000,255000,76000,30
TIKI,thoi-trang-nam,160902809,"Quần Jogger Nam LAMPOS, Cotton Cao Cấp, Siêu Co Giản - Thoáng Mát - Siêu Bền (Màu đen)",195000,195000,0,0
TIKI,thoi-trang-nam,137611546,"Áo Thun Thể Thao Nam TSIMPLE cổ tròn tay ngắn tập gym vải thun lạnh thoáng mát co giãn chuẩn form MSSAHRBC",149000,149000,0,0
TIKI,thoi-trang-nam,104913896,"áo khoác dù JACKET KILL SYSTEM, Áo khoác dù kiểu bomber logo Kill System phong cách, ÁO KHOÁC DÙ NAM NỮ FORM RỘNG KILL SYSTEM SIÊU CHẤT MỚI VỀ, ÁO KHOÁC DÙ CÓ NÓN UNISEX ULZZANG PHONG CÁCH HÀN QUỐC",99000,99000,0,0
TIKI,thoi-trang-nam,131375331,"Áo Thun Nam Dài Tay Unisex, áo thu đông trơn tay dài cổ tròn basic",75000,75000,0,0
TIKI,thoi-trang-nam,35193591,"[FREEMAN] Combo 4 quần boxer nam BO501",316000,316000,0,0
TIKI,thoi-trang-nam,138752406,"Áo thu đông nam cổ tròn dài tay chất cotton co giãn dáng body thời trang",70000,70000,0,0
TIKI,thoi-trang-nam,3714775,"Combo 5 Quần Lót Nam Freeman 6023-CB5-M (Size",395000,395000,0,0
TIKI,thoi-trang-nam,34328573,"Áo thun nam thoát nhiệt Nhật Bản GOKING, chất liệu tự nhiên 100% cotton thoáng mát, thấm hút mồ hôi",119000,119000,0,0
TIKI,thoi-trang-nam,24250579,"Quần lót boxer nam hình sao",199000,199000,0,0
TIKI,thoi-trang-nam,154917738,"Áo ba lỗ nam chính hãng May 10",135000,135000,0,0
TIKI,thoi-trang-nam,125485858,"Áo khoác dù nam 2 lớp có nón không thêu LADOS - 2030, chống trượt nước tốt, form đẹp",329000,329000,0,0
TIKI,thoi-trang-nam,76121693,"Áo khoác nam áo gió vải dù DOKA STORE cao cấp 2 lớp chống nắng tia UV và chống nước khoát phong cách Hàn Quốc - PS21",125000,209000,84000,40
TIKI,thoi-trang-nam,132143960,"Áo Đồng Phục Đầu Bếp Màu Trắng Tay Ngắn",150000,150000,0,0
TIKI,thoi-trang-nam,113066078,"Áo khoác sơ mi caro tay dài thời trang phong cách Hàn Quốc cho nam",84000,84000,0,0
TIKI,thoi-trang-nam,94794850,"Áo thun nam trơn Gold Rhino cao cấp, 2 màu Trắng / Đen, hàng xuất khẩu Nhật Bản, 100% cotton chất xịn, áo phông nam trơn mềm mịn, thấm hút mồ hôi, kháng khuẩn, khử mùi hôi triệt để - Hàng chính hãng - Đen",179000,350000,171000,49
TIKI,thoi-trang-nam,72309285,"Áo khoác nam chất kaki 2 lớp xịn xò Julido Store mẫu mới theo xu hướng thời trang Trend MQ11",199000,199000,0,0
TIKI,thoi-trang-nam,192367709,"ÁO THUN POLO NAM TAY NGẮN BIG SIZE TỚI 130KG CHẤT VẢI CÁ SẤU",250000,250000,0,0
TIKI,thoi-trang-nam,178058273,"Quần kaki dài nam cao cấp form đẹp LADOS-4069 vải kaki co giãn, không bay màu",329000,329000,0,0
TIKI,thoi-trang-nam,56465215,"Áo Khoác Kaki Nam Hai Lớp Hàn Quốc Đơn Giản Cao Cấp KK36 - ShopN6 (Nhiều Màu)",169000,240000,71000,30
TIKI,thoi-trang-nam,40979664,"Combo 3 quần sịp đùi nam Cao Cấp Boxer Cạp Nhỏ MRM FASHION cùng màu",185000,255000,70000,27
TIKI,thoi-trang-nam,77868132,"Quần Đùi Nam Vải Kaki Cao Cấp Thời Trang Vicero",159000,298000,139000,47
TIKI,thoi-trang-nam,174651544,"Quần Sọt Jean nam co dãn 4 chiều Thương Hiệu Chandi, phong cách hàn quốc mẫu mới nhất MS218",220000,220000,0,0
TIKI,thoi-trang-nam,53515490,"Quần jeans nam co dãn , quần bò nam kiểu trơn và xước thiết kế trẻ trung đơn điệu phá cách gồm 5 kích thước (28-32) Julido mẫu QJN099703 - Màu xanh phối bạc",169000,299000,130000,43
TIKI,thoi-trang-nam,4399961,"Quần Dài Jogger Nam Phối Sọc 1041 xám",95000,95000,0,0
TIKI,thoi-trang-nam,76705126,"Áo thun nam có cổ cá sấu vải loại 1 nhập từ thái lan loại áo thun tay lỡ size 55kg đến 85kg",81900,81900,0,0
TIKI,thoi-trang-nam,52702515,"Đồ bơi nam tay dài dây kéo cá tính 18-20",433000,433000,0,0
TIKI,thoi-trang-nam,182134920,"Viettien - Áo sơ mi công sở nam dài tay màu trắng mới 390 regular",390000,390000,0,0
TIKI,thoi-trang-nam,11246610,"Aó thun nam SITAKI có cổ thêu logo ATN02-XANHDEN",130000,130000,0,0
TIKI,thoi-trang-nam,51551126,"Áo Sơ Mi Nam Cao Cấp Túi Hộp Ngắn Tay Siêu Hot",163000,163000,0,0
TIKI,thoi-trang-nam,77198910,"Quần đùi nam mặc nhà chất kate cotton 100% mềm mại thoáng mát thương hiệu FEZZIO",64500,129000,64500,50
TIKI,thoi-trang-nam,146265626,"Áo hoodie nỉ bông unisex Homies liền mũ có túi in hình UNFL, Áo hoodie unisex nam nữ nỉ Unfl Studio video thật tại Shop ,Áo nỉ bông ulzzang unisex nam nữ siêu đẹp, Áo khoác Nỉ Có Mũ Túi Bụng Phong Cách Hàn Quốc",100000,100000,0,0
TIKI,thoi-trang-nam,73456416,"Áo Khoác Nam Big Size Áo Khoác Kaki Nam Hai Lớp Big Size Chống Lạnh Chống Nắng Chống Gió Hàn Quốc Cao Cấp WK35 - ShopN6 (Nhiều Màu)",168000,260000,92000,35
TIKI,thoi-trang-nam,117583764,"Áo Khoác Dù Nam Cao Cấp STYLE Hàn Quốc",189000,189000,0,0
TIKI,thoi-trang-nam,28634261,"Áo sơ mi nam ngắn tay vải sơ mi  chống nhăn cao cấp",108000,108000,0,0
TIKI,thoi-trang-nam,78488663,"Quần Bò Nam cao cấp thương hiệu Chandi, chất jean co dãn mẫu mới nhất mã HD26",159000,169000,10000,6
TIKI,thoi-trang-nam,71918836,"Áo Khoác Kaki Nam Hai Lớp Cổ Bẻ Túi Hộp Chống Nắng Chống Lạnh Chống Gió Cao Cấp KK48 - ShopN6 (Nhiều Màu)",189000,240000,51000,21
TIKI,thoi-trang-nam,167431460,"Quần Bò Nam, Phối Rách Cao Cấp Thương Hiệu Chandi, Chất Jean Co Dãn Mẫu Mới Nhất 2023 MS86",169000,299000,130000,43
TIKI,thoi-trang-nam,148994401,"Quần Lót Nam Tam Giác Thun Lạnh, Quần Sịp Nam Tam Giác Cao Cấp, Chất Thun Lạnh Đẹp, Co Dãn 4 Chiều",40000,40000,0,0
TIKI,thoi-trang-nam,67488235,"Quần dài thể thao nam, jogger 3 sọc ống bo có khóa túi size đại hơn 80kg",55500,55500,0,0
TIKI,thoi-trang-nam,50347611,"Combo 2 Quần shorts thể thao nam dạng sọt sport đùi chất thun lạnh 4 chiều cao cấp phù hợp tập gym hay mặc nhà màu trắng và đen DUI-P101 - tặng 1 khẩu trang chống nắng",79000,130000,51000,39
TIKI,thoi-trang-nam,116105914,"Áo Khoác Dù Bomber TSM Túi Có Khóa Kéo Áo Khoác Gió Nam Nữ Couple Rẻ Đẹp Chống Nắng - Bomber Jacket -HIỀN LINH SHOP ÁO KHOÁC",105000,105000,0,0
TIKI,thoi-trang-nam,74281156,"Áo khoác nam Julido Store, chất jean cotton xịn mẫu mới MS37",199000,300000,101000,34
TIKI,thoi-trang-nam,183901382,"Viettien - Áo sơ mi công sở nam ngắn tay màu trắng mới 340 vạt bầu regular",340000,340000,0,0
TIKI,thoi-trang-nam,102521005,"HÌNH SHOP CHỤP THẬT - Quần short nhung lửng có túi sau bao đẹp, Quần Short  Vải Nhung Cao cấp, QUẦN SHORT NHUNG , QUẦN THỂ THAO  NAM NỮ, QUẦN LỬNG MẶC NHÀ , QUẦN ĐÙI , QUẦN LỬNG, quần lửng ngố , quần short nam nữ",99000,99000,0,0
TIKI,thoi-trang-nam,140463315,"Quần Short Nam Phối Túi Hộp Mẫu GV01 Thời Trang Cao Cấp PONIVA Chất Liệu Kaki Dày Dặn Chuẩn Form",175000,175000,0,0
TIKI,thoi-trang-nam,168224759,"[COMBO 3 QUẦN] Quần Lót Nam Thun Lạnh Lados 4115 - Thun lụa co giãn 4 chiều, siêu mềm, siêu thoải mái",140000,140000,0,0
TIKI,thoi-trang-nam,160903200,"Quần Jogger Nam LAMPOS Túi Hộp, Ống Zipper Cao Cấp, Cotton Co Giản 4 Chiều",195000,195000,0,0
TIKI,thoi-trang-nam,52188800,"Combo 4 Quần Lót Nam Quần Sịp Đùi Sợi Cotton Cao Cấp MRM FASHION Mix 3 Màu TẶNG Đôi Tất Nam Cao Cấp",255000,380000,125000,33
TIKI,thoi-trang-nam,119056035,"Áo polo nam màu trắng phối viền chìm ADINO vải cotton polyester mềm dáng slimfit trẻ trung năng động AP81",159000,318000,159000,50
TIKI,thoi-trang-nam,113052759,"Áo khoác nam Áo khoát nam kaki chống nắng rẻ from rộng trơn cực chất siêu chất",145000,145000,0,0
TIKI,thoi-trang-nam,123204494,"Quần lót nam thun boxer Espresso iBasic PANM103",59000,99000,40000,40
TIKI,thoi-trang-nam,91467052,"Quần bơi nam boxer cao cấp, dáng ngắn thể thao, eo kép dễ chịu, chất thun bơi đẹp không thấm nước nhanh khô, đàn hồi cao | BN006",240000,240000,0,0
TIKI,thoi-trang-nam,173032354,"Quần Short nam nhung tăm, quần đùi nam style Hàn Quốc- FORMEN SHOP- FMTP013",99000,250000,151000,60
TIKI,thoi-trang-nam,176561403,"Quần Short Gió Nam Kiểu Dáng Năng Động Phong Cách Thể Thao Trẻ Trung 5 Màu Thời Trang AVIANO",129000,258000,129000,50
TIKI,thoi-trang-nam,133689539,"Áo khoác gió nam trung niên chất đẹp+ẢNH THẬT - 3",375000,375000,0,0
TIKI,thoi-trang-nam,163032507,"Áo Sơ Mi Nam Công Sở Trung Niên Thương Hiệu Anton Dài Tay Công Sở Vải Cotton Xanh Dương -XA14",225000,280000,55000,20
TIKI,thoi-trang-nam,178102021,"Quần tây học sinh việt tiến cấp 2 - 3 loại tốt",223000,223000,0,0
TIKI,thoi-trang-nam,58062140,"Áo khoác nam JJ07 , khoác dù 3D nam 2 lớp thời trang hàn quốc trẻ trung cuốn hút Julido mẫu THU36 chất liệu thấm hút mồ hôi dày dặn mặc thoáng mát",139000,139000,0,0
TIKI,thoi-trang-nam,84777124,"Combo 3 quần đùi thun nam mặc nhà iBasic SHM003",389000,477000,88000,18
TIKI,thoi-trang-nam,150731971,"Áo Thể Thao Nam TSIMPLE cổ tròn tay ngắn tập gym vải thun lạnh thoáng mát co giãn chuẩn form MSSAHP4",149000,149000,0,0
TIKI,thoi-trang-nam,96160421,"Áo thun nam thể thao tay lỡ, cổ tròn đẹp, trẻ trung, mặc thoáng mát, thấm hút tốt CHANDI HH14",89000,89000,0,0
TIKI,thoi-trang-nam,155764985,"Áo len nam May 10 mã 200119453ON Ghi-202",129000,129000,0,0
TIKI,thoi-trang-nam,163550992,"Bộ Thể Thao Nam Có Cổ Phối Màu Sọc Ngang Thời Trang Thiết Kế AVIANO",269000,458000,189000,41
TIKI,thoi-trang-nam,58441436,"Áo sơ mi nam tay ngắn vải Oxford cao cấp phù hợp công sở trắng ND05",219000,219000,0,0
TIKI,thoi-trang-nam,15784024,"Áo Khoác Nam Áo Khoác Dù Dày Nam Trơn  Cao Cấp ShopN6 - AD34",179000,245000,66000,27
TIKI,thoi-trang-nam,67730631,"Quần short jean nam B888 co dãn kiểu dán trẻ trung đơn giản thêu họa tiết Julido thời trang hàn quốc",139000,220000,81000,37
TIKI,thoi-trang-nam,102872512,"Quần short lưng thun nam Novelty 1910560",99000,265000,166000,63
TIKI,thoi-trang-nam,138750674,"Áo thun nam tay dài mặc thu đông, giữ nhiệt, chất cotton co giãn, áo dài tay dáng ôm cao cấp",70000,70000,0,0
TIKI,thoi-trang-nam,158905125,"quần lót nam relax thun lạnh cao cấp chính hãng, quần sip nam relax underwear rltk22 - M",74000,74000,0,0
TIKI,thoi-trang-nam,160407460,"Viettien - Quần dài kaki nam màu xám sáng không ly regular 6Q6050",630000,630000,0,0
TIKI,thoi-trang-nam,94775547,"Đồ bộ nam nữ unisex mùa hè chất mè xịn co giãn 4 chiều thoáng mát (sports)",92000,92000,0,0
TIKI,thoi-trang-nam,74404407,"Quần jogger kaki nam cao cấp Amazing, sắc màu trẻ trung, phong cách thể thao cá tính, gấu quần bo chun, có big size",253000,385000,132000,34
TIKI,thoi-trang-nam,83160842,"Áo Thun Nam Cổ Polo Phối Viền Ngang Lịch Lãm",157000,157000,0,0
TIKI,thoi-trang-nam,129301896,"Quần ngố kaki túi hộp nam trung niên chất siêu mềm nhẹ size 100kg hàng nội địa trung",223000,223000,0,0
TIKI,thoi-trang-nam,20534153,"Áo Sơ Mi Nam Tay Dài Khatoco A1MD568S1-CNMK003-2102-D",354000,568000,214000,38
TIKI,thoi-trang-nam,104921367,"Quần đùi thun nam, quần tập gym, quần mặc nhà chất thun cotton 100% thương hiệu Fezzio",69500,139000,69500,50
TIKI,thoi-trang-nam,101656410,"Áo Khoác Dạ Nam Áo Dạ Nam Dáng Ngắn Sans09 Sans Shop",599999,599999,0,0
TIKI,thoi-trang-nam,143694820,"Áo Sơ Mi Nam Sọc Chữ Dài Tay Mã Q889 Thời Trang Nam Công Sở PONIVA Cao Cấp Chất Liệu Mềm Mịn Thoáng Mát Hàng Chất Lượng VNXK",157000,157000,0,0
TIKI,thoi-trang-nam,108772138,"Áo Thun Nam Ngắn Tay Không Cổ US ARMY U229, Chất Liệu Cotton Thoáng Mát, Mềm Mịn, Mát, Bền Màu-HÀNG CHÍNH HÃNG",185000,398000,213000,54
TIKI,thoi-trang-nam,189648166,"Áo sơ mi nam ngắn tay trắng Regular fit NSMMMWMSPR210261N",199000,319000,120000,38
TIKI,thoi-trang-nam,87250655,"Áo Sơ Mi Flannel Sơ Mi Caro Áo Khoác Nam Nữ Form Rộng Cá Tính Unisex SM11",110000,110000,0,0
TIKI,thoi-trang-nam,3714905,"Combo 3 Quần Lót Nam Freeman 6042-CB3 (Size",225000,225000,0,0
TIKI,thoi-trang-nam,163716172,"Áo Sơ Mi Nam Xanh Tím Than Ngắn Tay Công Sở Trung Niên Anton Kẻ Caro Thoáng Mát, Thấm Hút Mồ Hôi - NT201",295000,425000,130000,31
TIKI,thoi-trang-nam,10083296,"Áo sơ mi caro nam tay dài cá tính - SMNHHP045",83000,83000,0,0
TIKI,thoi-trang-nam,164251213,"NEVER SAY LOSE, mã G43. Áo thun nam nữ siêu đẹp. Áo phông thoát nhiệt Goking hàng hiệu",168000,168000,0,0
TIKI,thoi-trang-nam,93828594,"Áo Khoác Big Size Nam Nữ Unisex Áo Khoác Nỉ Có Nón Cổ Cao Chống Nắng Chống Nóng Chống Lạnh Chống Gió Đi Phượt Racing Thời Trang Hàn Quốc Cao Cấp AN14 - ShopN6",169000,190000,21000,11
TIKI,thoi-trang-nam,162162250,"QUẦN KAKI NAM TÚI MỸ DÁNG SUÔNG",140000,140000,0,0
TIKI,thoi-trang-nam,177274778,"Áo sơ mi rộng tay dài nam nữ unisex phong cách trẻ trung hàn quốc vải lụa mềm mịn mát ít nhăn -MRD01",98000,190000,92000,48
TIKI,thoi-trang-nam,126596446,"Áo thun cổ tròn vải xịn, form đẹp Lados - 29021, unisex, chất thun 100% cotton 4 chiều, không ra màu, không xù lông",199000,199000,0,0
TIKI,thoi-trang-nam,104935833,"Quần short nam có túi thun cotton 100% thương hiệu Fezzio",69500,139000,69500,50
TIKI,thoi-trang-nam,112064344,"Combo 3 áo ba lỗ nam, áo 3 lỗ nam, sợi cotton mềm mịn, thấm hút mồ hôi tốt, thoáng mát, mặc thoải mái JAMANO",219000,297000,78000,26
TIKI,thoi-trang-nam,192020577,"Bộ Thể Thao Nam mùa hè mặc ở nhà chất Cotton Xốp Thái siêu xịn, Đồ Bộ Quần Áo mùa hè cộc tay BX01- PROMAN",199000,199000,0,0
TIKI,thoi-trang-nam,82984729,"Áo sơ mi nam tay dài hai túi công sở màu trắng vải oxford denim cao cấp NS035",249000,249000,0,0
TIKI,thoi-trang-nam,91640238,"Bộ bơi nam dài tay cao cấp, tay phối họa tiết cá tính, chất bơi chuyên dụng co giãn tốt, dày dặn đẹp, có mẫu nữ để mặc đôi | BN020",420000,420000,0,0
TIKI,thoi-trang-nam,22774390,"Áo Thun nam cá sấu mẫu mới, combo 4 áo - ĐB437",396000,623000,227000,36
TIKI,thoi-trang-nam,3714885,"Combo 3 Quần Lót Nam Freeman 6041-CB3 (Size",195000,195000,0,0
TIKI,thoi-trang-nam,105514108,"Quần đùi nam xuất khẩu, quần mặc nhà, quần short chất vải thun 100% thương hiệu Fezzio",64500,129000,64500,50
TIKI,thoi-trang-nam,118985353,"Áo polo nam ADINO màu xanh đen vải cotton co giãn thiết kế basic trẻ trung PL42",159000,318000,159000,50
TIKI,thoi-trang-nam,186290739,"Áo Sơ Mi nam sọc caro NSMMCLMTCR210233D",199000,319000,120000,38
TIKI,thoi-trang-nam,20990241,"Áo sơ mi trơn tay dài",440000,440000,0,0
TIKI,thoi-trang-nam,87056067,"BỘ QUẦN ÁO THỂ THAO , bộ quần áo nam ,BỘ ĐỒ NAM CHẤT THUN LẠNH MÀU ĐEN , ĐỎ , TRẮNG",97000,97000,0,0
TIKI,thoi-trang-nam,15381298,"Áo lót nam thoát nhiệt Nhật Bản Goking, áo thun ba lỗ nam thoáng mát thấm hút mồ hôi, thoải mái vận động",139000,139000,0,0
TIKI,thoi-trang-nam,30764045,"Quần lót nam Khatoco Q4M075R0-VNMA011-2101-T",57000,75000,18000,24
TIKI,thoi-trang-nam,188794495,"Bộ bơi nam cộc tay quần sooc đùi thể thao khỏe khoắn, chất bơi thun lạnh Spandex cao cấp dày đẹp, co giãn đa chiều | BN011",480000,480000,0,0
TIKI,thoi-trang-nam,85087388,"Áo sơ mi nam cổ tàu kẻ sọc thời trang",159000,159000,0,0
TIKI,thoi-trang-nam,20518713,"Quần Kaki Nam Khatoco Q2M528S0-CNMA003-2006-0- Nâu",189000,528000,339000,64
TIKI,thoi-trang-nam,76469417,"Áo sơ mi nam cổ lãnh tụ dài tay màu xanh biển vải oxford",159000,159000,0,0
TIKI,thoi-trang-nam,113769576,"Áo sơ mi nam màu trắng, tay ngắn, đồng phục học sinh các cấp, size từ 20-95kg, form suông, vạt bầu, thương hiệu Amazing",104000,161000,57000,35
TIKI,thoi-trang-nam,115101947,"quần baggy nam dài ống côn chất đũi mềm mại nhiều màu",85000,85000,0,0
TIKI,thoi-trang-nam,118015579,"Đồ Lam Đi Chùa # Lãnh Tụ Nam Thêu 3 Túi # Đồ Bộ Nam # Quần Áo Nam",222000,222000,0,0
TIKI,thoi-trang-nam,134389875,"Quần Jogger\Quần Nỉ Ống Rộng Bo Chân Nam Nữ Unisex HIPHOP Ulzzang KUN",103000,103000,0,0
TIKI,thoi-trang-nam,34964186,"Áo phông cổ bẻ Goking, form unisex cho nam nữ, công ty, đội nhóm, đồng phục cao cấp. Áo thun polo cá sấu hàng hiệu xuất khẩu",138000,138000,0,0
TIKI,thoi-trang-nam,163713265,"Áo Sơ Mi Nam Công Sở Trung Niên Thương Hiệu Anton Dài Tay Vải Cotton Xanh Đậm Trơn Có Túi -XA13",225000,280000,55000,20
TIKI,thoi-trang-nam,138414268,"Combo 3 Quần Lót Nam NOVELTY Chất Liệu Polyamide Mềm Mại Thoáng Mát Dễ Chịu Co Giãn Thoải Mái",199000,477000,278000,58
TIKI,thoi-trang-nam,169467998,"Quần kaki nam dáng suông túi mỹ chất lượng cao màu xám trung niên co dáng đẹp",140000,140000,0,0
TIKI,thoi-trang-nam,82642262,"Áo Sơ Mi Nam Ngắn Tay Ô Kẻ Thời Trang Poniva",169000,169000,0,0
TIKI,thoi-trang-nam,129303606,"Quần Jean quần bò nam trung niên trung tuổi ẢNH THẬT SHOP TỰ CHỤP",259000,259000,0,0
TIKI,thoi-trang-nam,46107976,"Áo thun nam ngắn tay cổ tim FREEMAN TSF315 [Combo 2",198000,198000,0,0
TIKI,thoi-trang-nam,90483788,"Combo 3 Áo thun nam ngắn tay cổ tim cotton FREEMAN TSF315",297000,297000,0,0
TIKI,thoi-trang-nam,155563936,"áo khoác nam trung niên cổ bẻ lót nhung dày dặn cực ấm",623500,623500,0,0
TIKI,thoi-trang-nam,191777227,"ÁO THUN ĐỎ CỔ TRÒN ĐỦ MẪU BIG SIZE NAM TỚI 130KG",290000,290000,0,0
TIKI,thoi-trang-nam,100367154," Quần đùi nam Big Size Fasvin D20206.HN cỡ đại vải gió mềm mại co giãn thoải mái",209000,209000,0,0
TIKI,thoi-trang-nam,137863363,"Áo Sơ Mi Nam Caro Phối Chữ Ngắn Tay PONIVA Mã 01 Thời Trang Nam Công Sở Thiết Kế Lịch Lãm Nam Tính Và Sang Trọng",169000,169000,0,0
TIKI,thoi-trang-nam,86893155,"Quần lót nam - Combo 4 quần sịp đùi nam thoáng mát",159888,159888,0,0
TIKI,thoi-trang-nam,96935359,"Set đồ bộ nam chất thun cotton co giản thoáng mát, thời trang đồ bộ thể thao nam, Set Bộ Quần Áo Thể Thao Nam Mùa hè Co Dãn, SÉT ĐỒ BỘ THỂ THAO MẶC NHÀ, đồ bộ mặc nhà in con gấu mặc thoải mái",99000,99000,0,0
TIKI,thoi-trang-nam,124638185,"Quần tây nam chất lượng LADOS - 327, chất vải dày dặn co giãn nhẹ, form slimfit",299000,299000,0,0
TIKI,thoi-trang-nam,108334865,"Áo thun tay dài nam form rộng unisex nam nữ vải thun dày dặn",75000,75000,0,0
TIKI,thoi-trang-nam,142781683,"Áo len nam dài tay phối cổ tròn cao cấp mẫu mới hot trend 2023 Micado",189000,378000,189000,50
TIKI,thoi-trang-nam,148600532,"Áo khoác dù nam 2 mặt chống Nước LADOS cao cấp - 22027 , Form đẹp, chống nắng, chống nước tốt",379000,379000,0,0
TIKI,thoi-trang-nam,47270550,"Áo Khoác Nam Trung Niên 2 Lớp Cổ Bẻ Chất Vải Dày Và Ấm Form Áo Vest Cao Cấp",420000,420000,0,0
TIKI,thoi-trang-nam,126700312,"Áo khoác dù nam Lados có nón không thêu Lados - 12030, chống trượt nước tốt",329000,329000,0,0
TIKI,thoi-trang-nam,160291075,"OWEN - Áo sơ mi dài tay Owen Regular fit sợi sồi màu xanh xám đậm 23419",598000,598000,0,0
TIKI,thoi-trang-nam,95054251,"Quần Short Nam Big Size Quần Sọt Nam Thể Thao Cotton 4 Chiều Quần Đùi Nam Trên 100kg Quần Thun Nam Cao Cấp Giá Tốt WSB1 - ShopN6 (Sọc Ngẫu Nhiên)",69000,105000,36000,34
TIKI,thoi-trang-nam,91848059,"Quần jogger kaki cao cấp Amazing, lưng thun có dây rút, ống bo, thời trang unisex, màu sắc classic dễ phối đồ, có big size",253000,385000,132000,34
TIKI,thoi-trang-nam,169331344,"Áo chống nắng nam sọc tay mới 5 màu thun lạnh thoáng mát chống tia UV cao cấp Micado",99000,150000,51000,34
TIKI,thoi-trang-nam,148985495,"Quần sịp nam boxer onesize chất thun cotton thấm hút mồ hôi, dễ dang vận động - FORMEN SHOP - FMQS016",35000,70000,35000,50
TIKI,thoi-trang-nam,72101305,"Quần lót nam boxer cao cấp thun cotton co giãn tốt, sịp đùi nam kiểu dáng hiện đại trẻ trung, lưng cạp to nam tính và co giãn thoải mái, màu trơn thanh lịch QLINC004",99000,135000,36000,27
TIKI,thoi-trang-nam,105710028,"Áo Khoác Big Size Áo Khoác Kaki Nam Chống Nắng Chống Gió Chống Lạnh Chống Nóng Có Cổ Cao Dày 2 Lớp Thời Trang Nam Tính Hàn Quốc Cao Cấp ShopN6 - QK51",199000,199000,0,0
TIKI,thoi-trang-nam,129296991,"quần bò nam trung niên hàng đẹp dáng thụng túi chéo Shop Nhung trung niên cao cấp",339000,339000,0,0
TIKI,thoi-trang-nam,163546188,"Bộ Thể Thao Nam Có Cổ Phối Màu Sọc Ngang Phong Cách Thiết Kế Thời Trang AVIANO",269000,458000,189000,41
TIKI,thoi-trang-nam,14991688,"Combo 3 Chiếc Quần Lót Nam Tam Giác Thời Trang Aristino AC 02",210000,210000,0,0
TIKI,thoi-trang-nam,138748825,"Áo thun nam tay ngắn cổ tròn, chất cotton 100% , áo ngắn tay nhiều màu dáng ôm thời trang",79000,79000,0,0
TIKI,thoi-trang-nam,22490670,"Áo thun nam cổ bẻ vải cá sấu, Combo 2 áo – EZ210",178500,285000,106500,37
TIKI,thoi-trang-nam,72304064,"Áo khoác dù nam , áo khoác gió nam , áo khoác nam có túi trong vải dù 2 lớp chống nắng chống lạnh tốt",109000,109000,0,0
TIKI,thoi-trang-nam,130029779,"Áo Khoác Nỉ Bomber Nam Nữ Form Rộng Unisex Chất Nỉ Ngoại Dày Dặn Cực Hot (chucuu)",95000,95000,0,0
TIKI,thoi-trang-nam,76165666,"Áo sơ mi unisex form rộng - somi nam nữ phối 2 màu",179000,215000,36000,17
TIKI,thoi-trang-nam,134245251,"Áo thun nam kiểu dáng Hàn quốc - phong cách lịch lãm (D2)",149000,149000,0,0
TIKI,thoi-trang-nam,170498390,"Bộ Quần Áo Thể Thao Nam Phối Màu Có Cổ Thời Trang Thiết Kế Cao Cấp AVIANO",219000,430000,211000,49
TIKI,thoi-trang-nam,172282390,"Áo thun nam nữ in hình Sư Tử siêu đẹp, mã G114. Áo phông thoát nhiệt GOKING hàng hiệu cao cấp cho nam nữ trẻ em",168000,168000,0,0
TIKI,thoi-trang-nam,110438951,"Quần tây nam Novelty 0Ply 1709220 màu xám đậm",445000,445000,0,0
TIKI,thoi-trang-nam,162526851,"Áo Sơ Mi Nam Công Sở Trung niên Ngắn tay Họa Tiết Chấm Bi Nhỏ Màu Trắng Vải Cotton thương hiệu Anton 808",225000,328000,103000,31
TIKI,thoi-trang-nam,78501183,"Quần Jean Nam cao cấp co dãn 4 chiều Thương Hiệu Chandi, phong cách hàn quốc trẻ trung cá tính HD23",169000,299000,130000,43
TIKI,thoi-trang-nam,134750203,"Áo Sơ Mi Trắng Form Rộng Unisex Nam Nữ Tay Dài Hàn Quốc Kiểu Cổ Bẻ Vải Lụa Nhiều Màu - SMD01",87000,210000,123000,59
TIKI,thoi-trang-nam,96809572," Quần lót nam Brief iBasic PANM077",65000,99000,34000,34
TIKI,thoi-trang-nam,169467895,"Quần kaki nam dáng suông túi mỹ chất lượng cao màu xanh lá nhạt kaki trung niên co dáng đẹp",140000,140000,0,0
TIKI,thoi-trang-nam,195947484,"Áo sơ mi ngắn tay nam màu xanh nhạt ADINO vải nến lụa sợi sồi modal dáng công sở slimfit hơi ôm trẻ trung CT04",259000,380000,121000,32
TIKI,thoi-trang-nam,134656633," Áo sơ mi form rộng tay ngắn tay lỡ unisex nam nữ cá tính form Hàn Quốc vải lụa - SMN02",84000,190000,106000,56
TIKI,thoi-trang-nam,90069525,"BỘ QUẦN ÁO THỂ THAO BỘ ĐỒ MẶC NHÀ THỜI TRANG NAM NỮ",96000,96000,0,0
TIKI,thoi-trang-nam,97765315,"Quần ngủ nam, boxer nam, quần đùi nam mặc nhà thun 100% cotton thương hiệu Fezzio chính hãng",49500,99000,49500,50
TIKI,thoi-trang-nam,134380574,"Áo thun nam kiểu dáng Hàn quốc - phong cách lịch lãm (D2)",148000,148000,0,0
TIKI,thoi-trang-nam,3716233,"Áo sơ mi nam form rộng kẻ caro ANK02",119000,119000,0,0
TIKI,thoi-trang-nam,52253824,"Quần short thun Nam tập GYM thể thao - Q0003",110000,110000,0,0
TIKI,thoi-trang-nam,105708174,"Áo Khoác Big Size Áo Khoác Dù Nam Có Nón Cổ Trụ Chống Nắng Chống Nóng Chống Lạnh Chống Gió 2 Lớp Phối Logo Thời Trang Nam Tính Hàn Quốc Giá Tốt ShopN6 - QD58",199000,245000,46000,19
TIKI,thoi-trang-nam,50327852,"Quần tây nam ống suông Khatoco Q1M428R0",325000,428000,103000,24
TIKI,thoi-trang-nam,84471533,"Áo Khoác Hoodie Nam Nữ Form rộng chống nắng Có 4 Màu, Unisex hình Lập Phương Ulzzang 123SHOP",99000,99000,0,0
TIKI,thoi-trang-nam,20518200,"Quần Kaki Nam Khatoco Q2M528S0-VNMA007-1811-0003",189000,528000,339000,64
TIKI,thoi-trang-nam,72103007,"Áo thun nam dài tay Julido, Chất thun cotton xịn bo tay và hông mẫu thu đông AT1357",129000,169000,40000,24
TIKI,thoi-trang-nam,184901447,"Quần lót nam brief RLTK053 quần sịp nam thoáng mát mềm mại cao cấp, co giãn tốt, ôm gọn - RELAX",109000,109000,0,0
TIKI,thoi-trang-nam,27990828,"Áo thun nam cổ tròn tay ngắn, chất thun cao cấp, trẻ trung, năng động – FORMEN SHOP – FMPS089",99000,189000,90000,48
TIKI,thoi-trang-nam,63037905,"Áo khoác gió cách nhiệt GOKING có mũ, form unisex cho nam nữ. Ngoài vải dù, trong lót vải cào cách nhiệt. 3 túi to rộng",255000,255000,0,0
TIKI,thoi-trang-nam,83377872,"Quần Bò Nam cao cấp thương hiệu Chandi, chất jean co dãn mẫu mới nhất MA195",169000,289000,120000,42
TIKI,thoi-trang-nam,52470520,"Áo POLO thun nam trơn basic TUTO5 áo phông có cổ ngắn tay Regular fit chất vải cá sấu cotton đẹp cao cấp trắng ATP01",399000,399000,0,0
TIKI,thoi-trang-nam,11730375,"Áo thun nam cổ tròn tay ngắn, chất thun cao cấp, trẻ trung, năng động – FORMEN SHOP – FMPS003",95000,189000,94000,50
TIKI,thoi-trang-nam,169332884,"Áo chống nắng nam mặc 2 mặt thun lạnh lỗ kim thoáng mát, thấm hút mồ hôi mẫu mới Micado",119000,119000,0,0
TIKI,thoi-trang-nam,109840857,"Quần Jocker ống rộng bo gót in hình Heroes có túi sau sành điệu, quần thun nỉ dài ống rộng nam phong cách Hàn Quốc",92000,92000,0,0
TIKI,thoi-trang-nam,159100290,"Áo sơ mi nam Oscar tay ngắn - OCMSCSF 046",349000,1990000,1641000,82
TIKI,thoi-trang-nam,87895026,"Bộ bơi nam họa tiết da cá, phom dáng đẹp ôm sát người, chất thun bơi dày đẹp, ít thấm nước, mau khô | BN010",350000,350000,0,0
TIKI,thoi-trang-nam,129299572,"Quần thô Kaki Nam Trung Niên hàng chuẩn đẹp ẢNH THẬT",279000,279000,0,0
TIKI,thoi-trang-nam,55911268,"Áo Thun Nam Cổ Polo Họa Tiết KO888 Cao Cấp",157000,157000,0,0
TIKI,thoi-trang-nam,50456519,"Quần ngủ nam lưới thể thao vải mát lịm thêm miếng lót nhỏ bên trong nâng đỡ phần nhạy cảm, lỗ thoáng mát sexy kiểu dáng thể thao nam tính",99000,99000,0,0
TIKI,thoi-trang-nam,21601483,"Combo 4 quần lót nam quần sịp tam giác nam đúc tàng hình cao cấp",319000,319000,0,0
TIKI,thoi-trang-nam,30030737,"Quần Khaki Nam Không Ply Ống Ôm Khatoco Q2M528S0-VNMA002-1811-0004",189000,528000,339000,64
TIKI,thoi-trang-nam,56919853,"Áo Len Cổ Lọ Nam SZone SAL222 Phong Cách Hàn Quốc",129000,129000,0,0
TIKI,thoi-trang-nam,109150516,"Quần thun jogger logo in không bong tróc chất thun da cá mềm mịn form đẹp, quần dài nam heroes, Quần thể thao nam nữ mặc , quần thun nam ,quần dài nam, quần nỉ , quần jogger 2 sọc, quần thun",99000,99000,0,0
TIKI,thoi-trang-nam,56064912,"Quần Short KaKi Nam Thương Hiệu VICERO Trẻ Trung Năng Động",159000,298000,139000,47
TIKI,thoi-trang-nam,121635925,"Áo Khoác Nam Cách Nhiệt Vải Kaki Cao Cấp US ARMY U559, Áo Khoác Kaki Lính Lót Bông Cừu Siêu Ấm Phong Cách Cực Ngầu  -HÀNG CHÍNH HÃNG",557000,1198000,641000,54
TIKI,thoi-trang-nam,125614162,"OWEN - Quần kaki nam Owen chất thô giấy mềm mại co dãn màu đen 21993/22006",625000,625000,0,0
TIKI,thoi-trang-nam,181136946,"Áo sơ mi nam Slim fit ngắn tay xanh cổ vịt 171424N",148000,469000,321000,68
TIKI,thoi-trang-nam,167421285,"Quần Tây Âu Nam Co Giãn Nhẹ Dáng Ôm, Quần Nam Công Sở Lịch Sự Phù Hợp Mọi Hoàn Cảnh Thương Hiệu Chandi Mã MT2",180000,350000,170000,49
TIKI,thoi-trang-nam,18012630,"Quần dài thun jogger nam bo lưng thun Phúc An 1042",90000,90000,0,0
TIKI,thoi-trang-nam,195305781,"Combo 3 quần đùi mặc nhà - Giao màu ngẫu nhiên",165000,285000,120000,42
TIKI,thoi-trang-nam,191450967,"Quần Đùi Nam Thể Thao mặc nhà quần short thể thao nam vải Xốp Thái thun mềm mịn, thấm hút mồ hôi tốt - PROMAN",54000,54000,0,0
TIKI,thoi-trang-nam,84750552,"QUẦN LÓT BOXER NAM ROSSO 0002 - UNDERWEAR",120000,120000,0,0
TIKI,thoi-trang-nam,106043939,"Áo Khoác Jean Nam đen form rộng thương hiệu Chandi, Áo Khoác Nam in hình mẫu mới hot trend NT1925",299000,299000,0,0
TIKI,thoi-trang-nam,185710778,"Áo Polo Novelty đỏ đô NATMMDNPSR181219N",235000,235000,0,0
TIKI,thoi-trang-nam,163882213,"Áo Sơ Mi Nam Xanh Dương Ngắn Tay Công Sở Trung Niên Anton Vải Sợi Tre Thấm Hút Mồ Hôi - NT203",295000,325000,30000,9
TIKI,thoi-trang-nam,91754227,"Áo khoác Hoodie  hoạt hình unisex, Áo hoodie nỉ bông in hình nam nữ cặp đôi mặc siêu cute -from rộng khoác hoodie nam Unisex , Áo hoodie nam nữ mặc in/ áo sweater nam nữ mặc / áo thun áo form rộng / áo cặp đôi / áo khoác",108000,108000,0,0
TIKI,thoi-trang-nam,75601328,"áo hoodie nam nữ, áo hoodie nữ, áo hoodie nam, áo hoodie ulzzang, áo hoodie unisex, Áo Hoodie Nỉ Bông Unisex Streetwear Lục Lăng ( unisex nam nữ đều mặc được)",100000,100000,0,0
TIKI,thoi-trang-nam,85086749,"Áo sơ mi nam dài tay sọc đẹp",159000,159000,0,0
TIKI,thoi-trang-nam,59473713,"Quần Short Kaki Nam Cao Cấp NamMinh",109000,109000,0,0
TIKI,thoi-trang-nam,78906543,"Quần Bò Nam co dãn 4 chiều Thương Hiệu Chandi, chất jean mềm mịn xịn xò xu hướng HD82",169000,299000,130000,43
TIKI,thoi-trang-nam,162734947,"Áo Sơ Mi Nam Công Sở Trung Niên Ngắn Tay Vải Cotton Họa Tiết Chấm Bi Nhỏ Màu Trắng Anton - Y808",225000,328000,103000,31
TIKI,thoi-trang-nam,169626424,"Viettien - Áo sơ mi nam ngắn tay kẻ sọc vạt bầu 1N0728 regular",365000,365000,0,0
TIKI,thoi-trang-nam,3714855,"Combo 5 Quần Lót Nam Freeman 6036-CB5-M (Size",345000,345000,0,0
TIKI,thoi-trang-nam,106808609,"OWEN - Áo sơ mi trắng dài tay regular fit (không túi ngực) chất sơi tre 90527",556000,556000,0,0
TIKI,thoi-trang-nam,95053519,"Quần bơi nam lửng màu trơn đơn giản, đồ bơi nam form dài trên gối thiết kế trẻ trung QB022",199000,235000,36000,15
TIKI,thoi-trang-nam,101657582,"Áo Măng Tô - Áo Khoác Dạ Dáng Dài Sans02 Sans Shop",639000,639000,0,0
TIKI,thoi-trang-nam,7989432,"Áo khoác chống nước nam",680000,680000,0,0
TIKI,thoi-trang-nam,105361476,"Áo Phông Nam Polo Tay Ngắn Phối Màu Thời Trang VICERO",189000,300000,111000,37
TIKI,thoi-trang-nam,163477158,"Áo Sơ Mi Nam Công Sở Trung Niên Ngắn Tay Anton Màu Xanh Than Thoáng Mát, Thấm Hút Mồ Hôi - YNC130",295000,425000,130000,31
TIKI,thoi-trang-nam,194124865,"Quần Dài Kaki Nam Slim Tapered Giordano 01122002",649000,890000,241000,27
TIKI,thoi-trang-nam,20518075,"Quần Lót Nam Khatoco Q4M108R0-VNMA001-2006-0",49000,108000,59000,55
TIKI,thoi-trang-nam,68200548,"Áo ba lỗ nam, áo sát nách nam,sợi cotton cao cấp mềm mịn, thấm hút mồ hôi, siều thoáng mát, co giãn 4 chiều Mrm Manlywear",119000,155000,36000,23
TIKI,thoi-trang-nam,192666726,"Quần lót nam thể thao ONOFF Microfiber Mesh Premium siêu mảnh, trẻ trung, nam tính - 18UQ23A007",199000,199000,0,0
TIKI,thoi-trang-nam,20329891,"Quần jogger kaki nam",99000,99000,0,0
TIKI,thoi-trang-nam,67595415,"Áo Khoác Dù Nam Nữ Áo Khoác Nam RG Chống Nắng Chống Lạnh Cổ Cao Hai Lớp Cao Cấp AD62 - ShopN6 (Nhiều Màu)",139000,245000,106000,43
TIKI,thoi-trang-nam,58487752,"Quần tây âu nam vải cao cấp phù hợp công sở ND01",229000,229000,0,0
TIKI,thoi-trang-nam,84429549,"Áo khoác dù 1 sọc ,áo khoù dù , áo khoác gió , áo khoác nam nữ mặc vài dù  có nón trùm đầu 2 lớp chống nắng chống lạnh tốt",103000,103000,0,0
TIKI,thoi-trang-nam,83517309,"ÁO THUN NAM DÀI TAY NỈ DA CÁ PHỐI MÀU",297700,297700,0,0
TIKI,thoi-trang-nam,162714466,"Áo Sơ Mi Nam Công Sở Trung Niên Ngắn Tay Vải Cotton Họa Tiết Chấm Bi Nhỏ Màu Trắng Anton - X808",225000,328000,103000,31
TIKI,thoi-trang-nam,108255317," Áo sơ mi nam Novelty ngắn tay 170302N vạt ngang",439000,439000,0,0
TIKI,thoi-trang-nam,109847419,"Áo Hoodie Nỉ Ngoại Unisex Nam Nữ Angel Form Rộng Thoải Mái",100000,100000,0,0
TIKI,thoi-trang-nam,29939062,"Áo sơ mi nam cổ trụ chui đầu dài tay",159000,159000,0,0
TIKI,thoi-trang-nam,162838969,"Áo Sơ Mi Nam Xanh Dương Ngắn Tay Thương Hiệu Anton Công Sở Trung Niên Vải Sợi Tre Họa Tiết In YGD561",265000,325000,60000,18
TIKI,thoi-trang-nam,55353337,"Áo thun nam nữ form rộng tay lỡ Unisex Hinerets dưới 69kg",89000,89000,0,0
TIKI,thoi-trang-nam,90078846,"Sét đồ bộ nam in hình Naruto siêu đẹp, Set Đồ Thể Thao Áo Thun Tay Ngắn In Hình uzumaki Thời Trang, Nguyên bộ quần áo nam Uzumaki cực hot, bộ mặc nhà, quần áo thể thao nam, đồ bộ thể thao mặc nhà nam, BỘ QUẦN ÁO THỂ THAO MẶC NHÀ, THỜI TRANG NAM NỮ, BỘ ĐỒ ",99000,99000,0,0
TIKI,thoi-trang-nam,141657282,"Áo khoác măng tô nam cổ đức trẻ trung công sở NMT54",1030000,1030000,0,0
TIKI,thoi-trang-nam,174593731,"Quần Short NamThể Thao Thanh Lịch US ARMY 8898 Trẻ Trung, Năng Động, Nam Tính -HÀNG CHÍNH HÃNG",140000,300000,160000,53
TIKI,thoi-trang-nam,163902369,"Áo Sơ Mi Nam Xanh Dương Kẻ Caro Ngắn Tay Công Sở Trung Niên Thương Hiệu Anton Vải Sợi Tre - YGD566",265000,355000,90000,25
TIKI,thoi-trang-nam,114415789,"(Video Ảnh Thật ) Áo hoodie THIS'S FACLY áo khoác nỉ form rộng Unisex Nam Nữ Couple đều được, Áo Hoodie tay phồng chất nỉ bông cực mịn chữ nhật - Form rộng Unisex Nam Nữ Couple đều mặc được",103000,103000,0,0
TIKI,thoi-trang-nam,166132556,"Áo đoàn viên, đồng phục thanh niên Việt Nam, thêu cờ đỏ sao vàng, tay dài và tay ngắn, có 2 túi có nắp và cầu vai",126000,194000,68000,35
TIKI,thoi-trang-nam,20737439,"Áo khoác gió cách nhiệt GOKING, có mũ dấu sau cổ. Form unisex cho nam nữ. Ngoài vải dù, trong lót vải cào cao cấp. Chống nắng gió bụi",255000,255000,0,0
TIKI,thoi-trang-nam,87010975,"Áo Thun Nam Ngắn Tay Chandi, Chất Thun Cotton Xịn Mẫu Mới NT17",129000,199000,70000,35
TIKI,thoi-trang-nam,101655941,"Áo Măng Tô Nam Dáng Dài - Áo Khoác Dạ Nam Dài Sans13 Sans Shop San Shop",499000,499000,0,0
TIKI,thoi-trang-nam,163545116,"Áo Phông Nam PoLo Ngắn Tay 8 Màu Thời Trang AVIANO",129000,258000,129000,50
TIKI,thoi-trang-nam,140464696,"Áo Sơ Mi Nam Dài Tay Họa Tiết Caro Màu Xanh Lá Mẫu Không lên lai Thời Trang PONIVA Chất Vải Mềm Mại Thấm Hút Mồ Hôi",97500,97500,0,0
TIKI,thoi-trang-nam,111710567,"Áo Thun Nam Áo Thun Nam Cổ Polo phối hai sọc thẳng trắng Thiết kế trẻ trung, năng động và lịch lãm",125000,125000,0,0
TIKI,thoi-trang-nam,84903806,"QUẦN LÓT BOXER NAM ROSSO 0001 - UNDERWEAR",120000,120000,0,0
TIKI,thoi-trang-nam,46698977,"Quần jogger nam phối dây kéo Phúc An 1068 màu",129000,129000,0,0
TIKI,thoi-trang-nam,137666840,"Áo Khoác Nhung Gân Tăm Bomber Jackets Thêu Logo G.O.N.Z Cúc Bấm Unisex Nam Nữ Form Rộng Ulzzang",152000,152000,0,0
TIKI,thoi-trang-nam,58613402,"QUẦN LÓT NAM ROSSO",79000,79000,0,0
TIKI,thoi-trang-nam,181787243,"Áo thun lót trắng nam cổ tim 100% cotton loại 1",55000,55000,0,0
TIKI,thoi-trang-nam,11270937,"Áo thun nam dài tay cổ sơ mi SITAKI - ATD01",130000,130000,0,0
TIKI,thoi-trang-nam,118020324,"Đồ Lam Đi Chùa # Xéo Nhật Viền Nam # Đồ Bộ Nam # Quần Áo Nam",210000,210000,0,0
TIKI,thoi-trang-nam,170498978,"Bộ Quần Áo Thể Thao Nam Cao Cấp Nhiều Màu Thời Trang Thiết Kế AVIANO",269000,458000,189000,41
TIKI,thoi-trang-nam,78510529,"Quần Sọt Jean nam co dãn 4 chiều Thương Hiệu Chandi, phong cách hàn quốc mẫu mới nhất HD221",139000,220000,81000,37
TIKI,thoi-trang-nam,187892807,"Áo gile nam, áo gile nam túi hộp ARM-1215 màu kem",400000,400000,0,0
TIKI,thoi-trang-nam,163888596,"Sơ mi nam Ngắn tay công sở trung niên thương hiệu Anton vải bamboo xanh lục thoáng mát, thấm hút mồ hôi - NT204",295000,395000,100000,25
TIKI,thoi-trang-nam,58838015,"Quần bơi nam vảy da cá thể thao chuyên nghiệp YOUYOU",130000,130000,0,0
TIKI,thoi-trang-nam,19701519,"Áo sơ mi nam tay dài SMH102",104000,104000,0,0
TIKI,thoi-trang-nam,4343771,"Áo Khoác Nam Có Big Size (Over size)",160000,160000,0,0
TIKI,thoi-trang-nam,162844085,"Áo Sơ Mi Nam Công Sở Trung Niên thương hiệu Anton Ngắn Tay màu Xanh Tím Than Vải Cotton Họa Tiết Hoa Nhí – X809",225000,325000,100000,31
TIKI,thoi-trang-nam,94776254,"Áo khoác dù nam nữ unisex kiểu sơmi form rộng, 2 lớp dày dặn (Lestreet)",97000,97000,0,0
TIKI,thoi-trang-nam,95056670,"Áo khoác dù 7Zia - Trắng/Đen, ÁO 7ZIA Windbreaker Jacket, ÁO KHOÁC DÙ BOMBER NAM NỮ",99000,99000,0,0
TIKI,thoi-trang-nam,74151584,"Quần tây nam Amazing màu đen và xanh đen, size 28 đến 40, form công sở truyền thống, không ly, ống suông",348000,528000,180000,34
TIKI,thoi-trang-nam,125777598,"Quần bơi lửng 30-110kg",75000,75000,0,0
TIKI,thoi-trang-nam,90483743," Áo thun nam ngắn tay cổ tim cotton thoáng mát FREEMAN TSF315",99000,99000,0,0
TIKI,thoi-trang-nam,163904210,"Áo Sơ Mi Nam Ngắn Tay Anton Công Sở Trung Niên Vải Cotton Màu Xanh Dương Kẻ Trắng – XGD553",265000,355000,90000,25
TIKI,thoi-trang-nam,186523086,"Quần Jogger Nam thể thao túi hộp thương hiệu Chandi, chất kaki dày dặn bo chân xu hướng mới nhất hiện nay CT2",220000,220000,0,0
TIKI,thoi-trang-nam,120171921,"SET 2 Quần lót nam dáng trunk MAY 10 (giao màu ngẫu nhiên)",249000,249000,0,0
TIKI,thoi-trang-nam,155705074,"Viettien - Quần jeans nam smart casual 6Q7127-7123",720000,720000,0,0
TIKI,thoi-trang-nam,87012003,"Áo Thun Nam Ngắn Tay Chandi, Chất Thun Cotton Xịn Mẫu Mới NT20",220000,220000,0,0
TIKI,thoi-trang-nam,36194934,"áo thun polo nam tay lỡ chính hãng dokafashion dáng thể thao nam cao cấp được thuê logo sắc xảo  sắc tông màu cơ bản -combo 3 áo xám trắng đen - DBM307",364000,488000,124000,25
TIKI,thoi-trang-nam,185599995,"Bộ 3 Quần Lót Nam Dạng Trunk Giordano Men's Trunk 01179013",216000,590000,374000,63
TIKI,thoi-trang-nam,167473781,"Áo Polo Nam Nanh Sói 3 Màu Phong Cách Thời Trang Thiết Kế AVIANO",129000,258000,129000,50
TIKI,thoi-trang-nam,141660170,"Áo vest dạ nam trẻ trung cao cấp NAD70",1480000,1480000,0,0
TIKI,thoi-trang-nam,163034644,"Áo Sơ Mi Nam Công Sở Trung Niên Ngắn Tay Anton Màu Xanh Than Thoáng Mát, Thấm Hút Mồ Hôi - NC130",295000,405000,110000,27
TIKI,thoi-trang-nam,79369713,"Quần Lót Nam, Quần Sịp Nam Cao Cấp - Chất Liệu Mềm Mịn Thoáng Mát - Thiết Kế Cạp Liền - Thương Hiệu Brave Person B1151",159000,260000,101000,39
TIKI,thoi-trang-nam,109249941,"Đồ bộ nam quần áo thể thao in chữ futuar (45-70kg) MÙA HÈ chất thun lanh mặc mát /Đồ Bộ Thể Thao Nam/Set Bộ Quần Áo Thể Thao Nam/đồ bộ mặc nhà/đồ bộ đẹp, ĐỒ BỘ MẶC NHÀ FUTUAR NAM NỮ, QUẦN ÁO THỂ THAO THUN MÙA HÈ NHẸ MÁT",99000,99000,0,0
TIKI,thoi-trang-nam,151800968,"QUẦN LÓT NAM - LỌT KHE SEXY - THUN COTTON",49000,49000,0,0
TIKI,thoi-trang-nam,160357923,"Quần lót nam relax dệt kim cao cấp chính hãng ,quần sịp nam relaxunderwear rltk13",94000,94000,0,0
TIKI,thoi-trang-nam,100148987," <FREE SHIP> Đồ bộ nam nữ chữ A chất vải thun lạnh in chuyển nhiệt co giãn 4 chiều",105000,105000,0,0
TIKI,thoi-trang-nam,38496061,"Combo 7 Quần lót nam tam giác cotton xịn nhiều lưng có size lớn màu ngẫu nhiên cao cấp mặc cực thoãi mái underwear SỊP HN7",68700,135000,66300,49
TIKI,thoi-trang-nam,110429809,"Quần đùi nam Cotton mặc nhà thoải mái thoáng mát JAMANO- 1 Chiếc MÀU NGẪU NHIÊN",55000,70000,15000,21
TIKI,thoi-trang-nam,110696030,"Quần Baggy Kaki Nam Trơn ống côn unisex phối đồ thoải mái",85000,85000,0,0
TIKI,thoi-trang-nam,84823077,"Quần Sịp Pump Cotton Kiểu Dáng Thể Thao Mới K222",65000,65000,0,0
TIKI,thoi-trang-nam,71168734,"Áo thun nam ngắn tay cổ tim body thời trang SITAKI cao cấp ATN06",80000,80000,0,0
TIKI,thoi-trang-nam,81715297,"Quần Short Kaki Nam Túi Hộp",150000,150000,0,0
TIKI,thoi-trang-nam,193233136,"Áo Khoác Dù Nam Chống Nắng Giordano UPF 50+ Chất Mỏng Nhẹ Có Thể Gấp Gọn Windbreaker 01072011",799000,940000,141000,15
TIKI,thoi-trang-nam,30030428,"Quần Khaki Nam Không Ply Ống Ôm Khatoco Q2M528S0-VNMA001-1907-006",189000,528000,339000,64
TIKI,thoi-trang-nam,52251333,"Áo Thun Nam Cổ Bẻ Doka 4 Chiều Cao Cấp, Trẻ Trung ( 8 Màu)",99000,198000,99000,50
TIKI,thoi-trang-nam,87896252,"Đồ bơi cao cấp cho Nam giới, áo bơi dài tay & cộc tay cùng quần sooc đùi dài mạnh mẽ, chất thun bơi lạnh dày đẹp | BN012",320000,320000,0,0
TIKI,thoi-trang-nam,105605705,"Quần kaki nam lưng thun, quần nam có BIG SIZE đến gần 100kg, NHIỀU MÀU - NH Shop",85000,85000,0,0
TIKI,thoi-trang-nam,168957775,"Đồ Bơi Nam Và Nữ Couple Tay Dài Che Nắng Kiểu Korea ATI81 MayHomes Chuẩn UPF 50+, Long-Sleeve Rash Guard Swimsuit",280250,295000,14750,5
TIKI,thoi-trang-nam,168872132,"Đồ Bơi Nam Nữ Đồ Tắm Couple Mùa Hè ATI80 MayHomes Tay Dài Chống Nắng UPF 50+, Long-Sleeve Rash Guard Swimsuit",274550,289000,14450,5
TIKI,thoi-trang-nam,174842957,"Áo Khoác Varsity Local Brand Bomber Chữ A thêu cả Áo phù hợp cho cả Nam và Nữ, Áo khoác bomber jacket nam nữ phối Nâu Boin shop thêu nỉ 2 lớp, chất nỉ bông siêu đẹp",123000,123000,0,0
TIKI,thoi-trang-nam,76122566,"Quần Jean Nam co dãn 4 chiều thương hiệu Julido Store, mẫu mới QJ608",169000,279000,110000,39
TIKI,thoi-trang-nam,194284327,"Quần Jean nam Leman xanh wash bụi JD11 - Slim Form",549000,549000,0,0
TIKI,thoi-trang-nam,96594332,"Áo Khoác Big Size Unisex Áo Khoác Dù Nam Chống Nước Nhẹ Chống Nóng Chống Lạnh Chống Gió Chống Tia UV Có Nón Thời Trang Nam Tính Hàn Quốc Cao Cấp AD75 - ShopN6",199000,210000,11000,5
TIKI,thoi-trang-nam,189595382,"Quần lót nam Under Armour TECH 6IN 2 - 1363619-600",907000,1295000,388000,30
TIKI,thoi-trang-nam,84558587,"Áo nỉ hoodie nam nữ in hình độc lạ form rộng hàn quốc dưới 70kg, chất nỉ mềm mịn, Áo nỉ hoodie nam nữ form rộng,Aó hoodie nam , áo hoodie nữ , áo khoác áo hoodie cặp đôi nam nữ mặc",100000,100000,0,0
TIKI,thoi-trang-nam,197603286,"Áo Khoác Da Nam, Áo Khoác Da Lót Lông Siêu Ấm Mùa Thu Đông Phối Khóa Đồng Cao Cấp Thời Trang DokaFashion ELD14",499000,499000,0,0
TIKI,thoi-trang-nam,28621391,"Áo sơ mi nam dài tay  màu vàng nhạt",159000,159000,0,0
TIKI,thoi-trang-nam,124765809,"Áo khoác nam nữ chất liệu gió cao cấp 2 lớp dày dặn, bên trong lót lưới, áo khoác dù chống nước",167000,180000,13000,7
TIKI,thoi-trang-nam,69611736,"Áo khoác da nam lót lông SITAKI thời trang cao cấp AD28",299000,299000,0,0
TIKI,thoi-trang-nam,116024135,"Áo sơ mi nam tay dài ADINO màu xanh nhạt dáng slimfit vải modal trẻ trung S304",279000,350000,71000,20
TIKI,thoi-trang-nam,162617092,"Áo Sơ Mi Nam Công Sở Trung Niên Dài Tay Trắng Vải Cotton Họa Tiết Chấm Bi Nhỏ Thương Hiệu Anton - X302",225000,295000,70000,24
TIKI,thoi-trang-nam,178006534,"Đồ Bơi Cặp Nam Nữ Tay Dài Chống Nắng AT225 MayHomes Thun Lạnh Co Giãn Tốt UPF 50+, Long-Sleeve Rash Guard Swimsuit",312550,329000,16450,5
TIKI,thoi-trang-nam,53721207,"Áo sơ mi caro nam tay dài kẻ sọc vải Oxford cao cấp trắng phù hợp công sở Nexx & Dee 02",229000,229000,0,0
TIKI,thoi-trang-nam,3715005,"Combo 3 Quần Lót Boxer Nam Freeman 6517-CB3 (Size",237000,237000,0,0
TIKI,thoi-trang-nam,107153975,"Quần lót nam kiểu dáng sexy họa tiết hình con voi",35000,35000,0,0
TIKI,thoi-trang-nam,116273173,"Quần Bơi Nam Tam Giác Thời Trang Desmiit S324 - Thiết Kế Thời Trang Hợp Xu Hướng - Màu Sắc Kết Hợp Cực Cá Tính, Đa Dạng Cho Bạn Lựa Chọn",229000,400000,171000,43
TIKI,thoi-trang-nam,195866795,"Áo khoác gió đôi nam nữ cao cấp unisex chống nước, chống gió, chống bụi, chống nắng ngăn tia UV AG01 - PROMAN",199000,199000,0,0
TIKI,thoi-trang-nam,106764912,"Quần Lót Nam Boxer Xuyên Thấu Thông Hơi Lưng Nhật Thoáng Mát, Quần Sịp Đùi Thông Hơi Cao cấp",40000,40000,0,0
TIKI,thoi-trang-nam,105342665,"Áo Thun Nam Polo Có Cổ Tay Ngắn Mùa Hè Thời Trang VICERO",189000,300000,111000,37
TIKI,thoi-trang-nam,154785711,"Áo khoác nhung bomber NAM CỰC CHẤT",157000,157000,0,0
TIKI,thoi-trang-nam,111710381,"Áo Thun Nam Áo Thun Nam Có Cổ Phối Boa Tay Mẫu TR01 Chất Vải Đẹp Chuẩn Form",125000,125000,0,0
TIKI,thoi-trang-nam,101582147,"Áo KHOÁC DÙ 2 LỚP unisex form rộng cặp đôi ulzzang Hàn Quốc dành cho nam nữ, Áo khoác dù 2 lớp màu đen, có nón Glean local brand ONTOP JACKET cho nam nữ cho cặp đôi,Áo khoác dù unisex Glean Mark 2 local brand ONTOP",99000,99000,0,0
TIKI,thoi-trang-nam,196586343,"Quần tây nam 1ply Novelty màu nâu NQTMMDMPRR1600181",199000,199000,0,0
TIKI,thoi-trang-nam,183731008,"Áo sơ mi nam, Áo sơ mi Nam dài tay cổ Đức, Thêu viền tay - cổ áo sang trọng lịch sự N10",199000,199000,0,0
TIKI,thoi-trang-nam,72747421,"Áo hoodie, áo sweater trơn nam nữ",99000,99000,0,0
TIKI,thoi-trang-nam,106700356,"Quần Jean Nam Vovesa Mẫu Mới, Dáng Ôm Trẻ Trung, Nam Tính Q4",115000,115000,0,0
TIKI,thoi-trang-nam,162248191,"OWEN - Áo sơ mi dài tay OWEN SLIMFIT cổ tàu chất cafe 22731",598000,598000,0,0
TIKI,thoi-trang-nam,182710825,"áo khoác kaki nam lót dù caro trơn thấm hút tốt phong cách trẻ 2022",189000,189000,0,0
TIKI,thoi-trang-nam,104728743,"Quần baggy kaki nam, Quần chinos kaki nam ống suông lưng thun",85000,85000,0,0
TIKI,thoi-trang-nam,117170151,"Áo Khoác Bomber Nỉ Dày Dặn 199x Unisex (ẢNH THẬT)",95000,95000,0,0
TIKI,thoi-trang-nam,58660993,"Quần short jean nam co dãn kiểu dán trẻ trung đơn giản thêu họa tiết Julido thời trang hàn quốc THU12",139000,220000,81000,37
TIKI,thoi-trang-nam,4401897,"Quần Dài Jogger Nam form rộng 1060",95000,95000,0,0
TIKI,thoi-trang-nam,95522395,"Quần lót nam boxer thun lạnh, sịp đùi nam lưới thoáng mát, quần lót nam thun lạnh cạp nhỏ thiết kế đơn giản QLW0601",89000,89000,0,0
TIKI,thoi-trang-nam,95053555,"Áo Khoác Big Size Bomber Nam Nữ Áo Khoác Kaki Nam Nữ Chống Nắng Chống Lạnh Chống Gió Chống Nóng Tia UV 2 lớp Thời Trang FS Hàn Quốc Nam Tính Giá Tốt Cao Cấp QK46 - ShopN6",189000,240000,51000,21
TIKI,thoi-trang-nam,181992090,"Viettien - Quần tây nam màu đen form regular fit không ly giá 650",650000,650000,0,0
TIKI,thoi-trang-nam,151802223,"QUẦN LÓT NAM - Dạng Dây Nâng Mông - JOCKSTRAP",49000,49000,0,0
TIKI,thoi-trang-nam,74823287,"Quần short kaki nam Amazing, lưng thun có giây rút, vải co giãn, màu sắc đa dạng, có big size",129000,198000,69000,35
TIKI,thoi-trang-nam,195961172,"Quần lót nam Freeman chất liệu cotton TC kiểu dáng trẻ trung BO303",49000,49000,0,0
TIKI,thoi-trang-nam,179162754,"(Big size <130kg) Áo sơ mi nam cổ trụ tay ngắn big size",235000,235000,0,0
TIKI,thoi-trang-nam,176292749,"Bộ quần áo Mặc Nhà Thể Thao Nam Mùa Hè Phong Cách Cao Cấp IN CÚ MÈO, Bộ Đồ Ngủ Áo Tay Ngắn Phối Quần short Vải cotton In Hoạt Hình Thời Trang Mùa Hè",102000,102000,0,0
TIKI,thoi-trang-nam,90722180,"Quần short đũi nam dáng ngắn mặc hè Đũi Việt DV06",149000,149000,0,0
TIKI,thoi-trang-nam,89466346,"Quần Kaki Baggy Nam Nữ Ống Suông mã Q002",95000,95000,0,0
TIKI,thoi-trang-nam,197529327,"Áo hoodie nam nữ PEPPER samseyo, Áo hoodie form rộng phong cách Unisex, Áo khoác hoodie nam nữ Pepper Tutudesign, Áo sweater nỉ form rộng chất cực đẹp",100000,100000,0,0
TIKI,thoi-trang-nam,119064764,"Áo polo nam màu xanh bích đậm phối viền chìm ADINO vải cotton polyester mềm dáng slimfit công sở trẻ trung năng động AP83",159000,318000,159000,50
TIKI,thoi-trang-nam,179163330,"ÁO SƠ MI ĐEN TRƠN TAY NGẮN BIG SIZE NAM TỚI 130KG",185000,185000,0,0
TIKI,thoi-trang-nam,3603023,"Combo 5 Quần Lót Nam Freeman chất liệu thun lạnh 6042",375000,375000,0,0
TIKI,thoi-trang-nam,185592566,"Bộ 6 Quần Lót Nam Dạng Tam Giác Giordano Cotton Briefs 01177014",365000,595000,230000,39
TIKI,thoi-trang-nam,74280103,"Quần jean nam xanh bạc Julido Store, chất jean co dãn 4 chiều tôn dáng nam tính BC5678 - 30",169000,279000,110000,39
TIKI,thoi-trang-nam,54762474,"Quần kaki nam 1 ply Khatoco Q2M528R1-INMA004-2106-1",189000,528000,339000,64
TIKI,thoi-trang-nam,48579478,"Áo Hoodie Nỉ Cotton Đen Trơn Đủ Size S M L XL Cao Cấp",99000,99000,0,0
TIKI,thoi-trang-nam,122762684,"Áo Hoodie nam - Chất liệu nỉ da cá mềm mịn , kiểu dáng trẻ trung, năng động, mặc là đẹp",97000,97000,0,0
TIKI,thoi-trang-nam,78488223,"Quần Bò Nam cao cấp thương hiệu Chandi,  chất jean co dãn mẫu mới mã HD54",169000,299000,130000,43
TIKI,thoi-trang-nam,54717637,"Áo Polo nam cổ bẻ ngắn tay, chất liệu vải cá sấu cotton cao cấp, trẻ trung, năng động – FORMEN SHOP – FMPS110",109000,210000,101000,48
TIKI,thoi-trang-nam,52198702,"Combo 4 Quần Lót Nam Quần Sịp Nam Sợi Cotton Cao Cấp MRM FASHION Mix 3 Màu TẶNG Đôi Tất Nam Cao Cấp",239000,340000,101000,30
TIKI,thoi-trang-nam,185943431,"Bộ Quần Áo Thun Nam Nữ Unisex Mùa Hè Ngắn Tay Cổ Tròn Phối Quần Đùi Họa Tiết Thời Trang, Set đồ bộ nam chất thun cotton co giản thoáng mát, thời trang đồ bộ thể thao nam, Set Bộ Quần Áo Thể Thao Nam Mùa hè Co Dãn",99000,99000,0,0
TIKI,thoi-trang-nam,192218094,"Áo thun nam dài tay cổ tròn mặc thu đông, giữ nhiệt, chất cotton co giãn, dáng ôm thời trang",109000,129000,20000,16
TIKI,thoi-trang-nam,114194298,"Quần dài thể thao nam Jogger 3 sọc ống xuông trẻ trung năng động Micado",59000,110000,51000,46
TIKI,thoi-trang-nam,57829428,"Áo Khoác Kaki Nam Hai Lớp Cổ Trụ Giả Vest Cao Cấp KK43 - ShopN6 (Nhiều Màu)",179000,245000,66000,27
TIKI,thoi-trang-nam,194033988,"Áo thun nam đũi Sans312 chất cotton mát cộc tay cài nút cổ v trơn đẹp xịn mềm mịn big size 5XL 4XL 3XL 2XL XL L M",119000,119000,0,0
TIKI,thoi-trang-nam,67262849,"ÁO THUN NAM DÀI TAY ĐẸP",84000,84000,0,0
TIKI,thoi-trang-nam,91281487,"BỘ ĐỒ BỘ NAM THỂ THAO THUN 4 CHIỀU CO GIÃN",100000,100000,0,0
TIKI,thoi-trang-nam,81694400,"Quần Jean Nam đẹp dẫn đầu xu hướng Thương Hiệu Chandi , mẫu mới form đẹp tôn dáng không quá ôm MR9043",169000,299000,130000,43
TIKI,thoi-trang-nam,93206831,"Áo Khoác Nam Big Size Áo Khoác Kaki Nam Chống Nắng Chống Gió Chống Lạnh Chống Nóng Có Cổ Dày Hai Lớp Đồ Phượt Hàn Quốc Cao Cấp KK51 - ShopN6",189000,235000,46000,20
TIKI,thoi-trang-nam,67638732,"Áo Sơ Mi Nam Dài Tay Caro TS333 Thiết Kế Trẻ Trung Năng Động",96000,96000,0,0
TIKI,thoi-trang-nam,153471940,"Áo khoác Hoodie Chất Liệu Nỉ Bông - Áo Hoodie Hot Trend 2021 Kiểu Dáng unisex",110000,110000,0,0
TIKI,thoi-trang-nam,125801495,"Áo sơ mi học sinh nam cấp 2 - 3 Viettien",186000,186000,0,0
TIKI,thoi-trang-nam,72522476,"Combo 4 quần lót nam boxer thun cotton, sịp đùi nam đơn giản màu trơn, kiểu dáng boxer nam tính kết hợp thiết kế đơn giản trẻ trung",126000,180000,54000,30
TIKI,thoi-trang-nam,83161336,"Áo Thun Nam Cổ Bẻ Viền Tay Thời Trang Poniva",157000,157000,0,0
TIKI,thoi-trang-nam,193461827,"Áo gile túi hộp, áo gile lính, áo gile nam",350000,350000,0,0
TIKI,thoi-trang-nam,187946161,"Áo gile lính, áo gile phóng viên, áo gile túi hộp",450000,450000,0,0
TIKI,thoi-trang-nam,190154762,"Viettien - Quần tây nam màu xanh đen không ly regular fit 650k quần âu việt tiến phom vừa không ôm không rộng",650000,650000,0,0
TIKI,thoi-trang-nam,78945633,"Quần Lót Nam Tam Giác Chất Liệu Mềm Mại Thoáng Mát, Co Dãn 4 Chiều Thương Hiệu Brave Person B1129",169000,240000,71000,30
TIKI,thoi-trang-nam,95059457," Áo thun sát nách unisex tanktop form rộng GEE nam nữ ulzzang Wind",89000,89000,0,0
TIKI,thoi-trang-nam,184914221,"Quần Short khaki nam Novelty in họa tiết NSKMINNCSR1620190",265000,285000,20000,7
TIKI,thoi-trang-nam,90483829,"Combo 2 Áo lót nam cổ tim tay ngắn FREEMAN TSF311",258000,258000,0,0
TIKI,thoi-trang-nam,7402949,"Hộp 4 Quần Sịp Đùi Nam Thông Hơi Tặng 01 Tất Cổ Ngắn (Giao màu ngẫu nhiên)",68998,68998,0,0
TIKI,thoi-trang-nam,197536590,"Áo Sơ mi nam ngắn tay NOVELTY họa tiết cổ danton NSMMINMSPB200118N",159000,159000,0,0
TIKI,thoi-trang-nam,85490518,"Áo sơ mi nam dài tay form rộng kẻ sọc caro cổ bẻ phong cách Hàn Quốc – FORMEN SHOP – FMTTB013",110000,219000,109000,50
TIKI,thoi-trang-nam,24004714,"Áo sơ nam việt tiến dài tay",440000,440000,0,0
TIKI,thoi-trang-nam,71095904,"Áo thun nam tay lỡ TUTO5 phông ngắn tay SUMMER ALONE BOY Regular fit form rộng cotton 2 chiều cao cấp phong cách trẻ trung ATI01",299000,299000,0,0
TIKI,thoi-trang-nam,163581206,"Áo sơ mi nam dài tay công sở trung niên thương hiệu Anton sợi tre họa tiết màu ghi - 8551",265000,325000,60000,18
TIKI,thoi-trang-nam,48591617,"Quần Jean Nam Dài Phong Cách QJ016",115000,115000,0,0
TIKI,thoi-trang-nam,75929061,"Áo sweater thời trang nam nữ phong cách Basic in hoạt hình Kaws dễ thương - FORMENSHOP - FMGV036",89000,169000,80000,47
TIKI,thoi-trang-nam,153824693,"Quần sọt kaki nam size đại, lưng bo, short form rộng, lai lật phối sọc, bigsize, hiệu Amazing",136000,209000,73000,35
TIKI,thoi-trang-nam,95059515," Áo thu sát nách unisex form rộng 1975 nam nữ ulzzang Wind",88000,88000,0,0
TIKI,thoi-trang-nam,161541055,"quần lót nam relax cotton cao cấp chính hãng, quần sịp nam relax underwear rltk53",92000,92000,0,0
TIKI,thoi-trang-nam,132136528,"Áo thun gia đình là số 1 set đồ đồng phục gia đình hội nhóm độc đáo thun cotton dày dặn màu trắng GD338T | SG",25000,25000,0,0
TIKI,thoi-trang-nam,32988061,"Hộp Combo 5 Sịp Đùi Loại Đẹp",199000,199000,0,0
TIKI,thoi-trang-nam,6187707,"Bộ 5 quần sịp đùi xuất Nhật chất lụa cao cấp",74098,74098,0,0
TIKI,thoi-trang-nam,177275239,"Áo sơ mi form rộng nam nữ tay dài unisex phong cách hàn quốc trẻ trung vải lụa mềm mịn mát - MRD02",98000,190000,92000,48
TIKI,thoi-trang-nam,117073612,"ÁO POLO VULCANO 1018",495000,495000,0,0
TIKI,thoi-trang-nam,51638534,"Áo Sơ Mi Nam Trơn Ngắn Tay Form Chuẩn",138000,138000,0,0
TIKI,thoi-trang-nam,190231380,"Áo phóng viên - áo gile lính cao cấp ARM-1114 (Đen)",700000,700000,0,0
TIKI,thoi-trang-nam,89560797,"Quần Áo Thể Thao, Bộ quần áo thể thao nam nữ in Hold Right, Bộ Đồ Thể Thao Nam Chất Đẹp, Đồ bộ thể thao nam, set quần áo thể thao nam nữ mặc nhà Unisex tay ngắn phong cách Ulzzang, Set Bộ Quần Áo Thể Thao Nam Mùa hè Co Dãn, SÉT ĐỒ BỘ THỂ THAO MẶC NHÀ - Đe",99000,99000,0,0
TIKI,thoi-trang-nam,196297504,"Áo thun cổ tròn tay ngắn thời trang nam, chất cotton 100%, thấm mồ hôi cực tốt, thun co giãn 4 chiều - FORMEN SHOP - FMPS194",179000,350000,171000,49
TIKI,thoi-trang-nam,5862059,"Combo 5 Quần Sịp Đùi Nam Thông Hơi Nhật Bản - MS88 - Hộp MJ 5 cái nhiều màu",78000,78000,0,0
TIKI,thoi-trang-nam,184072326,"Áo Gile nam, Áo Gile phối dây đai 2 bên Ngực cách điệu, lịch lãm, trẻ trung, phong cách. Mã N41",269000,269000,0,0
TIKI,thoi-trang-nam,87011090,"Áo Thun Nam Ngắn Tay Chandi, Chất Thun Cotton Xịn Mẫu Mới NT18",199000,199000,0,0
TIKI,thoi-trang-nam,177055613,"Áo sơ mi rộng cổ vest nam nữ unisex tay dài phong cách hàn quốc trẻ trung vải lụa mềm mát-VRD01",87000,190000,103000,54
TIKI,thoi-trang-nam,192683632,"ÁO SƠ MI TAY NGẮN-V46-014619-GY5",2781000,2990000,209000,7
TIKI,thoi-trang-nam,160291044,"OWEN - Áo sơ mi dài tay Owen Slimfit chất sợi tre màu trắng in hình 23371",588000,588000,0,0
TIKI,thoi-trang-nam,189643225,"Áo sơ mi nam dài tay trắng Regular fit NSMMMWMTCR220000D",199000,319000,120000,38
TIKI,thoi-trang-nam,161494286,"quần lót nam relax underwear thun lạnh cao cấp chính hãng, quần sip nam rltk16",81000,81000,0,0
TIKI,thoi-trang-nam,71659029,"Áo Khoác Nam Nữ form cực rộng, Áo cặp hoodie nam nữ từ 46kg đến 68kg",96900,96900,0,0
TIKI,thoi-trang-nam,149684151,"ÁO KHOÁC DÙ CAO CỔ NAM NỮ TMS MIDSIDE",95000,95000,0,0
TIKI,thoi-trang-nam,62745390,"Quần jean nam chất jean xịn Julido, Phối rách mẫu mới form đẹp tôn dáng không quá ôm mẫu MM01",169000,299000,130000,43
TIKI,thoi-trang-nam,84866436,"Quần Lót Nam Lọt Khe Siêu Gợi Cảm Boxers Brave Person B1181",140000,200000,60000,30
TIKI,thoi-trang-nam,21436280,"Áo dơ mi việt tiến",410000,410000,0,0
TIKI,thoi-trang-nam,93233783,"Áo Khoác Big Size Nam Nữ Unisex Áo Khoác Dù Nam 2 Lớp Chống Nắng Chống Lạnh Chống Gió Thời Trang Phom Body Phối Màu Hàn Quốc Cao Cấp AD73 - ShopN6",149000,180000,31000,17
TIKI,thoi-trang-nam,179163908,"(Big size <130kg) quần tây nam form slim fit big size đủ màu",330000,330000,0,0
TIKI,thoi-trang-nam,195949063,"Quần âu nam hàn quốc màu đen ADINO vải cotton không bai không xù co giãn dáng công sở slimfit ống đứng hơi côn QA140",249000,380000,131000,34
TIKI,thoi-trang-nam,74493882,"Áo thun unisex tay lỡ form rộng - phông thêu 4 logo",79000,125000,46000,37
TIKI,thoi-trang-nam,179161511,"SƠ MI BBR TAY NGẮN BIG SIZE NAM TỚI 130KG ĐỦ MÀU",255000,255000,0,0
TIKI,thoi-trang-nam,193762563,"Viettien - Quần tây nam màu xám sáng 1R4034 - 1R4035 - 1R4036 loại có ly và không ly - Quần âu cao cấp Việt Tiến",710000,710000,0,0
TIKI,thoi-trang-nam,163902635,"Áo Sơ Mi Nam Xanh Dương Kẻ Caro Ngắn Tay Công Sở Trung Niên Thương Hiệu Anton Vải Sợi Tre - GD566",265000,355000,90000,25
TIKI,thoi-trang-nam,189980959,"Viettien - Quần tây nam màu xám đậm không ly 1R4157 regular fit quần âu việt tiến phom vừa không ôm không rộng",650000,650000,0,0
TIKI,thoi-trang-nam,163497845,"Áo sơ mi nam dài tay công sở trung niên thương hiệu Anton vải sợi tre kẻ caro màu xanh dương – 8553",265000,355000,90000,25
TIKI,thoi-trang-nam,112969165,"COMBO 4 QUẦN LÓT BOXER NAM ROSSO 0002 - UNDERWEAR MÀU NGẪU NHIÊN",480000,480000,0,0
TIKI,thoi-trang-nam,151799597,"QUẦN LÓT NAM - Tam Giác Bikini Bản Nhỏ Gọn - Thun Lạnh Sọc Siêu Mát",39000,39000,0,0
TIKI,thoi-trang-nam,14973295,"Áo khoác lính US ARMY",464000,499000,35000,7
TIKI,thoi-trang-nam,25097546,"ÁO KHOÁC DA NAM LÓT LÔNG - AD14 NÂU",299000,299000,0,0
TIKI,thoi-trang-nam,121626976,"Áo sơ mi nam dài tay có túi LADOS - 8024 chất OXFORD mịn mát form chuẩn dễ mặc",329000,329000,0,0
TIKI,thoi-trang-nam,134796301,"Quần Jogger Túi Hộp 4 Màu Thể Thao Năng Động Cao Cấp VICERO",179000,358000,179000,50
TIKI,thoi-trang-nam,197170201,"Áo Khoác Phối 2 Màu Nam Nữ Cao Cấp | Áo Khoác thể thao | áo khoác gió cổ cao unisex, Áo khoác gió học sinh kiểu Unisex cổ đứng vải dù 2 lớp phối màu độc lạ họa tiết chữ AGGSRMAN cản gió,chống nắng",95000,95000,0,0
TIKI,thoi-trang-nam,3714865,"Combo 3 Quần Lót Nam Freeman 6040-CB3 (Size",195000,195000,0,0
TIKI,thoi-trang-nam,117583489,"ÁO KHOÁC DÙ NAM ÁO KHOÁC NAM CHO MỌI THÒI ĐẠI",145000,145000,0,0
TIKI,thoi-trang-nam,3714719,"Combo 5 Quần Lót Nam Freeman 6017CB5-XL (Size",445000,445000,0,0
TIKI,thoi-trang-nam,102531428,"Quần âu nam Hiền Trần BOUTIQUE công sở chất vải chéo 79 cao cấp",278000,499000,221000,44
TIKI,thoi-trang-nam,179575330,"Áo thun Polo nam Novelty 210059 màu xanh đen",199000,289000,90000,31
TIKI,thoi-trang-nam,148845226,"Đồ bộ thể thao nam thun lạnh siêu mát",249000,249000,0,0
TIKI,thoi-trang-nam,127197643,"Bộ Quần Áo Nam Lính Mỹ US ARMY  Kiểu Dáng Túi Hộp, Chất Liệu Kaki Cao Cấp Phong Cách Lính Cực Ngầu (Tặng dây lưng) - HÀNG CHÍNH HÃNG",899000,1798000,899000,50
TIKI,thoi-trang-nam,75409629,"Áo Da Nam Cao Cấp Form Chuẩn",469000,469000,0,0
TIKI,thoi-trang-nam,15659073,"Quần Short Nam Jean TS305",123000,123000,0,0
TIKI,thoi-trang-nam,164083716,"Don't be afraid, show your true colours, mã G30. Áo thun LGBT cho người đồng tính",168000,168000,0,0
TIKI,thoi-trang-nam,30764036,"Quần lót boxer nam Khatoco Q5M085R0-VNMA011-2101-B",65000,85000,20000,24
TIKI,thoi-trang-nam,173535129,"Trang phục chú Cuội, bộ đồ dân gian truyền thống hóa trang chú Cuội",220000,220000,0,0
TIKI,thoi-trang-nam,22774900,"Áo Thun nam cá sấu mẫu mới - ĐB441 - Đỏ đô, Xanh Môn, Xanh Dương, Xanh Đen  - L",396000,659000,263000,40
TIKI,thoi-trang-nam,15777699,"Áo Sweater Nam bigsize SST14",86000,86000,0,0
TIKI,thoi-trang-nam,52198505,"Combo 4 Quần Lót Nam Quần Sịp Nam Sợi Cotton Cao Cấp MRM FASHION Mix 2 Màu TẶNG Đôi Tất Nam Cao Cấp",239000,340000,101000,30
TIKI,thoi-trang-nam,109516642,"QUẦN LÓT NAM VIỆT TIẾN",135000,135000,0,0
TIKI,thoi-trang-nam,47099868,"Quần Biển Nam",109000,109000,0,0
TIKI,thoi-trang-nam,53408141,"Áo thun nam cổ bẻ chính hãng DOKA dáng thể thao nam cao cấp được thêu logo sắc xảo tông màu cơ bản - Combo 3 áo",279000,509000,230000,45
TIKI,thoi-trang-nam,160556315,"quần lót nam relax cotton cao cấp chính hãng, quần sịp đùi nam relax underwear rltk49",104000,104000,0,0
TIKI,thoi-trang-nam,53969647,"Áo khoác jeans nam xanh GT02 form vừa chất liệu mềm mềm co dãn lôi cuốn có mũ có 3 size (M L XL) Julido mẫu khoác AKJ8687 thời trang lịch lãm hàn quốc trẻ trung hiện đại",199000,299000,100000,33
TIKI,thoi-trang-nam,85087738,"Áo sơ mi nam ngắn tay nhiều màu",159000,159000,0,0
TIKI,thoi-trang-nam,129297742,"áo khoác nam trung niên lót lông hàng cao cấp dày dăn cưc ấm shop Trung Niên",499000,499000,0,0
TIKI,thoi-trang-nam,106769474,"BỘ PIJAMA NAM cộc tay, PYJAMA COTTON 100%, PIZAMA họa tiết kẻ sọc-Shop Thủy Bông",492000,492000,0,0
TIKI,thoi-trang-nam,52251398,"Áo Thun Nam Cổ Bẻ, Áo thun nam có cổ thun cotton 4 Chiều Cao Cấp, Trẻ Trung thương hiệu Doka (Nhiều Màu) PSDB01",81000,159000,78000,49
TIKI,thoi-trang-nam,129424110,"Áo sơ mi nam tay dài trắng công sở đi tiệc vải oxford denim có túi cao cấp SM02",229000,229000,0,0
TIKI,thoi-trang-nam,111710758,"Áo thun nam Áo polo nam ngắn tay có cổ PN02 Cotton 100% cao cấp phong cách Hàn Quốc",125000,125000,0,0
TIKI,thoi-trang-nam,188914141,"Tất Nam Cổ Thấp FASVIN Mềm Mịn Co Giãn Tốt TCT22904.HN",14000,28000,14000,50
TIKI,thoi-trang-nam,82306488,"Quần Jean Nam cao cấp chất bò siêu co dãn Thương Hiệu Chandi, form đứng dáng đẹp mẫu mới siêu hot MR9083",169000,299000,130000,43
TIKI,thoi-trang-nam,151799545,"QUẦN LÓT NAM - Tam Giác Nửa Mông - Thun Lạnh Siêu Mát",49000,49000,0,0
TIKI,thoi-trang-nam,78544461,"Áo Thun Ba Lỗ Nam Phong Cách Hàn Nhiều Màu",84000,84000,0,0
TIKI,thoi-trang-nam,76047427,"Áo thun Polo nam Novelty 200029N",319200,399000,79800,20
TIKI,thoi-trang-nam,163731428,"Quần bơi boxer nam loại đẹp dầy dặn, thiết kế chuyên nghiệp, chất thun bơi lạnh cao cấp mau khô, ôm gọn chống lộ | BN002",125000,125000,0,0
TIKI,thoi-trang-nam,46694543,"QUẦN TÂY NAM QUẦN ÂU NAM THỜI TRANG DN20010513",148000,159000,11000,7
TIKI,thoi-trang-nam,163582097,"Áo sơ mi nam dài tay công sở trung niên thương hiệu Anton sợi tre họa tiết màu ghi -X8551",265000,325000,60000,18
TIKI,thoi-trang-nam,105304392,"Áo Phông Nam Polo Có Cổ Tay Ngắn Trơn Mùa Hè Cao Cấp ZERO",189000,300000,111000,37
TIKI,thoi-trang-nam,176769589,"Quần bơi big size cho nam giới béo mập, có size lớn đến 125kg, dáng sooc đùi dài, chất thun bơi lạnh dày dặn co giãn 4 chiều | BN017",180000,180000,0,0
TIKI,thoi-trang-nam,73398416,"Combo 4 Quần Sịp Nam Quần Lót Đùi Nam Boxer Thun lạnh Mềm Mịn Siêu Thoáng Mát, Co Giãn 4 Chiều Cao Cấp",89000,89000,0,0
TIKI,thoi-trang-nam,106700067,"Quần jean baggy Vonesa nam nữ ống rộng , dáng xuông , không phai màu Q1",115000,115000,0,0
TIKI,thoi-trang-nam,187900055,"Áo gile nam, áo gile nam túi hộp lính 1215",440000,440000,0,0
TIKI,thoi-trang-nam,151801252,"QUẦN LÓT NAM - Dạng Dây NỔI BẬT- Nâng Mông Nhẹ - Mặc Cực Đã",59000,59000,0,0
TIKI,thoi-trang-nam,189596330,"Áo sơ mi nam xếp ly mặc Tuxedo Anlimen & Gentle Spread Collar",1370000,1370000,0,0
TIKI,thoi-trang-nam,55778935,"Áo Ba Lỗ Tank Top Thoáng Mát Không Viền Không Đường May Phong Cách Độc Lạ - Thời Trang Nam SZone SA485",49000,49000,0,0
TIKI,thoi-trang-nam,3714765,"Combo 3 Quần Lót Nam Freeman 6023-CB3 (Size",237000,237000,0,0
TIKI,thoi-trang-nam,151802696,"QUẦN LÓT NAM - TAM GIÁC THUN LẠNH - LƯỚI NHỎ THOÁNG MÁT",59000,59000,0,0
TIKI,thoi-trang-nam,132137295,"Quần đi biển gia đình màu cam kiểu short ngắn thun da cá dày dặn có thể mặc cặp đôi nam nữ hội nhóm SGQC DONGPHUCSG",70000,70000,0,0
TIKI,thoi-trang-nam,194477427,"SHORT KAKI MẪU MỚI BIG SIZE NAM TỪ 80 ĐẾN 130KG CÓ CO GIÃN",265000,265000,0,0
TIKI,thoi-trang-nam,141000723,"Combo 3 quần lót nam không đường may Trunk Seamless iBasic PANM095 - 3",379000,477000,98000,21
TIKI,thoi-trang-nam,129298361,"Quần kaki trung niên 2li túi thẳng chất cực đẹp",329000,329000,0,0
TIKI,thoi-trang-nam,183690994,"Áo Sơ Mi, Sơ Mi Nam Tay lỡ, cổ Vest phối Vai cách điệu, chất liệu không nhăn, không phai màu, mát mẻ sang trọng lịch lãm, trẻ trung, co giãn nhẹ hàng thiết kế tại xưởng mã T1",199000,199000,0,0
TIKI,thoi-trang-nam,95059774,"Áo khoác dù unisex form rộng trơn sọc phong cách ulzzang Wind",107000,107000,0,0
TIKI,thoi-trang-nam,30028312,"Áo sơ mi nam ngắn tay màu trắng cổ trụ chui đầu",159000,159000,0,0
TIKI,thoi-trang-nam,39853665,"Áo khoác nỉ Hoodie Hot",89000,89000,0,0
TIKI,thoi-trang-nam,28310952,"Áo sơ mi nam Flanel Caro Victory đen trắng ASM3016C",90000,90000,0,0
TIKI,thoi-trang-nam,174037994,"Áo thun nam tay ngắn họa tiết LOS ANGELES LADOS - 9081, vải cotton thoáng mát, form rộng, siêu đẹp",339000,339000,0,0
TIKI,thoi-trang-nam,67708834,"Quần Bơi Nam Đen Họa Tiết Vảy Cá Phong Cách Chuyên Nghiệp SZone SQB109",55000,55000,0,0
TIKI,thoi-trang-nam,125803140,"Quần đùi nam mặc ở nhà, đi biển chất liệu linner nhẹ mát phom dáng trẻ trung trên gối thương hiệu Fezzio chính hãng",87500,175000,87500,50
TIKI,thoi-trang-nam,22543488,"Quần Jogger Nam Chất Kaki Ống Bó Kiểu Dáng Thể Thao",89000,89000,0,0
TIKI,thoi-trang-nam,94776620,"Đồ bộ nam nữ unisex mùa hè chất mè xịn co giãn 4 chiều thoáng mát",92000,92000,0,0
TIKI,thoi-trang-nam,22559742,"Áo Thun nam mẫu mới logo trước ngực, combo 3 áo -  ĐB3QC11",279000,509000,230000,45
TIKI,thoi-trang-nam,122349032,"Áo Thun Có Cổ Nam Giordano Lion 3D Polo 01018222",640000,640000,0,0
TIKI,thoi-trang-nam,118990975,"Áo polo nam ADINO màu xanh bích vải cotton co giãn thiết kế basic trẻ trung PL50",159000,318000,159000,50
TIKI,thoi-trang-nam,186359480," Áo Sơ Mi nam tay dài sọc nhỏ NSMMSNMTCR212809D",299000,329000,30000,9
TIKI,thoi-trang-nam,113065450,"Áo sơ mi CARO UNISEX nam nữ đa năng (kèm ảnh thật)",104000,104000,0,0
TIKI,thoi-trang-nam,186359416,"Áo Sơ Mi nam tay dài sọc nhỏ NSMMSNMTCR212805D",299000,329000,30000,9
TIKI,thoi-trang-nam,101278805,"Sét  5 Quần lót nam thun lạnh hàng cao cấp thoáng mát Từ 40kg đến 75kg( màu ngẫu nhiên)",134400,134400,0,0
TIKI,thoi-trang-nam,91339522,"Áo chống nắng nam thông hơi vải kim cương cao cấp hàng xuất khẩu Micado",89000,150000,61000,41
TIKI,thoi-trang-nam,79723089,"Bộ quần áo thể thao thun lạnh nam nữ",90000,90000,0,0
TIKI,thoi-trang-nam,67428731,"Quần thể thao 3 sọc nam nữ ( hình thật ) , quần jogger nỉ nam 3 sọc, quần jogger thun, quần thể thao nam, quần nỉ nam",60000,60000,0,0
TIKI,thoi-trang-nam,3952347,"Áo Gile Aligro Cổ Tim Màu Tím ALENGL009",533500,533500,0,0
TIKI,thoi-trang-nam,139607008,"Bộ 6 Quần Lót Nam Dạng Tam Giác Giordano Cotton Briefs 0117701437",365000,640000,275000,43
TIKI,thoi-trang-nam,183727360,"Áo sơ Mi, Áo sơ Mi Nam thiết kế nhún vai tạo điểm nhấn mạnh mẽ thu hút mọi ánh nhìn mã H41",199000,199000,0,0
TIKI,thoi-trang-nam,176067897,"Quần Bơi Nam Thể Thao Swimming KUNBE, Kiểu Dáng Năng Động Khỏe Khoắn Chất Liệu Co Dãn Thoáng Khí Nhanh Khô",79000,79000,0,0
TIKI,thoi-trang-nam,191725120,"Quần đùi nam thể thao chất nhung co dãn cao cấp, quần short nam mặc nhà mềm mịn thấm hút mồ hôi QD06 - PROMAN",65000,65000,0,0
TIKI,thoi-trang-nam,165709094,"Quần sịp nam Thái Lan dệt kim cao cấp, Quần lót nam Lihana",60000,60000,0,0
TIKI,thoi-trang-nam,130969557,"Quần thun nam mặc ngủ, thể thao, tập gym - A077",120000,120000,0,0
TIKI,thoi-trang-nam,83517269,"Bộ áo khoác thể thao thu đông cao cấp",505700,505700,0,0
TIKI,thoi-trang-nam,196093567,"Áo May Ô Ba Lỗ Nam Vicci Màu Trắng, Chất Liệu 100% Sợi Cotton Mềm Mịn, Co Giãn 4 Chiều, Thấm Hút Mồ Hôi, Siêu Thoáng Mát",52000,60000,8000,13
TIKI,thoi-trang-nam,149684587,"ÁO KHOÁC DÙ BOMBER CAO CỔ 7ZIA",105000,105000,0,0
TIKI,thoi-trang-nam,132107824,"Áo gia đình 3/4/5 người Đồng phục gia đình Family Áo đôi mẹ và bé Màu thiên thanh GD332TT",49000,49000,0,0
TIKI,thoi-trang-nam,78488562,"Quần Jean Nam siêu cấp thương hiệu Chandi,  chất jean co dãn mẫu mới mã HD89",169000,299000,130000,43
TIKI,thoi-trang-nam,164309510,"The Cycling Lion, mã G73. Áo thun nam nữ in siêu đẹp. Áo phông thoát nhiệt GOKING hàng hiệu cao cấp",168000,168000,0,0
TIKI,thoi-trang-nam,160814776,"quần lót nam relax thun lạnh cao cấp chính hãng, quần sipn nam relax rltk07 - M",96000,96000,0,0
TIKI,thoi-trang-nam,48101769,"Quần Lót Nam Boxer Kiểu Jean 5964",75000,75000,0,0
TIKI,thoi-trang-nam,83158705,"Áo Thun Nam Có Cổ Phối Logo",157000,157000,0,0
TIKI,thoi-trang-nam,171046883,"Quần Bò Nam cao cấp thương hiệu Chandi, chất jean co dãn mẫu mới nhất  MS64",350000,350000,0,0
TIKI,thoi-trang-nam,95334507,"Quần short tây nam Novelty in họa tiết 2100090",199000,299000,100000,33
TIKI,thoi-trang-nam,197720684,"Áo khoác hoodie Kill System So Sad oversize có nón nam nữ, vải nỉ bông chân cua phong cách unisex, Hoodie Nỉ Ngoại Too Young Toneso Sad Unisex Jacket form rộng tay bồng kiểu dáng đường phố hàn quốc",100000,100000,0,0
TIKI,thoi-trang-nam,76725581,"Áo thun Polo nam Novelty màu đỏ NATMMTMT3R180079N",299000,395000,96000,24
TIKI,thoi-trang-nam,115593847,"Quần Jogger Đen/Trắng Hoạ Tiết Hoạt Hình Ulzzang Nam Nữ 1hit_Unisex",147000,147000,0,0
TIKI,thoi-trang-nam,68936826,"Áo Sơ Mi Mam Dài Tay Hàn Quốc Dáng Ôm Sơ Cổ Bẻ Vải Lụa Thái Chống Nhăn Chống Xù",124000,124000,0,0
TIKI,thoi-trang-nam,134739638,"Áo Hoodie nỉ  Couple nam nữ - Form rộng",106000,106000,0,0
TIKI,thoi-trang-nam,24388904,"áo hoodie nam unisex from rộng BHD6",99000,99000,0,0
TIKI,thoi-trang-nam,164308730,"TOKYO JAPAN, mã G53. Áo thun nam nữ siêu đẹp. Áo phông thoát nhiệt Goking hàng hiệu",168000,168000,0,0
TIKI,thoi-trang-nam,107039457,"Set Đồ Lam Đi Chùa Cao Cấp Cho Nam S1 #đồ lam đi chùa - đồ phật tử",300000,300000,0,0
TIKI,thoi-trang-nam,113234818,"Combo 4 quần đùi nam xuất khẩu vải kate cotton 100% thương hiệu Fezzio",249500,499000,249500,50
TIKI,thoi-trang-nam,176298191,"Combo đồ bơi nam giới, set 4,5 chi tiết Quần boxer 2 lớp + Kính bơi anti fog + Mũ + Bịt tai kẹp mũi + Túi đựng, mẫu cao cấp đẹp | BN007",350000,350000,0,0
TIKI,thoi-trang-nam,83518858,"ÁO KHOÁC KAKI NAM 2 LỚP",349700,349700,0,0
TIKI,thoi-trang-nam,184898769,"Quần lót nam boxer RLTK007 quần sịp nam thoáng mát mềm mại cao cấp, co giãn tốt, ôm gọn - RELAX",113000,113000,0,0
TIKI,thoi-trang-nam,192678290,"ÁO SƠ MI TAY NGẮN-V46-014618-BL3",2967000,3190000,223000,7
TIKI,thoi-trang-nam,177603771,"Quần Lót Nam Boxer Thun Lạnh Cao Cấp LUXIS, Quần Sịp Đùi Nam Co Giãn 4 Chiều Mềm Mịn Siêu thoáng mát - LD023",65000,85000,20000,24
TIKI,thoi-trang-nam,114415816,"Áo khoác dù nam nữ mặc in nổi hình sói , áo khoác gió , áo khoác unisex vải dù 2 lớp, Áo khoác kiểu bomber nam , Áo khoác dù nam , áo khoác kiểu bomber nam , áo dù bomber , áo khoác nam vải dù 2 lớp",95000,95000,0,0
TIKI,thoi-trang-nam,148680632,"QUẦN LÍNH TÚI HỘP HÀN QUỐC CỰC ĐẸP, Quần Kaki Lính Rằn Ri Chất Vải kaki, Quần jogger kaki rằn ri - lính nam túi hộp, QUẦN JOGGER KAKI CO GIÃN HOẠT TIẾT LÍNH CAO CẤP, Quần kaki dài basic nam nữ lính",95000,95000,0,0
TIKI,thoi-trang-nam,165150012,"Quần tắm biển nam phong cách Nhật Bản 9850",49500,99000,49500,50
TIKI,thoi-trang-nam,170270845,"Áo Polo Tay Ngắn Thiết Kế Phong Cách Năng Động Thời Trang AVIANO",99000,198000,99000,50
TIKI,thoi-trang-nam,78965186,"Đồ bộ thể thao nam vải thun lạnh mềm mịn, Thời Trang Phong Cách Hàn - Lee’s Home (Freesize từ 45-70kg)-Nhiều kiểu lựa chọn",75000,75000,0,0
TIKI,thoi-trang-nam,132814989,"Quần Đi Biển Nam 2 lớp Sobie Black",331500,390000,58500,15
TIKI,thoi-trang-nam,138557111,"Bộ PIJAMA CAO CẤP chất liệu cotton SIÊU MỀM MỊN, Full size L-3XL, trơn màu phù hợp mọi lứa tuổi",540000,540000,0,0
TIKI,thoi-trang-nam,178554426,"Áo sơ mi màu hồng pastel hiệu Amazing, dáng trẻ slim fit, phong cách Hàn Quốc, vải bamboo mềm mịn",195000,297000,102000,34
TIKI,thoi-trang-nam,179575398,"Áo thun Polo nam Novelty 210060 màu xanh da trời",199000,289000,90000,31
TIKI,thoi-trang-nam,184899153,"Quần lót nam brief RLTK022 quần sịp nam thoáng mát mềm mại cao cấp, co giãn tốt, ôm gọn - RELAX",88000,88000,0,0
TIKI,thoi-trang-nam,195622075,"Quần nỉ Jogger thể thao nam hàng Quảng Châu cao cấp - Quần nỉ nam nót lông cừu siêu ấm - Hàng chính hãng D Danido",160000,160000,0,0
TIKI,thoi-trang-nam,144227349,"Quần jean baggy nam MĐ Q902 form rộng, trẻ trung phong cách",179000,179000,0,0
TIKI,thoi-trang-nam,152348255,"Quần short Nam sọc caro vải kate - A102",149000,149000,0,0
TIKI,thoi-trang-nam,193132125,"Áo Hoodie Nỉ Nam Nữ Trơn From Rộng Unisex Chất Nỉ Cotton Bao Dày Không Đổ Lông",88000,88000,0,0
TIKI,thoi-trang-nam,155269199,"Áo thun nam Novelty dài tay cổ tròn 4 màu lựa chọn",153000,269000,116000,43
TIKI,thoi-trang-nam,117583592,"(XẢ KHO DIỆP TẾT) ÁO KHOÁC DÙ DẦY MỚI PHONG CÁCH CAO CẤP",155000,155000,0,0
TIKI,thoi-trang-nam,20678306,"Quần short thun nam vải da cá nhập Phúc An 1065 có size lớn  (oversize)",79000,79000,0,0
TIKI,thoi-trang-nam,151799619,"QUẦN BƠI NAM - Dạng Bán Đùi Viền Sọc Bên Cá Tính - Hàng Chất",160000,160000,0,0
TIKI,thoi-trang-nam,194115595,"Quần nam short khaki MKB0132 - 34",224000,224000,0,0
TIKI,thoi-trang-nam,191055924,"Áo thun polo thời trang nam phong cách trẻ trung, lịch lãm - FORMEN SHOP - FMPS191",189000,250000,61000,24
TIKI,thoi-trang-nam,196033255,"Áo sơ mi nam form rộng tay dài kiểu trẻ trung hàn quốc chất lụa mềm mịn mát ít nhăn- MRD04",93000,210000,117000,56
TIKI,thoi-trang-nam,113235477,"Quần đùi nam kate, quần đùi mặc nhà nam cotton Fezzio chính hãng big size",119000,238000,119000,50
TIKI,thoi-trang-nam,83517021,"ÁO THUN NAM DÀI TAY CỔ SƠ MI PHONG CÁCH HÀN QUỐC ATD01-ĐỎ ĐÔ",193700,193700,0,0
TIKI,thoi-trang-nam,138749879,"Áo phông nam cổ tròn chất cotton thun lạnh mềm, mịn , dáng body thời trang",89000,99000,10000,10
TIKI,thoi-trang-nam,93212275,"Áo Khoác Kaki Jean Wash Nam Nữ Unisex Có Cổ Bẻ Chống Lạnh Chống Nắng Chống Gió Chống Tia Uv Dày 2 Lớp Thời Trang Hàn Quốc Cao Cấp KK52 - ShopN6",199000,245000,46000,19
TIKI,thoi-trang-nam,22760805,"Áo thun nam cổ bẻ vải cá sấu,combo 3 áo - EZ306",269000,397000,128000,32
TIKI,thoi-trang-nam,79721593,"Áo khoác sơ mi nam nữ có nón",104000,104000,0,0
TIKI,thoi-trang-nam,194205679,"Quần tây short nam 0 ply màu rêu Regular fit NQSMMDMT3R2201180",375000,375000,0,0
TIKI,thoi-trang-nam,167429610,"Bộ Pijama nam kẻ caro chất liệu cotton cao cấp dày mịn, thoáng mát, size L-3XL",660000,660000,0,0
TIKI,thoi-trang-nam,168856937,"Viettien - Áo sơ mi nam dài tay họa tiết 1N2012 regular",580000,580000,0,0
TIKI,thoi-trang-nam,195302427,"Áo thun ba lỗ NAM HOẠ TIẾT HOẠT HÌNH CỰC ĐẸP 2021 MẪU MỚI NHẤT HIỆN NAY",73000,73000,0,0
TIKI,thoi-trang-nam,111710197,"Áo Sơ Mi Nam Ngắn Tay Mẫu TNFS Thời Trang Cao Cấp PONIVA Phong Cách Hàn Quốc Trẻ Trung, Lịch Lãm",125000,125000,0,0
TIKI,thoi-trang-nam,97099486,"Áo sơ mi trơn tay dài Amazing, form slimfit Hàn Quốc, màu sắc đa dạng, trẻ trung, vải bamboo mềm mượt, thoáng mát",195000,297000,102000,34
TIKI,thoi-trang-nam,51563792,"Combo 3 Chiếc Quần Lót Nam Tam Giác Thời Trang Kwin KBF037, Mềm Mại, Kháng Khuẩn, Khử Mùi - Hàng Chính Hãng",155000,195000,40000,21
TIKI,thoi-trang-nam,155564740,"Quần bò dài nam trung niên dáng thụng có đến size 36+ẢNH THẬT",523500,523500,0,0
TIKI,thoi-trang-nam,20991311,"Áo sơ mi trơn tay ngắn",300000,300000,0,0
TIKI,thoi-trang-nam,181990263,"Quần jeans dài Vistino",509000,509000,0,0
TIKI,thoi-trang-nam,117090822,"Set Bộ Mặc nhà Gấu Cặp Đôi Nam Nữ HOT RẺ ĐẸP Quần Đùi Phối Áo Thun Form Rộng Tay Lỡ -Đồ Bộ Thun Hoạt Hinh siêu Cute",91000,91000,0,0
TIKI,thoi-trang-nam,100369140," Quần đùi ngắn nam Fasvin R21448.HN vải gió chun mềm mại co giãn thoải mái vận động",129000,159000,30000,19
TIKI,thoi-trang-nam,191127039,"Áo Khoác Dù Unisex Chống Nắng Phối Hoa Văn Nam Nữ RẺ ĐẸPÁo Khoác Gió Mùa Đông Cặp Đôi Couple Cực Ngầu Jacktes",94000,94000,0,0
TIKI,thoi-trang-nam,137668107,"Áo Bomber Jacket/ Áo Khoác Dù 2 Lớp Style Bóng Chày in Bmoody Unisex Nam Nữ Couple Hot Trend",107000,107000,0,0
TIKI,thoi-trang-nam,59439299,"Áo thun nam cổ tròn tay ngắn, chất thun cao cấp, trẻ trung, năng động – FORMEN SHOP – FMPS133",90000,179000,89000,50
TIKI,thoi-trang-nam,13580313,"Quần short jean nam xanh bạc Q32",132000,132000,0,0
TIKI,thoi-trang-nam,132084938,"Áo Bếp Tay Dài Đồng Phục Đầu Bếp Màu Trắng Đen",126000,126000,0,0
TIKI,thoi-trang-nam,115093722,"Quần boxer nam cotton mịn mỏng thoáng khí co giãn tốt cao cấp, quần lót nam, sịp cotton trẻ trung K117",59000,59000,0,0
TIKI,thoi-trang-nam,197172576,"Áo hoodie nỉ bông WISH NOW unisex nam nữ (Ảnh thật/Có sẵn)",108000,108000,0,0
TIKI,thoi-trang-nam,148848665,"Đồ bộ thun thể thao nam",249000,249000,0,0
TIKI,thoi-trang-nam,16546849,"Combo 5 Quần Lót Nam Tam Giác Nhật",114000,114000,0,0
TIKI,thoi-trang-nam,79876518,"Quần Lót Nam Dạng Lưới Mềm Mại Thoáng Mát - Thiết Kế 2 Màu Kết Hợp Ấn Tượng - Co Dãn 4 Chiều Cao Cấp Brave Person B1139",134000,289000,155000,54
TIKI,thoi-trang-nam,36344393,"Trắng ngắn tay vải spun",410000,410000,0,0
TIKI,thoi-trang-nam,166081740,"Combo 6 quần sip đùi kháng khuẩn AAA chất coton cao cấp co giãn 4 chiều",89000,99000,10000,10
TIKI,thoi-trang-nam,100369201," Quần short Big Size thể thao nam Fasvin D20267.HN chất liệu cao cấp mềm mịn, co giãn tốt",169000,209000,40000,19
TIKI,thoi-trang-nam,180990072,"ÁO SƠ MI TAY NGẮN MÀU XANH ĐEN BIG SIZE NAM TỚI 130KG",185000,185000,0,0
TIKI,thoi-trang-nam,72462368,"Áo Khoác Nam Áo Khoác Dù Dày Nam Hai Lớp Lót Nỉ Chống Lạnh Chống Gió Chống Nắng Tia UV Cao Cấp AD64 - ShopN6 (Nhiều Màu)",149000,225000,76000,34
TIKI,thoi-trang-nam,119286524,"Áo sơ mi nam trắng Amazing, vạt bầu, đồng phục học sinh, công sở, form suông Regular, chất liệu KT silk mềm mượt, size từ 45-105kg",187000,286000,99000,35
TIKI,thoi-trang-nam,46640497,"QUẦN JOGGER NỈ NAM 1 SỌC JG02",75000,75000,0,0
TIKI,thoi-trang-nam,173832691,"Áo khoác bóng chày phong cách vintage đường phố thời trang 2022 cho nam, Áo Jacket, Áo Khoác Dày Dặn Sành Điệu M Nam, Áo Cardigan Chữ M Thêu Unisex, Áo khoác nỉ Cardigan M nỉ ngoại mềm mịn, áo khoác thời trang nam nữ",99000,99000,0,0
TIKI,thoi-trang-nam,95306637,"Áo thun nam Polo NOVELTY dệt họa tiết 210134N",299000,469000,170000,36
TIKI,thoi-trang-nam,195801442,"Áo sơ mi nam màu hồng ADINO vải nến lụa sợi sồi modal dáng công sở slimfit hơi ôm trẻ trung S06",279000,400000,121000,30
TIKI,thoi-trang-nam,133815093,"ÁO PHÔNG áo thun nam trung niên cộc tay cổ bẻ có túi góc",189000,189000,0,0
TIKI,thoi-trang-nam,191820527,"Áo Polo Nam Trẻ Trung 7 Màu Hiện Đại Thời Trang Nam AVIANO",189000,360000,171000,48
TIKI,thoi-trang-nam,178584562,"Áo Khoác Dù Nam Nữ Cao Cấp SWEED Kiểu Cổ Bẻ Phối Zip Kéo Dáng Rộng Phong Cách Cá Tính Độc Lạ Hot Trend",102000,102000,0,0
TIKI,thoi-trang-nam,93961252,"Áo sơ mi tay dài-V18-014565-BL2",3190000,3190000,0,0
TIKI,thoi-trang-nam,186547206,"Áo bomber nam nữ unisex khoác gió jacket dù 2 lớp cúc bấm form rộng local brand ulzzang phong cách hàn quốc đep PENTA.Q",96000,96000,0,0
TIKI,thoi-trang-nam,128125119,"Quần short, đùi chất linner nam thương hiệu Fezzio chính hãng",69500,139000,69500,50
TIKI,thoi-trang-nam,178585332,"Áo Khoác Hoodie 2 Nón In Gấu SATUDR Kiểu Khóa Zip Kéo Phối 2 Nón Giữ Nhiệt Che Nắng Đa Năng Phong Cách Thời Trang Cá Tín",102000,102000,0,0
TIKI,thoi-trang-nam,22158405,"Áo sơ mi trắng dài tay vải kate",430000,430000,0,0
TIKI,thoi-trang-nam,73281196,"Áo Phông Undertale Sans",126500,126500,0,0
TIKI,thoi-trang-nam,85800121,"ÁO POLO VULCANO 1007 - L",495000,495000,0,0
TIKI,thoi-trang-nam,163544556,"Áo Sơ Mi Nam Thương Hiệu Anton Dài Tay Công Sở Trung Niên Vải Cotton Họa Tiết Kẻ Caro Màu Xanh - 8566",265000,355000,90000,25
TIKI,thoi-trang-nam,97823018,"Áo khoác dù Happiness Ulzzang chất dù cao cấp 2 lớp , Form Rộng Unisex size M  L  XL  Nam Nữ Couple Đều Mặc Được - Áo khoác gió nam nữ mặc",97000,97000,0,0
TIKI,thoi-trang-nam,127352139,"Áo Khoác Nỉ Nam Nữ Form Rộng Siêu Hot Chất Nỉ Dày Dặn Siêu Đẹp Áo Khoác Jackets Thun Unisex POWR",96000,96000,0,0
TIKI,thoi-trang-nam,193229397,"Quần Lót Vận Động Nam Siêu Mỏng Nhẹ Thoáng Khí Aonijie E7004 Dáng Trunk Combo 3 Cái Màu Hỗn Hợp",660000,660000,0,0
TIKI,thoi-trang-nam,183916651,"Áo Khoác Nỉ Bomber Cardigan Form Rộng Nam Nữ Logo Kiểu Dáng Bóng Chày Thời Trang",120000,120000,0,0
TIKI,thoi-trang-nam,31196961,"Quần short jean Q169 MuiDoi",132000,132000,0,0
TIKI,thoi-trang-nam,179161819,"(big size <130kg) Short jean đen không rách big size nam",270000,270000,0,0
TIKI,thoi-trang-nam,172284477,"ALWAYS COOL, mã G106. Áo thun nam nữ in siêu đẹp. Áo phông thoát nhiệt GOKING hàng hiệu cao cấp",168000,168000,0,0
TIKI,thoi-trang-nam,93969398,"Áo sơ mi nam tay ngắn-V46-014531-PK1",2874000,3090000,216000,7
TIKI,thoi-trang-nam,78967228,"Đồ bộ thể thao nam vải thun tuyết mưa mềm mịn, Thời Trang Phong Cách Hàn aloha style (Freesize từ 45-70kg) -Bộ UZUMAKI-Nhiều kiểu lựa chọn",95000,95000,0,0
TIKI,thoi-trang-nam,15362990,"Quần Short Nam Winfa TỪ 50-95KG 4 Màu",109000,109000,0,0
TIKI,thoi-trang-nam,15363095,"Quần Short Nam Winfa Từ 50-95kg 5 Màu",109000,109000,0,0
TIKI,thoi-trang-nam,45242530,"áo thun nam đơn giản",99000,99000,0,0
TIKI,thoi-trang-nam,181785465,"Áo sơ mi trắng lễ phục",150000,150000,0,0
TIKI,thoi-trang-nam,94774234,"Quần jogger túi hộp chất kaki mịn, đẹp, cực ngầu",95000,95000,0,0
TIKI,thoi-trang-nam,148680020,"ÁO KHOÁC NỈ BOMBER CẬU BÉ JACKET CÚC BẤM HỒNG ĐEN IN VIỀN SỌC, áo khoác nỉ bomber đen chạy viền trắng unisex, Áo Khoác Cadigan Nam Nữ Form Rộng Thêu Chữ Ngực phối viền Phong Cách Mới",99000,99000,0,0
TIKI,thoi-trang-nam,94776001,"Áo sơ mi caro unisex chất dày dặn cực đẹp, y ảnh",93000,93000,0,0
TIKI,thoi-trang-nam,76369205,"Áo thun nam Novelty cổ tròn 190166",99000,169000,70000,41
TIKI,thoi-trang-nam,140308361,"Quần baggy nam nữ unisex vải kaki TRƠN ống suông tây đen công sở đi học lưng cao ulzzang hàn quốc dây rút đẹp",89000,89000,0,0
TIKI,thoi-trang-nam,156199083,"Combo 5 quần lót nam Brief Mr Mitas Basics viền êm ái",229000,359000,130000,36
TIKI,thoi-trang-nam,34159128,"Áo Sơ Mi Nam Sọc Đen",120000,120000,0,0
TIKI,thoi-trang-nam,179162795,"(Big size <130kg) Áo sơ mi nam big size màu đỏ",185000,185000,0,0
TIKI,thoi-trang-nam,13587414,"Quần short jean nam xanh cào xước Q37",132000,132000,0,0
TIKI,thoi-trang-nam,66709381,"Quần sịp boxer kháng khuẩn Hàn Quốc",15000,15000,0,0
TIKI,thoi-trang-nam,77329940,"Sơ mi nam họa tiết sói và đại bàng thời trang",175000,175000,0,0
TIKI,thoi-trang-nam,95313870,"Quần short khaki nam 0Ply Novelty trơn màu NSKMMNMCSR2101240",271200,339000,67800,20
TIKI,thoi-trang-nam,158893978,"JAPAN, mã G55. Áo thun nam nữ siêu đẹp. Áo phông thoát nhiệt Goking hàng hiệu",168000,168000,0,0
TIKI,thoi-trang-nam,35364542,"Hôp 5 quần lót nam boxer thun lạnh Nhật Bản cao cấp",74098,74098,0,0
TIKI,thoi-trang-nam,184236673,"Áo sơ mi trắng tay dài, đồng phục học sinh nam, chất vải KT Silk mềm mại, size từ 20-95kg",104000,161000,57000,35
TIKI,thoi-trang-nam,192193672,"Quần short đùi nam cao cấp TC với chất cotton co dãn tốt, kết hợp họa tiết logo chữ in nổi, độc đáo được may chắc chắn, phong cách trẻ trung, lịch lãm, hợp thời trang-21293",350000,350000,0,0
TIKI,thoi-trang-nam,73096116,"Áo Hoodie Nỉ Bông Unisex Streetwear Lục Lăng ( unisex nam nữ đều mặc được)",97000,97000,0,0
TIKI,thoi-trang-nam,196470991,"Quần short kaki nam BLOOK chất vải kaki phom lửng ngang gối 30081",389000,389000,0,0
TIKI,thoi-trang-nam,117082001,"Quần kaki nam nữ túi hộp lửng cá tính, năng động,ống rộng phong cách,thời trang",95000,95000,0,0
TIKI,thoi-trang-nam,179162922,"(bigsizenam <135kg) BỘ THỂ THAO BIG SIZE NAM IN HÌNH NGÔI SAO MỚI LẠ",300000,300000,0,0
TIKI,thoi-trang-nam,25045069,"Combo 5 chiếc Quần lót Boxer nam SQB200 - 1",147000,147000,0,0
TIKI,thoi-trang-nam,197745833,"Áo thun nam cổ trụ thời trang phong cách Hàn Quốc BLOOK 35617",489000,489000,0,0
TIKI,thoi-trang-nam,111711378,"Áo Sơ Mi Nam Ngắn Tay Đính Nút Mẫu ZF01 Thời Trang Cao Cấp PONIVA Phong Cách Hàn Quốc Trẻ Trung, Cá Tính",105000,105000,0,0
TIKI,thoi-trang-nam,5757757,"Bộ 4 Quần Boxer Đúc Cao Cấp Nhật Bản Cho Nam",152000,152000,0,0
TIKI,thoi-trang-nam,85086882,"Áo sơ mi nam dài tay màu vàng nhạt",159000,159000,0,0
TIKI,thoi-trang-nam,95063635,"quần thể thao nam nữ, quần thun lửng in hoa cúc đủ màu, quần short unisex nam nữ, quần lửng ulzzang đẹp, quần đùi nam nữ, quần thun nam ngắn mặc mát",89000,89000,0,0
TIKI,thoi-trang-nam,162029329,"QUẦN JEAN NAM WASH NHẸ PHONG CÁCH SANG TRỌNG",224000,224000,0,0
TIKI,thoi-trang-nam,193708586,"Quần nam short jeans MJB0123",259000,259000,0,0
TIKI,thoi-trang-nam,25196817,"Quần đũi nam sọc ngang phong cách SQ502",129000,129000,0,0
TIKI,thoi-trang-nam,102524057,"áO Khoác Dù Bomber Nam Nữ ZZA Unisex 2 lớp đủ Size, Áo khoác dù in logo TMS bao đẹp, Áo khoác bomber dù unisex 2 lớp,Áo khoác dù TMS LOGO JACKET, áo khoác dù gió thể thao unisex ulzzang from rộng phong cách hàn quốc",101000,101000,0,0
TIKI,thoi-trang-nam,178153833,"Quần sịp đùi 100% cotton kháng khuẩn khử mùi YG YV0081N của Nhật",195000,195000,0,0
TIKI,thoi-trang-nam,45657448,"Áo Khoác Nam Trung Niên 2 Lớp Cổ Bẻ Chất Vải Dày Và Ấm Cao Cấp",450000,450000,0,0
TIKI,thoi-trang-nam,106886116,"OWEN - Áo sơ mi dài tay Owen REGULAR FIT 20862 chất sợi tre",568000,568000,0,0
TIKI,thoi-trang-nam,196314768,"Áo Polo nam cổ bẻ phối sọc BLOOK vải cá sấu Cotton CVC cao cấp co giãn đa chiều thấm hút nhanh bền màu slimfit 35620",429000,429000,0,0
TIKI,thoi-trang-nam,84826901,"Quần Sịp Nam Chữ V Nâng Mông Siêu Thoáng K367 - Đen,M",65000,65000,0,0
TIKI,thoi-trang-nam,194198359,"Quần tây short nam 0 ply Caro lớn Regular fit NQSMCLMT3R2201250",299000,375000,76000,20
TIKI,thoi-trang-nam,163677493,"Áo Sơ Mi Nam Dài Tay Công Sở Trung Niên Anton Xanh Caro Sợi Tre Thoáng Mát, Thấm Hút Mồ Hôi - AC130",325000,425000,100000,24
TIKI,thoi-trang-nam,184899796,"Quần lót nam brief RLTK057 quần sịp nam thoáng mát mềm mại cao cấp, co giãn tốt, ôm gọn - RELAX",93000,93000,0,0
TIKI,thoi-trang-nam,186826593,"Áo Polo nam Novelty Regular fit NATMINMCLR210085N",299000,399000,100000,25
TIKI,thoi-trang-nam,76087213,"Áo khoác dù nam nữ mặc / áo khoác gió nam nữ mặc / áo khoác dù kiểu bomber / áo khoác cặp đôi / áo khoác form rộng",128000,128000,0,0
TIKI,thoi-trang-nam,722256,"Áo Sơ Mi Nam Tay Dài Slim Fit Titishop SM537 - Xanh Da Trời",19000,19000,0,0
TIKI,thoi-trang-nam,7707600,"Quần short thun nam phối sọc hông Phúc An N0001 màu xám",79000,79000,0,0
TIKI,thoi-trang-nam,20731450,"Áo khoác gió cách nhiệt GOKING có mũ, form unisex cho nam nữ. Ngoài vải dù, trong lót vải cào cách nhiệt. 3 túi to rộng. Hàng hiệu Việt Nam xuất khẩu",255000,255000,0,0
TIKI,thoi-trang-nam,110813116,"Áo Khoác Big Size Nam Nữ Áo Khoác Kaki Bomber Nam Nữ Chống Nắng Chống Lạnh Chống Gió Chống Nóng Hai lớp Thời Trang FS Hàn Quốc Nam Tính Giá Rẻ Cao Cấp WK46 - ShopN6",199000,235000,36000,15
TIKI,thoi-trang-nam,29976829,"Áo Vest Nam Thời Trang Phối Viền Túi Nhiều Màu AVNM01",189000,189000,0,0
TIKI,thoi-trang-nam,90071296,"BỘ QUẦN ÁO THỂ THAO BỘ ĐỒ MẶC NHAD THỜI TRANG NAM NỮ",93000,93000,0,0
TIKI,thoi-trang-nam,83638546,"Hộp 3 quần sịp nam boxer 5D cao cấp ",77970,77970,0,0
TIKI,thoi-trang-nam,41216023,"Áo khoác chống nước, giữ ấm, 2 áo kết hợp trong 1, KTOM Mã K97 - Màu Navy",760000,760000,0,0
TIKI,thoi-trang-nam,72639228,"Áo Sơ Mi Nam Sọc Caro Phong Cách Hàn Quốc GOAT MENSWEAR",82000,82000,0,0
TIKI,thoi-trang-nam,90078906,"Đồ bộ thể thao chất thun lạnh ETINONUC, Set Thể thao nam nữ, Đồ bộ thể thao mặc nhà etinonuc, Đồ bộ mặc nhà chất thun lạnh cá tính, BỘ QUẦN ÁO THỂ THAO BỘ ĐỒ NAM NỮ SIZE M L CHẤT THUN LẠNH, BỘ QUẦN ÁO THỂ THAO BỘ ĐỒ MẶC NHÀ / ĐỒ BỘ NAM NỮ / BỘ ĐỒ NAM NỮ -",99000,99000,0,0
TIKI,thoi-trang-nam,192208918,"Quần Short Nam Nhung Tăm 6 Màu Thiết Kế Thời Trang Cao Cấp AVIANO",149000,298000,149000,50
TIKI,thoi-trang-nam,50239323,"Quần bơi nam dáng lửng cao cấp",99000,99000,0,0
TIKI,thoi-trang-nam,85087342,"Áo sơ mi nam ngắn tay màu xanh navy vải không nhăn",108000,108000,0,0
TIKI,thoi-trang-nam,77199974,"Quần đùi nam chất kate cotton thương hiệu Fezzio",59500,119000,59500,50
TIKI,thoi-trang-nam,136385051,"Quần sọt kaki túi hộp có dây kéo,6 túi .",159000,159000,0,0
TIKI,thoi-trang-nam,169916705,"Viettien - Áo sơ mi nam dài tay ca rô 1N0527 form regular",475000,475000,0,0
TIKI,thoi-trang-nam,43950321,"Áo Khoác Gió Thu Đông Nam Trung Niên 2 Lớp Cổ Bẻ",339000,339000,0,0
TIKI,thoi-trang-nam,29616695,"Áo sơ mi nam cổ trụ chui đầu dài tay",159000,159000,0,0
TIKI,thoi-trang-nam,183742098,"Áo Vest Nam ,Vest Nam Tay lỡ 2 lớp lót, Chất liệu cao cấp không xù, không nhăn. Trẻ trung mới lạ H48",309000,309000,0,0
TIKI,thoi-trang-nam,21191213,"Áo Polo nam cổ bẻ ngắn tay, chất liệu cao cấp, thoáng mát, bền màu, thiết kế trẻ trung – FORMEN SHOP – FMPS086 - ĐEN - M",148000,239000,91000,38
TIKI,thoi-trang-nam,35236973,"Combo 3 quần lót nam Freeman 6053 - Chất liệu thun lạnh cao cấp",267000,267000,0,0
TIKI,thoi-trang-nam,140865500,"Áo khoác Hoodie Nam, Hoodie Basic Unisex Nỉ From Rộng NÓN 2 LỚP PHẢN QUANG 7 MÀU, Áo khoác Nỉ form rộng HÀN QUỐC,có nón và dây kéo HOODIE ZIP, 7 MÀU kiểu dáng UNISEX NAM NỮ",129000,129000,0,0
TIKI,thoi-trang-nam,10047542,"Bộ 4 Quần Boxer Nam Chất Lụa",98000,98000,0,0
TIKI,thoi-trang-nam,197352209,"Áo polo ngắn tay nam, chất thun poly mềm mịn co giãn 4 chiều, họa tiết phối màu trẻ trung - FORMEN SHOP - FMPS195",189000,350000,161000,46
TIKI,thoi-trang-nam,7078819,"Bộ 5 Quần Lót Nam Nhật Thông Hơi Cao Cấp (Giao Màu Ngẫu Nhiên) - XL (chéo có hộp MJ)",58998,58998,0,0
TIKI,thoi-trang-nam,118803534,"Áo sơ mi nam tay ngắn ADINO màu trắng tinh vải sợi sồi modal dáng slimfit trẻ trung CT102",259000,320000,61000,19
TIKI,thoi-trang-nam,83617921,"Quần lót nam không viền may siêu mỏng túi lồi thoải mái",97500,97500,0,0
TIKI,thoi-trang-nam,150214175,"Bộ bảo hộ lao động VAT cài cúc có nẹp giấu cúc, quần túi hộp",229000,229000,0,0
TIKI,thoi-trang-nam,12108954,"Áo Khoác Da Nam Đen Lót Lông Cao Cấp ShopN6 AKD06",275000,425000,150000,35
TIKI,thoi-trang-nam,155701494,"Viettien - Quần jeans nam smart casual regular fit 6Q7119",720000,720000,0,0
TIKI,thoi-trang-nam,106700106,"Quần jean baggy Vonesa nam nữ ống rộng , dáng xuông , không phai màu Q2",115000,115000,0,0
TIKI,thoi-trang-nam,167491747,"Áo Polo Nam 3 Màu Nanh Sói Phong Cách Thời Trang Thiết Kế AVIANO",129000,258000,129000,50
TIKI,thoi-trang-nam,144334069,"Viettien - Bộ vest nam phong cách thời thượng màu đen 1Q9505",2605000,2605000,0,0
TIKI,thoi-trang-nam,41654783,"Áo Len Cổ Lọ Nam Phong Cách Hàn Quốc Siêu Ấm SAL222",118000,118000,0,0
TIKI,thoi-trang-nam,75404518,"Áo khoác kaki nam phong cách",249000,249000,0,0
TIKI,thoi-trang-nam,105644329,"áo khoác dù bomber đầu lâu hot trend, ÁO KHOÁC DÙ BOMBER CỰC HOT, áo khoác bóng chày hàn quốc, áo khoác bomber chữ K, áo bomber jacket kill system, áo khoác dù đẹp, áo bomber unisex from rộng phong cách ullzang",99000,99000,0,0
TIKI,thoi-trang-nam,131396456,"Áo khoác bomber gió chữ R trắng in hình họa tiết cực nổi nam nữ mặc cực chất,, Áo Khoác Dù BomBer Phối Cúc Bấm Thời Trang in Họa Tiết Trẻ Trung Năng Động",99000,99000,0,0
TIKI,thoi-trang-nam,82643089,"Áo Sơ Mi Nam Dài Tay Sọc Ngang Bảng To PONIVA",157000,157000,0,0
TIKI,thoi-trang-nam,198500416,"Combo 3 quần lót tam giác nam, chất thun cotton thấm hút mồ hôi tốt, thiết kế lưới thoáng mát - FORMEN SHOP - FMCB3QS019",180000,180000,0,0
TIKI,thoi-trang-nam,198536564,"Viettien - Áo sơ mi nam dài tay màu xanh đen 1R0412 vải có hoa văn ca rô chìm form regular",710000,710000,0,0
TIKI,thoi-trang-nam,31202082,"Quần tây nam không ply ống đứng Khatoco Q1M528R0-CNMA033-2105-0",351000,528000,177000,34
TIKI,thoi-trang-nam,107962165,"Quần sịp nam xuất EU thun lạnh kháng khuẩn cao cấp TG",8500,8500,0,0
TIKI,thoi-trang-nam,35193626,"[FREEMAN] Combo 3 Quần lót nam 6051 - Quần dệt cao cấp",447000,447000,0,0
TIKI,thoi-trang-nam,191657786,"Áo polo nam slimfit BLOOK Vải thun cotton thêu logo đơn giản 33086 (HÌNH THẬT)",469000,469000,0,0
TIKI,thoi-trang-nam,25965097,"Quần lót nam dạng lưới trong suốt gợi cảm - Màu tím",45000,45000,0,0
TIKI,thoi-trang-nam,197139408,"Áo khoác gió 2 lớp cao cấp chống nắng, chống nước thiết kế phối sọc trẻ trung - FORMEN SHOP - FMTHT051",179000,350000,171000,49
TIKI,thoi-trang-nam,83617770,"Quần ngủ nam lưới sexy thoáng mát có miếng lót nâng đỡ bên trong - Quan ngu luoi nam",99000,99000,0,0
TIKI,thoi-trang-nam,155763970,"Áo len nam May 10 mã 200119453ON Bộ đội-129",129000,129000,0,0
TIKI,thoi-trang-nam,119639482,"Quần tây nam việt tiến màu đen có 1ly regular 495",495000,495000,0,0
TIKI,thoi-trang-nam,179162130,"(bigsizenam <130kg) ÁO THUN POLO CÓ CỔ IN LOGO BIG SIZE NAM",250000,250000,0,0
TIKI,thoi-trang-nam,53516447,"Quần jeans nam co dãn , quần bò nam kiểu trơn và xước thiết kế trẻ trung đơn điệu phá cách gồm 5 kích thước (28-32) Julido mẫu QJN099704 - Màu bạc xước",169000,299000,130000,43
TIKI,thoi-trang-nam,129451322,"Áo Khoác Nam Nữ Hoodie Gấu - In Phản Quang 7 Màu From Unisex, Áo khoác hoodie phản quang Gấu Teddy, Áo Hoodie Crush Thỏ/Gấu - Thỏ Bảy Màu, áo hoodie ulzzang nam nữ đều mặc được",129000,129000,0,0
TIKI,thoi-trang-nam,9796365,"Aó khoác Jacket Aligro ALGAKG10",979000,979000,0,0
TIKI,thoi-trang-nam,160882838,"GOKING-1985-JAPAN-TOKYO, mã Goking4. Áo thun in chữ đẹp cho nam nữ, áo phông thoát nhiệt GOKING hàng hiệu cao cấp",168000,168000,0,0
TIKI,thoi-trang-nam,179746796,"Simple Box - 2 Áo ba lỗ nam, 3 quần lót nam Boxer, 5 đôi tất cao cấp MRM Manlywear",489000,699000,210000,30
TIKI,thoi-trang-nam,81188534,"Áo Thun Youtube",37000,37000,0,0
TIKI,thoi-trang-nam,196686994,"Viettien - Áo sơ mi nam dài tay kẻ sọc 1Q0511 fom regular - Áo sơ mi nam công sở Việt Tiến",580000,580000,0,0
TIKI,thoi-trang-nam,195890920,"Quần Jogger nam nữ rằn ri kaki, Quần JOGGER kaki thể thao nam nữ chất dày dặn - PROMAN",10000,10000,0,0
TIKI,thoi-trang-nam,35752589,"Combo 5 Quần Lót Nam Boxer Thời Trang Aristino ABX 16 16",489000,650000,161000,25
TIKI,thoi-trang-nam,108701320,"Quần baggy nam cạp chun ống côn chất đũi mát mẻ",80000,80000,0,0
TIKI,thoi-trang-nam,162097090,"QUẦN KAKI NAM TÚI MỸ DÁNG SUÔNG",150000,150000,0,0
TIKI,thoi-trang-nam,155240548,"Quần tây âu công sở nam ADINO màu đen vải cotton dày không bai không xù co giãn nhẹ dáng công sở slimfit ống đứng hơi côn Q02",329000,420000,91000,22
TIKI,thoi-trang-nam,68919995,"Áo thun tay dài trơn",78000,78000,0,0
TIKI,thoi-trang-nam,193414925,"ÁO THUN ĐEN CỔ TRÒN CHỮ XANH TRƯỚC NGỰC SIZE 80 ĐẾN 130KG",260000,260000,0,0
TIKI,thoi-trang-nam,51375262,"Áo Sơ Mi Nam Sọc Bản To Cao Cấp",157000,157000,0,0
TIKI,thoi-trang-nam,30795991,"Áo sơ mi nam dài tay kẻ sọc xanh",159000,159000,0,0
TIKI,thoi-trang-nam,191474727,"Áo sơ mi măng sét trắng Anlimen Cuff Shirt - AGS02",790000,790000,0,0
TIKI,thoi-trang-nam,33008560,"Áo Sơ Mi Tay Ngắn Sọc Caro To Bản",157000,157000,0,0
TIKI,thoi-trang-nam,152882456,"Quần tây nam đen và xanh than, ống đứng, form truyền thống, không ly, phong cách công sở, big size tới 100kg",224000,341000,117000,34
TIKI,thoi-trang-nam,74280101,"Quần jean nam xanh bạc Julido Store, chất jean co dãn 4 chiều tôn dáng nam tính BC5678 - 29",169000,279000,110000,39
TIKI,thoi-trang-nam,137209511,"quần sọt kaki nam túi hộp",150000,150000,0,0
TIKI,thoi-trang-nam,184794779,"JEAN DÀI MÀU XANH BẠC CHÂN BIG SIZE NAM TỚI 130KG",370000,370000,0,0
TIKI,thoi-trang-nam,97752488,"Quần đùi nam mặc ở nhà, đi ngủ chất cotton 100% phom dáng trẻ trung năng động thương hiêu Fezzio chính hãng",49500,99000,49500,50
TIKI,thoi-trang-nam,191777714,"Áo thun cổ tròn big size nam màu xanh tới 130kg",200000,200000,0,0
TIKI,thoi-trang-nam,195948130,"Quần tây nam hàn quốc màu ghi đậm ADINO vải rayon polyester co giãn không bai không xù dáng công sở ống đứng hơi côn QA131",359000,450000,91000,20
TIKI,thoi-trang-nam,179163723,"(bigsizenam<130kg) ÁO THUN TRẮNG IN LƯNG BIG SIZE NAM LA",285000,285000,0,0
TIKI,thoi-trang-nam,73842105,"Áo Polo nam cổ bẻ ngắn tay, chất liệu cao cấp, thoáng mát, bền màu, thiết kế trẻ trung – FORMEN SHOP – FMPS147",99000,199000,100000,50
TIKI,thoi-trang-nam,44834030,"Áo Hoodie  Phong Cách Nam Màu Trơn Dễ Mặc - FMGV16_05",75000,75000,0,0
TIKI,thoi-trang-nam,127267574,"Áo Khoác Nỉ Hoodie PURBSSO KNN36",100000,100000,0,0
TIKI,thoi-trang-nam,117083129,"Áo khoác dù nam nữ chạy sọc tay siêu đẹp,phong cách cá tính tự tin,vải dù 2 lớp chống nắng giử nhiệt hiệu quả,Áo khoác dù 1 sọc ,áo khoù dù , áo khoác gió",102000,102000,0,0
TIKI,thoi-trang-nam,179162571,"ÁO SƠ MI TAY DÀI CARO CÓ TÚI BIG SIZE NAM TỚI 130KG",230000,230000,0,0
TIKI,thoi-trang-nam,179163025,"(Bigsizenam <130kg) Áo thun nam dài tay big size nam",200000,200000,0,0
TIKI,thoi-trang-nam,69000357,"MỚI  ÁO HOODIE NỈ NGOẠI Basic (HD810 - Trơn)",94900,94900,0,0
TIKI,thoi-trang-nam,198262051,"Áo khoác nam Aligro 2 lớp màu xanh lá chất liệu vải cotton mịn, đanh không xù, thoáng khí ALGAKG8",890000,890000,0,0
TIKI,thoi-trang-nam,14694657,"Áo khoác gió cách nhiệt GOKING, form unisex cho nữ nam. Ngoài vải dù, trong lót vải cào cách nhiệt. Hàng Việt Nam chất lượng cao",235000,235000,0,0
TIKI,thoi-trang-nam,72881856,"Quần lót nam thun lạnh không đường may, sịp đùi nam cao cấp kiểu dáng boxer nam ôm sát, chất liệu su thoáng mát, mềm mịn và mỏng nhẹ, quần lót cạp nhỏ đơn giản với màu trơn QLW806",135000,135000,0,0
TIKI,thoi-trang-nam,130287356,"Quần Tây Nam Oscar Regular Fit OCMPKR 007 - Quần Âu nam công sở dáng đứng giữ form, mềm mịn, thoáng mát, chống nhăn, thấm hút hiệu quả",449000,1290000,841000,65
TIKI,thoi-trang-nam,184898955,"Quần lót nam brief RLTK060 quần sịp nam thoáng mát mềm mại cao cấp, co giãn tốt, ôm gọn - RELAX",109000,109000,0,0
TIKI,thoi-trang-nam,91245826,"Áo Khoác Nam Dù 2 lớp Xin có túi trong khóa kéo túi ngoài, Áo khoác Nam trắng trơn thương hiệu Julido Store KFF01",149000,199000,50000,25
TIKI,thoi-trang-nam,191778890,"Áo polo nam May 10 mã 140122033",265000,265000,0,0
TIKI,thoi-trang-nam,76165828,"Quần tây nam 1 ply ống đứng đen Khatoco Q1M478R1-CNMA026-2411-1",363000,478000,115000,24
TIKI,thoi-trang-nam,163905753,"Áo Sơ Mi Nam Xám Ghi Ngắn Tay Công Sở Trung Niên Thương Hiệu Anton Vải Sợi Tre Kẻ Caro Trắng – GD551",265000,355000,90000,25
TIKI,thoi-trang-nam,3714983,"Combo 5 Quần Lót Boxer Nam Freeman 6513-CB5-XL (Size",495000,495000,0,0
TIKI,thoi-trang-nam,184898944,"Quần lót nam brief RLTK048 quần sịp nam thoáng mát mềm mại cao cấp, co giãn tốt, ôm gọn - RELAX",109000,109000,0,0
TIKI,thoi-trang-nam,67516773,"Áo sơ mi nam tay ngắn form slim sọc ngang tím Khatoco A1MN538S1-CNSC006-2102-N",239000,538000,299000,56
TIKI,thoi-trang-nam,194040292,"Áo sơ mi nam tay ngắn cổ vest hoạ tiết đường phố LADOS - 8081 co giãn, thấm hút mồ hôi, sang trọng",259000,259000,0,0
TIKI,thoi-trang-nam,170502080,"Quần Kaki Nam Chất Cao Cấp Siêu nhẹ Dáng Âu Phong Cách Công Sở VICERO",200000,318000,118000,37
TIKI,thoi-trang-nam,160291057,"OWEN - Áo sơ mi dài tay Owen Sợi Sồi mềm mát màu xanh bạc hà 23417",598000,598000,0,0
TIKI,thoi-trang-nam,190490081,"Áo Khoác Việt Tiến Phom mới 6Q5006 Áo Jacket nam Áo khoác 2 lớp Viettien",650000,650000,0,0
TIKI,thoi-trang-nam,195781338,"Viettien - Quần kaki nam màu xanh đen 0ly 6R6076 regular dáng rộng - Quần kaki cao cấp trung niên Việt Tiến",695000,695000,0,0
TIKI,thoi-trang-nam,163919880,"Áo Sơ Mi Nam Xanh Ngọc Ngắn Tay Công Sở Thương Hiệu Anton Trung Niên Sợi Tre Họa Tiết -GD560",265000,325000,60000,18
TIKI,thoi-trang-nam,67526051,"MAY 10 - Quần ĐÙI mặc nhà + mặc ngủ (HÀNG HIỆU GIÁ SHOCK)",65000,65000,0,0
TIKI,thoi-trang-nam,169908972,"Quần short thun nam thể thao có túi LADOS - 4060 năng động, mặc ở nhà, đi chơi, tập gym",209000,209000,0,0
TIKI,thoi-trang-nam,14678664,"Quần Jogger Kaki Nam Đen JOGGER98 (Jogger)",95000,95000,0,0
TIKI,thoi-trang-nam,101657805,"Áo Khoác Dạ Nam Hàn Quốc Dáng Dài Áo Măng Tô Nam Hàn Quốc Sans01 Sans Shop",399000,399000,0,0
TIKI,thoi-trang-nam,117583504,"ÁO KHOÁC KAKI CARO NAM THƠI TRANG CHO MUA XUÂN",190000,190000,0,0
TIKI,thoi-trang-nam,163903477,"Áo Sơ Mi Nam Xanh Dương Ngắn Tay Anton Công Sở Trung Niên Vải Sợi Tre Kẻ Trắng – GD553",265000,355000,90000,25
TIKI,thoi-trang-nam,74811114,"Quần baggy nam Amazing, chất liệu kaki, lưng thun có giây rút, form ôm Unisex, tôn dáng đẹp, trẻ trung",253000,385000,132000,34
TIKI,thoi-trang-nam,14695097,"Áo sơ mi trắng dài tay Việt Tiến 500",590000,590000,0,0
TIKI,thoi-trang-nam,73125633,"Áo khoác dạ nam hàn quốc dáng dài NAD67 - M",1450000,1450000,0,0
TIKI,thoi-trang-nam,123204495,"Quần lót nam thun brief Espresso iBasic PANM102",59000,99000,40000,40
TIKI,thoi-trang-nam,107890267,"Áo khoác dù bomber nam nữ cúc bấm logo chữ K sắc nét",94000,94000,0,0
TIKI,thoi-trang-nam,108359020,"Áo Hoodie Họa Tiết Con Bò Sữa Cặp Nam Nữ Chất Nỉ PE Cotton Cao Cấp, Áo khoác Hoodie Zip Nỉ Bông Bò Sữa unisex nam nữ đều mặc được Có Clip Cận Chất,  Áo hoodie nam / áo hooodie nữ /Áo Hoodie/ Áo Khoác Nỉ Bông Bò Sữa Form Rộng Unisex Nam Nữ HOT TREND 2021",100000,100000,0,0
TIKI,thoi-trang-nam,89266198,"ÁO KHOÁC NỈ HOODIE GẤU NAM NỮ UNISEX - GIN STORE",114000,114000,0,0
TIKI,thoi-trang-nam,52343026,"Áo Sơ Mi Nam Phối Caro Phong Cách Trẻ Trung",115000,115000,0,0
TIKI,thoi-trang-nam,111850645,"Bộ Quần Áo KaKi Lính Mỹ US ARMY U569 Kiểu Dáng Túi Hộp Chiến Thuật, Chất Liệu Kaki Cao Cấp Phong Cách Lính Cực Ngầu - HÀNG CHÍNH HÃNG",899000,1798000,899000,50
TIKI,thoi-trang-nam,198115338,"Quần lính, quần dài nam, quần kaki nam, Quần chiến thuật lính S.archon cao cấp ARM-1056",600000,600000,0,0
TIKI,thoi-trang-nam,103243177,"Quần Sịp Nam Chữ V Nâng Mông Siêu Thoáng K367 - Trắng - L",65000,65000,0,0
TIKI,thoi-trang-nam,176608368,"Áo Sơ Mi Oxford Nam Dài Tay Logo Classics Giordano 01042043",498000,940000,442000,47
TIKI,thoi-trang-nam,29115771,"Quần Jogger Nam Thun Nỉ Ống Bó Có Big Size",122000,122000,0,0
TIKI,thoi-trang-nam,112990508,"ÁO KHOÁC HOODIE. ÁO KHOÁT HOOIDE STICK NAM NỮ",101000,101000,0,0
TIKI,thoi-trang-nam,67656086,"Quần Jogger thể thao Quần tập gym nam 3 sọc dài Q-01",68000,68000,0,0
TIKI,thoi-trang-nam,184901063,"Quần lót nam brief RLTK064 quần sịp nam thoáng mát mềm mại cao cấp, co giãn tốt, ôm gọn - RELAX",109000,109000,0,0
TIKI,thoi-trang-nam,116096207,"Áo sơ mi dài tay nam TUTO5 sơ mi công sở họa tiết sọc kẻ caro Extra Slim fit Shirt cotton chống nhăn cao cấp phong cách trẻ trung, nam tính",479000,479000,0,0
TIKI,thoi-trang-nam,71908855,"Quần lót nam cao cấp thun cotton co giãn và thấm hút mồ hôi tốt, sịp nam tam giác kiểu dáng hiện đại trẻ trung, cạp to nam tính và co giãn thoải mái",99000,135000,36000,27
TIKI,thoi-trang-nam,162865525,"áo khoác Bomber, Áo khoác bomber 2 lớp phối tay đen trắng freesize form rộng nam nữ mặc đồ đôi cực ngầu",99000,99000,0,0
TIKI,thoi-trang-nam,194099667,"Quần short kaki nam cao cấp, dáng đứng form, chất liệu mềm mại thoáng mát - FORMENSHOP - FMQL014",99000,350000,251000,72
TIKI,thoi-trang-nam,85086751,"Áo sơ mi nam trắng chuẩn soái ca",159000,159000,0,0
TIKI,thoi-trang-nam,79546542,"Quần Short Nam Kaki Vicero 6 Màu Phong Cách Hàn Quốc",159000,298000,139000,47
TIKI,thoi-trang-nam,183736730,"Quần kaki dài nam việt tiến màu be không ly 6R6020 Regular",665000,665000,0,0
TIKI,thoi-trang-nam,193738850,"Áo Thun Local Brand Teeworld Love Yourself Premium T-shirt Nam Nữ Form Rộng Unisex",350000,350000,0,0
TIKI,thoi-trang-nam,94522304,"Quần tây truyền thông Amazing, ống xuông, không ly, vải dày có vân chìm, thấm hút tốt, có size lớn 105kg",348000,528000,180000,34
TIKI,thoi-trang-nam,151801574,"QUẦN LÓT NAM - TAM GIÁC LƯỚI - THOÁNG MÁT",59000,59000,0,0
TIKI,thoi-trang-nam,117902589,"ÁO HOODIE NÓN NAM NỮ MÀU ĐEN VẢI NỈ POLY IN SÚNG NƯỚC Unisex hoodie,Áo Khoác Nỉ Hoodie In Datlity, Áo Khoác Nỉ Hoodie Unisex Nam Nữ Cao Cấp",100000,100000,0,0
TIKI,thoi-trang-nam,82947907,"Bộ Mặc Nhà Thể Thao Nam Chất Liệu Cao Cấp Mùa Hè 4 Màu ZERO",199000,300000,101000,34
TIKI,thoi-trang-nam,54801175,"Áo Thun Nam Ngắn Tay Cổ Tròn Trơn Basic  Form Rộng Navy Wave Phong Cách, Trẻ Trung Cao Cấp Hàng Việt Nam Xuất Khẩu",199000,199000,0,0
TIKI,thoi-trang-nam,90063534,"Áo khoác sơ mi nam , áo sơ mi nam , áo khoác nam kiểu sơ mi vải dù",118000,118000,0,0
TIKI,thoi-trang-nam,115093792,"Sịp đùi- Quần lót nam boxer băng lụa kháng khuẩn siêu thoáng khí K118",69000,69000,0,0
TIKI,thoi-trang-nam,13306746,"Quần Jogger Nam Ống Bó Thời Trang Hàn Quốc JOGGER04",88000,88000,0,0
TIKI,thoi-trang-nam,47815627,"Combo 2 Quần shorts thể thao nam ( Tặng 1 áo thun nam ngẫu nhiên theo cân nặng ) dạng sọt sport đùi chất thun lạnh 4 chiều cao cấp phù hợp tập gym hay mặc nhà màu trắng và đen DUI-P101",179000,255000,76000,30
TIKI,thoi-trang-nam,181169393,"Áo khoác hoodie nam nữ mặc được hình mặt cười cực đẹp",120000,120000,0,0
TIKI,thoi-trang-nam,193978418,"Quần Jean nam Leman xám khói trơn JD13 - Slim Form",549000,549000,0,0
TIKI,thoi-trang-nam,30684522,"Áo Sơ Mi Nam Tay Ngắn Form Slim Khatoco A1MN438S1-CNMA001-2102-N - Size",291000,438000,147000,34
TIKI,thoi-trang-nam,13632609,"Quần jean nam ống suông Q61 (Xanh đen )",170000,170000,0,0
TIKI,thoi-trang-nam,163580450,"Áo Sơ Mi Nam Công sở Trung Niên Ngắn Tay Thương Hiệu Anton Kẻ Caro Màu Nâu Sợi Tre Thấm Hút NC135",295000,425000,130000,31
TIKI,thoi-trang-nam,94879183,"Áo sơ mi ngắn tay việt tiến màu đỏ đô",300000,300000,0,0
TIKI,thoi-trang-nam,90723093,"Áo Khoác Big Size Nam Nữ Áo Khoác Dù Nam Nữ Chống Nắng Chống Nóng Chống Tia Cực Tím UV Chống Lạnh Gió Hàn Quốc Cao Cấp ShopN6 - TM19",149000,169000,20000,12
TIKI,thoi-trang-nam,59519839,"QUẦN LÓT BOXER NAM ROSSO - APPLE 0303",39000,39000,0,0
TIKI,thoi-trang-nam,185709557,"Áo thun Polo nam Novelty màu đỏ in họa tiết NATMHTMPSR190213N",222000,239000,17000,7
TIKI,thoi-trang-nam,111676895,"OWEN - Quần kaki Owen màu xanh navy 91735 - Quần kaki nam",595000,595000,0,0
TIKI,thoi-trang-nam,95071979,"Quần Short Jean Nam co dãn kiểu dáng trẻ trung đơn giản Thương Hiệu Chandi, quần sọt mẫu mới xu hướng QSJN250",150000,299000,149000,50
TIKI,thoi-trang-nam,159054187,"ÁO KHOÁC BOMBER NAM NỮ CỰC CHẤT",108000,108000,0,0
TIKI,thoi-trang-nam,50602762,"Áo Sweater Nỉ Chui Trơn Nam Nữ Đều Mặc Được Dễ Dàng Phối Đồ",93000,93000,0,0
TIKI,thoi-trang-nam,117583112,"ÁO KHOÁC BOMBER NAM CHẤT LIỆU DÙ CAO CẤP THỜI TRANG NAM 2021",155000,155000,0,0
TIKI,thoi-trang-nam,76370129,"Áo sơ mi dài tay nam TUTO5 sơ mi công sở họa tiết sọc kẻ caro Slim fit Shirt cotton chống nhăn cao cấp phong cách trẻ trung, nam tính - 115123037",449000,449000,0,0
TIKI,thoi-trang-nam,163543299,"Áo Thun Nam PoLo Ngắn Tay 8 Màu Thời Trang Cao Cấp AVIANO",129000,258000,129000,50
TIKI,thoi-trang-nam,88081909,"Quần Áo Thể Thao, Sét Bộ Thể Thao Nam DINKBHAYS, Bộ Đồ Thể Thao Nam Chất Đẹp, Đồ bộ thể thao nam, set quần áo thể thao nam nữ mặc nhà Unisex tay ngắn phong cách Ulzzang, Set Bộ Quần Áo Thể Thao Nam Mùa hè Co Dãn, SÉT ĐỒ BỘ THỂ THAO MẶC NHÀ, đồ bộ mặc nhà ",99000,99000,0,0
TIKI,thoi-trang-nam,71153341,"Áo thun nam ngắn tay cổ tim cúc ngực thời trang Sitaki cao cấp ATN04-5 màu",80000,80000,0,0
TIKI,thoi-trang-nam,7252979,"Áo thun nam cổ tròn 100% cotton cao cấp Doka CT-01 ( Xám lợt )",104000,104000,0,0
TIKI,thoi-trang-nam,141111076,"Quần jogger unisex thể thao, quần ống rộng kiểu dáng jogger mặc nhà nam nữ vải TỔ ONG",79000,79000,0,0
TIKI,thoi-trang-nam,160814353,"quần lót nam relax thun lạnh cao cấp chính hãng, quần sịp nam relax underwear rl036",69000,69000,0,0
TIKI,thoi-trang-nam,159382032,"quần lót nam relax dệt kim cao cấp chính hãng, quần sịp nam relax underwear rltk14",102000,102000,0,0
TIKI,thoi-trang-nam,49733157,"Quần bơi nam dáng lửng, mẫu mới 2020, vải bơi dày dặn đẹp, co giãn 4 chiều | BN005",115000,115000,0,0
TIKI,thoi-trang-nam,181114107,"Quần đùi kate nam trơn co giãn có túi LADOS - 4071 thoáng mát, nhiều màu sắc lựa chọn",129000,129000,0,0
TIKI,thoi-trang-nam,98642493,"Áo thun Teeworld Outer Space T-shirt Form Rộng Unisex Nam Nữ",339000,339000,0,0
TIKI,thoi-trang-nam,182139764,"Viettien - Quần kaki nam màu be có 1ly 6R6021 regular",665000,665000,0,0
TIKI,thoi-trang-nam,115981807,"Áo Khoác Dù Bomber Bóng Chày 23 Nam Nữ Áo Khoác Gió Phối Màu Cặp đôi Couple Rẻ Đẹp - Bomber Jacket",97000,97000,0,0
TIKI,thoi-trang-nam,764366,"Quần Short Nam Phúc An 1001 - Đen",79000,79000,0,0
TIKI,thoi-trang-nam,162832750,"Áo khoác trái tym chất nỉ cotton giá rẻ bất ngờ có video và ảnh thật, Áo Khoác Nỉ Bomber Cardigan Form Rộng Chất Nỉ Bông Dày Dặn Nữ Unisex",100000,100000,0,0
TIKI,thoi-trang-nam,41531018,"Combo 3 quần lót nam Boxer sợi tre tự nhiên mềm mịn thoáng mát co giãn 4 chiều MRM Manlywear Tặng đôi tất nam Cao Cấp -Màu Ngẫu Nhiên",189000,270000,81000,30
TIKI,thoi-trang-nam,108849574,"Quần Kaki Dáng Âu Nam Thời Trang Thanh Lịch 4 Màu Thời Thượng ZERO",239000,350000,111000,32
TIKI,thoi-trang-nam,85087603,"Áo sơ mi nam ngắn tay vải không nhăn",108000,108000,0,0
TIKI,thoi-trang-nam,45300477,"Áo thun nam cá sấu tay dài dây kéo SITAKI ATD06",130000,130000,0,0
TIKI,thoi-trang-nam,174315711,"Áo Thun Polo Nam Tay Ngắn Unisex thương hiệu Chandi thiết kế cố bẻ thêu không bong tróc khi giặt PLN7",220000,220000,0,0
TIKI,thoi-trang-nam,71979063,"Áo len gile nam aligro đỏ đô kẻ viền",500500,500500,0,0
TIKI,thoi-trang-nam,84821897,"Sịp Đùi- Quần Lót Nam Boxer Cotton Siêu Mềm Form To Thoáng Khí Họa Tiết Chữ 3D K459",50000,50000,0,0
TIKI,thoi-trang-nam,184901328,"Quần lót nam brief RLTK017 quần sịp nam thoáng mát mềm mại cao cấp, co giãn tốt, ôm gọn - RELAX",96000,96000,0,0
TIKI,thoi-trang-nam,144317186,"Bộ vest nam Viettien màu xám regular 1Q9503",2605000,2605000,0,0
TIKI,thoi-trang-nam,139602560,"Áo Khoác Thể Thao Nam Giordano 01071222",1190000,1190000,0,0
TIKI,thoi-trang-nam,67516552,"Áo sơ mi nam tay ngắn form slim sọc ngang hồng Khatoco A1MN538S1-CNSC004-2102-N",239000,538000,299000,56
TIKI,thoi-trang-nam,184899117,"Quần lót nam brief RLTK013 quần sịp nam thoáng mát mềm mại cao cấp, co giãn tốt, ôm gọn - RELAX",104000,104000,0,0
TIKI,thoi-trang-nam,73100612,"Áo khoác dù nam 2 lớp thêu N",89000,89000,0,0
TIKI,thoi-trang-nam,163895036,"Áo Sơ Mi Nam Trắng Ngắn Tay Công Sở Trung Niên Thương Hiệu Anton Vải Nano SRN01",265000,380000,115000,30
TIKI,thoi-trang-nam,181136924,"Áo sơ mi nam Slim fit ngắn tay tím nhạt NSMMMTMMMR171426N",144000,479000,335000,70
TIKI,thoi-trang-nam,73409755,"ÁO LEN GILE NAM ALIGRO - MÀU XANH DƯƠNG ALENGL012",364000,364000,0,0
TIKI,thoi-trang-nam,171901581,"Áo khoác nam mới đẹp lót lông nhung cao cấp thời trang thời trang-A1018",177450,177450,0,0
TIKI,thoi-trang-nam,97360861,"Combo 4 quần lót nam, sịp đùi nam hàng đẹp",87000,87000,0,0
TIKI,thoi-trang-nam,169051826,"Áo sơ mi nam Novelty ngắn tay 171435 vạt bầu Form Slim Fit ôm Body",199000,469000,270000,58
TIKI,thoi-trang-nam,164817080,"Áo thun sweater Tay Dài LADOS 9071 - trẻ trung, năng động, form rộng thoải mái",259000,259000,0,0
TIKI,thoi-trang-nam,109407224,"ÁO KHOÁC DÙ ,ÁO KHOÁC DÙ BOMBER NAM CỰC ĐẸP - PHONG CÁCH HÀN QUỐC - 2021 THỜI TRANG MỚI KINGSHOP79",107000,107000,0,0
TIKI,thoi-trang-nam,181142190,"Áo sơ mi nam Slim fit ngắn tay hồng đậm 170284N",159000,449000,290000,65
TIKI,thoi-trang-nam,173998078,"Quần Jean nam Leman xanh trơn JD04 - Slim Form",549000,549000,0,0
TIKI,thoi-trang-nam,178247910,"Áo Khoác ACOVER dù Jacket Form Rộng PALY Phong Cách Ulzzang, Áo Khoác Dù Logo In Chữ ACOVER Vô Cùng Đẹp Mắt,Chất Dù 2 Lớp Cao Cấp Hót Trend, Áo Khoác Dù Jacket 2 Lớp ACOVER Unisex Nam Nữ, Áo Jacket dây kéo Ulzzang",99000,99000,0,0
TIKI,thoi-trang-nam,150214417,"Quần kaki tím than túi hộp bảo hộ lao động SHUNI loại dày",129000,129000,0,0
TIKI,thoi-trang-nam,58732140,"Áo gile nam",370000,370000,0,0
TIKI,thoi-trang-nam,184901608,"Quần lót nam trunk RLTK065 quần sịp nam thoáng mát mềm mại cao cấp, co giãn tốt, ôm gọn - RELAX",119000,119000,0,0
TIKI,thoi-trang-nam,163436248,"Áo Sơ Mi Nam Công Sở Trung Niên Ngắn Tay Anton Màu Xanh Than Thoáng Mát, Thấm Hút Mồ Hôi - XNC130",295000,425000,130000,31
TIKI,thoi-trang-nam,15135625,"Áo Khoác Dù Nam Chống Nắng Chống Lạnh Phối Cổ Cao Cấp AB21",159000,265000,106000,40
TIKI,thoi-trang-nam,54583055,"Áo khoác hooide trơn cá tính, năng động - FORMENSHOP - FM5GV016",101000,199000,98000,49
TIKI,thoi-trang-nam,106886142,"OWEN - Áo sơ mi ngắn tay Owen vải sợi sen AS90774 - Áo sơ mi nam ngắn tay",628000,628000,0,0
TIKI,thoi-trang-nam,179746188,"Áo Khoác Dù Nam Basic Dây Kéo Sọc Màu Couple TX MOP 1021",559000,559000,0,0
TIKI,thoi-trang-nam,15132079,"Áo Khoác Da Nam Đen Lót Lông Cao Cấp AKD22",269000,420000,151000,36
TIKI,thoi-trang-nam,50079513,"Áo Jacket Nam 2 Lớp Novelty NJKMMDMPLR1806542 - Màu Xanh Ve Chai",399000,399000,0,0
TIKI,thoi-trang-nam,104909650,"Quần đùi mặc nhà chất thun cotton 100% thương hiệu Fezzio",42500,85000,42500,50
TIKI,thoi-trang-nam,114278010,"Áo thun Teeworld TW x Vietnamese Food - Ca Phe Sua Da Nam Nữ Trắng Đen Form Rộng Unisex",359000,359000,0,0
TIKI,thoi-trang-nam,117585187,"Áo Khoác Dù Nam Kiểu Bomber",189000,189000,0,0
TIKI,thoi-trang-nam,49268992,"QUẦN JOGGER KAKI NAM",89000,89000,0,0
TIKI,thoi-trang-nam,95064066,"Quần Short Jean Nam co dãn kiểu dáng trẻ trung đơn giản Thương Hiệu Chandi, quần sọt mẫu mới xu hướng QSJN300",149000,149000,0,0
TIKI,thoi-trang-nam,174012874,"Quần Jean nam Leman xanh rách JD07 - Slim Form",449000,449000,0,0
TIKI,thoi-trang-nam,129299158,"quần kaki thô nam trung niên cao cấp mềm mịn có co giãn",349000,349000,0,0
TIKI,thoi-trang-nam,160910728,"Áo Hoodie TMAG - BLUE WORLD HOODIE - Hàng Chính Hãng",360000,480000,120000,25
TIKI,thoi-trang-nam,193367063,"OWEN - Áo sơ mi dài tay Owen regular fit chất sợi tre kẻ ca rô xanh - Áo sơ mi nam dài tay kẻ ca rô",598000,598000,0,0
TIKI,thoi-trang-nam,54761601,"Áo sơ mi nam tay dài trơn Khatoco A1MD360T1- CNTR011-2409-D - Trắng",325000,360000,35000,10
TIKI,thoi-trang-nam,111709266,"Áo thun nam Áo polo nam ngắn tay có cổ PN03 Cotton 100% cao cấp phong cách Hàn Quốc",125000,125000,0,0
TIKI,thoi-trang-nam,85705434,"Áo Chống Nắng Nam Cotton Laroma| UPF50+ | Vải Thơm | Làm Mát | Thời Trang | Đa Dụng",359000,359000,0,0
TIKI,thoi-trang-nam,174006978,"Quần Jean nam Leman xanh trơn JD05 - Slim Form",549000,549000,0,0
TIKI,thoi-trang-nam,101656387,"Áo Khoác Dạ Nam Dáng Dài - Áo Mangto Nam Hàn Quốc Sans16",629000,629000,0,0
TIKI,thoi-trang-nam,187936785,"Áo gile túi hộp, áo gile nam, áo phóng viên",450000,450000,0,0
TIKI,thoi-trang-nam,144526512,"Áo dạ nam - kiểu dáng hiện đại, style Hàn Quốc (R8)",299000,299000,0,0
TIKI,thoi-trang-nam,95310196,"Áo thun nam Polo NOVELTY dệt họa tiết 210136N",469000,469000,0,0
TIKI,thoi-trang-nam,110152115,"Áo sơ mi dài tay nam TUTO5 sơ mi công sở họa tiết sọc kẻ Slim fit Shirt cotton chống nhăn cao cấp phong cách trẻ trung, nam tính",399000,399000,0,0
TIKI,thoi-trang-nam,247879461,"Quần bơi nam tam giác màu trơn kẻ sọc, đồ bơi nam đi biển đẹp QBUXH03",130000,130000,0,0
TIKI,thoi-trang-nam,124766433,"Quần thể thao nam nữ, quần jogger ống suông 3 sọc 1 sọc chất dày dặn, vải cao cấp Joger",70000,70000,0,0
TIKI,thoi-trang-nam,193981069,"Quần Jean nam Leman đen mài xám JD14 - Slim Form",549000,549000,0,0
TIKI,thoi-trang-nam,181137513,"Áo sơ mi nam Slim fit ngắn tay tím đậm 171434N",159000,469000,310000,66
TIKI,thoi-trang-nam,106886067,"OWEN - Áo sơ mi dài tay Owen SLIMFIT màu trắng in vân AS 90017 - áo sơ mi trắng",620000,620000,0,0
TIKI,thoi-trang-nam,25084178,"Hộp combo 5 sịp đùi boxer SQB101 BLACK",199000,199000,0,0
TIKI,thoi-trang-nam,16721295,"VEST NAM PHONG CÁCH - CÓ 3 MÀU - ĐEN-XANH-XÁM - AVN009-200",185000,185000,0,0
TIKI,thoi-trang-nam,64275643,"Quần lót boxer nam Khatoco Q5M085R0-VNMA019-2112-B",65000,85000,20000,24
TIKI,thoi-trang-nam,10922941,"Áo phông hàng hiệu Goking, quà tặng cao cấp cho gia đình, cặp đôi, lớp nhóm, doanh nghiệp, người nước ngoài. Áo thun trơn basic, form unisex cho nam nữ",138000,138000,0,0
TIKI,thoi-trang-nam,134702556,"Áo Sơ Mi Form Rộng Unisex Nam Nữ Tay Dài Hàn Quốc Kiểu Cổ Vest Cổ Ve Áo Khoác Ngoài Vải Lụa Mềm Mịn - SMV01",87000,210000,123000,59
TIKI,thoi-trang-nam,55740133,"Quần lót nam tam giác thun cotton co giãn tốt, sịp nam cao cấp lưng thun cạp to, thiết kế trẻ trung đơn giản và sang trọng QLCC019",99000,135000,36000,27
TIKI,thoi-trang-nam,18013163,"Quần dài jogger nam viền đánh bông 1060",85500,85500,0,0
TIKI,thoi-trang-nam,167489550,"Quần kaki nam ống suông vải dày dặn, quần slimfit nam full size- tsstore95",169000,169000,0,0
TIKI,thoi-trang-nam,9820790,"Áo len gile Aligro màu nâu đỏ ALENGL015",500500,500500,0,0
TIKI,thoi-trang-nam,117082039,"ÁO KHOÁC KAKI NAM NỮ 2 LỚP NGOẠI, FORM RỘNG DÀY CHỐNG NẮNG LẠNH CAO CẤP,Áo Khoác Nữ và Nam KaKi Cao Cấp cặp đôi 2 lớp Form rộng Free Size từ 65kg trở xuống",140000,140000,0,0
TIKI,thoi-trang-nam,176292713,"Áo Bomber Nhung Gân Thêu G Chất Nhung Mịn Đẹp Form rộng Unisex Nam Nữ Couple jacket Varsity",160000,160000,0,0
TIKI,thoi-trang-nam,136790793,"OWEN - Áo khoác gió nam 2 lớp màu xÁM 61035- Áo khoác gió thể thao",1100000,1100000,0,0
TIKI,thoi-trang-nam,58625400,"Áo gile nam",500000,500000,0,0
TIKI,thoi-trang-nam,142779738,"Áo len cổ lọ nam dài tay vân zíc zắc cực ấm hàng cao cấp AL11 Micado",189000,378000,189000,50
TIKI,thoi-trang-nam,31202193,"Quần tây nam không ply ống đứng Khatoco Q1M528R0-CNMA035-2105-0",351000,528000,177000,34
TIKI,thoi-trang-nam,135075286,"Áo Sơ Mi Tay Ngắn Nam Nữ Form Rộng Sơ Mi Cổ Vest UNISEX Hàn Quốc Vải Lụa Giãn Mềm Mịn Mát - SMV02",80000,180000,100000,56
TIKI,thoi-trang-nam,193989559,"Quần Jean nam Leman xanh bạc rách JD18 - Slim Form",549000,549000,0,0
TIKI,thoi-trang-nam,94851076,"Quần Lót Nam Tam Giác Thương Hiệu Brave Person B1124 - Kiểu dáng thời trang phù hợp xu hướng giới trẻ - Chất liệu thun cao cấp co dãn 4 chiều - Thiết kế dạng lưới thoáng mát, mềm mịn",159000,199000,40000,20
TIKI,thoi-trang-nam,101656633,"Áo Khoác Dạ Nam Dáng Ngắn Áo Dạ Nam Dáng Vest Sans19 Sans Shop",690000,690000,0,0
TIKI,thoi-trang-nam,52406817,"Quần Short Nam Thể Thao Cao Cấp - Combo 2 quần màu trắng và đen",128800,199000,70200,35
TIKI,thoi-trang-nam,184076118,"Áo sơ mi nam, Áo Sơ Mi nam Dài tay cổ Vest phối 2 màu Đen - Trắng phong cách lịch lãm. Mã N22",209000,209000,0,0
TIKI,thoi-trang-nam,176553475,"Quần Short Gió Nam Thể Thao 5 Màu Kiểu Dáng Năng Động Thời Trang AVIANO",129000,258000,129000,50
TIKI,thoi-trang-nam,162530652,"Áo Sơ Mi Nam Công Sở Trung Niên Dài Tay Trắng Thương Hiệu Anton Vải Cotton Họa Tiết Chấm Bi Nhỏ  - 302",225000,295000,70000,24
TIKI,thoi-trang-nam,198194808,"Áo sơ mi nam ngắn tay cổ vest form đẹp LADOS 8085 vải đũi thấm hút, sang trọng dễ phối đồ",300000,300000,0,0
TIKI,thoi-trang-nam,188916034,"Quần Đùi Nam Thun Lạnh Cao Cấp FASVIN HL22497.HN Hàng Nhà Máy Chất Lượng Đặc Biệt",179000,338000,159000,47
TIKI,thoi-trang-nam,164022017,"Áo Sơ Mi Nam Công Sở Trung niên Dài Tay Thương Hiệu ANTON Đen Kẻ Sọc Cotton - AT206",295000,425000,130000,31
TIKI,thoi-trang-nam,184075392,"Áo khoác Blazer nam, Áo Vest Blazer Nam Phối màu Xanh Cô Ban phong cách Hot Trend trẻ trung. Mã N44",340000,340000,0,0
TIKI,thoi-trang-nam,42629498,"Quần kaki ống côn nam chất kaki mềm",85000,85000,0,0
TIKI,thoi-trang-nam,251275614,"Áo gile nam, áo gile lính ARM-920",320000,320000,0,0
TIKI,thoi-trang-nam,124748904,"quần tây đen việt tiến",690000,690000,0,0
TIKI,thoi-trang-nam,56492086,"Quần Short Kaki Túi Hộp Dành Cho Phái Mạnh",188000,188000,0,0
TIKI,thoi-trang-nam,101656078,"Áo Dạ Nam Áo Măng Tô Nam Dáng Dài Sẵn Hàng Chất Đẹp Sans Shop Sans02",639000,639000,0,0
TIKI,thoi-trang-nam,15993454,"Áo Khoác Nam Áo Khoác Kaki Nam Đơn Giản Cao Cấp-KK34",169000,270000,101000,37
TIKI,thoi-trang-nam,189677243,"Áo sơ mi nam ngắn tay trắng Classic NSMMMWNTCC220128N",199000,309000,110000,36
TIKI,thoi-trang-nam,3714895,"Combo 5 Quần Lót Nam Freeman 6041-CB5-M (Size",325000,325000,0,0
TIKI,thoi-trang-nam,35193565,"[FREEMAN] Combo 3 quần boxer nam BO501",237000,237000,0,0
TIKI,thoi-trang-nam,57786091,"Áo Khoác Kaki Nam 2 Lớp Giả Vest Phối Khóa Ngực Cao Cấp ShopN6 - KK42 (Nhiều Màu)",169000,245000,76000,31
TIKI,thoi-trang-nam,190195064,"Sơ mi măng sét Anlimen Gentle Cuff Shirt - AGS04",890000,890000,0,0
TIKI,thoi-trang-nam,107962045,"Quần Sịp Nam Tam Giác Thun Lạnh Kháng Khuẩn Co Giãn 4 Chiều Thông Minh",8500,8500,0,0
TIKI,thoi-trang-nam,72524903,"Aó hoodie nam , áo hoodie nữ , áo khoác áo hoodie cặp đôi nam nữ mặc",103000,103000,0,0
TIKI,thoi-trang-nam,169642344,"Quần Short Jean Nam co dãn kiểu dáng trẻ trung đơn giản Thương Hiệu Chandi, quần sọt mẫu mới xu hướng QSJN229",139000,250000,111000,44
TIKI,thoi-trang-nam,134490721,"Quần lót nam Tam giác chất thun mềm LADOS - 4113",38000,38000,0,0
TIKI,thoi-trang-nam,161952378,"Áo Khoác Nỉ Nam Cao Cấp - Vải Nỉ Nhập Mặt Thoáng Mát,Có Nón Che Rộng Cao Cấp AK016",105000,105000,0,0
TIKI,thoi-trang-nam,80620917,"Áo Khoác Dù Chống Nắng dành cho nam nữ và cặp đôi Có 2 Màu, Unisex Form Rộng DELLI Jacket Ulzzang",99000,99000,0,0
TIKI,thoi-trang-nam,184899220,"Quần lót nam brief RLTK023 quần sịp nam thoáng mát mềm mại cao cấp, co giãn tốt, ôm gọn - RELAX",96000,96000,0,0
TIKI,thoi-trang-nam,129298648,"áo khoác nam trung niên ẢNH THẬT 2 lớp không nhăn không nhàu siêu nhẹ",339000,339000,0,0
TIKI,thoi-trang-nam,3714693,"Combo 3 Quần Lót Nam Freeman 6005-CB3-XL (Size",195000,195000,0,0
TIKI,thoi-trang-nam,171477321,"Áo Thun Nam Ngắn Tay Có Cổ Chandi, Chất Thun Cotton Xịn Thấm Hút Mồ Hôi Mẫu Mới Hot Trend NT11",220000,220000,0,0
TIKI,thoi-trang-nam,71020058,"Combo 4 quần đùi mặc nhà chất liệu thun cotton cao cấp phom dáng năng động trẻ trung chính hãng Fezzio",238000,476000,238000,50
TIKI,thoi-trang-nam,183729019,"Áo Sơ Mi Nam, Áo Sơ Mi dài tay Cổ Vest phối 2 màu Đen Trắng phong cách trẻ trung, lịch lãm mã H50",199000,199000,0,0
TIKI,thoi-trang-nam,90066960,"(Video ) Áo khoác dù , áo khoác cặp đôi  , áo khoác gió , áo khoác nam kiểu bomber vải dù ngoại 2 lớp",98000,98000,0,0
TIKI,thoi-trang-nam,71920655,"Áo khoác dù , áo khoác gió  nam nữ mặc , áo khoác nam nữ mặc vài dù 2 lớp size L và XL",97000,97000,0,0
TIKI,thoi-trang-nam,146515449,"Áo Khoác Nhung Gân Tăm Bomber Jackets Thêu Logo G.O.N.Z Cúc Bấm Unisex Nam Nữ Form Rộng Ulzzang, Áo Khoác Nhung Tăm Thêu Chữ G, Áo BomBer Bóng Chày Nam Nữ Phong Cách Hàn Quốc",166000,166000,0,0
TIKI,thoi-trang-nam,129300979,"Quần bò ngố quần sóc nam trung niên trung tuổi",129000,129000,0,0
TIKI,thoi-trang-nam,197693327,"Quần tây nam 0Ply Novelty màu đen Classic NQTMMDNTRC2203020",399000,479000,80000,17
TIKI,thoi-trang-nam,70903617,"Áo sơ mi nam ngắn tay cổ trụ thời trang SITAKI vải siêu chất SM801",175000,175000,0,0
TIKI,thoi-trang-nam,91533035,"Áo Hoodie Nỉ - Áo Khoác Nỉ Nam Nữ Unisex Nỉ BECHY 4 Màu Cực Hot, ÁO HOODIE GẤU BECHY, ÁO HOODIE UNISEX NAM NỮ ĐẦU MẶC ĐƯỢC, ÁO HOOIDE TAY PHỒNG ULZZANG, áo hoodie tránh mưa, chống nắng",99000,99000,0,0
TIKI,thoi-trang-nam,20518837,"Quần Kaki Nam Khatoco Q2M528S0-CNMA002-2006-0- Nâu Nhạt",189000,528000,339000,64
TIKI,thoi-trang-nam,97822276,"Áo khoác dù Handes cặp đôi nam nữ mặc siêu ngầu hình sói , chất dù 2 cao cấp 2 lớp - Form rộng Unisex size M  L  XL nam nữ mcawj tôn dáng đep - Áo khoác gió nam nữ",97000,97000,0,0
TIKI,thoi-trang-nam,130787763,"OWEN - Áo sơ mi dài tay Owen Slimfit chất sợi tre màu trắng sọc xanh 23305",568000,568000,0,0
TIKI,thoi-trang-nam,80975175,"Áo Thun Nam Có Cổ Tay Ngắn Polo Trơn Thời Trang VICERO 6 Màu",99000,198000,99000,50
TIKI,thoi-trang-nam,71955860,"Áo sơ mi nam họa tiết đi biển NOVELTY 200121N",195000,195000,0,0
TIKI,thoi-trang-nam,164947687,"ÁO SƠMI TRẮNG CÔNG SỞ CỔ CÁCH ĐIỆU NAM HÀN QUỐC 006370",1400000,1400000,0,0
TIKI,thoi-trang-nam,28938947,"Áo sơ mi nam dài tay màu xanh navy",159000,159000,0,0
TIKI,thoi-trang-nam,43161858,"Combo 4 quần sịp đùi nam quần lót nam Cao Cấp Boxer MRM FASHION (2 màu)",255000,360000,105000,29
TIKI,thoi-trang-nam,25277963,"Áo len dài tay nam thời trang Hàn Quốc SAL214",189000,189000,0,0
TIKI,thoi-trang-nam,137643038,"Áo Sơ Mi Nam Tay Ngắn Phối Caro In 3D Một Túi Thời Trang Nam Công Sở Cao Cấp Tạo Cảm Giác Thoải Mái Cho Người Mặc",169000,169000,0,0
TIKI,thoi-trang-nam,167402284,"Viettien - Áo sơ mi nam dài tay họa tiết 1N2094 chất liệu sợ tre regular",580000,580000,0,0
TIKI,thoi-trang-nam,41083401,"Combo 3 quần sịp nam quần lót nam Cao cạp nhỏ MRM FASHION",165000,225000,60000,27
TIKI,thoi-trang-nam,138563568,"áo khoác Bomber",93000,93000,0,0
TIKI,thoi-trang-nam,46699028,"Quần short thun nam có lưới thông hơi Phúc An 1051 màu",71100,71100,0,0
TIKI,thoi-trang-nam,40260666,"Quần lót nam sexy men thoáng khí - màu tím",45000,45000,0,0
TIKI,thoi-trang-nam,35193581,"[FREEMAN] Combo 5 quần lót nam 639",245000,245000,0,0
TIKI,thoi-trang-nam,68581385,"Áo thun nam tay lỡ form rộng in hình Naruto cực chất",60000,60000,0,0
TIKI,thoi-trang-nam,114744071,"Áo thun Teeworld Bánh Mì T-shirt Màu Trắng Đen Nam Nữ Form Rộng Unisex",339000,339000,0,0
TIKI,thoi-trang-nam,72673381,"Áo sơ mi nam trơn nhiều màu Amazing, vải Bamboo mềm mịn thấm hút, dáng truyền thống, vạt bầu, tay dài",253000,385000,132000,34
TIKI,thoi-trang-nam,173661116,"Combo 3 Quần Lót Nam RLTK033 Dạng Boxer",199000,199000,0,0
TIKI,thoi-trang-nam,34702589,"Áo khoác dạ nam dáng dài hàn quốc cổ lông NAD79",1250000,1250000,0,0
TIKI,thoi-trang-nam,87267258,"Quần lót dùng 1 lần Procare Cotton Nam",32000,32000,0,0
TIKI,thoi-trang-nam,145029744,"áo khoác cadigan nam nữ mẫu viền vàng xinh xắn Sumisu shop",120000,120000,0,0
TIKI,thoi-trang-nam,76258517,"Quần jocker nỉ chạy sọc caro, quần jogger chạy sọc, quần jogger phối sọc caro",89000,89000,0,0
TIKI,thoi-trang-nam,98675410,"Quần Short Nam Mặc Ngủ, Quần Thun Nam Mặc Nhà Brave Person B1164 - Form dáng trẻ trung, năng động, nam tính - Chất liệu thoáng mát, co dãn 4 chiều",142000,250000,108000,43
TIKI,thoi-trang-nam,94808227,"Quần ống rộng kẻ caro nam nữ - quần vải unisex- năng động thoải mái - Đổi trả free nếu không ưng hoặc hàng lỗi",97000,97000,0,0
TIKI,thoi-trang-nam,36573622,"Áo Sơ Mi Nam",115000,115000,0,0
TIKI,thoi-trang-nam,183731843,"Áo sơ mi nam, Áo sơ mi nam cổ Đức tay Lỡ, Phối sọc Nhấn vai nam tính, trẻ trung, lịch lãm h46",199000,199000,0,0
TIKI,thoi-trang-nam,20526128,"Áo Sơ Mi Nam Tay Dài Khatoco A1MD568S1-CNMK002-2102-D",354000,568000,214000,38
TIKI,thoi-trang-nam,102386244,"Combo 2 áo thun Tiedye nam Novelty Full Size 100% Cotton",312000,390000,78000,20
TIKI,thoi-trang-nam,56446427,"Quần Bơi Lửng Nam Phong Cách Chuyên Nghiệp Thời Trang Thể Thao SZone SQB119",99000,99000,0,0
TIKI,thoi-trang-nam,84594046,"Quần shorts Nam siêu mỏng vải dù - A029",190000,190000,0,0
TIKI,thoi-trang-nam,197603511,"Áo Khoác Da Nam, Áo Khoác Da Lót Lông Siêu Ấm Mùa Thu Đông Phối Khóa Đồng Cao Cấp Thời Trang Dokafashion EZAD28",499000,499000,0,0
TIKI,thoi-trang-nam,195775262,"Viettien - Áo sơ mi nam ngắn tay xẻ tà lai ngang 8N3631 ca rô phom slim fit may ôm dành cho giới trẻ hoặc trung niên thích phong cách trẻ",490000,490000,0,0
TIKI,thoi-trang-nam,197899578,"Áo gile nam, áo gile phóng viên nhiếp ảnh, áo gile công trường ARM-945",450000,450000,0,0
TIKI,thoi-trang-nam,58720667,"Áo Vest Nam Titishop AVN Đen 1 nút cài",599000,599000,0,0
TIKI,thoi-trang-nam,176301640,"Áo thun tay lỡ form rộng - phông nam nữ cotton oversize - T shirt summer - 2N Unisex",79000,79000,0,0
TIKI,thoi-trang-nam,189892112,"Áo khoác DirtyCoins Special Letters Monogram Hoodie",790000,790000,0,0
TIKI,thoi-trang-nam,178058271,"Áo thun tank top nam trơn LADOS-9085 vải cotton siêu mát mẻ,tập gym, chạy bộ, đi chơi",179000,179000,0,0
TIKI,thoi-trang-nam,83160055,"Áo sơ mi nam caro",157000,157000,0,0
TIKI,thoi-trang-nam,94879492,"Áo sơ mi việt tiến dài tay màu kem",350000,350000,0,0
TIKI,thoi-trang-nam,108850741,"Quần Dài Nam Chất Kaki Co Giãn Thời Trang Cao Cấp VICERO",239000,350000,111000,32
TIKI,thoi-trang-nam,52293352,"Áo Polo nam cổ bẻ ngắn tay, chất liệu vải cá sấu cotton cao cấp, trẻ trung, năng động – FORMEN SHOP – FMPS105",139000,199000,60000,30
TIKI,thoi-trang-nam,167025428,"Viettien - Áo sơ mi nam dài tay màu xanh đen 1M2808 chất liệu sợ tre regular",525000,525000,0,0
TIKI,thoi-trang-nam,3970625,"Áo Sơ Mi Nam Aligro Màu Sọc Trắng ALG1008",599500,599500,0,0
TIKI,thoi-trang-nam,70790578,"Quần Baggy Nam Kaki Ống Suông Unisex - Kiểu quần baggy kaki nam nữ thun vải đen và be tan, xám",79000,79000,0,0
TIKI,thoi-trang-nam,113066232,"Sét đồ bộ mặc nhà nam- đồ thể thao nam in hình GẤU",103000,103000,0,0
TIKI,thoi-trang-nam,163882883,"Áo Sơ Mi Nam Công Sở Trung Niên Dài Tay Anton Vải Sợi Tre Xanh Lục Thấm Hút Mồ Hôi - AT204",325000,395000,70000,18
TIKI,thoi-trang-nam,79007628,"Quần Short Jean cao cấp co dãn tốt Thương Hiệu Chandi, phong cách hàn quốc mẫu mới nhất MR8010",150000,299000,149000,50
TIKI,thoi-trang-nam,98985299,"Áo thun Teeworld TW x Vietnamese Food - Hot Vit Lon Form Rộng Unisex Nam Nữ",359000,359000,0,0
TIKI,thoi-trang-nam,39088060,"Quần Jogger Nam Nữ - Cực Chất",182000,182000,0,0
TIKI,thoi-trang-nam,163877732,"Áo Sơ Mi Nam Công Sở Trung Niên Anton Vải Sợi Tre Ngắn Tay màu xám Thấm Hút Mồ Hôi - XNT202",295000,425000,130000,31
TIKI,thoi-trang-nam,6925731,"Quần thun dài jogger nam Phúc An 1011 màu đen",115000,115000,0,0
TIKI,thoi-trang-nam,95054026,"Áo Khoác Big Size Unisex Áo Khoác Kaki Nam Nữ Chống Lạnh Chống Nắng Chống Nóng Chống Gió Có Túi Có Cổ Bẻ Hàn Quốc Thời Trang Cao Cấp QK48 - ShopN6",179000,189000,10000,5
TIKI,thoi-trang-nam,20832274,"Áo Khoác Da Nam Lót Lông Simple Cao Cấp KD06",275000,435000,160000,37
TIKI,thoi-trang-nam,184309258,"Áo sơ mi casual tay dài sọc dọc WS21FH88C-LC - RED, RED",700000,700000,0,0
TIKI,thoi-trang-nam,184899700,"Quần lót nam trunk RLTK063 quần sịp nam thoáng mát mềm mại cao cấp, co giãn tốt, ôm gọn - RELAX",109000,109000,0,0
TIKI,thoi-trang-nam,183755187,"Áo khoác nam, Áo khoác mùa xuân phiên bản hàn quốc. Phong cách nam tính lịch lãm đễ phối đồ, Mã T66",280000,280000,0,0
TIKI,thoi-trang-nam,176420130,"Áo khoác nam nữ in chữ màu nổi bật năng động cá tính chất vải siêu xịn, Áo Khoác Nón Chui Trùm Đầu Nữ Nam Unisex Nỉ Poly",105000,105000,0,0
TIKI,thoi-trang-nam,43230254,"Áo sơ mi nam tay dài trắng công sở vải Oxford cao cấp SM03",229000,229000,0,0
TIKI,thoi-trang-nam,189681762,"Áo sơ mi nam ngắn tay sọc nhỏ Regular fit NSMMSNMTCR212826N",199000,315000,116000,37
TIKI,thoi-trang-nam,146231681,"Áo polo nam ADINO màu xanh đen phối viền vải cotton co giãn dáng slimfit trẻ trung AP75",139000,278000,139000,50
TIKI,thoi-trang-nam,186359252,"Áo Sơ Mi nam tay dài sọc nhỏ NSMMSNMTCR210230D",319000,319000,0,0
TIKI,thoi-trang-nam,94775934,"Quần jogger nam nữ vải kaki co giãn ống bó khóa zip cá tính (k1)",92000,92000,0,0
TIKI,thoi-trang-nam,10075781,"Áo softshell k100",325000,325000,0,0
TIKI,thoi-trang-nam,88020921,"Áo khoác dù kiểu bomber in ENJOG cá tính, thời trang, Áo khoác dù Bomber chữ phối màu Unisex nam nữ, Áo khoác dù nam nữ mặc / áo khoác gió nam nữ mặc / áo khoác dù kiểu bomber / áo khoác cặp đôi / áo khoác form rộng, Áo Khoác Nam Nữ Unisex - Áo Jacket Bom",99000,99000,0,0
TIKI,thoi-trang-nam,83519755,"ÁO THUN NAM DÀI TAY CỔ SƠ MI  ATD01",193700,193700,0,0
TIKI,thoi-trang-nam,117604181,"Áo Sơ mi Nam Nữ Unisex vải Nhung Gân áo khoác sơ mi form rộng ảnh thật",160000,160000,0,0
TIKI,thoi-trang-nam,142781435,"Áo len dài tay nam cổ lọ phối kẻ ngang phong cách trẻ trung AL12 Micado",189000,378000,189000,50
TIKI,thoi-trang-nam,146504750,"Áo Khoác Dù Nam Nữ, Áo Khoác Chống Nắng in Hình Khủng Long Xinh Xinh.Tp TKT",150000,150000,0,0
TIKI,thoi-trang-nam,121262057,"Áo thun trơn tay ngắn LADOS - 9021, chất thun cotton 4 chiều dày đẹp, không đổ lông, không ra màu",199000,199000,0,0
TIKI,thoi-trang-nam,67429010,"Quần jogger nỉ nam ( hình thật ) , quần nỉ nam, quần thể thao nam, quần nỉ nữ, quần thể thao, quần jogger,quần 1sọc phối",82000,82000,0,0
TIKI,thoi-trang-nam,169617467,"Viettien - Áo sơ mi nam ngắn tay ca rô vạt bầu 1N0526 regular",395000,395000,0,0
TIKI,thoi-trang-nam,248193855,"Áo Khoác Gió 7-ZIA Phối Màu Đen Trắng Dây Rút Form Rộng Unisex",95000,95000,0,0
TIKI,thoi-trang-nam,134388322,"Quần JOGGER Thể Thao Unisex Nam Nữ HIPHOP Ống Rộng Bo Gấu Rút Dây In Hình GẤU Ulzzang",105000,105000,0,0
TIKI,thoi-trang-nam,76402270,"quần jogger, quần thể thao nam, quần nam dài, quần nữ dài, quần thể thao nam nữ đều mặc được, quần thun nam nữ, quần thun dài, quần thể thao nam nữ, quần jogger nam nữ",89000,89000,0,0
TIKI,thoi-trang-nam,76048960,"Áo thun Polo nam Novelty 200032N",299000,399000,100000,25
TIKI,thoi-trang-nam,118895371,"Áo sơ mi nam tay dài ADINO màu trắng tinh vải sợi sồi modal dáng slimfit trẻ trung S302",279000,350000,71000,20
TIKI,thoi-trang-nam,113771027,"Áo sơ mi nam màu trắng, tay dài, đồng phục học sinh các cấp, size từ 20-95kg, form suông, vạt bầu, thương hiệu Amazing",104000,161000,57000,35
TIKI,thoi-trang-nam,179735521,"Elegant Box - 2 Áo thun nam, 2 quần short đùi nam rằn ri, 5 đôi tất nam cao cấp thương hiệu MRM Manlywear",589000,1075000,486000,45
TIKI,thoi-trang-nam,116494114,"[4 MÀU] OWEN - Áo polo ngắn tay Owen chất cotton mềm mát - chống bai xù",439000,439000,0,0
TIKI,thoi-trang-nam,179563185,"Elegant Box - 2 Áo thun nam, 2 Quần đùi short , 5 đôi tất cao cấp Thương hiệu MRM Manlywear",589000,1075000,486000,45
TIKI,thoi-trang-nam,132965282,"Áo Varsity Jacket - Chất dày đẹp form bao to cho nam nữ dưới 70kg - Hình thêu nổi sắc nét, Áo Khoác Bomber Phối Tay form rộng cực kỳ thoải mái, áo khoác dù bóng chày",99000,99000,0,0
TIKI,thoi-trang-nam,101949747,"Quần lót lưới nam",18000,18000,0,0
TIKI,thoi-trang-nam,15787672,"Áo Khoác Nam Áo Khoác Dù Nam Phối Nón Viền Cao Cấp ShopN6-AD29",239000,275000,36000,13
TIKI,thoi-trang-nam,171232017,"Áo sơ mi nam tay dài kẻ caro công sở vải oxford denim cao cấp Nexx&Dee SM01",259000,259000,0,0
TIKI,thoi-trang-nam,58230280,"Áo thun nam cổ tròn tay ngắn, chất thun lạnh mềm mại, co giãn thoải mái – FORMEN SHOP – FMPS124",99000,179000,80000,45
TIKI,thoi-trang-nam,78925174,"Quần Jean Nam cao cấp co dãn 4 chiều Thương Hiệu Chandi, phong cách hàn quốc trẻ trung cá tính MR9011",169000,299000,130000,43
TIKI,thoi-trang-nam,129297267,"áo thun dài tay nam trung niên áo cho bố nhiều mẫu",189000,189000,0,0
TIKI,thoi-trang-nam,70283780,"Áo Cờ Đỏ Sao Vàng Áo Thun Cờ Đỏ Sao Vàng Áo Cờ Đỏ Sao Vàng Giá Rẻ Áo Cờ Đỏ Sao Vàng Trẻ Em Bán Sỉ Áo Cờ Đỏ Sao Vàng",29000,29000,0,0
TIKI,thoi-trang-nam,101656679,"Áo Khoác Dạ Nam Dáng Dài Áo Dạ Nam Đẹp Sans01 Sans Shop",399000,399000,0,0
TIKI,thoi-trang-nam,14694949,"Áo khoác cách nhiệt GOKING 2 lớp, form unisex cho nam nữ. Áo khoác dù ấm áp, cản gió hiệu quả, thích hợp đông và thu đông. Hàng hiệu Việt Nam cao cấp xuất khẩu",235000,235000,0,0
TIKI,thoi-trang-nam,129246479,"Áo khoác măng tô nam trẻ trung thời trang mới NMT74",1080000,1080000,0,0
TIKI,thoi-trang-nam,197344491,"Áo Thun Nam Polo OSCAR - OCMPKSF 003",249000,890000,641000,72
TIKI,thoi-trang-nam,83159675,"Áo Sơ Mi Nam Ngắn Tay Ô Kẻ Thời Trang Poniva",169000,169000,0,0
TIKI,thoi-trang-nam,162249691,"OWEN - Áo sơ mi trắng ngắn tay Owen chất sồi 22752/22753 Slimfit - Regularfit",420000,420000,0,0
TIKI,thoi-trang-nam,117734983,"Quần baggy nam cạp chun ống côn chất đũi nhiều màu mặc thoáng mát",82000,82000,0,0
TIKI,thoi-trang-nam,20521520,"Áo Thun Lót Nam Khatoco A3MN140R2-VNMA025-2504-N - Trắng",93000,140000,47000,34
TIKI,thoi-trang-nam,179163689,"(Big size <120kg) Áo sơ mi nam dài tay thêu chư big size",185000,185000,0,0
TIKI,thoi-trang-nam,20526282,"Áo Sơ Mi Nam Tay Ngắn Khatoco A1MN438S1-CNCR016-2102-N",291000,438000,147000,34
TIKI,thoi-trang-nam,191780520,"Áo polo nam May 10 mã 140122132",265000,265000,0,0
TIKI,thoi-trang-nam,114330661,"ÁO KHOÁC DÙ NAM BOMBER NAM FORM RỘNG,CHẤT LIỆU THOÁNG MÁT MẪU MỚI NHẤT HIỆN NAY",88000,88000,0,0
TIKI,thoi-trang-nam,41822711,"Áo vest nam form ôm body màu đen chất vải mềm mịn may đúng chuẩn 2 lớp dựng và độn vai có túi trong và ngoài (size M)",189000,189000,0,0
TIKI,thoi-trang-nam,83156837,"Áo Thun Có Cổ Phối Hai Sọc Thẳng Trắng Mẫu GK02 Thời Trang Thiết Kế Trẻ Trung Phong Cách",157000,157000,0,0
TIKI,thoi-trang-nam,64275868,"Quần lót boxer nam Khatoco Q5M085R0-VNMA017-2112-B",65000,85000,20000,24
TIKI,thoi-trang-nam,41275931,"áo hoodie from rộng Nam Nữ HD12",99000,99000,0,0
TIKI,thoi-trang-nam,108336042,"Áo Bomber Nam/ Áo Khoác Nỉ dày dặn Face đen form rộng Unisex Nam Nữ Ulzzang",100000,100000,0,0
TIKI,thoi-trang-nam,54643395,"Quần Short Khaki Nam 0Ply Trơn Novelty NSKMMNMCSR1813820 - Vàng Nhạt",199000,295000,96000,33
TIKI,thoi-trang-nam,135273112,"Áo khoác nam nữ nỉ ngoại hoodie puppprsooo",108000,108000,0,0
TIKI,thoi-trang-nam,88007961,"Aó khoác sơ mi nam caro , áo hoác sơ mi nữ caro , áo caro nam , áo caro nữ , áo khoác UNISEX kiểu dáng sơ mi sọc caro nhuyễn màu xanh , áo sơ mi caro có nón",104000,104000,0,0
TIKI,thoi-trang-nam,107336589,"Quần Sịp Nam Cao Cấp, Quần Lót Nam Thun Lạnh, Hộp 4 Sịp Đùi Nam Vải Sợi Tự Nhiên Thun Lạnh, Thoáng Khí, Co Giãn 4 Chiều, Không Phai Màu, Không Xù Lông, Thấm Hút Mồ Hôi, Thoát Hơi Và Kháng Khuẩn Rất Tốt.",369000,369000,0,0
TIKI,thoi-trang-nam,93050507," quần nam dài chất đũi mềm mại",76000,76000,0,0
TIKI,thoi-trang-nam,86868118,"Quần Jogger Nam thể thao túi hộp thương hiệu Chandi, chất kaki bo chân xu hướng mới nhất CD2",299000,299000,0,0
TIKI,thoi-trang-nam,76528055,"Áo sơ mi công sở trung niên nam TUTO5 Menswear dài tay trơn Cufflinks Slim fit Lilac Double Cuff Herringbone Shirt cotton chống nhăn cao cấp phong cách trẻ trung, nam tính tím 105123052",449000,449000,0,0
TIKI,thoi-trang-nam,193891481,"Đồ Bơi Nam Ngắn Tay Quần Đùi",169000,255000,86000,34
TIKI,thoi-trang-nam,95305852,"Áo thun nam Polo NOVELTY dệt họa tiết 210132N",299000,469000,170000,36
TIKI,thoi-trang-nam,174605566,"Áo Thun Nam Ngắn Tay Chandi, Chất Thun Cotton Xịn Co Giãn Mẫu Mới NT62",220000,220000,0,0
TIKI,thoi-trang-nam,129300338,"quần ngố thô kaki nam trung niên ngon bổ rẻ dáng thụng túi chéo",179000,179000,0,0
TIKI,thoi-trang-nam,103702291,"OWEN - Áo sơ mi dài tay Owen Slimfit vải sợi tre màu hồng nhạt 68079 - Áo sơ mi nam",565000,565000,0,0
TIKI,thoi-trang-nam,101272357,"Áo Khoác Big Size Nam Nữ Áo Khoác Dù Nam Chống Nước Nhẹ Chống Nóng Chống Lạnh Chống Gió Chống Tia UV Có Nón Thời Trang Nam Tính Hàn Quốc Cao Cấp WD75 - ShopN6",199000,215000,16000,7
TIKI,thoi-trang-nam,171989852,"Quần lót boxer xịp đùi nam TUTO5 thun lạnh cotton cao cấp kháng khuẩn trơn basic cạp cao thể thao trắng/đen/xám ghi BX01",75000,75000,0,0
TIKI,thoi-trang-nam,76166161,"Áo sơ mi unisex form rộng - somi nam nữ sọc số 16",215000,215000,0,0
TIKI,thoi-trang-nam,186359379,"Áo Sơ Mi nam tay dài sọc nhỏ NSMMSNMTCR212804D",299000,329000,30000,9
TIKI,thoi-trang-nam,77712163,"Áo Hoodie Nỉ Ngoại Trơn Đủ Màu ( unisex nam nữ đều mặc được)",98000,98000,0,0
TIKI,thoi-trang-nam,95293206,"Áo thun nam Polo NOVELTY trơn màu cổ bo 210127N",399000,469000,70000,15
TIKI,thoi-trang-nam,76165492,"Áo sơ mi nam tay ngắn vạt ngang form tailor xanh dương họa tiết Khatoco A1MN538T2-CNMK002-2202-N",284000,538000,254000,47
TIKI,thoi-trang-nam,106987435,"Áo Khoác Nỉ Bông Ngoại Reception F Mềm MỊn - Form Unisex Cardigan Bomber Jackets Nam Nữ Couple Thoitrangsihienlinh",100000,100000,0,0
TIKI,thoi-trang-nam,106886606,"OWEN - Áo sơ mi ngắn tay Owen Regular fit chất sợi tre kẻ sọc xanh 22663",548000,548000,0,0
TIKI,thoi-trang-nam,20612481,"Quần Lót Nam Cao Cấp Brave B1153",119000,225000,106000,47
TIKI,thoi-trang-nam,54762569,"Áo sơ mi nam tay dài form ôm trơn Khatoco A1MD468S1-CNTR008-2412-D - Trắng",400000,468000,68000,15
TIKI,thoi-trang-nam,194005560,"Áo sơ mi nam tay lửng lỡ Sans310 chất đũi cổ tàu đuôi tôm mềm mát bigsize to trẻ hàn quốc cao cấp trắng đen xanh rêu",169999,169999,0,0
TIKI,thoi-trang-nam,46698996,"Quần jogger nam phối sọc, dây kéo túi Phúc An 1067 màu",107100,107100,0,0
TIKI,thoi-trang-nam,77118805,"Áo sơ mi dài tay nam TUTO5 sơ mi công sở họa tiết sọc kẻ caro Extra Slim fit Shirt cotton chống nhăn cao cấp phong cách trẻ trung, nam tính - 105122022",449000,449000,0,0
TIKI,thoi-trang-nam,90063761,"ÁO KHOÁC DÙ NAM , ÁO KHOÁC NAM CHẤT VAIT DÙ 2 LỚP MÀU ĐEN FORM LỚN (VIDEO ẢNH THẬT )",107000,107000,0,0
TIKI,thoi-trang-nam,150213959,"Áo bảo hộ lao động nam nữ khóa kéo SHUNI 006A vải kaki liên doanh loại dày",149000,149000,0,0
TIKI,thoi-trang-nam,59518446,"QUẦN LÓT ROSSO NAM DỆT KIM",110000,110000,0,0
TIKI,thoi-trang-nam,110151273,"Áo sơ mi dài tay nam TUTO5 sơ mi công sở họa tiết sọc kẻ Slim fit Shirt cotton chống nhăn cao cấp phong cách trẻ trung, nam tính - TRISTAN457 - 38",399000,399000,0,0
TIKI,thoi-trang-nam,34909799,"Hộp 4 chiếc quần sịp đùi nam thông hơi CAO CẤP ( TẶNG VÒNG ĐEO TAY THỜI TRANG ) KÈM HỘP",199000,199000,0,0
TIKI,thoi-trang-nam,103308803,"Áo khoác sơ mi ca rô , áo sơ mi caro có nón vải thun dày dặn",128000,128000,0,0
TIKI,thoi-trang-nam,195946970,"Áo sơ mi nam màu trắng kem ADINO vải nến lụa sợi sồi modal dáng công sở slimfit hơi ôm trẻ trung SM01",279000,400000,121000,30
TIKI,thoi-trang-nam,57759258,"Áo Thun Nam Có Cổ Bẻ Đơn Giản Cao Cấp ShopN6 - AT03 (Nhiều Màu)",119000,140000,21000,15
TIKI,thoi-trang-nam,178058243,"Áo 3 lỗ nam cotton co giãn 4 chiều, rộng in họa tiết TOKYO LADOS-9087, thấm hút mồ hôi, năng động, tập gym, chạy bộ",229000,229000,0,0
TIKI,thoi-trang-nam,115886097,"Áo thun NOWSAIGON Signature Drop Shoulder Tee",365000,365000,0,0
TIKI,thoi-trang-nam,184899069,"Quần lót nam boxer RLTK014 quần sịp nam thoáng mát mềm mại cao cấp, co giãn tốt, ôm gọn - RELAX",114000,114000,0,0
TIKI,thoi-trang-nam,69621551,"Áo khoác kaki nam 2 lớp có nón SITAKI thời trang cao cấp AKK15",175000,175000,0,0
TIKI,thoi-trang-nam,164309408,"Cha và con trai, mã G71. Áo thun nam nữ in siêu đẹp. Áo phông thoát nhiệt GOKING hàng hiệu cao cấp",105000,105000,0,0
TIKI,thoi-trang-nam,76397392,"quần jogger, quần thể thao nam, quần nam dài, quần nữ dài, quần thể thao nam nữ đều mặc được, quần thun nam nữ, quần thun dài",89000,89000,0,0
TIKI,thoi-trang-nam,251268901,"Áo gile nam ARM-920",320000,320000,0,0
TIKI,thoi-trang-nam,83517293,"ÁO KHOÁC DÙ NAM 2 LỚP -ĐỎ ĐÔ",323700,323700,0,0
TIKI,thoi-trang-nam,163712685,"Áo Sơ Mi Nam Anton Công Sở Trung Niên Dài Tay Màu Xám Ghi Họa Tiết Kẻ Caro YAT202",325000,425000,100000,24
TIKI,thoi-trang-nam,76286679,"Áo sơ mi dài tay nam TUTO5 sơ mi công sở họa tiết sọc kẻ Slim fit Shirt cotton chống nhăn cao cấp phong cách trẻ trung, nam tính - TRISTAN449",399000,399000,0,0
TIKI,thoi-trang-nam,172457811,"ÁO KHOÁC KAKI NGOẠI NAM NỮ TRƠN FORM RỘNG CÁ TÍNH, Áo khoác kaki nam phong cách Hàn Quốc phối túi bên tay áo, Áo Khoác Nam, Áo Khoác Kaki Hộp Unisex,Áo khoác kaki ngoại unisex thời trang dành cho nam nữ form rộng 70kg",156000,156000,0,0
TIKI,thoi-trang-nam,56691583,"Áo thun dài tay nam",94000,94000,0,0
TIKI,thoi-trang-nam,153404157,"Quần Kaki nam ống côn kiểu dáng hàn quốc, phong cách thể thao trẻ trung năng động",85000,85000,0,0
TIKI,thoi-trang-nam,174015511,"Quần Short Jean nam Leman xanh trơn JL01 - Slim straight Form",459000,459000,0,0
TIKI,thoi-trang-nam,72972591,"Áo thun nam cổ tròn tay ngắn, chất thun cao cấp, trẻ trung, năng động – FORMEN SHOP – FMPS142",148000,189000,41000,22
TIKI,thoi-trang-nam,167426594,"Áo polo nam, thời trang nam chất vải cao cấp, thiết kế kẻ dọc sang trọng, phù hợp nhiều hoạt động - FORMEN SHOP - FMHK005",99000,250000,151000,60
TIKI,thoi-trang-nam,169468037,"Quần kaki nam dáng suông túi mỹ chất lượng cao màu môn kaki trung niên co dáng đẹp",140000,140000,0,0
TIKI,thoi-trang-nam,35233700,"Quần Short Đùi Nam Boxer Tập Gym Mặc Ngủ Super Body",132000,132000,0,0
TIKI,thoi-trang-nam,73410837,"ÁO LEN GILE NAM ALIGRO - MÀU XANH THAN",451000,451000,0,0
TIKI,thoi-trang-nam,34707251,"Áo khoác măng tô nam trẻ mẫu mới nhất NMT21",1650000,1650000,0,0
TIKI,thoi-trang-nam,73727390,"Quần lót nam boxer cao cấp thun cotton co giãn tốt, sịp đùi nam kiểu dáng hiện đại trẻ trung, lưng cạp to nam tính và co giãn thoải mái, màu trơn thanh lịch QLCIN1017",99000,135000,36000,27
TIKI,thoi-trang-nam,104681929,"Áo khoác kaki nam VONESA chất vải dày cực tốt . Nhiều màu - Nhiều size tha hồ lựa chọn",185000,185000,0,0
TIKI,thoi-trang-nam,82741318,"Đồ bộ PIJAMA NAM dài tay họa tiết Caro nam tính, chất Cotton 100% thông thoáng mùa hè, style Hàn Quốc thời thượng",600000,600000,0,0
TIKI,thoi-trang-nam,78969135,"Đồ bộ thể thao nam vải thun tuyết mưa mềm mịn. Bộ PIKACHU- Thời Trang Phong Cách Hàn aloha style (Freesize từ 45-70kg)-Nhiều kiểu lựa chọn",97000,97000,0,0
TIKI,thoi-trang-nam,5464905,"Áo Khoác Nam Có Big Size (Over size) màu xám nhạt",160000,160000,0,0
TIKI,thoi-trang-nam,90599050,"Đồ bộ Pijama cộc tay họa tiết sọc Caro style Hàn Quốc-Đồ bộ nam vải COTTON 100% dày dặn & thông thoáng (613)",456000,456000,0,0
TIKI,thoi-trang-nam,198628980,"Áo thun nam cotton, cao cấp, (Màu Đen) thương hiệu Doka D01",199000,199000,0,0
TIKI,thoi-trang-nam,71941220,"Bộ quần áo thể thao nam nữ in cờ",95000,95000,0,0
TIKI,thoi-trang-nam,47406493,"Quần Jogger Nam Nữ Sọc Phản Quang Túi Hộp Unisex - Quần Thể Thao Tập Gym",80800,80800,0,0
TIKI,thoi-trang-nam,143656326,"Combo 2 quần lót nam boxer, set 2 sịp đùi nam màu trơn thun cotton CBQL116",80000,130000,50000,38
TIKI,thoi-trang-nam,137670041,"Quần Jogger\Quần Nỉ Ống Rộng Bo Chân Nam Nữ Unisex HIPHOP Ulzzang KUN",99000,99000,0,0
TIKI,thoi-trang-nam,184899126,"Quần lót nam trunk RLTK061 quần sịp nam thoáng mát mềm mại cao cấp, co giãn tốt, ôm gọn - RELAX",109000,109000,0,0
TIKI,thoi-trang-nam,75326733,"Quần áo giữ nhiệt Nam",420000,420000,0,0
TIKI,thoi-trang-nam,191780196,"Đồ bộ thể thao nam đẹp cao cấp LADOS - 7001, vải thun lạnh, mặc nhà, chạy bộ, tập gym",329000,329000,0,0
TIKI,thoi-trang-nam,107661666,"Quần Lót Nam Sexy Brave Person B1186 - Chất Liệu Xi Phông Kết Hợp Spandex Siêu Quyến Rũ Và Cá Tính - Form Dáng Ôm, Tôn Lên Vẻ Nam Tính Cùa Phái Mạnh",129000,199000,70000,35
TIKI,thoi-trang-nam,214261956,"Quần Short Thể Thao Nam Phúc An 1001 - Xám",71100,71100,0,0
TIKI,thoi-trang-nam,52187546,"Combo 3 Quần Lót Nam Quần Sịp Đùi Sợi Cotton Cao Cấp MRM FASHION 1 màu TẶNG Đôi Tất Nam Cao Cấp",205000,285000,80000,28
TIKI,thoi-trang-nam,54889097,"Quần Bơi Nam 2 Lớp Không Xuyên Thấu Thông Thoáng Thoải Mái 469",99000,99000,0,0
TIKI,thoi-trang-nam,179161649,"Quần kaki dài nam big size tới 130kg",310000,310000,0,0
TIKI,thoi-trang-nam,7175397,"Bộ 4 Quần Sịp Tam Giác Nam Nhật Bản (Nhiều màu) - 5Star",95000,95000,0,0
TIKI,thoi-trang-nam,176814083,"Áo Sơ Mi Nam Công Sở Trung Niên Thương Hiệu Anton Dài Tay Tím Chấm Bi Vải Cotton – AC128",215000,425000,210000,49
TIKI,thoi-trang-nam,196350462,"Viettien - Áo sơ mi nam dài tay ca rô cao cấp 1Q0587 fom regular chất liệu 100% cotton - Áo sơ mi công sở Việt Tiến",880000,880000,0,0
TIKI,thoi-trang-nam,122944927,"BỘ ĐỒ BỘ NAM THỂ THAO THUN 4 CHIỀU CO GIÃN",94000,94000,0,0
TIKI,thoi-trang-nam,155190387,"Viettien - Áo sơ mi nam ngắn tay xẻ tà vạt ngang họa tiết 6Q0286",535000,535000,0,0
TIKI,thoi-trang-nam,174406721,"Áo Chống Nắng Nam 2 Lớp Laroma| UPF50+ | Vải Thơm | Làm Mát | Thời Trang | Đa Dụng",319000,319000,0,0
TIKI,thoi-trang-nam,88020835,"Áo Bomber Torona, Áo khoác BOMBER TORONA unisex form rộng màu đen, Áo khoác TORONA unisex nam nữ from rộng đen cao cấp, Áo Khoác dù BOMBER TQRONA UNISEX",99000,99000,0,0
TIKI,thoi-trang-nam,57796167,"Áo Khoác Nhẹ Nam Phối Nón Chất Nỉ Chống Nóng Lạnh Có Túi Balo Cao Cấp AN11 - ShopN6 (Nhiều Màu)",169000,240000,71000,30
TIKI,thoi-trang-nam,136790795,"OWEN - Aó sơ mi dài tay Owen Slimfit chất sợi tre kẻ ca rô xanh 23219",588000,588000,0,0
TIKI,thoi-trang-nam,184073206,"Áo vest nam, Áo Vest Nam tay dài Bo ống Tay chất liệu nỉ da cá, không nhàu, 2 nút áo khoác mã H52",340000,340000,0,0
TIKI,thoi-trang-nam,94283900,"Áo thun nam Polo NOVELTY kiểu dáng Melange 210099N",399000,439000,40000,9
TIKI,thoi-trang-nam,64275382,"Quần lót boxer nam Khatoco Q5M085R0-VNMA015-2112-B",65000,85000,20000,24
TIKI,thoi-trang-nam,164250892,"I'm not drunk i'm Vietnamese, mã G46. Áo thun nam nữ siêu đẹp. Áo phông thoát nhiệt Goking hàng hiệu",168000,168000,0,0
TIKI,thoi-trang-nam,16924160,"Quần bơi nam freesize Bn01",99000,99000,0,0
TIKI,thoi-trang-nam,85087082,"Áo sơ mi nam ngắn tay",159000,159000,0,0
TIKI,thoi-trang-nam,147931665,"Áo Hoodie nam nữ - Áo khoác Hoodie nam nữ Trắng chống nắng Unisex form rộng CỪU HỒNG nỉ bông ấm áp",88000,88000,0,0
TIKI,thoi-trang-nam,74280099,"Quần jean nam xanh bạc Julido Store, chất jean co dãn 4 chiều tôn dáng nam tính BC5678 - 28",169000,279000,110000,39
TIKI,thoi-trang-nam,183731782,"Áo sơ mi nam, Áo sơ mi dài tay thêu hoa văn Tay- Cổ tinh tế.Cúc được thiết kế kiểu vạt chéo mã N27",199000,199000,0,0
TIKI,thoi-trang-nam,187913098,"Áo gile nam, áo phóng viên, áo gile lính 1204",450000,450000,0,0
TIKI,thoi-trang-nam,8915134,"Áo khoác phao nam giữ ấm chóng gió lạnh mùa thu đông thương hiệu doka",349000,499000,150000,30
TIKI,thoi-trang-nam,83157075,"Áo Sơ Mi Nam Ngắn Tay Họa Tiết Ô Vuông Cao Cấp Thời Trang Chất Vải Không Nhăn Không Xù",169000,169000,0,0
TIKI,thoi-trang-nam,125633222,"Áo Hoodie trơn Unisex Hàn Quốc(kèm ảnh thật)",96000,96000,0,0
TIKI,thoi-trang-nam,90071009,"ÁO SƠ MI CARO ÁO KHOÁC SƠ MI NAM NỮ MẶC",87000,87000,0,0
TIKI,thoi-trang-nam,79191302,"Áo Gile Túi Hộp",514500,514500,0,0
TIKI,thoi-trang-nam,764560,"Quần Short Thể Thao Nam Phúc An 1001 - Xám",71100,71100,0,0
TIKI,thoi-trang-nam,167421709,"Quần Sọt Jean nam co dãn 4 chiều Thương Hiệu Chandi, phong cách hàn quốc mẫu mới nhất MS245",150000,299000,149000,50
TIKI,thoi-trang-nam,129302662,"Quần short ngố kaki nam trung niên hàng cty cao cấp có size 100kg ẢNH THẬT",279000,279000,0,0
TIKI,thoi-trang-nam,136385047,"Quần sọt kaki nam túi hộp vuông,6 túi .",159000,159000,0,0
TIKI,thoi-trang-nam,67996875,"Áo hoodie unisex form rộng WIND Nỉ Ngoại 2020 Swag, áo hoodie ullzang WIND",90000,90000,0,0
TIKI,thoi-trang-nam,133691736,"Quần kaki nam trung niên 2 li (4 màu)ẢNH THẬT",343500,343500,0,0
TIKI,thoi-trang-nam,95059591," Áo thun tanktop unisex sát nách form rộng SUPER nam nữ ulzzang Wind",88000,88000,0,0
TIKI,thoi-trang-nam,20521574,"Áo Thun Ba Lỗ Nam Khatoco A4MN120R2-VNMA025-2504-N - Trắng",80000,120000,40000,33
TIKI,thoi-trang-nam,85086930,"Áo sơ mi nam vải cotton mềm không nhăn-Quà tặng",108000,108000,0,0
TIKI,thoi-trang-nam,132143028,"Áo thun nam tay ngắn họa tiết cổ tròn in tay chất liệu thun cotton - FORMEN SHOP - FMPS165",149000,210000,61000,29
TIKI,thoi-trang-nam,172307380,"Áo thun cotton in chữ LADOS - 9077, form rộng thoải mái, siêu mát mẻ",349000,349000,0,0
TIKI,thoi-trang-nam,58519034,"Áo quạt điều hòa không có phụ kiện",248000,248000,0,0
TIKI,thoi-trang-nam,83158189,"Áo Thun Nam Có Cổ Tay Ngắn",157000,157000,0,0
TIKI,thoi-trang-nam,106886320,"OWEN - Aó sơ mi ngắn tay Owen chất sợi tre kẻ xanh 90020",570000,570000,0,0
TIKI,thoi-trang-nam,55600246,"Áo Sơ Mi Nam Tay Lỡ Vài Đũi SZone Phong Cách SA455",229000,229000,0,0
TIKI,thoi-trang-nam,73833910,"Áo Khoác Hoodie Nam Nữ MIRAKO Màu Xám Trơn Basic Đơn Giản",107000,107000,0,0
TIKI,thoi-trang-nam,94455981," Quần Baggy Nam Nữ KAKI Ống Suông Unisex - BG01 - SP1",89000,89000,0,0
TIKI,thoi-trang-nam,84800636,"Quần Bơi Chống Nắng Nam Dài Tới Gót 806",503000,503000,0,0
TIKI,thoi-trang-nam,110151277,"Áo sơ mi dài tay nam TUTO5 sơ mi công sở họa tiết sọc kẻ Slim fit Shirt cotton chống nhăn cao cấp phong cách trẻ trung, nam tính - TRISTAN460 - 38",399000,399000,0,0
TIKI,thoi-trang-nam,118895078,"Áo sơ mi nam tay dài ADINO màu trắng kem giấu khuy vải sợi sồi modal dáng slimfit trẻ trung S301",279000,350000,71000,20
TIKI,thoi-trang-nam,139235901,"Áo khoác nhung bomber unisex nam nữ hoạ tiết cực đẹp",160000,160000,0,0
TIKI,thoi-trang-nam,190230167,"Áo phóng viên - áo gile lính cao cấp ARM-1114 (Kem)",700000,700000,0,0
TIKI,thoi-trang-nam,196409442,"KAKI DÀI MẪU MỚI FORM SLIM FIT BIG SIZE NAM 80 ĐẾN 130KG",320000,320000,0,0
TIKI,thoi-trang-nam,109340149,"Quần lót nam thun cotton cạp to, sịp nam tam giác cao cấp trẻ trung màu trơn đơn giản QLTG064",90000,90000,0,0
TIKI,thoi-trang-nam,163877262,"Áo Sơ Mi Nam Công Sở Trung Niên Dài Tay Thương Hiệu Anton Xanh Tím Than Họa Tiết Kẻ Caro Chìm – YAT201",325000,425000,100000,24
TIKI,thoi-trang-nam,113066157,"Áo Khoác Sơ Mi Caro KẺ UNISEX NAM NỮ Dài Tay 2 màu (đỏ-vàng)",84000,84000,0,0
TIKI,thoi-trang-nam,3969655,"Quần Kaki Nam Aligo Xanh Dương ALGK030",429000,429000,0,0
TIKI,thoi-trang-nam,94880639,"Áo sơ mi nam việt tiến dài tay màu hồng lạt",350000,350000,0,0
TIKI,thoi-trang-nam,104870136,"Áo cadigan nam , áo khoác cadigan nam nữ , áo khoác nữ form rộng chống nắng chống lạnh tốt vải nỉ ngoại ko phai ko nhão, Áo khoác cadigan nam nữ, Áo khoác cadigan form rộng mùa đông chống lạnh , hè chống nắng",108000,108000,0,0
TIKI,thoi-trang-nam,101582771,"áo khoác degrey Cá Sấu Bông DEGREY , áo khoác degrey gấu xanh, Áo Khoác Dù Nam Nữ cặp đôi Unisex - Áo Khoác Jacket Bombers DEGREY, Áo khoác dù degrey cá sấu unisex Mới, áo khoác dù nam nữ ulzzang",99000,99000,0,0
TIKI,thoi-trang-nam,134386943,"Quần Ống Rộng Baggy In CHỮ Lưng Cao Chất Liệu Kaki Nhung Tăm Unisex Nam Nữ Phong Cách Hàn Quốc Ulzzang",115000,115000,0,0
TIKI,thoi-trang-nam,196855223,"Quần tây nam 0Ply Novelty màu xám đen Classic NQTMMDNTRC2202980",399000,479000,80000,17
TIKI,thoi-trang-nam,188914423,"Bộ quần áo nam Fasvin AT22505.HN chất vải thun mềm mát co giãn phù hợp thể thao hay mặc nhà",199000,358000,159000,44
TIKI,thoi-trang-nam,152695029,"BỘ PIJAMA NAM DÀI TAY CHẤT COTTON 100% CAO CẤP, SIÊU MỀM MỊN, SIZE L-3XL",600000,600000,0,0
TIKI,thoi-trang-nam,14069843,"Quần shorts Nam đi biển siêu mỏng phong cách Châu Âu - Q003",220000,220000,0,0
TIKI,thoi-trang-nam,94773840,"Áo khoác dù nam nữ unisex kiểu bomber form rộng, 2 lớp dày dặn",97000,97000,0,0
TIKI,thoi-trang-nam,164584229,"Áo sơ mi ngắn tay couple thời trang nam nữ, thun đũi trơn chất mát, phù hợp cho các bạn trẻ - FORMEN SHOP - FMHK003",99000,250000,151000,60
TIKI,thoi-trang-nam,75604513,"Quần áo giữ nhiệt cho nam, Bộ giữ ấm cho nam , Quần áo bó sát chống lạnh cổ tim",900000,900000,0,0
TIKI,thoi-trang-nam,63478020,"Quần lót nam cotton boxer Freeman [Combo 3] BO503",237000,237000,0,0
TIKI,thoi-trang-nam,186285725,"Áo Sơ Mi Tay Dài họa tiết xanh nước biển NSMMCLMTCR210224D",319000,319000,0,0
TIKI,thoi-trang-nam,76167395,"Áo sơ mi nam dài tay họa tiết rồng",95000,95000,0,0
TIKI,thoi-trang-nam,142003692,"Áo thun polo nam ngắn tay, họa tiết thêu trước ngực, chất thun co giãn 4 chiều, form chuẩn phối màu lạ mắt - FORMEN SHOP - FMPS170",105000,210000,105000,50
TIKI,thoi-trang-nam,3714875,"Combo 5 Quần Lót Nam Freeman 6040-CB5-XXL (Size",325000,325000,0,0
TIKI,thoi-trang-nam,112955858,"COMBO 3 QUẦN LÓT BOXER NAM ROSSO 0001 - UNDERWEAR",360000,360000,0,0
TIKI,thoi-trang-nam,91533024,"ÁO HOODIE TIẾNG NHẬT UNISEX, Áo Hoodie Chữ Nhật Unisex Form Rộng Tay Bồng, Áo Hoodie Nam Nữ Có Mũ Chữ Nhật, Áo Hoodie Chữ Nhật Có Mũ hình gấu, ÁO HOODIE ULZZANG UNISEX CHỮ NHẬT",100000,100000,0,0
TIKI,thoi-trang-nam,15806734,"Áo Khoác Nam Áo Khoác Dù Nam Cổ Trụ Fashion Cao Cấp ShopN6-AD36",269000,275000,6000,2
TIKI,thoi-trang-nam,25965007,"[Chọn màu] Quần lót nam lọt khe gợi cảm",45000,45000,0,0
TIKI,thoi-trang-nam,106997567,"Áo thun Nam Nữ One Piece Zoro, áo phông One Piece Zoro Unisex Nam Nữ có Size bé từ 25-84kg",40000,40000,0,0
TIKI,thoi-trang-nam,99472055,"Áo Ba Lỗ Tank Top Thể Thao Nam T-SIMPLE Ver.01 (Màu Xám)",170000,170000,0,0
TIKI,thoi-trang-nam,101656171,"Áo Khoác Kaki Nam Dáng Vừa Áo Măng Tô Nam Chất Kaki Sans15 Sans Shop",1199000,1199000,0,0
TIKI,thoi-trang-nam,45301531,"Áo thun cá sấu dây kéo thời trang SITAKI - ATN08",130000,130000,0,0
TIKI,thoi-trang-nam,186577235,"Set áo thun form rộng gấu Bear Brich + Quần short Unisex Nam nữ , Set đồ bộ nam nữ ,Set đồ đôi tay lỡ unisex, đồ bộ hàn quốc thể thao in gấu Bear Brich Chất cotton form thụng tay lỡ Unisex Form <70kg, đồ Bộ mặc nhà ngủ mùa hè nam nữ",99000,99000,0,0
TIKI,thoi-trang-nam,197062475,"Áo khoác măng tô nam cổ đứng dáng ngắn khóa kéo chất vải kaki đẹp NMT34",780000,780000,0,0
TIKI,thoi-trang-nam,191420758,"Áo Khoác nam Việt Tiến mẫu mới 6Q5005 có 2 màu xanh và màu đen - Áo Jacket nam - Áo khoác nhẹ nam 2 lớp Viettien",650000,650000,0,0
TIKI,thoi-trang-nam,76255587,"áo hoodie in phản quan, áo hoodie ulzzang, áo hoodie cá tính, áo hoodie nam nữ đều mặc được",115000,115000,0,0
TIKI,thoi-trang-nam,43154580,"Combo 4 Quần Lót Nam Xuất Nhật Thông Hơi Cao Cấp - Chất Liệu Mềm Mịn Mát Lạnh",66400,66400,0,0
TIKI,thoi-trang-nam,73279196,"ÁO KHOÁC 2 LỚP CAO CẤP - Tabalo  Camping Jacket - Unisex",550000,550000,0,0
TIKI,thoi-trang-nam,128866159,"Áo Khoác Cardigan Nỉ Ngoại 199 Nam Nữ Form Rộng Hàn Quốc",106000,106000,0,0
TIKI,thoi-trang-nam,114822300,"Áo sơ mi nam cộc tay ALGS-C112",545000,545000,0,0
TIKI,thoi-trang-nam,103243180,"Quần Sịp Nam Chữ V Nâng Mông Siêu Thoáng K367 - Trắng - M",65000,65000,0,0
TIKI,thoi-trang-nam,90483623,"Combo 3 Áo thun nam ba lỗ cotton FREEMAN ASF205",267000,267000,0,0
TIKI,thoi-trang-nam,128276503,"(Size đến 4XL)Quần jogger kaki zipper nam nữ đều mặc được, chất kaki dày dặn",168000,168000,0,0
TIKI,thoi-trang-nam,78501924,"Quần Jean Nam đẹp dẫn đầu xu hướng Thương Hiệu Chandi , mẫu mới form đẹp tôn dáng không quá ôm mẫu HD31",169000,299000,130000,43
TIKI,thoi-trang-nam,125397100,"Quần short thun Nam ôm body - A076",110000,110000,0,0
TIKI,thoi-trang-nam,116096415,"Áo sơ mi dài tay nam TUTO5 sơ mi công sở họa tiết sọc kẻ caro Regular fit Shirt cotton chống nhăn cao cấp phong cách trẻ trung, nam tính - 105126012",499000,499000,0,0
TIKI,thoi-trang-nam,26002537,"Áo thun Nam tay dài mỏng mát cho mùa hè - AT014",190000,190000,0,0
TIKI,thoi-trang-nam,186317393,"Áo sơ mi nam dài tay caro nhỏ NSMMCNMTCR212817D",329000,329000,0,0
TIKI,thoi-trang-nam,98985678,"Áo thun Teeworld TW x Vietnamese Food - Com Tam Form Rộng Unisex Nam Nữ",359000,359000,0,0
TIKI,thoi-trang-nam,5465375,"Áo Khoác Nam Có Big Size (Over size) màu xanh đậm",160000,160000,0,0
TIKI,thoi-trang-nam,74682428,"Áo khoác dù nam nữ in family",100000,100000,0,0
TIKI,thoi-trang-nam,174296543,"ÁO VARSITY JACKER BOMBER UNDERTRAP ÁO BOMBER NỈ PE LÓT BÔNG SIÊU ẤM\",99000,99000,0,0
TIKI,thoi-trang-nam,193234712,"Áo Sơ Mi Nam Dài Tay Linen Shirt Giordano 01042201",328000,940000,612000,65
TIKI,thoi-trang-nam,30030445,"Quần Khaki Nam Không Ply Ống Ôm Khatoco Q2M528S0-VNMA002-1907-006",189000,528000,339000,64
TIKI,thoi-trang-nam,57822939,"Áo Khoác Nhẹ Nam Cardigan Chất Nỉ Phối Cổ Tim Phong Cách Nam Tính Cao Cấp AN14 - ShopN6",149000,155000,6000,4
TIKI,thoi-trang-nam,155716886,"Viettien - Quần tây nam màu nâu đậm không ly 8P4091 regular fit",540000,540000,0,0
TIKI,thoi-trang-nam,184327303,"OWEN - Quần âu nam màu ĐEN dáng regular cạp tăng đơ co dãn",650000,650000,0,0
TIKI,thoi-trang-nam,95053766,"Áo Khoác Big Size Nam Nữ Áo Khoác Kaki Unisex Chống Nóng Chống Nắng Chống Lạnh Chống Gió 2 Lớp Có Cổ Cao Thời Trang Nam Tính Hàn Quốc Cao Cấp QK36 - ShopN6",169000,235000,66000,28
TIKI,thoi-trang-nam,145178769,"OWEN - Áo sơ mi dài tay Owen Regular fit kẻ ca rô chất sợi tre 23377",588000,588000,0,0
TIKI,thoi-trang-nam,85087534,"Áo sơ mi nam dài tay màu tím",159000,159000,0,0
TIKI,thoi-trang-nam,46601617,"Áo thun nam tay lỡ form rộng Unisex Methata Freesize mặc vừa từ 45 - 70kg",40000,40000,0,0
TIKI,thoi-trang-nam,121610316,"Áo khoác dạ măng tô nam màu nâu bò  ALGMT.2",1375000,1375000,0,0
TIKI,thoi-trang-nam,90598742,"Đồ bộ PIJAMA Nam dài tay họa tiết sọc Caro, chất Cotton 100%, hàng cao cấp style Hàn Quốc thời thượng",504000,504000,0,0
TIKI,thoi-trang-nam,189676721,"Áo sơ mi nam ngắn tay trắng Regular fit NSMMMWNTCR220127N",199000,309000,110000,36
TIKI,thoi-trang-nam,176731624,"Áo Sơ Mi Nam Công Sở Trung Niên Thương Hiệu Anton Dài Tay Kẻ Sọc Đỏ Vải Cotton Mã AC153",295000,405000,110000,27
TIKI,thoi-trang-nam,105708792,"Áo Khoác Big Size Áo Khoác Kaki Nam Cổ Cao Hai Lớp Chống Nắng Chống Lạnh Phối Dây Kéo Ngực Giả Ves Hàn Quốc Cao Cấp ShopN6 - QK45  - M",199000,235000,36000,15
TIKI,thoi-trang-nam,186191043,"Áo thun Polo melange dệt chìm xương cá không túi đen NATMMTMCSR210109N",299000,379000,80000,21
TIKI,thoi-trang-nam,70307237,"ÁO KHOÁC DÙ CÓ TÚI TRONG, CÓ KHÓA KÉO",100000,100000,0,0
TIKI,thoi-trang-nam,91009687," Sét bộ quần áo thể thao nam - Thời trang hè",102000,102000,0,0
TIKI,thoi-trang-nam,54781910,"Quần Đi Bơi Nam Thời Trang 410",220000,220000,0,0
TIKI,thoi-trang-nam,76688304,"Áo thun nam cổ tròn màu xám NOVELTY 181211N",219000,219000,0,0
TIKI,thoi-trang-nam,84826810,"Quần Sịp Nam Chữ V Nâng Mông Siêu Thoáng K367",62000,62000,0,0
TIKI,thoi-trang-nam,20831989,"Áo Khoác Da Nam Cổ Trụ Lót Lông Cao Cấp ShopN6 AKD18",269000,430000,161000,37
TIKI,thoi-trang-nam,158755601,"Áo Sơ Mi Nam Dài Tay Sọc Chữ Mã GM11 Thời Trang EMEY LUXURY Thiết Kế Nam Tính Lịch Lãm Chuẩn Form",150000,150000,0,0
TIKI,thoi-trang-nam,188915801,"Bộ Quần Áo Gió Thể Thao Nam FASVIN BC21485.HN 02 Lớp Lót Thun Dày Dặn Ấm Áp Chất Vải Và Phom Dáng Rất Đẹp",799000,938000,139000,15
TIKI,thoi-trang-nam,24744552,"Quần Lót Nam Vải Lụa Sữa Cao Cấp LS2088",95000,95000,0,0
TIKI,thoi-trang-nam,51557341,"Áo Sơ Mi Nam Caro Ô Nhỏ Cao Cấp",125000,125000,0,0
TIKI,thoi-trang-nam,186630767,"Bộ quần áo mặc nhà cho ông, cho bố BD02 set bộ áo cộc cổ tàu quần dài chất đũi mềm mát",265000,265000,0,0
TIKI,thoi-trang-nam,188492826,"Combo 2 quần boxer nam trơn, bảng to chất thun mềm mịn thoáng mát, co giãn tốt - FORMEN SHOP - FMCB2QS017",99000,150000,51000,34
TIKI,thoi-trang-nam,72791018,"Áo Khoác Nam Cardigan Nam Len Cao Cấp Thời Trang SZone SAL219",209000,209000,0,0
TIKI,thoi-trang-nam,185124050,"0113-Bộ Pijama nam dài tay cotton 100% màu xanh navy gọn dáng, phù hợp những ai thích đơn giản, sang trọng (M0113)",500000,500000,0,0
TIKI,thoi-trang-nam,67656515," Combo 4 quần lót nam,sịp nam nhật bản ,lụa sữa nhẹ tênh mát lạnh có hộp đẹp",163400,163400,0,0
TIKI,thoi-trang-nam,113052002,"[P] Áo khoác nam Áo khoát nam gió dù 2 lớp chống nắng tiếng Nhật xitin hàng rất đẹp-M111",89250,89250,0,0
TIKI,thoi-trang-nam,188718369,"SECRET BOX - Áo thun Teeworld Unisex Form Rộng Nam Nữ",99000,99000,0,0
TIKI,thoi-trang-nam,84826168,"Sịp Đùi- Quần Lót Nam Boxer Sọc Ngang Cotton Siêu Mềm Form To Thoáng Khí K458",48000,48000,0,0
TIKI,thoi-trang-nam,165213172,"Quần Boxer Nam sợi cotton lạnh kháng khuẩn thoải mái mềm mịn, Quần Lót Nam co giãn 4 chiều thấm hút mồ hôi cực tốt thương hiệu BAW (combo 3 màu ngẫu nhiên) QLN9",149000,149000,0,0
TIKI,thoi-trang-nam,3947017,"Áo Polo Nam Aligo ALGPS.2 (Size",434500,434500,0,0
TIKI,thoi-trang-nam,94879813,"Viettien - Áo sơ mi nam ngắn tay xẻ tà lai ngang ca rô regular 0583",497000,497000,0,0
TIKI,thoi-trang-nam,122348854,"Áo Thun Nam Cổ Tròn Giordano GM C-neck Tee 01020250",239000,320000,81000,25
TIKI,thoi-trang-nam,120326517,"Quần âu dáng slim-fit cạp lót họa tiết cao cấp logo TORANO BT030",450000,450000,0,0
TIKI,thoi-trang-nam,181255167,"Áo sơ mi nam cổ tàu dài tay xanh quả bơ",159000,159000,0,0
TIKI,thoi-trang-nam,166411572,"OWEN - Quần kaki nam Owen chất thô giấy mềm mại co dãn màu xám đậm 21995",595000,595000,0,0
TIKI,thoi-trang-nam,29641000,"Áo sơ mi nam cổ trụ cài hết cúc",159000,159000,0,0
TIKI,thoi-trang-nam,191777273,"ÁO SƠ MI CARO VNXK CÓ TÚI TAY DÀI BIG SIZE TỚI 130KG",225000,225000,0,0
TIKI,thoi-trang-nam,164336544,"[VIDEO ẢNH THẬT] Áo Khoác dù Unisex Hoa Văn GD Cặp Nam nữ-Áo Khoác Gió Có khóa kéo - Thu Đông Kiểu Rộng Couple Jackets",102000,102000,0,0
TIKI,thoi-trang-nam,117901638,"BỘ THỂ THAO NAM MÙA HÈ VẢI THUN LẠNH CO GIÃN MÁT MẺ ÁO THUN QUẦN LỬNG DINKBHFKS,Set bộ thun thể thao nam quần đùi áo ngắn tay chất thun mè cực mát cho mùa hè",106000,106000,0,0
TIKI,thoi-trang-nam,191579766,"Quần đùi nam Novelty NQDMCTNCVC220071S",95000,95000,0,0
TIKI,thoi-trang-nam,189642405,"Áo sơ mi nam dài tay màu xanh dương nhạt Regular fit NSMMMNNSPR220262D",299000,389000,90000,23
TIKI,thoi-trang-nam,134387013,"Áo Khoác Bomber Jackets Dù 2 Lớp LASTIC Form Rộng Nam Nữ Unisex Ulzzang KUN",100000,100000,0,0
TIKI,thoi-trang-nam,170735829,"Viettien - Áo sơ mi nam ngắn tay xẻ tà vạt ngang 1Q0168 kẻ sọc regular",535000,535000,0,0
TIKI,thoi-trang-nam,39983639,"ÁO PHÔNG Luffy",120000,120000,0,0
TIKI,thoi-trang-nam,178779614,"Áo sơ mi nam màu tím nho, phong cách Hàn Quốc, form body slim fit, không túi, vải Bamboo, Amazing",195000,297000,102000,34
TIKI,thoi-trang-nam,100367931," Quần đùi nam Fasvin Q21462.HN vải gió chun co giãn mềm mại thoải mái vận động",99000,198000,99000,50
TIKI,thoi-trang-nam,48622497,"Áo Hoodie Nỉ trơn đơn giản cá tính",89000,89000,0,0
TIKI,thoi-trang-nam,132815335,"Áo Polo Nam Full White cổ bẻ vải Cotton bền màu, chuẩn form, sang trọng, lịch lãm - SOBIE",245000,350000,105000,30
TIKI,thoi-trang-nam,115885857,"Áo thun NEEDS OF WISDOM Puff Ombre Tee",395000,395000,0,0
TIKI,thoi-trang-nam,196855999,"Đai kẹp giữ áo sơ mi QT983",100000,100000,0,0
TIKI,thoi-trang-nam,90065743,"Bộ quần áo thể thao nam",82000,82000,0,0
TIKI,thoi-trang-nam,195912241,"Áo sơ mi nam dài tay SSM-656",300000,300000,0,0
TIKI,thoi-trang-nam,15309836,"QUẦN SHORT NAM MÀU KEM",105000,105000,0,0
TIKI,thoi-trang-nam,67233026,"ÁO SWEATER 4 MÀU NỈ NGOẠI FORM RỘNG OVERSIZE (Unisex nam nữ đều mặc được)",94900,94900,0,0
TIKI,thoi-trang-nam,197218258,"Quần thun dài jogger vải nỉ big size nam 80-130kg",215000,215000,0,0
TIKI,thoi-trang-nam,83518673,"ÁO THUN NAM NGẮN TAY CỔ TRỤ PHONG CÁCH",193700,193700,0,0
TIKI,thoi-trang-nam,164947733,"ÁO BLAZER NAM HÀN QUỐC BỐN MÙA 006375",3500000,3500000,0,0
TIKI,thoi-trang-nam,88020907,"Áo Khoác Bomber Dù Unisex Form Rộng 2 Lớp ULZZANG, ÁO KHOÁC GIÓ BOMBER NAM NỮ CÚC BẤM, Áo Bomber CHẤT LIỆU DÙ 2 LỚP CHỐNG THẤM NƯỚC, Áo khoác bomber bóng chày nam nữ",99000,99000,0,0
TIKI,thoi-trang-nam,23074205,"ÁO SƠ MI DÀI TAY CÔNG SỞ DÁNG SLIM MÃ ALGS168",588500,588500,0,0
TIKI,thoi-trang-nam,181806687,"Áo Khoác Bomber Nhung Kaki 2 Lớp Lót Dù Chữ Super Bros - Kiểu Hàn Quốc Unisex  Cặp Nam Nữ Thu Đông",164000,164000,0,0
TIKI,thoi-trang-nam,178588791,"Áo sơ mi nam form body slim fit,  phong cách Hàn, không túi, vải Bamboo màu trơn, hiệu Amazing",195000,297000,102000,34
TIKI,thoi-trang-nam,38447776,"Combo 5 Quần lót nam tam giác cotton xịn nhiều lưng có size lớn màu ngẫu nhiên cao cấp mặc cực thoãi mái underwear SỊP HN5",61000,128000,67000,52
TIKI,thoi-trang-nam,138491682,"Áo khoác Hoodie Nam, Hoodie Basic Unisex Nỉ From Rộng NÓN 2 LỚP PHẢN QUANG 7 MÀU, Áo Khoác Hoodie Nam Phản Quang Mẫu Mới Vải Nỉ Dầy Kiểu Dáng Thời Trang Hình In Hot Trend",127000,127000,0,0
TIKI,thoi-trang-nam,48981200,"Áo sơ mi nam có nón in 2 sọc tay",89000,89000,0,0
TIKI,thoi-trang-nam,151799923,"QUẦN LÓT NAM - Tam Giác Lưới Nhỏ Thoáng Mát - Thun Lạnh",59000,59000,0,0
TIKI,thoi-trang-nam,178476854,"Áo somi nam màu xanh ngọc tay dài, style Hàn Quốc, không túi, vải Bamboo nhẹ mát, hiệu Amazing",195000,297000,102000,34
TIKI,thoi-trang-nam,35908681,"Khóa bướm chống hằn dây đồng hồ da",119000,119000,0,0
TIKI,thoi-trang-nam,157206405,"Áo khoác bomber jacket nam nữ hình in undertrap khoác varsity undertrap chất nỉ cotton cao cấp hany shop",119000,119000,0,0
TIKI,thoi-trang-nam,73420975,"ÁO LEN GILE NAM ALIGRO - XÁM NHẠT",500500,500500,0,0
TIKI,thoi-trang-nam,197890094,"OWEN - Quần âu nam Owen dáng Trendy (dáng ôm) trẻ trung - Quần tây Owen",595000,595000,0,0
TIKI,thoi-trang-nam,53774764,"Quần Thun Lửng Nam",86000,86000,0,0
TIKI,thoi-trang-nam,57979853,"Áo Thun Nam Tanktop Ba Lỗ Tập Gym Thể Thao - AT022",120000,120000,0,0
TIKI,thoi-trang-nam,105358971,"Quần jeans nam ống suông MESSI MJB0106",590000,590000,0,0
TIKI,thoi-trang-nam,44003442,"Quần lót nam mạnh mẽ màu vàng- Freesize dưới 85kg",35000,35000,0,0
TIKI,thoi-trang-nam,182710041,"áo khoác dù dày nam hàn quốc 2 lớp dày dặn không phai màu hot 2022",165000,165000,0,0
TIKI,thoi-trang-nam,183353659,"2016- ĐỒ BỘ PIZAMA NAM cộc tay: COTTON 100%, style HÀN QUỐC-Shop Thủy Bông",430000,430000,0,0
TIKI,thoi-trang-nam,113052130,"Áo khoác nam Áo khoát nam gió dù 2 lớp chống nắng LOCAL PEOPLE đẹp siêu hot - M100",89250,89250,0,0
TIKI,thoi-trang-nam,70630832,"Áo khoác kaki nam cao cấp thời trang, có túi trong tiện lợi cao cấp phong cách thời trang Dokafashion DKN15",204000,299000,95000,32
TIKI,thoi-trang-nam,162834923,"Áo Sơ Mi Nam Xanh Dương Ngắn Tay Thương Hiệu Anton Công Sở Trung Niên Vải Sợi Tre Họa Tiết In XGD561",265000,325000,60000,18
TIKI,thoi-trang-nam,77629950,"Áo sơ mi nam tay dài họa tiết ngôi sao",207000,207000,0,0
TIKI,thoi-trang-nam,197709218,"Áo Polo nam BLOOK có cổ BASIC vải cá sấu cotton, nam tính, chỉn chu, sang trọng mã 35568",399000,399000,0,0
TIKI,thoi-trang-nam,114313293,"QUẦN JOGGER KAKI NAM PHONG CÁCH HÀN QUỐC CÁ TÍNH LỊCH LÃM",83000,83000,0,0
TIKI,thoi-trang-nam,176405279,"Áo Khoác Bomber Varsity Jacket in chữ A A&amp;X in phối tay cá tính form Unisex Nam Nữ",92000,92000,0,0
TIKI,thoi-trang-nam,128868401,"Áo Khoác Hoodie Nam Nữ In Hoạt Hình Form Rộng",106000,106000,0,0
TIKI,thoi-trang-nam,111710357,"Áo Thun Nam Áo Thun Nam Polo Viền Vai Full Màu VG01 Chất Thun Mát Trẻ Trung",125000,125000,0,0
TIKI,thoi-trang-nam,110904270,"Quần jogger nam lót lông siêu ấm quần nỉ nam bo gấu cạp chun dây rút siêu ấm thời trang Banamo Fashion 792",111000,111000,0,0
TIKI,thoi-trang-nam,198211810,"Quần jean nam form to, Quần chiến thuật lính S.archon ARM-1123",680000,680000,0,0
TIKI,thoi-trang-nam,169347359,"Áo Thun TAY LỠ TRƠN - Áo Phông Trơn Basic Unisex Nam Nữ Form Rộng Thời Trang Hàn Quốc Ullzang",78000,78000,0,0
TIKI,thoi-trang-nam,198203124,"COMBO 4 cái Quần lót nam Boxer Kendotogo màu ngẫu nhiên",249000,392000,143000,36
TIKI,thoi-trang-nam,169348109,"Áo Khoác Bomber Jackets Kaki Nhung Tăm Thêu IAOR Form Rộng Nam Nữ Unisex HOT TREND",158000,158000,0,0
TIKI,thoi-trang-nam,116096241,"Áo sơ mi dài tay nam TUTO5 sơ mi công sở họa tiết sọc kẻ caro Slim fit Shirt cotton chống nhăn cao cấp phong cách trẻ trung, nam tính - TRISTAN446",449000,449000,0,0
TIKI,thoi-trang-nam,171905408,"Áo Thun T LÀO Nam Nữ Ulzzang Unisex, ÁO THUN T LÀO FORM RỘNG NAM NỮ PHÔNG 3158 COTTON ULZZANG, Áo Snoopdogg x Thuốc Lào - Ghost Trick local brand, ÁO UNISEX TAY LỠ FROM RỘNG NAM NỮ _ COUPLE ĐỀU MẶC ĐƯỢC IN THUỐC LÀO",99000,99000,0,0
TIKI,thoi-trang-nam,29647841,"Áo sơ mi nam ngắn tay màu xanh đen",108000,108000,0,0
TIKI,thoi-trang-nam,76162763,"Áo sơ mi nam viền đen họa tiết kiến",207000,207000,0,0
TIKI,thoi-trang-nam,117176114,"Sịp Đùi- Quần Lót Nam Boxer Cotton Sọc Ngang Phong Cách Nhật Bản Thanh Lịch K141",38000,38000,0,0
TIKI,thoi-trang-nam,119063763,"Áo polo nam màu xanh biển nhạt phối viền chìm ADINO vải cotton polyester mềm dáng slimfit công sở trẻ trung năng động AP82",159000,318000,159000,50
TIKI,thoi-trang-nam,43768930,"Áo Khoác Dù Dày Nam Xanh Đen Hai Lớp Cổ Trụ Cao Cấp - ADD33",145000,245000,100000,41
TIKI,thoi-trang-nam,101656125,"Áo Khoác Dạ Nam Có Đai Áo Dạ Nam Dáng Vừa Kèm Đai Sans06 Sans Shop",599000,599000,0,0
TIKI,thoi-trang-nam,161367286,"Áo Sơ Mi Trơn thun Dầy Dặn Tay Dài Nam Cho Tomboy Trắng Đen Form Rộng Bigsize Unisex Cao Cấp Đi Học Công Sở Nguyễn Nguyên",250740,250740,0,0
TIKI,thoi-trang-nam,189641803,"Áo sơ mi nam dài tay màu xanh da trời Regular fit NSMMMNNSPR220261D",299000,389000,90000,23
TIKI,thoi-trang-nam,137668311,"Quần Jogger Nam Nữ Phản Quang Túi Hộp UNISEX - Quần Dài Thể Thao Vải Thun Nhảy Dance - Tập Gym Ulzzang KUN",85000,85000,0,0
TIKI,thoi-trang-nam,44302757,"Quần lót nam sexy - trắng",45000,45000,0,0
TIKI,thoi-trang-nam,186288814,"Áo Sơ Mi nam tay dài caro NSMMCLMTCR210226D",199000,319000,120000,38
TIKI,thoi-trang-nam,140465164,"Áo Sơ Mi Nam Dài Tay Phối Họa Tiết Chữ Ký Cổ Áo Thời Trang Hàn Quốc Sành Điệu",92500,92500,0,0
TIKI,thoi-trang-nam,91281686,"Bộ nam hè    BỘ ĐỒ BỘ THỂ THAO NAM THUN 4 CHIỀU CO DẴN MẶC MÁT",100000,100000,0,0
TIKI,thoi-trang-nam,68642296,"Quần bơi nam Lan Hạnh 50123L-DE0101",238000,238000,0,0
TIKI,thoi-trang-nam,194771065,"Quần Kaki Nam Ống Đứng MESSI SKM-730-18",420000,420000,0,0
TIKI,thoi-trang-nam,94880272,"Quần kaki nam việt tiến 8N6020 regular fit màu khaki",630000,630000,0,0
TIKI,thoi-trang-nam,174017097,"Quần Short Jean nam Leman xanh rách JL06 - Skinny Form",459000,459000,0,0
TIKI,thoi-trang-nam,57760785,"Áo khoác cardigan nam",420000,420000,0,0
TIKI,thoi-trang-nam,114328710,"ÁO KHOÁC DÙ BOMBER UNISEX NAM 2021",93000,93000,0,0
TIKI,thoi-trang-nam,19845869,"Quần lót nam",69840,69840,0,0
TIKI,thoi-trang-nam,210145683,"Quần lót nam lọt khe Cailin Kelei Jockstrap phối dây",59000,59000,0,0
TIKI,thoi-trang-nam,131417965,"Áo nỉ da cá nam dài tay T41",179000,179000,0,0
TIKI,thoi-trang-nam,129304037,"Quần thô kaki trung niên trung tuổi 1 li hàng Quảng Châu loại 1 chất cực đẹp",419000,419000,0,0
TIKI,thoi-trang-nam,165237748,"Quần Jean Nam Co Giãn Ống Đứng Dáng Đẹp Màu Xanh Biển , jean nam co gian",180000,180000,0,0
TIKI,thoi-trang-nam,78548052,"Áo Sweater Nam Nữ Form Rộng - nỉ chui thường không nón",86000,86000,0,0
TIKI,thoi-trang-nam,164309839,"Dad you're my hero, mã G94. Áo thun nam nữ in siêu đẹp. Áo phông thoát nhiệt GOKING hàng hiệu cao cấp",168000,168000,0,0
TIKI,thoi-trang-nam,173410519,"Áo Thun Nam Ngắn Tay Thương Hiệu Chandi, Chất Thun Cotton Xịn Mẫu Mới NH52",220000,220000,0,0
TIKI,thoi-trang-nam,79722388,"Bộ quần áo thể thao nam nữ in DINK",102000,102000,0,0
TIKI,thoi-trang-nam,197603813,"Áo Khoác Da Nam, Áo Khoác Da Lót Lông Bo Tay Siêu Ấm Phối Khóa Đồng Cao Cấp Thời Trang Dokafashion EZAD30",269000,499000,230000,46
TIKI,thoi-trang-nam,114189771,"BỘ HÈ CLOTHING - NGUYÊN SÉT THỂ THAO IN HÌNH CON MÈO HOẶC DƠI SIÊU NGẦU, BỘ QUẦN ÁO THỂ THAO MẶC NHÀ, THỜI TRANG NAM NỮ, BỘ ĐỒ NAM / BỘ ĐỒ NỮ / BỘ QUẦN ÁO NAM /BỘ QUẦN ÁO THỂ THAO BỘ ĐỒ NAM NỮ",99000,99000,0,0
TIKI,thoi-trang-nam,83519454,"ÁO THUN NAM DÀI TAY CỔ SƠ MI PHONG CÁCH HÀN QUỐC ATD01-XANH ĐEN",193700,193700,0,0
TIKI,thoi-trang-nam,93038427,"Áo Khoác Pilot - Áo Khoác Pilot Lính",1250000,1250000,0,0
TIKI,thoi-trang-nam,161952668,"Áo Khoác Nỉ Nam Cao Cấp - Vải Nỉ Nhập Mặt Thoáng Mát,Có Nón Che Rộng Cao Cấp AK016",105000,105000,0,0
TIKI,thoi-trang-nam,186552687,"Áo vest,áo vest nam với chất POLY chéo hàn cao cấp ,lịch lãm,sang trọng,hàng thiết kế cao cấp H60",489000,489000,0,0
TIKI,thoi-trang-nam,155564548,"áo phao lính gile nam trung niên chất đẹp",373500,373500,0,0
TIKI,thoi-trang-nam,83160371,"Áo Thun Nam Polo Phối Hai Sọc Thẳng Trắng",157000,157000,0,0
TIKI,thoi-trang-nam,163685308,"Áo Sơ Mi Nam Công Sở Trung Niên Thương Hiệu Anton Dài Tay Màu Xanh Ngọc Họa Tiết In Chìm 8560",265000,355000,90000,25
TIKI,thoi-trang-nam,146621968,"Áo Khoác Gió Nam Giordano 01071018",764000,2190000,1426000,65
TIKI,thoi-trang-nam,110182378,"Quần tây nam cao cấp Amazing, quần âu không ly, màu xám xanh và xám chì, họa tiết vân chìm, form truyền thống",260000,396000,136000,34
TIKI,thoi-trang-nam,190232181,"Áo phóng viên - áo gile lính Jeep cao cấp ARM-1062 (Cát)",610000,610000,0,0
TIKI,thoi-trang-nam,91282963,"BỘ THỂ THAO NAM, Bộ Quần Áo Thể Thao Nam Chất Thun Lạnh Mẫu Mới Nhất 2021",88000,88000,0,0
TIKI,thoi-trang-nam,190233058,"Áo gile nam, áo gile lính, áo phóng viên nam nhiều túi ARM-1063",580000,580000,0,0
TIKI,thoi-trang-nam,164582293,"Áo polo ngắn tay thời trang nam phối màu nhiều kiểu, chất thun cá sấu xịn - FORMEN SHOP - FMHK002",99000,250000,151000,60
TIKI,thoi-trang-nam,3967059,"Ao sơ mi nam dài tay ALIGRO 100% chất cotton xanh da trời cổ bẻ dáng ôm body ALGS106",329000,329000,0,0
TIKI,thoi-trang-nam,184070558,"Áo Vest nam, Áo Vest nam phối 2 màu lịch lãm, 2 lớp, bên trong lót nhung, ôm body, trẻ trung N39",350000,350000,0,0
TIKI,thoi-trang-nam,54762444,"Áo sơ mi nam tay dài form ôm Khatoco A1MD468S1-CNIN014-2106-D - Xanh dương họa tiết",356000,468000,112000,24
TIKI,thoi-trang-nam,162844633,"Áo Sơ Mi Nam Công Sở Trung Niên Ngắn Tay Xanh Tím Than Vải Cotton Họa Tiết Hoa Nhí  thương hiệu Anton – 809",225000,325000,100000,31
TIKI,thoi-trang-nam,197601957,"Áo khoác da nam lót lông siêu ấm cao cấp DAD30",269000,499000,230000,46
TIKI,thoi-trang-nam,73570874,"Áo Thun Nam Cổ Tròn Nhiều Màu",45000,45000,0,0
TIKI,thoi-trang-nam,20680707,"Quần Dài Jogger Nam Phối Sọc 1066",85500,85500,0,0
TIKI,thoi-trang-nam,30684306,"Áo Sơ Mi Nam Tay Ngắn Form Slim Khatoco A1MN438S1-CNMA002-2102-N - Size",291000,438000,147000,34
TIKI,thoi-trang-nam,141309645,"Áo hoodie nam nữ form rộng siêu xinh , Áo khoác nam nữ nỉ có mũ phong cách",110000,110000,0,0
TIKI,thoi-trang-nam,121677792,"Áo khoác lông vũ  màu đen ALGALV.10",1815000,1815000,0,0
TIKI,thoi-trang-nam,99838541,"Áo khoác len, cardigan nam, áo khoác bomber cardigan chữ F, áo khoác cardigan chống nắng chống lạnh freesize from rộng nam nữ, áo cardigan hàn quốc",100000,100000,0,0
TIKI,thoi-trang-nam,94879059,"Áo sơ mi nam việt tiến ngắn tay chấm bi 1P0726",490000,490000,0,0
TIKI,thoi-trang-nam,84749739,"ÁO KHOÁC NAM FORM RỘNG UNISEX, DÀNH CHO CẢ NAM NỮ PHONG CÁCH HÀN QUỐC",137000,137000,0,0
TIKI,thoi-trang-nam,55706073,"Kendo - Quần lót nam Kendo Boxer Silver Men's Underwear",68600,98000,29400,30
TIKI,thoi-trang-nam,85087212,"Áo sơ mi nam ngắn tay màu xanh biển",108000,108000,0,0
TIKI,thoi-trang-nam,178729678,"Áo Polo Nam Thiết Kế 2 Màu Năng Động Thời Trang Cao Cấp AVIANO",199000,398000,199000,50
TIKI,thoi-trang-nam,75615248,"Áo Hoodie Nỉ Bông Unisex Streetwear Lục Lăng ( unisex nam nữ đều mặc được) áo hoodie nam nữ, áo hoodie nữ, áo hoodie nam, áo hoodie ulzzang, áo hoodie unisex",113000,113000,0,0
TIKI,thoi-trang-nam,57910304,"Quần shorts Nam siêu mỏng vải dù - Q003B",230000,230000,0,0
TIKI,thoi-trang-nam,147914215,"PUMA - Áo thun polo nam Essentials Pique Train 586674",999000,999000,0,0
TIKI,thoi-trang-nam,13740267,"áo khoác jean nam A85 xanh trơn",256000,256000,0,0
TIKI,thoi-trang-nam,117583804,"ÁO HOÁC CHỐNG NẮNG BAO CHẮT KHÔNG PHAI MÀU",199000,199000,0,0
TIKI,thoi-trang-nam,103702113,"OWEN - Áo sơ mi dài tay Owen Slimfit chất modan màu tím 80761",568000,568000,0,0
TIKI,thoi-trang-nam,192724557,"Quần Lót Nam Relax Mã RLTK016",96000,96000,0,0
TIKI,thoi-trang-nam,90599019,"Đồ bộ Pijama nam cộc tay chất vải lụa satin cao cấp, nhẹ tênh, mềm mại, mặc cực kỳ dễ chịu, thư giãn, size L-3XL",430000,430000,0,0
TIKI,thoi-trang-nam,163677693,"Áo Sơ Mi Nam Dài Tay Công Sở Trung Niên Anton Xanh Caro Sợi Tre Thoáng Mát, Thấm Hút Mồ Hôi - XAC130",325000,425000,100000,24
TIKI,thoi-trang-nam,134409005,"Quần lót nam - Quần đùi boxer nam CAO KOE cho Học sinh trẻ trung, sinh viên cá tính cotton nguyên chất 100% thoáng khí",64000,80000,16000,20
TIKI,thoi-trang-nam,126040369,"Áo thu đông, chất nỉ da cá - dài tay form rộng cho các MEN (T41)",178000,178000,0,0
TIKI,thoi-trang-nam,71940265,"Áo khoác dù nam nữ in hình cầu thủ số 93",105000,105000,0,0
TIKI,thoi-trang-nam,191658148,"Áo Polo nam cổ bẻ phối vải cá sấu Cotton xuất xịn,chuẩn form, trẻ trung, sang trọng, thanh lịch, mã 35525 - BLOOk",429000,429000,0,0
TIKI,thoi-trang-nam,141332149,"Áo khoác nam, áo phao lông vũ siêu nhẹ, siêu ấm, chống nước ATUNER QLN026, áo khoác phao nam nữ kiểu dáng unisex năng động, trẻ trung – HÀNG CHÍNH HÃNG",225000,429000,204000,48
TIKI,thoi-trang-nam,76544147,"Áo sơ mi công sở trung niên nam TUTO5 Menswear dài tay trơn Regular Fit Plain Midnight Blue Shirt cotton chống nhăn cao cấp phong cách trẻ trung, nam tính xanh 105126021",499000,499000,0,0
TIKI,thoi-trang-nam,72638988,"Áo Sơ Mi Nam Sọc Caro Phong Cách Hàn Quốc GOAT MENSWEAR",94000,94000,0,0
TIKI,thoi-trang-nam,183948442,"Áo vest, Áo vest nam Tay lỡ phối màu Đen - Trắng hình khối độc lạ, đặc sắc tạo điểm nhấn nổi bật N30",288000,288000,0,0
TIKI,thoi-trang-nam,90599527,"Đồ bộ Pijama đồ bộ nam dài tay, chất lụa satin cao cấp mềm mại, nhẹ và mát, không phải phi lụa nhé. Size L-2XL",540000,540000,0,0
TIKI,thoi-trang-nam,155769333,"Áo len nam May 10 mã 200119455ON Đỏ đun-115",129000,129000,0,0
TIKI,thoi-trang-nam,101657309,"Áo Khoác Dạ Nam Trần Bông Áo Khoác Nam Có Mũ Có Đai Siêu Ấm Sans11 Sans Shop",790000,790000,0,0
TIKI,thoi-trang-nam,14695084,"Áo sơ mi trắng ngắn tay Việt Tiến 420",520000,520000,0,0
TIKI,thoi-trang-nam,76128506,"Áo khoác da nam tay thun lót lông thời trang cao cấp",315000,315000,0,0
TIKI,thoi-trang-nam,88020750,"Áo khoác dù 2 lớp thêu logo TM cá tính, Áo Khoác Dù Unisex Kiểu Dáng Bomber - Chất Liệu 2 Lớp Lót Dù Thoáng Mát - Thiết Kế Họa Tiết Chữ In 3D Cá Tính",99000,99000,0,0
TIKI,thoi-trang-nam,13798416,"Áo Khoác Dù Nam Đen 2 Lớp Chống Tia UV Cao Cấp ShopN6 - KM07",259000,266000,7000,3
TIKI,thoi-trang-nam,106886579,"OWEN - Áo sơ mi ngắn tay Owen Slimfit vải sợi tre kẻ sọc 22685",548000,548000,0,0
TIKI,thoi-trang-nam,140865474,"Áo khoác Hoodie Nam, Hoodie Basic Unisex Nỉ From Rộng NÓN 2 LỚP PHẢN QUANG 7 MÀU, Áo Hoodie Nam Nữ oversize form rộng nam nữ phong cách ulzzang hàn quốc",127000,127000,0,0
TIKI,thoi-trang-nam,122590860,"OWEN - Áo sơ mi dài tay Owen regularfit kẻ ca rô màu xám chất Nano ko nhăn 22969",598000,598000,0,0
TIKI,thoi-trang-nam,81093614,"ÁO KHOÁC DÙ CẶP ĐÔI FORM RỘNG SIÊU XINH",100000,100000,0,0
TIKI,thoi-trang-nam,183948366,"Áo khoác Nam, Áo khoác cổ Vest, tay 3/4 chất liệu Lai KAKI, phong cách năng động, lịch lãm Mã T9",270000,270000,0,0
TIKI,thoi-trang-nam,165176854,"Áo thun Relax mã RTKA014",225000,225000,0,0
TIKI,thoi-trang-nam,58255722,"Áo thun nam cổ bẻ tay ngắn trẻ trung, chất liệu cotton cao cấp mẫu THUU67",129000,199000,70000,35
TIKI,thoi-trang-nam,141662877,"Áo len nam khóa kéo có túi mẫu mới LNA17",340000,340000,0,0
TIKI,thoi-trang-nam,186271254,"Áo Polo nam xanh da trời NATMINMCLR210088N",299000,399000,100000,25
TIKI,thoi-trang-nam,174318792,"Viettien - Áo sơ mi nam dài tay ca rô cao cấp 1R0420 regular",710000,710000,0,0
TIKI,thoi-trang-nam,11444695,"Combo 6 Quần Lót Nam Tam Giác Thun Lạnh Vĩnh Tiến QL-03 - Nhiều Màu",459000,510000,51000,10
TIKI,thoi-trang-nam,34707514,"Áo măng tô nam dáng dài hàng hiệu cao cấp NMT11",3850000,3850000,0,0
TIKI,thoi-trang-nam,191777586,"ÁO THUN XÁM TAY NGẮN CỔ TRÒN CHỮ TIME BIG SIZE NAM TỚI 130KG",200000,200000,0,0
TIKI,thoi-trang-nam,76128603,"Áo da lót dù thời trang cao cấp",374000,374000,0,0
TIKI,thoi-trang-nam,157097984,"Quần Kaki Nam Kiểu Dáng Hàn Quốc Trẻ Trung Ống Côn Trẻ Trung Cực Dễ Phối Đồ CV024",90000,90000,0,0
TIKI,thoi-trang-nam,90984718,"Áo Khoác Dù Nam Phối Nón, Dù Thái Nhập Khẩu  ( Tặng 1 áo khoác dù màu ngẫu nhiên ) Dokafashion Siêu Nhẹ Cao Cấp Dành Cho Đi Nắng Đi Mưa EZAK24",265000,350000,85000,24
TIKI,thoi-trang-nam,90065800,"QUẦN SHORT QUẦN KAKI LỬNG THỜI TRANG NAM SIZE M L XL",102000,102000,0,0
TIKI,thoi-trang-nam,13331882,"Quần lót Nam Boxer thời trang",99000,99000,0,0
TIKI,thoi-trang-nam,129301004,"Quần Kaki Nam Trung Niên cao cấp size cho người 100kg có màu tối sáng chất bao đẹp",279000,279000,0,0
TIKI,thoi-trang-nam,30764120,"Quần lót boxer nam Khatoco Q5M085R0-VNMA010-2101-B",65000,85000,20000,24
TIKI,thoi-trang-nam,94881811,"Áo sơ mi ngắn tay việt tiến màu tím cà",300000,300000,0,0
TIKI,thoi-trang-nam,22760760,"Áo thun nam cổ bẻ vải cá sấu,combo 3 áo - EZ304",269000,397000,128000,32
TIKI,thoi-trang-nam,140533256,"Viettien - Áo sơ mi nam dài tay ca rô 1P2081 form regular",535000,535000,0,0
TIKI,thoi-trang-nam,146954133,"Quần lót tam giác Nam trẻ trung thời trang - A094",95000,95000,0,0
TIKI,thoi-trang-nam,138749504,"Áo thun nam cổ tim dài tay đẹp nhiều màu ( hàng cao cấp )",109000,129000,20000,16
TIKI,thoi-trang-nam,133688746,"Quần kaki nam trung niên có size 100kg - 3",358500,358500,0,0
TIKI,thoi-trang-nam,114992543,"Áo sơ mi nam dài tay cổ tàu công sở hoạt tiết TUTO5 cao cấp chất đẹp Slimfit Shirt kháng khuẩn khử mùi tốt, ít nhăn",399000,399000,0,0
TIKI,thoi-trang-nam,151799931,"QUẦN LÓT NAM - LỌT KHE SEXY - LƯỚI SỌC",49000,49000,0,0
TIKI,thoi-trang-nam,197601289,"Áo khoác da nam lót lông siêu ấm cao cấp cấp DAD26",499000,499000,0,0
TIKI,thoi-trang-nam,140210564,"Viettien - Áo sơ mi nam ngắn tay chấm bi vạt bầu chất liệu sợi sen 3996 regular",505000,505000,0,0
TIKI,thoi-trang-nam,85087385,"Áo Sơ mi nam denim xanh đen",159000,159000,0,0
TIKI,thoi-trang-nam,45438648,"Áo thun nam cổ tròn tay ngắn, chất thun cao cấp, trẻ trung, năng động – FORMEN SHOP – FMPS080",109000,210000,101000,48
TIKI,thoi-trang-nam,88020724,"Áo khoác bomber dù unisex bóng chày form rộng Mèo Lâu nam nữ ulzzang, Áo khoác dù kiểu bomber 2 lớp thêu logo cá tính thời trang, Áo Khoác Bomber Dù Unisex Bóng Chày Form Rộng Mèo Lâu Nam Nữ Ulzzang KiuKiu, Áo Khoác Bomber Chất Liệu Kaki Chất Đẹp",99000,99000,0,0
TIKI,thoi-trang-nam,76281423,"Áo sơ mi dài tay nam TUTO5 sơ mi công sở họa tiết sọc kẻ caro Extra Slim fit Shirt cotton chống nhăn cao cấp phong cách trẻ trung, nam tính - 105122059 - 38",449000,449000,0,0
TIKI,thoi-trang-nam,35363158,"Quần Lót Nam Thong Sexy Phong Cách Mỹ",89000,89000,0,0
TIKI,thoi-trang-nam,113786766,"OWEN - Quần short Khaki nam Owen 22320/22316 - quần sooc nam kaki",395000,395000,0,0
TIKI,thoi-trang-nam,49998187,"Áo Jacket nam Novelty 02 lớp màu xanh Yamaha NJKMMTMPLR1806362",399000,399000,0,0
TIKI,thoi-trang-nam,110151265,"Áo sơ mi dài tay nam TUTO5 sơ mi công sở họa tiết sọc kẻ Slim fit Shirt cotton chống nhăn cao cấp phong cách trẻ trung, nam tính - TRISTAN457 - 37",399000,399000,0,0
TIKI,thoi-trang-nam,133814446,"áo phông nam trung niên ngắn tay có cổ",179000,179000,0,0
TIKI,thoi-trang-nam,162030202,"Áo Bomber/ Áo khoác nỉ màu tàn phối trắng in chữ CS  cúc bấm ,ÁO KHOÁC NỈ  nam nữ NĂNG ĐỘNG, MÃU MỚI 2022",134000,134000,0,0
TIKI,thoi-trang-nam,13326027,"Quần lót nam thun lạnh - QL005",99000,99000,0,0
TIKI,thoi-trang-nam,162118236,"QUẦN KAKI NAM  MÀU XANH ĐEN TÚI MỸ DÁNG SUÔNG",165000,165000,0,0
TIKI,thoi-trang-nam,184247626,"Áo Vest Nam, Áo Vest Nam 2 nút, ống tay bo phối sọc ngang nổi bật, phong cách tối giản. Mã H58",340000,340000,0,0
TIKI,thoi-trang-nam,68629983,"Quần bơi nam Lan Hạnh 50123-DE0102",238000,238000,0,0
TIKI,thoi-trang-nam,125803035,"(ẢNH THẬT) ÁO SWEATER BÓNG CHÀY FORM RỘNG UNISEX THIẾT KẾ ĐỦ SIZE CHO CẢ NAM VÀ NỮ, ÁO HOODIE CHUI ĐẦU ULZZANG PHỐI VIỀN, Áo Nỉ Viền Cổ Tim Số 26 Ngược Chất Nỉ Ngoại Dày Mịn",99000,99000,0,0
TIKI,thoi-trang-nam,101656322,"Áo khoác kaki nam hàn quốc manto Sans12 măng tô dáng ngắn khaki blazer bigsize to 3xl 4xl 5xl cỡ đại 80kg 90kg 100kg",599000,599000,0,0
TIKI,thoi-trang-nam,152292752,"Quần Kaki Nam Kiểu Dáng Hàn Quốc Trẻ Trung Ống Côn Trẻ Trung Cực Dễ Phối Đồ CV024",90000,90000,0,0
TIKI,thoi-trang-nam,165596173,"Viettien - Áo thun nam có cổ kẻ sọc ngang 6R3113 regular",660000,660000,0,0
TIKI,thoi-trang-nam,150879043,"Viettien - Quần short nam kaki màu xanh đen 6Q8003 regular fit",525000,525000,0,0
TIKI,thoi-trang-nam,140462500,"Áo Sơ Mi Nam Dài Tay Họa Tiết Sọc 621 Thời Trang Cao Cấp PONIVA Chất Vải Cao Cấp Mềm Mại Thấm Hút Mồ Hôi Tốt",99000,99000,0,0
TIKI,thoi-trang-nam,196209471,"Áo thun Teeworld Hanoi Retro T-Shirt Trắng Đen Form Rộng Unisex Nam Nữ",399000,399000,0,0
TIKI,thoi-trang-nam,75789492,"QUẦN NGỦ NAM THUN 100 % COTTON FEZZIO",59500,119000,59500,50
TIKI,thoi-trang-nam,129228655,"Áo Hoodie phản quang 7 màu POKER form dưới 70kg decan in xịn, áo khoác hoodie unisex ulzzang quảng châu in hình ách cơ, áo hoodie nam nữ đều mặc được chống nắng, tranh mưa mặc đi đà lạt",125000,125000,0,0
TIKI,thoi-trang-nam,74280990,"Quần jogger nam thể thao Julido Store, chất kaki bo chân xu hướng mới nhất JD02",149000,220000,71000,32
TIKI,thoi-trang-nam,116096336,"Áo sơ mi ngắn tay nam TUTO5 sơ mi công sở họa tiết sọc kẻ caro Slim fit Shirt cotton chống nhăn cao cấp phong cách trẻ trung, nam tính",379000,379000,0,0
TIKI,thoi-trang-nam,183731890,"Áo sơ mi nam, Áo sơ mi dài tay phối vạt Bu Dông khỏe khoắn, cúc bấm mang trẻ trung lịch lãm H55",275000,275000,0,0
TIKI,thoi-trang-nam,145139297,"Áo phao nam đại hàn trẻ trung NAP36",780000,780000,0,0
TIKI,thoi-trang-nam,79721715,"Bộ đồ UNISEX nam nữ in chữ Hàn",99000,99000,0,0
TIKI,thoi-trang-nam,40350993,"Quần lót nam mềm mại thoáng khí hở mông - Màu đen",45000,45000,0,0
TIKI,thoi-trang-nam,133690824,"Quần kaki 1 ly nam trung niên(4 màu) ẢNH THẬT",343500,343500,0,0
TIKI,thoi-trang-nam,184073425,"Áo Gile nam, Áo Gile Nam cách điệu Gấu áo Tam giác, phối nơ sau. Kiểu dáng tối giản , lịch sự. mã T7",269000,269000,0,0
TIKI,thoi-trang-nam,56703828,"Bộ 4 áo thun nam cổ bẻ cao cấp ( Tặng 1 dây nịt da ) DokaFashion, chất liệu thun cá sấu 4 chiều ngoại nhập - Đỏ đô, Xám đậm, Xanh dương, Xanh cổ vịt",348500,571000,222500,39
TIKI,thoi-trang-nam,71940867,"Áo thun tay dài nam nữ",75000,75000,0,0
TIKI,thoi-trang-nam,184901282,"Quần lót nam brief RLTK006 quần sịp nam thoáng mát mềm mại cao cấp, co giãn tốt, ôm gọn - RELAX",93000,93000,0,0
TIKI,thoi-trang-nam,164017356,"Áo Sơ Mi Nam Trắng Công Sở Thương Hiệu ANTON  Dài Tay Họa Tiết Kẻ Sọc Cotton - AT205",325000,425000,100000,24
TIKI,thoi-trang-nam,173998725,"Quần Jean nam Leman xanh rách JD06 - Slim Form",549000,549000,0,0
TIKI,thoi-trang-nam,99679451,"Áo sơ mi nam thêu chữ,  thương hiệu cao cấp Amazing, phong cách Hàn Quốc, form body slimfit, tay dài",195000,297000,102000,34
TIKI,thoi-trang-nam,169111704,"Combo 3 quần lót nam x-men, lưng quàn bản vừa, chất vải thấm hút mồ hôi - FORMEN SHOP - FM3QS005",99000,150000,51000,34
TIKI,thoi-trang-nam,124766042,"Quần jogger thể thao nam nữ, quần ống suông 3 sọc 1 sọc chất dày dặn, vải cao cấp Joger không xù không nhăn",65000,65000,0,0
TIKI,thoi-trang-nam,34707114,"Áo khoác măng tô nam trẻ trung mẫu hàn quốc NMT10",1850000,1850000,0,0
TIKI,thoi-trang-nam,7548467,"Áo khoác dù nam, cầu vai",203000,299000,96000,32
TIKI,thoi-trang-nam,162865673,"Áo Sơ Mi Nam Công Sở Trung Niên Ngắn Tay Xanh Tím Than thương hiệu Anton Vải Cotton Họa Tiết Hoa Nhí – Y809",225000,325000,100000,31
TIKI,thoi-trang-nam,90024039,"ÁO SƠ MI NAM TRẮNG DÀI TAY PHỐI CỔ XANH ALIGRO DÁNG SLIMFIT MÃ ALGS194",607200,607200,0,0
TIKI,thoi-trang-nam,161539871,"quần lót nam relax cotton cao cấp chính hãng, quần sịp nam relax underwear rltk24",81000,81000,0,0
TIKI,thoi-trang-nam,130337196,"Quần kaki dài túi hộp nam",320000,320000,0,0
TIKI,thoi-trang-nam,179746482,"Simple Box - 2 Áo ba lỗ nam, 3 quần lót nam tam giác, 5 đôi tất cao cấp MRM Manlywear",489000,699000,210000,30
TIKI,thoi-trang-nam,184899472,"Quần lót nam brief RL036 quần sịp nam thoáng mát mềm mại cao cấp, co giãn tốt, ôm gọn - RELAX",75000,75000,0,0
TIKI,thoi-trang-nam,154728856,"ÁO KHOÁC FORM RỘNG SIÊU ĐẸP",98000,98000,0,0
TIKI,thoi-trang-nam,55703509,"Kendo - Quần lót nam cao cấp Kendo Gold Men's Underwear",62300,89000,26700,30
TIKI,thoi-trang-nam,73208079,"Áo khoác dạ nam dáng lửng cao cấp đẹp nhất hà nội NAD49",2250000,2250000,0,0
TIKI,thoi-trang-nam,188731085,"Áo sơ mi nam cộc tay hàn quốc Sans304 ngắn basic công sở đẹp trắng đen somi thời trang trẻ trung lịch lãm size S",59999,59999,0,0
TIKI,thoi-trang-nam,70662020,"Áo khoác dù nam dấu nón 2 lớp lót nỉ thời trang SITAKI cao cấp AKD38",155000,155000,0,0
TIKI,thoi-trang-nam,39362779,"Quần lót vòi voi gợi cảm độc đáo cho nam - Màu đen",35000,35000,0,0
TIKI,thoi-trang-nam,111709035,"Áo Sơ Mi Nam Ngắn Tay Caro MR L3 Thời Trang Cao Cấp PONIVA Chất Vải Cao Cấp Mềm Mại Thấm Hút Mồ Hôi Tốt",135000,135000,0,0
TIKI,thoi-trang-nam,3714915,"Combo 5 Quần Lót Nam Freeman 6042-CB5-XL (Size",375000,375000,0,0
TIKI,thoi-trang-nam,9412575,"Áo Vest Nam Titishop AVN145 - Xanh Dương (Size",299000,299000,0,0
TIKI,thoi-trang-nam,70636228,"Quần Short Kaki Nam Sọc CaRo Cao Cấp NamMinh",119000,119000,0,0
TIKI,thoi-trang-nam,47470601,"Combo 02 áo thun ba lỗ nam Novelty màu ngẫu nhiên",168000,210000,42000,20
TIKI,thoi-trang-nam,114824250,"Áo sơ mi nam cộc tay form slimfit chất liệu bamboo cao cấp  ALGS-C113",545000,545000,0,0
TIKI,thoi-trang-nam,113705603,"QUẦN KAKI NAM TÚI MỸ VIỀN DÁNG SUÔNG TRUNG NIÊN",165000,165000,0,0
TIKI,thoi-trang-nam,193180803,"Áo Hoodie Nỉ Bông In Hình Form Unisex Nam Nữ",101000,101000,0,0
TIKI,thoi-trang-nam,140579637,"QUẦN JOGGER KAKI NAM NỮ",209000,209000,0,0
TIKI,thoi-trang-nam,41539670,"Áo Polo nam cổ bẻ ngắn tay, chất liệu vải cá sấu cotton cao cấp, trẻ trung, năng động – FORMEN SHOP – FMPS100",139000,180000,41000,23
TIKI,thoi-trang-nam,144523087,"Áo dạ nam - kiểu dáng hiện đại, style Hàn Quốc (R8)",298000,298000,0,0
TIKI,thoi-trang-nam,193367030,"OWEN - Áo sơ mi ngắn tay Owen REGULAR FIT chất SỢI TRE MÀU XANH THAN 220133",590000,590000,0,0
TIKI,thoi-trang-nam,185947180,"Áo sơ mi nam big size form rộng, ngắn tay, hoa văn hoạ tiết cho trung niên, vải sô mát, hiệu Amazing",166000,253000,87000,34
TIKI,thoi-trang-nam,90752743,"Quần kaki nam ống đứng - Aligro ALGK050",607200,607200,0,0
TIKI,thoi-trang-nam,191777604,"ÁO SƠ MI BBR TAY NGẮN MÀU MỚI BIG SIZE NAM TỚI 135KG",260000,260000,0,0
TIKI,thoi-trang-nam,44056362,"Quần lót nam eo thấp - tím",45000,45000,0,0
TIKI,thoi-trang-nam,125730758,"Bộ Đồ Thun Unisex Hàn Quốc I Like Cặp Nam NữHOT RẺ ĐẸPSet Đồ Bộ Mặc Nhà In Hình Cute Áo Thun Rộng -Quần Short Đùi Suit[ [ẢNH THẬT ] - THIÊN HÀ SHOP ĐỒ BỘ THUN NAM NỮ",103000,103000,0,0
TIKI,thoi-trang-nam,115885731,"Áo khoác NOWSAIGON Multicolor Embroidered Jacket",495000,495000,0,0
TIKI,thoi-trang-nam,133689958,"Quần nỉ nam trung niên trung tuổi hàng quảng châu chất đẹp",268500,268500,0,0
TIKI,thoi-trang-nam,9795798,"Áo khoác Jacket Aligro ALGAKG9",979000,979000,0,0
TIKI,thoi-trang-nam,46694203,"QUẦN TÂY NAM CO GIÃN CAO CẤP DN20010510 - đen - 31",153000,159000,6000,4
TIKI,thoi-trang-nam,153390827,"Viettien - Quần jeans nam smart casual regular fit 6Q7132",720000,720000,0,0
TIKI,thoi-trang-nam,7178021,"Bộ 4 Quần Sịp Đùi Xuất Nhật Chất Lụa Cao Cấp (Giao màu ngẫu nhiên)",90000,90000,0,0
TIKI,thoi-trang-nam,9795733,"Aó khoác Jacket Aligro ALGAKG8",979000,979000,0,0
TIKI,thoi-trang-nam,90078863,"Đồ Bộ Mặc Nhà Dạo Phố FREE SHIP Áo Thun Ba Lỗ Nam In HARBOUR PARIS Siêu Đẹp, ĐỒ BỘ CHẤT LIỆU THUN LẠNH IN 3D USA, HARBOUR PARIS MẶC Ở NHÀ, DẠO PHỐ SIÊU CHẤT CHO MÙA HÈ, Bộ Đồ Thể Thao Ba Lỗ Nam , Dạo Phố, Đồ bộ nam, Bộ đồ Nam Thể Thao Sát Nách Phong Cách ",100000,100000,0,0
TIKI,thoi-trang-nam,183375598,"Áo sơ mi, Áo sơ mi nam cộc tay phối màu trang nhã sang chảnh hàng thiết kế cao cấp N28",320000,320000,0,0
TIKI,thoi-trang-nam,94881044,"Áo sơ mi nam việt tiến ngắn tay ca rô xanh vạt bầu 2159 regular",490000,490000,0,0
TIKI,thoi-trang-nam,175904827,"Áo Vest , Áo Vest Nam thời trang phong cách,chất vải dày  mềm mịn,giá cả hợp lý,hàng thiết kế cao cấp H52",450000,450000,0,0
TIKI,thoi-trang-nam,188916501,"Quần lót nam tam giác Fasvin LSV2118.HN vải lưới thể thao thông hơi thoáng mát",39000,68000,29000,43
TIKI,thoi-trang-nam,197602003,"Áo khoác da nam lót lông siêu ấm cao cấp DAD32",599000,599000,0,0
TIKI,thoi-trang-nam,85086755,"Áo sơ mi nam tay ngắn cổ sơ mi",159000,159000,0,0
TIKI,thoi-trang-nam,197849874,"Áo Thun Teeworld Ăn Sập Sài Gòn Unisex Nam Nữ Form Rộng",399000,399000,0,0
TIKI,thoi-trang-nam,58472905,"QUẦN LÓT NAM THUN LẠNH ROSSO-1501",30000,30000,0,0
TIKI,thoi-trang-nam,66104352,"Áo phông cổ tim ALIGRO ALGAPC054",269500,269500,0,0
TIKI,thoi-trang-nam,197218274,"ÁO THUN ĐEN TAY NGẮN CỔ TRÒN IN CHỮ PHẢN QUANG BIG SIZE NAM 80 ĐẾN 130KG",275000,275000,0,0
TIKI,thoi-trang-nam,105937313,"Quần Lót Nam Lọt Khe Sexy Brave Person B1177 - Thiết Kế Quyến Rũ Dành Riêng Cho Phái Mạnh - Chất Liệu Mềm Mại, Thoải Mái, Thoàng Khí, Kháng Khuẩn",139000,199000,60000,30
TIKI,thoi-trang-nam,68939519,"Áo Thun Thể Thao Cá Sấu Mè Có Cổ Siêu Mát",94000,94000,0,0
TIKI,thoi-trang-nam,22761048,"Áo thun nam cổ bẻ vải cá sấu,combo 3 áo - EZ346",269000,410000,141000,34
TIKI,thoi-trang-nam,191680657,"Quần tây nam 0Ply Regular fit màu xám đen NQTMMDMT3R2200600",499000,549000,50000,9
TIKI,thoi-trang-nam,144236494,"Hoodie trơn basic unisex, Áo mũ Hoodie Unisex nỉ bông trơn basic cặp đôi nam nữ Oversize Ulzzang Hàn Quốc thu đông form rộng 5 MÀU, Áo khoác Hoodie chui đầu nam nữ màu trơn form basic giá rẻ, áo khoác nam có mũ chùm đầu",92000,92000,0,0
TIKI,thoi-trang-nam,14625921,"Quần short thun nam dáng đứng Phúc An 1044",47000,47000,0,0
TIKI,thoi-trang-nam,75404433,"Áo khoác dù nam",194000,194000,0,0
TIKI,thoi-trang-nam,115886077,"Áo khoác NOWSAIGON Coaches Jacket",420000,420000,0,0
TIKI,thoi-trang-nam,167893265,"Quần jean nam co giãn dáng đẹp màu xanh biển mẫu mới jean nam co gian",212000,212000,0,0
TIKI,thoi-trang-nam,179575287,"Áo thun Polo nam Novelty 210058 màu xanh cổ vịt",199000,289000,90000,31
TIKI,thoi-trang-nam,117585113,"Aó Khoác Kaki Nam Lót Caro Phong Cách Cho Mọi Lứa Tuổi",195000,195000,0,0
TIKI,thoi-trang-nam,183920435,"Áo khoác cardigan nam phối nút kiểu dáng bomber thêu chữ UN.9 form rộng cực đẹp",89000,89000,0,0
TIKI,thoi-trang-nam,183742145,"Áo sơ mi nam, Áo sơ mi Nam Cổ trụ, vạt chéo thêu hoa văn họa tiết nhấn Cổ và Tay áo bắt mắt,  mã H37",199000,199000,0,0
TIKI,thoi-trang-nam,153772594,"Quần kaki nam BIG SIZE đến 110kg, quần nam SIZE ĐẠI chất kaki co giãn, quần lưng thun NH SHOP",85000,85000,0,0
TIKI,thoi-trang-nam,149980106,"Quần tây nam form body, ống côn, không ly, chất liệu co giãn, đồng phục học sinh màu đen và xanh đen, Amazing",260000,396000,136000,34
TIKI,thoi-trang-nam,122350096,"Quần Short Thun Nam Giordano Terry Short 01109805",490000,490000,0,0
TIKI,thoi-trang-nam,118809730,"Áo sơ mi nam tay ngắn ADINO màu đen vải sợi sồi modal dáng slimfit trẻ trung CT103",259000,320000,61000,19
TIKI,thoi-trang-nam,74330744,"áo sweater in bé hớt tóc mới về, áo sweater, áo chui đầu, áo chui",99000,99000,0,0
TIKI,thoi-trang-nam,198518327,"Áo thun nam tay ngắn Khatoco A2MN418R2-VNMK019-2403-N-XANH DƯƠNG",357000,418000,61000,15
TIKI,thoi-trang-nam,85087456,"Áo sơ mi nam ngắn tay",159000,159000,0,0
TIKI,thoi-trang-nam,117585641,"áo khoác du cao cấp chống nắng",215000,215000,0,0
TIKI,thoi-trang-nam,34706302,"Áo khoác măng tô nam dáng lửng sang trọng nam tính NMT46",1250000,1250000,0,0
TIKI,thoi-trang-nam,105212083,"Bộ thể thao nam phong cách họa tiết chữ thái vải thun lạnh co giãn siêu thoáng túi có dây kéo và dây rút đa năng hót triend 2021 - bộ chữ thái",98000,98000,0,0
TIKI,thoi-trang-nam,149480675,"Áo Sơ Mi Nam Trơn, Karo Công Sở Dài Tay Cotton Cao Cấp",295000,295000,0,0
TIKI,thoi-trang-nam,93959052,"Áo sơ mi tay dài-V18-014508-BL2",2990000,2990000,0,0
TIKI,thoi-trang-nam,118036962,"Đồ đi chùa cho nam vải xô (tixi) hàn, đồ bộ nam cao cấp, thời trang nam",222000,222000,0,0
TIKI,thoi-trang-nam,195969868,"Áo khoác Pilot Nasa cao cấp lót bông, áo khoác lính ARM-1270B",1050000,1050000,0,0
TIKI,thoi-trang-nam,144271311,"Viettien - Quần tây nam màu xám đậm có 1ly 1P4116 regular",580000,580000,0,0
TIKI,thoi-trang-nam,133868386,"Áo thun nam cổ tròn tay ngắn, chất thun cao cấp, trẻ trung, năng động – FORMEN SHOP – FMPS168",149000,210000,61000,29
TIKI,thoi-trang-nam,82643799,"QUẦN TÂY NAM THỜI TRANG",182000,182000,0,0
TIKI,thoi-trang-nam,102753530,"[ Ảnh Thật ] Áo khoác nhung gân bomber Zombie nam nữ cặp đôi mặc -Form rộng Unisex Bomber jackets nhung nam - Hiền Linh Shop",160000,160000,0,0
TIKI,thoi-trang-nam,191924161,"Áo phông nam tay ngắn cổ tròn cotton, áo thun nam thể thao co dãn 4 chiều cao cấp AT05 - PROMAN",140000,140000,0,0
TIKI,thoi-trang-nam,1351555,"Áo Sơ Mi Trắng Trơn Dài Tay Slimfit 369 Vĩnh Tiến - LT3-G800",332100,369000,36900,10
TIKI,thoi-trang-nam,82457455,"Quần Tây 0Ly Slimfit 482 Vĩnh Tiến - HC5-C002 - Đen",433800,482000,48200,10
TIKI,thoi-trang-nam,167529972,"Áo Khoác Bomber Nỉ Chữ Cs Knn13",99000,99000,0,0
TIKI,thoi-trang-nam,173975939,"Áo mặc nhà nam pyjama lụa satin tay dài hoạ tiết icon iBasic HOMM016T",159000,259000,100000,39
TIKI,thoi-trang-nam,178058291,"Áo thun 3 lỗ nam, nữ in họa tiết Los Angeles LADOS-9086 cotton co giãn 4 chiều, thấm hút mồ hôi",229000,229000,0,0
TIKI,thoi-trang-nam,128634673,"Áo khoác nam lót lông, mũ lông trẻ trung NMT47",850000,850000,0,0
TIKI,thoi-trang-nam,161310458,"Áo thun nam nữ unisex Cộng Cà Phê cotton co giãn 4 chiều màu xanh",250000,250000,0,0
TIKI,thoi-trang-nam,26756439,"Combo 3 quần sịp nam lụa siêu mát thông hơi thoáng khí SQB200 - 2-3",119000,119000,0,0
TIKI,thoi-trang-nam,184915041,"ÁO BA LỖ NAM là áo may ô nam từ 40_83kg vải 100% cotton thiết kế 3 lỗ thoáng mát lót trong áo sơ mi",59000,59000,0,0
TIKI,thoi-trang-nam,52849349,"Áo sơ mi nam caro - KLS125",116000,116000,0,0
TIKI,thoi-trang-nam,94879600,"Áo sơ mi nam việt tiến dài tay chấm bi 2145 regular",580000,580000,0,0
TIKI,thoi-trang-nam,83161021,"Quần Sọt Kaki Nam Túi Hộp Phối Họa Tiết Lính",188000,188000,0,0
TIKI,thoi-trang-nam,145180850,"Áo phao nam trẻ trung thời trang hàn quốc NAP38",930000,930000,0,0
TIKI,thoi-trang-nam,75649772,"Áo Khoác Big Size Nam Áo Khoác Dù Nam Chống Nóng Chống Nắng Chống Lạnh Chống Gió Hai Lớp Có Nón Hàn Quốc Cao Cấp WD54 - ShopN6",125000,189000,64000,34
TIKI,thoi-trang-nam,70896832,"Áo khoác dù nam nữ 2 lớp có nón chống thấm nước SITAKI cao cấp AKD36",125000,125000,0,0
TIKI,thoi-trang-nam,81188233,"Áo Thun In Hình Đội Tuyển Việt Nam",37000,37000,0,0
TIKI,thoi-trang-nam,83615800,"Bộ 5 quần lót nam tam giác vải cotton thấm hút cạp to co giãn",167700,167700,0,0
TIKI,thoi-trang-nam,30684456,"Áo Sơ Mi Nam Tay Ngắn Form Slim Khatoco A1MN438S1-CNMA004-2102-N - Size",291000,438000,147000,34
TIKI,thoi-trang-nam,127663016,"Áo Thun Tay Lỡ Unisex",150000,150000,0,0
TIKI,thoi-trang-nam,42625686,"Quần kaki baggy nam nữ cực chất",71000,71000,0,0
TIKI,thoi-trang-nam,186191264,"Áo thun Polo melange dệt viền có túi xanh coban NATMMTMCSR210115N",299000,379000,80000,21
TIKI,thoi-trang-nam,52724660,"Combo 15 Quần Lót Nam tam giác thun cotton mềm mịn thoáng mát thấm hút mồ hôi co giãn 4 chiều cao cấp thương hiệu Doka PQL15 - Màu Ngẫu Nhiên",159000,209000,50000,24
TIKI,thoi-trang-nam,54569520,"Quần Lót nam, quần sịp nam lụa Sữa Cao Cấp sp-340",62000,67000,5000,7
TIKI,thoi-trang-nam,7095585,"Áo Khoác Da Nam, đen - DK014",499000,499000,0,0
TIKI,thoi-trang-nam,175867824,"Bộ Thu Đông Nam Chất Liệu Nỉ Trơn Áo Khoác Quần Ống Bo In Phản Quang Trẻ trung",769000,769000,0,0
TIKI,thoi-trang-nam,161539220,"quần lót nam relax cotton cao cấp chính hãng, quần sịp nam relax underwear rltk23",89000,89000,0,0
TIKI,thoi-trang-nam,3969977,"Quần âu nam ALIGRO trơn màu đen chất liệu cao cấp, chuẩn form, tôn dáng ALGO1012",690000,690000,0,0
TIKI,thoi-trang-nam,105302808,"Áo Phông Nam Polo Có Cổ Ngắn Tay Thời Trang ZERO  Hàn Quốc",189000,300000,111000,37
TIKI,thoi-trang-nam,7010515,"Áo thun nam 100% cotton, cao cấp, (Màu Đen), D01",149000,149000,0,0
TIKI,thoi-trang-nam,182710304,"ÁO KHOÁC KAKI NAM ĐẲNG CẤP THỜI TRANG CHẤT LỆU MỀM MẠI",189000,189000,0,0
TIKI,thoi-trang-nam,54931043,"Combo 2 quần đùi nam cotton co giãn 4 chiều",129000,129000,0,0
TIKI,thoi-trang-nam,145178707,"Áo phao nam trẻ trung thời trang hàn quốc NAP38",830000,830000,0,0
TIKI,thoi-trang-nam,45601844,"Áo thun Nam tay ngắn cổ tròn họa tiết thêu trước ngực sang trọng, chất liệu vải cotton cao cấp, co giãn nhẹ mặc thoải mái dễ phối đồ phù hợp với xu hướng thời trang",120000,120000,0,0
TIKI,thoi-trang-nam,197603965,"Áo Khoác Da Nam, Áo Khoác Da Lót Lông Túi Hộp Cao Cấp Thời Trang DokaFashion ELD32",599000,599000,0,0
TIKI,thoi-trang-nam,73360134,"Jean đen rách gối",219000,219000,0,0
TIKI,thoi-trang-nam,158755588,"Áo sơ mi nam dài tay phối sọc 3D Mã M336 Thời trang EMEY LUXURY Thiết kế theo phong cách công sở lịch lãm sang trọng",150000,150000,0,0
TIKI,thoi-trang-nam,195952623,"Áo khoác lính Mỹ, Áo khoác Pilot có lót bông, áo khoác thu đông ARM-1109B",950000,950000,0,0
TIKI,thoi-trang-nam,129298910,"quần kaki túi hộp nam trung niên lính mỹ cực ngầu hàng đẹp co giãn",289000,289000,0,0
TIKI,thoi-trang-nam,150214082,"Áo bảo hộ lao động nam nữ khóa kéo SHUNI -012A vải kaki liên doanh loại dày",159000,159000,0,0
TIKI,thoi-trang-nam,134388258,"Áo Bomber Jacket/ Áo Khoác Dù 2 Lớp Style Bóng Chày in Bmoody Unisex Nam Nữ Couple Hot Trend",92000,92000,0,0
TIKI,thoi-trang-nam,82643954,"QUẦN TÂY NAM THỜI TRANG",182000,182000,0,0
TIKI,thoi-trang-nam,130326781,"Bộ Thu Đông Nam Baboyka Thiết Kế Thể Thao, Ống Suông, In Họa Tiết Thế Thao Không Co Bai, Form Dáng Mãi Như Mới",749000,749000,0,0
TIKI,thoi-trang-nam,55585008,"Combo 10 Quần Lót Nam tam giác thun cotton mềm mịn thoáng mát thấm hút mồ hôi co giãn 4 chiều cao cấp thương hiệu Doka PQL10 - Màu Ngẫu Nhiên",119000,199000,80000,40
TIKI,thoi-trang-nam,194022042,"Áo sơ mi nam ngắn tay Sans311 chất linen đũi trơn nhẹ thoáng mát đẹp cổ tàu trụ trắng xanh dương xám nhạt than be",189999,189999,0,0
TIKI,thoi-trang-nam,119068396,"Áo polo nam màu hồng phối viền chìm ADINO vải cotton polyester mềm dáng slimfit công sở trẻ trung năng động AP85",159000,318000,159000,50
TIKI,thoi-trang-nam,57759545,"Áo Thun Nam Cotton Cổ Tròn Hình 3D Eagle Cao Cấp ShopN6 - AT06 (Nhiều Màu)",109000,129000,20000,16
TIKI,thoi-trang-nam,7095435,"Áo Khoác Da Nam, nâu- DK014",599000,599000,0,0
TIKI,thoi-trang-nam,91753894,"Áo Hoodie Nam Nữ , áo hoodie cặp Unisex form rộng, áo khoác hoodie đôi phong cách ulzzang, áo hoodie hàn quốc, áo khoác hoodie có mủ, áo hoodie đẹp",123700,123700,0,0
TIKI,thoi-trang-nam,17912183,"Áo khoác nam chống nắng gió thu đông Doka (NBLS201) chất liệu nỉ giữ ấm cao cấp có màu đen , xám đậm , xám lợt",213000,299000,86000,29
TIKI,thoi-trang-nam,52339542,"Áo sơ mi nam dài tay màu trắng không túi vải mềm mịn không nhăn",108000,108000,0,0
TIKI,thoi-trang-nam,156212090,"Quần Lót Nam Boxer Thun Lạnh Lados 4116 - Thun lụa co giãn, dai, thoáng mát, thấm hút mồ hôi tốt",59000,59000,0,0
TIKI,thoi-trang-nam,138491818,"Áo khoác Hoodie Nam, Hoodie Basic Unisex Nỉ From Rộng NÓN 2 LỚP PHẢN QUANG 7 MÀU, Áo Khoác Hoodie Nam Đẹp Nhất Form Rộng Thoải Mái Vải Nỉ Dầy",134000,134000,0,0
TIKI,thoi-trang-nam,90066522,"BỘ QUẦN ÁO THỂ THỂ THAO BỘ ĐỒ MẶC NHÀ THỜI TRANG NAM NỮ",93000,93000,0,0
TIKI,thoi-trang-nam,190808256,"Quần SHORT KAKI TÚI HỘP BOX Nam Nữ Ulzzang Unisex",89000,89000,0,0
TIKI,thoi-trang-nam,23228431,"Áo khoác dù nam xếp balo",185000,299000,114000,38
TIKI,thoi-trang-nam,175867879,"Áo Khoác Gió Nam In Hoạ Tiết Logo BABOYKA, Cản Gió Chống Tia UV Trượt Nước Tốt",435000,435000,0,0
TIKI,thoi-trang-nam,110941439,"Siêu sale quần đùi nam mặc nhà xuất khẩu chất vải kate cotton 100% kiểu dáng năng động, trẻ trungthương hiệu Fezzio",64500,129000,64500,50
TIKI,thoi-trang-nam,82643416,"Áo Thun Nam Cổ Polo Phối Viền Ngang",157000,157000,0,0
TIKI,thoi-trang-nam,182711094,"ÁO KHOÁC KAKI CARO NAM THƠI TRANG CHO MUA XUÂN",185000,185000,0,0
TIKI,thoi-trang-nam,115981997,"Áo Khoác Bomber Dù Bóng Chày Chữ Số 23 Cặp Đôi Cực Rẻ Đẹp FTEESHIP Áo KhoácGió H909 Chống nắng Kiểu Bomber Jacket - ÁO KHOÁC HIỀN LINH SHOP",97000,97000,0,0
TIKI,thoi-trang-nam,179163331,"(big size < 130kg) áo sơ mi nam caro big size",225000,225000,0,0
TIKI,thoi-trang-nam,176792604,"Viettien - Áo thun nam có cổ màu tím cà 6M3020 regular",589000,589000,0,0
TIKI,thoi-trang-nam,101790152,"ÁO KHOÁC MẶC 2 MẶT vải dù có túi, áo khoác gió, áo khoác nam , áo khoác đôi, áo khoác cặp",157000,157000,0,0
TIKI,thoi-trang-nam,271964103,"Áo sơ mi nam dài tay rằn ri phong cách lính ARM-1266",420000,420000,0,0
TIKI,thoi-trang-nam,94881390,"Áo sơ mi nam việt tiến dài tay regular fit chấm bi 0085",580000,580000,0,0
TIKI,thoi-trang-nam,136037159,"OWEN - Áo sơ mi dài tay Owen Slimfit chất sợi tre kẻ ca rô màu nâu 61012",590000,590000,0,0
TIKI,thoi-trang-nam,191514904,"Áo Khoác Kaki Nam Nữ DELI Form Rộng Hai Màu Đen Be Thiết Kế Basic Phong Cách Trẻ Trung Ulzzang Unisex, Áo khoác kaki form rộng nam nữ Basic unisex phong cách ulzzang Nhiều Màu Cá Tính Phong Cách Chống Nắng",129000,129000,0,0
TIKI,thoi-trang-nam,186542699,"Áo sơ mi nam nữ unisex khoác jacket kaki dày mịn cúc gài form rộng local brand ulzzang phong cách hàn quốc đep",125000,125000,0,0
TIKI,thoi-trang-nam,35548457,"Áo Khoác Dù Nam Unisex Hàn Quốc KD2B7",208950,208950,0,0
TIKI,thoi-trang-nam,125813336,"Áo Khoác Dù Nam Nữ, Áo Khoác Form Rộng, Áo Khoác unisex, Dù 2 Lớp, Hình Sói Hades Cực Cá Tính",97000,97000,0,0
TIKI,thoi-trang-nam,83161524,"QUẦN TÂY NAM THỜI TRANG",188000,188000,0,0
TIKI,thoi-trang-nam,77109845,"Quần Jogger lính ống bo nam nữ túi hộp rằn ri chất liệu vải cotton cao cấp trẻ trung hợp thời trang",199000,199000,0,0
TIKI,thoi-trang-nam,13512763,"Áo khoác Goking cơ bản 2 lớp, form unisex cho nam nữ, vải dù ấm áp, cản gió hiệu quả, thích hợp đông và thu đông",235000,235000,0,0
TIKI,thoi-trang-nam,181989369,"Viettien - Quần tây nam màu đen dáng regular fit không ly 580",580000,580000,0,0
TIKI,thoi-trang-nam,194497102,"Quần kaki nam SKM-400-71 (Straight)",390000,390000,0,0
TIKI,thoi-trang-nam,83518455,"ÁO KHOÁC DÙ NAM 2 LỚP CÓ NÓN CAO CẤP -XANH ĐEN",323700,323700,0,0
TIKI,thoi-trang-nam,193366062,"Áo Khoác Bomber Nỉ R Nam Nữ Unisex Form Rộng Nhiều Màu Ulzzang",92000,92000,0,0
TIKI,thoi-trang-nam,178577388,"Áo Hoodie Nỉ Bông NEW YORK 3 Màu Nam Nữ (Có Sẵn/Ảnh Thật),ÁO HOODIE NAM NỮ UNISEX FORM RỘNG CHẤT NỈ NGOẠI DÀY DẶN CỰC ĐẸP CỰC NGẦU",115000,115000,0,0
TIKI,thoi-trang-nam,27925245,"Áo Thun Nam Cổ Bẻ Thời Trang Cao Cấp ShopN6 - AT1",150000,150000,0,0
TIKI,thoi-trang-nam,25281818,"Áo len dài tay nam thời trang Hàn Quốc SAL214 Xanh than",189000,189000,0,0
TIKI,thoi-trang-nam,119055901,"Áo polo nam màu đen phối viền chìm ADINO vải cotton polyester mềm dáng slimfit công sở trẻ trung năng động AP80",159000,318000,159000,50
TIKI,thoi-trang-nam,37640712,"Quần Short Nam Kaki Mềm Mịn VICERO 5 Màu Trẻ Trung Phong Cách Hàn Quốc",159000,250000,91000,36
TIKI,thoi-trang-nam,9798275,"Áo phông dài tay nam ALIGRO  ALGAPD038",247500,247500,0,0
TIKI,thoi-trang-nam,95059659," Áo khoác dù cardigan unisex form rộng Mặt Cười nam nữ ulzzang Wind",123000,123000,0,0
TIKI,thoi-trang-nam,3968393,"Áo sơ mi dài tay nam ALIGRO trơn basic chất liệu cotton cao cấp, thoáng mát , form dáng trẻ trung ALGS031",764500,764500,0,0
TIKI,thoi-trang-nam,79722551,"Quần kaki nam nữ TPshop dế phối đồ",77000,77000,0,0
TIKI,thoi-trang-nam,101350843,"Áo Thun Nhóm Lớp",82000,82000,0,0
TIKI,thoi-trang-nam,53774750,"Quần kaki lửng, quần short nam kaki",109000,109000,0,0
TIKI,thoi-trang-nam,81186471,"Áo Thun In Hình Quang Hải",82000,82000,0,0
TIKI,thoi-trang-nam,137668747,"Áo Khoác Bomber Nỉ Bông DIRTY OUT Chất Nỉ Mịn In Đẹp không Phai Form rộng Unisex Nam Nữ Couple",93000,93000,0,0
TIKI,thoi-trang-nam,55664211,"Áo Ba Lỗ Cổ Vuông Nam SZone",50000,50000,0,0
TIKI,thoi-trang-nam,8820355,"Áo Sơ Mi Nam Titishop SM495 In Họa Tiết Màu Trắng Phối Đen (Size",49000,49000,0,0
TIKI,thoi-trang-nam,173626670,"Áo Khoác Bomber Nam Phong Cách Hàn Quốc Chuẩn Đẹp Trai Hàn Quốc",97000,97000,0,0
TIKI,thoi-trang-nam,198587426,"Áo sơ mi nam tay ngắn form suông LAI BẰNG Khatoco A1MN388T2-ININ025-2307-N-XÁM TRẮNGHỌA TIẾT",310000,388000,78000,20
TIKI,thoi-trang-nam,98984347,"Áo thun Teeworld TW x Vietnamese Food - Banh Mi",359000,359000,0,0
TIKI,thoi-trang-nam,75971224,"Áo Hoodie In Chữ THINKING THE SAME Chất Nỉ Dày Dặn Form Unisex - FMGV040",105000,209000,104000,50
TIKI,thoi-trang-nam,191658244,"Áo polo nam slimfit BLOOK vải thun mềm, in nhiệt , cotton co giãn 35019 ( HÌNH THẬT )",469000,469000,0,0
TIKI,thoi-trang-nam,129297280,"bộ nỉ cho bố bộ nỉ thể thao nam trung niên loại đẹp",349000,349000,0,0
TIKI,thoi-trang-nam,198587366,"Áo sơ mi nam tay ngắn form suông LAI BẰNG Khatoco A1MN388T2-ININ024-2307-N-XANH DA TRỜI HỌA TIẾT",310000,388000,78000,20
TIKI,thoi-trang-nam,178577200,"Áo Khoác Bomber Jacket Nhung Gân G Unisex (Ảnh Thật/Có Sẵn),Áo khoác  bomber unisex  cực phong cách , hàn quốc cho các bạn trẻ",160000,160000,0,0
TIKI,thoi-trang-nam,48504476,"áo thun nam họa tiét độc đáo",99000,99000,0,0
TIKI,thoi-trang-nam,138123497,"Áo Khoác Dù BomBer Unisex In Chữ F Courage Nút Bấm Oversize Dưới 70kg",103000,103000,0,0
TIKI,thoi-trang-nam,129233676,"Áo Hoodie Drew phản quang, Áo Hoodie nam nữ tay dài chất nỉ bông dày dặn, Áo hoodie in phản quang màu bạc thun nỉ ngoại decal in xịn form dưới 70kg, áo khoác hoodie nam nữ from rộng unisex ulzzang quảng châu cao cấp",128000,128000,0,0
TIKI,thoi-trang-nam,125416555,"Áo Khoác BOMBER nỉ tăm nhung ( Hình thật của Shop 100% chất xịn dày form rộng chuẩn xịn giá Rẻ Cực )",98000,98000,0,0
TIKI,thoi-trang-nam,178937547,"Áo sơ mi nam công sở màu trơn, form slim fit không túi, vải Bamboo, phong cách Hàn, vạt bầu, Amazing",195000,297000,102000,34
TIKI,thoi-trang-nam,198074932,"Quần dài nam, quần lính chiến thuật lính vải trượt nước IX8 ARM-1124",580000,580000,0,0
TIKI,thoi-trang-nam,107005003,"Áo thun Nam Nữ Vonesa, áo phông One Piece Unisex Nam Nữ có Size bé từ 25-84kg A5",40000,40000,0,0
TIKI,thoi-trang-nam,52724033,"Combo 7 Quần Lót Nam tam giác thun cotton mềm mịn thoáng mát thấm hút mồ hôi co giãn 4 chiều cao cấp thương hiệu Doka PQL7 - Màu Ngẫu Nhiên",89000,109000,20000,18
TIKI,thoi-trang-nam,36450410,"Áo Thun Nam Có Cổ Simple Cao Cấp ShopN6 - AT01 (Nhiều Màu)",99000,125000,26000,21
TIKI,thoi-trang-nam,90483672,"Áo thun nam ngắn tay cổ tim cotton thoáng mát FREEMAN TSF311",129000,129000,0,0
TIKI,thoi-trang-nam,169747104,"Áo polo nam tay ngắn, họa tiết phối bo đẹp mắt, chi tiết thêu cực nét - FORMEN SHOP - FMPS179",169000,250000,81000,32
TIKI,thoi-trang-nam,176246108,"Áo sơ mi,  áo sơ mi nam tay lỡ phối màu cực thời trang phong cách,hàng thiết kế cao cấp N40",320000,320000,0,0
TIKI,thoi-trang-nam,9820186,"Áo len dài tay Aligro ALEND034 - Ghi",759000,759000,0,0
TIKI,cross-border-hang-quoc-te,11534299,"It Ends With Us",359000,359000,0,0
TIKI,cross-border-hang-quoc-te,129458810,"Trà cốm hoa quả Burine dinh dưỡng dành cho bé - Vị Cam Nam Mỹ giúp hỗ trợ giảm viêm nhiễm, tăng cường đề kháng (Không dành cho trẻ dưới 8 tháng tuổi)",155000,155000,0,0
TIKI,cross-border-hang-quoc-te,170678272,"Sách - Where the Crawdads Sing by Delia Owens (US edition, paperback)",463500,515000,51500,10
TIKI,cross-border-hang-quoc-te,17970237,"Picture Of Dorian Gray (Feb 03)",289200,289200,0,0
TIKI,cross-border-hang-quoc-te,17965475,"Steal Like an Artist: 10 Things Nobody Told You About Being Creative",438000,438000,0,0
TIKI,cross-border-hang-quoc-te,151548619,"Sách - The Song of Achilles : Bloomsbury Modern Classics by Madeline Miller - (UK Edition, paperback)",439000,439000,0,0
TIKI,cross-border-hang-quoc-te,170692846,"Sách - On Earth We're Briefly Gorgeous : A Novel by Ocean Vuong (US edition, paperback)",473000,473000,0,0
TIKI,cross-border-hang-quoc-te,113401672,"Sách - Your Money or Your Life: 9 Steps to Transforming Your Relationship with Money and Achieving Financial Independence: Fully Revised and Updated by Vicki Robin,Joe Dominguez,Mr. Money Mustache - (US Edition, paperback)",529000,529000,0,0
TIKI,cross-border-hang-quoc-te,176463031,"Sách - Prisoners of Geography : Ten Maps That Tell You Everything You Need to Kn by Tim Marshall (UK edition, paperback)",394000,394000,0,0
TIKI,cross-border-hang-quoc-te,113209079,"Sách - Mindset: The New Psychology of Success by Carol Dweck - (US Edition, paperback)",479000,479000,0,0
TIKI,cross-border-hang-quoc-te,17970408,"How to Love (Mindfulness Essentials) - New Cover ",291000,291000,0,0
TIKI,cross-border-hang-quoc-te,109435197,"Loa máy tính có cáp âm thanh 2 * 3,5mm cho Mic SADA V-103-Màu đen",416000,416000,0,0
TIKI,cross-border-hang-quoc-te,165017868,"Sách - Seven Husbands of Evelyn Hugo : Tiktok made me buy it! by TAYLOR JENKINS REID (UK edition, paperback)",399000,399000,0,0
TIKI,cross-border-hang-quoc-te,109164159,"Túi đựng hành lí khi đi xe đạp, Túi Trunk, túi đặt yên sau xe đạp",464000,464000,0,0
TIKI,cross-border-hang-quoc-te,17966869,"The 48 Laws Of Power by Robert Greene",549000,549000,0,0
TIKI,cross-border-hang-quoc-te,174400333,"Sách - The Power of Geography : Ten Maps That Reveal the Future of Our World by Tim Marshall (UK edition, paperback)",384000,384000,0,0
TIKI,cross-border-hang-quoc-te,191781146,"Sách - Beyond O.rder : 12 More Rules for Life by Jordan B. Peterson (UK edition, paperback)",396000,396000,0,0
TIKI,cross-border-hang-quoc-te,173561222,"Túi Đeo Chéo Mark Ryden Kiểu Dáng Đơn Giản Cho Nam Giới Dung Tích Lớn Không Thấm Nước Simple Casual Chest Bag",541000,541000,0,0
TIKI,cross-border-hang-quoc-te,11777090,"Collins Classics: The Art Of War",192000,192000,0,0
TIKI,cross-border-hang-quoc-te,113349197,"Sách - How to Fight by Thich Nhat Hanh Jason Deantonis - (UK Edition, paperback)",236000,236000,0,0
TIKI,cross-border-hang-quoc-te,115255563,"Xịt Bưởi Mọc Tóc Thảo Mộc the FleurA Ngăn Rụng Tóc Giúp Mọc Tóc Nhanh Ngăn Nấm Da Đầu",75000,150000,75000,50
TIKI,cross-border-hang-quoc-te,114051039,"Sách - High Output Management by Andrew S. Grove - (US Edition, paperback)",469000,469000,0,0
TIKI,cross-border-hang-quoc-te,109435783,"Nút tai silicon Bluedio NE -40dB Giảm tiếng ồn Cách âm Bảo vệ tai Chống ồn khi ngủ và đi bơi",150000,150000,0,0
TIKI,cross-border-hang-quoc-te,111389961,"Balo Ozuko phong cách mới cho nam có sạc USB và cơ chế chống trộm công suất lớn, đa chức năng chống thấm nước",915000,915000,0,0
TIKI,cross-border-hang-quoc-te,2043735,"The Culture Map: Decoding How People Think, Lead, And Get Things Done Across Cultures",481000,481000,0,0
TIKI,cross-border-hang-quoc-te,170631106,"Sách - Irrational Exuberance : Revised and Expanded Third Edition by Robert J. Shiller (US edition, paperback)",591000,591000,0,0
TIKI,cross-border-hang-quoc-te,134791132,"Sách - Radical Candor : How to Get What You Want by Saying What You Mean by Kim Scott - (UK Edition, paperback)",411000,411000,0,0
TIKI,cross-border-hang-quoc-te,17966855,"Life Of A Stupid Man",173000,173000,0,0
TIKI,cross-border-hang-quoc-te,170610748,"Sách - Eat That Frog! 21 Great Ways to Stop Procrastinating and Get More Done in Less T by Tracy (US edition, paperback)",458000,458000,0,0
TIKI,cross-border-hang-quoc-te,11573091,"HOLY BIBLE: King James Version (KJV) Popular Gift & Award Black Leatherette Edition: Authorized King James Version (Bible Akjv)",439000,439000,0,0
TIKI,cross-border-hang-quoc-te,111062477,"Bàn phím số không dây Ajazz 2.4G kỹ thuật số cho Window XP Win7 8 10 ios Máy tính xách tay",325000,325000,0,0
TIKI,cross-border-hang-quoc-te,189573294,"Sách - Good Girl, Bad Blood by Holly Jackson (UK edition, paperback)",354600,394000,39400,10
TIKI,cross-border-hang-quoc-te,162105083,"Sách - A Woman Makes A Plan : Advice for a Lifetime of Adventure, Beauty, and Succe by Maye Musk (US edition, paperback)",499000,499000,0,0
TIKI,cross-border-hang-quoc-te,163159382,"Sách - The Concise Mastery by Robert Greene (UK edition, paperback)",318600,354000,35400,10
TIKI,cross-border-hang-quoc-te,7917829,"Good To Great: Why Some Companies Make The Leap",354600,394000,39400,10
TIKI,cross-border-hang-quoc-te,111415952,"Túi câu cá 1,2M",260000,260000,0,0
TIKI,cross-border-hang-quoc-te,17966903,"Normal People",705000,705000,0,0
TIKI,cross-border-hang-quoc-te,177560813,"Sách - The New Market Wizards : Conversations with America's Top Traders by Jack D. Schwager (US edition, paperback)",517000,517000,0,0
TIKI,cross-border-hang-quoc-te,18011335,"Mastery (New in paperback)",696000,696000,0,0
TIKI,cross-border-hang-quoc-te,163163704,"Sách - The Concise 33 Strategies of War by Robert Greene (UK edition, paperback)",345000,345000,0,0
TIKI,cross-border-hang-quoc-te,17965556,"Call Me By Your Name",377000,377000,0,0
TIKI,cross-border-hang-quoc-te,161030316,"Sách - The Psychology of Money : Timeless lessons on wealth, greed, and happiness by Morgan Housel - (UK Edition, paperback)",531000,531000,0,0
TIKI,cross-border-hang-quoc-te,161036131,"Sách - The Love Hypothesis by Ali Hazelwood - (US Edition, paperback)",524000,524000,0,0
TIKI,cross-border-hang-quoc-te,162156987,"Sách - The Midnight Library by Matt Haig (UK edition, paperback)",368000,368000,0,0
TIKI,cross-border-hang-quoc-te,171760068,"Sách - Changing World Order : Why Nations Succeed or Fail by Ray Dalio (UK edition, hardcover)",979000,979000,0,0
TIKI,cross-border-hang-quoc-te,170678248,"Sách - People We Meet On Vacation by Emily Henry (US edition, paperback)",341100,379000,37900,10
TIKI,cross-border-hang-quoc-te,170372034,"Kem Chống Lão Hóa Dưỡng Ẩm Estee Lauder Revitalizing Supreme+ Global Anti-Aging Power Soft Creme 15Ml",649000,649000,0,0
TIKI,cross-border-hang-quoc-te,108603660,"Giá đỡ bình nước để xe đạp, chạy thể thao ngoài trời bằng nhôm, siêu nhẹ và bền-Màu Bạc",180000,180000,0,0
TIKI,cross-border-hang-quoc-te,170355215,"Tinh Chất Phục Hồi Chống Lão Hóa Thế Hệ Mới Estee Lauder Synchronized Multi-Recovery Complex Complexe 7Ml",529000,529000,0,0
TIKI,cross-border-hang-quoc-te,170695922,"Sách - The Summer I Turned Pretty by Jenny Han (UK edition, paperback)",341000,341000,0,0
TIKI,cross-border-hang-quoc-te,11777049,"Collins Classics: Little Women",140000,140000,0,0
TIKI,cross-border-hang-quoc-te,170625037,"Sách - Bobby Fischer Teaches Chess by Bobby Fischer (US edition, paperback)",321000,321000,0,0
TIKI,cross-border-hang-quoc-te,188041077,"Sách - Maybe Someday by Colleen Hoover (UK edition, paperback)",299000,299000,0,0
TIKI,cross-border-hang-quoc-te,10755339,"Why Men Love Bitches",578000,578000,0,0
TIKI,cross-border-hang-quoc-te,108603413,"Túi đựng, cất trữ xe đạp có thế gấp gọn, dày 2 lớp vải, phù hợp với hầu hết các mẫu xe gấp trên thị trường-Size 16 inch",408000,408000,0,0
TIKI,cross-border-hang-quoc-te,18011331,"The Daily Stoic: 366 Meditations on Wisdom, Perseverance, and the Art of Living",447300,497000,49700,10
TIKI,cross-border-hang-quoc-te,134441362,"Sách - A Little Life : Shortlisted for the Man Booker Prize 2015 by Hanya Yanagihara - (UK Edition, paperback)",369000,369000,0,0
TIKI,cross-border-hang-quoc-te,170693069,"Sách - Ugly Love by Colleen Hoover (UK edition, paperback)",540000,600000,60000,10
TIKI,cross-border-hang-quoc-te,111416031,"Máy dò cá di động bằng sóng âm LUCKY có màn hình LCD-Size",953000,953000,0,0
TIKI,cross-border-hang-quoc-te,11778403,"Without Merit",489000,489000,0,0
TIKI,cross-border-hang-quoc-te,11471836,"The Hard Thing About Hard Things",677000,677000,0,0
TIKI,cross-border-hang-quoc-te,7917830,"Principles: Life and Work",704700,783000,78300,10
TIKI,cross-border-hang-quoc-te,189573329,"Sách - Hopeless by Colleen Hoover (UK edition, paperback)",316000,316000,0,0
TIKI,cross-border-hang-quoc-te,11504729,"Harvard Business Review: Guide To Project Management",477000,477000,0,0
TIKI,cross-border-hang-quoc-te,173561830,"Balo Văn Phòng Nhiều Lớp Chống Nước Chống Trộm Đựng Máy Tính Xách Tay Có Cổng Usb Tiện Dụng Mark Ryden",895000,895000,0,0
TIKI,cross-border-hang-quoc-te,11778902,"The 5 AM Club: Own Your Morning. Elevate Your Life",549000,549000,0,0
TIKI,cross-border-hang-quoc-te,113407876,"Sách - How to Eat by Thich Nhat Hanh - (UK Edition, paperback)",411000,411000,0,0
TIKI,cross-border-hang-quoc-te,111067221,"Nút tai silicon Bluedio NE -40dB Giảm tiếng ồn Cách nhiệt Bảo vệ tai Chống ồn ",141000,141000,0,0
TIKI,cross-border-hang-quoc-te,11504808,"Rich Dad Poor Dad For Teens",437000,437000,0,0
TIKI,cross-border-hang-quoc-te,190172014,"Sách - Time Is a Mother by Ocean Vuong (US edition, hardcover)",485000,485000,0,0
TIKI,cross-border-hang-quoc-te,162124438,"Sách - The Spanish Love Deception : TikTok made me buy it! The Goodreads Choice A by Elena Armas (UK edition, paperback)",366300,407000,40700,10
TIKI,cross-border-hang-quoc-te,17970189,"Letters From A Stoic (New Cover)",356000,356000,0,0
TIKI,cross-border-hang-quoc-te,170726270,"Sách - We Were Liars by E. Lockhart (UK edition, paperback)",337000,337000,0,0
TIKI,cross-border-hang-quoc-te,113345623,"Sách - How to Connect by Thich Nhat Hanh - (UK Edition, paperback)",237000,237000,0,0
TIKI,cross-border-hang-quoc-te,170721330,"Sách - What Got You Here Won't Get You There : How Successful People Be by Dr Marshall Goldsmith (US edition, paperback)",397000,397000,0,0
TIKI,cross-border-hang-quoc-te,170722326,"Sách - What to Expect When You're Expecting by unknown,Heidi Murkoff (US edition, paperback)",755100,839000,83900,10
TIKI,cross-border-hang-quoc-te,188043098,"Sách - My Mechanical Romance by Alexene Farol Follmuth (UK edition, paperback)",305000,305000,0,0
TIKI,cross-border-hang-quoc-te,171089881,"Thạch Giúp Cân Bằng Và Ngăn Nhiễm Trùng Đường Tiết Niệu COZO Cranberry Jelly Chiết Xuất Nam Việt Quất Và Elderberry, Tăng Khả Năng Miễn Dịch",852000,852000,0,0
TIKI,cross-border-hang-quoc-te,113356599,"Sách - The Whole-Brain Child : 12 Revolutionary Strategies to Nuture Your Child&#x27;s Developing Mind by Daniel J Siegel - (US Edition, paperback)",356000,356000,0,0
TIKI,cross-border-hang-quoc-te,108600088,"Áo khoác phản quang cho nam đi xe đạp và các hoạt động thể thao ngoài trời",430000,430000,0,0
TIKI,cross-border-hang-quoc-te,175886807,"Sách - Why Has Nobody Told Me This Before? by Dr Julie Smith (US edition, hardcover)",819000,819000,0,0
TIKI,cross-border-hang-quoc-te,11466602,"First Thousand Words In Chinese",281000,281000,0,0
TIKI,cross-border-hang-quoc-te,170600668,"Sách - The Rise and Fall of the Great Powers by Paul Kennedy (UK edition, paperback)",704000,704000,0,0
TIKI,cross-border-hang-quoc-te,170625593,"Sách - Six of Crows: Collector's Edition : Book 1 by Leigh Bardugo (UK edition, hardcover)",791000,791000,0,0
TIKI,cross-border-hang-quoc-te,178060756,"Sách - Layla by Colleen Hoover (US edition, paperback)",488000,488000,0,0
TIKI,cross-border-hang-quoc-te,109165144,"Túi xe đạp Khung trước Chất lượng cao WEST BIKING với thiết kế Màn hình chống thấm nước",337000,337000,0,0
TIKI,cross-border-hang-quoc-te,109164826,"Mặt nạ đi xe đạp, khăn che mặt cổ chống tia cực tím, chất liệu vải thoáng khí, hút ẩm-Màu Sọc đen",120000,120000,0,0
TIKI,cross-border-hang-quoc-te,163282613,"Sách - Make Your Bed : 10 Life Lessons from a Navy SEAL by Admiral William H. McRaven (UK edition, hardcover)",436000,436000,0,0
TIKI,cross-border-hang-quoc-te,108601935,"Túi sau Xe đạp 3 trong 1 đa chức năng Không thấm nước gắn yên xe",980000,980000,0,0
TIKI,cross-border-hang-quoc-te,17965621,"Keep Going: 10 Ways To Stay Creative In Good Times And Bad",403000,403000,0,0
TIKI,cross-border-hang-quoc-te,129220702,"Sách - The Song of Achilles by Madeline Miller - (UK Edition, hardcover)",772000,772000,0,0
TIKI,cross-border-hang-quoc-te,11708850,"Put Your Dream To The Test: 10 Questions To Help You See It And Seize It",519000,519000,0,0
TIKI,cross-border-hang-quoc-te,170704433,"Sách - Sapiens: A Graphic History, Volume 2 : The Pillars of Civilization by Yuval Noah Harari (paperback)",599000,599000,0,0
TIKI,cross-border-hang-quoc-te,10732338,"Mindset - Updated Edition: Changing The Way You think To Fulfil Your Potential ",399000,399000,0,0
TIKI,cross-border-hang-quoc-te,170654324,"Sách - Little Kids First Big Book of The World by Elizabeth Carney (US edition, hardcover)",636000,636000,0,0
TIKI,cross-border-hang-quoc-te,11714322,"Stone Fox 30th Anniversary Edition",255000,255000,0,0
TIKI,cross-border-hang-quoc-te,170580458,"Sách - Stock Market Wizards : Interviews with America's Top Stock Traders by J. Schwager (US edition, paperback)",519000,519000,0,0
TIKI,cross-border-hang-quoc-te,11708960,"The Leader In Me: How Schools Around The World Are Inspiring Greatness, One Child At A Time",486000,486000,0,0
TIKI,cross-border-hang-quoc-te,111063307,"Chuột dọc không dây YWYT 2.4G  3 mức DPI có thể điều chỉnh",179000,179000,0,0
TIKI,cross-border-hang-quoc-te,10738613,"The Healing Self ",478000,478000,0,0
TIKI,cross-border-hang-quoc-te,11504798,"Rich Dad's CASHFLOW Quadrant: Rich Dad's Guide to Financial Freedom",290000,290000,0,0
TIKI,cross-border-hang-quoc-te,17966574,"Antifragile (New In Paperback)
 (Osd: 7 Nov 13)",525000,525000,0,0
TIKI,cross-border-hang-quoc-te,170656768,"Sách - The Jesus Storybook Bible : Every Story Whispers His Name by Sally Lloyd-Jones (US edition, hardcover)",813000,813000,0,0
TIKI,cross-border-hang-quoc-te,17970181,"In Order To Live",387000,387000,0,0
TIKI,cross-border-hang-quoc-te,71080138,"Sản phẩm dinh dưỡng Vinamilk Sure Prevent Gold Chai 200ml (Lốc 6 chai)",165000,165000,0,0
TIKI,cross-border-hang-quoc-te,113401016,"Sách - The Ride of a Lifetime : Lessons in Creative Leadership from the CEO of the Walt Disney Company by Robert Iger - (US Edition, paperback)",708000,708000,0,0
TIKI,cross-border-hang-quoc-te,170600434,"Sách - The Fellowship of the Ring by J. R. R. Tolkien (UK edition, paperback)",365000,365000,0,0
TIKI,cross-border-hang-quoc-te,170725864,"Sách - Beating the Street by Peter Lynch (US edition, paperback)",476000,476000,0,0
TIKI,cross-border-hang-quoc-te,11504865,"Harvard Business Review: 20 Minute Manager: Performance Reviews",389000,389000,0,0
TIKI,cross-border-hang-quoc-te,111066739,"Máy tính bảng đồ họa VEIKK VK640 kỹ thuật số với 8192 mức Độ nhạy áp suất 5080LPI Độ phân giải 250RPS",996000,996000,0,0
TIKI,cross-border-hang-quoc-te,170269089,"Sách - The Octonauts Explore The Great Big Ocean by Meomi (UK edition, paperback)",361000,361000,0,0
TIKI,cross-border-hang-quoc-te,108598918,"Máy đo tốc độ INBIKE 2.8inch bằng thép không gỉ-Màu xanh lá",434000,434000,0,0
TIKI,cross-border-hang-quoc-te,109165745,"Đèn pin xe đạp siêu sáng WEST BIKING 6 chế độ sáng không thấm nước sạc USB-Màu đen",343000,343000,0,0
TIKI,cross-border-hang-quoc-te,170725207,"Sách - Marketing Made Simple : A Step-by-Step StoryBrand Guide for by Donald Miller J.J Peterson (US edition, hardcover)",466000,466000,0,0
TIKI,cross-border-hang-quoc-te,170623388,"Sách - Your True Home by Thich Nhat Hanh (US edition, paperback)",614000,614000,0,0
TIKI,cross-border-hang-quoc-te,10732402,"The Lean Startup",455000,455000,0,0
TIKI,cross-border-hang-quoc-te,182581864,"Máy Bơm Xe Đạp Mini Giyo 120Psi - Đen",385000,385000,0,0
TIKI,cross-border-hang-quoc-te,57527989,"Cloud Atlas: A Novel",399000,399000,0,0
TIKI,cross-border-hang-quoc-te,196056829,"Sách - First Person Singular : Stories by Haruki Murakami Philip Gabriel (US edition, paperback)",332000,332000,0,0
TIKI,cross-border-hang-quoc-te,108780054,"Đồng hồ Quartz Thể thao đơn giản Dây da 3ATM chống nước Chronograph MEGIR 2094 Nam-Màu Bạc",497000,497000,0,0
TIKI,cross-border-hang-quoc-te,174222565,"Sách - The Book You Wish Your Parents Had Read (and Your Children Will Be Glad by Philippa Perry (UK edition, paperback)",340200,378000,37800,10
TIKI,cross-border-hang-quoc-te,11779254,"Two Dark Reigns: Three Dark Crowns $3",819000,819000,0,0
TIKI,cross-border-hang-quoc-te,170696047,"Sách - Five Dark Fates by Kendare Blake (paperback)",656000,656000,0,0
TIKI,cross-border-hang-quoc-te,170605629,"Sách - Piano Exam Pieces 2021 & 2022, ABRSM Grade 6 : Selected from the 2021 & 2022 syl by ABRSM (UK edition, paperback)",480000,480000,0,0
TIKI,cross-border-hang-quoc-te,11855779,"The American Spirit",521000,521000,0,0
TIKI,cross-border-hang-quoc-te,170692392,"Sách - The Fantastic Book of Feelings: A Guide to Being Happy, Sad and Everyt by Marcia Williams (UK edition, hardcover)",588000,588000,0,0
TIKI,cross-border-hang-quoc-te,170671632,"Sách - Hold Me Tight : Your Guide to the Most Successful Approach to Building  by Dr Sue Johnson (UK edition, paperback)",527000,527000,0,0
TIKI,cross-border-hang-quoc-te,11844285,"The Boy In The Dress",298800,332000,33200,10
TIKI,cross-border-hang-quoc-te,11504829,"Why The Rich Are Getting Richer",326000,326000,0,0
TIKI,cross-border-hang-quoc-te,11778281,"The Troop",462000,462000,0,0
TIKI,cross-border-hang-quoc-te,163882906,"Sách - Pusheen Coloring Book by Claire Belton (US edition, paperback)",490000,490000,0,0
TIKI,cross-border-hang-quoc-te,170623495,"Sách - The Unfettered Mind by Takuan Soho (US edition, paperback)",478000,478000,0,0
TIKI,cross-border-hang-quoc-te,170578822,"Sách - The Right Side of History : How Reason and Moral Purpose Made the West Gre by Ben Shapiro (US edition, hardcover)",838000,838000,0,0
TIKI,cross-border-hang-quoc-te,170726266,"Sách - Meditations by Marcus Aurelius (UK edition, paperback)",202000,202000,0,0
TIKI,cross-border-hang-quoc-te,170605954,"Sách - Getting Started in Technical Analysis by Jack D. Schwager (US edition, paperback)",730000,730000,0,0
TIKI,cross-border-hang-quoc-te,108599526,"Giá đỡ điện thoại dùng cho xe đạp GUB, thiết kế bằng nhôm-Màu Titan",262000,262000,0,0
TIKI,cross-border-hang-quoc-te,108603307,"Túi sườn xe đạp Fream, thiết kế dạng ống,nhỏ gọn,chất liệu vải cao cấp chống thấm nước",313000,313000,0,0
TIKI,cross-border-hang-quoc-te,170583243,"Sách - 20,000 Leagues Under the Sea: GS Classic Tales #10 by Geronimo Stilton (US edition, paperback)",392000,392000,0,0
TIKI,cross-border-hang-quoc-te,11708956,"How To Fix A Broken Heart",527000,527000,0,0
TIKI,cross-border-hang-quoc-te,17964072,"Dk Eyewitness Travel Guide: Vietnam",554000,554000,0,0
TIKI,cross-border-hang-quoc-te,10756812,"How To Be A Stoic",538200,598000,59800,10
TIKI,cross-border-hang-quoc-te,186284934,"Sách - Rise of the School for Good and Evil by Soman Chainani (UK edition, paperback)",494000,494000,0,0
TIKI,cross-border-hang-quoc-te,170726415,"Sách - Killing Commendatore by Haruki Murakami (US edition, paperback)",661000,661000,0,0
TIKI,cross-border-hang-quoc-te,170726292,"Sách - The Odd 1s Out : How to Be Cool and Other Things I Definitely Learned f by James Rallison (UK edition, paperback)",494000,494000,0,0
TIKI,cross-border-hang-quoc-te,11385039,"First Thousand Words In English",310000,310000,0,0
TIKI,cross-border-hang-quoc-te,111063679,"VEIKK Drawing Glove Two-finger Drawing Glove Lightweight Sweatproof Soft Glove for VEIKK Graphics Tablet Graphic Monitor",66000,66000,0,0
TIKI,cross-border-hang-quoc-te,170672854,"Sách - The Little Prince : Colour Illustrations by Antoine de Saint-Exupery (UK edition, hardcover)",386000,386000,0,0
TIKI,cross-border-hang-quoc-te,17961566,"Road To Character",391000,391000,0,0
TIKI,cross-border-hang-quoc-te,11534783,"Life Lessons From The Monk Who Sold His Ferrari",368000,368000,0,0
TIKI,cross-border-hang-quoc-te,170661471,"Sách - The Jesus Storybook Bible Gift Edition : Every Story Whispers His Na by Sally Lloyd-Jones (US edition, hardcover)",916000,916000,0,0
TIKI,cross-border-hang-quoc-te,108603603,"Mũ bảo hiểm đa năng ba trong một có đèn nền, tấm che mặt có thể tháo rời, đèn hậu-Màu đỏ",492000,492000,0,0
TIKI,cross-border-hang-quoc-te,172631307,"Sách - The Life-Changing Manga of Tidying Up : A Magical Story to Spark Joy in Li by Marie Kondo (UK edition, paperback)",354000,354000,0,0
TIKI,cross-border-hang-quoc-te,170625321,"Sách - The Consolation of Philosophy by Ancius Boethius (UK edition, paperback)",359000,359000,0,0
TIKI,cross-border-hang-quoc-te,11863524,"Lonely Planet Seoul (Travel Guide)",606000,606000,0,0
TIKI,cross-border-hang-quoc-te,170682231,"Sách - You Are Here : Discovering the Magic of the Present Moment by Thich Nhat Hanh (US edition, hardcover)",843000,843000,0,0
TIKI,cross-border-hang-quoc-te,109164618,"Bơm Xe Đạp mini WEST BIKING 120PSI thiết kế khóa cài có độ bèn tốt, không bị rơi khi bơm",198000,198000,0,0
TIKI,cross-border-hang-quoc-te,170605730,"Sách - Violin Exam Pieces 2020-2023, ABRSM Grade 5, Score & Part : Selected from the 20 by ABRSM (UK edition, paperback)",757000,757000,0,0
TIKI,cross-border-hang-quoc-te,111066708,"Túi lưu trữ cầm tay đa chức năng BUBM Dung lượng lớn kỹ thuật số hai lớp-Màu Xám-Size N",283000,283000,0,0
TIKI,cross-border-hang-quoc-te,11667724,"Harvard Business Review: Smart Business",553000,553000,0,0
TIKI,cross-border-hang-quoc-te,189561742,"Sách - American Psycho by Bret Easton Ellis (UK edition, paperback)",395000,395000,0,0
TIKI,cross-border-hang-quoc-te,108603111,"Găng tay thể thao Wheel UpSummer đi xe đạp nửa ngón chống nắng, chống trượt , giảm sốc",202000,202000,0,0
TIKI,cross-border-hang-quoc-te,173910621,"Sách - Effortless : Make it Easier to Do What Matters by Greg McKeown (UK edition, paperback)",540000,540000,0,0
TIKI,cross-border-hang-quoc-te,170625474,"Sách - Ninth House by Leigh Bardugo (UK edition, paperback)",408000,408000,0,0
TIKI,cross-border-hang-quoc-te,11846123,"Lonely Planet Berlin (Travel Guide)",587000,587000,0,0
TIKI,cross-border-hang-quoc-te,108603895,"Bàn đạp xe đạp ZTTO MTB hợp kim nhôm cao cấp, chống trượt-Màu tía",542000,542000,0,0
TIKI,cross-border-hang-quoc-te,11471619,"My Husband And I",400000,400000,0,0
TIKI,cross-border-hang-quoc-te,170693869,"Sách - Pre-Suasion : A Revolutionary Way to Influence and Persuade by Robert Cialdini (UK edition, paperback)",412000,412000,0,0
TIKI,cross-border-hang-quoc-te,514255,"Combo 6 Chai Sữa Nước Abbott Ensure Liquid Vanilla 237ml",290000,290000,0,0
TIKI,cross-border-hang-quoc-te,168188135,"Găng Tay Thể Thao Nửa Ngón Có Đệm Chống Trượt Dành Cho Dân Thể Thao Leo Núi Thương Hiệu Boodun - Trắng",293000,293000,0,0
TIKI,cross-border-hang-quoc-te,170675232,"Sách - Bond 11+: Non-verbal Reasoning: Assessment Papers : 11+-12+ years Book 2 by Nic Morgan (UK edition, paperback)",379000,379000,0,0
TIKI,cross-border-hang-quoc-te,11392443,"The Home Distilling & Infusing Handbook",485000,485000,0,0
TIKI,cross-border-hang-quoc-te,11863458,"Lonely Planet Spain (Travel Guide)",750000,750000,0,0
TIKI,cross-border-hang-quoc-te,112401140,"Quạt Tản Nhiệt Cpu Máy Tính Asus F3J A8 A8J Z99 X80 N80 F8S Z53 M51 4 Pin Gc056015Vh-A 13.1.b2433f.n 5v 3w",283619,283619,0,0
TIKI,cross-border-hang-quoc-te,170704873,"Sách - A Shepherd Looks at Psalm 23 by W. Phillip Keller (US edition, paperback)",247000,247000,0,0
TIKI,cross-border-hang-quoc-te,170693368,"Sách - Doing Good Better : Effective Altruism and a Radical New Way to M by Dr William MacAskill (UK edition, paperback)",401000,401000,0,0
TIKI,cross-border-hang-quoc-te,170694427,"Sách - The Rough Guide to Singapore (Travel Guide) by Rough Guides (UK edition, paperback)",305000,305000,0,0
TIKI,cross-border-hang-quoc-te,173561545,"Túi Đeo Chéo Nam Nhiều Lớp Nhiều Ngăn Chống Nước Chống Trộm Mark Ryden",501000,501000,0,0
TIKI,cross-border-hang-quoc-te,170711107,"Sách - The Humans by Matt Haig (UK edition, paperback)",365000,365000,0,0
TIKI,cross-border-hang-quoc-te,159034159,"Sách - The Laws of Human Nature by Robert Greene - (US Edition, paperback)",978000,978000,0,0
TIKI,cross-border-hang-quoc-te,17966899,"Ego Is The Enemy",417600,464000,46400,10
TIKI,cross-border-hang-quoc-te,170683177,"Sách - The Disappearing Act : The Impossible Case of Mh370 by Florence de Changy (UK edition, paperback)",584000,584000,0,0
TIKI,cross-border-hang-quoc-te,170706415,"Sách - Dr. Jekyll & Mr. Hyde by Robert Louis Stevenson (US edition, paperback)",341000,341000,0,0
TIKI,cross-border-hang-quoc-te,11407777,"Behind Her Eyes",310000,310000,0,0
TIKI,cross-border-hang-quoc-te,173562065,"Túi Đeo Chéo Nam Nhiều Lớp Nhiều Ngăn Chống Nước Chống Trộm Mark Ryden",379000,499000,120000,24
TIKI,cross-border-hang-quoc-te,170581878,"Sách - The Sandman Volume 1: 30th Anniversary Edition : Preludes and Nocturnes by Neil Gaiman (US edition, paperback)",787000,787000,0,0
TIKI,cross-border-hang-quoc-te,11846736,"Scrambled Eggs Super: Dr Seuss Yellow Back Book",252000,252000,0,0
TIKI,cross-border-hang-quoc-te,170722346,"Sách - Lonely Planet's Global Coffee Tour by Lonely Planet (paperback)",765000,765000,0,0
TIKI,cross-border-hang-quoc-te,109164824,"Dụng cụ sửa xe đạp đa năng WEST BIKING-Màu vàng",192000,192000,0,0
TIKI,cross-border-hang-quoc-te,11849581,"Hidden Bodies",403000,403000,0,0
TIKI,cross-border-hang-quoc-te,170698930,"Sách - 86--EIGHTY-SIX, Vol. 2 (manga) by Asato Asato (US edition, paperback)",535000,535000,0,0
TIKI,cross-border-hang-quoc-te,114049525,"Sách - They Both Die at the End by Adam Silvera - (UK Edition, paperback)",361000,361000,0,0
TIKI,cross-border-hang-quoc-te,11779410,"And To Think That I Saw It: Dr Seuss Green Back Bk",464000,464000,0,0
TIKI,cross-border-hang-quoc-te,134780405,"Sách - Find Me André Aciman by Andre Aciman - (UK Edition, paperback)",389000,389000,0,0
TIKI,cross-border-hang-quoc-te,170624746,"Sách - Berlitz Pocket Guide Lisbon (Travel Guide with Dictionary) by  (UK edition, paperback)",483000,483000,0,0
TIKI,cross-border-hang-quoc-te,170705019,"Sách - Where Are the Customers' Yachts? : or A Good Hard Look at Wall Street by Fred Schwed (US edition, paperback)",556000,556000,0,0
TIKI,cross-border-hang-quoc-te,17970317,"The Design Of Everyday Things",598000,598000,0,0
TIKI,cross-border-hang-quoc-te,170602874,"Sách - Whisky A Tasting Course : A New Way to Think - and Drink - Whisky by Eddie Ludlow (UK edition, hardcover)",863000,863000,0,0
TIKI,cross-border-hang-quoc-te,11778986,"The Alpha Woman Meets Her Match: How Today's Strong Women Can Find Love And Happiness Without Settling",462000,462000,0,0
TIKI,cross-border-hang-quoc-te,177081630,"Sách - Tales from the Cafe : Before the Coffee Gets Cold by Toshikazu Kawaguchi (UK edition, paperback)",343000,343000,0,0
TIKI,cross-border-hang-quoc-te,170692653,"Sách - We Are Okay by Nina LaCour (US edition, paperback)",361000,361000,0,0
TIKI,cross-border-hang-quoc-te,146553822,"CINCATDY Tai Nghe Bluetooth V5.0 Earbuds Gaming Headphone True Wireless Headset E6S - Hàng Chính Hãng",175000,175000,0,0
TIKI,cross-border-hang-quoc-te,111063930,"USB Flash Drive  Mã hóa vân tay kim loại Tốc độ đọc 150MB / s cho máy tính xách tay PC",866800,866800,0,0
TIKI,cross-border-hang-quoc-te,170704469,"Sách - The Symposium by Plato (UK edition, paperback)",317000,317000,0,0
TIKI,cross-border-hang-quoc-te,170694296,"Sách - Five Lessons : The Modern Fundamentals of Golf by Ben Hogan (US edition, paperback)",406000,406000,0,0
TIKI,cross-border-hang-quoc-te,170582962,"Sách - The Art Of Seduction by Robert Greene (UK edition, paperback)",810000,810000,0,0
TIKI,cross-border-hang-quoc-te,17964262,"Hooked: How to Build Habit-Forming Products",504000,504000,0,0
TIKI,cross-border-hang-quoc-te,10732450,"The Infographic Guide To Personal Finance",578000,578000,0,0
TIKI,cross-border-hang-quoc-te,190322298,"Sách - Heartstopper Volume One by ALICE OSEMAN (UK edition, paperback)",477000,477000,0,0
TIKI,cross-border-hang-quoc-te,17966514,"Great Crash 1929 (New Cover)",529000,529000,0,0
TIKI,cross-border-hang-quoc-te,146518742,"CINCATDY Tai Nghe Bluetooth Earbuds Gaming Headset True Wireless Headphone ME-19",391000,391000,0,0
TIKI,cross-border-hang-quoc-te,11708848,"TED Talks: The Official TED Guide To Public Speaking",483000,483000,0,0
TIKI,cross-border-hang-quoc-te,170693281,"Sách - The Little Book of Astrology by Marion Williamson (UK edition, hardcover)",411000,411000,0,0
TIKI,cross-border-hang-quoc-te,17965909,"Body Language",334000,334000,0,0
TIKI,cross-border-hang-quoc-te,17970380,"Make Time",733000,733000,0,0
TIKI,cross-border-hang-quoc-te,11465059,"Collins Cobuild Advance Learners Dict 9Ed.",942000,942000,0,0
TIKI,cross-border-hang-quoc-te,170357900,"ESTEE LAUDER Advanced Night Repair Eye Supercharged Complex 3ml",449000,449000,0,0
TIKI,cross-border-hang-quoc-te,11464922,"Easy Learning Complete German Grammar, Verbs & Vocabu",675000,675000,0,0
TIKI,cross-border-hang-quoc-te,170657673,"Sách - Life of Pi (International Edition) by Yann Martel (US edition, paperback)",609000,609000,0,0
TIKI,cross-border-hang-quoc-te,170624917,"Sách - Berlitz Pocket Guide Switzerland (Travel Guide with Free Dictionary) by  (UK edition, paperback)",330000,330000,0,0
TIKI,cross-border-hang-quoc-te,11777233,"Collins Classics: The Valley Of Fear",235000,235000,0,0
TIKI,cross-border-hang-quoc-te,170582988,"Sách - The Montessori Method by Maria Montessori (US edition, paperback)",598000,598000,0,0
TIKI,cross-border-hang-quoc-te,11504725,"Harvard Business Review: Guide To Persuasive Presentations",394000,394000,0,0
TIKI,cross-border-hang-quoc-te,170706306,"Sách - The Daily Laws : 366 Meditations on Power, Seduction, Mastery, Strategy, by Robert Greene (US edition, hardcover)",862200,958000,95800,10
TIKI,cross-border-hang-quoc-te,170683960,"Sách - Pillow Thoughts III : Mending the Mind by Courtney Peppernell (US edition, paperback)",417000,417000,0,0
TIKI,cross-border-hang-quoc-te,10738649,"Mao: The Unknown Story ",551000,551000,0,0
TIKI,cross-border-hang-quoc-te,165215709,"Giường xếp cho thú cưng Shinetrip Nâng cao lõi nhôm với túi mang theo để sử dụng trong nhà và ngoài trời",661000,661000,0,0
TIKI,cross-border-hang-quoc-te,170693730,"Sách - X-Treme Sudoku by Nikoli Publishing (US edition, paperback)",381000,381000,0,0
TIKI,cross-border-hang-quoc-te,19247662,"Plato And A Platypus Walk Into A Bar",457000,457000,0,0
TIKI,cross-border-hang-quoc-te,108604328,"1 găng tay chơi Bida-Màu đỏ-Size",209000,209000,0,0
TIKI,cross-border-hang-quoc-te,17970353,"Jony Ive (Backlist)",413000,413000,0,0
TIKI,cross-border-hang-quoc-te,170726346,"Sách - Greenlights by Matthew McConaughey (US edition, hardcover)",728000,728000,0,0
TIKI,cross-border-hang-quoc-te,165218707,"Túi Thể Thao Rhinowalk Treo Phía Trước Xe Đạp Tiện Lợi Chống Thấm Nước Thích Hợp Cho Thể Thao Handlebar Bag Bicycle - Xanh",363000,363000,0,0
TIKI,cross-border-hang-quoc-te,11384985,"Selection Coloring Book",462000,462000,0,0
TIKI,cross-border-hang-quoc-te,173585995,"Sách - Studio Ghibli: 100 Collectible Postcards by Studio Ghibli (US edition, paperback)",953000,953000,0,0
TIKI,cross-border-hang-quoc-te,170580299,"Sách - Baptism of Fire by Andrzej Sapkowski David A French (US edition, paperback)",363000,363000,0,0
TIKI,cross-border-hang-quoc-te,170683967,"Sách - Pillow Thoughts IV : Stitching the Soul by Courtney Peppernell (US edition, paperback)",457000,457000,0,0
TIKI,cross-border-hang-quoc-te,17961586,"Myth Of Sisyphus",359000,359000,0,0
TIKI,cross-border-hang-quoc-te,17968526,"Wine Bible",950000,950000,0,0
TIKI,cross-border-hang-quoc-te,17964030,"Astrology: Using The Wisdom Of The Stars In Your Everyday Life",872000,872000,0,0
TIKI,cross-border-hang-quoc-te,170706312,"Sách - Six Crimson Cranes by Elizabeth Lim (US edition, hardcover)",702000,702000,0,0
TIKI,cross-border-hang-quoc-te,170695963,"Sách - A Tale of Magic... by Chris Colfer (UK edition, paperback)",450000,450000,0,0
TIKI,cross-border-hang-quoc-te,108603984,"Túi trước cho xe đạp có nắp chống thấm, dung tích lớn",537000,537000,0,0
TIKI,cross-border-hang-quoc-te,170561956,"Sách - Insight Guides City Guide Hong Kong by Insight Guides (UK edition, paperback)",421000,421000,0,0
TIKI,cross-border-hang-quoc-te,109436694,"Loa kết hợp có dây SADA D-203 USB siêu trầm cho máy tính để bàn ",288000,288000,0,0
TIKI,cross-border-hang-quoc-te,11845638,"Insight Guides Nepal",786000,786000,0,0
TIKI,cross-border-hang-quoc-te,146553974,"CINCATDY Tai Nghe Bluetooth V5.0 Earbuds Gaming Headphone True Wireless Headset SE-6 - Hàng Chính Hãng",368000,368000,0,0
TIKI,cross-border-hang-quoc-te,112994107,"Bộ Softbox Godox FL-SF3045 với Túi đựng bằng vải mềm dạng lưới tổ ong cho Godox FL60 Linh hoạt LED Light Roll-Flex Photo",583000,583000,0,0
TIKI,cross-border-hang-quoc-te,11505582,"HBR's 10 Must Reads: On Collaboration",667000,667000,0,0
TIKI,cross-border-hang-quoc-te,170608628,"Sách - Hardball for Women : Winning at the Game of Business by Pat Heim (paperback)",578000,578000,0,0
TIKI,cross-border-hang-quoc-te,11466397,"Cobuild Essential English Dictionary",359000,359000,0,0
TIKI,cross-border-hang-quoc-te,119006522,"Ba Lô Urban life style",632000,632000,0,0
TIKI,cross-border-hang-quoc-te,170687650,"Sách - The Napoleonic Wars by Prof Richard Holmes (UK edition, paperback)",318000,318000,0,0
TIKI,cross-border-hang-quoc-te,171134862,"Tinh Chất Phục Hồi Chống Lão Hóa Thế Hệ Mới Estee Lauder Synchronized Multi-Recovery Complex Complexe 7Ml*2",880000,880000,0,0
TIKI,cross-border-hang-quoc-te,11384988,"Red Queen: The Official Coloring Book",462000,462000,0,0
TIKI,cross-border-hang-quoc-te,28602093,"The End Of Cheap China, Revised And Updated: Economic And Cultural Trends That Will Disrupt The World",273000,273000,0,0
TIKI,cross-border-hang-quoc-te,17966893,"Sherlock Holmes The Novels",878000,878000,0,0
TIKI,cross-border-hang-quoc-te,17964326,"Dk Eyewitness Travel Guide Jerusalem, Israel And The Palestinian Territories",714000,714000,0,0
TIKI,cross-border-hang-quoc-te,11667769,"The Almighty Dollar",409000,409000,0,0
TIKI,cross-border-hang-quoc-te,170383591,"Nước Dưỡng Da Kép Lancôme Clarifique Double Essence Enzymatique Resurfacante 50Ml",769000,769000,0,0
TIKI,cross-border-hang-quoc-te,170658444,"Sách - The Midnight Library : A Novel by Matt Haig (US edition, hardcover)",766000,766000,0,0
TIKI,cross-border-hang-quoc-te,127646919,"Đồng hồ thông minh Mibro Air phiên bản toàn cầu Đồng hồ theo dõi thể dục XPAW001",992000,992000,0,0
TIKI,cross-border-hang-quoc-te,170582490,"Sách - Blue Period 1 by Tsubasa Yamaguchi (US edition, paperback)",321000,321000,0,0
TIKI,cross-border-hang-quoc-te,170682327,"Sách - Morpho: Skeleton and Bone Reference Points : Anatomy for Artists by Michel Lauricella (US edition, paperback)",400000,400000,0,0
TIKI,cross-border-hang-quoc-te,11778417,"All Your Perfect",378000,378000,0,0
TIKI,cross-border-hang-quoc-te,108999996,"Think Like a Monk : The Secret of How to Harness the Power of Positivity and be Happy Now",650000,650000,0,0
TIKI,cross-border-hang-quoc-te,11849714,"Gravity Falls: Journal 3",781000,781000,0,0
TIKI,cross-border-hang-quoc-te,17964226,"DK Eyewitness Travel Guide: Switzerland",562000,562000,0,0
TIKI,cross-border-hang-quoc-te,17964190,"Dk Eyewitness Travel Guide Provence And The Côte D'Azur",487000,487000,0,0
TIKI,cross-border-hang-quoc-te,11505578,"Harvard Business Review: 10 Must Reads On Teams",681000,681000,0,0
TIKI,cross-border-hang-quoc-te,170686231,"Sách - Finder Deluxe Edition: Target in Sight, Vol. 1 by Ayano Yamane (US edition, paperback)",417000,417000,0,0
TIKI,cross-border-hang-quoc-te,11504707,"Harvard Business Review: 10 Must Reads On Leadership",473000,473000,0,0
TIKI,cross-border-hang-quoc-te,11477012,"Leading : Learning from Life and My Years at Manchester United",670000,670000,0,0
TIKI,cross-border-hang-quoc-te,177560800,"Sách - Influence, New and Expanded : The Psychology of Persuasion by Robert B. Cialdini (US edition, paperback)",539000,539000,0,0
TIKI,cross-border-hang-quoc-te,178219248,"Sách - The Hating Game: 'Warm, witty and wise' The Daily Mail by Sally Thorne (UK edition, paperback)",382000,382000,0,0
TIKI,cross-border-hang-quoc-te,170590823,"Sách - Model Under Cover : Stolen with Style by Carina Axelsson (UK edition, paperback)",345000,345000,0,0
TIKI,cross-border-hang-quoc-te,171331099,"Serum Trẻ Hóa Da Lancôme Génifique Youth Activating Concentrate 7Ml*4",930000,930000,0,0
TIKI,cross-border-hang-quoc-te,170625158,"Sách - Kim Jiyoung, Born 1982 : The international bestseller by Cho Nam-Joo (UK edition, paperback)",350000,350000,0,0
TIKI,cross-border-hang-quoc-te,190701363,"Sách - GMAT Official Guide Verbal Review 2022 :  by Gmac (Graduate Management Admission Council) (US edition, paperback)",947000,947000,0,0
TIKI,cross-border-hang-quoc-te,10732580,"The 4 - Hour Work Week (UK)",622000,622000,0,0
TIKI,cross-border-hang-quoc-te,17963365,"Penguin Modern Classics: The Girl on the Via Flaminia",225000,225000,0,0
TIKI,cross-border-hang-quoc-te,109164774,"Bộ quần áo đạp xe đạp dành cho Nam-Màu vàng-Size",860000,860000,0,0
TIKI,cross-border-hang-quoc-te,10755009,"Creative Selection (Uk)",578000,578000,0,0
TIKI,cross-border-hang-quoc-te,170624704,"Sách - The Tower of the Swallow : Witcher 4 - Now a major Netflix show by Andrzej Sapkowski (UK edition, paperback)",420000,420000,0,0
TIKI,cross-border-hang-quoc-te,190861115,"Sách - All Your Perfects by Colleen Hoover (UK edition, paperback)",327000,327000,0,0
TIKI,cross-border-hang-quoc-te,170571143,"Sách - The Nightingale by Kristin Hannah (US edition, paperback)",442000,442000,0,0
TIKI,cross-border-hang-quoc-te,116125571,"Sách - No Rules Rules : Netflix and the Culture of Reinvention by REED HASTINGS - (US Edition, paperback)",891000,891000,0,0
TIKI,cross-border-hang-quoc-te,17965889,"Why I Am So Clever",158000,158000,0,0
TIKI,cross-border-hang-quoc-te,170686250,"Sách - JoJo's Bizarre Adventure: Part 1--Phantom Blood, Vol. 1 by Hirohiko Araki (US edition, hardcover)",915000,915000,0,0
TIKI,cross-border-hang-quoc-te,128519381,"Sách - Karma : A Yogi&#x27;s Guide to Creating Your Own Destiny by Sadhguru - (US Edition, hardcover)",612000,612000,0,0
TIKI,cross-border-hang-quoc-te,170720604,"Sách - Managing Oneself (Harvard Business Review Classics) by Peter Ferdinand Drucker (US edition, hardcover)",523000,523000,0,0
TIKI,cross-border-hang-quoc-te,10769325,"The Power Of Now: A Guide To Spiritual Enlightenment",534000,534000,0,0
TIKI,cross-border-hang-quoc-te,18011353,"Start With Why UK",371000,371000,0,0
TIKI,cross-border-hang-quoc-te,109435078,"Bộ sạc pin 4 khe LIITOKALA LII-M4 với màn hình LCD cho pin 18650 26650 14500 AA AAA Lithium NiMH thông minh",488000,488000,0,0
TIKI,cross-border-hang-quoc-te,17963538,"The Penguin Book Of Japanese Short Stories",506000,506000,0,0
TIKI,cross-border-hang-quoc-te,28684211,"Emotional Intelligence: Why It Can Matter More Than IQ",294000,294000,0,0
TIKI,cross-border-hang-quoc-te,171130714,"Kem Mắt Estee Lauder Advanced Night Repair Eye Supercharged Complex 3Ml",790000,790000,0,0
TIKI,cross-border-hang-quoc-te,11625785,"Sales Dogs",575000,575000,0,0
TIKI,cross-border-hang-quoc-te,7917799,"Ikigai: Japanese Secret To Long Life",517000,517000,0,0
TIKI,cross-border-hang-quoc-te,170686487,"Sách - JoJo's Bizarre Adventure: Part 4--Diamond Is Unbreakable, Vol. 4 by Hirohiko Araki (US edition, hardcover)",766000,766000,0,0
TIKI,cross-border-hang-quoc-te,108602458,"Áo đua xe đạp dài tay thoáng khí dành cho Nam-Màu đen-Size",431000,431000,0,0
TIKI,cross-border-hang-quoc-te,170687335,"Sách - History Is All You Left Me : The much-loved hit from the author of No.1 b by Adam Silvera (UK edition, paperback)",346000,346000,0,0
TIKI,cross-border-hang-quoc-te,108603168,"Túi gắn dưới yên xe đạp, để bình nước",441000,441000,0,0
TIKI,cross-border-hang-quoc-te,109436449,"Tai nghe Fineblue F1 Bluetooth 5.0 không dây Có thể Thu vào-Màu trắng",463000,463000,0,0
TIKI,cross-border-hang-quoc-te,108602111,"Máy đo tốc độ xe đạp không dây 2,8 inch Màn hình LCD không thấm nước",411000,411000,0,0
TIKI,cross-border-hang-quoc-te,170717789,"Sách - Notes from Underground and the Double by Fyodor Dostoyevsky (UK edition, paperback)",380000,380000,0,0
TIKI,cross-border-hang-quoc-te,17961663,"Collapse : How Societies Choose To Fail Or Succeed",770000,770000,0,0
TIKI,cross-border-hang-quoc-te,17970275,"Selected Poems",376000,376000,0,0
TIKI,cross-border-hang-quoc-te,173743996,"Sách - Heaven Official's Blessing: Tian Guan Ci Fu (Novel) Vol. 2 by Mo Xiang Tong Xiu (US edition, paperback)",591000,591000,0,0
TIKI,cross-border-hang-quoc-te,10761305,"Federer: The Biography",490000,490000,0,0
TIKI,cross-border-hang-quoc-te,17966761,"Great Dialogues Of Plato",341000,341000,0,0
TIKI,cross-border-hang-quoc-te,170581743,"Sách - Ecce Homo : How One Becomes What One is by Friedrich Nietzsche (UK edition, paperback)",388000,388000,0,0
TIKI,cross-border-hang-quoc-te,189641142,"Sách - We'll Always Have Summer (Reprint) by Jenny Han (US edition, paperback)",316000,316000,0,0
TIKI,cross-border-hang-quoc-te,108602773,"Bộ quần áo đi đạp xe đạp cho nam nữ, quần có đệm thoáng khí, áo ngắn tay chuyên dụng",745000,745000,0,0
TIKI,cross-border-hang-quoc-te,170725433,"Sách - The 7 Habits of Highly Effective People : 30th Anniversary Edition by Stephen R. Covey (US edition, paperback)",603000,603000,0,0
TIKI,cross-border-hang-quoc-te,17963986,"The Things You Can See Only When You Slow Down",380000,380000,0,0
TIKI,cross-border-hang-quoc-te,170602055,"Sách - The Lord of the Rings by J. R. R. Tolkien (UK edition, paperback)",967000,967000,0,0
TIKI,cross-border-hang-quoc-te,28602279,"The Official Act Prep Guide, 2019 Edition, Revised And Updated (Book + Bonus Online Content)",927000,927000,0,0
TIKI,cross-border-hang-quoc-te,170650656,"Sách - Spirited Away Film Comic, Vol. 2 by Hayao Miyazaki (US edition, paperback)",365000,365000,0,0
TIKI,cross-border-hang-quoc-te,10761139,"BEHAVE The Biology of Humans at Our Best and Worst",523000,523000,0,0
TIKI,cross-border-hang-quoc-te,170675333,"Sách - Book Of Shadows - 150 Spells, Charms, Potions and Enchantments for Wiccans : Witches  by Shadow Books (paperback)",298000,298000,0,0
TIKI,cross-border-hang-quoc-te,109633049,"Sách - German for Beginners",304200,338000,33800,10
TIKI,cross-border-hang-quoc-te,170717302,"Sách - A Storm of Swords: Part 1 Steel and Snow (Reissue) by George R. R. Martin (UK edition, paperback)",484000,484000,0,0
TIKI,cross-border-hang-quoc-te,108603060,"Túi Đựng Đồ Chống Thấm Nước Treo Sườn Xe Đạp Tiện Dụng",595000,595000,0,0
TIKI,cross-border-hang-quoc-te,171126691,"Kem Chống Lão Hóa Dưỡng Ẩm Estee Lauder Revitalizing Supreme+ Global Anti-Aging Power Soft Creme 15Ml*2",1190000,1190000,0,0
TIKI,cross-border-hang-quoc-te,17965609,"Philosophy Of Aristotle (New Cover)",339000,339000,0,0
TIKI,cross-border-hang-quoc-te,170715912,"Sách - My Little Ikigai Journal : A Journey into the Japanese Secret to Living a  by Amanda Kudo (US edition, paperback)",418000,418000,0,0
TIKI,cross-border-hang-quoc-te,170693372,"Sách - The Practice of Not Thinking : A Guide to Mindful Living by Ryunosuke Koike (UK edition, paperback)",347000,347000,0,0
TIKI,cross-border-hang-quoc-te,10732452,"King Of Capital",492000,492000,0,0
TIKI,cross-border-hang-quoc-te,19253164,"Percy Jackson"s Greek Gods",375000,375000,0,0
TIKI,cross-border-hang-quoc-te,162105952,"Sách - The Green Witch : Your Complete Guide to the Natural Magic of Herb by Arin Murphy-Hiscock (US edition, hardcover)",525000,525000,0,0
TIKI,cross-border-hang-quoc-te,11778509,"Marvel Comics: Mighty Captain Marvel Vol 2",338000,338000,0,0
TIKI,cross-border-hang-quoc-te,170682467,"Sách - The Concise Seduction by Robert Greene (UK edition, paperback)",394000,394000,0,0
TIKI,cross-border-hang-quoc-te,17965887,"How To Use Your Enemies",141300,157000,15700,10
TIKI,cross-border-hang-quoc-te,17963662,"The Hunt For Red October (Movie Tie-In)",259000,259000,0,0
TIKI,cross-border-hang-quoc-te,129212190,"Sách - The Boy, The Mole, The Fox and The Horse by Charlie Mackesy - (US Edition, hardcover)",683000,683000,0,0
TIKI,cross-border-hang-quoc-te,11838443,"Marvel Comics: Return To Planet Hulk",600000,600000,0,0
TIKI,cross-border-hang-quoc-te,170682794,"Sách - The Tyranny of Merit : Can We Find the Common Good? by Michael J Sandel (paperback)",395000,395000,0,0
TIKI,cross-border-hang-quoc-te,173561578,"Balo Văn Phòng Chống Nước Chống Trộm Đựng Máy Tính Xách Tay 2 Cổng Usb Tiện Dụng Dung Tích Lớn Mark Ryden",932000,932000,0,0
TIKI,cross-border-hang-quoc-te,17968366,"The Great Gatsby",314000,314000,0,0
TIKI,cross-border-hang-quoc-te,108211861,"【 Ready stock 】Dây Cáp Irig Thay Thế Cho Điện Thoại / Ipad",187900,187900,0,0
TIKI,cross-border-hang-quoc-te,111061686,"Loa không dây di động Bluedio HS Bluetooth gắn trên cổ với hỗ trợ âm thanh vòm trung thực Chức năng FM Thẻ SD",487000,487000,0,0
TIKI,cross-border-hang-quoc-te,170711129,"Sách - The Little Book of Chanel by Emma Baxter-Wright (UK edition, hardcover)",506000,506000,0,0
TIKI,cross-border-hang-quoc-te,113230575,"Sách - Origin Story: A Big History of Everything by David Christian - (US Edition, paperback)",421000,421000,0,0
TIKI,cross-border-hang-quoc-te,11476839,"Gorbachev",926000,926000,0,0
TIKI,cross-border-hang-quoc-te,11838428,"Marvel Comics: Deadpoll Kills The Marvel Universe Again",491000,491000,0,0
TIKI,cross-border-hang-quoc-te,162405954,"Sách - Good Vibes, Good Life : How Self-Love Is the Key to Unlocking Your Greatness by Vex King (UK edition, paperback)",470000,470000,0,0
TIKI,cross-border-hang-quoc-te,11625771,"Ogilvy On Advertising In The Digital Age",853200,948000,94800,10
TIKI,cross-border-hang-quoc-te,17963668,"Lust, Caution",270000,270000,0,0
TIKI,cross-border-hang-quoc-te,113408354,"Sách - Omoiyari : The Japanese Art of Compassion by Erin Niimi Longhurst - (UK Edition, hardcover)",464000,464000,0,0
TIKI,cross-border-hang-quoc-te,170583751,"Sách - The Inferno by Dante Alighieri (paperback)",220000,220000,0,0
TIKI,cross-border-hang-quoc-te,11863544,"Lonely Planet Paris (Travel Guide)",606000,606000,0,0
TIKI,cross-border-hang-quoc-te,147749203,"Sách - The Things You Can See Only When You Slow Down : How to be Calm in a Busy World by Haemin Sunim - (UK Edition, paperback)",399000,399000,0,0
TIKI,cross-border-hang-quoc-te,127515847,"Sách - Atomic Habits : An Easy and Proven Way to Build Good Habits and Break Bad Ones by James Clear - (US Edition, paperback)",449100,499000,49900,10
TIKI,cross-border-hang-quoc-te,11573113,"Silence: The Power Of Quiet In A World Full Of Noise",447000,447000,0,0
TIKI,cross-border-hang-quoc-te,10769313,"Wabi Sabi: Japanese Wisdom For A Perfectly Imperfect Life",520200,578000,57800,10
TIKI,cross-border-hang-quoc-te,108603917,"Túi đựng đồ xe đạp 20L gắn yên sau không thấm nước va đọ bền cao",610000,610000,0,0
TIKI,cross-border-hang-quoc-te,28601438,"Algorithms For Dummies",858000,858000,0,0
TIKI,cross-border-hang-quoc-te,113345721,"Sách - Usborne Young Reading Series 3 - Pride and Prejudice by Jane Austen - (UK Edition, paperback)",340000,340000,0,0
TIKI,cross-border-hang-quoc-te,179371946,"Sách - The Almanack of Naval Ravikant : A Guide to Wealth and Happiness by Eric Jorgenson (paperback)",529000,529000,0,0
TIKI,cross-border-hang-quoc-te,17968726,"A Streetcar Named Desire",402000,402000,0,0
TIKI,cross-border-hang-quoc-te,109165456,"Bộ dụng cụ sửa chữa xe đạp WEST BIKING-Màu mờ-Size",180000,180000,0,0
TIKI,cross-border-hang-quoc-te,170602766,"Sách - The Prophet : The Spiritual Classic by Kahlil Gibran Tom Butler-Bowdon (UK edition, hardcover)",366300,407000,40700,10
TIKI,cross-border-hang-quoc-te,170630898,"Sách - The Art of Asking Essential Questions : Based on Critical Thinking Concept by Linda Elder (US edition, paperback)",924000,924000,0,0
TIKI,cross-border-hang-quoc-te,170567883,"Sách - Einstein: His Life and Universe by Walter Isaacson (paperback)",406000,406000,0,0
TIKI,cross-border-hang-quoc-te,11505202,"Beren And Luthien",417000,417000,0,0
TIKI,cross-border-hang-quoc-te,107904975,"Loa đeo cổ bluetooth 5.0 không dây, rảnh tay ôm vừa vặn cổ và đường cong vai, tạo cảm giác thoải mái",554000,554000,0,0
TIKI,cross-border-hang-quoc-te,108601298,"Bộ đề trước của xe đạp leo núi 31.8-34.9MM-Size 9 tốc độ",193000,193000,0,0
TIKI,cross-border-hang-quoc-te,11708858,"Leadershift: The 11 Essential Changes Every Leader Must Embrace",490000,490000,0,0
TIKI,cross-border-hang-quoc-te,112995053,"đèn LED trợ sáng Godox LITEMONS LED6Bi có thể sạc lại 3200K-6500K Hỗ trợ điều chỉnh",549000,549000,0,0
TIKI,cross-border-hang-quoc-te,170599368,"Sách - The Reunion by Guillaume Musso (US edition, hardcover)",978000,978000,0,0
TIKI,cross-border-hang-quoc-te,170725260,"Sách - Antifragile: Things That Gain from Disor.der (Incerto) by Nassim Nicholas Taleb (US edition, paperback)",643000,643000,0,0
TIKI,cross-border-hang-quoc-te,108603523,"Nón bảo hiểm dành cho nam giới đi xe đạp, leo núi, hoặc hoạt động ngoài trời",461000,461000,0,0
TIKI,cross-border-hang-quoc-te,18011081,"Cute As An Axolotl",706000,706000,0,0
TIKI,cross-border-hang-quoc-te,170661666,"Sách - The Lost Tarot of Nostradamus by John Matthews Wil Kinghan (UK edition, paperback)",658000,658000,0,0
TIKI,cross-border-hang-quoc-te,28731723,"Successful Marketing Plan 4E",569000,569000,0,0
TIKI,cross-border-hang-quoc-te,28601543,"Data Science For Dummies 2Nd Edition",934000,934000,0,0
TIKI,cross-border-hang-quoc-te,195970947,"Motorola v3xx classic cheap mobile phone unlocks the world and supports Vietnamese language",813000,813000,0,0
TIKI,cross-border-hang-quoc-te,109165109,"Túi xe đạp thể thao chống nước treo sườn có ngăn đựng điện thoại cảm ứng",298000,298000,0,0
TIKI,cross-border-hang-quoc-te,170563828,"Sách - Lonely Planet Morocco by Lonely Planet (paperback)",811000,811000,0,0
TIKI,cross-border-hang-quoc-te,113408334,"Sách - Permanent Record by Edward Snowden - (UK Edition, paperback)",395000,395000,0,0
TIKI,cross-border-hang-quoc-te,17968550,"On The Road",335700,373000,37300,10
TIKI,cross-border-hang-quoc-te,170602511,"Sách - Black Clover, Vol. 2 by Yuki Tabata (US edition, paperback)",453000,453000,0,0
TIKI,cross-border-hang-quoc-te,109164170,"Kính Lái Xe Phân Cực WEST BIKING, Chống Gió, Thiết Bị Xe Đạp Leo Núi-Màu đỏ",337000,337000,0,0
TIKI,cross-border-hang-quoc-te,17963461,"The Devil In The Flesh",332000,332000,0,0
TIKI,cross-border-hang-quoc-te,17963862,"Sanshiro",288000,288000,0,0
TIKI,cross-border-hang-quoc-te,170693287,"Sách - Practical Sigil Magic : Creating Personal Symbols for Success by U.D. Frater (US edition, paperback)",537000,537000,0,0
TIKI,cross-border-hang-quoc-te,11778243,"The Sun And Her Flowers",464000,464000,0,0
TIKI,cross-border-hang-quoc-te,170706560,"Sách - The Eclectic Witch's Book of Shadows : Witchy Wisdom at Your Fingertips by Deborah Blake (US edition, hardcover)",667000,667000,0,0
TIKI,cross-border-hang-quoc-te,170725930,"Sách - Autumn Baking: Natural Yeast by Chiew See by Chiew See (paperback)",539000,539000,0,0
TIKI,cross-border-hang-quoc-te,11715910,"Harvard Business Review: Nine Things Successful People Do Differently",383000,383000,0,0
TIKI,cross-border-hang-quoc-te,28601674,"Value Investing In Asia - The Definitive Guide To Investing In Asia",794000,794000,0,0
TIKI,cross-border-hang-quoc-te,174403162,"Sách - The Fine Print by Lauren Asher (UK edition, paperback)",360000,360000,0,0
TIKI,cross-border-hang-quoc-te,173561728,"Túi Đeo Chéo Nam Chống Nước Chống Trộm Thiết Kế Đơn Giản Dung Tích Vừa Mark Ryden",338000,338000,0,0
TIKI,cross-border-hang-quoc-te,17968476,"Love In The Time Of Cholera",418000,418000,0,0
TIKI,cross-border-hang-quoc-te,108601127,"Túi đựng đồ yên sau xe đạp, chất liệu vải chống thấm nước, sức chứa lớn",283000,283000,0,0
TIKI,cross-border-hang-quoc-te,17966989,"How To Sit",244000,244000,0,0
TIKI,cross-border-hang-quoc-te,17968580,"The Call Of Cthlhu And Other Weird Stories",652000,652000,0,0
TIKI,cross-border-hang-quoc-te,11573207,"The Other Miss Bridgerton",367000,367000,0,0
TIKI,cross-border-hang-quoc-te,108599887,"Mũ bảo hiểm MTB đi xe đạp dành cho nam nữ, có tấm che nắng có thể tháo rời",576000,576000,0,0
TIKI,cross-border-hang-quoc-te,109435974,"Tai nghe chơi game ONIKUMA K5 PRO có micrô PC Gamer,âm thanh nổi 3,5 mm chống ồn  - Màu xanh dương -Màu xanh dương",477000,477000,0,0
TIKI,cross-border-hang-quoc-te,108603243,"Bọc giày chống thấm nước, chống gió, bảo vệ giày của bạn-Size",448000,448000,0,0
TIKI,cross-border-hang-quoc-te,111389380,"Ba Lô Sinh Viên Mark Ryden dành cho nam thiết kế có cổng sạc USB, dung tích lớn, thiết kế tinh tế",650000,789000,139000,18
TIKI,cross-border-hang-quoc-te,146553907,"CINCATDY Tai Nghe Bluetooth True Wireless TWS A6S pro Phiên Bản Nâng Cấp - Hàng Chính Hãng",162000,162000,0,0
TIKI,cross-border-hang-quoc-te,11777193,"Collins Classics: The Art Of Rhetoric",216000,216000,0,0
TIKI,cross-border-hang-quoc-te,108600941,"Bàn đạp xe đạp bằng hợp kim nhôm chống trượt-Màu đen",341000,341000,0,0
TIKI,cross-border-hang-quoc-te,170672353,"Sách - The Witches' Love Spell Book : For Passion, Romance, and Desire by Cerridwen Greenleaf (US edition, hardcover)",240000,240000,0,0
TIKI,cross-border-hang-quoc-te,11862275,"Best Of Italy 2Ed.",768000,768000,0,0
TIKI,cross-border-hang-quoc-te,17964074,"Dk Eyewitness Travel Guide: Amsterdam 2019",289000,289000,0,0
TIKI,cross-border-hang-quoc-te,170706778,"Sách - The Mythology Book by DK (US edition, paperback)",727000,727000,0,0
TIKI,cross-border-hang-quoc-te,134443753,"Sách - Kafka on the Shore by Haruki Murakami - (UK Edition, paperback)",381000,381000,0,0
TIKI,cross-border-hang-quoc-te,17970213,"Mansfield Park (Mar 03)",363000,363000,0,0
TIKI,cross-border-hang-quoc-te,108598793,"Máy bơm xe đạp nhỏ INBIKE, máy bơm lốp xe đạp",206000,206000,0,0
TIKI,cross-border-hang-quoc-te,17963804,"Love In A Fallen City",419000,419000,0,0
TIKI,cross-border-hang-quoc-te,10769408,"Man's Search For Meaning",552000,552000,0,0
TIKI,cross-border-hang-quoc-te,170717679,"Sách - Pitch Anything: An Innovative Method for Presenting, Persuading, and Winnin by Oren Klaff (US edition, paperback)",699000,699000,0,0
TIKI,cross-border-hang-quoc-te,111066566,"Chuột quang chơi game có dây ZELOTES T-30 công thái học với 4 DPI có thể điều chỉnh ",262000,262000,0,0
TIKI,cross-border-hang-quoc-te,10755105,"Data Visualization With Python And JavaScript",988000,988000,0,0
TIKI,cross-border-hang-quoc-te,17966554,"Think And Grow Rich (Revised)",370000,370000,0,0
TIKI,cross-border-hang-quoc-te,170400893,"Nước Hoa Hồng Lancome Tonique Confort Toner 125Ml",690000,690000,0,0
TIKI,cross-border-hang-quoc-te,112019250,"Balo dung tích 5l để đi xe đạp, chạy bộ, leo núi, thiết kế gọn nhẹ-Màu xanh dương-Size Chỉ ba lô",382000,382000,0,0
TIKI,cross-border-hang-quoc-te,179583789,"Sách - Terms and Conditions : TikTok made me buy it! Meet the Dreamland Billiona by Lauren Asher (UK edition, paperback)",530000,530000,0,0
TIKI,cross-border-hang-quoc-te,17966965,"How To Walk",244000,244000,0,0
TIKI,cross-border-hang-quoc-te,170682665,"Sách - A Farewell to Arms: The Special Edition by Ernest Hemingway (UK edition, paperback)",379000,379000,0,0
TIKI,cross-border-hang-quoc-te,170583476,"Sách - The Mysteries of the Universe : Discover the Best-Kept Secrets of Space by DK (paperback)",727000,727000,0,0
TIKI,cross-border-hang-quoc-te,11862453,"Little Prince, The (Picture Bk)",474000,474000,0,0
TIKI,cross-border-hang-quoc-te,171135461,"Nước Dưỡng Da Estee Lauder Micro Essence 50Ml*2",1240000,1240000,0,0
TIKI,cross-border-hang-quoc-te,170569191,"Sách - The Legacy of the Bones by Dolores Redondo (UK edition, paperback)",466000,466000,0,0
TIKI,cross-border-hang-quoc-te,18011175,"Elmer And The Tune",238000,238000,0,0
TIKI,cross-border-hang-quoc-te,11778385,"Diary Of An Oxygen Thief",416000,416000,0,0
TIKI,cross-border-hang-quoc-te,109436054,"Loa Cyboris S5 IPX7 không dây,chống bụi,siêu trầm và không thấm nước",604000,604000,0,0
TIKI,cross-border-hang-quoc-te,28731852,"Becoming An Effective Mentoring Leader: Proven Strategies for Building Excellence in Your",823000,823000,0,0
TIKI,cross-border-hang-quoc-te,173764839,"Sách - The Practical Witch's Spell Book : For Love, Happiness, by Cerridwen Greenleaf Mara Penny (US edition, hardcover)",588000,588000,0,0
TIKI,cross-border-hang-quoc-te,170706385,"Sách - Crying in H Mart by Michelle Zauner (US edition, paperback)",794000,794000,0,0
TIKI,cross-border-hang-quoc-te,188135079,"Sách - Malibu Rising : THE SUNDAY TIMES BESTSELLER AS SEEN ON TIKTOK by Taylor Jenkins Reid (UK edition, paperback)",322000,322000,0,0
TIKI,cross-border-hang-quoc-te,17963441,"The Years",517000,517000,0,0
TIKI,cross-border-hang-quoc-te,97032352,"Đệm Yên Xe Đạp MTB Silicon Bọt Biển Thoáng Khí",283000,283000,0,0
TIKI,cross-border-hang-quoc-te,10756940,"Thinking, Fast And Slow",499000,499000,0,0
TIKI,cross-border-hang-quoc-te,28601987,"Stock Investing For Dummies, 5Th Edition",377000,377000,0,0
TIKI,cross-border-hang-quoc-te,109434854,"Bộ sạc pin LiitoKala lii-600 Li-ion-3.7V Ni-MH1.2V 4 khe cắm-Màu đen-Size Cắm EU",914000,914000,0,0
TIKI,cross-border-hang-quoc-te,170693707,"Sách - Original Sudoku by Editors of Nikoli Publishing (US edition, paperback)",369000,369000,0,0
TIKI,cross-border-hang-quoc-te,166551242,"Nước Dưỡng Da Estee Lauder Micro Essence 50ml",750000,750000,0,0
TIKI,cross-border-hang-quoc-te,10732570,"Zero To One",390600,434000,43400,10
TIKI,cross-border-hang-quoc-te,11779322,"Where You Go Is Not Who You'll Be: An Antidote To The College Admissions Mania",505000,505000,0,0
TIKI,cross-border-hang-quoc-te,109436301,"Loa Bluetooth không dây Rolton E500 6W Máy nghe nhạc âm thanh nổi HiFi Đài FM kỹ thuật số di động với màn hình LED đèn pin-Màu xanh lá",393000,393000,0,0
TIKI,cross-border-hang-quoc-te,170682273,"Sách - Weave the Liminal : Living Modern Traditional Witchcraft by Laura Tempest Zakroff (US edition, paperback)",619000,619000,0,0
TIKI,cross-border-hang-quoc-te,17963556,"Territory Of Light",370000,370000,0,0
TIKI,cross-border-hang-quoc-te,108601815,"Hộp đựng dụng cụ, túi đựng dụng cụ sửa chữa xe đạp gắn trên xe tiện dụng-Size Chỉ túi",161000,161000,0,0
TIKI,cross-border-hang-quoc-te,108600904,"Giày đạp xe đạp không thấm nước với thiết kế phản quang cho Na",355000,355000,0,0
TIKI,cross-border-hang-quoc-te,109436605,"Loa máy tính có dây USB SADA V-193 siêu trầm âm thanh vòm 3.5mm",305000,305000,0,0
TIKI,cross-border-hang-quoc-te,10769329,"Getting To Yes: Negotiating An Agreement Without Giving In",387000,387000,0,0
TIKI,cross-border-hang-quoc-te,170724409,"Sách - Because of Miss Bridgerton by Julia Quinn (US edition, paperback)",225000,225000,0,0
TIKI,cross-border-hang-quoc-te,178079153,"Sách - How to Be Alone : If You Want To, and Even If You Don't by Lane Moore (US edition, paperback)",462000,462000,0,0
TIKI,cross-border-hang-quoc-te,125590850,"Sách - The Master Key System : Your Step-by-Step Guide to Using the Law of Attraction by Charles F. Haanel - (US Edition, paperback)",354600,394000,39400,10
TIKI,cross-border-hang-quoc-te,111416069,"Balo câu cá đa năng 23L ngăn lớn đựng dụng cụ câu ngăn hông đựng máy câu tiện lợi, mang được nhiều kiểu",445000,445000,0,0
TIKI,cross-border-hang-quoc-te,171124884,"Serum Trẻ Hóa Da Lancôme Génifique Youth Activating Concentrate 7Ml*2",580000,580000,0,0
TIKI,cross-border-hang-quoc-te,11709099,"Everybody Lies: Big Data, New Data, And What The Internet Can Tell Us About Who We Really Are",510000,510000,0,0
TIKI,cross-border-hang-quoc-te,17968728,"Civilization And Its Discontents",422000,422000,0,0
TIKI,cross-border-hang-quoc-te,170682191,"Sách - Origami Animal Sculpture : Paper Folding Inspired by Nature: Fold and Dis by John Szinger (US edition, paperback)",741000,741000,0,0
TIKI,cross-border-hang-quoc-te,146554010,"CINCATDY Tai Nghe Bluetooth Earbuds Gaming Headset True Wireless Headphone Dock Sạc có Led Báo Pin Kép S6 PLUS",240000,240000,0,0
TIKI,cross-border-hang-quoc-te,17964118,"Zen: The Art Of Simple Living",548000,548000,0,0
TIKI,cross-border-hang-quoc-te,7917852,"How Will You Measure Your Life?",383400,426000,42600,10
TIKI,cross-border-hang-quoc-te,111389878,"Túi đeo ngực thời trang dành cho người đàn ông Mark Ryden",644000,644000,0,0
TIKI,cross-border-hang-quoc-te,108602189,"Bộ đề sau cho xe đạp leo núi 9S/10S/11S 9 tốc độ-Size 9 tốc độ",350000,350000,0,0
TIKI,cross-border-hang-quoc-te,113349248,"Sách - Sapiens (Graphic Edition) : A Brief History of Humankind by Yuval Noah Harari - (US Edition, paperback)",897000,897000,0,0
TIKI,cross-border-hang-quoc-te,17966174,"Benjamin Graham On Value Investing",595000,595000,0,0
TIKI,cross-border-hang-quoc-te,192231247,"Bơm lốp xe đạp WEST BIKING 160psi bằng thép không gỉ",207000,207000,0,0
TIKI,cross-border-hang-quoc-te,170725133,"Sách - Leadership Presence (HBR Emotional Intelligence Series) by Harvard Business Review (US edition, paperback)",446000,446000,0,0
TIKI,cross-border-hang-quoc-te,112319619,"Sách - Pokemon: Super Deluxe Essential Handbook by Scholastic",992000,992000,0,0
TIKI,cross-border-hang-quoc-te,19253168,"Penguin Classics: Lolita",380000,380000,0,0
TIKI,cross-border-hang-quoc-te,17963393,"Dandelions",328000,328000,0,0
TIKI,cross-border-hang-quoc-te,170605950,"Sách - The Dhandho Investor : The Low-Risk Value Method to High Returns by Mohnish Pabrai (US edition, hardcover)",907000,907000,0,0
TIKI,cross-border-hang-quoc-te,28602201,"Intelligent Testing With The Wisc-V",935000,935000,0,0
TIKI,cross-border-hang-quoc-te,17964012,"The Way Home",338000,338000,0,0
TIKI,cross-border-hang-quoc-te,170583066,"Sách - Positive Discipline Parenting Tools by Jane Nelsen (US edition, paperback)",598000,598000,0,0
TIKI,cross-border-hang-quoc-te,11504844,"Harvard Business Review: 20 Minute Manager: Delegating Work",389000,389000,0,0
TIKI,cross-border-hang-quoc-te,109436747,"Tai nghe Bluetooth không dây Fineblue với micrô Đen",346000,346000,0,0
TIKI,cross-border-hang-quoc-te,172191121,"TINH CHẤT TRẺ HÓA LÀN DA 7ML SERUM LANCOME ADVANCED GENIFIQUE YOUTH ACTIVATING CONCENTRATE",295000,295000,0,0
TIKI,cross-border-hang-quoc-te,11466409,"Unlocking German With Paul Noble",619000,619000,0,0
TIKI,cross-border-hang-quoc-te,17968730,"Just An Ordinary Day",261000,261000,0,0
TIKI,cross-border-hang-quoc-te,17963550,"Patriot Games",470000,470000,0,0
TIKI,cross-border-hang-quoc-te,170725027,"Sách - My Morning Routine : How Successful People Start Every Day Inspired by Benjamin Spall (UK edition, paperback)",590000,590000,0,0
TIKI,cross-border-hang-quoc-te,17968492,"The Collected Short Stories",410000,410000,0,0
TIKI,cross-border-hang-quoc-te,109164938,"Gương chiếu hậu dành cho xe đạp",194000,194000,0,0
TIKI,cross-border-hang-quoc-te,108209868,"Set 2 Quạt Tản Nhiệt 75mm Cho Card Đồ Họa Gtx 1050ti-4gd5 V2 Gtx960 Gtx950 Gtx 1060-6gd5 Thẻ Videos",296362,296362,0,0
TIKI,cross-border-hang-quoc-te,171551092,"Sách - The Last Hours: Chain of Iron by Cassandra Clare (UK edition, paperback)",429000,429000,0,0
TIKI,cross-border-hang-quoc-te,11777972,"I Am Going! (An Elephant & Piggie)",385000,385000,0,0
TIKI,cross-border-hang-quoc-te,17963463,"O Pioneers!",321000,321000,0,0
TIKI,cross-border-hang-quoc-te,112996823," Đèn Godox LITEMONS LED6R RGB LED có thể thay đổi 13 hiệu ứng ánh sáng",599000,599000,0,0
TIKI,cross-border-hang-quoc-te,17963568,"Mrs Dalloway",382000,382000,0,0
TIKI,cross-border-hang-quoc-te,17963708,"View From The Bridge",212400,236000,23600,10
TIKI,cross-border-hang-quoc-te,108602395,"Túi Đựng Đồ Phía Sau Xe Đạp Bền Sức Chứa Lớn Sức Chứa Lớn",580000,580000,0,0
TIKI,cross-border-hang-quoc-te,109436358,"Tai nghe Bluetooth không dây Fineblue F2 Pro 5.0 cảnh báo rung với mic cho điện thoại thông minh -Màu đen",522000,522000,0,0
TIKI,cross-border-hang-quoc-te,28731805,"Instagram For Business For Dummies",999000,999000,0,0
TIKI,cross-border-hang-quoc-te,170703015,"Sách - The Lion King Read-Along Storybook by Disney Books Disney Storybook Art Team (US edition, paperback)",275000,275000,0,0
TIKI,cross-border-hang-quoc-te,28731795,"The Laws Of Brand Storytelling:Win—And Keep—Your Customers’ Hearts And Minds",876000,876000,0,0
TIKI,cross-border-hang-quoc-te,113407235,"Sách - Before by Anna Todd - (US Edition, paperback)",381000,381000,0,0
TIKI,cross-border-hang-quoc-te,11466222,"199 Flowers",321000,321000,0,0
TIKI,cross-border-hang-quoc-te,191356451,"Viên Uống Bổ Sung Dầu Cá DHA, EPA, Efamol Efalex Tăng Cường Trí Nhớ, Hỗ Trợ Trí Não, Tim Mạch, Thị Lực (240 Viên Nang)",1954000,1954000,0,0
TIKI,cross-border-hang-quoc-te,109435554,"Tai nghe Fineblue F970 Pro Kẹp trên tai,không dây Bluetooth 5.0-Màu trắng",422000,422000,0,0
TIKI,cross-border-hang-quoc-te,11464952,"French Ages 7-9",194000,194000,0,0
TIKI,cross-border-hang-quoc-te,17963832,"The Day of the Locust The Dream Life of Balso Snell",390000,390000,0,0
TIKI,cross-border-hang-quoc-te,170707214,"Sách - Insight Guides Pocket Japan (Travel Guide with Free eBook) by Insight Guides (UK edition, paperback)",359000,359000,0,0
TIKI,cross-border-hang-quoc-te,108602272,"Túi yên sau xe đạp Roswheel",180000,180000,0,0
TIKI,cross-border-hang-quoc-te,189280644,"Túi Giả Da Đựng Chìa Khóa Xe Hơi",80000,80000,0,0
TIKI,cross-border-hang-quoc-te,17963648,"Tom Clancy'S Power And Empire",256000,256000,0,0
TIKI,cross-border-hang-quoc-te,11625767,"Harvard Business Review: Guide To Data Analytics Basics For Managers",580000,580000,0,0
TIKI,cross-border-hang-quoc-te,108599345,"Áo khoác không tay đi xe đạp Jersey chống gió thoáng khí dành cho Nam Nữ-Size",412000,412000,0,0
TIKI,cross-border-hang-quoc-te,11838402,"Invincible Iron Man: Ironheart Vol. 2 - Choices",373000,373000,0,0
TIKI,cross-border-hang-quoc-te,170641406,"Sách - Dear Mr. Henshaw by Beverly Cleary (US edition, paperback)",276000,276000,0,0
TIKI,cross-border-hang-quoc-te,18011466,"Problem Solving 101",716000,716000,0,0
TIKI,cross-border-hang-quoc-te,128518941,"Sách - Code Name Bananas by David Walliams, Tony Ross - (UK Edition, paperback)",573000,573000,0,0
TIKI,cross-border-hang-quoc-te,170670267,"Sách - Slither by Joseph Delaney (US edition, paperback)",618000,618000,0,0
TIKI,cross-border-hang-quoc-te,11849702,"Minions: The Doodle Activity Book",351000,351000,0,0
TIKI,cross-border-hang-quoc-te,173372266,"Sách - Fear : Essential Wisdom for Getting Through The Storm by Thich Nhat Hanh (UK edition, paperback)",496000,496000,0,0
TIKI,cross-border-hang-quoc-te,17968368,"In Love",524000,524000,0,0
TIKI,cross-border-hang-quoc-te,28602125,"Unlearn: Let Go Of Past Success To Achieve Extraordinary Results",839000,839000,0,0
TIKI,cross-border-hang-quoc-te,10738550,"Creative Baking: Macarons",625000,625000,0,0
TIKI,cross-border-hang-quoc-te,107905058,"Túi đựng vợt cầu lông chống nước",154000,154000,0,0
TIKI,cross-border-hang-quoc-te,11730003,"Sideways Stories From Wayside School",265000,265000,0,0
TIKI,cross-border-hang-quoc-te,170602758,"Sách - Wordsearches for Kids by Collins Kids (UK edition, paperback)",289000,289000,0,0
TIKI,cross-border-hang-quoc-te,170585451,"Sách - The Last Apprentice: Fury of the Seventh Son (Book 13) by Joseph Delaney (US edition, paperback)",587000,587000,0,0
TIKI,cross-border-hang-quoc-te,19246918,"The Element",505000,505000,0,0
TIKI,cross-border-hang-quoc-te,17963730,"The Princess Saves Herself In This One",467000,467000,0,0
TIKI,cross-border-hang-quoc-te,111389931,"Túi du lịch thời trang cho nam MARK RYDEN, thiết kế chống nước, nhiều ngăn, dung tích lớn",758000,758000,0,0
TIKI,cross-border-hang-quoc-te,111067634,"Máy tính bảng vẽ đồ họa chuyên nghiệp Huion H420 với 3 phím tắt 2048 mức Độ nhạy áp lực Bút 4000LPI",703000,703000,0,0
TIKI,cross-border-hang-quoc-te,17968994,"Inward",441000,441000,0,0
TIKI,cross-border-hang-quoc-te,170678826,"Sách - Eat Vietnam by Food (paperback)",622000,622000,0,0
TIKI,cross-border-hang-quoc-te,108602351,"Giá đỡ điện thoại GUB cao cấp bằng hợp kim nhôm nhẹ và bền Thiết kế có thể điều chỉnh phù hợp cho xe đạp,xe máy-Màu Titan",283000,283000,0,0
TIKI,cross-border-hang-quoc-te,174400108,"Sách - Red, White and Royal Blue by Casey McQuiston (UK edition, paperback)",400000,400000,0,0
TIKI,cross-border-hang-quoc-te,11464756,"Collins English Thesaurus",994000,994000,0,0
TIKI,cross-border-hang-quoc-te,170605765,"Sách - Nomadology : The War Machine by Gilles Deleuze (US edition, paperback)",550000,550000,0,0
TIKI,cross-border-hang-quoc-te,170585367,"Sách - All the Light We Cannot See by Anthony Doerr (UK edition, paperback)",423000,423000,0,0
TIKI,cross-border-hang-quoc-te,109434902,"Tai nghe trong tai Fineblue F990 có thể thu vào",429000,429000,0,0
TIKI,cross-border-hang-quoc-te,17963455,"Try It! Cake Decorating",654000,654000,0,0
TIKI,cross-border-hang-quoc-te,111388663,"Dụng cụ nướng đồ ăn, cắm trại BBQ ngoài trời, dã ngoại, du lịch-Màu B",215000,215000,0,0
TIKI,cross-border-hang-quoc-te,11863402,"Lonely Planet India (Travel Guide)",918000,918000,0,0
TIKI,cross-border-hang-quoc-te,11778507,"Marvel Comics: The Mighty Captain Marvel Vol. 1",456000,456000,0,0
TIKI,cross-border-hang-quoc-te,11466175,"My Very First Animals Book",953000,953000,0,0
TIKI,cross-border-hang-quoc-te,108604148,"Khóa xe đạp chữ U với giá đỡ cáp thép Chịu được cắt, bẻ, cưa và xén.-Màu đen-Size Cáp",191000,191000,0,0
TIKI,cross-border-hang-quoc-te,111415836,"Túi câu cá có đệm đa chức năng",421000,421000,0,0
TIKI,cross-border-hang-quoc-te,17963570,"To The Lighthouse",627000,627000,0,0
TIKI,cross-border-hang-quoc-te,7917828,"Hit Refresh",452000,452000,0,0
TIKI,cross-border-hang-quoc-te,111067204,"Ổ đĩa flash USB Type-C USB3.0 EAGET FU68 32GB hai cổng kim loại, mã hóa vân tay cho điện thoại thông minh Máy tính xách tay PC",862000,862000,0,0
TIKI,cross-border-hang-quoc-te,11385461,"Dc Comics: Batman Through The Ages Pkt Notebk (Set Of 3)",390000,390000,0,0
TIKI,cross-border-hang-quoc-te,170715851,"Sách - How We Die : Reflections on Life's Final Chapter by Sherwin B. Nuland (US edition, paperback)",636000,636000,0,0
TIKI,cross-border-hang-quoc-te,108603827,"Mũ bảo hiểm dành cho nam và nữ hiệu MTB bảo vệ an toàn khi đi xe đạp, leo núi, hoạt động ngoài trời-Màu đỏ",464000,464000,0,0
TIKI,cross-border-hang-quoc-te,11778511,"Marvel Comics: Dark Origins: Mighy Captain Marvel Vol 3",444000,444000,0,0
TIKI,cross-border-hang-quoc-te,170711089,"Sách - The Girl, the Penguin, the Home-Schooling and the Gin : A hilarious parody o by Guy Adams (UK edition, hardcover)",361000,361000,0,0
TIKI,cross-border-hang-quoc-te,11446378,"Vietnamese Phrasebook & Dictionary 8Ed.",318000,318000,0,0
TIKI,cross-border-hang-quoc-te,170707389,"Sách - Archer's Voice by Mia Sheridan (paperback)",456300,507000,50700,10
TIKI,cross-border-hang-quoc-te,108598814,"Túi đựng đồ yên sau xe đạp,Chất liệu Polyester độ dẻo dai cao, chịu lực, dung tích lớn 13L với ngăn đựng cốc",306000,306000,0,0
TIKI,cross-border-hang-quoc-te,108599125,"Túi đựng đồ dùng xe đạp không thấm nưới",292000,292000,0,0
TIKI,cross-border-hang-quoc-te,170579107,"Sách - How to Win Friends and Influence People by Dale Carnegie (US edition, paperback)",519000,519000,0,0
TIKI,cross-border-hang-quoc-te,11407519,"The Complete Guide to Figure Drawing for Comics and Graphic Novels",678000,678000,0,0
TIKI,cross-border-hang-quoc-te,17968938,"Criminal : The Truth about why people do Bad Things",398000,398000,0,0
TIKI,cross-border-hang-quoc-te,11513240,"The Song of Middle-earth : J. R. R. Tolkien's Themes, Symbols and Myths",349000,349000,0,0
TIKI,cross-border-hang-quoc-te,108783429,"Đồng hồ nam hàng hiệu da thạch anh chống thấm nước mặt tròn cổ tay Đồng hồ đeo tay thời trang doanh nhân Relogio Masculino CURREN 8329-Màu xanh lá",331000,331000,0,0
TIKI,cross-border-hang-quoc-te,170579054,"Sách - The How Not To Die Cookbook : Over 100 Recipes to Help Prevent and Reve by Michael Greger (UK edition, paperback)",823000,823000,0,0
TIKI,cross-border-hang-quoc-te,111066051,"Chuột chơi game ZELOTES F-17 không dây 2.4GHz 6 phím Chuột quang công thái học với 3 DPI có thể điều chỉnh cho PC",271000,271000,0,0
TIKI,cross-border-hang-quoc-te,11855829,"Lagom",573000,573000,0,0
TIKI,cross-border-hang-quoc-te,108600506,"Túi tay lái dành cho xe đạp",632000,632000,0,0
TIKI,cross-border-hang-quoc-te,108602178,"Máy bơm xe đạp công suât 120 PSI và bộ dụng cụ vá xe thủng lốp-Màu đen-Size Thay đổi van thủ công",250000,250000,0,0
TIKI,cross-border-hang-quoc-te,111061937,"Quạt tản nhiệt bằng hợp kim nhôm cho laptop COOLCOLD K30",638000,638000,0,0
TIKI,cross-border-hang-quoc-te,11504721,"Harvard Business Review: Guide To Better Business Writing",568000,568000,0,0
TIKI,cross-border-hang-quoc-te,182581316,"Đồng Hồ Kỹ Thuật Số North Edge Bấm Giờ Đèn Nền Led Chống Nước 50M - Vàng",707000,707000,0,0
TIKI,cross-border-hang-quoc-te,170724975,"Sách - Recursion by Blake Crouch (UK edition, paperback)",557000,557000,0,0
TIKI,cross-border-hang-quoc-te,11779540,"The Midnight Gang",365400,406000,40600,10
TIKI,cross-border-hang-quoc-te,170726115,"Sách - City of Bones (The Mortal Instruments) by Cassandra Clare (UK edition, paperback)",443000,443000,0,0
TIKI,cross-border-hang-quoc-te,108599952,"Giày đi xe đạp leo núi bằng thun spandex có khóa kéo tiện lợi, chống bụi dành cho Nam nữ-Màu đen-Size",221000,221000,0,0
TIKI,cross-border-hang-quoc-te,17963678,"The Trial",396000,396000,0,0
TIKI,cross-border-hang-quoc-te,170585806,"Sách - How to Be a Genius : Your Brain and How to Train It by DK (paperback)",812000,812000,0,0
TIKI,cross-border-hang-quoc-te,163871653,"Sách - The Silent Patient : The record-breaking, multimillion copy Sunday Ti by Alex Michaelides (UK edition, paperback)",373000,373000,0,0
TIKI,cross-border-hang-quoc-te,170725058,"Sách - Buffettology : The Previously Unexplained Techniques That Have Made Warre by Mary Buffett (US edition, paperback)",550000,550000,0,0
TIKI,cross-border-hang-quoc-te,109164694,"Khóa chữ U WEST BIKING chất lượng cao bằng thép carbon dày 10mm kèm 2 chìa khóa thích hợp cho khóa xe đạp, xe máy",200000,200000,0,0
TIKI,cross-border-hang-quoc-te,11471651,"The Lost City Of Z",265000,265000,0,0
TIKI,cross-border-hang-quoc-te,109435589," Loa Bluetooth không dây di động 10W âm thanh nổi ngoài trời U Disk TF Đầu đọc thẻ T&G 116 ",380000,380000,0,0
TIKI,cross-border-hang-quoc-te,189587943,"Sách - How to Prevent the Next Pandemic by Bill Gates (US edition, hardcover)",618000,618000,0,0
TIKI,cross-border-hang-quoc-te,170626033,"Sách - Wreck This Journal Everywhere : To Create Is to Destroy by Keri Smith (US edition, hardcover)",322000,322000,0,0
TIKI,cross-border-hang-quoc-te,170658285,"Sách - One Line A Day: A Five-Year Memory Book by Chronicle Books (US edition, paperback)",542000,542000,0,0
TIKI,cross-border-hang-quoc-te,111389326,"Túi đeo ngực thời trang chất liệu vải Oxford, chống mài mòn, chống thấm nước Mark Ryden",379000,499000,120000,24
TIKI,cross-border-hang-quoc-te,11466417,"Scrabble Word Addict",300000,300000,0,0
TIKI,cross-border-hang-quoc-te,170625876,"Sách - Harry Potter Hogwarts Castle and Sticker Book : Lights Up! by Running Press (US edition, paperback)",348000,348000,0,0
TIKI,cross-border-hang-quoc-te,11544122,"Einstein's Dice And Schrodinger's Cat",380000,380000,0,0
TIKI,cross-border-hang-quoc-te,19246930,"Burmese Days",256000,256000,0,0
TIKI,cross-border-hang-quoc-te,173399495,"Máy cạo râu điện hai lưỡi Philips (PQ182)",719200,719200,0,0
TIKI,cross-border-hang-quoc-te,170720980,"Sách - Avatar: The Last Airbender - Imbalance Part Two by Faith Erin Hicks (US edition, paperback)",470000,470000,0,0
TIKI,cross-border-hang-quoc-te,11471978,"Thick Face, Black Heart",598000,598000,0,0
TIKI,cross-border-hang-quoc-te,148068456,"Sách - Immune : A Journey Into the Mysterious System That Keeps You Alive by Philipp Dettmer - (US Edition, hardcover)",963000,963000,0,0
TIKI,cross-border-hang-quoc-te,11464872,"Collins Easy Learning Mandarin Chinese Dictionary",694000,694000,0,0
TIKI,cross-border-hang-quoc-te,17964144,"Australia",483000,483000,0,0
TIKI,cross-border-hang-quoc-te,170693388,"Sách - The Heart Sutra by Red Pine (US edition, paperback)",472000,472000,0,0
TIKI,cross-border-hang-quoc-te,109434987,"Bộ sạc pin LiitoKala lii-S8 Li-ion 3.7V NiMH 1.2V Li-FePO4 3.2V IMR 3.8V sạc cho 18650 26650 21700 26700 AA AAA-Màu đen-Size Phích cắm của Hoa Kỳ",840000,840000,0,0
TIKI,cross-border-hang-quoc-te,17970351,"Seriously...I'M Kidding",280800,312000,31200,10
TIKI,cross-border-hang-quoc-te,97029524,"WEST BIKING Yên Xe Đạp Phản Quang Có Xốp Đệm Mềm Cho Xe Đạp MTB",286000,286000,0,0
TIKI,cross-border-hang-quoc-te,170654667,"Sách - Adult Piano Adventures : Classics Book 2 by Nancy Faber Randall Faber (US edition, paperback)",366000,366000,0,0
TIKI,cross-border-hang-quoc-te,11708836,"21 Irrefutable Laws Of Leadership: Follow Them And People Will Follow You",443700,493000,49300,10
TIKI,cross-border-hang-quoc-te,17968714,"The Great Adventures of Sherlock Holmes (Puffin Classics)",341000,341000,0,0
TIKI,cross-border-hang-quoc-te,170693043,"Sách - Freed : Fifty Shades Freed as Told by Christian by E L James (US edition, paperback)",682000,682000,0,0
TIKI,cross-border-hang-quoc-te,109164674,"Đèn hậu đi xe đạp cảm biến phanh tự động, chống thấm nước IPX6-Màu đen-Size Yên xe cố định",325000,325000,0,0
TIKI,cross-border-hang-quoc-te,147273832,"Sách - Pokemon: Super Extra Deluxe Essential Handbook by Scholastic - (US Edition, paperback)",893700,993000,99300,10
TIKI,cross-border-hang-quoc-te,17965973,"On Grand Strategy",529000,529000,0,0
TIKI,cross-border-hang-quoc-te,17965399,"The Penguin Book Of Outer Space Exploration",487000,487000,0,0
TIKI,cross-border-hang-quoc-te,108598849,"Túi trước xe đap,túi tay lái xe đạp, Giỏ xe đạp có túi lưới Cách nhiệt",227000,227000,0,0
TIKI,cross-border-hang-quoc-te,11505404,"The Screwtape Letters",459000,459000,0,0
TIKI,cross-border-hang-quoc-te,111388730,"Thảm cắm trại, đi biển di động ngoài trời, không thấm nước-Màu xanh dương-Size M (1,4 x 2m)",207000,207000,0,0
TIKI,cross-border-hang-quoc-te,11466421,"Scrabble Trainer",175000,175000,0,0
TIKI,cross-border-hang-quoc-te,146519015,"CINCATDY Tai Nghe Bluetooth Earbuds Gaming Headset True Wireless Headphone G7S - Hàng Chính Hãng",213000,213000,0,0
TIKI,cross-border-hang-quoc-te,170591750,"Sách - Creative Writer's Handbook by Megan Cullis (UK edition, paperback)",482000,482000,0,0
TIKI,cross-border-hang-quoc-te,11504800,"Unfair Advantage",549000,549000,0,0
TIKI,cross-border-hang-quoc-te,11534740,"Assassin'S Greed Origins: Desert Oath",338000,338000,0,0
TIKI,cross-border-hang-quoc-te,170577484,"Sách - Lonely Planet Best of Great Britain by Damian Harper (US edition, paperback)",343000,343000,0,0
TIKI,cross-border-hang-quoc-te,170582802,"Sách - Modern Cider : Simple Recipes to Make Your Own Ciders, Perries, Cyser by Emma Christensen (US edition, paperback)",977000,977000,0,0
TIKI,cross-border-hang-quoc-te,173560886,"Balo Văn Phòng Nhiều Lớp Chống Nước Chống Trộm Đựng Máy Tính Xách Tay Có Cổng Usb Tiện Dụng Mark Ryden",990000,990000,0,0
TIKI,cross-border-hang-quoc-te,28602415,"Mcgraw-Hill Education: 10 Act Practice Tests, Fifth Edition",646000,646000,0,0
TIKI,cross-border-hang-quoc-te,170707233,"Sách - The Rough Guide to Shanghai (Travel Guide) by Rough Guides (UK edition, paperback)",454000,454000,0,0
TIKI,cross-border-hang-quoc-te,11778405,"Love Her Wild",577000,577000,0,0
TIKI,cross-border-hang-quoc-te,108603789,"Mũ bảo hiểm thể thao có vành, Chất liệu ABS chống va đập với lớp PU bên ngoài chống thấm nước.",367000,367000,0,0
TIKI,cross-border-hang-quoc-te,111390043,"Balo NamThời Trang Nhẹ Nhàng Mark Ryden",860000,860000,0,0
TIKI,cross-border-hang-quoc-te,11846572,"Shark In Park: Phonics Readers",394000,394000,0,0
TIKI,cross-border-hang-quoc-te,17966694,"Paper Promises",410000,410000,0,0
TIKI,cross-border-hang-quoc-te,17964238,"DK Eyewitness Travel Guide: Norway",557000,557000,0,0
TIKI,cross-border-hang-quoc-te,10769392,"When Breath Becomes Air",425000,425000,0,0
TIKI,cross-border-hang-quoc-te,17966376,"Sherlock Holmes: A Scandal In Japan",628000,628000,0,0
TIKI,cross-border-hang-quoc-te,188138696,"Sách - Heartstopper Volume Two by ALICE OSEMAN (UK edition, paperback)",491000,491000,0,0
TIKI,cross-border-hang-quoc-te,170678792,"Sách - Eat Italy by Food (paperback)",622000,622000,0,0
TIKI,cross-border-hang-quoc-te,171324990,"Nước Hoa Hồng Lancome Tonique Confort Toner 125Ml*4",2360000,2360000,0,0
TIKI,cross-border-hang-quoc-te,108601069,"Khóa dây xe đạp TONYON mật khẩu 4 số có đèn led dây khóa bằng thép cứng cáp",292000,292000,0,0
TIKI,cross-border-hang-quoc-te,17965631,"The Best Of Archie Americana Vol. 3",409000,409000,0,0
TIKI,cross-border-hang-quoc-te,17963882,"Penguin Modern Classic: Boys In Zinc",386000,386000,0,0
TIKI,cross-border-hang-quoc-te,108603734,"Túi yên phía sau cho xe đạp leo núi, chất liệu chống nước, dễ dàng lau chùi bằng khăn lau, có đèn nền cảnh báo ban đêm",316000,316000,0,0
TIKI,cross-border-hang-quoc-te,170725400,"Sách - The Effective Executive : The Definitive Guide to Getting the Right Thin by Peter Drucker (US edition, hardcover)",972000,972000,0,0
TIKI,cross-border-hang-quoc-te,170625496,"Sách - The Concise 48 Laws Of Power by Robert Greene (UK edition, paperback)",350000,350000,0,0
TIKI,cross-border-hang-quoc-te,108599261,"Mũ bảo hiểm GUB đi leo núi, chơi thể thao bằng nhựa ABS chất lượng cao, phù hợp với chu vi vòng đầu: 56 - 62cm (22.0 - 24.4in)",579000,579000,0,0
TIKI,cross-border-hang-quoc-te,11625742,"Harvard Business Review: Guide To Performance Management",563000,563000,0,0
TIKI,cross-border-hang-quoc-te,11471804,"Game Changers",606000,606000,0,0
TIKI,cross-border-hang-quoc-te,170581212,"Sách - Unfuck Your Brain : Using Science To Get Over Anxiety, Depression, Anger, by Faith Harper (US edition, paperback)",417000,417000,0,0
TIKI,cross-border-hang-quoc-te,170653884,"Sách - The Spook's Tale and Other Horrors by Joseph Delaney (US edition, paperback)",413000,413000,0,0
TIKI,cross-border-hang-quoc-te,17963427,"Great Expectations",347000,347000,0,0
TIKI,cross-border-hang-quoc-te,170682801,"Sách - Tom Clancy's Op-Center: God of War by Jeff Rovin Tom Clancy Steve Pieczenik (paperback)",273000,273000,0,0
TIKI,cross-border-hang-quoc-te,170582804,"Sách - Liquid Education: Beer : From hop to the perfect pour by Will Hawkes (paperback)",674000,674000,0,0
TIKI,cross-border-hang-quoc-te,111063673,"Tấm nền Huion L4S ánh sáng LED siêu mỏng có thể điều chỉnh",990000,990000,0,0
TIKI,cross-border-hang-quoc-te,170568615,"Sách - Happy Money : The Science of Happier Spending by Elizabeth Dunn (paperback)",469000,469000,0,0
TIKI,cross-border-hang-quoc-te,170686477,"Sách - Tokyo Ghoul:re Illustrations: zakki by Sui Ishida (US edition, hardcover)",995000,995000,0,0
TIKI,cross-border-hang-quoc-te,11863314,"Pocket Budapest 2",414000,414000,0,0
TIKI,cross-border-hang-quoc-te,170623241,"Sách - Minecraft: Mobestiary by Mojang AB (US edition, hardcover)",763000,763000,0,0
TIKI,cross-border-hang-quoc-te,170725438,"Sách - Point of Retreat by Colleen Hoover (US edition, paperback)",495000,495000,0,0
TIKI,cross-border-hang-quoc-te,11464811,"Collins Junior Illustrated Thesaurus",349000,349000,0,0
TIKI,cross-border-hang-quoc-te,170683985,"Sách - DUNE: The Graphic Novel, Book 1: Dune by Brian Herbert (US edition, paperback)",837000,837000,0,0
TIKI,cross-border-hang-quoc-te,28601715,"Java All-In-One For Dummies",623000,623000,0,0
TIKI,cross-border-hang-quoc-te,108125739,"Vây bơi thoải mái linh hoạt",492000,492000,0,0
TIKI,cross-border-hang-quoc-te,108604092,"Túi đựng đồ treo khung trước xe đạp vỏ cứng, chất liệu bền, chống thấm nước",275000,275000,0,0
TIKI,cross-border-hang-quoc-te,11778377,"Warm Bodies And The New Hunger",629000,629000,0,0
TIKI,cross-border-hang-quoc-te,170625759,"Sách - The Beast Awakens by Joseph Delaney (UK edition, paperback)",330000,330000,0,0
TIKI,cross-border-hang-quoc-te,17961602,"Hiroshima",363000,363000,0,0
TIKI,cross-border-hang-quoc-te,11844620,"The Cat In The Hat Dr Seuss Green Back Bk",252000,252000,0,0
TIKI,cross-border-hang-quoc-te,19247056,"Meetings With Remarkable Men",394000,394000,0,0
TIKI,cross-border-hang-quoc-te,170658435,"Sách - How to Teach Your Baby Math : The Gentle Revolution by Glenn Doman (US edition, paperback)",478000,478000,0,0
TIKI,cross-border-hang-quoc-te,170569686,"Sách - The Red Queen: A Novel by Philippa Gregory (US edition, paperback)",304000,304000,0,0
TIKI,cross-border-hang-quoc-te,11845879,"My Weirdest School #8: Mrs. Master Is A Disaster!",252000,252000,0,0
TIKI,cross-border-hang-quoc-te,170679075,"Sách - My Body, My Home : A Radical Guide to Resilience and Belonging by Victoria Emanuela (US edition, paperback)",486000,486000,0,0
TIKI,cross-border-hang-quoc-te,170569091,"Sách - How to Fall in Love with a Man Who Lives in a Bush by Emmy Abrahamson (UK edition, paperback)",373000,373000,0,0
TIKI,cross-border-hang-quoc-te,17963383,"The Mission Song",383000,383000,0,0
TIKI,cross-border-hang-quoc-te,11464845,"Collins Scrabble Dictionary",310000,310000,0,0
TIKI,cross-border-hang-quoc-te,170699174,"Sách - A Week in Winter by Maeve Binchy (US edition, paperback)",361000,361000,0,0
TIKI,cross-border-hang-quoc-te,170723795,"Sách - The Rough Guide to South India and Kerala by Rough Guides (UK edition, paperback)",333000,333000,0,0
TIKI,cross-border-hang-quoc-te,170572026,"Sách - Three Sisters, Three Queens by Philippa Gregory (US edition, paperback)",698000,698000,0,0
TIKI,cross-border-hang-quoc-te,170717827,"Sách - Billy Budd, Bartleby, and Other Stories by Herman Melville (UK edition, paperback)",385000,385000,0,0
TIKI,cross-border-hang-quoc-te,170565056,"Sách - Lands of Lost Borders : A Journey on the Silk Road by Kate Harris (US edition, paperback)",871000,871000,0,0
TIKI,cross-border-hang-quoc-te,17964004,"Top 10 Prague: 2019",307000,307000,0,0
TIKI,cross-border-hang-quoc-te,11407565,"Marvel Vehicles",558000,558000,0,0
TIKI,cross-border-hang-quoc-te,11505685,"Harvard Business Review10 Must Reads: On Emotional Intelligence",639000,639000,0,0
TIKI,cross-border-hang-quoc-te,170621631,"Sách - The Good Hawk (Shadow Skye, Book One) by Joseph Elliott (US edition, hardcover)",893000,893000,0,0
TIKI,cross-border-hang-quoc-te,108599199,"Túi gắn dưới yên xe đạp, dung tích lớn",309000,309000,0,0
TIKI,cross-border-hang-quoc-te,170723787,"Sách - The Rough Guide to Tuscany and Umbria by Rough Guides (UK edition, paperback)",317000,317000,0,0
TIKI,cross-border-hang-quoc-te,11845538,"Make My Day Hong Kong 1",311000,311000,0,0
TIKI,cross-border-hang-quoc-te,11466113,"My Very First Dinosaurs Book",538000,538000,0,0
TIKI,cross-border-hang-quoc-te,11465147,"Greek Myths & Legends: Myths And Stories",406000,406000,0,0
TIKI,cross-border-hang-quoc-te,170707288,"Sách - Insight Guides Travel Map Italy by Insight Guides (UK edition, paperback)",537000,537000,0,0
TIKI,cross-border-hang-quoc-te,179063457,"Sách - Bloom Into You (Light Novel): Regarding Saeki Sayaka Vol. 1 by Hitoma Iruma (US edition, paperback)",540000,540000,0,0
TIKI,cross-border-hang-quoc-te,170723783,"Sách - The Rough Guide to Greece by Rough Guides (UK edition, paperback)",356000,356000,0,0
TIKI,cross-border-hang-quoc-te,171903319,"Sách - Founders (Export) by Jimmy Soni (US edition, paperback)",482000,482000,0,0
TIKI,cross-border-hang-quoc-te,11777118,"Collins Classics: A Portrait Of The Artist As A Young Man",216000,216000,0,0
TIKI,cross-border-hang-quoc-te,11466371,"Gem School Thesaurus Four Vi",151000,151000,0,0
TIKI,cross-border-hang-quoc-te,11862898,"Formula One: Illustrated History",948000,948000,0,0
TIKI,cross-border-hang-quoc-te,17961550,"The Song Of Kieu",371000,371000,0,0
TIKI,cross-border-hang-quoc-te,11712775,"If You Give Cat Cupcake",529000,529000,0,0
TIKI,cross-border-hang-quoc-te,111415231,"Túi đựng cuộn quay cần câu cá JSFUN chất liệu EVA chống nước",161000,161000,0,0
TIKI,cross-border-hang-quoc-te,11505019,"The Murder On The Links",281000,281000,0,0
TIKI,cross-border-hang-quoc-te,170695620,"Sách - Insight Guides Italy by Insight Guides (UK edition, paperback)",942000,942000,0,0
TIKI,cross-border-hang-quoc-te,17966630,"Total Inventor's Manual",910000,910000,0,0
TIKI,cross-border-hang-quoc-te,11471726,"The Bright Hour",483000,483000,0,0
TIKI,cross-border-hang-quoc-te,11845416,"Rough Gde To Italy",921000,921000,0,0
TIKI,cross-border-hang-quoc-te,108599098,"Đèn pin siêu sáng không thấm nước đèn Xe đạp phía trước Đèn pin có thể sạc lại",312000,312000,0,0
TIKI,cross-border-hang-quoc-te,28602451,"The Talent Manifesto: How Disrupting People Strategies Maximizes Business Results",638000,638000,0,0
TIKI,cross-border-hang-quoc-te,11465048,"Collins Primary Math Dictionary",410000,410000,0,0
TIKI,cross-border-hang-quoc-te,170726499,"Sách - Success Is a Choice : Make the Choices that Make You Successful by John C. Maxwell (US edition, hardcover)",426000,426000,0,0
TIKI,cross-border-hang-quoc-te,11625937,"There's A Snake In My School",281000,281000,0,0
TIKI,cross-border-hang-quoc-te,11625883,"Stuck",339000,339000,0,0
TIKI,cross-border-hang-quoc-te,7917831,"Strengths Finder 2.0",709900,709900,0,0
TIKI,cross-border-hang-quoc-te,170725877,"Sách - Powerful : Building a Culture of Freedom and Responsibility by Patty McCord (US edition, paperback)",403000,403000,0,0
TIKI,cross-border-hang-quoc-te,109436700,"Micrô Karaoke không dây TOSING 008 có loa Bluetooth 2 trong 1 cho IOS-Màu Xám",605000,605000,0,0
TIKI,cross-border-hang-quoc-te,170693290,"Sách - Fingerstyle Guitar Method by Chad Johnson (US edition, paperback)",716000,716000,0,0
TIKI,cross-border-hang-quoc-te,11534394,"Seeing Further: The Story of Science and the Royal Society",469000,469000,0,0
TIKI,cross-border-hang-quoc-te,170587945,"Sách - Empowered : Ordinary People, Extraordinary Products by Marty Cagan (US edition, paperback)",883800,982000,98200,10
TIKI,cross-border-hang-quoc-te,146518684,"CINCATDY Tai Nghe Gaming True Wireless Headset Earbuds Headphone Bluetooth V5.0 Phiên Bản Nâng Cấp D17",231000,231000,0,0
TIKI,cross-border-hang-quoc-te,192232102,"Giá Đựng Củi Đốt Bằng Kim Loại Đa Chức Năng Có Thể Gấp Lại Campingmoon",492000,492000,0,0
TIKI,cross-border-hang-quoc-te,111062754,"Ổ cứng thể rắn chống va đập tốc độ cao cho máy tính để bàn KingSpec SATA II SSD 2,5 inch 32 GB MLC SATA",469000,469000,0,0
TIKI,cross-border-hang-quoc-te,170354402,"Tinh Chất Dưỡng Da Chống Lão Hóa Vùng Mắt Estee Lauder Advanced Night Repair Eye Concentrate Matrix 5Ml",590000,590000,0,0
TIKI,cross-border-hang-quoc-te,11844264,"The Way Back Home (Award)",232000,232000,0,0
TIKI,cross-border-hang-quoc-te,108602036,"Cổ xe đạp 25,4mm / 31,8mm có thể điều chỉnh 60 độ-Size 25,4x110mm",326000,326000,0,0
TIKI,cross-border-hang-quoc-te,170601823,"Sách - Color Your Own Captain Marvel by Marvel Comics (US edition, paperback)",407000,407000,0,0
TIKI,cross-border-hang-quoc-te,170726076,"Sách - The Rough Guide to Bangkok by Rough Guides (UK edition, paperback)",252000,252000,0,0
TIKI,cross-border-hang-quoc-te,196176682,"Sách - Love on the Brain by Ali Hazelwood (US edition, paperback)",623000,623000,0,0
TIKI,cross-border-hang-quoc-te,11476902,"The Girl Who Escaped Isis",462000,462000,0,0
TIKI,cross-border-hang-quoc-te,111066043,"Bút kỹ thuật số Huion PEN80 có thể sạc, lập trình cho đồ họa 1060PLUS",530000,530000,0,0
TIKI,cross-border-hang-quoc-te,170568871,"Sách - Phineas and Ferb Reader #2: Perry Speaks! (Phineas and Ferb Reader: World of R by Unknown (US edition, paperback)",326000,326000,0,0
TIKI,cross-border-hang-quoc-te,107904925,"Bộ dụng cụ tập luyện tennis bao gồm một bảng đế và một quả bóng tennis có dây đàn hồi",197000,197000,0,0
TIKI,cross-border-hang-quoc-te,108600254,"Bộ phanh đĩa trước sau cho xe đạp-Size Calip phía sau",224000,224000,0,0
TIKI,cross-border-hang-quoc-te,170721082,"Sách - The Rough Guide to Beijing by Rough Guides (UK edition, paperback)",559000,559000,0,0
TIKI,cross-border-hang-quoc-te,170707346,"Sách - Moleskine Medium Ruled Hardcover Notebook: Black by Unknown (US edition, hardcover)",564000,564000,0,0
TIKI,cross-border-hang-quoc-te,17966098,"World Order",444000,444000,0,0
TIKI,cross-border-hang-quoc-te,108603904,"2 cái Bàn đạp xe đạp bằng hợp kim nhôm chống trượt",365000,365000,0,0
TIKI,cross-border-hang-quoc-te,109165159,"Túi đôi Pannier gắn yên xe đạp bằng Polyester sức chứa lớn 28L chống mài mòn chống nước phản quang-Màu Xám",445000,445000,0,0
TIKI,cross-border-hang-quoc-te,11468184,"My First Word Book",423900,471000,47100,10
TIKI,cross-border-hang-quoc-te,97029798,"WEST BIKING Đèn Xe Đạp 1000 Lumens Đế Xoay 360 Độ",310000,310000,0,0
TIKI,cross-border-hang-quoc-te,17965481,"Winners Take All",409000,409000,0,0
TIKI,cross-border-hang-quoc-te,109434983,"Bộ sạc pin thông minh LIITOKALA LII-PD2  2 khe cắm Độc lập - Phích cắm của UK-Size Vương quốc Anh cắm",354000,354000,0,0
TIKI,cross-border-hang-quoc-te,11778505,"Marvel Comics: Thanos Vol. 2: The God Quarry",506000,506000,0,0
TIKI,cross-border-hang-quoc-te,108601347,"Túi đựng đồ đi xe đạp đơn 15L Pannier , Túi đựng đồ đa chức năng phía sau có sức chứa lớn",458000,458000,0,0
TIKI,cross-border-hang-quoc-te,108599272,"Khóa cáp xe đạp chống trộm an toàn , đa chức năng",219000,219000,0,0
TIKI,cross-border-hang-quoc-te,170724072,"Sách - The Way of the Witch : A path to spirituality and self-empowerment by Sally Morningstar (UK edition, hardcover)",944000,944000,0,0
TIKI,cross-border-hang-quoc-te,111061684,"Bộ chuyển đổi Vention USB sang jack cắm tai nghe 3,5 mm ",237000,237000,0,0
TIKI,cross-border-hang-quoc-te,11385224,"Dc Comics Variant Covers",931000,931000,0,0
TIKI,cross-border-hang-quoc-te,146553901,"CINCATDY Tai Nghe Bluetooth True Wireless TWS MD1588 Phiên Bản Nâng Cấp - Hàng Chính Hãng",285000,285000,0,0
TIKI,cross-border-hang-quoc-te,109164513,"Túi đựng đồ 2 mặt đi xe đạp không thấm nước 30l",568000,568000,0,0
TIKI,cross-border-hang-quoc-te,17968646,"The 24-Hour Wine Expert",245000,245000,0,0
TIKI,cross-border-hang-quoc-te,11448166,"Coaching With NLP",533700,593000,59300,10
TIKI,cross-border-hang-quoc-te,170624703,"Sách - The House in the Cerulean Sea by TJ Klune (US edition, paperback)",565000,565000,0,0
TIKI,cross-border-hang-quoc-te,11708944,"Money Master The Game: 7 Simple Steps To Financial Freedom",368000,368000,0,0
TIKI,cross-border-hang-quoc-te,109435960,"Tai nghe Fineblue F920 âm thanh nổi  Bluetooth 4.0,Cảnh báo rung đa kết nối-Màu trắng",371000,371000,0,0
TIKI,cross-border-hang-quoc-te,18011313,"Science of Selling",748000,748000,0,0
TIKI,cross-border-hang-quoc-te,115298851,"Sách - Blood of Elves by Andrzej Sapkowski - (US Edition, paperback)",375000,375000,0,0
TIKI,cross-border-hang-quoc-te,170605057,"Sách - Hooked : How Leaders Connect, Engage and Inspire with Storytelling by Gabrielle Dolan (US edition, paperback)",529000,529000,0,0
TIKI,cross-border-hang-quoc-te,11777069,"Collins Classics: Persuasion",220000,220000,0,0
TIKI,cross-border-hang-quoc-te,11842316,"Gravity Falls Dipper's And Mabel's Guide To Mystery And Nonstop Fun! (Guide to Life) ",482000,482000,0,0
TIKI,cross-border-hang-quoc-te,111061577,"Ổ đĩa flash USB cổng kép 64GB SanDisk Ultra Dual Drive Go Portable U Disk USB 3.1 Đĩa U Type-C tốc độ cao cho PC điện thoại-Màu đen-Size",319000,319000,0,0
TIKI,cross-border-hang-quoc-te,7917793,"Leonardo Da Vinci",520000,520000,0,0
TIKI,cross-border-hang-quoc-te,170723437,"Sách - The Human Body : A Pop-Up Guide to Anatomy by Richard Walker (UK edition, paperback)",879000,879000,0,0
TIKI,cross-border-hang-quoc-te,108603842,"Mũ bảo hiểm dành cho người lớn và trẻ em, giúp bảo vệ và an toàn cho nhiều môn thể thao như : trượt ván, đi xe máy, xe đạp-Size",325000,325000,0,0
TIKI,cross-border-hang-quoc-te,111415252,"Bộ câu cá trọn gói, Combo đồ dùng câu cá cần câu, cuộn quay, dây câu, mồi câu, lưỡi câu, cần xoay và một số phụ kiện khác cần thiết khi câu cá.-Size 1,8 triệu",753000,753000,0,0
TIKI,cross-border-hang-quoc-te,108602205,"Đồng hồ đo tốc độ xe đạp không dây Màn hình LCD đa chức năng-Màu trắng",355000,355000,0,0
TIKI,cross-border-hang-quoc-te,108598805,"Túi tay lái xe đạp Túi khung xe đạp phía trướt với ngăn trên trong suốt để bản đồ, điện thoại chỉ đường",400000,400000,0,0
TIKI,cross-border-hang-quoc-te,180221614,"Sách - Surrounded by Idiots : The Four Types of Human Behavior and How to Effectively Comm by Thomas Erikson (paperback)",351000,351000,0,0
TIKI,cross-border-hang-quoc-te,108125689,"Chân vịt bơi lặn cho người lớn , có điều chỉnh gót chân",459000,459000,0,0
TIKI,cross-border-hang-quoc-te,109164569,"Túi đựng đồ gắn khung xe đạp WEST BIKING",307000,307000,0,0
TIKI,cross-border-hang-quoc-te,189272117,"Set 2 đèn LED phanh 1157 SMD 5630 chuyên dụng cho ô tô",241500,241500,0,0
TIKI,cross-border-hang-quoc-te,170581728,"Sách - Totto Chan: The Little Girl At The Window by Tetsuko Kuroyanagi (US edition, paperback)",359000,359000,0,0
TIKI,cross-border-hang-quoc-te,17961516,"Start with Why: How Great Leaders Inspire Everyone to Take Action",377000,377000,0,0
TIKI,cross-border-hang-quoc-te,108602117,"Túi Pannier ghế sau xe đạp đa chức năng",317000,317000,0,0
TIKI,cross-border-hang-quoc-te,17968528,"Every Word You Cannot Say",611000,611000,0,0
TIKI,cross-border-hang-quoc-te,17963602,"Sylvia Plath Poems Chosen By Carol Ann Duffy",371000,371000,0,0
TIKI,cross-border-hang-quoc-te,11447776,"Spanish Phrasebook 7",318000,318000,0,0
TIKI,cross-border-hang-quoc-te,112995025,"Đèn LED cho máy ảnh DSLR máy quay phim Mini DVR",444000,444000,0,0
TIKI,cross-border-hang-quoc-te,109436438,"Radio kĩ thuật số Retekess MW / FM / SW Radio âm thanh nổi 9KHz Pocket World Band Điều chỉnh kỹ thuật số Radio Mini DSP",322000,322000,0,0
TIKI,cross-border-hang-quoc-te,164242158,"Sách - How to Eat by Thich Nhat Hanh (US edition, paperback)",306000,306000,0,0
TIKI,cross-border-hang-quoc-te,17961622,"12 Rules for Life: An Antidote to Chaos",458100,509000,50900,10
TIKI,cross-border-hang-quoc-te,170697591,"Sách - The Perks of Being a Wallflower by Stephen Chbosky (UK edition, paperback)",332000,332000,0,0
TIKI,cross-border-hang-quoc-te,108604346,"Túi đựng đồ cho Xe đạp Đạp xe Máy chở hàng 37L",719000,719000,0,0
TIKI,cross-border-hang-quoc-te,170716002,"Sách - Mindful Listening (HBR Emotional Intelligence Series) by Harvard Business Review (US edition, paperback)",446000,446000,0,0
TIKI,cross-border-hang-quoc-te,109435042,"Radio Retekess TR106 FM / AM di động với màn hình LCD ",324000,324000,0,0
TIKI,cross-border-hang-quoc-te,109434912,"Tai nghe KZ Z1 PRO Bluetooth 5.2 TWS  không dây năng động Điều khiển cảm ứng và chống nước",858000,858000,0,0
TIKI,cross-border-hang-quoc-te,170605718,"Sách - Piano Specimen Sight-Reading Tests, Grade 1 by ABRSM (UK edition, paperback)",287000,287000,0,0
TIKI,cross-border-hang-quoc-te,170591847,"Sách - Pop-Up London by Fiona Watt Wesley Robins (UK edition, paperback)",418000,418000,0,0
TIKI,cross-border-hang-quoc-te,11504986,"Mmmm... Salad",580000,580000,0,0
TIKI,cross-border-hang-quoc-te,109164578,"WEST BIKING Máy bơm xe đạp",527000,527000,0,0
TIKI,cross-border-hang-quoc-te,108226720,"Đồng hồ nam mặt vuông Cơ khí bằng thép không gỉ Không thấm nước Mặt số tự động lên dây cót màn hình phát sáng FORSINING -Màu Bạc & Vàng hồng",678000,678000,0,0
TIKI,cross-border-hang-quoc-te,109164940,"Yên xe đạp cao cấp WEST BIKING Thiết kế rỗng, không đè lên đáy quần, siêu nhẹ,có đèn hậu-Màu xanh dương",352000,352000,0,0
TIKI,cross-border-hang-quoc-te,111389358,"Cốc cắm trại 750ml bằng Titan nguyên chất Không độc hại, không nhiễm từ, chịu nhiệt độ cao.-Màu Bạc-Size",631000,631000,0,0
TIKI,cross-border-hang-quoc-te,111415489,"167 lưỡi câu cá và miếng mồi câu cá",275000,275000,0,0
TIKI,cross-border-hang-quoc-te,108603959,"Áo khoác dành cho nam giới có mũ trùm, thoáng khí, chống gió khi đi xe đạp, có phản quang-Màu đen-Size",512000,512000,0,0
TIKI,cross-border-hang-quoc-te,170672023,"Sách - The Little World of Liz Climo: A Magnetic Kit by Liz Climo (US edition, paperback)",356000,356000,0,0
TIKI,cross-border-hang-quoc-te,111065298,"Máy tính bảng vẽ đồ họa kỹ thuật số VEIKK S640 6 * 4 inch và Bút cảm ứng 5080 LPI một chạm ",740000,740000,0,0
TIKI,cross-border-hang-quoc-te,170726283,"Sách - Dune (Movie Tie-In) by Frank Herbert (US edition, paperback)",480000,480000,0,0
TIKI,cross-border-hang-quoc-te,17970195,"Wuthering Heights (Feb 03)",338000,338000,0,0
TIKI,cross-border-hang-quoc-te,108599524,"1 Cặp tay phanh xe đạp được làm bằng hợp kim nhôm cao cấp, bền và mát",199000,199000,0,0
TIKI,cross-border-hang-quoc-te,28601951,"Finance For Non-Financial Managers 2E",610000,610000,0,0
TIKI,cross-border-hang-quoc-te,109165269,"Yên Xe Đạp Bằng Da Pu Gel + Polyurethane Chống Sốc Thoáng Khí Thoải Mái-Màu xanh dương",265000,265000,0,0
TIKI,cross-border-hang-quoc-te,28602239,"Lean Strategy",989000,989000,0,0
TIKI,cross-border-hang-quoc-te,11505574,"Harvard Business Review: 10 Must Reads On Innovation",465000,465000,0,0
TIKI,cross-border-hang-quoc-te,111065958,"Chuột quang dọc không dây Delux 2.4G Công thái học có thể điều chỉnh 1600 DPI Các nút 5D với lòng bàn tay có thể tháo rời",600000,600000,0,0
TIKI,cross-border-hang-quoc-te,108603923,"Mũ bảo hiểm đi xe đạp đúc nguyên khối với kính từ tính có thể tháo rời-Màu trắng",608000,608000,0,0
TIKI,cross-border-hang-quoc-te,170581816,"Sách - The Law of Success : The Master Wealth-Builder's Complete and Original L by Napoleon Hill (US edition, paperback)",967000,967000,0,0
TIKI,cross-border-hang-quoc-te,170582467,"Sách - Wotakoi: Love Is Hard For Otaku 2 by Fujita (US edition, paperback)",552000,552000,0,0
TIKI,cross-border-hang-quoc-te,171426279,"Kem Mắt Estee Lauder Advanced Night Repair Eye Supercharged Complex 3Ml*4",1390000,1390000,0,0
TIKI,cross-border-hang-quoc-te,170625365,"Sách - My Hero Academia, Vol. 1 by Kohei Horikoshi (US edition, paperback)",335000,335000,0,0
TIKI,cross-border-hang-quoc-te,111415575,"Hộp câu cá hai mặt giúp giữ các phụ kiện câu cá ngăn nắp-Màu xanh lá-Size N",169000,169000,0,0
TIKI,cross-border-hang-quoc-te,17967056,"The New Airfryer Cookbook",446000,446000,0,0
TIKI,cross-border-hang-quoc-te,170377477,"Nước Thần Lựu Đỏ Estee Lauder Nutritious Super Pomegranate Radiant Energy Lotion 30Ml",440000,440000,0,0
TIKI,cross-border-hang-quoc-te,17965861,"Communist Manifesto",177000,177000,0,0
TIKI,cross-border-hang-quoc-te,109436681,"Tai nghe Bluetooth không dây Bluetooth 4.0 Đeo Kẹp Rảnh tay Fineblue F-V6-Màu trắng",328000,328000,0,0
TIKI,cross-border-hang-quoc-te,111415625,"Cần câu cá bằng hợp kim Titan siêu nhẹ, bền, hàng chất lượng cao-Size",380000,380000,0,0
TIKI,cross-border-hang-quoc-te,97034225,"Đèn Xe Đạp 250 Lumens 4 Trong 1 Đa Chức Năng Có Còi Giá Đỡ Điện Thoại Pin Dự Phòng Xe Đạp",275000,275000,0,0
TIKI,cross-border-hang-quoc-te,108780908,"Đồng hồ nam Curren dành cho doanh nhân chống nước đa năng-Màu Đen & Đen & Nâu đậm",375000,375000,0,0
TIKI,cross-border-hang-quoc-te,182583593,"Túi đựng xe đạp không thấm nước ROCKBROS Vỏ cứng MTB",259000,259000,0,0
TIKI,cross-border-hang-quoc-te,11708750,"Follow Your Heart: Finding A Purpose In Your Life",628000,628000,0,0
TIKI,cross-border-hang-quoc-te,108603129,"Mũ bảo hiểm đi xe đạp có đèn hậu LED-Màu Xám",621000,621000,0,0
TIKI,cross-border-hang-quoc-te,129730788,"Sách - Nudge: Improving Decisions About Health, Wealth, and Happiness by Richard H. Thaler,Cass R. Sunstein - (US Edition, paperback)",511200,568000,56800,10
TIKI,cross-border-hang-quoc-te,186493907,"Bột Hỗ Trợ Kiểm Soát Cân Nặng, Phân Hủy Chất Béo Cozo Slim Sleek, Chống Phản Ứng Đường Hóa, Giúp Cơ Thể Thải Độc, Da Đẹp Dáng Xinh",1574000,1574000,0,0
TIKI,cross-border-hang-quoc-te,11849785,"101 Top Tips From Profesional Manga Artists",183000,183000,0,0
TIKI,cross-border-hang-quoc-te,170676912,"Sách - Humankind : A Hopeful History by Rutger Bregman (US edition, paperback)",913000,913000,0,0
TIKI,cross-border-hang-quoc-te,170726238,"Sách - Magic of Thinking Big by David Schwartz (US edition, paperback)",511000,511000,0,0
TIKI,cross-border-hang-quoc-te,109164732,"Máy bơm xe đạp di động, ống bơm xe đạp chất lượng cao-Màu đen",584000,584000,0,0
TIKI,cross-border-hang-quoc-te,11471940,"Barking Up The Wrong Tree",498000,498000,0,0
TIKI,cross-border-hang-quoc-te,170719726,"Sách - Oliver Twist by Charles Dickens (UK edition, paperback)",386000,386000,0,0
TIKI,cross-border-hang-quoc-te,171390765,"Kem Chống Lão Hóa Dưỡng Ẩm Estee Lauder Revitalizing Supreme+ Global Anti-Aging Power Soft Creme",2200000,2200000,0,0
TIKI,cross-border-hang-quoc-te,109435781,"Bộ sạc pin LiitoKala Lii-100 cho 1.2V / 3.7V / 3.2V / 3.85V AA / AAA 18350/10440/14500/16340 NiMH Lithium có thể sạc lại",170000,170000,0,0
TIKI,cross-border-hang-quoc-te,17963305,"Leaders Eat Last",758000,758000,0,0
TIKI,cross-border-hang-quoc-te,109435413,"Tai nghe nhét trong tai Mini Smart Bluetooth 5.0 với Mic nhấc tai ghép nối tự động KZ S1 TWS -Màu đen",634000,634000,0,0
TIKI,cross-border-hang-quoc-te,170581581,"Sách - The Book Thief by Markus Zusak (US edition, paperback)",572000,572000,0,0
TIKI,cross-border-hang-quoc-te,17968990,"The Frolic Of The Beasts",358000,358000,0,0
TIKI,cross-border-hang-quoc-te,170684132,"Sách - The Next Person You Meet in Heaven : The Sequel to the Five People You Mee by Mitch Albom (US edition, paperback)",890000,890000,0,0
TIKI,cross-border-hang-quoc-te,109164575,"Túi WEST BIKING gắn khung xe đạp, chất liệu cứng, không thấm nước-Màu đen",323000,323000,0,0
TIKI,cross-border-hang-quoc-te,11465282,"100 Things To Know About The Human Body",522000,522000,0,0
TIKI,cross-border-hang-quoc-te,170715871,"Sách - Asian Godfathers : Money and Power in Hong Kong and Southeast Asia by Joe Studwell (US edition, paperback)",628000,628000,0,0
TIKI,cross-border-hang-quoc-te,108602822,"Giá đỡ điện thoại cho xe đạp bằng nhôm xoay 360 độ Có thể điều chỉnh chống trượt-Màu Titan",267000,267000,0,0
TIKI,cross-border-hang-quoc-te,170610717,"Sách - Wicca and Witchcraft For Dummies by Diane Smith (US edition, paperback)",681000,681000,0,0
TIKI,cross-border-hang-quoc-te,170601876,"Sách - The Miracle of Mindfulness: The Classic Guide to Meditation by the Wor by Thich Nhat Hanh (UK edition, hardcover)",529000,529000,0,0
TIKI,cross-border-hang-quoc-te,170568778,"Sách - What to Expect: Eating Well When You're Expecting by Heidi E Murkoff (US edition, paperback)",678000,678000,0,0
TIKI,cross-border-hang-quoc-te,17963816,"Love And Misadventure",373000,373000,0,0
TIKI,cross-border-hang-quoc-te,108603385,"Trục giữa xe đạp (TRỤC GIỮA BB) 68mm-Size",240000,240000,0,0
TIKI,cross-border-hang-quoc-te,170683054,"Sách - Wild Swans : Three Daughters of China by Jung Chang (UK edition, paperback)",523000,523000,0,0
TIKI,cross-border-hang-quoc-te,111061807,"Đèn cực tím điện cầm tay UVC an toàn cho Văn phòng Khách sạn ",765000,765000,0,0
TIKI,cross-border-hang-quoc-te,108599599,"Bộ Phanh xe đạp địa hình MTB Kích thước vòm: 120mm, kích thước má phanh: 54mm.bằng nhôm cao cấp",215000,215000,0,0
TIKI,cross-border-hang-quoc-te,192230980,"Balo Văn Phòng Chống Nước Chống Trộm Đựng Máy Tính Xách Tay Mark Ryden",927000,927000,0,0
TIKI,cross-border-hang-quoc-te,170578938,"Sách - The Gene: An Intimate History by Siddhartha Mukherjee (US edition, paperback)",913000,913000,0,0
TIKI,cross-border-hang-quoc-te,170722293,"Sách - Attack On Titan 1 by Hajime Isayama (US edition, paperback)",378000,378000,0,0
TIKI,cross-border-hang-quoc-te,108783442,"Đồng hồ Chống nước 3ATM Màn hình kép Double Movements Giờ GMT Đa chức năng SKMEI 1515 Men Quartz-Màu Bạc",359000,359000,0,0
TIKI,cross-border-hang-quoc-te,11471950,"Are You Smart Enough To Work At Google?",270000,270000,0,0
TIKI,cross-border-hang-quoc-te,108603345,"Pô Tăng Xe Đạp 17 Độ, cấu tạo bằng hợp kim nhôm 6061 cho độ bền tốt và trọng lượng nhẹ-Màu đen-Size",237000,237000,0,0
TIKI,cross-border-hang-quoc-te,111389384,"Túi đeo vai đơn MARK RYDEN phong cách mới được làm bằng vải oxford cao cấp, độ dai cao",520000,659000,139000,21
TIKI,cross-border-hang-quoc-te,170625401,"Sách - Writers & Lovers by Lily King (UK edition, paperback)",392000,392000,0,0
TIKI,cross-border-hang-quoc-te,11862229,"Lonely Planet Denmark (Travel Guide)",598000,598000,0,0
TIKI,cross-border-hang-quoc-te,146554083,"CINCATDY Tai Nghe Bluetooth V5.0 Earbuds Gaming Headphone True Wireless Headset K-88 - Hàng Chính Hãng",195000,195000,0,0
TIKI,cross-border-hang-quoc-te,11464741,"Collins Work On Your Vocabulary - Elementary (A1)",445000,445000,0,0
TIKI,cross-border-hang-quoc-te,28601927,"Marketing For Dummies, 5Th Edition",796000,796000,0,0
TIKI,cross-border-hang-quoc-te,170704046,"Sách - Letters from a Stoic by Lucius Seneca (UK edition, paperback)",223000,223000,0,0
TIKI,cross-border-hang-quoc-te,11407622,"Revenge Wears Prada: The Devil Returns",319000,319000,0,0
TIKI,cross-border-hang-quoc-te,108603429,"Líp xe đạp leo núi 9 tốc độ 11-40T",770000,770000,0,0
TIKI,cross-border-hang-quoc-te,170588138,"Sách - The Wizard of Oz: Bath Treasury of Children's Classics by L. Frank Baum (UK edition, paperback)",541000,541000,0,0
TIKI,cross-border-hang-quoc-te,196056834,"Sách - It Happened One Summer - A Novel by Tessa Bailey (US edition, paperback)",383000,383000,0,0
TIKI,cross-border-hang-quoc-te,170682320,"Sách - Morpho by Michel Lauricella (US edition, paperback)",806000,806000,0,0
TIKI,cross-border-hang-quoc-te,182581143,"Máy đo độ căng Xe đạp WEST BIKING hiệu chỉnh độ căng bằng nhôm Hợp kim nhôm để sửa chữa bánh xe đạp",314000,314000,0,0
TIKI,cross-border-hang-quoc-te,109435860,"Bộ sạc pin LiitoKala Lii-500 Bộ sạc thông minh có 4 khe cắm pin Màn hình LCD cho Ni-MH Ni-Cd Li-ion có thể sạc lại-Size Phích cắm của Hoa Kỳ",600000,600000,0,0
TIKI,cross-border-hang-quoc-te,109436157,"FX-Audio D802C PRO Audio Power Amplifier Wireless Bluetooth 4.2 Support APTX NFC USB /AUX/Optical/Coaxial Pure Digital",3534000,3534000,0,0
TIKI,cross-border-hang-quoc-te,170626000,"Sách - One Zentangle A Day : A 6-Week Course in Creative Drawing for Relaxatio by Beckah Krahula (US edition, paperback)",720000,720000,0,0
TIKI,cross-border-hang-quoc-te,11407557,"Destiny: The Official Coloring Book",462000,462000,0,0
TIKI,cross-border-hang-quoc-te,170581903,"Sách - Attack On Titan 29 by Hajime Isayama (US edition, paperback)",356000,356000,0,0
TIKI,cross-border-hang-quoc-te,170693886,"Sách - Love Yourself Like Your Life Depends on It by Kamal Ravikant (US edition, hardcover)",833000,833000,0,0
TIKI,cross-border-hang-quoc-te,174096918,"Nước Hoa Nam Coach New York Fashion Classic Eau De Toilette 4.5Ml",439000,439000,0,0
TIKI,cross-border-hang-quoc-te,108602326,"Túi đựng đồ yên sau xe đạp Pannier bằng vải oxford, chống rách sức chứa lớn có Dải phản quang và đèn cảnh báo",259000,319000,60000,19
TIKI,cross-border-hang-quoc-te,165215268,"Bàn dã ngoại gấp SUNDICK ngoài trời có tụi đựng phía dưới",996000,996000,0,0
TIKI,cross-border-hang-quoc-te,11392447,"Call Of Duty Wwii: Field Manual",678000,678000,0,0
TIKI,cross-border-hang-quoc-te,170671593,"Sách - The CBT Handbook : A comprehensive guide to using Cognitive Behavi by Pamela Myles-Hooton (UK edition, paperback)",736000,736000,0,0
TIKI,cross-border-hang-quoc-te,14054882,"Harvard Business Review's 10 Must Reads On Change Management",569000,569000,0,0
TIKI,cross-border-hang-quoc-te,17966991,"Quiet",394000,394000,0,0
TIKI,cross-border-hang-quoc-te,170581885,"Sách - Fire Force 1 by Atsushi Ohkubo (US edition, paperback)",356000,356000,0,0
TIKI,cross-border-hang-quoc-te,17966462,"Return Of Depression Economics And Crisis Of 2008",363000,363000,0,0
TIKI,cross-border-hang-quoc-te,28601897,"Emotional Intelligence 4 Project Mgrs 2E",643000,643000,0,0
TIKI,cross-border-hang-quoc-te,170590042,"Sách - Emotional Intelligence for Sales Leadership : The Secret to Building H by Colleen Stanley (US edition, paperback)",535000,535000,0,0
TIKI,cross-border-hang-quoc-te,111416562,"Túi đựng cần câu cá 3 ngăn dài 80cm / 90cm chống nước-Size",476000,476000,0,0
TIKI,cross-border-hang-quoc-te,108602746,"Giày đi xe đạp, chạy bộ, chống thấm nước-Size",356000,356000,0,0
TIKI,cross-border-hang-quoc-te,11466013,"Hush Now, Banshee! : A Not-So-Quiet Counting Book",610000,610000,0,0
TIKI,cross-border-hang-quoc-te,109435300,"Bộ sạc pin LiitoKala Lii-500S 18650 4 khe Màn hình LCD cảm ứng cho Pin AA AAA Lithium / NiMH 26650-Size Phích cắm của Hoa Kỳ",723000,723000,0,0
TIKI,cross-border-hang-quoc-te,182586283,"Bộ kẹp phanh đĩa thủy lực HB-875 MTB Phía trước Bộ kẹp phanh sau 22MM Xe đạp leo núi Bộ cần phanh trái phải",993000,993000,0,0
TIKI,cross-border-hang-quoc-te,108598931,"Bộ dụng cụ rửa xe đạp hoàn chỉnh ",455000,455000,0,0
TIKI,cross-border-hang-quoc-te,11504764,"The Halo Effect",361000,361000,0,0
TIKI,cross-border-hang-quoc-te,19253235,"Little Course In Crochet",576000,576000,0,0
TIKI,cross-border-hang-quoc-te,170675156,"Sách - Moleskine Scarlet Red Large Squared Notebook Soft by Moleskine (paperback)",596000,596000,0,0
TIKI,cross-border-hang-quoc-te,10769215,"Dreams: Vintage Minis",337000,337000,0,0
TIKI,cross-border-hang-quoc-te,170661619,"Sách - The Power of Geography : Ten Maps That Reveals the Future of Our World by Tim Marshall (UK edition, paperback)",578000,578000,0,0
TIKI,cross-border-hang-quoc-te,173561185,"Set vợt chơi bóng bàn trẻ em gồm 2 vợt và 4 bóng",735000,735000,0,0
TIKI,cross-border-hang-quoc-te,11505122,"A Game Of Thrones",397000,397000,0,0
TIKI,cross-border-hang-quoc-te,108227034,"Đồng hồ thông minh SENBONO Youth2 Màn hình TFT 1,28 inch BT4.1 IP67 chống thấm nước Nhiệt độ cơ thể / Giấc ngủ / Nhịp tim-Màu Hồng",738000,738000,0,0
TIKI,cross-border-hang-quoc-te,11778515,"Marvel Comics: Black Panther: Panther's Quest",875000,875000,0,0
TIKI,cross-border-hang-quoc-te,170697358,"Sách - The Brown Fairy Book by Andrew Lang (US edition, paperback)",547000,547000,0,0
TIKI,cross-border-hang-quoc-te,11464679,"English For Life: Speaking - Intermediate",783000,783000,0,0
TIKI,cross-border-hang-quoc-te,165215854,"Túi đựng đồ đi xe đạp ROCKBROS Chống thấm nước cho xe đạp đựng đồ phía trước treo khung xe đạp 4,5L cho MTB Road Bike Scooter",303000,303000,0,0
TIKI,cross-border-hang-quoc-te,28601759,"Investing All-In-One For Dummies",964000,964000,0,0
TIKI,cross-border-hang-quoc-te,108604135,"Bàn đạp xe đạp leo núi PROMEND",209000,209000,0,0
TIKI,cross-border-hang-quoc-te,111416095,"Áo ghi lê có khóa cài chắc chắn nhanh khô, tuyệt vời để câu cá, chụp ảnh, đi săn và một số hoạt động ngoài trời khác-Màu Kaki-Size",369000,499000,130000,26
TIKI,cross-border-hang-quoc-te,11385203,"Terry Pratchett's Discworld Coloring Book",462000,462000,0,0
TIKI,cross-border-hang-quoc-te,170600912,"Sách - Wild Swans: Three Daughters of China by Jung Chang (UK edition, paperback)",545000,545000,0,0
TIKI,cross-border-hang-quoc-te,28684387,"The Strategic Storyteller: Content Marketing In The Age Of The Educated Consumer",888000,888000,0,0
TIKI,cross-border-hang-quoc-te,170631491,"Sách - The Successful CFO by Tony Tripodo (hardcover)",837000,837000,0,0
TIKI,cross-border-hang-quoc-te,109269951,"Đồng Hồ Đo Nhịp Tim Đo Huyết Áp 100M Chống Thấm Nước Theo Dõi Hoạt Động Thể Thao - Đen",850000,850000,0,0
TIKI,cross-border-hang-quoc-te,170704853,"Sách - The Night Circus by Erin Morgenstern (US edition, paperback)",624000,624000,0,0
TIKI,cross-border-hang-quoc-te,11862237,"Lonely Planet Philippines (Travel Guide)",793000,793000,0,0
TIKI,cross-border-hang-quoc-te,172632087,"Sách - The Happiness of Pursuit : Find the Quest that will Bring Purpose to  by Chris Guillebeau (UK edition, paperback)",401000,401000,0,0
TIKI,cross-border-hang-quoc-te,107490295,"Hộp đựng túi câu cá di động",344000,344000,0,0
TIKI,cross-border-hang-quoc-te,17966045,"Meek One",173000,173000,0,0
TIKI,cross-border-hang-quoc-te,170661675,"Sách - Tech Deck: Official Guide by Scholastic (US edition, paperback)",504000,504000,0,0
TIKI,cross-border-hang-quoc-te,11777290,"Macbeth",322000,322000,0,0
TIKI,cross-border-hang-quoc-te,179135517,"Sách - Gravity Falls: Lost Legends : 4 All-New Adventures! by Alex Hirsch (US edition, hardcover)",675000,675000,0,0
TIKI,cross-border-hang-quoc-te,168184463,"Đồng Hồ Kỹ Thuật Số 50M Nam North Edge Kim Loại La Bàn Giờ Thế Giới Có Bấm Giờ Chống Nước",724000,724000,0,0
TIKI,cross-border-hang-quoc-te,17968387,"Beautiful Oops! (Pop-Ups, Lift-The-Flaps, Tears, Holes, Overlays And Accordion "Telescope")",565000,565000,0,0
TIKI,cross-border-hang-quoc-te,170600504,"Sách - Do One Thing Every Day That Makes You Happy : A Journal by Robie Rogge Dian G. Smith (US edition, paperback)",431000,431000,0,0
TIKI,cross-border-hang-quoc-te,109434921,"Máy nghe nhạc đa chức năng Bluetooth 4.0,màn hình TFT w / dây buộc tai nghe 3,5 mm",715000,715000,0,0
TIKI,cross-border-hang-quoc-te,18010921,"The Wizard Of Oz (Puffin Graphics Plus)",745000,745000,0,0
TIKI,cross-border-hang-quoc-te,108602071,"Túi đựng đồ gắn trên khung xe đạp, không thấm nước, 0.6 lít-Size 0,3L",209000,209000,0,0
TIKI,cross-border-hang-quoc-te,17964102,"The Classical Music Book",886000,886000,0,0
TIKI,cross-border-hang-quoc-te,11667763,"The Almighty Dollar",941000,941000,0,0
TIKI,cross-border-hang-quoc-te,11544409,"Starcraft Ii: Flashpoint",451000,451000,0,0
TIKI,cross-border-hang-quoc-te,108599029,"Túi đựng hành lý, túi để gắn ghế sau xe đạp, dung tích lớn 17lít, không thấm nước.-Màu đen",880000,880000,0,0
TIKI,cross-border-hang-quoc-te,170687564,"Sách - The Lay of Aotrou and Itroun by J. R. R. Tolkien Verlyn Flieger (UK edition, paperback)",331000,331000,0,0
TIKI,cross-border-hang-quoc-te,116913071,"Sách - Numbers Don&#x27;t Lie : 71 Things You Need to Know About the World by Vaclav Smil - (UK Edition, paperback)",399000,399000,0,0
TIKI,cross-border-hang-quoc-te,11846330,"Lonely Planet'S Best In Travel 19",635000,635000,0,0
TIKI,cross-border-hang-quoc-te,11843991,"The Black Witch #1",541000,541000,0,0
TIKI,cross-border-hang-quoc-te,111063102,"Bộ tua vít JAKEMY JM-8150 5 2 in 1 sửa chữa chuyên nghiệp cho điện thoại di động Máy tính điện tử",274000,274000,0,0
TIKI,cross-border-hang-quoc-te,17965869,"Power Of Your Subconscious Mind Us",355000,355000,0,0
TIKI,cross-border-hang-quoc-te,11777320,"Bourbon",655000,655000,0,0
TIKI,cross-border-hang-quoc-te,109436244,"FX-AUDIO BOX-02 Hi-Fi Mini MM&MC Audio Amplifier for Record Player Home Cinema",1344000,1344000,0,0
TIKI,cross-border-hang-quoc-te,170726503,"Sách - The Secret to Love, Health, and Money : A Masterclass by Rhonda Byrne (UK edition, paperback)",551000,551000,0,0
TIKI,cross-border-hang-quoc-te,108603758,"Bộ chén cổ, ổ bi xe đạp ZTTO CNC ZS44 / ZS56 bằng hợp kim nhôm cao cấp",352000,352000,0,0
TIKI,cross-border-hang-quoc-te,170707273,"Sách - Berlitz Language: Arabic for Your Trip by Berlitz (UK edition, paperback)",407000,407000,0,0
TIKI,cross-border-hang-quoc-te,17968435,"Beyond Good And Evil",421000,421000,0,0
TIKI,cross-border-hang-quoc-te,165217463,"Máy bơm khí ZTTO 300PSI giảm chấn cho xe đạp MTB áp suất cao với thiết bị đo van Schrader & Presta",380000,380000,0,0
TIKI,cross-border-hang-quoc-te,17965619,"Dk Bilingual Visual Dictionary: Japanese English",537000,537000,0,0
TIKI,cross-border-hang-quoc-te,28603488,"Leadership Mind Switch",976000,976000,0,0
TIKI,cross-border-hang-quoc-te,108600686,"Nhông sên dành cho xe đạp-Size 9 tốc độ",388000,388000,0,0
TIKI,cross-border-hang-quoc-te,166419241,"Bộ nạp nước thông minh Tuya 2.5L WiFi cho vật nuôi tuần hoàn tự động Khử trùng, Đài phun nước uống Thân thiện với vật nuôi",747000,747000,0,0
TIKI,cross-border-hang-quoc-te,170722338,"Sách - What To Expect The 1st Year [3rd Edition] by Heidi Murkoff (UK edition, paperback)",899000,899000,0,0
TIKI,cross-border-hang-quoc-te,170605728,"Sách - Violin Exam Pieces 2020-2023, ABRSM Grade 1, Score, Part & CD : Selected from the 202 by  (UK edition, paperback)",580000,580000,0,0
TIKI,cross-border-hang-quoc-te,111416173,"Thiết bị báo động cá cắn câu, đèn LED tăng khả năng quan sát, thuận tiện cho việc câu đêm-Size 1 báo thức",162000,162000,0,0
TIKI,cross-border-hang-quoc-te,11779576,"The Barcelona Inheritance: The Evolution Of Winning Soccer Tactics From Cruyff To Guardiola",638000,638000,0,0
TIKI,cross-border-hang-quoc-te,170632735,"Sách - A Darkest Minds Novel: The Darkest Minds : Book 1 by Alexandra Bracken (UK edition, paperback)",398000,398000,0,0
TIKI,cross-border-hang-quoc-te,11713036,"Pete The Cat: Out Of This World",354000,354000,0,0
TIKI,cross-border-hang-quoc-te,165216005,"Bánh đà Cassette ZTTO Bike thay thế bánh xe đạp 12 tốc độ 11-32T cho xe đạp đường trường MTB",863000,863000,0,0
TIKI,cross-border-hang-quoc-te,11777906,"Baby's Bedtime Storybook",755000,755000,0,0
TIKI,cross-border-hang-quoc-te,11842373,"Alice Through The Looking Glass",715000,715000,0,0
TIKI,cross-border-hang-quoc-te,170718962,"Sách - Ten Little Fingers and Ten Little Toes by Mem Fox (paperback)",961000,961000,0,0
TIKI,cross-border-hang-quoc-te,109436058,"Bộ sạc pin LiitoKala Lii-S6 6 khe cắm 4 dòng điện Tự động phát hiện phân cực cho 18650 26650 21700 32650 Pin AA AAA - Phích cắm của EU-Size Cắm EU",723000,723000,0,0
TIKI,cross-border-hang-quoc-te,170600377,"Sách - Mythology 101 : From Gods and Goddesses to Monsters and Mortals, Your G by Kathleen Sears (US edition, hardcover)",548000,548000,0,0
TIKI,cross-border-hang-quoc-te,170598685,"Sách - Scary Stories to Tell in the Dark : More Scary Stories to Tell in the Dark, Scary S by Alvin Schwartz (paperback)",836000,836000,0,0
TIKI,cross-border-hang-quoc-te,108778687,"Đồng hồ cơ tự động KINYUED dành cho nam giới thiết kế con trỏ dạ quang chống thấm nước",901000,901000,0,0
TIKI,cross-border-hang-quoc-te,109434906,"Bộ thu Wifi không dây MiraScreen E9 HD TV 2.4G DLNA Bộ thu hiển thị không dây Smart TV HD Dongle ",334000,334000,0,0
TIKI,cross-border-hang-quoc-te,170581340,"Sách - HBR's 10 Must Reads on Entrepreneurship and Startups (featuring Bonus Art by Reid Hoffman (US edition, paperback)",629000,629000,0,0
TIKI,cross-border-hang-quoc-te,11779236,"Wine Bar Theory",536000,536000,0,0
TIKI,cross-border-hang-quoc-te,170720816,"Sách - Russian Slanguage by Mike Ellis (US edition, paperback)",375000,375000,0,0
TIKI,cross-border-hang-quoc-te,170699004,"Sách - PAW Patrol: The Movie: Be Brave, Little Pup (PAW Patro by Elle Stephens Fabrizio Petrossi (US edition, hardcover)",254000,254000,0,0
TIKI,cross-border-hang-quoc-te,111389248,"Dây khóa gió Lều cắm trại Đa chức năng 3mm-Màu vàng",184000,184000,0,0
TIKI,cross-border-hang-quoc-te,173561121,"Vợt gỗ PowerTi chơi banh nhựa với độ bám của đệm công thái học cho trong nhà và ngoài trời",750000,750000,0,0
TIKI,cross-border-hang-quoc-te,170623464,"Sách - Comfortable with Uncertainty : 108 Teachings on Cultivating Fearlessness  by Pema Chodron (US edition, paperback)",708000,708000,0,0
TIKI,cross-border-hang-quoc-te,108779817,"Đồng hồ cơ tự động TEVISE dành cho nam bấm giờ đeo tay 30M Chống thấm nước với con trỏ phát sáng theo pha tuần trăng",687000,687000,0,0
TIKI,cross-border-hang-quoc-te,109435711," Loa SADA D-202 kết hợp có dây USB  âm thanh nổi Bass Loa siêu trầm  cho máy tính để bàn",287000,287000,0,0
TIKI,cross-border-hang-quoc-te,111389477,"Đèn chiếu sáng đốt khí ga, chỉ sử dụng ngoài trời để cắm trại dã ngoại",450000,450000,0,0
TIKI,cross-border-hang-quoc-te,11505047,"The Kicking The Bucket List",387000,387000,0,0
TIKI,cross-border-hang-quoc-te,11845999,"Where The Wild Things Are - Award",325000,325000,0,0
TIKI,cross-border-hang-quoc-te,11465002,"Easy Learning Spanish Audio Course",657000,657000,0,0
TIKI,cross-border-hang-quoc-te,112996535,"Bộ Softbox Godox FL-SF6060 với Túi  bằng vải mềm dạng lưới tổ ong sử dụng trong chụp ảnh",723000,723000,0,0
TIKI,cross-border-hang-quoc-te,192231559,"Máy đo tốc độ MTB WEST BIKING Không dây Song ngữ cho xe đạp Đa chức năng Đèn nền toàn màn hình",537000,537000,0,0
TIKI,cross-border-hang-quoc-te,165216507,"Cảm biến tốc độ xe đạp IGPSPORT ANT+ BT5.0 không dây chống nước IPX7",533000,533000,0,0
TIKI,cross-border-hang-quoc-te,11544021,"How To Build A Universe: The Infinite Monkey Cage",392000,392000,0,0
TIKI,cross-border-hang-quoc-te,17966848,"Letters To A Young Poet",176000,176000,0,0
TIKI,cross-border-hang-quoc-te,168185228,"Giá đỡ mở rộng Phụ kiện xe đạp ZTTO làm Khung đỡ chai nước có thể điều chỉnh",374000,374000,0,0
TIKI,cross-border-hang-quoc-te,28601400,"How To Deliver A Ted Talk: Secrets of the World's Most Inspiring Presentations",615000,615000,0,0
TIKI,cross-border-hang-quoc-te,11862227,"Lonely Planet Norway (Travel Guide)",721000,721000,0,0
TIKI,cross-border-hang-quoc-te,192230908,"Túi đựng điện thoại phía trước  WILD MAN dành cho xe đạp EVA với thiết kế hiển thị được màn hình cảm ứng",532000,532000,0,0
TIKI,cross-border-hang-quoc-te,109434862,"Máy nghe nhạc MP3 MP4 Đài FM Máy ghi âm khe cắm thẻ nhớ 3,5 mm Tai nghe Tích hợp Mic Loa RUIZU D11 8GB",786000,786000,0,0
TIKI,cross-border-hang-quoc-te,109435576,"Loa máy tính âm thanh nổi  cho máy tính xách tay để bàn SADA V-118 USB",254000,254000,0,0
TIKI,cross-border-hang-quoc-te,170657178,"Sách - National Geographic Kids Readers: Frogs by Elizabeth Carney National Geographic Kids (US edition, paperback)",298000,298000,0,0
TIKI,cross-border-hang-quoc-te,168190309,"Giá treo ba chân làm bếp lò dã chiến cho cắm trại, picnic Sundick",211000,211000,0,0
TIKI,cross-border-hang-quoc-te,108600011,"Bộ mở rộng đồng hồ bấm giờ IGPSPORT với giá đỡ gắn ngoài mặt trước Tương thích với xe đạp leo núi, xe đường trường 1,8mm",241000,241000,0,0
TIKI,cross-border-hang-quoc-te,192231759,"Đèn LED cảm biến thông minh WEST BIKING USB có thể sạc lại gắn Phanh xe đạp an toàn",274000,274000,0,0
TIKI,cross-border-hang-quoc-te,170707284,"Sách - Insight Guides Iceland (Travel Guide with Free eBook) by Insight Guides (UK edition, paperback)",948000,948000,0,0
TIKI,cross-border-hang-quoc-te,168185027,"Bàn đạp xe đạp RACEWORK  MTB leo núi Vòng bi kín không kép siêu nhẹ SPD 9/16 inch",632000,632000,0,0
TIKI,cross-border-hang-quoc-te,170724515,"Sách - The Death Sculptor : A brilliant serial killer thriller, featuring the un by Chris Carter (UK edition, paperback)",352000,352000,0,0
TIKI,cross-border-hang-quoc-te,168189575,"Giỏ xe đạp đa chức năng phía sau WEST BIKING Chở hành lý đi bằng nhôm hợp kim MTB",812000,812000,0,0
TIKI,cross-border-hang-quoc-te,182586188,"Bàn cắm trại gấp ShineTrip hợp kim nhôm có thể điều chỉnh độ cao với túi đựng cho bãi biển BBQ dã ngoại ngoài trời",963000,963000,0,0
TIKI,cross-border-hang-quoc-te,192232098,"Đồng hồ đo lực căng ZTTO Bike Spoke bằng hợp kim nhôm đểsửa chữa dây, điều chỉnh độ căng dây",418000,418000,0,0
TIKI,cross-border-hang-quoc-te,165215188,"Chuôi tay lái xe đạp ZTTO Hợp kim nhôm MTB cho Xe đạp leo núi",187000,187000,0,0
TIKI,cross-border-hang-quoc-te,11504715,"Harvard Business Review: 10 Must Reads On Managing People",676000,676000,0,0
TIKI,cross-border-hang-quoc-te,170658522,"Sách - First History Encyclopedia : A First Reference Book for Children by DK (UK edition, paperback)",543000,543000,0,0
TIKI,cross-border-hang-quoc-te,7917812,"One Up On Wall Street",454000,454000,0,0
TIKI,cross-border-hang-quoc-te,170621611,"Sách - Peppa Pig and the Family Reunion by Candlewick Press (US edition, hardcover)",518000,518000,0,0
TIKI,cross-border-hang-quoc-te,168185137,"Mũ bảo hiểm đi xe đạp nhẹ thoáng khí thoải mái",528000,528000,0,0
TIKI,cross-border-hang-quoc-te,165217380,"Đèn LED xe đạp WEST BIKING sáng 1300 Lumen sạc USB có thể sạc lại cho xe đạp leo núi MTB an toàn",420000,420000,0,0
TIKI,cross-border-hang-quoc-te,182586100,"Yên xe thoải mái WEST BIKING  Giảm sốc Ghế rộng Đệm với dây đeo phản quang",274000,274000,0,0
TIKI,cross-border-hang-quoc-te,17965415,"Fourth Revolution (Prev Subbed)",463000,463000,0,0
TIKI,cross-border-hang-quoc-te,111415246,"Cần câu cá 1m tháo rời 2 phần bằng titan, sợi thủy tinh siêu nhẹ",455000,455000,0,0
TIKI,cross-border-hang-quoc-te,109164427,"Bọc yên ghế xe đạp WEST BIKING không thấm nước tránh mưa và hư hỏng",96000,96000,0,0
TIKI,cross-border-hang-quoc-te,170698947,"Sách - Elmer by David McKee (UK edition, paperback)",323000,323000,0,0
TIKI,cross-border-hang-quoc-te,170656700,"Sách - National Geographic Kids Readers: Planets by Elizabeth Carney (US edition, paperback)",298000,298000,0,0
TIKI,cross-border-hang-quoc-te,165217909,"Chắn bùn WEST BIKING MTB gấp Mặt trước và phía sau có phản quang Làm nổi bật xe trong đêm tối",188000,188000,0,0
TIKI,cross-border-hang-quoc-te,192232659,"Bơm xe đạp mini WEST BIKING CO2 cho Presta và Schrader",334000,334000,0,0
TIKI,cross-border-hang-quoc-te,170708699,"Sách - Berlitz Pocket Guide Bulgaria (Travel Guide with Dictionary) by Berlitz (UK edition, paperback)",403000,403000,0,0
TIKI,cross-border-hang-quoc-te,17963522,"Things Fall Apart (60Th Anniversary Edition)",815000,815000,0,0
TIKI,cross-border-hang-quoc-te,171134940,"Tinh Chất Dưỡng Da Chống Lão Hóa Vùng Mắt Estee Lauder Advanced Night Repair Eye Concentrate Matrix 5Ml*2",1150000,1150000,0,0
TIKI,cross-border-hang-quoc-te,170706229,"Sách - Crime and Punishment : With selected excerpts from the Notebooks fo by Fyodor Dostoyevsky (UK edition, paperback)",291000,291000,0,0
TIKI,cross-border-hang-quoc-te,182584779,"Dây đeo tay điều chỉnh băng cổ tay cho tập thể thao có dây treo",616000,616000,0,0
TIKI,cross-border-hang-quoc-te,170568735,"Sách - Lonely Planet Poland (Travel Guide) by Lonely Planet,Mark Baker,Marc Di Duca,Tim Richards (US edition, paperback)",918000,918000,0,0
TIKI,cross-border-hang-quoc-te,170675348,"Sách - Beware of the Storybook Wolves by Lauren Child (UK edition, paperback)",344000,344000,0,0
TIKI,cross-border-hang-quoc-te,11392438,"Winning Lotto/Lottery Everyday Player",437000,437000,0,0
TIKI,cross-border-hang-quoc-te,170674737,"Sách - Ten Little Fingers and Ten Little Toes by Mem Fox (US edition, paperback)",540000,540000,0,0
TIKI,cross-border-hang-quoc-te,170578298,"Sách - Lonely Planet Best of Switzerland by Benedict Walker (US edition, paperback)",598000,598000,0,0
TIKI,cross-border-hang-quoc-te,170581828,"Sách - Mindful Games : Sharing Mindfulness and Meditation with Childre by Susan Kaiser Greenland (US edition, paperback)",519000,519000,0,0
TIKI,cross-border-hang-quoc-te,165217697,"Đèn Gấp Di động ShineTrip Cắm trại Hợp kim nhôm để cắm trại ngoài trời",537000,537000,0,0
TIKI,cross-border-hang-quoc-te,170671993,"Sách - Harry Potter Pensieve Memory Set by Running Press (US edition, paperback)",959000,959000,0,0
TIKI,cross-border-hang-quoc-te,11846251,"Insight Guides Explore Iceland",249000,249000,0,0
TIKI,cross-border-hang-quoc-te,109435727,"Tai nghe âm thanh nổi Fineblue RWS-X8 TWS True Wireless Bluetooth 5.0-Màu Bạc",974000,974000,0,0
TIKI,cross-border-hang-quoc-te,11466606,"Pass Key To The Gre (8rh Ed.)",533000,533000,0,0
TIKI,cross-border-hang-quoc-te,165216037,"Đèn hậu cho xe đạp WEST BIKING 5m chiếu sáng từ xa LED báo rẽ MTB cho Đèn xe đạp chống nước USB có thể sạc lại",268000,268000,0,0
TIKI,cross-border-hang-quoc-te,165217142,"Túi bọc bánh xe đạp rhinowalk 29 inch xách tay cho xe đạp leo núi, xe đường trường",402000,402000,0,0
TIKI,cross-border-hang-quoc-te,170719828,"Sách - The 7 Habits of Happy Kids by Sean Covey Stacy Curtis (US edition, hardcover)",769000,769000,0,0
TIKI,cross-border-hang-quoc-te,111415928,"Phụ kiện câu cá nổi 3PCS 12.5cm 10g P10g gồm 3 Màu sắc 5# 7# 9#",93000,93000,0,0
TIKI,cross-border-hang-quoc-te,192231563,"Bàn đạp xe đạp PROMEND bằng hợp kim nhôm siêu nhẹ",216000,216000,0,0
TIKI,cross-border-hang-quoc-te,170599641,"Sách - Black Beauty by Anna Sewell Fiona Hsieh (UK edition, paperback)",283000,283000,0,0
TIKI,cross-border-hang-quoc-te,165215960,"Túi canvas treo tay ghế cắm trại đa dụng dành cho câu cá, cắm trại",211000,211000,0,0
TIKI,cross-border-hang-quoc-te,170687376,"Sách - The 2022 Almanac of Fun : A Year of Puzzles, Fun Facts, Jokes, Crafts, Game by Highlights (US edition, paperback)",620000,620000,0,0
TIKI,cross-border-hang-quoc-te,170703912,"Sách - Will Shortz Presents Sudoku for Your Commute : 200 Challenging Puzzles by Will Shortz (US edition, paperback)",533000,533000,0,0
TIKI,cross-border-hang-quoc-te,111061718,"Ổ đĩa flash Plug & Play Netac U381 64GB Micro USB + USB Double Interface cho điện thoại di động mở rộng bộ nhớ U Disk-Màu Bạc-Size",246000,246000,0,0
TIKI,cross-border-hang-quoc-te,170671969,"Sách - Gudetama: The Talking Lazy Egg by Sanrio Sanrio (US edition, paperback)",333000,333000,0,0
TIKI,cross-border-hang-quoc-te,170624702,"Sách - The Wizard of Oz (Penguin Classics Deluxe Edition) by L. Frank Baum (UK edition, paperback)",569000,569000,0,0
TIKI,cross-border-hang-quoc-te,11845684,"Insight Guides Alaska",870000,870000,0,0
TIKI,cross-border-hang-quoc-te,192232430,"Đèn hậu Cảm biến ánh sáng thông minh WEST BIKING MTB có 7 chế độ Điều chỉnh đường, có thể sạc lại USB",255000,255000,0,0
TIKI,cross-border-hang-quoc-te,170675366,"Sách - Who's Afraid of the Big Bad Book? by Lauren Child (UK edition, paperback)",351000,351000,0,0
TIKI,cross-border-hang-quoc-te,28690200,"Ceo Difference",813000,813000,0,0
TIKI,cross-border-hang-quoc-te,170624284,"Sách - Red Queen : Red Queen Book 1 by Victoria Aveyard (UK edition, paperback)",387000,387000,0,0
TIKI,cross-border-hang-quoc-te,170590821,"Sách - A Crime of Fashion by Carina Axelsson (UK edition, paperback)",385000,385000,0,0
TIKI,cross-border-hang-quoc-te,18011151,"My Dog Laughs",647000,647000,0,0
TIKI,cross-border-hang-quoc-te,170584057,"Sách - The Way to London: A Novel of World War II by Alix Rickloff (US edition, paperback)",598000,598000,0,0
TIKI,cross-border-hang-quoc-te,182585584,"Túi tay lái WILD MAN đỡ điện thoại Màn hình cảm ứng cho Xe đạp  không thấm nước dung tích lớn",314000,314000,0,0
TIKI,cross-border-hang-quoc-te,168184477,"Giá đỡ dụng cụ pha cafe Sundick nhỏ giọt có thể thu gọn bằng thép không gỉ đỡ bộ lọc cà phê có thể gập lại với túi",238000,238000,0,0
TIKI,cross-border-hang-quoc-te,182582647,"Tấm nhôm ShineTrip gắn giá đỡ cho kệ bếp dã ngoại để đi cắm trại, câu cá, picnic",246000,246000,0,0
TIKI,cross-border-hang-quoc-te,182582592,"Máy bơm xe đạp leo núi áp suất cao WEST BIKING 120PSI cầm tay bằng hợp kim nhôm",269000,269000,0,0
TIKI,cross-border-hang-quoc-te,182585887,"Giá đỡ xe đạp ZTTO phía trước chặn xe, Giá đỡ mái cho 5/12/15 / 15x110mm",305000,305000,0,0
TIKI,cross-border-hang-quoc-te,111064492,"Thẻ nhớ SD U3 C10 V30 4K Tốc độ siêu nhanh 95MB / s Chính hãng SanDisk Extreme Pro SDHC-Size",420000,420000,0,0
TIKI,cross-border-hang-quoc-te,19253027,"Billy and The Minpins (Illustrated By Quentin Blake)",274000,274000,0,0
TIKI,cross-border-hang-quoc-te,11846620,"Lobster Is The Best Medicine",392000,392000,0,0
TIKI,cross-border-hang-quoc-te,170682259,"Sách - The Three Kingdoms, Volume 2: The Sleeping Dragon: Volume 2 : The Epic C by Luo Guanzhong (US edition, paperback)",664000,664000,0,0
TIKI,cross-border-hang-quoc-te,168185952,"Thân tay lái ngắn ZTTO 31,8mm 35mm Hợp kim nhôm cho Xe đạp leo núi MTB",316000,316000,0,0
TIKI,cross-border-hang-quoc-te,107905003,"12 cái bóng bàn đầy màu sắc để trang trí, vẽ thủ công",104000,104000,0,0
TIKI,cross-border-hang-quoc-te,11845626,"Insight Guides Sweden",943000,943000,0,0
TIKI,cross-border-hang-quoc-te,168184959,"Túi lưu trữ đồ lặn di động PVC Tcó thể điều chỉnh đeo vai",476000,476000,0,0
TIKI,cross-border-hang-quoc-te,17963747,"The Snowden Files (Film Tie-In) (Prev Subbed)",650000,650000,0,0
TIKI,cross-border-hang-quoc-te,165218205,"Túi rút WEST BIKING đựng chai nước đỡ cốc phản quang treo xe đạp",228000,228000,0,0
TIKI,cross-border-hang-quoc-te,192232222,"Túi chống nước lưu trữ gắn trước chất liệu EVA SHELL cho xe tay ga điện tử E",329000,329000,0,0
TIKI,cross-border-hang-quoc-te,182585962,"Tấm nhôm ShineTrip gắn giá đỡ cho kệ bếp dã ngoại để đi cắm trại, câu cá, picnic",768000,768000,0,0
TIKI,cross-border-hang-quoc-te,192231051,"Bộ bảo vệ chuỗi BB Mount  cho xích xe đạp ZTTO MTB gắn trực tiếp",458000,458000,0,0
TIKI,cross-border-hang-quoc-te,165215628,"Thùng đốt lửa CAMPLEADER tích hợp bằng thép không gỉ để cắm trại ngoài trời kiêm bếp sưởi ấm đêm",995000,995000,0,0
TIKI,cross-border-hang-quoc-te,168184672,"Nồi cắm trại CAMPLEADER dạng treo cho 5-6 người chất liệu Nhôm oxit chống dính nấu ăn dã ngoại Đi bộ đường dài",403000,403000,0,0
TIKI,cross-border-hang-quoc-te,170638674,"Sách - Secret Kingdom: Mermaid Magic : Book 32 by Rosie Banks (UK edition, paperback)",274000,274000,0,0
TIKI,cross-border-hang-quoc-te,192233048,"Gương chiếu hậu WEST BIKING cho xe đạp có thể gập lại 360 ° an toàn",300000,300000,0,0
TIKI,cross-border-hang-quoc-te,146553994,"CINCATDY Tai Nghe Gaming True Wireless Earbuds Headphone Bluetooth V5.0 Phiên Bản Nâng Cấp Headset MD188",266000,266000,0,0
TIKI,cross-border-hang-quoc-te,17966911,"My Lovely Wife",600000,600000,0,0
TIKI,cross-border-hang-quoc-te,170567917,"Sách - The Rough Guide to Scotland - Scotland Travel Guide Book by Rob Humphreys (UK edition, paperback)",736000,736000,0,0
TIKI,cross-border-hang-quoc-te,172206436,"Nước Hoa Hồng Lancome Tonique Confort Toner 125Ml*2",1060000,1060000,0,0
TIKI,cross-border-hang-quoc-te,108490812,"Surrounded by Idiots : The Four Types of Human Behaviour (or, How to Understand Those Who Cannot Be Understood)",338400,376000,37600,10
TIKI,cross-border-hang-quoc-te,28602579,"Disney Way Revised Edition 3E",887000,887000,0,0
TIKI,cross-border-hang-quoc-te,109435147,"TOSING 04 Micrô Karaoke không dây Loa Bluetooth 2 trong 1 Hát & Ghi âm Máy hát KTV di động dành cho - Vàng-Màu Vàng",990000,990000,0,0
TIKI,cross-border-hang-quoc-te,107490591,"Bảng treo bằng gỗ treo tường để tập bám, thiết bị tăng cường lực tay để tập luyện ngón tay và kéo cơ thể lên",877000,877000,0,0
TIKI,cross-border-hang-quoc-te,170583290,"Sách - Gene Machine : The Race to Decipher the Secrets of the Ribosome by Venki Ramakrishnan (US edition, hardcover)",882000,882000,0,0
TIKI,cross-border-hang-quoc-te,111063327," Thẻ Micro SD Class10 U1 A1 V10 TF Hiệu suất cao hành trình của điện thoại Lexar 633x 32GB-Size",154000,154000,0,0
TIKI,cross-border-hang-quoc-te,11845608,"Insight Guides Chile & Easter Island",746000,746000,0,0
TIKI,cross-border-hang-quoc-te,182586227,"Túi treo xe đạp công suất lớn 10L WEST BIKING",652000,652000,0,0
TIKI,cross-border-hang-quoc-te,170650674,"Sách - Splatoon, Vol. 11 by Sankichi Hinodeya (US edition, paperback)",314000,314000,0,0
TIKI,cross-border-hang-quoc-te,182583273,"Túi đôi phía sau xe đạp WEST BIKING 35L Công suất lớn vận chuyển hành lý tiện dụng",601000,601000,0,0
TIKI,cross-border-hang-quoc-te,109441569,"TOMTOP 2 cái Móc kết dính chắc chắn trong suốt bằng nhựa Superglue đỡ phích cắm không thấm nước",87000,87000,0,0
TIKI,cross-border-hang-quoc-te,107904947,"Công cụ sửa lưới cho thẳng AWL điều chỉnh lưới cho quần vợt và cầu lông",250000,250000,0,0
TIKI,cross-border-hang-quoc-te,170715880,"Sách - From an Idea to Nike : How Marketing Made Nike a Global Success by Lowey Bundy Sichol (US edition, paperback)",287000,287000,0,0
TIKI,cross-border-hang-quoc-te,165218188,"Máy đo tốc độ đi xe đạp có dây SunDing Màn hình LCD cho xe đạp leo núi với đèn nền màu xanh lá cây",201000,201000,0,0
TIKI,cross-border-hang-quoc-te,192231031,"Chuông xe đạp Mini WEST BIKING Siêu nhẹ Cảnh báo an toàn gắn tay lái",181000,181000,0,0
TIKI,cross-border-hang-quoc-te,11838991,"The Elder Scrolls V: Skyrim",743000,743000,0,0
TIKI,cross-border-hang-quoc-te,11713270,"The Worst Years of My Life",524000,524000,0,0
TIKI,cross-border-hang-quoc-te,170702934,"Sách - Brown : What Being Brown in the World Today Means (to Everyone) by Kamal Al-Solaylee (US edition, paperback)",476000,476000,0,0
TIKI,cross-border-hang-quoc-te,17964307,"Back Roads California",673000,673000,0,0
TIKI,cross-border-hang-quoc-te,182585705,"Túi trước tay lái WEST BIKING 2L cho Xe điện MTB Xe đạp gấp Khung chùm Pannier không thấm nước",266000,266000,0,0
TIKI,cross-border-hang-quoc-te,168189419,"Băng tay lái xe đạp mềm WEST BIKING độ đàn hồi cao thoáng khí Giảm sốc chống trượt Phụ kiện cho tay lái",185000,185000,0,0
TIKI,cross-border-hang-quoc-te,182585657,"Bàn đạp xe đạp ZTTO hợp kim nhôm phẳng cho MTB Road Bike",622000,622000,0,0
TIKI,cross-border-hang-quoc-te,17967011,"Gene Machine",354000,354000,0,0
TIKI,cross-border-hang-quoc-te,11845764,"Best Of France 1",773000,773000,0,0
TIKI,cross-border-hang-quoc-te,170653909,"Sách - Don't Be Horrid, Henry! : Book 1 by Francesca Simon (UK edition, paperback)",272000,272000,0,0
TIKI,cross-border-hang-quoc-te,165216129,"Túi ghế sau công suất lớn WEST BIKING vận chuyển hành lý tiện lợi",719000,719000,0,0
TIKI,cross-border-hang-quoc-te,192231102,"Công cụ cài đặt phần đầu ZTTO MTB Cúp bấm BB làm giá đỡ sửa chữa xe đạp",416000,416000,0,0
TIKI,cross-border-hang-quoc-te,182582994,"Túi đựng đồ đi xe đạp dung tích lớn 4,5L WEST BIKING treo khung, không thấm nước TPU",266000,266000,0,0
TIKI,cross-border-hang-quoc-te,170577331,"Sách - Lonely Planet Brazil by Lonely Planet (US edition, paperback)",792000,792000,0,0
TIKI,cross-border-hang-quoc-te,11862233,"Lonely Planet Sweden (Travel Guide)",323000,323000,0,0
TIKI,cross-border-hang-quoc-te,192232925,"Giá đỡ xe đạp ZTTO đỡ bánh sau có thể chở hàng hợp kim nhôm cố định",305000,305000,0,0
TIKI,cross-border-hang-quoc-te,111061860," Ổ cứng thể rắn di động SSD EAGET M1 SSD di động Type-C USB 3.1",960000,960000,0,0
TIKI,cross-border-hang-quoc-te,170723696,"Sách - Lonely Planet Russia by Ali Lemer (paperback)",401000,401000,0,0
TIKI,cross-border-hang-quoc-te,165218601,"Yên xe đạp WHEEL UP mềm với sạc USB Đèn hậu cảnh báo, Đệm ghế thoáng khí cho Xe đạp đường trường MTB",345000,345000,0,0
TIKI,cross-border-hang-quoc-te,17964156,"Where To Go When",614000,614000,0,0
TIKI,cross-border-hang-quoc-te,165217527,"Túi xe đạp WEST BIKIN gấp đựng đồ phía trước Chống rơi chống mài mòn",368000,368000,0,0
TIKI,cross-border-hang-quoc-te,192231256,"Túi đựng nước dung tích 10L WEST BIKING để đi xe đạp chạy bộ",444000,444000,0,0
TIKI,cross-border-hang-quoc-te,170577372,"Sách - Lonely Planet Iceland by Alexis Averbuck (US edition, paperback)",961000,961000,0,0
TIKI,cross-border-hang-quoc-te,170601264,"Sách - The Addams Family by Vic Mizzy Lissy Marlin (US edition, hardcover)",600000,600000,0,0
TIKI,cross-border-hang-quoc-te,11715941,"Touchpoints Birth To Three",766000,766000,0,0
TIKI,cross-border-hang-quoc-te,168187350,"Dụng cụ treo ShineTrip Đứng Di Động Làm Giá đỡ Đèn, Kệ Bếp Cho Dã Ngoại & BBQ",998000,998000,0,0
TIKI,cross-border-hang-quoc-te,168185626,"Túi phụ kiện sửa chữa lốp xe đạp mini SAHOO Di động đa chức năng",293000,293000,0,0
TIKI,cross-border-hang-quoc-te,182582951,"Bộ đèn xe đạp WEST BIKING ngoài trời cường độ thấp chiếu sáng mạnh mẽ Thiết kế kính thiên văn",264000,264000,0,0
TIKI,cross-border-hang-quoc-te,165217754,"Công cụ tháo rời ZTTO Xe đạp bằng thép không gỉ cho Xe đạp leo núi Freehubs",184000,184000,0,0
TIKI,cross-border-hang-quoc-te,170581432,"Sách - Build Your Own Website for Beginners by Laura Cowan Anna Wray (UK edition, paperback)",431000,431000,0,0
TIKI,cross-border-hang-quoc-te,182583324,"Túi canvas treo tay ghế cắm trại đa dụng dành cho câu cá, cắm trại",204000,204000,0,0
TIKI,cross-border-hang-quoc-te,192232407,"Khóa xe đạp gấp gọn chống trộm WEST BIKING khóa xích bảo vệ an toàn hạng nặng với 3 chìa khóa cho xe đạp & xe tay ga",430000,430000,0,0
TIKI,cross-border-hang-quoc-te,109435171,"Tai nghe Bluetooth 5.0 TWS Thể thao không dây có micrô ",386000,386000,0,0
TIKI,cross-border-hang-quoc-te,170638632,"Sách - Mr. Lemoncello's 4-Book Boxed Set and Poster by Chris Grabenstein (US edition, paperback)",993000,993000,0,0
TIKI,cross-border-hang-quoc-te,11846332,"Pocket Hamburg",328000,328000,0,0
TIKI,cross-border-hang-quoc-te,107905027,"Túi tote đựng máy tính xách tay cho nữ 14 inch thuận tiện trong chuyến đi công tác du lịch",494000,494000,0,0
TIKI,cross-border-hang-quoc-te,192230506,"Túi yên xe đạp không thấm nước WEST BIKING 10l tiện dụng",508000,508000,0,0
TIKI,cross-border-hang-quoc-te,189596307,"Sách - The Truth about Crypto : A Practical, Easy-To-Understand Guide to Bit.coin, by Ric Edelman (US edition, paperback)",740000,740000,0,0
TIKI,cross-border-hang-quoc-te,192231011,"Công cụ lắp kim điều khiển phanh dầu Xe đạp ZTTO 2 trong 1 lắp ống thủy lực với dao cắt mạnh mẽ",418000,418000,0,0
TIKI,cross-border-hang-quoc-te,17964268,"Dk Eyewitness Travel Guide Greek Islands",690000,690000,0,0
TIKI,cross-border-hang-quoc-te,11846342,"The Rough Guide to the Netherlands",595000,595000,0,0
TIKI,cross-border-hang-quoc-te,168184670,"Bàn đạp xe đạp WEST BIKING siêu nhẹ DU  Hợp kim nhôm chống trượt cho xe leo núi, đường trường",251000,251000,0,0
TIKI,cross-border-hang-quoc-te,111064317,"Thẻ nhớ Netac TF (MicroSD) A1 U1 C10 Máy ghi lưu lượng Giám sát Camera Thẻ lưu trữ điện thoại di động-Màu đỏ-Size",134000,134000,0,0
TIKI,cross-border-hang-quoc-te,11407531,"Purple Hibiscus",339000,339000,0,0
TIKI,cross-border-hang-quoc-te,165216244,"Máy đo tốc độ đi xe đạp có dây Sunding Màn hình LCD cho xe đạp leo núi với đèn nền màu xanh lá cây",200000,200000,0,0
TIKI,cross-border-hang-quoc-te,165217911,"Yên xe đạp rộng & dày WEST BIKING thoải mái Giảm chấn giảm xóc cho xe đạp đường trường MTB đa năng",416000,416000,0,0
TIKI,cross-border-hang-quoc-te,107904979,"Bóng Tennis cao su có dây,trọng lượng nhẹ ,dụng cụ huấn luyện chó",116000,116000,0,0
TIKI,cross-border-hang-quoc-te,170672178,"Sách - The Republic of Plato by Adam Kirsch (US edition, paperback)",719000,719000,0,0
TIKI,cross-border-hang-quoc-te,192230938,"Chuỗi ổn định ZTTO MTB bảo vệ dây xích cho MTB & Xe đạp đường bộ",249000,249000,0,0
TIKI,cross-border-hang-quoc-te,172656438,"Sách - The 65-Storey Treehouse by Andy Griffiths (UK edition, paperback)",348000,348000,0,0
TIKI,cross-border-hang-quoc-te,168185807,"Dụng cụ Sửa lốp xe đạp WEST BIKING kiêm khoan lốp ô tô dùng được cho các loại lốp không săm, không cần dán keo",199000,199000,0,0
TIKI,cross-border-hang-quoc-te,10764269,"Extreme Ownership: Us Seals Lead /H",797000,797000,0,0
TIKI,cross-border-hang-quoc-te,17964264,"All Marketers are Liars: The Underground Classic That Explains How Marketing Really Works",436000,436000,0,0
TIKI,cross-border-hang-quoc-te,146518881,"CINCATDY Tai Nghe Bluetooth V5.0 Earbuds Gaming Headphone True Wireless Headset K-98 - Hàng Chính Hãng",345000,345000,0,0
TIKI,cross-border-hang-quoc-te,17968965,"The Science Of Getting Rich",311400,346000,34600,10
TIKI,cross-border-hang-quoc-te,11544611,"The Ultimate Introduction To NLP: How To Build",526500,585000,58500,10
TIKI,cross-border-hang-quoc-te,173399136,"Máy cạo râu ba lưỡi Philips Máy cạo râu (S2305)",2878000,2878000,0,0
TIKI,cross-border-hang-quoc-te,170578694,"Sách - A Storm of Swords: Part 2 Blood and Gold (Reissue) by George R. R. Martin (UK edition, paperback)",464000,464000,0,0
TIKI,cross-border-hang-quoc-te,189339192,"Sách - Meditations by Marcus Aurelius (US edition, paperback)",213000,213000,0,0
TIKI,cross-border-hang-quoc-te,108600267,"Ba lô đi du lịch, thể thao, cắm trại, đạp xe đạp, nhẹ nhàng, thoáng khí-Màu đỏ",388000,388000,0,0
TIKI,cross-border-hang-quoc-te,11625819,"The Giver",326000,326000,0,0
TIKI,cross-border-hang-quoc-te,17963964,"The Aircraft Book",876000,876000,0,0
TIKI,cross-border-hang-quoc-te,28731803,"Cryptoassets: The Innovative Investor's Guide To Bitcoin And Beyond",961000,961000,0,0
TIKI,cross-border-hang-quoc-te,171327285,"SK-II SKINPOWER AIRY MILKY LTION 15ml*4",3000000,3000000,0,0
TIKI,cross-border-hang-quoc-te,111066948,"Chuột dọc Delux M618mini GX không dây với 3 bánh răng có thể điều chỉnh DPI cho máy tính xách tay",476000,476000,0,0
TIKI,cross-border-hang-quoc-te,108602135,"Túi trước lắp ghi đông xe đạp Pannier chống thấm nước, có thể tháo rời đeo vai-Màu Kaki",269000,269000,0,0
TIKI,cross-border-hang-quoc-te,108602677,"Túi yên xe đạp, MTB Dung tích lớn, bằng vải polyester chống thấm nước",287000,287000,0,0
TIKI,cross-border-hang-quoc-te,170624755,"Sách - The Master Guide to Drawing Anime : How to Draw Original Characters f by Christopher Hart (US edition, paperback)",996000,996000,0,0
TIKI,cross-border-hang-quoc-te,11471930,"Crushing It",843000,843000,0,0
TIKI,cross-border-hang-quoc-te,109165675,"Đồng hồ đo tốc độ WEST BIKING màn hình lớn cho xe đạp 2,8 inch-Màu Loại B-Size Có dây",317000,317000,0,0
TIKI,cross-border-hang-quoc-te,108601368,"Cần số xe đạp chất lượng tốt, được làm từ hợp kim nhôm, độ bền cao-Size 21 tốc độ",279000,279000,0,0
TIKI,cross-border-hang-quoc-te,17963846,"The Universe Of Us",322000,322000,0,0
TIKI,cross-border-hang-quoc-te,17963704,"Milk And Honey",379000,379000,0,0
TIKI,cross-border-hang-quoc-te,170719522,"Sách - A Game of Thrones (Reissue) by George R. R. Martin (UK edition, paperback)",538000,538000,0,0
TIKI,cross-border-hang-quoc-te,115522377,"Sách - Burn After Writing (Pink) by Sharon Jones - (US Edition, paperback)",409000,409000,0,0
TIKI,cross-border-hang-quoc-te,111065952,"Máy tính bảng vẽ đồ họa Huion H430P với 4096 mức độ nhạy áp lực Độ phân giải bút 5080LPI 233PPS",990000,990000,0,0
TIKI,cross-border-hang-quoc-te,170705021,"Sách - Romeo and Juliet by William Shakespeare (US edition, paperback)",187000,187000,0,0
TIKI,cross-border-hang-quoc-te,170624672,"Sách - In Five Years by Rebecca Serle (UK edition, paperback)",357000,357000,0,0
TIKI,cross-border-hang-quoc-te,11407513,"Manual Of The Warrior Of Light",292000,292000,0,0
TIKI,cross-border-hang-quoc-te,17968486,"Sense And Sensibility",352000,352000,0,0
TIKI,cross-border-hang-quoc-te,170706543,"Sách - Llewellyn's 2022 Herbal Almanac : A Practical Guide to Growing, by Llewellyn Publications (US edition, paperback)",491000,491000,0,0
TIKI,cross-border-hang-quoc-te,10732414,"Day Trading 101",556000,556000,0,0
TIKI,cross-border-hang-quoc-te,170601913,"Sách - Into the Wild by Jon Krakauer (UK edition, paperback)",602000,602000,0,0
TIKI,cross-border-hang-quoc-te,170674627,"Sách - When the Body Says No : The Cost of Hidden Stress by Dr Gabor Mate (UK edition, paperback)",362700,403000,40300,10
TIKI,cross-border-hang-quoc-te,170704055,"Sách - Meditations by Marcus Aurelius (UK edition, paperback)",297000,297000,0,0
TIKI,cross-border-hang-quoc-te,108125612,"Mặt nạ có ống thở lặn dưới nước-Màu đỏ",491000,491000,0,0
TIKI,cross-border-hang-quoc-te,111389909,"Túi đeo chéo ngực cao cấp cho nam Mark Ryden",571000,571000,0,0
TIKI,cross-border-hang-quoc-te,108604236,"Quần đùi đi xe đạp cho nam thoáng khí, có đệm-Size",236000,236000,0,0
TIKI,cross-border-hang-quoc-te,97032433,"Phụ Kiện Còi Điện Tử Gắn Tay Lái Cho Xe Đạp",124000,124000,0,0
TIKI,cross-border-hang-quoc-te,170682215,"Sách - Runes for Beginners : Simple Divination and Interpretation by Alexandra Chauran (US edition, paperback)",449000,449000,0,0
TIKI,cross-border-hang-quoc-te,170706554,"Sách - Llewellyn&#x27;s Book of Natural Remedies : Over 400 Ayurvedic, He by Vannoy Gentles Fite (US edition, paperback)",706000,706000,0,0
TIKI,cross-border-hang-quoc-te,189278326,"Đèn pha Halogen Xenon HID H4 12V 35W siêu sáng dùng cho xe hơi",194000,194000,0,0
TIKI,cross-border-hang-quoc-te,113407407,"Sách - Billion Dollar Whale : The Man Who Fooled Wall Street, Hollywood, and the World by Tom Wright Bradley Hope - (US Edition, paperback)",648900,721000,72100,10
TIKI,cross-border-hang-quoc-te,170692779,"Sách - Little Women by Louisa May Alcott (UK edition, hardcover)",612000,612000,0,0
TIKI,cross-border-hang-quoc-te,17963808,"Milk And Honey",594000,594000,0,0
TIKI,cross-border-hang-quoc-te,19253227,"Lolita",593000,593000,0,0
TIKI,cross-border-hang-quoc-te,11843424,"By Your Side",517000,517000,0,0
TIKI,cross-border-hang-quoc-te,170583311,"Sách - Bakemonogatari, Part 2 by Nisioisin (US edition, paperback)",487000,487000,0,0
TIKI,cross-border-hang-quoc-te,111416489,"Dụng cụ loại bỏ lưỡi câu cá với tay cầm bằng nhôm dài 6.8 inch-Màu xanh dương",147000,147000,0,0
TIKI,cross-border-hang-quoc-te,17963766,"The Better Angels Of Our Nature Uk",798000,798000,0,0
TIKI,cross-border-hang-quoc-te,108602535,"Giá đỡ Điện Thoại Trên Xe Máy Bằng hợp kim nhôm chống cướp giật Xoay 360 độ-Màu đỏ-Size Loại 1",186000,186000,0,0
TIKI,cross-border-hang-quoc-te,11464766,"Collins E Learning German Dictionary (7th Ed)",389000,389000,0,0
TIKI,cross-border-hang-quoc-te,57515986,"A Little Life: A Novel",519000,519000,0,0
TIKI,cross-border-hang-quoc-te,28602001,"Mcgraw-Hill Education Math Grade 4, Second Edition",482000,482000,0,0
TIKI,cross-border-hang-quoc-te,170631187,"Sách - Crypto Grenade, A Beginners Guide to Technical Analysis & Understanding Crypto by Leland Schumacher (paperback)",577000,577000,0,0
TIKI,cross-border-hang-quoc-te,10761129,"The Official SAT Subject Tests in Chemistry",678000,678000,0,0
TIKI,cross-border-hang-quoc-te,11778207,"November 9",383000,383000,0,0
TIKI,cross-border-hang-quoc-te,170695748,"Sách - The Red Scrolls of Magic by Cassandra Clare (UK edition, paperback)",369000,369000,0,0
TIKI,cross-border-hang-quoc-te,170706352,"Sách - Pages & Co.: The Book Smugglers by Anna James (US edition, hardcover)",390000,390000,0,0
TIKI,cross-border-hang-quoc-te,11778261,"The Dreamers",550000,550000,0,0
TIKI,cross-border-hang-quoc-te,97029574,"Giá Đỡ Mở Rộng 25mm Cho Ghi Đông Xe Đạp 18-35mm Bằng Hợp Kim Nhôm/Sợi Cacbon - 35mm Handlebar Extension Aluminium Alloy/Carbon Fibre",247000,247000,0,0
TIKI,cross-border-hang-quoc-te,11573205,"The Girl With The Make-Believe Husband",329000,329000,0,0
TIKI,cross-border-hang-quoc-te,17963628,"Ariel (Poetry)",389000,389000,0,0
TIKI,cross-border-hang-quoc-te,108600172,"Mũ bảo hiểm đi xe đạp leo núi CAIRBULL được làm bằng vỏ PC và lớp lót EPS để bảo vệ tối đa cho đầu.22 lỗ thông hơi-Màu xanh dương",680000,680000,0,0
TIKI,cross-border-hang-quoc-te,11625432,"The Festival Of Insignificance",510000,510000,0,0
TIKI,cross-border-hang-quoc-te,111415290,"Hộp đựng đồ câu cá tiện dụng 11 ngăn không thấm nước-Màu Hồng-Size N",185000,185000,0,0
TIKI,cross-border-hang-quoc-te,170706235,"Sách - Pride and Prejudice by Jane Austen (US edition, paperback)",271000,271000,0,0
TIKI,cross-border-hang-quoc-te,170600364,"Sách - Philosophy 101 : From Plato and Socrates to Ethics and Metaphysics, an E by Paul Kleinman (US edition, hardcover)",719000,719000,0,0
TIKI,cross-border-hang-quoc-te,11474712,"Eating Việt Nam",800000,800000,0,0
TIKI,cross-border-hang-quoc-te,108780862,"Đồng hồ điện tử kỹ thuật số siêu mỏng cho nam SKMEI Màn hình kép Unisex 3 Chế độ thời gian Ngày trong tuần Đồng hồ báo thức chống nước 5ATM-Màu đen",239000,239000,0,0
TIKI,cross-border-hang-quoc-te,109165577,"Yên xe đạp Da PU chống thấm nước Rỗng mềm mại chống va đập-Màu xanh dương",302000,302000,0,0
TIKI,cross-border-hang-quoc-te,170695985,"Sách - Love & Gelato by Jenna Evans Welch (paperback)",416000,416000,0,0
TIKI,cross-border-hang-quoc-te,17963746,"The Art Of Happiness At Work",582000,582000,0,0
TIKI,cross-border-hang-quoc-te,10769223,"How To Read Tarot: A Practical Guide",534000,534000,0,0
TIKI,cross-border-hang-quoc-te,170599876,"Sách - You Are a Badass Every Day : How to Keep Your Motivation Strong, Your Vibe by Jen Sincero (UK edition, paperback)",483000,483000,0,0
TIKI,cross-border-hang-quoc-te,129730793,"Sách - Crossing the Chasm, 3rd Edition: Marketing and Selling Disruptive Products to Mainstream Customers (Collins Business Essentials) by Geoffrey A. Moore - (US Edition, paperback)",647000,647000,0,0
TIKI,cross-border-hang-quoc-te,108778154,"Đồng hồ ONOLA Men's Quartz Watch đeo tay đa chức năng thời trang Đồng hồ 3ATM-Màu Hồng & nâu",487000,487000,0,0
TIKI,cross-border-hang-quoc-te,171020999,"Sách - Life of Pi : A Novel by Yann Martel (paperback)",999000,999000,0,0
TIKI,cross-border-hang-quoc-te,108602869,"Tấm chắn bùn siêu mỏng, nhẹ cho xe đạp, được làm bằng nhựa PP chất lượng cao-Màu đen",109000,109000,0,0
TIKI,cross-border-hang-quoc-te,170579069,"Sách - A Dance With Dragons: Part 1 Dreams and Dust by George R. R. Martin (UK edition, paperback)",504000,504000,0,0
TIKI,cross-border-hang-quoc-te,11714512,"Despicable Me 3: Gru's Gadget Guide",334000,334000,0,0
TIKI,cross-border-hang-quoc-te,170716139,"Sách - The Bridgertons : Happily Ever After by Julia Quinn (US edition, paperback)",508000,508000,0,0
TIKI,cross-border-hang-quoc-te,17963734,"Classical Mechanics",376000,376000,0,0
TIKI,cross-border-hang-quoc-te,97033857,"Dây Quấn Ghi Đông Xe Đạp Màu Gradient Chất Liệu PU Hấp Thu Mồ Hôi",305000,305000,0,0
TIKI,cross-border-hang-quoc-te,170578690,"Sách - A Feast for Crows (Reissue) by George R. R. Martin . QIAO ZHI R... (UK edition, paperback)",553000,553000,0,0
TIKI,cross-border-hang-quoc-te,108780436,"Đồng hồ MEGIR Quartz dành cho nam phong cách cổ điển doanh nhân chống thấm nước 3ATM -Màu Bạc đen",475000,475000,0,0
TIKI,cross-border-hang-quoc-te,170706528,"Sách - Amulets and Talismans for Beginners : How to Choose, Make and Use Magi by Richard Webster (US edition, paperback)",522000,522000,0,0
TIKI,cross-border-hang-quoc-te,28602029,"Trading Options For Dummies, 3Rd Edition",971000,971000,0,0
TIKI,cross-border-hang-quoc-te,11505069,"Sparkling Cyanide",363000,363000,0,0
TIKI,cross-border-hang-quoc-te,168186570,"Giá đỡ điện thoại cho xe đạp xe máy Promend Bike STEM hợp kim nhôm xoay 360 ° MTB",298000,298000,0,0
TIKI,cross-border-hang-quoc-te,170693819,"Sách - The Sixth Extinction : An Unnatural History by Elizabeth Kolbert (UK edition, paperback)",476000,476000,0,0
TIKI,cross-border-hang-quoc-te,170626093,"Sách - Johanna Basford 2021 Weekly Coloring Planner Calendar by Johanna Basford (US edition, paperback)",891000,891000,0,0
TIKI,cross-border-hang-quoc-te,170581702,"Sách - The Audacity of Hope : Thoughts on Reclaiming the American Dream by Barack Obama (US edition, paperback)",529000,529000,0,0
TIKI,cross-border-hang-quoc-te,170631224,"Sách - Investing for Growth : How to make money by only buying the best companies by Terry Smith (UK edition, hardcover)",889200,988000,98800,10
TIKI,cross-border-hang-quoc-te,17966362,"Body Politic",192000,192000,0,0
TIKI,cross-border-hang-quoc-te,28601499,"Perfecting Your English Pronunciation",985000,985000,0,0
TIKI,cross-border-hang-quoc-te,170571890,"Sách - Winning by J. Welch (US edition, paperback)",402000,402000,0,0
TIKI,cross-border-hang-quoc-te,131504722,"Xịt Mọc Tóc Dược Liệu Thái Dương - Sao Thái Dương",150000,150000,0,0
TIKI,cross-border-hang-quoc-te,108598965,"Túi ghế sau cho xe đạp, chất liệu PVC chất lượng cao, chống nước, Dung tích lớn lên đến 27L,có sọc phản quang-Màu đen",937000,937000,0,0
TIKI,cross-border-hang-quoc-te,111389264,"Ba lô đi xe đạp Túi chạy bộ ngoài trời túi thể thao siêu nhẹ cho nam nữ-Màu Xám-Size Túi chỉ",448000,448000,0,0
TIKI,cross-border-hang-quoc-te,11471115,"I Am Malala: The Girl Who Stood Up for Education and Was Shot by the Taliban",290000,290000,0,0
TIKI,cross-border-hang-quoc-te,19247073,"The Art Of War",566000,566000,0,0
TIKI,cross-border-hang-quoc-te,170717693,"Sách - Perfect Phrases for Real Estate Agents &amp; Brokers by Dan Hamilton (US edition, paperback)",406000,406000,0,0
TIKI,cross-border-hang-quoc-te,113205846,"Sách - Sapiens/Homo Deus Box Set W/Bonus Material by Yuval Noah Harari - (US Edition, paperback)",599000,599000,0,0
TIKI,cross-border-hang-quoc-te,170673712,"Sách - Practice Makes Perfect: English Conversation, Premium Third Edition by Jean Yates (US edition, paperback)",535000,535000,0,0
TIKI,cross-border-hang-quoc-te,109164198,"Mũ bảo hiểm đi xe đạp không thấm nước, thoáng khí",171000,171000,0,0
TIKI,cross-border-hang-quoc-te,11505396,"The Abc Murders",339000,339000,0,0
TIKI,cross-border-hang-quoc-te,11778231,"Three Sisters, Three Queen",400000,400000,0,0
TIKI,cross-border-hang-quoc-te,28601763,"English Grammar For Dummies 3E",686000,686000,0,0
TIKI,cross-border-hang-quoc-te,111067093,"Bàn phím Hỗn hợp Màu 83 Phím Mini Portable Girls Mofii honey BT-Màu xanh lá",762000,762000,0,0
TIKI,cross-border-hang-quoc-te,11465080,"On Writing",595000,595000,0,0
TIKI,cross-border-hang-quoc-te,170647833,"Sách - Every Last Word by Tamara Ireland Stone (US edition, paperback)",662000,662000,0,0
TIKI,cross-border-hang-quoc-te,111062698," Chuột có dây Dọc có thể sạc lại được 4 3200 DPI chơi game di động tùy chọn cho máy tính xách tay T-20 ",248000,248000,0,0
TIKI,cross-border-hang-quoc-te,11476962,"Change By Design",979000,979000,0,0
TIKI,cross-border-hang-quoc-te,11471016,"Letters To The Lady Upstairs",293000,293000,0,0
TIKI,cross-border-hang-quoc-te,11778247,"Practical Magic",420000,420000,0,0
TIKI,cross-border-hang-quoc-te,108783484,"Đồng hồ SKMEI Quartz Kỹ thuật số,chế độ kép ngày trong tuần,báo thức,đèn nền,chống thấm nước-Màu Vàng đen",283000,283000,0,0
TIKI,cross-border-hang-quoc-te,111061657,"Cần điều khiển trò chơi có thể kéo dài không dây iPega PG-9167 BT 4.0 cho Điện thoại di động Android / PC / Máy tính bảng",715000,715000,0,0
TIKI,cross-border-hang-quoc-te,11409844,"Pagan Magic Of The Northern Tradingtion",502000,502000,0,0
TIKI,cross-border-hang-quoc-te,108603847,"Bàn đạp hợp kim nhôm cho xe đạp leo núi-Màu Bạc",344000,344000,0,0
TIKI,cross-border-hang-quoc-te,17963494,"The Little Drummer Girl",271000,271000,0,0
TIKI,cross-border-hang-quoc-te,11505263,"Fahrenheit 451",339000,339000,0,0
TIKI,cross-border-hang-quoc-te,170583350,"Sách - The Warren Buffett Stock Portfolio : Warren Buffett Stock Picks: Why and  by Mary Buffett (UK edition, paperback)",362000,362000,0,0
TIKI,cross-border-hang-quoc-te,171330314,"SK-II Facial Treatment Clear Lotion 30ml*4",1720000,1720000,0,0
TIKI,cross-border-hang-quoc-te,11839193,"After (Mti)",625000,625000,0,0
TIKI,cross-border-hang-quoc-te,170687378,"Sách - My Big Book of Mazes Bind Up by Kumon Publishing (US edition, paperback)",756000,756000,0,0
TIKI,cross-border-hang-quoc-te,170583035,"Sách - Lost Ocean : An Inky Adventure and Coloring Book for Adults by Johanna Basford (paperback)",561000,561000,0,0
TIKI,cross-border-hang-quoc-te,108599637,"Mũ Bảo Hiểm Đi Xe Đạp Leo Núi Có Đèn -Màu Đen & Titan",623000,623000,0,0
TIKI,cross-border-hang-quoc-te,11855831,"Bobbi Brown Beauty Evolution",800000,800000,0,0
TIKI,cross-border-hang-quoc-te,109435109,"FX-AUDIO TUBE-06 Tube Preamplifier Home Audio Tube 6N3 Pre Amplifier Input PC-USB AUX Bass&Treble Adjustment DC12V/1A",2355600,2355600,0,0
TIKI,cross-border-hang-quoc-te,11708907,"The Magic",555000,555000,0,0
TIKI,cross-border-hang-quoc-te,17967041,"Daisy Jones & The Six",583000,583000,0,0
TIKI,cross-border-hang-quoc-te,17964198,"The Age of Innocence",385000,385000,0,0
TIKI,cross-border-hang-quoc-te,109165116,"WEST BIKING Đồng hồ đo tốc độ xe đạp Màn hình kỹ thuật số lớn với đèn nền chống thấm nước",275000,275000,0,0
TIKI,cross-border-hang-quoc-te,170579007,"Sách - Billion Dollar Whale : the man who fooled Wall Street, Hollyw by Tom Wright Bradley Hope (UK edition, massmarket)",617000,617000,0,0
TIKI,cross-border-hang-quoc-te,108600882,"Túi đựng đồ ghế sau xe đạp 8L, chất liệu vải cao cấp chống nước-Size",508000,508000,0,0
TIKI,cross-border-hang-quoc-te,170693197,"Sách - A Clash of Kings (Reissue) by George R. R. Martin (UK edition, paperback)",577000,577000,0,0
TIKI,cross-border-hang-quoc-te,28602309,"Powerful Conversations",913000,913000,0,0
TIKI,cross-border-hang-quoc-te,11839030,"Ramayana",953000,953000,0,0
TIKI,cross-border-hang-quoc-te,28602183,"Practice Makes Perfect Organic Chemistry",660000,660000,0,0
TIKI,cross-border-hang-quoc-te,170571126,"Sách - A Game of Thrones (A Song of Ice and Fire) by George R. R. Martin (UK edition, paperback)",548000,548000,0,0
TIKI,cross-border-hang-quoc-te,11466232,"Quantum Information For Babies: Baby University",413000,413000,0,0
TIKI,cross-border-hang-quoc-te,97034051,"WEST BIKING Đồng Hồ Xe Đạp Không Dây Chạy Bằng Năng Lượng Mặt Trời Chống Nước",382000,382000,0,0
TIKI,cross-border-hang-quoc-te,10732434,"The Winning Investment Habits of Warren Buffett & George Soros",512000,512000,0,0
TIKI,cross-border-hang-quoc-te,170580626,"Sách - Self Reiki : Tune in to Your Life Force to Achieve Harmony and Balance by Jasmin Harsono (UK edition, hardcover)",431000,431000,0,0
TIKI,cross-border-hang-quoc-te,109017770,"Ví đeo cổ đựng hộ chiếu có ngăn chặn RFID-Màu Hoa hồng đỏ",190000,190000,0,0
TIKI,cross-border-hang-quoc-te,7917858,"Japonisme",397000,397000,0,0
TIKI,cross-border-hang-quoc-te,108602605,"Mũ bảo hiểm đi xe đạp Siêu nhẹ 21 lỗ thoáng khí an toàn cho người đi xe đạp-Màu xanh lá-Size",531000,531000,0,0
TIKI,cross-border-hang-quoc-te,108603436,"Quần short dành cho nam giới đi xe đạp, nhanh khô, thoáng khí-Màu đen-Size",575000,575000,0,0
TIKI,cross-border-hang-quoc-te,11778579,"Closed Casket",462000,462000,0,0
TIKI,cross-border-hang-quoc-te,17970185,"Art Of War",468000,468000,0,0
TIKI,cross-border-hang-quoc-te,17963828,"The Confidence Game: Why We Fall for It . . . Every Time",560000,560000,0,0
TIKI,cross-border-hang-quoc-te,108602651,"Mũ bảo hiểm đi xe đạp, chơi trượt tuyết, thể thao mùa đông đúc dập nguyên khối, có miếng giữ ấm tai-Màu đen",718000,718000,0,0
TIKI,cross-border-hang-quoc-te,170581598,"Sách - Capitalism in America : An Economic History of the Un by Alan Greenspan Adrian Wooldridge (US edition, paperback)",668000,668000,0,0
TIKI,cross-border-hang-quoc-te,111064079,"Túi lưu trữ kỹ thuật số BUBM Di động Dung lượng lớn, hai lớp cho cáp dữ liệu Ngân hàng điện U Disk",300000,300000,0,0
TIKI,cross-border-hang-quoc-te,108601735,"Phanh đĩa thủy lực trước /sau cho xe đạp-Màu đen-Size Đằng trước",544000,544000,0,0
TIKI,cross-border-hang-quoc-te,170579075,"Sách - A Dance With Dragons: Part 2 After the Feast by George R. R. Martin (UK edition, paperback)",469000,469000,0,0
TIKI,cross-border-hang-quoc-te,11663442,"The Infographic Guide To The Bible: The Old Testament: A Visual Reference For Everything You Need To Know",516000,516000,0,0
TIKI,cross-border-hang-quoc-te,11778888,"Happy Summerween!/The Convenience Store... Of Horrors!",386000,386000,0,0
TIKI,cross-border-hang-quoc-te,170725788,"Sách - A Cook's Tour : Global Adventures in Extreme Cuisines by Anthony Bourdain (US edition, paperback)",515000,515000,0,0
TIKI,cross-border-hang-quoc-te,108598769,"Bộ dụng cụ sửa chữa xe đạp đa năng, tiện lợi mang theo mọi nơi",284000,284000,0,0
TIKI,cross-border-hang-quoc-te,109165030,"Gương chiếu hậu xe đạp xoay 360 hình tròn",165000,165000,0,0
TIKI,cross-border-hang-quoc-te,18011355,"Art Of Possibility: Transforming Professional And Personal Life",356000,356000,0,0
TIKI,cross-border-hang-quoc-te,108598786,"Yên Ghế ZTTO dành cho xe đạp độ đàn hồi cao, mềm mại, thiết kế yên rỗng thoáng khí-Màu đỏ",294000,294000,0,0
TIKI,cross-border-hang-quoc-te,108783329,"Đồng hồ cơ tự động TEVISE dành cho nam không thấm nước có mặt số phát sáng-Màu Con trỏ đen và đỏ",780000,780000,0,0
TIKI,cross-border-hang-quoc-te,134299449,"Sách - Paw Patrol Phonics Boxed Set (Paw Patrol) : 12 Step Into Reading Books by Jennifer Liberts - (US Edition, paperback)",425000,425000,0,0
TIKI,cross-border-hang-quoc-te,11505206,"Tolkien Calendar 2018",568000,568000,0,0
TIKI,cross-border-hang-quoc-te,11407536,"Half Of A Yellow Sun",281000,281000,0,0
TIKI,cross-border-hang-quoc-te,28602649,"Mcgraw-Hill Education Sat Subject Test U.S. History, Fifth Edition",330000,330000,0,0
TIKI,cross-border-hang-quoc-te,170675373,"Sách - Master Your Emotions : A Practical Guide to Overcome Negativity and Better Manage by Thibaut Meurisse (paperback)",717000,717000,0,0
TIKI,cross-border-hang-quoc-te,111415446,"Thiết bị dò cá cầm tay LUCKY FF818 với màn hình LCD TN / ANTI-UV.Phạm vi độ sâu 100m",988000,988000,0,0
TIKI,cross-border-hang-quoc-te,109435084,"Chuột không dây Micrô điều khiển từ xa bằng giọng nói,2.4G Con quay hồi chuyển dành cho Android thông minh",481000,481000,0,0
TIKI,cross-border-hang-quoc-te,108602319,"Túi đựng đồ, 50 lít gắn yên sau xe đạp, không thấm nước, có nắp che mưa-Màu Quân đội xanh",928000,928000,0,0
TIKI,cross-border-hang-quoc-te,170600486,"Sách - Daisy Jones and The Six : Winner of the Glass Bell Award for Ficti by TAYLOR JENKINS REID (UK edition, paperback)",726000,726000,0,0
TIKI,cross-border-hang-quoc-te,111061691,"Ổ cứng di động 500GB USB 3.0 Tốc độ cao 5400 vòng / phút chống sốc cho máy tính xách tay PC EAGET G20 2.5 inch-Màu đen-Size",574000,574000,0,0
TIKI,cross-border-hang-quoc-te,170693356,"Sách - Philosophy in 40 ideas: From Aristotle to Zhong by The School of Life (UK edition, hardcover)",413000,413000,0,0
TIKI,cross-border-hang-quoc-te,28731729,"Trillion Dollar Coach",999000,999000,0,0
TIKI,cross-border-hang-quoc-te,170661366,"Sách - Super Easy Amigurumi : Crochet Cute Animals by Mitsuki Hoshi (US edition, paperback)",620000,620000,0,0
TIKI,cross-border-hang-quoc-te,109435422,"Bộ khuếch đại âm thanh kỹ thuật số âm thanh nổi Lepy HiFi 2.1 siêu trầm, công suất BT 45W * 2 + 68W * 1 - Đen - Phích cắm US-Màu đen-Size Phích cắm của Hoa Kỳ",980000,980000,0,0
TIKI,cross-border-hang-quoc-te,118896405,"Sách - Everything Happens for a Reason : And Other Lies I&#x27;ve Loved by Kate Bowler - (US Edition, hardcover)",581000,581000,0,0
TIKI,cross-border-hang-quoc-te,109436056,"Điều khiển từ xa đa phương tiện không dây cho thuyết trình Powerpoint Con trỏ Laser PPT Flip Pen VIBOTON PP-936 2.4G ",181000,181000,0,0
TIKI,cross-border-hang-quoc-te,11477016,"Sell It Like Serhant: How to Sell More, Earn More, and Become the Ultimate Sales Machine",585000,585000,0,0
TIKI,cross-border-hang-quoc-te,170587499,"Sách - Breaking Rockefeller : The Incredible Story of the Ambitious Rivals Who by Peter B. Doran (US edition, paperback)",581000,581000,0,0
TIKI,cross-border-hang-quoc-te,191355490,"Vòng Đeo Tay Thạch Anh Hồng Floral Knots Cùng Thạch Anh Tím Với Phụ Kiện Hạt Charm Nhiều Kiểu Dáng Dễ Thương",967000,967000,0,0
TIKI,cross-border-hang-quoc-te,170693314,"Sách - Harry Potter: Film Vault: Volume 7 : Quidditch and the Triwizard Tournament by Jody Revenson (hardcover)",927000,927000,0,0
TIKI,cross-border-hang-quoc-te,170682724,"Sách - Giraffes Can't Dance by Giles Andreae Guy Parker-Rees (UK edition, paperback)",336000,336000,0,0
TIKI,cross-border-hang-quoc-te,170706607,"Sách - How to Be Good at Science, Technology and Engineering Workbook, Grades 2-5 by Dk (US edition, paperback)",473000,473000,0,0
TIKI,cross-border-hang-quoc-te,171439384,"Nước Dưỡng Da Estee Lauder Micro Essence 50Ml*4",2360000,2360000,0,0
TIKI,cross-border-hang-quoc-te,7917834,"100 Deadly Skills",497000,497000,0,0
TIKI,cross-border-hang-quoc-te,111389880,"Balo đi xe đạp dung tích 10L, vải nylon siêu nhẹ chống thấm nước và chống rách.-Màu quả cam",320000,320000,0,0
TIKI,cross-border-hang-quoc-te,17965591,"Circles Of Hell",176000,176000,0,0
TIKI,cross-border-hang-quoc-te,174400306,"Sách - Worth Dying For : The Power and Politics of Flags by Tim Marshall (UK edition, paperback)",432000,432000,0,0
TIKI,cross-border-hang-quoc-te,11855827,"The Art Of Lettering",702000,702000,0,0
TIKI,cross-border-hang-quoc-te,11777037,"Collins Classics: The Scarlet Letter",202000,202000,0,0
TIKI,cross-border-hang-quoc-te,170707362,"Sách - Dreams from My Father (Adapted for Young Adults) by Barack Obama (US edition, paperback)",544000,544000,0,0
TIKI,cross-border-hang-quoc-te,170650651,"Sách - A White Rose in Bloom Vol. 1 by Asumiko Nakamura (US edition, paperback)",370000,370000,0,0
TIKI,cross-border-hang-quoc-te,28602621,"Mcgraw Hills 500 Sat Reading, Writing And Language Questions To Know By Test Day 2Ed",308000,308000,0,0
TIKI,cross-border-hang-quoc-te,174246085,"Sách - The Little Book of Psychology by DK (UK edition, paperback)",367000,367000,0,0
TIKI,cross-border-hang-quoc-te,17965809,"Thinking, Fast And Slow",538000,538000,0,0
TIKI,cross-border-hang-quoc-te,146518663,"CINCATDY Tai Nghe Gaming True Wireless Earbuds Headphone Bluetooth ME-29",391000,391000,0,0
TIKI,cross-border-hang-quoc-te,17964270,"The Wedding Date",441000,441000,0,0
TIKI,cross-border-hang-quoc-te,11663216,"The Dark Between Stars",589000,589000,0,0
TIKI,cross-border-hang-quoc-te,109435125,"Loa máy tính để bàn SADA D-238 Siêu trầm âm thanh nổi 4D dây 3,5mm USB hỗ trợ 30HZ-15KHZ",560000,560000,0,0
TIKI,cross-border-hang-quoc-te,170720592,"Sách - Harvard Business Review Everyday Emotional Intelligence : Big Ideas by Sydney Finkelstein (US edition, paperback)",845000,845000,0,0
TIKI,cross-border-hang-quoc-te,11849642,"Skill Sharpeners Math & Phonics Fun: Kindergarten",719000,719000,0,0
TIKI,cross-border-hang-quoc-te,111062989,"Túi lưu trữ  phụ kiện kỹ thuật số BUBM Dung lượng lớn chống mài mòn cho Cáp dữ liệu ",180000,180000,0,0
TIKI,cross-border-hang-quoc-te,17968825,"Ernest Hemingway",919000,919000,0,0
TIKI,cross-border-hang-quoc-te,174400182,"Sách - One Last Stop by Casey McQuiston (UK edition, paperback)",349000,349000,0,0
TIKI,cross-border-hang-quoc-te,170602812,"Sách - Shadowplay : Behind the Lines and Under Fire: The Inside Story of Europe' by Tim Marshall (UK edition, paperback)",434000,434000,0,0
TIKI,cross-border-hang-quoc-te,170704990,"Sách - Yoga Anatomy by Leslie Kaminoff (US edition, paperback)",903000,903000,0,0
TIKI,cross-border-hang-quoc-te,170565900,"Sách - Handbuilt Pottery Techniques Revealed: The Secrets of Handbuilding Shown  by Jacqui Atkin (US edition, paperback)",892000,892000,0,0
TIKI,cross-border-hang-quoc-te,11466585,"See Inside Your Body",607000,607000,0,0
TIKI,cross-border-hang-quoc-te,109164004,"Khóa cáp xe đạp WEST BIKING chống trộm-Màu đen-Size Mã 4 chữ số",217000,217000,0,0
TIKI,cross-border-hang-quoc-te,109000092,"No Hard Feelings : Emotions at Work and How They Help Us Succeed",877000,877000,0,0
TIKI,cross-border-hang-quoc-te,108489388,"The Visual MBA : Two Years of Business School Packed into One Priceless Book of Pure Awesomeness",555000,555000,0,0
TIKI,cross-border-hang-quoc-te,170687170,"Sách - So I'm a Spider, So What?, Vol. 9 (light novel) by Tsukasa Kiryu (US edition, paperback)",431000,431000,0,0
TIKI,cross-border-hang-quoc-te,11385019,"Illustrated Fairytales from Hans Christian Anderson",455000,455000,0,0
TIKI,cross-border-hang-quoc-te,28602571,"Upheaval: Turning Points for Nations in Crisis",487000,487000,0,0
TIKI,cross-border-hang-quoc-te,109435427,"FX-AUDIO D502BT Pure Digital Amplifier 2.1 Subwoofer Home HIFI Decoding Amplifier Headphone DAC AMP",2683200,2683200,0,0
TIKI,cross-border-hang-quoc-te,11777221,"Collins Classics: The Return Of Sherlock Holmes",136000,136000,0,0
TIKI,cross-border-hang-quoc-te,108603256,"Bọc giày chống gió giữ nhiệt cho đi xe đạp mùa đông giữ chân khô ráo và ấm áp-Size",390000,390000,0,0
TIKI,cross-border-hang-quoc-te,146554071,"CINCATDY Tai Nghe Bluetooth V5.0 Earbuds Gaming Headphone True Wireless Headset MD128 - Hàng Chính Hãng",285000,285000,0,0
TIKI,cross-border-hang-quoc-te,11504723,"Harvard Business Review: Leading Change",902000,902000,0,0
TIKI,cross-border-hang-quoc-te,113407771,"Sách - The Model Thinker : What You Need to Know to Make Data Work for You by Scott E. Page - (US Edition, paperback)",933000,933000,0,0
TIKI,cross-border-hang-quoc-te,108601176,"Túi xe đạp phía trước, túi giỏ xe đạp Pannier thiết kế ngăn trong chứa màn hình cảm ứng",305000,305000,0,0
TIKI,cross-border-hang-quoc-te,170720827,"Sách - The Monstrumologist by Rick Yancey (paperback)",449000,449000,0,0
TIKI,cross-border-hang-quoc-te,170605732,"Sách - Violin Scales & Arpeggios, ABRSM Grade 5 : from 2012 by ABRSM (UK edition, paperback)",263000,263000,0,0
TIKI,cross-border-hang-quoc-te,170630836,"Sách - What the Heck Is EOS? : A Complete Guide for Employees in Companies Runni by Gino Wickman (US edition, hardcover)",729000,729000,0,0
TIKI,cross-border-hang-quoc-te,11505592,"Design To Grow",349000,349000,0,0
TIKI,cross-border-hang-quoc-te,28602537,"Six Sigma For Managers 2E",620000,620000,0,0
TIKI,cross-border-hang-quoc-te,17968881,"Gandhi: The Years That Changed the World, 1914-1948",615000,615000,0,0
TIKI,cross-border-hang-quoc-te,170605567,"Sách - Piano Exam Pieces 2021 & 2022, ABRSM Grade 5 : Selected from the 2021 & 2022 syl by ABRSM (UK edition, paperback)",371000,371000,0,0
TIKI,cross-border-hang-quoc-te,108598831,"Túi để xe đạp đạp leo núi, được làm bằng chất liệu da PU cao cấp, chịu nước và chống mài mòn, độ bền lâu dài-Màu trắng",255000,255000,0,0
TIKI,cross-border-hang-quoc-te,111063917,"Bàn phím không dây BOW K221 2.4G 96 phím tròn thiết kế tiện dụng di động nhỏ cho IOS / Windows Xanh",534000,534000,0,0
TIKI,cross-border-hang-quoc-te,182581111,"Lưỡi cưa cắm trại với túi lưu trữ để đi picnic, trekking ngoài trời",529000,529000,0,0
TIKI,cross-border-hang-quoc-te,11505525,"The Theoretical Minimum : What You Need to Know to Start Doing Physics",591000,591000,0,0
TIKI,cross-border-hang-quoc-te,17963838,"Quantum Mechanics: The Theoretical Minimum",427000,427000,0,0
TIKI,cross-border-hang-quoc-te,11464930,"Collins Gem German Dict 12Ed.",270000,270000,0,0
TIKI,cross-border-hang-quoc-te,28731797,"Bitcoin For Dummies",573000,573000,0,0
TIKI,cross-border-hang-quoc-te,112993629,"Gậy Selfie Yunteng 2 trong 1 có thể gập lại ",375000,375000,0,0
TIKI,cross-border-hang-quoc-te,11838495,"The Complete Illustrated Guide To Massage",865000,865000,0,0
TIKI,cross-border-hang-quoc-te,111065385,"Chuột không dây HXSJ T24 2.4G Chuột công thái học dọc có đầu thu USB Thay thế cho Máy tính xách tay - Đen-Màu đen",211000,211000,0,0
TIKI,cross-border-hang-quoc-te,170648328,"Sách - So I'm a Spider, So What?, Vol. 8 (light novel) by Okina Baba (US edition, paperback)",429000,429000,0,0
TIKI,cross-border-hang-quoc-te,10757073,"Garden: A Parable",479000,479000,0,0
TIKI,cross-border-hang-quoc-te,17966206,"All Quiet On The Western Front",684000,684000,0,0
TIKI,cross-border-hang-quoc-te,170718924,"Sách - Wild Things by Lonely Planet Kids Fiona Danks Jo Schofield (hardcover)",813000,813000,0,0
TIKI,cross-border-hang-quoc-te,11466228,"Statistical Physics For Babies: Baby University",318000,318000,0,0
TIKI,cross-border-hang-quoc-te,111063419,"Chuột quang di động không dây Delux M618 Plus 2.4G Blue Light với Bộ thu USB 800/1000/1600 DPI 3 cấp độ",696000,696000,0,0
TIKI,cross-border-hang-quoc-te,19253158,"Dk Readers 1: Lego Nexo Knights Stop The Stone Monsters",295000,295000,0,0
TIKI,cross-border-hang-quoc-te,17966308,"Crisis Economics Uk",421000,421000,0,0
TIKI,cross-border-hang-quoc-te,196056863,"Sách - Malibu Rising : A Novel by Taylor Jenkins Reid (US edition, paperback)",340000,340000,0,0
TIKI,cross-border-hang-quoc-te,170581695,"Sách - The Science of Spice : Understand Flavour Connections and Revolut by Dr. Stuart Farrimond (UK edition, hardcover)",997000,997000,0,0
TIKI,cross-border-hang-quoc-te,170725420,"Sách - Rage of the Fallen by Joseph Delaney (US edition, paperback)",399000,399000,0,0
TIKI,cross-border-hang-quoc-te,11849751,"The Enchanted Tarot",318000,318000,0,0
TIKI,cross-border-hang-quoc-te,192231404,"Yên xe đạp WEST BIKING với đèn đuôi LED sạc có thể tháo rời cho xe đạp leo núi và đường trường",260000,260000,0,0
TIKI,cross-border-hang-quoc-te,170583020,"Sách - Gentle Discipline : Using Emotional Connection--Not Punishment--To Raise Confi by Sarah Ockwell-Smith (paperback)",483000,483000,0,0
TIKI,cross-border-hang-quoc-te,11465223,"English Thesaurus",428000,428000,0,0
TIKI,cross-border-hang-quoc-te,170631664,"Sách - Consumption Economics : The New Rules of Tech by Todd Hewlin (UK edition, hardcover)",805000,805000,0,0
TIKI,cross-border-hang-quoc-te,109435574,"Bộ sạc pin Liitokala LII-S4 LCD 4 Khe cắm cho pin 26650 21700 18350 AA AA Lithium NiMH Máy dò phân cực tự động",333000,333000,0,0
TIKI,cross-border-hang-quoc-te,170725820,"Sách - King's Cage by Victoria Aveyard (US edition, paperback)",446000,446000,0,0
TIKI,cross-border-hang-quoc-te,108780406,"Đồng hồ điện tử nam kỹ thuật số SKMEI siêu mỏng chống thấm nước-Màu Bạc",283000,283000,0,0
TIKI,cross-border-hang-quoc-te,170582980,"Sách - Montessori from the Start by Paula Polk Lillard (US edition, paperback)",549000,549000,0,0
TIKI,cross-border-hang-quoc-te,170693115,"Sách - The Lives of Saints: As seen in the Netflix original series, Shadow and by Leigh Bardugo (UK edition, hardcover)",687000,687000,0,0
TIKI,cross-border-hang-quoc-te,170591825,"Sách - Timelines of World History by Various (UK edition, paperback)",860000,860000,0,0
TIKI,cross-border-hang-quoc-te,170601911,"Sách - Civilization : The West and the Rest by Niall Ferguson (UK edition, paperback)",461000,461000,0,0
TIKI,cross-border-hang-quoc-te,170687182,"Sách - Re-educated : How I changed my job, my home, my husband and my hair by Lucy Kellaway (UK edition, hardcover)",627000,627000,0,0
TIKI,cross-border-hang-quoc-te,111061500,"Bộ điều khiển trò chơi Bluetooth IPEGA PG-SW023 Không dây Rung sáu trục Trò chơi thay thế cho N-S-Màu xanh lá",507000,507000,0,0
TIKI,cross-border-hang-quoc-te,170686316,"Sách - Nisekoi: False Love, Vol. 10 by Naoshi Komi (US edition, paperback)",328000,328000,0,0
TIKI,cross-border-hang-quoc-te,11464753,"Work On Your Vocabulary - Advanced (C1)",413000,413000,0,0
TIKI,cross-border-hang-quoc-te,170661833,"Sách - Become a Great Leader & Coach Using NLP by Steve Kay (UK edition, paperback)",389000,389000,0,0
TIKI,cross-border-hang-quoc-te,108784321,"Đồng hồ thạch anh đeo tay mặt số lớn tuyệt vời OULM Nam -Màu đỏ",298000,298000,0,0
TIKI,cross-border-hang-quoc-te,28602321,"Mcgraw-Hill Education Trigonometry Review And Workbook",287000,287000,0,0
TIKI,cross-border-hang-quoc-te,108600887,"Tay lái thẳng Xe đạp bằng Hợp kim nhôm chất lượng cao 780mm-Size",237000,237000,0,0
TIKI,cross-border-hang-quoc-te,252867407,"Vòng Đeo Tay Singapore Đá Mặt Trăng Floral Knots Chất Liệu Vàng Hồng Starry Twin Star",1300000,1300000,0,0
TIKI,cross-border-hang-quoc-te,11534621,"The Mathematics Of Love - Ted",300000,300000,0,0
TIKI,cross-border-hang-quoc-te,170707328,"Sách - 101 Tough Conversations To Have With Employees : A Manager's Guide To Add by Paul Falcone (US edition, paperback)",755000,755000,0,0
TIKI,cross-border-hang-quoc-te,17965905,"Demographic Cliff",635000,635000,0,0
TIKI,cross-border-hang-quoc-te,17965639,"Hindi Bilingual Visual Dictionary (With Audio)",504000,504000,0,0
TIKI,cross-border-hang-quoc-te,11844574,"Cinderella: Best-Loved Classics",902000,902000,0,0
TIKI,cross-border-hang-quoc-te,170600326,"Sách - A Concise Guide to Macroeconomics, Second Edition : What Managers, Execu by David A. Moss (US edition, hardcover)",981000,981000,0,0
TIKI,cross-border-hang-quoc-te,170624060,"Sách - The Death of Common Sense : How Law Is Suffocating America by Philip K Howard (US edition, paperback)",525000,525000,0,0
TIKI,cross-border-hang-quoc-te,28602117,"The Data Driven Leader: A Powerful Approach To Delivering Measurable Business Impact Through People Analytics",785000,785000,0,0
TIKI,cross-border-hang-quoc-te,19247672,"The Communist Manifesto",449000,449000,0,0
TIKI,cross-border-hang-quoc-te,170725973,"Sách - Mind Maps for Kids : Study Skills by Tony Buzan (UK edition, paperback)",596000,596000,0,0
TIKI,cross-border-hang-quoc-te,162113580,"Sách - Not Here to Be Liked by Michelle Quach (hardcover)",637000,637000,0,0
TIKI,cross-border-hang-quoc-te,165215618,"Chén Ăn Dã Ngoại Bằng Thép Không Gỉ Sierra Cup Nhẹ Campingmoon",181000,181000,0,0
TIKI,cross-border-hang-quoc-te,109270351,"Đệm vuông đấm bốc gắn tường luyện tập tiện dụng",255000,255000,0,0
TIKI,cross-border-hang-quoc-te,170709011,"Sách - Final Fantasy Ultimania Archive Volume 3 by Square Enix (paperback)",1155000,1155000,0,0
TIKI,cross-border-hang-quoc-te,170581882,"Sách - That Time I Got Reincarnated As A Slime 1 by Fuse (US edition, paperback)",619000,619000,0,0
TIKI,cross-border-hang-quoc-te,11431209,"The Pilgrimage",452000,452000,0,0
TIKI,cross-border-hang-quoc-te,109436377,"Bộ sạc pin YONII D4 LCD 18650 4 khe cắm cho pin 18650 21700 26650 Lithium AA AAA Nimh",386000,386000,0,0
TIKI,cross-border-hang-quoc-te,170693421,"Sách - Miracles by C. S. Lewis (UK edition, paperback)",391000,391000,0,0
TIKI,cross-border-hang-quoc-te,17965423,"The Penguin Book Of Brexit Cartoons",243000,243000,0,0
TIKI,cross-border-hang-quoc-te,11476855,"Ernest Hemingway",491000,491000,0,0
TIKI,cross-border-hang-quoc-te,11385371,"Destiny Sketchbook",629000,629000,0,0
TIKI,cross-border-hang-quoc-te,170704916,"Sách - A Tale of Sorcery... by Chris Colfer (US edition, hardcover)",689000,689000,0,0
TIKI,cross-border-hang-quoc-te,109165588,"Máy bơm bánh xe đạp mini",344000,344000,0,0
TIKI,cross-border-hang-quoc-te,170680005,"Sách - In the Footsteps of Bodhisattvas : Buddhist Teachings on the Essence by Phakchok Rinpoche (US edition, paperback)",484000,484000,0,0
TIKI,cross-border-hang-quoc-te,192231273,"Mũ Bảo Hiểm Đi Xe Đạp Dành Cho Người Lớn Với Phần Bảo Vệ Cằm Có Thể Tháo Rời Cairbull - Màu Xám",965000,965000,0,0
TIKI,cross-border-hang-quoc-te,17965819,"Moby-Dick",324000,324000,0,0
TIKI,cross-border-hang-quoc-te,111063090,"Chuột quang dọc  Delux USB có dây Ergonomic có thể điều chỉnh 1600 DPI Các nút 5D với phần tựa tay có thể tháo rời",496000,496000,0,0
TIKI,cross-border-hang-quoc-te,170700057,"Sách - Trust Yourself : Stop Overthinking and Channel Your Emotions for Succes by Melody Wilding (US edition, hardcover)",760000,760000,0,0
TIKI,cross-border-hang-quoc-te,108603802,"Mũ bảo hiểm xe đạp nam nữ có Đèn điện tử chiếu sáng phía sau, sạc bằng USB-Màu Titan",660000,660000,0,0
TIKI,cross-border-hang-quoc-te,170715909,"Sách - Curious George Math and Science Readers : 10 Book STEM Reading Program by H. A. Rey (US edition, paperback)",572000,572000,0,0
TIKI,cross-border-hang-quoc-te,170580490,"Sách - Emotional First Aid : Healing Rejection, Guilt, Failure, and Other Eve by Guy Winch Ph.D. (US edition, paperback)",505000,505000,0,0
TIKI,cross-border-hang-quoc-te,174096907,"Nước Hoa Coach New York Floral Flori Eau De Parfum 4.5ml",439000,439000,0,0
TIKI,cross-border-hang-quoc-te,170693123,"Sách - Love & Olives (Export) by Jenna Welch (US edition, paperback)",448000,448000,0,0
TIKI,cross-border-hang-quoc-te,182584152,"Chai nước thể thao Rockbros 750ml BPA vắt xe đạp, đi picnic cắm trại",162000,162000,0,0
TIKI,cross-border-hang-quoc-te,170654654,"Sách - Adult Piano Adventures All-in-One Book 2 : Spiral Bound by Nancy Faber Randall Faber (US edition, paperback)",694000,694000,0,0
TIKI,cross-border-hang-quoc-te,108599558,"Đồng hồ đo tốc độ xe đạp không dây với cảm biến đo nhịp tim chống thấm nước-Size Có dây",327000,327000,0,0
TIKI,cross-border-hang-quoc-te,170673727,"Sách - 100 Easy STEAM Activities : Awesome Hands-On Projects for Aspiring Ar by Andrea Scalzo Yi (US edition, paperback)",693000,693000,0,0
TIKI,cross-border-hang-quoc-te,28602411,"Mcgraw-Hill Education Sat Subject Test Chemistry, Fifth Edition",330000,330000,0,0
TIKI,cross-border-hang-quoc-te,111065886,"Ổ cứng thể rắn bên trong KingDian SSD Giao diện M-SATA3 M200 64GB cho máy tính xách tay",715000,715000,0,0
TIKI,cross-border-hang-quoc-te,196015132,"COXO SOCO SC-Plus Tệp quay kênh rễ nội nha Công cụ nha khoa",410000,410000,0,0
TIKI,cross-border-hang-quoc-te,10764055,"The Life-Changing Magic Of Tidying: A Simple, Effective Way To Banish Clutter Forever /T",456000,456000,0,0
TIKI,cross-border-hang-quoc-te,108602439,"Mũ bảo hiểm dành cho nam gười đi xe đạp leo núi-Màu Đỏ đen",827000,827000,0,0
TIKI,cross-border-hang-quoc-te,17970416,"Educated",680000,680000,0,0
TIKI,cross-border-hang-quoc-te,170582451,"Sách - Danganronpa 2: Ultimate Luck And Hope And Despair Volume 2 by Spike Chunsoft (US edition, paperback)",609000,609000,0,0
TIKI,cross-border-hang-quoc-te,11417957,"Sacred Geometry For Artists, Dreamers And Philosophers",749000,749000,0,0
TIKI,cross-border-hang-quoc-te,11471808,"Secrets Of The Millionaire Mind",187000,187000,0,0
TIKI,cross-border-hang-quoc-te,11845952,"My 1St Icr Pete The Cat'S Groovy Bake Sale",221000,221000,0,0
TIKI,cross-border-hang-quoc-te,170581820,"Sách - The Blooming Of A Lotus by Thich Nhat Hanh (US edition, paperback)",449000,449000,0,0
TIKI,cross-border-hang-quoc-te,17970378,"Me, Myself & Ideas: The Ultimate Guide To Brainstorming Solo",600000,600000,0,0
TIKI,cross-border-hang-quoc-te,109435609,"Bộ Thu Tín Hiệu Wifi Không Dây Xm Mirascreen G4 1080p Hd Tv Cho Android Ios ",404000,404000,0,0
TIKI,cross-border-hang-quoc-te,170692987,"Sách - Klara and the Sun : Longlisted for the Booker Prize 2021 by Kazuo Ishiguro (UK edition, paperback)",595000,595000,0,0
TIKI,cross-border-hang-quoc-te,108599426,"Túi yên xe đạp có phản quang, chống thấm nước",371000,371000,0,0
TIKI,cross-border-hang-quoc-te,179586314,"Sách - Britannica All New Children's Encyclopedia : What We Know & What We  by Christopher Lloyd (UK edition, hardcover)",981000,981000,0,0
TIKI,cross-border-hang-quoc-te,28602175,"Practice Makes Perfect Algebra I Review And Workbook, Second Edition",536000,536000,0,0
TIKI,cross-border-hang-quoc-te,170623416,"Sách - Cryptocurrency Investing For Dummies by Kiana Danial (US edition, paperback)",755000,755000,0,0
TIKI,cross-border-hang-quoc-te,170725962,"Sách - Unshakeable : Your Financial Freedom Playbook by Tony Robbins (US edition, paperback)",517000,517000,0,0
TIKI,cross-border-hang-quoc-te,190081095,"Sách - Tokyo Ueno Station by Yu Miri (UK edition, paperback)",474000,474000,0,0
TIKI,cross-border-hang-quoc-te,11464614,"Collins Gem Spanish Phrasebook",277000,277000,0,0
TIKI,cross-border-hang-quoc-te,179979255,"Sách - The 80/20 Principle : Achieve More with Less: THE NEW 2022 EDITION OF THE by Richard Koch (UK edition, paperback)",704000,704000,0,0
TIKI,cross-border-hang-quoc-te,173479792,"Sách - The Most Important Thing : Uncommon Sense for the Thoughtful Investor by Howard Marks (US edition, hardcover)",999000,999000,0,0
TIKI,cross-border-hang-quoc-te,109164428,"Khẩu trang mặt nạ đeo tai Được làm bằng vải lụa băng, mát và thoáng khí, chống tia cực tím-Màu Xám",194000,194000,0,0
TIKI,cross-border-hang-quoc-te,170715839,"Sách - Little Prince Coloring Book: Beautiful Images for you to Color a by Antoine Saint-Exupéry (US edition, paperback)",758000,758000,0,0
TIKI,cross-border-hang-quoc-te,170661549,"Sách - Alice's Adventures in Wonderland (Illustrated with Interactive Elements) by Lewis Carroll (US edition, hardcover)",948000,948000,0,0
TIKI,cross-border-hang-quoc-te,188214186,"Sách - The Stone Crystals Deck : 78 Crystals to Energize Your Life by Andrew Smart (US edition, paperback)",519000,519000,0,0
TIKI,cross-border-hang-quoc-te,111061721," Chân đế máy tính xách tay có thể điều chỉnh 9 cấp Gấp Di động Không trượt Olmaster HY-AP9001-B -Màu trắng-Size Không có chân đế",414000,414000,0,0
TIKI,cross-border-hang-quoc-te,11838438,"Marvel Comics: Despicable Deadpool Vol 1",632000,632000,0,0
TIKI,cross-border-hang-quoc-te,170687487,"Sách - D&D Character Sheets by Wizards Rpg Team (US edition, paperback)",349000,349000,0,0
TIKI,cross-border-hang-quoc-te,11505714,"Dictionary Of Marketing Terms",678000,678000,0,0
TIKI,cross-border-hang-quoc-te,28602425,"Mcgraw-Hill Education Math Grade 7, Second Edition",518000,518000,0,0
TIKI,cross-border-hang-quoc-te,170624831,"Sách - My First Piano Adventure - Writing Book a by Nancy Faber (US edition, paperback)",295000,295000,0,0
TIKI,cross-border-hang-quoc-te,170658414,"Sách - Playful Designs : Coloring Book by Patty Young (US edition, paperback)",410000,410000,0,0
TIKI,cross-border-hang-quoc-te,170581726,"Sách - White Heat : The Friendship of Emily Dickinson and Thomas Wentworth H by Brenda Wineapple (US edition, paperback)",832000,832000,0,0
TIKI,cross-border-hang-quoc-te,108599657,"Đồng Hồ Đo Tốc Độ Không Dây Kỹ Thuật Số Có Đèn Nền Đa Năng Chống Thấm Nước Cho Xe Đạp-Size Có dây",329000,329000,0,0
TIKI,cross-border-hang-quoc-te,168186555,"Túi messenger cho nam Ozuko đeo vai đơn với khả năng lưu trữ lớn vải fabric",750000,750000,0,0
TIKI,cross-border-hang-quoc-te,28690350,"Business Strategy",361000,361000,0,0
TIKI,cross-border-hang-quoc-te,170693386,"Sách - The Tao of Pooh & The Te of Piglet by Benjamin Hoff (UK edition, paperback)",476000,476000,0,0
TIKI,cross-border-hang-quoc-te,11845867,"Pete The Cat Take-Along Storybook Set",533000,533000,0,0
TIKI,cross-border-hang-quoc-te,17966013,"Plain Words",391000,391000,0,0
TIKI,cross-border-hang-quoc-te,17966811,"The Human Body Book (3Rd Edition)",899000,899000,0,0
TIKI,cross-border-hang-quoc-te,170725835,"Sách - Principles for Success by Ray Dalio (US edition, hardcover)",875000,875000,0,0
TIKI,cross-border-hang-quoc-te,170687504,"Sách - Berserk of Gluttony (Light Novel) Vol. 3 by Isshiki Ichika (US edition, paperback)",467000,467000,0,0
TIKI,cross-border-hang-quoc-te,170600456,"Sách - Boy Swallows Universe by Trent Dalton (UK edition, paperback)",415000,415000,0,0
TIKI,cross-border-hang-quoc-te,170687678,"Sách - Kawaii: How to Draw Really Cute Fantasy Creatures : Draw Your Own Collec by Angela Nguyen (UK edition, paperback)",439000,439000,0,0
TIKI,cross-border-hang-quoc-te,108600251,"Đèn hậu xe đạp Meilan, với cảm biến nhấp nháy phanh thông minh chống nước có thể sạc lại bằng USB",336000,336000,0,0
TIKI,cross-border-hang-quoc-te,11448183,"Predictably Irrational",404000,404000,0,0
TIKI,cross-border-hang-quoc-te,170725291,"Sách - Lean in : Women, Work, and the Will to Lead by Sheryl Sandberg (US edition, paperback)",530000,530000,0,0
TIKI,cross-border-hang-quoc-te,11464801,"Collins Gem Spanish School Dictionary",270000,270000,0,0
TIKI,cross-border-hang-quoc-te,17967017,"The Lady And The Little Fox Fur (Penguin European Writers)",246000,246000,0,0
TIKI,cross-border-hang-quoc-te,146518665,"CINCATDY Tai Nghe Bluetooth V5.0 Earbuds Gaming Headphone True Wireless Headset ME-19T",391000,391000,0,0
TIKI,cross-border-hang-quoc-te,10761133,"Cracking The SAT 2019 Editon",633000,633000,0,0
TIKI,cross-border-hang-quoc-te,170624636,"Sách - Auditing For Dummies by Maire Loughran (US edition, paperback)",701000,701000,0,0
TIKI,cross-border-hang-quoc-te,170356733,"Sữa Dưỡng Da Estee Lauder Revitalizing Supreme+ Global Anti-Aging Power Soft Creme 15Ml",690000,690000,0,0
TIKI,cross-border-hang-quoc-te,11855936,"Game Of Thrones: In Memoriam",604000,604000,0,0
TIKI,cross-border-hang-quoc-te,170625468,"Sách - The Little Book of Big Medical Emergencies : How to Recognize and Respo by Stuart Fischer (US edition, paperback)",559000,559000,0,0
TIKI,cross-border-hang-quoc-te,11505735,"Networking Like A Pro",667000,667000,0,0
TIKI,cross-border-hang-quoc-te,109436402,"Đài Ăng-ten Retekess TR606 Mini Di động kính thiên văn với đầu phát Cassette Radio kỹ thuật số Phát lại loa",581000,581000,0,0
TIKI,cross-border-hang-quoc-te,108601425,"Quần short nam đi xe đạp có đệm thoáng khí-Size",215000,215000,0,0
TIKI,cross-border-hang-quoc-te,170590838,"Sách - Anna and the French Kiss by Stephanie Perkins (UK edition, paperback)",371000,371000,0,0
TIKI,cross-border-hang-quoc-te,170624360,"Sách - The Big Fun Second Grade Workbook by Highlights (US edition, paperback)",654000,654000,0,0
TIKI,cross-border-hang-quoc-te,11625501,"On Cats",731000,731000,0,0
TIKI,cross-border-hang-quoc-te,11505614,"The Industries Of The Future",529000,529000,0,0
TIKI,cross-border-hang-quoc-te,170707377,"Sách - Will by Will Smith Mark Manson (US edition, hardcover)",990000,990000,0,0
TIKI,cross-border-hang-quoc-te,17963339,"The Wimpy Kid Movie Diary",536000,536000,0,0
TIKI,cross-border-hang-quoc-te,170583024,"Sách - What's My Teenager Thinking : Practical Child Psychology for Modern Parents by Tanith Carey (paperback)",699000,699000,0,0
TIKI,cross-border-hang-quoc-te,170599626,"Sách - Second World War by Conrad Mason (UK edition, paperback)",340000,340000,0,0
TIKI,cross-border-hang-quoc-te,28602510,"The Wall Street Mba, Third Edition: Your Personal Crash Course In Corporate Finance",692000,692000,0,0
TIKI,cross-border-hang-quoc-te,111063472,"Ổ cứng thể rắn cho Máy tính PC Máy tính để bàn Máy tính xách tay X-star Bull Shark mSATA SSD 1.8 inch -Size",330000,330000,0,0
TIKI,cross-border-hang-quoc-te,170602856,"Sách - Bullshit Jobs : The Rise of Pointless Work, and What We Can Do About It by David Graeber (UK edition, paperback)",421000,421000,0,0
TIKI,cross-border-hang-quoc-te,170583157,"Sách - HBR Guide to Making Better Decisions by Harvard Business Review (US edition, paperback)",569000,569000,0,0
TIKI,cross-border-hang-quoc-te,171890821,"Nước hoa nữ Nước hoa nữ Salvatore Ferragamo Incanto Shine 5ml",500000,500000,0,0
TIKI,cross-border-hang-quoc-te,11779180,"Cruel Crown: Red Queen Novella",324000,324000,0,0
TIKI,cross-border-hang-quoc-te,114427103,"Máy rửa kính áp tròng-Màu Hồng",319000,319000,0,0
TIKI,cross-border-hang-quoc-te,111063862,"Máy chiếu TRANSJEE  LCD di động mini Hỗ trợ 1080P Thẻ TF Thiết bị USB HiFi Âm thanh nổi HiFi Máy chiếu rạp hát tại nhà-Màu đen-Size Phích cắm của Hoa Kỳ",988000,988000,0,0
TIKI,cross-border-hang-quoc-te,17968449,"The Behavior Gap",722000,722000,0,0
TIKI,cross-border-hang-quoc-te,170579957,"Sách - Pre-Suasion: A Revolutionary Way to Influence and Persuade by Robert Cialdini Ph.D. (US edition, paperback)",586000,586000,0,0
TIKI,cross-border-hang-quoc-te,28731850,"Management Lessons From Mayo Clinic",651000,651000,0,0
TIKI,cross-border-hang-quoc-te,28602185,"How To Simplify Your Life",609000,609000,0,0
TIKI,cross-border-hang-quoc-te,11625407,"The Miniaturist",486000,486000,0,0
TIKI,cross-border-hang-quoc-te,147423040,"Sách - Cat Kid Comic Club 2 by Dav Pilkey - (US Edition, hardcover)",600000,600000,0,0
TIKI,cross-border-hang-quoc-te,170631195,"Sách - Options Trading Crash Course : Advanced Guide to Make Mon-ey with Options Trading in 30 by Mark Elder (paperback)",518000,518000,0,0
TIKI,cross-border-hang-quoc-te,170581765,"Sách - How to Draw: Kawaii : In Simple Steps by Yishan Li (UK edition, paperback)",269000,269000,0,0
TIKI,cross-border-hang-quoc-te,17965736,"Korean Bilingual Visual Dictionary (With Audio)",510000,510000,0,0
TIKI,cross-border-hang-quoc-te,170717823,"Sách - Japanese Tales of Mystery and Imagination by Edogawa Rampo (paperback)",453000,453000,0,0
TIKI,cross-border-hang-quoc-te,97032483,"Mặt Nạ Thể Thao Trùm Kín Mặt Chống Tia Cực Tím Có Nón",206000,206000,0,0
TIKI,cross-border-hang-quoc-te,170590107,"Sách - Microbiology For Dummies by Jennifer Stearns (US edition, paperback)",695000,695000,0,0
