ecommerce,category,original_id,name,price,original_price,discount,discount_rate
TIKI,nha-sach-tiki,58342212,"Set 3 cuốn Moi Moi và những người bạn - Dành cho trẻ từ 0-2 tuổi",75600,117000,41400,35
TIKI,nha-sach-tiki,273536931,"Kinh Doanh Thời Trang - 8 Bước Xây Dựng, Vận Hành Và Phát Triển Shop Quần Áo Của Bạn",155000,199000,44000,22
TIKI,nha-sach-tiki,262837213,"Sách Excel Power Query Và Power Pivot Tự Động Hóa Dữ Liệu Báo Cáo Cơ Bản ĐÀO TẠO TIN HỌC Có Kèm Video Khóa Học",178600,188000,9400,5
TIKI,nha-sach-tiki,271442564,"Sổ planner 52 tuần 2024 SDstationery “Treasure the Journey” gáy lò xo, họa tiết màu pastel trang nhã 14x20.3cm",112000,132000,20000,15
TIKI,nha-sach-tiki,74021317,"Cây Cam Ngọt Của Tôi",77300,108000,30700,28
TIKI,nha-sach-tiki,271061349,"Cách đưa bạn trở thành siêu sao nơi công sở - How to Be the Employee Your Company Can't Live Without",249000,249000,0,0
TIKI,nha-sach-tiki,188940817,"Vị Thần Của Những Quyết Định",56100,79000,22900,29
TIKI,nha-sach-tiki,189643105,"Không Phải Sói Nhưng Cũng Đừng Là Cừu -Tặng kèm bookmark 2 mặt",96800,128000,31200,24
TIKI,nha-sach-tiki,109017985,"Thiên Tài Bên Trái, Kẻ Điên Bên Phải (Tái Bản)",118000,179000,61000,34
TIKI,nha-sach-tiki,26114399,"Nóng Giận Là Bản Năng , Tĩnh Lặng Là Bản Lĩnh",56500,89000,32500,37
TIKI,nha-sach-tiki,135498945,"COMBO EHON SONG NGỮ ANH VIỆT PHIÊN BẢN ĐẶC BIỆT CÓ FILE ÂMTHANH",109000,109000,0,0
TIKI,nha-sach-tiki,166643806,"Bộ Ehon kĩ năng sống Thỏ Bông (song ngữ Việt Anh) 5 quyển -(Quét mã QR file nghe)",79000,79000,0,0
TIKI,nha-sach-tiki,273046888,"Lãnh đạo là ngôn ngữ - Leadership is language",349000,349000,0,0
TIKI,nha-sach-tiki,174301838,"BỘ BOOKMARK 1% TINH HOA",49000,49000,0,0
TIKI,nha-sach-tiki,272412121,"THUẬT LÃNH ĐẠO nơi công sở - How to Manage Problem Employees",249000,249000,0,0
TIKI,nha-sach-tiki,174444163,"Dear, Darling",62900,88000,25100,29
TIKI,nha-sach-tiki,52789367,"Nhà Giả Kim (Tái Bản 2020)",54000,79000,25000,32
TIKI,nha-sach-tiki,113964351,"(Gift)Bút ký khắc tên cao cấp Doanh nhân 006, thép nguyên khối, mực bi đều ở mọi góc nghiêng",450000,450000,0,0
TIKI,nha-sach-tiki,73207240,"Xa Ngoài Kia Nơi Loài Tôm Hát - Where The Crawdads Sing",105000,165000,60000,36
TIKI,nha-sach-tiki,272530379,"Bộ sách trở thành “ÁT CHỦ BÀI” công sở (Gồm 2 cuốn)",498000,498000,0,0
TIKI,nha-sach-tiki,271960042,"Xoay chuyển con tàu - Turn the Ship Around",299000,299000,0,0
TIKI,nha-sach-tiki,69764541,"Tâm Lý Học Hành Vi (Tặng Kèm 1 Bookmark )",70100,98000,27900,28
TIKI,nha-sach-tiki,147920903,"Một Thoáng Ta Rực Rỡ Ở Nhân Gian",100000,135000,35000,26
TIKI,nha-sach-tiki,121635154,"Điều Đẹp Nhất Có Khi Là Buông Tay (Tặng Kèm Bookmark)",51000,72000,21000,29
TIKI,nha-sach-tiki,108259024,"Combo Sách Osho - Đàn Ông + Đàn Bà + Ươm Mầm",299500,299500,0,0
TIKI,nha-sach-tiki,73787185,"Những Tù Nhân Của Địa Lý",139000,210000,71000,34
TIKI,nha-sach-tiki,195801653,"Chú Thuật Hồi Chiến - Tập 6 - Bản Tặng Kèm Obi Và Thẻ Bo Góc Nhựa",30000,30000,0,0
TIKI,nha-sach-tiki,46240929,"Rèn Luyện Tư Duy Phản Biện",68000,99000,31000,31
TIKI,nha-sach-tiki,3954355,"Yêu Những Điều Không Hoàn Hảo",99500,139000,39500,28
TIKI,nha-sach-tiki,72882553,"Kỷ Luật Tự Giác (Tặng Kèm Bookmark )",58500,84000,25500,30
TIKI,nha-sach-tiki,42230121,"Sách Hiểu Về Trái Tim (Tái Bản 2019) - Minh Niệm",128000,158000,30000,19
TIKI,nha-sach-tiki,117254517,"Đại Dương Đen - Những Câu Chuyện Từ Thế Giới Của Trầm Cảm",186000,240000,54000,23
TIKI,nha-sach-tiki,8885999,"Totto - Chan Bên Cửa Sổ (Tái Bản)",67000,98000,31000,32
TIKI,nha-sach-tiki,68585576,"Càng Kỷ Luật, Càng Tự Do",79100,109000,29900,27
TIKI,nha-sach-tiki,143217512,"Điềm Tĩnh Và Nóng Giận",69600,96000,26400,28
TIKI,nha-sach-tiki,196515658,"Blue Period - Tập 04",43100,48000,4900,10
TIKI,nha-sach-tiki,216102104,"Bóng nhựa Arylic trong suốt đường kính 35 cm",1500000,1500000,0,0
TIKI,nha-sach-tiki,145288029,"Xứ Cát",186000,249000,63000,25
TIKI,nha-sach-tiki,216102826,"Bóng nhựa Arylic trong suốt đường kính 60 cm",6500000,6500000,0,0
TIKI,nha-sach-tiki,195969664,"Tokyo Revengers - Tập 4",37000,115000,78000,68
TIKI,nha-sach-tiki,157432544,"Giải Thích Ngữ Pháp Tiếng Anh (Với Bài Tập Và Đáp Án) (Tái Bản)",142000,220000,78000,35
TIKI,nha-sach-tiki,190861557,"Yêu Những Ngày Nắng Chẳng Ghét Những Ngày Mưa",106000,132000,26000,20
TIKI,nha-sach-tiki,117238177,"Thư Viện Nửa Đêm",115000,150000,35000,23
TIKI,nha-sach-tiki,111285062,"Đắc Nhân Tâm (Bìa Mềm)(Tái Bản)",62300,86000,23700,28
TIKI,nha-sach-tiki,97594364,"Luật Tâm Thức - Giải Mã Ma Trận Vũ Trụ",226000,292000,66000,23
TIKI,nha-sach-tiki,197719874,"Suy Nghĩ Thống Kê Trong Đời Thường",105000,160000,55000,34
TIKI,nha-sach-tiki,72459686,"How Psychology Works - Hiểu Hết Về Tâm Lý Học",225000,300000,75000,25
TIKI,nha-sach-tiki,193151000,"Trend Following – Cách thức để kiếm được VẬN MAY LỚN và GIÀU CÓ trong các thị trường BÒ, GẤU và các sự kiện THIÊN NGA ĐEN",599000,599000,0,0
TIKI,nha-sach-tiki,85763211,"Hãy Khiến Tương Lai Biết Ơn Vì Hiện Tại Bạn Đã Cố Gắng Hết Mình (Tặng Kèm: 01 Bookmark)",68800,99000,30200,31
TIKI,nha-sach-tiki,194959173,"Semantic Error – Lỗi Logic (Tập 2)",194000,259000,65000,25
TIKI,nha-sach-tiki,121635152,"Không Ai Có Thể Làm Bạn Tổn Thương Trừ Khi Bạn Cho Phép (Tặng Kèm 1 Bộ Bookmark Gồm 4 Cái)",84000,119000,35000,29
TIKI,nha-sach-tiki,106863963,"Tâm Lý Học - Phác Họa Chân Dung Kẻ Phạm Tội",105000,145000,40000,28
TIKI,nha-sach-tiki,194960721,"Blue Period - Tập 03",34100,48000,13900,29
TIKI,nha-sach-tiki,3304875,"Điều Kỳ Diệu Của Tiệm Tạp Hóa NAMIYA (Tái Bản)",80900,105000,24100,23
TIKI,nha-sach-tiki,10095276,"Ikigai - Bí Mật Sống Trường Thọ Và Hạnh Phúc Của Người Nhật",69700,90000,20300,23
TIKI,nha-sach-tiki,173748415,"Tâm Lý Học Mối Quan Hệ",69200,98000,28800,29
TIKI,nha-sach-tiki,80628929,"Từ IQ Đến EQ - Nắm Bắt Thành Công Qua Trí Tuệ Cảm Xúc",63500,91000,27500,30
TIKI,nha-sach-tiki,147999778,"Không Bao Giờ Là Thất Bại - Tất Cả Là Thử Thách (Ấn Bản Cập Nhật Đầy Đủ Nhất)(Bìa Cứng)",141000,268000,127000,47
TIKI,nha-sach-tiki,103640412,"Đừng Lựa Chọn An Nhàn Khi Còn Trẻ (Tái Bản)",69000,99000,30000,30
TIKI,nha-sach-tiki,138107485,"Mặt Dày Tâm Đen (Tái Bản)",109000,169000,60000,36
TIKI,nha-sach-tiki,196016785,"Ikigami - Tập 08",40400,45000,4600,10
TIKI,nha-sach-tiki,72308265,"Hoa Vẫn Nở Mỗi Ngày",140400,234000,93600,40
TIKI,nha-sach-tiki,168293266,"Chiến Tranh Tiền Tệ - Phần 2 - Sự Thống Trị Của Quyền Lực Tài Chính ( Tái Bản 2022)",111000,170000,59000,35
TIKI,nha-sach-tiki,195969669,"Chào Mừng Đến Lớp Học Đề Cao Thực Lực - 3",63000,120000,57000,48
TIKI,nha-sach-tiki,196923457,"Blue Flag - Tập 2",44100,45000,900,2
TIKI,nha-sach-tiki,174215347,"Ajin - Boxset Số 3 (Tập 13 - 17) - Tặng Kèm Bookmark 3D",192000,270000,78000,29
TIKI,nha-sach-tiki,91947689,"7 Thói Quen Hiệu Quả (The 7 Habits Of Highly Effective People) (Tái Bản)",191000,250000,59000,24
TIKI,nha-sach-tiki,74362508,"Thần Số Học Ứng Dụng",78000,129000,51000,40
TIKI,nha-sach-tiki,23416722,"How The Body Works - Hiểu Hết Về Cơ Thể",205000,300000,95000,32
TIKI,nha-sach-tiki,70016692,"Bắt Trẻ Đồng Xanh (Tái Bản 2020)",60200,88000,27800,32
TIKI,nha-sach-tiki,3608625,"Payback Time - Ngày Đòi Nợ",299000,299000,0,0
TIKI,nha-sach-tiki,197344439,"Kingdom - Tập 34",43600,45000,1400,3
TIKI,nha-sach-tiki,184070223,"OSHO - Cảm Xúc",131000,188000,57000,30
TIKI,nha-sach-tiki,197344441,"Như Cơn Gió Thoảng - Nghĩ Về Những Qui Luật Cuộc Sống",80500,80500,0,0
TIKI,nha-sach-tiki,27582931,"How Money Works - Hiểu Hết Về Tiền",220000,300000,80000,27
TIKI,nha-sach-tiki,103379147,"Bạch Dạ Hành (Tái Bản)",156000,209000,53000,25
TIKI,nha-sach-tiki,76013378,"Storytelling With Data - Kể Chuyện Thông Qua Dữ Liệu (Cuốn Cẩm Nang Hướng Dẫn Trực Quan Hóa Dữ Liệu)",222100,319000,96900,30
TIKI,nha-sach-tiki,127844385,"Kiêu Hãnh Và Định Kiến (Tái Bản)",86500,116000,29500,25
TIKI,nha-sach-tiki,82912488,"Từ Tốt Đến Vĩ Đại (Tái bản 2021)",75000,130000,55000,42
TIKI,nha-sach-tiki,56454897,"Hiệu Sách Nhỏ Ở Paris",110000,149000,39000,26
TIKI,nha-sach-tiki,5067169,"Luật Hấp Dẫn (Tái Bản)",65800,89000,23200,26
TIKI,nha-sach-tiki,195801662,"Ngôi Sao Vườn Nữ Sinh - Tập 1",49100,50000,900,2
TIKI,nha-sach-tiki,8835159,"Đời Ngắn Đừng Ngủ Dài (Tái Bản)",62200,85000,22800,27
TIKI,nha-sach-tiki,148760924,"How Management Works - Hiểu Hết Về Quản Lý",242000,330000,88000,27
TIKI,nha-sach-tiki,70224520,"Băng keo dán nano 2 mặt siêu dính trong suốt dày 1mm dài 2m rộng 3cm và 5cm",17999,17999,0,0
TIKI,nha-sach-tiki,139303869,"Nghệ Thuật Tinh Tế Của Việc Đếch Quan Tâm (Tái Bản)",83000,128000,45000,35
TIKI,nha-sach-tiki,140416370,"Dòng Chảy",167000,228000,61000,27
TIKI,nha-sach-tiki,7718737,"Nghệ Thuật Tư Duy Rành Mạch (Tái Bản)",85600,118000,32400,27
TIKI,nha-sach-tiki,59262880,"Sách Người Bán Hàng Vĩ Đại Nhất Thế Giới (Tái Bản 2020)",103000,148000,45000,30
TIKI,nha-sach-tiki,157255752,"Sức Mạnh Của Hiện Tại (Tái Bản)",117000,168000,51000,30
TIKI,nha-sach-tiki,181699664,"Những Ngã Tư Và Những Cột Đèn",149000,200000,51000,26
TIKI,nha-sach-tiki,74341297,"Không Sợ Chậm Chỉ Sợ Dừng",92400,129000,36600,28
TIKI,nha-sach-tiki,72001057,"Chiến Tranh Tiền Tệ - Phần III",112000,175000,63000,36
TIKI,nha-sach-tiki,194205608,"Cherry Magic - Tập 2",86000,109000,23000,0
TIKI,nha-sach-tiki,192115858,"Chú Thuật Hồi Chiến -  Tập 5 - Giao Lưu Trường Kết Nghĩa Kyoto [Tặng Kèm Obi Và Thẻ Bo Góc Nhựa]",30000,30000,0,0
TIKI,nha-sach-tiki,58342212,"Set 3 cuốn Moi Moi và những người bạn - Dành cho trẻ từ 0-2 tuổi",75600,117000,41400,35
TIKI,nha-sach-tiki,115281323,"(Gift) Bút ký khắc tên cao cấp Doanh nhân LC048, mực mịn, đều ở mọi góc nghiêng",380000,380000,0,0
TIKI,nha-sach-tiki,273536931,"Kinh Doanh Thời Trang - 8 Bước Xây Dựng, Vận Hành Và Phát Triển Shop Quần Áo Của Bạn",155000,199000,44000,22
TIKI,nha-sach-tiki,115281552,"(Gift) Bút ký khắc tên cao câp Doanh nhân LC 046, mực bi mịn đều ở mọi góc nghiêng cầm bút",450000,450000,0,0
TIKI,nha-sach-tiki,113530805,"Tuổi Trẻ Đáng Giá Bao Nhiêu (Tái Bản)",61100,90000,28900,32
TIKI,nha-sach-tiki,168283405,"Chiến Tranh Tiền Tệ - Phần 1 - Ai Thực Sự Là Người Giàu Nhất Thế Giới ( Tái Bản 2022)",106000,165000,59000,36
TIKI,nha-sach-tiki,113779037,"(Gift) Bút ký khắc tên cao cấp Doanh nhân LC014, mực bi, đều ở mọi góc nghiêng",299000,299000,0,0
TIKI,nha-sach-tiki,274585509,"Phiên bản mới Sách nói điện tử song ngữ Anh Việt cho bé trên 3 tuổi",189000,250000,61000,24
TIKI,nha-sach-tiki,54614797,"Có Một Ngày, Bố Mẹ Sẽ Già Đi",66700,96000,29300,31
TIKI,nha-sach-tiki,161008715,"Power Vs Force - Trường Năng Lượng Và Những Nhân Tố Quyết Định Hành Vi Của Con Người (Tái Bản)",128000,179000,51000,28
TIKI,nha-sach-tiki,115701940,"Giá MiCa Để Sách, iPad, Máy Tính",75000,75000,0,0
TIKI,nha-sach-tiki,270704495,"Lịch bàn 2024 Thông Thái Tinh Khôn SDstationery, 21x16x6 cm, dễ thương vui nhộn, minh họa vũ trụ, hành tinh, hệ mặt trời",23000,88000,65000,74
TIKI,nha-sach-tiki,3639597,"Bước Chậm Lại Giữa Thế Gian Vội Vã (Tái Bản)",65000,85000,20000,24
TIKI,nha-sach-tiki,4780917,"Người Đua Diều (Tái Bản 2018)",100000,129000,29000,22
TIKI,nha-sach-tiki,180592885,"Combo 2Q: Mong Mẹ Hãy Yêu Lấy Chính Mình + Cơ Thể Tự Chữa Lành: Nước Ép Cần Tây",197500,197500,0,0
TIKI,nha-sach-tiki,92859698,"Tâm Lý Học Biểu Cảm",65500,98000,32500,33
TIKI,nha-sach-tiki,271405604,"Lịch bàn 2024 SDstationery From Yourself with Love, cảm hứng phát triển bản thân, tiếng Anh, minh họa đẹp 20x24x7,5",22000,110000,88000,80
TIKI,nha-sach-tiki,193659018,"Combo 2 Cuốn: Dinh Dưỡng Học Bị Thất Truyền + Chế Độ Ăn Trường Thọ",268350,268350,0,0
TIKI,nha-sach-tiki,262837213,"Sách Excel Power Query Và Power Pivot Tự Động Hóa Dữ Liệu Báo Cáo Cơ Bản ĐÀO TẠO TIN HỌC Có Kèm Video Khóa Học",178600,188000,9400,5
TIKI,nha-sach-tiki,141739123,"Ruột bút kim loại 0.5 mm và 0.7 mm, mực mịn đều ở mọi góc nghiêng cầm bút",170000,170000,0,0
TIKI,nha-sach-tiki,52788072,"Chiến Binh Cầu Vồng (Tái Bản 2020)",84500,109000,24500,22
TIKI,nha-sach-tiki,10005245,"Đàn Ông Sao Hỏa Đàn Bà Sao Kim",134000,188000,54000,29
TIKI,nha-sach-tiki,161310103,"Từ Vựng IELTS 8.0 - Từ Vựng Đắt Để Đạt Điểm Cao 4 Kỹ Năng",89000,135000,46000,34
TIKI,nha-sach-tiki,15267827,"Hoàng Tử Bé (Tái Bản 2019)",53500,75000,21500,29
TIKI,nha-sach-tiki,114937969,"Rừng Nauy (Tái Bản)",116000,150000,34000,23
TIKI,nha-sach-tiki,8885995,"Sự Im Lặng Của Bầy Cừu (Tái Bản)",85800,115000,29200,25
TIKI,nha-sach-tiki,271442564,"Sổ planner 52 tuần 2024 SDstationery “Treasure the Journey” gáy lò xo, họa tiết màu pastel trang nhã 14x20.3cm",112000,132000,20000,15
TIKI,nha-sach-tiki,104612965,"FLASHCARD SachID Moon",10000,10000,0,0
TIKI,nha-sach-tiki,53720978,"Trong Cái Không Có Gì Không ? (Thiền Sư Thích Nhất Hạnh Trả Lời Cho Trẻ Em Những Thắc Mắc Về Ý Nghĩa Cuộc Sống, Về Cái Chết, Về Gia Đình, Bạn Bè Và Nhiều Câu Hỏi Khác)",113000,160000,47000,29
TIKI,nha-sach-tiki,171556602,"2030: Những Xu Hướng Lớn Sẽ Định Hình Thế Giới Tương Lai (Tái Bản Lần 1)",155000,209000,54000,26
TIKI,nha-sach-tiki,54266567,"Sách Nghĩ Giàu Và Làm Giàu (Bìa Mềm)",78000,110000,32000,29
TIKI,nha-sach-tiki,161008717,"Kiếp Nào Ta Cũng Tìm Thấy Nhau: Câu Chuyện Về Những Linh Hồn Tri Kỷ Vĩnh Viễn Không Chia Lìa (Tái Bản)",66800,99000,32200,33
TIKI,nha-sach-tiki,57325187,"Sách Người Giàu Có Nhất Thành Babylon (Tái Bản 2020)",64500,98000,33500,34
TIKI,nha-sach-tiki,20917699,"Làm Sao Học Ít Hiểu Nhiều",82700,128000,45300,35
TIKI,nha-sach-tiki,135498945,"COMBO EHON SONG NGỮ ANH VIỆT PHIÊN BẢN ĐẶC BIỆT CÓ FILE ÂMTHANH",109000,109000,0,0
TIKI,nha-sach-tiki,77774625,"Nghệ Thuật Tập Trung - Nâng Cao Năng Suất, Tối Ưu Thời Gian, Hiệu Quả Bất Ngờ",68800,99000,30200,31
TIKI,nha-sach-tiki,78598381,"Tâm Lý Học Tính Cách (Tặng Kèm: 1 Bookmark)",76900,109000,32100,29
TIKI,nha-sach-tiki,76388962,"Chúng Ta Rồi Sẽ Hạnh Phúc, Theo Những Cách Khác Nhau [Tặng Kèm: 01 Bookmark]",61400,86000,24600,29
TIKI,nha-sach-tiki,7833728,"Dạy Con Làm Giàu (Tập 1) - Để Không Có Tiền Vẫn Tạo Ra Tiền - Cha Giàu Cha Nghèo (Tái Bản)",49100,80000,30900,39
TIKI,nha-sach-tiki,187338036,"Chiến Tranh Tiền Tệ - Tập 4",116700,185000,68300,37
TIKI,nha-sach-tiki,106318762,"Sách ID Tiếng Anh cho người mới bắt đầu - người mới mất gốc Cô Trang Anh",159000,200000,41000,21
TIKI,nha-sach-tiki,197344455,"Ikigami - The Ultimate Limit - Tuyển Tập Những Câu Chuyện Lay Động Lòng Người - Tập 9",45000,45000,0,0
TIKI,nha-sach-tiki,109505434,"Bạn Không Thông Minh Lắm Đâu (Tái Bản)(Tặng kèm Bookmark)",96800,139000,42200,30
TIKI,nha-sach-tiki,71345381,"Sách Thay Đổi Cuộc Sống Với Nhân Số Học - Lê Đỗ Quỳnh Hương",181000,248000,67000,27
TIKI,nha-sach-tiki,49747007,"Hai Mặt Của Gia Đình",68500,98000,29500,30
TIKI,nha-sach-tiki,193614514,"[Gift] Tặng 01 bookmark cho mỗi đơn hàng",19500,30000,10500,35
TIKI,nha-sach-tiki,184466860,"Hành Tinh Của Một Kẻ Nghĩ Nhiều",64000,86000,22000,26
TIKI,nha-sach-tiki,106185389,"Tổng ôn ngữ pháp Tiếng Anh cô Trang Anh- Sách luyện thi THPT Quốc gia môn tiếng anh",189000,250000,61000,24
TIKI,nha-sach-tiki,197558905,"Komi - Nữ Thần Sợ Giao Tiếp - Tập 13",24700,25000,300,1
TIKI,nha-sach-tiki,75307228,"Sách OSHO Yêu - Being In Love - Yêu Trong Tỉnh Thức",117000,168000,51000,30
TIKI,nha-sach-tiki,19792256,"Chuyện Con Mèo Dạy Hải Âu Bay (Tái Bản 2019)",37200,49000,11800,24
TIKI,nha-sach-tiki,168373800,"Sách - Thao túng tâm lý - 1980BOOKS",118000,169000,51000,30
TIKI,nha-sach-tiki,112110014,"TÂM LÝ HỌC ỨNG DỤNG",89800,129000,39200,30
TIKI,nha-sach-tiki,69978860,"Sói đội lốt Cừu - Kẻ hiếu chiến ngầm và các thủ thuật thao túng tâm lí",75000,110000,35000,32
TIKI,nha-sach-tiki,90622579,"Tâm Lý Học - Nghệ Thuật Giải Mã Hành Vi",96100,150000,53900,36
TIKI,nha-sach-tiki,196851308,"Dragon Ball Full Color - Phần Năm: Truy Lùng Cell Bọ Hung - Tập 4",76500,77000,500,1
TIKI,nha-sach-tiki,167972598,"Tôi Thích Bản Thân Nỗ Lực Hơn (Ấn Bản Kỷ Niệm)",84500,120000,35500,30
TIKI,nha-sach-tiki,107802183,"Sách Sức Mạnh Tiềm Thức (Tái Bản) (Bìa Mềm)",91700,128000,36300,28
TIKI,nha-sach-tiki,173882437,"8 Vụ Án Hoàn Hảo - Vạch Trần Tâm Lý Kẻ Phạm Tội",101000,145000,44000,30
TIKI,nha-sach-tiki,94173458,"Khuyến Học (Tái Bản)",47100,65000,17900,28
TIKI,nha-sach-tiki,192124399,"Blue Period Tập 2",34000,48000,14000,29
TIKI,nha-sach-tiki,163703151,"Chuyện Kể Rằng Có Nàng Và Tôi",51700,72000,20300,28
TIKI,nha-sach-tiki,85396163,"Combo 2 Cuốn: Yêu Những Điều Không Hoàn Hảo + Bước Chậm Lại Giữa Thế Gian Vội Vã (Tái Bản)",165000,224000,59000,26
TIKI,nha-sach-tiki,179546672,"Làm Sao Học Hết Được Nhân Sinh",130000,169000,39000,23
TIKI,nha-sach-tiki,185067342,"Tô Bình Yên Vẽ Hạnh Phúc (Tái Bản)",62000,88000,26000,30
TIKI,nha-sach-tiki,13333355,"Đọc Nhiều Nhớ Được Bao Nhiêu?",76200,118000,41800,35
TIKI,nha-sach-tiki,139567621,"Thức Tỉnh Mục Đích Sống (Tái Bản)",98000,148000,50000,34
TIKI,nha-sach-tiki,179735872,"Sách Tâm Lý Dành Cho Người Nhạy Cảm",62700,89000,26300,30
TIKI,nha-sach-tiki,196409700,"Công Chúa Ma Cà Rồng Quyền Năng Chỉ Muốn Có Một Người Em Gái Mà Thôi",146000,175000,29000,17
TIKI,nha-sach-tiki,195885688,"Dragon Quest - Dấu Ấn Roto (Dragon Quest Saga Emblem Of Roto) Perfect Edition - Tập 9",74100,75000,900,1
TIKI,nha-sach-tiki,76776245,"Nghệ Thuật Tư Duy Phản Biện",85900,129000,43100,33
TIKI,nha-sach-tiki,105663942,"Hành Trình Về Phương Đông (Tái Bản 2021)",83000,118000,35000,30
TIKI,nha-sach-tiki,52329763,"Kafka bên bờ biển (Tái Bản 2020)",114000,158000,44000,28
TIKI,nha-sach-tiki,171549981,"Cuộc Diễu Hành Thầm Lặng",148000,198000,50000,25
TIKI,nha-sach-tiki,540039,"Giáo Trình Chuẩn HSK 1 - Bài Học (Kèm file MP3)",149000,198000,49000,25
TIKI,nha-sach-tiki,108684605,"Trí Thông Minh Của Sự Tinh Tế",63600,89000,25400,29
TIKI,nha-sach-tiki,196422809,"Bá Tước Tiểu Thư - Tập 3",30000,30000,0,0
TIKI,nha-sach-tiki,173763072,"Tâm Lý Học Hẹn Hò - Nghệ Thuật Giao Tiếp Trong Tình Yêu",78000,109000,31000,28
TIKI,nha-sach-tiki,273624916,"[ Trạm Đọc Official ]  Trí Tuệ Do Thái (Tái Bản)",142000,189000,47000,25
TIKI,nha-sach-tiki,124767703,"Cân Bằng Cảm Xúc Cả Lúc Bão Giông (Tặng Kèm Bookmark)(Tái Bản)",67100,105000,37900,36
TIKI,nha-sach-tiki,100931416,"Bắt Đầu Với Câu Hỏi Tại Sao - Nghệ Thuật Truyền Cảm Hứng Trong Kinh Doanh (Tái Bản)",78000,109000,31000,28
TIKI,nha-sach-tiki,194205620,"Người Hướng Nội Trong Thế Giới Hướng Ngoại",79000,105000,26000,25
TIKI,nha-sach-tiki,168234714,"Cư Xử Như Đàn Bà Suy Nghĩ Như Đàn Ông",78100,109000,30900,28
TIKI,nha-sach-tiki,55605170,"Cơ Thể Tự Chữa Lành: Thực Phẩm Thay Đổi Cuộc Sống",119000,185000,66000,36
TIKI,nha-sach-tiki,197353399,"Học Viện Siêu Anh Hùng Vigilantes - My Hero Academia Illegals - Tập 1: Đã Có Ta Ở Đây",29000,30000,1000,3
TIKI,nha-sach-tiki,71907876,"Từ Điển Tiếng “Em”",48200,69000,20800,30
TIKI,nha-sach-tiki,8886007,"Ngàn Mặt Trời Rực Rỡ (Tái Bản)",100000,130000,30000,23
TIKI,nha-sach-tiki,158019962,"Combo 3 Cuốn Bộ Sách: Nuôi Con Không Phải Là Cuộc Chiến 2 (Tái Bản)",262000,377000,115000,31
TIKI,nha-sach-tiki,105483727,"Ổn Định Hay Tự Do",92400,129000,36600,28
TIKI,nha-sach-tiki,195187480,"Thiên Quan Tứ Phúc - Tập 6 (Tiểu thuyết, đam mỹ)",110700,159000,48300,30
TIKI,nha-sach-tiki,3644267,"Đặc Quyền Của Gái Hư",61400,86000,24600,29
TIKI,nha-sach-tiki,120219394,"Tôi Nói Gì Khi Nói Về Chạy Bộ",53000,76000,23000,30
TIKI,nha-sach-tiki,191920180,"Cherry Magic - Tập 1",86000,109000,23000,21
TIKI,nha-sach-tiki,149089470,"Những Vị Thần Nước Mỹ",187000,250000,63000,25
TIKI,nha-sach-tiki,154245455,"Combo 2 Cuốn Nghiền Từ Vựng Tiếng Anh: Học Qua Gốc Từ Bằng Hình Ảnh - Gốc Từ Là Bí Quyết Để Ghi Nhớ Hàng Nghìn Từ Vựng",177000,270000,93000,34
TIKI,nha-sach-tiki,126743459,"Fear - Sợ Hãi (Hóa Giải Sợ Hãi Bằng Tình Thương)",76100,109000,32900,30
TIKI,nha-sach-tiki,185071145,"Sói Đầu Đàn Và Cún Nhỏ - Tập 2",105000,135000,30000,22
TIKI,nha-sach-tiki,35191892,"21 Bài Học Cho Thế Kỷ 21",162000,209000,47000,22
TIKI,nha-sach-tiki,194960238,"Slam Dunk - Deluxe Edition - Tập 10",55000,60000,5000,8
TIKI,nha-sach-tiki,104741661,"Combo 2 Tập : 999 Lá Thư Gửi Cho Chính Mình (Tái Bản)",193000,258000,65000,25
TIKI,nha-sach-tiki,197781975,"Dr.Slump Ultimate Edition Tập 12",59500,60000,500,1
TIKI,nha-sach-tiki,167210779,"Quyền Lực",111000,155000,44000,28
TIKI,nha-sach-tiki,54422942,"Tôi Quyết Định Sống Cho Chính Tôi (Tái Bản 2020)",59400,88000,28600,33
TIKI,nha-sach-tiki,196016781,"Kingdom - Tập 33",42000,45000,3000,7
TIKI,nha-sach-tiki,195190105,"Color Rush - Bản Thông Thường",223000,265000,42000,16
TIKI,nha-sach-tiki,152740748,"Lối Sống Tối Giản Của Người Nhật (Tái Bản)",85200,119000,33800,28
TIKI,nha-sach-tiki,54748899,"Sách Muôn Kiếp Nhân Sinh (Bìa Mềm) - Nguyên Phong",118000,168000,50000,30
TIKI,nha-sach-tiki,57110087,"Siêu Cò – How To Be A Power Connector",249000,249000,0,0
TIKI,nha-sach-tiki,196851310,"Migi & Dali - Tập 2",39000,40000,1000,3
TIKI,nha-sach-tiki,87226756,"Những Đêm Không Ngủ, Những Ngày Chậm Trôi",56000,86000,30000,35
TIKI,nha-sach-tiki,3608623,"Bí Mật Của Phan Thiên Ân",69000,69000,0,0
TIKI,nha-sach-tiki,185242031,"The Shining - Thị Kiến",200000,269000,69000,26
TIKI,nha-sach-tiki,77105730,"Tàn Ngày Để Lại (Bìa Cứng)",126000,169000,43000,25
TIKI,nha-sach-tiki,183058543,"OSHO - Trưởng Thành",89100,128000,38900,30
TIKI,nha-sach-tiki,17336360,"Lolita (Tái Bản 2019)",92900,128000,35100,27
TIKI,nha-sach-tiki,378448,"Nhà Giả Kim",66950,66950,0,0
TIKI,nha-sach-tiki,170708233,"Thay Đổi Tí Hon - Hiệu Quả Bất Ngờ (Tái Bản)",140000,189000,49000,26
TIKI,nha-sach-tiki,187827003,"Không Diệt Không Sinh Đừng Sợ Hãi (TB5)",75000,110000,35000,32
TIKI,nha-sach-tiki,53532186,"Tuyệt kỹ Giao dịch bằng đồ thị nến Nhật – Japanese Candlestick Charting Techniques",499000,499000,0,0
TIKI,nha-sach-tiki,14508205,"Sổ tay thực hành 66 ngày thử thách",89000,89000,0,0
TIKI,nha-sach-tiki,196923451,"Vua Sáng Chế - Tập 17",20000,20000,0,0
TIKI,nha-sach-tiki,73878873,"Tư Duy Sâu",64100,91000,26900,30
TIKI,nha-sach-tiki,50414368,"Án Mạng Mười Một Chữ",75400,110000,34600,31
TIKI,nha-sach-tiki,57762732,"Nhà Đầu Tư Thông Minh (Tái Bản 2020)",154000,199000,45000,23
TIKI,nha-sach-tiki,750578,"Khi Hơi Thở Hóa Thinh Không",74000,109000,35000,32
TIKI,nha-sach-tiki,196515661,"Văn Phòng Thám Tử Quái Vật - Tập 12",23500,30000,6500,22
TIKI,nha-sach-tiki,196515664,"Anh Em Phi Hành Gia - Tập 33",44500,45000,500,1
TIKI,nha-sach-tiki,12377498,"Bố Con Cá Gai (Tái Bản 2019)",74400,96000,21600,23
TIKI,nha-sach-tiki,45902241,"Tìm Mình Trong Thế Giới Hậu Tuổi Thơ",106000,142000,36000,25
TIKI,nha-sach-tiki,158019964,"Combo 4 Cuốn Bộ Sách: Nuôi Con Không Phải Là Cuộc Chiến (Tái Bản)",350300,506000,155700,31
TIKI,nha-sach-tiki,191571494,"Black Jack - Tập 12",30000,30000,0,0
TIKI,nha-sach-tiki,162844699,"Tạm Biệt Tôi Của Nhiều Năm Về Trước",67800,95000,27200,29
TIKI,nha-sach-tiki,110448022,"Ba Phút Sơ Cứu",104000,140000,36000,26
TIKI,nha-sach-tiki,115266692,"Sách - Ám Ảnh Sợ Xã Hội - Chạy Trốn Hay Đối Mặt",82900,125000,42100,34
TIKI,nha-sach-tiki,90887853,"Mình Chỉ Là Người Bình Thường (Sách Tô Màu)",97500,138000,40500,29
TIKI,nha-sach-tiki,84970841,"Men Chase Women Choose - Chuyện Tình Yêu Bạn Biết Được Bao Nhiêu?",73600,109000,35400,32
TIKI,nha-sach-tiki,145289356,"Sách Atomic Habits - Thay Đổi Tí Hon, Hiệu Quả Bất Ngờ ( Những Thay Đổi Nhỏ Tạo Nên Thành Công Lớn/ Tặng kèm Bookmark)",160000,189000,29000,15
TIKI,nha-sach-tiki,9948009,"Dám Hạnh Phúc",78100,110000,31900,29
TIKI,nha-sach-tiki,186237324,"Thiên quan tứ phúc - Tập 5 (Tiểu thuyết đam mỹ) - Tặng kèm 1 bookmark 2 mặt",110700,159000,48300,30
TIKI,nha-sach-tiki,641906,"Bí Mật Của Naoko",79400,108000,28600,26
TIKI,nha-sach-tiki,104074997,"Kỹ Năng Bán Hàng Tuyệt Đỉnh (Tái Bản)",77500,120000,42500,35
TIKI,nha-sach-tiki,179546078,"Luật Hấp Dẫn - Quy Luật Về Sức Mạnh Tâm Trí Và Phát Huy Năng Lượng Tích Cực Để Làm Chủ Định Mệnh",81500,139000,57500,41
TIKI,nha-sach-tiki,100321478,"Muốn An Được An (Tái bản 2021)",43000,65000,22000,34
TIKI,nha-sach-tiki,11122712,"Bộ sách Làm Giàu Từ Chứng Khoán (How To Make Money In Stock) phiên bản mới + Hướng Dẫn Thực Hành CANSLIM Cho Người Mới Bắt Đầu",700000,700000,0,0
TIKI,nha-sach-tiki,197990865,"Dragon Quest - Dấu Ấn Roto (Dragon Quest Saga Emblem Of Roto) Perfect Edition - Tập 10",73300,75000,1700,2
TIKI,nha-sach-tiki,128649312,"21 Nguyên Tắc Tự Do Tài Chính (Tái Bản)",38000,55000,17000,31
TIKI,nha-sach-tiki,168559521,"Sự Trung Thực Của Xác Chết – Ghi Chép Của Một Nhà Pháp Y",68800,99000,30200,31
TIKI,nha-sach-tiki,2496281,"Đồi Gió Hú (Tái Bản)",80000,108000,28000,26
TIKI,nha-sach-tiki,179063952,"Khi Mọi Điểm Tựa Đều Mất",65200,98000,32800,33
TIKI,nha-sach-tiki,106864418,"Combo 10 Cuốn: Chuyện Xóm Gà",409000,580000,171000,29
TIKI,nha-sach-tiki,7982628,"Suối Nguồn (Tái Bản)",229000,380000,151000,40
TIKI,nha-sach-tiki,73316977,"Hành Trình Của Linh Hồn (Tái Bản 2020)",89800,129000,39200,30
TIKI,nha-sach-tiki,155550591,"Dinh Dưỡng Học Bị Thất Truyền - Dinh Dưỡng Đẩy Lùi Bệnh Tật",115000,178000,63000,35
TIKI,nha-sach-tiki,52584834,"Tư Duy Hệ Thống Trong Công Việc",61500,89000,27500,31
TIKI,nha-sach-tiki,173865570,"Một Cuốn Sách Về Chủ Nghĩa Tối Giản (Tái bản 2022)",129000,129000,0,0
TIKI,nha-sach-tiki,73515859,"Sách OSHO - Can Đảm Là Chính Mình Trong Thế Giới Hiểm Nguy",61100,88000,26900,31
TIKI,nha-sach-tiki,86517373,"Khoa Học Về Nấu Ăn - The Science Of Cooking",267000,350000,83000,24
TIKI,nha-sach-tiki,35283863,"Lược Sử Thế Giới",219000,320000,101000,32
TIKI,nha-sach-tiki,191782162,"Trên Đường Băng (Tony Buổi Sáng)",71500,105000,33500,32
TIKI,nha-sach-tiki,179546070,"Luật Hấp Dẫn - Quy Luật Về Sức Mạnh Của Linh Hồn Và Năng Lượng Chữa Lành Cơ Thể Từ Bên Trong",85900,129000,43100,33
TIKI,nha-sach-tiki,540040,"Giáo Trình Chuẩn HSK 1 - Bài Tập (Kèm file MP3)",119000,158000,39000,25
TIKI,nha-sach-tiki,194960244,"Fullmetal Alchemist - Cang Giả Kim Thuật Sư - Fullmetal Edition - Tập 16",63000,69000,6000,9
TIKI,nha-sach-tiki,196515668,"Quán Rượu Dị Giới "Nobu" - Tập 11",35000,40000,5000,13
TIKI,nha-sach-tiki,11368965,"Combo Giáo Trình Chuẩn HSK 1 - Bài Học (Kèm 1 MP3) và Giáo Trình Chuẩn HSK 1 - Bài Tập (Kèm 1 MP3) ( Tặng Kèm Viết )",284800,356000,71200,20
TIKI,nha-sach-tiki,130233544,"Mèo Và Triết Lý Nhân Sinh - Mèo Đã Dạy Chúng Ta Điều Gì Về Cuộc Sống",145500,209000,63500,30
TIKI,nha-sach-tiki,66090079,"Cơ Thể Tự Chữa Lành: Giải Cứu Gan",161000,250000,89000,36
TIKI,nha-sach-tiki,21130350,"Vụ Án LEROUGE (Trinh Thám)",79000,168000,89000,53
TIKI,nha-sach-tiki,102629318,"999 Lá Thư Gửi Cho Chính Mình (*) - Tập 1 - Mong Bạn Trở Thành Phiên Bản Hoàn Hảo Nhất (Tái bản)",92400,129000,36600,28
TIKI,nha-sach-tiki,145288026,"Chia Rẽ - Tại Sao Chúng Ta Đang Sống Trong Thời Đại Của Những Bức Tường",149000,200000,51000,26
TIKI,nha-sach-tiki,828621,"Dolocher (Trinh Thám)",44000,159000,115000,72
TIKI,nha-sach-tiki,56692532,"Tôi Từng Nghĩ Mọi Thứ Sẽ Ổn Khi Trở Thành Người Lớn (Tặng Kèm 1 Bookmark)",66500,96000,29500,31
TIKI,nha-sach-tiki,193434490,"Ikigami - Tập 07",32000,45000,13000,29
TIKI,nha-sach-tiki,194104216,"Văn Phòng Thám Tử Quái Vật - Tập 11",29100,30000,900,3
TIKI,nha-sach-tiki,174842858,"Sách Sức Mạnh Của Ngôn Từ (Tái Bản 2022)",75100,108000,32900,30
TIKI,nha-sach-tiki,126743464,"Kế Hoạch Của Linh Hồn - Khám Phá Ý Nghĩa Cuộc Sống Mà Bạn Đã Lên Kế Hoạch Trước Khi Sinh Ra",117000,169000,52000,31
TIKI,nha-sach-tiki,69644752,"Toàn Thư Chiêm Tinh Học Nhập Môn",226000,350000,124000,35
TIKI,nha-sach-tiki,186286187,"Nhà Lãnh Đạo Không Chức Danh",68000,105000,37000,35
TIKI,nha-sach-tiki,100931414,"Cách Khen Cách Mắng Cách Phạt Con (Tái Bản)",47800,69000,21200,31
TIKI,nha-sach-tiki,13419678,"Sách Đi Tìm Lẽ Sống (Tái Bản )",61100,88000,26900,31
TIKI,nha-sach-tiki,1938915,"Sự Tiếp Xúc Của Văn Hóa Việt Nam Với Pháp",81650,109000,27350,25
TIKI,nha-sach-tiki,184070221,"Sách OSHO Hiểu - Đường Đến Tự Do",117000,168000,51000,30
TIKI,nha-sach-tiki,13624088,"Nghĩ Thiện Để Cuộc Đời Và Công Việc Viên Mãn",51000,85000,34000,40
TIKI,nha-sach-tiki,45321594,"Nghệ Thuật Bán Hàng Của Người Hướng Nội",88800,119000,30200,25
TIKI,nha-sach-tiki,193988323,"Sa Vào Ánh Hào Quang Của Người – Tập 2",113000,138000,25000,18
TIKI,nha-sach-tiki,104314401,"Sách Bí Mật Của May Mắn (Khổ Lớn) (Tái Bản)",46100,68000,21900,32
TIKI,nha-sach-tiki,155683832,"túi đựng card visit - JL",5000,5000,0,0
TIKI,nha-sach-tiki,168576295,"Mình Phải Sống Như Biển Rộng Sông Dài",77300,109000,31700,29
TIKI,nha-sach-tiki,49910019,"Bác Sĩ Riêng Của Bé Yêu - Chào Con! Ba Mẹ Đã Sẵn Sàng (Tái Bản)",66000,95000,29000,31
TIKI,nha-sach-tiki,17719702,"Một Thế Giới Không Có Đàn Bà (Trinh Thám Việt Nam)",98000,142000,44000,31
TIKI,nha-sach-tiki,160759005,"Cơ Thể Tự Chữa Lành - Thanh Lọc Để Phục Hồi",190000,295000,105000,36
TIKI,nha-sach-tiki,50723822,"Con Đường Đi Đến Thành Công Bằng Sự Tử Tế (Tái Bản 2020)",48000,70000,22000,31
TIKI,nha-sach-tiki,145287904,"Sách - Giận (Tái Bản 2021)(Cuốn sách hay của Thiền sư Thích Nhất Hạnh/ Tặng kèm Bookmark)",128650,128650,0,0
TIKI,nha-sach-tiki,48481763,"Thiên Nga Đen (Tái Bản 2020)",190400,299000,108600,36
TIKI,nha-sach-tiki,44433397,"Yêu Mình Trước Đã, Yêu Đời Để Sau",75800,109000,33200,30
TIKI,nha-sach-tiki,184774173,"Những Người Nhật Tử Tế",96000,148000,52000,35
TIKI,nha-sach-tiki,143172597,"2000 English Collocation and Idioms",119000,200000,81000,41
TIKI,nha-sach-tiki,195801644,"Black Jack - Tập 13 (Bìa Cứng)",128000,135000,7000,5
TIKI,nha-sach-tiki,129381090,"Minh Triết Trong Đời Sống (Tái Bản)",71100,108000,36900,34
TIKI,nha-sach-tiki,52597663,"Đừng Chạy Theo Số Đông - Cuốn Sách Bạn Cần Đọc Trước Khi Quá Muộn",129000,200000,71000,36
TIKI,nha-sach-tiki,170297937,"Tâm Lý Học Về Sự Lo Âu",95100,129000,33900,26
TIKI,nha-sach-tiki,32155084,"Combo 25 Chuyên đề ngữ pháp tiếng anh trọng tâm ( trọn bộ tập 1+2 )",148000,230000,82000,36
TIKI,nha-sach-tiki,100958457,"Gieo Trồng Hạnh Phúc (Tái Bản)",61800,89000,27200,31
TIKI,nha-sach-tiki,113540576,"Hảo Nữ Trung Hoa",101000,128000,27000,21
TIKI,nha-sach-tiki,160081252,"Người Tan Làm Sau Cùng Là Người Nghỉ Việc Đầu Tiên (Tặng kèm bookmark)",84000,119000,35000,29
TIKI,nha-sach-tiki,90469338,"Combo 5 cuốn: Cơ Thể Tự Chữa Lành",594000,923000,329000,36
TIKI,nha-sach-tiki,136143567,"Thần Số Học",146000,219000,73000,33
TIKI,nha-sach-tiki,54051752,"Bộ Ba Quái Hiệp (Trinh Thám)",69000,138000,69000,50
TIKI,nha-sach-tiki,145288031,"Tarot Toàn Thư - Đọc Vận Mệnh Qua Những Lá Bài",244000,380000,136000,36
TIKI,nha-sach-tiki,7916685,"All The Rule - Bình Tĩnh Khi Ế, Mạnh Mẽ Khi Yêu",60600,86000,25400,30
TIKI,nha-sach-tiki,179063564,"Tôi Tự Học",79000,120000,41000,34
TIKI,nha-sach-tiki,119694726,"Combo 6 cuốn Ehon Kích thích thị giác - Âm thanh cho Trẻ sơ sinh",121680,234000,112320,48
TIKI,nha-sach-tiki,153045603,"Sách Người Giỏi Không Phải Là Người Làm Tất Cả (Tái Bản 2021)",40100,58000,17900,31
TIKI,nha-sach-tiki,100931418,"Giao Tiếp Bất Kỳ Ai - 101 Cách Nâng Cao Khả Năng Giao Tiếp (Tái Bản)",37800,55000,17200,31
TIKI,nha-sach-tiki,198016656,"Blue Flag - Tập 3",44100,45000,900,2
TIKI,nha-sach-tiki,148802202,"How Philosophy Works - Hiểu Hết Về Triết Học",246000,330000,84000,25
TIKI,nha-sach-tiki,176909221,"Ngôi Nhà Bên Bờ Biển Xanh Thẳm",124000,174000,50000,29
TIKI,nha-sach-tiki,2429811,"Tư Duy Phản Biện",56100,85000,28900,34
TIKI,nha-sach-tiki,130996082,"Bồ Câu Bay Đi Tìm Bà",56100,77000,20900,27
TIKI,nha-sach-tiki,52785564,"Dịch Hạch (Nobel Văn Chương 1957)",93700,129000,35300,27
TIKI,nha-sach-tiki,11371249,"Chuyện Con Mèo Và Con Chuột Bạn Thân Của Nó - Tái Bản",30100,39000,8900,23
TIKI,nha-sach-tiki,111580006,"Sách Muôn Kiếp Nhân Sinh 2 (Khổ Nhỏ) - Nguyên Phong",86000,148000,62000,42
TIKI,nha-sach-tiki,159004131,"Semantic Error – Lỗi Logic (Tập 1) - Bản thường (Tặng Kèm 01 Bookmark + 01 Postcard)",183000,259000,76000,29
TIKI,nha-sach-tiki,195357772,"Máy Tính CASIO FX-880BTG - Màu Đen",696000,800000,104000,13
TIKI,nha-sach-tiki,52805060,"Chúa Ruồi - Tiểu Thuyết (Nobel Văn Chương 1983)(Tái Bản 2020)",63700,88000,24300,28
TIKI,nha-sach-tiki,22881852,"English Grammar in Use Book w Ans",160200,198000,37800,19
TIKI,nha-sach-tiki,50751279,"Vui Vẻ Không Quạu Nha - Tản Văn",49200,69000,19800,29
TIKI,nha-sach-tiki,57761618,"Vụ Án Mạng Ở Lữ Quán Kairotei",84100,123000,38900,32
TIKI,nha-sach-tiki,66619715,"Sách Vị Tu Sĩ Bán Chiếc Ferrari (Tái Bản)",68100,98000,29900,31
TIKI,nha-sach-tiki,162205263,"Những Đồ Vật Có Linh Hồn - Bản Thường (Tặng Kèm 1 Bookmark)",106000,149000,43000,29
TIKI,nha-sach-tiki,147988185,"Combo 2 Cuốn "Hiểu Hết" : How Business Works - Hiểu Hết Về Kinh Doanh + How Money Works - Hiểu Hết Về Tiền",469000,680000,211000,31
TIKI,nha-sach-tiki,157240665,"Ra Bờ Suối Ngắm Hoa Kèn Hồng (Truyện Dài-Nguyễn Nhật Ánh) - Bìa Mềm (Màu Hồng) (Tặng Kèm Bookmark Bồi Hai Mặt, Thiệp Trái Tim In Bài Thơ Của Tác Giả)",97400,145000,47600,33
TIKI,nha-sach-tiki,196923452,"Birdmen - Tập 7",30000,30000,0,0
TIKI,nha-sach-tiki,193411736,"Anh Em Nhà Motohashi - Tập 2",52000,68000,16000,24
TIKI,nha-sach-tiki,95218451,"Lần Đầu Làm Mẹ - Tổng Hợp Những Kiến Thức Mới Nhất Về Mang Thai Và Sinh Nở (Tái Bản)",176000,260000,84000,32
TIKI,nha-sach-tiki,190238356,"Kỷ Luật Bản Thân",125000,189000,64000,34
TIKI,nha-sach-tiki,193433626,"Kỹ năng tự học cho trẻ tiểu học",142000,199000,57000,29
TIKI,nha-sach-tiki,160997378,"Giải Thích Ngữ Pháp Tiếng Anh Với Bài Tập Và Đáp Án (TB 2022) - Tác giả Mai Lan Hương, Hà Thanh Uyên",165000,220000,55000,25
TIKI,nha-sach-tiki,143186001,"Chiến Thắng Con Quỷ Trong Bạn - Bí Quyết Tự Do Và Thành Công (Tái Bản)",82300,115000,32700,28
TIKI,nha-sach-tiki,1926761,"Khởi Nghiệp Bán Lẻ - Bí Quyết Thành Công Và Giàu Có Bằng Những Cửa Hàng Đông Khách - Công Thức Kinh Doanh Và Quản Lý Cửa Hàng Hiệu Quả",125000,199000,74000,37
TIKI,nha-sach-tiki,14053724,"Sự Cứu Rỗi Của Thánh Nữ",93700,128000,34300,27
TIKI,nha-sach-tiki,70016690,"Thế Giới Rộng Lớn Lòng Người Chật Hẹp (Tặng Kèm 1 Bookmark )",62100,92000,29900,33
TIKI,nha-sach-tiki,164336673,"How The Brain Works - Hiểu Hết Về Bộ Não",264000,330000,66000,20
TIKI,nha-sach-tiki,79672197,"Bí Mật Của May Mắn (Khổ Nhỏ)(Tái Bản)",32100,45000,12900,29
TIKI,nha-sach-tiki,195649312,"Trí Tuệ Do Thái  (Tái Bản 2022)",137000,189000,52000,28
TIKI,nha-sach-tiki,137741275,"Ngỡ Như Lương Thiện, Hóa Ra Mềm Yếu",93000,125000,32000,26
TIKI,nha-sach-tiki,25557704,"Bãi săn người - Trinh Thám Kinh Dị",62000,162000,100000,62
TIKI,nha-sach-tiki,195885685,"Vua Sáng Chế -  Tập 16",20000,20000,0,0
TIKI,nha-sach-tiki,3976835,"Velma - Trinh Thám Cổ Điển Phương Tây",49500,99000,49500,50
TIKI,nha-sach-tiki,141333746,"Chúng Ta Học Thế Nào - How We Learn (Sự Thật Khó Tin Về Việc Học Nó Diễn Ra Khi Nào, Ở Đâu , Và Tại Sao)",112000,150000,38000,25
TIKI,nha-sach-tiki,66067655,"Trải Nghiệm Khách Hàng Xuất Sắc",181000,250000,69000,28
TIKI,nha-sach-tiki,85029033,"Truyện Cổ Grimm (Ấn Bản Đầy Đủ Nhất Kèm 184 Minh Hoạ Của Philipp Grot Johann Và Robert Leinweber)",446000,680000,234000,34
TIKI,nha-sach-tiki,67271338,"Sách OSHO - Trò Chuyện Với Vĩ Nhân",135000,198000,63000,32
TIKI,nha-sach-tiki,108501279,"Viết Đi Đừng Sợ! Từ Tay Không Thành Tay Viết",188000,245000,57000,23
TIKI,nha-sach-tiki,187190676,"Black Jack - Tập 11",30000,30000,0,0
TIKI,nha-sach-tiki,160081250,"Tăng Cường Sức Mạnh Não Bộ",95000,120000,25000,21
TIKI,nha-sach-tiki,197634252,"Văn phòng thám tử quái vật - Tập 13",25400,30000,4600,0
TIKI,nha-sach-tiki,195357776,"Máy Tính CASIO FX-880BTG - Màu Hồng",742000,800000,58000,7
TIKI,nha-sach-tiki,96357336,"Cáo Pax",85100,116000,30900,27
TIKI,nha-sach-tiki,182548592,"Thiên Sứ Nhà Bên – Tập 3",70000,95000,25000,26
TIKI,nha-sach-tiki,197781977,"Yu-Gi-Oh! Gx Tập 1: “Người Hùng Mới” Lộ Diện",29000,30000,1000,3
TIKI,nha-sach-tiki,197353391,"Ninja Rantaro - Tập 61",39000,40000,1000,3
TIKI,nha-sach-tiki,1080002,"Boxset Harry Potter - Tiếng Việt (Trọn Bộ 7 Tập)",1199000,1750000,551000,31
TIKI,nha-sach-tiki,100947274,"Tìm Bình Yên Trong Gia Đình (Tái Bản)",68800,99000,30200,31
TIKI,nha-sach-tiki,48323805,"Sách Người trong muôn nghề",169000,189000,20000,11
TIKI,nha-sach-tiki,243358535,"Squid Game Móc khoá - Móc khoá Silicon 5cm-SQ1",10000,20000,10000,50
TIKI,nha-sach-tiki,274404957,"Montessori – Phương Pháp Giáo Dục Toàn Diện Cho Trẻ 0-6 Tuổi",81100,81100,0,0
TIKI,nha-sach-tiki,179952621,"Hành Trình Tarot (Tái Bản 2022)",107000,149000,42000,28
TIKI,nha-sach-tiki,57870426,"Sức Mạnh Của Ngôn Từ (Tặng Kèm 1 Photocard Mintbooks Limited)",64500,96000,31500,33
TIKI,nha-sach-tiki,171057415,"Cẩm nang hướng dẫn tự học tiếng Thái – trình độ sơ cấp – trung cấp",98000,98000,0,0
TIKI,nha-sach-tiki,194104631,"Mong Bạn Đừng Khóc Một Mình",65500,88000,22500,26
TIKI,nha-sach-tiki,178483637,"Nước Ép Trị Liệu Và Chế Độ Ăn Theo Phương Pháp Cơ Thể Tự Chữa Lành",142000,199000,57000,29
TIKI,nha-sach-tiki,80657321,"Cơ Thể Tự Chữa Lành: Phục Hồi Tuyến Giáp",116000,180000,64000,36
TIKI,nha-sach-tiki,194104232,"Anh Em Phi Hành Gia - Tập 32",42300,45000,2700,6
TIKI,nha-sach-tiki,196944533,"Tài chính doanh nghiệp for Dummies",166000,239000,73000,31
TIKI,nha-sach-tiki,176550321,"Bàn Về Ham Muốn: Tại Sao Chúng Ta Muốn Thứ Mà Ta Muốn",121000,169000,48000,28
TIKI,nha-sach-tiki,147058065,"Phi Lý Trí - Khám Phá Những Động Lực Vô Hình Ẩn Sau Những Quyết Định Của Con Người ( Tái Bản)",110000,169000,59000,35
TIKI,nha-sach-tiki,195649281,"Đọc Vị Tâm Lý Hành Vi Của Giới Giàu Và Siêu Giàu",222000,299000,77000,26
TIKI,nha-sach-tiki,113655533,"Giáo Trình Chủ Nghĩa Xã Hội Khoa Học (Dành Cho Bậc Đại Học Hệ Không Chuyên Lý Luận Chính Trị) - Bộ mới năm 2021",58000,58000,0,0
TIKI,nha-sach-tiki,81323246,"90-20-30 90 Bài Học Vỡ Lòng Về Ý Tưởng Và Câu Chữ (Bản Đen Trắng)",149000,195000,46000,24
TIKI,nha-sach-tiki,90056907,"Khởi Nghiệp Tinh Gọn (The Lean Startup) (Tái Bản)",129000,165000,36000,22
TIKI,nha-sach-tiki,115478654,"Keo Siêu Dính Đa Năng Mạnh Gấp 80 Keo 502 Dán Sắt, Dán Đá, Dán Nhựa, Dán Gỗ",39000,39000,0,0
TIKI,nha-sach-tiki,50475521,"Sách Đánh Thức Con Người Phi Thường Trong Bạn",97000,168000,71000,42
TIKI,nha-sach-tiki,193433863,"101 Lời Khuyên Tài Chính Cá Nhân Từ Thái Phạm",299000,299000,0,0
TIKI,nha-sach-tiki,3737963,"Bức Xúc Không Làm Ta Vô Can (Tái Bản)",63300,85000,21700,26
TIKI,nha-sach-tiki,191148794,"Tôi Ước Mình Chưa Từng Được Sinh Ra -Tặng kèm 1 bookmark",63000,90000,27000,30
TIKI,nha-sach-tiki,187622420,"The Art and Science of Technical Analysis – Phân tích kỹ thuật: Sự kết hợp giữa KHOA HỌC và NGHỆ THUẬT trong đầu tư chứng khoán",569000,569000,0,0
TIKI,nha-sach-tiki,125528587,"Thần Với Chả Thoại (Những Câu Chuyện "Mệt Mỏi" Về Các Vị Thần)",85000,139000,54000,39
TIKI,nha-sach-tiki,110448020,"Nhà Ảo Thuật Đen Và Vụ Án Mạng Tại Thị Trấn Không Tên",154000,199000,45000,23
TIKI,nha-sach-tiki,161245852,"Giải Thích Ngữ Pháp Tiếng Anh (Tái Bản 2022)",176000,220000,44000,20
TIKI,nha-sach-tiki,162181800,"Cảm Ơn Anh Đã Đánh Mất Em - Bản Thường (Tặng Kèm 2 postcard)",70000,99000,29000,29
TIKI,nha-sach-tiki,186091870,"Fullmetal Alchemist - Cang Giả Kim Thuật Sư - Fullmetal Edition Tập 15 [Tặng Kèm Bookmark PVC]",62100,69000,6900,10
TIKI,nha-sach-tiki,626886,"Những Tấm Lòng Cao Cả",53100,80000,26900,34
TIKI,nha-sach-tiki,87959748,"451 Độ F",73800,99000,25200,25
TIKI,nha-sach-tiki,58695343,"Kỹ Năng Giao Tiếp Đỉnh Cao",66500,96000,29500,31
TIKI,nha-sach-tiki,193434488,"Kingdom -  Tập 32",32500,45000,12500,0
TIKI,nha-sach-tiki,71090268,"Ám Ảnh Từ Kiếp Trước - Bí Mật Của Sự Sống Và Cái Chết (Tái Bản 2020)",58100,89000,30900,35
TIKI,nha-sach-tiki,168662171,"Vừa Nhắm Mắt Vừa Mở Cửa Số",52000,75000,23000,31
TIKI,nha-sach-tiki,69644748,"Thiền Sư Và Em Bé 5 Tuổi",67100,120000,52900,44
TIKI,nha-sach-tiki,67491398,"Sách OSHO Từ Bi - Compassion",89100,128000,38900,30
TIKI,nha-sach-tiki,40933969,"Một Đời Quản Trị (Tái Bản)",121000,200000,79000,40
TIKI,nha-sach-tiki,73222800,"Nghĩ Giàu Và Làm Giàu (Khổ Nhỏ)",74000,108000,34000,31
TIKI,nha-sach-tiki,153521878,"Nhân Loại - Một Lịch Sử Tràn Đầy Hi Vọng",153000,245000,92000,38
TIKI,nha-sach-tiki,195885690,"Birdmen - Tập 6",29000,30000,1000,3
TIKI,nha-sach-tiki,140416373,"Hành Trình Về Phương Đông (Khổ Nhỏ)(Tái Bản)",54100,78000,23900,31
TIKI,nha-sach-tiki,63473605,"Ho’Oponopono: Sống Như Người Hawaii – Chấp Nhận, Biết Ơn Và Tha Thứ",80200,109000,28800,26
TIKI,nha-sach-tiki,377644,"Chờ Đến Mẫu Giáo Thì Đã Muộn",49000,69000,20000,29
TIKI,nha-sach-tiki,31509726,"Làm Bạn Với Bầu Trời (Bìa Mềm) (Tặng Kèm Khung Ảnh Số Lượng Có Hạn)",62000,110000,48000,44
TIKI,nha-sach-tiki,151994935,"Sói Đầu Đàn Và Cún Nhỏ - Tập 1",99300,128000,28700,22
TIKI,nha-sach-tiki,195357782,"Máy Tính CASIO FX-880BTG - Màu Xám",740000,800000,60000,8
TIKI,nha-sach-tiki,95218447,"Con Đường Chuyển Hóa - Kinh Bốn Lĩnh Vực Quán Niệm (Tái Bản)",61800,89000,27200,31
TIKI,nha-sach-tiki,45663008,"Ngày Xưa Có Một Con Bò…(Tái Bản)",48000,70000,22000,31
TIKI,nha-sach-tiki,155550600,"Sống Bán Nông Bán X - Tâm Lý Mới Về Cuộc Sống Điền Viên",96000,148000,52000,35
TIKI,nha-sach-tiki,49317816,"Cơ Thể Tự Chữa Lành",103000,160000,57000,36
TIKI,nha-sach-tiki,162865518,"Tôn Tử Binh Pháp (Tái Bản)",117000,160000,43000,27
TIKI,nha-sach-tiki,106863962,"Sách Bên Rặng Tuyết Sơn - Nguyên Phong (Tái Bản)",82100,118000,35900,30
TIKI,nha-sach-tiki,36363381,"Sao Chúng Ta Lại Ngủ",186800,249000,62200,25
TIKI,nha-sach-tiki,112106439,"GIẢI MÃ HÀNH VI ĐỌC VỊ CẢM XÚC",89800,129000,39200,30
TIKI,nha-sach-tiki,188548575,"Đời Muối: Lịch Sử Thế Giới",152000,235000,83000,35
TIKI,nha-sach-tiki,108715084,"Rio Book No.1 - Xấu Thế Nào, Đẹp Ra Sao - Bí Kíp Thẩm Định Thiết Kế Trong Marketing (Tái Bản Lần 6)",134000,175000,41000,23
TIKI,nha-sach-tiki,99513994,"Những Người Đàn Ông Không Có Đàn Bà (Tái Bản)",73000,100000,27000,27
TIKI,nha-sach-tiki,56697257,"Bí Mật Và Thực Tế Về Tự Kỉ Ám Thị (Self Mastery Through Conscious Autosuggestion) - Cuốn Sách Về Tự Kỉ Ám Thị Được Freud Và Các Bậc Thầy Phân Tâm Trích Dẫn Và Nghiên Cứu - Liệu Pháp Tự Chữa Lành Được Napoleon Hill Và Tony Robbin Sử Dụng Đều Xuất Phát Từ Đ",52700,83000,30300,37
TIKI,nha-sach-tiki,109862191,"Combo 8 cuốn: Bộ sách IQ vượt trội - IQ booster",49920,96000,46080,48
TIKI,nha-sach-tiki,76012203,"Cuộc Đời Là Một Tiểu Thuyết",104000,140000,36000,26
TIKI,nha-sach-tiki,173745189,"Clean Code – Mã Sạch Và Con Đường Trở Thành Lập Trình Viên Giỏi",244000,386000,142000,37
TIKI,nha-sach-tiki,69764534,"Thợ Xăm Ở Auschwitz",110000,148000,38000,26
TIKI,nha-sach-tiki,2126103,"Tazaki Tsukuru Không Màu Và Những Năm Tháng Hành Hương (Tái Bản 2018)",79000,106000,27000,25
TIKI,nha-sach-tiki,94173462,"Muôn Kiếp Nhân Sinh 2",192000,268000,76000,28
TIKI,nha-sach-tiki,66712456,"Trở Về Không - Trải Nghiệm Ho'oponopono - Thực Hiện Hóa Những Phép Màu Trong Cuộc Sống",118000,159000,41000,26
TIKI,nha-sach-tiki,194960730,"Nỗi buồn chiến tranh",86000,130000,44000,34
TIKI,nha-sach-tiki,107331062,"Khởi Nghiệp Kinh Doanh Online - Bán Hàng Hiệu Quả Trên Face.book",159000,199000,40000,20
TIKI,nha-sach-tiki,193446628,"Dragon Ball Full Color - Phần Năm: Truy Lùng Cell Bọ Hung Tập 3 [Tặng kèm Standee hoặc Postcard]",69100,77000,7900,10
TIKI,nha-sach-tiki,74686986,"Spy X Family Tập 2",25000,25000,0,0
TIKI,nha-sach-tiki,103550551,"Hung Khí Hoàn Mỹ",116000,150000,34000,23
TIKI,nha-sach-tiki,95220861,"Tuần Làm Việc 4 Giờ (Tái Bản)",80000,115000,35000,30
TIKI,nha-sach-tiki,117595535,"Kẻ Ngoại Cuộc",90000,123000,33000,27
TIKI,nha-cua-doi-song,252135037,"Giường xếp gấp gọn 6 chân đa năng SUMIKA 298, có nệm, 5 cấp độ điều chỉnh",769000,1200000,431000,36
TIKI,nha-cua-doi-song,252134180,"Giường xếp gấp gọn 4 chân đa năng SUMIKA 181, có nệm, 5 cấp độ điều chỉnh",869000,1580000,711000,45
TIKI,nha-cua-doi-song,262731552,"Giường xếp gấp gọn di động SUMIKA 386, khung thép, có bánh xe",1529000,2250000,721000,32
TIKI,nha-cua-doi-song,270466751,"Ghế ăn Tami, ghế nhựa đúc ngoài trời",1290000,1290000,0,0
TIKI,nha-cua-doi-song,270247452,"Ghế ăn đúc nguyên khối cổ điển dành cho quán cà phế, văn phòng",599000,599000,0,0
TIKI,nha-cua-doi-song,99868980,"Bình Giữ Nhiệt Locknlock Bucket Tumbler 540ml LHC4269WHT",284000,473000,189000,40
TIKI,nha-cua-doi-song,73124602,"Bình Giữ Nhiệt Bằng Thép Không Gỉ Lock&amp;Lock Vacuum Bottle LHC6180FU (800ML)",352000,677000,325000,48
TIKI,nha-cua-doi-song,58828647,"Xe đẩy hàng 4 bánh SUMIKA T150 - Khung thép, tay cầm gấp mở tiện lợi, tải trọng 150kg",880000,1350000,470000,35
TIKI,nha-cua-doi-song,83412126,"Bình Giữ Nhiệt Lock&Lock Energetic One-Touch Tumbler LHC3249 - 550ML",264000,528000,264000,50
TIKI,nha-cua-doi-song,270139577,"Chất Tăng Cứng Sàn Liquid Hardener HTS HARD+ thùng 6Kg - Tăng cứng, Chống bụi, Dùng được cho sàn Mác yếu",427500,450000,22500,5
TIKI,nha-cua-doi-song,129370124,"Hoá Chất Tăng Cứng Sàn Liquid Hardener HTS HARD+ thùng nhỏ 6Kg - Thi công 40m2 sàn",421800,444000,22200,5
TIKI,nha-cua-doi-song,53789448,"Bộ cây lau nhà tự vắt thông minh, chổi lau nhà 360 độ, lau sạch khô nhanh - Parroti Pro PR01",419000,799000,380000,48
TIKI,nha-cua-doi-song,223727594,"[Chính Hãng]Keo Chống Thấm TAIKO Trong Suốt Silicon 500 ml -Chống Thấm Gạch Lát Nền,Trần, Tường, Cửa Sổ, Vết Nứt Mái Nhà Triệt Để - Keo sau 72h mới khô hoàn toàn",110000,137500,27500,20
TIKI,nha-cua-doi-song,272888590,"Keo Chống Thấm TAIKO Trong Suốt Gốc Silicon 0.5 Kg , 1 Kg, Combo 2 Kg  -Chống Thấm Gạch Lát Nền,Trần, Tường, Cửa Sổ, Vết Nứt Mái Nhà Triệt Để",230340,349000,118660,34
TIKI,nha-cua-doi-song,253402833,"Móc gỗ treo tường Anzzar, móc treo quần áo, phụ kiện, giá gỗ treo quần áo-MT04",209000,220000,11000,5
TIKI,nha-cua-doi-song,94778000,"Ô Dù che nắng, che mưa, có nút bấm 2 chiều, hàng chất lượng, dễ thương, thiết kế sang trọng và bền bỉ, ô dù có lựa chọn màu sắc",196000,196000,0,0
TIKI,nha-cua-doi-song,214131948,"Vải Polyester Phủ Chống Thấm Mái Nhà Tường Nhà Khe Nứt Tiện Dụng Đa Năng Khổ 1m",331500,390000,58500,15
TIKI,nha-cua-doi-song,58804363,"Dụng Cụ Băm Rau Củ Quả Lock&amp;Lock Quick Chopper CKS310BLU",112000,216000,104000,48
TIKI,nha-cua-doi-song,185380333,"Keo Sơn Chống Thấm Dột 1 Thành Phần TAIKOMI CT4 - Chuyên Xử Lý Chống Thấm Ngược, Môi Trường Ẩm, Bể Âm, Hố Thang Máy, Nhà Vệ Sinh - Thùng 1 Lít",254800,320000,65200,20
TIKI,nha-cua-doi-song,249206732,"Bàn cafe Tulip mặt tròn",1790000,1790000,0,0
TIKI,nha-cua-doi-song,2119173,"Cây Lau Nhà Dạng Xịt Nước Lock&Lock ETM472",280000,539000,259000,48
TIKI,nha-cua-doi-song,186558014,"Combo 10 Móc Dán Tường Treo Đồ Đa Năng Siêu Chịu Lực",25000,25000,0,0
TIKI,nha-cua-doi-song,71890908,"Bộ lau nhà xoay 360 độ Sunhouse KS-CL330S",231000,406000,175000,43
TIKI,nha-cua-doi-song,33067171,"Áo mưa dây kéo vải dù tổ ong chống thấm ( nhiều màu)",95000,95000,0,0
TIKI,nha-cua-doi-song,104270135,"Bình Giữ Nhiệt LocknLock Featherlight One-touch Tumbler 500ml LHC3257WHT - Màu trắng",269000,517000,248000,48
TIKI,nha-cua-doi-song,169848307,"Kệ Wifi Treo Tường 2 Tầng Không Cần Khoan Để Đầu Thu Kỹ Thuật Số, Remote, Điện Thoại - IG407",56000,60000,4000,7
TIKI,nha-cua-doi-song,54484578,"Đèn Bàn Học LED USB Di Động Cao Cấp Có Thể Gập Hai Chỗ – 03 Chế Độ Ánh Sáng Vàng Bảo Vệ Mắt Chống Cận eLights - Đèn Cắm Dây",185000,199000,14000,7
TIKI,nha-cua-doi-song,185380360,"[Hàng Chính Hãng - BH 2 Năm]Keo Sơn Chống Thấm Sàn Mái TAIKO NITTON - Thùng 10 Lít",1485000,1500000,15000,1
TIKI,nha-cua-doi-song,1657931,"Vợt Muỗi Sunhouse SHE-E200 - Vàng",72000,119000,47000,39
TIKI,nha-cua-doi-song,56941523,"Ly nhựa 2 lớp LocknLock kèm ống hút HAP507 750ml",113000,217000,104000,48
TIKI,nha-cua-doi-song,99621372,"Bình giữ nhiệt Lock&amp;Lock Belt Bottle LHC4267IVY490ml - Màu",284000,473000,189000,40
TIKI,nha-cua-doi-song,184126392,"Bình giữ nhiệt 450ml kèm cốc đẹp lõi INOX 304 cao cấp giữ nhiệt tới 8 tiếng chống tràn có cốc uống, có thể dùng làm quà tặng độc đáo",72995,72995,0,0
TIKI,nha-cua-doi-song,71178441,"Áo Mưa Bít Dù Trơn, Áo Mưa Kín Người Vải Dù Siêu Dày, Chống Thấm Hiệu Quả, Phù Hợp Nam Và Nữ, Có Túi Đựng, Có Lựa Chọn Màu Sắc",115000,115000,0,0
TIKI,nha-cua-doi-song,73125530,"Hộp cơm thủy tinh kèm muỗng đũa LocknLock LLG991CLNVY 930ml - Màu Navy",188000,362000,174000,48
TIKI,nha-cua-doi-song,99994000,"Bình giữ nhiệt có ống hút Lock&Lock Bucket Tumbler with Straw LHC4268 540ml - Màu",284000,473000,189000,40
TIKI,nha-cua-doi-song,122692850,"Cây chà sàn thông minh cao cấp, chổi chà sàn đa năng 2 trong 1, cọ sàn và gạt nước – Parroti Easy ES02",129000,199000,70000,35
TIKI,nha-cua-doi-song,11488920,"Bình Giữ Nhiệt Lock&Lock RigaTumbler (Shanghai) LHC4160RED  897ml - màu Red",372000,715000,343000,48
TIKI,nha-cua-doi-song,84566545,"Ổ cắm điện đa năng kết hợp ổ cắm USB Nakagami chất lượng cao công nghệ Nhật Bản - Màu ngẫu nhiên",159000,159000,0,0
TIKI,nha-cua-doi-song,48045630,"5 Viên Pin Smartkey - Cmos Panasonic CR2032 - Hàng Chính Hãng",80000,100000,20000,20
TIKI,nha-cua-doi-song,75614459,"Thùng rác treo tủ bếp có nắp đậy thông minh, thùng rác treo tường dán tường, có thanh trượt cửa bếp – Parroti Bin BN01/BIN01",299000,299000,0,0
TIKI,nha-cua-doi-song,92453371,"Áo Mưa Cánh Dơi Có Kiếng Đèn, Áo Mưa Kiếng Đèn Vải Dù Loại Siêu Dày, Hàng Việt Nam, Khổ To Rộng, Chống Thấm Hiệu Quả, Phù Hợp Nam Và Nữ, Có Túi Đựng, Có Lựa Chọn Màu Sắc",130000,130000,0,0
TIKI,nha-cua-doi-song,273624233,"Bình giữ nhiệt LocknLock Metro Two Way LHC4272/LHC4274 - Hàng chính hãng",315000,605000,290000,48
TIKI,nha-cua-doi-song,90531871,"Đèn Pixar, Đèn Bàn Học Chống Cận Thị, Đèn Đọc Sách, Đèn Làm Việc Bảo Vệ Mắt - Hàng Chính Hãng Moontronics",139000,139000,0,0
TIKI,nha-cua-doi-song,52574827,"Ô (dù) tự động 2 chiều cao cấp DandiHome chống UV",104500,110000,5500,5
TIKI,nha-cua-doi-song,107961500,"Ly Nhựa 2 Lớp LocknLock Double Wall Cold Cup Cherry Blossom 750ml HAP509WHT - Màu",130000,217000,87000,40
TIKI,nha-cua-doi-song,92521124,"Ủng Bọc Giày Đi Mưa Chống Nước Có Đế Chống Trơn Trượt Cao Cấp",39900,39900,0,0
TIKI,nha-cua-doi-song,17423771,"5 Viên Pin CR2032 3V Panasonic Lithium thay pin Smartkey , Cmos , Pin thay Airtag - Hàng chính hãng",77000,100000,23000,23
TIKI,nha-cua-doi-song,2119169,"Bộ Cây Lau Nhà Lock&Lock Squeeze Flat Mop ETM471",509000,979000,470000,48
TIKI,nha-cua-doi-song,46202190,"Combo nhiều túi lưới giặt đồ cho máy giặt bảo vệ quần áo chống biến dạng chất lượng tốt dây kéo lưới mịn Polyester",42000,42000,0,0
TIKI,nha-cua-doi-song,187636657,"Keo Dán Giày Đa Năng Dán Mọi Loại Giày, Chống Thấm",45000,45000,0,0
TIKI,nha-cua-doi-song,173211404,"Ghế Xoay Văn Phòng Ngồi Làm Việc Công Thái Học Deli - Tay Gập Thông Minh, Có Ngả Lưng, Lưới Thoáng Khí, Chân Xoay Tiện Ích, Đệm Ghế Êm Aí - Phù Hợp Học Sinh, Văn Phòng, Game Thủ, Gaming - Hàng Chính Hãng - E4928 / E4929 / E4925 / E4926G",886000,1618200,732200,45
TIKI,nha-cua-doi-song,116819040,"Thước Dây 1,5m - YOGA QG, Thước Dây May Má, Đo Chiều Cao Cho Bé, Đo Kích Thước Ba Vòng",9999,9999,0,0
TIKI,nha-cua-doi-song,892121,"Pin Max 8 + 4 Viên Energizer E91 BP8+4 AA",152000,180000,28000,16
TIKI,nha-cua-doi-song,3480627,"Bộ Cây Lau Nhà Xoay Tay Compact Spin Mop Lock&Lock ETM466: Thùng Giặt + Cây + Bông Lau",480000,924000,444000,48
TIKI,nha-cua-doi-song,120552065,"Bình giữ nhiệt inox 304 Elmich EL-8013OL dung tích 480ml",139000,389000,250000,64
TIKI,nha-sach-tiki,274566783,"Siêu Nhí Hỏi Nhà Khoa Học Trả Lời - 100 Bí Ẩn Mọi Đứa Trẻ Đều Muốn Hỏi Một Nhà Khoa Học",173000,173000,0,0
TIKI,nha-sach-tiki,130996088,"Câu Chuyện Ngôn Ngữ",116000,160000,44000,28
TIKI,nha-sach-tiki,129381098,"Tiếp Thị 5.0: Công Nghệ Vị Nhân Sinh",82500,120000,37500,31
TIKI,nha-sach-tiki,77900454,"Bí Mật Của Nước (Tái Bản)",63600,89000,25400,29
TIKI,nha-sach-tiki,197558899,"Anime Comics: One Piece Film Z - Tập 1",68300,77000,8700,11
TIKI,nha-sach-tiki,394434,"Giấy Excel A4 DL70",62000,62000,0,0
TIKI,nha-sach-tiki,93734071,"Trí Thông Minh Trên Giường",130000,219000,89000,41
TIKI,nha-sach-tiki,154160965,"Thần Thoại Hy Lạp (Tái Bản)",169000,255000,86000,34
TIKI,nha-sach-tiki,186578227,"Những kẻ cuồng nhạc Musicophilia – Tales of music and the brain",177000,230000,53000,23
TIKI,nha-sach-tiki,197119849,"Chuông Gió (Tập 3)",135000,174000,39000,22
TIKI,nha-sach-tiki,87959745,"Hạnh Phúc Là Con Đường",115000,155000,40000,26
TIKI,nha-sach-tiki,72744612,"Nghề Thầy",52000,70000,18000,26
TIKI,nha-sach-tiki,17881046,"Trầm lặng - Sức mạnh tiềm ẩn của người hướng nội",88100,130000,41900,32
TIKI,nha-sach-tiki,189657049,"One Piece - Tập 99",25000,25000,0,0
TIKI,nha-sach-tiki,72680632,"Năng Lực Tìm Kiếm",60400,91000,30600,34
TIKI,nha-sach-tiki,90985718,"Càng Mạnh Mẽ, Càng Dịu Dàng (Tái Bản)",67800,99000,31200,32
TIKI,nha-sach-tiki,97561438,"Thế Giới Quả Là Rộng Lớn Và Có Rất Nhiều Việc Phải Làm (Tái Bản)",92620,139000,46380,33
TIKI,nha-sach-tiki,100947276,"Ung Thư - Sự Thật, Hư Cấu, Gian Lận Và Những Phương Pháp Chữa Bệnh Không Độc Hại (Tái Bản)",114000,169000,55000,33
TIKI,nha-sach-tiki,53722909,"Combo Trinh Thám Trung Quốc: Phục Thù (2 tập)",95000,225000,130000,58
TIKI,nha-sach-tiki,192048665,"Vỡ lòng về tiền tệ - Money for Beginners",112000,150000,38000,25
TIKI,nha-sach-tiki,39228816,"Kỹ Thuật Giao Dịch Để Kiếm Tiền Hàng Ngày Trên Thị Trường Chứng Khoán – Day Trade For A Living",298000,298000,0,0
TIKI,nha-sach-tiki,113540577,"Anne Tóc Đỏ Dưới Chái Nhà Xanh",92300,119000,26700,22
TIKI,nha-sach-tiki,133599625,"Spy X Family Tập 6",25000,25000,0,0
TIKI,nha-sach-tiki,194960245,"Migi & Dali -Tập 1",37100,40000,2900,7
TIKI,nha-sach-tiki,197558902,"Anime Comics: One Piece Film Z - Tập 2",68300,77000,8700,11
TIKI,nha-sach-tiki,194104223,"Quán Rượu Dị Giới "Nobu" - Tập 10",28100,40000,11900,30
TIKI,nha-sach-tiki,193590152,"Méthode Rose - Phương pháp hồng 1 - Năm thứ nhất với đàn piano - Giáo trình dạy piano nổi tiếng của Pháp",97000,150000,53000,35
TIKI,nha-sach-tiki,96616370,"Con Đường Trở Thành Freelance Writer - Tôi Đã Kiếm 800.000.000 Một Năm Từ Viết Lách Như Thế Nào? (Tái Bản)",164000,220000,56000,25
TIKI,nha-sach-tiki,184466862,"Trưởng Thành Là Khi Nỗi Buồn Cũng Có Deadline",65000,88000,23000,26
TIKI,nha-sach-tiki,193605362,"Ali Và NiNo",97000,125000,28000,22
TIKI,nha-sach-tiki,168662558,"CCMR. Phải Trái Đúng Sai",92000,155000,63000,41
TIKI,nha-sach-tiki,125776045,"Giấy in photo A4 IK Copy IK-01 - Định lượng 70 gsm - 500 tờ/ream - giấy chất lượng cao nhập khẩu Indonesia",70000,110000,40000,36
TIKI,nha-sach-tiki,274607551,"Lời Nói Thần Kỳ Nuôi Dưỡng Những Đứa Trẻ Hạnh Phúc: 0 - 6 Tuổi",61100,61800,700,1
TIKI,nha-sach-tiki,77621607,"Spy X Family Tập 3",24300,25000,700,3
TIKI,nha-sach-tiki,192909291,"Văn Phòng Thám Tử Quái Vật - Tập 10",21000,30000,9000,30
TIKI,nha-sach-tiki,21130354,"Vòng Tròn Máu - Trinh Thám Cổ Điển Anh",72000,102000,30000,29
TIKI,nha-sach-tiki,178294073,"Trading in The Zone - Thực Hành Kiểm Soát Cảm Xúc bằng Tâm Lý Học Hành Vi trong Đầu Tư và Giao Dịch",295000,295000,0,0
TIKI,nha-sach-tiki,191045565,"Cô Gái Mặc Váy Tím",73600,95000,21400,23
TIKI,nha-sach-tiki,55506686,"Tiktok Marketing",92600,139000,46400,33
TIKI,nha-sach-tiki,193896563,"Cô Bạn Tôi Thầm Thích Lại Quên Mang Kính Rồi - Tập 2 [Tặng Kèm Standee Ivory]",37100,38000,900,2
TIKI,nha-cua-doi-song,252135037,"Giường xếp gấp gọn 6 chân đa năng SUMIKA 298, có nệm, 5 cấp độ điều chỉnh",769000,1200000,431000,36
TIKI,nha-cua-doi-song,270247452,"Ghế ăn đúc nguyên khối cổ điển dành cho quán cà phế, văn phòng",599000,599000,0,0
TIKI,nha-cua-doi-song,270466751,"Ghế ăn Tami, ghế nhựa đúc ngoài trời",1290000,1290000,0,0
TIKI,nha-cua-doi-song,252134180,"Giường xếp gấp gọn 4 chân đa năng SUMIKA 181, có nệm, 5 cấp độ điều chỉnh",869000,1580000,711000,45
TIKI,nha-cua-doi-song,262731552,"Giường xếp gấp gọn di động SUMIKA 386, khung thép, có bánh xe",1529000,2250000,721000,32
TIKI,nha-cua-doi-song,21441057,"Chảo Chống Dính Đá Sunhouse SBD18 - 18cm",187000,260000,73000,28
TIKI,nha-cua-doi-song,122700651,"Cây lau kính, gạt chùi kính đa năng 2 đầu trong 1 - Parroti Shiny SN01",129000,199000,70000,35
TIKI,nha-cua-doi-song,146262084,"Gối Ngủ Memory Foam NOOZ Ruột Gối Cao Su Non Giúp Nâng Đỡ Đốt Sống Cổ Chống Đau Vai Gáy Ngủ Sâu Hỗ Trợ Chống Trào Ngược Phù Hợp Với Mọi Tư Thế Nằm Vỏ Gối Tencel",339000,560000,221000,39
TIKI,nha-cua-doi-song,78025846,"Khăn tắm Bamboo Life BL058 hàng chính hãng được làm từ sợi tre thiên nhiên mềm mại kháng khuẩn siêu thấm hút an toàn cho da",59000,59000,0,0
TIKI,nha-cua-doi-song,129370124,"Hoá Chất Tăng Cứng Sàn Liquid Hardener HTS HARD+ thùng nhỏ 6Kg - Thi công 40m2 sàn",421800,444000,22200,5
TIKI,nha-cua-doi-song,270139577,"Chất Tăng Cứng Sàn Liquid Hardener HTS HARD+ thùng 6Kg - Tăng cứng, Chống bụi, Dùng được cho sàn Mác yếu",427500,450000,22500,5
TIKI,nha-cua-doi-song,147265074,"Vỉ 2 VPin AA , Pin AAA DURACELL 1,5V Siêu Bền - Hàng chính hãng",30000,30000,0,0
TIKI,nha-cua-doi-song,119195755,"Bộ lau nhà tự vắt thông minh, chổi lau nhà 360 độ, lau sạch khô nhanh - Parroti ProMax PX01",519000,849000,330000,39
TIKI,nha-cua-doi-song,249206732,"Bàn cafe Tulip mặt tròn",1790000,1790000,0,0
TIKI,nha-cua-doi-song,177610565,"Đèn Pin Siêu Sáng US ARMY Mã XML-T6 Cao Cấp Vỏ Hợp Kim Chống Nước Sử Dụng Pin Có Thể Sạc Lại Tặng Hộp Full Box- HÀNG CHÍNH HÃNG",108000,258000,150000,58
TIKI,nha-cua-doi-song,185380306,"[Hàng Chính Hãng - BH 2 Năm]Keo Sơn Chống Thấm Sàn Mái TAIKO NITTON - Thùng 5 Lít - Tặng Kèm Vải Kết Cấu",883500,930000,46500,5
TIKI,nha-cua-doi-song,165013585,"Ổ Cắm Điện Dài VINAVU Kèm Cổng USB Công Tắc Riêng Chịu Tải 2500W, Chống Giật, Chống Cháy",199000,199000,0,0
TIKI,nha-cua-doi-song,54145105,"Cọ Bồn Cầu Toilet, Cọ Vệ Sinh Cao Cấp - Parroti Silicon SL01 – Có Bình Đựng Nước Tẩy, Cây Gắp Tóc Tiện Dụng",88000,89000,1000,1
TIKI,nha-cua-doi-song,185380333,"Keo Sơn Chống Thấm Dột 1 Thành Phần TAIKOMI CT4 - Chuyên Xử Lý Chống Thấm Ngược, Môi Trường Ẩm, Bể Âm, Hố Thang Máy, Nhà Vệ Sinh - Thùng 1 Lít",254800,320000,65200,20
TIKI,nha-cua-doi-song,120759154,"Bó 100 Dây Thít, Dây Rút, Lạt Nhựa Đủ Mọi Kích Cỡ Tiện Lợi",24000,30000,6000,20
TIKI,nha-cua-doi-song,1399571,"Gối Memory Foam 50D Hình Cong Lock&Lock HLW111 (50 x 30 cm) - Trắng",290000,483000,193000,40
TIKI,nha-cua-doi-song,182971940,"Bình giữ nhiệt LocknLock có 2 nắp thay thế New Clip Tumbler 540ml LHC4279",270000,520000,250000,48
TIKI,nha-cua-doi-song,92385690,"Áo Mưa Cánh Dơi 2 Đầu Vải Dù Loại Siêu Dày, Hàng Việt Nam Chất Lượng Cao, Khổ To Rộng Phù Hợp Cho 2 Người, An Toàn Cho Người Sử Dụng, Có Túi Đựng Dễ Bảo Quản.",140000,140000,0,0
TIKI,nha-cua-doi-song,119007194,"Thanh 4 Móc Treo Dán Tường, Móc Treo Đồ Đa Năng Parroti Handy HD41",21900,36000,14100,39
TIKI,nha-cua-doi-song,106457363,"Túi Giữ Nhiệt Đựng Hộp Cơm 2 Ngăn – Chọn Màu Túi Giữ Nhiệt Đựng Cặp Lồng Cơm – Nhiều Màu – Chống Thấm Nước Chính Hãng",45000,70000,25000,36
TIKI,nha-cua-doi-song,84886093,"Vợt muỗi thông minh 3in1 SUNHOUSE SHE-PRO11.W",208000,344000,136000,40
TIKI,nha-cua-doi-song,214131948,"Vải Polyester Phủ Chống Thấm Mái Nhà Tường Nhà Khe Nứt Tiện Dụng Đa Năng Khổ 1m",331500,390000,58500,15
TIKI,nha-cua-doi-song,58828647,"Xe đẩy hàng 4 bánh SUMIKA T150 - Khung thép, tay cầm gấp mở tiện lợi, tải trọng 150kg",880000,1350000,470000,35
TIKI,nha-cua-doi-song,32328782,"Phin Nhôm Cà Phê Tráng Men Đen Trung Nguyên  ",79000,79000,0,0
TIKI,nha-cua-doi-song,195853999,"[Hàng Chính Hãng - BH 2 Năm]Keo Chống Thấm PU (Polyurethane) Taikomi PU95 Thùng 18 Lít - Xử lý chống thấm nền gạch, bề mặt bê tông",2533000,2980000,447000,15
TIKI,nha-cua-doi-song,57867024,"Bộ Lau Nhà Xoay 360 Độ Sunhouse Ks-Cl350PO",337000,513000,176000,34
TIKI,nha-cua-doi-song,119203295,"Combo 5 Khăn Lau Bếp, Lau Kính Siêu Thấm Hút Parroti - Fiber FB02",47000,89000,42000,47
TIKI,nha-cua-doi-song,52504270,"Chiếu Mây Điều Hòa Cao Cấp Loại dày",169000,230000,61000,27
TIKI,nha-cua-doi-song,183907622,"Cây Lăn Bụi Quần Áo, Ghế Sofa - Tặng Kèm 2 lõi lăn",31000,55000,24000,44
TIKI,nha-cua-doi-song,241804451," Móc INOX 304 Treo Đồ nặng, treo thớt, nồi niêu INOX 304 [CHỐNG NƯỚC, CHỐNG RỈ] Dán Mọi Bề Mặt",15000,15000,0,0
TIKI,nha-cua-doi-song,1024190,"Bộ 3 Hộp Cơm Giữ Nhiệt Lock&amp;Lock Mushroom LHC8025SLV - Bạc",524000,1007000,483000,48
TIKI,nha-cua-doi-song,185756654,"Cây chà sàn nhà tắm Kitimop-Z4 chổi cọ sàn và gạt nước đa năng 2 trong 1, cọ sạch khe hẹp và góc tường",49000,75000,26000,35
TIKI,nha-cua-doi-song,94724913,"Ron Dán Che Khe Cửa ,Chân Cửa,Khung Cửa CTFAST Chống Bụi, Ngăn Côn Trùng, Chống Ồn, Chống Thoát Nhiệt Điều Hòa, Chống Va Đập Cửa - Mẫu Cải Tiến 2021 ( Hàng Chính Hãng )",49000,68000,19000,28
TIKI,nha-cua-doi-song,119030223,"Keo Dán Giày, Gỗ, Nhựa, Sứ Siêu Dính Chống Thấm Đa Năng Deli - 7Ml / 20Ml - 7140 / 7149",8000,16200,8200,51
TIKI,nha-cua-doi-song,52756206,"1kg Túi Đựng Rác Tự Phân Hủy Sinh Học Gimex II (full size)",28000,28000,0,0
TIKI,nha-cua-doi-song,143841853,"Bình Giữ Nhiệt Coffee Bugu Mini Inox 304 LI-02 – Hàng Chính Hãng",108000,150000,42000,28
TIKI,nha-cua-doi-song,253402833,"Móc gỗ treo tường Anzzar, móc treo quần áo, phụ kiện, giá gỗ treo quần áo-MT04",209000,220000,11000,5
TIKI,nha-cua-doi-song,73147684,"Thanh xốp gắn chân cửa chống kẹt chân cho bé, bịt khe hở, chắn gió, chặn côn trùng",8000,13999,5999,43
TIKI,nha-cua-doi-song,71924330,"Bộ Chổi Quét Nhà Lock&Lock Gồm Cây Chổi và Dụng Cụ Hốt ETM465",257000,428000,171000,40
TIKI,nha-cua-doi-song,163550425,"Nệm Bông Gòn Xuất Nhật, Nệm Trải Sàn Tiện Lợi, Đệm Văn Phòng Size 1m x 2m; 1.4m x 2m; 1.6m x 2m",387000,500000,113000,23
TIKI,nha-cua-doi-song,147265074,"Vỉ 2 VPin AA , Pin AAA DURACELL 1,5V Siêu Bền - Hàng chính hãng",30000,30000,0,0
TIKI,nha-cua-doi-song,181410158,"Bàn Làm Việc Đa Năng Decor Phong Cách Gaming Thương Hiệu IGA - GM62",293000,320000,27000,8
TIKI,nha-cua-doi-song,185910176,"Giấy Nến Vàng Lót Nồi Chiên Không Dầu Sạch Sẽ Tiện Dụng An Toàn Cho Sức Khỏe - 1 set 50 Tờ",85000,85000,0,0
TIKI,nha-cua-doi-song,186627908,"Ghế Gác Chân Công Thái Học Ergonomic Footrest, Ghế Kê Chân Ghế Gác Chân Văn Phòng",189000,280000,91000,33
TIKI,nha-cua-doi-song,112321595,"Đèn Học Chống Cận Thị, Đèn Đọc Sách, Đèn Làm Việc Để Bàn Chống Chói Mắt Lóa Mắt Bảo Vệ Mắt Chống Cận Thị, Cảm Ứng Siêu Sáng - VinBuy",164000,300000,136000,45
TIKI,nha-cua-doi-song,57806524,"Áo Mưa Bộ Vải Dù Cao Cấp Cho Bé Từ 3 -10 Tuổi, Chống Thấm, Che Kín Người An Toàn Cho Bé, Lựa Chọn Màu Sắc Phù Hợp Giới Tính (Giao Màu - Mẫu Ngẫu Nhiên)",110000,110000,0,0
TIKI,nha-cua-doi-song,115092053,"Bộ ga giường poly cotton LIDACO drap giường đủ size nệm 1m2, 1m4, 1m6, 1m8",119000,120000,1000,1
TIKI,nha-cua-doi-song,138952791,"Móc Treo Cây Lau Nhà Dán Tường Đa Năng Chịu Lực Tốt, 2 Trong 1 - Parroti Keeper KP03",22900,42000,19100,45
TIKI,nha-cua-doi-song,892141,"Pin Max 8 + 4 Viên Energizer E92 BP8+4 AAA",152000,180000,28000,16
TIKI,nha-cua-doi-song,98562149," 328 Cái Ống Co Nhiệt Cách Nhiệt Ống Co Phân Loại Điện Tử",28989,28989,0,0
TIKI,nha-cua-doi-song,1651191,"Kệ Đỡ Màn Hình Máy Tính Monitor Stand Walnut Plyconcept MSM01003 (490 x 200 mm) - Nâu Đậm",290000,380000,90000,24
TIKI,nha-cua-doi-song,104680895,"Cây Lau Nhà Đơn MyJae Sợi Microfiber Xoay 360 Độ Phù Hợp Cho Nhiều Loại Thùng Lau 134cm",199000,330000,131000,40
TIKI,nha-cua-doi-song,153066085,"Pin CR2032 Lithium 3V Maxell cao cấp Made In Japan - Hàng chính hãng",26000,30000,4000,13
TIKI,nha-cua-doi-song,58357614,"Đèn bắt muỗi, ruồi và các loại côn trùng Con Dơi",390000,390000,0,0
TIKI,nha-cua-doi-song,184245786,"Túi đựng hộp cơm giữ nhiệt, túi đựng đồ ăn trưa văn phòng có lớp lót nhôm giữ nhiệt dày dặn, kích thước lớn tiện lợi",59000,59000,0,0
TIKI,nha-cua-doi-song,273244363,"Kệ Sách Gỗ 5 Tầng, Giá Sách Đứng Cạnh Bàn Làm Việc - GP189",318000,346000,28000,8
TIKI,nha-cua-doi-song,64988886,"Bình giữ nhiệt Lock&amp;Lock Flat nắp gỗ 400ml - LHC4227WHT - Màu",278000,534000,256000,48
TIKI,nha-cua-doi-song,52484490,"Keo Dán Chống Thấm Siêu Dính Nhật Bản Bosui Dài 5m ",13000,14999,1999,13
TIKI,nha-cua-doi-song,14681534,"Bộ tua vít sửa chữa đồng hồ điện thoại",31160,32800,1640,5
TIKI,nha-cua-doi-song,173732608,"Combo Khăn Lau Đa Năng 2 Mặt Siêu Thấm , Khăn Lau Bếp , Khăn Lau Kính , Khăn Lau Chén Bát , Khăn Lau Tay , Khăn Lau Ô Tô PaKaSa",38000,38000,0,0
TIKI,nha-cua-doi-song,122911188,"Găng tay cao su siêu dai rửa bát, bao tay cao su rửa chén, vệ sinh nhà cửa, an toàn, không mùi hôi Parroti Active AT01",47000,89000,42000,47
TIKI,nha-cua-doi-song,200960836,"Dây Đèn Led Fairy Light Trang Trí Giáng Sinh Biểu Tượng Cây Thông, Người Tuyết, Ông Già Noel - Chính Hãng NAVIVU",79000,79000,0,0
TIKI,nha-cua-doi-song,162548473,"Hộp Đựng Giày Nhựa Cứng Cao Cấp Size Lớn Cửa Nam Châm Lắp Ráp Tiện Lợi Song Anh- Hàng Chính Hãng",95000,95000,0,0
TIKI,nha-cua-doi-song,46163430,"Sáo Recorder Soprano Yamaha YRS-24B Tone C (Đô) - Kèm Móng Gảy DreamMaker",129000,129000,0,0
TIKI,nha-cua-doi-song,71206737,"Đèn Pin Laser 303 - Hàng Chính Hãng",133400,145000,11600,8
TIKI,nha-cua-doi-song,75664370,"GỐI MỀN BIỆT ĐỘI RU NGỦ 3 IN 1 - BỘ CHĂN GỐI VĂN PHÒNG SIÊU MỊN -MẪU 2021",199000,199000,0,0
TIKI,nha-cua-doi-song,117353723,"Chiếu ngủ văn phòng cao cấp",45000,45000,0,0
TIKI,nha-cua-doi-song,174236741,"Găng tay cao su tự nhiên Lock&amp;Lock ETM830 (có móc treo)",31000,56000,25000,45
TIKI,nha-cua-doi-song,2153015,"Bộ Vít 24 Món Xiaomi Wiha Precision Screwdriver",399000,490000,91000,19
TIKI,nha-cua-doi-song,119112667,"Combo 2 Miếng Lau Nhà Parroti ProMAX - Kích Thước 38 x12 CM",85000,145000,60000,41
TIKI,nha-cua-doi-song,44620765,"Đèn Pin Led Siêu Sáng Mini Có Sạc USB Có Hỗ Trợ Sạc Dự Phòng Lại Cho Điện Thoại Khẩn Cấp - Hàng Chính Hãng",85000,129000,44000,34
TIKI,nha-cua-doi-song,149617968,"Thùng đựng gạo thông minh M&L Royalcare 6068 - bao gồm khay đựng ngũ cốc - chống ẩm mốc côn trùng - đồ gia dụng tiện ích",469000,469000,0,0
TIKI,nha-cua-doi-song,177969021,"Bộ Hộp Cơm Giữ Nhiệt 2GOOD Lunch Box HC02 (2000ml) - Kèm Muỗng và Đũa Inox 304",590000,590000,0,0
TIKI,nha-cua-doi-song,63051860," Đèn Học Làm Việc Đọc Sách Để Bàn Pixar Chống Cận Thị Bảo Vệ Mắt - Hàng Chính Hãng eLights",159000,219000,60000,27
TIKI,nha-cua-doi-song,165256438,"Khăn mặt sợi tre Bamboo&Love 30x50 mềm mại kháng khuẩn siêu thấm hút an toàn cho da ngay cả với trẻ sơ sinh",23700,23900,200,1
TIKI,nha-cua-doi-song,148713415,"Tua Vít Cầm Tay Nhỏ Gọn, Tiện Dụng Lắp Ráp Và Sửa Chữa Vật Dụng Gia Đình (5mmx155mm)",27000,27000,0,0
TIKI,nha-cua-doi-song,131407951,"Bàn làm việc bàn hoc chữ k",372240,396000,23760,6
TIKI,nha-cua-doi-song,110001215,"Nẹp Dây Điện Dán Tường Siêu Dính ,Kẹp Dây Điện Cố Định Và Giữ Dây Điện Siêu Sốc an toàn tiện lợi dễ lắp đặt",11699,11699,0,0
TIKI,nha-cua-doi-song,127031393,"Ca nước giữ nhiệt LocknLock Metro Mug LHC4219MIT 475ml - Màu",304000,506000,202000,40
TIKI,nha-cua-doi-song,149573787,"Thùng rác thông minh cảm ứng tự động M&L-FH-2 phong cách Hàn Quốc",479000,479000,0,0
TIKI,nha-cua-doi-song,128969410,"Kệ Sách Để Bàn, Giá Sách Thiết Kế Hiện Đại Thương Hiệu IGA - GP157",187000,205000,18000,9
TIKI,nha-cua-doi-song,118858137,"Nạo Gọt Rau Củ Quả  Inox 304 Hàng Cao Cấp - Mua 1 Lần Dùng Mãi Mãi",70000,70000,0,0
TIKI,nha-cua-doi-song,2151853,"Ly Giữ Nhiệt Lock&Lock Swing Tumbler LHC4138SLV",374000,623000,249000,40
TIKI,nha-cua-doi-song,57999394,"Bộ Ga Gối Cotton Đũi Tici LIDACO Cao Cấp - Xanh Mint",149000,220000,71000,32
TIKI,nha-cua-doi-song,36560504,"Bình Nước Lock&Lock One Touch ABF687LPIK 500ml",151000,290000,139000,48
TIKI,nha-cua-doi-song,138507381,"Chai xịt chuột thái land rat off",83000,83000,0,0
TIKI,nha-cua-doi-song,10227148,"Dụng Cụ Mài Dao 3 Lớp Lock&Lock CKK112 (245 x 53 x 72 mm)",165000,275000,110000,40
TIKI,nha-cua-doi-song,52187161,"Giá Treo Ổ Điện Dán Tường Tiết Kiệm Không Gian",6000,9000,3000,33
TIKI,nha-cua-doi-song,104110135,"Bàn chải nhà tắm, cọ bồn rửa Parroti Clever CR01",55000,99000,44000,44
TIKI,nha-cua-doi-song,75615959,"Combo 5 khăn lau đa năng siêu thấm hút, khăn size lớn (30x40 cm) khăn lau kính, ô tô, mặt bàn, bếp Parroti Fiber FB01",48000,89000,41000,46
TIKI,nha-sach-tiki,637390,"Tuần Của Bé - Bé Thông Minh",21850,23000,1150,5
TIKI,nha-sach-tiki,93249197,"22 Quy Luật Bất Biến Trong Marketing",53100,78000,24900,32
TIKI,nha-sach-tiki,20444622,"Cẩm Nang Cấu Trúc Tiếng Anh",63000,98000,35000,36
TIKI,nha-sach-tiki,197634260,"Black Jack - Tập 14",30000,30000,0,0
TIKI,nha-sach-tiki,80960198,"Thiên Tài Bên Trái, Kẻ Điên Bên Phải (Tái Bản 2021)",121000,179000,58000,32
TIKI,nha-sach-tiki,197990871,"Doraemon Movie Story: Nobita Và Hòn Đảo Diệu Kì - Cuộc Phiêu Lưu Của Loài Thú",30000,30000,0,0
TIKI,nha-sach-tiki,197990867,"Doraemon Movie Story: Nobita Và Viện Bảo Tàng Bảo Bối",30000,30000,0,0
TIKI,nha-sach-tiki,174444205,"Dịch Vụ Đặc Biệt: Dọn Dẹp Nhà Cho Người Chết",71300,99000,27700,28
TIKI,nha-sach-tiki,56218385,"Thông Điệp Của Nước (Tái Bản 2020)",59100,89000,29900,34
TIKI,nha-sach-tiki,381234,"Cuốn Sách Hoàn Hảo Về Ngôn Ngữ Cơ Thể - Body Language (Tái Bản)",149000,198000,49000,25
TIKI,nha-sach-tiki,54624820,"Sức Mạnh Của Tĩnh Lặng (Tái Bản 2020)",46500,68000,21500,32
TIKI,nha-sach-tiki,106605689,"Spy X Family Tập 5 - Bản Thường",25000,25000,0,0
TIKI,nha-sach-tiki,111582631,"Cái Dũng Của Thánh Nhân (Thu Giang Nguyễn Duy Cần) (Tái Bản)",62000,90000,28000,31
TIKI,nha-sach-tiki,14645351,"Cuộc Đời Của Pi ( Tái Bản 2019)",82000,110000,28000,25
TIKI,nha-sach-tiki,195885680,"Tiệm Trừ Yêu Kì Ảo -  Tập 18",34100,35000,900,3
TIKI,nha-sach-tiki,87391039,"Thuật Yêu Đương (Tái Bản)",81000,120000,39000,33
TIKI,nha-sach-tiki,54051756,"19 Năm Mưu Sát - Tập 2 (Trinh Thám Trung Quốc)",74000,115000,41000,36
TIKI,nha-sach-tiki,52329861,"Con Đường Hồi Giáo (Tái Bản 2020)",72500,100000,27500,28
TIKI,nha-sach-tiki,89179374,"Spy X Family Tập 4",24300,25000,700,3
TIKI,nha-sach-tiki,77109209,"Nghệ Thuật Đánh Cắp Ý Tưởng (10 Bí Mật Không Ai Nói Với Bạn Về Sáng Tạo)",65400,99000,33600,34
TIKI,nha-sach-tiki,10397239,"Chiến Lược Dữ Liệu",114000,158000,44000,28
TIKI,nha-sach-tiki,124639646,"Bé chinh phục 2000 từ vựng tiếng Anh - My First 2000 English words",62400,120000,57600,48
TIKI,nha-sach-tiki,192909304,"Lên Tàu Cùng Socrates - Đi Tìm Ý Nghĩa Cuộc Sống Từ Các Triết Gia",103900,195000,91100,47
TIKI,nha-sach-tiki,46789754,"Hiểu Hết Về Kinh Doanh",283000,380000,97000,26
TIKI,nha-sach-tiki,10405966,"Tarot Nhập Môn (Tái Bản 2019)",87100,120000,32900,27
TIKI,nha-sach-tiki,77230663,"Combo 2 Cuốn: Tâm Lý Học Tội Phạm",200000,288000,88000,31
TIKI,nha-sach-tiki,54051754,"19 Năm Mưu Sát - Tập 1 (Trinh Thám Trung Quốc)",74000,115000,41000,36
TIKI,nha-sach-tiki,149180057,"Đừng Cố Làm Người Tốt Trong Mắt Tất Cả Mọi Người",86000,108000,22000,20
TIKI,nha-sach-tiki,59293803,"A Holistic Approach To IELTS Writing",131000,189000,58000,31
TIKI,nha-sach-tiki,189641379,"Anh Em Nhà Motohashi - Tập 1",53400,68000,14600,21
TIKI,nha-sach-tiki,140635217,"Mất Kết Nối (Khám Phá Các Nguyên Nhân Thực Của Trầm Cảm Và Các Giải Pháp Bất Ngờ)",166000,250000,84000,34
TIKI,nha-sach-tiki,81224320,"Nước Ép Xanh Chữa Lành Cơ Thể",124600,179000,54400,30
TIKI,nha-sach-tiki,116406678,"Quản Lý Nghiệp (Tái Bản)",40800,59000,18200,31
TIKI,nha-sach-tiki,76175424,"Vụ Án Mạng Ở Nhà Khách Núi Hakuba",101000,138000,37000,27
TIKI,nha-sach-tiki,190240560,"Bộ Sách Tô Màu - Bé Làm Họa Sĩ",19000,25000,6000,24
TIKI,nha-sach-tiki,100958444,"Hạnh Phúc Cầm Tay (Tái Bản)",52000,75000,23000,31
TIKI,nha-sach-tiki,595724,"Giáo Trình Chuẩn HSK 4 Bài Học (Tập 1)",171000,228000,57000,25
TIKI,nha-sach-tiki,187843301,"How Technology Works – Hiểu hết về công nghệ",242000,330000,88000,27
TIKI,nha-sach-tiki,162201947,"One Piece - Tập 98: “Phút Huy Hoàng Của Những Trung Thần",25000,25000,0,0
TIKI,nha-sach-tiki,194104226,"Mô Hình Can Thiệp Sớm Denver Cho Trẻ Tự Kỷ - Thúc Đẩy Kỹ Năng Ngôn Ngữ, Học Tập Và Tương Tác",110200,210000,99800,48
TIKI,nha-sach-tiki,190708154,"Dragon Quest - Dấu Ấn Roto (Dragon Quest Saga Emblem Of Roto) Perfect Edition Tập 8 [Tặng Kèm Bookmark PVC]",70000,75000,5000,7
TIKI,nha-sach-tiki,10383904,"Tôi Là Bêtô",65000,95000,30000,32
TIKI,nha-sach-tiki,140360874,"Những Đòn Tâm Lý Trong Bán Hàng (Tái Bản)",80620,139000,58380,42
TIKI,nha-sach-tiki,77105810,"Nỗi Đau Của Chàng Werther (Bìa Cứng)",63300,85000,21700,26
TIKI,nha-sach-tiki,176654072,"Bộ 5 bút chì gỗ 2B HB Deli - Có bán lẻ 1 chiếc - Nhiều loại mẫu mã màu sắc - Phù hợp cho học sinh sinh viên tập viết vẽ tranh",1700,3420,1720,50
TIKI,nha-sach-tiki,58342212,"Set 3 cuốn Moi Moi và những người bạn - Dành cho trẻ từ 0-2 tuổi",75600,117000,41400,35
TIKI,nha-sach-tiki,73125816,"Digital Marketing - Từ Chiến Lược Đến Thực Thi (Tái Bản 2020)",167000,220000,53000,24
TIKI,nha-sach-tiki,176906726,"Chân Dung Thật - Thấu Hiểu Khách Hàng Chỉ Bằng Những Cuộc Trò Chuyện",211000,245000,34000,14
TIKI,nha-sach-tiki,100347903,"Nói Một Cách Đơn Giản",90000,129000,39000,30
TIKI,nha-sach-tiki,137161811,"Bút gel bấm ngòi 0.5mm nhiều màu Deli - Độ dài mực lên tới 1000m - 12 màu mực - 1 chiếc - EG118",5000,10800,5800,54
TIKI,nha-sach-tiki,105614684,"Bút gel 0.5mm Deli nhiều màu lựa chọn - Bút bi nước -  1 chiếc - Mực đỏ / Xanh / Đen - A116",7200,7200,0,0
TIKI,nha-sach-tiki,195801646,"Ninja Rantaro - Tập 60",37100,40000,2900,7
TIKI,nha-sach-tiki,138226289,"Storytelling With Data: Let’S Practice! - Thực Hành Kể Chuyện Thông Qua Dữ Liệu!",277800,399000,121200,30
TIKI,nha-sach-tiki,84950232,"Hoa Sen Trên Tuyết (Tái Bản)",68100,98000,29900,31
TIKI,nha-sach-tiki,180851000,"Bảy Thanh Hung Giản 3 Mưa Phùn Chôn Nho - Truy Lùng Báo Săn Giá",182000,235000,53000,23
TIKI,nha-sach-tiki,50685547,"Bản Đồ (Bản Thông Thường)",237000,345000,108000,31
TIKI,nha-sach-tiki,130997085,"Chuyện Con Chó Tên Là Trung Thành",34000,45000,11000,24
TIKI,nha-sach-tiki,193434494,"Shaman King - Tập 15",33300,35000,1700,0
TIKI,nha-sach-tiki,72542509,"Raw Vegan – Sức Mạnh Chữa Lành Của Thực Vật (Tặng kèm bookmark)",63900,92000,28100,31
TIKI,nha-sach-tiki,144203242,"9 Lần Khởi Nghiệp - Chuyện Kể Về Những Thất Bại Và Thành Công Của Một Triệu Phú",149000,199000,50000,25
TIKI,nha-sach-tiki,45663835,"Lạc Quan Tếu – Irrational Exuberance",299000,299000,0,0
TIKI,nha-sach-tiki,509829,"Giấy Double A A4 DL70",85500,90000,4500,5
TIKI,nha-sach-tiki,168946125,"Digital Marketing - Chiến Lược Là Lược Đi Để Chiến",111200,139000,27800,20
TIKI,nha-sach-tiki,174427255,"Lốc Vở Kẻ Ngang Primer (120 trang - 200 trang | Giao mẫu ngẫu nhiên)",80070,157000,76930,49
TIKI,nha-sach-tiki,115873770,"Sách: Thay Đổi Một Suy Nghĩ Thay Đổi cả Cuộc Đời",120000,160000,40000,25
TIKI,nha-sach-tiki,193978836,"Trí Óc Minh Mẫn: Để Não Bộ Sắc Bén Ở Mọi Lứa Tuổi",164400,249000,84600,34
TIKI,nha-sach-tiki,148761077,"Khách Sạn Mặt Nạ 1",136000,175000,39000,22
TIKI,nha-sach-tiki,10325548,"How Food Works - Hiểu Hết Về Thức Ăn",223000,300000,77000,26
TIKI,nha-sach-tiki,193736891,"Tâm Lý Học Xã Hội - Đi Tìm Chất Gây Nghiện Trong Mỗi Con Người",99600,139000,39400,28
TIKI,nha-sach-tiki,15397971,"Hà Nội Băm Sáu Phố Phường (Tái bản 2019)",37100,50000,12900,26
TIKI,nha-sach-tiki,49181801,"Oxford Advanced Learner's Dictionary : Paperback - 10th Edition (With 1 Year's Access To Both Premium Online And App)",522660,562000,39340,7
TIKI,nha-sach-tiki,72818335,"Bộ Thẻ học Thông minh - 416 Thẻ Flashcards Tiếng Anh - 16 Chủ đề mới nhất",65790,129000,63210,49
TIKI,nha-sach-tiki,197781968,"Migi & Dali Tập 3",37900,40000,2100,5
TIKI,nha-sach-tiki,78975610,"Siêu Tập Trung (Tái Bản)",90000,140000,50000,36
TIKI,nha-sach-tiki,62648441,"The Customer Rules - 39 Nguyên Tắc Cốt Lõi Để Mang Tới Dịch Vụ Đỉnh Cao",174000,220000,46000,21
TIKI,nha-sach-tiki,197587849,"Yuri Espoir (Tập 3)",62700,79000,16300,21
TIKI,nha-sach-tiki,196001724,"Dưới Cánh Đại Bàng (Bìa Mềm)",95100,138000,42900,31
TIKI,nha-sach-tiki,95090804,"Bút dạ viết bảng Deli - xóa được - Mực xanh/đen/đỏ - 1 chiếc – EU00120/ EU00130 / EU00140",14400,14400,0,0
TIKI,nha-sach-tiki,148760915,"Khách Sạn Mặt Nạ 2 - Đêm Trước Lễ Hội Hóa Trang",97000,125000,28000,22
TIKI,nha-sach-tiki,196001693,"Trí Tuệ Của Trái Tim",69000,88000,19000,0
TIKI,nha-sach-tiki,152875147,"Miền Đất Hứa (A Promised Land) - Barack Obama (Bìa Cứng)",179000,768000,589000,77
TIKI,nha-sach-tiki,95997783,"Sách Luyện thi B1 Vstep 4 kỹ năng - Ôn thi chứng chỉ tiếng Anh B1 bậc 3 (bằng B1 tiếng Anh) theo Khung NLNN Việt Nam",300000,300000,0,0
TIKI,nha-sach-tiki,171825201,"Người Bà Tài Giỏi Vùng Saga – Tập 7",41600,52000,10400,20
TIKI,nha-sach-tiki,13446508,"Cánh Đồng Bất Tận (Tái Bản 2019)",65000,85000,20000,24
TIKI,nha-sach-tiki,55119955,"Cách Sống (Tái Bản 2020)",58500,85000,26500,31
TIKI,nha-sach-tiki,87226754,"Một Cuốn Sách Buồn… Cười - Vui Vẻ Không Quạu Nha 2",52000,79000,27000,34
TIKI,nha-sach-tiki,195190272,"Nhất Quỷ Nhì Ma, Thứ Ba Takagi  - Tập 15",29000,30000,1000,3
TIKI,nha-sach-tiki,177637709,"Làm Chủ Bình Minh - Sống Đời Xuất Chúng - CLB 5 Giờ Sáng (Robin Sharma)",109000,185000,76000,41
TIKI,nha-sach-tiki,54383647,"Fullmetal Alchemist - Cang Giả Kim Thuật Sư - Fullmetal Edition Tập 4",64100,69000,4900,7
TIKI,nha-sach-tiki,76014598,"Blue Ocean Strategy - Chiến Lược Đại Dương Xanh (Bìa Cứng) (Tái Bản)",150600,239000,88400,37
TIKI,nha-sach-tiki,186271356,"Từ điển xây kênh từ cơ bản đến thành công",268000,268000,0,0
TIKI,nha-sach-tiki,185888686,"Trường An Ly Ca 3 – Cao Sơn Lưu Thuỷ",134000,170000,36000,21
TIKI,nha-sach-tiki,52329765,"Biên Niên Ký Chim Vặn Dây Cót (Tái Bản 2020)",137000,199000,62000,31
TIKI,nha-sach-tiki,195357774,"Máy Tính CASIO FX-880BTG - Màu Xanh Biển",708000,800000,92000,12
TIKI,nha-sach-tiki,9695881,"Nghệ Thuật đầu tư Dhandho - The Dhandho Investor",238000,238000,0,0
TIKI,nha-sach-tiki,160375101,"Ngữ pháp luyện thi IELTS - Grammar for ielts",88000,88000,0,0
TIKI,nha-sach-tiki,74285820,"Cơ Thể Tự Chữa Lành: Nước Ép Cần Tây",96000,148000,52000,35
TIKI,nha-sach-tiki,189326210,"Nghệ thuật tư duy dựa trên dữ liệu - Để ra quyết điịnh thông minh hơn trong một thê giới không chắc chắn",85000,150000,65000,43
TIKI,nha-sach-tiki,196849409,"Gửi Em, Người Bất Tử - Tập 11 (Tái Bản 2022)",28900,30000,1100,4
TIKI,nha-sach-tiki,10678954,"Full bộ Ehon Nhật Bản cho bé 0-6 tuổi thông minh, sáng tạo",271000,390000,119000,31
TIKI,nha-sach-tiki,113656455,"Giáo Trình Tư Tưởng Hồ Chí Minh (Dành Cho Bậc Đại Học Hệ Không Chuyên Lý Luận Chính Trị) - Bộ mới năm 2021",55000,55000,0,0
TIKI,nha-sach-tiki,4080373,"90% Trẻ Thông Minh Nhờ Cách Trò Chuyện Đúng Đắn Của Cha Mẹ",31000,39000,8000,21
TIKI,nha-sach-tiki,121185870,"Và Rồi Núi Vọng",109000,148000,39000,26
TIKI,nha-sach-tiki,196849406,"Gửi Em, Người Bất Tử - Tập 9 (Tái Bản 2022)",21300,30000,8700,29
TIKI,nha-sach-tiki,101782486,"Làm Ra Làm, Chơi Ra Chơi (Tái Bản)",104200,159000,54800,34
TIKI,nha-sach-tiki,165150439,"TalMud - Tinh Hoa Trí Tuệ Do Thái (Tái Bản)",73000,110000,37000,34
TIKI,nha-sach-tiki,148750882,"Khi Mọi Thứ Sụp Đổ - Lời Khuyên Chân Thành Trong Những Thời Điểm Khó Khăn",82800,119000,36200,30
TIKI,nha-sach-tiki,196849389,"Gửi Em, Người Bất Tử - Tập 10 (Tái Bản 2022)",28900,30000,1100,4
TIKI,nha-sach-tiki,37411897,"Sách Đen - Bộ Công Cụ Của Phụ Nữ Thành Đạt",55600,79000,23400,30
TIKI,nha-sach-tiki,63187280,"Combo 2 Cuốn: Cơ Thể Tự Chữa Lành",222000,345000,123000,36
TIKI,nha-sach-tiki,167301575,"Khí Chất Bao Nhiêu Hạnh Phúc Bấy Nhiêu (Tái Bản 2022)",103000,139000,36000,26
TIKI,nha-sach-tiki,20520720,"Đối Thoại Với Thượng Đế ( Tái Bản )",73000,98000,25000,26
TIKI,nha-sach-tiki,75630595,"The Design Thinking Playbook- Thực Hành Tư Duy Thiết Kế",185400,299000,113600,38
TIKI,nha-sach-tiki,73102465,"Bé Tô màu - Combo 11 cuốn",64900,127255,62355,49
TIKI,nha-sach-tiki,53452969,"Khởi Nghiệp Du Kích - Kinh Doanh Ít Vốn - Vận Dụng Nguồn Lực Nhỏ Chiến Thắng Cuộc Chơi Lớn (Tái Bản)",155000,199000,44000,22
TIKI,nha-sach-tiki,124767712,"Không Tự Khinh Bỉ - Không Tự Phí Hoài (Tái Bản)",85200,119000,33800,28
TIKI,nha-sach-tiki,73316970,"Osho - Ươm Mầm",75800,109000,33200,30
TIKI,nha-sach-tiki,196849403,"Gửi Em, Người Bất Tử - Tập 8 (Tái Bản 2022)",21400,30000,8600,29
TIKI,nha-sach-tiki,73207098,"Làm Chủ - Mastery",128000,200000,72000,36
TIKI,nha-sach-tiki,32415084,"Combo 2 cuốn Giáo Trình Hán Ngữ (Sách học Tiếng Trung dành cho người Việt): Giáo Trình Hán Ngữ Tập 1 + Giáo Trình Hán Ngữ Tập 2 (Học bằng App McBooks) - Tặng kèm bookmark GreenLife",170800,244000,73200,30
TIKI,nha-cua-doi-song,144752155,"Khăn lau đa năng H600 Khăn lau tay bát đĩa nhà bếp vải mềm mịn thấm nước siêu nhanh tiện lợi an toàn",1700,1700,0,0
TIKI,nha-cua-doi-song,35905855,"Cây Lau Nhà Pva Lock&Lock ETM481 - PP, 33 x 6 x 132 cm - Màu Trắng",280000,539000,259000,48
TIKI,nha-cua-doi-song,58002786,"Vòi bơm dây dẫn nước rửa chén gắn chậu rửa Hobby home decor NRC2 đầu bơm inox 304 có van 1 chiều gắn chai nước rửa chén",205000,279000,74000,27
TIKI,nha-cua-doi-song,137671794," Cân Tiểu Ly Nhà Bếp Chống Nước Cao Cấp Khoảng Chính Xác 1g - 5kg ",165000,295000,130000,44
TIKI,nha-cua-doi-song,71111080,"Kệ Để Giày Dép Inox 5 Tầng Chính Hãng Amalife, Giá Để Giày Inox 5 Tầng - Chọn Màu",99000,99000,0,0
TIKI,nha-cua-doi-song,195852183,"Bình giữ nhiệt bằng thép không gỉ LocknLock Jumbo Tumbler LHC4300NVY 900ML",438000,730000,292000,40
TIKI,nha-cua-doi-song,51476716,"Bộ 10 đôi đũa inox 304 - 316 DandiHome 2020 chống trơn trượt, sang trọng, tinh tế",300000,300000,0,0
TIKI,nha-cua-doi-song,3677799,"Hộp 6 Lõi  Lọc Nước BRITA Maxtra Plus Filter Cartridge",1849000,1849000,0,0
TIKI,nha-cua-doi-song,52885368,"1 Kg túi zip chỉ đỏ thương hiệu Gimex II",69000,69000,0,0
TIKI,nha-cua-doi-song,210760574,"Cây lau nhà tự vắt thông minh sợi microfiber",209000,209000,0,0
TIKI,nha-cua-doi-song,48510374,"Combo 300 Túi Lọc Rác Siêu Tiện dụng cho Bồn rửa Chén bát",129000,200000,71000,36
TIKI,nha-cua-doi-song,69929041,"Móc Treo Quần Áo, Móc Phơi Đồ Trẻ Em Inox Kẹp Chống Rơi, Móc Treo Tất, Vớ, Đồ Lót Nhiều Kiểu Dáng",35000,35000,0,0
TIKI,nha-cua-doi-song,7114709,"Đèn Pin Đội Đầu Sunhouse Cỡ Nhỏ She 5012",62000,99000,37000,37
TIKI,nha-cua-doi-song,54686184,"Bạt Áo Trùm Máy Giặt Cửa Trên, Cửa Ngang Vải Dù Siêu Dày, Chống Thấm Nước, Không Phai Màu - (Giao Màu - Họa Tiết Ngẫu Nhiên)",99999,99999,0,0
TIKI,nha-cua-doi-song,45300792,"Đồng hồ báo thức điện tử để bàn màn hình đa chức năng thời gian, lịch, báo thức, nhiệt độ DH89",50900,50900,0,0
TIKI,nha-cua-doi-song,35058677,"Vỉ 5 Viên Pin CR1632 ( CR 1632/5BE x 1 Vỉ ) Panasonic Lithium 3 V - Hàng Chính Hãng",87000,100000,13000,13
TIKI,nha-cua-doi-song,696495,"Ổ Cắm Điện 4 Lỗ 3 Chấu 3m Philips SPN1348WB/74 (2500W)",328000,369000,41000,11
TIKI,nha-cua-doi-song,109654810,"Bình xịt tưới cây MONROVIA 2 lít, phun sương tưới cây cảnh, vòi dài, tặng vòi ngắn, màu xanh, tiêu chuẩn Châu Âu",169000,169000,0,0
TIKI,nha-cua-doi-song,87873126,"Áo Mưa Bộ Vải Dù, Bộ Quần Áo Mưa Có Phản Quang Đủ Size, Chống Thấm Hiệu Quả, Phù Hợp Nam Và Nữ, Có Túi Đựng, Có Lựa Chọn Màu Sắc",150000,150000,0,0
TIKI,nha-cua-doi-song,41430891,"Ổ Khóa 4 Số Có Đổi Mã Chữ U ZR-01",68000,96000,28000,29
TIKI,nha-cua-doi-song,193433927,"Đèn Bàn Học Led Đọc Sách Làm Việc Học Tập Bảo Vệ Mắt Chống Cận - 2 Trục Đèn Chiếu Sáng - Gấp Gọn Tiện Lợi",569000,699000,130000,19
TIKI,nha-cua-doi-song,85029598,"Ổ cắm Điện Quang ĐQ 002A-02 (3 lỗ)",95000,95000,0,0
TIKI,nha-cua-doi-song,58828647,"Xe đẩy hàng 4 bánh SUMIKA T150 - Khung thép, tay cầm gấp mở tiện lợi, tải trọng 150kg",880000,1350000,470000,35
TIKI,nha-cua-doi-song,141246639,"Hộp giữ nhiệt đựng đồ ăn có tay cầm Handle Food Jar LocknLock 700ml LHC8042NVY - Màu",416000,800000,384000,48
TIKI,nha-cua-doi-song,71999229,"Nồi Inox 3 Lớp Đáy Liền Elmich Trimax Classic 2408OL",700000,990000,290000,29
TIKI,nha-cua-doi-song,208413993,"Bàn Làm Việc Phong Cách Bắc Âu Thương Hiệu IGEA (Không Bao Gồm Ghế)",275500,290000,14500,5
TIKI,nha-cua-doi-song,161225352,"Miếng dán đỡ kệ gỗ, chia ngăn tủ, không cần đóng đinh",22000,22000,0,0
TIKI,nha-cua-doi-song,578967,"Chảo Đá Chống Dính Siêu Bền Sunhouse SBD28 28cm",273000,430000,157000,37
TIKI,nha-cua-doi-song,217714140,"Móc Dán Tường INOX 304 Treo Đồ nặng, Treo Thớt, Nồi Niêu Treo Đồ Đa Năng [CHỐNG NƯỚC, CHỐNG RỈ] Dán Mọi Bề Mặt",15000,15000,0,0
TIKI,nha-cua-doi-song,51662145,"Keo dán siêu dính X2000 (50g) dán gỗ, sắt, sứ, kim loại đa năng",18000,46900,28900,62
TIKI,nha-cua-doi-song,51554889,"Ron Dán Che Khe Cửa ,Chân Cửa Chống Gió Lùa, Chống Bụi Và Chống Côn Trùng - Hàng Chính Hãng Cuộn 2m",40000,52000,12000,23
TIKI,nha-cua-doi-song,54130086,"Cây lau nhà tự vắt thông minh đa năng cao cấp Parroti Magic MG01 - Tặng 1 Miếng Lau",229000,349000,120000,34
TIKI,nha-cua-doi-song,56880195,"Bình nước Lock&Lock Eco Bottle ABF664BLU 750ml - Màu",145000,242000,97000,40
TIKI,nha-cua-doi-song,155794592,"Kệ lò vi sóng đa năng Thép Carbon cao cấp Vando, kệ để đồ nhà bếp siêu chịu lực 300kg sơn tĩnh điện chống bong tróc, kệ nhà bếp",899000,1427000,528000,37
TIKI,nha-cua-doi-song,114789036,"Vòi Dẫn Nước Rửa Chén Bộ Đầu Vòi Dẫn Bơm Hút Xịt Nước Rửa Chén Dầu Rửa Bát Gắn Bồn Rửa Bát",59596,59596,0,0
TIKI,nha-cua-doi-song,178068438,"Khăn giấy cuộn đa năng, lau bếp, lau kính, chén bát, lau tay (50 khăn/cuộn, 25cm x25cm) - Parroti Bingo NG01",38900,78000,39100,50
TIKI,nha-cua-doi-song,55365176,"0.5kg túi zipper chỉ đỏ đựng thực phẩm",39000,39000,0,0
TIKI,nha-cua-doi-song,134582052,"ĐỆM TRẢI SÀN, NỆM, TOPPER HÀNG XUẤT NHẬT",242000,269900,27900,10
TIKI,nha-cua-doi-song,19719366,"Võng dù 2 lớp BAN MAI, gọn nhẹ 230x145 cm, nặng 600gr (Giao màu ngẫu nhiên)",129000,150000,21000,14
TIKI,nha-cua-doi-song,48055150,"Thảm Lau Chân Chống Trượt Siêu Thấm 40x60cm",93000,186000,93000,50
TIKI,nha-cua-doi-song,118966833,"Móc Treo Cây Lau Nhà Dán Tường Đa Năng  Chịu Lực Tốt - Parroti Keeper KP02",22900,42000,19100,45
TIKI,nha-cua-doi-song,74396976,"Máy xay tỏi ớt bằng tay Lock&Lock (Nhiều kích cỡ) - Hàng chính hãng, lực nghiền mạnh với 3 lưỡi dao thép không gỉ",129000,216000,87000,40
TIKI,nha-cua-doi-song,165404269,"Khăn tắm sợi tre Bamboo&Love 60x120cm mềm mại kháng khuẩn siêu thấm hút an toàn cho da ngay cả với trẻ sơ sinh",70000,70000,0,0
TIKI,nha-cua-doi-song,189491905,"Nhang Sen Thuần Khiết Liên Tâm 20.5cm 160 cây - Ít khói, dịu nhẹ, 100% Đài sen thiên nhiên",75000,75000,0,0
TIKI,nha-cua-doi-song,180378151,"Bình giữ nhiệt LocknLock Metro Drive LHC4277S 650ml - Kèm ống hút và cọ rửa",301000,579000,278000,48
TIKI,nha-cua-doi-song,121396300,"Dây rút nhựa 10cm ,15cm, 20cm, 25cm, 30cm ( Khoảng 80 sợi/bịch )",3900,3900,0,0
TIKI,nha-cua-doi-song,3490669,"Cây lau nhà tự vắt thông minh Panda ",39899,41999,2100,5
TIKI,nha-cua-doi-song,147806385,"Đũa gắp thức ăn vặt DandiHome siêu nhẹ cho chơi game, làm việc văn phòng",13250,15000,1750,12
TIKI,nha-cua-doi-song,71005991,"Bình xịt dầu Lock&Lock 100ml kèm phểu và cọ rửa - CKO109",104000,174000,70000,40
TIKI,nha-cua-doi-song,10032000,"Ổ cắm đa năng du lịch Adapter",30500,30500,0,0
TIKI,nha-cua-doi-song,134853381,"Bình giữ nhiệt LocknLock Feather Light Ring LHC4244PIK 460ml - Màu",313000,601000,288000,48
TIKI,nha-cua-doi-song,206485076,"Hương nhang sạch Dương Minh nhang 20cm và 30cm 100% thành phần tự nhiên các loại nhang Cam Sả nhang Bồ Kết nhang Bắc nhang Thảo Mộc nhang Quế nhang Khuynh Diệp và Trầm Hương cao cấp",45000,55000,10000,18
TIKI,nha-cua-doi-song,57867023,"Cây Lau Nhà Xoay 360 Độ Sunhouse Ks-Mo350I",130000,200000,70000,35
TIKI,nha-cua-doi-song,259514693,"Cây chà sàn nhà tắm Kitimop-Z1 chổi cọ sàn và gạt nước đa năng 2 trong 1, cán hợp kim nhôm tăng giảm chiều dài 65-125cm",145000,215000,70000,33
TIKI,nha-cua-doi-song,55900887,"Đèn Bàn Học Đọc Sách, Làm Việc (Học Sinh, Sinh Viên, Văn Phòng) LED Chống Cận, Cảm Ứng Nhôm Cao Cấp eLights",389000,449000,60000,13
TIKI,nha-cua-doi-song,162526068,"Đất trồng cây SOILMIX cho hoa hồng, cây cảnh, sen đá, rau sạch hữu cơ, bổ sung phân bón vi sinh, trichoderma, đá perlite",50000,50000,0,0
TIKI,nha-cua-doi-song,179370829,"GÓI 20 VIÊN KHĂN GIẤY NÉN HÀN QUỐC HÌNH VIÊN KẸO ĐA NĂNG",16999,16999,0,0
TIKI,nha-cua-doi-song,185756969,"Cây lau kính đa năng Kitimop-3in1 có thiết kế thông minh gạt chùi kính 3 đầu trong 1, nhỏ gọn tiện lợi hiệu quả",39000,75000,36000,48
TIKI,nha-cua-doi-song,82875291,"Bộ 2 thùng vải, hộp vải đựng đồ đa năng -Màu Nâu Kem + Tặng kèm dây cột tóc- Hộp vải đựng quần áo 2 size đựng quần áo, đồ lót, giày, văn phòng phẩm, đồ dùng cá nhân rất tiện lợi-Bộ 2 hộp vải đựng đồ vải canvas siêu xinh có nắp đậy, tủ vải đựng đồ hộp cái ",109000,141700,32700,23
TIKI,nha-cua-doi-song,178783625,"Combo 2 Giá đỡ bàn chải máy dán tường NAVIVU",50000,50000,0,0
TIKI,nha-cua-doi-song,57945711,"Hộp đựng bàn chải kem đánh răng nhà tắm tặng kèm 4 cốc-Kệ để đồ vệ sinh răng miệng dán tường (màu ngẫu nhiên)",168850,168850,0,0
TIKI,nha-cua-doi-song,17593518,"Bộ Hộp Cơm Giữ Nhiệt Thép Không Gỉ Lock & Lock LHC8031SLV - Bạc",668000,1285000,617000,48
TIKI,nha-cua-doi-song,102488853,"Thùng Đựng Gạo Cao Cấp 5kg & 10kg - Thùng Đựng Gạo Nắp Đậy Thông Minh, Thiết Kế Hiện Đại & Đẹp Mắt, Chất Liệu ABS &PP An Toàn Chống Nước, Chống Ẩm Mốc, Mối Mọt - Hàng Nhập Khẩu",206000,343500,137500,40
TIKI,nha-cua-doi-song,121602582,"Bình xịt chống thấm tường, Keo chống dột xịt chống thấm nhà, mái tôn, bể nước 720ml Waterproof",58000,63000,5000,8
TIKI,nha-cua-doi-song,77775165,"Hộp Bảo Quản Thủy Tinh Lock&Lock LBG - Top Class (Nhiều Dung Tích)",102000,196000,94000,48
TIKI,nha-cua-doi-song,949687,"Kệ Đỡ Màn Hình Máy Tính Monitor Stand Plyconcept MSM01001 (490 x 200 mm) - Gỗ",250000,300000,50000,17
TIKI,nha-cua-doi-song,53518638,"2 Móc Dán Tường Giữ Dây Cắm Điện Phích Cắm Loại Trong Suốt",8950,8950,0,0
TIKI,nha-cua-doi-song,199728521,"Bộ lau nhà đa năng Space Saving Sunhouse KS-CL3211PW",310000,450000,140000,31
TIKI,nha-cua-doi-song,52578184,"Tuýp Keo Dán Đồ Gia Dụng Siêu Dính, Keo Dán Kim Loại Cao Cấp",15000,15000,0,0
TIKI,nha-cua-doi-song,12030860,"Áo Mưa kín người Không Xẻ Tà Vải Dù Hàng Cao Cấp Chống Thấm Cực Tốt, Áo Mưa Đi Xe Máy",85940,85940,0,0
TIKI,nha-cua-doi-song,14640240,"Cân Điện Tử Nhà Bếp 5kg - Cân Chia Thực Phẩm Nhà Bếp - Cân Tiểu Ly 5kg",90000,135000,45000,33
TIKI,nha-cua-doi-song,55669191,"Đèn Pixar, Đèn Học Chống Cận Thị, Đèn Đọc Sách, Đèn Làm Việc Để Bàn Chống Chói Mắt Lóa Mắt Bảo Vệ Mắt - Hàng Chính Hãng",250000,250000,0,0
TIKI,nha-cua-doi-song,110894852,"Giấy Bạc Màng Nhôm MyJae Đài Loan Để Bảo Quản, Nướng Thức Ăn, Bọc Thực Phẩm 30cm x 14m",85000,119000,34000,29
TIKI,nha-cua-doi-song,467912,"Máy Khoan Động Lực Bosch GSB 550 550W Set Và Bộ Dụng Cụ 100 Chi Tiết",1710000,2177000,467000,21
TIKI,nha-cua-doi-song,114204740,"Bình giữ nhiệt inox 304 Sunhouse 900ml KS-TU900I",149000,225000,76000,34
TIKI,nha-cua-doi-song,68716605,"Dao Làm Bếp Đa Năng Sunhouse KS-KN165KS",74000,117000,43000,37
TIKI,nha-cua-doi-song,3927949,"Bộ sạc Energizer Charger kèm 4 pin Ener AA 2000mAh, tự ngắt sạc (CHVCM4)",447000,460000,13000,3
TIKI,nha-cua-doi-song,21101765,"Bàn Học Bàn Làm Việc Kết Hợp Kệ Sách Thương Hiệu IGEA",670000,729000,59000,8
TIKI,nha-cua-doi-song,19298165,"Áo Mưa Bộ Cho Bé Trai, Bé Gái ( số 1-5)",46000,46000,0,0
TIKI,nha-cua-doi-song,13309367,"Ổ điện thông minh có 6 phích cắm 3 cổng USB (Giao Màu Ngẫu Nhiên)",44000,44000,0,0
TIKI,nha-sach-tiki,1471887,"Tớ Muốn Ăn Tụy Của Cậu",72000,96000,24000,25
TIKI,nha-sach-tiki,40774181,"Combo Sách Tiếng hàn tổng hợp dành cho người Việt Nam - Sơ cấp 1 (Phiên bản 1 màu)",163800,234000,70200,30
TIKI,nha-sach-tiki,179546074,"Luật Hấp Dẫn - Quy Luật Về Sự Thịnh Vượng Và Thành Công",85900,129000,43100,33
TIKI,nha-sach-tiki,197781971,"Chòm Sao Linh Thú Tập 9",39100,40000,900,2
TIKI,nha-sach-tiki,50322710,"48 Nguyên Tắc Chủ Chốt Của Quyền Lực (Tái Bản 2020)",119000,200000,81000,41
TIKI,nha-sach-tiki,75615273,"Combo 3 Cuốn Sách Ehon: Buồn Ngủ Ơi Là Buồn Ngủ (Dành Cho Trẻ Từ 0 - 4 Tuổi)",75700,117000,41300,35
TIKI,nha-sach-tiki,191320058,"Set 6 Chiếc Bút Highlight Hai Đầu Bút Nhớ Dòng Đánh Dấu Dạ Quang Take Note Ghi Chú Deli - Bảng Màu Pastel Macaron - 33002 S605 S735 S134",29000,57600,28600,50
TIKI,nha-sach-tiki,44627532,"Cẩm Nang Hướng Dẫn Thải Độc & Chế Độ Ăn Uống Lành Mạnh",98500,145000,46500,32
TIKI,nha-sach-tiki,109633951,"Combo 8 cuốn: Tô màu Nối số Thông minh",49920,96000,46080,48
TIKI,nha-sach-tiki,273633981,"[ Trạm Đọc Official ] Sách: Tâm Lý Học Thành Công (Tái Bản)",149000,199000,50000,25
TIKI,nha-sach-tiki,38223395,"Tâm Lý Học Hài Hước (Tái Bản)",63600,89000,25400,29
TIKI,nha-sach-tiki,176550203,"Cuộc Đời Ngắn Lắm Đừng Ôm Muộn Phiền",62900,88000,25100,29
TIKI,nha-sach-tiki,193211309,"Chuông Gió (Tập 2)",125000,174000,49000,28
TIKI,nha-sach-tiki,195980676,"Phượng Hoàng Tái Sinh - 12 Phẩm Chất Quan Trọng Để Bứt Phá Sự Nghiệp Và Cuộc Sống",109440,152000,42560,28
TIKI,nha-sach-tiki,545278,"Combo Sherlock Holmes Toàn Tập (Trọn Bộ 3 Tập)",156000,300000,144000,48
TIKI,nha-sach-tiki,36854641,"Sự Thật Về Thế Giới : Mười Lý Do Khiến Ta Hiểu Sai Về Thế Giới - Và Vì Sao Thế Gian Này Tốt Hơn Ta Tưởng",88200,160000,71800,45
TIKI,nha-sach-tiki,76105910,"5 Ngôn Ngữ Yêu Thương - The Five Love Languages (Tái Bản)",89100,128000,38900,30
TIKI,nha-sach-tiki,4255933,"Plato Và Con Thú Mỏ Vịt Bước Vào Quán Bar (Tái Bản 2018 )",74500,100000,25500,26
TIKI,nha-sach-tiki,196849396,"Gửi Em, Người Bất Tử - Tập 3 (Tái Bản 2022)",29500,30000,500,2
TIKI,nha-sach-tiki,10397241,"Sách Chữa Lành Nỗi Đau",68100,98000,29900,31
TIKI,nha-sach-tiki,176906754,"Inspired - Kiến Tạo Sản Phẩm Công Nghệ Chiếm Trọn Trái Tim Người Dùng",228000,295000,67000,23
TIKI,nha-sach-tiki,76013370,"Được Học - Educated (Tái Bản)",136000,182000,46000,25
TIKI,nha-sach-tiki,10920495,"Dế Mèn Phiêu Lưu Ký",104000,150000,46000,31
TIKI,nha-sach-tiki,196849393,"Gửi Em, Người Bất Tử - Tập 4 (Tái Bản 2022)",21000,30000,9000,30
TIKI,nha-sach-tiki,106693398,"Combo 4 cuốn: Luyện viết (Theo chương trình mới - Bé vào lớp 1)",37440,72000,34560,48
TIKI,nha-sach-tiki,10767515,"Phân Tâm Học Nhập Môn",118000,159000,41000,26
TIKI,nha-sach-tiki,196849400,"Gửi Em, Người Bất Tử - Tập 5 (Tái Bản 2022)",21400,30000,8600,29
TIKI,nha-sach-tiki,147920907,"Combo Bộ 6 Cuốn: Thư Viện Song Ngữ Đầu Tiên Cho Bé (0-3 Tuổi)",80500,108000,27500,25
TIKI,nha-sach-tiki,189350061,"Giá Mà Nỗi Buồn Có Thể Cầm Nắm Trên Tay - Tặng kèm 03 postcard",78000,109000,31000,28
TIKI,nha-sach-tiki,552393,"Hiểu Về Trái Tim",142000,158000,16000,10
TIKI,nha-sach-tiki,184475053,"Sa Vào Ánh Hào Quang Của Người – Tập 1",108000,132000,24000,18
TIKI,nha-sach-tiki,192124393,"Ikigami - Tập 06",43100,45000,1900,4
TIKI,nha-sach-tiki,5067167,"Tôi Là Ai - Và Nếu Vậy Thì Bao Nhiêu? (Tái Bản 2018)",92700,126000,33300,26
TIKI,nha-sach-tiki,74460137,"Sách Bí Quyết Áp Dụng 7 Thói Quen Của Bạn Trẻ Thành Đạt (Khổ Nhỏ) (Tái Bản 2020)",75100,108000,32900,30
TIKI,nha-sach-tiki,104651900,"Sách Seneca: Những Bức Thư Đạo Đức – Chủ nghĩa Khắc kỷ trong đời sống - Tập 1",149000,159000,10000,6
TIKI,nha-sach-tiki,187622581,"Sách Sức Mạnh Của Sự Trầm Lắng",99840,128000,28160,22
TIKI,nha-sach-tiki,75338644,"Bảng viết, bảng vẽ cảm ứng điện tử thông minh tự động xóa cho bé - Hàng Chính Hãng VinBuy",65000,120000,55000,46
TIKI,nha-sach-tiki,103471709,"Full bộ (10 quyển) Truyện cổ tích Việt Nam (Song ngữ Việt - Anh) (giao ngẫu nhiên)",62400,120000,57600,48
TIKI,nha-sach-tiki,140360872,"Để Xây Dựng Doanh Nghiệp Hiệu Quả (Tái Bản)",92620,139000,46380,33
TIKI,nha-sach-tiki,95218547,"Đọc Vị Mọi Vấn Đề Của Trẻ - Giải Mã Mọi Vấn Đề Về Nuôi Con Nhỏ: Ăn - Ngủ - Kỷ Luật Hành Vi (Tái Bản)",133000,199000,66000,33
TIKI,nha-cua-doi-song,11203853,"Bộ 10 đinh treo tranh, mắc màn loại 4 chân",13992,13992,0,0
TIKI,nha-cua-doi-song,110756858,"Set 200 Găng Tay Nilon Trong Suốt Sử Dụng Một Lần Tiện Lợi ",18394,18394,0,0
TIKI,nha-cua-doi-song,41886085,"Túi Đựng Ly Giữ Nhiệt Lớn 900ml - Nhiều Hoa Văn",40000,40000,0,0
TIKI,nha-cua-doi-song,54122078,"Pin AAAA Energizer E96 BP2",67000,80000,13000,16
TIKI,nha-cua-doi-song,63133571,"Mền lông cừu xanh dương đậm cao cấp A - 1m8x2m",165000,180000,15000,8
TIKI,nha-cua-doi-song,22081865,"TÚI ÁO BÌNH GIỮ NHIỆT TIỆN LỢI",40000,40000,0,0
TIKI,nha-cua-doi-song,16166750,"ÁO MƯA BIT CƠ BẢN",85000,85000,0,0
TIKI,nha-cua-doi-song,1453915,"Ly Giữ Nhiệt Bằng Thép Không Gỉ Lock&Lock Clip Tumbler LHC4151BLK (540ml) - Đen",304000,506000,202000,40
TIKI,nha-cua-doi-song,146887829,"Đèn Pixar, Đèn Bàn Học Chống Cận Thị, Đèn Đọc Sách LED, Đèn Làm Việc Bảo Vệ Mắt, đèn học để bàn, đèn học cho học sinh sinh viên, đèn trang trí decor - Hàng Chính Hãng dododios",148000,148000,0,0
TIKI,nha-cua-doi-song,54485029,"Đèn Bàn Học Đọc Sách LED Chống Cận 03 Chế Độ Ánh Sáng Bảo Vệ Mắt Có Hộp Bút Và Giá Để Điện Thoại eLights",179000,220000,41000,19
TIKI,nha-cua-doi-song,153291977,"Băng Keo Chống Thấm, Chống Dột Dán Siêu Dính Trên Mọi Bề Mặt, Dán Mái Tôn, Dán Tường, Dán Ống Nước - PucaMart",13000,18999,5999,32
TIKI,nha-cua-doi-song,76046302,"Móc treo quần áo gắn sau cánh cửa tử HOBBY MTGC Nice Day 6 chấu - 2 màu tùy chọn",28000,79000,51000,65
TIKI,nha-cua-doi-song,3677797,"Hộp 3 Lõi Lọc Nước BRITA Maxtra Plus Filter Cartridge",599000,949000,350000,37
TIKI,nha-cua-doi-song,51105287,"Bộ 4 ống hút Inox 304 kèm cọ rửa DandiHome",33000,39000,6000,15
TIKI,nha-cua-doi-song,146384829,"Ghế xoay văn phòng công thái học ergonomic có ngả lưng Premium 02, ghế xoay Gaming cao cấp nhập khẩu",1064000,2490000,1426000,57
TIKI,nha-cua-doi-song,86376338,"Đèn ngủ Oval cắm điện 10 cấp độ sáng có remote - đèn ngủ thông minh - hẹn giờ - 2 cổng USB sạc nhanh mới 2021",99000,99000,0,0
TIKI,nha-cua-doi-song,81936300,"BIG SIZE -Túi Đựng Quần Áo Khung Thép 88L: 60x40x35 (cm) Morning House- Gấp gọn tiện lợi, bảo quản quần áo bền đẹp",88000,88000,0,0
TIKI,nha-cua-doi-song,55875210,"Tủ Vải Đựng Đồ Khung Thép Chịu Lực, Túi Đựng Chăn Màn Quần Áo miDoctor Tiện Lợi - Giao Màu Ngẫu Nhiên",88000,89000,1000,1
TIKI,nha-cua-doi-song,7635008,"Bộ 2 cuộn túi hút chân không một mặt nhám rộng",60000,60000,0,0
TIKI,nha-cua-doi-song,90523892,"Ly Giữ Nhiệt Lock&Lock Energetic One Touch Tumbler LHC3249 (550ml) - Hàng Chính Hãng, Bằng Thép Không Gỉ Inox 316L, Nắp Mở Một Chạm, Tặng Ống Hút Và Cọ Rửa",289000,488000,199000,41
TIKI,nha-cua-doi-song,272453821,"[Tặng Bông Lau] Bộ Lau Nhà MyJae Đài Loan Sợi Microfiber Xoay Siêu Tốc 360 Độ Thông Minh 129.5cm",699000,990000,291000,29
TIKI,nha-cua-doi-song,162112460,"Thùng Rác Tròn Chân Đạp 6l Phù Hợp Văn Phòng, Gia Đình, Phòng Bếp Tiện Nghi Sang Trọng",129000,129000,0,0
TIKI,nha-cua-doi-song,77448059,"Cốc giữ nhiệt LocknLock LHC4247PIK Table Mug 473ml",252000,484000,232000,48
TIKI,nha-cua-doi-song,52006431,"Hộp đựng thìa đũa cá nhân DandiHome (màu ngẫn nhiên)",26500,30000,3500,12
TIKI,nha-cua-doi-song,466737,"Hộp Cơm Cắm Điện - Hộp Hâm Nóng Văn Phòng 2 Tầng Life360 EL-ALS263 (Tím) - Hàng Chính Hãng",456000,749000,293000,39
TIKI,nha-cua-doi-song,165346784,"Khăn gội sợi tre Bamboo&Love 35x75cm mềm mại kháng khuẩn siêu thấm hút an toàn cho da ngay cả với trẻ sơ sinh",34900,58000,23100,40
TIKI,nha-cua-doi-song,130767592,"Ổ cắm Điện Quang ĐQ ESK 5W. SM740SL (4 lỗ 3 chấu dây 5 mét màu Trắng Đỏ)",158480,198100,39620,20
TIKI,nha-cua-doi-song,74598515,"Đệm ngồi 3D Silicon cao cấp thoáng khí chống đau mỏi - Hàng nhập khẩu",149000,149000,0,0
TIKI,nha-cua-doi-song,193709920,"Bình Đựng Nước 1L Bao Bì Dễ Thương Có Vạch Báo Giờ Uống Nước Chia Lượng Nước Deli - Nhựa Cao Cấp An Toàn Đầy Đủ Kiểm Định Chất Lượng Phủ Hợp Bình Nước Thể Thao Cho Bé Tới Trường - VS822 VS823",99000,178200,79200,44
TIKI,nha-cua-doi-song,53307149,"Bộ tua vít đa năng sửa chữa điện thoại 25 in 1 vít từ tính chất liệu cao cấp S2",38880,38880,0,0
TIKI,nha-cua-doi-song,73529777,"Kệ chén bát đa năng bằng thép carbon không gỉ, chống xước, sơn đen tĩnh điện, giá bát trên bồn rửa ráo nước cho nhà bếp sạch sẽ VANDO",319000,349000,30000,9
TIKI,nha-cua-doi-song,655378,"Đèn Tích Điện Đa Năng 360 Cỡ Trung Sunhouse SHE-6848LA - Trắng",201000,331000,130000,39
TIKI,nha-cua-doi-song,27609461,"Dụng cụ thông tắc bồn cầu, cống bằng khi nén áp lực siêu mạnh",185000,185000,0,0
TIKI,nha-cua-doi-song,72904497,"Kệ Nhà Tắm Kèm Nhả Kem Đánh Răng Tự Động 2 Cốc OENON Lắp Đặt Dán Tường - OEKEM",159000,300000,141000,47
TIKI,nha-cua-doi-song,197412247,"[ TikiNow giao hàng ] Ghế chỉnh dáng ngồi đúng Roichen - Hàn Quốc. Sản phẩm dành cho Nam. Nhập khẩu Hàn Quốc (Made in Korea). Hàng chính hãng Roichen",785000,898000,113000,13
TIKI,nha-cua-doi-song,191820658,"Gối Cao Su Thiên Nhiên Gummi Cookie Thiết Kế Vòm Cong Tối Ưu Giúp Giảm Đau Cổ Vai Gáy Vượt Trội",489000,720000,231000,32
TIKI,nha-cua-doi-song,48175867,"KỆ TRANG TRÍ VUÔNG 2 TẦNG - CAO 50CM x DÀI 35CM x RỘNG 35CM ",150000,150000,0,0
TIKI,nha-cua-doi-song,32178097,"Chảo Sâu Lòng NAG2653 Đáy Từ 5 Lớp Chống Dính Vung Kính Siêu Bền Nagakawa (26cm) - Dùng Trên Mọi Loại Bếp - Hàng Chính Hãng",333000,585000,252000,43
TIKI,nha-cua-doi-song,139562345,"Khăn mặt khô  Animerry dùng 1 lần lau khô, lau ướt - Giấy lau mặt dùng một lần",12900,18500,5600,30
TIKI,nha-cua-doi-song,54483857,"Đèn Bàn Học Đọc Sách, Làm Việc (Học Sinh, Sinh Viên, Văn Phòng) LED Chống Cận, Cảm Ứng Tích Điện Pin 2500mAh Elights BT-618",49000,49000,0,0
TIKI,nha-sach-tiki,73139676,"Full bộ (20 quyển) Truyện kể Mầm non - Cổ tích - Ngụ ngôn Aesop (giao ngẫu nhiên)",107781,207271,99490,48
TIKI,nha-cua-doi-song,84699481,"Đèn Bàn Học Đọc Sách Làm Việc LED Chống Cận Bảo Vệ Mắt – Cảm Ứng Tích Hợp Sạc Không Dây - Vùng Sáng 3000-6500K – 5 Cấp Độ Điều Chỉnh – Phiên Bản Nâng Cấp Cổng Type-C",649000,799000,150000,19
TIKI,nha-sach-tiki,167210783,"Trường An Ly Ca 1 – Máu Đỏ Hoa Đào",135000,175000,40000,23
TIKI,nha-sach-tiki,100958526,"Nhân Tố Enzyme - Thực Hành (Tái Bản 2021)",73000,109000,36000,33
TIKI,nha-cua-doi-song,73116895,"Găng tay nướng bánh cách nhiệt Baking Gloves ",50000,50000,0,0
TIKI,nha-cua-doi-song,113458874,"Tủ Để Đồ Thông Minh S Smart Tận Dụng Không Gian Cạnh Cửa Sổ - GP131",406000,444000,38000,9
TIKI,nha-sach-tiki,192339426,"Không Ai Sống Giống Ai Trong Cuộc Đời Này",112000,145000,33000,23
TIKI,nha-cua-doi-song,579928,"Chảo Sâu Chống Dính Sunhouse SHS20 20cm",130000,180000,50000,28
TIKI,nha-cua-doi-song,100522012,"Cây Lau Nhà Thông Minh, Chổi Lau Nhà 360 Độ Đa Năng (Không Bao Gồm Thùng Vắt) - Parroti MOP-PR01",209000,269000,60000,22
TIKI,nha-cua-doi-song,174378686,"Miếng gảy đàn, Pick - Alice AP-ALT - Dành cho Guitar, Ukulele, Bass - Dày 0.46mm, Colorful Celluloid - Màu ngẫu nhiên - Hàng chính hãng",14000,14000,0,0
TIKI,nha-sach-tiki,181379116,"Hackers Toeic Vocabulary (Tái Bản)",173800,279000,105200,38
TIKI,nha-cua-doi-song,25412653,"Cây lăn bụi quần áo đa năng kèm 2 cục dự phòng",13000,15000,2000,13
TIKI,nha-cua-doi-song,579854,"Nồi Nấu Bột Chống Dính Nắp Kính Sunhouse SHG-MP14 14cm",122000,180000,58000,32
TIKI,nha-cua-doi-song,199581980,"Kệ Sách Gỗ Để Bàn Thương Hiệu IGA - GP62",100000,109000,9000,8
TIKI,nha-cua-doi-song,10017811,"Súng bắn keo nến 20w +Tặng 10 cây keo nến ",44300,44300,0,0
TIKI,nha-sach-tiki,111285050,"Ai Lấy Miếng Pho Mát Của Tôi ? (Tái Bản)",47100,68000,20900,31
TIKI,nha-cua-doi-song,14981747,"01 hộp đũa Inox 304 cao cấp DandiHome (10 đôi) - Cá chép vượt cổng Vũ Môn",300000,300000,0,0
TIKI,nha-sach-tiki,76541999,"Tăng tốc luyện đề thi Đánh giá năng lực (theo cấu trúc đề thi của Đại học Quốc gia TP. Hồ Chí Minh)",157000,225000,68000,30
TIKI,nha-cua-doi-song,241805597,"Móc Dán Tường, Móc Dính Tường Treo Đồ Nặng Siêu Dính Inox 304 - Treo Thớt, Nồi Niêu Xong Chảo, Treo Đồ Đa Năng",12000,12000,0,0
TIKI,nha-cua-doi-song,54476660,"Đèn Bàn Học Đọc Sách, Làm Việc (Học Sinh, Sinh Viên, Văn Phòng) Cao Cấp Kẹp Bàn – 03 Mức Độ Ánh Sáng Vàng Bảo Vệ Mắt Chống Cận Pin 2500 mAh",149000,149000,0,0
TIKI,nha-cua-doi-song,146509745,"Bộ Hộp Cơm Giữ Nhiệt Văn Phòng Cao Cấp Cắm Điện inox 3 tầng - Chính hãng dododios",189000,189000,0,0
TIKI,nha-cua-doi-song,120470943,"Bình Nước Thuỷ Tinh Luminarc Bucolique 1.3L - LUBIN1806 ",136000,136000,0,0
TIKI,nha-cua-doi-song,31206755,"Hộp 40 viên pin Maxell AAA",122000,130000,8000,6
TIKI,nha-cua-doi-song,197799361,"Combo 2 Bộ Chuyển Đổi Ổ Cắm 2 Chấu Thành 3 Chấu",27094,28520,1426,5
TIKI,nha-cua-doi-song,59047203,"Bộ 10 đầu tưới nắp chai nhỏ giọt tự động thông minh có điều chỉnh ( tưới hoa, cây cảnh )",29000,29000,0,0
TIKI,nha-cua-doi-song,134621577,"[Nhập CECAMP70KD1 giảm 70k đơn 999k] Bộ Dao 7 Món Lock&amp;Lock CKK301",1594000,2657000,1063000,40
TIKI,nha-cua-doi-song,105717965,"Bình Giữ Nhiệt 2GOOD FLASK WM-02 Sport Lid (946ml) - Hàng Chính Hãng",399000,399000,0,0
TIKI,nha-cua-doi-song,51530502,"GƯƠNG KỆ ĐỨNG KHUNG GỖ HÀN QUỐC - MIRROR SHELF - D41 X R35 X C160 - 2 MÀU LỰA CHỌN",415000,420000,5000,1
TIKI,nha-sach-tiki,11357193,"Những Cuộc Phiêu Lưu Của Huckleberry Finn",63000,98000,35000,36
TIKI,nha-cua-doi-song,112760341,"Thùng rác treo tủ bếp có nắp đậy thông minh, thùng rác treo tường dán tường, có thanh trượt cửa bếp – Parroti Bin BN02",169000,299000,130000,43
TIKI,nha-sach-tiki,191801175,"Nhịn Khô",98500,139000,40500,29
TIKI,nha-sach-tiki,193981038,"Vua sáng chế - Tập 15",20000,20000,0,0
TIKI,nha-sach-tiki,113583126,"Ngữ Pháp Tiếng Anh (Tái Bản)",57400,89000,31600,36
TIKI,nha-sach-tiki,3048355,"Nhà (Tái Bản)",70400,109000,38600,35
TIKI,nha-cua-doi-song,17000892,"Ô gấp gọn chống tia UV ",35000,35000,0,0
TIKI,nha-cua-doi-song,72332230,"GỐI CHỮ U CAO SU NON - GỐI TỰA CỔ CHO DÂN VĂN PHÒNG, LÁI XE, DU LỊCH",99000,99000,0,0
TIKI,nha-sach-tiki,9687409,"Thôi Miên Bằng Ngôn Từ",121580,169000,47420,28
TIKI,nha-cua-doi-song,172447892,"Bộ 6 túi giặt siêu dày 3 lớp cao cấp - Combo 6 túi lưới bảo vệ quần áo dùng cho máy giặt siêu bền tiện dụng chính hãng",165000,250000,85000,34
TIKI,nha-cua-doi-song,128584341,"Ổ cắm đa năng USB Rạng Đông dài 3m Model: OC02.USB 3C/3M/10A",277200,308000,30800,10
TIKI,nha-sach-tiki,135754581,"Những Câu Chuyện Truyền Cảm Hứng - I Will Be Better: Nguồn Năng Lượng Tích Cực",43000,58000,15000,26
TIKI,nha-cua-doi-song,56612464,"Hộp Cơm Giữ Nhiệt INOX304 Hiện Đại Kèm Hộp Đựng Canh Soup",177650,187000,9350,5
TIKI,nha-cua-doi-song,143217219,"Kệ Đa Năng Lưu Trữ Đồ Dùng, Giá Sách Có Bánh Xe Thương Hiệu IGA - GP173",293000,318000,25000,8
TIKI,nha-sach-tiki,155115301,"Bộ "Chuyện xóm gà" 2",276000,348000,72000,21
TIKI,nha-sach-tiki,45349383,"Hashtag No.2 Fashion - Kinh Doanh Thời Trang Tại Thị Trường Việt Nam",153000,200000,47000,24
TIKI,nha-cua-doi-song,63821690,"Vòi Lavabo lạnh - 01 đường nước - tay gật gù Yamato cao cấp",169000,200000,31000,16
TIKI,nha-sach-tiki,53301006,"Sách Ping - Vượt Ao Tù Ra Biển Lớn (Tái Bản 2020)",64100,98000,33900,35
TIKI,nha-cua-doi-song,88241130,"Khăn trải bàn nhựa PVC không thấm nước, khăn trai bàn có hoạ tiết đẹp phù hợp với mọi nhà",55000,55000,0,0
TIKI,nha-cua-doi-song,176592358,"Cây lau nhà tự vắt đa năng Sunhouse KS-MO3211PW",181000,263000,82000,31
TIKI,nha-sach-tiki,92492870,"Combo 6 Cuốn Ehon Nhật Bản : Ai Ở Sau Lưng Bạn Thế (Tái Bản)",161000,234000,73000,31
TIKI,nha-sach-tiki,197602047,"Fullmetal Alchemist - Cang Giả Kim Thuật Sư - Fullmetal Edition Tập 9",61400,69000,7600,11
TIKI,nha-sach-tiki,2380007,"Khi Bạn Đang Mơ Thì Người Khác Đang Nỗ Lực",108800,136000,27200,20
TIKI,nha-cua-doi-song,195968874,"Đèn LED Mini Móc Khóa Siêu Sáng Tiện Dụng US ARMY,  Đèn Pin COB Dã Ngoại Thường Ngày, Sạc TYPE-C Tiện Dụng Dung Lượng PIN 500mAh  Full Hộp Sạc- HÀNG CHÍNH HÃNG",63000,178000,115000,65
TIKI,nha-cua-doi-song,477936,"Lõi Lọc Kova-Barrier Tiêu Chuẩn - FC-STD",183000,235000,52000,22
TIKI,nha-sach-tiki,69219921,"OKRs - Hiểu Đúng, Làm Đúng - Cách Để Áp Dụng Thành Công OKRs Ngay Từ Đầu",150600,239000,88400,37
TIKI,nha-sach-tiki,190464440,"Ikigami - Tập 05",32000,45000,13000,29
TIKI,nha-sach-tiki,186434701,"Khi Bạn Đang Say Giấc, Ai Đó Đã Đạt Được Ước Mơ-Tặng kèm 01 bookmark",76100,108000,31900,30
TIKI,nha-cua-doi-song,579962,"Bộ Nồi 5 Đáy Cao Cấp Núm Vàng Sunhouse SH781 Quay Mạ Vàng Cao Cấp (16cm, 20cm, 24cm) - Dùng Cho Mọi Loại Bếp - Hàng Chính Hãng",487000,960000,473000,49
TIKI,nha-sach-tiki,58390336,"Python cơ bản",125000,125000,0,0
TIKI,nha-sach-tiki,8835165,"Ông Trăm Tuổi Trèo Qua Cửa Sổ Và Biến Mất (Tái Bản)",125000,190000,65000,34
TIKI,nha-sach-tiki,189657596,"Komi - Nữ Thần Sợ Giao Tiếp Tập 11",25000,25000,0,0
TIKI,nha-cua-doi-song,70898819,"Giấy ăn giấy gấu trúc Ycool -khăn giấy rút 300 tờ 1bịch 10 gói mẫu trắng",45000,45000,0,0
TIKI,nha-cua-doi-song,274121764,"Ruột Gối Ôm Gòn Cozy Thuần Việt - Sợi Gòn Cao Cấp, Êm Ái - Kích Thước 20x100",220000,350000,130000,37
TIKI,nha-sach-tiki,68392386,"Stephen Hawking - Trả Lời Ngắn Gọn Những Câu Hỏi Lớn",55800,90000,34200,38
TIKI,nha-sach-tiki,22634335,"Kỹ Năng Quản Lý Nhân Sự Chuyên Nghiệp",82800,119000,36200,30
TIKI,nha-cua-doi-song,70820849,"Pin CR2032 Energizer 3V vỉ 5 viên",59000,100000,41000,41
TIKI,nha-sach-tiki,188940825,"Những Chàng Trai Ở Lộc Phong Quán – Tập 10 - Tặng 1 bookmark 2 mặt ",38100,48000,9900,21
TIKI,nha-cua-doi-song,134242996,"Ly Nhựa Có Ống Hút Lock&amp;Lock HAP507YEL",113000,217000,104000,48
TIKI,nha-sach-tiki,107342987,"Bút bi nước khô nhanh Deli - 0.5mm - Bút viết thư pháp - Ống bút liền mực - Mực Xanh - 1 chiếc - S856",12600,12600,0,0
TIKI,nha-sach-tiki,90227346,"Sapiens: Lược Sử Loài Người Bằng Tranh - Tập 1: Khởi Đầu Của Loài Người",212100,345000,132900,39
TIKI,nha-cua-doi-song,80901951,"Kéo Nhật Nội Địa SK5 Siêu Sắc, Kéo Nhà Bếp, Kéo Cắt Gà, Cắt Vịt, Cắt Thịt Các Loại",79000,79000,0,0
TIKI,nha-sach-tiki,190242074,"Chuông Gió (Tập 1) - Tặng kèm 1 bookmark",123000,174000,51000,29
TIKI,nha-sach-tiki,186211127,"Khởi Nghiệp Kinh Doanh Online - Bán Hàng Hiệu Quả Trên Shopee",151000,199000,48000,24
TIKI,nha-sach-tiki,196517619,"Thiếu Nữ (Shoujo)",97500,150000,52500,35
TIKI,nha-sach-tiki,188487640,"Dragon Ball Full Color - Phần Năm: Truy Lùng Cell Bọ Hung  - Tập 2 [Tặng Ngẫu Nhiên 1 Trong 2 Mẫu Postcard Nhân Vật]",68100,77000,8900,12
TIKI,nha-cua-doi-song,51541280,"Hộp Cơm Cắm Điện - Hộp Hâm Nóng Văn Phòng 2 Tầng ArirangLife EL-ALS263 (Hồng) - Hàng chính hãng",455000,749000,294000,39
TIKI,nha-sach-tiki,76401055,"Sét Bong Bóng Trang Trí Sinh Nhật FUNU Nhiều Mẫu Kèm Bơm Tay- Hàng Chính Hãng",116850,123000,6150,5
TIKI,nha-sach-tiki,171170802,"Kỹ thuật giao dịch nâng cao để kiếm tiền hàng ngày trên thị trường chứng khoán – Advanced Techniques in Day Trading",359000,359000,0,0
TIKI,nha-sach-tiki,193605374,"Làm Sao Để Che Giấu Một Đế Quốc - How To Hide An Empire",222000,299000,77000,26
TIKI,nha-sach-tiki,8886005,"Bay Trên Tổ Chim Cúc Cu (Tái Bản)",91500,118000,26500,22
TIKI,nha-sach-tiki,186434891,"Cá Cược Với Tình Yêu",95000,95000,0,0
TIKI,nha-sach-tiki,100384412,"Vô Cùng Tàn Nhẫn Vô Cùng Yêu Thương (Tái Bản)",109620,189000,79380,42
TIKI,nha-sach-tiki,59078520,"Các phương pháp giao dịch ngắn hạn hiệu quả trên thị trường Forex – Day Trading and Swing Trading the Currency Market",299000,299000,0,0
TIKI,nha-sach-tiki,196150482,"Người nuôi ong thành Aleppo - The beekeeper of Aleppo (Aspen Words Literary Prize Winner)",108000,168000,60000,36
TIKI,nha-sach-tiki,193917227,"Mỹ Vị Hầm Ngục - 3 - Bản Đặc Biệt - Tặng Kèm Bìa 2 Mặt, Bộ Đôi Card Chiến Binh & Ẩm Thực",45000,70000,25000,36
TIKI,nha-sach-tiki,109322300,"Combo 8 cuốn Ehon Kỹ năng sống: Bon và Gia đình, Bạn bè",120640,232000,111360,48
TIKI,nha-sach-tiki,139979524,"Thiền - Osho (Tái Bản)",102000,149000,47000,32
TIKI,nha-sach-tiki,192475873,"Để Con Được Ốm",90100,120000,29900,25
TIKI,nha-sach-tiki,188534368,"Khúc Ngẫu Hứng Trước Ga Mahoro",135000,180000,45000,25
TIKI,nha-sach-tiki,95090643,"Bút màu marker chuyên nghiệp Deli -kèm túi vải - 30/40/60/80 Màu - 70806",232200,232200,0,0
TIKI,nha-sach-tiki,95289208,"Người Bà Tài Giỏi Vùng Saga",83000,128000,45000,35
TIKI,nha-sach-tiki,184801142,"Cutie Pie – Em Ngoan, Lại Cho Là Em Ngốc - Bản thường (tặng kèm 1 bookmark in bồi 2 mặt)",145000,189000,44000,23
TIKI,nha-sach-tiki,196849405,"Gửi Em, Người Bất Tử - Tập 7 (Tái Bản 2022)",21000,30000,9000,30
TIKI,nha-sach-tiki,129672282,"Từ vựng luyện thi IELTS - Vocabulary for Ielts with answers",56000,90000,34000,38
TIKI,nha-sach-tiki,116397449,"Người Tình Sputnik",64000,86000,22000,26
TIKI,nha-sach-tiki,1565657,"Dốc Hết Trái Tim - Cách Starbucks Xây Dựng Công Ty Bằng Từng Tách Cà Phê (Tái Bản 2018)",99000,150000,51000,34
TIKI,nha-sach-tiki,198016673,"Vua Sáng Chế - Tập 18",20000,20000,0,0
TIKI,nha-sach-tiki,190701644,"Dám Mơ Lớn, Đừng Hoài Phí Tuổi Trẻ (Tái Bản) -Tặng kèm 1 bookmark 2 mặt",82100,119000,36900,31
TIKI,nha-sach-tiki,274175495,"Tĩnh Lặng",49200,69000,19800,29
TIKI,nha-sach-tiki,145300494,"The Mastery Of Self - Hành Trình Thấu Hiểu Bản Thân Và Tìm Thấy Tự Do",119000,180000,61000,34
TIKI,nha-sach-tiki,186290802,"Bàn Có Năm Chỗ Ngồi (Tái Bản 2022)",25600,38000,12400,33
TIKI,nha-sach-tiki,184236581,"Năng Lực Của Sự Ngu Ngốc",168000,225000,57000,25
TIKI,nha-sach-tiki,197634255,"Anh em phi hành gia - Tập 34",32000,45000,13000,29
TIKI,nha-sach-tiki,2812299,"Tiếng Nhật Cho Mọi Người - Sơ Cấp 1 - Bản Dịch Và Giải Thích Ngữ Pháp - Tiếng Việt (Bản Mới)",65000,100000,35000,35
TIKI,nha-sach-tiki,19349145,"Bí Mật Tư Duy Triệu Phú (Tái Bản 2019)",86000,108000,22000,20
TIKI,nha-sach-tiki,88791130,"Gôm Tẩy 2B Deli, 40×22×12Mm, Đen - 1 Viên - E3043",7200,7200,0,0
TIKI,nha-sach-tiki,12107394,"Barron's Essential Words For The Toeic (Tái Bản)",166000,238000,72000,30
TIKI,nha-sach-tiki,3640421,"Đắc Nhân Tâm - Bản Dịch Gốc Từ Nguyễn Hiến Lê (Tặng Kèm Audio Book)",56100,90000,33900,38
TIKI,nha-sach-tiki,22878271,"Essential Grammar in Use Book with Answers Edition: A Self-Study Reference and Practice Book for Elementary Learners of English",165540,178000,12460,7
TIKI,nha-sach-tiki,2716247,"Quẳng Gánh Lo Đi Và Vui Sống (Bìa Cứng)",77300,108000,30700,28
TIKI,nha-sach-tiki,77900446,"Thần Số Học: Thấu Hiểu Nhân Tâm",75800,109000,33200,30
TIKI,nha-sach-tiki,136340700,"Trên Lưng Khổng Tượng - Kinh Doanh Online Trên Sàn Thương Mại Điện Tử - Khởi Nghiệp Với Bán Hàng Qua Mạng và Nhãn Hàng Riêng",155000,199000,44000,22
TIKI,nha-sach-tiki,57350380,"Very Easy Toeic 1 - Introduction",159000,228000,69000,30
TIKI,nha-sach-tiki,186088879,"Beyond Order - Vượt Lên Trật Tự",257000,350000,93000,27
TIKI,nha-sach-tiki,91444567,"Sống Cuộc Đời Bạn Muốn",180000,220000,40000,18
TIKI,nha-sach-tiki,196849394,"Gửi Em, Người Bất Tử - Tập 6 (Tái Bản 2022)",21000,30000,9000,30
TIKI,nha-sach-tiki,54422996,"Nóng Giận Là Bản Năng, Tĩnh Lặng Là Bản Lĩnh (Tái Bản 2020)",66800,89000,22200,25
TIKI,nha-sach-tiki,73105037,"Combo 9 cuốn Tập tô - Tập viết chữ - Làm quen chữ cái/chữ số (Chuẩn bị vào lớp 1)",56160,108000,51840,48
TIKI,nha-sach-tiki,57815506,"Sách Tư Duy Ngược Dịch Chuyển Thế Giới",124000,178000,54000,30
TIKI,nha-sach-tiki,131401030,"Ayurveda",240000,240000,0,0
TIKI,nha-sach-tiki,185188826,"Fryderyk Chopin: Cuộc Đời Và Thời Đại ",374000,499000,125000,25
TIKI,nha-cua-doi-song,72049662,"Combo 6 Túi Giặt Lưới Bảo Vệ Quần Áo, túi lưới mịn polyester bảo quản quần áo",99000,99000,0,0
TIKI,nha-cua-doi-song,146432055,"Túi Chân Không Tự Hút Đựng Chăn Mền Quần Áo Không Cần Dụng Cụ Hút",42000,42000,0,0
TIKI,nha-cua-doi-song,19929974,"Bộ 4 Ống Hút Thủy Tinh Chịu Nhiệt (2 Cong + 2 Thẳng) + 2 Cọ Rửa + 1 Túi Vải",69000,69000,0,0
TIKI,nha-cua-doi-song,52238726,"Mùng Chụp Tự Bung Cao Cấp Siêu Dày - Màu Xanh Da Trời  + Tặng kèm túi thơm thảo dược",155000,215000,60000,28
TIKI,nha-cua-doi-song,89992214,"Kệ Góc Nhà Tắm INOX 304 dán tường gạch men siêu chắc",69000,125000,56000,45
TIKI,nha-cua-doi-song,59259444,"Mùng chụp tự bung cao cấp FUNU - Màn chống muỗi thông minh - Hàng chính hãng (Sản xuất tại Việt Nam)",145700,155000,9300,6
TIKI,nha-cua-doi-song,116048764,"Kệ sách tổ ong vân gỗ dễ dàng kết hợp với bàn làm việc chính hãng IGA - GP100",121000,130000,9000,7
TIKI,nha-cua-doi-song,70083074,"Ghế xếp thư giãn SUMIKA 199 - có lăn tay massage, khung vuông cao cấp, tải trọng 300kg",1165000,1580000,415000,26
TIKI,nha-cua-doi-song,134515126,"Bình giữ nhiệt cho trẻ em LocknLock Cozy Kids Straw Tumbler LHC4236BLU 330ml - Màu",355000,592000,237000,40
TIKI,nha-cua-doi-song,53599746,"Combo Giá Treo Ổ Cắm Điện, Modem Dán Tường Tiện Dụng",19900,19900,0,0
TIKI,nha-cua-doi-song,38059858,"Bộ 10 khăn lau 2 mặt siêu thấm- Khăn lau không phai màu không rụng sợi- nhanh khô- Khăn lau bếp, khăn lau kính, lau bát lau tay",9999,9999,0,0
TIKI,nha-cua-doi-song,157055245,"Combo 100 viên khăn giấy nén hình viên kẹo bỏ túi khi đi du lịch, 50 viên khăn lau mặt dạng nén dùng một lần siêu tiện lợi",35000,35000,0,0
TIKI,nha-cua-doi-song,191822621,"Gối Foam Contour Doona Sofy Cấu Trúc Lượn Sóng Nâng Đỡ Định Hình Xương Cổ Và Đầu Hoàn Hảo",339000,600000,261000,44
TIKI,nha-cua-doi-song,111511362,"Cuộn giấy lau nhà bếp đa năng 220 tờ màu trắng siêu dai có thể giặt được",9000,10500,1500,14
TIKI,nha-cua-doi-song,14448546,"Bình Gas Bơm Bật Lửa BlueSky",55000,55000,0,0
TIKI,nha-cua-doi-song,163827070,"Combo 2 hộp chia ngăn sắp xếp quần áo phong cách Nhật Bản VINAVU",190000,190000,0,0
TIKI,nha-cua-doi-song,169650796,"Màn chụp, mùng chụp đỉnh vuông Không chân viền cao cấp Một Cửa - Hàng chính hãng (Giao ngẫu nhiên)",313500,330000,16500,5
TIKI,nha-cua-doi-song,54412879,"Lô 4 túi rác tiện dụng Soji - size 10L - 25L và 50L",33250,35000,1750,5
TIKI,nha-cua-doi-song,163574367,"Nến Thơm Cenote 4 Mùi Cao Cấp, Có Nắp Tắt Lửa Không Khói, Dùng cho Phòng Khách, Spa, Khách sạn và Phòng Hát Karaoke",139000,139000,0,0
TIKI,nha-cua-doi-song,71999227,"Bộ Nồi Inox 3 Lớp Đáy Liền Elmich Trimax Classic 2106OL Size 18,20,24cm",1591000,2870000,1279000,45
TIKI,nha-cua-doi-song,192258425,"Thảm Chùi Chân 4 Lớp Siêu Thấm Hút Nhiều Hoa Văn Độc Đáo",79000,79000,0,0
TIKI,nha-cua-doi-song,89980825,"Bộ 2 nhả kem đánh răng tự động OENON, Kệ nhà tắm thông minh kèm cốc láp đặt dán tường - 2NHAKEM",229000,400000,171000,43
TIKI,nha-cua-doi-song,17488465,"Vỉ 5 viên Pin GP 12V 23A",49000,49000,0,0
TIKI,nha-cua-doi-song,169978766,"Túi Hút Chân Không Đựng Quần Áo, Chăn Ga Gối, Thú Bông Deli - Loại Dày Cao Cấp, Nhiều Hoạ Tiết, Bảo Vệ Quần Áo, Chăn Ga Khỏi Ẩm, Nấm Mốc, Chống Nước Tuyệt Đối",16000,35820,19820,55
TIKI,nha-cua-doi-song,31576989,"Quai xách Dây Dù bình giữ nhiệt 2GOOD Para Handle",65000,65000,0,0
TIKI,nha-cua-doi-song,270862516,"Gối cao su chống đau cột sống - Gối cao su dành cho người hay ngủ ngáy mỏi cổ vai gáy – Hàng chính hãng",127000,200000,73000,37
TIKI,nha-cua-doi-song,45404047,"[ĐẶC BIỆT] Nhang Xanh Trầm Hương Cao Cấp 15 năm -100g - mùi thơm tự nhiên, dịu ngọt của trầm - Nhang Thiền",123500,125000,1500,1
TIKI,nha-cua-doi-song,68716607,"Dao Thái Sunhouse KS-KN165SS",73000,117000,44000,38
TIKI,nha-cua-doi-song,165109465,"Kệ Lò Vi Sóng 2 Tầng, Kệ Nhà Bếp Thương Hiệu IGA - GM52",155000,169000,14000,8
TIKI,nha-cua-doi-song,84746981,"Lọ đựng gia vị, dầu ăn, nước chấm bằng thủy tinh trong suốt kèm muỗng tiện lợi",11900,11900,0,0
TIKI,nha-cua-doi-song,59598451,"Miếng xốp bọc chân cửa chắn gió chống bụi, ngăn tiếng ồn, ngăn côn trùng 93 x 9.6cm",20000,20000,0,0
TIKI,nha-cua-doi-song,114976767,"Nệm foam Goodnight Massage bán chạy số 1 Việt Nam 9cm tại Vua Nệm - Cấu trúc lượn sóng duy trì tư thế tự nhiên của cột sống",4290000,4290000,0,0
TIKI,nha-cua-doi-song,199593599,"Kệ Sách Hình Cây Để Sàn",224000,245000,21000,9
TIKI,nha-cua-doi-song,71174837,"Đèn Pin Mini Siêu Sáng XML-T6 miDoctor - Chính Hãng",86000,86000,0,0
TIKI,nha-cua-doi-song,803123,"Thùng rác nhựa Fitis Compact X PPL1-906",280000,350000,70000,20
TIKI,nha-cua-doi-song,115532506,"Hộp Nhựa Đựng Thực Phẩm, Hộp Bảo Quản Thực Phẩm Tủ Lạnh Homepower Trong Suốt Có Khay Lót Đáy Giúp Ráo Nước, Vòng Ghi Chú Thời Gian Bảo Quản Tiện Lợi",129000,129000,0,0
TIKI,nha-cua-doi-song,75340681,"Hộp Đựng Đồ Đa Năng TD1 – Túi Vải Đựng Quần Áo Chăn Màn Phong Cách Thụy Điển Sang Trọng, Lịch Sự – Hàng Chính Hãng",76000,130000,54000,42
TIKI,nha-cua-doi-song,88925284,"Ổ Cắm Điện LIOA 10 ổ dây 3m(4D6S32) & 5m (4D6S52)",140000,140000,0,0
TIKI,nha-cua-doi-song,103780888,"Ổ cắm có dây - Ổ điện an toàn - Ổ cắm điện đa năng - Ổ cắm điện Lioa ( 4 - 6 - 10 ổ cắm ) dây 5m và 3m Lioa - hàng chính hãng cao cấp",62000,62000,0,0
TIKI,nha-cua-doi-song,146062295,"Bộ 2 Ốc Vít - Chốt Cao Su Cố Định Nắp Bồn Cầu",68000,68000,0,0
TIKI,nha-sach-tiki,109018530,"Vườn Hoa Mạt Dược Ký Sự - Những Kỳ Án Nổi Tiếng Chưa Có Lời Giải (Tặng Kèm 1 Bookmark Chữ Nhật)",90100,139000,48900,35
TIKI,nha-sach-tiki,170094968,"Atlas Giải Phẫu Cơ Thể Người - Tái Bản",502000,680000,178000,26
TIKI,nha-sach-tiki,187619074,"Quý Cô Tài Chính",103000,139000,36000,26
TIKI,nha-sach-tiki,185595374,"Picasso Và Bức Tranh Khiến Thế Giới Sửng Sốt",299000,399000,100000,25
TIKI,nha-sach-tiki,173093792,"Thao Túng Tâm Lý - Nhận Diện, Thức Tỉnh Và Chữa Lành Những Tổn Thương Tiềm Ẩn",126800,169000,42200,25
TIKI,nha-sach-tiki,95090377," Bút màu sáp dầu học sinh hộp nhựa Deli - 12/18/24 màu - 72090/72091/72092",52200,52200,0,0
TIKI,nha-sach-tiki,170463582,"Siêu Nhí Biết Tuốt - 101 Bí Ẩn Kích Thích Tò Mò Của Các Bạn Nhỏ",124800,240000,115200,48
TIKI,nha-sach-tiki,58441509,"Ăn Uống Đúng Cách: Bộ Quy Tắc Ẩm Thực Lành Mạnh",86500,116000,29500,25
TIKI,nha-sach-tiki,13673970,"Combo Trinh Thám Giây Thứ 12 (2 Tập)",95000,276000,181000,66
TIKI,nha-sach-tiki,87389629,"OSHO - Sáng Tạo Bừng Cháy Sức Mạnh Bên Trong (Tái Bản)",72500,108000,35500,33
TIKI,nha-sach-tiki,77324132,"Phụ Nữ Hiểu Biết Sẽ Có Cuộc Sống Đẳng Cấp Hơn (Tặng Kèm Bookmark)",85900,119000,33100,28
TIKI,nha-sach-tiki,75813201,"Không Đến Một (Tái Bản - Bìa Cam)",79200,110000,30800,28
TIKI,nha-sach-tiki,335337,"Tôi Tài Giỏi - Bạn Cũng Thế",128050,135000,6950,5
TIKI,nha-sach-tiki,195306000,"Tư trị thông giám - Tập 9",211000,285000,74000,26
TIKI,nha-sach-tiki,56878836,"Sách Muôn Kiếp Nhân Sinh (Bìa Cứng) - Nguyên Phong",169000,228000,59000,26
TIKI,nha-sach-tiki,191506179,"Sách Bạn Thật Sự Là Ai?",60600,88000,27400,31
TIKI,nha-sach-tiki,117035933,"Sách: Hài Hước Một Chút Thế Giới Sẽ Khác Đi (Tái Bản)",64000,80000,16000,20
TIKI,nha-sach-tiki,193981046,"Tiệm trừ yêu kì ảo - Tập 17",33000,35000,2000,6
TIKI,nha-sach-tiki,142002263,"Muôn Kiếp Nhân Sinh 2 (Bìa Cứng)",338000,338000,0,0
TIKI,nha-sach-tiki,126853168,"Thấu hiểu Hành vi giá Thị trường Tài chính (Understanding Price Action)",367000,367000,0,0
TIKI,nha-sach-tiki,176473191,"Bút màu marker lẻ chiếc 2 đầu to nhỏ nhiều màu thân bút vuông màu đen Deli - Tô màu vẽ tranh trang trí sổ tay - 70701",4000,9000,5000,56
TIKI,nha-sach-tiki,137241842,"Trồng Một Nụ Cười - Cùng Trẻ Thực Hành Chánh Niệm",138000,199000,61000,31
TIKI,nha-sach-tiki,195801645,"Thực Học Của Inamori Kazuo: Quản Trị Và Kế Toán",64000,95000,31000,33
TIKI,nha-sach-tiki,190214568,"Kỷ luật bản thân",132300,189000,56700,30
TIKI,nha-sach-tiki,26593338,"Misty Morning Walk With Mother - Cùng Mẹ Đi Trong Sương Sớm",41000,85000,44000,52
TIKI,nha-sach-tiki,32192510,"Madame Chic - Rất Thần Thái, Rất Paris",64000,99000,35000,35
TIKI,nha-sach-tiki,107802188,"Bí Mật Tư Duy Triệu Phú (Tái Bản)",75100,108000,32900,30
TIKI,nha-sach-tiki,174038838,"Here U Are – Tập 2 - Bản Thường: Tặng Kèm 1 Bookmark Bế Hình",88100,110000,21900,20
TIKI,nha-sach-tiki,189371286,"[ Gift] [Hàng Tặng Không Bán] Sổ Tay Sức Khỏe DHC",50000,50000,0,0
TIKI,nha-sach-tiki,185024355,"Spy X Family 7",25000,25000,0,0
TIKI,nha-sach-tiki,107363748,"Bút chì màu dạng cốc Deli - bút chì gỗ khô tự nhiên an toàn -  12/24/36/48 màu - 7070",52200,52200,0,0
TIKI,nha-sach-tiki,130314065,"Tâm lý thị trường chứng khoán - Hành vi đám đông và sự thật đằng sau những con sóng",37100,50000,12900,26
TIKI,nha-sach-tiki,193684717,"Từ Vũ Trụ Đến Trái Tim – Những Thông Điệp Yêu Thương",88500,89000,500,1
TIKI,nha-sach-tiki,117681065,"Sống Thực Tế Giữa Đời Thực Dụng (Tái Bản)",92400,129000,36600,28
TIKI,nha-sach-tiki,95090744," Bút chì lục giác Deli - loại 2B/HB - 30 chiếc/hộp - 58166 / 58167",45000,99000,54000,55
TIKI,nha-sach-tiki,67477613,"Xin Bạn Hãy Ôm Lấy Trái Tim Mình Trước Đã (Tặng Kèm 1 Bookmark)",64800,96000,31200,33
TIKI,nha-sach-tiki,41131985,"Thực Hành 7 Thói Quen Của Bạn Trẻ Thành Đạt",54100,78000,23900,31
TIKI,nha-sach-tiki,174377494,"Combo 10 cuốn Ehon Ươm mầm Tính cách",202800,390000,187200,48
TIKI,nha-sach-tiki,49249526,"Thiết Kế Cuộc Đời Thịnh Vượng - Design a Prosperous Life",299000,299000,0,0
TIKI,nha-sach-tiki,75403873,"Bộ Màu Nước Solid Water Color Cao Cấp - Tặng Kèm 2 Bút Nước, 2 Mút, 1 Palette - Chuyên Dùng Cho Học Sinh, Sinh Viên, Vẽ Chuyên Nghiệp - Hàng Chính Hãng - VinBuy",65000,120000,55000,46
TIKI,nha-cua-doi-song,20025334,"Bình Chữa Cháy Dạng Bột Khô ABC MFLZ-4Kg (Chữa cháy chất Rắn, Lỏng và Khí)",220000,380000,160000,42
TIKI,nha-cua-doi-song,135321378,"Thanh Chặn Khe Cửa 95cm Đa Năng,Chặn Đáy Khe Cửa, Ngăn Côn Trùng, Chắn Gió Mùa, Ngừa Bụi Bẩn, Giảm Ồn",8000,13999,5999,43
TIKI,nha-cua-doi-song,53647975,"1 Gối Ôm thương hiệu A có khóa kéo - an toàn sức khỏe, không chứa chất độc hại - êm ái, mềm mịn - KT",125000,150000,25000,17
TIKI,nha-cua-doi-song,57272706,"Combo 200 túi lọc rác bồn rửa bát - Túi lưới lọc rác giúp ngăn chặn tắc đường ống",33030,33030,0,0
TIKI,nha-cua-doi-song,162597633,"Combo 4 miếng dán đỡ kệ gỗ VINAVU, giúp chia ngăn tủ, không cần đóng đinh",24000,24000,0,0
TIKI,nha-cua-doi-song,202805092,"Bình Giữ Nhiệt 800ml Lock&Lock Vacuum Bottle LHC6180 - Hàng Chính Hãng, Bằng Thép Không Gỉ, Có Lưới Lọc Trà Bằng Inox, Mức Giữ Nhiệt Vượt Trội Tặng Kèm Ống Hút Inox",373000,697000,324000,46
TIKI,nha-cua-doi-song,190989483,"Bình giữ nhiệt Baby Inox 316 Elmich EL8017 dung tích 300ml",231000,319000,88000,28
TIKI,nha-cua-doi-song,104681179,"Bông Lau Thay Thế MyJae Dạng Tròn Dành Cho Cây Lau Nhà Xoay 360 Độ",109000,200000,91000,46
TIKI,nha-cua-doi-song,185380294,"Lưới Polyester Phủ Chống Thấm, Vải Polyester Gia Cố Chống Thấm Mái Nhà Sàn Nhà Khe Nứt Khổ 10 cm",77350,91000,13650,15
TIKI,nha-cua-doi-song,272966734,"Ổ cắm điện 5 lỗ 2m Điện Quang SM750SL - Hàng Chính Hãng",175000,175000,0,0
TIKI,nha-cua-doi-song,91475535,"Áo Mưa Cánh Dơi Rằn Ri, Áo Mưa Xẻ Tà Màu Lính Vải Dù Siêu Dày 1M4, Chống Thấm Hiệu Quả, Phù Hợp Nam Và Nữ, Có Túi Đựng",130000,130000,0,0
TIKI,nha-cua-doi-song,34230976,"Bàn làm việc 2 tầng 80cm",210602,214900,4298,2
TIKI,nha-cua-doi-song,125913928,"Móc dán tường trong suốt Móc treo đồ Móc dán tường 3D",700,1000,300,30
TIKI,nha-cua-doi-song,79267304,"Túi rác tự hủy inochi tiện dụng SOJI có quai xuất nhật Dùng đựng rác gia đình ,Bao đựng rác văn phòng đủ size -màu đen mềm nhẹ dai túi rác tự hủy giúp bảo vệ môi trường",38000,45000,7000,16
TIKI,nha-cua-doi-song,21466758,"Đầu chuyển ổ cắm 3 chấu qua 2 chấu - Hàng nhập khẩu",11353,11950,597,5
TIKI,nha-cua-doi-song,117195930,"Pin Maxell Super Đỏ - Hộp 40 Viên Pin Tiểu AA (2A) 1.5V",105000,105000,0,0
TIKI,nha-cua-doi-song,135321411,"Giấy Bạc Tráng Nhôm, dán bếp tăng thẩm mỹ và rất sạch sẽ(2M)",16000,35000,19000,54
TIKI,nha-cua-doi-song,3526073,"Bộ Túi Hộp Cơm Thủy Tinh Lock&Lock 3EA LLG428M2 - Xanh Mint",343000,660000,317000,48
TIKI,nha-cua-doi-song,54132706,"Bộ sạc Energizer Charger kèm 4 pin Ener AA 2000mAh, tự ngắt sạc (CHVCM4) ( Mẫu mới)",429800,449000,19200,4
TIKI,nha-cua-doi-song,72044284,"BÀN LÀM VIỆC CHÂN GẤP GỌN 100CM - Nhiều màu sắc",392000,400000,8000,2
TIKI,nha-cua-doi-song,54582729,"KỆ ĐẦU GIƯỜNG 1 TẦNG - TỦ ĐẦU GIƯỜNG - GỖ THÔNG NEWZEALAND - MÀU GỖ VÀNG NHẠT TỰ NHIÊN CÓ VÂN GỖ",109000,200000,91000,46
TIKI,nha-cua-doi-song,153467342,"Xốp Chèn Cửa 95cm Chặn Đáy Khe Cửa, Cách Nhiệt, Cách Âm, Ngăn Côn Trùng, Thanh Chắn Khe Cửa",4000,26000,22000,85
TIKI,nha-cua-doi-song,55202824,"Bình Nước Nhựa Nắp Vặn Dây Treo Họa Tiết Hươu Và Trăng Tiện Dụng Phù Hợp Với Mọi Lứa Tuổi 560ml",129000,258000,129000,50
TIKI,nha-cua-doi-song,59092666,"MÁY KHUẾCH TÁN TINH DẦU CHUYÊN DỤNG | Vân Gỗ Cao Cấp | Có Điều Khiển Từ Xa | Máy Phun Sương Tỏa Hương Tinh Dầu 500ML Cho Phòng Lớn",229000,476000,247000,52
TIKI,nha-cua-doi-song,15343778,"Kệ góc nhà tắm dán tường inox 304 bóng Hobby Home Decor KG1 kèm keo dán và đinh ốc",249000,249000,0,0
TIKI,nha-cua-doi-song,137572447,"Bóng đèn LED Bulb PHILIPS Essential E27 - Tiết kiệm điện, Ánh sáng chất lượng cao - Hàng Chính Hãng",42000,66000,24000,36
TIKI,nha-cua-doi-song,21301419,"Bàn để là quần áo dạng đứng",140000,140000,0,0
TIKI,nha-cua-doi-song,53830678,"1 cặp ruột gối hơi cao cấp - Gòn bông nhân tạo an toàn sức khỏe, không chứa chất độc hại - Có khóa kéo dễ dàng thêm bớt gòn bên trong - Êm ái, mềm mịn",60000,65000,5000,8
TIKI,nha-cua-doi-song,114621700,"Kệ để hồ sơ văn phòng tiện lợi, kệ sách để bàn nhỏ gọn gỗ MDF chống ẩm chất lượng cao",126000,171000,45000,26
TIKI,nha-cua-doi-song,75616917,"Khăn lau vuông đa năng tiện lợi có dây treo siêu thấm hút lau tay lau bếp vệ sinh nhà cửa 25x25cm",8000,8000,0,0
TIKI,nha-cua-doi-song,66877902,"Đèn Ngủ Quả Cầu Mây Để Bàn SPEVI - Điều Chỉnh Độ Sáng, Làm Đèn Ngủ Trang Trí, Quà Sinh Nhật Cực Đáng Yêu, Đầu USB, Adapter USB Tiện Lợi, Đế Gỗ Xếp Sang Trọng, Bóng Đèn Led Vô Cùng Tiết Kiệm Điện - Hàng Chính Hãng",129000,246000,117000,48
TIKI,nha-cua-doi-song,21782438,"Kìm  kẹp quả óc chó ,càng cua, ghẹ inox - 17x4.5cm 247g",26000,26000,0,0
TIKI,nha-cua-doi-song,95335291,"Combo 10 cặp kẹp dán tường thông minh - Không cần khoan lỗ, đục tường- Chịu lực lên đến 3Kg",35939,37830,1891,5
TIKI,nha-cua-doi-song,70316883,"KỆ ĐỂ GIÀY DÉP GỖ THÔNG- Dài 50cm - 2T500",119000,119000,0,0
TIKI,nha-cua-doi-song,263488472,"Tủ kệ sách để bàn H6689 nhiều màu tiện ích ( Ngẫu nhiên )",48000,58000,10000,17
TIKI,nha-cua-doi-song,193708669,"Bình Đựng Nước 2L Kèm Ống Hút Bao Bì Dễ Thương Có Vạch Báo Giờ Uống Nước Chia Lượng Nước Deli - Bình Nước 2 Lít Nhựa Cao Cấp An Toàn Đầy Đủ Kiểm Định Chất Lượng Phủ Hợp Bình Nước Thể Thao Cho Bé Tới Trường - VS818 VS819",85000,160200,75200,47
TIKI,nha-cua-doi-song,64618364,"Day Đèn LED Siêu Sáng 5050 RGB Chống Nước Quấn Cây Trang Trí Ngoài Trời",112000,112000,0,0
TIKI,nha-cua-doi-song,97817455,"Bộ túi hộp cơm thủy tinh COBA'COOK. Gồm 3 hộp 400ml và 1 túi giữ nhiệt với 2 khóa kéo tiện dụng- CCR43BL",203000,316000,113000,36
TIKI,nha-cua-doi-song,162360312,"[HÀNG XỊN - CHỌN SIZE] Chiếu điều hòa sợi mây tổng hợp lót vải không dệt cao cấp hàng xuất khẩu 2 mặt giá rẻ 1m2 1m6 1m8 chính hãng",182000,300000,118000,39
TIKI,nha-cua-doi-song,92441037,"[LOẠI XỊN - CÓ TẶNG BƠM TAY] Bộ 8 Túi Hút Chân Không Đựng Quần Áo, Chăn Màn CỠ ĐẠI Cao Cấp - Hàng chính hãng",198000,198000,0,0
TIKI,nha-sach-tiki,106788395,"Toán Tư duy - Beginning Creative Math (Dành cho bé 4-6 tuổi/Song ngữ Việt - Anh)",57200,110000,52800,48
TIKI,nha-sach-tiki,544731,"Giáo Trình Chuẩn HSK 2 - Bài Học (Kèm file MP3)",149000,198000,49000,25
TIKI,nha-sach-tiki,140416366,"Hôm Nay Phải Mở Mang (Một Tựa Sách Của Ngày Ngày Viết Chữ Dành Cho Người Học Viết Và Làm Nghề Viết)",93000,119000,26000,22
TIKI,nha-sach-tiki,111290700,"Bố Già (Bìa Cứng) (Tái Bản)",149175,250000,100825,40
TIKI,nha-sach-tiki,178483666,"Những Lời Giáo Huấn Của Epictetus",171000,239000,68000,28
TIKI,nha-sach-tiki,149573910,"Thiên Quan Tứ Phúc - Tập 4",110700,159000,48300,30
TIKI,nha-sach-tiki,23433003,"30 Chủ Đề Từ Vựng Tiếng Anh (Tập 1)",123000,190000,67000,35
TIKI,nha-sach-tiki,4466841,"Trưởng Thành Sau Ngàn Lần Tranh Đấu (Tái Bản)",69100,95000,25900,27
TIKI,nha-sach-tiki,142791749,"Sự Trỗi Dạy Và Suy Tàn Của Đế Chế Thứ 3 (Tái Bản)",275000,445000,170000,38
TIKI,nha-sach-tiki,126474205,"Làm giàu từ chứng khoán bằng phương pháp VSA chính gốc: Nghiên cứu chuyên sâu về cách giao dịch của Wyckoff",499000,499000,0,0
TIKI,nha-sach-tiki,971704,"Tạo Lập Mô Hình Kinh Doanh (Tái bản)",185400,299000,113600,38
TIKI,nha-sach-tiki,192125806,"Dạy con làm giàu - Tập 11 - Trường dạy kinh doanh cho những người thích giúp đỡ người khác (Tái Bản 2022)",53000,80000,27000,34
TIKI,nha-sach-tiki,197629362,"Bức Họa Múa Rối Xương (Combo tập 1+2)",217000,279000,62000,22
TIKI,nha-sach-tiki,190701636,"Yuri Espoir (Tập 2) - Bản thường: tặng kèm postcard",59100,79000,19900,25
TIKI,nha-sach-tiki,171549988,"Trường An Ly Ca 2 - Vén Mây Thấy Trời",127000,165000,38000,23
TIKI,nha-sach-tiki,116835635,"Tớ Học Lập Trình - Làm Quen Với Python",78300,105000,26700,25
TIKI,nha-sach-tiki,113655308,"Giáo Trình Kinh Tế Chính Trị Mác – Lênin (Dành Cho Bậc Đại Học Hệ Không Chuyên Lý Luận Chính Trị) - Bộ mới năm 2021",59000,59000,0,0
TIKI,nha-sach-tiki,142675354,""Từ Điển" Sử Dụng Loài Người",75500,105000,29500,28
TIKI,nha-sach-tiki,96327064,"Bye Béo - Cách giảm 7kg trong 30 ngày",199000,199000,0,0
TIKI,nha-sach-tiki,1445365,"Dưới Một Mái Nhà Ở Paris",87600,119000,31400,26
TIKI,nha-sach-tiki,192124401,"Kingdom -Tập 31",43100,45000,1900,0
TIKI,nha-sach-tiki,95311757,"Lưu Thông Máu Tốt Hóa Giải Bách Bệnh",68800,99000,30200,31
TIKI,nha-sach-tiki,192692368,"Phương Pháp Thực Chiến Hiệu Suất Cao Đến Từ Nhà Quán Quân Giao Dịch Tài Chính",364000,364000,0,0
TIKI,nha-sach-tiki,174605333,"Châu Phi Nghìn Trùng (Tái Bản)",123000,165000,42000,25
TIKI,nha-sach-tiki,136232535,"Ux Content 4.0 (Chọn Đúng Chữ, Giữ Người Dùng)",117000,139000,22000,16
TIKI,nha-sach-tiki,193446626,"Chòm Sao Linh Thú Tập 8 [Tặng kèm Bookmark]",39000,40000,1000,3
TIKI,nha-sach-tiki,106997685,"Keo dán siêu chắc Sealant Fix - Giải pháp thay thế đinh vít",21000,21000,0,0
TIKI,nha-sach-tiki,50773990,"Triết Lý Kinh Doanh Của Kyocera",124000,175000,51000,29
TIKI,nha-sach-tiki,185226873,"Achievers Grade 7 Student's Book with CLIL Book",251000,251000,0,0
TIKI,nha-sach-tiki,53434797,"Sách Tài Chính Cá Nhân Cho Người Việt Nam - Tặng Khóa học Online về Tài chính",200000,200000,0,0
TIKI,nha-sach-tiki,175845415,"Bí Quyết Tìm Kiếm Mặt Bằng Kinh Doanh - Đến Sahara Mở Quán Trà Đá - Bộ Sách Khởi Nghiệp Bán Lẻ",169000,199000,30000,15
TIKI,nha-sach-tiki,181699672,"Shuggie Bain: Chiếc Linh Hồn Nhỏ",156000,235000,79000,34
TIKI,nha-sach-tiki,23437685,"English Vocabulary in Use: Pre-Intermediate and Intermediate Book with Answers: Vocabulary Reference and Practice (Kèm CD)",177600,193000,15400,8
TIKI,nha-sach-tiki,137561095,"Combo 2 Cuốn Sách Tâm Lý Học Nhập Môn: Toàn Thư Tâm Lý Học + Từ Điển Tâm Lý",183000,254000,71000,28
TIKI,nha-sach-tiki,139979522,"Ăn Dặm Kiểu Nhật (Tái Bản)",127000,189000,62000,33
TIKI,nha-sach-tiki,55605172,"Tắt Đèn (Tái Bản 2020)",33000,50000,17000,34
TIKI,nha-sach-tiki,193099631,"Đại Gia Gatsby",59000,86000,27000,31
TIKI,nha-sach-tiki,197602052,"Fullmetal Alchemist - Cang Giả Kim Thuật Sư - Fullmetal Edition Tập 7",61900,69000,7100,10
TIKI,nha-sach-tiki,162832796,"Rilla Dưới Mái Nhà Bên Ánh Lửa",154000,200000,46000,23
TIKI,nha-sach-tiki,106206473,"Thân Gửi Sở Thú",60600,79000,18400,0
TIKI,nha-sach-tiki,106149744,"Tôi Đã Kiếm 2.000.000 Đô La Từ Thị Trường Chứng Khoán Như Thế Nào (Tái Bản)",63220,109000,45780,42
TIKI,nha-sach-tiki,98733259,"Những Tù Nhân Của Địa Lí - Khám Phá Sự Vận Hành Của Thế Giới Qua Những Tấm Bản Đồ - Phiên Bản Minh Hoạ Màu Dành Cho Độc Giả Trẻ",162000,230000,68000,30
TIKI,nha-sach-tiki,57590002,"Fullmetal Alchemist - Cang Giả Kim Thuật Sư - Fullmetal Edition Tập 5",61000,69000,8000,12
TIKI,nha-sach-tiki,192474352,"Vẻ Đẹp Của Sự Vừa Đủ",114000,136000,22000,16
TIKI,nha-sach-tiki,43859629,"Người giàu nhất thành Babylon - phiên bản đầy đủ thêm 2 chương mới",54000,80000,26000,33
TIKI,nha-sach-tiki,3876677,"Hỏa Ngục",149000,239000,90000,38
TIKI,nha-sach-tiki,187933551,"Reiki - Nghệ Thuật Chữa Lành Bằng Năng Lượng",131600,189000,57400,30
TIKI,nha-sach-tiki,188039858,"Combo 4 Cuốn Sổ Tay Ghi Chép A5 Gáy Xoắn 120 Trang Kẻ Ngang Deli - Phù Hợp Làm Sổ Kế Hoạch Planner, Nhật Kí, Tập Vở Ghi Chép Bullet Journal - LA560-06",18000,37800,19800,52
TIKI,nha-sach-tiki,897016,"Combo Sân Chơi Trí Tuệ Của Chim Đa Đa (Bộ 6 Cuốn)",125000,180000,55000,31
TIKI,nha-sach-tiki,197602124,"Fullmetal Alchemist - Cang Giả Kim Thuật Sư - Fullmetal Edition - Tập 6",61100,69000,7900,11
TIKI,nha-sach-tiki,83664156,"Rio Book No.2 - Nhận Diện Thương Hiệu, Những Điểm Chạm Thị Giác (Tái Bản)",127000,170000,43000,25
TIKI,nha-sach-tiki,147802908,"Trong Cái Không Có Gì Không ? - Thiền Sư Thích Nhất Hạnh (NXB KĐ - bìa cứng)",144000,160000,16000,10
TIKI,nha-sach-tiki,56377199,"Giải Mã Siêu Trí Tuệ",126000,169000,43000,25
TIKI,nha-sach-tiki,189641377,"Kombucha - Tuyệt Đỉnh Thức Uống Lên Men",248000,320000,72000,0
TIKI,nha-sach-tiki,192677821,"Sổ tay công thức giải nhanh Toán 12",59000,98000,39000,40
TIKI,nha-sach-tiki,187827390,"Gửi Tới Người Mùa Đông Này Sẽ Không Còn Nữa",95400,123000,27600,22
TIKI,nha-sach-tiki,188663311,"Khi Bạn Đang Mơ Thì Người Khác Đang Nỗ Lực (2022)",91200,136000,44800,33
TIKI,nha-sach-tiki,273896677,"Trí Tuệ Do Thái",141000,189000,48000,25
TIKI,nha-sach-tiki,140635218,"Nuôi Dạy Đứa Trẻ Tự Chủ",130000,179000,49000,27
TIKI,nha-sach-tiki,110944248,"Tôi Không Thích Ồn Ào (Tặng Kèm Bookmark)(Tái Bản)",55000,75000,20000,27
TIKI,nha-sach-tiki,131879454,"Combo Philip Kotler: Tiếp Thị 5.0 - Công Nghệ Vị Nhân Sinh Và Tiếp Thị 4.0 - Dịch Chuyển Từ Truyền Thống Sang Công Nghệ Số",223250,235000,11750,5
TIKI,nha-sach-tiki,105778970,"Nhật Ký Tarot",158000,199000,41000,21
TIKI,nha-sach-tiki,174449882,"“Lần Đầu Làm Sếp” – (Your First Leadership Job)",137000,195000,58000,30
TIKI,nha-sach-tiki,3640427,"Quẳng Gánh Lo Đi Và Vui Sống (Nguyễn Hiến Lê - Bộ Sách Sống Sao Cho Đúng)",56100,90000,33900,38
TIKI,nha-sach-tiki,178514165,"Dọc Đường",124000,160000,36000,23
TIKI,nha-sach-tiki,104315085,"Tư Duy Logic (Tái Bản)",71800,110000,38200,35
TIKI,nha-sach-tiki,67991600,"Nghệ Thuật Từ Chối – Cách Nói Không Mà Vẫn Có Được Đồng Thuận",56000,82000,26000,32
TIKI,nha-sach-tiki,143185998,"Ăn Dặm Không Phải Là Cuộc Chiến (Tái Bản)",197000,289000,92000,32
TIKI,nha-sach-tiki,149257065,"Keanu Reeves - Ma Trận Cuộc Đời (Bí Ẩn Đằng Sau Người Đàn Ông Tử Tế Nhất Hành Tinh)",80000,168000,88000,52
TIKI,nha-sach-tiki,54433518,"Combo Sách Học Tiếng Anh Little Stories 1 (5 Cuốn)",226000,325000,99000,30
TIKI,nha-sach-tiki,168367080,"Thông Não Ielts Reading Cùng Linear",432000,499000,67000,13
TIKI,nha-sach-tiki,11336581,"Rich Habits - Thói Quen Thành Công Của Những Triệu Phú Tự Thân",110000,158000,48000,30
TIKI,nha-sach-tiki,150956757,"Combo 8 cuốn Túi tô màu Tập làm họa sĩ nhí",43680,84000,40320,48
TIKI,nha-sach-tiki,193917225,"Vẽ Vời Vẩn Vơ - 3",19000,58000,39000,67
TIKI,nha-sach-tiki,191571530,"Văn Phòng Thám Tử Quái Vật - Tập 09",29100,30000,900,3
TIKI,nha-sach-tiki,11806671,"Combo Doraemon Truyện Tranh Màu Kỹ Thuật Số (6 Tập)",161000,180000,19000,11
TIKI,nha-sach-tiki,76278485,"Ảo Dạ (Tái Bản)",132000,179000,47000,0
TIKI,nha-sach-tiki,110965784,"Keo Dán Giày Siêu Chắc Chống Nước Tốt Seaglue 100g",69000,79000,10000,13
TIKI,nha-sach-tiki,65786287,"Triệu phú thức tỉnh - bí kíp để khơi dòng suối nguồn thịnh vượng trong tâm thức",214400,268000,53600,20
TIKI,nha-sach-tiki,116158321,"7 Chiến Lược Thịnh Vượng Và Hạnh Phúc (Tái Bản 2021)",68000,85000,17000,20
TIKI,nha-cua-doi-song,184519325,"Bộ quần áo mưa vân tổ ong cao cấp siêu bền",138000,138000,0,0
TIKI,nha-cua-doi-song,107961495,"Ly Nhựa 2 Lớp LocknLock 900ml HAP502BEG - Màu",158000,263000,105000,40
TIKI,nha-cua-doi-song,106996271,"Bộ vòi dẫn nước nước rửa chén inox 304 gắn bồn rửa bát dây dài 1.2met",56154,56154,0,0
TIKI,nha-cua-doi-song,14764119,"Ly Giữ Nhiệt Nắp Trượt Chống Tràn Rinfere - Tặng Kèm Ống Hút Không Gỉ, Dụng Cụ Vệ Sinh Ông Hút (590ml)",265000,299000,34000,11
TIKI,nha-cua-doi-song,54133235,"Pin Sạc AA 2000mAh NH15 Power Plus RP2 Energizer NH15 RP2 (Mẫu mới)",157000,160000,3000,2
TIKI,nha-cua-doi-song,195980111,"Bình giữ nhiệt LocknLock LHC3275 - 490ML - Hàng chính hãng",294000,490000,196000,40
TIKI,nha-cua-doi-song,50294624,"Lưới Đèn LED Chống Nước Trang Trí Ngoài Trời Cho Giánh Sinh, Tiệc, Lễ Tết - Nhiều kích cỡ",119000,119000,0,0
TIKI,nha-cua-doi-song,68513020,"Combo 3 hộp đựng đồ cao cấp Việt Nam phong cách Nhật (38x25xH25cm) Storage Box",166000,166000,0,0
TIKI,nha-cua-doi-song,157169614,"Thớt Nhựa Kháng Khuẩn 5D Cao Cấp - Chính Hãng ( Giao màu ngẫu nhiên)",29000,58000,29000,50
TIKI,nha-cua-doi-song,195469953,"Súng Bắn Keo (Cỡ Lớn/Nhỏ) Kèm 10 Keo Nến Silicon",109000,109000,0,0
TIKI,nha-cua-doi-song,272452316,"Bộ Lau Nhà MyJae Đài Loan Sợi Fiber Xoay 360 Độ Thông Minh 125cm",429000,1200000,771000,64
TIKI,nha-cua-doi-song,182432982,"KỆ ĐỂ GIÀY DÉP SAGOKER, mã KED201",141000,159999,18999,12
TIKI,nha-cua-doi-song,133885539,"Tô Giấy Dùng 1 lần KETILO Cao Cấp 250ml, Trắng Trơn, Cứng Cáp, An Toàn và Thân Thiện Môi Trường - HÀNG CHÍNH HÃNG TG100",69900,89000,19100,21
TIKI,nha-cua-doi-song,181909422,"Chảo Sâu Lòng Suit LocknLock CSU1225PIK – 22cm - Màu Pink",331730,677000,345270,51
TIKI,nha-cua-doi-song,5146283,"Ấm đun nước Inox 304 Elmich 3L EL3373 dùng bếp từ",643000,890000,247000,28
TIKI,nha-cua-doi-song,58469713,"Dây đèn nháy led đom đóm trang trí dùng pin nhiều màu, bóng đèn nháy fairy light cao cấp décor phòng, nhà cửa, tết (Tùy chọn chiều dài dây)",89000,115000,26000,23
TIKI,nha-cua-doi-song,195949375,"Đèn bàn học làm việc đọc sách chống cận, pin sạc tích điện led có thể gấp gọn – 03 chế độ ánh sáng bảo vệ mắt - Chính hãng VinBuy",179000,300000,121000,40
TIKI,nha-cua-doi-song,28937063,"Đồng hồ để bàn báo thức điện tử",81000,120000,39000,33
TIKI,nha-cua-doi-song,66546628,"Giá Treo Rổ Rá, Thau Chậu và Dụng Cụ Bếp Dán Tường Không Khoan Đục Kèm 4 Móc Treo Đồ Tiện Lợi MTC1",58000,99000,41000,41
TIKI,nha-cua-doi-song,13287995,"Cây gãi lưng chỉnh độ dài có đầu gãi bằng PVC ",18000,18000,0,0
TIKI,nha-cua-doi-song,125771437,"Khay nướng Bít-tết Phụ kiện nồi chiên không dầu 2GOOD ",380000,380000,0,0
TIKI,nha-cua-doi-song,20528052,"Bộ 2 Pin Sạc AA 1.2V - 1.450mAh Tích Hợp Cổng Sạc USB Tiện Dụng (Màu ngẫu nhiên)",140000,140000,0,0
TIKI,nha-cua-doi-song,180997554,"Bộ 12 ly  thủy tinh cao cấp",64991,64991,0,0
TIKI,nha-cua-doi-song,12622141,"Cân điện tử mini nhà bếp 5kg",36000,36000,0,0
TIKI,nha-cua-doi-song,57971649,"Bộ 2 chảo Lock&Lock Easy Frypan 2P Set, Chảo 1 tay cầm 24cm + Chảo lòng sâu 26cm (LEY1243 x 1, LEY1265 x 1) LEY1243S2",308000,593000,285000,48
TIKI,nha-cua-doi-song,37495650,"Kệ Sách Để Sàn Cao Cấp 11 Tầng Bằng Gỗ MDF Phủ Melamin Chống Nước, Chống Xước - Hàng Chính Hãng",400000,439000,39000,9
TIKI,nha-cua-doi-song,183335921,"Bộ ống hút inox thẳng kèm cọ rửa đảm bảo sức khỏe cho người tiêu dùng",20000,20000,0,0
TIKI,nha-cua-doi-song,19590366,"Kệ Đa Năng Inochi B4 (45,5 x 26,0 x 44,7 cm)",76000,80000,4000,5
TIKI,nha-cua-doi-song,96608971,"Móc treo quần áo gấp gọn tiện dụng/Móc du lịch đa năng",7680,9600,1920,20
TIKI,nha-cua-doi-song,75478111,"Bộ tượng 04 chú tiểu trang trí xe hơi, bàn làm việc, mang lại bình an, hạnh phúc",41400,45000,3600,8
TIKI,nha-cua-doi-song,15444566,"Kệ đựng xà bông dán tường phòng tắm Hobby Home Decor SBL2 có miếng dán gạch men",70000,89000,19000,21
TIKI,nha-cua-doi-song,56383693,"Combo 300 túi lọc rác bồn rửa bát",37999,37999,0,0
TIKI,nha-cua-doi-song,75730188,"Băng keo dán chống thấm nước bồn rửa chén, bếp, nhà vệ sinh [Tặng dây cột tóc hoa mặt trời ngẫu nhiên",40997,40997,0,0
TIKI,nha-cua-doi-song,77577550,"Bộ Chăn Gối Văn Phòng 3 Trong 1 Kiểu Gấu Nâu Độc Đáo Dùng Để Ngủ Trưa Tại Văn Phòng, Tựa Lưng Và Gấu Bông Dùng Để Trang Trí",249000,279000,30000,11
TIKI,nha-cua-doi-song,94847014,"Nến thơm trang trí phong cách hoa khô thảo mộc",180000,180000,0,0
TIKI,nha-cua-doi-song,134676914,"Lọ Hũ Thủy Tinh Nắp Cài Kín Hơi Đáy Vuông Nhiều Dung Tích",55000,55000,0,0
TIKI,nha-cua-doi-song,115972789,"HỘP ĐỰNG TÚI ĐỰNG QUẦN ÁO KHUNG THÉP 66L- LIVING BOX 66L- Dài 50x Rộng 40x Cao 33.5 cm",85000,85000,0,0
TIKI,nha-cua-doi-song,116185291,"Nhiệt ẩm kế cơ học TANAKA TH101E Chính hãng nhật,nhiệt ẩm kế cơ theo công nghệ nhật bản,đồng hồ đo ẩm kế chính xác,nhiệt ẩm kế phòng,nhiệt ẩm kế sử dụng cho trẻ sơ sinh,nhiệt ẩm kế treo tường ",118500,140000,21500,15
TIKI,dien-thoai-may-tinh-bang,271046571,"Điện thoại Xiaomi Redmi Note 12 (8GB/128GB) - Hàng chính hãng",3790000,4530000,740000,16
TIKI,dien-thoai-may-tinh-bang,273947792,"Điện thoại AI Samsung Galaxy S24 Ultra 12GB/256GB, Camera 200MP Zoom 100x, S Pen- Đen- Hàng Chính Hãng",31990000,34490000,2500000,7
TIKI,dien-thoai-may-tinh-bang,214756058,"Máy đọc sách New Kindle 11th 2022 (16GB) - Hàng chính hãng",2920000,2920000,0,0
TIKI,dien-thoai-may-tinh-bang,125182567,"Máy đọc sách All New Kindle Paperwhite 5 (11th Gen) - Hàng nhập khẩu",3690000,3690000,0,0
TIKI,dien-thoai-may-tinh-bang,43924153,"Máy đọc sách Kindle Oasis 3 (2019) - Amazon - Hàng nhập khẩu",5790000,5790000,0,0
TIKI,nha-cua-doi-song,112946538,"Tấm trải tiện ích Everon Lite (Giao màu ngẫu nhiên)",296000,395000,99000,25
TIKI,dien-thoai-may-tinh-bang,57809866,"Điện thoại Xiaomi Redmi 9A (2GB/32GB)",1690000,2490000,800000,32
TIKI,dien-thoai-may-tinh-bang,184036446,"Apple iPhone 11",11490000,15999000,4509000,28
TIKI,dien-thoai-may-tinh-bang,184059211,"Apple iPhone 13",13990000,24990000,11000000,44
TIKI,dien-thoai-may-tinh-bang,183330021,"Apple iPad 10.2-inch (9th Gen) Wi-Fi 2021",6990000,10990000,4000000,36
TIKI,dien-thoai-may-tinh-bang,125182567,"Máy đọc sách All New Kindle Paperwhite 5 (11th Gen) - Hàng nhập khẩu",3950000,3950000,0,0
TIKI,dien-thoai-may-tinh-bang,217640502,"Máy đọc sách Kindle Scribe - Hàng chính hãng",12590000,12590000,0,0
TIKI,nha-cua-doi-song,32021492,"Ổ Khóa Số Du Lịch Stanley S742-054",161000,167000,6000,4
TIKI,dien-thoai-may-tinh-bang,173387789,"Máy đọc sách All New Kindle Oasis 3 - Hàng nhập khẩu",7200000,7200000,0,0
TIKI,dien-thoai-may-tinh-bang,273947785,"Điện thoại AI Samsung Galaxy S24+ 12GB/256GB, Camera 50MP, Màn hình 6.7"- Đen- Hàng Chính Hãng",25490000,27490000,2000000,7
TIKI,dien-thoai-may-tinh-bang,217645692,"Combo Máy đọc sách All New Kindle Paperwhite 5 (11th Gen) - 16Gb và Bao da - Hàng nhập khẩu",3980000,3980000,0,0
TIKI,dien-thoai-may-tinh-bang,270510406,"Điện thoại Vivo Y36 (8GB/128GB) - Hàng Chính Hãng - Camera 50MP - Sạc Nhanh 44W",5190000,5190000,0,0
TIKI,dien-thoai-may-tinh-bang,120295859,"Điện Thoại Nokia C30 (2GB/32GB) - Hàng Chính Hãng",1490000,1990000,500000,25
TIKI,dien-thoai-may-tinh-bang,123345348,"Apple iPhone 12",11490000,16990000,5500000,32
TIKI,dien-thoai-may-tinh-bang,184248127,"Apple iPad mini (6th Gen) Wi-Fi 2021",11490000,14990000,3500000,23
TIKI,dien-thoai-may-tinh-bang,163914808,"Điện thoại bàn Panasonic  KX-TS500MX-hàng chính hãng",300000,300000,0,0
TIKI,dien-thoai-may-tinh-bang,252586291,"Máy đọc sách All New Kindle Paperwhite 5 (11th Gen) - Hàng chính hãng",3790600,3990000,199400,5
TIKI,dien-thoai-may-tinh-bang,252586291,"Máy đọc sách All New Kindle Paperwhite 5 (11th Gen) - Hàng chính hãng",3790600,3990000,199400,5
TIKI,dien-thoai-may-tinh-bang,272909668,"[Mới] Điện thoại vivo V29e 5G (8GB/256GB) - Hàng Chính Hãng - Camera Selfie 50 MP - Vòng Sáng Aura 2.0 - Màn hình AMOLED 6.67",8990000,8990000,0,0
TIKI,dien-thoai-may-tinh-bang,181977398,"Điện thoại bàn Panasonic KX-TS880 hàng chính hãng",1050000,1050000,0,0
TIKI,dien-thoai-may-tinh-bang,273559020,"Máy tính bảng Kindle Fire HD10 2023 13th - 32Gb - Hàng chính hãng",3390000,3390000,0,0
TIKI,dien-thoai-may-tinh-bang,201067649,"Combo máy đọc sách Kindle Paperwhite 5 (11th gen) tặng kèm bao da ( Cover ) - Hàng nhập khẩu",3760000,3990000,230000,6
TIKI,dien-thoai-may-tinh-bang,121744434,"Điện Thoại Xiaomi Redmi 10 4GB/128GB - Hàng Chính Hãng",2949000,4290000,1341000,31
TIKI,dien-thoai-may-tinh-bang,201067649,"Combo máy đọc sách Kindle Paperwhite 5 (11th gen) tặng kèm bao da ( Cover ) - Hàng nhập khẩu",3849000,4100000,251000,6
TIKI,dien-thoai-may-tinh-bang,189466001,"Điện thoại Xiaomi Redmi 10A (2GB/32GB) - Hàng chính hãng",1949000,2890000,941000,33
TIKI,dien-thoai-may-tinh-bang,31261844,"Điện Thoại Bàn Cố Định Không Dây Lắp Sim",650000,650000,0,0
TIKI,dien-thoai-may-tinh-bang,272113804,"[MỚI] Điện thoại vivo Y17s - Hàng chính hãng - Camera 50MP - Pin 5000 mAh - Sạc nhanh- RAM mở rộng đến 8GB",3990000,3990000,0,0
TIKI,dien-thoai-may-tinh-bang,73842403,"Điện thoại bàn có dây nhỏ gọn màu trắng",250000,250000,0,0
TIKI,dien-thoai-may-tinh-bang,125590981,"Điện thoại Nokia C30 2GB/32GB - Hàng chính hãng",1550000,1550000,0,0
TIKI,dien-thoai-may-tinh-bang,270794184,"Máy đọc sách Kobo Clara - Hàng Chính Hãng",2899000,2925000,26000,1
TIKI,dien-thoai-may-tinh-bang,204237269,"Điện Thoại Bàn Panasonic KX-TSC11 - Hàng Chính Hãng - Trắng",600000,600000,0,0
TIKI,dien-thoai-may-tinh-bang,197654695,"Điện thoại Masstel izi 26 4G - Gọi HD Call - Hàng chính hãng",489000,650000,161000,25
TIKI,dien-thoai-may-tinh-bang,150724369,"Máy tính bảng Fire HD10 2021 - 11th - (All New Fire HD10 - 2021) - Ram 3/4GB, bộ nhớ 32GB, màn hình 1080 FullHD",3115000,3500000,385000,11
TIKI,dien-thoai-may-tinh-bang,197960169,"Điện thoại Masstel Lux 10 4G - Sang trọng - Gọi HD Call - Hàng chính hãng",538000,700000,162000,23
TIKI,dien-thoai-may-tinh-bang,139632023,"Máy đọc sách Kobo Libra 2 - hàng nhập khẩu",5199000,5800000,601000,10
TIKI,dien-thoai-may-tinh-bang,172329599,"Điện thoại Xiaomi Redmi 9A (2GB/32GB) - Hàng chính hãng",1754000,2199000,445000,20
TIKI,dien-thoai-may-tinh-bang,195317118," Máy tính bảng Oppo Pad Air (4GB/64GB) - Hàng Chính Hãng",4990000,6999000,2009000,29
TIKI,dien-thoai-may-tinh-bang,173387789,"Máy đọc sách All New Kindle Oasis 3 - Hàng nhập khẩu",5790000,5790000,0,0
TIKI,dien-thoai-may-tinh-bang,29931445,"Ulefone Armor X 5 ( chống nước,chống va đập,pin 5.000mAh ) hàng chính hãng",3990000,3990000,0,0
TIKI,dien-thoai-may-tinh-bang,197652030,"Điện thoại Masstel Lux 20 4G - Sang trọng - Gọi HD Call - Hàng chính hãng",567000,800000,233000,29
TIKI,dien-thoai-may-tinh-bang,42333095,"Điện thoại cố định không dây cho người già, màn hình hiển thị đầu số - Hàng chính hãng",490000,490000,0,0
TIKI,dien-thoai-may-tinh-bang,11415485,"ĐIỆN THOẠI CỐ ĐỊNH PANASONIC KX-TS580MX",940000,940000,0,0
TIKI,dien-thoai-may-tinh-bang,181266509,"Điện thoại Ulefone Armor 14 pro (chống nước,chống va đập,pin khủng,pin 10.000mAh,Ram 8Gb,Rom 128Gb)- hàng chính hãng",5990000,5990000,0,0
TIKI,dien-thoai-may-tinh-bang,170165701,"Điện thoại bàn Ktel 645 hàng chính hãng",398000,398000,0,0
TIKI,dien-thoai-may-tinh-bang,168526284,"Điện thoại Nokia 105 4G - Hàng chính hãng",675000,769000,94000,12
TIKI,dien-thoai-may-tinh-bang,43924153,"Máy đọc sách Kindle Oasis 3 (2019) - Amazon - Hàng nhập khẩu",5790000,5790000,0,0
TIKI,dien-thoai-may-tinh-bang,140940220,"Máy đọc sách Kobo Sage - hàng nhập khẩu",8679000,8679000,0,0
TIKI,dien-thoai-may-tinh-bang,173557858,"Máy tính bảng Kindle File HD 8 (10th generation - 2020) Hàng nhập khẩu",2250000,2250000,0,0
TIKI,dien-thoai-may-tinh-bang,184578632,"Điện thoại Itel it9010 4G - Hàng chính hãng",399000,399000,0,0
TIKI,dien-thoai-may-tinh-bang,181452535,"Điện thoại Itel it9200 4G - WIFI - Xem YTB , FB - Hàng chính hãng",547000,790000,243000,31
TIKI,dien-thoai-may-tinh-bang,167466044,"Điện thoại Masstel FAMI 60 4G Pin 2000 mah - Hàng chính hãng",636000,750000,114000,15
TIKI,dien-thoai-may-tinh-bang,126050455,"Điện thoại Nokia C20 (2GB/16GB) - Hàng Chính Hãng",1290000,2290000,1000000,44
TIKI,nha-cua-doi-song,48967324,"Khóa Vali Khóa Balo Mã Số Chữ Thập",29000,29000,0,0
TIKI,nha-cua-doi-song,67299755,"Giấy nến đục lỗ lót nồi chiên không dầu loại 4 lít, 4.5 lít, 5 lít, 6.5 lít - Size 21cm - 100 tờ - siêu tiện dung",29000,29000,0,0
TIKI,nha-cua-doi-song,164479566,"Ghế chỉnh dáng ngồi đúng - Roichen Hàn Quốc (Made in Korea). Dùng cho Nam, Nữ, Trẻ em. Hàng chính hãng",710000,750000,40000,5
TIKI,nha-cua-doi-song,71925401,"Đèn Bàn Học Đọc Sách, Đèn Bàn Làm Việc Sang Trọng, Đèn Ngủ Cao Cấp (Học Sinh, Sinh Viên, Văn Phòng) LED Chống Cận 03 Mức Độ Sáng, Cảm Ứng Tích Điện Pin 2500mAh - Hàng Chính Hãng - VinBuy",123000,260000,137000,53
TIKI,nha-cua-doi-song,75659112,"Kệ Sách Tổ Ong IGEA Đa Tầng Convent 234F - GP100",181000,198000,17000,9
TIKI,nha-cua-doi-song,52238368,"Chiếu điều hòa cao cấp Ánh Sao - Sợi mây tổng hợp + Tặng kèm túi thơm thảo dược - giao mẫu ngẫu nhiên",130000,140000,10000,7
TIKI,nha-cua-doi-song,54460849,"Bộ chăn ga gối cotton LIDACO PL1 - Caro Nâu (SP000661)",195000,276000,81000,29
TIKI,nha-cua-doi-song,169919224,"Kệ Để Kem Đánh Răng & Bàn Chải, Tặng Kèm Cốc - Kệ Nhà Tắm Dán Tường Thông Minh - Giá Treo Bàn Chải Đánh Răng Kiêm Để Đồ & Úp Cốc - Giao Màu Ngẫu Nhiên [HÀNG CHÍNH HÃNG",99000,120000,21000,18
TIKI,nha-cua-doi-song,686906,"Hộp Thủy Tinh Cao Tròn Glasslock MCCD072 (720ml)",144000,194000,50000,26
TIKI,nha-cua-doi-song,263990262,"Lọ xay tiêu Inox 304 DandiHome cao cấp",56000,65000,9000,14
TIKI,nha-cua-doi-song,51373821,"Đèn bàn học led cảm ứng chính hãng Rạng Đông Model: RD RL 36 LED",203000,203000,0,0
TIKI,nha-cua-doi-song,58546654,"Đèn Pixar, Đèn Học Chống Cận Thị, Đèn Đọc Sách, Đèn Làm Việc Để Bàn Chống Chói Mắt Lóa Mắt Bảo Vệ Mắt + Bóng Đèn + Chân Kẹp + Chân Đế - Hàng Chính Hãng Amalife",165000,165000,0,0
TIKI,nha-cua-doi-song,163304843,"Máy phun rửa áp lực cao Karcher K2 Classic ",2222700,2390000,167300,7
TIKI,nha-cua-doi-song,53497035,"40 VIÊN PIN MAXELL AAA TEM BẠC - HÀNG CHÍNH HÃNG",51400,51400,0,0
TIKI,nha-cua-doi-song,57335326,"Ghế xếp thư giãn SUMIKA 179A - Khóa kim loại, khung thép tròn, tải trọng 200kg",765000,1000000,235000,24
TIKI,nha-cua-doi-song,19867726,"Võng lưới mềm dày 99, gỗ 50 (Giao màu ngẫu nhiên)",208000,350000,142000,41
TIKI,nha-cua-doi-song,52789105,"Đế Bình Giữ Nhiệt Silicone Boot 2GOOD Flask 900ml",50000,50000,0,0
TIKI,nha-cua-doi-song,241806648,"Móc Dán Tường Treo Chậu Rổ, Treo Đồ Đa Năng Inox 304 Jodily Sử Dụng Miếng Dán Thế Hệ Mới",20000,20000,0,0
TIKI,nha-cua-doi-song,171797241,"{XẢ KHO} Cây Lau Nhà Thông Minh, Tự Động Tách Nước Bẩn, Tự Động Vắt Khô, Xoay 360 độ Hatachi  HTC - V6 - HÀNG CHÍNH HÃNG",512050,539000,26950,5
TIKI,nha-cua-doi-song,188375839,"Khăn tắm Khăn lau mặt Cotton 100% Mềm Êm Dày dặn Màu trơn Nhấn viền họa tiết 74x33cm",49000,49000,0,0
TIKI,nha-cua-doi-song,189339895,"Đèn LED Mini Móc Khóa - Đèn Pin COB - Đèn Pin Dã Ngoại - Sạc Type C Tiện Dụng",30400,32000,1600,5
TIKI,nha-cua-doi-song,55124901,"Thùng Rác Mini Phòng Ngủ, Toilet, Xe Hơi Khả Năng Giữ Mùi 90",100000,100000,0,0
TIKI,nha-cua-doi-song,67650750,"Đệm ngồi lót ghế làm từ hợp chất TPE, thoáng khí, hỗ trợ tuần hoàn máu, chống ê mông, mỏi lưng - Thương hiệu Nhà của Mẹ- giao màu ngẫu nhiên",153000,160000,7000,4
TIKI,nha-cua-doi-song,47163069,"Túi Đựng Chăn Mền Quần Áo Kháng Mốc Cỡ Lớn Nhiều Màu",58000,58000,0,0
TIKI,nha-cua-doi-song,111410597,"Kính bảo hộ Honeywell A700 Mắt kính chống bụi, chống tia UV, chống trầy xước, đọng sương",77900,82000,4100,5
TIKI,nha-cua-doi-song,68413077,"Đèn đọc sách mini, pin sạc tiện dụng Baseus Comfort Reading Mini Clip Lamp ( Dịu mắt, chân kẹp, 3 mức sáng, 350mAh, 24h sử dụng)hàng nhập khẩu",215000,249000,34000,14
TIKI,nha-cua-doi-song,78633940,"Máy Sấy Và Khử Trùng Giày Xiaomi Youpin SOTHING DSHJ-S-1904 có hẹn giờ",259000,269000,10000,4
TIKI,nha-cua-doi-song,135442410,"Máy Đo Khoảng Cách Laser Deli Chính Hãng Loại 40m / 50m / 60m Đa Năng - Dễ Dàng Sử Dụng Từ Xa - DL331050P / EDL4168",488000,896000,408000,46
TIKI,nha-cua-doi-song,20103667,"Combo Cọ Rửa Dành Cho Ống Hút Inox và Ống Hút Thủy Tinh",28000,28000,0,0
TIKI,nha-cua-doi-song,117645437,"Ổ cắm điện LiOA đa năng kết hợp - 2D2S, 3D3S, 4D6S dây dài 3m/5m - Ổ cắm điện Lioa Chính Hãng",85000,85000,0,0
TIKI,nha-cua-doi-song,44803282,"Bàn Làm Việc Có Kệ Sách Mẫu Mới",262500,350000,87500,25
TIKI,nha-cua-doi-song,178101136,"Bơm điện 2 chiều bơm và hút chân không cao cấp miDoctor",97000,180000,83000,46
TIKI,nha-cua-doi-song,152789537,"Combo 5 Đôi Đũa Thủy Tinh Đầu Đũa Vạt Xéo Trang Trí Họa Tiết Nhật Bản Phủ Bóng",70000,70000,0,0
TIKI,nha-cua-doi-song,72459016,"Bộ Nhả Kem Đánh Tự Động OENON, Kệ Treo Bàn Chải Nhà Tắmg Dán Tường Kèm Cốc Hút Từ Tính - OEKEM",99000,190000,91000,48
TIKI,nha-cua-doi-song,152784110,"Khay Đá Silicon Có Nắp Đậy 14 Viên, Khay Đựng Đá Tủ Lạnh, Làm Đá Thạch Kem Bảo Quản Chống Mùi Tuyệt Đối- Hàng Loại 1",49000,49000,0,0
TIKI,nha-cua-doi-song,250512089,"Kéo cắt cành cộng lực chuyên dụng Germany -dụng cụ làm vườn đa năng",162000,280000,118000,42
TIKI,nha-cua-doi-song,16196661,"Bộ Tua Vít Đa Năng Tua Vít 25 Đầu Trong 1 Screwdriver",28044,28044,0,0
TIKI,nha-cua-doi-song,143002904,"Ổ  điện đa năng shoptida hình tháp nhiều tầng T8/ T12 chịu tải 3600W, an toàn chống cháy chống giật, dây dài 3m và 4m",549000,579000,30000,5
TIKI,nha-cua-doi-song,141201958,"Ly Giữ Nhiệt Cà Phê Có Tay Cầm Nắp Trượt Chống Tràn Rinfere (415ml)",295000,449000,154000,34
TIKI,nha-cua-doi-song,41318920,"Bộ chặn cửa chống va đập nam châm hít cửa dán sàn Hobby Home Decor CC1 inox 304 kèm keo dán sàn",82000,139000,57000,41
TIKI,nha-sach-tiki,185889844,"Tại Sao Chúng Tôi Muốn Bạn Giàu",89000,135000,46000,34
TIKI,nha-sach-tiki,177736624,"Mặc Kệ Thiên Hạ - Sống Như Người Nhật (Tái Bản)",71000,94000,23000,24
TIKI,nha-sach-tiki,195291930,"Bốn Thỏa Ước",84000,130000,46000,35
TIKI,nha-sach-tiki,178032047,"Fullmetal Alchemist - Cang Giả Kim Thuật Sư - Fullmetal Edition Tập 14 [Tặng Kèm Bookmark Pvc]",61100,69000,7900,11
TIKI,nha-sach-tiki,58971674,"Sách Nghệ Thuật Bán Hàng Của Người Do Thái (Tái Bản 2020)",61100,88000,26900,31
TIKI,nha-sach-tiki,65008052,"Từ Điển Anh - Anh - Việt",208600,298000,89400,30
TIKI,nha-sach-tiki,193605360,"Chuyện Xưa Tôi Nhớ Người Cũ Đã Quên (Lam – Lê)",64500,89000,24500,28
TIKI,nha-sach-tiki,85923342,"Minh Triết Trong Ăn Uống Của Phương Đông (Tái Bản)",122000,168000,46000,27
TIKI,nha-sach-tiki,148802204,"Chuyện Trà - Lịch Sử Một Thức Uống Lâu Đời Của Người Việt (Bìa Mềm)",216000,290000,74000,26
TIKI,nha-sach-tiki,184782104,"Cha Mẹ Độc Hại (Tái Bản)",110000,148000,38000,26
TIKI,nha-sach-tiki,52798281,"Phương Pháp Giáo Dục Sớm Montessori Cho Trẻ Từ
0 – 3 Tuổi",63000,99000,36000,36
TIKI,nha-sach-tiki,167686691,"Sách Tổng Ôn Cấp Tốc Toán Học 12, Sách Ôn Thi THPT Quốc Gia Moon",149000,200000,51000,26
TIKI,nha-sach-tiki,165030714,"Black Jack 07 (Bìa Mềm)",28000,30000,2000,7
TIKI,nha-sach-tiki,74981856,"Gửi Bạn, Người Đã Kiệt Sức Vì Những Chịu Đựng Âm Thầm [Tặng Kèm: 1 Bookmark Daisy]",66700,96000,29300,31
TIKI,nha-sach-tiki,174215331,"Ajin - Boxset Số 2 (Tập 7 - 12) - Tặng Kèm Bookmark 3D",214000,300000,86000,29
TIKI,nha-sach-tiki,121372698,"NGÀI CÓC ĐI GẶP BÁC SĨ TÂM LÝ ( BÌA CỨNG)",152500,219000,66500,30
TIKI,nha-sach-tiki,84950236,"Người Nhạy Cảm Trong Thế Giới Vô Cảm",56100,85000,28900,34
TIKI,nha-sach-tiki,192909296,"Anh Em Phi Hành Gia - Tập 31",32500,45000,12500,28
TIKI,nha-sach-tiki,1734377,"Những Chú Chó Bán Hàng",89000,140000,51000,36
TIKI,nha-sach-tiki,75636226,"Phương pháp VPA - Kỹ thuật nhận diện Dòng Tiền Thông Minh bằng Hành Động Giá kết hợp Khối Lượng Giao Dịch",357000,357000,0,0
TIKI,nha-sach-tiki,121185868,"Vang Bóng Một Thời (Việt Nam Danh Tác)",58000,76000,18000,24
TIKI,nha-sach-tiki,163165281,"Mong Mẹ Hãy Yêu Lấy Chính Mình",72100,99000,26900,27
TIKI,nha-sach-tiki,9490657,"Hệ thống giao dịch Ichimoku Charts - Ichimoku Kinko Clouds (Phiên bản sách năm 2018)",330000,330000,0,0
TIKI,nha-sach-tiki,127077157,"Bà Tổng Thống Trước Họng Súng - Hai Số Phận - Phần III",114000,169000,55000,33
TIKI,nha-sach-tiki,7644510,"Lòng Tốt Của Bạn Cần Thêm Đôi Phần Sắc Sảo",80500,108000,27500,25
TIKI,nha-sach-tiki,186265452,"My Hero Academia - Học Viện Siêu Anh Hùng Tập 29: Bakugo Katsuki: Trỗi Dậy",25000,25000,0,0
TIKI,nha-sach-tiki,104273017,"Combo 2 Tập: Tăng Thông Khí - Bản Thường - (Tặng Kèm 2 Bookmark In 2 Mặt)(Bìa Mềm)",181000,258000,77000,30
TIKI,nha-sach-tiki,28292286,"Combo 30 Chủ Đề Từ Vựng Tiếng Anh (2 Tập)",245000,380000,135000,36
TIKI,nha-sach-tiki,191571328,"Black Jack (Bản Đặc Biệt) - Tập 12",134000,135000,1000,1
TIKI,nha-sach-tiki,114765005,"Vụng Trộm Yêu Anh - Tập 1+2 (Tặng Kèm: 02 Bookmark 2 Mặt Theo Bìa)",178000,249000,71000,29
TIKI,nha-sach-tiki,186202768,"Và Rồi Tháng 9 Không Có Cậu Đã Tới (Tái Bản)",75800,106000,30200,28
TIKI,nha-sach-tiki,184629090,"Lấy Nước Đường Xa",68800,99000,30200,31
TIKI,nha-sach-tiki,187001113,"Giấy bọc sách vở / Giấy gói quà / giấy bao tập / giấy bao vở học sinh, sinh viên size A4, B5, A5 cao cấp – 24 cuốn",49000,88000,39000,44
TIKI,nha-sach-tiki,185435293,"Nhân Sinh Nơi Nơi Đều Là Tu Hành ( Tặng 1 Bookmark 02 mặt + 1 Sổ phụ chương khổ 12x16cm)",144000,145000,1000,1
TIKI,nha-sach-tiki,467896,"Trà Hoa Nữ (Tái Bản)",33000,50000,17000,34
TIKI,nha-sach-tiki,146223395,"Cách thức kinh doanh và đầu cơ cổ phiếu! – How to Trade in Stocks",349000,349000,0,0
TIKI,nha-sach-tiki,184779709,"Xã Hội Học - Khái Lược Những Tư Tưởng Lớn",284000,390000,106000,27
TIKI,nha-sach-tiki,69624539,"Khoa Học Về Yoga",223000,300000,77000,26
TIKI,nha-sach-tiki,13061338,"Series Địch Công Kỳ Án Tập 15 - Hoa Văn Cây Liễu",49500,99000,49500,50
TIKI,nha-sach-tiki,110447680,"Kế Hoạch Marketing Trên Một Trang Giấy (Những Chỉ Dẫn Dễ Hiểu Nhất Cho Một Kế Hoạch Marketing Thông Minh)",104200,159000,54800,34
TIKI,dien-thoai-may-tinh-bang,31820638,"Điện Thoại Bàn Panasonic KX-TS500MX - Panasonic KX-TS500MX Integrated Telephone System - Hàng chính hãng",299000,299000,0,0
TIKI,dien-thoai-may-tinh-bang,196760330,"Điện Thoại Vivo T1x 4GB/64GB - Hàng Chính Hãng",3379000,4490000,1111000,25
TIKI,dien-thoai-may-tinh-bang,37289936,"Điện thoại Oukitel WP2 chống nước,chống va đập, pin 10.000 mAh - Hàng chính hãng",5490000,5490000,0,0
TIKI,dien-thoai-may-tinh-bang,4048043,"Điện Thoại Bàn Panasonic KX-TS500",339000,369000,30000,8
TIKI,dien-thoai-may-tinh-bang,221518066,"Máy đọc sách Kindle Oasis 3 10th - Hàng nhập khẩu",6042210,6789000,746790,11
TIKI,dien-thoai-may-tinh-bang,194462682,"Điện thoại ZTE Blade A52 4GB l 64GB, Pin 5000mAh, Màn hình 6.52", Camera AI Triple - Hàng chính hãng",3490000,3490000,0,0
TIKI,dien-thoai-may-tinh-bang,273227290,"Combo Máy đọc sách Kindle Scribe kèm bút – thế hệ đầu tiên có thể đọc và viết, màn hình 10,2” 300PPI, đèn vàng warmlight, bộ nhớ 16-64GB, đồng bộ dữ liệu qua Microsoft Word - hàng nhập khẩu",11276100,11390000,113900,1
TIKI,dien-thoai-may-tinh-bang,171852890,"Điện thoại Masstel FAMI 60 4G ,Pin 2000 mah ,cỡ chữ to rõ ràng,âm thanh lớn,màn hình to- Hàng chính hãng",689000,689000,0,0
TIKI,dien-thoai-may-tinh-bang,80132874,"ĐIỆN THOẠI TÂN CỔ ĐIỂN DT16 bàn phím quay chuông thanh, dùng được nghe gọi âm thanh rõ ràng. Điện thoại để bàn tân cổ điển- Điện thoại bàn chất liệu gỗ để trang trí",2320000,2900000,580000,20
TIKI,dien-thoai-may-tinh-bang,196176544,"Điện Thoại Cho Người Già Masstel Fami 12 4G-hỗ trợ 4g-chữ to dành cho người già(Hàng Chính Hãng)",630000,630000,0,0
TIKI,dien-thoai-may-tinh-bang,198203859,"Điện Thoại Vivo V25 5G 2022 (8GB/128GB) - Hàng Chính Hãng",7490000,10490000,3000000,29
TIKI,dien-thoai-may-tinh-bang,198111545,"Điện Thoại Vivo V25e 2022 (8GB/128GB) - Hàng Chính Hãng",8490000,8490000,0,0
TIKI,dien-thoai-may-tinh-bang,181216830,"Điện thoại ZTE Blade V40 Vita (ZTE 8045) - MH giọt nước HD+ 6.75" - Pin 6000 mAh sạc nhanh 22.5W -  Bộ nhớ mở rộng (4+2)GB - Hàng chính hãng",4290000,4290000,0,0
TIKI,dien-thoai-may-tinh-bang,29440849,"điện thoại  IP622C - hàng chính hãng",1650000,1650000,0,0
TIKI,dien-thoai-may-tinh-bang,21317020,"Điện thoại bàn không dây Panasonic KX-TGF310 - Hàng Chính Hãng",2450000,2450000,0,0
TIKI,dien-thoai-may-tinh-bang,188030974,"Máy tính bảng Oukitel RT1 - hàng chính hãng  (chống nước,chống va đập , pin khủng,pin 10.000mAh,màn hình 10,1 inch,Ram 4Gb,Rom 64Gb,tám nhân,học online)",6990000,6990000,0,0
TIKI,dien-thoai-may-tinh-bang,4059671,"Điện Thoại Bàn Panasonic KXTS 520 - Hàng Chính Hãng",469000,489000,20000,4
TIKI,dien-thoai-may-tinh-bang,174085242,"Điện Thoại Cho Người Già Masstel Fami 12 4G - Viền Kim Loại, Ăng Ten FM Không Dây - Hàng Chính Hãng",612000,699000,87000,12
TIKI,dien-thoai-may-tinh-bang,14508445,"Điện thoại Ip phone Cisco CP-7841-K9 chính hãng",4200000,4200000,0,0
TIKI,dien-thoai-may-tinh-bang,157835051,"Điện Thoại Để Bàn Panasonic KX-TS500MX - Hàng Chính Hãng",380000,380000,0,0
TIKI,dien-thoai-may-tinh-bang,257866809,"Điện thoại để bàn tân cổ điển phím quay DT15",3900000,3900000,0,0
TIKI,dien-thoai-may-tinh-bang,140747649,"Điện thoại Realme C11 2021 (4GB/64GB) - Hàng chính hãng",3790000,3790000,0,0
TIKI,dien-thoai-may-tinh-bang,215125094,"Điện Thoại Di Động Forme D999 4G - Hàng Chính Hãng",760000,760000,0,0
TIKI,dien-thoai-may-tinh-bang,11110653,"Điện thoại bàn không dây Panasonic KX-TGF320 - Hàng Chính Hãng",2500000,2500000,0,0
TIKI,dien-thoai-may-tinh-bang,91281318,"Máy Đọc Sách Likebook P10 - Hàng chính hãng",9090000,9090000,0,0
TIKI,dien-thoai-may-tinh-bang,170727305,"Điện thoại bàn Panasonic KX-TS580 hàng chính hãng",999000,999000,0,0
TIKI,dien-thoai-may-tinh-bang,52326343,"Cisco Unified IP Phone CP-7821-K9 - Hàng chính hãng",2580000,2580000,0,0
TIKI,dien-thoai-may-tinh-bang,113475741,"Điện thoại Panasonic KX-TS520MX - Trắng - Hàng chính hãng",450000,450000,0,0
TIKI,dien-thoai-may-tinh-bang,54882670,"Điện thoại để bàn tân cổ điển chuông thanh bàn phím quay mã DT10 dùng sim di động hoặc dùng cáp nghe gọi âm thanh rõ ràng và để trang trí (điện thoại bàn tân cổ điển)",2320000,2900000,580000,20
TIKI,dien-thoai-may-tinh-bang,121154009,"Điện thoại bàn cố định không dây lắp các loại Sim Di động, Cố định (Viettel, Vinaphone, Mobifone...)",650000,650000,0,0
TIKI,dien-thoai-may-tinh-bang,117347869,"ĐIỆN THOẠI HỘI NGHỊ YEALINK CP960 -HÀNG CHÍNH HÃNG",15230000,15230000,0,0
TIKI,dien-thoai-may-tinh-bang,156222386,"Điện thoại Panasonic KX-TS520MX -Hàng chính hãng",449000,459000,10000,2
TIKI,dien-thoai-may-tinh-bang,54989813,"Điện thoại tân cổ điển để bàn mã DT4 màu trắng kết hợp vàng, chuông thanh bàn phím quay, dùng sim di động nghe gọi âm thanh tốt và để trang trí (Điện thoại bàn tân cổ điển)",2900000,2900000,0,0
TIKI,dien-thoai-may-tinh-bang,55197731,"Điện thoại bàn màu đỏ KXT438",215000,215000,0,0
TIKI,dien-thoai-may-tinh-bang,11376644,"Điện thoại bàn có dây Panasonic KX-TS560MX",730000,730000,0,0
TIKI,dien-thoai-may-tinh-bang,197905982,"Điện thoại di động Vtel E10 4G – Hàng Chính Hãng",379050,399000,19950,5
TIKI,dien-thoai-may-tinh-bang,94453667,"Điện thoại VoIP Yealink SIP-T30",1050000,1050000,0,0
TIKI,dien-thoai-may-tinh-bang,54683561,"ĐIỆN THOẠI TÂN CỔ ĐIỂN DT14 bàn phím quay chuông quả, dùng cáp điện thoại cố định nghe gọi âm thanh rõ ràng (điện thoại bàn tân cổ điển)",3520000,4400000,880000,20
TIKI,dien-thoai-may-tinh-bang,16518032,"Điện thoại để bàn Panasonic KX-TS560 hàng chính hãng",730000,730000,0,0
TIKI,dien-thoai-may-tinh-bang,125171841,"Điện Thoại Bàn Panasonic KX-TSC11 - Hàng Chính Hãng",620000,620000,0,0
TIKI,dien-thoai-may-tinh-bang,271046571,"Điện thoại Xiaomi Redmi Note 12 (8GB/128GB) - Hàng chính hãng",3790000,4790000,1000000,21
TIKI,dien-thoai-may-tinh-bang,273947792,"Điện thoại AI Samsung Galaxy S24 Ultra 12GB/256GB, Camera 200MP Zoom 100x, S Pen- Xám- Hàng Chính Hãng",31990000,34490000,2500000,7
TIKI,dien-thoai-may-tinh-bang,273947785,"Điện thoại AI Samsung Galaxy S24+ 12GB/256GB, Camera 50MP, Màn hình 6.7"- Đen- Hàng Chính Hãng",25490000,27490000,2000000,7
TIKI,dien-thoai-may-tinh-bang,170448099,"Điện Thoại Người Già Masstel Fami 60 4G - Loa To, FM Không Dây, Đọc Số Bằng Giọng Nói, SOS, Đèn Pin Kép,... Hàng Chính Hãng",679000,882000,203000,23
TIKI,dien-thoai-may-tinh-bang,125182567,"Máy đọc sách All New Kindle Paperwhite 5 (11th Gen) - Hàng nhập khẩu",3690000,3690000,0,0
TIKI,dien-thoai-may-tinh-bang,217706932,"Combo Máy đọc sách All New Kindle Paperwhite 5 (11th Gen) và Bao da - Hàng nhập khẩu",3980000,3980000,0,0
TIKI,dien-thoai-may-tinh-bang,173387789,"Máy đọc sách All New Kindle Oasis 3 - Hàng nhập khẩu",5880000,5880000,0,0
TIKI,dien-thoai-may-tinh-bang,214756058,"Máy đọc sách New Kindle 11th 2022 (16GB) - Hàng chính hãng",2920000,2920000,0,0
TIKI,dien-thoai-may-tinh-bang,197666071,"Điện thoại Masstel Fami 65 4G - Tặng dock sạc - Gọi HD Call - Hàng chính hãng",656000,900000,244000,27
TIKI,dien-thoai-may-tinh-bang,117929342,"Điện thoại Panasonic KX-TSC11MX -Hàng chính hãng",599000,599000,0,0
TIKI,dien-thoai-may-tinh-bang,272113804,"[MỚI] Điện thoại vivo Y17s - Hàng chính hãng - Camera 50MP - Pin 5000 mAh - Sạc nhanh- RAM mở rộng đến 8GB",3990000,3990000,0,0
TIKI,dien-thoai-may-tinh-bang,167465704,"Điện thoại Masstel IZI 20 4G , Pin 1700 mAh - Hàng chính hãng",399000,499000,100000,20
TIKI,dien-thoai-may-tinh-bang,194498804,"Máy Tính Bảng OPPO Pad Air (4GB/64GB) | Màn Hình 2K 1 tỷ Màu | Chip Snapdragon 680 | Hàng Chính Hãng",4990000,6990000,2000000,29
TIKI,dien-thoai-may-tinh-bang,74776150,"Máy đọc sách Kobo Libra H20 8GB Trắng/Đen có đèn nền vàng, chống nước - Hàng nhập khẩu",4499000,4499000,0,0
TIKI,dien-thoai-may-tinh-bang,242434782,"Máy đọc sách New Kindle 11th 2022 (16GB) - Hàng nhập khẩu",2920000,2920000,0,0
TIKI,dien-thoai-may-tinh-bang,209872337,"Máy đọc sách Kindle 2022 (11th) - All new kindle 2022 11th màn hình 6inch 300PPI gấp 2 lần độ sắc nét, 16GB bộ nhớ trong với cổng kết nối USB-C - Hàng nhập khẩu",2920000,2920000,0,0
TIKI,dien-thoai-may-tinh-bang,11251711,"Điện thoại bàn không dây Panasonic KX-TGD312 - Hàng Chính Hãng",2090000,2090000,0,0
TIKI,dien-thoai-may-tinh-bang,43924153,"Máy đọc sách Kindle Oasis 3 (2019) - Amazon - Hàng nhập khẩu",5790000,5790000,0,0
TIKI,dien-thoai-may-tinh-bang,217645692,"Combo Máy đọc sách All New Kindle Paperwhite 5 (11th Gen) - 16Gb và Bao da - Hàng nhập khẩu",3980000,3980000,0,0
TIKI,dien-thoai-may-tinh-bang,197907038,"Điện thoại di động Vtel E10 4G – Hàng Chính Hãng",375000,399000,24000,6
TIKI,dien-thoai-may-tinh-bang,217640502,"Máy đọc sách Kindle Scribe - Hàng chính hãng",12590000,12590000,0,0
TIKI,dien-thoai-may-tinh-bang,125753416,"Điện thoại Nokia 110 4G - Hàng chính hãng",740000,740000,0,0
TIKI,dien-thoai-may-tinh-bang,4048581,"Điện Thoại Bàn Panasonic KX-TSC11",689000,689000,0,0
TIKI,dien-thoai-may-tinh-bang,23142193,"Điện thoại bàn không dây Panasonic KX-TGC313 - Hàng Chính Hãng",2100000,2100000,0,0
TIKI,dien-thoai-may-tinh-bang,125753291,"Điện thoại Nokia 105 4G - Hàng chính hãng",629000,629000,0,0
TIKI,dien-thoai-may-tinh-bang,193366048,"Điện thoại OnePlus 10T 5G - Hàng Chính Hãng",15990000,15990000,0,0
TIKI,dien-thoai-may-tinh-bang,176909016,"Máy tính bảng HANET Smart Edu Tablet Model T432 - Hàng Chính Hãng",3300000,3300000,0,0
TIKI,dien-thoai-may-tinh-bang,72310352,"Máy tính bảng Vankyo MatrixPad Z10 - Hàng Chính Hãng",2990000,2990000,0,0
TIKI,dien-thoai-may-tinh-bang,155833852,"Điện Thoại Masstel Hapi 30 3GB/32GB - Hàng Chính Hãng",1879000,2390000,511000,21
TIKI,dien-thoai-may-tinh-bang,16521748,"Điện thoại để bàn Panasonic KX-TS880 hàng chính hãng",1150000,1150000,0,0
TIKI,dien-thoai-may-tinh-bang,160450655,"Điện Thoại Masstel Tab 10A 3GB/32GB - Hàng Chính Hãng",2939000,3790000,851000,22
TIKI,dien-thoai-may-tinh-bang,192694043,"Điện thoại để bàn Panasonic KX-TS880 hàng chính hãng",1060000,1060000,0,0
TIKI,dien-thoai-may-tinh-bang,72290345,"Máy đọc sách Kobo Clara HD 8GB đen, 6 inch, có đèn cam - Hàng nhập khẩu",3099000,3099000,0,0
TIKI,dien-thoai-may-tinh-bang,151463645,"Điện thoại Bphone A60 (Ram 6Gb,Rom 128 Gb,màn hình đục lổ FHD 6.7inch , pin 5.000mAh ) - Hàng chính hãng",6490000,6490000,0,0
TIKI,dien-thoai-may-tinh-bang,162866839,"Máy tính bảng VNPT Technology VNT Tab8 Plus 8 Inch Android 11 RAM 4GB - Hàng chính hãng",3146000,3146000,0,0
TIKI,dien-thoai-may-tinh-bang,72310420,"Máy tính bảng VANKYO MatrixPad S30 - Hàng Chính Hãng",3090000,3090000,0,0
TIKI,dien-thoai-may-tinh-bang,62242668,"Điện Thoại Bàn Homephone lắp sim - Lắp Tất Cả Các Sim Đi Động - Di Chuyển Mang Đi Khắp Nơi - Hàng Chính Hãng",699000,699000,0,0
TIKI,dien-thoai-may-tinh-bang,148701811,"Máy đọc sách Kobo Nia - Hàng nhập khẩu",2680000,2680000,0,0
TIKI,dien-thoai-may-tinh-bang,140144656,"Điện thoại Realme C25Y (4GB/128GB) - Hàng chính hãng",3599000,4990000,1391000,28
TIKI,dien-thoai-may-tinh-bang,198111545,"Điện Thoại Vivo V25e 2022 (8GB/128GB) - Hàng Chính Hãng",8490000,8490000,0,0
TIKI,dien-thoai-may-tinh-bang,47292697,"Điện thoại bàn cổ điển DT40",2000000,2000000,0,0
TIKI,dien-thoai-may-tinh-bang,185755283,"Máy đọc sách Onyx Boox Nova Air - Hàng chính hãng",9860000,9860000,0,0
TIKI,dien-thoai-may-tinh-bang,143359355,"Điện Thoại Tecno Spark 6 Go 4GB/64GB - Hàng Chính Hãng",2079000,2990000,911000,30
TIKI,dien-thoai-may-tinh-bang,197966909,"Điện Thoại Samsung A04s 4GB/64GB - Hàng Chính Hãng",2669000,3990000,1321000,33
TIKI,dien-thoai-may-tinh-bang,163875403,"ĐIỆN THOẠI MASSTEL IZI 55 4G-HÀNG CHÍNH HÃNG",650000,650000,0,0
TIKI,dien-thoai-may-tinh-bang,128895957,"Paperwhite 5 (11th-generation) - 2021 - Hàng Nhập Khẩu",3690000,3800000,110000,3
TIKI,dien-thoai-may-tinh-bang,192859201,"Điện thoại Oukitel WP19(chống sốc ,chống nước ,Pin 21000mAh ,Ram 8G ,Rom 256G ,Tầm nhìn ban đêm 64MP ,  Máy ảnh 90Hz ,Điện thoại Helio G95 )-hàng chính hãng",9790000,9790000,0,0
TIKI,dien-thoai-may-tinh-bang,140184098,"Điện Thoại Vsmart Bee Lite 2GB/16GB - Hàng Chính Hãng",999000,1990000,991000,50
TIKI,dien-thoai-may-tinh-bang,84757299,"Điện thoại Itel it9200 4G - Hàng chính hãng",590000,590000,0,0
TIKI,dien-thoai-may-tinh-bang,270510406,"Điện thoại Vivo Y36 (8GB/128GB) - Hàng Chính Hãng - Camera 50MP - Sạc Nhanh 44W",5190000,5190000,0,0
TIKI,dien-thoai-may-tinh-bang,197651936,"Điện thoại Masstel Izi 25 4G Pin siêu khỏe, Gọi HD call- Hàng chính hãng",489000,599000,110000,18
TIKI,dien-thoai-may-tinh-bang,118486668,"Máy đọc sách Kobo Elipsa - Hàng nhập khẩu",12000000,12000000,0,0
TIKI,dien-thoai-may-tinh-bang,147969070,"Điện thoại thông minh itel A26 - giá rẻ | 2 Sim 2 Sóng 4G LTE | Màn hình IPS 5.7" HD+ | RAM 2GB + ROM 32 GB (Hỗ trợ thẻ nhớ 32 GB) | Mở khoá bằng Gương Mặt | Chính Hãng bảo hành 12 tháng| 1 đổi 1 trong 30 ngày",2390000,2390000,0,0
TIKI,dien-thoai-may-tinh-bang,158895857,"Điện thoại Vivo Y33s (8GB/128GB) - Hàng chính hãng",6069000,6069000,0,0
TIKI,dien-thoai-may-tinh-bang,136876846,"Máy Tính Bảng Samsung Galaxy Tab A7 3GB/64GB - Hàng Chính Hãng",4989000,7990000,3001000,38
TIKI,nha-sach-tiki,157255019,"Bộ Màu Nước Nén Water Color Cao Cấp 24 36 48 Màu Tặng Bút Lông Nước, Mút, Cọ, Tẩy, Bút Chì, Gọt, Màu Trắng Deli - Chuyên Dùng Cho Học Sinh, Sinh Viên, Vẽ Mĩ Thuật Chuyên Nghiệp - Ô tổ ong - 73936",135000,268200,133200,50
TIKI,nha-sach-tiki,110583137,"Bút highlight nhấn dòng dạ quang Deli - Cam/ Vàng/ Xanh Lá/ Hồng/ Xanh Dương - S625",8333,17400,9067,52
TIKI,nha-sach-tiki,185242029,"Vũ Điệu Quỷ Satan",123000,158000,35000,22
TIKI,nha-sach-tiki,49722650,"12 Quy Luật Cuộc Đời: Thần Dược Cho Cuộc Sống Hiện Đại",194000,300000,106000,35
TIKI,nha-sach-tiki,447164,"Tôi Vẽ - Phương Pháp Tự Học Vẽ Truyện Tranh",73000,100000,27000,27
TIKI,nha-sach-tiki,62648437,"Kinh Doanh Dịch Vụ Tại Việt Nam - Tự Tay Vận Hành Hoạt Động Marketing Của Bạn",144000,190000,46000,24
TIKI,nha-sach-tiki,169621653,"Đến Ngày Gặp Anh",103800,115000,11200,10
TIKI,nha-sach-tiki,194205624,"Pippi Tất Dài",92000,125000,33000,26
TIKI,nha-sach-tiki,74608742,"Vừa Đủ - Đẳng Cấp Sống Của Người Thụy Điển (Tái Bản)",64000,98000,34000,35
TIKI,nha-sach-tiki,196204932,"[A3/A4/A5/A6] Giấy Vẽ Màu Nước Tệp 16 Tờ 300Gsm A3 / A4 / A5 / A6 Chuyên Dụng Hạng Hoạ Sĩ Watercolor Paper Cao Cấp Finenolo Deli - Dùng Cho Màu Nước Gouache Acrylic Nhiều Cọ - EC270",29000,63000,34000,54
TIKI,nha-sach-tiki,158641027,"Kẻ Nhắc Tuồng (Tái Bản)",116000,155000,39000,25
TIKI,nha-sach-tiki,160488838,"Axit Và Kiềm Trong Thực Dưỡng (Tái Bản)",53500,75000,21500,29
TIKI,nha-sach-tiki,132355750,"Võ Nguyên Giáp - Hào Khí Trăm Năm (Tái Bản)",116000,200000,84000,42
TIKI,nha-sach-tiki,173650547,"30 Chuyên Đề Ngữ Pháp Tiếng Anh Cô Trang Anh: Sách ID Tổng ôn Ngữ pháp Tiếng Anh Moonbook",189000,250000,61000,24
TIKI,nha-sach-tiki,80141519,"Hackers IELTS Basic- Writing",115420,199000,83580,42
TIKI,nha-sach-tiki,81437585,"Tiếng Triều Dâng",105000,140000,35000,25
TIKI,nha-sach-tiki,97825967,"Tuyển Tập Những Câu Chuyện Hay Nhất Của AESOP (Song Ngữ Anh - Việt)",72600,108000,35400,33
TIKI,nha-sach-tiki,57386279,"Quạt xếp, quạt vải cầm tay họa tiết hoa anh đào 21*38 cm+ Tặng kèm hình dán-Quạt xếp cầm tay nhỏ gọn phong cách",59000,73750,14750,20
TIKI,nha-sach-tiki,155049277,"IELTS Key Writing - Công Thức Học Nhanh IELTS Writing Task 1",78000,119000,41000,34
TIKI,nha-sach-tiki,115897817,"Kỷ Luật Mềm Trong Gia Đình: Giáo Dục Trẻ 3 - 10 Tuổi Dành Cho Gia Đình Việt",118000,165000,47000,28
TIKI,nha-sach-tiki,130233550,"Vượt Qua Âu Lo, Chữa Lành Tâm Trí - Kiểm Soát Trầm Cảm Trong 7 Tuần Bằng Liệu Pháp Nhận Thức Hành Vi",137000,189000,52000,28
TIKI,nha-sach-tiki,155463014,"Quốc Gia Khởi Nghiệp - Câu Chuyện Về Nền Kinh Tế Thần Kỳ Của Israel (Tái Bản)",121220,209000,87780,42
TIKI,nha-sach-tiki,150783204,"Combo 10 miếng dán keo 2 mặt xốp siêu dính",20000,20000,0,0
TIKI,nha-sach-tiki,192788797,"Fly Me To The Moon - Tóm Lại Là Em Dễ Thương, Được Chưa - Tập 2",45000,55000,10000,18
TIKI,nha-sach-tiki,26272210,"Mọi người đều nói dối - Dữ liệu lớn, Dữ liệu mới và những điều Internet tiết lộ về chính chúng ta",127000,150000,23000,15
TIKI,nha-sach-tiki,184466858,"Tâm Lý Học - Những Thí Nghiệm Não Bộ Chưa Được Tiết Lộ",93100,125000,31900,26
TIKI,nha-sach-tiki,75953557,"Tâm Lý Học Về Tiền",132300,189000,56700,30
TIKI,nha-sach-tiki,101801426,"Sách IRED Books - ĐÚNG VIỆC - Một góc nhìn về câu chuyện KHAI MINH (Tái Bản) - Giản Tư Trung",125000,125000,0,0
TIKI,nha-sach-tiki,273645890,"Trạm Đọc | Thuật Tẩy Não",141000,189000,48000,25
TIKI,nha-sach-tiki,87960389,"Keo Siêu Dính Đa Năng Deli - 7Ml/ 20Ml - 7140/7149",16200,16200,0,0
TIKI,nha-sach-tiki,169262882,"Combo 2 cuốn Giáo Trình Hán Ngữ (Sách học Tiếng Trung dành cho người Việt) Giáo Trình Hán Ngữ Tập 1 + Giáo Trình Hán Ngữ Tập 2 (Phiên bản mới - Học bằng App McBooks)",170800,244000,73200,30
TIKI,nha-sach-tiki,13101929,"Series Địch Công Kỳ Án Tập 13 - Địch Gia Bát Án",66000,137000,71000,52
TIKI,nha-sach-tiki,153521902,"Những Người Phụ Nữ Bé Nhỏ",89800,129000,39200,30
TIKI,nha-sach-tiki,181656866,"Lịch Sử Israel - Câu Chuyện Về Sự Hồi Sinh Của Một Dân Tộc (Daniel Gordis)",291000,389000,98000,25
TIKI,nha-sach-tiki,184774171,"Đũa - Chuyện Linh Dị",214000,289000,75000,26
TIKI,nha-sach-tiki,104074993,"Nhảy Nhảy Nhảy (Tái Bản)",116000,169000,53000,31
TIKI,nha-sach-tiki,143226162,"Tỷ Phú Bán Giày (Tái Bản)",104200,159000,54800,34
TIKI,nha-sach-tiki,6915413,"Nghệ Thuật Tối Giản: Có Ít Đi, Sống Nhiều Hơn (Tái bản)",69700,108000,38300,35
TIKI,nha-sach-tiki,77982978,"The Master COACH - Con Đường Trở Thành Nhà Khai Vấn Tài Ba",96500,150000,53500,36
TIKI,nha-sach-tiki,160081248,"Gấu Pooh Xinh Xắn",69700,90000,20300,23
TIKI,nha-sach-tiki,189940724,"Triệu Phú Khu Ổ Chuột",94000,126000,32000,25
TIKI,nha-sach-tiki,141483251,"Sách: Thai Giáo Theo Chuyên Gia - 280 Ngày Mỗi Ngày Đọc 1 Trang (Tái Bản)",88000,110000,22000,20
TIKI,nha-sach-tiki,69337681,"Nhà Tư Tưởng Lớn - Nietzsche Trong 60 Phút",63000,96000,33000,34
TIKI,nha-sach-tiki,5154511,"Bà Nội Găngxtơ (Tái Bản)",58000,75000,17000,23
TIKI,nha-sach-tiki,114689806,"Full combo (Bộ 10 cuốn) Ehon song ngữ Kỹ năng - Màu sắc - Hình khối - Nhận biết",182000,350000,168000,48
TIKI,nha-sach-tiki,83432000,"Sách Người trong muôn nghề: Ngành Kinh tế có gì?",173000,189000,16000,8
TIKI,nha-sach-tiki,194110075,"Bẩm thầy Tường có thầy Vũ đến tìm - tập 2",115000,115000,0,0
TIKI,nha-sach-tiki,271536000,"Chú Thuật Hồi Chiến Tập 3: Cá Con Và Trừng Phạt Ngược",29800,30000,200,1
TIKI,nha-sach-tiki,185410021,"Set Decal Bọc Sách Vở Dán Bìa Trong Suốt Chống Nước Nhiều Kích Cỡ Deli - Bọc SGK Vở Sổ Tay Ghi Chép Truyện Tiều Thuyết - Lưu Trữ Bền Đẹp - 70603 / 70602 / 70601",27000,48600,21600,44
TIKI,nha-sach-tiki,124767704,"Bạn Đắt Giá Bao Nhiêu? (Tái Bản)",86400,119000,32600,27
TIKI,nha-sach-tiki,176550199,"Hội Chứng Trầm Cảm Cười: Đằng Sau Nụ Cười Hạnh Phúc Là Những Nỗi Đau",81100,109000,27900,26
TIKI,nha-sach-tiki,36727163,"Người Nam Châm (Tái Bản 2019)",55000,79000,24000,30
TIKI,nha-sach-tiki,127654481,"Tiệm Café Bên Rìa Thế Giới",70000,108000,38000,35
TIKI,nha-sach-tiki,108261352,"Tự Học Ngữ pháp Tiếng Anh Bằng Mindmap Tập 2",108000,145000,37000,26
TIKI,nha-sach-tiki,187009994,"Lôi Thần Và Nhân Viên Văn Phòng (Tập 5)",51200,66000,14800,22
TIKI,nha-sach-tiki,71880692,"600 Câu Hỏi Dùng Cho Sát Hạch, Cấp Giấy Phép Lái Xe Cơ Giới Đường Bộ",45000,45000,0,0
TIKI,nha-sach-tiki,157432540,"Thư Tình Gửi Một Người (Trịnh Công Sơn) (Tái Bản)",112000,195000,83000,43
TIKI,nha-sach-tiki,138269668,"Từ Điển Tiếng Việt (Hoàng Phê)(Tái Bản)",442000,495000,53000,11
TIKI,nha-sach-tiki,73795265,"Sách Hợp Nhất Với Vũ Trụ (Bìa Mềm) (Tái Bản 2020)",68100,88000,19900,23
TIKI,nha-sach-tiki,188536931,"Gửi Người Bí Ẩn Thân Thương (Truyện Tranh)",91100,109000,17900,16
TIKI,nha-sach-tiki,181379111,"Vô Cùng Tàn Nhẫn Vô Cùng Yêu Thương Tập 4",86420,149000,62580,42
TIKI,nha-sach-tiki,188694727,"Tập viết tiếng Thái",34000,50000,16000,32
TIKI,nha-sach-tiki,149942445,"Sức Mạnh Thương Mại Điện Tử - 12 Tháng Kiếm 1 Triệu Đô Bằng Kinh Doanh Online - Bộ Sách Trên Lưng Khổng Tượng",142000,199000,57000,29
TIKI,nha-sach-tiki,107409375,"Tiếng Anh 6 I-Learn Smart World - Workbook (Sách Bài Tập)",68000,68000,0,0
TIKI,nha-sach-tiki,73810559,"Combo 3 Cuốn: Hiệu Ứng Chim Mồi Tập 1 + 2 + 3",182000,265000,83000,31
TIKI,nha-sach-tiki,137751490,"[Tặng Bút Lông + Lau Bảng] Bảng từ trắng treo tường viết bút lông Deli Nhiều kích cỡ - Dùng Cho Văn Phòng, Trường Học, Tập Vẽ, Ghi Chú Công Thức Nấu Ăn, Trang Trí Nhà Cửa",405000,405000,0,0
TIKI,nha-sach-tiki,184226848,"Sợi tóc - Thạch Lam (Bìa mềm)",26700,35000,8300,24
TIKI,nha-sach-tiki,196395463,"Dưới cánh đại bàng (bìa mềm)",117300,138000,20700,15
TIKI,nha-sach-tiki,47323853,"Chinh Phục Luyện Thi Vào Lớp 10 Môn Tiếng Anh Theo Chủ Đề",105000,159000,54000,34
TIKI,nha-sach-tiki,48592472,"Combo Truyện Tranh Song Ngữ Việt - Anh Cho Bé (12 Tập)",135000,180000,45000,25
TIKI,nha-sach-tiki,46009013,"Fullmetal Alchemist - Cang Giả Kim Thuật Sư - Fullmetal Edition Tập 2",61100,69000,7900,11
TIKI,nha-sach-tiki,99992416,"Fullmetal Alchemist - Cang giả kim thuật sư - Fullmetal Edition - Tập 10",65600,69000,3400,5
TIKI,nha-sach-tiki,67040880,"Thân Mật Cội Nguồn Của Hạnh Phúc (Tái Bản 2020)",68100,98000,29900,31
TIKI,nha-sach-tiki,45438055,"BỘ SÁCH HỌC TIẾNG ANH lITTLE STORIES",421000,650000,229000,35
TIKI,nha-sach-tiki,11347711,"All The Rule - Sống Bản Lĩnh Theo Cách Một Quý Cô",62100,96000,33900,35
TIKI,nha-sach-tiki,146988856,"Lựa Chọn Đúng Quan Trọng Hơn Nỗ Lực - 6 Bước Để Ra Quyết Định Hoàn Hảo",110000,170000,60000,35
TIKI,nha-sach-tiki,13065341,"Series Địch Công Kỳ Án Tập 16 - Quảng Châu Án",101000,158000,57000,36
TIKI,nha-sach-tiki,5112975,"Marketing giỏi phải kiếm được tiền - The end of marketing as we know it",299000,299000,0,0
TIKI,nha-sach-tiki,182149648,"Nước Ép Trị Liệu Và Chế Độ Ăn Theo Phương Pháp Cơ Thể Tự Chữa Lành",149300,199000,49700,25
TIKI,nha-sach-tiki,14100920,"Bánh Mì Kẹp Chuột (Tái Bản 2019)",58800,79000,20200,26
TIKI,nha-cua-doi-song,139815721,"Sào Phơi Giá Rẻ - ko khoen,ko bánh xe,1m",125000,125000,0,0
TIKI,nha-cua-doi-song,159971094,"Bộ 2 hộp vải đựng đồ 7 ngăn mã HQ2 - Combo 2 hộp vải đựng quần áo chia ngăn gọn gàng tiện lợi chất vải Oxford cao cấp miDoctor",150000,250000,100000,40
TIKI,nha-cua-doi-song,185647202,"Tranh Cát Chảy Chuyển Động 3D KUNBE Nhiều Mẫu Trang Trí Nhà Cửa Bàn Làm Việc, Giảm Stress",168000,168000,0,0
TIKI,nha-cua-doi-song,15839139,"Đèn pin Laser Laze MV – 303 (Đen) tặng pin sạc và sạc",108000,108000,0,0
TIKI,nha-cua-doi-song,42491736,"Bút thử nước TDS, dụng cụ đo TDS, máy đo độ cứng của nước - Hàng chính hãng",124000,180000,56000,31
TIKI,nha-cua-doi-song,12736380,"Đồng hồ để bàn led báo thức thông minh",178000,178000,0,0
TIKI,nha-cua-doi-song,75411116,"Lót chân ghế, miếng dán chống trầy, chống rung lắc bàn ghế - Hàng chính hãng",23000,25000,2000,8
TIKI,nha-cua-doi-song,117318253,"Nệm xếp đa năng Goodnight 70x180cm, Nệm gấp văn phòng, Nệm xếp 3 thiết kế gọn nhẹ, kèm túi đựng (Giao màu ngẫu nhiên)",466000,570000,104000,18
TIKI,nha-cua-doi-song,54682452,"Pin vuông 9V Energizer 522 ALKALINE chính hãng ( Mẫu mới )",57000,60000,3000,5
TIKI,nha-cua-doi-song,98153708,"Chậu Gội Đầu Tại Giường KUNBE, Chậu Gội Đầu Tại Nhà Thông Minh Cho Mọi Người - Tặng Lược Massage Và Cốc Gội Đầu",209000,209000,0,0
TIKI,nha-cua-doi-song,194465292,"Bình giữ nhiệt LocknLock DIY Strap Tumbler LHC3283 350ml",254000,489000,235000,48
TIKI,nha-cua-doi-song,181909427,"Nồi 2 Tay Cầm Suit LocknLock CSU1202PIK - Màu Pink",578000,1112000,534000,48
TIKI,nha-cua-doi-song,185889866,"[ Mới nhất ] Hashtag Cầm Tay check in đám cưới",28000,28000,0,0
TIKI,nha-cua-doi-song,38114299,"Thanh treo rèm cửa inox đa năng, không cần khoan tường hay bắt vít, thay đổi vị trí linh hoạt HT03",60000,60000,0,0
TIKI,nha-cua-doi-song,102508672,"Thùng Đựng Rác Thông Minh E1906, Nắp Đóng Mở Một Chạm Tiện Ích, Chất Liệu Nhựa Cao Cấp Chống Nước, Chịu Nhiệt Tốt, Dung Tích 10 Lít - Hàng Nhập Khẩu",229000,360000,131000,36
TIKI,nha-cua-doi-song,149657438,"Tấm Nệm Trải Sàn Gấp Gọn Hàng xuất Nhật",273000,350000,77000,22
TIKI,nha-cua-doi-song,177129235,"Bình giữ nhiệt Thermos nút bấm JNL-752 MTB 750ml màu xanh dương",854000,1090000,236000,22
TIKI,nha-cua-doi-song,781987,"Gối Memory Foam 50D Lock & Lock HLW114 (61 x 34 x 10 cm)",475000,791000,316000,40
TIKI,nha-cua-doi-song,75044183,"Đèn Đọc Sách Cao Cấp - Đèn Bàn Làm Việc Sang Trọng - Đèn Ngủ - Đèn Trang Trí - Có Thể Gập Hai Chỗ – 03 Chế Độ Ánh Sáng Vàng Bảo Vệ Mắt Chống Cận Pin Sạc - Hàng Chính Hãng - VinBuy",175000,300000,125000,42
TIKI,nha-cua-doi-song,45170002,"Tấm Chắn Dầu Mỡ Tiện Dụng Cho Bếp Ga - TC29",14000,15478,1478,10
TIKI,nha-cua-doi-song,125658476,"Bình Giữ Nhiệt Kim Cương 1500Ml Inox 304- YOGA QG- Chống Rỉ Set, Nắp Đậy Chặt, Giữ Nhiệt Nóng Lạnh Tốt 6- 8h, Quai Đeo Chắc Chắn, Thiết Kế Sang Trọng, Màu Sắc Thanh Lịch, Tiện Lợi, Pha Lọc Trà, Hàng Chính Hãng",141000,172000,31000,18
TIKI,nha-cua-doi-song,74859074,"Chuông Cửa Không Dây Thông Minh CTFAST CT - 01 (1 Nút Bấm, 1 Chuông ), Chống Nước, Khoảng Cách Sử Dụng Hiệu Quả 300 mét - Hàng Chính Hãng",135000,169000,34000,20
TIKI,nha-cua-doi-song,59238383,"Vòi nước đa năng 2 đầu đồng mạ chorme cao cấp mẫu mới 2024 (Hàng chính hãng)",171000,295000,124000,42
TIKI,nha-cua-doi-song,189157824,"Bộ 8 túi hút chân không tặng kèm bơm hút chân không đựng quần áo, chăn màn, ga gối gọn gàng D Danido",189000,199000,10000,5
TIKI,nha-cua-doi-song,12213522,"Ô dù đi mưa gấp gọn hình gấu Brown",45000,45000,0,0
TIKI,nha-cua-doi-song,80757840,"Combo 3 hộp vải đựng đồ đa năng TD2 – Bộ 3 túi vải Thụy Điển không nắp tiết kiệm sang trọng dung tích 24L mỗi hộp - chính hãng",159000,210000,51000,24
TIKI,nha-cua-doi-song,7699064,"Chảo Nhôm Sâu Lòng Chống Dính Lock&Lock Baum Marble 1 Tay Cầm, Nắp Thủy Tinh LBU1285 (28cm)",404000,776000,372000,48
TIKI,nha-cua-doi-song,21582013,"Bộ Bịt Mắt Ngủ 3D Tặng Kèm Bịt Tai Chống Ồn Màu Ngẫu Nhiên",45000,45000,0,0
TIKI,nha-cua-doi-song,252390050,"Gương dán tường 30x30cm LOẠI MỚI",33000,39000,6000,15
TIKI,nha-cua-doi-song,106338289,"Dép Lỗ Đi Trong Nhà Tắm Chống Trơn Trượt Nhanh Khô, Thoáng Mát, Mẫu Mới Nhất. Dép Cho Cả Gia Đình",95000,155000,60000,39
TIKI,nha-cua-doi-song,185004372,"Ly Thủy Tinh Phong Cách Bắc Âu Đế Xoay 170ml - Navivu Rock Glass",45000,45000,0,0
TIKI,nha-cua-doi-song,105374376,"Bộ Lõi Lọc Khử Mùi Hôi Lỗ Thoát Sàn Cao Cấp MIFAN - Ngăn chặn mùi hôi cống, chống côn trùng lỗ thoát nước nhà tắm, vệ sinh, bồn rửa - Mẫu mới 2021",50000,50000,0,0
TIKI,nha-cua-doi-song,73640967,"Miếng lau nhà thay thế Bộ lau nhà KITIMOP-C6 PLUS ( 33 x 12cm)",15000,19000,4000,21
TIKI,nha-cua-doi-song,131407862,"ghế văn phòng ghế xoay văn phòng",399000,591000,192000,32
TIKI,nha-cua-doi-song,104681142,"(Chọn Loại) Túi Zip PE Trong Suốt 2 Đường Kéo MyJae, Túi Bọc Đồ Ăn, Rau Củ Bảo Quản Trong Tủ Lạnh",66000,99000,33000,33
TIKI,nha-cua-doi-song,83927709,"Bịt Mắt Ngủ Che Mắt Ngủ Có Túi Gel Massage - Giảm Thâm Quầng Mắt - Mẫu Hoạt Hình Mới - Xanh Đen",35000,35000,0,0
TIKI,nha-cua-doi-song,38462026,"Đèn Led Trang Trí Bóng Tròn Dài 3M - 20 Bóng Trang Trí Noel Lễ Tết",43900,43900,0,0
TIKI,nha-cua-doi-song,77962744,"Kệ nhà tắm, kệ dán tường đựng đồ nhà tắm, đồ bếp, nhà vệ sinh, siêu chịu lực, (không dán lên tường sơn nước, sơn vôi) - Giao màu ngẫu nhiên",42750,45000,2250,5
TIKI,nha-cua-doi-song,75354717,"Tủ Quần Áo 2 Buồng 6 Ngăn Tiện Lợi, Tủ Vải 170cm Chất Lượng Cao Chắc Chắn, Vững Chãi - Hàng Chính Hãng miDoctor",240000,295000,55000,19
TIKI,nha-cua-doi-song,164593190,"Tăm chỉ nha khoa tiệt trùng hộp 50 cây, vệ sinh kẽ răng chân nướu chuyên dụng",4999,4999,0,0
TIKI,dien-thoai-may-tinh-bang,15428119,"Điện thoại Ip phone Cisco CP-7945G chính hãng",4500000,4500000,0,0
TIKI,dien-thoai-may-tinh-bang,52481412,"Điện thoại bàn cổ điển, điện thoại bàn tân cổ điển, DT122",2200000,2200000,0,0
TIKI,dien-thoai-may-tinh-bang,23865953,"Điện Thoại Để Bàn Panasonic KX-TS500MX - Hàng Chính Hãng",299000,299000,0,0
TIKI,dien-thoai-may-tinh-bang,172537996,"(Hàng chính hãng) Điện thoại bàn hữu tuyến H2P, hiệu Alcatel - Lucent",2220000,2220000,0,0
TIKI,dien-thoai-may-tinh-bang,29446449,"Điện thoại không dây IP 622CW ",1850000,1850000,0,0
TIKI,dien-thoai-may-tinh-bang,252884859,"Tay con điện thoại bàn Panasonic TGDA30-hàng chính hãng",990000,990000,0,0
TIKI,dien-thoai-may-tinh-bang,271152577,"Điện Thoại Samsung Galaxy Z Flip5 5G - Hàng Chính Hãng - Đã kích hoạt bảo hành điện tử",29490000,29490000,0,0
TIKI,dien-thoai-may-tinh-bang,274440344,"Điện thoại Xiaomi Redmi Note 13 pro (8GB - 128GB) hàng chính hãng - Bảo hành 18 tháng",6490000,6790000,300000,4
TIKI,dien-thoai-may-tinh-bang,273955111,"Điện Thoại Oppo Reno 10 5G (8GB/128GB) - Hàng Chính Hãng",7650000,8990000,1340000,15
TIKI,dien-thoai-may-tinh-bang,249955152,"Điện thoại Xiaomi Redmi Note 12 Pro 5G (8GB/256GB) - Hàng chính hãng",9490000,9490000,0,0
TIKI,dien-thoai-may-tinh-bang,274568845,"Điện thoại Xiaomi 14 5G (12GB/256GB) - Hàng chính hãng",22990000,22990000,0,0
TIKI,dien-thoai-may-tinh-bang,273685412,"Điện thoại Samsung Galaxy A25 5G (6GB/128GB) - Hàng chính hãng",6590000,6590000,0,0
TIKI,dien-thoai-may-tinh-bang,253443894,"Điện Thoại Samsung Galaxy M14 5G (4GB/128GB) - Hàng Chính Hãng",4212000,4212000,0,0
TIKI,dien-thoai-may-tinh-bang,160434731,"Máy Tính Bảng Samsung Galaxy Tab A8 4GB/64GB - Hàng Chính Hãng",5856000,5856000,0,0
TIKI,dien-thoai-may-tinh-bang,273388474,"Điện thoại chắc chắn Ulefone Power Armor 18T Ultra (chụp ảnh nhiệt Camera FLIR5G 512GB ROM +24GB RAM)- hàng chính hãng",15990000,15990000,0,0
TIKI,dien-thoai-may-tinh-bang,271822675,"Máy Tính Bảng Samsung Galaxy Tab A8 - Hàng Chính Hãng",5856000,5856000,0,0
TIKI,dien-thoai-may-tinh-bang,204872160,"Điện thoại Oppo A17k (3GB/64GB) - Hàng chính hãng",3290000,3290000,0,0
TIKI,dien-thoai-may-tinh-bang,273360836,"Điện thoại Ulefone armor 22(chống nước,chống va đập, Màn hình giọt nước 6,58 inch, RAM:8GB,Rom 128GB/256GB,Thẻ nhớ microSD Lên đến 512GB, Camera kép 64MP + 64MP)- hàng chính hãng",5990000,5990000,0,0
TIKI,dien-thoai-may-tinh-bang,273897590,"Điện thoại Tecno SPARK 20c (8+8)GB/128GB - MTK G36 | 5000 mAh | Sạc nhanh 18W | Hàng Chính Hãng",2490000,2690000,200000,7
TIKI,dien-thoai-may-tinh-bang,273640492,"Điện Thoại Samsung Galaxy A05 (6GB/128GB) - Hàng Chính Hãng",3237000,3237000,0,0
TIKI,dien-thoai-may-tinh-bang,273411988,"Điện thoại Xiaomi Redmi 13C (6+128GB) | 6.74" 90Hz| Media Tek Helio G85| 5000mAh - Hàng chính hãng",3028000,3490000,462000,13
TIKI,dien-thoai-may-tinh-bang,249730344,"Điện thoại Masstel IZI 12 4G LTE - 2 Sim 2 Sóng - Pin 1000 mAh - Loa to - Hàng Chính Hãng - Bảo Hành 12 Tháng",456000,456000,0,0
TIKI,dien-thoai-may-tinh-bang,53380152,"Điện Thoại IP Phone Fanvil X1S - Hàng Chính Hãng",950000,950000,0,0
TIKI,dien-thoai-may-tinh-bang,274191773,"Điện thoại ZTE Libero 5G IV - 4GB/128GB Dimensity 700 , Kháng nước IP67 , Sạc nhanh 22,5W - Mới nguyên seal - Hàng nhập khẩu",2350000,2990000,640000,21
TIKI,dien-thoai-may-tinh-bang,255866251,"Điện Thoại Samsung A14 4GB/128GB - Hàng Chính Hãng",3429000,4490000,1061000,24
TIKI,dien-thoai-may-tinh-bang,247730209,"Điện thoại Samsung Galaxy A34 5G (8GB/128GB) - Hàng chính hãng",7164000,7164000,0,0
TIKI,dien-thoai-may-tinh-bang,274498287,"Điện Thoại Samsung Galaxy A55 5G (8GB/128GB)- Hàng Chính Hãng",9390000,9990000,600000,6
TIKI,dien-thoai-may-tinh-bang,197902452,"Điện thoại Masstel Lux 20 4G dành cho người lớn tuổi - Hàng chính hãng, Nguyên Seal",790000,790000,0,0
TIKI,dien-thoai-may-tinh-bang,271290719,"Điện Thoại Cho Người Già Masstel Fami 65 - SOS, Loa To, FM Không Dây, Đọc Số Bằng Giọng Nói, Xem Lịch Âm - HÀNG CHÍNH HÃNG",699000,999000,300000,30
TIKI,dien-thoai-may-tinh-bang,273373420,"Điện thoại Xiaomi Redmi 13C (4GB/128GB) - Hàng chính hãng - Bảo hành 18 tháng",2832000,3090000,258000,8
TIKI,dien-thoai-may-tinh-bang,261965186,"Điện Thoại Xiaomi Redmi Note 12S (8GB/256GB) - Hàng Chính Hãng",6132000,6132000,0,0
TIKI,dien-thoai-may-tinh-bang,249168949,"Điện thoại Samsung Galaxy A34 5G 8GB/128GB Bạc - Hàng chính hãng",7164000,7164000,0,0
TIKI,dien-thoai-may-tinh-bang,249178196,"Điện thoại Samsung Galaxy A34 5G 8GB/128GB Xanh - Hàng chính hãng",7600000,8490000,890000,10
TIKI,dien-thoai-may-tinh-bang,192348147,"Điện thoại Oppo A57 (4GB/64GB) - Hàng chính hãng",4284000,4284000,0,0
TIKI,dien-thoai-may-tinh-bang,273244815,"Điện thoại Samsung Galaxy A23 5G 4GB/128GB Đen - Hàng chính hãng",5200000,5990000,790000,13
TIKI,dien-thoai-may-tinh-bang,251772653,"Điện thoại Masstel izi 56 4G (pin trâu-loa chữ to rõ) - Hàng Chính Hãng",687000,687000,0,0
TIKI,dien-thoai-may-tinh-bang,245770363,"Điện thoại Samsung Galaxy A04e (3GB/32GB) - Hàng chính hãng",2325000,2325000,0,0
TIKI,dien-thoai-may-tinh-bang,262589811,"Điện thoại Samsung Galaxy A24 (6GB/128GB) - Hàng chính hãng - ĐÃ KÍCH HOẠT BẢO HÀNH ĐIỆN TỬ",6084000,6084000,0,0
TIKI,dien-thoai-may-tinh-bang,215097578,"Điện Thoại Di Động Forme D666 4G - Hàng Chính Hãng",650000,650000,0,0
TIKI,dien-thoai-may-tinh-bang,244355503,"Điện thoại Samsung Galaxy A04s (4GB/64BG) - Hàng chính hãng",3990000,3990000,0,0
TIKI,nha-sach-tiki,120357410,"Thực Hành Khởi Nghiệp - Từng Bước Nhỏ Làm Chủ Doanh Nghiệp Lớn",125000,169000,44000,26
TIKI,nha-sach-tiki,147920905,"Đường Mây Qua Xứ Tuyết (Tái Bản)",82100,118000,35900,30
TIKI,nha-sach-tiki,11508322,"Nội Tình Của Ngoại Tình",142000,220000,78000,35
TIKI,nha-sach-tiki,192339427,"Bà Bác Khủng Khiếp",116000,150000,34000,23
TIKI,nha-sach-tiki,1029894,"Tuần Của Bé - Bé Tinh Tế (Dành Cho Trẻ 3 - 6 Tuổi)",21850,23000,1150,5
TIKI,nha-sach-tiki,185500894,"i-Learn Smart Start 5 Student's Book Special Edition",113000,113000,0,0
TIKI,nha-sach-tiki,193895767,"THE DAILY STOIC – 366 CHIÊM NGHIỆM VỀ TRÍ TUỆ VÀ LÒNG CAN TRƯỜNG CÙNG NGHỆ THUẬT SỐNG",166400,239000,72600,30
TIKI,nha-sach-tiki,193450572,"Quái Mèo Độc Tấu",99200,119000,19800,17
TIKI,nha-sach-tiki,3526069,"Quản Trị Nguồn Nhân Lực",116000,116000,0,0
TIKI,nha-sach-tiki,190705661,"Lại Thằng Nhóc Emil",84500,109000,24500,22
TIKI,nha-sach-tiki,100202726,"Phương Pháp Wyckoff Hiện Đại - Kỹ thuật Nhận diện Xu hướng Thị trường Tiềm năng",356000,356000,0,0
TIKI,nha-sach-tiki,176824204,"Tinh Hoa Kinh Tế Học (Tái Bản)",431000,555000,124000,22
TIKI,nha-sach-tiki,46723656,"Sách Tử Tế Đáng Giá Bao Nhiêu",68100,98000,29900,31
TIKI,nha-sach-tiki,40933973,"Dịch Kinh Tường Giải (Di Cảo): Quyển Thượng (Tái Bản)",222000,340000,118000,35
TIKI,nha-sach-tiki,45321630,"Bạn Chỉ Tưởng Là Mình Đang Rất Cố Gắng",93000,123000,30000,24
TIKI,nha-sach-tiki,58627102,"Sổ Tay Nhà Thôi Miên",98500,145000,46500,32
TIKI,nha-sach-tiki,67712912,"Phát Triển Trí Tuệ Cảm Xúc- Chúng Mình Tôn Trọng Cơ Thể Và Cảm Xúc Của Nhau",37100,50000,12900,26
TIKI,nha-sach-tiki,89001327,"Giao Dịch Theo Xu Hướng Để Kiếm Sống",366000,366000,0,0
TIKI,nha-sach-tiki,115972858,"Sổ tay ghi chép lò xo màu pastel Deli - Giấy kẻ ngang 80 trang khổ A5 / B5 - Phù hợp làm sổ kế hoạch, sổ nhật kí, tập vở ghi chép - 24202 / 24203",33000,70200,37200,53
TIKI,nha-sach-tiki,274145052,"Trạm Đọc| Hackers IELTS Basic: Reading + Writing + Speaking + Listening ( Dành cho người mới bắt đầu )",624000,836000,212000,25
TIKI,nha-sach-tiki,188960732,"COMBO TỰ HỌC TAROT: Sách Nhật ký Tarot + Bộ Bài & Sách Hướng Dẫn (Tái bản 2022)",296000,398000,102000,26
TIKI,nha-sach-tiki,568762,"Tam Quốc Diễn Nghĩa (Trọn Bộ 04 Tập)",182000,350000,168000,48
TIKI,nha-sach-tiki,34751481,"Ngụ Ngôn Song Ngữ Anh - Việt: Kiến Và Chim Bồ Câu (Tái Bản 2019)",16800,28000,11200,40
TIKI,nha-sach-tiki,155463025,"Nghệ Thuật Bán Hàng Bậc Cao - Bí Quyết Chốt Deal Mọi Thời Đại (Khổ Lớn)(Tái Bản)",128000,198000,70000,35
TIKI,nha-sach-tiki,71094783,"Linh Hồn Của Tiền - The Soul Of Money",249000,249000,0,0
TIKI,nha-sach-tiki,171212880,"Ikigai – Đi Tìm Lý Do Thức Dậy Mỗi Sáng",61800,89000,27200,31
TIKI,nha-sach-tiki,185658131,"Dragon Quest - Dấu Ấn Roto (Dragon Quest Saga Emblem Of Roto) Perfect Edition Tập 7 [Tặng Kèm Bookmark PVC] ",67100,75000,7900,11
TIKI,nha-sach-tiki,168559524,"Gia Đình Tỉnh Thức",149000,209000,60000,29
TIKI,nha-sach-tiki,102832719,"Thay Tư Duy Xoay Cục Diện - Ngưng Sống Cầm Chừng",95800,129000,33200,0
TIKI,nha-sach-tiki,72202103,"Con Chim Xanh Biếc Bay Về (Nguyễn Nhật Ánh) (Bìa Mềm)",99000,150000,51000,34
TIKI,nha-sach-tiki,181699658,"Chiến Lược Giao Dịch Của Jesse Livermore",110700,159000,48300,30
TIKI,nha-sach-tiki,193099629,"Chuyên Gia Kinh Tế Bước Vào Nhà Thổ Và Những Nơi Không Ngờ Khác Để Hiểu Về Rủi Ro",135000,175000,40000,23
TIKI,nha-sach-tiki,5743603,"Vật Lý Thiên Văn Cho Người Vội Vã",58700,80000,21300,27
TIKI,nha-sach-tiki,25203389,"Advanced Grammar in Use Book with Answers  Edition: A Self-Study Reference and Practice Book for Advanced Learners of English",163800,178000,14200,8
TIKI,nha-sach-tiki,114228620,"Combo Tiếng Hàn Tổng Hợp Sơ Cấp 1 Dành Cho Người Việt Nam Bản In Màu - Học Kèm App",249900,357000,107100,30
TIKI,nha-sach-tiki,89204253,"4000 Từ Vựng Và Mẫu Câu Tiếng Anh Thiết Yếu Cho Trẻ Em",177000,250000,73000,29
TIKI,nha-sach-tiki,344788,"Bất Cứ Điều Gì Em Muốn",41400,69000,27600,40
TIKI,nha-sach-tiki,95089986," Bút chì màu gốc dầu cao cấp Deli - 6565 / 6566 / 6567",250200,250200,0,0
TIKI,nha-sach-tiki,195959545,"Chú Thuật Hồi Chiến - Tập 6 - Bản Thường - Tặng Kèm Obi Và Thẻ Bo Góc Nhựa",29100,30000,900,3
TIKI,nha-sach-tiki,55589742,"Sách Bài Học Diệu Kỳ Từ Chiếc Xe Rác (Khổ Lớn) (Tái Bản)",71100,108000,36900,34
TIKI,nha-cua-doi-song,7202377,"Bộ 3 Lõi Lọc Nước Máy Tiêu Chuẩn Barrier",504000,660000,156000,24
TIKI,nha-cua-doi-song,21459762,"PHÂN TRÙN QUẾ HỮU CƠ DÙNG CHO RAU SẠCH VÀ HOA KIỂNG - 2 KG",15900,15900,0,0
TIKI,nha-cua-doi-song,32014487,"Chăn Nỉ Văn Phòng Cao Cấp (160cm * 120cm)",129000,179000,50000,28
TIKI,nha-cua-doi-song,73464817,"Kệ gia vị dán tường dài 30/40/50cm sơn đen tĩnh điện Vando chính hãng - kèm keo chuyên dụng kệ treo tường bằng thép carbon không gỉ, siêu chịu lực 30kg",119000,141000,22000,16
TIKI,nha-cua-doi-song,87982701,"Pin Nút Áo CR2032 BR2032 DL2032 ECR2032 Lithium 3V CR 2032 220mAh (5 Viên) Pin Cho Đồng Hồ Điện Tử/ Đồ Chơi Điều Khiển Từ Xa/ Đèn Xe Đạp",26000,39000,13000,33
TIKI,nha-cua-doi-song,87966539,"Sọt rác lưới tròn 26x23x18.5cm - Màu Ngẫu Nhiên",76000,120000,44000,37
TIKI,nha-cua-doi-song,59425995,"Bộ Ga Gối Cotton Tici Kẻ LIDACO Cao Cấp - Kẻ Cam Ghi",159000,229000,70000,31
TIKI,nha-cua-doi-song,27986931,"Kệ Sách Để Bàn Tiện Ích - Vân gỗ",68000,99000,31000,31
TIKI,nha-cua-doi-song,191918107,"Bình lắc LocknLock Balance Shake It Bottle HAP949BLK 800ml - Màu",139000,267000,128000,48
TIKI,nha-cua-doi-song,176309828,"Túi thực phẩm Inochi - shinsen 25 x 35cm",35000,35000,0,0
TIKI,nha-cua-doi-song,201687096,"[TikiNow giao hàng] Ghế chỉnh dáng ngồi đúng Roichen - Hàn Quốc. Sản phẩm dành cho Nữ , Sản phẩm nhập khẩu Hàn Quốc (Made in Korea). Hàng chính hãng Roichen",785000,898000,113000,13
TIKI,nha-cua-doi-song,68391419,"ĐẦU VÒI RỬA CHÉN LỌC NƯỚC TĂNG ÁP 360 ĐỘ - giao màu ngẫu nhiên",7850,7850,0,0
TIKI,nha-cua-doi-song,72829989,"Lá diệp phật - Ngọc Quý Gemstones",39000,39000,0,0
TIKI,nha-cua-doi-song,167041804,"Ly rock thủy tinh pha lê đế xoay 360 độ, cốc uống whisky rượu tây 160ml wine glass",35000,35000,0,0
TIKI,nha-cua-doi-song,81936258,"Hộp đựng quần áo gấp gọn có nắp Màu kem Morning House  - SIZE S",45000,50000,5000,10
TIKI,nha-cua-doi-song,88914388,"Bộ 04 chân đế cao su chống rung máy giặt - HT SYS - Đế chống rung máy giặt - Đế chống ồn máy giặt, máy sấy,tủ lạnh, bàn ghế + Sét 3 móc dính dán tường vàng tài lộc HT SYS",139000,139000,0,0
TIKI,nha-cua-doi-song,46327991,"Hộp Nhựa Đựng Thực Phẩm Trong Suốt GAGI Mã GH01 Nhựa PP Bền Bỉ, Sử Dụng Cho Cả Lò Vi Sóng Không Bám Mùi Dễ Dàng Vệ Sinh - Hàng Chính Hãng",44000,69000,25000,36
TIKI,nha-cua-doi-song,138380998,"Gói 20 Chiếc Khăn Cotton Nén Sử Dụng Một Lần Tiện Dụng Cho Du Lịch Khổ 20x24cm Khăn Uớt Viên Kẹo",17000,35000,18000,51
TIKI,nha-cua-doi-song,29339320,"Công tắc điều khiển từ xa Honest HT-6220KGD công suất lớn 220v 40A 1000m dùng cho máy bơm ,moto điện..",159000,159000,0,0
TIKI,nha-cua-doi-song,657076,"Màng Bọc Thực Phẩm PE Ringo 150 (30cm x 150m)",103000,103000,0,0
TIKI,nha-cua-doi-song,55427978,"Combo 200 Túi Lọc Rác cho bồn rửa chén bát ",99000,99000,0,0
TIKI,nha-cua-doi-song,42759652,"Chốt cửa dây xích an toàn inox 304 gắn cửa HOBBY Home Decor KLC1 bảo vệ phòng cho chung cư phòng ngủ không rỉ sét",82000,129000,47000,36
TIKI,nha-cua-doi-song,73314056,"Lọ xay tiêu cầm tay nắp viền inox 304 lọ thủy tinh Hobby Home Decor XT mẫu thon cao và mẫu thấp tùy chọn",54000,99000,45000,45
TIKI,nha-cua-doi-song,164848242,"Chậu gội đầu tại giường cho người già, trẻ nhỏ, người bệnh... màu sắc giao ngẫu nhiên- Hàng chính hãng",124000,130000,6000,5
TIKI,nha-cua-doi-song,78904788,"Gối Lót Ngồi Y Tế Hình Chữ O Bằng Cao Su Non Phòng Bệnh Trĩ Giảm Đau Xương Cụt",205000,205000,0,0
TIKI,nha-cua-doi-song,21389285,"Vỉ 20 viên pin cmoss CR2032",38200,38200,0,0
TIKI,nha-cua-doi-song,174262175,"Bát Sen Tắm Của Vòi Tắm Hoa Sen Nóng Lạnh Pimisi Với Tay Sen Bằng Nhựa Cao Cấp Mạ Xi Cr/Ni Màu Inox Sáng Bóng Kiểu Vuông Bo Tròn Góc - Ổn Định Nhiệt Độ Nước Nóng Lạnh Theo Công Nghệ Đầu Phun Tăng Áp Dạng Phun Mưa Tiết Kiệm Nước | Hàng Chính Hãng",124000,200000,76000,38
TIKI,nha-cua-doi-song,73230427,"Chill Party-Đèn Chiếu Ngàn Sao 6 phong cách kiêm đèn ngủ xoay tự động, tích hợp phát nhạc bằng Bluetooth nhiều màu sắc tuyệt đẹp, sạc lại bằng USB",380000,380000,0,0
TIKI,nha-cua-doi-song,181223364,"Bộ vòi xịt vệ sinh toilet kèm giá treo và dây lò xo co giãn HOBBY Home Decor VSR2 inox 304 ren chờ 21mm",144000,229000,85000,37
TIKI,nha-cua-doi-song,134360720,"Bộ 8 Pin AAA ( R03NT/2S ) Panasonic 1,5V Không Chì - Hàng Chính Hãng",40000,45000,5000,11
TIKI,nha-cua-doi-song,137176118,"100gram Túi Zip trong suốt đáy đứng- túi đựng thực phẩm khô, nước - size",38000,40000,2000,5
TIKI,nha-cua-doi-song,171022457,"Dầu bôi trơn thiết bị gia dụng đa năng dùng trong gia đình - Dầu bôi trơn động cơ, chống rỉ bánh răng cơ khí",24000,24000,0,0
TIKI,nha-cua-doi-song,20104505,"Hộp 3 ống hút inox và cọ rửa",43000,43000,0,0
TIKI,nha-cua-doi-song,90530495,"Đèn Pixar, Đèn Bàn Học Chống Cận Thị, Đèn Đọc Sách, Đèn Làm Việc Bảo Vệ Mắt - Hàng Chính Hãng Moontronics MT01",255000,310000,55000,18
TIKI,nha-cua-doi-song,186094219,"Khăn Tắm Nén Bằng Cotton Tiện Lợi Dùng Một Lần 70*140 cm - Khăn Nén Du Lịch - Khăn Nén Spa",13000,14111,1111,8
TIKI,nha-cua-doi-song,55465365,"Pin Max 8 + 4 Viên Energizer E92 BP8+4 AAA - Hàng Chính Hãng Model 2020",138000,145000,7000,5
TIKI,nha-cua-doi-song,118451214,"Ổ cắm điện LiOA đa năng - Ổ on/off 4 lỗ, 6 lỗ mỗi ổ 1 công tắc dây dài 3m",139000,139000,0,0
TIKI,nha-cua-doi-song,169696716,"Bình Đựng Nước 2L Dễ Thương Kèm Ống Hút , Có Vạch Báo Giờ Uống Nước - Hàng Loại 1 Chính Hãng",124000,218000,94000,43
TIKI,nha-cua-doi-song,205819517," Bóng đèn Led thông minh Xiaomi Yeelight Bulb W3 đui xoắn E27 (RGB 16 triệu màu) - tích hợp Razer Chroma",261000,350000,89000,25
TIKI,nha-cua-doi-song,21418511,"Hộp đựng bông tẩy trang và tăm bông 2 ngăn mica cao cấp 14.5 x 10.5 x 13 cm",85000,85000,0,0
TIKI,dien-thoai-may-tinh-bang,272555368,"XIAOMI 13T 5G (12GB-256GB) - Hàng chính hãng",11385000,11990000,605000,5
TIKI,dien-thoai-may-tinh-bang,274019932,"Điện thoại Masstel Izi 56 4G (LTE) Gọi HD Call ,Pin khủng ,loa lớn - Hàng Chính Hãng",548000,650000,102000,16
TIKI,dien-thoai-may-tinh-bang,217706932,"Combo Máy đọc sách All New Kindle Paperwhite 5 (11th Gen) và Bao da - Hàng nhập khẩu",3980000,3980000,0,0
TIKI,dien-thoai-may-tinh-bang,270707514,"Máy Đọc Sách BOOX Tab Mini C - Hàng Chính Hãng",11850000,12990000,1140000,9
TIKI,dien-thoai-may-tinh-bang,252073075,"Điện thoại Masstel IZI11 4G - Hàng Chính Hãng",468000,468000,0,0
TIKI,dien-thoai-may-tinh-bang,270074304,"Điện Thoại Xiaomi Redmi Note 12S 8GB/256GB - Hàng Chính Hãng",4739000,6690000,1951000,29
TIKI,dien-thoai-may-tinh-bang,273016223,"Điện Thoại Xiaomi Redmi A2 2GB/32GB - Hàng Chính Hãng",1729000,2190000,461000,21
TIKI,dien-thoai-may-tinh-bang,252428990,"Điện thoại Tecno SPARK 10 Pro 8GB/256GB - Helio G88 | 5000 mAh | Sạc nhanh 18W | Cảm ứng vân tay - Hàng chính hãng",4149000,4490000,341000,8
TIKI,dien-thoai-may-tinh-bang,263073487,"Điện thoại Tecno CAMON 20 Pro 8GB/256GB - Camera 64MP + 32MP | Helio G99 | 5000 mAh/ 33W | 6.7'' FHD AMOLED - Hàng Chính Hãng - BH 13 Tháng",5490000,5490000,0,0
TIKI,dien-thoai-may-tinh-bang,270636882,"Điện Thoại Samsung M14 5G 4GB/64GB - Hàng Chính Hãng",2989000,4990000,2001000,40
TIKI,dien-thoai-may-tinh-bang,273664463,"Điện Thoại Oppo A18 4GB/128GB - Hàng Chính Hãng",3499000,3990000,491000,12
TIKI,dien-thoai-may-tinh-bang,249890023,"Điện Thoại Xiaomi Redmi Note 12 Pro 5G 8GB/256GB - Hàng Chính Hãng",7249000,9490000,2241000,24
TIKI,dien-thoai-may-tinh-bang,274116886,"Điện Thoại Xiaomi Redmi A2+ 3GB/64GB - Hàng Chính Hãng",1989000,2790000,801000,29
TIKI,dien-thoai-may-tinh-bang,197214029,"Apple iPhone 14",16490000,24990000,8500000,34
TIKI,dien-thoai-may-tinh-bang,153581568,"Điện thoại Masstel IZI 55 4G - Hàng chính hãng",659000,659000,0,0
TIKI,dien-thoai-may-tinh-bang,274101262,"Máy Tính Bảng Samsung Galaxy Tab A9 Plus Wifi 4GB/64GB - Hàng Chính Hãng",3990000,5990000,2000000,33
TIKI,dien-thoai-may-tinh-bang,224873580,"Điện thoại Masstel izi 26 - Hàng chính hãng ",600000,600000,0,0
TIKI,dien-thoai-may-tinh-bang,273258830,"Điện thoại Samsung Galaxy A05 (4GB/128GB) - Đã kích hoạt bảo hành điện tử -Hàng chính hãng",2590000,3050000,460000,15
TIKI,dien-thoai-may-tinh-bang,274639765,"Điện thoại OPPO A2M 5G 6GB/128GB , Dimensity 6020 , Màn 90Hz , Rom tiếng việt - Hàng chính hãng",2990000,3690000,700000,19
TIKI,dien-thoai-may-tinh-bang,258330471,"Điện thoại để bàn tân cổ điển phím bấm DT08, Điện thoại nghe gọi được",3500000,3500000,0,0
TIKI,dien-thoai-may-tinh-bang,242434782,"Máy đọc sách New Kindle 11th 2022 (16GB) - Hàng nhập khẩu",2920000,2920000,0,0
TIKI,dien-thoai-may-tinh-bang,270510406,"Điện thoại Vivo Y36 (8GB/128GB) - Hàng Chính Hãng - Camera 50MP - Sạc Nhanh 44W",5190000,5190000,0,0
TIKI,dien-thoai-may-tinh-bang,274544634,"Điện thoại Redmi Note 12R 5G 6/128GB Snapdragon 4 Gen 2, Rom Quốc tế có sẳn Tiếng việt - Hàng nhập khẩu",3050000,3590000,540000,15
TIKI,dien-thoai-may-tinh-bang,204671569,"Điện Thoại Oppo A17k 3GB/64GB - Hàng Chính Hãng",2529000,3290000,761000,23
TIKI,dien-thoai-may-tinh-bang,247823537,"Điện thoại Realme C55 (6GB/128GB) - Hàng chính hãng",3790000,4990000,1200000,24
TIKI,dien-thoai-may-tinh-bang,273366296,"ulefone Armor 24 (TIÊU CHUẨN MIL-STD-810H ,IP69K, chống nước ,chống sốc,pin 22000mah , màn hình6,78 inch, NFC, Ram24GB(12Gb+12Gb),rom 256GB)-hàng chính hãng ",7990000,7990000,0,0
TIKI,dien-thoai-may-tinh-bang,262908601,"Máy tính bảng chắc chắn oukitel RT3 (chống nước,chống va đập,Ram 4Gb,Rom 64 Gb,màn hình 8 inch,pin 5150 mAh)- hÀng chính hãng",4990000,4990000,0,0
TIKI,dien-thoai-may-tinh-bang,274536294,"Máy đọc sách Kindle Paperwhite 5 (16GB) - Hàng chính hãng",4050000,4990000,940000,19
TIKI,dien-thoai-may-tinh-bang,121059239,"Máy Tính Bảng Samsung Galaxy Tab A7 Lite T225 3GB/32GB - Hàng Chính Hãng",3587000,3587000,0,0
TIKI,dien-thoai-may-tinh-bang,270978486,"Điện thoại Samsung Galaxy M14 5G (6GB/128GB) - Đã kích hoạt bảo hành điện tử - Hàng chính hãng",3910000,5690000,1780000,31
TIKI,dien-thoai-may-tinh-bang,271730109,"Điện thoại chắc chắn Ulefone Armor X13, (Ram 12GB(6Gb+6Gb),Rom 64GB,chống nước,chống va đập IP68/IP69K, Android 13,CPU MediaTek Helio G36 Octa Core,Màn hình 6,52 inch, Mạng: 4G, NFC,OTG)-hàng chính hãng",3990000,3990000,0,0
TIKI,dien-thoai-may-tinh-bang,273942001,"Điện thoại Xiaomi Redmi Note 13 (6GB/128GB) - Hàng chính hãng",4090000,4490000,400000,9
TIKI,dien-thoai-may-tinh-bang,271218081,"Máy đọc sách Kindle Oasis Edition 3 (8GB) - Hàng chính hãng",6500000,7690000,1190000,15
TIKI,dien-thoai-may-tinh-bang,273127929,"Điện thoại Xiaomi 13T 12GB-256GB - Hàng Chính Hãng",12990000,12990000,0,0
TIKI,dien-thoai-may-tinh-bang,274392442,"Điện thoại Oppo A38 - Hàng chính hãng",4490000,4490000,0,0
TIKI,dien-thoai-may-tinh-bang,153581522,"Máy đọc sách All new Paperwhite Gen 5 (11th) màn hình 6.8 inch có đèn vàng warmlight",3690000,3800000,110000,3
TIKI,dien-thoai-may-tinh-bang,270832077,"Điện thoại Xiaomi Redmi 12 (4GB-128GB) - Hàng Chính Hãng",3890000,3890000,0,0
TIKI,dien-thoai-may-tinh-bang,257861524,"Điện thoại để bàn tân cổ điển phím quay DT11",3500000,3500000,0,0
TIKI,dien-thoai-may-tinh-bang,191689878,"Điện thoại OPPO CPH2387 - A57 Xanh - Hàng Chính Hãng",4632000,4632000,0,0
TIKI,dien-thoai-may-tinh-bang,262514707,"Điện thoại Xiaomi Redmi Note 12 Pro (8GB/256GB) - Hàng chính hãng",7990000,7990000,0,0
TIKI,nha-cua-doi-song,58206715,"Bản lề tự đóng cửa tự động cho cửa hàng, văn phòng, nhà ở",38900,38900,0,0
TIKI,nha-cua-doi-song,31895999,"Đầu Vòi Lọc Sạch Nước Than Hoạt Tính",19400,19400,0,0
TIKI,nha-cua-doi-song,185654331,"Hộp, Lọ, Hũ Thủy Tinh Nắp Gỗ JIMMEAL 200ml 350ml 500ml 750ml 1000ml 1200ml 1600ml",32000,32000,0,0
TIKI,nha-cua-doi-song,67416013,"CỐC GIỮ NHIỆT ELMICH INOX 304 470ML EL3668",254000,399000,145000,36
TIKI,nha-cua-doi-song,121367420,"Gối ngồi lót mông y tế chống trĩ, đau xương cụt, ê mỏi mông cho dân văn phòng, lái xe, thu ngân, sinh viên...Chính hãng Ema - Hàng nhập khẩu",550000,550000,0,0
TIKI,nha-cua-doi-song,800795,"Bình đựng thức ăn giữ nhiệt 1800ml EL3128",699000,1390000,691000,50
TIKI,nha-cua-doi-song,3677753,"Bình Lọc Nước BRITA Flow Basic Blue - 8.2L (Kèm Maxtra Plus) - Hàng Chính Hãng",2499000,2499000,0,0
TIKI,nha-cua-doi-song,142261128,"Đệm Lót Ghế Ngồi NOOZ Home Goods Gối Lót Ghế Ngồi Bệt Memory Foam Giúp Chống Đau Lưng, Đau Xương Cụt, Đau Thần Kinh Tọa Ruột Đệm Cao Su Non Danh Cho Dân Văn Phòng",339000,450000,111000,25
TIKI,nha-cua-doi-song,7699062,"Chảo Nhôm Chống Dính Lock&Lock Baum Marble 1 Tay Cầm LBU1283C (28cm)",295000,567000,272000,48
TIKI,nha-cua-doi-song,173717336,"Túi Hộp Vải Lưới Đựng Đồ Lót, Tất Vớ Nhiều Ngăn - Khay Xếp Chia Ô Đựng Đồ Để Tủ Quần Áo Tiện Ích",24000,24000,0,0
TIKI,nha-cua-doi-song,106281034,"Bình nước thủy tinh Luminarc Quadro 1.7L -LUQUG2668",154000,205000,51000,25
TIKI,nha-cua-doi-song,155546820,"Hộp nhựa đựng thực phẩm tủ lạnh 2 lớp Homepower ghi chú thời gian bảo quản thông minh kèm rổ thoát nước tiện lợi - Cao cấp",89000,89000,0,0
TIKI,nha-cua-doi-song,187622257,"Bộ 3 Kệ Trang Trí Treo Góc Tường SIB DECOR Hình Cung Tròn",149000,149000,0,0
TIKI,nha-cua-doi-song,53185365,"Túi Ly Giữ Nhiệt Rinfere - Sản Phẩm Handmade Phù Hợp Với Ly Giữ Nhiệt Rinfere, Lock and Lock, Yeti - Free Size",104000,104000,0,0
TIKI,nha-cua-doi-song,149959628,"Cmbo 6 Cuộn Túi Đựng Rác Gia Đình, Bao Đựng Rác Văn Phòng, Trường Học Tiện Lợi Màu Đen Đầy Đủ 3 Size Tiểu Trung Đại - Chính Hãng MINIIN",45000,45000,0,0
TIKI,nha-cua-doi-song,52297710,"Bộ 25 Móc dán tường, dính tường trong suốt Siêu chắc, siêu chịu lực loại 10kg",11968,11968,0,0
TIKI,nha-cua-doi-song,74615464,"Phin pha cà phê nhôm Trung Nguyên( Không Hoa Văn)",30000,30000,0,0
TIKI,nha-cua-doi-song,160909295,"0,5KG - 1KG TÚI ZIP LỤA MỜ và TRONG Túi Zip lock LỤA MỜ có khoá kéo, túi zip đựng quần áo, khoá chắc chắn",65000,65000,0,0
TIKI,nha-cua-doi-song,127693039,"[Thùng 1, 5, 10, 18 Lít] Keo Sơn Chống Thấm Sàn Mái Lộ Thiên TAIKO NITTON (Gốc Acrylic) - Tặng Kèm Vải Kết Cấu Và Chổi Lăn Sơn - Chống Thấm Sàn Mái, Máng Xối, Ban Công Lô Gia, Bể Nước, Bể Cá, Bề Mặt Cát Xi Măng (Hiệu quả hơn khi pha với Xi Măng",249600,320000,70400,22
TIKI,nha-cua-doi-song,141971329,"Túi Đựng Hộp Cơm Grepaco Giữ Nhiệt Nóng Lạnh Dạng Đứng Có Ngăn Phụ Đựng Đồ Thức Ăn Văn Phòng, Du Lịch – Vải Bố Canvas, Kích Thước Size Vừa, Kiểu Giỏ Xách Thời Trang Nam Nữ - Tặng Túi Đựng Muỗng Nĩa - Hàng Chính Hãng",69000,69000,0,0
TIKI,nha-cua-doi-song,11710987,"Combo 10 cuộn keo lụa vặn ren vòi nước, ren ống cao cấp (Cao su non, băng tan) ",33000,38000,5000,13
TIKI,nha-cua-doi-song,11341623,"Hộp 40 viên pin 2A Maxell",122000,130000,8000,6
TIKI,nha-cua-doi-song,198214329,"Combo 2 bộ chuyển đổi 3 chấu thành 2 chấu phích tròn Barwell - Chính hãng, giao màu ngẫu nhiên",32200,35000,2800,8
TIKI,nha-cua-doi-song,181909425,"Nồi 1 Tay Cầm Suit LocknLock CSU1181PIK (18cm) - Màu Pink",491000,945000,454000,48
TIKI,nha-cua-doi-song,105026602,"Chuông báo động, còi báo động dành cho người lớn tuổi, người bệnh ",234060,249000,14940,6
TIKI,nha-cua-doi-song,79971957,"Bộ Chăn Gối Văn Phòng 3 IN 1 Hình Thú Mặc Áo Hà Mã, Bò Vàng Siêu Tiện Lợi- Bò áo xám",219000,219000,0,0
TIKI,nha-cua-doi-song,167030045,"Áo Nệm, Ga bọc Nệm Toppper 2 Mặt Có Khóa Kéo, Kich Thước 1mx2m,1m2x2m, 1m4x2m, 1m6x2m, 1m8x2m",145000,145000,0,0
TIKI,nha-cua-doi-song,116244976,"Túi Đựng Hộp Cơm Grepaco Giữ Nhiệt Nóng Lạnh Đựng Đồ Thức Ăn Văn Phòng, Du Lịch – Vải Bố Canvas, Kích Thước To (Cỡ Lớn), Kiểu Dáng Giỏ Xách Thời Trang Nam Nữ - Tặng Túi Đựng Muỗng Nĩa",149000,149000,0,0
TIKI,nha-cua-doi-song,403497,"Đèn Diệt Côn Trùng Well DS-D6",625000,786000,161000,20
TIKI,nha-cua-doi-song,13619778,"Đồng Hồ Treo Tường P1 (25cm) - Màu ngẫu nhiên",99000,99000,0,0
TIKI,nha-cua-doi-song,113899477,"Đèn học để bàn, đèn đọc sách LED tích điện di động Homepower gập 2 chỗ - 3 chế độ ánh sáng vàng bảo vệ mắt, chống cận Pin 2500mAh",179000,179000,0,0
TIKI,nha-cua-doi-song,38666598,"Túi Đựng Ly Giữ Nhiệt Lớn 900ml Nhiều Mẫu",40000,40000,0,0
TIKI,nha-cua-doi-song,91546481,"️ Kệ nhà bếp gấp gọn đa năng TI-KE001 - Tháo ra dùng ngay được",401000,433900,32900,8
TIKI,nha-cua-doi-song,162406191,"Giấy lau mặt dùng 1 lần khăn mặt cotton khô cuộn giấy tẩy trang lau khô/lau ướt",14900,28500,13600,48
TIKI,nha-cua-doi-song,149242704,"Combo 20 Móc treo ảnh gắn tường, móc treo ảnh cưới ôm sát tường decor rất đẹp, không cần khoan đục - Hàng chính hãng",33250,35000,1750,5
TIKI,nha-cua-doi-song,84953200,"Kệ đựng dụng cụ rửa chén dán tường Hobby Home Decor KRC6 inox 304 có miếng dán",173000,279000,106000,38
TIKI,nha-cua-doi-song,198508670,"Đèn LED Mini Móc Khóa - Đèn Pin COB - Đèn Pin Dã Ngoại - Sạc USB Tiện Dụng- Kiêm hộp quẹt",48510,49000,490,1
TIKI,nha-cua-doi-song,51406882,"Bộ 10 miếng xốp dán tường giả gạch 3D 70x77cm",104000,104000,0,0
TIKI,nha-cua-doi-song,274121804,"Ruột Gối Ôm Lông Vũ Thuần Việt - Sợi Lông Vũ Nhân Tạo Microfiber Êm Ái Mềm Mịn - KT 20x100cm",340000,550000,210000,38
TIKI,nha-cua-doi-song,140746932,"Bàn Gấp Treo Tường Đầy Đủ Phụ Kiện và Hướng Dẫn Đi Kèm",165000,165000,0,0
TIKI,nha-cua-doi-song,140791193,"Bóng đèn LED Bright PHILIPS E27 - Thay thế hoàn hảo cho bóng đèn Compact - Hàng Chính Hãng",56000,90000,34000,38
TIKI,nha-cua-doi-song,72615961,"Dây đèn led đom đóm trang trí decor phòng, du lịch cắm trại, fairy light cao cấp (tùy chọn loại nguồn cấp, chiều dài dây và màu sắc)",14000,23000,9000,39
TIKI,nha-cua-doi-song,72041730,"Bộ Dao 6 Món Lock&Lock (4 Dao, 1 Kéo, 1 Hộp Đựng Dao) CKK802",598000,996000,398000,40
TIKI,nha-cua-doi-song,47108061,"Bộ 100 túi bóng hút chân không 1 mặt nhám - có nhiều size túi kích thước khác nhau",65000,65000,0,0
TIKI,nha-cua-doi-song,32072094,"Dầu neem hữu cơ DOCNEEM phòng trị sâu bệnh hoa hồng, phong lan, cây cảnh, dầu neem oil nguyên chất ép lạnh 100ml",150000,150000,0,0
TIKI,nha-cua-doi-song,16869707,"Kính Bịt Mắt Ngủ 3D (Đen)",29900,39000,9100,23
TIKI,nha-cua-doi-song,272298582,"Bóng đèn bắt muỗi ( dùng để thay thế bóng khi bóng chính bị hỏng)",68000,68000,0,0
TIKI,nha-cua-doi-song,192975755,"Kệ Gỗ Trang Trí Treo Tường Không Cần Khoan - Tặng Kèm Móc Treo Inox Và Phụ Kiện",95000,110000,15000,14
TIKI,nha-cua-doi-song,146495143,"Hộp vải đựng đồ BA03 đa năng, thùng đựng quần áo có nắp rời đậy chắc chắn an toàn dododios",129000,129000,0,0
TIKI,nha-cua-doi-song,49100347,"Cây massage đa chức năng: gãi lưng , đấm lưng , massage đầu, tay, chân, vai tặng kèm móc treo siêu dính (màu ngẫu nhiên)",21900,21900,0,0
TIKI,nha-cua-doi-song,7583254,"Vòi xịt vệ sinh inox - Vòi xịt bồn cầu inox SUS 304 cao cấp",59800,59800,0,0
TIKI,nha-cua-doi-song,184122885,"Khăn tắm lau mặt nén bằng cotton dùng 1 lần hoặc tái sử dụng được cho du lịch khách sạn",38000,40000,2000,5
TIKI,nha-cua-doi-song,53063443,"Ga giường chống thẩm trơn kích thước 1.6mx2m - Màu giao ngẫu nhiên",49450,49450,0,0
TIKI,nha-cua-doi-song,145767958,"Set 3 hộp tròn đựng thực phẩm tủ lạnh, bảo quản thực phẩm có lót đáy ráo nước, van thoát khí PET Xuất Khẩu EU",299000,299000,0,0
TIKI,nha-cua-doi-song,55727445,"Nắp đậy ly cốc bằng silicon nhiều mẫu xinh xắn",10000,10000,0,0
TIKI,nha-cua-doi-song,718885,"Thùng rác nhựa Fitis Compact PPS1-904 - xanh xám - 10L",232000,290000,58000,20
TIKI,nha-cua-doi-song,197826403,"Bình Đựng Nước 2L Có Vạch Báo Giờ Uống Nước",65000,65000,0,0
TIKI,nha-cua-doi-song,10788516,"Khuôn làm kem 6 que  (Màu ngẫu nhiên)",32999,32999,0,0
TIKI,nha-cua-doi-song,135442243,"Bộ Lục Giác Deli Đầu Bằng Chữ L Cao Cấp - Kiểu Dáng Nhỏ Gọn Giúp Người Dùng Cầm Nắm, Thao Tác Dễ Dàng DL230008 DL230009",24000,46800,22800,49
TIKI,nha-cua-doi-song,149376396,"Túi peva SmileBox size lớn bọc nhiều bộ quần áo treo tủ chống thấm, chống bụi, có khóa kéo đôi tiện lợi nhiều size ngắn dài 90cm 110cm- Hàng chính hãng",105000,105000,0,0
TIKI,nha-cua-doi-song,144590196," Kéo Nhật Nhà Bếp Cắt Gà Cắt Đồ Đa Năng Jodily - Hàng Chính Hãng ",105000,105000,0,0
TIKI,nha-cua-doi-song,4355547,"Bộ lọc nước thô đầu nguồn 3 cấp lọc 10inch Yamato YMTH10-3TX",334000,385000,51000,13
TIKI,nha-cua-doi-song,173701257,"Khăn lau đa năng bếp, bát đĩa, cốc chén thấm nước chống dính dầu mỡ hai mặt",8000,8000,0,0
TIKI,nha-cua-doi-song,71518280,"Đèn Led Thanh 8 Bóng Để Bàn Đầu Gắn Ngõ USB Dự Phòng 4W (0.5W/led) Siêu Sáng",7000,14000,7000,50
TIKI,nha-cua-doi-song,162424714,"Khay Giấy Bạc, Khay Bạc Đựng Thực Phẩm Lót Nồi Chiên Không Dầu Chịu Nhiệt Cao - Hàng Loại 1 - Chính Hãng MINIIN",32000,65000,33000,51
TIKI,nha-cua-doi-song,73887002,"Đèn Ngủ Cảm Ứng Cảm Biến Dán Tường Sạc Pin USB Đời Mới",79000,79000,0,0
TIKI,nha-cua-doi-song,16382292,"Bộ Quần Áo Đi Mưa - 3XL",115000,115000,0,0
TIKI,nha-cua-doi-song,26060194,"GĂNG TAY RỬA BÁT SILICON SIÊU DAI CỰC BỀN",9989,9989,0,0
TIKI,nha-cua-doi-song,25088140,"2 cuộn 1 lốc Bao rác cực đại",25000,25000,0,0
TIKI,nha-cua-doi-song,66903798,"Remote Điều Khiển Từ Xa Cho Quạt SenkoTR1428, TR1628, DR1608 – Hàng Chính Hãng",75000,75000,0,0
TIKI,nha-cua-doi-song,72016703,"Bếp Nướng Than Hoa Phiên Bản Cải Tiến Loại Dài 2023 Chống Cháy Thực Phẩm, An Toàn Sức Khỏe, Không Cần Quạt, Bếp Nướng Không Khói, Bếp Nướng Ngoài Trời, Bếp Nướng Than Hoa Vuông",209000,209000,0,0
TIKI,nha-cua-doi-song,167954128,"BỘ LAU NHÀ TRÒN XOAY 360 ĐỘ MẪU MỚI",183000,350000,167000,48
TIKI,nha-cua-doi-song,99099494,"Bóng Đèn LED 38W COMET Bulb Fighter CB02F0386 Ánh Sáng Trắng - Hàng Chính Hãng",164000,164000,0,0
TIKI,nha-cua-doi-song,143001862,"Ổ cắm điện đa năng shoptida có sạc nhanh PD 20W cổng USB+TYPEC, có 4-6 lỗ cắm tải 2500W, 1 đổi 1 15 tháng",174000,250000,76000,30
TIKI,nha-cua-doi-song,26334551,"Mền dù cao cấp  - mỏng nhẹ - thoáng mát - Cho giấc ngủ dễ chịu [chăn ga gối đệm",160000,180000,20000,11
TIKI,nha-cua-doi-song,58679667,"Chuỗi dây đèn led gương trang điểm 10 bóng 5 màu điều chỉnh",199900,199900,0,0
TIKI,nha-cua-doi-song,58014281,"Giá treo móc phơi, kẹp quần áo cho gọn loại lớn Inox 304 dán tường gạch men - kèm keo dán sealant fix - HOBBY GPM3",123000,199000,76000,38
TIKI,nha-cua-doi-song,75836319,"Phân bón hữu cơ Kích Hoa cho Hoa hồng, Hoa lan, cây cảnh, cây kiểng trong nhà và ngoài trời, giàu lân giúp phân nhánh nụ, hoa, giảm chồi điếc, dung tích 1 lít, chính hãng DOCNEEM",119000,119000,0,0
TIKI,nha-cua-doi-song,50241058,"Kệ sách gỗ để bàn - Tủ,kệ sách mini - Giao màu sắc ngẫu nhiên ",47500,50000,2500,5
TIKI,nha-cua-doi-song,93760107,"Dây đèn trang trí ngoài trời chống nước dùng cho quán cà phê, trà chanh, trà sữa đuôi đèn chống nước -thương hiệu Kiotool",103000,103000,0,0
TIKI,nha-sach-tiki,191655862,"[Combo Manga] Diệt Slime Suốt 300 Năm, Tôi Levelmax Lúc Nào Chẳng Hay (Tập 8 + 9)",148000,184000,36000,20
TIKI,nha-sach-tiki,186229224,"Bộ Sách Khởi Nghiệp Kinh Doanh Online - Marketing và Bán Hàng Hiệu Quả Với Thương Mại Điện Tử Tại Việt Nam",277000,378000,101000,27
TIKI,nha-sach-tiki,123236564,"Combo 6 cuốn: Miếng dán Thông minh cho bé (Phát triển EQ - IQ) - My First Sticker Book",131040,252000,120960,48
TIKI,nha-sach-tiki,185232575,"Tiếng Anh 3 Extra and Friends Activity book (Sách bài tập)",65000,65000,0,0
TIKI,nha-sach-tiki,57211757,"Utopia - Địa đàng trần gian (Tái Bản 2020)",43100,60000,16900,0
TIKI,nha-sach-tiki,160585830,"Tôi Thích Tin Tức Tố Của Cậu - Tập 2 (Tặng Kèm Bookmark)",146000,169000,23000,14
TIKI,nha-sach-tiki,195801705,"Một Nửa Chiếc Va Li",116000,130000,14000,11
TIKI,nha-sach-tiki,2903309,"Khéo Ăn Nói Sẽ Có Được Thiên Hạ ( Tái Bản )",104000,130000,26000,20
TIKI,nha-sach-tiki,92996206,"Kinh Yoga Của Patanjali",60700,85000,24300,29
TIKI,nha-sach-tiki,149534865,"Bảy Thanh Hung Giản 2 - Hổ Phách Đỏ Son - Gió Cuốn Cát Bụi",171000,230000,59000,26
TIKI,nha-sach-tiki,152743069,"FPT Bí Lục - Khám Phá Văn Hoá Doanh Nghiệp Tại FPT",138000,199000,61000,31
TIKI,nha-sach-tiki,464132,"Truyện Kiều",24000,35000,11000,31
TIKI,nha-sach-tiki,56757447,"Tiền Đẻ Ra Tiền: Đầu Tư Tài Chính Thông Minh",95100,139000,43900,32
TIKI,nha-sach-tiki,188128048,"Ikigami - Tập 04",32100,45000,12900,29
TIKI,nha-sach-tiki,21146016,"Tinh Mắt Bắt Hình – Nông Trại",41500,60000,18500,31
TIKI,nha-sach-tiki,15256884,"Đầu Tư Tài Chính (Investments)",610000,659000,49000,7
TIKI,nha-sach-tiki,14655498,"Bút bi TriTouch ngòi 0.7mm (hộp 12 cái)",54000,54000,0,0
TIKI,nha-sach-tiki,101325467,"Bộ Truyện Tranh Gieo Hạt Cùng Vĩ Nhân (Tập 1-10)",270000,270000,0,0
TIKI,nha-sach-tiki,184419723,"Sapiens Lược Sử Loài Người (Tái Bản 2022)",185400,299000,113600,38
TIKI,nha-sach-tiki,48629547,"Tiền Không Mua Được Gì (What money can't buy?) - Michael Sandel Tác giả Phải Trái Đúng Sai",78000,125000,47000,38
TIKI,nha-sach-tiki,197634256,"Black Jack - Tập 14 (Bìa Cứng)",134000,135000,1000,1
TIKI,nha-sach-tiki,198016658,"Birdmen - Tập 8",29000,30000,1000,3
TIKI,nha-sach-tiki,152743081,"Bàn Tay Ánh Sáng",193000,269000,76000,28
TIKI,nha-sach-tiki,55119185,"Sách Nghĩ Giàu và Làm Giàu (Bìa Cứng) (Tái Bản 2020)",117000,168000,51000,30
TIKI,nha-sach-tiki,145977548,"Kiếp Người - Vĩnh Cửu Và Vô Thường ",56100,79000,22900,29
TIKI,nha-sach-tiki,49002497,"Tâm Bệnh Học",82900,145000,62100,43
TIKI,nha-sach-tiki,151597556,"American Jetstream Pre-Intermediate A Student's book & Workbook ( không kèm CD)",207000,207000,0,0
TIKI,nha-sach-tiki,181122317,"Chân Trần Chí Thép (Tái Bản 2022)",114000,168000,54000,32
TIKI,nha-sach-tiki,167149888,"Khám Phá Đứa Trẻ Bên Trong Bạn",98000,139000,41000,29
TIKI,nha-sach-tiki,185500892,"i-Learn Smart Start 5 Workbook Special Edition",81000,81000,0,0
TIKI,nha-sach-tiki,44976191,"Economix - Các Nền Kinh Tế Vận Hành (Và Không Vận Hành) Thế Nào Và Tại Sao?",114000,152000,38000,25
TIKI,nha-sach-tiki,194959695,"Thế Giới Mênh Mông Buồn Vui Cất Vào Lòng",64700,90000,25300,28
TIKI,nha-sach-tiki,100947280,"Những Phương Thức Phục Hồi Sức Khỏe Theo Tự Nhiên (Tái Bản)",70800,99000,28200,28
TIKI,nha-sach-tiki,191919683,"Tro tàn của Angela",171000,220000,49000,22
TIKI,nha-sach-tiki,48362502,"Sang Chấn Tâm Lý - Hiểu Để Chữa Lành",226000,350000,124000,35
TIKI,nha-sach-tiki,7958959,"5 Điểm Chết Trong Teamwork",79300,128000,48700,38
TIKI,nha-sach-tiki,75601401,"Nghệ Thuật Bán Hàng Bằng Câu Chuyện",135360,188000,52640,28
TIKI,nha-sach-tiki,113656189,"Giáo Trình Lịch Sử Đảng Cộng Sản Việt Nam (Dành Cho Bậc Đại Học Hệ Không Chuyên Lý Luận Chính Trị) - Bộ mới năm 2021",84000,84000,0,0
TIKI,nha-sach-tiki,182736915,"Combo 3 Cuốn Sách: Cuộc Hành Hương Nội Tại - Chính Trực - Giác Ngộ",325100,467000,141900,30
TIKI,nha-sach-tiki,71898415,"Cơ Thể Ta Đã Hai Triệu Năm - Giải Mã Các Căn Bệnh Thời Hiện Đại",54800,79000,24200,31
TIKI,dien-thoai-may-tinh-bang,274179544,"Điện thoại Realme C51 (6GB/256GB) - Hàng Chính Hãng",3390000,4190000,800000,19
TIKI,dien-thoai-may-tinh-bang,248704404,"Điện Thoại Samsung Galaxy A14 (4GB/128GB) - Hàng Chính Hãng",3672000,3672000,0,0
TIKI,dien-thoai-may-tinh-bang,270471106,"Điện Thoại Nokia 105 4G Pro TA-1538 - Hàng Chính Hãng",630000,680000,50000,7
TIKI,dien-thoai-may-tinh-bang,271966786,"iPhone 15",19490000,21490000,2000000,9
TIKI,dien-thoai-may-tinh-bang,212261734,"Điện thoại Masstel Play 10 4G Thiết kế hầm hố,Khung viền kim loại - Hàng chính hãng",558000,799000,241000,30
TIKI,dien-thoai-may-tinh-bang,273359059,"Điện Thoại Chắc Chắn OUKITEL WP23 PRO ( Ram 16Gb(8GB+8Gb),Rom 128GB ,Android13, Pin 10600mAh,Màn hình 6.52 "HD + ,13MP camera Sau,chống nước,chống va đập)-hàng chính hãng",4990000,4990000,0,0
TIKI,dien-thoai-may-tinh-bang,65091422,"Điện thoại Oukitel WP6 (Chống va đập,chống nước,Ram 6Gb,Rom 128Gb,pin 8.000mAh) hàng chính hãng",6990000,6990000,0,0
TIKI,dien-thoai-may-tinh-bang,274059475,"Điện Thoại Samsung Galaxy S24 Ultra (12GB/256GB) - Hàng Chính Hãng",33990000,33990000,0,0
TIKI,dien-thoai-may-tinh-bang,274166857,"Điện thoại Samsung Galaxy S23 FE (8GB/128GB) - Hàng chính hãng",14890000,14890000,0,0
TIKI,dien-thoai-may-tinh-bang,274542883,"Điện Thoại Samsung A35 5G 8GB/128GB - Hàng Chính Hãng",7369000,8290000,921000,11
TIKI,dien-thoai-may-tinh-bang,263073555,"Điện thoại Tecno CAMON 20 8GB/256GB - Camera 64MP + 32MP | 5000 mAh | Sạc nhanh 33W | 6.7'' FHD AMOLED - BH 13 Tháng - Hàng Chính Hãng",4990000,4990000,0,0
TIKI,dien-thoai-may-tinh-bang,261946899,"Điện Thoại Samsung Galaxy A14 (6GB/128GB) - Hàng Chính Hãng",3999000,4990000,991000,20
TIKI,dien-thoai-may-tinh-bang,273774937,"Điện thoại Samsung Galaxy A15 (8GB/128GB) - Hàng chính hãng - Đã kích hoạt bảo hành điện tử",4455000,4990000,535000,11
TIKI,dien-thoai-may-tinh-bang,271494404,"Điện thoại Tecno POVA 5 (8GB+8GB/128GB) RAM mở rộng 16GB | Pin 6000 mAh | Màn 120Hz - Sạc nhanh 45W - Hàng Chính Hãng",3799000,4490000,691000,15
TIKI,dien-thoai-may-tinh-bang,273718967,"Điện Thoại Samsung A15 8GB/128GB - Hàng Chính Hãng",4349000,4990000,641000,13
TIKI,dien-thoai-may-tinh-bang,271118390,"Điện thoại OPPO Reno10 5G (8GB/256GB) - Hàng Chính Hãng",9190000,10990000,1800000,16
TIKI,dien-thoai-may-tinh-bang,273373436,"Điện thoại Xiaomi Redmi 13C (6GB/128GB) - Hàng chính hãng - Bảo hành 18 tháng",3028000,3490000,462000,13
TIKI,dien-thoai-may-tinh-bang,274375122,"Điện thoại Xiaomi Redmi Note 13 Pro 4G (8GB/128GB) - Hàng chính hãng",6489000,7290000,801000,11
TIKI,dien-thoai-may-tinh-bang,273958512,"Điện thoại Xiaomi Redmi Note 13 (6GB/128GB) - Hàng chính hãng",4890000,4890000,0,0
TIKI,dien-thoai-may-tinh-bang,248799307,"Điện thoại Xiaomi 13 Lite (8GB/256GB) - Hàng chính hãng",11490000,11490000,0,0
TIKI,dien-thoai-may-tinh-bang,274164078,"Máy tính bảng Samsung Galaxy Tab A9 WIFI 4GB-64GB- Hàng chính hãng",3210000,3990000,780000,20
TIKI,dien-thoai-may-tinh-bang,209927605,"Combo máy đọc sách Kindle 2022 (11th) tặng kèm bao da ( Cover ) - Hàng nhập khẩu",3100000,3100000,0,0
TIKI,dien-thoai-may-tinh-bang,273430216,"Điện thoại Ulefone Armor 13 (pin khủng,pin 13.200mAh, Ram 8Gb,Rom 256Gb,chống sốc,chống va đập,nội soi,tia hồng ngoại,tia lade,loa to,học online)- hàng chính hãng",7990000,7990000,0,0
TIKI,dien-thoai-may-tinh-bang,274498288,"Điện Thoại Samsung Galaxy A35 5G (8GB/128GB)- Hàng Chính Hãng",7890000,8290000,400000,5
TIKI,dien-thoai-may-tinh-bang,271982547,"Điện thoại Oukitel  WP12 Pro (chống nước,chống va đập,RAM 8GB(Ram 4GB+ 4Gb),Rom 64 Gb,8 nhân)- hÀng chính hãng",3990000,3990000,0,0
TIKI,dien-thoai-may-tinh-bang,274316885,"Điện Thoại Xiaomi POCO X6 5G 8GB-256GB - Hàng chính hãng",7510000,9990000,2480000,25
TIKI,dien-thoai-may-tinh-bang,273897523,"Điện thoại Tecno SPARK 20 (8+8)GB/128GB - Helio G85 | 5000 mAh | Sạc nhanh 18W | Hàng Chính Hãng",3390000,3490000,100000,3
TIKI,dien-thoai-may-tinh-bang,257682739,"Điện thoại Samsung Galaxy A04 (3GB/32GB) - Đã kích hoạt bảo hành điện tử -  Hàng chính hãng",1999000,2990000,991000,33
TIKI,dien-thoai-may-tinh-bang,272909668,"[Mới] Điện thoại vivo V29e 5G (8GB/256GB) - Hàng Chính Hãng - Camera Selfie 50 MP - Vòng Sáng Aura 2.0 - Màn hình AMOLED 6.67",8690000,8990000,300000,3
TIKI,dien-thoai-may-tinh-bang,271128271,"Điện Thoại Oppo A58 6GB/128GB - Hàng Chính Hãng",4349000,4990000,641000,13
TIKI,dien-thoai-may-tinh-bang,273378164,"Điện thoại Xiaomi Redmi 13C (6GB/128GB) - Hàng chính hãng - Đã kích hoạt bảo hành điện tử",2960100,3490000,529900,15
TIKI,dien-thoai-may-tinh-bang,272348047,"Điện Thoại Samsung A05s 4GB/128GB - Hàng Chính Hãng",3239000,3990000,751000,19
TIKI,dien-thoai-may-tinh-bang,263274580,"Điện thoại Samsung Galaxy M14 5G (4GB/64GB) - Hàng chính hãng - Đã kích hoạt bảo hành điện tử",2743000,3990000,1247000,31
TIKI,dien-thoai-may-tinh-bang,25949745,"Máy Đọc Sách Kindle Oasis (10th Gen) 2019- 8GB - Hàng Chính Hãng",6043100,6790000,746900,11
TIKI,dien-thoai-may-tinh-bang,273252926,"Điện Thoại Oppo A18 (4GB/128GB) - Hàng Chính Hãng",3390000,3990000,600000,15
TIKI,dien-thoai-may-tinh-bang,273553649,"Điện thoại Oppo A18 - Hàng chính hãng",3499000,3690000,191000,5
TIKI,dien-thoai-may-tinh-bang,272222033,"Máy đọc sách Boox Palma - Hàng Chính Hãng",7200000,8590000,1390000,16
TIKI,dien-thoai-may-tinh-bang,52002453,"Cisco Unified IP Phone 7962G - Hàng chính hãng",4900000,4900000,0,0
TIKI,dien-thoai-may-tinh-bang,217640502,"Máy đọc sách Kindle Scribe - Hàng chính hãng",12590000,12590000,0,0
TIKI,dien-thoai-may-tinh-bang,52480318,"Điện thoại bàn cổ điển DT115",2500000,2500000,0,0
TIKI,nha-cua-doi-song,188769126,"Chuông cửa không dây thông minh CACAZI A10, chống nước khoảng cách sử dụng trong 300M, 60 loại nhạc chuông, 110 DB",185000,185000,0,0
TIKI,nha-cua-doi-song,185004559,"Ly Thủy Tinh Hoa Văn Navivu Vintage Glass 300 - 350ml",47000,47000,0,0
TIKI,nha-cua-doi-song,30008695,"Vĩ 5 viên pin Maxell dòng cao cấp CR2032",20050,20050,0,0
TIKI,nha-cua-doi-song,42718737," Đèn Led Trang Trí Bóng Tròn Dài 6M - 40  Bóng Trang Trí Noel Lễ Tết",80000,80000,0,0
TIKI,nha-cua-doi-song,696521,"Ổ Cắm Điện 4 Lỗ 3 Chấu 2 cổng USB Philips SPN6248WB/74 (2500W)",416000,469000,53000,11
TIKI,nha-cua-doi-song,153263106,"Kéo Cắt Gà  Nhật Bản Làm Bếp Đa Năng Cắt Vải Cắt Giấy SK5 Siêu Sắc - Hàng Loại 1- Chính Hãng",58000,65000,7000,11
TIKI,nha-cua-doi-song,155718559,"Bình xịt dầu ăn, xịt gia vị dạng phun sương chai thủy tinh 100ml - hàng chính hãng THAFA",35000,39000,4000,10
TIKI,nha-cua-doi-song,174489182,"Túi đựng rác phân hủy sinh học Sunhouse KS-GA6578BS",46000,70000,24000,34
TIKI,nha-cua-doi-song,4216861,"Kính bảo hộ 3M SF401AF chống đọng sương",75000,75000,0,0
TIKI,nha-cua-doi-song,36935892,"Combo 10 khăn lau bếp đa năng - KL29 (Giao ngẫu nhiên mẫu)",10000,10998,998,9
TIKI,nha-cua-doi-song,42264813,"Kẹp phơi đồ Inox -Kẹp phơi quần áo đồ chống gió",61800,61800,0,0
TIKI,nha-cua-doi-song,77315431,"[Chọn màu] Bộ 20 miếng bọc chân ghế tròn, chân bàn bằng silicon dày, bọc chân bàn chống trượt, chống xước cho sàn gỗ GD365-BCGheTron-20",19998,19998,0,0
TIKI,nha-cua-doi-song,26053920,"Vòi Nước Inox 304 Loại Tốt",34293,34293,0,0
TIKI,nha-cua-doi-song,38306937,"Vỉ 5 Viên Pin CR1616 Lithium 3V Panasonic - Hàng Chính Hãng",86400,89000,2600,3
TIKI,nha-cua-doi-song,32153958,"Khóa Số ABUS 145/20 (20mm) - Nhiều Màu",129000,139000,10000,7
TIKI,nha-cua-doi-song,7078973,"Kìm Cắt Chân Linh Kiện PLT 170 125mm",17000,17000,0,0
TIKI,nha-cua-doi-song,70840199,"Vá Canh Bằng Gỗ Nhãn Tự Nhiên - VAGOO - Làm Thủ Công Chống Thấm, Chống Ẩm Mốc, An Toàn Cho Sức Khoẻ",99000,99000,0,0
TIKI,nha-cua-doi-song,12461025,"Nước cắm hoa công nghệ nano đồng Fresh Flowers AHT 430ml - giúp hoa lâu tàn, không thối nước",44000,55000,11000,20
TIKI,nha-cua-doi-song,17998301,"Túi đựng đồ lót nhiều ngăn có móc treo",32600,32600,0,0
TIKI,nha-cua-doi-song,139161475," Muỗng, Muôi Múc Canh, Vá múc canh Inox 304 Cao Cấp, Sang Trọng Cho Bữa Cơm",45000,45000,0,0
TIKI,nha-cua-doi-song,146288304,"Giá để/ Chân để/ Giá đỡ/ Chân đỡ đàn Guitar cao cấp - Kzm Kurtzman J2 - Đa năng, dành cho tất cả loại đàn Guitar - Màu đen - Hàng chính hãng",168000,168000,0,0
TIKI,nha-cua-doi-song,126244017,"Ghế Học Sinh Tiểu Học Chống Gù Thông Minh Có Gác Chân BHS288 Ghế Ngồi Bàn Học Cho Bé Tuỳ Chỉnh Độ Cao - Hàng Chính Hãng",1035000,1265000,230000,18
TIKI,nha-cua-doi-song,161455577,"Đui đèn cảm biến chuyển động",42000,42000,0,0
TIKI,nha-cua-doi-song,57521842,"Bàn Học Bàn Làm Việc Kết Hợp Kệ Sách Thương Hiệu IGEA",569000,620000,51000,8
TIKI,nha-cua-doi-song,152446716,"Cây Lài Trà - cây cảnh vườn + Tặng phân bón cho cây mau lớn",25000,30000,5000,17
TIKI,nha-cua-doi-song,52609001,"Đèn Pin Mini Cầm Tay Siêu Sáng Loại Đèn Nhỏ 3W Police Dùng Pin AA",31000,55000,24000,44
TIKI,nha-cua-doi-song,207557574,"Bàn học gấp gọn ngồi bệt, bàn chân nhựa cứng 40x60cm mặt gỗ MDF loại đẹp ( giao màu ngẫu nhiên )",60000,77000,17000,22
TIKI,nha-cua-doi-song,69927147,"Túi Đựng Hộp Cơm Giữ Nhiệt Đa Lớp Nhiều Hoa Văn - Xanh Denim",23896,23896,0,0
TIKI,nha-cua-doi-song,93062863,"Ô dù tự động thông minh cao cấp toàn Fully Automatic Safe Umbrella, cơ chế giữ nước như dù ngược, khung nan chắc chắn chống gió bão cấp 6, vải siêu chống nước phủ Nano chống tia UV",259000,259000,0,0
TIKI,nha-cua-doi-song,3677777,"Bình Lọc Nước BRITA Active Pink - 600ml (Kèm Microdisc)",549000,849000,300000,35
TIKI,nha-cua-doi-song,58536862,"Cặp Vỏ Gối Lụa Cao cấp A - 50x70cm hoặc 60x80cm - mềm mịn mát lạnh",165000,200000,35000,18
TIKI,nha-cua-doi-song,58678597,"Hộp Cơm Điện Lock&Lock EJR226IVY (2 Lít)",1010000,1942000,932000,48
TIKI,nha-cua-doi-song,73758944,"Kệ Đa Năng Để Lò Vi Sóng INOX Trắng Cao Cấp Chống Han Gỉ Kệ Để Đồ Nặng Siêu Gọn Cho Nhà Bếp VANDO",599000,856000,257000,30
TIKI,nha-cua-doi-song,143322314,"Ron chặn khe hở 90cm đa năng, Nẹp dán chân cửa chống côn trùng, phù hợp mọi loại cửa tiện dụng-GD534-Ron90",29000,29000,0,0
TIKI,nha-cua-doi-song,90072128,"Kệ Giày Dép 7 Tầng Rộng 80cm Gỗ Tự Nhiên 100%- TN",745000,980000,235000,24
TIKI,nha-cua-doi-song,53521887,"Giấy lọc cà phê Hario 40 cái (V60-VCF-02-40M)",49000,62000,13000,21
TIKI,nha-cua-doi-song,167937668,"Aó mưa măng tô,Áo mưa có dây kéo ,vải dù cao cấp chống thấm nước cực tốt ,bảo vệ cơ thể ấm áp,cho nam và nữ",151050,159000,7950,5
TIKI,nha-cua-doi-song,52354974,"Combo 9 Ván Sàn Gỗ Tự Nhiên Màu Nâu Vàng, Vỉ Gỗ Lót Sàn Ban Công, Sân Vườn, Hồ Bơi, Phòng Spa, Siêu Bền, Chịu Nước Tốt, Chống Trơn Trượt, Tiêu Chuẩn Xuất Khẩu",249000,279000,30000,11
TIKI,nha-cua-doi-song,82877146,"Đèn Bàn Học LED Chống Cận GHINER GN-1902 (Pin 4500mAh)",250000,320000,70000,22
TIKI,nha-cua-doi-song,180001622,"Bộ 2 Ly Thuỷ Tinh Cao Luminarc Salto Frost Lime 350ml - LUSAQ3177",139000,180000,41000,23
TIKI,nha-sach-tiki,68456842,"Bài Tập Tiếng Anh 8 - Không Đáp Án",27100,40000,12900,32
TIKI,nha-sach-tiki,195190269,"Combo Anime Comics: One Piece Film Strong World (2 Cuốn)",153000,154000,1000,1
TIKI,nha-sach-tiki,138934620,"Red Nile - Tiểu Sử Của Dòng Sông Vĩ Đại Nhất Thế Giới",243400,399000,155600,39
TIKI,nha-sach-tiki,66698344,"Sách Bài Học Diệu Kỳ Từ Chiếc Xe Rác (Khổ Nhỏ) (Tái Bản 2020)",61100,88000,26900,31
TIKI,nha-sach-tiki,171055469,"TikTok Tất Tần Tật",113000,158000,45000,28
TIKI,nha-sach-tiki,38265901,"Điều Quan Trọng Nhất – The Most Important Thing",299000,299000,0,0
TIKI,nha-sach-tiki,67060012,"Phát Triển Trí Tuệ Cảm Xúc- Cảm Xúc Của Con Màu Gì?",37100,50000,12900,26
TIKI,nha-sach-tiki,138504809,"EQ - Đừng Để Cảm Xúc Hạ Gục Bản Thân",115000,159000,44000,28
TIKI,nha-sach-tiki,159259322,"Nhớ Hà Nội, Thương Sài Gòn",102000,129000,27000,21
TIKI,nha-sach-tiki,58732189,"Liệu Pháp Tâm Lý: Ứng Dụng Màu Sắc Thay Đổi Cuộc Sống",113000,159000,46000,29
TIKI,nha-sach-tiki,190708149,"Chitose Trong Chai Ramune – Tập 1 - Bản Phổ Thông - [Tặng Bookmark Bế Hình Có Chân Đế]",105000,105000,0,0
TIKI,nha-sach-tiki,187827433,"Sau Tang Lễ",82900,145000,62100,43
TIKI,nha-sach-tiki,176824199,"Thần Số Học - Làm Chủ Cuộc Đời",98500,138000,39500,29
TIKI,nha-sach-tiki,172206434,"Huyền Thuật Và Các Đạo Sĩ Tây Tạng (Tái Bản)",75100,108000,32900,30
TIKI,nha-sach-tiki,51845986,"Chinh Phục Luyện Thi Vào 10 Môn Ngữ Văn Theo Chủ Đề",105000,159000,54000,34
TIKI,nha-sach-tiki,59478514,"Combo 2 Cuốn: Osho Đàn Ông + Osho Phụ Nữ",165000,228000,63000,28
TIKI,nha-sach-tiki,1534613,"Giáo Trình Chuẩn HSK 5 Bài Học (Tập 1)",209000,278000,69000,25
TIKI,nha-sach-tiki,143513113,"Con Yêu Bố Chừng Nào",59000,79000,20000,25
TIKI,nha-sach-tiki,8886001,"Giết Con Chim Nhại (Tái Bản)",93100,120000,26900,22
TIKI,nha-sach-tiki,7369223,"Cho Tôi Xin Một Vé Đi Tuổi Thơ",61000,90000,29000,32
TIKI,nha-sach-tiki,11368983,"Combo Giáo Trình Chuẩn HSK 2 - Bài Học (Kèm 1 MP3) và Giáo Trình HSK 2 - Sách Bài Tập (Kèm MP3) ( Tặng Kèm Viết )",308800,386000,77200,20
TIKI,nha-sach-tiki,110112108,"Phương Pháp Đầu Tư Warren Buffett",110000,169000,59000,35
TIKI,nha-sach-tiki,193895769,"Cao Thủ "Đổi Đen Thay Trắng" - Tập 6 (Tiểu thuyết)",121500,159000,37500,24
TIKI,nha-sach-tiki,192125793,"Harry Potter và tên tù nhân ngục Azkaban (Tái Bản 2022)",132000,205000,73000,36
TIKI,nha-sach-tiki,197656790,"Kaguya-Sama: Cuộc Chiến Tỏ Tình - Tập 1 - Tặng Kèm Lót Ly",38800,40000,1200,3
TIKI,nha-sach-tiki,165030729,"Những Kẻ Âu Lo",97600,180000,82400,46
TIKI,nha-sach-tiki,22725674,"Kinh Nghiệm Từ Nước Nhật - Giúp Con Tự Lập Từ 0-6 Tuổi",45100,62000,16900,27
TIKI,nha-sach-tiki,74856421,"Hạnh Phúc Trong Công Việc",109220,159000,49780,31
TIKI,nha-sach-tiki,194959693,"Hàn Quốc Quốc Gia Gây Sững Sờ",197000,225000,28000,12
TIKI,nha-sach-tiki,50668886,"Thiện, Ác Và Smart Phone (Tái Bản)",76000,105000,29000,28
TIKI,nha-sach-tiki,58547334,"Bài Tập Tiếng Anh 9 - Không Đáp Án (Tái Bản 2020)",40000,52000,12000,23
TIKI,nha-sach-tiki,102629342,"999 Lá Thư Gửi Cho Chính Mình (**) - Tập 2 - Mong Bạn Trở Thành Phiên Bản Hạnh Phúc Nhất (Tái bản)",92800,129000,36200,28
TIKI,nha-sach-tiki,197751561,"MONSTER #8 - Tập 5",52200,58000,5800,10
TIKI,nha-sach-tiki,2583023,"Bé Nhanh Nhẹn",11500,23000,11500,50
TIKI,nha-sach-tiki,143676192,"Màu Acrylic tuýp mini chuyên nghiệp Deli - 5ml/tuýp - Vẽ vải / Vẽ quần áo / Vẽ giày - 12/18/24 màu",75600,75600,0,0
TIKI,nha-sach-tiki,191636255,"Chòm Sao Linh Thú Tập 7 [Tặng Kèm Bookmark]",37000,40000,3000,8
TIKI,nha-sach-tiki,181379287,"Tốc Độ Của Niềm Tin (The Speed Of Trust)(Tái Bản 2022)",139000,175000,36000,21
TIKI,nha-sach-tiki,71957923,"Sách Ehon - Combo 4 cuốn Bạn là ai vậy - Dành cho trẻ từ 0 - 3 tuổi",100000,156000,56000,36
TIKI,nha-sach-tiki,181699688,"Husky Và Sư Tôn Mèo Trắng Của Hắn - Tập 3",127000,169000,42000,25
TIKI,nha-sach-tiki,46849710,"Robinson Crusoe ",125000,190000,65000,34
TIKI,nha-cua-doi-song,28619438,"Thang nhôm rút gọn SUMIKA SK320 - Chiều cao tối đa 3.2m, chiều dài rút gọn 0.8m, hợp kim nhôm cao cấp, khóa chốt chắc chắn, đế cao su chống trượt, nhỏ gọn, di chuyển tiện lợi",1139000,1500000,361000,24
TIKI,nha-cua-doi-song,157175018,"Kệ Thanh Ngang Treo Tường Kết Cấu Giấu Chân SIB Decor, Gỗ Lõi Xanh Chống Ẩm, Kèm Phụ Kiện Và Thước Thuỷ Lấy Cân Bằng",89000,89000,0,0
TIKI,nha-cua-doi-song,173768367,"Hộp đựng đồ chia ngăn 7 - 9 và 12 ngăn sắp xếp quần áo Danido - Khay đựng đồ chia ngăn tiện ích, chất liệu cao cấp",75050,79000,3950,5
TIKI,nha-cua-doi-song,49123718,"Bàn Học, Bàn Làm Việc Thông Ming Thương Hiệu IGEA",758000,825000,67000,8
TIKI,nha-cua-doi-song,27068546,"Bộ 2 Túi Đựng Chăn Màn - Túi Quần Áo Khung Sắt Gấp Gọn 2 Chiếc Cao Cấp (Giao màu ngẫu nhiên)",169000,250000,81000,32
TIKI,nha-cua-doi-song,75483321,"Dụng Cụ Cọ Rủa Bình,Ly Có Đầu Mút-Giao Màu Ngẫu Nhiên",12000,12000,0,0
TIKI,nha-cua-doi-song,98678067,"10 Thùng hộp carton - Mã MHL8 - Kích thước 50x40x30 (cm)",162000,162000,0,0
TIKI,nha-cua-doi-song,198562465,"Bàn Làm Việc, Bàn Học Có Ngăn Để Đồ Tiện Dụng Phong Cách Bắc Âu Thương Hiệu IGA - GP185",613000,666000,53000,8
TIKI,nha-cua-doi-song,42354346,"Gối Chữ U Kèm Bịt Mắt, Bịt Tai – Gối Ngủ Du Lịch, Tựa Đầu Chống Mỏi Chất Liệu Memory Foam Chính Hãng miDoctor – mi1711",149000,149000,0,0
TIKI,nha-cua-doi-song,54758744,"combo 5 keo bẫy  chuột siêu dính cao cấp , dùng được nhiều lần ",34900,34900,0,0
TIKI,nha-cua-doi-song,68716601,"Dao Gọt Hoa Quả Sunhouse KS-KN100PS",33000,49000,16000,33
TIKI,nha-cua-doi-song,148810239,"Hộp Cơm Cắm Điện Đời Mới Chính Hãng MINIIN, Hâm Nóng, Giữ Nhiệt, Nấu Chín Cơm Và Thức Ăn, 2 Tầng Nhỏ Gọn, 4 Bát Innox Không Gỉ, Tặng Kèm Bộ Đũa Và Thìa, Đa Chức Năng, Dễ Dàng Vệ Sinh",220150,259000,38850,15
TIKI,nha-cua-doi-song,25036470,"Bình Lọc Nước Barrier Nika (2.5l) - Xanh Lá",206000,450000,244000,54
TIKI,nha-cua-doi-song,71342375,"Áo Mưa Bít Trẻ Em Vải Dù Siêu Dày Hàng Việt Nam, Chống Thấm Nước, Phơi Mau Khô Ráo, Che Kín Người An Toàn Cho Bé, Có Lựa Chon Size, Giới Tính Cho Bé ( Giao Màu - Mẫu Ngẫu Nhiên Vì Nhiều Hoạt Tiết)",90000,90000,0,0
TIKI,nha-cua-doi-song,117791447,"Bình nước cho bé đi học, Bình uống nước cho bé có ống hút 700ml bằng nhựa PP chịu nhiệt tốt tặng kèm túi và dây đeo tiện lợi BBShine – BN011",94000,150000,56000,37
TIKI,nha-cua-doi-song,118898224,"Phin nhôm cao cấp hoa văn màu đen có hộp giấy",75000,75000,0,0
TIKI,nha-cua-doi-song,54644755,"Áo bọc bàn để ủi quần áo, nhiều họa tiết - Áo trùm bàn ủi đồ, chọ size theo ý, giao mẫu ngẫu nhiên+ Tặng kèm hình dán",59000,59000,0,0
TIKI,nha-cua-doi-song,138534630,"Tủ nhựa KATA 5 tầng giá rẻ, chất lượng, chính hãng, nhiều màu sắc",1049000,1250000,201000,16
TIKI,nha-cua-doi-song,34527170,"Giấy bạc dán tường nhà bếp chống thấm dầu, thấm nước tiện dụng 3mx60cm",20999,20999,0,0
TIKI,nha-cua-doi-song,133245917,"Hộp Đựng Bàn Chải Và Nhả Kem Đánh Răng Tự Động Tặng Kèm  Cốc Hút Từ -Kệ Để Đồ Nhà Tắm Dán Tường Tiện Lợi- Hàng Chính Hãng MINIIN",145350,153000,7650,5
TIKI,nha-cua-doi-song,67937873,"Tấm bảo vệ nệm Everon White",370000,370000,0,0
TIKI,nha-cua-doi-song,46178511,"Túi Lọc Sữa Đậu Nành, Túi Lọc Sữa Hạt Cao Cấp, Túi Lọc Trà, Túi Lọc Gia Vị - Hàng Chính Hãng",28000,60000,32000,53
TIKI,nha-cua-doi-song,1084776,"Chảo Chống Dính Vân Đá Đáy Từ HappyCook MFP-26IH GRAY (26cm)",235000,373000,138000,37
TIKI,nha-cua-doi-song,108712114,"Kèn Melodion Swan 32 Phím Model SW-37 Tặng kèm túi đựng TIKCO và khăn lau hàng chính hãng",195000,195000,0,0
TIKI,nha-cua-doi-song,165219472,"Sét 10 khay giấy bạc,khay bạc đựng thực phẩm lót nồi chiên không dầu chịu nhiệt độ cao",10000,13000,3000,23
TIKI,nha-cua-doi-song,16284231,"Bộ 50 móc dán tường siêu dính ",22999,22999,0,0
TIKI,nha-cua-doi-song,184915910,"Chậu Gội Đầu Tại Nhà, Tại Giường Cho Người Già, Người Bệnh, Trẻ Em",89000,125000,36000,29
TIKI,nha-cua-doi-song,85908084,"Nhang Sạch Phòng Máy Lạnh - Ít khói - Hương trầm dịu nhẹ - Chân tăm mộc - Nhang Xanh - 300g - 20cm",120000,120000,0,0
TIKI,nha-cua-doi-song,120470924,"Bình Thuỷ Tinh Luminarc Dona Embossment Ray 1L - LUDOQ0436 ",104000,104000,0,0
TIKI,nha-cua-doi-song,190989561,"Bình đựng thức ăn giữ nhiệt Inox 316 Elmich EL-8019 dung tích 600ml",301000,419000,118000,28
TIKI,nha-cua-doi-song,263488389,"Kệ sách để bàn HT003  - Vàng vân gỗ - Ván dày 12mm",47000,58000,11000,19
TIKI,nha-cua-doi-song,146373034,"Hộp Đựng Đồ Dùng Gấp Gọn Cao Cấp BA01 Kích Thước 38x25x25cm Tiện Lợi, Hộp Vải Chia Ngăn Đựng Quần áo, Hộp vải chia 7 ngăn, chia 9 ngăn, chia 11 ngăn, chia 12 ngăn - Chính Hãng dododios",65000,65000,0,0
TIKI,nha-cua-doi-song,177081696,"Cây Sứ Thái Kép Hoa Tím - cây cảnh để trong nhà + tặng phân bón cho cây",65000,110000,45000,41
TIKI,nha-cua-doi-song,243047801,"Gối tựa lưng văn phòng cao su non A kích thước 34 x 34 cm x 6/10cm",180000,180000,0,0
TIKI,nha-cua-doi-song,144203362,"Bộ túi hộp cơm thủy tinh Lock&amp;Lock 3EA LLG429DS2GRY (LLG429Dx1, LLG428x1, HWB820GRYx1) - Màu",355000,682000,327000,48
TIKI,nha-cua-doi-song,25731116,"Thùng vuông 55 lít - có bánh xe Duy Tân No.748 (61 x 43 x 32 cm)",195000,195000,0,0
TIKI,nha-cua-doi-song,76058957,"Kệ gia vị chữ E cao cấp VANDO bằng thép carbon chống gỉ, chống xước, kệ đựng chai lọ gia vị đa năng, kệ để đồ nhà bếp gọn gàng, sang trọng",399000,656000,257000,39
TIKI,nha-cua-doi-song,8085585,"Giấy lọc cà phê Hario 40 cái (V60-VCF-02-40W)",47000,58000,11000,19
TIKI,nha-cua-doi-song,180750013,"VẢI GA BỌC GHẾ SOFA GIƯỜNG - SOFA BED",66000,66000,0,0
TIKI,nha-cua-doi-song,155114109,"Ngăn Kéo Nhựa Nhỏ Mini, Khay Đựng Bút Gắn, Hộp ngăn kéo Treo Dưới Bàn Làm Việc Giúp Cất Giữ Gọn Gàng Bàn Làm Việc (Giao Màu Ngẫu Nhiên)",119000,119000,0,0
TIKI,dien-thoai-may-tinh-bang,188769126,"Chuông cửa không dây thông minh CACAZI A10, chống nước khoảng cách sử dụng trong 300M, 60 loại nhạc chuông, 110 DB",185000,185000,0,0
TIKI,dien-thoai-may-tinh-bang,185004559,"Ly Thủy Tinh Hoa Văn Navivu Vintage Glass 300 - 350ml",47000,47000,0,0
TIKI,dien-thoai-may-tinh-bang,30008695,"Vĩ 5 viên pin Maxell dòng cao cấp CR2032",20050,20050,0,0
TIKI,dien-thoai-may-tinh-bang,32153958,"Khóa Số ABUS 145/20 (20mm) - Nhiều Màu",129000,139000,10000,7
TIKI,nha-cua-doi-song,174897090,"Combo 4 Miếng dán tường treo kệ bếp, kệ nhà tắm",24000,24000,0,0
TIKI,dien-thoai-may-tinh-bang,42264813,"Kẹp phơi đồ Inox -Kẹp phơi quần áo đồ chống gió",61800,61800,0,0
TIKI,dien-thoai-may-tinh-bang,696521,"Ổ Cắm Điện 4 Lỗ 3 Chấu 2 cổng USB Philips SPN6248WB/74 (2500W)",416000,469000,53000,11
TIKI,nha-cua-doi-song,35068214,"Pin 12V- Pin A23 Panasonic LRV08 - Hàng Chính Hãng",35000,35000,0,0
TIKI,nha-cua-doi-song,71692258,"Mũ làm khô tóc siêu thấm nước dùng sau khi gội đầu/tắm đa năng",42000,42000,0,0
TIKI,dien-thoai-may-tinh-bang,69927147,"Túi Đựng Hộp Cơm Giữ Nhiệt Đa Lớp Nhiều Hoa Văn - Xanh Denim",23896,23896,0,0
TIKI,nha-cua-doi-song,984752,"Nồi Inox 3 Đáy Fivestar N20-3DG (20cm) - Hàng Chính Hãng",279000,279000,0,0
TIKI,dien-thoai-may-tinh-bang,42718737," Đèn Led Trang Trí Bóng Tròn Dài 6M - 40  Bóng Trang Trí Noel Lễ Tết",80000,80000,0,0
TIKI,dien-thoai-may-tinh-bang,174489182,"Túi đựng rác phân hủy sinh học Sunhouse KS-GA6578BS",46000,70000,24000,34
TIKI,nha-cua-doi-song,4361879,"Bộ lọc nước thô đầu nguồn 3 cấp lọc 10inch Yamato YMTH10-3T",334000,450000,116000,26
TIKI,nha-cua-doi-song,212986033,"Đồng hồ bấm giờ đếm ngược điện tử mini, đồng hồ điện tử đa năng - Funu Home",65000,65000,0,0
TIKI,nha-cua-doi-song,67980198,"Phân bón hữu cơ sinh học KingCrop, dùng trồng rau, cây ăn trái sạch, an toàn",70000,70000,0,0
TIKI,dien-thoai-may-tinh-bang,153263106,"Kéo Cắt Gà  Nhật Bản Làm Bếp Đa Năng Cắt Vải Cắt Giấy SK5 Siêu Sắc - Hàng Loại 1- Chính Hãng",58000,65000,7000,11
TIKI,nha-cua-doi-song,274541068,"Combo 10 cặp nút tai chống ồn cao cấp Honeywell Max 1 - Nút bịt tai chống ồn khi đi ngủ, ôn thi, đi máy bay, công trình, xưởng in",3000,3000,0,0
TIKI,dien-thoai-may-tinh-bang,57521842,"Bàn Học Bàn Làm Việc Kết Hợp Kệ Sách Thương Hiệu IGEA",569000,620000,51000,8
TIKI,nha-cua-doi-song,128202074,"Găng Tay Siêu Dai Hình Con Hươu Lót Nỉ",21000,21000,0,0
TIKI,dien-thoai-may-tinh-bang,207557574,"Bàn học gấp gọn ngồi bệt, bàn chân nhựa cứng 40x60cm mặt gỗ MDF loại đẹp ( giao màu ngẫu nhiên )",60000,77000,17000,22
TIKI,nha-cua-doi-song,192443483,"Hộp cơm văn phòng KIPOR KP-HC01 - Thuỷ tinh cao cấp dùng được trong lò vi sóng - Chống tràn, tiện lợi - Hàng chính hãng",42000,72000,30000,42
TIKI,nha-cua-doi-song,197649725,"Bình Nước Giữ Nhiệt 500ml Bằng Thép Không Gỉ 304 Hai Lớp Có Màn Hình Kỹ Thuật Số Hiển Thị Nhiệt Độ Cảm Biến 1 Chạm",125000,125000,0,0
TIKI,nha-cua-doi-song,155253236,"HỘP PIN MAXELL 40 VIÊN  AAA TEM BẠC - HÀNG CHÍNH HÃNG",51450,51450,0,0
TIKI,nha-cua-doi-song,136014171,"Bình Nước Nhựa We Bare Bears 1l Dễ Thương Có Kèm Túi Rút Túi Giữ Nhiệt Và Ống Hút Siêu Tiện Lợi",418000,418000,0,0
TIKI,dien-thoai-may-tinh-bang,93062863,"Ô dù tự động thông minh cao cấp toàn Fully Automatic Safe Umbrella, cơ chế giữ nước như dù ngược, khung nan chắc chắn chống gió bão cấp 6, vải siêu chống nước phủ Nano chống tia UV",259000,259000,0,0
TIKI,dien-thoai-may-tinh-bang,53521887,"Giấy lọc cà phê Hario 40 cái (V60-VCF-02-40M)",49000,62000,13000,21
TIKI,dien-thoai-may-tinh-bang,180001622,"Bộ 2 Ly Thuỷ Tinh Cao Luminarc Salto Frost Lime 350ml - LUSAQ3177",139000,180000,41000,23
TIKI,nha-cua-doi-song,26602007,"Kẹp Bẫy Bắt Chuột Thông Minh",7000,18000,11000,61
TIKI,dien-thoai-may-tinh-bang,155718559,"Bình xịt dầu ăn, xịt gia vị dạng phun sương chai thủy tinh 100ml - hàng chính hãng THAFA",35000,39000,4000,10
TIKI,nha-cua-doi-song,25620364,"Set 300 ống hút nhựa PP an toàn",64500,64500,0,0
TIKI,nha-cua-doi-song,48354676,"Bộ 2 Hộp Thủy Tinh Chịu Nhiệt KLOCK KV400 (2 x 400ml) Tặng Túi Giữ Nhiệt",119000,199000,80000,40
TIKI,nha-cua-doi-song,11249688,"Dụng Cụ Bịt Mắt Ngủ- Màu Trắng Hình Ngẫu Nhiên",10800,10800,0,0
TIKI,nha-cua-doi-song,101937904,"Kệ nhà tắm, Kệ để đồ toilet thông minh Kệ để đồ phòng tắm phòng vệ sinh dán tường không cần khoan đục",38999,38999,0,0
TIKI,dien-thoai-may-tinh-bang,17998301,"Túi đựng đồ lót nhiều ngăn có móc treo",32600,32600,0,0
TIKI,nha-cua-doi-song,152446518,"Cây cúc tần ấn độ - cây cảnh vườn + tặng phân bón cho cây",25000,30000,5000,17
TIKI,dien-thoai-may-tinh-bang,139161475," Muỗng, Muôi Múc Canh, Vá múc canh Inox 304 Cao Cấp, Sang Trọng Cho Bữa Cơm",45000,45000,0,0
TIKI,dien-thoai-may-tinh-bang,161455577,"Đui đèn cảm biến chuyển động",42000,42000,0,0
TIKI,nha-cua-doi-song,46185330,"COMBO 10 MÓC INOX HÌNH CHỮ S NHỎ",60000,60000,0,0
TIKI,nha-cua-doi-song,59236591,"Cốc Thủy Tinh Chia Vạch Tiên Lợi-màu giao ngẫu nhiên- CCV",24000,26499,2499,9
TIKI,dien-thoai-may-tinh-bang,4216861,"Kính bảo hộ 3M SF401AF chống đọng sương",75000,75000,0,0
TIKI,dien-thoai-may-tinh-bang,77315431,"[Chọn màu] Bộ 20 miếng bọc chân ghế tròn, chân bàn bằng silicon dày, bọc chân bàn chống trượt, chống xước cho sàn gỗ GD365-BCGheTron-20",19998,19998,0,0
TIKI,dien-thoai-may-tinh-bang,7078973,"Kìm Cắt Chân Linh Kiện PLT 170 125mm",17000,17000,0,0
TIKI,nha-cua-doi-song,98955056,"Móc Treo Quần Áo Inox SUS304 7 Chấu Dán Tường Không Cần Khoan Đục - Tặng Kèm keo và Đinh Vít",150000,195000,45000,23
TIKI,nha-cua-doi-song,26299212,"Miếng Che Mắt Ngủ Có Túi Gel Làm Mát - Màu Ngẫu Nhiên",32000,32000,0,0
TIKI,dien-thoai-may-tinh-bang,146288304,"Giá để/ Chân để/ Giá đỡ/ Chân đỡ đàn Guitar cao cấp - Kzm Kurtzman J2 - Đa năng, dành cho tất cả loại đàn Guitar - Màu đen - Hàng chính hãng",168000,168000,0,0
TIKI,dien-thoai-may-tinh-bang,152446716,"Cây Lài Trà - cây cảnh vườn + Tặng phân bón cho cây mau lớn",25000,30000,5000,17
TIKI,nha-cua-doi-song,253106781,"Nút Nắp Đậy Chai Bằng Silicon Hình Con Chim Giao Màu Ngẫu Nhiên",61600,61600,0,0
TIKI,nha-cua-doi-song,59412424,"Bộ Dụng Cụ Bếp (Đũa, Sạn, Vá) Bằng Gỗ Nhãn Tự Nhiên - VAGOO - Làm Thủ Công Chống Thấm, Chống Ẩm Mốc, An Toàn Sức Khoẻ",169000,169000,0,0
TIKI,dien-thoai-may-tinh-bang,38306937,"Vỉ 5 Viên Pin CR1616 Lithium 3V Panasonic - Hàng Chính Hãng",86400,89000,2600,3
TIKI,nha-cua-doi-song,47271244,"Shaker Inox 2 mảnh - Cocktail Boston",175000,175000,0,0
TIKI,nha-cua-doi-song,150561019,"Ủng Bọc Giày Đi Mưa Cổ Cao Có Đế Chống Trượt",38900,38900,0,0
TIKI,dien-thoai-may-tinh-bang,70840199,"Vá Canh Bằng Gỗ Nhãn Tự Nhiên - VAGOO - Làm Thủ Công Chống Thấm, Chống Ẩm Mốc, An Toàn Cho Sức Khoẻ",99000,99000,0,0
TIKI,dien-thoai-may-tinh-bang,90072128,"Kệ Giày Dép 7 Tầng Rộng 80cm Gỗ Tự Nhiên 100%- TN",745000,980000,235000,24
TIKI,nha-cua-doi-song,217766070,"Thùng Rác Văn Phòng Dạng Lưới Kim Loại Size 27cm",88000,88000,0,0
TIKI,nha-cua-doi-song,31264857,"Combo 5 Chiếc Khăn Tắm Xuất Nhật bản to 70x140cm",62999,62999,0,0
TIKI,dien-thoai-may-tinh-bang,167937668,"Aó mưa măng tô,Áo mưa có dây kéo ,vải dù cao cấp chống thấm nước cực tốt ,bảo vệ cơ thể ấm áp,cho nam và nữ",151050,159000,7950,5
TIKI,dien-thoai-may-tinh-bang,73758944,"Kệ Đa Năng Để Lò Vi Sóng INOX Trắng Cao Cấp Chống Han Gỉ Kệ Để Đồ Nặng Siêu Gọn Cho Nhà Bếp VANDO",599000,856000,257000,30
TIKI,dien-thoai-may-tinh-bang,143322314,"Ron chặn khe hở 90cm đa năng, Nẹp dán chân cửa chống côn trùng, phù hợp mọi loại cửa tiện dụng-GD534-Ron90",29000,29000,0,0
TIKI,nha-cua-doi-song,42566535,"Dụng Cụ Mài Dao 3 Rảnh - Dụng Cụ Mài Nhiều Loại Dao, Nhiều Chế Độ",15000,15000,0,0
TIKI,dien-thoai-may-tinh-bang,58678597,"Hộp Cơm Điện Lock&Lock EJR226IVY (2 Lít)",1010000,1942000,932000,48
TIKI,dien-thoai-may-tinh-bang,82877146,"Đèn Bàn Học LED Chống Cận GHINER GN-1902 (Pin 4500mAh)",250000,320000,70000,22
TIKI,dien-thoai-may-tinh-bang,26053920,"Vòi Nước Inox 304 Loại Tốt",34293,34293,0,0
TIKI,nha-cua-doi-song,35169106,"Bộ 3 đầu cọ bàn chải gắn máy Khoan cầm tay - Dụng cụ vệ sinh nhà cửa lốp xe thông minh",60000,149440,89440,60
TIKI,nha-cua-doi-song,196552579,"Ô Dù gấp gọn , dù che mưa , chống tia UV 8 nan ( nhiều mẫu )",51000,51000,0,0
TIKI,dien-thoai-may-tinh-bang,3677777,"Bình Lọc Nước BRITA Active Pink - 600ml (Kèm Microdisc)",549000,849000,300000,35
TIKI,nha-cua-doi-song,58498874,"Bộ Đũa Thìa Dĩa Inox, Hộp Đựng Lúa Mạch, Nhiều Màu Lựa Chọn, Tặng Kèm Ống Hút Tre",48999,48999,0,0
TIKI,nha-cua-doi-song,82979825,"Bàn Chải Đa Năng Cầm Tay Dùng Cho Phòng Tắm Hình Cá Voi Có Đế Đựng Tiện Lợi",45000,45000,0,0
TIKI,nha-cua-doi-song,27826567,"Dụng cụ ép tỏi, nghiền tỏi có tay cầm tiện dụng",22000,22000,0,0
TIKI,nha-cua-doi-song,55718749,"Tấm lót silicon đa năng trơn dùng làm bánh lót bàn ăn",69000,69000,0,0
TIKI,nha-cua-doi-song,13509515,"Đèn LED siêu sáng USB 28 bóng AZONE",34000,89000,55000,62
TIKI,nha-cua-doi-song,145420630,"kệ treo quần áo chống gỉ / Giá treo áo khoác kim loại đơn giản và thời trang Bền Chắc Đa Năng Nội Thất Cho Phòng Ngủ- Bảo hành 10 năm",399000,399000,0,0
TIKI,dien-thoai-may-tinh-bang,36935892,"Combo 10 khăn lau bếp đa năng - KL29 (Giao ngẫu nhiên mẫu)",10000,10998,998,9
TIKI,nha-cua-doi-song,100431737,"Bộ hộp bảo quản thực phẩm đa năng Nora Ez – FS11-E1++++",198000,198000,0,0
TIKI,dien-thoai-may-tinh-bang,58536862,"Cặp Vỏ Gối Lụa Cao cấp A - 50x70cm hoặc 60x80cm - mềm mịn mát lạnh",165000,200000,35000,18
TIKI,dien-thoai-may-tinh-bang,52609001,"Đèn Pin Mini Cầm Tay Siêu Sáng Loại Đèn Nhỏ 3W Police Dùng Pin AA",31000,55000,24000,44
TIKI,dien-thoai-may-tinh-bang,52354974,"Combo 9 Ván Sàn Gỗ Tự Nhiên Màu Nâu Vàng, Vỉ Gỗ Lót Sàn Ban Công, Sân Vườn, Hồ Bơi, Phòng Spa, Siêu Bền, Chịu Nước Tốt, Chống Trơn Trượt, Tiêu Chuẩn Xuất Khẩu",249000,279000,30000,11
TIKI,dien-thoai-may-tinh-bang,12461025,"Nước cắm hoa công nghệ nano đồng Fresh Flowers AHT 430ml - giúp hoa lâu tàn, không thối nước",44000,55000,11000,20
TIKI,nha-cua-doi-song,116749239,"Ruột Gối Doona Basic độ bền cao, mềm mịn, an toàn cho sức khoẻ",195000,210000,15000,7
TIKI,dien-thoai-may-tinh-bang,126244017,"Ghế Học Sinh Tiểu Học Chống Gù Thông Minh Có Gác Chân BHS288 Ghế Ngồi Bàn Học Cho Bé Tuỳ Chỉnh Độ Cao - Hàng Chính Hãng",1035000,1265000,230000,18
TIKI,dien-thoai-may-tinh-bang,243165179,"Điện thoại OPPO Reno8 T 4G (8GB/256GB) - Hàng Chính Hãng",8136000,8136000,0,0
TIKI,nha-sach-tiki,181802012,"Set 50/100 tem dán cảm ơn khách và lưu ý quay video mở hàng (8x10cm) (1.025) - tem dán đơn hàng, kiện hàng dành cho shop",40000,40000,0,0
TIKI,dien-thoai-may-tinh-bang,225960096,"Điện Thoại Samsung Galaxy S23+ 5G - Hàng Chính Hãng",18000000,18000000,0,0
TIKI,dien-thoai-may-tinh-bang,219400421,"Điện thoại OPPO CPH2471 - A17k Xanh - Hàng Chính Hãng (chỉ giao HN và một số khu vực)",3276000,3276000,0,0
TIKI,nha-sach-tiki,102893964,"Combo 5-10-20 Bút Bi Thiên Long TL-027 - Mực Xanh/Đen/Đỏ/Tím",23000,23000,0,0
TIKI,nha-sach-tiki,14136016,"Phía Nam Biên Giới, Phía Tây Mặt Trời (Tái Bản 2018)",63300,85000,21700,26
TIKI,nha-sach-tiki,186265453,"Komi - Nữ Thần Sợ Giao Tiếp Tập 10 [Tặng Kèm PVC Card]",25000,25000,0,0
TIKI,nha-sach-tiki,73685374,"Combo Trinh Thám Đen: Cô Dâu Đen + Ám Ảnh Đen + Điểm Hẹn Đen + Kết Hôn Với Người Chết",199500,399000,199500,50
TIKI,nha-sach-tiki,189765038,"Python lập trình thuật toán",95000,95000,0,0
TIKI,nha-sach-tiki,32219488,"Doanh Nghiệp Của Thế Kỷ 21 (Tái Bản 2019)",62200,100000,37800,38
TIKI,nha-sach-tiki,186578226,"Hy vọng mong manh",118000,158000,40000,25
TIKI,dien-thoai-may-tinh-bang,175851126,"Máy Tính Bảng Galaxy Tab A8 4GB | 64GB - Hàng Chính Hãng",5856000,5856000,0,0
TIKI,dien-thoai-may-tinh-bang,244167098,"Điện thoại Xiaomi Redmi 12C (4GB/64GB) - Hàng chính hãng",3168000,3168000,0,0
TIKI,nha-sach-tiki,4978895,"Biết Chính Mình",60700,85000,24300,29
TIKI,nha-sach-tiki,58067801,"Luyện Kỹ Năng Phát Âm Tiếng Anh (Trình Độ Sơ Cấp) - English Pronunciation In Use (Elementary)",80000,80000,0,0
TIKI,nha-sach-tiki,160370181,"Khói Trời Lộng Lẫy (Tập Truyện Ngắn Nguyễn Ngọc Tư)(Tái Bản)",60800,90000,29200,32
TIKI,nha-sach-tiki,52788074,"Khu Vườn Mùa Hạ (Tái Bản 2020)",50500,68000,17500,26
TIKI,dien-thoai-may-tinh-bang,197214015,"Apple iPhone 14 Plus",19490000,27990000,8500000,30
TIKI,dien-thoai-may-tinh-bang,248754839,"Điện Thoại OPPO A17K (3GB/64GB) - Hàng Chính Hãng",3276000,3276000,0,0
TIKI,nha-sach-tiki,1007137,"Tự Học 2000 Từ Vựng Tiếng Anh Theo Chủ Đề",45500,65000,19500,30
TIKI,nha-sach-tiki,192909289,"Quán Rượu Dị Giới "Nobu" - Tập 09",31000,40000,9000,0
TIKI,nha-sach-tiki,197652268,"Như Cơn Gió Thoảng - Nghĩ Về Những Qui Luật Cuộc Sống",103500,115000,11500,10
TIKI,dien-thoai-may-tinh-bang,273185467,"Điện thoại Samsung A05 4GB - hàng chính hãng",3112000,3112000,0,0
TIKI,dien-thoai-may-tinh-bang,252073013,"Điện thoại hiệu Masstel Fami 60 - Hàng chính hãng - Giá rẻ - hỗ trợ 4G - dành cho người lớn tuổi",730000,730000,0,0
TIKI,nha-sach-tiki,185409035,"Bút Bi Nước Mực Gel Bấm Ngòi 0.5mm Deli - Có Ngòi Thay Thế Viết Trơn Đều Phù Hợp Ghi Chép Văn Phòng Học Sinh Sổ Tay - A575",2000,5400,3400,63
TIKI,dien-thoai-may-tinh-bang,205846229,"Điện Thoại Oppo A57 4GB/128GB - Hàng Chính Hãng",4632000,4632000,0,0
TIKI,dien-thoai-may-tinh-bang,248185860,"Điện Thoại Masstel Fami 12 4G - Hàng Chính Hãng",630000,630000,0,0
TIKI,nha-sach-tiki,10379317,"Nghệ Thuật Giao Tiếp Để Thành Công (Tái Bản 2019)",98020,169000,70980,42
TIKI,nha-sach-tiki,27971953,"Lược Sử Tôn Giáo",96300,129000,32700,25
TIKI,nha-sach-tiki,102832718,"Thay Tư Duy Xoay Cục Diện - Vĩnh Biệt Lối Mòn",84100,119000,34900,29
TIKI,nha-sach-tiki,122869197,"túi giấy đựng quà các cỡ loại đẹp có nắp",9000,14400,5400,38
TIKI,nha-sach-tiki,187827438,"Vọng Lâu Tử Thần",72400,120000,47600,40
TIKI,dien-thoai-may-tinh-bang,271801317,"Máy tính bảng siêu bền Oukitel RT6 (chống nước,chống va đập,pin 20000mAh,Ram 16Gb(8GB+8Gb),Rom 256GB,Màn hình 10.1" ,FHD,Android 13,CPU MTK8788 ,Camera 16MP,sạc nhanh 33W)-hàng chính hãng",9990000,9990000,0,0
TIKI,nha-sach-tiki,195521211,"Diệt Slime Suốt 300 Năm, Tôi Levelmax Lúc Nào Chẳng Hay (Tập 11)",119000,159000,40000,25
TIKI,dien-thoai-may-tinh-bang,198671718,"Điện Thoại Samsung Galaxy A04s (4GB/64GB) - Hàng Chính Hãng - Đã kích hoạt bảo hành điện tử",2670000,3990000,1320000,33
TIKI,nha-sach-tiki,32720778,"Sách tiếng Anh - Principles: Life and Work",483600,520000,36400,7
TIKI,dien-thoai-may-tinh-bang,136364272,"Máy tính bảng Masstel Tab 10.4" (4GB/64GB) - Hàng chính hãng - ĐÃ KÍCH HOẠT BẢO HÀNH ĐIỆN TỬ",4800000,4800000,0,0
TIKI,dien-thoai-may-tinh-bang,274364026,"Máy tính bảng học tập thông minh Nexta Edutab Pro tối ưu cho trẻ 9-12 tuổi, 64GB, tích hợp ứng dụng học tập - Hàng nhập khẩu",6490000,6490000,0,0
TIKI,dien-thoai-may-tinh-bang,273231495,"Máy tính bảng Masstel tab 10.1 pro - Hàng chính hãng",4290000,4290000,0,0
TIKI,dien-thoai-may-tinh-bang,270975124,"Điện Thoại Oppo A58 6GB/128GB - Hàng Chính Hãng",4190000,4990000,800000,16
TIKI,dien-thoai-may-tinh-bang,258766897,"Điện Thoại Masstel iZi 11 4G - Hàng Chính Hãng",468000,468000,0,0
TIKI,nha-sach-tiki,48329799,"Tự Học Toàn Diện Hóa Học - Từ Cơ Bản Đến Nâng Cao Lớp 9",65000,99000,34000,34
TIKI,nha-sach-tiki,90679276,"Mở Cửa Tương Lai",128000,200000,72000,36
TIKI,nha-sach-tiki,68049234,"Đừng Để Mất Bò - 7 Bước Quản Lý Cửa Hàng Hiệu Quả Và Chống Thất Thoát",149000,169000,20000,12
TIKI,nha-sach-tiki,141472522,"Sách: Cẩm Nang Tuổi Dậy Thì Dành Cho Bạn Gái (Tái Bản)",80000,100000,20000,20
TIKI,dien-thoai-may-tinh-bang,168094334,"Điện thoại Samsung Galaxy S20 FE (8GB/256GB) - Hàng chính hãng",8625000,8625000,0,0
TIKI,dien-thoai-may-tinh-bang,273407277,"Máy tính bảng chắc chắn Oukitel RT7(Chống va đập,Màn hình 10.1" FHD+,Pin 32000mAh ,Ram 24GB,Rom 256GB, Android 13,Camera sau 48MP, tầm nhìn ban đêm 20MP,camera trước 32MP,5G) – hàng chính hãng",13990000,13990000,0,0
TIKI,nha-sach-tiki,105614665,"Bút bi bấm ngòi 0.7mm mực xanh Deli - Màu sắc theo lựa chọn -  1 chiếc - EQ199-BL",7200,7200,0,0
TIKI,nha-sach-tiki,117254518,"Thiên Nga Hoang Dã",271000,350000,79000,23
TIKI,dien-thoai-may-tinh-bang,216934468,"Điện thoại Samsung Galaxy A14 5G (4GB/128GB) - Hàng chính hãng",5000000,5000000,0,0
TIKI,dien-thoai-may-tinh-bang,248590019,"Điện thoại Xiaomi Redmi 12C (3GB/32GB) - Hàng chính hãng",2808000,2808000,0,0
TIKI,dien-thoai-may-tinh-bang,274065746,"Điện thoại siêu bền Oukitel WP33 Pro 5G (Loa to 136 dB (5W) ,Pin 22000mAh,màn hình 6,6 inch FHD+,Ram 24GB(8+16),Rom 256GB, Camera 64MP,sạc nhanh 33W)- hàng chính hãng",8990000,8990000,0,0
TIKI,nha-sach-tiki,113540588,"Thiên Táng",73900,96000,22100,23
TIKI,dien-thoai-may-tinh-bang,249782771,"Máy tính bảng Xelex Gama Tab X8 EDU (Hàng chính hãng)",2890000,2890000,0,0
TIKI,dien-thoai-may-tinh-bang,176438864,"Điện thoại Xiaomi REDMI 9A (2+32) Xanh dương - Hàng chính hãng (chỉ giao HN và một số khu vực)",2088000,2088000,0,0
TIKI,dien-thoai-may-tinh-bang,249168300,"Điện thoại OPPO A57 4GB/128GB Đen - Hàng chính hãng",4890000,4990000,100000,2
TIKI,nha-sach-tiki,83396665,"Hướng dẫn khởi động & 200 tư thế Yoga từ cơ bản đến nâng cao",128000,185000,57000,31
TIKI,dien-thoai-may-tinh-bang,273389282,"Điện Thoại ulefone armor 21(Loa to 122dB Speaker ,pin 9600mAh,sạc nhanh 33W,Màn hình 6.58 in,camera chính 64MP,ban đêm 24MP,Ram 16Gb(8+8),rom 256Gb, điều khiển từ xa đa năng)- hàng chính hãng",6990000,6990000,0,0
TIKI,nha-sach-tiki,146271773,"Nghiệp Tình Yêu - Karma Of Love (Tái Bản 2021)",175200,199000,23800,12
TIKI,nha-sach-tiki,192733741,"Mùi hương - Tái Bản",85800,115000,29200,25
TIKI,nha-sach-tiki,176831144,"Combo 23 Tập Thanh Gươm Diệt Quỷ (Tập 1-23)",499000,575000,76000,13
TIKI,nha-sach-tiki,111582624,"Trải Nghiệm Apple - Xây Dựng Lòng Trung Thành Không Chỉ Từ Sản Phẩm",197000,239000,42000,18
TIKI,dien-thoai-may-tinh-bang,262055875,"Điện thoại POCO M5 4GB+64GB - Pin 5000mAh - MediaTek Helio G99 -  Sạc nhanh 18W - Hàng chính hãng",2599000,3990000,1391000,35
TIKI,dien-thoai-may-tinh-bang,272273680,"Điện thoại Samsung Galaxy A05s (4GB/128GB) - Hàng chính hãng",3174000,4290000,1116000,26
TIKI,dien-thoai-may-tinh-bang,200848570,"Điện thoại Mobell M539 4G - Màn hình lớn 2.8 inch - Hàng chính hãng",626000,730000,104000,14
TIKI,nha-sach-tiki,13312178,"Combo Tôi Tự Học và Óc Sáng Suốt ( Tặng Kèm Sổ Tay )",181350,181350,0,0
TIKI,dien-thoai-may-tinh-bang,274257669,"Điện thoại Masstel Izi S1 4G (LTE) Gọi HD Call - Hàng chính hãng",420000,499000,79000,16
TIKI,nha-sach-tiki,88592202,"Tiny Habits : Thói quen tí hon - Tiềm năng khổng lồ",299000,299000,0,0
TIKI,dien-thoai-may-tinh-bang,215119245,"Điện Thoại Di Động Forme D888 4G - Hàng Chính Hãng",680000,680000,0,0
TIKI,dien-thoai-may-tinh-bang,274524033,"Điện thoại người già Masstel Fami 12S 4G(LTE) , Bàn phím chữ số to, Loa lớn , Máy viền thép chắc chắn - Hàng chính hãng",569000,650000,81000,12
TIKI,dien-thoai-may-tinh-bang,274564360,"Điện Thoại Xiaomi Redmi 12 4G (4GB/128GB) - Hàng chính hãng",3290000,4990000,1700000,34
TIKI,dien-thoai-may-tinh-bang,103168071,"Máy tính bảng Samsung Galaxy Tab A7 Lite LTE SM-T225 - Hàng Chính Hãng",3587000,3587000,0,0
TIKI,nha-sach-tiki,176550198,"Nam Hải Dị Nhân Liệt Truyện",353000,500000,147000,29
TIKI,nha-sach-tiki,1362559,"Cổ Phiếu Thường, Lợi Nhuận Phi Thường (Tái Bản)",127400,199000,71600,36
TIKI,dien-thoai-may-tinh-bang,273595363,"Oukitel wp30 Pro 5g SIÊU BỀN (sạc nhanh 120W ,pin 11000 mAh,màn hình 6.78 inch,Ram 24 GB(12gb + 12GB),Rom 512GB ,120Hz ,Android 13,camera 108mp)- hàng chính hãng",11990000,11990000,0,0
TIKI,nha-sach-tiki,177569697,"Perfect Ielts Vocabulary (Tái Bản)",162200,259000,96800,37
TIKI,dien-thoai-may-tinh-bang,262688183,"ĐIỆN THOẠI MASSTEL IZI 30 4G-LTE-HÀNG CHÍNH HÃNG",560000,560000,0,0
TIKI,dien-thoai-may-tinh-bang,175967811,"Điện Thoại Samsung Galaxy S20 FE 256GB | 8GB - Hàng Chính Hãng",8625000,8625000,0,0
TIKI,dien-thoai-may-tinh-bang,274560616,"Máy tính bảng học tập giá rẻ Nexta Edutab Kid cho bé từ 5-8 tuổi, màn hình full HD 64GB, bao da, kính dán cường lực, hàng chính hãng",4990000,4990000,0,0
TIKI,dien-thoai-may-tinh-bang,68693081,"Điện Thoại Samsung Galaxy S20 FE (8GB/256GB) - Hàng Chính Hãng",8625000,8625000,0,0
TIKI,dien-thoai-may-tinh-bang,181699208,"Máy tỉnh bảng Samsung Galaxy Tab A8 -Hàng chính hãng",5856000,5856000,0,0
TIKI,dien-thoai-may-tinh-bang,273186334,"Điện thoại Samsung Galaxy A05s 4GB/128GB- Hàng Chính hãng",3980000,3980000,0,0
TIKI,dien-thoai-may-tinh-bang,250113073,"Điện thoại Xiaomi Redmi Note 12 Pro 5G (8GB/256GB) - Hàng chính hãng",9000000,9000000,0,0
TIKI,dien-thoai-may-tinh-bang,196348143,"Điện Thoại OPPO A57 (4GB/64GB) - Hàng Chính Hãng",4284000,4284000,0,0
TIKI,dien-thoai-may-tinh-bang,253443652,"Điện Thoại Samsung Galaxy M14 5G - Hàng Chính Hãng",4212000,4212000,0,0
TIKI,dien-thoai-may-tinh-bang,272200109,"Điện Thoại Samsung Galaxy A04e - Hàng Chính Hãng",2340000,2340000,0,0
TIKI,dien-thoai-may-tinh-bang,244182370,"Điện thoại Samsung Galaxy S23 Ultra 1TB - Hàng chính hãng",44990000,44990000,0,0
TIKI,dien-thoai-may-tinh-bang,273947785,"Điện thoại AI Samsung Galaxy S24+ 12GB/256GB, Camera 50MP, Màn hình 6.7"- Đen- Hàng Chính Hãng",25490000,27490000,2000000,7
TIKI,dien-thoai-may-tinh-bang,168317790,"Điện Thoại Xiaomi Redmi 9A (2GB/32GB)- Đã kích hoạt bảo hành điện tử- Hàng Chính Hãng - Peacock Green",2088000,2088000,0,0
TIKI,dien-thoai-may-tinh-bang,274030201,"Điện thoại TECNO SPARK 10 8GB/128GB - Hàng Chính Hãng",2832000,3590000,758000,21
TIKI,dien-thoai-may-tinh-bang,273366493,"Máy tính bảng chắc chắn Ulefone Armor Pad 2(màn hình 11" ,2K, pin 18600 mAh, IP68/IP69K, Android 13, NFC ,GPS, 4G, Ram 16GB(8gb+8gb),rom 256GB)- hàng chính hãng",7990000,7990000,0,0
TIKI,dien-thoai-may-tinh-bang,273511450,"Điện thoại Xiaomi Redmi 12 8GB/128GB - Hàng Chính Hãng",4390000,4390000,0,0
TIKI,dien-thoai-may-tinh-bang,258373871,"Điện Thoại Itel S23 128GB/16GB (8GB+8GB) | Pin 5000mAh | 6.6 Inch | Camera 50MP | 90Hz | Face ID - Hàng chính Hãng",2342000,3490000,1148000,33
TIKI,dien-thoai-may-tinh-bang,215135773,"Điện Thoại Di Động Forme D111 4G - Hàng Chính Hãng",520000,520000,0,0
TIKI,dien-thoai-may-tinh-bang,273454566,"Điện thoại Xiaomi POCO C65 (6GB/128GB) - Helio G85 - Màn 90HZ - Hàng chính hãng",2669000,2990000,321000,11
TIKI,dien-thoai-may-tinh-bang,252423003,"Điện thoại Tecno SPARK 10 4GB/128GB - Camera 50MP | 5000 mAh | Sạc nhanh 18W | Cảm ứng vân tay - Hàng chính hãng",3190000,3190000,0,0
TIKI,dien-thoai-may-tinh-bang,242657652,"Điện thoại Samsung Galaxy S23 Plus 256GB - Hàng chính hãng",26990000,26990000,0,0
TIKI,dien-thoai-may-tinh-bang,160051501,"Điện thoại Masstel IZI 20 4G - Hàng chính hãng, Nguyên Seal",512000,512000,0,0
TIKI,dien-thoai-may-tinh-bang,273440662,"Điện thoại Xiaomi Redmi 12 (4GB/128GB) , Helio G88 , Màn 90HZ - Hàng chính hãng",3299000,4290000,991000,23
TIKI,dien-thoai-may-tinh-bang,271341795,"Điện thoại smartphone Masstel Hapi 15 (2GB/16GB) - 2 Sim, Tặng kèm ốp lưng - Hàng chính hãng - Bảo hành chính hãng",1499000,1499000,0,0
TIKI,dien-thoai-may-tinh-bang,212329857,"Điện thoại Xiaomi Redmi 9A 2GB/32GB Xám - Hàng chính hãng",2088000,2088000,0,0
TIKI,dien-thoai-may-tinh-bang,207883258,"Điện thoại oukitel  wp21 (Ram 12Gb,Rom 256Gb ,chống sốc,chống nước,pin khủng, pin 9.800mAh) - hàng chính hãng",9970000,9970000,0,0
TIKI,dien-thoai-may-tinh-bang,251514670,"Điện thoại Xiaomi Redmi Note 12 (4GB/128GB) Màn AMOLED 120HZ, Snapdragon 685 , Sạc 33W - Hàng chính hãng",3599000,4990000,1391000,28
TIKI,dien-thoai-may-tinh-bang,200816374,"Điện Thoại Forme D888 - Hàng Chính Hãng",589000,699000,110000,16
TIKI,dien-thoai-may-tinh-bang,215543460,"Điện Thoại Samsung Galaxy A14 5G (4GB/128GB) - Hàng Chính hãng",5190000,5190000,0,0
TIKI,dien-thoai-may-tinh-bang,271234313,"Điện Thoại Nokia 110 4G Pro - Hàng Chính Hãng",699000,710000,11000,2
TIKI,dien-thoai-may-tinh-bang,274638430,"Điện thoại Redmi Note 13R 5G 4GB/128GB Dimensity 6100+ , Màn 90Hz , Rom quốc tế có sẳn Tiếng việt - Hàng nhập khẩu",2899000,3590000,691000,19
TIKI,dien-thoai-may-tinh-bang,262660017,"Điện Thoại Samsung Galaxy A24 (6GB/128GB) - Hàng Chính Hãng",5800000,5800000,0,0
TIKI,dien-thoai-may-tinh-bang,273438458,"Điện thoại Samsung Galaxy A05 (4GB/128GB)- Helio G85 - Sạc nhanh 25W - Hàng chính hãng",2636000,3090000,454000,15
TIKI,dien-thoai-may-tinh-bang,274456687,"Điện thoại Samsung Galaxy A55 5G (8GB/128GB) - Hàng chính hãng",9990000,9990000,0,0
TIKI,dien-thoai-may-tinh-bang,226552005,"Điện thoại bàn Panasonic KX-TSC11 hàng chính hãng",600000,600000,0,0
TIKI,dien-thoai-may-tinh-bang,248766283,"Máy đọc sách New Kindle 11th 2022 (Kids) kèm bao da - Hàng Chính Hãng",3010000,3299000,289000,9
TIKI,dien-thoai-may-tinh-bang,102620086,"Điện thoại VoIP Yealink SIP-T30 - Hàng Chính Hãng",1200000,1200000,0,0
TIKI,dien-thoai-may-tinh-bang,272113804,"[MỚI] Điện thoại vivo Y17s - Hàng chính hãng - Camera 50MP - Pin 5000 mAh - Sạc nhanh- RAM mở rộng đến 8GB",3790000,3990000,200000,5
TIKI,dien-thoai-may-tinh-bang,274019962,"Điện thoại Masstel Fami 8 4G(LTE) Gọi HD call , Bàn phím chữ số lớn,Loa to - Hàng chính hãng",489000,550000,61000,11
TIKI,dien-thoai-may-tinh-bang,201001781,"Điện thoại Masstel Lux 10 4G - Nhiều chức năng - Hàng chính hãng",675000,675000,0,0
TIKI,dien-thoai-may-tinh-bang,131028406,"Máy tính bảng Fire HD 10 Plus 2021 thế hệ 11th",3551100,3990000,438900,11
TIKI,dien-thoai-may-tinh-bang,208171115,"Điện thoại OUKITEL WP18 (Chống nước ,chống va đập, pin khủng 12500mAh, Ram 4GB ,Rom 32GB ,màn hình 5.93 inch,Điện thoại chắc chắn) – HÀNG CHÍNH HÃNG",3990000,3990000,0,0
TIKI,dien-thoai-may-tinh-bang,249734070,"Điện Thoại Masstel Fami 12 4G LTE - 2 Sim- Pin 1400 mAh - Đọc số bằng giọng nói - Hàng Chính Hãng - Bảo Hành 12 Tháng",630000,630000,0,0
TIKI,dien-thoai-may-tinh-bang,209872337,"Máy đọc sách Kindle 2022 (11th) - All new kindle 2022 11th màn hình 6inch 300PPI gấp 2 lần độ sắc nét, 16GB bộ nhớ trong với cổng kết nối USB-C - Hàng nhập khẩu",2300000,2300000,0,0
TIKI,nha-sach-tiki,170490710,"Bàn Về Cách Sống – Đối Thoại Giữa Triết Gia, Bác Sĩ Và Nhà Sư",99600,139000,39400,28
TIKI,nha-sach-tiki,153518828,"Hong Tay Khói Lạnh (Tản Văn Nguyễn Ngọc Tư)",62000,90000,28000,31
TIKI,nha-sach-tiki,174605338,"Bách Khoa Thư Về Nghệ Thuật",301400,499000,197600,40
TIKI,nha-sach-tiki,109298270,"Sách Cẩm Nang Con Gái (Tái Bản)",47500,68000,20500,30
TIKI,nha-sach-tiki,145092110,"Cách Biến Đổi Câu Trong Tiếng Anh",57900,80000,22100,28
TIKI,nha-sach-tiki,171549954,"Tâm Hồn Cao Thượng",150000,220000,70000,32
TIKI,nha-sach-tiki,130230750,"Combo 10 Tập - Truyện tranh song ngữ Việt-Anh dành cho trẻ em - Cùng học cư xử tốt",278000,280000,2000,1
TIKI,nha-sach-tiki,189643106,"Tự Tôn",117700,169000,51300,30
TIKI,nha-sach-tiki,194197858,"Achievers grade 7 Workbook",112000,112000,0,0
TIKI,nha-sach-tiki,72542474,"Biên Niên Cô Đơn (Bản Thông Thường)",72000,99000,27000,27
TIKI,nha-sach-tiki,190705658,"Bật Khóc Ở H Mart",104000,140000,36000,26
TIKI,nha-sach-tiki,46259908,"Fibonacci Trading",299000,299000,0,0
TIKI,nha-sach-tiki,10244763,"Bút quay nghệ thuật - Era PS Mod",99000,99000,0,0
TIKI,nha-sach-tiki,136539753,"Tự Chữa Lành Thông Qua Hiểu Biết Về Khoa Học Tâm Thức",84700,119000,34300,0
TIKI,nha-sach-tiki,137241901,"Thần Số Học: Sức Mạnh Của Những Con Số",98500,139000,40500,29
TIKI,nha-sach-tiki,190242072,"Qủy Ấn - Bộ 2 tập ( Tập 1 và 2) - tặng kèm 1 bookmark",211000,291000,80000,27
TIKI,nha-sach-tiki,193981040,"Birdmen - Tập 5",29000,30000,1000,3
TIKI,nha-sach-tiki,69621516,"Combo sách: Bài thơ - bài hát - câu đố dành cho bé (tái bản 2020)",95000,135000,40000,30
TIKI,nha-sach-tiki,157468180,"Trọn Bộ 4 Quyển Sách Trên Lưng Khổng Tượng - Kinh Doanh Online Trên Sàn Thương Mại Điện Tử - Khởi Nghiệp Với Bán Hàng Qua Mạng và Nhãn Hàng Riêng",481000,796000,315000,40
TIKI,nha-sach-tiki,192048663,"Sáng trăng",57500,75000,17500,23
TIKI,nha-sach-tiki,87149160,"Bộ Cọ Vẽ Chuyên Nghiệp Deli - Dùng Cho Màu Nước/Bột/Sơn Acrylic -Set 4/6 Cây- 73885/73866/73867",40000,88200,48200,55
TIKI,nha-sach-tiki,170345811,"Phân Tích Khách Hàng For Dummies",159000,229000,70000,31
TIKI,nha-sach-tiki,77900450,"Đạo Phật Vỡ Lòng (Tái Bản)",49600,69000,19400,28
TIKI,nha-sach-tiki,58067806,"Từ Vựng Tiếng Anh Thực Hành (Trình Độ Trung Cấp) - English Collocation In Use (Intermediate)",47000,80000,33000,41
TIKI,nha-sach-tiki,38436464,"Khác Biệt Để Bứt Phá (Tái Bản 2019)",89100,128000,38900,30
TIKI,nha-sach-tiki,127377217,"Sách Người Trong Muôn Nghề: Ngành Sáng tạo và Nghệ thuật có gì?",201000,219000,18000,8
TIKI,nha-sach-tiki,185055209,"Osho - Combo Sống Hài Hòa (Yêu, Cảm Xúc, Hiểu)",375000,524000,149000,28
TIKI,nha-sach-tiki,5852521,"Combo Cà Phê Cùng Tony và Trên Đường Băng",186950,186950,0,0
TIKI,nha-sach-tiki,273714632,"Trí Tuệ Do Thái (Tái Bản)",140900,189000,48100,25
TIKI,nha-sach-tiki,54614791,"Từ Điển Tâm Lý - Tính Cách Và Cảm Xúc Đến Từ Đâu ?",94000,128000,34000,27
TIKI,nha-sach-tiki,160585764,"Veil - Thân Nhiệt Của Sắc Cam - Tập 1 (Tặng Kèm Postcard)",92200,109000,16800,15
TIKI,nha-sach-tiki,193177952,"Bản đặc biệt Tổng ôn 30 chuyên đề ngữ pháp tiếng anh cô Trang anh 2023",199000,300000,101000,34
TIKI,nha-sach-tiki,6482397,"Hàn Quốc Dưới Chế Độ Độc Tài Phát Triển Park Chung Hee (1961 – 1979)(Tái Bản 2020)",76000,98000,22000,22
TIKI,nha-sach-tiki,12533371,"Đạo Đức Kinh",66400,99000,32600,33
TIKI,nha-sach-tiki,196001728,"Vạn Sắc Hư Vô",99000,150000,51000,34
TIKI,nha-sach-tiki,165700192,"Lịch Sử Vú",173000,248000,75000,30
TIKI,nha-sach-tiki,75697497,"Lịch Sử Triết Học (Trọn Bộ 2 Tập) (Tập 1: Triết Học Cổ Đại Và Trung Đại + Tập 2: Triết Học Cận Đại Và Hiện Đại)",853000,900000,47000,5
TIKI,nha-cua-doi-song,144203367,"Bộ túi hộp cơm thủy tinh Lock&Lock 3EA LLG428S2IVY (LLG429Dx1, LLG428x1, HWB821GRYx1) - Màu",378000,726000,348000,48
TIKI,nha-cua-doi-song,74605907,"Khăn Tắm/Khăn Mặt Cotton Mềm Mại Thấm Hút Nước 34x75cm Nhanh Khô",33000,33000,0,0
TIKI,nha-cua-doi-song,6643347,"Phích Cắm Chuyển Đổi 3 Chấu Sang 2 Chấu",12000,12000,0,0
TIKI,nha-cua-doi-song,112068381,"Kệ Đa Năng, Kệ Để Đồ Black Kodo Phong Cách Hiện Đại - GM06",202000,220000,18000,8
TIKI,nha-sach-tiki,13797246,"Combo 6 Cuốn Ehon nhật bản - Giờ Chơi Của Bé ( Tái Bản )",125000,174000,49000,28
TIKI,nha-sach-tiki,193896561,"Ninja Rantaro - Tập 59",37100,40000,2900,7
TIKI,nha-cua-doi-song,78010514,"Timer hẹn giờ bật tắt điện tự động KG316T-II/25A/220V",67500,67500,0,0
TIKI,nha-cua-doi-song,76545899,"Bộ Máy Khoan Mài khuôn Khắc mini Đa Năng 100 chi tiết 6 tốc độ Kiotool",545000,545000,0,0
TIKI,nha-cua-doi-song,67932480,"Topper Everon White",899000,899000,0,0
TIKI,nha-sach-tiki,189557422,"THINK OUT OF THE BOOK - Nghĩ Ngoài Sách Vở",190000,220000,30000,14
TIKI,nha-cua-doi-song,193081467,"Ghế Xoay Văn Phòng Lưới Làm Việc Công Thái Học Deli - Tay Gập Thông Minh, Có Chỉnh Lưng, Lưới Thoáng Khí, Chân Xoay Tiện Ích, Đệm Ghế Êm Aí, Nhiều Màu - Phù Hợp Học Sinh, Văn Phòng, Game Thủ, Gaming - Hàng chính hãng",886000,1978200,1092200,55
TIKI,nha-cua-doi-song,186693022,"Cây lau nhà tự vắt Kitimop-Red bàn lau lớn 38cm, con lăn trợ lực, thanh thép không gỉ, khớp xoay 360 độ, 2 bông lau",139000,225000,86000,38
TIKI,nha-cua-doi-song,59401658,"Cuộn Đèn LED Trang Trí Quấn Cây RGB Chống Nước, Dài 5M Kèm Remote 44 Phím",115000,115000,0,0
TIKI,nha-cua-doi-song,183254388,"Ô (Dù) Tự Động 2 Chiều Cao Cấp Teement, Che Mưa, Che Nắng, Chống UV - Hàng Chính Hãng",170000,170000,0,0
TIKI,nha-cua-doi-song,121330266,"sét 10 bóng Đèn Led 3w Ánh Sáng Trắng",4000,4000,0,0
TIKI,nha-cua-doi-song,73113608,"Bình PET Đựng Nước Tròn Có Vòi 10 Lít Duy Tân thân bình trong suốt giao quai màu ngẫu nhiên (Ø 20 x 40.2 cm) No.625 ",65000,65000,0,0
TIKI,nha-cua-doi-song,26387653,"KỆ ĐỂ GIÀY DÉP 3 TẦNG 80 CM",209000,300000,91000,30
TIKI,nha-cua-doi-song,270862442,"Ổ Cắm Điện Đa Năng Chống Giật Có 3 Cổng USB, Sạc Trực Tiếp, Tiết Kiệm Điện – Bộ Ổ Cắm Điện Xanh Lá Cao Cấp Chính Hãng - (Model ngẫu nhiên)",69000,100000,31000,31
TIKI,nha-cua-doi-song,172950048,"Kệ Nhà Bếp Đa Năng, Kệ Để Lò Vi Sóng Chính Hãng IGA - GM05",213000,232000,19000,8
TIKI,nha-cua-doi-song,163580111,"Bọ xiphong ống thoát chậu rửa chén siêu to",450000,450000,0,0
TIKI,nha-cua-doi-song,980512,"Cân Nhơn Hòa NHS-5 (5kg) - Hàng Chính Hãng",320000,320000,0,0
TIKI,nha-cua-doi-song,208761326,"Chai xịt chuột thái land rat off",84000,84000,0,0
TIKI,nha-cua-doi-song,56247996,"Kệ sách mini bằng gỗ, để trên bàn làm việc hoặc bàn học. Hàng tự lắp ghép đa năng, thông minh. Gồm 3 màu đẹp hiện đại",50249,50249,0,0
TIKI,nha-cua-doi-song,182148476,"Combo Móc Dán Tường In Hình Họa Tiết Dễ Thương Loại Lớn PaKaSa - Hàng Chính Hãng ( Giao họa tiết ngẫu nhiên )",39000,58000,19000,33
TIKI,nha-cua-doi-song,122311338,"Nhang Nụ Trầm Hương tự nhiên khói chảy ngược - Hộp 40 nụ - Mùi thơm dịu nhẹ, không cay mắt, không kích mũi - Thiên Mộc Hương",261000,350000,89000,25
TIKI,nha-cua-doi-song,165705675,"Cọ vệ sinh Bình Giữ Nhiệt chuyên dụng, Cứng cáp, Đế gỗ",150000,150000,0,0
TIKI,nha-cua-doi-song,125555122,"Bàn Học, Bàn Làm Việc Gấp Gọn Hiện Đại Thương Hiệu IGA - GP154",155000,169000,14000,8
TIKI,nha-cua-doi-song,230013933,"Kệ Sách Để Bàn Phong Cách Nordic Thương Hiệu IGA - GP176",281000,305000,24000,8
TIKI,nha-cua-doi-song,191057553,"Ổ Cắm Điện Thông Minh USB Cao Cấp Jodily StarHome",185000,185000,0,0
TIKI,nha-cua-doi-song,77947848,"Kệ Chén Đĩa Thép Cao Cấp Sơn Đen Tĩnh Điện Kèm Khay Ráo Nước VANDO, Giá Kệ Úp Bát Đa Năng",429000,656000,227000,35
TIKI,nha-cua-doi-song,169208802,"Vỏ gối chất liệu Cotton 40x60, 50x70 mềm mại siêu rẻ cho khách sạn, phòng ngủ, phòng trọ",30000,30000,0,0
TIKI,nha-cua-doi-song,174128094,"SALE SỐC NỆM VĂN PHÒNG- ĐỆM NGỦ VĂN PHÒNG CHỐNG THẮM NƯỚC 75 X 180 X 3CM ( GIAO MÀU NGẪU NHIÊN )",259000,350000,91000,26
TIKI,nha-cua-doi-song,194125082,"Khăn mặt sợi tre MORI xuất Nhật cao cấp 30x50cm",20900,38000,17100,45
TIKI,nha-cua-doi-song,160310283,"Găng Tay Tắm Funu Giúp Tẩy Tế Bào Chết, Làm Sạch Da - Giao Màu Ngẫu Nhiên",33000,33000,0,0
TIKI,nha-cua-doi-song,116681853,"Bình Giữ Nhiệt Lock&Lock Featherlight One-touch Tumbler 500ml LHC3257 - Hàng Chính Hãng - Tặng Kèm Ống Hút Inox",309000,537000,228000,42
TIKI,nha-cua-doi-song,116191376,"Nhang trầm hương tự nhiên Thiên Mộc Hương 30cm, Ít Khói, Thơm Nhẹ, Dễ Chịu, Không kích mũi",89000,150000,61000,41
TIKI,nha-cua-doi-song,125084260,"Vỏ gối ôm cotton tici Lidaco kích thước 35x100cm",35000,39000,4000,10
TIKI,nha-cua-doi-song,152521474,"Combo 200 Túi Lọc Rác Bồn Rửa Bát - Túi Lưới Lọc Rác Giúp Ngăn Chặn Tắc Đường Ống- Hàng Loại 1 - Chính Hãng MINIIN",56050,59000,2950,5
TIKI,nha-cua-doi-song,76658958,"Khăn Tắm Khách Sạn 5 sao – Cotton 100% - Sợi se đôi cao cấp – Thấm hút cực tốt - Kích thước lớn 70 x 140 cm có thể quấn quanh người",53888,53888,0,0
TIKI,nha-cua-doi-song,72652196,"Bộ túi hộp cơm thủy tinh Lock&Lock 3EA (LLG429Dx1,LLG428x1,BAG-HPL815SGRYx1) LLG428S2GRY - Màu",337000,649000,312000,48
TIKI,nha-cua-doi-song,98804083,"Bóng Đèn Thông Minh TP-Link Tapo L530E Đa Sắc - Hàng Chính Hãng",199000,398000,199000,50
TIKI,nha-cua-doi-song,95043563,"Khăn tắm sợi tre Bamboo Life hàng chính hãng Khăn lau người mềm mại kháng khuẩn siêu thấm hút an toàn cho da ngay cả với trẻ sơ sinh BL046",65000,65000,0,0
TIKI,nha-cua-doi-song,108605078,"Pin kiềm Akaline AA Deli - Vỉ 2 viên/ 4 viên - 18500 / 18501",30600,30600,0,0
TIKI,nha-cua-doi-song,194005519,"Ghế Kê Chân Văn Phòng, Chịu lực 200 kg Plyconcept Seiza Chair - Gỗ Uốn Cong",160000,280000,120000,43
TIKI,nha-cua-doi-song,108936951,"Bảng Gỗ Quy Tắc Gia Đình, Tranh Treo Tường Gia đình, Những Quy Tắc Để Con Có Cuộc Sống Hạnh Phúc",160000,160000,0,0
TIKI,nha-cua-doi-song,1611899,"Vợt Muỗi Điện Quang ĐQ EMR02 WR - Trắng Phối Đỏ",115855,136300,20445,15
TIKI,nha-cua-doi-song,57712474,"Keo dán đa năng trên mọi bề mặt 50ml+ Tặng kèm miếng dán nam châm",41000,41000,0,0
TIKI,nha-cua-doi-song,161030427,"Cây lau trần nhà, chổi quét trần nhà đa năng hình tam giác - Kitimop A3",149000,199000,50000,25
TIKI,nha-cua-doi-song,48522643,"Nhiệt ẩm kế cao cấp TT-513 Nhật Bản, đo nhiệt độ phòng, độ ẩm không khí- sản phẩm cần thiết trong mỗi gia đình",197000,296000,99000,33
TIKI,nha-cua-doi-song,48488492,"Đèn Ngủ Hình Mèo Con Siêu Dễ Thương - Chất liệu Silicon Dẻo Cao Cấp An Toàn ",90000,157725,67725,43
TIKI,nha-cua-doi-song,117059826,"Giấy lọc cà phê Hario 100 cái (V60-VCF-02-100W)",99000,99000,0,0
TIKI,nha-cua-doi-song,111472777,"Miếng Dán Tường Đa Năng SenNai - Móc Dán Cây Lau Nhà Loại Tốt - Chịu Tải Lên Đến 5kg",17820,18000,180,1
TIKI,nha-cua-doi-song,198193045,"Khăn lau kính lau xe ma thuật không để lại vết mờ - Hàng cao cấp - Hàng hót 2022",16900,16900,0,0
TIKI,nha-cua-doi-song,183029245,"Mền lông cừu Caro cao cấp A kích thước 1m8 x 2m",195000,195000,0,0
TIKI,nha-cua-doi-song,73467694,"Kệ để lò vi sóng đa năng Inox 304 cao cấp Vando chính hãng kệ để đồ lò nướng chắc chắn, sơn tĩnh điện chống bong tróc, kệ nhà bếp siêu chịu lực 300kg",1099000,1099000,0,0
TIKI,nha-cua-doi-song,141143706,"Ly Giữ Nhiệt Cà Phê Nắp Trượt Chống Tràn Rinfere (295ml)",249000,349000,100000,29
TIKI,nha-cua-doi-song,79691104,"Bộ Hộp Cơm Giữ Nhiệt Văn Phòng Cao Cấp Cắm Điện inox 3 tầng - Chính Hãng",209000,300000,91000,30
TIKI,nha-cua-doi-song,94891198,"Hộp Cơm Giữ Nhiệt INOX304 Hiện Đại Kèm Hộp Đựng Canh Soup và Bộ Đũa Thìa INOX – Chất Liệu Cao Cấp An Toàn Cho Sức Khỏe – Hàng Chính Hãng Vinbuy",281000,500000,219000,44
TIKI,nha-cua-doi-song,162577287,"Cuộn Dây 5m/10m Đèn LED Trang Trí RGB 5050 Strip Light miDoctor, Quấn Cây Chống Nước, Trang Trí Phòng, Dán Tường, Bàn Máy Tính, Tạo Không Gian Quay Video Tiktok, Chụp Ảnh, Kèm Remote 44 Phím",115000,115000,0,0
TIKI,nha-cua-doi-song,178936441," Đũa Gỗ Mộc Hương Cao Cấp - Gỗ Tự Nhiên - Đánh Bóng Thủ Công - Không Ẩm Mốc - Vỉ 10 đôi ",135000,135000,0,0
TIKI,nha-cua-doi-song,104027916,"Bộ gối tựa lưng và đệm lót ghế chống đau xương cụt Ema loại có gel cao cấp cho dân văn phòng, lái xe, sinh viên",330000,660000,330000,50
TIKI,nha-cua-doi-song,25055074,"Tủ vải quần áo 3 buồng 8 ngăn, khách được chọn màu,  khung sắt sơn tĩnh điện, vải không dệt",210000,210000,0,0
TIKI,nha-cua-doi-song,127152344,"Chổi Cọ Nhà Vệ Sinh Bồn Cầu Toilet Không Dây Đa Năng SENNAI Pin 4000mAh - Hàng Chính Hãng",129000,195000,66000,34
TIKI,nha-cua-doi-song,186348775,"Đệm ngồi ghế văn phòng chống đau xương cụt, ê mông, thâm mông, xệ mông cho dân văn phòng, lái xe, học sinh - Thương hiệu EMA - Loại cao cấp có gel tản nhiệt",285000,570000,285000,50
TIKI,nha-cua-doi-song,143861521,"Dây Led Neon Flex 12V Kèm Nguồn Dài 1M/2M/3M/5M Trang Trí Cổ Điển",100000,100000,0,0
TIKI,nha-cua-doi-song,59500188,"Gối cổ chữ U cao su non Nice Food",115000,115000,0,0
TIKI,nha-cua-doi-song,193541405,"Áo Mưa Bít Trẻ Em Cho Bé Cute Dễ Thương Siêu Dày Chống Thấm Nước Có Phản Quang Phơi Mau Khô Ráo Che Kín Người Kèm Túi Đựng Deli - Chất Liệu An Toàn Có Lựa Chọn Nhiều Size Màu Sắc",196000,340200,144200,42
TIKI,nha-cua-doi-song,121268576,"Ổ cắm điện 5 lỗ 2m Điện Quang SM750SL - Hàng Chính Hãng",166000,166000,0,0
TIKI,nha-cua-doi-song,134360863,"Vỉ 6 Viên Pin AA , Pin AAA Energizer Max 1,5V Alkaline - Hàng chính hãng",79000,90000,11000,12
TIKI,nha-cua-doi-song,83927711,"Bịt Mắt Ngủ Che Mắt Ngủ Có Túi Gel Massage - Giảm Thâm Quầng Mắt - Mẫu Hoạt Hình Mới - Xanh Nhạt",35000,35000,0,0
TIKI,nha-cua-doi-song,69843631,"CÂY TREO QUẦN ÁO HÀN QUỐC GỖ LẮP RÁP- STANDING HANGER- BLUE HOME- MÀU GỖ TỰ NHIÊN",259000,279000,20000,7
TIKI,nha-cua-doi-song,53098903,"Giá treo khăn - Vắt Khăn tắm, Giá treo khăn tắm inox 304 Đa năng 2 tầng, có móc treo quần áo Cao Cấp",380000,510000,130000,25
TIKI,nha-cua-doi-song,76451291,"Đèn Led Đom Đóm Dây Kẽm Dễ Uốn Kèm Pin CR2032",9999,9999,0,0
TIKI,nha-cua-doi-song,191918105,"Bộ Bàn Chải Vệ Sinh Các Khe LocknLock ETM415 - 2 cái/bộ",20000,39000,19000,49
TIKI,nha-cua-doi-song,147694768,"găng tay làm bếp nấu ăn siêu dai Victoria Bay chất liệu TPE không mùi chống nhăn hộp 100 cái size M",11000,16998,5998,35
TIKI,nha-cua-doi-song,130769103,"Bộ 12 Hũ Thủy Tinh Sọc Làm Sữa Chua 100ml, Hũ Lọ Yaourt, Lọ Pudding, Hủ Làm Sữa Chua, Caramen- Có Nắp Đậy- Hàng Chính Hãng MINIIN",56000,65000,9000,14
TIKI,nha-cua-doi-song,184282768,"Combo 6 túi giặt 3 lớp bảo vệ quần áo, đồ lót dùng cho máy giặt chính hãng Dododios",149000,149000,0,0
TIKI,nha-cua-doi-song,56228508,"Phân bón hữu cơ dịch chuối DOCNEEM, phân bón cho phong lan, hoa hồng, cây cảnh kích rễ, kích kei, chồi, mầm, chai 1 lít",119000,119000,0,0
TIKI,nha-cua-doi-song,108918404,"GA GIƯỜNG THUN LẠNH MÀU TRƠN - Xám chì - Ga lẻ 1x2m nệm 5->15cm",100000,100000,0,0
TIKI,nha-cua-doi-song,143363686,"Băng keo chống thấm x2000 Nhật Bản chống thấm dột, dán tường, dán mái tôn, dán ống nước",24000,40000,16000,40
TIKI,nha-cua-doi-song,135156091,"Tua vít bake thép 3*100mm",10000,10000,0,0
TIKI,nha-cua-doi-song,192635575,"Combo Chén/ Bát gáo dừa + Muỗng gỗ dừa DK Harvest - Loại size lớn 12 - 14cm (Loại Xuất khẩu)",38000,38000,0,0
TIKI,nha-cua-doi-song,200762341,"Cốc Giữ Nhiệt Ly Giữ Nhiệt Inox 304 Có Ống Hút Ly Uống Coffee 600ml",88312,88312,0,0
TIKI,dien-thoai-may-tinh-bang,273659145,"Máy tính bảng Masstel Kidzone dành cho bé - quản lý thời gian cho bé - bé học tốt, hiệu quả cao - 1 đổi 1 trong 100 ngày - Hàng chính hãng",2990000,3990000,1000000,25
TIKI,dien-thoai-may-tinh-bang,249851724,"Điện Thoại 4G Masstel Lux 10 - 2 Sim 2 Sóng - Sóng 4G HD Call - Loa To Rõ - Pin Bền - Hàng Chính Hãng - Bảo Hành 12 Tháng",675000,675000,0,0
TIKI,dien-thoai-may-tinh-bang,223859345,"Điện thoại Masstel Fami 60 - Hàng chính hãng ",730000,730000,0,0
TIKI,dien-thoai-may-tinh-bang,200819471,"Điện thoại Mobell Rock 4 4G , Pin 3250mah , Loa Siêu lớn - Hàng chính hãng",685000,799000,114000,14
TIKI,dien-thoai-may-tinh-bang,200829966,"Điện thoại Mobell M239 4G - 2 SIM - Hàng chính hãng",415000,500000,85000,17
TIKI,dien-thoai-may-tinh-bang,274611998,"Điện thoại Xiaomi Redmi 12 (4GB/128GB) - Hàng chính hãng",3790000,3790000,0,0
TIKI,dien-thoai-may-tinh-bang,205815576,"Apple iPad 10.9-inch (10th Gen) Wi-Fi, 2022",9990000,12990000,3000000,23
TIKI,dien-thoai-may-tinh-bang,271364652,"Máy tính bảng Xiaomi Pad 6 (8GB/128GB) -  Hàng chính hãng - Đã kích hoạt bảo hành điện tử",8790000,9490000,700000,7
TIKI,dien-thoai-may-tinh-bang,250109584,"Điện thoại Xiaomi Redmi Note 12 (4GB/128GB) - Hàng chính hãng",3600000,4990000,1390000,28
TIKI,dien-thoai-may-tinh-bang,270473116,"Điện thoại Xiaomi Redmi Note 12 (8GB/128GB) - Hàng chính hãng",4489000,5790000,1301000,22
TIKI,dien-thoai-may-tinh-bang,179547641,"Máy đọc sách Kindle Paperwhite 5 (8GB) - Hàng chính hãng",3750000,3750000,0,0
TIKI,dien-thoai-may-tinh-bang,246163082,"Điện Thoại Nokia C30 2GB/32GB - Hàng Chính Hãng",1599000,2290000,691000,30
TIKI,dien-thoai-may-tinh-bang,273438769,"Điện thoại Xiaomi Redmi A2 2GB/32GB MediaTek Helio G36 , Pin 5000 mAh - Hàng chính hãng",1669000,2190000,521000,24
TIKI,dien-thoai-may-tinh-bang,274638556,"BÚT MÁY ĐỌC SÁCH KINDLE SCRIBE - HÀNG CHÍNH HÃNG",2500000,2500000,0,0
TIKI,dien-thoai-may-tinh-bang,249890677,"Điện Thoại Xiaomi Redmi Note 12 4GB/128GB - Hàng Chính Hãng",3599000,4990000,1391000,28
TIKI,dien-thoai-may-tinh-bang,263309601,"Điện thoại siêu bền Oukitel K16(mini,Vỏ lưng bằng da,Ram 8Gb,Rom 128Gb,camera 48MP,pin 3.050mAh)- hàng chính hãng",4990000,4990000,0,0
TIKI,dien-thoai-may-tinh-bang,272273169,"Điện thoại Samsung Galaxy M34 5G (8GB/128GB) - Hàng chính hãng",7590000,7990000,400000,5
TIKI,dien-thoai-may-tinh-bang,242771940,"Điện Thoại Samsung A04e 3GB/32GB - Hàng Chính Hãng",2109000,2990000,881000,29
TIKI,dien-thoai-may-tinh-bang,271973414,"iPhone 15 Pro Max 256GB Titan Tự Nhiên",30990000,33990000,3000000,9
TIKI,dien-thoai-may-tinh-bang,270164674,"Điện thoại OPPO A78 (8GB/256GB) - Hàng Chính Hãng",6990000,6990000,0,0
TIKI,dien-thoai-may-tinh-bang,273559020,"Máy tính bảng Kindle Fire HD10 2023 13th - 32Gb - Hàng chính hãng",3390000,3390000,0,0
TIKI,dien-thoai-may-tinh-bang,274545326,"Điện thoại OPPO A36 6GB/128GB, Chip Snapdragon 680 , Màn 90Hz , Rom Tiếng việt - Hàng nhập khẩu",3050000,3590000,540000,15
TIKI,dien-thoai-may-tinh-bang,274542808,"Điện Thoại Samsung A55 5G 8GB/128GB - Hàng Chính Hãng",9499000,9990000,491000,5
TIKI,dien-thoai-may-tinh-bang,274316036,"Điện Thoại Samsung Galaxy M34 5G 8GB-128GB - Hàng chính hãng",6250000,7990000,1740000,22
TIKI,dien-thoai-may-tinh-bang,191089547,"Điện Thoại Nokia 110 4G - Hàng Chính Hãng",675000,899000,224000,25
TIKI,dien-thoai-may-tinh-bang,271046571,"Điện thoại Xiaomi Redmi Note 12 (8GB/128GB) - Hàng chính hãng",3790000,4790000,1000000,21
TIKI,dien-thoai-may-tinh-bang,198968094,"Điện Thoại Xiaomi Redmi A1 2GB/32GB - Hàng Chính Hãng",1749000,2190000,441000,20
TIKI,dien-thoai-may-tinh-bang,251407092,"Điện Thoại Samsung Galaxy A34 5G (8GB/128GB) ĐKH -  Hàng Chính Hãng",7164000,7164000,0,0
TIKI,dien-thoai-may-tinh-bang,274393574,"Điện thoại Xiaomi Poco C65 - Hàng chính hãng",3090000,3090000,0,0
TIKI,dien-thoai-may-tinh-bang,244308977,"Điện Thoại Xiaomi Redmi 12C 4GB/64GB - Hàng Chính Hãng",3168000,3168000,0,0
TIKI,dien-thoai-may-tinh-bang,202035122,"[HCM]Ốp Lưng IPHONE Cường Lực Trong Suốt Cao Cấp Cho Dòng Iphone 14/14Pro/14Plus/14 Pro Max, Iphone 13Mini/13Pro/13ProMax, Iphone 12/12Pro/12Promax, Iphone 11/11Pro/11ProMax- Hàng nhập khẩu",110000,110000,0,0
TIKI,dien-thoai-may-tinh-bang,230155305,"Điện thoại Xiaomi Redmi Note 10 JE 5G 4GB/64GB - Màn 90HZ - Chống Nước IP68 - Hàng Nhập Khẩu - Bản quốc tế",2276000,3990000,1714000,43
TIKI,dien-thoai-may-tinh-bang,253395356,"Điện Thoại Samsung M14 5G 6GB/128GB - Hàng Chính Hãng",5292000,5292000,0,0
TIKI,dien-thoai-may-tinh-bang,258668285,"Điện thoại cố định Panasonic KX-TS520MX ( màu đen)-Hàng chính hãng",449000,469000,20000,4
TIKI,dien-thoai-may-tinh-bang,216092766,"Điện Thoại Oppo Reno 8T 4G (8GB/256GB)",8136000,8136000,0,0
TIKI,dien-thoai-may-tinh-bang,249169833,"Điện thoại Samsung Galaxy A34 5G 8GB/128GB Đen - Hàng chính hãng",7164000,7164000,0,0
TIKI,dien-thoai-may-tinh-bang,245770248,"Điện thoại Xiaomi Redmi 12C (4GB/64GB) - Hàng chính hãng",3168000,3168000,0,0
TIKI,dien-thoai-may-tinh-bang,274162900,"Điện thoại OPPO A18 4GB-128GB - Hàng chính hãng",3690000,3990000,300000,8
TIKI,dien-thoai-may-tinh-bang,274383701,"Điện thoại Samsung Galaxy A05s 6GB-128GB - Hàng chính hãng",3890000,3890000,0,0
TIKI,dien-thoai-may-tinh-bang,230055130,"Điện thoại Oppo Reno8 T (8GB/256GB) - Hàng chính hãng",10392000,10392000,0,0
TIKI,nha-sach-tiki,49204092,"Tái Tạo Tổ Chức: Phá Vỡ Rào Cản, Thổi Bùng Sinh Khí (Tái Bản)",123000,190000,67000,35
TIKI,nha-sach-tiki,59618902,"Ehon - Hướng Dẫn Sử Dụng Mẹ (Tái Bản 2020)",40800,59000,18200,31
TIKI,nha-sach-tiki,186578993,"Đu Đưa Trên Ngọn Cây Bàng",91500,118000,26500,22
TIKI,nha-sach-tiki,130863107,"Sách Người Tìm Xác tập 1+2 - Truyện trinh thám, linh dị",298000,378000,80000,21
TIKI,nha-sach-tiki,195662905,"Circe",137000,200000,63000,32
TIKI,nha-sach-tiki,175724125,"Chú Thuật Hồi Chiến Tập 2: Chú Thai Đới Thiên [Tặng Kèm Obi Và Thẻ Bo Góc Nhựa]",29000,30000,1000,3
TIKI,nha-sach-tiki,176906739,"UX Writing - Quyền Năng Tối Thượng Của Nội Dung Tương Tác",61000,99000,38000,38
TIKI,nha-sach-tiki,66398387,"Trời Sinh Vụng Về, Hãy Bù Đắp Bằng Sự Kiên Trì",92400,129000,36600,28
TIKI,nha-sach-tiki,77539095,"Nghệ Thuật Dạy Con Từ Kinh Talmud (20 Câu Chuyện Sâu Sắc Từ Bộ Kinh Cổ Của Người Do Thái)",104000,135000,31000,23
TIKI,nha-sach-tiki,32490132,"Một Đời Như Kẻ Tìm Đường",113000,175000,62000,35
TIKI,nha-sach-tiki,129766803,"Sách Khác Biệt Hay Là Chết (Tái Bản)",89100,128000,38900,30
TIKI,nha-sach-tiki,147988202,"Combo 2 Cuốn Tớ Học Lập Trình: Tớ Học Lập Trình - Làm Quen Với Python + Tớ Học Lập Trình - Làm Quen Với Lập Trình Scratch",167000,210000,43000,20
TIKI,nha-sach-tiki,76737958,"Mind Map English Vocabulary - Từ Vựng Tiếng Anh Qua Sơ Đồ Tư Duy",128700,198000,69300,35
TIKI,nha-sach-tiki,58828012,"Ai Lấy Miếng Pho Mát Của Tôi ? - Phiên Bản Dành Cho Độc Giả Nhí",47100,68000,20900,31
TIKI,nha-sach-tiki,273656715,"Trạm Đọc Official |  Tư Duy Nhanh Và Chậm",201000,269000,68000,25
TIKI,nha-sach-tiki,157540009,"Diệt Slime Suốt 300 Năm, Tôi Levelmax Lúc Nào Chẳng Hay (Tập 7)",42000,48000,6000,13
TIKI,nha-sach-tiki,14684952,"Khu Vườn Bí Mật ( Tái Bản 2019 )",71500,96000,24500,26
TIKI,nha-sach-tiki,72027523,"Ehon - Đi Đã Ngoại Ngày Mưa (Tái Bản 2020)",39100,55000,15900,29
TIKI,nha-sach-tiki,192913462,"Lớp 7(bộ Kết nối, Cánh diều, Chân trời) - Sách Siêu trọng tâm môn Toán, Anh, KHTN - Nhà sách Ôn luyện",80000,160000,80000,50
TIKI,nha-sach-tiki,188767663,"Quỷ Giá - Bản Thường ( Tặng kèm 1 Bookmark 2 mặt)",124000,159000,35000,22
TIKI,nha-sach-tiki,867314,"Tuần Của Bé - Bé Sạch Sẽ",11500,23000,11500,50
TIKI,nha-sach-tiki,4040663,"25 Chuyên Đề Ngữ Pháp Tiếng Anh Trọng Tâm – (Tập 1)",71000,110000,39000,35
TIKI,nha-sach-tiki,13673964,"Giây Thứ 12 - Tập 1 (Trinh Thám)",42000,87000,45000,52
TIKI,nha-sach-tiki,125362334,"Dinh Dưỡng Thai Kỳ (Mẹ Bầu Ăn Gì Giúp Con Phát Triển Toàn Diện Và Thông Minh",122000,189000,67000,35
TIKI,nha-sach-tiki,68437861,"Đừng Chết Bởi Canxi",110000,159000,49000,31
TIKI,nha-sach-tiki,74277389,"Combo 4 Cuốn: Bộ Tuyển Tập Truyện Hay Dành Cho Thiếu Nhi (Tái Bản)",133000,192000,59000,31
TIKI,nha-sach-tiki,194205609,"Ai Đó Chạy Cùng Ta",175000,225000,50000,22
TIKI,nha-sach-tiki,188535073,"Tối Giản Thông Thái",75700,96000,20300,21
TIKI,nha-sach-tiki,151597210,"Practice Test Grade 6",118000,118000,0,0
TIKI,nha-sach-tiki,55071991,"Combo Trọn Bộ 6 Cuốn Giáo Trình Hán Ngữ",512400,732000,219600,30
TIKI,nha-sach-tiki,176132374,"Truyện Thiếu Nhi Hạt Giống Tâm Hồn - Điều Ước Gửi Các Vì Sao",46000,56000,10000,18
TIKI,nha-sach-tiki,7804743,"Bí mật - The secret",238000,298000,60000,20
TIKI,nha-sach-tiki,58220389,"Mô Hình Biểu Đồ - Phương pháp Hiệu quả để Tìm kiếm Lợi nhuận",368000,368000,0,0
TIKI,nha-sach-tiki,112333133,"Quý Cô Thịnh Vượng - Khi Phụ Nữ Tư Duy Đúng Về Tiền",68900,89000,20100,23
TIKI,nha-sach-tiki,164336681,"Việt Nam Danh Tác - Bỉ Vỏ",69700,90000,20300,23
TIKI,nha-sach-tiki,197464901,"Bẩm Thầy Tường Có Thầy Vũ Tới Tìm - Tập 2",97800,115000,17200,15
TIKI,nha-sach-tiki,190859600,"Lôi Thần Và Nhân Viên Văn Phòng (Tập 4)",58400,66000,7600,12
TIKI,nha-sach-tiki,190702862,"Siddhartha",79000,120000,41000,34
TIKI,nha-sach-tiki,186290792,"Bồ Câu Không Đưa Thư (Tái Bản 2022)",27800,38000,10200,27
TIKI,nha-sach-tiki,8288935,"Của Chuột Và Người",68400,76000,7600,10
TIKI,dien-thoai-may-tinh-bang,270814388,"Điện thoại Tecno POVA 5 (8+8)/128GB - MediaTek Helio G99 - Sạc nhanh 45W - 6.8'' FHD+120HZ - Hàng Chính Hãng - BH 13 Tháng",3690000,4490000,800000,18
TIKI,dien-thoai-may-tinh-bang,217276360,"Điện thoại Mobell F209 4G ,Loa to, Phím lớn - Hàng chính hãng",567000,670000,103000,15
TIKI,dien-thoai-may-tinh-bang,272151221,"Điện thoại Xiaomi Redmi 10 2022 (4GB/128GB) - Hàng chính hãng",2690000,3990000,1300000,33
TIKI,dien-thoai-may-tinh-bang,273951550,"Điện Thoại Samsung Galaxy A15 LTE (8GB/128GB)- Đã Kích Hoạt Bảo Hành Điện tử - Hàng Chính Hãng",4290000,4990000,700000,14
TIKI,dien-thoai-may-tinh-bang,273668660,"Điện Thoại Oppo A18 4GB/64GB - Hàng Chính Hãng",3329000,3690000,361000,10
TIKI,dien-thoai-may-tinh-bang,248762051,"Điện Thoại Samsung A34 5G 8GB/128GB - Hàng Chính Hãng",5939000,8490000,2551000,30
TIKI,dien-thoai-may-tinh-bang,273367316,"Điện Thoại Xiaomi Redmi 13C 6GB/128GB - Hàng Chính Hãng",2979000,3490000,511000,15
TIKI,dien-thoai-may-tinh-bang,273165324,"Điện thoại Xiaomi Redmi A2 (2GB/32GB) - Hàng chính hãng",2190000,2190000,0,0
TIKI,dien-thoai-may-tinh-bang,273683300,"Điện thoại Samsung Galaxy A15 LTE (8GB/128GB) - Hàng chính hãng",4990000,4990000,0,0
TIKI,dien-thoai-may-tinh-bang,173789184,"Điện thoại bàn treo tường TC990",250000,250000,0,0
TIKI,dien-thoai-may-tinh-bang,274365104,"Điện thoại Xiaomi Redmi Note 13 Pro (8GB/128GB) - Hàng Chính Hãng",5990000,7290000,1300000,18
TIKI,dien-thoai-may-tinh-bang,203853390,"Điện Thoại Oppo A17k (3GB/64GB)",2390000,3290000,900000,27
TIKI,dien-thoai-may-tinh-bang,203278278,"Điện Thoại Samsung A04 3GB/32GB - Hàng Chính Hãng",2159000,2990000,831000,28
TIKI,dien-thoai-may-tinh-bang,271967379,"iPhone 15 Plus",22490000,25990000,3500000,13
TIKI,dien-thoai-may-tinh-bang,103168844,"Máy tính bảng Samsung Galaxy Tab A7 Lite LTE SM-T225) - ĐÃ KÍCH HOẠT ĐIỆN TỬ - Hàng Chính Hãng",3587000,3587000,0,0
TIKI,dien-thoai-may-tinh-bang,270544863,"Điện Thoại Samsung Galaxy A24 (8GB/128GB) - Hàng Chính Hãng",6084000,6084000,0,0
TIKI,dien-thoai-may-tinh-bang,272241346,"Điện thoại Samsung Galaxy A05s (4GB/128GB) - Hàng chính hãng",3990000,3990000,0,0
TIKI,dien-thoai-may-tinh-bang,274456447,"Điện thoại Samsung Galaxy A35 5G (8GB/128GB) - Hàng chính hãng",7949000,8290000,341000,4
TIKI,dien-thoai-may-tinh-bang,225936344,"Máy tính bảng Samsung Galaxy Tab A8 (4GB/64GB) - Hàng Chính Hãng",5856000,5856000,0,0
TIKI,dien-thoai-may-tinh-bang,219397711,"Điện thoại Samsung Galaxy A14 5G A146P (4+128G) Đen - Hàng Chính Hãng (chỉ giao HN và một số khu vực)",5080000,5080000,0,0
TIKI,dien-thoai-may-tinh-bang,191636459,"Điện thoại Masstel IZI 11 4G - Hàng chính hãng",468000,468000,0,0
TIKI,dien-thoai-may-tinh-bang,253443788,"Điện Thoại Samsung Galaxy M14 5G (4GB/64GB) - Hàng Chính Hãng",6000000,6000000,0,0
TIKI,dien-thoai-may-tinh-bang,248655651,"Điện Thoại Samsung Galaxy A14 5G (4GB/128GB) - Hàng chính hãng - ĐÃ KÍCH HOẠT BẢO HÀNH ĐIỆN TỬ",5000000,5000000,0,0
TIKI,dien-thoai-may-tinh-bang,273029857,"Điện Thoại Samsung Galaxy A05s (4GB/128GB) - Hàng Chính Hãng",3980000,3980000,0,0
TIKI,dien-thoai-may-tinh-bang,251448280,"Samsung Galaxy A34 5G A346E (8+128G) Silver Bạc - Hàng Chính Hãng (chỉ giao HN và một số khu vực)",7164000,7164000,0,0
TIKI,dien-thoai-may-tinh-bang,215746882,"Điện thoại OPPO Reno8T 4G - Hàng chính hãng",8136000,8136000,0,0
TIKI,dien-thoai-may-tinh-bang,273897681,"Điện thoại Tecno SPARK GO 2024 (4+4)GB/64GB - Unisoc T606 | 5000 mAh | 6,6" HD+ | Hàng Chính Hãng",2009000,2190000,181000,8
TIKI,dien-thoai-may-tinh-bang,217559440,"Điện thoại Samsung Galaxy A03s (3GB/32GB) - Hàng chính hãng",2990000,2990000,0,0
TIKI,dien-thoai-may-tinh-bang,196197701,"Điện thoại Samsung Galaxy Z Fold4 5G (12GB/256GB) - Hàng chính hãng",40990000,40990000,0,0
TIKI,dien-thoai-may-tinh-bang,273653444,"Máy tính bảng Kindle Fire Hd 10 2023 13th - Hàng nhập khẩu",3790000,3790000,0,0
TIKI,dien-thoai-may-tinh-bang,272056889,"Điện Thoại Samsung A24 6GB/128GB - Hàng Chính Hãng",4789000,6490000,1701000,26
TIKI,dien-thoai-may-tinh-bang,204802771,"Điện thoại Oppo A57 (4GB/128GB) - Hàng chính hãng",4632000,4632000,0,0
TIKI,dien-thoai-may-tinh-bang,273610105,"Điện Thoại Samsung Galaxy A05 - Hàng Chính Hãng",3025000,3025000,0,0
TIKI,dien-thoai-may-tinh-bang,273348837,"Điện thoại Xiaomi Redmi 13C (6GB/128GB) - Hàng chính hãng",2890000,3290000,400000,12
TIKI,dien-thoai-may-tinh-bang,213858174,"Máy tính bảng Samsung Galaxy Tab A7 Lite (3GB/32GB) - Hàng chính hãng - Màn hình 8.7inch TFT LCD, Camera sau 8MP - Bảo Hành 12 Tháng",3587000,3587000,0,0
TIKI,dien-thoai-may-tinh-bang,219392186,"Điện thoại OPPO CPH2471 - A17k Vàng - Hàng Chính Hãng (chỉ giao HN và một số khu vực)",3276000,3276000,0,0
TIKI,dien-thoai-may-tinh-bang,267178005,"Điện thoại Samsung Galaxy A24 - Hàng chính hãng",5808000,5808000,0,0
TIKI,dien-thoai-may-tinh-bang,271799133,"Máy tính bảng chắc chắn oukitel RT5 (chống nước,chống va đập,pin 11.000mAh,Màn hình 10.1 inch FHD, Ram 14Gb,Rom 256Gb, CPU : Mediatek 8788,lõi 8, lên đến 2.0 GHz, Camera Trước,sau 16 MP, Android 13)- hàng chính hãng",7490000,7490000,0,0
TIKI,dien-thoai-may-tinh-bang,263060294,"Điện thoại di động Samsung A24 (6G/128G) - Hàng chính hãng - Đã kích hoạt bảo hành điện tử",5808000,5808000,0,0
TIKI,dien-thoai-may-tinh-bang,242712931,"Điện thoại Samsung Galaxy S23 Ultra 512GB - Hàng chính hãng",36990000,36990000,0,0
TIKI,nha-sach-tiki,184334565,"Bút vẽ kỹ thuật / Bút vẽ nét/ bút lông kim Fine Pen cơ bản – chuyên nghiệp mực đen",22000,30000,8000,27
TIKI,nha-sach-tiki,191926693,"Trái cây đại chiến Zombie - Thế giới khủng long: Tập 9 - Trên đảo khủng long",58000,89000,31000,35
TIKI,nha-sach-tiki,196394972,"Thương Tiến Tửu - Tập 2",133000,169000,36000,0
TIKI,nha-sach-tiki,160585832,"Veil – Sắc Trắng Yêu Kiều - Tập 3 (Tặng Kèm Postcard)",90000,109000,19000,17
TIKI,nha-sach-tiki,196305158,"Vì Cuộc Đời Không Hẹn Lần Sau",106000,139000,33000,24
TIKI,nha-sach-tiki,142833447,"Sanctify - Tập 3",89700,109000,19300,18
TIKI,nha-sach-tiki,273401813,"Tết Ở Làng Địa Ngục",116000,169000,53000,31
TIKI,nha-sach-tiki,176909238,"Hà Nội Còn Một Chút Này",84000,109000,25000,23
TIKI,nha-sach-tiki,187843292,"Hoa trên mộ Algernon",112000,150000,38000,25
TIKI,nha-sach-tiki,148008757,"Combo 2 Cuốn "Tim Marshall": "Những Tù Nhân Của Địa Lý" + "Chia Rẽ - Tại Sao Chúng Ta Đang Sống Trong Thời Đại Của Những Bức Tường"",281000,410000,129000,31
TIKI,nha-sach-tiki,71149569,"Cách kiếm lợi nhuận 18.000% từ thị trường chứng khoán - Trade Like An O'Neil Disciple",499000,499000,0,0
TIKI,nha-sach-tiki,189326211,"Văn phòng thám tử quái vật - Tập 08",21100,30000,8900,30
TIKI,nha-sach-tiki,980770,"Chí Phèo",31700,48000,16300,34
TIKI,nha-sach-tiki,76826978,"Sức Mạnh Chữa Lành Của Tinh Dầu",121000,169000,48000,28
TIKI,nha-sach-tiki,598974,"Dạy Con Làm Giàu 05 - Để Có Sức Mạnh Về Tài Chính",98200,160000,61800,39
TIKI,nha-sach-tiki,4077687,"Bài Tập Trắc Nghiệm Tiếng Anh 9 (Có Đáp Án)",37100,56000,18900,34
TIKI,nha-sach-tiki,94132196,"Bộ Luật Lao Động Hiện Hành (Mới Nhất) Thông Qua Tại Kỳ Họp Thứ 8 Quốc Hội Khóa XIV",51000,119000,68000,57
TIKI,nha-sach-tiki,185408437,"Bút Bi Nước Mực Gel Bấm Ngòi 0.5mm Deli - Mực Đen Nhanh Khô, Viết Đều, Trơn Tru, Phù Hợp Văn Phòng Học Sinh - S08-B",6000,11700,5700,49
TIKI,nha-sach-tiki,173481387,"Eo Thon Nhỏ",163000,239000,76000,32
TIKI,nha-sach-tiki,195827102,"(Bìa cứng in màu trên giấy cóuche - tặng kèm postcard) SƠN HẢI KINH – Lương Siêu biên soạn – Sam Trạch minh họa – An Lạc Group dịch – Wingbooks - NXB Kim Đồng",325000,325000,0,0
TIKI,nha-sach-tiki,76531748,"Sách DevUP",149000,149000,0,0
TIKI,nha-sach-tiki,187827445,"Lược Sử Thời Gian",79000,115000,36000,31
TIKI,nha-sach-tiki,446881,"Các Thế Giới Song Song (Tái Bản 2018)",95500,128000,32500,25
TIKI,nha-sach-tiki,112332742,"English Grammar In Use - 130 Bài Ngữ Pháp Tiếng Anh (Tái Bản)",115000,165000,50000,30
TIKI,nha-sach-tiki,167940010,"Thao Túng Tâm Lý",118300,169000,50700,30
TIKI,nha-sach-tiki,146225297,"Flow - Dòng Chảy",175600,228000,52400,23
TIKI,nha-sach-tiki,3152291,"Hướng Dẫn Giao Dịch Theo Sóng Elliott",369000,369000,0,0
TIKI,nha-sach-tiki,126742911,"Món Quà Của Linh Hồn - Sức Mạnh Chữa Lành Của Những Thữ Thách Trong Cuộc Sống",206000,289000,83000,29
TIKI,nha-sach-tiki,69219919,"Muôn Kiếp Nhân Sinh (Khổ Nhỏ)",73500,98000,24500,25
TIKI,nha-sach-tiki,17719704,"Hạn Chót Lúc Bình Minh",80000,122000,42000,34
TIKI,nha-sach-tiki,193450565,"Nam Đình Cốc Vi– Tập 7 -  Tặng 1 Postcard Nam Đình Cốc Vi",99200,119000,19800,17
TIKI,nha-sach-tiki,111537689,"Án Mạng Trên Sông Nile (Agatha Christie)(Tái Bản)",78700,135000,56300,42
TIKI,nha-sach-tiki,147220978,"Sự Tiến Hóa Của Tiền Tệ",111000,139000,28000,20
TIKI,nha-sach-tiki,158235745,"Phương Pháp Kaizen
 (The Kaizen Way)(Tái Bản)",75500,95000,19500,21
TIKI,nha-sach-tiki,53563837,"Combo Sách Nuôi Dạy Trẻ: Phương Pháp Giáo Dục Con Của Người Do Thái + Chờ Đến Mẫu Giáo Thì Đã Muộn +90% Trẻ Thông Minh Nhờ Cách Trò Chuyện Đúng Đắn Của Cha Mẹ + Cách Khen, Cách Mắng, Cách Phạt Con + Poster An Toàn(Tủ Sách Người Mẹ Tốt)",251350,251350,0,0
TIKI,nha-sach-tiki,170706996,"Điểm Bùng Phát ( Tái Bản)",115800,179000,63200,35
TIKI,nha-sach-tiki,161383826,"Đảo Mộng Mơ (Tái Bản)",55800,75000,19200,26
TIKI,nha-sach-tiki,188381614,"Thẻ học Thông minh (Size Lớn - 18 Chủ đề - 288 thẻ) - Song ngữ Anh - Việt - Thế giới Xung quanh",104000,200000,96000,48
TIKI,nha-sach-tiki,106365090,"Kinh Dịch Đạo Của Người Quân Tử - Nguyễn Hiến Lê (Tái Bản)",173000,268000,95000,35
TIKI,nha-sach-tiki,185854305,"Full bộ 4 cuốn Truyện - Thơ - Đồng dao - Câu đố cho Trẻ mầm non (Giúp bé sáng dạ, thông minh, tập nói và đọc nhanh)",141999,278429,136430,49
TIKI,nha-sach-tiki,72290296,"Bí Quyết Đầu Tư & Kinh Doanh Chứng Khoán Của Tỷ Phú Warren Buffett Và George Soros (Tái Bản 2020)",110000,158000,48000,30
TIKI,nha-sach-tiki,174444166,"Cẩm Nang Diện Chẩn – Phương Pháp Đơn Giản Áp Dụng Tại Gia",124000,179000,55000,31
TIKI,nha-sach-tiki,347334,"Có Hai Con Mèo Ngồi Bên Cửa Sổ",70500,100000,29500,30
TIKI,nha-sach-tiki,1029908,"Tuần Của Bé - Bé Công Bằng (Dành Cho Trẻ 3 - 6 Tuổi)",17000,23000,6000,26
TIKI,nha-sach-tiki,8149335,"Cổ Học Tinh Hoa (Bìa Mềm)",94300,115000,20700,18
TIKI,nha-sach-tiki,170708219,"Đừng Bao Giờ Chia Đôi Lợi Ích Trong Mọi Cuộc Đàm Phán",103820,179000,75180,42
TIKI,nha-sach-tiki,80920029,"Nguyên lý kế toán TBL9",63000,63000,0,0
TIKI,nha-sach-tiki,71990280,"Nói Chuyện Là Bản Năng, Giữ Miệng Là Tu Dưỡng, Im Lặng Là Trí Tuệ",132300,189000,56700,30
TIKI,nha-sach-tiki,100958464,"Hỏi Đáp Từ Trái Tim (Tái Bản)",102000,149000,47000,32
TIKI,nha-sach-tiki,71553549,"Đọc Nhanh, Hiểu Sâu, Nhớ Lâu Trọn Đời (Tái Bản 2020)",41500,59000,17500,0
TIKI,nha-sach-tiki,40750124,"Không Gia Đình (Phiên Bản Mới) - Tặng kèm bộ Postcard",119250,159000,39750,25
TIKI,nha-sach-tiki,181928999,"Yuri Espoir (Tập 1) - Bản Thường Tặng Kèm Postcard",57200,79000,21800,0
TIKI,nha-sach-tiki,111537682,"Bách Khoa Cho Trẻ Em - Bách Khoa Động Vật (Tái Bản)",131000,180000,49000,27
TIKI,nha-sach-tiki,160585762,"Veil – Sắc Đen Trầm Lặng - Tập 2 - (Tặng Kèm Postcard)",92200,109000,16800,15
TIKI,nha-sach-tiki,175956866,"Giới Hạn Của Bạn Chỉ Là Xuất Phát Điểm Của Tôi (Tái Bản)",62700,89000,26300,30
TIKI,nha-sach-tiki,109654814,"Bút bi gel 0.5mm nhiều màu Deli - Có nắp gài - 1 chiếc - Đỏ/ Xanh Dương/ Xanh Lá/ Tím/ Cam - A119",5000,10800,5800,54
TIKI,nha-sach-tiki,34708988,"Bộ 10 Bút Gel Điểm 10 xóa được TP-GELE01",95000,120000,25000,21
TIKI,nha-sach-tiki,40433264,"Combo Bí Ẩn Mãi Mãi Là Bí Ẩn( Trọn bộ 6 cuốn)( tặng kèm sổ Tay Xương Rồng)",261000,290000,29000,10
TIKI,nha-sach-tiki,13673968,"Giây Thứ 12 - Tập 2 (Trinh Thám)",68000,145000,77000,53
TIKI,nha-sach-tiki,155351487,"IELTS 16 ACADEMIC",195000,195000,0,0
TIKI,nha-sach-tiki,187889757,"Gọt bút chì mini Deli - Màu ngẫu nhiên - E0594",2500,5400,2900,54
TIKI,nha-sach-tiki,74616448,"Lập Kế Hoạch Kinh Doanh Cho Người Mới Bắt Đầu",69020,119000,49980,42
TIKI,nha-sach-tiki,21031780,"Pháo Đài Số ( Tái Bản )",128500,199000,70500,35
TIKI,nha-sach-tiki,73684906,"Marketing Phải Bán Được Hàng",110000,159000,49000,31
TIKI,nha-sach-tiki,150711999,"Michelle Obama - Chất Michelle (Bìa Cứng) (Tái Bản)",372000,520000,148000,28
TIKI,nha-sach-tiki,17530147,"Series Địch Công Kỳ Án Tập 14 - Hầu Tử Và Lão Hổ ( Tái Bản )",44000,88000,44000,50
TIKI,nha-sach-tiki,77403145,"The Story Of Food - Câu Chuyện Thực Phẩm",483000,486000,3000,1
TIKI,nha-sach-tiki,83162438,"Combo Kinh Tế Vi Mô và Câu Hỏi - Bài Tập - Trắc Nghiệm Kinh Tế Vi Mô",171000,180000,9000,5
TIKI,nha-sach-tiki,107492789,"Keo dán x2000 siêu dính, keo dán đa năng dán tất cả vật liệu bằng gỗ, thủy tinh, dán nhựa an toàn với da tay (Dạng nước)",21996,21996,0,0
TIKI,nha-sach-tiki,175833959,"Combo 5-10-20 Bút Bi Bấm Deli EQ24 Ngòi 0.7mm - Mực Xanh/Đen/Đỏ - Bút bi dầu phù hợp học sinh văn phòng",8500,17100,8600,50
TIKI,nha-sach-tiki,8011021,"Tâm Lý Học Thành Công (Tái Bản)",149000,199000,50000,25
TIKI,nha-sach-tiki,170434495,"Hộp Quà Bí Mật Dành Tặng Bé Yêu",19000,19000,0,0
TIKI,nha-sach-tiki,195969658,"Tiệm Sách Cũ Biblia - Ngoại Truyện 2 - Tobirako Và Thời Gian Bỏ Ngỏ",51000,95000,44000,46
TIKI,nha-sach-tiki,16284286,"Tuổi Thơ Dữ Dội - Tập 1 (Tái Bản)",57900,80000,22100,28
TIKI,nha-sach-tiki,165038798,"OKRs - Tối Ưu Hóa Hiệu Suất Của Bất Kỳ Đội Nhóm Nào",110000,169000,59000,35
TIKI,nha-sach-tiki,109982979,"Isaac Newton - Nhà Khoa Học Vĩ Đại",28000,40000,12000,30
TIKI,nha-sach-tiki,195479322,"Tàn Tro",79400,108000,28600,26
TIKI,nha-sach-tiki,46240920,"Kỹ Năng Quản Lý Tài Chính Cá Nhân Trong 30 Ngày",82800,119000,36200,30
TIKI,nha-sach-tiki,58462050,"Sách Người Trong Muôn Nghề: Ngành IT có gì?",155000,169000,14000,8
TIKI,nha-sach-tiki,168181452,"Thiên Sứ Nhà Bên - Tập 2",83600,95000,11400,12
TIKI,do-choi-me-be,273532024,"[Combo 3 lon còn 1tr440] Sữa Bột Nutifood GrowPLUS+ Suy Dinh Dưỡng 1.5kg - Tăng Cân, Tăng Chiều Cao (Lon 1.5kg)",568000,884000,316000,36
TIKI,do-choi-me-be,116407260,"Combo 2 túi nước giặt OMO Matic chuyên dụng Cửa Trước Lavender Khử Mùi Thư Thái 3.6kg",350000,454000,104000,23
TIKI,do-choi-me-be,116407426,"Combo 2 Túi Nước Giặt Omo Matic Máy Giặt Cửa Trên Hương Comfort Tinh Dầu Thơm Xoáy Bay Vết Bẩn Thơm Bền Lâu 3.6Kg",350000,454000,104000,23
TIKI,do-choi-me-be,134516825,"Combo 2 túi Nước Xả Vải Comfort Giữ Màu & Bền Vải Một Lần Xả Hương Ban Mai, túi 3.8L",427000,542000,115000,21
TIKI,do-choi-me-be,134516823,"Combo 2 túi nước xả vải em bé Comfort cho da nhạy cảm với công thức riêng dịu nhẹ 100% nguồn gốc thực vật, Túi 3.8L",452000,570000,118000,21
TIKI,do-choi-me-be,97551646,"Bộ 2 Lon Sữa Bột Friso Gold 4 1400g Dành Cho Trẻ Từ 2 - 6 Tuổi + Tặng Lon Sữa Friso Gold 4 380g",1260000,1770000,510000,29
TIKI,do-choi-me-be,1000534,"Sữa Bột Anlene Gold Movepro Hương Vanilla (Hộp Giấy 440g)",189000,204000,15000,7
TIKI,do-choi-me-be,116410119,"Túi Nước giặt Omo Nước giặt cửa trước hương Lavender Khử mùi thư thái 3.6KG",180000,227000,47000,21
TIKI,do-choi-me-be,59143353,"Combo Tiết Kiệm: 6 Gói Khăn Ướt Bobby Care Không Hương 100 Miếng/Gói",199000,279000,80000,29
TIKI,do-choi-me-be,20088686,"Sữa tắm gội toàn thân Johnson's Baby (500ml)",155000,155000,0,0
TIKI,do-choi-me-be,68347468,"Nước xả làm mềm vải COMFORT Nước xả vải hương Bella Giữ màu, Bền Vải & Hương nước hoa thiên nhiên 3.8L",215000,271000,56000,21
TIKI,do-choi-me-be,68370674,"Nước Xả Làm Mềm Vải COMFORT Nước Xả Vải Hương Ban Mai Đậm Đặc 1 Lần Xả Giúp Giữ Màu & Bền Vải 3.8L",215000,271000,56000,21
TIKI,do-choi-me-be,160299786,"Nước Rửa Chén Bát Sunlight Chanh 100 Sạch Nhanh Xả Bọt Nhanh Rửa Sạch Dầu Mỡ 3.6kg",100000,104900,4900,5
TIKI,do-choi-me-be,76404389,"Tã/ Bỉm Quần PAMPERS Giữ Dáng Gói Cực Đại Size M (74 miếng, 7-12kg), Chống Xệ",332000,528000,196000,37
TIKI,do-choi-me-be,23957552,"Combo 2 Tã Quần Người Lớn Sunmate Mềm Mại L8 (8 Miếng)",160000,199999,39999,20
TIKI,do-choi-me-be,116410107,"TúI Nước Giặt Omo Matic Comfort Cho Máy Giặt Cửa Trên Hương Tinh Dầu Thơm Xoáy Bay Vết Bẩn, Hương Thơm Bền Lâu 3.6Kg",180000,227000,47000,21
TIKI,do-choi-me-be,59143353,"Combo Tiết Kiệm: 6 Gói Khăn Ướt Bobby Care Không Hương 100 Miếng/Gói",199000,279000,80000,29
TIKI,do-choi-me-be,100989176,"Nước Xả Làm Mềm Vải Comfort Chăm Sóc Dịu Nhẹ Cho Da Nhạy Cảm 3.8L",285000,285000,0,0
TIKI,do-choi-me-be,272847939,"Hạt nêm rau củ Massel Úc 100% từ rau củ thảo mộc bảo vệ sức khỏe, dành cho ăn chay, ăn mặn, ăn kiêng và cho bé ăn dặm - QuaTangMe Extaste",88400,180000,91600,51
TIKI,do-choi-me-be,41356464,"Nước Rửa Chén Bát Sunlight Thiên Nhiên Muối Khoáng & Lô Hội 3.6kg",118000,126500,8500,7
TIKI,do-choi-me-be,498703,"Combo 6 Khăn Ướt Unifresh Aloevera 80M (80 Miếng)",140970,140970,0,0
TIKI,do-choi-me-be,116410159,"Túi Nước Giặt Omo Matic Cho Máy Giặt Cửa Trước Bền Đẹp Bền Màu Sau 100 Lần Giặt 3.6Kg",180000,227000,47000,21
TIKI,do-choi-me-be,213586941,"Combo 3 Tấm lót SunMate cải tiến mới 20 miếng/gói size M (45 x 70cm)",271000,350510,79510,23
TIKI,do-choi-me-be,111304924,"Túi Nước Giặt Omo Matic Cho Quần Áo Bé Yêu Chiết Xuất Tràm Trà Và Nha Đam Dịu Nhẹ, Sạch Khuẩn 3.6Kg",180000,227000,47000,21
TIKI,do-choi-me-be,273662537,"Tã quần Người Lớn Confidence Slim & Fit size M20 (20 miếng)",179000,220000,41000,19
TIKI,do-choi-me-be,116410110,"TúI Nước Giặt Omo Matic Cho Máy Giặt Cửa Trên Xoáy Bay Vết Bẩn Sạch Bẩn Khử Mùi Toàn Diện 3.9Kg",180000,227000,47000,21
TIKI,do-choi-me-be,41356464,"Nước Rửa Chén Bát Sunlight Thiên Nhiên Muối Khoáng & Lô Hội 3.6kg",118000,126500,8500,7
TIKI,do-choi-me-be,1745009,"Tấm Đệm Lót Siêu Thấm Caryn (20 Miếng)",105000,128700,23700,18
TIKI,do-choi-me-be,100989176,"Nước Xả Làm Mềm Vải Comfort Chăm Sóc Dịu Nhẹ Cho Da Nhạy Cảm 3.8L",285000,285000,0,0
TIKI,do-choi-me-be,19944385,"Tấm Đệm Lót Caryn Mỏng Nhẹ (14 Miếng)",90000,102900,12900,13
TIKI,do-choi-me-be,68347466,"Nước Xả Làm Mềm Vải Comfort Giữ Màu & Bền Vải Sophia Hương Nước Hoa Thiên Nhiên 3.8L",215000,271000,56000,21
TIKI,do-choi-me-be,24028050,"Sữa bột Abbott Pediasure 1.6kg cho trẻ từ 1-10 tuổi",1039000,1240250,201250,16
TIKI,do-choi-me-be,116407426,"Combo 2 Túi Nước Giặt Omo Matic Máy Giặt Cửa Trên Hương Comfort Tinh Dầu Thơm Xoáy Bay Vết Bẩn Thơm Bền Lâu 3.6Kg",350000,454000,104000,23
TIKI,do-choi-me-be,68347468,"Nước xả làm mềm vải COMFORT Nước xả vải hương Bella Giữ màu, Bền Vải & Hương nước hoa thiên nhiên 3.8L",215000,271000,56000,21
TIKI,do-choi-me-be,114771870,"Nước giặt dưỡng vải Comfort Nước giặt xả đa chức năng hương Thanh Lịch giúp quần áo sạch thơm & tươi màu Túi 3.8kg",163000,195000,32000,16
TIKI,do-choi-me-be,116407260,"Combo 2 túi nước giặt OMO Matic chuyên dụng Cửa Trước Lavender Khử Mùi Thư Thái 3.6kg",350000,454000,104000,23
TIKI,do-choi-me-be,114771868,"Nước giặt dưỡng vải Comfort Nước giặt xả đa chức năng hương Thời Thượng giúp quần áo sạch thơm & tươi màu Túi 3.8kg",167000,195000,28000,14
TIKI,do-choi-me-be,116447512,"Sữa tắm Johnson's Baby chứa sữa và gạo (1000ml)",235000,235000,0,0
TIKI,do-choi-me-be,175953065,"Combo 4 Tã Dán Người Lớn SunMate G2 size M10, M/L10, XL10, M/L18",267000,365234,98234,27
TIKI,do-choi-me-be,174865692,"Combo 5 Bộ Viên tẩy bồn cầu Vim Power 5 Hương Lavender 275G (5x55G)",112000,120000,8000,7
TIKI,do-choi-me-be,134516823,"Combo 2 túi nước xả vải em bé Comfort cho da nhạy cảm với công thức riêng dịu nhẹ 100% nguồn gốc thực vật, Túi 3.8L",452000,570000,118000,21
TIKI,do-choi-me-be,134516825,"Combo 2 túi Nước Xả Vải Comfort Giữ Màu & Bền Vải Một Lần Xả Hương Ban Mai, túi 3.8L",427000,542000,115000,21
TIKI,do-choi-me-be,34537694,"Tã Dán Siêu Thấm Caryn Gói Siêu Tiết Kiệm M40 (40 Miếng)",334000,352300,18300,5
TIKI,do-choi-me-be,125240682,"Nước Xả Vải Downy Dạng Túi",275000,275000,0,0
TIKI,do-choi-me-be,1000540,"Sữa Bột Anlene Gold Movepro 3X Hương Vanilla (Hộp Thiếc 800g)",385000,410000,25000,6
TIKI,do-choi-me-be,137337237,"Combo Mua 1 Tặng 1 - Giấy vệ sinh PREMIER Deluxe đóng cặp ",165000,200000,35000,18
TIKI,do-choi-me-be,88924596,"Sữa Bột Frisolac Gold 2 850g Dành Cho Trẻ Từ 6 - 12 Tháng Tuổi",539000,539000,0,0
TIKI,do-choi-me-be,115667006,"Khăn giấy lụa Premier VinaTissue 280 tờ - Combo lốc 6",120000,155000,35000,23
TIKI,do-choi-me-be,68370674,"Nước Xả Làm Mềm Vải COMFORT Nước Xả Vải Hương Ban Mai Đậm Đặc 1 Lần Xả Giúp Giữ Màu & Bền Vải 3.8L",215000,271000,56000,21
TIKI,do-choi-me-be,88949154,"Sữa Bột Friso Gold 4 1400g (Dành Cho Trẻ Từ 2 - 6 Tuổi)",730000,885000,155000,18
TIKI,do-choi-me-be,38438031,"Combo Viên tẩy bồn cầu 55G x 3 VIM Power 5 hương Oải hương Sạch Khuẩn Thơm Mát suốt 30 ngày",75000,84000,9000,11
TIKI,do-choi-me-be,160299786,"Nước Rửa Chén Bát Sunlight Chanh 100 Sạch Nhanh Xả Bọt Nhanh Rửa Sạch Dầu Mỡ 3.6kg",100000,104900,4900,5
TIKI,do-choi-me-be,25746246,"Combo 2 Chai Nước Tẩy Bồn Cầu Vim Trắng Sáng Hương Oải Hương 870 ML",77000,78000,1000,0
TIKI,do-choi-me-be,88784189,"Bột thông cống và khủ mùi hôi bồn cầu, lavabo, chậu rửa bát, đường ống cực  mạnh nắp xanh",10000,16139,6139,38
TIKI,do-choi-me-be,23957552,"Combo 2 Tã Quần Người Lớn Sunmate Mềm Mại L8 (8 Miếng)",160000,199999,39999,20
TIKI,nha-cua-doi-song,116571619,"Ga Chống Thấm Cotton LIDACO Cao Cấp - Kẻ sao - 1m2x2mxdưới12cm",149000,200000,51000,26
TIKI,nha-cua-doi-song,116571657,"Ga Chống Thấm Cotton LIDACO Cao Cấp - Kitty hồng - 2m2x2mxdưới12cm",199000,217000,18000,8
TIKI,nha-cua-doi-song,116571660,"Ga Chống Thấm Cotton LIDACO Cao Cấp - Kẻ sao - 1m6x2mxdưới12cm",149000,179000,30000,17
TIKI,nha-cua-doi-song,116571729,"Ga Chống Thấm Cotton LIDACO Cao Cấp - Cá đĩa - 1m8x2mxdưới12cm",155000,300000,145000,48
TIKI,nha-cua-doi-song,116571721,"Ga Chống Thấm Cotton LIDACO Cao Cấp - Cá đĩa - 1m4x2mxdưới12cm",149000,189000,40000,21
TIKI,nha-cua-doi-song,116571731,"Ga Chống Thấm Cotton LIDACO Cao Cấp - Thỏ bé - 1m4x2mxdưới12cm",149000,160000,11000,7
TIKI,nha-cua-doi-song,116571742,"Ga Chống Thấm Cotton LIDACO Cao Cấp - Cá đĩa - 2m2x2mxdưới12cm",199000,226000,27000,12
TIKI,nha-cua-doi-song,116571735,"Ga Chống Thấm Cotton LIDACO Cao Cấp - Thỏ bé - 1m6x2mxdưới12cm",149000,179000,30000,17
TIKI,nha-cua-doi-song,116571649,"Ga Chống Thấm Cotton LIDACO Cao Cấp - Kitty hồng - 1m2x2mxdưới12cm",149000,217000,68000,31
TIKI,nha-cua-doi-song,116571707,"Ga Chống Thấm Cotton LIDACO Cao Cấp - Baby shark - 2m2x2mxdưới12cm",199000,213000,14000,7
TIKI,nha-cua-doi-song,116571710,"Ga Chống Thấm Cotton LIDACO Cao Cấp - Baby shark - 1m6x2mxdưới12cm",149000,159000,10000,6
TIKI,nha-cua-doi-song,129144356,"Ga Chống Thấm Cotton LIDACO Cao Cấp - Lông vũ - 1m2x2mxdưới12cm",149000,189000,40000,21
TIKI,nha-cua-doi-song,116571667,"Ga Chống Thấm Cotton LIDACO Cao Cấp - Baby shark - 1m2x2mxdưới12cm",149000,154000,5000,3
TIKI,nha-cua-doi-song,116571603,"Ga Chống Thấm Cotton LIDACO Cao Cấp - Dâu nhật - 1m8x2mxdưới12cm",155000,291000,136000,47
TIKI,nha-cua-doi-song,116571687,"Ga Chống Thấm Cotton LIDACO Cao Cấp - Thỏ bé - 2m2x2mxdưới12cm",199000,250000,51000,20
TIKI,nha-cua-doi-song,116571663,"Ga Chống Thấm Cotton LIDACO Cao Cấp - Kẻ sao - 1m8x2mxdưới12cm",155000,200000,45000,23
TIKI,nha-cua-doi-song,116571693,"Ga Chống Thấm Cotton LIDACO Cao Cấp - Baby shark - 1m4x2mxdưới12cm",149000,184000,35000,19
TIKI,nha-cua-doi-song,116571685,"Ga Chống Thấm Cotton LIDACO Cao Cấp - Cá đĩa - 1m2x2mxdưới12cm",149000,189000,40000,21
TIKI,nha-cua-doi-song,116571625,"Ga Chống Thấm Cotton LIDACO Cao Cấp - Dâu nhật - 1m4x2mxdưới12cm",149000,154000,5000,3
TIKI,nha-cua-doi-song,116571623,"Ga Chống Thấm Cotton LIDACO Cao Cấp - Kitty hồng - 1m4x2mxdưới12cm",149000,189000,40000,21
TIKI,nha-cua-doi-song,217736127,"Ga Chống Thấm Cotton LIDACO Cao Cấp - San hô",149000,250000,101000,40
TIKI,nha-cua-doi-song,116571602,"Ga Chống Thấm Cotton LIDACO Cao Cấp - Hươu vàng - 1m6x2mxdưới12cm",149000,169000,20000,12
TIKI,nha-cua-doi-song,116571607,"Ga Chống Thấm Cotton LIDACO Cao Cấp - Phong lan - 1m4x2mxdưới12cm",149000,189000,40000,21
TIKI,nha-cua-doi-song,186645870,"Máy Bắn Keo Nến Deli - Phù hợp DIY Làm Đồ Handmade Thủ Công - An Toàn, Nhỏ Gọn, Dễ Sử Dụng - DL390120",79000,171000,92000,54
TIKI,nha-cua-doi-song,116571727,"Ga Chống Thấm Cotton LIDACO Cao Cấp - Cá đĩa - 1m6x2mxdưới12cm",149000,179000,30000,17
TIKI,nha-cua-doi-song,116571716,"Ga Chống Thấm Cotton LIDACO Cao Cấp - Thỏ bé - 1m8x2mxdưới12cm",155000,242000,87000,36
TIKI,nha-cua-doi-song,69741184,"Thanh treo inox cao cấp không cần khoan tường, siêu chắc chắn, khả năng chịu tải cao HT07",150000,150000,0,0
TIKI,nha-cua-doi-song,101841654,"Đàn Kalimba Cega 17 phím gỗ nguyên tấm Mahogany",290000,290000,0,0
TIKI,nha-cua-doi-song,116571597,"Ga Chống Thấm Cotton LIDACO Cao Cấp - Hươu vàng - 1m2x2mxdưới12cm",149000,160000,11000,7
TIKI,nha-cua-doi-song,116571671,"Ga Chống Thấm Cotton LIDACO Cao Cấp - Kẻ sao - 2m2x2mxdưới12cm",199000,226000,27000,12
TIKI,nha-cua-doi-song,96209890,"Dụng cụ thông ống thoát nước chuyên nghiệp có tay cầm - Độ dài dây lò xo: 5m",153400,153400,0,0
TIKI,nha-cua-doi-song,189492088,"Nhang Sen Thuần Khiết Liên Tâm 29cm 200 cây - Ít khói, dịu nhẹ, 100% Đài sen thiên nhiên",99750,99750,0,0
TIKI,nha-cua-doi-song,118680989,"Set nến thơm hộp quà thắt nơ – xinh xắn phù hợp làm quà tặng bạn gái",100000,100000,0,0
TIKI,nha-cua-doi-song,36300228,"Bộ Móc treo chữ S, có 3 size chọn lựa",21400,21400,0,0
TIKI,nha-cua-doi-song,116571699,"Ga Chống Thấm Cotton LIDACO Cao Cấp - Baby shark - 1m8x2mxdưới12cm",155000,200000,45000,23
TIKI,nha-cua-doi-song,164158123,"Vỉ 2 Viên Pin Duracell CR2032 / CR2025 / CR2016 Lithium 3V - Hàng chính hãng",60000,60000,0,0
TIKI,nha-cua-doi-song,116571741,"Ga Chống Thấm Cotton LIDACO Cao Cấp - Thỏ bé - 1m2x2mxdưới12cm",149000,250000,101000,40
TIKI,nha-cua-doi-song,116571655,"Ga Chống Thấm Cotton LIDACO Cao Cấp - Kẻ sao - 1m4x2mxdưới12cm",149000,189000,40000,21
TIKI,nha-cua-doi-song,116571627,"Ga Chống Thấm Cotton LIDACO Cao Cấp - Dâu nhật - 1m6x2mxdưới12cm",149000,179000,30000,17
TIKI,nha-cua-doi-song,19423384,"Bộ võng xếp BAN MAI: sơn tĩnh điện và lưới thép số 9 (Giao màu ngẫu nhiên)",619000,920000,301000,33
TIKI,do-choi-me-be,273532024,"[Combo 3 lon còn 1tr440] Sữa Bột Nutifood GrowPLUS+ Suy Dinh Dưỡng 1.5kg - Tăng Cân, Tăng Chiều Cao (Lon 1.5kg)",568000,884000,316000,36
TIKI,do-choi-me-be,116407424,"Combo 2 túi nước giặt OMO Matic cho máy giặt cửa trên giúp quần áo sạch bẩn khử mùi toàn diện, túi 3.9kg",350000,454000,104000,23
TIKI,do-choi-me-be,184101589,"Combo 2 TúI Nước Giặt Omo Matic Cho Quần Áo Bé Yêu Chiết Xuất Tràm Trà Và Nha Đam Dịu Nhẹ, Sạsh Khuẩn , túi 3.6Kg",350000,454000,104000,23
TIKI,do-choi-me-be,181452377,"Combo 2 túi Nước xả làm mềm vải Comfort chăm sóc chuyên sâu phơi trong nhà Hương nắng mới",422000,542000,120000,22
TIKI,do-choi-me-be,181426565,"Nước xả làm mềm vải Comfort chăm sóc chuyên sâu phơi trong nhà Hương nắng mới",215000,271000,56000,21
TIKI,do-choi-me-be,95269395,"Tã Quần Siêu Cao Cấp Huggies Platinum Nature Made L44 (44 Miếng)",329000,460000,131000,28
TIKI,do-choi-me-be,68612510,"Combo 2 Túi nước giặt xả Maxkleen Hương Huyền Diệu 3.8kg/túi ",369000,420000,51000,12
TIKI,do-choi-me-be,115483206," Sữa bột Enfagrow A+ NeuroPro 3 với 2’-FL HMO cho trẻ từ 1 – 3 Tuổi - Vị Nhạt Dễ Uống (2.2kg)",997000,997000,0,0
TIKI,do-choi-me-be,145976954,"[CỘNG 6 MIẾNG] Tã quần Moony cao cấp XL38+6 (Girl) - Nhập khẩu từ Nhật Bản",339000,475000,136000,29
TIKI,do-choi-me-be,57044932,"Thùng 48 Hộp Sữa Nước Abbott Pediasure Vani 180ml cho trẻ từ 1 - 10 tuổi",1470000,1633728,163728,10
TIKI,do-choi-me-be,6840059,"Combo 2 Tã Dán Người Lớn SunMate G2 Size M10 (10 Miếng)",146000,182620,36620,20
TIKI,do-choi-me-be,175953067,"Combo 4 Tã Quần Người Lớn SunMate Mềm Mại",293000,399997,106997,27
TIKI,do-choi-me-be,498670,"Combo 2 Tã Dán Người Lớn SunMate G2 Size XL10 (10 Miếng)",202000,261163,59163,23
TIKI,do-choi-me-be,145976954,"[CỘNG 6 MIẾNG] Tã quần Moony cao cấp XL38+6 (Girl) - Nhập khẩu từ Nhật Bản",339000,475000,136000,29
TIKI,do-choi-me-be,126022163,"Bột thông tắc cống, bồn cầu, bồn rửa bát, đường ống cực mạnh HGO Super 250g",49000,75000,26000,35
TIKI,do-choi-me-be,59143355,"Combo Tiết Kiệm: 6 Gói Khăn Ướt Bobby Care Bổ Sung 80 Miếng/Gói",159000,231000,72000,31
TIKI,do-choi-me-be,199903947,"Combo 4 Tấm lót SunMate cải tiến mới (45 x 70cm)",197000,240451,43451,18
TIKI,do-choi-me-be,573673,"Thùng 48 Hộp Sữa Nước Abbott Grow Gold 180ml cho trẻ 1 tuổi trở lên",813000,904224,91224,10
TIKI,do-choi-me-be,23957447,"Combo 2 Tã Quần Người Lớn Sunmate Mềm Mại M9 (9 Miếng)",166000,203702,37702,19
TIKI,do-choi-me-be,175953065,"Combo 4 Tã Dán Người Lớn SunMate G2 size M10, M/L10, XL10, M/L18",380000,522327,142327,27
TIKI,do-choi-me-be,213586945,"Combo 4 Tấm lót SunMate cải tiến mới 14 miếng/gói size L (60 x 70cm)",292000,373092,81092,22
TIKI,do-choi-me-be,130997754,"Combo 2 túi nước giặt dưỡng vải Comfort 3.8kg",390000,390000,0,0
TIKI,do-choi-me-be,88924594,"Sữa Bột Frisolac Gold 1 850g Dành Cho Trẻ Từ 0 - 6 Tháng Tuổi",531000,531000,0,0
TIKI,do-choi-me-be,25099352,"Combo 02 Hộp Bột Tẩy Vệ Sinh Lồng Máy Giặt Ag+ Mao Bao 306g - Tặng 01 hộp Bột Tẩy Quần Áo Thiên Nhiên 12g x 2 gói",84000,110000,26000,24
TIKI,do-choi-me-be,6840059,"Combo 2 Tã Dán Người Lớn SunMate G2 Size M10 (10 Miếng)",146000,182620,36620,20
TIKI,do-choi-me-be,117836946,"[Mới] Hộp giấy 2 Kg Frisolac Gold 3",939000,939000,0,0
TIKI,do-choi-me-be,498670,"Combo 2 Tã Dán Người Lớn SunMate G2 Size XL10 (10 Miếng)",202000,261163,59163,23
TIKI,do-choi-me-be,124708784,"Nước Giặt Ariel Hương Downy Túi 3.2Kg",236500,236500,0,0
TIKI,do-choi-me-be,181452377,"Combo 2 túi Nước xả làm mềm vải Comfort chăm sóc chuyên sâu phơi trong nhà Hương nắng mới",422000,542000,120000,22
TIKI,do-choi-me-be,24030105,"Sữa bột Abbott Pediasure 850g cho trẻ từ 1 - 10 tuổi",665000,755948,90948,12
TIKI,do-choi-me-be,184101589,"Combo 2 TúI Nước Giặt Omo Matic Cho Quần Áo Bé Yêu Chiết Xuất Tràm Trà Và Nha Đam Dịu Nhẹ, Sạsh Khuẩn , túi 3.6Kg",350000,454000,104000,23
TIKI,do-choi-me-be,118123582,"Giấy vệ sinh PREMIER VinaRoll không lõi - Combo 3 lốc",225000,225000,0,0
TIKI,do-choi-me-be,7178671,"Bột Tẩy Quần Áo Thiên Nhiên Baking Soda Mao Bao (12 g x 5 gói)",43000,55000,12000,22
TIKI,do-choi-me-be,199903945,"Combo 2 Tấm lót SunMate cải tiến mới (45 x 70cm)",99000,130680,31680,24
TIKI,do-choi-me-be,181426565,"Nước xả làm mềm vải Comfort chăm sóc chuyên sâu phơi trong nhà Hương nắng mới",215000,271000,56000,21
TIKI,do-choi-me-be,88949152,"Sữa Bột Frisolac Gold 3 1400g (Dành Cho Trẻ Từ 1 - 2 Tuổi)",735000,735000,0,0
TIKI,do-choi-me-be,10054452,"Thùng 48 Hộp Sữa Bột Pha Sẵn Friso Gold Rtd Vani (48 Hộp X 110ml)",438000,505000,67000,13
TIKI,do-choi-me-be,32030382,"Combo 12 Gói Khăn Ướt Huggies Cacao và Bơ Hạt Mỡ (72 Miếng/ Gói)",369000,408000,39000,10
TIKI,do-choi-me-be,116407424,"Combo 2 túi nước giặt OMO Matic cho máy giặt cửa trên giúp quần áo sạch bẩn khử mùi toàn diện, túi 3.9kg",350000,454000,104000,23
TIKI,do-choi-me-be,159387940,"Đai đi xe máy cho bé phản quang, thoáng khí sử dụng khóa 2 cấp bền chắc, chống bui bẩn",129000,179000,50000,28
TIKI,do-choi-me-be,213586941,"Combo 3 Tấm lót SunMate cải tiến mới 20 miếng/gói size M (45 x 70cm)",271000,350510,79510,23
TIKI,do-choi-me-be,413088,"Miếng Lót Sơ Sinh Bobby Fresh Newborn 2 - 40 (40 Miếng)",79000,98000,19000,19
TIKI,do-choi-me-be,145974290,"[CỘNG 4 MIẾNG] Tã dán Moony cao cấp L54+4 - Nhập khẩu từ Nhật Bản",339000,475000,136000,29
TIKI,do-choi-me-be,35043572,"Thùng 48 Hộp Sữa Nước Abbott Similac 110ml cho trẻ từ 1 tuổi",605000,699600,94600,14
TIKI,do-choi-me-be,23957447,"Combo 2 Tã Quần Người Lớn Sunmate Mềm Mại M9 (9 Miếng)",166000,203702,37702,19
TIKI,do-choi-me-be,98276143,"Thùng 3 Gói Tã/ Bỉm Quần PAMPERS Nhật Thượng Hạng, Size M (144 miếng, 6-12kg), Siêu Mềm Mịn & Thoáng Khí",964000,1410000,446000,32
TIKI,do-choi-me-be,84304880,"Tẩy cặn canxi vách kính, vòi sen inox, bồn sứ, gạch men HGO Plus 500ml",95000,95000,0,0
TIKI,do-choi-me-be,435762,"Sữa Bột Abbott Grow Gold 3+ cho trẻ từ 3 - 6 tuổi (1.7Kg)",674000,781380,107380,14
TIKI,do-choi-me-be,175953067,"Combo 4 Tã Quần Người Lớn SunMate Mềm Mại",293000,399997,106997,27
TIKI,do-choi-me-be,72924801,"Combo 3 Hộp 4 Viên Nén Vệ Sinh Lồng Giặt OMO Matic 80gr",227000,276000,49000,18
TIKI,do-choi-me-be,57044926,"Thùng 48 Hộp Sữa Nước Abbott Pediasure Vani 110ml cho trẻ từ 1 - 10 tuổi",1009000,1111824,102824,9
TIKI,do-choi-me-be,24028484,"Sữa bột Abbott Pediasure cho trẻ từ 1 - 10 tuổi (400g)",321000,346500,25500,7
TIKI,do-choi-me-be,24026125,"Thùng 30 Chai Sữa Nước Abbott Glucerna Vani 220ml",1440000,1567500,127500,8
TIKI,do-choi-me-be,160299782,"Nước Lau Sàn Sunlight Tinh Dầu Thảo Mộc Hương Hoa Hạ & Bạc Hà 3,6 Kg - Sạch Thơm Thư Thái - Nhà Thêm Trong Lành",92900,93000,100,0
TIKI,do-choi-me-be,130461479,"Sữa Bột Similac Einstein 4 cho trẻ từ 2 - 6 tuổi",499000,547560,48560,9
TIKI,nha-cua-doi-song,199263383,"Bàn Ăn Phong Cách Bắc Âu Đơn Giản Thương Hiệu IGA - GP181",485000,528000,43000,8
TIKI,nha-cua-doi-song,162407831,"Kệ Để Máy Tính Kết Hợp Kệ Sách Đa Năng Hiện Đại Thương Hiệu IGA - GP184",176000,186000,10000,5
TIKI,nha-cua-doi-song,89198232,"Kệ Gia Vị Để Bàn Nora Cho Phòng Bếp Gọn Gàng - GM04",133000,146000,13000,9
TIKI,nha-cua-doi-song,51473042,"Kệ đa năng Tokyo 4 tầng hàng cao cấp",154000,154000,0,0
TIKI,nha-cua-doi-song,131498054,"Bóng đèn LED trụ Hi-lumen G3 PHILIPS E27 - Độ sáng cao, tiết kiệm điện, chất lượng ánh sáng vượt trội - Hàng Chính Hãng",134000,264000,130000,49
TIKI,nha-cua-doi-song,131145091,"Giá Sách Mini Tủ Đầu Giường Phong Cách Nordic Thương Hiệu IGA - GP156",221000,240000,19000,8
TIKI,nha-cua-doi-song,113773790,"Bình Thủy Tinh 2 Lớp Pha Trà Doron MS79 - Cách Nhiệt Tốt - Có Lõi Lọc Inox 304 - Dung Tích 400ml - Hàng Loại 1",129000,129000,0,0
TIKI,nha-cua-doi-song,208358660,"Ổ cắm điện LiOA đa năng - 3 lỗ, 4 lỗ, 6 lỗ, 8 lỗ dây dài 3m/5m - Chính Hãng - MITA",95000,95000,0,0
TIKI,nha-cua-doi-song,175147417,"Set 10 hộp nhựa chữ nhật mỏng đựng thực phẩm Đại Đồng Tiến 100% nhựa PP an toàn cho sức khỏe dùng được cho lò vi sóng",49020,51600,2580,5
TIKI,nha-cua-doi-song,55630076,"Miếng lót ly bằng đất xốp Diatomite siêu hút nước, thông điệp ý nghĩa",55000,55000,0,0
TIKI,nha-cua-doi-song,158804921,"Gối ngủ cao su non vỏ sợi tre kháng khuẩn cao cấp cho người lớn EMA - Phong cách Nhật Bản - Chống đau mỏi cổ vai gáy, ngủ ngáy - KT 50x30x10cm",149000,298000,149000,50
TIKI,nha-cua-doi-song,165594187,"Kệ Sách Để Bàn Có Hộc Đựng Tiện Lợi Thương Hiệu IGA - GP187",134000,134000,0,0
TIKI,nha-cua-doi-song,44350764,"Combo 2 Thanh treo đồ dán tường,tủ quần áo, nhà bếp, có 6 móc chịu lực (giao màu ngẫu nhiên) GD263-MTSC-Thanh2",34899,34899,0,0
TIKI,nha-cua-doi-song,191918103,"Dụng cụ rửa chai và ly LocknLock ETM143DGRY - Màu xám đen",41000,79000,38000,48
TIKI,nha-cua-doi-song,149387829,"Hộp Đựng Giấy Vệ Sinh Đa Năng 2 Tầng Treo Tường Cao Cấp - Có Ngăn Kéo Và Khe Cắm Điện Thoại, Ipad - Hàng Chính Hãng Nhập Khẩu",125000,159000,34000,21
TIKI,nha-cua-doi-song,135507759,"Dây vòi hoa sen tắm nóng lạnh Pimisi bằng inox 304 với đầu dây đồng thau không gỉ phù hợp với mọi sen tắm trong nhà vệ sinh dài 150cm chống xoắn - mạ xi sáng bóng - ống mềm cấp nước và dùng được cho cả vòi xịt nhà vệ sinh phòng tắm | Hàng chính hãng",87000,120000,33000,28
TIKI,nha-cua-doi-song,6710595,"Bộ 10 móc treo dán tường chịu lực 10kg",4000,30000,26000,87
TIKI,nha-cua-doi-song,117138509,"Ổ cắm điện LiOA đa năng - 3 lỗ, 4 lỗ, 6 lỗ, 8 lỗ dây dài 3m/5m - Chính Hãng - MITA",92000,92000,0,0
TIKI,nha-cua-doi-song,182602992,"Khăn Tắm Gội Đầu Lau Mặt ROYAL TOWEL Dùng Cho Gia Đình Spa Khách Sạn 100% Cotton Thấm Hút Không Ra Màu",29000,29000,0,0
TIKI,nha-cua-doi-song,59318679,"Bộ Ga Gối Cotton Tici Kẻ LIDACO Cao Cấp - Caro Nâu Nhạt",159000,229000,70000,31
TIKI,nha-cua-doi-song,186440945,"Giá Sách Treo Tường Trang Trí FIVO Mã FB40 Không Cần Khoan Tặng Kèm Đinh 4 Chân Chịu Lực Lên Đến 10KG Với Móc Inox Dễ Dàng Gắn Lên Tường",42000,82000,40000,49
TIKI,nha-cua-doi-song,135442402,"Mỏ Hàn Điện Deli Chính Hãng 30W / 60W Chất Lượng Cao - Sử Dụng Đa Năng, Tiện Ích - DL8830 / DL8860",83000,142200,59200,42
TIKI,nha-cua-doi-song,165758264,"Bộ dao 2 chiếc Eco Family Sunhouse KS-KN2E1",102000,163000,61000,37
TIKI,nha-cua-doi-song,161455657,"Bóng đèn led 30W TAT",19000,19000,0,0
TIKI,nha-cua-doi-song,58802544,"Hộp Cơm Giữ Nhiệt INOX304 Hiện Đại Tặng Kèm Túi Giữ Nhiệt",162630,208500,45870,22
TIKI,nha-cua-doi-song,144582478," Dán Tường Để Đồ Đa Năng, Dán Tường Để Điện Thoại, Để Điều Khiển... - Giao màu ngẫu nhiên ",15000,15000,0,0
TIKI,nha-cua-doi-song,12197016,"Bộ 280 Ống gen co nhiệt cách điện nhiều màu đủ size",28896,28896,0,0
TIKI,nha-cua-doi-song,52021508,"Bảng điện nổi V2 Điện Quang ĐQ FEP 32W 02S (màu trắng, 3 lỗ 2 chấu, 2 công tắc)",60000,81200,21200,26
TIKI,nha-cua-doi-song,27948515,"Bộ 2 móc treo chổi, cây lau nhà dụng cụ tẩy rửa nhà tắm dán tường chống khuẩn tiết kiệm không gian chịu lực tối đa 5Kg",10899,10899,0,0
TIKI,nha-cua-doi-song,139600248,"Miếng Tấm Pát Pad Thép Vuông Sửa Bản Lề Tủ Cửa Gỗ Lỗ Vít Door Hinge Repair Kit",10000,10000,0,0
TIKI,nha-cua-doi-song,50339509,"Kệ sách gỗ để đồ đa năng 2 tầng kích thước 80*26*50 cm",159000,179000,20000,11
TIKI,nha-cua-doi-song,23476097,"Ô Dù Che mưa Che Nắng Chống Tia UV (màu ngẫu nhiên)",28000,150000,122000,81
TIKI,nha-cua-doi-song,96703757,"bàn làm việc - Nâu - 80x40x75cm",179999,179999,0,0
TIKI,nha-cua-doi-song,55481938,"Đồng hồ gỗ LED để bàn cao cấp - Gỗ đen led trắng - Hiển thị nhiệt độ",195000,195000,0,0
TIKI,nha-cua-doi-song,50775246,"Gối hơi du lịch, gối kê cổ du lịch, văn phòng tự bơm, gối hơi kê cổ đa năng, nhiều màu, giao ngẫu nhiên+ Tặng kèm hình dán",95000,95000,0,0
TIKI,nha-cua-doi-song,7221847,"Bộ Nồi Inox Sunhouse Mama cao cấp 5 đáy SH784 (16cm, 20cm, 24cm) - Dùng cho mọi loại bếp - Hàng chính hãng",858000,1340000,482000,36
TIKI,nha-cua-doi-song,35273810,"Keo vá tường,Keo trám vết nứt tường thông minh - Tặng kèm bộ dụng cụ",16051,16051,0,0
TIKI,nha-cua-doi-song,177744785,"Bộ lau nhà tách nước bẩn Kitimop K22 Plus có thùng lau nhà tự vắt 2 ngăn riêng biệt, chổi lau nhà xoay 360 độ lau sạch khô nhanh, 2 bông lau",459000,685000,226000,33
TIKI,nha-cua-doi-song,106385679,"Túi Giữ Nhiệt Đựng Hộp Cơm Văn Phòng Siêu Dày – Chọn Size – Giữ Nhiệt – 3 Lớp - Chống Thấm Cao Cấp Chính Hãng miDoctor",67000,67000,0,0
TIKI,nha-cua-doi-song,116571600,"Ga Chống Thấm Cotton LIDACO Cao Cấp - Hươu vàng - 1m4x2mxdưới12cm",149000,160000,11000,7
TIKI,dien-thoai-may-tinh-bang,116571619,"Ga Chống Thấm Cotton LIDACO Cao Cấp - Kẻ sao - 1m2x2mxdưới12cm",149000,200000,51000,26
TIKI,dien-thoai-may-tinh-bang,116571657,"Ga Chống Thấm Cotton LIDACO Cao Cấp - Kitty hồng - 2m2x2mxdưới12cm",199000,217000,18000,8
TIKI,dien-thoai-may-tinh-bang,116571660,"Ga Chống Thấm Cotton LIDACO Cao Cấp - Kẻ sao - 1m6x2mxdưới12cm",149000,179000,30000,17
TIKI,dien-thoai-may-tinh-bang,116571721,"Ga Chống Thấm Cotton LIDACO Cao Cấp - Cá đĩa - 1m4x2mxdưới12cm",149000,189000,40000,21
TIKI,dien-thoai-may-tinh-bang,116571707,"Ga Chống Thấm Cotton LIDACO Cao Cấp - Baby shark - 2m2x2mxdưới12cm",199000,213000,14000,7
TIKI,dien-thoai-may-tinh-bang,116571729,"Ga Chống Thấm Cotton LIDACO Cao Cấp - Cá đĩa - 1m8x2mxdưới12cm",155000,300000,145000,48
TIKI,dien-thoai-may-tinh-bang,116571693,"Ga Chống Thấm Cotton LIDACO Cao Cấp - Baby shark - 1m4x2mxdưới12cm",149000,184000,35000,19
TIKI,dien-thoai-may-tinh-bang,116571742,"Ga Chống Thấm Cotton LIDACO Cao Cấp - Cá đĩa - 2m2x2mxdưới12cm",199000,226000,27000,12
TIKI,dien-thoai-may-tinh-bang,116571731,"Ga Chống Thấm Cotton LIDACO Cao Cấp - Thỏ bé - 1m4x2mxdưới12cm",149000,160000,11000,7
TIKI,dien-thoai-may-tinh-bang,116571649,"Ga Chống Thấm Cotton LIDACO Cao Cấp - Kitty hồng - 1m2x2mxdưới12cm",149000,217000,68000,31
TIKI,dien-thoai-may-tinh-bang,116571625,"Ga Chống Thấm Cotton LIDACO Cao Cấp - Dâu nhật - 1m4x2mxdưới12cm",149000,154000,5000,3
TIKI,dien-thoai-may-tinh-bang,116571685,"Ga Chống Thấm Cotton LIDACO Cao Cấp - Cá đĩa - 1m2x2mxdưới12cm",149000,189000,40000,21
TIKI,dien-thoai-may-tinh-bang,116571735,"Ga Chống Thấm Cotton LIDACO Cao Cấp - Thỏ bé - 1m6x2mxdưới12cm",149000,179000,30000,17
TIKI,dien-thoai-may-tinh-bang,116571671,"Ga Chống Thấm Cotton LIDACO Cao Cấp - Kẻ sao - 2m2x2mxdưới12cm",199000,226000,27000,12
TIKI,dien-thoai-may-tinh-bang,116571597,"Ga Chống Thấm Cotton LIDACO Cao Cấp - Hươu vàng - 1m2x2mxdưới12cm",149000,160000,11000,7
TIKI,dien-thoai-may-tinh-bang,129144356,"Ga Chống Thấm Cotton LIDACO Cao Cấp - Lông vũ - 1m2x2mxdưới12cm",149000,189000,40000,21
TIKI,dien-thoai-may-tinh-bang,116571710,"Ga Chống Thấm Cotton LIDACO Cao Cấp - Baby shark - 1m6x2mxdưới12cm",149000,159000,10000,6
TIKI,dien-thoai-may-tinh-bang,116571727,"Ga Chống Thấm Cotton LIDACO Cao Cấp - Cá đĩa - 1m6x2mxdưới12cm",149000,179000,30000,17
TIKI,dien-thoai-may-tinh-bang,116571623,"Ga Chống Thấm Cotton LIDACO Cao Cấp - Kitty hồng - 1m4x2mxdưới12cm",149000,189000,40000,21
TIKI,dien-thoai-may-tinh-bang,116571699,"Ga Chống Thấm Cotton LIDACO Cao Cấp - Baby shark - 1m8x2mxdưới12cm",155000,200000,45000,23
TIKI,dien-thoai-may-tinh-bang,116571716,"Ga Chống Thấm Cotton LIDACO Cao Cấp - Thỏ bé - 1m8x2mxdưới12cm",155000,242000,87000,36
TIKI,dien-thoai-may-tinh-bang,116571663,"Ga Chống Thấm Cotton LIDACO Cao Cấp - Kẻ sao - 1m8x2mxdưới12cm",155000,200000,45000,23
TIKI,dien-thoai-may-tinh-bang,116571667,"Ga Chống Thấm Cotton LIDACO Cao Cấp - Baby shark - 1m2x2mxdưới12cm",149000,154000,5000,3
TIKI,dien-thoai-may-tinh-bang,116571655,"Ga Chống Thấm Cotton LIDACO Cao Cấp - Kẻ sao - 1m4x2mxdưới12cm",149000,189000,40000,21
TIKI,dien-thoai-may-tinh-bang,116571603,"Ga Chống Thấm Cotton LIDACO Cao Cấp - Dâu nhật - 1m8x2mxdưới12cm",155000,291000,136000,47
TIKI,dien-thoai-may-tinh-bang,116571741,"Ga Chống Thấm Cotton LIDACO Cao Cấp - Thỏ bé - 1m2x2mxdưới12cm",149000,250000,101000,40
TIKI,dien-thoai-may-tinh-bang,116571602,"Ga Chống Thấm Cotton LIDACO Cao Cấp - Hươu vàng - 1m6x2mxdưới12cm",149000,169000,20000,12
TIKI,dien-thoai-may-tinh-bang,116571607,"Ga Chống Thấm Cotton LIDACO Cao Cấp - Phong lan - 1m4x2mxdưới12cm",149000,189000,40000,21
TIKI,dien-thoai-may-tinh-bang,217736127,"Ga Chống Thấm Cotton LIDACO Cao Cấp - San hô",149000,250000,101000,40
TIKI,dien-thoai-may-tinh-bang,116571687,"Ga Chống Thấm Cotton LIDACO Cao Cấp - Thỏ bé - 2m2x2mxdưới12cm",199000,250000,51000,20
TIKI,dien-thoai-may-tinh-bang,116571627,"Ga Chống Thấm Cotton LIDACO Cao Cấp - Dâu nhật - 1m6x2mxdưới12cm",149000,179000,30000,17
TIKI,dien-thoai-may-tinh-bang,186645870,"Máy Bắn Keo Nến Deli - Phù hợp DIY Làm Đồ Handmade Thủ Công - An Toàn, Nhỏ Gọn, Dễ Sử Dụng - DL390120",79000,171000,92000,54
TIKI,dien-thoai-may-tinh-bang,189492088,"Nhang Sen Thuần Khiết Liên Tâm 29cm 200 cây - Ít khói, dịu nhẹ, 100% Đài sen thiên nhiên",99750,99750,0,0
TIKI,dien-thoai-may-tinh-bang,19423384,"Bộ võng xếp BAN MAI: sơn tĩnh điện và lưới thép số 9 (Giao màu ngẫu nhiên)",619000,920000,301000,33
TIKI,dien-thoai-may-tinh-bang,96209890,"Dụng cụ thông ống thoát nước chuyên nghiệp có tay cầm - Độ dài dây lò xo: 5m",153400,153400,0,0
TIKI,dien-thoai-may-tinh-bang,69741184,"Thanh treo inox cao cấp không cần khoan tường, siêu chắc chắn, khả năng chịu tải cao HT07",150000,150000,0,0
TIKI,dien-thoai-may-tinh-bang,36300228,"Bộ Móc treo chữ S, có 3 size chọn lựa",21400,21400,0,0
TIKI,dien-thoai-may-tinh-bang,101841654,"Đàn Kalimba Cega 17 phím gỗ nguyên tấm Mahogany",290000,290000,0,0
TIKI,dien-thoai-may-tinh-bang,118680989,"Set nến thơm hộp quà thắt nơ – xinh xắn phù hợp làm quà tặng bạn gái",100000,100000,0,0
TIKI,dien-thoai-may-tinh-bang,164158123,"Vỉ 2 Viên Pin Duracell CR2032 / CR2025 / CR2016 Lithium 3V - Hàng chính hãng",60000,60000,0,0
TIKI,nha-sach-tiki,193684715,"Ngoan Cường Vượt Định Kiến",56100,79000,22900,29
TIKI,nha-sach-tiki,135552451,"Các Triều Đại Việt Nam",78000,120000,42000,35
TIKI,nha-sach-tiki,332626,"Oxford Learner's Pocket Dictionary : A Pocket-sized Reference to English Vocabulary (Fourth Edition)",76260,85000,8740,10
TIKI,nha-sach-tiki,259537049,"Hộp 10 Bút Lông Bảng Thiên Long WB-03",73000,93000,20000,22
TIKI,nha-sach-tiki,197629358,"Chúng Ta Có Hẹn Với Bình Yên",71000,89000,18000,20
TIKI,nha-sach-tiki,169603497,"Macmillan Dictionary Vietnam ED with App – Soft cover",399000,399000,0,0
TIKI,nha-sach-tiki,101297001,"Tâm Lý Hành Vi Trong Đầu Tư Chứng Khoán",110700,159000,48300,30
TIKI,nha-sach-tiki,148761075,"Combo 6 Cuốn: "Hít Hà Mùi Đất Nước"",207000,240000,33000,14
TIKI,nha-sach-tiki,46107068,"Thế Giới Ảo, Thương Hiệu Thật",86420,149000,62580,42
TIKI,nha-sach-tiki,76305752,"Combo Bộ 2 Cuốn: Giết Chỉ Huy Đội Kỵ Sĩ (Tập 1: Ý Tưởng Xuất Hiện + Tập 2: Ẩn Dụ Dịch Chuyển)",326000,410000,84000,20
TIKI,nha-sach-tiki,193988316,"Siêu Tâm Trí – Học Cách Suy Nghĩ Như Sherlock Holmes",98100,145000,46900,32
TIKI,nha-sach-tiki,150682463,"Linh Ứng - Hành Trình Của Kẻ Siêu Vô Thần Đến Thế Giới Tâm Linh",187000,268000,81000,30
TIKI,nha-sach-tiki,5974545,"Series Địch Công Kỳ Án Tập 11: Bóng Ma Trong Chùa",53000,110000,57000,52
TIKI,nha-sach-tiki,189598539,"Bài tập bổ trợ Tiếng Anh 10",118000,118000,0,0
TIKI,nha-sach-tiki,191926650,"Trái cây đại chiến Zombie - Thế giới khủng long: Tập 11 - Thợ săn đáy biển",58000,89000,31000,35
TIKI,nha-sach-tiki,191148968,"Bút Hết Nặng Viết Hết Đau",185000,239000,54000,23
TIKI,nha-sach-tiki,87941401,"Lối Tắt Khởi Nghiệp - Con Đường Ngắn Từ Tay Trắng Đến Thành Công Bền Vững",125000,169000,44000,26
TIKI,nha-sach-tiki,176909246,"Bí Quyết Bấm Huyệt Chữa Bệnh",124000,178000,54000,30
TIKI,nha-sach-tiki,10581200,"Dế Mèn Phiêu Lưu Ký (Tái Bản)",38000,50000,12000,24
TIKI,nha-sach-tiki,101897983,"Không Tức Giận Bạn Đã Thắng",107000,149000,42000,28
TIKI,nha-sach-tiki,152517438,"Dữ Liệu Bạch Kim (Văn Học Trinh Thám)",127200,159000,31800,20
TIKI,nha-sach-tiki,147988196,"Combo 3 Cuốn "Hiểu Hết": How Food Works - Hiểu Hết Về Thức Ăn + How The Body Works - Hiểu Hết Về Cơ Thể + How Psychology Works - Hiểu Hết Về Tâm Lý Học",759000,900000,141000,16
TIKI,nha-sach-tiki,74983567,"Tứ Trấn Huyền Linh",158000,259000,101000,39
TIKI,nha-sach-tiki,166033485,"Sách 14 Nguyên Tắc Tăng Trưởng Thần Tốc Như Amazon",125000,188000,63000,34
TIKI,nha-sach-tiki,173092689,"Phát triển trí tuệ (140 câu đố) - Bộ sách Rèn luyện Trí thông minh - Dành cho trẻ 5-6 tuổi",23538,46152,22614,49
TIKI,nha-sach-tiki,187190670,"Black Jack - Tập 11 (Bìa Cứng)",126000,135000,9000,7
TIKI,nha-sach-tiki,164323204,"Semantic Error - Lỗi Logic - Tập 1 - Tặng Kèm Bookmark + 01 Postcard",233100,259000,25900,10
TIKI,nha-sach-tiki,194130753,"Bong bóng số 0-9 nhiều màu 35cm trang trí tiệc xinh",18000,18000,0,0
TIKI,nha-sach-tiki,136753126,"Tôi Đã Kiếm 1 Triệu Đô Đầu Tiên Trên Internet Như Thế Nào Và Bạn Cũng Có Thể Làm Như Thế (Tái Bản)",115420,199000,83580,42
TIKI,nha-sach-tiki,51660434,"Những Bí Quyết Vàng Đầu Tư Bất Động Sản",89000,89000,0,0
TIKI,nha-sach-tiki,146936894,"Combo 4 cuốn Sách tự xóa: Chữ cái - Toán - Chữ số - Hình khối & Màu sắc (tặng kèm bút)",79528,152939,73411,48
TIKI,nha-sach-tiki,193100617,"Anh Hùng Diệt Thần & Bảy Thệ Ước (Tập 2)",134000,149000,15000,10
TIKI,nha-sach-tiki,99681443,"Khoa Học - Khái Lược Những Tư Tưởng Lớn ",327000,450000,123000,27
TIKI,nha-sach-tiki,69162885,"Influencer - Phương Pháp 5 Bước Để Trở Thành Người Có Tầm Ảnh Hưởng Nhất Trong Lĩnh Vực Của Bạn",88100,129000,40900,32
TIKI,nha-sach-tiki,95090180," Bút dấu dòng dạ quang Deli – 6 chiếc/ hộp - S624",52200,52200,0,0
TIKI,nha-sach-tiki,42180465,"Đừng Chỉ Đẹp Mà Không Hiểu Chuyện",61800,89000,27200,31
TIKI,nha-sach-tiki,184781428,"Nuôi Con Bằng Yêu Thương Dạy Con Bằng Lý Trí (Tái bản) - Tặng Kèm Bookmark",85000,114000,29000,25
TIKI,nha-sach-tiki,188128043,"Kingdom - Tập 29",44500,45000,500,1
TIKI,nha-sach-tiki,68456844,"Bài Tập Tiếng Anh 8 - Tập 1 - Có Đáp Án (Theo Chương Trình Mới Của Bộ GD&ĐT)",37900,48000,10100,21
TIKI,nha-sach-tiki,714012,"Truyện Ngụ Ngôn La Fontaine",58800,98000,39200,40
TIKI,dien-thoai-may-tinh-bang,57146868,"máy đồng hồ treo tường kim trôi ja-pan",59000,59000,0,0
TIKI,dien-thoai-may-tinh-bang,136855573,"Xe Kéo Hàng, Xe Đẩy Hàng Gấp Gọn Nhập Khẩu Chất Lượng Cao XKT04 Mới",559000,559000,0,0
TIKI,dien-thoai-may-tinh-bang,135720334,"Bình pha trà cafe French Press Lock&Lock, 800ml - LLG018",169000,255000,86000,34
TIKI,dien-thoai-may-tinh-bang,25140473,"KỆ LÒ VI SÓNG 3 TẦNG Dài 60cm x Cao 80cm",229000,350000,121000,35
TIKI,dien-thoai-may-tinh-bang,69226574,"Combo 10 viên pin CR2032 Maxell Nhật Bản",31700,31700,0,0
TIKI,dien-thoai-may-tinh-bang,89144285,"Cốc Dán Tường Nhà Tắm Hình Gấu Nâu Dễ Thương - Cốc Đựng Bàn Chải Đánh Răng - Cốc Hình Gấu",6897,6897,0,0
TIKI,dien-thoai-may-tinh-bang,204207230,"Nhang nụ trầm hương đốt xông nhà tẩy uế HÀ XÁ đồ thờ cúng phong thủy, xua đuổi vận xui, thu hút nguồn năng lượng tích cực, thanh lọc không khí, an toàn cho sức khỏe",99000,198000,99000,50
TIKI,dien-thoai-may-tinh-bang,202840456,"Kệ Lò Vi Sóng Effect Đa Năng - GM02",128000,139000,11000,8
TIKI,dien-thoai-may-tinh-bang,57911829,"GỐI MỀN 3 trong 1 Trái Cây hình thú cute, thun 4 chiều siêu mịn, bộ chăn gối văn phòng, gấu bông kèm mền GM74-Chuotfruit",158745,158745,0,0
TIKI,dien-thoai-may-tinh-bang,79323009,"Tủ Sách Đa Năng Conven Phong Cách Nordic Thương Hiệu IGA",632000,689000,57000,8
TIKI,dien-thoai-may-tinh-bang,55580718,"Bộ 3 Nồi Inox 304 Đáy Từ 5 Đáy Nagakawa NAG1352 (16cm, 20cm, 24cm) - Hàng Chính Hãng",1000000,1890000,890000,47
TIKI,dien-thoai-may-tinh-bang,57755151,"Đèn đường năng lượng mặt trời 300W",760000,760000,0,0
TIKI,dien-thoai-may-tinh-bang,168234677,"[Hàng chính hãng] Ghế chỉnh dáng ngồi đúng - Curble Wider_Premium Model Hàn Quốc (Made in Korea). Phù hợp mọi đối tượng (Free Size)",699840,729000,29160,4
TIKI,dien-thoai-may-tinh-bang,72527573,"Hộp Đựng Giấy Vệ Sinh Cao Cấp OENON Dán Tường, Hộp Đựng Giấy Đa Năng Có Thêm Ngăn Để Đồ Tiện Lợi - OENON",149000,280000,131000,47
TIKI,dien-thoai-may-tinh-bang,57046106,"Bình Đựng Nước Lock&Lock Easy Grip Dung Tích 1.5L HAP814",48000,77000,29000,38
TIKI,dien-thoai-may-tinh-bang,52004331,"Kệ lò nướng - Kệ lò vi sóng - kệ nhà bếp đa năng bằng gỗ thông tự nhiên 4 tầng kích thước 60 x 40 x 110 cm",319000,450000,131000,29
TIKI,dien-thoai-may-tinh-bang,87831027,"ĐÈN NĂNG LƯỢNG MẶT TRỜI 100W - 180W - 80W - 60W - 45W  SOLAR LIGHT - ĐIỀU KHIỂN TỪ XA - PIN SẠC TRỌN DỜI - D1147",290000,290000,0,0
TIKI,dien-thoai-may-tinh-bang,193777239,"Cưa cành cây cưa gỗ gấp gọn bằng thép không gỉ sản xuất tại NHẬT BẢN",25000,50000,25000,50
TIKI,dien-thoai-may-tinh-bang,578902,"Chảo Đáy Từ Chống Dính Sunhouse SHM26 26cm",207000,300000,93000,31
TIKI,dien-thoai-may-tinh-bang,142441475,"Hộp Sấy Và Khử Khuẩn Đũa Thìa Muỗng Thông Minh,  Có Nắp Đậy Cao Cấp Chống Côn Trùng, Kiến, Dán Tường Chắc Chắn- Hàng Loại 1 Chính Hãng MINIIN",229000,229000,0,0
TIKI,dien-thoai-may-tinh-bang,7159593,"Khóa số chống trộm an toàn Royal",32000,32000,0,0
TIKI,dien-thoai-may-tinh-bang,117560257,"CHẢO CHỐNG DÍNH SÂU LÒNG SIÊU TIỆN LỢI",33999,33999,0,0
TIKI,dien-thoai-may-tinh-bang,103755910,"Ghế tatami, ghế lười bệt tựa lưng nệm - Có 5 cấp độ ngã lưng - Chính hãng TIDO",390000,390000,0,0
TIKI,dien-thoai-may-tinh-bang,125739804,"BỘ CÂY LAU NHÀ THÔNG MINH SAGOKER, mã BLNEC",146000,159999,13999,9
TIKI,dien-thoai-may-tinh-bang,158462914,"Cây Lau Kính, Gạt Chùi Kính Đa Năng 2 Đầu Trong 1 MyJae Cán Dài Uốn Xoay Thông Minh Chống Trơn Trượt",239000,390000,151000,39
TIKI,dien-thoai-may-tinh-bang,24482769,"Dây xịt vệ sinh inox 304 dài 120cm",54000,60000,6000,10
TIKI,dien-thoai-may-tinh-bang,1918931,"Keo Dán Đa Năng Selleys Epoxy Fix (10ml / Tuýp)",37050,39000,1950,5
TIKI,dien-thoai-may-tinh-bang,48622915,"Bộ Đầu Vòi Xịt Vệ Sinh (Toilet), Vệ Sinh Bồn Cầu + Giá Đỡ - Thiết kế Thông Minh Nhỏ Gọn Tiện Ích",55000,69000,14000,20
TIKI,dien-thoai-may-tinh-bang,75330721,"Then Chốt Cài Cửa, Chốt Khóa Bằng Thép Không Gỉ KUNBE An Toàn Tiện Lợi Nhiều Kích Thước",22900,22900,0,0
TIKI,dien-thoai-may-tinh-bang,48287902,"KỆ GIÀY DÉP 2 TẦNG GỖ THÔNG- Dài 50cm x Cao 50cm",109000,169000,60000,36
TIKI,dien-thoai-may-tinh-bang,54156958,"Pin Sạc Energizer AAA 700mAh Power Plus",157000,160000,3000,2
TIKI,dien-thoai-may-tinh-bang,117125057,"Ổ Cắm Điện LiOA Phổ Thông - Ổ Cắm Điện 3 lỗ - 4 lỗ - 5 lỗ - 6 lỗ - dài 3m - MITA",65000,65000,0,0
TIKI,dien-thoai-may-tinh-bang,21268314,"Ổ cắm điện chuyển đổi đa chức năng dùng khi xuất ngoại, đi du lịch,...",35000,35000,0,0
TIKI,dien-thoai-may-tinh-bang,125604026,"Dây Treo Trang Trí Noel Dài 3m",25000,25000,0,0
TIKI,dien-thoai-may-tinh-bang,196051243,"Búa Lùn Nguyên Khối Deli Chính Hãng - Đóng Đinh, Nhổ Đinh Dễ Dàng, Tiện Dụng - Nhỏ Gọn, Tay Cầm Bọc Cao Su - DL441008",62000,106000,44000,42
TIKI,dien-thoai-may-tinh-bang,172143534,"Kệ Gỗ Để Đồ Đa Năng Có Bánh Xe Di Chuyển Dễ Dàng - GP190",216000,235000,19000,8
TIKI,dien-thoai-may-tinh-bang,165844799,"Giá Kệ Sách Để Sàn 5 Tầng Gỗ Cao Cấp Màu Trắng FIVO Mã FB70 Gỗ MDF Phủ Melamine Chống Thấm Bề Mặt Phù Hợp Với Nhiều Không Gian",749000,1168000,419000,36
TIKI,dien-thoai-may-tinh-bang,156222332,"SEN TẮM CÂY NÓNG LẠNH NHẬP KHẨU NGA FULLBOX F2428 - HÀNG CHÍNH HÃNG - SIÊU BỀN BỈ",2491000,4700000,2209000,47
TIKI,dien-thoai-may-tinh-bang,146260986,"Nồi inox kho cá thịt chống dính bếp từ Fivestar ( 18cm / 20cm / 22cm ) nắp kính , 3 đáy , inox 430 , tặng 1 vá canh",199000,199000,0,0
TIKI,dien-thoai-may-tinh-bang,21482254,"Bàn gấp chân sắt 1m2 BVP23Đ",396900,490000,93100,19
TIKI,do-choi-me-be,25096869,"Bột Tẩy Quần Áo Thiên Nhiên Mao Bao chứa Baking Soda (12g x 2 gói)",22000,32000,10000,31
TIKI,do-choi-me-be,453774,"Kem Dưỡng Da Chứa Sữa Và Gạo Johnson’s Baby 20309343 (50g)",66000,66000,0,0
TIKI,do-choi-me-be,92496752,"Combo tẩy cặn canxi nhà tắm HGO Plus + tẩy dầu mỡ nhà bếp HGO bình xịt 500ml, sử dụng tiện lợi hiệu quả tiết kiệm",179000,265000,86000,32
TIKI,do-choi-me-be,249054309,"Sữa Ensure Vanila Úc cho người già, người suy dinh dưỡng, cấp đầy đủ dinh dưỡng giúp hồi phục sức khỏe - Massel Official (850g/lon)",1039000,2078000,1039000,50
TIKI,do-choi-me-be,75435459,"Tã Quần Caryn Loại Mỏng Nhẹ M32",315000,350400,35400,10
TIKI,do-choi-me-be,47961612,"Combo 2 Que Thử Thai QuickStick",40000,40000,0,0
TIKI,do-choi-me-be,576239,"Nước Tẩy Đa Năng Kháng Khuẩn Mao Bao 600ml",43000,50000,7000,14
TIKI,do-choi-me-be,1744989,"Tã Quần Mỏng Nhẹ Caryn Gói Siêu Lớn L14 (14 Miếng)",180000,181600,1600,1
TIKI,do-choi-me-be,543122,"Nước Giặt Quần Áo Em Bé D-nee Hương Lavender 3L - [8851989061535]",203000,245000,42000,17
TIKI,do-choi-me-be,68088749,"Combo 2 Túi Nước Giặt Xả Maxkleen Hương Hoa Nắng (3.8kg/túi)",369000,420000,51000,12
TIKI,do-choi-me-be,124722427,"Xịt đuổi chuột  200ml Thái Lan",48500,48500,0,0
TIKI,do-choi-me-be,34402891,"Viên Thả Làm Sạch Bồn Cầu (1 Gói 10 Viên)",8000,10869,2869,26
TIKI,do-choi-me-be,135325550,"Combo 2 Nước Tẩy Bồn Cầu Vim 880ml Diệt 99,9% Vi Khuẩn",67100,76000,8900,12
TIKI,do-choi-me-be,52293405,"Khăn Giấy Rút See-U, 2 Lớp 250 Tờ/gói",27000,27000,0,0
TIKI,do-choi-me-be,133040504,"Combo 3 viên giặt xả MaxKleen hương ngày thư thái (34 viên/túi)",374000,420000,46000,11
TIKI,do-choi-me-be,68268748,"Viên sắt, acid folic, DHA, vitamin & khoáng chất Fe-NANA - Hộp 20 viên",84000,110000,26000,24
TIKI,do-choi-me-be,1744997,"Tã Dán Siêu Thấm Caryn Gói Siêu Lớn M20 (20 Miếng)",180000,201800,21800,11
TIKI,do-choi-me-be,182709739,"Combo 2 Sữa tắm gội dịu lành cho bé Cetaphil Baby Gentle Wash & Shampoo 400ml/chai",490000,490000,0,0
TIKI,do-choi-me-be,75435457,"Tã Quần Caryn Loại Mỏng Nhẹ L28",315000,391200,76200,19
TIKI,do-choi-me-be,17888580,"Cờ Vua Cao Cấp miDoctor (Chính Hãng) - NHỎ 3810A:  25 x 25 x 2 cm - Hàng chính hãng",92000,92000,0,0
TIKI,do-choi-me-be,77858363,"Nước Súc Miệng Listerine Kids dành riêng cho trẻ trên 6 tuổi 250ml - ",49000,55000,6000,11
TIKI,do-choi-me-be,135328955,"Sữa Bột Nestlé NAN SupremePro 1 lon 400g với 5HMO & đạm Gentle Optipro nhập khẩu nguyên lon từ Đức",299000,299000,0,0
TIKI,do-choi-me-be,95269446,"Tã Dán Siêu Cao Cấp Huggies Platinum Naturemade L54 (54 Miếng)",329000,460000,131000,28
TIKI,do-choi-me-be,106307519,"1 VIÊN TẨY BỒN CẦU",2299,2299,0,0
TIKI,do-choi-me-be,168662602,"Sữa bột NAN INFINIPRO A2 Thụy Sĩ 3 800g với đạm quý A2 tiêu hóa tốt sau 7 ngày và 5HMO tăng cường đề kháng (2 - 6 tuổi)",559000,600000,41000,7
TIKI,do-choi-me-be,61292593,"Combo 4 Gói Khăn Ướt Yuniku 90 Tờ Hương Lài ( 90 tờ x 4 )",99000,167200,68200,41
TIKI,do-choi-me-be,53135547,"Lọ Tẩy Vệ Sinh Bồn Cầu Nhật Bản SPEVI - Khử Mùi Nhà Vệ Sinh, Diệt Sạch 99,9% Vi Khuẩn Thiết Kế Thông Minh Giúp Dễ Dàng Sử Dụng, Lọ Thả Bồn Cầu Hiệu Quả Rất Nhiều So Với Viên Thả Bồn Câ·",19000,19000,0,0
TIKI,do-choi-me-be,142115663,"Tranh Cát Cho Bé Tập Làm Họa Sỹ",5000,5000,0,0
TIKI,do-choi-me-be,88949156,"Sữa Bột Friso Gold 4 850g (Dành Cho Trẻ Từ 2 - 6 Tuổi)",495000,600000,105000,18
TIKI,do-choi-me-be,730944,"Sữa Tắm Gội Trẻ Em Lactacyd Milky BẢO VỆ, NUÔI DƯỠNG DA và TÓC BÉ VƯỢT TRỘI 500ml",183000,183000,0,0
TIKI,do-choi-me-be,76099465,"Chế phẩm diệt kiến gián sinh học Anbio - lọ 10ml",16800,16800,0,0
TIKI,do-choi-me-be,48964146,"Set 2 Khăn Tắm Em Bé Sợi Tre Bonny Siêu Mềm Và Thấm Hút (KT: 1m2x1m2) - Giao họa tiết ngẫu nhiên",190000,190000,0,0
TIKI,do-choi-me-be,146556777,"Cờ Vua Gỗ - Cờ Vua Cao Cấp - Đồ Chơi Bằng Gỗ Tự Nhiên - Chính hãng dododios",138000,138000,0,0
TIKI,do-choi-me-be,35043549,"Thùng 48 Hộp Sữa Nước Abbott Similac 180ml cho trẻ từ 1 tuổi",875000,1003200,128200,13
TIKI,do-choi-me-be,274034133,"Bộ Bài Drink Game Say sưa 84 lá đầy đủ thử thách vui nhộn",90000,165000,75000,45
TIKI,do-choi-me-be,82525136,"Combo 3 lon Sữa Morinaga số 2 Chilmil 850g và 1 lon sữa Morinaga số 2 320gr dành cho bé từ 6-36 tháng tuổi",1450000,1734000,284000,16
TIKI,do-choi-me-be,175953079,"Combo 4 Gói Tã Quần Người Lớn SunMate Khô Thoáng",299000,399997,100997,25
TIKI,do-choi-me-be,25027164,"Combo 2 Gói Tã Quần Người Lớn Sunmate Khô Thoáng L7 (7 Miếng/ Gói)",151000,199999,48999,24
TIKI,do-choi-me-be,145677986,"Bộ cờ vua tiêu chuẩn thi đấu, quân cờ nhựa đặc ruột cao cấp (tặng thêm 2 Hậu thuận tiện phong cấp)",250000,250000,0,0
TIKI,do-choi-me-be,7827140,"Chất thông tắc bồn cầu toilet chống hôi Siêu tốc 5 phút Sifa (1400g)",53000,53000,0,0
TIKI,nha-cua-doi-song,57146868,"máy đồng hồ treo tường kim trôi ja-pan",59000,59000,0,0
TIKI,nha-cua-doi-song,136855573,"Xe Kéo Hàng, Xe Đẩy Hàng Gấp Gọn Nhập Khẩu Chất Lượng Cao XKT04 Mới",559000,559000,0,0
TIKI,nha-cua-doi-song,25140473,"KỆ LÒ VI SÓNG 3 TẦNG Dài 60cm x Cao 80cm",229000,350000,121000,35
TIKI,nha-cua-doi-song,202840456,"Kệ Lò Vi Sóng Effect Đa Năng - GM02",128000,139000,11000,8
TIKI,nha-cua-doi-song,204207230,"Nhang nụ trầm hương đốt xông nhà tẩy uế HÀ XÁ đồ thờ cúng phong thủy, xua đuổi vận xui, thu hút nguồn năng lượng tích cực, thanh lọc không khí, an toàn cho sức khỏe",99000,198000,99000,50
TIKI,nha-cua-doi-song,89144285,"Cốc Dán Tường Nhà Tắm Hình Gấu Nâu Dễ Thương - Cốc Đựng Bàn Chải Đánh Răng - Cốc Hình Gấu",6897,6897,0,0
TIKI,nha-cua-doi-song,135720334,"Bình pha trà cafe French Press Lock&Lock, 800ml - LLG018",169000,255000,86000,34
TIKI,nha-cua-doi-song,87831027,"ĐÈN NĂNG LƯỢNG MẶT TRỜI 100W - 180W - 80W - 60W - 45W  SOLAR LIGHT - ĐIỀU KHIỂN TỪ XA - PIN SẠC TRỌN DỜI - D1147",290000,290000,0,0
TIKI,nha-cua-doi-song,57046106,"Bình Đựng Nước Lock&Lock Easy Grip Dung Tích 1.5L HAP814",48000,77000,29000,38
TIKI,nha-cua-doi-song,7159593,"Khóa số chống trộm an toàn Royal",32000,32000,0,0
TIKI,nha-cua-doi-song,57911829,"GỐI MỀN 3 trong 1 Trái Cây hình thú cute, thun 4 chiều siêu mịn, bộ chăn gối văn phòng, gấu bông kèm mền GM74-Chuotfruit",158745,158745,0,0
TIKI,nha-cua-doi-song,125604026,"Dây Treo Trang Trí Noel Dài 3m",25000,25000,0,0
TIKI,nha-cua-doi-song,142441475,"Hộp Sấy Và Khử Khuẩn Đũa Thìa Muỗng Thông Minh,  Có Nắp Đậy Cao Cấp Chống Côn Trùng, Kiến, Dán Tường Chắc Chắn- Hàng Loại 1 Chính Hãng MINIIN",229000,229000,0,0
TIKI,nha-cua-doi-song,117560257,"CHẢO CHỐNG DÍNH SÂU LÒNG SIÊU TIỆN LỢI",33999,33999,0,0
TIKI,nha-cua-doi-song,24482769,"Dây xịt vệ sinh inox 304 dài 120cm",54000,60000,6000,10
TIKI,nha-cua-doi-song,75330721,"Then Chốt Cài Cửa, Chốt Khóa Bằng Thép Không Gỉ KUNBE An Toàn Tiện Lợi Nhiều Kích Thước",22900,22900,0,0
TIKI,nha-cua-doi-song,57755151,"Đèn đường năng lượng mặt trời 300W",760000,760000,0,0
TIKI,nha-cua-doi-song,193777239,"Cưa cành cây cưa gỗ gấp gọn bằng thép không gỉ sản xuất tại NHẬT BẢN",25000,50000,25000,50
TIKI,nha-cua-doi-song,48287902,"KỆ GIÀY DÉP 2 TẦNG GỖ THÔNG- Dài 50cm x Cao 50cm",109000,169000,60000,36
TIKI,nha-cua-doi-song,79323009,"Tủ Sách Đa Năng Conven Phong Cách Nordic Thương Hiệu IGA",632000,689000,57000,8
TIKI,nha-cua-doi-song,55580718,"Bộ 3 Nồi Inox 304 Đáy Từ 5 Đáy Nagakawa NAG1352 (16cm, 20cm, 24cm) - Hàng Chính Hãng",1000000,1890000,890000,47
TIKI,nha-cua-doi-song,158462914,"Cây Lau Kính, Gạt Chùi Kính Đa Năng 2 Đầu Trong 1 MyJae Cán Dài Uốn Xoay Thông Minh Chống Trơn Trượt",239000,390000,151000,39
TIKI,nha-cua-doi-song,125739804,"BỘ CÂY LAU NHÀ THÔNG MINH SAGOKER, mã BLNEC",146000,159999,13999,9
TIKI,nha-cua-doi-song,69226574,"Combo 10 viên pin CR2032 Maxell Nhật Bản",31700,31700,0,0
TIKI,nha-cua-doi-song,48622915,"Bộ Đầu Vòi Xịt Vệ Sinh (Toilet), Vệ Sinh Bồn Cầu + Giá Đỡ - Thiết kế Thông Minh Nhỏ Gọn Tiện Ích",55000,69000,14000,20
TIKI,nha-cua-doi-song,165844799,"Giá Kệ Sách Để Sàn 5 Tầng Gỗ Cao Cấp Màu Trắng FIVO Mã FB70 Gỗ MDF Phủ Melamine Chống Thấm Bề Mặt Phù Hợp Với Nhiều Không Gian",749000,1168000,419000,36
TIKI,nha-cua-doi-song,52004331,"Kệ lò nướng - Kệ lò vi sóng - kệ nhà bếp đa năng bằng gỗ thông tự nhiên 4 tầng kích thước 60 x 40 x 110 cm",319000,450000,131000,29
TIKI,nha-cua-doi-song,72527573,"Hộp Đựng Giấy Vệ Sinh Cao Cấp OENON Dán Tường, Hộp Đựng Giấy Đa Năng Có Thêm Ngăn Để Đồ Tiện Lợi - OENON",149000,280000,131000,47
TIKI,nha-cua-doi-song,21268314,"Ổ cắm điện chuyển đổi đa chức năng dùng khi xuất ngoại, đi du lịch,...",35000,35000,0,0
TIKI,nha-cua-doi-song,54156958,"Pin Sạc Energizer AAA 700mAh Power Plus",157000,160000,3000,2
TIKI,nha-cua-doi-song,156222332,"SEN TẮM CÂY NÓNG LẠNH NHẬP KHẨU NGA FULLBOX F2428 - HÀNG CHÍNH HÃNG - SIÊU BỀN BỈ",2491000,4700000,2209000,47
TIKI,nha-cua-doi-song,21482254,"Bàn gấp chân sắt 1m2 BVP23Đ",396900,490000,93100,19
TIKI,nha-cua-doi-song,117125057,"Ổ Cắm Điện LiOA Phổ Thông - Ổ Cắm Điện 3 lỗ - 4 lỗ - 5 lỗ - 6 lỗ - dài 3m - MITA",65000,65000,0,0
TIKI,nha-cua-doi-song,172143534,"Kệ Gỗ Để Đồ Đa Năng Có Bánh Xe Di Chuyển Dễ Dàng - GP190",216000,235000,19000,8
TIKI,nha-cua-doi-song,168234677,"[Hàng chính hãng] Ghế chỉnh dáng ngồi đúng - Curble Wider_Premium Model Hàn Quốc (Made in Korea). Phù hợp mọi đối tượng (Free Size)",699840,729000,29160,4
TIKI,nha-cua-doi-song,103755910,"Ghế tatami, ghế lười bệt tựa lưng nệm - Có 5 cấp độ ngã lưng - Chính hãng TIDO",390000,390000,0,0
TIKI,nha-cua-doi-song,578902,"Chảo Đáy Từ Chống Dính Sunhouse SHM26 26cm",207000,300000,93000,31
TIKI,nha-cua-doi-song,196051243,"Búa Lùn Nguyên Khối Deli Chính Hãng - Đóng Đinh, Nhổ Đinh Dễ Dàng, Tiện Dụng - Nhỏ Gọn, Tay Cầm Bọc Cao Su - DL441008",62000,106000,44000,42
TIKI,nha-cua-doi-song,146260986,"Nồi inox kho cá thịt chống dính bếp từ Fivestar ( 18cm / 20cm / 22cm ) nắp kính , 3 đáy , inox 430 , tặng 1 vá canh",199000,199000,0,0
TIKI,nha-cua-doi-song,1918931,"Keo Dán Đa Năng Selleys Epoxy Fix (10ml / Tuýp)",37050,39000,1950,5
TIKI,nha-sach-tiki,191353862,"Green Witchcraft - Năng lượng từ thảo mộc",104300,149000,44700,30
TIKI,nha-sach-tiki,73222804,"Sách Putin Logic Của Quyền Lực (Tái Bản 2020)",117000,168000,51000,30
TIKI,nha-sach-tiki,520337,"Luật Im Lặng (Mario Puzo)",63000,95000,32000,34
TIKI,nha-sach-tiki,112588572,"Yêu Trong Tỉnh Thức - Từ Bạn Đời Đến Bạn Đạo Tập 1",185000,185000,0,0
TIKI,nha-sach-tiki,195801643,"Cà Phê Cùng Tony (Tái Bản 2022)",72000,105000,33000,31
TIKI,nha-sach-tiki,870619,"Túp Lều Bác Tom",71000,110000,39000,35
TIKI,nha-sach-tiki,6807847,"Cảm Ơn Người Lớn (Bìa Mềm) - Bản Tặng Kèm Thiệp + Phong Bì Thiệp + Bookmark (Số Lượng Có Hạn)",64200,110000,45800,42
TIKI,nha-sach-tiki,91120169,"Homecoming - Hồi Sinh Đứa Trẻ Bên Trong Bạn",117000,169000,52000,31
TIKI,nha-sach-tiki,190592917,"Combo 2 Quyển: Thiên Tài Bên Trái, Kẻ Điên Bên Phải + Tâm Lý Học Tội Phạm: Phác Họa Chân Dung Kẻ Phạm Tội",223000,324000,101000,31
TIKI,nha-sach-tiki,194959697,"Thánh Hiệp Sĩ Nơi Tận Cùng Thế Giới – Tập 1",116000,145000,29000,20
TIKI,nha-sach-tiki,72688722,"Giáo Dục - Tương Lai & Đổi Mới",148000,180000,32000,18
TIKI,nha-sach-tiki,172800656,"Komi - Nữ Thần Sợ Giao Tiếp Tập 8 [Tặng kèm Card bo góc Nữ thần]",25000,25000,0,0
TIKI,nha-sach-tiki,109982956,"Leonardo Da Vinci - Thiên Tài Toàn Năng",40000,60000,20000,33
TIKI,nha-sach-tiki,91774356,"Fullmetal Alchemist - Cang Giả Kim Thuật Sư - Fullmetal Edition Tập 8",65500,69000,3500,5
TIKI,nha-sach-tiki,5087505,"Ám Dạ Hành (Trinh Thám Hiện Đại Trung Quốc)",63000,151000,88000,58
TIKI,nha-sach-tiki,1544255,"Băng Keo Trong 5F (2 Cuộn / Lốc)",17000,49000,32000,65
TIKI,nha-sach-tiki,191373346,"[QUÀ TẶNG ĐỘC QUYỀN]  Ví da y tế cao cấp đa năng, đựng thuốc, đựng máy đo đường huyết, nhiệt kế, điện thoại, ví tiền, bền đẹp và tiện lợi, hạn chế va đập, tiện lợi cả ở nhà và đi du lịch",199000,199000,0,0
TIKI,nha-sach-tiki,100382935,"Sách - Hành Trình Về Phương Đông (Bìa Mềm - Tái bản 2021) - First News",106650,106650,0,0
TIKI,nha-sach-tiki,130997089,"[Manga] Diệt Slime Suốt 300 Năm, Tôi Levelmax Lúc Nào Chẳng Hay (Tập 6)",47100,48000,900,2
TIKI,nha-sach-tiki,171821043,"Bộ "Anne Tóc Đỏ" 8 Cuốn",717000,972000,255000,26
TIKI,nha-sach-tiki,109982972,"Marie Curie - Nhà Nữ Khoa Học Kiệt Xuất",58500,75000,16500,22
TIKI,nha-sach-tiki,191148787,"Green Witchcraft - Năng lượng từ thảo mộc",103700,149000,45300,30
TIKI,nha-sach-tiki,175967753,"Komi - Nữ Thần Sợ Giao Tiếp Tập 9",25000,25000,0,0
TIKI,nha-sach-tiki,36311444,"Đàn Ông Sao Hỏa Đàn Bà Sao Kim (Tặng Bookmark PL)",135360,188000,52640,28
TIKI,nha-sach-tiki,11119019,"Oxford Advanced Learner's Dictionary 8th Edition (With Vietnamese Translation) and CD - ROM (Paperback)",581300,625000,43700,7
TIKI,nha-sach-tiki,3840809,"New Economy Toeic Lc 1000 (Kèm file MP3)",149000,198000,49000,25
TIKI,nha-sach-tiki,52691750,"Tự Do Đầu Tiên & Cuối Cùng",123000,178000,55000,0
TIKI,nha-sach-tiki,76117849,"Luyện Kỹ Năng Nghe Tiếng Anh (Trình Độ Cơ Bản) -Tactics For Listening Basic",64000,90000,26000,29
TIKI,nha-sach-tiki,160814425,"Thai Giáo Theo Chuyên Gia - 280 Ngày - Mỗi Ngày Đọc Một Trang (Tái Bản 2021)",82800,115000,32200,28
TIKI,nha-sach-tiki,73553840,"Truyện Thiếu Nhi Hạt Giống Tâm Hồn - Thế Giới Trong Ngăn Tủ (Tái Bản 2020)",35000,40000,5000,13
TIKI,nha-sach-tiki,158972052,"Cẩm Nang Con Trai",47100,68000,20900,31
TIKI,nha-sach-tiki,11413619,"Combo Mẹ Hỏi Bé Trả Lời (4 Cuốn)",95000,120000,25000,21
TIKI,nha-sach-tiki,173420792,"Người Hạt Dẻ",159200,199000,39800,20
TIKI,nha-sach-tiki,72688720,"Năm Phút Nữa Thôi",43800,59000,15200,26
TIKI,nha-sach-tiki,77481097,"Nghề Nhân Sự Việt - Nghìn Lẻ Chuyện Giờ Mới Kể",127400,199000,71600,36
TIKI,nha-sach-tiki,172422019,"Vì Con Gái Tôi Có Thể Đánh Bại Cả Ma Vương - Tập 5 - Tặng Kèm Poster + Bookmark",119000,140000,21000,15
TIKI,nha-sach-tiki,46107066,"Học Cách Học",119000,159000,40000,25
TIKI,nha-sach-tiki,100376369,"Đứa Con Gái Hoang Đàng - Hai Số Phận - Phần II",129000,209000,80000,38
TIKI,nha-sach-tiki,392568,"Marvellous Techniques For IELTS Writing",201000,268000,67000,25
TIKI,nha-sach-tiki,11413616,"Mẹ Hỏi Bé Trả Lời 4-5 Tuổi (Tái Bản)",27000,30000,3000,10
TIKI,do-choi-me-be,173164598,"Sữa Bột Anlene Gold 5X Hương Vanilla (Hộp Thiếc 800g)",469000,508000,39000,8
TIKI,do-choi-me-be,435855,"Sữa Bột Abbott Grow Gold 6+cho trẻ từ 6 tuổi trở lên (900g)",464000,472500,8500,2
TIKI,do-choi-me-be,147246867,"Sữa Bột Anlene Gold 5X Hương Vanilla (Hộp Thiếc 400g)",249000,268000,19000,7
TIKI,do-choi-me-be,175953065,"Combo 4 Tã Dán Người Lớn SunMate G2 size M10, M/L10, XL10, M/L18",267000,365234,98234,27
TIKI,do-choi-me-be,115483434,"Sữa bột Enfamil A+ NeuroPro 2 với 2’-FL HMO cho trẻ từ 6 –12  tháng tuổi– 1.7kg",979000,979000,0,0
TIKI,do-choi-me-be,967305,"Sữa Bột Abbott Similac Mom Vani 900g",465000,493020,28020,6
TIKI,do-choi-me-be,84705786,"Gạc Rơ Lưỡi, Vệ Sinh Răng Miệng Cho Bé Dr Papie (1 hộp 30 gói)",102000,102000,0,0
TIKI,do-choi-me-be,146555381,"Đồ Chơi Rút Gỗ Trẻ Em - 2 Cỡ (Lớn và Nhỏ) - 54 Thanh Rút Gỗ Kèm 4 Con Súc Sắc Cho Bé – Bộ Đồ Chơi Rút Gỗ Cao Cấp Chính Hãng dododios",49000,49000,0,0
TIKI,do-choi-me-be,105901380,"Vitamin k2 d3 hỗ trợ tăng chiều cao, hết còi xương cho trẻ sơ sinh - LINEABON K2D3 - Sản phẩm từ Châu Âu - Công nghệ mới giúp hấp thu tối đa canxi tự nhiên",271000,369000,98000,27
TIKI,do-choi-me-be,88949150,"Sữa Bột Frisolac Gold 3 850g (Dành Cho Trẻ Từ 1 - 2 Tuổi)",484000,484000,0,0
TIKI,do-choi-me-be,177436965,"Đồ bơi trẻ em, đồ bơi bé trai chất vải chống nắng size lớn 45kg cho bé trai đến 10 tuổi",199000,224130,25130,11
TIKI,do-choi-me-be,49884598,"Sữa Morinaga Số 2 - Chilmil (850g) dành cho bé từ 6 đến 36 tháng tuổi",495000,578000,83000,14
TIKI,do-choi-me-be,75357776,"Hộp quà cặp tóc dây buộc tóc công chúa bé gái nhiêu màu cực xinh",69000,69000,0,0
TIKI,do-choi-me-be,158887692,"Đồ chơi lắp ráp, xếp hình Qman 1801 - Trực thăng chiến đấu - 381 mảnh ghép",199000,269000,70000,26
TIKI,do-choi-me-be,76372614,"Đồ chơi trí tuệ Smart Games Thử thách IQ hạt tròn",279000,279000,0,0
TIKI,do-choi-me-be,2173355,"Combo 5 Bịch Khăn Vải Khô Likado (300g)",169000,169000,0,0
TIKI,do-choi-me-be,185262304,"Kem đánh răng Colgate Batman 40g dành cho bé",23000,23000,0,0
TIKI,do-choi-me-be,114958267,"Bộ Bài Tình Yêu Game Card Lovetouch - Love card game, board games, bài cho cặp đôi, bài thấu hiểu [Kim Ngọc Thuỷ]",155000,300000,145000,48
TIKI,do-choi-me-be,20088701,"Dầu gội Johnson's Baby dịu nhẹ (800ml)",159000,192000,33000,17
TIKI,do-choi-me-be,6464021,"Cháo Tươi Cá Lóc Đậu Xanh Cây Thị",21600,25000,3400,14
TIKI,do-choi-me-be,75521920,"Combo 10 cuộn giấy vệ sinh lớn An Khang AKC500 hai lớp loại 500gr",320000,480000,160000,33
TIKI,do-choi-me-be,61285745,"Combo 4 Gói Khăn Ướt Yuniku 90 Tờ Không Hương ( 90 tờ x 4 )",99000,167200,68200,41
TIKI,do-choi-me-be,50131768,"Set 12 miếng silicon bọc cạnh, góc bàn bảo vệ bé không bị thương khi va đập",19000,19000,0,0
TIKI,do-choi-me-be,85239904,"Cuộn Xốp Bọc Cạnh Bàn 2M - Dây Cao Su Che Bịt Cạnh Bàn, Ghế An Toàn Cho Bé",25000,25000,0,0
TIKI,do-choi-me-be,270229665,"Sách nói điện tử song ngữ trẻ em (Bản nâng cấp 1+) - Sách quý điện tử song ngữ Anh – Việt cho bé - Có lựa chọn lấy thêm pin",122000,140000,18000,13
TIKI,do-choi-me-be,68925517,"Cháo Tươi Tôm Rau Ngót Cây Thị",21600,25000,3400,14
TIKI,do-choi-me-be,52774130,"Bộ 2 chai chất thông tắc Cầu, Cống Sifa chống hôi Siêu nhanh Siêu mạnh 5 phút",110000,110000,0,0
TIKI,do-choi-me-be,152469540,"Ghép Hình Lực Lượng Cảnh Sát - Xe Tuần Tra 158 Chi Tiết DK81063",81000,108000,27000,25
TIKI,do-choi-me-be,19944439,"Tã Dán Moony Natural Bông Organic M46 (46 Miếng)",379000,569400,190400,33
TIKI,do-choi-me-be,88928340,"Combo 10 khăn ướt Mamamy ( 80 tờ )",285000,300000,15000,5
TIKI,do-choi-me-be,61290431,"Combo 4 Gói Khăn Ướt Yuniku 90 Tờ Hương Phấn ( 90 tờ x 4 )",99000,167200,68200,41
TIKI,do-choi-me-be,57302858,"Bột Thông Cống, Thông Tắc Bồn Cầu Hàn Quốc Cao Cấp combo ( Hộp 5 Gói )",35192,35192,0,0
TIKI,do-choi-me-be,6632811,"Cháo Tươi Thịt Heo Bí Đỏ Cây Thị",18000,21000,3000,14
TIKI,do-choi-me-be,89261232,"Combo 20 gói khăn giấy lau tay An Khang AK20-2 loại hai lớp dài 20cm - 102 tờ/gói",308000,440000,132000,30
TIKI,do-choi-me-be,12425736,"Lốc 4 Gói Khăn Giấy Cao Cấp Tempo Softpack Mùi Bạc Hà, 4 Lớp, Không Gây Kích Ứng Da (90 Tờ/ Gói) - Thương Hiệu Đức",105000,105000,0,0
TIKI,do-choi-me-be,54619802,"Chai Thả Bồn Cầu Nhật bản, Vệ Sinh Bồn Cầu, Giúp Hỗ Trợ Giảm Thông Tắc Bồn Cầu Và Khử Mùi, Diệt Sạch 99% Vi Khuẩn (Combo 02 Lọ) - Hàng Chính Hãng",53000,58000,5000,9
TIKI,do-choi-me-be,7459815," Thuốc diệt gián hộp 12 viên - Nội địa Nhật",55000,55000,0,0
TIKI,do-choi-me-be,435891,"Sữa Bột Abbott Glucerna Vani 850g",890000,890000,0,0
TIKI,do-choi-me-be,86155733,"Bộ đồ chơi nhập vai BOWA – Bộ Trang điểm ( BOWA 8252 / BOWA 8255P )",259000,259000,0,0
TIKI,do-choi-me-be,79672168,"Sữa Bột Enfagrow Premium Toddler Hương Sữa Tự Nhiên cho trẻ 1-3 tuổi (907g)",691000,691000,0,0
TIKI,nha-sach-tiki,49716241,"Tử Vi Hàm Số (Bìa Cứng)",121000,180000,59000,33
TIKI,nha-sach-tiki,178240555,"Tần Số Của Chúng Ta",178000,179000,1000,1
TIKI,nha-sach-tiki,1667307,"Quân Vương – Thuật Cai Trị (Tái Bản)",69000,109000,40000,37
TIKI,nha-sach-tiki,195305999,"Giải mã truyện Tây Du",80000,119000,39000,33
TIKI,nha-sach-tiki,171137376,"SUY TƯỞNG – MARCUS AURELIUS ANTONINUS – TỦ SÁCH TINH HOA -",155000,155000,0,0
TIKI,nha-sach-tiki,196373994,"Sổ Tay Ghi Chép Bìa Da A5 300 Trang Kẻ Ngang Deli - Phù Hợp Làm Sổ Kế Hoạch Planner, Nhật Kí, Tập Vở Ghi Chép Bullet Journal - EN012 / EN013",106200,106200,0,0
TIKI,nha-sach-tiki,26135056,"Bộ 2 cuốn sách về kinh tế hay nhất : Dạy Con Làm Giàu (Tập 1) - Để Không Có Tiền Vẫn Tạo Ra Tiền + Dạy Con Làm Giàu (Tập 2) - Sử Dụng Đồng Vốn (Tặng kèm Bookmark thiết kế AHA)",191500,191500,0,0
TIKI,nha-sach-tiki,42975887,"Nuốt Cá Lớn - Eating The Big Fish",299000,299000,0,0
TIKI,nha-sach-tiki,145092202,"Túi giấy kraft Nhật trơn có quai đựng thực phẩm nhiều kích thước, túi giấy xi măng đựng quà",1675,1675,0,0
TIKI,nha-sach-tiki,273636756,"Trạm Đọc Official | Hackers Toeic Vocabulary",209250,279000,69750,25
TIKI,nha-sach-tiki,196157730,"[QUÀ TẶNG ĐỘC QUYỀN] Combo 10 bông tẩm cồn sát trùng Alcohol Pads - Nhỏ gọn, rất tiện khi sử dụng.",25000,25000,0,0
TIKI,nha-sach-tiki,59362973,"Osho Phụ Nữ - The Book Of Women",78000,109000,31000,28
TIKI,nha-sach-tiki,197587848,"Mỗi Ngày Gửi Cậu Một Cái Ôm",103000,129000,26000,20
TIKI,nha-sach-tiki,176824198,"How To Draw – Vẽ Nguệch Ngoạc Cả Thế Giới",103000,139000,36000,26
TIKI,nha-sach-tiki,58864689,"Giải Mã Siêu Trí Nhớ",139000,139000,0,0
TIKI,nha-sach-tiki,163553056,"Thần Chết Làm Thêm 300 Yên/Giờ (Tái Bản)",77200,105000,27800,26
TIKI,nha-sach-tiki,178514167,"Tìm Lại Màu Xanh (Phần Tiếp Theo Của Người Truyền Ký Ức)",84000,108000,24000,22
TIKI,nha-sach-tiki,134846272,"Education - Kinh Doanh Giáo Dục Tại Thị Trường Việt Nam",163000,220000,57000,0
TIKI,nha-sach-tiki,152522279,"Phúc Cho Ai Không Thấy Mà Tin - Những Câu Chuyện Nhiệm Mầu Về Hồng Ân Thiên Chúa",61100,88000,26900,31
TIKI,nha-sach-tiki,31515106,"Đàn Kiến Chăm Chỉ - Ngụ Ngôn Song Ngữ (Tái Bản 2019)",19200,32000,12800,40
TIKI,nha-sach-tiki,42877486,"Văn Học Kinh Điển Thế Giới - Peter Pan (Tái Bản)",57000,88000,31000,35
TIKI,nha-sach-tiki,72744539,"IELTS 15 ACADEMIC",142000,142000,0,0
TIKI,nha-sach-tiki,106770825,"Bộ 10 bìa bao tập Thiên Long Điểm 10 TP-NBC01",15000,15000,0,0
TIKI,nha-sach-tiki,192048655,"Tớ đã từng sợ hãi",58000,75000,17000,23
TIKI,nha-sach-tiki,187933180,"OKR - Phương Pháp Thiết Lập Mục Tiêu Và Quản Lý Công Việc Vượt Trội (Tái Bản 2022)",89800,129000,39200,30
TIKI,nha-sach-tiki,105614549,"Khay pha màu 10/14 ngăn Deli - 1 chiếc - 9402 / 9403",10000,10000,0,0
TIKI,nha-sach-tiki,7440075,"Lâu Đài Trên Mây",71500,96000,24500,26
TIKI,nha-sach-tiki,184075082,"Học Đàn Piano",90000,125000,35000,28
TIKI,nha-sach-tiki,181131167,"Boxset Nhà Trọ Của Những Điều Đã Mất (3 Cuốn)",89000,90000,1000,1
TIKI,nha-sach-tiki,598975,"Dạy Con Làm Giàu 10 - Trước Khi Bạn Thôi Việc",78300,90000,11700,13
TIKI,nha-sach-tiki,51215567,"Đồng Tiền Hạnh Phúc",62000,95000,33000,35
TIKI,nha-sach-tiki,190705657,"Nuôi Dạy Con Theo Phương Pháp Montessori: Em Bé Sơ Sinh Từ 0-1 Tuổi",153000,220000,67000,30
TIKI,nha-sach-tiki,160371977,"Ăn Tối Cùng Chef Và Nói Chuyện Bếp",98000,170000,72000,42
TIKI,nha-sach-tiki,129765498,"Văn Học Kinh Điển - Những Người Phụ Nữ Bé Nhỏ (tặng 2 postcard Tranh Màu + 1 bookmark)",190000,380000,190000,50
TIKI,nha-sach-tiki,182548599,"Dragon Quest - Dấu Ấn Roto (Dragon Quest Saga Emblem Of Roto) Perfect Edition Tập 6 - Tặng Kèm Bookmark PVC",68000,75000,7000,9
TIKI,nha-sach-tiki,173135243,"Vòng Đời (Life Cycles)",233000,350000,117000,33
TIKI,nha-sach-tiki,171549996,"Never Get Bored - Tí Ta Tí Toáy",120000,155000,35000,23
TIKI,nha-sach-tiki,134605012,"15 Nguyên Tắc Vàng Về Phát Triển Bản Thân (Tái Bản)",103820,179000,75180,42
TIKI,nha-sach-tiki,10971007,"EQ - Trí Thông Minh Xúc Cảm Trong Công Việc",111300,159000,47700,30
TIKI,nha-sach-tiki,197353392,"Holmes Ở Kyoto - Tập 6",52000,85000,33000,39
TIKI,nha-cua-doi-song,272035598,"HỘP 10 ĐÔI ĐŨA INOX 304 - CAO CẤP - SANG TRỌNG - NGUYÊN KHỐI INOX 304",235000,235000,0,0
TIKI,nha-cua-doi-song,85029640,"Ổ cắm Điện Quang ĐQ ESK 2WR 23-3U (2 lỗ 3 chấu, 3 USB, dây dài 2m, màu trắng đỏ)",214160,267700,53540,20
TIKI,nha-cua-doi-song,124691053,"Đệm thắt lưng tam giác Ema thế hệ 2 - Rộng hơn - Thoải mái xoay trở - Dành cho người thoát vị thắt lưng, bà bầu, người cao tuổi",200000,400000,200000,50
TIKI,nha-cua-doi-song,168837331,"Giấy Nến Lót Nồi Chiên Không Dầu Hình Khuôn Bánh Siêu Tiện Lợi - Thấm Giảm Thiểu Tối Đa Dầu Mỡ Bám - Hàng Chính Hãng MINIIN",99000,99000,0,0
TIKI,nha-cua-doi-song,44321391,"Tủ nhựa lắp ghép 6 Ô quần áo (70cm x 110cmx47cm)",279000,279000,0,0
TIKI,nha-cua-doi-song,190542051,"[70*140cm] Khăn Tắm Viên Nén HQ",8900,15000,6100,41
TIKI,nha-cua-doi-song,78890431,"Bộ nắp bàn cầu nhà vệ sinh bằng nhựa cao cấp, thích hợp sử dụng với nhiều loại bồn cầu",65000,65000,0,0
TIKI,nha-cua-doi-song,39292323,"Bình Nước Thủy Tinh WATER Phong Cách Hàn Quốc 460ml",115000,115000,0,0
TIKI,nha-cua-doi-song,53116171,"PHÂN TRÙN QUẾ DẠNG VIÊN NÉN SFARM CHUYÊN DÙNG CHO LAN VÀ HOA KIỂNG TRỒNG CHẬU - BỔ SUNG HỆ VI SINH CÓ LỢI CHO ĐẤT",45000,45000,0,0
TIKI,nha-cua-doi-song,96183241,"Chân đàn Organ, Piano đa năng - Kzm Kurtzman STX2 - Dáng chữ X đôi - Hàng chính hãng",210000,210000,0,0
TIKI,nha-cua-doi-song,2039747,"Bộ Nồi Inox 3 Đáy Sunhouse SH334",440000,690000,250000,36
TIKI,nha-cua-doi-song,35449842,"hộp 200 ống hút giấy cao cấp _ Clean Paper Straw màu trắng kích thước 6mm x 197mm dùng cho cà phê, nước ép....",53000,53000,0,0
TIKI,nha-cua-doi-song,52577269," Đầu vòi rửa chén tăng áp nhựa mạ điện-Ba phương pháp thoát nước",38000,85000,47000,55
TIKI,nha-cua-doi-song,195544340,"Bình Inox Đựng Rượu CCCP Truyền Thống Dung Tích 2.0L Dày 0,6 ly - 64OZ ( Loại 1 ), Kèm Bao Da Phong Cách",185000,398000,213000,54
TIKI,nha-cua-doi-song,139723967,"Combo Khăn Lau Đa Năng Mặt Siêu Thấm, Khăn Lau Bếp, Khăn Lau Kính, Khăn Lau Bát, Khăn Lau Tay, Khăn Lâu Ô Tô miDoctor",16000,16000,0,0
TIKI,nha-cua-doi-song,145243898,"Bộ vòi bơm hút nước rửa chén gắn chậu rửa HOBBY Home Decor NRC4 màu đen đầu bơm Inox 304 kèm dây dẫn 120cm",209000,280000,71000,25
TIKI,nha-cua-doi-song,75783351,"Máy Xay Tỏi Ớt Cầm Tay Mini Sạc Điện 100ml 250ml Tiện Lợi",160000,160000,0,0
TIKI,nha-cua-doi-song,140204791,"Bộ 24 Quả Châu Bóng Nhũ Kim Tuyến Lấp Lánh Trang Trí Cây Thông Noel Giáng Sinh Giá Rẻ",78000,78000,0,0
TIKI,nha-cua-doi-song,96271704,"Ổ Cắm Điện Thông Minh XSmart Đa Tính Năng Chống Giật Hàng Siêu Cao Cấp,  Chống Cháy Nổ Chịu Được Công Suất Cao, Chính Hãng",139000,139000,0,0
TIKI,nha-cua-doi-song,56451459,"Pin C carbon Panasonic R14UT/2S chính hãng",27550,29000,1450,5
TIKI,nha-cua-doi-song,162875961,"Hộp 10 Đôi Đũa  Sừng Chất Liệu Hợp Kim Mạ Vàng Cao Cấp Đầu Đũa Có Chống Trơn - Hàng Loại 1 - Chính Hãng MINIIN",32000,32000,0,0
TIKI,nha-cua-doi-song,85351583," 100 Túi bao Ổi, Cam, Na, Vú Sữa,.. túi bọc trái cây phòng ngừa sâu bệnh phá hoại - Dạng Rút Túi Chuyên Dụng",32000,32000,0,0
TIKI,nha-cua-doi-song,15262922,"Đầu Gắn Vòi Nước Rửa Chén Xoay 360 Độ Tiết Kiệm Nước XR581",18800,18800,0,0
TIKI,nha-cua-doi-song,273377437,"Ổ cắm điện kéo dài Rạng Đông 2m/5m Model OC04, OC05 chống giật, rơ le tự ngắt chống quá tải",126000,140000,14000,10
TIKI,nha-cua-doi-song,170927755,"Hộp nhựa đựng thực phẩm Homepower trong suốt có khay lót đáy giúp ráo nước, chất liệu cao cấp, an toàn cho sức khỏe",149000,149000,0,0
TIKI,nha-cua-doi-song,10404394,"Bình Đựng Thức Ăn Giữ Nhiệt ELmich Inox 304 EL0631 (500ml)",243000,469000,226000,48
TIKI,nha-cua-doi-song,87578488,"Găng tay y tế latex S Gloves - Bao tay y tế có bột màu trắng hộp 100 chiếc",54000,70000,16000,23
TIKI,nha-cua-doi-song,55134471,"1kg - Túi đựng rác gia đình , Bao đựng rác văn phòng 3 màu size trung 55x65",34000,34000,0,0
TIKI,nha-cua-doi-song,26670490,"Kệ Góc Nhà Tắm Chống Nước",204000,222000,18000,8
TIKI,nha-cua-doi-song,116198000,"Đệm Ngồi Thông Minh Lưu Thông Máu Thoáng Khí PEAFLO",145000,165000,20000,12
TIKI,nha-cua-doi-song,2391311,"Cân Treo Mini Bỏ Túi 1 Mặt Số 5kg Nhơn Hòa NHMGS-5 - Hàng Chính Hãng",69000,69000,0,0
TIKI,nha-cua-doi-song,67811819,"Đèn LED Cảm Biến Chuyển Động Nhiều Kích Cỡ, Cảm Ứng Hồng Ngoại 3 Chế Độ",197000,197000,0,0
TIKI,nha-cua-doi-song,20634384,"Ổ Khóa inox Mật Mã 4 Số",28000,28000,0,0
TIKI,nha-cua-doi-song,68736740,"Ruột gối nằm lông vũ khách sạn cao cấp sợi microfiber nhân tạo Hanvico by Homemark có kích thước trẻ em và 50x70 cm",133000,250000,117000,47
TIKI,nha-cua-doi-song,114204741,"Bình giữ nhiệt inox 304 Sunhouse 450ml KS-TU450I",98000,150000,52000,35
TIKI,nha-cua-doi-song,90850071,"DECAL DÁN KÍNH CHỐNG NẮNG CÁCH NHIỆT XANH DƯƠNG(CUÔN 3M)",169000,169000,0,0
TIKI,nha-cua-doi-song,73608154,"ĐỒNG HỒ TREO TƯỜNG TRÒN KIM TRÔI SIZE LỚN ĐƯỜNG KÍNH 30CM",149000,149000,0,0
TIKI,nha-cua-doi-song,135610861,"Ga thun lạnh đủ kích thước",55000,55000,0,0
TIKI,nha-cua-doi-song,47462861,"Bộ 6 vỉ (12 viên pin) pin Kiềm Alkaline Panasonic AAA LR03T/2B-Hàng chính hãng",167000,180000,13000,7
TIKI,nha-cua-doi-song,14639229,"Nắp Kính Cường Lực Nồi Và Chảo Fivestar",55000,55000,0,0
TIKI,nha-cua-doi-song,103118895,"Đèn pha led năng lượng mặt trời 300w 200w 100w 60w báo dung lượng pin pha nhôm chống nước IP67 có giấy bảo hành 2 năm",434000,434000,0,0
TIKI,nha-cua-doi-song,164771128,"Roi mây dẻo dai siêu thần thánh",22500,30000,7500,25
TIKI,nha-cua-doi-song,85763912,"Ghế đôn hộp, ghế ngồi kiêm hộp đựng đồ 2 IN 1. Ghế ngồi đa năng mẫu mới",149000,149000,0,0
TIKI,nha-cua-doi-song,72707434,"BỘ KÍCH THÉP DI CHUYỂN ĐỒ NẶNG 500KG 12 BÁNH PU XOAY 360° GOODTOOL35",275000,275000,0,0
TIKI,nha-cua-doi-song,132276408,"Ron pvc chặn khe hở - Thanh cao su dán chân cửa chắn khe hở, chống côn trùng, cách âm, phù hợp mọi loại cửa RPVC",35000,35000,0,0
TIKI,nha-cua-doi-song,95333782,"Đế lót chậu cây có bánh xe MONROVIA, đế để chậu cây, kệ chậu cây do động, có bánh xe, mặt tròn hoặc vuông bằng gỗ tràm cao cấp loại 1, trên 10 năm tuổi, màu vàng đường kinh 30 cm, chính hãng thương hiệu MONROVIA",85000,85000,0,0
TIKI,nha-cua-doi-song,53830664,"Mùng ngủ không cửa giăng dây 4 góc truyền thống - Vải tuyn dày lỗ nhỏ chống muỗi tuyệt đối",155000,155000,0,0
TIKI,nha-cua-doi-song,14257715,"Dụng Cụ Lấy Dấu, Định Vị Điểm Khoan - Chống Trượt",27999,27999,0,0
TIKI,nha-cua-doi-song,119446046,"Bát Tô Canh Sứ Trắng Đủ Size - Tô khum Sứ Long Phương - 6 inch",38400,38400,0,0
TIKI,nha-cua-doi-song,112072065,"Túi Đựng Hộp Cơm Giữ Nhiệt - Túi Trữ Lạnh Cao Cấp Chống Thấm Nước – Túi Giữ Nhiệt Hàng Chính Hãng",36000,70000,34000,49
TIKI,nha-cua-doi-song,185380278,"Bình Xịt Nhật Bản - TAIKOMI Japan Chống Thấm Vết Nứt Mái Nhà, Sàn Nhà Vệ Sinh, Máng Xối, Mái Tôn, Sàn Nhà",99185,135000,35815,27
TIKI,nha-cua-doi-song,54075243,"Gối cao su non chống ngáy người lớn chất lượng êm ái cho giấc ngủ sâu hơn, gối cao su non, gối chống mỏi cổ, gối chống mỏi gáy (màu ngẫu nhiên)",49000,58997,9997,17
TIKI,nha-cua-doi-song,117212183,"Ổ Cắm Nối Chia 3 Lioa, Phích Cắm 1 ra 3 Lioa - MITA",22000,22000,0,0
TIKI,nha-cua-doi-song,120470467,"Bộ 6 Ly Cao Thuỷ Tinh Luminarc Louvre 350ml - LULON1807 ",289000,289000,0,0
TIKI,nha-cua-doi-song,70002562,"BÁO ĐỘNG CHỐNG TRỘM HỒNG NGOẠI HT1A-S 3 NÚT, 180-220V AC - 50Hz.",190000,190000,0,0
TIKI,nha-cua-doi-song,171174862,"Vỏ Thay Thế Cho Gối Nooz Mềm Mịn Kháng Khuẩn Và Không Gây Kích Ứng Da",150000,150000,0,0
TIKI,nha-cua-doi-song,76514380,"Ổ Cắm Điện Đa Năng Chống Giật Có 3 Cổng USB – Sạc Trực Tiếp – Tiết Kiệm Điện – Bộ Ổ Cắm Điện Xanh Lá Cao Cấp Chính Hãng Amalife - DE30",55000,55000,0,0
TIKI,nha-cua-doi-song,96180139,"Chân đàn Organ/ Piano đa năng - Kzm Kurtzman STX1 - Dáng chữ X đơn - Màu đen - Hàng chính hãng",140000,140000,0,0
TIKI,nha-cua-doi-song,142989680,"Màn chụp tự bung đỉnh vuông Bảo An - Mẫu mùng chụp tự bung có viền chân chống muỗi tuyệt đối",203697,203697,0,0
TIKI,nha-cua-doi-song,152446542,"Cây Cau Tiểu Trâm - cây cảnh để bàn",33000,46000,13000,28
TIKI,nha-cua-doi-song,67910007,"Vỉ 20 nẹp cố định dây điện dán tường, bàn ghế",12999,12999,0,0
TIKI,nha-cua-doi-song,74329992,"Hộp Đựng Trang Sức Nữ Trang Cỡ Lớn Da Cao Cấp",150000,150000,0,0
TIKI,nha-cua-doi-song,696349,"Ổ Cắm Điện 4 Lỗ 3 Chấu 3m Philips SPN1248WB/74 (2500W)",280000,299000,19000,6
TIKI,nha-cua-doi-song,50098102,"Tủ Vải Quần Áo 3 Buồng 8 Ngăn To, Bền - Hàng Chính Hãng",385000,550000,165000,30
TIKI,nha-cua-doi-song,59273521,"Combo 02 Khăn tắm, khăn mặt FUNU, mềm mịn, siêu thấm, kháng khuẩn - Hàng chính hãng, hàng nhiều mẫu design, giao mẫu ngẫu nhiên",92000,100000,8000,8
TIKI,nha-cua-doi-song,51368456,"Bộ 6 thìa Inox 304 pha nước (số 12)",174000,210000,36000,17
TIKI,nha-cua-doi-song,53116344,"Súng bắn keo nến silicon + Tặng 10 cây keo silicon nến",38000,79000,41000,52
TIKI,nha-cua-doi-song,165029589,"VỢT BẮT MUỖI CAO CẤP 2 IN 1 DP - 834",99000,99000,0,0
TIKI,nha-cua-doi-song,51044868,"Vòi sen tăng áp, bát sen tắm inox 304 KAMA PK03, vòi nước tăng áp, bát sen tăng áp inox 304, bề mặt inox 304 nguyên bản, không rỉ sét, vòi sen tắm tăng áp lực nước",180000,180000,0,0
TIKI,nha-cua-doi-song,57894229,"Kệ đựng để đồ đa năng có bánh xe 3 tầng (giao màu ngẫu nhiên)",80000,80000,0,0
TIKI,nha-cua-doi-song,135442231,"Máy Khoan Deli Chính Hãng Pin 12V Bắt Vít - Nhỏ Gọn, Tiện Dụng - Dùng Cho Sửa Chữa Vật Dụng - DL600012",551000,1006200,455200,45
TIKI,nha-cua-doi-song,161024967,"Combo 2 hộp chia ngăn sắp xếp quần áo phong cách Nhật Bản Mai Anh House",210000,210000,0,0
TIKI,nha-cua-doi-song,189373783,"Máy Rửa Xe Mini Deli Công Suất Lớn - Tiết Kiệm Điện Năng, Phun Rửa Đa Năng - DL882201",1349000,2399000,1050000,44
TIKI,nha-cua-doi-song,54348370,"Kệ di động Inochi hàng cao cấp",140000,150000,10000,7
TIKI,nha-cua-doi-song,138814386,"Set 10 móc phơi quần áo inox dày bọc nhựa cao cấp",25000,25000,0,0
TIKI,nha-cua-doi-song,143779168,"Thảm ngủ cá nhân văn phòng",25000,25000,0,0
TIKI,nha-cua-doi-song,125667836,"Bộ Cờ Lê 14 Chi Tiết",235000,235000,0,0
TIKI,nha-cua-doi-song,4777363,"Bàn làm việc gấp gọn có khe cắm ipad - giao màu ngẫu nhiên",71000,71000,0,0
TIKI,nha-cua-doi-song,62292300,"Bộ vòi sen tắm lạnh – tay sen tăng áp  (Hàng chính hãng)",209000,350000,141000,40
TIKI,nha-cua-doi-song,19560656,"Bộ 4 Chiếc Kẹp Ga Giường",49000,49000,0,0
TIKI,dien-thoai-may-tinh-bang,214603586,"Điện Thoại Samsung Galaxy A04e (3GB/32GB)- Hàng Chính Hãng",1998000,2690000,692000,26
TIKI,dien-thoai-may-tinh-bang,212926651,"Điện Thoại Samsung Galaxy S20 FE 8GB/256GB - Hàng Chính Hãng - Đã Kích Hoạt Bảo Hành Điện Tử",8625000,8625000,0,0
TIKI,dien-thoai-may-tinh-bang,272850971,"Điện thoại Libero 5G III - 4/64GB Dimensity 700 ,Màn OLED ,Kháng nước IP57 - Hàng nhập khẩu nhật",2244000,2990000,746000,25
TIKI,dien-thoai-may-tinh-bang,270714226,"Điện Thoại Itel S23 4GB/128GB | Pin 5000mAh | 6.6 Inch | Camera 50MP | HÀNG CHÍNH HÃNG",2290000,2590000,300000,12
TIKI,dien-thoai-may-tinh-bang,171685825,"Điện thoại Nokia 105 4G -  chính hãng - Đen",690000,690000,0,0
TIKI,dien-thoai-may-tinh-bang,271329051,"Máy tính bảng Kindle Fire MAX 11, màn hình 11 inch, RAM 4GB, CPU Octa-core 2.2Ghz, bộ nhớ 64/128GB - Hàng chính hãng",5300000,5500000,200000,4
TIKI,dien-thoai-may-tinh-bang,217505504,"Máy tính bảng Kindle Fire HD8 PLUS 2022 (Fire HD 8 12th) - Màn hình 8inch HD, RAM 3GB, CPU Hexa-core 2.0 GHz, CÀI ĐƯỢC CH PLAY- Hàng nhập khẩu",2483100,2790000,306900,11
TIKI,dien-thoai-may-tinh-bang,273650151,"Điện thoại siêu bền Ulefone Power Armor X11(chống nước,chống va đập , Ram8 GB(4gb+4gb),Rom 32 GB, NFC, Helio G25, WiFi 2.4G/5G, Pin 8150 Mah,)-hàng chính hãng",3290000,3290000,0,0
TIKI,dien-thoai-may-tinh-bang,271954384,"Điện thoại OPPO A58 6GB/128GB , Sạc nhanh 33W - Hàng Chính Hãng",4311000,4990000,679000,14
TIKI,dien-thoai-may-tinh-bang,217505430,"Máy tính bảng Kindle Fire HD8 2022 (Fire HD 8 12th) - Màn hình 8inch HD, RAM 2GB, CPU Hexa-core 2.0 GHz, CÀI ĐƯỢC CH PLAY- Hàng nhập khẩu",2050000,2050000,0,0
TIKI,dien-thoai-may-tinh-bang,170449059,"Điện Thoại Masstel Izi 20 4G - Loa To, Pin Trâu, 2 Sim 2 Sóng, Hỗ Trợ 4G VoLTE, Đèn Pin Sáng, Giá Rẻ - Hàng Chính Hãng",482000,489000,7000,1
TIKI,dien-thoai-may-tinh-bang,261964853,"Điện thoại ulefone note 16 pro (Ram 16Gb(8+8),rom 128Gb,android 13 , camera 50MP,pin 4.400mAhm, Mở khóa vân tay, Mở khóa bằng khuôn mặt )-hàng chính hãng",5990000,5990000,0,0
TIKI,dien-thoai-may-tinh-bang,249730342,"Điện Thoại Masstel Fami 12 4G LTE - 2 Sim- Pin 1400 mAh - Đọc số bằng giọng nói - Hàng Chính Hãng - Bảo Hành 12 Tháng",630000,630000,0,0
TIKI,dien-thoai-may-tinh-bang,274638822,"Điện thoại Xiaomi Redmi Note 12 Turbo , Snapdragon 7 Gen 2 , Màn OLED 120Hz , Sạc nhanh 67W , Rom tiếng việt  - Hàng nhập khẩu",5999000,7990000,1991000,25
TIKI,dien-thoai-may-tinh-bang,252884932,"Tay con điện thoại bàn Panasonic TGCA30- Hàng chính hãng-Chỉ xài được khi đã có máy mẹ",750000,750000,0,0
TIKI,dien-thoai-may-tinh-bang,273990229,"Điện Thoại Xiaomi Redmi Note 13 6GB/128GB - Hàng Chính Hãng",4289000,4890000,601000,12
TIKI,dien-thoai-may-tinh-bang,225912504,"Điện Thoại Forme D111 - Hàng Chính Hãng",499000,519000,20000,4
TIKI,dien-thoai-may-tinh-bang,249730334,"Điện Thoại Masstel Izi 20 4G LTE - 2 sim -Pin 1700 mAh - Loa To - Camera 0.08 MP - Hàng Chính Hãng - Bảo Hành 12 Tháng",512000,512000,0,0
TIKI,dien-thoai-may-tinh-bang,274415640,"Điện Thoại Xiaomi Redmi Note 13 Pro 8GB/128GB - Hàng Chính Hãng",6329000,7290000,961000,13
TIKI,dien-thoai-may-tinh-bang,272394241,"Điện thoại Samsung Galaxy A05s (4Gb/128Gb) - Hàng chính hãng - Đã kích hoạt bảo hành điện tử",3260000,3990000,730000,18
TIKI,dien-thoai-may-tinh-bang,274524050,"Điện thoại Masstel izi T2 4G(LTE), Màn hình 2.4 inch, Đèn pin siêu sáng, Loa to - Hàng chính hãng",489000,550000,61000,11
TIKI,dien-thoai-may-tinh-bang,198648645,"Điện thoại Xiaomi Redmi A1 (2GB/32GB)",1715000,2190000,475000,22
TIKI,dien-thoai-may-tinh-bang,271284934,"Máy tính bảng Edutab 10.4 & Case da tặng Quà hot Hệ thống quản lý học tập & kiểm soát dành cho Phụ huynh trọn đời - Hàng Chính Hãng",5769000,5769000,0,0
TIKI,dien-thoai-may-tinh-bang,272323566,"Điện Thoại Samsung M34 5G 8GB/128GB - Hàng Chính Hãng",6179000,7990000,1811000,23
TIKI,dien-thoai-may-tinh-bang,172920927,"Điện thoại Masstel izi 12 4G - Hàng chính hãng",10000000,10000000,0,0
TIKI,dien-thoai-may-tinh-bang,274172292,"Điện thoại Samsung Galaxy A05 (4GB/64GB) - Hàng chính hãng",2990000,2990000,0,0
TIKI,dien-thoai-may-tinh-bang,245770806,"Điện thoại Samsung Galaxy A14 LTE (4GB/128GB) - Hàng chính hãng",3672000,3672000,0,0
TIKI,dien-thoai-may-tinh-bang,273258825,"Điện thoại Samsung Galaxy A05s (4GB/128GB) - Đã kích hoạt bảo hành điện tử - Hàng chính hãng",3190000,3950000,760000,19
TIKI,dien-thoai-may-tinh-bang,249956458,"Điện thoại Xiaomi Redmi Note 12 (4GB/128GB) - Hàng chính hãng",4990000,4990000,0,0
TIKI,dien-thoai-may-tinh-bang,270814316,"Điện thoại Tecno POVA 5 (8+8)/256GB - MediaTek Helio G99 - Sạc nhanh 45W - 6.8'' FHD+120HZ - Hàng Chính Hãng -  BH 13 Tháng",4529000,5290000,761000,14
TIKI,dien-thoai-may-tinh-bang,175845367,"Điện Thoại Samsung Galaxy S20 FE (8GB/256GB) Xanh Thanh Mát - Đã kích hoạt bảo hành điện tử - Hàng Chính Hãng",8625000,8625000,0,0
TIKI,dien-thoai-may-tinh-bang,217645692,"Combo Máy đọc sách All New Kindle Paperwhite 5 (11th Gen) - 16Gb và Bao da - Hàng nhập khẩu",3980000,3980000,0,0
TIKI,dien-thoai-may-tinh-bang,247925719,"Điện thoại Samsung Galaxy A14  (4GB/128GB) - Hàng Chính Hãng - Đã kích hoạt bảo hành điện tử",3672000,3672000,0,0
TIKI,dien-thoai-may-tinh-bang,274638659,"Điện Thoại Xiaomi Redmi Note 13 Pro 5G 8GB/128GB Snapdragon 7s Gen 2 , Màn OLED 120Hz, Rom Tiếng việt - Hàng nhập khẩu",5290000,6990000,1700000,24
TIKI,dien-thoai-may-tinh-bang,270625677,"Điện Thoại Oppo A78 8GB/256GB - Hàng Chính Hãng",5969000,6990000,1021000,15
TIKI,dien-thoai-may-tinh-bang,273412211,"Điện thoại Xiaomi Redmi 13C (4+128GB) | 6.74" 90Hz| Media Tek Helio G85| 5000mAh - Hàng chính hãng",2832000,3290000,458000,14
TIKI,dien-thoai-may-tinh-bang,273357326,"Điện thoại Xiaomi Redmi 13C (6GB/128GB) - Hàng chính hãng",3490000,3490000,0,0
TIKI,dien-thoai-may-tinh-bang,271451188,"Điện thoại Xiaomi Redmi A2| IPS LCD 6.52" HD+| MediaTek Helio G36| 5000 mAh - Hàng chính hãng",1669000,2190000,521000,24
TIKI,dien-thoai-may-tinh-bang,248005118,"Điện Thoại Samsung Galaxy A34 5G (8GB/128GB) - Hàng Chính Hãng",7164000,7164000,0,0
TIKI,dien-thoai-may-tinh-bang,274186112,"Máy tính bảng Samsung Galaxy Tab A9 Wifi (4GB/64GB) - Hàng chính hãng",3990000,3990000,0,0
TIKI,nha-sach-tiki,1686729,"Học Tiếng Anh Giao Tiếp Chỉ Trong 30 Ngày",224000,298000,74000,25
TIKI,nha-sach-tiki,194104629,"Một Quyển Phong Hoa Đại Đường",96500,139000,42500,31
TIKI,nha-sach-tiki,12107379,"Barron's Essential Words For The Ielts (Tái Bản)",145000,208000,63000,30
TIKI,nha-sach-tiki,111155169," [Manga] Diệt Slime Suốt 300 Năm, Tôi Levelmax Lúc Nào Chẳng Hay (Tập 5) ",38100,48000,9900,21
TIKI,nha-sach-tiki,192714730,"Tuyển Tập Đề Kiểm Tra Định Kì Khoa Học Tự Nhiên Lớp 7 ( Theo Chương Trình GDPT Mới )",69000,92000,23000,25
TIKI,nha-sach-tiki,14643411,"Điều Kỳ Diệu (Tái Bản)",84200,148000,63800,43
TIKI,nha-sach-tiki,7556499,"GAM7 No.11 Promotion - Khuyến Mại",136000,165000,29000,18
TIKI,nha-sach-tiki,386182,"Thế Giới Tuổi Thần Tiên - Những Câu Chuyện Trong Rừng Xanh",20000,38000,18000,47
TIKI,nha-sach-tiki,41299108,"Trở Về Từ Cõi Sáng (Tái Bản)",68100,98000,29900,31
TIKI,nha-sach-tiki,46253703,"Danh Gia Cổ Vật - Bí Ẩn Thanh Minh Thượng Hà Đồ",119000,150000,31000,21
TIKI,nha-sach-tiki,95311763,"Phương Pháp Ăn Uống Cải Thiện Lưu Thông Máu",61800,89000,27200,31
TIKI,nha-sach-tiki,55957270,"Sách Hoa Trôi Trên Sóng Nước (Tái Bản 2020) - Nguyên Phong",64000,98000,34000,35
TIKI,nha-sach-tiki,157244522,"Văn Minh Đông Phương Và Tây Phương (Ts Thu Giang Nguyễn Duy Cần)(Tái Bản)",41200,60000,18800,31
TIKI,nha-sach-tiki,15634588,"Who? Chuyện Kể Về Danh Nhân Thế Giới: Ludwig Van Beethoven (Tái Bản 2019)",41000,55000,14000,25
TIKI,nha-sach-tiki,187279375,"Sách Luyện thi B2 Vstep 4 kỹ năng - Ôn thi chứng chỉ tiếng Anh bậc 4 (bằng B2 tiếng Anh) khung năng lực Ngoại ngữ 6 bậc Việt Nam",304500,350000,45500,13
TIKI,nha-sach-tiki,11470936,"Combo Giáo Trình HSK 3 - Sách Bài Học (Kèm MP3) và Giáo Trình HSK 3 - Sách Bài Tập (Kèm MP3) ( Tặng Kèm Sổ Tay)",380800,476000,95200,20
TIKI,nha-sach-tiki,41299102,"Những Nguyên Lý Quản Trị Bất Biến Mọi Thời Đại (Tái Bản 2019)",96100,138000,41900,30
TIKI,nha-sach-tiki,73553827,"Dữ Liệu Lớn Cho Doanh Nghiệp Nhỏ For Dummies",118000,159000,41000,26
TIKI,nha-sach-tiki,67120551,"Đây Là Monet",109000,150000,41000,27
TIKI,nha-sach-tiki,136540035,"Tư Duy Hộp Đen (Tìm Ra Lời Giải Cho Những Câu Hỏi Trong Cuộc Sống Và Kinh Doanh Bằng Tư Duy Thực Tế)",152500,219000,66500,30
TIKI,nha-sach-tiki,191045567,"Làm Người Là Như Thế Nào? How To Be Human – The Manual",133000,179000,46000,26
TIKI,nha-sach-tiki,190707619,"Của Chuột Và Người",60300,76000,15700,21
TIKI,nha-sach-tiki,273634677,"Trạm Đọc Official | Hackers Ielts 4 cuốn  ( Listening + Reading + Speaking + Writing )",743000,996000,253000,25
TIKI,nha-sach-tiki,1732997,"Hồ Sơ Mật Lầu 5 Góc Và Hồi Ức Về Chiến Tranh Việt Nam (Sách Tham Khảo)",290000,290000,0,0
TIKI,nha-sach-tiki,68350215,"Combo Chinh Phục Luyện Thi Vào 10 Toán Văn Anh Theo Chủ Đề",313000,477000,164000,34
TIKI,nha-sach-tiki,49904794,"Fullset Ehon Nhật Bản cho bé thông minh sáng tạo: Ehon Điều Kỳ Diệu Của Hình Khối + Điều Kỳ Diệu Của Âm Thanh + Điều Kỳ Diệu Của Màu Sắc (Bộ 10 cuốn cho bé 0-6 tuổi / Bộ Sách Phát Triển Trí Tuệ & Kích Thích Thị Giác Cho Bé)",269000,390000,121000,31
TIKI,nha-sach-tiki,112331977,"Quiz! Khoa Học Kì Thú: Khám Phá Trái Đất",49100,68000,18900,28
TIKI,nha-sach-tiki,9687403,"The Book Of Leadership - Dẫn Dắt Bản Thân, Đội Nhóm Và Tổ Chức Vươn Xa",150000,218000,68000,31
TIKI,nha-sach-tiki,29190890,"Tôi Đi Tìm Tôi",102000,160000,58000,36
TIKI,nha-sach-tiki,187859733,"Thám Tử Đã Chết Tập 4 - Bản Phổ Thông - Quà Tặng Kèm Bookmark, Bộ Card Trong Bù Của Tập 3 (Trong Lần In Đầu)",83900,109000,25100,23
TIKI,nha-sach-tiki,595726,"Giáo Trình Chuẩn HSK 4 Bài Học (Tập 2)",179000,238000,59000,25
TIKI,nha-sach-tiki,189076559,"Gatsby vĩ đại",184000,280000,96000,34
TIKI,nha-sach-tiki,178240500,"Đường Gia Tiểu Miêu",133000,179000,46000,26
TIKI,nha-sach-tiki,187859732,"Spy Room – Lớp Học Điệp Viên 4",83900,109000,25100,23
TIKI,nha-sach-tiki,195288800,"Combo 2 Cuốn Khám Phá Sứ Mệnh Với Câu Hỏi Tại Sao – Bắt Đầu Với Câu Hỏi Tại Sao",149000,208000,59000,28
TIKI,nha-sach-tiki,172175794,"Lý Thuyết Dow - Khoa Học Đầu Cơ Chứng Khoán: Bí Quyết Phân Tích Hành Vi Thị Trường Của Cha Đẻ Chỉ Số Dow Jones - Tác Phẩm Nền Tảng Của Phân Tích Kĩ Thuật Hiện Đại",37100,55000,17900,33
TIKI,nha-sach-tiki,77281352,"Lời giải bài tập Python cơ bản",75000,75000,0,0
TIKI,nha-sach-tiki,81499980,"Danh Gia Cổ Vật - Minh Nhãn Mai Hoa",178000,230000,52000,23
TIKI,nha-sach-tiki,190701640,"Diệt Slime Suốt 300 Năm, Tôi Levelmax Lúc Nào Chẳng Hay (Tập 4) - (Tái Bản)",48000,52000,4000,8
TIKI,nha-sach-tiki,595738,"Giáo Trình Chuẩn HSK 4 Bài Tập (Tập 1)",111000,148000,37000,25
TIKI,do-choi-me-be,25769067,"Cờ Vua Nam Châm Cỡ Lớn miDoctor 4812A",175000,175000,0,0
TIKI,do-choi-me-be,66615105,"Bộ bài Uno Giấy cứng giải trí",18800,18800,0,0
TIKI,do-choi-me-be,6464017,"Cháo Tươi Cá Hồi Rong Biển Cây Thị",22500,26000,3500,13
TIKI,do-choi-me-be,104131972,"Núm vú cổ rộng silicone siêu mềm Plus Pigeon 2 Cái/Vỉ",120000,199000,79000,40
TIKI,do-choi-me-be,17114404,"Sữa tắm gội toàn thân Johnson's Baby mềm mịn (500ml)",145000,178000,33000,19
TIKI,do-choi-me-be,270845223,"Sữa cho bé 1 đến 3 tuổi Meiji nội địa Nhật giúp bé phát triển cân đối chiều cao, cân nặng, trí não - QuaTangMe Extaste",415000,415000,0,0
TIKI,do-choi-me-be,88928273,"Combo 10 Gói Khăn Ướt Trẻ Em MAMAMY 100 Tờ",296000,323000,27000,8
TIKI,do-choi-me-be,34537693,"Tã Dán Siêu Thấm Caryn Gói Siêu Tiết Kiệm L40 (40 Miếng)",369000,403300,34300,9
TIKI,do-choi-me-be,76072139,"Xe công trình xây dựng bằng kim loại  KAVY gồm 6 xe chi tiết sắc sảo, an toàn cho bé, dùng làm đồ chơi trẻ em hoặc trang trí",129000,129000,0,0
TIKI,do-choi-me-be,249030271,"Ensure Úc sữa cho người lớn Giúp hồi phục sức khỏe cho người gầy yếu, người suy dinh dưỡng - QuaTangMe Extaste",903000,2078000,1175000,57
TIKI,do-choi-me-be,130461472,"Sữa Bột Similac Einstein 3 cho trẻ 1 – 2 tuổi",510000,510000,0,0
TIKI,do-choi-me-be,1744987,"Tã Quần Mỏng Nhẹ Caryn Gói Siêu Lớn M16 (16 Miếng)",180000,181600,1600,1
TIKI,do-choi-me-be,68179518,"Nước Tẩy Nhà Tắm Mao Bao 600ml",42500,50000,7500,15
TIKI,do-choi-me-be,102738895,"Muối Rửa Bát Finish 1,2kg - Hàng Nhập Khẩu Đức",106975,106975,0,0
TIKI,do-choi-me-be,116452634,"Khăn giấy bếp PREMIER VinaRoll 2 cuộn/gói - Combo 3 gói",68000,99000,31000,31
TIKI,do-choi-me-be,29540357,"Đồ chơi lắp ghép xếp hình  Trực thăng chiến đấu 8 trong 1 Qman 1801",229000,229000,0,0
TIKI,do-choi-me-be,95035819,"Bột ăn dặm dinh dưỡng Sữa - Ăn dặm khởi đầu HiPP Organic 250g",145000,145000,0,0
TIKI,do-choi-me-be,104140783,"Tắm gội dịu nhẹ Pigeon Hương Jojoba 200ml/700ml",60000,79000,19000,24
TIKI,do-choi-me-be,52344942,"Combo 4 gói Khăn Giấy Rút See-U 2 Lớp 200 Tờ/gói",66000,66000,0,0
TIKI,do-choi-me-be,104125144,"Ty ngậm đôi Pigeon size L (HSD: 11/2025)",95000,158000,63000,40
TIKI,do-choi-me-be,184217978,"Nước Giặt ARIEL Cửa Trên Sạch Sâu",214000,236500,22500,10
TIKI,do-choi-me-be,145512639,"Nút Che Bịt Ổ Điện Chắc Chắn An Toàn Cho Bé",1881,1900,19,1
TIKI,do-choi-me-be,412772,"Tã Quần Cao Cấp Moony Nhật Bản Bé Gái XL38 (38 Miếng)",339000,466400,127400,27
TIKI,do-choi-me-be,97008405,"Combo 02 Hộp Vệ Sinh Lồng Máy Giặt Ag+ Mao Bao 306g - Tặng Chất Làm Sạch Bình Đun Nước 25g x 1 gói",84000,100000,16000,16
TIKI,do-choi-me-be,129577440,"Bột Tẩy Rong Rêu Trên Nền Xi Măng ROC",38997,38997,0,0
TIKI,do-choi-me-be,71080136,"Sure Prevent Gold HT 900g",615000,615000,0,0
TIKI,do-choi-me-be,543129,"Dung Dịch Giặt Quần Áo Cho Bé D-Nee - Chai 3000ml (Xanh)",196000,245000,49000,20
TIKI,do-choi-me-be,73638976,"Tẩy dầu mỡ máy hút mùi, mặt bếp, tường gạch ốp, bồn rửa bát HGO 500ml",105000,105000,0,0
TIKI,do-choi-me-be,68612841,"Combo 2 túi nước giặt xả Maxkleen hương Vườn Sớm Mai 3.8kg/túi ",291000,420000,129000,31
TIKI,do-choi-me-be,10054502,"Thùng 48 Hộp Sữa Bột Pha Sẵn Friso Gold Rtd Vani (48 x 180Ml)",685000,807000,122000,15
TIKI,do-choi-me-be,57967652,"Viên Thả Bồn Cầu Nhật Bản Dạng Nén Cao Cấp HOMI Mã HC01 Thế Hệ 2 Giúp Diệt Sạch Vi Khuẩn Khử Mùi Hiệu Quả Tuyệt Đối An Toàn Khi Sử Dụng (Hộp 10 viên) - Hàng Chính Hãng",26000,89000,63000,71
TIKI,do-choi-me-be,97846795,"Set 5 Khăn Rửa Mặt 4 Lớp Sợi Tre Lụa Mềm, Thấm Hút Tốt, Kháng Khuẩn 100% Thương Hiệu Bonny (KT: 30x30 Cm)",98000,98000,0,0
TIKI,do-choi-me-be,10021552,"Sữa Bột Meiji 0-1 Infant Formula (800g)",519000,519000,0,0
TIKI,do-choi-me-be,170331247,"Gạc Rơ Lưỡi Oribebe Vệ Sinh Răng Miệng Cho Bé Hộp 30 Gói",115000,165000,50000,30
TIKI,do-choi-me-be,6464033,"Cháo Tươi Rau Củ Thập Cẩm Cây Thị",18900,22000,3100,14
TIKI,do-choi-me-be,76507811,"Đồ Chơi Rút Gỗ Trẻ Em - 2 Cỡ (Lớn và Nhỏ) - 54 Thanh Rút Gỗ Kèm 4 Con Súc Sắc Cho Bé – Bộ Đồ Chơi Rút Gỗ Cao Cấp Chính Hãng Amalife",39000,39000,0,0
TIKI,do-choi-me-be,53039237,"Combo 2 Túi Nước rửa bình sữa Arau Baby (450ml x 2 túi)",229000,229000,0,0
TIKI,do-choi-me-be,43191091,"Thùng 48 Hộp Sữa Anlene Đậm Đặc 4X Ít Béo Hương Vani (12 x 4 x 125 ml)",509000,552000,43000,8
TIKI,do-choi-me-be,109882431,"BẤM MÓNG TAY AN TOÀN CHO TRẺ SƠ SINH NUK DÙNG CHO BÉ TỪ 0 THÁNG TUỔI",65000,69000,4000,6
TIKI,do-choi-me-be,189657651,"Nước giặt Lix Đậm Đặc Hương Hoa Túi 3.5Kg - Tẩy Sạch Cực Mạnh Vết Bẩn - NG350",115000,115000,0,0
TIKI,nha-sach-tiki,22881666,"Mindset For IELTS - Foundation Student's Book With Testbank And Online Modules",367350,395000,27650,7
TIKI,nha-sach-tiki,146272575,"Ăn Ít Để Khỏe - 1 Bữa Là Đủ Sao Phải Cần 3 (Tái Bản 2021)",92900,119000,26100,22
TIKI,nha-sach-tiki,194206884,"Frugal Innovation - Làm tốt hơn với nguồn lực ít hơn",142000,220000,78000,35
TIKI,nha-sach-tiki,173425949,"Khung ảnh để bàn nhiều kích thước, khung ảnh trong suốt Anzzar loại 2.5cm",47000,55000,8000,15
TIKI,nha-sach-tiki,73116944,"Combo 20 cuốn - Bé Tô màu - Luyện chữ (Mầm non - Chuẩn bị vào lớp 1)",99272,190907,91635,48
TIKI,nha-sach-tiki,34750340,"Ngụ Ngôn Song Ngữ Anh - Việt: Đừng Tin Lời Gã Cáo (Tái Bản 2019)",16800,28000,11200,40
TIKI,nha-sach-tiki,35410612,"Combo Sách Tư Duy - Kỹ Năng Sống Ai Cũng Cần Phải Có : Cân Bằng Cảm Xúc, Cả Lúc Bão Giông + Nóng Giận Là Bản Năng , Tĩnh Lặng Là Bản Lĩnh ( Tặng Kèm Bookmark Green Life)",163500,163500,0,0
TIKI,nha-sach-tiki,195661677,"Tư Duy Sâu, Ý Tưởng Bén, Sáng Tạo Thần Sầu",139000,139000,0,0
TIKI,nha-sach-tiki,121236564,"PHÂN TÍCH MẪU HÌNH BIỂU ĐỒ - Những Bí Quyết Giúp Nhà Giao Dịch Siêu Hạng DAN ZANGER Biến 11 Nghìn Đô Thành 42 Triệu Đô Trong 23 Tháng",348000,348000,0,0
TIKI,nha-sach-tiki,72470133,"Bộ Cọ Tròn 6 Cây Chuyên Dụng Cao Cấp Để Tô Vẽ Tranh Sơn Dầu, Màu Nước, Màu Acrylic, Vẽ Nghệ Thuật",45000,59000,14000,24
TIKI,nha-sach-tiki,170298040,"Những Ý Tưởng Lớn Của Lý Quang Diệu",79000,120000,41000,34
TIKI,nha-sach-tiki,181699596,"Jesse Livermore - Nhà Đầu Tư Chứng Khoán Vĩ Đại",152000,219000,67000,31
TIKI,nha-sach-tiki,74235036,"Điều Kỳ Diệu của Thái Độ Sống (Tái Bản)",44100,58000,13900,24
TIKI,nha-sach-tiki,14683083,"Nhượng Quyền Khỏi Nghiệp - Con Đường Ngắn Để Bước Ra Thế Giới (Tái Bản)",112000,112000,0,0
TIKI,nha-sach-tiki,74307132,"Arty Mouse - Đồ Theo Nét (Học Tập Đầu Đời Thông Qua Mỹ Thuật)",41700,45000,3300,7
TIKI,nha-sach-tiki,157054867,"Tôi Muốn Giỏi Tiếng Anh Nhưng Tôi Không Muốn Chăm Chỉ",145000,210000,65000,31
TIKI,nha-sach-tiki,168559528,"Chiêm Tinh Học For Dummies",171000,249000,78000,31
TIKI,nha-sach-tiki,16422526,"365 Chuyện Kể Trước Giờ Đi Ngủ - Những Câu Chuyện Phát Triển Chỉ Số Tình Cảm EQ (Tái Bản)",55000,78000,23000,29
TIKI,nha-sach-tiki,70540568,"Nuôi Dạy Bé Gái Từ 0 Đến 6 Tuổi (Tái Bản 2020)",52000,75000,23000,31
TIKI,nha-sach-tiki,115078652,"Huấn Luyện Cảm Xúc Để Con Trẻ Phát Triển Toàn Diện",152000,198000,46000,23
TIKI,nha-sach-tiki,173515430,"Khám Phá Vận Mệnh - 7 Bước Đánh Thức Bản Thân",82900,145000,62100,43
TIKI,nha-sach-tiki,146502516,"[Hàng Cao Cấp Loại Dày 2mm] Băng Dính 2 Mặt Đa Năng Trong Suốt Siêu Dày 2mm – Chọn Chiều Dài – Siêu Bám Dính - Băng Keo Trong Suốt Chính Hãng dododios",29000,29000,0,0
TIKI,nha-sach-tiki,173973552,"Sách Từ Vựng Tiếng Anh : Từ Cùng Trường Nghĩa Trong Tiếng Anh Cô Trang Anh",149000,200000,51000,26
TIKI,nha-sach-tiki,273119845,"Ông Trùm Cuối Cùng (Mario Puzo)",99000,150000,51000,34
TIKI,nha-sach-tiki,593709,"Góc Khuất Đàn Bà - Bản Thông Thường",66300,89000,22700,26
TIKI,nha-sach-tiki,19274771,"Chuỗi Án Mạng A.B.C (Tái Bản)",62100,105000,42900,41
TIKI,nha-sach-tiki,272588674,"Giấy Photo, giấy in Samsung A4/70gsm - 500 tờ/ream",78000,78000,0,0
TIKI,nha-sach-tiki,1029852,"Tuần Của Bé - Bé Thân Thiện (Dành Cho Trẻ 3 - 6 Tuổi)",21850,23000,1150,5
TIKI,nha-sach-tiki,13116553,"Thị Trấn Mèo Tập 1 (Tái Bản 2019)",62000,68000,6000,9
TIKI,nha-sach-tiki,195541265,"Bài Tập Thực Hành Tiếng Anh 7 (Có Đáp Án) - Dùng Kèm SGK Tiếng Anh 7 GLOBAL SUCCESS",64000,65000,1000,2
TIKI,nha-sach-tiki,77323488,"Chatter - Trò Chuyện Với Chính Mình",128000,199000,71000,36
TIKI,nha-sach-tiki,41556498,"Tác Phẩm Kinh Điển: Thiên Tài Bên Trái, Kẻ Điên Bên Phải / Sách Văn Học Hay (Tặng Kèm Bookmark Thiết Kế Bookmark Happy Life)",163250,163250,0,0
TIKI,nha-sach-tiki,34751670,"Ngụ Ngôn Song Ngữ Anh - Việt: Đôi Sừng Hươu (Tái Bản 2019)",19200,32000,12800,40
TIKI,nha-sach-tiki,186290800,"Đón Ngọn Triều Dâng",76600,130000,53400,41
TIKI,nha-sach-tiki,22881827,"Complete IELTS B1 Student's Book with answer with CD-ROM",259470,279000,19530,7
TIKI,nha-sach-tiki,10675287,"EAT CLEAN Thực Đơn 14 Ngày Thanh Lọc Cơ Thể Và Giảm Cân",105000,149000,44000,30
TIKI,nha-sach-tiki,173878382,"Bảng Từ Trắng Viết Bút Lông Deli - Bảng Mica Hít Nam Châm Nhiều Kích Cỡ - Có Khay Đựng - Phù Hợp Học Sinh Văn Phòng - EV450 / EV600 / EV900",199000,405000,206000,51
TIKI,nha-sach-tiki,182735416,"Pet Sematary - Nghĩa địa thú cưng - 1980books",209300,299000,89700,30
TIKI,nha-sach-tiki,91343895,"Những Sự Thật Về Ung Thư - Hiểu Thêm Để Bớt Lo",74100,105000,30900,29
TIKI,nha-sach-tiki,109982974,"Alfred Nobel Và Bản Di Chúc Bất Hủ",51500,65000,13500,21
TIKI,do-choi-me-be,119706884,"Sữa tắm gội dịu lành cho bé Cetaphil Baby Wash & Shampoo with Organic Calendula 400ml",295000,295000,0,0
TIKI,do-choi-me-be,10021580,"Sữa Bột Meiji 1-3 Growing Up Formula (800g)",455000,455000,0,0
TIKI,do-choi-me-be,7250239,"Chất Thông Cống Siêu Mạnh SiFa (1.6kg)",65000,65000,0,0
TIKI,do-choi-me-be,138581421,"Combo 10 Gói Khăn Ướt Yuniku 20 Tờ Hương Hoa Lài ( 20 Tờ x 10 )",95000,137000,42000,31
TIKI,do-choi-me-be,104341333,"Xe đẩy cho bé, Xe Đẩy Gấp Gọn 2 Chiều Thông Minh Cho Bé, Xe Đẩy Dạo Chơi Cho Bé Du Lịch",310000,310000,0,0
TIKI,do-choi-me-be,107935064,"Bình sữa mô phỏng tự nhiên hiệu Philips Avent (260 ml - đơn) cho trẻ từ 1 tháng tuổi 693.13",295000,295000,0,0
TIKI,do-choi-me-be,108598576,"[LOẠI XỊN - CÓ CHỌN SIZE] Cờ Vây Nam Châm Cao Cấp, Cờ Caro Tiện Dụng Chính Hãng - Chọn Nhiều Cỡ",155000,155000,0,0
TIKI,do-choi-me-be,150565149,"Bộ Dụng Cụ Lấy Ráy Tai Có Đèn Led Cao Cấp Kèm Hộp Đựng Sịn Sò Sử Dụng Cổng Sạc USB",179000,179000,0,0
TIKI,do-choi-me-be,104883479,"Nước Rửa Chén Gốc Thực Vật Peace Mass Công Nghệ Enzyme Rửa Sạch & Không Lưu Mùi (Thuộc nhóm Sản phẩm Lành tính / Hữu cơ) Can 3.6 Lít",162450,171000,8550,5
TIKI,do-choi-me-be,81227999,"Xe Cứu Hoả Duka DK81039",135000,180000,45000,25
TIKI,do-choi-me-be,89802357,"Nước Rửa Bát Hữu Cơ ENZYCO Lên Men Từ Bồ Hòn Và Dứa Không Chất Tẩy Công Nghiệp Không Gây Dị Ứng Cho Tay An Toàn Cho Trẻ Nhỏ Mùi Hương - Chai",180000,180000,0,0
TIKI,do-choi-me-be,108753317,"Núm ty Silicon mô phỏng tự nhiên hiệu Philips Avent cho trẻ sơ sinh",225000,225000,0,0
TIKI,do-choi-me-be,116727455,"(Date mới) Sữa Hữu Cơ Miwako A+ Hộp 700g Vị Vani Nhập Khẩu Malaysia, Sữa Hạt Organic Dinh Dưỡng Phát Triển Trí Não & Chiều Cao Cho Bé Từ 1-6 Tuổi Vị Ngọt Thanh Dễ Uống",649000,675000,26000,4
TIKI,do-choi-me-be,173910843,"Xe ô tô điều khiển từ xa KAVY 058 bằng cử chỉ có nhạc, đèn phun được khói xoay 360 độ cao",525000,525000,0,0
TIKI,do-choi-me-be,198614354,"Bình Trữ Sữa Cổ Rộng Mama's Choice 180ml–240ml, Tương Thích Máy Hút Sữa Spectra, Avent, Fatz, Rozabi, Cimilre",92000,95000,3000,3
TIKI,do-choi-me-be,95035813,"Bột ăn dặm dinh dưỡng Sữa, Chuối, Đào HiPP Organic 250g",145000,145000,0,0
TIKI,do-choi-me-be,54412956,"Bộ Cờ Cá Ngựa – Cờ Cá Ngựa Nam Châm – Chính Hãng An Toàn Vui Nhộn Cho Bé (Vỏ Hộp Màu Ngẫu Nhiên)",95000,130000,35000,27
TIKI,do-choi-me-be,55294509,"Đồ Chơi Lắp Ghép Bộ Chữ Số Biến Hình Từ 1 2 3 4 5 6 7 8 9 Thành Robot",299000,400000,101000,25
TIKI,do-choi-me-be,197529904,"Học liệu bóc dán thông minh cho bé, học liệu busy book 17 chủ đề đa dạng dùng nhiều lần",89500,89500,0,0
TIKI,do-choi-me-be,26303479,"Cốc Hút Sữa Silicon NatureBond Chính Hãng Hoa Kỳ, số 1 tại Anh, Canada + Nút chặn chống đổ sữa, túi nhung cao cấp",499000,499000,0,0
TIKI,do-choi-me-be,74871422,"Đồ chơi xe ô tô địa hình chạy đà KAVY quán tính bằng nhựa nguyên sinh an toàn, chạy rất xa và khỏe",24000,24000,0,0
TIKI,do-choi-me-be,196675403,"Cốc tập uống bằng nhựa HiPP - Nhập khẩu Đức (Màu ngẫu nhiên)",75000,75000,0,0
TIKI,do-choi-me-be,30911702,"Bộ Bài Tarot Bói Smith Waite Tarot  Cao Cấp",89000,89000,0,0
TIKI,do-choi-me-be,879798,"3 Gói Khăn Ướt Yuniku Max Cool YK20-02 (20 Tờ x 3) - 3 Màu",29000,41100,12100,29
TIKI,do-choi-me-be,104850929,"Váy đầm bé gái Hồng Chấm Bi Cổ Vàng KIKA - Size 11-45kg - K139",199000,199000,0,0
TIKI,do-choi-me-be,2682725,"Thuốc viên diệt gián nội địa Nhật Bản",66000,77000,11000,14
TIKI,do-choi-me-be,57930183,"Hộp 8 bộ đồ chơi lắp ráp Trực thăng tấn công 8in1 Qman 1801 (381 chi tiết)",199000,269000,70000,26
TIKI,do-choi-me-be,435753,"Sữa Bột Abbott Grow 3 cho trẻ từ 1- 2 tuổi (900g)",295000,295000,0,0
TIKI,do-choi-me-be,77014311,"Nước Rửa Chén Sinh Học ENZYCO Lên Men Tự Nhiên Từ Dứa Và Bồ Hòn An Toàn Cho Da Tay Và Diệt Khuẩn - Hương Cam 480ml",100000,100000,0,0
TIKI,do-choi-me-be,115483210,"Sữa bột Enfagrow A+ NeuroPro 3 với 2’-FL HMO cho trẻ từ 1 – 3 tuổi – 830g",492000,492000,0,0
TIKI,do-choi-me-be,171666372,"[Tặng 12 màu + 2 cọ] Combo 20 tượng thạch cao size 5cm - Tô tượng cho bé",55000,55000,0,0
TIKI,do-choi-me-be,64978053,"Combo 4 Gói Khăn Ướt Max Cool 80 Tờ Có Hương Tặng 2 Gói Cùng Loại",124000,124000,0,0
TIKI,do-choi-me-be,109372981,"Hộp 6 bộ đồ chơi lắp ráp Robot biến hình - Khủng long (553 chi tiết) Qman 1414",339000,349000,10000,3
TIKI,do-choi-me-be,109123361,"Combo 60 túi trữ sữa mẹ Sunmum mini hồng 100ml (2 hộp) tặng 2 zipper bảo quản",125000,138000,13000,9
TIKI,do-choi-me-be,144121555,"Túi Trữ Sữa Và Bảo Quản Sữa Mẹ Mama’s Choice, Bịch Đựng Sữa Mẹ, Có Khóa Zip Tiện Lợi An Toàn, Lẻ 10 Túi",65000,87000,22000,25
TIKI,do-choi-me-be,184101595,"Combo 2 túi Nước giặt OMO Matic Comfort Hương Hoa Hồng Ecuador cho máy giặt cửa trên, túi 3.6kg",350000,454000,104000,23
TIKI,do-choi-me-be,263388843,"Viên giặt xả Bold Gel Ball 3D hương hoa túi 44 viên của Nhật Bản",179000,179000,0,0
TIKI,do-choi-me-be,50615508,"Xe gà cho bé tập đi bằng gỗ siêu bền",95997,95997,0,0
TIKI,do-choi-me-be,115694868,"Đồ chơi lắp ráp xếp hình robot người máy Qman 1414 - Siêu Robot khủng long (456 mảnh ghép) dành cho bé trên 6 tuổi",259000,359000,100000,28
TIKI,do-choi-me-be,51661295,"Vitamin k2 d3 Lineabon từ Châu Âu chứa MK7 giúp hấp thụ calci – Hỗ trợ hấp thu canxi tự nhiên cho trẻ, giúp tăng chiều cao, hết còi xương - Hết ngay khóc đêm, trằn trọc, mồ hôi trộn",275000,369000,94000,25
TIKI,do-choi-me-be,118946346,"Nước rửa chén bát hữu cơ Golden Life 1L - Hương",42000,42000,0,0
TIKI,do-choi-me-be,95269416,"Tã Dán Siêu Cao Cấp Huggies Platinum Naturemade M64 (64 Miếng)",329000,460000,131000,28
TIKI,do-choi-me-be,19944519,"Tã dán người lớn Caryn XL10 (10 Miếng)",130000,144400,14400,10
TIKI,do-choi-me-be,146499353,"Bộ Bài Tây Poker Nền Đen Cao Cấp Chọn Màu – Bài Tây Đen Bằng Nhựa PVC Chống Thấm Nước Chống Gập Chính Hãng Dododios",29000,29000,0,0
TIKI,do-choi-me-be,194017033,"Balo Tiểu Học Dành Bé Trai Mr Vui 838",337000,398000,61000,15
TIKI,do-choi-me-be,82482707,"GẤU BÔNG KHỦNG LONG LỬA NGỦ SAY (30 CM) GB73",99000,99000,0,0
TIKI,do-choi-me-be,54477959,"Đồ chơi trẻ em bằng nhựa ABS Vô Lăng Tập Lái Cho Bé Có 2 màu cho bé trai và gái",300000,300000,0,0
TIKI,do-choi-me-be,74973224,"Đồ chơi xe địa hình điều khiển từ xa KAVY tỷ lệ 1:16 bằng hợp kim tốc độ cao, bền bỉ chắc chắn, dẫn động 2 bánh",360000,360000,0,0
TIKI,do-choi-me-be,196757806,"Set 2 Miếng Silicon Bọc Góc Bàn, Góc Tủ, Cạnh Giường Giữ An Toàn Cho Bé",39000,39000,0,0
TIKI,do-choi-me-be,67729762,"Sữa tắm gội toàn thân Cetaphil Baby Gentle Wash & Shampoo 2 in 1 400ml",221000,226000,5000,2
TIKI,do-choi-me-be,179764120,"Đồ bộ bé gái, quần áo Mimykid in 3D hoạt hình dễ thương, đáng yêu chất liệu thun dày mịn mát, được các bé gái yêu thích, thời trang, set, đồ cho trẻ em, bé gái từ 8kg-28kg",66000,66000,0,0
TIKI,do-choi-me-be,104144223,"Tắm gội dịu nhẹ Pigeon Hoa hướng dương 200ml/700ml",60000,79000,19000,24
TIKI,do-choi-me-be,188126560,"Combo 3 Viên Tẩy Bồn Cầu VIM Power 5 Hương Trà Xanh Chanh Vàng 55G",83000,84000,1000,1
TIKI,do-choi-me-be,62315154,"Hộp 12 viên diệt gián tận gốc Nhật Bản",35999,35999,0,0
TIKI,do-choi-me-be,214238333,"Sữa tăng chiều cao và tăng cân cho trẻ Milo Úc và A2 Full Cream High In Calcium Úc - Chống loãng xương ở người lớn, tăng sức khỏe tổng thể - Massel Official",461000,922000,461000,50
TIKI,do-choi-me-be,101148136,"Bột Thông Cống YUHAO 280gr - Thông Tắc Cực Mạnh, Đường Ống, Bồn Cầu, Bồn Rửa Mặt - Hàng Chính Hãng",31000,39000,8000,21
TIKI,do-choi-me-be,48040396,"Muối rửa chén Finish Dishwasher Salt 4kg PTT017389",228000,228000,0,0
TIKI,do-choi-me-be,20088699,"Dầu dưỡng ẩm mát xa Johnson's Baby (200ml)",105000,105000,0,0
TIKI,do-choi-me-be,17459641,"Hộp xếp hình lắp ráp sáng tạo 460 chi tiết Qman 2901",179000,214000,35000,16
TIKI,do-choi-me-be,122234661,"Đồ chơi lắp ráp tháp trượt lăn bi, trò chơi thách thức trí tuệ và vui nhộn cho bé từ 3 tuổi",180000,180000,0,0
TIKI,do-choi-me-be,72875812,"Combo 20 gói khăn giấy lau tay Roto eco20-2 hai lớp 100% bột giấy nguyên sinh, dài 20cm, họa tiết chấm bi xốp, thấm hút 2 chiều, gồm 102 tờ/gói",232000,360000,128000,36
TIKI,do-choi-me-be,67546214,"Sữa Tắm Gội Toàn Thân Cetaphil Baby Gentle Wash Shampoo 2 in 1 (400ml)",221000,226000,5000,2
TIKI,do-choi-me-be,125628724,"Cờ Tỉ Phú Monopoly – Cờ Tỷ Phú Vui Nhộn Cao Cấp, An Toàn Cỡ Cực Đại 42x42 – Hàng Chính Hãng",96000,180000,84000,47
TIKI,do-choi-me-be,3708857,"Combo 5 gói giấy ướt không mùi Mamamy mẫu mới nhất (Gói 100 tờ)",162500,162500,0,0
TIKI,do-choi-me-be,115483438,"Sữa bột Enfamil A+ NeuroPro 1 với 2’-FL HMO cho trẻ từ 0 – 6 tháng tuổi– 830g",567000,567000,0,0
TIKI,do-choi-me-be,115483446,"Sữa bột Enfagrow A+ NeuroPro 3 với 2’-FL HMO cho trẻ từ 1 – 3 tuổi– 400g",239000,239000,0,0
TIKI,do-choi-me-be,87378190,"Nước giặt LIX Đậm đặc Hương Nước hoa (Cam) tẩy sạch vết bẩn cực mạnh túi 3.5KGX2",189000,189000,0,0
TIKI,do-choi-me-be,576191,"Nước Giặt Kháng Khuẩn Mao Bao 3200g",124500,159000,34500,22
TIKI,do-choi-me-be,130015080,"[MUA LÀ CÓ QUÀ] Tấm Lót Thấm Sữa Nha Đam Pigeon 12 miếng/30 miếng/50 miếng",42000,52000,10000,19
TIKI,do-choi-me-be,25026925,"Combo 2 Gói Tã Quần Người Lớn Sunmate Khô Thoáng M8 (8 Miếng/ Gói)",161000,199999,38999,19
TIKI,do-choi-me-be,103881069,"Miếng Bịt Góc Bàn Ghế Hình Chân Mèo",56250,56250,0,0
TIKI,do-choi-me-be,116448455,"Nước hoa Johnson's Baby Cho Bé - Dung Tích 125ml",81000,81000,0,0
TIKI,do-choi-me-be,184101603,"Combo 2 túi nước xả vải làm mềm vải Comfort Chăm sóc Chuyên sâu Hương nước hoa thiên nhiên Sophia túi 3.8L",420000,542000,122000,23
TIKI,do-choi-me-be,55512044,"Sữa Bột Anlene Gold Movepro 3X Hương Vanilla (Hộp Giấy 1,2kg)",455000,455000,0,0
TIKI,do-choi-me-be,89144736,"Xe Tập Đi Bằng Gỗ 3 Con Gà Cao Cấp Cho Bé Yêu",88000,88000,0,0
TIKI,do-choi-me-be,273235757,"Sữa dành cho người tiểu đường Glucerna Úc Bổ sung dinh dưỡng, cân bằng đường huyết, tạo sức khỏe tim, tăng sức khỏe chung - QuaTangMe Extaste",1045000,2090000,1045000,50
TIKI,do-choi-me-be,117720148,"Combo 4 miếng bịt góc bàn silicon an toàn cho trẻ - TIDO",20000,20000,0,0
TIKI,do-choi-me-be,184101593,"Combo 2 túi nước xả vải làm mềm vải Comfort Chăm sóc Chuyên sâu Hương nước hoa thiên nhiên Bella túi 3.8L",420000,542000,122000,23
TIKI,do-choi-me-be,143503334,"BA LÔ CHỐNG GÙ HÌNH GẤU CHO BÉ",109000,109000,0,0
TIKI,do-choi-me-be,164075691,"Tả quần Kitin Natural size L40 (9-14kg)",153000,225000,72000,32
TIKI,nha-sach-tiki,4319337,"Tạo Dựng Thương Hiệu Cá Nhân",76300,109000,32700,30
TIKI,nha-sach-tiki,148802195,"How We’Re F***Ing Up Our Planet - Ta Đang Hủy Diệt Trái Đất Như Thế Nào",255000,330000,75000,23
TIKI,nha-sach-tiki,186578233,"Trúc thư dao 2 (Nước Tấn - Gió nổi cung đình)",173000,219000,46000,21
TIKI,nha-sach-tiki,154245459,"Nghiền Từ Vựng Tiếng Anh - Học Qua Gốc Từ Bằng Hình Ảnh - Gốc Từ Là Bí Quyết Để Ghi Nhớ Hàng Nghìn Từ Vựng - Quyển 1",89000,135000,46000,34
TIKI,nha-sach-tiki,163297416,"My Hero Academia - Học Viện Siêu Anh Hùng Tập 3: All Might (Tái Bản)",25000,25000,0,0
TIKI,nha-sach-tiki,105837988,"Hộp 22 gôm tẩy học sinh Deli - Hình dáng ngộ nghĩnh đáng yêu - 71055 / 71054",59400,59400,0,0
TIKI,nha-sach-tiki,82072617,"Các Lỗi Thường Gặp Trong Tiếng Anh",51500,80000,28500,36
TIKI,nha-sach-tiki,8128223,"Lột xác để trở thành nhà đầu tư giá trị - The education of a value investor",268000,268000,0,0
TIKI,nha-sach-tiki,172160196,"Thấu Hiểu Marketing Bệnh Viện",249000,249000,0,0
TIKI,nha-sach-tiki,110649726,"Hành Trình Thức Tỉnh ",229000,229000,0,0
TIKI,nha-sach-tiki,82996527,"Tinh Thần Chiến Đấu Rực Lửa",66500,95000,28500,30
TIKI,nha-sach-tiki,714023,"Ngụ Ngôn E Dốp - Văn Học Cổ Điển Hi Lạp",58800,98000,39200,40
TIKI,nha-sach-tiki,63924629,"Tạp Văn Nguyễn Ngọc Tư (Tái Bản Lần Thứ 20-2020)",62000,90000,28000,31
TIKI,nha-sach-tiki,186265472,"Thế Giới Của Truyện Nôm",112000,170000,58000,34
TIKI,nha-sach-tiki,427631,"Tầm Nhìn Thay Đổi Quốc Gia",187000,268000,81000,30
TIKI,nha-sach-tiki,730723,"Tuần Của Bé Tháng 7- Bé Tự Tin",11500,23000,11500,50
TIKI,nha-sach-tiki,273718791,"Sapiens: Lược Sử Loài Người",224000,299000,75000,25
TIKI,nha-sach-tiki,273714602,"Trạm Đọc | Thuật Tẩy Não - Nghệ Thuật Thao Túng Và Kiểm Soát Tâm Lý Đối Phương",141000,189000,48000,25
TIKI,nha-sach-tiki,190238358,"Nhặt Sao - Bản Thường - (Tặng kèm 1 bookmark in 2 mặt)",161000,179000,18000,10
TIKI,nha-sach-tiki,192833921,"Combo 2 Sách: Tiếng Anh Cho Người Mới Bắt Đầu và Tổng Ôn Ngữ Pháp Tiếng Anh Cô Trang Anh",328000,400000,72000,18
TIKI,nha-sach-tiki,14684312,"Dấn Thân (Tái Bản)",75000,112000,37000,33
TIKI,nha-sach-tiki,191926658,"Trái cây đại chiến Zombie - Thế giới khủng long: Tập 10 - Vương quốc ngủ say",58000,89000,31000,35
TIKI,nha-sach-tiki,273568395,"Husky Và Sư Tôn Mèo Trắng Của Hắn (Tập 2)",111000,169000,58000,34
TIKI,nha-sach-tiki,196394987,"Hai Ta Trên Đường Kẻ Cuộc Đời",98400,109000,10600,10
TIKI,nha-sach-tiki,193896500,"How Yoga Works: Bí mật Yoga",171900,239000,67100,28
TIKI,nha-sach-tiki,49252204,"Dạy Con Làm Giàu - Tập 12: Lời Tiên Tri Của Người Cha Giàu (Tái Bản)",98200,160000,61800,39
TIKI,nha-sach-tiki,147964307,"COMBO SÁCH PHÙ HỢP MỌI THỂ LOẠI ĐẦU TƯ – KỸ THUẬT KHÓ CHẲNG LO",428000,428000,0,0
TIKI,nha-sach-tiki,188930498,"Người Bà Tài Giỏi Vùng Saga – Tập 6",40500,52000,11500,22
TIKI,nha-sach-tiki,644081,"Đường Về",52000,70000,18000,26
TIKI,nha-sach-tiki,194103341,"Bột Nước Muối Men: Nền tảng của bánh mỳ và pizza thủ công",232000,360000,128000,36
TIKI,nha-sach-tiki,189557421,"Blog Writing - Sống với nghề viết blog",216000,250000,34000,14
TIKI,nha-sach-tiki,107576379,"Sổ tay học sinh Destination B1,B2,C1&2",118500,118500,0,0
TIKI,nha-sach-tiki,58165559,"Ngữ Pháp Tiếng Hàn Thông Dụng - Sơ Cấp",160000,250000,90000,36
TIKI,nha-sach-tiki,191782142,"Điều Vĩ Đại Đời Thường",63000,92000,29000,32
TIKI,nha-sach-tiki,47323978,"Quick Quick Học Nhanh Toàn Diện Từ Vựng Tiếng Anh Theo Chủ Đề Lớp 1",66000,89000,23000,26
TIKI,nha-sach-tiki,111537683,"Và Rồi Chẳng Còn Ai (Agatha Christie)",64200,110000,45800,42
TIKI,nha-sach-tiki,75454261,"Stay Positive - Sống Tích Cực, Đời Hết Bực - Bí Quyết Sống Vui Mỗi Ngày",99000,120000,21000,18
TIKI,nha-sach-tiki,19948893,"Chạm Tay Hóa Vàng (Tái Bản)",77000,125000,48000,38
TIKI,nha-sach-tiki,145977554,"Combo 2 Cuốn: Thần Số Học + Thần Số Học Ứng Dụng",242300,348000,105700,30
TIKI,nha-sach-tiki,7982626,"Thế Giới Phẳng (Tái Bản)",162000,310000,148000,48
TIKI,nha-cua-doi-song,19920919,"Bật Lửa Mồi Lửa Bếp Gas Bếp Cồn An Toàn (Màu Sắc Ngẫu Nhiên)",13000,24000,11000,46
TIKI,nha-cua-doi-song,152816167,"Bình Đựng Nước 2L Dễ Thương Có Vạch Báo Giờ Uống Nước Mỗi Ngày Kèm Khăn Lau 2 Mặt BaoAn - Hàng Chính Hãng",89000,99000,10000,10
TIKI,nha-cua-doi-song,134582057,"TẤM LÓT BẢO VỆ NỆM HÀNG KHÁCH SẠN CAO CẤP 1M/1M2/1M4/1M6/1M8/2M2",140000,140000,0,0
TIKI,nha-cua-doi-song,73371758,"Găng tay làm vườn -  Găng Tay Chống Cắt Ansell 11-801 Cấp Độ 1 - Chống Đâm Xuyên, Giặt Và Tái Sử Dụng",61750,65000,3250,5
TIKI,nha-cua-doi-song,204279461,"Lư xông trầm gỗ hương nguyên khối cao cấp HÀ XÁ",199000,398000,199000,50
TIKI,nha-cua-doi-song,10768010,"Đèn bắt muỗi Điện Quang ĐQ EML06L ",300000,300000,0,0
TIKI,nha-cua-doi-song,49116420,"Bút thử nước TDS, dụng cụ đo TDS, máy đo độ cứng của nước",102000,159000,57000,36
TIKI,nha-cua-doi-song,52760599,"Dây Đèn LED Đom Đóm Fairy Light Trang Trí Ngoài Trời Chống Nước, Nhiều Chế Độ Sáng",42000,42000,0,0
TIKI,nha-cua-doi-song,114938906,"Bộ 6 Ly Thấp Thuỷ Tinh Luminarc Louvre 260ml -  LULON1808",281000,281000,0,0
TIKI,nha-cua-doi-song,119025800,"Bộ 5 Hộp Đựng Thực Phẩm Giỏ Có Nắp Đậy Khay Nhựa Kèm Rổ Ráo Nước Để Tủ Lạnh Bảo Quản Thức Ăn Tiện Dụng",119935,119935,0,0
TIKI,nha-cua-doi-song,153770352,"Thanh Móc 9 Lỗ Treo Quần Áo Tiện Dụng",7500,12000,4500,38
TIKI,nha-cua-doi-song,47461891,"Bộ 6 vỉ (12 viên pin) pin Kiềm Alkaline Panasonic AA LR6T/2B-Hàng chính hãng",172000,180000,8000,4
TIKI,nha-cua-doi-song,67111908,"Mật rỉ đường ủ phân bón (can 7kg) - Mật đường can 5 Lít",155000,155000,0,0
TIKI,nha-cua-doi-song,14453485,"Combo 10 móc treo đồ dán tường",4790,4790,0,0
TIKI,nha-cua-doi-song,172123103,"Bàn làm việc thông minh kèm giá sách cho học sinh, sinh viên hiện đại kiểu Hàn từ gỗ MDF, phủ Melamin chống xước ND01",400000,400000,0,0
TIKI,nha-cua-doi-song,52145781,"Bàn Trà Cafe, Bàn Trà Sofa Phong Cách Bắc Âu Thương Hiệu IGEA",199000,218000,19000,9
TIKI,nha-cua-doi-song,90510185,"Ghế gác chân, Gác chân Guitar - Kzm Kurtzman KGQ3 - Điều chỉnh 4 mức độ cao thấp - Hàng chính hãng",112000,112000,0,0
TIKI,nha-cua-doi-song,179063461,"Bộ 2 khăn tắm cotton cao cấp dành cho gia đình, siêu thấm hút, mềm mại, kháng khuẩn",189000,189000,0,0
TIKI,nha-cua-doi-song,6329515,"Đèn gắn tường - đèn tường - đèn treo tường cao cấp FLOWER",118000,118000,0,0
TIKI,nha-cua-doi-song,173558017,"Lưỡi cắt cỏ tận gốc sợi thép siêu bền",85000,85000,0,0
TIKI,nha-cua-doi-song,249157000,"Giá Treo Bàn Chải Đánh Răng OENON liền 2 Nhả Kem tự động kèm cốc hút từ tính lắp đặt dán tường gạch men",99000,180000,81000,45
TIKI,nha-cua-doi-song,167391475,"Kệ Để Giày Dép 05 Tầng Khung Inox, Giá Để Giày Inox 05 Tầng, Giày Dép, Kệ Để Đồ, Kệ Sách Loại Cao Cấp miDoctor",106000,180000,74000,41
TIKI,nha-cua-doi-song,155184630,"Móc Treo Quần Áo, Móc Treo Đa Năng Hara, Bộ Sưu Tập Móc Quần Áo Người Lớn Nhựa Cao Cấp Inochi",26950,26950,0,0
TIKI,nha-cua-doi-song,181909432,"Chảo Suit LocknLock CSU1263PIK - Màu Pink",395000,759000,364000,48
TIKI,nha-cua-doi-song,71544914," Ổ Cắm Wifi Thông Minh TP-Link Tapo P100 - Hàng Chính Hãng ",199000,199000,0,0
TIKI,nha-cua-doi-song,194496895,"Chặn cửa chân móng ngựa có lẫy gạt HOBBY Home Decor CMG1 chống va đập cửa ở bất kì vị trí nào tiện dụng",85000,129000,44000,34
TIKI,nha-cua-doi-song,149149135,"Kệ Gia Vị 3 Tầng Để Bàn Thương Hiệu IGA - GM04",181000,197000,16000,8
TIKI,nha-cua-doi-song,148797223,"Bộ Hộp Cơm Giữ Nhiệt Văn Phòng Cao Cấp Cắm Điện inox 3 Tầng - Chính Hãng MINIIN",176000,199000,23000,12
TIKI,nha-cua-doi-song,164326067,"Bộ Chổi Điện Cọ Rửa Đa Năng Spin 3 Đầu - Máy Chà Tẩy Rửa Vệ Sinh Thông Minh Dùng Cho Nhà Tắm, Nhà Bếp - HÀNG CHÍNH HÃNG",495000,495000,0,0
TIKI,nha-cua-doi-song,196362415,"Máy cắt cỏ, tỉa cành cầm tay LAPUSEN pin khủng 15000mah, động cơ mạnh 1800w",843600,888000,44400,5
TIKI,nha-cua-doi-song,7202329,"Bộ 3 Hộp Thủy Tinh KOVA KLOCK370 (370ml/ Hộp)",137000,200000,63000,32
TIKI,nha-cua-doi-song,69253420,"Ổ khóa cao cấp Toplex, 1205-50mm",90000,90000,0,0
TIKI,nha-cua-doi-song,517873,"Giá Phơi Đồ Inox Co Giãn Thông Minh Prota - 86 Cm",290000,290000,0,0
TIKI,nha-cua-doi-song,20615119,"Pin sạc AAA NiMH dung lượng lớn 1300mah (4 Viên AAA)",119000,119000,0,0
TIKI,nha-cua-doi-song,127215514," Hộp Đũa Dán Tường Jodily Có Nắp Sang Trọng, Sạch Sẽ",205000,205000,0,0
TIKI,nha-cua-doi-song,54029566,"Bộ Dụng Cụ Tua Vít Đa Năng Nhiều Món Có Từ Tính 111 in 1 Dùng Tháo Lắp, Tháo Mở Và Sửa Chữa Điện Thoại Di Động, Máy Tính, PC/ Laptop, Máy Tính Bảng",175000,175000,0,0
TIKI,nha-cua-doi-song,204204717,"Nhang khoanh trầm hương HÀ XÁ xông nhà 100g đồ thờ cúng thanh lọc không khí, an toàn cho sức khỏe",199000,398000,199000,50
TIKI,nha-cua-doi-song,170876560,"Khăn giấy ướt vịt vàng 10 gói kèm thùng nhựa tiện dụng siêu đáng - Amina",46550,49000,2450,5
TIKI,nha-cua-doi-song,448378,"Hộp Cơm Giữ Nhiệt Zojirushi ZOCM-SL-JAF14-SA 4 Ngăn - 1.3L (Bạc)",950500,950500,0,0
TIKI,nha-cua-doi-song,163583429,"Máy Xay Hạt Cafe, Hạt Khô, Hạt Tiêu, Ngũ Cốc, Đậu Nành Đa Năng, Cối Xay Thép Không Gỉ SUS 304 Cao Cấp - Hàng Chính Hãng MINIIN",199000,199000,0,0
TIKI,nha-cua-doi-song,91063233,"Hạt Giống Hoa Mãn Đình Hồng Kép Nhiều Màu 20 hạt",13000,15260,2260,15
TIKI,nha-cua-doi-song,146926667,"Giây Ăn SAKARA Mã 6089 Siêu Mịn, Siêu Dai, Bốn Lớp, Không Mủn Giấy Ăn Cao Cấp Nhập Khẩu Thùng 30 gói",141897,141897,0,0
TIKI,nha-cua-doi-song,187829576,"VỎ GỐI NẰM,GỐI ÔM COTTON MỀM MỊN. THOÁNG MÁT GIÁ SIÊU RẺ,KÍCH THƯỚC 40X60.50X70.35X105",30400,40000,9600,24
TIKI,nha-cua-doi-song,28604722,"Ghế bệt gỗ kiểu nhật D227 ( Hàng nhập khẩu )",320000,320000,0,0
TIKI,nha-cua-doi-song,184591044,"Đèn Pixar, Đèn Bàn Chống Cận Thị, Đèn Đọc Sách LED, Đèn Làm Việc Bảo Vệ Mắt - Hàng Chính Hãng",258000,320000,62000,19
TIKI,nha-cua-doi-song,104472138,"Tấm/Miếng Lót Nồi Bằng Gỗ Đường Kính 21cm",25000,25000,0,0
TIKI,nha-cua-doi-song,93780998,"Đồng hồ hẹn giờ đếm ngược dùng trong nấu ăn, pha chế",185000,200000,15000,8
TIKI,nha-cua-doi-song,88230880,"Bóng đèn cảm ứng cảm biến chuyển động rada vi sóng 5.8 Hz tự động bật tắt đèn khi có người đi qua",41000,41000,0,0
TIKI,nha-cua-doi-song,73759724,"Kệ Sách Đứng Để Sàn Cao Cấp FIVO Mẫu FB70 Lắp Ráp Đơn Giản, Phù Hợp Với Mọi Không Gian",749000,1168000,419000,36
TIKI,nha-cua-doi-song,189568098,"Bình giữ nhiệt inox 304 Elmich",220000,499000,279000,56
TIKI,nha-cua-doi-song,66877577,"Hộp đựng cơm thủy tinh cao cấp 3 ngăn ( Giao mầu ngẫu nhiên)",89000,89000,0,0
TIKI,nha-cua-doi-song,121162213,"Set 10 Móc Treo Quần Áo Người Lớn Jodily inox 304 Sáng Bóng Bền Mãi Với Thời Gian",150000,150000,0,0
TIKI,nha-cua-doi-song,8141095,"Bình nước Lock&Lock Aqua HAP739B/HAP739W 2,6L",68800,109000,40200,37
TIKI,nha-cua-doi-song,17164211,"Bộ 13 mũi khoan đa năng lục giác",44999,44999,0,0
TIKI,nha-cua-doi-song,42270992,"Bình Giữ Nhiệt Rinfere, Với Miệng Rộng, Nắp Quai Cầm - Nhiều Kích Cỡ Và Màu Sắc",305000,499000,194000,39
TIKI,nha-cua-doi-song,137796584,"Thảm Lau Chân Nhà Tắm Đa Năng Chất Liệu Chống Trơn Trượt Cao Cấp 4 Lớp Thấm Hút Tốt 40x60cm Loại 1 - Hàng Chính Hãng -( Màu Và Chữ Ngẫu Nhiên)",94050,99000,4950,5
TIKI,nha-cua-doi-song,98556230,"Kệ Gỗ Trang Trí Treo Tường Không Cần Khoan Với Móc Treo Inox Và Đầy Đủ Phụ Kiện Tặng Kèm, Dễ Dàng Gắn Lên Tường",119000,125000,6000,5
TIKI,nha-cua-doi-song,84153167,"Kệ Sách Đa Năng Athena 5F Thương Hiệu IGEA",409000,445000,36000,8
TIKI,nha-cua-doi-song,117282929,"Phích ổ cắm đa năng LiOA chuyển 3 chân thành 2 chân 15A/220V Chân Tròn/Dẹt - Ổ điện chuyển đổi từ 3 chấu sang 2 chấu",18000,18000,0,0
TIKI,nha-cua-doi-song,128935485,"Thìa Ăn Phở Ăn Soup - Inox 304 Jodily Cao Cấp Sáng Bóng Bền Mãi Với Thời Gian",15000,15000,0,0
TIKI,nha-cua-doi-song,146393649,"Ngăn Mùi Hôi Cống  Ngăn Mùi Thoát Sàn Silicon-Nút Bịt Ống Cống Chống Hôi Hiệu Quả 100%",9499,9999,500,5
TIKI,nha-cua-doi-song,120166109,"Bóng Philips LED bulb Essential E27 (5W,7W,9W,11W,13W) - E27 (3000K/6500K)",50600,52200,1600,3
TIKI,nha-cua-doi-song,176530481,"Chiếu điều hòa tencel Lidaco (Nhiều mẫu lựa chọn)",389000,560000,171000,31
TIKI,nha-cua-doi-song,106677814,"Hộp thuỷ tinh chữ nhật Nikko 370 ml",43000,43000,0,0
TIKI,nha-cua-doi-song,74986118,"Màng Bọc Thực Phẩm PE Shinsen 30 x 40000",163000,163000,0,0
TIKI,nha-cua-doi-song,134407128,"Tủ Kệ Sách Trang Trí, Làm Từ Gỗ Công Nghiệp rẻ vô địch, Chất Lượng Cao, Dễ Dàng Lắp Ghép Nhiều Ngăn Để Đồ tiện lợi",252000,252000,0,0
TIKI,nha-cua-doi-song,20575031,"VÒI LAVABO LẠNH INOX SUS304",165000,165000,0,0
TIKI,nha-cua-doi-song,37730520,"Thanh treo quần áo 4 chấu dán tường Hobby 4TV160 chuẩn Inox 304 - kèm keo dán siêu dính",147000,219000,72000,33
TIKI,nha-cua-doi-song,134360858,"Bộ 8 Pin AA Panasonic 1,5V Không chì , Pin không chảy nước R6DT/4S - Hàng chính hãng",38000,60000,22000,37
TIKI,nha-cua-doi-song,165758266,"Bộ dao 3 chiếc Eco Family Sunhouse KS-KN3E1",283000,438000,155000,35
TIKI,nha-cua-doi-song,106281062,"Bộ 6 Ly Bia Thuỷ Tinh Luminarc Benidorm 450ml - LUBEG2616",309000,386000,77000,20
TIKI,nha-cua-doi-song,26149459,"Bộ Muỗng Đũa Cơm Trưa INOX 304 Thiết Kế Sang Trọng Mạ PVD Cao Cấp - Xanh Da Trời",120000,120000,0,0
TIKI,nha-cua-doi-song,7699055,"Chảo Nhôm Chống Dính Lock&Lock Baum Marble 1 Tay Cầm LBU1243C (24cm)",235000,451000,216000,48
TIKI,nha-cua-doi-song,53472238,"Kệ gỗ thông để giày đa năng",129800,129800,0,0
TIKI,nha-cua-doi-song,125149573,"Sáo Tiêu Recorder Soprano Yamaha YRS-402, YRS-20,YRS-24B Chính Hãng, Độ Bền Cao, Chất Liệu ABS An Toàn",135000,135000,0,0
TIKI,nha-cua-doi-song,72751318,"Báo Động Chống Trộm, Chuông Báo Khách Mở Cửa Đa Chức Năng Có Điều Khiển Từ Xa MC - 02, Báo Động Nhiều Chế Độ : Chống Trộm Xâm Nhập , Báo Chuông Cửa..",205000,249000,44000,18
TIKI,nha-cua-doi-song,80874505,"Cốc gấu đựng bàn chải kem đánh răng, Cốc gấu dán tường siêu dính",14999,14999,0,0
TIKI,nha-cua-doi-song,34816875,"Dụng Cụ Thông Tắc Cống, Kẹp Gắp Rác Đa Năng Loại Tốt",21000,21000,0,0
TIKI,nha-cua-doi-song,51343718,"Thau Gập Gọn - Chậu Nhựa Gấp Gọn Đa Năng1 2x35cm, nhiều màu, giao màu ngẫu nhiên+ Tặng kèm móc treo",68135,126000,57865,46
TIKI,nha-cua-doi-song,77746708,"Dây đèn led đom đóm trang trí pin không nháy tiểu dây bóng đèn fairy light cao cấp, tinh tế sang trọng decor phòng, du lịch, lều trại, luôn sáng - Chính hãng DEHA",35000,65000,30000,46
TIKI,nha-cua-doi-song,166659124,"Dao Nhật Bản Siêu Sắc Bén Hàng Chính Hãng Cao Cấp ",365000,365000,0,0
TIKI,nha-cua-doi-song,121243851,"Vòi rửa bát inox 304 Pimisi gắn chậu rửa bát 1 đường nước lạnh đơn cho mọi loại chậu rửa chén phổ biến trong nhà bếp | Hàng chính hãng",463000,700000,237000,34
TIKI,nha-cua-doi-song,14526627,"Quánh Inox 430 Bếp Từ 3 Đáy Fivestar Nắp Kính",199000,199000,0,0
TIKI,nha-cua-doi-song,130978265,"Ổ cắm Xoay 90° Điện Quang ĐQ ESK RT 6GW (6 lỗ, màu xanh lá trắng)",77440,103300,25860,25
TIKI,nha-cua-doi-song,32004018,"PHÂN GÀ HỮU CƠ (NHẬT BẢN) - BAO 5KG - SẢN PHẨM CAO CẤP CHO MỌI LOẠI CÂY TRỒNG ( MS 025)",90000,90000,0,0
TIKI,nha-cua-doi-song,56562967,"Combo 5 Miếng Xốp Dán Tường Giả Gạch Dày 4mm -  Trắng",51299,53999,2700,5
TIKI,nha-cua-doi-song,134361201,"Giấy Dán Tường Nhà Bếp Chống Thấm Dầu Mở, Chống Thấm Nước, Cách Nhiệt Tiện Dụng [Tặng Móc Dán Tường Treo Đồ",43000,43000,0,0
TIKI,nha-cua-doi-song,80657249,"Hộp vải đựng đồ đa năng có nắp TD3a và TD3b – Túi vải Thụy Điển có nắp rời 34L sang trọng vải Oxford chính hãng miDoctor",129000,200000,71000,36
TIKI,nha-cua-doi-song,76827765,"Pin Energizer ECR2025 Lithium 3V Chính Hãng | Bộ Vỉ 5 Viên",55300,59000,3700,6
TIKI,nha-cua-doi-song,263076438,"Gối chống trào ngược dạ dày thực quản người lớn Ema giúp giảm trào ngược dạ dày, viêm họng mãn tính, nuốt vướng, nghẹn cổ, khó thở khi ngủ, ngáy ngủ",585000,1170000,585000,50
TIKI,nha-cua-doi-song,52188851,"Muỗng Thìa Cà Phê Cán Dài INOX304 24cm",30000,30000,0,0
TIKI,nha-cua-doi-song,81936306,"Kệ Decor Phòng Gương 2 Tầng Morning House",159000,169000,10000,6
TIKI,nha-cua-doi-song,59386141,"Bọc Giày Đi Mưa Silicon Siêu Bền Nhiều Màu",59900,59900,0,0
TIKI,nha-cua-doi-song,57863885,"Đồng hồ LED để bàn hình hộp gỗ - Nhiệt kế - Báo thức - Cảm ứng âm thanh",109000,159000,50000,31
TIKI,nha-cua-doi-song,67096743,"Combo Full Bộ Ống Hút Inox 304 Thép Không Gỉ, Tái Chế Sử Dụng, Thân Thiện Môi Trường - Hàng Chính Hãng",29000,29000,0,0
TIKI,nha-cua-doi-song,186142362,"Ô Dù Chống Nắng Che Mưa Cản UV Tự Động Đóng Mở Khung 12 Xương",230000,230000,0,0
TIKI,nha-cua-doi-song,135099603,"Cây lau nhà thay thế bộ lau nhà PX01 (Không bao gồm thùng vắt) - Parroti MOP-PX01",229000,280000,51000,18
TIKI,nha-cua-doi-song,50254577,"Thước Đo Khoảng Cách Bằng Tia Laser SNDWAY Phạm Vi 50m SW-M50 Cao Cấp AZONE",350000,350000,0,0
TIKI,nha-cua-doi-song,142857607,"Thông tắc vệ sinh, dây thông cống lò xo, tiện dụng và được việc",45000,67500,22500,33
TIKI,nha-cua-doi-song,177679445,"Chuông Cửa Không Dây Thông Minh Besti YBT01 (1 Nút Bấm, 1 Chuông ), Chống Nước, Khoảng Cách Sử Dụng Hiệu Quả 300M, 60 Loại Nhạc Chuông, 4 Mức Điều Chỉnh Âm Lượng - Hàng Chính Hãng",180000,180000,0,0
TIKI,nha-cua-doi-song,135059226,"Móc Dán Tường Inox 304 Dùng Keo 3M Siêu Chắc, Chịu lực lên đến hơn 20kg, Nhiều Kiểu Dáng Đẹp",41000,41000,0,0
TIKI,nha-cua-doi-song,17008839,"Thiết Bị Bấm Lỗ Dây Nịt Da Cầm Tay (6-9")",53091,53091,0,0
TIKI,nha-cua-doi-song,159144262,"Cây lau nhà VILEDA Turbo Easy Wring&Clean đầu lau tam giác, xô giặt quay bằng chân, thêm 2 bông lau",659000,659000,0,0
TIKI,nha-cua-doi-song,46207255,"Combo 2 túi lưới giặt đồ 2 lớp Polyester dạng lưới mịn giặt đồ chống biến dạng quần áo cho máy giặt dạng hộp khóa kéo phù hợp giặt đồ nhỏ đồ lót",45000,45000,0,0
TIKI,nha-cua-doi-song,50206492,"Thuốc trừ rầy, nhện, kiến, gián mối, bọ chét, ve chó Regent 800WG",40000,40000,0,0
TIKI,nha-cua-doi-song,39748239,"Kệ để đồ dán tường cho phòng tắm và nhà bếp (Giao ngẫu nhiên mẫu)",10000,20900,10900,52
TIKI,nha-cua-doi-song,50825030,"Dụng cụ kẹp gắp bát, đĩa, đồ nóng",14500,14500,0,0
TIKI,nha-cua-doi-song,33404972,"Tủ kệ sách để bàn HT003",45600,48000,2400,5
TIKI,nha-cua-doi-song,63479866,"[CHÍNH HÃNG] Khoá treo đồng bấm Việt - Tiệp Cao cấp - Chống trộm | Mã SP: 01524",125970,132600,6630,5
TIKI,nha-cua-doi-song,186883908,"Khăn tắm nén du lịch (70x140cm) bằng cotton thấm hút tốt, dùng một lần tiện lợi - Chính hãng MINIIN",21000,29000,8000,28
TIKI,nha-cua-doi-song,184903735,"Khay xếp quần áo chia ngăn 6 7 20, Hộp đựng đồ lót tất vớ chất liệu vải không dệt cao cấp",32000,32000,0,0
TIKI,nha-cua-doi-song,117058329,"Giấy lọc cà phê Hario 100 cái (V60-VCF-01-100W)",89000,99000,10000,10
TIKI,nha-cua-doi-song,167046966,"Áo bọc bàn để ủi cầu là quần áo có mút Kokomega BU04 KT: 35*100cm( Và Sử Dụng Cho BU-120)",75050,79000,3950,5
TIKI,nha-cua-doi-song,196571419,"CHẢO CẠN INOX 5 ĐÁY SUNHOUSE 16-20-24-26-28CM (DÙNG TRÊN MỌI LOẠI BẾP)",175000,175000,0,0
TIKI,nha-cua-doi-song,51915247,"Combo 200 túi lọc rác bồn rửa bát",22999,22999,0,0
TIKI,nha-cua-doi-song,16093882,"Phích Cắm Chuyển Đổi 3 Chấu Sang 2 Chấu Milliken NL-3106",15000,15000,0,0
TIKI,nha-cua-doi-song,147593105,"Miếng chặn khe cửa chống bụi  Nẹp chặn cửa chắn khe hở chống bụi, chống côn trùng, chống thoát hơi gió điều hòa",20000,20000,0,0
TIKI,nha-cua-doi-song,90597884,"Bàn Học Bàn Làm Việc Ngồi Bệt Model 1 Thông Minh - GP116",382000,415000,33000,8
TIKI,nha-cua-doi-song,83397956,"MXK4 - 25x15x10 cm - 20 Thùng hộp carton",52600,52600,0,0
TIKI,nha-cua-doi-song,81647926,"Đầu nối chia điện đa năng 3 cửa SOPOKA P11 P12 chịu tải 2200W",32000,32000,0,0
TIKI,dien-thoai-may-tinh-bang,116199362,"Ly thủy tinh có chia vạch 625ml-B00322 ",35000,35000,0,0
TIKI,dien-thoai-may-tinh-bang,20484673,"Nắp ngồi rơi êm cao cấp thay thế cho các loại bồn cầu INAX thân dài 504-702-700-710-808-900",295000,295000,0,0
TIKI,dien-thoai-may-tinh-bang,30691895,"Dụng cụ tách sò huyết inox cao cấp",40000,40000,0,0
TIKI,dien-thoai-may-tinh-bang,133866129,"Móc Dán Tường Inox 304 Sang Trọng, Cứng Cáp, Dùng Keo 3M, Nhiều Kiểu Dáng Đẹp",43000,43000,0,0
TIKI,dien-thoai-may-tinh-bang,124480954,"Nhang trầm hương tự nhiên Thiên Mộc Hương, 20cm, Ít Khói, Mùi thơm nhẹ diu, an toàn cho sức khỏe",135000,200000,65000,33
TIKI,dien-thoai-may-tinh-bang,13369293,"Bịt mắt ngủ có túi giải nhiệt làm mát mắt - #10",68000,68000,0,0
TIKI,dien-thoai-may-tinh-bang,51238343,"Túi Lọc Trà Lọc Gia Vị Vải Không Dệt (combo 100 túi)",28000,28000,0,0
TIKI,dien-thoai-may-tinh-bang,5429807,"Bộ 50 cút nối dây điện nhanh CH-2",31000,31000,0,0
TIKI,dien-thoai-may-tinh-bang,158564745,"Cuộn 220 Tờ Khăn Giấy Lau Bếp Đa Năng",8000,9990,1990,20
TIKI,dien-thoai-may-tinh-bang,83847675,"Combo 30 bịch giấy ăn gấu trúc",55000,107500,52500,49
TIKI,dien-thoai-may-tinh-bang,16170433,"Combo 3 lõi lọc nước yamato 1,2,3 - 10 inch",143000,155000,12000,8
TIKI,dien-thoai-may-tinh-bang,134351529,"Đũa Gỗ Dùng 1 Lần KETILO Cao Cấp, Thân Thiện Với Môi Trường, Không Hóa Chất Độc Hại, An Toàn Sức Khỏe Người Dùng(Giao Ngẫu Nhiên) - CHÍNH HÃNG ĐG001",45000,53000,8000,15
TIKI,dien-thoai-may-tinh-bang,15212797,"Đèn led năng lượng mặt trời SUN-28200 200W, Đèn năng lượng mặt trời IP 67",410000,410000,0,0
TIKI,dien-thoai-may-tinh-bang,193713061,"Bàn Học Và Làm Việc Thông Minh Đa Năng Mặt Bàn Nghiêng 90 Độ, Bàn Laptop Xếp Gọn Có Bánh Xe - Hàng Chính Hãng",717000,999000,282000,28
TIKI,dien-thoai-may-tinh-bang,85512749,"Kẹp dán tường thông minh - Không cần khoan lỗ, đục tường- Chịu lực lên đến 3Kg",4000,4000,0,0
TIKI,dien-thoai-may-tinh-bang,213491032,"Bàn để ủi quần áo khung bằng thép Lebenlang LBB363",659000,959000,300000,31
TIKI,dien-thoai-may-tinh-bang,6816541,"Cân tiểu ly điện tử 3000g - 0.1g. Cân tiểu li điện tử có độ chính xác cao",68000,68000,0,0
TIKI,dien-thoai-may-tinh-bang,89642725,"Bình xịt nước tưới cây bằng nhựa, bình xịt nước tạo mẫu tóc, xịt nước làm bánh cao cấp - Hàng chính hãng, giao màu ngẫu nhiên",42750,45000,2250,5
TIKI,dien-thoai-may-tinh-bang,577125,"Thang Nhôm Gấp Chữ A Nikawa NKD-06 - 6 Bậc - 1.5 Mét",1480000,1680000,200000,12
TIKI,dien-thoai-may-tinh-bang,580040,"Chảo Đá Chống Dính Siêu Bền Sunhouse SBD24 24cm",171000,320000,149000,47
TIKI,dien-thoai-may-tinh-bang,142096809,"Bàn làm việc có giá sách 1,2m 1m thiết kế hiện đại có giá sách, chân sắt sơn tĩnh điện mặt gỗ mdf phủ melamine",525000,829000,304000,37
TIKI,dien-thoai-may-tinh-bang,199263969,"Bàn Trang Điểm Mini Ngồi Bệt Hiện Đại Thương Hiệu IGA - GP143",385000,419000,34000,8
TIKI,dien-thoai-may-tinh-bang,167545572,"Bộ 2 hộp đựng đồ chia 7 ngăn sắp xếp quần áo dododios - Hộp vải đa năng HQ2 tiện ích, chất liệu cao cấp, phong cách Nhật Bản sang trọng",139000,139000,0,0
TIKI,dien-thoai-may-tinh-bang,98650585,"Bộ Ga Gối Cotton Kẻ 3F Lidaco Chuyên Dụng Cho Homestay, Khách Sạn (Nhiều Mẫu Lựa Chọn)",189000,250000,61000,24
TIKI,dien-thoai-may-tinh-bang,135322547,"Set 10 Móc áo chống trượt Inochi Hara 186",45100,45100,0,0
TIKI,dien-thoai-may-tinh-bang,70564013,"Bộ Tua Vít Bỏ Túi Đa Năng 24 Món - Tô Vít Sửa Chữa Mở Điện Thoại Vi Tính cao cấp",39000,196992,157992,80
TIKI,dien-thoai-may-tinh-bang,168641002,"Kệ Góc Đa Năng White Corner 5F Thông Minh Phong Cách Hiện Đại",320000,350000,30000,9
TIKI,dien-thoai-may-tinh-bang,70809147,"SET 2 TÚI ĐỰNG QUẦN ÁO KHUNG THÉP GẤP GỌN 66L -  Dài 50 cm x Rộng 40 cm x Cao 33 cm",139000,139000,0,0
TIKI,dien-thoai-may-tinh-bang,892129,"Pin Max 4 + 2 Viên Energizer E92 BP4+2 AAA",73000,73000,0,0
TIKI,dien-thoai-may-tinh-bang,90852479,"Bộ liền 2 nhả kem đánh răng tự động, Giá treo bàn chải kèm 3 cốc hút từ tính lắp đặt dán tường - OE2KEM",245000,450000,205000,46
TIKI,dien-thoai-may-tinh-bang,108201708,"Bộ Rổ Nhựa Kèm Chậu 6 Món Cao Cấp Vàng xanh hàng đẹp loại 1",32000,47000,15000,32
TIKI,dien-thoai-may-tinh-bang,16861361,"Nắp ly giữ nhiệt 900ml màu trắng",28000,28000,0,0
TIKI,dien-thoai-may-tinh-bang,181909421,"Nồi Thấp Suit LocknLock CSU1242PIK – 24cm - Màu Pink",602000,1184000,582000,49
TIKI,dien-thoai-may-tinh-bang,72754059,"Nệm Gấp Văn Phòng, Đệm Ngủ Trưa Văn Phòng Gấp Gọn Tiện Lợi, Mặt Vải Chống Thấm Tặng Túi Đựng Nệm - Kích Thước 70 x 190cm",160000,280000,120000,43
TIKI,dien-thoai-may-tinh-bang,128623891,"Dây chằng hàng tăng đơ (dây cảo) bản 25mm dài 3 - 5m tải trọng 500-800kg - capthepgiasi",50000,50000,0,0
TIKI,dien-thoai-may-tinh-bang,52581646,"Dây Đèn LED Rèm Trăng Sao Chống Thấm Nước Trang Trí Ngoài Trời - Dài 2.5 Mét",105000,105000,0,0
TIKI,dien-thoai-may-tinh-bang,126120768,"Ghế Xoay Văn Phòng Làm Việc Thư Giãn Cao Cấp YLF2199 Có Thể Làm Ghế Gaming - Hàng Nhập Khẩu",820000,1399000,579000,41
TIKI,dien-thoai-may-tinh-bang,171198348,"Ghế Xoay Văn Phòng Công Thái Học Ergonomic Có Ngả Lưng Gác Chân TANNI Premium 02 Plus, Ghế Xoay Gaming Cao Cấp Nhập Khẩu",1198000,2450000,1252000,51
TIKI,dien-thoai-may-tinh-bang,67989898,"Bàn Học Bàn Làm Việc Kết Hợp Kệ Sách GP73",250000,250000,0,0
TIKI,dien-thoai-may-tinh-bang,174299634,"Giá Treo Bàn Chải Nhà Tắm OENON - Bộ nhả kem đánh răng tự động kèm cốc và miếng dán tường - OEKEM",99000,190000,91000,48
TIKI,nha-cua-doi-song,116199362,"Ly thủy tinh có chia vạch 625ml-B00322 ",35000,35000,0,0
TIKI,nha-cua-doi-song,20484673,"Nắp ngồi rơi êm cao cấp thay thế cho các loại bồn cầu INAX thân dài 504-702-700-710-808-900",295000,295000,0,0
TIKI,nha-cua-doi-song,89642725,"Bình xịt nước tưới cây bằng nhựa, bình xịt nước tạo mẫu tóc, xịt nước làm bánh cao cấp - Hàng chính hãng, giao màu ngẫu nhiên",42750,45000,2250,5
TIKI,nha-cua-doi-song,5429807,"Bộ 50 cút nối dây điện nhanh CH-2",31000,31000,0,0
TIKI,nha-cua-doi-song,51238343,"Túi Lọc Trà Lọc Gia Vị Vải Không Dệt (combo 100 túi)",28000,28000,0,0
TIKI,nha-cua-doi-song,124480954,"Nhang trầm hương tự nhiên Thiên Mộc Hương, 20cm, Ít Khói, Mùi thơm nhẹ diu, an toàn cho sức khỏe",135000,200000,65000,33
TIKI,nha-cua-doi-song,13369293,"Bịt mắt ngủ có túi giải nhiệt làm mát mắt - #10",68000,68000,0,0
TIKI,nha-cua-doi-song,30691895,"Dụng cụ tách sò huyết inox cao cấp",40000,40000,0,0
TIKI,nha-cua-doi-song,134351529,"Đũa Gỗ Dùng 1 Lần KETILO Cao Cấp, Thân Thiện Với Môi Trường, Không Hóa Chất Độc Hại, An Toàn Sức Khỏe Người Dùng(Giao Ngẫu Nhiên) - CHÍNH HÃNG ĐG001",45000,53000,8000,15
TIKI,nha-cua-doi-song,83847675,"Combo 30 bịch giấy ăn gấu trúc",55000,107500,52500,49
TIKI,nha-cua-doi-song,133866129,"Móc Dán Tường Inox 304 Sang Trọng, Cứng Cáp, Dùng Keo 3M, Nhiều Kiểu Dáng Đẹp",43000,43000,0,0
TIKI,nha-cua-doi-song,108201708,"Bộ Rổ Nhựa Kèm Chậu 6 Món Cao Cấp Vàng xanh hàng đẹp loại 1",32000,47000,15000,32
TIKI,nha-cua-doi-song,70809147,"SET 2 TÚI ĐỰNG QUẦN ÁO KHUNG THÉP GẤP GỌN 66L -  Dài 50 cm x Rộng 40 cm x Cao 33 cm",139000,139000,0,0
TIKI,nha-cua-doi-song,16170433,"Combo 3 lõi lọc nước yamato 1,2,3 - 10 inch",143000,155000,12000,8
TIKI,nha-cua-doi-song,158564745,"Cuộn 220 Tờ Khăn Giấy Lau Bếp Đa Năng",8000,9990,1990,20
TIKI,nha-cua-doi-song,892129,"Pin Max 4 + 2 Viên Energizer E92 BP4+2 AAA",73000,73000,0,0
TIKI,nha-cua-doi-song,85512749,"Kẹp dán tường thông minh - Không cần khoan lỗ, đục tường- Chịu lực lên đến 3Kg",4000,4000,0,0
TIKI,nha-cua-doi-song,15212797,"Đèn led năng lượng mặt trời SUN-28200 200W, Đèn năng lượng mặt trời IP 67",410000,410000,0,0
TIKI,nha-cua-doi-song,70564013,"Bộ Tua Vít Bỏ Túi Đa Năng 24 Món - Tô Vít Sửa Chữa Mở Điện Thoại Vi Tính cao cấp",39000,196992,157992,80
TIKI,nha-cua-doi-song,126120768,"Ghế Xoay Văn Phòng Làm Việc Thư Giãn Cao Cấp YLF2199 Có Thể Làm Ghế Gaming - Hàng Nhập Khẩu",820000,1399000,579000,41
TIKI,nha-cua-doi-song,171198348,"Ghế Xoay Văn Phòng Công Thái Học Ergonomic Có Ngả Lưng Gác Chân TANNI Premium 02 Plus, Ghế Xoay Gaming Cao Cấp Nhập Khẩu",1198000,2450000,1252000,51
TIKI,nha-cua-doi-song,168641002,"Kệ Góc Đa Năng White Corner 5F Thông Minh Phong Cách Hiện Đại",320000,350000,30000,9
TIKI,nha-cua-doi-song,142096809,"Bàn làm việc có giá sách 1,2m 1m thiết kế hiện đại có giá sách, chân sắt sơn tĩnh điện mặt gỗ mdf phủ melamine",525000,829000,304000,37
TIKI,nha-cua-doi-song,193713061,"Bàn Học Và Làm Việc Thông Minh Đa Năng Mặt Bàn Nghiêng 90 Độ, Bàn Laptop Xếp Gọn Có Bánh Xe - Hàng Chính Hãng",717000,999000,282000,28
TIKI,nha-cua-doi-song,580040,"Chảo Đá Chống Dính Siêu Bền Sunhouse SBD24 24cm",171000,320000,149000,47
TIKI,nha-cua-doi-song,199263969,"Bàn Trang Điểm Mini Ngồi Bệt Hiện Đại Thương Hiệu IGA - GP143",385000,419000,34000,8
TIKI,nha-cua-doi-song,213491032,"Bàn để ủi quần áo khung bằng thép Lebenlang LBB363",659000,959000,300000,31
TIKI,nha-cua-doi-song,577125,"Thang Nhôm Gấp Chữ A Nikawa NKD-06 - 6 Bậc - 1.5 Mét",1480000,1680000,200000,12
TIKI,nha-cua-doi-song,167545572,"Bộ 2 hộp đựng đồ chia 7 ngăn sắp xếp quần áo dododios - Hộp vải đa năng HQ2 tiện ích, chất liệu cao cấp, phong cách Nhật Bản sang trọng",139000,139000,0,0
TIKI,nha-cua-doi-song,72754059,"Nệm Gấp Văn Phòng, Đệm Ngủ Trưa Văn Phòng Gấp Gọn Tiện Lợi, Mặt Vải Chống Thấm Tặng Túi Đựng Nệm - Kích Thước 70 x 190cm",160000,280000,120000,43
TIKI,nha-cua-doi-song,67989898,"Bàn Học Bàn Làm Việc Kết Hợp Kệ Sách GP73",250000,250000,0,0
TIKI,nha-cua-doi-song,181909421,"Nồi Thấp Suit LocknLock CSU1242PIK – 24cm - Màu Pink",602000,1184000,582000,49
TIKI,nha-cua-doi-song,6816541,"Cân tiểu ly điện tử 3000g - 0.1g. Cân tiểu li điện tử có độ chính xác cao",68000,68000,0,0
TIKI,nha-cua-doi-song,135322547,"Set 10 Móc áo chống trượt Inochi Hara 186",45100,45100,0,0
TIKI,nha-cua-doi-song,52581646,"Dây Đèn LED Rèm Trăng Sao Chống Thấm Nước Trang Trí Ngoài Trời - Dài 2.5 Mét",105000,105000,0,0
TIKI,nha-cua-doi-song,174299634,"Giá Treo Bàn Chải Nhà Tắm OENON - Bộ nhả kem đánh răng tự động kèm cốc và miếng dán tường - OEKEM",99000,190000,91000,48
TIKI,nha-cua-doi-song,128623891,"Dây chằng hàng tăng đơ (dây cảo) bản 25mm dài 3 - 5m tải trọng 500-800kg - capthepgiasi",50000,50000,0,0
TIKI,nha-cua-doi-song,90852479,"Bộ liền 2 nhả kem đánh răng tự động, Giá treo bàn chải kèm 3 cốc hút từ tính lắp đặt dán tường - OE2KEM",245000,450000,205000,46
TIKI,nha-cua-doi-song,98650585,"Bộ Ga Gối Cotton Kẻ 3F Lidaco Chuyên Dụng Cho Homestay, Khách Sạn (Nhiều Mẫu Lựa Chọn)",189000,250000,61000,24
TIKI,nha-cua-doi-song,16861361,"Nắp ly giữ nhiệt 900ml màu trắng",28000,28000,0,0
TIKI,nha-cua-doi-song,152446406,"Cây Chúc ( chanh thái ) - Cây chanh ăn lá ( chanh hấp gà ) + Tặng phân bón cho cây",39000,58000,19000,33
TIKI,nha-cua-doi-song,51966031,"Phân Hữu Cơ Gà Dynamic Nhật Bản Tốt Cây Xanh lá  Cung Cấp Đầy Đủ Dưỡng Chất , Dúng Bón Hoa Hồng ,Cây Kiểng , Cây Ăn Trái( Túi 1 KG)",35000,35000,0,0
TIKI,nha-cua-doi-song,61278429,"Bình Nước Giữ Nhiệt Có Móc Treo (300ml)",68000,68000,0,0
TIKI,nha-cua-doi-song,52021362,"Bảng điện nổi V3 Điện Quang ĐQ FEP 32W 03S (màu trắng, 3 lỗ 2 chấu, 3 công tắc)",71000,91900,20900,23
TIKI,nha-cua-doi-song,141469357,"COMBO 50 Khay (Chén, Bát) Giấy FEST CHOICE FOOD TRAY 3x3 Inches THÁI LAN Hàng Nhập Khẩu Cao Cấp, Dùng 1 Lần Tiện Lợi, An Toàn - CHÍNH HÃNG F010 (Tặng Móc Khóa KETILO)",99000,99000,0,0
TIKI,nha-cua-doi-song,142383214,"Hộp Đựng Giấy Ăn Để Bàn Có Ngăn Để Đồ Đa Năng, Hộp Khăn Giấy Nắp Gỗ",25624,25624,0,0
TIKI,nha-cua-doi-song,26159911,"Decal dán tường thước đo chiều cao Hươu cao cổ 5 AmyShop (145 x 84 cm)",66900,75000,8100,11
TIKI,nha-cua-doi-song,84958837,"Kệ sách tổ ong đa năng.GP100",65000,69999,4999,7
TIKI,nha-cua-doi-song,46601114,"KỆ GƯƠNG 2 TẦNG ĐẦU GIƯỜNG GỖ THÔNG- GLASS SHELF- CAO 50CM x DÀI 30CM x RỘNG 30CM",180000,180000,0,0
TIKI,nha-cua-doi-song,193095643,"Combo 2 Móc Dán Tường Trong Suốt Treo Đồ Dùng Thông Minh",6900,6900,0,0
TIKI,nha-cua-doi-song,132209590,"Thảm chùi chân siêu thấm hút nước 3 giây  cho phòng tắm, phòng bếp, dễ dàng vệ sinh, nhanh khô vệ sinh nhà cửa an toàn với da.",28997,28997,0,0
TIKI,nha-cua-doi-song,36568964,"thước kep điện tử sợi carbon 0-150mm",49900,49900,0,0
TIKI,nha-cua-doi-song,12756233,"Ổ điện thông minh có 6 phích cắm 3 cổng USB (giao màu ngẫu nhiên)",41000,41000,0,0
TIKI,nha-cua-doi-song,202185819,"Bình Giữ Nhiệt Cao Cấp 304  Có Nắp Xoáy Tiện Lợi Giữ Nhiệt Nóng Lạnh",200000,200000,0,0
TIKI,nha-cua-doi-song,89059076,"Chảo sâu lòng chống dính đáy từ Tefal Ultimate 28cm, dùng cho mọi loại bếp - Sản xuất tại Pháp - Hàng chính hãng",1699000,1699000,0,0
TIKI,nha-cua-doi-song,107486345,"Bộ chăn ga giường Lidaco cotton Tici cao cấp (Nhiều mẫu lựa chọn)",239000,339000,100000,29
TIKI,nha-cua-doi-song,93154028,"Thảm lông trải sàn lông mịn kích thước 1.2 x 1.6m- dài Thảm lông trải sàn cao cấp phòng khách trang trí nhà cửa.",175000,175000,0,0
TIKI,nha-cua-doi-song,43110675,"Móc Khóa Tua Vít mini đa năng sửa chữa kính, đồng hồ, điện thoại (6cm x 0,5cm)",9700,9700,0,0
TIKI,nha-cua-doi-song,96419574,"Màng PE trắng khổ 50cm 2,5kg - Màng PE quấn hàng.",135000,135000,0,0
TIKI,nha-cua-doi-song,159144266,"Cây lau nhà VILEDA Turbo Easy Wring&Clean đầu lau tam giác, xô giặt quay bằng chân",579000,579000,0,0
TIKI,nha-cua-doi-song,204230323,"Bộ nhang không tăm đầy đủ hộp đựng và máng đốt bằng gỗ nhà HÀ XÁ cao cấp",99000,198000,99000,50
TIKI,nha-cua-doi-song,35422376,"Ô Dù 4 Lớp Che Nắng, Đi Mưa Chống Tia UV",37996,37996,0,0
TIKI,nha-cua-doi-song,4995493,"Thang Nhôm Rút Chữ A Sumika SK380D NEW - Chữ A cao 1.9m, chữ I cao 3.8m, tải trọng 300kg",1769000,2300000,531000,23
TIKI,nha-cua-doi-song,141001207,"Ghế Gấp Inox Phòng Chờ, Ghế Xếp Văn Phòng, Ghế Phòng Họp Gấp Gọn - Hàng Chính Hãng",479000,800000,321000,40
TIKI,nha-cua-doi-song,271696352,"Gối Niu Cao Cấp Ru9 - Công Nghệ Đột Phá Graphene Foam | Chất Liệu Foam Mềm Mại | Nâng Đỡ Đốt Sống Cổ | Chống Đau Vai Gáy",912000,950000,38000,4
TIKI,nha-cua-doi-song,50324146,"Combo 5 Chai Thủy Tinh đựng nước 500ML - Nắp Thiếc vặn có dây treo (Bình thủy tinh đựng nước, đựng sữa - Chai thủy tinh đựng nước ép)",53000,53000,0,0
TIKI,nha-cua-doi-song,143299139,"Bình Đựng Nước Cho Bé, Bình Nước Goki Rudy 450ml, Bình Nước Cao Cấp Chính Hãng Inochi Đạt Tiêu Chuẩn Xuất Nhật",82600,118000,35400,30
TIKI,nha-cua-doi-song,14886261," Máy sấy khử mùi giày",156988,156988,0,0
TIKI,nha-cua-doi-song,54082178,"Túi đựng rác lốc 3 cuộn 1kg - Bịch đựng rác 3 cuộn cỡ đại, trung, tiểu",24000,24000,0,0
TIKI,nha-cua-doi-song,72797082,"Chảo Sâu Lòng DECOR Lock&Lock LDE1225IH 22cm (màu vàng) - Hàng chính hãng",397000,662000,265000,40
TIKI,nha-cua-doi-song,117370665,"Chiếu ngủ trưa văn phòng cá nhân dày 3.5ly / Chiếu Cách Nhiệt Văn Phòng 100 X 190 cm",46000,46000,0,0
TIKI,nha-cua-doi-song,98335248,"Đèn laser ánh sáng laze cảm biến âm thanh - Kết hợp Đèn LED xoay 7 màu dùng trang trí vũ trường, phòng karaoke",349000,349000,0,0
TIKI,nha-cua-doi-song,226043852,"Chăn Gối Ngủ Văn Phòng Hình Mèo Kèm Chăn",148000,148000,0,0
TIKI,nha-cua-doi-song,174307623,"Đệm Ngồi Bệt Tròn Cho Bàn Trang Điểm Vải Cao Cấp Kiểu Hàn Chính Hãng IGA - GC13",91000,99000,8000,8
TIKI,nha-cua-doi-song,101870479,"Thanh treo rèm cửa đa năng, không cần khoan tường hay bắt vít, thay đổi vị trí linh hoạt",75000,120000,45000,38
TIKI,nha-cua-doi-song,57650806,"Máy bơm tăng áp mini tự động",480000,480000,0,0
TIKI,nha-cua-doi-song,778124,"Bộ Hộp Cơm Giữ Nhiệt Lock&Lock LHC8015 (910ml) - Xám Bạc ",619000,1142000,523000,46
TIKI,nha-cua-doi-song,89792661,"[tặng kèm khay trúc 02 tầng] Bộ Ấm Chén Pha Trà Du Lịch 2 - Kiểu dáng trang nhã, Gọn gàng, Thích hợp mang đi du lịch, công tác",134964,134964,0,0
TIKI,nha-cua-doi-song,72659852,"Kệ Nhà Tắm Dán Tường OENON chất liệu nhựa ABS có thêm thanh nhôm treo khăn - OE08",169000,300000,131000,44
TIKI,nha-cua-doi-song,10814223,"Dụng Cụ Gắp Rác Thông Tắc Đường Ống, Lavabo Tiện Ích (160cm)",32900,32900,0,0
TIKI,nha-sach-tiki,196906879,"Máy Tính Khoa Học FX-880 BTG [ Siêu Máy Tính 2022",699000,699000,0,0
TIKI,nha-sach-tiki,74855017,"Quản Lý Tài Chính Cá Nhân Cho Phụ Nữ",110000,159000,49000,31
TIKI,nha-sach-tiki,192115854,"Ninja Rantaro - Tập 58 [Tặng Kèm Postcard]",38100,40000,1900,5
TIKI,nha-sach-tiki,13443851,"Cùng Khủng Long Học Tiếng Anh Theo Chủ Đề Lớp 1 (Tái Bản)",48100,68000,19900,29
TIKI,nha-sach-tiki,584873,"Sách Kiến Tạo Thế Hệ Việt Nam Ưu Việt - John Vu",62100,88000,25900,29
TIKI,nha-sach-tiki,176132392,"Truyện Thiếu Nhi Hạt Giống Tâm Hồn - Những Bông Hoa Hình Trái Tim",43200,56000,12800,23
TIKI,nha-sach-tiki,73717906,"Khởi Nghiệp Công Nghệ - Máu Bẩn",150600,239000,88400,37
TIKI,nha-sach-tiki,47273271,"Inbound Selling - Thay Đổi Phương Thức Bán Hàng Theo Mô Hình Inbound",116000,158000,42000,27
TIKI,nha-sach-tiki,195623888,"Truyện tranh tuổi thần tiên - Cây táo thần",15000,15000,0,0
TIKI,nha-sach-tiki,447670,"Phép Tắc Của Loài Sói (Tái Bản 2015)",106999,106999,0,0
TIKI,nha-sach-tiki,138396005,"Thiên Quan Tứ Phúc - Tập 2 (Tái Bản)",110700,159000,48300,30
TIKI,nha-sach-tiki,111285054,"Quẳng Gánh Lo Đi & Vui Sống (Tái Bản)",58500,86000,27500,32
TIKI,nha-sach-tiki,2906447,"Series Địch Công Kỳ Án Tập 7 - Ngọc Xuyến Án",39000,91000,52000,57
TIKI,nha-sach-tiki,191148802,"Tâm lý học giao tiếp",130000,189000,59000,31
TIKI,nha-sach-tiki,74217686,"Gi Gỉ Gì Gi, Cái Gì Cũng Biết - 130 Bí Mật Vui Nhất Cho Tuổi Tiểu Học",86000,115000,29000,25
TIKI,nha-sach-tiki,29290844,"Kho Tàng Truyện Thần Thoại Cổ Đại Trung Quốc (Không CD)",22000,22000,0,0
TIKI,nha-sach-tiki,191655860,"Làm Đẹp Thuần Chay",102000,139000,37000,27
TIKI,nha-sach-tiki,165098800,"My Hero Academia - Học Viện Siêu Anh Hùng - Tập 4: Cậu Bé Sinh Ra Với Tất Cả (Tái Bản 2022)",25000,25000,0,0
TIKI,nha-sach-tiki,51244265,"Lược Sử Kinh Tế Học",98500,135000,36500,27
TIKI,nha-sach-tiki,22634351,"Combo All The Rules Bình Tĩnh Khi Ế, Mạnh Mẽ Khi Yêu + Sống Bản Lĩnh Theo Cách Một Quý Cô (2 Cuốn)",132000,182000,50000,27
TIKI,nha-sach-tiki,174444190,"Người Bên Gối",90900,119000,28100,24
TIKI,nha-sach-tiki,186578228,"Đời sống vỉa hè Sài Gòn",131000,169000,38000,22
TIKI,nha-sach-tiki,196305161,"Cơ Thể Con Là Của Con (Tái bản 2022)",74100,75000,900,1
TIKI,nha-sach-tiki,394438,"Giấy Excel A4 DL80 ",70000,70000,0,0
TIKI,nha-sach-tiki,111271564,"Vòng Xoáy Đi Lên - Đảo Chiều Trầm Cảm Từ Những Thay Đổi Nhỏ",99300,149000,49700,33
TIKI,nha-sach-tiki,5067155,"Nhật Ký Anne Frank (Tái Bản)",73000,98000,25000,26
TIKI,nha-sach-tiki,66464344,"Sài Gòn Đất Và Người (Tái Bản 2020)",109000,165000,56000,34
TIKI,nha-sach-tiki,730782,"Tuần Của Bé Tháng 7 - Bé Trung Thực",11500,23000,11500,50
TIKI,nha-sach-tiki,80142837,"Hackers IELTS Basic- Listening",144800,229000,84200,37
TIKI,nha-sach-tiki,10144818,"20 bong bóng cao su nhiều màu",16000,16000,0,0
TIKI,nha-sach-tiki,36399672,"Trò Đùa Của Sự Ngẫu Nhiên",115800,209000,93200,45
TIKI,nha-sach-tiki,82041440,"Models: Quyến Rũ Phái Đẹp Bằng Cả Chân Tình",103000,160000,57000,36
TIKI,nha-sach-tiki,188930500,"Người Bà Tài Giỏi Vùng Saga – Tập 5",40500,52000,11500,22
TIKI,nha-sach-tiki,196377993,"Sáng Mắt",99250,155000,55750,36
TIKI,nha-sach-tiki,192377680,"Cách Dạy, Cách Học, Cách Sống Trong Thế Kỷ XXI: Khảo Sát Triết Lý Giáo Dục Của Dewey Và Makiguchi Để Đưa Ra Phương Thức Giáo Dục Mới Cho Nhân Loại",143000,145000,2000,1
TIKI,nha-sach-tiki,76688366,"Leader Mindset - Thay Đổi Tư Duy Lãnh Đạo - LOAN VĂN SƠN",325000,500000,175000,35
TIKI,nha-sach-tiki,67060010,"Thực Đơn Ăn Dặm Kiểu Nhật",116000,168000,52000,31
TIKI,nha-sach-tiki,189642774,"Thay Đổi Vận Mệnh Từ Bàn Tay",84000,128000,44000,34
TIKI,nha-sach-tiki,180400055,"Thất Lạc Cõi Người (Tái Bản 2022)",106250,106250,0,0
TIKI,nha-sach-tiki,107773093,"Hộp màu 150 chi tiết cho bé, bộ màu vẽ đa năng cho bé thỏa thích tô - MAU150",55900,55900,0,0
TIKI,do-choi-me-be,78283430,"Đồ chơi mô hình xe bus 2 tầng mui trần  KAVY có nhạc và đèn chạy cót bằng kim loại bền bỉ, xe thăm quan du lịch thành phố",185000,185000,0,0
TIKI,do-choi-me-be,146618294,"Hộp 6 bộ đồ chơi lắp ráp Robot biến hình - Phương tiện cảnh sát ( 453 chi tiết) Qman 41104",329000,349000,20000,6
TIKI,do-choi-me-be,131192983,"[HÀNG CHÍNH HÃNG] Nước lau sàn chuyên dụng dành riêng cho Robot hút bụi lau nhà ECOVACS DEEBOT / ILIFE / XIAOMI / LIECTROUX / IROBOT",96900,96900,0,0
TIKI,do-choi-me-be,51064515,"Tấm lót chống thấm cho bé Organic Good Cotton Babyup. Miếng lót chống thấm 4 lớp. Tấm lót thay tả mềm mại, thoáng khí, siêu thấm hút, có thể giặt, an toàn cho bé",139000,199000,60000,30
TIKI,do-choi-me-be,55500745,"Bộ đồ chơi nhà bếp cao 40cm",209000,209000,0,0
TIKI,do-choi-me-be,107995394,"Bộ 2 Bình sữa mô phỏng tự nhiên hiệu Philips Avent (125 ml) cho trẻ từ 0 tháng tuổi 690.23",485000,485000,0,0
TIKI,do-choi-me-be,49884596,"Sữa Morinaga Số 3 Hương Vani - Kodomil (850g) dành cho bé trên 36 tháng tuổi",432000,551000,119000,22
TIKI,do-choi-me-be,173339381,"Mũ Bảo Hiểm Tập Đi An Toàn Cho Bé 7 Tháng đến 4 Tuổi nhẹ gọn, thoáng mát đầu bé",89800,89800,0,0
TIKI,do-choi-me-be,212607471,"Ensure Đức cho người lớn tuổi Ensure Vanille-Geschmask giúp hồi phục sức khỏe cho người gầy, suy dinh dưỡng - QuaTangMe Extaste",496000,992000,496000,50
TIKI,do-choi-me-be,59493903,"Phụ kiện tóc cho bé phong cách Hàn Quốc 17 món kèm hộp, giao màu ngẫu nhiên+ Tặng kèm hình dán nam châm hình que kem cho bé",69000,89700,20700,23
TIKI,do-choi-me-be,88820588,"Hộp 30 túi trữ sữa sunmum mini 100ml Thái Lan (có tem niêm phong) tặng 2 zipper 15x20cm",69000,69000,0,0
TIKI,do-choi-me-be,49184432,"Đồ bơi cho bé gái quần short dài tay size từ 28kg đến 45kg",249000,283090,34090,12
TIKI,do-choi-me-be,104137482,"Núm vú cổ hẹp silicone mềm Pigeon (2 cái/vỉ)",9000,26000,17000,65
TIKI,do-choi-me-be,50415176,"Sữa Tắm Gội Trẻ Em Lactacyd Bb GIẢM RÔM SẢY và HĂM KẼ VƯỢT TRỘI 250ml",97000,101000,4000,4
TIKI,do-choi-me-be,89221426,"Hai lốc giấy vệ sinh An Khang Classic10 hai lớp - 10 cuộn / lốc",72000,104000,32000,31
TIKI,do-choi-me-be,168293316,"Canxi & vitamin D Ostelin Úc cho bà bầu (130 viên)",330000,330000,0,0
TIKI,do-choi-me-be,95269411,"Tã Dán Siêu Cao Cấp Huggies Platinum Naturemade XL44 (44 Miếng)",329000,460000,131000,28
TIKI,do-choi-me-be,143778813,"Cờ tỷ phú Monopoly - Việt Nam Phiên Bản cao cấp",351000,351000,0,0
TIKI,do-choi-me-be,112969206,"Bộ Thẻ Bài Pokemon 25 Thẻ Sword Shield BATTLESTYLES ( Mẫu Ngẫu Nhiên) Loại Cao cấp",25000,25000,0,0
TIKI,do-choi-me-be,49209058,"Combo 3 Khăn Tắm Bonny Sợi Tre Siêu Mềm Và Thấm Hút Cho Bé",285000,285000,0,0
TIKI,do-choi-me-be,131246833,"Lều Xông Hơi Tự Bung Lều Xông Hơi Sau Sinh Trị Cúm Tại Nhà Kèm Nồi Hơi Cao Cấp Dung Tích 2L",539000,539000,0,0
TIKI,do-choi-me-be,104850831,"Váy đầm thun cho bé gái mùa hè mầu vàng cổ sen dây nơ - Size 11-45kg - K140",199000,199000,0,0
TIKI,do-choi-me-be,14766073,"Bộ bài UNO  giấy cứng",19600,19600,0,0
TIKI,do-choi-me-be,180396538,"Đai địu vải 4 tư thế có đỡ cổ cho bé sơ sinh, trẻ em 36 tháng tuổi ngồi xe máy an toàn - MySun",144000,255000,111000,44
TIKI,do-choi-me-be,87894726,"Xe Trượt Scooter 3 Bánh Phát Sáng Cho Bé Bằng Nhựa - Kiểu mới",161000,280000,119000,43
TIKI,do-choi-me-be,164075724,"Tả quần Kitin Natural size XL38 (12-15kg)",140000,225000,85000,38
TIKI,do-choi-me-be,107020740,"Đồ chơi Câu Cá Đại Dương Duka",104250,139000,34750,25
TIKI,do-choi-me-be,192650438,"Sữa Tắm Gội Trẻ Em Lactacyd Baby Gentle Care Bảo Vệ Dịu Nhẹ Cho Làn Da Nhạy Cảm 500ml",183000,183000,0,0
TIKI,do-choi-me-be,79126494,"Combo 10 Nút bịt ổ điện an toàn cho bé chất liệu nhựa ABS cao cấp",6605,9026,2421,27
TIKI,do-choi-me-be,164075817,"Tả quần Kitin Natural size XXXL34(>18kg)",140000,225000,85000,38
TIKI,do-choi-me-be,7187943,"Sữa Bột Vinamilk Sure Diecerna - Hộp Thiếc 900g",585000,585000,0,0
TIKI,do-choi-me-be,116572132,"Combo 2 lon sữa bột dinh dưỡng công thức HiPP 2 Organic Combiotic chất lượng hữu cơ tự nhiên an toàn, bổ sung Omega 3 (DHA & ALA) dành cho trẻ từ 6 đến 12 tháng tuổi (2 lon x 800g)",1440000,1440000,0,0
TIKI,do-choi-me-be,43282996,"Cờ Vua Nam Châm Cao Cấp 25cm, 32cm, 36cm – Hàng Chính Hãng",89000,89000,0,0
TIKI,do-choi-me-be,42794160,"COMBO 3 Bộ Quần áo Tole lanh Bé Gái | Mẫu đùi Cánh Tiên cài nút sau - Size 1-16 cho bé 5-43kg -  Hàng Việt Nam chất lượng",117000,117000,0,0
TIKI,do-choi-me-be,37130044,"Vệ sinh máy rửa bát Finish",99000,99000,0,0
TIKI,do-choi-me-be,34024059,"Bô vệ sinh cho bé Kiu Kiu babyhop NM-105",188000,320000,132000,41
TIKI,do-choi-me-be,58978895,"Vi Sinh Xử Lý Hầm Cầu, Bể Phốt Bị Đầy - EcoClean Septic - Nhập Khẩu Mỹ - Túi 100gram",82000,82000,0,0
TIKI,do-choi-me-be,19944395,"Tã Quần Moony Natural Bông Organic L36 (36 Miếng)",280000,280000,0,0
TIKI,do-choi-me-be,27731018,"Đồ Chơi Bác Sĩ 31 Chi Tiết Có Đèn Và Áo Mũ Blouse - Màu Hồng",119000,119000,0,0
TIKI,do-choi-me-be,91256196,"Nước rửa chén diệt khuẩn KAO Kyukyutto Clear 1380mL nội địa Nhật - Hương bưởi",159740,163000,3260,2
TIKI,nha-sach-tiki,145279201,"Sách Đường Xưa Mây Trắng - Theo Gót Chân Bụt (Tái bản năm 2020) (Bìa mềm/ Câu Chuyện Thú Vị Về Bụt/ Tặng Kèm Bookmark)",270650,270650,0,0
TIKI,nha-sach-tiki,19349136,"Sức Mạnh Tiềm Thức (Tái Bản)",102000,128000,26000,20
TIKI,nha-sach-tiki,186880675,"Thế Chiến Thứ Hai",435400,699000,263600,38
TIKI,nha-sach-tiki,191949999,"ĐẠO ĐỨC HỌC - SPINOZA",154000,268000,114000,43
TIKI,nha-sach-tiki,114937975,"Bóng Trăng Trắng Ngà - Bản Thường (Tặng Kèm: Bìa Áo + 1 Book Mark)",102000,129000,27000,21
TIKI,nha-sach-tiki,183539215,"Trần Triều Nhàn Thoại",80000,119000,39000,33
TIKI,nha-sach-tiki,192339430,"Tâm Lý Học Về Sự Tự Tôn",95100,129000,33900,26
TIKI,nha-sach-tiki,72511282,"Bộ Sách Tự Xóa Thông Minh - Bé Học Toán Mỗi Ngày (5 -7 tuổi) (Tặng Kèm Bút Xóa)",69500,89000,19500,22
TIKI,nha-sach-tiki,150997930,"Thế Giới Otome Game Thật Khắc Nghiệt Với Nhân Vật Quần Chúng - Tập 4",137000,179000,42000,23
TIKI,nha-sach-tiki,185909452,"Điệp Viên Hoàn Hảo X6 (Bìa Mềm)",124000,178000,54000,30
TIKI,nha-sach-tiki,69764547,"Hẹn Nhau Phía Sau Tan Vỡ",61400,86000,24600,29
TIKI,nha-sach-tiki,71092794,"Thanh Gươm Diệt Quỷ - Tập 18: Kí Ức Trỗi Dậy",25000,25000,0,0
TIKI,nha-sach-tiki,68580163,"Sổ Tay Học Nhanh Toàn Diện Kiến Thức Và Dạng Bài Hóa Học Lớp  10 - 11 - 12",78000,119000,41000,34
TIKI,nha-sach-tiki,16391543,"Cha Voi - Dạy Con Nên Người Ở Thời Đại Số",97000,150000,53000,35
TIKI,nha-sach-tiki,186286174,"Trại Hoa Vàng (Tái Bản 2022)",33000,50000,17000,34
TIKI,nha-sach-tiki,193433940,"Tập luyện cổ họng – 5 phút 1 ngày giúp kéo dài 10 năm tuổi thọ",56400,79000,22600,29
TIKI,nha-sach-tiki,195801673,"Khoa Học Khám Phá - Vũ Trụ Trong Vỏ Hạt Dẻ (Tái Bản 2022)",73000,108000,35000,32
TIKI,nha-sach-tiki,186578985,"Hãy Yêu Đời Dẫu Đời Có Trái Ngang -Tặng kèm 01 Bookmark",68100,89000,20900,23
TIKI,nha-sach-tiki,83757985,"Cao Thủ “Đổi Đen Thay Trắng” - Tập 2 (Dành Cho 18+)",111000,149000,38000,26
TIKI,nha-sach-tiki,966503,"Tuần Của Bé - Bé Lắng Nghe",11500,23000,11500,50
TIKI,nha-sach-tiki,173357306,"Sách 7 Thói Quen Tạo Gia Đình Hạnh Phúc",117000,168000,51000,30
TIKI,nha-sach-tiki,186495460,"Những Bài Diễn Văn Làm Thay Đổi Thế Giới Từ 1945 Đến Nay",253000,340000,87000,26
TIKI,nha-sach-tiki,75615221,"Combo 3 Cuốn Sách Ehon: Ai Giấu Cái Gì Đó (Dành Cho Trẻ Từ 0 - 4 Tuổi)",74100,117000,42900,37
TIKI,nha-sach-tiki,75630589,"Sách PACE Books - Tốc độ của niềm tin (The Speed Of Trust: The One Thing That Changes Everything) (Tái Bản) - Stephen M. R. Covey, Rebecca R. Merrill",140000,175000,35000,20
TIKI,nha-sach-tiki,164273180,"Dệt Nên Sự Sống: Khám Phá Bí Mật Cứu Tinh Của Thế Giới Tự Nhiên",84000,119000,35000,29
TIKI,nha-sach-tiki,8306438,"Combo Lược Sử Thời Gian và Vũ Trụ Trong Vỏ Hạt Dẻ",206350,206350,0,0
TIKI,nha-sach-tiki,63516905,"Boxset 4 Cuốn: Cá Voi Đêm Bão Và Những Câu Chuyện Khác…",142000,200000,58000,29
TIKI,nha-sach-tiki,186267247,"Shaman King 11",34300,35000,700,2
TIKI,nha-sach-tiki,16284262,"Tuổi Thơ Dữ Dội - Tập 2 (Tái Bản 2019)",58000,80000,22000,28
TIKI,nha-sach-tiki,184283143,"Combo 10 bìa nút túi hồ sơ tài liệu A4 loại dày màu tự chọn Deli - Phù hợp học sinh văn phòng - EF10412 / EF10432 / EF10442 / EF10452 / EF10462 / EF10472",12000,27000,15000,56
TIKI,nha-sach-tiki,716891,"Mom's Letters: Alphabet",17000,18000,1000,6
TIKI,nha-sach-tiki,93249305,"Tư Duy Nhanh Và Chậm (Bản mới nhất 2020)",201000,269000,68000,25
TIKI,nha-sach-tiki,148937423,"Sách: Vì Sao Đơn Giản Lại Hiệu Quả",84500,130000,45500,35
TIKI,nha-sach-tiki,18002162,"Sách Thiếu Nhi - Truyện Tranh Mây Trắng và hành trình giải cứu Trái đất ",33250,35000,1750,5
TIKI,nha-sach-tiki,188533804,"Chuyện Dài Thành Chuyện Ngắn",103000,115000,12000,10
TIKI,nha-sach-tiki,108261354,"Tự Học Ngữ pháp Tiếng Anh Bằng Mindmap Tập 1",108000,145000,37000,26
TIKI,nha-sach-tiki,181699638,"Đất Tiền Đất Bạc",99000,150000,51000,34
TIKI,nha-sach-tiki,2782635,"Nghệ Thuật Quản Lý Tài Chính Cá Nhân",111300,159000,47700,30
TIKI,nha-sach-tiki,57708766,"Kẻ trừng phạt (Tái Bản 2020)",62500,125000,62500,50
TIKI,nha-sach-tiki,196201375,"Sách - Bình Yên Trong Bão Tố",213750,225000,11250,5
TIKI,thiet-bi-kts-phu-kien-so,273908702,"Bộ sạc nhanh IP công suất 20W chuẩn PD iCybernet IC-3001 (C to L cho IP14 trở xuống) - Hàng chính hãng",192000,300000,108000,36
TIKI,thiet-bi-kts-phu-kien-so,273908828,"Bộ sạc nhanh IP, Android chuẩn PD 20W iCybernet IC-3002 cáp C to C 1,2m (Cáp hỗ trợ sạc tối đa 100W cho mọi thiết bị typeC) - Hàng chính hãng",192000,300000,108000,36
TIKI,thiet-bi-kts-phu-kien-so,273906695,"Cáp sạc và truyền dữ liệu 2.4A iCybernet IC-1002 USB to TypeC - Hàng chính hãng",58000,100000,42000,42
TIKI,thiet-bi-kts-phu-kien-so,273906522,"Cáp sạc USB to IP iCybernet IC-1001 sạc 2.4A và truyền dữ liệu đồng thời, chiều dài 1,2m - Hàng chính hãng",58000,100000,42000,42
TIKI,thiet-bi-kts-phu-kien-so,109393113,"Tai nghe bluetooth nhét tai chống ồn cao cấp V5.0 chính hãng dùng cho iPhone Samsung OPPO VIVO HUAWEI XIAOMI tai nghe không dây Hàng Chính Hãng PKCB",280000,500000,220000,44
TIKI,thiet-bi-kts-phu-kien-so,123836523," Adapter Sạc 1 Cổng USB Type-C 20W Apple MHJE3ZA/A",450000,790000,340000,43
TIKI,thiet-bi-kts-phu-kien-so,273891515,"Cáp sạc siêu nhanh PD 100W iCybernet IC-1004 C to C chiều dài 1m - Hàng chính hãng",98000,150000,52000,35
TIKI,thiet-bi-kts-phu-kien-so,72796676,"Giá Đỡ Laptop Hợp Kim Nhôm Cao Cấp Có Thể Gấp Gọn, Giúp Tản Nhiệt Laptop, Macbook, Máy Tính Xách Tay. 07 Vị Trí Điều Chỉnh Góc Độ. Hàng Chính Hãng Tamayoko FS060",199000,229000,30000,13
TIKI,thiet-bi-kts-phu-kien-so,273908414,"Cáp sạc nhanh IP chuẩn PD 20W iCybernet IC-1003 TypeC to IP chiều dài 1,2m - Hàng chính hãng",98000,150000,52000,35
TIKI,thiet-bi-kts-phu-kien-so,143957287,"HUB Type C và HUB USB 3.0 tốc độ cao 4 in 1 Sidotech bộ chia cổng usb mở rộng kết nối chuyển đổi cho Macbook Pro Laptop PC máy tính hỗ trợ sạc pin kết nối đa năng ổ cứng bàn phím chuột máy in, thiết bị ổ chia usb - Hàng chính hãng",399000,399000,0,0
TIKI,thiet-bi-kts-phu-kien-so,110850007,"Tai nghe nhét tai có dây jack 3.5mm Remax RM-512 (New Package) - Hàng chính hãng",106550,150000,43450,29
TIKI,thiet-bi-kts-phu-kien-so,251518071,"Cáp sạc nhanh chuẩn PD 20W cho IP Remax RC-183i chiều dài 2m - Hàng chính hãng",144550,200000,55450,28
TIKI,thiet-bi-kts-phu-kien-so,1935009,"Tai Nghe Apple EarPods Cổng Lightning - MMTN2",480000,790000,310000,39
TIKI,thiet-bi-kts-phu-kien-so,142439870,"Cáp sạc Baseus Cafule sạc nhanh dùng cho iPhone - Hàng chính hãng",89000,159000,70000,44
TIKI,thiet-bi-kts-phu-kien-so,123838761,"Apple AirPods 2 - MV7N2 - Hộp Sạc Thường",2690000,5390000,2700000,50
TIKI,thiet-bi-kts-phu-kien-so,72796676,"Giá Đỡ Laptop Hợp Kim Nhôm Cao Cấp Có Thể Gấp Gọn, Giúp Tản Nhiệt Laptop, Macbook, Máy Tính Xách Tay. 07 Vị Trí Điều Chỉnh Góc Độ. Hàng Chính Hãng Tamayoko FS060",179000,179000,0,0
TIKI,thiet-bi-kts-phu-kien-so,216238849,"Bộ sạc nhanh cho IP công suất 18W Remax RP-U37 - Hàng chính hãng",249000,300000,51000,17
TIKI,thiet-bi-kts-phu-kien-so,73179180,"Thẻ Nhớ microSD SanDisk Ultra 128GB UHS-I - 100MB/s (New 2020) - Hàng Nhập Khẩu",229000,229000,0,0
TIKI,thiet-bi-kts-phu-kien-so,73315307,"Thẻ Nhớ microSD SanDisk Ultra 64GB UHS-I - 100MB/s (New 2020) - Hàng Nhập Khẩu",129000,129000,0,0
TIKI,thiet-bi-kts-phu-kien-so,102782859,"Tai nghe In Ear Remax RM330 - Hàng chính hãng",212000,250000,38000,15
TIKI,thiet-bi-kts-phu-kien-so,102391960,"Giá Đỡ Máy Tính, Laptop, iPad, Macbook Hợp Kim Nhôm Cao Cấp. Hỗ Trợ Tản Nhiệt Chống Mỏi Cổ, Vai, Gáy. Hàng Chính Hãng Tamayoko",450000,500000,50000,10
TIKI,thiet-bi-kts-phu-kien-so,201437484,"Giá Đỡ Máy Tính, Laptop, iPad, Macbook Hợp Kim Nhôm Cao Cấp. Hỗ Trợ Tản Nhiệt Chống Mỏi Cổ, Vai, Gáy. Hàng Chính Hãng Tamayoko",489000,489000,0,0
TIKI,thiet-bi-kts-phu-kien-so,189474023,"Sạc dự phòng không dây từ tính Remax RPP-65 10000mAh - Hàng chính hãng",753500,990000,236500,24
TIKI,thiet-bi-kts-phu-kien-so,299431,"Chuột Không Dây Logitech M221",280000,280000,0,0
TIKI,thiet-bi-kts-phu-kien-so,172146754,"Ốp lưng chống sốc lưng trong phong cách mới dành cho iPhone 11 / 12 / 13 / 11 Pro / 12 Pro / 13 Pro / 11 Pro Max / 12 Pro Max / 13 Pro Max / 12 Mini / 13 Mini - Hàng chính hãng",179000,250000,71000,28
TIKI,thiet-bi-kts-phu-kien-so,134364129,"Bộ Thu Phát Bluetooth TP-Link UB500 USB Nano Bluetooth 5.0 - Hàng Chính Hãng",118000,118000,0,0
TIKI,thiet-bi-kts-phu-kien-so,207520850,"Cáp sạc nhanh Lesu Pro Series 5A Remax RC-188a USB To TypeC- Hàng chính hãng",144550,200000,55450,28
TIKI,thiet-bi-kts-phu-kien-so,201437484,"Giá Đỡ Máy Tính, Laptop, iPad, Macbook Hợp Kim Nhôm Cao Cấp. Hỗ Trợ Tản Nhiệt Chống Mỏi Cổ, Vai, Gáy. Hàng Chính Hãng Tamayoko",479000,489900,10900,2
TIKI,thiet-bi-kts-phu-kien-so,56859344,"Chuột không dây sạc điện HXSJ M103 - Hàng chính hãng",119000,199000,80000,40
TIKI,thiet-bi-kts-phu-kien-so,123847933,"Apple Pencil 2 - MU8F2",2690000,4890000,2200000,45
TIKI,thiet-bi-kts-phu-kien-so,272913331,"Thiết bị theo dõi thông minh Samsung Galaxy SmartTag2-Hàng Chính hãng",355000,355000,0,0
TIKI,thiet-bi-kts-phu-kien-so,36007224,"Bàn phím có dây Dell KB216 USB - Hàng Chính Hãng",160000,160000,0,0
TIKI,thiet-bi-kts-phu-kien-so,123518348,"Tai nghe Remax RM-201 - Hàng chính hãng",112250,150000,37750,25
TIKI,thiet-bi-kts-phu-kien-so,97547734,"Giá Đỡ Để Bàn Điện Thoại Di Động, Máy Tính Bảng, Ipad Hợp Kim Nhôm Cao Cấp Hai Trục Xoay 180 Độ Chống Đổ Hàng Chính Hãng Tamayoko",390000,450000,60000,13
TIKI,thiet-bi-kts-phu-kien-so,76480235,"Bao Tay Chơi Game Cảm Ứng Chống Mồ Hôi SIDOTECH Siêu Mỏng Vải Sợi Carbon Siêu Bền Chống Giãn Xù, Cảm Ứng Nhạy Thuộc Dòng Găng Tay Chơi Game Bao Ngón Tay Cho PUBG Tốc Chiến Freefire Liên Quân mobile - Hàng Chính Hãng",26000,26000,0,0
TIKI,thiet-bi-kts-phu-kien-so,162772687,"Chuột không dây Logitech SIGNATURE M650 Wireless/Bluetooth - Hàng Chính Hãng",650000,650000,0,0
TIKI,thiet-bi-kts-phu-kien-so,71091864,"Đồng Hồ Pomodoro Hẹn Giờ 60 Phút Kim Loại Nhiều Kiểu Dáng",75000,75000,0,0
TIKI,thiet-bi-kts-phu-kien-so,299461,"Chuột Không Dây Logitech M331 Silent",389000,389000,0,0
TIKI,thiet-bi-kts-phu-kien-so,126697,"Tai Nghe Nhét Tai Sony MDR-EX15AP",190000,199000,9000,5
TIKI,thiet-bi-kts-phu-kien-so,174593860,"Chuột Không Dây Bluetooth PIX-LINK P100B Chống Ồn, DPI 1600, Chế Độ Kép Wireless Usb 2.4Ghz, Bluetooth Dùng Cho Macbook, Laptop, PC - Hàng chính Hãng",133000,299000,166000,56
TIKI,thiet-bi-kts-phu-kien-so,174593840,"Chuột Không Dây PIX-LINK P100 Wireless 2.4Ghz Sạc Pin, Chống Ồn, DPI1600 Dùng Cho Máy Tính, Laptop, Tivi-Hàng Chính Hãng",115000,230000,115000,50
TIKI,thiet-bi-kts-phu-kien-so,146266186,"Miếng Lót Chuột Kai Hình Chữ Nhật Siêu Dễ thương Nhiều Mẫu Mới",23000,28000,5000,18
TIKI,thiet-bi-kts-phu-kien-so,171657209,"Thẻ Nhớ Micro SDXC Samsung Evo Plus U3 130MB/s 128GB New  - Hàng Nhập Khẩu",295000,295000,0,0
TIKI,thiet-bi-kts-phu-kien-so,3671793,"Sim 4G Mobifone 12FD50 Tặng 150GB/Tháng(5GB/Ngày) Trọn Gói 1 Năm- Hàng Chính Hãng - Mẫu ngẫu nhiên",750000,750000,0,0
TIKI,thiet-bi-kts-phu-kien-so,88798139,"Dây Cáp Dù Lõi HDMI 2.1 8K 48Gbps, 4K 165Hz Dài 2M CHOETECH XHH01 Dùng Cho Tivi/ Máy Tính/ Playstation - Hàng Chính Hãng",219000,390000,171000,44
TIKI,thiet-bi-kts-phu-kien-so,1060082,"Dây Cáp Sạc Li.ght.ning Cho i.Phone Anker PowerLine II 1.8m - A8433H22",320000,380000,60000,16
TIKI,thiet-bi-kts-phu-kien-so,158868703,"[Miễn Phí 12 Tháng] SIM MAX DATA 4G VIETNAMOBILE 6GB/Ngày. Trọn Gói 1 Năm - Hàng Chính Hãng",368000,650000,282000,43
TIKI,thiet-bi-kts-phu-kien-so,19419738,"Bộ Thu Phát Bluetooth TP-Link UB400 USB Nano Bluetooth 4.0 - Hàng Chính Hãng",102000,102000,0,0
TIKI,thiet-bi-kts-phu-kien-so,389145,"Chuột không dây Logitech B175 - đầu thu USB 2.4Ghz, pin 1 năm, nhỏ gọn, thiết kế thuận cả 2 tay, phù hợp PC/ Laptop - Hàng chính hãng",199000,199000,0,0
TIKI,thiet-bi-kts-phu-kien-so,1059892,"Dây Cáp Sạc Lightning Cho iPhone Anker PowerLine II 0.9m - A8432H21",260000,330000,70000,21
TIKI,thiet-bi-kts-phu-kien-so,174593826,"Lót chuột máy tính PixLink kích thước 22x18cm hàng chính hãng",14000,39000,25000,64
TIKI,thiet-bi-kts-phu-kien-so,174490279,"Chuột không dây bluetooth Logitech Signature M650 - Dành cho tay có kích cỡ từ nhỏ tới trung bình, Cuộn SmartWheel, giảm ồn, các nút bên có thể tùy chỉnh - Hàng chính hãng",576000,869000,293000,34
TIKI,thiet-bi-kts-phu-kien-so,137864606,"Tấm Lót Chuột, Thảm Da Trải Bàn Làm Việc VinBuy, Miếng Di Chuột Cỡ Lớn 40cmx80cm - Hàng Chính Hãng",90000,180000,90000,50
TIKI,thiet-bi-kts-phu-kien-so,56889347,"Chuột Không Dây HXSJ X50 Plus - Hàng Chính Hãng",129000,245000,116000,47
TIKI,thiet-bi-kts-phu-kien-so,71672203,"Thẻ Nhớ microSDHC SanDisk Ultra 32GB UHS-I - 100MB/s (New 2020) - Hàng Nhập Khẩu",108000,108000,0,0
TIKI,nha-cua-doi-song,70372700,"Đèn Cây Dạng Đứng Đọc Sách Pixar, Đèn Sàn, Đèn Trang Trí Phòng Khách, Đèn Ngủ. Chống Cận Thị Bảo Vệ Mắt. Chiều Cao 1,85m. Hàng Chính Hãng Moontronics",399000,399000,0,0
TIKI,nha-cua-doi-song,75356087,"Túi Đựng Hộp Cơm Giữ Nhiệt Đa Lớp Cỡ Lớn 34cm*25cm*15cm",60000,60000,0,0
TIKI,nha-cua-doi-song,116670105,"Dụng cụ di chuyển vật nặng",275000,275000,0,0
TIKI,nha-cua-doi-song,107713002,"Nam châm siêu trường, siêu mạnh, siêu hút dính dùng để trục vớt đồ vật, nâng vật nặng, treo đồ Dan House - DST15, Hàng chính hãng-D20",92000,92000,0,0
TIKI,nha-cua-doi-song,173673833,"Ghế Quầy Bar Cao Cấp Phong Cách Hiện Đại Decor Tại Nhà Hoặc Văn Phòng Thư Giãn - Hàng Chính Hãng",699000,935000,236000,25
TIKI,nha-cua-doi-song,192909616,"Khăn mặt khô KIPOR dùng 1 lần lau khô, lau ướt - 60 khăn/cuộn, kích thước 20x20cm - Hàng chính hãng",33000,65000,32000,49
TIKI,nha-cua-doi-song,58451521,"Combo 2 Miếng Lau Nhà Parroti Magic MG01 – Kích Thước 32x10 CM - Chất Liệu Microfiber Cao Cấp",55000,109000,54000,50
TIKI,nha-cua-doi-song,73566076,"Cây lau nhà tự vắt thông minh chổi lau nhà 360 độ, kèm 2 miếng lau Kitimop-RED, vắt kiệt nước dễ dàng, cầm nhẹ tay, chổi lau nhà thông minh",145000,145000,0,0
TIKI,nha-cua-doi-song,44297321,"Đèn Diệt Côn Trùng Đại Sinh DS-D6",585000,585000,0,0
TIKI,nha-cua-doi-song,14338957,"Bộ 3 khăn tắm Nhật siêu mềm siêu thấm - khăn tắm khổ rộng 70x140",28998,28998,0,0
TIKI,nha-cua-doi-song,115436781,"Đèn Fairy Light Năng Lượng Mặt Trời Điều Khiển Remote",270000,270000,0,0
TIKI,nha-cua-doi-song,162405563,"Cọ Bồn Cầu Toilet Nhà Vệ Sinh Cao Cấp Kèm Giá Cắm Chổi  Silicon - Hàng Loại 1 - Chính Hãng MINIIN",83000,109000,26000,24
TIKI,nha-cua-doi-song,191136118,"Bóng Đèn Led Bulb, Led Edison Đui E27 Các Loại - Hàng Chính Hãng NAVIVU",15000,15000,0,0
TIKI,nha-cua-doi-song,31473727,"Combo 100 Túi Lọc Trà Có Dây Rút",24000,24000,0,0
TIKI,nha-cua-doi-song,94888985,"Sọt Đựng Quần Áo Bẩn Túi Đựng Đồ Đa Năng",65000,65000,0,0
TIKI,nha-cua-doi-song,58415187,"Đèn cảm ứng gắn cầu thang, tủ đồ, toilet, tự động bật/tắt ánh sáng, sạc bằng USB tiện dụng",84000,84000,0,0
TIKI,nha-cua-doi-song,117196166,"Pin Maxell R6P super AA hộp 40 viên tiểu",49900,49900,0,0
TIKI,nha-cua-doi-song,19853979,"Võng lưới số 9.2, căng kim dày BAN MAI, khổ rộng, cán thép 50 (Giao màu ngẫu nhiên)",215000,300000,85000,28
TIKI,nha-cua-doi-song,173710560,"Cuộn Khăn Giấy Lau Đa Năng - Chất Liệu Rayon An Toàn - Lau Chén Đĩa , Lau Nhà Bếp..vv - Hàng Chính Hãng",49000,58000,9000,16
TIKI,nha-cua-doi-song,191604178,"Đèn đốt nến thơm, an toàn, sang trọng, phù hợp mọi không gian",299000,299000,0,0
TIKI,nha-cua-doi-song,109213631,"Chân đặt khung ảnh chân đặt khung hình thờ chữ L xếp lại gọn gàng chắc vững - Nhiều cỡ",52000,52000,0,0
TIKI,nha-cua-doi-song,81988120,"Dây nguồn phích âm SOPOKA N8-N10 dây 2,3m-6,5m",43000,43000,0,0
TIKI,nha-cua-doi-song,58448882,"Thanh xốp chắn khe cửa đa năng thông minh",20000,20000,0,0
TIKI,nha-cua-doi-song,108025488,"BÀN CHẢI ĐÁNH RĂNG PIH HÀNG VIỆT NAM CAO CẤP SIÊU MỀM",4000,4000,0,0
TIKI,nha-cua-doi-song,73755163,"Hộp Đựng Mỹ Phẩm,Đồ Trang Điểm MOHI MT9 ,2 Ngăn Có Kệ Trên Và Nắp Đậy-Hàng Chính Hãng",414000,450000,36000,8
TIKI,nha-cua-doi-song,19557637,"Combo 2 Gối Mây Đan Tổng Hợp Thoáng Mát",67000,67000,0,0
TIKI,nha-cua-doi-song,15428054,"Đệm (Bồ đoàn) ngồi thiền Sunny",175000,175000,0,0
TIKI,nha-cua-doi-song,70536777,"Đèn bắt muỗi, ruồi và các loại côn trùng Đại Sinh DS-D6",585000,585000,0,0
TIKI,nha-cua-doi-song,69543163,"Cây thông tắc bồn cầu, nhà vệ sinh đa năng cao cấp- Dụng cụ thông tắc bồn cầu, cống bằng khi nén áp lực siêu mạnh kèm bơm rời Morado - Hàng Chính Hãng",310000,310000,0,0
TIKI,nha-cua-doi-song,76468352,"Combo 200 CÁI TÚI LỌC RÁC BỒN RỬA CHÉN - KT: 10x10cm -Hàng chất lượng tốt",27999,27999,0,0
TIKI,nha-cua-doi-song,51062179,"Keo dán đa năng siêu dính V - 370 gắn tất cả các loại vật liệu ( 50ml)",89000,89000,0,0
TIKI,nha-cua-doi-song,9805349,"Ổ cắm Điện Quang ECO ĐQ ESK 5WR 8ECO (8 Lỗ, dây dài 5m, màu trắng đỏ)",165000,223800,58800,26
TIKI,nha-cua-doi-song,116452179,"SÉT 100 TÚI BỌC THỰC PHẨM GẤU HÀNG ĐẸP, DÀY DẶN LOẠI 1.",12798,12798,0,0
TIKI,nha-cua-doi-song,39318884,"Hộp 60 Viên Pin AA Panasonic ( Pin Tiểu ) Hi Top - Hàng Chính Hãng",174000,179000,5000,3
TIKI,nha-cua-doi-song,162189829,"Nhang Xanh Phổ Thông 30cm 500g (Đỏ)",163000,165000,2000,1
TIKI,nha-cua-doi-song,230062294,"Bộ dụng cụ tháo vặn ốc vít",148000,148000,0,0
TIKI,nha-cua-doi-song,58228617,"Cuộn dây cáp làm giàn, có sợi gia cường, nhựa bọc kim loại cực kỳ bền chắc - 1kg",79000,79000,0,0
TIKI,nha-cua-doi-song,196376951,"Cốc Giữ Nhiệt Nóng Lạnh Vusign Inox 304 Cao Cấp Viền Cao Su Cách Nhiệt Deli Dung Tích 510ml -Phù Hợp Cà Phê Trà Nước Ép Sinh Tố Đá Du Lịch Đi Học Tập Gym",119000,250200,131200,52
TIKI,nha-cua-doi-song,160570940,"Set 10  Khay giấy bạc lót nồi chiên không dầu tái sử dụng được ",11000,11999,999,8
TIKI,nha-cua-doi-song,181936450,"Túi Lọc Trà Túi Lọc Cà Phê Cold Brew Vải Không Dệt Có Dây Rút 8X10Cm, Định Lượng 60G/Túi, Combo 10 Túi",14000,15000,1000,7
TIKI,dien-thoai-may-tinh-bang,152446406,"Cây Chúc ( chanh thái ) - Cây chanh ăn lá ( chanh hấp gà ) + Tặng phân bón cho cây",39000,58000,19000,33
TIKI,dien-thoai-may-tinh-bang,51966031,"Phân Hữu Cơ Gà Dynamic Nhật Bản Tốt Cây Xanh lá  Cung Cấp Đầy Đủ Dưỡng Chất , Dúng Bón Hoa Hồng ,Cây Kiểng , Cây Ăn Trái( Túi 1 KG)",35000,35000,0,0
TIKI,dien-thoai-may-tinh-bang,52021362,"Bảng điện nổi V3 Điện Quang ĐQ FEP 32W 03S (màu trắng, 3 lỗ 2 chấu, 3 công tắc)",71000,91900,20900,23
TIKI,dien-thoai-may-tinh-bang,46601114,"KỆ GƯƠNG 2 TẦNG ĐẦU GIƯỜNG GỖ THÔNG- GLASS SHELF- CAO 50CM x DÀI 30CM x RỘNG 30CM",180000,180000,0,0
TIKI,dien-thoai-may-tinh-bang,61278429,"Bình Nước Giữ Nhiệt Có Móc Treo (300ml)",68000,68000,0,0
TIKI,dien-thoai-may-tinh-bang,96419574,"Màng PE trắng khổ 50cm 2,5kg - Màng PE quấn hàng.",135000,135000,0,0
TIKI,dien-thoai-may-tinh-bang,142383214,"Hộp Đựng Giấy Ăn Để Bàn Có Ngăn Để Đồ Đa Năng, Hộp Khăn Giấy Nắp Gỗ",25624,25624,0,0
TIKI,dien-thoai-may-tinh-bang,26159911,"Decal dán tường thước đo chiều cao Hươu cao cổ 5 AmyShop (145 x 84 cm)",66900,75000,8100,11
TIKI,dien-thoai-may-tinh-bang,36568964,"thước kep điện tử sợi carbon 0-150mm",49900,49900,0,0
TIKI,dien-thoai-may-tinh-bang,132209590,"Thảm chùi chân siêu thấm hút nước 3 giây  cho phòng tắm, phòng bếp, dễ dàng vệ sinh, nhanh khô vệ sinh nhà cửa an toàn với da.",28997,28997,0,0
TIKI,dien-thoai-may-tinh-bang,141469357,"COMBO 50 Khay (Chén, Bát) Giấy FEST CHOICE FOOD TRAY 3x3 Inches THÁI LAN Hàng Nhập Khẩu Cao Cấp, Dùng 1 Lần Tiện Lợi, An Toàn - CHÍNH HÃNG F010 (Tặng Móc Khóa KETILO)",99000,99000,0,0
TIKI,dien-thoai-may-tinh-bang,84958837,"Kệ sách tổ ong đa năng.GP100",65000,69999,4999,7
TIKI,dien-thoai-may-tinh-bang,204230323,"Bộ nhang không tăm đầy đủ hộp đựng và máng đốt bằng gỗ nhà HÀ XÁ cao cấp",99000,198000,99000,50
TIKI,dien-thoai-may-tinh-bang,193095643,"Combo 2 Móc Dán Tường Trong Suốt Treo Đồ Dùng Thông Minh",6900,6900,0,0
TIKI,dien-thoai-may-tinh-bang,93154028,"Thảm lông trải sàn lông mịn kích thước 1.2 x 1.6m- dài Thảm lông trải sàn cao cấp phòng khách trang trí nhà cửa.",175000,175000,0,0
TIKI,dien-thoai-may-tinh-bang,141001207,"Ghế Gấp Inox Phòng Chờ, Ghế Xếp Văn Phòng, Ghế Phòng Họp Gấp Gọn - Hàng Chính Hãng",479000,800000,321000,40
TIKI,dien-thoai-may-tinh-bang,159144266,"Cây lau nhà VILEDA Turbo Easy Wring&Clean đầu lau tam giác, xô giặt quay bằng chân",579000,579000,0,0
TIKI,dien-thoai-may-tinh-bang,89792661,"[tặng kèm khay trúc 02 tầng] Bộ Ấm Chén Pha Trà Du Lịch 2 - Kiểu dáng trang nhã, Gọn gàng, Thích hợp mang đi du lịch, công tác",134964,134964,0,0
TIKI,dien-thoai-may-tinh-bang,35422376,"Ô Dù 4 Lớp Che Nắng, Đi Mưa Chống Tia UV",37996,37996,0,0
TIKI,dien-thoai-may-tinh-bang,57650806,"Máy bơm tăng áp mini tự động",480000,480000,0,0
TIKI,dien-thoai-may-tinh-bang,202185819,"Bình Giữ Nhiệt Cao Cấp 304  Có Nắp Xoáy Tiện Lợi Giữ Nhiệt Nóng Lạnh",200000,200000,0,0
TIKI,dien-thoai-may-tinh-bang,117370665,"Chiếu ngủ trưa văn phòng cá nhân dày 3.5ly / Chiếu Cách Nhiệt Văn Phòng 100 X 190 cm",46000,46000,0,0
TIKI,dien-thoai-may-tinh-bang,50324146,"Combo 5 Chai Thủy Tinh đựng nước 500ML - Nắp Thiếc vặn có dây treo (Bình thủy tinh đựng nước, đựng sữa - Chai thủy tinh đựng nước ép)",53000,53000,0,0
TIKI,dien-thoai-may-tinh-bang,89059076,"Chảo sâu lòng chống dính đáy từ Tefal Ultimate 28cm, dùng cho mọi loại bếp - Sản xuất tại Pháp - Hàng chính hãng",1699000,1699000,0,0
TIKI,dien-thoai-may-tinh-bang,143299139,"Bình Đựng Nước Cho Bé, Bình Nước Goki Rudy 450ml, Bình Nước Cao Cấp Chính Hãng Inochi Đạt Tiêu Chuẩn Xuất Nhật",82600,118000,35400,30
TIKI,dien-thoai-may-tinh-bang,12756233,"Ổ điện thông minh có 6 phích cắm 3 cổng USB (giao màu ngẫu nhiên)",41000,41000,0,0
TIKI,dien-thoai-may-tinh-bang,4995493,"Thang Nhôm Rút Chữ A Sumika SK380D NEW - Chữ A cao 1.9m, chữ I cao 3.8m, tải trọng 300kg",1769000,2300000,531000,23
TIKI,dien-thoai-may-tinh-bang,14886261," Máy sấy khử mùi giày",156988,156988,0,0
TIKI,dien-thoai-may-tinh-bang,43110675,"Móc Khóa Tua Vít mini đa năng sửa chữa kính, đồng hồ, điện thoại (6cm x 0,5cm)",9700,9700,0,0
TIKI,dien-thoai-may-tinh-bang,54082178,"Túi đựng rác lốc 3 cuộn 1kg - Bịch đựng rác 3 cuộn cỡ đại, trung, tiểu",24000,24000,0,0
TIKI,dien-thoai-may-tinh-bang,72797082,"Chảo Sâu Lòng DECOR Lock&Lock LDE1225IH 22cm (màu vàng) - Hàng chính hãng",397000,662000,265000,40
TIKI,dien-thoai-may-tinh-bang,271696352,"Gối Niu Cao Cấp Ru9 - Công Nghệ Đột Phá Graphene Foam | Chất Liệu Foam Mềm Mại | Nâng Đỡ Đốt Sống Cổ | Chống Đau Vai Gáy",912000,950000,38000,4
TIKI,dien-thoai-may-tinh-bang,778124,"Bộ Hộp Cơm Giữ Nhiệt Lock&Lock LHC8015 (910ml) - Xám Bạc ",619000,1142000,523000,46
TIKI,dien-thoai-may-tinh-bang,107486345,"Bộ chăn ga giường Lidaco cotton Tici cao cấp (Nhiều mẫu lựa chọn)",239000,339000,100000,29
TIKI,dien-thoai-may-tinh-bang,174307623,"Đệm Ngồi Bệt Tròn Cho Bàn Trang Điểm Vải Cao Cấp Kiểu Hàn Chính Hãng IGA - GC13",91000,99000,8000,8
TIKI,dien-thoai-may-tinh-bang,101870479,"Thanh treo rèm cửa đa năng, không cần khoan tường hay bắt vít, thay đổi vị trí linh hoạt",75000,120000,45000,38
TIKI,dien-thoai-may-tinh-bang,72659852,"Kệ Nhà Tắm Dán Tường OENON chất liệu nhựa ABS có thêm thanh nhôm treo khăn - OE08",169000,300000,131000,44
TIKI,dien-thoai-may-tinh-bang,226043852,"Chăn Gối Ngủ Văn Phòng Hình Mèo Kèm Chăn",148000,148000,0,0
TIKI,dien-thoai-may-tinh-bang,10814223,"Dụng Cụ Gắp Rác Thông Tắc Đường Ống, Lavabo Tiện Ích (160cm)",32900,32900,0,0
TIKI,dien-thoai-may-tinh-bang,98335248,"Đèn laser ánh sáng laze cảm biến âm thanh - Kết hợp Đèn LED xoay 7 màu dùng trang trí vũ trường, phòng karaoke",349000,349000,0,0
TIKI,thiet-bi-kts-phu-kien-so,173058453,"Chuột không dây bluetooth Logitech POP MOUSE - giảm ồn, nút emoji tùy chỉnh - Hàng chính hãng",529000,899000,370000,41
TIKI,thiet-bi-kts-phu-kien-so,191817608,"Bộ Bàn Phím Chuột không dây W201 nhỏ gọn",218500,230000,11500,5
TIKI,thiet-bi-kts-phu-kien-so,116125939,"Dán màn hình dành cho iPad Paper-like Kai Cao Cấp chống vân tay cho cảm giác vẽ như trên giấy",145000,145000,0,0
TIKI,thiet-bi-kts-phu-kien-so,270767050,"[Mới 100%] Sim VIETNAMOBILE Chuyên Dùng Để Nghe Gọi & Tạo Tài Khoản TMĐT, Laz, Sope, Sen, Face, ZaL0, Momo, Tw, Tele, Game... TK 0đ Giá Rẻ - Cam Kết Chưa Từng Đăng Ký Dịch Vụ Gì. Hàng Chính Hãng",55900,110000,54100,49
TIKI,thiet-bi-kts-phu-kien-so,111748361,"Lót chuột phím tắt văn phòng đã Việt hóa khổ lớn cực tiện dụng - Hàng chính hãng",55000,55000,0,0
TIKI,thiet-bi-kts-phu-kien-so,52602232,"Combo Sạc cáp nhanh 25w Type C dùng cho SS Note10 / S10plus 5G / A80, OPPO, VIVO, HUAWEI",110000,110000,0,0
TIKI,thiet-bi-kts-phu-kien-so,51059393,"Tai Nghe Dây Cho Các Dòng Sản Phẩm Phân Khúc Galaxy J Của Samsung",27900,27900,0,0
TIKI,thiet-bi-kts-phu-kien-so,126998612,"Loa Bluetooth JBL Charge 5 - Hàng Chính Hãng",3790000,3990000,200000,5
TIKI,thiet-bi-kts-phu-kien-so,13781962,"Bút trình chiếu Lazer- Bút thuyết trình- Bút trình chiếu silde- Bút điều khiển trình chiếu- Bút trình chiếu powerpoint",94500,94500,0,0
TIKI,thiet-bi-kts-phu-kien-so,86018342,"Kính Cường Lực KingKong 9D Trong Suốt Dành Cho iPhone - Full Hộp Sắt Cao Cấp - Dán Full Màn - Hàng Chính Hãng",105991,211982,105991,50
TIKI,thiet-bi-kts-phu-kien-so,122949142,"Tai nghe Bluetooth True Wireless Samsung Galaxy Buds 2 - Hàng Chính Hãng",1590000,2990000,1400000,47
TIKI,thiet-bi-kts-phu-kien-so,55210024,"Giá Đỡ Dành Cho Laptop Macbook Để Bàn Chất Liệu Hợp Kim Nhôm Cao Cấp Hàng Nhập Khẩu Helios",219000,400000,181000,45
TIKI,thiet-bi-kts-phu-kien-so,158848954,"Chuột không dây Wireless Bluetooth sạc pin SIDOTECH PM1 không cần thay pin, sạc 1 lần dùng 30 ngày thiết kế công thái học không mỏi tay, silent chống ồn ban đêm tương thích Laptop Macbook Máy tính bảng PC- Hàng Chính Hãng",182000,182000,0,0
TIKI,thiet-bi-kts-phu-kien-so,158868825,"[FREE 6 Tháng - Đầu Số 092] SIM MAX DATA 4G VIETNAMOBILE - 6GB/Ngày. Trọn Gói 6 Tháng Không Cần Nạp Tiền - Hàng Chính Hãng",268000,350000,82000,23
TIKI,thiet-bi-kts-phu-kien-so,72725402,"Combo chuột phím không dây Logitech MK295 Silent - Chống ồn 90%, có phím số, mắt đọc cải tiến, bền bỉ, không lag - Hàng chính hãng",694000,694000,0,0
TIKI,thiet-bi-kts-phu-kien-so,7734288,"SIM 4G Mobifone MDT250A Trọn Gói 1 Năm Không Cần Nạp Tiền - Hàng chính hãng - Mẫu ngẫu nhiên",299000,299000,0,0
TIKI,thiet-bi-kts-phu-kien-so,115847303,"Giá Đỡ Để Bàn Điện Thoại Di Động, Máy Tính Bảng. Chất Liệu Hợp Kim Nhôm Cao Cấp. Xoay 270 Độ Tự Do Điều Chỉnh Góc Nhìn Model Z4. Hàng Chính Hãng Tamayoko",119000,149000,30000,20
TIKI,thiet-bi-kts-phu-kien-so,195998782,"Cáp sạc và truyền dữ liệu 2.4A Remax RC-138a USB to TypeC  - Hàng chính hãng",59000,99000,40000,40
TIKI,thiet-bi-kts-phu-kien-so,95681232,"Adapter Sạc Anker 1 cổng 65W Hỗ Trợ Sạc Nhanh PIQ 3.0 PowerPort III Pod Lite - A2718 - Hàng chính hãng",594000,750000,156000,21
TIKI,thiet-bi-kts-phu-kien-so,97034068,"Tai Nghe Nhét Tai XSmart HiFi S2000 Pro Super Bass Chống Ồn Cực Tốt, Âm Thanh Khủng, Chơi Game Ngon - Hàng Chính Hãng",69000,69000,0,0
TIKI,thiet-bi-kts-phu-kien-so,96595575,"Cáp USB nối dài 1.5M 3M 5M CHỐNG NHIỄU",12000,12000,0,0
TIKI,thiet-bi-kts-phu-kien-so,3416201,"Bảng Vẽ Wacom Intuos S CTL-4100 - Hàng Chính Hãng",2147000,2147000,0,0
TIKI,thiet-bi-kts-phu-kien-so,150205187,"Que Chọc Sim",1490,1490,0,0
TIKI,thiet-bi-kts-phu-kien-so,356188,"Chuột Có Dây Logitech B100 - Hàng Chính Hãng",89000,89000,0,0
TIKI,thiet-bi-kts-phu-kien-so,73261935,"Giá Đỡ Để Bàn Điện Thoại Di Động, Máy Tính Bảng, Ipad Mini. Chất Liệu Hợp Kim Nhôm Cao Cấp. Hàng Chính Hãng Tamayoko",119200,149000,29800,20
TIKI,thiet-bi-kts-phu-kien-so,183119284,"Case Silicon dành cho Airpods 1,2/ Airpods Pro/ Airpods 3 Hình Chó Cori_ Hàng Chính Hãng",85000,85000,0,0
TIKI,thiet-bi-kts-phu-kien-so,115105801,"Thiết Bị Đọc Thẻ Nhớ ROBOT CR202 - 2 Đầu Type-C Và USB 3.0, Khe Cắm Thẻ Nhớ SD/Micro SD - Hàng Chính Hãng",220000,220000,0,0
TIKI,thiet-bi-kts-phu-kien-so,1457747,"Thẻ Nhớ Micro SDXC SanDisk UHS-1 64GB Class 10 - Hàng Chính Hãng",173000,173000,0,0
TIKI,thiet-bi-kts-phu-kien-so,54616399,"Giá đỡ điện thoại để bàn gấp Điện thoại di động Giá đỡ bàn cho iPhone ipad pro mini Samsung Xiaomi Tablet Đứng tăng và giảm Giá đỡ có thể điều chỉnh",13000,13798,798,6
TIKI,thiet-bi-kts-phu-kien-so,68467585,"Đồng Hồ Thông Minh Trẻ Em ngôn ngữ Tiếng Việt, Pin sử dụng được 2 ngày, dây đeo có Hoa văn hình Trái tim Dễ thương Model Y85 Pro - Hàng nhập khẩu",490000,490000,0,0
TIKI,thiet-bi-kts-phu-kien-so,135412837,"Đế Sạc Nhanh Không Dây Đa Năng 3in1 Remax RP-W53 - Hỗ Trợ Sạc Nhanh Lên Đến 15W - Hàng Chính Hãng",550000,550000,0,0
TIKI,thiet-bi-kts-phu-kien-so,175104946,"Thẻ Nhớ Micro SDXC Samsung Evo Plus U3 130MB/s 256GB New - Hàng Nhập Khẩu",480000,480000,0,0
TIKI,thiet-bi-kts-phu-kien-so,173034520,"Combo chuột phím không dây Logitech MK345 - 1 đầu thu USB, pin lâu, chống tràn, fullsize - Hàng chính hãng",565000,749000,184000,25
TIKI,thiet-bi-kts-phu-kien-so,148824604,"Bộ thu phát Bluetooth, thiết bị hỗ trợ thu phát nhạc không dây Nano USB 5.0 Bluetooth dành cho Laptop, Máy tính để bàn, Tivi",30000,39000,9000,23
TIKI,thiet-bi-kts-phu-kien-so,22633043,"Dây 2 Đầu HDMi 5M UNITEK - Cáp HDMI 5M UNITEK Full HD 4K - Hàng Nhập Khẩu",155000,155000,0,0
TIKI,thiet-bi-kts-phu-kien-so,148813604,"Chuột không dây Logitech M331 SILENT-Hàng chính hãng",397000,397000,0,0
TIKI,thiet-bi-kts-phu-kien-so,71291990,"Giá Đỡ Laptop Nhôm Gấp Gọn, Laptop Stand Dùng Cho Máy Từ 11~17 inch, Có Thể Điều Chỉnh Nhiều Mức Độ Cao, Chất Liệu Hợp Kim Nhôm Cao Cấp",65800,65800,0,0
TIKI,thiet-bi-kts-phu-kien-so,195977274,"Bàn phím cơ gaming 5TECH Led RGB 10 chế độ nháy cực đẹp, chơi game gõ siêu đã, thiết kế nhỏ gọn dùng cho máy tính, laptop hàng chính hãng",449000,449000,0,0
TIKI,thiet-bi-kts-phu-kien-so,135716055,"Ốp da cao cấp dành cho iPhone 13 / 13 Pro / 13 Pro Max / 13 Mini - Hàng chính hãng",149000,250000,101000,40
TIKI,thiet-bi-kts-phu-kien-so,4539349,"Bộ Vệ Sinh Laptop ",19000,19000,0,0
TIKI,thiet-bi-kts-phu-kien-so,113568856,"Tai nghe chụp tai không dây Remax RB-660HB - Hàng chính hãng",563500,700000,136500,20
TIKI,thiet-bi-kts-phu-kien-so,273908702,"Bộ sạc nhanh IP công suất 20W chuẩn PD iCybernet IC-3001 (C to L cho IP14 trở xuống) - Hàng chính hãng",192000,300000,108000,36
TIKI,thiet-bi-kts-phu-kien-so,273908828,"Bộ sạc nhanh IP, Android chuẩn PD 20W iCybernet IC-3002 cáp C to C 1,2m (Cáp hỗ trợ sạc tối đa 100W cho mọi thiết bị typeC) - Hàng chính hãng",192000,300000,108000,36
TIKI,thiet-bi-kts-phu-kien-so,273908414,"Cáp sạc nhanh IP chuẩn PD 20W iCybernet IC-1003 TypeC to IP chiều dài 1,2m - Hàng chính hãng",98000,150000,52000,35
TIKI,thiet-bi-kts-phu-kien-so,273906522,"Cáp sạc USB to IP iCybernet IC-1001 sạc 2.4A và truyền dữ liệu đồng thời, chiều dài 1,2m - Hàng chính hãng",58000,100000,42000,42
TIKI,thiet-bi-kts-phu-kien-so,181772131,"Tai Nghe Bluetooth Chụp Tai Sony WH-1000XM5 Hi-Res Noise Canceling - Hàng Chính Hãng",6890000,7990000,1100000,14
TIKI,thiet-bi-kts-phu-kien-so,161007768,"Ốp lưng dẻo mỏng dành cho iPhone 11 / 12 / 13 / 11 Pro / 12 Pro / 13 Pro / 11 Pro Max / 12 Pro Max / 13 Pro Max / 12 Mini / 13 Mini - Hàng chính hãng",49000,69000,20000,29
TIKI,thiet-bi-kts-phu-kien-so,15251528,"Đầu Chuyển HDMI ra VGA",25300,25300,0,0
TIKI,thiet-bi-kts-phu-kien-so,273891515,"Cáp sạc siêu nhanh PD 100W iCybernet IC-1004 C to C chiều dài 1m - Hàng chính hãng",98000,150000,52000,35
TIKI,thiet-bi-kts-phu-kien-so,855600,"Tai Nghe Nhét Tai Sony MDR-EX155AP",350000,390000,40000,10
TIKI,thiet-bi-kts-phu-kien-so,176752662,"Kính Cường Lực Kingkong iPhone, Màn Nhám Chống Vân Tay Dành Cho Game Thủ - Full Hộp - Hàng Chính Hãng",88000,135000,47000,35
TIKI,thiet-bi-kts-phu-kien-so,272913331,"Thiết bị theo dõi thông minh Samsung Galaxy SmartTag2-Hàng Chính hãng",355000,355000,0,0
TIKI,thiet-bi-kts-phu-kien-so,56608719,"Chuột không dây Bluetooth  HXSJ M90 - Hàng chính hãng",139000,168000,29000,17
TIKI,thiet-bi-kts-phu-kien-so,125781,"Tai Nghe Nhét Tai Sony Fontopia MDR-E9LP",143000,159000,16000,10
TIKI,thiet-bi-kts-phu-kien-so,273906695,"Cáp sạc và truyền dữ liệu 2.4A iCybernet IC-1002 USB to TypeC - Hàng chính hãng",58000,100000,42000,42
TIKI,thiet-bi-kts-phu-kien-so,170273830,"Thẻ nhớ Micro SD Hikvision 32GB 64GB 128GB Class 10 tốc độ 92MB/s - Hàng chính hãng",120000,160000,40000,25
TIKI,thiet-bi-kts-phu-kien-so,102391960,"Giá Đỡ Máy Tính, Laptop, iPad, Macbook Hợp Kim Nhôm Cao Cấp. Hỗ Trợ Tản Nhiệt Chống Mỏi Cổ, Vai, Gáy. Hàng Chính Hãng Tamayoko",450000,500000,50000,10
TIKI,thiet-bi-kts-phu-kien-so,216238849,"Bộ sạc nhanh cho IP công suất 18W Remax RP-U37 - Hàng chính hãng",249000,300000,51000,17
TIKI,thiet-bi-kts-phu-kien-so,13119283,"Bút Cảm Ứng Dành  Cho SMARTPHONE VÀ IPAD -Giao  Màu  Ngẩu Nhiên",6430,8788,2358,27
TIKI,thiet-bi-kts-phu-kien-so,73324095,"Bộ điều khiển thông minh Google Chromecast with Google TV - Hàng Nhập Khẩu",1300000,1610000,310000,19
TIKI,thiet-bi-kts-phu-kien-so,123843835,"Cây chọt sim điện thoại, que chọc sim để sau ốp lưng dành cho iphone 5/5s/6/6plus/6s/6s plus/6/7/7plus/8/8plus/x/xs/xs max",3900,3900,0,0
TIKI,thiet-bi-kts-phu-kien-so,56049649,"CỐC SẠC NHANH 15W 2 CỔNG CHỐNG CHÁY NỔ HOCO C73 - CỦ SẠC ĐA NĂNG 2.4A CHO CÁC DÒNG ĐIỆN THOẠI CHÍNH HÃNG",69000,119000,50000,42
TIKI,thiet-bi-kts-phu-kien-so,251518071,"Cáp sạc nhanh chuẩn PD 20W cho IP Remax RC-183i chiều dài 2m - Hàng chính hãng",144550,200000,55450,28
TIKI,thiet-bi-kts-phu-kien-so,179541784,"Cáp sạc nhanh siêu bền C to IP Baseus Dynamic Series FAST CHARGING DATA CABLE 20W dùng cho IP 13,12,... - Hàng chính hãng",101000,159000,58000,36
TIKI,thiet-bi-kts-phu-kien-so,97547734,"Giá Đỡ Để Bàn Điện Thoại Di Động, Máy Tính Bảng, Ipad Hợp Kim Nhôm Cao Cấp Hai Trục Xoay 180 Độ Chống Đổ Hàng Chính Hãng Tamayoko",390000,450000,60000,13
TIKI,thiet-bi-kts-phu-kien-so,154835064,"Đồng hồ Thông minh Trẻ em AMA Watch Q15 lắp SIM nghe gọi 2 chiều 3 màu Xanh Hồng Đen Hàng chinh hãng",400000,400000,0,0
TIKI,thiet-bi-kts-phu-kien-so,72796676,"Giá Đỡ Laptop Hợp Kim Nhôm Cao Cấp Có Thể Gấp Gọn, Giúp Tản Nhiệt Laptop, Macbook, Máy Tính Xách Tay. 07 Vị Trí Điều Chỉnh Góc Độ. Hàng Chính Hãng Tamayoko FS060",199000,229000,30000,13
TIKI,thiet-bi-kts-phu-kien-so,63912442,"Giá Đỡ Điện Thoại Gấp Gọn, Tùy Chỉnh Độ Cao - DT056",16676,16676,0,0
TIKI,thiet-bi-kts-phu-kien-so,76067387,"Đầu đọc thẻ nhớ 2.0 Hoco HB20 Mindful - hỗ trợ khe microSD/SD (Hàng chính hãng)",79000,79000,0,0
TIKI,thiet-bi-kts-phu-kien-so,113568856,"Tai nghe chụp tai không dây Remax RB-660HB - Hàng chính hãng",563500,700000,136500,20
TIKI,thiet-bi-kts-phu-kien-so,35420153,"Cáp sạc nhanh, truyền dữ liệu tốc độ cao Baseus Cafule Type C cho Samsung S8/S9/ Note8/ Note9/ Xiaomi/ Huawei/ Oppo/Nokia ( 3A, Sạc nhanh Quick charge 3.0, Siêu bền)- Hàng nhập khẩu",87000,159000,72000,45
TIKI,thiet-bi-kts-phu-kien-so,359484,"Bàn phím có dây Logitech K120 - Hàng chính hãng",146000,179000,33000,18
TIKI,thiet-bi-kts-phu-kien-so,49658272,"Đen - Dây cáp sạc nhanh Type-C dài 2M hiệu Baseus Cafule Type C to Type C PD truyền data tốc độ cao  cho Smartphone / Tablet / Macbook / Laptop Type C Samsung Huawei Oppo Xiaomi (3A, 60W, Sạc nhanh PD, Sạc nhanh QC 4.0 Quick Charge)-Hàng nhập khẩu",93000,109000,16000,15
TIKI,thiet-bi-kts-phu-kien-so,127695415,"Loa Bluetooth HXSJ V6 Bản Mở Rộng Hỗ Trợ Kết Nối Bluetooth 5.0, Thẻ Nhớ, USB, Công suất 2 loa 10W Nhiều Màu Sắc - Hàng chính hãng",349000,689000,340000,49
TIKI,thiet-bi-kts-phu-kien-so,192977208,"Đồng hồ Thông minh Chống nước IP67 Dành cho Trẻ em nhuẩn AMA Watch Q16S Hàng chính hãng",395000,395000,0,0
TIKI,thiet-bi-kts-phu-kien-so,167528098,"HUB TYPE C Và HUB USB 3.0 Tốc Độ Cao Chia 4 Cổng VinBuy, HUB Chuyển Đổi Dành Cho Macbook Pro Laptop PC Hỗ Trợ Sạc Pin Kết Nối Đa Năng Ổ Cứng Bàn Phím Chuột Máy In, Thiết Bị Ổ Chia USB - Hàng Chính Hãng",88000,300000,212000,71
TIKI,thiet-bi-kts-phu-kien-so,107067035,"Thẻ Nhớ SanDisk Ultra MicroSDXC UHS-1 100 MB/s Class 10 32GB/64GB/128GB - Hàng Chính Hãng",110000,141000,31000,22
TIKI,thiet-bi-kts-phu-kien-so,78010530,"Adapter Củ Sạc CHOETECH PD5005 PD 20W Chuyên Sạc Nhanh iPhone, iPad - Hàng Chính Hãng",199000,390000,191000,49
TIKI,thiet-bi-kts-phu-kien-so,67517393,"Thẻ Nhớ Camera Hikvision 64Gb Class 10 ( Chuyên dùng cho Camera IP ) - Hàng Chính hãng",84000,84000,0,0
TIKI,thiet-bi-kts-phu-kien-so,67907870,"Chuột Bluetooth Silent Logitech Pebble M350 - Hàng chính hãng",418000,599000,181000,30
TIKI,thiet-bi-kts-phu-kien-so,195305655,"Adapter Sạc ANKER 511 Nano Pro 20W Type-C Sạc Nhanh Tích Hợp PIQ 3.0 A2637 Tương Thích iPhone 13 series và iPhone 12 series, Galaxy, Pixel 4/3, iPad / iPad mini - Hàng Chính Hãng",250000,450000,200000,44
TIKI,thiet-bi-kts-phu-kien-so,111978854,"Hub Chuyển Đổi USB Type C to HDMI CHOETECH HUB-H10 Độ Phân Giải 4K 60Hz, 1080P Cho Tivi/Laptop/Playstation/PC - Hàng Chính Hãng",299000,590000,291000,49
TIKI,thiet-bi-kts-phu-kien-so,80857582,"Kính Cường Lực Chống Nhìn Trộm KingKong Dành Cho iPhone - Full Hộp - Dán Full Màn - Hàng Chính Hãng ",34000,34000,0,0
TIKI,thiet-bi-kts-phu-kien-so,145495427,"Thẻ Nhớ Lexar MICRO 633X Tốc Độ 100mb/s - Hàng Chính Hãng",88000,88000,0,0
TIKI,thiet-bi-kts-phu-kien-so,112087792,"Thẻ nhớ chuyên camera Mirco SD HIKVISION  64G - 32GB - 92MB/s, chuyên ghi hình cho camera, máy ảnh, ... Hàng nhập khẩu",71900,71900,0,0
TIKI,thiet-bi-kts-phu-kien-so,125652874,"Combo củ cáp sạc nhanh chuẩn PD 20W cho IP12,IP13 Remax RPU88i-RC188i- Hàng chính hãng",450000,500000,50000,10
TIKI,thiet-bi-kts-phu-kien-so,112287571,"Đồng Hồ Thông Minh cho Trẻ em 6 tuổi, 7 tuổi, 8 tuổi, 9 tuổi, 10 tuổi, 11 tuổi Lắp Sim Độc lập nghe gọi 2 chiều AMA Watch Y92 Chống nước Định vị Wifi độ chính xác cao Hàng nhập khẩu",577000,577000,0,0
TIKI,thiet-bi-kts-phu-kien-so,88796437,"Dây Cáp Nối Dài Âm Thanh 2 Đầu Đực 3.5mm Dài 1.2M CHOETECH AUX002 - Hàng Chính Hãng",99000,150000,51000,34
TIKI,thiet-bi-kts-phu-kien-so,128678712,"Apple Watch Series 7 GPS Sport Band (Viền Nhôm, Dây Cao Su)",7890000,12990000,5100000,39
TIKI,thiet-bi-kts-phu-kien-so,95085073,"Dây Cáp Chuyển Đổi USB Type C To HDMI 4K 60Hz Dài 1.8M CHOETECH CH0019 - Hàng Chính Hãng",369000,590000,221000,37
TIKI,thiet-bi-kts-phu-kien-so,194458001,"Tai nghe bluetooth nhét tai chống ồn cao cấp V5.3 chính hãng dùng cho iPhone Samsung OPPO VIVO HUAWEI XIAOMI tai nghe không dây - Hàng Chính Hãng PKCB",313000,500000,187000,37
TIKI,thiet-bi-kts-phu-kien-so,189474023,"Sạc dự phòng không dây từ tính Remax RPP-65 10000mAh - Hàng chính hãng",753500,990000,236500,24
TIKI,thiet-bi-kts-phu-kien-so,191502436,"Dây Đeo Thay Thế Viền Dành Cho Vòng Đeo Tay Thông Minh Xiaomi Mi Band 5/ Miband 6 - Hàng chính hãng",42000,45000,3000,7
TIKI,thiet-bi-kts-phu-kien-so,133637826,"CÂY CHỌC SIM ĐIỆN INOX - QUE CHỌC SIM INOX HÌNH GIỌT NƯỚC",1000,3000,2000,67
TIKI,thiet-bi-kts-phu-kien-so,1517005,"Thẻ Nhớ Micro SDHC SanDisk UHS-1 32GB Class 10 - Hàng Chính Hãng",108000,108000,0,0
TIKI,thiet-bi-kts-phu-kien-so,74343712,"Dây Nguồn Laptop 1.5m",18945,37890,18945,50
TIKI,thiet-bi-kts-phu-kien-so,87106876,"Dây Cáp Sạc Nhanh USB Type C to Type C 100W Dài 1.8M Chuyên Sạc iPhone 15, Macbook, Laptop, Smartphone CHOETECH XCC-1002-GY - Hàng Chính Hãng",189000,280000,91000,33
TIKI,thiet-bi-kts-phu-kien-so,56885648,"Đầu Chuyển Đổi USB Type C Sang USB 3.0 Hàng Chính Hãng Helios",59000,59000,0,0
TIKI,thiet-bi-kts-phu-kien-so,68985833,"Dây sạc Cáp sạc Nam châm Đồng hồ Thông minh Q12, Q16, Q19, Q100, TD26, A28, DS60, DS66, Y95, D06, DF39 Hàng nhập khẩu",57000,57000,0,0
TIKI,thiet-bi-kts-phu-kien-so,188998014,"Ốp Bảo Vệ Chống Sốc Armor TPU PC Cho Airpods 1,2 / Airpods 3/ Airpods Pro/ Airpods Pro 2 Kèm Móc Treo- Hàng Chính Hãng",99000,99000,0,0
TIKI,thiet-bi-kts-phu-kien-so,52945747,"Giá đỡ laptop nhôm có thể gấp gọn dành cho Macbook Ipad Surface và máy tính xách tay",109000,109000,0,0
TIKI,thiet-bi-kts-phu-kien-so,201437397,"Giá Đỡ Laptop Hợp Kim Nhôm Cao Cấp Dễ Dàng Gấp Gọn, Giúp Tản Nhiệt Laptop, Máy Tính Xách Tay - 07 Nấc Điều Chỉnh Góc Độ. Hàng Chính Hãng Tamayoko",160000,160000,0,0
TIKI,thiet-bi-kts-phu-kien-so,637038,"Chuột Có Dây Dell MS116 (Đen) - Hàng Chính Hãng",82000,82000,0,0
TIKI,thiet-bi-kts-phu-kien-so,191684818,"Tai Nghe Bluetooth True Wireless AMOI F9 Cảm Ứng Vân Tay, Nâng Cấp Dock Sạc có Led Báo Pin Kép - Hàng Nhập Khẩu",89000,94000,5000,5
TIKI,thiet-bi-kts-phu-kien-so,195300861,"Cáp ANKER Powerline III Flow USB-C To USB-C - A8552 / A8553 - Siêu Mềm Mại và Bền Bỉ - Hàng Chính Hãng",180000,300000,120000,40
TIKI,thiet-bi-kts-phu-kien-so,102391960,"Giá Đỡ Máy Tính, Laptop, iPad, Macbook Hợp Kim Nhôm Cao Cấp. Hỗ Trợ Tản Nhiệt Chống Mỏi Cổ, Vai, Gáy. Hàng Chính Hãng Tamayoko",450000,500000,50000,10
TIKI,thiet-bi-kts-phu-kien-so,107071890,"Miếng Kê tay, Thanh Kê Tay Bàn Phím Cực Dễ Thương Nhiểu Mẫu Mới_ Hàng Chính Hãng",136843,144045,7202,5
TIKI,thiet-bi-kts-phu-kien-so,87675294,"Đồng Hồ Thông Minh Trẻ Em Chống Nước Chuẩn IP67 AMA Watch Q12 Hàng nhập khẩu",280000,280000,0,0
TIKI,thiet-bi-kts-phu-kien-so,201437484,"Giá Đỡ Máy Tính, Laptop, iPad, Macbook Hợp Kim Nhôm Cao Cấp. Hỗ Trợ Tản Nhiệt Chống Mỏi Cổ, Vai, Gáy. Hàng Chính Hãng Tamayoko",489000,489000,0,0
TIKI,thiet-bi-kts-phu-kien-so,169196334,"Bàn Di Chuột Cỡ Lớn 30-80cm,Pad Chuột,Lót Chuột Phím Tắt Văn Phòng Cao Cấp - Bàn Di Công Thức",39000,39000,0,0
TIKI,thiet-bi-kts-phu-kien-so,91013563,"Remote Quạt Senko Điều Khiển (Tất Cả Các Loại như TR1683, DR1608, TR1628, DH1600) Hàng Chính Hãng",70000,70000,0,0
TIKI,thiet-bi-kts-phu-kien-so,195277333,"Ốp lưng dẻo cho iPhone 8 / SE 2020 / 8 Plus / X / XS / XR / XS Max / 11 / 11 Pro / 11 Pro Max / 12 / 12 Pro / 12 Pro Max / 12 Mini / 13 / 13 Pro / 13 Pro Max / 13 Mini / 14 / 14 Pro / 14 Pro Max / 14 Max -Hàng chính hãng-Photodesign VN",149000,250000,101000,40
TIKI,thiet-bi-kts-phu-kien-so,192364741,"Miếng Lót Chuột ,Bàn Di Chuột Huqu -Chất Liệu Sợi Fiber -Hàng Chính Hãng ",28500,30000,1500,5
TIKI,thiet-bi-kts-phu-kien-so,24865067,"Bút laser trình chiếu Slide VSON N35 - Hàng nhập khẩu",172000,172000,0,0
TIKI,thiet-bi-kts-phu-kien-so,199165708,"Giá đỡ laptop tuỳ chỉnh góc nghiêng để phù hợp góc nhìn của bạn chất liệu hợp kim nhôm, hỗ trợ tản nhiệt tốt cho máy tính laptop, macbook và máy tính bảng",109000,109000,0,0
TIKI,thiet-bi-kts-phu-kien-so,117635957,"Cáp sạc siêu nhanh công suất tối đa 100W chuẩn PD Remax Lesu Pro typeC to typeC RC-187c - Hàng chính hãng",144550,200000,55450,28
TIKI,thiet-bi-kts-phu-kien-so,88796298,"Dây Cáp Nối Dài Âm Thanh 3.5mm Dài 2M CHOETECH AUX001-BK - Hàng Chính Hãng",99000,150000,51000,34
TIKI,thiet-bi-kts-phu-kien-so,53547831,"Lót chuột  siêu bền 26x21 cm - Hàng chính hãng",19000,19000,0,0
TIKI,thiet-bi-kts-phu-kien-so,895314,"Tai Nghe Nhét Tai Langsdom Super Bass JM26",45000,50000,5000,10
TIKI,thiet-bi-kts-phu-kien-so,111983048,"Dây Cáp HDMI 2.1 CHOETECH XHH03-BK Dài 2M Phân Giải Tối Đa 8K 48Gbps, 4K 120Hz Dùng Cho Tivi/Laptop/Playstation/PC - Hàng Chính Hãng",179000,260000,81000,31
TIKI,thiet-bi-kts-phu-kien-so,72540740,"Ốp lưng dẻo thoát nhiệt dành cho iPhone 11 PRO MAX - Đen - Hàng chính hãng",49000,69000,20000,29
TIKI,thiet-bi-kts-phu-kien-so,126032985,"Ốp Lưng Trong Suốt MIPOW TEMPERED GLASS Dành Cho iPhone 13 Mini, Iphone 13/ 13 Pro, 13 Pro Max - Hàng Chính Hãng",68000,290000,222000,77
TIKI,thiet-bi-kts-phu-kien-so,111484548,"Dây cáp VGA 1.5M Đen chống nhiễu loại cực tốt",19470,19470,0,0
TIKI,thiet-bi-kts-phu-kien-so,132144149,"Cường Lực Chống Nhìn Trộm KingKong Dành Cho iPhone X-XS, XS Max, iPhone 11, 11Pro, 11ProMax, iPhone 12, 12Mini, 12Pro, 12Pro Max, iPhone 13, 13Mini, 13Pro, 13Pro Max - Dán Full Màn - Hàng Chính Hãng",35000,35000,0,0
TIKI,thiet-bi-kts-phu-kien-so,116783441,"5in1 - Bộ vệ sinh Laptop, Macbook, Máy ảnh Cao Cấp - Hàng Nhập Khẩu - Chính Hãng JRC",228800,228800,0,0
TIKI,thiet-bi-kts-phu-kien-so,104268199,"Chuột không dây kiểu đứng sạc pin HXSJ T22 wireless USB 2.4GHz chống mỏi tay chuyên dùng cho pc laptop macbook ipad tivi - Hàng chính hãng",349000,599000,250000,42
TIKI,thiet-bi-kts-phu-kien-so,360660,"Bộ Bàn Phím Và Chuột Logitech MK220 Không Dây - Hàng chính hãng",419000,419000,0,0
TIKI,thiet-bi-kts-phu-kien-so,117987260,"Loa Máy Tính Doron V-196 - Âm Thanh Siêu Trầm 4D, Bass Êm - Hàng Chính Hãng",190000,190000,0,0
TIKI,thiet-bi-kts-phu-kien-so,110169574,"Thảm Lót Chuột Cỡ Lớn, Dùng Được Hai Mặt - Da PU Chống Nước - Doron HD01 - Kiêm Deskpad Thảm Da, Trải Bàn Làm Việc - Hàng Nhập Khẩu",79000,79000,0,0
TIKI,thiet-bi-kts-phu-kien-so,26029929,"Bàn di,tấm lót chuột chơi game Mouse pad",11900,11900,0,0
TIKI,thiet-bi-kts-phu-kien-so,122158068,"Tẩu sạc nhanh 20W trên xe hơi ô tô HOCO Z42 PD QC 3.0 Dành cho điện thoại iPhone iP Samsung Oppo cốc củ cóc sạc oto  - Hàng chính hãng",159000,159000,0,0
TIKI,thiet-bi-kts-phu-kien-so,135410778,"Ốp Lưng Trong Suốt Hoco Dành Cho iPhone - Hàng Chính Hãng ",86000,86000,0,0
TIKI,thiet-bi-kts-phu-kien-so,53977774,"Phụ kiện giữ dây cáp sạc Giá Silicon mini cố định dây cáp sạc cho các thiết bị điện tử trên bàn làm việc - Hàng Chính Hãng",20000,69000,49000,71
TIKI,thiet-bi-kts-phu-kien-so,107338360,"Bàn Di Chuột - Miếng Lót Chuột Cỡ Lớn Doron-HDC01 Size 40x80, 45x90 cm - Kiêm Deskpad Thảm Da, Trải Bàn Làm Việc Chống Nước Dùng Được Hai Mặt - Hàng Nhập Khẩu",99000,99000,0,0
TIKI,thiet-bi-kts-phu-kien-so,193209851,"Pin Sạc Dự Phòng 20000mAh Sạc Nhanh PD 20W QC 18W RAVPower RP-PB1205 - Hàng Chính Hãng",699000,1190000,491000,41
TIKI,do-choi-me-be,270796181,"Vitamin tổng hợp cho trẻ L'il Critters Gummy Vites Daily Mỹ chứa vitamin và khoáng chất hỗ trợ miễn dịch, mắt, chống oxy hóa và tăng sức khỏe tổng thể - QuaTangMe Extaste",593000,1186000,593000,50
TIKI,do-choi-me-be,171153525,"Hộp 6 bộ đồ chơi lắp ráp Robot biến hình - Thiết bị quân sự Qman 1412",329000,359000,30000,8
TIKI,do-choi-me-be,129710218,"HOT: Chó Shiba XẢ STRESS - Chó Shiba silicon co dãn, dẻo, đàn hồi ngộ nghĩnh, giải tỏa căng thẳng, xả STRESS",20000,20000,0,0
TIKI,do-choi-me-be,126243917,"Chậu Xông Vùng Kín Sau Sinh, Chậu xông hơi vùng kín Gấp Gọn, gắn bồn cầu, bô xông vùng kín Tiện Lợi kèm Vòi xịt phụ khoa",83900,83900,0,0
TIKI,do-choi-me-be,118494409,"Siro Uống Nature's Way Kids Smart Drops DHA Dạng Giọt Giúp Tăng IQ, Phát Triển Não Bộ Cho Bé 20ml",350000,350000,0,0
TIKI,do-choi-me-be,95035825,"Bột ăn dặm dinh dưỡng Ngũ cốc bắp non HiPP Organic 200g",135000,135000,0,0
TIKI,do-choi-me-be,2173351,"Combo 3 Bịch Khăn Vải Khô Likado (300g)",109000,120000,11000,9
TIKI,do-choi-me-be,133545034,"Combo 6 Gói Khăn Ướt Yuniku 90 Tờ Hương Lài ( 90 Tờ x 6 )",145000,250800,105800,42
TIKI,do-choi-me-be,105219052,"Mút Cao Su Dán, Bọc Cạnh, Góc Bàn An Toàn Cho Bé - KUB",74000,74000,0,0
TIKI,do-choi-me-be,191678954,"Đèn lồng trung thu hình thú phát sáng, Đèn led phát sáng vui nhộn",33377,33377,0,0
TIKI,do-choi-me-be,42411606,"Cuộn bọc cạnh bàn ghế, cạnh tủ cao su non bảo vệ an toàn cho bé vui chơi trong nhà (2 mét) tặng kèm băng dính -giao màu ngẫu nhiên",31998,31998,0,0
TIKI,do-choi-me-be,177751108,"MÁY HÚT SỮA ĐIỆN ĐÔI FATZ BABY - CHORUS 2 - FB1182MX",666000,666000,0,0
TIKI,do-choi-me-be,129665688,"(HCM) Tấm đệm lót người già Caryn khổ lớn 60x70cm gói 14 miếng",98000,98000,0,0
TIKI,do-choi-me-be,58141815,"Bột Thông Tắc Cống, Đường Ống - EcoSock Hộp 0.5Kg - Hàng Chính Hãng Từ Mỹ",362000,362000,0,0
TIKI,do-choi-me-be,59049510,"Chất thông tắc Cống và Cầu Sifa chống hôi Siêu nhanh siêu mạnh 5 phút 425ml cao cấp",50000,50000,0,0
TIKI,do-choi-me-be,168160974,"Khăn Lau Hạ Sốt 0+ Dr.Papie Cho Bé Hạ Nhiệt Giảm Sốt Ngăn Ngừa Co Giật",185000,185000,0,0
TIKI,do-choi-me-be,75996180,"Đồ chơi lò xo cầu vồng ma thuật bằng nhựa (đường kính 7 cm)",15600,15600,0,0
TIKI,do-choi-me-be,17702472,"4 Bịch Khăn vải khô đa năng LIKADO 400g (20 x 22cm)",220000,240000,20000,8
TIKI,do-choi-me-be,94728752,"Đồ chơi giáo dục sớm thả hình khối có quai xách cho bé Toyshouse 0702-TH-HE0218",139000,160000,21000,13
TIKI,do-choi-me-be,55461311,"Tinh dầu tràm Huế Kim Vui 125ml - Tinh dầu dùng cho trẻ sơ sinh",190000,190000,0,0
TIKI,do-choi-me-be,197329427,"Cuộn 2m Mút Xốp Bọc Cạnh Bàn Ghế Giường Tủ Bảo Vệ An Toàn Cho Bé",65000,65000,0,0
TIKI,do-choi-me-be,48184895,"Dung dịch tẩy rửa máy rửa chén Finish Dishwasher Cleaner Lemon 2x250ml QT04441 - hương chanh",179000,179000,0,0
TIKI,do-choi-me-be,102262521,"Phao bơi chống lật Swim Bobo cho bé từ 1 tuổi đến 5 tuổi",319000,346020,27020,8
TIKI,nha-sach-tiki,173093879,"Liễu Phàm Tứ Huấn - Tích Tập Phúc Đức, Cải Tạo Vận Mênh (Tái Bản 2022)",45500,59000,13500,23
TIKI,do-choi-me-be,56815790,"Bộ tranh xếp hình 150 mảnh – Totoro",45000,65000,20000,31
TIKI,do-choi-me-be,70839639,"Bàn Tỷ Phú Lớn",115000,115000,0,0
TIKI,nha-sach-tiki,62373311,"Nồi Niêu Xoong Chảo - Sổ Tay Bếp Núc Của Tôi (Sách Màu)",93000,120000,27000,23
TIKI,nha-sach-tiki,105614631,"Kéo mini tiện lợi 105mm Deli - 5 màu Đen/ Xanh/ Hồng/ Trắng - Dành cho văn phòng, học sinh, sắc bén - 6072",45000,45000,0,0
TIKI,do-choi-me-be,72577100,"03 bộ tranh xếp hình 70 mảnh ghép khổ A3 – đồ chơi trí tuệ cho bé từ 3 tuổi – Combo 1 (Giao mẫu ngẫu nhiên)",85000,110000,25000,23
TIKI,nha-sach-tiki,192333857,"Ông già và biển cả",131000,200000,69000,35
TIKI,nha-sach-tiki,43665704,"Combo Chiến thắng kì thi 9 vào 10 chuyên môn Vật Lí( Tập 1 - Tập 2)",206000,358000,152000,42
TIKI,nha-sach-tiki,2583037,"Series Địch Công Kỳ Án: Ngự Châu Án",46000,99000,53000,54
TIKI,do-choi-me-be,134440669,"Ghế ăn dặm gấp gọn cao cấp Umoo mới nhất 2021, có bánh xe và điều chỉnh được độ cao",647000,699999,52999,8
TIKI,nha-sach-tiki,11475738,"Combo 2 Cuốn: Kế Toán Tài Chính (Tập 1 & 2)",495000,750000,255000,34
TIKI,do-choi-me-be,107972572,"Bình sữa mô phỏng tự nhiên hiệu Philips Avent (125 ml - đơn) cho trẻ từ 0 tháng tuổi 690.13",285000,285000,0,0
TIKI,nha-sach-tiki,91625816,"Trên Đỉnh Phố Wall (Tái bản 2021)",139000,219000,80000,37
TIKI,do-choi-me-be,90584712,"Bệ Thu Nhỏ Bồn Cầu Cho Bé - Nhựa PVC Cao Cấp",179000,179000,0,0
TIKI,nha-sach-tiki,73176340,"Combo 10 cuốn Truyện Ngụ ngôn Aesop Song ngữ - Truyện kể mầm non (giao ngẫu nhiên)",62400,120000,57600,48
TIKI,nha-sach-tiki,170352757,"Người Sống Cũng Phải Hồi Sinh",89100,129000,39900,31
TIKI,do-choi-me-be,174624883,"Giấy vệ sinh 3 lớp cao cấp có lõi JAPANI SILK | Thế Giới Giấy | 100% bột giấy nguyên sinh | 10 cuộn",64000,86000,22000,26
TIKI,do-choi-me-be,165846177,"XE ĐẨY GẤP GỌN CHO BÉ HAKAWA HK-B07 - HÀNG CHÍNH HÃNG",1200000,1200000,0,0
TIKI,do-choi-me-be,49498423,"Combo 2 bịch bỉm/tã quần cao cấp MIJUKU - M",335000,335000,0,0
TIKI,do-choi-me-be,127993576,"Đồ Chơi Gỗ Cao Cấp Hộp thả hình, đồ chơi gỗ thông minh - hàng chính hãng",134640,136000,1360,1
TIKI,nha-sach-tiki,53974339,"Combo 3 Cuốn Di Sản Của GS. Phan Văn Trường Để Lại Cho Thế Hệ Sau: Một Đời Thương Thuyết + Một Đời Quản Trị + Một Đời Như Kẻ Tìm Đường (Cả Đời Trên Thương Trường)",431950,431950,0,0
TIKI,do-choi-me-be,730491,"Nước Rửa Bình Thảo Mộc Arau Baby Dạng Túi (450ml)",109650,129000,19350,15
TIKI,nha-sach-tiki,5743619,"Học Tiếng Anh Siêu Thú Vị : Sách Luyện - Tập 2",13000,24000,11000,46
TIKI,nha-sach-tiki,44911496,"Little Stories - The Best Book For Your Leisure Time",41800,65000,23200,36
TIKI,do-choi-me-be,3525963,"Đồ Chơi Bé Trai, Đồ Chơi Dụng Cụ Sửa Chữa Cơ Khí Toyshouse",170000,170000,0,0
TIKI,do-choi-me-be,74850451,"Đồ chơi mô hình xe ô tô cảnh sát chạy pin, nhựa nguyên sinh an toàn, chạy rất nhanh và xa",36000,36000,0,0
TIKI,nha-sach-tiki,1205103,"Free Marketing  –  101 Ý Tưởng Phát Triển Doanh Nghiệp Với Chi Phí Thấp (Tái Bản 2017)",135400,199000,63600,32
TIKI,nha-sach-tiki,27639420,"Toán Song Ngữ Tiền Tiểu Học - Sách Học 2",32400,36000,3600,10
TIKI,nha-sach-tiki,173718231,"Combo 2 Cuốn Luyện viết Lớp 1 - Chương trình SGK Cánh diều",31200,60000,28800,48
TIKI,nha-sach-tiki,34750208,"Ngụ Ngôn Song Ngữ Anh - Việt: Con Quạ Thông Minh (Tái Bản 2019)",16800,28000,11200,40
TIKI,nha-sach-tiki,66398385,"Hành Trình Sinh Tử",75800,109000,33200,30
TIKI,nha-sach-tiki,27639410,"Toán Song Ngữ Tiền Tiểu Học - Sách Học 3",28100,36000,7900,22
TIKI,nha-sach-tiki,52805069,"Những Vị Thần Bắc Âu",122000,175000,53000,30
TIKI,do-choi-me-be,116572109,"Combo 3 Trà cốm lợi sữa hoà tan HiPP Mama Herbal Nursing Tea 100% thảo mộc, dành cho mẹ sau sinh và đang cho con bú giúp bồi bổ cơ thể, hỗ trợ và tăng cường lượng sữa (2 hộp x 200g)",525000,525000,0,0
TIKI,do-choi-me-be,95035851,"Trà cốm lợi sữa HiPP dành cho phụ nữ cho con bú 200g",175000,175000,0,0
TIKI,nha-sach-tiki,193895765,"Lập Kế Hoạch Công Việc chu Trình PDCA (Tái Bản)",103700,149000,45300,30
TIKI,nha-sach-tiki,31993279,"4000 Từ Vựng Tiếng Anh Thường Dùng Nhất (Kèm CD Hoặc File MP3)",186000,248000,62000,25
TIKI,nha-sach-tiki,19662170,"Tên Tôi Là Đỏ (Tái Bản 2019)",114000,155000,41000,26
TIKI,nha-sach-tiki,191571444,"Anh Em Phi Hành Gia - Tập 30",44500,45000,500,1
TIKI,do-choi-me-be,147588060,"Bộ Bài Tây Poker Mạ Si Vàng 24K Cao Cấp Phủ Nhũ Vàng Chính Hãng Dododios – Bộ 54 Lá Bài Tây Pocker Nhựa Dẻo Chống Thấm Nước Chống Gãy",29000,29000,0,0
TIKI,do-choi-me-be,74769754,"Đồ chơi mô hình xe trộn bê tông KAVY NO.8809 chất liệu hợp kim và nhựa nguyên sinh an toàn, chi tiết sắc sảo",68000,68000,0,0
TIKI,nha-sach-tiki,176132390,"Truyện Thiếu Nhi Hạt Giống Tâm Hồn - Lễ Tạ Ơn",43100,56000,12900,23
TIKI,nha-sach-tiki,189940682,"Hãy Sống Cuộc Đời Như Bạn Muốn  (Tái bản)",69420,99000,29580,30
TIKI,nha-sach-tiki,136939563,"Ho’Oopnopono: Phục Hồi Tự Nhiên, Chữa Lành Cuộc Sống, Hoàn Thiện Cuộc Đời",46100,66000,19900,30
TIKI,nha-sach-tiki,185415267,"Bút gel B màu Pastel Thiên Long Flexoffice Pazto FO-GELB039/VN - Mực xanh (5 cây)",41000,50000,9000,18
TIKI,nha-sach-tiki,90480255,"Sách - Lão Tử Đạo Đức kinh - Nguyễn Hiến Lê ( Tuyển Tập Bách Gia Tranh Minh)",112000,159000,47000,30
TIKI,nha-sach-tiki,1750249,"Phân Tích Chứng Khoán",301400,499000,197600,40
TIKI,nha-sach-tiki,194959710,"Đâu Chỉ Độc Mình Tôi Đơn Độc",68000,88000,20000,23
TIKI,nha-sach-tiki,13362558,"Làm sạch tâm hồn - Các bài tập thiền",47300,69000,21700,31
TIKI,nha-sach-tiki,187503389,"Thiên Thần Diệt Thế - Seraph Of The End - Tập 24",22000,22000,0,0
TIKI,nha-sach-tiki,170298048,"Dịch Bệnh Atlantis",151000,195000,44000,23
TIKI,nha-sach-tiki,186262546,"BILLY SUMMERS – VỤ ÁM SÁT CUỐI CÙNG",209300,299000,89700,30
TIKI,nha-sach-tiki,89222118,"Sổ Vẽ Phác Thảo Deli 40 Trang - Gáy Lò Xo - Khổ Ngang A4/B5 - Giấy Định Lượng 100Gsm / 110Gsm - 7696 / 7697 / 73632",29000,57600,28600,50
TIKI,nha-sach-tiki,4219547,"Người đàn ông đánh bại mọi thị trường - A man for all markets",349000,349000,0,0
TIKI,nha-sach-tiki,167019786,"Cơ Thể Tự Chữa Lành - Thanh Lọc Để Phục Hồi",221300,295000,73700,25
TIKI,nha-sach-tiki,157412117,"Chưa Kịp Lớn Đã Phải Trưởng Thành",63000,79000,16000,20
TIKI,nha-sach-tiki,75696174,"Vẫy Vùng Giữa Vũng Lầy",140000,140000,0,0
TIKI,nha-cua-doi-song,108243508,"Chảo sâu đáy từ miệng rót Sunhouse SHS20MRD - Dùng trên mọi loại bếp - Hàng chính hãng",272000,400000,128000,32
TIKI,nha-cua-doi-song,131407865,"bàn làm việc chân gấp gọn",405000,450000,45000,10
TIKI,nha-cua-doi-song,49724259,"Nệm Foam Cao Cấp Nest Ru9 15cm - Màu Xám | 2 Lớp Foam Nâng Đỡ | Bao Gồm 6 Kích Thước | 100 Đêm Ngủ Thử",5790000,5790000,0,0
TIKI,nha-cua-doi-song,55502241,"Bộ chăn ga gối cotton LIDACO PL1 - Dưa Hấu Hồng (SP001111)",198200,299000,100800,34
TIKI,nha-cua-doi-song,62734430,"Gói 5 Kg Phân bón đầu trâu hữu cơ vi sinh cao cấp Trichoderma + TE giúp kháng bệnh và tăng trưởng khỏe cho cây trồng",125000,125000,0,0
TIKI,nha-cua-doi-song,162210732,"Bộ Tua Vít Deli Cao Cấp 30 Chi Tiết Đa Năng Vặn Ốc Vít, Bu Lông - Phù Hợp Sửa Chữa Vật Dụng, Xe Máy - DL1130",164000,268000,104000,39
TIKI,nha-cua-doi-song,13561925,"Nồi Hấp 2 Tầng Bằng Inox Lock&Lock LLH1282 (28cm)",791000,1319000,528000,40
TIKI,nha-cua-doi-song,112218352,"Ron Gioăng Chữ T Dán Chặn Che Khe Hở Khung Chân Cửa Chống Gió Bụi Côn Trùng Thoát Hơi Máy Lạnh",13000,13000,0,0
TIKI,nha-cua-doi-song,162767378,"Bình giữ nhiệt có ống hút, quai đeo cho bé dung tích 1L",93099,97999,4900,5
TIKI,nha-cua-doi-song,49098494,"Kệ Góc Nhà Tắm, Kệ Góc Tường, Kệ Nhà Tắm Inox 304 2 tầng Cao Cấp L1",380000,550000,170000,31
TIKI,nha-cua-doi-song,125968227,"Cây lau nhà phun sương thông minh 2 trong 1, đầu xoay 360 độ tiện lợi - Broom Green Pro 02",64986,64986,0,0
TIKI,nha-cua-doi-song,984246,"Kèn Melodion - Melodica Suzuki MX-37 37 Phím",750000,750000,0,0
TIKI,nha-cua-doi-song,200936447,"Bàn Trà Cafe, Bàn Trà Sofa Phong Cách Bắc Âu Thương Hiệu IGEA",176000,176000,0,0
TIKI,nha-cua-doi-song,146289201,"Túi đựng hộp cơm giữ nhiệt, túi đựng đồ ăn trưa văn phòng đa chức năng phù hợp cho cả nam và nữ có tay cầm tiện lợi, chống thấm nước",59000,59000,0,0
TIKI,nha-cua-doi-song,148877182,"Ruột gối nằm K-Bedding chất liệu Microfiber màu ngẫu nhiên (45x65cm)",320000,400000,80000,20
TIKI,nha-cua-doi-song,168878527,"SET 10 KHĂN LAU NHÀ BẾP ĐA NĂNG THIẾT KẾ 2 MẶT CHỐNG THẤM DẦU CAO CẤP",28000,28000,0,0
TIKI,nha-cua-doi-song,117291914,"Bàn Trang Điểm Ngồi Bệt IGA Sắp Xếp Mỹ Phẩm, Son Gọn Gàng - GP143",385000,419000,34000,8
TIKI,nha-cua-doi-song,54752502,"Bộ 10 khăn lau 2 mặt xuất Nhật Toki - Khăn lau không phai màu không rụng sợi- nhanh khô- Khăn lau bếp, khăn lau kính, lau bát lau tay - HN09421L",10000,15000,5000,33
TIKI,do-choi-me-be,133790543,"Gối Mẹ Bầu Đậu Khuyết Đa Năng Linen Bông Gòn Lông Vũ Cao Cấp | 159",599000,599000,0,0
TIKI,do-choi-me-be,64029864,"Bộ Thẻ Nhân Quả (Cấp Độ Trung Bình) | Game Tư Duy Nhân Quả Số 1 Tại Việt Nam",200000,200000,0,0
TIKI,do-choi-me-be,90526567," Váy đầm thun bé gái dễ thương - Size 11-45kg - K134",150000,150000,0,0
TIKI,nha-cua-doi-song,154157961,"Màn Dây Không Cửa FUNU Chống Muỗi Cao Cấp, Vải Màn Mềm, Mịn, Mắt Dày Dặn Chống Muỗi Tuyệt Đối - Hàng Chính Hãng",133000,140000,7000,5
TIKI,nha-cua-doi-song,148026925,"Bình Đựng Nước 2L Dễ Thương Có Vạch Báo Giờ Uống Nước - Hàng Loại 1 - Chính Hãng MINIIN",94000,120000,26000,22
TIKI,do-choi-me-be,184522257,"Đồ chơi lắp ráp, xếp hình tàu chiến Qman 1411 cho bé trai - Tàu tuần dương biển (700 mảnh ghép)",359000,459000,100000,22
TIKI,nha-cua-doi-song,794973,"Gối Cao Su Liên Á Oval LAGOV4565 (45 x 65 cm) - Trắng",790000,790000,0,0
TIKI,do-choi-me-be,52579303,"[COMBO 4 GÓI] KHĂN VẢI KHÔ ĐA NĂNG AIKO X 270 TỜ/ GÓI",140000,140000,0,0
TIKI,nha-cua-doi-song,72049797,"Set 02 Cuộn Giấy Nến, Giấy Sáp, Giấy Lót Nướng Bánh, Lẩu Nướng, Hấp Bánh, Nướng Thực Ăn Chịu Nhiệt, Chống Dính, Không Thấm Dầu Tiện Dụng 30cm x 5m + Tặng Chổi Phếu Dầu Ăn",45000,45000,0,0
TIKI,nha-cua-doi-song,56596052,"KỆ ĐỂ BÀN CHẢI ĐÁNH RĂNG VÀ NHẢ KEM ĐÁNH RĂNG TỰ ĐỘNG KÈM 2 CỐC HÚT TỪ TÍNH",106799,119999,13200,11
TIKI,nha-cua-doi-song,207227522,"Giấy nến nấu ăn thương hiệu MyJae",55000,130000,75000,58
TIKI,do-choi-me-be,755394,"Cờ Domino Ngà Lớn Liên Hiệp Thành KDNL",78000,78000,0,0
TIKI,nha-cua-doi-song,158816154,"Bộ 5 Tấm Xốp Dán Tường Hoạt Hình Mèo Ú Siêu Dễ Thương Sẵn Keo 70x77",85000,85000,0,0
TIKI,do-choi-me-be,89233900,"Lưới bọc quạt loại to có dây kéo an toàn cho trẻ nhỏ . Đường kính tối đa 50cm",20500,20500,0,0
TIKI,do-choi-me-be,107693416,"Nước rửa bát hữu cơ Fuwa3e organic Enzyme sinh học 500ml an toàn cho bé bảo vệ da tay",58000,58000,0,0
TIKI,nha-cua-doi-song,10115744,"Ổ cắm Điện Quang ECO ĐQ ESK 2BR 6ECO (6 Lỗ, dây dài 2m, màu đen đỏ)",88000,88000,0,0
TIKI,do-choi-me-be,73272562,"Combo 4 Gói Khăn Ướt Max Cool 80 Tờ Tặng 2 Gói Cùng Loại",99000,124000,25000,20
TIKI,do-choi-me-be,48477021,"Combo Bộ Bài Tarot Bói Smith Waite Tarot Cao Cấp và Túi Nhung Đựng Tarot và Khăn Trải Bàn Tarot",119000,119000,0,0
TIKI,nha-cua-doi-song,58814335,"Xe đẩy hàng 4 bánh SUMIKA T300 - Khung thép, tay cầm gấp mở tiện lợi, tải trọng 300kg",1265000,1950000,685000,35
TIKI,nha-cua-doi-song,115986066,"Miếng Dán Chân Bàn Ghế Chống Trượt Hamart Bọc Lót Chân Bàn Ghế Chống Ồn Chống Xước Nền Nhà",18000,29000,11000,38
TIKI,do-choi-me-be,130362474,"SET 10 QUẦN ĐÙI THUN COTTON NHIỀU HOẠ TIẾT CHO BÉ GÁI",197000,197000,0,0
TIKI,do-choi-me-be,16374640,"Tấm Lót Chống Thấm Tiện Lợi An Toàn Cho Bé (80 x 120 cm)",88000,117000,29000,25
TIKI,nha-cua-doi-song,101627081,"Ô dù cầm tay siêu nhẹ 105g cho phái đẹp, chống tia UV - Nason Feather Umbrella for Lady - Dù gấp gọn bỏ túi Nason",195000,195000,0,0
TIKI,nha-cua-doi-song,66090300,"Bộ 20 dụng cụ kẹp giữ dây điện gọn gàng",12999,12999,0,0
TIKI,nha-cua-doi-song,175432384,"Bàn để ủi quần áo cao cấp Nakagami tư thế đứng có giá đỡ chất lượng Công nghệ Nhật Bản - Màu ngẫu nhiên - Hàng chính hãng",399000,399000,0,0
TIKI,do-choi-me-be,146366199,"MÁY ĐA NĂNG ĐIỆN TỬ (ALL-IN-ONE) FATZBABY - MULTIMAX 2 - FB9013SLTHẾ HỆ MỚI",1099000,1099000,0,0
TIKI,do-choi-me-be,144278087,"Lều Xông Hơi Tự Bung 3 Lớp Và Nồi Xông Hơi Cao Cấp Dùng Tại Nhà Spa",698000,698000,0,0
TIKI,do-choi-me-be,274536010,"[Combo Tiện Lợi] Gói Men Bể Phốt EcoClean Septic - Men Vi Sinh Xử Lý Hầm Cầu, Bể Phốt Đầy, Tràn - Túi Gói 100gram",246000,246000,0,0
TIKI,do-choi-me-be,68462933,"Bỉm - Tã Quần Moony Natural Size XL- 32 miếng ( bé 12- 22Kg)",286900,286900,0,0
TIKI,nha-cua-doi-song,35475781,"Bộ củ sen tắm nóng lạnh bồn tắm inox 304 gồm ( củ sen tắm, vòi sen inox, giá đỡ vòi sen inox, dây sen inox)",276000,550000,274000,50
TIKI,do-choi-me-be,95035841,"(date T6.24) Dinh dưỡng đóng lọ ăn dặm Trái cây nhiệt đới HiPP Organic 125g",45000,45000,0,0
TIKI,do-choi-me-be,70904714,"Tã Dán Siêu Thấm Caryn Gói Siêu Tiết Kiệm M40 (40 Miếng) - MẪU MỚI",349000,349000,0,0
TIKI,do-choi-me-be,44885577,"Đồ Chơi Gỗ Bộ Domino 100 Quốc Gia Trên Thế Giới",95000,150000,55000,37
TIKI,nha-cua-doi-song,113833830,"Tấm Lót Bảo Vệ Nệm Cao Cấp PHÚC HẠNH - Lót Chống Thấm",171000,190000,19000,10
TIKI,do-choi-me-be,55576959,"Tinh dầu tràm Con Dơi ( Nguyên chất 100%)",137000,137000,0,0
TIKI,do-choi-me-be,70844277,"Bộ Thẻ Bài Pokemon 324 Thẻ Cao Cấp Nhiều Loại",198000,198000,0,0
TIKI,do-choi-me-be,153820898,"Bộ bóc dán thông minh cho bé 17 chủ đề (loại cao cấp), dùng nhiều lần, giúp bé vừa chơi, vừa học tiếng Anh",99000,198000,99000,50
TIKI,do-choi-me-be,181184380,"Ghế ăn dặm cho bé gập gọn và nâng hạ độ cao Mastela 7331 - Ghế tập ăn dặm cho bé đạt chuẩn ASTM Mỹ BPA Free",660000,660000,0,0
TIKI,do-choi-me-be,247474808," Bàn Chải Đánh Răng Trẻ Em Jodily 1-4 Tuổi Siêu Mền Mại (Dành Cho Bé Tập Đánh Răng)",55000,55000,0,0
TIKI,do-choi-me-be,205290276,"Nước làm bóng Finish 750ml",118000,118000,0,0
TIKI,do-choi-me-be,104156562,"Sữa tắm dịu nhẹ Jojoba Pigeon 200ml/700ml",47000,67000,20000,30
TIKI,nha-cua-doi-song,108418530,"Kệ bồn cầu 3 tầng để sau bồn cầu, kệ nhà vệ sinh trên toilet, Kệ nhà tắm đa năng tiện lợi",212900,212900,0,0
TIKI,nha-cua-doi-song,189208326,"Thảm nhà tắm, nhà bếp siêu thấm nước, chống trơn trượt tối giản, hiện đại NAVIVU",99000,99000,0,0
TIKI,do-choi-me-be,89752727,"Bộ bơi bé gái lớn, dáng 2 mảnh cộc tay quần sooc đùi thể thao, màu sắc trẻ trung, áo tắm trẻ em nữ size đại từ 25 đến 60kg | BT37",299000,314420,15420,5
TIKI,do-choi-me-be,205719867,"Combo muối rửa bát Finish 1,5kg+viên rửa bát Finish 120 viên+Nước làm bóng bát chén finish 800ml",519000,519000,0,0
TIKI,nha-cua-doi-song,48175833,"KỆ VUÔNG 3 TẦNG GỖ THÔNG- DÀI 35cm x CAO 65cm",159000,250000,91000,36
TIKI,do-choi-me-be,94728826,"Áo yếm máng dài tay Cotton chống thấm nước cho bé tập ăn dặm, tập vẽ Mastela Dành cho bé từ 0-4 tuổi - Có chọn màu và size",69000,95000,26000,27
TIKI,do-choi-me-be,146399059,"Sữa bột Nutricare Care 100 Plus phục hổi dinh dưỡng cho trẻ biếng ăn (900g)",335000,335000,0,0
TIKI,do-choi-me-be,90475777,"Thuốc diệt chuột thái lan tiêu diệt cả đàn sau 3 ngày tặng kèm bịt thuốc diệt dán và kiến",31900,31900,0,0
TIKI,do-choi-me-be,120170572,"Xe chòi chân B.Duck yên da cho bé từ 1 đến 2 tuổi - Xe thăng bằng khung thép, bánh cao su an toàn cho trẻ DC019",249000,249000,0,0
TIKI,do-choi-me-be,74944614,"Đồ chơi hình cú mèo chạy cót KAVY nhấn là chạy đáng yêu dễ thương nhựa nguyên sinh an toàn",22000,22000,0,0
TIKI,nha-cua-doi-song,136227595,"Khay đựng remote  - điện thoại dán tường có khe luồn sạc nhỏ gọn tiện lợi  ( Giao màu ngẫu nhiên ) - Hàng chính hãng ",16000,30000,14000,47
TIKI,nha-cua-doi-song,20680352,"Combo 5 bẫy diệt chuột thông minh",75000,75000,0,0
TIKI,do-choi-me-be,117031983,"Áo Hút Sữa Rảnh Tay Mama’s Choice, Mặc Hút Sữa Cho Mẹ, Có Dây Giữ Bình Hút Sữa Chắc Chắn, Chất Liệu Thoáng Khí, Freesize - MÀU ĐEN",350000,390000,40000,10
TIKI,do-choi-me-be,68142209,"Nutifood GrowPLUS+ Đỏ 1500 Gr : sữa dành cho trẻ từ 1- 10 tuổi bị suy dinh dưỡng thấp còi (mẫu mới)",555000,555000,0,0
TIKI,do-choi-me-be,104559720,"Kính bơi cho trẻ em độ tuổi từ 4 tuổi đến 10 tuổi",89000,94240,5240,6
TIKI,nha-cua-doi-song,195891839,"Đèn LED Mini Móc Khóa - Đèn Pin COB - Đèn Pin Dã Ngoại - Sạc USB Tiện Dụng - Hàng Loại 1 - Chính Hãng MINIIN",51000,59000,8000,14
TIKI,do-choi-me-be,115694932,"Đồ chơi lắp ráp xếp hình tên lửa chiến đấu Qman 1728 - Tên lửa đánh chặn (409 mảnh ghép) dành cho bé trai trên 6 tuổi",279000,359000,80000,22
TIKI,do-choi-me-be,24448316,"Nước rửa bình sữa D-nee Mild & Care chai 500ml",79000,91000,12000,13
TIKI,nha-cua-doi-song,111705115,"Túi đựng dụng cụ 13 inch INGCO HTBG281328",108000,108000,0,0
TIKI,do-choi-me-be,57933293,"Hộp 8 bộ đồ chơi lắp ráp Biệt đội cứu hỏa vòi rồng 8in1 Qman 1805 (313 chi tiết)",177000,256000,79000,31
TIKI,do-choi-me-be,135478535,"Nước giặt Dnee cho bé chai 3000ml-hàng chính hãng có hoá đơn",194000,194000,0,0
TIKI,do-choi-me-be,16555626,"Ngựa bập bênh kiêm xe chòi chân cho bé (có nhạc + bánh xe + đệm lót)",194000,194000,0,0
TIKI,do-choi-me-be,197544914,"Gấu bông khủng long đeo tai nghe cao cấp - Thú nhồi bông siêu dễ thương",215000,430000,215000,50
TIKI,do-choi-me-be,42957984,"Bộ tranh xếp hình cao cấp 1500 mảnh – Nhà Thờ St. Basil, Nga (60x100cm)",285000,360000,75000,21
TIKI,do-choi-me-be,145703441,"Áo ô tô 95 mc queen cực đẹp cho bé trai",62000,62000,0,0
TIKI,do-choi-me-be,125681962,"Combo 5 Quần sơ sinh dài mặc bỉm bo gấu Babiboo BB44",190000,190000,0,0
TIKI,do-choi-me-be,108760703,"Áo khoác bé gái hình ngựa Pony 11-43kg - Áo lạnh nữ - PONY - Thun cotton da cá in 3D cực chất- Hương Nhiên",149000,241000,92000,38
TIKI,do-choi-me-be,501433,"Nước Lau Sàn Mrs McKenic Chai 2L",163150,251000,87850,35
TIKI,do-choi-me-be,260806630,"Bộ đồ chơi xếp hình Macaron 4D hót nhất 2023 đồ chơi lắp ghép que nối 4d cho bé",75000,75000,0,0
TIKI,do-choi-me-be,108746629,"Hộp đựng phấn rơm cho bé kuku ku5345",131950,145000,13050,9
TIKI,do-choi-me-be,7591655,"Đồ Chơi Gỗ Chàng Trai Gỗ - Máy Bay BABY 94006",105000,105000,0,0
TIKI,do-choi-me-be,109850209,"Lều cho bé – Lều tự bung",215000,215000,0,0
TIKI,do-choi-me-be,94790570,"Áo khoác dạ bé gái Chuột đỏ - AICDBGTWWQVT - AIN Closet",165000,220000,55000,25
TIKI,do-choi-me-be,196343078,"Thảm Nhạc Cho Bé Sơ Sinh Nằm Chơi Kích Thích THị Giác Thính Giác Phát Triển Thể Chất",159000,159000,0,0
TIKI,do-choi-me-be,195695590,"Bộ Đồ Chơi Lắp Ghép STEM Mô Hình Chim Gõ Kiến, Bộ Đồ Chơi Khoa Học Tự Làm Chim Gõ Kiến, Bộ Đồ Chơi Gỗ Cao Cấp Khoa Học Tự Làm DIY Wood Steam - Chính Hãng BABYBOSS.",55000,75000,20000,27
TIKI,do-choi-me-be,27930462,"Giày patin trẻ em thời trang có đèn led - Đầy đủ bảo hộ và phụ kiện",404940,404940,0,0
TIKI,do-choi-me-be,197545185,"Gấu bông cá mập mặt chó husky dễ thương - Thú nhồi bông cao cấp",104000,165000,61000,37
TIKI,do-choi-me-be,7972027,"Đồ Bộ Bé Trai Hình Spider Man In 3D 09  (Size",139000,240000,101000,42
TIKI,do-choi-me-be,43183462,"Bộ tranh xếp hình 330 mảnh – Thu Vàng (30x44cm) ",78000,100000,22000,22
TIKI,do-choi-me-be,94728806,"Thìa cán ngắn chất liệu bột tre Bamboo kháng khuẩn D7066 ROYALCARE - ăn dặm an toàn cho cho sức khỏe của bé",28000,28000,0,0
TIKI,do-choi-me-be,141567690,"đồng hồ bé gái có đèn",60000,60000,0,0
TIKI,do-choi-me-be,26499571,"Đồ Chơi Rèn Luyện Trí Tuệ Phát Triển Tư Duy Logic Four color game",96000,96000,0,0
TIKI,do-choi-me-be,19918617,"Nút Bịt Ổ Điện An Toàn",22000,22000,0,0
TIKI,do-choi-me-be,54084855,"Combo 3 Đồ Chơi Lúc Lắc Cho Trẻ Happy Baby  - Giao màu ngẫu nhiên",84000,120000,36000,30
TIKI,do-choi-me-be,175956084,"Túi đeo chéo túi xách bé gái mẫu giáo hình trái tim siêu xin cute phong cách Hàn Quốc 2022",125000,125000,0,0
TIKI,do-choi-me-be,116572809,"Đồ Chơi Khám Răng Cá Sấu Cắn Tay Cho Bé",42900,42900,0,0
TIKI,do-choi-me-be,183930455,"Đồ Chơi Lắp Ráp Mô Hình Nhân Vật Thanh Gươm Diệt Quỷ - LinkGo 68291 - Tsuyuri Kanao (253 Mảnh Ghép)",80000,93000,13000,14
TIKI,do-choi-me-be,206141099,"Khóa tủ lạnh, khoá ngăn kéo, tủ đồ chống kẹp tay an toàn cho bé hình cá chất liệu nhựa ABS cao cấp",20000,25000,5000,20
TIKI,do-choi-me-be,34359233,"Combo 3 Áo Lót Bầu Và Cho Con Bú",140001,140001,0,0
TIKI,do-choi-me-be,54619207,"Túi ngủ cotton mùa hè cho bé cỡ 3 tháng đến 5 tuổi",230000,230000,0,0
TIKI,do-choi-me-be,126508624,"Quần áo búp bê 60 cm - đầm có tay",60000,60000,0,0
TIKI,do-choi-me-be,193741716,"Cờ tướng nam châm bỏ túi cao cấp - Cờ tướng nam châm hộp da có bàn là hộp đựng - Hàng chính hãng  D Danido",59000,59000,0,0
TIKI,do-choi-me-be,121535015,"Bộ 2 bình sữa Mô phỏng tự nhiên bằng nhựa Philips Avent cho trẻ từ 6 tháng 330ml (SCF696/23)",565000,565000,0,0
TIKI,do-choi-me-be,15587886,"Bột ăn dặm dinh dưỡng Metacare 8 loại hỗ trợ phát triển toàn diện (200g)",55000,61000,6000,10
TIKI,do-choi-me-be,106699606,"Mũ, nón rộng vành hình chú hươu hoạt hình 3D họa tiết chấm bị rất xinh cho bé",58000,58000,0,0
TIKI,do-choi-me-be,51095972,"Đồ chơi xếp hình Domino 1000 chi tiết bằng gỗ nhiều màu sắc cho bé yêu thỏa sức sáng tạo đồ chơi thông minh ",399999,399999,0,0
TIKI,do-choi-me-be,112103259,"Váy bé gái cánh tiên nơ cổ. Từ 11kg - 45kg. K125",499000,499000,0,0
TIKI,do-choi-me-be,173444046,"Gạc Rơ Lưỡi Cao Cấp Vệ Sinh Răng Miệng Cho Bé Sơ Sinh - Trẻ Nhỏ (Hộp 5 Chiếc Tiệt Trùng)",5000,5000,0,0
TIKI,do-choi-me-be,56707108,"Đồ Bộ Thun Ba Lỗ In 3D cho bé trai hình chú khủng long",125000,200000,75000,38
TIKI,do-choi-me-be,107018280,"Trống Bi Bô - Nốt Nhạc Xanh",84000,120000,36000,30
TIKI,lam-dep-suc-khoe,13423145,"Kem Chống Nắng Dành Cho Da Bóng Dầu, Dễ Nổi Mụn La Roche-Posay Anthelios Anti-Imperfection 50ml",373000,585000,212000,36
TIKI,lam-dep-suc-khoe,76158697,"Combo 2 Chai xịt tinh dầu bưởi kích mọc tóc, giảm rụng tóc Pomelo Tabaha 120ml cho tóc dày và dài hơn gấp 2 đến 3 lần",150000,150000,0,0
TIKI,do-choi-me-be,152470348,"Bộ đồ chơi phát triển trí não BDC30 - Thương hiệu Hinata Nhật Bản",544500,544500,0,0
TIKI,lam-dep-suc-khoe,72864994,"Máy Xông Tinh Dầu Có Loa Bluetooth Kết Nối Với Điện Thoại Nghe Nhạc Cực Hay, Máy Khuếch Tán Tinh Dầu Cho Phòng Lớn Thể Tích 1000ML, Có Remote Điều Khiển Từ Xa và Đèn LED Biến Đổi Màu Cực Đẹp",368000,788000,420000,53
TIKI,lam-dep-suc-khoe,74212735,"Tinh dầu Quế Nguyên Chất 50ML. Tinh Dầu Vỏ Quế Cao Cấp Nhập Khẩu Ấn Độ. Tinh Dầu Xông Phòng Kháng Khuẩn, Phòng Tránh Cảm Cúm - Dùng Với Máy Xông Tinh dầu",78000,228000,150000,66
TIKI,lam-dep-suc-khoe,75307295,"[HỘP - FAMAPRO MAX] - Khẩu trang y tế kháng khuẩn 4 lớp Famapro Max (40 cái/ hộp) - 1 HỘP",25900,25900,0,0
TIKI,lam-dep-suc-khoe,129947293,"Kem dưỡng trắng da mặt Yococi giúp sáng da, ngăn chặn ánh sáng xanh White Perfect Face Cream 20g",163200,320000,156800,49
TIKI,lam-dep-suc-khoe,58601415,"Viên uống Vitamin tổng hợp cho Nữ - One A Day women Multivitamin 300 viên của Mỹ - mẫu mới",590000,590000,0,0
TIKI,lam-dep-suc-khoe,10734388,"Nước cân bằng giàu khoáng dành cho da dầu La Roche Posay Effaclar Astringent Lotion 200ml ",377000,455000,78000,17
TIKI,lam-dep-suc-khoe,173854434,"Set 100cái khẩu trang y tế KF94 Kháng Khuẩn, Màu Trắng, Chống Bụi Mịn, Hàng Cao Cấp",82000,120000,38000,32
TIKI,lam-dep-suc-khoe,101552499,"Kem Chống Nắng Cell Fusion C Toning Sunscreen 100 SPF50+/ PA +++ Nâng Tông Sáng Hồng",389000,600000,211000,35
TIKI,lam-dep-suc-khoe,69839188,"Dầu gội bưởi VIJULLY kích thích mọc tóc giảm gãy rụng tóc",280000,280000,0,0
TIKI,lam-dep-suc-khoe,72117492,"BÌNH RỬA MŨI WATER PULSE TẶNG KÈM 1 CHAI NƯỚC MUỐI SINH LÍ 500ML",144000,144000,0,0
TIKI,lam-dep-suc-khoe,248790766,"Vitamina Tổng hợp Kirkland Daily Multi Vitamins - Mỹ - QuaTangMe Extaste",696000,1392000,696000,50
TIKI,lam-dep-suc-khoe,122868597,"Set 2 cái lô dính mái, lô quấn tóc xoăn cỡ đại - giao màu ngẫu nhiên",19000,25000,6000,24
TIKI,lam-dep-suc-khoe,174829842,"Kem Dưỡng Ẩm Làm Dịu Cho Da Khô, Ngứa, Mẫn Đỏ Latopic Face And Body Cream 75ml",322000,379000,57000,15
TIKI,lam-dep-suc-khoe,470626,"Kem Dưỡng Làm Dịu Mát, Phục Hồi Da La Roche-Posay Cicaplast Baume B5 (40ml) - M3232900",307000,410000,103000,25
TIKI,lam-dep-suc-khoe,68279712,"Combo 2 Lăn khử mùi Romano kháng khuẩn & khô thoáng cả ngày 50mlx2 Force",136000,136000,0,0
TIKI,lam-dep-suc-khoe,167926077,"Đông trùng hạ thảo Kingdom Herb chính hãng loại thượng hạng sấy thăng hoa hộp",439000,869000,430000,49
TIKI,lam-dep-suc-khoe,92558840,"Lăn khử mùi dưỡng trắng hương nước hoa Refre Whitening Perfume In Love - Hương Tình Yêu 40ml",56100,62000,5900,10
TIKI,lam-dep-suc-khoe,117057283,"Dán Móng Tay Giả Bằng silicon COMBO 5 MIẾNG x12 Sticker thay thế keo dán tiện lợi sử dụng",20000,20000,0,0
TIKI,lam-dep-suc-khoe,52240184,"Máy Đo Huyết Áp Bắp Tay OMRON HEM-7156- Thế Hệ Mới ( THƯƠNG HIỆU OMRON NHẬT BẢN )",1550000,1550000,0,0
TIKI,lam-dep-suc-khoe,166417513,"Khẩu Trang Y tế  KF94 PT Mask Kháng khuẩn, Chống Bụi. Đạt Các Chứng Chỉ ISO 13485, ISO 9001, CE, FDA, TGA",9900,9900,0,0
TIKI,lam-dep-suc-khoe,173600339,"Dung dịch xịt họng PlasmaKare H - Spray 30ml, cho trẻ từ 06 tháng, an toàn cho phụ nữ có thai không kháng sinh",170000,170000,0,0
TIKI,lam-dep-suc-khoe,13566981,"Kem dưỡng da chống lão hóa Shiseido Benefiance Wrinkle Smoothing Cream 50ml",1850000,1850000,0,0
TIKI,lam-dep-suc-khoe,70638800,"Lược cắt tóc 0612",18000,30000,12000,40
TIKI,lam-dep-suc-khoe,84283337,"Sáp Wax Lông Nóng Wax Bean 100gr, Dạng Hạt Đậu(Tặng Kèm Que Phết Wax Stick)",13000,23999,10999,46
TIKI,lam-dep-suc-khoe,5780691,"Son dưỡng có màu chiết xuất trái cây Lipice Sheer Color Fruit Juice Strawberry",83400,103000,19600,19
TIKI,lam-dep-suc-khoe,59238608,"MÁY XÔNG TINH DẦU CHUYÊN DỤNG DUNG TÍCH 550ML, VÂN GỖ CAO CẤP, TÍCH HỢP ĐIỀU KHIỂN TỪ XA",219000,496000,277000,56
TIKI,lam-dep-suc-khoe,63511644,"Cân điện tử bluetooth phân tích chỉ số cơ thể Kachi MK223 - Màu đen - Hàng chính hãng",299000,399000,100000,25
TIKI,lam-dep-suc-khoe,58220974,"Kem Dưỡng Thể 2% BHA Paula’s Choice Resist Weightless Body Treatment With 2% BHA  - M",810000,950000,140000,15
TIKI,lam-dep-suc-khoe,88992738,"Combo Mật ong  rừng Phương Nam 100% mật ong chín Honimore 990g",195000,282000,87000,31
TIKI,lam-dep-suc-khoe,94613156,"ĐỆM MASSGE HỒNG NGOẠI TOÀN THÂN CAO CẤP HAKAWA HK-M11 - HÀNG CHÍNH HÃNG",2940000,2940000,0,0
TIKI,lam-dep-suc-khoe,556237,"Nước Súc Miệng Trà Xanh Listerine Natural Green Tea (750ml)",135000,173000,38000,22
TIKI,lam-dep-suc-khoe,101018297,"Miếng Dán Lột Mụn Đầu Đen Vùng Mũi Cằm Trán Từ Tro Núi Lửa Đảo JeJu Dewytree Black Head Out Nose Patch (1 Miếng)",12000,15000,3000,20
TIKI,lam-dep-suc-khoe,50884640,"Kem Dưỡng Reihaku Hatomugi Cải Thiện Làn Da khô, thâm, mụn 300g",160000,163800,3800,2
TIKI,lam-dep-suc-khoe,20534750,"Khẩu trang trẻ em Gấu trúc StayDry",35100,39000,3900,10
TIKI,lam-dep-suc-khoe,173472760,"Combo 2 hộp ANGELA GOLD tăng cường sinh lý nữ 60 viên tặng 1 hộp 15 viên",1440000,1630000,190000,12
TIKI,lam-dep-suc-khoe,54682884,"Dầu gội đầu Head&Shoulders Clinical Strength Shampoo",299000,299000,0,0
TIKI,lam-dep-suc-khoe,16443914,"Son Dưỡng Môi Gạo Hương Cam Có Màu Phớt Cam Nhẹ Dưỡng Môi Hết Khô Nẻ An Toàn Từ Thiên Nhiên Cỏ Mềm 3.8g",90000,90000,0,0
TIKI,lam-dep-suc-khoe,109070194,"Cân Điện Tử OMRON HN-289 - Màu Đen",590000,700000,110000,16
TIKI,thiet-bi-kts-phu-kien-so,50077198,"Miếng lót chuột, bàn di chuột, mouse pad nhỏ dùng trong văn phòng, cừa hàng kích thước 26x21 nhiều mẫu dễ thương 2020",20000,20000,0,0
TIKI,thiet-bi-kts-phu-kien-so,48576455,"Máy trợ giảng Unizone UZ-U2 - Máy trợ giảng không dây Hàn Quốc chính hãng mới nhất 2020",2850000,3500000,650000,19
TIKI,thiet-bi-kts-phu-kien-so,105740488,"Giá đỡ Kẹp điện thoại xe máy MOTOWOLF01 bằng hợp kim nhôm, chống rung, chống giựt (Giao Màu Ngẫu Nhiên)",250000,250000,0,0
TIKI,thiet-bi-kts-phu-kien-so,108945995,"Bao tay chơi game cảm ứng găng tay chống mồ hôi, chống trượt - 1 ngón lẻ",1800,1800,0,0
TIKI,thiet-bi-kts-phu-kien-so,127600345,"Máy trợ giảng không dây TAKSTAR E261W khoảng cách truyền 40M, công suất cao 25W -Tặng túi đựng máy trợ giảng - Hàng Chính Hãng",1699000,1699000,0,0
TIKI,thiet-bi-kts-phu-kien-so,59379773,"Dây Đeo Thay Thế Dành Cho Vòng Đeo Tay Thông Minh Xiaomi Mi Band 5 Dẻo TPU",35000,35000,0,0
TIKI,thiet-bi-kts-phu-kien-so,31515652,"Ốp lưng Memumi cho Samsung Galaxy Note 10 Plus/Note 10 - Hàng nhập khẩu",84797,84797,0,0
TIKI,thiet-bi-kts-phu-kien-so,58801158,"Cáp sạc USB dành cho Xiaomi MiBand 5",34000,34000,0,0
TIKI,thiet-bi-kts-phu-kien-so,118275020,"Lót chuột có đệm tay chống mỏi chất liệu silicon siêu êm - Hàng nhập khẩu",39000,39000,0,0
TIKI,thiet-bi-kts-phu-kien-so,84131202,"Bảng viết, bảng vẽ điện tử thông minh LCD tự xóa 8.5 inch có khóa màn hình -dc3603",37999,37999,0,0
TIKI,thiet-bi-kts-phu-kien-so,174888634,"Ốp lưng cho Xiaomi Redmi Note 11 - Note 11S chống sốc trong viền nhựa dẻo XunDD - Hàng nhập khẩu",99000,99000,0,0
TIKI,thiet-bi-kts-phu-kien-so,187050070,"Tai Nghe Bluetooth Lenovo Livepods XT92 Gamming 5.1 - Hàng Chính Hãng",265050,279000,13950,5
TIKI,thiet-bi-kts-phu-kien-so,121534422,"CẶP LOA TREBLE 2 TỪ - TREBLE GIẤY - GIÁ 2 LOA",60000,60000,0,0
TIKI,thiet-bi-kts-phu-kien-so,13630622,"Cáp chuyển từ DisplayPort sang HDMI",33550,33550,0,0
TIKI,thiet-bi-kts-phu-kien-so,271336602,"Chuột Gaming không dây Dareu EM911X RGB - Hàng chính hãng",569000,569000,0,0
TIKI,thiet-bi-kts-phu-kien-so,172431997,"Ốp lưng dành cho Samsung Galaxy S22 - S22 Plus - S22 Ultra - mẫu Cung Hoàng Đạo - Virgo",40000,55000,15000,27
TIKI,thiet-bi-kts-phu-kien-so,91075304,"Ốp lưng nhám mờ cho Samsung Galaxy S21 Plus, S21 Ultra chống sốc, bảo vệ Camera (đen)",39000,39000,0,0
TIKI,thiet-bi-kts-phu-kien-so,153544569,"Loa Máy Tính Để Bàn, Âm Thanh Siêu Trầm, Dành Cho Học Online, Nghe Nhạc, Xem Phim - Hàng Chính Hãng",220000,220000,0,0
TIKI,thiet-bi-kts-phu-kien-so,135055868,"Hub USB 3 Cổng 3.0 Tốc Độ Cao, chia usb ra 4 cổng usb",79000,79000,0,0
TIKI,thiet-bi-kts-phu-kien-so,19831761,"Ốp Silicon Dẻo Trong Chống Sốc Cho Iphone 7 Plus và Iphone 8 Plus",12500,12500,0,0
TIKI,thiet-bi-kts-phu-kien-so,71972222,"Ốp Lưng Silicon TPU trong suốt GOR cho Samsung Galaxy S20 / S20 Plus / S20 Ultra - Hàng Nhập Khẩu",45000,45000,0,0
TIKI,thiet-bi-kts-phu-kien-so,83749872,"Bao Da Cover Dành Cho Máy Tính Bảng Huawei MatePad 10.4 inch BAH3-W09 / BAH3-AL00 Hỗ Trợ Smart Cover",129000,129000,0,0
TIKI,thiet-bi-kts-phu-kien-so,120464311,"Giá Đỡ Điện Thoại Chiếc Nhẫn Vuông Trơn",8450,8450,0,0
TIKI,thiet-bi-kts-phu-kien-so,108962702,"Bàn phím không dây Logitech K580 Slim (Graphite) - Hàng Chính Hãng",929000,929000,0,0
TIKI,thiet-bi-kts-phu-kien-so,74923685,"Ốp Lưng Silicon TPU Hoco  Dành Cho iPhone 12 Mini, iPhone 12 Pro , iPhone 12 Pro Max - Hàng Chính Hãng",37000,89998,52998,59
TIKI,thiet-bi-kts-phu-kien-so,113011938,"Giá Đỡ Điện Thoại Trên Ô Tô - Kẹp Điện Thoại Ô Tô, Xe Máy Hít Nam Châm Cực Chắc",43000,43000,0,0
TIKI,thiet-bi-kts-phu-kien-so,71936242,"	 Ốp silicon dẻo cho Samsung Tab S6 Lite P610/P615",46999,46999,0,0
TIKI,thiet-bi-kts-phu-kien-so,73166444,"Chuột không dây Bluetooth Logitech MX Master 3 - Hàng chính hãng",1879000,1879000,0,0
TIKI,thiet-bi-kts-phu-kien-so,1998403,"Cáp Nối Dài Ugreen USB 2.0 10321 (10m) - Hàng Chính Hãng",234000,234000,0,0
TIKI,thiet-bi-kts-phu-kien-so,20879266,"Tai Phone Điện Thoại Loa Kép Bass Siêu Trầm , Âm Thanh Sống Động 4D - Tai Nghe Nhạc Y90",46550,49000,2450,5
TIKI,thiet-bi-kts-phu-kien-so,124275193,"Bộ Bàn Phím Và Chuột Không Dây Lớn Siêu Mỏng Có Phím Số",294500,310000,15500,5
TIKI,thiet-bi-kts-phu-kien-so,199568819,"Combo 3 Nhẫn Điện Thoại Gấp Gọn Giúp Hạn Chế Rơi Vỡ Điện Thoại Xoay 360 Độ",53130,101200,48070,48
TIKI,thiet-bi-kts-phu-kien-so,27719207,"Đen - Giá đỡ iRing từ tính xoay 360 độ hiệu XUNDD Iring Holder cho điện thoại / tablet (Lực hút nam châm mạnh mẽ, thiết kế nhỏ gọn) - hàng nhập khẩu",129000,129000,0,0
TIKI,thiet-bi-kts-phu-kien-so,155014801,"Dây Cáp Sạc Dây Dù Hoco X14 USB-A to Type-C  dùng cho samsung, sony, Huawai,... Màu ngẫu nhiên- Hàng chính hãng",37900,37900,0,0
TIKI,thiet-bi-kts-phu-kien-so,17577491,"Jack chia từ 6.5ly ra 2 lỗ 6.5 ly",25000,25000,0,0
TIKI,thiet-bi-kts-phu-kien-so,145488761,"Miếng Dán Dẻo PPF Dành Cho iPhone 13, 13Mini, 13Pro, 13Pro Max - Hạn Chế Trầy Xước Thân Máy Hiệu Quả Khi Không Sử Dụng Ốp. Kèm Bộ Khăn Lau 1-2",41000,64000,23000,36
TIKI,thiet-bi-kts-phu-kien-so,160691668,"Ốp lưng cho Xiaomi 11T - 11T Pro TPU Trong Suốt Che Camera",39000,39000,0,0
TIKI,thiet-bi-kts-phu-kien-so,44946468,"Ốp Hybrid Viền TPU Mặt Kính Cường Lực Leeu Design dành cho iPhone Xs Max _ Hàng Nhập Khẩu",189993,379986,189993,50
TIKI,thiet-bi-kts-phu-kien-so,27591152,"Tai nghe nhạc Eranc Hàn Quốc có hộp quấn chống rối hình mèo dễ thương",79000,79000,0,0
TIKI,thiet-bi-kts-phu-kien-so,37792470,"Bao Da Cover Dành Cho Máy Đọc Sách Kindle Paperwhite Gen 4 (10th) Tuần Lộc",119000,119000,0,0
TIKI,thoi-trang-nu,92055188," Bra / Áo Lá Học Sinh Hai Lớp Xuất Đông Âu ( AL : 193 ) Hàng Loại Đẹp",26000,26000,0,0
TIKI,thoi-trang-nu,92159061,"Set 3 món đồ bơi nữ tay dài quần dài kèm quần đùi bơi rời - TK2165",437000,437000,0,0
TIKI,thoi-trang-nu,192710205,"Áo Hoodie nỉ bông thêu sadboiz màu ĐEN / Nam nữ unisex",100000,100000,0,0
TIKI,dien-gia-dung,134306036,"CHÍNH HÃNG: Máy hút bụi giường, đệm, thảm không dây CHIGO, lực hút 10.000 Pa, diệt khuẩn bằng tia UV và nhiệt độ 50 độ C",580000,580000,0,0
TIKI,dien-gia-dung,32403859,"Máy sấy tóc công suất lớn 2200w tặng kèm 5 chi tiết",129999,129999,0,0
TIKI,thoi-trang-nu,92489126,"Quần dài nữ Baggy kẻ sọc caro lưng thun",104500,104500,0,0
TIKI,dien-gia-dung,165046253,"Máy vắt cam điện Nagakawa NAG0814 (0.75 Lít) - Hàng Chính Hãng",289000,499000,210000,42
TIKI,thoi-trang-nu,128158907,"Quần lót lọt khe Full lưới Sexy kiểu dáng độc đáo siêu co giãn",35000,35000,0,0
TIKI,thoi-trang-nu,134025545,"Đầm body ôm 2 dây thiết kế khoét vai dự tiệc",121000,121000,0,0
TIKI,dien-gia-dung,813164,"Nồi Áp Suất Điện Comet CM6151 (6.0 Lít) - Hàng Chính Hãng",1139000,1690000,551000,33
TIKI,dien-gia-dung,973084,"Quạt Hút Thông Gió Âm Trần Senko HT250 (40W) - Hàng Chính Hãng",275000,275000,0,0
TIKI,thoi-trang-nu,158129574,"Váy/đầm ngủ chất liệu ren voan mềm mịn, cao cấp, xẻ tà trước đầy gợi cảm LYEN008",112000,118000,6000,5
TIKI,thoi-trang-nu,78553196,"Đầm suông linen cổ sen vuông form rộng trẻ trung, chất vải linen mềm mát, thời trang phong cách Nhật Bản",230000,230000,0,0
TIKI,thoi-trang-nu,196205490,"Chân Váy Nữ New Design Thiết kế Dáng Váy Đắp Tà Chéo ,Phom chữ A Trẻ Trung, Dài 63cm ,Thanh Lịch Công Sở ,,Chất Vải Tốt Co Giãn (3 Màu )CV0083",159000,359000,200000,56
TIKI,thoi-trang-nu,73200262,"Áo Kiểu Nữ Hàn Quốc Dạng Áo Kiểu Tay Lỡ Phối Màu - Nhiều Màu GOTI 3A03",219000,219000,0,0
TIKI,thoi-trang-nu,181428485,"Set bộ linen áo cổ 2 ve dáng lửng và quần ống rộng, thời trang phong cách Hàn - Xám",350000,350000,0,0
TIKI,dien-gia-dung,1695751,"Máy Sấy Tóc Philips BHC010/00 - Hàng Chính Hãng",385000,402000,17000,4
TIKI,dien-gia-dung,50712789,"Nồi cơm điện cao tần Sharp KS-IH191V 1.8L, hàng chính hãng (Giao màu ngẫu nhiên)",2499000,3500000,1001000,29
TIKI,dien-gia-dung,74261828,"Máy Pha Cà Phê Espresso Zamboo ZB-68CF (3.5Bar) - Hàng Chính Hãng",990000,990000,0,0
TIKI,dien-gia-dung,150977066,"Máy lọc nước nóng lạnh Karofi KAD-D66 - Hàng chính hãng",13440000,13440000,0,0
TIKI,dien-gia-dung,52896572,"MÁY ĐÁNH TRỨNG TẠO BỌT CÀ PHÊ MINI - GIAO MÀU NGẪU NHIÊN",22900,22900,0,0
TIKI,thoi-trang-nu,25964805,"Quần lót lọt khe sexy nữ chất liệu ren thiết kế xẻ đáy quyến rũ gợi cảm - Màu hồng",25000,25000,0,0
TIKI,dien-gia-dung,162507161,"Máy lọc nước nóng lạnh 9 lõi lọc hàng chính hãng Karofi Livotec 612, màng RO 100GDP Hàn Quốc",9320000,9320000,0,0
TIKI,dien-gia-dung,75374493,"Máy pha cà phê Espresso chuẩn áp suất 20 bar, chế độ cốc đôi CM6863 tích hợp cảm ứng tiện lợi Hàng Chính Hãng",2545000,2545000,0,0
TIKI,thoi-trang-nu,197191834,"Áo hoodie in chữ YE MUST BE BORN AGAIN KANYE cho nam và nữ, ÁO HOODIE NỈ IN CHỮ YE MUST BORN FORM RỘNG UNISEX NAM NỮ, Áo hoodie in chữ YE MUST BE BORN AGAIN KANYE cho nam và nữ",100000,100000,0,0
TIKI,thoi-trang-nu,178509168,"Áo croptop hai dây bản to polo cổ v nữ, áo thun ôm body rút dây gợi cảm hở lưng mặc đi biển đi chơi dưới 50 cân",86900,86900,0,0
TIKI,thoi-trang-nu,19758703,"ÁO THUN NỮ TRỄ VAI",29000,29000,0,0
TIKI,thoi-trang-nu,271138640,"Đồ Bộ Đũi Trung Niên Chất Liệu Đũi Cao Cấp Cho Mẹ Và Bà Mặc Đi Tiệc Đi Chơi - Tuấn Tú Store 68",279000,279000,0,0
TIKI,thoi-trang-nu,129402470,"Quần kẻ caro nữ",69000,69000,0,0
TIKI,thoi-trang-nu,110757056,"chân váy nữ có túi kiểu hàn 3 màu kiểu hàn quốc",89000,89000,0,0
TIKI,dien-gia-dung,912416,"Vỉ Nướng Điện Lock&Lock EJG211BLK (1800W) - Hàng chính hãng",799000,1429000,630000,44
TIKI,thoi-trang-nu,51731179,"Đồ ngủ cosplay nữ phi công sexy gợi cảm",139000,139000,0,0
TIKI,dien-gia-dung,729907,"Quạt Bàn Lifan B-106 - Xanh Dương - Hàng Chính Hãng",180000,180000,0,0
TIKI,thoi-trang-nu,58327731,"Đầm suông nữ xếp từng phối ren form rộng đủ size AH10",179000,179000,0,0
TIKI,thoi-trang-nu,76541904,"Quần lót lọt khe nữ dễ thương ren buộc dây",25000,25000,0,0
TIKI,thoi-trang-nu,109190445,"ĐẦM HOA PHỐI DẬP LY TRẺ TRUNG - MS 0603D",390000,390000,0,0
TIKI,dien-gia-dung,82885822,"Quạt treo tường 1 dây SENKO T1680 - Hàng chính hãng",305000,305000,0,0
TIKI,thoi-trang-nu,137669568,"Áo Sơ Mi Nhung Gân Tăm Phong Cách Retro Hàn Quốc Form Rộng Unisex Nam Nữ Ulzzang",152000,152000,0,0
TIKI,thoi-trang-nu,69028851," ÁO THUN CROPTOP ÔM BODY TRƠN BASIC XOẮN NGỰC 50",84000,84000,0,0
TIKI,thoi-trang-nu,179979931,"Áo lót trung niên cài trước, áo lót cho người già",108000,108000,0,0
TIKI,dien-gia-dung,193570411,"Nồi áp suất Elmich PCE-1805 dung tích 2.5L - Hàng Chính Hãng",999000,2090000,1091000,52
TIKI,thoi-trang-nu,185004745,"Quần đùi mẹ Nâu cà phê chéo Hàn - AICDMEVKF3HT - AIN Closet",165000,260000,95000,37
TIKI,thoi-trang-nu,184489131,"Áo Bơi Nữ Tay Dài Black Befree Sobie",382500,450000,67500,15
TIKI,dien-gia-dung,76077245,"Ấm sắc thuốc điện tự động ông già, dung tích 3L, công suất 300W-Màu ngẫu nhiên",179000,179000,0,0
TIKI,thoi-trang-nu,187012164,"Bộ đồ bơi bikini nữ đi tắm biển kín đáo - B.35",190000,200000,10000,5
TIKI,thoi-trang-nu,57400785,"Bộ đồ bơi bikini 2 mảnh nữ phong cách Hàn xinh xắn, chất bơi thun lạnh Lycra cao cấp, dáng dễ mặc, kín đáo mà vẫn quyến rũ | KT047",480000,480000,0,0
TIKI,dien-gia-dung,185690322,"Nồi cơm điện Cuckoo 1.8 lít CR-1055 - Hàng Chính Hãng",880000,1380000,500000,36
TIKI,thoi-trang-nu,35976449,"Áo Len Nữ Cardigan Nhẹ Bốn Mùa ALN002 MayHomes Kiểu Cánh Dơi",118900,145000,26100,18
TIKI,dien-gia-dung,136966246,"Nồi Nấu Cháo Chậm Cho Bé Ăn Dặm SEKA GT68 - Nồi Hầm Cháo, Kho Cá Chậm, Hầm Cách Thủy, Ninh Cháo Cho Bé 4 In 1 - Hàng chính hãng",299000,299000,0,0
TIKI,dien-gia-dung,172307694,"Máy Ép Chậm Trục Ngang Olivo SJ22 [Hàng Chính Hãng] Ép Rau Không Lo Kẹt Máy - Ép Kiệt Bã - Dễ Vệ Sinh",3390000,3390000,0,0
TIKI,dien-gia-dung,102572188,"Máy cạo râu Xiaomi Mijia S300 - Hàng Nhập Khẩu",405000,417000,12000,3
TIKI,dien-gia-dung,48726164,"Máy làm kem từ trái cây tươi Đa Năng",250000,250000,0,0
TIKI,thoi-trang-nu,143148359,"ĐẦM XÒE VOAN DỰ TIỆC THẮT NƠ EO SIÊU XINH",123000,123000,0,0
TIKI,dien-gia-dung,48290147,"Máy Xay Sinh Tố Đa Năng Tiện Lợi",408000,408000,0,0
TIKI,thoi-trang-nu,186862647,"Bộ quần áo lửng cho mẹ họa tiết Sọc xám linen cotton - AICDMESQPMZ0 - AIN Closet",310000,430000,120000,28
TIKI,dien-gia-dung,76283066,"Nồi Cơm Điện Tử Sharp KS-COM08V-SL (0.72 Lít) – Hàng Chính Hãng",979000,979000,0,0
TIKI,thoi-trang-nu,112052377,"(HÀNG HOT TEEN) VÁY ĐŨI SUÔNG DÁNG MAXI FULL MÀU HÀNG CHUẨN NHƯ HÌNH CÓ ẢNH THẬT",78700,78700,0,0
TIKI,dien-gia-dung,184955159,"Quạt Tích Điện Không Dây XIAOMI Smartmi Gen 2S, Sử Dụng 20 Giờ Liên Tục 100 Tốc Độ Gió Quạt Siêu Êm, Có Remote, Kết Nối App Thông Minh Công Suất 25W- Hàng Chính Hãng",1789000,3569000,1780000,50
TIKI,dien-gia-dung,53297461,"Nồi chiên không dầu 5L mẫu 2020",416000,440064,24064,5
TIKI,dien-gia-dung,53772628,"Máy rửa rau quả, khử độc thực phẩm Dr.Ozone 400mg / giờ, khử trùng bình sữa màn hình cảm ứng - Hàng Chính Hãng",1650000,1650000,0,0
TIKI,thoi-trang-nu,103358919,"Váy ngủ quảng châu cao cấp – Váy ngủ sexy ren G7 – Váy ngủ gợi cảm – Đầm ngủ ren hoa – Đồ ngủ sexy – Váy ngủ sexy",95000,95000,0,0
TIKI,thoi-trang-nu,179412988,"Áo kiểu nữ ngắn tay in hình phong cách Retro,bốn màu siêu đẹp,siêu sang - Mã A17",166470,166470,0,0
TIKI,dien-gia-dung,1953527,"Máy Sấy Tóc Sunhouse SHD2305 - Xanh",118000,118000,0,0
TIKI,dien-gia-dung,187569563,"Quạt Đeo Cổ Mini Tích Điện Không Cánh Tiện Lợi Thời Trang Dáng Thể Thao",68990,68990,0,0
TIKI,thoi-trang-nu,74915290,"Đầm suông linen cổ đức phối 2 túi ngực ArcticHunter, chất vải linen tự nhiên mềm mại, thời trang thương hiệu chính hãng",250000,250000,0,0
TIKI,dien-gia-dung,159888554,"Máy Làm Bánh Mì Tự Động Gevi GEBMA333-V - Menu 12 Chế Độ Tự Động, Hẹn Giờ 13 Tiếng - Hàng Chính Hãng",1890000,2990000,1100000,37
TIKI,dien-gia-dung,186084792,"Nồi cơm điện Happy Cook 1.2 lít HDC-WNB120W - Hàng chính hãng",880000,1265000,385000,30
TIKI,dien-gia-dung,142024770,"Bếp điện từ Elmich ICE-1831 hàng chính hãng",1190000,1190000,0,0
TIKI,thoi-trang-nu,134357642,"Chân váy xếp ly dáng dài - kèm đai",153400,153400,0,0
TIKI,dien-gia-dung,35364939,"Bình áp lọc nước 10L",700000,700000,0,0
TIKI,thoi-trang-nu,7150525,"Quần Độn Mông Đúc Dạng Đùi Nâng Mông Cao Cấp - 5Star",72000,72000,0,0
TIKI,thoi-trang-nu,108507753,"Quần baggy nữ công sở gấu bằng vải tuyết mưa",75000,75000,0,0
TIKI,dien-gia-dung,189468815,"Nồi Chiên Hơi Nước OLIVO SF18 - 50 Chức Năng - Dung Tích 18L - Công Suất 2450W - Hàng Chính Hãng",5990000,5990000,0,0
TIKI,dien-gia-dung,196186238,"Máy xay mini cầm tay 3 trong 1 (máy xay nghiền tỏi ớt, rau củ, sinh tố;, máy nạo gọt hoa quả; máy cắt sợi, thái lát đồ ăn) dễ dàng vệ sinh - Chính hãng MINIIN (Giao màu ngẫu nhiên)",96000,149000,53000,36
TIKI,thoi-trang-nu,34499006,"Quần bò giấy nữ chất dãn từ 43-76kg",169000,169000,0,0
TIKI,dien-gia-dung,142672117,"Máy Ép Chậm Hurom H300E-BBE - Hàng Chính Hãng",7950000,14200000,6250000,44
TIKI,dien-gia-dung,169002747,"MÁY ÉP TRÁI CÂY KANGAROO KG200SJD2 (MÁY ÉP CHẬM 665ml - 200W) Hàng Chính Hãng",4870000,4870000,0,0
TIKI,dien-gia-dung,16215259,"Quạt Hộp USS-H3VU-Hàng chính hãng",285000,285000,0,0
TIKI,dien-gia-dung,185495917,"Nồi cơm điện Sunhouse SHD8606 1.8L - Hàng chính hãng",643000,1319000,676000,51
TIKI,dien-gia-dung,53067628,"Máy hút bụi diệt khuẩn Giường, nệm, sofa CM800 công suất 450W hút sạch bụi và khử khuẩn triệt để bằng tia UV ( Giao màu ngẫu nhiên )",648000,662500,14500,2
TIKI,o-to-xe-may-xe-dap,2799693,"Giá Đỡ Điện Thoại Trên Ô TÔ One -  Touch",30999,30999,0,0
TIKI,o-to-xe-may-xe-dap,182456852,"Túi than hoạt tính TTAUTO 100% từ gáo dừa Bến Tre khử mùi diệt khuẩn trên ô tô, tủ đồ, phòng tắm - Túi 150 Gram",33000,65000,32000,49
TIKI,o-to-xe-may-xe-dap,196525119,"Tấm thảm lót chân xe máy điện VinFast Vento S 2022",150000,150000,0,0
TIKI,o-to-xe-may-xe-dap,271370123,"Xe đạp địa hình Thống Nhất MTB26-05 đen mờ - Hàng chính hãng",3390000,3390000,0,0
TIKI,o-to-xe-may-xe-dap,53626686,"Ghế Ngồi Gắn Xe Đạp An Toàn Cho Bé Song Long",129000,129000,0,0
TIKI,o-to-xe-may-xe-dap,208206856,"Mũ bảo hiểm lỗ thông gió chính hãng NÓN SƠN TG-XM151",340000,650000,310000,48
TIKI,o-to-xe-may-xe-dap,14289778,"Cần số Titan dành cho xe Wave",75000,75000,0,0
TIKI,o-to-xe-may-xe-dap,87848828,"Đệm Hơi ô tô,Nệm hơi xe ô tô Cao Cấp Chất Liệu Vải Nhung",301000,555000,254000,46
TIKI,o-to-xe-may-xe-dap,181908818,"Xe đạp Thống Nhất thể thao M26-01 - Hàng chính hãng",3549000,3549000,0,0
TIKI,o-to-xe-may-xe-dap,7543371,"Mũ Bảo Hiểm 3/4 Đầu Royal M139",542000,700000,158000,23
TIKI,o-to-xe-may-xe-dap,83429308,"Bộ 2 gương cầu lồi gắn kính chiếu hậu xe hơi và xe máy",28000,28000,0,0
TIKI,o-to-xe-may-xe-dap,127198691,"MIẾNG DECAL CÓ LOGO DÁN BẢO VỆ BẬC CHÂN XE Ô TÔ , MIẾNG DÁN CHỐNG TRẦY XƯỚC BẬC CHÂN XE ÔTÔ CÓ LOGO Theo Xe",90000,90000,0,0
TIKI,o-to-xe-may-xe-dap,72333316,"Máy Khuếch Tán Tinh Dầu Xe Hơi Cao Cấp và Chuyên Dụng, Máy Xông Tinh Dầu Dùng Điện USB Trên Xe ô tô, Đèn LED Cực Đẹp, Không Dùng Lõi Bông",198000,556000,358000,0
TIKI,o-to-xe-may-xe-dap,128710056,"Combo 2 Đèn LED Gắn Van Bánh Xe Đạp, Xe Máy, Ô Tô",26499,26499,0,0
TIKI,o-to-xe-may-xe-dap,91973091,"Gối tựa cổ cao su non trên ô tô bảo vệ cổ, lưng, cột sống khi lái xe -Gối tựa cổ cao su non trên ô tô bảo vệ cổ, lưng",175000,175000,0,0
TIKI,o-to-xe-may-xe-dap,139445958,"Móc Treo Đồ Xe Máy -2 Móc Xoay 180 độ mẫu mới loại dày đẹp hàng cao cấp lắp cho các xe máy xe điện",65550,69000,3450,5
TIKI,o-to-xe-may-xe-dap,35930998,"Khung Gắn Biển Số ( Khung, Viền, Kính, Ốc Gắn ) Cho Tất Cả Loại Xe STĐA Hoàng Long - Hàng Cao Cấp",36000,36000,0,0
TIKI,o-to-xe-may-xe-dap,95548243,"Tẩu sạc nhanh ô tô QC 3.0 chia 2 nguồn sạc usb 5V/6.2A nguồn DC 12V/24V sử dụng cho tất cả các dòng xe ô tô",88000,88000,0,0
TIKI,o-to-xe-may-xe-dap,177479143,"Mũ bảo hiểm 1/2 đầu Napoli N088 New vòng đầu từ 54 -57cm chất liệu nhựa ABS, xốp EPS giảm xung chấn cực tốt",229000,229000,0,0
TIKI,o-to-xe-may-xe-dap,125010167,"Nhớt Hộp Số Nhớt Láp Xe Tay Ga Motul Scooter Gear Oil Plus 120ml",55000,55000,0,0
TIKI,o-to-xe-may-xe-dap,71918313,"Bộ 12 miếng decal phản quang dán ô tô, xe máy",19000,19000,0,0
TIKI,o-to-xe-may-xe-dap,177830682,"Chắn bùn xe đạp Kiotool Touring, Fixed, 700c",65000,65000,0,0
TIKI,o-to-xe-may-xe-dap,3172271,"Chai Xịt Bôi Trơn Sên Chống Văng Tơ Nhện Spider Spray 600ml",220000,220000,0,0
TIKI,o-to-xe-may-xe-dap,44000599,"Sạc điện thoại trên xe máy thông qua bình xe",69000,69000,0,0
TIKI,o-to-xe-may-xe-dap,13239149,"Đệm ngồi lót ghế ô tô cao su thoáng khí hỗ trợ tuần hoàn máu E3-L206",74794,74794,0,0
TIKI,o-to-xe-may-xe-dap,18288302,"Ghế Xe Đạp Trẻ Em Song Long - Màu Ngẫu Nhiên",126000,126000,0,0
TIKI,o-to-xe-may-xe-dap,11204849,"Túi treo đầu xe máy mẫu mới siêu bền",189000,189000,0,0
TIKI,bach-hoa-online,116766566,"Bánh Goute Hạt dinh dưỡng hộp 8 gói (316.8g)",60500,62000,1500,2
TIKI,bach-hoa-online,2454325,"Thùng 48 Hộp Sữa Uống Dutch Lady Cô Gái Hà Lan Vị Dâu Cao Khỏe (48X170ml)",307500,450000,142500,32
TIKI,o-to-xe-may-xe-dap,22027685,"Gương Cầu Lồi Đa cực 360 Độ Gắn Gương Chiếu Hậu Ô Tô",10000,10000,0,0
TIKI,bach-hoa-online,51571008,"Trà kỷ tử - Câu kỷ tử - Loại cao cấp (500gr)",157000,157000,0,0
TIKI,o-to-xe-may-xe-dap,35911745,"Bộ 4 Khăn lau xe hơi, ô tô, xe máy đa năng chuyên dụng cao cấp siêu thấm hút nước mạnh giúp vệ sinh chăm sóc ô tô/ xe máy sạch sẽ - Hàng chính hãng",84550,89000,4450,5
TIKI,bach-hoa-online,25165565,"Hạt lanh nâu DK HARVEST (nhập khẩu Canada) - 500g",82000,89000,7000,8
TIKI,bach-hoa-online,208622974,"Combo 2 hộp thanh hạt dinh dưỡng PLAY Natural & Healthy - Bánh hạt dinh dưỡng, bánh ngũ cốc ăn sáng",168000,198000,30000,15
TIKI,bach-hoa-online,138489137,"Bột Diếp Cá Dalahouse Hộp 60g (mẫu mới) - 20 tuýp 3g tiện dụng - Hỗ trợ trĩ - Kháng viêm - Tiêu hóa tốt",108000,120000,12000,10
TIKI,bach-hoa-online,20469816,"SÔCÔLA ĐEN 100% ALLUVIA NGUYÊN CHẤT KHÔNG ĐƯỜNG | EXTREME DARK CHOCOLATE 100% NO SUGAR",75000,75000,0,0
TIKI,o-to-xe-may-xe-dap,130168640,"Đèn Led Xe Đạp nhấp nháy gắn đuôi xe đạp, tay lái, nón bảo hiểm, báng xe - siêu sáng, tuổi thọ dài, chống nước, tăng độ an toàn khi đạp xe ban đêm",25000,25000,0,0
TIKI,o-to-xe-may-xe-dap,146240539,"1 ĐÈN PHA LED 6 TIM SIÊU SÁNG XE MÁY XE HƠI ÔTÔ MẪU MỚI LOẠI TỐT",199000,199000,0,0
TIKI,bach-hoa-online,110210574,"Nui Màu Tự Nhiên Fuma Macaroni 500g - Kèm Gói Nguyệt Quế HavaFoodies",45000,45000,0,0
TIKI,bach-hoa-online,2245153,"Bắp Rang Uncle Jax Vị Bơ Caramel Kiểu Chicago (80g)",21000,21000,0,0
TIKI,bach-hoa-online,58448473,"Cà phê Sáng tạo 4 (340gr)",109000,118114,9114,8
TIKI,bach-hoa-online,127076265," Patê Cột Đèn Hải Phòng 150g - Đồ Hộp Hạ Long",26125,27500,1375,5
TIKI,bach-hoa-online,140229111,"1 Hủ Muối chấm hảo hảo 120gram",19000,19000,0,0
TIKI,bach-hoa-online,10409796,"Thùng 24 Lon Cà Phê Sữa Highlands Coffee (235ml/Lon)",312000,360000,48000,13
TIKI,bach-hoa-online,100275064,"Sữa tươi UHT Đà Lạt True Milk không đường 180ml (Thùng 48 hộp)",426500,426500,0,0
TIKI,o-to-xe-may-xe-dap,134230819,"Giá chở hàng đa năng- Baga- Cáng chở hàng dành cho các loại xe máy, mở cốp tiện lợi 60x70cm",289000,289000,0,0
TIKI,o-to-xe-may-xe-dap,48887218,"Combo Xịt Dưỡng sên Thunder Chain Lube 400ml, Vệ sinh sên MC-40 400ml tặng bàn chải chà sên 3D",117000,117000,0,0
TIKI,bach-hoa-online,107078512,"Sữa tươi UHT Đà Lạt True Milk ít đường 110ml (Thùng 48 hộp)",274400,274400,0,0
TIKI,o-to-xe-may-xe-dap,25454895,"Bộ 2 miếng dán chống nước gương chiếu hậu xe hơi",37000,37000,0,0
TIKI,o-to-xe-may-xe-dap,118298811,"Giỏ xe đạp Khung thép",250000,250000,0,0
TIKI,bach-hoa-online,107881916,"Trà gạo lứt xạ đen đậu đen (1kg) - hỗ trợ giảm cân - lợi sữa - ngủ ngon ( MS)",115000,130000,15000,12
TIKI,bach-hoa-online,601765,"Bột Trà Xanh Matcha Hiệu Gold Cocoa Indochine (Hộp 10 Gói x 10g)",199000,199000,0,0
TIKI,bach-hoa-online,92710891,"Bộ 12 túi thức ăn cho mèo Whiskas vị cá ngừ 80g",150000,150000,0,0
TIKI,bach-hoa-online,136656459,"Trà tim sen túi lọc cao cấp, hộp quấn dây kraft",79000,79000,0,0
TIKI,bach-hoa-online,209334917,"Combo 3 hộp thanh hạt dinh dưỡng PLAY Natural & Healthy - Bánh hạt dinh dưỡng, bánh ăn kiêng giảm cân",250000,297000,47000,16
TIKI,bach-hoa-online,66993225,"Rượu Whisky Chivas Regal 12 (700ml) 39.7% - 40.3% - Kèm Hộp",699000,709000,10000,1
TIKI,o-to-xe-may-xe-dap,143292192,"Túi Treo Xe Đạp Thể Thao B-Soul01 40cm - Túi Đeo Xe Đạp Địa Hình Chống Nước - Phụ Kiện Xe Đạp Chính Hãng",112000,112000,0,0
TIKI,bach-hoa-online,35382934,"Combo 10 miếng lót chuồng, vệ sinh cho chó",24960,24960,0,0
TIKI,o-to-xe-may-xe-dap,125009528,"Nhớt Tổng Hợp Cho Xe Tay Ga 4 Thì Motul Scooter Power LE 5W40 Có Chiết Lẻ",175000,175000,0,0
TIKI,bach-hoa-online,56407789,"Combo 1 Cà Phê Hòa Tan Espresso KING COFFEE - Hộp 100 gói x 2.5g + Tặng 1 Cà Phê Sữa PLUS Hòa Tan 3in1 KING COFFEE - Hộp 10 gói x 20g",379200,403200,24000,6
TIKI,bach-hoa-online,16685808,"Yến Sào cao cấp win'snest Tổ Yến Chưng Sẵn Không Đường 20% (6 Lọ/Hộp) thích hợp cho mọi đối tượng đặc biệt là người ăn kiêng và tiểu đường. ",196350,385000,188650,49
TIKI,bach-hoa-online,73090604,"Rượu vang trắng Jacob's Creek Classic Chardonnay 750ml 11.9% - 13.9% - Không hộp",299000,341000,42000,12
TIKI,bach-hoa-online,16680747,"Yến sào cao cấp win'sNest tổ yến chưng sẵn đường phèn 20% (6 lọ/hộp) phù hợp cho mọi đối tượng và trẻ từ 1 tuổi trở lên giúp bồi bổ sức khỏe. ",231000,385000,154000,40
TIKI,o-to-xe-may-xe-dap,82459827,"Đèn Hậu Xe Đạp 3 Bóng Đèn Sau Xe Đạp Giúp Cảnh Báo Đạp Xe/Chạy Bộ Ban Đêm Sạc USB Mai Lee",94000,99000,5000,5
TIKI,bach-hoa-online,138956444,"[Combo 10 lọ] Nước Yến sào Khánh Hòa Sanest đóng lọ 70ml",360000,360000,0,0
TIKI,bach-hoa-online,97990952,"Muối Ớt Chanh Nha Trang 200gr Dh Foods",23500,23500,0,0
TIKI,bach-hoa-online,13799086,"Gạo Hữu Cơ Hoa Nắng - Gạo Tấm 1kg",46000,46000,0,0
TIKI,bach-hoa-online,8157213,"Bánh Custas Hộp 12 Cái (282g)",60000,73000,13000,18
TIKI,bach-hoa-online,72508423,"Combo 2 gói NATURAL Gia Vị Nấu Bún Bò Huế Dh Foods",31400,31400,0,0
TIKI,bach-hoa-online,52855014,"Combo 2 lon Sữa bột Bonecare xương và khớp 400g: dành cho người lớn bổ sung GLUCOSAMINE tạo dịch nhờn cho khớp, giúp phòng ngừa đau xương khớp, viêm khớp, đặc biệt là người bệnh xương và khớp.",249390,489000,239610,49
TIKI,bach-hoa-online,99324784,"1KG CƠM GẠO LỨT SẤY RONG BIỂN GIÒN THƠM HIỆU SK FOOD",89000,99000,10000,10
TIKI,bach-hoa-online,190701491,"Cà Phê Cold Brew Arabica Cầu Đất DalatFarm - Túi 125 g",112000,130000,18000,14
TIKI,bach-hoa-online,7740597,"Chà Là khô nguyên cành Deglet Nour Tunisia hộp 500g",138000,210000,72000,34
TIKI,bach-hoa-online,97551977,"Thùng 12 chai Nước Khoáng Kiềm Thiên Nhiên Vikoda 1.5L",120000,120000,0,0
TIKI,bach-hoa-online,7316589,"Sữa bột Wincofood Bonecare dưỡng chất cho xương và khớp 400g dành cho người lớn phòng ngừa đau xương khớp, viêm khớp, đặc biệt là người bệnh xương và khớp.",150000,250000,100000,40
TIKI,bach-hoa-online,41067741,"Nho Khô Mix Không Hạt Smile Nuts Túi 250g - Nhập khẩu từ Chile, nho khô hỗn hợp gồm nho đen, nho đỏ và nho vàng (loại không hạt, trái to)",59000,82000,23000,28
TIKI,o-to-xe-may-xe-dap,1254773,"Kem Xóa Vết Xước Sơn Xe Hơi Liqui Moly Kratzer Stop 2320 (200ml)",179000,179000,0,0
TIKI,o-to-xe-may-xe-dap,75548106,"Tẩu sạc nhanh ô tô cao cấp tự điều chỉnh độ dài dây sạc usb",199000,199000,0,0
TIKI,bach-hoa-online,102123726,"KHÔ CÁ THIỀU TÂN LỘC PHÁT HŨ 200G",52000,119000,67000,56
TIKI,bach-hoa-online,55556648,"Dừa Sấy Bến Tre TETE 500 gram",66000,67000,1000,1
TIKI,dien-gia-dung,134240170,"Nồi Lẩu Điện Mini Mickey Bear LD-183 - Ca Nấu Mì,Chiên,Sào Đa Năng - Dung Tích",219000,299000,80000,27
TIKI,dien-gia-dung,3071357,"Lõi lọc cho máy lọc nước tại vòi Eurolife LS-D10",187000,220000,33000,15
TIKI,dien-gia-dung,144743247,"Lò vi sóng nướng đối lưu chiên không dầu Panasonic NN-CT65MBYUE – 20 thực đơn tự động – Dung tích 27L – Hàng chính hãng",6520000,6520000,0,0
TIKI,dien-gia-dung,191923908,"Nồi Áp Suất Điện Đa Năng INSTANT POT PRO 10-IN-1, 5.7L - Hàng Chính Hãng",4900000,4900000,0,0
TIKI,dien-gia-dung,110931903,"ĐẦU TREO 2 DÂY - 3HT Hàng chính hãng",175000,175000,0,0
TIKI,dien-gia-dung,225938034,"Máy Hút Bụi Cầm Tay Không Dây Yoice, hút bụi ô tô - công suất 120w- Hàng chính hãng",343900,362000,18100,5
TIKI,dien-gia-dung,44327908,"Máy Uốn, Duỗi Và Tạo Kiểu Tóc Panasonic EH-HT40-K645 - Hàng Chính Hãng",1169000,1169000,0,0
TIKI,dien-gia-dung,56085151,"Màng Lọc HEPA Cho Máy Hút Bụi Deerma DX128/DX118C - Hàng chính hãng",45000,69000,24000,35
TIKI,dien-gia-dung,11384814,"Quạt treo 2 dây mẫu mới F23 Senko TC1620 - Màu ngẫu nhiên - Hàng chính hãng",425000,425000,0,0
TIKI,dien-gia-dung,155163055,"Máy Hút Gia Đình Cao Cấp, Máy Hút Bụi Cầm Tay Không Dây Tiện Lợi, Hút Bụi Xe Ô Tô, Laptop, Giường Nệm - Lực Hút 9000PA- Hàng Chính Hãng",295000,295000,0,0
TIKI,dien-gia-dung,38171233,"Quạt Sạc Comet CRF0803 (3W)",174000,174000,0,0
TIKI,dien-gia-dung,174241905,"Quạt tháp không cánh và lọc không khí Tiross TS9176 (33W) - Hàng Chính Hãng",5580000,6990000,1410000,20
TIKI,dien-gia-dung,101470870,"Máy ép tốc độ chậm thế hệ mới Magic Eco AC-131 (130W) - Hàng chính hãng",1250000,3190000,1940000,61
TIKI,dien-gia-dung,273159644,"Máy hút bụi cầm tay không dây UNIQ Free A7 đa năng gia đình mini pin sạc hút giường đệm nệm sofa xe hơi lực hút mạnh - Hàng chính hãng",2670000,2670000,0,0
TIKI,dien-gia-dung,548778,"Nồi Cơm Áp Suất Điện Tử Cuckoo CRP-G1015M - 1.8L (Đỏ) - Hàng Chính Hãng",2980000,4590000,1610000,35
TIKI,dien-gia-dung,147352659,"Bàn ủi hơi nước PHILIPS GC7933/30 2400W - Hàng Chính Hãng",3799000,3799000,0,0
TIKI,dien-gia-dung,187316658,"Bình Pha Cà Phê French Press Lock&Lock LLG019 Chất Liệu Thủy Tinh Và Thép Không Gỉ - 800ml - Hàng Chính Hãng",299000,499000,200000,40
TIKI,dien-gia-dung,71159450,"Máy Lọc Không Khí ULTTY SKJ-CR021 Dạng Quạt, Chế Độ Làm Mát 9 Cấp, Bộ Lọc HEPA H13 Loại Bỏ 99,97% Bụi Mịn, Vi Khuẩn, Virut - Màu Trắng - Hàng Chính Hãng",4550000,5850000,1300000,22
TIKI,dien-gia-dung,52686889,"Máy Xay Nấu Đa Năng Kangaroo KG175HB1 (Xay 800W - Nấu 900W) - Hàng Chính Hãng",2180000,3940000,1760000,45
TIKI,dien-gia-dung,119308993,"Quạt Hút Thông Gió - Quạt Thông Gió Gắn Tường LiOA -  Hàng chính hãng",344000,344000,0,0
TIKI,dien-gia-dung,21407423,"Quạt Treo Tường Có Remote Panasonic F409MB - Xanh Dương - Hàng nhập khẩu",2079000,2079000,0,0
TIKI,dien-gia-dung,56731056,"MÁY XAY SINH TỐ, THỰC PHẨM, XAY ĐÁ NẮP NÂU ĐỜI MỚI 2020",88999,88999,0,0
TIKI,dien-gia-dung,58617116,"Nồi Điện Đa Năng Lock&Lock EJG556 (2.5 Lít) - Hàng Chính Hãng",2299000,3550000,1251000,35
TIKI,dien-gia-dung,181505052,"Quạt điện lưu thông không khí MIDEA Bản màu vàng model GAF20ER Tạo dòng khí đối lưu thông gió trong phòng 3 Mức gió Hẹn giờ tắt Thiết kế 2 trong 1 Có điều khiển từ xa Hàng chính hãng",1890500,1990000,99500,5
TIKI,dien-gia-dung,272563162,"Nồi Lẩu Nướng BEAR DKL-C15L1 Gồm 2 Ngăn Dung Tích 2.5 Lít Công Suất 1600 W - Hàng Nhập Khẩu",1449000,2889000,1440000,50
TIKI,dien-gia-dung,15279924,"Combo điếu inox bếp gas Hồng ngoại SOHO  9cm (2 Cái) - Hàng chính hãng",79000,79000,0,0
TIKI,dien-gia-dung,172081643,"Ấm siêu tốc KIPOR KP-A318SA - 1.8L - Ấm điện inox 304 chống ăn mòn - Chân đế xoay 360 độ tự ngắt chống quá tải, quá nhiệt- Hàng chính hãng",99000,319000,220000,69
TIKI,dien-gia-dung,124273130,"Bộ 16 Cây Kim Đầu Vàng May Thêu Vá Tiện Dụng",10450,11000,550,5
TIKI,dien-gia-dung,74623864,"Bộ Cốc Lọc Đầu Nguồn Kangaroo KG01G3 – Hàng Chính Hãng",1070000,2000000,930000,47
TIKI,dien-gia-dung,125363359,"Máy hút bụi cầm tay HAFELE HSV-21G (Hàng chính hãng)",4090000,6220000,2130000,34
TIKI,dien-gia-dung,121036328,"Nồi Chiên Không Dầu BEAR QZG-A15V1 Cách Nhiệt, Giảm Độ Ồn, 8 Chương Trình Chiên Tự Động, Dung Tích 10 Lít Công Suất 1500 W - Hàng Chính Hãng",2599000,5179000,2580000,50
TIKI,dien-gia-dung,922171,"Máy Hút Bụi Trên Giường Tiross TS9302 (350W) - Hàng chính hãng",1910000,2190000,280000,13
TIKI,dien-gia-dung,26028656,"Bàn ủi hơi nước công nghiệp bình nước treo 94A - Hàng nhập khẩu",829500,829500,0,0
TIKI,dien-gia-dung,55169649,"Máy hút bụi không dây 3 trong 1 Samsung VS03R6523J1 - Hàng chính hãng",3990000,5890000,1900000,32
TIKI,dien-gia-dung,41179687,"Quạt thông gió mini  12x12cm 220V",60000,60000,0,0
TIKI,dien-gia-dung,136816190,"Quạt Kẹp Bình 12V B3 - 3 Tốc Độ Gió - HÀNG CHÍNH HÃNG",230000,230000,0,0
TIKI,dien-gia-dung,20239549,"Máy xay thịt dành cho nhà bếp",100750,100750,0,0
TIKI,dien-gia-dung,23462368,"Máy Cạo Râu Xiaomi MIJIA Mini",379000,379000,0,0
TIKI,dien-gia-dung,12389198,"Quạt Hộp Midea FB40-9H (55W) - Hàng chính hãng",759000,990000,231000,23
TIKI,dien-gia-dung,147723791,"Bàn là hơi nước cầm tay Lock&lock Handy Steamer ENI222WHT (Model New) - Hàng chính hãng",699000,1391000,692000,50
TIKI,thoi-trang-nam,141109930,"Quần jogger unisex thể thao, quần ống rộng kiểu dáng jogger mặc nhà nam nữ vải TỔ ONG 3 màu năng động",80000,80000,0,0
TIKI,thoi-trang-nam,172120849,"Áo Polo Nam kiểu dáng Vintage Slub hãng JohnSton&Murphy hàng xuất Mỹ đủ màu phù hợp cả trang phục công sở lịch lãm",375000,375000,0,0
TIKI,thoi-trang-nam,181113990,"Áo polo nam có cổ cao cấp LADOS-9089 thêu đầu hươu, phối 2 màu trắng đen sang trọng, thoáng khí siêu mát mẻ",169000,318000,149000,47
TIKI,thoi-trang-nam,107338883,"Áo thun Nam Nữ Vonesa, áo phông Unisex Nam Nữ có Size từ 25-84kg B7",40000,40000,0,0
TIKI,thoi-trang-nam,83489010,"Áo Khoác Nam, Khoác Dù Nam 2 lớp phối nón thời trang hàn quốc trẻ trung cuốn hút Thương Hiệu Chandi chất liệu thấm hút mồ hôi dày dặn mặc thoáng mát mẫu M123",143000,299000,156000,52
TIKI,thoi-trang-nam,66683004,"Áo Khoác Nam Vải Kaki 2 Lớp Mặc Bốn Mùa Kiểu Dáng Thời Trang",474050,499000,24950,5
TIKI,thoi-trang-nam,113233457,"Quần đùi nam xuất khẩu, quần đùi mặc nhà chất kate cotton cao cấp  thương hiệu Fezzio",42500,85000,42500,50
TIKI,thoi-trang-nam,31594559,"Áo khoác da cá GOKING 6 túi, form unisex cho nam nữ, trẻ em. Áo chống lạnh, giữ ấm, chống nắng. Hàng hiệu cao cấp vnxk",295000,295000,0,0
TIKI,thoi-trang-nam,75945178,"áo hoodie hoạt hình, áo hoodie cute, áo hoodie han quốc, áo hoodie cá tính, áo hoodie nam nữ, áo hoodie nữ, áo hoodie nam, áo hoodie ulzzang, áo hoodie unisex",100000,100000,0,0
TIKI,thoi-trang-nam,74385119,"Áo Khoác Nam Big Size Áo Khoác Dù Nam Hai Lớp Cổ Cao Chống Nắng Chống Lạnh Chống Gió Chống Tia UV Hàn Quốc Cao Cấp QD62 - ShopN6 (Nhiều Màu)",135000,240000,105000,44
TIKI,thoi-trang-nam,59556296,"Combo 3 Chiếc Quần Lót Nam Cao Cấp Aristino ABF01807 Chất liệu Cotton Chitosan Thuần Khiết (Giao Màu Ngẫu Nhiên) - Hàng Chính Hãng",255000,315000,60000,19
TIKI,thoi-trang-nam,100868615,"Áo sơ mi FLANNEL kẻ caro Unisex phong cách streetswear, Kẻ Caro Nam Nữ Form rộng Phong Cách, Áo Sơ Mi Khoác Ngoài Cao Cấp Siêu Đẹp, Áo khoác sowmi unisex form rộng CARO nam nữ phong cách ulzzang",95000,95000,0,0
TIKI,thoi-trang-nam,176789536,"Áo bơi tay ngắn nam 401",119000,119000,0,0
TIKI,thoi-trang-nam,14450071,"Quần Bò Nam Đen Rách Gối RACHGOI97 (Rách Gối)",168000,168000,0,0
TIKI,thoi-trang-nam,19639438,"quần jean dài nam trơn thời trang",110000,110000,0,0
TIKI,thoi-trang-nam,196603717,"Quần tây nam 0Ply Novelty màu đen Regular fit NQTMMDNTRR2202880",479000,479000,0,0
TIKI,thoi-trang-nam,197675716,"Áo sơ mi nam dài tay màu đen dáng suông May 10 mã 010122912L2",295000,295000,0,0
TIKI,thoi-trang-nam,87094676,"Bộ bơi đôi dài tay Nam và Nữ, set 3 chi tiết quần dài chống nắng, đồ bơi cho couple, có size nhỏ cho bé mặc đồ gia đình | KT022 | BN022",520000,520000,0,0
TIKI,thoi-trang-nam,98986504,"Áo thun Teeworld Sài Gòn - Everything you need to know Form Rộng Unisex Nam Nữ",299000,299000,0,0
TIKI,thoi-trang-nam,163896997,"Áo Sơ Mi Nam Trắng Trơn Dài Tay Công Sở Trung Niên Thương Hiệu Anton Vải Nano Chống Nhăn - SRD05",295000,355000,60000,17
TIKI,thoi-trang-nam,150748227,"Áo Thể Thao Nam TSIMPLE cổ tròn tay ngắn tập gym vải thun lạnh thoáng mát co giãn chuẩn form MSSAHP5",165000,165000,0,0
TIKI,thoi-trang-nam,13677604,"Áo khoác nam không bo lai Phúc An 2026",195000,195000,0,0
TIKI,thoi-trang-nam,13629284,"Quần Short unisex Nam Cotton SV2",63000,63000,0,0
TIKI,thoi-trang-nam,52863921,"Áo vest nam phong cách Hàn Quốc nhiều màu",185000,185000,0,0
TIKI,thoi-trang-nam,74554228,"Áo Khoác Big Size Áo Khoác Dù Dày Bomber Nam Nữ Chống Nắng Chống Lạnh Chống Gió Lót Nỉ Hai Lớp Hàn Quốc Cao Cấp QD66 - ShopN6",155000,235000,80000,34
TIKI,thoi-trang-nam,92807600,"Quần short kaki Amazing, lưng thun có giây rút, vải kaki dày dặn, co giãn nhẹ, nhiều màu, có size lớn",159000,239000,80000,33
TIKI,thoi-trang-nam,195192891,"Quần Gió Nam Thể Thao FASVIN Vải Gió Đẹp Hàng Nhà Máy Chất Lượng Cao Dùng Khi Thể Thao Hay Mặc Nhà DC20423.HN",185000,298000,113000,38
TIKI,thoi-trang-nam,31202048,"Quần tây nam không ply ống đứng Khatoco Q1M528R0-CNMA032-2105-0",422400,528000,105600,20
TIKI,thoi-trang-nam,67201856,"Set 2 áo ba lỗ nam, áo 3 lỗ nam, sợi cotton mềm mịn, thấm hút mồ hôi tốt, thoáng mát, mặc thoải  mái",36000,36000,0,0
TIKI,thoi-trang-nam,174001966,"Quần Jean nam Leman xanh trơn JD03 - Slim Form",455000,549000,94000,17
TIKI,thoi-trang-nam,72747384,"Áo khoác dù nam form rộng",127900,127900,0,0
TIKI,thoi-trang-nam,111990270,"Quần Kaki Nam Đẹp Dáng Hàn Lưng Thun Tiện Dụng Form Slim Fit Cực Đẹp QK045",103000,103000,0,0
TIKI,thoi-trang-nam,98624377,"Quần Sọt Nam ️️ Quần Short Jean Nam Đen Phối Rách Chất Bò Cao Cấp Chuẩn Hàng Shop Tô Tồ Shop - QSJNM232",138000,138000,0,0
TIKI,thoi-trang-nam,169621343,"Viettien - Áo sơ mi nam ngắn tay họa tiết vạt bầu 1N1868 regular",395000,395000,0,0
TIKI,thoi-trang-nam,84872072,"Set đồ bơi nam full 5 chi tiết kèm túi đựng, Quần bơi da cá + Kính bơi + Mũ + Bịt tai + Kẹp mũi, hàng xịn đẹp chuẩn | BN009",320000,320000,0,0
TIKI,thoi-trang-nam,75358011,"Big size, short kaki lưng thun unisex, quần sọt nam thương hiêu Amazing, phong cách thể thao",159000,239000,80000,33
TIKI,thoi-trang-nam,193976862,"Quần Jean nam Leman xanh mài rêu JD12 - Slim Form",455000,549000,94000,17
TIKI,thoi-trang-nam,190154616,"Quần kaki dài nam việt tiến màu xám sáng có 1ly và không ly 6R6013 - 6R6012 Regular",785000,785000,0,0
TIKI,thoi-trang-nam,130029611,"Áo Hoodie Nỉ Nam Nữ From Rộng Unisex In Dạ Quang Phát Sáng Hình Gấu Cực Hot Chất Nỉ Ngoại Dày Dặn (bear)",113000,113000,0,0
TIKI,thoi-trang-nam,196207027,"Áo thun Teeworld Sài Gòn Retro Nam Nữ Trắng Đen Form Rộng Unisex",359000,359000,0,0
TIKI,dien-gia-dung,171816262,"Nồi chiên không dầu KIPOR KP-AF657 - 15L - Lò nướng điển tử công nghệ RAPID AIR nhiệt tối đa 230 độ lòng nồi inox 304- Hàng chính hãng",3704000,5549000,1845000,33
TIKI,dien-gia-dung,119967922,"Máy hút bụi không dây siêu nhẹ Panasonic MC-SBV01W246 – Hút sạch mọi lúc mọi nơi – Dễ dàng tháo lắp - Tích hợp đèn LED phát hiện bụi - Hàng chính hãng",4489000,4489000,0,0
TIKI,dien-gia-dung,42958544,"Biến áp (Adaptor) - chuyển nguồn",139000,150000,11000,7
TIKI,dien-gia-dung,449515,"Bếp Hồng Ngoại Cảm Ứng Sunhouse SHD6017 - Hàng chính hãng",1100000,1480000,380000,26
TIKI,dien-gia-dung,165345772,"ĐẦU QUẠT TREO SẮT ĐỘNG CƠ 100% ĐỒNG - HÀNG CHÍNH HÃNG 3HT",220000,220000,0,0
TIKI,dien-gia-dung,186756297,"Nồi chiên không dầu hơi nước Elmich 7L AFE-3945 - Hàng chính hãng",3644000,3899000,255000,7
TIKI,dien-gia-dung,229806089,"Máy Ép Trái Cây, Máy Ép Chậm Cao Cấp KALITE KL-599 Tiêu Chuẩn Châu Âu , Dung Tích 400 ML Công Suất 400 W - Hàng Chính Hãng",4849000,9659000,4810000,50
TIKI,dien-gia-dung,362105,"Máy Sấy Tóc Panasonic PAST-EH-ND13-V645",469000,469000,0,0
TIKI,dien-gia-dung,76184310,"Máy Làm Sạch Thảm Karcher SE 4002",10842000,11990000,1148000,10
TIKI,dien-gia-dung,75558085,"Máy hút bụi khô và ướt HiClean HC30 NEW (30L) - Hàng chính hãng",3100000,3100000,0,0
TIKI,dien-gia-dung,161241984,"Quạt treo Mitsubishi W16-RA CY-GY - Hàng chính hãng",1739000,1739000,0,0
TIKI,dien-gia-dung,48436325,"LÕI LỌC NƯỚC SỐ 3 CARBON BLOCK MÁY LỌC NƯỚC RO - lõi lọc số 3",22000,22000,0,0
TIKI,dien-gia-dung,106378953,"Bếp Gas Dương Kính Sunhouse SHB2106 - Hàng Chính Hãng",570000,570000,0,0
TIKI,dien-gia-dung,101845731,"Đèn khò gas ECO 20 công suất cao TS2022RN - HÀNG CHÍNH HÃNG NAMILUX (MP)",169000,169000,0,0
TIKI,dien-gia-dung,110035573,"Chân kệ để máy lọc nước R.O (free size) - Hàng chính hãng",76000,82000,6000,7
TIKI,dien-gia-dung,658108,"Quạt Bàn Đảo 3 Tấc Senko BD8860 - Màu Ngẫu Nhiên - Hàng chính hãng",365000,365000,0,0
TIKI,dien-gia-dung,272420836,"Máy Làm Đá Gia Đình CASO IceMaster Ecostyle 3301 Pro/3304 Icemaster Ecostyle - Nhập Khẩu Đức Cao Cấp, Thời Gian Làm Đá 0.5 Kg/Giờ Dung Tích 2.2 Lít Công Suất 90 W - Hàng Nhập Khẩu",4899000,9759000,4860000,50
TIKI,dien-gia-dung,1368631,"Nồi Nấu Cháo Đa Năng BBCooker BS25 (2.5L) - Hàng Chính Hãng",515000,515000,0,0
TIKI,dien-gia-dung,19241570,"Nồi Tiềm Nấu Cháo Chậm Kho Cá Hầm Chưng Yến Đa Năng NK Media (2,5 lít) - Màu Ngẫu Nhiên - Hàng Chính Hãng",243000,250000,7000,3
TIKI,dien-gia-dung,72802933,"Máy hút bụi cầm tay Deerma Vacuum Cleaner DX118C - Hàng Nhập Khẩu",859000,859000,0,0
TIKI,dien-gia-dung,7170571,"Bình Đun Siêu Tốc Điện Inox Sunhouse SHD1057 (1.5L) - Hàng chính hãng",170000,240000,70000,29
TIKI,dien-gia-dung,22476084,"Quạt đèn trần cao cấp có điều khiển TOP192",1490000,1490000,0,0
TIKI,dien-gia-dung,253498875,"Bộ Lọc Thay Thế Pureit Ultima 1 - Hàng Chính Hãng",1187500,1250000,62500,5
TIKI,dien-gia-dung,35283819,"Máy Sấy Tóc Panasonic Máy Sấy Tóc Panasonic EH-ND11-W645 Hàng Chính Hãng",290000,290000,0,0
TIKI,dien-gia-dung,173771927,"Máy Nướng Bánh Mì YG-3088 650W",610000,610000,0,0
TIKI,dien-gia-dung,196305556,"Máy hút bụi cầm tay GAABOR GVCC-M4A2 lực hút mạnh 4500pa cắm ô tô dây nguồn dài 4.5m - Hàng chính hãng",149500,299000,149500,50
TIKI,dien-gia-dung,176762199,"Máy Xay Sinh Tố Công Nghiệp Uniblend UB - 712 ( Hàng Nhập Khẩu)",2595000,2595000,0,0
TIKI,dien-gia-dung,117571940,"Nồi điện đa năng ăn lẩu, nướng, làm bánh,... DKL-D12A1 tặng ổ cắm 3 chấu",720000,720000,0,0
TIKI,dien-gia-dung,193748334,"Quạt không cánh lọc không khí bù độ ẩm- 2 chiều nóng lạnh màn hình LED có điều khiển",2469050,2599000,129950,5
TIKI,dien-gia-dung,56274878,"Củ lọc vòi nước đa chiều nhựa trắng",33000,33000,0,0
TIKI,dien-gia-dung,449130,"Bình Thủy Điện Sunhouse SH1535 (3.5 lít) - Hàng chính hãng",889000,889000,0,0
TIKI,dien-gia-dung,103914497,"Combo 3 lõi lọc thô 123 + 1 màng RO Karofi - Hàng chính hãng",543000,543000,0,0
TIKI,dien-gia-dung,44467818,"Máy sấy tóc Panasonic EH-NE81-K645 - tạo ion dòng Ionity - Công suất 2500W - Hàng chính hãng - Đen",1245000,1414800,169800,12
TIKI,dien-gia-dung,56946211,"Miếng lọc bụi Hepa 13 VC 3 - Hàng chính hãng",380000,380000,0,0
TIKI,dien-gia-dung,191044822,"Quạt Tích Điện Đeo Cổ Không Cánh USB Mini Tiện Lợi Parrot  , Thời Trang, Dáng Thể Thao 3 Tốc Độ Gió Dung Lượng Pin Lớn Sử Dụng 3-6 Giờ",63000,63000,0,0
TIKI,lam-dep-suc-khoe,143786928,"Combo 2 Tinh Dầu Oải Hương 50ML + Tinh Dầu Bạc Hà 50ML Nguyên Chất Chính Hãng TIDAMO, Xông Thơm Phòng Giúp Thư Giãn và Nâng Cao Sức Khỏe, Rất Tốt Khi Sử Dụng Với Máy Xông Tinh Dầu",158000,436000,278000,64
TIKI,dien-gia-dung,264014444,"Máy Hút Bụi Lau Sàn Khô Uớt Tự Giặt Giẻ Diệt Khuẩn TINECO Floor 3 Thương Hiệu Mỹ Lực Hút 12,000 Pa Công Suất 190 W - Hàng Chính Hãng",6999000,13939000,6940000,50
TIKI,lam-dep-suc-khoe,77026005,"Dầu Gội Thảo Dược Bồ Kết Tóc Mây Ngăn Ngừa Tóc Gãy Rụng An Toàn Từ Thiên Nhiên Không Chứa Hóa Chất Giảm Gàu Và Ngứa Da Đầu Cỏ Mềm 300g",325000,325000,0,0
TIKI,lam-dep-suc-khoe,73772610,"Saffron Kingdom Herb nhụy hoa nghệ tây Iran hộp 0.2 gram, hàng chính hãng super negin thượng hạng (Tặng bình nước thủy tinh)",70000,155000,85000,55
TIKI,dien-gia-dung,50643212,"Quạt bàn đảo 4 Tấc chuyển hướng điện cao cấp Senko ( Hàng Chính Hãng ) BD1410",490000,490000,0,0
TIKI,lam-dep-suc-khoe,136690839,"Dầu Gội Head Và Shoulders",212000,239000,27000,11
TIKI,dien-gia-dung,680672,"Máy Xay Sinh Tố Electrolux EMB3025 (600ml) - Hàng Chính Hãng",769000,769000,0,0
TIKI,dien-gia-dung,192177674,"Máy Nấu Sữa Hạt, Máy Làm Sữa Hạt OLIVO CB22 PRO Thương Hiệu Mỹ Gồm 14 Chức Năng Xay Nấu Với Khả Năng Chống Trào Dung Tích 1.75 Lít Công Suất 1000 W - Hàng Chính Hãng",2679000,5339000,2660000,50
TIKI,lam-dep-suc-khoe,54004408,"Dầu Gội Rejoice Siêu Mượt Chai 1800ML",358000,375000,17000,5
TIKI,lam-dep-suc-khoe,91752078," BỘ DỤNG CỤ LÀM MÓNG BẤM MÓNG - BỘ KỀM CẮT MÓNG TAY CAO CẤP",62793,85817,23024,27
TIKI,lam-dep-suc-khoe,56389444,"Bộ đôi Nước súc miệng Colgate diệt 99% vi khuẩn Plax trà xanh 500ml/chai",155000,165000,10000,6
TIKI,dien-gia-dung,50820171,"Bếp điện từ điện tử Iruka I-78 (2000W) - Hàng chính hãng",1910000,2790000,880000,32
TIKI,lam-dep-suc-khoe,116189274,"Kìm cắt móng tay, móng chân, kìm cắt da chết bằng thép không gỉ siêu sắc  tặng kèm thanh nạy móng (mầu sắc ngẫu nhiên)",79000,79000,0,0
TIKI,lam-dep-suc-khoe,24828338,"Gel ngừa mụn diệt khuẩn Floslek Pharma Antibacterial Intense Gel 20ml",230000,329000,99000,30
TIKI,lam-dep-suc-khoe,192880305,"Máy cắt tỉa lông mũi pin sạc Enchen hàng cao cấp phiên bản quà tặng hộp đẹp",200000,400000,200000,50
TIKI,lam-dep-suc-khoe,188964498,"SPECIAL COMBO 2 chai Nước Dưỡng Tóc Tinh Dầu Bưởi Cocoon 140ml - tặng Serum Sachi phục hồi tóc Cocoon 70ml",330000,330000,0,0
TIKI,lam-dep-suc-khoe,241982269,"Máy mát xa cổ cao cấp, có chườm nóng - 4 đầu tiếp xúc, 6 chế độ massage khác nhau, 9 cường độ massage - Màu Trắng",130000,130000,0,0
TIKI,lam-dep-suc-khoe,15262824,"Tinh dầu dưỡng tóc Nashi Argan Oil - trattamento di bellezza per tutti i tipi di capello 100ml",720000,720000,0,0
TIKI,lam-dep-suc-khoe,89753515,"DUNG DỊCH VỆ SINH PHỤ NỮ HANA SOFT SILK HANAYUKI",108000,108000,0,0
TIKI,lam-dep-suc-khoe,51095498,"Kem mắt chống lão hóa The INKEY List Retinol Eye Cream 15ml",399000,399000,0,0
TIKI,lam-dep-suc-khoe,8142233,"Kềm Cắt Móng Thép Chuyên Dụng Kềm Nghĩa M-306",69000,69000,0,0
TIKI,lam-dep-suc-khoe,2254547,"Viên uống điều hòa nội tiết tố nữ, nuôi dưỡng da Solgar Dầu Anh Thảo Evening Primrose Oil 1300 mg - NHẬP KHẨU USA",981818,981818,0,0
TIKI,lam-dep-suc-khoe,24862534,"Tinh Chất Tế Bào Gốc Tái Tạo Phục Hồi Trẻ Hoá Da Cấp Ẩm Dưỡng Trắng Chống Lão Hoá Cellkey-Scien White Serum 30ml",790500,930000,139500,15
TIKI,lam-dep-suc-khoe,177516306,"Set 5 Son Kem Lì Thỏ LEADUU lâu trôi mềm mịn",75000,125000,50000,40
TIKI,lam-dep-suc-khoe,12084494,"Nước Tẩy Trang Eucerin Hỗ Trợ Trị Mụn Làm Trắng Da (200ml)",261000,349000,88000,25
TIKI,lam-dep-suc-khoe,119988682,"Uốn mi cong thân nhựa cao cấp KAI màu hồng kèm miếng đệm thay thế",139000,152000,13000,9
TIKI,lam-dep-suc-khoe,21760234,"Sữa rửa mặt Sắc Ngọc Khang 50g giúp loại bỏ bụi bẩn và bã nhờn dư thừa, cung cấp các dưỡng chất cho da, giúp da trắng sáng, mịn màng",40000,50000,10000,20
TIKI,lam-dep-suc-khoe,114467695,"Combo Dầu Gội X-Men Nước hoa Fire 650G và Sữa Tắm X-Men Nước hoa Fire 650G",382000,382000,0,0
TIKI,lam-dep-suc-khoe,38372056,"Viên uống Vitamin C sáng da, tăng cường đề kháng, giảm cảm cúm, cảm lạnh Mega We Care NAT C 1000 (30 viên)",138000,155000,17000,11
TIKI,lam-dep-suc-khoe,166389092,"Sữa tắm gội Romano cho nam 2 trong 1 Gentleman 180g",56000,65000,9000,14
TIKI,lam-dep-suc-khoe,119700381,"Bộ 6 Kem Đánh Răng Colgate Sensitive Pro Relief ngăn ê buốt và bảo vệ toàn diện 110g/hộp",359000,414000,55000,13
TIKI,lam-dep-suc-khoe,77339534,"Kem Đánh Răng Colgate Sensitive ngăn ngừa ê buốt toàn diện 110g/tuýp",65000,69000,4000,6
TIKI,lam-dep-suc-khoe,26096771,"Thực phẩm bảo vệ sức khỏe Maxxhair New hộp 30 viên- Bổ sung Vitamin và khoáng chất giúp tăng cường sức khỏe của tóc; giúp tóc mọc nhanh, chắc khỏe, suôn mượt và bóng đẹp, ngăn ngừa rụng tóc, đồng thời giúp thải độc do ảnh hưởng của các hóa chất sử dụng ch",226000,226000,0,0
TIKI,lam-dep-suc-khoe,71669650,"Tinh chất kháng mụn mờ thâm The INKEY List Niacinamide 30ml",329000,329000,0,0
TIKI,lam-dep-suc-khoe,50698010,"Serum dưỡng trắng da, mờ đốm nâu, đều màu da - Vitamin C, Vitamin E, Bisabolol - NNO VITE Mega We Care (30 viên)",390000,390000,0,0
TIKI,lam-dep-suc-khoe,36261358,"Kem tan mỡ Missha Hot Burning Perfect Body Gel Hàn Quốc",145000,159000,14000,9
TIKI,lam-dep-suc-khoe,77655821,"MÁY KHUẾCH TÁN TINH DẦU CỔ CAO MODEL 4G CAO CẤP CHUYÊN DỤNG - MÁY XÔNG TINH DẦU PHUN SƯƠNG, GIÚP TỎA HƯƠNG TINH DẦU, THƯ GIẢN, THÍCH HỢP DÙNG CHO PHÒNG LỚN - TẶNG KÈM REMOTE",286000,286000,0,0
TIKI,lam-dep-suc-khoe,14336296,"Combo 2 hộp nước uống vị hồng sâm Hàn Quốc 10 chai x 100ml",150920,154000,3080,2
TIKI,lam-dep-suc-khoe,83608793,"Kem đánh răng Colgate Thiên Nhiên 180g",50000,55000,5000,9
TIKI,lam-dep-suc-khoe,10771483,"Kem Dưỡng Ẩm Cho Da Khô Klairs Rich Moist Soothing Cream",450000,450000,0,0
TIKI,lam-dep-suc-khoe,13778270,"Tinh chất kích thích mọc tóc L’Oréal Serioxyl Denser Hair 90ml",931000,980000,49000,5
TIKI,lam-dep-suc-khoe,20201723,"NƯỚC SÚC MIỆNG KIN B5 LÀM SẠCH MẢNG BÁM VÀ PHỤC HỒI NƯỚU RĂNG 500ML",292000,292000,0,0
TIKI,lam-dep-suc-khoe,73574991,"Dego Pharma - Dầu gội sạch vảy gàu mảng trắng, hết ngứa chiết xuất thiên nhiên từ vỏ cây Zizyphus, sản xuất theo tiêu chuẩn và dưới sự giám sát của công ty dược phẩm Châu Âu (80ml)",192000,390000,198000,51
TIKI,lam-dep-suc-khoe,36768495,"Bàn chải thông minh Xiaomi Mijia T100 - Hàng nhập khẩu",208000,208000,0,0
TIKI,lam-dep-suc-khoe,272918313,"Omega 3-6-9 Úc Healthy Care Ultimate 1000mg Tạo sức khỏe cho tim, não, khớp, mắt và cải thiện da khô - QuaTangMe Extaste",413400,866000,452600,52
TIKI,thoi-trang-nu,108329137,"Áo Lót Nữ, Combo 2 Áo Lót Đúc Su Đệm Mỏng Phối Ren Siêu Quyến Rũ, Áo Ngực Su Không Gọng Không Đường May Thương Hiệu BAW Mã AN3721",159000,159000,0,0
TIKI,thoi-trang-nu,89560821,"Áo Khoác bomber summer, ÁO BOMBER NỈ IN CHỮ SUMMER, Áo Khoác Bomber Unisex, áo cardigan bomber phối màu, Áo cardigan nữ , áo cardigan nam , áo khoác cardigan nam nữ mặc vải nỉ ngoại chống nắng chống lạnh tốt",95000,95000,0,0
TIKI,thoi-trang-nu,118014408,"Đồ Lam Đi Chùa# Một Nút Nơ Phối # Quần Áo Nữ # Đồ Bộ Nữ",186000,186000,0,0
TIKI,thoi-trang-nu,172677701,"Váy ngủ nữ, váy 2 dây lụa mềm quyến rũ VILADY - V121 thiết kế siêu sang màu Trắng gạo, chất liệu lụa Pháp ( lụa latin) cao cấp",289000,400000,111000,28
TIKI,thoi-trang-nu,55211860,"Đồ Bơi Cặp Đồ Bơi Tay Dài Chống Nắng Kiểu Hàn Quốc AT173 MayHomes Đồ Bơi Nam Nữ",282240,288000,5760,2
TIKI,thoi-trang-nu,130867193,"Áo khoác hoodie trơn xanh form rộng/Nam nữ unisex Jaystoree",93000,93000,0,0
TIKI,thoi-trang-nu,125939310,"Đồ mặc nhà đồ ngủ nữ vải đũi nhăn mềm có túi cách điệu nút áo xinh xắn size từ 40-70kg",133000,133000,0,0
TIKI,thoi-trang-nu,152646087,"Đầm CS phối hoa sang trọng - DAM002",270000,270000,0,0
TIKI,thoi-trang-nu,98604901,"Quần gen bụng/ định hình body lưng vừa chống cuộn, nâng mông, mềm mịn cho nữ LYEQ015",189000,199000,10000,5
TIKI,thoi-trang-nu,169833290,"Áo quây/áo ngực nữ không dây/áo lót quây dây/áo ngực mặc váy cúp ngực nâng ngực, dây lưng mảnh cá tính khoe lưng trần gợi cảm và năng động (kèm quai/dây áo ngực trong) LYEA028",122550,129000,6450,5
TIKI,thoi-trang-nu,121038488,"váy maxi hở lưng, đầm maxi hở lưng đan dây",315000,315000,0,0
TIKI,thoi-trang-nu,68419614,"Áo Thun Nữ Màu Trắng Cổ Tròn Lên Dáng Phong Cách Siêu Đẹp",21000,21000,0,0
TIKI,thoi-trang-nu,62360188,"Quần Jeans Pha Sợi Cà Phê Aaa Jeans Dáng Skinny lưng cao  - UCSD COFFEE",549000,549000,0,0
TIKI,thoi-trang-nu,107393162,"Bộ Đồ Pijama Nữ Mặc Nhà, Quần Áo Ngủ Nữ Ngắn Tay Azuno BN196 Chất Liệu Cotton Lụa Cho Mùa Hè",275000,275000,0,0
TIKI,thoi-trang-nu,78918979,"Áo Sơ Mi Nữ Đẹp Hàn Quốc Kiểu Công Sở Điệu Họa Tiết Hoa HATI",178000,178000,0,0
TIKI,thoi-trang-nu,143306359,"Váy/đầm ngủ 2 dây sexy, ren hoa voan mỏng quyến rũ LYEN003",94000,99000,5000,5
TIKI,thoi-trang-nu,182308585,"ĐẦM HOA PHỐI DẬP LY TAY LỒNG ĐÈN - DAM 0019",219000,398000,179000,45
TIKI,thoi-trang-nu,82704480,"Bộ 5 Quần Lót Ren Sexy quyến rủ thương hiệu BAW, đính nơ xì teen mẫu QLN25",199000,199000,0,0
TIKI,thoi-trang-nu,182995569,"Đồ Bơi Hai Mảnh Nữ Tay Dài Quần Dài Họa Tiết Lovely Và Hoa Xinh AT228 MayHomes Long Sleeves And Long Pants Women Swimwear With UPF 50 Sun Protection",289100,295000,5900,2
TIKI,thoi-trang-nu,165106956,"Combo 2 quần lót ren nữ sexy cạp thấp, dây hông mảnh đầy gợi cảm ( màu ngẫu nhiên) LYEQ051",81700,86000,4300,5
TIKI,thoi-trang-nu,173449599,"Combo 2 quần đùi nữ mặc nhà thoải mái thoáng mát họa tiết ngẫu nhiên JAMANO",99000,140000,41000,29
TIKI,thoi-trang-nu,87642260,"Áo Lót Mút Mỏng Vừa Phối Ren Habpy Lady By Sabina HBXLP0001",229000,383000,154000,40
TIKI,thoi-trang-nu,84471379,"Áo khoác hoodie chống nắng 123SHOP dành cho nam nữ Thuê Trái Tim, Nỉ ngoại form rộng Có Dây Kéo unisex ulzzang",100000,100000,0,0
TIKI,thoi-trang-nu,4426799,"Quần thun dài nữ jogger Phúc An 3008_den",99000,99000,0,0
TIKI,thoi-trang-nu,98084034,"Áo thun unisex tay lỡ nam nữ form rộng, cổ tròn, oversize, cotton co giãn 4 chiều, họa tiết đa dạng, thoải mái khi mặc hàng ngày",159000,159000,0,0
TIKI,thoi-trang-nu,108857591,"Váy đầm voan thời trang Hàn Quốc dáng ngắn thắt eo trẻ trung dự tiệc, dạo phố (tay lỡ)",265000,265000,0,0
TIKI,thoi-trang-nu,74439423,"Quần Lót Nữ Lưng Cao Modal Phối Ren Active Miley Lingerie FDS-25",60000,109000,49000,45
TIKI,thoi-trang-nu,167597953,"Quần lót nữ cotton đúc su không đường may cao cấp chất liệu thun lạnh mềm mại kháng khuẩn được chọn màu mẫu Q1",35000,35000,0,0
TIKI,thoi-trang-nu,192650522,"YU CHERRY | Áo Pattern Flying Off Top YA416",390000,390000,0,0
TIKI,thoi-trang-nu,46654253,"Bikini Hai Mảnh Hoa Hồng Trẻ Trung Dễ Thương AT143 MayHomes",231830,239000,7170,3
TIKI,thoi-trang-nu,66487798,"Đồ lót liền thân sexy Đồ ngủ ren gợi cảm",54600,54600,0,0
TIKI,thoi-trang-nu,108896350,"Quần Tây nữ ống loe chất liệu tuyết mưa sang chảnh",80000,80000,0,0
TIKI,thoi-trang-nu,84119398,"Quần lót giấy mặc 1 lần KACHOO, 5 cái/bịch,thoáng mát, tiện lợi khi đi du lịch hay những ngày ấy",25870,25870,0,0
TIKI,thoi-trang-nu,75447661,"Đồ Bơi Nữ Tay Dài Quần Dài Nắng Hồng Ôm Thân Gợi Cảm AT204 MayHomes Pink Colored Long Sleeves And Long Pants Women Swimware Set, UPF 50 Sun Protection",391020,399000,7980,2
TIKI,thoi-trang-nu,83033277,"Áo Ngực Quai Trong Đệm Dày Mặc Đầm Hở Lưng Hở Vai",125000,185000,60000,32
TIKI,thoi-trang-nu,3579913,"Áo Ngực Triumph Sloggi ZERO WHU - Da (Size",529000,529000,0,0
TIKI,thoi-trang-nu,14378329,"Set áo hoa cổ yếm và chân váy ôm – MS0456D",420000,420000,0,0
TIKI,thoi-trang-nu,195549407,"Đầm xòe phối hoa ngực quyến rũ D025- Lady fashion",198000,390000,192000,49
TIKI,thoi-trang-nu,109567589,"Combo 5 Quần Lót Nữ Cotton Lưng Miley Lingerie - FDS1104",282000,475000,193000,41
TIKI,thoi-trang-nu,102743436,"Áo khoác DirtyCoins Print Cardigan, ÁO KHOÁC CARDIGAN BẢN PHỐI TƯƠI TRẺ LẪN HOÀI NIỆM CHO GEN Z, Áo cardigan nữ phong cách hàn quốc xinh xắn, áo khoác thu đông nữ chất liệu gân form rộng, vải đẹp không xù",99000,99000,0,0
TIKI,bach-hoa-online,59178463,"Cà phê Sáng tạo 2 (340gr)",80000,86363,6363,7
TIKI,bach-hoa-online,168561896,"Cà phê Trần Quang NGON cafe sữa uống liền bịch 24 gói",54000,54000,0,0
TIKI,bach-hoa-online,179921782,"Nước yến thật BRAND'S Không Đường",439000,439000,0,0
TIKI,bach-hoa-online,181134349,"Cà Phê Robusta Lâm Đồng Rang Mộc Nguyên Chất- Hộp 250Gr (Dạng Bột)",111000,130000,19000,15
TIKI,bach-hoa-online,189604485,"Cà phê phin giấy Robusta Lâm Đồng DalatFarm - Hộp 10 túi x 10 g",105000,110000,5000,5
TIKI,bach-hoa-online,176491668,"Combo 2 chai dầu ăn Ranee Golden 2 lít (2 lít/chai x 2 chai)",179000,270000,91000,34
TIKI,bach-hoa-online,46221303,"Trái cây sấy khô thập cẩm Huynh Đệ Tề Hùng 1kg ( 2 túi 500g)",122550,129000,6450,5
TIKI,bach-hoa-online,181000438,"Đặc Sản Sóc Trăng - Bánh Pía Chay Đậu Xanh Sầu Riêng Tân Huê Viên Lớn 500G, Bánh Pía Sóc Trăng Ăn Chay Không Trứng Muối",94500,105000,10500,10
TIKI,bach-hoa-online,74795579,"Combo 3 bịch cát vệ sinh cho mèo - Cát nhật 8L (được chọn mùi)",139999,139999,0,0
TIKI,bach-hoa-online,184429270,"Bột gạo lứt nguyên chất Goce - 180g (18 gói x 10g)",96000,120000,24000,20
TIKI,bach-hoa-online,1820321,"Bột ngũ cốc dinh dưỡng Calsome hương Sô cô la",63000,70000,7000,10
TIKI,bach-hoa-online,165947055,"Hạnh Nhân Mỹ Tách Vỏ Pams, Rang Nguyên Vị, Ăn Kiêng Giảm Cân, Ngũ Cốc Dinh Dưỡng Bà Bầu",122000,225000,103000,46
TIKI,bach-hoa-online,66948978,"Đặc Sản Phan Thiết - NướC MắM Nhỉ Làng Chài Xưa Truyền Thống Nhãn Đỏ Thùng 6 Chai Thủy Tinh 500Ml Cốt Nhỉ Đặc Biệt Vị Đậm Đà Gu Ông Bà Xưa Nước Mắm Nguyên Chất Sạch Nước Mắm Nhĩ Từ Thùng Lều Gỗ 100% Cá Cơm Tươi Muối Tinh Khiết Không Chất Bảo Quản",420000,590000,170000,29
TIKI,bach-hoa-online,146292090,"Ngũ cốc hạt ăn liền Granola Min Min, ngũ cốc dinh dưỡng dạng hạt ăn liền (hộp 500g)",190000,190000,0,0
TIKI,bach-hoa-online,65118142,"Bột gạo lứt đỏ (1Kg) Rang xay theo phương pháp thực dưỡng Ohsawa",95000,95000,0,0
TIKI,bach-hoa-online,115250922,"Bộ 6 túi thức ăn cho chó lớn dạng sốt Pedigree vị gà 130g",114000,114000,0,0
TIKI,bach-hoa-online,3747989,"Đặc Sản Phan Thiết - Nước Mắm Tĩn Cá Cơm Than Nhãn Xưa 41N ( Tĩn Gốm 500Ml) Sánh Đặc Thịt Cá, Không Chất Bảo Quản",275000,320000,45000,14
TIKI,bach-hoa-online,599733,"Trà Sữa Vị Trà Xanh Aik Cheong Matcha Café Art (12 Gói x 25g)",119000,129000,10000,8
TIKI,bach-hoa-online,57893764,"Yến Mạch Cán Mỏng DK Harvest Nhập Khẩu Úc - 2kg",119000,119000,0,0
TIKI,bach-hoa-online,70092877,"Hạt Điều Rang Muối Loại Vỡ Thương Hiệu SK FOOD - Combo 1Kg 2 Hũ",97000,129000,32000,25
TIKI,bach-hoa-online,21477025,"Bánh Mochi Nhân Khoai Môn Japanese Style Taro Mochi 210g",60760,62000,1240,2
TIKI,bach-hoa-online,189586825,"Cà phê phin giấy Arabica Cầu Đất DalatFarm - Hộp 10 túi x 10 g",131000,150000,19000,13
TIKI,bach-hoa-online,97377864,"Combo 3 gói Gia Vị Hoàn Chỉnh Barona - Bún Bò Huế 80g",54000,54000,0,0
TIKI,bach-hoa-online,57524251,"Cà phê nguyên chất Arabica Cầu Đất, cafe mộc rang xay Beemo 500g - Đắng ít, chua thanh, thơm, hậu vị ngọt",150000,210000,60000,29
TIKI,bach-hoa-online,181978846,"Đặc Sản Sóc Trăng - Bánh Hạnh Nhân Trứng Muối 300G, Bánh Hạnh Nhân Tân Huê Viên Sóc Trăng, Bánh Bột Đậu Trứng Muối, Bánh Kẹo Ăn Vặt",62100,69000,6900,10
TIKI,bach-hoa-online,76747171,"Trà vằng túi lọc lợi sữa - Giảm mỡ bụng Wonmom",69000,69000,0,0
TIKI,bach-hoa-online,88909463,"Mực xé tẩm gia vị siêu ngon - Hũ 200G hiệu TPS",89000,99000,10000,10
TIKI,bach-hoa-online,99350540,"Rong biển vụn rắc cơm hữu cơ Ipsoon 30g nhập khẩu Hàn Quốc",53000,59000,6000,10
TIKI,bach-hoa-online,64648273,"Lược Chải Lông Vệ Sinh Chó Mèo Màu Ngẫu Nhiên [Tặng Móc Dán Tường Treo Đồ]",38888,38888,0,0
TIKI,bach-hoa-online,8021230,"Ngũ cốc hoa quả Calbee Furugura Nhật Bản",137600,137600,0,0
TIKI,bach-hoa-online,11960475,"Ngũ Cốc Ăn Sáng Kellogg's Mueslix Harvest Fruit 375g",131000,138000,7000,5
TIKI,bach-hoa-online,184432853,"Bột cải xoăn Kale nguyên chất Goce - 60g (20 gói x 3g)",176000,220000,44000,20
TIKI,bach-hoa-online,190966039,"Combo 4 Hộp Bánh ChocoPie Tình ORION vị truyền thống 396G",233000,270000,37000,14
TIKI,bach-hoa-online,73667907,"Nhân Hạt Bí Xanh Smile Nuts (265g - 500g) | Nhân bí xanh đã nướng nguyên vị, hàng nhập khẩu 100",88000,108000,20000,19
TIKI,bach-hoa-online,270844874,"Sữa dành cho người tiểu đường Entrust Milk Bổ sung đầy đủ dinh dưỡng, cân bằng đường huyết, phòng loãng xương - QuaTangMe Extaste",490400,1022000,531600,52
TIKI,bach-hoa-online,85557163,"Combo 2 Lon Sữa Đặc Có Đường Creamer Premium Alphana nhập khẩu Malaysia Lon 500g Giàu Protein Vitamin A D3 B1 - Không Cholesterol - Nắp Khui Tiện Dụng",64000,78000,14000,18
TIKI,bach-hoa-online,51654679,"Hạt điều rang muối nhân trắng bể nửa sviet 500g",96000,96000,0,0
TIKI,bach-hoa-online,58797152,"Hạt Bí Xanh Đã Tách Võ (Đã Rang) TETE 500 gram",102000,103000,1000,1
TIKI,bach-hoa-online,68141542,"HẠT ĐIỀU VỎ LỤA RANG MUỐI CAO CẤP THƯƠNG HIỆU SK FOOD - HỘP 500G",99000,99000,0,0
TIKI,bach-hoa-online,92710926,"Bộ 12 túi thức ăn cho mèo Whiskas vị cá thu 80g",150000,150000,0,0
TIKI,cross-border-hang-quoc-te,185329850,"Thắt lưng da bò CAMEL khóa tự động cho nam",457000,457000,0,0
TIKI,cross-border-hang-quoc-te,207005187,"CAMEL CROWN Cốc Titan Cắm Trại Bộ Đồ Ăn Du Lịch Ngoài Trời Thiết Bị Nấu Ăn Dã Ngoại Đi Bộ Đường Dài Du Lịch",788000,788000,0,0
TIKI,cross-border-hang-quoc-te,189618718,"Túi ngủ du lịch dã ngoại ngủ trưa văn phòng CAMEL CROWN chất lượng cao (1.1KG & 1.35KG) Thích hợp trong 15 độ C đến 25 độ C",1023000,1023000,0,0
TIKI,cross-border-hang-quoc-te,190320464,"Giày chạy bộ nam CAMEL CROWN Lớp Có đệm không trượt Chịu mài mòn Thở nhẹ",961000,961000,0,0
TIKI,cross-border-hang-quoc-te,204601749,"Vỏ Bọc Ghế Ngồi Bàn Ăn Co Giãn Dày Dặn Tiện Dụng Cho Gia Đình",238200,238200,0,0
TIKI,cross-border-hang-quoc-te,214774935,"CAMEL CROWN 2 Người Mang Trang Bị Sau Lưng Lều Cắm Trại Chống Nước Siêu Nhẹ Mái Vòm Lều 190T Đi Bộ Đường Dài Lều Cho Du Lịch Ngoài Trời",1965000,1965000,0,0
TIKI,cross-border-hang-quoc-te,209568752,"Streetwear Casual Jogger Cargo Pants  Hiking Trousers Outdoor Gray_S",379000,379000,0,0
TIKI,cross-border-hang-quoc-te,191316017,"Đồ bơi Nữ CAMEL CROWN Bikini Hai Mảnh Tam Giác Sling",500000,500000,0,0
TIKI,cross-border-hang-quoc-te,17965475,"Steal Like an Artist: 10 Things Nobody Told You About Being Creative",438000,438000,0,0
TIKI,cross-border-hang-quoc-te,115902462,"Phích chuyển đổi sạc 3 chân - Giắc cắm điện chuyển đổi ổ 3 chấu thành 2 chấu",15000,15000,0,0
TIKI,cross-border-hang-quoc-te,186309101,"CAMEL CROWN Thảm Dã Ngoại Ngoài Trời Thảm Đi Chơi Mùa Xuân Dày Dặn Chống Thấm Nước Thảm Cỏ Chống Ẩm",1044000,1044000,0,0
TIKI,cross-border-hang-quoc-te,195520240,"Áo thun polo CAMEL áo thun có cổ mùa hè ngắn tay ve áoáo thun nam XBB192157",586000,586000,0,0
TIKI,cross-border-hang-quoc-te,170692846,"Sách - On Earth We're Briefly Gorgeous : A Novel by Ocean Vuong (US edition, paperback)",473000,473000,0,0
TIKI,cross-border-hang-quoc-te,176304381,"Sách - Tuesdays with Morrie: an Old Man, a Young Man, and Life's Greatest Lesson by Mitch Albom (US edition, paperback)",247650,247650,0,0
TIKI,cross-border-hang-quoc-te,113954381,"4 chiếc Giày chống thấm nước, chống trượt cho chó-Size",369000,369000,0,0
TIKI,cross-border-hang-quoc-te,203812989,"Quần đùi short gió nam CAMEL thể thao Basic trẻ trung năng động",403000,403000,0,0
TIKI,cross-border-hang-quoc-te,192709820,"30 Pieces Polymer Clay Tools Pottery Modeling Smoothing for Beginners with Carrying Case DIY Ceramic Clay Carving Tool Set Clay Tools",187000,187000,0,0
TIKI,cross-border-hang-quoc-te,205051050,"Áo Khoác Gió CAMEL Cho Nam Áo Áo Khoác Nam Mùa Đông Thể Thao Có Mũ Chống Gió Mùa Thu Nam Thường Ngày Áo Khoác Gió Chữ",1401000,1401000,0,0
TIKI,cross-border-hang-quoc-te,207966543,"Áo khoác nam CAMEL Mùa xuân và mùa thu áo khoác thể thao nam chống gió chống nước ngoài trời quần áo áo khoác leo núi quần áo",1530000,1530000,0,0
TIKI,cross-border-hang-quoc-te,11534299,"It Ends With Us",359000,359000,0,0
TIKI,cross-border-hang-quoc-te,102428769,"2 Piece Replacement  Wrist Strap for Misfit Ray Fitness Tracker",119000,119000,0,0
TIKI,cross-border-hang-quoc-te,17970237,"Picture Of Dorian Gray (Feb 03)",289200,289200,0,0
TIKI,cross-border-hang-quoc-te,46386341,"Sunnimix 1 Glockenspiel Đàn Xylophone Đập Nhựa Cứng Nhám Đầu Cái Vồ Gậy Be",244000,244000,0,0
TIKI,cross-border-hang-quoc-te,17970408,"How to Love (Mindfulness Essentials) - New Cover ",291000,291000,0,0
TIKI,cross-border-hang-quoc-te,248885790,"Đồ bơi một mảnh CAMEL CROWN thời trang tùy chọn kích thước dành cho nữ",807000,807000,0,0
TIKI,cross-border-hang-quoc-te,201628799,"Quần áo yoga CAMEL Phụ nữ hàng đầu của trang phục thể dục thể thao rộng rãi chạy áo mùa hè áo thun thể thao ngắn tay thoáng khí",548000,548000,0,0
TIKI,cross-border-hang-quoc-te,190320464,"Giày chạy bộ nam CAMEL CROWN Lớp Có đệm không trượt Chịu mài mòn Thở nhẹ",961000,961000,0,0
TIKI,cross-border-hang-quoc-te,165017868,"Sách - Seven Husbands of Evelyn Hugo : Tiktok made me buy it! by TAYLOR JENKINS REID (UK edition, paperback)",399000,399000,0,0
TIKI,cross-border-hang-quoc-te,7917829,"Good To Great: Why Some Companies Make The Leap",394000,394000,0,0
TIKI,cross-border-hang-quoc-te,191781146,"Sách - Beyond O.rder : 12 More Rules for Life by Jordan B. Peterson (UK edition, paperback)",396000,396000,0,0
TIKI,cross-border-hang-quoc-te,195282895,"Nước Uống Đẹp Da Liquid Collagen One Per Day Drink Mix Mỹ",589000,589000,0,0
TIKI,cross-border-hang-quoc-te,108227401,"Tấm bảo vệ màn hình chống ánh sáng xanh cho máy tính với khung hình 16: 9 -Size 14 "16 & 9",172000,172000,0,0
TIKI,cross-border-hang-quoc-te,151548619,"Sách - The Song of Achilles : Bloomsbury Modern Classics by Madeline Miller - (UK Edition, paperback)",439000,439000,0,0
TIKI,cross-border-hang-quoc-te,52834154,"Thông Gió Miếng Dán Mũi Cho Nghẹt Mũi Giảm Ngáy",167000,167000,0,0
TIKI,cross-border-hang-quoc-te,113401672,"Sách - Your Money or Your Life: 9 Steps to Transforming Your Relationship with Money and Achieving Financial Independence: Fully Revised and Updated by Vicki Robin,Joe Dominguez,Mr. Money Mustache - (US Edition, paperback)",529000,529000,0,0
TIKI,cross-border-hang-quoc-te,163159382,"Sách - The Concise Mastery by Robert Greene (UK edition, paperback)",354000,354000,0,0
TIKI,cross-border-hang-quoc-te,17966282,"Wine Folly: Magnum Edition",999000,999000,0,0
TIKI,cross-border-hang-quoc-te,113349197,"Sách - How to Fight by Thich Nhat Hanh Jason Deantonis - (UK Edition, paperback)",236000,236000,0,0
TIKI,cross-border-hang-quoc-te,190229589,"Vỉ 6 Hộp Chỉ Nha Khoa Oral-B Glide Advanced Multi-Protection Floss Mỹ 44m(hộp)",446000,446000,0,0
TIKI,cross-border-hang-quoc-te,109164159,"Túi đựng hành lí khi đi xe đạp, Túi Trunk, túi đặt yên sau xe đạp",464000,464000,0,0
TIKI,cross-border-hang-quoc-te,17966869,"The 48 Laws Of Power by Robert Greene",549000,549000,0,0
TIKI,cross-border-hang-quoc-te,205405312,"Áo Thun Lông Cừu Nam CAMEL, Áo Dài Tay Cổ Tròn Mùa Thu Áo Thun Ấm Áp Đơn Giản Mùa Đông",686000,686000,0,0
TIKI,cross-border-hang-quoc-te,170695688,"Sách - A Good Girl's Guide to Murder by Holly Jackson (US edition, paperback)",406000,406000,0,0
TIKI,cross-border-hang-quoc-te,201569105,"Quần áo tập yoga CAMEL 2022 mới mùa thu và mùa đông áo lông cừu quần áo thể dục quần áo thể thao quần áo thun dài tay phụ nữ",690000,690000,0,0
TIKI,cross-border-hang-quoc-te,174400333,"Sách - The Power of Geography : Ten Maps That Reveal the Future of Our World by Tim Marshall (UK edition, paperback)",384000,384000,0,0
TIKI,cross-border-hang-quoc-te,7917827,"Intelligent Investor, The",545000,545000,0,0
TIKI,cross-border-hang-quoc-te,11573091,"HOLY BIBLE: King James Version (KJV) Popular Gift & Award Black Leatherette Edition: Authorized King James Version (Bible Akjv)",439000,439000,0,0
TIKI,cross-border-hang-quoc-te,109435197,"Loa máy tính có cáp âm thanh 2 * 3,5mm cho Mic SADA V-103-Màu đen",416000,416000,0,0
TIKI,cross-border-hang-quoc-te,2043735,"The Culture Map: Decoding How People Think, Lead, And Get Things Done Across Cultures",481000,481000,0,0
TIKI,cross-border-hang-quoc-te,176463031,"Sách - Prisoners of Geography : Ten Maps That Tell You Everything You Need to Kn by Tim Marshall (UK edition, paperback)",394000,394000,0,0
TIKI,cross-border-hang-quoc-te,112018071,"Giá đỡ bánh xe đạp chuyên dụng chất lượng cao trong nhà có thể gập lại được",587000,587000,0,0
TIKI,cross-border-hang-quoc-te,273115068,"Christmas Tabletop Decorations Christmas Centerpiece for Home Office Kitchen",209000,209000,0,0
TIKI,cross-border-hang-quoc-te,114051039,"Sách - High Output Management by Andrew S. Grove - (US Edition, paperback)",469000,469000,0,0
TIKI,cross-border-hang-quoc-te,46362176,"Tai Thay Thế Miếng Lót Đệm Tai Nghe Sony MDR-V150 V250 V300 V100 V200 V400 ZX100 ZX300 Tai Nghe",157000,157000,0,0
TIKI,cross-border-hang-quoc-te,109435783,"Nút tai silicon Bluedio NE -40dB Giảm tiếng ồn Cách âm Bảo vệ tai Chống ồn khi ngủ và đi bơi",150000,150000,0,0
TIKI,dien-gia-dung,51200047,"Nồi Chiên Không Dầu Philips HD9745 (1500W) - Hàng Chính Hãng",4999000,5985000,986000,16
TIKI,dien-gia-dung,2890867,"Lò vi sóng inverter có nướng Panasonic PALM-NN-GD37HBYUE (23L) - Hàng chính hãng",4290000,4290000,0,0
TIKI,dien-gia-dung,230086770,"Máy Trộn Bột Đánh Trứng Đa Năng UNIE EM2 Cao Cấp Tiêu Chuẩn Đức Dung Tích 5 Lít Công Suất 1000 W - Hàng Chính Hãng",3029000,6039000,3010000,50
TIKI,dien-gia-dung,37709143,"Tông đơ cắt tóc KEMEI 1997",599000,599000,0,0
TIKI,dien-gia-dung,10369519,"[Hàng chính hãng]- Máy hút bụi dùng pin(18v) Makita DCL180ZB(chưa kèm pin sạc)",1269000,1269000,0,0
TIKI,dien-gia-dung,23411036,"Máy Hút Bụi DEERMA DX700 ( hàng nhập khẩu )",655000,658500,3500,1
TIKI,dien-gia-dung,176716144,"Quạt điều khiển và quạt nút vặn cơ- 3 Tốc độ- Hướng xoay và kích thước quạt điều chỉnh linh hoạt- Hàng chính hãng",680000,680000,0,0
TIKI,dien-gia-dung,101972521,"LƯỚI LỌC THÔ CHO MÁY LỌC KHÔNG KHÍ HAFELE/532.86.236 - HÀNG CHÍNH HÃNG (DÒNG MÁY CF-8116/ CF-8126S/ CF- 8209)",990000,990000,0,0
TIKI,dien-gia-dung,249859672,"Bình Thủy Giữ Nhiệt, Bình Thủy Điện KALITE KL-888 Pha Trà Pha Sữa, Mức Nhiệt Cài Sẵn Dung Tích 2.7 Lít Công Suất 2200 W - Hàng Chính Hãng",1999000,3989000,1990000,50
TIKI,dien-gia-dung,1860525,"Nồi Áp Suất Điện Đa Năng Sunhouse SHD1562 (6L) - Cafe - Hàng chính hãng",992000,992000,0,0
TIKI,dien-gia-dung,129750096,"Bộ chân đế ấm siêu tốc loại tốt-PT",30000,30000,0,0
TIKI,dien-gia-dung,66546602,"Máy Uốn Tóc, Ép Duỗi Tóc 2in1 PA001 Có Chỉnh Được Nhiệt Độ Giúp Duỗi Thẳng, Làm Xoăn 2in1 Chuẩn Salon tại Nhà",599000,599000,0,0
TIKI,dien-gia-dung,76124825,"Máy Xay Thịt Làm Giò Chả Ruốc, Xay Cua, Xay Cá Gia Đình NEWSUN 1 Kg/ Mẻ, Inox Cao Cấp, Công Suất 900W, Chân vuông",3050000,3050000,0,0
TIKI,dien-gia-dung,185495919,"Nồi cơm điện Sunhouse SHD8305 3L - Hàng chính hãng",979000,1580000,601000,38
TIKI,dien-gia-dung,143359444,"Bàn là quần áo hơi nước cầm tay, bàn ủi mini siêu tiện ích dễ dàng mang theo khi đi du lịch",60083,60083,0,0
TIKI,dien-gia-dung,39186205,"Bếp gas đôi dương Rinnai RV-375 SW(N) (Trắng)- Hàng chính hãng",967939,967939,0,0
TIKI,dien-gia-dung,165286204,"ĐẦU QUẠT ĐỨNG 3HT - HÀNG CHÍNH HÃNG",160000,160000,0,0
TIKI,dien-gia-dung,115324059,"Máy Xay Sinh Tố Cầm Tay YOICE REKKY (150W - 300ml- loại SẠC PIN ). máy xay sinh tố mini - Hàng Chính Hãng",292000,369000,77000,21
TIKI,dien-gia-dung,35242894,"Tông Đơ Cắt Tóc Philips HC3520 - Hàng chính hãng",1422000,1422000,0,0
TIKI,dien-gia-dung,20914429,"Máy xay sinh tố cối thủy tinh Comet CM9953 - Hàng chính hãng",455000,569000,114000,20
TIKI,dien-gia-dung,73607646,"Bếp gas mini nhỏ gọn, tiện lợi, chất liệu cao cấp dễ dàng mang theo khi đi du lịch, cắm trại ",73000,73000,0,0
TIKI,dien-gia-dung,50363603,"Bàn ủi du lịch xịn - Bàn là hơi nước mini hàng hiệu màu Trắng Sữa",530000,530000,0,0
TIKI,dien-gia-dung,95064261,"Máy lọc không khí Ozone Ion Âm 4 chế độ lọc không khí, khử mùi ,khử trùng cho nhà bếp,nhà vệ sinh ,phòng ngủ",375000,375000,0,0
TIKI,dien-gia-dung,101075601,"Nồi Chiên Không Dầu BIYI AF25A (6,4L) - Hàng Chính Hãng",1539000,2980000,1441000,48
TIKI,dien-gia-dung,186742016,"Bình Đun Siêu Tốc Panasonic NC-K301SRA (1,7 lít) - Hàng chính hãng",980000,1002000,22000,2
TIKI,dien-gia-dung,126863127,"Lõi Lọc PPCF Pureit Lavita Nóng Thông Minh (DIY) - Hàng Chính Hãng",446500,470000,23500,5
TIKI,dien-gia-dung,130063458,"Quạt treo Toshiba F-WSA20(H)VN - Hàng chính hãng",1490000,1490000,0,0
TIKI,dien-gia-dung,52789747,"Quạt điều hòa hơi nước 40 Lít  YH38A  mặt kính cường lực",1300000,1300000,0,0
TIKI,dien-gia-dung,128820551,"Máy xay hạt và phê và các loại hạt ngũ cốc Shardor CG638B công suất 150W - Hàng Nhập Khẩu",1005000,1005000,0,0
TIKI,dien-gia-dung,146097554,"Combo 3 lõi lọc nước Karofi 1,2,3 dùng cho máy S-S038 - Hàng chính hãng",175000,175000,0,0
TIKI,dien-gia-dung,51059438,"Ấm đun siêu tốc Sharp 1.7 lít EKJ-17EVPS-BK - Hàng chính hãng",529000,529000,0,0
TIKI,dien-gia-dung,186495131,"Nồi chiên không dầu điện tử Xiaomi Mi Smart Air Fryer 3.5 lít BHR4849EU MAF02 - Hàng chính hãng",1399000,2390000,991000,41
TIKI,dien-gia-dung,68692812,"Máy Lọc Trực Tiếp Đầu Vòi Eurolife EL-LS-D20 - Hàng Chính Hãng",578000,680000,102000,15
TIKI,dien-gia-dung,52695660,"Máy cạo râu Kemei 1102",199000,199000,0,0
TIKI,dien-gia-dung,188513963,"Linh kiện máy xay sinh tố công nghiệp của Osako Os-1800 1800W-hàng chính hãng",99000,99000,0,0
TIKI,dien-gia-dung,185578084,"Bàn ủi hơi nước Philips GC482 - Hàng Chính Hãng",1440000,1860000,420000,23
TIKI,dien-gia-dung,78487832,"Quạt Lửng Thân Sắt Senko LTS1632 - Màu ngẫu nhiên - Hàng Chính Hãng",485000,485000,0,0
TIKI,dien-gia-dung,121739784,"Nồi Chiên, Nướng, Quay Không Dầu Điện Tử BIYI AF-60A, Dung Tích Lớn 11L, màu đen - Hàng Chính Hãng",1769000,4290000,2521000,59
TIKI,dien-gia-dung,217291175,"Máy xay thịt đa năng SOKANY LB7005A 3L- Hàng chính hãng",474050,499000,24950,5
TIKI,dien-gia-dung,189702459,"Bộ chổi lăn thay thế Máy hút bụi lau sàn khô và ướt Roborock Dyad - Hàng chính hãng",590000,590000,0,0
TIKI,the-thao-da-ngoai,5777583,"Túi ngủ du lịch dã ngoại (Giao màu ngẫu nhiên)",117000,117000,0,0
TIKI,the-thao-da-ngoai,57010114,"Lều 2 Lớp 4 - 5 Người Dã Ngoại Phượt Cắm Trại Galaxy Store GSL07 Chống Nước Tốt - Màu Ngẫu Nhiên",1175000,1950000,775000,40
TIKI,the-thao-da-ngoai,136029752,"Tất Bóng Rổ, Tất Bóng Chuyền Chuyên Nghiệp V-pro. Dòng Tất Thể Thao Cao Cấp Có Độ Ôm Và Bảo Vệ Cổ Chân Tốt - Thấm Hút Mồ Hôi Và Rất Êm (1 Đôi)",85000,120000,35000,29
TIKI,the-thao-da-ngoai,75396049,"Khăn trùm đầu Ninja Fullface đi phượt (Màu đen)",15000,15000,0,0
TIKI,the-thao-da-ngoai,95524187,"Lưỡi Câu Cá Maruseigo Thép Trắng Siêu Cứng Cực Bén Không Gỉ Sét",40000,40000,0,0
TIKI,the-thao-da-ngoai,35454276,"Bao Tay, Găng Tay Tập Gym, Tập YoGa Cho Nam, Nữ Cao Cấp - GT002",136000,136000,0,0
TIKI,the-thao-da-ngoai,135815532,"Quả bóng đá EURO 2021 số 5, số 4 da PU - Tặng kim bơm bóng ( bóng may )",157000,157000,0,0
TIKI,the-thao-da-ngoai,104884872,"Bột Câu Cá Ngũ Vị Hương Hiệu Quả Với Cá Tra, Chép, Rô Phi Chuyên Dùng Ủ Cơm Thiu, Trộn Cháo Rết, Ủ Bún, Trộn Cám",55000,55000,0,0
TIKI,the-thao-da-ngoai,8493528,"Xà đơn gắn cửa cải tiến có chốt chống xoay (83cm-130cm) - Đen Xanh Dương",312000,344000,32000,9
TIKI,the-thao-da-ngoai,140333347,"Băng Đội Trưởng Captain C Bóng Đá",20000,20000,0,0
TIKI,the-thao-da-ngoai,67539013,"Đai bảo vệ, cố định khớp vai có điều chỉnh GoodFit GF702S  - Trái",149000,199000,50000,25
TIKI,the-thao-da-ngoai,111859855,"Bộ 5 Dây Ngũ Sắc Đàn Hồi Tập Gym, Tập Thể Hình Đa Năng Tại Nhà Amalife ",88000,88000,0,0
TIKI,the-thao-da-ngoai,146370515,"Dụng Cụ Hít Đất Chống Đẩy Đa Năng 14 Bài Tập – Dụng Cụ Chống Đẩy 18 Lỗ - Chính Hãng dododios",146000,146000,0,0
TIKI,the-thao-da-ngoai,149598355,"Dây cáp câu cá kèm sẵn lưỡi câu",2300,2300,0,0
TIKI,the-thao-da-ngoai,34278045,"Đai bó ống chân co giãn khi chơi thể thao loại dài (Màu ngẫu nhiên)",65550,69000,3450,5
TIKI,the-thao-da-ngoai,167025735,"Máy câu cá, câu tôm giá rẻ",40800,40800,0,0
TIKI,the-thao-da-ngoai,11378700,"Mũ nón chống nắng nam, mũ nón đi câu cá, cắm trại cho Nam – chống tia UV – bảo vệ da đầu",132000,132000,0,0
TIKI,the-thao-da-ngoai,60229542,"Dây Câu Cá Leader Daiwa D-Fron 100% Fluoro Carbon Cuộn 100m Made In Japan",278000,278000,0,0
TIKI,the-thao-da-ngoai,20847671,"Bật lửa Zippo 352B –Bật lửa Zippo Venetian Brass",1050000,1050000,0,0
TIKI,the-thao-da-ngoai,21299541,"TÚI NGỦ VĂN PHÒNG CAO CẤP EDENA 75CM X 190CM",370000,370000,0,0
TIKI,the-thao-da-ngoai,92806758,"La bàn cầm tay 4cm",15000,15000,0,0
TIKI,the-thao-da-ngoai,169984115,"Bộ quần áo bóng đá - Áo đấu các câu lạc bộ bóng đá MU, PSG, Mancity, Liverpool...  mùa giải 2022 - Bộ đồ đá banh",95000,150000,55000,37
TIKI,the-thao-da-ngoai,148823403,"Bộ Đôi Găng Bao Tay Đấm Bốc Trẻ Em 5-13 Tuổi Cao Cấp – Găng Tay Tập Boxing MMA Trẻ Em Chính Hãng Dododios",109000,109000,0,0
TIKI,the-thao-da-ngoai,146905558,"Mồi Câu Cá Dạng Viên Cám Câu Cá Trắm, Chép, Chôi, Rô Phi,..Loại Hạt To, Hạt Nhỏ Siêu Nhậy - thegioidocau",39000,39000,0,0
TIKI,the-thao-da-ngoai,59213855,"Giày Trượt Patin 2 Hàng Bánh Chính Hãng LongFeng Cho Trẻ Em Và Người Lớn",593000,593000,0,0
TIKI,the-thao-da-ngoai,33257269,"Thảm Yoga Fitness Adidas 7mm",810000,839000,29000,3
TIKI,the-thao-da-ngoai,148567017,"Mồi Câu Cá Giả Bằng Nhựa Mềm 90mm/14g MG-15",12200,12200,0,0
TIKI,the-thao-da-ngoai,49267678,"Gel Uống Bổ Sung Năng Lượng Và Vitamin ENERGY GEL BiotechuSA",600000,600000,0,0
TIKI,the-thao-da-ngoai,135539059,"Lọ chiết mỹ phẩm dầu gội du lịch Silicon 89ml",55000,55000,0,0
TIKI,the-thao-da-ngoai,191073426,"Kính bơi người lớn nam nữ + Mũ Bơi - hãng chính hãng dododios - Mã 2030",89000,89000,0,0
TIKI,the-thao-da-ngoai,33370060,"DỤNG CỤ KÌM BÓP TAY LÒ XO TẬP TAY CHẮC KHỎE",25000,25000,0,0
TIKI,the-thao-da-ngoai,87094552,"Vợt Tennis Babolat PURE STRIKE LiTE 265gram 3rd Gen (101408)",4106000,4490000,384000,9
TIKI,the-thao-da-ngoai,169692394,"Bộ Cần Câu Bút Mini 1M Fish Pen",229000,229000,0,0
TIKI,the-thao-da-ngoai,136826840,"Quần đùi chạy bộ AERDIDA137725 nhẹ,thoáng khí, khô nhanh",249000,249000,0,0
TIKI,the-thao-da-ngoai,161451921,"Bộ 2 vỏ tạ tay nhựa bát giác 5kg REEFIT (2 vỏ 5kg, tổng 10kg)",59000,59000,0,0
TIKI,the-thao-da-ngoai,17909353,"Bàn bóng bàn Đức Long TL-05",4400000,4400000,0,0
TIKI,the-thao-da-ngoai,272445832,"Sữa tăng cơ hương vị tự nhiên Rule 1 Protein Isolate/ Hydrolysate Naturally Flavored 1.68 - 1.72lb tặng Rule 1 Sample",700000,700000,0,0
TIKI,the-thao-da-ngoai,138898017,"Túi đeo bụng đựng điện thoại đi tập thể dục, chạy bộ",22106,31931,9825,31
TIKI,the-thao-da-ngoai,170758060,"Tăng Bạt Trải Dã Ngoại Naturehike NH15D004-X Thảm Dã Ngoại Đa Năng",195000,195000,0,0
TIKI,the-thao-da-ngoai,56407340,"GẬY TẬP THỂ LỰC SWING - PGM SOFT SWING BAR - HGB011",350000,550000,200000,36
TIKI,o-to-xe-may-xe-dap,25208495,"Máy bơm lốp ô tô 2 xilanh Air Compressor, Đèn LED, Có hộp đựng, bộ dụng cụ",456220,456220,0,0
TIKI,o-to-xe-may-xe-dap,127238506,"Thùng rác trên xe ô tô, loại nhỏ gắn cửa xe, gắn ghế sau",75000,75000,0,0
TIKI,o-to-xe-may-xe-dap,49537959,"Bơm hợp kim nhôm loại đạp chân dùng cho xe đạp, xe máy, ô tô, tặng kèm kim bơm banh và bơm thú hơi - Màu giao ngẫu nhiên",99000,99000,0,0
TIKI,o-to-xe-may-xe-dap,33544494,"Bộ 4 miếng dán chống đọng nước kính hông và gương chiếu hậu ô tô, xe hơi",58400,58400,0,0
TIKI,o-to-xe-may-xe-dap,125013850,"Combo Nhớt Xe Tay Ga và Nhớt Hộp Số Motul Scooter Power LE 5W40 Và Motul Scooter Gear Oil 120ml",211000,211000,0,0
TIKI,o-to-xe-may-xe-dap,1254625,"Chai Xịt Đánh Bóng Nhanh 3M Gloss Enhancer 39034LT (400ml)",152000,170000,18000,11
TIKI,o-to-xe-may-xe-dap,13644131,"Nước hoa sáp thơm kèm đèn led nháy, khử mùi hôi trong xe hơi,ô tô, phòng ngủ, phòng làm việc",36000,36000,0,0
TIKI,o-to-xe-may-xe-dap,22293088,"Găng Tay Xe Máy Oakley Có Gù Ngón Cụt - Xanh",65000,65000,0,0
TIKI,o-to-xe-may-xe-dap,50731632,"Thùng đựng đồ ở giữa dành cho xe Winner 150.",188000,188000,0,0
TIKI,o-to-xe-may-xe-dap,162227264,"Ắc quy khô miễn bảo dưỡng Đồng Nai PTZ5L | 12V - 4Ah",241000,241000,0,0
TIKI,o-to-xe-may-xe-dap,3665771,"Dầu bôi trơn chống rỉ sét đa năng 3M 5-W",79000,79000,0,0
TIKI,the-thao-da-ngoai,133772727,"Túi Ngủ Văn Phòng Du Lịch, Phượt Cá Nhân, Túi Ngủ Mùa Đông - 3 Lớp Cao Cấp - Gói Gọn Tiện Ích- Hàng Chính Hãng MINIIN",199000,199000,0,0
TIKI,the-thao-da-ngoai,108480875,"Mã hàng KT1.HT – Xà đơn xếp Khánh Trình hai tầng dành cho cả trẻ em và người lớn",1820000,1820000,0,0
TIKI,o-to-xe-may-xe-dap,32146027,"Máy sạc bình ắc quy 12V 5A FOXSUR 4-100Ah có khử sunfat phục hồi ắc quy",158000,180000,22000,12
TIKI,the-thao-da-ngoai,176166906,"Dây Nhảy FED XM0105 - Dây Nhảy Tăng Thể Lực Giúp Thân Hình Cân Đối Săn Chắc Và Đẹp - Hàng Chính Hãng",385000,450000,65000,14
TIKI,the-thao-da-ngoai,105791646,"Bảng phi tiêu 40cm  + 6 phi tiêu nam châm",430000,430000,0,0
TIKI,the-thao-da-ngoai,75722804,"Túi Đấm Bốc Boxing Cho Trẻ Em Hình Người Nhện Đỏ Size Trung 37*18*18 cm, Kèm 2 Găng Tay Cho Bé+Tặng Kèm Hình Dán",139000,139000,0,0
TIKI,the-thao-da-ngoai,213868966,"Sữa Tăng Cân Tăng Cơ Mass Tech Elite 6lbs (~2.72kg) - Nhiều Hương Vị - Hàng Nhập Khẩu Chính Hãng Muscletech - Kèm Quà Tặng",1495000,1875000,380000,20
TIKI,o-to-xe-may-xe-dap,131402469,"ĐÈN TRỢ SÁNG L4 ngắn 3 chế độ lắp cho xe máy xe đạp điện",79000,79000,0,0
TIKI,o-to-xe-may-xe-dap,82473496,"Bộ gối tựa đầu và dựa lưng cao su non cao cấp siêu đàn hồi",135000,135000,0,0
TIKI,o-to-xe-may-xe-dap,131531524,"Bọc yên xe đạp thể thao HT-SPORTS bọc silicone dày êm thoáng khí, có phản quang đi đêm tặng kèm bọc mưa",109000,109000,0,0
TIKI,o-to-xe-may-xe-dap,96910002," 2 miếng dán chống bám nước mưa trên kính hậu xe ô tô - hình bầu dục",24000,28700,4700,16
TIKI,the-thao-da-ngoai,180567273,"Đồ bơi nam quần lửng áo cộc tay đẹp",330000,330000,0,0
TIKI,the-thao-da-ngoai,185966772,"Bộ Tăng Dã Ngoại Cắm Trại Lục Giác Naturehike NH16T012-S",1490000,1490000,0,0
TIKI,the-thao-da-ngoai,254091226,"BỘ ĐÔI TẠ 30KG BG Tạ Tập Tay Đa Năng Điều Chỉnh 2 in 1 Kết Hợp Tạ Đẩy ( hàng nhập khẩu)",699000,999000,300000,30
TIKI,o-to-xe-may-xe-dap,62905859,"Máy Bơm Lốp Ô Tô, Xe Hơi Điện Tử Thông Minh YD787 tích hợp đèn pin",395000,395000,0,0
TIKI,o-to-xe-may-xe-dap,120562215,"Khóa Xe Máy Caps Lock Khóa Tay Ga Tay Phanh KH78 Shalla Tặng móc khóa hình búa",121109,121109,0,0
TIKI,the-thao-da-ngoai,89476448,"Bộ Tạ Loại 1kg bọc cao su (Tổng 2kg)",116000,230000,114000,50
TIKI,o-to-xe-may-xe-dap,7982124,"Bộ 4 Tấm Che Nắng Ô Tô",33000,33000,0,0
TIKI,the-thao-da-ngoai,92533531,"Mũ Bơi Người Lớn,Nón Bơi Cho Nữ Tóc Dài Chất Liệu 100% Silicon Co giãn,Chống Nước,Thoải Mái Đại Nam Sport",89000,150000,61000,41
TIKI,o-to-xe-may-xe-dap,105185009,"Khung biển số xe máy - viền trơn trắng, inox, meca chống nước",35000,35000,0,0
TIKI,o-to-xe-may-xe-dap,169885717,"[Vải Dù Dày Nặng 1kg3]Bạt Phủ - Áo Trùm Xe Máy Cao Cấp Vải Dù 2 Mặt Che Nắng, Mưa Giữ Xe Luôn Như Mới Vừa Tất Cả Loại Xe",135000,135000,0,0
TIKI,o-to-xe-may-xe-dap,126960923,"Bao Da Chìa Khóa Honda SH 2021, SH 2022, SH 350i (loại 2 nút bấm) handmade da thật",100000,100000,0,0
TIKI,the-thao-da-ngoai,92807916,"La bàn kim loại cầm tay bỏ túi 70mm ",33950,33950,0,0
TIKI,the-thao-da-ngoai,144611597,"Bình nước thể thao | Bình nước xe đạp thể thao Sahoo 700ml ",87000,87000,0,0
TIKI,the-thao-da-ngoai,76696769,"Thảm Fitness Yoga Adidas 10mm ADMT-11015",1098000,1208000,110000,9
TIKI,the-thao-da-ngoai,117391192,"Lưỡi Câu Cá Đôi Buộc Sẵn Chuyên Câu Đài",33000,33000,0,0
TIKI,the-thao-da-ngoai,143808230,"Đai dù (phụ kiện) cho dụng cụ kéo giãn đốt sống cổ, vật liệu vải dù DAIKC01",79000,79000,0,0
TIKI,o-to-xe-may-xe-dap,142783294,"Đèn Hậu Xe Đạp - Đèn Led Nháy Tín Hiệu Gắn Xe Đạp Giant Xe Đạp Thể Thao MTB Địa Hình Cảnh Báo An Toàn Trong Đêm Với 3 Chế Độ Sáng",61000,61000,0,0
TIKI,the-thao-da-ngoai,150342336,"Bó Cổ Chân, Băng Cổ Chân, Bảo Vệ Mắt Cá Chân, Bảo Vệ Tránh Băng Gân",69000,69000,0,0
TIKI,the-thao-da-ngoai,138725435,"Mồi câu cá giả mềm 90mm/14g có 6 màu",13300,13300,0,0
TIKI,o-to-xe-may-xe-dap,4698547,"Bọc chân chống xe máy",5900,5900,0,0
TIKI,the-thao-da-ngoai,55463985,"Ống lăn massage gai 33cm- CON LĂN MASSAGE TẬP YOGA GAI  Thể Dục Thẩm Mỹ Gym Massage Giãn Cơ Tập Tạ - Chất liệu EVA PVC Cao Cấp",200000,200000,0,0
TIKI,o-to-xe-may-xe-dap,34585636,"Cặp Đèn Xinhan Led L14 Gắn Vario , WINNER X và mọi loại xe máy BẢO LONG RACING",55000,55000,0,0
TIKI,o-to-xe-may-xe-dap,117201628,"Bộ nâng cổ xe đạp thể thao ",150000,150000,0,0
TIKI,the-thao-da-ngoai,188377225,"Phao câu đài Nano Tăm To Độ Ổn Định Cao Truyền Tin Nhanh Chính Xác PC28",29000,29000,0,0
TIKI,the-thao-da-ngoai,173277026,"Giày Thể Thao Nam Biti's Hunter Core 3D-Airmesh Grey DSMH08700XAL (Xám)",662000,736000,74000,10
TIKI,the-thao-da-ngoai,56866299,"Túi ngủ văn phòng du lịch V2108 (Giao màu ngẫu nhiên)",115000,115000,0,0
TIKI,the-thao-da-ngoai,20847679,"Bật lửa ZIPPO 207 –Bật lửa ZIPPO STREET CHROME",535000,535000,0,0
TIKI,the-thao-da-ngoai,89477087,"Xà Đơn – Xà kép Đa Năng EX30 Bản Cao Cấp Tiêu Chuẩn Phòng Gym(Tặng Kìm Bóp Cơ Tay 5-60kg)",2789000,5000000,2211000,44
TIKI,the-thao-da-ngoai,10785162,"Lều 2 Người Phượt Cắm Trại Du Lịch Galaxy Store Tetragon 2PLE01 Hàng Xuất Khẩu Châu Âu (Màu Ngẫu Nhiên)",579000,920000,341000,37
TIKI,the-thao-da-ngoai,177061983,"Bộ đồ chơi bóng rổ trẻ em",115000,115000,0,0
TIKI,o-to-xe-may-xe-dap,110483410,"Combo 3 Khăn lau xe ô tô Muses (33x70cm) - Màu ngẫu nhiên",78000,78000,0,0
TIKI,o-to-xe-may-xe-dap,122437189,"Chân Chống Xe Đạp Thể Thao Kiotool Thay đổi kích thước phù hợp với mọi dòng xe đạp địa hình",65000,65000,0,0
TIKI,the-thao-da-ngoai,34811029,"Banh Bóng Rổ Geru Cam",97000,97000,0,0
TIKI,o-to-xe-may-xe-dap,529456,"Xi Đánh Bóng Cana 100G",37000,37000,0,0
TIKI,o-to-xe-may-xe-dap,2788431,"Bọt biển rửa xe ô tô chuyên dụng (Màu ngẫu nhiên)",24000,24000,0,0
TIKI,o-to-xe-may-xe-dap,45555276,"Nước Hoa Grasse L'Esterel - Bulgarian Rose Bullsone HQST30 (110ml)",396000,396000,0,0
TIKI,o-to-xe-may-xe-dap,189632921,"Băng Keo 2 Mặt Dán Phụ Kiện Oto Xe Máy - Keo Nano Đỏ Siêu Dính",30000,30000,0,0
TIKI,the-thao-da-ngoai,111928268,"Bộ quần áo bóng đá câu lạc bộ Liverpool mùa giải mới - Áo bóng đá CLB ngoại hạng Anh - Bộ đồ bóng đá đẹp",95000,150000,55000,37
TIKI,the-thao-da-ngoai,271392535,"Viên Sủi GU ENERGY Hydration Drink Tabs - Ống 12 Viên - Bổ Sung Nước Và Điện Giải Khi Hoạt Động Thể Thao - Ống 12 viên",185000,185000,0,0
TIKI,o-to-xe-may-xe-dap,44884682,"Gối Tựa Đầu Cao Su Non Cho Mọi Loại Xe Ô tô",120000,120000,0,0
TIKI,o-to-xe-may-xe-dap,172167246,"Nước rửa kính đậm đặc Senfineco Windschield Cleaner 9964",48000,48000,0,0
TIKI,the-thao-da-ngoai,16997248,"Bình Nước Xếp Gọn Du Lịch Cắm Trại Dã Ngoại Naturehike NH14S002-T",90000,90000,0,0
TIKI,the-thao-da-ngoai,53926218,"Túi Đai Đeo Bụng Hông Chạy Bộ Có Ngăn Đựng Bình Nước JP1",175000,175000,0,0
TIKI,the-thao-da-ngoai,158615618,"Bàn Xếp Gấp Gọn Du Lịch Và Dã Ngoại Dễ Mang Theo Khi Đi Cắm Trại Picnic Ăn Uống Cùng Gia Đình - Hàng Chính Hãng",626000,626000,0,0
TIKI,the-thao-da-ngoai,162042284,"Giàn Tạ Đa Năng Zasami Có xà đơn xà kép gồm 1 đòn tạ 1m5 - Lựa chọn mức tạ đĩa nhựa ngẫu nhiên",5500000,7250000,1750000,24
TIKI,the-thao-da-ngoai,159906214,"Áo bơi nữ Zoggs Quay - 462347",430000,859000,429000,50
TIKI,the-thao-da-ngoai,38074373,"Găng Bao Tay Xỏ Ngón MMA Boxing Đấm Bốc Người Lớn Amalife - Găng Tay Xỏ Ngón MMA Cao Cấp",102000,102000,0,0
TIKI,the-thao-da-ngoai,152074922,"Ghế Vớt Tạ đa năng Zasami ",590000,850000,260000,31
TIKI,the-thao-da-ngoai,10689279,"Thảm tập yoga định tuyến PU Liforme 4.2mm",4197000,4617000,420000,9
TIKI,o-to-xe-may-xe-dap,107522197,"Bạt Phủ Toàn Xe 3 Lớp Chống Xước, Chống Nắng, Chống Cháy Cho Ô Tô",249999,249999,0,0
TIKI,o-to-xe-may-xe-dap,68480807,"Sáp thơm trang trí táp lô xe hơi, ô tô chạy bằng năng lượng mặt trời mô hình trực thăng",199000,259000,60000,23
TIKI,o-to-xe-may-xe-dap,157150852,"Chuông Xe Đạp Retro Thể Thao Nhỏ Gọn - Làm Bằng Hợp Kim Nhôm - Âm Thanh Vang 90 - 100dB Gắn Tay Lái (Ghi Đông) - Bigbull Retro Phụ Kiện Xe Đạp Chính Hãng",45000,45000,0,0
TIKI,o-to-xe-may-xe-dap,73364277,"1 Tấm Bạt Đệm Miếng Phủ Trùm Lót Che Yên Xe Máy SIZE LỚN Chống Nóng Nắng Mưa 3 Lớp Cao Cấp",48000,48000,0,0
TIKI,o-to-xe-may-xe-dap,87393586,"Túi xe đạp cao cấp,túi treo sườn xe đạp chống nước bọc cảm ứng phù hợp với mọi dòng xe - Thương Hiệu KIOTOOL",75000,75000,0,0
TIKI,the-thao-da-ngoai,146763912,"Gối Ngủ Du Lịch Chất Liệu Memory Foam Mật Độ Cao - Gối Ngủ Văn Phòng Thông Minh Cao Cấp Chính Hãng Dododios – Kèm Túi Vải Nhung Đựng Gối Ngủ Chữ U Văn Phòng",349000,349000,0,0
TIKI,the-thao-da-ngoai,83783760,"Dụng cụ cầm tay đa năng Leatherman Free T4 (12 tools)",1950000,1950000,0,0
TIKI,o-to-xe-may-xe-dap,20918089,"Bộ Combo Dưỡng sên Thunder Chain Lube 400ml, Vệ sinh sên MC-40 400ml tặng bàn chải chà sên 3D",112000,112000,0,0
TIKI,the-thao-da-ngoai,198522142,"Khung Hỗ Trợ Tập Lưng, Nắn Chỉnh Cột Sống, Khung Định Hình Cột Sống, Hỗ Trợ Điều Trị Thoát Vị Đĩa Đệm, Đau Lưng, Vai Gáy - Chính Hãng",95000,95000,0,0
TIKI,bach-hoa-online,72204051,"Thức Ăn Hạt Cho Mèo Thái Lan Hello Cat Tuna 1.2Kg - Tặng Lon Pate Hello Cat 190G",145000,145000,0,0
TIKI,bach-hoa-online,1987981,"Nước mắm truyền thống Lê Gia - Cốt đặc biệt 525ml",95000,95000,0,0
TIKI,bach-hoa-online,161497171,"Thùng 48 hộp sữa chua uống tiệt trùng TOPKID hương dâu tự nhiên TH True Yogurt 110ml (110ml x 48)",248417,248417,0,0
TIKI,bach-hoa-online,32951824,"Thùng Sữa đậu nành Fami Nguyên Chất ít đường (200ml x 36 Hộp)",157000,190340,33340,18
TIKI,bach-hoa-online,26039862,"Khô Heo Mix Tỏi Thơm Ngon Cay Cay TeTe Food 500 gram",92000,92000,0,0
TIKI,bach-hoa-online,135321742,"Bột Matcha Trà Xanh Dalat Farm - Túi 110Gr",137000,150000,13000,9
TIKI,bach-hoa-online,116699818,"Thùng 24 chai Nước Khoáng Thiên Nhiên Có Ga Đảnh Thạnh 430ml (Đảnh Thạnh Lạt)",180000,180000,0,0
TIKI,bach-hoa-online,154698865,"Trà atisô túi lọc, 100 tép, bịch, mẫu truyền thống, Thái Bảo",119000,119000,0,0
TIKI,bach-hoa-online,95735106,"Trà Xanh Hương Dứa DalatFarm - Túi 150Gr",51000,60000,9000,15
TIKI,bach-hoa-online,57805039,"Combo 2 gói Natural Gia Vị Nấu Phở Bò Sài Gòn Dh Foods",31400,31400,0,0
TIKI,bach-hoa-online,14934644,"Gạo Nhật hữu cơ cao cấp/ECOBA Sakura 1kg - Nấu cháo cho bé ăn dặm - Hạt tròn, cơm mềm dẻo ngọt - 100% Organic",120000,120000,0,0
TIKI,bach-hoa-online,181000510,"Đặc Sản Sóc Trăng - Bánh Pía Sóc Trăng Đậu Xanh Sầu Riêng Trứng Tân Huê Viên 600G, Bánh Pía Tân Huê Viên 5 Sao 1 Trứng",114660,117000,2340,2
TIKI,bach-hoa-online,161498328,"Thùng 48 hộp sữa chua uống tiệt trùng TOPKID hương dâu-chuối-lúa mạch tự nhiên TH True Yogurt 110ml (110ml x 48)",248417,248417,0,0
TIKI,bach-hoa-online,73088749,"Rượu Whisky Chivas Regal 12 375ml 39% - 41% - Kèm Hộp",379000,385000,6000,2
TIKI,bach-hoa-online,70567304," Gạo Lứt Đỏ Vinh Hiển - Gạo Lứt Đỏ Đóng Túi 1Kg Đạt Chuẩn Chất Lượng HACCP - Ngọt Cơm, Dinh Dưỡng ",42000,42000,0,0
TIKI,bach-hoa-online,146373242,"2 Hộp (1kg) Ngũ Cốc Granola Min Min _ Ngũ Cốc Hạt Ăn Liền Granloa Min Min (1hộp 500gr)",370000,370000,0,0
TIKI,bach-hoa-online,109488207,"Đặc Sản Phan Thiết - Nước Mắm Tôm Biển Làng Chài Xưa Hồng Ngọc Đại Dương 125Ml/Chai",19000,29000,10000,34
TIKI,bach-hoa-online,138101958,"Combo 2 Sản Phẩm Gạo  ST25 Túi 5Kg - Gạo Ông Cua, Đặc Sản Sóc Trăng",385000,385000,0,0
TIKI,bach-hoa-online,166092597,"Bánh Dinh Dưỡng AFC Vị Caramel Flan Mỏng Giòn 300g",52000,52000,0,0
TIKI,bach-hoa-online,126218819,"Cà phê Hoà tan 3 in 1 Goodmorning (bịch 24 gói x 20gr) Cafe sữa uống liền Trần Quang Coffee",52000,52000,0,0
TIKI,bach-hoa-online,269956157,"Đông Trùng Hạ Thảo Khô Thiên An Hộp 3gr Loại Thượng Hạng, Cao Cấp",220000,220000,0,0
TIKI,bach-hoa-online,54807081,"Đặc Sản Đồng Tháp - Trà Tâm Sen Dk Harvest Giúp An Thần, Giảm Mất Ngủ 200G",135000,145000,10000,7
TIKI,bach-hoa-online,31917897,"Sữa Bột Abbott Ensure Gold HMB Hương Vani (850g)",900000,900000,0,0
TIKI,bach-hoa-online,271685680,"Rượu Đông Trùng Hạ Thảo 700ml",180000,180000,0,0
TIKI,bach-hoa-online,271685732,"Đông Trùng Hạ Thảo Khô Thiên An Hộp 25gr Đóng Hộp Thủy Tinh Cao Cấp ***mua 3 tặng 1",220000,220000,0,0
TIKI,bach-hoa-online,90744761,"Combo 2 Túi Sữa Bột Nguyên Kem Hai Con Bò Đỏ (500g/túi)",95000,95000,0,0
TIKI,bach-hoa-online,165854443,"Hạt Dinh Dưỡng Tổng Hợp Mix 6 Loại Macca, Hạnh Nhân, Hạt Điều, Nhân Hạt Óc Chó, Hạt Bí, Nho Úc Pams",86000,168000,82000,49
TIKI,bach-hoa-online,58409812,"Cà phê Chế phin 1 (500gr)",112000,122810,10810,9
TIKI,bach-hoa-online,271682957,"Đông Trùng Hạ Thảo Khô Thiên An Hộp 10gr, Nấm Đông Trùng Loại Thượng Hạng, Cao Cấp ***mua 3 tặng 1",200000,200000,0,0
TIKI,bach-hoa-online,195194378,"[Thêm Macca + Óc Chó] Granola Nướng Chậm 2 Lần DK Harvest - Ngũ Cốc Giảm Cân, Eat clean, Tạp gym - Trọng lượng 250g/500g",89000,94000,5000,5
TIKI,bach-hoa-online,45812684,"Bột tía tô nguyên chất Goce - 72g (24 gói x 3g)",136000,170000,34000,20
TIKI,bach-hoa-online,140579049,"Mì Hảo Hảo Hương vị Tôm Chua Cay (Thùng 30 gói)",139000,139000,0,0
TIKI,bach-hoa-online,142471168,"Nồng độ cồn 4.7% - Thùng 24 lon bia Huda 330ml",275000,275000,0,0
TIKI,bach-hoa-online,32499359,"Mật Ong Hoa Rừng Tây Bắc Xuất Khẩu",78000,130000,52000,40
TIKI,lam-dep-suc-khoe,20701571,"Tinh dầu dưỡng tóc AURANE Softliss Fantastic Repair hair oil 125ml",123500,130000,6500,5
TIKI,bach-hoa-online,105736344,"Gạo  ST25 Lúa Tôm Túi 5Kg - Cơm mềm dẻo, vị ngọt, thơm ",205000,205000,0,0
TIKI,bach-hoa-online,45806849,"Bột cần tây nguyên chất Goce - 72g (24 gói x 3g)",152000,190000,38000,20
TIKI,bach-hoa-online,183335076,"Đặc Sản Sóc Trăng - Bánh In Đậu Xanh Sầu Riêng Tân Huê Viên Túi 10 Bánh 400G, Đặc Sản Bánh In Sóc Trăng Nhân Đậu Xanh, Sầu Riêng",70300,74000,3700,5
TIKI,bach-hoa-online,181000365,"Đặc Sản Sóc Trăng - Bánh Pía Kim Sa Siêu Trứng Đậu Xanh Trứng Muối Đặc Biệt 300Gr, BáNh PíA TâN Huê ViêN Sóc Trăng",67450,71000,3550,5
TIKI,lam-dep-suc-khoe,108535201,"Bao cao su Sagami White box - Có gai - Hộp 10 chiếc",120000,120000,0,0
TIKI,bach-hoa-online,171057893,"Bánh Gạo Lứt Ăn Kiêng Giảm Cân DK Harvest (170g/18 bánh) - 3 Vị (Lứt Huyết Rồng, Yến Mạch, Lứt Tím Than)",49000,49000,0,0
TIKI,lam-dep-suc-khoe,8057340,"Xà Phòng Giảm Mụn Lưng For Back 135g Nội Địa Nhật Bản",96000,98280,2280,2
TIKI,lam-dep-suc-khoe,91565658,"Combo 6 Băng Vệ Sinh Quần Peppy Shana Siêu Thấm Free Size (12 miếng)",79550,89000,9450,11
TIKI,bach-hoa-online,72505895,"Muối Chấm Hoa Quả 110g Dh Foods",21000,21000,0,0
TIKI,lam-dep-suc-khoe,106969437,"Dầu Gội Dược Liệu Nguyên Xuân Bồng Bềnh - Thơm Ngát Hương Hoa Tự Nhiên",78400,78400,0,0
TIKI,lam-dep-suc-khoe,137253587,"Máng Trainer ( Niềng răng chỉnh nha)|DỤNG CỤ NIỀNG RĂNG",56000,56000,0,0
TIKI,lam-dep-suc-khoe,176048170,"Thực phẩm bảo vệ sức khỏe Thảo mộc cải thiện cân nặng Slimming Care X3 ( số 2) hộp 15 viên - dành cho người béo lâu năm, cơ địa chai lì",473000,550000,77000,14
TIKI,lam-dep-suc-khoe,190290564,"Khẩu trang y tế VN95 an tâm, Lẻ 10 cái. sỉ thùng 500 cái, kháng khuẩn chống virus Corona chủng BA5, chuyên dụng cho bệnh viện",7000,7000,0,0
TIKI,lam-dep-suc-khoe,46643670,"Cho máy Oral-B Braun,  Bộ 4 đầu bàn chải đánh răng điện - Trẻ em, cho mọi loại máy - EB10A",115000,115000,0,0
TIKI,lam-dep-suc-khoe,76564284,"Xịt Họng Keo Ong 3T 25ml Giảm Đau Họng, Ho Khan, Ngứa Rát Họng",49500,99000,49500,50
TIKI,lam-dep-suc-khoe,169585264,"Obagi Retinol 1.0 (28g)",1280000,1750000,470000,27
TIKI,lam-dep-suc-khoe,192704831,"Kem che khuyết điểm Mochi Nhật Bản",99000,99000,0,0
TIKI,lam-dep-suc-khoe,74192960,"Máy Massage Cổ Vai Gáy Chuyên Sâu 3D KINGTECH KS460 - Hỗ Trợ Mát xa Đùi, Chân, Lưng Dưới - Tích Hợp Nhiệt Hồng Ngoại - Tiện Sử Dụng Tại Nhà, Văn Phòng, Du Lịch - Quà Tặng Tuyệt Vời Dành Cho Người Thân - Chính Hãng",1038000,1750000,712000,41
TIKI,lam-dep-suc-khoe,132081941,"Mặt Nạ Ngủ Dưỡng Ẩm Laneige Water Sleeping Mask EX",270000,310000,40000,13
TIKI,lam-dep-suc-khoe,190641506,"Sữa Rửa Mặt Dịu Nhẹ Cho Da Dầu CeraVe Foaming Cleanser 473ml",386000,455000,69000,15
TIKI,lam-dep-suc-khoe,11874956,"Viên Uống Cân Bằng Nội Tiết Tố, Cải Thiện Sinh Lý Nữ Marilyn (Hộp 30 viên)",198000,198000,0,0
TIKI,lam-dep-suc-khoe,8011746,"Tinh Chất Hàu Biển OYSTER MAN Tăng Cường Sinh Lý Nam, Cải Thiện Xuất Tinh Sớm, Yếu Sinh Lý (Hộp 30 Viên)",109500,219000,109500,50
TIKI,lam-dep-suc-khoe,188785183,"Saffron mật ong đông trùng hạ thảo Kingdom Herb chính hãng thượng hạng hộp 312g (tặng bình thuỷ tinh và cây lấy mật)",400000,789000,389000,49
TIKI,lam-dep-suc-khoe,29496992,"FLOSLEK PHARMA GEL RỬA MẶT DIỆT KHUẨN NGỪA MỤN ANTIBACTERIAL FACE CLEANSING GEL 200ML",277000,396000,119000,30
TIKI,lam-dep-suc-khoe,164410334,"Son Môi M.O.I Hồ Ngọc Hà Son Thỏi LOVE BY THUỲ TIÊN 2022 (Bản Giới Hạn)",249000,359000,110000,31
TIKI,lam-dep-suc-khoe,176296819,"Nước Cân Bằng Giảm Mụn Và Thông Thoáng Lỗ Chân Lông SVR Sebiaclear Micro - Peel 150ml",312000,390000,78000,20
TIKI,lam-dep-suc-khoe,118090021,"Bộ 2 Hộp Viên Sủi Bổ Sung Vitamin Berocca Performance Mango 10 Viên/Hộp",196000,196000,0,0
TIKI,lam-dep-suc-khoe,186272570,"Đôi Giày Chườm Nóng Thảo Dược Giảm Đau Bàn Chân Dùng Điện Phiên Bản Vỏ Đai Bằng Vải Da Lộn - Hapaku",995000,1300000,305000,23
TIKI,lam-dep-suc-khoe,270548759,"Omega 3 Úc Healthy Care Fish Oil giúp bổ mắt, kháng viêm, tốt cho trí não, tim mạch - QuaTangMe Extaste",378400,910000,531600,58
TIKI,lam-dep-suc-khoe,631026,"Dung dịch dưỡng ẩm tối ưu Hada Labo Advanced Nourish Lotion dùng cho da thường và da khô 170ml",168000,208000,40000,19
TIKI,lam-dep-suc-khoe,144208515,"Dầu gội khô Girlz Only Dry Shampoo 200ml",89000,89000,0,0
TIKI,lam-dep-suc-khoe,180303300,"Dầu chăm sóc da giúp cải thiện rạn da, mờ sẹo và đều màu da - BIO-OIL SKINCARE OIL (chai 200ml)",435000,460000,25000,5
TIKI,do-choi-me-be,177755610,"[602 CHI TIẾT-HÀNG CHUẨN] BỘ ĐỒ CHƠI LẮP GHÉP XẾP HÌNH Mô Hình Người Sắt,  ROBOT",189000,189000,0,0
TIKI,do-choi-me-be,248544526,"Lốc 6 lọ nước yến sào Nunest Kid 4 hương vị (70ml)",202000,202000,0,0
TIKI,lam-dep-suc-khoe,118089805,"Kem Chống Hăm Bepanthen Balm Dạng Kem Mỡ 30G/Tuýp",95500,95500,0,0
TIKI,lam-dep-suc-khoe,11625471,"Titan Gel Nga - Gel bôi trơn  tăng kích thước 50ml - hàng chuẩn Nga",230000,230000,0,0
TIKI,lam-dep-suc-khoe,10639651,"Thực Phẩm Chức Năng Heposal - Phục hồi tổn thương viêm gan xơ gan",350000,360000,10000,3
TIKI,lam-dep-suc-khoe,190119292,"Bấm Móng Tay Thép Carbon Chuyên Dụng KỀM NGHĨA B.939 - Lưỡi Cong (Loại Lớn)",27550,29000,1450,5
TIKI,lam-dep-suc-khoe,147420070,"Bộ quà tặng cho nam FULL-HOUSE BOX-Sữa tắm gội hương nước hoa 3in1 350ml & Dung dịch vệ sinh nam giới 50g & Gel rửa mặt Nano Curcumin 100ml",476000,595000,119000,20
TIKI,lam-dep-suc-khoe,34315213,"Dao Cạo Râu 2 Lưỡi Dorco TG 710YL-5P (05 Dao Cạo)",28000,28000,0,0
TIKI,do-choi-me-be,242526640,"MÔ HÌNH HÀ TRỤ TOKITO MUICHIRO - KIMETSU NO YAIBA - thanh gươm diệt quỷ - Cao 15,5cm",54900,54900,0,0
TIKI,do-choi-me-be,77655899,"Tìm cặp hình giống nhau phương tiện giao thông",93500,110000,16500,15
TIKI,lam-dep-suc-khoe,273217865,"Combo Máy khuếch tán/ máy xông tinh dầu Bí Ngô Lorganic FX2027 + tinh dầu sả chanh + tinh dầu cam Lorganic (10ml x2)",250000,400000,150000,38
TIKI,lam-dep-suc-khoe,76210034,"Combo 2 Tinh Dầu Sả Chanh 50ML (Lemongrass) + Tinh Dầu Oải Hương 50ML (Lavender) - Tinh Dầu TIDAMO Nguyên Chất Xông Phòng Giúp Thư Giãn, Thơm Phòng và Nâng Cao Sức Khỏe - Rất Tốt Khi Sử Dụng Với Máy Xông Tinh Dầu",184000,436000,252000,58
TIKI,lam-dep-suc-khoe,166369511,"Sữa tắm gội cho nam Romano 2 trong 1 Gentleman 650g",154000,191000,37000,19
TIKI,do-choi-me-be,157446182,"Áo khoác lông mềm có mũ cho bé trai bé gái",99000,200000,101000,51
TIKI,do-choi-me-be,45841290,"Bộ 4 thìa ăn dặm báo nóng Munchkin Mỹ tặng 5 túi zipper",189000,189000,0,0
TIKI,do-choi-me-be,134560687,"Balo bỉm sữa đựng đồ đa năng cho mẹ và bé , balo giữ nhiệt đựng đồ cho bé sơ sinh",95999,95999,0,0
TIKI,do-choi-me-be,127120446,"Quần áo búp bê 60 cm",60000,60000,0,0
TIKI,do-choi-me-be,71972984,"Thảm nằm chơi thông minh cao cấp cho bé Kinderkraft",1120000,1120000,0,0
TIKI,do-choi-me-be,58866536,"Sữa Tắm Gừng Nghệ Cho bé COCAYHOALA Với 9 Loại Thảo Mộc An Toàn, Lành Tính - Giúp Phòng Cảm, Tránh Gió, Giữ Ấm Cơ Thể chai 300ml",180000,180000,0,0
TIKI,do-choi-me-be,48897589,"Đồ Chơi Rubik Megaminx Biến Thể 12 Mặt Xoay Trơn",80000,80000,0,0
TIKI,lam-dep-suc-khoe,2775387,"Bao Cao Su Sagami Xtreme Super Thin (10 Cái / Hộp)",95000,95000,0,0
TIKI,do-choi-me-be,114852429,"Bộ đồ chơi câu cá gỗ 7 in 1 cho bé yêu",98900,98900,0,0
TIKI,do-choi-me-be,22304706,"Combo 2 bộ tã vải Đêm Siêu chống tràn BabyCute size S, M, L, XL, XXL - Giao mẫu ngẫu nhiên",260000,260000,0,0
TIKI,lam-dep-suc-khoe,2775397,"Bao Cao Su Có Gai Nhật Bản Sagami Extreme White (10 Cái / Hộp)",56000,56000,0,0
TIKI,do-choi-me-be,180847833," Xúc Xắc Xí Ngầu Trong Suốt Nhiều Màu Sắc Size 14 Mm",15000,15000,0,0
TIKI,do-choi-me-be,171666243,"Set 5 KÈN THỔI SINH NHẬT",16000,16000,0,0
TIKI,lam-dep-suc-khoe,53410887,"Cân Điện Tử Sức Khỏe Hình Chú Heo Xinh Xắn Dành Cho Gia Đình + Tặng kèm 1 thước dây",60191,60191,0,0
TIKI,do-choi-me-be,194182186,"Đồ bơi dáng lửng cho nữ và bé gái lớn size từ 38-75kg",275000,275000,0,0
TIKI,do-choi-me-be,194082754,"CHONG CHÓNG 3 TẦNG",79200,79200,0,0
TIKI,do-choi-me-be,127120653,"Đầm học sinh búp bê 60 cm",35000,35000,0,0
TIKI,do-choi-me-be,3774051,"Gói bột thông tắc hầm cầu M. phốt 300g Hando",25000,25000,0,0
TIKI,do-choi-me-be,72693652,"03 bộ tranh xếp hình 70 mảnh ghép khổ A3 – đồ chơi trí tuệ cho bé từ 3 tuổi – Combo 12",85000,110000,25000,23
TIKI,do-choi-me-be,21682818,"Tranh ghép gỗ 200 mảnh - Thế giới ô tô",49000,49000,0,0
TIKI,do-choi-me-be,148670228,"Set 4 Nút bần cho bé tập đóng đinh hoặc nút bình",12000,12000,0,0
TIKI,lam-dep-suc-khoe,126959538,"Serum hôi nách INOD Huyền Phi 5ml tác dụng triệt hôi nách, hôi chân , mồ hôi tay chân vĩnh viên",161400,161400,0,0
TIKI,do-choi-me-be,120784448,"Đồ bộ bé trai cộc tay BIGFOX - MISS MEOW size đại chất cotton phong cách Âu Mỹ in Báo GAME DAY 10 - 37 kg QATE",159000,200000,41000,21
TIKI,do-choi-me-be,32444316,"Đồ bộ 3D cho bé trai hình Supper Wing",139000,240000,101000,42
TIKI,do-choi-me-be,56596932,"Combo Viên rửa bát Finish 77 viên hương chanh + Nước làm bóng finish 750ml dùng cho máy rửa bát",399000,399000,0,0
TIKI,do-choi-me-be,43867118,"Đồ chơi gỗ,đồ chơi phát triển trí tuệ - Khóa Luban",39000,39000,0,0
TIKI,do-choi-me-be,51299324,"Áo thun Xe MC Queen bé trai",110000,110000,0,0
TIKI,do-choi-me-be,118014025,"Đồ Lam Đi Chùa # La Hán Cho Bé Iu # Đồ Bộ Bé Trai Gái # Quần Áo Bé Trai Gái",88000,88000,0,0
TIKI,do-choi-me-be,17041941,"Combo gối nằm + chặn vỏ đậu xanh Sunny (dành cho trẻ sơ sinh)",132000,132000,0,0
TIKI,do-choi-me-be,107018284,"Trống Bi Bô - Bé Nói Cười",90000,120000,30000,25
TIKI,do-choi-me-be,53088383,"Combo Bột Rửa Bát Finish Nhật 2,2kg + Bóng Finish 400ml + Muối Finish 1,2kg",600000,1276814,676814,53
TIKI,do-choi-me-be,168190330,"Combo 5 quần ngắn Babiboo họa tiết xinh xắn cho bé",180000,180000,0,0
TIKI,do-choi-me-be,53548111,"Bộ đồ chơi lắp ráp đường trượt và đội đua xe chó cứu hộ - Bãi đỗ xe chó cứu hộ (mẫu ngẫu nhiên)",239000,239000,0,0
TIKI,do-choi-me-be,152534382,"Ghép Hình 4 Mùa - Mùa Thu 24 Chi Tiết DK81076",95200,136000,40800,30
TIKI,do-choi-me-be,56741558,"Đồ Bộ Thun Ba Lỗ In 3D cho bé trai hình khủng long",139000,240000,101000,42
TIKI,do-choi-me-be,93754507,"Đồ Bộ Thun Lạnh Có Tay In 3D cho bé trai hình Đại Học Quái Vật",139000,240000,101000,42
TIKI,do-choi-me-be,123861521,"Bộ Thẻ Học Thông Minh 19 Chu Đề Loại To Song ngữ tiếng Anh loại chuẩn Glenn Doman Flashcard cho bé từ 0-6 tuổi",145000,145000,0,0
TIKI,do-choi-me-be,66393163,"Mũ lưỡi trai mỏ mềm bít đuôi cho bé từ 1 đến 3 tuổi gắn logo chữ Z kèm đục 3 lỗ sò ở mỏ kết độc đáo - Đỏ",130000,130000,0,0
TIKI,do-choi-me-be,125603951,"Combo 5 Bộ Xếp Hình ",50000,50000,0,0
TIKI,do-choi-me-be,174280412,"ÁO THUN BÉ TRAI NGẮN TAY CATRIO in PARK là áo phông trẻ em từ 9T_12T(32kg_50kg)",111200,111200,0,0
TIKI,thiet-bi-kts-phu-kien-so,11772926,"Cáp chuyển OTG TYPE-C ra USB 3.1 mở rộng kết nối cho điện thoại với USB, chuột, bàn phím, ổ cứng cắm ngoài",10400,10400,0,0
TIKI,thiet-bi-kts-phu-kien-so,81926706,"Bộ Găng tay chơi game cảm ứng bao ngón tay chống mồ hôi chống trượt",4800,4800,0,0
TIKI,thiet-bi-kts-phu-kien-so,3494769,"Miếng dán màn hình cường lực chống nhìn trộm full màn hình 3D Baseus cho iPhone 7 Plus/ iPhone 8 Plus - Đen - Hàng chính hãng",129999,259998,129999,50
TIKI,thiet-bi-kts-phu-kien-so,45586976,"Đế tản nhiệt COOLING PAD cho laptop - Hàng nhập khẩu",117850,117850,0,0
TIKI,thiet-bi-kts-phu-kien-so,178523954,"Pin dành cho tay cầm chơi game Xbox/ Xbox One S/ Xbox Series X",209000,209000,0,0
TIKI,thiet-bi-kts-phu-kien-so,16117576,"Pin điện thoại  BL-5C dành cho điện thoại 1202;1280;2255;1110;205;C2-00;6630;6681;2700c; ....",49000,49000,0,0
TIKI,thiet-bi-kts-phu-kien-so,108633882,"Củ sạc nhanh Baseus 30W, Củ sạc Baseus Si 30W, Củ sạc Baseus Super Si Quick Charger 30W dùng cho iPhone/ Samsung/ OPPO... (30W, Type C, PD/ QC3.0 Quick charger)",295000,319000,24000,8
TIKI,thiet-bi-kts-phu-kien-so,4594727,"Bộ Chuyển Tín Hiệu 2 CPU Dùng 1 Màn Hình KVM Switch USB Ugreen 30357 - Hàng Chính Hãng",345000,345000,0,0
TIKI,thiet-bi-kts-phu-kien-so,125594820,"Ốp Lưng ESR CLOUD SOFT Dành Cho iPhone 13 Mini, Iphone 13/ 13 Pro, 13 Pro Max - Hàng Chính Hãng",427500,450000,22500,5
TIKI,thiet-bi-kts-phu-kien-so,74555237,"Túi Đựng Phụ Kiện 1 Ngăn Chống Nước, Chống Sốc Cao Cấp – Túi Để Phụ Kiện Điện Thoại – Hàng Chính Hãng miDoctor",119000,119000,0,0
TIKI,thiet-bi-kts-phu-kien-so,161455925,"Ổ Cắm Điện Âm Bàn Tích Hợp Sạc Không Dây",1360000,1360000,0,0
TIKI,thiet-bi-kts-phu-kien-so,141050950,"Hộp Đựng Dành Cho Chuột Logitech MX Master/ Master 2S/ Master 3/ MX Lucas - Hàng Chính Hãng",98000,98000,0,0
TIKI,thiet-bi-kts-phu-kien-so,135716110,"Cường Lực Camera Dành Cho iPhone - Bảo Vệ Full Cụm Camera",44999,64000,19001,30
TIKI,thiet-bi-kts-phu-kien-so,178102405,"Bao Da Dạng Ví Dành Cho Samsung  A73, A53, A33, A23, A13 4G Hiệu Hanman Có Ngăn Thẻ- Hàng Chính hãng",114999,126498,11499,9
TIKI,thiet-bi-kts-phu-kien-so,13626136,"Bàn phím số không dây Mini Number Keyboard AZONE",75000,75000,0,0
TIKI,thiet-bi-kts-phu-kien-so,21078084,"Miếng Lót Chuột, Bàn Di Chuột, mouse pad cỡ lớn (80x30x0.3)",90000,90000,0,0
TIKI,thiet-bi-kts-phu-kien-so,15184032,"Bao Da Smart Case Gen2 TPU Dành Cho iPad 9.7 2018 - Hàng nhập khẩu",104999,209998,104999,50
TIKI,thiet-bi-kts-phu-kien-so,21163509,"Ốp lưng viền dẻo trong sần nhám trắng dành cho iPhone 6 vs iPhone 6s",29000,36990,7990,22
TIKI,thiet-bi-kts-phu-kien-so,104069956,"Lót chuột bàn di chuột siêu mềm mịn",5955,5955,0,0
TIKI,thiet-bi-kts-phu-kien-so,34495897,"Máy Trợ Giảng 4 IN 1 ROLTON K300 TẶNG Kèm Micro Không Dây Gài Tai AZONE - Hàng Nhập Khẩu",319000,379000,60000,16
TIKI,thiet-bi-kts-phu-kien-so,2010041,"Máy Nghe Nhạc Lossless Bluetooth Ruizu D02 8GB (2018)",550000,550000,0,0
TIKI,thiet-bi-kts-phu-kien-so,188543326,"Case Ốp Vỏ Hình Gương sóng Gradient dành cho Airpods 1/2/ Airpods 3/ Airpods Pro- Hàng chính hãng",94050,99000,4950,5
TIKI,thiet-bi-kts-phu-kien-so,147800518,"Gậy chụp ảnh tự sướng Mawa K07 - Tích hợp 3 chân tripod và remote bluetooth chụp từ xa - Hàng chính hãng",98993,138000,39007,28
TIKI,thiet-bi-kts-phu-kien-so,135715950,"Bộ 3 Vòng Bảo vệ Camera iPhone 13Pro, iPhone 13Pro Max - Chống Bụi, Hạn chế vân tay & Mờ Camera - Bảo Vệ Toàn Diện Cho Cụm Camera - Cực Phẩm 2021",66590,94000,27410,29
TIKI,thiet-bi-kts-phu-kien-so,51341102,"Bao da kèm bàn phím Bluetooth dành cho iPad Air 2 / iPad 6 Smart Keyboard",338999,338999,0,0
TIKI,thiet-bi-kts-phu-kien-so,70771922,"Bao da chống sốc cho Samsung Galaxy Tab S7 T870/ T875 thương hiệu DUX DUCIS Domo Series cao cấp - Hàng nhập khẩu",277000,277000,0,0
TIKI,thiet-bi-kts-phu-kien-so,9678974,"Bộ USB thu Bluetooth 5 in 1 cho dàn amply và loa",58400,58400,0,0
TIKI,thiet-bi-kts-phu-kien-so,185409734,"Tai nghe Bluetooth Lenovo HQ08 TWS chống nước HiFi Âm nhạc ,chơi game Tai nghe thể thao Bluetooth không dây-Hàng Chính Hãng",272000,289000,17000,6
TIKI,thiet-bi-kts-phu-kien-so,109947285,"Giá đỡ điện thoại để bàn, Máy tính bảng đa năng Hợp Kim Nhôm dành cho tất cả điện thoại thông minh - Hàng Chính Hãng PKCB",82000,179000,97000,54
TIKI,thiet-bi-kts-phu-kien-so,49559133,"Miếng Lót Chuột, Bàn Di Chuột, mouse pad anime Kimetsu no Yaiba - Diệt Qủy Cứu Nhân cỡ lớn (80x30x0.3)",90000,90000,0,0
TIKI,thiet-bi-kts-phu-kien-so,77403120,"Micro karaoke kèm loa bluetooth Mini, AUX, USB, microSD, FM, TWS - Hàng Chính Hãng",390000,799000,409000,51
TIKI,thiet-bi-kts-phu-kien-so,550407,"Bộ Chuyển Đổi Bluetooth Logitech Receiver - Hàng Chính Hãng",669000,669000,0,0
TIKI,thiet-bi-kts-phu-kien-so,160843325,"Ghế game, ghế gaming phiên bản giới hạn, ghế xoay văn phòng mẫu mới nhất năm 2022 có kèm video và ảnh thật",1179000,1179000,0,0
TIKI,thiet-bi-kts-phu-kien-so,72573302,"Ốp lưng dẻo mỏng màu xanh dương dành cho iPhone X / XS  - Hàng chính hãng",39000,45000,6000,13
TIKI,thiet-bi-kts-phu-kien-so,190707857,"Miếng dán kính cường lực full 3D cho Samsung Galaxy S22 Ultra hiệu Nillkin CP+ Max (Mỏng 0.3mm, Kính ACC Japan, Chống Lóa, Hạn Chế Vân Tay) - Hàng nhập khẩu",232990,232990,0,0
TIKI,thiet-bi-kts-phu-kien-so,24633902,"Đầu chuyển Type-C 3.1 ra cổng LAN RJ45 hiệu CHOETECH HUB-R01 cho điện thoại Macbook (Kết nối mạng có dây, thiết kế nhỏ gọn, tốc độ cao) - Hàng chính hãng",329000,329000,0,0
TIKI,thiet-bi-kts-phu-kien-so,22380700,"Dây 2 Đầu HDMI 3m Unitek - Cáp HDMI 3m Unitek Full HD 4K - Hàng nhập khẩu ",86000,91900,5900,6
TIKI,thiet-bi-kts-phu-kien-so,99618665,"Đế Sạc Dành Cho Tay Cầm PS5/Playstation 5",248000,248000,0,0
TIKI,thiet-bi-kts-phu-kien-so,100910755,"Đôi loa bass 30 cho loa karaoke và nghe nhạc Hải Triều (hàng chính hãng) 1 cặp ",649000,649000,0,0
TIKI,thiet-bi-kts-phu-kien-so,53727656,"Micro karaoke không dây màn hình LCD Zansong V12 (hàng nhập khẩu)",220000,220000,0,0
TIKI,dien-gia-dung,21177085,"Bếp Ga Mini Du Lịch INOX",125000,125000,0,0
TIKI,dien-gia-dung,128116608,"Bếp Hồng Ngoại Lock&Lock EJI341 (Model 2021) - Hàng Chính Hãng",1199000,2000000,801000,40
TIKI,dien-gia-dung,187641895,"Quạt tích điện mini để bàn, quạt tích điện mini gấp gọn, quạt tích điện mini cao cấp Super Q18 có 3 chế độ làm mát, có thể xoay 180 độ sử dụng trong nhiều giờ, quạt mini, quạt sạc điện, quạt cầm tay",52999,52999,0,0
TIKI,dien-gia-dung,173251811,"Máy xay thịt Kangaroo KG12T (1.2 Lít) - Hàng chính hãng",777000,1200000,423000,35
TIKI,dien-gia-dung,88085663,"LƯỠI DAO THÔNG MINH CỦA MÁY XAY THỊT ĐA NĂNG",32999,32999,0,0
TIKI,dien-gia-dung,116877695,"Nồi cơm điện Cuckoo 3 lít CR-1720/SIVNCV màu bạc - Hàng chính hãng",2090000,2410000,320000,13
TIKI,dien-gia-dung,56225103,"Quạt bàn đảo 4 Tấc chuyển hướng điện cao cấp Senko BD1410 ( Hàng Chính Hãng )- Giao màu ngẫu nhiên",465000,465000,0,0
TIKI,dien-gia-dung,448841,"Máy Sấy Tóc Panasonic PAST-EH-ND11-A645 - Hàng Chính Hãng",272000,300000,28000,9
TIKI,dien-gia-dung,242406040,"Nồi Chiên Không Dầu, Nồi Chiên Hơi Nước KALITE STEAM STAR Tích Hợp 10 Chương Trình Nấu Dung Tích 15 Lít Công Suất 1800 W - Hàng Chính Hãng",3999000,7969000,3970000,50
TIKI,dien-gia-dung,48952752,"Máy tạo ẩm cá nhân BONECO U50 Dùng Cho Xe Hơi/Xe Đẩy Em Bé/Bàn Làm Việc - Hàng nhập khẩu",1250000,1250000,0,0
TIKI,dien-gia-dung,44371240,"Nồi cơm điện tử Panasonic SR-CL188WRA 1.8 lít / SR-CL108WRA 1 lít - Hàng chính hãng",2300000,2300000,0,0
TIKI,dien-gia-dung,68419791,"Tông đơ cắt tóc Xiaomi Enchen Boost - Enchen Boost Hair Clipper - Hàng Nhập Khẩu",189000,209000,20000,10
TIKI,dien-gia-dung,162865713,"Quạt đứng Kangaroo KG725 (55W) - Hàng Chính Hãng",809000,1329000,520000,39
TIKI,dien-gia-dung,115243711,"COMBO 3 LÕI LỌC NƯỚC SỐ 1-2-3 (PP - CTO - PP) - HÀNG CHÍNH HÃNG ĐẠI VIỆT",120000,120000,0,0
TIKI,dien-gia-dung,178549512,"Quạt Mini Tích Điện Đeo Cổ Thời Trang Besti Y01,  3 Tốc Độ Gió Siêu Mát, Chạy Siêu Êm, Dung Lượng Pin 2000mAh, Phù Hợp Khi Chạy Bộ, Đi Du Lịch , Văn Phòng, Đi Chơi- Hàng Chính Hãng",220000,220000,0,0
TIKI,dien-gia-dung,262758706,"Máy cạo râu 3 lưỡi Panasonic ES-SL41-S453 - Hàng Chính Hãng",1590000,1599000,9000,1
TIKI,dien-gia-dung,37131076,"Bình tạo nước icon kiềm Hydrogen 430ml",834000,834000,0,0
TIKI,dien-gia-dung,188785423,"Máy Xay Sinh Tố Mini Cầm Tay Sử Dụng Pin Sạc Cổng USB, Máy Xay Mini 6 Lưỡi Siêu Tiện Lợi - Hàng chính hãng MINIIN (Giao màu ngẫu nhiên)",178000,199000,21000,11
TIKI,dien-gia-dung,185411479,"Bình Đun Siêu Tốc 2 Lớp Damas DK-6018 1.8L - Trang Bị Công Nghệ Giữ Nhiệt 3 Lớp Hiện Đại, Bộ Cảm Biến Nhiệt Đạt Chuẩn EU - Công Suất Lớn 1800W Sôi Nhanh Chỉ Trong 6 Phút - Thiết Kế Bề Mặt Bên Trong Bằng Thép Không Gỉ Inox 304 Cao Cấp - Hàng Nhập Khẩu",391000,700000,309000,44
TIKI,dien-gia-dung,21327173,"Bếp Nướng Không Khói-Bếp Nướng Điện",168000,168000,0,0
TIKI,dien-gia-dung,101995241,"Máy hàn miệng túi nilon, túi zip chuyên dụng vỏ nhựa 200x2 ( màu trắng)",298000,298000,0,0
TIKI,dien-gia-dung,59097386,"Quạt Lỡ Sắt Senko LS1630 - Màu Ngẫu Nhiên - Hàng Chính Hãng",385000,385000,0,0
TIKI,dien-gia-dung,205819654,"Máy vắt cam Mitomo VC-55Pro Bảo hành 3 năm xuất xứ thái lan",759000,1288999,529999,41
TIKI,do-choi-me-be,140628018,"Sữa Tắm Gội Cho Bé Công Nghệ Anh Quốc Tami Natural 2 Trong 1 An Toàn Dịu Nhẹ 350ml",79000,123200,44200,36
TIKI,dien-gia-dung,130780467,"Máy hút bụi cầm tay sạc pin không dây SeaSy R6053 công suất mạnh 120W dùng cho gia đình hút bụi giường đệm, ghế ô tô - Hàng chính hãng",499000,499000,0,0
TIKI,dien-gia-dung,123433395,"Cánh quạt hộp cánh quạt tản sải cánh 300mm - 350mm-Giadung24h",32000,32000,0,0
TIKI,dien-gia-dung,149178837,"Máy Xay Sinh Tố Mini Cầm Tay 300ml 4 Lưỡi Dao Thép Không Gỉ Có Pin Tích Hợp Sạc USB Bugu BG-JS2 - Hàng Chính Hãng",271000,329000,58000,18
TIKI,dien-gia-dung,146630136,"Nồi lẩu mini, ca nấu mì, Nồi Lẩu Điện Đa Năng Mini 2 Tầng Cao Cấp Núm Xoay 2 Nấc Nhiệt Tặng Kèm Giá Hấp 1,8L - Chính Hãng dododios - Logo ngẫu nhiên trên thân nồi, ca nấu mỳ đa năng mini",109000,109000,0,0
TIKI,dien-gia-dung,689250,"Ấm Đun Siêu Tốc LOCK EJK418SLV -Hàng Chính Hãng",469000,800000,331000,41
TIKI,dien-gia-dung,15252783,"Tông Đơ Cắt Tóc Hàn Quốc CODOL 531 TẶNG KÈM Bộ Kéo Cắt Tỉa Chuyên Nghiệp ",219000,219000,0,0
TIKI,do-choi-me-be,54008653,"Mộc Cầm Baby Rock Star",62000,126000,64000,51
TIKI,dien-gia-dung,19755982,"Quạt tháp Tiross TS9182 (35W) - Hàng Chính Hãng",3160000,3990000,830000,21
TIKI,do-choi-me-be,148899565,"Ghế Gội Đầu Cho Bé Từ 2 đến 12 Tuổi",109000,109000,0,0
TIKI,do-choi-me-be,117786314,"Quả Bóng Biến Hình Đĩa Bay UFO Cho Bé",69000,69000,0,0
TIKI,do-choi-me-be,107979634,"Bộ 2 muỗng tập ăn cho bé kuku ku5439",68250,75000,6750,9
TIKI,do-choi-me-be,271759944,"Mũ tròn họa tiết SMILE Chất Bông mềm mịn kiểu dáng hàn quốc cho bé 2 tuổi - 6 tuổi",84500,84500,0,0
TIKI,do-choi-me-be,140817755,"Combo Tiết Kiệm - Bộ 2 Túi Nước Rửa Bình Sữa Arau Baby 450ml tặng 1 Cọ Rữa Bình Sữa Nhật Bản màu Xanh Trắng",255000,255000,0,0
TIKI,do-choi-me-be,267099992,"Balo teen Mr Vui BLTEEN946 phù hợp cho học sinh cấp 2 (40 x 29 x 14 cm)",418500,465000,46500,10
TIKI,dien-gia-dung,140136287,"Máy Phun Sương Tạo Ẩm Mini Xông Hơi Nước 380ml KONKA KZ-HU0001(B) - Hàng Chính Hãng",135000,185000,50000,27
TIKI,do-choi-me-be,99869529,"Lều công chúa, lều hoàng tử mẫu mới cho bé LOẠI TO (Hàng cực chất) lưu ý Không kèm phụ kiện trang trí",278000,278000,0,0
TIKI,do-choi-me-be,36661806,"Đồ chơi lắp ghép STEM- Xe tải chở hàng chạy bằng cót",55250,65000,9750,15
TIKI,do-choi-me-be,59522378,"Đồ bộ bé trai - Xe đua",155000,155000,0,0
TIKI,do-choi-me-be,196204875,"BALO CHỐNG GÙ CHO BÉ MẪU GIÁO MR VUI 896 CHO BÉ TRAI VÀ BÉ GÁI",236000,295000,59000,20
TIKI,do-choi-me-be,21859646,"Ghép hình gỗ 16 mảnh - Combo 5 tranh bộ Elsa",40000,40000,0,0
TIKI,do-choi-me-be,115288015,"ÁO THUN BÉ TRAI NGẮN TAY CATRIO hình mũ du hành, màu ĐỎ là áo phông trẻ em từ 9 tuổi đến 18 tuổi (30kg 40kg đến 70kg) thuộc BST quần áo trẻ em CATRIO du lịch hè năm 2021",111200,111200,0,0
TIKI,do-choi-me-be,56703887,"Đồ bộ ba lỗ 3D cho bé trai hình siêu xe",125000,200000,75000,38
TIKI,dien-gia-dung,66727944,"Máy xay sinh tố cầm tay Philips HR2537 (650W) - Hàng chính hãng",1220000,1690000,470000,28
TIKI,dien-gia-dung,162841495,"Máy cạo râu khô và ướt Philips S1103/02 - Hàng Chính Hãng",664000,764000,100000,13
TIKI,dien-gia-dung,157241885,"Bộ lõi máy lọc nước KAROFI Smax hiệu suất cao HP 6.2 - Hàng chính hãng",889000,889000,0,0
TIKI,dien-gia-dung,1754771,"Bình thủy điện thép không gỉ Comet CM3217 3.4 Lít (Bạc) - Hàng Chính Hãng",829000,1100000,271000,25
TIKI,do-choi-me-be,242528561,"Mô hình Kimetsu No Yaiba - Mô hình thanh gươm diệt quỷ - Thủy trụ Tomioka Giyuu - Giyu - Cao 16cm",55000,55000,0,0
TIKI,do-choi-me-be,242526930,"Mô hình Kimetsu No Yaiba - Mô hình thanh gươm diệt quỷ - Agatsuma Zenitsu - Cao 16cm",54000,54000,0,0
TIKI,do-choi-me-be,52052246,"Nước làm bóng finish 800ml dùng cho Máy rửa bát chén",135000,135000,0,0
TIKI,do-choi-me-be,151611540,"ĐỒ CHƠI GỖ - BỘ ĐỒ CHƠI XE CẦU TRƯỢT 4 TẦNG BẰNG GỖ",145000,145000,0,0
TIKI,do-choi-me-be,83489131,"Đồ Bộ Thun Có Tay In 3D cho bé trai hình Minecraft",139000,240000,101000,42
TIKI,dien-gia-dung,426242,"Nồi Tiềm Korea King KSC-30R (3L) - Hàng chính hãng",859000,859000,0,0
TIKI,dien-gia-dung,77985981,"Máy Xay Thịt Cối Inox 3 Lít Midimori (800W) - Hàng Chính Hãng",529000,849000,320000,38
TIKI,do-choi-me-be,168919599,"BÀN CHẢI ĐÁNH RĂNG CHỮ U SILICON CHÍNH HÃNG KICHILACHI",42000,42000,0,0
TIKI,do-choi-me-be,2627105,"Bộ thìa nĩa tập ăn cho bé Palm Grasp Marcus & Marcus, từ 18 tháng",208000,208000,0,0
TIKI,dien-gia-dung,51626369,"Tông đơ bấm viền cao cấp kemei 1949 vỏ nhôm nguyên khối pin LITHIUM 1400mah-hãng phân phối",350000,369000,19000,5
TIKI,do-choi-me-be,107404777,"Màn chụp cho bé",153000,153000,0,0
TIKI,do-choi-me-be,44728959,"Nón snapback hiphop cho bé từ 2 đến 6 tuổi, phong cách năng động cho bé yêu nhà bạn, thiết kế mỏ bằng, màu sắc hoạt tiết nổi bật bắt mắt",30000,30000,0,0
TIKI,dien-gia-dung,248703729,"Nồi điện mini đa năng Bear 1.2L (kèm khay hấp) nồi lẩu điện mini, Anh Lam Store - Hàng chính hãng",386000,425000,39000,9
TIKI,dien-gia-dung,172573484,"Quạt Treo Tường 3 Cánh Midea FW40-6H (Công Suất 55W - 3 Cấp Gió) - Hàng Chính Hãng",1170000,1170000,0,0
TIKI,do-choi-me-be,45423922,"Combo 5 Tranh Ghép 20 Mảnh Bộ Gà Trống, Heo - Tặng 1 Túi Zip Đựng Mảnh Ghép",40000,40000,0,0
TIKI,do-choi-me-be,85032546,"MIO MIO - Áo Nút Giữa Tay Dài BST Thỏ-có ảnh thật",64000,64000,0,0
TIKI,do-choi-me-be,46749623,"Nước Tắm Dao Đỏ - Bản Tả Phìn",120000,120000,0,0
TIKI,do-choi-me-be,116111659,"BALO SIÊU NHẸ CLEVER HIPPO ROBOT ĐẠI CHIẾN BT0103",369000,369000,0,0
TIKI,do-choi-me-be,14537741,"Thảm Xốp Cho Bé, Thảm Chơi Xếp Hình Lắp Ghép, Xốp Lót Trải Sàn Thoại Tân Thành - Bộ 40 tấm (15x15cm)",90000,90000,0,0
TIKI,cross-border-hang-quoc-te,111067221,"Nút tai silicon Bluedio NE -40dB Giảm tiếng ồn Cách nhiệt Bảo vệ tai Chống ồn ",141000,141000,0,0
TIKI,cross-border-hang-quoc-te,95720463,"Đồng Hồ Tốc Độ Không Dây Cho Xe Đạp Leo Núi",384800,384800,0,0
TIKI,cross-border-hang-quoc-te,271773634,"Wireless Lavalier Microphone Clip-on Phone Wireless Mic Noise Reduction Plug-Play Wireless Mic for Vlog Live Stream",310000,310000,0,0
TIKI,cross-border-hang-quoc-te,190172014,"Sách - Time Is a Mother by Ocean Vuong (US edition, hardcover)",485000,485000,0,0
TIKI,do-choi-me-be,24592446,"Quần lót bầu su lưới cạp chéo combo 5 cái",109000,109000,0,0
TIKI,cross-border-hang-quoc-te,77721918,"In Ear Headphone Headset Earbuds Tip Cover Silicone Earplug For Airpods Pro3",157000,157000,0,0
TIKI,cross-border-hang-quoc-te,11778902,"The 5 AM Club: Own Your Morning. Elevate Your Life",549000,549000,0,0
TIKI,do-choi-me-be,68819481,"Combo 2 chai Nước Giặt Đồ Lót Nhật Bản (120ml/chai x 2)",214000,214000,0,0
TIKI,do-choi-me-be,3871463,"Nước hoa xịt phòng khử mùi Hando 200ml",20000,20000,0,0
TIKI,do-choi-me-be,20282147,"Bộ 3 Áo Lót Bầu Và Cho Con Bú Thông Hơi - Màu Ngẫu Nhiên",85000,85000,0,0
TIKI,do-choi-me-be,167212605,"Áo Thun Hoạt Hình Khủng Long WHAT ARE YOU DOING",79000,79000,0,0
TIKI,do-choi-me-be,19556965,"Baby Vit Drop cung cấp các vitamin cần thiết cho trẻ sơ sinh và trẻ nhỏ",290000,290000,0,0
TIKI,cross-border-hang-quoc-te,109437991,"Đèn pha xe đạp phong cách cổ điển 3 đèn LED",183000,183000,0,0
TIKI,do-choi-me-be,12866825,"Túi đựng thuốc tiện ích nhiều ngăn tiện lợi",33000,33000,0,0
TIKI,do-choi-me-be,101359079,"Combo 3 Cốc thả bồn cầu tẩy xanh toilet Hàn Quốc Mr Fresh 180g hương ngàn hoa",115000,115000,0,0
TIKI,do-choi-me-be,175582482,"Bộ Tháp Xếp Khối Tròn Vuông Tam Giác, Đồ chơi phát triển tư duy cho bé, bo cạnh an toàn, Chàng Trai Gỗ",160000,160000,0,0
TIKI,cross-border-hang-quoc-te,171089881,"Thạch Giúp Cân Bằng Và Ngăn Nhiễm Trùng Đường Tiết Niệu COZO Cranberry Jelly Chiết Xuất Nam Việt Quất Và Elderberry, Tăng Khả Năng Miễn Dịch",852000,852000,0,0
TIKI,cross-border-hang-quoc-te,191004714,"Ba lô leo núi chuyên nghiệp ngoài trời CAMEL CROWN 40L",1376000,1376000,0,0
TIKI,cross-border-hang-quoc-te,113345623,"Sách - How to Connect by Thich Nhat Hanh - (UK Edition, paperback)",237000,237000,0,0
TIKI,cross-border-hang-quoc-te,46353107,"2 CHIẾC 100% Cotton Hankie Nam Nữ Khăn Tay Bỏ Túi Vuông Hanky Kerchief",154000,154000,0,0
TIKI,cross-border-hang-quoc-te,114424308,"Hộp đựng thuốc lá nhôm nhẹ-Màu Bạc",117000,117000,0,0
TIKI,cross-border-hang-quoc-te,17968668,"The Making Of A Manager",582000,582000,0,0
TIKI,cross-border-hang-quoc-te,190468483,"Giày chạy bộ nữ CAMEL CROWN Lưới đế mềm thoáng khí Trọng lượng nhẹ",1217000,1217000,0,0
TIKI,do-choi-me-be,22972154,"Set 5 Khăn Sữa 6 Lớp Vải Xô Nhăn Mềm Thấm Hút Tốt Hàng Xuất Khẩu - Họa Tiết Ngẫu Nhiên (Tặng Kèm Khẩu Trang Cho Bé)",59000,59000,0,0
TIKI,cross-border-hang-quoc-te,17970235,"Never Split The Difference",427000,427000,0,0
TIKI,cross-border-hang-quoc-te,11777049,"Collins Classics: Little Women",140000,140000,0,0
TIKI,cross-border-hang-quoc-te,170693069,"Sách - Ugly Love by Colleen Hoover (UK edition, paperback)",600000,600000,0,0
TIKI,cross-border-hang-quoc-te,7917830,"Principles: Life and Work",783000,783000,0,0
TIKI,cross-border-hang-quoc-te,170704473,"Sách - Beyond Good and Evil by Friedrich Nietzsche (US edition, paperback)",371000,371000,0,0
TIKI,do-choi-me-be,53577228,"Muối Tắm Bé Độc Mộc 400G - Muối Tắm Bé Sinh Dược  Làm Giảm Rôm Sẩy,  Hăm Tả, Cứt Trâu, Mẩn Ngứa, Mồ Hôi Trộm CHo Bé An Toàn CHo Cả TRẻ Sơ SInh Tặng Kèm 01 Túi Muối NGâm Chân",189000,189000,0,0
TIKI,cross-border-hang-quoc-te,188043098,"Sách - My Mechanical Romance by Alexene Farol Follmuth (UK edition, paperback)",305000,305000,0,0
TIKI,cross-border-hang-quoc-te,108603413,"Túi đựng, cất trữ xe đạp có thế gấp gọn, dày 2 lớp vải, phù hợp với hầu hết các mẫu xe gấp trên thị trường-Size 16 inch",408000,408000,0,0
TIKI,cross-border-hang-quoc-te,46352165,"Viết Tạp Chí Nhật Ký Sổ Tay, A6 Vintage Da Nhân Tạo Bao Trống Viết Scrapbooks Xách Tay",186000,186000,0,0
TIKI,cross-border-hang-quoc-te,11504808,"Rich Dad Poor Dad For Teens",437000,437000,0,0
TIKI,cross-border-hang-quoc-te,113407876,"Sách - How to Eat by Thich Nhat Hanh - (UK Edition, paperback)",411000,411000,0,0
TIKI,cross-border-hang-quoc-te,11471836,"The Hard Thing About Hard Things",677000,677000,0,0
TIKI,cross-border-hang-quoc-te,11504729,"Harvard Business Review: Guide To Project Management",477000,477000,0,0
TIKI,cross-border-hang-quoc-te,94366242,"Open Breathable Leather Paly Buckle Belt Silicon Mouth Gag for Women",209000,209000,0,0
TIKI,cross-border-hang-quoc-te,95718600,"Ống Bơm Bánh Xe Đạp Đa Chức Năng",249600,249600,0,0
TIKI,cross-border-hang-quoc-te,113356599,"Sách - The Whole-Brain Child : 12 Revolutionary Strategies to Nuture Your Child&#x27;s Developing Mind by Daniel J Siegel - (US Edition, paperback)",356000,356000,0,0
TIKI,cross-border-hang-quoc-te,189705994,"Giày Chạy Bộ Nữ Giày thể thao CAMEL thoáng khí siêu nhẹ thời trang cho",1040000,1040000,0,0
TIKI,cross-border-hang-quoc-te,173561830,"Balo Văn Phòng Nhiều Lớp Chống Nước Chống Trộm Đựng Máy Tính Xách Tay Có Cổng Usb Tiện Dụng Mark Ryden",895000,895000,0,0
TIKI,cross-border-hang-quoc-te,189573329,"Sách - Hopeless by Colleen Hoover (UK edition, paperback)",316000,316000,0,0
TIKI,cross-border-hang-quoc-te,76744011,"LED Wrist Ball Trainer Gyroscope Ball Gyro Arm Power Exerciser",208000,208000,0,0
TIKI,cross-border-hang-quoc-te,111684569,"Dây đeo cổ tay bằng da cho Máy ảnh cầm tay thay thế cho máy ảnh DSLR Canon Nikon Sony Pentax Olympus",121000,121000,0,0
TIKI,cross-border-hang-quoc-te,95382679,"Giày Thể Thao Leo Núi Chống Thấm Nước Chống Trượt Cho Nam Và Nữ giày dép nam trung niên 40 tuổi",884000,884000,0,0
TIKI,cross-border-hang-quoc-te,107860639,"Bình xịt vệ sinh cá nhân cầm tay cho phụ nữ",152500,152500,0,0
TIKI,cross-border-hang-quoc-te,98029417,"Màn Hình Chiếu HD 120 Inch 16: 9 Có Thể Gập Lại Treo Tường Cho Rạp Hát Tại Nhà/Văn Phòng, Màu Đen Trắng - 100 inch",204000,204000,0,0
TIKI,cross-border-hang-quoc-te,52837551,"Jacquard Stretch Low Back Ghế Cover Bar Counter Stool Trượt",181000,181000,0,0
TIKI,cross-border-hang-quoc-te,162124438,"Sách - The Spanish Love Deception : TikTok made me buy it! The Goodreads Choice A by Elena Armas (UK edition, paperback)",407000,407000,0,0
TIKI,cross-border-hang-quoc-te,10732510,"Astronomy 101: From The Sun And Moon To Wormholes And Warp Drive, Key Theories, Discoveries, And Facts About The Universe",556000,556000,0,0
TIKI,thiet-bi-kts-phu-kien-so,21154823,"Ốp lưng viền dẻo đen cao cấp giành cho iPhone XS Max",18000,18000,0,0
TIKI,thiet-bi-kts-phu-kien-so,197668727,"Ốp lưng cho samsung Z flip 3 - Z Flip 4 - ZFlip3 - ZFlip4 - Z Flip3 - Z Flip4",284050,299000,14950,5
TIKI,thiet-bi-kts-phu-kien-so,13944218,"Micro Hội Nghị Cao Cấp",184000,217000,33000,15
TIKI,thiet-bi-kts-phu-kien-so,197546361,"Bass loa 4 tấc từ 140 côn 51 Hải Triều (hàng chính hãng) 1 cặp ",800000,800000,0,0
TIKI,thiet-bi-kts-phu-kien-so,8441779,"Ốp Lưng Blackberry Key2 / Key2 LE Siêu Mỏng",141000,149000,8000,5
TIKI,thiet-bi-kts-phu-kien-so,143660812,"Ốp điện thoại chống sốc cho Samsung Galaxy S21 S20 FE Ultra S10 Lite S9 S8 Plus S10E S7 S20+ S10+ S9+ S8+_B020",30000,30000,0,0
TIKI,thiet-bi-kts-phu-kien-so,48056587,"Bao da iPad pro 10.5 2017/ ipad air 3 10.5 2019  KAKU_ hàng nhập khẩu",119000,119000,0,0
TIKI,thiet-bi-kts-phu-kien-so,43384946,"Ốp lưng da kính cao cấp dành cho iPhone 7 Plus / iPhone 8 Plus - Màu đỏ - Hàng nhập khẩu - DELICATE",149000,150000,1000,1
TIKI,thiet-bi-kts-phu-kien-so,193156667,"Ốp lưng cho Xiaomi 11T - 11T Pro gương cứng 2 màu Gradient Ver 2 , viền TPU dẻo đen",80000,80000,0,0
TIKI,thiet-bi-kts-phu-kien-so,128677420,"Bao Da dành cho iPad Pro 12.9 2021 M1 MUTURAL Y-Type With Pencil Holder - Hàng Nhập Khẩu",531000,590000,59000,10
TIKI,thiet-bi-kts-phu-kien-so,169558817,"Bàn phím máy tính không dây Ajazz 308i - Hàng chính hãng",432060,454800,22740,5
TIKI,thiet-bi-kts-phu-kien-so,107780600,"Cáp sạc nhanh Baseus C to C 100W màn led, Cáp sạc nhanh 100W Baseus Display Fast Charging Data Cable Type C to C 100W (20V/5A) - Hàng chính hãng",160000,160000,0,0
TIKI,thiet-bi-kts-phu-kien-so,33578970,"Găng Tay Họa Sĩ Dùng Với Bảng Vẽ Điện Tử, Tablet, Vẽ Tranh Giấy - Hàng nhập khẩu",120000,120000,0,0
TIKI,thiet-bi-kts-phu-kien-so,22269322,"1 Đôi loa rời vi tính",88000,88000,0,0
TIKI,thiet-bi-kts-phu-kien-so,10727171,"Cổng chuyển/Hub USB Type-C ra USB Type-A 2.0 Baseus - Hàng Chính Hãng",88499,88499,0,0
TIKI,thiet-bi-kts-phu-kien-so,90021971,"Hub chuyển đổi đa năng Baseus Type-C - HDMI, USB, RJ45, SD, TF,... dành cho Macbook, Notebook, Laptop,... - phân phối chính hãng tại Baseus Việt Nam",848499,848499,0,0
TIKI,thiet-bi-kts-phu-kien-so,98969544,"Trạm loa kép vuông",6500,6500,0,0
TIKI,thiet-bi-kts-phu-kien-so,48601451,"Nút tai nghe silicone",10000,10000,0,0
TIKI,thiet-bi-kts-phu-kien-so,32866408,"Đồng hồ thông minh định vị trẻ em Wonlex KT04 - Hàng Nhập Khẩu",890000,890000,0,0
TIKI,thiet-bi-kts-phu-kien-so,96615280,"Chuột Máy Tính XSmart Free Wolf V1 LED RGB Chơi Game Tự Động Đổi Màu Cực Đẹp - Hàng Chính Hãng",129000,129000,0,0
TIKI,the-thao-da-ngoai,272620692,"Gel Uống Bổ Sung Năng Lượng GU Energy Gel gói 32g",44000,44000,0,0
TIKI,the-thao-da-ngoai,67446841,"Băng đô, băng trán thể thao headband thấm hút mồ hôi nam nữ GoodFit GF802SB",39000,69000,30000,43
TIKI,thiet-bi-kts-phu-kien-so,152710164,"Ốp Case PC Color Mặt Kính Cường Lực cho Apple Watch Series 7 (Size 41mm/45mm)",159000,159000,0,0
TIKI,thiet-bi-kts-phu-kien-so,162371779,"Dây cáp sạc nhanh 25w Type C to Type C 2 đầu USB C độ dài 1m chuẩn PD Handtown - Hàng Chính Hãng",125000,125000,0,0
TIKI,the-thao-da-ngoai,52040314,"Máy Tập Đa năng New Six Pack Care mẫu mới model KM2017 (Hàng nhập khẩu)",859000,1599000,740000,46
TIKI,the-thao-da-ngoai,1599479,"Máy Tập Cơ Bụng Đa Năng Cải Tiến New Six Pack Care  KM2017 (hàng nhập khẩu)",799000,1198500,399500,33
TIKI,thiet-bi-kts-phu-kien-so,74235841,"Bao Da Case Cover Dành Cho iPad Pro 11 inch (2020) / iPad Air 4 (10.9 inch) / iPad Pro 12.9 inch (2020) Có Khe Cắm Apple Pencil - Hàng Chính Hãng Meliya accessories",177362,300000,122638,41
TIKI,thiet-bi-kts-phu-kien-so,10697310,"Kẹp Điện Thoại",10000,10000,0,0
TIKI,the-thao-da-ngoai,26025780,"Bộ Bảng Phóng Phi Tiêu An Toàn Cao Cấp và 6 Mũi Tiêu Có Móc Treo Cực Tiện",249000,249000,0,0
TIKI,the-thao-da-ngoai,14700951,"Thảm Tập Yoga 2 Lớp TPE 6mm Cao Cấp - Thảm Tập Gym và Yoga Chuyên Nghiệp QS - Nhiều Màu",64992,64992,0,0
TIKI,the-thao-da-ngoai,76747146,"Găng Tay Tập Gym Có Dây Quấn Trợ Lực Cổ Tay GVN001, Bao Tay Tập Gym Bảo Vệ Lòng Bàn Tay Và Cổ Tay",180000,250000,70000,28
TIKI,thiet-bi-kts-phu-kien-so,20600634,"Ốp lưng da cao cấp dành cho điện thoại iPhone 7 Plus",129000,149000,20000,13
TIKI,thiet-bi-kts-phu-kien-so,141590236,"Bao da ipad 2017/2018/gen 5/gen 6/Air 1/2 hoạt hình siêu cute",115000,115000,0,0
TIKI,thiet-bi-kts-phu-kien-so,91190426,"Cáp sạc Light/ning MFI UGREEN US155 US199 US291 cho iPhone / iPad / iPod dòng 2.4A dài 1m 2m - Hàng chính hãng",235000,305000,70000,23
TIKI,the-thao-da-ngoai,89754166,"Kìm Bóp Tay, Dụng Cụ Tập Cơ Tay Cao Cấp, Kìm Tập Gym Bấm Số Tự Động (5-60 Kg) Hàng Cao Cấp Tay Cầm Dài ",39000,60000,21000,35
TIKI,the-thao-da-ngoai,138896660,"Áo bra nữ thể thao Fitme Delta 2 dây nâng ngực hỗ trợ cho gym và yoga, chất liệu thun cao cấp thoáng khí",179000,179000,0,0
TIKI,the-thao-da-ngoai,257845274,"Tạ đôi, Tạ tay (Chọn Lực Nặng Của Tạ 20kg ,30kg, 40kg Tùy chọn) tập tay đẩy kết hợp, tạ nam nữ tập gym tập thon tay Giá tốt Hàng Chuẩn ( hàng nhập khẩu",259000,429000,170000,40
TIKI,the-thao-da-ngoai,6658395,"Xe đạp tập thể dục kết hợp tay chân tập luyện trong nhà BG",1599000,2699000,1100000,41
TIKI,the-thao-da-ngoai,65077785,"Khăn Rimix Đa Năng Trùm Đầu Ninja Fullface Chống Nắng, Chống Tia UV Thích Hợp Đi Xe , Chạy Bộ , Leo Núi  Dành Cho Cả Nam Và Nữ Rimix - Hàng Chính Hãng",99000,188000,89000,47
TIKI,thiet-bi-kts-phu-kien-so,167441543,"Ốp Lưng Silicon Gor Cho Samsung Galaxy S22/ S22 Plus/ S22 Ultra Trong Suốt Có Gờ Bảo Vệ Camera, hãng GOR - Hàng nhập khẩu",36000,39999,3999,10
TIKI,the-thao-da-ngoai,36694065,"Quần Bơi  Lửng Cho Nam  Với Thiết Kế Vảy Cá Mập Yesure Chống Thấm Nước , Nhanh Khô Tặng Kèm Nón Bơi Vải chống nước",143000,242000,99000,41
TIKI,the-thao-da-ngoai,36694065,"Quần Bơi  Lửng Cho Nam  Với Thiết Kế Vảy Cá Mập Yesure Chống Thấm Nước , Nhanh Khô Tặng Kèm Nón Bơi Vải chống nước",143000,242000,99000,41
TIKI,thiet-bi-kts-phu-kien-so,34437149,"Dây cáp HDMI to Micro HDMI 50cm",95000,95000,0,0
TIKI,the-thao-da-ngoai,59200054,"Dây nhảy lõi thép, tay cầm hợp kim nhôm, bền bỉ dẻo dai Cleacco",112000,201000,89000,44
TIKI,thiet-bi-kts-phu-kien-so,49501166,"Hộp đựng ổ cứng SATA cổng USB-C 3.1 cao cấp Ugreen 50743 - Hàng chính hãng",416000,416000,0,0
TIKI,the-thao-da-ngoai,31575097,"Bộ đồ thể thao nam vải thun lạnh siêu mát, dáng thể thao, trẻ trung, năng động – FORMEN SHOP – FMCBTD095 - Quần đen Áo đen - XL",239000,350000,111000,32
TIKI,the-thao-da-ngoai,73861344,"Dây kháng lực đàn hồi Power Band",79000,79000,0,0
TIKI,the-thao-da-ngoai,108125514,"Xà Đơn Gắn Cửa, Treo Tường Bằng Thép Chịu Lực Có Thước Thăng Bằng Cao Cấp 2022 Tienphatsmart ( Bảo Hành 12 Tháng)",259000,518000,259000,50
TIKI,thiet-bi-kts-phu-kien-so,191453994,"Dây đeo dành cho Huawei Band 7 bằng thép cao cấp",140000,140000,0,0
TIKI,thiet-bi-kts-phu-kien-so,138940950,"Ốp lưng dành cho Iphone 13 Mini - Iphone 13 - Iphone 13 Pro -  Iphone 13 Pro Max - Tranh Hoa Nền Trắng",45000,55000,10000,18
TIKI,the-thao-da-ngoai,17627161,"GĂNG TAY TẬP GYM",36000,36000,0,0
TIKI,the-thao-da-ngoai,68194409,"Dụng Cụ Tập Chân Tay Đa Năng Giảm Mỡ Đùi Vai Bắp Tay Tại Nhà",39000,39000,0,0
TIKI,thiet-bi-kts-phu-kien-so,14615267,"Cáp USB 3.0 sang HDMI Hỗ Trợ Full HD 1080p dùng cho Windows và MacOS",164800,164800,0,0
TIKI,the-thao-da-ngoai,254081998,"Máy Tập Đa năng,Máy Tập Cơ Bụng Đa Năng - Kết Hợp Tập Bụng, Tập Eo, Tập Gym, Tập Thể Hình Tại Nhà (Hàng nhập khẩu)",1345000,2690000,1345000,50
TIKI,the-thao-da-ngoai,57812878,"Đai đeo chạy bộ, túi đựng điện thoại đeo tay chạy bộ GoodFit chống nước, phản quang Goodfit GF201RA",120000,200000,80000,40
TIKI,the-thao-da-ngoai,150561878,"Bộ Quần Áo Thể Thao Nam TSIMPLE tập gym vải thun lạnh thoáng mát thấm hút mồ hôi co giãn chuẩn form MSSBHP1",159000,215000,56000,26
TIKI,the-thao-da-ngoai,568178,"Máy Tập Bụng New Six Pack Care New 2018",1099000,1999000,900000,45
TIKI,the-thao-da-ngoai,1599467,"Máy Tập Cơ Bụng Đa Năng Cải Tiến New Six Pack Care KM2018 (hàng nhập khẩu)",1099000,1899000,800000,42
TIKI,thiet-bi-kts-phu-kien-so,57956720,"Hub Type-c HDMI cho Samsung Dex hỗ trợ sạc và usb 3.0",91900,91900,0,0
TIKI,the-thao-da-ngoai,198119424,"SET 5 Dây thun tập gym mini band GoodFit GF911MB",29000,49000,20000,41
TIKI,the-thao-da-ngoai,68976174,"Kìm Bóp Cơ Tay Điều Chỉnh Lực 5-60kg Cỡ To Đẹp Chắc Chắn",50000,50000,0,0
TIKI,the-thao-da-ngoai,57708428,"Băng bảo vệ cổ chân, băng quấn cổ chân, mắt cá chân GoodFit mỏng nhẹ, miếng dán chắc chắn GF611A",99000,150000,51000,34
TIKI,the-thao-da-ngoai,216128968,"BG Ghế tập bụng ALL MODEL - Máy tập thể dục, thể hình, tập gym đa năng phù hợp cho cả nam và nữ",699000,1299000,600000,46
TIKI,the-thao-da-ngoai,57015948,"Đai Túi Chạy Bộ Thể Thao Đa Năng Có Vạch Phát Quang, Túi Để Chai Nước Hàng Chính Hãng Buffalo Sports BS03",91000,99000,8000,8
TIKI,the-thao-da-ngoai,13671918,"Ghế Xếp Mini Dã Ngoại Có Tựa Lưng",297000,297000,0,0
TIKI,thiet-bi-kts-phu-kien-so,161397481,"Dây Đeo Thay Thế Cho Galaxy Watch 4 / Galaxy Watch 4 Classic Size 40/42/44/46mm (Dây Size 20mm)",150000,150000,0,0
TIKI,the-thao-da-ngoai,22197859,"Nón bơi cao cấp Yesure Cleacco chất liệu làm từ hợp chất Silicon dẻo , chống nước , chóng UV , mềm mại thoải mái khi đeo - Nhiều màu sắc",59000,120000,61000,51
TIKI,the-thao-da-ngoai,125285272,"Máy chạy bộ tại nhà Kingsport BK-8000 Pro đa năng có chức nâng dốc tự động, kèm theo đai massage và thanh gập bụng",13500000,13500000,0,0
TIKI,thiet-bi-kts-phu-kien-so,142833965,"Bao da Dux Ducis cho iPhone 13 Pro Max dạng ví - hàng chính hãng",259000,259000,0,0
TIKI,the-thao-da-ngoai,263061424,"Sữa tăng cơ VEGAN PRO hộp 70 lần dùng của APPLIED NUTRITION với 100% protein từ thực vật - hỗ trợ tăng cơ giảm mỡ cao cấp",1325000,1850000,525000,28
TIKI,thiet-bi-kts-phu-kien-so,34843660,"Kính cường lực Nillkin XD CP+ MAX",121000,259992,138992,53
TIKI,the-thao-da-ngoai,169922643,"Dây Câu Mạch Nhỏ B-30 - Cuộn 2m",1470,1470,0,0
TIKI,the-thao-da-ngoai,191282295,"Bộ tạ đeo chân Zasami - 2kg/4kg/1 đôi - Tập kháng lực nâng cao sức khoẻ nhỏ gọn tiện lợi tại nhà",450000,675000,225000,33
TIKI,thiet-bi-kts-phu-kien-so,54139454,"Miếng Lót Chuột, Bàn Di Chuột, mouse pad cỡ lớn Kaws - Brearbrick (80x30x0.3)",90000,90000,0,0
TIKI,the-thao-da-ngoai,257859695,"BG Bộ xà đơn, xà kép đa năng cao 1m9 cao cấp đa năng Gym, lượng Kéo lên tại nhà dụng cụ tập thể dục phòng gym (hàng nhập khẩu)",1299000,2399000,1100000,46
TIKI,the-thao-da-ngoai,44434176,"Máy chạy bộ cơ đa năng BG mẫu mới Treadmill SH306 5 in 1 thích hợp cho mọi lứa tuổi luyện tập (hàng nhập khẩu)",1632000,2999000,1367000,46
TIKI,the-thao-da-ngoai,67271402,"Băng khuỷu tay hỗ trợ bảo vệ khuỷu tay, củi chỏ, vải co giãn đàn hồi, lớp silicon chống trượt thấm hút mồ hôi tốt Goodfit GF402E",99000,150000,51000,34
TIKI,the-thao-da-ngoai,50702715,"Tạ Tập Tay Nhựa VN Sportslink - Xanh",15000,17000,2000,12
TIKI,the-thao-da-ngoai,125284613,"Máy chạy bộ tại nhà KingSport BK-8000 Đa Năng có thảm chạy rộng chống trơn trượt, chống ồn, kèm theo đai massage và thanh gập bụng",11406000,13000000,1594000,12
TIKI,the-thao-da-ngoai,94867193,"Khung Nắn Chỉnh Cột Sống, Khung Định Hình Cột Sống, Dụng Cụ Hỗ Trợ Thoát Vị Đĩa Đệm, Đau Mỏi Lưng, Đau Vai Gáy - Chính Hãng VinBuy",86000,160000,74000,46
TIKI,the-thao-da-ngoai,120370474,"[TẶNG TÚI + DÂY ĐEO] Thảm Tập Yoga  8MM 2 Lớp Định Tuyến Cao Cấp - YOGA QG, Màu Sắc Đa Dạng, Không Kích Ứng Da, Chất Liệu Cao Su Tự Nhiên, Thấm Hút Mồ Hôi, Đàn Hồi Tốt, Dễ Lau Chùi, Thân Thiện Môi Trường - Hàng Chính Hãng",154000,178500,24500,14
TIKI,the-thao-da-ngoai,105312036,"Bao, Túi đựng Điện Thoại tới 6.5 Inch Đeo tay chạy bộ, Tập thể dục Rhino B121 Kháng nước, có thể cắm tai nghe",61000,80000,19000,24
TIKI,thiet-bi-kts-phu-kien-so,91833246,"Sound Card Thu Âm Behringer UFO202- Hàng chính hãng",600000,600000,0,0
TIKI,the-thao-da-ngoai,3941727,"Chai xịt làm nóng cơ Starbalm - Hà Lan 150ml",227000,360000,133000,37
TIKI,the-thao-da-ngoai,103735659,"Combo 2 Cuộn Băng Keo Vải Dán Cơ Thể Thao Cao Cấp Kinesiology Tape  (5cm x 5m) - Băng Keo Dán Cơ Chuyên Dụng Trong Thể Thao Phù Hợp Cho Mọi Lứa Tuổi Và Tất Cả Các Bộ Môn Thể Thao",135000,190000,55000,29
TIKI,the-thao-da-ngoai,50707951,"Bộ 2 Tạ Tập Tay Nhựa VN Sportslink - Xanh",18000,24000,6000,25
TIKI,the-thao-da-ngoai,37407482,"Con Lăn Tập Cơ Bụng 4 Bánh Chính Hãng",92000,92000,0,0
TIKI,thiet-bi-kts-phu-kien-so,6213359,"Ốp lưng chống sốc Likgus cho Samsung Galaxy Note 8 (chuẩn quân đội, chống va đập, chống vân tay) - Hàng chính hãng",79000,79000,0,0
TIKI,the-thao-da-ngoai,194116776,"Băng keo thể thao đá bóng, băng cuốn thể thao vải tự dính, băng quấn y tế cuốn ngón tay, cổ tay, cổ chân, quấn cán vợt chống trơn trượt",8000,8000,0,0
TIKI,the-thao-da-ngoai,68837035,"Băng Quấn Tay Boxing Glofit GBX009 ( 5m ), Băng Đa Quấn Tay Võ Thuật Cao Cấp Glofit ( Một Đôi )",135000,250000,115000,46
TIKI,the-thao-da-ngoai,159725676,"Dụng Cụ Hít Đất Hỗ Trợ Chống Đẩy Đa Năng 16 trong 1 - Bảng Chống Đẩy SP010 Chính Hãng miDoctor",139000,139000,0,0
TIKI,the-thao-da-ngoai,138359762,"Áo croptop nữ Fitme Meta ba lỗ kiểu dáng ôm body tập gym yoga chất liệu thun cao cấp, thấm hút tốt",159000,159000,0,0
TIKI,the-thao-da-ngoai,50583334,"Máy Tập Cơ Bụng Đa Năng,Máy Tập Cơ Bụng Đa Năng Tập Bụng, Lưng, Eo Tại Nhà Gấp Gọn Tiện Lợi Tập Được Nhiều Động Tác Khác Nhau (hàng nhập khẩu)",2299000,2299000,0,0
TIKI,the-thao-da-ngoai,16102793,"Combo 5 Khăn Đa Năng Đi Phượt Sành Điệu - Màu Ngẫu Nhiên",33300,65499,32199,49
TIKI,the-thao-da-ngoai,145987080,"Găng Tay Thể Thao Tập Gym Thời Trang HW Basic Sport Gloves | Găng Tay Đi Phượt, Bao Tay Chạy Xe Máy, Xe Đạp | Bao Tay Cụt Ngón Bảo Vệ Bàn Tay Đa Năng",52000,52000,0,0
TIKI,bach-hoa-online,58209006,"Trà kỷ tử - Câu kỷ tử - Loại hạt to đều khô - Gói 200g",85000,85000,0,0
TIKI,bach-hoa-online,176630892,"Granola siêu Hạt &amp; Quả NOFA 600gr, Ngũ cốc giảm cân thêm Macca, Óc chó đỏ",41000,41000,0,0
TIKI,bach-hoa-online,89072249,"Hạt Điều Vỡ Đôi DK Harvest - Hạt Điều Sống Vỡ Đôi",65000,79000,14000,18
TIKI,bach-hoa-online,92523387,"Thức ăn chó Pedigree vị gà & rau củ dạng túi 1.5kg",111000,111000,0,0
TIKI,bach-hoa-online,171256657,"Tã giấy lót chuồng cho chó mèo - Tã giấy vệ sinh siêu thấm hút dùng lót chuồng nuôi, khay vệ sinh thú cưng",107000,107000,0,0
TIKI,bach-hoa-online,32081161,"Hà Thủ Ô Mật Ong Rừng Cao Cấp FUJI 300g - Điều Trị Bạc Tóc, Rụng Tóc, Bồi Bổ Cơ Thể - Viên Hà Thủ Ô Mật Ong theo Công Thức Bí Truyền Nhật Bản - Sản Phẩm Chính Hãng - Đã Kiểm Nghiệm và Công Bố",420000,420000,0,0
TIKI,bach-hoa-online,56345533,"1KG - COMBO 2 HŨ CƠM GẠO LỨT RONG BIỂN TLP - ĂN CHAY ĐƯỢC",79000,129000,50000,39
TIKI,bach-hoa-online,103786341,"Chè dưỡng nhan 12 vị - Chống  lảo hóa, giúp thanh nhiệt mùa hè - Gói 400gr",67000,67000,0,0
TIKI,bach-hoa-online,62652057,"Hồng trà (trà đen) Déli - 500gr - chuyên dùng pha chế trà sữa, trà trái cây.",75000,85000,10000,12
TIKI,bach-hoa-online,59256820,"Thức ăn cho chó trưởng thành Ganador vị gà nướng Adult Roasted Chicken Flavor 3kg",128888,128888,0,0
TIKI,bach-hoa-online,42116117,"COMBO SIÊU TIẾT KIỆM - 1 Hũ Hạt Hạnh Nhân DK Harvest 250g + 1 Hũ Hạt Óc Chó DK Harvest 200g",180000,249000,69000,28
TIKI,bach-hoa-online,92710879,"Thức ăn mèo Whiskas vị cá biển lon 400g",43200,43200,0,0
TIKI,bach-hoa-online,46752707,"Mật ong nghệ viên Viethoney hũ 160g - Mẫu mới",34000,34000,0,0
TIKI,bach-hoa-online,3793175,"Vòng cổ có chuông bấm mở cho chó mèo (màu ngẫu nhiên)",9888,9888,0,0
TIKI,bach-hoa-online,127590999,"Combo 2 Hộp Bánh Solite Tầng Dinh Dưỡng Với Vị Cam Tươi Mới 2x238g",86500,87000,500,1
TIKI,bach-hoa-online,3747383,"Đặc Sản Bình Thuận  - Nước Mắm Tĩn Cá Cơm Than Nhãn Đỏ 40N Chai Thủy Tinh (500Ml/Chai) Sánh Đặc Thịt Cá, Không Chất Bảo Quản - Ocop 4 Sao",165000,190000,25000,13
TIKI,bach-hoa-online,483311,"Dầu Hướng Dương Simply (1L / Chai)",73600,84021,10421,12
TIKI,bach-hoa-online,686706,"Bột Trà Xanh Yanoen Matcha Uji 30g",69000,69000,0,0
TIKI,bach-hoa-online,486865,"Đồ Ăn Cho Mèo Con Me-O Hương Vị Cá Biển (1.1Kg)",108888,108888,0,0
TIKI,bach-hoa-online,87446689,"1Kg cơm gạo lứt rong biển sấy giòn thơm ngon",92000,129000,37000,29
TIKI,bach-hoa-online,68354084,"Cà phê G7 hòa tan Đen Bịch 100 gói( Không Đường Sữa) Trung Nguyên",170000,170000,0,0
TIKI,bach-hoa-online,73291856,"Combo 4 gói Bột ngọt AJI-NO-MOTO 454g",142000,142000,0,0
TIKI,bach-hoa-online,48276314,"Đặc Sản Bình Thuận  - Cặp 2 Chai Nước Mắm Tĩn Cá Cơm Than Nhãn Đỏ 40N (500Ml/Chai) - Ocop 4 Sao",330000,350000,20000,6
TIKI,bach-hoa-online,186275034,"Bánh Tráng Cuốn 22cm Asiadeli gói 300g Hàng Xuất Khẩu",32880,32880,0,0
TIKI,bach-hoa-online,1907359,"Trà Ôlong Tâm Châu Bao Nhôm 250gr",165000,165000,0,0
TIKI,bach-hoa-online,112047777,"Combo 5 gói Thức ăn cho chó trưởng thành Fib's 400g ",71249,74999,3750,5
TIKI,bach-hoa-online,10685133,"Tẩy Giun cho chó mèo Sanpet",6666,6666,0,0
TIKI,bach-hoa-online,1064964,"Cà Phê Sáng Tạo 4 Trung Nguyên (340g)",98000,98000,0,0
TIKI,bach-hoa-online,76694342,"Hà Thủ Ô Mật Ong Rừng Phúc Khang 300g ( 7 trong 1 ) - làm đen tóc ,giảm rụng tóc , kích thích mọc tóc .giúp ăn ngon , ngủ ngon , hũ thủy tinh cao cấp , dạng viên tiện lợi , vị ngọt , dễ uống ",165000,350000,185000,53
TIKI,bach-hoa-online,1064988,"Cà Phê G7 2in1 Trung Nguyên (Hộp 15 Gói)",58000,65859,7859,12
TIKI,bach-hoa-online,107018264,"Bột ngũ cốc Quasure light túi 400 gram Bibica - thực phẩm dành cho người ăn kiêng, người tiểu đường",76000,76000,0,0
TIKI,bach-hoa-online,127220058,"Đặc Sản Phan Thiết - Mắm Nêm Pha Sẵn Cao Cấp Làng Chài Xưa, Nguyên Liệu Tươi, Thơm Ngon Đặc Biệt, Chai Thủy Tinh 300G",65000,90000,25000,28
TIKI,bach-hoa-online,181000398,"Đặc Sản Sóc Trăng - Bánh Pía Đậu Xanh Sầu Riêng Trứng Muối Tân Huê Viên 320G, Bánh Pía Sóc Trăng Chính Hãng",67620,69000,1380,2
TIKI,bach-hoa-online,99078139,"Lốc 8 Gói Mì Bò Hầm Ottogi 120g",76800,76800,0,0
TIKI,bach-hoa-online,58571664,"Nho Khô Mix Không Hạt Smile Nuts Túi 500g - Nhập khẩu từ Chile (nho khô hỗn hợp gồm nho đen, nho đỏ và nho vàng)",105000,133000,28000,21
TIKI,bach-hoa-online,437758,"Bánh Ăn Sáng Nestle Cflakes (275g)",66000,82000,16000,20
TIKI,bach-hoa-online,142671560,"Ngũ Cốc Dinh Dưỡng Min Min 29 Hạt Vị Truyền Thống _ Ngũ Cốc Bầu (1 hộp 500gr)",205000,240000,35000,15
TIKI,bach-hoa-online,109392347,"Đặc Sản Phan Thiết - Nước Mắm Tôm Biển Làng Chài Xưa 525Ml/Chai Hồng Ngọc Đại Dương 300 Năm Truyền Thống",48000,90000,42000,47
TIKI,bach-hoa-online,54349922,"Nho Khô Raisins 3 Màu Không Hạt DK Harvest (Hàng Nhập Khẩu Chile)  - Thơm ngon, vị ngọt tự nhiên, không pha trộn thêm đường hay chất tạo ngọt",65000,79000,14000,18
TIKI,bach-hoa-online,181000425,"Đặc Sản Sóc Trăng - Bánh Pía 2 Trứng Đậu Xanh Sầu Riêng Tân Huê Viên 580G, Bánh Pía Sóc Trăng Tân Huê Viên 2 Trứng Muối",111720,114000,2280,2
TIKI,lam-dep-suc-khoe,72710940,"Bao cao su Powermen Ôm sát, 250 Gai nhỏ, Kéo dài thời gian",39000,39000,0,0
TIKI,lam-dep-suc-khoe,15654981,"Cây Lấy Khóe Đầu Cong Inox Hỗ Trợ Móc Khóe và Vệ Sinh Khóe KỀM NGHĨA",7000,7000,0,0
TIKI,lam-dep-suc-khoe,1679039,"Bông Cắt Bông Bạch Tuyết TPM-25 (500g)",116000,200000,84000,42
TIKI,lam-dep-suc-khoe,104323277,"Tinh Dầu Sả Chanh Treo Xe TOKI MORI Xuất Khẩu Nhật Bản (10ml) 100% Thiên Nhiên, An Toàn Cho Trẻ, Xông Phòng, Khử Mùi, Thơm Xe, Chống Ói, Kháng Khuẩn",99000,99000,0,0
TIKI,lam-dep-suc-khoe,79411386,"Kem chống nắng nâng tông Skin Aqua Tone up Rose cho da trắng, khuyết điểm xanh hoặc tái xanh, dạng tinh chất Sunplay Skin Aqua Tone Up UV Essence Happiness Aura (Rose) SPF 50+ PA++++ 50g",161000,199000,38000,19
TIKI,lam-dep-suc-khoe,37974580,"Viên uống Trắng da DHC Adlay Extract Nhật Bản - 60 Ngày (60 viên)",425000,500000,75000,15
TIKI,lam-dep-suc-khoe,43334084,"Trial Tinh chất Làm Mờ Vết Nám và Đốm Nâu Paula's Choice Clinical 1% Retinol Treatment 5 ml",449000,449000,0,0
TIKI,lam-dep-suc-khoe,140107223,"Sữa dưỡng thể Vaseline Healthy White UV Lightening Body Lotion 725ml",150000,150000,0,0
TIKI,lam-dep-suc-khoe,96199726,"NAKIZ LIVELY BUTT kem ngừa mụn, mờ thâm Mông bẹn nách Thái Lan 100g",299000,299000,0,0
TIKI,lam-dep-suc-khoe,111874128,"Bộ 4 Kem đánh răng Colgate bạc hà the mát Maxfresh 225g/tuýp tặng bàn chải đánh răng lông mềm",190000,263000,73000,28
TIKI,lam-dep-suc-khoe,137847856," Nước Hoa Nam Dạng Sáp Khô Cao Cấp Meidian Hương Thơm Cuốn Hút,Nam Tính(Combo 3 mùi)",60000,120000,60000,50
TIKI,lam-dep-suc-khoe,40935834,"Dầu gội Sunsilk Óng Mượt Rạng Ngời 1.4kg dành cho tóc khô xơ với tinh chất Bồ Kết truyền thống",205000,205000,0,0
TIKI,lam-dep-suc-khoe,73322326,"Nước Tẩy Trang Simple Micellar Cleansing Water 200ml",119000,119000,0,0
TIKI,lam-dep-suc-khoe,140440052,"Máy Massage Chân VISPO VP-C21G - Máy Massage Lòng Bàn Chân, Mu Bàn Chân Công Nghê Hiện Đại, Xoa Bóp, Trườm Ấm Thư Giãn, giải tỏa Căng Thằng Mệt Mỏi",1659000,2980000,1321000,44
TIKI,lam-dep-suc-khoe,58053818,"Bấm Móng Tay Chân Thép Không Gỉ KỀM NGHĨA B.904 - Lưỡi Cong (Loại Nhỏ)",40000,40000,0,0
TIKI,lam-dep-suc-khoe,89139805,"[TÚI - FAMAPRO 4D] - Khẩu trang y tế kháng khuẩn cao cấp Famapro 4D tiêu chuẩn KF94 (5 cái/ túi)",10000,10000,0,0
TIKI,lam-dep-suc-khoe,36678762,"Combo 6 gói Băng vệ sinh Diana Siêu thấm siêu mỏng cánh 8 miếng",120000,132000,12000,9
TIKI,lam-dep-suc-khoe,212317103,"Vitamin E Mỹ Kirkland Signature E 180mg  – Chống Oxy hóa mạnh, làm chậm quá trình lão, đẹp da, tóc và tốt cho tim mạch - Massel Official - 500 Viên",501000,1002000,501000,50
TIKI,lam-dep-suc-khoe,136816203,"Saffron ngâm mật ong Kingdom Herb chính hãng thượng hạng hộp 311g",305000,599000,294000,49
TIKI,lam-dep-suc-khoe,1313893,"Xịt khử mùi chiết xuất thiên nhiên Refre Natural Rosemary Hương Thảo (30ml)",59000,65000,6000,9
TIKI,lam-dep-suc-khoe,270886117,"Vitamin E Mỹ Kirkland Signature E 180mg (400 IU) – Giúp đẹp da, tóc, làm chậm quá trình lão hóa và tăng sức khỏe tổng thể - QuaTangMe Extaste",451400,1002000,550600,55
TIKI,lam-dep-suc-khoe,106503541,"Máy mát xa cổ vai gáy trị liệu cao cấp - Máy matxa cổ",144000,144000,0,0
TIKI,lam-dep-suc-khoe,113500007,"Đai Chống Gù Lưng Có Rung Cảm Biến Ba Chiều Nhắc Nhở Sửa Tư Thế Thông Minh - Nẹp Lưng Chống Gù Cho Trẻ Em, Nam, Nữ",141550,149000,7450,5
TIKI,lam-dep-suc-khoe,126689830,"Viên Uống Phụ Khoa- Men Vi Sinh Vùng Chữ Y LAVIMA BIOTIC",210000,210000,0,0
TIKI,lam-dep-suc-khoe,271473344,"Viên uống bổ não Healthy Care Ginkgo Biloba 100 viên",300000,300000,0,0
TIKI,lam-dep-suc-khoe,55890380,"Bộ 2 Kem đánh răng trẻ em Colgate Kid Free From 6-9 80g/tuýp",87000,104000,17000,16
TIKI,lam-dep-suc-khoe,272919105,"Khẩu Trang Trẻ Em Tenamyd Chính Hãng",62500,125000,62500,50
TIKI,lam-dep-suc-khoe,32237380,"Kem dưỡng ban đêm Sắc Ngọc Khang dưỡng sáng và mờ thâm nám 30g",279000,300000,21000,7
TIKI,lam-dep-suc-khoe,75621730,"Viên Uống Hỗ Trợ Co Thắt Búi Trĩ Trimax Hủ 30 Viên Nguyên Liệu Từ Thiên Nhiên",179000,210000,31000,15
TIKI,lam-dep-suc-khoe,116522296,"HÀNG CHÍNH HÃNG- Cân điện tử Camry EB5681, trọng tải tối đa 150kg- Thiết kế sang trọng, hiện đại",179000,179000,0,0
TIKI,lam-dep-suc-khoe,2616909,"Nước Tẩy Trang Làm Sạch Sâu & Kiểm Soát Bã Nhờn Cho Da Dầu Nhạy Cảm La Roche-Posay Micellar Water Ultra Oily Skin 400ml",390000,520000,130000,25
TIKI,lam-dep-suc-khoe,1628055,"Lăn Khử Mùi Giúp Khô Thoáng Vùng Da Dưới Cánh Tay 72h Vichy Detransprirant Intensif 72h Transpiration Excessive (50ml)",272000,320000,48000,15
TIKI,lam-dep-suc-khoe,120777637,"Protein Bar đến từ KIND - công ty bánh dinh dưỡng lớn nhất thế giới  : Hộp 12 thanh",435000,435000,0,0
TIKI,lam-dep-suc-khoe,58451261,"Gói Bột Uống Giảm Nhanh Ợ Nóng Ợ Chua Trào Ngược Dạ Dày Fobe-AD (Hộp 20 gói).",272250,272250,0,0
TIKI,lam-dep-suc-khoe,12084498,"Tẩy Tế Bào Chết Ngăn Ngừa Mụn Eucerin (100ml)",291000,389000,98000,25
TIKI,lam-dep-suc-khoe,148895418,"Khẩu trang chống nắng Anti UV Soteria Ebony đạt chuẩn UPF 50+, chống khuẩn chống bụi siêu mịn 0.1 micro - Size S,M,L",171990,171990,0,0
TIKI,lam-dep-suc-khoe,16620681,"Bàn lăn gỗ massage chân 5x6",182000,182000,0,0
TIKI,lam-dep-suc-khoe,152709665,"Máy Tăm Nước Cầm Tay - Tăm Nước Vệ Sinh Răng Miệng Oral Irrigator - Bản Quốc Tế Chuẩn Châu Âu",169000,169000,0,0
TIKI,lam-dep-suc-khoe,100265407,"Cao Gừng Nghệ Đỏ Thanh Lăn Tan Mỡ 180ml",240000,480000,240000,50
TIKI,lam-dep-suc-khoe,51696125,"Combo 2 Xịt toàn thân Romano Force tươi mát năng động 150ml",206000,206000,0,0
TIKI,lam-dep-suc-khoe,185591384,"Mặt nạ dưỡng ẩm chuyên sâu Hada Labo Premium Hydrating Serum Mask 23g/ miếng",38500,44000,5500,13
TIKI,lam-dep-suc-khoe,548110,"Sữa Tắm L'amont En Provence Cherry Blossom Shower Gel Hương Hoa Anh Đào Chai 500ml ",98100,149000,50900,34
TIKI,lam-dep-suc-khoe,46644605,"Cho máy Braun Oral-B, Bộ 4 đầu bàn chải đánh răng điện - Đánh bật cao răng- EB-25A-Cho răng sáng bóng",165000,165000,0,0
TIKI,lam-dep-suc-khoe,198324072,"Dầu gội Matrix gội là đen - gội là nâu",27000,27000,0,0
TIKI,lam-dep-suc-khoe,3490281,"Nước Hoa Hồng Cân Bằng Và Điều Chỉnh Lỗ Chân Lông Paula's Choice Skin Balancing Pore Reducing Toner (190ml)",619000,729000,110000,15
TIKI,lam-dep-suc-khoe,270549724,"Xịt keo Ong Vitatree Super Propolis Spray Complex tăng sức đề kháng, kháng khuẩn, nấm, giảm viêm họng, ho, nhiệt miệng - QuaTangMe Extaste",122400,258000,135600,53
TIKI,lam-dep-suc-khoe,158788377,"COMBO 5 GÓI 400 CÂY Tăm chỉ nha khoa ENVIRONTMENT  - Chỉ Đức công nghệ Nhật ENVIRONTMENT",150000,175000,25000,14
TIKI,lam-dep-suc-khoe,247300543,"Tinh dầu Treo 100% Thiên nhiên - Nhà của Thời Thanh Xuân",132000,132000,0,0
TIKI,lam-dep-suc-khoe,108971623,"Băng quấn cổ chân đàn hồi Dr.MED DR-A135",155000,155000,0,0
TIKI,lam-dep-suc-khoe,58916813,"Lăn Khử Mùi ETIAXIL Détranspirant Traitement Aisselles Peaux Normales 15ml (Dành Cho Da Thường) + Tặng 1 Móc Khóa Nhựa 2 Mặt",249000,320000,71000,22
TIKI,lam-dep-suc-khoe,4354111,"Bột lá nhuộm tóc màu Nâu Đỏ Lá Móng Ogatic 50gr thảo dược",96000,150000,54000,36
TIKI,lam-dep-suc-khoe,83349366,"Sữa tắm Palmolive Naturals chiết xuất 100% thiên nhiên 500g",99000,99000,0,0
TIKI,lam-dep-suc-khoe,107323260,"Combo 2 Chai Dầu Gội Và Xả Hoa Bưởi Thorakao 400ml",139900,139900,0,0
TIKI,lam-dep-suc-khoe,144191635,"Sáp Wax Lông An Lành / Wax Lông Nách Tay / Chân (Tặng giấy và que )",55000,55000,0,0
TIKI,lam-dep-suc-khoe,59476479,"Bao cao su Liebe kéo dài thời gian, gai nổi lớn - Hộp 12 cái",40000,40000,0,0
TIKI,lam-dep-suc-khoe,10770097,"Gel Dưỡng Da I’m From Vitamin Tree Water Gel",315000,315000,0,0
TIKI,lam-dep-suc-khoe,142904041,"Tinh Chất Phục Hồi, Cấp Ẩm Smas Pro Vitamin B5 Hydra Serum 120ml",465000,750000,285000,38
TIKI,lam-dep-suc-khoe,158222388,"Viên uống đẹp da Collagen Sắc Ngọc Khang 120 viên thế hệ mới giúp sáng da, giảm nếp nhăn - đốm nâu, nuôi dưỡng và làm đẹp da , tóc, móng",640000,730000,90000,12
TIKI,lam-dep-suc-khoe,198102288,"Lăn khử mùi Perspirex Strong: khử mùi hôi nách và ngăn tiết mồ hôi loại mạnh",290000,290000,0,0
TIKI,lam-dep-suc-khoe,3928213,"Kềm Cắt Móng Thép Chuyên Dụng M-205 Kềm Nghĩa",72200,76000,3800,5
TIKI,lam-dep-suc-khoe,8142273,"Kềm Cắt Da Thép Không Gỉ Kềm Nghĩa D-04(14)",175000,175000,0,0
TIKI,lam-dep-suc-khoe,135266767,"Bộ 4 Kem đánh răng Colgate Maxfresh Bamboo Charcoal 225g kèm bàn chải lông tơ phủ than",190000,263000,73000,28
TIKI,lam-dep-suc-khoe,63690465,"Combo 3 Hộp Bột Lá Nhuộm Tóc Ogatic Màu Nâu",280000,450000,170000,38
TIKI,lam-dep-suc-khoe,118124195,"Viên uống RITANA trắng da mờ sạm nám với L-Glutathion, Sakura, Pomegranate, P.Leucotomos, collagen (30 viên)",330000,330000,0,0
TIKI,lam-dep-suc-khoe,177518984,"Saffron mật ong Kingdom Herb chính hãng thượng hạng nguyên chất 100% hộp 311g (tặng que lấy mật và bình thuỷ tinh)",319000,629000,310000,49
TIKI,lam-dep-suc-khoe,150718926,"COMBO bộ 9 Dụng Cụ day ấn Huyệt Mát xa toàn thân kiểu Thái (MH849) bằng gỗ Bách Xanh - Chăm sóc sức khỏe gia đình",189050,199000,9950,5
TIKI,lam-dep-suc-khoe,113843414,"Máy Cạo Lông / Máy Tẩy Lông Không Dây Đời Mới Pin Lithium Tích Điện - Có Thời Gian Sử Dụng Liên Tục Trong 1 Giờ - Sạc Điện Bằng Cáp USB (Đã Bao Gồm) - Hàng Chính Hãng",182000,219000,37000,17
TIKI,lam-dep-suc-khoe,1628057,"Lăn khử mùi và giúp khô thoáng vùng da dưới cánh tay 48h Vichy 50ml",272000,320000,48000,15
TIKI,lam-dep-suc-khoe,68554897,"Gel Rửa Mặt La Roche-Posay Hỗ Trợ Giảm Mụn Cho Mặt & Toàn Thân Effaclar Micro-Peeling Purifying Gel 50Ml",41000,85000,44000,52
TIKI,lam-dep-suc-khoe,74465822,"	 Nước Hoa Hồng Dr.Pepti+ Dưỡng Da Căng Bóng  Centella Toner (180ml )",315000,350000,35000,10
TIKI,lam-dep-suc-khoe,187845877,"Máy mát xa massage mini đa năng cầm tay 6 chế độ tặng kèm 4 đầu massage",127499,127499,0,0
TIKI,lam-dep-suc-khoe,74308679,"Máy Đo Đường Huyết Safe Accu Chính Hãng Sinocare Tặng Kèm 50 Que Thử+50 Kim Chích Máu",225000,360000,135000,38
TIKI,lam-dep-suc-khoe,89931480,"Bộ 3 chai Dung Dịch Vệ Sinh Phụ Nữ Lactacyd Odor Fresh Ngăn Mùi 24H 250ml/chai",243000,243000,0,0
TIKI,lam-dep-suc-khoe,270813246,"Vitamin cho bà bầu Prenatal Folic Acid+ DHA Nature Made giúp mẹ khỏe, bé phát triển não bộ, hệ thần kinh và thể lực - QuaTangMe Extaste",794400,1664000,869600,52
TIKI,lam-dep-suc-khoe,58488552,"Tinh Dầu Hoa Anh Thảo Blackmores Evening Primrose Oil 190 viên - mẫu 2020",480000,480000,0,0
TIKI,lam-dep-suc-khoe,73207101,"Mật ong nguyên chất - Mật hoa cafe (1L)",111000,111000,0,0
TIKI,lam-dep-suc-khoe,73237382,"Dầu gội Head&Shoulders Bạc hà 1800ml",319000,319000,0,0
TIKI,lam-dep-suc-khoe,117222715,"Máy Triệt Lông Vĩnh Viễn Tại Nhà Halio IPL Hair Removal Device 999999 Xung Ánh Sáng",2899000,3549000,650000,18
TIKI,lam-dep-suc-khoe,75425181,"Set miếng dán móng cho bé gái đáng yêu – J007",8000,12000,4000,33
TIKI,lam-dep-suc-khoe,158762711,"Combo hoàn hảo Oniiz - Bọt vệ sinh nam giới dung dịch tạo bọt mịn 100ml & Nước hoa nam giới THE PARIS & THE MIAMI 10ml",299000,299000,0,0
TIKI,thoi-trang-nu,170154797,"Áo Bơi Nữ Tay Dài - Sea Foam Sobie",365500,430000,64500,15
TIKI,thoi-trang-nu,73244551,"Áo Ngực Đệm Dày Chữ U Mặc Đầm Hở Lưng LOIRECHIC BRL04",260000,325000,65000,20
TIKI,thoi-trang-nu,192725467,"Áo Quây Ngực CCHAT Không Đệm Thun Trơn Croptop Dáng Ôm Cao Cấp Phong Cách Trẻ Trung 22ZQC2001OT",189000,189000,0,0
TIKI,thoi-trang-nu,73521773," QUẦN JEAN DÀI ỐNG RỘNG LƯNG CAO XÁM ĐEN TRƠN BASIC - QUẦN BÒ NỮ CULOTTES SUÔNG 60 - S<45Kg",144000,144000,0,0
TIKI,thoi-trang-nu,145290013,"Chân Váy Công Sở  New Design Thiết Kế 2 Tầng Váy Xòe Tôn Dáng Midi Che Khuyết Điểm, Vải Tốt Màu Đen Co Giãn Mặc Mát",179000,328000,149000,45
TIKI,thoi-trang-nu,131419223,"áo kiểu nữ chất đũi - hàng VNXK (A17)",142000,142000,0,0
TIKI,thoi-trang-nu,25766384,"Áo khoác vest nữ caro phong cách Hàn Quốc NA66",368000,368000,0,0
TIKI,thoi-trang-nu,118126502,"Bộ đồ lửng thun lạnh trung niên nữ cao cấp_ bộ đồ nữ mặc nhà",158000,158000,0,0
TIKI,thoi-trang-nu,24031994,"Combo 5 quần lót nữ basic Comfort Modal MILEY LINGERIE - Màu sắc ngẫu nhiên",179000,395000,216000,55
TIKI,thoi-trang-nu,134020411,"Set Váy Ngủ Ren Áo Choàng Ngủ Sexy 3 Chi Tiết",199000,398000,199000,50
TIKI,thoi-trang-nu,112506256,"Đầm suôn chữ A phối hoa Xanh dễ tươi trẻ-MS027",250000,250000,0,0
TIKI,thoi-trang-nu,78283255,"Đầm suông linen tay lỡ basic sang trọng, thời trang xuân hè 2021",220000,220000,0,0
TIKI,thoi-trang-nu,83489669,"COMBO 2 QUẦN LÓT REN NƠ XUYÊN THẤU SEXY ( màu ngẫu nhiên) LYEQ008",58000,58000,0,0
TIKI,thoi-trang-nu,54345259,"Quần thể dục nam nữ học sinh dài ba sọc trắng",64000,64000,0,0
TIKI,thoi-trang-nu,69932425,"Quần jogger kaki nữ line to, phản quang khi chụp flash, kèm hình thật",89000,89000,0,0
TIKI,thoi-trang-nu,74532262,"Combo 3 Quần Lót Nữ Bikini Melange Active Miley Lingerie - Vàng, Da và Trắng Kem FCB0300-0900-1400",179000,285000,106000,37
TIKI,thoi-trang-nu,185591424,"Đầm suông linen dáng yếm nơ lưng vạt tròn trẻ trung ArctcicHunter, thời trang thương hiệu chính hãng",260000,260000,0,0
TIKI,thoi-trang-nu,185005658,"Áo lá học sinh cấp 1 cấp 2 cao cấp áo ngực trẻ em tuổi mới lớn dậy thì chất cotton mềm mại thoáng mát Lá Bralette A23",38000,38000,0,0
TIKI,thoi-trang-nu,196184595,"Bộ Quần Áo Blouse CỘC TAY, Dáng Dài Ngang Mông NAM NỮ Cho Điều Dưỡng, Y tá ,Dược Sĩ, Vải Lon Nhật Và Thô Cotton (Giá Sỉ)",99000,99000,0,0
TIKI,thoi-trang-nu,7618209,"Áo Sơ Mi Nữ Alyssa 2 In 1 MS0073A",150000,150000,0,0
TIKI,thoi-trang-nu,128523060,"Quần áo dài nữ ống suông chất liệu lụa mỹ cao cấp",100000,100000,0,0
TIKI,thoi-trang-nu,87616279,"Áo Lót Không Gọng Mút Dày Siêu Nâng Ngực Màu Trơn Habpy Lady By Sabina HBXLP0005",229000,383000,154000,40
TIKI,thoi-trang-nu,142322427,"Quần Lót Đùi Nữ Su Đúc Mặc Trong Váy - Không Đường May. Không Lộ Viền. Nhiều size từ 40 - 70kg",32000,32000,0,0
TIKI,thoi-trang-nu,16171715,"Áo Ngực Thể Thao Seamless, Áo Ngực Tập Yoga Thời Trang Cao Cấp, Cá Tính, Co Giãn Tốt, Ôm Gọn Vòng 1 Khi Vận Động Ibasic IBX019 - Hàng Chính Hãng",169000,199000,30000,15
TIKI,thoi-trang-nu,116407392,"váy suông nữ, đầm suông cộc tay in chữ cest chic phom rộng 4 màu",75000,75000,0,0
TIKI,thoi-trang-nu,117694143,"Quần đùi nữ ống rộng Eva design , quần short nữ lưng cao mặc nhà có bigsize",115000,210000,95000,45
TIKI,thoi-trang-nu,160897585,"Áo kiểu nữ form rộng fullsize M đến 2XL, áo đũi nữ thêu hoa họa tiết dễ mix đồ Haint Boutique ALe17",151050,159000,7950,5
TIKI,thoi-trang-nu,99664264," Hộp 10 Miếng Dán Ngực Silicon Miếng Dán Ti Tàng Hình",27999,27999,0,0
TIKI,thoi-trang-nu,138479370,"Quần Giảm Mỡ bụng tráng bạc NaNo, Quần Tan Mỡ ĐÙI",29000,29000,0,0
TIKI,thoi-trang-nu,180923786,"Bộ đồ mặc nhà nữ lanh (tole) Vicci BN181 thiết kế áo tay ngắn nhún bèo cách điệu phối quần lửng in họa tiết",155000,269000,114000,42
TIKI,thoi-trang-nu,52241970,"Miếng dán ngực silicon loại dày nâng ngực",85000,85000,0,0
TIKI,thoi-trang-nu,142717766,"Áo khoác hoodie chống nắng dành cho nam nữ Thêu Trái Tim, Nỉ ngoại form rộng Có Dây Kéo unisex ulzzang",97000,97000,0,0
TIKI,thoi-trang-nu,185006832,"Áo bra nữ học sinh cấp 2 cấp 3 chất cotton trơn cao cấp mềm mại thoáng mát kiểu dáng thể thao Lá Bralette A24 áo ngực học sinh",49000,89000,40000,45
TIKI,thoi-trang-nu,170487504,"Quần legging nữ Hiền Trần BOUTIQUE nâng mông lưng cạp cao vải thun dày dặn đùi ngố lửng ôm body bó mặc nhà tập gym yoga",151000,170000,19000,11
TIKI,thoi-trang-nu,147016979,"Quần mặc áo dài",55000,55000,0,0
TIKI,thoi-trang-nu,104792356,"Quần lót nữ thái lan  5134  – big size, Chất cotton mềm mại",33000,33000,0,0
TIKI,bach-hoa-online,3660113,"Trà Atiso Ladophar 100 túi lọc artichoke actiso combo 2 gói",179999,179999,0,0
TIKI,thoi-trang-nu,97930097,"Đồ bộ đi biển. đồng phục gia đình. mẫu bông dừa",58000,58000,0,0
TIKI,bach-hoa-online,1716071,"Sữa Tắm Cho Chó SOS - Giúp Mềm Mượt Lông (530ml)",76666,76666,0,0
TIKI,bach-hoa-online,58863735,"Bột CaCao Nguyên Chất Cao Cấp DTFood 500g",55000,55000,0,0
TIKI,thoi-trang-nu,67556616,"Hộp 60 miếng dán ti giấy",57000,57000,0,0
TIKI,bach-hoa-online,140579056,"Mì Ly ăn liền Handy Hảo Hảo ( Tôm Chua cay ) 67gr x 24 ly",249000,249000,0,0
TIKI,thoi-trang-nu,182479802,"Quần nữ ống rộng, dài, chất liệu Đũi mát, vải mềm mịn, form rộng, thoải mái, phong cách trẻ trung QKH.51",133000,259000,126000,49
TIKI,bach-hoa-online,10690088,"Thùng 24 hộp Nước dừa xiêm VICO FRESH (330ml / hộp)",439000,439000,0,0
TIKI,bach-hoa-online,54512538,"Chè dây (Trà dây) - Gói 1kg",120000,120000,0,0
TIKI,bach-hoa-online,20367638," Cà Phê Hạt Trung Nguyên Legend Success 2",397000,441214,44214,10
TIKI,bach-hoa-online,126218758,"Cà phê Hòa tan 3in1 Arabica cafe sữa uống liền (bịch 24 gói x 20gr) ca phe Trần Quang Việt Nam Coffee",64000,64000,0,0
TIKI,bach-hoa-online,204404539,"Bột Diếp Cá hữu cơ nguyên chất sấy lạnh Dalahouse - Hộp 20 gói nhỏ 3gr định lượng sẵn cho 1 lần sử dụng - Mát Gan, ngừa mụn, ngừa trĩ và táo bón. Hỗ trợ bảo vệ Phổi",109000,109000,0,0
TIKI,bach-hoa-online,49289523,"Thùng 48 hộp Cà phê Sữa Highlands Coffee Tetra pack (180ml /hộp)",418000,480000,62000,13
TIKI,bach-hoa-online,146276627,"Táo đỏ sấy khô cao cấp Kobe Bussan chất lượng nội địa Nhật Bản 500g",225000,225000,0,0
TIKI,bach-hoa-online,126937953,"[Combo 2 Hũ] Da heo cháy tỏi ớt giòn tan hiệu SK FOOD - mỗi hũ 100g",95000,99000,4000,4
TIKI,thoi-trang-nu,84077317,"Đồ bơi áo tắm cho người trung tuổi, dáng váy quần sooc đùi dài, tôn dáng tránh lộ bụng, bikini trung niên cho mẹ cho bà size lớn | KT007",350000,350000,0,0
TIKI,bach-hoa-online,58410333,"Cà phê Gourmet Blend (500gr)",126000,137718,11718,9
TIKI,bach-hoa-online,57141102,"Coffee Tree truyền thống số 1 đậm đà, gu mạnh - Cà phê hạt nguyên chất 100%",199000,352000,153000,43
TIKI,bach-hoa-online,147371751,"Viên nhai Nexgard trị ve rận, bọ chét cho chó (1 viên) - 25-50kg",285000,285000,0,0
TIKI,bach-hoa-online,67336524,"Yến Mạch Oats Canada Nguyên Chất túi 500g ( Nguyên Hạt )",60000,60000,0,0
TIKI,bach-hoa-online,143947375,"Viên nhai Nexgard trị ve rận, bọ chét cho chó (1 viên) - 4-10kg",135000,135000,0,0
TIKI,bach-hoa-online,3812951,"Cà Phê Hòa Tan Tchibo Gold T100G (100g)",185000,185000,0,0
TIKI,bach-hoa-online,117600114,"Tương ớt Mường Khương 500ml, Đặc sản Lào Cai, vị cay truyền thống, sản xuất thủ công, không chất bảo quản, phụ gia, hóa chất",43000,80000,37000,46
TIKI,bach-hoa-online,143947372,"Viên nhai Nexgard trị ve rận, bọ chét cho chó (1 viên) - 2-4kg",125000,125000,0,0
TIKI,bach-hoa-online,66712870,"KHÔ GÀ BƠ TỎI TÂN LỘC PHÁT COMBO 1KG - MỖI HŨ 500G",129000,199000,70000,35
TIKI,bach-hoa-online,50819822,"Natural Gừng bột 30g Dh Foods - Bột gừng nguyên chất 100%",15000,15000,0,0
TIKI,bach-hoa-online,69273975,"Combo 3 Cà Phê Sữa Hòa Tan 3IN1 KING COFFEE - Túi 50 gói x 24g",512000,512000,0,0
TIKI,bach-hoa-online,66954836,"Nước mắm nhỉ Làng Chài Xưa xuất khẩu nhãn xanh thùng 6 chai thủy tinh 500ml cốt nhỉ đặc biệt vị dịu nhẹ gu Việt Kiều giới trẻ thành thị nước mắm nguyên chất sạch nước mắm nhĩ từ thùng lều gỗ 100% cá cơm tươi muối tinh khiết chuẩn xuất khẩu",330000,590000,260000,44
TIKI,bach-hoa-online,174428346,"Bột Tía Tô Sấy Lạnh Nguyên Chất Dalahouse Hỗ Trợ Hạ Sốt, Thải Độc, Làm Sáng Da Giúp Cơ Thể Săn Chắc – Hàng Chính Hãng",108000,108000,0,0
TIKI,bach-hoa-online,111422771,"Bơ hạt ăn kiêng GUfoods (bơ đậu phộng / bơ ca cao / bơ hạt điều / bơ hạnh nhân) - Tự nhiên, Lành mạnh, Eat clean",51000,99000,48000,48
TIKI,bach-hoa-online,48920324,"Bột cacao nguyên chất 100% Việt Nam - Dòng Balanced phổ thông túi 500g -  Chuyên dùng làm bánh, pha chế cho quán cà phê - Heyday Cacao",134000,134000,0,0
TIKI,bach-hoa-online,1064998,"Cà Phê Sữa G7 3in1 Trung Nguyên (50 Gói)",150000,150000,0,0
TIKI,bach-hoa-online,138569338,"Bột Rau Má Dalahouse Hộp 60g (Mẫu mới gồm 20 tuýp 3g) Nguyên chất sấy lạnh - Mát gan giải độc",103500,115000,11500,10
TIKI,bach-hoa-online,3812947,"Cà Phê Hòa Tan Tách Caffein Tchibo Exclusive Decaf T100D (100g)",225000,225000,0,0
TIKI,bach-hoa-online,5506013,"Ngũ Cốc Sấy Khô Calbee nội địa Nhật Bản 800g",145000,145000,0,0
TIKI,bach-hoa-online,143947377,"Viên nhai Nexgard trị ve rận, bọ chét cho chó (1 viên) - 10-25kg",179000,179000,0,0
TIKI,bach-hoa-online,65104290,"Rượu Soju Hàn Quốc Jinro Fresh 16.5% 360ml Không Hộp",64000,64000,0,0
TIKI,bach-hoa-online,43604178,"500gr táo đỏ khô cao cấp",67000,67000,0,0
TIKI,bach-hoa-online,161409505,"Thùng 12 hộp sữa tươi tiệt trùng nguyên chất TH True Milk 1L (1L x 12)",472794,472794,0,0
TIKI,bach-hoa-online,53181616,"Trà Táo Đỏ Sấy Khô Mộc Sắc 100g",55000,55000,0,0
TIKI,bach-hoa-online,272848393,"Hạt nêm rau củ Massel Úc 100% từ rau củ thảo mộc bảo vệ sức khỏe, dành cho ăn chay, ăn mặn, ăn kiêng và cho bé ăn dặm - QuaTangMe Extaste",85400,180000,94600,53
TIKI,bach-hoa-online,154698804,"Trà hoa cúc túi lọc Thái Bảo, 60 tép, hộp, mẫu pastel art",104000,104000,0,0
TIKI,bach-hoa-online,138956210,"[Combo 20 lọ] Nước Yến sào Sanvinest Khánh Hòa đóng lọ 70ml - Có đường 101",720000,720000,0,0
TIKI,bach-hoa-online,51713336,"Cà Phê Trung Nguyên House Blend (500G)",94000,102453,8453,8
TIKI,dien-gia-dung,973086,"Quạt Treo Tường Điều Khiển Từ Xa Senko TR1428 (Remote) - Xám - Hàng chính hãng",530000,530000,0,0
TIKI,dien-gia-dung,173276828,"[Hàng Chính Hãng] Máy Xay Sinh Tố Công Nghiệp Uniblend UB-712 Đa Năng - Tiện Dụng",2499000,2950000,451000,15
TIKI,dien-gia-dung,171894493,"Máy cạo râu Philips PQ206/18 - Hàng chính hãng",399000,425000,26000,6
TIKI,dien-gia-dung,51520868,"Nồi Chiên Đa Năng Đảo Chiều 360 độ Nagakawa NAG3301 (6 Lít) - Hàng chính hãng",1740000,4160000,2420000,58
TIKI,dien-gia-dung,161241966,"Máy xay sinh tố Panasonic MX-MG5351WRA - Hàng chính hãng",1370000,1620000,250000,15
TIKI,dien-gia-dung,253133968,"Nồi Chưng Yến, Nồi Tiềm Thuốc Bắc, Nồi Nấu Cháo Chậm BEAR SUBE002 Gồm 3 Thố Và Khay Hấp,Dung Tích 1.6 Lít Công Suất 200 W - Hàng Chính Hãng",879000,1559000,680000,44
TIKI,dien-gia-dung,126303703,"Máy ép trái cây Philips HR1863 - Hàng chính hãng",3330000,3750000,420000,11
TIKI,dien-gia-dung,160094786,"Nồi Lẩu Điện Mini KONKA KDZG-8000L Ca Nấu Mì 2 Mức Công Suất, Thiết Kế Đẹp Mắt -HÀNG CHÍNH HÃNG",390000,590000,200000,34
TIKI,dien-gia-dung,210402680,"Robot Hút Bụi Lau Nhà, Tự Động Giặt Sấy Giẻ, Tự Gom Rác Tự Động Thêm Nước DREAME S10/L10S Ultra, Tạo Bản Đồ Siêu Nhanh, Camera AI, Diện Tích Hoạt Động 200m2, Áp Suất 5300 Pa, Công Suất 75W - Hàng Chính Hãng",9059000,18119000,9060000,50
TIKI,dien-gia-dung,133650432,"Máy hút bụi cầm tay, máy hút bui trên xe oto Zilano D01",365000,365000,0,0
TIKI,dien-gia-dung,107982411,"Nồi Cơm Điện Mini Nagakawa NAG0134 Hồng Trắng - Lòng niêu chống dính- 400W-1L - Hàng Chính Hãng",885000,1090000,205000,19
TIKI,dien-gia-dung,53308239,"Máy Xay Thịt Inox Làm Giò Chả, Xay Cua, Xay Cá Midimori MDMR-1200 (1200W) – Hàng chính hãng",1479000,2500000,1021000,41
TIKI,dien-gia-dung,92477737,"Máy vắt cam LEBENLANG model LBC388 600W-400ml Bảo hành 2 năm",1399000,1399000,0,0
TIKI,dien-gia-dung,203246988,"Nồi hầm điện ninh cháo cách thủy nồi chưng yến MIDEA Đi kèm tô sứ cao cấp tiệt trùng bình sữa em bé bằng hơi nước Hàng chính hãng",1568000,1639000,71000,4
TIKI,dien-gia-dung,273314720,"Bếp gas đơn mặt kính chén nhôm Fujishi FR-268N - Kính xanh - Hàng chính hãng",255000,255000,0,0
TIKI,dien-gia-dung,169925548,"Dây Cảm Biến Bếp Hồng Ngoại",8730,8730,0,0
TIKI,dien-gia-dung,112792230,"Máy cạo râu   Dao Máy Cạo Râu Yandou SCW 301U - Sử dụng pin sạc tiện dụng",82000,82000,0,0
TIKI,dien-gia-dung,127574637,"Máy Xay Thịt Cối Inox 304, 4 Lưỡi Dao Đa Năng, Công Suất 300W, Cối Xay Thịt, Tỏi, Ớt, Rau Củ Quả ",110600,110600,0,0
TIKI,dien-gia-dung,366368,"Máy Xay Sinh Tố Comet CM9956 (1.25 Lít) - Hàng Chính Hãng",379000,579000,200000,35
TIKI,dien-gia-dung,1919531,"Máy Pha Cà Phê Delonghi EC685.R - Hàng Chính Hãng",5200000,5200000,0,0
TIKI,dien-gia-dung,73955526,"Máy Lọc Nước Pureit Lavita - CR5240 Chức Năng Làm Nóng Nhiều Cấp Độ Tích Hợp Công Nghệ RO+UV - Hàng Chính Hãng",8125000,12500000,4375000,35
TIKI,dien-gia-dung,529093,"Máy Sấy Quần Áo Tiross TS882 (1500W) - Xanh Dương - Hàng chính hãng",2160000,2900000,740000,26
TIKI,dien-gia-dung,115902466,"Lược Điện Chải Thẳng Tóc, Uốn Cụp Tóc Chuyên Nghiệp Tiện Lợi - Máy Uốn Tóc Siêu Tốc Hiện Đại Công Nghệ Hàn Quốc Mới Nhất",71154,74899,3745,5
TIKI,dien-gia-dung,86630316,"Quạt Trần trang trí tân cổ Châu Âu - Quạt Trần trang trí Phòng Khách, nhà hàng, khách sạn SLY8001",1697400,1697400,0,0
TIKI,dien-gia-dung,273314841,"Bếp gas đơn mặt kính chén đồng Fujishi FR-268D - Kính xanh - Hàng chính hãng",265000,265000,0,0
TIKI,dien-gia-dung,73089414,"Máy Hút Bụi Cầm Tay Karcher VC 4s - Hàng Chính Hãng",7151700,7690000,538300,7
TIKI,dien-gia-dung,102007535,"Đầu Vòi Lọc Nước Xoay 360 Độ - Đầu Lọc Gắn Vòi Nước Bồn Rửa Chén Bát",12089,12089,0,0
TIKI,dien-gia-dung,114467195,"Máy pha cà phê Espresso Zamboo ZB-68CF - màu nâu ",990000,990000,0,0
TIKI,dien-gia-dung,88231301,"Máy hút bụi lau nhà cầm tay Xiaomi Roidmi X20 - Nhập khẩu và phân phối chính hãng, Bản quốc tế, bảo hành 24 tháng",8900000,8900000,0,0
TIKI,dien-gia-dung,181503535,"Quạt điện lưu thông không khí MIDEA Bản màu xanh model GAF20EQ Tạo dòng khí đối lưu thông gió trong phòng 3 Mức gió Hẹn giờ tắt Thiết kế 2 trong 1 Có điều khiển từ xa Hàng chính hãng",1905000,1990000,85000,4
TIKI,dien-gia-dung,112086581,"Máy HÚT BỤI KHÔNG DÂY nhỏ gọn SPEVI Cartoon thế hệ mới, Cổng sạc USB-Pin 1200MaH vệ sinh ôtô, máy tính, bàn phím, hút lông thú cưng, bàn làm việc",310000,310000,0,0
TIKI,dien-gia-dung,730311,"Quạt Sàn Lifan S-18CN - Hàng chính hãng",625000,625000,0,0
TIKI,dien-gia-dung,140587780,"Kẹp nướng sandwich Tiross TS9658 - Hàng chính hãng",658000,790000,132000,17
TIKI,dien-gia-dung,36978258,"Máy hút bụi  Deerma DX115C  ( Hàng nhập khẩu )",445000,699000,254000,36
TIKI,dien-gia-dung,11824785,"Nồi Cơm Điện Kangaroo KG823 (1.2 Lít) - Hàng chính hãng",679000,1170000,491000,42
TIKI,dien-gia-dung,192298202,"Nút nhựa sạc gas mini, 50 nút",38950,38950,0,0
TIKI,dien-gia-dung,113045096,"Ấm Siêu Tốc 2 Lớp Cách Nhiệt Thái Lan 2.5L",73102,73102,0,0
TIKI,dien-gia-dung,57496390,"Lò Vi Sóng Tráng Men Samsung Có Nướng 30L MG30T5018CK - Hàng Chính Hãng",3290000,4290000,1000000,23
TIKI,dien-gia-dung,21980528,"Ấm sắc thuốc bắc điện NodaCook Bát Tràng tự động sắc thuốc không có mâm nhiệt kim loại bên trong ấm 3 lít màu đen - Hàng chính hãng",650000,925000,275000,30
TIKI,dien-gia-dung,165934869,"Nồi Nấu Đa Năng Lẩu Và Hấp 2 Trong 1 BEAR DZG-D80D2 10L Cao Cấp Công Suất 1200 W - Hàng Chính Hãng",1299000,2399000,1100000,46
TIKI,thoi-trang-nu,270879502,"Vitamin B Kirkland Super B-Complex tăng khả năng nấp thụ, chuyển hóa năng lượng, tăng cường hệ miễn dịch, giảm căng thẳng - QuaTangMe Extaste",709000,1418000,709000,50
TIKI,thoi-trang-nu,118536461,"Nước Tẩy Trang Dành Cho Mọi Loại Da Oribe Bi-Phase Makeup Removal 200g",165000,210000,45000,21
TIKI,thoi-trang-nu,270185520,"Tinh Dầu Nguyên Chất 24Care 50ml - Tinh Dầu Xông Thơm Phòng Giúp Giảm Căng Thẳng, Thư giãn, Đuổi Muỗi và Khử Mùi - Tinh dầu Sả Chanh/ Cam Ngọt/ Oải hương/ Ngọc Lan Tây/ Tràm Trà/ Bưởi Ngọt/ Vỏ Quế",215000,215000,0,0
TIKI,thoi-trang-nu,43827108,"Trà Orihiro đốt mỡ và kiểm soát cân nặng an toàn (20 gói) Nội địa Nhật Bản",142000,177660,35660,20
TIKI,thoi-trang-nu,149969411,"Combo Hỗ Trợ Ngăn Ngừa Các Triệu Chứng Của Trĩ Giúp Co Búi Trĩ Dân Khang Trimax ",260000,339000,79000,23
TIKI,thoi-trang-nu,12478871,"Gel Rửa Mặt và Tắm Cho Da Đang Bị Kích Ứng A-Derma Shower Gel Hydra-Protective (200ml)",347000,408000,61000,15
TIKI,thoi-trang-nu,45150752,"Xịt mũi viêm xoang thảo dược Rohto Nosewash 35ml",58000,58000,0,0
TIKI,thoi-trang-nu,24405272,"Máy tỉa lông mũi ",30990,30990,0,0
TIKI,thoi-trang-nu,250020365,"Máy xông tinh dầu phòng ngủ tạo ẩm phun sương khuếch tán tinh dầu làm thơm phòng, khử mùi nhà vệ sinh trụ tròn - Hàng chính hãng Vinbuy",225000,450000,225000,50
TIKI,thoi-trang-nu,8211882,"Nhíp Vỉ Giấy N-404 - Kềm Nghĩa",44000,44000,0,0
TIKI,thoi-trang-nu,189685567,"Serum dưỡng ẩm sáng da Caryophy Glass Skin Serum 50ml",660000,660000,0,0
TIKI,thoi-trang-nu,185077932,"Gôm xịt tóc nam nữ BRITISH M Hard Tailor Spray giữ nếp, dễ dàng đổi kiểu 80ml",167400,180000,12600,7
TIKI,thoi-trang-nu,251584913,"Túi Chườm Giữ Nhiệt Nóng Mini Họa Tiết Hoạt Hình Giữ Ấm Giảm Đau Nhanh Chóng",19000,20000,1000,5
TIKI,thoi-trang-nu,67088623,"Máy Xông Tinh Dầu Vân Gỗ 550ML Chuyên Dụng Cho Phòng Lớn Có Remote Điều Khiển Từ Xa Kèm Đèn LED Thay Đổi Màu Cực Đẹp",239000,528000,289000,55
TIKI,thoi-trang-nu,72042163,"Khẩu Trang Y Tế 4 Lớp Nam Anh (Hộp 50 Cái - Màu Đen)",35000,35000,0,0
TIKI,thoi-trang-nu,73841542,"Dầu gội giảm gàu, rụng tóc dành cho da dầu Vichy Dercos Anti-Dandruff DS (200mL)",332000,415000,83000,20
TIKI,thoi-trang-nu,63189246,"Combo 2 Xịt khử mùi Charming/Sensation/Magic/Delightful/Romantic 150ml/Chai",176000,220000,44000,20
TIKI,thoi-trang-nu,14924192,"Lăn khử mùi giảm tiết mồ hôi Etiaxil Deodorant Anti-transpirant 48H Roll On 50ml ",249000,289000,40000,14
TIKI,thoi-trang-nu,190843443,"Máy massage đeo tay Phú Quý (tặng kèm 1 bộ than)",519000,519000,0,0
TIKI,thoi-trang-nu,76786308,"Tinh Dầu Xông Phòng HOA HỒNG TIDAMO 50ML - Tinh Dầu Hoa Hồng Cao Cấp Nhập Khẩu Tạo Hương Thơm Thư Giãn, Kích Thích Cảm Giác Lãng Mạn, Giải Tỏa Mệt Mõi",148000,230000,82000,36
TIKI,thoi-trang-nu,172120367,"Thuốc nhỏ mắt Eyemiru 40EX giảm viêm, ngứa mắt (Hộp 1 lọ 15ml)",74000,74000,0,0
TIKI,thoi-trang-nu,165091719,"Viên Uống DHC Biotin Ngăn Rụng Tóc Sustained Release Biotin 30 Ngày (30 Viên)",140000,160000,20000,13
TIKI,thoi-trang-nu,877332,"Combo 5 Giấy Thấm Dầu Mayan Than Hoạt Tính (100 Tờ)",144000,175000,31000,18
TIKI,thoi-trang-nu,165766694,"Nến thơm tinh dầu thiên nhiên cao cấp - Nến thơm phòng Candle Cup (Tặng thanh dũa móng tay ngẫu nhiên)",60000,60000,0,0
TIKI,lam-dep-suc-khoe,57656981,"Xịt mũi thảo dược giúp giảm triệu chứng viêm xoang, viêm mũi EUGICA THÔNG XOANG (Chai 15 ml)",50000,60000,10000,17
TIKI,lam-dep-suc-khoe,196025286,"Găng Tay Y Tế Latex  I'm gloves Có Bột Màu Trắng Hộp 100 Chiếc",54000,70000,16000,23
TIKI,thoi-trang-nu,70771723,"Nhiệt kế điện tử hồng ngoại đo trán không chạm Yamada - đo nhanh 1 giây, cảnh báo sốt, màn hình 3 màu đèn, đo sữa, nước tắm, nhiệt độ phòng",379050,399000,19950,5
TIKI,the-thao-da-ngoai,58360279,"Băng cổ tay thấm mồ hôi GoodFit chất cotton mềm mại an toàn cho da GF303W",69000,99000,30000,30
TIKI,thoi-trang-nu,146643977,"01 Thùng 03 hộp Nước uống đẹp da The Collagen Shiseido (Hộp 10 chai x 50mL)",1467000,1467000,0,0
TIKI,thoi-trang-nu,59599863,"Viên uống bổ mắt, tăng cường thị lực Fons Vision (30 viên)",250000,250000,0,0
TIKI,the-thao-da-ngoai,174597319,"Vòng Lắc Eo Giảm Mỡ Bụng Lõi Thép Không Gỉ Bọc Mút Xốp, Có Thể Điều Chỉnh Cân Nặng - Chính Hãng Amalife",167000,167000,0,0
TIKI,lam-dep-suc-khoe,176098208,"Nước tẩy trang da dầu mụn ELDAS, tinh chất TRÀM TRÀ, sạch sâu không cồn thẩm thấu nhanh giảm kích ứng ELDAS 250ml",96000,150000,54000,36
TIKI,thoi-trang-nu,85396315,"Thực phẩm chức năng bổ sung cho Xương Khớp. Kirkland Glucosamine HCl 1500mg with MSM (375 Viên) - Mỹ",540000,540000,0,0
TIKI,thoi-trang-nu,104655988,"Combo SÁNG DA - MỜ THÂM DHC Nhật Bản gồm viên uống vitamin C và viên uống trắng da 30 ngày JN-DHC-CB1",340000,381480,41480,11
TIKI,the-thao-da-ngoai,162167871,"Xe đạp tập thể dục thể thao, gym, fitness tại nhà Toshiko X9 - giúp tăng cơ, giảm mỡ hiệu quả",2470000,4990000,2520000,51
TIKI,the-thao-da-ngoai,52240862,"Giày Thể Thao Nam Biti's Hunter X DSMH02800TRG (Size",893000,971000,78000,8
TIKI,the-thao-da-ngoai,38419309,"Thảm Tập Yoga Định Tuyến Chính Hãng Amalife + Bao Thảm Tập Yoga Định Tuyến + Dây Buộc",135000,135000,0,0
TIKI,the-thao-da-ngoai,112168798,"Khung nắn chỉnh cột sống - Đai kéo giãn cột sống cổ - Chống thoái hóa cột sống, Dụng Cụ Tập Lưng - Hàng nhập khẩu Chính Hãng KitAcoom ( Giao màu ngẫu nhiên)",119000,119000,0,0
TIKI,lam-dep-suc-khoe,150296053,"Thực Phẩm Bảo Vệ Sức Khỏe Ferolly Bổ Sung Sắt, Cải Thiện Tình Trạng Thiếu Máu Hộp 20 ống",118000,155000,37000,24
TIKI,thoi-trang-nu,187597380,"[Combo bộ 2] -  Hỗ Trợ Trị Sẹo Actiscar làm mờ sẹo Lồi, Sẹo Lõm, Sẹo Rỗ, Sẹo Thâm Lâu Năm",799000,799000,0,0
TIKI,the-thao-da-ngoai,72975492,"Quần short nam thể thao thun lạnh cao cấp, phối sọc, thoải mái, năng động, trẻ trung – FORMEN SHOP – FMPS140",99000,189000,90000,48
TIKI,the-thao-da-ngoai,67215716,"Dụng Cụ Bẻ Cổ Tay và Kìm Bóp Cơ Tay Lực Điều Chỉnh 5-60Kg Dùng Cho Mọi Lứa Tuổi (Màu ngẫu nhiên)",94000,170000,76000,45
TIKI,the-thao-da-ngoai,161237585,"Bó Gối Dài Chính Hãng, Băng Gối Dài Thể Thao Ôm Cơ Glofit VN030A | Long Knee Sleeves Glofit VN030A (1 Chiếc)",175000,290000,115000,40
TIKI,the-thao-da-ngoai,4686101,"Dây đàn hồi mini band,Bộ 5 dây đàn hồi tập gym tập yoga dây đàn hồi kháng lực cao cấp, dây đàn hồi tập thể dục BG ( bộ 5 dây đủ màu trong 1 túi ) hàng nhập khẩu",60000,60000,0,0
TIKI,thoi-trang-nu,273564866,"Canxi Mỹ Kirkland Signature Calcium Citrate Magnesium And Zinc with Vitamin D3 phát triển hệ thống xương, phòng loãng xương - QuaTangMe Extaste",244400,598000,353600,59
TIKI,lam-dep-suc-khoe,94904349,"Lược Gội Đầu Massage Silicon - Massage da đầu - Giảm rụng tóc - Kích thích mọc tóc (Màu ngẫu nhiên) + Tặng kèm móc treo siêu dính",75000,75000,0,0
TIKI,the-thao-da-ngoai,158853545,"Rule 1 Protein Isolate 5Lbs - Sữa tăng cơ Rule1 - Whey Protein R1",1570000,1570000,0,0
TIKI,lam-dep-suc-khoe,162844540,"Cao Nám Insam DR CELL 20g",950000,950000,0,0
TIKI,lam-dep-suc-khoe,107428139,"Combo 2 Tuýp Sữa Rửa Mặt Hạt Nghệ Ngừa Mụn Thorakao Curcuma Cleansing Milk 100g",103600,103600,0,0
TIKI,thoi-trang-nu,136855309,"Dầu gội nam Bergami hương nước hoa Shocking Man - Hương nước hoa nam tính - Lịch lãm - Sạch gàu vượt trội",152000,239000,87000,36
TIKI,thoi-trang-nu,141556736,"Máy tăm nước Colgate cầm tay IPX7 trắng sáng răng",1590000,1590000,0,0
TIKI,lam-dep-suc-khoe,694387,"Tinh Dầu Bạc Hà Lorganic (10ml)",90000,90000,0,0
TIKI,thoi-trang-nu,73276050,"Nước Tẩy Trang Bí Đao Cocoon 500ml",295000,295000,0,0
TIKI,lam-dep-suc-khoe,96309591,"Dầu gội khô Batiste dry shampoo 200ml TẶNG mặt nạ Sexylook (Nhập khẩu)",198000,198000,0,0
TIKI,thoi-trang-nu,102018794,"Dầu gội Nguyên Xuân bồng bềnh - Chai 250ml Mẫu mới - Dùng cho tóc bết, xẹp, nhiều dầu - Hoàn toàn từ thảo dược",102000,160000,58000,36
TIKI,thoi-trang-nu,121482721,"Combo Dầu gội, Dầu xả, Kem ủ & Serum TRESEMME Keratin Smooth Dưỡng tóc vào nếp suôn mượt với công thức Hydrolyzed Keratin 640g, 620g, 180ml, 97ml",521000,836000,315000,38
TIKI,lam-dep-suc-khoe,16392632,"Xà Bông Tắm Và Rửa Mặt Trà Xanh Mát Lạnh Sảng Khoái An Toàn Từ Thiên Nhiên Cỏ mềm 90g",130000,130000,0,0
TIKI,thoi-trang-nu,57649869,"Sữa Dưỡng Thể 200Ml Vaseline Dưỡng Ẩm Sáng Da Fresh & Bright 10X Niacinamide Giúp Da Sáng Khỏe Mịn Căng Tinh Chất Menthol Mát Lạnh Như Tuyết Tan Trên Da",98000,98000,0,0
TIKI,the-thao-da-ngoai,68282442,"Bó gối thể thao, băng đầu gối, băng bảo vệ đầu gối tập gym GoodFit co giãn 4 chiều, dệt 3D dày dặn GF518K",119000,149000,30000,20
TIKI,thoi-trang-nu,8142221,"Kềm Cắt Móng Thép Không Gỉ Kềm Nghĩa M-01",185000,185000,0,0
TIKI,lam-dep-suc-khoe,8142267,"Kềm Cắt Da Thép Không Gỉ Kềm Nghĩa D-09(16)",175000,175000,0,0
TIKI,lam-dep-suc-khoe,68659707,"KHẨU TRANG Y TẾ KOREA, 04 LỚP",50000,50000,0,0
TIKI,the-thao-da-ngoai,58293367,"Bao tay tập gym, găng tay hở ngón tập xà đơn nam nữ GoodFit đệm silicone chống trượt, mỏng nhẹ thoáng khí GF203G",199000,250000,51000,20
TIKI,lam-dep-suc-khoe,80736819,"KEM DƯỠNG TRẮNG DA BODY CARYOPHY GLASS SKIN 3 IN 1 300G",650000,650000,0,0
TIKI,lam-dep-suc-khoe,164941170,"Gel Bôi Trơn Sagami Original (60g) - Trong Suốt - Không Màu - Không Mùi - 100% Nhập Khẩu Nhật Bản - Che Tên Sản Phẩm",188900,279000,90100,32
TIKI,lam-dep-suc-khoe,442830,"Cân Điện Tử Mặt Kính Beurer GS 14",425000,425000,0,0
TIKI,lam-dep-suc-khoe,63496813,"Serum hỗ trợ trị mụn Detox Blanc Peel Acnes Blanc 40ml (Serum H cho da nhiều mụn)",190000,190000,0,0
TIKI,lam-dep-suc-khoe,102767167,"Viên uống chống nắng PIOME SUN",800000,800000,0,0
TIKI,thoi-trang-nu,194040396,"Bộ 2 Nước súc miệng cho răng nhạy cảm Listerine Total Care Sensitive Soothing Taste 750ml/chai",288000,374000,86000,23
TIKI,thoi-trang-nu,95252945,"Máy massage cầm tay 4 đầu 6 chế độ/ massage trị liệu đau mỏi vai gáy - Hàng chính hãng",127986,127986,0,0
TIKI,lam-dep-suc-khoe,8142305,"Bấm Móng Kềm Nghĩa B-904",53000,53000,0,0
TIKI,the-thao-da-ngoai,56384512,"Bộ Dụng Cụ Hít Đất Chống Đẩy 9 in 1 – Dụng Cụ Chống Đẩy - Hít Đất - Chính Hãng miDoctor",199000,199000,0,0
TIKI,the-thao-da-ngoai,56387585,"Dụng Cụ Hít Đất Chống Đẩy – Đa Dạng 14 Bài Tập – Nhiều Nút 14 in 1 – Dụng Cụ Chống Đẩy Chính Hãng miDoctor",137000,137000,0,0
TIKI,lam-dep-suc-khoe,169815915,"Kem chống nắng dạng gel giúp giảm mụn kiểm soát bóng nhờn và thu nhỏ lỗ chân lông La Roche-Posay Anthelios Oil Correct 50ml",385000,550000,165000,30
TIKI,the-thao-da-ngoai,428880,"Bóng Rổ Prostar No.7 - Cam",190000,190000,0,0
TIKI,lam-dep-suc-khoe,115795855,"Viên uống tiêu hóa Bio Probiotic + ZinC (Hộp 30 viên)",119000,119000,0,0
TIKI,lam-dep-suc-khoe,3074967,"Dầu Gội Bồ Kết Thorakao (750ml)",54000,54000,0,0
TIKI,lam-dep-suc-khoe,5136667,"Gel làm mờ sẹo Fixderma Scar gel (15ml)",222000,278000,56000,20
TIKI,lam-dep-suc-khoe,192203142,"Máy chống ngáy ngủ bằng xung điện CTFAST, hỗ trợ giảm ngủ ngáy và giúp điều hòa nhịp thở, thiết kế nhỏ gọn phù hợp với mọi người đem lại giấc ngủ trọn vẹn, hiệu quả sau 2 tháng sử dụng",270000,329000,59000,18
TIKI,lam-dep-suc-khoe,193603955," Cân Điện Tử, Cân Sức Khỏe Gia Đình Màn Hình LED Hiển Thị Cân Nặng, Nhiệt Độ Hình Con Heo. -JL",75000,75000,0,0
TIKI,lam-dep-suc-khoe,116552538,"Khẩu Trang Y Tế Kháng Khuẩn Famapro 4D Chính Hãng - Hộp 10 cái - 5 màu lựa chọn",12000,12000,0,0
TIKI,the-thao-da-ngoai,147778093,"[HÀNG CAO CẤP - CHỐNG NỔ] Bóng Tập Yoga Cỡ Đại 65cm, 75cm - Bóng Tròn Yoga Cao Cấp - Hàng Chính Hãng dododios",119000,119000,0,0
TIKI,the-thao-da-ngoai,131337750,"Bọc Balo chống mưa CHỐNG NƯỚC loại Tốt",35000,35000,0,0
TIKI,the-thao-da-ngoai,196152970,"Xà Đơn Treo Tường Gắn Cửa Đa Năng Chịu Lực Độ Dài Tùy Chỉnh Giúp Bạn Tập Gym, Tập Cơ Bụng, Cơ Vai, Cơ Xô 60-140Cm Cao Cấp Agnite - Hàng Chính Hãng - Tập Luyện Tại Nhà Tay Cầm Bọc Đệm Chống Trượt",139000,139000,0,0
TIKI,the-thao-da-ngoai,77037910,"Bộ cần câu Lure máy ngang chính hãng -  Cần Lure 2 ngọn -  tặng kèm ngọn cần + cước CL01",599000,599000,0,0
TIKI,the-thao-da-ngoai,86999917,"Băng bảo vệ đầu gối Rhino P7720 (1 Đôi) Bó gối thể thao Đai bảo vệ đầu gối khớp gối Băng quấn đầu gối khớp gối hàng chính hãng dành cho cả nam và nữ",78000,105000,27000,26
TIKI,lam-dep-suc-khoe,16061455,"Nước tẩy trang Loreal Micellar Water 3-in-1 Refreshing Even For Sensitive Skin",175000,175000,0,0
TIKI,the-thao-da-ngoai,192563036,"Kìm Bóp Tập Cơ Tay, Dụng Cụ Tập Cơ Tay Kìm R Có Bộ Đếm Số Bản Nâng Cấp 5-60KG",95000,95000,0,0
TIKI,the-thao-da-ngoai,188255489,"Cần Câu Tay 6H Tiểu Ngư Vương Cần Câu Đài Cacbon Cao Cấp Tặng Kèm Ngọn Phụ CC30",193000,193000,0,0
TIKI,lam-dep-suc-khoe,55461727,"Kem Dưỡng Sáng Da Laneige Radian-C Cream 50ml",1060000,1200000,140000,12
TIKI,lam-dep-suc-khoe,15402733,"Gel rửa mặt trắng sáng, trẻ hóa da ISIS Pharma Neotone Gel 150ml",468000,468000,0,0
TIKI,lam-dep-suc-khoe,79316295,"Băng cá nhân MONOPLAST (Hộp 100 miếng)",60000,60000,0,0
TIKI,the-thao-da-ngoai,175850022,"Kìm Bóp Tay, Kìm Tập Cơ Tay, Dụng Cụ Tập Cơ Tay Tập Gym Điều Chỉnh Lực 10-60kg Có Đếm",89000,89000,0,0
TIKI,lam-dep-suc-khoe,144191633,"Combo triệt lông Wax An Lành + Mỡ Trăn An Lành ( Tặng bộ dụng cụ wax)",100000,200000,100000,50
TIKI,lam-dep-suc-khoe,2984005,"Dầu Gội Xả Hoa Bưởi Thorakao (400ml)",69000,69000,0,0
TIKI,the-thao-da-ngoai,39079101,"Vỏ Bao Cát Đấm Bốc 3 Lớp Cao Cấp – 8 Phụ kiện – Vỏ Bao Đấm Boxing Chính Hãng Amalife, Trụ Đấm Bốc Treo",269000,269000,0,0
TIKI,the-thao-da-ngoai,73530013,"Băng cổ tay thấm mồ hôi thể thao nam nữ Boer 0230 Sports Bandage Aol (1 chiếc) - Băng thấm mồ hôi, cuốn cổ tay thể thao - Chạy bộ, đạp xe, bóng đá, bóng bàn, bóng chuyền, hoạt động ngoài trời - Hàng chính hãng",15000,19000,4000,21
TIKI,lam-dep-suc-khoe,68494650,"Sữa Ngăn Ngừa Rạn Da Happy Event  Anti-Stretch Mark Lotion 100ml",121000,149000,28000,19
TIKI,the-thao-da-ngoai,96043669,"Tạ đeo chân tay chạy bộ thể thao",169000,169000,0,0
TIKI,lam-dep-suc-khoe,69064268,"Bồn ngâm chân massage cao cấp USA 6 con lăn tự động, vòi phun massage, Serenelife SLIFTSP12 nhập khẩu ",2198800,3200000,1001200,31
TIKI,the-thao-da-ngoai,192562929,"Kìm Tập Cơ Tay KUNOSPORT Loại Không Đếm Số",50000,50000,0,0
TIKI,the-thao-da-ngoai,165341879,"Còi Đồng Thể Thao Cao Cấp US ARMY U889, Còi Đồng Huấn Luyện Viên, Trọng Tài Tiếng Kêu To Và Vang , Dùng Cho Hoạt Động Ngoài Trời Du Lịch, Đá Bóng- HÀNG CHÍNH HÃNG",108000,238000,130000,55
TIKI,lam-dep-suc-khoe,172123298,"Kem dưỡng da ban ngày Shiseido Essential Energy Hydrating Day Cream 50ml",1500000,1500000,0,0
TIKI,the-thao-da-ngoai,51342947,"Kính Bơi Tráng Gương  kèm bịt tại cao cấp Cleaco chống sương mù , chống tia UV Hàng chính hãng - Tặng kèm nón bơi Silicon  ( Màu ngẫu nhiên )",279000,404000,125000,31
TIKI,the-thao-da-ngoai,58211146,"Bó gối thể thao, băng đầu gối thủ môn, băng bảo vệ đầu gối tập gym GoodFit đệm silicone, thanh lò xo trợ lực GF515K",179000,249000,70000,28
TIKI,the-thao-da-ngoai,16764525,"Nón Bơi Vải PU Yesure Cleacco Cao Cấp",99000,174000,75000,43
TIKI,lam-dep-suc-khoe,36158816,"Kem ủ trắng toàn thân Truesky Whitening Body Cream chiết xuất rễ cây cam thảo 100g",160000,160000,0,0
TIKI,lam-dep-suc-khoe,193583704,"Sữa tắm dưỡng thể Dove Invigorating Da bóng mịn thơm mát với dầu bơ và hoa cúc Calendular 500g",122000,142500,20500,14
TIKI,the-thao-da-ngoai,146417286,"Thảm tập gym, thể hình, thể dục tại nhà, chống trơn trượt, độ bám ma sát cao + túi đựng dễ dàng di chuyển + dây buộc thảm chuyên dụng - giao màu ngẫu nhiên - thảm dày 2 lớp - Chính hãng dododios",200000,200000,0,0
TIKI,lam-dep-suc-khoe,114778801,"[Chính Hãng] Bàn Chải Đánh Răng Điện Zenyum Sonic T11 - Màu Đen Matte - Công Nghệ Singapore",979000,1300000,321000,25
TIKI,the-thao-da-ngoai,90526759,"Xà Đơn Treo Tường Gắn Cửa Thế Hệ Mới 2021 Đầu Xà Hình Chữ Nhật Chịu Lực 250kg Đại Nam Sport + Kèm Găng Tay Tập Xa",279000,450000,171000,38
TIKI,the-thao-da-ngoai,132277180,"Bộ đồ tập gym yoga aerobic nữ quần áo tập gym yoga aerobic nữ dáng đẹp quần dài áo có tay chất vải co giãn(cộc tay)",189000,189000,0,0
TIKI,the-thao-da-ngoai,42832894,"Bao đeo tay điện thoại chạy bộ, thể thao Rimix RM5506",119000,201000,82000,41
TIKI,lam-dep-suc-khoe,102878262,"Tăm nước vệ sinh răng miệng Xiaomi Soocas W3 Pro - Hàng Nhập Khẩu",775000,796000,21000,3
TIKI,the-thao-da-ngoai,98845652,"Lương khô quân đội 900",409000,409000,0,0
TIKI,lam-dep-suc-khoe,173463343,"Siêu mặt nạ chăm sóc lỗ chân lông Innisfree Super Volcanic Pore Clay Mask 100ml (New 2023)",324000,360000,36000,10
TIKI,the-thao-da-ngoai,194836205,"[Chính hãng] Ostrovit Creatine Monohydrate (500g) Hỗ Trợ Tăng Cơ, Tăng Sức Mạnh & Hiệu Suất Tập Luyện",520000,550000,30000,5
TIKI,the-thao-da-ngoai,103797488,"Dây nhảy loại nặng tăng thể lực (tặng kèm túi đựng)",199000,199000,0,0
TIKI,lam-dep-suc-khoe,73317762,"Nước xịt dưỡng tóc tinh dầu bưởi pomelo cocoon 140ml + Serum mọc tóc pomelo bồ kết herbario 30ml",350000,350000,0,0
TIKI,the-thao-da-ngoai,125753385,"Miếng đệm bảo vệ khuỷu tay hỗ trợ tập Yoga, Gym, chơi thể thao",57420,58000,580,1
TIKI,o-to-xe-may-xe-dap,58444444,"Bộ Chuyển Đổi Nguồn Điện DC 12V Sang AC 220V 150W Cho Xe Ô Tô Cao Cấp",236550,249000,12450,5
TIKI,o-to-xe-may-xe-dap,63706090,"Cờ Lê Lắp Chéo, Chữ T dùng Tháo Lốp Ô Tô, Xe Hơi",240000,240000,0,0
TIKI,o-to-xe-may-xe-dap,109015505,"Nón bảo hiểm fullface M138B Thời Trang, Cá tính",760000,760000,0,0
TIKI,o-to-xe-may-xe-dap,23881791,"Tem xe ô tô thể thao TS027",239000,239000,0,0
TIKI,o-to-xe-may-xe-dap,149238728,"Găng tay phượt, găng tay đi xe máy - Hàng chính hãng",60000,60000,0,0
TIKI,o-to-xe-may-xe-dap,90836292,"Nón bảo hiểm 3/4 Royal XH 01 cao cấp Lót tháo rời, che hết mặt",389000,389000,0,0
TIKI,o-to-xe-may-xe-dap,97890211,"Phễu Thay Nhớt Xe Máy",15000,15000,0,0
TIKI,o-to-xe-may-xe-dap,143225978,"Giá Đỡ Bình Nước Xe Đạp, Lồng Đựng Chai Nước Gắn Khung Xe Đạp Thể Thao Chắc Chắn",25000,25000,0,0
TIKI,o-to-xe-may-xe-dap,3004439,"Đèn LED Trợ Sáng Xe Máy L4X (40W)",165000,165000,0,0
TIKI,o-to-xe-may-xe-dap,5182479,"Combo 10 viên sủi nước rửa kính xe hơi",8999,8999,0,0
TIKI,o-to-xe-may-xe-dap,34623929,"Kính chiếu hậu Ya Z dành cho các loại xe máy (gương Yaz) BẢO LONG RACING",46000,46000,0,0
TIKI,o-to-xe-may-xe-dap,71197334,"Vỏ Bọc lót yên xe đạp thể thao thoáng khí với bọt biển mềm dày cho xe đạp địa hình/ xe đạp đua đường trường Mai Lee - Thân Hẹp (xe đạp đua)",179000,179000,0,0
TIKI,o-to-xe-may-xe-dap,35841278,"Mũ bảo hiểm nửa đầu SUNDA 135D kính râm nhẹ có thể giấu vào trong thân mũ, tác dụng chống tia uv, chống chói, lớp lót mũ tháo giặt, có 4 lỗ thông gió trên mũ, kiểu dáng gọn nhẹ thời trang - hàng chính hãng SUNDA",365000,365000,0,0
TIKI,o-to-xe-may-xe-dap,130172028,"Chuông Xe Đạp Thể Thao Nhỏ Gọn - Làm Bằng Hợp Kim Kẽm - Âm Thanh Vang 90 - 100dB Gắn Tay Lái (Ghi Đông)",19000,19000,0,0
TIKI,o-to-xe-may-xe-dap,51299173,"Sạc Điện Thoại 3 trong 1 Gắn Các Dòng Xe ",142000,142000,0,0
TIKI,o-to-xe-may-xe-dap,129147873,"Miếng Phản Quang Cảnh Báo Dành Cho Xe Đạp - Xe Đạp Spoke Plsatic Ống Kính Phản Quang Bánh Xe - Vành Phản Xạ Cảnh Báo An Toàn ",15000,15000,0,0
TIKI,o-to-xe-may-xe-dap,11506461,"Bơm MICHELIN 4398ml 12266 bơm ô tô, xe hơi mini tự ngắt",1049000,1049000,0,0
TIKI,o-to-xe-may-xe-dap,186092078,"Bạt Phủ Nửa Xe Ô Tô Che Cả Nắp Capo, Bạt Che Nóc Xe Hơi Chống Nắng, Chống Xước Cho Các Dòng Xe",219000,219000,0,0
TIKI,o-to-xe-may-xe-dap,139578655,"Nước rửa kính và vệ sinh kính xe ô tô đa năng TH CLEAN can 2.5 Lít",48990,48990,0,0
TIKI,o-to-xe-may-xe-dap,56720792,"Combo 2 Bóng Đèn Halogen Tăng Sáng 150% OSRAM Night Breaker Laser H4 12V 60/55W",968000,968000,0,0
TIKI,o-to-xe-may-xe-dap,111198553,"Yên Xe Đạp, Đệm Yên Xe Đạp Thể Thao Siêu Êm, Chống Nước Cao Cấp",97988,97988,0,0
TIKI,o-to-xe-may-xe-dap,26074025,"Kẹp Điện Thoại Gấp Gọn Trên Ô Tô",199000,199000,0,0
TIKI,o-to-xe-may-xe-dap,35895193,"Thảm Lót Sàn Cao Su Theo Dành Cho Ô Tô Toyota Fortuner",788000,788000,0,0
TIKI,o-to-xe-may-xe-dap,119420828,"Đai ghế ngồi trên ô tô cho bé (Dành cho bé dưới 20kg)",175000,175000,0,0
TIKI,o-to-xe-may-xe-dap,33279105,"Bao da chìa khóa cao cấp dành cho xe Mitsu Xpander kèm móc khóa mẫu RO",137500,137500,0,0
TIKI,o-to-xe-may-xe-dap,127677589,"Đèn led cảnh báo mở cửa ô tô chống va chạm, gắn cửa xe TÂM LUÂN Chổi lau tẩm dầu - Hàng chính hãng",68000,100000,32000,32
TIKI,o-to-xe-may-xe-dap,3935969,"Bọc khóa Smartkey Honda Lead, Airblade (Màu đen)",19000,19000,0,0
TIKI,o-to-xe-may-xe-dap,116828251,"Khóa Số Xe Đạp 4 Số Mật Mã Vỏ PVC Bọc Lõi Thép (dạng tròn cứng) (mật khẩu mặc định 0000) Mai Lee",61000,69000,8000,12
TIKI,o-to-xe-may-xe-dap,154273998,"Đèn led pha siêu sáng chân hs5 dành cho xe airblade, lead, pcx",212000,212000,0,0
TIKI,o-to-xe-may-xe-dap,149919468,"Dè con nối dài 2 râu (kiểu mơi) chăn bùn dành cho xe ex 150 ex 155 exciter 150 exciter 155 (CHỮ NGẪU NHIÊN)",70000,70000,0,0
TIKI,o-to-xe-may-xe-dap,105085632,"Bóng Đèn Pha Bi Cầu Mini Chân H4 Siêu Sáng , 2 Chế Độ Vàng Và Trắng",91000,91000,0,0
TIKI,o-to-xe-may-xe-dap,11949113,"Bọc vô lăng cao cấp ô tô mẫu VL011",88000,88000,0,0
TIKI,o-to-xe-may-xe-dap,20357325,"Biển Cảnh Báo Nguy Hiểm - Biển Tam Giác cảnh báo cho xe hơi Phản quang kích cỡ 43Cm",49000,49000,0,0
TIKI,o-to-xe-may-xe-dap,105184008,"Bọc chìa khóa Smartkey Honda Air Blade, Vision, Lead, Vario- 2 nút silicon ( mẫu cũ to)",18050,18050,0,0
TIKI,o-to-xe-may-xe-dap,134362466,"Đèn đuôi nhấp nháy đèn cảnh báo sau cho xe đạp thể thao siêu sáng, chống nước",29000,29000,0,0
TIKI,o-to-xe-may-xe-dap,190516458,"Bình Xịt phủ Nano Chống Nước  Ceramic Wax - Phủ Nano Chống Nước Kính Ô tô - Phủ Bóng Xe Hơi Xe Máy(200ml)",88000,88000,0,0
TIKI,o-to-xe-may-xe-dap,84694878,"Mũ Bảo Hiểm Nửa Đầu Kính Âm SRT -Kính chống tia UV",199000,199000,0,0
TIKI,o-to-xe-may-xe-dap,35582464,"Dụng cụ đi tiểu khi đi ô tô / dã ngoại hoặc cho người bệnh",58000,58000,0,0
TIKI,o-to-xe-may-xe-dap,181623378,"(LOẠI TỐT) Hộp 2 bóng đèn pha Xenon ô tô siêu sáng H4 100W HOD 6000K dành cho xe hơi sáng trắng mẫu mới, đồ chơi ô tô",198000,198000,0,0
TIKI,o-to-xe-may-xe-dap,90439133,"Khoá Chống Trộm Chữ U Cho Xe Máy Kèm 2 Chìa Tiện Lợi",54000,54000,0,0
TIKI,bach-hoa-online,39221263,"HẠT HẠNH NHÂN NGUYÊN VỊ 500G - ĐÃ RANG",122500,122500,0,0
TIKI,bach-hoa-online,106894376,"KHÔ GÀ LÁ CHANH TÂN LỘC PHÁT COMBO 1KG - MỖI HŨ 500G",119000,199000,80000,40
TIKI,bach-hoa-online,47362814,"Trà khổ qua rừng sấy khô nguyên trái 250g - Trà khổ qua rừng hỗ trợ điểu trị tiểu đường - Quà tặng ý nghĩa cho người cao tuổi",90000,90000,0,0
TIKI,bach-hoa-online,77753411,"Trân châu đường đen 300g (10*30g)",35000,35000,0,0
TIKI,bach-hoa-online,184599156,"Hạt giống cỏ mèo và súp thưởng Shizuka cho mèo",19000,19000,0,0
TIKI,bach-hoa-online,195566734,"Combo Best Seller 3 Túi Canh I-Soup Mặn",204000,204000,0,0
TIKI,bach-hoa-online,2467249,"Muối tôm ớt kiểu Tây Ninh 120gr Dh Foods",21000,21000,0,0
TIKI,bach-hoa-online,51239296,"Đặc Sản Phan Thiết - 1 Cặp 2 Chai 500Ml Nước Mắm Tôm Biển 45N",400000,700000,300000,43
TIKI,bach-hoa-online,8013693,"Thùng 30 Mì Gà Tím VIFON (75g / Gói)",150500,150500,0,0
TIKI,bach-hoa-online,59418250,"CƠM GẠO LỨT RONG BIỂN THƯƠNG HIỆU TLP - 2 HŨ 1KG",97000,109000,12000,11
TIKI,bach-hoa-online,55547368,"1 KG HẠT MACCA NỨT VỎ HÀNG NHẬP KHẨU CAO CẤP THƯƠNG HIỆU SK FOOD",239000,269000,30000,11
TIKI,bach-hoa-online,20581831," Cà Phê Trung Nguyên Legend Cà phê sữa đá - (Hộp 9)",76000,76000,0,0
TIKI,bach-hoa-online,21969628,"Thùng 12 Hộp Sữa Tươi Tiệt Trùng Vinamilk 100% Ít Đường (1L)",417000,485000,68000,14
TIKI,bach-hoa-online,189697666,"Hộp 1 tổ yến sào tinh chế cao cấp Nha Trang Khánh Hoà The Nest House",400000,400000,0,0
TIKI,bach-hoa-online,62208201,"Hạt Dinh Dưỡng Hỗn Hợp 4 Loại Hạt Điều, Hạnh Nhân, Óc Chó, Hạt Dẻ Cười Có Muối LAFOOCO 270g",100100,143000,42900,30
TIKI,bach-hoa-online,77060395,"500Gr Yến mạch tươi nguyên chất Hafer Flocken loại cán dẹt - Nhập Khẩu Từ Đức",31262,31900,638,2
TIKI,bach-hoa-online,272799968,"BÁNH TRÁNG PHÔ MAI HOT SIÊU PHẨM ĂN VẶT ABI SNACK",28000,28000,0,0
TIKI,bach-hoa-online,58357538,"COMBO 2 HỘP HẠT ĐIỀU RANG MUỐI VỠ TÂN LỘC PHÁT (1KG)",89000,139000,50000,36
TIKI,bach-hoa-online,173153272,"Sốt Me Chua Ngọt 200gr Dh Foods - gia vị chấm  và chế biến hải sản, các món nướng",25000,25000,0,0
TIKI,bach-hoa-online,2180351,"Sữa Hạt Hạnh Nhân Không Đường 137 Degrees (Hộp 1000ML)",119000,119000,0,0
TIKI,bach-hoa-online,108014199,"LẠP XƯỞNG HEO TÂN LỘC PHÁT COMBO 1KG - MỖI BỊCH 500G",174000,231400,57400,25
TIKI,bach-hoa-online,127591003,"Combo 2 khay Solite bánh dinh dưỡng bông lan cuộn, giảm đường, vị lá dứa 2x360g",111000,115000,4000,3
TIKI,bach-hoa-online,75622108,"[Combo 1Kg] 500G Đậu Phộng Rang Tỏi Ớt + 500G Đậu Phộng Da Cá Sấy ( Đậu Phộng Cốt Dừa) Thương Hiệu SK FOOD",85000,89000,4000,4
TIKI,bach-hoa-online,76582330,"Tổ Yến Sào Tinh Chế (5 Tổ/40g/Hộp) (Tổ Yến làm sạch/Tổ Yến Sạch chế biến từ Tổ Yến Thô /Tổ Yến còn lông) Yến Sào Trung Nam",1932000,2100000,168000,8
TIKI,bach-hoa-online,6006865,"Sữa bột Bonecare dưỡng chất cho xương và khớp dành cho người từ 30 tuổi trở lên phòng ngừa đau xương khớp, viêm khớp, đặc biệt là người bệnh xương và khớp",449000,449000,0,0
TIKI,bach-hoa-online,204820804,"Hạt macca Úc đã tách vỏ (loại 1 nguyên hạt), sấy giòn ăn liền hoặc làm sữa Nunuts ( nhân macca)",200000,200000,0,0
TIKI,bach-hoa-online,131182322,"[[Combo 2 Hũ] Thanh gạo lứt chà bông mỗi hũ 250g hiệu SK FOOD",95000,95000,0,0
TIKI,bach-hoa-online,58409447,"Cà phê Chế phin 2 (500gr)",129000,140982,11982,8
TIKI,bach-hoa-online,68778070,"Gạo Basmati India (Ấn Độ) 5kg",290000,290000,0,0
TIKI,bach-hoa-online,37651735,"Thực phẩm bổ sung Vitamin của Mỹ - ONE A DAY WOMEN 50+ Healthy Advantage 300 viên",610000,610000,0,0
TIKI,bach-hoa-online,57812465,"Combo 5 gói Natural Gia vị nấu Bò Kho Dh Foods",25600,25600,0,0
TIKI,bach-hoa-online,124412395,"Bột matcha Nhật Bản 01 (Hàng chính hãng)",180000,180000,0,0
TIKI,bach-hoa-online,8157212,"Bánh Custas Hộp 20 Cái (470g)",106000,114000,8000,7
TIKI,bach-hoa-online,155163127,"CHAI XỊT KHỬ MÙI HÔI THÚ CƯNG, KHỬ MÙI HÔI NƯỚC TIỂU CHÓ MÈO, CÁT VỆ SINH CHÓ MÈO, XỊT THƠM MIỆNG THÚ CƯNG-NANO BẠC DIỆT KHUẨN KHỬ MÙI XCLEAN PET 100ML-NANO BẠC AHT CORP (AHTC)-AN TOÀN THÂN THIỆN CHO BOSS",49500,99000,49500,50
TIKI,bach-hoa-online,121327363,"Thức Ăn Cá Cảnh | Phù Hợp Cá Thủy Sinh, Guppy, Betta, Bình Tích - Cám Thái Inve 2/3-3/5-5/8",50000,50000,0,0
TIKI,bach-hoa-online,151554912,"Xốt Mayonnaise Aji-mayo® Professional Sauce 3kg/Thùng",240000,240000,0,0
TIKI,bach-hoa-online,8458924,"Sữa tắm 450ml Olive Essence Cho chó mèo",36888,36888,0,0
TIKI,bach-hoa-online,97857514,"Combo 3 Natural Gia vị Lẩu Thái Dh Foods",40856,40856,0,0
TIKI,bach-hoa-online,5032435,"Dầu Olive Pomace Silarus 1L cao cấp, dùng chiên rán, nấu ăn, giảm chất béo có hại - thương hiệu Silarus nhập khẩu 100% từ Ý",217000,217000,0,0
TIKI,bach-hoa-online,58911324,"cà phê Robusta Đắk Lắk 1kg",199000,199000,0,0
TIKI,dien-gia-dung,730095,"Quạt Đứng Lifan Đ-616A (Trắng - Lồng Xi) - Hàng chính hãng",620000,620000,0,0
TIKI,dien-gia-dung,7647826,"Lò Nướng Electrolux EOT38MXC (38 Lít) - Hàng chính hãng",1739000,2390000,651000,27
TIKI,dien-gia-dung,72549285,"Quạt sạc tích điện Honjianda FL 301 - tích hợp đèn LED & cổng USB",820000,820000,0,0
TIKI,dien-gia-dung,102551598,"Quạt Sạc Tích Điện Sunhouse SHD7223 (24W) - Hàng Chính Hãng",1350000,2050000,700000,34
TIKI,dien-gia-dung,14640744,"Nồi cơm điện Kim Cương nắp rời 1.8L (18R) - Chính Hãng",344000,399000,55000,14
TIKI,dien-gia-dung,227543350,"Máy ép chậm Magic Eco AC-132 - Hàng chính hãng",1689000,3190000,1501000,47
TIKI,dien-gia-dung,449796,"Ấm Siêu Tốc Inox Sunhouse SHD1182- Hàng chính hãng",160000,160000,0,0
TIKI,dien-gia-dung,102798861,"Nồi Lẩu Điện Bếp Nướng Đa Năng Mini 2 In 1 - Vừa Nấu Lẩu Vừa Nướng",192000,214000,22000,10
TIKI,dien-gia-dung,85373707,"Bộ Lọc Thô Đầu Nguồn 10 INC",350000,350000,0,0
TIKI,dien-gia-dung,13441953,"Máy hút ẩm mini, máy hút ẩm và lọc không khí thiết bị hữu ích cho mọi gia đình",597900,597900,0,0
TIKI,dien-gia-dung,121009841,"Máy Hâm Nóng, Đế Hâm Nóng Giữ Nhiệt Đồ Uống KUNBE Với 3 Chế Độ Nhiệt, Hâm Nóng Trà, Cà Phê, Sữa Cho Bé, Nhỏ Gọn, Màn Hình Điện Tử Cao Cấp",379000,379000,0,0
TIKI,dien-gia-dung,91645738,"Máy Ép Trái Cây Miệng Lớn Hafele JE230-BL - 535.43.531 (Hàng chính hãng)",4149000,7927000,3778000,48
TIKI,dien-gia-dung,130233649,"Quạt Lỡ ống nhựa SENKO L1638 - Màu ngẫu nhiên - Hàng chính hãng",360000,360000,0,0
TIKI,dien-gia-dung,52480695,"Lưỡi Dao thay thế cho máy cạo râu xiaomi Enchen BlackStone - Hàng Nhập Khẩu",99000,99000,0,0
TIKI,dien-gia-dung,15303322,"Quạt Mini Tích Điện Cầm Tay Có Đế",30989,30989,0,0
TIKI,dien-gia-dung,107632070,"Combo Máy pha cà phê Espresso Zamboo ZB-68CF+ Máy xay ZB-100GR- Hàng chính hãng",1390000,1390000,0,0
TIKI,dien-gia-dung,97341755,"Robot hút bụi lau nhà thông minh Liectroux F5Pro - Hàng chính hãng",6390000,6390000,0,0
TIKI,dien-gia-dung,73856571,"Quạt Lửng Sharp Có Điều Khiển PJ-L40RV-DG - Hàng Chính Hãng",1037000,1800000,763000,42
TIKI,dien-gia-dung,56034883,"Quạt Đôi Mini 360 Độ Công Suất Lớn F404, Để Trong Ô Tô, Để Bàn Làm Việc (Màu Ngẫu Nhiên)",171999,171999,0,0
TIKI,dien-gia-dung,140964386,"Máy Hút Bụi Cầm Tay Đệm Giường DEERMA CM300 (300W) - Hàng chính hãng",599000,599000,0,0
TIKI,dien-gia-dung,22486816,"Tông Đơ Cắt Tóc Chuyên Nghiệp F10 Hai Pin Máy Chạy Cực Trâu",288000,290000,2000,1
TIKI,dien-gia-dung,95154301,"Máy Xay Bột Khô Siêu Mịn Seka Z10-800Y - Máy Xay Nghiền Bột Đa Năng Inox 304, Công Suất Lớn - Hàng chính hãng",779000,850000,71000,8
TIKI,dien-gia-dung,52683384,"Máy xay và đùn thịt Cối Gang Cỡ Vừa 12 đã có motor",2750000,2750000,0,0
TIKI,dien-gia-dung,253414567,"Máy sấy tóc Lebenlang LBL3088 công suất 2100W của Đức, chống xơ rối tóc bằng công nghệ ion - Hàng Chính Hãng",349000,569000,220000,39
TIKI,dien-gia-dung,100947624,"NỒI ÁP SUẤT KHALUCK.HOME KL-160 16L HÀNG CHÍNH HÃNG",3429020,3499000,69980,2
TIKI,dien-gia-dung,185715444,"Nồi cơm điện Happy Cook 1.2 lít HC-120 - Hàng Chính Hãng",660000,787000,127000,16
TIKI,dien-gia-dung,90714271,"Quạt trần mini, quạt treo mùng 3 cánh lớn",104000,104000,0,0
TIKI,dien-gia-dung,56647581,"Nồi chiên nhúng điện đơn, chiên gà, chiên khoai tây,... loại Tốt- Hàng nhập khẩu",999000,999000,0,0
TIKI,dien-gia-dung,20810839,"[TĂNG ĐƠ] Tông Đơ Cắt Tóc Nhật Bản KATO G5 Mày Chạy Êm",222648,222648,0,0
TIKI,dien-gia-dung,52057781,"Bóng Đèn UV Diệt Khuẩn Aquapro 11W,  4 Chấu – 215mm  (BDUVA11W), Diệt khuẩn nhanh, Tinh lọc nguồn nước uống, Chống vi khuẩn, viruss có hại, Thích hợp cho hệ thống lọc nước nhỏ, vừa và lớn",101000,150000,49000,33
TIKI,dien-gia-dung,71513166,"Tông Đơ Cắt Tóc Chuyên Nghiệp Panasonic ER-GP80-K751 - Hàng Chính Hãng",3520000,3840000,320000,8
TIKI,dien-gia-dung,188844856,"Lưới nhôm, tấm lọc màng chắn mỡ máy hút mùi âm tủ dạng kéo đẩy",185000,185000,0,0
TIKI,dien-gia-dung,38138637,"Tông đơ cắt tóc  Kemei KM 5017",199000,199000,0,0
TIKI,dien-gia-dung,184097463,"Nồi cơm điện thông minh ZHIWUZHU ZCDQ056",1299000,1459000,160000,11
TIKI,dien-gia-dung,1021427,"Sưởi Điện Hồng Ngoại Sunhouse SHD7013 (800W) - Đen Đỏ - Hàng Chính Hãng",381000,669000,288000,43
TIKI,dien-gia-dung,576131,"Ấm Siêu Tốc Du Lịch Tiross TS1360 (0.5 Lít) - Xanh - Hàng chính hãng",339000,390000,51000,13
TIKI,dien-gia-dung,128302673,"Quạt Trần DC 6 Số PROMAX Lõi Đồng Tiết KIệm Điện, Có Hút Ẩm Mùa Đông 3 Chế Độ Đèn LED",1500000,1500000,0,0
TIKI,dien-gia-dung,56492437,"Quạt Bàn Đảo 3 Tấc Senko BD1010 - Màu Ngẫu Nhiên - Hàng chính hãng",360000,360000,0,0
TIKI,dien-gia-dung,449721,"Ấm Siêu Tốc Thủy Tinh Sunhouse SHD1217- Hàng chính hãng",388000,388000,0,0
TIKI,dien-gia-dung,178255837,"Tủ sấy bát gia đình 2 tầng KS-980A dung tích 98 lít - Máy sấy bát đĩa",2000000,2000000,0,0
TIKI,giay-dep-nam,8863183,"Miếng lót giày thể thao thoáng khí (Size giày nam, từ 40-46)",79000,79000,0,0
TIKI,giay-dep-nam,115767457,"Sục da nam,giày da nam hở gót xả kho giá gốc",199000,199000,0,0
TIKI,giay-dep-nam,176472467,"Dung môi vệ sinh làm sạch bề mặt da Ximo LeatherPreparer &amp; Deglazer Premium XI17",130000,150000,20000,13
TIKI,giay-dep-nam,101655632,"Đón Gót Giày Đót Giầy Sans974 Sans Shop",9900,9900,0,0
TIKI,giay-dep-nam,187482141,"Dép nam quai 2 dây ngang TL547",195000,195000,0,0
TIKI,giay-dep-nam,103917241,"Dép quai ngang thời trang nam năng động kiểu dáng Nhật Bản ôm chân thoáng khí thân thiện với môi trường",159000,309000,150000,49
TIKI,giay-dep-nam,192910228,"Giày Tây Da Cao Cấp ChristinA-Q GNA411",919200,1149000,229800,20
TIKI,giay-dep-nam,26691723,"Dép Nam BIGGBEN Da Bò Thật Cao Cấp DN201",319000,380000,61000,16
TIKI,giay-dep-nam,183554496,"Dép đế may sẵn quai ngang cao cấp KEEDO KD2906 Full hộp",960000,960000,0,0
TIKI,giay-dep-nam,103467604,"Giày Tây Nam Không Dây Da Bò Thật Màu Vàng Chính Hãng Trường Hải GT280  Đế Cao Su Không Trơn",501000,549000,48000,9
TIKI,giay-dep-nam,177947150,"Dép quai ngang nam, nữ siêu nhẹ DUWA - Hàng chính hãng – VÀNG TK1172",79500,159000,79500,50
TIKI,giay-dep-nam,70796867,"Giày nam thể thao sneaker vải dệt cao cấp thoáng khi bền đẹp SP-371",169100,178000,8900,5
TIKI,giay-dep-nam,12676321,"Dép bít mũi da bò vàng cao cấp Trường Hải  TH033",281000,329000,48000,15
TIKI,giay-dep-nam,138193990,"Dép Xỏ Ngón Nam HÀ NAM Da Bò Thật Cao Cấp DNA2144",325000,325000,0,0
TIKI,giay-dep-nam,50261195,"Găng Tay Lau Chùi Giày Có Thể Sử Dụng Để Đánh Giày Da Với Xi (Giao Màu Ngẫu Nhiên)",30000,30000,0,0
TIKI,giay-dep-nam,163550695,"BÌNH XỊT KHỬ MÙI GIÀY, CHỐNG HÔI CHÂN NCE SIÊU KHÔ THOÁNG",25000,25000,0,0
TIKI,giay-dep-nam,51148182,"Giày nam, chất thoáng mát, mẫu bán chạy, phù hợp cho mùa thu G35",110081,115875,5794,5
TIKI,giay-dep-nam,153258290,"Dép lỗ táo đi trong nhà, nhà tắm siêu mềm (size 39-44)",18600,18600,0,0
TIKI,giay-dep-nam,130439692,"Giày Nam Da Bò SUNPOLO CS4060 Trẻ trung, thanh lịch (Nâu đỏ)",780000,780000,0,0
TIKI,giay-dep-nam,254117623,"Dép nam trung niên đẹp bền siêu nhẹ KEEDO KDN08",320000,320000,0,0
TIKI,giay-dep-nam,55141466,"Combo 3 đôi lót giày Hương Quế (CI-03, CI-13, CI-14) giúp khử mùi hôi chân - phòng cảm cúm - hút ẩm êm chân - tốt cho sức khỏe",75000,75000,0,0
TIKI,giay-dep-nam,15320462,"Dây giày Saphir Pháp",65000,65000,0,0
TIKI,giay-dep-nam,153416263,"Giày Tây Nam Giày Công Sở Nam Da Bò Cao Cấp Màu Nâu-P26 Giày Đánh Patina Thủ Công Sang Trọng Lịch Lãm ,Giày SAGO’S",890000,890000,0,0
TIKI,giay-dep-nam,177674636,"Dép Nam Quai Ngang Da Bò Thật BIGGBEN Cao Cấp DN310",289000,380000,91000,24
TIKI,giay-dep-nam,10099420,"Lót Giày Da - Nội Địa Nhật Bản",42000,42000,0,0
TIKI,giay-dep-nam,15932470,"Kem phục hồi màu đồ da Saphir JUVACUIR 75ml",415000,415000,0,0
TIKI,giay-dep-nam,119244798,"Dép Bít Mũi Nam TiTi ĐÔ Da Bò Thật Cao Cấp GSB2076a",480000,480000,0,0
TIKI,giay-dep-nam,189635020,"Giày Sandal Vento Nam 2 Quai Ngang dạo phố  đi học du lịch Big Size NV3610",345000,345000,0,0
TIKI,giay-dep-nam,127934628,"[Hương Bạc Hà Trà Xanh] Nước Hoa Xịt Khử mùi Giày Cao Cấp MIS PIES - 20ml - Công Nghệ Nano Bạc Khử Mùi - Khử mùi hôi chân hiệu quả",199000,199000,0,0
TIKI,giay-dep-nam,37833006,"Dép cao su Nam  Nữ 3 quai có hậu bhh",300000,300000,0,0
TIKI,giay-dep-nam,45281426,"Dép quai ngang nam GIAVY - T483",195000,195000,0,0
TIKI,giay-dep-nam,91271840,"Khăn Giấy Lau Giày Siêu Sạch SNEAKER Hộp 30 Tờ Siêu Hot Không Hoá Chất Làm Hại Vải hàng đẹp",23616,23616,0,0
TIKI,giay-dep-nam,43865571,"Giày Da Nam Cao Cấp Phong Cách Trẻ Trung Năng Động Lịch lãm, Giày Tây Nam HS31",799000,799000,0,0
TIKI,giay-dep-nam,147694523,"Dép nam dép quai ngang nam kiểu Hàn Quốc mã DEP09LE",159000,289000,130000,45
TIKI,giay-dep-nam,163875026,"Đón giày Gỗ Hương/Gõ đỏ vân gỗ đẹp, có thể bỏ túi tiện dụng (DGH905) hàng xuất khẩu, kiểu dáng nhỏ gọn - HAHANCO",60000,60000,0,0
TIKI,giay-dep-nam,48813671,"Cây xỏ giầy gỗ khảm trai hoa văn- dây giưa 70cm",128000,128000,0,0
TIKI,giay-dep-nam,196319310,"Giày Sneaker Da Nam DINCOX E11 Sang Trọng Lịch Thiệp Black",620000,620000,0,0
TIKI,giay-dep-nam,195013905,"Dép da nam đế cao 3.5cm may viền Trường Hải da bò thật màu vàng thời trang nam cao cấp DN156",259000,450000,191000,42
TIKI,giay-dep-nam,3985369," Giày ông già da bò thật VO KK 445",480000,650000,170000,26
TIKI,giay-dep-nam,182144405,"Dép nam xỏ ngón da bò màu đen may viền chính hãng Trường Hải XN159",285000,379000,94000,25
TIKI,ngon,176170801,"[ Chỉ giao HN] - Xúc xích Torpedo Phomai 50gr",134500,134500,0,0
TIKI,ngon,169343556,"Đặc Sản Nha Trang - Thùng 24 Chai Nước Mắm Nhỉ Cá Cơm 584 Loại 35 Độ Đạm Seavy Chai 180 ml / Chai",568000,580000,12000,2
TIKI,ngon,108894807,"[CHỈ GIAO HN] - VITOT FOOD CHẢ MỰC HẠ LONG (500g)",239000,239000,0,0
TIKI,ngon,117401939,"[CHỈ GIAO HN] Set lẩu thập cẩm dành cho 6 người",599000,599000,0,0
TIKI,ngon,190707718,"Chả quế hoa chay Đôi Đũa Vàng dẻo dai đậm đà 230g",115000,115000,0,0
TIKI,ngon,112256720,"Secreto Panceta (Diềm thăn) - Khay 300gram",207000,230000,23000,10
TIKI,ngon,117405160,"[CHỈ GIAO HN] Combo thập Cẩm cho 2 người ăn thoải Mái",329000,329000,0,0
TIKI,ngon,184650676,"Khoai môn lệ phố nhân đậu đỏ Đôi Đũa Vàng, đồ ăn vặt bánh khoai thơm dẻo 260g",105000,105000,0,0
TIKI,ngon,92380623,"Thịt đùi sau Serrano muối cắt lát - Gran Reserva (120g)",230000,230000,0,0
TIKI,ngon,127509679,"[Chỉ giao HN] Dẻ Sườn Bò Mỹ Sốt Tare 150gr",152900,152900,0,0
TIKI,ngon,125796857,"[ Chỉ giao HN] -Khoai lang Nhật 1kg",45000,45000,0,0
TIKI,ngon,179711434,"[Chỉ giao HN] - Nước ép cam - size S (325ml)",68000,68000,0,0
TIKI,ngon,92368136,"Đùi trước Cebo cắt lát - trên 24 tháng (100g)",241000,241000,0,0
TIKI,ngon,124040229,"[Chỉ giao HN] - Bưởi Da Xanh Bến Tre Loại 1 - Size 1.2-1.4Kg",189000,189000,0,0
TIKI,ngon,128707138,"[Chỉ giao HN] Sườn Cừu New Zealand cắt kiểu Pháp - 1KG",1130000,1130000,0,0
TIKI,ngon,92384949,"Thịt đùi sau Serrano muối cắt lát - Reserva (100g)",171000,171000,0,0
TIKI,ngon,176170704,"[ Chỉ giao HN] - Bánh bao sữa nhân matcha 360gr",57500,57500,0,0
TIKI,ngon,195279791,"Đặc Sản Nha Trang - Mực Khô Loại 1 Size 8 Con/Kg Gói 500G",680000,700000,20000,3
TIKI,ngon,197770756,"Đặc Sản Nha Trang - Combo 3 Gói Bánh Khoai Lang Loại Seavy Gói 300G",105000,110000,5000,5
TIKI,ngon,164428765,"[ Chỉ giao HN] - Hồng Xiêm Miền Tây - 1kg",62000,62000,0,0
TIKI,ngon,126962675,"[ Chỉ giao HN] -Váng đậu 500g",45000,45000,0,0
TIKI,ngon,193881160,"Gạo lứt dẻo điện biên -1kg",39000,39000,0,0
TIKI,ngon,121441823,"[Chỉ Giao HN] Quýt Úc (0.4kg - 1.2kg)",99000,99000,0,0
TIKI,ngon,112192994,"Iberico Tapas Mix S - 100g",335000,335000,0,0
TIKI,ngon,160276839,"Nem thịt đặc biệt CP",61560,61560,0,0
TIKI,ngon,164428802,"[ Chỉ giao HN] - Mãng cầu Xiêm - 1kg",52000,52000,0,0
TIKI,ngon,195649326,"Đặc Sản Nha Trang - Cá Bò Da Tẩm Gia Vị Ăn Liền Seavy Gói 250G",92000,95000,3000,3
TIKI,ngon,167734949,"Đặc Sản Nha Trang - Rong Biển Nấu Canh, Rong Riển Khô ,Seavy Gói 200 Gram",129000,135000,6000,4
TIKI,ngon,176170740,"[ Chỉ giao HN] - Xúc xích Vườn Bia 450gr",106100,106100,0,0
TIKI,ngon,92380634,"Đùi sau Bellota cắt lát - trên 36 tháng (100g)",490000,490000,0,0
TIKI,ngon,120563495,"[CHỈ GIAO HN] - MỰC LÁ CÂU TƯƠI VITOT FOOD (500g/khay)",390000,390000,0,0
TIKI,ngon,156937356,"[ Chỉ giao HN] -Nấm Rơm - 1kg",160000,160000,0,0
TIKI,ngon,171138069,"Đặc Sản Nha Trang - Khô Cá Chai Seavy Gói 500G",170000,170000,0,0
TIKI,ngon,92380603,"Thịt lưng trước Iberico (khay 300g)",266000,295000,29000,10
TIKI,ngon,176170760,"[ Chỉ giao HN] - Ðùi gà chiên cay 500gr",93900,93900,0,0
TIKI,ngon,125578113,"[Chỉ giao HN] Cá Basa cắt khúc khay 1kg",70000,70000,0,0
TIKI,ngon,169005467,"Lược Chải Ve Chấy Rận Cho Chó Mèo Hộp LCL004",25000,25000,0,0
TIKI,ngon,92368138,"Đùi heo trắng muối cắt lát - trên 16 tháng (100g)",158000,158000,0,0
TIKI,ngon,169345916,"Đặc Sản Nha Trang - Rau Câu Chân Vịt Sạch Cát, Rau Câu Nấu Chè, Seavy Gói 200 Gram",169000,175000,6000,3
TIKI,ngon,116553121,"[Chỉ giao HN] - Dẻ Sườn Bò - Khay 1Kg Hút Chân Không",329000,329000,0,0
TIKI,giay-dep-nu,125098634,"Giày Anh Khoa E993-1",220000,220000,0,0
TIKI,giay-dep-nu,61278538,"Giày thể thao nữ hoa cúc đi bộ cực êm siêu xinh V253 - Đỏ đô - Size 36",55000,55000,0,0
TIKI,giay-dep-nu,141955613,"Giày boot bốt nữ cổ thấp 8 phân hàng hiệu rosata hai màu đen đỏ ro370",560000,560000,0,0
TIKI,ngon,169003905,"[Gói 100g] Thức ăn cho mèo con và mèo trưởng thành Royal canin,Reflex,Me-o.Whiskas,Catsrang,Cat Eye - Reflex Plus mèo lớn vị gà",15000,15000,0,0
TIKI,giay-dep-nu,190737358,"Giày Búp Bê Nữ Hỡ Mũi Da Bò Thật BIGGBEN Cao 5 Phân BB127",309000,400000,91000,23
TIKI,ngon,166083051,"RỌ MÕM MỎ VỊT THỜI TRANG ( giao màu ngẫu nhiên) - L",55000,55000,0,0
TIKI,ngon,169004001,"Đồ Chơi Bóng Lật Đật Cho Thú Cưng Chó Mèo Hili HL600010",11000,11000,0,0
TIKI,giay-dep-nu,132299268,"Giày Keds Nữ - Champion Black - KD034100",599000,1290000,691000,54
TIKI,ngon,169005030,"Bình ti bú sữa cho cún mèo con 150ml bình bú dạng có núm vú",27200,27200,0,0
TIKI,giay-dep-nu,127380264,"Giày Sneaker Vải Nữ DINCOX C20 Nữ Tính Sang Trọng Black",376000,376000,0,0
TIKI,ngon,170180045,"Clicker Huấn Luyện Chó Kún Miu - Giao Màu Ngẫu Nhiên",29999,29999,0,0
TIKI,giay-dep-nu,182301306,"DÉP QUAI NGANG BÁNH MỲ KẺ Ô NAM NỮ ĐI CHUNG- MẪU MỚI HOT TREND",35000,38000,3000,8
TIKI,phu-kien-thoi-trang,45092445,"NÓN LEN NỮ BUTION, MŨ LEN NỮ BUTION DN19121713",99000,99000,0,0
TIKI,giay-dep-nu,178211269,"Dép Quai Ngang Nam Nữ Siêu Nhẹ Tăng Chiều Cao Chống Trơn Đế 4CM",57000,82000,25000,30
TIKI,ngon,166062718,"Thức Ăn Cho Chó Trưởng Thành REFLEX PLUS MINI & SMALL BREED ADULT - Gói ăn thử - Thịt Gà",10000,10000,0,0
TIKI,giay-dep-nu,69537025,"Giày oxford đế thô 5 phân S162",221000,235000,14000,6
TIKI,giay-dep-nu,90374824,"Giày Búp Bê Đế Xuồng Trơn Chính Hãng TRƯỜNG HẢI DX125 Da Bò Thật Màu Đen Đế Cao su Mềm Dẻo 4Cm HÌNH ẢNH THẬT",239000,279000,40000,14
TIKI,giay-dep-nu,14346271,"Giày nữ đế xuồng da bò cao cấp Trường Hải DX016",255000,319000,64000,20
TIKI,ngon,169064932,"Dây Dắt Chó Mèo Chất Liệu Dây Dù Cao Cấp Dây Dẫn Cho Thú Cưng Dưới 4kg Dài 120cm Dày 1cm - Đỏ",19999,19999,0,0
TIKI,giay-dep-nu,109787993,"Giày nữ thời trang cao cấp ELLY – EG125",1299000,1299000,0,0
TIKI,phu-kien-thoi-trang,75950576,"Mấn nhung cài tóc phong cách Âu Mỹ - Mã MA001",75000,75000,0,0
TIKI,phu-kien-thoi-trang,86422940,"Tóc giả nữ  tặng lưới chùm tóc- Tóc giả cao cấp nguyên đầu xoăn qua vai cao cấp - hình thật",222000,222000,0,0
TIKI,ngon,166063059,"Quả bóng đồ chơi nhai gặm cho cún cưng, có chuông kêu vui nhộn - Size nhỏ 5.5cm",17000,17000,0,0
TIKI,phu-kien-thoi-trang,197219102,"Nón Kết EVISU Da Phối Lưới /Nón Kết Nam Nữ",219000,219000,0,0
TIKI,giay-dep-nu,101026765,"Giày múa bale nữ 21114",93300,114100,20800,18
TIKI,phu-kien-thoi-trang,50328654,"Cài tóc nam - nữ",10000,10000,0,0
TIKI,ngon,186166024,"Bột Chiên Giòn Tempura Thái Lan 1kg - EUFOOD Việt Nam - Nguyên Liệu Nấu Ăn Nhập Khẩu Chính Hãng",90000,90000,0,0
TIKI,ngon,186166104,"Màng Nhôm Thực Phẩm 198 (45cm x 230m) - EUFOOD Việt Nam - Màng phủ Khay Nướng Trung Quốc",314000,314000,0,0
TIKI,giay-dep-nu,20818428,"Giày búp bê nữ , Giày lười nữ , Giày mọi nữ , Giày slip on nữ cao cấp SP34",209000,209000,0,0
TIKI,phu-kien-thoi-trang,128649189,"200 g Dây thun cột tóc dây chun cột tóc đen và nhiều màu loại tốt",38000,38000,0,0
TIKI,giay-dep-nu,57784268,"Dép đi trong nhà nhiều màu đi bộ siêu bền tiện lợi V249",25000,25000,0,0
TIKI,phu-kien-thoi-trang,196234708,"Dây buộc tóc nữ bện tít [Set 10 dây] NASI nhiều màu dễ thương phong cách hàn quốc thun cột tóc nữ co giãn tốt phụ kiện tóc",19000,19000,0,0
TIKI,phu-kien-thoi-trang,196531757,"Dây buộc tóc nữ quả anh đào [Set 5 dây] NASI dễ thương phong cách hàn quốc thun cột tóc nữ co giãn tốt phụ kiện tóc",15000,15000,0,0
TIKI,giay-dep-nu,206239614,"Giày búp bê nữ quai ngang, giày bệt nữ trung niên đế cao 3cm đi nhẹ êm chân  - Mã SP : GD1",220000,220000,0,0
TIKI,phu-kien-thoi-trang,46109359,"Mũ nón lưỡi trai nửa đầu thể thao cao cấp mũ nón golf tennis",149000,149000,0,0
TIKI,giay-dep-nu,181447678,"Guốc Gỗ, Guốc Mộc Quai Nhung Đen Sang Trọng",109000,109000,0,0
TIKI,ngon,186553721,"Khô Bò Xé Sợi hàng loại 55g-125g",78000,78000,0,0
TIKI,ngon,169069537,"Dây + Yếm Size M (Lớn)(1 sản phẩm)",29000,29000,0,0
TIKI,giay-dep-nu,8005607,"Sandal Nữ BIGGBEN Da Bò Thật Cao Cấp SDN06",329000,450000,121000,27
TIKI,phu-kien-thoi-trang,159390392,"Thắt lưng nữ/ dây nịt nữ da bò nguyên miếng cao cấp Mã 9204",69000,119000,50000,42
TIKI,phu-kien-thoi-trang,81090114,"Kính cơn chữ nhỏ AO tròng thủy tinh 12KGF.51- 2 cao cấp",223000,235000,12000,5
TIKI,ngon,166059312,"Phụ kiện kính đeo thời trang cho chó mèo",30000,30000,0,0
TIKI,giay-dep-nu,148932451,"Giày Thể Thao Nữ Thoáng Khí Êm Chân Phong Cách Hàn Quốc Đế Cao Su Nguyên Khối 4CM Tôn Dáng GTTN03 SUNO STORE",248000,248000,0,0
TIKI,giay-dep-nu,71508520,"Giày oxford đế độn 4 phân - Giày nữ đế thấp S161",178000,189000,11000,6
TIKI,giay-dep-nu,108511546,"Giày Sandal Cao Gót Da Bò BIGGBEN SDCG67",319000,450000,131000,29
TIKI,giay-dep-nu,52228079,"Giày Sandal Nữ BIGGBEN Da Bò Thật SDN51",329000,400000,71000,18
TIKI,ngon,169062501,"Bình nước gắn chuồng cho chó mèo",29999,29999,0,0
TIKI,giay-dep-nu,15246575,"Dép Xỏ Ngón Nữ BIGGBEN Da Bò Thật DXN18",289000,350000,61000,17
TIKI,phu-kien-thoi-trang,263965913,"Kiếng bảo hộ mắt kiếng trắng bảo vệ mắt kiếng đi mưa kính mắt che bụi tráng gương chống loá chống tia uv kính lao động",47500,47500,0,0
TIKI,phu-kien-thoi-trang,157086434,"Thắt lưng nữ  bản nhỏ, dây nịt nữ da thật cao cấp thời trang cá tính mã TL.NU02",129000,229000,100000,44
TIKI,phu-kien-thoi-trang,11696126,"Mũ nón thủy thủ nữ hotgirl 2019",65998,65998,0,0
TIKI,phu-kien-thoi-trang,37969775,"Quần Tất Nữ Kiểu Cách Hàn Quốc Siêu Cấp LS11",49000,88500,39500,45
TIKI,ngon,197988720,"Kem Body Ngày Cần Tây Rau Má Vinanutrifood, nuôi dưỡng làn da trắng sáng, Lọ 200g",180000,180000,0,0
TIKI,ngon,186165966,"Túi Đựng Thực Phẩm Tự Hủy Sinh Học 30cm x 45cm (1kg/Cuộn) - Túi Chịu Nhiệt, Bảo Vệ Môi Trường",90000,90000,0,0
TIKI,phu-kien-thoi-trang,177924143,"KIM BĂNG CÀI QUẦN, GHIM CÀI QUẤN ÁO, THU NHỎ EO CỰC HOT",16999,16999,0,0
TIKI,giay-dep-nu,152335377,"[GDSG111] Dép đi trong nhà bọt xốp[Giá hủy diệt][Có sẵn] Dép nhiều kiểu hàng nhập [Hàng nhập",45000,45000,0,0
TIKI,ngon,172161893,"Măng củ tươi Hòa Bình ",23000,23000,0,0
TIKI,ngon,185657620,"Viên Tôm Thái 500g",35000,35000,0,0
TIKI,ngon,172148855," Rau đay",8000,8000,0,0
TIKI,giay-dep-nu,147689002,"Dép sục bò sữa siêu nhẹ - Dép nữ DS4550",89000,89000,0,0
TIKI,phu-kien-thoi-trang,25144973,"THẮT LƯNG NỮ DN19TL05",79000,99000,20000,20
TIKI,giay-dep-nu,51289444,"Lót giày cao gót mũi nhọn 4D có gờ chống sốc giảm mỏi gang bàn chân - buybox - BBPK65",35000,70000,35000,50
TIKI,ngon,104370012,"Bánh macaron thường - 1 cái",15000,15000,0,0
TIKI,giay-dep-nu,81132358,"Dép đi trong nhà- nachidu- MT14 - MÀU HỒNG- free size ( 38-42)",89000,89000,0,0
TIKI,phu-kien-thoi-trang,72648990,"Cột Tóc Vải Scrunchies, Dây Buộc Tóc Scrunchies Nhiều Màu Hàn Quốc SC03 cực kì xinh xắn",11000,11000,0,0
TIKI,phu-kien-thoi-trang,196597140,"Dây buộc tóc nữ chữ M [Set 5 dây] NASI dễ thương phong cách hàn quốc thun cột tóc nữ co giãn tốt phụ kiện tóc",12000,12000,0,0
TIKI,giay-dep-nu,150859559,"Dép Eva Phun Nữ Biti's DEW007900HOL (Hồng Lợt)",94000,102000,8000,8
TIKI,ngon,166062658,"Rọ mõm mỏ vịt cho chó (mầu ngẫu nhiên) - L",44000,44000,0,0
TIKI,phu-kien-thoi-trang,196204064,"Dây buộc tóc nữ hoa 8 cánh [Set 5 dây] NASI dễ thương phong cách hàn quốc thun cột tóc nữ co giãn tốt phụ kiện tóc",10000,10000,0,0
TIKI,phu-kien-thoi-trang,184694700,"Ghim cài áo vest - ghim ( kèm ảnh minh họa ) - Full box",159000,159000,0,0
TIKI,giay-dep-nu,113255924,"Dép guốc quai trong",166500,166500,0,0
TIKI,phu-kien-thoi-trang,195991054,"Dây buộc tóc nữ đính hạt tròn Acrylic [Set 5 dây] NASI dễ thương phong cách hàn quốc thun cột tóc nữ co giãn tốt phụ kiện tóc",25000,25000,0,0
TIKI,ngon,171021206,"[ Chỉ giao HN] - Trà Thái Nguyên 3 sao 200g Tâm Minh",60000,60000,0,0
TIKI,phu-kien-thoi-trang,98084968," MŨ BUCKET 2 MẶT NAM NỮ - CHIẾC LÁ",42600,42600,0,0
TIKI,giay-dep-nu,90797525,"COMBO 2 BỘ MIẾNG DÁN ĐẾ GIÀY CHỐNG TRƠN TRỢT (MÀU ĐEN)",30000,30000,0,0
TIKI,ngon,155495704,"[Chỉ giao HN] Muối vừng đen to 500gr",55000,55000,0,0
TIKI,phu-kien-thoi-trang,196598437,"Trâm cài áo - ghim cài Áo Vest nam Pha Lê phối xích tạo kiểu bánh lái tàu nạm đá cao cấp",349000,349000,0,0
TIKI,giay-dep-nu,177924123,"Sục Lưới ĐEN FULL (Tem chữ trắng) 7CM - SOD599-2003",599000,599000,0,0
TIKI,phu-kien-thoi-trang,95141785,"Kẹp tóc càng cua màu trơn Snail KT07 dễ thương, đơn giản, xinh xắn, chất liệu cao cấp",19500,19500,0,0
TIKI,giay-dep-nu,181997091,"Sandal nữ đế bằng mũi nhọn thời trang mới nhất V301",89000,89000,0,0
TIKI,giay-dep-nu,176543491,"Sandal quai trong nạm đinh sang chảnh",169000,169000,0,0
TIKI,ngon,170180059,"Thức Ăn Cho Mèo lông dài Me-O Gold Persian  - 1,2kg",170000,170000,0,0
TIKI,phu-kien-thoi-trang,184650894,"Kính Mát Thể Thao Nam Phân Cực AORON Dáng Ôm Chống Tia UV Phù Hợp Đạp Xe, Câu Cá, Hoạt Động Ngoài Trời - AK054",290000,390000,100000,26
TIKI,ngon,166083560,"Rọ mõm cho chó mẫu mỏ vịt  - Size M",29000,29000,0,0
TIKI,ngon,159728985,"[Chỉ giao HN] - Cá Nục Nhật Nguyên con -  1kg",69000,69000,0,0
TIKI,ngon,169074972,"[Combo 10 lọ] Nước Yến sào Khánh Hòa Sanest dành cho trẻ em đóng lọ 62ml",330000,330000,0,0
TIKI,ngon,172919908,"[Chỉ giao Hà Nội] - Bình Gas Công Nghiệp Petrol Việt Nam - 45kg",1680000,1680000,0,0
TIKI,phu-kien-thoi-trang,124265869,"Dây Cột tóc hoa cúc đủ màu dễ thương phong cách hàn quốc, Buộc tóc hoa cúc",1050,1050,0,0
TIKI,ngon,172175896,"Salad mix màu xanh- 200g",35000,35000,0,0
TIKI,giay-dep-nu,143793578,"Dép xỏ ngón nữ thời trang cao cấp Trường Hải Màu đen Da mềm đế Pu cao 2.5cm N145Đ",207000,259000,52000,20
TIKI,ngon,185226492,"Cá Ba Sa Làm Sạch Nguyên Con Size 1.6-3kg",78000,78000,0,0
TIKI,ngon,169068137,"Bình nước gài chuồng cho thú cưng",24000,24000,0,0
TIKI,giay-dep-nu,125099021,"Giày Lười Nữ Anh Khoa A923-3",199000,199000,0,0
TIKI,phu-kien-thoi-trang,90321827,"Bờm cài tóc nam nữ unisex nhựa mẫu mới",11500,11500,0,0
TIKI,phu-kien-thoi-trang,132955940,"TẤT VỚ NỮ MÀU DA Loại xỏ ngón Chất liệu thun Co giãn Thoáng mát Dài 37cm Loại dày êm",18000,18000,0,0
TIKI,phu-kien-thoi-trang,99670089," Cặp tóc càng cua mẫu 6 răng nhựa bóng",22000,22000,0,0
TIKI,giay-dep-nu,189492042,"GIÀY THỂ THAO NỮ FASHION ĐEN TRẮNG CỰC ĐẸP",155000,155000,0,0
TIKI,phu-kien-thoi-trang,118844763,"Nón beret bí nỉ 4 màu best seller",129000,129000,0,0
TIKI,giay-dep-nu,197663303,"Giày Cao Gót Nữ BIGGBEN Da Bò Thật Cao 5 Phân GCG11",329000,400000,71000,18
TIKI,ngon,118777717,"[Chỉ Giao Hà Nội] Thịt nạc vai xay - 1kg ",125000,125000,0,0
TIKI,phu-kien-thoi-trang,24932638,"Gọng Kính Unisex BOXX BMX 917R/F90",570000,1900000,1330000,70
TIKI,phu-kien-thoi-trang,190323876,"Kẹp Tóc Nữ 3 Hạt Giữ Tóc Đa Năng Siêu Hot",28000,28000,0,0
TIKI,ngon,104370016,"Set 4 macaron hoạt hình - 4 cái",100000,100000,0,0
TIKI,phu-kien-thoi-trang,124163370,"Gọng Kính Nam Mắt Vuông Cao Cấp Không Độ - Mắt Kính Chống Ánh Sáng Xanh",185000,195000,10000,5
TIKI,ngon,169061490,"Bát ăn cho chó - bát nhựa tròn giao màu ngẫu nhiên - M",19000,19000,0,0
TIKI,ngon,166062466,"Banh bảy màu đồ chơi cho chó mèo  - Size M",25000,25000,0,0
TIKI,ngon,169068144,"Đồ Ăn Cho Mèo Trưởng Thành Me-O Hương Vị Cá Thu (1.2kg)",100000,100000,0,0
TIKI,giay-dep-nu,7985178,"Dép Xỏ Ngón Nữ BIGGBEN Da Bò Thật Cao Cấp DXN02",329000,350000,21000,6
TIKI,ngon,166062734,"Máy Phun Sương Và Bình Hương Xịt Khử Mùi Khử Trùng Tự Động Bioion cho chó mèo thú cưng",259000,259000,0,0
TIKI,ngon,169069423,"Bình Nước Dã Ngoại Cho Thú Cưng",30000,30000,0,0
TIKI,phu-kien-thoi-trang,163023727,"Tất Cao Cổ Giả Boot, Tất Bắp Chân Cotton Len Thu Đông Chất Dày Mềm Mịn PK227",49000,49000,0,0
TIKI,phu-kien-thoi-trang,95141820,"Kẹp Tóc Càng Cua Vuông Phong Cách Hàn Quốc Cực Đẹp KT14",20000,20000,0,0
TIKI,phu-kien-thoi-trang,196339398,"Dây buộc tóc nữ hoa Rumdul [Set 6 dây] NASI đẹp ngọt ngào phong cách hàn quốc thun cột tóc nữ co giãn tốt phụ kiện tóc",39000,39000,0,0
TIKI,phu-kien-thoi-trang,196234379,"Dây buộc tóc nữ pha lê cao cấp [Set 5 dây] NASI sang trọng dễ thương phong cách hàn quốc thun cột tóc nữ co giãn tốt phụ kiện tóc",49000,49000,0,0
TIKI,giay-dep-nu,117684784,"Lót gót giày rộng giảm size Chống Tuột gót chống phồng Chống Đau Chân Kéo Dài Từ Gót Chân Đến Nửa Bàn Chân 1 Đôi",24999,24999,0,0
TIKI,giay-dep-nu,185990101,"Dép đế xuồng nữ dép nữ cổ tích đế cao 5cm êm nhẹ phong cách Hàn Quốc mã 1418-737",299500,599000,299500,50
TIKI,ngon,160392720,"Tôm Surimi chả tôm định hình",64000,64000,0,0
TIKI,ngon,117510039,"Giò Lụa (250 gram)",66000,66000,0,0
TIKI,phu-kien-thoi-trang,175413663,"Cài Tóc, Bờm Nhựa Dẻo Không Gãy (Giao Màu Ngẫu Nhiên)",12000,12000,0,0
TIKI,ngon,169061830,"CHUÔNG HUẤN LUYỆN CHÓ, MÈO - Màu Xanh Bích",28000,28000,0,0
TIKI,phu-kien-thoi-trang,174566949,"Set 10 Khuy Cài Áo",34000,34000,0,0
TIKI,ngon,180322246,"Thùng 6 chai nước mắm nhỉ Làng Chài Xưa Nhãn Đỏ 500ml/chai truyền thống vị gu ông bà",590000,590000,0,0
TIKI,ngon,176170680,"[ Chỉ giao HN] - Đùi tháo khớp 2kg",245000,245000,0,0
TIKI,ngon,193881175,"Mỳ 8 vị đặc sản Bắc Giang - 1kg",85000,85000,0,0
TIKI,ngon,169843977,"Đặc Sản Nha Trang - Khô Cá Mai Nha Trang, Seavy Gói 500 Gram",180000,180000,0,0
TIKI,ngon,168463044,"Đặc Sản Nha Trang - Mắm Ruột Cá Thu Ngừ Hương Vị Truyền Thống Seavy Hộp 500g",82000,85000,3000,4
TIKI,ngon,109396585,"[CHỈ GIAO HN] - CUA RỐC XAY VITOT FOOD (4- 5túi/kg)",129000,129000,0,0
TIKI,ngon,126809018,"[ Chỉ giao HN] - Cơm sầu Thái khay 800g - 1,2 kg",267000,267000,0,0
TIKI,ngon,179371944,"Phô mai que kéo sợi Mozzarella thơm ngậy Đôi Đũa Vàng 300gr - Giao tại Hà Nội và Hồ Chí Minh",199000,199000,0,0
TIKI,ngon,195329408,"Đặc Sản Nha Trang - Khô Cá Bò Đại Dương Phi Lê Tẩm Gia Vị Sẵn, Seavy Hộp 400g",135000,140000,5000,4
TIKI,ngon,118588322,"Bánh nướng thập cẩm nhân lạp xưởng, lá chanh, hạt sen, hạt dưa",50000,50000,0,0
TIKI,ngon,193881191,"Mỳ chũ rau củ Bắc Giang - 1kg",80000,80000,0,0
TIKI,ngon,104008001,"[Chỉ Giao HN] Cam vàng Navel - 1KG",89000,89000,0,0
TIKI,ngon,179510971,"Pizza nhân thịt heo bằm sốt phô mai Đôi Đũa Vàng hộp 350g đậm đà hương vị truyền thống",205000,205000,0,0
TIKI,ngon,184790625,"Cánh gà khúc giữa Ba Lan - 1kg",84000,84000,0,0
TIKI,ngon,171833835,"[ Chỉ giao HN] -Raw Food Chim cút dứa vừng 250gr",45000,45000,0,0
TIKI,ngon,177714038,"Bim Bim Que Thái Lan",7000,7000,0,0
TIKI,ngon,142203019,"[CHỈ GIAO HN] Mận đỏ An Phước 1KG",68000,68000,0,0
TIKI,ngon,118988738,"[Chỉ giao HN] - Trứng Cá Ngừ Đại Dương – 1Kg",319000,319000,0,0
TIKI,ngon,179711624,"[Chỉ giao HN] - Hạnh nhân Olam sống nhập khẩu Mỹ - 1kg",370000,370000,0,0
TIKI,ngon,176909569,"[Chỉ giao HN] - Xúc xích Đức Việt- Túi 500g",48000,82000,34000,41
TIKI,ngon,193128581,"[Chỉ giao HN] - Sụn Gối Gà - Túi 1Kg",135000,167000,32000,19
TIKI,ngon,142315251,"[Chỉ giao HN] Phô mai bào Mozzarella Anchor New Zealand gói 2kg",557000,557000,0,0
TIKI,ngon,103663765,"[Chỉ giao HN] - Dưa Đài Loan 1 quả - 1 quả",199000,199000,0,0
TIKI,ngon,176170681,"[ Chỉ giao HN] - Giò bò Cắt Khoanh 250gr",72000,72000,0,0
TIKI,ngon,144238806,"[Chỉ giao HN] - Hồng Sấy Dẻo - Món Ngon Từ Đà Lạt - Quà Biếu Sang Trọng",199000,199000,0,0
TIKI,ngon,168152059,"Đặc Sản Nha Trang - Mắm Ruốc Nguyên Chất Nha Trang Hương Vị Biển Khơi, Seavy Hộp 500g",68000,70000,2000,3
TIKI,ngon,120431072,"[Chỉ giao HN] - Vịt Cỏ Vân Đình Tươi Ngon Thịt Sẵn ",419000,419000,0,0
TIKI,ngon,114197781,"[Chỉ giao HN] - Khoai Lang Kén Chiên Giòn Túi 250g",50000,50000,0,0
TIKI,ngon,163554326,"[Chỉ giao HN] - Ba chỉ bò Mỹ - Khay 500g",119000,160000,41000,26
TIKI,ngon,163554369,"[Chỉ giao HN] - Móng heo - Túi 2 chiếc ( 1,1kg)",78000,78000,0,0
TIKI,ngon,125796885,"[ Chỉ giao HN] -Dưa chuột 1kg",40000,40000,0,0
TIKI,ngon,116553139,"[Chỉ giao HN] - Bắp Hoa Trâu - Khay 1Kg Hút Chân Không",379000,379000,0,0
TIKI,ngon,169342826,"Đặc Sản Nha Trang - Nước Mắm Nhĩ Cá Cơm 584 Nha Trang 35 Độ Đạm, Seavy Hộp 6 Chai 180ml",168000,170000,2000,1
TIKI,ngon,171833856,"[ Chỉ giao HN] -Raw Food Bò nam việt quất hạt lanh 250gr",45000,45000,0,0
TIKI,ngon,155495694,"[Chỉ giao HN]Khoai Tây Baby- 1kg",36000,36000,0,0
TIKI,ngon,108276806,"[Chỉ giao HN] - Giỏ trái cây A 481 -  Giỏ",480000,480000,0,0
TIKI,ngon,129521030,"Vú Sữa Lò Rèn SKYFRUIT",49000,49000,0,0
TIKI,ngon,171105628,"Đặc Sản Nha Trang - Cá Mú Khô Phi Lê Hộp Seavy 250G",92000,95000,3000,3
TIKI,ngon,118510736,"Giỏ Quả Trái Cây Nhập Khẩu - Cỡ Bé",399000,399000,0,0
TIKI,ngon,126768835,"[Chỉ giao HN] Set Móng Heo Giả Cầy ( Đủ vị ) - 1Kg",90000,90000,0,0
TIKI,ngon,127388276,"[Chỉ giao HN] Set lẩu full topping",379000,379000,0,0
TIKI,ngon,126796310,"Cá mối phi lê - gói 500gr",75000,75000,0,0
TIKI,ngon,125577752,"[CHỉ giao HN] Thịt ba chỉ heo rút sườn loại ngon - 1kg",118000,118000,0,0
TIKI,ngon,173288238,"[Chỉ giao HN] - Ba Chỉ Hun Khói Tây Bắc Ăn Liền - 500g",189000,189000,0,0
TIKI,ngon,169077695,"Nước Yến Sào Cao Cấp Khánh Hòa Sanest Lọ 70ml",34000,34000,0,0
TIKI,ngon,173382235,"12 Túi Đồ Ăn Cho Chó Nhỏ Vị Thịt Gà Miếng Nấu Xốt SmartHeart (130g)",180000,180000,0,0
TIKI,ngon,170180254,"Bát ăn cho chó - bát nhựa tròn giao màu ngẫu nhiên - M",19000,19000,0,0
TIKI,ngon,169003745,"Sữa tắm SOS cho chó mèo (100% chính hãng) - Nâu,550ml",79900,79900,0,0
TIKI,ngon,123575326,"Bánh khúc Việt Trì (sét 10 cái trắng) cấp đông",129000,129000,0,0
TIKI,ngon,169067375,"Đĩa Bay huấn luyện chó mèo - Đồ chơi cho chó mèo (Màu ngẫu nhiên)",20000,20000,0,0
TIKI,ngon,171833884,"[ Chỉ giao HN] -Snack sấy khô Thực quản bò 100gr",80000,80000,0,0
TIKI,ngon,170179459,"Xẻng hốt phân mèo kèm thùng rác - tặng kèm 15 túi đựng phân (giao màu ngẫu nhiên)",63000,63000,0,0
TIKI,ngon,166057773,"Sữa Tắm Dành Cho Mèo SOS (530ml)",79999,79999,0,0
TIKI,ngon,170179201,"Tấm lót vệ sinh than hoạt tính cho chó mèo - Loại thường xanh,50 miếng(45x60)",122222,122222,0,0
TIKI,ngon,170180223,"Miếng lót vệ sinh đa năng chó thú cưng nhà bạn 00100 - Xanh - M",149999,149999,0,0
TIKI,ngon,173381289,"Sữa Tắm Olive Essence 450ml Cho Chó Mèo - 4. Trừ ngứa khử mùi",44444,44444,0,0
TIKI,ngon,169004507,"Dầu tắm SOS cho chó mèo 530ml - Xanh ngọc",79999,79999,0,0
TIKI,ngon,166083106,"Thức ăn hạt cho mèo Me-O - Kitten 400g",45000,45000,0,0
TIKI,ngon,169004636,"[CHÍNH HÃNG] Thuốc Nhỏ Tai BIO GENTAZOL Trị Viêm Tai cho Chó Mèo 10ml",35000,35000,0,0
TIKI,ngon,169003960,"Tấm lót vệ sinh cho chó mèo - S",149999,149999,0,0
TIKI,ngon,170180258,"Miếng lót vệ sinh cho chó mèo S-M-L-XL-79100 - Xanh - S",144000,144000,0,0
TIKI,ngon,170179965,"Dây cổ công ty cho thú cưng dưới 5kg (giao màu ngẫu nhiên)",45000,45000,0,0
TIKI,ngon,170180502,"ĐỒ CHƠI Thảm cào móng cho mèo( dạng sóng, hình ngẫu nhiên) - To",59000,59000,0,0
TIKI,ngon,166057915,"Thức ăn hạt cho mèo Me-O - Kitten 400g",45000,45000,0,0
TIKI,ngon,170180532,"Vòi uống nước gắn chuồng cho chó mèo (Xanh)",38999,38999,0,0
TIKI,ngon,169005937,"Bộ 2 Vòng cổ, dây đeo cổ cho chó mèo -  Màu ngẫu nhiên - VOC-25, Dài 36-52 cm Rộng 2.5 cm",80000,80000,0,0
TIKI,ngon,169063476,"Bình Nước Gắn Chuồng Cho Thú Cưng - Vàng",25000,25000,0,0
TIKI,ngon,170179473,"Bát ăn cho chó mèo xuống nước tự động (màu ngẫu nhiên, không kèm bình nước) - Size M",31000,31000,0,0
TIKI,ngon,170179891,"ROYAL CANIN URINARY S/O - THỨC ĂN CHO MÈO BỊ SỎI THẬN - 1,5Kg",549000,549000,0,0
TIKI,ngon,170179757,"Bình Ti Bình Sữa Chó Mèo Sơ Sinh Pet Bottles Dill 150ml",25000,25000,0,0
TIKI,ngon,169004207,"Dây Dắt Vòng Cổ Chó Mèo Kún Miu (1.5cm) - Giao Màu Ngẫu Nhiên",28000,28000,0,0
TIKI,ngon,169004084,"Thức Ăn Cho Mèo Lớn Me-O Adult (350g)",26999,26999,0,0
TIKI,ngon,169003972,"Đồ Chơi Cao Su Hình Xương Có Gai Luyện Tập Răng Cho Thú Cưng",19000,19000,0,0
TIKI,ngon,169004887,"Vòng cổ đệm cho chó (Chọn 4 màu)  - Xanh Dương - M",32000,32000,0,0
TIKI,ngon,173359501,"Thức ăn cho mèo ROYAL CANIN BRITISH SHORTHAIR ADULT - 2kg",575000,575000,0,0
TIKI,ngon,166062959,"Thức ăn cho chó con Smartheart Puppy vị thịt bò và sữa 1.5kg-Tặng kèm 1 gói Pate Smartheart 130g",118888,118888,0,0
TIKI,ngon,173379761,"Cát vệ sinh cho mèo GENKI",55500,55500,0,0
TIKI,ngon,166059240,"Bánh Bi men sữa dinh dưỡng Cho Hamster, Nhím, Sóc - Túi ăn thử",3000,3000,0,0
TIKI,ngon,169005135,"[Gói 100g] Thức ăn Pháp giúp chăm sóc răng miệng,hỗ trợ tiêu hóa,tiêu búi lông cho mèo con và mèo trưởng thành - RC Indoor 27",23000,23000,0,0
TIKI,may-anh,47878241,"Kính Lọc Filter Hoya UX UV 67mm - Hàng Chính Hãng",441999,441999,0,0
TIKI,may-anh,158890697,"Chân đèn Ciya Inox IN-210, 210cm - Hàng nhập khẩu",379999,379999,0,0
TIKI,may-anh,91729501,"Pin Cho Máy Ảnh Nikon Li-ion 7.4V 2200mAh EN-EL3E",170050,179000,8950,5
TIKI,may-anh,153037267,"Camera IP POE Thân 2.0MP DAHUA DS2230SFIP-S2 hàng chính hãng DSS Việt Nam",721500,721500,0,0
TIKI,may-anh,23417162," Kính thiên văn cao cấp Carson SkySeeker JC-1000 - Hàng chính hãng",5400000,5400000,0,0
TIKI,may-anh,108087879,"Camera giám sát IMOU Ranger 2C 2MP, 1080P IPC-TA22CP-B - Hàng Chính Hãng",569000,569000,0,0
TIKI,may-anh,91648636,"Pin Cho Camera Action Gopro Hero 5/6/7 Li-ion 1250mAh AHDBT-501",156750,165000,8250,5
TIKI,may-anh,155761583,"Camera hành trình xe hơi, ô tô thương hiệu HP f960x cao cấp tích hợp Wifi GPS Full HD 2304*1296P - Hàng Nhập Khẩu ",2300000,2300000,0,0
TIKI,may-anh,184771570,"Giá đở Camera hành trình và camera thể thao gắn trên kính xe hơi",69000,69000,0,0
TIKI,may-anh,11370580,"Combo Giá đỡ chụp hình Tripod 3120 dành cho điện thoại, máy ảnh, tặng kẹp điện thoại",54100,54100,0,0
TIKI,may-anh,95526954,"Camera IP Wifi ngoài trời PTZ SriHome SP028 2.0MP FullHD 1080P, Xoay 355 độ, chống nước IP66 (Trắng) HÀNG CHÍNH HÃNG",539000,539000,0,0
TIKI,may-anh,92165099,"Camera Dahua 2 Mp DH HAC B1A21P 1080P - Thân Trụ Ngoài Trời - Hàng chính hãng",313000,313000,0,0
TIKI,may-anh,52324969,"Camera Kim Loại SQ8 HD Camera Thể Thao DV Ngoài Trời SQ8",130000,199000,69000,35
TIKI,may-anh,108089799,"Chân máy ảnh Benro dòng FIF28, Hàng chính hãng",2699999,2699999,0,0
TIKI,may-anh,101639481,"Camera mô hình robot đàm thoại 2 chiều 1080p",1035000,1035000,0,0
TIKI,may-anh,142872424,"Mount nối gắn camera",100000,100000,0,0
TIKI,may-anh,47570169,"Phông 3D chụp ảnh sản phẩm – mã MB51",160000,160000,0,0
TIKI,may-anh,158889876,"Chân đèn Beike AR-189, Hàng nhập khẩu",349999,349999,0,0
TIKI,may-anh,4708387,"Bộ 8 Dụng Cụ Mount Dán Gopro (Đen Đỏ) - Hàng Nhập Khẩu",59999,59999,0,0
TIKI,may-anh,9423471,"Kẹp Jaws Flex Clamp cho Gopro",269000,269000,0,0
TIKI,may-anh,10120870,"Camera IP Wifi Ngoài Trời EZVIZ CS-CV310 (1080P) - Hàng Chính Hãng",949000,949000,0,0
TIKI,may-anh,155997868,"Giấy lau, bóng thổi, bút lau VSGO -Hàng Chính Hãng",75555,75555,0,0
TIKI,may-anh,107184715,"Camera IP WIFI IMOU RANGER 2 IPC - A22EP Full HD 1080P ,KÈM THẺ NHỚ 128G - Hàng Chính Hãng",749000,749000,0,0
TIKI,may-anh,200657326,"[ tặng thẻ nhớ 64G] Camera Hành Trình Cho Xe Hơi/Ô Tô Màn Hình Cảm Ứng 12 Inch Ips Bên Trước Và Sau 2K/Full HD1080P, Buletooth, Có Wifi Quay Video Vòng Lặp",4404884,4404884,0,0
TIKI,may-anh,84566847,"Camera IP Wifi Không Dây Xoay Thông Minh Kawasan IPC02 Full HD1080P - Hàng Chính Hãng",1000000,1000000,0,0
TIKI,may-anh,16458389,"Nguồn Camera 12V - 2A",32000,32000,0,0
TIKI,may-anh,269899146,"Kính Hiển Vi Điện Tử Đa Năng 3 trong 1 50x -1000x",590000,590000,0,0
TIKI,may-anh,93741171,"Bóng Thổi Bụi Cho Máy Ảnh",99000,99000,0,0
TIKI,may-anh,71690345,"Tủ chống ẩm Dry Cabi DHC-80 II Tủ ngang, 80 Lít, Hàng nhập khẩu",3249999,3249999,0,0
TIKI,may-anh,2564513,"Bộ Kéo Phông 3 Trục Và Khung Treo",1199000,1199000,0,0
TIKI,may-anh,174811081,"Camera Hành Trình Vietmap C61 Pro cảnh báo giọng nói kèm thẻ nhớ 32 GB - Hàng chính hãng",3275000,3275000,0,0
TIKI,may-anh,10979816,"Sạc đôi kèm cáp sạc và 2 pin sạc KingMa LP-E17 cho Canon EOS M3 M5 M6 760D 800D - Hàng chính hãng",649999,649999,0,0
TIKI,may-anh,155997739,"Filter Kính lọc Hoya UV UX 62mm - Hàng Chính Hãng",409555,409555,0,0
TIKI,may-anh,230082338," 200 Gói chống ẩm 1,2,5,10 gram đóng túi 200 gram",27000,27000,0,0
TIKI,may-anh,169343191,"Chân Máy Ảnh Tripod YungFeng 3388, Giá Đỡ Kèm nút bấm Bluetooth Cao Cấp Chuyên Dùng ChO Điện Thoại Camera Model 2020",239000,239000,0,0
TIKI,may-anh,270812879,"Camera WIFI FullColor 4MP có đàm thoại 2 chiều IMOU BULLET 2 IPC-F42FEP hàng chính hãng",1045000,1045000,0,0
TIKI,may-anh,152647094,"Camera IP POE Dome 2.0MP DAHUA DS2230TDIP-S2 hàng chính hãng DSS Việt Nam",721500,721500,0,0
TIKI,may-anh,157425728,"Camera IP Wifi Yoosee 3 Râu - hàng chính hãng",550000,550000,0,0
TIKI,may-anh,54478379,"Micro thu âm Saramonic Blink 500 B6 - Hàng Chính Hãng",6178000,6178000,0,0
TIKI,may-anh,188907056,"CAMERA YOOSEE WIFI 4 RÂU 20 LED XOAY 180 ĐỘ 5.0 MPX CẢNH BÁO CHỐNG TRỘM KÈM THẺ 32-HÀNG CHÍNH HÃNG",545000,545000,0,0
TIKI,phu-kien-thoi-trang,175192213,"Set 5 Đôi Vớ Nữ Cổ Ngắn GOMTAT Phong Cách Vintage, Tất Cổ Ngắn Nữ Nhiều Màu 5 Đôi Sử Dụng Cả Tuần – CB001-5DOI",29000,49000,20000,41
TIKI,phu-kien-thoi-trang,124276845,"Mắt Kính Đi Đường Chống Bụi Và Tia UV",21499,21499,0,0
TIKI,phu-kien-thoi-trang,15491037,"Combo 4 dụng cụ tạo phồng mái, phồng tóc",39900,39900,0,0
TIKI,phu-kien-thoi-trang,136369438,"Dụng cụ kẹp xược búi bới tóc giúp độn phồng mái độn tóc trông dày hơn rất tự nhiên",20000,20000,0,0
TIKI,phu-kien-thoi-trang,91515814,"Bộ Chân đế gắn đầu manocanh, giá đỡ đầu Manocanh, đế 3 chân cao để đầu manocanh cho bạn thực hành cắt và tạo kiểu tóc tóc  ( Sắt )",350000,350000,0,0
TIKI,phu-kien-thoi-trang,195287211,"Bộ dụng cụ tạo kiểu tóc đa năng",24000,24000,0,0
TIKI,phu-kien-thoi-trang,41068611,"Tròng kính viễn VELOCITY 1.56 HMC UV EMI (1 miếng)",72000,90000,18000,20
TIKI,phu-kien-thoi-trang,160898199,"Set 7 Kẹp Tóc Màu Sắc Xinh Xắn Dành Cho Nữ vintag ( giao mầu ngẫu nhiên)",34000,34000,0,0
TIKI,phu-kien-thoi-trang,130735136,"Kính lão thị kính đọc sách nam nữ chống mỏi chống nhức khi đeo lâu mắt sáng rõ",85500,90000,4500,5
TIKI,phu-kien-thoi-trang,57484446,"Mũ bucket cụp vành nhỏ thời trang phong cách cho nữ",45000,45000,0,0
TIKI,phu-kien-thoi-trang,81985683,"khăn quàng cổ, khăn len, khăn quàng cổ nữ, khăn len choàng cổ, khăn len nữ, khăn choàng cổ, khăn choàng cổ nữ, khăn nữ",119000,119000,0,0
TIKI,phu-kien-thoi-trang,125720574,"Bờm cài tóc nhựa nam nữ unisex BN141 và các mẫu khác",14000,14000,0,0
TIKI,phu-kien-thoi-trang,208174760,"( 40cm ) Tóc giả nữ cột xù mì ngắn, tóc giả buộc xoăn sóng",160000,160000,0,0
TIKI,phu-kien-thoi-trang,248590817,"Thắt lưng nam học sinh DHM-437 | Mặt khoá lăn atimon bóng bản nhỏ 2.3cm | Bảo hành 12 tháng",42000,42000,0,0
TIKI,phu-kien-thoi-trang,137456492,"Mũ len trùm đầu nữ SIÊU_TO Mũ len dệt kim phiên bản Hàn Quốc cho nữ giữ ấm đầu tai có 4 màu, không phai màu",79000,90000,11000,12
TIKI,phu-kien-thoi-trang,188585455,"Khăn Choàng Lụa Hot Trend Size 90x180CM",280000,280000,0,0
TIKI,phu-kien-thoi-trang,270831375,"90x90cmKhăn bandana lụa quấn áo BlackPink - Khăn quàng cổ lụa vuông họa tiết tranh cổ điển Picaso",59000,59000,0,0
TIKI,phu-kien-thoi-trang,166070243,"Gọng kính chính hãng SARIFA 2252",75000,520000,445000,86
TIKI,phu-kien-thoi-trang,163572920,"Thắt lưng da nam cao cấp- dây nịt da bò 2 lớp EMRENEW -Full hộp đựng cao cấp",261000,522000,261000,50
TIKI,phu-kien-thoi-trang,205892995,"Bờm cài tóc nam - nữ màu đen bằng sắt siêu bền",8500,8500,0,0
TIKI,phu-kien-thoi-trang,183040760,"Kính Râm Nam Chống Tia UV, Kính Mát Nam Vuông Dáng Thể Thao, Kính Đổi Màu Đi Ngày Đêm AK048- Aoron",250000,390000,140000,36
TIKI,phu-kien-thoi-trang,120431754,"(Hàng Xịn) Thắt lưng vải_siêu bền, Khóa cài tự động thép không gỉ chắc chắn, tiện lợi_ Dây lưng vải dù cao cấp, Dây nịt lính mạnh mẽ TẶNG MÓC CHÌA KHÓA",129000,129000,0,0
TIKI,phu-kien-thoi-trang,114700099,"Nón bucket Thuglife - mũ tai bèo Ulzzang phong cách, cá tính Unisex nam nữ",44500,89000,44500,50
TIKI,phu-kien-thoi-trang,116021256,"Tất nữ búp bê, Vớ Nữ mang giày lười, giày cao gót, giày búp bê giấu vớ, có đệm cao su chống trượt",17900,22000,4100,19
TIKI,phu-kien-thoi-trang,111422462,"Khăn Lau Kính Chuyên Dụng Đa Năng Nhiều Màu(Ngẫu Nhiên)",1000,1000,0,0
TIKI,phu-kien-thoi-trang,165602381,"Tất Nữ, Combo 5 Đôi Tất Nữ Cổ Ngắn, Mẫu Tất Nữ Hình Gấu Dễ Thương Thời Trang Baw TN05",59000,99000,40000,40
TIKI,phu-kien-thoi-trang,72649409,"Mũ bucket thêu con vịt siêu dễ thương, đội được 2 mặt độc đáo Hạnh Dương",45000,45000,0,0
TIKI,phu-kien-thoi-trang,93213005,"Combo 3 Miếng độn mái phồng, Kẹp tóc chuyên dụng tạo độ phồng tóc KT23",21000,21000,0,0
TIKI,phu-kien-thoi-trang,2343047,"Đai kẹp giữ áo sơ mi kẹp sắt bấm",68000,68000,0,0
TIKI,phu-kien-thoi-trang,82297874,"  Nón lưỡi trai trơn unisex nhiều màu sắc thời trang, form chuẩn, nón kết dành cho nam và nữ, dáng Hàn Quốc hot",15000,15999,999,6
TIKI,phu-kien-thoi-trang,90870222,"KÍNH LÃO GẬP TIỆN LỢI GIÁ RẺ",99000,99000,0,0
TIKI,phu-kien-thoi-trang,96298394,"Xược tóc:xược cài tóc con,xược tóc gáy",25000,25000,0,0
TIKI,phu-kien-thoi-trang,70796252,"Thắt Lưng Nữ Cute Kiểu Hàn Quốc TL008 MayHomes, Dây Lưng Nữ, Dây Nịt Nữ Chất Liệu Da PU Khóa Kim Loại Dễ Thương, Dùng Cho Đầm, Jeans, Quần Âu Và Short",42300,45000,2700,6
TIKI,phu-kien-thoi-trang,132837171,"Thắt lưng nam, dây nịt nam da bò thật nguyên tấm Bụi Leather L111 - Khóa tự động, nhiều mặt khóa tùy chọn - Bảo hành 12 tháng",225000,398000,173000,43
TIKI,phu-kien-thoi-trang,73360217,"Kính Giả Cận Chống Ánh Sáng Xanh, Chống Mỏi Mắt, Gọng Kính Cận Nam Nữ Không Độ Hàn Quốc - BLUE LIGHT SHOP",170000,170000,0,0
TIKI,phu-kien-thoi-trang,96032800," Găng tay nam ,bao tay nam cụt ngón lái xe du lịch phượt Mechanix Mpact",55000,55000,0,0
TIKI,phu-kien-thoi-trang,159034209,"Set 2 kim băng ngọc trai, gim cài quần áo, thu nhỏ eo, khuy cài áo siêu hot, cá tính, dễ sử dụng",31400,31400,0,0
TIKI,phu-kien-thoi-trang,140953128,"Cài tóc gấp gọn, băng đô cài tóc gấp gọn bỏ túi siêu tiện lợi, phong cách Hàn Quốc xinh xắn - Culi accessories",25000,25000,0,0
TIKI,phu-kien-thoi-trang,192666115,"KÌM BẤM CÚC, BẤM KHUY ÁO QUẦN TIỆN LỢI (HÀNG ĐẸP ĐÓNG VỈ) KÈM 50 KHUY",29000,32999,3999,12
TIKI,phu-kien-thoi-trang,192666117,"KÌM BẤM CÚC, BẤM KHUY ÁO QUẦN TIỆN LỢI (HÀNG ĐẸP ĐÓNG VỈ) KÈM 50 KHUY",25000,25000,0,0
TIKI,balo-va-vali,197410911,"Balo laptop nữ thời trang cao cấp phong cách mới 14",513000,570000,57000,10
TIKI,balo-va-vali,53419562,"Túi đựng đồ cá nhân chống nước UAG Dopp Kit - hàng chính hãng",480000,600000,120000,20
TIKI,balo-va-vali,50025604,"Balo laptop nam 2 trong 1 đa chức năng thời trang cao cấp phong cách mới",621000,690000,69000,10
TIKI,balo-va-vali,2297015,"Túi bọc bảo vệ vali -Áo vỏ bọc vali - Around-Vuông",149000,250000,101000,40
TIKI,balo-va-vali,190336999,"Balo laptop nhiều ngăn tiện lợi GUBAG cao cấp cho nam nữ, chống nước, dành cho dân công sở, đựng vừa laptop 15,6inch",529000,599000,70000,12
TIKI,balo-va-vali,179791876,"Vali Kéo LUG Aber S20/S24/S28 Xách Tay PP02 Nhựa PP Chống Bể Vỡ, Trọng Lượng Siêu Nhẹ, Bề Mặt Chống Trầy Tối Ưu",2190000,5475000,3285000,60
TIKI,balo-va-vali,208742191,"Balo nam chống nước cao cấp, túi du lịch đa năng tiện lợi TOUGHSLHSBAG - T0278",400000,400000,0,0
TIKI,balo-va-vali,790799,"Balo Laptop Mikkor The Edwin TEB001 - Đen (15.6" - Mac 17")",690000,690000,0,0
TIKI,balo-va-vali,168667505,"Ổ KHOÁ MINI KHOÁ VALI DU LỊCH COLUMBIA",25000,25000,0,0
TIKI,balo-va-vali,9431921,"Balo dây rút dù TROY",59000,70000,11000,16
TIKI,balo-va-vali,72001076,"Túi SmileBox 2 ngăn vải chống thấm ướt, chống sốc cho iPad, máy tính bảng 8 inch, 9.7 inch, 10.2 inch, 10.5 inch, 11 inch- Hàng chính hãng",135000,135000,0,0
TIKI,balo-va-vali,149526380,"Combo balo 4 món thời trang ulzzang, Set balo 4 món đi học, balo 4 món- phối MiCa YiFang",71900,71900,0,0
TIKI,balo-va-vali,74258075,"Túi Đựng Đồ Cá Nhân Du Lịch , Túi Đựng Mỹ Phẩm Kiểu Hàn Quốc 2021 - MP001",60000,60000,0,0
TIKI,balo-va-vali,7229921,"Thẻ hành lý Vali ",10718,15481,4763,31
TIKI,balo-va-vali,171761612,"Vali du lịch kéo cao cấp Size 24inch- Chất lượng cao  KS-155 - Bạc",478000,668000,190000,28
TIKI,balo-va-vali,90629794,"Túi xách du lịch túi trống da nam nữ cao cấp đựng quần áo đi công tác, đi chơi, tập gym",178200,257400,79200,31
TIKI,balo-va-vali,94914858,"Balo laptop công sở chống trộm chống nước cao cấp phong cách mới",513000,570000,57000,10
TIKI,balo-va-vali,51054350,"Túi Phụ Kiện Chống Nước, Đựng Cáp, Sạc, Tai Nghe, Pin",123000,123000,0,0
TIKI,balo-va-vali,91140134,"Balo du lịch Travel Accessories AMERICAN TOURISTER_Mỹ: Chất liệu Polyester bền, trượt nước, dễ dàng vệ sinh Trọng lượng siêu nhẹ Dây đai vai với đệm và có thể điều chỉnh, Lót đệm lưng êm ái và thoải mái",600000,600000,0,0
TIKI,balo-va-vali,11558750,"Ba Lô Laptop Nam Nữ Thời Trang Cao Cấp Case Logic 17.3" GBL03 - Hàng Xuất Khẩu Loại 1 + Tặng Áo BL Chống Nước",457000,850000,393000,46
TIKI,balo-va-vali,74219528,"Túi du lịch đa năng, gắn vali kéo tiện dụng MOHI MT22 - Chính hãng",85000,85000,0,0
TIKI,balo-va-vali,68449139,"Cặp Xách Đựng Laptop Hàng cao Cấp Túi Da Chống Sốc Cho Máy Tính, Macbook, Surface 13 đến 15 Inch - BG002",299000,299000,0,0
TIKI,balo-va-vali,7772310,"Balo Thời Trang Unisex PRAZA - BL167 (Xám)",155000,155000,0,0
TIKI,balo-va-vali,183679770,"Balo nữ đi học đi làm không thấm nước cao cấp phong cách hàn quốc",423000,470000,47000,10
TIKI,balo-va-vali,59048821,"Túi xách cặp da đựng laptop công sở T20 39x28x6cm",315000,315000,0,0
TIKI,balo-va-vali,44314042,"Balo đi phượt, leo núi, du lịch chất liệu cao cấp, nhiều tiện lợi Nam Nữ đều thích",102960,148720,45760,31
TIKI,balo-va-vali,87379607,"Balo nữ đi học laptop vải Canvas ulzzang bò sữa cặp sách đi học thời trang học sinh sinh viên( Tặng kèm gấu và sticker)",194000,194000,0,0
TIKI,balo-va-vali,15513854,"Túi xách Tomtoc A45 Messenger Bags Macbook 13.3/15",1000000,1000000,0,0
TIKI,balo-va-vali,101721970,"Túi xách chống sốc cho máy tính, macbook, laptop chống nước, siêu nhiều ngăn màu tím - HỒNG - 14 INCH",370500,390000,19500,5
TIKI,phu-kien-thoi-trang,59063838,"Kính không độ unisex chống UV400, ánh sáng xanh UV101910-C4",180500,190000,9500,5
TIKI,phu-kien-thoi-trang,139449942,"(HÀNG ĐẸP) Dây nịt Nam vải dù_Tushi siêu bền_Khóa cài tự động chắc chắn, tiện lợi,, Thắt lưng vải bố cao cấp",149000,149000,0,0
TIKI,balo-va-vali,175413559,"Balo Laptop Du Lịch Thời Trang Cao Cấp SAKOS MATURA Phối Da Dành Cho Laptop 15.6 Inch (15.6")",1749000,1749000,0,0
TIKI,balo-va-vali,23750060,"Túi Du Lịch Vali Kéo Đựng Quần Áo Mỹ Phẩm Tiện Ích",123750,169125,45375,27
TIKI,phu-kien-thoi-trang,192713913,"Thắt Lưng Dây Nịt Nam Da Bò Khóa Tự Động Đa Dạng Nhiều Mẫu Mới Lạ Phong Cách Âu Cá Tính  DT116",112500,150000,37500,25
TIKI,balo-va-vali,57045167,"Túi chống sốc laptop 11 - 13 - 14 -15 inch elastic siêu đàn hồi cao cấp SK95",28500,30000,1500,5
TIKI,balo-va-vali,24423057,"Dây khóa Vali chữ thập kèm thẻ hành lý",79000,79000,0,0
TIKI,phu-kien-thoi-trang,120431502,"Khăn rằn campuchia",90000,90000,0,0
TIKI,balo-va-vali,149124589,"Túi đựng mỹ phẩm, đồ trang điểm khi đi du lịch, công tác đa năng Love & Peace, có tay cầm họa tiết thời trang và sang trọng",49000,49000,0,0
TIKI,phu-kien-thoi-trang,79842942," Băng Đô Turban Thắt Nút Phối 2 Màu Phong Cách Hàn Quốc Vải Lụa - Mã BD003",29000,29000,0,0
TIKI,phu-kien-thoi-trang,13533833,"Khăn Choàng Nữ Thời Trang Cashmere HN19",94000,94000,0,0
TIKI,phu-kien-thoi-trang,15387314,"Dụng cụ tạo búi tóc mẫu mới siêu hot (Dễ dàng thực hiện)",18000,18000,0,0
TIKI,phu-kien-thoi-trang,186738622,"Bao tay Găng tay Nam Kiểu hở 2 ngón Gắn chữ adiddas Chất liệu vải mềm êm, Chống nắng, Chống tia UV, Bảo vệ đôi tay",42000,42000,0,0
TIKI,phu-kien-thoi-trang,81992016,"Khăn rằn campuchia xanh dương",75000,75000,0,0
TIKI,phu-kien-thoi-trang,164021840,"Kính râm thời trang cho nam dáng kính phi công tròng phân cực chống chói đi ngày và đêm AK002 - Aoron",210000,320000,110000,34
TIKI,balo-va-vali,847449,"Túi Xách Du Lịch HARAS HRTK186 (46 x 28 cm) - Đen",250000,250000,0,0
TIKI,phu-kien-thoi-trang,76904868,"NÓN LƯỠI TRAI TRƠN THỜI TRANG NAM NỮ MŨ BÓNG CHÀY RÁCH TRƠN NHIỀU MÀU KIỂU DÁNG THỂ THAO - SMICE HOUSE",126000,126000,0,0
TIKI,balo-va-vali,52636232,"ba lô cỡ đại  du lịch  40L Bumno  39F1 Shalla",102960,148720,45760,31
TIKI,phu-kien-thoi-trang,77181263,"Thắt lưng nữ co giãn khóa kim loại cá tính dễ phối đồ",64000,64000,0,0
TIKI,balo-va-vali,2297817,"Túi bọc bảo vệ vali -Áo vỏ bọc vali - Gấu Trắng",149000,250000,101000,40
TIKI,phu-kien-thoi-trang,160186129,"mũ cối tàu cốt phíp lòng vàng đinh trắng phiên bản xưa 1966, vải gabadin tô châu chuẩn tàu màu ổi ương",85000,85000,0,0
TIKI,phu-kien-thoi-trang,58502208,"Băng đô đính đá lấp lánh phong cách Hàn siêu kute",39000,39000,0,0
TIKI,phu-kien-thoi-trang,11211343,"Dụng cụ che mắt ngủ",19200,24000,4800,20
TIKI,phu-kien-thoi-trang,181693359,"Khay đựng lens Angel Eyes cao cấp không chì",45000,45000,0,0
TIKI,phu-kien-thoi-trang,17593177,"Găng tay chống nắng Let's Slim Hàn Quốc 45gr",11000,11000,0,0
TIKI,phu-kien-thoi-trang,193758447,"Trâm cài tóc bằng sừng hàng VIP siêu đẹp/ tỉa khắc sang chảnh HOT TREND - HH602-40",39000,39000,0,0
TIKI,phu-kien-thoi-trang,137501545,"Thắt Lưng Da Bò Thật Vân Cá Sấu mặt khóa tự động cao cấp Dây nịt nam sang trọng bản nhỏ 3.5cm bảo hành 24 tháng",210000,210000,0,0
TIKI,phu-kien-thoi-trang,113490079,"Kính Mát ,Mắt Kính Unisex ASARIFA RP18013 c2",800000,800000,0,0
TIKI,phu-kien-thoi-trang,74387382,"Thắt lưng co giãn khóa tam giác cá tính TL64",45000,45000,0,0
TIKI,balo-va-vali,114696357,"Túi bạt siêu to. Túi Bạt Túi Dứa Túi Đựng Đồ Có Khóa Kéo Túi Vải Bạt Đựng Quần Áo( có nhiều kích cỡ )",24000,24000,0,0
TIKI,phu-kien-thoi-trang,90473785,"Kính lão thị viễn thị có độ sẵn nam nữ siêu dẻo màu Đen",109000,109000,0,0
TIKI,balo-va-vali,66412028,"Balo Mini Nữ Vải Polyester Thời Trang, Balo Vải Dù Chống Thấm",249000,249000,0,0
TIKI,balo-va-vali,53582344,"Túi trống tiện lợi Du Lịch Đựng Giày Quần áo Behold thời trang KSU8",124740,170478,45738,27
TIKI,phu-kien-thoi-trang,76402289,"Gọng kính chính hãng SARIFA TR90 2477 (Size 52-16-141) nhiều màu",199000,450000,251000,56
TIKI,phu-kien-thoi-trang,89947925,"Khăn choàng nữ, Khăn voan choàng cổ cỡ lớn 206010",27800,44000,16200,37
TIKI,phu-kien-thoi-trang,86168569," TÓC GIẢ NỮ NGẮN TÉM DÀI TẶNG LƯỚI TRÙM TÓC",159000,159000,0,0
TIKI,phu-kien-thoi-trang,160894064,"Hộp 5 đôi tất đi giày tây nam mẫu Quả Trám, vớ nam công sở cổ cao cao cấp, chất cotton hút ẩm, thoáng khí - GOM-QUATRAM-CB5",179000,250000,71000,28
TIKI,phu-kien-thoi-trang,102888651,"Tóc giả kẹp phím phồng ngắn K04 Sỉ 14k",24000,24000,0,0
TIKI,phu-kien-thoi-trang,27525458,"Mũ nón len bere lông thỏ đính hạt thời trang Hàn Quốc dn19081815",175000,175000,0,0
TIKI,phu-kien-thoi-trang,53546168,"Kính viễn thị lão thị đa tròng nhìn mọi khoảng cách mắt sẵn độ cao cấp",199000,199000,0,0
TIKI,phu-kien-thoi-trang,24629723,"Kính Mát Nam Cao Cấp Kèm Hộp Và Khăn Lau Sang Trọng Đẳng Cấp Nhất - Phân Phối Cao Cấp",99000,99000,0,0
TIKI,phu-kien-thoi-trang,55685304,"Mắt Kính Nam Cao Cấp, Gọng Kính Gấp Gọn Màu Vàng, Tròng Kính Xanh Đen Sang Trọng Chống Tia UV",160000,160000,0,0
TIKI,phu-kien-thoi-trang,165243589,"Mũ phớt cao bồi Fedora MP06 đẹp cho nam và nữ",125000,197000,72000,37
TIKI,phu-kien-thoi-trang,76795155,"Mũ Rộng Vành Gấp Gọn Nón Rộng Vành Đi Biển - DONA21012803",160550,169000,8450,5
TIKI,phu-kien-thoi-trang,136033125,"Gọng kính cận vuông Basic Glasses 01, gọng kính nam, nữ thời trang",152000,160000,8000,5
TIKI,phu-kien-thoi-trang,190167581,"Băng đô cài tóc, Bờm cài tóc bản nhỏ sóng kép nhiều màu xinh xắn",36000,36000,0,0
TIKI,phu-kien-thoi-trang,21784158,"Mũ trùm đầu ninja Thái Lan M1",42000,42000,0,0
TIKI,phu-kien-thoi-trang,15016103,"Kẹp tròn lấp lánh - phụ kiện tóc style Hàn Quốc",34900,34900,0,0
TIKI,phu-kien-thoi-trang,190152854,"Nón Kết Ông Địa Cầm Đàn F1 Cao Cấp .",219000,219000,0,0
TIKI,phu-kien-thoi-trang,165192946,"3 đôi tất gấu nữ cổ ngắn hình gấu - tất cổ ngắn nữ - giao màu ngẫu nhiên ",15000,45000,30000,67
TIKI,phu-kien-thoi-trang,102803271,"Sét kẹp tóc 5 món siêu xinh",34900,34900,0,0
TIKI,tui-vi-nu,214588850,"Túi da nữ Louis Fontaine Eze màu đen size L",4600000,4600000,0,0
TIKI,tui-vi-nu,17003410,"Túi Xách Nữ Thời Trang Cao Cấp EL95 đỏ",719400,1199000,479600,40
TIKI,tui-vi-nu,95394051," Túi Xách Nữ Thời Trang Đeo Chéo Chất Da Xịn Lên Dáng Chuẩn Form Xinh Lắm Lắm Luôn",68000,68000,0,0
TIKI,tui-vi-nu,191309750,"Marhen.J - Túi xách nữ phom chữ nhật Rhonda Mini MJ21BRNDMN-OG",3590000,3590000,0,0
TIKI,tui-vi-nu,186128722,"Túi Đeo Chéo Vải Cavas Siêu Dễ Thương Cho Nữ Đựng Đồ Đi Chơi Dạo Phố, Túi Xách Nữ Thời Trang Nhật Bản",55000,55000,0,0
TIKI,tui-vi-nu,83471905,"Ví cầm tay nữ Yuumy YV32",175000,320000,145000,45
TIKI,tui-vi-nu,86561430,"Ví bóp nữ    Ví nữ cao cấp cầm tay mini thời trang nhỏ gọn nhiều ngăn đẹp giá rẻ Micloset - V05311",16000,16000,0,0
TIKI,tui-vi-nu,149449416,"Túi xách đeo chéo mới CeeKay (Fullbox) - Túi xách nữ hàng cao cấp chính hãng",450000,450000,0,0
TIKI,tui-vi-nu,187843426,"Túi xách nữ dễ thương NASI T1044 vải cói pu cầm tay đẹp túi tote đeo vai có dây kéo thời trang cho nữ công sở, học sinh",69000,69000,0,0
TIKI,tui-vi-nu,36827817,"Ví Nữ Mini Ngắn Cầm Tay Cao Cấp Sang Trọng Phong Cách Hàn Quốc, Nhiều Ngăn Tiện Lợi V07",125000,250000,125000,50
TIKI,tui-vi-nu,185077985,"Túi xách nữ Oscar - OCWHBSG 056",690000,2490000,1800000,72
TIKI,tui-vi-nu,46166280,"Túi xách nữ thời trang kiểu dáng công sở Châu Âu",189000,189000,0,0
TIKI,tui-vi-nu,77649350,"Túi đeo mini unisex cá tính Fimax cho nam nữ, túi đeo chéo nhỏ gọn với kích thước 17x15x5cm làm từ vải chống nước dùng đựng điện thoại và phụ kiện cá nhân khi đi chơi dự tiệc",199000,199000,0,0
TIKI,tui-vi-nu,160315073,"Ví Nữ Dài Cầm Tay FOREVER YOUNG Đựng Tiền Phong Cách Hàn Quốc Siêu Đẹp VD07 - Micocah Mall",119000,119000,0,0
TIKI,tui-vi-nu,163719940,"Túi Xách Nữ Đeo Chéo Đeo Vai Kẹp Nách Crescent-Moon Hobo GIPSY",690000,690000,0,0
TIKI,tui-vi-nu,35573460,"Túi đeo chéo nam nữ - túi bao tử thời trang BEE GEE 028 ( Trơn ) vải dù",40000,80000,40000,50
TIKI,tui-vi-nu,5003395,"Túi Xách Nữ Cao Cấp Da Thật Elly ET37",2499000,2499000,0,0
TIKI,tui-vi-nu,82485562,"VÍ NÚT BẤM ĐỰNG THẺ ATM, CARD VISIT (24 NGĂN)",15000,15000,0,0
TIKI,tui-vi-nu,131337770,"Túi vải bố, Túi vải Canvas trơn màu kem không khóa kéo",19000,19000,0,0
TIKI,tui-vi-nu,145555826,"Túi xách nữ thời trang LATA TX09",490000,490000,0,0
TIKI,tui-vi-nu,116594664,"Túi Xách Nữ -Túi vải CANVAS đeo chéo nữ dây YXY TOLIVE TV02",40000,40000,0,0
TIKI,tui-vi-nu,93291134,"Marhen.J - Túi đeo vai chữ nhật Ludy MJ20DLUDYB-PK",3890000,3890000,0,0
TIKI,tui-vi-nu,188995393,"Túi Đeo Chéo Tomtoc H02 Lightweight Codura Sling Bag - đựng phụ kiện, đồ dùng cá nhân",883150,1039000,155850,15
TIKI,tui-vi-nu,196675540,"Túi Cói, Túi Xách Cỏ Bàng Vẽ Hoa Hướng Dương Cao Cấp Chuẩn Đẹp-Giỏ Xách Cỏ Bàng Mỹ Nghệ TXCBVHHDLTK15",339000,339000,0,0
TIKI,tui-vi-nu,48461717,"Ví nữ dáng dài cầm tay Since kiểu dáng Hàn Quốc",48000,48000,0,0
TIKI,tui-vi-nu,160314958,"Ví Nữ Dài Cầm Tay Chính Hãng FOREVER YOUNG Đựng Tiền Đựng Thẻ Da Mềm Khóa Đồng Xu Siêu Đẹp FY01 - Micocah Mall",119000,119000,0,0
TIKI,tui-vi-nu,136940214,"Túi đựng điện thoại thêu 3 cô gái Việt Nam",25000,25000,0,0
TIKI,tui-vi-nu,69192511,"Túi Xách Nữ Đeo Vai 2 Dây Đeo Size To Nhiều Ngăn Tiện Dụng Chất Da Đẹp SK912",55000,55000,0,0
TIKI,tui-vi-nu,81736110,"Ví da đựng thẻ ATM 24 ngăn – Bóp da 24 ngăn đựng giấy tờ nữ ( đọc kỹ hdsd) F329SP1",15000,15000,0,0
TIKI,tui-vi-nu,174468730,"Ví Nữ Dài Cầm Tay PERFECT FOR YOU Chất Da Cao Cấp Cực Đẹp Nhiều Ngăn Tiện Dụng PFY02",129000,129000,0,0
TIKI,tui-vi-nu,157549366,"BỘ 4 TÚI DA THỜI TRANG  Túi xách nữ công sở đẹp cao cấp set 4 món da sang trọng, thời trang",365000,365000,0,0
TIKI,tui-vi-nu,252597316,"[Da thật] Ví mini nam nữ da bò thật MN114ALS (Đen/Nâu/Xanh Navy) - 100% da bò thật, BH 3 năm",149000,149000,0,0
TIKI,tui-vi-nu,191309685,"Marhen.J - Túi đeo vai nữ chữ nhật Milly Nano MJ21AMLYNA-KH",2890000,2890000,0,0
TIKI,tui-vi-nu,42134677,"TÚI ĐEO NỮ NHỎ XINH NHIỀU MÀU - H0011",49000,75000,26000,35
TIKI,tui-vi-nu,173986171,"Phụ kiện túi vải Yuumy cỡ lớn YBVLL",20000,20000,0,0
TIKI,tui-vi-nu,248991490,"XI SÁP GOLDCARE - GC5003",55000,55000,0,0
TIKI,tui-vi-nu,119410137,"Túi đeo chéo nữ trong suốt thời trang dạo phố XX25 Tặng bút cảm ứng ĐT",66973,91530,24557,27
TIKI,tui-vi-nu,200016854,"Túi Cói Xinh Xắn Nữ Tính Đi Biển Đi Chơi Hình Dáng Vỏ Ốc Cách Điệu Độc Đáo Thủ Công Thân Thiện Môi Trường",320000,320000,0,0
TIKI,tui-vi-nu,159787715,"Hộp Tre Xinh - Cơi Tre Bông Có Nắp 10 * 12cm",126000,242200,116200,48
TIKI,tui-vi-nu,204668560,"Túi xách nữ thời trang đa năng FA DO DA FTX3 nhiều màu",520000,520000,0,0
TIKI,dong-ho-va-trang-suc,26299569,"Bộ dụng cụ bấm lỗ tai kèm 144 khuyên",185000,185000,0,0
TIKI,dong-ho-va-trang-suc,71044752,"Đồng Hồ Nữ Julius Hàn Quốc JA979 Mặt Tròn Cá TÍnh Dây Da Màu",699000,699000,0,0
TIKI,dong-ho-va-trang-suc,17010108,"Dây chuyền nam mạ Vàng 24k D1",119000,143000,24000,17
TIKI,dong-ho-va-trang-suc,4898407,"Đồng Hồ Nam Dây Nhựa Casio MQ-24-7ELDF - Đen",377400,444000,66600,15
TIKI,dong-ho-va-trang-suc,46242612,"Vòng tay nam phong thủy may mắn (đá Obsidian với tỳ hưu vàng)",29000,29000,0,0
TIKI,dong-ho-va-trang-suc,35458141,"Nhẫn Nam Nữ Khắc Bát Nhã Tâm Kinh Titan Ko Đen TT 1379",99000,99000,0,0
TIKI,dong-ho-va-trang-suc,74301311,"Dây Chuyền Tropicana Phối Charm Swarovski Ngọc Trai Hai Màu Trắng Đen",624000,624000,0,0
TIKI,dong-ho-va-trang-suc,173084229,"Dây cước trong co giãn bó 10m - Ngọc Quý Gemstones",13000,13000,0,0
TIKI,dong-ho-va-trang-suc,38068697,"Đồng hồ thể thao  nữ trẻ trung, năng động phong cách Hàn Quốc",44999,44999,0,0
TIKI,dong-ho-va-trang-suc,26142731,"Dây chuyền nam inox cách điệu mạ vàng Hàn Quốc BHDC124",102000,109000,7000,6
TIKI,dong-ho-va-trang-suc,172631252,"7 Chiếc ximen inox chạm khắc tinh xảo không đen không gỉ Trang sức Bé Heo",17000,20000,3000,15
TIKI,dong-ho-va-trang-suc,116904410,"Biểu tượng Thiên tâm đạo gỗ mun đen",169000,169000,0,0
TIKI,dong-ho-va-trang-suc,212981958,"Hộp Đựng Đồng Hồ 10 Ngăn Vỏ Da PU Cao Cấp, Chuyên Dùng Để Lưu Trữ, Sưu Tập Đồng Hồ",223000,250000,27000,11
TIKI,dong-ho-va-trang-suc,105196441,"Dây đồng hồ DA BÒ nam size 18mm 19mm 20mm 21mm 22mm CỰC MỀM,đường chỉ may đẹp, chắc chắn - LX07",129000,129000,0,0
TIKI,dong-ho-va-trang-suc,84450667," Đồng hồ nữ Julius chính hãng Hàn Quốc Ja-787 Ju1125 dây da (5 màu)",590000,989000,399000,40
TIKI,dong-ho-va-trang-suc,81319726,"Đồng Hồ Nam Chính Hãng ECONOMICXI Dây Thép Mành Đen Kích Thước Mặt 40mm Có Lịch Ngày - Thiết Kế Nam Tính ECNTA23",278000,278000,0,0
TIKI,dong-ho-va-trang-suc,37170312,"Dây chuyền nam mạ vàng 24k hình số 8 mã D18",218000,218000,0,0
TIKI,dong-ho-va-trang-suc,33033766,"Khóa cài dây đồng hồ cao cấp thép không gỉ",15000,15000,0,0
TIKI,dong-ho-va-trang-suc,136364489,"VÒNG TAY BỒ ĐỀ TINH NGUYỆT DÂY NGŨ SẮC KHẮC OMMANI CÁT TƯỜNG",120000,120000,0,0
TIKI,dong-ho-va-trang-suc,75424505,"Đồng hồ Elsa & Anna cho bé gái BBShine – DH002",140000,140000,0,0
TIKI,dong-ho-va-trang-suc,98634613," Vòng tay cặp in tên theo yêu cầu",76700,76700,0,0
TIKI,dong-ho-va-trang-suc,167447605,"Vòng gỗ Nu Huyết Long mix Tỳ Hưu Vàng",480000,480000,0,0
TIKI,dong-ho-va-trang-suc,95060535,"Đồng hồ Nam SANDA JAPAN 668, Siêu Chống Nước, Pin dùng 5 năm",120000,120000,0,0
TIKI,dong-ho-va-trang-suc,106396243,"Vòng tay hoa khô, vòng đeo tay Bangle bất diệt, dáng vòng Boho Vintage nhiều màu lựa chọn",32900,32900,0,0
TIKI,dong-ho-va-trang-suc,56211673,"Charm bạc hình hồ lô treo - Ngọc Quý Gemstones",128000,148000,20000,14
TIKI,dong-ho-va-trang-suc,35572791,"Bông tai hoa tuyết bạc nữ S925 cao cấp đính đá  (HT.B2)",90000,90000,0,0
TIKI,dong-ho-va-trang-suc,35458926,"Nhẫn Xoay Khắc Chú Trừ Tà Om Mani Padme Hum Titan Không Rỉ TT 1784",95000,95000,0,0
TIKI,dong-ho-va-trang-suc,44011577,"Bộ trang sức ngọc trai vòng cổ bông tay đính hạt zic zắc",29000,29000,0,0
TIKI,dong-ho-va-trang-suc,122260115,"Vòng Tay Trầm Hương Tốc Cao Cấp Đủ Size Từ 6mm - 20mm cho Nam Nữ Phong Thủy May Mắn - Lạc Việt Trầm Hương",98000,98000,0,0
TIKI,dong-ho-va-trang-suc,208645303,"Dây Đeo SILICON 2 màu dành Cho Huawei band 6",40000,40000,0,0
TIKI,dong-ho-va-trang-suc,89879324,"Bông tai nữ bạc Ý xinh MS55dc",85000,85000,0,0
TIKI,dong-ho-va-trang-suc,45869183,"Vòng choker vải ren đính đá đen quyến rũ cho nữ",31000,45000,14000,31
TIKI,dong-ho-va-trang-suc,195925152,"vòng tay trầm hương tốc tự nhiên mix tuỳ hưu cao cấp",239000,239000,0,0
TIKI,dong-ho-va-trang-suc,219136341,"(Ký Hiệu+Không Phai Màu) Siêu Phẩm Ximen Bộ 7 Chấm Vonfram Cao Cấp- Dùng vĩnh viễn thoải mái nước hay mồ hôi muối",1285000,1285000,0,0
TIKI,dong-ho-va-trang-suc,78954452,"Bông Tai Hổ Phách Baltic Xanh Lá – Stud",966000,1050000,84000,8
TIKI,dong-ho-va-trang-suc,99055649,"Dây Chuyền Nam Trơn 3mm, Dây Chuyền Nam Dẹp Cực Đẹp",48000,48000,0,0
TIKI,dong-ho-va-trang-suc,12039865,"Đồng hồ nam dây nhựa Casio AE-1200WH-1BVDF",900000,1140000,240000,21
TIKI,dong-ho-va-trang-suc,15233480,"Vòng Tay Đá Ngọc Bích - Nephrite",720000,720000,0,0
TIKI,dong-ho-va-trang-suc,42838588,"Dây chuyền nữ mặt phật xi dát vàng 18k EKP624K",200000,200000,0,0
TIKI,dong-ho-va-trang-suc,154234306,"Dây chuyền titan cún con - Trang sức Bé Heo BHDC265",45000,76000,31000,41
TIKI,may-anh,109580308,"Chân máy quay Coman DF-06, Hàng chính hãng",2349999,2349999,0,0
TIKI,may-anh,154590799,"Camera Wifi Ngoài Trời EZVIZ C3W Color Night Pro 4Mp, Đèn Và Còi Báo Động, Tính Năng AI - Hàng chính hãng",1950000,1950000,0,0
TIKI,may-anh,214756796,"Camera quan sát từ xa qua điện thoại, tự động quay lưu",750000,750000,0,0
TIKI,may-anh,2570631,"Bộ Đèn Chụp Sản Phẩm (600W) - Hàng Nhập Khẩu",1399000,1399000,0,0
TIKI,may-anh,10375024,"Hít kính 3 chân đế mini gắn GoPro Hero lên kính xe hơi",59000,59000,0,0
TIKI,may-anh,134958087,"Dây đeo ngực + Đế chữ J + Ốc vít Kết Nối Khớp Với Gopro Camera Hành Trình",115000,115000,0,0
TIKI,may-anh,22492463,"Tay cầm GoPro và Action Cam tích hợp Pin Kingma - Hàng Nhập Khẩu",469999,469999,0,0
TIKI,may-anh,37155769,"Đèn Flash Godox TT600 Tặng Kèm Bộ Pin Sạc - Hàng Nhập Khẩu",1799999,1799999,0,0
TIKI,may-anh,108341744,"Combo 2 pin 1 sạc đôi Kingma for Canon LP-E17 - Hàng chính hãng",549999,549999,0,0
TIKI,may-anh,127187953,"Combo Camera Wi-fi Trong Nhà EZVIZ C6N 2MP và Thẻ Nhớ 32GB/64GB - Hàng Chính Hãng",450000,450000,0,0
TIKI,may-anh,104070232,"Đầu ghi 8 kênh Dahua DH-XVR1A08 - Đâu ghi hình camera 1080P - Hàng chính hãng",1350000,1350000,0,0
TIKI,may-anh,34477918,"Camera lùi ô tô siêu nét full HD chống nước",154000,168000,14000,8
TIKI,may-anh,186208864,"Tủ chống ẩm Andbon AB-50C, 50 lít - Hàng chính hãng",1549999,1549999,0,0
TIKI,may-anh,3597899,"Bộ Chân Máy Ảnh Bạch Tuộc Lớn Và Đầu Bi Chân Máy Ảnh Thân Kim Loại Q00159",159000,159000,0,0
TIKI,may-anh,74536460,"Kính thiên văn PowerSeeker 50AZ 450x, hiệu Celestron chính hãng Mỹ, kính phủ FMC chống lóa",1620000,1620000,0,0
TIKI,may-anh,50325159,"Ống nhòm hải tặc một mắt 25x30 - Thiết kế theo khuôn mẫu phục cổ với độ phóng đại cao cùng hình ảnh sắc nét trong một hình hài nhỏ gọn",700000,700000,0,0
TIKI,may-anh,52188469,"Phông vải key hình 2 mặt di động chuyên nghiệp (1.5 x 2m)",1050000,1050000,0,0
TIKI,may-anh,4755099,"Dụng Cụ Tháo Mở Lens Chuyên Nghiệp - Hàng Nhập Khẩu",399000,399000,0,0
TIKI,may-anh,4712551,"Túi Chống Sốc Đựng Chân Đèn Size L - Hàng Nhập Khẩu",499000,499000,0,0
TIKI,may-anh,109992240,"Túi máy ảnh Safrotto H1-S, Hàng chính hãng",499999,499999,0,0
TIKI,may-anh,15927483,"Chân Máy Ảnh Tripod Beike Q999 - Hàng Chính Hãng",1074999,1074999,0,0
TIKI,may-anh,97649318,"Chân đế cao cấp cho máy ảnh, ống nhòm Carson Rock TR-300 - Hàng chính hãng",3050000,3050000,0,0
TIKI,may-anh,28736848,"Combo Tản sáng Godox AK-R1 và ngàm Godox S-R1",1049999,1049999,0,0
TIKI,may-anh,11891323,"Đầu Ghi Hình Dahua NVR2108HS-4KS2-Hàng Chính Hãng",1850000,1850000,0,0
TIKI,may-anh,124254502,"Ống nhòm 2 Mắt Thiết Kế Chắc Chắn Độ Phóng Đại 10X SA60X90",655500,690000,34500,5
TIKI,may-anh,2533237,"Bộ Gel 12 Màu For Flash Speedlite",79000,79000,0,0
TIKI,may-anh,4707917,"Đèn LED Yongnuo 600 (Đen) - Hàng Nhập Khẩu",1949999,1949999,0,0
TIKI,may-anh,50600150,"Kingma 2 Pin + 1 Sạc 3 Pin Cho Gopro Hero 5/6/7/8 - Hàng nhập khẩu",529999,529999,0,0
TIKI,may-anh,76514892,"Intel RealSense Depth Camera D455 - Hàng Chính Hãng",16924400,16924400,0,0
TIKI,may-anh,19578553,"DDPai MINI 2 Camera hành trình độ nét cao, tích hợp kết nối Wifi không dây. Độ phân giải 2K Ultra HD. Hàng nhập khẩu",1150000,1150000,0,0
TIKI,may-anh,26086283,"KÍNH LỌC HOYA UX UV SIZE 77MM - Hàng Chính Hãng",599999,599999,0,0
TIKI,may-anh,125499125,"Camera WiFi V380 Mini Hành Trình 1080P WiFi Không Dây HD Quan Sát Ban Đêm IR Camera An Ninh Gia Đình Quan Sát Từ Xa Trên Điện Thoại-Tặng kèm cục nguồn sạc 5V-1A",260000,260000,0,0
TIKI,may-anh,19565935,"Phụ kiện thanh nối đa năng gắn đến 4 điện thoại lên tripod hỗ trợ livestream, quay video nhiều điện thoại cùng lúc",275000,275000,0,0
TIKI,may-anh,206335803,"Túi máy ảnh nhỏ gọn D26",270000,270000,0,0
TIKI,dong-ho-va-trang-suc,181144977,"Vòng tay đá thạch anh tóc đen mệnh thủy, mộc - Ngọc Quý",800000,1140000,340000,30
TIKI,dong-ho-va-trang-suc,161942149,"Ốp Kính Cường Lực Apple Watch Series 1/2/3/4/5/SE/6 Đủ Size 38mm 40mm 42mm 44mm",52000,52000,0,0
TIKI,dong-ho-va-trang-suc,8061519,"Đồng Hồ Nam Citizen Dây Da NH8363-14H - Mặt Xám",6485000,6485000,0,0
TIKI,dong-ho-va-trang-suc,32215287,"Nhẫn nam quân đội mỹ -không đen -không rỷ",105000,105000,0,0
TIKI,may-anh,72740809,"Thiết Bị Blackmagic ATEM Mini  | Chính hãng",5200000,5200000,0,0
TIKI,may-anh,109083771,"Combo pin sạc Kingma cho Fujifilm NP-W235, Hàng chính hãng",249999,249999,0,0
TIKI,dong-ho-va-trang-suc,157316575,"Đồng Hồ Nam Dây Nhựa Casio G-Shock GA-2100FR-5ADR Chính Hãng - GA-2100FR-5A",3291750,4389000,1097250,25
TIKI,dong-ho-va-trang-suc,152152254,"Vòng Gỗ Huyết Long Tỵ Dậu Sửu - Vòng Tay Tam Hợp Quý Nhân Huyết Rồng - May Mắn Tài Lộc",219000,219000,0,0
TIKI,dong-ho-va-trang-suc,44866294,"Nhẫn Nam Bản To Loại Bóng Titan Không Rỉ TT 2379 - 1 Cái",87000,87000,0,0
TIKI,dong-ho-va-trang-suc,150491033,"Vòng Cẩm Thạch Đỏ đẹp I Size 49mm Vòng tay đỏ đỏ đậm đẹp đeo lên may mắn chuẩn hợp Nữ mệnh Hỏa mệnh Thổ ạ Nữ cân  nặng 45kg -> 51kg đeo vừa tay đẹp xinh tay ạ",550000,1100000,550000,50
TIKI,dong-ho-va-trang-suc,103419257,"Combo Nhẫn Xoàn, Kiểu dáng Ruby, Hợp kim tráng Platin, Hợp Nam Nữ, Phong cách Cung đình, Kèm túi đựng Cung Hỷ - mẫu CrownX.436B",136000,153000,17000,11
TIKI,may-anh,97651658,"Chân đế cao cấp cho máy ảnh, ống nhòm Carson Rock TR-200 - Hàng chính hãng",2780000,2780000,0,0
TIKI,dong-ho-va-trang-suc,172154180,"Vòng thạch anh ưu linh trắng liền khối bản vuông mệnh thủy, kim - Ngọc Quý Gemstones",1999000,2500000,501000,20
TIKI,may-anh,109504357,"Chân máy ảnh Monopod Coman DT286C Carbon, Hàng chính hãng",1249999,1249999,0,0
TIKI,dong-ho-va-trang-suc,130014524,"Nhẫn xoàn, Phong cách Âu Mỹ, Màu vàng 18K, Chất liệu hợp kim đính Pha lê tinh thể, mẫu Luxi Green 007M, Kèm hộp đựng Cẩm Tú",168000,168000,0,0
TIKI,dong-ho-va-trang-suc,14884836,"Bông Tai Ngọc Trai Cao Cấp Cỡ Hạt 7x7 Ly - B2352 - Bảo Ngọc Jewelry - Trắng",315000,332000,17000,5
TIKI,dong-ho-va-trang-suc,106393684,"(TẶNG CHỐT VÀ DỤNG CỤ THAY DÂY) Dây Đồng hồ Kim Loại Đúc Đầu cong đầu ôm",150000,150000,0,0
TIKI,dong-ho-va-trang-suc,147344123,"Nhẫn nữ con công",75000,75000,0,0
TIKI,dong-ho-va-trang-suc,26329169,"Vòng chuỗi hạt đeo tay 2 line nữ đá labradorite mài giác 5mm mệnh thủy , kim - Ngọc Quý Gemstones",1239000,1700000,461000,27
TIKI,may-anh,192124206,"Dây Đeo Máy Ảnh Cổ Tay ",99000,99000,0,0
TIKI,dong-ho-va-trang-suc,31661608,"Đồng hồ nam dây thép không gỉ Skmei 90TCK58",251750,265000,13250,5
TIKI,may-anh,14534576,"Bộ 2 pin và đế sạc kép RAVPower RP-BC014 tương thích Canon LP-E10 - Hàng Chính Hãng",649999,649999,0,0
TIKI,dong-ho-va-trang-suc,184915973,"Vòng Tay Đá Ngọc Cẩm Thạch tự nhiên TR LÝ 49mm x cọng 7,2mm Màu bạch ngọc trắng bóng điểm lý xanh rêu rất là đẹp sang Nữ mệnh Kim, mệnh Thủy năngh 47kg - 51kg đeo đẹp ạ",899000,1798000,899000,50
TIKI,dong-ho-va-trang-suc,77742801,"Đồng hồ dây kim loại thời trang nam Skmei Sk6909, mặt tròn kính cứng kèm lịch ngày sang trọng",99000,99000,0,0
TIKI,dong-ho-va-trang-suc,59243874,"ĐỒNG HỒ NỮ DÂY DA MẶT VUÔNG THỜI TRANG CAO CẤP",120000,120000,0,0
TIKI,dong-ho-va-trang-suc,134677518,"Dây đeo cho Samsung Watch 6/ 6 Classic/ 5/ 5 Pro/ Watch 4/ Watch 4 Classic (DSG)",140000,140000,0,0
TIKI,dong-ho-va-trang-suc,87984992,"Nhẫn Dây Xích Khui Bia",6500,6500,0,0
TIKI,dong-ho-va-trang-suc,51933070,"Nhẫn Bạc Nữ - Nhẫn Bạc Nữ Đính Đá Bạc S925 Đơn Giản Phong Cách Hàn Quốc Thiết Kế Dáng Hở Điều Chỉnh Được Cỡ - N2458 - Bảo Ngọc Jewelry",220000,220000,0,0
TIKI,dong-ho-va-trang-suc,15627807,"Lu thống ngọc cẩm thạch",39130,39130,0,0
TIKI,dong-ho-va-trang-suc,43936313,"Vòng Chuỗi Mân Côi Đá Thạch Anh Tóc Đen Phối Thánh Giá hạt 12mm, ni50 - Ngọc Qúy Gemstones",1039000,1480000,441000,30
TIKI,dong-ho-va-trang-suc,50377999,"Dây Chuyền Vuông Titan Nam Hình Song Long Mạ Vàng 18K + TẶNG LÁ BỒ ĐỀ MAY MẮN TÀI LỘC ĐỂ VÍ ĐIỆN THOẠI",327750,345000,17250,5
TIKI,dong-ho-va-trang-suc,54685037,"Nhẫn Cặp | Nhẫn Đôi Nam Nữ Freesize Thiết Kế Đơn Giản ND2518 (Có thể tùy chỉnh tùy ý theo cỡ tay)",372000,372000,0,0
TIKI,dong-ho-va-trang-suc,49722402,"Nhẫn Nữ Bản To Titan Ko Đen TT 2464",105000,105000,0,0
TIKI,dong-ho-va-trang-suc,14998285,"Dây chuyền nam kiểu mì lớn mạ vàng 18k",113000,119000,6000,5
TIKI,dong-ho-va-trang-suc,20103710,"Vòng Tay Trầm Hương Chỉ Đỏ Thiên Mộc Hương",379000,490000,111000,23
TIKI,dong-ho-va-trang-suc,4407201,"Đồng Hồ thể thao Trẻ Em Chống Nước SKMEI 1061",170000,179000,9000,5
TIKI,dong-ho-va-trang-suc,78622641,"Nhẫn Bạc Thái | Nhẫn Bạc Thái Hình Sao Cho Nữ N1740 - Bảo Ngọc Jewelry",200000,200000,0,0
TIKI,dong-ho-va-trang-suc,14903787,"Dây Chuyền Ngọc Trai Cao Cấp DB2354 Cỡ Hạt 12x16 Bảo Ngọc Jewelry",388000,388000,0,0
TIKI,dong-ho-va-trang-suc,46717935,"Vòng tay đá cẩm thạch xanh lý bản tròn mệnh mộc hỏa - Ni",1599000,2000000,401000,20
TIKI,dong-ho-va-trang-suc,77947555,"Dây chuyền mặt đá cho nam nữ BHDC212",36000,59000,23000,39
TIKI,dong-ho-va-trang-suc,72880942,"Đồng hồ nữ thời trang Hàn Quốc mặt nhỏ JW-6337 - Hàng chính hãng",199000,199000,0,0
TIKI,dong-ho-va-trang-suc,35233450,"Đồng hồ nam Sunrise 1146SA B [Full Box] - Kính Sapphire, chống xước, chống nước - Dây da cao cấp",2218800,2218800,0,0
TIKI,dong-ho-va-trang-suc,68292794,"Dây Và Mặt Dây Chuyền Bạc Hiểu Minh DMD275 phật bà quan âm bồ tát",480000,590000,110000,19
TIKI,dong-ho-va-trang-suc,68347055,"Lắc Tay Nữ Bạc Hiểu Minh LTU409 kiềng bạc ta",680000,850000,170000,20
TIKI,dong-ho-va-trang-suc,106391315,"(TẶNG KÈM CHỐT VÀ DỤNG CỤ THAY DÂY) Dây đồng hồ inox không gỉ size 19mm dạng 5 mắt dây Tissot đầu ôm bo tròn",150000,150000,0,0
TIKI,dong-ho-va-trang-suc,114595314,"Đồng hồ nam quân đội chính hãng KASSAW S15008-1",3285000,3650000,365000,10
TIKI,voucher-dich-vu,75319261,"Goimon.net - Hotpot House - 1 Trong 6 Set Lẩu Nhiều Hương Vị Lựa Chọn Dành Cho 2-3 Người",308000,308000,0,0
TIKI,voucher-dich-vu,209389851,"Phiếu Quà Tặng Beloved & Beyond 500K",500000,500000,0,0
TIKI,voucher-dich-vu,80063321,"Khóa học Kỹ năng quản lý hiệu quả - Agilearn",1245000,1245000,0,0
TIKI,voucher-dich-vu,155742754,"Sách nói: Học Khôn Ngoan Mà Không Gian Nan",99000,99000,0,0
TIKI,voucher-dich-vu,155742739,"Sách nói: Tâm Lý Học Đám Đông",99000,99000,0,0
TIKI,voucher-dich-vu,34362532,"[HCM] Tour 6N5Đ Hà Nội - Ninh Bình - Hạ Long - Sapa, Gồm Vé Máy Bay Khứ Hồi, Khởi Hành Hàng Tuần",9600000,9600000,0,0
TIKI,voucher-dich-vu,34325063,"Bọc Răng Sứ Cercon Tại Nha Khoa Moli",4490000,4490000,0,0
TIKI,voucher-dich-vu,11797980,"Gói Khám Sức Khỏe Tiền Mang Thai Cho Nam - Phòng Khám Careplus",1500000,1500000,0,0
TIKI,voucher-dich-vu,185858956,"Tranh 3D Koifish cho hồ cá cảnh, các kích thước, theo yêu cầu",57000,57000,0,0
TIKI,dien-tu-dien-lanh,82435104,"Máy Giặt AQUA 9.8 Kg AQD-AF980A (W) -hàng chính hãng- Chỉ giao tại Hà Nội",8690000,8690000,0,0
TIKI,voucher-dich-vu,10085218,"Liệu Trình Hifu Tạo Hình VLine Nâng Cơ, Xóa Nhăn, Trẻ Hóa Da Tại Thanh Thanh Spa (Miễn Tip)",1499000,1499000,0,0
TIKI,voucher-dich-vu,71188902,"Khóa học CHUYÊN ĐỀ: HÓA HỌC VÔ CƠ - thầy Lê Minh Phấn - 09 tháng",1000000,1000000,0,0
TIKI,dien-tu-dien-lanh,157424564,"Điều khiển điều hoà Panasonic inverter 2 chiều",95000,95000,0,0
TIKI,voucher-dich-vu,205582354,"Phiếu Quà Tặng Lẩu Đài Loan Băng Chuyền Shang Chi 200K",200000,200000,0,0
TIKI,voucher-dich-vu,244132974,"[E-Voucher] Tour Cần Thơ Cà Mau An Giang 3 ngày 2 đêm",3050000,3050000,0,0
TIKI,dien-tu-dien-lanh,176289422,"[HCM] Máy Giặt Cửa Trước Electrolux EWF1142R7SB 11kg - Inverter - Hàng Chính Hãng",20990000,20990000,0,0
TIKI,voucher-dich-vu,155923812,"HCM [E-voucher] Giảm 30K Giặt Hấp Vest, Blazer, Váy, Đầm, Áo Quần khác - giao nhận tận nơi tại ứng dụng HERAMO",30000,30000,0,0
TIKI,voucher-dich-vu,105836034,"ELLY - Phiếu Quà Tặng 300.000đ",300000,300000,0,0
TIKI,voucher-dich-vu,21787103,"Tick Edu - Dựng Phim Truyền Thông Chuyên Nghiệp Với Adobe Premiere",699000,699000,0,0
TIKI,dien-tu-dien-lanh,93374789,"Van cấp đôi dành cho máy giặt Electrolux",250000,250000,0,0
TIKI,dien-tu-dien-lanh,94586492,"TÚI BỌC REMOTE ĐIỀU KHIỂN TV ĐIỀU HÒA (50 Tờ)",349700,349700,0,0
TIKI,dien-tu-dien-lanh,272456536,"Băng dính chịu nhiệt 10mm x 33m, 15mm x 33m, 20mm x 33m, 25mm x 33m, 30mm x 33m",23000,23000,0,0
TIKI,dien-tu-dien-lanh,121259030,"Android Tivi TCL 43 inch L43S5200 model 2021- Hàng chính hãng- Chỉ giao tại Hà Nội",9700000,9700000,0,0
TIKI,voucher-dich-vu,252135736,"Gói 2N1Đ - Du Thuyền 5 Sao Ambassador  Đẳng Cấp Nhất Vịnh Hạ Long - Nghỉ Dưỡng Trọn Gói Dành Cho 02 Người Lớn & 01 Trẻ Em Dưới 5 Tuổi (Miễn Phí Setup Sinh Nhật, Honey Moon, Kỷ Niệm Cưới)",2590000,2590000,0,0
TIKI,dien-tu-dien-lanh,126702214,"Điều khiển Điều Hòa dành cho DaiKin Loại ngắn,thường",64600,68000,3400,5
TIKI,dien-tu-dien-lanh,96355635," BỌC MÁY LẠNH KITTY   KITTY HOUSE",120000,120000,0,0
TIKI,voucher-dich-vu,222659074,"[EVoucher Vietravel] Đà Nẵng - Huế - Đầm Lập An - La Vang - Động Phong Nha & Thiên Đường - KDL Bà Nà - Cầu Vàng -Sơn Trà - Hội An - Đà Nẵng",7990000,7990000,0,0
TIKI,dien-tu-dien-lanh,192202335,"MÁY RỬA CHÉN KAFF KF-S770TFTS (Màu Inox) KF-S770TFTB (Màu Đen) - Seri 2022 - Hàng Chính Hãng",24800000,24800000,0,0
TIKI,voucher-dich-vu,271663649,"Xe bus Đà Nẵng – Hội An (một chiều)/ Shuttle Bus Da Nang to Hoi An (one way)",150000,150000,0,0
TIKI,dien-tu-dien-lanh,60815887,"Kệ chân để lọc nước có thể tùy chỉnh kích thước từ 30cm-40cm GNG",39000,89000,50000,56
TIKI,voucher-dich-vu,184512442,"Sách nói: Luật Của Warren Buffett",99000,99000,0,0
TIKI,dien-tu-dien-lanh,74459324,"  Tivi Box Android HDgo 4K Ram 2Gb Hàng chính hãng",800000,800000,0,0
TIKI,dien-tu-dien-lanh,8356903,"Máy làm đá viên tinh khiết HA180 - Hàng Chính Hãng",67200000,67200000,0,0
TIKI,voucher-dich-vu,131506242,"Video bài giảng trực tuyến Kỹ năng tổ chức hội nghị, hội họp và đi công tác",50000,50000,0,0
TIKI,voucher-dich-vu,19694062,"Khám Phụ Khoa Nữ Có Gia Đình - HPV Cobas - Phòng Khám Careplus",1900000,1900000,0,0
TIKI,dien-tu-dien-lanh,168042362,"Smart Tivi QLED Samsung 4K 75 inch QA75Q70BA - Model 2022",24350000,28950000,4600000,16
TIKI,dien-tu-dien-lanh,195660650,"Smart Tivi NanoCell LG 4K 65 inch 65NANO76SQA - Model 2022",14200000,15500000,1300000,8
TIKI,voucher-dich-vu,29284677,"MintWIFI-SIM 4G Du lịch 36 nước Châu Âu tốc độ cao dung lượng 5GB cho 30 ngày sử dụng",779000,779000,0,0
TIKI,dien-tu-dien-lanh,58531097,"Máy rửa bát Texgio TG-BI205 - 8 bộ bát đĩa Châu Âu - Điều khiển cảm ứng - Hàng nhập khẩu",12600000,12600000,0,0
TIKI,dien-tu-dien-lanh,119692556,"CÔNG TẮC CHO CỬA MÁY GIẶT ELECTROLUX EWF 85752, 85742, 10742, 10842, 12732, 12732S – HÀNG CHÍNH HÃNG",320000,320000,0,0
TIKI,dien-tu-dien-lanh,113048833,"Điều khiển chuột bay chức năng giọng nói.",95000,95000,0,0
TIKI,voucher-dich-vu,221818509,"[E-Voucher] Vietourist - Tour Du Lịch Tây Ninh: Núi Bà Đen - Thánh Địa Đạo Cao Đài",790000,790000,0,0
TIKI,dien-tu-dien-lanh,190630682,"Túi vệ sinh máy lạnh 1m7 và 2m, đuôi dài 3m [HÀNG CHẤT LƯỢNG CAO",39000,39000,0,0
TIKI,dien-tu-dien-lanh,71111373,"Android Tivi TCL 4K 55 inch 55P618",8690000,8690000,0,0
TIKI,dien-tu-dien-lanh,123432496,"Thiết bị bảo vệ dành cho tủ lạnh, bảo vệ thiết bị lạnh",135000,135000,0,0
TIKI,dien-tu-dien-lanh,142852181,"Bộ điều khiển từ xa dành cho quạt trần và đèn (Hàng cao cấp)",93100,98000,4900,5
TIKI,dien-tu-dien-lanh,189466193,"Google Tivi TCL 4K 43 inch 43P737 - Hàng Chính Hãng - Chỉ Giao Hà Nội",8800000,8800000,0,0
TIKI,voucher-dich-vu,34476220,"Khóa học Bí quyết xây dựng mối quan hệ trong kinh doanh",400000,400000,0,0
TIKI,voucher-dich-vu,973188,"Khóa Học Online Luyện TOEIC Nâng Cao 800+",319000,319000,0,0
TIKI,voucher-dich-vu,132184336,"[E-BOOK] CYLET Practice Tests Pre A1 Starters File nghe Audio",10000,10000,0,0
TIKI,voucher-dich-vu,2065131,"Dịch Vụ Trị Mụn Bằng Mỹ Phẩm Dermaligical Của Mỹ",195000,195000,0,0
TIKI,dien-tu-dien-lanh,192972253,"Khung Treo TiVi Nghiêng CP từ 39-65inch C65N - Hàng Chính Hãng",350000,350000,0,0
TIKI,dien-tu-dien-lanh,162097122,"Máy giặt lồng ngang Samsung AI Inverter 9Kg WW90T634DLE/SV - Hàng chính hãng - Chỉ giao Hà Nội",8650000,9250000,600000,6
TIKI,voucher-dich-vu,204339072,"T3. TOUR CANO 3 ĐẢO LẶN NGẮM SAN HÔ TỰ NHIÊN -PHÚ QUỐC",600000,600000,0,0
TIKI,voucher-dich-vu,204267279,"T1. ĐỊA TRUNG HẢI, BÃI SAO VÀ NGẮM HOÀNG HÔN VERSAILLES - PHÚ QUỐC ( Tour riêng )",690000,690000,0,0
TIKI,voucher-dich-vu,170630440,"Khóa Học Video Online Xoa Bóp Giảm Đau Khớp Gối Do Thoái Hóa Khớp, Khô Khớp - Trung Tâm Chăm Sóc Sức Khỏe VMC",900000,900000,0,0
TIKI,dien-tu-dien-lanh,169277370,"GIÁ TREO TIVI ĐA NĂNG SP2 40-70 INCH",1190000,1190000,0,0
TIKI,dien-tu-dien-lanh,248466163,"Đầm Bông Họa Tiết Nhiệt Đới Nổi Bật HOYANG D123",1550000,1550000,0,0
TIKI,dien-tu-dien-lanh,32402057,"Remote Điều Khiển Cho Máy Lạnh, Máy Điều Hòa MIDEA MSMA3-10CRN1, MSMA3-18CRN1",53000,53000,0,0
TIKI,voucher-dich-vu,190238877,"Hoa Yêu Thương - Evoucher Bình Hoa Tươi - Nắng Hồng ",550000,550000,0,0
TIKI,voucher-dich-vu,198463635,"Tour Du lịch Miền Bắc 4N3D (LT8): Nội Bài - Hà Nội - Vịnh Hạ Long - Sapa - Fansipan, Khởi hành Hằng ngày",3949000,3949000,0,0
TIKI,dien-tu-dien-lanh,73176691,"Điều khiển bằng giọng nói dùng cho Smartbox MyTV Chính hãng Cao cấp",237500,250000,12500,5
TIKI,voucher-dich-vu,11183866,"Combo Cắt Da Tay + Sơn Gel + Vẽ Tự Nhiên Tại Vietgangz Nails",229000,229000,0,0
TIKI,dien-tu-dien-lanh,74459280,"COMBO 10 BỘ CHIA CÁP TÍN HIỆU 2-3-4-6-8 TIVI",200000,200000,0,0
TIKI,dien-tu-dien-lanh,21327077,"Giá treo màn hình máy tính, tivi 14-27 inch đa năng xoay góc 180 độ nhập khẩu",190000,190000,0,0
TIKI,voucher-dich-vu,253232326,"À La Carte Hạ Long Bay Hotel & Residence 5* - Gồm Bữa Sáng, Nghỉ Dưỡng Đẳng Cấp Bên Bờ Biển, Hồ Bơi Vô Cực View Vịnh, Mới Khai Trương",1499000,1499000,0,0
TIKI,dien-tu-dien-lanh,25479295,"ĐIỀU KHIỂN DÀNH CHO TIVI SONY RMT - TZ300A",35000,35000,0,0
TIKI,dien-tu-dien-lanh,46184503,"Remote Điều Khiển Dành Cho TV LCD, TV LED SAMSUNG AA59-00602A (Kèm Pin AAA Maxell)",29900,29900,0,0
TIKI,voucher-dich-vu,214766631,"Kịch IDECAF: CƯỚI VỢ CHO AI",270000,270000,0,0
TIKI,voucher-dich-vu,11306320,"Combo Nail: Nhặt Da Tay Kết Hợp Sơn Gel TRINITY Tại MOH Beauty",179000,179000,0,0
TIKI,dien-tu-dien-lanh,25476219," ĐIỀU KHIỂN DÀNH CHO TIVI SONY TX-102D ",33000,33000,0,0
TIKI,dien-tu-dien-lanh,162750869,"Máy Giặt Samsung Inverter 9 kg WW90T634DLE",8900000,9250000,350000,4
TIKI,voucher-dich-vu,182832440,"Sách nói: Một Nửa Của 13 Là 8",99000,99000,0,0
TIKI,voucher-dich-vu,269964216,"[EVoucher Vietravel Hà Nội] Combo 3N2D KS Eden Ocean View Hotel Đà Nẵng 4 Sao: VMB khứ hồi Hà Nội - Đà Nẵng + Phòng Tiêu Chuẩn + Ăn sáng",3990000,3990000,0,0
TIKI,dien-tu-dien-lanh,119194733,"Remote dành cho máy lạnh Sumikura",75000,75000,0,0
TIKI,dien-tu-dien-lanh,126701879,"Remote điều khiển tivi dành cho Sony RM-ED047",50000,50000,0,0
TIKI,dien-tu-dien-lanh,195226962,"Dây CUROA Máy Giặt M18.5",25000,25000,0,0
TIKI,dien-tu-dien-lanh,72954000,"Tấm Chắn Gió Điều Hòa - Tản Nhiệt Máy Lạnh - Thiết Kế Lỗ Nhỏ Tránh Gió Trực Tiếp Từ Điều Hòa - Xoay 180 độ - Chăm Sóc Sức Khỏe Gia Đình, nhựa pvc thân thiện môi trường",113000,113000,0,0
TIKI,voucher-dich-vu,137229860,"[E-BOOK] New Amanda & Friends 2 File nghe Audio",10000,10000,0,0
TIKI,voucher-dich-vu,202763559,"Lấy Cao Răng (Cạo vôi răng) Và Đánh Bóng Công Nghệ Siêu Âm Mới - Nha khoa BeDental (5 chi nhánh)",99000,99000,0,0
TIKI,dien-tu-dien-lanh,132786001,"Tủ lạnh Beko Inverter 340 lít RDNT371E50VZGB - Hàng chính hãng - Giao toàn quốc",11200000,11200000,0,0
TIKI,voucher-dich-vu,214893569,"Gói học Speech Analyzer thời hạn 1 năm từ ELSA SPEAK - Công cụ luyện nói tiếng Anh toàn diện ",1720000,1720000,0,0
TIKI,voucher-dich-vu,167141168,"[APP] Ứng dụng Từ điển EVLD",139000,139000,0,0
TIKI,voucher-dich-vu,214893546,"Gói học Speech Analyzer thời hạn 3 tháng từ ELSA SPEAK - Công cụ luyện nói tiếng Anh toàn diện ",660000,660000,0,0
TIKI,voucher-dich-vu,1559411,"Phiếu Quà Tặng 50.000đ",50000,50000,0,0
TIKI,voucher-dich-vu,1559415,"Phiếu Quà Tặng 100.000đ",100000,100000,0,0
TIKI,voucher-dich-vu,2648565,"Phiếu Quà Tặng 3.000.000đ",3000000,3000000,0,0
TIKI,voucher-dich-vu,273818595,"Bảo hiểm du lịch toàn cầu MIC, chuyến đi từ 23 - 27 ngày, gói Thượng hạng",396200,566000,169800,30
TIKI,voucher-dich-vu,1559593,"Phiếu Quà Tặng 2.000.000đ",2000000,2000000,0,0
TIKI,voucher-dich-vu,273818388,"Bảo hiểm du lịch toàn cầu MIC, chuyến đi từ 4 - 6 ngày, gói Thượng hạng",128800,184000,55200,30
TIKI,voucher-dich-vu,17929617,"Voucher Gói Học ELSA Pro Trọn Đời Từ ELSA SPEAK - Học phát âm tiếng Anh chuẩn bản xứ",1845000,1845000,0,0
TIKI,voucher-dich-vu,1559601,"Phiếu Quà Tặng 5.000.000đ",5000000,5000000,0,0
TIKI,voucher-dich-vu,273818490,"Bảo hiểm du lịch toàn cầu MIC, chuyến đi từ 19 - 22 ngày, gói Thượng hạng",362600,518000,155400,30
TIKI,voucher-dich-vu,1559585,"Phiếu Quà Tặng 500.000đ",500000,500000,0,0
TIKI,voucher-dich-vu,214620199,"Gói học Speech Analyzer thời hạn 1 tháng từ ELSA SPEAK - Công cụ luyện nói tiếng Anh toàn diện",320000,320000,0,0
TIKI,voucher-dich-vu,7321979,"Phiếu Quà Tặng 300.000đ",300000,300000,0,0
TIKI,voucher-dich-vu,24382188,"Phiếu Quà Tặng 4.000.000đ",4000000,4000000,0,0
TIKI,voucher-dich-vu,273818359,"Bảo hiểm du lịch toàn cầu MIC, chuyến đi từ 1 - 3 ngày, gói Thượng hạng",102200,146000,43800,30
TIKI,voucher-dich-vu,1559589,"Phiếu Quà Tặng 1.000.000đ",1000000,1000000,0,0
TIKI,voucher-dich-vu,1559581,"Phiếu Quà Tặng 200.000đ",200000,200000,0,0
TIKI,voucher-dich-vu,273818656,"Bảo hiểm du lịch toàn cầu MIC, chuyến đi từ 28 - 31 ngày, gói Thượng hạng",436800,624000,187200,30
TIKI,voucher-dich-vu,196288504,"Toàn Quốc [E- Voucher] 1 Vé Vui chơi cho bé tại tại Playtime trên Toàn Quốc - Áp dụng các ngày kể cả Lễ không phụ thu",109000,109000,0,0
TIKI,voucher-dich-vu,7322123,"Phiếu Quà Tặng 10.000.000đ",10000000,10000000,0,0
TIKI,voucher-dich-vu,116881979,"Monkey Junior (Trọn đời, 4 năm, 2 năm,1 năm) - Phần mềm tiếng Anh và đa ngôn ngữ",499000,499000,0,0
TIKI,voucher-dich-vu,273737742,"Bảo hiểm Du lịch toàn cầu MIC, chuyến đi 16 - 18 ngày, gói Thượng hạng",315700,451000,135300,30
TIKI,voucher-dich-vu,173761446,"Phát âm tiếng Anh chuẩn bản xứ cùng ELSA SPEAK - Gói học ELSA Pro thời hạn 1 tháng",145000,145000,0,0
TIKI,voucher-dich-vu,244183622,"[3 tháng] Voiz FM - Voucher nghe Sách Nói",239000,249000,10000,4
TIKI,voucher-dich-vu,24376736,"Phiếu Quà Tặng 1.500.000đ",1500000,1500000,0,0
TIKI,voucher-dich-vu,152568784,"Sách nói: Việt Nam Sử Lược",99000,99000,0,0
TIKI,voucher-dich-vu,179786211,"[EVoucher Vietravel] Thái Lan: Pattaya - Bangkok (Thành cổ Muang Boran, tặng Show Colosseum và Buffet tại BaiYoke Sky)",7990000,7990000,0,0
TIKI,voucher-dich-vu,272744625,"Bảo hiểm TNDS xe ô tô 7 chỗ ngồi, không kinh doanh, giấy chứng nhận điện tử - Bảo hiểm Quân đội MIC",873400,873400,0,0
TIKI,voucher-dich-vu,80617753,"Gói Hội viên Ứng dụng sách nói Fonos: Gói 1 tháng",99000,99000,0,0
TIKI,voucher-dich-vu,117033031,"Voucher Gói Học ELSA Pro 3 tháng từ ELSA SPEAK - Phần mềm học nói tiếng Anh chuẩn bản xứ",329000,329000,0,0
TIKI,voucher-dich-vu,7322047,"Phiếu Quà Tặng 400.000đ",400000,400000,0,0
TIKI,voucher-dich-vu,273624354,"Bảo hiểm Du lịch toàn cầu MIC, chuyến đi 11 - 15 ngày, gói Thượng hạng",227500,325000,97500,30
TIKI,voucher-dich-vu,135043785,"Voucher Golf Valley Hotel 4* Đà Lạt - Gần Chợ & Hồ Xuân Hương, Gồm Buffet Sáng, Khách Sạn Vị Trí Thuận Tiện",1499000,1499000,0,0
TIKI,voucher-dich-vu,17929217,"Phát âm tiếng Anh chuẩn bản xứ cùng ELSA SPEAK - Gói học ELSA Pro thời hạn 1 năm",985000,985000,0,0
TIKI,voucher-dich-vu,76359037,"Hoàng Yến - Phiếu Quà Tặng 100K",100000,100000,0,0
TIKI,voucher-dich-vu,191378552,"Gói Hội viên Ứng dụng sách nói Fonos: Gói Quý (3 tháng)",249000,249000,0,0
TIKI,voucher-dich-vu,9672465,"Phiếu Quà Tặng 800.000đ",800000,800000,0,0
TIKI,voucher-dich-vu,80901684,"Gói Hội viên Ứng dụng sách nói Fonos: Gói 1 năm ",899000,899000,0,0
TIKI,voucher-dich-vu,7230533,"Voucher Spa Làm Đẹp tại Chuẩn Massage - Massage Body Tổng Hợp 75 Phút",280000,280000,0,0
TIKI,voucher-dich-vu,17929617,"Voucher Gói Học ELSA Pro Trọn Đời Từ ELSA SPEAK - Học phát âm tiếng Anh chuẩn bản xứ",1845000,1845000,0,0
TIKI,voucher-dich-vu,10806109,"Voucher Liệu Trình 75 Phút Massage Body Đá Nóng Thải Độc (Bao Gồm Xông Hơi) tại Rita Homespa",149000,149000,0,0
TIKI,voucher-dich-vu,2145217,"Voucher Buffet Chay Buổi Trưa tại Bông Sen Hotel Nhà Hàng Cỏ Nội với Hơn 40 Món Ăn Đặc Sắc",189000,189000,0,0
TIKI,voucher-dich-vu,973036,"Khóa Học Online Luyện TOEIC 450+ (Cho Người Mất Gốc)",299000,299000,0,0
TIKI,voucher-dich-vu,272036817,"Tour Tà Đùng 3N2Đ Caravan Buôn Ma Thuộc",3960000,3960000,0,0
TIKI,voucher-dich-vu,273720644,"Bảo hiểm du lịch toàn cầu MIC, chuyến đi 7 - 10 ngày, gói Thượng hạng",170800,244000,73200,30
TIKI,voucher-dich-vu,3234697,"Voucher Buffet Trưa Tại Nhà Hàng Gánh Bông Sen - Độc Đáo Hương Vị Ba Miền",249000,249000,0,0
TIKI,voucher-dich-vu,81084052,"CODE THI THỬ GMETRIX MOS- tinhocmos",250000,290000,40000,14
TIKI,voucher-dich-vu,9817034,"Voucher Dịch Vụ Cạo Vôi, Đánh Bóng Răng - Nha Khoa Hạnh Nguyên",100000,100000,0,0
TIKI,voucher-dich-vu,129734215,"[E-BOOK] Achievers Grade 6 Sách mềm sách học sinh",15000,15000,0,0
TIKI,voucher-dich-vu,7816222,"Voucher 14 Bước Trắng Sáng Da, Sạch Mụn, Mịn Màng Điều Trị Mụn Cao Cấp (90 Phút) Tại Ellis Spa",149000,149000,0,0
TIKI,voucher-dich-vu,59321599,"Gói đọc sách điện tử Waka 03 tháng",150000,150000,0,0
TIKI,voucher-dich-vu,129734261,"[E-BOOK] Achievers Grade 6 Sách mềm sách bài tập",15000,15000,0,0
TIKI,ngon,127392414,"[Chỉ giao HN] Set lẩu cô đơn",119000,119000,0,0
TIKI,ngon,127518539,"[Chỉ giao HN] Set lẩu Nhật",496000,496000,0,0
TIKI,ngon,125741626,"Cá mối hương fillet - 1kg 2 khay không xương",199000,199000,0,0
TIKI,ngon,273254746,"Khay Quà Lê Hàn Quốc",550000,550000,0,0
TIKI,ngon,157858407,"[ Chỉ giao HN] - QT_Hộp Lang Liêu 2 bánh – hộp 1100gram",220000,220000,0,0
TIKI,ngon,159728997,"[Chỉ giao HN] - Miến Hàn Quốc Nhập Khẩu -  1kg",110000,110000,0,0
TIKI,ngon,117727165,"[ Chỉ giao HN]-Há cảo sò-20gr/ cái",12000,12000,0,0
TIKI,ngon,116725571,"7 Chai Trà Sữa Collagen KetoX 6 vị (300ml)",950000,950000,0,0
TIKI,ngon,273620481,"Đặc Sản Nha Trang - Tôm Sấy Giòn Seavy Hộp 200g",86000,90000,4000,4
TIKI,ngon,170179106,"Lược Chải Ve Chấy Rận Cho Chó Mèo 14X3cm",20000,20000,0,0
TIKI,ngon,273710650,"Đặc Sản Nha Trang - Khô Cá Lá Chanh Sấy Giòn Thơm Lạ Miệng Seavy Hộp 200gram",72000,75000,3000,4
TIKI,ngon,169069145,"Đồ chơi chút chít cho thú cưng - Đồ chơi bông có tiếng kêu chút chít cho chó - Dâu",16000,16000,0,0
TIKI,ngon,97691609,"[[Chỉ Giao HN]] - Bún nem Tôm Hùm Ca",80000,80000,0,0
TIKI,ngon,117916508,"[Chỉ giao HN] - Bề Bề Vụn - 1Kg 2 Hộp",449000,449000,0,0
TIKI,ngon,166083139,"Vòng cổ cho chó mèo thú cưng: Vòng chuông bấm - Xanh Đậm",10000,10000,0,0
TIKI,ngon,169004676,"Dây đeo cổ vải dù nhiều màu có họa tiết dấu chân thú cưng đáng yêu cho chó mèo - Black",9999,9999,0,0
TIKI,ngon,169064138,"Vòng Cổ Chuông Nhiều Họa Tiết Cho Thú Cưng (Giao Màu Ngẫu Nhiên) - SIZE S",18999,18999,0,0
TIKI,ngon,169004400,"Vòng cổ 2 lớp 1cm có chuông cho mèo - Giao màu ngẫu nhiên",9999,9999,0,0
TIKI,ngon,169005129,"DÂY XÍCH CHÓ Dây dắt chó mèo ( phát màu ngẫu nhiên) - vòng cổ 2 lớp",122222,122222,0,0
TIKI,ngon,166062792,"Vòng cổ cho chó mèo thú cưng: Vòng chuông bấm - Đỏ",19999,19999,0,0
TIKI,ngon,166058200,"Thức ăn cho mèo royal canin babycat 1 kg chia lẻ túi zip - gói 1kg",262000,262000,0,0
TIKI,ngon,166058107,"VÒNG CỔ CHO CHÓ MÈO 2 LỚP 1 CM ( phát màu ngẫu nhiên)",9999,9999,0,0
TIKI,ngon,169066973,"Đồ Ăn Cho Mèo Con Me-O Hương Vị Cá Biển (1.1Kg)",110000,110000,0,0
TIKI,ngon,166083122,"THỨC ĂN CHO MÈO ROYAL CANIN KITTEN 36 THỨC ĂN MÈO - 1KG CHIA LẺ",226000,226000,0,0
TIKI,ngon,166058149,"Thức ăn cho mèo Pate me-o gói 80g - Vị cá biển - 1 Gói",12500,12500,0,0
TIKI,ngon,170180510,"Đồ chơi chút chít cho thú cưng - Đồ chơi bông có tiếng kêu chút chít cho chó - Miếng cam",17000,17000,0,0
TIKI,ngon,166062564,"Xương canxi sạch răng Orgo cho chó - Bò",28999,28999,0,0
TIKI,ngon,170179417,"Vòng Cổ Cho Chó Mèo",15999,15999,0,0
TIKI,ngon,169068455,"Vòng cổ chuông nhỏ họa tiết hoa văn",19999,19999,0,0
TIKI,ngon,166058090,"Thức ăn cho chó trưởng thành SmartHeart vị thịt bò 1.5kg- Tặng kèm 1 gói pate SmartHeart 130g",114999,114999,0,0
TIKI,ngon,169068879,"Gậy cao su tét đít Chó Mèo - Size S 42cm",30999,30999,0,0
TIKI,ngon,169058434,"Thức ăn cho mèo con và mèo trưởng thành Royal Canin Pháp Hộp 1kg - RC Dry Mix Feeding",225000,225000,0,0
TIKI,ngon,166062753,"Thức ăn cho mèo Pate me-o gói 80g - Vị cá mòi,gà và gạo - Hộp 12 gói",144000,144000,0,0
TIKI,ngon,169003964,"Vòng Cổ Cho Chó Mèo",15999,15999,0,0
TIKI,ngon,170180522,"Đồ Ăn Cho Chó Trưởng Thành SmartHeart Hương Vị Thịt Bò Nướng (1.5kg)  - Giao Ngẫu Nhiên",110000,110000,0,0
TIKI,ngon,169067770,"6 Gói Thức Ăn Cho Mèo Lớn Me-O Adult (350g/ Gói)",168888,168888,0,0
TIKI,ngon,166062726,"Sữa bột Dr.kyan Precaten cho chó mèo thú cưng - Chó - Hộp 110g",40000,40000,0,0
TIKI,ngon,170180416,"Thức Ăn Cho Mèo  Me-O Adult Vị Cá Thu (350g) - 5 Gói",138000,138000,0,0
TIKI,ngon,169064251,"Thức Ăn Cho Mèo  Me-O Adult Vị Cá Thu (350g) - 5 Gói",125000,125000,0,0
TIKI,ngon,169005873,"Thức ăn cho mèo trưởng thành Royal Canin FIt 32 - 1kg- túi zip",205999,205999,0,0
TIKI,giay-dep-nu,76055468,"Giày cao gót nữ phong cách Hàn Quốc gót vuông 7cm Y16",259000,259000,0,0
TIKI,giay-dep-nu,251462728,"Dép quai kẹp xốp Biti's nữ đế 7cm",265000,265000,0,0
TIKI,giay-dep-nu,54066106,"Dép Xỏ Ngón Nữ Da Bò BIGGBEN Cao Cấp DXN27",219000,380000,161000,42
TIKI,giay-dep-nu,125099482,"Giày lười nữ Anh Khoa E85",190000,190000,0,0
TIKI,giay-dep-nu,42734518,"Giày lười nữ TLG 20873-4",292400,325100,32700,10
TIKI,giay-dep-nu,16332290,"Combo 4 cặp lót giày cao gót giảm đau lòng bàn chân phía mũi lót giày hút mồ hôi chân khi mang giày bít mũi PK14-4",75000,75000,0,0
TIKI,giay-dep-nu,71028138,"Giày sandal nữ đi mưa thời trang mới nhất V256",69000,69000,0,0
TIKI,giay-dep-nu,81132312,"Dép đi trong nhà - dép mát xa -nachidu – MT1 ( Xanh cô ban ).",89000,89000,0,0
TIKI,giay-dep-nu,26687553,"Dép nữ xăng đan  đen da mềm mại TH -SD0017",239000,279000,40000,14
TIKI,giay-dep-nu,81507658,"Giày Cao Gót 7cm Gót Nhọn Hở Eo Màu Kem Pixie X693",480000,480000,0,0
TIKI,giay-dep-nu,192802180,"Dép Thái Lan Nam Nữ quai đúc cao su siêu êm Monobo Moniga AD01",110000,110000,0,0
TIKI,giay-dep-nu,68112057,"Giày nữ cao cấp ELLY – EGM86",1499000,1499000,0,0
TIKI,giay-dep-nu,4076119,"Giày Sneaker Unisex Converse Chuck Taylor All Star II 150144V - Nâu (Size",1440000,1600000,160000,10
TIKI,giay-dep-nu,195866601,"PUMA - Giày thể thao nữ Run XX Nitro WNS Running 376171",3699000,3699000,0,0
TIKI,giay-dep-nu,141291774,"Dép Nữ Quai Ngang Đế Xuồng TiTi ĐÔ Thời Trang Cao Cấp 9cm DNU2077a",380000,380000,0,0
TIKI,giay-dep-nu,130166567,"Dép Đế Trấu Nam Nữ Chiến Binh Bít Mũi Detaunisex Màu Đen - DETA41",300000,300000,0,0
TIKI,giay-dep-nu,121959890,"Sục Nữ Chất Liệu Vải Thông Thoáng, Thấm Hút Mồ Hôi Cao Gót Đơn Giản, Trang Nhã 669",190000,200000,10000,5
TIKI,giay-dep-nu,91866194,"HAVAIANAS - Dép nữ Slim Sparkle 4146093",949000,949000,0,0
TIKI,giay-dep-nu,12525704,"Giày Sandal Nữ BIGGBEN Da Bò Thật SDN19",339000,500000,161000,32
TIKI,giay-dep-nu,179877563,"Dép Nữ Quai Ngang Đế Xuồng HÀ NAM Thời Trang Da Bò Cao Cấp 9cm DNU2076c",390000,390000,0,0
TIKI,giay-dep-nu,113206920,"Dép Sục Lông hình Sừng Hươu Mềm Mại Mang Trong Nhà Siêu Ấm Cho Nữ - Hàng chính hãng ( Size 38-39)",158000,212000,54000,25
TIKI,giay-dep-nu,84565546,"DÉP BÁNH MÌ NỮ QUAI NGANG SIÊU NHẸ MỀM ÊM HOT 2021 - V764",39000,39000,0,0
TIKI,giay-dep-nu,185709558,"Giày cao gót quai ngang voan nhún xếp ly gót vuông 5p (Trắng)",125000,125000,0,0
TIKI,giay-dep-nu,173673012,"Giày khiêu vũ kín mũi, giày nhảy Dance Sport Latin cực đẹp",200000,200000,0,0
TIKI,giay-dep-nu,58423723,"Dép bông hình tai thỏ đi trong nhà",135000,139000,4000,3
TIKI,giay-dep-nu,133235013,"Dép Thái Lan Quai Chéo Nữ Monobo Moniga Ivy, không thấm nước, siêu bền",110000,110000,0,0
TIKI,giay-dep-nu,101014860,"Giày nữ da thật cao cấp nữ thời trang 21202",509100,565900,56800,10
TIKI,giay-dep-nu,38279646,"Dép Xuồng Nữ BIGGBEN Cao Cấp DX14",339000,400000,61000,15
TIKI,giay-dep-nu,81132332,"Dép đi trong nhà - dép mát xa -nachidu – MT17 ( xanh dương )",89000,89000,0,0
TIKI,giay-dep-nu,53043343,"Giày saldan nữ TRƯỜNG HẢI màu đen da mềm mại đế xuống cao 9.5cm thời trang cao cấp nữ XDN785",253000,299000,46000,15
TIKI,giay-dep-nu,141792311,"Giày búp bê nữ cao gót 2 phân hàng hiệu rosata đẹp hai màu đen đỏ ro358",430000,430000,0,0
TIKI,giay-dep-nu,53055153,"Dép bít mũi TRƯỜNG HẢI da bò thật mềm mại không bong tróc đế cao su chồng mòn êm ái BMN0361",236000,279000,43000,15
TIKI,giay-dep-nu,48329854,"Dép Xỏ Ngón Nữ Da Bò BIGGBEN Cao Cấp DXN25",299000,350000,51000,15
TIKI,giay-dep-nu,151537804,"0Dép bánh mỳ Hoạt Hình Chibi Dễ Thương | Dép Nữ thời trang độn đế siêu êm",42000,42000,0,0
TIKI,giay-dep-nu,91877043,"[Combo 3 ] Chai xịt khử mùi giày Nano Xclean Nano Bạc AHT Corp 50ml - Khử mùi, diệt khuẩn giày dép",108900,181500,72600,40
TIKI,giay-dep-nu,196843097,"Huy hiệu (Jibbitz) Crocs Cup Of Joe 10007121 - 1 cái",145000,145000,0,0
TIKI,giay-dep-nu,113256351,"GIÀY BÚP BÊ NỮ DÁNG BASIC full box",117000,117000,0,0
TIKI,giay-dep-nu,111551564,"Giày sneaker nữ siêu nhẹ 02, chất liệu vải dù kết hợp da siêu bền đep, đế casu chống trơn trượt, hàng nhập Quảng Châu",50000,50000,0,0
TIKI,giay-dep-nu,111092833,"Chai xi đánh giày da lộn chính hãng Yuppies dạng xịt, dùng cho tất cả các màu. dưỡng da cực tốt và rất thơm; dung tích",60000,85000,25000,29
TIKI,giay-dep-nu,144180204,"Dép nhựa nữ xỏ ngón dép kẹp nữ mang trong nhà hai quai",47500,47500,0,0
TIKI,phu-kien-thoi-trang,31259846,"Váy Chống Nắng Jean Cao Cấp Thêu Hoa Cánh Trắng",250000,250000,0,0
TIKI,phu-kien-thoi-trang,163572787,"Thắt lưng da nam cao cấp- dây nịt da bò 2 lớp EMRENEW -Full hộp đựng cao cấp",300000,600000,300000,50
TIKI,phu-kien-thoi-trang,72120344,"Kính Giả Cận, Gọng Kính Cận Nam Nữ Mắt Vuông Gọng Kim Loại Cứng Cáp - BLUE LIGHT SHOP",126000,142000,16000,11
TIKI,phu-kien-thoi-trang,138900300,"Set 10 khuy cài cúc áo, combo 10 khuy cài áo",22400,22400,0,0
TIKI,phu-kien-thoi-trang,168313503,"Tất Giày Tây Nam Cao Cấp Họa Tiết Sọc Chéo, Vớ Nam Cổ Cao Chất Liệu Cotton Hút Ẩm Thoáng Khí - GOM-TAYCHEO-1DOI",26000,50000,24000,48
TIKI,phu-kien-thoi-trang,76035462,"Combo 3 đôi Tất thể thao Redikick Cổ thấp R365 Sợi Cotton Cao Cấp Vớ Nam Nữ Unisex có đệm Cushion Chống hôi chân, Thoáng khí, Thấm mồ hôi phù hợp chơi Bóng Rổ Bóng đá Bóng Chuyền Tennis Chạy Bộ Đá banh - Hàng Chính Hãng",109000,150000,41000,27
TIKI,phu-kien-thoi-trang,138052017,"Hộp 4 đôi tất nam cổ ngắn sợi tre cao cấp, vớ cổ ngắn nam mềm mại thoáng mát - GOMTAT-SOITRE-NGAN",125000,200000,75000,38
TIKI,phu-kien-thoi-trang,94998994,"Khẩu trang ninja vải nỉ có kính chống bụi dán gáy che kín tai chống nắng chồng gió bụi chạy xe phượt nam nữ - khau trang ni",30000,30000,0,0
TIKI,phu-kien-thoi-trang,160395612,"sao huy hiệu gắn mũ cối",12000,12000,0,0
TIKI,phu-kien-thoi-trang,57523197,"Set 10 Đôi Tất Họa Tiết Hoa Cúc Kèm Túi Đựng Xinh Xắn Cho Nữ",37900,37900,0,0
TIKI,phu-kien-thoi-trang,172126746,"Khẩu Trang Vải Linen 4D NEMO Collection, Chống Nắng, Lọc Khuẩn, Thoáng Khí Không Gây Mụn - KTDM",25000,50000,25000,50
TIKI,phu-kien-thoi-trang,108585245,"Set 5 ghim cài áo quần váy cao cấp",25998,25998,0,0
TIKI,phu-kien-thoi-trang,155061502,"Mũ lưỡi trai, nón kết big size cỡ lớn cho nam đầu to (chu vi 59-65cm)",40000,40000,0,0
TIKI,phu-kien-thoi-trang,71197467,"Combo lens cận không màu, nước ngâm lens 150ml, gắp lens, khay ngâm lens",200000,200000,0,0
TIKI,phu-kien-thoi-trang,177997131,"Tất Nam Nữ Cổ Ngắn Thời Trang Hàn Quốc, Vớ Cổ Thấp Unisex 2 Sọc Êm Mềm Thoáng Mát - NGAN-2SOC-1DOI-201",9000,11000,2000,18
TIKI,phu-kien-thoi-trang,198584207,"Mũ/ nón lưỡi trai hàn quốc thêu chữ 1987 màu trắng sữa, Nón kết trơn unisex nam nữ hàng chuẩn đẹp",10000,10000,0,0
TIKI,phu-kien-thoi-trang,75528777,"Thắt Lưng Nữ Bản To Kèm Dây Xích Cá Tính TL012 MayHomes Dây Lưng Nữ Thời Trang, Dây Nịt Nữ Da PU Khóa Kim Loại Bền Chắc Đa Năng Dùng Cho Đầm, Jeans, Quần Âu Và Shorts",85000,85000,0,0
TIKI,phu-kien-thoi-trang,160894097,"Hộp 4 đôi tất sợi tre cổ ngắn, tất vớ nam nữ cổ ngắn sợi tre cao cấp, khử mùi, kháng khuẩn - GOMTAT-SOITRE-NGAN",132000,200000,68000,34
TIKI,phu-kien-thoi-trang,84774789,"Kính lão thị viễn thị trung niên mắt thủy tinh chống xước sẵn độ",80000,80000,0,0
TIKI,phu-kien-thoi-trang,75523746,"Thắt Lưng Nữ Thời Trang Mặt Khóa Kim Loại Hình Oval Chất Liệu Da PU TL010 MayHomes Dây Lưng Nữ, Dây Nịt Nữ Đa Năng Bền Chắc Dùng Cho Đầm, Jeans, Quần Âu Và Shorts",68888,78000,9112,12
TIKI,phu-kien-thoi-trang,166591681,"Dây cột tóc- buộc tóc vải nhiều màu hot nhất hiện nay- màu ngẫu nhiên",28500,30000,1500,5
TIKI,phu-kien-thoi-trang,32725930,"Set 100 Dây Thun Cột Tóc, Chun Buộc Tóc Hàn Quốc Nhiều Màu Tiện Dụng",19000,19000,0,0
TIKI,phu-kien-thoi-trang,96587894,"Kính mát phân cực nam VEITHDIA",244800,288000,43200,15
TIKI,phu-kien-thoi-trang,58631403,"Khăn lau kính chống mờ hơi nước hộp 30 miếng Ichinen Nhật Bản",189000,189000,0,0
TIKI,phu-kien-thoi-trang,198460229,"Tất Đùi Len Vân Sọc Loại Dày Mẫu Mới Thu Đông Phong Cách Nhật Bản PK214",75000,75000,0,0
TIKI,phu-kien-thoi-trang,113912892,"Mũ tai bèo - nón tai bèo - mũ Thanh niên tình nguyện",28000,28000,0,0
TIKI,phu-kien-thoi-trang,163572707,"Thắt lưng da nam cao cấp- dây nịt da bò 2 lớp EMRENEW -Full hộp đựng cao cấp",290000,580000,290000,50
TIKI,phu-kien-thoi-trang,146399186,"Kính Giả Cận, Gọng Kính Cận Nam Nữ GM V Mắt Vuông Viền Dày Nhỏ Hàn Quốc Không Độ - BLUE LIGHT SHOP",185000,185000,0,0
TIKI,phu-kien-thoi-trang,192950066,"Quà tặng 1 cái khẩu trang y tế KF94 4 lớp tiệt trùng túi riêng từng cái Khánh An KA99 vệ sinh và tiện lợi khi mang theo ngăn vi khuẩn 99% thiết kế 4D HÀN QUỐC hợp thời trang và dễ thở",4000,5000,1000,20
TIKI,phu-kien-thoi-trang,176261734,"Kính lão nhựa gọng dẻo tròng kính chống vỡ from kính đẹp dành cho nam và nữ đủ số từ 0.5-4.0 độ mẫu L02",19000,19000,0,0
TIKI,phu-kien-thoi-trang,212426558,"Tất Đùi Trong Suốt Kèm Dây Đai Quyến Rũ Chống Tuột PK522",92000,92000,0,0
TIKI,phu-kien-thoi-trang,191500974,"Tất Đùi Dày Dặn Qua Đầu Gối Dễ Thương Coplay Hàn Quốc Sọc Trắng Đen",39000,79000,40000,51
TIKI,phu-kien-thoi-trang,70931921,"Nón beret nam, mũ mỏ vịt dành cho người trung niên, không thêu họa tiết, chất liệu vải oát mềm mại, tăng giảm size dễ dàng",65000,65000,0,0
TIKI,phu-kien-thoi-trang,88085836,"Tất nữ cổ ngắn, vớ nữ kẻ đẹp",12500,12500,0,0
TIKI,phu-kien-thoi-trang,49048540,"Khẩu trang vải trơn",1900,2000,100,5
TIKI,phu-kien-thoi-trang,21036436,"Gói dây thun 100 gam nhiều màu cột tóc",21000,35000,14000,40
TIKI,phu-kien-thoi-trang,184062627,"Gọng kính hợp kim cước thời trang nam nữ siêu nhẹ siêu bền Ouress 58026",202000,280000,78000,28
TIKI,phu-kien-thoi-trang,107344200,"Tất nam nữ - Vớ nam nữ cổ ngắn mã TT70 đẹp cao cấp  kiểu tất chân",3699,3699,0,0
TIKI,phu-kien-thoi-trang,70795767,"Thắt Lưng Nữ Họa Tiết Hoa Cúc TL007 MayHomes, Dây Lưng Nữ, Dây Nịt Nữ Chất Liệu Da PU Khóa Kim Loại Dễ Thương, Dùng Cho Đầm, Jeans, Quần Âu Và Short",42300,45000,2700,6
TIKI,phu-kien-thoi-trang,110205031,"Băng Đô Bờm Tóc Cài Tóc Quấn Tóc Màu Sắc Tinh Tế Đơn Giản Quà Tặng Xinh Xắn",98000,98000,0,0
TIKI,phu-kien-thoi-trang,26386138,"Kính cận thị gọng hợp kim titan mắt kính đổi màu KDN -KCM10",152000,152000,0,0
TIKI,phu-kien-thoi-trang,71161566,"Tóc giả buộc thẳng 60cm FREESHIP tóc cột giả, buộc tóc giả D13L",49000,49000,0,0
TIKI,phu-kien-thoi-trang,189491970,"Dây Buộc Tóc Vải, Khăn choàng cổ Lụa In Họa Tiết Thắt Nơ Phong Cách Hàn Quốc Cho Nữ",18000,18000,0,0
TIKI,phu-kien-thoi-trang,172456630,"DÂY THUN CỘT TÓC Loại size to Co giãn Bịch 40g",9000,9000,0,0
TIKI,phu-kien-thoi-trang,173650726,"Mặt khoá rời thắt lưng CA",99000,99000,0,0
TIKI,phu-kien-thoi-trang,20200845,"Băng đô bông -băng đô đa năng - băng đô tai gấu",41000,41000,0,0
TIKI,phu-kien-thoi-trang,11427996,"Đai chống gù lưng cho nữ size",199900,199900,0,0
TIKI,phu-kien-thoi-trang,146621749,"Kim Loại Sang Trọng Kim Cương - Kẹp Tóc Hình Học Đơn Giản Thiết Kế Mỏ Vịt - Kẹp Tóc Phong Cách Hàn Quốc",34900,34900,0,0
TIKI,phu-kien-thoi-trang,178112267,"Cà Vạt Nam Cao Cấp Sang Trọng Nam Tính phụ kiện mặc vest, suit đi họp, dự tiệc bản 8cm",145000,145000,0,0
TIKI,phu-kien-thoi-trang,24935652,"Bộ 5 đôi tất lưới nữ cổ thuyền Basic",54000,54000,0,0
TIKI,phu-kien-thoi-trang,10765937,"Kính mát thể thao Unisex Tifosi Swank - Gọng Crimson / Onyx, Tròng Smoke Red",950000,950000,0,0
TIKI,phu-kien-thoi-trang,109367023,"Kính lão thị viễn thị đọc sách  trung niên HAI TRÒNG nhìn xa và gần tiện lợi PKTMKT92JJH",219000,219000,0,0
TIKI,phu-kien-thoi-trang,147116858,"Kính mát nam kính râm phù hợp mặt to gọng kim loại kính cường lực chống trầy xước",79200,99000,19800,20
TIKI,phu-kien-thoi-trang,124400004,"Thắt lưng nam dây nịt nam chất liệu da bò thật khóa tự động hàng hiệu cao cấp NT302 - Nutushop",320000,320000,0,0
TIKI,phu-kien-thoi-trang,146381894,"Set Kẹp Tóc Nữ Felling Màu Sắc Siêu Bền",12600,12600,0,0
TIKI,phu-kien-thoi-trang,5919055,"2 Đôi Găng Tay Chống Nắng Let Slim Đen (4 Chiếc)",18000,18000,0,0
TIKI,phu-kien-thoi-trang,173482223,"Ví da đựng kính thời trang nút bấm kim loại (giao màu ngẫu nhiên)",56000,60000,4000,7
TIKI,phu-kien-thoi-trang,43879862,"THẮT LƯNG NỮ CLIME, DÂY NỊT NỮ DN1912322",69000,69000,0,0
TIKI,phu-kien-thoi-trang,48725015,"GỌNG KÍNH UNISEX VELOCITY VL48471",256000,360000,104000,29
TIKI,phu-kien-thoi-trang,117692356,"Kính Giả Cận, Gọng Kính Cận Không Độ Dáng Vuông Lớn Nam Nữ ",155800,164000,8200,5
TIKI,phu-kien-thoi-trang,24540381,"Tất nữ cao cổ Basic II",14000,15000,1000,7
TIKI,phu-kien-thoi-trang,31140848,"Băng đô giữ tóc vải mịn Song An Eco TB07",15000,15000,0,0
TIKI,phu-kien-thoi-trang,81555103,"Thắt lưng nam da , dây nịt nam TRƠN - MS-110",55000,110000,55000,50
TIKI,phu-kien-thoi-trang,96010859,"Thắt lưng nam , dây nịt da nam cao cấp - MCZ",50000,50000,0,0
TIKI,phu-kien-thoi-trang,74676716,"Kính lão thị viễn thị loại tốt kính mắt sáng rõ và không mỏi gọng khoan siêu nhẹ và sang trọng",186000,186000,0,0
TIKI,phu-kien-thoi-trang,48050429,"Bộ 3 Kẹp tóc càng cua mỏ vịt kẹp mái thời trang như hình",35000,35000,0,0
TIKI,phu-kien-thoi-trang,169641317,"Móc vít chìa khóa sửa gọng kính",9000,12000,3000,25
TIKI,phu-kien-thoi-trang,54146582,"Kính lão thị viễn thị trung niên gọng khoan nam tính chống bức xạ kv4n cao cấp nhật bản",179000,179000,0,0
TIKI,phu-kien-thoi-trang,99670139,"Kẹp phồng tóc:phụ kiện tóc nữ,miếng độn tóc",30000,30000,0,0
TIKI,phu-kien-thoi-trang,47301060,"Kính V SOUTHSIDE Mắt vuông unisex cho Nam và Nữ",35000,35000,0,0
TIKI,phu-kien-thoi-trang,72203600,"Tag Hoa Hồng Lớn Cài Áo, Kiểu Cài Áo Hoa Có Ghim, Có Trâm Cài Áo Váy Màu Nâu Đậm, màu da, Đỏ  - Kích Thước 8-9 CM CH002",48000,54000,6000,11
TIKI,phu-kien-thoi-trang,164021838,"Kính Mát Nam Thời Trang Phân Cực Polaroid Chống Lóa, Chống Tia UV AK015 - AORON",250000,350000,100000,29
TIKI,phu-kien-thoi-trang,169304683,"Thắt lưng nam ADL04, dây nịt nam thời trang khóa kim đúc đồng siêu đẹp, bảo hành 12 tháng - Adonis Store",249000,249000,0,0
TIKI,phu-kien-thoi-trang,208067236,"Tóc giả nữ búi gấp mini, tóc búi kẹp, tóc búi mini",160000,160000,0,0
TIKI,phu-kien-thoi-trang,241631539,"Mũ nón len nam nữ mùa thu đông chất dày co dãn tốt giữ ấm tốt tròn thời trang",45000,45000,0,0
TIKI,phu-kien-thoi-trang,77670404,"Thắt lưng nữ Dress/ dây nịt nữ đẹp phối đầm / Đai váy sang trọng DONA21021704",79000,99000,20000,20
TIKI,phu-kien-thoi-trang,160894063,"Hộp 5 đôi tất đi giày tây họa tiết sọc chéo, vớ nam công sở cổ cao cao cấp, chất cotton hút ẩm, thoáng khí - GOM-TAYCHEO-CB5",179000,250000,71000,28
TIKI,phu-kien-thoi-trang,83617329,"Khẩu trang ninja vải nỉ kính bảo vệ mắt dán gáy che kín tai chạy xe phượt nam nữ - khau trang ni - Đỏ đô có kính",49000,49000,0,0
TIKI,phu-kien-thoi-trang,170720661,"Khăn Mùi Xoa, Khăn Tay Nam (L2)",55000,55000,0,0
TIKI,phu-kien-thoi-trang,95295101,"Thắt lưng chun - độ đàn hồi tốt (dành chuyên cho người vận động thể thao)",360000,360000,0,0
TIKI,may-anh,16988898,"Bộ Filter vuông ND 2-4-8-16 - hàng nhập khẩu",469000,469000,0,0
TIKI,may-anh,108591207,"Pin Kingma for Canon LP-E6, Hàng chính hãng",349999,349999,0,0
TIKI,may-anh,251455755,"Camera IP Wifi IMOU Cruiser GS7EP 3MP và 5MP có màu ban đêm, đàm thoại 2 chiều - Hàng chính hãng",1200000,1950000,750000,38
TIKI,may-anh,155998242,"Túi máy ảnh Safrotto SF001",900555,900555,0,0
TIKI,may-anh,52251276,"Bộ kính hiển vi cho trẻ Science Microscope",194000,194000,0,0
TIKI,may-anh,65442449,"Camera IP Wifi quay quét EZVIZ C6N 2MP chính hãng (Tặng thẻ nhớ 32GB)",510000,510000,0,0
TIKI,may-anh,194069934,"Camera Wifi Trong Nhà EZVIZ C6N 4MP 2K Quay Quét 355 độ - Đàm thoại 2 chiều - Hàng Chính Hãng",619900,619900,0,0
TIKI,may-anh,109853501,"jack DC nguồn 12v Vặn Vít - jack cái 12v - jack nguồn camera âm",4990,4990,0,0
TIKI,may-anh,195948753,"Camera Hành Trình Ô Tô DDPAI Mini 5 Có Định Vị GPS Kết Nối WIFI Camera AI Thông Minh Độ Phân Giải 4K, Cảnh Báo Làn Đường, Giám Sát 24 Giờ, Hiển Thị Tốc Độ - Hàng Chính Hãng",2799000,5579000,2780000,50
TIKI,may-anh,10771705,"Camera Thân Chữ Nhật Hikvision HD-TVI 2MP DS-2CC12D9T - Hàng Chính Hãng",3250000,3250000,0,0
TIKI,may-anh,104070021,"Đầu ghi 16 kênh HDTVI H.265+ Hikvision DS-7216HQHI-K1 vỏ sắt - Hàng chính hãng",3430000,3430000,0,0
TIKI,may-anh,22427331,"Chân Máy Ảnh Benro T660 EX (Tripod) - Hàng Nhập khẩu",590000,590000,0,0
TIKI,may-anh,177488244,"Camera wifi không dây Imou C22 đàm thoại/ hồng ngoại/ cảnh báo chuyển động- Hàng chính hãng",469500,890000,420500,47
TIKI,may-anh,950416,"Bộ Dây Đeo Camera Trước Ngực DJI",78000,78000,0,0
TIKI,may-anh,16626395,"Bộ sạc và pin máy ảnh cho Canon LP-E17 LPE17 EOS M3 M5 M6 Rebel SL2 T6i T6s T7i 200D 77D 760D 750D 8000D 800D KISS X8i",218000,267000,49000,18
TIKI,may-anh,54654279,"HỘP CHỤP SẢN PHẨM CÓ LED 40X40CM",191000,245000,54000,22
TIKI,may-anh,147969828,"Bộ đèn 2 chảo chụp ảnh trong nhà TIANRUI",630000,630000,0,0
TIKI,may-anh,179921012,"Kính hiển vi dành cho học sinh, Kính hiển vi sinh học C2170 cao cấp độ phóng đại lên 1200X",475000,475000,0,0
TIKI,may-anh,38364371,"Đèn LED Trợ Sáng 96 Bóng Ulanzi FUDB1, Hỗ Trợ Quay Phim Công Suất Sáng Cực Mạnh, Có 2 Loại Nguồn Sạc Cực Kì Tiện Lợi, 2 Nguồn Sáng, Trắng Sáng Chói Hỗ Trợ Quay Trong Trường Hợp Thiếu Ánh Sáng, Trắng Sáng Mờ, Bảo Vệ Mắt Của Bạn Khi Tiếp Cận Với Ánh Đèn - H",200000,200000,0,0
TIKI,may-anh,113967701,"Kính Thiên Văn Khúc Xạ F36050",387000,387000,0,0
TIKI,may-anh,13176003,"Hạt hút ẩm màu xanh nhạt đóng gói 1kg",95000,95000,0,0
TIKI,may-anh,4727157,"Túi Đựng Filter 10 Cái - Hàng Nhập Khẩu",129000,129000,0,0
TIKI,may-anh,195668579,"Camera WIFI ngoài trời EZVIZ CB8 3MP 2K năng lượng mặt trời, có màu ban đêm - Hàng chính hãng",2250000,3500000,1250000,36
TIKI,may-anh,28745899,"Túi đựng máy ảnh vải gai cổ điển M80",224900,224900,0,0
TIKI,may-anh,94596171,"Camera wifi yoosee ngoài trời 20 LED 4 râu thân xoay Full HD 1080P Quay đêm có màu, Chống Nước đàm thoại 2 chiều , App ngôn ngữ tiếng Việt - Hàng Nhập Khẩu",479000,479000,0,0
TIKI,may-anh,24605730,"Sạc pin NP-FH50 cho máy ảnh, máy quay Sony- Hàng nhập khẩu",109000,109000,0,0
TIKI,may-anh,8090713,"Thẻ Nhớ Micro SD Netac U3 Class 10 64GB – Hàng Chính Hãng",149000,149000,0,0
TIKI,may-anh,56589563,"Softbox Godox 50x130cm - Hàng chính hãng",683000,683000,0,0
TIKI,may-anh,51470490,"Camera IP Wifi Xoay Theo Chuyển Động Đàm Thoại 2 Chiều Imou A22EP+ Thẻ Netac 32G - Hàng Chính Hãng",590000,590000,0,0
TIKI,may-anh,10118152,"Camera Hikvision DS-2CE16D0T-IT5 - Hàng chính hãng ",728000,728000,0,0
TIKI,may-anh,77242660,"Camera yoosee xem đêm có màu , camera wifi 3 râu chuẩn 2.0 Full HD 1080P , đàm thoại 2 chiều - Hàng Nhập Khẩu",348000,348000,0,0
TIKI,may-anh,44841778,"Mắt Camera ngoài trời Hikvision DS-2CE16D0T-IR 2MP - Hàng chính hãng",389000,389000,0,0
TIKI,may-anh,67720636,"Kính Hiển Vi 1000X Hd X4s-1000 ( ỐNG KÍNH NHẬP FULL HD, CHÂN ĐẾ CHẮC CHẮN CHỐNG RUNG TỐT ) - HÀNG NHẬP KHẨU",649000,649000,0,0
TIKI,may-anh,28364394,"VIETMAP C65 - Camera Hành Trình Cảm Ứng Ghi Hình Trước Sau + Cảnh báo bằng giọng nói + Wifi + Thẻ nhớ 32GB - Hàng Chính Hãng",4200000,4200000,0,0
TIKI,may-anh,120110838,"Camera wifi yoosee ngoài trời 20 LED 4 râu thân xoay Full HD 1080P Quay đêm có màu tặng thẻ 32g, Chống Nước đàm thoại 2 chiều , App ngôn ngữ tiếng Việt - Hàng Nhập Khẩu - Chỉ Camera",510000,510000,0,0
TIKI,may-anh,98738720," MÁY ẢNH KỸ THUẬT DSRL MINI CHO BÉ + tặng thẻ 16GB",637000,637000,0,0
TIKI,may-anh,2545863,"Bộ Đèn Chụp Sản Phẩm Softbox (150W) - Hàng Nhập Khẩu",599000,599000,0,0
TIKI,may-anh,34719990,"Bộ 2 Pin Và Sạc Kép RAVPower Cho Sony FZ100 A9 A7III A7RIII A6600 - Hàng Nhập Khẩu",1299999,1299999,0,0
TIKI,may-anh,69861503,"Dây máy ảnh đeo cổ tay kiểu sợi bện",135000,135000,0,0
TIKI,may-anh,2227437,"Tủ Chống Ẩm Nikatei NC-30C (30L) - Vàng - Hàng Chính Hãng",1700000,2550000,850000,33
TIKI,giay-dep-nu,15240349,"Sneaker nữ siêu nhẹ Flex X_- 4SMG003",699000,699000,0,0
TIKI,giay-dep-nu,142002374,"Dép nữ thời trang chống nước DXG02",35000,35000,0,0
TIKI,giay-dep-nu,176542963,"Dép sandal đế bằng quai ngang xinh xắn",135000,135000,0,0
TIKI,giay-dep-nu,176544380,"giày cao gót hoa đi tiệc tiểu thư xinh 12cm",245000,245000,0,0
TIKI,giay-dep-nu,44224471,"Độn giày silicon đệm khí êm chân, lót giày 2 lớp tăng chiều cao 5cm- giao màu ngẫu nhiên ",44299,44299,0,0
TIKI,giay-dep-nu,119668935,"giày Dép bông bộ Đồ thú khủng long xanh liền thân lông mịn Pijama Động Vật Hoạt Hình Cosplay",119000,119000,0,0
TIKI,giay-dep-nu,193602832,"HAVAIANAS - Sandals nữ Luna Premium II 4147009",1049000,1049000,0,0
TIKI,giay-dep-nu,125098628,"Giày lười nữ Anh Khoa A688",250000,250000,0,0
TIKI,giay-dep-nu,104792780,"Dép nhựa Quai ngang Thái Lan Siêu Nhẹ, êm Monobo - Moniga 4.4",90000,90000,0,0
TIKI,giay-dep-nu,191592488,"Giày da công sở Chelsea Boots Zip Classic 22 (CB.ZC22) da bò nhập khẩu, Lucas Shoes bảo hành 1 năm",645000,645000,0,0
TIKI,giay-dep-nu,129233346,"HJ7038-7920 - Giày boot nữ Huy hoàng da bò màu nâu, đen",1399000,1399000,0,0
TIKI,giay-dep-nu,87134083,"Giày Búp Bê Nữ Da Microfiber Đính Nơ Siêu Nhẹ Tomoyo TMW32202",800000,800000,0,0
TIKI,giay-dep-nu,242489571,"Giày lười Loafer No.5 trắng đé gỗ",999000,999000,0,0
TIKI,giay-dep-nu,184069072,"HAVAIANAS - Dép nữ Slim Glitter II 4146975",949000,949000,0,0
TIKI,giay-dep-nu,109546785,"Giày Nữ Búp Bê Đế Xuồng HÀ NAM Da Bò Thật Cao Cấp 4cm GBBN2036",350000,350000,0,0
TIKI,giay-dep-nu,183116036,"_HÌNH THẬT_ Giày bệt búp bê hàng VNXK, da lì cao cấp siêu bền size từ 36 đến 42",89000,89000,0,0
TIKI,giay-dep-nu,87940576,"Giày sandal nữ da bò thật HÀ NAM đế xuồng gót cao 5cm DNU2021",346000,346000,0,0
TIKI,giay-dep-nu,160818672,"Dây giày boot tròn to 4.5mm Sans946 cotton dù đen nâu trắng be xám cột buộc giầy thể thao cao cổ bốt nam nữ shoe laces",22000,22000,0,0
TIKI,giay-dep-nu,125098565,"Giày nữ Anh Khoa C963-7",220000,220000,0,0
TIKI,giay-dep-nu,170110746,"2 chiếc giày Bata tàu phủi chính hãng Wika Ultra 1",219000,219000,0,0
TIKI,giay-dep-nu,183787500,"Giày Thể Thao Nữ Tăng Chiều Cao Hồng GN Dáng Đẹp-S104 Có 2 Màu",109000,150000,41000,27
TIKI,giay-dep-nu,59058783,"Dép  nữ Mang Trong Nhà Chống Trơn Trượt Siêu Êm Ái Họa Tiết Hoa Hướng Dương Tặng Dây Buộc Tóc",115000,115000,0,0
TIKI,giay-dep-nu,51718162,"Dép Đi Trong Nhà Massage Chân - S26",85000,85000,0,0
TIKI,giay-dep-nu,68659155,"Dép quai hậu nữ đep sandals nữ hoa cúc kiểu dáng trẻ trung mới 2020 FS2",149000,149000,0,0
TIKI,giay-dep-nu,125099265,"Giày Lười Nữ Anh Khoa A913-9",199000,199000,0,0
TIKI,giay-dep-nu,186143660,"Giày bệt nữ, giày búp bê, có dây buộc nơ giúp ôm chân, loại đẹp, phong cách tiểu thư Hàn Quốc",137500,137500,0,0
TIKI,giay-dep-nu,125779665,"Giày đi mưa siêu nhẹ",65000,65000,0,0
TIKI,giay-dep-nu,108035446,"Miếng Lót Mũi Chân Nữ Cao Cấp Silicon Bảo Vệ Chân Khi Di Giày Siêu Mềm Thoáng Khí",15000,15000,0,0
TIKI,giay-dep-nu,2024015,"Giày Nữ Búp Bê Da Bò Huy Hoàng HT7911 - Tím",489000,489000,0,0
TIKI,giay-dep-nu,114739749,"GIÀY CƯỚI - GIÀY CÔ DÂU BEJO W06 2HOA BABY - WEDDING SHOES",840000,840000,0,0
TIKI,giay-dep-nu,184316951,"DÉP MASSAGE CHÂN - BẤM NGUYỆT ",124000,124000,0,0
TIKI,giay-dep-nu,42643992,"Máy sấy giày khử mùi Lớn Chuyên dụng UV",1590000,1590000,0,0
TIKI,giay-dep-nu,50743767,"[HÌNH ẢNH THẬT] Giày đế xuồng nữ Trường Hải 3cm trơn đen da bò cao cấp mềm mại không bong tróc đế cao chống mòn không trơn DX0845",215000,299000,84000,28
TIKI,giay-dep-nu,192803896,"OLV - Dép Cream Casual Slipper",350000,350000,0,0
TIKI,giay-dep-nu,172972756,"Dép Đế Xuồng Nữ Da Bò Thật BIGGBEN Cao 5cm DX38",309000,400000,91000,23
TIKI,giay-dep-nu,36800101,"Giày Búp Bê Nữ Đế Bệt Nhựa Dẻo Êm Ái G01",59000,59000,0,0
TIKI,giay-dep-nu,14527186,"Bộ 02 cặp gồm 04 miếng lót gót giày silicon chống trầy bảo vệ gót chân",13999,13999,0,0
TIKI,giay-dep-nu,129942527,"Giày sneaker Vans UA Old Skool Mix & Match - VN0A4U3B2PD",1750000,1750000,0,0
TIKI,giay-dep-nu,205943587,"Giày cao gót nữ 8p RO466 ROSATA tại BCASHOP bít mũi, hở gót, gót trụ cùng màu thân - màu đen",489000,489000,0,0
TIKI,giay-dep-nu,76065255,"Giày cao gót nữ kiểu Pháp gót 7cm nhọn Y17",269000,269000,0,0
TIKI,dong-ho-va-trang-suc,2762225,"Đồng hồ Nam thể thao SKMEI 1228 - DHA518",165000,165000,0,0
TIKI,dong-ho-va-trang-suc,19842390,"Dây chuyền mặt Phật Độ Mệnh đủ các tuổi nam nữ V38",62000,62000,0,0
TIKI,dong-ho-va-trang-suc,139478724,"Bộ 2 viên Pin cúc áo AG4 LR626 377A 1.55V (Trong vỉ)",8000,14950,6950,46
TIKI,dong-ho-va-trang-suc,77155440,"Vòng tay mã não đỏ 10 ly, vòng tay phong thủy đá thạch anh",126000,126000,0,0
TIKI,dong-ho-va-trang-suc,90719200,"Lắc tay nam inox kiểu lặc cá tính thép không gỉ 9mm",29000,29000,0,0
TIKI,dong-ho-va-trang-suc,122574988,"Vòng tay pha lê đẹp màu sắc thời trang cho nữ VTPL0008",68400,68400,0,0
TIKI,dong-ho-va-trang-suc,155089694,"Dây chuyền Thiên Tâm đế sen hồng may mắn (vàng) WDC099V",318000,318000,0,0
TIKI,dong-ho-va-trang-suc,132701877,"[5 cái] Con đỉa dây đồng hồ - Phụ kiện dây đồng hồ silicone",65000,65000,0,0
TIKI,dong-ho-va-trang-suc,184614624,"Mặt dây chuyền ngọc bội như ý phong thủy đá ngọc phỉ thúy",290000,290000,0,0
TIKI,dong-ho-va-trang-suc,10933528,"Vòng cổ choker tattoo V45",16000,16000,0,0
TIKI,dong-ho-va-trang-suc,90720669,"Lắc tay nam inox nam cá tính thép không đen, không gỉ - QuynhChi 79",30000,30000,0,0
TIKI,dong-ho-va-trang-suc,102142363,"Bông tai nụ bạc Ý mặt tim MS03d",52000,52000,0,0
TIKI,dong-ho-va-trang-suc,35919858,"(BẠC THẬT 100%) Dây chuyền bạc nữ mặt hồ Ly - Trang sức bạc PANMILA - Dây + Mặt Hồ Ly 1",163000,163000,0,0
TIKI,dong-ho-va-trang-suc,23286510,"Vòng Tay - Vòng Đeo Tay Da SAM Leather SAMVDT001",149000,149000,0,0
TIKI,dong-ho-va-trang-suc,21197167,"Bông tai ngọc  dài ngôi sao BHBT83",35000,61000,26000,43
TIKI,dong-ho-va-trang-suc,99427357,"Combo 5 dây chuyền đeo cổ vải dù ( giao màu ngẫu nhiên) -  T027",82800,82800,0,0
TIKI,dong-ho-va-trang-suc,105185109,"Dây đồng hồ da bò cực mềm size 18mm 19mm 20mm 22mm chịu nước và đàn hồi tốt - M02",110000,110000,0,0
TIKI,dong-ho-va-trang-suc,11097922,"Mặt dây chuyền thánh giá MDC322 (Màu Đen)",180000,180000,0,0
TIKI,dong-ho-va-trang-suc,57441676,"Đồng hồ nữ chính hãng Lobinni No.2060-3",4450000,7071429,2621429,37
TIKI,dong-ho-va-trang-suc,58917457,"Combo bộ trang sức cưới mạ 24k cao cấp H0202",329000,329000,0,0
TIKI,dong-ho-va-trang-suc,196207484,"Dây đồng hồ cao su Sikai Sports 20mm và 22mm cao cấp chống thấm nước",179000,179000,0,0
TIKI,dong-ho-va-trang-suc,129619655,"Hoa tai bạc nữ, bông tai nữ bạc 925 chữ V đính đá AAA mạ vàng sáng bóng phong cách HQ.",49000,49000,0,0
TIKI,dong-ho-va-trang-suc,263805091,"Vòng tay 108 hạt gỗ đàn hương nâu 8 ly ( size XL ), chuỗi tràng 108 hạt niệm Phật, vòng chuỗi đeo tay",200000,200000,0,0
TIKI,dong-ho-va-trang-suc,56869314,"Charm bạc chuồn chuồn gắn trụ treo  - Ngọc Quý Gemstones",138000,138000,0,0
TIKI,dong-ho-va-trang-suc,106390205,"Máy khử từ đồng hồ và vật dụng nhiễm từ",140000,140000,0,0
TIKI,dong-ho-va-trang-suc,59471580,"Đồng Hồ Nam Chống Nước MF0018G Dành Cho Doanh Nhân Tặng Kèm Nút Bảo Vệ Đầu Sạc Điện Thoại",549000,549000,0,0
TIKI,dong-ho-va-trang-suc,106390879,"GIÁ HỦY DIỆT Dây đồng hồ HUBLOT nữ cao su trắng case 34 size dây 13 - 19 - 18",150000,150000,0,0
TIKI,dong-ho-va-trang-suc,100462774,"BÔNG TAI NỮ BẠC TA - BÔNG TAI HỒ LY",65000,65000,0,0
TIKI,dong-ho-va-trang-suc,30034533,"Dây chuyền nữ mạ",125000,125000,0,0
TIKI,dong-ho-va-trang-suc,155788680,"Vòng Tay Trầm Hương Cao Cấp Hạt Tròn Đơn - Trầm Tốc Tự Nhiên - Vòng Tay Phong Thủy - Size Nam Nữ",389500,410000,20500,5
TIKI,dong-ho-va-trang-suc,14903396,"Mặt dây chuyền phật Văn Thù Bồ Tát màu vàng - Phật bản mệnh",69000,69000,0,0
TIKI,dong-ho-va-trang-suc,35454502,"Nhẫn Nam Khắc Kim Quang Chú Titan Không Đen TT 1426",99000,99000,0,0
TIKI,dong-ho-va-trang-suc,184096918,"Vòng tay nữ charm bạc phong thuỷ chất liệu bạc s925 MS236",400000,400000,0,0
TIKI,dong-ho-va-trang-suc,176073854,"Dây đồng hồ cao su Sikai 22mm cao cấp chống thấm nước",135000,135000,0,0
TIKI,dong-ho-va-trang-suc,129383697,"Bông tai nữ ngọc trai mạ màu cao cấp P1104",139000,139000,0,0
TIKI,may-anh,124411830,"[GIAO HN & HCM] - CÁ THÁC LÁC RÚT XƯƠNG VITOT FOOD (3- 4 con/kg)",283000,283000,0,0
TIKI,dong-ho-va-trang-suc,56027057,"Charm bạc hồ ly 9 đuôi xỏ ngang - Ngọc Quý Gemstones",67000,110000,43000,39
TIKI,dong-ho-va-trang-suc,176072237,"Dây da đồng hồ dành cho Samsung galaxy watch 3 41 / 45mm",200000,200000,0,0
TIKI,dong-ho-va-trang-suc,229696838,"Dây và Ốp TPU bảo vệ cho đồng hồ Xiaomi Miband 7 Pro",68000,68000,0,0
TIKI,phu-kien-thoi-trang,2762225,"Đồng hồ Nam thể thao SKMEI 1228 - DHA518",165000,165000,0,0
TIKI,phu-kien-thoi-trang,77155440,"Vòng tay mã não đỏ 10 ly, vòng tay phong thủy đá thạch anh",126000,126000,0,0
TIKI,dong-ho-va-trang-suc,58204009,"NHẪN ĐÁ CẨM THẠCH MÀU ĐỎ ĐẸP NI NHẪN 17MM HỢP MỆNH HỎA THỔ",280000,560000,280000,50
TIKI,phu-kien-thoi-trang,19842390,"Dây chuyền mặt Phật Độ Mệnh đủ các tuổi nam nữ V38",62000,62000,0,0
TIKI,phu-kien-thoi-trang,139478724,"Bộ 2 viên Pin cúc áo AG4 LR626 377A 1.55V (Trong vỉ)",8000,14950,6950,46
TIKI,dong-ho-va-trang-suc,101659993,"Bông tai trẻ em bạc ta MS05c",89000,89000,0,0
TIKI,phu-kien-thoi-trang,122574988,"Vòng tay pha lê đẹp màu sắc thời trang cho nữ VTPL0008",68400,68400,0,0
TIKI,phu-kien-thoi-trang,90719200,"Lắc tay nam inox kiểu lặc cá tính thép không gỉ 9mm",29000,29000,0,0
TIKI,may-anh,176256278,"Cánh gà khúc giữa nhập khẩu 500g [Chỉ giao hỏa tốc HN]",60000,60000,0,0
TIKI,may-anh,193881164,"Bún khô gạo lứt đỏ Cao Bằng - 0.5kg",35000,35000,0,0
TIKI,may-anh,114197783,"[Chỉ giao HN] - Cánh Gà Khúc Giữa Khay 1Kg Hút Chân Không",199000,199000,0,0
TIKI,may-anh,191292439,"Củ riềng",16000,16000,0,0
TIKI,may-anh,120800177,"[Chỉ giao HN] - Táo AM 90 -1kg",139000,139000,0,0
TIKI,may-anh,162386995,"[Chỉ giao HN] - Thịt trâu gác bếp Tây Bắc - 500gr ",380000,380000,0,0
TIKI,phu-kien-thoi-trang,155089694,"Dây chuyền Thiên Tâm đế sen hồng may mắn (vàng) WDC099V",318000,318000,0,0
TIKI,phu-kien-thoi-trang,57441676,"Đồng hồ nữ chính hãng Lobinni No.2060-3",4450000,7071429,2621429,37
TIKI,phu-kien-thoi-trang,105185109,"Dây đồng hồ da bò cực mềm size 18mm 19mm 20mm 22mm chịu nước và đàn hồi tốt - M02",110000,110000,0,0
TIKI,may-anh,142315240,"[Chỉ giao HN] Thanh Surimi hương vị cua đông lạnh Mayumi hộp 250g",84000,84000,0,0
TIKI,phu-kien-thoi-trang,30034533,"Dây chuyền nữ mạ",125000,125000,0,0
TIKI,phu-kien-thoi-trang,132701877,"[5 cái] Con đỉa dây đồng hồ - Phụ kiện dây đồng hồ silicone",65000,65000,0,0
TIKI,may-anh,127578814,"(Chỉ giao HN) Mắm nêm pha sẵn đặc biệt - Chai 250ml",38000,38000,0,0
TIKI,may-anh,197528945,"Khay trái cây mix - KF01",810000,810000,0,0
TIKI,phu-kien-thoi-trang,35454502,"Nhẫn Nam Khắc Kim Quang Chú Titan Không Đen TT 1426",99000,99000,0,0
TIKI,may-anh,126809014,"[ Chỉ giao HN] - Củ dền 1kg",45000,45000,0,0
TIKI,phu-kien-thoi-trang,11097922,"Mặt dây chuyền thánh giá MDC322 (Màu Đen)",180000,180000,0,0
TIKI,phu-kien-thoi-trang,184096918,"Vòng tay nữ charm bạc phong thuỷ chất liệu bạc s925 MS236",400000,400000,0,0
TIKI,phu-kien-thoi-trang,196207484,"Dây đồng hồ cao su Sikai Sports 20mm và 22mm cao cấp chống thấm nước",179000,179000,0,0
TIKI,phu-kien-thoi-trang,90720669,"Lắc tay nam inox nam cá tính thép không đen, không gỉ - QuynhChi 79",30000,30000,0,0
TIKI,may-anh,126962611,"[ Chỉ giao HN] - Củ dền 1kg",45000,45000,0,0
TIKI,phu-kien-thoi-trang,56869314,"Charm bạc chuồn chuồn gắn trụ treo  - Ngọc Quý Gemstones",138000,138000,0,0
TIKI,phu-kien-thoi-trang,129383697,"Bông tai nữ ngọc trai mạ màu cao cấp P1104",139000,139000,0,0
TIKI,phu-kien-thoi-trang,184614624,"Mặt dây chuyền ngọc bội như ý phong thủy đá ngọc phỉ thúy",290000,290000,0,0
TIKI,may-anh,121743877,"Bánh Nướng Nhân Trà Xanh - Vỏ Truyền Thống - Không Trứng Muối",45000,45000,0,0
TIKI,may-anh,149118483,"Táo Envy Mỹ size 70",199000,199000,0,0
TIKI,may-anh,184634212,"3G-Vịt om sấu",127000,127000,0,0
TIKI,may-anh,195658367,"Cánh Gà - 1Kg",60000,60000,0,0
TIKI,may-anh,169074962,"[Combo 10 lọ] Nước yến sào Khánh Hòa Sanest dành cho người cao tuổi đóng lọ 70ml",335000,335000,0,0
TIKI,phu-kien-thoi-trang,14903396,"Mặt dây chuyền phật Văn Thù Bồ Tát màu vàng - Phật bản mệnh",69000,69000,0,0
TIKI,may-anh,181918013,"GẠO BẮC HƯƠNG NHÃN FAS LOẠI 5KG",100000,100000,0,0
TIKI,may-anh,180322231,"Nước Mắm Tĩn Nhãn Đỏ cá cơm than Mini 40N 60ml/chai Rin Nguyên Chất Truyền Thống",35000,35000,0,0
TIKI,phu-kien-thoi-trang,99427357,"Combo 5 dây chuyền đeo cổ vải dù ( giao màu ngẫu nhiên) -  T027",82800,82800,0,0
TIKI,phu-kien-thoi-trang,21197167,"Bông tai ngọc  dài ngôi sao BHBT83",35000,61000,26000,43
TIKI,phu-kien-thoi-trang,106390879,"GIÁ HỦY DIỆT Dây đồng hồ HUBLOT nữ cao su trắng case 34 size dây 13 - 19 - 18",150000,150000,0,0
TIKI,may-anh,191292334,"Củ gừng",25000,25000,0,0
TIKI,may-anh,149798306,"Sữa chua ít đường - Vỉ 4 hộp",28000,28000,0,0
TIKI,may-anh,187580210,"Đặc Sản Nha Trang - Mực Tẩm Gia Vị Nha Trang  Size Đại Gói 500G",785000,790000,5000,1
TIKI,phu-kien-thoi-trang,129619655,"Hoa tai bạc nữ, bông tai nữ bạc 925 chữ V đính đá AAA mạ vàng sáng bóng phong cách HQ.",49000,49000,0,0
TIKI,may-anh,115902844,"[CHỈ GIAO HN] - CÁ HỐ TƯƠI CẮT KHÚC VITOT FOOD (500g/khay)",125000,125000,0,0
TIKI,phu-kien-thoi-trang,58917457,"Combo bộ trang sức cưới mạ 24k cao cấp H0202",329000,329000,0,0
TIKI,may-anh,186578437,"Bò viên chiên Đôi Đũa Vàng 150g viên thả lẩu đậm đà từ thịt bò sạch",119000,119000,0,0
TIKI,may-anh,160557854,"[ Chỉ giao HN] - Ngũ cốc dinh dưỡng Granola 500gr - Vị Cacao",270000,270000,0,0
TIKI,phu-kien-thoi-trang,155788680,"Vòng Tay Trầm Hương Cao Cấp Hạt Tròn Đơn - Trầm Tốc Tự Nhiên - Vòng Tay Phong Thủy - Size Nam Nữ",389500,410000,20500,5
TIKI,phu-kien-thoi-trang,56027057,"Charm bạc hồ ly 9 đuôi xỏ ngang - Ngọc Quý Gemstones",67000,110000,43000,39
TIKI,may-anh,128480130,"GIỎ QUÀ TẶNG CHÂN THÀNH",800000,800000,0,0
TIKI,phu-kien-thoi-trang,58204009,"NHẪN ĐÁ CẨM THẠCH MÀU ĐỎ ĐẸP NI NHẪN 17MM HỢP MỆNH HỎA THỔ",280000,560000,280000,50
TIKI,phu-kien-thoi-trang,263805091,"Vòng tay 108 hạt gỗ đàn hương nâu 8 ly ( size XL ), chuỗi tràng 108 hạt niệm Phật, vòng chuỗi đeo tay",200000,200000,0,0
TIKI,may-anh,188964510,"Đậu Hà Lan tươi sạch Đôi Đũa Vàng dinh dưỡng gói 400g",105000,105000,0,0
TIKI,phu-kien-thoi-trang,106390205,"Máy khử từ đồng hồ và vật dụng nhiễm từ",140000,140000,0,0
TIKI,phu-kien-thoi-trang,10933528,"Vòng cổ choker tattoo V45",16000,16000,0,0
TIKI,may-anh,155495743,"[Chỉ giao HN]Cần Tây ĐL -1kg",48000,48000,0,0
TIKI,may-anh,190842073,"Cà tím dài",13000,13000,0,0
TIKI,phu-kien-thoi-trang,176073854,"Dây đồng hồ cao su Sikai 22mm cao cấp chống thấm nước",135000,135000,0,0
TIKI,phu-kien-thoi-trang,229696838,"Dây và Ốp TPU bảo vệ cho đồng hồ Xiaomi Miband 7 Pro",68000,68000,0,0
TIKI,may-anh,128645765,"GIỎ PHÂN ƯU G-003",2700000,2700000,0,0
TIKI,may-anh,196031615,"Gầu bò Canada",115000,115000,0,0
TIKI,phu-kien-thoi-trang,101659993,"Bông tai trẻ em bạc ta MS05c",89000,89000,0,0
TIKI,phu-kien-thoi-trang,100462774,"BÔNG TAI NỮ BẠC TA - BÔNG TAI HỒ LY",65000,65000,0,0
TIKI,phu-kien-thoi-trang,102142363,"Bông tai nụ bạc Ý mặt tim MS03d",52000,52000,0,0
TIKI,phu-kien-thoi-trang,35919858,"(BẠC THẬT 100%) Dây chuyền bạc nữ mặt hồ Ly - Trang sức bạc PANMILA - Dây + Mặt Hồ Ly 1",163000,163000,0,0
TIKI,phu-kien-thoi-trang,59471580,"Đồng Hồ Nam Chống Nước MF0018G Dành Cho Doanh Nhân Tặng Kèm Nút Bảo Vệ Đầu Sạc Điện Thoại",549000,549000,0,0
TIKI,phu-kien-thoi-trang,23286510,"Vòng Tay - Vòng Đeo Tay Da SAM Leather SAMVDT001",149000,149000,0,0
TIKI,may-anh,115802075,"[CHỈ GIAO HN] - CHẢ TÔM VITOT FOOD (500g/ khay)",219000,219000,0,0
TIKI,may-anh,179728667,"Nem rán gia đình nhân thịt bò Đôi Đũa Vàng thơm ngọt giòn rụm gói 480g ",138000,138000,0,0
TIKI,may-anh,193881183,"Gạo lứt đen tím than Sóc Trăng  - 1kg",45000,45000,0,0
TIKI,may-anh,172025027,"[ Chỉ giao HN] -Dâu tây - 330gr",350000,350000,0,0
TIKI,phu-kien-thoi-trang,176072237,"Dây da đồng hồ dành cho Samsung galaxy watch 3 41 / 45mm",200000,200000,0,0
TIKI,may-anh,144803401,"[ Chỉ giao HN] - Chân gà đông tảo loại 1 -1kg (7-8 cái/kg)",750000,750000,0,0
TIKI,may-anh,184634207,"3G-Khổ qua nhồi thịt 300g",35000,35000,0,0
TIKI,may-anh,193881193,"Bánh canh gạo lứt - 1kg",130000,130000,0,0
TIKI,may-anh,193159759,"[Chỉ giao HN] - Duôi heo Cộc - Túi 1kg",114000,114000,0,0
TIKI,may-anh,116553118,"[Chỉ giao HN] - Cá Nục 1 Nắng - 1Kg 2 Khay",239000,239000,0,0
TIKI,giay-dep-nu,125099352,"Giày lười nữ Anh Khoa A662 - Đen nam (A662-1),43 (đế vằn cho nam)",290000,290000,0,0
TIKI,giay-dep-nu,178339958,"Dép chiếu cói quai gấm - ND014",45000,45000,0,0
TIKI,giay-dep-nu,20495948,"Dép cao su êm chân quai nhũ chịu nước đi mưa đi biển kiểu dáng thời trang mẫu HOT DN01",69000,69000,0,0
TIKI,giay-dep-nu,242064655,"Dép quai ngang nữ Skechers Foamies - 111511-FUS",690000,690000,0,0
TIKI,giay-dep-nu,143858842,"Giày Cao Gót (DA THẬT) Da Mềm Như Bún Công Sở Văn Phòng Nữ Vạt Xiên FFAN STORE",399000,399000,0,0
TIKI,giay-dep-nu,92688120,"Giày Búp Bê Đế Xuồng Mũi Nhọn M201 G̳I̳Á̳ ̳X̳Ư̳Ở̳N̳G̳   Da Bò Thật ÊM CHÂN",199000,199000,0,0
TIKI,giay-dep-nu,51413591,"Giày thể thao nữ cổ cao CV Cúc Họa Mi thời trang V231",99000,99000,0,0
TIKI,giay-dep-nu,111232450,"Giày thể thao ulzzang sneaker canvas nữ. Phong cách HongKong 1970 siêu cá tính LAH STORES GCCNU02",110000,110000,0,0
TIKI,giay-dep-nu,59397420,"Giày thể thao nữ phong cách thời trang trẻ trung năng động",185000,359000,174000,48
TIKI,giay-dep-nu,43543659,"Giầy thể thao nữ, giày sneaker nữ buộc dây V202",54000,54000,0,0
TIKI,giay-dep-nu,182134376,"Giày nữ cao cấp ELLY – EGM170",649500,1299000,649500,50
TIKI,giay-dep-nu,125099243,"Giày Lười Nữ Anh Khoa A83-3",170000,170000,0,0
TIKI,giay-dep-nu,32689468,"Dụng Cụ Hỗ Trợ Mang Giày Tây Inox Đẹp Japan Tặng Cafe MeetMore",71500,71500,0,0
TIKI,giay-dep-nu,177518483,"Dép Nữ Quai Ngang Đế Xuồng HÀ NAM Da Bò Thời Trang Cao Cấp 7cm DNU2124",400000,400000,0,0
TIKI,giay-dep-nu,128935265,"Giày sandal đế bệt bít mũi hở gót phối nỉ đen thời thượng Enako TP13505",325000,325000,0,0
TIKI,giay-dep-nu,262804126,"Giầy cao gót nữ Enako Tp13677 - slingback mũi vuông nhỏ gót mảnh cao 7cm",390000,390000,0,0
TIKI,giay-dep-nu,114291366,"Giày sục thể thao, giày nữ phong cách trẻ đi 4 mùa",318000,318000,0,0
TIKI,giay-dep-nu,125778921,"Dép bánh mì hai lớp siêu nhẹ nam",49000,49000,0,0
TIKI,giay-dep-nu,71049024,"Giầy nhựa Vintage hoa hồng chịu nước dễ thương GN25",75000,75000,0,0
TIKI,giay-dep-nu,36986846,"Dép đi trong nhà hình gấu hồng",59900,59900,0,0
TIKI,giay-dep-nu,7986108,"Dép Xỏ Ngón Nữ BIGGBEN Da Bò Thật DXN03",289000,350000,61000,17
TIKI,giay-dep-nu,145219165,"Dép đi trong nhà tắm văn phòng thỏ cute nhựa dẻo chống trơn trượt, nhanh khô DN-3256",55000,55000,0,0
TIKI,giay-dep-nu,193993565,"GIÀY CAO GÓT ECCO NỮ SCULPTURED 45 PUMP 23020301434",990000,3990000,3000000,75
TIKI,giay-dep-nu,71049603,"Giầy nhựa hoa hồng hở gót thoáng chân chịu nước Vintage dễ thương GN24",75000,75000,0,0
TIKI,giay-dep-nu,171197017,"Giày cao gót 11cm trắng",230000,230000,0,0
TIKI,giay-dep-nu,125098721,"Giày Lười Nữ Anh Khoa A923-7",199000,199000,0,0
TIKI,may-anh,194140881,"Thẻ nhớ SDXC SanDisk Extreme Pro SDSDXXD-512G U3 V30 512GB 200MB/s New 2022 - Hàng Nhập Khẩu",2050000,2050000,0,0
TIKI,may-anh,4755383,"Cap Bấm Hình Cartoon (Size 40.5) - Hàng Nhập Khẩu (Giao Màu Ngẫu Nhiên)",69000,69000,0,0
TIKI,may-anh,176694691,"Thẻ nhớ 32GB/64GB MIXIE Hàng chính hãng",79000,79000,0,0
TIKI,giay-dep-nu,195232899,"Giày Thể Thao Nữ Thông Hơi Thoáng Khí Êm Chân,Giày Nữ Cao Cấp Phiên Bản Hàn Quốc Trẻ Trung Năng Động GTTN27",189000,189000,0,0
TIKI,giay-dep-nu,124273633,"Dép Nhựa Hình 3 Sọc Ngang Mang Trong Nhà",74000,79000,5000,6
TIKI,may-anh,7464485,"Loa che nắng hood ET-65III ống kính Canon EF 85mm f1.8 USM ",67000,67000,0,0
TIKI,giay-dep-nu,179881213,"Dép Nữ Quai Ngang Đế Xuồng HÀ NAM Thời Trang Da Bò Cao Cấp 9cm DNU2077c",420000,420000,0,0
TIKI,may-anh,198425914,"Camera thông minh Aqara G2H pro AI Full HD 1080p - Bản Quốc Tế - Hàng Chính Hãng",1320000,1320000,0,0
TIKI,giay-dep-nu,48995605,"Dép lỗ VIP đi trong nhà, nhà tắm xanh",25000,25000,0,0
TIKI,may-anh,6921779,"Micro thu âm đa năng Boya BY-MM1 - Hàng nhập khẩu",430000,430000,0,0
TIKI,phu-kien-thoi-trang,77715163,"MẶT KHÓA THẮT LƯNG NAM KHÓA TÌ TRƯỢT TỰ ĐỘNG CHO DÂY RỘNG 3,5 CM (KO KÈM DÂY)",115000,115000,0,0
TIKI,may-anh,107047614,"Camera IP Wifi VNPT Technology ONE HOME HVIP01 xoay 360 quan sát rõ ngày và đêm kèm thẻ nhớ hàng Việt Nam",840000,840000,0,0
TIKI,may-anh,143809133,"Camera nội soi 7mm dùng cho điện thoại Android",289350,289350,0,0
TIKI,may-anh,88482985,"Camera Wifi - Camera Ip Trong Nhà EZVIZ C6N 1080P - Đàm Thoại 2 Chiều - Xoay 360 Độ Theo Chuyển Động - Hàng nhập khẩu",383900,383900,0,0
TIKI,giay-dep-nu,191315968,"Giày thể thao kiểu dáng Hàn Quốc cho nữ Hamishu-H479",162000,290000,128000,44
TIKI,may-anh,91189681,"Đầu đọc thẻ USB 3.0 Card Reader Hỗ trợ thẻ TF và SD UGREEN 20203- Hàng chính hãng",220000,250000,30000,12
TIKI,giay-dep-nu,61278542,"Giày thể thao nữ hoa cúc đi bộ cực êm siêu xinh V253 - Đỏ đô - Size 38",55000,55000,0,0
TIKI,giay-dep-nu,171202354,"Dép kẹp nữ Giavy quai nhỏ thắt bím",170000,170000,0,0
TIKI,phu-kien-thoi-trang,89480888,"Mắt kính V nam nữ Hàn Quốc đen sang trọng ",68000,80000,12000,15
TIKI,may-anh,56682381,"Trọn Bộ 4 Camera IP PoE Hikvision 2.0MP Tầm Xa Hồng Ngoại 30M Chức Năng Cấp Nguồn Qua Mạng PoE - Hàng Chính Hãng",11954000,11954000,0,0
TIKI,phu-kien-thoi-trang,83675838,"Kính Mắt Chống Tia UV Từ Điện Thoại, Máy Tính, Chống Mỏi Mắt Nhiều Màu Thoải Mái Lựa Chọn - Kính Thời Trang",1600000,1600000,0,0
TIKI,may-anh,59381719,"dây đeo máy ảnh thao tác nhanh Quick Release XJ",280000,280000,0,0
TIKI,phu-kien-thoi-trang,163170195,"Set 5 đôi tất nữ đi giày lười, tất vớ nữ đi giày búp bê họa tiết trái tim - LUOITRAITIM-CB5",70000,99000,29000,29
TIKI,may-anh,129249761,"Camera hành trình cao cấp Navicom J247 Pro - Hàng chính hãng",4990000,4990000,0,0
TIKI,may-anh,197154629,"Camera ngoài trời eufy Outdoor Cam Pro 2K E220 chống nước IP67 có đèn chiếu đêm - Hàng Chính Hãng",1650000,1790000,140000,8
TIKI,phu-kien-thoi-trang,145243704,"Băng đô cài tóc, Cài lượn sóng bản nhỏ nhiều màu xinh xắn - Culi accessories",20900,20900,0,0
TIKI,phu-kien-thoi-trang,15387324,"Sét 40 dây buộc tóc tròn cao cấp xuất Nhật HD12 hộp giấy sang trọng",85000,85000,0,0
TIKI,giay-dep-nu,98083512,"Sục Nữ Cao Gót 7Phân chất vải mẫu mới Lạ Mắt 699",200000,200000,0,0
TIKI,may-anh,57641967,"Camera IP WIFI trong nhà YooSee 2.0 ( 3 anten, 11 led HD) + Thẻ nhớ 32G -  Hàng Nhấp Khẩu",350000,350000,0,0
TIKI,phu-kien-thoi-trang,26389419,"Hình Xăm Dán Cá Chép QSA046",45000,45000,0,0
TIKI,phu-kien-thoi-trang,74636624,"Gọng kính, mắt kính SARIFA 3505 (53-19-145) chính hãng, nhiều màu lựa chọn",199000,520000,321000,62
TIKI,may-anh,105652903,"Chân máy ảnh dòng FSL09, Hàng chính hãng",1649999,1649999,0,0
TIKI,phu-kien-thoi-trang,87960116,"Nón lưỡi trai in logo UAG - Hàng Chính Hãng",150000,150000,0,0
TIKI,may-anh,34575579,"Máy Ảnh Mini Chụp Hình Cho Bé Loại Cao Cấp 2019",495000,495000,0,0
TIKI,may-anh,181747823,"Camera WI-FI EZVIZ C3TN 2MP, Ngoài Trời, Không/Có Màu Ban Đêm, IP67 Chống Nước--Hàng Chính Hãng",709000,709000,0,0
TIKI,phu-kien-thoi-trang,48933940,"Quần tất da chân Hàn Quốc",30300,30300,0,0
TIKI,phu-kien-thoi-trang,183290600,"[Combo 5 Đôi] Vớ lười Nam Mẫu Sọc Ngang Cotton Cao Cấp, Tất Nam Đi Giày Lười có đệm sao su chống tuột gót - TATLUOI-SOCNGANG",99000,180000,81000,45
TIKI,phu-kien-thoi-trang,170724294,"Khăn Mùi Xoa, Khăn Tay Nam (L3)",55000,55000,0,0
TIKI,may-anh,114973774," Ống nhòm viễn vọng chống nước Barska 20-60x80 WP Level  (màu đen) - Hàng chính hãng",15125000,15125000,0,0
TIKI,phu-kien-thoi-trang,217499890,"Khăn cột tóc turban lụa ,Ruy băng quấn túi xách quàng cổ phụ kiện dễ thương cho nữ đẹp phong cách Hàn Quốc",9000,9000,0,0
TIKI,phu-kien-thoi-trang,101465247,"Kính lão inox gọng xếp màu xám - Mắt kính lão thị phù hợp cho nam và nữ",314000,314000,0,0
TIKI,may-anh,51699597,"NGÀM CHUYỂN AF VILTROX CANON EF-FX2 (0.71X) FOR FUJIFILM Hàng Nhập Khẩu",3999000,3999000,0,0
TIKI,may-anh,9975567,"Camera HD-TVI Trụ Hồng Ngoại 5MP HIKVISION DS-2CE16H0T-ITPF - Hàng chính hãng",728000,728000,0,0
TIKI,may-anh,108968206,"Combo pin sạc Kingma cho Panasonic DMW-BLC12, Hàng chính hãng",199999,199999,0,0
TIKI,phu-kien-thoi-trang,173864902,"Khẩu Trang Vải 4D Nemo Collection, Chống Nắng, Lọc Khuẩn, Thoáng Khí Không Gây Mụn, Nam Nữ đều sử dụng được - KTMHG",35750,55000,19250,35
TIKI,may-anh,46822268,"Bộ Camera Hành Trình Trước Và Sau U5 Dùng Cho Ô Tô, Xe Hơi Sử Dụng Màn Hình DVD Android",1245000,1245000,0,0
TIKI,phu-kien-thoi-trang,5476547,"Set Tất 7 Ngày Cho Nữ (Kèm Túi)",74000,74000,0,0
TIKI,phu-kien-thoi-trang,97433431,"Tất Vớ Nữ Trơn Cổ Ngắn 100% Cotton Aaa Jeans",29000,29000,0,0
TIKI,may-anh,171124803,"Trọn Bộ 10 Camera Đầy Đủ Phụ Kiện Hikvision 2.0MP Full HD - Hàng chính hãng",10300000,10300000,0,0
TIKI,may-anh,825520,"Ống Kính Yongnuo YN AF-S 50mm F/1.8 Cho Nikon - Hàng nhập khẩu",1990000,1990000,0,0
TIKI,phu-kien-thoi-trang,73123648,"Trâm Cài Áo Pin Cổ Áo Tay Áo Cardigan Mini Nhẹ Nhàng Sang Trọng Unisex Món Quà Nhỏ Đầy Ý Nghĩa Phong Cách Hàn Quốc (Tặng Kèm Hộp Quà Tặng Màu Đen)",118000,118000,0,0
TIKI,phu-kien-thoi-trang,81640112,"Bộ Nhiều Mẫu anime, xăm 3D Hình Xăm Dán, Hình Xăm henna Tattoo Cao Cấp",4900,4900,0,0
TIKI,giay-dep-nu,155503390,"Giày thể thao thời trang nữ thiết kế  dệt kim mềm nhẹ mã  J11",229500,459000,229500,50
TIKI,phu-kien-thoi-trang,90099141,"Thắt lưng CA",140000,280000,140000,50
TIKI,may-anh,88861632,"Chân máy ảnh MANFROTTO 190XPRO ALU 3-Section - Chính hãng",4899999,4899999,0,0
TIKI,may-anh,173479725,"Balo máy ảnh Lowepro Flipside 400 AW III, Hàng chính hãng",3649999,3649999,0,0
TIKI,may-anh,192678522,"Khăn lau đa năng dùng cho lau màn hình điện thoại / máy tính bảng / máy tính laptop / ống kính lens máy ảnh / khăn lau kính mắt - Handtown - Hàng Chính Hãng",89000,89000,0,0
TIKI,may-anh,208129810,"Túi chống sốc máy ảnh và lens vải bố canvas cao cấp",180000,180000,0,0
TIKI,may-anh,6911647,"Dây Đeo Máy Ảnh Peak Design Slide Lite (Black) - Hàng Chính Hãng",1699999,1699999,0,0
TIKI,giay-dep-nu,59169733,"Dép Nữ Da Bò BIGGBEN Cao Cấp DNQN30",279000,400000,121000,30
TIKI,giay-dep-nu,129352191,"Giày Sandals Vento Nam Quai Ngang dạo phố đi chơi đi học du lịch NB57",345000,345000,0,0
TIKI,may-anh,204643382,"Khung L Plate thanh bảo vệ máy ảnh dành cho Sony A7II A7R2 A7S2",299000,299000,0,0
TIKI,phu-kien-thoi-trang,72566161,"Nón bucket mặt cười Unisex siêu dễ thương, mang phong cách vui vẻ mới - Hạnh Dương",45000,45000,0,0
TIKI,phu-kien-thoi-trang,133246090,"Nón đầu bếp Nam Nữ Cao Cấp",27500,27500,0,0
TIKI,phu-kien-thoi-trang,25917232,"Kính Mát Nữ Gọng Đen Sành Điệu",149000,149000,0,0
TIKI,giay-dep-nu,72797214,"Dép Bông Đi Trong Nhà Đế Cao Su Chống Trơn Trượt NineRed D29",89000,89000,0,0
TIKI,may-anh,149509501,"Camera an ninh wifi 2 râu (Sóng khỏe Hình nét)",499000,499000,0,0
TIKI,phu-kien-thoi-trang,139449939,"Thắt lưng Nam Tushi vải dù_khóa tự động tiện lợi, siêu bền_Thắt lưng lính_vải bố_cao cấp",139000,139000,0,0
TIKI,may-anh,74347298,"Camera Ip Wifi Imou F22FP Hình Ảnh Đầy Màu Sắc Ngay Cả Vào Ban Đêm Full HD 1080P Bullet 2E Tặng Kèm Dây Nối Nguồn 20M - Hàng Chính Hãng",885000,885000,0,0
TIKI,may-anh,108968436,"Pin Kingma cho Panasonic DMW-BLC12, Hàng chính hãng",399999,399999,0,0
TIKI,may-anh,22365770,"Thẻ nhớ JVJ Micro SDHC Pro 32G C10 – thẻ nhớ chuyên dụng cho camera - Hàng chính hãng",180000,180000,0,0
TIKI,phu-kien-thoi-trang,243806022,"Cặp tóc mái mỏ vịt phong cách Hàn Quốc xinh xắn thời trang",8000,8000,0,0
TIKI,may-anh,191509288,"Pin Flycam ZLRC SG108 Pro - Phụ kiện hỗ trợ tăng thêm thời gian bay - Hàng nhập khẩu",450000,500000,50000,10
TIKI,phu-kien-thoi-trang,146585779,"Kẹp tóc sau - kẹp tóc hoa hồng camellia đính đá dạng dài",49000,49000,0,0
TIKI,may-anh,2547051,"Bộ Ống Nối Tăng Độ Phóng Đại Cho Máy Canon (Đen)",159000,159000,0,0
TIKI,phu-kien-thoi-trang,77038949,"Set 10 đôi tất da chân cho nữ tiện dụng",28990,28990,0,0
TIKI,phu-kien-thoi-trang,91831301,"Kính lão thị viễn thị giả bút cài màu Đen cực tiện lợi",99000,99000,0,0
TIKI,phu-kien-thoi-trang,64629151,"Dây buộc tóc - Scrunchies hoa thêu mẫu mới hàng đẹp HD63",19000,19000,0,0
TIKI,may-anh,6903641,"Kính lọc Benro Master ND256 (8-Stops) hệ 100mm- Hàng Chính Hãng",1599999,1599999,0,0
TIKI,phu-kien-thoi-trang,164947295,"Bờm vải 1 màu bản to phong cách Hàn Quốc",25000,25000,0,0
TIKI,phu-kien-thoi-trang,102889000,"Tóc giả búi tròn mini dạng kẹp, búi kẹp tròn tóc giả B05 Sỉ 30k",45000,45000,0,0
TIKI,phu-kien-thoi-trang,92156856,"Khăn Lụa Vuông Lụa Satin Quàng Cổ Quấn Tóc Quấn Túi Xách Làm Áo Yếm Lụa- 90x90cm - Mã KL060",75000,75000,0,0
TIKI,may-anh,184876859,"Camera Wifi Yoosee 3 râu 11 led - Xoay 360 độ, cảnh báo chống trộm - Hàng chính hãng",299000,299000,0,0
TIKI,phu-kien-thoi-trang,181694721,"Băng đô cài tóc độc lạ: Con cá, cà rốt,tai thỏ. Phụ kiện tóc ở nhà cho bạn",25000,25000,0,0
TIKI,giay-dep-nu,86882426,"( HÀNG SẴN) Giày Sục Đế Xuồng Tăng Chiều Cao Êm Chân Thoáng Khí AG79 - Hàng Quảng Châu Cao Cấp",365000,365000,0,0
TIKI,may-anh,9804983,"Camera Hành Trình Sjcam SJ8 Pro 4K Wifi - Hàng Chính Hãng",3739000,3939000,200000,5
TIKI,phu-kien-thoi-trang,196910669,"[T2] Tất vớ cổ cao nữ trơn lót lông cực ấm",29000,29000,0,0
TIKI,phu-kien-thoi-trang,159486418,"Vớ Tất Len Nam Nữ Cổ Cao Retro Họa Tiết Thổ Cẩm Phong Cách Vintage Thời Trang Thu Đông - Mã TV024",25000,25000,0,0
TIKI,phu-kien-thoi-trang,178031106,"Cà Vạt len trơn Nam Cao Cấp Sang Trọng Nam Tính- Caravat knit tie cá tính bản 6cm",125000,135000,10000,7
TIKI,phu-kien-thoi-trang,197571874,"Kẹp Tóc Đính Đá Và Ngọc Trai Thời Trang Phong Cách Hàn Quốc",55000,55000,0,0
TIKI,giay-dep-nu,201798576,"Giày nữ cao gót hở mũi nhọn ChristinA-Q HMN028",699000,699000,0,0
TIKI,phu-kien-thoi-trang,83616022,"Mũ len nam nữ trùm đầu liền khăn cổ lót nỉ ấm áp mùa đông chống gió lạnh - mu len nam nu lot ni trum co",115000,115000,0,0
TIKI,phu-kien-thoi-trang,186529124,"Kính lão gập gọng rút nhỏ gọn tiện lợi dễ dàng mang theo dành cho nam và nữ",49000,49000,0,0
TIKI,phu-kien-thoi-trang,157056967,"Kẹp tóc hình nơ phối lông tua rua xinh xắn phong cách Hàn Quốc hợp thời trang cho nữ",50000,50000,0,0
TIKI,ngon,126234053,"Thịt dẻ sườn trâu M123 - 1kg",140000,140000,0,0
TIKI,ngon,119465265,"[Chỉ giao HN] - Gà Muối Xông Khói",209000,209000,0,0
TIKI,ngon,155495725,"[Chỉ giao HN]Khoai Lang Sấy Đà Lạt- 500gr",60000,60000,0,0
TIKI,ngon,155495733,"[Chỉ giao HN]Gạo Séng Cù- 5kg",162000,162000,0,0
TIKI,ngon,183035925,"[Mã 8938511152012]Gạo Bắc Hương Vinafood1 3,5kg",92225,92225,0,0
TIKI,ngon,169077579,"[Combo 20 lọ] Nước Yến sào Sanvinest Khánh Hòa đóng lọ 70ml",663000,663000,0,0
TIKI,ngon,159728989,"[Chỉ giao HN] - Bắp Hoa Trâu -  1kg",172000,172000,0,0
TIKI,ngon,120129102,"[Chỉ giao HN] - Rong Biển Tươi Làm Salad Hàn Quốc - 1Kg",399000,399000,0,0
TIKI,ngon,155495680,"[Chỉ giao HN] Cà Chua Bi Đà Lạt- 1kg",75000,75000,0,0
TIKI,ngon,180322232,"Nước Mắm Nhỉ Làng Chài Xưa Xuất Khẩu Nhãn Xanh Chai Thủy Tinh 500ml Cốt Nhỉ Đặc Biệt Vị Dịu Nhẹ",120000,120000,0,0
TIKI,ngon,180322205,"Nước mắm tôm biển Làng Chài Xưa 525ml/chai Hồng Ngọc Đại Dương 300 năm truyền thống",90000,90000,0,0
TIKI,ngon,125796863,"[ Chỉ giao HN] -Cà tím 1kg",35000,35000,0,0
TIKI,ngon,191502065,"Xịt thơm quần áo hương trái cây chai 380ml - Hàng Nhật nội địa- 380ml",55000,55000,0,0
TIKI,ngon,120480662,"[Chỉ Giao Hà Nội] Sườn heo - 1kg",129000,129000,0,0
TIKI,ngon,112192277,"Iberico Tapas Mix 5 - 100g",310000,310000,0,0
TIKI,ngon,142120746,"[CHỈ GIAO HN] Dưa hấu Long An",65000,65000,0,0
TIKI,ngon,128124463,"Cá thu phấn cô tô file - gói 500gr",125000,125000,0,0
TIKI,ngon,195855598,"Dưa hấu",50000,50000,0,0
TIKI,ngon,142315245,"[Chỉ giao HN] Bơ nhạt Anchor New Zealand khối 5kg",1500000,1500000,0,0
TIKI,ngon,97691617,"[[Chỉ Giao HN]] - Súp gạch trứng tôm hùm",55000,55000,0,0
TIKI,ngon,126796320,"Chả cá đặc biệt Lan Làn - gói 500gr",130000,130000,0,0
TIKI,ngon,127388462,"[Chỉ giao HN] Set lẩu đôi ta",199000,199000,0,0
TIKI,ngon,162475486,"[Chỉ giao HN] - Nước lẩu nấm Ashima - 0.5kg",85000,85000,0,0
TIKI,ngon,162873949,"Sữa Bledilait Bledina Pháp - Hàng air chính hãng",240000,240000,0,0
TIKI,ngon,116553092,"[Chỉ giao HN] - Chả Ốc - 1Kg 2 Khay",300000,300000,0,0
TIKI,ngon,162475492,"[Chỉ giao HN] - Nước lẩu nấm Ashima - 1kg",140000,140000,0,0
TIKI,ngon,92380614,"Ba rọi Iberico cuộn (khay 300g)",142000,158000,16000,10
TIKI,ngon,121641695,"Cánh Gà Khúc Giữa - 1kg",125000,125000,0,0
TIKI,ngon,142315231,"[Chỉ giao HN] Cá trích vàng ép trứng Nhật Bản đông lạnh thanh 130g",211000,211000,0,0
TIKI,ngon,126794326,"[Chỉ giao HN] Sườn Cánh Buồm Heo - 1Kg",115000,115000,0,0
TIKI,ngon,125452823,"Mực 1 nắng Coto 2-3 con 1 kg hút chân không",279000,279000,0,0
TIKI,ngon,125796859,"[ Chỉ giao HN] -Tai chua khô 500g",75000,75000,0,0
TIKI,ngon,127509716,"[Chỉ giao HN] Sốt chấm thịt nướng 300gr",66000,66000,0,0
TIKI,ngon,171833840,"[ Chỉ giao HN] -Pate Chín Heo Yến mạch 450gr",40000,40000,0,0
TIKI,ngon,173381030,"Khăn tắm khô nhanh cho chó mèo (2 size - màu ngẫu nhiên) Khăn tắm siêu thấm nước cho thú cưng -  66x43cm không hộp",45555,45555,0,0
TIKI,ngon,120267612,"[Chỉ giao HN] - Muối Vừng Đặc Biệt - 1 Hũ",199000,199000,0,0
TIKI,ngon,173273845,"[Chỉ giao HN] - Cồi Sò Điệp - 500g",215000,215000,0,0
TIKI,ngon,172021752,"[ Chỉ giao HN]- Gạo Tám Gò Công Vinafood1 túi 3,5kg",130000,130000,0,0
TIKI,ngon,160219240,"Cá trứng Minh Tiến 400g",69000,69000,0,0
TIKI,ngon,155495686,"[Chỉ giao HN] Củ Dền - 1kg",44000,44000,0,0
TIKI,phu-kien-thoi-trang,197572113,"Kẹp Tóc Hình Hoa Đính Đá Bằng Kim Loại Cao Cấp",79000,79000,0,0
TIKI,phu-kien-thoi-trang,192363690,"Dây Đeo Khẩu Trang Chống Thất Lạc Cho Bé và Người Lớn Phong Cách Hàn Quốc Cute",25645,25645,0,0
TIKI,phu-kien-thoi-trang,73460070,"Kính Giả Cận Chống Ánh Sáng Xanh, Chống Mỏi Mắt, Gọng Kính Cận Nam Nữ Không Viền Đa Giác Không Độ Hàn Quốc - BLUE LIGHT SHOP",190000,190000,0,0
TIKI,phu-kien-thoi-trang,145289619,"Dây buộc tóc cột tóc vải nhiều màu dễ thương PK0003",9000,15000,6000,40
TIKI,phu-kien-thoi-trang,177726832,"Găng tay nam chống lạnh mùa đông cảm ứng điện thoại lót lông cực ấm thiết kế ôm tay GTN1",278000,278000,0,0
TIKI,phu-kien-thoi-trang,74744875,"Dây thắt lưng nam dây nịt nam da bò hàng cao cấp dùng cho khóa tự động kích thước 3.5cm (không đầu khóa)",140000,140000,0,0
TIKI,phu-kien-thoi-trang,136822512,"Khăn rằn Nam Bộ",51900,51900,0,0
TIKI,phu-kien-thoi-trang,91147160,"Găng Tay Bao Tay Ống Chống Nắng Cao Cấp RMIX Cho Nam Và Nữ Chất Liệu Polyester Chống Nắng, Tia UV, Sợi Vải Thoáng Khí - Hàng chính hãng BORO SPORT",108000,201000,93000,46
TIKI,phu-kien-thoi-trang,171043573,"Găng tay chống nắng",22000,22000,0,0
TIKI,phu-kien-thoi-trang,85753009,"Mặt Khóa Thắt Lưng Nam D&D Fashion",30000,60000,30000,50
TIKI,phu-kien-thoi-trang,1491673,"[Một cặp] Kính Áp Tròng Trong Suốt Dùng 1 Tháng Eye Secret KT1T (7.5 Độ)",120000,135000,15000,11
TIKI,phu-kien-thoi-trang,151524797,"Thắt lưng nam dây nịt nam chất liệu da bò thật khóa tự động hàng hiệu cao cấp NT326 - Nutushop",335000,335000,0,0
TIKI,phu-kien-thoi-trang,127253185,"Set 100 Thun Cột tóc HANVIET Kèm Túi ZIp",4300,4300,0,0
TIKI,phu-kien-thoi-trang,56067940,"Kính lão thị viễn thị trung niên nam nữ sẵn độ KV656 kính lão kính viễn",186000,186000,0,0
TIKI,phu-kien-thoi-trang,97865285," Nón Sơn Snapback Hoa Văn - Nón Hiphop Nón Sơn - Nón Snapback Nón Sơn - Mũ snapback hiphop nam nữ ĐEN",85000,85000,0,0
TIKI,phu-kien-thoi-trang,87093178,"Dây Thắt Lưng Da Bò D&D Fashion - Dây Nịt Nam Không Mặt Khóa",50000,100000,50000,50
TIKI,phu-kien-thoi-trang,100446801,"Bộ 5 kẹp tóc, kẹp càng cua kèm dây buộc tóc phối ngọc trai Hottrend Hàn Quốc",30000,30000,0,0
TIKI,phu-kien-thoi-trang,146369753,"[VIDEO]- Khăn choàng cổ đi biển dáng dài, khăn lụa cao cấp đa năng 180cmx90cm- Qùa tặng cho phái đẹp- CHỌN MẪU",148000,148000,0,0
TIKI,phu-kien-thoi-trang,91751051,"Mặt khóa thắt lưng đen trơn chính hãng D&D Fashion (Mặt rời không dây)",40000,80000,40000,50
TIKI,phu-kien-thoi-trang,91754754,"[ KÈM LƯỚI VÀ LƯỢC, 2117 ] Tóc giả nữ nguyên đầu cup ngắn, tóc vic, tóc giả có rãnh da đầu, tóc giả ngắn , tóc giả bộ cả đầu mái thưa , tóc giả hàn quốc, tóc giả cao cấp",280000,280000,0,0
TIKI,phu-kien-thoi-trang,25924080,"Combo 10 Đôi Tất Gấu Nữ Cổ Ngắn Chất Đẹp Tặng Kèm Túi Đẹp",28000,29676,1676,6
TIKI,phu-kien-thoi-trang,139497655,"Khăn Choàng Cổ khẩu trang băng đô nữ dona21111301",46550,49000,2450,5
TIKI,phu-kien-thoi-trang,83616414,"Khẩu trang ninja vải nỉ dán gáy che kín tai chống nắng chạy xe phượt nam nữ hè",28000,28000,0,0
TIKI,phu-kien-thoi-trang,7156461,"Bộ Dụng Cụ Búi Tóc (4 Món)",17000,20000,3000,15
TIKI,phu-kien-thoi-trang,72524754,"KHẨU TRANG PITTA TRẺ EM KIDS COOL (Gói 3 cái)",180000,180000,0,0
TIKI,phu-kien-thoi-trang,181123291,"Kính Mắt Unisex Thời Trang Southside Chống Ánh Sáng Xanh CHo Nam và Nữ",112000,120000,8000,7
TIKI,phu-kien-thoi-trang,67992749,"Dây buộc tóc Scrunchies lụa dáng dài dễ thương HD78",25500,25500,0,0
TIKI,phu-kien-thoi-trang,75804970,"Combo 6 Đôi Tất Vớ Chân Nữ Len Bông Chân Mèo Cổ Cao Ấm Áp Không Lo Mùa Đông Lạnh Giá  TN123",110000,110000,0,0
TIKI,phu-kien-thoi-trang,112814658,"Thắt Lưng Nam Dây Vải Dù Phong Cách Lính U379 US ARMY, Khóa Cài Tự Động Dễ Dàng Điều Chỉnh Theo Vòng Bụng- HÀNG CHÍNH HÃNG",84000,198000,114000,58
TIKI,phu-kien-thoi-trang,73104596,"Kẹp tóc sau - kẹp tóc ngọc trai đính đá - kẹp sườn sau",89000,89000,0,0
TIKI,phu-kien-thoi-trang,193042244,"Khăn Rằn Nam Bộ - Campuchia/ Khăn Thời Trang NOMAC Đi Phượt, Du Lịch, Trekking/ Hàng Loại 1, Vải Dày Mềm Mịn/ Kích Thước Lớn 170 x 60cm/ Combo B",85000,85000,0,0
TIKI,phu-kien-thoi-trang,174380145,"Mũ lưỡi trai - nón Ulzzang thêu chữ OFF unisex nam nữ chống nắng phong cách thời trang, cá tính",40000,80000,40000,50
TIKI,phu-kien-thoi-trang,80699239,"10 Nút cài áo mini siêu HOT 2021",32900,32900,0,0
TIKI,phu-kien-thoi-trang,132064440,"Dung Dịch Ngâm Kính Eye Secret DD360 (360ml)",99000,150000,51000,34
TIKI,phu-kien-thoi-trang,91755524,"Mặt khóa thắt lưng nam chính hãng D&D Fashion",50000,100000,50000,50
TIKI,phu-kien-thoi-trang,181777182,"Mũ Lưỡi Trai Nam Phong Cách Lính US ARMY, Nón Lưỡi Trai Đi Phượt Dã Ngoại, Nón Kết Lính Mỹ Cực Ngầu",83000,178000,95000,53
TIKI,phu-kien-thoi-trang,149534368,"Găng tay giữ ấm mùa đông chống gió, kháng nước mưa Rhino G102 Bao tay thể thao cảm ứng điện thoại, găng tay đi xe máy, xe đạp lót nỉ cho nam nữ, bảo hộ đi phượt",161000,179000,18000,10
TIKI,phu-kien-thoi-trang,35420355,"Kính Ngố Nobita KM01",26000,50000,24000,48
TIKI,phu-kien-thoi-trang,157559197,"ComBo 5 Khẩu Trang Vải 3D 3Lớp Linen",223000,223000,0,0
TIKI,phu-kien-thoi-trang,56406908,"KÈM LƯỚI VÀ LƯỢC. Tóc giả nữ nguyên đầu dài, tóc giả nguyên đầu, giống tóc thật 100%, có rãnh da đầu, chất tơ cao cấp, chịu nhiệt tốt, bấm, uốn, duỗi, gội thoải mái",198000,198000,0,0
TIKI,tui-thoi-trang-nam,107366288,"Túi đeo chéo nam thời trang cao cấp",351000,390000,39000,10
TIKI,tui-thoi-trang-nam,74896948,"Ví Nam Thời Trang Da Bò Thật TRITA RVN05 nhiều màu",199000,380000,181000,48
TIKI,tui-thoi-trang-nam,138569315,"Túi đeo chéo da nam TRITA RTN5",219000,420000,201000,48
TIKI,tui-thoi-trang-nam,213585423," Ví da nam D730 và D738 kiểu đứng và ngang bóp nam mini màu đen cao cấp lịch lãm",110000,220000,110000,50
TIKI,tui-thoi-trang-nam,193611368,"Túi đeo chéo nam đa năng cao cấp phong cách mới",207000,230000,23000,10
TIKI,tui-thoi-trang-nam,129575356,"ví nam ví nam clutch cầm tay cao cấp",297000,330000,33000,10
TIKI,tui-thoi-trang-nam,149753175,"TÚI ĐEO CHÉO HAVIN MỚI NHẤT 2021 SÀN PHẨM CHẤT LƯỢNG ĐƯỢC LÀM BẰNG VẢI DÙ TỐT NHẤT",99000,135000,36000,27
TIKI,tui-thoi-trang-nam,8259548,"Túi đeo chéo nam TROY classic V2",99000,129000,30000,23
TIKI,tui-thoi-trang-nam,196881208,"Ví nam da bò cao cấp phong cách mới",225000,250000,25000,10
TIKI,tui-thoi-trang-nam,183742082,"Túi đeo chéo Nam kết hợp Ví cầm tay vải Oxford cao cấp chống nước, chống bám bụi - Túi Ví Nam sang trọng",349000,349000,0,0
TIKI,tui-thoi-trang-nam,122234659,"Túi Bao Tử Nam Thời Trang Đeo Chéo Màu Nâu Đựng Được Nhiều Đồ",180000,360000,180000,50
TIKI,tui-thoi-trang-nam,85047463,"Túi da cao cấp đeo chéo nam Kangaroo",265000,265000,0,0
TIKI,tui-thoi-trang-nam,120469617,"Ví Nam Da Bò NAPA Mềm Mại - Vân Tự Nhiên, Size Lớn, Thiết Kế Cổ Điển, Đơn Giản - Mỏng Nhẹ, Dáng Đứng - Gập 2, Ngăn Đựng Tiền Có Khóa Kéo, Nhiều Ngăn Để Giấy Tờ Tiện Dụng - Hàng Chính Hãng SAIGIO",899000,899000,0,0
TIKI,tui-thoi-trang-nam,68345768,"Túi Đeo Chéo IBag Thời Trang Cao Cấp SAKOS FOCUS",688000,749000,61000,8
TIKI,tui-thoi-trang-nam,193395348,"Túi Đeo Chéo Vải OxFord Trung Niên Nhiều Ngăn Chứa Cho Nam Nữ Cao Cấp Đi Chơi Chống Nước, Túi Đựng Điện Thoại Ipad, Túi Đeo Vai Thời Trang Sang Trọng Thời Thượng",150000,150000,0,0
TIKI,tui-thoi-trang-nam,176749882,"Ví Nam Cao Cấp, Da Bò NAPA Láng Mịn In Caro, Mỏng Nhẹ, Size Lớn, Thiết Kế Đơn Giản - Sang Trọng, Dáng Ngang - Gập 2, Ngăn Đựng Tiền Có Khóa Kéo, Nhiều Ngăn Để Giấy Tờ Tiện Dụng - Hàng Chính Hãng SAIGIO",1183000,1199000,16000,1
TIKI,tui-thoi-trang-nam,99078225,"Túi đeo chéo nam đa năng cao cấp phong cách mới",261000,290000,29000,10
TIKI,tui-thoi-trang-nam,187860014,"Bóp Nam Da Bò Mềm Mại STRIPE, Size Lớn, 10 Ngăn Để Thẻ, 3 Ngăn Đựng Tiền, Dáng Ngang - Gập 2, Có Khóa Kéo, Để Vừa Các Giấy Tờ Chuyên Dụng Như Giấy Tờ Xe Máy, Bảo Hiểm",783000,799000,16000,2
TIKI,tui-thoi-trang-nam,195695187,"Túi Đeo Vai Nhỏ Unisex E&S Đựng Phụ Kiện, Điện Thoại , Thiết Bị Cá Nhân Tiện Lợi Nhỏ Gọn Bền Bỉ  BL012",130000,130000,0,0
TIKI,tui-thoi-trang-nam,118124155,"Ví Nam Da Bò NAPA Mềm Mại - Vân Tự Nhiên, Size Lớn, Thiết Kế Cổ Điển, Đơn Giản - Mỏng Nhẹ, Dáng Ngang - Gập 2, Ngăn Đựng Tiền Có Khóa Kéo, Nhiều Ngăn Để Giấy Tờ Tiện Dụng - Hàng Chính Hãng SAIGIO",883000,899000,16000,2
TIKI,tui-thoi-trang-nam,7713520,"Túi Đeo Chéo Cao Cấp 4 Ngăn (Xám)",100000,150000,50000,33
TIKI,tui-thoi-trang-nam,28445522,"Túi đeo hông lính",64350,87945,23595,27
TIKI,tui-thoi-trang-nam,122391985,"Bóp Nam Mini Nhỏ Gọn, Da Bò NAPA Mềm Mại - Vân Tự Nhiên, Thiết Kế Cổ Điển, Đơn Giản - Mỏng Nhẹ, Dáng Ngang - Gập 2, Đựng Tiền và Thẻ ATM Tiện Dụng - Hàng Chính Hãng SAIGIO",781000,799000,18000,2
TIKI,tui-thoi-trang-nam,89221457,"Túi đeo chéo Sakos Juvanis",582000,680000,98000,14
TIKI,tui-thoi-trang-nam,66828628,"Túi đựng điện thoại đeo thắt lưng Chiến thuật",90000,90000,0,0
TIKI,tui-thoi-trang-nam,33120359,"Túi đeo chéo và bao tử da thời trang nhất",65241,89162,23921,27
TIKI,tui-thoi-trang-nam,96032651,"Ví Da Nam, Ví Dài Nam Cầm Tay Cao Cấp Jeep Kèm Dây Kéo Thời Trang",67082,96896,29814,31
TIKI,tui-thoi-trang-nam,35330048,"Túi Đeo Hông Da Bò",98511,134632,36121,27
TIKI,tui-thoi-trang-nam,116959595,"(Xịn Sò) Túi chống nước, Túi đeo chéo_Steel Rose tiện dụng, sang trọng_Túi đeo vai, Túi vải_đeo hông",96525,131917,35392,27
TIKI,tui-thoi-trang-nam,75554891,"Túi xách nam da thật cao cấp phong cách mới",423000,470000,47000,10
TIKI,tui-thoi-trang-nam,89480630,"Túi Bao Tử Màu Đen Chất Bố Chống Nước Nhập Khẩu Hàng Quốc Nhỏ Gọn Nhẹ Tiện Lợi",320000,320000,0,0
TIKI,tui-thoi-trang-nam,113492100,"Ví Sen Cách Điệu Da Bò Thật, Bóp Mini Nam Nữ Cao Cấp Nhỏ Gọn VS24",99000,149000,50000,34
TIKI,tui-thoi-trang-nam,191376138,"Bao da dành cho chìa khoá Honda HRV 2022 2023, HR-V all new L, RS handmade da thật 006",200000,200000,0,0
TIKI,tui-thoi-trang-nam,146987080,"Ví Da Nam VD05 Kiểu Ngang Chính Hãng Siêu Xịn Siêu Đẳng Cấp",38000,50000,12000,24
TIKI,tui-thoi-trang-nam,186580955,"Túi đeo chéo nam vải cavans cao cấp phong cách mới",315000,350000,35000,10
TIKI,tui-thoi-trang-nam,183558250,"Túi đeo chéo nam thời trang cao cấp chống thấm nước",351000,390000,39000,10
TIKI,tui-thoi-trang-nam,58563135,"Cặp Công Sở Đa Năng TRITA TCA5",359000,650000,291000,45
TIKI,tui-thoi-trang-nam,77743002,"Túi Đeo Bụng Thể Thao Nam Nữ Đeo Hông Đeo Chéo Vải Dù Thời Trang Túi Bao Tử Nhỏ Gọn Tiện Dụng Chắc Chắn Bền Đẹp TU18",38610,52767,14157,27
TIKI,tui-thoi-trang-nam,58216140,"Cặp công sở TRITA TCA2",359000,600000,241000,40
TIKI,tui-thoi-trang-nam,11801361,"Túi đeo chéo nam hàn quốc HR227",650000,650000,0,0
TIKI,giay-dep-nu,157198929,"CẶP DA CÔNG SỞ ĐỰNG LAPTOP CAO CẤP RHINOS LIFE 9622",550000,550000,0,0
TIKI,giay-dep-nu,9797956,"Túi du lịch HARAS HRTK0231",250000,250000,0,0
TIKI,giay-dep-nu,17878692,"Túi đựng mỹ phẩm du lịch chống thấm tiện dụng cho gia đình ( Giao màu ngẫu nhiên )",62000,120000,58000,48
TIKI,giay-dep-nu,72295929,"Bao trùm vali Bao hình lí nhựa trong suốt 20 - 24 -28 inch cao cấp F45 Tặng túi đựng điện thoại chống nước",54450,74415,19965,27
TIKI,giay-dep-nu,185966884,"Túi xách túi chống sốc macbook và laptop 14,1 và 15,6 inh cao cấp phong cách mới",315000,350000,35000,10
TIKI,giay-dep-nu,188447672,"Balo Mini Nữ Thời Trang Hàn Quốc, Balo Nữ Mini Da PU Kẻ Caro Đi Học Đi Chơi Sang Trọng Sành Điệu",85000,85000,0,0
TIKI,giay-dep-nu,52003186,"Túi chống sốc TOMTOC Spill-resistant Macbook Pro 13 / 15 / 16 inch - (A22) - Hàng chính hãng",989000,989000,0,0
TIKI,giay-dep-nu,178006302,"Túi xách du lịch thể thao nam nữ công suất lớn phong cách mới BEE GEE T1009",208000,420000,212000,50
TIKI,giay-dep-nu,53969904,"Balo cỡ đại bố leo núi thể thao du lịch JUS20",106425,153725,47300,31
TIKI,giay-dep-nu,124276674,"Túi Đựng Thuốc, Đồ Y Tế Khi Đi Du Lịch, Cắm Trại Nhỏ Gọn",38000,41000,3000,7
TIKI,giay-dep-nu,146953092,"Balo - cặp sách Ulzzang Basic B097 vải Oxford nhỏ đi học, đi làm, du lịch, đựng laptop Unisex nam nữ phong cách thời trang, cá tính",105000,210000,105000,50
TIKI,giay-dep-nu,23912015,"Balo nam nữ thời trang đi học Ohazo! Phát sáng trong đêm, Balo đi học cao cấp HÓT 2021 - BL01DT26",249000,249000,0,0
TIKI,giay-dep-nu,194041528,"Balo Nam, Nữ Công Sở Đa Năng Teement, Đựng Vừa Laptop - Macbook - Máy Tính Xách Tay, Chất Liệu Vải Cao Cấp Chống Thấm Nước, Chống Xước, Có Cổng Sạc USB Tiện Lợi - Hàng Chính Hãng",250000,250000,0,0
TIKI,giay-dep-nu,144505664,"Túi Chống Sốc dành cho Laptop 11.6"/13.3"/14" /15.6" TARGUS City Gear 3 - Hàng Chính Hãng",339150,399000,59850,15
TIKI,giay-dep-nu,174664084,"Túi xách du lịch thể thao nữ phong cách mới BEE GEE T1001",317000,640000,323000,50
TIKI,giay-dep-nu,711097,"Túi Du Lịch HARAS HRTK136 (46 x 28 cm) - Xám",200000,200000,0,0
TIKI,giay-dep-nu,7462725,"Túi bọc bảo vệ vali -Áo vỏ bọc vali - Du Lịch Singapo",149000,232000,83000,36
TIKI,giay-dep-nu,189885668,"Túi Chống Sốc Da Kai Mẫu Ngang Dành Cho Macbook - iPad - Laptop, Surface Chống Nước Nắp Đậy Nam Châm- Hàng chính hãng",284050,299000,14950,5
TIKI,giay-dep-nu,31706795,"Túi Chống Sốc Laptop Macbook 13.3 inch Chống Nước, Chống Va Đập, Ma Sát (Màu",159000,159000,0,0
TIKI,giay-dep-nu,97562128,"balo nữ thời trang cao cấp phong cách mới",387000,430000,43000,10
TIKI,giay-dep-nu,189480752,"Túi xách - túi chống sốc cho laptop 13 INCH cao cấp phong cách mới – BEE GEE 0125",287000,580000,293000,51
TIKI,giay-dep-nu,135538633,"Túi đựng mỹ phẩm đồ du lịch Different Populations chống nước, trong suốt, đựng đồ cá nhân trang điểm PVC cao cấp",60000,60000,0,0
TIKI,giay-dep-nu,38064939,"Balo Laptop Du Lịch Thời Trang Cao Cấp SAKOS AGATHA Dành Cho Laptop 15.6 Inch (15.6")",999000,1050000,51000,5
TIKI,giay-dep-nu,190861114,"Vali kéo Comete + DELSEY - PHÁP : Vali kéo nhựa thương hiệu Pháp Chất liệu nhựa ABS kết hợp Polycarbonate bền chắc Kết cấu vỏ hạn chế trầy xước",3998000,5000000,1002000,20
TIKI,giay-dep-nu,71656493,"Balo nữ thời trang cao cấp ELLY – EBH32",1119300,1599000,479700,30
TIKI,giay-dep-nu,122700675,"Cặp Học Sinh Thời Trang Cao Cấp Phiên Bản Hàn Quốc Ulzzang Đặc Biệt Dành Cho Nữ Mã: FS827",149000,149000,0,0
TIKI,giay-dep-nu,36085596,"Túi Đựng Giày 2 ngăn du lịch tiện dụng KDR-NC055",97000,97000,0,0
TIKI,giay-dep-nu,22824570,"Túi Tiện ích Đa Năng Đựng Phụ Kiện Công Nghệ",84000,84000,0,0
TIKI,giay-dep-nu,39377570,"Túi Đeo Tay Chạy Bộ Đựng Điện Thoại Chống Sốc Đa Năng Quấn Bắp Tay Cho Chạy Bộ, Đi Bộ, Tập Thể Thao, Tập Gym - Mai Lee",26000,39000,13000,33
TIKI,giay-dep-nu,3491723,"Balo Laptop Hasun HS 645",321000,369000,48000,13
TIKI,giay-dep-nu,26029393,"Balo thời trang Willbe thể thao M2 Shalla",49005,70785,21780,31
TIKI,giay-dep-nu,173055365,"Túi bao da đựng máy tính xách tay cho Laptop, MacBook Size 11 - 15.6 Inch",154380,154380,0,0
TIKI,giay-dep-nu,49158047,"Combo Balo Laptop Cao Cấp Có Nhiều Ngăn Và Túi Đeo Chéo Tiện Dụng PRAZA - BLTK182&DC095",249000,329000,80000,24
TIKI,giay-dep-nu,121332321,"Dây đai buộc hành lý chuyên dụng chịu tải lớn chiều dài dây 1.5 mét và khóa",19000,19000,0,0
TIKI,giay-dep-nu,179554923,"Thẻ treo hành lý Anse Enamel Luggage Name Tag LA313 Thương Hiệu MIA",22000,22000,0,0
TIKI,giay-dep-nu,194472995,"Vali Nhựa Khung Nhôm Khóa Sập NiceVilla",765000,900000,135000,15
TIKI,giay-dep-nu,23028656,"Cặp xách da, túi xách da đựng macbook, laptop, surface chống nước, chống sốc - Tặng kèm ví đựng sạc, chuột",379050,399000,19950,5
TIKI,giay-dep-nu,149451828,"Áo bọc vali silicon trong suốt, áo trùm vali chống xước, chống nước, chống bụi bẩn size20 size24 size28 size29",45738,66066,20328,31
TIKI,giay-dep-nu,162477459,"Ba lô nam cao cấp thời trang công sở",285000,285000,0,0
TIKI,giay-dep-nu,111869058,"Balo du lịch Arctic Hunter B00227 chất liệu Oxford chống nước, khóa mở rộng như vali, cổng kết nối USB",679000,1100000,421000,38
TIKI,balo-va-vali,16257171,"Bộ ba lô thời trang 5 món học sinh",78999,78999,0,0
TIKI,balo-va-vali,86012687,"Combo sét 5 món  balo nữ balo học sinh nữ  balo  cấp 1 balo cấp 2 balo cấp 3 siêu đẹp đáng yêu - mã 372",319000,599000,280000,47
TIKI,balo-va-vali,140430190,"Túi xách du lịch chống thấm nước túi trống thể thao đa năng to nam nữ tiện dụng SPORT",123750,178750,55000,31
TIKI,balo-va-vali,35189051,"Bộ Vali Túi Xách Du Lịch 
Macat MA9- 25 inch",1282500,1350000,67500,5
TIKI,balo-va-vali,3006991,"Túi Xách Du Lịch Cao Cấp Praza TX082 (Xanh)",168000,168000,0,0
TIKI,balo-va-vali,11285203,"Balo da nữ HARAS BL003",170000,170000,0,0
TIKI,balo-va-vali,55088865,"Balo leo núi đường trường 55+15L",490000,490000,0,0
TIKI,balo-va-vali,197665859,"Vali kéo Argyle  AMERICAN TOURISTER - MỸ: Vali kéo nhựa PP có trọng lượng nhẹ và bền chắc Hệ thống 4 bánh xe đôi 360",2658000,3800000,1142000,30
TIKI,balo-va-vali,74858586,"Balo Da Thời Trang Hàn Quốc HARAS HR271",250000,250000,0,0
TIKI,balo-va-vali,149451599,"Vali kéo du lịch khung nhôm thời trang chống bể vỡ vali nhựa khung nhôm SIZE 20, SIZE 24 chống trộm",1250000,1250000,0,0
TIKI,balo-va-vali,15219389,"Vali du lịch tay kéo XXCLW size lớn 20inch 39x21,5x45cm tặng kèm túi",559000,559000,0,0
TIKI,balo-va-vali,63081579,"Cặp Học Sinh Nữ Cấp 1 Kiểu Dáng Thanh Lịch Nhiều Màu Sắc Để Lựa Chọn",228000,270000,42000,16
TIKI,balo-va-vali,71087115,"Balo nam nữ thời trang phối màu năng động cao cấp hàn quốc K7 - Đen",94050,128535,34485,27
TIKI,balo-va-vali,179758386,"VALI SIÊU KÉO NHỰA DẺO CHỐNG VA ĐẬP SIZE 22 24 INCH",990000,990000,0,0
TIKI,balo-va-vali,14044923," Balo laptop  Mikkor 14 inch the Ralph",590000,590000,0,0
TIKI,balo-va-vali,115572785,"COMBO 2 vali kéo du lịch SUNNY SV05 (Size 20 - 24), nhựa dẻo ABS, chống va đập, chống trầy xước",998000,1800000,802000,45
TIKI,balo-va-vali,73410860,"Balo nữ combo 4 món ulzzang - balo đi học cặp phối màu - Ba lô thời trang học sinh sinh viên Munnini",79900,79900,0,0
TIKI,balo-va-vali,20421337,"Balo Nam Phát Sáng Có Cổng Sạc, Chống Nước , Tặng Kèm Dây Sạc USB Và Khóa Chống Trộm",199000,199000,0,0
TIKI,balo-va-vali,75003617,"Túi xách đựng đồ đa năng, nhiều ngăn, có ngăn chống thấm, thay đổi dung lích, túi du lích - Hàng chính hãng",185000,185000,0,0
TIKI,balo-va-vali,193165752,"Cặp Xách Chống Sốc Cao Cấp Cho Laptop, Macbook 15.6 Inch Nhỏ Gọn, Tiện dụng, Túi Đựng Laptop Chống Sốc, Túi Đeo Chéo Thời Thượng Bền An Toàn Cho Laptop, Máy Tính",330000,330000,0,0
TIKI,balo-va-vali,15479179,"Túi chống sốc Tomtoc A06 cho Ipad, Tablet size 10-11''",950000,950000,0,0
TIKI,balo-va-vali,179777302,"VALI KHUNG NHÔM CAO CẤP 2022",700000,700000,0,0
TIKI,balo-va-vali,41227807,"Balo Laptop Mr Vui BLLT744 17 inch",372000,465000,93000,20
TIKI,balo-va-vali,35612570,"Túi kéo đa năng, túi kéo shopping CTM",664050,699000,34950,5
TIKI,balo-va-vali,67326498,"Balo nữ đi học thời trang chống nước kèm sticker kiểu dáng Hàn Quốc",66900,66900,0,0
TIKI,balo-va-vali,186243212,"Balo du lịch kiêm túi xách du lịch cao cấp phong cách mới",477000,530000,53000,10
TIKI,balo-va-vali,185904831,"Balo nam đa chức năng cao cấp phong cách cá tính mới 15,6",531000,590000,59000,10
TIKI,balo-va-vali,90503387,"Ba lô du lịch đa năng chống trộm chống nước cao cấp",621000,690000,69000,10
TIKI,balo-va-vali,106379286,"Cặp Học Sinh Nữ Version Hàn Quốc Ulzzang Balo Học Sinh Nữ Dễ Thương Sinh Động  MÃ FS816",99000,99000,0,0
TIKI,balo-va-vali,1642591,"Túi Kéo Du Lịch Macat Innova 5 (48 x 25 cm) - Đỏ",678600,754000,75400,10
TIKI,balo-va-vali,41824303,"Balo Cặp Sách Diea Đi Học Thời Trang Nam Nữ Vải Canvas Cao Cấp- Hồng",75900,75900,0,0
TIKI,balo-va-vali,171759478,"Vali du lịch kéo cao cấp Size 24inch- Chất lượng cao  KS-155 - Xanh lam nhạt",478000,763000,285000,37
TIKI,balo-va-vali,32132323,"Bộ Balo Nữ Thời Trang 5 Món Họa Tiết Đám Mây Cloudy (xanh đen)",89000,89000,0,0
TIKI,balo-va-vali,58134868,"Balo nữ thời trang công sở cao cấp phong cách mới",423000,470000,47000,10
TIKI,balo-va-vali,161618109,"Balo canvas phối da ba lô du lịch phượt dã ngoại, balo sinh viên 205876",255600,288000,32400,11
TIKI,balo-va-vali,157254374,"Balo Nắp Dài SAIGON SWAGGER SGS Flapped Backpack-Ngăn Chống Sốc 15inch",500000,500000,0,0
TIKI,balo-va-vali,172683678,"Túi da PU đựng máy tính xách tay thích hợp cho dòng Macbook Air Pro/Macbook Air 11/12/13.3/15.4 inch",297700,297700,0,0
TIKI,balo-va-vali,89221572,"Túi xách túi chống sốc cho laptop 15,6 "cao cấp phong cách sang trọng",315000,350000,35000,10
TIKI,balo-va-vali,71721534,"Balo nữ thời trang cao cấp ELLY – EBH37",1599000,1599000,0,0
TIKI,balo-va-vali,90533052,"Balo da nam thời trang cao cấp phong cách châu âu",449000,498000,49000,10
TIKI,dong-ho-va-trang-suc,138282893,"Khuyên tai hình hoa cúc xinh xắn HT663 - Culi accessories",85000,85000,0,0
TIKI,dong-ho-va-trang-suc,29253359,"Bông tai nam nữ cá tính",83000,83000,0,0
TIKI,dong-ho-va-trang-suc,56994124,"Charm bạc tròn hoa văn - Ngọc Quý Gemstones",75000,150000,75000,50
TIKI,dong-ho-va-trang-suc,28730086,"Vòng tay phong thủy nữ đá thạch anh ưu linh trắng charm tỳ hưu 8mm mệnh thủy , kim - Ngọc Quý Gemstones",1009000,1570000,561000,36
TIKI,dong-ho-va-trang-suc,71516022,"Đồng hồ nam dây nhựa Casio G-Shock chính hãng GA-900-1ADR (49mm)",3335000,4276000,941000,22
TIKI,dong-ho-va-trang-suc,104157493,"Dây da bò cao cấp cho Fossil size 20 và 22 chốt thông minh",370000,370000,0,0
TIKI,dong-ho-va-trang-suc,40261556,"Đồng hồ nam nữ thời trang thông minh tacona DH34",37000,37000,0,0
TIKI,dong-ho-va-trang-suc,56107956,"Combo 2 cái charm bạc mạ vàng 12 con giáp xỏ ngang - Ngọc Quý Gemstones",200000,320000,120000,38
TIKI,dong-ho-va-trang-suc,117490054,"Vòng giải thoát pháp bảo hộ thân mật tông",15000,15000,0,0
TIKI,dong-ho-va-trang-suc,14865613,"Vòng Tay Băng Ngọc Thuỷ Tảo Huyết Ni 56 Ngọc Quý Gemstones",1539000,1924000,385000,20
TIKI,dong-ho-va-trang-suc,74751478,"Đồng hồ dây da nữ mặt vuông Rtv1, mặt kính viền kim loại dây da mềm",31000,31000,0,0
TIKI,dong-ho-va-trang-suc,32785995,"Bông Tai Ngôi Sao Sợi",61750,65000,3250,5
TIKI,dong-ho-va-trang-suc,72033073,"Đồng Hồ Nữ Julius Hàn Quốc JA-496",529000,529000,0,0
TIKI,dong-ho-va-trang-suc,158602614,"Dây Handmade Da Bò Thật Cho Đồng Hồ Fossil Casio Samsung Huawei [Tặng Chốt thông minh & Hộp gỗ",190000,190000,0,0
TIKI,dong-ho-va-trang-suc,51565052," Đồng hồ thời trang nam nữ dây da unisex phong cách thanh lịch công sở ZO38",53999,53999,0,0
TIKI,dong-ho-va-trang-suc,106393572,"Combo cây thay dây đồng hồ + 4 chốt lò xo",30000,30000,0,0
TIKI,dong-ho-va-trang-suc,212461988,"Bông tai kiểu dáng đôi dép đính đá phụ kiện trang sức cá tính",56000,56000,0,0
TIKI,dong-ho-va-trang-suc,53977619,"Đồng hồ nam thời trang cao cấp dây da bền bỉ mặt kính tròn to ZO97",43000,43000,0,0
TIKI,dong-ho-va-trang-suc,52003160,"Dây Chuyền Hồ Ly Pha Lê Cầu Tài Lộc - Ngọc Qúy Gemstones",99000,150000,51000,34
TIKI,dong-ho-va-trang-suc,9860555,"Mặt Phật Thiên Thủ Thiên Nhãn đá mắt hổ 3.6cm",219000,219000,0,0
TIKI,dong-ho-va-trang-suc,92957153,"Charm bạc chuỗi xích trang trí - Ngọc Quý Gemstones",17000,34000,17000,50
TIKI,dong-ho-va-trang-suc,103665044,"Dây chuyền bạc 925, Vòng cổ bạc 925 Mặt Đá Pha Lê Xanh Dây Chuyền Hình Bầu Dục [SN0104]",90000,90000,0,0
TIKI,dong-ho-va-trang-suc,108919519,"Charm bạc trắng xỏ ngang nhiều cạnh - Ngọc Quý Gemstones",55000,100000,45000,45
TIKI,dong-ho-va-trang-suc,75301179,"Lắc chân titan hoa tuyết BHLC36",90000,119000,29000,24
TIKI,dong-ho-va-trang-suc,16875010,"Lắc tay nam mạ vàng 24k rồng vàng LT6",201000,212000,11000,5
TIKI,dong-ho-va-trang-suc,54856711,"1 vỉ 10 viên pin đồng hồ đeo tay",13000,13000,0,0
TIKI,dong-ho-va-trang-suc,74296458,"Dây Chuyền Swarovski Pha Lê Lấp Lánh",1360000,1360000,0,0
TIKI,dong-ho-va-trang-suc,12274959,"Đồng hồ nữ dây nhựa Casio LRW-200H-4E2VDR",751200,939000,187800,20
TIKI,dong-ho-va-trang-suc,19587473,"Dây chuyền nam mặt chữ nhật khảm Rồng mạ Vàng 24k MD30",254000,300000,46000,15
TIKI,dong-ho-va-trang-suc,56861139,"Charm bạc hình nén vàng - Ngọc Quý Gemstones",260000,260000,0,0
TIKI,dong-ho-va-trang-suc,154180789,"Bông tai nữ dáng dài hoa mai sang trọng thiết kế đeo nhiều kiểu.",67000,67000,0,0
TIKI,dong-ho-va-trang-suc,15062418,"Dây chuyền bạc nữ - Vòng cổ bạc nữ mặt hồ ly [DC-A13]",159000,159000,0,0
TIKI,dong-ho-va-trang-suc,82923020,"Vòng đeo tay, lắc tay phong thủy đá mắt hổ đỏ",350000,350000,0,0
TIKI,dong-ho-va-trang-suc,94517970,"Charm bạc túi tài lộc treo - Ngọc Quý Gemstones",99000,100000,1000,1
TIKI,dong-ho-va-trang-suc,161030297,"Mặt dây chuyền Thiên Tâm đài sen 5cm MMD019",142000,142000,0,0
TIKI,dong-ho-va-trang-suc,148923807,"[5 Hạt/10 Hạt] 3.5MM Đá Peridot Xanh Lá Tự Nhiên (Xử Lý Nhiệt) Giác Cắt, Mộc, Hoả, Đá Phối Vòng Tay Phong Thuỷ, Chuỗi Hạt - Bead Art",55400,55400,0,0
TIKI,dong-ho-va-trang-suc,14031474,"Chuỗi hạt đeo cổ phật Hư Không Tạng Bồ Tát - Bản mệnh người",69000,69000,0,0
TIKI,dong-ho-va-trang-suc,68166306,"Mặt Dây Chuyền Tỳ hưu Phong Thủy Đá Aventurine Thiên Nhiên  - Có Móc Bạc và Dây Đeo Cổ",280000,280000,0,0
TIKI,dong-ho-va-trang-suc,99495727,"Vòng tay mèo kitty bạc ta cho bé",275000,275000,0,0
TIKI,dong-ho-va-trang-suc,920500,"Đồng Hồ Nữ Dây Da Julius JA-787B (24 x 19 mm) - Đen",589000,589000,0,0
TIKI,balo-va-vali,43043353," Nhẫn nam mạ vàng 24k rồng vàng mặt xanh dương N2",99500,99500,0,0
TIKI,balo-va-vali,122311273,"Vòng tay Trầm Hương Trụ Trúc Việt Nam - Đẳng Cấp, Sang Trọng - Tốc Banh - 9 trụ 9 hạt - Thiên Mộc Hương",2371500,2790000,418500,15
TIKI,balo-va-vali,98634341,"Vòng tay dây gút",7800,7800,0,0
TIKI,balo-va-vali,54751825,"Mặt dây chuyền hạt đá thiên nhiên - Ngọc Quý Gemstones",369000,730000,361000,49
TIKI,balo-va-vali,102602552,"VÒNG TAY LU THỐNG ĐÁ PHONG THUỶ VẠN SỰ HANH THÔNG",240000,240000,0,0
TIKI,balo-va-vali,55014646,"Vòng tay dây đen thắt hạt đá thiên nhiên - Ngọc Quý Gemstones",159000,300000,141000,47
TIKI,balo-va-vali,144531539,"Vòng Cổ (Dây Chuyền) Thạch Anh Hồng Madagascar, Pink Quartz 8MM Tự Nhiên,Trang Sức Phong Thuỷ, Chuỗi Hạt, Hoả, Thổ - Bead Art",120000,120000,0,0
TIKI,balo-va-vali,74306401,"Dây Chuyền Swarovski Pha Lê Trái Tim Tình Yêu",1622000,1622000,0,0
TIKI,balo-va-vali,19728992,"Đồng Hồ Nam Citizen Dây Da NH8360-12A - Mặt Trắng",5585000,5585000,0,0
TIKI,balo-va-vali,159730187,"Đồng Hồ Nam Dây Da Casio Standard MTP-VD02BL-2EUDF Chính Hãng - MTP-VD02BL-2E",962250,1283000,320750,25
TIKI,balo-va-vali,11338157,"Cặp nhẫn Bạc Panmila - Nhẫn đôi tình yêu (TS-ND-A3)",149000,149000,0,0
TIKI,balo-va-vali,191281267,"Đồng hồ nữ dây da Julius Ja-925",589000,589000,0,0
TIKI,balo-va-vali,147782522,"Đồng hồ nam Orient RE-AU0001S00B - Đồng hồ cơ hiển thị dự trữ năng lượng, lên dây cót bằng tay, mặt kính sapphire chống xước, mức chống nước 5 ATM, dây da thời trang cao cấp, chính hãng, bảo hành quốc tế 1 năm, phân phối độc quyền Galle Watch",20854000,23160000,2306000,10
TIKI,balo-va-vali,106390694,"Combo dây đồng hồ, dụng cụ cắt dây, thay dây",190000,190000,0,0
TIKI,balo-va-vali,58185905,"Bông tai nữ Bạc Quang Thản dáng dài treo hình trái tim gắn đá màu trắng chất liệu bạc thật không xi mạ  - QTBT43",175000,175000,0,0
TIKI,balo-va-vali,16836619,"Vòng tay nam nữ bện chỉ đỏ tròn đính 2 hạt ngọc CD19",22000,22000,0,0
TIKI,balo-va-vali,10781909,"Vòng tay nữ mã não đỏ may mắn nhiều kích thước VT31A",100000,100000,0,0
TIKI,balo-va-vali,19275615,"CUỘN DÂY THUN CO GIÃN TO DẦY 1MM ĐỂ XỎ VÒNG TAY BẰNG GỖ MÀU ĐEN",64500,64500,0,0
TIKI,balo-va-vali,26449087,"Bông tai đá cẩm thạch 10mm mệnh hỏa , mộc - Ngọc Quý Gemstones",309000,605000,296000,49
TIKI,balo-va-vali,22782187,"Vòng tay nữ đính xoàn dát",259000,259000,0,0
TIKI,balo-va-vali,177497222,"Dây chuyền vàng 14k Huy Thanh Jewelry DCMAMD535",4131000,4131000,0,0
TIKI,balo-va-vali,68144509,"Vòng Tay Chuỗi Hạt Trầm Hương 108 Hạt Size 6mm, Mùi thơm vĩnh viễn",160000,160000,0,0
TIKI,balo-va-vali,177787632,"Vòng tay inox nam trơn hở hai đầu bản 6mm",120000,120000,0,0
TIKI,phu-kien-thoi-trang,52580540,"Tóc giả búi cột xoăn kiểu Hàn siêu xinh, Chất tơ Cao cấp có thể dùng nhiệt bấm, uốn, duỗi, gội thoải mái, cam kết y hình, giống tóc thật 100%. mẫu này rất tiện lợi và dễ sử dụng ạ",70000,70000,0,0
TIKI,balo-va-vali,173426064,"Đồng Hồ Nam Dây Nhựa Casio G-Shock GBD-200RD-4DR Chính Hãng - GBD-200RD-4 Bluetooth",4349000,5441000,1092000,20
TIKI,balo-va-vali,25408070,"Vòng Tay May Mắn Hạt Đá Phong Thủy Đá Núi Lửa Obsidian",31000,31000,0,0
TIKI,phu-kien-thoi-trang,164021757,"Kính Mát, Kính Thời Trang, Mắt Kính Nam Nữ Gọng Tròn Tròng Phân Cực Chống Tia UV Cực Tốt AK001- Aoron",230000,320000,90000,28
TIKI,phu-kien-thoi-trang,183689033,"Thắt Lưng Nam Vải Bố Phong Cách Lính US ARMY, Dây Nịt Nam Vải Dù Khóa ZHANBEIKU Chống Ghỉ Siêu Bền Cao Cấp - HÀNG CHÍNH HÃNG",85000,178000,93000,52
TIKI,phu-kien-thoi-trang,72905084,"Thắt Lưng Nam, Dây Nịt Nam, Dây Lưng Nam Công Sở Da Bò Cao Cấp Màu",520000,520000,0,0
TIKI,phu-kien-thoi-trang,181692627,"Nước ngâm lens Angel Eyes Aqua B5 dung tích 150ml và 360ml",50000,50000,0,0
TIKI,phu-kien-thoi-trang,148841912,"Nón tai bèo nón tai bèo nam mũ tai bèo vành nhỏ vải kaki tốt, vành xụp chống nắng tốt, đội được 2 mặt tiện dụng - Hạnh Dương",69000,69000,0,0
TIKI,balo-va-vali,174536458,"Vòng Tay Hạt Bồ Đề Kim Cang (Rudraksha) Từ Tibet, Mệnh Mộc, Hoả, Chuỗi Hạt , Vòng Tay Phong Thuỷ - Bead Art",496000,496000,0,0
TIKI,phu-kien-thoi-trang,115547666,"Gọng Kính Mắt Tròn Mắt Kính Nữ Thời Trang",59000,59000,0,0
TIKI,balo-va-vali,180105022,"Pin đồng hồ chính hãng Maxell 377 SR626SW AG4 dành cho đồng hồ, thiết bị điện tử - 1 Viên",15000,15000,0,0
TIKI,balo-va-vali,16931722,"Nhẫn nam quân đội Mỹ mạ Vàng 24k mặt đá đỏ N10",99000,99000,0,0
TIKI,phu-kien-thoi-trang,29206688,"Gọng kính Unisex VELOCITY VL36460 162",141000,420000,279000,66
TIKI,phu-kien-thoi-trang,86658645," Mũ nón bucbet TRƠN 2 mặt- nón tai bèo vành",32400,32400,0,0
TIKI,phu-kien-thoi-trang,74417661,"Vớ tất lười nữ Basic ELLE EBW LINER010",15000,35000,20000,57
TIKI,phu-kien-thoi-trang,44898237,"Hộp 12 Chun Buộc Tóc Hàn Quốc Sang Trọng",22000,22000,0,0
TIKI,phu-kien-thoi-trang,6770079,"30 Tờ Hình Xăm Dán Tattoo Tha Thu Từ 55 - 120 Mẫu",21000,21000,0,0
TIKI,phu-kien-thoi-trang,103877600,"Cài tóc ngọc trai phụ kiện xinh - cài tóc ngọc trai nhiều hàng",63000,63000,0,0
TIKI,phu-kien-thoi-trang,75355377,"Mũ Nam Nón Nam Nón Kết Sơn Sò Lốc Xoáy Mũ Nam Nữ Vải Dù Chất Liệu Cao Cấp Nhiều Màu Model T0110 UY TÍN VÀ ĐẸP NHẤT TẠI H3L SHOP",69000,69000,0,0
TIKI,phu-kien-thoi-trang,106893165,"Vớ Nữ Xỏ Ngón, 10 Đôi Vớ Nữ Cổ Cao, Tất Nữ Chống Nắng Màu Da Thời Trang Baw VN01",99000,99000,0,0
TIKI,phu-kien-thoi-trang,72477851,"SET 5 Tất nam dài họa tiết quả trám đi giày tây, giày công sở MM1",350000,350000,0,0
TIKI,phu-kien-thoi-trang,130398062,"[HOT HOT] [ SET 5 đôi ] Tất đi giày bệt, tất ren đi giày búp bê, vớ nữ ren, vớ đi giày búp bê",42000,45000,3000,7
TIKI,phu-kien-thoi-trang,48260426,"Kính lão thị viễn thị trung niên mắt Thủy Tinh chống xước cao cấp JAPAKVN33CP",154000,154000,0,0
TIKI,phu-kien-thoi-trang,117492175,"Set 6 đôi Vớ Nam Cổ Ngắn Cao Cấp, Tất Cổ Ngắn Nam Họa Tiết, Nhiều Màu - NACN-FEEL-CB6",149000,199000,50000,25
TIKI,balo-va-vali,192711875,"Khuyên Tai Phối Đá Opal Phong Cách Hàn Quốc Thanh Lịch",9089,14900,5811,39
TIKI,balo-va-vali,103809048,"(6.5 LÍT ) Máy Rửa bằng Sóng Siêu Âm, Máy Rửa Trang Sức, Linh Kiện Điện Tử, Linh Kiện Cơ Khí, Nha Khoa Bằng Sóng Siêu ÂM",4500000,4500000,0,0
TIKI,phu-kien-thoi-trang,26077813,"Mũ nón nồi nữ thời trang phong cách KPOP",96000,96000,0,0
TIKI,balo-va-vali,194432931,"Đồng Hồ Điện Tử Đeo Tay F-91W Huyền Thoại (Đen)",42750,45000,2250,5
TIKI,balo-va-vali,75728547,"Dây Da Đồng Hồ Julius Hàn Quốc Size 10 - Chọn Màu",129000,129000,0,0
TIKI,balo-va-vali,469035,"Đồng Hồ Nữ Dây Da Julius JA-766L-Hồng",515000,515000,0,0
TIKI,phu-kien-thoi-trang,117492142,"Combo 5 đôi Vớ nam CỔ NGẮN Vintage, Tất Nam sử dụng cả tuần - Votuannam",39000,69000,30000,43
TIKI,phu-kien-thoi-trang,104415087,"Kẹp cua Kim loại phong cách hàn quốc size lớn cho nàng tóc dày",25000,25000,0,0
TIKI,phu-kien-thoi-trang,131415658,"Kính lão thị cao cấp gập gọn NQ06 có bao da sẵn độ mắt cực sáng và rõ",97920,136000,38080,28
TIKI,phu-kien-thoi-trang,27733727,"Nón mũ rộng vành đi biển đẹp dn19081905",166250,175000,8750,5
TIKI,balo-va-vali,116142575,"Vòng đeo tay, lắc tay phong thủy quấn 3 vòng đá aquamarine",350000,350000,0,0
TIKI,phu-kien-thoi-trang,114731752,"Mũ cói mềm dây ren buộc cổ - nón cói vành to chống nắng, đi biển phong cách",74000,148000,74000,50
TIKI,phu-kien-thoi-trang,4791907,"Kính râm nam phân cực A8177",182000,225000,43000,19
TIKI,balo-va-vali,11897663,"Đồng Hồ Mix Đá Mắt Hổ Đen Đỏ DHN28 Bảo Ngọc Jewelry",493000,690000,197000,29
TIKI,balo-va-vali,195862815,"NHẪN CHIM CÔNG - KHỔNG TƯỚC MẠ BẠC - BIỂU TƯỢNG QUYẾN RŨ , QUYỀN LỰC",110000,110000,0,0
TIKI,phu-kien-thoi-trang,117492233,"Set 5 đôi tất nữ cổ ngắn họa tiết hình gấu trắng đen, vớ nữ cổ ngắn cực dễ thương – NUCN-HINHGAU-CB5-2",150000,150000,0,0
TIKI,balo-va-vali,192329351,"CECI - Khuyên tai nữ dạng kẹp một bên tai cá tính CC1-04000036",49000,250000,201000,80
TIKI,balo-va-vali,46209581,"Bộ Trang Sức 3 Món Đính Đá Saphire Cao Cấp Cho Nữ - BNT613 - Bảo Ngọc Jewelry [THIẾT KẾ ĐỘC QUYỀN]",1150000,1150000,0,0
TIKI,phu-kien-thoi-trang,96523075,"Thắt lưng nữ dây nịt nữ Nutushop hàng cao cấp bản nhỏ 2.3cm chất liệu da thật, dễ phối đồ với các loại quần jean, váy, đầm NT168",140000,140000,0,0
TIKI,balo-va-vali,12114220,"Vòng Tay Tỳ Hưu Đá Mã Não Tự Nhiên 9mm",153000,153000,0,0
TIKI,phu-kien-thoi-trang,129427364,"Quần tất nữ Hàn Quốc tàng hình siêu dai và mỏng, mặc thu đông, tất da chân chất lưới mỏng co dãn siêu trong",28000,28000,0,0
TIKI,phu-kien-thoi-trang,132016620,"Thắt lưng nam, dây nịt nam da bò 3 lớp Bụi Leather L104 - Khóa tự động, nhiều mặt khóa tùy chọn - Bảo hành 24 tháng",225000,412000,187000,45
TIKI,phu-kien-thoi-trang,117492373,"Set 5 đôi Tất Nữ Cổ Ngắn Hàn Quốc (Nhiều Mẫu)",29000,50000,21000,42
TIKI,phu-kien-thoi-trang,99670802," *Cài khăn đẹp siêu ấn tượng:nhiều mẫu,đẹp,rẻ",56050,56050,0,0
TIKI,phu-kien-thoi-trang,115269812,"Dây cột tóc srunchies mẫu mới màu đen huyền",20000,20000,0,0
TIKI,phu-kien-thoi-trang,169686025,"Mũ Tàu Siêu Bền Lòng Xanh, lòng vàng - 80kg Đứng Ngồi Lên Mũ Thoải Mái - Cách nhiệt, cách nước",98000,98000,0,0
TIKI,phu-kien-thoi-trang,21537558,"Thanh búi tóc đa năng",19000,19000,0,0
TIKI,phu-kien-thoi-trang,148811117,"Thắt Lưng Nam Vải Dù U104 US ARMY cao cấp Phong Cách Lính Mỹ, Mặt Khóa Tăng Tự Động Chất Liệu Thép Không Gỉ, Dây Vải Dù Nhiều Màu Dây  lựa chọn- HÀNG CHÍNH HÃNG",85000,178000,93000,52
TIKI,phu-kien-thoi-trang,68555006,"Kính viễn thị, Kính lão thị, Kính trung niên, Kính đọc sách nam nữ có sẵn độ dn20092702",35000,35000,0,0
TIKI,phu-kien-thoi-trang,192985737,"Móc Cài Tai Silicon Siêu Dẻo, Giúp Giữ Gọng Kính Không Bị Tuột Khi Chạy, Nhảy, Chơi Thể Thao, Màu Đen, Trong Suốt",10000,10000,0,0
TIKI,phu-kien-thoi-trang,1535135,"Nước Nhỏ Mắt Eye Secret NM15 (15ml)",60000,75000,15000,20
TIKI,balo-va-vali,64037934,"Đồng hồ Casio Nữ Baby G BA-130-7A2DR",4407000,4407000,0,0
TIKI,phu-kien-thoi-trang,90870352," Kính lão gọng dẻo có độ 0.5-4 độ cho người già kính viễn thị gọng titan",107000,144000,37000,26
TIKI,may-anh,120789075,"Kết nối chân máy bi cầu kim loại Q29 khớp nối kẹp điện thoại máy ảnh gopro ren 1/4",35000,35000,0,0
TIKI,may-anh,111850437,"Camera hành trình SJCAM SJ8 Pro Wifi 4K - Chống rung Gyro 6 trục, thời gian sử dụng 110 phút -Hàng Chính Hãng",3739000,3939000,200000,5
TIKI,may-anh,11187933,"Ống kính Yongnuo 50mm F1.8 Mark II for Canon - Hàng nhập khẩu",1999000,1999000,0,0
TIKI,may-anh,80641635,"Máy ảnh chụp được dưới nước (ko kèm film kodak200 36exp). Máy ảnh chụp film lomo có thể chụp dưới nước (tối đa 3m), máy không cần pin lắp vào chụp luôn",169000,169000,0,0
TIKI,may-anh,165707302,"Camera Aqara G3, QHD 2K,AI Tracking, hỗ trợ Apple HomeKit, tích hợp Hub Zigbee - Hàng Chính Hãng",2050000,2890000,840000,29
TIKI,may-anh,117059970,"Đèn chụp ảnh sản phẩm đèn softbox bộ đèn studio quay phim livestream chuyên nghiệp",243000,243000,0,0
TIKI,may-anh,196023427,"Combo Camera WiFi TP-Link Tapo C100 2MP và Thẻ Nhớ MicroSD Kioxia / Lexar 32Gb/64Gb/128Gb - Hàng Chính Hãng",539000,1078000,539000,50
TIKI,may-anh,89689513,"Camera IP Wifi PTZ EZVIZ C8C FHD 1080P - Xoay 355 độ, tích hợp AI nhận diện con người - ban đêm có màu - hổ trợ thẻ nhớ lên đến 256G - hàng nhập khẩu",1198900,1198900,0,0
TIKI,may-anh,160563261,"Đèn Flash Godox V860III cho máy ảnh Canon Hàng Chính Hãng",3549999,3549999,0,0
TIKI,may-anh,77712990,"Camera hành trình ô tô Xiaomi 70mai cao cấp A800S chất lượng hình ảnh 4K, tích hợp Wifi (Bộ tích hợp Camera trước + Sau) -  Bản Quốc Tế - Hàng Nhập Khẩu",4477000,4477000,0,0
TIKI,may-anh,47277282,"Màn Hình Hỗ Trợ Quay Monitor Feelworld 7inch HD IPS Có Peaking Focus FW759 - Hàng Nhập Khẩu",2905000,2905000,0,0
TIKI,may-anh,55390064,"Kính thiên văn Celestron 70400 ( THỎA MÃN ĐAM MÊ THIÊN VĂN HỌC ) - HÀNG NHẬP KHẨU",3200000,3200000,0,0
TIKI,may-anh,102603530,"Ba lô máy ảnh Lowepro Protactic BP300 AW II, Hàng chính hãng",3349999,3349999,0,0
TIKI,may-anh,88797887,"Balun 8mp A3 cho camera quan sát dùng được 720P/960P/1080P/3MP/4MP/5MP/8MP",27900,27900,0,0
TIKI,may-anh,25107816,"Dây máy ảnh bản nhỏ",120000,120000,0,0
TIKI,may-anh,74245919,"Kính hiển vi soi tinh trùng Carson MS-040 (40-400x) - Hàng chính hãng",4550000,4550000,0,0
TIKI,may-anh,151500452,"Gói 500g hạt chống ẩm, hạt hút ẩm màu xanh cho máy ảnh tặng kèm 5 túi giấy vải đựng hạt",70000,70000,0,0
TIKI,may-anh,102905148,"Đầu ball Benro Video Head S6 Pro - Hàng Chính Hãng",3599999,3599999,0,0
TIKI,may-anh,77767028,"Thẻ nhớ SDHC Sony 32GB 90Mb/70Mb/s (SF-32UY3) - Chính Hãng",350000,350000,0,0
TIKI,may-anh,271289304,"Camera WiFi hành trình ô tô Gương chiếu hậu 9.66 inch Full gương -Màn hình cảm ứng -Kết nối điện thoại video 2K sắc nét - Camera kép trước và sau",915000,915000,0,0
TIKI,may-anh,45351133,"CHÂN MÁY ẢNH MANFROTTO PIXI EVO MINI (Đen) - Hàng Chính Hãng",990000,990000,0,0
TIKI,may-anh,79675307,"Hộp chụp sản phẩm Studio Box 80x80cm size lớn",2340000,2340000,0,0
TIKI,may-anh,216907765,"KÍNH LỌC K&F CONCEPT HD SLIM MC UV GERMAN OPTICS Hàng Nhập Khẩu",250000,250000,0,0
TIKI,may-anh,58805539,"Đầu đọc thẻ nhớ USB 3.0 Kingma kèm hộp đựng hàng chính hãng.",249999,249999,0,0
TIKI,may-anh,68293626,"Balo máy ảnh Benro Incongito B200 - hàng nhập khẩu",1499999,1499999,0,0
TIKI,may-anh,115325415,"Chân đế Tripod Bluetooth cho điện thoại và máy ảnh TTX - 6218 (Kèm túi đựng và remote bluetooth)",292000,450000,158000,35
TIKI,may-anh,84426330,"Ống nhòm một mắt đo khoảng cách Bushnell Prime 1300 - Một sản phẩm chính hãng đến từ Bushnell USA ",6600000,6600000,0,0
TIKI,may-anh,188111220,"Camera IP Wifi Hikvision Ezviz C6N 2.0MP - Hàng chính hãng được bảo trì và PP tại Điện Tử Siêu Nhỏ",405000,405000,0,0
TIKI,may-anh,20737732,"Túi máy ảnh Mirrorless cho các dòng máy Sony , Canon , Nikon , Pentax , Fuji - hàng nhập khẩu",124900,124900,0,0
TIKI,may-anh,15851291,"Bộ Kit Studio 3 Đèn LED360 60W 5500K",2299900,2299900,0,0
TIKI,may-anh,7017765,"Đèn Flash Godox V860II TTL For Sony - Hàng nhập khẩu",2990000,2990000,0,0
TIKI,may-anh,108586916,"Cáp đồng trục kèm dây nguồn RG59+2C Superlink cuộn 305m- Hàng chính hãng",1650000,1650000,0,0
TIKI,may-anh,57003675,"Pin Dành Cho Máy Ảnh, Máy Quay Phim Sony NP-FV70 7.2V 2600mAh Cao Cấp AZONE",173000,173000,0,0
TIKI,may-anh,15096383,"Chân máy ảnh/ Gậy chụp hình 3 chân dùng livestream - Tripod TF3110",47967,47967,0,0
TIKI,may-anh,19987491,"Miếng dán màn hình cường lực cho máy ảnh Sony A7/A7S/A7R",59000,59000,0,0
TIKI,may-anh,139812717,"Ống nhòm một mắt chống nước BARSKA 10-30x50mm - Hàng chính hãng",3135000,3135000,0,0
TIKI,may-anh,151986433,"Dây máy ảnh đeo cổ tay",120000,120000,0,0
TIKI,may-anh,24210643,"Ống nhòm ngày cao cấp Carson RD-826 (chống nước) - Hàng chính hãng",4390000,4390000,0,0
TIKI,may-anh,195949057,"Camera Hành Trình Ô Tô DDPAI N3 Pro GPS Camera Trước Sau Độ Phân Giải 2K, Cảnh Báo Làn Đường, Giám Sát 24 Giờ, Định Vị GPS, Hiển Thị Tốc Độ, Hỗ Trợ Bộ Nhớ 128GB - Hàng Chính Hãng",2499000,4979000,2480000,50
TIKI,may-anh,135237041,"Combo Camera Wi-fi Trong Nhà EZVIZ C3W-PRO 2MP/4MP Kèm Thẻ Nhớ  32GB/64GB - Hàng Chính Hãng",1100000,1100000,0,0
