ecommerce,category,original_id,name,price,original_price,discount,discount_rate
TIKI,nha-sach-tiki,143185998,"Ăn Dặm Không Phải Là Cuộc Chiến (Tái Bản)",196000,289000,93000,32
TIKI,nha-sach-tiki,273536931,"Kinh Doanh Thời Trang - 8 Bước Xây Dựng, Vận Hành Và Phát Triển Shop Quần Áo Của Bạn",155000,199000,44000,22
TIKI,nha-sach-tiki,184075874,"(Gift) Bút ký khắc tên cao cấp LC 010, đẹp, mực mịn đều ở mọi góc nghiêng",159000,159000,0,0
TIKI,nha-sach-tiki,74158943,"Miễn phí khắc tên & Tặng kèm ống mực - Bút Kim Loại Cao Cấp BJ024W Eliteman Đẳng Cấp Tinh Hoa Phong Cách Bắc Âu",150000,150000,0,0
TIKI,nha-sach-tiki,184785575,"Bút Rồng Hoàng Gia cao cấp dành cho Doanh nhân LC056",399000,399000,0,0
TIKI,nha-sach-tiki,74021317,"Cây Cam Ngọt Của Tôi",76800,108000,31200,29
TIKI,nha-sach-tiki,188940817,"Vị Thần Của Những Quyết Định",56100,79000,22900,29
TIKI,nha-sach-tiki,189643105,"Không Phải Sói Nhưng Cũng Đừng Là Cừu -Tặng kèm bookmark 2 mặt",96800,128000,31200,24
TIKI,nha-sach-tiki,26114399,"Nóng Giận Là Bản Năng , Tĩnh Lặng Là Bản Lĩnh",56500,89000,32500,37
TIKI,nha-sach-tiki,109017985,"Thiên Tài Bên Trái, Kẻ Điên Bên Phải (Tái Bản)",118000,179000,61000,34
TIKI,nha-sach-tiki,271442564,"Sổ planner 52 tuần 2024 SDstationery “Treasure the Journey” gáy lò xo, họa tiết màu pastel trang nhã 14x20.3cm",112000,132000,20000,15
TIKI,nha-sach-tiki,271405604,"Lịch bàn 2024 SDstationery From Yourself with Love, cảm hứng phát triển bản thân, tiếng Anh, minh họa đẹp 20x24x7,5",22000,110000,88000,80
TIKI,nha-sach-tiki,113964351,"(Gift)Bút ký khắc tên cao cấp Doanh nhân 006, thép nguyên khối, mực bi đều ở mọi góc nghiêng",450000,450000,0,0
TIKI,nha-sach-tiki,270704495,"Lịch bàn 2024 Thông Thái Tinh Khôn SDstationery, 21x16x6 cm, dễ thương vui nhộn, minh họa vũ trụ, hành tinh, hệ mặt trời",23000,88000,65000,74
TIKI,nha-sach-tiki,69764541,"Tâm Lý Học Hành Vi (Tặng Kèm 1 Bookmark )",70100,98000,27900,28
TIKI,nha-sach-tiki,73207240,"Xa Ngoài Kia Nơi Loài Tôm Hát - Where The Crawdads Sing",105000,165000,60000,36
TIKI,nha-sach-tiki,174301838,"BỘ BOOKMARK 1% TINH HOA",49000,49000,0,0
TIKI,nha-sach-tiki,108259024,"Combo Sách Osho - Đàn Ông + Đàn Bà + Ươm Mầm",299500,299500,0,0
TIKI,nha-sach-tiki,121635154,"Điều Đẹp Nhất Có Khi Là Buông Tay (Tặng Kèm Bookmark)",51000,72000,21000,29
TIKI,nha-sach-tiki,105617716,"(Gift) Bút ký khắc tên cao cấp LC036, xoay mực bi, mượt đều cở mọi góc nghiêng",399000,399000,0,0
TIKI,nha-sach-tiki,174444163,"Dear, Darling",62900,88000,25100,29
TIKI,nha-sach-tiki,52789367,"Nhà Giả Kim (Tái Bản 2020)",54000,79000,25000,32
TIKI,nha-sach-tiki,105631243,"(Gift) Bút ký khắc tên cao cấp thép nguyên khối LC002,  sơn tĩnh cao cấp dành cho doanh nhân",290000,290000,0,0
TIKI,nha-sach-tiki,147920903,"Một Thoáng Ta Rực Rỡ Ở Nhân Gian",99000,135000,36000,27
TIKI,nha-sach-tiki,117254517,"Đại Dương Đen - Những Câu Chuyện Từ Thế Giới Của Trầm Cảm",186000,240000,54000,23
TIKI,nha-sach-tiki,180592885,"Combo 2Q: Mong Mẹ Hãy Yêu Lấy Chính Mình + Cơ Thể Tự Chữa Lành: Nước Ép Cần Tây",197500,197500,0,0
TIKI,nha-sach-tiki,42230121,"Sách Hiểu Về Trái Tim (Tái Bản 2019) - Minh Niệm",129000,158000,29000,18
TIKI,nha-sach-tiki,141739123,"Ruột bút kim loại 0.5 mm và 0.7 mm, mực mịn đều ở mọi góc nghiêng cầm bút",170000,170000,0,0
TIKI,nha-sach-tiki,197719874,"Suy Nghĩ Thống Kê Trong Đời Thường",105000,160000,55000,34
TIKI,nha-sach-tiki,117238177,"Thư Viện Nửa Đêm",114000,150000,36000,24
TIKI,nha-sach-tiki,195801653,"Chú Thuật Hồi Chiến - Tập 6 - Bản Tặng Kèm Obi Và Thẻ Bo Góc Nhựa",30000,30000,0,0
TIKI,nha-sach-tiki,73787185,"Những Tù Nhân Của Địa Lý",139000,210000,71000,34
TIKI,nha-sach-tiki,190861557,"Yêu Những Ngày Nắng Chẳng Ghét Những Ngày Mưa",106000,132000,26000,20
TIKI,nha-sach-tiki,194959173,"Semantic Error – Lỗi Logic (Tập 2)",194000,259000,65000,25
TIKI,nha-sach-tiki,157432544,"Giải Thích Ngữ Pháp Tiếng Anh (Với Bài Tập Và Đáp Án) (Tái Bản)",142000,220000,78000,35
TIKI,nha-sach-tiki,121635152,"Không Ai Có Thể Làm Bạn Tổn Thương Trừ Khi Bạn Cho Phép (Tặng Kèm 1 Bộ Bookmark Gồm 4 Cái)",84000,119000,35000,29
TIKI,nha-sach-tiki,143217512,"Điềm Tĩnh Và Nóng Giận",69600,96000,26400,28
TIKI,nha-sach-tiki,97594364,"Luật Tâm Thức - Giải Mã Ma Trận Vũ Trụ",226000,292000,66000,23
TIKI,nha-sach-tiki,145288029,"Xứ Cát",186000,249000,63000,25
TIKI,nha-sach-tiki,46240929,"Rèn Luyện Tư Duy Phản Biện",68000,99000,31000,31
TIKI,nha-sach-tiki,3954355,"Yêu Những Điều Không Hoàn Hảo",98500,139000,40500,29
TIKI,nha-sach-tiki,85763211,"Hãy Khiến Tương Lai Biết Ơn Vì Hiện Tại Bạn Đã Cố Gắng Hết Mình (Tặng Kèm: 01 Bookmark)",68800,99000,30200,31
TIKI,nha-sach-tiki,196515658,"Blue Period - Tập 04",43100,48000,4900,10
TIKI,nha-sach-tiki,3304875,"Điều Kỳ Diệu Của Tiệm Tạp Hóa NAMIYA (Tái Bản)",80900,105000,24100,23
TIKI,nha-sach-tiki,193151000,"Trend Following – Cách thức để kiếm được VẬN MAY LỚN và GIÀU CÓ trong các thị trường BÒ, GẤU và các sự kiện THIÊN NGA ĐEN",599000,599000,0,0
TIKI,nha-sach-tiki,195969664,"Tokyo Revengers - Tập 4",37000,115000,78000,68
TIKI,nha-sach-tiki,194960721,"Blue Period - Tập 03",34100,48000,13900,29
TIKI,nha-sach-tiki,106863963,"Tâm Lý Học - Phác Họa Chân Dung Kẻ Phạm Tội",105000,145000,40000,28
TIKI,nha-sach-tiki,271061349,"Cách đưa bạn trở thành siêu sao nơi công sở - How to Be the Employee Your Company Can't Live Without",249000,249000,0,0
TIKI,nha-sach-tiki,72882553,"Kỷ Luật Tự Giác (Tặng Kèm Bookmark )",58000,84000,26000,31
TIKI,nha-sach-tiki,10095276,"Ikigai - Bí Mật Sống Trường Thọ Và Hạnh Phúc Của Người Nhật",69200,90000,20800,23
TIKI,nha-sach-tiki,72459686,"How Psychology Works - Hiểu Hết Về Tâm Lý Học",225000,300000,75000,25
TIKI,nha-sach-tiki,111285062,"Đắc Nhân Tâm (Bìa Mềm)(Tái Bản)",62300,86000,23700,28
TIKI,nha-sach-tiki,8885999,"Totto - Chan Bên Cửa Sổ (Tái Bản)",67000,98000,31000,32
TIKI,nha-sach-tiki,68585576,"Càng Kỷ Luật, Càng Tự Do",78600,109000,30400,28
TIKI,nha-sach-tiki,195357772,"Máy Tính CASIO FX-880BTG - Màu Đen",696000,800000,104000,13
TIKI,nha-sach-tiki,273536931,"Kinh Doanh Thời Trang - 8 Bước Xây Dựng, Vận Hành Và Phát Triển Shop Quần Áo Của Bạn",155000,199000,44000,22
TIKI,nha-sach-tiki,115086647,"(Gift) Bút ký khắc tên cao cấp Doanh nhân LC 011, đẳng cấp và sang trọng, mực đều ở mọi góc nghiêng",680000,680000,0,0
TIKI,nha-sach-tiki,175553095,"Combo 2Q: Lãnh Đạo Và Văn Hóa Doanh Nghiệp + How Management Works - Hiểu Hết Về Quản Lý (Sách Quản Lý/Quản Trị Nhân Lực Thành Công)",450500,450500,0,0
TIKI,nha-sach-tiki,115281323,"(Gift) Bút ký khắc tên cao cấp Doanh nhân LC048, mực mịn, đều ở mọi góc nghiêng",380000,380000,0,0
TIKI,nha-sach-tiki,113530805,"Tuổi Trẻ Đáng Giá Bao Nhiêu (Tái Bản)",61100,90000,28900,32
TIKI,nha-sach-tiki,161008715,"Power Vs Force - Trường Năng Lượng Và Những Nhân Tố Quyết Định Hành Vi Của Con Người (Tái Bản)",127000,179000,52000,29
TIKI,nha-sach-tiki,54614797,"Có Một Ngày, Bố Mẹ Sẽ Già Đi",66200,96000,29800,31
TIKI,nha-sach-tiki,168283405,"Chiến Tranh Tiền Tệ - Phần 1 - Ai Thực Sự Là Người Giàu Nhất Thế Giới ( Tái Bản 2022)",106000,165000,59000,36
TIKI,nha-sach-tiki,184075874,"(Gift) Bút ký khắc tên cao cấp LC 010, đẹp, mực mịn đều ở mọi góc nghiêng",159000,159000,0,0
TIKI,nha-sach-tiki,184785575,"Bút Rồng Hoàng Gia cao cấp dành cho Doanh nhân LC056",399000,399000,0,0
TIKI,nha-sach-tiki,105631243,"(Gift) Bút ký khắc tên cao cấp thép nguyên khối LC002,  sơn tĩnh cao cấp dành cho doanh nhân",290000,290000,0,0
TIKI,nha-sach-tiki,170352283,"Đi Gặp Mùa Xuân - Hành Trạng Thiền Sư Thích Nhất Hạnh",305500,305500,0,0
TIKI,nha-sach-tiki,272412121,"THUẬT LÃNH ĐẠO nơi công sở - How to Manage Problem Employees",249000,249000,0,0
TIKI,nha-sach-tiki,197344455,"Ikigami - The Ultimate Limit - Tuyển Tập Những Câu Chuyện Lay Động Lòng Người - Tập 9",45000,45000,0,0
TIKI,nha-sach-tiki,3639597,"Bước Chậm Lại Giữa Thế Gian Vội Vã (Tái Bản)",64500,85000,20500,24
TIKI,nha-sach-tiki,4780917,"Người Đua Diều (Tái Bản 2018)",100000,129000,29000,22
TIKI,nha-sach-tiki,71345381,"Sách Thay Đổi Cuộc Sống Với Nhân Số Học - Lê Đỗ Quỳnh Hương",181000,248000,67000,27
TIKI,nha-sach-tiki,22777661,"Combo Truyện Cổ Grim + Thần Thoại Hy Lạp + Truyện Cổ Andecxen",455002,455002,0,0
TIKI,nha-sach-tiki,184466860,"Hành Tinh Của Một Kẻ Nghĩ Nhiều",64000,86000,22000,26
TIKI,nha-sach-tiki,161008717,"Kiếp Nào Ta Cũng Tìm Thấy Nhau: Câu Chuyện Về Những Linh Hồn Tri Kỷ Vĩnh Viễn Không Chia Lìa (Tái Bản)",66800,99000,32200,33
TIKI,nha-sach-tiki,271442564,"Sổ planner 52 tuần 2024 SDstationery “Treasure the Journey” gáy lò xo, họa tiết màu pastel trang nhã 14x20.3cm",112000,132000,20000,15
TIKI,nha-sach-tiki,15267827,"Hoàng Tử Bé (Tái Bản 2019)",53000,75000,22000,29
TIKI,nha-sach-tiki,92859698,"Tâm Lý Học Biểu Cảm",65500,98000,32500,33
TIKI,nha-sach-tiki,49747007,"Hai Mặt Của Gia Đình",68500,98000,29500,30
TIKI,nha-sach-tiki,8885995,"Sự Im Lặng Của Bầy Cừu (Tái Bản)",85300,115000,29700,26
TIKI,nha-sach-tiki,78598381,"Tâm Lý Học Tính Cách (Tặng Kèm: 1 Bookmark)",76900,109000,32100,29
TIKI,nha-sach-tiki,59478514,"Combo 2 Cuốn: Osho Đàn Ông + Osho Phụ Nữ",201500,201500,0,0
TIKI,nha-sach-tiki,57325187,"Sách Người Giàu Có Nhất Thành Babylon (Tái Bản 2020)",64000,98000,34000,35
TIKI,nha-sach-tiki,161310103,"Từ Vựng IELTS 8.0 - Từ Vựng Đắt Để Đạt Điểm Cao 4 Kỹ Năng",89000,135000,46000,34
TIKI,nha-sach-tiki,104612965,"FLASHCARD SachID Moon",10000,10000,0,0
TIKI,nha-sach-tiki,113964351,"(Gift)Bút ký khắc tên cao cấp Doanh nhân 006, thép nguyên khối, mực bi đều ở mọi góc nghiêng",450000,450000,0,0
TIKI,nha-sach-tiki,193614514,"[Gift] Tặng 01 bookmark cho mỗi đơn hàng",19500,30000,10500,35
TIKI,nha-sach-tiki,108259024,"Combo Sách Osho - Đàn Ông + Đàn Bà + Ươm Mầm",299500,299500,0,0
TIKI,nha-sach-tiki,106318762,"Sách ID Tiếng Anh cho người mới bắt đầu - người mới mất gốc Cô Trang Anh",159000,200000,41000,21
TIKI,nha-sach-tiki,90622579,"Tâm Lý Học - Nghệ Thuật Giải Mã Hành Vi",96100,150000,53900,36
TIKI,nha-sach-tiki,197558905,"Komi - Nữ Thần Sợ Giao Tiếp - Tập 13",24800,25000,200,1
TIKI,nha-sach-tiki,20917699,"Làm Sao Học Ít Hiểu Nhiều",82700,128000,45300,35
TIKI,nha-sach-tiki,75307228,"Sách OSHO Yêu - Being In Love - Yêu Trong Tỉnh Thức",116000,168000,52000,31
TIKI,nha-sach-tiki,54266567,"Sách Nghĩ Giàu Và Làm Giàu (Bìa Mềm)",78000,110000,32000,29
TIKI,nha-sach-tiki,168373800,"Sách - Thao túng tâm lý - 1980BOOKS",118000,169000,51000,30
TIKI,nha-sach-tiki,52788072,"Chiến Binh Cầu Vồng (Tái Bản 2020)",84500,109000,24500,22
TIKI,nha-sach-tiki,187338036,"Chiến Tranh Tiền Tệ - Tập 4",116700,185000,68300,37
TIKI,nha-sach-tiki,106185389,"Tổng ôn ngữ pháp Tiếng Anh cô Trang Anh- Sách luyện thi THPT Quốc gia môn tiếng anh",189000,250000,61000,24
TIKI,nha-sach-tiki,114937969,"Rừng Nauy (Tái Bản)",115000,150000,35000,23
TIKI,nha-sach-tiki,76388962,"Chúng Ta Rồi Sẽ Hạnh Phúc, Theo Những Cách Khác Nhau [Tặng Kèm: 01 Bookmark]",61400,86000,24600,29
TIKI,nha-sach-tiki,7833728,"Dạy Con Làm Giàu (Tập 1) - Để Không Có Tiền Vẫn Tạo Ra Tiền - Cha Giàu Cha Nghèo (Tái Bản)",49100,80000,30900,39
TIKI,nha-sach-tiki,171556602,"2030: Những Xu Hướng Lớn Sẽ Định Hình Thế Giới Tương Lai (Tái Bản Lần 1)",155000,209000,54000,26
TIKI,nha-sach-tiki,77774625,"Nghệ Thuật Tập Trung - Nâng Cao Năng Suất, Tối Ưu Thời Gian, Hiệu Quả Bất Ngờ",68300,99000,30700,31
TIKI,nha-sach-tiki,10005245,"Đàn Ông Sao Hỏa Đàn Bà Sao Kim",134000,188000,54000,29
TIKI,nha-sach-tiki,112110014,"TÂM LÝ HỌC ỨNG DỤNG",89800,129000,39200,30
TIKI,nha-sach-tiki,53720978,"Trong Cái Không Có Gì Không ? (Thiền Sư Thích Nhất Hạnh Trả Lời Cho Trẻ Em Những Thắc Mắc Về Ý Nghĩa Cuộc Sống, Về Cái Chết, Về Gia Đình, Bạn Bè Và Nhiều Câu Hỏi Khác)",113000,160000,47000,29
TIKI,nha-sach-tiki,109505434,"Bạn Không Thông Minh Lắm Đâu (Tái Bản)(Tặng kèm Bookmark)",96300,139000,42700,31
TIKI,nha-sach-tiki,19792256,"Chuyện Con Mèo Dạy Hải Âu Bay (Tái Bản 2019)",37200,49000,11800,24
TIKI,nha-sach-tiki,69978860,"Sói đội lốt Cừu - Kẻ hiếu chiến ngầm và các thủ thuật thao túng tâm lí",75000,110000,35000,32
TIKI,nha-sach-tiki,173748415,"Tâm Lý Học Mối Quan Hệ",69200,98000,28800,29
TIKI,nha-sach-tiki,80628929,"Từ IQ Đến EQ - Nắm Bắt Thành Công Qua Trí Tuệ Cảm Xúc",63500,91000,27500,30
TIKI,nha-sach-tiki,103640412,"Đừng Lựa Chọn An Nhàn Khi Còn Trẻ (Tái Bản)",69000,99000,30000,30
TIKI,nha-sach-tiki,70016692,"Bắt Trẻ Đồng Xanh (Tái Bản 2020)",60000,88000,28000,32
TIKI,nha-sach-tiki,5067169,"Luật Hấp Dẫn (Tái Bản)",66300,89000,22700,26
TIKI,nha-sach-tiki,103379147,"Bạch Dạ Hành (Tái Bản)",156000,209000,53000,25
TIKI,nha-sach-tiki,196923457,"Blue Flag - Tập 2",44100,45000,900,2
TIKI,nha-sach-tiki,195969669,"Chào Mừng Đến Lớp Học Đề Cao Thực Lực - 3",63000,120000,57000,48
TIKI,nha-sach-tiki,147999778,"Không Bao Giờ Là Thất Bại - Tất Cả Là Thử Thách (Ấn Bản Cập Nhật Đầy Đủ Nhất)(Bìa Cứng)",141000,268000,127000,47
TIKI,nha-sach-tiki,70224520,"Băng keo dán nano 2 mặt siêu dính trong suốt dày 1mm dài 2m rộng 3cm và 5cm",17999,17999,0,0
TIKI,nha-sach-tiki,91947689,"7 Thói Quen Hiệu Quả (The 7 Habits Of Highly Effective People) (Tái Bản)",191000,250000,59000,24
TIKI,nha-sach-tiki,197344441,"Như Cơn Gió Thoảng - Nghĩ Về Những Qui Luật Cuộc Sống",80500,80500,0,0
TIKI,nha-sach-tiki,168293266,"Chiến Tranh Tiền Tệ - Phần 2 - Sự Thống Trị Của Quyền Lực Tài Chính ( Tái Bản 2022)",111000,170000,59000,35
TIKI,nha-sach-tiki,174215347,"Ajin - Boxset Số 3 (Tập 13 - 17) - Tặng Kèm Bookmark 3D",192000,270000,78000,29
TIKI,nha-sach-tiki,3608625,"Payback Time - Ngày Đòi Nợ",299000,299000,0,0
TIKI,nha-sach-tiki,82912488,"Từ Tốt Đến Vĩ Đại (Tái bản 2021)",75000,130000,55000,42
TIKI,nha-sach-tiki,138107485,"Mặt Dày Tâm Đen (Tái Bản)",109000,169000,60000,36
TIKI,nha-sach-tiki,8835159,"Đời Ngắn Đừng Ngủ Dài (Tái Bản)",62200,85000,22800,27
TIKI,nha-sach-tiki,140416370,"Dòng Chảy",167000,228000,61000,27
TIKI,nha-sach-tiki,23416722,"How The Body Works - Hiểu Hết Về Cơ Thể",203000,300000,97000,32
TIKI,nha-sach-tiki,72001057,"Chiến Tranh Tiền Tệ - Phần III",112000,175000,63000,36
TIKI,nha-sach-tiki,56454897,"Hiệu Sách Nhỏ Ở Paris",110000,149000,39000,26
TIKI,nha-sach-tiki,139303869,"Nghệ Thuật Tinh Tế Của Việc Đếch Quan Tâm (Tái Bản)",83000,128000,45000,35
TIKI,nha-sach-tiki,74341297,"Không Sợ Chậm Chỉ Sợ Dừng",92400,129000,36600,28
TIKI,nha-sach-tiki,148760924,"How Management Works - Hiểu Hết Về Quản Lý",240000,330000,90000,27
TIKI,nha-sach-tiki,72308265,"Hoa Vẫn Nở Mỗi Ngày",140400,234000,93600,40
TIKI,nha-sach-tiki,194205608,"Cherry Magic - Tập 2",86500,109000,22500,21
TIKI,nha-sach-tiki,192115858,"Chú Thuật Hồi Chiến -  Tập 5 - Giao Lưu Trường Kết Nghĩa Kyoto [Tặng Kèm Obi Và Thẻ Bo Góc Nhựa]",30000,30000,0,0
TIKI,nha-sach-tiki,195801662,"Ngôi Sao Vườn Nữ Sinh - Tập 1",49100,50000,900,2
TIKI,nha-sach-tiki,127844385,"Kiêu Hãnh Và Định Kiến (Tái Bản)",86000,116000,30000,26
TIKI,nha-sach-tiki,7718737,"Nghệ Thuật Tư Duy Rành Mạch (Tái Bản)",85100,118000,32900,28
TIKI,nha-sach-tiki,197344439,"Kingdom - Tập 34",43600,45000,1400,3
TIKI,nha-sach-tiki,157255752,"Sức Mạnh Của Hiện Tại (Tái Bản)",116000,168000,52000,31
TIKI,nha-sach-tiki,181699664,"Những Ngã Tư Và Những Cột Đèn",148000,200000,52000,26
TIKI,nha-sach-tiki,74362508,"Thần Số Học Ứng Dụng",78000,129000,51000,40
TIKI,nha-sach-tiki,196016785,"Ikigami - Tập 08",40400,45000,4600,10
TIKI,nha-sach-tiki,59262880,"Sách Người Bán Hàng Vĩ Đại Nhất Thế Giới (Tái Bản 2020)",102000,148000,46000,31
TIKI,nha-sach-tiki,27582931,"How Money Works - Hiểu Hết Về Tiền",218000,300000,82000,27
TIKI,nha-sach-tiki,184070223,"OSHO - Cảm Xúc",130000,188000,58000,31
TIKI,nha-sach-tiki,76013378,"Storytelling With Data - Kể Chuyện Thông Qua Dữ Liệu (Cuốn Cẩm Nang Hướng Dẫn Trực Quan Hóa Dữ Liệu)",222100,319000,96900,30
TIKI,nha-sach-tiki,196851308,"Dragon Ball Full Color - Phần Năm: Truy Lùng Cell Bọ Hung - Tập 4",76500,77000,500,1
TIKI,nha-sach-tiki,167972598,"Tôi Thích Bản Thân Nỗ Lực Hơn (Ấn Bản Kỷ Niệm)",84500,120000,35500,30
TIKI,nha-sach-tiki,173882437,"8 Vụ Án Hoàn Hảo - Vạch Trần Tâm Lý Kẻ Phạm Tội",101000,145000,44000,30
TIKI,nha-sach-tiki,120219394,"Tôi Nói Gì Khi Nói Về Chạy Bộ",53000,76000,23000,30
TIKI,nha-sach-tiki,94173458,"Khuyến Học (Tái Bản)",47100,65000,17900,28
TIKI,nha-sach-tiki,107802183,"Sách Sức Mạnh Tiềm Thức (Tái Bản) (Bìa Mềm)",91700,128000,36300,28
TIKI,nha-sach-tiki,85396163,"Combo 2 Cuốn: Yêu Những Điều Không Hoàn Hảo + Bước Chậm Lại Giữa Thế Gian Vội Vã (Tái Bản)",165000,224000,59000,26
TIKI,nha-sach-tiki,196409700,"Công Chúa Ma Cà Rồng Quyền Năng Chỉ Muốn Có Một Người Em Gái Mà Thôi",147000,175000,28000,16
TIKI,nha-sach-tiki,192124399,"Blue Period Tập 2",34000,48000,14000,29
TIKI,nha-sach-tiki,55605170,"Cơ Thể Tự Chữa Lành: Thực Phẩm Thay Đổi Cuộc Sống",119000,185000,66000,36
TIKI,nha-sach-tiki,76776245,"Nghệ Thuật Tư Duy Phản Biện",85900,129000,43100,33
TIKI,nha-sach-tiki,173763072,"Tâm Lý Học Hẹn Hò - Nghệ Thuật Giao Tiếp Trong Tình Yêu",78000,109000,31000,28
TIKI,nha-sach-tiki,179546672,"Làm Sao Học Hết Được Nhân Sinh",130000,169000,39000,23
TIKI,nha-sach-tiki,108684605,"Trí Thông Minh Của Sự Tinh Tế",63600,89000,25400,29
TIKI,nha-sach-tiki,124767703,"Cân Bằng Cảm Xúc Cả Lúc Bão Giông (Tặng Kèm Bookmark)(Tái Bản)",67100,105000,37900,36
TIKI,nha-sach-tiki,273624916,"[ Trạm Đọc Official ]  Trí Tuệ Do Thái (Tái Bản)",142000,189000,47000,25
TIKI,nha-sach-tiki,154245455,"Combo 2 Cuốn Nghiền Từ Vựng Tiếng Anh: Học Qua Gốc Từ Bằng Hình Ảnh - Gốc Từ Là Bí Quyết Để Ghi Nhớ Hàng Nghìn Từ Vựng",177000,270000,93000,34
TIKI,nha-sach-tiki,105663942,"Hành Trình Về Phương Đông (Tái Bản 2021)",83000,118000,35000,30
TIKI,nha-sach-tiki,158019962,"Combo 3 Cuốn Bộ Sách: Nuôi Con Không Phải Là Cuộc Chiến 2 (Tái Bản)",260000,377000,117000,31
TIKI,nha-sach-tiki,71907876,"Từ Điển Tiếng “Em”",48200,69000,20800,30
TIKI,nha-sach-tiki,8886007,"Ngàn Mặt Trời Rực Rỡ (Tái Bản)",99000,130000,31000,24
TIKI,nha-sach-tiki,139567621,"Thức Tỉnh Mục Đích Sống (Tái Bản)",98000,148000,50000,34
TIKI,nha-sach-tiki,195885688,"Dragon Quest - Dấu Ấn Roto (Dragon Quest Saga Emblem Of Roto) Perfect Edition - Tập 9",74100,75000,900,1
TIKI,nha-sach-tiki,52329763,"Kafka bên bờ biển (Tái Bản 2020)",113000,158000,45000,28
TIKI,nha-sach-tiki,194205620,"Người Hướng Nội Trong Thế Giới Hướng Ngoại",79000,105000,26000,25
TIKI,nha-sach-tiki,195187480,"Thiên Quan Tứ Phúc - Tập 6 (Tiểu thuyết, đam mỹ)",110700,159000,48300,30
TIKI,nha-sach-tiki,163703151,"Chuyện Kể Rằng Có Nàng Và Tôi",51600,72000,20400,28
TIKI,nha-sach-tiki,149089470,"Những Vị Thần Nước Mỹ",187000,250000,63000,25
TIKI,nha-sach-tiki,100931416,"Bắt Đầu Với Câu Hỏi Tại Sao - Nghệ Thuật Truyền Cảm Hứng Trong Kinh Doanh (Tái Bản)",77500,109000,31500,29
TIKI,nha-sach-tiki,105483727,"Ổn Định Hay Tự Do",91900,129000,37100,29
TIKI,nha-sach-tiki,185067342,"Tô Bình Yên Vẽ Hạnh Phúc (Tái Bản)",62000,88000,26000,30
TIKI,nha-sach-tiki,540039,"Giáo Trình Chuẩn HSK 1 - Bài Học (Kèm file MP3)",149000,198000,49000,25
TIKI,nha-sach-tiki,191920180,"Cherry Magic - Tập 1",86500,109000,22500,21
TIKI,nha-sach-tiki,13333355,"Đọc Nhiều Nhớ Được Bao Nhiêu?",76200,118000,41800,35
TIKI,nha-sach-tiki,3644267,"Đặc Quyền Của Gái Hư",61400,86000,24600,29
TIKI,nha-sach-tiki,179735872,"Sách Tâm Lý Dành Cho Người Nhạy Cảm",62700,89000,26300,30
TIKI,nha-sach-tiki,171549981,"Cuộc Diễu Hành Thầm Lặng",148000,198000,50000,25
TIKI,nha-sach-tiki,168234714,"Cư Xử Như Đàn Bà Suy Nghĩ Như Đàn Ông",78100,109000,30900,28
TIKI,nha-sach-tiki,196422809,"Bá Tước Tiểu Thư - Tập 3",30000,30000,0,0
TIKI,nha-sach-tiki,197353399,"Học Viện Siêu Anh Hùng Vigilantes - My Hero Academia Illegals - Tập 1: Đã Có Ta Ở Đây",29000,30000,1000,3
TIKI,nha-sach-tiki,185071145,"Sói Đầu Đàn Và Cún Nhỏ - Tập 2",105000,135000,30000,22
TIKI,nha-sach-tiki,126743459,"Fear - Sợ Hãi (Hóa Giải Sợ Hãi Bằng Tình Thương)",76100,109000,32900,30
TIKI,nha-sach-tiki,104741661,"Combo 2 Tập : 999 Lá Thư Gửi Cho Chính Mình (Tái Bản)",193000,258000,65000,25
TIKI,nha-sach-tiki,35191892,"21 Bài Học Cho Thế Kỷ 21",161000,209000,48000,23
TIKI,nha-sach-tiki,54422942,"Tôi Quyết Định Sống Cho Chính Tôi (Tái Bản 2020)",59400,88000,28600,33
TIKI,nha-sach-tiki,194960238,"Slam Dunk - Deluxe Edition - Tập 10",55000,60000,5000,8
TIKI,nha-sach-tiki,152740748,"Lối Sống Tối Giản Của Người Nhật (Tái Bản)",84700,119000,34300,29
TIKI,nha-sach-tiki,197781975,"Dr.Slump Ultimate Edition Tập 12",59500,60000,500,1
TIKI,nha-sach-tiki,77105730,"Tàn Ngày Để Lại (Bìa Cứng)",126000,169000,43000,25
TIKI,nha-sach-tiki,196016781,"Kingdom - Tập 33",42000,45000,3000,7
TIKI,nha-sach-tiki,3608623,"Bí Mật Của Phan Thiên Ân",69000,69000,0,0
TIKI,nha-sach-tiki,54748899,"Sách Muôn Kiếp Nhân Sinh (Bìa Mềm) - Nguyên Phong",117000,168000,51000,30
TIKI,nha-sach-tiki,196851310,"Migi & Dali - Tập 2",39000,40000,1000,3
TIKI,nha-sach-tiki,185242031,"The Shining - Thị Kiến",200000,269000,69000,26
TIKI,nha-sach-tiki,45902241,"Tìm Mình Trong Thế Giới Hậu Tuổi Thơ",105000,142000,37000,26
TIKI,nha-sach-tiki,191571494,"Black Jack - Tập 12",30000,30000,0,0
TIKI,nha-sach-tiki,750578,"Khi Hơi Thở Hóa Thinh Không",74000,109000,35000,32
TIKI,nha-sach-tiki,14508205,"Sổ tay thực hành 66 ngày thử thách",89000,89000,0,0
TIKI,nha-sach-tiki,196515664,"Anh Em Phi Hành Gia - Tập 33",44500,45000,500,1
TIKI,nha-sach-tiki,196515661,"Văn Phòng Thám Tử Quái Vật - Tập 12",23500,30000,6500,22
TIKI,nha-sach-tiki,183058543,"OSHO - Trưởng Thành",88600,128000,39400,31
TIKI,nha-sach-tiki,57110087,"Siêu Cò – How To Be A Power Connector",249000,249000,0,0
TIKI,nha-sach-tiki,187827003,"Không Diệt Không Sinh Đừng Sợ Hãi (TB5)",74500,110000,35500,32
TIKI,nha-sach-tiki,73878873,"Tư Duy Sâu",63100,91000,27900,31
TIKI,nha-sach-tiki,12377498,"Bố Con Cá Gai (Tái Bản 2019)",73900,96000,22100,23
TIKI,nha-sach-tiki,167210779,"Quyền Lực",111000,155000,44000,28
TIKI,nha-sach-tiki,196923451,"Vua Sáng Chế - Tập 17",20000,20000,0,0
TIKI,nha-sach-tiki,87226756,"Những Đêm Không Ngủ, Những Ngày Chậm Trôi",56000,86000,30000,35
TIKI,nha-sach-tiki,53532186,"Tuyệt kỹ Giao dịch bằng đồ thị nến Nhật – Japanese Candlestick Charting Techniques",499000,499000,0,0
TIKI,nha-sach-tiki,378448,"Nhà Giả Kim",66950,66950,0,0
TIKI,nha-sach-tiki,110448022,"Ba Phút Sơ Cứu",104000,140000,36000,26
TIKI,nha-sach-tiki,57762732,"Nhà Đầu Tư Thông Minh (Tái Bản 2020)",154000,199000,45000,23
TIKI,nha-sach-tiki,170708233,"Thay Đổi Tí Hon - Hiệu Quả Bất Ngờ (Tái Bản)",140000,189000,49000,26
TIKI,nha-sach-tiki,158019964,"Combo 4 Cuốn Bộ Sách: Nuôi Con Không Phải Là Cuộc Chiến (Tái Bản)",350300,506000,155700,31
TIKI,nha-sach-tiki,195190105,"Color Rush - Bản Thông Thường",224000,265000,41000,15
TIKI,nha-sach-tiki,162844699,"Tạm Biệt Tôi Của Nhiều Năm Về Trước",67800,95000,27200,29
TIKI,nha-sach-tiki,17336360,"Lolita (Tái Bản 2019)",92400,128000,35600,28
TIKI,nha-sach-tiki,90887853,"Mình Chỉ Là Người Bình Thường (Sách Tô Màu)",97500,138000,40500,29
TIKI,nha-sach-tiki,50414368,"Án Mạng Mười Một Chữ",75100,110000,34900,32
TIKI,nha-sach-tiki,115266692,"Sách - Ám Ảnh Sợ Xã Hội - Chạy Trốn Hay Đối Mặt",82900,125000,42100,34
TIKI,nha-sach-tiki,84970841,"Men Chase Women Choose - Chuyện Tình Yêu Bạn Biết Được Bao Nhiêu?",73600,109000,35400,32
TIKI,nha-sach-tiki,145289356,"Sách Atomic Habits - Thay Đổi Tí Hon, Hiệu Quả Bất Ngờ ( Những Thay Đổi Nhỏ Tạo Nên Thành Công Lớn/ Tặng kèm Bookmark)",160000,189000,29000,15
TIKI,nha-sach-tiki,173865570,"Một Cuốn Sách Về Chủ Nghĩa Tối Giản (Tái bản 2022)",129000,129000,0,0
TIKI,nha-sach-tiki,9948009,"Dám Hạnh Phúc",78100,110000,31900,29
TIKI,nha-sach-tiki,186237324,"Thiên quan tứ phúc - Tập 5 (Tiểu thuyết đam mỹ) - Tặng kèm 1 bookmark 2 mặt",110700,159000,48300,30
TIKI,nha-sach-tiki,128649312,"21 Nguyên Tắc Tự Do Tài Chính (Tái Bản)",37500,55000,17500,32
TIKI,nha-sach-tiki,100321478,"Muốn An Được An (Tái bản 2021)",43000,65000,22000,34
TIKI,nha-sach-tiki,641906,"Bí Mật Của Naoko",78900,108000,29100,27
TIKI,nha-sach-tiki,145288026,"Chia Rẽ - Tại Sao Chúng Ta Đang Sống Trong Thời Đại Của Những Bức Tường",149000,200000,51000,26
TIKI,nha-sach-tiki,86517373,"Khoa Học Về Nấu Ăn - The Science Of Cooking",267000,350000,83000,24
TIKI,nha-sach-tiki,168559521,"Sự Trung Thực Của Xác Chết – Ghi Chép Của Một Nhà Pháp Y",68300,99000,30700,31
TIKI,nha-sach-tiki,73515859,"Sách OSHO - Can Đảm Là Chính Mình Trong Thế Giới Hiểm Nguy",61100,88000,26900,31
TIKI,nha-sach-tiki,179063952,"Khi Mọi Điểm Tựa Đều Mất",65200,98000,32800,33
TIKI,nha-sach-tiki,104074997,"Kỹ Năng Bán Hàng Tuyệt Đỉnh (Tái Bản)",77000,120000,43000,36
TIKI,nha-sach-tiki,155550591,"Dinh Dưỡng Học Bị Thất Truyền - Dinh Dưỡng Đẩy Lùi Bệnh Tật",115000,178000,63000,35
TIKI,nha-sach-tiki,102629318,"999 Lá Thư Gửi Cho Chính Mình (*) - Tập 1 - Mong Bạn Trở Thành Phiên Bản Hoàn Hảo Nhất (Tái bản)",92400,129000,36600,28
TIKI,nha-sach-tiki,197990865,"Dragon Quest - Dấu Ấn Roto (Dragon Quest Saga Emblem Of Roto) Perfect Edition - Tập 10",73800,75000,1200,2
TIKI,nha-sach-tiki,11122712,"Bộ sách Làm Giàu Từ Chứng Khoán (How To Make Money In Stock) phiên bản mới + Hướng Dẫn Thực Hành CANSLIM Cho Người Mới Bắt Đầu",700000,700000,0,0
TIKI,nha-sach-tiki,196515668,"Quán Rượu Dị Giới "Nobu" - Tập 11",35000,40000,5000,13
TIKI,nha-sach-tiki,130233544,"Mèo Và Triết Lý Nhân Sinh - Mèo Đã Dạy Chúng Ta Điều Gì Về Cuộc Sống",145500,209000,63500,30
TIKI,nha-sach-tiki,7982628,"Suối Nguồn (Tái Bản)",229000,380000,151000,40
TIKI,nha-sach-tiki,540040,"Giáo Trình Chuẩn HSK 1 - Bài Tập (Kèm file MP3)",119000,158000,39000,25
TIKI,nha-sach-tiki,179546078,"Luật Hấp Dẫn - Quy Luật Về Sức Mạnh Tâm Trí Và Phát Huy Năng Lượng Tích Cực Để Làm Chủ Định Mệnh",81500,139000,57500,41
TIKI,nha-sach-tiki,56692532,"Tôi Từng Nghĩ Mọi Thứ Sẽ Ổn Khi Trở Thành Người Lớn (Tặng Kèm 1 Bookmark)",66500,96000,29500,31
TIKI,nha-sach-tiki,193434490,"Ikigami - Tập 07",32000,45000,13000,29
TIKI,nha-sach-tiki,73316977,"Hành Trình Của Linh Hồn (Tái Bản 2020)",89300,129000,39700,31
TIKI,nha-sach-tiki,828621,"Dolocher (Trinh Thám)",44000,159000,115000,72
TIKI,nha-sach-tiki,2496281,"Đồi Gió Hú (Tái Bản)",80500,108000,27500,25
TIKI,nha-sach-tiki,11368965,"Combo Giáo Trình Chuẩn HSK 1 - Bài Học (Kèm 1 MP3) và Giáo Trình Chuẩn HSK 1 - Bài Tập (Kèm 1 MP3) ( Tặng Kèm Viết )",284800,356000,71200,20
TIKI,nha-sach-tiki,66090079,"Cơ Thể Tự Chữa Lành: Giải Cứu Gan",161000,250000,89000,36
TIKI,nha-sach-tiki,106864418,"Combo 10 Cuốn: Chuyện Xóm Gà",407000,580000,173000,30
TIKI,nha-sach-tiki,35283863,"Lược Sử Thế Giới",219000,320000,101000,32
TIKI,nha-sach-tiki,174842858,"Sách Sức Mạnh Của Ngôn Từ (Tái Bản 2022)",74600,108000,33400,31
TIKI,nha-sach-tiki,126743464,"Kế Hoạch Của Linh Hồn - Khám Phá Ý Nghĩa Cuộc Sống Mà Bạn Đã Lên Kế Hoạch Trước Khi Sinh Ra",116000,169000,53000,31
TIKI,nha-sach-tiki,21130350,"Vụ Án LEROUGE (Trinh Thám)",79000,168000,89000,53
TIKI,nha-sach-tiki,191782162,"Trên Đường Băng (Tony Buổi Sáng)",71100,105000,33900,32
TIKI,nha-sach-tiki,194104216,"Văn Phòng Thám Tử Quái Vật - Tập 11",29100,30000,900,3
TIKI,nha-sach-tiki,179546070,"Luật Hấp Dẫn - Quy Luật Về Sức Mạnh Của Linh Hồn Và Năng Lượng Chữa Lành Cơ Thể Từ Bên Trong",85400,129000,43600,34
TIKI,nha-sach-tiki,52584834,"Tư Duy Hệ Thống Trong Công Việc",61000,89000,28000,31
TIKI,nha-sach-tiki,194960244,"Fullmetal Alchemist - Cang Giả Kim Thuật Sư - Fullmetal Edition - Tập 16",63000,69000,6000,9
TIKI,nha-sach-tiki,176909221,"Ngôi Nhà Bên Bờ Biển Xanh Thẳm",124000,174000,50000,29
TIKI,nha-sach-tiki,130996082,"Bồ Câu Bay Đi Tìm Bà",56100,77000,20900,27
TIKI,nha-sach-tiki,22881852,"English Grammar in Use Book w Ans",160200,198000,37800,19
TIKI,nha-sach-tiki,52785564,"Dịch Hạch (Nobel Văn Chương 1957)",93200,129000,35800,28
TIKI,nha-sach-tiki,2429811,"Tư Duy Phản Biện",56100,85000,28900,34
TIKI,nha-sach-tiki,11371249,"Chuyện Con Mèo Và Con Chuột Bạn Thân Của Nó - Tái Bản",30100,39000,8900,23
TIKI,nha-sach-tiki,195357772,"Máy Tính CASIO FX-880BTG - Màu Đen",696000,800000,104000,13
TIKI,nha-sach-tiki,111580006,"Sách Muôn Kiếp Nhân Sinh 2 (Khổ Nhỏ) - Nguyên Phong",86000,148000,62000,42
TIKI,nha-sach-tiki,50751279,"Vui Vẻ Không Quạu Nha - Tản Văn",49200,69000,19800,29
TIKI,nha-sach-tiki,193411736,"Anh Em Nhà Motohashi - Tập 2",52000,68000,16000,24
TIKI,nha-sach-tiki,196923452,"Birdmen - Tập 7",30000,30000,0,0
TIKI,nha-sach-tiki,95218451,"Lần Đầu Làm Mẹ - Tổng Hợp Những Kiến Thức Mới Nhất Về Mang Thai Và Sinh Nở (Tái Bản)",176000,260000,84000,32
TIKI,nha-sach-tiki,79672197,"Bí Mật Của May Mắn (Khổ Nhỏ)(Tái Bản)",32100,45000,12900,29
TIKI,nha-sach-tiki,157240665,"Ra Bờ Suối Ngắm Hoa Kèn Hồng (Truyện Dài-Nguyễn Nhật Ánh) - Bìa Mềm (Màu Hồng) (Tặng Kèm Bookmark Bồi Hai Mặt, Thiệp Trái Tim In Bài Thơ Của Tác Giả)",97400,145000,47600,33
TIKI,nha-sach-tiki,67271338,"Sách OSHO - Trò Chuyện Với Vĩ Nhân",135000,198000,63000,32
TIKI,nha-sach-tiki,143186001,"Chiến Thắng Con Quỷ Trong Bạn - Bí Quyết Tự Do Và Thành Công (Tái Bản)",81800,115000,33200,29
TIKI,nha-sach-tiki,187190676,"Black Jack - Tập 11",30000,30000,0,0
TIKI,nha-sach-tiki,52805060,"Chúa Ruồi - Tiểu Thuyết (Nobel Văn Chương 1983)(Tái Bản 2020)",63700,88000,24300,28
TIKI,nha-sach-tiki,1926761,"Khởi Nghiệp Bán Lẻ - Bí Quyết Thành Công Và Giàu Có Bằng Những Cửa Hàng Đông Khách - Công Thức Kinh Doanh Và Quản Lý Cửa Hàng Hiệu Quả",125000,199000,74000,37
TIKI,nha-sach-tiki,162205263,"Những Đồ Vật Có Linh Hồn - Bản Thường (Tặng Kèm 1 Bookmark)",106000,149000,43000,29
TIKI,nha-sach-tiki,3976835,"Velma - Trinh Thám Cổ Điển Phương Tây",49500,99000,49500,50
TIKI,nha-sach-tiki,85029033,"Truyện Cổ Grimm (Ấn Bản Đầy Đủ Nhất Kèm 184 Minh Hoạ Của Philipp Grot Johann Và Robert Leinweber)",446000,680000,234000,34
TIKI,nha-sach-tiki,195649312,"Trí Tuệ Do Thái  (Tái Bản 2022)",137000,189000,52000,28
TIKI,nha-sach-tiki,25557704,"Bãi săn người - Trinh Thám Kinh Dị",62000,162000,100000,62
TIKI,nha-sach-tiki,164336673,"How The Brain Works - Hiểu Hết Về Bộ Não",264000,330000,66000,20
TIKI,nha-sach-tiki,137741275,"Ngỡ Như Lương Thiện, Hóa Ra Mềm Yếu",93000,125000,32000,26
TIKI,nha-sach-tiki,57761618,"Vụ Án Mạng Ở Lữ Quán Kairotei",84100,123000,38900,32
TIKI,nha-sach-tiki,147988185,"Combo 2 Cuốn "Hiểu Hết" : How Business Works - Hiểu Hết Về Kinh Doanh + How Money Works - Hiểu Hết Về Tiền",467000,680000,213000,31
TIKI,nha-sach-tiki,159004131,"Semantic Error – Lỗi Logic (Tập 1) - Bản thường (Tặng Kèm 01 Bookmark + 01 Postcard)",183000,259000,76000,29
TIKI,nha-sach-tiki,190238356,"Kỷ Luật Bản Thân",125000,189000,64000,34
TIKI,nha-sach-tiki,160997378,"Giải Thích Ngữ Pháp Tiếng Anh Với Bài Tập Và Đáp Án (TB 2022) - Tác giả Mai Lan Hương, Hà Thanh Uyên",165000,220000,55000,25
TIKI,nha-sach-tiki,141333746,"Chúng Ta Học Thế Nào - How We Learn (Sự Thật Khó Tin Về Việc Học Nó Diễn Ra Khi Nào, Ở Đâu , Và Tại Sao)",112000,150000,38000,25
TIKI,nha-sach-tiki,66619715,"Sách Vị Tu Sĩ Bán Chiếc Ferrari (Tái Bản)",67600,98000,30400,31
TIKI,nha-sach-tiki,70016690,"Thế Giới Rộng Lớn Lòng Người Chật Hẹp (Tặng Kèm 1 Bookmark )",62100,92000,29900,33
TIKI,nha-sach-tiki,160081250,"Tăng Cường Sức Mạnh Não Bộ",95000,120000,25000,21
TIKI,nha-sach-tiki,108501279,"Viết Đi Đừng Sợ! Từ Tay Không Thành Tay Viết",188000,245000,57000,23
TIKI,nha-sach-tiki,195885685,"Vua Sáng Chế -  Tập 16",20000,20000,0,0
TIKI,nha-sach-tiki,14053724,"Sự Cứu Rỗi Của Thánh Nữ",93700,128000,34300,27
TIKI,nha-sach-tiki,66067655,"Trải Nghiệm Khách Hàng Xuất Sắc",181000,250000,69000,28
TIKI,nha-sach-tiki,193433626,"Kỹ năng tự học cho trẻ tiểu học",142000,199000,57000,29
TIKI,nha-sach-tiki,69644752,"Toàn Thư Chiêm Tinh Học Nhập Môn",226000,350000,124000,35
TIKI,nha-sach-tiki,186286187,"Nhà Lãnh Đạo Không Chức Danh",68000,105000,37000,35
TIKI,nha-sach-tiki,100931414,"Cách Khen Cách Mắng Cách Phạt Con (Tái Bản)",47800,69000,21200,31
TIKI,nha-sach-tiki,13419678,"Sách Đi Tìm Lẽ Sống (Tái Bản )",60100,88000,27900,32
TIKI,nha-sach-tiki,104314401,"Sách Bí Mật Của May Mắn (Khổ Lớn) (Tái Bản)",46100,68000,21900,32
TIKI,nha-sach-tiki,195801644,"Black Jack - Tập 13 (Bìa Cứng)",128000,135000,7000,5
TIKI,nha-sach-tiki,184070221,"Sách OSHO Hiểu - Đường Đến Tự Do",117000,168000,51000,30
TIKI,nha-sach-tiki,49910019,"Bác Sĩ Riêng Của Bé Yêu - Chào Con! Ba Mẹ Đã Sẵn Sàng (Tái Bản)",66000,95000,29000,31
TIKI,nha-sach-tiki,193988323,"Sa Vào Ánh Hào Quang Của Người – Tập 2",113000,138000,25000,18
TIKI,nha-sach-tiki,52597663,"Đừng Chạy Theo Số Đông - Cuốn Sách Bạn Cần Đọc Trước Khi Quá Muộn",128000,200000,72000,36
TIKI,nha-sach-tiki,1938915,"Sự Tiếp Xúc Của Văn Hóa Việt Nam Với Pháp",81650,109000,27350,25
TIKI,nha-sach-tiki,168576295,"Mình Phải Sống Như Biển Rộng Sông Dài",77300,109000,31700,29
TIKI,nha-sach-tiki,7916685,"All The Rule - Bình Tĩnh Khi Ế, Mạnh Mẽ Khi Yêu",60600,86000,25400,30
TIKI,nha-sach-tiki,48481763,"Thiên Nga Đen (Tái Bản 2020)",190400,299000,108600,36
TIKI,nha-sach-tiki,155683832,"túi đựng card visit - JL",5000,5000,0,0
TIKI,nha-sach-tiki,45321594,"Nghệ Thuật Bán Hàng Của Người Hướng Nội",88300,119000,30700,26
TIKI,nha-sach-tiki,145288031,"Tarot Toàn Thư - Đọc Vận Mệnh Qua Những Lá Bài",244000,380000,136000,36
TIKI,nha-sach-tiki,13624088,"Nghĩ Thiện Để Cuộc Đời Và Công Việc Viên Mãn",51000,85000,34000,40
TIKI,nha-sach-tiki,136143567,"Thần Số Học",146000,219000,73000,33
TIKI,nha-sach-tiki,160759005,"Cơ Thể Tự Chữa Lành - Thanh Lọc Để Phục Hồi",190000,295000,105000,36
TIKI,nha-sach-tiki,32155084,"Combo 25 Chuyên đề ngữ pháp tiếng anh trọng tâm ( trọn bộ tập 1+2 )",148000,230000,82000,36
TIKI,nha-sach-tiki,184774173,"Những Người Nhật Tử Tế",96000,148000,52000,35
TIKI,nha-sach-tiki,50723822,"Con Đường Đi Đến Thành Công Bằng Sự Tử Tế (Tái Bản 2020)",48000,70000,22000,31
TIKI,nha-sach-tiki,179063564,"Tôi Tự Học",79000,120000,41000,34
TIKI,nha-sach-tiki,113540576,"Hảo Nữ Trung Hoa",101000,128000,27000,21
TIKI,nha-sach-tiki,153045603,"Sách Người Giỏi Không Phải Là Người Làm Tất Cả (Tái Bản 2021)",40000,58000,18000,31
TIKI,nha-sach-tiki,129381090,"Minh Triết Trong Đời Sống (Tái Bản)",71100,108000,36900,34
TIKI,nha-sach-tiki,119694726,"Combo 6 cuốn Ehon Kích thích thị giác - Âm thanh cho Trẻ sơ sinh",121680,234000,112320,48
TIKI,nha-sach-tiki,100931418,"Giao Tiếp Bất Kỳ Ai - 101 Cách Nâng Cao Khả Năng Giao Tiếp (Tái Bản)",37300,55000,17700,32
TIKI,nha-sach-tiki,148802202,"How Philosophy Works - Hiểu Hết Về Triết Học",246000,330000,84000,25
TIKI,nha-sach-tiki,90469338,"Combo 5 cuốn: Cơ Thể Tự Chữa Lành",594000,923000,329000,36
TIKI,nha-sach-tiki,170297937,"Tâm Lý Học Về Sự Lo Âu",95100,129000,33900,26
TIKI,nha-sach-tiki,198016656,"Blue Flag - Tập 3",44100,45000,900,2
TIKI,nha-sach-tiki,145287904,"Sách - Giận (Tái Bản 2021)(Cuốn sách hay của Thiền sư Thích Nhất Hạnh/ Tặng kèm Bookmark)",128650,128650,0,0
TIKI,nha-sach-tiki,100958457,"Gieo Trồng Hạnh Phúc (Tái Bản)",61800,89000,27200,31
TIKI,nha-sach-tiki,143172597,"2000 English Collocation and Idioms",119000,200000,81000,41
TIKI,nha-sach-tiki,44433397,"Yêu Mình Trước Đã, Yêu Đời Để Sau",75800,109000,33200,30
TIKI,nha-sach-tiki,17719702,"Một Thế Giới Không Có Đàn Bà (Trinh Thám Việt Nam)",98000,142000,44000,31
TIKI,nha-sach-tiki,54051752,"Bộ Ba Quái Hiệp (Trinh Thám)",69000,138000,69000,50
TIKI,nha-sach-tiki,160081252,"Người Tan Làm Sau Cùng Là Người Nghỉ Việc Đầu Tiên (Tặng kèm bookmark)",84000,119000,35000,29
TIKI,nha-sach-tiki,197634252,"Văn phòng thám tử quái vật - Tập 13",24900,30000,5100,17
TIKI,nha-sach-tiki,195357776,"Máy Tính CASIO FX-880BTG - Màu Hồng",742000,800000,58000,7
TIKI,nha-sach-tiki,96357336,"Cáo Pax",85100,116000,30900,27
TIKI,nha-sach-tiki,197781977,"Yu-Gi-Oh! Gx Tập 1: “Người Hùng Mới” Lộ Diện",29500,30000,500,2
TIKI,nha-sach-tiki,182548592,"Thiên Sứ Nhà Bên – Tập 3",70000,95000,25000,26
TIKI,nha-sach-tiki,197353391,"Ninja Rantaro - Tập 61",39000,40000,1000,3
TIKI,nha-sach-tiki,100947274,"Tìm Bình Yên Trong Gia Đình (Tái Bản)",68300,99000,30700,31
TIKI,nha-sach-tiki,1080002,"Boxset Harry Potter - Tiếng Việt (Trọn Bộ 7 Tập)",1199000,1750000,551000,31
TIKI,nha-sach-tiki,48323805,"Sách Người trong muôn nghề",169000,189000,20000,11
TIKI,nha-sach-tiki,171057415,"Cẩm nang hướng dẫn tự học tiếng Thái – trình độ sơ cấp – trung cấp",98000,98000,0,0
TIKI,nha-sach-tiki,194104631,"Mong Bạn Đừng Khóc Một Mình",65000,88000,23000,26
TIKI,nha-sach-tiki,179952621,"Hành Trình Tarot (Tái Bản 2022)",107000,149000,42000,28
TIKI,nha-sach-tiki,243358535,"Squid Game Móc khoá - Móc khoá Silicon 5cm-SQ1",10000,20000,10000,50
TIKI,nha-sach-tiki,161245852,"Giải Thích Ngữ Pháp Tiếng Anh (Tái Bản 2022)",176000,220000,44000,20
TIKI,nha-sach-tiki,176550321,"Bàn Về Ham Muốn: Tại Sao Chúng Ta Muốn Thứ Mà Ta Muốn",120000,169000,49000,29
TIKI,nha-sach-tiki,57870426,"Sức Mạnh Của Ngôn Từ (Tặng Kèm 1 Photocard Mintbooks Limited)",64500,96000,31500,33
TIKI,nha-sach-tiki,191148794,"Tôi Ước Mình Chưa Từng Được Sinh Ra -Tặng kèm 1 bookmark",63000,90000,27000,30
TIKI,nha-sach-tiki,186091870,"Fullmetal Alchemist - Cang Giả Kim Thuật Sư - Fullmetal Edition Tập 15 [Tặng Kèm Bookmark PVC]",62100,69000,6900,10
TIKI,nha-sach-tiki,196944533,"Tài chính doanh nghiệp for Dummies",166000,239000,73000,31
TIKI,nha-sach-tiki,626886,"Những Tấm Lòng Cao Cả",53100,80000,26900,34
TIKI,nha-sach-tiki,274404957,"Montessori – Phương Pháp Giáo Dục Toàn Diện Cho Trẻ 0-6 Tuổi",81100,81100,0,0
TIKI,nha-sach-tiki,81323246,"90-20-30 90 Bài Học Vỡ Lòng Về Ý Tưởng Và Câu Chữ (Bản Đen Trắng)",149000,195000,46000,24
TIKI,nha-sach-tiki,80657321,"Cơ Thể Tự Chữa Lành: Phục Hồi Tuyến Giáp",116000,180000,64000,36
TIKI,nha-sach-tiki,87959748,"451 Độ F",73300,99000,25700,26
TIKI,nha-sach-tiki,50475521,"Sách Đánh Thức Con Người Phi Thường Trong Bạn",97000,168000,71000,42
TIKI,nha-sach-tiki,187622420,"The Art and Science of Technical Analysis – Phân tích kỹ thuật: Sự kết hợp giữa KHOA HỌC và NGHỆ THUẬT trong đầu tư chứng khoán",569000,569000,0,0
TIKI,nha-sach-tiki,115478654,"Keo Siêu Dính Đa Năng Mạnh Gấp 80 Keo 502 Dán Sắt, Dán Đá, Dán Nhựa, Dán Gỗ",39000,39000,0,0
TIKI,nha-sach-tiki,147058065,"Phi Lý Trí - Khám Phá Những Động Lực Vô Hình Ẩn Sau Những Quyết Định Của Con Người ( Tái Bản)",110000,169000,59000,35
TIKI,nha-sach-tiki,194104232,"Anh Em Phi Hành Gia - Tập 32",42300,45000,2700,6
TIKI,nha-sach-tiki,110448020,"Nhà Ảo Thuật Đen Và Vụ Án Mạng Tại Thị Trấn Không Tên",154000,199000,45000,23
TIKI,nha-sach-tiki,193434488,"Kingdom -  Tập 32",32600,45000,12400,28
TIKI,nha-sach-tiki,125528587,"Thần Với Chả Thoại (Những Câu Chuyện "Mệt Mỏi" Về Các Vị Thần)",85000,139000,54000,39
TIKI,nha-sach-tiki,90056907,"Khởi Nghiệp Tinh Gọn (The Lean Startup) (Tái Bản)",129000,165000,36000,22
TIKI,nha-sach-tiki,3737963,"Bức Xúc Không Làm Ta Vô Can (Tái Bản)",62800,85000,22200,26
TIKI,nha-sach-tiki,162181800,"Cảm Ơn Anh Đã Đánh Mất Em - Bản Thường (Tặng Kèm 2 postcard)",70000,99000,29000,29
TIKI,nha-sach-tiki,178483637,"Nước Ép Trị Liệu Và Chế Độ Ăn Theo Phương Pháp Cơ Thể Tự Chữa Lành",141000,199000,58000,29
TIKI,nha-sach-tiki,193433863,"101 Lời Khuyên Tài Chính Cá Nhân Từ Thái Phạm",299000,299000,0,0
TIKI,nha-sach-tiki,58695343,"Kỹ Năng Giao Tiếp Đỉnh Cao",66500,96000,29500,31
TIKI,nha-sach-tiki,195649281,"Đọc Vị Tâm Lý Hành Vi Của Giới Giàu Và Siêu Giàu",222000,299000,77000,26
TIKI,nha-sach-tiki,113655533,"Giáo Trình Chủ Nghĩa Xã Hội Khoa Học (Dành Cho Bậc Đại Học Hệ Không Chuyên Lý Luận Chính Trị) - Bộ mới năm 2021",58000,58000,0,0
TIKI,nha-sach-tiki,71090268,"Ám Ảnh Từ Kiếp Trước - Bí Mật Của Sự Sống Và Cái Chết (Tái Bản 2020)",58100,89000,30900,35
TIKI,nha-sach-tiki,168662171,"Vừa Nhắm Mắt Vừa Mở Cửa Số",52000,75000,23000,31
TIKI,nha-sach-tiki,195885690,"Birdmen - Tập 6",29000,30000,1000,3
TIKI,nha-sach-tiki,69644748,"Thiền Sư Và Em Bé 5 Tuổi",67100,120000,52900,44
TIKI,nha-sach-tiki,67491398,"Sách OSHO Từ Bi - Compassion",88600,128000,39400,31
TIKI,nha-sach-tiki,155550600,"Sống Bán Nông Bán X - Tâm Lý Mới Về Cuộc Sống Điền Viên",96000,148000,52000,35
TIKI,nha-sach-tiki,40933969,"Một Đời Quản Trị (Tái Bản)",121000,200000,79000,40
TIKI,nha-sach-tiki,140416373,"Hành Trình Về Phương Đông (Khổ Nhỏ)(Tái Bản)",53600,78000,24400,31
TIKI,nha-sach-tiki,151994935,"Sói Đầu Đàn Và Cún Nhỏ - Tập 1",99300,128000,28700,22
TIKI,nha-sach-tiki,73222800,"Nghĩ Giàu Và Làm Giàu (Khổ Nhỏ)",74000,108000,34000,31
TIKI,nha-sach-tiki,153521878,"Nhân Loại - Một Lịch Sử Tràn Đầy Hi Vọng",153000,245000,92000,38
TIKI,nha-sach-tiki,56697257,"Bí Mật Và Thực Tế Về Tự Kỉ Ám Thị (Self Mastery Through Conscious Autosuggestion) - Cuốn Sách Về Tự Kỉ Ám Thị Được Freud Và Các Bậc Thầy Phân Tâm Trích Dẫn Và Nghiên Cứu - Liệu Pháp Tự Chữa Lành Được Napoleon Hill Và Tony Robbin Sử Dụng Đều Xuất Phát Từ Đ",52700,83000,30300,37
TIKI,nha-sach-tiki,69764534,"Thợ Xăm Ở Auschwitz",109000,148000,39000,26
TIKI,nha-sach-tiki,377644,"Chờ Đến Mẫu Giáo Thì Đã Muộn",49000,69000,20000,29
TIKI,nha-sach-tiki,106863962,"Sách Bên Rặng Tuyết Sơn - Nguyên Phong (Tái Bản)",81600,118000,36400,31
TIKI,nha-sach-tiki,63473605,"Ho’Oponopono: Sống Như Người Hawaii – Chấp Nhận, Biết Ơn Và Tha Thứ",79700,109000,29300,27
TIKI,nha-sach-tiki,108715084,"Rio Book No.1 - Xấu Thế Nào, Đẹp Ra Sao - Bí Kíp Thẩm Định Thiết Kế Trong Marketing (Tái Bản Lần 6)",134000,175000,41000,23
TIKI,nha-sach-tiki,94173462,"Muôn Kiếp Nhân Sinh 2",192000,268000,76000,28
TIKI,nha-sach-tiki,31509726,"Làm Bạn Với Bầu Trời (Bìa Mềm) (Tặng Kèm Khung Ảnh Số Lượng Có Hạn)",62000,110000,48000,44
TIKI,nha-sach-tiki,49317816,"Cơ Thể Tự Chữa Lành",103000,160000,57000,36
TIKI,nha-sach-tiki,66712456,"Trở Về Không - Trải Nghiệm Ho'oponopono - Thực Hiện Hóa Những Phép Màu Trong Cuộc Sống",118000,159000,41000,26
TIKI,nha-sach-tiki,95218447,"Con Đường Chuyển Hóa - Kinh Bốn Lĩnh Vực Quán Niệm (Tái Bản)",61300,89000,27700,31
TIKI,nha-sach-tiki,45663008,"Ngày Xưa Có Một Con Bò…(Tái Bản)",48000,70000,22000,31
TIKI,nha-sach-tiki,195357782,"Máy Tính CASIO FX-880BTG - Màu Xám",740000,800000,60000,8
TIKI,nha-sach-tiki,2126103,"Tazaki Tsukuru Không Màu Và Những Năm Tháng Hành Hương (Tái Bản 2018)",78500,106000,27500,26
TIKI,nha-sach-tiki,107331062,"Khởi Nghiệp Kinh Doanh Online - Bán Hàng Hiệu Quả Trên Face.book",159000,199000,40000,20
TIKI,nha-sach-tiki,99513994,"Những Người Đàn Ông Không Có Đàn Bà (Tái Bản)",73000,100000,27000,27
TIKI,nha-sach-tiki,95220861,"Tuần Làm Việc 4 Giờ (Tái Bản)",80000,115000,35000,30
TIKI,nha-sach-tiki,109862191,"Combo 8 cuốn: Bộ sách IQ vượt trội - IQ booster",49920,96000,46080,48
TIKI,nha-sach-tiki,194960730,"Nỗi buồn chiến tranh",86000,130000,44000,34
TIKI,nha-sach-tiki,36363381,"Sao Chúng Ta Lại Ngủ",186800,249000,62200,25
TIKI,nha-sach-tiki,173745189,"Clean Code – Mã Sạch Và Con Đường Trở Thành Lập Trình Viên Giỏi",244000,386000,142000,37
TIKI,nha-sach-tiki,193446628,"Dragon Ball Full Color - Phần Năm: Truy Lùng Cell Bọ Hung Tập 3 [Tặng kèm Standee hoặc Postcard]",69100,77000,7900,10
TIKI,nha-sach-tiki,188548575,"Đời Muối: Lịch Sử Thế Giới",152000,235000,83000,35
TIKI,nha-sach-tiki,162865518,"Tôn Tử Binh Pháp (Tái Bản)",117000,160000,43000,27
TIKI,nha-sach-tiki,76012203,"Cuộc Đời Là Một Tiểu Thuyết",104000,140000,36000,26
TIKI,nha-sach-tiki,112106439,"GIẢI MÃ HÀNH VI ĐỌC VỊ CẢM XÚC",89800,129000,39200,30
TIKI,nha-sach-tiki,103550551,"Hung Khí Hoàn Mỹ",115000,150000,35000,23
TIKI,nha-sach-tiki,74686986,"Spy X Family Tập 2",25000,25000,0,0
TIKI,nha-sach-tiki,117595535,"Kẻ Ngoại Cuộc",90000,123000,33000,27
TIKI,nha-sach-tiki,637390,"Tuần Của Bé - Bé Thông Minh",21850,23000,1150,5
TIKI,nha-sach-tiki,93249197,"22 Quy Luật Bất Biến Trong Marketing",53100,78000,24900,32
TIKI,nha-sach-tiki,20444622,"Cẩm Nang Cấu Trúc Tiếng Anh",63000,98000,35000,36
TIKI,nha-sach-tiki,80960198,"Thiên Tài Bên Trái, Kẻ Điên Bên Phải (Tái Bản 2021)",121000,179000,58000,32
TIKI,nha-sach-tiki,174444205,"Dịch Vụ Đặc Biệt: Dọn Dẹp Nhà Cho Người Chết",71800,99000,27200,27
TIKI,nha-sach-tiki,197634260,"Black Jack - Tập 14",30000,30000,0,0
TIKI,nha-sach-tiki,197990867,"Doraemon Movie Story: Nobita Và Viện Bảo Tàng Bảo Bối",30000,30000,0,0
TIKI,nha-sach-tiki,111582631,"Cái Dũng Của Thánh Nhân (Thu Giang Nguyễn Duy Cần) (Tái Bản)",62000,90000,28000,31
TIKI,nha-sach-tiki,106605689,"Spy X Family Tập 5 - Bản Thường",25000,25000,0,0
TIKI,nha-sach-tiki,197990871,"Doraemon Movie Story: Nobita Và Hòn Đảo Diệu Kì - Cuộc Phiêu Lưu Của Loài Thú",30000,30000,0,0
TIKI,nha-sach-tiki,54051756,"19 Năm Mưu Sát - Tập 2 (Trinh Thám Trung Quốc)",74000,115000,41000,36
TIKI,nha-sach-tiki,189641379,"Anh Em Nhà Motohashi - Tập 1",53900,68000,14100,21
TIKI,nha-sach-tiki,46789754,"Hiểu Hết Về Kinh Doanh",281000,380000,99000,26
TIKI,nha-sach-tiki,149180057,"Đừng Cố Làm Người Tốt Trong Mắt Tất Cả Mọi Người",86000,108000,22000,20
TIKI,nha-sach-tiki,10405966,"Tarot Nhập Môn (Tái Bản 2019)",86600,120000,33400,28
TIKI,nha-sach-tiki,381234,"Cuốn Sách Hoàn Hảo Về Ngôn Ngữ Cơ Thể - Body Language (Tái Bản)",149000,198000,49000,25
TIKI,nha-sach-tiki,77230663,"Combo 2 Cuốn: Tâm Lý Học Tội Phạm",198000,288000,90000,31
TIKI,nha-sach-tiki,89179374,"Spy X Family Tập 4",24300,25000,700,3
TIKI,nha-sach-tiki,59293803,"A Holistic Approach To IELTS Writing",130000,189000,59000,31
TIKI,nha-sach-tiki,52329861,"Con Đường Hồi Giáo (Tái Bản 2020)",72000,100000,28000,28
TIKI,nha-sach-tiki,54624820,"Sức Mạnh Của Tĩnh Lặng (Tái Bản 2020)",46500,68000,21500,32
TIKI,nha-sach-tiki,76175424,"Vụ Án Mạng Ở Nhà Khách Núi Hakuba",101000,138000,37000,27
TIKI,nha-sach-tiki,187843301,"How Technology Works – Hiểu hết về công nghệ",242000,330000,88000,27
TIKI,nha-sach-tiki,190240560,"Bộ Sách Tô Màu - Bé Làm Họa Sĩ",19000,25000,6000,24
TIKI,nha-sach-tiki,54051754,"19 Năm Mưu Sát - Tập 1 (Trinh Thám Trung Quốc)",74000,115000,41000,36
TIKI,nha-sach-tiki,195885680,"Tiệm Trừ Yêu Kì Ảo -  Tập 18",34100,35000,900,3
TIKI,nha-sach-tiki,124639646,"Bé chinh phục 2000 từ vựng tiếng Anh - My First 2000 English words",62400,120000,57600,48
TIKI,nha-sach-tiki,595724,"Giáo Trình Chuẩn HSK 4 Bài Học (Tập 1)",171000,228000,57000,25
TIKI,nha-sach-tiki,77109209,"Nghệ Thuật Đánh Cắp Ý Tưởng (10 Bí Mật Không Ai Nói Với Bạn Về Sáng Tạo)",65400,99000,33600,34
TIKI,nha-sach-tiki,100958444,"Hạnh Phúc Cầm Tay (Tái Bản)",52000,75000,23000,31
TIKI,nha-sach-tiki,87391039,"Thuật Yêu Đương (Tái Bản)",81000,120000,39000,33
TIKI,nha-sach-tiki,116406678,"Quản Lý Nghiệp (Tái Bản)",40300,59000,18700,32
TIKI,nha-sach-tiki,194104226,"Mô Hình Can Thiệp Sớm Denver Cho Trẻ Tự Kỷ - Thúc Đẩy Kỹ Năng Ngôn Ngữ, Học Tập Và Tương Tác",110200,210000,99800,48
TIKI,nha-sach-tiki,162201947,"One Piece - Tập 98: “Phút Huy Hoàng Của Những Trung Thần",25000,25000,0,0
TIKI,nha-sach-tiki,81224320,"Nước Ép Xanh Chữa Lành Cơ Thể",124600,179000,54400,30
TIKI,nha-sach-tiki,56218385,"Thông Điệp Của Nước (Tái Bản 2020)",59100,89000,29900,34
TIKI,nha-sach-tiki,14645351,"Cuộc Đời Của Pi ( Tái Bản 2019)",82000,110000,28000,25
TIKI,nha-sach-tiki,192909304,"Lên Tàu Cùng Socrates - Đi Tìm Ý Nghĩa Cuộc Sống Từ Các Triết Gia",103900,195000,91100,47
TIKI,nha-sach-tiki,130996088,"Câu Chuyện Ngôn Ngữ",116000,160000,44000,28
TIKI,nha-sach-tiki,93734071,"Trí Thông Minh Trên Giường",130000,219000,89000,41
TIKI,nha-sach-tiki,10397239,"Chiến Lược Dữ Liệu",114000,158000,44000,28
TIKI,nha-sach-tiki,39228816,"Kỹ Thuật Giao Dịch Để Kiếm Tiền Hàng Ngày Trên Thị Trường Chứng Khoán – Day Trade For A Living",298000,298000,0,0
TIKI,nha-sach-tiki,77900454,"Bí Mật Của Nước (Tái Bản)",63100,89000,25900,29
TIKI,nha-sach-tiki,129381098,"Tiếp Thị 5.0: Công Nghệ Vị Nhân Sinh",82000,120000,38000,32
TIKI,nha-sach-tiki,87959745,"Hạnh Phúc Là Con Đường",114000,155000,41000,26
TIKI,nha-sach-tiki,72680632,"Năng Lực Tìm Kiếm",60300,91000,30700,34
TIKI,nha-sach-tiki,17881046,"Trầm lặng - Sức mạnh tiềm ẩn của người hướng nội",88100,130000,41900,32
TIKI,nha-sach-tiki,178294073,"Trading in The Zone - Thực Hành Kiểm Soát Cảm Xúc bằng Tâm Lý Học Hành Vi trong Đầu Tư và Giao Dịch",295000,295000,0,0
TIKI,nha-sach-tiki,77621607,"Spy X Family Tập 3",24300,25000,700,3
TIKI,nha-sach-tiki,186578227,"Những kẻ cuồng nhạc Musicophilia – Tales of music and the brain",178000,230000,52000,23
TIKI,nha-sach-tiki,274566783,"Siêu Nhí Hỏi Nhà Khoa Học Trả Lời - 100 Bí Ẩn Mọi Đứa Trẻ Đều Muốn Hỏi Một Nhà Khoa Học",173000,173000,0,0
TIKI,nha-sach-tiki,154160965,"Thần Thoại Hy Lạp (Tái Bản)",169000,255000,86000,34
TIKI,nha-sach-tiki,274607551,"Lời Nói Thần Kỳ Nuôi Dưỡng Những Đứa Trẻ Hạnh Phúc: 0 - 6 Tuổi",61100,61800,700,1
TIKI,nha-sach-tiki,197558899,"Anime Comics: One Piece Film Z - Tập 1",68800,77000,8200,11
TIKI,nha-sach-tiki,113540577,"Anne Tóc Đỏ Dưới Chái Nhà Xanh",91800,119000,27200,23
TIKI,nha-sach-tiki,194960245,"Migi & Dali -Tập 1",37100,40000,2900,7
TIKI,nha-sach-tiki,90985718,"Càng Mạnh Mẽ, Càng Dịu Dàng (Tái Bản)",67800,99000,31200,32
TIKI,nha-sach-tiki,197119849,"Chuông Gió (Tập 3)",136000,174000,38000,22
TIKI,nha-sach-tiki,72744612,"Nghề Thầy",52000,70000,18000,26
TIKI,nha-sach-tiki,133599625,"Spy X Family Tập 6",25000,25000,0,0
TIKI,nha-sach-tiki,100947276,"Ung Thư - Sự Thật, Hư Cấu, Gian Lận Và Những Phương Pháp Chữa Bệnh Không Độc Hại (Tái Bản)",114000,169000,55000,33
TIKI,nha-sach-tiki,394434,"Giấy Excel A4 DL70",62000,62000,0,0
TIKI,nha-sach-tiki,125776045,"Giấy in photo A4 IK Copy IK-01 - Định lượng 70 gsm - 500 tờ/ream - giấy chất lượng cao nhập khẩu Indonesia",70000,110000,40000,36
TIKI,nha-sach-tiki,97561438,"Thế Giới Quả Là Rộng Lớn Và Có Rất Nhiều Việc Phải Làm (Tái Bản)",92620,139000,46380,33
TIKI,nha-sach-tiki,194104223,"Quán Rượu Dị Giới "Nobu" - Tập 10",28100,40000,11900,30
TIKI,nha-sach-tiki,197558902,"Anime Comics: One Piece Film Z - Tập 2",68800,77000,8200,11
TIKI,nha-sach-tiki,193896563,"Cô Bạn Tôi Thầm Thích Lại Quên Mang Kính Rồi - Tập 2 [Tặng Kèm Standee Ivory]",37100,38000,900,2
TIKI,nha-sach-tiki,189657049,"One Piece - Tập 99",25000,25000,0,0
TIKI,nha-sach-tiki,193605362,"Ali Và NiNo",96000,125000,29000,23
TIKI,nha-sach-tiki,191045565,"Cô Gái Mặc Váy Tím",73100,95000,21900,23
TIKI,nha-sach-tiki,140635217,"Mất Kết Nối (Khám Phá Các Nguyên Nhân Thực Của Trầm Cảm Và Các Giải Pháp Bất Ngờ)",166000,250000,84000,34
TIKI,nha-sach-tiki,192909291,"Văn Phòng Thám Tử Quái Vật - Tập 10",21000,30000,9000,30
TIKI,nha-sach-tiki,193590152,"Méthode Rose - Phương pháp hồng 1 - Năm thứ nhất với đàn piano - Giáo trình dạy piano nổi tiếng của Pháp",97000,150000,53000,35
TIKI,nha-sach-tiki,184466862,"Trưởng Thành Là Khi Nỗi Buồn Cũng Có Deadline",65000,88000,23000,26
TIKI,nha-sach-tiki,21130354,"Vòng Tròn Máu - Trinh Thám Cổ Điển Anh",72000,102000,30000,29
TIKI,nha-sach-tiki,53722909,"Combo Trinh Thám Trung Quốc: Phục Thù (2 tập)",95000,225000,130000,58
TIKI,nha-sach-tiki,168662558,"CCMR. Phải Trái Đúng Sai",92000,155000,63000,41
TIKI,nha-sach-tiki,192048665,"Vỡ lòng về tiền tệ - Money for Beginners",112000,150000,38000,25
TIKI,nha-sach-tiki,96616370,"Con Đường Trở Thành Freelance Writer - Tôi Đã Kiếm 800.000.000 Một Năm Từ Viết Lách Như Thế Nào? (Tái Bản)",164000,220000,56000,25
TIKI,nha-sach-tiki,55506686,"Tiktok Marketing",92100,139000,46900,34
TIKI,nha-sach-tiki,10383904,"Tôi Là Bêtô",65000,95000,30000,32
TIKI,nha-sach-tiki,77105810,"Nỗi Đau Của Chàng Werther (Bìa Cứng)",63300,85000,21700,26
TIKI,nha-sach-tiki,190708154,"Dragon Quest - Dấu Ấn Roto (Dragon Quest Saga Emblem Of Roto) Perfect Edition Tập 8 [Tặng Kèm Bookmark PVC]",70000,75000,5000,7
TIKI,nha-sach-tiki,140360874,"Những Đòn Tâm Lý Trong Bán Hàng (Tái Bản)",80620,139000,58380,42
TIKI,nha-sach-tiki,105614684,"Bút gel 0.5mm Deli nhiều màu lựa chọn - Bút bi nước -  1 chiếc - Mực đỏ / Xanh / Đen - A116",7200,7200,0,0
TIKI,nha-sach-tiki,137161811,"Bút gel bấm ngòi 0.5mm nhiều màu Deli - Độ dài mực lên tới 1000m - 12 màu mực - 1 chiếc - EG118",5000,10800,5800,54
TIKI,nha-sach-tiki,100347903,"Nói Một Cách Đơn Giản",90000,129000,39000,30
TIKI,nha-sach-tiki,73125816,"Digital Marketing - Từ Chiến Lược Đến Thực Thi (Tái Bản 2020)",167000,220000,53000,24
TIKI,nha-sach-tiki,45663835,"Lạc Quan Tếu – Irrational Exuberance",299000,299000,0,0
TIKI,nha-sach-tiki,176906726,"Chân Dung Thật - Thấu Hiểu Khách Hàng Chỉ Bằng Những Cuộc Trò Chuyện",211000,245000,34000,14
TIKI,nha-sach-tiki,84950232,"Hoa Sen Trên Tuyết (Tái Bản)",68100,98000,29900,31
TIKI,nha-sach-tiki,10325548,"How Food Works - Hiểu Hết Về Thức Ăn",223000,300000,77000,26
TIKI,nha-sach-tiki,509829,"Giấy Double A A4 DL70",85500,90000,4500,5
TIKI,nha-sach-tiki,58342212,"Set 3 cuốn Moi Moi và những người bạn - Dành cho trẻ từ 0-2 tuổi",75600,117000,41400,35
TIKI,nha-sach-tiki,176654072,"Bộ 5 bút chì gỗ 2B HB Deli - Có bán lẻ 1 chiếc - Nhiều loại mẫu mã màu sắc - Phù hợp cho học sinh sinh viên tập viết vẽ tranh",1600,3420,1820,53
TIKI,nha-sach-tiki,195801646,"Ninja Rantaro - Tập 60",37100,40000,2900,7
TIKI,nha-sach-tiki,144203242,"9 Lần Khởi Nghiệp - Chuyện Kể Về Những Thất Bại Và Thành Công Của Một Triệu Phú",149000,199000,50000,25
TIKI,nha-sach-tiki,174427255,"Lốc Vở Kẻ Ngang Primer (120 trang - 200 trang | Giao mẫu ngẫu nhiên)",80070,157000,76930,49
TIKI,nha-sach-tiki,50685547,"Bản Đồ (Bản Thông Thường)",235000,345000,110000,32
TIKI,nha-sach-tiki,72542509,"Raw Vegan – Sức Mạnh Chữa Lành Của Thực Vật (Tặng kèm bookmark)",63900,92000,28100,31
TIKI,nha-sach-tiki,138226289,"Storytelling With Data: Let’S Practice! - Thực Hành Kể Chuyện Thông Qua Dữ Liệu!",277800,399000,121200,30
TIKI,nha-sach-tiki,196001693,"Trí Tuệ Của Trái Tim",68500,88000,19500,22
TIKI,nha-sach-tiki,193978836,"Trí Óc Minh Mẫn: Để Não Bộ Sắc Bén Ở Mọi Lứa Tuổi",164400,249000,84600,34
TIKI,nha-sach-tiki,148761077,"Khách Sạn Mặt Nạ 1",136000,175000,39000,22
TIKI,nha-sach-tiki,168946125,"Digital Marketing - Chiến Lược Là Lược Đi Để Chiến",111200,139000,27800,20
TIKI,nha-sach-tiki,180851000,"Bảy Thanh Hung Giản 3 Mưa Phùn Chôn Nho - Truy Lùng Báo Săn Giá",182000,235000,53000,23
TIKI,nha-sach-tiki,193434494,"Shaman King - Tập 15",33800,35000,1200,3
TIKI,nha-sach-tiki,15397971,"Hà Nội Băm Sáu Phố Phường (Tái bản 2019)",37100,50000,12900,26
TIKI,nha-sach-tiki,130997085,"Chuyện Con Chó Tên Là Trung Thành",34000,45000,11000,24
TIKI,nha-sach-tiki,78975610,"Siêu Tập Trung (Tái Bản)",90000,140000,50000,36
TIKI,nha-sach-tiki,62648441,"The Customer Rules - 39 Nguyên Tắc Cốt Lõi Để Mang Tới Dịch Vụ Đỉnh Cao",174000,220000,46000,21
TIKI,nha-sach-tiki,193736891,"Tâm Lý Học Xã Hội - Đi Tìm Chất Gây Nghiện Trong Mỗi Con Người",99600,139000,39400,28
TIKI,nha-sach-tiki,49181801,"Oxford Advanced Learner's Dictionary : Paperback - 10th Edition (With 1 Year's Access To Both Premium Online And App)",522660,562000,39340,7
TIKI,nha-sach-tiki,196001724,"Dưới Cánh Đại Bàng (Bìa Mềm)",95100,138000,42900,31
TIKI,nha-sach-tiki,95090804,"Bút dạ viết bảng Deli - xóa được - Mực xanh/đen/đỏ - 1 chiếc – EU00120/ EU00130 / EU00140",14400,14400,0,0
TIKI,nha-sach-tiki,115873770,"Sách: Thay Đổi Một Suy Nghĩ Thay Đổi cả Cuộc Đời",120000,160000,40000,25
TIKI,nha-sach-tiki,72818335,"Bộ Thẻ học Thông minh - 416 Thẻ Flashcards Tiếng Anh - 16 Chủ đề mới nhất",65790,129000,63210,49
TIKI,nha-sach-tiki,197781968,"Migi & Dali Tập 3",37900,40000,2100,5
TIKI,nha-sach-tiki,148760915,"Khách Sạn Mặt Nạ 2 - Đêm Trước Lễ Hội Hóa Trang",96500,125000,28500,23
TIKI,nha-sach-tiki,197587849,"Yuri Espoir (Tập 3)",62700,79000,16300,21
TIKI,nha-sach-tiki,152875147,"Miền Đất Hứa (A Promised Land) - Barack Obama (Bìa Cứng)",179000,768000,589000,77
TIKI,nha-sach-tiki,95997783,"Sách Luyện thi B1 Vstep 4 kỹ năng - Ôn thi chứng chỉ tiếng Anh B1 bậc 3 (bằng B1 tiếng Anh) theo Khung NLNN Việt Nam",300000,300000,0,0
TIKI,nha-sach-tiki,165150439,"TalMud - Tinh Hoa Trí Tuệ Do Thái (Tái Bản)",73000,110000,37000,34
TIKI,nha-sach-tiki,185888686,"Trường An Ly Ca 3 – Cao Sơn Lưu Thuỷ",134000,170000,36000,21
TIKI,nha-sach-tiki,171825201,"Người Bà Tài Giỏi Vùng Saga – Tập 7",40600,52000,11400,22
TIKI,nha-sach-tiki,13446508,"Cánh Đồng Bất Tận (Tái Bản 2019)",65000,85000,20000,24
TIKI,nha-sach-tiki,87226754,"Một Cuốn Sách Buồn… Cười - Vui Vẻ Không Quạu Nha 2",52000,79000,27000,34
TIKI,nha-sach-tiki,189326210,"Nghệ thuật tư duy dựa trên dữ liệu - Để ra quyết điịnh thông minh hơn trong một thê giới không chắc chắn",85000,150000,65000,43
TIKI,nha-sach-tiki,55119955,"Cách Sống (Tái Bản 2020)",59000,85000,26000,31
TIKI,nha-sach-tiki,177637709,"Làm Chủ Bình Minh - Sống Đời Xuất Chúng - CLB 5 Giờ Sáng (Robin Sharma)",109000,185000,76000,41
TIKI,nha-sach-tiki,75630595,"The Design Thinking Playbook- Thực Hành Tư Duy Thiết Kế",185400,299000,113600,38
TIKI,nha-sach-tiki,195190272,"Nhất Quỷ Nhì Ma, Thứ Ba Takagi  - Tập 15",29000,30000,1000,3
TIKI,nha-sach-tiki,54383647,"Fullmetal Alchemist - Cang Giả Kim Thuật Sư - Fullmetal Edition Tập 4",64100,69000,4900,7
TIKI,nha-sach-tiki,73316970,"Osho - Ươm Mầm",75300,109000,33700,31
TIKI,nha-sach-tiki,160375101,"Ngữ pháp luyện thi IELTS - Grammar for ielts",88000,88000,0,0
TIKI,nha-sach-tiki,52329765,"Biên Niên Ký Chim Vặn Dây Cót (Tái Bản 2020)",137000,199000,62000,31
TIKI,nha-sach-tiki,196849389,"Gửi Em, Người Bất Tử - Tập 10 (Tái Bản 2022)",28900,30000,1100,4
TIKI,nha-sach-tiki,196849409,"Gửi Em, Người Bất Tử - Tập 11 (Tái Bản 2022)",28900,30000,1100,4
TIKI,nha-sach-tiki,76014598,"Blue Ocean Strategy - Chiến Lược Đại Dương Xanh (Bìa Cứng) (Tái Bản)",150600,239000,88400,37
TIKI,nha-sach-tiki,74285820,"Cơ Thể Tự Chữa Lành: Nước Ép Cần Tây",96000,148000,52000,35
TIKI,nha-sach-tiki,195357774,"Máy Tính CASIO FX-880BTG - Màu Xanh Biển",708000,800000,92000,12
TIKI,nha-sach-tiki,101782486,"Làm Ra Làm, Chơi Ra Chơi (Tái Bản)",104200,159000,54800,34
TIKI,nha-sach-tiki,4080373,"90% Trẻ Thông Minh Nhờ Cách Trò Chuyện Đúng Đắn Của Cha Mẹ",31000,39000,8000,21
TIKI,nha-sach-tiki,9695881,"Nghệ Thuật đầu tư Dhandho - The Dhandho Investor",238000,238000,0,0
TIKI,nha-sach-tiki,32415084,"Combo 2 cuốn Giáo Trình Hán Ngữ (Sách học Tiếng Trung dành cho người Việt): Giáo Trình Hán Ngữ Tập 1 + Giáo Trình Hán Ngữ Tập 2 (Học bằng App McBooks) - Tặng kèm bookmark GreenLife",170800,244000,73200,30
TIKI,nha-sach-tiki,10678954,"Full bộ Ehon Nhật Bản cho bé 0-6 tuổi thông minh, sáng tạo",271000,390000,119000,31
TIKI,nha-sach-tiki,196849406,"Gửi Em, Người Bất Tử - Tập 9 (Tái Bản 2022)",21400,30000,8600,29
TIKI,nha-sach-tiki,186271356,"Từ điển xây kênh từ cơ bản đến thành công",268000,268000,0,0
TIKI,nha-sach-tiki,63187280,"Combo 2 Cuốn: Cơ Thể Tự Chữa Lành",222000,345000,123000,36
TIKI,nha-sach-tiki,196849403,"Gửi Em, Người Bất Tử - Tập 8 (Tái Bản 2022)",21400,30000,8600,29
TIKI,nha-sach-tiki,73102465,"Bé Tô màu - Combo 11 cuốn",64900,127255,62355,49
TIKI,nha-sach-tiki,37411897,"Sách Đen - Bộ Công Cụ Của Phụ Nữ Thành Đạt",55600,79000,23400,30
TIKI,nha-sach-tiki,121185870,"Và Rồi Núi Vọng",109000,148000,39000,26
TIKI,nha-sach-tiki,124767712,"Không Tự Khinh Bỉ - Không Tự Phí Hoài (Tái Bản)",85200,119000,33800,28
TIKI,nha-sach-tiki,20520720,"Đối Thoại Với Thượng Đế ( Tái Bản )",72500,98000,25500,26
TIKI,nha-sach-tiki,113656455,"Giáo Trình Tư Tưởng Hồ Chí Minh (Dành Cho Bậc Đại Học Hệ Không Chuyên Lý Luận Chính Trị) - Bộ mới năm 2021",55000,55000,0,0
TIKI,nha-sach-tiki,53452969,"Khởi Nghiệp Du Kích - Kinh Doanh Ít Vốn - Vận Dụng Nguồn Lực Nhỏ Chiến Thắng Cuộc Chơi Lớn (Tái Bản)",155000,199000,44000,22
TIKI,nha-sach-tiki,167301575,"Khí Chất Bao Nhiêu Hạnh Phúc Bấy Nhiêu (Tái Bản 2022)",103000,139000,36000,26
TIKI,nha-sach-tiki,73207098,"Làm Chủ - Mastery",128000,200000,72000,36
TIKI,nha-sach-tiki,148750882,"Khi Mọi Thứ Sụp Đổ - Lời Khuyên Chân Thành Trong Những Thời Điểm Khó Khăn",82300,119000,36700,31
TIKI,nha-sach-tiki,1471887,"Tớ Muốn Ăn Tụy Của Cậu",72000,96000,24000,25
TIKI,nha-sach-tiki,40774181,"Combo Sách Tiếng hàn tổng hợp dành cho người Việt Nam - Sơ cấp 1 (Phiên bản 1 màu)",163800,234000,70200,30
TIKI,nha-sach-tiki,179546074,"Luật Hấp Dẫn - Quy Luật Về Sự Thịnh Vượng Và Thành Công",85400,129000,43600,34
TIKI,nha-sach-tiki,197781971,"Chòm Sao Linh Thú Tập 9",39100,40000,900,2
TIKI,nha-sach-tiki,50322710,"48 Nguyên Tắc Chủ Chốt Của Quyền Lực (Tái Bản 2020)",119000,200000,81000,41
TIKI,nha-sach-tiki,44627532,"Cẩm Nang Hướng Dẫn Thải Độc & Chế Độ Ăn Uống Lành Mạnh",98000,145000,47000,32
TIKI,nha-sach-tiki,75615273,"Combo 3 Cuốn Sách Ehon: Buồn Ngủ Ơi Là Buồn Ngủ (Dành Cho Trẻ Từ 0 - 4 Tuổi)",75700,117000,41300,35
TIKI,nha-sach-tiki,273633981,"[ Trạm Đọc Official ] Sách: Tâm Lý Học Thành Công (Tái Bản)",149000,199000,50000,25
TIKI,nha-sach-tiki,176550203,"Cuộc Đời Ngắn Lắm Đừng Ôm Muộn Phiền",62900,88000,25100,29
TIKI,nha-sach-tiki,109633951,"Combo 8 cuốn: Tô màu Nối số Thông minh",49920,96000,46080,48
TIKI,nha-sach-tiki,191320058,"Set 6 Chiếc Bút Highlight Hai Đầu Bút Nhớ Dòng Đánh Dấu Dạ Quang Take Note Ghi Chú Deli - Bảng Màu Pastel Macaron - 33002 S605 S735 S134",29000,57600,28600,50
TIKI,nha-sach-tiki,147920907,"Combo Bộ 6 Cuốn: Thư Viện Song Ngữ Đầu Tiên Cho Bé (0-3 Tuổi)",80500,108000,27500,25
TIKI,nha-sach-tiki,10767515,"Phân Tâm Học Nhập Môn",117000,159000,42000,26
TIKI,nha-sach-tiki,38223395,"Tâm Lý Học Hài Hước (Tái Bản)",63100,89000,25900,29
TIKI,nha-sach-tiki,193211309,"Chuông Gió (Tập 2)",126000,174000,48000,28
TIKI,nha-sach-tiki,176906754,"Inspired - Kiến Tạo Sản Phẩm Công Nghệ Chiếm Trọn Trái Tim Người Dùng",228000,295000,67000,23
TIKI,nha-sach-tiki,545278,"Combo Sherlock Holmes Toàn Tập (Trọn Bộ 3 Tập)",156000,300000,144000,48
TIKI,nha-sach-tiki,76013370,"Được Học - Educated (Tái Bản)",136000,182000,46000,25
TIKI,nha-sach-tiki,106693398,"Combo 4 cuốn: Luyện viết (Theo chương trình mới - Bé vào lớp 1)",37440,72000,34560,48
TIKI,nha-sach-tiki,4255933,"Plato Và Con Thú Mỏ Vịt Bước Vào Quán Bar (Tái Bản 2018 )",74000,100000,26000,26
TIKI,nha-sach-tiki,192124393,"Ikigami - Tập 06",43600,45000,1400,3
TIKI,nha-sach-tiki,196849393,"Gửi Em, Người Bất Tử - Tập 4 (Tái Bản 2022)",21000,30000,9000,30
TIKI,nha-sach-tiki,195980676,"Phượng Hoàng Tái Sinh - 12 Phẩm Chất Quan Trọng Để Bứt Phá Sự Nghiệp Và Cuộc Sống",109440,152000,42560,28
TIKI,nha-sach-tiki,76105910,"5 Ngôn Ngữ Yêu Thương - The Five Love Languages (Tái Bản)",89100,128000,38900,30
TIKI,nha-sach-tiki,36854641,"Sự Thật Về Thế Giới : Mười Lý Do Khiến Ta Hiểu Sai Về Thế Giới - Và Vì Sao Thế Gian Này Tốt Hơn Ta Tưởng",88200,160000,71800,45
TIKI,nha-sach-tiki,196849400,"Gửi Em, Người Bất Tử - Tập 5 (Tái Bản 2022)",21400,30000,8600,29
TIKI,nha-sach-tiki,189350061,"Giá Mà Nỗi Buồn Có Thể Cầm Nắm Trên Tay - Tặng kèm 03 postcard",78000,109000,31000,28
TIKI,nha-sach-tiki,10397241,"Sách Chữa Lành Nỗi Đau",67100,98000,30900,32
TIKI,nha-sach-tiki,196849396,"Gửi Em, Người Bất Tử - Tập 3 (Tái Bản 2022)",29500,30000,500,2
TIKI,nha-sach-tiki,103471709,"Full bộ (10 quyển) Truyện cổ tích Việt Nam (Song ngữ Việt - Anh) (giao ngẫu nhiên)",62400,120000,57600,48
TIKI,nha-sach-tiki,184475053,"Sa Vào Ánh Hào Quang Của Người – Tập 1",108000,132000,24000,18
TIKI,nha-sach-tiki,5067167,"Tôi Là Ai - Và Nếu Vậy Thì Bao Nhiêu? (Tái Bản 2018)",92200,126000,33800,27
TIKI,nha-sach-tiki,552393,"Hiểu Về Trái Tim",142000,158000,16000,10
TIKI,nha-sach-tiki,10920495,"Dế Mèn Phiêu Lưu Ký",104000,150000,46000,31
TIKI,nha-sach-tiki,74460137,"Sách Bí Quyết Áp Dụng 7 Thói Quen Của Bạn Trẻ Thành Đạt (Khổ Nhỏ) (Tái Bản 2020)",75100,108000,32900,30
TIKI,nha-sach-tiki,104651900,"Sách Seneca: Những Bức Thư Đạo Đức – Chủ nghĩa Khắc kỷ trong đời sống - Tập 1",149000,159000,10000,6
TIKI,nha-sach-tiki,187622581,"Sách Sức Mạnh Của Sự Trầm Lắng",99840,128000,28160,22
TIKI,nha-sach-tiki,95218547,"Đọc Vị Mọi Vấn Đề Của Trẻ - Giải Mã Mọi Vấn Đề Về Nuôi Con Nhỏ: Ăn - Ngủ - Kỷ Luật Hành Vi (Tái Bản)",133000,199000,66000,33
TIKI,nha-sach-tiki,140360872,"Để Xây Dựng Doanh Nghiệp Hiệu Quả (Tái Bản)",92620,139000,46380,33
TIKI,nha-sach-tiki,75338644,"Bảng viết, bảng vẽ cảm ứng điện tử thông minh tự động xóa cho bé - Hàng Chính Hãng VinBuy",65000,120000,55000,46
TIKI,nha-sach-tiki,100384412,"Vô Cùng Tàn Nhẫn Vô Cùng Yêu Thương (Tái Bản)",109620,189000,79380,42
TIKI,nha-sach-tiki,59078520,"Các phương pháp giao dịch ngắn hạn hiệu quả trên thị trường Forex – Day Trading and Swing Trading the Currency Market",299000,299000,0,0
TIKI,nha-sach-tiki,193917227,"Mỹ Vị Hầm Ngục - 3 - Bản Đặc Biệt - Tặng Kèm Bìa 2 Mặt, Bộ Đôi Card Chiến Binh & Ẩm Thực",45000,70000,25000,36
TIKI,nha-sach-tiki,196150482,"Người nuôi ong thành Aleppo - The beekeeper of Aleppo (Aspen Words Literary Prize Winner)",108000,168000,60000,36
TIKI,nha-sach-tiki,95090643,"Bút màu marker chuyên nghiệp Deli -kèm túi vải - 30/40/60/80 Màu - 70806",232200,232200,0,0
TIKI,nha-sach-tiki,188534368,"Khúc Ngẫu Hứng Trước Ga Mahoro",135000,180000,45000,25
TIKI,nha-sach-tiki,88791130,"Gôm Tẩy 2B Deli, 40×22×12Mm, Đen - 1 Viên - E3043",7200,7200,0,0
TIKI,nha-sach-tiki,139979524,"Thiền - Osho (Tái Bản)",102000,149000,47000,32
TIKI,nha-sach-tiki,1565657,"Dốc Hết Trái Tim - Cách Starbucks Xây Dựng Công Ty Bằng Từng Tách Cà Phê (Tái Bản 2018)",99000,150000,51000,34
TIKI,nha-sach-tiki,185188826,"Fryderyk Chopin: Cuộc Đời Và Thời Đại ",374000,499000,125000,25
TIKI,nha-sach-tiki,19349145,"Bí Mật Tư Duy Triệu Phú (Tái Bản 2019)",86000,108000,22000,20
TIKI,nha-sach-tiki,192475873,"Để Con Được Ốm",90100,120000,29900,25
TIKI,nha-sach-tiki,109322300,"Combo 8 cuốn Ehon Kỹ năng sống: Bon và Gia đình, Bạn bè",120640,232000,111360,48
TIKI,nha-sach-tiki,22878271,"Essential Grammar in Use Book with Answers Edition: A Self-Study Reference and Practice Book for Elementary Learners of English",165540,178000,12460,7
TIKI,nha-sach-tiki,95289208,"Người Bà Tài Giỏi Vùng Saga",83000,128000,45000,35
TIKI,nha-sach-tiki,3640421,"Đắc Nhân Tâm - Bản Dịch Gốc Từ Nguyễn Hiến Lê (Tặng Kèm Audio Book)",56100,90000,33900,38
TIKI,nha-sach-tiki,145300494,"The Mastery Of Self - Hành Trình Thấu Hiểu Bản Thân Và Tìm Thấy Tự Do",119000,180000,61000,34
TIKI,nha-sach-tiki,54422996,"Nóng Giận Là Bản Năng, Tĩnh Lặng Là Bản Lĩnh (Tái Bản 2020)",66800,89000,22200,25
TIKI,nha-sach-tiki,116397449,"Người Tình Sputnik",63500,86000,22500,26
TIKI,nha-sach-tiki,77900446,"Thần Số Học: Thấu Hiểu Nhân Tâm",75300,109000,33700,31
TIKI,nha-sach-tiki,274175495,"Tĩnh Lặng",49200,69000,19800,29
TIKI,nha-sach-tiki,184801142,"Cutie Pie – Em Ngoan, Lại Cho Là Em Ngốc - Bản thường (tặng kèm 1 bookmark in bồi 2 mặt)",146000,189000,43000,23
TIKI,nha-sach-tiki,186290802,"Bàn Có Năm Chỗ Ngồi (Tái Bản 2022)",25600,38000,12400,33
TIKI,nha-sach-tiki,91444567,"Sống Cuộc Đời Bạn Muốn",180000,220000,40000,18
TIKI,nha-sach-tiki,190701644,"Dám Mơ Lớn, Đừng Hoài Phí Tuổi Trẻ (Tái Bản) -Tặng kèm 1 bookmark 2 mặt",82100,119000,36900,31
TIKI,nha-sach-tiki,57350380,"Very Easy Toeic 1 - Introduction",158000,228000,70000,31
TIKI,nha-sach-tiki,197634255,"Anh em phi hành gia - Tập 34",32000,45000,13000,29
TIKI,nha-sach-tiki,136340700,"Trên Lưng Khổng Tượng - Kinh Doanh Online Trên Sàn Thương Mại Điện Tử - Khởi Nghiệp Với Bán Hàng Qua Mạng và Nhãn Hàng Riêng",155000,199000,44000,22
TIKI,nha-sach-tiki,129672282,"Từ vựng luyện thi IELTS - Vocabulary for Ielts with answers",56000,90000,34000,38
TIKI,nha-sach-tiki,198016673,"Vua Sáng Chế - Tập 18",20000,20000,0,0
TIKI,nha-sach-tiki,2716247,"Quẳng Gánh Lo Đi Và Vui Sống (Bìa Cứng)",77300,108000,30700,28
TIKI,nha-sach-tiki,196849405,"Gửi Em, Người Bất Tử - Tập 7 (Tái Bản 2022)",21000,30000,9000,30
TIKI,nha-sach-tiki,131401030,"Ayurveda",240000,240000,0,0
TIKI,nha-sach-tiki,12107394,"Barron's Essential Words For The Toeic (Tái Bản)",165000,238000,73000,31
TIKI,nha-sach-tiki,196849394,"Gửi Em, Người Bất Tử - Tập 6 (Tái Bản 2022)",21000,30000,9000,30
TIKI,nha-sach-tiki,184236581,"Năng Lực Của Sự Ngu Ngốc",168000,225000,57000,25
TIKI,nha-sach-tiki,73105037,"Combo 9 cuốn Tập tô - Tập viết chữ - Làm quen chữ cái/chữ số (Chuẩn bị vào lớp 1)",56160,108000,51840,48
TIKI,nha-sach-tiki,2812299,"Tiếng Nhật Cho Mọi Người - Sơ Cấp 1 - Bản Dịch Và Giải Thích Ngữ Pháp - Tiếng Việt (Bản Mới)",65000,100000,35000,35
TIKI,nha-sach-tiki,57815506,"Sách Tư Duy Ngược Dịch Chuyển Thế Giới",123000,178000,55000,31
TIKI,nha-sach-tiki,186088879,"Beyond Order - Vượt Lên Trật Tự",255000,350000,95000,27
TIKI,nha-sach-tiki,73139676,"Full bộ (20 quyển) Truyện kể Mầm non - Cổ tích - Ngụ ngôn Aesop (giao ngẫu nhiên)",107781,207271,99490,48
TIKI,nha-sach-tiki,167210783,"Trường An Ly Ca 1 – Máu Đỏ Hoa Đào",135000,175000,40000,23
TIKI,nha-sach-tiki,100958526,"Nhân Tố Enzyme - Thực Hành (Tái Bản 2021)",73000,109000,36000,33
TIKI,nha-sach-tiki,192339426,"Không Ai Sống Giống Ai Trong Cuộc Đời Này",112000,145000,33000,23
TIKI,nha-sach-tiki,181379116,"Hackers Toeic Vocabulary (Tái Bản)",173800,279000,105200,38
TIKI,nha-sach-tiki,155115301,"Bộ "Chuyện xóm gà" 2",276000,348000,72000,21
TIKI,nha-sach-tiki,111285050,"Ai Lấy Miếng Pho Mát Của Tôi ? (Tái Bản)",47100,68000,20900,31
TIKI,nha-sach-tiki,76541999,"Tăng tốc luyện đề thi Đánh giá năng lực (theo cấu trúc đề thi của Đại học Quốc gia TP. Hồ Chí Minh)",157000,225000,68000,30
TIKI,nha-sach-tiki,69219921,"OKRs - Hiểu Đúng, Làm Đúng - Cách Để Áp Dụng Thành Công OKRs Ngay Từ Đầu",150600,239000,88400,37
TIKI,nha-sach-tiki,190464440,"Ikigami - Tập 05",32000,45000,13000,29
TIKI,nha-sach-tiki,196517619,"Thiếu Nữ (Shoujo)",97500,150000,52500,35
TIKI,nha-sach-tiki,92492870,"Combo 6 Cuốn Ehon Nhật Bản : Ai Ở Sau Lưng Bạn Thế (Tái Bản)",161000,234000,73000,31
TIKI,nha-sach-tiki,22634335,"Kỹ Năng Quản Lý Nhân Sự Chuyên Nghiệp",82300,119000,36700,31
TIKI,nha-sach-tiki,8835165,"Ông Trăm Tuổi Trèo Qua Cửa Sổ Và Biến Mất (Tái Bản)",125000,190000,65000,34
TIKI,nha-sach-tiki,3048355,"Nhà (Tái Bản)",69900,109000,39100,36
TIKI,nha-sach-tiki,193605374,"Làm Sao Để Che Giấu Một Đế Quốc - How To Hide An Empire",221000,299000,78000,26
TIKI,nha-sach-tiki,197602047,"Fullmetal Alchemist - Cang Giả Kim Thuật Sư - Fullmetal Edition Tập 9",61400,69000,7600,11
TIKI,nha-sach-tiki,191801175,"Nhịn Khô",98000,139000,41000,29
TIKI,nha-sach-tiki,9687409,"Thôi Miên Bằng Ngôn Từ",121580,169000,47420,28
TIKI,nha-sach-tiki,186211127,"Khởi Nghiệp Kinh Doanh Online - Bán Hàng Hiệu Quả Trên Shopee",151000,199000,48000,24
TIKI,nha-sach-tiki,58390336,"Python cơ bản",125000,125000,0,0
TIKI,nha-sach-tiki,171170802,"Kỹ thuật giao dịch nâng cao để kiếm tiền hàng ngày trên thị trường chứng khoán – Advanced Techniques in Day Trading",359000,359000,0,0
TIKI,nha-sach-tiki,107342987,"Bút bi nước khô nhanh Deli - 0.5mm - Bút viết thư pháp - Ống bút liền mực - Mực Xanh - 1 chiếc - S856",12600,12600,0,0
TIKI,nha-sach-tiki,2380007,"Khi Bạn Đang Mơ Thì Người Khác Đang Nỗ Lực",108800,136000,27200,20
TIKI,nha-sach-tiki,53301006,"Sách Ping - Vượt Ao Tù Ra Biển Lớn (Tái Bản 2020)",64100,98000,33900,35
TIKI,nha-sach-tiki,68392386,"Stephen Hawking - Trả Lời Ngắn Gọn Những Câu Hỏi Lớn",55800,90000,34200,38
TIKI,nha-sach-tiki,8886005,"Bay Trên Tổ Chim Cúc Cu (Tái Bản)",91000,118000,27000,23
TIKI,nha-sach-tiki,186434701,"Khi Bạn Đang Say Giấc, Ai Đó Đã Đạt Được Ước Mơ-Tặng kèm 01 bookmark",76100,108000,31900,30
TIKI,nha-sach-tiki,188940825,"Những Chàng Trai Ở Lộc Phong Quán – Tập 10 - Tặng 1 bookmark 2 mặt ",38100,48000,9900,21
TIKI,nha-sach-tiki,190242074,"Chuông Gió (Tập 1) - Tặng kèm 1 bookmark",124000,174000,50000,29
TIKI,nha-sach-tiki,11357193,"Những Cuộc Phiêu Lưu Của Huckleberry Finn",63000,98000,35000,36
TIKI,nha-sach-tiki,45349383,"Hashtag No.2 Fashion - Kinh Doanh Thời Trang Tại Thị Trường Việt Nam",153000,200000,47000,24
TIKI,nha-sach-tiki,193981038,"Vua sáng chế - Tập 15",20000,20000,0,0
TIKI,nha-sach-tiki,90227346,"Sapiens: Lược Sử Loài Người Bằng Tranh - Tập 1: Khởi Đầu Của Loài Người",212100,345000,132900,39
TIKI,nha-sach-tiki,113583126,"Ngữ Pháp Tiếng Anh (Tái Bản)",57400,89000,31600,36
TIKI,nha-sach-tiki,189657596,"Komi - Nữ Thần Sợ Giao Tiếp Tập 11",25000,25000,0,0
TIKI,nha-sach-tiki,76401055,"Sét Bong Bóng Trang Trí Sinh Nhật FUNU Nhiều Mẫu Kèm Bơm Tay- Hàng Chính Hãng",116850,123000,6150,5
TIKI,nha-sach-tiki,135754581,"Những Câu Chuyện Truyền Cảm Hứng - I Will Be Better: Nguồn Năng Lượng Tích Cực",43000,58000,15000,26
TIKI,nha-sach-tiki,188487640,"Dragon Ball Full Color - Phần Năm: Truy Lùng Cell Bọ Hung  - Tập 2 [Tặng Ngẫu Nhiên 1 Trong 2 Mẫu Postcard Nhân Vật]",68100,77000,8900,12
TIKI,nha-sach-tiki,186434891,"Cá Cược Với Tình Yêu",95000,95000,0,0
TIKI,nha-sach-tiki,109018530,"Vườn Hoa Mạt Dược Ký Sự - Những Kỳ Án Nổi Tiếng Chưa Có Lời Giải (Tặng Kèm 1 Bookmark Chữ Nhật)",90100,139000,48900,35
TIKI,nha-sach-tiki,170094968,"Atlas Giải Phẫu Cơ Thể Người - Tái Bản",502000,680000,178000,26
TIKI,nha-sach-tiki,95090377," Bút màu sáp dầu học sinh hộp nhựa Deli - 12/18/24 màu - 72090/72091/72092",52200,52200,0,0
TIKI,nha-sach-tiki,187619074,"Quý Cô Tài Chính",103000,139000,36000,26
TIKI,nha-sach-tiki,173093792,"Thao Túng Tâm Lý - Nhận Diện, Thức Tỉnh Và Chữa Lành Những Tổn Thương Tiềm Ẩn",126800,169000,42200,25
TIKI,nha-sach-tiki,13673970,"Combo Trinh Thám Giây Thứ 12 (2 Tập)",95000,276000,181000,66
TIKI,nha-sach-tiki,185595374,"Picasso Và Bức Tranh Khiến Thế Giới Sửng Sốt",299000,399000,100000,25
TIKI,nha-sach-tiki,170463582,"Siêu Nhí Biết Tuốt - 101 Bí Ẩn Kích Thích Tò Mò Của Các Bạn Nhỏ",124800,240000,115200,48
TIKI,nha-sach-tiki,87389629,"OSHO - Sáng Tạo Bừng Cháy Sức Mạnh Bên Trong (Tái Bản)",72000,108000,36000,33
TIKI,nha-sach-tiki,77324132,"Phụ Nữ Hiểu Biết Sẽ Có Cuộc Sống Đẳng Cấp Hơn (Tặng Kèm Bookmark)",85900,119000,33100,28
TIKI,nha-sach-tiki,335337,"Tôi Tài Giỏi - Bạn Cũng Thế",128050,135000,6950,5
TIKI,nha-sach-tiki,142002263,"Muôn Kiếp Nhân Sinh 2 (Bìa Cứng)",338000,338000,0,0
TIKI,nha-sach-tiki,58441509,"Ăn Uống Đúng Cách: Bộ Quy Tắc Ẩm Thực Lành Mạnh",86000,116000,30000,26
TIKI,nha-sach-tiki,191506179,"Sách Bạn Thật Sự Là Ai?",60600,88000,27400,31
TIKI,nha-sach-tiki,176473191,"Bút màu marker lẻ chiếc 2 đầu to nhỏ nhiều màu thân bút vuông màu đen Deli - Tô màu vẽ tranh trang trí sổ tay - 70701",4000,9000,5000,56
TIKI,nha-sach-tiki,117035933,"Sách: Hài Hước Một Chút Thế Giới Sẽ Khác Đi (Tái Bản)",64000,80000,16000,20
TIKI,nha-sach-tiki,117681065,"Sống Thực Tế Giữa Đời Thực Dụng (Tái Bản)",92400,129000,36600,28
TIKI,nha-sach-tiki,26593338,"Misty Morning Walk With Mother - Cùng Mẹ Đi Trong Sương Sớm",41000,85000,44000,52
TIKI,nha-sach-tiki,174038838,"Here U Are – Tập 2 - Bản Thường: Tặng Kèm 1 Bookmark Bế Hình",88600,110000,21400,19
TIKI,nha-sach-tiki,107802188,"Bí Mật Tư Duy Triệu Phú (Tái Bản)",75100,108000,32900,30
TIKI,nha-sach-tiki,95090744," Bút chì lục giác Deli - loại 2B/HB - 30 chiếc/hộp - 58166 / 58167",45000,99000,54000,55
TIKI,nha-sach-tiki,126853168,"Thấu hiểu Hành vi giá Thị trường Tài chính (Understanding Price Action)",367000,367000,0,0
TIKI,nha-sach-tiki,189371286,"[ Gift] [Hàng Tặng Không Bán] Sổ Tay Sức Khỏe DHC",50000,50000,0,0
TIKI,nha-sach-tiki,75813201,"Không Đến Một (Tái Bản - Bìa Cam)",79200,110000,30800,28
TIKI,nha-sach-tiki,32192510,"Madame Chic - Rất Thần Thái, Rất Paris",64000,99000,35000,35
TIKI,nha-sach-tiki,195306000,"Tư trị thông giám - Tập 9",211000,285000,74000,26
TIKI,nha-sach-tiki,67477613,"Xin Bạn Hãy Ôm Lấy Trái Tim Mình Trước Đã (Tặng Kèm 1 Bookmark)",64800,96000,31200,33
TIKI,nha-sach-tiki,193684717,"Từ Vũ Trụ Đến Trái Tim – Những Thông Điệp Yêu Thương",88100,89000,900,1
TIKI,nha-sach-tiki,185024355,"Spy X Family 7",25000,25000,0,0
TIKI,nha-sach-tiki,193981046,"Tiệm trừ yêu kì ảo - Tập 17",33000,35000,2000,6
TIKI,nha-sach-tiki,137241842,"Trồng Một Nụ Cười - Cùng Trẻ Thực Hành Chánh Niệm",138000,199000,61000,31
TIKI,nha-sach-tiki,75403873,"Bộ Màu Nước Solid Water Color Cao Cấp - Tặng Kèm 2 Bút Nước, 2 Mút, 1 Palette - Chuyên Dùng Cho Học Sinh, Sinh Viên, Vẽ Chuyên Nghiệp - Hàng Chính Hãng - VinBuy",65000,120000,55000,46
TIKI,nha-sach-tiki,195801645,"Thực Học Của Inamori Kazuo: Quản Trị Và Kế Toán",64000,95000,31000,33
TIKI,nha-sach-tiki,130314065,"Tâm lý thị trường chứng khoán - Hành vi đám đông và sự thật đằng sau những con sóng",37100,50000,12900,26
TIKI,nha-sach-tiki,41131985,"Thực Hành 7 Thói Quen Của Bạn Trẻ Thành Đạt",53600,78000,24400,31
TIKI,nha-sach-tiki,174377494,"Combo 10 cuốn Ehon Ươm mầm Tính cách",202800,390000,187200,48
TIKI,nha-sach-tiki,107363748,"Bút chì màu dạng cốc Deli - bút chì gỗ khô tự nhiên an toàn -  12/24/36/48 màu - 7070",52200,52200,0,0
TIKI,nha-sach-tiki,56878836,"Sách Muôn Kiếp Nhân Sinh (Bìa Cứng) - Nguyên Phong",169000,228000,59000,26
TIKI,nha-sach-tiki,190214568,"Kỷ luật bản thân",132300,189000,56700,30
TIKI,nha-sach-tiki,49249526,"Thiết Kế Cuộc Đời Thịnh Vượng - Design a Prosperous Life",299000,299000,0,0
TIKI,nha-sach-tiki,106788395,"Toán Tư duy - Beginning Creative Math (Dành cho bé 4-6 tuổi/Song ngữ Việt - Anh)",57200,110000,52800,48
TIKI,nha-sach-tiki,544731,"Giáo Trình Chuẩn HSK 2 - Bài Học (Kèm file MP3)",149000,198000,49000,25
TIKI,nha-sach-tiki,140416366,"Hôm Nay Phải Mở Mang (Một Tựa Sách Của Ngày Ngày Viết Chữ Dành Cho Người Học Viết Và Làm Nghề Viết)",93500,119000,25500,21
TIKI,nha-sach-tiki,111290700,"Bố Già (Bìa Cứng) (Tái Bản)",149175,250000,100825,40
TIKI,nha-sach-tiki,178483666,"Những Lời Giáo Huấn Của Epictetus",171000,239000,68000,28
TIKI,nha-sach-tiki,149573910,"Thiên Quan Tứ Phúc - Tập 4",110700,159000,48300,30
TIKI,nha-sach-tiki,23433003,"30 Chủ Đề Từ Vựng Tiếng Anh (Tập 1)",123000,190000,67000,35
TIKI,nha-sach-tiki,4466841,"Trưởng Thành Sau Ngàn Lần Tranh Đấu (Tái Bản)",69100,95000,25900,27
TIKI,nha-sach-tiki,142791749,"Sự Trỗi Dạy Và Suy Tàn Của Đế Chế Thứ 3 (Tái Bản)",275000,445000,170000,38
TIKI,nha-sach-tiki,126474205,"Làm giàu từ chứng khoán bằng phương pháp VSA chính gốc: Nghiên cứu chuyên sâu về cách giao dịch của Wyckoff",499000,499000,0,0
TIKI,nha-sach-tiki,971704,"Tạo Lập Mô Hình Kinh Doanh (Tái bản)",185400,299000,113600,38
TIKI,nha-sach-tiki,192125806,"Dạy con làm giàu - Tập 11 - Trường dạy kinh doanh cho những người thích giúp đỡ người khác (Tái Bản 2022)",53000,80000,27000,34
TIKI,nha-sach-tiki,190701636,"Yuri Espoir (Tập 2) - Bản thường: tặng kèm postcard",59100,79000,19900,25
TIKI,nha-sach-tiki,197629362,"Bức Họa Múa Rối Xương (Combo tập 1+2)",217000,279000,62000,22
TIKI,nha-sach-tiki,171549988,"Trường An Ly Ca 2 - Vén Mây Thấy Trời",127000,165000,38000,23
TIKI,nha-sach-tiki,113655308,"Giáo Trình Kinh Tế Chính Trị Mác – Lênin (Dành Cho Bậc Đại Học Hệ Không Chuyên Lý Luận Chính Trị) - Bộ mới năm 2021",59000,59000,0,0
TIKI,nha-sach-tiki,1445365,"Dưới Một Mái Nhà Ở Paris",87100,119000,31900,27
TIKI,nha-sach-tiki,142675354,""Từ Điển" Sử Dụng Loài Người",75500,105000,29500,28
TIKI,nha-sach-tiki,116835635,"Tớ Học Lập Trình - Làm Quen Với Python",77800,105000,27200,26
TIKI,nha-sach-tiki,193446626,"Chòm Sao Linh Thú Tập 8 [Tặng kèm Bookmark]",39000,40000,1000,3
TIKI,nha-sach-tiki,192124401,"Kingdom -Tập 31",43600,45000,1400,3
TIKI,nha-sach-tiki,174605333,"Châu Phi Nghìn Trùng (Tái Bản)",123000,165000,42000,25
TIKI,nha-sach-tiki,95311757,"Lưu Thông Máu Tốt Hóa Giải Bách Bệnh",68300,99000,30700,31
TIKI,nha-sach-tiki,50773990,"Triết Lý Kinh Doanh Của Kyocera",124000,175000,51000,29
TIKI,nha-sach-tiki,197602052,"Fullmetal Alchemist - Cang Giả Kim Thuật Sư - Fullmetal Edition Tập 7",62000,69000,7000,10
TIKI,nha-sach-tiki,185226873,"Achievers Grade 7 Student's Book with CLIL Book",251000,251000,0,0
TIKI,nha-sach-tiki,136232535,"Ux Content 4.0 (Chọn Đúng Chữ, Giữ Người Dùng)",117000,139000,22000,16
TIKI,nha-sach-tiki,106997685,"Keo dán siêu chắc Sealant Fix - Giải pháp thay thế đinh vít",21000,21000,0,0
TIKI,nha-sach-tiki,96327064,"Bye Béo - Cách giảm 7kg trong 30 ngày",199000,199000,0,0
TIKI,nha-sach-tiki,175845415,"Bí Quyết Tìm Kiếm Mặt Bằng Kinh Doanh - Đến Sahara Mở Quán Trà Đá - Bộ Sách Khởi Nghiệp Bán Lẻ",169000,199000,30000,15
TIKI,nha-sach-tiki,188039858,"Combo 4 Cuốn Sổ Tay Ghi Chép A5 Gáy Xoắn 120 Trang Kẻ Ngang Deli - Phù Hợp Làm Sổ Kế Hoạch Planner, Nhật Kí, Tập Vở Ghi Chép Bullet Journal - LA560-06",18000,37800,19800,52
TIKI,nha-sach-tiki,181699672,"Shuggie Bain: Chiếc Linh Hồn Nhỏ",156000,235000,79000,34
TIKI,nha-sach-tiki,192692368,"Phương Pháp Thực Chiến Hiệu Suất Cao Đến Từ Nhà Quán Quân Giao Dịch Tài Chính",364000,364000,0,0
TIKI,nha-sach-tiki,137561095,"Combo 2 Cuốn Sách Tâm Lý Học Nhập Môn: Toàn Thư Tâm Lý Học + Từ Điển Tâm Lý",183000,254000,71000,28
TIKI,nha-sach-tiki,273896677,"Trí Tuệ Do Thái",141000,189000,48000,25
TIKI,nha-sach-tiki,98733259,"Những Tù Nhân Của Địa Lí - Khám Phá Sự Vận Hành Của Thế Giới Qua Những Tấm Bản Đồ - Phiên Bản Minh Hoạ Màu Dành Cho Độc Giả Trẻ",162000,230000,68000,30
TIKI,nha-sach-tiki,55605172,"Tắt Đèn (Tái Bản 2020)",33000,50000,17000,34
TIKI,nha-sach-tiki,53434797,"Sách Tài Chính Cá Nhân Cho Người Việt Nam - Tặng Khóa học Online về Tài chính",200000,200000,0,0
TIKI,nha-sach-tiki,110944248,"Tôi Không Thích Ồn Ào (Tặng Kèm Bookmark)(Tái Bản)",55000,75000,20000,27
TIKI,nha-sach-tiki,106149744,"Tôi Đã Kiếm 2.000.000 Đô La Từ Thị Trường Chứng Khoán Như Thế Nào (Tái Bản)",63220,109000,45780,42
TIKI,nha-sach-tiki,193099631,"Đại Gia Gatsby",59000,86000,27000,31
TIKI,nha-sach-tiki,197602124,"Fullmetal Alchemist - Cang Giả Kim Thuật Sư - Fullmetal Edition - Tập 6",61100,69000,7900,11
TIKI,nha-sach-tiki,187827390,"Gửi Tới Người Mùa Đông Này Sẽ Không Còn Nữa",95400,123000,27600,22
TIKI,nha-sach-tiki,3876677,"Hỏa Ngục",149000,239000,90000,38
TIKI,nha-sach-tiki,83664156,"Rio Book No.2 - Nhận Diện Thương Hiệu, Những Điểm Chạm Thị Giác (Tái Bản)",127000,170000,43000,25
TIKI,nha-sach-tiki,162832796,"Rilla Dưới Mái Nhà Bên Ánh Lửa",154000,200000,46000,23
TIKI,nha-sach-tiki,23437685,"English Vocabulary in Use: Pre-Intermediate and Intermediate Book with Answers: Vocabulary Reference and Practice (Kèm CD)",177600,193000,15400,8
TIKI,nha-sach-tiki,139979522,"Ăn Dặm Kiểu Nhật (Tái Bản)",127000,189000,62000,33
TIKI,nha-sach-tiki,105778970,"Nhật Ký Tarot",158000,199000,41000,21
TIKI,nha-sach-tiki,11336581,"Rich Habits - Thói Quen Thành Công Của Những Triệu Phú Tự Thân",110000,158000,48000,30
TIKI,nha-sach-tiki,106206473,"Thân Gửi Sở Thú",60100,79000,18900,24
TIKI,nha-sach-tiki,187933551,"Reiki - Nghệ Thuật Chữa Lành Bằng Năng Lượng",131600,189000,57400,30
TIKI,nha-sach-tiki,57590002,"Fullmetal Alchemist - Cang Giả Kim Thuật Sư - Fullmetal Edition Tập 5",61000,69000,8000,12
TIKI,nha-sach-tiki,188663311,"Khi Bạn Đang Mơ Thì Người Khác Đang Nỗ Lực (2022)",91200,136000,44800,33
TIKI,nha-sach-tiki,43859629,"Người giàu nhất thành Babylon - phiên bản đầy đủ thêm 2 chương mới",54000,80000,26000,33
TIKI,nha-sach-tiki,192474352,"Vẻ Đẹp Của Sự Vừa Đủ",113000,136000,23000,17
TIKI,nha-sach-tiki,56377199,"Giải Mã Siêu Trí Tuệ",126000,169000,43000,25
TIKI,nha-sach-tiki,897016,"Combo Sân Chơi Trí Tuệ Của Chim Đa Đa (Bộ 6 Cuốn)",125000,180000,55000,31
TIKI,nha-sach-tiki,178514165,"Dọc Đường",124000,160000,36000,23
TIKI,nha-sach-tiki,147802908,"Trong Cái Không Có Gì Không ? - Thiền Sư Thích Nhất Hạnh (NXB KĐ - bìa cứng)",144000,160000,16000,10
TIKI,nha-sach-tiki,54433518,"Combo Sách Học Tiếng Anh Little Stories 1 (5 Cuốn)",226000,325000,99000,30
TIKI,nha-sach-tiki,191571530,"Văn Phòng Thám Tử Quái Vật - Tập 09",29100,30000,900,3
TIKI,nha-sach-tiki,193917225,"Vẽ Vời Vẩn Vơ - 3",19000,58000,39000,67
TIKI,nha-sach-tiki,3640427,"Quẳng Gánh Lo Đi Và Vui Sống (Nguyễn Hiến Lê - Bộ Sách Sống Sao Cho Đúng)",56100,90000,33900,38
TIKI,nha-sach-tiki,140635218,"Nuôi Dạy Đứa Trẻ Tự Chủ",130000,179000,49000,27
TIKI,nha-sach-tiki,131879454,"Combo Philip Kotler: Tiếp Thị 5.0 - Công Nghệ Vị Nhân Sinh Và Tiếp Thị 4.0 - Dịch Chuyển Từ Truyền Thống Sang Công Nghệ Số",223250,235000,11750,5
TIKI,nha-sach-tiki,189641377,"Kombucha - Tuyệt Đỉnh Thức Uống Lên Men",249000,320000,71000,22
TIKI,nha-sach-tiki,192677821,"Sổ tay công thức giải nhanh Toán 12",59000,98000,39000,40
TIKI,nha-sach-tiki,174449882,"“Lần Đầu Làm Sếp” – (Your First Leadership Job)",137000,195000,58000,30
TIKI,nha-sach-tiki,149257065,"Keanu Reeves - Ma Trận Cuộc Đời (Bí Ẩn Đằng Sau Người Đàn Ông Tử Tế Nhất Hành Tinh)",80000,168000,88000,52
TIKI,nha-sach-tiki,67991600,"Nghệ Thuật Từ Chối – Cách Nói Không Mà Vẫn Có Được Đồng Thuận",56000,82000,26000,32
TIKI,nha-sach-tiki,168367080,"Thông Não Ielts Reading Cùng Linear",432000,499000,67000,13
TIKI,nha-sach-tiki,11806671,"Combo Doraemon Truyện Tranh Màu Kỹ Thuật Số (6 Tập)",161000,180000,19000,11
TIKI,nha-sach-tiki,76278485,"Ảo Dạ (Tái Bản)",133000,179000,46000,26
TIKI,nha-sach-tiki,150956757,"Combo 8 cuốn Túi tô màu Tập làm họa sĩ nhí",43680,84000,40320,48
TIKI,nha-sach-tiki,116158321,"7 Chiến Lược Thịnh Vượng Và Hạnh Phúc (Tái Bản 2021)",68000,85000,17000,20
TIKI,nha-sach-tiki,143185998,"Ăn Dặm Không Phải Là Cuộc Chiến (Tái Bản)",196000,289000,93000,32
TIKI,nha-sach-tiki,104315085,"Tư Duy Logic (Tái Bản)",71300,110000,38700,35
TIKI,nha-sach-tiki,65786287,"Triệu phú thức tỉnh - bí kíp để khơi dòng suối nguồn thịnh vượng trong tâm thức",214400,268000,53600,20
TIKI,nha-sach-tiki,110965784,"Keo Dán Giày Siêu Chắc Chống Nước Tốt Seaglue 100g",69000,79000,10000,13
TIKI,nha-sach-tiki,185889844,"Tại Sao Chúng Tôi Muốn Bạn Giàu",89000,135000,46000,34
TIKI,nha-sach-tiki,177736624,"Mặc Kệ Thiên Hạ - Sống Như Người Nhật (Tái Bản)",71000,94000,23000,24
TIKI,nha-sach-tiki,195291930,"Bốn Thỏa Ước",83500,130000,46500,36
TIKI,nha-sach-tiki,121372698,"NGÀI CÓC ĐI GẶP BÁC SĨ TÂM LÝ ( BÌA CỨNG)",152500,219000,66500,30
TIKI,nha-sach-tiki,178032047,"Fullmetal Alchemist - Cang Giả Kim Thuật Sư - Fullmetal Edition Tập 14 [Tặng Kèm Bookmark Pvc]",61100,69000,7900,11
TIKI,nha-sach-tiki,58971674,"Sách Nghệ Thuật Bán Hàng Của Người Do Thái (Tái Bản 2020)",60600,88000,27400,31
TIKI,nha-sach-tiki,193605360,"Chuyện Xưa Tôi Nhớ Người Cũ Đã Quên (Lam – Lê)",64000,89000,25000,28
TIKI,nha-sach-tiki,65008052,"Từ Điển Anh - Anh - Việt",208600,298000,89400,30
TIKI,nha-sach-tiki,148802204,"Chuyện Trà - Lịch Sử Một Thức Uống Lâu Đời Của Người Việt (Bìa Mềm)",216000,290000,74000,26
TIKI,nha-sach-tiki,184782104,"Cha Mẹ Độc Hại (Tái Bản)",110000,148000,38000,26
TIKI,nha-sach-tiki,192909296,"Anh Em Phi Hành Gia - Tập 31",32600,45000,12400,28
TIKI,nha-sach-tiki,1734377,"Những Chú Chó Bán Hàng",89000,140000,51000,36
TIKI,nha-sach-tiki,174215331,"Ajin - Boxset Số 2 (Tập 7 - 12) - Tặng Kèm Bookmark 3D",214000,300000,86000,29
TIKI,nha-sach-tiki,9490657,"Hệ thống giao dịch Ichimoku Charts - Ichimoku Kinko Clouds (Phiên bản sách năm 2018)",330000,330000,0,0
TIKI,nha-sach-tiki,167686691,"Sách Tổng Ôn Cấp Tốc Toán Học 12, Sách Ôn Thi THPT Quốc Gia Moon",149000,200000,51000,26
TIKI,nha-sach-tiki,163165281,"Mong Mẹ Hãy Yêu Lấy Chính Mình",72100,99000,26900,27
TIKI,nha-sach-tiki,121185868,"Vang Bóng Một Thời (Việt Nam Danh Tác)",57500,76000,18500,24
TIKI,nha-sach-tiki,104273017,"Combo 2 Tập: Tăng Thông Khí - Bản Thường - (Tặng Kèm 2 Bookmark In 2 Mặt)(Bìa Mềm)",182000,258000,76000,29
TIKI,nha-sach-tiki,28292286,"Combo 30 Chủ Đề Từ Vựng Tiếng Anh (2 Tập)",245000,380000,135000,36
TIKI,nha-sach-tiki,185435293,"Nhân Sinh Nơi Nơi Đều Là Tu Hành ( Tặng 1 Bookmark 02 mặt + 1 Sổ phụ chương khổ 12x16cm)",144000,145000,1000,1
TIKI,nha-sach-tiki,52798281,"Phương Pháp Giáo Dục Sớm Montessori Cho Trẻ Từ
0 – 3 Tuổi",63000,99000,36000,36
TIKI,nha-sach-tiki,467896,"Trà Hoa Nữ (Tái Bản)",33000,50000,17000,34
TIKI,nha-sach-tiki,146223395,"Cách thức kinh doanh và đầu cơ cổ phiếu! – How to Trade in Stocks",349000,349000,0,0
TIKI,nha-sach-tiki,127077157,"Bà Tổng Thống Trước Họng Súng - Hai Số Phận - Phần III",114000,169000,55000,33
TIKI,nha-sach-tiki,69624539,"Khoa Học Về Yoga",223000,300000,77000,26
TIKI,nha-sach-tiki,110447680,"Kế Hoạch Marketing Trên Một Trang Giấy (Những Chỉ Dẫn Dễ Hiểu Nhất Cho Một Kế Hoạch Marketing Thông Minh)",104200,159000,54800,34
TIKI,nha-sach-tiki,165030714,"Black Jack 07 (Bìa Mềm)",28000,30000,2000,7
TIKI,nha-sach-tiki,114765005,"Vụng Trộm Yêu Anh - Tập 1+2 (Tặng Kèm: 02 Bookmark 2 Mặt Theo Bìa)",178000,249000,71000,29
TIKI,nha-sach-tiki,186265452,"My Hero Academia - Học Viện Siêu Anh Hùng Tập 29: Bakugo Katsuki: Trỗi Dậy",25000,25000,0,0
TIKI,nha-sach-tiki,75636226,"Phương pháp VPA - Kỹ thuật nhận diện Dòng Tiền Thông Minh bằng Hành Động Giá kết hợp Khối Lượng Giao Dịch",357000,357000,0,0
TIKI,nha-sach-tiki,85923342,"Minh Triết Trong Ăn Uống Của Phương Đông (Tái Bản)",121000,168000,47000,28
TIKI,nha-sach-tiki,7644510,"Lòng Tốt Của Bạn Cần Thêm Đôi Phần Sắc Sảo",80000,108000,28000,26
TIKI,nha-sach-tiki,191571328,"Black Jack (Bản Đặc Biệt) - Tập 12",134000,135000,1000,1
TIKI,nha-sach-tiki,84950236,"Người Nhạy Cảm Trong Thế Giới Vô Cảm",56100,85000,28900,34
TIKI,nha-sach-tiki,184779709,"Xã Hội Học - Khái Lược Những Tư Tưởng Lớn",284000,390000,106000,27
TIKI,nha-sach-tiki,186202768,"Và Rồi Tháng 9 Không Có Cậu Đã Tới (Tái Bản)",75800,106000,30200,28
TIKI,nha-sach-tiki,74981856,"Gửi Bạn, Người Đã Kiệt Sức Vì Những Chịu Đựng Âm Thầm [Tặng Kèm: 1 Bookmark Daisy]",66700,96000,29300,31
TIKI,nha-sach-tiki,184629090,"Lấy Nước Đường Xa",67800,99000,31200,32
TIKI,nha-sach-tiki,13061338,"Series Địch Công Kỳ Án Tập 15 - Hoa Văn Cây Liễu",49500,99000,49500,50
TIKI,nha-sach-tiki,187001113,"Giấy bọc sách vở / Giấy gói quà / giấy bao tập / giấy bao vở học sinh, sinh viên size A4, B5, A5 cao cấp – 24 cuốn",49000,88000,39000,44
TIKI,nha-sach-tiki,157255019,"Bộ Màu Nước Nén Water Color Cao Cấp 24 36 48 Màu Tặng Bút Lông Nước, Mút, Cọ, Tẩy, Bút Chì, Gọt, Màu Trắng Deli - Chuyên Dùng Cho Học Sinh, Sinh Viên, Vẽ Mĩ Thuật Chuyên Nghiệp - Ô tổ ong - 73936",135000,268200,133200,50
TIKI,nha-sach-tiki,110583137,"Bút highlight nhấn dòng dạ quang Deli - Cam/ Vàng/ Xanh Lá/ Hồng/ Xanh Dương - S625",8333,17400,9067,52
TIKI,nha-sach-tiki,185242029,"Vũ Điệu Quỷ Satan",123000,158000,35000,22
TIKI,nha-sach-tiki,49722650,"12 Quy Luật Cuộc Đời: Thần Dược Cho Cuộc Sống Hiện Đại",193000,300000,107000,36
TIKI,nha-sach-tiki,447164,"Tôi Vẽ - Phương Pháp Tự Học Vẽ Truyện Tranh",73000,100000,27000,27
TIKI,nha-sach-tiki,62648437,"Kinh Doanh Dịch Vụ Tại Việt Nam - Tự Tay Vận Hành Hoạt Động Marketing Của Bạn",144000,190000,46000,24
TIKI,nha-sach-tiki,194205624,"Pippi Tất Dài",92000,125000,33000,26
TIKI,nha-sach-tiki,74608742,"Vừa Đủ - Đẳng Cấp Sống Của Người Thụy Điển (Tái Bản)",64000,98000,34000,35
TIKI,nha-sach-tiki,150783204,"Combo 10 miếng dán keo 2 mặt xốp siêu dính",20000,20000,0,0
TIKI,nha-sach-tiki,173650547,"30 Chuyên Đề Ngữ Pháp Tiếng Anh Cô Trang Anh: Sách ID Tổng ôn Ngữ pháp Tiếng Anh Moonbook",189000,250000,61000,24
TIKI,nha-sach-tiki,160488838,"Axit Và Kiềm Trong Thực Dưỡng (Tái Bản)",53000,75000,22000,29
TIKI,nha-sach-tiki,169621653,"Đến Ngày Gặp Anh",103800,115000,11200,10
TIKI,nha-sach-tiki,77982978,"The Master COACH - Con Đường Trở Thành Nhà Khai Vấn Tài Ba",96500,150000,53500,36
TIKI,nha-sach-tiki,196204932,"[A3/A4/A5/A6] Giấy Vẽ Màu Nước Tệp 16 Tờ 300Gsm A3 / A4 / A5 / A6 Chuyên Dụng Hạng Hoạ Sĩ Watercolor Paper Cao Cấp Finenolo Deli - Dùng Cho Màu Nước Gouache Acrylic Nhiều Cọ - EC270",29000,63000,34000,54
TIKI,nha-sach-tiki,155049277,"IELTS Key Writing - Công Thức Học Nhanh IELTS Writing Task 1",78000,119000,41000,34
TIKI,nha-sach-tiki,273645890,"Trạm Đọc | Thuật Tẩy Não",141000,189000,48000,25
TIKI,nha-sach-tiki,97825967,"Tuyển Tập Những Câu Chuyện Hay Nhất Của AESOP (Song Ngữ Anh - Việt)",72100,108000,35900,33
TIKI,nha-sach-tiki,158641027,"Kẻ Nhắc Tuồng (Tái Bản)",116000,155000,39000,25
TIKI,nha-sach-tiki,75953557,"Tâm Lý Học Về Tiền",132300,189000,56700,30
TIKI,nha-sach-tiki,184466858,"Tâm Lý Học - Những Thí Nghiệm Não Bộ Chưa Được Tiết Lộ",93100,125000,31900,26
TIKI,nha-sach-tiki,6915413,"Nghệ Thuật Tối Giản: Có Ít Đi, Sống Nhiều Hơn (Tái bản)",69200,108000,38800,36
TIKI,nha-sach-tiki,143226162,"Tỷ Phú Bán Giày (Tái Bản)",104200,159000,54800,34
TIKI,nha-sach-tiki,104074993,"Nhảy Nhảy Nhảy (Tái Bản)",116000,169000,53000,31
TIKI,nha-sach-tiki,57386279,"Quạt xếp, quạt vải cầm tay họa tiết hoa anh đào 21*38 cm+ Tặng kèm hình dán-Quạt xếp cầm tay nhỏ gọn phong cách",59000,73750,14750,20
TIKI,nha-sach-tiki,192788797,"Fly Me To The Moon - Tóm Lại Là Em Dễ Thương, Được Chưa - Tập 2",45000,55000,10000,18
TIKI,nha-sach-tiki,132355750,"Võ Nguyên Giáp - Hào Khí Trăm Năm (Tái Bản)",116000,200000,84000,42
TIKI,nha-sach-tiki,130233550,"Vượt Qua Âu Lo, Chữa Lành Tâm Trí - Kiểm Soát Trầm Cảm Trong 7 Tuần Bằng Liệu Pháp Nhận Thức Hành Vi",136000,189000,53000,28
TIKI,nha-sach-tiki,80141519,"Hackers IELTS Basic- Writing",115420,199000,83580,42
TIKI,nha-sach-tiki,169262882,"Combo 2 cuốn Giáo Trình Hán Ngữ (Sách học Tiếng Trung dành cho người Việt) Giáo Trình Hán Ngữ Tập 1 + Giáo Trình Hán Ngữ Tập 2 (Phiên bản mới - Học bằng App McBooks)",170800,244000,73200,30
TIKI,nha-sach-tiki,155463014,"Quốc Gia Khởi Nghiệp - Câu Chuyện Về Nền Kinh Tế Thần Kỳ Của Israel (Tái Bản)",121220,209000,87780,42
TIKI,nha-sach-tiki,81437585,"Tiếng Triều Dâng",105000,140000,35000,25
TIKI,nha-sach-tiki,153521902,"Những Người Phụ Nữ Bé Nhỏ",89800,129000,39200,30
TIKI,nha-sach-tiki,13101929,"Series Địch Công Kỳ Án Tập 13 - Địch Gia Bát Án",66000,137000,71000,52
TIKI,nha-sach-tiki,101801426,"Sách IRED Books - ĐÚNG VIỆC - Một góc nhìn về câu chuyện KHAI MINH (Tái Bản) - Giản Tư Trung",125000,125000,0,0
TIKI,nha-sach-tiki,87960389,"Keo Siêu Dính Đa Năng Deli - 7Ml/ 20Ml - 7140/7149",16200,16200,0,0
TIKI,nha-sach-tiki,115897817,"Kỷ Luật Mềm Trong Gia Đình: Giáo Dục Trẻ 3 - 10 Tuổi Dành Cho Gia Đình Việt",118000,165000,47000,28
TIKI,nha-sach-tiki,160081248,"Gấu Pooh Xinh Xắn",69200,90000,20800,23
TIKI,nha-sach-tiki,26272210,"Mọi người đều nói dối - Dữ liệu lớn, Dữ liệu mới và những điều Internet tiết lộ về chính chúng ta",127000,150000,23000,15
TIKI,nha-sach-tiki,184774171,"Đũa - Chuyện Linh Dị",214000,289000,75000,26
TIKI,nha-sach-tiki,181656866,"Lịch Sử Israel - Câu Chuyện Về Sự Hồi Sinh Của Một Dân Tộc (Daniel Gordis)",291000,389000,98000,25
TIKI,nha-sach-tiki,189940724,"Triệu Phú Khu Ổ Chuột",94000,126000,32000,25
TIKI,nha-sach-tiki,141483251,"Sách: Thai Giáo Theo Chuyên Gia - 280 Ngày Mỗi Ngày Đọc 1 Trang (Tái Bản)",88000,110000,22000,20
TIKI,nha-sach-tiki,69337681,"Nhà Tư Tưởng Lớn - Nietzsche Trong 60 Phút",63000,96000,33000,34
TIKI,nha-sach-tiki,5154511,"Bà Nội Găngxtơ (Tái Bản)",57500,75000,17500,23
TIKI,nha-sach-tiki,114689806,"Full combo (Bộ 10 cuốn) Ehon song ngữ Kỹ năng - Màu sắc - Hình khối - Nhận biết",182000,350000,168000,48
TIKI,nha-sach-tiki,83432000,"Sách Người trong muôn nghề: Ngành Kinh tế có gì?",173000,189000,16000,8
TIKI,nha-sach-tiki,194110075,"Bẩm thầy Tường có thầy Vũ đến tìm - tập 2",115000,115000,0,0
TIKI,nha-sach-tiki,271536000,"Chú Thuật Hồi Chiến Tập 3: Cá Con Và Trừng Phạt Ngược",29800,30000,200,1
TIKI,nha-sach-tiki,185410021,"Set Decal Bọc Sách Vở Dán Bìa Trong Suốt Chống Nước Nhiều Kích Cỡ Deli - Bọc SGK Vở Sổ Tay Ghi Chép Truyện Tiều Thuyết - Lưu Trữ Bền Đẹp - 70603 / 70602 / 70601",27000,48600,21600,44
TIKI,nha-sach-tiki,124767704,"Bạn Đắt Giá Bao Nhiêu? (Tái Bản)",86400,119000,32600,27
TIKI,nha-sach-tiki,36727163,"Người Nam Châm (Tái Bản 2019)",55000,79000,24000,30
TIKI,nha-sach-tiki,176550199,"Hội Chứng Trầm Cảm Cười: Đằng Sau Nụ Cười Hạnh Phúc Là Những Nỗi Đau",81100,109000,27900,26
TIKI,nha-sach-tiki,67040880,"Thân Mật Cội Nguồn Của Hạnh Phúc (Tái Bản 2020)",67600,98000,30400,31
TIKI,nha-sach-tiki,127654481,"Tiệm Café Bên Rìa Thế Giới",70000,108000,38000,35
TIKI,nha-sach-tiki,157432540,"Thư Tình Gửi Một Người (Trịnh Công Sơn) (Tái Bản)",112000,195000,83000,43
TIKI,nha-sach-tiki,149942445,"Sức Mạnh Thương Mại Điện Tử - 12 Tháng Kiếm 1 Triệu Đô Bằng Kinh Doanh Online - Bộ Sách Trên Lưng Khổng Tượng",142000,199000,57000,29
TIKI,nha-sach-tiki,71880692,"600 Câu Hỏi Dùng Cho Sát Hạch, Cấp Giấy Phép Lái Xe Cơ Giới Đường Bộ",45000,45000,0,0
TIKI,nha-sach-tiki,73810559,"Combo 3 Cuốn: Hiệu Ứng Chim Mồi Tập 1 + 2 + 3",182000,265000,83000,31
TIKI,nha-sach-tiki,47323853,"Chinh Phục Luyện Thi Vào Lớp 10 Môn Tiếng Anh Theo Chủ Đề",105000,159000,54000,34
TIKI,nha-sach-tiki,108261352,"Tự Học Ngữ pháp Tiếng Anh Bằng Mindmap Tập 2",108000,145000,37000,26
TIKI,nha-sach-tiki,138269668,"Từ Điển Tiếng Việt (Hoàng Phê)(Tái Bản)",442000,495000,53000,11
TIKI,nha-sach-tiki,187009994,"Lôi Thần Và Nhân Viên Văn Phòng (Tập 5)",51200,66000,14800,22
TIKI,nha-sach-tiki,11347711,"All The Rule - Sống Bản Lĩnh Theo Cách Một Quý Cô",62100,96000,33900,35
TIKI,nha-sach-tiki,184226848,"Sợi tóc - Thạch Lam (Bìa mềm)",26700,35000,8300,24
TIKI,nha-sach-tiki,45438055,"BỘ SÁCH HỌC TIẾNG ANH lITTLE STORIES",421000,650000,229000,35
TIKI,nha-sach-tiki,181379111,"Vô Cùng Tàn Nhẫn Vô Cùng Yêu Thương Tập 4",86420,149000,62580,42
TIKI,nha-sach-tiki,48592472,"Combo Truyện Tranh Song Ngữ Việt - Anh Cho Bé (12 Tập)",135000,180000,45000,25
TIKI,nha-sach-tiki,5112975,"Marketing giỏi phải kiếm được tiền - The end of marketing as we know it",299000,299000,0,0
TIKI,nha-sach-tiki,182149648,"Nước Ép Trị Liệu Và Chế Độ Ăn Theo Phương Pháp Cơ Thể Tự Chữa Lành",149300,199000,49700,25
TIKI,nha-sach-tiki,73795265,"Sách Hợp Nhất Với Vũ Trụ (Bìa Mềm) (Tái Bản 2020)",67600,88000,20400,23
TIKI,nha-sach-tiki,107409375,"Tiếng Anh 6 I-Learn Smart World - Workbook (Sách Bài Tập)",68000,68000,0,0
TIKI,nha-sach-tiki,137751490,"[Tặng Bút Lông + Lau Bảng] Bảng từ trắng treo tường viết bút lông Deli Nhiều kích cỡ - Dùng Cho Văn Phòng, Trường Học, Tập Vẽ, Ghi Chú Công Thức Nấu Ăn, Trang Trí Nhà Cửa",405000,405000,0,0
TIKI,nha-sach-tiki,46009013,"Fullmetal Alchemist - Cang Giả Kim Thuật Sư - Fullmetal Edition Tập 2",61100,69000,7900,11
TIKI,nha-sach-tiki,14100920,"Bánh Mì Kẹp Chuột (Tái Bản 2019)",58800,79000,20200,26
TIKI,nha-sach-tiki,196395463,"Dưới cánh đại bàng (bìa mềm)",117300,138000,20700,15
TIKI,nha-sach-tiki,13065341,"Series Địch Công Kỳ Án Tập 16 - Quảng Châu Án",101000,158000,57000,36
TIKI,nha-sach-tiki,146988856,"Lựa Chọn Đúng Quan Trọng Hơn Nỗ Lực - 6 Bước Để Ra Quyết Định Hoàn Hảo",109000,170000,61000,36
TIKI,nha-sach-tiki,99992416,"Fullmetal Alchemist - Cang giả kim thuật sư - Fullmetal Edition - Tập 10",65600,69000,3400,5
TIKI,nha-sach-tiki,188694727,"Tập viết tiếng Thái",34000,50000,16000,32
TIKI,nha-sach-tiki,188536931,"Gửi Người Bí Ẩn Thân Thương (Truyện Tranh)",91100,109000,17900,16
TIKI,nha-sach-tiki,11508322,"Nội Tình Của Ngoại Tình",141000,220000,79000,36
TIKI,nha-sach-tiki,147920905,"Đường Mây Qua Xứ Tuyết (Tái Bản)",81600,118000,36400,31
TIKI,nha-sach-tiki,120357410,"Thực Hành Khởi Nghiệp - Từng Bước Nhỏ Làm Chủ Doanh Nghiệp Lớn",125000,169000,44000,26
TIKI,nha-sach-tiki,190705661,"Lại Thằng Nhóc Emil",84000,109000,25000,23
TIKI,nha-sach-tiki,192339427,"Bà Bác Khủng Khiếp",115000,150000,35000,23
TIKI,nha-sach-tiki,1029894,"Tuần Của Bé - Bé Tinh Tế (Dành Cho Trẻ 3 - 6 Tuổi)",21850,23000,1150,5
TIKI,nha-sach-tiki,185500894,"i-Learn Smart Start 5 Student's Book Special Edition",113000,113000,0,0
TIKI,nha-sach-tiki,181699658,"Chiến Lược Giao Dịch Của Jesse Livermore",110700,159000,48300,30
TIKI,nha-sach-tiki,193450572,"Quái Mèo Độc Tấu",99200,119000,19800,17
TIKI,nha-sach-tiki,193895767,"THE DAILY STOIC – 366 CHIÊM NGHIỆM VỀ TRÍ TUỆ VÀ LÒNG CAN TRƯỜNG CÙNG NGHỆ THUẬT SỐNG",166400,239000,72600,30
TIKI,nha-sach-tiki,67712912,"Phát Triển Trí Tuệ Cảm Xúc- Chúng Mình Tôn Trọng Cơ Thể Và Cảm Xúc Của Nhau",37100,50000,12900,26
TIKI,nha-sach-tiki,274145052,"Trạm Đọc| Hackers IELTS Basic: Reading + Writing + Speaking + Listening ( Dành cho người mới bắt đầu )",624000,836000,212000,25
TIKI,nha-sach-tiki,71094783,"Linh Hồn Của Tiền - The Soul Of Money",249000,249000,0,0
TIKI,nha-sach-tiki,46723656,"Sách Tử Tế Đáng Giá Bao Nhiêu",67600,98000,30400,31
TIKI,nha-sach-tiki,3526069,"Quản Trị Nguồn Nhân Lực",116000,116000,0,0
TIKI,nha-sach-tiki,25203389,"Advanced Grammar in Use Book with Answers  Edition: A Self-Study Reference and Practice Book for Advanced Learners of English",163800,178000,14200,8
TIKI,nha-sach-tiki,45321630,"Bạn Chỉ Tưởng Là Mình Đang Rất Cố Gắng",92500,123000,30500,25
TIKI,nha-sach-tiki,195959545,"Chú Thuật Hồi Chiến - Tập 6 - Bản Thường - Tặng Kèm Obi Và Thẻ Bo Góc Nhựa",29100,30000,900,3
TIKI,nha-sach-tiki,34751481,"Ngụ Ngôn Song Ngữ Anh - Việt: Kiến Và Chim Bồ Câu (Tái Bản 2019)",16800,28000,11200,40
TIKI,nha-sach-tiki,102832719,"Thay Tư Duy Xoay Cục Diện - Ngưng Sống Cầm Chừng",96300,129000,32700,25
TIKI,nha-sach-tiki,89001327,"Giao Dịch Theo Xu Hướng Để Kiếm Sống",366000,366000,0,0
TIKI,nha-sach-tiki,171212880,"Ikigai – Đi Tìm Lý Do Thức Dậy Mỗi Sáng",61300,89000,27700,31
TIKI,nha-sach-tiki,188960732,"COMBO TỰ HỌC TAROT: Sách Nhật ký Tarot + Bộ Bài & Sách Hướng Dẫn (Tái bản 2022)",296000,398000,102000,26
TIKI,nha-sach-tiki,100202726,"Phương Pháp Wyckoff Hiện Đại - Kỹ thuật Nhận diện Xu hướng Thị trường Tiềm năng",356000,356000,0,0
TIKI,nha-sach-tiki,5743603,"Vật Lý Thiên Văn Cho Người Vội Vã",58200,80000,21800,27
TIKI,nha-sach-tiki,89204253,"4000 Từ Vựng Và Mẫu Câu Tiếng Anh Thiết Yếu Cho Trẻ Em",177000,250000,73000,29
TIKI,nha-sach-tiki,115972858,"Sổ tay ghi chép lò xo màu pastel Deli - Giấy kẻ ngang 80 trang khổ A5 / B5 - Phù hợp làm sổ kế hoạch, sổ nhật kí, tập vở ghi chép - 24202 / 24203",33000,70200,37200,53
TIKI,nha-sach-tiki,568762,"Tam Quốc Diễn Nghĩa (Trọn Bộ 04 Tập)",182000,350000,168000,48
TIKI,nha-sach-tiki,155463025,"Nghệ Thuật Bán Hàng Bậc Cao - Bí Quyết Chốt Deal Mọi Thời Đại (Khổ Lớn)(Tái Bản)",127000,198000,71000,36
TIKI,nha-sach-tiki,344788,"Bất Cứ Điều Gì Em Muốn",41400,69000,27600,40
TIKI,nha-sach-tiki,114228620,"Combo Tiếng Hàn Tổng Hợp Sơ Cấp 1 Dành Cho Người Việt Nam Bản In Màu - Học Kèm App",249900,357000,107100,30
TIKI,nha-sach-tiki,40933973,"Dịch Kinh Tường Giải (Di Cảo): Quyển Thượng (Tái Bản)",222000,340000,118000,35
TIKI,nha-sach-tiki,185658131,"Dragon Quest - Dấu Ấn Roto (Dragon Quest Saga Emblem Of Roto) Perfect Edition Tập 7 [Tặng Kèm Bookmark PVC] ",67100,75000,7900,11
TIKI,nha-sach-tiki,95089986," Bút chì màu gốc dầu cao cấp Deli - 6565 / 6566 / 6567",250200,250200,0,0
TIKI,nha-sach-tiki,193099629,"Chuyên Gia Kinh Tế Bước Vào Nhà Thổ Và Những Nơi Không Ngờ Khác Để Hiểu Về Rủi Ro",135000,175000,40000,23
TIKI,nha-sach-tiki,58627102,"Sổ Tay Nhà Thôi Miên",98500,145000,46500,32
TIKI,nha-sach-tiki,55589742,"Sách Bài Học Diệu Kỳ Từ Chiếc Xe Rác (Khổ Lớn) (Tái Bản)",71100,108000,36900,34
TIKI,nha-sach-tiki,176824204,"Tinh Hoa Kinh Tế Học (Tái Bản)",431000,555000,124000,22
TIKI,nha-sach-tiki,72202103,"Con Chim Xanh Biếc Bay Về (Nguyễn Nhật Ánh) (Bìa Mềm)",99000,150000,51000,34
TIKI,nha-sach-tiki,168559524,"Gia Đình Tỉnh Thức",148000,209000,61000,29
TIKI,nha-sach-tiki,68456842,"Bài Tập Tiếng Anh 8 - Không Đáp Án",27100,40000,12900,32
TIKI,nha-sach-tiki,195190269,"Combo Anime Comics: One Piece Film Strong World (2 Cuốn)",153000,154000,1000,1
TIKI,nha-sach-tiki,138934620,"Red Nile - Tiểu Sử Của Dòng Sông Vĩ Đại Nhất Thế Giới",243400,399000,155600,39
TIKI,nha-sach-tiki,171055469,"TikTok Tất Tần Tật",113000,158000,45000,28
TIKI,nha-sach-tiki,58732189,"Liệu Pháp Tâm Lý: Ứng Dụng Màu Sắc Thay Đổi Cuộc Sống",113000,159000,46000,29
TIKI,nha-sach-tiki,187827433,"Sau Tang Lễ",82900,145000,62100,43
TIKI,nha-sach-tiki,190708149,"Chitose Trong Chai Ramune – Tập 1 - Bản Phổ Thông - [Tặng Bookmark Bế Hình Có Chân Đế]",105000,105000,0,0
TIKI,nha-sach-tiki,66698344,"Sách Bài Học Diệu Kỳ Từ Chiếc Xe Rác (Khổ Nhỏ) (Tái Bản 2020)",60600,88000,27400,31
TIKI,nha-sach-tiki,38265901,"Điều Quan Trọng Nhất – The Most Important Thing",299000,299000,0,0
TIKI,nha-sach-tiki,1534613,"Giáo Trình Chuẩn HSK 5 Bài Học (Tập 1)",209000,278000,69000,25
TIKI,nha-sach-tiki,22725674,"Kinh Nghiệm Từ Nước Nhật - Giúp Con Tự Lập Từ 0-6 Tuổi",45100,62000,16900,27
TIKI,nha-sach-tiki,192125793,"Harry Potter và tên tù nhân ngục Azkaban (Tái Bản 2022)",132000,205000,73000,36
TIKI,nha-sach-tiki,8886001,"Giết Con Chim Nhại (Tái Bản)",92600,120000,27400,23
TIKI,nha-sach-tiki,51845986,"Chinh Phục Luyện Thi Vào 10 Môn Ngữ Văn Theo Chủ Đề",105000,159000,54000,34
TIKI,nha-sach-tiki,7369223,"Cho Tôi Xin Một Vé Đi Tuổi Thơ",61000,90000,29000,32
TIKI,nha-sach-tiki,138504809,"EQ - Đừng Để Cảm Xúc Hạ Gục Bản Thân",114000,159000,45000,28
TIKI,nha-sach-tiki,143513113,"Con Yêu Bố Chừng Nào",59000,79000,20000,25
TIKI,nha-sach-tiki,67060012,"Phát Triển Trí Tuệ Cảm Xúc- Cảm Xúc Của Con Màu Gì?",37100,50000,12900,26
TIKI,nha-sach-tiki,176824199,"Thần Số Học - Làm Chủ Cuộc Đời",98500,138000,39500,29
TIKI,nha-sach-tiki,159259322,"Nhớ Hà Nội, Thương Sài Gòn",102000,129000,27000,21
TIKI,nha-sach-tiki,50668886,"Thiện, Ác Và Smart Phone (Tái Bản)",76000,105000,29000,28
TIKI,nha-sach-tiki,59478514,"Combo 2 Cuốn: Osho Đàn Ông + Osho Phụ Nữ",164000,228000,64000,28
TIKI,nha-sach-tiki,71957923,"Sách Ehon - Combo 4 cuốn Bạn là ai vậy - Dành cho trẻ từ 0 - 3 tuổi",100000,156000,56000,36
TIKI,nha-sach-tiki,58547334,"Bài Tập Tiếng Anh 9 - Không Đáp Án (Tái Bản 2020)",40000,52000,12000,23
TIKI,nha-sach-tiki,165030729,"Những Kẻ Âu Lo",97600,180000,82400,46
TIKI,nha-sach-tiki,191636255,"Chòm Sao Linh Thú Tập 7 [Tặng Kèm Bookmark]",37000,40000,3000,8
TIKI,nha-sach-tiki,102629342,"999 Lá Thư Gửi Cho Chính Mình (**) - Tập 2 - Mong Bạn Trở Thành Phiên Bản Hạnh Phúc Nhất (Tái bản)",92800,129000,36200,28
TIKI,nha-sach-tiki,110112108,"Phương Pháp Đầu Tư Warren Buffett",110000,169000,59000,35
TIKI,nha-sach-tiki,11368983,"Combo Giáo Trình Chuẩn HSK 2 - Bài Học (Kèm 1 MP3) và Giáo Trình HSK 2 - Sách Bài Tập (Kèm MP3) ( Tặng Kèm Viết )",308800,386000,77200,20
TIKI,nha-sach-tiki,143676192,"Màu Acrylic tuýp mini chuyên nghiệp Deli - 5ml/tuýp - Vẽ vải / Vẽ quần áo / Vẽ giày - 12/18/24 màu",75600,75600,0,0
TIKI,nha-sach-tiki,74856421,"Hạnh Phúc Trong Công Việc",109220,159000,49780,31
TIKI,nha-sach-tiki,172206434,"Huyền Thuật Và Các Đạo Sĩ Tây Tạng (Tái Bản)",74600,108000,33400,31
TIKI,nha-sach-tiki,193895769,"Cao Thủ "Đổi Đen Thay Trắng" - Tập 6 (Tiểu thuyết)",121500,159000,37500,24
TIKI,nha-sach-tiki,197656790,"Kaguya-Sama: Cuộc Chiến Tỏ Tình - Tập 1 - Tặng Kèm Lót Ly",38800,40000,1200,3
TIKI,nha-sach-tiki,194959693,"Hàn Quốc Quốc Gia Gây Sững Sờ",195000,225000,30000,13
TIKI,nha-sach-tiki,46849710,"Robinson Crusoe ",125000,190000,65000,34
TIKI,nha-sach-tiki,181379287,"Tốc Độ Của Niềm Tin (The Speed Of Trust)(Tái Bản 2022)",139000,175000,36000,21
TIKI,nha-sach-tiki,2583023,"Bé Nhanh Nhẹn",11500,23000,11500,50
TIKI,nha-sach-tiki,197751561,"MONSTER #8 - Tập 5",52200,58000,5800,10
TIKI,nha-sach-tiki,181699688,"Husky Và Sư Tôn Mèo Trắng Của Hắn - Tập 3",126000,169000,43000,25
TIKI,nha-sach-tiki,57211757,"Utopia - Địa đàng trần gian (Tái Bản 2020)",43300,60000,16700,28
TIKI,nha-sach-tiki,123236564,"Combo 6 cuốn: Miếng dán Thông minh cho bé (Phát triển EQ - IQ) - My First Sticker Book",131040,252000,120960,48
TIKI,nha-sach-tiki,191655862,"[Combo Manga] Diệt Slime Suốt 300 Năm, Tôi Levelmax Lúc Nào Chẳng Hay (Tập 8 + 9)",148000,184000,36000,20
TIKI,nha-sach-tiki,145977548,"Kiếp Người - Vĩnh Cửu Và Vô Thường ",56100,79000,22900,29
TIKI,nha-sach-tiki,2903309,"Khéo Ăn Nói Sẽ Có Được Thiên Hạ ( Tái Bản )",104000,130000,26000,20
TIKI,nha-sach-tiki,191919683,"Tro tàn của Angela",170000,220000,50000,23
TIKI,nha-sach-tiki,15256884,"Đầu Tư Tài Chính (Investments)",610000,659000,49000,7
TIKI,nha-sach-tiki,48362502,"Sang Chấn Tâm Lý - Hiểu Để Chữa Lành",225000,350000,125000,36
TIKI,nha-sach-tiki,92996206,"Kinh Yoga Của Patanjali",60200,85000,24800,29
TIKI,nha-sach-tiki,464132,"Truyện Kiều",24000,35000,11000,31
TIKI,nha-sach-tiki,71898415,"Cơ Thể Ta Đã Hai Triệu Năm - Giải Mã Các Căn Bệnh Thời Hiện Đại",54800,79000,24200,31
TIKI,nha-sach-tiki,75601401,"Nghệ Thuật Bán Hàng Bằng Câu Chuyện",135360,188000,52640,28
TIKI,nha-sach-tiki,48629547,"Tiền Không Mua Được Gì (What money can't buy?) - Michael Sandel Tác giả Phải Trái Đúng Sai",78000,125000,47000,38
TIKI,nha-sach-tiki,186229224,"Bộ Sách Khởi Nghiệp Kinh Doanh Online - Marketing và Bán Hàng Hiệu Quả Với Thương Mại Điện Tử Tại Việt Nam",277000,378000,101000,27
TIKI,nha-sach-tiki,149534865,"Bảy Thanh Hung Giản 2 - Hổ Phách Đỏ Son - Gió Cuốn Cát Bụi",170000,230000,60000,26
TIKI,nha-sach-tiki,49002497,"Tâm Bệnh Học",82900,145000,62100,43
TIKI,nha-sach-tiki,151597556,"American Jetstream Pre-Intermediate A Student's book & Workbook ( không kèm CD)",207000,207000,0,0
TIKI,nha-sach-tiki,188128048,"Ikigami - Tập 04",32100,45000,12900,29
TIKI,nha-sach-tiki,101325467,"Bộ Truyện Tranh Gieo Hạt Cùng Vĩ Nhân (Tập 1-10)",270000,270000,0,0
TIKI,nha-sach-tiki,198016658,"Birdmen - Tập 8",29000,30000,1000,3
TIKI,nha-sach-tiki,152743081,"Bàn Tay Ánh Sáng",193000,269000,76000,28
TIKI,nha-sach-tiki,181122317,"Chân Trần Chí Thép (Tái Bản 2022)",114000,168000,54000,32
TIKI,nha-sach-tiki,194959695,"Thế Giới Mênh Mông Buồn Vui Cất Vào Lòng",65200,90000,24800,28
TIKI,nha-sach-tiki,55119185,"Sách Nghĩ Giàu và Làm Giàu (Bìa Cứng) (Tái Bản 2020)",117000,168000,51000,30
TIKI,nha-sach-tiki,152743069,"FPT Bí Lục - Khám Phá Văn Hoá Doanh Nghiệp Tại FPT",138000,199000,61000,31
TIKI,nha-sach-tiki,185232575,"Tiếng Anh 3 Extra and Friends Activity book (Sách bài tập)",65000,65000,0,0
TIKI,nha-sach-tiki,44976191,"Economix - Các Nền Kinh Tế Vận Hành (Và Không Vận Hành) Thế Nào Và Tại Sao?",114000,152000,38000,25
TIKI,nha-sach-tiki,56757447,"Tiền Đẻ Ra Tiền: Đầu Tư Tài Chính Thông Minh",95100,139000,43900,32
TIKI,nha-sach-tiki,113656189,"Giáo Trình Lịch Sử Đảng Cộng Sản Việt Nam (Dành Cho Bậc Đại Học Hệ Không Chuyên Lý Luận Chính Trị) - Bộ mới năm 2021",84000,84000,0,0
TIKI,nha-sach-tiki,195801705,"Một Nửa Chiếc Va Li",115000,130000,15000,12
TIKI,nha-sach-tiki,100947280,"Những Phương Thức Phục Hồi Sức Khỏe Theo Tự Nhiên (Tái Bản)",70300,99000,28700,29
TIKI,nha-sach-tiki,197634256,"Black Jack - Tập 14 (Bìa Cứng)",134000,135000,1000,1
TIKI,nha-sach-tiki,14655498,"Bút bi TriTouch ngòi 0.7mm (hộp 12 cái)",54000,54000,0,0
TIKI,nha-sach-tiki,21146016,"Tinh Mắt Bắt Hình – Nông Trại",41500,60000,18500,31
TIKI,nha-sach-tiki,182736915,"Combo 3 Cuốn Sách: Cuộc Hành Hương Nội Tại - Chính Trực - Giác Ngộ",325100,467000,141900,30
TIKI,nha-sach-tiki,167149888,"Khám Phá Đứa Trẻ Bên Trong Bạn",98500,139000,40500,29
TIKI,nha-sach-tiki,160585830,"Tôi Thích Tin Tức Tố Của Cậu - Tập 2 (Tặng Kèm Bookmark)",146000,169000,23000,14
TIKI,nha-sach-tiki,185500892,"i-Learn Smart Start 5 Workbook Special Edition",81000,81000,0,0
TIKI,nha-sach-tiki,184419723,"Sapiens Lược Sử Loài Người (Tái Bản 2022)",185400,299000,113600,38
TIKI,nha-sach-tiki,7958959,"5 Điểm Chết Trong Teamwork",78800,128000,49200,38
TIKI,nha-sach-tiki,181802012,"Set 50/100 tem dán cảm ơn khách và lưu ý quay video mở hàng (8x10cm) (1.025) - tem dán đơn hàng, kiện hàng dành cho shop",40000,40000,0,0
TIKI,nha-sach-tiki,102893964,"Combo 5-10-20 Bút Bi Thiên Long TL-027 - Mực Xanh/Đen/Đỏ/Tím",23000,23000,0,0
TIKI,nha-sach-tiki,14136016,"Phía Nam Biên Giới, Phía Tây Mặt Trời (Tái Bản 2018)",62800,85000,22200,26
TIKI,nha-sach-tiki,186265453,"Komi - Nữ Thần Sợ Giao Tiếp Tập 10 [Tặng Kèm PVC Card]",25000,25000,0,0
TIKI,nha-sach-tiki,73685374,"Combo Trinh Thám Đen: Cô Dâu Đen + Ám Ảnh Đen + Điểm Hẹn Đen + Kết Hôn Với Người Chết",199500,399000,199500,50
TIKI,nha-sach-tiki,189765038,"Python lập trình thuật toán",95000,95000,0,0
TIKI,nha-sach-tiki,32219488,"Doanh Nghiệp Của Thế Kỷ 21 (Tái Bản 2019)",62200,100000,37800,38
TIKI,nha-sach-tiki,186578226,"Hy vọng mong manh",118000,158000,40000,25
TIKI,nha-sach-tiki,160370181,"Khói Trời Lộng Lẫy (Tập Truyện Ngắn Nguyễn Ngọc Tư)(Tái Bản)",60800,90000,29200,32
TIKI,nha-sach-tiki,4978895,"Biết Chính Mình",60200,85000,24800,29
TIKI,nha-sach-tiki,58067801,"Luyện Kỹ Năng Phát Âm Tiếng Anh (Trình Độ Sơ Cấp) - English Pronunciation In Use (Elementary)",80000,80000,0,0
TIKI,nha-sach-tiki,52788074,"Khu Vườn Mùa Hạ (Tái Bản 2020)",50000,68000,18000,26
TIKI,nha-sach-tiki,1362559,"Cổ Phiếu Thường, Lợi Nhuận Phi Thường (Tái Bản)",127400,199000,71600,36
TIKI,nha-sach-tiki,192733741,"Mùi hương - Tái Bản",85300,115000,29700,26
TIKI,nha-sach-tiki,48329799,"Tự Học Toàn Diện Hóa Học - Từ Cơ Bản Đến Nâng Cao Lớp 9",65000,99000,34000,34
TIKI,nha-sach-tiki,197652268,"Như Cơn Gió Thoảng - Nghĩ Về Những Qui Luật Cuộc Sống",103500,115000,11500,10
TIKI,nha-sach-tiki,90679276,"Mở Cửa Tương Lai",129000,200000,71000,36
TIKI,nha-sach-tiki,192909289,"Quán Rượu Dị Giới "Nobu" - Tập 09",31500,40000,8500,21
TIKI,nha-sach-tiki,32720778,"Sách tiếng Anh - Principles: Life and Work",483600,520000,36400,7
TIKI,nha-sach-tiki,27971953,"Lược Sử Tôn Giáo",95800,129000,33200,26
TIKI,nha-sach-tiki,13312178,"Combo Tôi Tự Học và Óc Sáng Suốt ( Tặng Kèm Sổ Tay )",181350,181350,0,0
TIKI,nha-sach-tiki,10379317,"Nghệ Thuật Giao Tiếp Để Thành Công (Tái Bản 2019)",98020,169000,70980,42
TIKI,nha-sach-tiki,176550198,"Nam Hải Dị Nhân Liệt Truyện",353000,500000,147000,29
TIKI,nha-sach-tiki,187827438,"Vọng Lâu Tử Thần",72400,120000,47600,40
TIKI,nha-sach-tiki,176831144,"Combo 23 Tập Thanh Gươm Diệt Quỷ (Tập 1-23)",499000,575000,76000,13
TIKI,nha-sach-tiki,102832718,"Thay Tư Duy Xoay Cục Diện - Vĩnh Biệt Lối Mòn",84100,119000,34900,29
TIKI,nha-sach-tiki,141472522,"Sách: Cẩm Nang Tuổi Dậy Thì Dành Cho Bạn Gái (Tái Bản)",80000,100000,20000,20
TIKI,nha-sach-tiki,83396665,"Hướng dẫn khởi động & 200 tư thế Yoga từ cơ bản đến nâng cao",128000,185000,57000,31
TIKI,nha-sach-tiki,177569697,"Perfect Ielts Vocabulary (Tái Bản)",162200,259000,96800,37
TIKI,nha-sach-tiki,146271773,"Nghiệp Tình Yêu - Karma Of Love (Tái Bản 2021)",175200,199000,23800,12
TIKI,nha-sach-tiki,105614665,"Bút bi bấm ngòi 0.7mm mực xanh Deli - Màu sắc theo lựa chọn -  1 chiếc - EQ199-BL",7200,7200,0,0
TIKI,nha-sach-tiki,68049234,"Đừng Để Mất Bò - 7 Bước Quản Lý Cửa Hàng Hiệu Quả Và Chống Thất Thoát",149000,169000,20000,12
TIKI,nha-sach-tiki,111582624,"Trải Nghiệm Apple - Xây Dựng Lòng Trung Thành Không Chỉ Từ Sản Phẩm",197000,239000,42000,18
TIKI,nha-sach-tiki,1007137,"Tự Học 2000 Từ Vựng Tiếng Anh Theo Chủ Đề",45500,65000,19500,30
TIKI,nha-sach-tiki,185409035,"Bút Bi Nước Mực Gel Bấm Ngòi 0.5mm Deli - Có Ngòi Thay Thế Viết Trơn Đều Phù Hợp Ghi Chép Văn Phòng Học Sinh Sổ Tay - A575",2000,5400,3400,63
TIKI,nha-sach-tiki,113540588,"Thiên Táng",73900,96000,22100,23
TIKI,nha-sach-tiki,122869197,"túi giấy đựng quà các cỡ loại đẹp có nắp",9000,14400,5400,38
TIKI,nha-sach-tiki,117254518,"Thiên Nga Hoang Dã",269000,350000,81000,23
TIKI,nha-sach-tiki,88592202,"Tiny Habits : Thói quen tí hon - Tiềm năng khổng lồ",299000,299000,0,0
TIKI,nha-sach-tiki,195521211,"Diệt Slime Suốt 300 Năm, Tôi Levelmax Lúc Nào Chẳng Hay (Tập 11)",119000,159000,40000,25
TIKI,nha-sach-tiki,170490710,"Bàn Về Cách Sống – Đối Thoại Giữa Triết Gia, Bác Sĩ Và Nhà Sư",99100,139000,39900,29
TIKI,nha-sach-tiki,153518828,"Hong Tay Khói Lạnh (Tản Văn Nguyễn Ngọc Tư)",62000,90000,28000,31
TIKI,nha-sach-tiki,174605338,"Bách Khoa Thư Về Nghệ Thuật",301400,499000,197600,40
TIKI,nha-sach-tiki,109298270,"Sách Cẩm Nang Con Gái (Tái Bản)",47500,68000,20500,30
TIKI,nha-sach-tiki,171549954,"Tâm Hồn Cao Thượng",150000,220000,70000,32
TIKI,nha-sach-tiki,130230750,"Combo 10 Tập - Truyện tranh song ngữ Việt-Anh dành cho trẻ em - Cùng học cư xử tốt",278000,280000,2000,1
TIKI,nha-sach-tiki,145092110,"Cách Biến Đổi Câu Trong Tiếng Anh",57900,80000,22100,28
TIKI,nha-sach-tiki,194197858,"Achievers grade 7 Workbook",112000,112000,0,0
TIKI,nha-sach-tiki,5852521,"Combo Cà Phê Cùng Tony và Trên Đường Băng",186950,186950,0,0
TIKI,nha-sach-tiki,165700192,"Lịch Sử Vú",173000,248000,75000,30
TIKI,nha-sach-tiki,137241901,"Thần Số Học: Sức Mạnh Của Những Con Số",98000,139000,41000,29
TIKI,nha-sach-tiki,72542474,"Biên Niên Cô Đơn (Bản Thông Thường)",72000,99000,27000,27
TIKI,nha-sach-tiki,190705658,"Bật Khóc Ở H Mart",103000,140000,37000,26
TIKI,nha-sach-tiki,77900450,"Đạo Phật Vỡ Lòng (Tái Bản)",49600,69000,19400,28
TIKI,nha-sach-tiki,127377217,"Sách Người Trong Muôn Nghề: Ngành Sáng tạo và Nghệ thuật có gì?",201000,219000,18000,8
TIKI,nha-sach-tiki,69621516,"Combo sách: Bài thơ - bài hát - câu đố dành cho bé (tái bản 2020)",95000,135000,40000,30
TIKI,nha-sach-tiki,10244763,"Bút quay nghệ thuật - Era PS Mod",99000,99000,0,0
TIKI,nha-sach-tiki,157468180,"Trọn Bộ 4 Quyển Sách Trên Lưng Khổng Tượng - Kinh Doanh Online Trên Sàn Thương Mại Điện Tử - Khởi Nghiệp Với Bán Hàng Qua Mạng và Nhãn Hàng Riêng",481000,796000,315000,40
TIKI,nha-sach-tiki,58067806,"Từ Vựng Tiếng Anh Thực Hành (Trình Độ Trung Cấp) - English Collocation In Use (Intermediate)",47000,80000,33000,41
TIKI,nha-sach-tiki,170345811,"Phân Tích Khách Hàng For Dummies",159000,229000,70000,31
TIKI,nha-sach-tiki,193177952,"Bản đặc biệt Tổng ôn 30 chuyên đề ngữ pháp tiếng anh cô Trang anh 2023",199000,300000,101000,34
TIKI,nha-sach-tiki,75697497,"Lịch Sử Triết Học (Trọn Bộ 2 Tập) (Tập 1: Triết Học Cổ Đại Và Trung Đại + Tập 2: Triết Học Cận Đại Và Hiện Đại)",853000,900000,47000,5
TIKI,nha-sach-tiki,196001728,"Vạn Sắc Hư Vô",99000,150000,51000,34
TIKI,nha-sach-tiki,46259908,"Fibonacci Trading",299000,299000,0,0
TIKI,nha-sach-tiki,12533371,"Đạo Đức Kinh",66400,99000,32600,33
TIKI,nha-sach-tiki,54614791,"Từ Điển Tâm Lý - Tính Cách Và Cảm Xúc Đến Từ Đâu ?",94000,128000,34000,27
TIKI,nha-sach-tiki,189557422,"THINK OUT OF THE BOOK - Nghĩ Ngoài Sách Vở",190000,220000,30000,14
TIKI,nha-sach-tiki,193981040,"Birdmen - Tập 5",29000,30000,1000,3
TIKI,nha-sach-tiki,192048663,"Sáng trăng",57500,75000,17500,23
TIKI,nha-sach-tiki,136539753,"Tự Chữa Lành Thông Qua Hiểu Biết Về Khoa Học Tâm Thức",85200,119000,33800,28
TIKI,nha-sach-tiki,189643106,"Tự Tôn",117700,169000,51300,30
TIKI,nha-sach-tiki,273714632,"Trí Tuệ Do Thái (Tái Bản)",140900,189000,48100,25
TIKI,nha-sach-tiki,13797246,"Combo 6 Cuốn Ehon nhật bản - Giờ Chơi Của Bé ( Tái Bản )",125000,174000,49000,28
TIKI,nha-sach-tiki,190242072,"Qủy Ấn - Bộ 2 tập ( Tập 1 và 2) - tặng kèm 1 bookmark",211000,291000,80000,27
TIKI,nha-sach-tiki,87149160,"Bộ Cọ Vẽ Chuyên Nghiệp Deli - Dùng Cho Màu Nước/Bột/Sơn Acrylic -Set 4/6 Cây- 73885/73866/73867",40000,88200,48200,55
TIKI,nha-sach-tiki,185055209,"Osho - Combo Sống Hài Hòa (Yêu, Cảm Xúc, Hiểu)",375000,524000,149000,28
TIKI,nha-sach-tiki,6482397,"Hàn Quốc Dưới Chế Độ Độc Tài Phát Triển Park Chung Hee (1961 – 1979)(Tái Bản 2020)",76000,98000,22000,22
TIKI,nha-sach-tiki,160585764,"Veil - Thân Nhiệt Của Sắc Cam - Tập 1 (Tặng Kèm Postcard)",92200,109000,16800,15
TIKI,nha-sach-tiki,38436464,"Khác Biệt Để Bứt Phá (Tái Bản 2019)",89000,128000,39000,30
TIKI,nha-sach-tiki,193896561,"Ninja Rantaro - Tập 59",37100,40000,2900,7
TIKI,nha-sach-tiki,184334565,"Bút vẽ kỹ thuật / Bút vẽ nét/ bút lông kim Fine Pen cơ bản – chuyên nghiệp mực đen",22000,30000,8000,27
TIKI,nha-sach-tiki,191926693,"Trái cây đại chiến Zombie - Thế giới khủng long: Tập 9 - Trên đảo khủng long",58000,89000,31000,35
TIKI,nha-sach-tiki,160585832,"Veil – Sắc Trắng Yêu Kiều - Tập 3 (Tặng Kèm Postcard)",90000,109000,19000,17
TIKI,nha-sach-tiki,196394972,"Thương Tiến Tửu - Tập 2",134000,169000,35000,21
TIKI,nha-sach-tiki,196305158,"Vì Cuộc Đời Không Hẹn Lần Sau",106000,139000,33000,24
TIKI,nha-sach-tiki,148008757,"Combo 2 Cuốn "Tim Marshall": "Những Tù Nhân Của Địa Lý" + "Chia Rẽ - Tại Sao Chúng Ta Đang Sống Trong Thời Đại Của Những Bức Tường"",281000,410000,129000,31
TIKI,nha-sach-tiki,273401813,"Tết Ở Làng Địa Ngục",116000,169000,53000,31
TIKI,nha-sach-tiki,71149569,"Cách kiếm lợi nhuận 18.000% từ thị trường chứng khoán - Trade Like An O'Neil Disciple",499000,499000,0,0
TIKI,nha-sach-tiki,187843292,"Hoa trên mộ Algernon",112000,150000,38000,25
TIKI,nha-sach-tiki,176909238,"Hà Nội Còn Một Chút Này",84000,109000,25000,23
TIKI,nha-sach-tiki,189326211,"Văn phòng thám tử quái vật - Tập 08",21100,30000,8900,30
TIKI,nha-sach-tiki,142833447,"Sanctify - Tập 3",89700,109000,19300,18
TIKI,nha-sach-tiki,598974,"Dạy Con Làm Giàu 05 - Để Có Sức Mạnh Về Tài Chính",98200,160000,61800,39
TIKI,nha-sach-tiki,76531748,"Sách DevUP",149000,149000,0,0
TIKI,nha-sach-tiki,146225297,"Flow - Dòng Chảy",175600,228000,52400,23
TIKI,nha-sach-tiki,187827445,"Lược Sử Thời Gian",79000,115000,36000,31
TIKI,nha-sach-tiki,195827102,"(Bìa cứng in màu trên giấy cóuche - tặng kèm postcard) SƠN HẢI KINH – Lương Siêu biên soạn – Sam Trạch minh họa – An Lạc Group dịch – Wingbooks - NXB Kim Đồng",325000,325000,0,0
TIKI,nha-sach-tiki,980770,"Chí Phèo",31700,48000,16300,34
TIKI,nha-sach-tiki,112332742,"English Grammar In Use - 130 Bài Ngữ Pháp Tiếng Anh (Tái Bản)",115000,165000,50000,30
TIKI,nha-sach-tiki,185408437,"Bút Bi Nước Mực Gel Bấm Ngòi 0.5mm Deli - Mực Đen Nhanh Khô, Viết Đều, Trơn Tru, Phù Hợp Văn Phòng Học Sinh - S08-B",6000,11700,5700,49
TIKI,nha-sach-tiki,69219919,"Muôn Kiếp Nhân Sinh (Khổ Nhỏ)",73500,98000,24500,25
TIKI,nha-sach-tiki,53563837,"Combo Sách Nuôi Dạy Trẻ: Phương Pháp Giáo Dục Con Của Người Do Thái + Chờ Đến Mẫu Giáo Thì Đã Muộn +90% Trẻ Thông Minh Nhờ Cách Trò Chuyện Đúng Đắn Của Cha Mẹ + Cách Khen, Cách Mắng, Cách Phạt Con + Poster An Toàn(Tủ Sách Người Mẹ Tốt)",251350,251350,0,0
TIKI,nha-sach-tiki,446881,"Các Thế Giới Song Song (Tái Bản 2018)",95500,128000,32500,25
TIKI,nha-sach-tiki,3152291,"Hướng Dẫn Giao Dịch Theo Sóng Elliott",369000,369000,0,0
TIKI,nha-sach-tiki,193450565,"Nam Đình Cốc Vi– Tập 7 -  Tặng 1 Postcard Nam Đình Cốc Vi",99200,119000,19800,17
TIKI,nha-sach-tiki,76826978,"Sức Mạnh Chữa Lành Của Tinh Dầu",121000,169000,48000,28
TIKI,nha-sach-tiki,111537689,"Án Mạng Trên Sông Nile (Agatha Christie)(Tái Bản)",78700,135000,56300,42
TIKI,nha-sach-tiki,170706996,"Điểm Bùng Phát ( Tái Bản)",115800,179000,63200,35
TIKI,nha-sach-tiki,106365090,"Kinh Dịch Đạo Của Người Quân Tử - Nguyễn Hiến Lê (Tái Bản)",172000,268000,96000,36
TIKI,nha-sach-tiki,4077687,"Bài Tập Trắc Nghiệm Tiếng Anh 9 (Có Đáp Án)",37100,56000,18900,34
TIKI,nha-sach-tiki,94132196,"Bộ Luật Lao Động Hiện Hành (Mới Nhất) Thông Qua Tại Kỳ Họp Thứ 8 Quốc Hội Khóa XIV",51000,119000,68000,57
TIKI,nha-sach-tiki,126742911,"Món Quà Của Linh Hồn - Sức Mạnh Chữa Lành Của Những Thữ Thách Trong Cuộc Sống",204000,289000,85000,29
TIKI,nha-sach-tiki,147220978,"Sự Tiến Hóa Của Tiền Tệ",111000,139000,28000,20
TIKI,nha-sach-tiki,158235745,"Phương Pháp Kaizen
 (The Kaizen Way)(Tái Bản)",75500,95000,19500,21
TIKI,nha-sach-tiki,185854305,"Full bộ 4 cuốn Truyện - Thơ - Đồng dao - Câu đố cho Trẻ mầm non (Giúp bé sáng dạ, thông minh, tập nói và đọc nhanh)",141999,278429,136430,49
TIKI,nha-sach-tiki,167940010,"Thao Túng Tâm Lý",118300,169000,50700,30
TIKI,nha-sach-tiki,173481387,"Eo Thon Nhỏ",163000,239000,76000,32
TIKI,nha-sach-tiki,17719704,"Hạn Chót Lúc Bình Minh",80000,122000,42000,34
TIKI,nha-sach-tiki,161383826,"Đảo Mộng Mơ (Tái Bản)",55800,75000,19200,26
TIKI,nha-sach-tiki,188381614,"Thẻ học Thông minh (Size Lớn - 18 Chủ đề - 288 thẻ) - Song ngữ Anh - Việt - Thế giới Xung quanh",104000,200000,96000,48
TIKI,nha-sach-tiki,49204092,"Tái Tạo Tổ Chức: Phá Vỡ Rào Cản, Thổi Bùng Sinh Khí (Tái Bản)",122000,190000,68000,36
TIKI,nha-sach-tiki,59618902,"Ehon - Hướng Dẫn Sử Dụng Mẹ (Tái Bản 2020)",40300,59000,18700,32
TIKI,nha-sach-tiki,186578993,"Đu Đưa Trên Ngọn Cây Bàng",91100,118000,26900,23
TIKI,nha-sach-tiki,195662905,"Circe",137000,200000,63000,32
TIKI,nha-sach-tiki,175724125,"Chú Thuật Hồi Chiến Tập 2: Chú Thai Đới Thiên [Tặng Kèm Obi Và Thẻ Bo Góc Nhựa]",29000,30000,1000,3
TIKI,nha-sach-tiki,130863107,"Sách Người Tìm Xác tập 1+2 - Truyện trinh thám, linh dị",298000,378000,80000,21
TIKI,nha-sach-tiki,176906739,"UX Writing - Quyền Năng Tối Thượng Của Nội Dung Tương Tác",61000,99000,38000,38
TIKI,nha-sach-tiki,77539095,"Nghệ Thuật Dạy Con Từ Kinh Talmud (20 Câu Chuyện Sâu Sắc Từ Bộ Kinh Cổ Của Người Do Thái)",104000,135000,31000,23
TIKI,nha-sach-tiki,125362334,"Dinh Dưỡng Thai Kỳ (Mẹ Bầu Ăn Gì Giúp Con Phát Triển Toàn Diện Và Thông Minh",122000,189000,67000,35
TIKI,nha-sach-tiki,157540009,"Diệt Slime Suốt 300 Năm, Tôi Levelmax Lúc Nào Chẳng Hay (Tập 7)",42000,48000,6000,13
TIKI,nha-sach-tiki,74277389,"Combo 4 Cuốn: Bộ Tuyển Tập Truyện Hay Dành Cho Thiếu Nhi (Tái Bản)",133000,192000,59000,31
TIKI,nha-sach-tiki,129766803,"Sách Khác Biệt Hay Là Chết (Tái Bản)",88600,128000,39400,31
TIKI,nha-sach-tiki,66398387,"Trời Sinh Vụng Về, Hãy Bù Đắp Bằng Sự Kiên Trì",92400,129000,36600,28
TIKI,nha-sach-tiki,32490132,"Một Đời Như Kẻ Tìm Đường",113000,175000,62000,35
TIKI,nha-sach-tiki,58828012,"Ai Lấy Miếng Pho Mát Của Tôi ? - Phiên Bản Dành Cho Độc Giả Nhí",47100,68000,20900,31
TIKI,nha-sach-tiki,176132374,"Truyện Thiếu Nhi Hạt Giống Tâm Hồn - Điều Ước Gửi Các Vì Sao",46000,56000,10000,18
TIKI,nha-sach-tiki,72027523,"Ehon - Đi Đã Ngoại Ngày Mưa (Tái Bản 2020)",39100,55000,15900,29
TIKI,nha-sach-tiki,147988202,"Combo 2 Cuốn Tớ Học Lập Trình: Tớ Học Lập Trình - Làm Quen Với Python + Tớ Học Lập Trình - Làm Quen Với Lập Trình Scratch",166000,210000,44000,21
TIKI,nha-sach-tiki,273656715,"Trạm Đọc Official |  Tư Duy Nhanh Và Chậm",201000,269000,68000,25
TIKI,nha-sach-tiki,190859600,"Lôi Thần Và Nhân Viên Văn Phòng (Tập 4)",58900,66000,7100,11
TIKI,nha-sach-tiki,112333133,"Quý Cô Thịnh Vượng - Khi Phụ Nữ Tư Duy Đúng Về Tiền",68900,89000,20100,23
TIKI,nha-sach-tiki,192913462,"Lớp 7(bộ Kết nối, Cánh diều, Chân trời) - Sách Siêu trọng tâm môn Toán, Anh, KHTN - Nhà sách Ôn luyện",80000,160000,80000,50
TIKI,nha-sach-tiki,164336681,"Việt Nam Danh Tác - Bỉ Vỏ",69200,90000,20800,23
TIKI,nha-sach-tiki,7804743,"Bí mật - The secret",238000,298000,60000,20
TIKI,nha-sach-tiki,14684952,"Khu Vườn Bí Mật ( Tái Bản 2019 )",71000,96000,25000,26
TIKI,nha-sach-tiki,188767663,"Quỷ Giá - Bản Thường ( Tặng kèm 1 Bookmark 2 mặt)",124000,159000,35000,22
TIKI,nha-sach-tiki,188535073,"Tối Giản Thông Thái",75700,96000,20300,21
TIKI,nha-sach-tiki,190702862,"Siddhartha",79000,120000,41000,34
TIKI,nha-sach-tiki,194205609,"Ai Đó Chạy Cùng Ta",175000,225000,50000,22
TIKI,nha-sach-tiki,151597210,"Practice Test Grade 6",118000,118000,0,0
TIKI,nha-sach-tiki,76737958,"Mind Map English Vocabulary - Từ Vựng Tiếng Anh Qua Sơ Đồ Tư Duy",128700,198000,69300,35
TIKI,nha-sach-tiki,186290792,"Bồ Câu Không Đưa Thư (Tái Bản 2022)",27800,38000,10200,27
TIKI,nha-sach-tiki,867314,"Tuần Của Bé - Bé Sạch Sẽ",11500,23000,11500,50
TIKI,nha-sach-tiki,55071991,"Combo Trọn Bộ 6 Cuốn Giáo Trình Hán Ngữ",512400,732000,219600,30
TIKI,nha-sach-tiki,8288935,"Của Chuột Và Người",68400,76000,7600,10
TIKI,nha-sach-tiki,58220389,"Mô Hình Biểu Đồ - Phương pháp Hiệu quả để Tìm kiếm Lợi nhuận",368000,368000,0,0
TIKI,nha-sach-tiki,197464901,"Bẩm Thầy Tường Có Thầy Vũ Tới Tìm - Tập 2",97800,115000,17200,15
TIKI,nha-sach-tiki,13673964,"Giây Thứ 12 - Tập 1 (Trinh Thám)",42000,87000,45000,52
TIKI,nha-sach-tiki,68437861,"Đừng Chết Bởi Canxi",109000,159000,50000,31
TIKI,nha-sach-tiki,4040663,"25 Chuyên Đề Ngữ Pháp Tiếng Anh Trọng Tâm – (Tập 1)",71000,110000,39000,35
TIKI,nha-sach-tiki,72290296,"Bí Quyết Đầu Tư & Kinh Doanh Chứng Khoán Của Tỷ Phú Warren Buffett Và George Soros (Tái Bản 2020)",110000,158000,48000,30
TIKI,nha-sach-tiki,80920029,"Nguyên lý kế toán TBL9",63000,63000,0,0
TIKI,nha-sach-tiki,347334,"Có Hai Con Mèo Ngồi Bên Cửa Sổ",70500,100000,29500,30
TIKI,nha-sach-tiki,160585762,"Veil – Sắc Đen Trầm Lặng - Tập 2 - (Tặng Kèm Postcard)",92200,109000,16800,15
TIKI,nha-sach-tiki,71990280,"Nói Chuyện Là Bản Năng, Giữ Miệng Là Tu Dưỡng, Im Lặng Là Trí Tuệ",132300,189000,56700,30
TIKI,nha-sach-tiki,34708988,"Bộ 10 Bút Gel Điểm 10 xóa được TP-GELE01",95000,120000,25000,21
TIKI,nha-sach-tiki,8149335,"Cổ Học Tinh Hoa (Bìa Mềm)",94300,115000,20700,18
TIKI,nha-sach-tiki,71553549,"Đọc Nhanh, Hiểu Sâu, Nhớ Lâu Trọn Đời (Tái Bản 2020)",41000,59000,18000,31
TIKI,nha-sach-tiki,74616448,"Lập Kế Hoạch Kinh Doanh Cho Người Mới Bắt Đầu",69020,119000,49980,42
TIKI,nha-sach-tiki,109654814,"Bút bi gel 0.5mm nhiều màu Deli - Có nắp gài - 1 chiếc - Đỏ/ Xanh Dương/ Xanh Lá/ Tím/ Cam - A119",5000,10800,5800,54
TIKI,nha-sach-tiki,111537682,"Bách Khoa Cho Trẻ Em - Bách Khoa Động Vật (Tái Bản)",131000,180000,49000,27
TIKI,nha-sach-tiki,107492789,"Keo dán x2000 siêu dính, keo dán đa năng dán tất cả vật liệu bằng gỗ, thủy tinh, dán nhựa an toàn với da tay (Dạng nước)",21996,21996,0,0
TIKI,nha-sach-tiki,195479322,"Tàn Tro",79400,108000,28600,26
TIKI,nha-sach-tiki,83162438,"Combo Kinh Tế Vi Mô và Câu Hỏi - Bài Tập - Trắc Nghiệm Kinh Tế Vi Mô",171000,180000,9000,5
TIKI,nha-sach-tiki,174444166,"Cẩm Nang Diện Chẩn – Phương Pháp Đơn Giản Áp Dụng Tại Gia",124000,179000,55000,31
TIKI,nha-sach-tiki,13673968,"Giây Thứ 12 - Tập 2 (Trinh Thám)",68000,145000,77000,53
TIKI,nha-sach-tiki,40433264,"Combo Bí Ẩn Mãi Mãi Là Bí Ẩn( Trọn bộ 6 cuốn)( tặng kèm sổ Tay Xương Rồng)",261000,290000,29000,10
TIKI,nha-sach-tiki,77403145,"The Story Of Food - Câu Chuyện Thực Phẩm",483000,486000,3000,1
TIKI,nha-sach-tiki,195969658,"Tiệm Sách Cũ Biblia - Ngoại Truyện 2 - Tobirako Và Thời Gian Bỏ Ngỏ",51000,95000,44000,46
TIKI,nha-sach-tiki,155351487,"IELTS 16 ACADEMIC",195000,195000,0,0
TIKI,nha-sach-tiki,16284286,"Tuổi Thơ Dữ Dội - Tập 1 (Tái Bản)",57400,80000,22600,28
TIKI,nha-sach-tiki,165038798,"OKRs - Tối Ưu Hóa Hiệu Suất Của Bất Kỳ Đội Nhóm Nào",110000,169000,59000,35
TIKI,nha-sach-tiki,150711999,"Michelle Obama - Chất Michelle (Bìa Cứng) (Tái Bản)",371000,520000,149000,29
TIKI,nha-sach-tiki,181928999,"Yuri Espoir (Tập 1) - Bản Thường Tặng Kèm Postcard",57300,79000,21700,27
TIKI,nha-sach-tiki,40750124,"Không Gia Đình (Phiên Bản Mới) - Tặng kèm bộ Postcard",119250,159000,39750,25
TIKI,nha-sach-tiki,17530147,"Series Địch Công Kỳ Án Tập 14 - Hầu Tử Và Lão Hổ ( Tái Bản )",44000,88000,44000,50
TIKI,nha-sach-tiki,73684906,"Marketing Phải Bán Được Hàng",110000,159000,49000,31
TIKI,nha-sach-tiki,170434495,"Hộp Quà Bí Mật Dành Tặng Bé Yêu",19000,19000,0,0
TIKI,nha-sach-tiki,175833959,"Combo 5-10-20 Bút Bi Bấm Deli EQ24 Ngòi 0.7mm - Mực Xanh/Đen/Đỏ - Bút bi dầu phù hợp học sinh văn phòng",8500,17100,8600,50
TIKI,nha-sach-tiki,170708219,"Đừng Bao Giờ Chia Đôi Lợi Ích Trong Mọi Cuộc Đàm Phán",103820,179000,75180,42
TIKI,nha-sach-tiki,46240920,"Kỹ Năng Quản Lý Tài Chính Cá Nhân Trong 30 Ngày",82800,119000,36200,30
TIKI,nha-sach-tiki,187889757,"Gọt bút chì mini Deli - Màu ngẫu nhiên - E0594",2500,5400,2900,54
TIKI,nha-sach-tiki,21031780,"Pháo Đài Số ( Tái Bản )",128500,199000,70500,35
TIKI,nha-sach-tiki,175956866,"Giới Hạn Của Bạn Chỉ Là Xuất Phát Điểm Của Tôi (Tái Bản)",62700,89000,26300,30
TIKI,nha-sach-tiki,8011021,"Tâm Lý Học Thành Công (Tái Bản)",149000,199000,50000,25
TIKI,nha-sach-tiki,58462050,"Sách Người Trong Muôn Nghề: Ngành IT có gì?",155000,169000,14000,8
TIKI,nha-sach-tiki,1029908,"Tuần Của Bé - Bé Công Bằng (Dành Cho Trẻ 3 - 6 Tuổi)",17000,23000,6000,26
TIKI,nha-sach-tiki,100958464,"Hỏi Đáp Từ Trái Tim (Tái Bản)",102000,149000,47000,32
TIKI,nha-sach-tiki,109982979,"Isaac Newton - Nhà Khoa Học Vĩ Đại",28000,40000,12000,30
TIKI,nha-sach-tiki,168181452,"Thiên Sứ Nhà Bên - Tập 2",83600,95000,11400,12
TIKI,nha-cua-doi-song,262731552,"Giường xếp gấp gọn di động SUMIKA 386, khung thép, có bánh xe",1529000,2250000,721000,32
TIKI,nha-cua-doi-song,252135037,"Giường xếp gấp gọn 6 chân đa năng SUMIKA 298, có nệm, 5 cấp độ điều chỉnh",769000,1200000,431000,36
TIKI,nha-cua-doi-song,252134180,"Giường xếp gấp gọn 4 chân đa năng SUMIKA 181, có nệm, 5 cấp độ điều chỉnh",869000,1580000,711000,45
TIKI,nha-cua-doi-song,270247452,"Ghế ăn đúc nguyên khối cổ điển dành cho quán cà phế, văn phòng",599000,599000,0,0
TIKI,nha-cua-doi-song,53789448,"Bộ cây lau nhà tự vắt thông minh, chổi lau nhà 360 độ, lau sạch khô nhanh - Parroti Pro PR01",419000,799000,380000,48
TIKI,nha-cua-doi-song,58828647,"Xe đẩy hàng 4 bánh SUMIKA T150 - Khung thép, tay cầm gấp mở tiện lợi, tải trọng 150kg",880000,1350000,470000,35
TIKI,nha-cua-doi-song,83412126,"Bình Giữ Nhiệt Lock&Lock Energetic One-Touch Tumbler LHC3249 - 550ML",264000,528000,264000,50
TIKI,nha-cua-doi-song,99868980,"Bình Giữ Nhiệt Locknlock Bucket Tumbler 540ml LHC4269WHT",284000,473000,189000,40
TIKI,nha-cua-doi-song,249206732,"Bàn cafe Tulip mặt tròn",1790000,1790000,0,0
TIKI,nha-cua-doi-song,1657931,"Vợt Muỗi Sunhouse SHE-E200 - Vàng",72000,119000,47000,39
TIKI,nha-cua-doi-song,253402833,"Móc gỗ treo tường Anzzar, móc treo quần áo, phụ kiện, giá gỗ treo quần áo-MT04",209000,220000,11000,5
TIKI,nha-cua-doi-song,56941523,"Ly nhựa 2 lớp LocknLock kèm ống hút HAP507 750ml",113000,217000,104000,48
TIKI,nha-cua-doi-song,92453371,"Áo Mưa Cánh Dơi Có Kiếng Đèn, Áo Mưa Kiếng Đèn Vải Dù Loại Siêu Dày, Hàng Việt Nam, Khổ To Rộng, Chống Thấm Hiệu Quả, Phù Hợp Nam Và Nữ, Có Túi Đựng, Có Lựa Chọn Màu Sắc",130000,130000,0,0
TIKI,nha-cua-doi-song,73124602,"Bình Giữ Nhiệt Bằng Thép Không Gỉ Lock&Lock Vacuum Bottle LHC6180SLV (800ML) - Màu",352000,677000,325000,48
TIKI,nha-cua-doi-song,249022286,"Sơn Chống Thấm Gốc Bitum TAIKO BITSUN No.1 - Chống Thấm Bể Cá Koi, Mái Nhà, Sân Thượng, Nhà Vệ Sinh, Logia",150000,250000,100000,40
TIKI,nha-cua-doi-song,11488920,"Bình Giữ Nhiệt Lock&Lock RigaTumbler (Shanghai) LHC4160RED  897ml - màu Red",372000,715000,343000,48
TIKI,nha-cua-doi-song,214133314,"[Hàng Chính Hãng - BH 2 Năm]Keo Sơn Chống Thấm Tường Nhà Taiko KB3 Thùng 10 Lít",1371942,1385800,13858,1
TIKI,nha-cua-doi-song,270466751,"Ghế ăn Tami, ghế nhựa đúc ngoài trời",1290000,1290000,0,0
TIKI,nha-cua-doi-song,73125530,"Hộp cơm thủy tinh kèm muỗng đũa LocknLock LLG991CLNVY 930ml - Màu Navy",188000,362000,174000,48
TIKI,nha-cua-doi-song,58804363,"Dụng Cụ Băm Rau Củ Quả Lock&amp;Lock Quick Chopper CKS310BLU",112000,216000,104000,48
TIKI,nha-cua-doi-song,2119169,"Bộ Cây Lau Nhà Lock&Lock Squeeze Flat Mop ETM471",509000,979000,470000,48
TIKI,nha-cua-doi-song,195853999,"[Hàng Chính Hãng - BH 2 Năm]Keo Chống Thấm PU (Polyurethane) Taikomi PU95 Thùng 18 Lít - Xử lý chống thấm nền gạch, bề mặt bê tông",2533000,2980000,447000,15
TIKI,nha-cua-doi-song,169848307,"Kệ Wifi Treo Tường 2 Tầng Không Cần Khoan Để Đầu Thu Kỹ Thuật Số, Remote, Điện Thoại - IG407",56000,60000,4000,7
TIKI,nha-cua-doi-song,185380360,"[Hàng Chính Hãng - BH 2 Năm]Keo Sơn Chống Thấm Sàn Mái TAIKO NITTON - Thùng 10 Lít",1485000,1500000,15000,1
TIKI,nha-cua-doi-song,33067171,"Áo mưa dây kéo vải dù tổ ong chống thấm ( nhiều màu)",95000,95000,0,0
TIKI,nha-cua-doi-song,99994000,"Bình giữ nhiệt có ống hút Lock&Lock Bucket Tumbler with Straw LHC4268 540ml - Màu",284000,473000,189000,40
TIKI,nha-cua-doi-song,272888590,"Keo Chống Thấm TAIKO Trong Suốt Gốc Silicon 0.5 Kg , 1 Kg, Combo 2 Kg  -Chống Thấm Gạch Lát Nền,Trần, Tường, Cửa Sổ, Vết Nứt Mái Nhà Triệt Để",230340,349000,118660,34
TIKI,nha-cua-doi-song,273624233,"Bình giữ nhiệt LocknLock Metro Two Way LHC4272/LHC4274 - Hàng chính hãng",315000,605000,290000,48
TIKI,nha-cua-doi-song,270139577,"Chất Tăng Cứng Sàn Liquid Hardener HTS HARD+ thùng 6Kg - Tăng cứng, Chống bụi, Dùng được cho sàn Mác yếu",427500,450000,22500,5
TIKI,nha-cua-doi-song,71890908,"Bộ lau nhà xoay 360 độ Sunhouse KS-CL330S",231000,406000,175000,43
TIKI,nha-cua-doi-song,54484578,"Đèn Bàn Học LED USB Di Động Cao Cấp Có Thể Gập Hai Chỗ – 03 Chế Độ Ánh Sáng Vàng Bảo Vệ Mắt Chống Cận eLights - Đèn Cắm Dây",185000,199000,14000,7
TIKI,nha-cua-doi-song,129370124,"Hoá Chất Tăng Cứng Sàn Liquid Hardener HTS HARD+ thùng nhỏ 6Kg - Thi công 40m2 sàn",421800,444000,22200,5
TIKI,nha-cua-doi-song,46202190,"Combo nhiều túi lưới giặt đồ cho máy giặt bảo vệ quần áo chống biến dạng chất lượng tốt dây kéo lưới mịn Polyester",42000,42000,0,0
TIKI,nha-cua-doi-song,107961500,"Ly Nhựa 2 Lớp LocknLock Double Wall Cold Cup Cherry Blossom 750ml HAP509WHT - Màu",130000,217000,87000,40
TIKI,nha-cua-doi-song,17423771,"5 Viên Pin CR2032 3V Panasonic Lithium thay pin Smartkey , Cmos , Pin thay Airtag - Hàng chính hãng",77000,100000,23000,23
TIKI,nha-cua-doi-song,104270135,"Bình Giữ Nhiệt LocknLock Featherlight One-touch Tumbler 500ml LHC3257WHT - Màu trắng",269000,517000,248000,48
TIKI,nha-cua-doi-song,3480627,"Bộ Cây Lau Nhà Xoay Tay Compact Spin Mop Lock&Lock ETM466: Thùng Giặt + Cây + Bông Lau",480000,924000,444000,48
TIKI,nha-cua-doi-song,94778000,"Ô Dù che nắng, che mưa, có nút bấm 2 chiều, hàng chất lượng, dễ thương, thiết kế sang trọng và bền bỉ, ô dù có lựa chọn màu sắc",196000,196000,0,0
TIKI,nha-cua-doi-song,186558014,"Combo 10 Móc Dán Tường Treo Đồ Đa Năng Siêu Chịu Lực",25000,25000,0,0
TIKI,nha-cua-doi-song,52574827,"Ô (dù) tự động 2 chiều cao cấp DandiHome chống UV",104500,110000,5500,5
TIKI,nha-cua-doi-song,116819040,"Thước Dây 1,5m - YOGA QG, Thước Dây May Má, Đo Chiều Cao Cho Bé, Đo Kích Thước Ba Vòng",9999,9999,0,0
TIKI,nha-cua-doi-song,84566545,"Ổ cắm điện đa năng kết hợp ổ cắm USB Nakagami chất lượng cao công nghệ Nhật Bản - Màu ngẫu nhiên",159000,159000,0,0
TIKI,nha-cua-doi-song,75614459,"Thùng rác treo tủ bếp có nắp đậy thông minh, thùng rác treo tường dán tường, có thanh trượt cửa bếp – Parroti Bin BN01/BIN01",299000,299000,0,0
TIKI,nha-cua-doi-song,122692850,"Cây chà sàn thông minh cao cấp, chổi chà sàn đa năng 2 trong 1, cọ sàn và gạt nước – Parroti Easy ES02",129000,199000,70000,35
TIKI,nha-cua-doi-song,184126392,"Bình giữ nhiệt 450ml kèm cốc đẹp lõi INOX 304 cao cấp giữ nhiệt tới 8 tiếng chống tràn có cốc uống, có thể dùng làm quà tặng độc đáo",72995,72995,0,0
TIKI,nha-cua-doi-song,892121,"Pin Max 8 + 4 Viên Energizer E91 BP8+4 AA",152000,180000,28000,16
TIKI,nha-cua-doi-song,187636657,"Keo Dán Giày Đa Năng Dán Mọi Loại Giày, Chống Thấm",45000,45000,0,0
TIKI,nha-cua-doi-song,71178441,"Áo Mưa Bít Dù Trơn, Áo Mưa Kín Người Vải Dù Siêu Dày, Chống Thấm Hiệu Quả, Phù Hợp Nam Và Nữ, Có Túi Đựng, Có Lựa Chọn Màu Sắc",115000,115000,0,0
TIKI,nha-cua-doi-song,2119173,"Cây Lau Nhà Dạng Xịt Nước Lock&Lock ETM472",280000,539000,259000,48
TIKI,nha-cua-doi-song,48045630,"5 Viên Pin Smartkey - Cmos Panasonic CR2032 - Hàng Chính Hãng",80000,100000,20000,20
TIKI,nha-cua-doi-song,99621372,"Bình giữ nhiệt Lock&amp;Lock Belt Bottle LHC4267IVY490ml - Màu",284000,473000,189000,40
TIKI,nha-cua-doi-song,90531871,"Đèn Pixar, Đèn Bàn Học Chống Cận Thị, Đèn Đọc Sách, Đèn Làm Việc Bảo Vệ Mắt - Hàng Chính Hãng Moontronics",139000,139000,0,0
TIKI,nha-cua-doi-song,120552065,"Bình giữ nhiệt inox 304 Elmich EL-8013OL dung tích 480ml",139000,389000,250000,64
TIKI,nha-cua-doi-song,92521124,"Ủng Bọc Giày Đi Mưa Chống Nước Có Đế Chống Trơn Trượt Cao Cấp",39900,39900,0,0
TIKI,nha-cua-doi-song,173211404,"Ghế Xoay Văn Phòng Ngồi Làm Việc Công Thái Học Deli - Tay Gập Thông Minh, Có Ngả Lưng, Lưới Thoáng Khí, Chân Xoay Tiện Ích, Đệm Ghế Êm Aí - Phù Hợp Học Sinh, Văn Phòng, Game Thủ, Gaming - Hàng Chính Hãng - E4928 / E4929 / E4925 / E4926G",886000,1618200,732200,45
TIKI,nha-cua-doi-song,262731552,"Giường xếp gấp gọn di động SUMIKA 386, khung thép, có bánh xe",1529000,2250000,721000,32
TIKI,nha-cua-doi-song,252135037,"Giường xếp gấp gọn 6 chân đa năng SUMIKA 298, có nệm, 5 cấp độ điều chỉnh",769000,1200000,431000,36
TIKI,nha-cua-doi-song,252134180,"Giường xếp gấp gọn 4 chân đa năng SUMIKA 181, có nệm, 5 cấp độ điều chỉnh",869000,1580000,711000,45
TIKI,nha-cua-doi-song,270466751,"Ghế ăn Tami, ghế nhựa đúc ngoài trời",1290000,1290000,0,0
TIKI,nha-cua-doi-song,21441057,"Chảo Chống Dính Đá Sunhouse SBD18 - 18cm",187000,260000,73000,28
TIKI,nha-cua-doi-song,249206732,"Bàn cafe Tulip mặt tròn",1790000,1790000,0,0
TIKI,nha-cua-doi-song,122700651,"Cây lau kính, gạt chùi kính đa năng 2 đầu trong 1 - Parroti Shiny SN01",129000,199000,70000,35
TIKI,nha-cua-doi-song,94724913,"Ron Dán Che Khe Cửa ,Chân Cửa,Khung Cửa CTFAST Chống Bụi, Ngăn Côn Trùng, Chống Ồn, Chống Thoát Nhiệt Điều Hòa, Chống Va Đập Cửa - Mẫu Cải Tiến 2021 ( Hàng Chính Hãng )",49000,68000,19000,28
TIKI,nha-cua-doi-song,146262084,"Gối Ngủ Memory Foam NOOZ Ruột Gối Cao Su Non Giúp Nâng Đỡ Đốt Sống Cổ Chống Đau Vai Gáy Ngủ Sâu Hỗ Trợ Chống Trào Ngược Phù Hợp Với Mọi Tư Thế Nằm Vỏ Gối Tencel",339000,560000,221000,39
TIKI,nha-cua-doi-song,270247452,"Ghế ăn đúc nguyên khối cổ điển dành cho quán cà phế, văn phòng",599000,599000,0,0
TIKI,nha-cua-doi-song,129370124,"Hoá Chất Tăng Cứng Sàn Liquid Hardener HTS HARD+ thùng nhỏ 6Kg - Thi công 40m2 sàn",421800,444000,22200,5
TIKI,nha-cua-doi-song,177610565,"Đèn Pin Siêu Sáng US ARMY Mã XML-T6 Cao Cấp Vỏ Hợp Kim Chống Nước Sử Dụng Pin Có Thể Sạc Lại Tặng Hộp Full Box- HÀNG CHÍNH HÃNG",108000,258000,150000,58
TIKI,nha-cua-doi-song,182971940,"Bình giữ nhiệt LocknLock có 2 nắp thay thế New Clip Tumbler 540ml LHC4279",270000,520000,250000,48
TIKI,nha-cua-doi-song,253402833,"Móc gỗ treo tường Anzzar, móc treo quần áo, phụ kiện, giá gỗ treo quần áo-MT04",209000,220000,11000,5
TIKI,nha-cua-doi-song,78025846,"Khăn tắm Bamboo Life BL058 hàng chính hãng được làm từ sợi tre thiên nhiên mềm mại kháng khuẩn siêu thấm hút an toàn cho da",59000,59000,0,0
TIKI,nha-cua-doi-song,214131948,"Vải Polyester Phủ Chống Thấm Mái Nhà Tường Nhà Khe Nứt Tiện Dụng Đa Năng Khổ 1m",331500,390000,58500,15
TIKI,nha-cua-doi-song,147265074,"Vỉ 2 VPin AA , Pin AAA DURACELL 1,5V Siêu Bền - Hàng chính hãng",30000,30000,0,0
TIKI,nha-cua-doi-song,163550425,"Nệm Bông Gòn Xuất Nhật, Nệm Trải Sàn Tiện Lợi, Đệm Văn Phòng Size 1m x 2m; 1.4m x 2m; 1.6m x 2m",387000,500000,113000,23
TIKI,nha-cua-doi-song,249022286,"Sơn Chống Thấm Gốc Bitum TAIKO BITSUN No.1 - Chống Thấm Bể Cá Koi, Mái Nhà, Sân Thượng, Nhà Vệ Sinh, Logia",150000,250000,100000,40
TIKI,nha-cua-doi-song,73147684,"Thanh xốp gắn chân cửa chống kẹt chân cho bé, bịt khe hở, chắn gió, chặn côn trùng",8000,13999,5999,43
TIKI,nha-cua-doi-song,272888590,"Keo Chống Thấm TAIKO Trong Suốt Gốc Silicon 0.5 Kg , 1 Kg, Combo 2 Kg  -Chống Thấm Gạch Lát Nền,Trần, Tường, Cửa Sổ, Vết Nứt Mái Nhà Triệt Để",230340,349000,118660,34
TIKI,nha-cua-doi-song,195853999,"[Hàng Chính Hãng - BH 2 Năm]Keo Chống Thấm PU (Polyurethane) Taikomi PU95 Thùng 18 Lít - Xử lý chống thấm nền gạch, bề mặt bê tông",2533000,2980000,447000,15
TIKI,nha-cua-doi-song,1399571,"Gối Memory Foam 50D Hình Cong Lock&Lock HLW111 (50 x 30 cm) - Trắng",290000,483000,193000,40
TIKI,nha-cua-doi-song,71924330,"Bộ Chổi Quét Nhà Lock&Lock Gồm Cây Chổi và Dụng Cụ Hốt ETM465",257000,428000,171000,40
TIKI,nha-cua-doi-song,119195755,"Bộ lau nhà tự vắt thông minh, chổi lau nhà 360 độ, lau sạch khô nhanh - Parroti ProMax PX01",519000,849000,330000,39
TIKI,nha-cua-doi-song,183907622,"Cây Lăn Bụi Quần Áo, Ghế Sofa - Tặng Kèm 2 lõi lăn",31000,55000,24000,44
TIKI,nha-cua-doi-song,143841853,"Bình Giữ Nhiệt Coffee Bugu Mini Inox 304 LI-02 – Hàng Chính Hãng",108000,150000,42000,28
TIKI,nha-cua-doi-song,92385690,"Áo Mưa Cánh Dơi 2 Đầu Vải Dù Loại Siêu Dày, Hàng Việt Nam Chất Lượng Cao, Khổ To Rộng Phù Hợp Cho 2 Người, An Toàn Cho Người Sử Dụng, Có Túi Đựng Dễ Bảo Quản.",140000,140000,0,0
TIKI,nha-cua-doi-song,185756654,"Cây chà sàn nhà tắm Kitimop-Z4 chổi cọ sàn và gạt nước đa năng 2 trong 1, cọ sạch khe hẹp và góc tường",49000,75000,26000,35
TIKI,nha-cua-doi-song,57867024,"Bộ Lau Nhà Xoay 360 Độ Sunhouse Ks-Cl350PO",337000,513000,176000,34
TIKI,nha-cua-doi-song,52504270,"Chiếu Mây Điều Hòa Cao Cấp Loại dày",169000,300000,131000,44
TIKI,nha-cua-doi-song,119203295,"Combo 5 Khăn Lau Bếp, Lau Kính Siêu Thấm Hút Parroti - Fiber FB02",47000,89000,42000,47
TIKI,nha-cua-doi-song,270139577,"Chất Tăng Cứng Sàn Liquid Hardener HTS HARD+ thùng 6Kg - Tăng cứng, Chống bụi, Dùng được cho sàn Mác yếu",427500,450000,22500,5
TIKI,nha-cua-doi-song,185910176,"Giấy Nến Vàng Lót Nồi Chiên Không Dầu Sạch Sẽ Tiện Dụng An Toàn Cho Sức Khỏe - 1 set 50 Tờ",85000,85000,0,0
TIKI,nha-cua-doi-song,106457363,"Túi Giữ Nhiệt Đựng Hộp Cơm 2 Ngăn – Chọn Màu Túi Giữ Nhiệt Đựng Cặp Lồng Cơm – Nhiều Màu – Chống Thấm Nước Chính Hãng",45000,70000,25000,36
TIKI,nha-cua-doi-song,115092053,"Bộ ga giường poly cotton LIDACO drap giường đủ size nệm 1m2, 1m4, 1m6, 1m8",119000,120000,1000,1
TIKI,nha-cua-doi-song,186627908,"Ghế Gác Chân Công Thái Học Ergonomic Footrest, Ghế Kê Chân Ghế Gác Chân Văn Phòng",189000,280000,91000,33
TIKI,nha-cua-doi-song,32328782,"Phin Nhôm Cà Phê Tráng Men Đen Trung Nguyên  ",79000,79000,0,0
TIKI,nha-cua-doi-song,52756206,"1kg Túi Đựng Rác Tự Phân Hủy Sinh Học Gimex II (full size)",28000,28000,0,0
TIKI,nha-cua-doi-song,181410158,"Bàn Làm Việc Đa Năng Decor Phong Cách Gaming Thương Hiệu IGA - GM62",293000,320000,27000,8
TIKI,nha-cua-doi-song,185380360,"[Hàng Chính Hãng - BH 2 Năm]Keo Sơn Chống Thấm Sàn Mái TAIKO NITTON - Thùng 10 Lít",1485000,1500000,15000,1
TIKI,nha-cua-doi-song,120759154,"Bó 100 Dây Thít, Dây Rút, Lạt Nhựa Đủ Mọi Kích Cỡ Tiện Lợi",24000,30000,6000,20
TIKI,nha-cua-doi-song,58828647,"Xe đẩy hàng 4 bánh SUMIKA T150 - Khung thép, tay cầm gấp mở tiện lợi, tải trọng 150kg",880000,1350000,470000,35
TIKI,nha-cua-doi-song,98562149," 328 Cái Ống Co Nhiệt Cách Nhiệt Ống Co Phân Loại Điện Tử",28989,28989,0,0
TIKI,nha-cua-doi-song,84886093,"Vợt muỗi thông minh 3in1 SUNHOUSE SHE-PRO11.W",208000,344000,136000,40
TIKI,nha-cua-doi-song,57806524,"Áo Mưa Bộ Vải Dù Cao Cấp Cho Bé Từ 3 -10 Tuổi, Chống Thấm, Che Kín Người An Toàn Cho Bé, Lựa Chọn Màu Sắc Phù Hợp Giới Tính (Giao Màu - Mẫu Ngẫu Nhiên)",110000,110000,0,0
TIKI,nha-cua-doi-song,1024190,"Bộ 3 Hộp Cơm Giữ Nhiệt Lock&amp;Lock Mushroom LHC8025SLV - Bạc",524000,1007000,483000,48
TIKI,nha-cua-doi-song,119007194,"Thanh 4 Móc Treo Dán Tường, Móc Treo Đồ Đa Năng Parroti Handy HD41",21900,36000,14100,39
TIKI,nha-cua-doi-song,138952791,"Móc Treo Cây Lau Nhà Dán Tường Đa Năng Chịu Lực Tốt, 2 Trong 1 - Parroti Keeper KP03",22900,42000,19100,45
TIKI,nha-cua-doi-song,241804451," Móc INOX 304 Treo Đồ nặng, treo thớt, nồi niêu INOX 304 [CHỐNG NƯỚC, CHỐNG RỈ] Dán Mọi Bề Mặt",15000,15000,0,0
TIKI,nha-sach-tiki,197629358,"Chúng Ta Có Hẹn Với Bình Yên",71000,89000,18000,20
TIKI,nha-cua-doi-song,892141,"Pin Max 8 + 4 Viên Energizer E92 BP8+4 AAA",152000,180000,28000,16
TIKI,nha-sach-tiki,193684715,"Ngoan Cường Vượt Định Kiến",56100,79000,22900,29
TIKI,nha-sach-tiki,193988316,"Siêu Tâm Trí – Học Cách Suy Nghĩ Như Sherlock Holmes",98500,145000,46500,32
TIKI,nha-cua-doi-song,119030223,"Keo Dán Giày, Gỗ, Nhựa, Sứ Siêu Dính Chống Thấm Đa Năng Deli - 7Ml / 20Ml - 7140 / 7149",8000,16200,8200,51
TIKI,nha-sach-tiki,259537049,"Hộp 10 Bút Lông Bảng Thiên Long WB-03",73000,93000,20000,22
TIKI,nha-cua-doi-song,54145105,"Cọ Bồn Cầu Toilet, Cọ Vệ Sinh Cao Cấp - Parroti Silicon SL01 – Có Bình Đựng Nước Tẩy, Cây Gắp Tóc Tiện Dụng",88000,89000,1000,1
TIKI,nha-cua-doi-song,165013585,"Ổ Cắm Điện Dài VINAVU Kèm Cổng USB Công Tắc Riêng Chịu Tải 2500W, Chống Giật, Chống Cháy",199000,199000,0,0
TIKI,nha-sach-tiki,101297001,"Tâm Lý Hành Vi Trong Đầu Tư Chứng Khoán",110700,159000,48300,30
TIKI,nha-cua-doi-song,112321595,"Đèn Học Chống Cận Thị, Đèn Đọc Sách, Đèn Làm Việc Để Bàn Chống Chói Mắt Lóa Mắt Bảo Vệ Mắt Chống Cận Thị, Cảm Ứng Siêu Sáng - VinBuy",164000,300000,136000,45
TIKI,nha-sach-tiki,46107068,"Thế Giới Ảo, Thương Hiệu Thật",86420,149000,62580,42
TIKI,nha-sach-tiki,194130753,"Bong bóng số 0-9 nhiều màu 35cm trang trí tiệc xinh",18000,18000,0,0
TIKI,nha-sach-tiki,169603497,"Macmillan Dictionary Vietnam ED with App – Soft cover",399000,399000,0,0
TIKI,nha-sach-tiki,176909246,"Bí Quyết Bấm Huyệt Chữa Bệnh",123000,178000,55000,31
TIKI,nha-sach-tiki,147988196,"Combo 3 Cuốn "Hiểu Hết": How Food Works - Hiểu Hết Về Thức Ăn + How The Body Works - Hiểu Hết Về Cơ Thể + How Psychology Works - Hiểu Hết Về Tâm Lý Học",759000,900000,141000,16
TIKI,nha-sach-tiki,152517438,"Dữ Liệu Bạch Kim (Văn Học Trinh Thám)",127200,159000,31800,20
TIKI,nha-sach-tiki,69162885,"Influencer - Phương Pháp 5 Bước Để Trở Thành Người Có Tầm Ảnh Hưởng Nhất Trong Lĩnh Vực Của Bạn",88100,129000,40900,32
TIKI,nha-sach-tiki,714012,"Truyện Ngụ Ngôn La Fontaine",58800,98000,39200,40
TIKI,nha-sach-tiki,184781428,"Nuôi Con Bằng Yêu Thương Dạy Con Bằng Lý Trí (Tái bản) - Tặng Kèm Bookmark",85000,114000,29000,25
TIKI,nha-sach-tiki,164323204,"Semantic Error - Lỗi Logic - Tập 1 - Tặng Kèm Bookmark + 01 Postcard",233100,259000,25900,10
TIKI,nha-sach-tiki,136753126,"Tôi Đã Kiếm 1 Triệu Đô Đầu Tiên Trên Internet Như Thế Nào Và Bạn Cũng Có Thể Làm Như Thế (Tái Bản)",115420,199000,83580,42
TIKI,nha-sach-tiki,173092689,"Phát triển trí tuệ (140 câu đố) - Bộ sách Rèn luyện Trí thông minh - Dành cho trẻ 5-6 tuổi",23538,46152,22614,49
TIKI,nha-sach-tiki,191148968,"Bút Hết Nặng Viết Hết Đau",185000,239000,54000,23
TIKI,nha-sach-tiki,135552451,"Các Triều Đại Việt Nam",78000,120000,42000,35
TIKI,nha-sach-tiki,191926650,"Trái cây đại chiến Zombie - Thế giới khủng long: Tập 11 - Thợ săn đáy biển",58000,89000,31000,35
TIKI,nha-sach-tiki,332626,"Oxford Learner's Pocket Dictionary : A Pocket-sized Reference to English Vocabulary (Fourth Edition)",76260,85000,8740,10
TIKI,nha-sach-tiki,87941401,"Lối Tắt Khởi Nghiệp - Con Đường Ngắn Từ Tay Trắng Đến Thành Công Bền Vững",125000,169000,44000,26
TIKI,nha-sach-tiki,99681443,"Khoa Học - Khái Lược Những Tư Tưởng Lớn ",327000,450000,123000,27
TIKI,nha-sach-tiki,101897983,"Không Tức Giận Bạn Đã Thắng",107000,149000,42000,28
TIKI,nha-sach-tiki,5974545,"Series Địch Công Kỳ Án Tập 11: Bóng Ma Trong Chùa",53000,110000,57000,52
TIKI,nha-sach-tiki,193100617,"Anh Hùng Diệt Thần & Bảy Thệ Ước (Tập 2)",134000,149000,15000,10
TIKI,nha-sach-tiki,74983567,"Tứ Trấn Huyền Linh",158000,259000,101000,39
TIKI,nha-sach-tiki,189598539,"Bài tập bổ trợ Tiếng Anh 10",118000,118000,0,0
TIKI,nha-sach-tiki,76305752,"Combo Bộ 2 Cuốn: Giết Chỉ Huy Đội Kỵ Sĩ (Tập 1: Ý Tưởng Xuất Hiện + Tập 2: Ẩn Dụ Dịch Chuyển)",324000,410000,86000,21
TIKI,nha-sach-tiki,166033485,"Sách 14 Nguyên Tắc Tăng Trưởng Thần Tốc Như Amazon",125000,188000,63000,34
TIKI,nha-sach-tiki,148761075,"Combo 6 Cuốn: "Hít Hà Mùi Đất Nước"",207000,240000,33000,14
TIKI,nha-sach-tiki,150682463,"Linh Ứng - Hành Trình Của Kẻ Siêu Vô Thần Đến Thế Giới Tâm Linh",186000,268000,82000,31
TIKI,nha-sach-tiki,95090180," Bút dấu dòng dạ quang Deli – 6 chiếc/ hộp - S624",52200,52200,0,0
TIKI,nha-sach-tiki,188128043,"Kingdom - Tập 29",45000,45000,0,0
TIKI,nha-sach-tiki,68456844,"Bài Tập Tiếng Anh 8 - Tập 1 - Có Đáp Án (Theo Chương Trình Mới Của Bộ GD&ĐT)",37900,48000,10100,21
TIKI,nha-sach-tiki,51660434,"Những Bí Quyết Vàng Đầu Tư Bất Động Sản",89000,89000,0,0
TIKI,nha-sach-tiki,187190670,"Black Jack - Tập 11 (Bìa Cứng)",127000,135000,8000,6
TIKI,nha-sach-tiki,146936894,"Combo 4 cuốn Sách tự xóa: Chữ cái - Toán - Chữ số - Hình khối & Màu sắc (tặng kèm bút)",79528,152939,73411,48
TIKI,nha-sach-tiki,10581200,"Dế Mèn Phiêu Lưu Ký (Tái Bản)",38000,50000,12000,24
TIKI,nha-sach-tiki,42180465,"Đừng Chỉ Đẹp Mà Không Hiểu Chuyện",61800,89000,27200,31
TIKI,nha-sach-tiki,191353862,"Green Witchcraft - Năng lượng từ thảo mộc",104300,149000,44700,30
TIKI,nha-sach-tiki,112588572,"Yêu Trong Tỉnh Thức - Từ Bạn Đời Đến Bạn Đạo Tập 1",185000,185000,0,0
TIKI,nha-sach-tiki,172800656,"Komi - Nữ Thần Sợ Giao Tiếp Tập 8 [Tặng kèm Card bo góc Nữ thần]",25000,25000,0,0
TIKI,nha-sach-tiki,73222804,"Sách Putin Logic Của Quyền Lực (Tái Bản 2020)",117000,168000,51000,30
TIKI,nha-sach-tiki,870619,"Túp Lều Bác Tom",71000,110000,39000,35
TIKI,nha-sach-tiki,109982956,"Leonardo Da Vinci - Thiên Tài Toàn Năng",40000,60000,20000,33
TIKI,nha-sach-tiki,91774356,"Fullmetal Alchemist - Cang Giả Kim Thuật Sư - Fullmetal Edition Tập 8",65500,69000,3500,5
TIKI,nha-sach-tiki,91120169,"Homecoming - Hồi Sinh Đứa Trẻ Bên Trong Bạn",117000,169000,52000,31
TIKI,nha-sach-tiki,77481097,"Nghề Nhân Sự Việt - Nghìn Lẻ Chuyện Giờ Mới Kể",127400,199000,71600,36
TIKI,nha-sach-tiki,6807847,"Cảm Ơn Người Lớn (Bìa Mềm) - Bản Tặng Kèm Thiệp + Phong Bì Thiệp + Bookmark (Số Lượng Có Hạn)",64200,110000,45800,42
TIKI,nha-sach-tiki,195801643,"Cà Phê Cùng Tony (Tái Bản 2022)",72000,105000,33000,31
TIKI,nha-sach-tiki,191148787,"Green Witchcraft - Năng lượng từ thảo mộc",103700,149000,45300,30
TIKI,nha-sach-tiki,130997089,"[Manga] Diệt Slime Suốt 300 Năm, Tôi Levelmax Lúc Nào Chẳng Hay (Tập 6)",47100,48000,900,2
TIKI,nha-sach-tiki,190592917,"Combo 2 Quyển: Thiên Tài Bên Trái, Kẻ Điên Bên Phải + Tâm Lý Học Tội Phạm: Phác Họa Chân Dung Kẻ Phạm Tội",223000,324000,101000,31
TIKI,nha-sach-tiki,171821043,"Bộ "Anne Tóc Đỏ" 8 Cuốn",717000,972000,255000,26
TIKI,nha-sach-tiki,11413619,"Combo Mẹ Hỏi Bé Trả Lời (4 Cuốn)",95000,120000,25000,21
TIKI,nha-sach-tiki,72688720,"Năm Phút Nữa Thôi",43800,59000,15200,26
TIKI,nha-sach-tiki,191373346,"[QUÀ TẶNG ĐỘC QUYỀN]  Ví da y tế cao cấp đa năng, đựng thuốc, đựng máy đo đường huyết, nhiệt kế, điện thoại, ví tiền, bền đẹp và tiện lợi, hạn chế va đập, tiện lợi cả ở nhà và đi du lịch",199000,199000,0,0
TIKI,nha-sach-tiki,5087505,"Ám Dạ Hành (Trinh Thám Hiện Đại Trung Quốc)",63000,151000,88000,58
TIKI,nha-sach-tiki,109982972,"Marie Curie - Nhà Nữ Khoa Học Kiệt Xuất",58500,75000,16500,22
TIKI,nha-sach-tiki,520337,"Luật Im Lặng (Mario Puzo)",63000,95000,32000,34
TIKI,nha-sach-tiki,36311444,"Đàn Ông Sao Hỏa Đàn Bà Sao Kim (Tặng Bookmark PL)",135360,188000,52640,28
TIKI,nha-sach-tiki,76117849,"Luyện Kỹ Năng Nghe Tiếng Anh (Trình Độ Cơ Bản) -Tactics For Listening Basic",64000,90000,26000,29
TIKI,nha-sach-tiki,46107066,"Học Cách Học",119000,159000,40000,25
TIKI,nha-sach-tiki,173420792,"Người Hạt Dẻ",159200,199000,39800,20
TIKI,nha-sach-tiki,100376369,"Đứa Con Gái Hoang Đàng - Hai Số Phận - Phần II",129000,209000,80000,38
TIKI,nha-sach-tiki,72688722,"Giáo Dục - Tương Lai & Đổi Mới",148000,180000,32000,18
TIKI,nha-sach-tiki,194959697,"Thánh Hiệp Sĩ Nơi Tận Cùng Thế Giới – Tập 1",116000,145000,29000,20
TIKI,nha-sach-tiki,3840809,"New Economy Toeic Lc 1000 (Kèm file MP3)",149000,198000,49000,25
TIKI,nha-sach-tiki,11119019,"Oxford Advanced Learner's Dictionary 8th Edition (With Vietnamese Translation) and CD - ROM (Paperback)",581300,625000,43700,7
TIKI,nha-sach-tiki,1544255,"Băng Keo Trong 5F (2 Cuộn / Lốc)",17000,49000,32000,65
TIKI,nha-sach-tiki,160814425,"Thai Giáo Theo Chuyên Gia - 280 Ngày - Mỗi Ngày Đọc Một Trang (Tái Bản 2021)",82800,115000,32200,28
TIKI,nha-sach-tiki,73553840,"Truyện Thiếu Nhi Hạt Giống Tâm Hồn - Thế Giới Trong Ngăn Tủ (Tái Bản 2020)",35000,40000,5000,13
TIKI,nha-sach-tiki,100382935,"Sách - Hành Trình Về Phương Đông (Bìa Mềm - Tái bản 2021) - First News",106650,106650,0,0
TIKI,nha-sach-tiki,52691750,"Tự Do Đầu Tiên & Cuối Cùng",124000,178000,54000,30
TIKI,nha-sach-tiki,11413616,"Mẹ Hỏi Bé Trả Lời 4-5 Tuổi (Tái Bản)",27000,30000,3000,10
TIKI,nha-sach-tiki,175967753,"Komi - Nữ Thần Sợ Giao Tiếp Tập 9",25000,25000,0,0
TIKI,nha-sach-tiki,172422019,"Vì Con Gái Tôi Có Thể Đánh Bại Cả Ma Vương - Tập 5 - Tặng Kèm Poster + Bookmark",119000,140000,21000,15
TIKI,nha-sach-tiki,392568,"Marvellous Techniques For IELTS Writing",201000,268000,67000,25
TIKI,nha-sach-tiki,158972052,"Cẩm Nang Con Trai",46600,68000,21400,31
TIKI,nha-cua-doi-song,1651191,"Kệ Đỡ Màn Hình Máy Tính Monitor Stand Walnut Plyconcept MSM01003 (490 x 200 mm) - Nâu Đậm",290000,380000,90000,24
TIKI,nha-cua-doi-song,104680895,"Cây Lau Nhà Đơn MyJae Sợi Microfiber Xoay 360 Độ Phù Hợp Cho Nhiều Loại Thùng Lau 134cm",199000,330000,131000,40
TIKI,nha-cua-doi-song,153066085,"Pin CR2032 Lithium 3V Maxell cao cấp Made In Japan - Hàng chính hãng",26000,30000,4000,13
TIKI,nha-cua-doi-song,184245786,"Túi đựng hộp cơm giữ nhiệt, túi đựng đồ ăn trưa văn phòng có lớp lót nhôm giữ nhiệt dày dặn, kích thước lớn tiện lợi",59000,59000,0,0
TIKI,nha-cua-doi-song,64988886,"Bình giữ nhiệt Lock&amp;Lock Flat nắp gỗ 400ml - LHC4227WHT - Màu",278000,534000,256000,48
TIKI,nha-cua-doi-song,122911188,"Găng tay cao su siêu dai rửa bát, bao tay cao su rửa chén, vệ sinh nhà cửa, an toàn, không mùi hôi Parroti Active AT01",47000,89000,42000,47
TIKI,nha-cua-doi-song,14681534,"Bộ tua vít sửa chữa đồng hồ điện thoại",31160,32800,1640,5
TIKI,nha-cua-doi-song,173732608,"Combo Khăn Lau Đa Năng 2 Mặt Siêu Thấm , Khăn Lau Bếp , Khăn Lau Kính , Khăn Lau Chén Bát , Khăn Lau Tay , Khăn Lau Ô Tô PaKaSa",38000,38000,0,0
TIKI,nha-cua-doi-song,58357614,"Đèn bắt muỗi, ruồi và các loại côn trùng Con Dơi",390000,390000,0,0
TIKI,nha-cua-doi-song,273244363,"Kệ Sách Gỗ 5 Tầng, Giá Sách Đứng Cạnh Bàn Làm Việc - GP189",318000,346000,28000,8
TIKI,nha-cua-doi-song,200960836,"Dây Đèn Led Fairy Light Trang Trí Giáng Sinh Biểu Tượng Cây Thông, Người Tuyết, Ông Già Noel - Chính Hãng NAVIVU",79000,79000,0,0
TIKI,nha-cua-doi-song,46163430,"Sáo Recorder Soprano Yamaha YRS-24B Tone C (Đô) - Kèm Móng Gảy DreamMaker",129000,129000,0,0
TIKI,nha-cua-doi-song,75664370,"GỐI MỀN BIỆT ĐỘI RU NGỦ 3 IN 1 - BỘ CHĂN GỐI VĂN PHÒNG SIÊU MỊN -MẪU 2021",199000,199000,0,0
TIKI,nha-cua-doi-song,119112667,"Combo 2 Miếng Lau Nhà Parroti ProMAX - Kích Thước 38 x12 CM",85000,145000,60000,41
TIKI,nha-cua-doi-song,162548473,"Hộp Đựng Giày Nhựa Cứng Cao Cấp Size Lớn Cửa Nam Châm Lắp Ráp Tiện Lợi Song Anh- Hàng Chính Hãng",95000,95000,0,0
TIKI,nha-cua-doi-song,174236741,"Găng tay cao su tự nhiên Lock&amp;Lock ETM830 (có móc treo)",31000,56000,25000,45
TIKI,nha-cua-doi-song,71206737,"Đèn Pin Laser 303 - Hàng Chính Hãng",133400,145000,11600,8
TIKI,nha-cua-doi-song,127031393,"Ca nước giữ nhiệt LocknLock Metro Mug LHC4219MIT 475ml - Màu",304000,506000,202000,40
TIKI,nha-cua-doi-song,148713415,"Tua Vít Cầm Tay Nhỏ Gọn, Tiện Dụng Lắp Ráp Và Sửa Chữa Vật Dụng Gia Đình (5mmx155mm)",27000,27000,0,0
TIKI,nha-cua-doi-song,110001215,"Nẹp Dây Điện Dán Tường Siêu Dính ,Kẹp Dây Điện Cố Định Và Giữ Dây Điện Siêu Sốc an toàn tiện lợi dễ lắp đặt",11699,11699,0,0
TIKI,nha-cua-doi-song,36560504,"Bình Nước Lock&Lock One Touch ABF687LPIK 500ml",151000,290000,139000,48
TIKI,nha-cua-doi-song,177969021,"Bộ Hộp Cơm Giữ Nhiệt 2GOOD Lunch Box HC02 (2000ml) - Kèm Muỗng và Đũa Inox 304",590000,590000,0,0
TIKI,nha-cua-doi-song,117353723,"Chiếu ngủ văn phòng cao cấp",45000,45000,0,0
TIKI,nha-cua-doi-song,10227148,"Dụng Cụ Mài Dao 3 Lớp Lock&Lock CKK112 (245 x 53 x 72 mm)",165000,275000,110000,40
TIKI,nha-cua-doi-song,149617968,"Thùng đựng gạo thông minh M&L Royalcare 6068 - bao gồm khay đựng ngũ cốc - chống ẩm mốc côn trùng - đồ gia dụng tiện ích",469000,469000,0,0
TIKI,nha-cua-doi-song,2153015,"Bộ Vít 24 Món Xiaomi Wiha Precision Screwdriver",399000,490000,91000,19
TIKI,nha-cua-doi-song,44620765,"Đèn Pin Led Siêu Sáng Mini Có Sạc USB Có Hỗ Trợ Sạc Dự Phòng Lại Cho Điện Thoại Khẩn Cấp - Hàng Chính Hãng",85000,129000,44000,34
TIKI,nha-cua-doi-song,138507381,"Chai xịt chuột thái land rat off",83000,83000,0,0
TIKI,nha-cua-doi-song,63051860," Đèn Học Làm Việc Đọc Sách Để Bàn Pixar Chống Cận Thị Bảo Vệ Mắt - Hàng Chính Hãng eLights",159000,219000,60000,27
TIKI,nha-cua-doi-song,165256438,"Khăn mặt sợi tre Bamboo&Love 30x50 mềm mại kháng khuẩn siêu thấm hút an toàn cho da ngay cả với trẻ sơ sinh",23700,23900,200,1
TIKI,nha-cua-doi-song,2151853,"Ly Giữ Nhiệt Lock&Lock Swing Tumbler LHC4138SLV",374000,623000,249000,40
TIKI,nha-cua-doi-song,128969410,"Kệ Sách Để Bàn, Giá Sách Thiết Kế Hiện Đại Thương Hiệu IGA - GP157",187000,205000,18000,9
TIKI,nha-cua-doi-song,118858137,"Nạo Gọt Rau Củ Quả  Inox 304 Hàng Cao Cấp - Mua 1 Lần Dùng Mãi Mãi",70000,70000,0,0
TIKI,nha-cua-doi-song,131407951,"Bàn làm việc bàn hoc chữ k",372240,396000,23760,6
TIKI,nha-cua-doi-song,52484490,"Keo Dán Chống Thấm Siêu Dính Nhật Bản Bosui Dài 5m ",13000,14999,1999,13
TIKI,nha-cua-doi-song,149573787,"Thùng rác thông minh cảm ứng tự động M&L-FH-2 phong cách Hàn Quốc",479000,479000,0,0
TIKI,nha-cua-doi-song,104110135,"Bàn chải nhà tắm, cọ bồn rửa Parroti Clever CR01",55000,99000,44000,44
TIKI,nha-cua-doi-song,52187161,"Giá Treo Ổ Điện Dán Tường Tiết Kiệm Không Gian",6000,9000,3000,33
TIKI,nha-cua-doi-song,75615959,"Combo 5 khăn lau đa năng siêu thấm hút, khăn size lớn (30x40 cm) khăn lau kính, ô tô, mặt bàn, bếp Parroti Fiber FB01",48000,89000,41000,46
TIKI,nha-cua-doi-song,57999394,"Bộ Ga Gối Cotton Đũi Tici LIDACO Cao Cấp - Xanh Mint",149000,220000,71000,32
TIKI,nha-cua-doi-song,118966833,"Móc Treo Cây Lau Nhà Dán Tường Đa Năng  Chịu Lực Tốt - Parroti Keeper KP02",22900,42000,19100,45
TIKI,nha-cua-doi-song,74396976,"Máy xay tỏi ớt bằng tay Lock&Lock (Nhiều kích cỡ) - Hàng chính hãng, lực nghiền mạnh với 3 lưỡi dao thép không gỉ",129000,216000,87000,40
TIKI,nha-cua-doi-song,165404269,"Khăn tắm sợi tre Bamboo&Love 60x120cm mềm mại kháng khuẩn siêu thấm hút an toàn cho da ngay cả với trẻ sơ sinh",70000,70000,0,0
TIKI,nha-cua-doi-song,180378151,"Bình giữ nhiệt LocknLock Metro Drive LHC4277S 650ml - Kèm ống hút và cọ rửa",301000,579000,278000,48
TIKI,nha-cua-doi-song,189491905,"Nhang Sen Thuần Khiết Liên Tâm 20.5cm 160 cây - Ít khói, dịu nhẹ, 100% Đài sen thiên nhiên",75000,75000,0,0
TIKI,nha-cua-doi-song,3490669,"Cây lau nhà tự vắt thông minh Panda ",39794,41888,2094,5
TIKI,nha-cua-doi-song,121396300,"Dây rút nhựa 10cm ,15cm, 20cm, 25cm, 30cm ( Khoảng 80 sợi/bịch )",3900,3900,0,0
TIKI,nha-cua-doi-song,17593518,"Bộ Hộp Cơm Giữ Nhiệt Thép Không Gỉ Lock & Lock LHC8031SLV - Bạc",668000,1285000,617000,48
TIKI,nha-cua-doi-song,10032000,"Ổ cắm đa năng du lịch Adapter",30500,30500,0,0
TIKI,nha-cua-doi-song,71005991,"Bình xịt dầu Lock&Lock 100ml kèm phểu và cọ rửa - CKO109",104000,174000,70000,40
TIKI,nha-cua-doi-song,147806385,"Đũa gắp thức ăn vặt DandiHome siêu nhẹ cho chơi game, làm việc văn phòng",13250,15000,1750,12
TIKI,nha-cua-doi-song,259514693,"Cây chà sàn nhà tắm Kitimop-Z1 chổi cọ sàn và gạt nước đa năng 2 trong 1, cán hợp kim nhôm tăng giảm chiều dài 65-125cm",145000,215000,70000,33
TIKI,nha-cua-doi-song,57945711,"Hộp đựng bàn chải kem đánh răng nhà tắm tặng kèm 4 cốc-Kệ để đồ vệ sinh răng miệng dán tường (màu ngẫu nhiên)",168850,168850,0,0
TIKI,nha-cua-doi-song,206485076,"Hương nhang sạch Dương Minh nhang 20cm và 30cm 100% thành phần tự nhiên các loại nhang Cam Sả nhang Bồ Kết nhang Bắc nhang Thảo Mộc nhang Quế nhang Khuynh Diệp và Trầm Hương cao cấp",45000,60000,15000,25
TIKI,nha-cua-doi-song,134853381,"Bình giữ nhiệt LocknLock Feather Light Ring LHC4244PIK 460ml - Màu",313000,601000,288000,48
TIKI,nha-cua-doi-song,77775165,"Hộp Bảo Quản Thủy Tinh Lock&Lock LBG - Top Class (Nhiều Dung Tích)",102000,196000,94000,48
TIKI,nha-cua-doi-song,110894852,"Giấy Bạc Màng Nhôm MyJae Đài Loan Để Bảo Quản, Nướng Thức Ăn, Bọc Thực Phẩm 30cm x 14m",85000,119000,34000,29
TIKI,nha-cua-doi-song,179370829,"GÓI 20 VIÊN KHĂN GIẤY NÉN HÀN QUỐC HÌNH VIÊN KẸO ĐA NĂNG",16999,16999,0,0
TIKI,nha-cua-doi-song,12030860,"Áo Mưa kín người Không Xẻ Tà Vải Dù Hàng Cao Cấp Chống Thấm Cực Tốt, Áo Mưa Đi Xe Máy",86000,86000,0,0
TIKI,nha-cua-doi-song,162526068,"Đất trồng cây SOILMIX cho hoa hồng, cây cảnh, sen đá, rau sạch hữu cơ, bổ sung phân bón vi sinh, trichoderma, đá perlite",50000,50000,0,0
TIKI,nha-cua-doi-song,82875291,"Bộ 2 thùng vải, hộp vải đựng đồ đa năng -Màu Nâu Kem + Tặng kèm dây cột tóc- Hộp vải đựng quần áo 2 size đựng quần áo, đồ lót, giày, văn phòng phẩm, đồ dùng cá nhân rất tiện lợi-Bộ 2 hộp vải đựng đồ vải canvas siêu xinh có nắp đậy, tủ vải đựng đồ hộp cái ",109000,141700,32700,23
TIKI,nha-cua-doi-song,52578184,"Tuýp Keo Dán Đồ Gia Dụng Siêu Dính, Keo Dán Kim Loại Cao Cấp",15000,15000,0,0
TIKI,nha-cua-doi-song,57867023,"Cây Lau Nhà Xoay 360 Độ Sunhouse Ks-Mo350I",130000,200000,70000,35
TIKI,nha-cua-doi-song,55900887,"Đèn Bàn Học Đọc Sách, Làm Việc (Học Sinh, Sinh Viên, Văn Phòng) LED Chống Cận, Cảm Ứng Nhôm Cao Cấp eLights",389000,449000,60000,13
TIKI,nha-cua-doi-song,178783625,"Combo 2 Giá đỡ bàn chải máy dán tường NAVIVU",50000,50000,0,0
TIKI,nha-cua-doi-song,102488853,"Thùng Đựng Gạo Cao Cấp 5kg & 10kg - Thùng Đựng Gạo Nắp Đậy Thông Minh, Thiết Kế Hiện Đại & Đẹp Mắt, Chất Liệu ABS &PP An Toàn Chống Nước, Chống Ẩm Mốc, Mối Mọt - Hàng Nhập Khẩu",206000,343500,137500,40
TIKI,nha-cua-doi-song,19298165,"Áo Mưa Bộ Cho Bé Trai, Bé Gái ( số 1-5)",46000,46000,0,0
TIKI,nha-cua-doi-song,3927949,"Bộ sạc Energizer Charger kèm 4 pin Ener AA 2000mAh, tự ngắt sạc (CHVCM4)",447000,460000,13000,3
TIKI,nha-cua-doi-song,21101765,"Bàn Học Bàn Làm Việc Kết Hợp Kệ Sách Thương Hiệu IGEA",670000,729000,59000,8
TIKI,nha-cua-doi-song,949687,"Kệ Đỡ Màn Hình Máy Tính Monitor Stand Plyconcept MSM01001 (490 x 200 mm) - Gỗ",250000,300000,50000,17
TIKI,nha-cua-doi-song,121602582,"Bình xịt chống thấm tường, Keo chống dột xịt chống thấm nhà, mái tôn, bể nước 720ml Waterproof",58000,63000,5000,8
TIKI,nha-cua-doi-song,114204740,"Bình giữ nhiệt inox 304 Sunhouse 900ml KS-TU900I",149000,225000,76000,34
TIKI,nha-cua-doi-song,199728521,"Bộ lau nhà đa năng Space Saving Sunhouse KS-CL3211PW",310000,450000,140000,31
TIKI,nha-cua-doi-song,14640240,"Cân Điện Tử Nhà Bếp 5kg - Cân Chia Thực Phẩm Nhà Bếp - Cân Tiểu Ly 5kg",90000,135000,45000,33
TIKI,nha-cua-doi-song,68716605,"Dao Làm Bếp Đa Năng Sunhouse KS-KN165KS",74000,117000,43000,37
TIKI,nha-cua-doi-song,185756969,"Cây lau kính đa năng Kitimop-3in1 có thiết kế thông minh gạt chùi kính 3 đầu trong 1, nhỏ gọn tiện lợi hiệu quả",39000,75000,36000,48
TIKI,nha-cua-doi-song,55669191,"Đèn Pixar, Đèn Học Chống Cận Thị, Đèn Đọc Sách, Đèn Làm Việc Để Bàn Chống Chói Mắt Lóa Mắt Bảo Vệ Mắt - Hàng Chính Hãng",250000,250000,0,0
TIKI,nha-cua-doi-song,13309367,"Ổ điện thông minh có 6 phích cắm 3 cổng USB (Giao Màu Ngẫu Nhiên)",44000,44000,0,0
TIKI,nha-cua-doi-song,53518638,"2 Móc Dán Tường Giữ Dây Cắm Điện Phích Cắm Loại Trong Suốt",8950,8950,0,0
TIKI,nha-cua-doi-song,467912,"Máy Khoan Động Lực Bosch GSB 550 550W Set Và Bộ Dụng Cụ 100 Chi Tiết",1710000,2177000,467000,21
TIKI,nha-sach-tiki,49716241,"Tử Vi Hàm Số (Bìa Cứng)",121000,180000,59000,33
TIKI,nha-sach-tiki,178240555,"Tần Số Của Chúng Ta",178000,179000,1000,1
TIKI,nha-sach-tiki,171137376,"SUY TƯỞNG – MARCUS AURELIUS ANTONINUS – TỦ SÁCH TINH HOA -",155000,155000,0,0
TIKI,nha-sach-tiki,195305999,"Giải mã truyện Tây Du",80000,119000,39000,33
TIKI,nha-sach-tiki,26135056,"Bộ 2 cuốn sách về kinh tế hay nhất : Dạy Con Làm Giàu (Tập 1) - Để Không Có Tiền Vẫn Tạo Ra Tiền + Dạy Con Làm Giàu (Tập 2) - Sử Dụng Đồng Vốn (Tặng kèm Bookmark thiết kế AHA)",191500,191500,0,0
TIKI,nha-sach-tiki,42975887,"Nuốt Cá Lớn - Eating The Big Fish",299000,299000,0,0
TIKI,nha-sach-tiki,1667307,"Quân Vương – Thuật Cai Trị (Tái Bản)",69000,109000,40000,37
TIKI,nha-sach-tiki,273636756,"Trạm Đọc Official | Hackers Toeic Vocabulary",209250,279000,69750,25
TIKI,nha-sach-tiki,7440075,"Lâu Đài Trên Mây",71500,96000,24500,26
TIKI,nha-sach-tiki,59362973,"Osho Phụ Nữ - The Book Of Women",77500,109000,31500,29
TIKI,nha-sach-tiki,197587848,"Mỗi Ngày Gửi Cậu Một Cái Ôm",103000,129000,26000,20
TIKI,nha-sach-tiki,196157730,"[QUÀ TẶNG ĐỘC QUYỀN] Combo 10 bông tẩm cồn sát trùng Alcohol Pads - Nhỏ gọn, rất tiện khi sử dụng.",25000,25000,0,0
TIKI,nha-sach-tiki,51215567,"Đồng Tiền Hạnh Phúc",62000,95000,33000,35
TIKI,nha-sach-tiki,105614549,"Khay pha màu 10/14 ngăn Deli - 1 chiếc - 9402 / 9403",10000,10000,0,0
TIKI,nha-sach-tiki,129765498,"Văn Học Kinh Điển - Những Người Phụ Nữ Bé Nhỏ (tặng 2 postcard Tranh Màu + 1 bookmark)",190000,380000,190000,50
TIKI,nha-sach-tiki,145092202,"Túi giấy kraft Nhật trơn có quai đựng thực phẩm nhiều kích thước, túi giấy xi măng đựng quà",1675,1675,0,0
TIKI,nha-sach-tiki,190705657,"Nuôi Dạy Con Theo Phương Pháp Montessori: Em Bé Sơ Sinh Từ 0-1 Tuổi",153000,220000,67000,30
TIKI,nha-sach-tiki,178514167,"Tìm Lại Màu Xanh (Phần Tiếp Theo Của Người Truyền Ký Ức)",84000,108000,24000,22
TIKI,nha-sach-tiki,176824198,"How To Draw – Vẽ Nguệch Ngoạc Cả Thế Giới",103000,139000,36000,26
TIKI,nha-sach-tiki,187933180,"OKR - Phương Pháp Thiết Lập Mục Tiêu Và Quản Lý Công Việc Vượt Trội (Tái Bản 2022)",89800,129000,39200,30
TIKI,nha-sach-tiki,163553056,"Thần Chết Làm Thêm 300 Yên/Giờ (Tái Bản)",77200,105000,27800,26
TIKI,nha-sach-tiki,72744539,"IELTS 15 ACADEMIC",142000,142000,0,0
TIKI,nha-sach-tiki,160371977,"Ăn Tối Cùng Chef Và Nói Chuyện Bếp",98000,170000,72000,42
TIKI,nha-sach-tiki,181131167,"Boxset Nhà Trọ Của Những Điều Đã Mất (3 Cuốn)",89000,90000,1000,1
TIKI,nha-sach-tiki,42877486,"Văn Học Kinh Điển Thế Giới - Peter Pan (Tái Bản)",57000,88000,31000,35
TIKI,nha-sach-tiki,196373994,"Sổ Tay Ghi Chép Bìa Da A5 300 Trang Kẻ Ngang Deli - Phù Hợp Làm Sổ Kế Hoạch Planner, Nhật Kí, Tập Vở Ghi Chép Bullet Journal - EN012 / EN013",106200,106200,0,0
TIKI,nha-sach-tiki,197353392,"Holmes Ở Kyoto - Tập 6",52000,85000,33000,39
TIKI,nha-sach-tiki,134846272,"Education - Kinh Doanh Giáo Dục Tại Thị Trường Việt Nam",164000,220000,56000,25
TIKI,nha-sach-tiki,192048655,"Tớ đã từng sợ hãi",57500,75000,17500,23
TIKI,nha-sach-tiki,31515106,"Đàn Kiến Chăm Chỉ - Ngụ Ngôn Song Ngữ (Tái Bản 2019)",19200,32000,12800,40
TIKI,nha-sach-tiki,152522279,"Phúc Cho Ai Không Thấy Mà Tin - Những Câu Chuyện Nhiệm Mầu Về Hồng Ân Thiên Chúa",61000,88000,27000,31
TIKI,nha-sach-tiki,171549996,"Never Get Bored - Tí Ta Tí Toáy",120000,155000,35000,23
TIKI,nha-sach-tiki,58864689,"Giải Mã Siêu Trí Nhớ",139000,139000,0,0
TIKI,nha-sach-tiki,173135243,"Vòng Đời (Life Cycles)",233000,350000,117000,33
TIKI,nha-sach-tiki,598975,"Dạy Con Làm Giàu 10 - Trước Khi Bạn Thôi Việc",78300,90000,11700,13
TIKI,nha-sach-tiki,182548599,"Dragon Quest - Dấu Ấn Roto (Dragon Quest Saga Emblem Of Roto) Perfect Edition Tập 6 - Tặng Kèm Bookmark PVC",68000,75000,7000,9
TIKI,nha-sach-tiki,184075082,"Học Đàn Piano",90000,125000,35000,28
TIKI,nha-sach-tiki,10971007,"EQ - Trí Thông Minh Xúc Cảm Trong Công Việc",111300,159000,47700,30
TIKI,nha-sach-tiki,106770825,"Bộ 10 bìa bao tập Thiên Long Điểm 10 TP-NBC01",15000,15000,0,0
TIKI,nha-sach-tiki,134605012,"15 Nguyên Tắc Vàng Về Phát Triển Bản Thân (Tái Bản)",103820,179000,75180,42
TIKI,nha-sach-tiki,22881666,"Mindset For IELTS - Foundation Student's Book With Testbank And Online Modules",367350,395000,27650,7
TIKI,nha-sach-tiki,146272575,"Ăn Ít Để Khỏe - 1 Bữa Là Đủ Sao Phải Cần 3 (Tái Bản 2021)",92900,119000,26100,22
TIKI,nha-sach-tiki,194206884,"Frugal Innovation - Làm tốt hơn với nguồn lực ít hơn",141000,220000,79000,36
TIKI,nha-sach-tiki,173425949,"Khung ảnh để bàn nhiều kích thước, khung ảnh trong suốt Anzzar loại 2.5cm",47000,55000,8000,15
TIKI,nha-sach-tiki,73116944,"Combo 20 cuốn - Bé Tô màu - Luyện chữ (Mầm non - Chuẩn bị vào lớp 1)",99272,190907,91635,48
TIKI,nha-sach-tiki,34750340,"Ngụ Ngôn Song Ngữ Anh - Việt: Đừng Tin Lời Gã Cáo (Tái Bản 2019)",16800,28000,11200,40
TIKI,nha-sach-tiki,195661677,"Tư Duy Sâu, Ý Tưởng Bén, Sáng Tạo Thần Sầu",139000,139000,0,0
TIKI,nha-sach-tiki,181699596,"Jesse Livermore - Nhà Đầu Tư Chứng Khoán Vĩ Đại",152000,219000,67000,31
TIKI,nha-sach-tiki,35410612,"Combo Sách Tư Duy - Kỹ Năng Sống Ai Cũng Cần Phải Có : Cân Bằng Cảm Xúc, Cả Lúc Bão Giông + Nóng Giận Là Bản Năng , Tĩnh Lặng Là Bản Lĩnh ( Tặng Kèm Bookmark Green Life)",163500,163500,0,0
TIKI,nha-sach-tiki,170298040,"Những Ý Tưởng Lớn Của Lý Quang Diệu",79000,120000,41000,34
TIKI,nha-sach-tiki,74307132,"Arty Mouse - Đồ Theo Nét (Học Tập Đầu Đời Thông Qua Mỹ Thuật)",41700,45000,3300,7
TIKI,nha-sach-tiki,121236564,"PHÂN TÍCH MẪU HÌNH BIỂU ĐỒ - Những Bí Quyết Giúp Nhà Giao Dịch Siêu Hạng DAN ZANGER Biến 11 Nghìn Đô Thành 42 Triệu Đô Trong 23 Tháng",348000,348000,0,0
TIKI,nha-sach-tiki,70540568,"Nuôi Dạy Bé Gái Từ 0 Đến 6 Tuổi (Tái Bản 2020)",52000,75000,23000,31
TIKI,nha-sach-tiki,173515430,"Khám Phá Vận Mệnh - 7 Bước Đánh Thức Bản Thân",82900,145000,62100,43
TIKI,nha-sach-tiki,72470133,"Bộ Cọ Tròn 6 Cây Chuyên Dụng Cao Cấp Để Tô Vẽ Tranh Sơn Dầu, Màu Nước, Màu Acrylic, Vẽ Nghệ Thuật",45000,59000,14000,24
TIKI,nha-sach-tiki,19274771,"Chuỗi Án Mạng A.B.C (Tái Bản)",62100,105000,42900,41
TIKI,nha-sach-tiki,157054867,"Tôi Muốn Giỏi Tiếng Anh Nhưng Tôi Không Muốn Chăm Chỉ",145000,210000,65000,31
TIKI,nha-sach-tiki,272588674,"Giấy Photo, giấy in Samsung A4/70gsm - 500 tờ/ream",78000,78000,0,0
TIKI,nha-sach-tiki,273119845,"Ông Trùm Cuối Cùng (Mario Puzo)",99000,150000,51000,34
TIKI,nha-sach-tiki,13116553,"Thị Trấn Mèo Tập 1 (Tái Bản 2019)",62000,68000,6000,9
TIKI,nha-sach-tiki,593709,"Góc Khuất Đàn Bà - Bản Thông Thường",66300,89000,22700,26
TIKI,nha-sach-tiki,173973552,"Sách Từ Vựng Tiếng Anh : Từ Cùng Trường Nghĩa Trong Tiếng Anh Cô Trang Anh",149000,200000,51000,26
TIKI,nha-sach-tiki,16422526,"365 Chuyện Kể Trước Giờ Đi Ngủ - Những Câu Chuyện Phát Triển Chỉ Số Tình Cảm EQ (Tái Bản)",55000,78000,23000,29
TIKI,nha-sach-tiki,168559528,"Chiêm Tinh Học For Dummies",171000,249000,78000,31
TIKI,nha-sach-tiki,91343895,"Những Sự Thật Về Ung Thư - Hiểu Thêm Để Bớt Lo",74100,105000,30900,29
TIKI,nha-sach-tiki,195541265,"Bài Tập Thực Hành Tiếng Anh 7 (Có Đáp Án) - Dùng Kèm SGK Tiếng Anh 7 GLOBAL SUCCESS",64000,65000,1000,2
TIKI,nha-sach-tiki,34751670,"Ngụ Ngôn Song Ngữ Anh - Việt: Đôi Sừng Hươu (Tái Bản 2019)",19200,32000,12800,40
TIKI,nha-sach-tiki,182735416,"Pet Sematary - Nghĩa địa thú cưng - 1980books",209300,299000,89700,30
TIKI,nha-sach-tiki,109982974,"Alfred Nobel Và Bản Di Chúc Bất Hủ",51500,65000,13500,21
TIKI,nha-sach-tiki,10675287,"EAT CLEAN Thực Đơn 14 Ngày Thanh Lọc Cơ Thể Và Giảm Cân",105000,149000,44000,30
TIKI,nha-sach-tiki,146502516,"[Hàng Cao Cấp Loại Dày 2mm] Băng Dính 2 Mặt Đa Năng Trong Suốt Siêu Dày 2mm – Chọn Chiều Dài – Siêu Bám Dính - Băng Keo Trong Suốt Chính Hãng dododios",29000,29000,0,0
TIKI,nha-sach-tiki,1029852,"Tuần Của Bé - Bé Thân Thiện (Dành Cho Trẻ 3 - 6 Tuổi)",21850,23000,1150,5
TIKI,nha-sach-tiki,115078652,"Huấn Luyện Cảm Xúc Để Con Trẻ Phát Triển Toàn Diện",152000,198000,46000,23
TIKI,nha-sach-tiki,77323488,"Chatter - Trò Chuyện Với Chính Mình",128000,199000,71000,36
TIKI,nha-sach-tiki,74235036,"Điều Kỳ Diệu của Thái Độ Sống (Tái Bản)",44100,58000,13900,24
TIKI,nha-sach-tiki,14683083,"Nhượng Quyền Khỏi Nghiệp - Con Đường Ngắn Để Bước Ra Thế Giới (Tái Bản)",112000,112000,0,0
TIKI,nha-sach-tiki,173878382,"Bảng Từ Trắng Viết Bút Lông Deli - Bảng Mica Hít Nam Châm Nhiều Kích Cỡ - Có Khay Đựng - Phù Hợp Học Sinh Văn Phòng - EV450 / EV600 / EV900",199000,405000,206000,51
TIKI,nha-sach-tiki,41556498,"Tác Phẩm Kinh Điển: Thiên Tài Bên Trái, Kẻ Điên Bên Phải / Sách Văn Học Hay (Tặng Kèm Bookmark Thiết Kế Bookmark Happy Life)",163250,163250,0,0
TIKI,nha-sach-tiki,186290800,"Đón Ngọn Triều Dâng",76600,130000,53400,41
TIKI,nha-sach-tiki,22881827,"Complete IELTS B1 Student's Book with answer with CD-ROM",259470,279000,19530,7
TIKI,nha-cua-doi-song,144752155,"Khăn lau đa năng H600 Khăn lau tay bát đĩa nhà bếp vải mềm mịn thấm nước siêu nhanh tiện lợi an toàn",1700,1700,0,0
TIKI,nha-cua-doi-song,58002786,"Vòi bơm dây dẫn nước rửa chén gắn chậu rửa Hobby home decor NRC2 đầu bơm inox 304 có van 1 chiều gắn chai nước rửa chén",205000,279000,74000,27
TIKI,nha-cua-doi-song,35905855,"Cây Lau Nhà Pva Lock&Lock ETM481 - PP, 33 x 6 x 132 cm - Màu Trắng",280000,539000,259000,48
TIKI,nha-cua-doi-song,3677799,"Hộp 6 Lõi  Lọc Nước BRITA Maxtra Plus Filter Cartridge",1849000,1849000,0,0
TIKI,nha-cua-doi-song,195852183,"Bình giữ nhiệt bằng thép không gỉ LocknLock Jumbo Tumbler LHC4300NVY 900ML",438000,730000,292000,40
TIKI,nha-cua-doi-song,48510374,"Combo 300 Túi Lọc Rác Siêu Tiện dụng cho Bồn rửa Chén bát",129000,200000,71000,36
TIKI,nha-cua-doi-song,71111080,"Kệ Để Giày Dép Inox 5 Tầng Chính Hãng Amalife, Giá Để Giày Inox 5 Tầng - Chọn Màu",99000,99000,0,0
TIKI,nha-cua-doi-song,51476716,"Bộ 10 đôi đũa inox 304 - 316 DandiHome 2020 chống trơn trượt, sang trọng, tinh tế",300000,300000,0,0
TIKI,nha-cua-doi-song,193433927,"Đèn Bàn Học Led Đọc Sách Làm Việc Học Tập Bảo Vệ Mắt Chống Cận - 2 Trục Đèn Chiếu Sáng - Gấp Gọn Tiện Lợi",569000,699000,130000,19
TIKI,nha-cua-doi-song,696495,"Ổ Cắm Điện 4 Lỗ 3 Chấu 3m Philips SPN1348WB/74 (2500W)",328000,369000,41000,11
TIKI,nha-cua-doi-song,69929041,"Móc Treo Quần Áo, Móc Phơi Đồ Trẻ Em Inox Kẹp Chống Rơi, Móc Treo Tất, Vớ, Đồ Lót Nhiều Kiểu Dáng",35000,35000,0,0
TIKI,nha-cua-doi-song,210760574,"Cây lau nhà tự vắt thông minh sợi microfiber",209000,209000,0,0
TIKI,nha-cua-doi-song,109654810,"Bình xịt tưới cây MONROVIA 2 lít, phun sương tưới cây cảnh, vòi dài, tặng vòi ngắn, màu xanh, tiêu chuẩn Châu Âu",169000,169000,0,0
TIKI,nha-cua-doi-song,54130086,"Cây lau nhà tự vắt thông minh đa năng cao cấp Parroti Magic MG01 - Tặng 1 Miếng Lau",229000,349000,120000,34
TIKI,nha-cua-doi-song,155794592,"Kệ lò vi sóng đa năng Thép Carbon cao cấp Vando, kệ để đồ nhà bếp siêu chịu lực 300kg sơn tĩnh điện chống bong tróc, kệ nhà bếp",899000,1427000,528000,37
TIKI,nha-cua-doi-song,51662145,"Keo dán siêu dính X2000 (50g) dán gỗ, sắt, sứ, kim loại đa năng",18000,46900,28900,62
TIKI,nha-cua-doi-song,137671794," Cân Tiểu Ly Nhà Bếp Chống Nước Cao Cấp Khoảng Chính Xác 1g - 5kg ",165000,295000,130000,44
TIKI,nha-cua-doi-song,87873126,"Áo Mưa Bộ Vải Dù, Bộ Quần Áo Mưa Có Phản Quang Đủ Size, Chống Thấm Hiệu Quả, Phù Hợp Nam Và Nữ, Có Túi Đựng, Có Lựa Chọn Màu Sắc",150000,150000,0,0
TIKI,nha-cua-doi-song,52885368,"1 Kg túi zip chỉ đỏ thương hiệu Gimex II",69000,69000,0,0
TIKI,nha-cua-doi-song,7114709,"Đèn Pin Đội Đầu Sunhouse Cỡ Nhỏ She 5012",62000,99000,37000,37
TIKI,nha-cua-doi-song,58828647,"Xe đẩy hàng 4 bánh SUMIKA T150 - Khung thép, tay cầm gấp mở tiện lợi, tải trọng 150kg",880000,1350000,470000,35
TIKI,nha-cua-doi-song,141246639,"Hộp giữ nhiệt đựng đồ ăn có tay cầm Handle Food Jar LocknLock 700ml LHC8042NVY - Màu",416000,800000,384000,48
TIKI,nha-cua-doi-song,41430891,"Ổ Khóa 4 Số Có Đổi Mã Chữ U ZR-01",68000,96000,28000,29
TIKI,nha-cua-doi-song,71999229,"Nồi Inox 3 Lớp Đáy Liền Elmich Trimax Classic 2408OL",700000,990000,290000,29
TIKI,nha-cua-doi-song,85029598,"Ổ cắm Điện Quang ĐQ 002A-02 (3 lỗ)",95000,95000,0,0
TIKI,nha-cua-doi-song,54686184,"Bạt Áo Trùm Máy Giặt Cửa Trên, Cửa Ngang Vải Dù Siêu Dày, Chống Thấm Nước, Không Phai Màu - (Giao Màu - Họa Tiết Ngẫu Nhiên)",99999,99999,0,0
TIKI,nha-cua-doi-song,35058677,"Vỉ 5 Viên Pin CR1632 ( CR 1632/5BE x 1 Vỉ ) Panasonic Lithium 3 V - Hàng Chính Hãng",87000,100000,13000,13
TIKI,nha-cua-doi-song,578967,"Chảo Đá Chống Dính Siêu Bền Sunhouse SBD28 28cm",273000,430000,157000,37
TIKI,nha-cua-doi-song,51554889,"Ron Dán Che Khe Cửa ,Chân Cửa Chống Gió Lùa, Chống Bụi Và Chống Côn Trùng - Hàng Chính Hãng Cuộn 2m",40000,52000,12000,23
TIKI,nha-cua-doi-song,208413993,"Bàn Làm Việc Phong Cách Bắc Âu Thương Hiệu IGEA (Không Bao Gồm Ghế)",275500,290000,14500,5
TIKI,nha-cua-doi-song,45300792,"Đồng hồ báo thức điện tử để bàn màn hình đa chức năng thời gian, lịch, báo thức, nhiệt độ DH89",50900,50900,0,0
TIKI,nha-cua-doi-song,19719366,"Võng dù 2 lớp BAN MAI, gọn nhẹ 230x145 cm, nặng 600gr (Giao màu ngẫu nhiên)",129000,150000,21000,14
TIKI,nha-cua-doi-song,48055150,"Thảm Lau Chân Chống Trượt Siêu Thấm 40x60cm",93000,186000,93000,50
TIKI,nha-cua-doi-song,55365176,"0.5kg túi zipper chỉ đỏ đựng thực phẩm",39000,39000,0,0
TIKI,nha-cua-doi-song,114789036,"Vòi Dẫn Nước Rửa Chén Bộ Đầu Vòi Dẫn Bơm Hút Xịt Nước Rửa Chén Dầu Rửa Bát Gắn Bồn Rửa Bát",59596,59596,0,0
TIKI,nha-cua-doi-song,56880195,"Bình nước Lock&Lock Eco Bottle ABF664BLU 750ml - Màu",145000,242000,97000,40
TIKI,nha-cua-doi-song,134582052,"ĐỆM TRẢI SÀN, NỆM, TOPPER HÀNG XUẤT NHẬT",242000,269900,27900,10
TIKI,nha-cua-doi-song,178068438,"Khăn giấy cuộn đa năng, lau bếp, lau kính, chén bát, lau tay (50 khăn/cuộn, 25cm x25cm) - Parroti Bingo NG01",38900,78000,39100,50
TIKI,nha-cua-doi-song,217714140,"Móc Dán Tường INOX 304 Treo Đồ nặng, Treo Thớt, Nồi Niêu Treo Đồ Đa Năng [CHỐNG NƯỚC, CHỐNG RỈ] Dán Mọi Bề Mặt",15000,15000,0,0
TIKI,nha-cua-doi-song,161225352,"Miếng dán đỡ kệ gỗ, chia ngăn tủ, không cần đóng đinh",22000,22000,0,0
TIKI,nha-cua-doi-song,11203853,"Bộ 10 đinh treo tranh, mắc màn loại 4 chân",13992,13992,0,0
TIKI,nha-cua-doi-song,110756858,"Set 200 Găng Tay Nilon Trong Suốt Sử Dụng Một Lần Tiện Lợi ",18394,18394,0,0
TIKI,nha-cua-doi-song,41886085,"Túi Đựng Ly Giữ Nhiệt Lớn 900ml - Nhiều Hoa Văn",40000,40000,0,0
TIKI,nha-cua-doi-song,54122078,"Pin AAAA Energizer E96 BP2",67000,80000,13000,16
TIKI,nha-cua-doi-song,63133571,"Mền lông cừu xanh dương đậm cao cấp A - 1m8x2m",165000,180000,15000,8
TIKI,nha-cua-doi-song,22081865,"TÚI ÁO BÌNH GIỮ NHIỆT TIỆN LỢI",40000,40000,0,0
TIKI,nha-cua-doi-song,16166750,"ÁO MƯA BIT CƠ BẢN",85000,85000,0,0
TIKI,nha-cua-doi-song,1453915,"Ly Giữ Nhiệt Bằng Thép Không Gỉ Lock&Lock Clip Tumbler LHC4151BLK (540ml) - Đen",304000,506000,202000,40
TIKI,nha-cua-doi-song,146887829,"Đèn Pixar, Đèn Bàn Học Chống Cận Thị, Đèn Đọc Sách LED, Đèn Làm Việc Bảo Vệ Mắt, đèn học để bàn, đèn học cho học sinh sinh viên, đèn trang trí decor - Hàng Chính Hãng dododios",148000,148000,0,0
TIKI,nha-cua-doi-song,54485029,"Đèn Bàn Học Đọc Sách LED Chống Cận 03 Chế Độ Ánh Sáng Bảo Vệ Mắt Có Hộp Bút Và Giá Để Điện Thoại eLights",179000,220000,41000,19
TIKI,nha-cua-doi-song,153291977,"Băng Keo Chống Thấm, Chống Dột Dán Siêu Dính Trên Mọi Bề Mặt, Dán Mái Tôn, Dán Tường, Dán Ống Nước - PucaMart",13000,18999,5999,32
TIKI,nha-cua-doi-song,76046302,"Móc treo quần áo gắn sau cánh cửa tử HOBBY MTGC Nice Day 6 chấu - 2 màu tùy chọn",28000,79000,51000,65
TIKI,nha-cua-doi-song,51105287,"Bộ 4 ống hút Inox 304 kèm cọ rửa DandiHome",33000,39000,6000,15
TIKI,nha-cua-doi-song,3677797,"Hộp 3 Lõi Lọc Nước BRITA Maxtra Plus Filter Cartridge",599000,949000,350000,37
TIKI,nha-cua-doi-song,86376338,"Đèn ngủ Oval cắm điện 10 cấp độ sáng có remote - đèn ngủ thông minh - hẹn giờ - 2 cổng USB sạc nhanh mới 2021",99000,99000,0,0
TIKI,nha-cua-doi-song,146384829,"Ghế xoay văn phòng công thái học ergonomic có ngả lưng Premium 02, ghế xoay Gaming cao cấp nhập khẩu",1064000,2490000,1426000,57
TIKI,nha-cua-doi-song,55875210,"Tủ Vải Đựng Đồ Khung Thép Chịu Lực, Túi Đựng Chăn Màn Quần Áo miDoctor Tiện Lợi - Giao Màu Ngẫu Nhiên",88000,89000,1000,1
TIKI,nha-cua-doi-song,130767592,"Ổ cắm Điện Quang ĐQ ESK 5W. SM740SL (4 lỗ 3 chấu dây 5 mét màu Trắng Đỏ)",158480,198100,39620,20
TIKI,nha-cua-doi-song,81936300,"BIG SIZE -Túi Đựng Quần Áo Khung Thép 88L: 60x40x35 (cm) Morning House- Gấp gọn tiện lợi, bảo quản quần áo bền đẹp",88000,88000,0,0
TIKI,nha-cua-doi-song,77448059,"Cốc giữ nhiệt LocknLock LHC4247PIK Table Mug 473ml",252000,484000,232000,48
TIKI,nha-cua-doi-song,655378,"Đèn Tích Điện Đa Năng 360 Cỡ Trung Sunhouse SHE-6848LA - Trắng",201000,331000,130000,39
TIKI,nha-cua-doi-song,165346784,"Khăn gội sợi tre Bamboo&Love 35x75cm mềm mại kháng khuẩn siêu thấm hút an toàn cho da ngay cả với trẻ sơ sinh",34900,58000,23100,40
TIKI,nha-cua-doi-song,52006431,"Hộp đựng thìa đũa cá nhân DandiHome (màu ngẫn nhiên)",26500,30000,3500,12
TIKI,nha-cua-doi-song,48175867,"KỆ TRANG TRÍ VUÔNG 2 TẦNG - CAO 50CM x DÀI 35CM x RỘNG 35CM ",150000,150000,0,0
TIKI,nha-cua-doi-song,162112460,"Thùng Rác Tròn Chân Đạp 6l Phù Hợp Văn Phòng, Gia Đình, Phòng Bếp Tiện Nghi Sang Trọng",129000,129000,0,0
TIKI,nha-cua-doi-song,191820658,"Gối Cao Su Thiên Nhiên Gummi Cookie Thiết Kế Vòm Cong Tối Ưu Giúp Giảm Đau Cổ Vai Gáy Vượt Trội",489000,720000,231000,32
TIKI,nha-cua-doi-song,90523892,"Ly Giữ Nhiệt Lock&Lock Energetic One Touch Tumbler LHC3249 (550ml) - Hàng Chính Hãng, Bằng Thép Không Gỉ Inox 316L, Nắp Mở Một Chạm, Tặng Ống Hút Và Cọ Rửa",289000,488000,199000,41
TIKI,nha-cua-doi-song,272453821,"[Tặng Bông Lau] Bộ Lau Nhà MyJae Đài Loan Sợi Microfiber Xoay Siêu Tốc 360 Độ Thông Minh 129.5cm",699000,990000,291000,29
TIKI,nha-cua-doi-song,466737,"Hộp Cơm Cắm Điện - Hộp Hâm Nóng Văn Phòng 2 Tầng Life360 EL-ALS263 (Tím) - Hàng Chính Hãng",456000,749000,293000,39
TIKI,nha-cua-doi-song,7635008,"Bộ 2 cuộn túi hút chân không một mặt nhám rộng",60000,60000,0,0
TIKI,nha-cua-doi-song,32178097,"Chảo Sâu Lòng NAG2653 Đáy Từ 5 Lớp Chống Dính Vung Kính Siêu Bền Nagakawa (26cm) - Dùng Trên Mọi Loại Bếp - Hàng Chính Hãng",333000,585000,252000,43
TIKI,nha-cua-doi-song,74598515,"Đệm ngồi 3D Silicon cao cấp thoáng khí chống đau mỏi - Hàng nhập khẩu",149000,149000,0,0
TIKI,nha-cua-doi-song,53307149,"Bộ tua vít đa năng sửa chữa điện thoại 25 in 1 vít từ tính chất liệu cao cấp S2",38880,38880,0,0
TIKI,nha-cua-doi-song,139562345,"Khăn mặt khô  Animerry dùng 1 lần lau khô, lau ướt - Giấy lau mặt dùng một lần",13000,22000,9000,41
TIKI,nha-cua-doi-song,73529777,"Kệ chén bát đa năng bằng thép carbon không gỉ, chống xước, sơn đen tĩnh điện, giá bát trên bồn rửa ráo nước cho nhà bếp sạch sẽ VANDO",319000,349000,30000,9
TIKI,nha-cua-doi-song,72904497,"Kệ Nhà Tắm Kèm Nhả Kem Đánh Răng Tự Động 2 Cốc OENON Lắp Đặt Dán Tường - OEKEM",159000,300000,141000,47
TIKI,nha-cua-doi-song,27609461,"Dụng cụ thông tắc bồn cầu, cống bằng khi nén áp lực siêu mạnh",185000,185000,0,0
TIKI,nha-cua-doi-song,193709920,"Bình Đựng Nước 1L Bao Bì Dễ Thương Có Vạch Báo Giờ Uống Nước Chia Lượng Nước Deli - Nhựa Cao Cấp An Toàn Đầy Đủ Kiểm Định Chất Lượng Phủ Hợp Bình Nước Thể Thao Cho Bé Tới Trường - VS822 VS823",99000,178200,79200,44
TIKI,nha-cua-doi-song,54483857,"Đèn Bàn Học Đọc Sách, Làm Việc (Học Sinh, Sinh Viên, Văn Phòng) LED Chống Cận, Cảm Ứng Tích Điện Pin 2500mAh Elights BT-618",49000,49000,0,0
TIKI,nha-cua-doi-song,197412247,"[ TikiNow giao hàng ] Ghế chỉnh dáng ngồi đúng Roichen - Hàn Quốc. Sản phẩm dành cho Nam. Nhập khẩu Hàn Quốc (Made in Korea). Hàng chính hãng Roichen",785000,898000,113000,13
TIKI,nha-sach-tiki,4319337,"Tạo Dựng Thương Hiệu Cá Nhân",76300,109000,32700,30
TIKI,nha-sach-tiki,148802195,"How We’Re F***Ing Up Our Planet - Ta Đang Hủy Diệt Trái Đất Như Thế Nào",253000,330000,77000,23
TIKI,nha-sach-tiki,186578233,"Trúc thư dao 2 (Nước Tấn - Gió nổi cung đình)",173000,219000,46000,21
TIKI,nha-sach-tiki,8128223,"Lột xác để trở thành nhà đầu tư giá trị - The education of a value investor",268000,268000,0,0
TIKI,nha-sach-tiki,154245459,"Nghiền Từ Vựng Tiếng Anh - Học Qua Gốc Từ Bằng Hình Ảnh - Gốc Từ Là Bí Quyết Để Ghi Nhớ Hàng Nghìn Từ Vựng - Quyển 1",89000,135000,46000,34
TIKI,nha-sach-tiki,163297416,"My Hero Academia - Học Viện Siêu Anh Hùng Tập 3: All Might (Tái Bản)",25000,25000,0,0
TIKI,nha-sach-tiki,110649726,"Hành Trình Thức Tỉnh ",229000,229000,0,0
TIKI,nha-sach-tiki,172160196,"Thấu Hiểu Marketing Bệnh Viện",249000,249000,0,0
TIKI,nha-sach-tiki,14684312,"Dấn Thân (Tái Bản)",75000,112000,37000,33
TIKI,nha-sach-tiki,105837988,"Hộp 22 gôm tẩy học sinh Deli - Hình dáng ngộ nghĩnh đáng yêu - 71055 / 71054",59400,59400,0,0
TIKI,nha-sach-tiki,82072617,"Các Lỗi Thường Gặp Trong Tiếng Anh",51500,80000,28500,36
TIKI,nha-sach-tiki,63924629,"Tạp Văn Nguyễn Ngọc Tư (Tái Bản Lần Thứ 20-2020)",62000,90000,28000,31
TIKI,nha-sach-tiki,427631,"Tầm Nhìn Thay Đổi Quốc Gia",186000,268000,82000,31
TIKI,nha-sach-tiki,145977554,"Combo 2 Cuốn: Thần Số Học + Thần Số Học Ứng Dụng",242300,348000,105700,30
TIKI,nha-sach-tiki,273718791,"Sapiens: Lược Sử Loài Người",224000,299000,75000,25
TIKI,nha-sach-tiki,49252204,"Dạy Con Làm Giàu - Tập 12: Lời Tiên Tri Của Người Cha Giàu (Tái Bản)",98200,160000,61800,39
TIKI,nha-sach-tiki,147964307,"COMBO SÁCH PHÙ HỢP MỌI THỂ LOẠI ĐẦU TƯ – KỸ THUẬT KHÓ CHẲNG LO",428000,428000,0,0
TIKI,nha-sach-tiki,194103341,"Bột Nước Muối Men: Nền tảng của bánh mỳ và pizza thủ công",232000,360000,128000,36
TIKI,nha-sach-tiki,714023,"Ngụ Ngôn E Dốp - Văn Học Cổ Điển Hi Lạp",58800,98000,39200,40
TIKI,nha-sach-tiki,188930498,"Người Bà Tài Giỏi Vùng Saga – Tập 6",40500,52000,11500,22
TIKI,nha-sach-tiki,75454261,"Stay Positive - Sống Tích Cực, Đời Hết Bực - Bí Quyết Sống Vui Mỗi Ngày",99000,120000,21000,18
TIKI,nha-sach-tiki,82996527,"Tinh Thần Chiến Đấu Rực Lửa",66500,95000,28500,30
TIKI,nha-sach-tiki,19948893,"Chạm Tay Hóa Vàng (Tái Bản)",77000,125000,48000,38
TIKI,nha-sach-tiki,47323978,"Quick Quick Học Nhanh Toàn Diện Từ Vựng Tiếng Anh Theo Chủ Đề Lớp 1",66000,89000,23000,26
TIKI,nha-sach-tiki,191926658,"Trái cây đại chiến Zombie - Thế giới khủng long: Tập 10 - Vương quốc ngủ say",58000,89000,31000,35
TIKI,nha-sach-tiki,196394987,"Hai Ta Trên Đường Kẻ Cuộc Đời",98400,109000,10600,10
TIKI,nha-sach-tiki,730723,"Tuần Của Bé Tháng 7- Bé Tự Tin",11500,23000,11500,50
TIKI,nha-sach-tiki,186265472,"Thế Giới Của Truyện Nôm",112000,170000,58000,34
TIKI,nha-sach-tiki,107576379,"Sổ tay học sinh Destination B1,B2,C1&2",118500,118500,0,0
TIKI,nha-sach-tiki,191782142,"Điều Vĩ Đại Đời Thường",63000,92000,29000,32
TIKI,nha-sach-tiki,193896500,"How Yoga Works: Bí mật Yoga",171900,239000,67100,28
TIKI,nha-sach-tiki,273714602,"Trạm Đọc | Thuật Tẩy Não - Nghệ Thuật Thao Túng Và Kiểm Soát Tâm Lý Đối Phương",141000,189000,48000,25
TIKI,nha-sach-tiki,192833921,"Combo 2 Sách: Tiếng Anh Cho Người Mới Bắt Đầu và Tổng Ôn Ngữ Pháp Tiếng Anh Cô Trang Anh",328000,400000,72000,18
TIKI,nha-sach-tiki,273568395,"Husky Và Sư Tôn Mèo Trắng Của Hắn (Tập 2)",111000,169000,58000,34
TIKI,nha-sach-tiki,190238358,"Nhặt Sao - Bản Thường - (Tặng kèm 1 bookmark in 2 mặt)",161000,179000,18000,10
TIKI,nha-sach-tiki,189557421,"Blog Writing - Sống với nghề viết blog",216000,250000,34000,14
TIKI,nha-sach-tiki,644081,"Đường Về",52000,70000,18000,26
TIKI,nha-sach-tiki,7982626,"Thế Giới Phẳng (Tái Bản)",162000,310000,148000,48
TIKI,nha-sach-tiki,111537683,"Và Rồi Chẳng Còn Ai (Agatha Christie)",64200,110000,45800,42
TIKI,nha-sach-tiki,58165559,"Ngữ Pháp Tiếng Hàn Thông Dụng - Sơ Cấp",160000,250000,90000,36
TIKI,nha-cua-doi-song,84699481,"Đèn Bàn Học Đọc Sách Làm Việc LED Chống Cận Bảo Vệ Mắt – Cảm Ứng Tích Hợp Sạc Không Dây - Vùng Sáng 3000-6500K – 5 Cấp Độ Điều Chỉnh – Phiên Bản Nâng Cấp Cổng Type-C",649000,799000,150000,19
TIKI,nha-cua-doi-song,73116895,"Găng tay nướng bánh cách nhiệt Baking Gloves ",50000,50000,0,0
TIKI,nha-cua-doi-song,113458874,"Tủ Để Đồ Thông Minh S Smart Tận Dụng Không Gian Cạnh Cửa Sổ - GP131",406000,444000,38000,9
TIKI,nha-cua-doi-song,14981747,"01 hộp đũa Inox 304 cao cấp DandiHome (10 đôi) - Cá chép vượt cổng Vũ Môn",300000,300000,0,0
TIKI,nha-cua-doi-song,25412653,"Cây lăn bụi quần áo đa năng kèm 2 cục dự phòng",13000,18000,5000,28
TIKI,nha-cua-doi-song,100522012,"Cây Lau Nhà Thông Minh, Chổi Lau Nhà 360 Độ Đa Năng (Không Bao Gồm Thùng Vắt) - Parroti MOP-PR01",209000,269000,60000,22
TIKI,nha-cua-doi-song,174378686,"Miếng gảy đàn, Pick - Alice AP-ALT - Dành cho Guitar, Ukulele, Bass - Dày 0.46mm, Colorful Celluloid - Màu ngẫu nhiên - Hàng chính hãng",14000,14000,0,0
TIKI,nha-cua-doi-song,10017811,"Súng bắn keo nến 20w +Tặng 10 cây keo nến ",44300,44300,0,0
TIKI,nha-cua-doi-song,579928,"Chảo Sâu Chống Dính Sunhouse SHS20 20cm",130000,180000,50000,28
TIKI,nha-cua-doi-song,199581980,"Kệ Sách Gỗ Để Bàn Thương Hiệu IGA - GP62",100000,109000,9000,8
TIKI,nha-cua-doi-song,54476660,"Đèn Bàn Học Đọc Sách, Làm Việc (Học Sinh, Sinh Viên, Văn Phòng) Cao Cấp Kẹp Bàn – 03 Mức Độ Ánh Sáng Vàng Bảo Vệ Mắt Chống Cận Pin 2500 mAh",149000,149000,0,0
TIKI,nha-cua-doi-song,51530502,"GƯƠNG KỆ ĐỨNG KHUNG GỖ HÀN QUỐC - MIRROR SHELF - D41 X R35 X C160 - 2 MÀU LỰA CHỌN",415000,420000,5000,1
TIKI,nha-cua-doi-song,72332230,"GỐI CHỮ U CAO SU NON - GỐI TỰA CỔ CHO DÂN VĂN PHÒNG, LÁI XE, DU LỊCH",99000,99000,0,0
TIKI,nha-cua-doi-song,477936,"Lõi Lọc Kova-Barrier Tiêu Chuẩn - FC-STD",183000,235000,52000,22
TIKI,nha-cua-doi-song,31206755,"Hộp 40 viên pin Maxell AAA",122000,130000,8000,6
TIKI,nha-cua-doi-song,146509745,"Bộ Hộp Cơm Giữ Nhiệt Văn Phòng Cao Cấp Cắm Điện inox 3 tầng - Chính hãng dododios",189000,189000,0,0
TIKI,nha-cua-doi-song,63821690,"Vòi Lavabo lạnh - 01 đường nước - tay gật gù Yamato cao cấp",169000,200000,31000,16
TIKI,nha-cua-doi-song,195968874,"Đèn LED Mini Móc Khóa Siêu Sáng Tiện Dụng US ARMY,  Đèn Pin COB Dã Ngoại Thường Ngày, Sạc TYPE-C Tiện Dụng Dung Lượng PIN 500mAh  Full Hộp Sạc- HÀNG CHÍNH HÃNG",63000,178000,115000,65
TIKI,nha-cua-doi-song,579854,"Nồi Nấu Bột Chống Dính Nắp Kính Sunhouse SHG-MP14 14cm",122000,180000,58000,32
TIKI,nha-cua-doi-song,70820849,"Pin CR2032 Energizer 3V vỉ 5 viên",59000,100000,41000,41
TIKI,nha-cua-doi-song,51541280,"Hộp Cơm Cắm Điện - Hộp Hâm Nóng Văn Phòng 2 Tầng ArirangLife EL-ALS263 (Hồng) - Hàng chính hãng",455000,749000,294000,39
TIKI,nha-cua-doi-song,105717965,"Bình Giữ Nhiệt 2GOOD FLASK WM-02 Sport Lid (946ml) - Hàng Chính Hãng",399000,399000,0,0
TIKI,nha-cua-doi-song,80901951,"Kéo Nhật Nội Địa SK5 Siêu Sắc, Kéo Nhà Bếp, Kéo Cắt Gà, Cắt Vịt, Cắt Thịt Các Loại",79000,79000,0,0
TIKI,nha-cua-doi-song,88241130,"Khăn trải bàn nhựa PVC không thấm nước, khăn trai bàn có hoạ tiết đẹp phù hợp với mọi nhà",55000,55000,0,0
TIKI,nha-cua-doi-song,241805597,"Móc Dán Tường, Móc Dính Tường Treo Đồ Nặng Siêu Dính Inox 304 - Treo Thớt, Nồi Niêu Xong Chảo, Treo Đồ Đa Năng",12000,12000,0,0
TIKI,nha-cua-doi-song,172447892,"Bộ 6 túi giặt siêu dày 3 lớp cao cấp - Combo 6 túi lưới bảo vệ quần áo dùng cho máy giặt siêu bền tiện dụng chính hãng",165000,250000,85000,34
TIKI,nha-cua-doi-song,120470943,"Bình Nước Thuỷ Tinh Luminarc Bucolique 1.3L - LUBIN1806 ",136000,136000,0,0
TIKI,nha-cua-doi-song,143217219,"Kệ Đa Năng Lưu Trữ Đồ Dùng, Giá Sách Có Bánh Xe Thương Hiệu IGA - GP173",293000,318000,25000,8
TIKI,nha-cua-doi-song,59047203,"Bộ 10 đầu tưới nắp chai nhỏ giọt tự động thông minh có điều chỉnh ( tưới hoa, cây cảnh )",29000,29000,0,0
TIKI,nha-cua-doi-song,17000892,"Ô gấp gọn chống tia UV ",35000,35000,0,0
TIKI,nha-cua-doi-song,274121764,"Ruột Gối Ôm Gòn Cozy Thuần Việt - Sợi Gòn Cao Cấp, Êm Ái - Kích Thước 20x100",220000,350000,130000,37
TIKI,nha-cua-doi-song,70898819,"Giấy ăn giấy gấu trúc Ycool -khăn giấy rút 300 tờ 1bịch 10 gói mẫu trắng",45000,45000,0,0
TIKI,nha-cua-doi-song,579962,"Bộ Nồi 5 Đáy Cao Cấp Núm Vàng Sunhouse SH781 Quay Mạ Vàng Cao Cấp (16cm, 20cm, 24cm) - Dùng Cho Mọi Loại Bếp - Hàng Chính Hãng",487000,960000,473000,49
TIKI,nha-cua-doi-song,197799361,"Combo 2 Bộ Chuyển Đổi Ổ Cắm 2 Chấu Thành 3 Chấu",27094,28520,1426,5
TIKI,nha-cua-doi-song,176592358,"Cây lau nhà tự vắt đa năng Sunhouse KS-MO3211PW",181000,263000,82000,31
TIKI,nha-cua-doi-song,128584341,"Ổ cắm đa năng USB Rạng Đông dài 3m Model: OC02.USB 3C/3M/10A",277200,308000,30800,10
TIKI,nha-cua-doi-song,134621577,"[Nhập CECAMP70KD1 giảm 70k đơn 999k] Bộ Dao 7 Món Lock&amp;Lock CKK301",1594000,2657000,1063000,40
TIKI,nha-cua-doi-song,134242996,"Ly Nhựa Có Ống Hút Lock&amp;Lock HAP507YEL",113000,217000,104000,48
TIKI,nha-cua-doi-song,112760341,"Thùng rác treo tủ bếp có nắp đậy thông minh, thùng rác treo tường dán tường, có thanh trượt cửa bếp – Parroti Bin BN02",169000,299000,130000,43
TIKI,nha-cua-doi-song,56612464,"Hộp Cơm Giữ Nhiệt INOX304 Hiện Đại Kèm Hộp Đựng Canh Soup",177650,187000,9350,5
TIKI,nha-sach-tiki,1686729,"Học Tiếng Anh Giao Tiếp Chỉ Trong 30 Ngày",224000,298000,74000,25
TIKI,nha-sach-tiki,12107379,"Barron's Essential Words For The Ielts (Tái Bản)",144000,208000,64000,31
TIKI,nha-sach-tiki,192714730,"Tuyển Tập Đề Kiểm Tra Định Kì Khoa Học Tự Nhiên Lớp 7 ( Theo Chương Trình GDPT Mới )",69000,92000,23000,25
TIKI,nha-sach-tiki,194104629,"Một Quyển Phong Hoa Đại Đường",96500,139000,42500,31
TIKI,nha-sach-tiki,111155169," [Manga] Diệt Slime Suốt 300 Năm, Tôi Levelmax Lúc Nào Chẳng Hay (Tập 5) ",38100,48000,9900,21
TIKI,nha-sach-tiki,190707619,"Của Chuột Và Người",60300,76000,15700,21
TIKI,nha-sach-tiki,11470936,"Combo Giáo Trình HSK 3 - Sách Bài Học (Kèm MP3) và Giáo Trình HSK 3 - Sách Bài Tập (Kèm MP3) ( Tặng Kèm Sổ Tay)",380800,476000,95200,20
TIKI,nha-sach-tiki,55957270,"Sách Hoa Trôi Trên Sóng Nước (Tái Bản 2020) - Nguyên Phong",64000,98000,34000,35
TIKI,nha-sach-tiki,7556499,"GAM7 No.11 Promotion - Khuyến Mại",136000,165000,29000,18
TIKI,nha-sach-tiki,41299102,"Những Nguyên Lý Quản Trị Bất Biến Mọi Thời Đại (Tái Bản 2019)",95600,138000,42400,31
TIKI,nha-sach-tiki,46253703,"Danh Gia Cổ Vật - Bí Ẩn Thanh Minh Thượng Hà Đồ",119000,150000,31000,21
TIKI,nha-sach-tiki,14643411,"Điều Kỳ Diệu (Tái Bản)",84200,148000,63800,43
TIKI,nha-sach-tiki,95311763,"Phương Pháp Ăn Uống Cải Thiện Lưu Thông Máu",61300,89000,27700,31
TIKI,nha-sach-tiki,157244522,"Văn Minh Đông Phương Và Tây Phương (Ts Thu Giang Nguyễn Duy Cần)(Tái Bản)",41200,60000,18800,31
TIKI,nha-sach-tiki,136540035,"Tư Duy Hộp Đen (Tìm Ra Lời Giải Cho Những Câu Hỏi Trong Cuộc Sống Và Kinh Doanh Bằng Tư Duy Thực Tế)",152500,219000,66500,30
TIKI,nha-sach-tiki,73553827,"Dữ Liệu Lớn Cho Doanh Nghiệp Nhỏ For Dummies",118000,159000,41000,26
TIKI,nha-sach-tiki,15634588,"Who? Chuyện Kể Về Danh Nhân Thế Giới: Ludwig Van Beethoven (Tái Bản 2019)",41000,55000,14000,25
TIKI,nha-sach-tiki,386182,"Thế Giới Tuổi Thần Tiên - Những Câu Chuyện Trong Rừng Xanh",20000,38000,18000,47
TIKI,nha-sach-tiki,41299108,"Trở Về Từ Cõi Sáng (Tái Bản)",67600,98000,30400,31
TIKI,nha-sach-tiki,112331977,"Quiz! Khoa Học Kì Thú: Khám Phá Trái Đất",49100,68000,18900,28
TIKI,nha-sach-tiki,67120551,"Đây Là Monet",109000,150000,41000,27
TIKI,nha-sach-tiki,595726,"Giáo Trình Chuẩn HSK 4 Bài Học (Tập 2)",179000,238000,59000,25
TIKI,nha-sach-tiki,273634677,"Trạm Đọc Official | Hackers Ielts 4 cuốn  ( Listening + Reading + Speaking + Writing )",743000,996000,253000,25
TIKI,nha-sach-tiki,187859733,"Thám Tử Đã Chết Tập 4 - Bản Phổ Thông - Quà Tặng Kèm Bookmark, Bộ Card Trong Bù Của Tập 3 (Trong Lần In Đầu)",83900,109000,25100,23
TIKI,nha-sach-tiki,187859732,"Spy Room – Lớp Học Điệp Viên 4",83900,109000,25100,23
TIKI,nha-sach-tiki,68350215,"Combo Chinh Phục Luyện Thi Vào 10 Toán Văn Anh Theo Chủ Đề",313000,477000,164000,34
TIKI,nha-sach-tiki,187279375,"Sách Luyện thi B2 Vstep 4 kỹ năng - Ôn thi chứng chỉ tiếng Anh bậc 4 (bằng B2 tiếng Anh) khung năng lực Ngoại ngữ 6 bậc Việt Nam",304500,350000,45500,13
TIKI,nha-sach-tiki,189076559,"Gatsby vĩ đại",184000,280000,96000,34
TIKI,nha-sach-tiki,29190890,"Tôi Đi Tìm Tôi",102000,160000,58000,36
TIKI,nha-sach-tiki,190701640,"Diệt Slime Suốt 300 Năm, Tôi Levelmax Lúc Nào Chẳng Hay (Tập 4) - (Tái Bản)",48000,52000,4000,8
TIKI,nha-sach-tiki,595738,"Giáo Trình Chuẩn HSK 4 Bài Tập (Tập 1)",111000,148000,37000,25
TIKI,nha-sach-tiki,191045567,"Làm Người Là Như Thế Nào? How To Be Human – The Manual",133000,179000,46000,26
TIKI,nha-sach-tiki,49904794,"Fullset Ehon Nhật Bản cho bé thông minh sáng tạo: Ehon Điều Kỳ Diệu Của Hình Khối + Điều Kỳ Diệu Của Âm Thanh + Điều Kỳ Diệu Của Màu Sắc (Bộ 10 cuốn cho bé 0-6 tuổi / Bộ Sách Phát Triển Trí Tuệ & Kích Thích Thị Giác Cho Bé)",269000,390000,121000,31
TIKI,nha-sach-tiki,77281352,"Lời giải bài tập Python cơ bản",75000,75000,0,0
TIKI,nha-sach-tiki,9687403,"The Book Of Leadership - Dẫn Dắt Bản Thân, Đội Nhóm Và Tổ Chức Vươn Xa",150000,218000,68000,31
TIKI,nha-sach-tiki,1732997,"Hồ Sơ Mật Lầu 5 Góc Và Hồi Ức Về Chiến Tranh Việt Nam (Sách Tham Khảo)",290000,290000,0,0
TIKI,nha-sach-tiki,81499980,"Danh Gia Cổ Vật - Minh Nhãn Mai Hoa",177000,230000,53000,23
TIKI,nha-sach-tiki,195288800,"Combo 2 Cuốn Khám Phá Sứ Mệnh Với Câu Hỏi Tại Sao – Bắt Đầu Với Câu Hỏi Tại Sao",149000,208000,59000,28
TIKI,nha-sach-tiki,178240500,"Đường Gia Tiểu Miêu",133000,179000,46000,26
TIKI,nha-sach-tiki,172175794,"Lý Thuyết Dow - Khoa Học Đầu Cơ Chứng Khoán: Bí Quyết Phân Tích Hành Vi Thị Trường Của Cha Đẻ Chỉ Số Dow Jones - Tác Phẩm Nền Tảng Của Phân Tích Kĩ Thuật Hiện Đại",37100,55000,17900,33
TIKI,nha-sach-tiki,196906879,"Máy Tính Khoa Học FX-880 BTG [ Siêu Máy Tính 2022",699000,699000,0,0
TIKI,nha-sach-tiki,74855017,"Quản Lý Tài Chính Cá Nhân Cho Phụ Nữ",110000,159000,49000,31
TIKI,nha-sach-tiki,192115854,"Ninja Rantaro - Tập 58 [Tặng Kèm Postcard]",38100,40000,1900,5
TIKI,nha-sach-tiki,13443851,"Cùng Khủng Long Học Tiếng Anh Theo Chủ Đề Lớp 1 (Tái Bản)",48100,68000,19900,29
TIKI,nha-sach-tiki,584873,"Sách Kiến Tạo Thế Hệ Việt Nam Ưu Việt - John Vu",62100,88000,25900,29
TIKI,nha-sach-tiki,195623888,"Truyện tranh tuổi thần tiên - Cây táo thần",15000,15000,0,0
TIKI,nha-sach-tiki,176132392,"Truyện Thiếu Nhi Hạt Giống Tâm Hồn - Những Bông Hoa Hình Trái Tim",42700,56000,13300,24
TIKI,nha-sach-tiki,47273271,"Inbound Selling - Thay Đổi Phương Thức Bán Hàng Theo Mô Hình Inbound",116000,158000,42000,27
TIKI,nha-sach-tiki,29290844,"Kho Tàng Truyện Thần Thoại Cổ Đại Trung Quốc (Không CD)",22000,22000,0,0
TIKI,nha-sach-tiki,73717906,"Khởi Nghiệp Công Nghệ - Máu Bẩn",150600,239000,88400,37
TIKI,nha-sach-tiki,447670,"Phép Tắc Của Loài Sói (Tái Bản 2015)",106999,106999,0,0
TIKI,nha-sach-tiki,2906447,"Series Địch Công Kỳ Án Tập 7 - Ngọc Xuyến Án",39000,91000,52000,57
TIKI,nha-sach-tiki,138396005,"Thiên Quan Tứ Phúc - Tập 2 (Tái Bản)",110700,159000,48300,30
TIKI,nha-sach-tiki,51244265,"Lược Sử Kinh Tế Học",98000,135000,37000,27
TIKI,nha-sach-tiki,111285054,"Quẳng Gánh Lo Đi & Vui Sống (Tái Bản)",58000,86000,28000,33
TIKI,nha-sach-tiki,5067155,"Nhật Ký Anne Frank (Tái Bản)",72500,98000,25500,26
TIKI,nha-sach-tiki,67060010,"Thực Đơn Ăn Dặm Kiểu Nhật",115000,168000,53000,32
TIKI,nha-sach-tiki,80142837,"Hackers IELTS Basic- Listening",144800,229000,84200,37
TIKI,nha-sach-tiki,36399672,"Trò Đùa Của Sự Ngẫu Nhiên",115800,209000,93200,45
TIKI,nha-sach-tiki,165098800,"My Hero Academia - Học Viện Siêu Anh Hùng - Tập 4: Cậu Bé Sinh Ra Với Tất Cả (Tái Bản 2022)",25000,25000,0,0
TIKI,nha-sach-tiki,76688366,"Leader Mindset - Thay Đổi Tư Duy Lãnh Đạo - LOAN VĂN SƠN",325000,500000,175000,35
TIKI,nha-sach-tiki,22634351,"Combo All The Rules Bình Tĩnh Khi Ế, Mạnh Mẽ Khi Yêu + Sống Bản Lĩnh Theo Cách Một Quý Cô (2 Cuốn)",132000,182000,50000,27
TIKI,nha-sach-tiki,111271564,"Vòng Xoáy Đi Lên - Đảo Chiều Trầm Cảm Từ Những Thay Đổi Nhỏ",98800,149000,50200,34
TIKI,nha-sach-tiki,191655860,"Làm Đẹp Thuần Chay",102000,139000,37000,27
TIKI,nha-sach-tiki,186578228,"Đời sống vỉa hè Sài Gòn",131000,169000,38000,22
TIKI,nha-sach-tiki,191148802,"Tâm lý học giao tiếp",130000,189000,59000,31
TIKI,nha-sach-tiki,74217686,"Gi Gỉ Gì Gi, Cái Gì Cũng Biết - 130 Bí Mật Vui Nhất Cho Tuổi Tiểu Học",86000,115000,29000,25
TIKI,nha-sach-tiki,196377993,"Sáng Mắt",99250,155000,55750,36
TIKI,nha-sach-tiki,82041440,"Models: Quyến Rũ Phái Đẹp Bằng Cả Chân Tình",103000,160000,57000,36
TIKI,nha-sach-tiki,188930500,"Người Bà Tài Giỏi Vùng Saga – Tập 5",40500,52000,11500,22
TIKI,nha-sach-tiki,394438,"Giấy Excel A4 DL80 ",70000,70000,0,0
TIKI,nha-sach-tiki,196305161,"Cơ Thể Con Là Của Con (Tái bản 2022)",74100,75000,900,1
TIKI,nha-sach-tiki,107773093,"Hộp màu 150 chi tiết cho bé, bộ màu vẽ đa năng cho bé thỏa thích tô - MAU150",55900,55900,0,0
TIKI,nha-sach-tiki,730782,"Tuần Của Bé Tháng 7 - Bé Trung Thực",11500,23000,11500,50
TIKI,nha-sach-tiki,189642774,"Thay Đổi Vận Mệnh Từ Bàn Tay",84000,128000,44000,34
TIKI,nha-sach-tiki,192377680,"Cách Dạy, Cách Học, Cách Sống Trong Thế Kỷ XXI: Khảo Sát Triết Lý Giáo Dục Của Dewey Và Makiguchi Để Đưa Ra Phương Thức Giáo Dục Mới Cho Nhân Loại",144000,145000,1000,1
TIKI,nha-sach-tiki,66464344,"Sài Gòn Đất Và Người (Tái Bản 2020)",109000,165000,56000,34
TIKI,nha-sach-tiki,174444190,"Người Bên Gối",90900,119000,28100,24
TIKI,nha-sach-tiki,180400055,"Thất Lạc Cõi Người (Tái Bản 2022)",106250,106250,0,0
TIKI,nha-sach-tiki,10144818,"20 bong bóng cao su nhiều màu",16000,16000,0,0
TIKI,nha-cua-doi-song,153467342,"Xốp Chèn Cửa 95cm Chặn Đáy Khe Cửa, Cách Nhiệt, Cách Âm, Ngăn Côn Trùng, Thanh Chắn Khe Cửa",4000,26000,22000,85
TIKI,nha-cua-doi-song,53647975,"1 Gối Ôm thương hiệu A có khóa kéo - an toàn sức khỏe, không chứa chất độc hại - êm ái, mềm mịn - KT",125000,150000,25000,17
TIKI,nha-cua-doi-song,20025334,"Bình Chữa Cháy Dạng Bột Khô ABC MFLZ-4Kg (Chữa cháy chất Rắn, Lỏng và Khí)",220000,380000,160000,42
TIKI,nha-cua-doi-song,91475535,"Áo Mưa Cánh Dơi Rằn Ri, Áo Mưa Xẻ Tà Màu Lính Vải Dù Siêu Dày 1M4, Chống Thấm Hiệu Quả, Phù Hợp Nam Và Nữ, Có Túi Đựng",130000,130000,0,0
TIKI,nha-cua-doi-song,162597633,"Combo 4 miếng dán đỡ kệ gỗ VINAVU, giúp chia ngăn tủ, không cần đóng đinh",24000,24000,0,0
TIKI,nha-cua-doi-song,54582729,"KỆ ĐẦU GIƯỜNG 1 TẦNG - TỦ ĐẦU GIƯỜNG - GỖ THÔNG NEWZEALAND - MÀU GỖ VÀNG NHẠT TỰ NHIÊN CÓ VÂN GỖ",109000,200000,91000,46
TIKI,nha-cua-doi-song,79267304,"Túi rác tự hủy inochi tiện dụng SOJI có quai xuất nhật Dùng đựng rác gia đình ,Bao đựng rác văn phòng đủ size -màu đen mềm nhẹ dai túi rác tự hủy giúp bảo vệ môi trường",38000,45000,7000,16
TIKI,nha-cua-doi-song,57272706,"Combo 200 túi lọc rác bồn rửa bát - Túi lưới lọc rác giúp ngăn chặn tắc đường ống",33030,33030,0,0
TIKI,nha-cua-doi-song,190989483,"Bình giữ nhiệt Baby Inox 316 Elmich EL8017 dung tích 300ml",231000,319000,88000,28
TIKI,nha-cua-doi-song,15343778,"Kệ góc nhà tắm dán tường inox 304 bóng Hobby Home Decor KG1 kèm keo dán và đinh ốc",249000,249000,0,0
TIKI,nha-cua-doi-song,125913928,"Móc dán tường trong suốt Móc treo đồ Móc dán tường 3D",700,1000,300,30
TIKI,nha-cua-doi-song,135321378,"Thanh Chặn Khe Cửa 95cm Đa Năng,Chặn Đáy Khe Cửa, Ngăn Côn Trùng, Chắn Gió Mùa, Ngừa Bụi Bẩn, Giảm Ồn",8000,13999,5999,43
TIKI,nha-cua-doi-song,66877902,"Đèn Ngủ Quả Cầu Mây Để Bàn SPEVI - Điều Chỉnh Độ Sáng, Làm Đèn Ngủ Trang Trí, Quà Sinh Nhật Cực Đáng Yêu, Đầu USB, Adapter USB Tiện Lợi, Đế Gỗ Xếp Sang Trọng, Bóng Đèn Led Vô Cùng Tiết Kiệm Điện - Hàng Chính Hãng",129000,246000,117000,48
TIKI,nha-cua-doi-song,185380294,"Lưới Polyester Phủ Chống Thấm, Vải Polyester Gia Cố Chống Thấm Mái Nhà Sàn Nhà Khe Nứt Khổ 10 cm",77350,91000,13650,15
TIKI,nha-cua-doi-song,95335291,"Combo 10 cặp kẹp dán tường thông minh - Không cần khoan lỗ, đục tường- Chịu lực lên đến 3Kg",35939,37830,1891,5
TIKI,nha-cua-doi-song,97817455,"Bộ túi hộp cơm thủy tinh COBA'COOK. Gồm 3 hộp 400ml và 1 túi giữ nhiệt với 2 khóa kéo tiện dụng- CCR43BL",203000,316000,113000,36
TIKI,nha-cua-doi-song,202805092,"Bình Giữ Nhiệt 800ml Lock&Lock Vacuum Bottle LHC6180 - Hàng Chính Hãng, Bằng Thép Không Gỉ, Có Lưới Lọc Trà Bằng Inox, Mức Giữ Nhiệt Vượt Trội Tặng Kèm Ống Hút Inox",373000,697000,324000,46
TIKI,nha-cua-doi-song,21301419,"Bàn để là quần áo dạng đứng",140000,140000,0,0
TIKI,nha-cua-doi-song,3526073,"Bộ Túi Hộp Cơm Thủy Tinh Lock&Lock 3EA LLG428M2 - Xanh Mint",343000,660000,317000,48
TIKI,nha-cua-doi-song,54132706,"Bộ sạc Energizer Charger kèm 4 pin Ener AA 2000mAh, tự ngắt sạc (CHVCM4) ( Mẫu mới)",429800,449000,19200,4
TIKI,nha-cua-doi-song,75616917,"Khăn lau vuông đa năng tiện lợi có dây treo siêu thấm hút lau tay lau bếp vệ sinh nhà cửa 25x25cm",8000,8000,0,0
TIKI,nha-cua-doi-song,114621700,"Kệ để hồ sơ văn phòng tiện lợi, kệ sách để bàn nhỏ gọn gỗ MDF chống ẩm chất lượng cao",126000,171000,45000,26
TIKI,nha-cua-doi-song,117195930,"Pin Maxell Super Đỏ - Hộp 40 Viên Pin Tiểu AA (2A) 1.5V",105000,105000,0,0
TIKI,nha-cua-doi-song,53830678,"1 cặp ruột gối hơi cao cấp - Gòn bông nhân tạo an toàn sức khỏe, không chứa chất độc hại - Có khóa kéo dễ dàng thêm bớt gòn bên trong - Êm ái, mềm mịn",60000,65000,5000,8
TIKI,nha-cua-doi-song,72044284,"BÀN LÀM VIỆC CHÂN GẤP GỌN 100CM - Nhiều màu sắc",392000,400000,8000,2
TIKI,nha-cua-doi-song,21466758,"Đầu chuyển ổ cắm 3 chấu qua 2 chấu - Hàng nhập khẩu",11353,11950,597,5
TIKI,nha-cua-doi-song,272966734,"Ổ cắm điện 5 lỗ 2m Điện Quang SM750SL - Hàng Chính Hãng",175000,175000,0,0
TIKI,nha-cua-doi-song,193708669,"Bình Đựng Nước 2L Kèm Ống Hút Bao Bì Dễ Thương Có Vạch Báo Giờ Uống Nước Chia Lượng Nước Deli - Bình Nước 2 Lít Nhựa Cao Cấp An Toàn Đầy Đủ Kiểm Định Chất Lượng Phủ Hợp Bình Nước Thể Thao Cho Bé Tới Trường - VS818 VS819",85000,160200,75200,47
TIKI,nha-cua-doi-song,137572447,"Bóng đèn LED Bulb PHILIPS Essential E27 - Tiết kiệm điện, Ánh sáng chất lượng cao - Hàng Chính Hãng",42000,66000,24000,36
TIKI,nha-cua-doi-song,70316883,"KỆ ĐỂ GIÀY DÉP GỖ THÔNG- Dài 50cm - 2T500",119000,119000,0,0
TIKI,nha-cua-doi-song,263488472,"Tủ kệ sách để bàn H6689 nhiều màu tiện ích ( Ngẫu nhiên )",48000,58000,10000,17
TIKI,nha-cua-doi-song,34230976,"Bàn làm việc 2 tầng 80cm",210602,214900,4298,2
TIKI,nha-cua-doi-song,162360312,"[HÀNG XỊN - CHỌN SIZE] Chiếu điều hòa sợi mây tổng hợp lót vải không dệt cao cấp hàng xuất khẩu 2 mặt giá rẻ 1m2 1m6 1m8 chính hãng",182000,300000,118000,39
TIKI,nha-cua-doi-song,59092666,"MÁY KHUẾCH TÁN TINH DẦU CHUYÊN DỤNG | Vân Gỗ Cao Cấp | Có Điều Khiển Từ Xa | Máy Phun Sương Tỏa Hương Tinh Dầu 500ML Cho Phòng Lớn",229000,476000,247000,52
TIKI,nha-cua-doi-song,21782438,"Kìm  kẹp quả óc chó ,càng cua, ghẹ inox - 17x4.5cm 247g",26000,26000,0,0
TIKI,nha-cua-doi-song,104681179,"Bông Lau Thay Thế MyJae Dạng Tròn Dành Cho Cây Lau Nhà Xoay 360 Độ",109000,200000,91000,46
TIKI,nha-cua-doi-song,135321411,"Giấy Bạc Tráng Nhôm, dán bếp tăng thẩm mỹ và rất sạch sẽ(2M)",16000,35000,19000,54
TIKI,nha-cua-doi-song,55202824,"Bình Nước Nhựa Nắp Vặn Dây Treo Họa Tiết Hươu Và Trăng Tiện Dụng Phù Hợp Với Mọi Lứa Tuổi 560ml",129000,258000,129000,50
TIKI,nha-cua-doi-song,64618364,"Day Đèn LED Siêu Sáng 5050 RGB Chống Nước Quấn Cây Trang Trí Ngoài Trời",112000,112000,0,0
TIKI,nha-cua-doi-song,92441037,"[LOẠI XỊN - CÓ TẶNG BƠM TAY] Bộ 8 Túi Hút Chân Không Đựng Quần Áo, Chăn Màn CỠ ĐẠI Cao Cấp - Hàng chính hãng",198000,198000,0,0
TIKI,nha-sach-tiki,59010153,"100 Kỹ Năng Sinh Tồn",70000,99000,29000,29
TIKI,nha-sach-tiki,13443886,"Giáo Trình Chuẩn HSK 3 Bài Học (Kèm file MP3) - Tái Bản",216000,288000,72000,25
TIKI,nha-sach-tiki,1823525,"Series Địch Công Kỳ Án: Đạo Quán Có Ma",36000,79000,43000,54
TIKI,nha-sach-tiki,185435307,"Thần Mộc Cào Bất Tận – Tập 2 - Bản Thường (Tặng 1 Bookmark in 2 Mặt)",129000,166000,37000,22
TIKI,nha-sach-tiki,644083,"Thời Gian Để Sống Và Thời Gian Để Chết",66000,100000,34000,34
TIKI,nha-sach-tiki,186290796,"Còn chút gì để nhớ (Tái Bản 2022)",28000,43000,15000,35
TIKI,nha-sach-tiki,192475874,"Tôi Muốn Vì Bạn Mà Trở Thành Người Tốt",66600,86000,19400,23
TIKI,nha-sach-tiki,161930883,"Thói Quen Thứ 8 - Từ Hiệu Quả Đến Vĩ Đại (Bìa Mềm)",113000,168000,55000,33
TIKI,nha-sach-tiki,73268489,"Những Ông Trùm Tài Chính",204400,299000,94600,32
TIKI,nha-sach-tiki,166525103,"NFT – Cuộc Cách Mạng Công Nghệ Tiếp Nối Blockchain Và Kỷ Nguyên Tiền Điện Tử",110700,159000,48300,30
TIKI,nha-sach-tiki,52332414,"Nghi thức trì Chú Đại Bi, Chú Dược Sư & Niệm Phật A Di Đà ",19000,19000,0,0
TIKI,nha-sach-tiki,185903114,"Bài tập Thực hành tiếng Anh 6 (Có đáp án) - Dùng kèm SGK TA 6 GLOBAL SUCCESS",44100,60000,15900,27
TIKI,nha-sach-tiki,111165275,"Cao Thủ Đổi Đen Thay Trắng - Tập 3 (Dành Cho 18+)",112000,149000,37000,25
TIKI,nha-sach-tiki,120509490,"Thương Nhớ Mười Hai (Việt Nam Danh Tác) (Tái Bản)",72100,99000,26900,27
TIKI,nha-sach-tiki,194959711,"Đao Ngữ (Katanagatari) 3",63000,120000,57000,48
TIKI,nha-sach-tiki,160754106,"Nghiên Cứu Phân Tâm Học",98000,135000,37000,27
TIKI,nha-sach-tiki,2651041,"Bàn Về Văn Minh",103000,139000,36000,26
TIKI,nha-sach-tiki,138934615,"Tô Màu Phát Triển Trí Não Bộ Cho Bé 1-5 Tuổi - Tập 4",16000,16000,0,0
TIKI,nha-sach-tiki,161929579,"Fullmetal Alchemist - Cang Giả Kim Thuật Sư - Fullmetal Edition Tập 13 [Tặng Kèm Bookmark PVC]",61600,69000,7400,11
TIKI,nha-sach-tiki,185243203,"Tiếng Anh 10 Bright Workbook (Sách bài tập)",65000,65000,0,0
TIKI,nha-sach-tiki,3529957,"i-Learn Smart World 8 Workbook",77900,82000,4100,5
TIKI,nha-sach-tiki,54616131,"Tử Huyệt Cảm Xúc",118000,118000,0,0
TIKI,nha-sach-tiki,122848364,"EQ - Từ Âm Vô Cực Đến Dương Vô Cùng",110700,159000,48300,30
TIKI,nha-sach-tiki,520330,"Đất Máu Sicily (Mario Puzo)",79000,120000,41000,34
TIKI,nha-sach-tiki,981942,"Combo Kích Thích Phát Triển Thị Giác Cho Bé ( Trọn Bộ 6 Cuốn )",134000,180000,46000,26
TIKI,nha-sach-tiki,195801639,"Hế Lô Nyao - Tập 09",23300,25000,1700,7
TIKI,nha-sach-tiki,194104230,"Gió Lẻ Và 9 Câu Chuyện Khác",58000,90000,32000,36
TIKI,nha-sach-tiki,185653966,"Tâm Lý Học Đám Đông",111650,149000,37350,25
TIKI,nha-sach-tiki,50269973,"Biểu Tượng Thất Truyền (Tái Bản 2020)",144400,239000,94600,40
TIKI,nha-sach-tiki,184781427,"Những Câu Hỏi Lớn Từ Người Phàm Trần Tí Hon Về Cái Chết",57200,79000,21800,28
TIKI,nha-sach-tiki,29830245,"Thuật Thôi Miên Trong Giao Tiếp",70100,108000,37900,35
TIKI,nha-sach-tiki,57318113,"Từ Điển Chính Tả Tiếng Việt ( Tác Phẩm Được Viện Ngôn Ngữ Học Thẩm Định)",58000,80000,22000,28
TIKI,nha-sach-tiki,185243205,"Tiếng Anh 10 Bright Student's Book (Sách học sinh)",69000,69000,0,0
TIKI,nha-sach-tiki,149409114,"Bổ Được Cà Chua, Mở Được Tiệm Cơm; Bật Được Nắp Chai, Mở Được Quán Nhậu (Tái Bản)",67750,105000,37250,35
TIKI,nha-sach-tiki,185786203,"Hộp đựng răng sữa cho bé bằng gỗ - Hộp đựng răng sữa kỷ niệm cho bé",54000,60000,6000,10
TIKI,nha-sach-tiki,57870430,"Trò Chuyện Với Thượng Đế (Tặng Kèm 01 Bookmark Một Mặt)",112000,159000,47000,30
TIKI,nha-sach-tiki,145144836,"Sách Bóc Dán Dành Cho Bé Gái - Những Nàng Tiên Chăm Chỉ",41100,55000,13900,25
TIKI,nha-sach-tiki,59043891,"Hố (Louis Sachar)(Tái Bản 2020)",51600,72000,20400,28
TIKI,nha-sach-tiki,107034694,"Gọt Chì Mini Deli - Xanh Lá/Xanh Dương/Hồng/Vàng - 1 chiếc - E0531 - Màu ngẫu nhiên",5400,5400,0,0
TIKI,nha-sach-tiki,157019700,"Thiệp chúc mừng sinh nhật 12x12 SDstationery SN2 STARRY họa tiết ngôi sao typography chữ viết tay đơn giản",56430,59400,2970,5
TIKI,nha-cua-doi-song,72049662,"Combo 6 Túi Giặt Lưới Bảo Vệ Quần Áo, túi lưới mịn polyester bảo quản quần áo",99000,99000,0,0
TIKI,nha-cua-doi-song,146432055,"Túi Chân Không Tự Hút Đựng Chăn Mền Quần Áo Không Cần Dụng Cụ Hút",42000,42000,0,0
TIKI,nha-cua-doi-song,19929974,"Bộ 4 Ống Hút Thủy Tinh Chịu Nhiệt (2 Cong + 2 Thẳng) + 2 Cọ Rửa + 1 Túi Vải",69000,69000,0,0
TIKI,nha-cua-doi-song,52238726,"Mùng Chụp Tự Bung Cao Cấp Siêu Dày - Màu Xanh Da Trời  + Tặng kèm túi thơm thảo dược",155000,215000,60000,28
TIKI,nha-cua-doi-song,116048764,"Kệ sách tổ ong vân gỗ dễ dàng kết hợp với bàn làm việc chính hãng IGA - GP100",121000,130000,9000,7
TIKI,nha-cua-doi-song,89992214,"Kệ Góc Nhà Tắm INOX 304 dán tường gạch men siêu chắc",69000,125000,56000,45
TIKI,nha-cua-doi-song,70083074,"Ghế xếp thư giãn SUMIKA 199 - có lăn tay massage, khung vuông cao cấp, tải trọng 300kg",1165000,1580000,415000,26
TIKI,nha-cua-doi-song,59259444,"Mùng chụp tự bung cao cấp FUNU - Màn chống muỗi thông minh - Hàng chính hãng (Sản xuất tại Việt Nam)",145700,155000,9300,6
TIKI,nha-cua-doi-song,14448546,"Bình Gas Bơm Bật Lửa BlueSky",55000,55000,0,0
TIKI,nha-cua-doi-song,192258425,"Thảm Chùi Chân 4 Lớp Siêu Thấm Hút Nhiều Hoa Văn Độc Đáo",79000,79000,0,0
TIKI,nha-cua-doi-song,53599746,"Combo Giá Treo Ổ Cắm Điện, Modem Dán Tường Tiện Dụng",19900,19900,0,0
TIKI,nha-cua-doi-song,165109465,"Kệ Lò Vi Sóng 2 Tầng, Kệ Nhà Bếp Thương Hiệu IGA - GM52",155000,169000,14000,8
TIKI,nha-cua-doi-song,71999227,"Bộ Nồi Inox 3 Lớp Đáy Liền Elmich Trimax Classic 2106OL Size 18,20,24cm",1591000,2870000,1279000,45
TIKI,nha-cua-doi-song,134515126,"Bình giữ nhiệt cho trẻ em LocknLock Cozy Kids Straw Tumbler LHC4236BLU 330ml - Màu",355000,592000,237000,40
TIKI,nha-cua-doi-song,71174837,"Đèn Pin Mini Siêu Sáng XML-T6 miDoctor - Chính Hãng",86000,86000,0,0
TIKI,nha-cua-doi-song,38059858,"Bộ 10 khăn lau 2 mặt siêu thấm- Khăn lau không phai màu không rụng sợi- nhanh khô- Khăn lau bếp, khăn lau kính, lau bát lau tay",10000,10998,998,9
TIKI,nha-cua-doi-song,157055245,"Combo 100 viên khăn giấy nén hình viên kẹo bỏ túi khi đi du lịch, 50 viên khăn lau mặt dạng nén dùng một lần siêu tiện lợi",35000,35000,0,0
TIKI,nha-cua-doi-song,191822621,"Gối Foam Contour Doona Sofy Cấu Trúc Lượn Sóng Nâng Đỡ Định Hình Xương Cổ Và Đầu Hoàn Hảo",339000,600000,261000,44
TIKI,nha-cua-doi-song,88925284,"Ổ Cắm Điện LIOA 10 ổ dây 3m(4D6S32) & 5m (4D6S52)",140000,140000,0,0
TIKI,nha-cua-doi-song,111511362,"Cuộn giấy lau nhà bếp đa năng 220 tờ màu trắng siêu dai có thể giặt được",9000,10500,1500,14
TIKI,nha-cua-doi-song,270862516,"Gối cao su chống đau cột sống - Gối cao su dành cho người hay ngủ ngáy mỏi cổ vai gáy – Hàng chính hãng",127000,200000,73000,37
TIKI,nha-cua-doi-song,17488465,"Vỉ 5 viên Pin GP 12V 23A",49000,49000,0,0
TIKI,nha-cua-doi-song,169650796,"Màn chụp, mùng chụp đỉnh vuông Không chân viền cao cấp Một Cửa - Hàng chính hãng (Giao ngẫu nhiên)",313500,330000,16500,5
TIKI,nha-cua-doi-song,75340681,"Hộp Đựng Đồ Đa Năng TD1 – Túi Vải Đựng Quần Áo Chăn Màn Phong Cách Thụy Điển Sang Trọng, Lịch Sự – Hàng Chính Hãng",76000,130000,54000,42
TIKI,nha-cua-doi-song,169978766,"Túi Hút Chân Không Đựng Quần Áo, Chăn Ga Gối, Thú Bông Deli - Loại Dày Cao Cấp, Nhiều Hoạ Tiết, Bảo Vệ Quần Áo, Chăn Ga Khỏi Ẩm, Nấm Mốc, Chống Nước Tuyệt Đối",16000,35820,19820,55
TIKI,nha-cua-doi-song,163827070,"Combo 2 hộp chia ngăn sắp xếp quần áo phong cách Nhật Bản VINAVU",190000,190000,0,0
TIKI,nha-cua-doi-song,115532506,"Hộp Nhựa Đựng Thực Phẩm, Hộp Bảo Quản Thực Phẩm Tủ Lạnh Homepower Trong Suốt Có Khay Lót Đáy Giúp Ráo Nước, Vòng Ghi Chú Thời Gian Bảo Quản Tiện Lợi",129000,129000,0,0
TIKI,nha-cua-doi-song,89980825,"Bộ 2 nhả kem đánh răng tự động OENON, Kệ nhà tắm thông minh kèm cốc láp đặt dán tường - 2NHAKEM",229000,400000,171000,43
TIKI,nha-cua-doi-song,59598451,"Miếng xốp bọc chân cửa chắn gió chống bụi, ngăn tiếng ồn, ngăn côn trùng 93 x 9.6cm",20000,20000,0,0
TIKI,nha-cua-doi-song,163574367,"Nến Thơm Cenote 4 Mùi Cao Cấp, Có Nắp Tắt Lửa Không Khói, Dùng cho Phòng Khách, Spa, Khách sạn và Phòng Hát Karaoke",139000,139000,0,0
TIKI,nha-cua-doi-song,199593599,"Kệ Sách Hình Cây Để Sàn",224000,245000,21000,9
TIKI,nha-cua-doi-song,45404047,"[ĐẶC BIỆT] Nhang Xanh Trầm Hương Cao Cấp 15 năm -100g - mùi thơm tự nhiên, dịu ngọt của trầm - Nhang Thiền",123500,125000,1500,1
TIKI,nha-cua-doi-song,31576989,"Quai xách Dây Dù bình giữ nhiệt 2GOOD Para Handle",65000,65000,0,0
TIKI,nha-cua-doi-song,84746981,"Lọ đựng gia vị, dầu ăn, nước chấm bằng thủy tinh trong suốt kèm muỗng tiện lợi",11900,11900,0,0
TIKI,nha-cua-doi-song,54412879,"Lô 4 túi rác tiện dụng Soji - size 10L - 25L và 50L",33250,35000,1750,5
TIKI,nha-cua-doi-song,114976767,"Nệm foam Goodnight Massage bán chạy số 1 Việt Nam 9cm tại Vua Nệm - Cấu trúc lượn sóng duy trì tư thế tự nhiên của cột sống",4290000,4290000,0,0
TIKI,nha-cua-doi-song,68716607,"Dao Thái Sunhouse KS-KN165SS",73000,117000,44000,38
TIKI,nha-cua-doi-song,146062295,"Bộ 2 Ốc Vít - Chốt Cao Su Cố Định Nắp Bồn Cầu",68000,68000,0,0
TIKI,nha-cua-doi-song,103780888,"Ổ cắm có dây - Ổ điện an toàn - Ổ cắm điện đa năng - Ổ cắm điện Lioa ( 4 - 6 - 10 ổ cắm ) dây 5m và 3m Lioa - hàng chính hãng cao cấp",62000,62000,0,0
TIKI,nha-cua-doi-song,803123,"Thùng rác nhựa Fitis Compact X PPL1-906",280000,350000,70000,20
TIKI,nha-sach-tiki,541248,"Võ Nguyên Giáp - Những Năm Tháng Cuộc Đời (Tái Bản)",49400,82000,32600,40
TIKI,nha-sach-tiki,77917794,"Từ Nước Mắt Đến Nụ Cười - Tận Cùng Khổ Đau Đến Ngời Sáng Tâm Hồn",104000,148000,44000,30
TIKI,nha-sach-tiki,32855400,"Tâm Lý Học Đám Đông (Tái Bản) ( tặng kèm bookmark Sáng Tạo )",111650,149000,37350,25
TIKI,nha-sach-tiki,195306005,"Nhà thờ Đức Bà Paris (Bìa Cứng)",426000,650000,224000,34
TIKI,nha-sach-tiki,192161603,"Chú Thuật Hồi Chiến - Tập 5 - Bản Thường - Tặng Kèm Obi Và Thẻ Bo Góc Nhựa",29100,30000,900,3
TIKI,nha-sach-tiki,179547036,"Bộ Sách Khởi Nghiệp Du Kích - Kinh Doanh Ít Vốn: Làm Thế Nào Để Khởi Động và Vận Hành Doanh Nghiệp Bằng Nguồn Vốn Hạn Hẹp",325000,567000,242000,43
TIKI,nha-sach-tiki,169376042,"Từ Điển Tiếng Việt Hoàng Phê (Tái Bản)",495000,495000,0,0
TIKI,nha-sach-tiki,195291853,"Kỳ Nghỉ Dưỡng Của Chàng Quý Tộc Ôn Hòa (Tập 3)",149000,196000,47000,24
TIKI,nha-sach-tiki,15634596,"Búp Sen Xanh (Tái Bản)",72000,72000,0,0
TIKI,nha-sach-tiki,581983,"Việt Nam Sử Lược (Bản Đặc Biệt - Ấn Bản Kỉ Niệm 60 Năm NXB Kim Đồng)",177000,250000,73000,29
TIKI,nha-sach-tiki,77988131,"Văn Học Kinh Điển - Thể Xác Và Tâm Hồn (Ấn Bản Phổ Thông - Bìa Cứng) [Tặng Kèm: Postcard + Bookmark]",179000,388000,209000,54
TIKI,nha-sach-tiki,92096347,"Trở Về Từ Xứ Tuyết (Tái Bản)",63400,92000,28600,31
TIKI,nha-sach-tiki,10694902,"Tôi Tài Giỏi - Bạn Cũng Thế (Tái bản) + tặng kèm 1 bookmark",133500,133500,0,0
TIKI,nha-sach-tiki,67120562,"Đây Là Leonardo Da Vinci",109000,150000,41000,27
TIKI,nha-sach-tiki,572247,"Chiến Thắng Kì Thi 9 Vào 10 Chuyên Vật Lý (Tập 1)",109000,189000,80000,42
TIKI,nha-sach-tiki,195801321,"The One Thing - Điều Ý Nghĩa Nhất (Tái Bản 2022)",78000,119000,41000,34
TIKI,nha-sach-tiki,170490622,"Người Điều Khiển Mê Cung",106700,128000,21300,17
TIKI,nha-sach-tiki,47504724,"Những Tấm Lòng Cao Cả (Tái Bản 2020)",59000,90000,31000,34
TIKI,nha-sach-tiki,52004412,"D. Trump - Nghệ Thuật Đàm Phán (Tái bản 2020)",74000,109000,35000,32
TIKI,nha-sach-tiki,71658956,"Full Combo (Bộ 10 cuốn) Ehon Kỹ năng - Âm thanh - Nhận biết",167440,322000,154560,48
TIKI,nha-sach-tiki,104074530,"Tôi, Tương Lai Và Thế Giới (Tái Bản)",102000,160000,58000,36
TIKI,nha-sach-tiki,115702579,"Quảng Cáo Không Nói Láo - Sự Thật Về Quảng Cáo Dưới Góc Nhìn Khoa Học, Toàn Diện Và Thực Tiễn",169000,195000,26000,13
TIKI,nha-sach-tiki,69908762,"Luyện viết chữ Hán Sơ cấp 1 (Theo Giáo trình Hán ngữ BOYA)",129000,250000,121000,48
TIKI,nha-sach-tiki,195928317,"Hộp Bút Túi Đựng Bút Đồ Dùng Học Tập Đồ Dùng Cá Nhân Học Sinh Họa Tiết Vui Nhộn Deli -  Bóp Viết Phù Hợp Cho Học Sinh, Đựng Mĩ Phẩm - Màu Sắc Tươi Sáng",39000,81000,42000,52
TIKI,nha-sach-tiki,94347312,"Cái Cười Của Thánh Nhân (Ts Thu Giang)(Tái Bản)",73000,105000,32000,30
TIKI,nha-sach-tiki,56819709,"Thiền Chữa Lành Thân Và Tâm (Tái Bản 2020)",67400,95000,27600,29
TIKI,nha-sach-tiki,76443018,"Lược Sử Triết Học",105000,142000,37000,26
TIKI,nha-sach-tiki,147265098,"Volume Profile - Góc nhìn từ người trong cuộc",209000,209000,0,0
TIKI,nha-sach-tiki,67060014,"Phát Triển Trí Tuệ Cảm Xúc - Con Được Là Chính Mình!",37100,50000,12900,26
TIKI,nha-sach-tiki,10271803,"Combo Ngữ Pháp Và Giải Thích Ngữ Pháp Tiếng Anh Cơ Bản Và Nâng Cao",280000,400000,120000,30
TIKI,nha-sach-tiki,176487508,"Trường Pháp Ở Việt Nam 1945 -1975",164400,249000,84600,34
TIKI,nha-sach-tiki,59362963,"Osho Đàn Ông - The Book Of Men",84700,119000,34300,29
TIKI,nha-sach-tiki,13828940,"Văn Học Kinh Điển Thế Giới - Phù Thủy Xứ OZ",57000,88000,31000,35
TIKI,nha-sach-tiki,59321997,"Luận Về Đại Chiến Lược",150220,259000,108780,42
TIKI,nha-sach-tiki,59291594,"100 Phương Pháp Thực Tiễn Để Cải Thiện Trải Nghiệm Khách Hàng",99000,150000,51000,34
TIKI,nha-sach-tiki,185055210,"Có Lẽ Bạn Nên Gặp Bác Sỹ Tâm Lý",185000,249000,64000,26
TIKI,nha-sach-tiki,197531553,"Blue Period - Tập 4 - Tặng Kèm Bookmark Giấy",45600,48000,2400,5
TIKI,nha-sach-tiki,173406524,"Kẻ Lãng Quên - Pháp Y Tần Minh",163500,163500,0,0
TIKI,nha-sach-tiki,49549966,"Ba Người Lính Ngự Lâm (Đông A) (Tái Bản)",164000,250000,86000,34
TIKI,nha-sach-tiki,50322534,"Song Ngữ Việt - Anh - Diary Of A Wimpy Kid - Nhật Ký Chú Bé Nhút Nhát",76800,96000,19200,20
TIKI,nha-cua-doi-song,48967324,"Khóa Vali Khóa Balo Mã Số Chữ Thập",29000,29000,0,0
TIKI,nha-cua-doi-song,164479566,"Ghế chỉnh dáng ngồi đúng - Roichen Hàn Quốc (Made in Korea). Dùng cho Nam, Nữ, Trẻ em. Hàng chính hãng",710000,750000,40000,5
TIKI,nha-cua-doi-song,67299755,"Giấy nến đục lỗ lót nồi chiên không dầu loại 4 lít, 4.5 lít, 5 lít, 6.5 lít - Size 21cm - 100 tờ - siêu tiện dung",29000,29000,0,0
TIKI,nha-cua-doi-song,75659112,"Kệ Sách Tổ Ong IGEA Đa Tầng Convent 234F - GP100",181000,198000,17000,9
TIKI,nha-cua-doi-song,71925401,"Đèn Bàn Học Đọc Sách, Đèn Bàn Làm Việc Sang Trọng, Đèn Ngủ Cao Cấp (Học Sinh, Sinh Viên, Văn Phòng) LED Chống Cận 03 Mức Độ Sáng, Cảm Ứng Tích Điện Pin 2500mAh - Hàng Chính Hãng - VinBuy",123000,260000,137000,53
TIKI,nha-cua-doi-song,51373821,"Đèn bàn học led cảm ứng chính hãng Rạng Đông Model: RD RL 36 LED",203000,203000,0,0
TIKI,nha-cua-doi-song,169919224,"Kệ Để Kem Đánh Răng & Bàn Chải, Tặng Kèm Cốc - Kệ Nhà Tắm Dán Tường Thông Minh - Giá Treo Bàn Chải Đánh Răng Kiêm Để Đồ & Úp Cốc - Giao Màu Ngẫu Nhiên [HÀNG CHÍNH HÃNG",99000,120000,21000,18
TIKI,nha-cua-doi-song,686906,"Hộp Thủy Tinh Cao Tròn Glasslock MCCD072 (720ml)",144000,194000,50000,26
TIKI,nha-cua-doi-song,52238368,"Chiếu điều hòa cao cấp Ánh Sao - Sợi mây tổng hợp + Tặng kèm túi thơm thảo dược - giao mẫu ngẫu nhiên",130000,140000,10000,7
TIKI,nha-cua-doi-song,54460849,"Bộ chăn ga gối cotton LIDACO PL1 - Caro Nâu (SP000661)",195000,276000,81000,29
TIKI,nha-cua-doi-song,57335326,"Ghế xếp thư giãn SUMIKA 179A - Khóa kim loại, khung thép tròn, tải trọng 200kg",765000,1000000,235000,24
TIKI,nha-cua-doi-song,117645437,"Ổ cắm điện LiOA đa năng kết hợp - 2D2S, 3D3S, 4D6S dây dài 3m/5m - Ổ cắm điện Lioa Chính Hãng",85000,85000,0,0
TIKI,nha-cua-doi-song,52789105,"Đế Bình Giữ Nhiệt Silicone Boot 2GOOD Flask 900ml",50000,50000,0,0
TIKI,nha-cua-doi-song,68413077,"Đèn đọc sách mini, pin sạc tiện dụng Baseus Comfort Reading Mini Clip Lamp ( Dịu mắt, chân kẹp, 3 mức sáng, 350mAh, 24h sử dụng)hàng nhập khẩu",215000,249000,34000,14
TIKI,nha-cua-doi-song,135442410,"Máy Đo Khoảng Cách Laser Deli Chính Hãng Loại 40m / 50m / 60m Đa Năng - Dễ Dàng Sử Dụng Từ Xa - DL331050P / EDL4168",488000,896000,408000,46
TIKI,nha-cua-doi-song,152784110,"Khay Đá Silicon Có Nắp Đậy 14 Viên, Khay Đựng Đá Tủ Lạnh, Làm Đá Thạch Kem Bảo Quản Chống Mùi Tuyệt Đối- Hàng Loại 1",49000,49000,0,0
TIKI,nha-cua-doi-song,67650750,"Đệm ngồi lót ghế làm từ hợp chất TPE, thoáng khí, hỗ trợ tuần hoàn máu, chống ê mông, mỏi lưng - Thương hiệu Nhà của Mẹ- giao màu ngẫu nhiên",153000,160000,7000,4
TIKI,nha-cua-doi-song,141201958,"Ly Giữ Nhiệt Cà Phê Có Tay Cầm Nắp Trượt Chống Tràn Rinfere (415ml)",295000,449000,154000,34
TIKI,nha-cua-doi-song,47163069,"Túi Đựng Chăn Mền Quần Áo Kháng Mốc Cỡ Lớn Nhiều Màu",58000,58000,0,0
TIKI,nha-cua-doi-song,19867726,"Võng lưới mềm dày 99, gỗ 50 (Giao màu ngẫu nhiên)",208000,350000,142000,41
TIKI,nha-cua-doi-song,171797241,"{XẢ KHO} Cây Lau Nhà Thông Minh, Tự Động Tách Nước Bẩn, Tự Động Vắt Khô, Xoay 360 độ Hatachi  HTC - V6 - HÀNG CHÍNH HÃNG",512050,539000,26950,5
TIKI,nha-cua-doi-song,143002904,"Ổ  điện đa năng shoptida hình tháp nhiều tầng T8/ T12 chịu tải 3600W, an toàn chống cháy chống giật, dây dài 3m và 4m",549000,579000,30000,5
TIKI,nha-cua-doi-song,250512089,"Kéo cắt cành cộng lực chuyên dụng Germany -dụng cụ làm vườn đa năng",162000,280000,118000,42
TIKI,nha-cua-doi-song,78633940,"Máy Sấy Và Khử Trùng Giày Xiaomi Youpin SOTHING DSHJ-S-1904 có hẹn giờ",259000,269000,10000,4
TIKI,nha-cua-doi-song,188375839,"Khăn tắm Khăn lau mặt Cotton 100% Mềm Êm Dày dặn Màu trơn Nhấn viền họa tiết 74x33cm",49000,49000,0,0
TIKI,nha-cua-doi-song,163304843,"Máy phun rửa áp lực cao Karcher K2 Classic ",2222700,2390000,167300,7
TIKI,nha-cua-doi-song,58546654,"Đèn Pixar, Đèn Học Chống Cận Thị, Đèn Đọc Sách, Đèn Làm Việc Để Bàn Chống Chói Mắt Lóa Mắt Bảo Vệ Mắt + Bóng Đèn + Chân Kẹp + Chân Đế - Hàng Chính Hãng Amalife",165000,165000,0,0
TIKI,nha-cua-doi-song,72459016,"Bộ Nhả Kem Đánh Tự Động OENON, Kệ Treo Bàn Chải Nhà Tắmg Dán Tường Kèm Cốc Hút Từ Tính - OEKEM",99000,190000,91000,48
TIKI,nha-cua-doi-song,16196661,"Bộ Tua Vít Đa Năng Tua Vít 25 Đầu Trong 1 Screwdriver",28044,28044,0,0
TIKI,nha-cua-doi-song,178101136,"Bơm điện 2 chiều bơm và hút chân không cao cấp miDoctor",97000,180000,83000,46
TIKI,nha-cua-doi-song,263990262,"Lọ xay tiêu Inox 304 DandiHome cao cấp",56000,65000,9000,14
TIKI,nha-cua-doi-song,41318920,"Bộ chặn cửa chống va đập nam châm hít cửa dán sàn Hobby Home Decor CC1 inox 304 kèm keo dán sàn",82000,139000,57000,41
TIKI,nha-cua-doi-song,20103667,"Combo Cọ Rửa Dành Cho Ống Hút Inox và Ống Hút Thủy Tinh",28000,28000,0,0
TIKI,nha-cua-doi-song,111410597,"Kính bảo hộ Honeywell A700 Mắt kính chống bụi, chống tia UV, chống trầy xước, đọng sương",77900,82000,4100,5
TIKI,nha-cua-doi-song,53497035,"40 VIÊN PIN MAXELL AAA TEM BẠC - HÀNG CHÍNH HÃNG",51400,51400,0,0
TIKI,nha-cua-doi-song,241806648,"Móc Dán Tường Treo Chậu Rổ, Treo Đồ Đa Năng Inox 304 Jodily Sử Dụng Miếng Dán Thế Hệ Mới",20000,20000,0,0
TIKI,nha-cua-doi-song,189339895,"Đèn LED Mini Móc Khóa - Đèn Pin COB - Đèn Pin Dã Ngoại - Sạc Type C Tiện Dụng",30400,32000,1600,5
TIKI,nha-cua-doi-song,44803282,"Bàn Làm Việc Có Kệ Sách Mẫu Mới",262500,350000,87500,25
TIKI,nha-cua-doi-song,55124901,"Thùng Rác Mini Phòng Ngủ, Toilet, Xe Hơi Khả Năng Giữ Mùi 90",100000,100000,0,0
TIKI,nha-cua-doi-song,152789537,"Combo 5 Đôi Đũa Thủy Tinh Đầu Đũa Vạt Xéo Trang Trí Họa Tiết Nhật Bản Phủ Bóng",70000,70000,0,0
TIKI,nha-cua-doi-song,107961495,"Ly Nhựa 2 Lớp LocknLock 900ml HAP502BEG - Màu",158000,263000,105000,40
TIKI,nha-cua-doi-song,184519325,"Bộ quần áo mưa vân tổ ong cao cấp siêu bền",138000,138000,0,0
TIKI,nha-cua-doi-song,195980111,"Bình giữ nhiệt LocknLock LHC3275 - 490ML - Hàng chính hãng",294000,490000,196000,40
TIKI,nha-cua-doi-song,54133235,"Pin Sạc AA 2000mAh NH15 Power Plus RP2 Energizer NH15 RP2 (Mẫu mới)",157000,160000,3000,2
TIKI,nha-cua-doi-song,195469953,"Súng Bắn Keo (Cỡ Lớn/Nhỏ) Kèm 10 Keo Nến Silicon",109000,109000,0,0
TIKI,nha-cua-doi-song,133885539,"Tô Giấy Dùng 1 lần KETILO Cao Cấp 250ml, Trắng Trơn, Cứng Cáp, An Toàn và Thân Thiện Môi Trường - HÀNG CHÍNH HÃNG TG100",69900,89000,19100,21
TIKI,nha-cua-doi-song,14764119,"Ly Giữ Nhiệt Nắp Trượt Chống Tràn Rinfere - Tặng Kèm Ống Hút Không Gỉ, Dụng Cụ Vệ Sinh Ông Hút (590ml)",265000,299000,34000,11
TIKI,nha-cua-doi-song,50294624,"Lưới Đèn LED Chống Nước Trang Trí Ngoài Trời Cho Giánh Sinh, Tiệc, Lễ Tết - Nhiều kích cỡ",119000,119000,0,0
TIKI,nha-cua-doi-song,58469713,"Dây đèn nháy led đom đóm trang trí dùng pin nhiều màu, bóng đèn nháy fairy light cao cấp décor phòng, nhà cửa, tết (Tùy chọn chiều dài dây)",89000,115000,26000,23
TIKI,nha-cua-doi-song,157169614,"Thớt Nhựa Kháng Khuẩn 5D Cao Cấp - Chính Hãng ( Giao màu ngẫu nhiên)",29000,58000,29000,50
TIKI,nha-cua-doi-song,68513020,"Combo 3 hộp đựng đồ cao cấp Việt Nam phong cách Nhật (38x25xH25cm) Storage Box",166000,166000,0,0
TIKI,nha-cua-doi-song,13287995,"Cây gãi lưng chỉnh độ dài có đầu gãi bằng PVC ",18000,18000,0,0
TIKI,nha-cua-doi-song,180997554,"Bộ 12 ly  thủy tinh cao cấp",64991,64991,0,0
TIKI,nha-cua-doi-song,106996271,"Bộ vòi dẫn nước nước rửa chén inox 304 gắn bồn rửa bát dây dài 1.2met",56154,56154,0,0
TIKI,nha-cua-doi-song,181909422,"Chảo Sâu Lòng Suit LocknLock CSU1225PIK – 22cm - Màu Pink",331730,677000,345270,51
TIKI,nha-cua-doi-song,57971649,"Bộ 2 chảo Lock&Lock Easy Frypan 2P Set, Chảo 1 tay cầm 24cm + Chảo lòng sâu 26cm (LEY1243 x 1, LEY1265 x 1) LEY1243S2",308000,593000,285000,48
TIKI,nha-cua-doi-song,94847014,"Nến thơm trang trí phong cách hoa khô thảo mộc",180000,180000,0,0
TIKI,nha-cua-doi-song,19590366,"Kệ Đa Năng Inochi B4 (45,5 x 26,0 x 44,7 cm)",76000,80000,4000,5
TIKI,nha-cua-doi-song,56383693,"Combo 300 túi lọc rác bồn rửa bát",37999,37999,0,0
TIKI,nha-cua-doi-song,272452316,"Bộ Lau Nhà MyJae Đài Loan Sợi Fiber Xoay 360 Độ Thông Minh 125cm",429000,1200000,771000,64
TIKI,nha-cua-doi-song,5146283,"Ấm đun nước Inox 304 Elmich 3L EL3373 dùng bếp từ",643000,890000,247000,28
TIKI,nha-cua-doi-song,115972789,"HỘP ĐỰNG TÚI ĐỰNG QUẦN ÁO KHUNG THÉP 66L- LIVING BOX 66L- Dài 50x Rộng 40x Cao 33.5 cm",85000,85000,0,0
TIKI,nha-cua-doi-song,77577550,"Bộ Chăn Gối Văn Phòng 3 Trong 1 Kiểu Gấu Nâu Độc Đáo Dùng Để Ngủ Trưa Tại Văn Phòng, Tựa Lưng Và Gấu Bông Dùng Để Trang Trí",249000,279000,30000,11
TIKI,nha-cua-doi-song,20528052,"Bộ 2 Pin Sạc AA 1.2V - 1.450mAh Tích Hợp Cổng Sạc USB Tiện Dụng (Màu ngẫu nhiên)",140000,140000,0,0
TIKI,nha-cua-doi-song,96608971,"Móc treo quần áo gấp gọn tiện dụng/Móc du lịch đa năng",7680,9600,1920,20
TIKI,nha-cua-doi-song,12622141,"Cân điện tử mini nhà bếp 5kg",37300,37300,0,0
TIKI,nha-cua-doi-song,125771437,"Khay nướng Bít-tết Phụ kiện nồi chiên không dầu 2GOOD ",380000,380000,0,0
TIKI,nha-cua-doi-song,15444566,"Kệ đựng xà bông dán tường phòng tắm Hobby Home Decor SBL2 có miếng dán gạch men",70000,89000,19000,21
TIKI,nha-cua-doi-song,182432982,"KỆ ĐỂ GIÀY DÉP SAGOKER, mã KED201",141000,159999,18999,12
TIKI,nha-cua-doi-song,28937063,"Đồng hồ để bàn báo thức điện tử",81000,120000,39000,33
TIKI,nha-cua-doi-song,112946538,"Tấm trải tiện ích Everon Lite (Giao màu ngẫu nhiên)",296000,395000,99000,25
TIKI,nha-cua-doi-song,75478111,"Bộ tượng 04 chú tiểu trang trí xe hơi, bàn làm việc, mang lại bình an, hạnh phúc",41400,45000,3600,8
TIKI,nha-cua-doi-song,195949375,"Đèn bàn học làm việc đọc sách chống cận, pin sạc tích điện led có thể gấp gọn – 03 chế độ ánh sáng bảo vệ mắt - Chính hãng VinBuy",179000,300000,121000,40
TIKI,nha-cua-doi-song,116185291,"Nhiệt ẩm kế cơ học TANAKA TH101E Chính hãng nhật,nhiệt ẩm kế cơ theo công nghệ nhật bản,đồng hồ đo ẩm kế chính xác,nhiệt ẩm kế phòng,nhiệt ẩm kế sử dụng cho trẻ sơ sinh,nhiệt ẩm kế treo tường ",118500,140000,21500,15
TIKI,nha-cua-doi-song,66546628,"Giá Treo Rổ Rá, Thau Chậu và Dụng Cụ Bếp Dán Tường Không Khoan Đục Kèm 4 Móc Treo Đồ Tiện Lợi MTC1",58000,99000,41000,41
TIKI,nha-cua-doi-song,32021492,"Ổ Khóa Số Du Lịch Stanley S742-054",161000,167000,6000,4
TIKI,nha-cua-doi-song,75730188,"Băng keo dán chống thấm nước bồn rửa chén, bếp, nhà vệ sinh [Tặng dây cột tóc hoa mặt trời ngẫu nhiên",40997,40997,0,0
TIKI,nha-sach-tiki,145279201,"Sách Đường Xưa Mây Trắng - Theo Gót Chân Bụt (Tái bản năm 2020) (Bìa mềm/ Câu Chuyện Thú Vị Về Bụt/ Tặng Kèm Bookmark)",270650,270650,0,0
TIKI,nha-sach-tiki,191949999,"ĐẠO ĐỨC HỌC - SPINOZA",154000,268000,114000,43
TIKI,nha-cua-doi-song,134676914,"Lọ Hũ Thủy Tinh Nắp Cài Kín Hơi Đáy Vuông Nhiều Dung Tích",55000,55000,0,0
TIKI,nha-sach-tiki,186880675,"Thế Chiến Thứ Hai",435400,699000,263600,38
TIKI,nha-sach-tiki,183539215,"Trần Triều Nhàn Thoại",80000,119000,39000,33
TIKI,nha-sach-tiki,19349136,"Sức Mạnh Tiềm Thức (Tái Bản)",102000,128000,26000,20
TIKI,nha-sach-tiki,185909452,"Điệp Viên Hoàn Hảo X6 (Bìa Mềm)",124000,178000,54000,30
TIKI,nha-sach-tiki,188533804,"Chuyện Dài Thành Chuyện Ngắn",103000,115000,12000,10
TIKI,nha-cua-doi-song,37495650,"Kệ Sách Để Sàn Cao Cấp 11 Tầng Bằng Gỗ MDF Phủ Melamin Chống Nước, Chống Xước - Hàng Chính Hãng",400000,439000,39000,9
TIKI,nha-sach-tiki,63516905,"Boxset 4 Cuốn: Cá Voi Đêm Bão Và Những Câu Chuyện Khác…",142000,200000,58000,29
TIKI,nha-sach-tiki,186286174,"Trại Hoa Vàng (Tái Bản 2022)",33000,50000,17000,34
TIKI,nha-sach-tiki,192339430,"Tâm Lý Học Về Sự Tự Tôn",95100,129000,33900,26
TIKI,nha-sach-tiki,75630589,"Sách PACE Books - Tốc độ của niềm tin (The Speed Of Trust: The One Thing That Changes Everything) (Tái Bản) - Stephen M. R. Covey, Rebecca R. Merrill",140000,175000,35000,20
TIKI,nha-sach-tiki,173357306,"Sách 7 Thói Quen Tạo Gia Đình Hạnh Phúc",116000,168000,52000,31
TIKI,nha-sach-tiki,114937975,"Bóng Trăng Trắng Ngà - Bản Thường (Tặng Kèm: Bìa Áo + 1 Book Mark)",102000,129000,27000,21
TIKI,nha-sach-tiki,186578985,"Hãy Yêu Đời Dẫu Đời Có Trái Ngang -Tặng kèm 01 Bookmark",68100,89000,20900,23
TIKI,nha-sach-tiki,69764547,"Hẹn Nhau Phía Sau Tan Vỡ",61400,86000,24600,29
TIKI,nha-sach-tiki,18002162,"Sách Thiếu Nhi - Truyện Tranh Mây Trắng và hành trình giải cứu Trái đất ",33250,35000,1750,5
TIKI,nha-sach-tiki,186267247,"Shaman King 11",34300,35000,700,2
TIKI,nha-sach-tiki,108261354,"Tự Học Ngữ pháp Tiếng Anh Bằng Mindmap Tập 1",108000,145000,37000,26
TIKI,nha-sach-tiki,181699638,"Đất Tiền Đất Bạc",99000,150000,51000,34
TIKI,nha-sach-tiki,71092794,"Thanh Gươm Diệt Quỷ - Tập 18: Kí Ức Trỗi Dậy",25000,25000,0,0
TIKI,nha-sach-tiki,16391543,"Cha Voi - Dạy Con Nên Người Ở Thời Đại Số",96500,150000,53500,36
TIKI,nha-sach-tiki,966503,"Tuần Của Bé - Bé Lắng Nghe",11500,23000,11500,50
TIKI,nha-sach-tiki,195801673,"Khoa Học Khám Phá - Vũ Trụ Trong Vỏ Hạt Dẻ (Tái Bản 2022)",73000,108000,35000,32
TIKI,nha-sach-tiki,83757985,"Cao Thủ “Đổi Đen Thay Trắng” - Tập 2 (Dành Cho 18+)",111000,149000,38000,26
TIKI,nha-sach-tiki,68580163,"Sổ Tay Học Nhanh Toàn Diện Kiến Thức Và Dạng Bài Hóa Học Lớp  10 - 11 - 12",78000,119000,41000,34
TIKI,nha-sach-tiki,72511282,"Bộ Sách Tự Xóa Thông Minh - Bé Học Toán Mỗi Ngày (5 -7 tuổi) (Tặng Kèm Bút Xóa)",69500,89000,19500,22
TIKI,nha-sach-tiki,184283143,"Combo 10 bìa nút túi hồ sơ tài liệu A4 loại dày màu tự chọn Deli - Phù hợp học sinh văn phòng - EF10412 / EF10432 / EF10442 / EF10452 / EF10462 / EF10472",12000,27000,15000,56
TIKI,nha-sach-tiki,164273180,"Dệt Nên Sự Sống: Khám Phá Bí Mật Cứu Tinh Của Thế Giới Tự Nhiên",84000,119000,35000,29
TIKI,nha-cua-doi-song,183335921,"Bộ ống hút inox thẳng kèm cọ rửa đảm bảo sức khỏe cho người tiêu dùng",20000,20000,0,0
TIKI,nha-sach-tiki,186495460,"Những Bài Diễn Văn Làm Thay Đổi Thế Giới Từ 1945 Đến Nay",253000,340000,87000,26
TIKI,nha-sach-tiki,150997930,"Thế Giới Otome Game Thật Khắc Nghiệt Với Nhân Vật Quần Chúng - Tập 4",138000,179000,41000,23
TIKI,nha-sach-tiki,16284262,"Tuổi Thơ Dữ Dội - Tập 2 (Tái Bản 2019)",58000,80000,22000,28
TIKI,nha-sach-tiki,8306438,"Combo Lược Sử Thời Gian và Vũ Trụ Trong Vỏ Hạt Dẻ",206350,206350,0,0
TIKI,nha-sach-tiki,57708766,"Kẻ trừng phạt (Tái Bản 2020)",62500,125000,62500,50
TIKI,nha-sach-tiki,716891,"Mom's Letters: Alphabet",17000,18000,1000,6
TIKI,nha-sach-tiki,2782635,"Nghệ Thuật Quản Lý Tài Chính Cá Nhân",111300,159000,47700,30
TIKI,nha-sach-tiki,93249305,"Tư Duy Nhanh Và Chậm (Bản mới nhất 2020)",201000,269000,68000,25
TIKI,nha-sach-tiki,75615221,"Combo 3 Cuốn Sách Ehon: Ai Giấu Cái Gì Đó (Dành Cho Trẻ Từ 0 - 4 Tuổi)",74100,117000,42900,37
TIKI,nha-sach-tiki,193433940,"Tập luyện cổ họng – 5 phút 1 ngày giúp kéo dài 10 năm tuổi thọ",55400,79000,23600,30
TIKI,nha-sach-tiki,148937423,"Sách: Vì Sao Đơn Giản Lại Hiệu Quả",84500,130000,45500,35
TIKI,nha-sach-tiki,196201375,"Sách - Bình Yên Trong Bão Tố",213750,225000,11250,5
TIKI,nha-cua-doi-song,139815721,"Sào Phơi Giá Rẻ - ko khoen,ko bánh xe,1m",125000,125000,0,0
TIKI,nha-cua-doi-song,159971094,"Bộ 2 hộp vải đựng đồ 7 ngăn mã HQ2 - Combo 2 hộp vải đựng quần áo chia ngăn gọn gàng tiện lợi chất vải Oxford cao cấp miDoctor",150000,250000,100000,40
TIKI,nha-cua-doi-song,185647202,"Tranh Cát Chảy Chuyển Động 3D KUNBE Nhiều Mẫu Trang Trí Nhà Cửa Bàn Làm Việc, Giảm Stress",168000,168000,0,0
TIKI,nha-cua-doi-song,15839139,"Đèn pin Laser Laze MV – 303 (Đen) tặng pin sạc và sạc",108000,108000,0,0
TIKI,nha-cua-doi-song,117318253,"Nệm xếp đa năng Goodnight 70x180cm, Nệm gấp văn phòng, Nệm xếp 3 thiết kế gọn nhẹ, kèm túi đựng (Giao màu ngẫu nhiên)",466000,570000,104000,18
TIKI,nha-cua-doi-song,42491736,"Bút thử nước TDS, dụng cụ đo TDS, máy đo độ cứng của nước - Hàng chính hãng",124000,180000,56000,31
TIKI,nha-cua-doi-song,194465292,"Bình giữ nhiệt LocknLock DIY Strap Tumbler LHC3283 350ml",254000,489000,235000,48
TIKI,nha-cua-doi-song,12736380,"Đồng hồ để bàn led báo thức thông minh",178000,178000,0,0
TIKI,nha-cua-doi-song,73640967,"Miếng lau nhà thay thế Bộ lau nhà KITIMOP-C6 PLUS ( 33 x 12cm)",15000,19000,4000,21
TIKI,nha-cua-doi-song,185004372,"Ly Thủy Tinh Phong Cách Bắc Âu Đế Xoay 170ml - Navivu Rock Glass",45000,45000,0,0
TIKI,nha-cua-doi-song,181909427,"Nồi 2 Tay Cầm Suit LocknLock CSU1202PIK - Màu Pink",578000,1112000,534000,48
TIKI,nha-cua-doi-song,185889866,"[ Mới nhất ] Hashtag Cầm Tay check in đám cưới",28000,28000,0,0
TIKI,nha-cua-doi-song,781987,"Gối Memory Foam 50D Lock & Lock HLW114 (61 x 34 x 10 cm)",475000,791000,316000,40
TIKI,nha-cua-doi-song,83927709,"Bịt Mắt Ngủ Che Mắt Ngủ Có Túi Gel Massage - Giảm Thâm Quầng Mắt - Mẫu Hoạt Hình Mới - Xanh Đen",35000,35000,0,0
TIKI,nha-cua-doi-song,12213522,"Ô dù đi mưa gấp gọn hình gấu Brown",44175,44175,0,0
TIKI,nha-cua-doi-song,98153708,"Chậu Gội Đầu Tại Giường KUNBE, Chậu Gội Đầu Tại Nhà Thông Minh Cho Mọi Người - Tặng Lược Massage Và Cốc Gội Đầu",209000,209000,0,0
TIKI,nha-cua-doi-song,21582013,"Bộ Bịt Mắt Ngủ 3D Tặng Kèm Bịt Tai Chống Ồn Màu Ngẫu Nhiên",45000,45000,0,0
TIKI,nha-cua-doi-song,80757840,"Combo 3 hộp vải đựng đồ đa năng TD2 – Bộ 3 túi vải Thụy Điển không nắp tiết kiệm sang trọng dung tích 24L mỗi hộp - chính hãng",159000,210000,51000,24
TIKI,nha-cua-doi-song,131407862,"ghế văn phòng ghế xoay văn phòng",399000,591000,192000,32
TIKI,nha-cua-doi-song,125658476,"Bình Giữ Nhiệt Kim Cương 1500Ml Inox 304- YOGA QG- Chống Rỉ Set, Nắp Đậy Chặt, Giữ Nhiệt Nóng Lạnh Tốt 6- 8h, Quai Đeo Chắc Chắn, Thiết Kế Sang Trọng, Màu Sắc Thanh Lịch, Tiện Lợi, Pha Lọc Trà, Hàng Chính Hãng",141000,172000,31000,18
TIKI,nha-cua-doi-song,102508672,"Thùng Đựng Rác Thông Minh E1906, Nắp Đóng Mở Một Chạm Tiện Ích, Chất Liệu Nhựa Cao Cấp Chống Nước, Chịu Nhiệt Tốt, Dung Tích 10 Lít - Hàng Nhập Khẩu",229000,360000,131000,36
TIKI,nha-cua-doi-song,75411116,"Lót chân ghế, miếng dán chống trầy, chống rung lắc bàn ghế - Hàng chính hãng",23000,25000,2000,8
TIKI,nha-cua-doi-song,59238383,"Vòi nước đa năng 2 đầu đồng mạ chorme cao cấp mẫu mới 2024 (Hàng chính hãng)",171000,295000,124000,42
TIKI,nha-cua-doi-song,105374376,"Bộ Lõi Lọc Khử Mùi Hôi Lỗ Thoát Sàn Cao Cấp MIFAN - Ngăn chặn mùi hôi cống, chống côn trùng lỗ thoát nước nhà tắm, vệ sinh, bồn rửa - Mẫu mới 2021",50000,50000,0,0
TIKI,nha-cua-doi-song,75354717,"Tủ Quần Áo 2 Buồng 6 Ngăn Tiện Lợi, Tủ Vải 170cm Chất Lượng Cao Chắc Chắn, Vững Chãi - Hàng Chính Hãng miDoctor",240000,295000,55000,19
TIKI,nha-cua-doi-song,149657438,"Tấm Nệm Trải Sàn Gấp Gọn Hàng xuất Nhật",273000,350000,77000,22
TIKI,nha-cua-doi-song,54682452,"Pin vuông 9V Energizer 522 ALKALINE chính hãng ( Mẫu mới )",57000,60000,3000,5
TIKI,nha-cua-doi-song,38114299,"Thanh treo rèm cửa inox đa năng, không cần khoan tường hay bắt vít, thay đổi vị trí linh hoạt HT03",60000,60000,0,0
TIKI,nha-cua-doi-song,77962744,"Kệ nhà tắm, kệ dán tường đựng đồ nhà tắm, đồ bếp, nhà vệ sinh, siêu chịu lực, (không dán lên tường sơn nước, sơn vôi) - Giao màu ngẫu nhiên",42750,45000,2250,5
TIKI,nha-cua-doi-song,45170002,"Tấm Chắn Dầu Mỡ Tiện Dụng Cho Bếp Ga - TC29",14000,15478,1478,10
TIKI,nha-cua-doi-song,177129235,"Bình giữ nhiệt Thermos nút bấm JNL-752 MTB 750ml màu xanh dương",854000,1090000,236000,22
TIKI,nha-cua-doi-song,189157824,"Bộ 8 túi hút chân không tặng kèm bơm hút chân không đựng quần áo, chăn màn, ga gối gọn gàng D Danido",189000,199000,10000,5
TIKI,nha-cua-doi-song,7699064,"Chảo Nhôm Sâu Lòng Chống Dính Lock&Lock Baum Marble 1 Tay Cầm, Nắp Thủy Tinh LBU1285 (28cm)",404000,776000,372000,48
TIKI,nha-cua-doi-song,74859074,"Chuông Cửa Không Dây Thông Minh CTFAST CT - 01 (1 Nút Bấm, 1 Chuông ), Chống Nước, Khoảng Cách Sử Dụng Hiệu Quả 300 mét - Hàng Chính Hãng",135000,169000,34000,20
TIKI,nha-cua-doi-song,38462026,"Đèn Led Trang Trí Bóng Tròn Dài 3M - 20 Bóng Trang Trí Noel Lễ Tết",43900,43900,0,0
TIKI,nha-cua-doi-song,164593190,"Tăm chỉ nha khoa tiệt trùng hộp 50 cây, vệ sinh kẽ răng chân nướu chuyên dụng",4999,4999,0,0
TIKI,nha-cua-doi-song,106338289,"Dép Lỗ Đi Trong Nhà Tắm Chống Trơn Trượt Nhanh Khô, Thoáng Mát, Mẫu Mới Nhất. Dép Cho Cả Gia Đình",95000,155000,60000,39
TIKI,nha-cua-doi-song,252390050,"Gương dán tường 30x30cm LOẠI MỚI",33000,39000,6000,15
TIKI,nha-cua-doi-song,104681142,"(Chọn Loại) Túi Zip PE Trong Suốt 2 Đường Kéo MyJae, Túi Bọc Đồ Ăn, Rau Củ Bảo Quản Trong Tủ Lạnh",66000,99000,33000,33
TIKI,nha-cua-doi-song,75044183,"Đèn Đọc Sách Cao Cấp - Đèn Bàn Làm Việc Sang Trọng - Đèn Ngủ - Đèn Trang Trí - Có Thể Gập Hai Chỗ – 03 Chế Độ Ánh Sáng Vàng Bảo Vệ Mắt Chống Cận Pin Sạc - Hàng Chính Hãng - VinBuy",175000,300000,125000,42
TIKI,nha-sach-tiki,173093879,"Liễu Phàm Tứ Huấn - Tích Tập Phúc Đức, Cải Tạo Vận Mênh (Tái Bản 2022)",45500,59000,13500,23
TIKI,nha-sach-tiki,62373311,"Nồi Niêu Xoong Chảo - Sổ Tay Bếp Núc Của Tôi (Sách Màu)",93000,120000,27000,23
TIKI,nha-sach-tiki,105614631,"Kéo mini tiện lợi 105mm Deli - 5 màu Đen/ Xanh/ Hồng/ Trắng - Dành cho văn phòng, học sinh, sắc bén - 6072",45000,45000,0,0
TIKI,nha-sach-tiki,91625816,"Trên Đỉnh Phố Wall (Tái bản 2021)",139000,219000,80000,37
TIKI,nha-sach-tiki,192333857,"Ông già và biển cả",131000,200000,69000,35
TIKI,nha-sach-tiki,2583037,"Series Địch Công Kỳ Án: Ngự Châu Án",46000,99000,53000,54
TIKI,nha-sach-tiki,11475738,"Combo 2 Cuốn: Kế Toán Tài Chính (Tập 1 & 2)",495000,750000,255000,34
TIKI,nha-sach-tiki,43665704,"Combo Chiến thắng kì thi 9 vào 10 chuyên môn Vật Lí( Tập 1 - Tập 2)",206000,358000,152000,42
TIKI,nha-sach-tiki,44911496,"Little Stories - The Best Book For Your Leisure Time",41800,65000,23200,36
TIKI,nha-sach-tiki,5743619,"Học Tiếng Anh Siêu Thú Vị : Sách Luyện - Tập 2",13000,24000,11000,46
TIKI,nha-sach-tiki,73176340,"Combo 10 cuốn Truyện Ngụ ngôn Aesop Song ngữ - Truyện kể mầm non (giao ngẫu nhiên)",62400,120000,57600,48
TIKI,nha-sach-tiki,31993279,"4000 Từ Vựng Tiếng Anh Thường Dùng Nhất (Kèm CD Hoặc File MP3)",186000,248000,62000,25
TIKI,nha-sach-tiki,53974339,"Combo 3 Cuốn Di Sản Của GS. Phan Văn Trường Để Lại Cho Thế Hệ Sau: Một Đời Thương Thuyết + Một Đời Quản Trị + Một Đời Như Kẻ Tìm Đường (Cả Đời Trên Thương Trường)",433000,510000,77000,15
TIKI,nha-sach-tiki,52805069,"Những Vị Thần Bắc Âu",122000,175000,53000,30
TIKI,nha-sach-tiki,19662170,"Tên Tôi Là Đỏ (Tái Bản 2019)",113000,155000,42000,27
TIKI,nha-sach-tiki,1205103,"Free Marketing  –  101 Ý Tưởng Phát Triển Doanh Nghiệp Với Chi Phí Thấp (Tái Bản 2017)",135400,199000,63600,32
TIKI,nha-sach-tiki,27639420,"Toán Song Ngữ Tiền Tiểu Học - Sách Học 2",32400,36000,3600,10
TIKI,nha-sach-tiki,191571444,"Anh Em Phi Hành Gia - Tập 30",45000,45000,0,0
TIKI,nha-sach-tiki,170352757,"Người Sống Cũng Phải Hồi Sinh",89100,129000,39900,31
TIKI,nha-sach-tiki,136939563,"Ho’Oopnopono: Phục Hồi Tự Nhiên, Chữa Lành Cuộc Sống, Hoàn Thiện Cuộc Đời",46100,66000,19900,30
TIKI,nha-sach-tiki,66398385,"Hành Trình Sinh Tử",75300,109000,33700,31
TIKI,nha-sach-tiki,185415267,"Bút gel B màu Pastel Thiên Long Flexoffice Pazto FO-GELB039/VN - Mực xanh (5 cây)",41000,50000,9000,18
TIKI,nha-sach-tiki,187503389,"Thiên Thần Diệt Thế - Seraph Of The End - Tập 24",22000,22000,0,0
TIKI,nha-sach-tiki,157412117,"Chưa Kịp Lớn Đã Phải Trưởng Thành",63000,79000,16000,20
TIKI,nha-sach-tiki,176132390,"Truyện Thiếu Nhi Hạt Giống Tâm Hồn - Lễ Tạ Ơn",43100,56000,12900,23
TIKI,nha-sach-tiki,170298048,"Dịch Bệnh Atlantis",150000,195000,45000,23
TIKI,nha-sach-tiki,90480255,"Sách - Lão Tử Đạo Đức kinh - Nguyễn Hiến Lê ( Tuyển Tập Bách Gia Tranh Minh)",112000,159000,47000,30
TIKI,nha-sach-tiki,27639410,"Toán Song Ngữ Tiền Tiểu Học - Sách Học 3",28100,36000,7900,22
TIKI,nha-sach-tiki,1750249,"Phân Tích Chứng Khoán",301400,499000,197600,40
TIKI,nha-sach-tiki,194959710,"Đâu Chỉ Độc Mình Tôi Đơn Độc",68000,88000,20000,23
TIKI,nha-sach-tiki,4219547,"Người đàn ông đánh bại mọi thị trường - A man for all markets",349000,349000,0,0
TIKI,nha-sach-tiki,189940682,"Hãy Sống Cuộc Đời Như Bạn Muốn  (Tái bản)",69420,99000,29580,30
TIKI,nha-sach-tiki,89222118,"Sổ Vẽ Phác Thảo Deli 40 Trang - Gáy Lò Xo - Khổ Ngang A4/B5 - Giấy Định Lượng 100Gsm / 110Gsm - 7696 / 7697 / 73632",29000,57600,28600,50
TIKI,nha-sach-tiki,173718231,"Combo 2 Cuốn Luyện viết Lớp 1 - Chương trình SGK Cánh diều",31200,60000,28800,48
TIKI,nha-sach-tiki,167019786,"Cơ Thể Tự Chữa Lành - Thanh Lọc Để Phục Hồi",221300,295000,73700,25
TIKI,nha-sach-tiki,13362558,"Làm sạch tâm hồn - Các bài tập thiền",47300,69000,21700,31
TIKI,nha-sach-tiki,34750208,"Ngụ Ngôn Song Ngữ Anh - Việt: Con Quạ Thông Minh (Tái Bản 2019)",16800,28000,11200,40
TIKI,nha-sach-tiki,193895765,"Lập Kế Hoạch Công Việc chu Trình PDCA (Tái Bản)",103700,149000,45300,30
TIKI,nha-sach-tiki,186262546,"BILLY SUMMERS – VỤ ÁM SÁT CUỐI CÙNG",209300,299000,89700,30
TIKI,nha-sach-tiki,75696174,"Vẫy Vùng Giữa Vũng Lầy",140000,140000,0,0
TIKI,nha-sach-tiki,19963125,"Thiên Tài Bên Trái, Kẻ Điên Bên Phải",155730,179000,23270,13
TIKI,nha-sach-tiki,165089915,"7 Câu Hỏi "Thần Kỳ" Của Mọi Sếp Giỏi (Tái bản)",96500,150000,53500,36
TIKI,nha-sach-tiki,170706992,"Thám Tử Lừng Danh Conan: Hồ Sơ Tuyệt Mật - Shuichi Akai & Toru Amuro",112000,120000,8000,7
TIKI,nha-sach-tiki,34340291,"Não Bộ Kể Gì Về Bạn",98400,149000,50600,34
TIKI,nha-sach-tiki,73553837,"Ngọc Sáng Trong Hoa Sen (Tái Bản 2020)",99300,128000,28700,22
TIKI,nha-sach-tiki,174449880,"Một Nghiên Cứu Về Giác Tính Con Người 
 (An Enquiry Concerning Human Understanding)",113000,145000,32000,22
TIKI,nha-sach-tiki,27957156,"Ehon Thông Minh Cho Trẻ Mẫu Giáo : Xếp Hàng Làm Gì Thế?",38000,52000,14000,27
TIKI,nha-sach-tiki,171549938,"Quy Tắc Làm Việc Của Google (Tái Bản)",139000,219000,80000,37
TIKI,nha-sach-tiki,190708160,"Nhất Quỷ Nhì Ma, Thứ Ba Takagi Tập 14 [Tặng Kèm Postcard]",30000,30000,0,0
TIKI,nha-sach-tiki,184779711,"Bách Khoa Cho Trẻ Em – Bách Khoa Vũ Trụ",131000,180000,49000,27
TIKI,nha-sach-tiki,48629535,"Ngày Xưa Có Một Chuyện Tình (Tái Bản)",87000,125000,38000,30
TIKI,nha-sach-tiki,53486723,"Vô Cùng Tàn Nhẫn Vô Cùng Yêu Thương 3 - Phương Pháp Dạy Con Của Một Người Cha Do Thái",69020,129000,59980,46
TIKI,nha-sach-tiki,16158716,"Cách Nuôi Dạy Những Đứa Trẻ Dễ Cáu Giận, Khó Bảo",64000,89000,25000,28
TIKI,nha-sach-tiki,199972960," Phong Bì Trắng A4 ĐL120,A5 ĐL 100, A6 ĐL 100 Xuất Xứ Việt Nam Quy Cách Tập 100 Chiếc",45000,45000,0,0
TIKI,nha-sach-tiki,129381392,"Cuốn Sách Tranh Đầu Tiên Về Quốc Kỳ (Ehon Nhật Bản)",73800,99000,25200,25
TIKI,nha-sach-tiki,860415,"Cổ Tích Việt Nam - Sự Tích Đầm Mực - Legend Of The Ink Pond (Song Ngữ Anh - Việt)",19200,32000,12800,40
TIKI,nha-sach-tiki,169621651,"Nam Đình Cốc Vi - Tập 6",94300,109000,14700,13
TIKI,nha-sach-tiki,85258271,"Bút Gel xóa được Mondee Thiên Long TP-GELE003",14000,14000,0,0
TIKI,nha-sach-tiki,11954630,"Combo Quản Lý Nghiệp (Tái Bản) + Năng Đoạn Kim Cương (Tái Bản 2018)",183040,208000,24960,12
TIKI,nha-sach-tiki,730678,"Tuần Của Bé Tháng 7 - Bé Hòa Đồng",11500,23000,11500,50
TIKI,nha-sach-tiki,4687535,"Series Thám Tử Kỳ Phát: Kỳ Phát Giết Người",51000,107000,56000,52
TIKI,nha-sach-tiki,186880508,"Slam Dunk - Deluxe Edition Tập 9 [Tặng Kèm Obi + Bìa Áo Limited Ngẫu Nhiên]",60000,60000,0,0
TIKI,nha-sach-tiki,68586415,"Cao Thủ Đổi Đen Thay Trắng - Tập 1 (Dành Cho Lứa Tuổi 18+)",112000,149000,37000,25
TIKI,nha-sach-tiki,100395623,"Bước Đi Ngẫu Nhiên Trên Phố Wall (Tái Bản)",156400,249000,92600,37
TIKI,nha-sach-tiki,44858499,"Dạy Con Theo Phương Pháp Montessori - Dậy Nào Bé Ơi",8000,13600,5600,41
TIKI,nha-sach-tiki,48212494,"How To Crack The IELTS Speaking Test - Part 1 (Tái Bản)",185400,299000,113600,38
TIKI,nha-sach-tiki,20104310,"Hệ thống bán hàng đỉnh cao - The Snowball System",328000,328000,0,0
TIKI,nha-sach-tiki,67835582,"Chiến Quốc Tung Hoành - Thế Cục Quỷ Cốc Tử: Tập 10",126000,195000,69000,35
TIKI,nha-sach-tiki,196830267,"Bá Tước Dracula (Bìa Cứng) - Tái Bản",130000,175000,45000,26
TIKI,nha-sach-tiki,50322156,"Thấu Hiểu Tiếp Thị Từ A Đến Z - 80 Khái Niệm Nhà Quản Lý Cần Biết (Tái Bản 2020)",66300,115000,48700,42
TIKI,nha-sach-tiki,83680361,"ISMS - Hiểu Về Nghệ Thuật Hiện Đại",142100,239000,96900,41
TIKI,nha-sach-tiki,167685123,"Sách Vượt Bẫy Cảm Xúc",131000,188000,57000,30
TIKI,nha-sach-tiki,3283713,"Phong Thủy Cho Người Mua Nhà Chung Cư",399000,399000,0,0
TIKI,nha-sach-tiki,190601856,"Tâm",61800,89000,27200,31
TIKI,nha-sach-tiki,146846342,"Sapiens - Lược Sử Loài Người Bằng Tranh - Tập 2 : Những Trụ Cột Của Nền Văn Minh",228100,345000,116900,34
TIKI,nha-sach-tiki,1475793,"Little Stories - To Make You A Good Person",48100,65000,16900,26
TIKI,nha-sach-tiki,174037877,"Điểm Dối Lừa ( Tái Bản)",132800,205000,72200,35
TIKI,nha-sach-tiki,105614601,"Cặp đựng tài liệu A4 Deli - 8 ngăn phân trang - file lưu trữ tài liệu - linfini - Xanh Dương / Trắng - 72456",45000,88200,43200,49
TIKI,nha-sach-tiki,73553846,"Sức Mạnh Niềm Tin (Tái Bản 2020)",67300,88000,20700,24
TIKI,nha-sach-tiki,2245453,"Đúng Việc (Tái Bản)",99500,99500,0,0
TIKI,nha-cua-doi-song,21459762,"PHÂN TRÙN QUẾ HỮU CƠ DÙNG CHO RAU SẠCH VÀ HOA KIỂNG - 2 KG",15900,15900,0,0
TIKI,nha-cua-doi-song,176309828,"Túi thực phẩm Inochi - shinsen 25 x 35cm",35000,35000,0,0
TIKI,nha-cua-doi-song,32014487,"Chăn Nỉ Văn Phòng Cao Cấp (160cm * 120cm)",129000,179000,50000,28
TIKI,nha-cua-doi-song,87966539,"Sọt rác lưới tròn 26x23x18.5cm - Màu Ngẫu Nhiên",76000,120000,44000,37
TIKI,nha-cua-doi-song,7202377,"Bộ 3 Lõi Lọc Nước Máy Tiêu Chuẩn Barrier",504000,660000,156000,24
TIKI,nha-cua-doi-song,87982701,"Pin Nút Áo CR2032 BR2032 DL2032 ECR2032 Lithium 3V CR 2032 220mAh (5 Viên) Pin Cho Đồng Hồ Điện Tử/ Đồ Chơi Điều Khiển Từ Xa/ Đèn Xe Đạp",26000,39000,13000,33
TIKI,nha-cua-doi-song,73230427,"Chill Party-Đèn Chiếu Ngàn Sao 6 phong cách kiêm đèn ngủ xoay tự động, tích hợp phát nhạc bằng Bluetooth nhiều màu sắc tuyệt đẹp, sạc lại bằng USB",380000,380000,0,0
TIKI,nha-cua-doi-song,118451214,"Ổ cắm điện LiOA đa năng - Ổ on/off 4 lỗ, 6 lỗ mỗi ổ 1 công tắc dây dài 3m",139000,139000,0,0
TIKI,nha-cua-doi-song,191918107,"Bình lắc LocknLock Balance Shake It Bottle HAP949BLK 800ml - Màu",139000,267000,128000,48
TIKI,nha-cua-doi-song,59425995,"Bộ Ga Gối Cotton Tici Kẻ LIDACO Cao Cấp - Kẻ Cam Ghi",159000,229000,70000,31
TIKI,nha-cua-doi-song,72829989,"Lá diệp phật - Ngọc Quý Gemstones",39000,39000,0,0
TIKI,nha-cua-doi-song,73464817,"Kệ gia vị dán tường dài 30/40/50cm sơn đen tĩnh điện Vando chính hãng - kèm keo chuyên dụng kệ treo tường bằng thép carbon không gỉ, siêu chịu lực 30kg",119000,141000,22000,16
TIKI,nha-cua-doi-song,42759652,"Chốt cửa dây xích an toàn inox 304 gắn cửa HOBBY Home Decor KLC1 bảo vệ phòng cho chung cư phòng ngủ không rỉ sét",82000,129000,47000,36
TIKI,nha-cua-doi-song,181223364,"Bộ vòi xịt vệ sinh toilet kèm giá treo và dây lò xo co giãn HOBBY Home Decor VSR2 inox 304 ren chờ 21mm",144000,229000,85000,37
TIKI,nha-cua-doi-song,186094219,"Khăn Tắm Nén Bằng Cotton Tiện Lợi Dùng Một Lần 70*140 cm - Khăn Nén Du Lịch - Khăn Nén Spa",13000,14111,1111,8
TIKI,nha-cua-doi-song,171022457,"Dầu bôi trơn thiết bị gia dụng đa năng dùng trong gia đình - Dầu bôi trơn động cơ, chống rỉ bánh răng cơ khí",24000,24000,0,0
TIKI,nha-cua-doi-song,137176118,"100gram Túi Zip trong suốt đáy đứng- túi đựng thực phẩm khô, nước - size",38000,40000,2000,5
TIKI,nha-cua-doi-song,27986931,"Kệ Sách Để Bàn Tiện Ích - Vân gỗ",68000,99000,31000,31
TIKI,nha-cua-doi-song,55465365,"Pin Max 8 + 4 Viên Energizer E92 BP8+4 AAA - Hàng Chính Hãng Model 2020",138000,145000,7000,5
TIKI,nha-cua-doi-song,657076,"Màng Bọc Thực Phẩm PE Ringo 150 (30cm x 150m)",103000,103000,0,0
TIKI,nha-cua-doi-song,81936258,"Hộp đựng quần áo gấp gọn có nắp Màu kem Morning House  - SIZE S",50000,50000,0,0
TIKI,nha-cua-doi-song,46327991,"Hộp Nhựa Đựng Thực Phẩm Trong Suốt GAGI Mã GH01 Nhựa PP Bền Bỉ, Sử Dụng Cho Cả Lò Vi Sóng Không Bám Mùi Dễ Dàng Vệ Sinh - Hàng Chính Hãng",44000,69000,25000,36
TIKI,nha-cua-doi-song,21389285,"Vỉ 20 viên pin cmoss CR2032",36190,36190,0,0
TIKI,nha-cua-doi-song,78904788,"Gối Lót Ngồi Y Tế Hình Chữ O Bằng Cao Su Non Phòng Bệnh Trĩ Giảm Đau Xương Cụt",205000,205000,0,0
TIKI,nha-cua-doi-song,167041804,"Ly rock thủy tinh pha lê đế xoay 360 độ, cốc uống whisky rượu tây 160ml wine glass",35000,35000,0,0
TIKI,nha-cua-doi-song,88914388,"Bộ 04 chân đế cao su chống rung máy giặt - HT SYS - Đế chống rung máy giặt - Đế chống ồn máy giặt, máy sấy,tủ lạnh, bàn ghế + Sét 3 móc dính dán tường vàng tài lộc HT SYS",139000,139000,0,0
TIKI,nha-cua-doi-song,169696716,"Bình Đựng Nước 2L Dễ Thương Kèm Ống Hút , Có Vạch Báo Giờ Uống Nước - Hàng Loại 1 Chính Hãng",124000,218000,94000,43
TIKI,nha-cua-doi-song,138380998,"Gói 20 Chiếc Khăn Cotton Nén Sử Dụng Một Lần Tiện Dụng Cho Du Lịch Khổ 20x24cm Khăn Uớt Viên Kẹo",17000,35000,18000,51
TIKI,nha-cua-doi-song,201687096,"[TikiNow giao hàng] Ghế chỉnh dáng ngồi đúng Roichen - Hàn Quốc. Sản phẩm dành cho Nữ , Sản phẩm nhập khẩu Hàn Quốc (Made in Korea). Hàng chính hãng Roichen",785000,898000,113000,13
TIKI,nha-cua-doi-song,134360720,"Bộ 8 Pin AAA ( R03NT/2S ) Panasonic 1,5V Không Chì - Hàng Chính Hãng",40000,45000,5000,11
TIKI,nha-cua-doi-song,29339320,"Công tắc điều khiển từ xa Honest HT-6220KGD công suất lớn 220v 40A 1000m dùng cho máy bơm ,moto điện..",159000,159000,0,0
TIKI,nha-cua-doi-song,55427978,"Combo 100 Túi Lọc Rác cho bồn rửa chén bát ",15780,15780,0,0
TIKI,nha-cua-doi-song,68391419,"ĐẦU VÒI RỬA CHÉN LỌC NƯỚC TĂNG ÁP 360 ĐỘ - giao màu ngẫu nhiên",7600,7600,0,0
TIKI,nha-cua-doi-song,73314056,"Lọ xay tiêu cầm tay nắp viền inox 304 lọ thủy tinh Hobby Home Decor XT mẫu thon cao và mẫu thấp tùy chọn",54000,99000,45000,45
TIKI,nha-cua-doi-song,174262175,"Bát Sen Tắm Của Vòi Tắm Hoa Sen Nóng Lạnh Pimisi Với Tay Sen Bằng Nhựa Cao Cấp Mạ Xi Cr/Ni Màu Inox Sáng Bóng Kiểu Vuông Bo Tròn Góc - Ổn Định Nhiệt Độ Nước Nóng Lạnh Theo Công Nghệ Đầu Phun Tăng Áp Dạng Phun Mưa Tiết Kiệm Nước | Hàng Chính Hãng",124000,200000,76000,38
TIKI,nha-cua-doi-song,90530495,"Đèn Pixar, Đèn Bàn Học Chống Cận Thị, Đèn Đọc Sách, Đèn Làm Việc Bảo Vệ Mắt - Hàng Chính Hãng Moontronics MT01",255000,310000,55000,18
TIKI,nha-cua-doi-song,205819517," Bóng đèn Led thông minh Xiaomi Yeelight Bulb W3 đui xoắn E27 (RGB 16 triệu màu) - tích hợp Razer Chroma",261000,350000,89000,25
TIKI,nha-cua-doi-song,21418511,"Hộp đựng bông tẩy trang và tăm bông 2 ngăn mica cao cấp 14.5 x 10.5 x 13 cm",85000,85000,0,0
TIKI,nha-cua-doi-song,20104505,"Hộp 3 ống hút inox và cọ rửa",43000,43000,0,0
TIKI,nha-cua-doi-song,142261128,"Đệm Lót Ghế Ngồi NOOZ Home Goods Gối Lót Ghế Ngồi Bệt Memory Foam Giúp Chống Đau Lưng, Đau Xương Cụt, Đau Thần Kinh Tọa Ruột Đệm Cao Su Non Danh Cho Dân Văn Phòng",339000,450000,111000,25
TIKI,nha-cua-doi-song,3677753,"Bình Lọc Nước BRITA Flow Basic Blue - 8.2L (Kèm Maxtra Plus) - Hàng Chính Hãng",2499000,2499000,0,0
TIKI,nha-cua-doi-song,52297710,"Bộ 25 Móc dán tường, dính tường trong suốt Siêu chắc, siêu chịu lực loại 10kg",11968,11968,0,0
TIKI,nha-cua-doi-song,7699062,"Chảo Nhôm Chống Dính Lock&Lock Baum Marble 1 Tay Cầm LBU1283C (28cm)",295000,567000,272000,48
TIKI,nha-cua-doi-song,127693039,"[Thùng 1, 5, 10, 18 Lít] Keo Sơn Chống Thấm Sàn Mái Lộ Thiên TAIKO NITTON (Gốc Acrylic) - Tặng Kèm Vải Kết Cấu Và Chổi Lăn Sơn - Chống Thấm Sàn Mái, Máng Xối, Ban Công Lô Gia, Bể Nước, Bể Cá, Bề Mặt Cát Xi Măng (Hiệu quả hơn khi pha với Xi Măng",249600,320000,70400,22
TIKI,nha-cua-doi-song,11341623,"Hộp 40 viên pin 2A Maxell",122000,130000,8000,6
TIKI,nha-cua-doi-song,58206715,"Bản lề tự đóng cửa tự động cho cửa hàng, văn phòng, nhà ở",38900,38900,0,0
TIKI,nha-cua-doi-song,31895999,"Đầu Vòi Lọc Sạch Nước Than Hoạt Tính",19400,19400,0,0
TIKI,nha-cua-doi-song,74615464,"Phin pha cà phê nhôm Trung Nguyên( Không Hoa Văn)",30000,30000,0,0
TIKI,nha-cua-doi-song,173717336,"Túi Hộp Vải Lưới Đựng Đồ Lót, Tất Vớ Nhiều Ngăn - Khay Xếp Chia Ô Đựng Đồ Để Tủ Quần Áo Tiện Ích",24000,24000,0,0
TIKI,nha-cua-doi-song,67416013,"CỐC GIỮ NHIỆT ELMICH INOX 304 470ML EL3668",254000,399000,145000,36
TIKI,nha-cua-doi-song,185654331,"Hộp, Lọ, Hũ Thủy Tinh Nắp Gỗ JIMMEAL 200ml 350ml 500ml 750ml 1000ml 1200ml 1600ml",32000,32000,0,0
TIKI,nha-cua-doi-song,106281034,"Bình nước thủy tinh Luminarc Quadro 1.7L -LUQUG2668",154000,205000,51000,25
TIKI,nha-cua-doi-song,121367420,"Gối ngồi lót mông y tế chống trĩ, đau xương cụt, ê mỏi mông cho dân văn phòng, lái xe, thu ngân, sinh viên...Chính hãng Ema - Hàng nhập khẩu",550000,550000,0,0
TIKI,nha-cua-doi-song,53185365,"Túi Ly Giữ Nhiệt Rinfere - Sản Phẩm Handmade Phù Hợp Với Ly Giữ Nhiệt Rinfere, Lock and Lock, Yeti - Free Size",104000,104000,0,0
TIKI,nha-cua-doi-song,187622257,"Bộ 3 Kệ Trang Trí Treo Góc Tường SIB DECOR Hình Cung Tròn",149000,149000,0,0
TIKI,nha-cua-doi-song,164848242,"Chậu gội đầu tại giường cho người già, trẻ nhỏ, người bệnh... màu sắc giao ngẫu nhiên- Hàng chính hãng",124000,130000,6000,5
TIKI,nha-cua-doi-song,167030045,"Áo Nệm, Ga bọc Nệm Toppper 2 Mặt Có Khóa Kéo, Kich Thước 1mx2m,1m2x2m, 1m4x2m, 1m6x2m, 1m8x2m",145000,145000,0,0
TIKI,nha-cua-doi-song,181909425,"Nồi 1 Tay Cầm Suit LocknLock CSU1181PIK (18cm) - Màu Pink",491000,945000,454000,48
TIKI,nha-cua-doi-song,38666598,"Túi Đựng Ly Giữ Nhiệt Lớn 900ml Nhiều Mẫu",40000,40000,0,0
TIKI,nha-cua-doi-song,800795,"Bình đựng thức ăn giữ nhiệt 1800ml EL3128",699000,1390000,691000,50
TIKI,nha-cua-doi-song,116244976,"Túi Đựng Hộp Cơm Grepaco Giữ Nhiệt Nóng Lạnh Đựng Đồ Thức Ăn Văn Phòng, Du Lịch – Vải Bố Canvas, Kích Thước To (Cỡ Lớn), Kiểu Dáng Giỏ Xách Thời Trang Nam Nữ - Tặng Túi Đựng Muỗng Nĩa",149000,149000,0,0
TIKI,nha-cua-doi-song,155546820,"Hộp nhựa đựng thực phẩm tủ lạnh 2 lớp Homepower ghi chú thời gian bảo quản thông minh kèm rổ thoát nước tiện lợi - Cao cấp",89000,89000,0,0
TIKI,nha-cua-doi-song,84953200,"Kệ đựng dụng cụ rửa chén dán tường Hobby Home Decor KRC6 inox 304 có miếng dán",173000,279000,106000,38
TIKI,nha-cua-doi-song,141971329,"Túi Đựng Hộp Cơm Grepaco Giữ Nhiệt Nóng Lạnh Dạng Đứng Có Ngăn Phụ Đựng Đồ Thức Ăn Văn Phòng, Du Lịch – Vải Bố Canvas, Kích Thước Size Vừa, Kiểu Giỏ Xách Thời Trang Nam Nữ - Tặng Túi Đựng Muỗng Nĩa - Hàng Chính Hãng",69000,69000,0,0
TIKI,nha-cua-doi-song,11710987,"Combo 10 cuộn keo lụa vặn ren vòi nước, ren ống cao cấp (Cao su non, băng tan) ",33000,38000,5000,13
TIKI,nha-cua-doi-song,91546481,"️ Kệ nhà bếp gấp gọn đa năng TI-KE001 - Tháo ra dùng ngay được",401000,433900,32900,8
TIKI,nha-cua-doi-song,149959628,"Cmbo 6 Cuộn Túi Đựng Rác Gia Đình, Bao Đựng Rác Văn Phòng, Trường Học Tiện Lợi Màu Đen Đầy Đủ 3 Size Tiểu Trung Đại - Chính Hãng MINIIN",45000,45000,0,0
TIKI,nha-cua-doi-song,113899477,"Đèn học để bàn, đèn đọc sách LED tích điện di động Homepower gập 2 chỗ - 3 chế độ ánh sáng vàng bảo vệ mắt, chống cận Pin 2500mAh",179000,179000,0,0
TIKI,nha-cua-doi-song,160909295,"0,5KG - 1KG TÚI ZIP LỤA MỜ và TRONG Túi Zip lock LỤA MỜ có khoá kéo, túi zip đựng quần áo, khoá chắc chắn",65000,65000,0,0
TIKI,nha-cua-doi-song,149242704,"Combo 20 Móc treo ảnh gắn tường, móc treo ảnh cưới ôm sát tường decor rất đẹp, không cần khoan đục - Hàng chính hãng",33250,35000,1750,5
TIKI,nha-cua-doi-song,198214329,"Combo 2 bộ chuyển đổi 3 chấu thành 2 chấu phích tròn Barwell - Chính hãng, giao màu ngẫu nhiên",32200,35000,2800,8
TIKI,nha-cua-doi-song,105026602,"Chuông báo động, còi báo động dành cho người lớn tuổi, người bệnh ",234060,249000,14940,6
TIKI,nha-cua-doi-song,13619778,"Đồng Hồ Treo Tường P1 (25cm) - Màu ngẫu nhiên",99000,99000,0,0
TIKI,nha-cua-doi-song,274121804,"Ruột Gối Ôm Lông Vũ Thuần Việt - Sợi Lông Vũ Nhân Tạo Microfiber Êm Ái Mềm Mịn - KT 20x100cm",340000,550000,210000,38
TIKI,nha-cua-doi-song,79971957,"Bộ Chăn Gối Văn Phòng 3 IN 1 Hình Thú Mặc Áo Hà Mã, Bò Vàng Siêu Tiện Lợi- Bò áo xám",219000,219000,0,0
TIKI,nha-cua-doi-song,51406882,"Bộ 10 miếng xốp dán tường giả gạch 3D 70x77cm",104000,104000,0,0
TIKI,nha-cua-doi-song,198508670,"Đèn LED Mini Móc Khóa - Đèn Pin COB - Đèn Pin Dã Ngoại - Sạc USB Tiện Dụng- Kiêm hộp quẹt",48510,49000,490,1
TIKI,nha-cua-doi-song,162406191,"Giấy lau mặt dùng 1 lần khăn mặt cotton khô cuộn giấy tẩy trang lau khô/lau ướt",14900,28500,13600,48
TIKI,nha-cua-doi-song,403497,"Đèn Diệt Côn Trùng Well DS-D6",625000,786000,161000,20
TIKI,nha-cua-doi-song,140746932,"Bàn Gấp Treo Tường Đầy Đủ Phụ Kiện và Hướng Dẫn Đi Kèm",165000,165000,0,0
TIKI,nha-sach-tiki,48659055,"Cuộc Sống "Đếch" Giống Cuộc Đời",62500,90000,27500,31
TIKI,nha-sach-tiki,181997205,"Nhập môn thuật toán",215000,215000,0,0
TIKI,nha-sach-tiki,184790643,"Nền kinh Tế Trải Nghiệm",185400,299000,113600,38
TIKI,nha-sach-tiki,188551111,"Tiệm Trừ Yêu Kì Ảo - Tập 15",33000,35000,2000,6
TIKI,nha-sach-tiki,28285288,"Little Stories - To Change Your Life",41800,65000,23200,36
TIKI,nha-sach-tiki,58444919,"Lời Nguyện Cầu Chernobyl (Biên Niên Sử Của Tương Lai)",127000,170000,43000,25
TIKI,nha-sach-tiki,112331969,"Quiz! Khoa Học Kì Thú: Thực Phẩm Dinh Dưỡng",49100,68000,18900,28
TIKI,nha-sach-tiki,184633072,"Tư Trị Thông Giám - Tập 8",188000,286000,98000,34
TIKI,nha-sach-tiki,118124353,"Thức Tỉnh Điều Vô Hình (Hành Trình Khám Phá Tâm Linh)",95600,138000,42400,31
TIKI,nha-sach-tiki,1028645,"Như Mây Thong Dong",57000,90000,33000,37
TIKI,nha-sach-tiki,167148807,"Tâm Lý Học Nói Gì Về Ấn Tượng Ban Đầu",89100,126000,36900,29
TIKI,nha-sach-tiki,76776247,"Hà Nội Bảo Thế Là Thường (Bìa Mềm)(Tản Văn)",96500,108000,11500,11
TIKI,nha-sach-tiki,71156902,"Máy Tính CASIO FX570ESPLUS-NEW (TL)",460000,460000,0,0
TIKI,nha-sach-tiki,9688926,"Phát Triển Tư Duy Đột Phá Giải Bài Tập Tài Liệu Dạy - Học Vật Lí Lớp 8",80400,134000,53600,40
TIKI,nha-sach-tiki,1534615,"Giáo Trình Chuẩn HSK 5 Bài Tập (Tập 1)",141000,188000,47000,25
TIKI,nha-sach-tiki,116397383,"Omoiyari - Nghệ Thuật Đối Nhân Xử Thế Của Người Nhật",119000,142000,23000,16
TIKI,nha-sach-tiki,186265470,"Theo Dấu Chân Bác Hồ",59100,65000,5900,9
TIKI,nha-sach-tiki,3136211,"Bắt Đầu Với Câu Hỏi Tại Sao? ( Tái Bản )",99501,99501,0,0
TIKI,nha-sach-tiki,157169477,"Hộp Đựng Bút Viết Đa Năng Grepaco Bằng Vải Bố Canvas Tote Đẹp Nhiều Ngăn Dạng Túi Đựng Dụng Cụ Đồ Dùng Học Tập, Phụ Kiện Học Sinh, Sinh Viên, Đồ Cá Nhân Văn Phòng – Hàng Chính Hãng",49000,49000,0,0
TIKI,nha-sach-tiki,138342170,"Sức Mạnh Của Sự Tử Tế (Tái bản năm 2020)",88000,104000,16000,15
TIKI,nha-sach-tiki,49747011,"Nghĩ Từ Trái Tim (Tái Bản 2020)",42500,50000,7500,15
TIKI,nha-sach-tiki,485326,"Những Cuộc Phiêu Lưu Của Sherlock Holmes",63200,79000,15800,20
TIKI,nha-sach-tiki,462169,"Đồng Hồ Angrybirds Năng Động",30000,30000,0,0
TIKI,nha-sach-tiki,192692429,"Thức Tỉnh",94800,139000,44200,32
TIKI,nha-sach-tiki,51348621,"Bỉ Vỏ (Tái Bản)",36500,50000,13500,27
TIKI,nha-sach-tiki,77111961,"Bộ 5 thiệp vuông 12cm SDstationery LIVE GREEN sinh nhật, tình bạn, tình yêu, chúc mừng, truyền cảm hứng",92340,97200,4860,5
TIKI,nha-sach-tiki,34749958,"Ngụ Ngôn Song Ngữ Anh - Việt: Cừu Non Nhanh Trí (Tái Bản 2019)",14000,28000,14000,50
TIKI,nha-sach-tiki,102566681,"Làm Quen Với Môn Cắt Thủ Công",70500,89000,18500,21
TIKI,nha-sach-tiki,11743071,"Bộ gương lược bỏ túi mini hình chiếc bánh cookie - màu",40000,45000,5000,11
TIKI,nha-sach-tiki,56111649,"Dây Đay Thừng Trang Trí Thủ Công Handmade 150 Mét",36000,125000,89000,71
TIKI,nha-sach-tiki,46332534,"Sherlock Holmes Toàn Tập (3 Tập - Hộp Đứng) (Bìa Mềm)(Tái Bản)",325000,495000,170000,34
TIKI,nha-sach-tiki,109310241,"7 Chiến Lược Thịnh Vượng Và Hạnh Phúc (Tái Bản)",56100,85000,28900,34
TIKI,nha-sach-tiki,2583031,"Bé Thông Thái",11500,23000,11500,50
TIKI,nha-sach-tiki,192583632,"Lốc 10 Vở (Tập) Ô ly Siêu nhí Cao cấp 80 trang (4 ô ly - Giao mẫu ngẫu nhiên)",95250,127000,31750,25
TIKI,nha-sach-tiki,22099041,"KẸP BẤM 1 LỖ KIM LOẠI",32000,32000,0,0
TIKI,nha-sach-tiki,190194623,"Không Phải Sói Nhưng Cũng Đừng Là Cừu",111360,128000,16640,13
TIKI,nha-sach-tiki,184594032,"Không gia đình (Tái bản)",119250,159000,39750,25
TIKI,nha-sach-tiki,98355902,"Gọt Bút Chì Điện Tự Động Deli - 1 Chiếc - 502",135000,279000,144000,52
TIKI,nha-sach-tiki,66452062,"Trái Tim Của Brutus",98000,138000,40000,29
TIKI,nha-sach-tiki,184476623,"Bút dạ quang màu Pastel Thiên Long Flexoffice Pazto FO-HL009/VN - Bút dạ quang rửa được - Không để lại vết khi Photocopy",11000,13000,2000,15
TIKI,nha-sach-tiki,165030720,"Miko! Tất Tần Tật - Best Selection",21600,25000,3400,14
TIKI,nha-sach-tiki,171549998,"Never Get Bored - Tí Ta Tí Toáy Ngoài Trời",120000,155000,35000,23
TIKI,nha-sach-tiki,15634598,"Who? Chuyện Kể Về Danh Nhân Thế Giới: Coco Chanel (Tái Bản 2019)",41100,55000,13900,25
TIKI,nha-sach-tiki,103390740,"Sách Luật Kinh Doanh Bất Động Sản Hiện Hành (Sửa Đổi, Bổ Sung Năm 2020)",24000,24000,0,0
TIKI,nha-sach-tiki,182551495,"Black Jack 10 (Bìa Cứng)",96100,135000,38900,29
TIKI,nha-sach-tiki,273119803,"Cha Con Giáo Hoàng (Mario Puzo)",89000,135000,46000,34
TIKI,nha-sach-tiki,181131175,"Combo 4 Cuốn Đề Ôn Luyện Và Tự Kiểm Tra Toán + Tiếng Việt Lớp 1",116000,156000,40000,26
TIKI,nha-sach-tiki,59207573,"Luyện Viết Chữ Nhớ Từ Vựng Tiếng Anh Theo Chương Trình Sách Giáo Khoa Lớp 5 – Tập 2",34000,35000,1000,3
TIKI,nha-sach-tiki,2449681,"Sách Tương Tác - Big Book - Cuốn Sách Khổng Lồ Về Các Ngôi Sao Và Các Hành Tinh (Tái Bản)",131100,168000,36900,22
TIKI,nha-sach-tiki,192339908,"Cuộc Nổi Dậy Của Cô Nàng Mọt Sách - Phần 1 : Con Gái Của Người Lính II",165000,165000,0,0
TIKI,nha-sach-tiki,13527009,"Thúc Đẩy Giao Tiếp - 300 Trò Chơi Và Các Hoạt Động Cho Trẻ Tự Kỷ",54300,79000,24700,31
TIKI,nha-sach-tiki,1029750,"Tuần Của Bé - Bé Thanh Lịch (Dành Cho Trẻ 3 - 6 Tuổi)",21850,23000,1150,5
TIKI,nha-sach-tiki,109960224,"Sách Dạy Con Học Nói Tập 1 (Tái Bản)",299000,299000,0,0
TIKI,nha-sach-tiki,2583035,"Bé Chu Đáo",11500,23000,11500,50
TIKI,nha-sach-tiki,74217673,"Gi Gỉ Gì Gi, Cái Gì Cũng Biết - Dành Cho Lớp 3",88800,119000,30200,25
TIKI,nha-sach-tiki,184779719,"Bách Khoa Cho Trẻ Em – Bách Khoa Khủng Long",131000,180000,49000,27
TIKI,nha-sach-tiki,78975579,"Bí Mật Một Tâm Hồn Cuốn Hút (Tái Bản Lại Từ Cuốn: Để Có 1 Tâm Hồn Đẹp)",67900,96000,28100,29
TIKI,nha-sach-tiki,57520291,"Kẻ Đại Lãn",78100,79000,900,1
TIKI,nha-sach-tiki,136684902,"Combo 3 sách luyện thi B1 Vstep: Luyện thi B1 Vstep 4 kỹ năng + 30 đề thi viết luận tiếng Anh B1, B2 Vstep + 10 bộ đề thi Đọc hiểu Vstep B1-B2-C1 ôn thi chứng chỉ ngoại ngữ bậc 3 Vstep writing, reading, speaking, listening",800000,800000,0,0
TIKI,nha-sach-tiki,21049645,"Xấp 10 Bìa lá A4 Plus dày ",21000,21000,0,0
TIKI,nha-sach-tiki,184081012,"Sách tham khảo Vật Lí 10 - Biên soạn theo chương trình GDPT mới",95000,95000,0,0
TIKI,nha-sach-tiki,531109,"i-Learn Smart Start Grade 3 Student's Book (Phiên Bản Dành Cho Các Tỉnh)",104500,110000,5500,5
TIKI,nha-sach-tiki,55605174,"Thả Diều Trên Đê - Thơ Cho Thiếu Nhi",76000,118000,42000,36
TIKI,nha-sach-tiki,72225310,"Cẩm Nang Chăm Sóc Răng Miệng Toàn Diện",51800,78000,26200,34
TIKI,nha-sach-tiki,53772001,"Bên Lề Sách Cũ - Bìa Cứng (Tái Bản 2020)",86000,130000,44000,34
TIKI,nha-sach-tiki,39521136,"Để Hiệu Quả Trong Công Việc (Tái Bản 2019)",36000,52000,16000,31
TIKI,nha-sach-tiki,196054990,"Đông Dương: Một Nền Thuộc Địa Nhập Nhằng, Giai Đoạn 1858 - 1954",329000,439000,110000,25
TIKI,nha-sach-tiki,719930,"Mom's Letters: Family",17000,18000,1000,6
TIKI,nha-sach-tiki,176824195,"Cách Quản Trị Của Amazon (Working Backwards: Insights, Stories, And Secrets From Inside Amazon)",131000,205000,74000,36
TIKI,nha-sach-tiki,19383404,"10 khoen tròn xâu flashcard",66000,70500,4500,6
TIKI,nha-sach-tiki,136540009,"Toàn Thư Tâm Lý Học (Tặng Kèm Bookmark)",95300,126000,30700,24
TIKI,nha-sach-tiki,73686632,"Combo 14 Truyện Ngụ ngôn Aesop - Truyện kể mầm non - Truyện cổ tích (Giao ngẫu nhiên)",83200,160000,76800,48
TIKI,nha-sach-tiki,106605687,"Giao Dịch Kỷ Luật Làm Chủ Thị Trường",110000,159000,49000,31
TIKI,nha-sach-tiki,3408331,"Những Trò Chơi Dân Gian Phổ Thông Và Vui Nhộn Dành Cho Thiếu Nhi (Tái Bản)",59600,80000,20400,26
TIKI,nha-sach-tiki,150838230,"Everybody Writes - Ai Rồi Cũng Viết (Cuốn Cẩm Nang Giúp Bạn Viết Content “Chất Như Nước Cất”)",133000,179000,46000,26
TIKI,nha-sach-tiki,142791683,"Sourdough Bread - Bánh Mì Men Tự Nhiên",139000,179000,40000,22
TIKI,nha-sach-tiki,15686499,"Nghệ Thuật Quyến Rũ (Tái Bản 2019)",161000,161000,0,0
TIKI,nha-sach-tiki,2601231,"Sài Côn Cố Sự",23000,120000,97000,81
TIKI,nha-sach-tiki,190605360,"Người Bà Tài Giỏi Vùng Saga – Tập 1 (Tái Bản)",41100,52000,10900,21
TIKI,nha-sach-tiki,161426354,"Netflix - Phá Bỏ Nguyên Tắc Để Bứt Phá",119000,198000,79000,40
TIKI,nha-cua-doi-song,140791193,"Bóng đèn LED Bright PHILIPS E27 - Thay thế hoàn hảo cho bóng đèn Compact - Hàng Chính Hãng",56000,90000,34000,38
TIKI,nha-cua-doi-song,72615961,"Dây đèn led đom đóm trang trí decor phòng, du lịch cắm trại, fairy light cao cấp (tùy chọn loại nguồn cấp, chiều dài dây và màu sắc)",14000,23000,9000,39
TIKI,nha-cua-doi-song,72041730,"Bộ Dao 6 Món Lock&Lock (4 Dao, 1 Kéo, 1 Hộp Đựng Dao) CKK802",598000,996000,398000,40
TIKI,nha-cua-doi-song,192975755,"Kệ Gỗ Trang Trí Treo Tường Không Cần Khoan - Tặng Kèm Móc Treo Inox Và Phụ Kiện",95000,110000,15000,14
TIKI,nha-cua-doi-song,47108061,"Bộ 100 túi bóng hút chân không 1 mặt nhám - có nhiều size túi kích thước khác nhau",65000,65000,0,0
TIKI,nha-cua-doi-song,146495143,"Hộp vải đựng đồ BA03 đa năng, thùng đựng quần áo có nắp rời đậy chắc chắn an toàn dododios",129000,129000,0,0
TIKI,nha-cua-doi-song,32072094,"Dầu neem hữu cơ DOCNEEM phòng trị sâu bệnh hoa hồng, phong lan, cây cảnh, dầu neem oil nguyên chất ép lạnh 100ml",150000,150000,0,0
TIKI,nha-cua-doi-song,272298582,"Bóng đèn bắt muỗi ( dùng để thay thế bóng khi bóng chính bị hỏng)",68000,68000,0,0
TIKI,nha-cua-doi-song,167954128,"BỘ LAU NHÀ TRÒN XOAY 360 ĐỘ MẪU MỚI",183000,350000,167000,48
TIKI,nha-cua-doi-song,197826403,"Bình Đựng Nước 2L Có Vạch Báo Giờ Uống Nước",65000,65000,0,0
TIKI,nha-cua-doi-song,58014281,"Giá treo móc phơi, kẹp quần áo cho gọn loại lớn Inox 304 dán tường gạch men - kèm keo dán sealant fix - HOBBY GPM3",123000,199000,76000,38
TIKI,nha-cua-doi-song,73887002,"Đèn Ngủ Cảm Ứng Cảm Biến Dán Tường Sạc Pin USB Đời Mới",79000,79000,0,0
TIKI,nha-cua-doi-song,718885,"Thùng rác nhựa Fitis Compact PPS1-904 - xanh xám - 10L",232000,290000,58000,20
TIKI,nha-cua-doi-song,55727445,"Nắp đậy ly cốc bằng silicon nhiều mẫu xinh xắn",10000,10000,0,0
TIKI,nha-cua-doi-song,173701257,"Khăn lau đa năng bếp, bát đĩa, cốc chén thấm nước chống dính dầu mỡ hai mặt",8000,8000,0,0
TIKI,nha-cua-doi-song,25088140,"2 cuộn 1 lốc Bao rác cực đại",25000,25000,0,0
TIKI,nha-cua-doi-song,53063443,"Ga giường chống thẩm trơn kích thước 1.6mx2m - Màu giao ngẫu nhiên",49450,49450,0,0
TIKI,nha-cua-doi-song,135442243,"Bộ Lục Giác Deli Đầu Bằng Chữ L Cao Cấp - Kiểu Dáng Nhỏ Gọn Giúp Người Dùng Cầm Nắm, Thao Tác Dễ Dàng DL230008 DL230009",24000,46800,22800,49
TIKI,nha-cua-doi-song,66903798,"Remote Điều Khiển Từ Xa Cho Quạt SenkoTR1428, TR1628, DR1608 – Hàng Chính Hãng",75000,75000,0,0
TIKI,nha-cua-doi-song,149376396,"Túi peva SmileBox size lớn bọc nhiều bộ quần áo treo tủ chống thấm, chống bụi, có khóa kéo đôi tiện lợi nhiều size ngắn dài 90cm 110cm- Hàng chính hãng",105000,105000,0,0
TIKI,nha-cua-doi-song,16382292,"Bộ Quần Áo Đi Mưa - 3XL",115000,115000,0,0
TIKI,nha-cua-doi-song,99099494,"Bóng Đèn LED 38W COMET Bulb Fighter CB02F0386 Ánh Sáng Trắng - Hàng Chính Hãng",164000,164000,0,0
TIKI,nha-cua-doi-song,184122885,"Khăn tắm lau mặt nén bằng cotton dùng 1 lần hoặc tái sử dụng được cho du lịch khách sạn",38000,40000,2000,5
TIKI,nha-cua-doi-song,7583254,"Vòi xịt vệ sinh inox - Vòi xịt bồn cầu inox SUS 304 cao cấp",59800,59800,0,0
TIKI,nha-cua-doi-song,50241058,"Kệ sách gỗ để bàn - Tủ,kệ sách mini - Giao màu sắc ngẫu nhiên ",47500,50000,2500,5
TIKI,nha-cua-doi-song,144590196," Kéo Nhật Nhà Bếp Cắt Gà Cắt Đồ Đa Năng Jodily - Hàng Chính Hãng ",105000,105000,0,0
TIKI,nha-cua-doi-song,155718559,"Bình xịt dầu ăn, xịt gia vị dạng phun sương chai thủy tinh 100ml - hàng chính hãng THAFA",35000,39000,4000,10
TIKI,nha-cua-doi-song,167937668,"Aó mưa măng tô,Áo mưa có dây kéo ,vải dù cao cấp chống thấm nước cực tốt ,bảo vệ cơ thể ấm áp,cho nam và nữ",151050,159000,7950,5
TIKI,nha-cua-doi-song,42264813,"Kẹp phơi đồ Inox -Kẹp phơi quần áo đồ chống gió",61750,61750,0,0
TIKI,nha-cua-doi-song,26334551,"Mền dù cao cấp  - mỏng nhẹ - thoáng mát - Cho giấc ngủ dễ chịu [chăn ga gối đệm",160000,180000,20000,11
TIKI,nha-cua-doi-song,58679667,"Chuỗi dây đèn led gương trang điểm 10 bóng 5 màu điều chỉnh",199900,199900,0,0
TIKI,nha-cua-doi-song,696521,"Ổ Cắm Điện 4 Lỗ 3 Chấu 2 cổng USB Philips SPN6248WB/74 (2500W)",416000,469000,53000,11
TIKI,nha-cua-doi-song,7078973,"Kìm Cắt Chân Linh Kiện PLT 170 125mm",17000,17000,0,0
TIKI,nha-cua-doi-song,72016703,"Bếp Nướng Than Hoa Phiên Bản Cải Tiến Loại Dài 2023 Chống Cháy Thực Phẩm, An Toàn Sức Khỏe, Không Cần Quạt, Bếp Nướng Không Khói, Bếp Nướng Ngoài Trời, Bếp Nướng Than Hoa Vuông",209000,209000,0,0
TIKI,nha-cua-doi-song,188769126,"Chuông cửa không dây thông minh CACAZI A10, chống nước khoảng cách sử dụng trong 300M, 60 loại nhạc chuông, 110 DB",185000,185000,0,0
TIKI,nha-cua-doi-song,162424714,"Khay Giấy Bạc, Khay Bạc Đựng Thực Phẩm Lót Nồi Chiên Không Dầu Chịu Nhiệt Cao - Hàng Loại 1 - Chính Hãng MINIIN",32000,65000,33000,51
TIKI,nha-cua-doi-song,145767958,"Set 3 hộp tròn đựng thực phẩm tủ lạnh, bảo quản thực phẩm có lót đáy ráo nước, van thoát khí PET Xuất Khẩu EU",299000,299000,0,0
TIKI,nha-cua-doi-song,77315431,"[Chọn màu] Bộ 20 miếng bọc chân ghế tròn, chân bàn bằng silicon dày, bọc chân bàn chống trượt, chống xước cho sàn gỗ GD365-BCGheTron-20",19998,19998,0,0
TIKI,nha-cua-doi-song,30008695,"Vĩ 5 viên pin Maxell dòng cao cấp CR2032",20049,20049,0,0
TIKI,nha-cua-doi-song,143001862,"Ổ cắm điện đa năng shoptida có sạc nhanh PD 20W cổng USB+TYPEC, có 4-6 lỗ cắm tải 2500W, 1 đổi 1 15 tháng",174000,250000,76000,30
TIKI,nha-cua-doi-song,16869707,"Kính Bịt Mắt Ngủ 3D (Đen)",29900,39000,9100,23
TIKI,nha-cua-doi-song,174489182,"Túi đựng rác phân hủy sinh học Sunhouse KS-GA6578BS",46000,70000,24000,34
TIKI,nha-cua-doi-song,73758944,"Kệ Đa Năng Để Lò Vi Sóng INOX Trắng Cao Cấp Chống Han Gỉ Kệ Để Đồ Nặng Siêu Gọn Cho Nhà Bếp VANDO",599000,856000,257000,30
TIKI,nha-cua-doi-song,139161475," Muỗng, Muôi Múc Canh, Vá múc canh Inox 304 Cao Cấp, Sang Trọng Cho Bữa Cơm",45000,45000,0,0
TIKI,nha-cua-doi-song,32153958,"Khóa Số ABUS 145/20 (20mm) - Nhiều Màu",129000,139000,10000,7
TIKI,nha-cua-doi-song,49100347,"Cây massage đa chức năng: gãi lưng , đấm lưng , massage đầu, tay, chân, vai tặng kèm móc treo siêu dính (màu ngẫu nhiên)",21900,21900,0,0
TIKI,nha-cua-doi-song,53521887,"Giấy lọc cà phê Hario 40 cái (V60-VCF-02-40M)",49000,62000,13000,21
TIKI,nha-cua-doi-song,71518280,"Đèn Led Thanh 8 Bóng Để Bàn Đầu Gắn Ngõ USB Dự Phòng 4W (0.5W/led) Siêu Sáng",7000,14000,7000,50
TIKI,nha-cua-doi-song,93760107,"Dây đèn trang trí ngoài trời chống nước dùng cho quán cà phê, trà chanh, trà sữa đuôi đèn chống nước -thương hiệu Kiotool",103000,103000,0,0
TIKI,nha-cua-doi-song,3677777,"Bình Lọc Nước BRITA Active Pink - 600ml (Kèm Microdisc)",549000,849000,300000,35
TIKI,nha-cua-doi-song,4216861,"Kính bảo hộ 3M SF401AF chống đọng sương",75000,75000,0,0
TIKI,nha-cua-doi-song,69927147,"Túi Đựng Hộp Cơm Giữ Nhiệt Đa Lớp Nhiều Hoa Văn - Xanh Denim",23896,23896,0,0
TIKI,nha-cua-doi-song,4355547,"Bộ lọc nước thô đầu nguồn 3 cấp lọc 10inch Yamato YMTH10-3TX",334000,385000,51000,13
TIKI,nha-cua-doi-song,161455577,"Đui đèn cảm biến chuyển động",42000,42000,0,0
TIKI,nha-cua-doi-song,70840199,"Vá Canh Bằng Gỗ Nhãn Tự Nhiên - VAGOO - Làm Thủ Công Chống Thấm, Chống Ẩm Mốc, An Toàn Cho Sức Khoẻ",99000,99000,0,0
TIKI,nha-cua-doi-song,58536862,"Cặp Vỏ Gối Lụa Cao cấp A - 50x70cm hoặc 60x80cm - mềm mịn mát lạnh",165000,200000,35000,18
TIKI,nha-cua-doi-song,153263106,"Kéo Cắt Gà  Nhật Bản Làm Bếp Đa Năng Cắt Vải Cắt Giấy SK5 Siêu Sắc - Hàng Loại 1- Chính Hãng",58000,65000,7000,11
TIKI,nha-cua-doi-song,75836319,"Phân bón hữu cơ Kích Hoa cho Hoa hồng, Hoa lan, cây cảnh, cây kiểng trong nhà và ngoài trời, giàu lân giúp phân nhánh nụ, hoa, giảm chồi điếc, dung tích 1 lít, chính hãng DOCNEEM",119000,119000,0,0
TIKI,nha-cua-doi-song,180001622,"Bộ 2 Ly Thuỷ Tinh Cao Luminarc Salto Frost Lime 350ml - LUSAQ3177",139000,180000,41000,23
TIKI,nha-cua-doi-song,26060194,"GĂNG TAY RỬA BÁT SILICON SIÊU DAI CỰC BỀN",9989,9989,0,0
TIKI,nha-cua-doi-song,42718737," Đèn Led Trang Trí Bóng Tròn Dài 6M - 40  Bóng Trang Trí Noel Lễ Tết",80000,80000,0,0
TIKI,nha-cua-doi-song,93062863,"Ô dù tự động thông minh cao cấp toàn Fully Automatic Safe Umbrella, cơ chế giữ nước như dù ngược, khung nan chắc chắn chống gió bão cấp 6, vải siêu chống nước phủ Nano chống tia UV",259000,259000,0,0
TIKI,nha-cua-doi-song,90072128,"Kệ Giày Dép 7 Tầng Rộng 80cm Gỗ Tự Nhiên 100%- TN",745000,980000,235000,24
TIKI,nha-cua-doi-song,10788516,"Khuôn làm kem 6 que  (Màu ngẫu nhiên)",32999,32999,0,0
TIKI,nha-cua-doi-song,58678597,"Hộp Cơm Điện Lock&Lock EJR226IVY (2 Lít)",1010000,1942000,932000,48
TIKI,nha-cua-doi-song,57521842,"Bàn Học Bàn Làm Việc Kết Hợp Kệ Sách Thương Hiệu IGEA",569000,620000,51000,8
TIKI,nha-cua-doi-song,207557574,"Bàn học gấp gọn ngồi bệt, bàn chân nhựa cứng 40x60cm mặt gỗ MDF loại đẹp ( giao màu ngẫu nhiên )",60000,77000,17000,22
TIKI,nha-cua-doi-song,52609001,"Đèn Pin Mini Cầm Tay Siêu Sáng Loại Đèn Nhỏ 3W Police Dùng Pin AA",31000,55000,24000,44
TIKI,nha-cua-doi-song,146288304,"Giá để/ Chân để/ Giá đỡ/ Chân đỡ đàn Guitar cao cấp - Kzm Kurtzman J2 - Đa năng, dành cho tất cả loại đàn Guitar - Màu đen - Hàng chính hãng",168000,168000,0,0
TIKI,nha-cua-doi-song,38306937,"Vỉ 5 Viên Pin CR1616 Lithium 3V Panasonic - Hàng Chính Hãng",86400,89000,2600,3
TIKI,nha-cua-doi-song,152446716,"Cây Lài Trà - cây cảnh vườn + Tặng phân bón cho cây mau lớn",25000,30000,5000,17
TIKI,nha-cua-doi-song,126244017,"Ghế Học Sinh Tiểu Học Chống Gù Thông Minh Có Gác Chân BHS288 Ghế Ngồi Bàn Học Cho Bé Tuỳ Chỉnh Độ Cao - Hàng Chính Hãng",1035000,1265000,230000,18
TIKI,nha-cua-doi-song,26053920,"Vòi Nước Inox 304 Loại Tốt",34293,34293,0,0
TIKI,nha-cua-doi-song,17998301,"Túi đựng đồ lót nhiều ngăn có móc treo",32597,32597,0,0
TIKI,nha-cua-doi-song,82877146,"Đèn Bàn Học LED Chống Cận GHINER GN-1902 (Pin 4500mAh)",250000,320000,70000,22
TIKI,nha-cua-doi-song,185004559,"Ly Thủy Tinh Hoa Văn Navivu Vintage Glass 300 - 350ml",47000,47000,0,0
TIKI,nha-cua-doi-song,12461025,"Nước cắm hoa công nghệ nano đồng Fresh Flowers AHT 430ml - giúp hoa lâu tàn, không thối nước",44000,55000,11000,20
TIKI,nha-cua-doi-song,36935892,"Combo 10 khăn lau bếp đa năng - KL29 (Giao ngẫu nhiên mẫu)",10000,10998,998,9
TIKI,nha-cua-doi-song,143322314,"Ron chặn khe hở 90cm đa năng, Nẹp dán chân cửa chống côn trùng, phù hợp mọi loại cửa tiện dụng-GD534-Ron90",29000,29000,0,0
TIKI,nha-cua-doi-song,52354974,"Combo 9 Ván Sàn Gỗ Tự Nhiên Màu Nâu Vàng, Vỉ Gỗ Lót Sàn Ban Công, Sân Vườn, Hồ Bơi, Phòng Spa, Siêu Bền, Chịu Nước Tốt, Chống Trơn Trượt, Tiêu Chuẩn Xuất Khẩu",249000,279000,30000,11
TIKI,nha-sach-tiki,170094970,"Bách Khoa Lịch Sử Thế Giới - Tái Bản",400000,550000,150000,27
TIKI,nha-sach-tiki,189161030,"Điều Thuộc Về Em",89000,138000,49000,36
TIKI,nha-sach-tiki,87569364,"Bộ Dụng Cụ Vẽ Phác Thảo 27 Phụ Kiện Deli - Vẽ Mỹ Thuật - 1 Bộ - 58125",286200,286200,0,0
TIKI,nha-sach-tiki,62686754,"Thanh Gươm Diệt Quỷ Tập 14: Mu Trong Muichiro",25000,25000,0,0
TIKI,nha-sach-tiki,177312713,"Tâm Lý Học Thấu Hiểu Bản Thân",88000,119000,31000,26
TIKI,nha-sach-tiki,100285591,"Bảng Tóm Tắt Toán Tiểu Học",5600,7000,1400,20
TIKI,nha-sach-tiki,50246190,"Life A1 - A2 : Student Book with Web App Code with Online Workbook (British English) (Viet Nam Edition) (Second Edition)",234000,260000,26000,10
TIKI,nha-sach-tiki,177564112,"Cẩm Nang Tư Duy Phản Biện & Lập Luận Hiệu Quả",105000,160000,55000,34
TIKI,nha-sach-tiki,104935828,"Truyện Ngắn Nguyễn Huy Thiệp (Bìa Cứng) - Ấn Bản Kỷ Niệm 70 Năm Ngày Sinh Tác Giả - Với Minh Họa Của Các Họa Sĩ (Tái Bản - Bìa Xanh)",295000,450000,155000,34
TIKI,nha-sach-tiki,182541449,"Billy Summers - Vụ Ám Sát Cuối Cùng",208200,299000,90800,30
TIKI,nha-sach-tiki,192398103,"Cấu Trúc Dữ Liệu Và Thuật Toán (Xuất bản lần thứ năm - năm 2023)",138000,138000,0,0
TIKI,nha-sach-tiki,91343901,"Huyễn Tưởng Về Trí Tuệ Nhân Tạo",130000,169000,39000,23
TIKI,nha-sach-tiki,186575354,"Siddhartha",102000,120000,18000,15
TIKI,nha-sach-tiki,35924699,"Hộp 12 cây bút chì 2b Đức ( Hàng loại 1)",58000,58000,0,0
TIKI,nha-sach-tiki,193897099,"Cuộc săn cừu hoang",106000,136000,30000,22
TIKI,nha-sach-tiki,167019723,"TalMud - Tinh Hoa Trí Tuệ Do Thái (Tái Bản)",85800,110000,24200,22
TIKI,nha-sach-tiki,43341584,"Tiểu Thuyết Trinh Thám 1/14 - Tập 5 - 14 Ngày Kinh Hoàng (Tái Bản)",105000,168000,63000,38
TIKI,nha-sach-tiki,167034122,"Spotify Và Những Chuyện Chưa Kể  - Hành Trình Đánh Bại Apple, Google Và Amazon Trong Cuộc Đua Âm Thanh Số Của Nhà Sáng Lập Daniel Ek",137000,175000,38000,22
TIKI,nha-sach-tiki,13105198,"Combo Kĩ Năng Giao Tiếp - Dành Cho Bé 2-6 Tuổi (Trọn Bộ 10 cuốn)",107000,150000,43000,29
TIKI,nha-sach-tiki,189558189,"Vị Thần Lang Thang - Tập 23 [Tặng Kèm Postcard]",20000,20000,0,0
TIKI,nha-sach-tiki,170298038,"Harvard Bốn Rưỡi Sáng",102000,139000,37000,27
TIKI,nha-sach-tiki,16564276,"TNT TOEIC - Intensive (Third Edition) (Kèm file MP3)",224000,298000,74000,25
TIKI,nha-sach-tiki,58063000,"Sông - Nguyễn Ngọc Tư (Tiểu Thuyết)(Tái Bản)",69380,99000,29620,30
TIKI,nha-sach-tiki,10392851,"Tôi Thấy Hoa Vàng Trên Cỏ Xanh",102000,150000,48000,32
TIKI,nha-sach-tiki,77105728,"Có Thanh Xuân Nào Không Đau Đớn, Có Tuổi Trẻ Nào Không Bão Giông",100000,129000,29000,22
TIKI,nha-sach-tiki,131497044,"Sách 33 Bài Thực Hành Giúp Phát Triển Não Bộ Cho Trẻ Theo Phương Pháp Shichida",82100,118000,35900,30
TIKI,nha-sach-tiki,43341578,"Tiểu Thuyết Trinh Thám 1/14 - Tập 3 - Lời Cảnh Báo (Tái Bản)",109000,175000,66000,38
TIKI,nha-sach-tiki,111059103,"Bút dạ kính 2 đầu Deli - không xóa được, mực vĩnh cửu - Mực Đen/Xanh/Đỏ - 1 cây - EU10420 / EU10430 / EU10440",16200,16200,0,0
TIKI,nha-sach-tiki,47339151,"Sống Xanh Như Những Lá Trà",81000,109000,28000,26
TIKI,nha-sach-tiki,31375305,"Sống Lành Để Trẻ",58500,85000,26500,31
TIKI,nha-sach-tiki,186290791,"Cô gái đến từ hôm qua (Tái Bản 2022)",59000,85000,26000,31
TIKI,nha-sach-tiki,2430427,"Thùng 5 Ream Giấy In Photo A4 Excel DL 80gsm",350000,350000,0,0
TIKI,nha-sach-tiki,156968646,"Thiệp chúc mừng sinh nhật 12x12 SDstationery CLASSY BLUE họa tiết bong bóng, nến, màu xanh đơn giản tinh tế",50000,59400,9400,16
TIKI,nha-sach-tiki,180396223,"Sách 7 Thói Quen Hiệu Quả (The 7 Habits Of Highly Effective People)- Tặng sổ tay",235000,250000,15000,6
TIKI,nha-sach-tiki,181920224,"Băng Keo Trong, Đục 100 Yard 1 Cây 6 Cuộn Nặng 1Kg Đóng hàng",44400,44400,0,0
TIKI,nha-sach-tiki,67477617,"Phát Triển Trí Tuệ Cảm Xúc- Sự Tử Tế Đẹp Như Bông Hoa",37100,50000,12900,26
TIKI,nha-sach-tiki,191782133,"Không Phải Huyền Thoại - Tiểu Thuyết Lịch Sử Đầu Tiên Về Đại Tướng Võ Nguyên Giáp Trong Chiến Dịch Điện Biên Phủ",152100,255000,102900,40
TIKI,nha-sach-tiki,88979638,"Sổ tay ghi chép A5 gáy xoắn 60 trang Deli - Kẻ ngang - Màu ngẫu nhiên - LA560-01",18000,37800,19800,52
TIKI,nha-sach-tiki,94383325,"Người Bà Tài Giỏi Vùng Saga - Tập 3",41600,52000,10400,20
TIKI,nha-sach-tiki,185055215,"Kinh Doanh Nhỏ Thu Lợi Lớn (Tái Bản 2022)",63600,99000,35400,36
TIKI,nha-cua-doi-song,28619438,"Thang nhôm rút gọn SUMIKA SK320 - Chiều cao tối đa 3.2m, chiều dài rút gọn 0.8m, hợp kim nhôm cao cấp, khóa chốt chắc chắn, đế cao su chống trượt, nhỏ gọn, di chuyển tiện lợi",1139000,1500000,361000,24
TIKI,nha-cua-doi-song,157175018,"Kệ Thanh Ngang Treo Tường Kết Cấu Giấu Chân SIB Decor, Gỗ Lõi Xanh Chống Ẩm, Kèm Phụ Kiện Và Thước Thuỷ Lấy Cân Bằng",89000,89000,0,0
TIKI,nha-cua-doi-song,173768367,"Hộp đựng đồ chia ngăn 7 - 9 và 12 ngăn sắp xếp quần áo Danido - Khay đựng đồ chia ngăn tiện ích, chất liệu cao cấp",75050,79000,3950,5
TIKI,nha-cua-doi-song,49123718,"Bàn Học, Bàn Làm Việc Thông Ming Thương Hiệu IGEA",758000,825000,67000,8
TIKI,nha-cua-doi-song,148810239,"Hộp Cơm Cắm Điện Đời Mới Chính Hãng MINIIN, Hâm Nóng, Giữ Nhiệt, Nấu Chín Cơm Và Thức Ăn, 2 Tầng Nhỏ Gọn, 4 Bát Innox Không Gỉ, Tặng Kèm Bộ Đũa Và Thìa, Đa Chức Năng, Dễ Dàng Vệ Sinh",220150,259000,38850,15
TIKI,nha-cua-doi-song,98678067,"10 Thùng hộp carton - Mã MHL8 - Kích thước 50x40x30 (cm)",162000,162000,0,0
TIKI,nha-cua-doi-song,27068546,"Bộ 2 Túi Đựng Chăn Màn - Túi Quần Áo Khung Sắt Gấp Gọn 2 Chiếc Cao Cấp (Giao màu ngẫu nhiên)",169000,250000,81000,32
TIKI,nha-cua-doi-song,165219472,"Sét 10 khay giấy bạc,khay bạc đựng thực phẩm lót nồi chiên không dầu chịu nhiệt độ cao",10000,12998,2998,23
TIKI,nha-cua-doi-song,42354346,"Gối Chữ U Kèm Bịt Mắt, Bịt Tai – Gối Ngủ Du Lịch, Tựa Đầu Chống Mỏi Chất Liệu Memory Foam Chính Hãng miDoctor – mi1711",149000,149000,0,0
TIKI,nha-cua-doi-song,75483321,"Dụng Cụ Cọ Rủa Bình,Ly Có Đầu Mút-Giao Màu Ngẫu Nhiên",12000,12000,0,0
TIKI,nha-cua-doi-song,184915910,"Chậu Gội Đầu Tại Nhà, Tại Giường Cho Người Già, Người Bệnh, Trẻ Em",89000,125000,36000,29
TIKI,nha-cua-doi-song,138534630,"Tủ nhựa KATA 5 tầng giá rẻ, chất lượng, chính hãng, nhiều màu sắc",1049000,1250000,201000,16
TIKI,nha-cua-doi-song,198562465,"Bàn Làm Việc, Bàn Học Có Ngăn Để Đồ Tiện Dụng Phong Cách Bắc Âu Thương Hiệu IGA - GP185",613000,666000,53000,8
TIKI,nha-cua-doi-song,263488389,"Kệ sách để bàn HT003  - Vàng vân gỗ - Ván dày 12mm",47000,58000,11000,19
TIKI,nha-cua-doi-song,1084776,"Chảo Chống Dính Vân Đá Đáy Từ HappyCook MFP-26IH GRAY (26cm)",235000,373000,138000,37
TIKI,nha-cua-doi-song,54758744,"combo 5 keo bẫy  chuột siêu dính cao cấp , dùng được nhiều lần ",34900,34900,0,0
TIKI,nha-cua-doi-song,68716601,"Dao Gọt Hoa Quả Sunhouse KS-KN100PS",33000,49000,16000,33
TIKI,nha-cua-doi-song,76058957,"Kệ gia vị chữ E cao cấp VANDO bằng thép carbon chống gỉ, chống xước, kệ đựng chai lọ gia vị đa năng, kệ để đồ nhà bếp gọn gàng, sang trọng",399000,656000,257000,39
TIKI,nha-cua-doi-song,71342375,"Áo Mưa Bít Trẻ Em Vải Dù Siêu Dày Hàng Việt Nam, Chống Thấm Nước, Phơi Mau Khô Ráo, Che Kín Người An Toàn Cho Bé, Có Lựa Chon Size, Giới Tính Cho Bé ( Giao Màu - Mẫu Ngẫu Nhiên Vì Nhiều Hoạt Tiết)",90000,90000,0,0
TIKI,nha-cua-doi-song,117791447,"Bình nước cho bé đi học, Bình uống nước cho bé có ống hút 700ml bằng nhựa PP chịu nhiệt tốt tặng kèm túi và dây đeo tiện lợi BBShine – BN011",94000,150000,56000,37
TIKI,nha-cua-doi-song,16284231,"Bộ 50 móc dán tường siêu dính ",22999,22999,0,0
TIKI,nha-cua-doi-song,25036470,"Bình Lọc Nước Barrier Nika (2.5l) - Xanh Lá",206000,450000,244000,54
TIKI,nha-cua-doi-song,8085585,"Giấy lọc cà phê Hario 40 cái (V60-VCF-02-40W)",47000,58000,11000,19
TIKI,nha-cua-doi-song,155114109,"Ngăn Kéo Nhựa Nhỏ Mini, Khay Đựng Bút Gắn, Hộp ngăn kéo Treo Dưới Bàn Làm Việc Giúp Cất Giữ Gọn Gàng Bàn Làm Việc (Giao Màu Ngẫu Nhiên)",119000,119000,0,0
TIKI,nha-cua-doi-song,120470924,"Bình Thuỷ Tinh Luminarc Dona Embossment Ray 1L - LUDOQ0436 ",104000,104000,0,0
TIKI,nha-cua-doi-song,133245917,"Hộp Đựng Bàn Chải Và Nhả Kem Đánh Răng Tự Động Tặng Kèm  Cốc Hút Từ -Kệ Để Đồ Nhà Tắm Dán Tường Tiện Lợi- Hàng Chính Hãng MINIIN",145350,153000,7650,5
TIKI,nha-cua-doi-song,46178511,"Túi Lọc Sữa Đậu Nành, Túi Lọc Sữa Hạt Cao Cấp, Túi Lọc Trà, Túi Lọc Gia Vị - Hàng Chính Hãng",28000,60000,32000,53
TIKI,nha-cua-doi-song,85908084,"Nhang Sạch Phòng Máy Lạnh - Ít khói - Hương trầm dịu nhẹ - Chân tăm mộc - Nhang Xanh - 300g - 20cm",120000,120000,0,0
TIKI,nha-cua-doi-song,146373034,"Hộp Đựng Đồ Dùng Gấp Gọn Cao Cấp BA01 Kích Thước 38x25x25cm Tiện Lợi, Hộp Vải Chia Ngăn Đựng Quần áo, Hộp vải chia 7 ngăn, chia 9 ngăn, chia 11 ngăn, chia 12 ngăn - Chính Hãng dododios",65000,65000,0,0
TIKI,nha-cua-doi-song,108712114,"Kèn Melodion Swan 32 Phím Model SW-37 Tặng kèm túi đựng TIKCO và khăn lau hàng chính hãng",195000,195000,0,0
TIKI,nha-cua-doi-song,25731116,"Thùng vuông 55 lít - có bánh xe Duy Tân No.748 (61 x 43 x 32 cm)",195000,195000,0,0
TIKI,nha-cua-doi-song,243047801,"Gối tựa lưng văn phòng cao su non A kích thước 34 x 34 cm x 6/10cm",180000,180000,0,0
TIKI,nha-cua-doi-song,177081696,"Cây Sứ Thái Kép Hoa Tím - cây cảnh để trong nhà + tặng phân bón cho cây",65000,110000,45000,41
TIKI,nha-cua-doi-song,118898224,"Phin nhôm cao cấp hoa văn màu đen có hộp giấy",75000,75000,0,0
TIKI,nha-cua-doi-song,190989561,"Bình đựng thức ăn giữ nhiệt Inox 316 Elmich EL-8019 dung tích 600ml",301000,419000,118000,28
TIKI,nha-cua-doi-song,67937873,"Tấm bảo vệ nệm Everon White",370000,370000,0,0
TIKI,nha-cua-doi-song,34527170,"Giấy bạc dán tường nhà bếp chống thấm dầu, thấm nước tiện dụng 3mx60cm",20999,20999,0,0
TIKI,nha-cua-doi-song,180750013,"VẢI GA BỌC GHẾ SOFA GIƯỜNG - SOFA BED",66000,66000,0,0
TIKI,nha-cua-doi-song,144203362,"Bộ túi hộp cơm thủy tinh Lock&amp;Lock 3EA LLG429DS2GRY (LLG429Dx1, LLG428x1, HWB820GRYx1) - Màu",355000,682000,327000,48
TIKI,nha-cua-doi-song,54644755,"Áo bọc bàn để ủi quần áo, nhiều họa tiết - Áo trùm bàn ủi đồ, chọ size theo ý, giao mẫu ngẫu nhiên+ Tặng kèm hình dán",59000,59000,0,0
TIKI,nha-cua-doi-song,152446518,"Cây cúc tần ấn độ - cây cảnh vườn + tặng phân bón cho cây",25000,30000,5000,17
TIKI,nha-cua-doi-song,4361879,"Bộ lọc nước thô đầu nguồn 3 cấp lọc 10inch Yamato YMTH10-3T",334000,450000,116000,26
TIKI,nha-cua-doi-song,155253236,"HỘP PIN MAXELL 40 VIÊN  AAA TEM BẠC - HÀNG CHÍNH HÃNG",51450,51450,0,0
TIKI,nha-cua-doi-song,174897090,"Combo 4 Miếng dán tường treo kệ bếp, kệ nhà tắm",24000,24000,0,0
TIKI,nha-cua-doi-song,212986033,"Đồng hồ bấm giờ đếm ngược điện tử mini, đồng hồ điện tử đa năng - Funu Home",65000,65000,0,0
TIKI,nha-cua-doi-song,150561019,"Ủng Bọc Giày Đi Mưa Cổ Cao Có Đế Chống Trượt",38900,38900,0,0
TIKI,nha-cua-doi-song,48354676,"Bộ 2 Hộp Thủy Tinh Chịu Nhiệt KLOCK KV400 (2 x 400ml) Tặng Túi Giữ Nhiệt",119000,199000,80000,40
TIKI,nha-cua-doi-song,67980198,"Phân bón hữu cơ sinh học KingCrop, dùng trồng rau, cây ăn trái sạch, an toàn",70000,70000,0,0
TIKI,nha-cua-doi-song,217766070,"Thùng Rác Văn Phòng Dạng Lưới Kim Loại Size 27cm",88000,88000,0,0
TIKI,nha-cua-doi-song,197649725,"Bình Nước Giữ Nhiệt 500ml Bằng Thép Không Gỉ 304 Hai Lớp Có Màn Hình Kỹ Thuật Số Hiển Thị Nhiệt Độ Cảm Biến 1 Chạm",125000,125000,0,0
TIKI,nha-cua-doi-song,35169106,"Bộ 3 đầu cọ bàn chải gắn máy Khoan cầm tay - Dụng cụ vệ sinh nhà cửa lốp xe thông minh",60000,149440,89440,60
TIKI,nha-cua-doi-song,274541068,"Combo 10 cặp nút tai chống ồn cao cấp Honeywell Max 1 - Nút bịt tai chống ồn khi đi ngủ, ôn thi, đi máy bay, công trình, xưởng in",3000,3000,0,0
TIKI,nha-cua-doi-song,196552579,"Ô Dù gấp gọn , dù che mưa , chống tia UV 8 nan ( nhiều mẫu )",51000,51000,0,0
TIKI,nha-cua-doi-song,136014171,"Bình Nước Nhựa We Bare Bears 1l Dễ Thương Có Kèm Túi Rút Túi Giữ Nhiệt Và Ống Hút Siêu Tiện Lợi",418000,418000,0,0
TIKI,nha-cua-doi-song,35068214,"Pin 12V- Pin A23 Panasonic LRV08 - Hàng Chính Hãng",35000,35000,0,0
TIKI,nha-cua-doi-song,98955056,"Móc Treo Quần Áo Inox SUS304 7 Chấu Dán Tường Không Cần Khoan Đục - Tặng Kèm keo và Đinh Vít",150000,195000,45000,23
TIKI,nha-cua-doi-song,100431737,"Bộ hộp bảo quản thực phẩm đa năng Nora Ez – FS11-E1++++",198000,198000,0,0
TIKI,nha-cua-doi-song,55718749,"Tấm lót silicon đa năng trơn dùng làm bánh lót bàn ăn",69000,69000,0,0
TIKI,nha-cua-doi-song,13509515,"Đèn LED siêu sáng USB 28 bóng AZONE",34000,89000,55000,62
TIKI,nha-cua-doi-song,26299212,"Miếng Che Mắt Ngủ Có Túi Gel Làm Mát - Màu Ngẫu Nhiên",32000,32000,0,0
TIKI,nha-cua-doi-song,128202074,"Găng Tay Siêu Dai Hình Con Hươu Lót Nỉ",21000,21000,0,0
TIKI,nha-cua-doi-song,71692258,"Mũ làm khô tóc siêu thấm nước dùng sau khi gội đầu/tắm đa năng",42000,42000,0,0
TIKI,nha-cua-doi-song,46185330,"COMBO 10 MÓC INOX HÌNH CHỮ S NHỎ",60000,60000,0,0
TIKI,nha-cua-doi-song,42566535,"Dụng Cụ Mài Dao 3 Rảnh - Dụng Cụ Mài Nhiều Loại Dao, Nhiều Chế Độ",15000,15000,0,0
TIKI,nha-cua-doi-song,984752,"Nồi Inox 3 Đáy Fivestar N20-3DG (20cm) - Hàng Chính Hãng",279000,279000,0,0
TIKI,nha-cua-doi-song,26602007,"Kẹp Bẫy Bắt Chuột Thông Minh",7000,9899,2899,29
TIKI,nha-cua-doi-song,82979825,"Bàn Chải Đa Năng Cầm Tay Dùng Cho Phòng Tắm Hình Cá Voi Có Đế Đựng Tiện Lợi",45000,45000,0,0
TIKI,nha-cua-doi-song,253106781,"Nút Nắp Đậy Chai Bằng Silicon Hình Con Chim Giao Màu Ngẫu Nhiên",61600,61600,0,0
TIKI,nha-cua-doi-song,47271244,"Shaker Inox 2 mảnh - Cocktail Boston",175000,175000,0,0
TIKI,nha-cua-doi-song,145420630,"kệ treo quần áo chống gỉ / Giá treo áo khoác kim loại đơn giản và thời trang Bền Chắc Đa Năng Nội Thất Cho Phòng Ngủ- Bảo hành 10 năm",399000,399000,0,0
TIKI,nha-cua-doi-song,27826567,"Dụng cụ ép tỏi, nghiền tỏi có tay cầm tiện dụng",22000,22000,0,0
TIKI,nha-cua-doi-song,58498874,"Bộ Đũa Thìa Dĩa Inox, Hộp Đựng Lúa Mạch, Nhiều Màu Lựa Chọn, Tặng Kèm Ống Hút Tre",48999,48999,0,0
TIKI,nha-cua-doi-song,59412424,"Bộ Dụng Cụ Bếp (Đũa, Sạn, Vá) Bằng Gỗ Nhãn Tự Nhiên - VAGOO - Làm Thủ Công Chống Thấm, Chống Ẩm Mốc, An Toàn Sức Khoẻ",169000,169000,0,0
TIKI,nha-cua-doi-song,31264857,"Combo 5 Chiếc Khăn Tắm Xuất Nhật bản to 70x140cm",62999,62999,0,0
TIKI,nha-cua-doi-song,59236591,"Cốc Thủy Tinh Chia Vạch Tiên Lợi-màu giao ngẫu nhiên- CCV",24000,26499,2499,9
TIKI,nha-cua-doi-song,25620364,"Set 300 ống hút nhựa PP an toàn",64500,64500,0,0
TIKI,nha-cua-doi-song,101937904,"Kệ nhà tắm, Kệ để đồ toilet thông minh Kệ để đồ phòng tắm phòng vệ sinh dán tường không cần khoan đục",38999,38999,0,0
TIKI,nha-cua-doi-song,192443483,"Hộp cơm văn phòng KIPOR KP-HC01 - Thuỷ tinh cao cấp dùng được trong lò vi sóng - Chống tràn, tiện lợi - Hàng chính hãng",42000,72000,30000,42
TIKI,nha-cua-doi-song,11249688,"Dụng Cụ Bịt Mắt Ngủ- Màu Trắng Hình Ngẫu Nhiên",10800,10800,0,0
TIKI,nha-cua-doi-song,116749239,"Ruột Gối Doona Basic độ bền cao, mềm mịn, an toàn cho sức khoẻ",195000,210000,15000,7
TIKI,nha-cua-doi-song,26387653,"KỆ ĐỂ GIÀY DÉP 3 TẦNG 80 CM",209000,300000,91000,30
TIKI,nha-cua-doi-song,183254388,"Ô (Dù) Tự Động 2 Chiều Cao Cấp Teement, Che Mưa, Che Nắng, Chống UV - Hàng Chính Hãng",170000,170000,0,0
TIKI,nha-cua-doi-song,6643347,"Phích Cắm Chuyển Đổi 3 Chấu Sang 2 Chấu",12000,12000,0,0
TIKI,nha-cua-doi-song,172950048,"Kệ Nhà Bếp Đa Năng, Kệ Để Lò Vi Sóng Chính Hãng IGA - GM05",213000,232000,19000,8
TIKI,nha-cua-doi-song,193081467,"Ghế Xoay Văn Phòng Lưới Làm Việc Công Thái Học Deli - Tay Gập Thông Minh, Có Chỉnh Lưng, Lưới Thoáng Khí, Chân Xoay Tiện Ích, Đệm Ghế Êm Aí, Nhiều Màu - Phù Hợp Học Sinh, Văn Phòng, Game Thủ, Gaming - Hàng chính hãng",886000,1978200,1092200,55
TIKI,nha-cua-doi-song,112068381,"Kệ Đa Năng, Kệ Để Đồ Black Kodo Phong Cách Hiện Đại - GM06",202000,220000,18000,8
TIKI,nha-cua-doi-song,121330266,"sét 10 bóng Đèn Led 3w Ánh Sáng Trắng",4000,4000,0,0
TIKI,nha-cua-doi-song,67932480,"Topper Everon White",899000,899000,0,0
TIKI,nha-cua-doi-song,186693022,"Cây lau nhà tự vắt Kitimop-Red bàn lau lớn 38cm, con lăn trợ lực, thanh thép không gỉ, khớp xoay 360 độ, 2 bông lau",139000,225000,86000,38
TIKI,nha-cua-doi-song,270862442,"Ổ Cắm Điện Đa Năng Chống Giật Có 3 Cổng USB, Sạc Trực Tiếp, Tiết Kiệm Điện – Bộ Ổ Cắm Điện Xanh Lá Cao Cấp Chính Hãng - (Model ngẫu nhiên)",69000,100000,31000,31
TIKI,nha-cua-doi-song,144203367,"Bộ túi hộp cơm thủy tinh Lock&Lock 3EA LLG428S2IVY (LLG429Dx1, LLG428x1, HWB821GRYx1) - Màu",378000,726000,348000,48
TIKI,nha-cua-doi-song,74605907,"Khăn Tắm/Khăn Mặt Cotton Mềm Mại Thấm Hút Nước 34x75cm Nhanh Khô",33000,33000,0,0
TIKI,nha-cua-doi-song,73113608,"Bình PET Đựng Nước Tròn Có Vòi 10 Lít Duy Tân thân bình trong suốt giao quai màu ngẫu nhiên (Ø 20 x 40.2 cm) No.625 ",65000,65000,0,0
TIKI,nha-cua-doi-song,163580111,"Bọ xiphong ống thoát chậu rửa chén siêu to",450000,450000,0,0
TIKI,nha-cua-doi-song,76545899,"Bộ Máy Khoan Mài khuôn Khắc mini Đa Năng 100 chi tiết 6 tốc độ Kiotool",545000,545000,0,0
TIKI,nha-cua-doi-song,122311338,"Nhang Nụ Trầm Hương tự nhiên khói chảy ngược - Hộp 40 nụ - Mùi thơm dịu nhẹ, không cay mắt, không kích mũi - Thiên Mộc Hương",261000,350000,89000,25
TIKI,nha-cua-doi-song,230013933,"Kệ Sách Để Bàn Phong Cách Nordic Thương Hiệu IGA - GP176",281000,305000,24000,8
TIKI,nha-cua-doi-song,59401658,"Cuộn Đèn LED Trang Trí Quấn Cây RGB Chống Nước, Dài 5M Kèm Remote 44 Phím",115000,115000,0,0
TIKI,nha-cua-doi-song,56247996,"Kệ sách mini bằng gỗ, để trên bàn làm việc hoặc bàn học. Hàng tự lắp ghép đa năng, thông minh. Gồm 3 màu đẹp hiện đại",50249,50249,0,0
TIKI,nha-cua-doi-song,165705675,"Cọ vệ sinh Bình Giữ Nhiệt chuyên dụng, Cứng cáp, Đế gỗ",150000,150000,0,0
TIKI,nha-cua-doi-song,191057553,"Ổ Cắm Điện Thông Minh USB Cao Cấp Jodily StarHome",185000,185000,0,0
TIKI,nha-cua-doi-song,208761326,"Chai xịt chuột thái land rat off",84000,84000,0,0
TIKI,nha-cua-doi-song,182148476,"Combo Móc Dán Tường In Hình Họa Tiết Dễ Thương Loại Lớn PaKaSa - Hàng Chính Hãng ( Giao họa tiết ngẫu nhiên )",39000,58000,19000,33
TIKI,nha-cua-doi-song,194125082,"Khăn mặt sợi tre MORI xuất Nhật cao cấp 30x50cm",20900,38000,17100,45
TIKI,nha-cua-doi-song,78010514,"Timer hẹn giờ bật tắt điện tự động KG316T-II/25A/220V",67500,67500,0,0
TIKI,nha-cua-doi-song,174128094,"SALE SỐC NỆM VĂN PHÒNG- ĐỆM NGỦ VĂN PHÒNG CHỐNG THẮM NƯỚC 75 X 180 X 3CM ( GIAO MÀU NGẪU NHIÊN )",259000,350000,91000,26
TIKI,nha-cua-doi-song,116191376,"Nhang trầm hương tự nhiên Thiên Mộc Hương 30cm, Ít Khói, Thơm Nhẹ, Dễ Chịu, Không kích mũi",89000,150000,61000,41
TIKI,nha-cua-doi-song,125555122,"Bàn Học, Bàn Làm Việc Gấp Gọn Hiện Đại Thương Hiệu IGA - GP154",155000,169000,14000,8
TIKI,nha-cua-doi-song,116681853,"Bình Giữ Nhiệt Lock&Lock Featherlight One-touch Tumbler 500ml LHC3257 - Hàng Chính Hãng - Tặng Kèm Ống Hút Inox",309000,537000,228000,42
TIKI,nha-cua-doi-song,160310283,"Găng Tay Tắm Funu Giúp Tẩy Tế Bào Chết, Làm Sạch Da - Giao Màu Ngẫu Nhiên",33000,33000,0,0
TIKI,nha-cua-doi-song,72652196,"Bộ túi hộp cơm thủy tinh Lock&Lock 3EA (LLG429Dx1,LLG428x1,BAG-HPL815SGRYx1) LLG428S2GRY - Màu",337000,649000,312000,48
TIKI,nha-cua-doi-song,152521474,"Combo 200 Túi Lọc Rác Bồn Rửa Bát - Túi Lưới Lọc Rác Giúp Ngăn Chặn Tắc Đường Ống- Hàng Loại 1 - Chính Hãng MINIIN",56050,59000,2950,5
TIKI,nha-cua-doi-song,980512,"Cân Nhơn Hòa NHS-5 (5kg) - Hàng Chính Hãng",320000,320000,0,0
TIKI,nha-cua-doi-song,98804083,"Bóng Đèn Thông Minh TP-Link Tapo L530E Đa Sắc - Hàng Chính Hãng",199000,398000,199000,50
TIKI,nha-cua-doi-song,76658958,"Khăn Tắm Khách Sạn 5 sao – Cotton 100% - Sợi se đôi cao cấp – Thấm hút cực tốt - Kích thước lớn 70 x 140 cm có thể quấn quanh người",53888,53888,0,0
TIKI,nha-cua-doi-song,169208802,"Vỏ gối chất liệu Cotton 40x60, 50x70 mềm mại siêu rẻ cho khách sạn, phòng ngủ, phòng trọ",30000,30000,0,0
TIKI,nha-cua-doi-song,77947848,"Kệ Chén Đĩa Thép Cao Cấp Sơn Đen Tĩnh Điện Kèm Khay Ráo Nước VANDO, Giá Kệ Úp Bát Đa Năng",429000,656000,227000,35
TIKI,nha-cua-doi-song,125084260,"Vỏ gối ôm cotton tici Lidaco kích thước 35x100cm",35000,39000,4000,10
TIKI,nha-cua-doi-song,194005519,"Ghế Kê Chân Văn Phòng, Chịu lực 200 kg Plyconcept Seiza Chair - Gỗ Uốn Cong",160000,280000,120000,43
TIKI,nha-cua-doi-song,95043563,"Khăn tắm sợi tre Bamboo Life hàng chính hãng Khăn lau người mềm mại kháng khuẩn siêu thấm hút an toàn cho da ngay cả với trẻ sơ sinh BL046",65000,65000,0,0
TIKI,nha-sach-tiki,184087030,"Beethoven - Nhà Soạn Nhạc Cổ Điển Vĩ Đại Thế Giới",43300,60000,16700,28
TIKI,nha-sach-tiki,145540463,"Combo 2 cuốn: Đường xưa mây trắng - Theo gót chân Bụt( Bìa Mềm) + Hành Trình Của Linh Hồn ( Bộ Sách Trò Chuyện Cùng Tâm Linh/ Tặng Kèm Bookmark)",386500,386500,0,0
TIKI,nha-sach-tiki,2583033,"Bé Trách Nhiệm",11500,23000,11500,50
TIKI,nha-sach-tiki,13853115,"Chiến Lược Mở Rộng Kinh Doanh Từ Cốt Lõi",79100,109000,29900,27
TIKI,nha-sach-tiki,10761049,"Gôm Bút Mực Mono Tombow ES-512A",45000,50000,5000,10
TIKI,nha-sach-tiki,26707903,"Thiết Kế Kết Cấu Bê Tông Cốt Thép Theo Tiêu Chuẩn Eurocode - Cơ Sở Lý Thuyết Và Ví Dụ Áp Dụng",91000,112000,21000,19
TIKI,nha-sach-tiki,186669701,"Danh Nhân Thế Giới: Lincoln (Tái Bản 2022)",23100,30000,6900,23
TIKI,nha-sach-tiki,58839915,"Amulet Book 6 : Escape from Lucien (Graphic Novel)",312000,312000,0,0
TIKI,nha-sach-tiki,191410859,"Trưởng Thành Sau Biến Cố",110000,130000,20000,15
TIKI,nha-sach-tiki,36996379,"Người Mẹ Tốt Hơn Là Người Thầy Tốt - Tập 2",136500,136500,0,0
TIKI,nha-sach-tiki,185409456,"Bút Bi Nước Mực Gel Bấm Ngòi 0.5mm Deli - Thiết Kế Vỏ Trong Suốt Phù Hợp Văn Phòng Sinh Viên Học Sinh Ghi Chép Sổ Tay - A057B",8000,18000,10000,56
TIKI,nha-sach-tiki,182972777,"Rồng Đỏ",98000,135000,37000,27
TIKI,nha-sach-tiki,8121460,"Giáo Trình Hán Ngữ 1 - Tập 1 - Quyển Thượng (Phiên Bản Mới)",83520,116000,32480,28
TIKI,nha-sach-tiki,5458537,"Tài Chính Doanh Nghiệp - Corporate Finance",610000,659000,49000,7
TIKI,nha-sach-tiki,23437828,"English Vocabulary in Use: Elementary Book with Answers Reprint Edition: Vocabulary Reference and Practice (CD-ROM)",124620,134000,9380,7
TIKI,nha-sach-tiki,48035293,"Kỷ Luật Tự Giác Thói Quen Của Người Thành Công",111300,159000,47700,30
TIKI,nha-sach-tiki,1995037,"21 Cách Học Tiếng Anh Du Kích - FuSuSu (Song ngữ)",150000,150000,0,0
TIKI,nha-sach-tiki,48362492,"Sách Tương Tác Vừa Học Vừa Chơi - Khủng Long Kỳ Thú",57200,79000,21800,28
TIKI,nha-sach-tiki,177747013,"Giác Ngộ",98000,139000,41000,29
TIKI,nha-sach-tiki,145499994,"Sách Quẳng Gánh Lo Đi Và Vui Sống (Khổ Nhỏ) (Tái Bản 2021)",48000,68000,20000,29
TIKI,nha-sach-tiki,169621664,"Anh Đừng Quyến Rũ Tôi - Tập 3",127000,169000,42000,25
TIKI,nha-sach-tiki,74953479,"Em Bé Hạnh Phúc: Nuôi Dạy Trẻ Tại Nhà Theo Phương Pháp Montessori",78500,110000,31500,29
TIKI,nha-sach-tiki,166525107,"Lịch Sử Đô Thị Hiện Đại",133000,169000,36000,21
TIKI,nha-sach-tiki,175724209,"Những Triết Gia Vĩ Đại",59000,90000,31000,34
TIKI,nha-sach-tiki,173156781,"Combo 2 Sách Thành thạo Tin học văn phòng: Thành thạo Hàm Excel phổ biến nhất + Thành thạo Soạn thảo văn bản Word - Mẹo xử lý lỗi Word Excel trong công việc -  tinhocmos",249000,308000,59000,19
TIKI,nha-sach-tiki,87726331,"Chết Vì Chứng Khoán",127400,199000,71600,36
TIKI,nha-sach-tiki,189938281,"Một Thư Viện Ở Paris",148000,148000,0,0
TIKI,nha-sach-tiki,159259017,"Ngày của người chết tập 1+ 2 - Đằng Bình - Truyện phiêu lưu viễn tưởng, mạt thế, kinh dị",231000,330000,99000,30
TIKI,nha-sach-tiki,197657395,"[PRE-ORDER] Tokyo Revengers - Tập 4 - Bản Thường",103500,115000,11500,10
TIKI,nha-sach-tiki,195845908,"EMPOWERED - Khai phóng tiềm năng nhân lực, sản phẩm công nghệ đột phá",206000,295000,89000,30
TIKI,nha-sach-tiki,41754180,"Nghệ Thuật Bán Hàng Bằng Câu Chuyện (Tặng Bookmark dễ thương)",129000,188000,59000,31
TIKI,nha-sach-tiki,176906756,"Dẫu Hóa Linh Hồn Xin Hãy Ở Bên Tôi",101000,118000,17000,14
TIKI,nha-sach-tiki,2099189,"Khéo Ăn Nói Sẽ Có Được Thiên Hạ (Bìa Cứng)",112500,150000,37500,25
TIKI,nha-sach-tiki,192474344,"BỘ SÁCH KỶ LUẬT: Không Sợ Chậm Chỉ Sợ Dừng – Càng Kỷ Luật Càng Tự Do",192000,238000,46000,19
TIKI,nha-sach-tiki,48320740,"[ Bookcare] Combo 50 Bìa Bọc Truyện Tranh Plastic Cao Cấp (Bọc mọi cuốn khổ 11,3x17,6cm)",120000,120000,0,0
TIKI,nha-sach-tiki,112053760,"Bồi dưỡng năng lực tự học Toán lớp 6 (Theo chương trình GDPT mới)",66000,66000,0,0
TIKI,nha-sach-tiki,17493916,"Luyện Nói Tiếng Trung Quốc Cấp Tốc Cho Người Bắt Đầu - Tập 1 (Kèm file MP3) (Tái Bản)",126000,168000,42000,25
TIKI,nha-sach-tiki,273537705,"Chinh Phục Cụm Động Từ Tiếng Anh",49000,65000,16000,25
TIKI,nha-sach-tiki,195801299,"Rembrandt Cuộc Đời Và Tác Phẩm Qua 500 Hình Ảnh",378400,599000,220600,37
TIKI,nha-sach-tiki,188930494,"Người Bà Tài Giỏi Vùng Saga – Tập 4",43200,52000,8800,17
TIKI,nha-sach-tiki,156821160,"Tổng Quan Về Tarot (Bìa Cứng)",224000,350000,126000,36
TIKI,nha-sach-tiki,273643617,"Trạm Đọc Official | Sách: Quốc Gia Khởi Nghiệp",156000,209000,53000,25
TIKI,nha-sach-tiki,92993878,"Truyện đọc cho bé trước giờ đi ngủ",70560,98000,27440,28
TIKI,nha-sach-tiki,120460868,"Thay Đổi Câu Hỏi Thay Đổi Cuộc Đời (Tái bản 2021 có bổ sung)",46000,63000,17000,27
TIKI,nha-sach-tiki,35473845,"Định Mệnh Chiến Tranh",137000,246000,109000,44
TIKI,nha-sach-tiki,25980689,"Complete IELTS B2 Student's Book with answer & CD-Rom",256700,279000,22300,8
TIKI,nha-sach-tiki,179735870,"Ta Chỉ Gặp Nhau Vào Ban Đêm (Tặng Kèm 03 postcard (10x15 cm) + 01 bookmark)",93700,129000,35300,27
TIKI,nha-sach-tiki,107707548,"Nụ Hôn Dối Lừa (Bộ 2 Tập) - Biên Niên Sử Còn Sót Lại - Phần 1 (Tặng Kèm Bộ 2 Postcard)",120000,228000,108000,47
TIKI,nha-sach-tiki,193450582,"Metaverse Handbook",145500,209000,63500,30
TIKI,nha-sach-tiki,185854301,"Những bài đồng dao cho bé (Minh họa bằng tranh theo chủ đề - Dành cho bé tập nói, tập đọc)",36400,70000,33600,48
TIKI,nha-sach-tiki,193701771,"Truyện Cổ Nhật Bản",156000,209000,53000,25
TIKI,nha-sach-tiki,35761355,"Binh Pháp Tôn Tử Trong Kinh Doanh",81600,118000,36400,31
TIKI,nha-sach-tiki,115768007,"Ruột bút bi cao cấp PARKER",153000,180000,27000,15
TIKI,nha-sach-tiki,145092099,"Thì Và Sự Phối Hợp Thì Trong Tiếng Anh",45000,70000,25000,36
TIKI,nha-sach-tiki,45299959,"Căn Bản Kỹ Thuật Nhiếp Ảnh",127000,135000,8000,6
TIKI,nha-sach-tiki,21130352,"Mùa Gặt Đỏ - Trinh Thám Cổ Điển Phương Tây",51000,102000,51000,50
TIKI,nha-sach-tiki,32921595,"Sổ Tay Học Nhanh , Toàn Diện Kiến Thức Và Dạng Bài Hóa Học Lớp 8 - 9",46600,68000,21400,31
TIKI,nha-sach-tiki,188930496,"Những Chàng Trai Ở Lộc Phong Quán – Tập 3 (Tái Bản)",38300,48000,9700,20
TIKI,nha-sach-tiki,2612737,"Thùng 5 ram giấy A4 Double A 70gsm",400000,400000,0,0
TIKI,nha-sach-tiki,31219037,"Làm Chủ Tuổi 20 (Phiên bản mới) - Dành cho độc giả từ 16-30",198000,198000,0,0
TIKI,nha-sach-tiki,23134440,"Hỷ Lạc Từ Tâm",96500,150000,53500,36
TIKI,nha-sach-tiki,104273044,"3000 câu Ngữ Pháp và Từ Vựng hay sai – Cô Trang Anh",119000,200000,81000,41
TIKI,nha-sach-tiki,137694341,"My First 1000 English Words - 1000 Từ Tiếng Anh Đầu Tiên Cho Bé (Bìa Cứng) (Tái Bản)",87100,120000,32900,27
TIKI,nha-sach-tiki,194205615,"Anh Chàng Hobbit",129000,175000,46000,26
TIKI,nha-sach-tiki,2469667,"Dạy Con Theo Phương Pháp Montessori - Tớ Là Bạn Tốt",12240,13600,1360,10
TIKI,nha-sach-tiki,576300,"Hướng Dẫn Tự Lắp Ráp 100 Mạch Điện - Điện Tử",50000,50000,0,0
TIKI,nha-sach-tiki,47161879,"Bách Khoa Toàn Thư Giáo Dục Và Phát Triển  Tâm Lý Tính Cách Trẻ 0 -6 Tuổi",104000,160000,56000,35
TIKI,nha-sach-tiki,381274,"Cẩm Nang Dưỡng Sinh Thông Kinh Lạc",224000,298000,74000,25
TIKI,nha-sach-tiki,109982964,"Những Thăng Trầm Trong Cuộc Đời Và Sự Nghiệp Của Andersen",47500,60000,12500,21
TIKI,nha-sach-tiki,116656411,"Bán hàng thời kỹ thuật số (Digital Selling: How to Use Social Media and the Web to Generate Leads and Sell More) - Tác giả: Grant Leboff",96000,96000,0,0
TIKI,nha-sach-tiki,179952631,"Chiến Dịch Trị - Thiên 1972",233300,280000,46700,17
TIKI,nha-sach-tiki,186237327,"Livestream – Hướng dẫn chi tiết cách kiếm tiền từ livestream",131600,189000,57400,30
TIKI,nha-sach-tiki,80927136,"Hệ thống bài tập & câu hỏi trắc nghiệm nguyên lý kế toán ",24000,24000,0,0
TIKI,nha-sach-tiki,192339432,"Giao Tiếp Cơ Bản – Cẩm Nang Làm Chủ Mọi Cuộc Trò Chuyện",102000,129000,27000,21
TIKI,nha-sach-tiki,2583027,"Bé Bao Dung",11500,23000,11500,50
TIKI,nha-sach-tiki,171549942,"Black Jack 08 (Bìa Cứng)",131000,135000,4000,3
TIKI,nha-sach-tiki,186880522,"Bí Mật Tiền Bạc Của Giới Siêu Giàu",71000,108000,37000,34
TIKI,nha-sach-tiki,159814614,"Đại Học Nghệ Thuật Tokyo",118000,149000,31000,21
TIKI,nha-sach-tiki,730580,"Tuần Của Bé Tháng 7 - Bé Đảm Đang",11500,23000,11500,50
TIKI,nha-sach-tiki,165030731,"Vượt Qua Chuyện Sao Hỏa - Sao Kim",89200,160000,70800,44
TIKI,nha-sach-tiki,136941173,"Giải Mã Hành Vi Disc: Bạn Thuộc Kiểu Lãnh Đạo Nào Trong 8 Nhóm Hành Vi?",101000,148000,47000,32
TIKI,nha-sach-tiki,270660229,"Who? Chuyện Kể Về Danh Nhân Thế Giới: Walt Disney",46000,55000,9000,16
TIKI,nha-sach-tiki,110448030,"Chuyện Xảy Đến Trong Đêm",138000,179000,41000,23
TIKI,nha-sach-tiki,9734633,"Ngày đó có em",55000,55000,0,0
TIKI,nha-sach-tiki,21502913,"Thân Nhiệt: Chìa Khóa Để Sống Khỏe Mạnh Và Trường Thọ",120000,120000,0,0
TIKI,nha-sach-tiki,52855109,"SÁCH KẾ HOẠCH DẠY TRẺ CHẬM NÓI - Tự Kỷ (Tái bản lần I - 2020)",280000,280000,0,0
TIKI,nha-sach-tiki,56908132,"Đảo Giấu Vàng (Tái Bản 2020)",66000,100000,34000,34
TIKI,nha-sach-tiki,109088709,"Hứa Với Con, Ba Nhé",136700,179000,42300,24
TIKI,nha-sach-tiki,170352966,"Trí Tuệ Gia Đình Từ Vị Tu Sĩ Bán Đi Chiếc Ferrari",85000,130000,45000,35
TIKI,nha-sach-tiki,8835539,"Vĩ Đại Do Lựa Chọn (Tái Bản)",92000,165000,73000,44
TIKI,nha-sach-tiki,1352355,"Bộ Kỹ Năng Trong Sinh Hoạt I - Ăn Thế Nào Cho Đủ - How To Eat Healthy (Song Ngữ Việt - Anh)",17000,29000,12000,41
TIKI,nha-sach-tiki,137555857,"Bộ Đề Kiểm Tra Tiếng Anh 8 (Chương Trình Thí Điểm)",68300,86000,17700,21
TIKI,nha-sach-tiki,1073276,"Combo Mê Cung Phát Triển Tư Duy (4 Cuốn)",238400,298000,59600,20
TIKI,nha-sach-tiki,181379273,"Ngài Kẹo",31000,60000,29000,48
TIKI,nha-sach-tiki,186862153,"Danh Nhân Thế Giới: Napoleon (Tái Bản 2022)",23100,30000,6900,23
TIKI,nha-sach-tiki,87642541,"Combo Lấy Nước Đường Xa và  Chú Bé Mang Pyjama Sọc  ",150250,150250,0,0
TIKI,nha-sach-tiki,161878354,"Combo 05 Cây Bút Lông Bảng FO-WB02 Và 01 Hộp Mực Lông Bảng FO-WBI02",70000,70000,0,0
TIKI,nha-sach-tiki,45472472,"Hộp Viết Gỗ Để Bàn",55000,78000,23000,29
TIKI,nha-sach-tiki,186239206,"Túi bọc sách truyện NOKISHI phù hợp với mọi loại sách truyện",13199,13199,0,0
TIKI,nha-sach-tiki,4439909,"Kĩ Năng Cho Bé Trong Giao Tiếp Hàng Ngày: Lời Chào Đi Trước (Tái Bản)",21000,35000,14000,40
TIKI,nha-sach-tiki,190857214,"Dinh Dưỡng Lành Mạnh - Ngại Gì Bệnh Tim",165200,259000,93800,36
TIKI,nha-sach-tiki,966505,"Tuần Của Bé - Bé Sâu Sắc",11500,23000,11500,50
TIKI,nha-sach-tiki,966501,"Tuần Của Bé - Bé Quyết Đoán",11500,23000,11500,50
TIKI,nha-sach-tiki,270660740,"Combo Cẩm Nang Sinh Hoạt Bằng Tranh Cho Bé (4 tập)",107000,144000,37000,26
TIKI,nha-sach-tiki,34751487,"Ngụ Ngôn Song Ngữ Anh - Việt: Một Cuộc Thi Chạy (Tái Bản 2019)",19200,32000,12800,40
TIKI,nha-sach-tiki,89764009,"Bóng của cây sồi",95200,136000,40800,30
TIKI,nha-sach-tiki,4439903,"Kĩ Năng Cho Bé Trong Giao Tiếp Hàng Ngày: Biết Cảm Ơn Khi Nhận (Tái Bản)",21000,35000,14000,40
TIKI,nha-sach-tiki,2679923,"Dây chữ Happy Birthday nét kiểu",54000,54000,0,0
TIKI,nha-sach-tiki,34567948,"Combo Phát Triển IQ Cho Trẻ Em: Chữ Số Biến Ảo + Nhận Biết Thế Giới + Tư Duy LôGic + Rèn Luyện Trí Tuệ + Nhanh Tay Tinh Mắt + Trò Chơi Trí Tuệ (Bộ 6 Cuốn - Tặng Kèm Postcard Greenlife)",198350,198350,0,0
TIKI,nha-sach-tiki,54120846,"Hannibal Trỗi Dậy",102000,138000,36000,26
TIKI,nha-sach-tiki,87672638,"Combo Lấy Nước Đường Xa và Nhà Giả Kim",160200,178000,17800,10
TIKI,nha-sach-tiki,447497,"Phật Thuyết Đại Thừa Vô Lượng Thọ Trang Nghiêm Thanh Tịnh Bình Đẳng Giác Kinh (Quyển 1)",65000,65000,0,0
TIKI,nha-sach-tiki,1021663,"Thủy Hử (Trọn Bộ 2 Tập)",210000,320000,110000,34
TIKI,nha-sach-tiki,100931010,"BĂNG KEO TRONG - VÀNG DÁN THÙNG 200 YARD",25000,25000,0,0
TIKI,nha-sach-tiki,49292724,"Bộ Màu nước vẽ cao cấp 36 màu nén tặng kèm 8 món gồm túi đựng, bút nước, bút lông, bút chì, miếng mút, giấy vẽ, gọt chì, tuýp màu lẻ",135000,135000,0,0
TIKI,nha-sach-tiki,56271593," Nắm Nhầm Một Bàn Tay, Tìm Được Người Như Ý",86200,99000,12800,13
TIKI,nha-sach-tiki,76048205,"Sách - Tip Công Sở 2 - Khả Năng Đặt Câu Hỏi - Hỏi sao cho đúng",66000,97000,31000,32
TIKI,nha-sach-tiki,58616751,"Nha Sĩ Yêu Quái (Tái Bản 2020)",74000,109000,35000,32
TIKI,nha-sach-tiki,1639671,"Ngay Bây Giờ Hoặc Không Bao Giờ (Tái Bản)",53800,79000,25200,32
TIKI,nha-sach-tiki,510195,"Tiếng Gọi Nơi Hoang Dã (Khang Việt)",34000,72000,38000,53
TIKI,nha-sach-tiki,189076565,"Nhật ký Anne Frank (TB 2022)",66000,100000,34000,34
TIKI,nha-sach-tiki,138934612,"Combo 4 Cuốn: Tô Màu Phát Triển Trí Não Bộ Cho Bé 1-5 Tuổi",45000,64000,19000,30
TIKI,nha-sach-tiki,88783858,"Màu Nước Dạng Tuýp 5Ml Deli - 12 Màu/18 Màu/24 Màu - 73859 / 73860 / 73861",86400,86400,0,0
TIKI,nha-sach-tiki,52665707,"Nghệ Thuật Kiếm Tiền Của Người Do Thái (Tái Bản 2020)",59000,90000,31000,34
TIKI,nha-sach-tiki,169621652,"Anh Đừng Quyến Rũ Tôi - Tập 2",126000,169000,43000,25
TIKI,nha-sach-tiki,51251660,"Chữa Lành Ánh Sáng Bản Thể",152000,220000,68000,31
TIKI,nha-sach-tiki,128635778,"Thái Nhân Cách - Phía Sau Tội Ác (Khám Phá Bộ Não Của Những Kẻ Sát Nhân Máu Lạnh)",131600,189000,57400,30
TIKI,nha-sach-tiki,95090938,"Bút chì màu chuyên nghiệp dạng cốc Deli 24/36/48 màu - 68123/68124/68125",106200,106200,0,0
TIKI,nha-sach-tiki,57211761,"Nhóc Nicolas: Những chuyện chưa kể Tập 2 (Tái Bản 2020)",64800,85000,20200,24
TIKI,nha-sach-tiki,173732586,"423 Lời Vàng của Phật Kinh Pháp Cú Dhammapada (Tái bản)",33000,33000,0,0
TIKI,nha-sach-tiki,1725947,"Combo Hồng Lâu Mộng (Trọn Bộ 4 Tập Bìa Cứng)",240000,499000,259000,52
TIKI,nha-sach-tiki,174038516,"Máy tính Casio FX-570VN Plus New dành cho học sinh cấp 2-3 chuyên dụng phòng thi và thi đại học",549000,627000,78000,12
TIKI,nha-sach-tiki,148802212,"Phong Ma Yến Tước Tập 1 - Nuối Tiếc Giang Hồ",164000,215000,51000,24
TIKI,nha-sach-tiki,860788,"Harvard Bốn Rưỡi Sáng",111000,139000,28000,20
TIKI,nha-sach-tiki,84565498,"Thuật Xử Thế Của Người Xưa (Tái Bản 2021)",37000,55000,18000,33
TIKI,nha-sach-tiki,104732038,"Tớ Học Lập Trình - Làm Quen Với Lập Trình Scratch",94500,105000,10500,10
TIKI,nha-sach-tiki,101985321,"12 Quy Tắc Lãnh Đạo Từ Seal (Trách Nhiệm Tối Thượng - Thành Công Tối Đa)",142000,186000,44000,24
TIKI,nha-sach-tiki,160370109,"Chính Bắc (Discover Your True North) - Khám Phá Ra “Chiếc La Bàn Nội Tâm” Của Chính Mình Để Dẫn Dắt Bản Thân Nhằm Trở Thành Nhà Lãnh Đạo Đích Thực (Tái Bản)",120600,155000,34400,22
TIKI,nha-sach-tiki,138934624,"Tô Màu Phát Triển Trí Não Bộ Cho Bé 1-5 Tuổi - Tập 1",16000,16000,0,0
TIKI,nha-sach-tiki,194005243,"Truyện cổ Andersen",58500,79000,20500,26
TIKI,nha-sach-tiki,138504802,"Kinh Doanh Giỏi Phải Kiếm Được Tiền",110700,159000,48300,30
TIKI,nha-sach-tiki,74416876,"Luyện Giải Bộ Đề Bồi Dưỡng Học Sinh Giỏi Tiếng Anh Lớp 6",53100,89000,35900,40
TIKI,nha-sach-tiki,50586033,"The magic phép màu ( tái bản )",214000,238000,24000,10
TIKI,nha-sach-tiki,16631728,"Sách Dám Nghĩ Lớn (Bìa Cứng)",130000,188000,58000,31
TIKI,nha-sach-tiki,145288033,"Năm Tháng Tĩnh Lặng, Kiếp Này Bình Yên (Tái Bản)",104000,138000,34000,25
TIKI,nha-sach-tiki,109262820,"Gôm tẩy hình hoa anh đào Nhật Bản Deli -1 chiếc - dành cho học sinh - 71135 / 71136",7200,7200,0,0
TIKI,nha-sach-tiki,181699634,"Tổng Thống K. Thứ Tư",131000,200000,69000,35
TIKI,nha-sach-tiki,53303190,"Perfect IELTS Vocabulary",194000,259000,65000,25
TIKI,nha-sach-tiki,173347859,"Thiết Kế Sự Nghiệp Tương Lai",79100,109000,29900,27
TIKI,nha-sach-tiki,171549980,"Bức Tranh Toàn Cảnh - Nguồn Gốc Của Sự Sống, Của Nghĩa Lý Và Của Chính Vũ Trụ",208000,269000,61000,23
TIKI,nha-sach-tiki,58946834,"Sách PACE Books - Lãnh đạo tỉnh thức (The Mindful Leader) - Michael Bunting",108000,108000,0,0
TIKI,nha-sach-tiki,95089958," Bút gel Deli - 0.5mm - Nắp đậy - Mực Xanh - 1 chiếc - EQ300-BL",10800,10800,0,0
TIKI,nha-sach-tiki,115897815,"Tâm Hơn Thuốc - Minh Chứng Khoa Học Về Sự Tự Chữa Lành",119000,179000,60000,34
TIKI,nha-sach-tiki,273636803,"Trạm Đọc Official | Combo 2 Cuốn Hackers IELTS : Hackers IELTS Listening + Hackers IELTS Reading",373000,498000,125000,25
TIKI,nha-sach-tiki,68330624,"Dế Mèn Phiêu Lưu Ký – Đậu Đũa Minh Họa - Ấn Bản Kỉ Niệm 100 Năm Tô Hoài",160000,225000,65000,29
TIKI,nha-sach-tiki,65443438,"Sách PACE Books - KPI thước đo mục tiêu trọng yếu (Key Performance Indicators) - David Parmenter",155000,195000,40000,21
TIKI,nha-sach-tiki,53095307,"Nàng Tóc Đỏ (Nobel Văn Chương 2006)",89000,120000,31000,26
TIKI,nha-sach-tiki,73871086,"Bộ Dây Trang Trí Sinh Nhật Chữ Happy Birthday Thiết Kế Hoạt Hình",40000,40000,0,0
TIKI,nha-sach-tiki,555504,"Sách Đắc Nhân Tâm (Bìa Cứng) (Tái Bản)",74600,108000,33400,31
TIKI,nha-sach-tiki,7125311,"10 Vạn Câu Hỏi Vì Sao - Vật Lý Vui (Tái Bản 2018)",41000,55000,14000,25
TIKI,nha-cua-doi-song,108936951,"Bảng Gỗ Quy Tắc Gia Đình, Tranh Treo Tường Gia đình, Những Quy Tắc Để Con Có Cuộc Sống Hạnh Phúc",160000,160000,0,0
TIKI,nha-cua-doi-song,1611899,"Vợt Muỗi Điện Quang ĐQ EMR02 WR - Trắng Phối Đỏ",115855,136300,20445,15
TIKI,nha-cua-doi-song,57712474,"Keo dán đa năng trên mọi bề mặt 50ml+ Tặng kèm miếng dán nam châm",41000,41000,0,0
TIKI,nha-cua-doi-song,161030427,"Cây lau trần nhà, chổi quét trần nhà đa năng hình tam giác - Kitimop A3",149000,199000,50000,25
TIKI,nha-cua-doi-song,48522643,"Nhiệt ẩm kế cao cấp TT-513 Nhật Bản, đo nhiệt độ phòng, độ ẩm không khí- sản phẩm cần thiết trong mỗi gia đình",197000,296000,99000,33
TIKI,nha-cua-doi-song,48488492,"Đèn Ngủ Hình Mèo Con Siêu Dễ Thương - Chất liệu Silicon Dẻo Cao Cấp An Toàn ",90000,157725,67725,43
TIKI,nha-cua-doi-song,117059826,"Giấy lọc cà phê Hario 100 cái (V60-VCF-02-100W)",99000,99000,0,0
TIKI,nha-cua-doi-song,111472777,"Miếng Dán Tường Đa Năng SenNai - Móc Dán Cây Lau Nhà Loại Tốt - Chịu Tải Lên Đến 5kg",17820,18000,180,1
TIKI,nha-cua-doi-song,198193045,"Khăn lau kính lau xe ma thuật không để lại vết mờ - Hàng cao cấp - Hàng hót 2022",16900,16900,0,0
TIKI,nha-cua-doi-song,79691104,"Bộ Hộp Cơm Giữ Nhiệt Văn Phòng Cao Cấp Cắm Điện inox 3 tầng - Chính Hãng",209000,300000,91000,30
TIKI,nha-cua-doi-song,73467694,"Kệ để lò vi sóng đa năng Inox 304 cao cấp Vando chính hãng kệ để đồ lò nướng chắc chắn, sơn tĩnh điện chống bong tróc, kệ nhà bếp siêu chịu lực 300kg",1099000,1099000,0,0
TIKI,nha-cua-doi-song,94891198,"Hộp Cơm Giữ Nhiệt INOX304 Hiện Đại Kèm Hộp Đựng Canh Soup và Bộ Đũa Thìa INOX – Chất Liệu Cao Cấp An Toàn Cho Sức Khỏe – Hàng Chính Hãng Vinbuy",281000,500000,219000,44
TIKI,nha-cua-doi-song,183029245,"Mền lông cừu Caro cao cấp A kích thước 1m8 x 2m",195000,195000,0,0
TIKI,nha-cua-doi-song,143861521,"Dây Led Neon Flex 12V Kèm Nguồn Dài 1M/2M/3M/5M Trang Trí Cổ Điển",100000,100000,0,0
TIKI,nha-cua-doi-song,178936441," Đũa Gỗ Mộc Hương Cao Cấp - Gỗ Tự Nhiên - Đánh Bóng Thủ Công - Không Ẩm Mốc - Vỉ 10 đôi ",135000,135000,0,0
TIKI,nha-cua-doi-song,130769103,"Bộ 12 Hũ Thủy Tinh Sọc Làm Sữa Chua 100ml, Hũ Lọ Yaourt, Lọ Pudding, Hủ Làm Sữa Chua, Caramen- Có Nắp Đậy- Hàng Chính Hãng MINIIN",56000,65000,9000,14
TIKI,nha-cua-doi-song,108918404,"GA GIƯỜNG THUN LẠNH MÀU TRƠN - Xám chì - Ga lẻ 1x2m nệm 5->15cm",100000,100000,0,0
TIKI,nha-cua-doi-song,193541405,"Áo Mưa Bít Trẻ Em Cho Bé Cute Dễ Thương Siêu Dày Chống Thấm Nước Có Phản Quang Phơi Mau Khô Ráo Che Kín Người Kèm Túi Đựng Deli - Chất Liệu An Toàn Có Lựa Chọn Nhiều Size Màu Sắc",196000,340200,144200,42
TIKI,nha-cua-doi-song,162577287,"Cuộn Dây 5m/10m Đèn LED Trang Trí RGB 5050 Strip Light miDoctor, Quấn Cây Chống Nước, Trang Trí Phòng, Dán Tường, Bàn Máy Tính, Tạo Không Gian Quay Video Tiktok, Chụp Ảnh, Kèm Remote 44 Phím",115000,115000,0,0
TIKI,nha-cua-doi-song,76451291,"Đèn Led Đom Đóm Dây Kẽm Dễ Uốn Kèm Pin CR2032",9999,9999,0,0
TIKI,nha-cua-doi-song,83927711,"Bịt Mắt Ngủ Che Mắt Ngủ Có Túi Gel Massage - Giảm Thâm Quầng Mắt - Mẫu Hoạt Hình Mới - Xanh Nhạt",35000,35000,0,0
TIKI,nha-cua-doi-song,191918105,"Bộ Bàn Chải Vệ Sinh Các Khe LocknLock ETM415 - 2 cái/bộ",20000,39000,19000,49
TIKI,nha-cua-doi-song,141143706,"Ly Giữ Nhiệt Cà Phê Nắp Trượt Chống Tràn Rinfere (295ml)",249000,349000,100000,29
TIKI,nha-cua-doi-song,147694768,"găng tay làm bếp nấu ăn siêu dai Victoria Bay chất liệu TPE không mùi chống nhăn hộp 100 cái size M",11000,16998,5998,35
TIKI,nha-cua-doi-song,104027916,"Bộ gối tựa lưng và đệm lót ghế chống đau xương cụt Ema loại có gel cao cấp cho dân văn phòng, lái xe, sinh viên",330000,660000,330000,50
TIKI,nha-cua-doi-song,121268576,"Ổ cắm điện 5 lỗ 2m Điện Quang SM750SL - Hàng Chính Hãng",166000,166000,0,0
TIKI,nha-cua-doi-song,25055074,"Tủ vải quần áo 3 buồng 8 ngăn, khách được chọn màu,  khung sắt sơn tĩnh điện, vải không dệt",210000,210000,0,0
TIKI,nha-cua-doi-song,143363686,"Băng keo chống thấm x2000 Nhật Bản chống thấm dột, dán tường, dán mái tôn, dán ống nước",24000,40000,16000,40
TIKI,nha-cua-doi-song,127152344,"Chổi Cọ Nhà Vệ Sinh Bồn Cầu Toilet Không Dây Đa Năng SENNAI Pin 4000mAh - Hàng Chính Hãng",129000,195000,66000,34
TIKI,nha-cua-doi-song,200762341,"Cốc Giữ Nhiệt Ly Giữ Nhiệt Inox 304 Có Ống Hút Ly Uống Coffee 600ml",88312,88312,0,0
TIKI,nha-cua-doi-song,135156091,"Tua vít bake thép 3*100mm",10000,10000,0,0
TIKI,nha-cua-doi-song,69843631,"CÂY TREO QUẦN ÁO HÀN QUỐC GỖ LẮP RÁP- STANDING HANGER- BLUE HOME- MÀU GỖ TỰ NHIÊN",259000,279000,20000,7
TIKI,nha-cua-doi-song,192635575,"Combo Chén/ Bát gáo dừa + Muỗng gỗ dừa DK Harvest - Loại size lớn 12 - 14cm (Loại Xuất khẩu)",38000,38000,0,0
TIKI,nha-cua-doi-song,56228508,"Phân bón hữu cơ dịch chuối DOCNEEM, phân bón cho phong lan, hoa hồng, cây cảnh kích rễ, kích kei, chồi, mầm, chai 1 lít",119000,119000,0,0
TIKI,nha-cua-doi-song,186348775,"Đệm ngồi ghế văn phòng chống đau xương cụt, ê mông, thâm mông, xệ mông cho dân văn phòng, lái xe, học sinh - Thương hiệu EMA - Loại cao cấp có gel tản nhiệt",285000,570000,285000,50
TIKI,nha-cua-doi-song,53098903,"Giá treo khăn - Vắt Khăn tắm, Giá treo khăn tắm inox 304 Đa năng 2 tầng, có móc treo quần áo Cao Cấp",380000,510000,130000,25
TIKI,nha-cua-doi-song,199263383,"Bàn Ăn Phong Cách Bắc Âu Đơn Giản Thương Hiệu IGA - GP181",485000,528000,43000,8
TIKI,nha-cua-doi-song,134360863,"Vỉ 6 Viên Pin AA , Pin AAA Energizer Max 1,5V Alkaline - Hàng chính hãng",79000,90000,11000,12
TIKI,nha-cua-doi-song,59500188,"Gối cổ chữ U cao su non Nice Food",115000,115000,0,0
TIKI,nha-cua-doi-song,184282768,"Combo 6 túi giặt 3 lớp bảo vệ quần áo, đồ lót dùng cho máy giặt chính hãng Dododios",149000,149000,0,0
TIKI,nha-cua-doi-song,162407831,"Kệ Để Máy Tính Kết Hợp Kệ Sách Đa Năng Hiện Đại Thương Hiệu IGA - GP184",176000,186000,10000,5
TIKI,nha-cua-doi-song,89198232,"Kệ Gia Vị Để Bàn Nora Cho Phòng Bếp Gọn Gàng - GM04",133000,146000,13000,9
TIKI,nha-cua-doi-song,51473042,"Kệ đa năng Tokyo 4 tầng hàng cao cấp",154000,154000,0,0
TIKI,nha-cua-doi-song,131145091,"Giá Sách Mini Tủ Đầu Giường Phong Cách Nordic Thương Hiệu IGA - GP156",221000,240000,19000,8
TIKI,nha-cua-doi-song,165594187,"Kệ Sách Để Bàn Có Hộc Đựng Tiện Lợi Thương Hiệu IGA - GP187",134000,134000,0,0
TIKI,nha-cua-doi-song,131498054,"Bóng đèn LED trụ Hi-lumen G3 PHILIPS E27 - Độ sáng cao, tiết kiệm điện, chất lượng ánh sáng vượt trội - Hàng Chính Hãng",134000,264000,130000,49
TIKI,nha-cua-doi-song,113773790,"Bình Thủy Tinh 2 Lớp Pha Trà Doron MS79 - Cách Nhiệt Tốt - Có Lõi Lọc Inox 304 - Dung Tích 400ml - Hàng Loại 1",129000,129000,0,0
TIKI,nha-cua-doi-song,208358660,"Ổ cắm điện LiOA đa năng - 3 lỗ, 4 lỗ, 6 lỗ, 8 lỗ dây dài 3m/5m - Chính Hãng - MITA",95000,95000,0,0
TIKI,nha-cua-doi-song,96703757,"bàn làm việc - Nâu - 80x40x75cm",179999,179999,0,0
TIKI,nha-cua-doi-song,117138509,"Ổ cắm điện LiOA đa năng - 3 lỗ, 4 lỗ, 6 lỗ, 8 lỗ dây dài 3m/5m - Chính Hãng - MITA",92000,92000,0,0
TIKI,nha-cua-doi-song,135507759,"Dây vòi hoa sen tắm nóng lạnh Pimisi bằng inox 304 với đầu dây đồng thau không gỉ phù hợp với mọi sen tắm trong nhà vệ sinh dài 150cm chống xoắn - mạ xi sáng bóng - ống mềm cấp nước và dùng được cho cả vòi xịt nhà vệ sinh phòng tắm | Hàng chính hãng",87000,120000,33000,28
TIKI,nha-cua-doi-song,12197016,"Bộ 280 Ống gen co nhiệt cách điện nhiều màu đủ size",28896,28896,0,0
TIKI,nha-cua-doi-song,158804921,"Gối ngủ cao su non vỏ sợi tre kháng khuẩn cao cấp cho người lớn EMA - Phong cách Nhật Bản - Chống đau mỏi cổ vai gáy, ngủ ngáy - KT 50x30x10cm",149000,298000,149000,50
TIKI,nha-cua-doi-song,52021508,"Bảng điện nổi V2 Điện Quang ĐQ FEP 32W 02S (màu trắng, 3 lỗ 2 chấu, 2 công tắc)",60000,81200,21200,26
TIKI,nha-cua-doi-song,55630076,"Miếng lót ly bằng đất xốp Diatomite siêu hút nước, thông điệp ý nghĩa",55000,55000,0,0
TIKI,nha-cua-doi-song,6710595,"Bộ 10 móc treo dán tường chịu lực 10kg",4000,30000,26000,87
TIKI,nha-cua-doi-song,7221847,"Bộ Nồi Inox Sunhouse Mama cao cấp 5 đáy SH784 (16cm, 20cm, 24cm) - Dùng cho mọi loại bếp - Hàng chính hãng",858000,1340000,482000,36
TIKI,nha-cua-doi-song,23476097,"Ô Dù Che mưa Che Nắng Chống Tia UV (màu ngẫu nhiên)",28000,150000,122000,81
TIKI,nha-cua-doi-song,175147417,"Set 10 hộp nhựa chữ nhật mỏng đựng thực phẩm Đại Đồng Tiến 100% nhựa PP an toàn cho sức khỏe dùng được cho lò vi sóng",49020,51600,2580,5
TIKI,nha-cua-doi-song,50339509,"Kệ sách gỗ để đồ đa năng 2 tầng kích thước 80*26*50 cm",159000,179000,20000,11
TIKI,nha-cua-doi-song,165758264,"Bộ dao 2 chiếc Eco Family Sunhouse KS-KN2E1",102000,163000,61000,37
TIKI,nha-cua-doi-song,44350764,"Combo 2 Thanh treo đồ dán tường,tủ quần áo, nhà bếp, có 6 móc chịu lực (giao màu ngẫu nhiên) GD263-MTSC-Thanh2",34899,34899,0,0
TIKI,nha-cua-doi-song,149387829,"Hộp Đựng Giấy Vệ Sinh Đa Năng 2 Tầng Treo Tường Cao Cấp - Có Ngăn Kéo Và Khe Cắm Điện Thoại, Ipad - Hàng Chính Hãng Nhập Khẩu",125000,159000,34000,21
TIKI,nha-cua-doi-song,50775246,"Gối hơi du lịch, gối kê cổ du lịch, văn phòng tự bơm, gối hơi kê cổ đa năng, nhiều màu, giao ngẫu nhiên+ Tặng kèm hình dán",95000,95000,0,0
TIKI,nha-cua-doi-song,177744785,"Bộ lau nhà tách nước bẩn Kitimop K22 Plus có thùng lau nhà tự vắt 2 ngăn riêng biệt, chổi lau nhà xoay 360 độ lau sạch khô nhanh, 2 bông lau",459000,685000,226000,33
TIKI,nha-cua-doi-song,35273810,"Keo vá tường,Keo trám vết nứt tường thông minh - Tặng kèm bộ dụng cụ",16051,16051,0,0
TIKI,nha-cua-doi-song,139600248,"Miếng Tấm Pát Pad Thép Vuông Sửa Bản Lề Tủ Cửa Gỗ Lỗ Vít Door Hinge Repair Kit",10000,10000,0,0
TIKI,nha-cua-doi-song,59318679,"Bộ Ga Gối Cotton Tici Kẻ LIDACO Cao Cấp - Caro Nâu Nhạt",159000,229000,70000,31
TIKI,nha-cua-doi-song,135442402,"Mỏ Hàn Điện Deli Chính Hãng 30W / 60W Chất Lượng Cao - Sử Dụng Đa Năng, Tiện Ích - DL8830 / DL8860",83000,142200,59200,42
TIKI,nha-cua-doi-song,27948515,"Bộ 2 móc treo chổi, cây lau nhà dụng cụ tẩy rửa nhà tắm dán tường chống khuẩn tiết kiệm không gian chịu lực tối đa 5Kg",10899,10899,0,0
TIKI,nha-cua-doi-song,161455657,"Bóng đèn led 30W TAT",19000,19000,0,0
TIKI,nha-cua-doi-song,191918103,"Dụng cụ rửa chai và ly LocknLock ETM143DGRY - Màu xám đen",41000,79000,38000,48
TIKI,nha-cua-doi-song,186440945,"Giá Sách Treo Tường Trang Trí FIVO Mã FB40 Không Cần Khoan Tặng Kèm Đinh 4 Chân Chịu Lực Lên Đến 10KG Với Móc Inox Dễ Dàng Gắn Lên Tường",42000,82000,40000,49
TIKI,nha-cua-doi-song,58802544,"Hộp Cơm Giữ Nhiệt INOX304 Hiện Đại Tặng Kèm Túi Giữ Nhiệt",162630,208500,45870,22
TIKI,nha-cua-doi-song,106385679,"Túi Giữ Nhiệt Đựng Hộp Cơm Văn Phòng Siêu Dày – Chọn Size – Giữ Nhiệt – 3 Lớp - Chống Thấm Cao Cấp Chính Hãng miDoctor",67000,67000,0,0
TIKI,nha-cua-doi-song,144582478," Dán Tường Để Đồ Đa Năng, Dán Tường Để Điện Thoại, Để Điều Khiển... - Giao màu ngẫu nhiên ",15000,15000,0,0
TIKI,nha-cua-doi-song,55481938,"Đồng hồ gỗ LED để bàn cao cấp - Gỗ đen led trắng - Hiển thị nhiệt độ",195000,195000,0,0
TIKI,nha-cua-doi-song,182602992,"Khăn Tắm Gội Đầu Lau Mặt ROYAL TOWEL Dùng Cho Gia Đình Spa Khách Sạn 100% Cotton Thấm Hút Không Ra Màu",29000,29000,0,0
TIKI,nha-cua-doi-song,116571619,"Ga Chống Thấm Cotton LIDACO Cao Cấp - Kẻ sao - 1m2x2mxdưới12cm",149000,200000,51000,26
TIKI,nha-cua-doi-song,116571600,"Ga Chống Thấm Cotton LIDACO Cao Cấp - Hươu vàng - 1m4x2mxdưới12cm",149000,160000,11000,7
TIKI,nha-cua-doi-song,116571657,"Ga Chống Thấm Cotton LIDACO Cao Cấp - Kitty hồng - 2m2x2mxdưới12cm",199000,217000,18000,8
TIKI,nha-cua-doi-song,116571660,"Ga Chống Thấm Cotton LIDACO Cao Cấp - Kẻ sao - 1m6x2mxdưới12cm",149000,179000,30000,17
TIKI,nha-cua-doi-song,116571721,"Ga Chống Thấm Cotton LIDACO Cao Cấp - Cá đĩa - 1m4x2mxdưới12cm",149000,189000,40000,21
TIKI,nha-cua-doi-song,116571707,"Ga Chống Thấm Cotton LIDACO Cao Cấp - Baby shark - 2m2x2mxdưới12cm",199000,213000,14000,7
TIKI,nha-cua-doi-song,116571729,"Ga Chống Thấm Cotton LIDACO Cao Cấp - Cá đĩa - 1m8x2mxdưới12cm",155000,300000,145000,48
TIKI,nha-cua-doi-song,116571742,"Ga Chống Thấm Cotton LIDACO Cao Cấp - Cá đĩa - 2m2x2mxdưới12cm",199000,226000,27000,12
TIKI,nha-cua-doi-song,116571625,"Ga Chống Thấm Cotton LIDACO Cao Cấp - Dâu nhật - 1m4x2mxdưới12cm",149000,154000,5000,3
TIKI,nha-cua-doi-song,116571685,"Ga Chống Thấm Cotton LIDACO Cao Cấp - Cá đĩa - 1m2x2mxdưới12cm",149000,189000,40000,21
TIKI,nha-cua-doi-song,116571649,"Ga Chống Thấm Cotton LIDACO Cao Cấp - Kitty hồng - 1m2x2mxdưới12cm",149000,217000,68000,31
TIKI,nha-cua-doi-song,116571693,"Ga Chống Thấm Cotton LIDACO Cao Cấp - Baby shark - 1m4x2mxdưới12cm",149000,184000,35000,19
TIKI,nha-cua-doi-song,116571597,"Ga Chống Thấm Cotton LIDACO Cao Cấp - Hươu vàng - 1m2x2mxdưới12cm",149000,160000,11000,7
TIKI,nha-cua-doi-song,116571735,"Ga Chống Thấm Cotton LIDACO Cao Cấp - Thỏ bé - 1m6x2mxdưới12cm",149000,179000,30000,17
TIKI,nha-cua-doi-song,129144356,"Ga Chống Thấm Cotton LIDACO Cao Cấp - Lông vũ - 1m2x2mxdưới12cm",149000,189000,40000,21
TIKI,nha-cua-doi-song,116571731,"Ga Chống Thấm Cotton LIDACO Cao Cấp - Thỏ bé - 1m4x2mxdưới12cm",149000,160000,11000,7
TIKI,nha-cua-doi-song,116571671,"Ga Chống Thấm Cotton LIDACO Cao Cấp - Kẻ sao - 2m2x2mxdưới12cm",199000,226000,27000,12
TIKI,nha-cua-doi-song,116571710,"Ga Chống Thấm Cotton LIDACO Cao Cấp - Baby shark - 1m6x2mxdưới12cm",149000,159000,10000,6
TIKI,nha-cua-doi-song,116571727,"Ga Chống Thấm Cotton LIDACO Cao Cấp - Cá đĩa - 1m6x2mxdưới12cm",149000,179000,30000,17
TIKI,nha-cua-doi-song,116571623,"Ga Chống Thấm Cotton LIDACO Cao Cấp - Kitty hồng - 1m4x2mxdưới12cm",149000,189000,40000,21
TIKI,nha-cua-doi-song,116571699,"Ga Chống Thấm Cotton LIDACO Cao Cấp - Baby shark - 1m8x2mxdưới12cm",155000,200000,45000,23
TIKI,nha-cua-doi-song,116571716,"Ga Chống Thấm Cotton LIDACO Cao Cấp - Thỏ bé - 1m8x2mxdưới12cm",155000,242000,87000,36
TIKI,nha-cua-doi-song,116571663,"Ga Chống Thấm Cotton LIDACO Cao Cấp - Kẻ sao - 1m8x2mxdưới12cm",155000,200000,45000,23
TIKI,nha-cua-doi-song,116571667,"Ga Chống Thấm Cotton LIDACO Cao Cấp - Baby shark - 1m2x2mxdưới12cm",149000,154000,5000,3
TIKI,nha-cua-doi-song,116571741,"Ga Chống Thấm Cotton LIDACO Cao Cấp - Thỏ bé - 1m2x2mxdưới12cm",149000,250000,101000,40
TIKI,nha-cua-doi-song,116571607,"Ga Chống Thấm Cotton LIDACO Cao Cấp - Phong lan - 1m4x2mxdưới12cm",149000,189000,40000,21
TIKI,nha-cua-doi-song,116571655,"Ga Chống Thấm Cotton LIDACO Cao Cấp - Kẻ sao - 1m4x2mxdưới12cm",149000,189000,40000,21
TIKI,nha-cua-doi-song,186645870,"Máy Bắn Keo Nến Deli - Phù hợp DIY Làm Đồ Handmade Thủ Công - An Toàn, Nhỏ Gọn, Dễ Sử Dụng - DL390120",79000,171000,92000,54
TIKI,nha-cua-doi-song,116571687,"Ga Chống Thấm Cotton LIDACO Cao Cấp - Thỏ bé - 2m2x2mxdưới12cm",199000,250000,51000,20
TIKI,nha-cua-doi-song,116571602,"Ga Chống Thấm Cotton LIDACO Cao Cấp - Hươu vàng - 1m6x2mxdưới12cm",149000,169000,20000,12
TIKI,nha-cua-doi-song,189492088,"Nhang Sen Thuần Khiết Liên Tâm 29cm 200 cây - Ít khói, dịu nhẹ, 100% Đài sen thiên nhiên",99750,99750,0,0
TIKI,nha-cua-doi-song,69741184,"Thanh treo inox cao cấp không cần khoan tường, siêu chắc chắn, khả năng chịu tải cao HT07",150000,150000,0,0
TIKI,nha-cua-doi-song,96209890,"Dụng cụ thông ống thoát nước chuyên nghiệp có tay cầm - Độ dài dây lò xo: 5m",153400,153400,0,0
TIKI,nha-cua-doi-song,36300228,"Bộ Móc treo chữ S, có 3 size chọn lựa",21300,21300,0,0
TIKI,nha-cua-doi-song,217736127,"Ga Chống Thấm Cotton LIDACO Cao Cấp - San hô",149000,250000,101000,40
TIKI,nha-cua-doi-song,116571627,"Ga Chống Thấm Cotton LIDACO Cao Cấp - Dâu nhật - 1m6x2mxdưới12cm",149000,179000,30000,17
TIKI,nha-cua-doi-song,118680989,"Set nến thơm hộp quà thắt nơ – xinh xắn phù hợp làm quà tặng bạn gái",100000,100000,0,0
TIKI,nha-cua-doi-song,116571603,"Ga Chống Thấm Cotton LIDACO Cao Cấp - Dâu nhật - 1m8x2mxdưới12cm",155000,291000,136000,47
TIKI,nha-cua-doi-song,164158123,"Vỉ 2 Viên Pin Duracell CR2032 / CR2025 / CR2016 Lithium 3V - Hàng chính hãng",60000,60000,0,0
TIKI,nha-cua-doi-song,101841654,"Đàn Kalimba Cega 17 phím gỗ nguyên tấm Mahogany",290000,290000,0,0
TIKI,nha-cua-doi-song,19423384,"Bộ võng xếp BAN MAI: sơn tĩnh điện và lưới thép số 9 (Giao màu ngẫu nhiên)",619000,920000,301000,33
TIKI,nha-cua-doi-song,57146868,"máy đồng hồ treo tường kim trôi ja-pan",59000,59000,0,0
TIKI,nha-cua-doi-song,25140473,"KỆ LÒ VI SÓNG 3 TẦNG Dài 60cm x Cao 80cm",229000,350000,121000,35
TIKI,nha-cua-doi-song,136855573,"Xe Kéo Hàng, Xe Đẩy Hàng Gấp Gọn Nhập Khẩu Chất Lượng Cao XKT04 Mới",559000,559000,0,0
TIKI,nha-cua-doi-song,135720334,"Bình pha trà cafe French Press Lock&Lock, 800ml - LLG018",169000,255000,86000,34
TIKI,nha-cua-doi-song,204207230,"Nhang nụ trầm hương đốt xông nhà tẩy uế HÀ XÁ đồ thờ cúng phong thủy, xua đuổi vận xui, thu hút nguồn năng lượng tích cực, thanh lọc không khí, an toàn cho sức khỏe",99000,198000,99000,50
TIKI,nha-cua-doi-song,69226574,"Combo 10 viên pin CR2032 Maxell Nhật Bản",31700,31700,0,0
TIKI,nha-cua-doi-song,89144285,"Cốc Dán Tường Nhà Tắm Hình Gấu Nâu Dễ Thương - Cốc Đựng Bàn Chải Đánh Răng - Cốc Hình Gấu",6898,6898,0,0
TIKI,nha-cua-doi-song,202840456,"Kệ Lò Vi Sóng Effect Đa Năng - GM02",128000,139000,11000,8
TIKI,nha-cua-doi-song,57755151,"Đèn đường năng lượng mặt trời 300W",760000,760000,0,0
TIKI,nha-cua-doi-song,79323009,"Tủ Sách Đa Năng Conven Phong Cách Nordic Thương Hiệu IGA",632000,689000,57000,8
TIKI,nha-cua-doi-song,168234677,"[Hàng chính hãng] Ghế chỉnh dáng ngồi đúng - Curble Wider_Premium Model Hàn Quốc (Made in Korea). Phù hợp mọi đối tượng (Free Size)",699840,729000,29160,4
TIKI,nha-cua-doi-song,52004331,"Kệ lò nướng - Kệ lò vi sóng - kệ nhà bếp đa năng bằng gỗ thông tự nhiên 4 tầng kích thước 60 x 40 x 110 cm",319000,450000,131000,29
TIKI,nha-cua-doi-song,57911829,"GỐI MỀN 3 trong 1 Trái Cây hình thú cute, thun 4 chiều siêu mịn, bộ chăn gối văn phòng, gấu bông kèm mền GM74-Chuotfruit",158745,158745,0,0
TIKI,nha-cua-doi-song,57046106,"Bình Đựng Nước Lock&Lock Easy Grip Dung Tích 1.5L HAP814",48000,77000,29000,38
TIKI,nha-cua-doi-song,158462914,"Cây Lau Kính, Gạt Chùi Kính Đa Năng 2 Đầu Trong 1 MyJae Cán Dài Uốn Xoay Thông Minh Chống Trơn Trượt",239000,390000,151000,39
TIKI,nha-cua-doi-song,578902,"Chảo Đáy Từ Chống Dính Sunhouse SHM26 26cm",207000,300000,93000,31
TIKI,nha-cua-doi-song,55580718,"Bộ 3 Nồi Inox 304 Đáy Từ 5 Đáy Nagakawa NAG1352 (16cm, 20cm, 24cm) - Hàng Chính Hãng",1000000,1890000,890000,47
TIKI,nha-cua-doi-song,1918931,"Keo Dán Đa Năng Selleys Epoxy Fix (10ml / Tuýp)",37050,39000,1950,5
TIKI,nha-cua-doi-song,75330721,"Then Chốt Cài Cửa, Chốt Khóa Bằng Thép Không Gỉ KUNBE An Toàn Tiện Lợi Nhiều Kích Thước",22900,22900,0,0
TIKI,nha-cua-doi-song,87831027,"ĐÈN NĂNG LƯỢNG MẶT TRỜI 100W - 180W - 80W - 60W - 45W  SOLAR LIGHT - ĐIỀU KHIỂN TỪ XA - PIN SẠC TRỌN DỜI - D1147",290000,290000,0,0
TIKI,nha-cua-doi-song,165844799,"Giá Kệ Sách Để Sàn 5 Tầng Gỗ Cao Cấp Màu Trắng FIVO Mã FB70 Gỗ MDF Phủ Melamine Chống Thấm Bề Mặt Phù Hợp Với Nhiều Không Gian",749000,1168000,419000,36
TIKI,nha-cua-doi-song,72527573,"Hộp Đựng Giấy Vệ Sinh Cao Cấp OENON Dán Tường, Hộp Đựng Giấy Đa Năng Có Thêm Ngăn Để Đồ Tiện Lợi - OENON",149000,280000,131000,47
TIKI,nha-cua-doi-song,21268314,"Ổ cắm điện chuyển đổi đa chức năng dùng khi xuất ngoại, đi du lịch,...",35000,35000,0,0
TIKI,nha-cua-doi-song,48622915,"Bộ Đầu Vòi Xịt Vệ Sinh (Toilet), Vệ Sinh Bồn Cầu + Giá Đỡ - Thiết kế Thông Minh Nhỏ Gọn Tiện Ích",55000,69000,14000,20
TIKI,nha-cua-doi-song,125739804,"BỘ CÂY LAU NHÀ THÔNG MINH SAGOKER, mã BLNEC",146000,159999,13999,9
TIKI,nha-cua-doi-song,48287902,"KỆ GIÀY DÉP 2 TẦNG GỖ THÔNG- Dài 50cm x Cao 50cm",109000,169000,60000,36
TIKI,nha-cua-doi-song,142441475,"Hộp Sấy Và Khử Khuẩn Đũa Thìa Muỗng Thông Minh,  Có Nắp Đậy Cao Cấp Chống Côn Trùng, Kiến, Dán Tường Chắc Chắn- Hàng Loại 1 Chính Hãng MINIIN",229000,229000,0,0
TIKI,nha-cua-doi-song,7159593,"Khóa số chống trộm an toàn Royal",32000,32000,0,0
TIKI,nha-cua-doi-song,21482254,"Bàn gấp chân sắt 1m2 BVP23Đ",396900,490000,93100,19
TIKI,nha-cua-doi-song,193777239,"Cưa cành cây cưa gỗ gấp gọn bằng thép không gỉ sản xuất tại NHẬT BẢN",25000,50000,25000,50
TIKI,nha-cua-doi-song,24482769,"Dây xịt vệ sinh inox 304 dài 120cm",54000,60000,6000,10
TIKI,nha-cua-doi-song,146260986,"Nồi inox kho cá thịt chống dính bếp từ Fivestar ( 18cm / 20cm / 22cm ) nắp kính , 3 đáy , inox 430 , tặng 1 vá canh",199000,199000,0,0
TIKI,nha-cua-doi-song,103755910,"Ghế tatami, ghế lười bệt tựa lưng nệm - Có 5 cấp độ ngã lưng - Chính hãng TIDO",390000,390000,0,0
TIKI,nha-cua-doi-song,117125057,"Ổ Cắm Điện LiOA Phổ Thông - Ổ Cắm Điện 3 lỗ - 4 lỗ - 5 lỗ - 6 lỗ - dài 3m - MITA",65000,65000,0,0
TIKI,nha-cua-doi-song,117560257,"CHẢO CHỐNG DÍNH SÂU LÒNG SIÊU TIỆN LỢI",33999,33999,0,0
TIKI,nha-cua-doi-song,196051243,"Búa Lùn Nguyên Khối Deli Chính Hãng - Đóng Đinh, Nhổ Đinh Dễ Dàng, Tiện Dụng - Nhỏ Gọn, Tay Cầm Bọc Cao Su - DL441008",62000,106000,44000,42
TIKI,nha-cua-doi-song,125604026,"Dây Treo Trang Trí Noel Dài 3m",25000,25000,0,0
TIKI,nha-cua-doi-song,54156958,"Pin Sạc Energizer AAA 700mAh Power Plus",157000,160000,3000,2
TIKI,nha-cua-doi-song,156222332,"SEN TẮM CÂY NÓNG LẠNH NHẬP KHẨU NGA FULLBOX F2428 - HÀNG CHÍNH HÃNG - SIÊU BỀN BỈ",2491000,4700000,2209000,47
TIKI,nha-cua-doi-song,272035598,"HỘP 10 ĐÔI ĐŨA INOX 304 - CAO CẤP - SANG TRỌNG - NGUYÊN KHỐI INOX 304",235000,235000,0,0
TIKI,nha-cua-doi-song,172143534,"Kệ Gỗ Để Đồ Đa Năng Có Bánh Xe Di Chuyển Dễ Dàng - GP190",216000,235000,19000,8
TIKI,nha-cua-doi-song,85029640,"Ổ cắm Điện Quang ĐQ ESK 2WR 23-3U (2 lỗ 3 chấu, 3 USB, dây dài 2m, màu trắng đỏ)",214160,267700,53540,20
TIKI,nha-cua-doi-song,124691053,"Đệm thắt lưng tam giác Ema thế hệ 2 - Rộng hơn - Thoải mái xoay trở - Dành cho người thoát vị thắt lưng, bà bầu, người cao tuổi",200000,400000,200000,50
TIKI,nha-cua-doi-song,44321391,"Tủ nhựa lắp ghép 6 Ô quần áo (70cm x 110cmx47cm)",279000,279000,0,0
TIKI,nha-cua-doi-song,168837331,"Giấy Nến Lót Nồi Chiên Không Dầu Hình Khuôn Bánh Siêu Tiện Lợi - Thấm Giảm Thiểu Tối Đa Dầu Mỡ Bám - Hàng Chính Hãng MINIIN",99000,99000,0,0
TIKI,nha-cua-doi-song,78890431,"Bộ nắp bàn cầu nhà vệ sinh bằng nhựa cao cấp, thích hợp sử dụng với nhiều loại bồn cầu",65000,65000,0,0
TIKI,nha-cua-doi-song,190542051,"[70*140cm] Khăn Tắm Viên Nén HQ",8900,15000,6100,41
TIKI,nha-cua-doi-song,39292323,"Bình Nước Thủy Tinh WATER Phong Cách Hàn Quốc 460ml",115000,115000,0,0
TIKI,nha-cua-doi-song,96183241,"Chân đàn Organ, Piano đa năng - Kzm Kurtzman STX2 - Dáng chữ X đôi - Hàng chính hãng",210000,210000,0,0
TIKI,nha-cua-doi-song,2039747,"Bộ Nồi Inox 3 Đáy Sunhouse SH334",440000,690000,250000,36
TIKI,nha-cua-doi-song,145243898,"Bộ vòi bơm hút nước rửa chén gắn chậu rửa HOBBY Home Decor NRC4 màu đen đầu bơm Inox 304 kèm dây dẫn 120cm",209000,280000,71000,25
TIKI,nha-cua-doi-song,56451459,"Pin C carbon Panasonic R14UT/2S chính hãng",27550,29000,1450,5
TIKI,nha-cua-doi-song,53116171,"PHÂN TRÙN QUẾ DẠNG VIÊN NÉN SFARM CHUYÊN DÙNG CHO LAN VÀ HOA KIỂNG TRỒNG CHẬU - BỔ SUNG HỆ VI SINH CÓ LỢI CHO ĐẤT",45000,45000,0,0
TIKI,nha-cua-doi-song,47462861,"Bộ 6 vỉ (12 viên pin) pin Kiềm Alkaline Panasonic AAA LR03T/2B-Hàng chính hãng",167000,180000,13000,7
TIKI,nha-cua-doi-song,162875961,"Hộp 10 Đôi Đũa  Sừng Chất Liệu Hợp Kim Mạ Vàng Cao Cấp Đầu Đũa Có Chống Trơn - Hàng Loại 1 - Chính Hãng MINIIN",32000,32000,0,0
TIKI,nha-cua-doi-song,15262922,"Đầu Gắn Vòi Nước Rửa Chén Xoay 360 Độ Tiết Kiệm Nước XR581",18800,18800,0,0
TIKI,nha-cua-doi-song,55134471,"1kg - Túi đựng rác gia đình , Bao đựng rác văn phòng 3 màu size trung 55x65",34000,34000,0,0
TIKI,nha-cua-doi-song,195544340,"Bình Inox Đựng Rượu CCCP Truyền Thống Dung Tích 2.0L Dày 0,6 ly - 64OZ ( Loại 1 ), Kèm Bao Da Phong Cách",185000,398000,213000,54
TIKI,nha-cua-doi-song,140204791,"Bộ 24 Quả Châu Bóng Nhũ Kim Tuyến Lấp Lánh Trang Trí Cây Thông Noel Giáng Sinh Giá Rẻ",78000,78000,0,0
TIKI,nha-cua-doi-song,135610861,"Ga thun lạnh đủ kích thước",55000,55000,0,0
TIKI,nha-cua-doi-song,52577269," Đầu vòi rửa chén tăng áp nhựa mạ điện-Ba phương pháp thoát nước",38000,85000,47000,55
TIKI,nha-cua-doi-song,35449842,"hộp 200 ống hút giấy cao cấp _ Clean Paper Straw màu trắng kích thước 6mm x 197mm dùng cho cà phê, nước ép....",53000,53000,0,0
TIKI,nha-cua-doi-song,139723967,"Combo Khăn Lau Đa Năng Mặt Siêu Thấm, Khăn Lau Bếp, Khăn Lau Kính, Khăn Lau Bát, Khăn Lau Tay, Khăn Lâu Ô Tô miDoctor",16000,16000,0,0
TIKI,nha-cua-doi-song,2391311,"Cân Treo Mini Bỏ Túi 1 Mặt Số 5kg Nhơn Hòa NHMGS-5 - Hàng Chính Hãng",69000,69000,0,0
TIKI,nha-cua-doi-song,87578488,"Găng tay y tế latex S Gloves - Bao tay y tế có bột màu trắng hộp 100 chiếc",54000,70000,16000,23
TIKI,nha-cua-doi-song,26670490,"Kệ Góc Nhà Tắm Chống Nước",204000,222000,18000,8
TIKI,nha-cua-doi-song,96271704,"Ổ Cắm Điện Thông Minh XSmart Đa Tính Năng Chống Giật Hàng Siêu Cao Cấp,  Chống Cháy Nổ Chịu Được Công Suất Cao, Chính Hãng",139000,139000,0,0
TIKI,nha-cua-doi-song,10404394,"Bình Đựng Thức Ăn Giữ Nhiệt ELmich Inox 304 EL0631 (500ml)",243000,469000,226000,48
TIKI,nha-cua-doi-song,75783351,"Máy Xay Tỏi Ớt Cầm Tay Mini Sạc Điện 100ml 250ml Tiện Lợi",160000,160000,0,0
TIKI,nha-cua-doi-song,273377437,"Ổ cắm điện kéo dài Rạng Đông 2m/5m Model OC04, OC05 chống giật, rơ le tự ngắt chống quá tải",126000,140000,14000,10
TIKI,nha-cua-doi-song,170927755,"Hộp nhựa đựng thực phẩm Homepower trong suốt có khay lót đáy giúp ráo nước, chất liệu cao cấp, an toàn cho sức khỏe",149000,149000,0,0
TIKI,nha-cua-doi-song,85351583," 100 Túi bao Ổi, Cam, Na, Vú Sữa,.. túi bọc trái cây phòng ngừa sâu bệnh phá hoại - Dạng Rút Túi Chuyên Dụng",32000,32000,0,0
TIKI,nha-cua-doi-song,68736740,"Ruột gối nằm lông vũ khách sạn cao cấp sợi microfiber nhân tạo Hanvico by Homemark có kích thước trẻ em và 50x70 cm",133000,250000,117000,47
TIKI,nha-cua-doi-song,73608154,"ĐỒNG HỒ TREO TƯỜNG TRÒN KIM TRÔI SIZE LỚN ĐƯỜNG KÍNH 30CM",149000,149000,0,0
TIKI,nha-cua-doi-song,67811819,"Đèn LED Cảm Biến Chuyển Động Nhiều Kích Cỡ, Cảm Ứng Hồng Ngoại 3 Chế Độ",197000,197000,0,0
TIKI,nha-cua-doi-song,14639229,"Nắp Kính Cường Lực Nồi Và Chảo Fivestar",55000,55000,0,0
TIKI,nha-cua-doi-song,90850071,"DECAL DÁN KÍNH CHỐNG NẮNG CÁCH NHIỆT XANH DƯƠNG(CUÔN 3M)",169000,169000,0,0
TIKI,nha-cua-doi-song,20634384,"Ổ Khóa inox Mật Mã 4 Số",28000,28000,0,0
TIKI,nha-cua-doi-song,116198000,"Đệm Ngồi Thông Minh Lưu Thông Máu Thoáng Khí PEAFLO",145000,165000,20000,12
TIKI,nha-cua-doi-song,103118895,"Đèn pha led năng lượng mặt trời 300w 200w 100w 60w báo dung lượng pin pha nhôm chống nước IP67 có giấy bảo hành 2 năm",434000,434000,0,0
TIKI,nha-cua-doi-song,114204741,"Bình giữ nhiệt inox 304 Sunhouse 450ml KS-TU450I",98000,150000,52000,35
TIKI,nha-cua-doi-song,164771128,"Roi mây dẻo dai siêu thần thánh",22500,30000,7500,25
TIKI,nha-cua-doi-song,85763912,"Ghế đôn hộp, ghế ngồi kiêm hộp đựng đồ 2 IN 1. Ghế ngồi đa năng mẫu mới",149000,149000,0,0
TIKI,nha-cua-doi-song,53830664,"Mùng ngủ không cửa giăng dây 4 góc truyền thống - Vải tuyn dày lỗ nhỏ chống muỗi tuyệt đối",155000,155000,0,0
TIKI,nha-cua-doi-song,132276408,"Ron pvc chặn khe hở - Thanh cao su dán chân cửa chắn khe hở, chống côn trùng, cách âm, phù hợp mọi loại cửa RPVC",35000,35000,0,0
TIKI,nha-cua-doi-song,72707434,"BỘ KÍCH THÉP DI CHUYỂN ĐỒ NẶNG 500KG 12 BÁNH PU XOAY 360° GOODTOOL35",275000,275000,0,0
TIKI,nha-cua-doi-song,119446046,"Bát Tô Canh Sứ Trắng Đủ Size - Tô khum Sứ Long Phương - 6 inch",38400,38400,0,0
TIKI,nha-cua-doi-song,74329992,"Hộp Đựng Trang Sức Nữ Trang Cỡ Lớn Da Cao Cấp",150000,150000,0,0
TIKI,nha-cua-doi-song,112072065,"Túi Đựng Hộp Cơm Giữ Nhiệt - Túi Trữ Lạnh Cao Cấp Chống Thấm Nước – Túi Giữ Nhiệt Hàng Chính Hãng",36000,70000,34000,49
TIKI,nha-cua-doi-song,185380278,"Bình Xịt Nhật Bản - TAIKOMI Japan Chống Thấm Vết Nứt Mái Nhà, Sàn Nhà Vệ Sinh, Máng Xối, Mái Tôn, Sàn Nhà",99185,135000,35815,27
TIKI,nha-cua-doi-song,76514380,"Ổ Cắm Điện Đa Năng Chống Giật Có 3 Cổng USB – Sạc Trực Tiếp – Tiết Kiệm Điện – Bộ Ổ Cắm Điện Xanh Lá Cao Cấp Chính Hãng Amalife - DE30",55000,55000,0,0
TIKI,nha-cua-doi-song,142989680,"Màn chụp tự bung đỉnh vuông Bảo An - Mẫu mùng chụp tự bung có viền chân chống muỗi tuyệt đối",207343,207343,0,0
TIKI,nha-cua-doi-song,54075243,"Gối cao su non chống ngáy người lớn chất lượng êm ái cho giấc ngủ sâu hơn, gối cao su non, gối chống mỏi cổ, gối chống mỏi gáy (màu ngẫu nhiên)",49000,58997,9997,17
TIKI,nha-cua-doi-song,135442231,"Máy Khoan Deli Chính Hãng Pin 12V Bắt Vít - Nhỏ Gọn, Tiện Dụng - Dùng Cho Sửa Chữa Vật Dụng - DL600012",551000,1006200,455200,45
TIKI,nha-cua-doi-song,189373783,"Máy Rửa Xe Mini Deli Công Suất Lớn - Tiết Kiệm Điện Năng, Phun Rửa Đa Năng - DL882201",1349000,2399000,1050000,44
TIKI,nha-cua-doi-song,57894229,"Kệ đựng để đồ đa năng có bánh xe 3 tầng (giao màu ngẫu nhiên)",80000,80000,0,0
TIKI,nha-cua-doi-song,59273521,"Combo 02 Khăn tắm, khăn mặt FUNU, mềm mịn, siêu thấm, kháng khuẩn - Hàng chính hãng, hàng nhiều mẫu design, giao mẫu ngẫu nhiên",92000,100000,8000,8
TIKI,nha-cua-doi-song,4777363,"Bàn làm việc gấp gọn có khe cắm ipad - giao màu ngẫu nhiên",71000,71000,0,0
TIKI,nha-cua-doi-song,62292300,"Bộ vòi sen tắm lạnh – tay sen tăng áp  (Hàng chính hãng)",209000,350000,141000,40
TIKI,nha-cua-doi-song,14257715,"Dụng Cụ Lấy Dấu, Định Vị Điểm Khoan - Chống Trượt",27999,27999,0,0
TIKI,nha-cua-doi-song,51368456,"Bộ 6 thìa Inox 304 pha nước (số 12)",174000,210000,36000,17
TIKI,nha-cua-doi-song,696349,"Ổ Cắm Điện 4 Lỗ 3 Chấu 3m Philips SPN1248WB/74 (2500W)",280000,299000,19000,6
TIKI,nha-cua-doi-song,161024967,"Combo 2 hộp chia ngăn sắp xếp quần áo phong cách Nhật Bản Mai Anh House",210000,210000,0,0
TIKI,nha-cua-doi-song,19560656,"Bộ 4 Chiếc Kẹp Ga Giường",49000,49000,0,0
TIKI,nha-cua-doi-song,152446542,"Cây Cau Tiểu Trâm - cây cảnh để bàn",33000,46000,13000,28
TIKI,nha-cua-doi-song,67910007,"Vỉ 20 nẹp cố định dây điện dán tường, bàn ghế",12999,12999,0,0
TIKI,nha-cua-doi-song,70002562,"BÁO ĐỘNG CHỐNG TRỘM HỒNG NGOẠI HT1A-S 3 NÚT, 180-220V AC - 50Hz.",190000,190000,0,0
TIKI,nha-cua-doi-song,53116344,"Súng bắn keo nến silicon + Tặng 10 cây keo silicon nến",38000,79000,41000,52
TIKI,nha-cua-doi-song,95333782,"Đế lót chậu cây có bánh xe MONROVIA, đế để chậu cây, kệ chậu cây do động, có bánh xe, mặt tròn hoặc vuông bằng gỗ tràm cao cấp loại 1, trên 10 năm tuổi, màu vàng đường kinh 30 cm, chính hãng thương hiệu MONROVIA",85000,85000,0,0
TIKI,nha-cua-doi-song,143779168,"Thảm ngủ cá nhân văn phòng",25000,25000,0,0
TIKI,nha-cua-doi-song,54348370,"Kệ di động Inochi hàng cao cấp",140000,150000,10000,7
TIKI,nha-cua-doi-song,125667836,"Bộ Cờ Lê 14 Chi Tiết",235000,235000,0,0
TIKI,nha-cua-doi-song,50098102,"Tủ Vải Quần Áo 3 Buồng 8 Ngăn To, Bền - Hàng Chính Hãng",385000,550000,165000,30
TIKI,nha-cua-doi-song,96180139,"Chân đàn Organ/ Piano đa năng - Kzm Kurtzman STX1 - Dáng chữ X đơn - Màu đen - Hàng chính hãng",140000,140000,0,0
TIKI,nha-cua-doi-song,117212183,"Ổ Cắm Nối Chia 3 Lioa, Phích Cắm 1 ra 3 Lioa - MITA",22000,22000,0,0
TIKI,nha-cua-doi-song,138814386,"Set 10 móc phơi quần áo inox dày bọc nhựa cao cấp",25000,25000,0,0
TIKI,nha-cua-doi-song,120470467,"Bộ 6 Ly Cao Thuỷ Tinh Luminarc Louvre 350ml - LULON1807 ",289000,289000,0,0
TIKI,nha-cua-doi-song,91063233,"Hạt Giống Hoa Mãn Đình Hồng Kép Nhiều Màu 20 hạt",13000,15260,2260,15
TIKI,nha-cua-doi-song,171174862,"Vỏ Thay Thế Cho Gối Nooz Mềm Mịn Kháng Khuẩn Và Không Gây Kích Ứng Da",150000,150000,0,0
TIKI,nha-cua-doi-song,51044868,"Vòi sen tăng áp, bát sen tắm inox 304 KAMA PK03, vòi nước tăng áp, bát sen tăng áp inox 304, bề mặt inox 304 nguyên bản, không rỉ sét, vòi sen tắm tăng áp lực nước",180000,180000,0,0
TIKI,nha-cua-doi-song,165029589,"VỢT BẮT MUỖI CAO CẤP 2 IN 1 DP - 834",99000,99000,0,0
TIKI,nha-cua-doi-song,146926667,"Giây Ăn SAKARA Mã 6089 Siêu Mịn, Siêu Dai, Bốn Lớp, Không Mủn Giấy Ăn Cao Cấp Nhập Khẩu Thùng 30 gói",141897,141897,0,0
TIKI,nha-cua-doi-song,187829576,"VỎ GỐI NẰM,GỐI ÔM COTTON MỀM MỊN. THOÁNG MÁT GIÁ SIÊU RẺ,KÍCH THƯỚC 40X60.50X70.35X105",30400,40000,9600,24
TIKI,nha-cua-doi-song,28604722,"Ghế bệt gỗ kiểu nhật D227 ( Hàng nhập khẩu )",320000,320000,0,0
TIKI,nha-cua-doi-song,184591044,"Đèn Pixar, Đèn Bàn Chống Cận Thị, Đèn Đọc Sách LED, Đèn Làm Việc Bảo Vệ Mắt - Hàng Chính Hãng",258000,320000,62000,19
TIKI,nha-cua-doi-song,104472138,"Tấm/Miếng Lót Nồi Bằng Gỗ Đường Kính 21cm",25000,25000,0,0
TIKI,nha-cua-doi-song,93780998,"Đồng hồ hẹn giờ đếm ngược dùng trong nấu ăn, pha chế",185000,200000,15000,8
TIKI,nha-cua-doi-song,88230880,"Bóng đèn cảm ứng cảm biến chuyển động rada vi sóng 5.8 Hz tự động bật tắt đèn khi có người đi qua",41000,41000,0,0
TIKI,nha-cua-doi-song,73759724,"Kệ Sách Đứng Để Sàn Cao Cấp FIVO Mẫu FB70 Lắp Ráp Đơn Giản, Phù Hợp Với Mọi Không Gian",749000,1168000,419000,36
TIKI,nha-cua-doi-song,189568098,"Bình giữ nhiệt inox 304 Elmich",220000,499000,279000,56
TIKI,nha-cua-doi-song,66877577,"Hộp đựng cơm thủy tinh cao cấp 3 ngăn ( Giao mầu ngẫu nhiên)",89000,89000,0,0
TIKI,nha-cua-doi-song,84153167,"Kệ Sách Đa Năng Athena 5F Thương Hiệu IGEA",409000,445000,36000,8
TIKI,nha-cua-doi-song,121162213,"Set 10 Móc Treo Quần Áo Người Lớn Jodily inox 304 Sáng Bóng Bền Mãi Với Thời Gian",150000,150000,0,0
TIKI,nha-cua-doi-song,17164211,"Bộ 13 mũi khoan đa năng lục giác",44999,44999,0,0
TIKI,nha-cua-doi-song,8141095,"Bình nước Lock&Lock Aqua HAP739B/HAP739W 2,6L",68800,109000,40200,37
TIKI,nha-cua-doi-song,120166109,"Bóng Philips LED bulb Essential E27 (5W,7W,9W,11W,13W) - E27 (3000K/6500K)",50600,52200,1600,3
TIKI,nha-cua-doi-song,134407128,"Tủ Kệ Sách Trang Trí, Làm Từ Gỗ Công Nghiệp rẻ vô địch, Chất Lượng Cao, Dễ Dàng Lắp Ghép Nhiều Ngăn Để Đồ tiện lợi",252000,252000,0,0
TIKI,nha-cua-doi-song,146393649,"Ngăn Mùi Hôi Cống  Ngăn Mùi Thoát Sàn Silicon-Nút Bịt Ống Cống Chống Hôi Hiệu Quả 100%",9499,9999,500,5
TIKI,nha-cua-doi-song,137796584,"Thảm Lau Chân Nhà Tắm Đa Năng Chất Liệu Chống Trơn Trượt Cao Cấp 4 Lớp Thấm Hút Tốt 40x60cm Loại 1 - Hàng Chính Hãng -( Màu Và Chữ Ngẫu Nhiên)",94050,99000,4950,5
TIKI,nha-cua-doi-song,176530481,"Chiếu điều hòa tencel Lidaco (Nhiều mẫu lựa chọn)",389000,560000,171000,31
TIKI,nha-cua-doi-song,42270992,"Bình Giữ Nhiệt Rinfere, Với Miệng Rộng, Nắp Quai Cầm - Nhiều Kích Cỡ Và Màu Sắc",305000,499000,194000,39
TIKI,nha-cua-doi-song,74986118,"Màng Bọc Thực Phẩm PE Shinsen 30 x 40000",163000,163000,0,0
TIKI,nha-cua-doi-song,134360858,"Bộ 8 Pin AA Panasonic 1,5V Không chì , Pin không chảy nước R6DT/4S - Hàng chính hãng",38000,60000,22000,37
TIKI,nha-cua-doi-song,72751318,"Báo Động Chống Trộm, Chuông Báo Khách Mở Cửa Đa Chức Năng Có Điều Khiển Từ Xa MC - 02, Báo Động Nhiều Chế Độ : Chống Trộm Xâm Nhập , Báo Chuông Cửa..",205000,249000,44000,18
TIKI,nha-cua-doi-song,125149573,"Sáo Tiêu Recorder Soprano Yamaha YRS-402, YRS-20,YRS-24B Chính Hãng, Độ Bền Cao, Chất Liệu ABS An Toàn",135000,135000,0,0
TIKI,nha-cua-doi-song,98556230,"Kệ Gỗ Trang Trí Treo Tường Không Cần Khoan Với Móc Treo Inox Và Đầy Đủ Phụ Kiện Tặng Kèm, Dễ Dàng Gắn Lên Tường",119000,125000,6000,5
TIKI,nha-cua-doi-song,7699055,"Chảo Nhôm Chống Dính Lock&Lock Baum Marble 1 Tay Cầm LBU1243C (24cm)",235000,451000,216000,48
TIKI,nha-cua-doi-song,106281062,"Bộ 6 Ly Bia Thuỷ Tinh Luminarc Benidorm 450ml - LUBEG2616",309000,386000,77000,20
TIKI,nha-cua-doi-song,20575031,"VÒI LAVABO LẠNH INOX SUS304",165000,165000,0,0
TIKI,nha-cua-doi-song,26149459,"Bộ Muỗng Đũa Cơm Trưa INOX 304 Thiết Kế Sang Trọng Mạ PVD Cao Cấp - Xanh Da Trời",120000,120000,0,0
TIKI,nha-cua-doi-song,53472238,"Kệ gỗ thông để giày đa năng",129800,129800,0,0
TIKI,nha-cua-doi-song,117282929,"Phích ổ cắm đa năng LiOA chuyển 3 chân thành 2 chân 15A/220V Chân Tròn/Dẹt - Ổ điện chuyển đổi từ 3 chấu sang 2 chấu",18000,18000,0,0
TIKI,nha-cua-doi-song,34816875,"Dụng Cụ Thông Tắc Cống, Kẹp Gắp Rác Đa Năng Loại Tốt",21000,21000,0,0
TIKI,nha-cua-doi-song,106677814,"Hộp thuỷ tinh chữ nhật Nikko 370 ml",43000,43000,0,0
TIKI,nha-cua-doi-song,128935485,"Thìa Ăn Phở Ăn Soup - Inox 304 Jodily Cao Cấp Sáng Bóng Bền Mãi Với Thời Gian",15000,15000,0,0
TIKI,nha-cua-doi-song,37730520,"Thanh treo quần áo 4 chấu dán tường Hobby 4TV160 chuẩn Inox 304 - kèm keo dán siêu dính",147000,219000,72000,33
TIKI,nha-cua-doi-song,165758266,"Bộ dao 3 chiếc Eco Family Sunhouse KS-KN3E1",283000,438000,155000,35
TIKI,nha-cua-doi-song,80874505,"Cốc gấu đựng bàn chải kem đánh răng, Cốc gấu dán tường siêu dính",14999,14999,0,0
TIKI,nha-cua-doi-song,77746708,"Dây đèn led đom đóm trang trí pin không nháy tiểu dây bóng đèn fairy light cao cấp, tinh tế sang trọng decor phòng, du lịch, lều trại, luôn sáng - Chính hãng DEHA",35000,65000,30000,46
TIKI,nha-cua-doi-song,51343718,"Thau Gập Gọn - Chậu Nhựa Gấp Gọn Đa Năng1 2x35cm, nhiều màu, giao màu ngẫu nhiên+ Tặng kèm móc treo",68135,126000,57865,46
TIKI,nha-cua-doi-song,116199362,"Ly thủy tinh có chia vạch 625ml-B00322 ",35000,35000,0,0
TIKI,nha-cua-doi-song,20484673,"Nắp ngồi rơi êm cao cấp thay thế cho các loại bồn cầu INAX thân dài 504-702-700-710-808-900",295000,295000,0,0
TIKI,nha-cua-doi-song,51238343,"Túi Lọc Trà Lọc Gia Vị Vải Không Dệt (combo 100 túi)",28000,28000,0,0
TIKI,nha-cua-doi-song,133866129,"Móc Dán Tường Inox 304 Sang Trọng, Cứng Cáp, Dùng Keo 3M, Nhiều Kiểu Dáng Đẹp",43000,43000,0,0
TIKI,nha-cua-doi-song,124480954,"Nhang trầm hương tự nhiên Thiên Mộc Hương, 20cm, Ít Khói, Mùi thơm nhẹ diu, an toàn cho sức khỏe",135000,200000,65000,33
TIKI,nha-cua-doi-song,30691895,"Dụng cụ tách sò huyết inox cao cấp",40000,40000,0,0
TIKI,nha-cua-doi-song,13369293,"Bịt mắt ngủ có túi giải nhiệt làm mát mắt - #10",68000,68000,0,0
TIKI,nha-cua-doi-song,89642725,"Bình xịt nước tưới cây bằng nhựa, bình xịt nước tạo mẫu tóc, xịt nước làm bánh cao cấp - Hàng chính hãng, giao màu ngẫu nhiên",42750,45000,2250,5
TIKI,nha-cua-doi-song,5429807,"Bộ 50 cút nối dây điện nhanh CH-2",31000,31000,0,0
TIKI,nha-cua-doi-song,16170433,"Combo 3 lõi lọc nước yamato 1,2,3 - 10 inch",143000,155000,12000,8
TIKI,nha-cua-doi-song,134351529,"Đũa Gỗ Dùng 1 Lần KETILO Cao Cấp, Thân Thiện Với Môi Trường, Không Hóa Chất Độc Hại, An Toàn Sức Khỏe Người Dùng(Giao Ngẫu Nhiên) - CHÍNH HÃNG ĐG001",45000,53000,8000,15
TIKI,nha-cua-doi-song,83847675,"Combo 30 bịch giấy ăn gấu trúc",55000,107500,52500,49
TIKI,nha-cua-doi-song,70809147,"SET 2 TÚI ĐỰNG QUẦN ÁO KHUNG THÉP GẤP GỌN 66L -  Dài 50 cm x Rộng 40 cm x Cao 33 cm",139000,139000,0,0
TIKI,nha-cua-doi-song,108201708,"Bộ Rổ Nhựa Kèm Chậu 6 Món Cao Cấp Vàng xanh hàng đẹp loại 1",32000,47000,15000,32
TIKI,nha-cua-doi-song,158564745,"Cuộn 220 Tờ Khăn Giấy Lau Bếp Đa Năng",8000,9990,1990,20
TIKI,nha-cua-doi-song,892129,"Pin Max 4 + 2 Viên Energizer E92 BP4+2 AAA",73000,73000,0,0
TIKI,nha-cua-doi-song,85512749,"Kẹp dán tường thông minh - Không cần khoan lỗ, đục tường- Chịu lực lên đến 3Kg",4000,4000,0,0
TIKI,nha-cua-doi-song,15212797,"Đèn led năng lượng mặt trời SUN-28200 200W, Đèn năng lượng mặt trời IP 67",410000,410000,0,0
TIKI,nha-cua-doi-song,70564013,"Bộ Tua Vít Bỏ Túi Đa Năng 24 Món - Tô Vít Sửa Chữa Mở Điện Thoại Vi Tính cao cấp",39000,196992,157992,80
TIKI,nha-cua-doi-song,126120768,"Ghế Xoay Văn Phòng Làm Việc Thư Giãn Cao Cấp YLF2199 Có Thể Làm Ghế Gaming - Hàng Nhập Khẩu",820000,1399000,579000,41
TIKI,nha-cua-doi-song,171198348,"Ghế Xoay Văn Phòng Công Thái Học Ergonomic Có Ngả Lưng Gác Chân TANNI Premium 02 Plus, Ghế Xoay Gaming Cao Cấp Nhập Khẩu",1198000,2450000,1252000,51
TIKI,nha-cua-doi-song,168641002,"Kệ Góc Đa Năng White Corner 5F Thông Minh Phong Cách Hiện Đại",320000,350000,30000,9
TIKI,nha-cua-doi-song,142096809,"Bàn làm việc có giá sách 1,2m 1m thiết kế hiện đại có giá sách, chân sắt sơn tĩnh điện mặt gỗ mdf phủ melamine",525000,829000,304000,37
TIKI,nha-cua-doi-song,580040,"Chảo Đá Chống Dính Siêu Bền Sunhouse SBD24 24cm",171000,320000,149000,47
TIKI,nha-cua-doi-song,193713061,"Bàn Học Và Làm Việc Thông Minh Đa Năng Mặt Bàn Nghiêng 90 Độ, Bàn Laptop Xếp Gọn Có Bánh Xe - Hàng Chính Hãng",717000,999000,282000,28
TIKI,nha-cua-doi-song,577125,"Thang Nhôm Gấp Chữ A Nikawa NKD-06 - 6 Bậc - 1.5 Mét",1480000,1680000,200000,12
TIKI,nha-cua-doi-song,181909421,"Nồi Thấp Suit LocknLock CSU1242PIK – 24cm - Màu Pink",602000,1184000,582000,49
TIKI,nha-cua-doi-song,16861361,"Nắp ly giữ nhiệt 900ml màu trắng",28000,28000,0,0
TIKI,nha-cua-doi-song,213491032,"Bàn để ủi quần áo khung bằng thép Lebenlang LBB363",659000,959000,300000,31
TIKI,nha-cua-doi-song,67989898,"Bàn Học Bàn Làm Việc Kết Hợp Kệ Sách GP73",250000,250000,0,0
TIKI,nha-cua-doi-song,19920919,"Bật Lửa Mồi Lửa Bếp Gas Bếp Cồn An Toàn (Màu Sắc Ngẫu Nhiên)",13000,24000,11000,46
TIKI,nha-cua-doi-song,72754059,"Nệm Gấp Văn Phòng, Đệm Ngủ Trưa Văn Phòng Gấp Gọn Tiện Lợi, Mặt Vải Chống Thấm Tặng Túi Đựng Nệm - Kích Thước 70 x 190cm",280000,280000,0,0
TIKI,nha-cua-doi-song,98650585,"Bộ Ga Gối Cotton Kẻ 3F Lidaco Chuyên Dụng Cho Homestay, Khách Sạn (Nhiều Mẫu Lựa Chọn)",189000,250000,61000,24
TIKI,nha-cua-doi-song,135322547,"Set 10 Móc áo chống trượt Inochi Hara 186",45100,45100,0,0
TIKI,nha-cua-doi-song,167545572,"Bộ 2 hộp đựng đồ chia 7 ngăn sắp xếp quần áo dododios - Hộp vải đa năng HQ2 tiện ích, chất liệu cao cấp, phong cách Nhật Bản sang trọng",139000,139000,0,0
TIKI,nha-cua-doi-song,90852479,"Bộ liền 2 nhả kem đánh răng tự động, Giá treo bàn chải kèm 3 cốc hút từ tính lắp đặt dán tường - OE2KEM",245000,450000,205000,46
TIKI,nha-cua-doi-song,199263969,"Bàn Trang Điểm Mini Ngồi Bệt Hiện Đại Thương Hiệu IGA - GP143",385000,419000,34000,8
TIKI,nha-cua-doi-song,52581646,"Dây Đèn LED Rèm Trăng Sao Chống Thấm Nước Trang Trí Ngoài Trời - Dài 2.5 Mét",105000,105000,0,0
TIKI,nha-cua-doi-song,128623891,"Dây chằng hàng tăng đơ (dây cảo) bản 25mm dài 3 - 5m tải trọng 500-800kg - capthepgiasi",50000,50000,0,0
TIKI,nha-cua-doi-song,174299634,"Giá Treo Bàn Chải Nhà Tắm OENON - Bộ nhả kem đánh răng tự động kèm cốc và miếng dán tường - OEKEM",99000,190000,91000,48
TIKI,nha-cua-doi-song,6816541,"Cân tiểu ly điện tử 3000g - 0.1g. Cân tiểu li điện tử có độ chính xác cao",68000,68000,0,0
TIKI,nha-cua-doi-song,152816167,"Bình Đựng Nước 2L Dễ Thương Có Vạch Báo Giờ Uống Nước Mỗi Ngày Kèm Khăn Lau 2 Mặt BaoAn - Hàng Chính Hãng",89000,99000,10000,10
TIKI,nha-cua-doi-song,134582057,"TẤM LÓT BẢO VỆ NỆM HÀNG KHÁCH SẠN CAO CẤP 1M/1M2/1M4/1M6/1M8/2M2",140000,140000,0,0
TIKI,nha-cua-doi-song,204279461,"Lư xông trầm gỗ hương nguyên khối cao cấp HÀ XÁ",199000,398000,199000,50
TIKI,nha-cua-doi-song,10768010,"Đèn bắt muỗi Điện Quang ĐQ EML06L ",305000,305000,0,0
TIKI,nha-cua-doi-song,47461891,"Bộ 6 vỉ (12 viên pin) pin Kiềm Alkaline Panasonic AA LR6T/2B-Hàng chính hãng",172000,180000,8000,4
TIKI,nha-cua-doi-song,194496895,"Chặn cửa chân móng ngựa có lẫy gạt HOBBY Home Decor CMG1 chống va đập cửa ở bất kì vị trí nào tiện dụng",85000,129000,44000,34
TIKI,nha-cua-doi-song,119025800,"Bộ 5 Hộp Đựng Thực Phẩm Giỏ Có Nắp Đậy Khay Nhựa Kèm Rổ Ráo Nước Để Tủ Lạnh Bảo Quản Thức Ăn Tiện Dụng",119935,119935,0,0
TIKI,nha-cua-doi-song,49116420,"Bút thử nước TDS, dụng cụ đo TDS, máy đo độ cứng của nước",102000,159000,57000,36
TIKI,nha-cua-doi-song,67111908,"Mật rỉ đường ủ phân bón (can 7kg) - Mật đường can 5 Lít",155000,155000,0,0
TIKI,nha-cua-doi-song,153770352,"Thanh Móc 9 Lỗ Treo Quần Áo Tiện Dụng",7500,12000,4500,38
TIKI,nha-cua-doi-song,52760599,"Dây Đèn LED Đom Đóm Fairy Light Trang Trí Ngoài Trời Chống Nước, Nhiều Chế Độ Sáng",42000,42000,0,0
TIKI,nha-cua-doi-song,155184630,"Móc Treo Quần Áo, Móc Treo Đa Năng Hara, Bộ Sưu Tập Móc Quần Áo Người Lớn Nhựa Cao Cấp Inochi",26950,26950,0,0
TIKI,nha-cua-doi-song,73371758,"Găng tay làm vườn -  Găng Tay Chống Cắt Ansell 11-801 Cấp Độ 1 - Chống Đâm Xuyên, Giặt Và Tái Sử Dụng",61750,65000,3250,5
TIKI,nha-cua-doi-song,6329515,"Đèn gắn tường - đèn tường - đèn treo tường cao cấp FLOWER",118000,118000,0,0
TIKI,nha-cua-doi-song,172123103,"Bàn làm việc thông minh kèm giá sách cho học sinh, sinh viên hiện đại kiểu Hàn từ gỗ MDF, phủ Melamin chống xước ND01",400000,400000,0,0
TIKI,nha-cua-doi-song,7202329,"Bộ 3 Hộp Thủy Tinh KOVA KLOCK370 (370ml/ Hộp)",137000,200000,63000,32
TIKI,nha-cua-doi-song,249157000,"Giá Treo Bàn Chải Đánh Răng OENON liền 2 Nhả Kem tự động kèm cốc hút từ tính lắp đặt dán tường gạch men",99000,180000,81000,45
TIKI,nha-cua-doi-song,517873,"Giá Phơi Đồ Inox Co Giãn Thông Minh Prota - 86 Cm",290000,290000,0,0
TIKI,nha-cua-doi-song,114938906,"Bộ 6 Ly Thấp Thuỷ Tinh Luminarc Louvre 260ml -  LULON1808",281000,281000,0,0
TIKI,nha-cua-doi-song,448378,"Hộp Cơm Giữ Nhiệt Zojirushi ZOCM-SL-JAF14-SA 4 Ngăn - 1.3L (Bạc)",950500,950500,0,0
TIKI,nha-cua-doi-song,167391475,"Kệ Để Giày Dép 05 Tầng Khung Inox, Giá Để Giày Inox 05 Tầng, Giày Dép, Kệ Để Đồ, Kệ Sách Loại Cao Cấp miDoctor",106000,180000,74000,41
TIKI,nha-cua-doi-song,14453485,"Combo 10 móc treo đồ dán tường",4790,4790,0,0
TIKI,nha-cua-doi-song,170876560,"Khăn giấy ướt vịt vàng 10 gói kèm thùng nhựa tiện dụng siêu đáng - Amina",46550,49000,2450,5
TIKI,nha-cua-doi-song,148797223,"Bộ Hộp Cơm Giữ Nhiệt Văn Phòng Cao Cấp Cắm Điện inox 3 Tầng - Chính Hãng MINIIN",176000,199000,23000,12
TIKI,nha-cua-doi-song,90510185,"Ghế gác chân, Gác chân Guitar - Kzm Kurtzman KGQ3 - Điều chỉnh 4 mức độ cao thấp - Hàng chính hãng",112000,112000,0,0
TIKI,nha-cua-doi-song,181909432,"Chảo Suit LocknLock CSU1263PIK - Màu Pink",395000,759000,364000,48
TIKI,nha-cua-doi-song,204204717,"Nhang khoanh trầm hương HÀ XÁ xông nhà 100g đồ thờ cúng thanh lọc không khí, an toàn cho sức khỏe",199000,398000,199000,50
TIKI,nha-cua-doi-song,179063461,"Bộ 2 khăn tắm cotton cao cấp dành cho gia đình, siêu thấm hút, mềm mại, kháng khuẩn",189000,189000,0,0
TIKI,nha-cua-doi-song,196362415,"Máy cắt cỏ, tỉa cành cầm tay LAPUSEN pin khủng 15000mah, động cơ mạnh 1800w",843600,888000,44400,5
TIKI,nha-cua-doi-song,52145781,"Bàn Trà Cafe, Bàn Trà Sofa Phong Cách Bắc Âu Thương Hiệu IGEA",199000,218000,19000,9
TIKI,nha-cua-doi-song,149149135,"Kệ Gia Vị 3 Tầng Để Bàn Thương Hiệu IGA - GM04",181000,197000,16000,8
TIKI,nha-cua-doi-song,69253420,"Ổ khóa cao cấp Toplex, 1205-50mm",90000,90000,0,0
TIKI,nha-cua-doi-song,20615119,"Pin sạc AAA NiMH dung lượng lớn 1300mah (4 Viên AAA)",119000,119000,0,0
TIKI,nha-cua-doi-song,127215514," Hộp Đũa Dán Tường Jodily Có Nắp Sang Trọng, Sạch Sẽ",205000,205000,0,0
TIKI,nha-cua-doi-song,173558017,"Lưỡi cắt cỏ tận gốc sợi thép siêu bền",85000,85000,0,0
TIKI,nha-cua-doi-song,166659124,"Dao Nhật Bản Siêu Sắc Bén Hàng Chính Hãng Cao Cấp ",365000,365000,0,0
TIKI,nha-cua-doi-song,164326067,"Bộ Chổi Điện Cọ Rửa Đa Năng Spin 3 Đầu - Máy Chà Tẩy Rửa Vệ Sinh Thông Minh Dùng Cho Nhà Tắm, Nhà Bếp - HÀNG CHÍNH HÃNG",495000,495000,0,0
TIKI,nha-cua-doi-song,71544914," Ổ Cắm Wifi Thông Minh TP-Link Tapo P100 - Hàng Chính Hãng ",199000,199000,0,0
TIKI,nha-cua-doi-song,54029566,"Bộ Dụng Cụ Tua Vít Đa Năng Nhiều Món Có Từ Tính 111 in 1 Dùng Tháo Lắp, Tháo Mở Và Sửa Chữa Điện Thoại Di Động, Máy Tính, PC/ Laptop, Máy Tính Bảng",175000,175000,0,0
TIKI,nha-cua-doi-song,163583429,"Máy Xay Hạt Cafe, Hạt Khô, Hạt Tiêu, Ngũ Cốc, Đậu Nành Đa Năng, Cối Xay Thép Không Gỉ SUS 304 Cao Cấp - Hàng Chính Hãng MINIIN",199000,199000,0,0
TIKI,nha-cua-doi-song,121243851,"Vòi rửa bát inox 304 Pimisi gắn chậu rửa bát 1 đường nước lạnh đơn cho mọi loại chậu rửa chén phổ biến trong nhà bếp | Hàng chính hãng",463000,700000,237000,34
TIKI,nha-cua-doi-song,32004018,"PHÂN GÀ HỮU CƠ (NHẬT BẢN) - BAO 5KG - SẢN PHẨM CAO CẤP CHO MỌI LOẠI CÂY TRỒNG ( MS 025)",90000,90000,0,0
TIKI,nha-cua-doi-song,130978265,"Ổ cắm Xoay 90° Điện Quang ĐQ ESK RT 6GW (6 lỗ, màu xanh lá trắng)",77440,103300,25860,25
TIKI,nha-cua-doi-song,14526627,"Quánh Inox 430 Bếp Từ 3 Đáy Fivestar Nắp Kính",199000,199000,0,0
TIKI,nha-cua-doi-song,56562967,"Combo 5 Miếng Xốp Dán Tường Giả Gạch Dày 4mm -  Trắng",51299,53999,2700,5
TIKI,nha-cua-doi-song,142857607,"Thông tắc vệ sinh, dây thông cống lò xo, tiện dụng và được việc",45000,67500,22500,33
TIKI,nha-cua-doi-song,186142362,"Ô Dù Chống Nắng Che Mưa Cản UV Tự Động Đóng Mở Khung 12 Xương",230000,230000,0,0
TIKI,nha-cua-doi-song,134361201,"Giấy Dán Tường Nhà Bếp Chống Thấm Dầu Mở, Chống Thấm Nước, Cách Nhiệt Tiện Dụng [Tặng Móc Dán Tường Treo Đồ",43000,43000,0,0
TIKI,nha-cua-doi-song,263076438,"Gối chống trào ngược dạ dày thực quản người lớn Ema giúp giảm trào ngược dạ dày, viêm họng mãn tính, nuốt vướng, nghẹn cổ, khó thở khi ngủ, ngáy ngủ",585000,1170000,585000,50
TIKI,nha-cua-doi-song,67096743,"Combo Full Bộ Ống Hút Inox 304 Thép Không Gỉ, Tái Chế Sử Dụng, Thân Thiện Môi Trường - Hàng Chính Hãng",29000,29000,0,0
TIKI,nha-cua-doi-song,135099603,"Cây lau nhà thay thế bộ lau nhà PX01 (Không bao gồm thùng vắt) - Parroti MOP-PX01",229000,280000,51000,18
TIKI,nha-cua-doi-song,59386141,"Bọc Giày Đi Mưa Silicon Siêu Bền Nhiều Màu",59900,59900,0,0
TIKI,nha-cua-doi-song,33404972,"Tủ kệ sách để bàn HT003",45600,48000,2400,5
TIKI,nha-cua-doi-song,117058329,"Giấy lọc cà phê Hario 100 cái (V60-VCF-01-100W)",89000,99000,10000,10
TIKI,nha-cua-doi-song,147593105,"Miếng chặn khe cửa chống bụi  Nẹp chặn cửa chắn khe hở chống bụi, chống côn trùng, chống thoát hơi gió điều hòa",20000,20000,0,0
TIKI,nha-cua-doi-song,80657249,"Hộp vải đựng đồ đa năng có nắp TD3a và TD3b – Túi vải Thụy Điển có nắp rời 34L sang trọng vải Oxford chính hãng miDoctor",129000,200000,71000,36
TIKI,nha-cua-doi-song,51915247,"Combo 200 túi lọc rác bồn rửa bát",22999,22999,0,0
TIKI,nha-cua-doi-song,50206492,"Thuốc trừ rầy, nhện, kiến, gián mối, bọ chét, ve chó Regent 800WG",40000,40000,0,0
TIKI,nha-cua-doi-song,135059226,"Móc Dán Tường Inox 304 Dùng Keo 3M Siêu Chắc, Chịu lực lên đến hơn 20kg, Nhiều Kiểu Dáng Đẹp",41000,41000,0,0
TIKI,nha-cua-doi-song,16093882,"Phích Cắm Chuyển Đổi 3 Chấu Sang 2 Chấu Milliken NL-3106",15000,15000,0,0
TIKI,nha-cua-doi-song,159144262,"Cây lau nhà VILEDA Turbo Easy Wring&Clean đầu lau tam giác, xô giặt quay bằng chân, thêm 2 bông lau",659000,659000,0,0
TIKI,nha-cua-doi-song,167046966,"Áo bọc bàn để ủi cầu là quần áo có mút Kokomega BU04 KT: 35*100cm( Và Sử Dụng Cho BU-120)",75050,79000,3950,5
TIKI,nha-cua-doi-song,184903735,"Khay xếp quần áo chia ngăn 6 7 20, Hộp đựng đồ lót tất vớ chất liệu vải không dệt cao cấp",32000,32000,0,0
TIKI,nha-cua-doi-song,83397956,"MXK4 - 25x15x10 cm - 20 Thùng hộp carton",52600,52600,0,0
TIKI,nha-cua-doi-song,57863885,"Đồng hồ LED để bàn hình hộp gỗ - Nhiệt kế - Báo thức - Cảm ứng âm thanh",109000,159000,50000,31
TIKI,nha-cua-doi-song,196571419,"CHẢO CẠN INOX 5 ĐÁY SUNHOUSE 16-20-24-26-28CM (DÙNG TRÊN MỌI LOẠI BẾP)",175000,175000,0,0
TIKI,nha-cua-doi-song,81936306,"Kệ Decor Phòng Gương 2 Tầng Morning House",169000,169000,0,0
TIKI,nha-cua-doi-song,39748239,"Kệ để đồ dán tường cho phòng tắm và nhà bếp (Giao ngẫu nhiên mẫu)",10000,20900,10900,52
TIKI,nha-cua-doi-song,186883908,"Khăn tắm nén du lịch (70x140cm) bằng cotton thấm hút tốt, dùng một lần tiện lợi - Chính hãng MINIIN",21000,29000,8000,28
TIKI,nha-cua-doi-song,52188851,"Muỗng Thìa Cà Phê Cán Dài INOX304 24cm",30000,30000,0,0
TIKI,nha-cua-doi-song,177679445,"Chuông Cửa Không Dây Thông Minh Besti YBT01 (1 Nút Bấm, 1 Chuông ), Chống Nước, Khoảng Cách Sử Dụng Hiệu Quả 300M, 60 Loại Nhạc Chuông, 4 Mức Điều Chỉnh Âm Lượng - Hàng Chính Hãng",180000,180000,0,0
TIKI,nha-cua-doi-song,81647926,"Đầu nối chia điện đa năng 3 cửa SOPOKA P11 P12 chịu tải 2200W",32000,32000,0,0
TIKI,nha-cua-doi-song,63479866,"[CHÍNH HÃNG] Khoá treo đồng bấm Việt - Tiệp Cao cấp - Chống trộm | Mã SP: 01524",125970,132600,6630,5
TIKI,nha-cua-doi-song,76827765,"Pin Energizer ECR2025 Lithium 3V Chính Hãng | Bộ Vỉ 5 Viên",55300,59000,3700,6
TIKI,nha-cua-doi-song,50825030,"Dụng cụ kẹp gắp bát, đĩa, đồ nóng",14500,14500,0,0
TIKI,nha-cua-doi-song,46207255,"Combo 2 túi lưới giặt đồ 2 lớp Polyester dạng lưới mịn giặt đồ chống biến dạng quần áo cho máy giặt dạng hộp khóa kéo phù hợp giặt đồ nhỏ đồ lót",45000,45000,0,0
TIKI,nha-cua-doi-song,17008839,"Thiết Bị Bấm Lỗ Dây Nịt Da Cầm Tay (6-9")",53091,53091,0,0
TIKI,nha-cua-doi-song,50254577,"Thước Đo Khoảng Cách Bằng Tia Laser SNDWAY Phạm Vi 50m SW-M50 Cao Cấp AZONE",350000,350000,0,0
TIKI,nha-cua-doi-song,90597884,"Bàn Học Bàn Làm Việc Ngồi Bệt Model 1 Thông Minh - GP116",382000,415000,33000,8
TIKI,nha-cua-doi-song,187843307,"Đèn Năng Lượng Mặt Trời Chống Lóa 100W 200W 300W, 4LED 200W 300W 500W",720000,900000,180000,20
TIKI,nha-cua-doi-song,43389470,"Bàn Ăn Thông Minh Tiết Kiệm Diện Tích Màu Sắc Hiện Đại",1127000,1220000,93000,8
TIKI,nha-cua-doi-song,106808360,"Bình Giữ Nhiệt Lock&Lock Riga Tumbler LHC4160 (897ml) - Hàng Chính Hãng, Bằng Thép Không Gỉ, Có Lưới Lọc Inox - Tặng Kèm Ống Hút Và Cọ Rửa Ống Hút",399000,735000,336000,46
TIKI,nha-cua-doi-song,71105497,"Bộ ấm trà xách tay đơn giản, sang trong, tiện lợi khi đi du lịch",299000,299000,0,0
TIKI,nha-cua-doi-song,169518924,"Bình Giữ Nhiệt Inox 304 - YOGA QG, Dung Tích 1000ml - 15000ml, Giữ Nhiệt Tốt Đến 12h, Thiết Kế Sang Trọng, Màu Sắc Bắt Mắt - Hàng chính hãng",114000,125000,11000,9
TIKI,nha-cua-doi-song,536498,"Bộ Vặn Vít Đa Năng 38 Chi Tiết Bosch 2607019506",439000,494000,55000,11
TIKI,nha-cua-doi-song,107016572,"Thùng rác văn phòng lưới Deli - Sọt đựng rác - Màu đen - 28cm - 9188/E9190",214200,214200,0,0
TIKI,nha-cua-doi-song,72646362,"Bộ dụng cụ di chuyển đồ nặng chuyên dụng tải trọng tối đa 1000kg xoay 360 độ",275000,275000,0,0
TIKI,nha-cua-doi-song,272452606,"Bộ cây lau nhà tự vắt thông minh 3 thanh vắt sợi microfiber",550000,1190000,640000,54
TIKI,nha-cua-doi-song,162427187,"Dụng Cụ Bơm Hút Rượu Xăng Dầu Chất Lỏng Bóp Tay Tiện Lợi Đa Năng - Hàng Loại 1-  Chính Hãng MINIIN",47000,76000,29000,38
TIKI,nha-cua-doi-song,49300423,"Kệ Gương Gỗ",415000,430000,15000,3
TIKI,nha-cua-doi-song,144527016,"Bộ Mũi khoan đa năng khoan gốm sứ tường, 1 Bộ 5 món 6/6/8/10/12mm",95195,95195,0,0
TIKI,nha-cua-doi-song,73988526,"Đuôi thoát sàn ngăn mùi hôi, chống côn trùng trọng lực nhựa ABS Hiwin FD-50LID",54000,54000,0,0
TIKI,nha-cua-doi-song,59267058,"Bình Pha Cà Phê Cold Brew Thủy Tinh 1200ml",279000,279000,0,0
TIKI,nha-cua-doi-song,124483451,"TREO CHỔI TREO CÂY LAU NHÀ TREO Ô DÙ VÒI HOA SEN VÒI NƯỚC JODILY DÁN TƯỜNG INOX 304",45000,45000,0,0
TIKI,nha-cua-doi-song,19448864,"Bộ võng xếp BAN MAI: khung sơn tĩnh điện VIP và lưới mềm dày 99 ( Giao màu ngẫu nhiên )",749000,1050000,301000,29
TIKI,nha-cua-doi-song,108243510,"Chảo Inox cao cấp 5 Đáy chống dính siêu bền Sunhouse IN20M2 - 20 cm - Dùng trên mọi loại bếp - Hàng chính hãng",293000,450000,157000,35
TIKI,nha-cua-doi-song,112976323,"Đèn LED cảm biến chuyển động SEASY SS02, cảm biến thông minh, ánh sáng bảo vệ mắt, sạc pin USB đời mới, dán tường, tủ quần áo, cầu thang, phòng ngủ - Hàng chính hãng",42000,89000,47000,53
TIKI,nha-cua-doi-song,36452514,"Đèn pin siêu sáng mini 2in1",46505,86000,39495,46
TIKI,nha-cua-doi-song,191326374,"Bộ Sạc Pin AA, AAA Beston Tự ngắt khi đầy Sạc Tốc Độ Cao Có Led báo trạng thái sạc BST-C9009, Pin sạc chính hãng",60000,60000,0,0
TIKI,nha-cua-doi-song,132855126,"Rèm Cửa Sổ, Rèm Cửa Ra Vào Vintage Phong Cách Scandinavian Bắc Âu",358000,358000,0,0
TIKI,nha-cua-doi-song,170270819,"Ổ cắm chuyển đổi 3 chấu sang 2 chấu tiện lợi - Hàng nhập khẩu",12000,25000,13000,52
TIKI,nha-cua-doi-song,72901343,"Combo 4 Móc Dán Tường Inox 304 Hình Trụ Vuông MD02 Cao Cấp Chống Gỉ Sét Siêu Bền Siêu Chịu Lực - Móc Treo Đồ Gia Đình Tiện Dụng",135000,230000,95000,41
TIKI,nha-cua-doi-song,35876754,"Ổ Điện Đa Năng Chống Giật 3 Cổng USB và 9 ổ cắm iCART",37899,37899,0,0
TIKI,nha-cua-doi-song,176076047,"Khăn Lau  Nhà Bếp Siêu Thấm Nước Mềm Mại Size Lớn",9000,9000,0,0
TIKI,nha-cua-doi-song,118090738,"Kệ Treo Tường - Thanh Ngang Trang Trí Màu Vân Gỗ Sồi Đơn Giản SIB Decor, Gỗ Chống Ẩm 25mm, Kết Cấu Không Giá Đỡ Chắc Chắn Thẩm Mỹ",159000,159000,0,0
TIKI,nha-cua-doi-song,73553244,"Hộp Đựng Trang Sức MOHI MH10 Kích Thước 10x10x5.5cm - Hàng Chính Hãng",64400,70000,5600,8
TIKI,nha-cua-doi-song,137136435," Keo silicon Apollo A500 chống thấm tốt, bền bỉ (keo trong - keo trắng đục) 300ml",61750,65000,3250,5
TIKI,nha-cua-doi-song,151555811,"Bàn làm việc có kệ - Màu vàng nhạt - 80cmx40cmx75cm",359000,359000,0,0
TIKI,nha-cua-doi-song,79665351," Đèn Led gắn tường, tủ đọc sách  tích điện đa năng 4 cấp độ",135000,135000,0,0
TIKI,nha-cua-doi-song,73829087,"Kệ để đồ rửa chén bát gác trên bồn rửa inox 304 Hobby Home Decor KRC5 có khay hứng nước",99000,159000,60000,38
TIKI,nha-cua-doi-song,116194000,"Hộp đựng trứng, khay trứng, hộp bảo quản thực phẩm tủ lạnh Homepower cao cấp, trên nắp đậy có phần ghi chú thời gian bảo quản tiện lợi",169000,169000,0,0
TIKI,nha-cua-doi-song,67707813,"Phụ kiện Ngăn mùi nhà tắm - INOX 304 lắp thoát sàn chống mùi hôi ngăn vi khuẩn trào ngược lên – DH2011",97000,97000,0,0
TIKI,nha-cua-doi-song,213710307,"Lưỡi cưa xích RAKUTEN LOẠI 1 gắn máy mài cầm tay, bộ dụng cụ chuyển đổi máy mài thành máy cưa gỗ mini",132050,139000,6950,5
TIKI,nha-cua-doi-song,176805088,"COMBO 3 Túi Phân Bón Lan ORCHID 1-2-3 - Dưỡng rễ, Cây, Kích Ra Hoa cho Phong Lan, cây kiểng - tan chậm Túi Lưới",79000,79000,0,0
TIKI,nha-cua-doi-song,89227279,"Giấy bạc dán tường nhà bếp chống thấm dầu, thấm nước tiện dụng, cách nhiệt",69000,69000,0,0
TIKI,nha-cua-doi-song,187512713,"Ly Thủy Tinh Navivu Oval 380ml - Cốc Thủy Tinh Uống Trà",45000,45000,0,0
TIKI,nha-cua-doi-song,95875948,"Ổ khóa cửa treo Việt Tiệp đồng vàng",58045,61100,3055,5
TIKI,nha-cua-doi-song,152446406,"Cây Chúc ( chanh thái ) - Cây chanh ăn lá ( chanh hấp gà ) + Tặng phân bón cho cây",39000,58000,19000,33
TIKI,nha-cua-doi-song,241980823,"Combo 20 Kẹp Inox 304 Phơi Quần Áo, Chăn Mền",25000,25000,0,0
TIKI,nha-cua-doi-song,75339729,"Chổi Quét Trần Nhà, Chổi Phất Trần Có Cán Điều Chỉnh Độ Dài KUNBE Quét Mạng Nhện, Lau Chùi Bụi Bẩn Trên Cao Tiện Dụng",149000,149000,0,0
TIKI,dien-thoai-may-tinh-bang,271046571,"Điện thoại Xiaomi Redmi Note 12 (8GB/128GB) - Hàng chính hãng",3790000,4790000,1000000,21
TIKI,dien-thoai-may-tinh-bang,273947792,"Điện thoại AI Samsung Galaxy S24 Ultra 12GB/256GB, Camera 200MP Zoom 100x, S Pen- Đen- Hàng Chính Hãng",31990000,34490000,2500000,7
TIKI,dien-thoai-may-tinh-bang,43924153,"Máy đọc sách Kindle Oasis 3 (2019) - Amazon - Hàng nhập khẩu",5790000,5790000,0,0
TIKI,dien-thoai-may-tinh-bang,273947785,"Điện thoại AI Samsung Galaxy S24+ 12GB/256GB, Camera 50MP, Màn hình 6.7"- Đen- Hàng Chính Hãng",25490000,27490000,2000000,7
TIKI,dien-thoai-may-tinh-bang,184036446,"Apple iPhone 11",11340000,15999000,4659000,29
TIKI,dien-thoai-may-tinh-bang,173387789,"Máy đọc sách All New Kindle Oasis 3 - Hàng nhập khẩu",5790000,5790000,0,0
TIKI,dien-thoai-may-tinh-bang,57809866,"Điện thoại Xiaomi Redmi 9A (2GB/32GB)",1690000,2490000,800000,32
TIKI,dien-thoai-may-tinh-bang,184059211,"Apple iPhone 13",13990000,24990000,11000000,44
TIKI,dien-thoai-may-tinh-bang,214756058,"Máy đọc sách New Kindle 11th 2022 (16GB) - Hàng chính hãng",2920000,2920000,0,0
TIKI,nha-cua-doi-song,46601114,"KỆ GƯƠNG 2 TẦNG ĐẦU GIƯỜNG GỖ THÔNG- GLASS SHELF- CAO 50CM x DÀI 30CM x RỘNG 30CM",180000,180000,0,0
TIKI,dien-thoai-may-tinh-bang,217640502,"Máy đọc sách Kindle Scribe - Hàng chính hãng",12590000,12590000,0,0
TIKI,dien-thoai-may-tinh-bang,183330021,"Apple iPad 10.2-inch (9th Gen) Wi-Fi 2021",6990000,10990000,4000000,36
TIKI,nha-cua-doi-song,52021362,"Bảng điện nổi V3 Điện Quang ĐQ FEP 32W 03S (màu trắng, 3 lỗ 2 chấu, 3 công tắc)",71000,91900,20900,23
TIKI,dien-thoai-may-tinh-bang,201067649,"Combo máy đọc sách Kindle Paperwhite 5 (11th gen) tặng kèm bao da ( Cover ) - Hàng nhập khẩu",3849000,4100000,251000,6
TIKI,dien-thoai-may-tinh-bang,252586291,"Máy đọc sách All New Kindle Paperwhite 5 (11th Gen) - Hàng chính hãng",3790600,3990000,199400,5
TIKI,dien-thoai-may-tinh-bang,252586291,"Máy đọc sách All New Kindle Paperwhite 5 (11th Gen) - Hàng chính hãng",3790600,3990000,199400,5
TIKI,dien-thoai-may-tinh-bang,272113804,"[MỚI] Điện thoại vivo Y17s - Hàng chính hãng - Camera 50MP - Pin 5000 mAh - Sạc nhanh- RAM mở rộng đến 8GB",3990000,3990000,0,0
TIKI,nha-cua-doi-song,174307623,"Đệm Ngồi Bệt Tròn Cho Bàn Trang Điểm Vải Cao Cấp Kiểu Hàn Chính Hãng IGA - GC13",91000,99000,8000,8
TIKI,dien-thoai-may-tinh-bang,31261844,"Điện Thoại Bàn Cố Định Không Dây Lắp Sim",650000,650000,0,0
TIKI,dien-thoai-may-tinh-bang,11415485,"ĐIỆN THOẠI CỐ ĐỊNH PANASONIC KX-TS580MX",940000,940000,0,0
TIKI,nha-cua-doi-song,98335248,"Đèn laser ánh sáng laze cảm biến âm thanh - Kết hợp Đèn LED xoay 7 màu dùng trang trí vũ trường, phòng karaoke",349000,349000,0,0
TIKI,dien-thoai-may-tinh-bang,172329599,"Điện thoại Xiaomi Redmi 9A (2GB/32GB) - Hàng chính hãng",1754000,2199000,445000,20
TIKI,dien-thoai-may-tinh-bang,184248127,"Apple iPad mini (6th Gen) Wi-Fi 2021",11490000,14990000,3500000,23
TIKI,nha-cua-doi-song,84958837,"Kệ sách tổ ong đa năng.GP100",65000,69999,4999,7
TIKI,dien-thoai-may-tinh-bang,242434782,"Máy đọc sách New Kindle 11th 2022 (16GB) - Hàng nhập khẩu",2920000,2920000,0,0
TIKI,dien-thoai-may-tinh-bang,120295859,"Điện Thoại Nokia C30 (2GB/32GB) - Hàng Chính Hãng",1490000,1990000,500000,25
TIKI,dien-thoai-may-tinh-bang,204237269,"Điện Thoại Bàn Panasonic KX-TSC11 - Hàng Chính Hãng - Trắng",600000,600000,0,0
TIKI,dien-thoai-may-tinh-bang,189466001,"Điện thoại Xiaomi Redmi 10A (2GB/32GB) - Hàng chính hãng",1949000,2890000,941000,33
TIKI,nha-cua-doi-song,10814223,"Dụng Cụ Gắp Rác Thông Tắc Đường Ống, Lavabo Tiện Ích (160cm)",32900,32900,0,0
TIKI,nha-cua-doi-song,132209590,"Thảm chùi chân siêu thấm hút nước 3 giây  cho phòng tắm, phòng bếp, dễ dàng vệ sinh, nhanh khô vệ sinh nhà cửa an toàn với da.",28997,28997,0,0
TIKI,dien-thoai-may-tinh-bang,42333095,"Điện thoại cố định không dây cho người già, màn hình hiển thị đầu số - Hàng chính hãng",490000,490000,0,0
TIKI,nha-cua-doi-song,193095643,"Combo 2 Móc Dán Tường Trong Suốt Treo Đồ Dùng Thông Minh",6900,6900,0,0
TIKI,dien-thoai-may-tinh-bang,195317118," Máy tính bảng Oppo Pad Air (4GB/64GB) - Hàng Chính Hãng",4990000,6999000,2009000,29
TIKI,dien-thoai-may-tinh-bang,209872337,"Máy đọc sách Kindle 2022 (11th) - All new kindle 2022 11th màn hình 6inch 300PPI gấp 2 lần độ sắc nét, 16GB bộ nhớ trong với cổng kết nối USB-C - Hàng nhập khẩu",2920000,2920000,0,0
TIKI,dien-thoai-may-tinh-bang,181266509,"Điện thoại Ulefone Armor 14 pro (chống nước,chống va đập,pin khủng,pin 10.000mAh,Ram 8Gb,Rom 128Gb)- hàng chính hãng",5990000,5990000,0,0
TIKI,dien-thoai-may-tinh-bang,125182567,"Máy đọc sách All New Kindle Paperwhite 5 (11th Gen) - Hàng nhập khẩu",4600000,4600000,0,0
TIKI,nha-cua-doi-song,12756233,"Ổ điện thông minh có 6 phích cắm 3 cổng USB (giao màu ngẫu nhiên)",41000,41000,0,0
TIKI,dien-thoai-may-tinh-bang,123345348,"Apple iPhone 12",11490000,16990000,5500000,32
TIKI,nha-cua-doi-song,61278429,"Bình Nước Giữ Nhiệt Có Móc Treo (300ml)",68000,68000,0,0
TIKI,nha-cua-doi-song,142383214,"Hộp Đựng Giấy Ăn Để Bàn Có Ngăn Để Đồ Đa Năng, Hộp Khăn Giấy Nắp Gỗ",25624,25624,0,0
TIKI,nha-cua-doi-song,101870479,"Thanh treo rèm cửa đa năng, không cần khoan tường hay bắt vít, thay đổi vị trí linh hoạt",75000,120000,45000,38
TIKI,dien-thoai-may-tinh-bang,173387789,"Máy đọc sách All New Kindle Oasis 3 - Hàng nhập khẩu",5790000,5790000,0,0
TIKI,nha-cua-doi-song,72797082,"Chảo Sâu Lòng DECOR Lock&Lock LDE1225IH 22cm (màu vàng) - Hàng chính hãng",397000,662000,265000,40
TIKI,dien-thoai-may-tinh-bang,168526284,"Điện thoại Nokia 105 4G - Hàng chính hãng",675000,769000,94000,12
TIKI,nha-cua-doi-song,141001207,"Ghế Gấp Inox Phòng Chờ, Ghế Xếp Văn Phòng, Ghế Phòng Họp Gấp Gọn - Hàng Chính Hãng",479000,800000,321000,40
TIKI,nha-cua-doi-song,35422376,"Ô Dù 4 Lớp Che Nắng, Đi Mưa Chống Tia UV",38000,38000,0,0
TIKI,dien-thoai-may-tinh-bang,217706932,"Combo Máy đọc sách All New Kindle Paperwhite 5 (11th Gen) và Bao da - Hàng nhập khẩu",3980000,3980000,0,0
TIKI,nha-cua-doi-song,57650806,"Máy bơm tăng áp mini tự động",480000,480000,0,0
TIKI,nha-cua-doi-song,93154028,"Thảm lông trải sàn lông mịn kích thước 1.2 x 1.6m- dài Thảm lông trải sàn cao cấp phòng khách trang trí nhà cửa.",175000,175000,0,0
TIKI,nha-cua-doi-song,204230323,"Bộ nhang không tăm đầy đủ hộp đựng và máng đốt bằng gỗ nhà HÀ XÁ cao cấp",99000,198000,99000,50
TIKI,nha-cua-doi-song,50324146,"Combo 5 Chai Thủy Tinh đựng nước 500ML - Nắp Thiếc vặn có dây treo (Bình thủy tinh đựng nước, đựng sữa - Chai thủy tinh đựng nước ép)",52999,52999,0,0
TIKI,nha-cua-doi-song,143299139,"Bình Đựng Nước Cho Bé, Bình Nước Goki Rudy 450ml, Bình Nước Cao Cấp Chính Hãng Inochi Đạt Tiêu Chuẩn Xuất Nhật",82600,118000,35400,30
TIKI,dien-thoai-may-tinh-bang,197960169,"Điện thoại Masstel Lux 10 4G - Sang trọng - Gọi HD Call - Hàng chính hãng",538000,700000,162000,23
TIKI,dien-thoai-may-tinh-bang,125590981,"Điện thoại Nokia C30 2GB/32GB - Hàng chính hãng",1550000,1550000,0,0
TIKI,nha-cua-doi-song,14886261," Máy sấy khử mùi giày",156988,156988,0,0
TIKI,dien-thoai-may-tinh-bang,170165701,"Điện thoại bàn Ktel 645 hàng chính hãng",398000,398000,0,0
TIKI,nha-cua-doi-song,72659852,"Kệ Nhà Tắm Dán Tường OENON chất liệu nhựa ABS có thêm thanh nhôm treo khăn - OE08",169000,300000,131000,44
TIKI,dien-thoai-may-tinh-bang,173557858,"Máy tính bảng Kindle File HD 8 (10th generation - 2020) Hàng nhập khẩu",2250000,2250000,0,0
TIKI,dien-thoai-may-tinh-bang,125182567,"Máy đọc sách All New Kindle Paperwhite 5 (11th Gen) - Hàng nhập khẩu",3950000,3950000,0,0
TIKI,nha-cua-doi-song,26159911,"Decal dán tường thước đo chiều cao Hươu cao cổ 5 AmyShop (145 x 84 cm)",66900,75000,8100,11
TIKI,dien-thoai-may-tinh-bang,43924153,"Máy đọc sách Kindle Oasis 3 (2019) - Amazon - Hàng nhập khẩu",5790000,5790000,0,0
TIKI,nha-cua-doi-song,202185819,"Bình Giữ Nhiệt Cao Cấp 304  Có Nắp Xoáy Tiện Lợi Giữ Nhiệt Nóng Lạnh",200000,200000,0,0
TIKI,nha-cua-doi-song,141469357,"COMBO 50 Khay (Chén, Bát) Giấy FEST CHOICE FOOD TRAY 3x3 Inches THÁI LAN Hàng Nhập Khẩu Cao Cấp, Dùng 1 Lần Tiện Lợi, An Toàn - CHÍNH HÃNG F010 (Tặng Móc Khóa KETILO)",99000,99000,0,0
TIKI,dien-thoai-may-tinh-bang,73842403,"Điện thoại bàn có dây nhỏ gọn màu trắng",250000,250000,0,0
TIKI,nha-cua-doi-song,159144266,"Cây lau nhà VILEDA Turbo Easy Wring&Clean đầu lau tam giác, xô giặt quay bằng chân",579000,579000,0,0
TIKI,dien-thoai-may-tinh-bang,197652030,"Điện thoại Masstel Lux 20 4G - Sang trọng - Gọi HD Call - Hàng chính hãng",567000,800000,233000,29
TIKI,nha-cua-doi-song,89792661,"[tặng kèm khay trúc 02 tầng] Bộ Ấm Chén Pha Trà Du Lịch 2 - Kiểu dáng trang nhã, Gọn gàng, Thích hợp mang đi du lịch, công tác",134964,134964,0,0
TIKI,nha-cua-doi-song,107486345,"Bộ chăn ga giường Lidaco cotton Tici cao cấp (Nhiều mẫu lựa chọn)",239000,339000,100000,29
TIKI,dien-thoai-may-tinh-bang,270794184,"Máy đọc sách Kobo Clara - Hàng Chính Hãng",2899000,2925000,26000,1
TIKI,nha-cua-doi-song,36568964,"thước kep điện tử sợi carbon 0-150mm",49900,49900,0,0
TIKI,dien-thoai-may-tinh-bang,121744434,"Điện Thoại Xiaomi Redmi 10 4GB/128GB - Hàng Chính Hãng",2949000,4290000,1341000,31
TIKI,nha-cua-doi-song,89059076,"Chảo sâu lòng chống dính đáy từ Tefal Ultimate 28cm, dùng cho mọi loại bếp - Sản xuất tại Pháp - Hàng chính hãng",1699000,1699000,0,0
TIKI,nha-cua-doi-song,778124,"Bộ Hộp Cơm Giữ Nhiệt Lock&Lock LHC8015 (910ml) - Xám Bạc ",619000,1142000,523000,46
TIKI,nha-cua-doi-song,51966031,"Phân Hữu Cơ Gà Dynamic Nhật Bản Tốt Cây Xanh lá  Cung Cấp Đầy Đủ Dưỡng Chất , Dúng Bón Hoa Hồng ,Cây Kiểng , Cây Ăn Trái( Túi 1 KG)",35000,35000,0,0
TIKI,nha-cua-doi-song,96419574,"Màng PE trắng khổ 50cm 2,5kg - Màng PE quấn hàng.",113000,113000,0,0
TIKI,dien-thoai-may-tinh-bang,163914808,"Điện thoại bàn Panasonic  KX-TS500MX-hàng chính hãng",300000,300000,0,0
TIKI,dien-thoai-may-tinh-bang,217645692,"Combo Máy đọc sách All New Kindle Paperwhite 5 (11th Gen) - 16Gb và Bao da - Hàng nhập khẩu",3980000,3980000,0,0
TIKI,dien-thoai-may-tinh-bang,139632023,"Máy đọc sách Kobo Libra 2 - hàng nhập khẩu",5199000,5800000,601000,10
TIKI,dien-thoai-may-tinh-bang,201067649,"Combo máy đọc sách Kindle Paperwhite 5 (11th gen) tặng kèm bao da ( Cover ) - Hàng nhập khẩu",3760000,3990000,230000,6
TIKI,nha-cua-doi-song,117370665,"Chiếu ngủ trưa văn phòng cá nhân dày 3.5ly / Chiếu Cách Nhiệt Văn Phòng 100 X 190 cm",46000,46000,0,0
TIKI,nha-cua-doi-song,70372700,"Đèn Cây Dạng Đứng Đọc Sách Pixar, Đèn Sàn, Đèn Trang Trí Phòng Khách, Đèn Ngủ. Chống Cận Thị Bảo Vệ Mắt. Chiều Cao 1,85m. Hàng Chính Hãng Moontronics",399000,399000,0,0
TIKI,dien-thoai-may-tinh-bang,29931445,"Ulefone Armor X 5 ( chống nước,chống va đập,pin 5.000mAh ) hàng chính hãng",3990000,3990000,0,0
TIKI,dien-thoai-may-tinh-bang,197654695,"Điện thoại Masstel izi 26 4G - Gọi HD Call - Hàng chính hãng",489000,650000,161000,25
TIKI,dien-thoai-may-tinh-bang,126050455,"Điện thoại Nokia C20 (2GB/16GB) - Hàng Chính Hãng",1290000,2290000,1000000,44
TIKI,nha-cua-doi-song,43110675,"Móc Khóa Tua Vít mini đa năng sửa chữa kính, đồng hồ, điện thoại (6cm x 0,5cm)",9700,9700,0,0
TIKI,nha-cua-doi-song,226043852,"Chăn Gối Ngủ Văn Phòng Hình Mèo Kèm Chăn",148000,148000,0,0
TIKI,nha-cua-doi-song,4995493,"Thang Nhôm Rút Chữ A Sumika SK380D NEW - Chữ A cao 1.9m, chữ I cao 3.8m, tải trọng 300kg",1769000,2300000,531000,23
TIKI,dien-thoai-may-tinh-bang,167466044,"Điện thoại Masstel FAMI 60 4G Pin 2000 mah - Hàng chính hãng",636000,750000,114000,15
TIKI,dien-thoai-may-tinh-bang,140940220,"Máy đọc sách Kobo Sage - hàng nhập khẩu",8679000,8679000,0,0
TIKI,dien-thoai-may-tinh-bang,181977398,"Điện thoại bàn Panasonic KX-TS880 hàng chính hãng",1050000,1050000,0,0
TIKI,dien-thoai-may-tinh-bang,181452535,"Điện thoại Itel it9200 4G - WIFI - Xem YTB , FB - Hàng chính hãng",547000,790000,243000,31
TIKI,dien-thoai-may-tinh-bang,184578632,"Điện thoại Itel it9010 4G - Hàng chính hãng",399000,399000,0,0
TIKI,nha-cua-doi-song,271696352,"Gối Niu Cao Cấp Ru9 - Công Nghệ Đột Phá Graphene Foam | Chất Liệu Foam Mềm Mại | Nâng Đỡ Đốt Sống Cổ | Chống Đau Vai Gáy",912000,950000,38000,4
TIKI,nha-cua-doi-song,54082178,"Túi đựng rác lốc 3 cuộn 1kg - Bịch đựng rác 3 cuộn cỡ đại, trung, tiểu",24000,24000,0,0
TIKI,dien-thoai-may-tinh-bang,150724369,"Máy tính bảng Fire HD10 2021 - 11th - (All New Fire HD10 - 2021) - Ram 3/4GB, bộ nhớ 32GB, màn hình 1080 FullHD",3115000,3500000,385000,11
TIKI,dien-thoai-may-tinh-bang,271046571,"Điện thoại Xiaomi Redmi Note 12 (8GB/128GB) - Hàng chính hãng",3790000,4530000,740000,16
TIKI,dien-thoai-may-tinh-bang,273947792,"Điện thoại AI Samsung Galaxy S24 Ultra 12GB/256GB, Camera 200MP Zoom 100x, S Pen- Đen- Hàng Chính Hãng",31990000,34490000,2500000,7
TIKI,dien-thoai-may-tinh-bang,273947785,"Điện thoại AI Samsung Galaxy S24+ 12GB/256GB, Camera 50MP, Màn hình 6.7"- Đen- Hàng Chính Hãng",25490000,27490000,2000000,7
TIKI,dien-thoai-may-tinh-bang,125182567,"Máy đọc sách All New Kindle Paperwhite 5 (11th Gen) - Hàng nhập khẩu",3690000,3690000,0,0
TIKI,dien-thoai-may-tinh-bang,217640502,"Máy đọc sách Kindle Scribe - Hàng chính hãng",12590000,12590000,0,0
TIKI,dien-thoai-may-tinh-bang,117929342,"Điện thoại Panasonic KX-TSC11MX -Hàng chính hãng",599000,599000,0,0
TIKI,dien-thoai-may-tinh-bang,197666071,"Điện thoại Masstel Fami 65 4G - Tặng dock sạc - Gọi HD Call - Hàng chính hãng",656000,900000,244000,27
TIKI,dien-thoai-may-tinh-bang,23142193,"Điện thoại bàn không dây Panasonic KX-TGC313 - Hàng Chính Hãng",2100000,2100000,0,0
TIKI,dien-thoai-may-tinh-bang,173387789,"Máy đọc sách All New Kindle Oasis 3 - Hàng nhập khẩu",5880000,5880000,0,0
TIKI,dien-thoai-may-tinh-bang,4048581,"Điện Thoại Bàn Panasonic KX-TSC11",689000,689000,0,0
TIKI,dien-thoai-may-tinh-bang,74776150,"Máy đọc sách Kobo Libra H20 8GB Trắng/Đen có đèn nền vàng, chống nước - Hàng nhập khẩu",4499000,4499000,0,0
TIKI,dien-thoai-may-tinh-bang,170448099,"Điện Thoại Người Già Masstel Fami 60 4G - Loa To, FM Không Dây, Đọc Số Bằng Giọng Nói, SOS, Đèn Pin Kép,... Hàng Chính Hãng",679000,882000,203000,23
TIKI,dien-thoai-may-tinh-bang,118486668,"Máy đọc sách Kobo Elipsa - Hàng nhập khẩu",12000000,12000000,0,0
TIKI,dien-thoai-may-tinh-bang,272113804,"[MỚI] Điện thoại vivo Y17s - Hàng chính hãng - Camera 50MP - Pin 5000 mAh - Sạc nhanh- RAM mở rộng đến 8GB",3990000,3990000,0,0
TIKI,dien-thoai-may-tinh-bang,272909668,"[Mới] Điện thoại vivo V29e 5G (8GB/256GB) - Hàng Chính Hãng - Camera Selfie 50 MP - Vòng Sáng Aura 2.0 - Màn hình AMOLED 6.67",8990000,8990000,0,0
TIKI,dien-thoai-may-tinh-bang,167465704,"Điện thoại Masstel IZI 20 4G , Pin 1700 mAh - Hàng chính hãng",399000,499000,100000,20
TIKI,dien-thoai-may-tinh-bang,198111545,"Điện Thoại Vivo V25e 2022 (8GB/128GB) - Hàng Chính Hãng",8490000,8490000,0,0
TIKI,dien-thoai-may-tinh-bang,11251711,"Điện thoại bàn không dây Panasonic KX-TGD312 - Hàng Chính Hãng",2090000,2090000,0,0
TIKI,dien-thoai-may-tinh-bang,242434782,"Máy đọc sách New Kindle 11th 2022 (16GB) - Hàng nhập khẩu",2920000,2920000,0,0
TIKI,dien-thoai-may-tinh-bang,43924153,"Máy đọc sách Kindle Oasis 3 (2019) - Amazon - Hàng nhập khẩu",5790000,5790000,0,0
TIKI,dien-thoai-may-tinh-bang,176909016,"Máy tính bảng HANET Smart Edu Tablet Model T432 - Hàng Chính Hãng",3300000,3300000,0,0
TIKI,dien-thoai-may-tinh-bang,162866839,"Máy tính bảng VNPT Technology VNT Tab8 Plus 8 Inch Android 11 RAM 4GB - Hàng chính hãng",3146000,3146000,0,0
TIKI,dien-thoai-may-tinh-bang,155833852,"Điện Thoại Masstel Hapi 30 3GB/32GB - Hàng Chính Hãng",1879000,2390000,511000,21
TIKI,dien-thoai-may-tinh-bang,151463645,"Điện thoại Bphone A60 (Ram 6Gb,Rom 128 Gb,màn hình đục lổ FHD 6.7inch , pin 5.000mAh ) - Hàng chính hãng",6490000,6490000,0,0
TIKI,dien-thoai-may-tinh-bang,192694043,"Điện thoại để bàn Panasonic KX-TS880 hàng chính hãng",1060000,1060000,0,0
TIKI,dien-thoai-may-tinh-bang,148701811,"Máy đọc sách Kobo Nia - Hàng nhập khẩu",2680000,2680000,0,0
TIKI,dien-thoai-may-tinh-bang,140184098,"Điện Thoại Vsmart Bee Lite 2GB/16GB - Hàng Chính Hãng",999000,1990000,991000,50
TIKI,dien-thoai-may-tinh-bang,197966909,"Điện Thoại Samsung A04s 4GB/64GB - Hàng Chính Hãng",2669000,3990000,1321000,33
TIKI,dien-thoai-may-tinh-bang,16521748,"Điện thoại để bàn Panasonic KX-TS880 hàng chính hãng",1150000,1150000,0,0
TIKI,dien-thoai-may-tinh-bang,209872337,"Máy đọc sách Kindle 2022 (11th) - All new kindle 2022 11th màn hình 6inch 300PPI gấp 2 lần độ sắc nét, 16GB bộ nhớ trong với cổng kết nối USB-C - Hàng nhập khẩu",2920000,2920000,0,0
TIKI,dien-thoai-may-tinh-bang,125753291,"Điện thoại Nokia 105 4G - Hàng chính hãng",629000,629000,0,0
TIKI,dien-thoai-may-tinh-bang,163875403,"ĐIỆN THOẠI MASSTEL IZI 55 4G-HÀNG CHÍNH HÃNG",650000,650000,0,0
TIKI,dien-thoai-may-tinh-bang,197651936,"Điện thoại Masstel Izi 25 4G Pin siêu khỏe, Gọi HD call- Hàng chính hãng",489000,599000,110000,18
TIKI,dien-thoai-may-tinh-bang,72290345,"Máy đọc sách Kobo Clara HD 8GB đen, 6 inch, có đèn cam - Hàng nhập khẩu",3099000,3099000,0,0
TIKI,dien-thoai-may-tinh-bang,72310420,"Máy tính bảng VANKYO MatrixPad S30 - Hàng Chính Hãng",3090000,3090000,0,0
TIKI,dien-thoai-may-tinh-bang,217645692,"Combo Máy đọc sách All New Kindle Paperwhite 5 (11th Gen) - 16Gb và Bao da - Hàng nhập khẩu",3980000,3980000,0,0
TIKI,dien-thoai-may-tinh-bang,214756058,"Máy đọc sách New Kindle 11th 2022 (16GB) - Hàng chính hãng",2920000,2920000,0,0
TIKI,dien-thoai-may-tinh-bang,143359355,"Điện Thoại Tecno Spark 6 Go 4GB/64GB - Hàng Chính Hãng",2079000,2990000,911000,30
TIKI,dien-thoai-may-tinh-bang,194498804,"Máy Tính Bảng OPPO Pad Air (4GB/64GB) | Màn Hình 2K 1 tỷ Màu | Chip Snapdragon 680 | Hàng Chính Hãng",4990000,6990000,2000000,29
TIKI,dien-thoai-may-tinh-bang,62242668,"Điện Thoại Bàn Homephone lắp sim - Lắp Tất Cả Các Sim Đi Động - Di Chuyển Mang Đi Khắp Nơi - Hàng Chính Hãng",699000,699000,0,0
TIKI,dien-thoai-may-tinh-bang,125753416,"Điện thoại Nokia 110 4G - Hàng chính hãng",740000,740000,0,0
TIKI,dien-thoai-may-tinh-bang,192859201,"Điện thoại Oukitel WP19(chống sốc ,chống nước ,Pin 21000mAh ,Ram 8G ,Rom 256G ,Tầm nhìn ban đêm 64MP ,  Máy ảnh 90Hz ,Điện thoại Helio G95 )-hàng chính hãng",9790000,9790000,0,0
TIKI,dien-thoai-may-tinh-bang,140144656,"Điện thoại Realme C25Y (4GB/128GB) - Hàng chính hãng",3599000,4990000,1391000,28
TIKI,dien-thoai-may-tinh-bang,158895857,"Điện thoại Vivo Y33s (8GB/128GB) - Hàng chính hãng",6069000,6069000,0,0
TIKI,dien-thoai-may-tinh-bang,72310352,"Máy tính bảng Vankyo MatrixPad Z10 - Hàng Chính Hãng",2990000,2990000,0,0
TIKI,dien-thoai-may-tinh-bang,128895957,"Paperwhite 5 (11th-generation) - 2021 - Hàng Nhập Khẩu",3690000,3800000,110000,3
TIKI,dien-thoai-may-tinh-bang,217706932,"Combo Máy đọc sách All New Kindle Paperwhite 5 (11th Gen) và Bao da - Hàng nhập khẩu",3980000,3980000,0,0
TIKI,dien-thoai-may-tinh-bang,136876846,"Máy Tính Bảng Samsung Galaxy Tab A7 3GB/64GB - Hàng Chính Hãng",4989000,7990000,3001000,38
TIKI,dien-thoai-may-tinh-bang,160450655,"Điện Thoại Masstel Tab 10A 3GB/32GB - Hàng Chính Hãng",2939000,3790000,851000,22
TIKI,dien-thoai-may-tinh-bang,193366048,"Điện thoại OnePlus 10T 5G - Hàng Chính Hãng",15990000,15990000,0,0
TIKI,dien-thoai-may-tinh-bang,147969070,"Điện thoại thông minh itel A26 - giá rẻ | 2 Sim 2 Sóng 4G LTE | Màn hình IPS 5.7" HD+ | RAM 2GB + ROM 32 GB (Hỗ trợ thẻ nhớ 32 GB) | Mở khoá bằng Gương Mặt | Chính Hãng bảo hành 12 tháng| 1 đổi 1 trong 30 ngày",2390000,2390000,0,0
TIKI,dien-thoai-may-tinh-bang,197907038,"Điện thoại di động Vtel E10 4G – Hàng Chính Hãng",375000,399000,24000,6
TIKI,dien-thoai-may-tinh-bang,47292697,"Điện thoại bàn cổ điển DT40",2000000,2000000,0,0
TIKI,dien-thoai-may-tinh-bang,84757299,"Điện thoại Itel it9200 4G - Hàng chính hãng",590000,590000,0,0
TIKI,dien-thoai-may-tinh-bang,185755283,"Máy đọc sách Onyx Boox Nova Air - Hàng chính hãng",9860000,9860000,0,0
TIKI,nha-cua-doi-song,116670105,"Dụng cụ di chuyển vật nặng",275000,275000,0,0
TIKI,nha-cua-doi-song,75356087,"Túi Đựng Hộp Cơm Giữ Nhiệt Đa Lớp Cỡ Lớn 34cm*25cm*15cm",60000,60000,0,0
TIKI,nha-cua-doi-song,192909616,"Khăn mặt khô KIPOR dùng 1 lần lau khô, lau ướt - 60 khăn/cuộn, kích thước 20x20cm - Hàng chính hãng",33000,65000,32000,49
TIKI,nha-cua-doi-song,107713002,"Nam châm siêu trường, siêu mạnh, siêu hút dính dùng để trục vớt đồ vật, nâng vật nặng, treo đồ Dan House - DST15, Hàng chính hãng-D20",92000,92000,0,0
TIKI,nha-cua-doi-song,162405563,"Cọ Bồn Cầu Toilet Nhà Vệ Sinh Cao Cấp Kèm Giá Cắm Chổi  Silicon - Hàng Loại 1 - Chính Hãng MINIIN",83000,109000,26000,24
TIKI,nha-cua-doi-song,173673833,"Ghế Quầy Bar Cao Cấp Phong Cách Hiện Đại Decor Tại Nhà Hoặc Văn Phòng Thư Giãn - Hàng Chính Hãng",699000,935000,236000,25
TIKI,nha-cua-doi-song,115436781,"Đèn Fairy Light Năng Lượng Mặt Trời Điều Khiển Remote",270000,270000,0,0
TIKI,nha-cua-doi-song,58451521,"Combo 2 Miếng Lau Nhà Parroti Magic MG01 – Kích Thước 32x10 CM - Chất Liệu Microfiber Cao Cấp",55000,109000,54000,50
TIKI,nha-cua-doi-song,44297321,"Đèn Diệt Côn Trùng Đại Sinh DS-D6",585000,585000,0,0
TIKI,nha-cua-doi-song,117196166,"Pin Maxell R6P super AA hộp 40 viên tiểu",49900,49900,0,0
TIKI,nha-cua-doi-song,94888985,"Sọt Đựng Quần Áo Bẩn Túi Đựng Đồ Đa Năng",65000,65000,0,0
TIKI,nha-cua-doi-song,58415187,"Đèn cảm ứng gắn cầu thang, tủ đồ, toilet, tự động bật/tắt ánh sáng, sạc bằng USB tiện dụng",84000,84000,0,0
TIKI,nha-cua-doi-song,160570940,"Set 10  Khay giấy bạc lót nồi chiên không dầu tái sử dụng được ",11000,11999,999,8
TIKI,nha-cua-doi-song,181936450,"Túi Lọc Trà Túi Lọc Cà Phê Cold Brew Vải Không Dệt Có Dây Rút 8X10Cm, Định Lượng 60G/Túi, Combo 10 Túi",14000,15000,1000,7
TIKI,nha-cua-doi-song,15428054,"Đệm (Bồ đoàn) ngồi thiền Sunny",175000,175000,0,0
TIKI,nha-cua-doi-song,58228617,"Cuộn dây cáp làm giàn, có sợi gia cường, nhựa bọc kim loại cực kỳ bền chắc - 1kg",79000,79000,0,0
TIKI,nha-cua-doi-song,31473727,"Combo 100 Túi Lọc Trà Có Dây Rút",24000,24000,0,0
TIKI,nha-cua-doi-song,9805349,"Ổ cắm Điện Quang ECO ĐQ ESK 5WR 8ECO (8 Lỗ, dây dài 5m, màu trắng đỏ)",165000,223800,58800,26
TIKI,nha-cua-doi-song,191136118,"Bóng Đèn Led Bulb, Led Edison Đui E27 Các Loại - Hàng Chính Hãng NAVIVU",15000,15000,0,0
TIKI,nha-cua-doi-song,191604178,"Đèn đốt nến thơm, an toàn, sang trọng, phù hợp mọi không gian",299000,299000,0,0
TIKI,nha-cua-doi-song,162189829,"Nhang Xanh Phổ Thông 30cm 500g (Đỏ)",163000,165000,2000,1
TIKI,nha-cua-doi-song,19557637,"Combo 2 Gối Mây Đan Tổng Hợp Thoáng Mát",67000,67000,0,0
TIKI,nha-cua-doi-song,173710560,"Cuộn Khăn Giấy Lau Đa Năng - Chất Liệu Rayon An Toàn - Lau Chén Đĩa , Lau Nhà Bếp..vv - Hàng Chính Hãng",49000,58000,9000,16
TIKI,nha-cua-doi-song,51062179,"Keo dán đa năng siêu dính V - 370 gắn tất cả các loại vật liệu ( 50ml)",89000,89000,0,0
TIKI,nha-cua-doi-song,14338957,"Bộ 3 khăn tắm Nhật siêu mềm siêu thấm - khăn tắm khổ rộng 70x140",28998,28998,0,0
TIKI,nha-cua-doi-song,81988120,"Dây nguồn phích âm SOPOKA N8-N10 dây 2,3m-6,5m",43000,43000,0,0
TIKI,nha-cua-doi-song,73566076,"Cây lau nhà tự vắt thông minh chổi lau nhà 360 độ, kèm 2 miếng lau Kitimop-RED, vắt kiệt nước dễ dàng, cầm nhẹ tay, chổi lau nhà thông minh",145000,145000,0,0
TIKI,nha-cua-doi-song,73755163,"Hộp Đựng Mỹ Phẩm,Đồ Trang Điểm MOHI MT9 ,2 Ngăn Có Kệ Trên Và Nắp Đậy-Hàng Chính Hãng",414000,450000,36000,8
TIKI,nha-cua-doi-song,39318884,"Hộp 60 Viên Pin AA Panasonic ( Pin Tiểu ) Hi Top - Hàng Chính Hãng",174000,179000,5000,3
TIKI,nha-cua-doi-song,19853979,"Võng lưới số 9.2, căng kim dày BAN MAI, khổ rộng, cán thép 50 (Giao màu ngẫu nhiên)",215000,300000,85000,28
TIKI,nha-cua-doi-song,108243508,"Chảo sâu đáy từ miệng rót Sunhouse SHS20MRD - Dùng trên mọi loại bếp - Hàng chính hãng",272000,400000,128000,32
TIKI,nha-cua-doi-song,116452179,"SÉT 100 TÚI BỌC THỰC PHẨM GẤU HÀNG ĐẸP, DÀY DẶN LOẠI 1.",12798,12798,0,0
TIKI,nha-cua-doi-song,230062294,"Bộ dụng cụ tháo vặn ốc vít",148000,148000,0,0
TIKI,nha-cua-doi-song,70536777,"Đèn bắt muỗi, ruồi và các loại côn trùng Đại Sinh DS-D6",585000,585000,0,0
TIKI,nha-cua-doi-song,76468352,"Combo 200 CÁI TÚI LỌC RÁC BỒN RỬA CHÉN - KT: 10x10cm -Hàng chất lượng tốt",27999,27999,0,0
TIKI,nha-cua-doi-song,109213631,"Chân đặt khung ảnh chân đặt khung hình thờ chữ L xếp lại gọn gàng chắc vững - Nhiều cỡ",52000,52000,0,0
TIKI,nha-cua-doi-song,69543163,"Cây thông tắc bồn cầu, nhà vệ sinh đa năng cao cấp- Dụng cụ thông tắc bồn cầu, cống bằng khi nén áp lực siêu mạnh kèm bơm rời Morado - Hàng Chính Hãng",310000,310000,0,0
TIKI,nha-cua-doi-song,58448882,"Thanh xốp chắn khe cửa đa năng thông minh",20000,20000,0,0
TIKI,nha-cua-doi-song,196376951,"Cốc Giữ Nhiệt Nóng Lạnh Vusign Inox 304 Cao Cấp Viền Cao Su Cách Nhiệt Deli Dung Tích 510ml -Phù Hợp Cà Phê Trà Nước Ép Sinh Tố Đá Du Lịch Đi Học Tập Gym",119000,250200,131200,52
TIKI,nha-cua-doi-song,108025488,"BÀN CHẢI ĐÁNH RĂNG PIH HÀNG VIỆT NAM CAO CẤP SIÊU MỀM",4000,4000,0,0
TIKI,dien-thoai-may-tinh-bang,31820638,"Điện Thoại Bàn Panasonic KX-TS500MX - Panasonic KX-TS500MX Integrated Telephone System - Hàng chính hãng",299000,299000,0,0
TIKI,dien-thoai-may-tinh-bang,196760330,"Điện Thoại Vivo T1x 4GB/64GB - Hàng Chính Hãng",3379000,4490000,1111000,25
TIKI,dien-thoai-may-tinh-bang,37289936,"Điện thoại Oukitel WP2 chống nước,chống va đập, pin 10.000 mAh - Hàng chính hãng",5490000,5490000,0,0
TIKI,dien-thoai-may-tinh-bang,221518066,"Máy đọc sách Kindle Oasis 3 10th - Hàng nhập khẩu",6042210,6789000,746790,11
TIKI,dien-thoai-may-tinh-bang,194462682,"Điện thoại ZTE Blade A52 4GB l 64GB, Pin 5000mAh, Màn hình 6.52", Camera AI Triple - Hàng chính hãng",3490000,3490000,0,0
TIKI,dien-thoai-may-tinh-bang,273227290,"Combo Máy đọc sách Kindle Scribe kèm bút – thế hệ đầu tiên có thể đọc và viết, màn hình 10,2” 300PPI, đèn vàng warmlight, bộ nhớ 16-64GB, đồng bộ dữ liệu qua Microsoft Word - hàng nhập khẩu",11276100,11390000,113900,1
TIKI,dien-thoai-may-tinh-bang,198203859,"Điện Thoại Vivo V25 5G 2022 (8GB/128GB) - Hàng Chính Hãng",7490000,10490000,3000000,29
TIKI,dien-thoai-may-tinh-bang,80132874,"ĐIỆN THOẠI TÂN CỔ ĐIỂN DT16 bàn phím quay chuông thanh, dùng được nghe gọi âm thanh rõ ràng. Điện thoại để bàn tân cổ điển- Điện thoại bàn chất liệu gỗ để trang trí",2320000,2900000,580000,20
TIKI,dien-thoai-may-tinh-bang,196176544,"Điện Thoại Cho Người Già Masstel Fami 12 4G-hỗ trợ 4g-chữ to dành cho người già(Hàng Chính Hãng)",630000,630000,0,0
TIKI,dien-thoai-may-tinh-bang,4059671,"Điện Thoại Bàn Panasonic KXTS 520 - Hàng Chính Hãng",469000,489000,20000,4
TIKI,dien-thoai-may-tinh-bang,21317020,"Điện thoại bàn không dây Panasonic KX-TGF310 - Hàng Chính Hãng",2450000,2450000,0,0
TIKI,dien-thoai-may-tinh-bang,14508445,"Điện thoại Ip phone Cisco CP-7841-K9 chính hãng",4200000,4200000,0,0
TIKI,dien-thoai-may-tinh-bang,181216830,"Điện thoại ZTE Blade V40 Vita (ZTE 8045) - MH giọt nước HD+ 6.75" - Pin 6000 mAh sạc nhanh 22.5W -  Bộ nhớ mở rộng (4+2)GB - Hàng chính hãng",4290000,4290000,0,0
TIKI,dien-thoai-may-tinh-bang,257866809,"Điện thoại để bàn tân cổ điển phím quay DT15",3900000,3900000,0,0
TIKI,dien-thoai-may-tinh-bang,170727305,"Điện thoại bàn Panasonic KX-TS580 hàng chính hãng",999000,999000,0,0
TIKI,dien-thoai-may-tinh-bang,4048043,"Điện Thoại Bàn Panasonic KX-TS500",339000,369000,30000,8
TIKI,dien-thoai-may-tinh-bang,188030974,"Máy tính bảng Oukitel RT1 - hàng chính hãng  (chống nước,chống va đập , pin khủng,pin 10.000mAh,màn hình 10,1 inch,Ram 4Gb,Rom 64Gb,tám nhân,học online)",6990000,6990000,0,0
TIKI,dien-thoai-may-tinh-bang,11110653,"Điện thoại bàn không dây Panasonic KX-TGF320 - Hàng Chính Hãng",2500000,2500000,0,0
TIKI,dien-thoai-may-tinh-bang,174085242,"Điện Thoại Cho Người Già Masstel Fami 12 4G - Viền Kim Loại, Ăng Ten FM Không Dây - Hàng Chính Hãng",612000,699000,87000,12
TIKI,dien-thoai-may-tinh-bang,94453667,"Điện thoại VoIP Yealink SIP-T30",1050000,1050000,0,0
TIKI,dien-thoai-may-tinh-bang,215125094,"Điện Thoại Di Động Forme D999 4G - Hàng Chính Hãng",760000,760000,0,0
TIKI,dien-thoai-may-tinh-bang,52326343,"Cisco Unified IP Phone CP-7821-K9 - Hàng chính hãng",2580000,2580000,0,0
TIKI,dien-thoai-may-tinh-bang,91281318,"Máy Đọc Sách Likebook P10 - Hàng chính hãng",9090000,9090000,0,0
TIKI,dien-thoai-may-tinh-bang,55197731,"Điện thoại bàn màu đỏ KXT438",215000,215000,0,0
TIKI,dien-thoai-may-tinh-bang,54882670,"Điện thoại để bàn tân cổ điển chuông thanh bàn phím quay mã DT10 dùng sim di động hoặc dùng cáp nghe gọi âm thanh rõ ràng và để trang trí (điện thoại bàn tân cổ điển)",2320000,2900000,580000,20
TIKI,dien-thoai-may-tinh-bang,198111545,"Điện Thoại Vivo V25e 2022 (8GB/128GB) - Hàng Chính Hãng",8490000,8490000,0,0
TIKI,dien-thoai-may-tinh-bang,117347869,"ĐIỆN THOẠI HỘI NGHỊ YEALINK CP960 -HÀNG CHÍNH HÃNG",15230000,15230000,0,0
TIKI,dien-thoai-may-tinh-bang,54989813,"Điện thoại tân cổ điển để bàn mã DT4 màu trắng kết hợp vàng, chuông thanh bàn phím quay, dùng sim di động nghe gọi âm thanh tốt và để trang trí (Điện thoại bàn tân cổ điển)",2900000,2900000,0,0
TIKI,dien-thoai-may-tinh-bang,113475741,"Điện thoại Panasonic KX-TS520MX - Trắng - Hàng chính hãng",450000,450000,0,0
TIKI,dien-thoai-may-tinh-bang,171852890,"Điện thoại Masstel FAMI 60 4G ,Pin 2000 mah ,cỡ chữ to rõ ràng,âm thanh lớn,màn hình to- Hàng chính hãng",689000,689000,0,0
TIKI,dien-thoai-may-tinh-bang,125171841,"Điện Thoại Bàn Panasonic KX-TSC11 - Hàng Chính Hãng",620000,620000,0,0
TIKI,dien-thoai-may-tinh-bang,197905982,"Điện thoại di động Vtel E10 4G – Hàng Chính Hãng",379050,399000,19950,5
TIKI,dien-thoai-may-tinh-bang,140747649,"Điện thoại Realme C11 2021 (4GB/64GB) - Hàng chính hãng",3790000,3790000,0,0
TIKI,dien-thoai-may-tinh-bang,11376644,"Điện thoại bàn có dây Panasonic KX-TS560MX",730000,730000,0,0
TIKI,dien-thoai-may-tinh-bang,29440849,"điện thoại  IP622C - hàng chính hãng",1650000,1650000,0,0
TIKI,dien-thoai-may-tinh-bang,121154009,"Điện thoại bàn cố định không dây lắp các loại Sim Di động, Cố định (Viettel, Vinaphone, Mobifone...)",650000,650000,0,0
TIKI,dien-thoai-may-tinh-bang,157835051,"Điện Thoại Để Bàn Panasonic KX-TS500MX - Hàng Chính Hãng",380000,380000,0,0
TIKI,dien-thoai-may-tinh-bang,16518032,"Điện thoại để bàn Panasonic KX-TS560 hàng chính hãng",730000,730000,0,0
TIKI,dien-thoai-may-tinh-bang,156222386,"Điện thoại Panasonic KX-TS520MX -Hàng chính hãng",449000,459000,10000,2
TIKI,dien-thoai-may-tinh-bang,54683561,"ĐIỆN THOẠI TÂN CỔ ĐIỂN DT14 bàn phím quay chuông quả, dùng cáp điện thoại cố định nghe gọi âm thanh rõ ràng (điện thoại bàn tân cổ điển)",3520000,4400000,880000,20
TIKI,nha-cua-doi-song,131407865,"bàn làm việc chân gấp gọn",405000,450000,45000,10
TIKI,nha-cua-doi-song,49724259,"Nệm Foam Cao Cấp Nest Ru9 15cm - Màu Xám | 2 Lớp Foam Nâng Đỡ | Bao Gồm 6 Kích Thước | 100 Đêm Ngủ Thử",5790000,5790000,0,0
TIKI,nha-cua-doi-song,55502241,"Bộ chăn ga gối cotton LIDACO PL1 - Dưa Hấu Hồng (SP001111)",197000,309000,112000,36
TIKI,nha-cua-doi-song,62734430,"Gói 5 Kg Phân bón đầu trâu hữu cơ vi sinh cao cấp Trichoderma + TE giúp kháng bệnh và tăng trưởng khỏe cho cây trồng",125000,125000,0,0
TIKI,nha-cua-doi-song,162210732,"Bộ Tua Vít Deli Cao Cấp 30 Chi Tiết Đa Năng Vặn Ốc Vít, Bu Lông - Phù Hợp Sửa Chữa Vật Dụng, Xe Máy - DL1130",164000,268000,104000,39
TIKI,nha-cua-doi-song,162767378,"Bình giữ nhiệt có ống hút, quai đeo cho bé dung tích 1L",93099,97999,4900,5
TIKI,nha-cua-doi-song,984246,"Kèn Melodion - Melodica Suzuki MX-37 37 Phím",750000,750000,0,0
TIKI,nha-cua-doi-song,13561925,"Nồi Hấp 2 Tầng Bằng Inox Lock&Lock LLH1282 (28cm)",791000,1319000,528000,40
TIKI,nha-cua-doi-song,146289201,"Túi đựng hộp cơm giữ nhiệt, túi đựng đồ ăn trưa văn phòng đa chức năng phù hợp cho cả nam và nữ có tay cầm tiện lợi, chống thấm nước",59000,59000,0,0
TIKI,nha-cua-doi-song,117291914,"Bàn Trang Điểm Ngồi Bệt IGA Sắp Xếp Mỹ Phẩm, Son Gọn Gàng - GP143",385000,419000,34000,8
TIKI,nha-cua-doi-song,136227595,"Khay đựng remote  - điện thoại dán tường có khe luồn sạc nhỏ gọn tiện lợi  ( Giao màu ngẫu nhiên ) - Hàng chính hãng ",16000,30000,14000,47
TIKI,nha-cua-doi-song,175432384,"Bàn để ủi quần áo cao cấp Nakagami tư thế đứng có giá đỡ chất lượng Công nghệ Nhật Bản - Màu ngẫu nhiên - Hàng chính hãng",399000,399000,0,0
TIKI,nha-cua-doi-song,54752502,"Bộ 10 khăn lau 2 mặt xuất Nhật Toki - Khăn lau không phai màu không rụng sợi- nhanh khô- Khăn lau bếp, khăn lau kính, lau bát lau tay - HN09421L",10000,15000,5000,33
TIKI,nha-cua-doi-song,195891839,"Đèn LED Mini Móc Khóa - Đèn Pin COB - Đèn Pin Dã Ngoại - Sạc USB Tiện Dụng - Hàng Loại 1 - Chính Hãng MINIIN",51000,59000,8000,14
TIKI,nha-cua-doi-song,148877182,"Ruột gối nằm K-Bedding chất liệu Microfiber màu ngẫu nhiên (45x65cm)",320000,400000,80000,20
TIKI,nha-cua-doi-song,35475781,"Bộ củ sen tắm nóng lạnh bồn tắm inox 304 gồm ( củ sen tắm, vòi sen inox, giá đỡ vòi sen inox, dây sen inox)",276000,550000,274000,50
TIKI,nha-cua-doi-song,125968227,"Cây lau nhà phun sương thông minh 2 trong 1, đầu xoay 360 độ tiện lợi - Broom Green Pro 02",64986,64986,0,0
TIKI,nha-cua-doi-song,20680352,"Combo 5 bẫy diệt chuột thông minh",75000,75000,0,0
TIKI,nha-cua-doi-song,101627081,"Ô dù cầm tay siêu nhẹ 105g cho phái đẹp, chống tia UV - Nason Feather Umbrella for Lady - Dù gấp gọn bỏ túi Nason",195000,195000,0,0
TIKI,nha-cua-doi-song,112218352,"Ron Gioăng Chữ T Dán Chặn Che Khe Hở Khung Chân Cửa Chống Gió Bụi Côn Trùng Thoát Hơi Máy Lạnh",13000,13000,0,0
TIKI,nha-cua-doi-song,794973,"Gối Cao Su Liên Á Oval LAGOV4565 (45 x 65 cm) - Trắng",790000,790000,0,0
TIKI,nha-cua-doi-song,168878527,"SET 10 KHĂN LAU NHÀ BẾP ĐA NĂNG THIẾT KẾ 2 MẶT CHỐNG THẤM DẦU CAO CẤP",28000,28000,0,0
TIKI,nha-cua-doi-song,154157961,"Màn Dây Không Cửa FUNU Chống Muỗi Cao Cấp, Vải Màn Mềm, Mịn, Mắt Dày Dặn Chống Muỗi Tuyệt Đối - Hàng Chính Hãng",133000,140000,7000,5
TIKI,nha-cua-doi-song,148026925,"Bình Đựng Nước 2L Dễ Thương Có Vạch Báo Giờ Uống Nước - Hàng Loại 1 - Chính Hãng MINIIN",94000,120000,26000,22
TIKI,nha-cua-doi-song,58814335,"Xe đẩy hàng 4 bánh SUMIKA T300 - Khung thép, tay cầm gấp mở tiện lợi, tải trọng 300kg",1265000,1950000,685000,35
TIKI,nha-cua-doi-song,56596052,"KỆ ĐỂ BÀN CHẢI ĐÁNH RĂNG VÀ NHẢ KEM ĐÁNH RĂNG TỰ ĐỘNG KÈM 2 CỐC HÚT TỪ TÍNH",106799,119999,13200,11
TIKI,nha-cua-doi-song,207227522,"Giấy nến nấu ăn thương hiệu MyJae",55000,130000,75000,58
TIKI,nha-cua-doi-song,49098494,"Kệ Góc Nhà Tắm, Kệ Góc Tường, Kệ Nhà Tắm Inox 304 2 tầng Cao Cấp L1",380000,550000,170000,31
TIKI,nha-cua-doi-song,200936447,"Bàn Trà Cafe, Bàn Trà Sofa Phong Cách Bắc Âu Thương Hiệu IGEA",176000,176000,0,0
TIKI,nha-cua-doi-song,111705115,"Túi đựng dụng cụ 13 inch INGCO HTBG281328",108000,108000,0,0
TIKI,nha-cua-doi-song,115986066,"Miếng Dán Chân Bàn Ghế Chống Trượt Hamart Bọc Lót Chân Bàn Ghế Chống Ồn Chống Xước Nền Nhà",18000,29000,11000,38
TIKI,nha-cua-doi-song,48175833,"KỆ VUÔNG 3 TẦNG GỖ THÔNG- DÀI 35cm x CAO 65cm",159000,250000,91000,36
TIKI,nha-cua-doi-song,158816154,"Bộ 5 Tấm Xốp Dán Tường Hoạt Hình Mèo Ú Siêu Dễ Thương Sẵn Keo 70x77",85000,85000,0,0
TIKI,nha-cua-doi-song,85930722,"Ổ cắm điện đa năng Hoco DC15 sạc nhanh PD18W hỗ trợ 4 cổng USB- cổng AC tiện dụng - Hàng chính hãng",338000,500000,162000,32
TIKI,nha-cua-doi-song,66090300,"Bộ 20 dụng cụ kẹp giữ dây điện gọn gàng",12999,12999,0,0
TIKI,nha-cua-doi-song,10115744,"Ổ cắm Điện Quang ECO ĐQ ESK 2BR 6ECO (6 Lỗ, dây dài 2m, màu đen đỏ)",88000,88000,0,0
TIKI,nha-cua-doi-song,113833830,"Tấm Lót Bảo Vệ Nệm Cao Cấp PHÚC HẠNH - Lót Chống Thấm",171000,190000,19000,10
TIKI,nha-cua-doi-song,189208326,"Thảm nhà tắm, nhà bếp siêu thấm nước, chống trơn trượt tối giản, hiện đại NAVIVU",99000,99000,0,0
TIKI,nha-cua-doi-song,72049797,"Set 02 Cuộn Giấy Nến, Giấy Sáp, Giấy Lót Nướng Bánh, Lẩu Nướng, Hấp Bánh, Nướng Thực Ăn Chịu Nhiệt, Chống Dính, Không Thấm Dầu Tiện Dụng 30cm x 5m + Tặng Chổi Phếu Dầu Ăn",45000,45000,0,0
TIKI,nha-cua-doi-song,108418530,"Kệ bồn cầu 3 tầng để sau bồn cầu, kệ nhà vệ sinh trên toilet, Kệ nhà tắm đa năng tiện lợi",212900,212900,0,0
TIKI,dien-thoai-may-tinh-bang,15428119,"Điện thoại Ip phone Cisco CP-7945G chính hãng",4500000,4500000,0,0
TIKI,dien-thoai-may-tinh-bang,52481412,"Điện thoại bàn cổ điển, điện thoại bàn tân cổ điển, DT122",2200000,2200000,0,0
TIKI,dien-thoai-may-tinh-bang,23865953,"Điện Thoại Để Bàn Panasonic KX-TS500MX - Hàng Chính Hãng",299000,299000,0,0
TIKI,dien-thoai-may-tinh-bang,172537996,"(Hàng chính hãng) Điện thoại bàn hữu tuyến H2P, hiệu Alcatel - Lucent",2220000,2220000,0,0
TIKI,dien-thoai-may-tinh-bang,29446449,"Điện thoại không dây IP 622CW ",1850000,1850000,0,0
TIKI,dien-thoai-may-tinh-bang,252884859,"Tay con điện thoại bàn Panasonic TGDA30-hàng chính hãng",990000,990000,0,0
TIKI,dien-thoai-may-tinh-bang,271152577,"Điện Thoại Samsung Galaxy Z Flip5 5G - Hàng Chính Hãng - Đã kích hoạt bảo hành điện tử",29490000,29490000,0,0
TIKI,dien-thoai-may-tinh-bang,273685412,"Điện thoại Samsung Galaxy A25 5G (6GB/128GB) - Hàng chính hãng",6590000,6590000,0,0
TIKI,dien-thoai-may-tinh-bang,249178196,"Điện thoại Samsung Galaxy A34 5G 8GB/128GB Xanh - Hàng chính hãng",7600000,8490000,890000,10
TIKI,dien-thoai-may-tinh-bang,274568845,"Điện thoại Xiaomi 14 5G (12GB/256GB) - Hàng chính hãng",22990000,22990000,0,0
TIKI,dien-thoai-may-tinh-bang,273897590,"Điện thoại Tecno SPARK 20c (8+8)GB/128GB - MTK G36 | 5000 mAh | Sạc nhanh 18W | Hàng Chính Hãng",2490000,2690000,200000,7
TIKI,dien-thoai-may-tinh-bang,273955111,"Điện Thoại Oppo Reno 10 5G (8GB/128GB) - Hàng Chính Hãng",7650000,8990000,1340000,15
TIKI,dien-thoai-may-tinh-bang,249955152,"Điện thoại Xiaomi Redmi Note 12 Pro 5G (8GB/256GB) - Hàng chính hãng",9490000,9490000,0,0
TIKI,dien-thoai-may-tinh-bang,253443894,"Điện Thoại Samsung Galaxy M14 5G (4GB/128GB) - Hàng Chính Hãng",4212000,4212000,0,0
TIKI,dien-thoai-may-tinh-bang,160434731,"Máy Tính Bảng Samsung Galaxy Tab A8 4GB/64GB - Hàng Chính Hãng",5856000,5856000,0,0
TIKI,dien-thoai-may-tinh-bang,244355503,"Điện thoại Samsung Galaxy A04s (4GB/64BG) - Hàng chính hãng",3990000,3990000,0,0
TIKI,dien-thoai-may-tinh-bang,197902452,"Điện thoại Masstel Lux 20 4G dành cho người lớn tuổi - Hàng chính hãng, Nguyên Seal",790000,790000,0,0
TIKI,dien-thoai-may-tinh-bang,273360836,"Điện thoại Ulefone armor 22(chống nước,chống va đập, Màn hình giọt nước 6,58 inch, RAM:8GB,Rom 128GB/256GB,Thẻ nhớ microSD Lên đến 512GB, Camera kép 64MP + 64MP)- hàng chính hãng",5990000,5990000,0,0
TIKI,dien-thoai-may-tinh-bang,274498287,"Điện Thoại Samsung Galaxy A55 5G (8GB/128GB)- Hàng Chính Hãng",9390000,9990000,600000,6
TIKI,dien-thoai-may-tinh-bang,53380152,"Điện Thoại IP Phone Fanvil X1S - Hàng Chính Hãng",950000,950000,0,0
TIKI,dien-thoai-may-tinh-bang,249168949,"Điện thoại Samsung Galaxy A34 5G 8GB/128GB Bạc - Hàng chính hãng",7164000,7164000,0,0
TIKI,dien-thoai-may-tinh-bang,274191773,"Điện thoại ZTE Libero 5G IV - 4GB/128GB Dimensity 700 , Kháng nước IP67 , Sạc nhanh 22,5W - Mới nguyên seal - Hàng nhập khẩu",2350000,2990000,640000,21
TIKI,dien-thoai-may-tinh-bang,204872160,"Điện thoại Oppo A17k (3GB/64GB) - Hàng chính hãng",3290000,3290000,0,0
TIKI,dien-thoai-may-tinh-bang,271822675,"Máy Tính Bảng Samsung Galaxy Tab A8 - Hàng Chính Hãng",5856000,5856000,0,0
TIKI,dien-thoai-may-tinh-bang,274440344,"Điện thoại Xiaomi Redmi Note 13 pro (8GB - 128GB) hàng chính hãng - Bảo hành 18 tháng",6490000,6790000,300000,4
TIKI,dien-thoai-may-tinh-bang,245770363,"Điện thoại Samsung Galaxy A04e (3GB/32GB) - Hàng chính hãng",2325000,2325000,0,0
TIKI,dien-thoai-may-tinh-bang,247730209,"Điện thoại Samsung Galaxy A34 5G (8GB/128GB) - Hàng chính hãng",7164000,7164000,0,0
TIKI,dien-thoai-may-tinh-bang,249730344,"Điện thoại Masstel IZI 12 4G LTE - 2 Sim 2 Sóng - Pin 1000 mAh - Loa to - Hàng Chính Hãng - Bảo Hành 12 Tháng",456000,456000,0,0
TIKI,dien-thoai-may-tinh-bang,262589811,"Điện thoại Samsung Galaxy A24 (6GB/128GB) - Hàng chính hãng - ĐÃ KÍCH HOẠT BẢO HÀNH ĐIỆN TỬ",6084000,6084000,0,0
TIKI,dien-thoai-may-tinh-bang,215097578,"Điện Thoại Di Động Forme D666 4G - Hàng Chính Hãng",650000,650000,0,0
TIKI,dien-thoai-may-tinh-bang,255866251,"Điện Thoại Samsung A14 4GB/128GB - Hàng Chính Hãng",3429000,4490000,1061000,24
TIKI,dien-thoai-may-tinh-bang,192348147,"Điện thoại Oppo A57 (4GB/64GB) - Hàng chính hãng",4284000,4284000,0,0
TIKI,dien-thoai-may-tinh-bang,273411988,"Điện thoại Xiaomi Redmi 13C (6+128GB) | 6.74" 90Hz| Media Tek Helio G85| 5000mAh - Hàng chính hãng",3028000,3490000,462000,13
TIKI,dien-thoai-may-tinh-bang,273373420,"Điện thoại Xiaomi Redmi 13C (4GB/128GB) - Hàng chính hãng - Bảo hành 18 tháng",2832000,3090000,258000,8
TIKI,dien-thoai-may-tinh-bang,273388474,"Điện thoại chắc chắn Ulefone Power Armor 18T Ultra (chụp ảnh nhiệt Camera FLIR5G 512GB ROM +24GB RAM)- hàng chính hãng",15990000,15990000,0,0
TIKI,dien-thoai-may-tinh-bang,261965186,"Điện Thoại Xiaomi Redmi Note 12S (8GB/256GB) - Hàng Chính Hãng",6132000,6132000,0,0
TIKI,dien-thoai-may-tinh-bang,273244815,"Điện thoại Samsung Galaxy A23 5G 4GB/128GB Đen - Hàng chính hãng",5200000,5990000,790000,13
TIKI,dien-thoai-may-tinh-bang,271290719,"Điện Thoại Cho Người Già Masstel Fami 65 - SOS, Loa To, FM Không Dây, Đọc Số Bằng Giọng Nói, Xem Lịch Âm - HÀNG CHÍNH HÃNG",699000,999000,300000,30
TIKI,dien-thoai-may-tinh-bang,273640492,"Điện Thoại Samsung Galaxy A05 (6GB/128GB) - Hàng Chính Hãng",3237000,3237000,0,0
TIKI,dien-thoai-may-tinh-bang,251772653,"Điện thoại Masstel izi 56 4G (pin trâu-loa chữ to rõ) - Hàng Chính Hãng",687000,687000,0,0
TIKI,dien-thoai-may-tinh-bang,272555368,"XIAOMI 13T 5G (12GB-256GB) - Hàng chính hãng",11385000,11990000,605000,5
TIKI,dien-thoai-may-tinh-bang,217706932,"Combo Máy đọc sách All New Kindle Paperwhite 5 (11th Gen) và Bao da - Hàng nhập khẩu",3980000,3980000,0,0
TIKI,dien-thoai-may-tinh-bang,274019932,"Điện thoại Masstel Izi 56 4G (LTE) Gọi HD Call ,Pin khủng ,loa lớn - Hàng Chính Hãng",548000,650000,102000,16
TIKI,dien-thoai-may-tinh-bang,252073075,"Điện thoại Masstel IZI11 4G - Hàng Chính Hãng",468000,468000,0,0
TIKI,dien-thoai-may-tinh-bang,224873580,"Điện thoại Masstel izi 26 - Hàng chính hãng ",600000,600000,0,0
TIKI,dien-thoai-may-tinh-bang,274639765,"Điện thoại OPPO A2M 5G 6GB/128GB , Dimensity 6020 , Màn 90Hz , Rom tiếng việt - Hàng chính hãng",2990000,3690000,700000,19
TIKI,dien-thoai-may-tinh-bang,153581568,"Điện thoại Masstel IZI 55 4G - Hàng chính hãng",659000,659000,0,0
TIKI,dien-thoai-may-tinh-bang,274544634,"Điện thoại Redmi Note 12R 5G 6/128GB Snapdragon 4 Gen 2, Rom Quốc tế có sẳn Tiếng việt - Hàng nhập khẩu",3050000,3590000,540000,15
TIKI,dien-thoai-may-tinh-bang,274536294,"Máy đọc sách Kindle Paperwhite 5 (16GB) - Hàng chính hãng",4050000,4990000,940000,19
TIKI,dien-thoai-may-tinh-bang,270074304,"Điện Thoại Xiaomi Redmi Note 12S 8GB/256GB - Hàng Chính Hãng",4739000,6690000,1951000,29
TIKI,dien-thoai-may-tinh-bang,270636882,"Điện Thoại Samsung M14 5G 4GB/64GB - Hàng Chính Hãng",2989000,4990000,2001000,40
TIKI,dien-thoai-may-tinh-bang,273664463,"Điện Thoại Oppo A18 4GB/128GB - Hàng Chính Hãng",3499000,3990000,491000,12
TIKI,dien-thoai-may-tinh-bang,249890023,"Điện Thoại Xiaomi Redmi Note 12 Pro 5G 8GB/256GB - Hàng Chính Hãng",7249000,9490000,2241000,24
TIKI,dien-thoai-may-tinh-bang,273016223,"Điện Thoại Xiaomi Redmi A2 2GB/32GB - Hàng Chính Hãng",1729000,2190000,461000,21
TIKI,dien-thoai-may-tinh-bang,273258830,"Điện thoại Samsung Galaxy A05 (4GB/128GB) - Đã kích hoạt bảo hành điện tử -Hàng chính hãng",2590000,3050000,460000,15
TIKI,dien-thoai-may-tinh-bang,247823537,"Điện thoại Realme C55 (6GB/128GB) - Hàng chính hãng",3790000,4990000,1200000,24
TIKI,dien-thoai-may-tinh-bang,262908601,"Máy tính bảng chắc chắn oukitel RT3 (chống nước,chống va đập,Ram 4Gb,Rom 64 Gb,màn hình 8 inch,pin 5150 mAh)- hÀng chính hãng",4990000,4990000,0,0
TIKI,dien-thoai-may-tinh-bang,257861524,"Điện thoại để bàn tân cổ điển phím quay DT11",3500000,3500000,0,0
TIKI,dien-thoai-may-tinh-bang,197214029,"Apple iPhone 14",16490000,24990000,8500000,34
TIKI,dien-thoai-may-tinh-bang,271730109,"Điện thoại chắc chắn Ulefone Armor X13, (Ram 12GB(6Gb+6Gb),Rom 64GB,chống nước,chống va đập IP68/IP69K, Android 13,CPU MediaTek Helio G36 Octa Core,Màn hình 6,52 inch, Mạng: 4G, NFC,OTG)-hàng chính hãng",3990000,3990000,0,0
TIKI,dien-thoai-may-tinh-bang,270978486,"Điện thoại Samsung Galaxy M14 5G (6GB/128GB) - Đã kích hoạt bảo hành điện tử - Hàng chính hãng",3910000,5690000,1780000,31
TIKI,dien-thoai-may-tinh-bang,274101262,"Máy Tính Bảng Samsung Galaxy Tab A9 Plus Wifi 4GB/64GB - Hàng Chính Hãng",3990000,5990000,2000000,33
TIKI,dien-thoai-may-tinh-bang,204671569,"Điện Thoại Oppo A17k 3GB/64GB - Hàng Chính Hãng",2529000,3290000,761000,23
TIKI,dien-thoai-may-tinh-bang,252428990,"Điện thoại Tecno SPARK 10 Pro 8GB/256GB - Helio G88 | 5000 mAh | Sạc nhanh 18W | Cảm ứng vân tay - Hàng chính hãng",4149000,4490000,341000,8
TIKI,dien-thoai-may-tinh-bang,270510406,"Điện thoại Vivo Y36 (8GB/128GB) - Hàng Chính Hãng - Camera 50MP - Sạc Nhanh 44W",5190000,5190000,0,0
TIKI,dien-thoai-may-tinh-bang,263073487,"Điện thoại Tecno CAMON 20 Pro 8GB/256GB - Camera 64MP + 32MP | Helio G99 | 5000 mAh/ 33W | 6.7'' FHD AMOLED - Hàng Chính Hãng - BH 13 Tháng",5490000,5490000,0,0
TIKI,dien-thoai-may-tinh-bang,258330471,"Điện thoại để bàn tân cổ điển phím bấm DT08, Điện thoại nghe gọi được",3500000,3500000,0,0
TIKI,dien-thoai-may-tinh-bang,153581522,"Máy đọc sách All new Paperwhite Gen 5 (11th) màn hình 6.8 inch có đèn vàng warmlight",3690000,3800000,110000,3
TIKI,dien-thoai-may-tinh-bang,270707514,"Máy Đọc Sách BOOX Tab Mini C - Hàng Chính Hãng",11850000,12990000,1140000,9
TIKI,dien-thoai-may-tinh-bang,271218081,"Máy đọc sách Kindle Oasis Edition 3 (8GB) - Hàng chính hãng",6500000,7690000,1190000,15
TIKI,dien-thoai-may-tinh-bang,270832077,"Điện thoại Xiaomi Redmi 12 (4GB-128GB) - Hàng Chính Hãng",3890000,3890000,0,0
TIKI,dien-thoai-may-tinh-bang,242434782,"Máy đọc sách New Kindle 11th 2022 (16GB) - Hàng nhập khẩu",2920000,2920000,0,0
TIKI,dien-thoai-may-tinh-bang,274116886,"Điện Thoại Xiaomi Redmi A2+ 3GB/64GB - Hàng Chính Hãng",1989000,2790000,801000,29
TIKI,dien-thoai-may-tinh-bang,273942001,"Điện thoại Xiaomi Redmi Note 13 (6GB/128GB) - Hàng chính hãng",4090000,4490000,400000,9
TIKI,dien-thoai-may-tinh-bang,274392442,"Điện thoại Oppo A38 - Hàng chính hãng",4490000,4490000,0,0
TIKI,dien-thoai-may-tinh-bang,191689878,"Điện thoại OPPO CPH2387 - A57 Xanh - Hàng Chính Hãng",4632000,4632000,0,0
TIKI,dien-thoai-may-tinh-bang,121059239,"Máy Tính Bảng Samsung Galaxy Tab A7 Lite T225 3GB/32GB - Hàng Chính Hãng",3587000,3587000,0,0
TIKI,dien-thoai-may-tinh-bang,273127929,"Điện thoại Xiaomi 13T 12GB-256GB - Hàng Chính Hãng",12990000,12990000,0,0
TIKI,dien-thoai-may-tinh-bang,262514707,"Điện thoại Xiaomi Redmi Note 12 Pro (8GB/256GB) - Hàng chính hãng",7990000,7990000,0,0
TIKI,dien-thoai-may-tinh-bang,273366296,"ulefone Armor 24 (TIÊU CHUẨN MIL-STD-810H ,IP69K, chống nước ,chống sốc,pin 22000mah , màn hình6,78 inch, NFC, Ram24GB(12Gb+12Gb),rom 256GB)-hàng chính hãng ",7990000,7990000,0,0
TIKI,nha-cua-doi-song,73639522,"Miếng lau nhà thay thế Cây lau nhà KITIMOP-RED ( 38 x 12cm)",15000,19000,4000,21
TIKI,nha-cua-doi-song,169208973,"Bộ 3 Hộp Nhựa đựng Thực Phẩm Chữ Nhật Hokkaido Inochi 500 -1000 -2000 ML Chịu Nhiệt Giao Màu Ngẫu Nhiên",77000,198000,121000,61
TIKI,nha-cua-doi-song,59163919,"Túi Đựng Chăn Màn (Được Chọn Màu) - Hộp Đựng Quần Áo Khung Sắt Gấp Gọn - Tủ Vải Chăn Màn Tiện Lợi",84000,130000,46000,35
TIKI,nha-cua-doi-song,21326864,"Decal giấy dán tường kệ xương rồng  HM71007",49000,94000,45000,48
TIKI,nha-cua-doi-song,87118108,"Decal dán kính mờ - có keo sẵn khổ rộng 1,2m dài 3m",116000,116000,0,0
TIKI,nha-cua-doi-song,6641279,"Đồng hồ báo thức cảm biến phát sáng trong đêm",78900,78900,0,0
TIKI,nha-cua-doi-song,112321653,"Thảm lau chân nhà tắm siêu thấm cao cấp chất liệu sợi lông cừu dày mềm mại - Hàng nhập khẩu",89000,89000,0,0
TIKI,nha-cua-doi-song,214614554,"Dụng cụ thông tắc bồn cầu, cống bằng khí nén áp lực",201000,210000,9000,4
TIKI,nha-cua-doi-song,43759208,"Đèn Ngủ Quả Cầu Mây - Đèn Ngủ Trang Trí Led Blackinner (đế xếp) Có Điều Chỉnh Độ Sáng - Hàng chính hãng",129000,246000,117000,48
TIKI,nha-cua-doi-song,11858785,"2kg Than không khói, than nướng sạch không khói BBQ",37000,37000,0,0
TIKI,nha-cua-doi-song,136117748,"Táp đầu giường gỗ, tủ đầu giường, tủ để đồ đầu giường",115998,115998,0,0
TIKI,nha-cua-doi-song,158646229,"Dụng cụ cắt gạch thông minh - Dao cắt gạch men và kính đa năng ốp lát gạch nền xây dựng chuẩn công ty",159000,159000,0,0
TIKI,nha-cua-doi-song,188196590,"Nạo, Gọt Vỏ Hoa Củ Quả Inox 304 Cán Gỗ Cao Cấp Jodily StarHome",55000,55000,0,0
TIKI,nha-cua-doi-song,184833497,"Pin sạc 3.7V 18650 Dung Lượng Cao 9800mAh Cho Sạc Dự Phòng, Đèn Pin, Quạt Mini, Đồ Chơi",58000,58000,0,0
TIKI,nha-cua-doi-song,46211207,"Bộ Drap Thun Lạnh Hàn Quốc ( 4 món } màu xám đẳng cấp",159000,159000,0,0
TIKI,nha-cua-doi-song,144532704,"[HÀNG CHÍNH HÃNG]Kéo nhà bếp đa sắc màu dài 25cm, lưỡi kéo dài 14cm bằng thép không gỉ của GGOMi Hàn Quốc GG173",62560,68000,5440,8
TIKI,nha-cua-doi-song,173972990,"Bộ 3 hộp tròn 400ml đựng cơm kèm túi hộp thủy tinh chịu nhiệt cường lực COBA'COOK- XẢ KHO",196000,339000,143000,42
TIKI,nha-cua-doi-song,204768319,"Kìm bấm cúc áo kèm túi 100 cúc",45000,45000,0,0
TIKI,nha-cua-doi-song,104557047,"   Ổ cắm Điện Quang ĐQ ESK 5W.SM750SL (5 lỗ 3 chấu dây 5 mét màu Trắng Đỏ)",202000,202000,0,0
TIKI,nha-cua-doi-song,192120961,"Túi Zip Lụa Nhựa CPE Trong Mờ Có Khóa Kéo Đa Năng",41000,41000,0,0
TIKI,nha-cua-doi-song,186654717,"Combo 4 Miếng Dán Treo Kệ, Rổ, Miếng Treo Dành Cho Hộp Giấy Ecoco",24000,24000,0,0
TIKI,nha-cua-doi-song,186557908,"Túi 100 Dây Rút, Lạt Nhựa (Trắng/Đen) Siêu Bền Để Làm Vườn, Thi Công Tiện Lợi",25000,25000,0,0
TIKI,nha-cua-doi-song,155287344,"Hộp Đựng Trứng Hai Tầng 32 Ô Tiện Dụng Tích Hợp Khay Trượt Đựng Trứng gà Phong Cách Nhật Bản",56000,60000,4000,7
TIKI,nha-cua-doi-song,196675194,"Đệm Ngồi 3D Silicon 2 Lớp Tổ Ong Lót Ghế Thoáng Khí Chống Đau Mỏi Lưng Amalife ",107700,107700,0,0
TIKI,nha-cua-doi-song,69240971,"Ổ khóa cao cấp Toplex, chống cắt tròn, size 40mm",80000,80000,0,0
TIKI,nha-cua-doi-song,193723418,"Lót Ly Siêu Thấm Diatom Mud Họa Tiết Gạch Terrazzo",39000,39000,0,0
TIKI,nha-cua-doi-song,171507665,"Đèn bắt muỗi, ruồi và các loại công trùng cao cấp 2022 SeaSy SS69 – Máy bắt muỗi kiêm đèn Led ngủ thông minh, chống lóa mắt, an toàn, dễ dàng sử dụng, thân thiện với môi trường - Hàng chính hãng",299000,437000,138000,32
TIKI,nha-cua-doi-song,71489738,"1000ml - Bình xịt sơn chống thấm trần nhà Bixuan dung tích lớn, sơn chống thấm chống dột tường công nghệ Thụy Sĩ",79000,79000,0,0
TIKI,nha-cua-doi-song,32729258,"Gói 1+1 Cây lăn bụi lớn Scotch Brite 3M XA010909407",119000,119000,0,0
TIKI,nha-cua-doi-song,69182343,"Bộ Hộp Cơm Giữ Nhiệt Thủy Tinh Văn Phòng Cao Cấp - Kèm Túi Xách giữ nhiệt hình cá ( mầu sắc ngẫu nhiên)",125000,125000,0,0
TIKI,nha-cua-doi-song,1325531,"Combo 10 Cặp Nút Tai Chống Ồn 3M 1100 - Cam, Nút bịt tai chống ồn khi đi máy bay, làm việc trong xưởng in, ôn thi",60000,60000,0,0
TIKI,nha-cua-doi-song,141825121,"Chai thông tắc đường ống, lavabo, bồn rửa bát Daichi Nhật Bản",59000,59000,0,0
TIKI,nha-cua-doi-song,107443884,"Combo 05 Khăn Nhà Bếp Lau Tay - Lau Chén Dĩa Đa Chức Năng",17885,17885,0,0
TIKI,nha-cua-doi-song,68354418,"LỒNG BÀN GIỮ NHIỆT DELISH GIỮ MÓN ĂN NÓNG HỔI, THƠM NGON",98999,98999,0,0
TIKI,nha-cua-doi-song,104269645,"Giấy thơm quần áo Aroma hương sen dùng cho máy giặt khô LG styler",260000,260000,0,0
TIKI,nha-cua-doi-song,11097788,"Ổ cắm công suất lớn Điện Quang ĐQ ESKHP 3RB 5M (3 lỗ, màu đỏ đen, dây dài 5m)",200560,250700,50140,20
TIKI,nha-cua-doi-song,144868820,"Hương nhang Quế Dương Minh nhang sạch 100% thành phần organic nhang thơm tự nhiên không hóa chất nhang cây an toàn",98000,180000,82000,46
TIKI,nha-cua-doi-song,183719122,"GỐI CHỮ U CAO SU NON - GỐI KÊ CỔ DU LỊCH, NGỦ TRƯA HOẠ TIẾT SỌC TRƠN",139000,139000,0,0
TIKI,nha-cua-doi-song,16363204,"Cân Điện Tử Cầm Tay Thép Ngang PT153 – Cân Điện Tử Mini Dạng Treo Nhỏ Gọn Tiện Lợi",129000,129000,0,0
TIKI,nha-cua-doi-song,52676101,"Bộ Combo 100 Túi Lọc Rác Siêu Tiên Ích Cho Bồn Rửa Bát",13999,13999,0,0
TIKI,dien-thoai-may-tinh-bang,168320000,"Điện Thoại Xiaomi Redmi 9A (2GB/32GB)- Đã kích hoạt bảo hành điện tử- Hàng Chính Hãng - Granite Gray",2088000,2088000,0,0
TIKI,dien-thoai-may-tinh-bang,190701486,"Điện Thoại OPPO A57 (4GB/64GB) - Hàng Chính Hãng",4284000,4284000,0,0
TIKI,dien-thoai-may-tinh-bang,251275686,"Điện thoại OPPO A57 4GB/128GB Vàng - Hàng chính hãng",4632000,4632000,0,0
TIKI,dien-thoai-may-tinh-bang,273636845,"Điện Thoại Samsung Galaxy A05 (4GB/64GB) - Hàng Chính Hãng",3025000,3025000,0,0
TIKI,dien-thoai-may-tinh-bang,186149961,"Máy tính bảng Samsung Galaxy Tab A7 Lite 32GB Xám - Hàng Chính Hãng",3587000,3587000,0,0
TIKI,dien-thoai-may-tinh-bang,247016383,"Điện Thoại Xiaomi Redmi 12C 4GB/64GB - Hàng Chính Hãng",3168000,3168000,0,0
TIKI,dien-thoai-may-tinh-bang,271234577,"Điện Thoại Nokia 105 4G Pro - Hàng Chính Hãng",669000,680000,11000,2
TIKI,dien-thoai-may-tinh-bang,270736028,"Điện thoại Samsung Galaxy Z Fold 5 - Hàng chính hãng",29990000,44990000,15000000,33
TIKI,dien-thoai-may-tinh-bang,253443951,"Điện Thoại Samsung Galaxy M14 5G (6GB/128GB) - Hàng Chính Hãng",5292000,5292000,0,0
TIKI,dien-thoai-may-tinh-bang,190544267,"Điện Thoại Oppo A57 4GB/64GB - Hàng Chính Hãng",4284000,4284000,0,0
TIKI,dien-thoai-may-tinh-bang,249730339,"Điện Thoại Masstel IZI 55 4G LTE - 2 Sim 2 Sóng - Pin 1800 mAh - Hàng Chính Hãng - Bảo Hành 12 Tháng",659000,659000,0,0
TIKI,dien-thoai-may-tinh-bang,188948039,"Máy tính bảng Samsung Galaxy Tab A8 64GB Xám (2022) - Hàng Chính Hãng",5856000,5856000,0,0
TIKI,dien-thoai-may-tinh-bang,91836155,"Điện Thoại  Dành Cho Người Già Masstel Fami 12 Phiên bản mới hỗ trợ đèn Pin siêu sáng- Hàng Chính Hãng - Màu đen",630000,630000,0,0
TIKI,dien-thoai-may-tinh-bang,273232944,"Máy tính bảng Masstel Tab 10.4 - Hàng chính hãng",4990000,4990000,0,0
TIKI,dien-thoai-may-tinh-bang,217158870,"Máy tính bảng Samsung Galaxy Tab A8 (4GB/64GB) - Hàng Chính Hãng",5856000,5856000,0,0
TIKI,dien-thoai-may-tinh-bang,249156531,"Điện thoại Realme C55 6GB/128GB Vàng nắng mai - Hàng chính hãng",4680000,4990000,310000,6
TIKI,dien-thoai-may-tinh-bang,164697930,"Máy tính bảng Samsung Galaxy Tab A8  (2022) - Hàng chính hãng - ĐÃ KÍCH HOẠT BẢO HÀNH ĐIỆN TỬ",5856000,5856000,0,0
TIKI,dien-thoai-may-tinh-bang,272270730,"Điện thoại Samsung Galaxy A05 (4GB/128GB) - Hàng chính hãng",2650000,3099000,449000,14
TIKI,dien-thoai-may-tinh-bang,274639670,"Điện thoại Realme V30T 4GB/128GB Dimensity 700 - Rom tiếng việt - Hàng nhập khẩu",2650000,3590000,940000,26
TIKI,dien-thoai-may-tinh-bang,274361820,"Máy Tính Bảng Học Tập Smart Study 1, Hàng Chính Hãng, Cho Trẻ Từ 5-12 Tuổi, 64GB, Tích Hợp Chương Trình Học Tập Toàn Diện",7900000,7900000,0,0
TIKI,dien-thoai-may-tinh-bang,198858451,"Điện thoại Samsung Galaxy A04s (4GB/64GB) - Hàng chính hãng",3990000,3990000,0,0
TIKI,dien-thoai-may-tinh-bang,244303202,"Điện Thoại Samsung A14 4GB/128GB - Hàng Chính Hãng",3349000,4490000,1141000,25
TIKI,dien-thoai-may-tinh-bang,220670303,"Yealink W73P - Điện thoại IP cầm tay không dây DECT - Hàng Chính Hãng - Điện thoại IP mẹ bồng con",2800000,2800000,0,0
TIKI,dien-thoai-may-tinh-bang,273438724,"Điện Thoại Samsung A05s 4GB/128GB , Snapdragon 680 , Sạc nhanh 25W - Hàng Chính Hãng",3204000,3990000,786000,20
TIKI,dien-thoai-may-tinh-bang,260406257,"Điện thoại oukitel wp23 ( chống nước,chống va đập,pin 10600mAh,Ram 4Gb.Rom 64Gb,màn hình 6.52 inch,mạng 2,3,4G,Android 13 )-hàng chính hãng",3990000,3990000,0,0
TIKI,dien-thoai-may-tinh-bang,230157205,"Điện thoại Xiaomi Redmi Note 10T 5G 4GB/64GB - Màn 90HZ - Chống Nước IP68 - Hàng Nhập Khẩu - Bản quốc tế",2420000,4190000,1770000,42
TIKI,dien-thoai-may-tinh-bang,263438199,"Máy tính bảng Edutab 10.1 Pro & Case da tặng Hệ thống quản lý học tập & kiểm soát dành cho Phụ huynh trọn đời",4989000,4989000,0,0
TIKI,dien-thoai-may-tinh-bang,212040697,"Điện Thoại Samsung Galaxy A04 (3GB/32GB) - Hàng Chính Hãng - Đã kích hoạt bảo hành điện tử",2130000,2990000,860000,29
TIKI,dien-thoai-may-tinh-bang,274516951,"Điện thoại Masstel izi 16 4G(LTE) , Bàn phím nổi, FM không dây - Hàng chính hãng",420000,499000,79000,16
TIKI,dien-thoai-may-tinh-bang,262516014,"Điện Thoại Samsung Galaxy A34 5G - Hàng Chính Hãng",7164000,7164000,0,0
TIKI,dien-thoai-may-tinh-bang,274410237,"Điện thoại người già IPRO F183 4G , Gọi HD Call , Có SOS , 2 sim 2 sóng - Hàng chính hãng",338000,450000,112000,25
TIKI,dien-thoai-may-tinh-bang,248235765,"Điện Thoại Masstel iZi 26 4G - Hàng Chính Hãng",589000,640000,51000,8
TIKI,dien-thoai-may-tinh-bang,258787119,"Máy tính bảng OUKITEL RT2 chắc chắn (chống nước,chống va đập ,pin xài lâu,Pin  20.000Mah, Màn hình  10,1 inch,Ram 8GB,Rom  128 GB, lõi tám nhân,Máy ảnh 16MP,Android 12,sạc nhanh 33W)- hàng chính hãng",8990000,8990000,0,0
TIKI,dien-thoai-may-tinh-bang,220678495,"Điện thoại bàn DECT không dây Yealink W73H có chân đế - Hàng chính hãng",2200000,2200000,0,0
TIKI,dien-thoai-may-tinh-bang,198868735,"Điện thoại IP Grandstream GRP 2601 hàng chính hãng",880000,880000,0,0
TIKI,dien-thoai-may-tinh-bang,274507025,"Điện thoại Realme V50 5G 6GB/128GB ,CPU Dimensity 6100+ , Màn 120HZ , Rom Quốc tế có tiếng việt - Hàng nhập khẩu",3199000,3990000,791000,20
TIKI,dien-thoai-may-tinh-bang,258667842,"Điện thoại Xiaomi Redmi Note 12 Pro 4G (8GB/256GB) - Hàng chính hãng",7990000,7990000,0,0
TIKI,dien-thoai-may-tinh-bang,271798615,"Điện thoại thông minh siêu bền Oukitel WP28 (màn hình 6.52‘' ,HD+ ,pin 10600mAh ,Ram 15Gb(8GB+7Gb),Rom 256GB ,Android13, camera 48MP)-hàng chính hãng",4990000,4990000,0,0
TIKI,dien-thoai-may-tinh-bang,248185228,"Điện Thoại Masstel Lux 10 4G - Hàng Chính Hãng",675000,675000,0,0
TIKI,dien-thoai-may-tinh-bang,273359059,"Điện Thoại Chắc Chắn OUKITEL WP23 PRO ( Ram 16Gb(8GB+8Gb),Rom 128GB ,Android13, Pin 10600mAh,Màn hình 6.52 "HD + ,13MP camera Sau,chống nước,chống va đập)-hàng chính hãng",4990000,4990000,0,0
TIKI,dien-thoai-may-tinh-bang,270471106,"Điện Thoại Nokia 105 4G Pro TA-1538 - Hàng Chính Hãng",630000,680000,50000,7
TIKI,dien-thoai-may-tinh-bang,248704404,"Điện Thoại Samsung Galaxy A14 (4GB/128GB) - Hàng Chính Hãng",3672000,3672000,0,0
TIKI,dien-thoai-may-tinh-bang,65091422,"Điện thoại Oukitel WP6 (Chống va đập,chống nước,Ram 6Gb,Rom 128Gb,pin 8.000mAh) hàng chính hãng",6990000,6990000,0,0
TIKI,dien-thoai-may-tinh-bang,212261734,"Điện thoại Masstel Play 10 4G Thiết kế hầm hố,Khung viền kim loại - Hàng chính hãng",558000,799000,241000,30
TIKI,dien-thoai-may-tinh-bang,271966786,"iPhone 15",19490000,21490000,2000000,9
TIKI,dien-thoai-may-tinh-bang,272909668,"[Mới] Điện thoại vivo V29e 5G (8GB/256GB) - Hàng Chính Hãng - Camera Selfie 50 MP - Vòng Sáng Aura 2.0 - Màn hình AMOLED 6.67",8690000,8990000,300000,3
TIKI,dien-thoai-may-tinh-bang,274166857,"Điện thoại Samsung Galaxy S23 FE (8GB/128GB) - Hàng chính hãng",14890000,14890000,0,0
TIKI,dien-thoai-may-tinh-bang,274316885,"Điện Thoại Xiaomi POCO X6 5G 8GB-256GB - Hàng chính hãng",7510000,9990000,2480000,25
TIKI,dien-thoai-may-tinh-bang,271494404,"Điện thoại Tecno POVA 5 (8GB+8GB/128GB) RAM mở rộng 16GB | Pin 6000 mAh | Màn 120Hz - Sạc nhanh 45W - Hàng Chính Hãng",3799000,4490000,691000,15
TIKI,dien-thoai-may-tinh-bang,273373436,"Điện thoại Xiaomi Redmi 13C (6GB/128GB) - Hàng chính hãng - Bảo hành 18 tháng",3028000,3490000,462000,13
TIKI,dien-thoai-may-tinh-bang,273774937,"Điện thoại Samsung Galaxy A15 (8GB/128GB) - Hàng chính hãng - Đã kích hoạt bảo hành điện tử",4455000,4990000,535000,11
TIKI,dien-thoai-may-tinh-bang,271118390,"Điện thoại OPPO Reno10 5G (8GB/256GB) - Hàng Chính Hãng",9190000,10990000,1800000,16
TIKI,dien-thoai-may-tinh-bang,261946899,"Điện Thoại Samsung Galaxy A14 (6GB/128GB) - Hàng Chính Hãng",3999000,4990000,991000,20
TIKI,dien-thoai-may-tinh-bang,274498288,"Điện Thoại Samsung Galaxy A35 5G (8GB/128GB)- Hàng Chính Hãng",7890000,8290000,400000,5
TIKI,dien-thoai-may-tinh-bang,271982547,"Điện thoại Oukitel  WP12 Pro (chống nước,chống va đập,RAM 8GB(Ram 4GB+ 4Gb),Rom 64 Gb,8 nhân)- hÀng chính hãng",3990000,3990000,0,0
TIKI,dien-thoai-may-tinh-bang,272348047,"Điện Thoại Samsung A05s 4GB/128GB - Hàng Chính Hãng",3239000,3990000,751000,19
TIKI,dien-thoai-may-tinh-bang,274059475,"Điện Thoại Samsung Galaxy S24 Ultra (12GB/256GB) - Hàng Chính Hãng",33990000,33990000,0,0
TIKI,dien-thoai-may-tinh-bang,273430216,"Điện thoại Ulefone Armor 13 (pin khủng,pin 13.200mAh, Ram 8Gb,Rom 256Gb,chống sốc,chống va đập,nội soi,tia hồng ngoại,tia lade,loa to,học online)- hàng chính hãng",7990000,7990000,0,0
TIKI,dien-thoai-may-tinh-bang,274542883,"Điện Thoại Samsung A35 5G 8GB/128GB - Hàng Chính Hãng",7369000,8290000,921000,11
TIKI,dien-thoai-may-tinh-bang,25949745,"Máy Đọc Sách Kindle Oasis (10th Gen) 2019- 8GB - Hàng Chính Hãng",6043100,6790000,746900,11
TIKI,dien-thoai-may-tinh-bang,263073555,"Điện thoại Tecno CAMON 20 8GB/256GB - Camera 64MP + 32MP | 5000 mAh | Sạc nhanh 33W | 6.7'' FHD AMOLED - BH 13 Tháng - Hàng Chính Hãng",4990000,4990000,0,0
TIKI,dien-thoai-may-tinh-bang,263274580,"Điện thoại Samsung Galaxy M14 5G (4GB/64GB) - Hàng chính hãng - Đã kích hoạt bảo hành điện tử",2750000,3990000,1240000,31
TIKI,dien-thoai-may-tinh-bang,273958512,"Điện thoại Xiaomi Redmi Note 13 (6GB/128GB) - Hàng chính hãng",4890000,4890000,0,0
TIKI,dien-thoai-may-tinh-bang,209927605,"Combo máy đọc sách Kindle 2022 (11th) tặng kèm bao da ( Cover ) - Hàng nhập khẩu",3100000,3100000,0,0
TIKI,dien-thoai-may-tinh-bang,272222033,"Máy đọc sách Boox Palma - Hàng Chính Hãng",7200000,8590000,1390000,16
TIKI,dien-thoai-may-tinh-bang,273252926,"Điện Thoại Oppo A18 (4GB/128GB) - Hàng Chính Hãng",3390000,3990000,600000,15
TIKI,dien-thoai-may-tinh-bang,274179544,"Điện thoại Realme C51 (6GB/256GB) - Hàng Chính Hãng",3390000,4190000,800000,19
TIKI,dien-thoai-may-tinh-bang,52480318,"Điện thoại bàn cổ điển DT115",2500000,2500000,0,0
TIKI,dien-thoai-may-tinh-bang,273897523,"Điện thoại Tecno SPARK 20 (8+8)GB/128GB - Helio G85 | 5000 mAh | Sạc nhanh 18W | Hàng Chính Hãng",3390000,3490000,100000,3
TIKI,dien-thoai-may-tinh-bang,273378164,"Điện thoại Xiaomi Redmi 13C (6GB/128GB) - Hàng chính hãng - Đã kích hoạt bảo hành điện tử",2960100,3490000,529900,15
TIKI,dien-thoai-may-tinh-bang,217640502,"Máy đọc sách Kindle Scribe - Hàng chính hãng",12590000,12590000,0,0
TIKI,dien-thoai-may-tinh-bang,271134741,"Điện thoại Samsung Galaxy Z Flip5 (8GB/512GB) - Hàng chính hãng",17639000,29990000,12351000,41
TIKI,dien-thoai-may-tinh-bang,273718967,"Điện Thoại Samsung A15 8GB/128GB - Hàng Chính Hãng",4349000,4990000,641000,13
TIKI,dien-thoai-may-tinh-bang,271128271,"Điện Thoại Oppo A58 6GB/128GB - Hàng Chính Hãng",4349000,4990000,641000,13
TIKI,dien-thoai-may-tinh-bang,257682739,"Điện thoại Samsung Galaxy A04 (3GB/32GB) - Đã kích hoạt bảo hành điện tử -  Hàng chính hãng",1999000,2990000,991000,33
TIKI,dien-thoai-may-tinh-bang,52002453,"Cisco Unified IP Phone 7962G - Hàng chính hãng",4900000,4900000,0,0
TIKI,dien-thoai-may-tinh-bang,274164078,"Máy tính bảng Samsung Galaxy Tab A9 WIFI 4GB-64GB- Hàng chính hãng",3210000,3990000,780000,20
TIKI,dien-thoai-may-tinh-bang,273553649,"Điện thoại Oppo A18 - Hàng chính hãng",3499000,3690000,191000,5
TIKI,dien-thoai-may-tinh-bang,248799307,"Điện thoại Xiaomi 13 Lite (8GB/256GB) - Hàng chính hãng",11490000,11490000,0,0
TIKI,dien-thoai-may-tinh-bang,274375122,"Điện thoại Xiaomi Redmi Note 13 Pro 4G (8GB/128GB) - Hàng chính hãng",6489000,7290000,801000,11
TIKI,nha-cua-doi-song,67262282,"Túi Hút Chân Không Thực Phẩm Hai Mặt Trơn (1kg)",89000,89000,0,0
TIKI,nha-cua-doi-song,205801715,"[HCM - Nhận đặt hàng theo yêu cầu] [Euro Style] Kệ trang trí chân sắt màu Đen, gỗ nguyên tấm chắc chắn. Kệ trang trí đẹp, sang trọng, mang phong cách cổ điển Bắc Âu. Sản phẩm cao cấp, đạt tiêu chuẩn Hàn Quốc",310000,310000,0,0
TIKI,nha-cua-doi-song,54583763,"Đèn bàn học Rạng Đông chính hãng RD RL 38 LED",189000,189000,0,0
TIKI,nha-cua-doi-song,197850024,"Áo Mưa Trong Suốt Dáng Dài Vành Rộng Có Khóa Kéo - Áo Mưa Trong Suốt",145000,145000,0,0
TIKI,nha-cua-doi-song,73617595,"Ống Đựng Đũa Inox 304 Treo Tường Cao Cấp Chính Hãng GAGI Mã GD01 Không Gỉ Sét, Có Thể Để Bàn (2 in 1)",282000,304000,22000,7
TIKI,nha-cua-doi-song,90185010," Tấm gỗ thông mặt rộng 20cm x dày 2cm x dài 1m2 + láng nhẵn mịn 4 mặt",95000,95000,0,0
TIKI,nha-cua-doi-song,115543256,"Bình Giữ Nhiệt Lock&Lock Feather Light LHC4131 (450ml) - Hàng Chính Hãng, Bằng Thép Không Gỉ, Có Lưới Lọc Trà, Trọng Lượng Nhẹ Hoàn Hảo, Giữ Nóng Và Giữ Lạnh Tốt - Tặng Kèm Ống Hút Và Cọ Rửa Ống Hút",319000,578000,259000,45
TIKI,nha-cua-doi-song,58990518,"Hộp đựng giấy nhà vệ sinh kèm kệ để đồ thông minh giao màu ngẫu nhiên",68000,68000,0,0
TIKI,nha-cua-doi-song,56537855,"Bộ dụng cụ sửa chữa đa năng chính hãng HAKAWA HK-850",1490000,2490000,1000000,40
TIKI,nha-cua-doi-song,66948895,"Kệ Dán Tường Nhà Tắm  Hình Vuông Bằng Sắt Đa Năng, Chắc Chắn",16000,18899,2899,15
TIKI,nha-cua-doi-song,105812707,"Thảm Lông 1m2 x 1m6, 1m6 x 2m, 1m6 x 2m3 Trải Sàn Sang Trọng, Hiện Đại cho Phòng Khách, Ngủ, Chụp Hình và Các Sự Kiện",149000,149000,0,0
TIKI,nha-cua-doi-song,99211523,"Nồi inox FiveStar Standard 3 đáy sandwich bếp từ nắp kính tặng 1 muỗng canh ( 16cm / 18cm / 20cm / 24cm )",189000,189000,0,0
TIKI,nha-cua-doi-song,184318192,"Ly Giữ Nhiệt Matte 3 Lớp INOX304 900ml - Tặng Kèm Túi và Ống Hút",239000,239000,0,0
TIKI,nha-cua-doi-song,43605340,"Giấy dán kính một chiều chống nhìn cho cửa - giấy decal dán kính phản quang",77000,77000,0,0
TIKI,nha-cua-doi-song,149758085,"Dụng cụ bơm hút rượu xăng dầu chất lỏng bóp tay - ống hút xăng dầu chất lỏng bóp tay, dụng để hút RƯỢU, NƯỚC BỂ CÁ",16000,22997,6997,30
TIKI,nha-cua-doi-song,53643460,"Bộ quần áo mưa nam nữ cao cấp",238000,238000,0,0
TIKI,nha-cua-doi-song,113005302,"Bình Pha Trà, Cafe Thủy Tinh Cao Cáp Có Lõi Lọc Inox Chống Rỉ , Bình Giữ Nhiệt, Chịu Nhiệt 450/550ml Tiện Lợi Phong Cách Mang Đi Học, Đi Làm, Đi Chơi, Trải Nghiệm Uống Trà Hoàn Toàn Mới",373500,373500,0,0
TIKI,nha-cua-doi-song,194818369,"Hộp Đựng Trang Sức Mini Cho Nữ, Đựng Vòng Cổ Nhẫn Bông Tai Hộp Đựng Đồ Trang Sức Có Khóa Kéo",76000,76000,0,0
TIKI,nha-cua-doi-song,106280895,"Bộ 6 Ly Thuỷ Tinh Cao Luminarc Islande 290ml - LUISD6293",146000,190000,44000,23
TIKI,nha-cua-doi-song,184858864,"Bình giữ nhiệt inox 304 có lõi lọc pha trà  giữ nhiệt 24h - 48h - YOGA QG ,  dây xách tiện lợi , bình nước giữ nhiệt cute nắp titan , dung tích 650ml- 800ml - 1000ml - 1300ml - 1500ml - Hàng chính hãng",170000,185000,15000,8
TIKI,nha-cua-doi-song,76254098,"Ruột Chăn Hè Thu Lidaco Chần Bông Bông Trắng Tinh Khiết Kích Thước 2mx2,2m",209000,280000,71000,25
TIKI,nha-cua-doi-song,157537059,"Thảm chống trơn trượt nhà tắm size 30x30cm tiện dụng, Tấm thảm nhựa lót sàn nhà tắm kháng khuẩn chống trượt",7000,7798,798,10
TIKI,nha-cua-doi-song,127743951,"Thanh vắt khăn nhà tắm OENON, Giá treo dép phòng tắm dán tường gạch men chất liệu nhựa ABS - OE48",139000,250000,111000,44
TIKI,nha-cua-doi-song,76070067,"Giá Để Đồ Nhà Tắm OENON, Kệ treo máy sấy tóc chất liệu nhựa ABS cao cấp lắp đặt dán tường - OE039",145000,280000,135000,48
TIKI,nha-cua-doi-song,66672429,"Bộ 2 móc dán tường treo chổi, cây lau nhà, móc treo tường tiện lợi, Giao màu ngẫu nhiên",10500,10500,0,0
TIKI,nha-cua-doi-song,148873333,"Sạc Thông Minh K65 3.7V 4.2V Sạc Các Loại Pin 14500, 18650 (Sạc tự ngắt, có đèn báo, không kèm pin)",99000,99000,0,0
TIKI,nha-cua-doi-song,75440160,"Móc dán tường chịu lực",700,1000,300,30
TIKI,nha-cua-doi-song,4935951,"Kéo cắt cưa cành trên cao thép SK5 Nhật",146000,146000,0,0
TIKI,nha-cua-doi-song,50485162,"Công tắc điều khiển từ xa 100m/3000W/220v bật tắt thiết bị điện từ xa-remote học lệnh, công tắc xuyên tường 100m",87000,87000,0,0
TIKI,nha-cua-doi-song,72621937,"Combo 3 tấm gỗ thông mới đẹp dài 50cm, rộng 14cm, dày 1.5cm thích hợp làm kệ treo, kệ ốp tường, trang trí, decorde",55000,55000,0,0
TIKI,nha-cua-doi-song,51461576,"Thùng rác đạp chữ nhật Hiro 10L",99000,99000,0,0
TIKI,nha-cua-doi-song,112020406,"Bàn Chải Cọ Lưng Chà Lưng Khi Tắm Cao Cấp Nhật Bản Có Hộp",24999,24999,0,0
TIKI,nha-cua-doi-song,174502547,"[CHÍNH HÃNG ABLUE] Ghế Curble Comfy chỉnh dáng ngồi đúng, chống gù. Hàn Quốc (Made in Korea). Màu Đen/ Xám trắng / Đỏ / Xanh dương",616420,629000,12580,2
TIKI,nha-cua-doi-song,99338532,"LƯỚI VÕNG DUY LỢI MỀM MỊN NẰM ÊM",429000,429000,0,0
TIKI,nha-cua-doi-song,73743740,"Combo 6 tấm lót bàn ăn cao cấp chịu nhiệt, chống thấm, chống trượt giúp trang trí bàn ăn sang trọng như khách sạn 5 sao - Hàng chính hãng",155100,165000,9900,6
TIKI,nha-cua-doi-song,106563599,"Bóng đèn PHILIPS LED Bright E27-Công suất (9W, 11W, 13W, 15W, 17W) ánh sáng vàng, ánh sáng trắng",64600,66600,2000,3
TIKI,nha-cua-doi-song,43808661,"Bồ đoàn (đệm) ngồi thiền vỏ đậu xanh The Yogis'Shop | Đường kính 25cm - 30cm",195000,195000,0,0
TIKI,nha-cua-doi-song,73100258,"Kệ Nhà Tắm OENON Cao Cấp lắp đặt Dán Tường, Kệ để đồ phòng tắm cao cấp ",175000,350000,175000,50
TIKI,nha-cua-doi-song,23096307,"Bình chữa cháy bột ABC MFZL4-4kg",225000,380000,155000,41
TIKI,nha-cua-doi-song,153027290,"Vỏ Bọc, Áo Trùm Máy Giặt Cửa Ngang ( Vải Dù Siêu Bền Chống Mưa Nắng )",179000,179000,0,0
TIKI,nha-cua-doi-song,99211918,"Nắp kính cường lực Fivestar dùng cho nồi -chảo-quánh-bộ nồi xửng(16 cm /18cm /20cm/ 22cm/24cm / 26cm / 28cm/ 30cm/ 32cm)",59000,59000,0,0
TIKI,nha-cua-doi-song,10914085,"Ổ cắm Điện Quang ĐQ 001A-02-2M (2 lỗ dây 2 mét)",78400,98000,19600,20
TIKI,nha-cua-doi-song,50231438,"Bộ 3 túi giặt dây rút túi vải lưới giặt đồ thông minh tiện lợi",69000,69000,0,0
TIKI,nha-cua-doi-song,20933262,"Đèn pin sạc Kennedeled  KN-4110 (Giao màu ngẫu nhiên)",65000,65000,0,0
TIKI,nha-cua-doi-song,161683477,"Xô nước nhựa màu xám 10L và 14L",119000,119000,0,0
TIKI,nha-cua-doi-song,190791221,"Hộp 4 pin sạc AA AAA Beston dung lượng cao, sạc lại nhiều lần - Hàng chính hãng",60000,60000,0,0
TIKI,nha-cua-doi-song,120338124,"Băng keo chống thấm x2000 Nhật Bản chống thấm dột, dán tường, dán mái tôn, dán ống nước",21849,21849,0,0
TIKI,nha-cua-doi-song,106281094,"Bộ 6 ly thủy tinh thấp Luminarc Salto 320ml  -LUSAG2562",281000,281000,0,0
TIKI,nha-cua-doi-song,28324641,"Bình Nước Handle Bottle 1.4L-PP-VN-15 HAP817GRY",43000,83000,40000,48
TIKI,nha-cua-doi-song,138822649,"Túi 12/50 viên khăn mặt viên nén NIKKORI NHẬT BẢN",30000,30000,0,0
TIKI,nha-cua-doi-song,169325250,"Combo 4 Đế Kê Chân Tủ Lạnh , Máy Giặt Chống Rung Lắc , Chống Trầy Xướt Nền Nhà PaKaSa - Hàng Việt Nam",39000,78000,39000,50
TIKI,nha-cua-doi-song,140011015,"Vòi hoa sen Luva VS6, đường kính bát sen 11cm, Bật/Tắt trực tiếp trên vòi sen",248000,248000,0,0
TIKI,nha-cua-doi-song,116766480,"Túi Đựng Bình Nước Grepaco Giữ Nhiệt Dạng Quai Xách Thể Thao Phù Hợp Bình/Ly Nước Thể Tích 500ml, 750ml, 800ml, 900ml, 1500ml – Vải Bố Canvas",59000,59000,0,0
TIKI,nha-cua-doi-song,754592,"Ổ Cắm Điện 3D + 3S Dây 3m x 2 Lioa 3D3S32 - Đen",98000,98000,0,0
TIKI,nha-cua-doi-song,80934535,"Ổ chia điện, đầu nối thông minh SOPOKA Q3T-Q5T chia 3 chia 5 siêu gọn, siêu tiết kiệm",28000,31200,3200,10
TIKI,nha-cua-doi-song,137181690,"Nhang Xanh Trầm Hương - Cao 20cm Hộp 200 gram",82500,82500,0,0
TIKI,nha-cua-doi-song,50252568,"Thước Đo Khoảng Cách Laser SNDWAY 50m - 70m - 100m - 120m Phạm Vi Đo Tùy Chọn Chuyên Dụng Cho Thiết Kế",350000,350000,0,0
TIKI,nha-cua-doi-song,162116332,"Bộ 6 Tô Thuỷ Tinh Luminarc Diwali Lines 18cm - LUDIQ1672",321000,630000,309000,49
TIKI,nha-cua-doi-song,39317473,"Hộp 60 Viên Pin AAA Panasonic NEO ( Pin Đũa ) - Hàng Chính Hãng",197000,205000,8000,4
TIKI,nha-cua-doi-song,23587570,"Chai Thủy Tinh Nắp Cài Kín Hơi 1 Lít",29000,29000,0,0
TIKI,nha-cua-doi-song,87159755,"Cây Lăn Bụi Đa Năng ( Lông Động Vật, Sợi Vải, Đồ Da, Chăn Nệm, Ghế Salon...)",12000,12000,0,0
TIKI,nha-cua-doi-song,73330346,"Đèn ngủ cảm ứng gắn giường, cầu thang, toilet, tủ đồ, tự động bật/tắt ánh sáng ban đêm, sạc bằng USB - Ánh sáng trắng dài 10cm",84000,84000,0,0
TIKI,nha-cua-doi-song,53926277,"Combo 6 cuộn Túi đựng rác gia đình, Bao đựng rác văn phòng tiện lợi màu đen size trung 55x65",59000,59000,0,0
TIKI,nha-cua-doi-song,180026928,"Đồng Hồ Báo Thức Để Bàn Phong Cách Vintage, 2 Quả Chuông To - Hàng Chính Hãng",125000,125000,0,0
TIKI,nha-cua-doi-song,191356959,"Dù Chống Tia UV MINI Siêu Gọn 8 Xương Có Hộp Đựng Chống Sốc",220000,220000,0,0
TIKI,nha-cua-doi-song,67811815,"Đèn pin mini 3in1 chiếu sáng, laser, tia cực tím sạc điện",87500,87500,0,0
TIKI,nha-cua-doi-song,107409149,"Bộ dây đàn Guitar Classic (Nylon) - D'Addario EJ27N - Normal Tension, Clear Nylon - Hàng chính hãng",252000,252000,0,0
TIKI,nha-cua-doi-song,75881900,"Kệ để lò vi sóng 2 tầng hình chữ Z, khung thép sơn tĩnh điện, mặt bằng gỗ MDF xử lý chống ẩm - Chính hãng",395000,395000,0,0
TIKI,nha-cua-doi-song,181223608,"Bộ vòi xịt vệ sinh rửa toilet tăng áp inox 304 Hobby home decor VSR1 dây sen 1.2m",148000,229000,81000,35
TIKI,nha-cua-doi-song,105731887,"Kìm bấm ghim 3 trong 1 INGCO HSG1405",146000,153000,7000,5
TIKI,nha-cua-doi-song,19522394,"Bộ Đàn Ukulele Concert BWS - Bao, Capo, Móng Gẩy BWS (Bảo trì trọn đời - Uku Gỗ Mahogany trơn cỡ trung 23 inch B-01 - Kèm Sách giáo trình học Ukulele online cơ bản dài 80 trang)",590000,590000,0,0
TIKI,nha-cua-doi-song,372944,"Chảo Nướng Chống Dính Kova Vuông HGS",344000,450000,106000,24
TIKI,nha-cua-doi-song,144492733,"Nệm cói/đệm ngồi bệt cói ONGTRE cao cấp dành cho nhà hàng, quán cafe, phòng khách, đệm yoga",69000,115000,46000,40
TIKI,nha-cua-doi-song,10329092,"Dao trổ kèm 5 lưỡi phụ - dao trổ",67000,67000,0,0
TIKI,nha-cua-doi-song,58811344,"CHẾ PHẨM VI SINH EMZEO - PHÂN GIẢI, KHỬ MÙI HÔI PHẾ THẢI HỮU CƠ - GÓI 200GR ",31000,31000,0,0
TIKI,nha-cua-doi-song,104273703,"Đèn LED Để Bàn Thông Minh Tự Động 2200mAh Cho Phòng Ngủ, Văn Phòng, Bàn Học, Bảo Vệ Mắt - Hàng Chính Hãng Baseus",531500,531500,0,0
TIKI,nha-cua-doi-song,22008086,"Bật lửa quẹt gas hình thỏi vàng sáng bóng",64000,64000,0,0
TIKI,nha-cua-doi-song,41457535,"Khoá tủ vân tay JMX 3892",375000,490000,115000,23
TIKI,nha-cua-doi-song,125685284,"Móc Nhựa Treo Quần Áo Đa Năng Tiết Kiệm Không Gian Tiện Dụng",2000,3500,1500,43
TIKI,nha-cua-doi-song,20223034,"Decal dán tường kệ hoa trang trí SK6093DS",80000,80000,0,0
TIKI,nha-cua-doi-song,137907353,"Giá treo ô dù dán tường, móc treo ô dù, móc treo chổi siêu chắc, tiện lợi, siêu dính, chịu lực tốt",15000,15000,0,0
TIKI,nha-cua-doi-song,155268009,"Găng tay y tế không bột, bao tay cao su hộp 100 cái",58000,58000,0,0
TIKI,nha-cua-doi-song,138456818,"Màng bọc thực phẩm Laspalm chính hãng MBTP00006163",105000,174900,69900,40
TIKI,nha-cua-doi-song,39286757,"Túi lưới giặt giày quần áo tổ ong có khoá kéo cao cấp dùng cho máy giặt nhanh chóng và tiện lợi",48000,85000,37000,44
TIKI,nha-cua-doi-song,138615688,"Lò xo uốn ống điện",40000,40000,0,0
TIKI,nha-cua-doi-song,162122783,"Bộ 6 Đĩa Sâu Thuỷ Tinh Luminarc Diwali Lines 20cm - LUDIQ1662",312000,470000,158000,34
TIKI,nha-cua-doi-song,14632647,"Đệm ngồi 3D thoáng khí chống đau mỏi Egg sister",165000,165000,0,0
TIKI,nha-cua-doi-song,50819884,"Cuộn Màng Bọc Hàng, Màng Co, Màng Chít, Màng PE bảo vệ hàng hóa 2.4kg x 50cm ",90000,90000,0,0
TIKI,nha-cua-doi-song,197676301,"Tủ nhựa TABI Vân gỗ cao cấp, chất lượng, giá rẻ, nhiều mẫu mã chính hãng Nhựa Duy Tân",1079000,1300000,221000,17
TIKI,nha-cua-doi-song,73571741,"Bàn Trà Sofa Hiện Đại Thương Hiệu IGEA",304000,320000,16000,5
TIKI,nha-cua-doi-song,25421013,"Bộ Nồi Inox 3 Đáy Sunhouse SH335(16cm, 20cm, 24cm ) - Dùng trên mọi loại bếp - Hàng chính hãng",356000,620000,264000,43
TIKI,nha-cua-doi-song,16341786,"Bình Giữ Nhiệt Lock&Lock LHC1439 Dung Tích 1000ml",299000,569000,270000,47
TIKI,nha-cua-doi-song,99213205,"Nồi inox Fivestar 3 đáy bếp từ nắp inox (16cm ) ,tặng 1 muỗng canh",189000,189000,0,0
TIKI,nha-cua-doi-song,59518200,"Nệm tiện ích Everon  201 ( Màu ngẫu nhiên )",350000,350000,0,0
TIKI,nha-cua-doi-song,150851260," Miếng Xốp Dán Tường Giả Gạch 3D- Trang Trí Nhà Cửa, Phòng Học, Nhà Hàng , Chống Thấm, Ẩm Mốc -Lớp Dán Siêu Chắc - Hàng Chính Hãng MINIIN(70 x 77cm)",13000,15000,2000,13
TIKI,nha-cua-doi-song,52316356,"Bộ máy khoan pin RAKUTEN 66V  khoan tường, khoan sắt, khoan bê tông máy 2 pin, đảo chiều và mũi khoan",558600,588000,29400,5
TIKI,nha-cua-doi-song,116274323,"Kệ sách treo tường hình chữ Z xinh xắn! dài 90cm",229000,239000,10000,4
TIKI,nha-cua-doi-song,179505447,"Bình Nước Giữ Nhiệt Cute 800ml Chất Liệu Inox 304 Giữ Nhiệt Không Gỉ Nóng Lạnh 24 Giờ Kèm Ống Hút Và Sticker - Hàng Loại 1 - Chính Hãng MINIIN",114000,131000,17000,13
TIKI,nha-cua-doi-song,68788653,"Tủ Quần Áo miDoctor Cải Tiến Thế Hệ Mới, Tủ Vải Quần Áo 3 Buồng 8 Ngăn 1,7m Cao Cấp",389000,550000,161000,29
TIKI,nha-cua-doi-song,10647257,"Ổ cắm Điện Quang ĐQ ESK 2B.SM750SL (5 lỗ 3 chấu dây 2 mét màu Đen Trắng Đỏ)",190960,238700,47740,20
TIKI,nha-cua-doi-song,147100752,"Dụng cụ bơm hút rượu, xăng dầu chất lỏng bóp tay , hút chất lỏng bóp tay",16000,22996,6996,30
TIKI,nha-cua-doi-song,36461827,"bàn làm việc chân sắt - vàng nhạt",177000,177000,0,0
TIKI,nha-cua-doi-song,59359188,"PHÍCH  CẮM CHUYỂN ĐỔI 3 CHẤU SANG 2 CHẤU VÀ CHIA 2 Ổ TOSHINO PS18-A2  2000W - HÀNG CHÍNH HÃNG",49000,49000,0,0
TIKI,nha-cua-doi-song,79445924,"Nến thơm hoa khô thiên nhiên, sáp nến thơm phòng MO hi cao cấp - Hàng chính hãng, giao màu, hình, họa tiết hộp ngẫu nhiên",41400,45000,3600,8
TIKI,nha-cua-doi-song,160306737,"Nắp Bồn Cầu,Nắp Bồn Cầu Rơi Êm Bệt Rời Viglacera,Dococera,HC,Thiên Thanh,American Standard,...",230000,450000,220000,49
TIKI,nha-cua-doi-song,101858930,"Áo Mưa Khoá Kéo, Áo Mưa Măng Tô Vải Dù Cao Cấp, Hàng Việt Nam, Khổ To Rộng, Chống Thấm Hiệu Quả, Phù Hợp Nam Và Nữ, Có Túi Đựng, Có Lựa Chọn Màu Sắc",140000,140000,0,0
TIKI,nha-cua-doi-song,109310666,"Kệ để kinh phật hoa sen bằng gỗ MDF phủ Melamine 2 mặt/ Bàn tụng kinh/ bàn đọc sách",380000,380000,0,0
TIKI,nha-cua-doi-song,179759048,"Bộ 10 Móc Dán Tường Gạch Men INOX304, Móc Dán Tường Keo 3M Treo Đồ Dùng Gia Đình - M08",69000,120000,51000,43
TIKI,nha-cua-doi-song,176534657,"Topper nệm chất liệu microfiber, dày 5cm Giao màu ngẫu nhiên",1092000,1400000,308000,22
TIKI,nha-cua-doi-song,107711424,"ÁO MƯA EVA  MÀU XANH- LOẠI TỐT - XUẤT NHẬT/ HÀN/ CHÂU ÂU / ÁO MƯA BÍT - phù hợp cả NAM & NỮ (không mùi, an toàn cho sức khỏe) ",137214,198198,60984,31
TIKI,nha-cua-doi-song,186256010,"Vỏ gối nằm cotton tici Lidaco kích thước tiêu chuẩn (1 chiếc)",29000,45000,16000,36
TIKI,nha-cua-doi-song,58357816,"Cây lau nhà inox 360 độ thái lan G7 + tặng kèm bông lau nhà ( màu ngẫu nhiên ) cao cấp",64900,64900,0,0
TIKI,nha-cua-doi-song,3747855,"Tủ vải đựng quần áo 3 buồng 8 ngăn tiện dụng",207000,207000,0,0
TIKI,nha-cua-doi-song,52027172,"Phích cắm thông minh Điện Quang Apollo ĐQ SP1.1 01 Wifi (Kiểu 1 lỗ, sử dụng wifi)",201876,237501,35625,15
TIKI,nha-cua-doi-song,184614872,"Chảo Đá Siêu Bền SUNHOUSE SBD20",196000,300000,104000,35
TIKI,nha-cua-doi-song,100867528,"Hộp Thủy Tinh Kháng Khuẩn Tròn Nikko 400ml-620ml-950ml Chính Hãng Inochi",40000,40000,0,0
TIKI,nha-cua-doi-song,59602156,"Combo Bộ 2 gối nằm + 1 gối ôm - Gòn bông nhân tạo an toàn sức khỏe - Có khóa kéo dễ dàng thêm bớt gòn bên trong - Êm ái, mềm mịn",220000,220000,0,0
TIKI,nha-cua-doi-song,162173209,"100G NaOH Tinh Khiết Dạng Hạt - Dùng Làm Xà Phòng - Trong Phòng Thí Nghiệm",18000,18000,0,0
TIKI,nha-cua-doi-song,24163146,"Kệ đựng bàn chải dán tường gạch men 2 ngăn Hobby Home Decor CD3M - Inox 304 không rỉ kèm keo dán gạch men",145000,199000,54000,27
TIKI,nha-cua-doi-song,51737688,"Túi Đựng Chăn Màn - Hộp Đựng Quần Áo Khung Sắt Gấp Gọn Amalife - Màu Ngẫu Nhiên",88000,130000,42000,32
TIKI,dien-thoai-may-tinh-bang,243165179,"Điện thoại OPPO Reno8 T 4G (8GB/256GB) - Hàng Chính Hãng",8136000,8136000,0,0
TIKI,dien-thoai-may-tinh-bang,225960096,"Điện Thoại Samsung Galaxy S23+ 5G - Hàng Chính Hãng",18000000,18000000,0,0
TIKI,dien-thoai-may-tinh-bang,219400421,"Điện thoại OPPO CPH2471 - A17k Xanh - Hàng Chính Hãng (chỉ giao HN và một số khu vực)",3276000,3276000,0,0
TIKI,dien-thoai-may-tinh-bang,175851126,"Máy Tính Bảng Galaxy Tab A8 4GB | 64GB - Hàng Chính Hãng",5856000,5856000,0,0
TIKI,dien-thoai-may-tinh-bang,248754839,"Điện Thoại OPPO A17K (3GB/64GB) - Hàng Chính Hãng",3276000,3276000,0,0
TIKI,dien-thoai-may-tinh-bang,176438864,"Điện thoại Xiaomi REDMI 9A (2+32) Xanh dương - Hàng chính hãng (chỉ giao HN và một số khu vực)",2088000,2088000,0,0
TIKI,dien-thoai-may-tinh-bang,244167098,"Điện thoại Xiaomi Redmi 12C (4GB/64GB) - Hàng chính hãng",3168000,3168000,0,0
TIKI,dien-thoai-may-tinh-bang,248590019,"Điện thoại Xiaomi Redmi 12C (3GB/32GB) - Hàng chính hãng",2808000,2808000,0,0
TIKI,dien-thoai-may-tinh-bang,205846229,"Điện Thoại Oppo A57 4GB/128GB - Hàng Chính Hãng",4632000,4632000,0,0
TIKI,dien-thoai-may-tinh-bang,273185467,"Điện thoại Samsung A05 4GB - hàng chính hãng",3112000,3112000,0,0
TIKI,dien-thoai-may-tinh-bang,168094334,"Điện thoại Samsung Galaxy S20 FE (8GB/256GB) - Hàng chính hãng",8625000,8625000,0,0
TIKI,dien-thoai-may-tinh-bang,273595363,"Oukitel wp30 Pro 5g SIÊU BỀN (sạc nhanh 120W ,pin 11000 mAh,màn hình 6.78 inch,Ram 24 GB(12gb + 12GB),Rom 512GB ,120Hz ,Android 13,camera 108mp)- hàng chính hãng",11990000,11990000,0,0
TIKI,dien-thoai-may-tinh-bang,271801317,"Máy tính bảng siêu bền Oukitel RT6 (chống nước,chống va đập,pin 20000mAh,Ram 16Gb(8GB+8Gb),Rom 256GB,Màn hình 10.1" ,FHD,Android 13,CPU MTK8788 ,Camera 16MP,sạc nhanh 33W)-hàng chính hãng",9990000,9990000,0,0
TIKI,dien-thoai-may-tinh-bang,274560616,"Máy tính bảng học tập giá rẻ Nexta Edutab Kid cho bé từ 5-8 tuổi, màn hình full HD 64GB, bao da, kính dán cường lực, hàng chính hãng",4990000,4990000,0,0
TIKI,dien-thoai-may-tinh-bang,197214015,"Apple iPhone 14 Plus",19490000,27990000,8500000,30
TIKI,dien-thoai-may-tinh-bang,215119245,"Điện Thoại Di Động Forme D888 4G - Hàng Chính Hãng",680000,680000,0,0
TIKI,dien-thoai-may-tinh-bang,249782771,"Máy tính bảng Xelex Gama Tab X8 EDU (Hàng chính hãng)",2890000,2890000,0,0
TIKI,dien-thoai-may-tinh-bang,262055875,"Điện thoại POCO M5 4GB+64GB - Pin 5000mAh - MediaTek Helio G99 -  Sạc nhanh 18W - Hàng chính hãng",2599000,3990000,1391000,35
TIKI,dien-thoai-may-tinh-bang,273407277,"Máy tính bảng chắc chắn Oukitel RT7(Chống va đập,Màn hình 10.1" FHD+,Pin 32000mAh ,Ram 24GB,Rom 256GB, Android 13,Camera sau 48MP, tầm nhìn ban đêm 20MP,camera trước 32MP,5G) – hàng chính hãng",13990000,13990000,0,0
TIKI,dien-thoai-may-tinh-bang,248185860,"Điện Thoại Masstel Fami 12 4G - Hàng Chính Hãng",630000,630000,0,0
TIKI,dien-thoai-may-tinh-bang,200848570,"Điện thoại Mobell M539 4G - Màn hình lớn 2.8 inch - Hàng chính hãng",626000,730000,104000,14
TIKI,dien-thoai-may-tinh-bang,272273680,"Điện thoại Samsung Galaxy A05s (4GB/128GB) - Hàng chính hãng",3174000,4290000,1116000,26
TIKI,dien-thoai-may-tinh-bang,68693081,"Điện Thoại Samsung Galaxy S20 FE (8GB/256GB) - Hàng Chính Hãng",8625000,8625000,0,0
TIKI,dien-thoai-may-tinh-bang,274564360,"Điện Thoại Xiaomi Redmi 12 4G (4GB/128GB) - Hàng chính hãng",3290000,4990000,1700000,34
TIKI,dien-thoai-may-tinh-bang,273389282,"Điện Thoại ulefone armor 21(Loa to 122dB Speaker ,pin 9600mAh,sạc nhanh 33W,Màn hình 6.58 in,camera chính 64MP,ban đêm 24MP,Ram 16Gb(8+8),rom 256Gb, điều khiển từ xa đa năng)- hàng chính hãng",6990000,6990000,0,0
TIKI,dien-thoai-may-tinh-bang,274364026,"Máy tính bảng học tập thông minh Nexta Edutab Pro tối ưu cho trẻ 9-12 tuổi, 64GB, tích hợp ứng dụng học tập - Hàng nhập khẩu",6490000,6490000,0,0
TIKI,dien-thoai-may-tinh-bang,258766897,"Điện Thoại Masstel iZi 11 4G - Hàng Chính Hãng",468000,468000,0,0
TIKI,dien-thoai-may-tinh-bang,216934468,"Điện thoại Samsung Galaxy A14 5G (4GB/128GB) - Hàng chính hãng",5000000,5000000,0,0
TIKI,dien-thoai-may-tinh-bang,274524033,"Điện thoại người già Masstel Fami 12S 4G(LTE) , Bàn phím chữ số to, Loa lớn , Máy viền thép chắc chắn - Hàng chính hãng",569000,650000,81000,12
TIKI,dien-thoai-may-tinh-bang,136364272,"Máy tính bảng Masstel Tab 10.4" (4GB/64GB) - Hàng chính hãng - ĐÃ KÍCH HOẠT BẢO HÀNH ĐIỆN TỬ",4800000,4800000,0,0
TIKI,dien-thoai-may-tinh-bang,175967811,"Điện Thoại Samsung Galaxy S20 FE 256GB | 8GB - Hàng Chính Hãng",8625000,8625000,0,0
TIKI,dien-thoai-may-tinh-bang,249168300,"Điện thoại OPPO A57 4GB/128GB Đen - Hàng chính hãng",4890000,4990000,100000,2
TIKI,dien-thoai-may-tinh-bang,274257669,"Điện thoại Masstel Izi S1 4G (LTE) Gọi HD Call - Hàng chính hãng",420000,499000,79000,16
TIKI,dien-thoai-may-tinh-bang,262688183,"ĐIỆN THOẠI MASSTEL IZI 30 4G-LTE-HÀNG CHÍNH HÃNG",560000,560000,0,0
TIKI,dien-thoai-may-tinh-bang,252073013,"Điện thoại hiệu Masstel Fami 60 - Hàng chính hãng - Giá rẻ - hỗ trợ 4G - dành cho người lớn tuổi",730000,730000,0,0
TIKI,dien-thoai-may-tinh-bang,273659145,"Máy tính bảng Masstel Kidzone dành cho bé - quản lý thời gian cho bé - bé học tốt, hiệu quả cao - 1 đổi 1 trong 100 ngày - Hàng chính hãng",2990000,3990000,1000000,25
TIKI,dien-thoai-may-tinh-bang,274065746,"Điện thoại siêu bền Oukitel WP33 Pro 5G (Loa to 136 dB (5W) ,Pin 22000mAh,màn hình 6,6 inch FHD+,Ram 24GB(8+16),Rom 256GB, Camera 64MP,sạc nhanh 33W)- hàng chính hãng",8990000,8990000,0,0
TIKI,dien-thoai-may-tinh-bang,198671718,"Điện Thoại Samsung Galaxy A04s (4GB/64GB) - Hàng Chính Hãng - Đã kích hoạt bảo hành điện tử",2670000,3990000,1320000,33
TIKI,dien-thoai-may-tinh-bang,103168071,"Máy tính bảng Samsung Galaxy Tab A7 Lite LTE SM-T225 - Hàng Chính Hãng",3587000,3587000,0,0
TIKI,dien-thoai-may-tinh-bang,273231495,"Máy tính bảng Masstel tab 10.1 pro - Hàng chính hãng",4290000,4290000,0,0
TIKI,dien-thoai-may-tinh-bang,249851724,"Điện Thoại 4G Masstel Lux 10 - 2 Sim 2 Sóng - Sóng 4G HD Call - Loa To Rõ - Pin Bền - Hàng Chính Hãng - Bảo Hành 12 Tháng",675000,675000,0,0
TIKI,dien-thoai-may-tinh-bang,223859345,"Điện thoại Masstel Fami 60 - Hàng chính hãng ",730000,730000,0,0
TIKI,dien-thoai-may-tinh-bang,272273169,"Điện thoại Samsung Galaxy M34 5G (8GB/128GB) - Hàng chính hãng",7590000,7990000,400000,5
TIKI,dien-thoai-may-tinh-bang,271364652,"Máy tính bảng Xiaomi Pad 6 (8GB/128GB) -  Hàng chính hãng - Đã kích hoạt bảo hành điện tử",8790000,9490000,700000,7
TIKI,dien-thoai-may-tinh-bang,200829966,"Điện thoại Mobell M239 4G - 2 SIM - Hàng chính hãng",415000,500000,85000,17
TIKI,dien-thoai-may-tinh-bang,274611998,"Điện thoại Xiaomi Redmi 12 (4GB/128GB) - Hàng chính hãng",3790000,3790000,0,0
TIKI,dien-thoai-may-tinh-bang,205815576,"Apple iPad 10.9-inch (10th Gen) Wi-Fi, 2022",9990000,12990000,3000000,23
TIKI,dien-thoai-may-tinh-bang,271973414,"iPhone 15 Pro Max 256GB Titan Tự Nhiên",30990000,33990000,3000000,9
TIKI,dien-thoai-may-tinh-bang,242771940,"Điện Thoại Samsung A04e 3GB/32GB - Hàng Chính Hãng",2109000,2990000,881000,29
TIKI,dien-thoai-may-tinh-bang,271046571,"Điện thoại Xiaomi Redmi Note 12 (8GB/128GB) - Hàng chính hãng",3790000,4790000,1000000,21
TIKI,dien-thoai-may-tinh-bang,179547641,"Máy đọc sách Kindle Paperwhite 5 (8GB) - Hàng chính hãng",3750000,3750000,0,0
TIKI,dien-thoai-may-tinh-bang,273438769,"Điện thoại Xiaomi Redmi A2 2GB/32GB MediaTek Helio G36 , Pin 5000 mAh - Hàng chính hãng",1669000,2190000,521000,24
TIKI,dien-thoai-may-tinh-bang,200819471,"Điện thoại Mobell Rock 4 4G , Pin 3250mah , Loa Siêu lớn - Hàng chính hãng",685000,799000,114000,14
TIKI,dien-thoai-may-tinh-bang,270473116,"Điện thoại Xiaomi Redmi Note 12 (8GB/128GB) - Hàng chính hãng",4489000,5790000,1301000,22
TIKI,dien-thoai-may-tinh-bang,274542808,"Điện Thoại Samsung A55 5G 8GB/128GB - Hàng Chính Hãng",9499000,9990000,491000,5
TIKI,dien-thoai-may-tinh-bang,274162900,"Điện thoại OPPO A18 4GB-128GB - Hàng chính hãng",3690000,3990000,300000,8
TIKI,dien-thoai-may-tinh-bang,274638556,"BÚT MÁY ĐỌC SÁCH KINDLE SCRIBE - HÀNG CHÍNH HÃNG",2500000,2500000,0,0
TIKI,dien-thoai-may-tinh-bang,274545326,"Điện thoại OPPO A36 6GB/128GB, Chip Snapdragon 680 , Màn 90Hz , Rom Tiếng việt - Hàng nhập khẩu",3050000,3590000,540000,15
TIKI,dien-thoai-may-tinh-bang,250109584,"Điện thoại Xiaomi Redmi Note 12 (4GB/128GB) - Hàng chính hãng",3600000,4990000,1390000,28
TIKI,dien-thoai-may-tinh-bang,246163082,"Điện Thoại Nokia C30 2GB/32GB - Hàng Chính Hãng",1599000,2290000,691000,30
TIKI,dien-thoai-may-tinh-bang,263309601,"Điện thoại siêu bền Oukitel K16(mini,Vỏ lưng bằng da,Ram 8Gb,Rom 128Gb,camera 48MP,pin 3.050mAh)- hàng chính hãng",4990000,4990000,0,0
TIKI,dien-thoai-may-tinh-bang,202035122,"[HCM]Ốp Lưng IPHONE Cường Lực Trong Suốt Cao Cấp Cho Dòng Iphone 14/14Pro/14Plus/14 Pro Max, Iphone 13Mini/13Pro/13ProMax, Iphone 12/12Pro/12Promax, Iphone 11/11Pro/11ProMax- Hàng nhập khẩu",110000,110000,0,0
TIKI,dien-thoai-may-tinh-bang,198968094,"Điện Thoại Xiaomi Redmi A1 2GB/32GB - Hàng Chính Hãng",1749000,2190000,441000,20
TIKI,dien-thoai-may-tinh-bang,244308977,"Điện Thoại Xiaomi Redmi 12C 4GB/64GB - Hàng Chính Hãng",3168000,3168000,0,0
TIKI,dien-thoai-may-tinh-bang,274383701,"Điện thoại Samsung Galaxy A05s 6GB-128GB - Hàng chính hãng",3890000,3890000,0,0
TIKI,dien-thoai-may-tinh-bang,230055130,"Điện thoại Oppo Reno8 T (8GB/256GB) - Hàng chính hãng",10392000,10392000,0,0
TIKI,dien-thoai-may-tinh-bang,274393574,"Điện thoại Xiaomi Poco C65 - Hàng chính hãng",3090000,3090000,0,0
TIKI,dien-thoai-may-tinh-bang,230155305,"Điện thoại Xiaomi Redmi Note 10 JE 5G 4GB/64GB - Màn 90HZ - Chống Nước IP68 - Hàng Nhập Khẩu - Bản quốc tế",2276000,3990000,1714000,43
TIKI,dien-thoai-may-tinh-bang,274316036,"Điện Thoại Samsung Galaxy M34 5G 8GB-128GB - Hàng chính hãng",6250000,7990000,1740000,22
TIKI,dien-thoai-may-tinh-bang,216092766,"Điện Thoại Oppo Reno 8T 4G (8GB/256GB)",8136000,8136000,0,0
TIKI,dien-thoai-may-tinh-bang,273559020,"Máy tính bảng Kindle Fire HD10 2023 13th - 32Gb - Hàng chính hãng",3390000,3390000,0,0
TIKI,dien-thoai-may-tinh-bang,249890677,"Điện Thoại Xiaomi Redmi Note 12 4GB/128GB - Hàng Chính Hãng",3599000,4990000,1391000,28
TIKI,dien-thoai-may-tinh-bang,191089547,"Điện Thoại Nokia 110 4G - Hàng Chính Hãng",675000,899000,224000,25
TIKI,dien-thoai-may-tinh-bang,251407092,"Điện Thoại Samsung Galaxy A34 5G (8GB/128GB) ĐKH -  Hàng Chính Hãng",7164000,7164000,0,0
TIKI,dien-thoai-may-tinh-bang,253395356,"Điện Thoại Samsung M14 5G 6GB/128GB - Hàng Chính Hãng",5292000,5292000,0,0
TIKI,dien-thoai-may-tinh-bang,258668285,"Điện thoại cố định Panasonic KX-TS520MX ( màu đen)-Hàng chính hãng",449000,469000,20000,4
TIKI,dien-thoai-may-tinh-bang,270975124,"Điện Thoại Oppo A58 6GB/128GB - Hàng Chính Hãng",4990000,4990000,0,0
TIKI,dien-thoai-may-tinh-bang,270164674,"Điện thoại OPPO A78 (8GB/256GB) - Hàng Chính Hãng",6990000,6990000,0,0
TIKI,dien-thoai-may-tinh-bang,249169833,"Điện thoại Samsung Galaxy A34 5G 8GB/128GB Đen - Hàng chính hãng",7164000,7164000,0,0
TIKI,dien-thoai-may-tinh-bang,245770248,"Điện thoại Xiaomi Redmi 12C (4GB/64GB) - Hàng chính hãng",3168000,3168000,0,0
TIKI,nha-cua-doi-song,176750496,"VUA Nấm Bệnh Thán thư thối nhũn vàng lá Đốm lá ghẻ sẹo phấn trắng rỉ sắt sương mai gói 26g",20000,20000,0,0
TIKI,nha-cua-doi-song,153665555,"Hũ Đựng Cà Phê Có Van Hút Chân Không",239000,239000,0,0
TIKI,nha-cua-doi-song,130369125,"Cây Treo Quần Áo, Túi Xách, Mũ Thông Minh Phong Cách VINTAG Gọn Gàng Tiết Kiệm Diện Tích Nhà Cửa- Hàng Chính Hãng MINIIN",149000,219000,70000,32
TIKI,nha-cua-doi-song,186351890,"Đệm ngồi chống trĩ, đau xương cụt Ema cho dân văn phòng, lái xe, phụ nữ sau sinh",325000,650000,325000,50
TIKI,nha-cua-doi-song,187184291,"Băng Dính Silicol 2 Mặt Siêu Dính Siêu Tiện Lợi Ứng Dụng Vào Mọi Công Việc Vị Trí Trong Gia Đình",35000,35000,0,0
TIKI,nha-cua-doi-song,184518592,"Gối Kê Cổ Chữ U Giúp Giảm Đau Cổ, Biến Hình 2 Trong 1, Phù Hợp Cho Văn Phòng Và Du Lịch",290000,290000,0,0
TIKI,nha-cua-doi-song,77990689,"[MẪU MỚI 2020] Bộ công tắc điều khiển từ xa rf 100m/30A/220V xuyên tường công suất lớn",83000,83000,0,0
TIKI,nha-cua-doi-song,171196878,"Bộ Nam Châm Vuông 90 Độ KUNBE Gắn Dán Cửa Tủ, Lực Hút Mạnh, Chắc Chắn",24000,24000,0,0
TIKI,nha-cua-doi-song,117717315,"Tủ điện nhựa ngoài trời - Hộp kỹ thuật LiOA JL-00C & JL-00C",100000,100000,0,0
TIKI,nha-cua-doi-song,68391408,"Combo 10 ĐÈN LED CHỚP 7 MÀU DÙNG PIN 3AAA SỬ DỤNG CHO ĐÈN LỒNG, ĐÈN TRUNG THU VÀ CÁC ĐỒ CHƠI TRẺ EM.",99000,99000,0,0
TIKI,nha-cua-doi-song,137730095,"Vá hớt bọt Lọc váng dầu Muỗng canh có lỗ Vớt thức ăn INOX 304 cao cấp",115000,115000,0,0
TIKI,nha-cua-doi-song,144505446,"[Gói 4 miếng] Cước Rửa Chén Siêu Mạnh Scotch Brite - Cọ rửa mọi vết bẩn cứng đầu, an toàn cho vỉ nướng, nồi inox, gang, thép",46000,51000,5000,10
TIKI,nha-cua-doi-song,108430436,"Nhiệt ẩm kế Tanaka Th337 - Đo nhiệt độ, độ ẩm trong nhà và ngoài trời",119000,165000,46000,28
TIKI,nha-cua-doi-song,24189275,"Cân điện tử mini nhà bếp ",64600,68000,3400,5
TIKI,nha-cua-doi-song,192833044,"Ghế Gỗ Kê Chân Văn Phòng Thoải Mái, Ghế Gác Chân Dễ Chịu",118750,125000,6250,5
TIKI,nha-cua-doi-song,146249285,"Cốc Gấu Cute Đựng Bàn Chải Kem Đánh Răng Dán Tường Đa Năng",4500,4500,0,0
TIKI,nha-cua-doi-song,43878049,"Ổ cắm chia 3 ngả đa năng MPE TA4 - Tích hợp 2 cổng USB sạc nhanh 2.4A",195000,195000,0,0
TIKI,nha-cua-doi-song,76403675,"(Chống Cắt) Ổ Khóa Ngăn Ngừa Trộm 60mm KhoNCC-Padlock Hàng Chính Hãng Cho Gia Đình - Kho Xưởng Cực Kỳ An Toàn - KPD-Padlock-6PCC (Bạc, Đồng)",189000,248000,59000,24
TIKI,nha-cua-doi-song,128792084,"Bình xịt chống thấm đa năng chai xịt ngăn dột nước trần sàn mái tôn, chân tường nhà (màu trắng) - Hàng Chất Lượng",35150,37000,1850,5
TIKI,nha-cua-doi-song,9970789,"Bộ 5 hộp đựng giày dép thông minh, tiện lợi GS0023",206999,206999,0,0
TIKI,nha-cua-doi-song,72804257,"Pin AA Energizer Ultimate Lithium L91 - Vỉ 2 viên",131000,139000,8000,6
TIKI,nha-cua-doi-song,102445108,"Ô Dù Mở Ngược Chuyên Dùng Cho Ô Tô Thiết Kế Thông Minh",78000,78000,0,0
TIKI,nha-cua-doi-song,135391727,"Lô 4 cuộn túi rác tiện dụng Inochi Soji (10L-25L-50L)",38000,59000,21000,36
TIKI,nha-cua-doi-song,68447740,"Bộ cấp nước bồn cầu - Bộ cấp nước két nước vệ sinh sử dụng phao cơ thông minh",155000,180000,25000,14
TIKI,nha-cua-doi-song,32476504,"Công tắc hẹn giờ Kg316T-ii 17 chương trình công suất lớn 25A/220V",67500,67500,0,0
TIKI,nha-cua-doi-song,17491418,"Đầu vòi xịt vệ sinh (toilet) inox SUS 304",65000,70000,5000,7
TIKI,nha-cua-doi-song,75707305,"Bộ May Vá Quần Áo Đa Năng Cho Gia Đình KUNBE Kèm Hộp Đựng Kim Chỉ",53000,53000,0,0
TIKI,nha-cua-doi-song,58469517,"Dây đèn nháy Led đom đóm trang trí pin dây bóng đèn nháy cao cấp decor nhà cửa, lễ tết, lều trại du lịch, fairy light cao cấp (Tùy chọn màu và chiều dài dây)",68000,113000,45000,40
TIKI,nha-cua-doi-song,33337588,"Áo Bọc Nệm Hai Mặt Có Khóa Đủ Kích Thước 10cm - Màu Ngẫu Nhiên",85000,85000,0,0
TIKI,nha-cua-doi-song,185409647,"Hũ Nhựa Pet Vuông Kín Hơi, Lọ, Hộp Nhựa Vuông Kín Hơi Đựng Sữa, Bột, Trà, Cà Phê, Thực Phẩm Đồ Khô Chống Ẩm, Côn Trùng",50000,50000,0,0
TIKI,nha-cua-doi-song,83927715,"Bịt Mắt Ngủ Che Mắt Ngủ Có Túi Gel Massage - Giảm Thâm Quầng Mắt - Mẫu Hoạt Hình Mới - XÁM",35000,35000,0,0
TIKI,nha-cua-doi-song,48287959,"KỆ LÒ VI SÓNG 2 TẦNG GỖ THÔNG - Dài 60cm x Cao 46cm",169000,190000,21000,11
TIKI,nha-cua-doi-song,103711453,"Máy Pha Trà Bear SUBE011",1190000,1190000,0,0
TIKI,nha-cua-doi-song,52254939,"Dụng cụ gọt nạo vỏ trái cây, củ quả inox",9890,9890,0,0
TIKI,nha-cua-doi-song,130829751,"Combo 12 Hũ Thủy Tinh PEAFLO Làm Caramen, Sữa Chua, Đựng Gia Vị Đa Năng - Giao Ngẫu Nhiên",62000,85000,23000,27
TIKI,nha-cua-doi-song,2395003,"Khăn lau đa năng cao cấp 3M xanh dương 36cm",39000,39000,0,0
TIKI,nha-cua-doi-song,112532029,"Khay đựng túi rác dành cho thùng rác thông minh TOWNEW T1, T1S, T Air X, T Air Lite_Hàng chính hãng",70000,70000,0,0
TIKI,nha-cua-doi-song,55994496,"Combo 2 Khăn Lau Xe Ô Tô Siêu Thấm, Khăn Lau Đa Năng Chất Liệu Microfiber 2 Chiếc - Hàng Chính Hãng",69000,100000,31000,31
TIKI,nha-cua-doi-song,115334461,"Combo 2 Lõi cây lăn bụi ,Lông Động Vật, Sợi Vải, Đồ Da, Chăn Nệm, Ghế Salon",10000,11800,1800,15
TIKI,nha-cua-doi-song,192523772,"Tấm Lót Tủ Lạnh, Tủ Bếp, Tủ Quần Áo Nhựa EVA Dễ Dàng Vệ Sinh (Đủ màu, đủ size)",49000,49000,0,0
TIKI,nha-cua-doi-song,200782721,"Hộp vải đựng quần áo chia ngăn, khay đựng đồ lót, tất vớ,có nắp gấp gọn tiện lợi",29000,37000,8000,22
TIKI,nha-cua-doi-song,69754010,"Keo dán Đa Năng Nhật Bản Dán thủy tinh, bê tông, gạch, đá, gỗ , nhựa cứng ULTRA SU HARD (CỨNG) 10ml #05140, chống thấm nước  (Hàng nội địa Nhật)",110880,138600,27720,20
TIKI,nha-cua-doi-song,59358608,"Combo 2 Ron Thanh Nẹp Xốp Chèn Chắn Cửa Chống Bụi Côn Trùng Dài 95cm Legaxi",40000,40000,0,0
TIKI,nha-cua-doi-song,52774383,"Đèn LED Đom Đóm Chipsbling Dùng Pin Năng Lượng Mặt Trời",149000,149000,0,0
TIKI,nha-cua-doi-song,177068285,"Trầu Bà Lá Xẻ - trầu bà nam mỹ - cây cảnh để trong nhà + tặng phân bón cho cây mau lớn",65000,110000,45000,41
TIKI,nha-cua-doi-song,152446878,"Cây mai xanh thái lan - Cây cảnh sân vườn trồng cổng rào ban công",55000,70000,15000,21
TIKI,nha-cua-doi-song,154835137,"Thìa, Muỗng Mạ Inox 304 Mạ Vàng Jodily Cao Cấp - Thìa Vàng Bắc Âu KT: 20.5x4 cm ",45000,45000,0,0
TIKI,nha-cua-doi-song,108998775,"Kệ Úp Chén Inox Đa Năng 2 Tầng Hình Chữ S PEAFLO",219000,290000,71000,24
TIKI,nha-cua-doi-song,103757642,"Chuông Báo Khách Cửa Hàng, Báo Động Chống Trộm Cảm Biến Chuyển Động Hồng Ngoại Không Dây CTFAST 02 - Lời Chào Báo Khách Ghé Thăm, Dọa Trộm Xâm Nhập",375000,409000,34000,8
TIKI,nha-cua-doi-song,41227454,"Combo 30 móc treo quần áo Prota",63000,75000,12000,16
TIKI,nha-cua-doi-song,111631559,"Hộp đựng đồ kiêm ghế ngồi đa năng - Ghế sofa đựng đồ gấp gọn cứng cáp tiện lợi có chọn size, hàng chính hãng miDoctor",295000,500000,205000,41
TIKI,nha-cua-doi-song,146845870,"Đèn Bàn Học Chống Cận Thị, Đèn Đọc Sách, Đèn Làm Việc Bảo Vệ Mắt - Đèn Bàn Học LED USB Di Động Cao Cấp Có Thể Gập Hai Chỗ – 03 Chế Độ Ánh Sáng Vàng Bảo Vệ Mắt Chống Cận, đèn học để bàn, đèn học cho học sinh sinh viên, trang trí - Hàng Chính Hãng dododios",198000,198000,0,0
TIKI,nha-cua-doi-song,90023970,"10 Tấm Keo Bẫy Chuột Siêu Dính - Để lâu, tái sử dụng nhiều lần",130000,130000,0,0
TIKI,nha-cua-doi-song,137942665,"Móc treo dính tường siêu tiện lợi",950,1000,50,5
TIKI,nha-cua-doi-song,789439,"Găng Tay Chống Cắt Cấp Độ 5 3M (Size M) - Xám",125000,125000,0,0
TIKI,nha-cua-doi-song,31023051,"Ghế xếp Inox lùn",124900,124900,0,0
TIKI,nha-cua-doi-song,15666493,"Bộ 6 thìa Inox 304 ngắn bún phở DandiHome",179500,210000,30500,15
TIKI,nha-cua-doi-song,97933907," Máy Xay Tỏi Ớt Cầm Tay Mini Sạc Điện 250ml Tiện Lợi (Sạc Điện)",75990,75990,0,0
TIKI,nha-cua-doi-song,192178657,"Bộ Chăn Gối Văn Phòng - Gối Mền 3in1 Chó Shiba, Voi, Thỏ Ngọc, Chuột",225000,225000,0,0
TIKI,nha-cua-doi-song,70825693,"Pin Cr2025 Energizer 3V vỉ 1 viên",30000,30000,0,0
TIKI,nha-cua-doi-song,85029113,"Set 5 Phích cắm công suất lớn cao cấp Điện Quang ĐQ EPR HP 2PN (Màu ngẫu nhiên)",83045,97700,14655,15
TIKI,nha-cua-doi-song,167042076,"Bộ 6 Ly Rượu Shot Thủy Tinh cao cấp 34ML, Ly uống Rượu đế dày wine glass",29999,29999,0,0
TIKI,nha-cua-doi-song,52385659,"Combo 10 Móc Dán Tường Inox 304 treo đồ gia đình siêu dính",41990,41990,0,0
TIKI,nha-cua-doi-song,20557823,"Bộ dây 20 kẹp ảnh có đèn led trang trí sinh nhât, nhà cửa, sự kiện chụp ảnh MT-203 (dùng pin AA)",68000,68000,0,0
TIKI,nha-cua-doi-song,153843550," Dụng Cụ Hút Rượu, Hút Chất Lỏng Xăng Dầu Bóp Tay Thủ Công",16000,44000,28000,64
TIKI,nha-cua-doi-song,101948734,"Hạt Giống Cải Bẹ Mào Gà 20 Gam",9900,9900,0,0
TIKI,nha-cua-doi-song,16211222,"Combo Thiếc Hàn Solder-OK 0.8mm-100g và Nhựa Thông Hộp Loại Tốt",34500,34500,0,0
TIKI,nha-cua-doi-song,126865171,"Vỏ gối ôm lụa cao cấp A 35 x 100 cm - mát mẻ, mềm mịn, không kích ứng da",100000,150000,50000,33
TIKI,nha-cua-doi-song,120470954,"Bình Nước Thuỷ Tinh Luminarc Flame 1.3L -  LUBIJ8535 ",136000,136000,0,0
TIKI,nha-cua-doi-song,55670724,"Combo 2 Chốt Chặn Cửa - Miếng Cao Su Chặn Cửa",24000,24000,0,0
TIKI,nha-cua-doi-song,169534430,"Cưa Cây Cưa Gỗ Cưa Xếp Lưỡi Thép Hợp Kim SK5 - Cưa Cầm Tay Gấp Gọn",60000,60000,0,0
TIKI,nha-cua-doi-song,138911086,"Bình nước bình giữ nhiệt, bình giữ nhiệt cute có ống hút, inox 304 không rỉ an toàn",78367,78367,0,0
TIKI,nha-cua-doi-song,72487651,"BÀN ĐỂ ỦI DẠNG NGỒI 30x80cm CHÂN XẾP NGUYỄN TRƯỜNG THẮNG",185000,185000,0,0
TIKI,nha-cua-doi-song,196889763,"Bình tưới cây 5 lít Monrovia, phun hai chế độ, áp suất lớn tiêu chuẩn Châu Âu",399000,399000,0,0
TIKI,nha-cua-doi-song,7625922,"Đồng hồ báo thức inox kim trôi",109000,109000,0,0
TIKI,nha-cua-doi-song,372846,"Bình Ngâm Rượu, Nước Hoa Quả Kova BNR1.8 1.8 Lít",137000,179000,42000,23
TIKI,nha-cua-doi-song,149658407,"Khăn treo lau tay san hô tròn nhà bếp bông lau khô dày thấm nước nhanh",22900,22900,0,0
TIKI,nha-cua-doi-song,10685676,"Ghế văn phòng chân xoay E0 - Normaline TH01",335750,395000,59250,15
TIKI,nha-cua-doi-song,77747671,"Miếng lau nhà thay thế Cây lau nhà KITIMOP-XPRO, WHITE ( 42 x 12cm)",19000,19000,0,0
TIKI,nha-cua-doi-song,24888275,"Nhang Nụ Trầm Hương tự nhiên khói chảy ngược - Trầm Hương 12 năm - Thơm dịu nhẹ, không cay mắt, không kích mũi - Hộp 40 nụ - Thiên Mộc Hương",290000,350000,60000,17
TIKI,dien-thoai-may-tinh-bang,181699208,"Máy tỉnh bảng Samsung Galaxy Tab A8 -Hàng chính hãng",5856000,5856000,0,0
TIKI,dien-thoai-may-tinh-bang,273186334,"Điện thoại Samsung Galaxy A05s 4GB/128GB- Hàng Chính hãng",3980000,3980000,0,0
TIKI,dien-thoai-may-tinh-bang,250113073,"Điện thoại Xiaomi Redmi Note 12 Pro 5G (8GB/256GB) - Hàng chính hãng",9000000,9000000,0,0
TIKI,dien-thoai-may-tinh-bang,253443652,"Điện Thoại Samsung Galaxy M14 5G - Hàng Chính Hãng",4212000,4212000,0,0
TIKI,dien-thoai-may-tinh-bang,244182370,"Điện thoại Samsung Galaxy S23 Ultra 1TB - Hàng chính hãng",44990000,44990000,0,0
TIKI,dien-thoai-may-tinh-bang,273947785,"Điện thoại AI Samsung Galaxy S24+ 12GB/256GB, Camera 50MP, Màn hình 6.7"- Đen- Hàng Chính Hãng",25490000,27490000,2000000,7
TIKI,dien-thoai-may-tinh-bang,196348143,"Điện Thoại OPPO A57 (4GB/64GB) - Hàng Chính Hãng",4284000,4284000,0,0
TIKI,dien-thoai-may-tinh-bang,252423003,"Điện thoại Tecno SPARK 10 4GB/128GB - Camera 50MP | 5000 mAh | Sạc nhanh 18W | Cảm ứng vân tay - Hàng chính hãng",3190000,3190000,0,0
TIKI,dien-thoai-may-tinh-bang,272200109,"Điện Thoại Samsung Galaxy A04e - Hàng Chính Hãng",2340000,2340000,0,0
TIKI,dien-thoai-may-tinh-bang,168317790,"Điện Thoại Xiaomi Redmi 9A (2GB/32GB)- Đã kích hoạt bảo hành điện tử- Hàng Chính Hãng - Peacock Green",2088000,2088000,0,0
TIKI,dien-thoai-may-tinh-bang,273366493,"Máy tính bảng chắc chắn Ulefone Armor Pad 2(màn hình 11" ,2K, pin 18600 mAh, IP68/IP69K, Android 13, NFC ,GPS, 4G, Ram 16GB(8gb+8gb),rom 256GB)- hàng chính hãng",7990000,7990000,0,0
TIKI,dien-thoai-may-tinh-bang,262660017,"Điện Thoại Samsung Galaxy A24 (6GB/128GB) - Hàng Chính Hãng",5800000,5800000,0,0
TIKI,dien-thoai-may-tinh-bang,271341795,"Điện thoại smartphone Masstel Hapi 15 (2GB/16GB) - 2 Sim, Tặng kèm ốp lưng - Hàng chính hãng - Bảo hành chính hãng",1499000,1499000,0,0
TIKI,dien-thoai-may-tinh-bang,215543460,"Điện Thoại Samsung Galaxy A14 5G (4GB/128GB) - Hàng Chính hãng",5190000,5190000,0,0
TIKI,dien-thoai-may-tinh-bang,272113804,"[MỚI] Điện thoại vivo Y17s - Hàng chính hãng - Camera 50MP - Pin 5000 mAh - Sạc nhanh- RAM mở rộng đến 8GB",3790000,3990000,200000,5
TIKI,dien-thoai-may-tinh-bang,273438458,"Điện thoại Samsung Galaxy A05 (4GB/128GB)- Helio G85 - Sạc nhanh 25W - Hàng chính hãng",2636000,3090000,454000,15
TIKI,dien-thoai-may-tinh-bang,273454566,"Điện thoại Xiaomi POCO C65 (6GB/128GB) - Helio G85 - Màn 90HZ - Hàng chính hãng",2669000,2990000,321000,11
TIKI,dien-thoai-may-tinh-bang,102620086,"Điện thoại VoIP Yealink SIP-T30 - Hàng Chính Hãng",1200000,1200000,0,0
TIKI,dien-thoai-may-tinh-bang,201001781,"Điện thoại Masstel Lux 10 4G - Nhiều chức năng - Hàng chính hãng",675000,675000,0,0
TIKI,dien-thoai-may-tinh-bang,215135773,"Điện Thoại Di Động Forme D111 4G - Hàng Chính Hãng",520000,520000,0,0
TIKI,dien-thoai-may-tinh-bang,273440662,"Điện thoại Xiaomi Redmi 12 (4GB/128GB) , Helio G88 , Màn 90HZ - Hàng chính hãng",3299000,4290000,991000,23
TIKI,dien-thoai-may-tinh-bang,273511450,"Điện thoại Xiaomi Redmi 12 8GB/128GB - Hàng Chính Hãng",4390000,4390000,0,0
TIKI,dien-thoai-may-tinh-bang,251514670,"Điện thoại Xiaomi Redmi Note 12 (4GB/128GB) Màn AMOLED 120HZ, Snapdragon 685 , Sạc 33W - Hàng chính hãng",3599000,4990000,1391000,28
TIKI,dien-thoai-may-tinh-bang,274638430,"Điện thoại Redmi Note 13R 5G 4GB/128GB Dimensity 6100+ , Màn 90Hz , Rom quốc tế có sẳn Tiếng việt - Hàng nhập khẩu",2899000,3590000,691000,19
TIKI,dien-thoai-may-tinh-bang,207883258,"Điện thoại oukitel  wp21 (Ram 12Gb,Rom 256Gb ,chống sốc,chống nước,pin khủng, pin 9.800mAh) - hàng chính hãng",9970000,9970000,0,0
TIKI,dien-thoai-may-tinh-bang,271234313,"Điện Thoại Nokia 110 4G Pro - Hàng Chính Hãng",699000,710000,11000,2
TIKI,dien-thoai-may-tinh-bang,274456687,"Điện thoại Samsung Galaxy A55 5G (8GB/128GB) - Hàng chính hãng",9990000,9990000,0,0
TIKI,dien-thoai-may-tinh-bang,258373871,"Điện Thoại Itel S23 128GB/16GB (8GB+8GB) | Pin 5000mAh | 6.6 Inch | Camera 50MP | 90Hz | Face ID - Hàng chính Hãng",2342000,3490000,1148000,33
TIKI,dien-thoai-may-tinh-bang,131028406,"Máy tính bảng Fire HD 10 Plus 2021 thế hệ 11th",3551100,3990000,438900,11
TIKI,dien-thoai-may-tinh-bang,249734070,"Điện Thoại Masstel Fami 12 4G LTE - 2 Sim- Pin 1400 mAh - Đọc số bằng giọng nói - Hàng Chính Hãng - Bảo Hành 12 Tháng",630000,630000,0,0
TIKI,dien-thoai-may-tinh-bang,209872337,"Máy đọc sách Kindle 2022 (11th) - All new kindle 2022 11th màn hình 6inch 300PPI gấp 2 lần độ sắc nét, 16GB bộ nhớ trong với cổng kết nối USB-C - Hàng nhập khẩu",2300000,2300000,0,0
TIKI,dien-thoai-may-tinh-bang,248766283,"Máy đọc sách New Kindle 11th 2022 (Kids) kèm bao da - Hàng Chính Hãng",3010000,3299000,289000,9
TIKI,dien-thoai-may-tinh-bang,274019962,"Điện thoại Masstel Fami 8 4G(LTE) Gọi HD call , Bàn phím chữ số lớn,Loa to - Hàng chính hãng",489000,550000,61000,11
TIKI,dien-thoai-may-tinh-bang,226552005,"Điện thoại bàn Panasonic KX-TSC11 hàng chính hãng",600000,600000,0,0
TIKI,dien-thoai-may-tinh-bang,242657652,"Điện thoại Samsung Galaxy S23 Plus 256GB - Hàng chính hãng",26990000,26990000,0,0
TIKI,dien-thoai-may-tinh-bang,208171115,"Điện thoại OUKITEL WP18 (Chống nước ,chống va đập, pin khủng 12500mAh, Ram 4GB ,Rom 32GB ,màn hình 5.93 inch,Điện thoại chắc chắn) – HÀNG CHÍNH HÃNG",3990000,3990000,0,0
TIKI,dien-thoai-may-tinh-bang,212329857,"Điện thoại Xiaomi Redmi 9A 2GB/32GB Xám - Hàng chính hãng",2088000,2088000,0,0
TIKI,dien-thoai-may-tinh-bang,274030201,"Điện thoại TECNO SPARK 10 8GB/128GB - Hàng Chính Hãng",2832000,3590000,758000,21
TIKI,dien-thoai-may-tinh-bang,200816374,"Điện Thoại Forme D888 - Hàng Chính Hãng",589000,699000,110000,16
TIKI,dien-thoai-may-tinh-bang,160051501,"Điện thoại Masstel IZI 20 4G - Hàng chính hãng, Nguyên Seal",512000,512000,0,0
TIKI,nha-cua-doi-song,74383210,"Kệ úp ly chén HOBBY KUL41 Inox 304 kèm khay hứng nước không rỉ sét - ngang 41cm",336000,499000,163000,33
TIKI,nha-cua-doi-song,529402,"Chất Bôi Trơn Chống Gỉ Sét Selleys RP7 150g",69000,79000,10000,13
TIKI,nha-cua-doi-song,142117009," Khay Làm Đá Silicol Có Nắp Đậy Dễ Dàng Lấy Đá, An Toàn Tiện Lợi",28000,28000,0,0
TIKI,nha-cua-doi-song,174618568,"Thùng rác cảm ứng thông minh 18 lít ML B-JA-18",859000,859000,0,0
TIKI,nha-cua-doi-song,195852180,"Ly nhựa 2 lớp có ống hút LocknLock Bucket Cold Cup with Straw HAP520BLU 580ml",145000,241000,96000,40
TIKI,nha-cua-doi-song,182814301,"Miếng Dán Chống Ngáy Khi Ngủ Nhật Bản, Chống Há Miệng Khi Ngủ Cho Người Lớn Và Trẻ Em",75000,90000,15000,17
TIKI,nha-cua-doi-song,106809822,"Đèn laser 60 trong 1 pin sạc đèn trang trí sân khấu vũ trường phòng karaoke",319000,319000,0,0
TIKI,nha-cua-doi-song,155420461,"Combo 2 hộp chia ngăn sắp xếp quần áo Mai Anh House - hộp đựng đồ chất liệu cao cấp, phong cách Nhật Bản sang trọng",210000,210000,0,0
TIKI,nha-cua-doi-song,77662747,"Bình giữ nhiệt Nhật Bản inox Thermos nút bấm 500ml JNL 502 SBR (JNL - 500/2) - Hàng chính hãng",745000,950000,205000,22
TIKI,nha-cua-doi-song,92507688,"Combo 50 Viên Khăn Nén Du Lịch Cao Cấp Đa Năng Tiện Lợi, Viên Khăn Uớt Nén Hình Viên Kẹo (Nhỏ Gọn, Tiện Lợi, Dùng Để Tẩy Trang, Lau Mặt, ...), KHĂN NÉN GẶP NƯỚC NỞ RA",24579,24579,0,0
TIKI,nha-cua-doi-song,129145019,"bình pha trà,ấm lọc trà thủy tinh có lõi lọc inox 304 chịu nhiệt",129000,129000,0,0
TIKI,nha-cua-doi-song,134360700,"Vỉ 10 Viên Pin LR44 , Pin A76 , Pin AG13 1,5V Energizer - Hàng Chính Hãng",65000,80000,15000,19
TIKI,nha-cua-doi-song,183038438,"Bình xịt tưới cây MONROVIA 2 lít, bán tự động, phun sương tưới cây cảnh, vòi dài, tặng vòi ngắn, màu xanh, tiêu chuẩn Châu Âu",169000,169000,0,0
TIKI,nha-cua-doi-song,6137123,"Phân Bón Npk 20-20-15 đa năng 3 màu  (1Kg)- bón cây, rau, cây ăn trái, hoa kiểng - bón gốc dễ sử dụng, kích thích ra lá, ra hoa, đậu trái",49000,49000,0,0
TIKI,nha-cua-doi-song,126151275,"Gối Hơi Ngủ Trưa Văn Phòng 42cm x 26cm",27000,27000,0,0
TIKI,nha-cua-doi-song,76103827,"Móc Treo Quần Áo Inox 304 Dán Tường Không Cần Khoan Đục - Tặng Kèm keo và Đinh Vít",110000,165000,55000,33
TIKI,nha-cua-doi-song,55126177,"[Xuất Nhật] Kệ Để Đồ Đa Năng 3 Tầng Tokyo - Nhựa Cao Cấp Rất Chắc Chắn Dùng Để Đựng Đồ Nhà Bếp  Hoặc Làm Giá Để Đồ Nhà Tắm Phòng Ngủ",109000,109000,0,0
TIKI,nha-cua-doi-song,167429965,"LY GIỮ NHIỆT ELEMENTAL ARTISAN MÀU TRƠN (360ML)",664050,699000,34950,5
TIKI,nha-cua-doi-song,115824604,"Bộ dây đàn Guitar Classic/ Classical Guitar String Set - D'Addario EJ49 - Pro-Arte Nylon Core, Normal Tension, Silverplated Wound, Black Nylon - Hàng chính hãng",392000,392000,0,0
TIKI,nha-cua-doi-song,186554008,"Khăn Tắm Nén Du Lịch 70 x 140cm Dạng Viên Nén Làm Từ Cotton Tự Nhiên, Sử Dụng Nhiều Lần",17994,17994,0,0
TIKI,nha-cua-doi-song,68460154,"ỐNG LÕI THÉP BỌC NHỰA PHI 11, COMBO 10 ỐNG",169750,175000,5250,3
TIKI,nha-cua-doi-song,177017969,"[SGFS53] Túi đựng đồ dây rút chống thấm hình gấu broun [TIỆN LỢI] Túi dây rút tiện dụng",5000,5000,0,0
TIKI,nha-cua-doi-song,158973350,"Lư Đốt Trầm Hương, Lư Xông Trầm Bằng Gốm Sứ - Hàng Chính Hãng",45080,49000,3920,8
TIKI,nha-cua-doi-song,183335881,"RÈM VẢI MÀU XANH DƯƠNG TRƠN CHỐNG NẮNG, NHIỀU KÍCH THƯỚC LỰA CHỌN",75000,75000,0,0
TIKI,nha-cua-doi-song,194125023,"Khăn tắm sợi tre MORI xuất Nhật cao cấp 60x120cm",99160,148000,48840,33
TIKI,nha-cua-doi-song,113330027,"Đàn Piano Đàn Điện Tử 61 Phím Kèm mic Cho Bé Đàn Organ thương hiêu DORON",259000,259000,0,0
TIKI,nha-cua-doi-song,74380878," CHỔI LÔNG QUÉT BỤI CÁN INOX RÚT GỌN TẶNG KÈM MÓC TREO 3D",78000,78000,0,0
TIKI,nha-cua-doi-song,137672977,"Viên khử mùi tẩy bồn cầu toilet siêu sạch bóng (1 viên), sáp chống ố vàng mùi hôi, diệt sạch vi khuẩn gây hại",1000,6000,5000,83
TIKI,nha-cua-doi-song,68135337,"Kệ nhà tắm dán tường HT SYS-ECOCO-E1923-chất liệu ABS cao cấp kèm thanh treo khăn SUS 304",155000,155000,0,0
TIKI,nha-cua-doi-song,21576181,"Công Tắc Thông Minh SONOFF Điều Khiển Qua Wifi, Mạng 3G, 4G",105000,105000,0,0
TIKI,nha-cua-doi-song,56388392,"Set 100s Dây rút nhựa có bảng tên dùng để đánh dấu dây cáp - tặng kèm bút viết chống xóa",155000,155000,0,0
TIKI,nha-cua-doi-song,150171465,"Đèn năng lượng mặt trời 60W,45W,80W,100W,180W Solar light - D1082",422000,422000,0,0
TIKI,nha-cua-doi-song,108591833,"Thùng đựng gạo thông minh hàng cao cấp dung tích 12kg- Thương hiệu DORON",198000,198000,0,0
TIKI,nha-cua-doi-song,196946521,"Combo Bình giữ nhiệt + Hộp đựng thức ăn cho bé Lock&Lock LHC3283YEL + LLG510S3",411000,919000,508000,55
TIKI,nha-cua-doi-song,116813584,"Set 4 Kệ Gỗ Treo Tường Thanh Ngang SIB Decor Trang Trí Phòng Khách Góc Làm Việc, Tặng Kèm Phụ Kiện Giấu Chân",338000,350000,12000,3
TIKI,nha-cua-doi-song,186619847,"Chậu cây để bàn MONROVIA cho hoa, cây cảnh, ban công, bonsai",34000,34000,0,0
TIKI,nha-cua-doi-song,52731281,"Kéo Thép Đa Năng Nhật Bản, Size Lớn, Chất Liệu Thép Cao Cấp Không Gỉ",26000,35000,9000,26
TIKI,nha-cua-doi-song,103094362,"Kệ Nhà Tắm Để Đồ Dùng Thông Minh, Kèm Cốc Hút Từ Tính Có Nhả Kem Đánh Răng Tự Động",93599,119999,26400,22
TIKI,nha-cua-doi-song,25557453,"Đèn pin mini chiếu sáng dùng pin",47000,47000,0,0
TIKI,nha-cua-doi-song,174812493,"3500W-Phích cắm ổ cắm chuyển 3 chấu sang 2 chấu,Công suất lớn Toshino EA-ES",150000,150000,0,0
TIKI,dien-thoai-may-tinh-bang,249153684,"Điện thoại Realme C55 6GB/128GB Đen trời đêm - Hàng chính hãng",4680000,4990000,310000,6
TIKI,dien-thoai-may-tinh-bang,191764688,"Điện thoại Xiaomi Redmi 10A (2GB/32GB) - Hàng chính hãng",2556000,2556000,0,0
TIKI,dien-thoai-may-tinh-bang,249730338,"Điện Thoại 4G Masstel Lux 20 - 2 Sim 2 Sóng - Sóng 4G Hd Call - Loa To Rõ - Hàng Chính Hãng - Bảo Hành 12 Tháng",790000,790000,0,0
TIKI,dien-thoai-may-tinh-bang,273359931,"Điện Thoại Thông Minh siêu bền Oukitel WP27 (Ram 12GB,Rom 256GB,Màn hình 6.78 “FHD + ,pin 8300MAH,NFC, Android 13 ,CPU MTK G99,chống nước,chống sốc) –hàng chính hãng",6990000,6990000,0,0
TIKI,dien-thoai-may-tinh-bang,273958619,"Điện Thoại Xiaomi Redmi Note 13 6GB-128GB - Hàng chính hãng",4145000,4890000,745000,15
TIKI,dien-thoai-may-tinh-bang,205750556,"Điện Thoại Oppo A57 4GB/128GB - Hàng Chính Hãng",4632000,4632000,0,0
TIKI,dien-thoai-may-tinh-bang,274380639,"Điện thoại Oppo Reno11 F 5G (8GB/256GB) - Hàng Chính Hãng",7990000,8990000,1000000,11
TIKI,dien-thoai-may-tinh-bang,263041214,"Điện thoại Gaming Tecno POVA 4 8GB/128GB - Hàng Chính Hãng - MediaTek G99 | 6000mAh - 6.82 inch - Bảo hành 13 Tháng",3649000,4690000,1041000,22
TIKI,dien-thoai-may-tinh-bang,263675862,"Điện thoại OPPO A77 4GB+4GB/128GB - Sạc siêu nhanh 33W - Hàng nhập khẩu nhật - Bản quốc tế",3369000,4990000,1621000,32
TIKI,dien-thoai-may-tinh-bang,197045354,"ĐIỆN THOẠI MASSTEL LUX 20-4G  HÀNG CHÍNH HÃNG",750000,750000,0,0
TIKI,dien-thoai-may-tinh-bang,272392928,"Điện thoại Samsung Galaxy A05 (4GB/128GB) - Hàng chính hãng - ĐÃ KÍCH HOẠT BẢO HÀNH ĐIỆN TỬ",3090000,3090000,0,0
TIKI,dien-thoai-may-tinh-bang,167465856,"Điện thoại Masstel IZI 50 4G , Pin 1700 mah - Hàng chính hãng",419000,549000,130000,24
TIKI,dien-thoai-may-tinh-bang,249730336,"Điện Thoại Masstel Fami 60 4G LTE - Pin 2000 mAh - Chức Năng SOS - Hàng Chính Hãng - Bảo Hành 12 tháng",730000,730000,0,0
TIKI,dien-thoai-may-tinh-bang,263438008,"Điện thoại Masstel Hapi 30 4G Hàng Chính Hãng",2290000,2290000,0,0
TIKI,dien-thoai-may-tinh-bang,160051494,"Điện thoại Masstel FAMI 60 4G - Hàng chính hãng, Nguyên Seal",689000,689000,0,0
TIKI,dien-thoai-may-tinh-bang,273498357,"Điện Thoại Itel S23 16GB(8GB+8GB)/256GB | Pin 5000mAh | 6.6 Inch | Camera 50MP | HÀNG CHÍNH HÃNG",2490000,3490000,1000000,29
TIKI,dien-thoai-may-tinh-bang,274516245,"Điện thoại Masstel Fami 60S 4G(LTE) ,Bàn phím lớn, Khung viền kim loại - Hàng chính hãng",656000,750000,94000,13
TIKI,dien-thoai-may-tinh-bang,273411607,"Điện thoại Samsung Galaxy M14 5G (4GB/64GB) - Hàng chính hãng",2750000,3690000,940000,25
TIKI,dien-thoai-may-tinh-bang,105830021,"Máy Tính Bảng Samsung Galaxy Tab A7 Lite LTE T225 (3GB/32GB) ĐÃ KÍCH HOẠT BẢO HÀNH ĐIỆN TỬ - Hàng Chính Hãng",3587000,3587000,0,0
TIKI,dien-thoai-may-tinh-bang,272328188,"Điện Thoại Samsung A05 4GB/128GB - Hàng Chính Hãng",2649000,3090000,441000,14
TIKI,dien-thoai-may-tinh-bang,274542983,"Điện Thoại Samsung A05 6GB/128GB - Hàng Chính Hãng",3049000,3490000,441000,13
TIKI,dien-thoai-may-tinh-bang,270471101,"Điện Thoại Nokia 110 4G Pro TA-1559 - Hàng Chính Hãng",650000,710000,60000,8
TIKI,dien-thoai-may-tinh-bang,201003623,"Điện thoại Masstel Fami 12 4G Dành cho người già - Hàng chính hãng",630000,630000,0,0
TIKI,dien-thoai-may-tinh-bang,271972435,"iPhone 15 Pro 128GB Titan Đen",25490000,27990000,2500000,9
TIKI,dien-thoai-may-tinh-bang,273684137,"Máy tính bảng quản lý thời gian sử dụng dành cho trẻ em Masstel Kidzone-1 đổi 1 trong vòng 100 ngày",1990000,1990000,0,0
TIKI,dien-thoai-may-tinh-bang,252427658,"Điện thoại Tecno SPARK 10 Pro 8GB/128GB - Helio G88 | 5000 mAh | Sạc nhanh 18W | Cảm ứng vân tay - Hàng chính hãng",3679000,3990000,311000,8
TIKI,dien-thoai-may-tinh-bang,274095168,"Điện thoại Xiaomi Redmi A2+ (3GB/64GB) - Hàng Chính Hãng",1890000,2790000,900000,32
TIKI,dien-thoai-may-tinh-bang,160556149,"Máy tính bảng Samsung Galaxy Tab A8 - Hàng chính hãng",5856000,5856000,0,0
TIKI,dien-thoai-may-tinh-bang,16518729,"Điện thoại để bàn Panasonic KX-TS580 hàng chính hãng",850000,850000,0,0
TIKI,dien-thoai-may-tinh-bang,272056193,"Điện Thoại Xiaomi Redmi Note 12 8GB/128GB - Hàng Chính Hãng",4029000,5790000,1761000,30
TIKI,dien-thoai-may-tinh-bang,250111470,"Điện thoại Xiaomi Redmi Note 12 (8GB/128GB) - Hàng chính hãng",4190000,5790000,1600000,28
TIKI,dien-thoai-may-tinh-bang,273872197,"Máy Tính Bảng Samsung Galaxy Tab A9 Wifi 4GB/64GB - Hàng Chính Hãng",2739000,3990000,1251000,31
TIKI,dien-thoai-may-tinh-bang,271530789,"Combo Máy đọc sách All New Kindle Paperwhite 5 (11th) KIDS EDITTION (KHÔNG QUẢNG CÁO) và Bao da - Hàng chính hãng",4064300,4190000,125700,3
TIKI,dien-thoai-may-tinh-bang,197670818,"Điện thoại Samsung Galaxy A04s (4GB/64GB) - Hàng chính hãng",2590000,3990000,1400000,35
TIKI,dien-thoai-may-tinh-bang,274186881,"Máy tính bảng Samsung Galaxy Tab A9+ Wifi (4GB/64GB) - Hàng chính hãng",5990000,5990000,0,0
TIKI,dien-thoai-may-tinh-bang,273411606,"Điện thoại Samsung Galaxy M14 5G (4GB/128GB) - Hàng chính hãng",3590000,3990000,400000,10
TIKI,dien-thoai-may-tinh-bang,274405521,"Điện Thoại Samsung A05 4GB/64GB - Hàng Chính Hãng",2409000,2990000,581000,19
TIKI,dien-thoai-may-tinh-bang,274101255,"Máy Tính Bảng Samsung Galaxy Tab A9 Wifi 4GB/64GB - Hàng Chính Hãng",2650000,3990000,1340000,34
TIKI,dien-thoai-may-tinh-bang,270814412,"Điện thoại Tecno CAMON 20 Premier 5G - 8GB/512GB | Dimensity 8050| Cụm Camera 108+50+ 2MP | AMOLED - Tần số quét 120Hz - Hàng chính hãng",11990000,11990000,0,0
TIKI,dien-thoai-may-tinh-bang,158742790,"Máy tính bảng Samsung Galaxy Tab A8 (4GB/64GB) - Hàng Chính Hãng",5856000,5856000,0,0
TIKI,nha-cua-doi-song,26062785,"Combo 50 Đinh 3 Chân Treo Ảnh Không Cần Khoan Milliken",39000,39000,0,0
TIKI,nha-cua-doi-song,70191598,"Combo 8 Viên Pin AA đỏ Chính Hãng Maxell",25000,25000,0,0
TIKI,nha-cua-doi-song,112606822,"Bộ 8 Móc treo Quần áo gấp gọn tiện dụng Có 2 nấc cho trẻ em và người lớn Mang theo du lịch - Nhựa",55000,55000,0,0
TIKI,nha-cua-doi-song,135450957,"Set 10 Móc Treo Dán Tường Mini, Móc Treo Đồ Nhỏ Gắn Hình Cute - Giao Màu Hình Ngẫu Nhiên",22000,22000,0,0
TIKI,nha-cua-doi-song,101893893,"Giỏ Đựng Đồ Rửa Chén Bát Silicon Treo Bồn Rửa Bát cao cấp",9999,9999,0,0
TIKI,nha-cua-doi-song,53954421,"Pin D Energizer Max E95 BP2",117000,150000,33000,22
TIKI,nha-cua-doi-song,205495107,"Hộp 24 Quả Châu 4CM Nhũ Kim Tuyến Lấp Lánh Trang Trí Noel, Giáng Sinh 4CM",98700,98700,0,0
TIKI,nha-cua-doi-song,191911126,"Kệ giày thông minh, tủ giày gỗ đa năng 4 tầng cánh tủ trắng, hai bên kèm kệ phong cách hiện đại 78x30x78 TAGO ND22",270749,284999,14250,5
TIKI,nha-cua-doi-song,109351669,"Kệ Sách Đứng Để Sàn FIVO Mã FB70 Chất Liệu Gỗ MDF Chống Thấm Bề Mặt Cực Tốt, Chia Ngăn Tiện Lợi, Kiểu Dáng Hiện Đại (Kích thước 80x24x178cm)",1319000,1867000,548000,29
TIKI,nha-cua-doi-song,101587122,"Áo Mưa, Áo Mưa Trong Suốt Chống Thấm Thời Trang Hàn Quốc",38000,38000,0,0
TIKI,nha-cua-doi-song,142312235,"Nệm PE Hàn Quốc cao cấp gấp 3 ( 1m2 x 2m x 3cm)  tặng 1 cặp áo gối nằm màu ngẫu nhiên",222000,270000,48000,18
TIKI,nha-cua-doi-song,97454973,"Giá kệ để đồ rửa chén bếp treo khăn lau siêu tiện lợi, kệ thép không gỉ khay hứng nước khô ráo VANDO",175000,330000,155000,47
TIKI,nha-cua-doi-song,984242,"Kèn Melodion - Melodica Suzuki MX-32D 32 Phím",599000,599000,0,0
TIKI,nha-cua-doi-song,79323086,"Đèn Ngủ kiêm Đèn Chiếu Ngàn Sao 6 phong cách xoay tự động, tích hợp phát nhạc bằng Bluetooth nhiều hiệu ứng, sạc bằng USB",380000,380000,0,0
TIKI,nha-cua-doi-song,193615690,"Bàn Làm Việc Học Tập Thông Minh Gấp Gọn Tùy Chỉnh Độ Cao Mặt Bàn Nghiêng 90 Độ Thích Hợp Nhiều Không Gian - Hàng Chính Hãng",620000,899000,279000,31
TIKI,nha-cua-doi-song,139815701,"Sào phơi đôi inox cao cấp có 2 thanh để đồ",180000,180000,0,0
TIKI,nha-cua-doi-song,186816987,"Dụng Cụ Mài Dao, Kéo 3 Rãnh Inox Jodily Đa Năng Dễ Sử Dụng",135000,135000,0,0
TIKI,nha-cua-doi-song,172527718,"Set 50 Giấy Nến Lót Nồi Chiên Không Dầu Siêu Tiện Dụng (Tặng 1 Cọ Quét Silicone)",17999,17999,0,0
TIKI,nha-cua-doi-song,162743067,"Bộ 1 Viên Pin Cell Panasonic NCR18650GA 3500 mAh , Pin 18650 dung lượng cao , Xả cao",129000,150000,21000,14
TIKI,nha-cua-doi-song,274121892,"Vỏ Áo gối nằm Thuần Việt - Lụa Tencel Thoáng Mát, Thấm Hút Mồ Hôi Tốt - Họa Tiết Hoa Văn - Đa Dạng Họa Tiết",130000,220000,90000,41
TIKI,nha-cua-doi-song,176728501,"Bàn trang điểm gương viền LED phong cách Nordic thương hiệu IGA- GP196",608000,660000,52000,8
TIKI,nha-cua-doi-song,91443194,"Dụng cụ Mở Rượu Vang Chuyên Dụng bằng Thép không gỉ Đẳng Cấp và Sang Trọng",89000,150000,61000,41
TIKI,nha-cua-doi-song,117207768,"Biến Áp Đổi Nguồn Hạ Áp LiOA - Biến Áp Đổi Nguồn LiOA 1000/1200/1500/2000VA( Điện Vào 220V- Điện Ra 100/120V) - MITA",495000,495000,0,0
TIKI,nha-cua-doi-song,31976047,"Màn cuốn văn phòng cao cố định 1m4 - MC-02",363999,363999,0,0
TIKI,nha-cua-doi-song,136605740,"Áo Bọc Bàn Để Ủi Nguyễn Trường Thắng - Ironing Board Cover",70000,70000,0,0
TIKI,nha-cua-doi-song,74651405,"Chai rót dầu ăn, nước tương thủy tinh bọc Inox 304 cao cấp 300ml bằng thủy tinh chai hũ lọ gia vị dụng cụ nhà bếp tiện ích VANDO",35000,50000,15000,30
TIKI,nha-cua-doi-song,71518871,"Nồi Decor Lock&Lock LDE1244IH Hai Tay Cầm (24cm) - Màu Mint",703000,1171000,468000,40
TIKI,nha-cua-doi-song,105310094,"Cell Pin 18650 LS Xanh  2000mAh  - Pin LS Sử Dụng Cho Máy Khoan,Pin Sạc Dự Phòng",25000,25000,0,0
TIKI,nha-cua-doi-song,59471210,"Bộ 3 Túi Đựng Chăn Màn Khung Sắt Gấp Gọn miDoctor (CÓ CHỌN MÀU)",248000,400000,152000,38
TIKI,nha-cua-doi-song,46235645,"Bộ nội quy tiêu lệnh Phòng cháy chữa cháy chất liệu tôn cao cấp",125000,175000,50000,29
TIKI,nha-cua-doi-song,67303104,"Đồng Hồ Treo Tường Kim Trôi Họa Tiết Sang Trọng Cao Cấp",107000,107000,0,0
TIKI,nha-cua-doi-song,130470014,"Vỏ trứng gà Sfarm đã qua xử lý",35000,35000,0,0
TIKI,nha-cua-doi-song,165085520,"Bộ Thìa Đũa  Cá Nhân Văn Phòng  3 Món Lúa Mạch Chất Liệu Inox 304 Không Rỉ Kèm Hộp- Hàng Loại 1 - Chính Hãng MINIIN",28000,43000,15000,35
TIKI,nha-cua-doi-song,164433381,"Bộ Đèn PHILIPS LED Âm Trần MESON IO Thế Hệ Mới - 5W 7W 9W 13W",100100,103200,3100,3
TIKI,nha-cua-doi-song,177971994,"[GDSG147] Muỗng Múc Xới Cơm Có Đế Đứng Hình Chú Thỏ Chất Liệu Nhựa Lúa Mì Thiên Nhiên [Tiện lợi]",9000,9000,0,0
TIKI,nha-cua-doi-song,253081471,"Miếng rửa chén đa năng sợi tre MyJae, miếng rửa chén chống xước 2 mặt, siêu bền đánh bay dầu bẩn",35000,69000,34000,49
TIKI,nha-cua-doi-song,126730148,"Hộp cơm thủy tinh 2,3 ngăn, hộp thủy tinh đựng thức ăn NIKKO INOCHI chính hãng",81600,81600,0,0
TIKI,nha-cua-doi-song,138173087,"Cuộn Decal Dán Bếp Chọn Chiều Dài Giấy Decal Dán Tường Tráng Nhôm Cách Nhiệt Cao Cấp Chính Hãng",35000,50000,15000,30
TIKI,nha-cua-doi-song,4166657,"Máy sạc Pin  ENERGIZER CHVC4 (kèm 4 viên pin sạc AA 1300 mAh)",327000,330000,3000,1
TIKI,nha-cua-doi-song,78964736,"Chốt Khóa Cài Cửa Có Lỗ Cài KUNBE, Chốt Cửa Khóa Gài Cây Gạt, An Toàn Cao Cấp Tiện Dụng",32000,32000,0,0
TIKI,dien-thoai-may-tinh-bang,270814388,"Điện thoại Tecno POVA 5 (8+8)/128GB - MediaTek Helio G99 - Sạc nhanh 45W - 6.8'' FHD+120HZ - Hàng Chính Hãng - BH 13 Tháng",3690000,4490000,800000,18
TIKI,dien-thoai-may-tinh-bang,217276360,"Điện thoại Mobell F209 4G ,Loa to, Phím lớn - Hàng chính hãng",567000,670000,103000,15
TIKI,dien-thoai-may-tinh-bang,272151221,"Điện thoại Xiaomi Redmi 10 2022 (4GB/128GB) - Hàng chính hãng",2690000,3990000,1300000,33
TIKI,dien-thoai-may-tinh-bang,273951550,"Điện Thoại Samsung Galaxy A15 LTE (8GB/128GB)- Đã Kích Hoạt Bảo Hành Điện tử - Hàng Chính Hãng",4290000,4990000,700000,14
TIKI,dien-thoai-may-tinh-bang,273668660,"Điện Thoại Oppo A18 4GB/64GB - Hàng Chính Hãng",3329000,3690000,361000,10
TIKI,dien-thoai-may-tinh-bang,248762051,"Điện Thoại Samsung A34 5G 8GB/128GB - Hàng Chính Hãng",5939000,8490000,2551000,30
TIKI,dien-thoai-may-tinh-bang,273367316,"Điện Thoại Xiaomi Redmi 13C 6GB/128GB - Hàng Chính Hãng",2979000,3490000,511000,15
TIKI,dien-thoai-may-tinh-bang,274365104,"Điện thoại Xiaomi Redmi Note 13 Pro (8GB/128GB) - Hàng Chính Hãng",5990000,7290000,1300000,18
TIKI,dien-thoai-may-tinh-bang,274456447,"Điện thoại Samsung Galaxy A35 5G (8GB/128GB) - Hàng chính hãng",7949000,8290000,341000,4
TIKI,dien-thoai-may-tinh-bang,173789184,"Điện thoại bàn treo tường TC990",250000,250000,0,0
TIKI,dien-thoai-may-tinh-bang,273165324,"Điện thoại Xiaomi Redmi A2 (2GB/32GB) - Hàng chính hãng",2190000,2190000,0,0
TIKI,dien-thoai-may-tinh-bang,273348837,"Điện thoại Xiaomi Redmi 13C (6GB/128GB) - Hàng chính hãng",2890000,3290000,400000,12
TIKI,dien-thoai-may-tinh-bang,191636459,"Điện thoại Masstel IZI 11 4G - Hàng chính hãng",468000,468000,0,0
TIKI,dien-thoai-may-tinh-bang,203853390,"Điện Thoại Oppo A17k (3GB/64GB)",2390000,3290000,900000,27
TIKI,dien-thoai-may-tinh-bang,203278278,"Điện Thoại Samsung A04 3GB/32GB - Hàng Chính Hãng",2159000,2990000,831000,28
TIKI,dien-thoai-may-tinh-bang,103168844,"Máy tính bảng Samsung Galaxy Tab A7 Lite LTE SM-T225) - ĐÃ KÍCH HOẠT ĐIỆN TỬ - Hàng Chính Hãng",3587000,3587000,0,0
TIKI,dien-thoai-may-tinh-bang,273897681,"Điện thoại Tecno SPARK GO 2024 (4+4)GB/64GB - Unisoc T606 | 5000 mAh | 6,6" HD+ | Hàng Chính Hãng",2009000,2190000,181000,8
TIKI,dien-thoai-may-tinh-bang,272241346,"Điện thoại Samsung Galaxy A05s (4GB/128GB) - Hàng chính hãng",3990000,3990000,0,0
TIKI,dien-thoai-may-tinh-bang,273683300,"Điện thoại Samsung Galaxy A15 LTE (8GB/128GB) - Hàng chính hãng",4990000,4990000,0,0
TIKI,dien-thoai-may-tinh-bang,271967379,"iPhone 15 Plus",22490000,25990000,3500000,13
TIKI,dien-thoai-may-tinh-bang,271799133,"Máy tính bảng chắc chắn oukitel RT5 (chống nước,chống va đập,pin 11.000mAh,Màn hình 10.1 inch FHD, Ram 14Gb,Rom 256Gb, CPU : Mediatek 8788,lõi 8, lên đến 2.0 GHz, Camera Trước,sau 16 MP, Android 13)- hàng chính hãng",7490000,7490000,0,0
TIKI,dien-thoai-may-tinh-bang,273653444,"Máy tính bảng Kindle Fire Hd 10 2023 13th - Hàng nhập khẩu",3790000,3790000,0,0
TIKI,dien-thoai-may-tinh-bang,272056889,"Điện Thoại Samsung A24 6GB/128GB - Hàng Chính Hãng",4789000,6490000,1701000,26
TIKI,dien-thoai-may-tinh-bang,213858174,"Máy tính bảng Samsung Galaxy Tab A7 Lite (3GB/32GB) - Hàng chính hãng - Màn hình 8.7inch TFT LCD, Camera sau 8MP - Bảo Hành 12 Tháng",3587000,3587000,0,0
TIKI,dien-thoai-may-tinh-bang,217559440,"Điện thoại Samsung Galaxy A03s (3GB/32GB) - Hàng chính hãng",2990000,2990000,0,0
TIKI,dien-thoai-may-tinh-bang,270544863,"Điện Thoại Samsung Galaxy A24 (8GB/128GB) - Hàng Chính Hãng",6084000,6084000,0,0
TIKI,dien-thoai-may-tinh-bang,204802771,"Điện thoại Oppo A57 (4GB/128GB) - Hàng chính hãng",4632000,4632000,0,0
TIKI,dien-thoai-may-tinh-bang,225936344,"Máy tính bảng Samsung Galaxy Tab A8 (4GB/64GB) - Hàng Chính Hãng",5856000,5856000,0,0
TIKI,dien-thoai-may-tinh-bang,215746882,"Điện thoại OPPO Reno8T 4G - Hàng chính hãng",8136000,8136000,0,0
TIKI,dien-thoai-may-tinh-bang,273029857,"Điện Thoại Samsung Galaxy A05s (4GB/128GB) - Hàng Chính Hãng",3980000,3980000,0,0
TIKI,dien-thoai-may-tinh-bang,251448280,"Samsung Galaxy A34 5G A346E (8+128G) Silver Bạc - Hàng Chính Hãng (chỉ giao HN và một số khu vực)",7164000,7164000,0,0
TIKI,dien-thoai-may-tinh-bang,248655651,"Điện Thoại Samsung Galaxy A14 5G (4GB/128GB) - Hàng chính hãng - ĐÃ KÍCH HOẠT BẢO HÀNH ĐIỆN TỬ",5000000,5000000,0,0
TIKI,dien-thoai-may-tinh-bang,253443788,"Điện Thoại Samsung Galaxy M14 5G (4GB/64GB) - Hàng Chính Hãng",6000000,6000000,0,0
TIKI,dien-thoai-may-tinh-bang,196197701,"Điện thoại Samsung Galaxy Z Fold4 5G (12GB/256GB) - Hàng chính hãng",40990000,40990000,0,0
TIKI,dien-thoai-may-tinh-bang,219397711,"Điện thoại Samsung Galaxy A14 5G A146P (4+128G) Đen - Hàng Chính Hãng (chỉ giao HN và một số khu vực)",5080000,5080000,0,0
TIKI,dien-thoai-may-tinh-bang,263060294,"Điện thoại di động Samsung A24 (6G/128G) - Hàng chính hãng - Đã kích hoạt bảo hành điện tử",5808000,5808000,0,0
TIKI,dien-thoai-may-tinh-bang,267178005,"Điện thoại Samsung Galaxy A24 - Hàng chính hãng",5808000,5808000,0,0
TIKI,dien-thoai-may-tinh-bang,273610105,"Điện Thoại Samsung Galaxy A05 - Hàng Chính Hãng",3025000,3025000,0,0
TIKI,dien-thoai-may-tinh-bang,242712931,"Điện thoại Samsung Galaxy S23 Ultra 512GB - Hàng chính hãng",36990000,36990000,0,0
TIKI,dien-thoai-may-tinh-bang,219392186,"Điện thoại OPPO CPH2471 - A17k Vàng - Hàng Chính Hãng (chỉ giao HN và một số khu vực)",3276000,3276000,0,0
TIKI,dien-thoai-may-tinh-bang,274524742,"Điện thoại Fonrox F2163 4G , Gọi HD Call , Lướt WEB , 2 sim 2 sóng - Hàng chính hãng",339000,399000,60000,15
TIKI,dien-thoai-may-tinh-bang,197143907,"Điện thoại POCO M5 4GB+64GB/6GB+128GB | Pin 5000mAh | MediaTek Helio G99 | Sạc nhanh 18W - Hàng chính hãng",2599000,3990000,1391000,35
TIKI,dien-thoai-may-tinh-bang,273947792,"Điện thoại AI Samsung Galaxy S24 Ultra 12GB/256GB, Camera 200MP Zoom 100x, S Pen- Đen- Hàng Chính Hãng",31990000,34490000,2500000,7
TIKI,dien-thoai-may-tinh-bang,214756058,"Máy đọc sách New Kindle 11th 2022 (16GB) - Hàng chính hãng",2920000,2920000,0,0
TIKI,dien-thoai-may-tinh-bang,263798932,"Máy đọc sách Boox Page - Hàng Chính Hãng",6700000,7990000,1290000,16
TIKI,dien-thoai-may-tinh-bang,272238679,"Điện thoại Samsung Galaxy A05 (4GB/128GB) - Hàng chính hãng",3090000,3090000,0,0
TIKI,dien-thoai-may-tinh-bang,273175604,"Máy đọc sách Boox Note Air 3 C - Hàng Chính Hãng",13980000,15990000,2010000,13
TIKI,dien-thoai-may-tinh-bang,58146831,"Điện Thoại Cổ Điển DT150 - Bản Dây Line",2500000,2500000,0,0
TIKI,dien-thoai-may-tinh-bang,247829297,"Điện thoại Realme C55 (8GB/256GB) - Hàng chính hãng",4470000,5690000,1220000,21
TIKI,dien-thoai-may-tinh-bang,191689727,"Điện thoại OPPO CPH2387 - A57 Đen - Hàng Chính Hãng",4284000,4284000,0,0
TIKI,dien-thoai-may-tinh-bang,261962220,"Điện Thoại Samsung Galaxy A24 (6GB/128GB) - Hàng Chính Hãng",5808000,5808000,0,0
TIKI,dien-thoai-may-tinh-bang,271822725,"Máy Tính Bảng Samsung Galaxy Tab A8 2022 (3GB/32GB) - Hàng Chính Hãng",5856000,5856000,0,0
TIKI,dien-thoai-may-tinh-bang,205897182,"Máy tính bảng Xiaomi Redmi Pad (3GB/64GB) - Hàng chính hãng",6290000,6290000,0,0
TIKI,dien-thoai-may-tinh-bang,271284934,"Máy tính bảng Edutab 10.4 & Case da tặng Quà hot Hệ thống quản lý học tập & kiểm soát dành cho Phụ huynh trọn đời - Hàng Chính Hãng",5769000,5769000,0,0
TIKI,dien-thoai-may-tinh-bang,176438844,"Điện thoại Xiaomi REDMI 9A (2+32) Xanh lá - Hàng chính hãng (chỉ giao HN và một số khu vực)",2088000,2088000,0,0
TIKI,dien-thoai-may-tinh-bang,189658085,"Điện Thoại Oppo A57 (4GB/64GB)",4284000,4284000,0,0
TIKI,dien-thoai-may-tinh-bang,192036708,"Điện Thoại OPPO A57 (4GB/128GB) - Hàng Chính Hãng",4632000,4632000,0,0
TIKI,dien-thoai-may-tinh-bang,165747145,"Điện thoại Xiaomi Redmi 9A 2GB/32GB - Chip MediaTek Helio G25 8 nhân (12 nm), Màn hình 6.53" HD+, Camera 13MP, Pin 5000 - Hàng Chính Hãng",2160000,2160000,0,0
TIKI,dien-thoai-may-tinh-bang,225912504,"Điện Thoại Forme D111 - Hàng Chính Hãng",499000,519000,20000,4
TIKI,dien-thoai-may-tinh-bang,217158529,"Máy tính bảng Samsung Galaxy Tab A7 Lite - Hàng chính hãng",3587000,3587000,0,0
TIKI,dien-thoai-may-tinh-bang,262706645,"Máy đọc sách kindle 2022 11th - hàng chính hãng",2790000,2790000,0,0
TIKI,dien-thoai-may-tinh-bang,170449059,"Điện Thoại Masstel Izi 20 4G - Loa To, Pin Trâu, 2 Sim 2 Sóng, Hỗ Trợ 4G VoLTE, Đèn Pin Sáng, Giá Rẻ - Hàng Chính Hãng",482000,489000,7000,1
TIKI,dien-thoai-may-tinh-bang,181699053,"Điện thoại Xiaomi Redmi 9A - Hàng chính hãng",2088000,2088000,0,0
TIKI,dien-thoai-may-tinh-bang,217505430,"Máy tính bảng Kindle Fire HD8 2022 (Fire HD 8 12th) - Màn hình 8inch HD, RAM 2GB, CPU Hexa-core 2.0 GHz, CÀI ĐƯỢC CH PLAY- Hàng nhập khẩu",2050000,2050000,0,0
TIKI,dien-thoai-may-tinh-bang,249143473,"Điện thoại Samsung Galaxy A34 5G (8GB/128GB) - Hàng chính hãng - ĐÃ KÍCH HOẠT BẢO HÀNH ĐIỆN TỬ",7164000,7164000,0,0
TIKI,dien-thoai-may-tinh-bang,274638822,"Điện thoại Xiaomi Redmi Note 12 Turbo , Snapdragon 7 Gen 2 , Màn OLED 120Hz , Sạc nhanh 67W , Rom tiếng việt  - Hàng nhập khẩu",5999000,7990000,1991000,25
TIKI,dien-thoai-may-tinh-bang,195177036,"Máy tính bảng Samsung Galaxy Tab A7 Lite LTE SM-T225 - Hàng Chính Hãng",3587000,3587000,0,0
TIKI,dien-thoai-may-tinh-bang,274160702,"Điện thoại Samsung Galaxy S24 Ultra - Hàng chính hãng",28390000,33990000,5600000,16
TIKI,dien-thoai-may-tinh-bang,115830124,"Điện Thoại Xiaomi Redmi 9A (2GB/32GB)- Đã kích hoạt bảo hành điện tử- Hàng Chính Hãng - Sky Blue",2088000,2088000,0,0
TIKI,dien-thoai-may-tinh-bang,248929458,"Điện thoại Samsung Galaxy A34 5G (8GB/128GB) - Hàng chính hãng",7164000,7164000,0,0
TIKI,dien-thoai-may-tinh-bang,273650151,"Điện thoại siêu bền Ulefone Power Armor X11(chống nước,chống va đập , Ram8 GB(4gb+4gb),Rom 32 GB, NFC, Helio G25, WiFi 2.4G/5G, Pin 8150 Mah,)-hàng chính hãng",3290000,3290000,0,0
TIKI,dien-thoai-may-tinh-bang,248005118,"Điện Thoại Samsung Galaxy A34 5G (8GB/128GB) - Hàng Chính Hãng",7164000,7164000,0,0
TIKI,dien-thoai-may-tinh-bang,274524050,"Điện thoại Masstel izi T2 4G(LTE), Màn hình 2.4 inch, Đèn pin siêu sáng, Loa to - Hàng chính hãng",489000,550000,61000,11
TIKI,dien-thoai-may-tinh-bang,270447782,"Điện thoại Nokia C32 (4GB/128GB) - Hàng chính hãng",2090000,3290000,1200000,36
TIKI,dien-thoai-may-tinh-bang,245770806,"Điện thoại Samsung Galaxy A14 LTE (4GB/128GB) - Hàng chính hãng",3672000,3672000,0,0
TIKI,dien-thoai-may-tinh-bang,249730334,"Điện Thoại Masstel Izi 20 4G LTE - 2 sim -Pin 1700 mAh - Loa To - Camera 0.08 MP - Hàng Chính Hãng - Bảo Hành 12 Tháng",512000,512000,0,0
TIKI,dien-thoai-may-tinh-bang,172920927,"Điện thoại Masstel izi 12 4G - Hàng chính hãng",10000000,10000000,0,0
TIKI,dien-thoai-may-tinh-bang,242712374,"Điện thoại Samsung Galaxy S23 Ultra 256GB - Hàng chính hãng",31990000,31990000,0,0
TIKI,dien-thoai-may-tinh-bang,249730342,"Điện Thoại Masstel Fami 12 4G LTE - 2 Sim- Pin 1400 mAh - Đọc số bằng giọng nói - Hàng Chính Hãng - Bảo Hành 12 Tháng",630000,630000,0,0
TIKI,dien-thoai-may-tinh-bang,261964853,"Điện thoại ulefone note 16 pro (Ram 16Gb(8+8),rom 128Gb,android 13 , camera 50MP,pin 4.400mAhm, Mở khóa vân tay, Mở khóa bằng khuôn mặt )-hàng chính hãng",5990000,5990000,0,0
TIKI,dien-thoai-may-tinh-bang,247925719,"Điện thoại Samsung Galaxy A14  (4GB/128GB) - Hàng Chính Hãng - Đã kích hoạt bảo hành điện tử",3672000,3672000,0,0
TIKI,dien-thoai-may-tinh-bang,272394241,"Điện thoại Samsung Galaxy A05s (4Gb/128Gb) - Hàng chính hãng - Đã kích hoạt bảo hành điện tử",3260000,3990000,730000,18
TIKI,dien-thoai-may-tinh-bang,273398391,"Điện thoại Ulefone Armor 18T (Ram 12Gb,Rom 256Gb,Camera 108MP,camera nhiệt FLIR,Pin 9600 mAh,5G,chống nước,chống va đập)-hàng chính hãng",14990000,14990000,0,0
TIKI,dien-thoai-may-tinh-bang,254125720,"Điện thoại oukitel WP22 (Loa to,Chống nước ,chống sốc IP68/IP69K,Ram 13Gb(8GB+5Gb mở rộng),Rom 256Gb,Màn hình 6.58 FHD,tầm nhìn ban đêm,Pin 10.000mAh)- Hàng chính hãng",5990000,5990000,0,0
TIKI,dien-thoai-may-tinh-bang,217548686,"Máy đọc sách Kindle Scribe – thế hệ đầu tiên có thể đọc và viết, màn hình 10,2” 300PPI, đèn vàng warmlight, bộ nhớ 16-64GB, đồng bộ dữ liệu qua Microsoft Word - hàng nhập khẩu",11390000,11390000,0,0
TIKI,dien-thoai-may-tinh-bang,198868573,"Điện thoại IP Grandstream GRP 2601P hàng chính hãng",1050000,1050000,0,0
TIKI,dien-thoai-may-tinh-bang,272397263,"Điện thoại Xiaomi 13T Pro (12GB/512GB) - Hàng chính hãng",16990000,16990000,0,0
TIKI,dien-thoai-may-tinh-bang,270260682,"Điện thoại Gaming Tecno POVA 4 8GB/128GB - Hàng Chính Hãng - MediaTek G99 | 6000mAh - 6.82 inch - Bảo hành 13 Tháng",3499000,4690000,1191000,25
TIKI,dien-thoai-may-tinh-bang,271954384,"Điện thoại OPPO A58 6GB/128GB , Sạc nhanh 33W - Hàng Chính Hãng",4311000,4990000,679000,14
TIKI,dien-thoai-may-tinh-bang,262304313,"Điện thoại Xiaomi Redmi Note 12S (8GB/256GB) - Hàng chính hãng",5019000,6690000,1671000,25
TIKI,dien-thoai-may-tinh-bang,195894801,"Masstel izi 26 4G - Chữ to - Loa to - Hàng Chính Hãng",489000,650000,161000,25
TIKI,dien-thoai-may-tinh-bang,274424330,"Điện thoại Người Già Good A60 Pro 4G (LTE) Gọi HD Call , Có SOS , Màn lớn - Phím to - Pin trâu - Sạc Type C - Hàng nhập khẩu",469000,490000,21000,4
TIKI,dien-thoai-may-tinh-bang,212926651,"Điện Thoại Samsung Galaxy S20 FE 8GB/256GB - Hàng Chính Hãng - Đã Kích Hoạt Bảo Hành Điện Tử",8625000,8625000,0,0
TIKI,dien-thoai-may-tinh-bang,230203067,"Điện thoại OPPO A55s 5G 4GB/64GB - Màn 90hz - Chống nước IP68 - Hàng nhập khẩu - Bản quốc tế",2841000,3699000,858000,23
TIKI,dien-thoai-may-tinh-bang,274164375,"Máy Tính Bảng Samsung Galaxy Tab A9 Plus WIFI 4GB-64GB - Hàng chính hãng",4350000,5990000,1640000,27
TIKI,dien-thoai-may-tinh-bang,272850971,"Điện thoại Libero 5G III - 4/64GB Dimensity 700 ,Màn OLED ,Kháng nước IP57 - Hàng nhập khẩu nhật",2244000,2990000,746000,25
TIKI,dien-thoai-may-tinh-bang,270814316,"Điện thoại Tecno POVA 5 (8+8)/256GB - MediaTek Helio G99 - Sạc nhanh 45W - 6.8'' FHD+120HZ - Hàng Chính Hãng -  BH 13 Tháng",4529000,5290000,761000,14
TIKI,dien-thoai-may-tinh-bang,270625677,"Điện Thoại Oppo A78 8GB/256GB - Hàng Chính Hãng",5969000,6990000,1021000,15
TIKI,dien-thoai-may-tinh-bang,217645692,"Combo Máy đọc sách All New Kindle Paperwhite 5 (11th Gen) - 16Gb và Bao da - Hàng nhập khẩu",3980000,3980000,0,0
TIKI,dien-thoai-may-tinh-bang,214603586,"Điện Thoại Samsung Galaxy A04e (3GB/32GB)- Hàng Chính Hãng",1998000,2690000,692000,26
TIKI,dien-thoai-may-tinh-bang,274638659,"Điện Thoại Xiaomi Redmi Note 13 Pro 5G 8GB/128GB Snapdragon 7s Gen 2 , Màn OLED 120Hz, Rom Tiếng việt - Hàng nhập khẩu",5290000,6990000,1700000,24
TIKI,dien-thoai-may-tinh-bang,273990229,"Điện Thoại Xiaomi Redmi Note 13 6GB/128GB - Hàng Chính Hãng",4289000,4890000,601000,12
TIKI,dien-thoai-may-tinh-bang,207914534,"Điện Thoại Nokia 5710 XpressAudio - Hàng Chính Hãng",1599000,1790000,191000,11
TIKI,dien-thoai-may-tinh-bang,271329051,"Máy tính bảng Kindle Fire MAX 11, màn hình 11 inch, RAM 4GB, CPU Octa-core 2.2Ghz, bộ nhớ 64/128GB - Hàng chính hãng",5300000,5500000,200000,4
TIKI,dien-thoai-may-tinh-bang,274415640,"Điện Thoại Xiaomi Redmi Note 13 Pro 8GB/128GB - Hàng Chính Hãng",6329000,7290000,961000,13
TIKI,dien-thoai-may-tinh-bang,272323566,"Điện Thoại Samsung M34 5G 8GB/128GB - Hàng Chính Hãng",6179000,7990000,1811000,23
TIKI,dien-thoai-may-tinh-bang,274186112,"Máy tính bảng Samsung Galaxy Tab A9 Wifi (4GB/64GB) - Hàng chính hãng",3990000,3990000,0,0
TIKI,dien-thoai-may-tinh-bang,252884932,"Tay con điện thoại bàn Panasonic TGCA30- Hàng chính hãng-Chỉ xài được khi đã có máy mẹ",750000,750000,0,0
TIKI,dien-thoai-may-tinh-bang,274172292,"Điện thoại Samsung Galaxy A05 (4GB/64GB) - Hàng chính hãng",2990000,2990000,0,0
TIKI,dien-thoai-may-tinh-bang,198648645,"Điện thoại Xiaomi Redmi A1 (2GB/32GB)",1715000,2190000,475000,22
TIKI,dien-thoai-may-tinh-bang,270714226,"Điện Thoại Itel S23 4GB/128GB | Pin 5000mAh | 6.6 Inch | Camera 50MP | HÀNG CHÍNH HÃNG",2290000,2590000,300000,12
TIKI,dien-thoai-may-tinh-bang,171685825,"Điện thoại Nokia 105 4G -  chính hãng - Đen",690000,690000,0,0
TIKI,dien-thoai-may-tinh-bang,273357326,"Điện thoại Xiaomi Redmi 13C (6GB/128GB) - Hàng chính hãng",3490000,3490000,0,0
TIKI,dien-thoai-may-tinh-bang,217505504,"Máy tính bảng Kindle Fire HD8 PLUS 2022 (Fire HD 8 12th) - Màn hình 8inch HD, RAM 3GB, CPU Hexa-core 2.0 GHz, CÀI ĐƯỢC CH PLAY- Hàng nhập khẩu",2483100,2790000,306900,11
TIKI,dien-thoai-may-tinh-bang,273258825,"Điện thoại Samsung Galaxy A05s (4GB/128GB) - Đã kích hoạt bảo hành điện tử - Hàng chính hãng",3190000,3950000,760000,19
TIKI,dien-thoai-may-tinh-bang,215617756,"Điện Thoại Samsung A14 5G 4GB/128GB - Hàng Chính Hãng",3439000,5190000,1751000,34
TIKI,dien-thoai-may-tinh-bang,271451188,"Điện thoại Xiaomi Redmi A2| IPS LCD 6.52" HD+| MediaTek Helio G36| 5000 mAh - Hàng chính hãng",1669000,2190000,521000,24
TIKI,dien-thoai-may-tinh-bang,273412211,"Điện thoại Xiaomi Redmi 13C (4+128GB) | 6.74" 90Hz| Media Tek Helio G85| 5000mAh - Hàng chính hãng",2832000,3290000,458000,14
TIKI,dien-thoai-may-tinh-bang,175845367,"Điện Thoại Samsung Galaxy S20 FE (8GB/256GB) Xanh Thanh Mát - Đã kích hoạt bảo hành điện tử - Hàng Chính Hãng",8625000,8625000,0,0
TIKI,dien-thoai-may-tinh-bang,249956458,"Điện thoại Xiaomi Redmi Note 12 (4GB/128GB) - Hàng chính hãng",4990000,4990000,0,0
TIKI,nha-cua-doi-song,131552628,"Đèn Cảm Ứng Thông Minh, Cảm Biến Chuyển Động SEASY SS30, Có Công Tắc 3 Chế Độ, Tự Động Bật/Tắt Ban Đêm, Tiết Kiệm Năng Lượng, Ánh Sáng Bảo Vệ Mắt, Sạc Bằng USB Tiện Lợi, Dán Cầu Thang, Phòng Ngủ, Nhà Vệ Sinh, Tủ Đồ – Hàng Chính Hãng",48000,89000,41000,46
TIKI,nha-cua-doi-song,148801631,"Cân Tiểu Ly Điện Tử Nhà Bếp Định Lượng 3000g - 0.1g  Cân Làm Bánh Có Độ Chính Xác Cao - Hàng Chính Hãng MINIIN",199000,199000,0,0
TIKI,nha-cua-doi-song,73775892,"Tủ Kệ Sách Gỗ Đa Tầng 4 Chân Cao Cấp FIVO Mẫu FB60 Nội Thất Lắp Ráp Đơn Giản, Nhiều Ngăn Rộng Rãi (Có Kèm Tấm Lưng)",669000,1096000,427000,39
TIKI,nha-cua-doi-song,185242856,"Móc treo quần áo INOX 304, Móc áo dẹp (6,7,8,9,10 móc) - Thanh treo đồ nhà tắm",42500,42500,0,0
TIKI,nha-cua-doi-song,72332317,"Nút Đậy Cống Thoát Nước Bằng Silicon Chống Mùi Hôi, Côn Trùng, Ngăn Trào Nước",16998,16998,0,0
TIKI,nha-cua-doi-song,71063120,"Kệ đựng mỹ phẩm, để đồ trang điểm, đồ trang sức, kệ gỗ để bàn kèm gương trang điểm cao cấp - Tặng kèm móc khóa khung hình thời trang",118000,125000,7000,6
TIKI,nha-cua-doi-song,21373904,"Ống Hút Thủy Tinh Lẻ Thẳng/Cong - Nhiều Màu - 20cm x 0.8cm",19000,19000,0,0
TIKI,nha-cua-doi-song,135442380,"Bộ Tua Vít Đa Năng 6 Chiếc Deli Cao Cấp Chính Hãng - Nhỏ Gọn, Tiện Ích, Dễ Dàng Sử Dụng - Thiết Thể Đẹp Mắt - EDL3206",28000,52200,24200,46
TIKI,nha-cua-doi-song,68661084,"Đèn led treo tường Baseus Magnetic Stepless Dimming Charging Desk Lamp Pro - Hàng chính hãng",298000,298000,0,0
TIKI,nha-cua-doi-song,130412896,"Bộ 10 Túi Chân Không Đựng Chăn Màn, Quần Áo - Gọn Gàng, Tiện Lợi + Tặng Bơm Hút Chân Không- Hàng Chính Hãng MINIIN",167000,189999,22999,12
TIKI,nha-cua-doi-song,52126872,"Kệ Treo Tường 3 Thanh Ngang SIB DECOR Dài 40cm x Sâu 15cm (Màu trắng, đen, vân gỗ sồi)",275000,280000,5000,2
TIKI,nha-cua-doi-song,96995267,"Bình đựng thức ăn giữ nhiệt nóng-lạnh chính hãng Rạng Đông RD 0850 N1.T",161000,161000,0,0
TIKI,nha-cua-doi-song,74729869,"Túi bạt đựng quần áo và hàng hóa nhiều size lựa chọn",45000,45000,0,0
TIKI,nha-cua-doi-song,48580898,"Đũa - Combo 30 đôi đũa khảm vàng - Đũa ăn viền vàng - đũa ăn cơm - đũa ăn đen viền vàng",80850,154000,73150,48
TIKI,nha-cua-doi-song,154261693,"Phin pha cafe cà phê inox đẹp trung nguyên inox cỡ lớn chuẩn các cỡ số 7-8-9-10",40000,40000,0,0
TIKI,nha-cua-doi-song,81577986,"Hộp Nhựa, Hũ Nhựa Pet Nắp Nhôm Đựng Thực Phẩm, Đồ Khô, Ngũ Côc JIMMEAL 200ml 250ml 500ml 600ml 700ml 800ml 1000ml 1200ml 1500ml",6500,6500,0,0
TIKI,nha-cua-doi-song,13158001,"Combo 50 đinh 3 chân treo khung ảnh không cần khoan tường",29999,29999,0,0
TIKI,nha-cua-doi-song,20203015,"Ống Hút Inox 304 (Ống Hút Thép Không Rỉ) - Nhiều Màu Tùy Chọn",12000,12000,0,0
TIKI,nha-cua-doi-song,116094839,"Kéo cắt cành cây trên cao.Kéo cắt tỉa cành cao cấp",85000,85000,0,0
TIKI,nha-cua-doi-song,57284183,"Đèn Bàn LED Kẹp Đầu Giường Đọc Sách Chống Cận Pin Sạc - Nhiều Màu",135000,135000,0,0
TIKI,nha-cua-doi-song,122446129,"Đồng Hồ Để Bàn Hai Quả Chuông Gõ Báo Thức Siêu To",120000,120000,0,0
TIKI,nha-cua-doi-song,20023596,"Vải bố ghế thư giãn nhập khẩu",200000,200000,0,0
TIKI,nha-cua-doi-song,101360455,"Giá Để Sạc Điện Thoại, Remote Dán Tường Đa Năng",18000,18000,0,0
TIKI,nha-cua-doi-song,84107855,"MÓC DÁN TƯỜNG TRONG SUỐT",1890,1890,0,0
TIKI,nha-cua-doi-song,26329498,"Bẫy chuột thông minh, không giết chuột, Lồng bắt chuột LT",140000,140000,0,0
TIKI,nha-cua-doi-song,146509769,"Hạt Giống Sâm Bố Chính Thảo Dược",12000,12000,0,0
TIKI,nha-cua-doi-song,55053013,"Bộ dụng cụ đa năng 108 món của Bosch 2607002788",1800000,2203000,403000,18
TIKI,nha-cua-doi-song,57800422,"Bộ Bình Trà Tử Sa Mini Có Túi Đựng Đi Du Lịch Tiện Lợi Thích Hợp 2 - 4 Người Dùng Gồm 1 Ấm Trà, 4 Tách, 1 Bình Đựng Trà ",94999,94999,0,0
TIKI,nha-cua-doi-song,59071660,"Tấm gỗ thông mới mặt lớn dài 1m rộng 20cm dày 2cm được bào láng 4 mặt dùng làm mặt bàn, ghế hoặc kệ sách và nhiều ứng dụng khác",80000,80000,0,0
TIKI,nha-cua-doi-song,21929492,"Gối Ngủ Du Lịch Văn Phòng Cao Cấp Amalife",339000,339000,0,0
TIKI,nha-cua-doi-song,56259814,"Giấy dán kính trơn nhám không hoa văn - khổ 1,2m có sẵn keo",69000,69000,0,0
TIKI,nha-cua-doi-song,85186733,"Giá thể mụn dừa đã qua xử lý Sfarm",18000,18000,0,0
TIKI,nha-cua-doi-song,110113411,"Bộ Công tơ điện tử,Thiết bị đo công suất 100A, đồng hồ điện tử hiển thị 6 thông số 100A",149000,149000,0,0
TIKI,nha-cua-doi-song,184243272,"Dây cáp, Dây kết nối, Cable MIDI USB 2.0 - Kzm Kurtzman KM1 - High quality - Dài 1.5m - Màu đen - Hàng chính hãng",70000,70000,0,0
TIKI,nha-cua-doi-song,55984850,"Dụng Cụ Đựng Nước Rửa Chén Và Miếng Bọt Biển Dạng Bơm, Xịt Đa Năng 2in1",45000,75000,30000,40
TIKI,nha-cua-doi-song,9979455,"Giá treo (móc treo) đàn guitar -HANG-50",21000,21000,0,0
TIKI,nha-cua-doi-song,69237854,"Ổ khóa cao cấp Toplex, chống cắt vuông, 1203-40mm",90000,90000,0,0
TIKI,nha-cua-doi-song,169198042,"Bóng Đèn Wifi Thông Minh TP-Link Tapo L520E Ánh Sáng Trắng Điều Chỉnh Độ Sáng - Hàng Chính Hãng",159000,299000,140000,47
TIKI,nha-cua-doi-song,34669933,"Gối Tựa Lưng Đệm Lót Ghế Gối Ôm Đa Năng Hình Totoro 40x40x40cm",269000,538000,269000,50
TIKI,nha-cua-doi-song,157027637,"Kệ đựng gia vị 2 tầng Inox 304 HOBBY Home Decor GV2T không rỉ sét và có chân chống trượt",589000,769000,180000,23
TIKI,nha-cua-doi-song,70192533,"Bộ dụng cụ nhả kem đánh răng tự động 4 cốc và giá treo bàn chải đa năng HT SYS-COCO-E1922-chất liệu ABS cao cấp",295000,295000,0,0
TIKI,nha-cua-doi-song,98678358,"MC2 - 25x9x9 cm - 20 Thùng hộp carton",37800,37800,0,0
TIKI,nha-cua-doi-song,139979908,"Thác khói trầm hương - tặng nụ trầm Cao Cấp - Trầm hương khói ngược - Xông nhà, văn phòng, mùi dễ chịu, không kích mũi - Thiên Mộc Hương",52000,80000,28000,35
TIKI,nha-cua-doi-song,186501762,"Kệ Nhà Tăm Dán Tường INOX 304 Treo Dầu Gội Mỹ Phẩm Sữa Tắm Thiết Kế 6 Móc Treo Đồ Thông Minh - KT40CM",95000,180000,85000,47
TIKI,nha-cua-doi-song,106699435,"Bàn làm việc, bàn học ngồi bệt gaming - Chân gấp gọn - Lắp sẵn - Chính Hãng TIDO",449000,449000,0,0
TIKI,nha-cua-doi-song,50393230,"Nhang Sạch Phòng Máy Lạnh - Ít khói - Hương trầm dịu nhẹ - Chân tăm mộc - Nhang Xanh",27000,27000,0,0
TIKI,nha-cua-doi-song,151861264,"Kệ đựng mỹ phẩm, tủ mỹ phẩm, kệ trang điểm để bàn VHM7-9 bằng gỗ Smartboard màu trắng phong cách trẻ trung sang trọng - Tặng kèm 1 băng đô cài tóc vải lụa màu ngẫu nhiên",99000,99000,0,0
TIKI,nha-cua-doi-song,173394319,"Đèn cầy nến -cháy 4h 100 viên , 8h 50 viên nhiều màu",118000,118000,0,0
TIKI,nha-cua-doi-song,110024738,"PHÍCH CẮM CHUYỂN ĐỔI 3 CHẤU SANG 2 CHẤU VÀ CHIA 2 Ổ MPE  2000W - HÀNG CHÍNH HÃNG",22000,22000,0,0
TIKI,nha-cua-doi-song,115986994,"Miếng Dán Tường Treo Ổ Cắm Điện Treo Wifi Móc Treo Đa Năng Tiện Lợi",16000,39000,23000,59
TIKI,nha-cua-doi-song,579790,"Chảo Đá Chống Dính Siêu Bền Sunhouse SBD30 30cm",246000,480000,234000,49
TIKI,nha-cua-doi-song,83480720,"Combo 2 Túi Bạt Đựng Quần Áo, Chăn Mền (Giao Ngẫu Nhiên) Chống Thấm Nước, Bộ 2 Giỏ Sọt Đựng Đồ Dơ Họa Tiết Vintage miDoctor",129000,200000,71000,36
TIKI,nha-cua-doi-song,108243370,"Đèn Pin Laze miDoctor Cao Cấp SD Lazer 303 Full Hộp - Chính Hãng",115000,115000,0,0
TIKI,nha-cua-doi-song,132944792,"3 Cuộn Túi Đựng Rác Tự Phân Hủy Sinh Học (1kg) Bảo Vệ Môi Trường - Size Tiểu, Size Trung, Size Đại, Size Cực Đại",34000,34000,0,0
TIKI,nha-cua-doi-song,91547318,"SET 6 khăn gội quấn đầu cotton 85x35ccm",115000,115000,0,0
TIKI,nha-cua-doi-song,41332433,"Tinh dầu xua đuổi chuột",75000,75000,0,0
TIKI,nha-cua-doi-song,21391325,"Combo 2 Ống Hút Thủy Tinh Trong Suốt Dài 20cm Kèm Cọ Rửa và Túi Vải Bố Màu Tùy Chọn",49000,49000,0,0
TIKI,nha-cua-doi-song,147763329,"Bộ 8 Túi Hút Chân Không Đựng Quần Áo, Chăn Màn Kèm Bơm Cao Cấp - Chính Hãng dododios",170000,170000,0,0
TIKI,nha-cua-doi-song,49129618,"Topper- Tấm Làm Mềm Nệm Tiêu Chuẩn 5 Sao - Xám Nhạt",236000,255000,19000,7
TIKI,nha-cua-doi-song,58021652,"Băng keo chống thấm dột mái tôn đa năng siêu dính khổ 10cm dài 5 mét",28400,28400,0,0
TIKI,nha-cua-doi-song,51288340,"Combo 2 cuôn khăn lau đa năng có thể tái sử dụng họa tiết hoạt hình",55000,55000,0,0
TIKI,nha-cua-doi-song,22605669,"Bàn Làm Việc Lắp Ghép Tiện Lợi",670000,729000,59000,8
TIKI,nha-cua-doi-song,123455475,"Combo 10 Khăn Lau Đa Năng Cỡ Lớn Siêu Mịn Bám Bụi Thấm Nước Jodily. KT:26x26cm",65000,65000,0,0
TIKI,nha-cua-doi-song,269023740,"50 Ly Nhựa HỮU PHONG Cao Cấp 700ml Kèm Nắp Cầu Dùng 1 Lần, An Toàn, Đựng Nước ép, Trà sữa (Tặng Móc khóa KETILO)",65000,73000,8000,11
TIKI,nha-cua-doi-song,12329959,"Combo 30 miếng lót chân bàn ghế chống trơn trượt và trầy xước - Giao mẫu ngẫu nhiên",24999,24999,0,0
TIKI,nha-cua-doi-song,109026622,"Thước Dây, Thước Thợ may, Thước đo vòng eo 150cm Đầu bọc thép",4500,4500,0,0
TIKI,nha-cua-doi-song,95004284,"Bịt mắt ngủ 3 con gấu vui nhộn có túi nước giải nhiệt tặng kèm bịt tai chống ồn",65000,65000,0,0
TIKI,nha-cua-doi-song,34623289,"Bộ 10 Túi Chân Không Đựng Chăn Màn, Quần Áo - Gọn Gàng, Tiện Lợi + Tặng bơm hút chân không",138000,138000,0,0
TIKI,nha-cua-doi-song,4939061,"Cuộn dây buộc bằng thép bọc nhựa 50m",29000,29000,0,0
TIKI,nha-cua-doi-song,35928141,"Combo 40 móc nhôm treo quần áo chắc chắn, tiện lợi, đa năng và cao cấp tiết kiệm không gian",72000,100000,28000,28
TIKI,nha-cua-doi-song,13238747,"Đệm ngồi lót ghế cao su thoáng khí tuần hoàn êm ái E3-L206",169000,169000,0,0
TIKI,nha-cua-doi-song,100048105,"Đồng hồ đo 7 chỉ số xe đạp thể thao",189000,189000,0,0
TIKI,nha-cua-doi-song,195462469,"Miếng Lót Ly, Đế Lót Đá Xốp Diatomite Siêu Thấm Hút",55000,55000,0,0
TIKI,nha-cua-doi-song,154566300,"Hộp đựng trứng 24 quả - Khay nhựa đựng trứng gà, vịt để tủ lạnh có nắp đậy tiện dụng  - Hàng loại 1 chính hãng",37000,47000,10000,21
TIKI,nha-cua-doi-song,141472707,"Keo dán chuột keo dính chuột keo bẫy chuột (Dài 1.2M)",79000,84000,5000,6
TIKI,nha-cua-doi-song,69228398,"Ổ khóa Toplex hợp kim thép, lõi đồng, càng dài",90000,90000,0,0
TIKI,nha-cua-doi-song,67831978,"Thanh Kẹp Miệng Túi Trà K10 – Kẹp tốt mọi loại túi đựng trà, bảo quản trà lâu hơn (giao màu ngẫu nhiên)",4500,4500,0,0
TIKI,nha-cua-doi-song,133888517,"Tô Giấy Dùng 1 Lần KETILO Trắng Trơn 500ml Cao Cấp, Chất Liệu An Toàn Thân Thiện Môi Trường, Tiện Lợi - HÀNG CHÍNH HÃNG TG002",135000,175000,40000,23
TIKI,nha-cua-doi-song,23264614,"Bộ Tua Vít Đa Năng 31 Đầu",19094,19094,0,0
TIKI,nha-cua-doi-song,112052096,"Bộ 2 ly uống rượu vang đỏ pha lê 650 ml trong xuốt !",314000,314000,0,0
TIKI,nha-cua-doi-song,182131031,"Ghế Hộp Đựng Đồ Đa Năng, Thùng Đựng Đồ Kiêm Ghế Ngồi - chất liệu khung gỗ nhân tạo Chịu Lực 150kg made in Việt Nam",190000,299000,109000,36
TIKI,nha-cua-doi-song,217145037,"Giỏ Nhựa Đựng Đồ Đa Năng Có Nắp Đậy Cao Cấp Deli - Đựng Sách Vở Đồ Cá Nhân Mỹ Phẩm Quần Áo Chăn Gối Ga Mền - Nhiều Size, Kích Cỡ Lớn Nhỏ , Có Tay Cầm, Phong Cách Nhật Bản Đơn Giản, Tiện Dụng, Vật Liệu An Toàn",63000,100800,37800,38
TIKI,nha-cua-doi-song,129379800,"Giường Ngủ Gấp Gọn Văn Phòng Và Gia Đình Thông Minh Đa Năng 1 Tầng, Giường Xếp Có Thể Làm Giường Trong Bệnh Viện Dành Cho Bệnh Nhân - Hàng Chính Hãng",1755000,2145000,390000,18
TIKI,nha-cua-doi-song,163543251,"Nệm Bông Gòn Xuất Nhật, Nệm Trải Sàn Tiện Lợi, Đệm Văn Phòng Size 1m x 2m; 1m2 x 2m; 1m4 x 2m; 1m6 x2m và 1m8 x2m",240000,240000,0,0
TIKI,nha-cua-doi-song,88785294,"Đèn bàn Bảo vệ Thị lực       Model: RD-RL-24.V2 5W",225720,250800,25080,10
TIKI,nha-cua-doi-song,189491948,"Kệ gia vị, Kệ đựng gia vị nhà bếp, Kệ gia vị đa năng",250000,250000,0,0
TIKI,nha-cua-doi-song,161455624,"bóng đèn led 50W siêu sáng có ",39000,39000,0,0
TIKI,nha-cua-doi-song,119363942,"Ấm pha trà thủy tinh chịu nhiệt lõi lọc inox 304 cao cấp",94000,94000,0,0
TIKI,nha-cua-doi-song,57763337,"BÌNH ĐỰNG NƯỚC VỎ LÚA MẠNH AN TOÀN, CAO CẤP IN HÌNH XƯƠNG RỒNG, TOTORO (Giao Hàng Theo Mẫu Ngẫu Nhiên)",10000,12999,2999,23
TIKI,nha-cua-doi-song,54778238,"Combo 10 móc nhựa đen treo quần áo tiện dụng bền đẹp",80000,80000,0,0
TIKI,nha-cua-doi-song,10604175,"Ổ cắm Điện Quang ĐQ ESK 2W.SM750SL (5 lỗ 3 chấu dây 2 mét màu Trắng Đỏ)",190960,238700,47740,20
TIKI,nha-cua-doi-song,163645078,"Hộp Nhựa Đựng Thực Phẩm Tủ Lạnh 2 Lớp Có Khóa Thoát Khí, Dễ Dàng Bảo Quản Rau Củ, Siêu Tiện Dụng",65000,65000,0,0
TIKI,nha-cua-doi-song,69500507,"Áo mưa cánh bướm trẻ em Rando Pocho dành cho các bé có độ tuổi từ (2 tuổi đến 12 tuổi) tương đương với các size từ số 1 đến số 5",54000,54000,0,0
TIKI,nha-cua-doi-song,144450194,"Bộ Tua Vít Đa Năng 24 Chi Tiết Chất Liệu Thép Từ Tính Cao Cấp Dùng Để Sửa Chữa Máy Mọc, Điện Tử Cỡ Nhỏ",37800,37800,0,0
TIKI,nha-cua-doi-song,13571023,"Bộ Sạc Pin DP-B02 Kèm 4 Pin Tiểu Sạc AA 1200mAh AZONE",78900,78900,0,0
TIKI,nha-cua-doi-song,171590605,"Tủ nhựa TABI-L cao cấp size lớn mặt ốp mica chính hãng Nhựa Duy Tân",1410000,1600000,190000,12
TIKI,nha-cua-doi-song,52599291,"Đèn năng lượng mặt trời cảm biến chuyển động 100 LED siêu sáng pin tách rời chống nước đèn led đèn cảm ứng chuyển động đèn treo tường đèn ngoài trời",94000,139000,45000,32
TIKI,nha-cua-doi-song,87628025,"Dây Đèn LED Bóng Tròn Năng Lượng Mặt Trời Chống Nước Trang Trí Sân Vườn",260000,260000,0,0
TIKI,nha-cua-doi-song,696894,"Bộ Dây Đàn Guitar Acoustic Alice AW436",74000,74000,0,0
TIKI,nha-cua-doi-song,135442312,"Keo Siêu Dính Đa Năng Deli - 7ml/ 20ml - Có Thể Dán Trên Mọi Bề Mặt - Phù Hợp Sửa Chữa, Ghép Nối - 7140 / 7149",8700,16200,7500,46
TIKI,nha-cua-doi-song,100623179,"Combo 2 Kệ Góc Để Đồ Nhà Tắm INOX SUS304 Dán Tường Gạch Men kèm bộ đinh vít khoan tường - OENON",285000,500000,215000,43
TIKI,nha-cua-doi-song,169514577,"Dụng Cụ Xay Tiêu Thuỷ Tinh Benchusch",99000,190000,91000,48
TIKI,nha-cua-doi-song,125673210," Thớt Inox 2 Mặt Cao Cấp - 01 Mặt Inox 304 01 Mặt Nhựa PP Sử Dụng Đa Năng Cho Nhà Bếp",305000,305000,0,0
TIKI,nha-cua-doi-song,15703213,"Bộ 16 món bát đĩa bằng thủy tinh ngọc Royal Stuart OPAL-C/T Hoa văn CITRON WEAVE / TWILIGHT BOUQUET (Giao màu ngẫu nhiên)",387000,979000,592000,60
TIKI,nha-cua-doi-song,158743936,"Combo 10 gói hạt giống rau ăn lá phổ biến trồng thủy canh - 10 loại khác nhau như hình (chat với shop nếu muốn chọn)",72000,72000,0,0
TIKI,nha-cua-doi-song,2909831,"Máy khoan động lực Bosch GSB 550 550W - Tặng bộ phụ kiện FREEDOM 90 chi tiết",1438000,1617000,179000,11
TIKI,nha-cua-doi-song,49127906,"Bao Da Đựng Đàn Guitar 3 Lớp Yamaha Bag YAB (Túi đựng Acoustic và Classic Ghi-ta, Có 2 quai đeo, Ngăn đựng đồ ) - Bao Acoustic Guitar",149000,149000,0,0
TIKI,nha-cua-doi-song,137753122,"Công tắc thông minh ĐIỀU KHIỂN TỪ XA qua wifi HUNONIC DATIC 1 Kênh 500W - Cơ Điện Shop",99000,99000,0,0
TIKI,nha-cua-doi-song,66647096,"Nệm đa năng Everon New ( màu ngẫu nhiên )",1790000,1790000,0,0
TIKI,nha-cua-doi-song,194498783,"Khăn Tắm Viên Nén Du Lịch 70*140cm Nhỏ Gọn, Siêu Tiện Lợi... Làm Từ Cotton,  Sử Dụng Nhiều Lần",10000,10000,0,0
TIKI,nha-cua-doi-song,192688324,"Dụng Cụ Xay Tiêu 2 trong 1 Benchusch",180000,245000,65000,27
TIKI,nha-cua-doi-song,163582596,"Bút khò bật lửa khò honest thân dài, vi trí hiển thị gas, có chế độ giữ gas và điều chỉnh gas lớn nhỏ tùy ý",153000,170000,17000,10
TIKI,nha-cua-doi-song,146363272,"Giấy Dán Bếp Decal Giả Vân Đá 3D, Hoa Văn Xinh Xắn Chịu Nhiệt Chống Nước, Chống Dầu Mỡ, Dễ Dàng Lau Chùi",45000,45000,0,0
TIKI,nha-cua-doi-song,75131601,"(Loại Tốt) Áo Mưa Cánh Dơi (xẻ tà) KhoNCC - Vải Dù Cao Cấp Loại Lớn 1m4 - Che Kín 2 Người Mùa Mưa - NQL-AoMuaDu (Xanh lá, Xanh Đen, Xanh Dương, Đỏ Đô, Cỏ Úa) - Hàng Chính Hãng",109000,158000,49000,31
TIKI,nha-cua-doi-song,54398878,"Mền trơn du lịch tuyết nhung siêu mịn, chăn ngủ trưa văn phòng êm nhẹ, đắp cực ấm GD287-Menle - Xàm",79418,79418,0,0
TIKI,nha-cua-doi-song,174032615,"Ô Dù Cán Thẳng 2 Tầng - Ô Golf 2 tầng chống tia UV đường kính 145cm - Nhiều Màu",259000,500000,241000,48
TIKI,nha-cua-doi-song,117597640,"Đầu vòi nước tăng áp, vòi rửa chén thông minh chứa hạt lọc bẩn, xoay 360 độ.",9100,9100,0,0
TIKI,nha-cua-doi-song,181361773,"Bàn học gấp gọn, bàn laptop đa năng tùy chỉnh được góc nghiêng giảm đau lưng mỏi mắt - GM55",183000,199000,16000,8
TIKI,nha-cua-doi-song,127964805,"Máy Đuổi Chuột Gián Muỗi 3in1 Dùng Sóng Siêu Âm Cho Hộ Gia Đình 30-50m2",349000,349000,0,0
TIKI,nha-cua-doi-song,127649036,"Keo Kẻ Mạch Gạch Chà Ron Gạch Cao Cấp Keo Dán Mạch Gạch Siêu Bám Dính Chống Thấm Nước Dung Tích 180ml",69000,75000,6000,8
TIKI,nha-cua-doi-song,176909993,"Bình xịt chống gỉ sét và bôi trơn Selleys RP7 350g",80750,85000,4250,5
TIKI,nha-cua-doi-song,191417967,"Dán Tường Đựng Bàn Chải Kem Đánh Răng, Đựng Đồ Đa Năng Jodily StarHome",35000,35000,0,0
TIKI,nha-cua-doi-song,55351571,"ÁO BỌC NỆM 2 MẶT THUN XÁM CÓ KHÓA KÉO 1M2X2M",190000,190000,0,0
TIKI,nha-cua-doi-song,193738570,"Cây Hoa Đại Cát - cây cảnh đẹp + tặng phân bón cho cây",25000,50000,25000,50
TIKI,nha-cua-doi-song,111821413,"Dù Che Mưa Che Nắng Ngăn Tia UV",40999,40999,0,0
TIKI,nha-cua-doi-song,51843538,"Set 10 khăn lau đa năng 2 mặt lau bát đĩa, lau bếp, lau đồ đạc - màu ngẫu nhiên",10447,10997,550,5
TIKI,nha-cua-doi-song,118275203,"ÁO MƯA CAO CẤP,DÀY DẶN,ÁO ĐI MƯA TIỆN DỤNG CÓ KHOÁ,CÓ MŨ VÀ KÍNH CHẮN",155000,155000,0,0
TIKI,nha-cua-doi-song,72830045,"Đèn Ngủ Mặt Trăng Quả Cầu Mây Để Bàn SPEVI - Đèn Trang Trí Cực Đáng Yêu, Có Điều Chỉnh Độ Sáng Tăng Giảm Theo Ý Muốn, Đầu USB Tiện Lợi, Cục Sạc USB, Đế Xếp Bằng Gỗ Sang Trọng - Hàng Chính Hãng",129000,246000,117000,48
TIKI,nha-cua-doi-song,71924152,"Mùng chụp, màn chụp tự bung chống muỗi FUNU - Hàng chính hãng, sản xuất tại Việt Nam",135000,150000,15000,10
TIKI,nha-cua-doi-song,183503039,"Kệ Gỗ Để Màn Hình Bàn Làm Việc 2 Tầng SIB Decor",330000,349000,19000,5
TIKI,nha-cua-doi-song,185949624,"Nệm ngủ trưa văn phòng, picnic /dã ngoại / cao cấp / siêu gọn nhẹ",199000,199000,0,0
TIKI,nha-cua-doi-song,19749652,"Bộ Áo Mưa Vải Dù không thấm nước cao cấp",90000,90000,0,0
TIKI,nha-cua-doi-song,107453161,"Bộ Đèn led dây dán RGB đổi màu điểu khiển 44 phím chọn màu đứng yên, nhấp nháy, bóng 5050 strip light trang trí  Tiktok dán tường, bàn máy tính, cửa hàng, quán cafe, chống nước bền đẹp (Tùy chọn chiều dài dây)",179000,298000,119000,40
TIKI,nha-cua-doi-song,137672504,"Móc dán tường Jumbo Command 3M chịu lực 3.4kg - Dễ sử dụng, độ bền cao, bám cực chắc, tháo cực dễ 17004ES",59000,68000,9000,13
TIKI,nha-cua-doi-song,20036138,"5 Viên Pin CR2025 3V Panasonic Lithium made in Indonesia - Hàng chính hãng",72000,90000,18000,20
TIKI,nha-cua-doi-song,53253096,"Bộ 4 dây kẹp 3 đầu cố định ga trải giường-Dây nẹp giữ cố định ga giường, nhiều màu, giao màu ngẫu nhiên + Tặng kèm hình dán",48000,96000,48000,50
TIKI,nha-cua-doi-song,41369724,"Pin Maxell CR2025 3V",70000,70000,0,0
TIKI,nha-cua-doi-song,68607055,"Muỗng xào DandiHome Inox 304 kết hợp bề mặt muỗng silicon cao cấp - chịu được nhiệt độ cao, an toàn với chảo chống dính",110000,110000,0,0
TIKI,nha-cua-doi-song,89262361,"Chậu Gội Đầu Tại Giường KUNBE Dành Cho Người Bệnh, Người Già, Bà Bầu Và Trẻ Em, Bản Nâng Cấp Có Đệm Lót Silicon Đầu Và Gáy, Ống Thoát Nước Đầu Cao Su Chống Rò Nước",189000,189000,0,0
TIKI,nha-cua-doi-song,145495739,"Nụ Trầm Dương Minh 100% thành phần tự nhiên nụ trầm, nụ quế, nụ bồ kết - nụ khói tỏa ngược hương nhang sạch an toàn cho sức khỏe",130000,150000,20000,13
TIKI,nha-cua-doi-song,76781108,"Kìm tuốt cắt tuốt vỏ dây điện lõi ø0.6 - 2.6mm 200mm có khóa an toàn bóp mở",45000,45000,0,0
TIKI,nha-cua-doi-song,174440648,"CHẤT TĂNG CƯỜNG SINH TRƯỞNG THỰC VẬT HB-101 (VITALIZER) | Chai 6ml",53000,53000,0,0
TIKI,nha-cua-doi-song,69253904,"Đèn Led 28 Bóng Cổng Usb Thân Kim Loại Có Thể Uốn Cong - Hàng Chính Hãng (Giao Màu Ngẫu Nhiên)",38000,40000,2000,5
TIKI,nha-cua-doi-song,2464245,"Bàn chải chà gót chân bằng đá san hô nội địa Nhật Bản",36500,36500,0,0
TIKI,nha-cua-doi-song,4019171,"Kìm tuốt dây điện, dây cáp, bấm cos đa năng 0.2 - 6mm",114000,114000,0,0
TIKI,nha-cua-doi-song,54097692,"Pin Energizer 12V A23 BP1",27000,40000,13000,33
TIKI,nha-cua-doi-song,187058636,"Khăn giấy nén hình viên kẹo dùng một lần tiện dụng khi đi du lịch, Khăn lau mặt Hàn Quốc nhỏ gọn đa năng - Chính hãng MINIIN",1900,2000,100,5
TIKI,nha-cua-doi-song,147265095,"Vỉ 2 Viên Pin Đại ( Pin D ) 1,5V DURACELL Siêu Bền - Hàng chính hãng",96000,130000,34000,26
TIKI,nha-cua-doi-song,137672212,"Bộ 8 Miếng dán treo tranh Command 3M tải trọng 7.2kg độ bền cao, bám cực chắc, tháo cực dễ",105000,121000,16000,13
TIKI,nha-cua-doi-song,53066875,"Áo mưa 2 đầu phản quang có kính che mặt – Giao màu ngẫu nhiên",76997,76997,0,0
TIKI,nha-cua-doi-song,134857845,"1kg sỏi trắng trang trí chậu cây cảnh, tiểu cảnh",5000,5000,0,0
TIKI,nha-cua-doi-song,132081711,"Đồng Hồ Treo Tường Hình Bản Đồ Việt Nam",179000,179000,0,0
TIKI,nha-cua-doi-song,6507845,"Bộ tua vít đa năng 45 món",105000,105000,0,0
TIKI,nha-cua-doi-song,181456477,"[1M8X2M] Ga chống thấm cotton, Drap chống thấm hiệu quả,Ga trải giường bằng vải cotton bảo vệ vỏ bọc bụi bao phủ nệm chống thấm",109250,115000,5750,5
TIKI,nha-cua-doi-song,37891224,"Súng bắn keo 20w, Tặng 10 keo nến 19cm",52000,52000,0,0
TIKI,nha-cua-doi-song,72839977,"Giá Treo Tường - Móc Treo Cây Lau Nhà, Treo Chổi Inox 304 Dán Tường Cao Cấp",68000,100000,32000,32
TIKI,nha-cua-doi-song,2432307,"Decal dán tường đoàn tàu sở thú ZOOYOO AM7123",70000,70000,0,0
TIKI,nha-cua-doi-song,78892635,"VỢT MUỖI THÔNG MINH TÍCH HỢP ĐÈN LED CÁO CẤP THU HÚT MUỖI HIỆU.KÈM DÂY SẠC",89969,89969,0,0
TIKI,nha-cua-doi-song,32558250,"PHÂN GÀ HỮU CƠ (NHẬT BẢN) - BAO 3KG - SẢN PHẨM CAO CẤP CHO MỌI LOẠI CÂY TRỒNG- Dạng",57000,57000,0,0
TIKI,nha-cua-doi-song,129145056," khay cơm,khay ăn dặm cho các bé inox 304 cao cấp 100",105000,105000,0,0
TIKI,nha-cua-doi-song,6422645,"Công tắc quả nhót có đèn báo trạng thái",18000,18000,0,0
TIKI,nha-cua-doi-song,171781942,"Bộ dùi trống/ Drumsticks/ Drumstick - Yamaha 5A - Gỗ Phong/ Chi Phong/ Chi Thích - Màu gỗ tự nhiên - Hàng chính hãng",126000,126000,0,0
TIKI,nha-cua-doi-song,242707636,"Ca lọc cặn dầu bằng thép không gỉ - Chính hãng (Giao ngẫu nhiên)",64400,70000,5600,8
TIKI,nha-cua-doi-song,43865528,"Bàn mầm non",360000,360000,0,0
TIKI,nha-cua-doi-song,10791010,"Ổ cắm kéo dài đa năng LiOA 3 ổ cắm (3D32N 3D52N)",95000,95000,0,0
TIKI,nha-cua-doi-song,16195896,"Combo 03 lõi lọc số 1 (lõi PP) 20 inch Yamato",101000,155000,54000,35
TIKI,nha-cua-doi-song,38084045,"Rèm Chống Muỗi, Côn Trùng 1.3m x 1.5m - Vải Lưới Mỏng",41097,76000,34903,46
TIKI,nha-cua-doi-song,124273121,"Bình Xịt Nước Tưới Cây 500ml Home And Garden",34200,36000,1800,5
TIKI,nha-cua-doi-song,152561356,"Giấy nến lót nồi chiên không dầu",10000,16998,6998,41
TIKI,nha-cua-doi-song,42123459,"Bộ 6 Nắp Silicon Đậy Thực Phẩm",26500,26500,0,0
TIKI,nha-cua-doi-song,136941091,"Móc treo dán tường tiện lợi",950,1000,50,5
TIKI,nha-cua-doi-song,191911148,"Kệ sách gỗ xương rồng, kệ sách hình cây gỗ MDF cao cấp, chống mối mọt, đựng sách 8 ngăn 50x20x120 ND25",220000,220000,0,0
TIKI,nha-cua-doi-song,83398135,"MD31 - 30x25x3 cm - 50 Thùng hộp carton trơn đóng hàng",168000,168000,0,0
TIKI,nha-cua-doi-song,25271790,"Tủ nhựa ghép đa năng 6 ô đựng quần áo (110*74*47cm)",279000,279000,0,0
TIKI,nha-cua-doi-song,107336808,"Bộ chăn chần ga giường cotton Tici kẻ LIDACO cao cấp (Nhiều mẫu lựa chọn)",449000,690000,241000,35
TIKI,nha-cua-doi-song,152446590,"Cây Nguyệt Quế hoa thơm - cây cảnh vườn + Tặng phân bón cho cây",28000,36000,8000,22
TIKI,nha-cua-doi-song,179689675,"Nến thơm Candle Cup/Agaya - Hương khơi gợi đặc điểm địa danh TWILIGHT",68000,68000,0,0
TIKI,nha-cua-doi-song,152446429,"Cây Thủy Tùng - Cây cảnh để bàn + tặng phân bón cho cây",39000,58000,19000,33
TIKI,nha-cua-doi-song,115992688,"Nệm cao su 100% thiên nhiên cao cấp Gummi Standard 10cm tại Vua Nệm - Nâng đỡ vượt trội, thoáng kí tối ưu",6901000,8679000,1778000,20
TIKI,nha-cua-doi-song,173854188,"Ổ cắm xoay gấp gọn Điện Quang ĐQ ESK RT",28080,35100,7020,20
TIKI,nha-cua-doi-song,111981222,"Kéo cắt cành cộng lực Nhật Bản SK5-bạc trắng",46000,180000,134000,74
TIKI,nha-cua-doi-song,140013826,"Chiếu trúc tre Tây Bắc, chiếu tre trúc Cao Bằng điều hòa loại đẹp ( Mát Lạnh Mùa Hè )",140000,140000,0,0
TIKI,nha-cua-doi-song,105658766,"[MS16] - Tấm gỗ thông mặt rộng 10cm x dày 1cm x dài 30cm + láng mịn 4 mặt",7500,7500,0,0
TIKI,nha-cua-doi-song,167017460,"Bô vệ sinh,bô di động cho người già, bà bầu vô cùng chắc chắn",260000,260000,0,0
TIKI,nha-cua-doi-song,3086603,"Ruột Gối Ôm Everon ELRG80100 Lite - Trắng (0.8 x 1 m)",240000,250000,10000,4
TIKI,nha-cua-doi-song,35766444,"Đế cài/ Giá đỡ vòi hoa sen inox 304 kèm phụ kiện treo tường có thể điều chỉnh",23000,23000,0,0
TIKI,nha-cua-doi-song,59437399,"Nệm bông chần gòn Everon Lite EV09 ( màu ngẫu nhiên )",2540000,2540000,0,0
TIKI,nha-cua-doi-song,79366461,"Tủ Kệ Nhà Tắm IGA Treo Tường Sắp Xếp Phòng Tắm Gọn Gàng",363850,383000,19150,5
TIKI,nha-cua-doi-song,263488917,"Kệ sách gỗ mini để bàn ( Màu Ngẫu Nhiên )",53200,56000,2800,5
TIKI,nha-cua-doi-song,166033411,"Ly thuỷ tinh đổi màu Luminarc Lille Scale Unicorn 425ml - LUSCQ3810",155000,155000,0,0
TIKI,nha-cua-doi-song,168333062,"Con Đội Thuỷ Lực ( Kích Ô tô - Kích Thuỷ Lực ) capthepgiasi",200000,200000,0,0
TIKI,nha-cua-doi-song,21201795,"Combo 2 Đèn Ngủ Cảm Biến Ánh Sáng",31000,48990,17990,37
TIKI,nha-cua-doi-song,89054053,"SET 100 GIẤY NẾN LÓT NỒI CHIÊN KHÔNG DẦU",39000,39000,0,0
TIKI,nha-cua-doi-song,143656502,"Thớt Gỗ Tre Organic Ultty Vina Có Đặc Tính Kháng Khuẩn Và Chống Mùi Hôi – Hàng Chính Hãng",99000,250000,151000,60
TIKI,nha-cua-doi-song,189104675,"Đồng Hồ Treo Tường Casio IQ-05-1DF Chính Hãng",566100,629000,62900,10
TIKI,nha-cua-doi-song,153273930,"Hộp cơm giữ nhiệt LEBENLANG LBT856 bằng inox 304 với 4 khay riêng biệt, dung tích 2.2L - hàng chính hãng",999000,999000,0,0
TIKI,nha-cua-doi-song,155487222,"Kệ Chén Đĩa Kéo Giãn Thông Minh VANDO Giá Úp Bát Thay Đổi Kích Thước Trên Bồn Rửa 1 Tầng Chống Han Gỉ Cao Cấp",749000,1207000,458000,38
TIKI,nha-cua-doi-song,77200011,"Set Nồi đá Ecoramic cao cấp phủ 5 lớp chống dính ceramic siêu bền gồm 4 nồi",2005500,2865000,859500,30
TIKI,nha-cua-doi-song,95014508,"Công tắc điều khiển từ xa bằng điện thoại Hunonic Lahu 4 kênh 500W/kênh + Hẹn giờ thông minh | Công nghệ 4.0",380000,380000,0,0
TIKI,nha-cua-doi-song,4581757,"Phích Nước Nóng Rạng Đông Inox RD 2545 ST1.E (2.5L)",432000,480000,48000,10
TIKI,nha-cua-doi-song,142331006,"Chuôi đèn liền công tắc Điện Quang ĐQ LH E27",40000,49800,9800,20
TIKI,nha-cua-doi-song,121329002,"Đèn Pha LED siêu sáng 15 Bóng 1000lm Hỗ trợ sáng tối đa cho các phương tiện",89000,89000,0,0
TIKI,nha-cua-doi-song,58481259,"Kệ nâng màn hình máy tính 1 tầng lắp ghép MS 07",33993,33993,0,0
TIKI,nha-cua-doi-song,121741414,"NỆM VĂN PHÒNG- ĐỆM NGỦ VĂN PHÒNG 90X190X3CM",225000,225000,0,0
TIKI,nha-cua-doi-song,195797725,"Thớt tre tự nhiên Sunhouse KS-CH3522B",97000,153000,56000,37
TIKI,nha-cua-doi-song,118847639,"MÓC DÁN TƯỜNG TREO CỔ TRAI INOX 304 JODILY TIỆN LỢI - SỬ DỤNG KEO SIÊU DÍNH ",50000,50000,0,0
TIKI,nha-cua-doi-song,95160676,"Nệm Lò Xo Cao Su Liên Kết Zinus 18cm Bonnel Mattress",4290000,4290000,0,0
TIKI,nha-cua-doi-song,176598081,"Bình giữ nhiệt LocknLock Metro Two Way LHC4274NVY 475ml",339000,605000,266000,44
TIKI,nha-cua-doi-song,112329326," Đầu Chuyển Chấu | Chuyển đổi phích cắm  (nhiều tiêu chuẩn)",18000,18000,0,0
TIKI,nha-cua-doi-song,121162096,"Hộp 5 Đôi Đũa Inox Mạ Vàng Jodily Cao Cấp - Không Trơn Trượt, Bền Mãi Với Thời Gian",205000,205000,0,0
TIKI,nha-cua-doi-song,147020767,"Hộp cơm văn phòng giữ nhiệt 3 tầng Inox 304 cao cấp , giữ nhiệt lâu 6 - 8 tiếng - Hàng chính hãng",429000,459000,30000,7
TIKI,nha-cua-doi-song,185922606,"Cốc Thủy Tinh Hai Lớp Cách Nhiệt Ly Đựng Cà Phê Trà Trang Nhã",99000,99000,0,0
TIKI,nha-cua-doi-song,153918454,"Ốc tán rút M3-M12 M3,M4,M5,M6,M8,M10,M12 thép mạ",15000,15000,0,0
TIKI,nha-cua-doi-song,195791850,"Chảo chống dính Ultra titanium Sunhouse ST20B - Dùng cho mọi loại bếp - Hàng chính hãng",388000,650000,262000,40
TIKI,nha-cua-doi-song,73983551,"Bình Giữ Nhiệt Inox 304 1500ml Giữ Nhiệt Trên 12H T.H BAOL",111386,111386,0,0
TIKI,nha-cua-doi-song,53407674,"Kệ INOX304 Để Dao Thớt Kèm Ống Đũa Có Khay Hứng Nước Tiết Kiệm Không Gian",480000,480000,0,0
TIKI,nha-cua-doi-song,87651538,"BỘ ÁO ĐI MƯA TRONG MÀU PHẢN QUANG, AN TOÀN, RANDO",243000,243000,0,0
TIKI,nha-cua-doi-song,17461856,"Giá treo đồ gập gọn di động sau cửa Wellex MH1060",300000,350000,50000,14
TIKI,nha-cua-doi-song,89308771,"Thước Dây Deli Có Thể Làm Móc Chìa Khóa- Dài 1.5M - Thước Dây Cuộn - Màu Trơn Xanh Lá / Xanh Dương / Hồng / Trắng  - 1 Chiếc",15000,32400,17400,54
TIKI,nha-cua-doi-song,75027386,"Chậu Tắm Gấp Gọn Cho Người Lớn Trẻ Em Dài 1,4m - Thau Tắm Silicon Cao Cấp - Bồn Xông Hơi Gia Đình",1399000,2300000,901000,39
TIKI,nha-cua-doi-song,138359526,"Máy Xay Tiêu Tự Động Bằng Điện Benchusch Màu Trắng/ Đen/ Xanh/ Đỏ",449000,599000,150000,25
TIKI,nha-cua-doi-song,116778234,"KỆ NGŨ GIÁC 4 TẦNG - KỆ GÓC TAM GIÁC LẮP GHÉP SIÊU ĐẸP",199000,199000,0,0
TIKI,nha-cua-doi-song,92099727,"Thảm đá lau chân siêu thấm loại nhỏ, Thảm đá, Thảm đá lau chân, thảm dậm chân, Thảm đá siêu thấm",115000,190000,75000,39
TIKI,nha-cua-doi-song,212942837,"Lư đốt trầm hương",55000,55000,0,0
TIKI,nha-cua-doi-song,152446804,"Cây Kim Thanh Mai - cây cảnh bonsai để bàn",39000,58000,19000,33
TIKI,nha-cua-doi-song,160577685,"Dung dịch hỗ trợ hàn thiếc với kim loại Sắt, thép, inox,... thích hợp hàn cell pin",54900,54900,0,0
TIKI,nha-cua-doi-song,6775905,"Thùng nhựa đựng đồ Đa Năng Bestlock",179000,179000,0,0
TIKI,nha-cua-doi-song,75303322,"Khay kệ đựng đồ mỹ phẩm để bàn nhiều ngăn tiện lợi",28999,28999,0,0
TIKI,nha-cua-doi-song,116828169,"Tấm bảo vệ nệm Doona Bamboo ứng dụng công nghệ vải lạnh giúp làm mát và chống thấm hiệu quả",737200,808000,70800,9
TIKI,nha-cua-doi-song,10213201,"Bộ Dây +  Đầu Nối Đa Năng + Vòi Xịt Tăng Áp Lực NướcChuyển Rửa Xe Tưới Cây Chịu Nhiệt",169000,213000,44000,21
TIKI,nha-cua-doi-song,980486,"Cân Đồng Hồ Lò Xo Nhơn Hòa NHS-30 (30kg) - Hàng Chính Hãng",610000,610000,0,0
TIKI,nha-cua-doi-song,174012858,"Sáo dọc Recorder Soprano YAMAHA YRS-24B kèm túi đựng - Nốt thổi Baroque, tiêu chuẩn giáo dục quốc tế",147273,147273,0,0
TIKI,nha-cua-doi-song,122413518,"Bình giữ nhiệt LOCK&LOCK 1.000mL Easy Take - LHC1439",299000,549000,250000,46
TIKI,nha-cua-doi-song,88784706,"Đèn bàn Bảo vệ Thị lực Model: RD-RL-27.V2 5W",150000,150000,0,0
TIKI,nha-cua-doi-song,85029571,"Set 5 Phích cắm công suất lớn Điện Quang ECO ĐQ EPR HP 2PN ECO (Màu ngẫu nhiên)",51340,60400,9060,15
TIKI,nha-cua-doi-song,190707199,"Đệm ngồi 3D silicon thoáng khí, đàn hồi tốt, Nệm lót ghế chất liệu mềm mại chống đau mỏi - Chính hãng MINIIN (Giao mẫu ngẫu nhiên)",71000,89000,18000,20
TIKI,nha-cua-doi-song,176310413,"Bình nước thể thao Inochi - Kita Active 700ml màu Xanh chàm/Cam sữa/Ghi sữa/Hồng sen",199000,199000,0,0
TIKI,nha-cua-doi-song,125533701,"1 KG Đất Ibaraki Akadama size S - loại cứng - giá siêu rẻ - trồng sen đá - xương rồng - bonsai",35000,35000,0,0
TIKI,nha-cua-doi-song,104681190,"Màng bọc thực phẩm PE MyJae Đài Loan 30cmx50m dạng xé chấm đứt bảo quản thực phẩm an toàn tiện lợi",59000,99000,40000,40
TIKI,nha-cua-doi-song,125658918,"DỤNG CỤ BƠM HÚT DẦU, RƯỢU, CHẤT LỎNG ĐA NĂNG",16000,22998,6998,30
TIKI,nha-cua-doi-song,485396,"Giá Lấy Ly/Cốc Giấy Tự Động Kova Hàn Quốc GDL",290000,352000,62000,18
TIKI,nha-cua-doi-song,117207732,"Biến Áp Đổi Nguồn Hạ Áp LiOA - Biến Áp Đổi Nguồn LiOA 200/400/600VA ( Điện Vào 220V- Điện Ra 100/120V)",279000,279000,0,0
TIKI,nha-cua-doi-song,170458084,"Máy lăn rãnh sắt hộp - dùng để uốn hoa sắt mỹ thuật",860000,960000,100000,10
TIKI,nha-cua-doi-song,36629994,"Pin Sạc Lithium 18650 3.7V  new",15900,15900,0,0
TIKI,nha-cua-doi-song,75373271,"Túi Bạt Đựng Quần Áo, Chăn Mền, Túi Chăn 100L Chống Thấm Nước - Sọt Đựng Đồ Gấp Gọn Cỡ Đại 50x40x50cm - Hàng Chính Hãng",61750,65000,3250,5
TIKI,nha-cua-doi-song,117582501,"Bộ 2 dụng cụ cạo lưỡi bằng inox 304, làm sạch bề mặt lưỡi giúp hơi thở thơm mát",31997,31997,0,0
TIKI,nha-cua-doi-song,57243045,"Cuộn 10 Mét Ron Dán Khung Cửa Giảm Tiếng Ồn Va Đập, Ngăn Bụi, Ngăn Côn Trùng Size  4 mm 6 mm 8 mm 10 mm - Hàng Chính Hãng",70000,110000,40000,36
TIKI,nha-cua-doi-song,171922257,"Áo Mưa Bộ RANDO Chính Hãng, Nhựa Trong Thời Trang, Siêu Nhẹ, Không Thấm Nước, Dành Cho Đi Phượt, Đi Xe Đạp",219000,219000,0,0
TIKI,nha-cua-doi-song,53307168,"Đũa Tập Ăn Cho Bé",12000,12000,0,0
TIKI,nha-cua-doi-song,132276904,"Bình Ủ Trà  Giữ Nhiệt Inox 304 Có Vòi Bấm Nước- Dung Tích 8-12 L - Hàng Loại 1- Chính Hãng MINIIN",282000,363000,81000,22
TIKI,nha-cua-doi-song,72841405,"Bộ 4 Móc Dán Tường Inox 304 Lưỡi Câu Cao Cấp MD01 Chống Gỉ Sét Siêu Bền Siêu Chịu Lực - Móc Treo Đồ Gia Đình Tiện Dụng",155000,210000,55000,26
TIKI,nha-cua-doi-song,41578500,"Bộ bù lông ốc vít các loại 900g Milliken",250000,250000,0,0
TIKI,nha-cua-doi-song,26576088,"Đèn Ngủ Hình Trứng Gà Màu Vàng Óng Dễ Thương",13000,13000,0,0
TIKI,nha-cua-doi-song,72513099,"Đèn Nháy LED Cảm Biến Theo Nhạc Tạo Hiệu Ứng 7 Màu Dùng Trang Trí Phòng Làm Việc, Phòng Karaoke, Sinh Nhật, Có Remote Điều Khiển Từ Xa",89989,89989,0,0
TIKI,nha-cua-doi-song,101894776,"Bóng bulb trụ PHILIPS Tforce Core G3 (Thế hệ mới)- Hi Lumen (22W,30W,40W,50W)",76800,79200,2400,3
TIKI,nha-cua-doi-song,54875389,"Gối Massage Vòng Cổ Chữ U Đa Năng,Gối Ngủ Văn Phòng, Gói Đi Du Lịch",229997,229997,0,0
TIKI,nha-cua-doi-song,105880677,"Bóng Đèn Compact V-Light PL 13W",50000,50000,0,0
TIKI,nha-cua-doi-song,103850354,"Đầu Chuyển Chấu | Chuyển đổi phích cắm 2 chân - 3 chân (nhiều tiêu chuẩn)",19000,25000,6000,24
TIKI,nha-cua-doi-song,70090449,"Bộ dụng cụ nhả kem đánh răng tự động độc lập và giá treo bàn chải đa năng 02 cốc HT SYS-ECOCO-E1924 - chất liệu ABS cao cấp",188000,325000,137000,42
TIKI,nha-cua-doi-song,52483298,"Màng nhựa PVC trong suốt loại cứng - kính nhựa làm tấm che, vách ngăn trong suốt - khổ 80cm",50000,50000,0,0
TIKI,nha-cua-doi-song,52469160,"Thảm lông trắng trải sàn siêu mượt dành cho trang trí nhà- thảm chụp ảnh",48000,48000,0,0
TIKI,nha-cua-doi-song,113454140,"Khay treo bồn rửa bát có lưới lọc rác đa năng, tiện dụng",7000,7000,0,0
TIKI,nha-cua-doi-song,168960299,"Băng Keo Siêu Dính Đa Năng, Băng Dính Chống Thấm, Chống Dột Dán Được Trên Mọi Bề Mặt Chọn Size WaterProof Tape Chính Hãng Amalife – Băng Dính Chống Thấm Nhật Bản",49900,49900,0,0
TIKI,nha-cua-doi-song,558335,"Ổ Cắm Điện Có Nắp Che 5 Lỗ 2 Chân Mpower MP-153 - 3 Mét",99000,125000,26000,21
TIKI,nha-cua-doi-song,4546885,"Bộ 12 Ly Thủy Tinh Bầu Lùn Góc Uống Trà Đá Camdaco (225ml)",81000,81000,0,0
TIKI,nha-cua-doi-song,91271951,"Túi 100 Màng Bọc Thực phẩm, Thức Ăn Co Dãn Tái Sử Dụng Nhiều Lần HÀNG ĐẸP",7995,7995,0,0
TIKI,nha-cua-doi-song,480128,"Bình Nước Thể Thao PC Lock&Lock HPP722 - 700Ml",99000,168000,69000,41
TIKI,nha-cua-doi-song,8321424,"Bộ 10 Viên Nam Châm Đất Hiếm 20x10x2mm",49000,49000,0,0
TIKI,nha-cua-doi-song,83397883,"MHL7 - 45x45x45 cm - 10 Thùng hộp carton",206000,206000,0,0
TIKI,nha-cua-doi-song,113041554,"Mũi khoan khoét tường,bê tông - Khoan rút lõi tường gạch lắp điều hòa răng hợp kim",119000,119000,0,0
TIKI,nha-cua-doi-song,94737742,"Kệ Vuông 3 Tầng Màu Gỗ Tự Nhiên- Tháo lắp dễ dàng, sức chịu lực lớn",155000,169000,14000,8
TIKI,nha-cua-doi-song,186636635,"Vòi xịt vệ sinh có giá đỡ và dây cấp Chiba Hafele 589.34.921 (Hàng chính hãng)",300000,410000,110000,27
TIKI,nha-cua-doi-song,273546668,"Nhang cây trầm hương đốt xông nhà tẩy uế HÀ XÁ đồ thờ cúng phong thủy, xua đuổi vận xui, thu hút nguồn năng lượng tích cực, thanh lọc không khí, an toàn cho sức khỏe",99000,198000,99000,50
TIKI,nha-cua-doi-song,85378825,"Chuông Báo Khách Cửa Hàng, Báo Động Chống Trộm Cảm Biến Hồng Ngoại CTFAST 01 - Chuông Cửa Báo Khách Ghé Thăm, Dọa Trộm Xâm Nhập, Ánh Sáng Đèn Ngủ",340000,379000,39000,10
TIKI,nha-cua-doi-song,51706657,"Bộ điều khiển từ xa cho quạt trần và đèn mạch quạt điều khiên từ xa",81000,81000,0,0
TIKI,nha-cua-doi-song,144070527,"Đầu cos dây điện tròn có phủ nhựa-1250 đầu cos đựng trong hộp nhựa tiện dụng",99000,99000,0,0
TIKI,nha-cua-doi-song,106676756,"Thùng rác đạp chữ nhật Inochi 30L",349000,349000,0,0
TIKI,nha-cua-doi-song,268505461,"Dù Golf cao cấp khung chịu lực kép Nason 27 inch, khắc tên logo lên cán gỗ, chống lật trong gió to, che 2 3 người, nan sợi thủy tinh, lịch lãm, hợp thời trang",349000,349000,0,0
TIKI,nha-cua-doi-song,59452008,"Ổ cắm điện đa năng Sopoka",36000,36000,0,0
TIKI,nha-cua-doi-song,253047582,"Thanh Xốp Chắn Khe Cửa Tiện Lợi Và Chống Côn Trùng",9000,14500,5500,38
TIKI,nha-cua-doi-song,181503592,"Ghế Đôn Hộp Vải Đa Năng VINAVU Chất Liệu Vải Oxford Cao Cấp",175000,175000,0,0
TIKI,nha-cua-doi-song,13309021,"chiếu trúc thanh Tây Bắc - Cao Bằng Việt Nam",133000,133000,0,0
TIKI,nha-cua-doi-song,136874704,"Kệ để Giày Dép 5 Tầng Bằng Gỗ Cao Cấp/Kệ được Thiết Kế 5 Tầng để Giày Dép ,ngăn Kéo đựng đồ Kt Kệ 5 Tầng: 83 X 24 X  60",156578,156578,0,0
TIKI,nha-cua-doi-song,184123491," Set 5 Khăn Nén Dùng Một Lần Tiện Dụng Khi Đi Du Lịch",51000,70000,19000,27
TIKI,nha-cua-doi-song,5853283,"Tấm lưới tựa lưng ghế văn phòng tiện ích",28110,28110,0,0
TIKI,nha-cua-doi-song,14323807,"Túi đựng chăn màn khung sắt - màu cơ bản/giao ngẫu nhiên",56000,56000,0,0
TIKI,nha-cua-doi-song,90850064,"COMBO 3M DECAL DÁN KÍNH MỜ TRÚC TRẮNG",119000,119000,0,0
TIKI,nha-cua-doi-song,26056546,"Kệ sách gỗ dạng xương cá (mầu vân gỗ như hình)",111998,111998,0,0
TIKI,nha-cua-doi-song,117583065,"Cốc (ly) bằng inox 304 loại 2 lớp 280ml, có nắp đạy 2 lớp giữ nhiệt và chống nóng tốt",139000,139000,0,0
TIKI,nha-cua-doi-song,124069690,"Lưới chống muỗi, côn trùng 304 1x1.3m ",85000,85000,0,0
TIKI,nha-cua-doi-song,187764887,"Tấm Chắn Gió Bếp Chống Văng Dầu Mỡ KUNBE Chất Liệu Inox 304 Chắc Chắn Bền Đẹp, Chắn Gió Hiệu Quả",249000,249000,0,0
TIKI,nha-cua-doi-song,71105367,"Cuộn Giấy Decal Dài Khoảng Từ 3 Mét, Giấy Decal Dán Bếp, Giấy Dán Tường Tráng Nhôm Cách Nhiệt Cao Cấp Chính Hãng Amalife",41000,41000,0,0
TIKI,nha-cua-doi-song,92533598,"Giá Kệ Để Chậu Hoa, Đôn Để Chậu Hoa Cây Kiểng Kích Thước Rộng 25cm x Cao 19.5cm",105000,105000,0,0
TIKI,nha-cua-doi-song,161236346,"Bộ 2 chiếc hộp vải đựng đồ Thụy Điển 24L, Combo 2 chiếc túi vải đa năng TD1 có chọn màu miDoctor",150000,250000,100000,40
TIKI,nha-cua-doi-song,86962592," 100 Túi bao Bưởi cỡ lớn, Bưởi Da Xanh,.. túi bao trái cây VẢI KHÔNG DỆT RÚT TÚI CHUYÊN DỤNG",58000,58000,0,0
TIKI,nha-cua-doi-song,197334789,"[Xuất Nhật] Kệ Để Đồ Đa Năng 4 Tầng Tokyo - Nhựa Cao Cấp Rất Chắc Chắn Dùng Để Đựng Đồ Nhà Bếp  Hoặc Làm Giá Để Đồ Nhà Tắm Phòng Ngủ",180000,180000,0,0
TIKI,nha-cua-doi-song,15457912,"Áo mưa gấp gọn đi du lịch",19000,19000,0,0
TIKI,nha-cua-doi-song,152446601,"Cây trầu bà vàng - cây cảnh để trong nhà + tặng phân bón cho cây",29000,38000,9000,24
TIKI,nha-cua-doi-song,52238892,"Bộ dụng cụ làm vườn chuyên dụng ( Găng tay làm vườn móng vuốt và 3 dụng cụ xẻng làm vườn mini)",29000,29000,0,0
TIKI,nha-cua-doi-song,38434027,"Thanh treo rèm cửa inox không cần khoan tường hay bắt vít, thay đổi vị trí linh hoạt HT04",55000,55000,0,0
TIKI,nha-cua-doi-song,193904085,"Keo dính, bẫy thằn lằn, thạch sùng, ruồi DAEGIL, hoa văn thu hút thằn lằn, thạch sùng, xuất xứ Hàn Quốc (1 hộp 5 miếng)",55000,55000,0,0
TIKI,nha-cua-doi-song,1937707,"Decal Dán Tường Bé Đi Sở Thú",39000,77000,38000,49
TIKI,nha-cua-doi-song,905112,"Bình Lưỡng Tính Zojirushi SF- CC20- XA (2L)",959000,959000,0,0
TIKI,nha-cua-doi-song,53993306,"Thước kẹp điện tử với phạm vi đo 0-150mm hiển thị màn hình kỹ thuật số",58999,58999,0,0
TIKI,nha-cua-doi-song,22362602,"Keo chuyên dụng dán màn hình và mỹ nghệ  B7000 50ml",25000,25000,0,0
TIKI,nha-cua-doi-song,2239281,"Decal dán tường thế giới cá ngộ nghĩnh cho bé ZOOYOO XL7225",60000,60000,0,0
TIKI,nha-cua-doi-song,114616457,"Bàn chải silicon gội đầu massage cho trẻ em và người lớn- Dụng cụ chà lưng, tay chân tạo bọt silicon mềm mại",49000,49000,0,0
TIKI,nha-cua-doi-song,16378194,"Dụng cụ lọc trà bằng inox",15000,15000,0,0
TIKI,nha-cua-doi-song,102464159,"Sơn xịt ATM Spray đa năng xịt trên mọi chất liệu cao cấp",36000,36000,0,0
TIKI,nha-cua-doi-song,71158649,"700ml - Bình xịt sơn chống thấm chống dột Bixuan dung tích lớn, chống thấm trần nhà công nghệ Thụy Sĩ",59000,59000,0,0
TIKI,nha-cua-doi-song,52719833,"Bộ Mũi Khoan Rút Lõi Điều Hòa Kèm Cán Chuôi Rút Lõi Bê Tông Cao Cấp",189000,189000,0,0
TIKI,nha-cua-doi-song,75179250,"Kiềng Chắn Gió Bếp Gas, Tấm, Vỉ Che Bếp Chống Tỏa Nhiệt, Tiết Kiệm Gas KUNBE Mẫu Mới - Tặng Khăn Lau Bếp Đa Năng",38000,38000,0,0
TIKI,nha-cua-doi-song,106503197,"Gối Hơi Văn Phòng Gấp Gọn _Gối Hơi Du Lịch Dã Ngoại",28000,28000,0,0
TIKI,nha-cua-doi-song,11290201,"Ổ Cắm Công Suất Lớn Điện Quang ĐQ ESKHP 3RB (3 Lỗ, Màu Đỏ Đen, Không Dây)",81840,102300,20460,20
TIKI,nha-cua-doi-song,69228458,"Khóa cửa tay nắm tròn Demax LK302 SS - Hàng chính hãng",99000,99000,0,0
TIKI,nha-cua-doi-song,12734772,"Bút đo độ PH, máy đo PH, dụng cụ đo PH (PH-2, Có đèn led)",89000,89000,0,0
TIKI,nha-cua-doi-song,106707718,"Cục chống va đập cửa vào tường dán gạch men Hobby Home Decor CC3 có đệm cao su kèm keo dán và đinh ốc",42000,59000,17000,29
TIKI,nha-cua-doi-song,51984645,"Thùng rác có nắp treo cửa tủ bếp tiện dụng - Giao màu ngẫu nhiên",82000,82000,0,0
TIKI,nha-cua-doi-song,144515292,"Kính hàn điện tử mặt kính thay thế",69000,69000,0,0
TIKI,nha-cua-doi-song,54747122,"Chặn cửa chống va đập cửa Hy Lạp",110000,110000,0,0
TIKI,nha-cua-doi-song,578974,"Chảo Trơn Chống Dính Sunhouse CT16 16cm",60000,100000,40000,40
TIKI,nha-cua-doi-song,124272941,"Ổ Khóa Inox 3 Vòng Số Dài 6cm Chống Rỉ Sét",32000,32000,0,0
TIKI,nha-cua-doi-song,103564402,"Dây vòi sen Inox HOBBY DS Inox 304 chiều dài 1.5m và 2m tùy chọn",49000,99000,50000,51
TIKI,nha-cua-doi-song,51005591,"Túi Giặt Bảo Vệ Quần Áo - Nhiều Mẫu",26000,26000,0,0
TIKI,nha-cua-doi-song,101995256,"Thanh Xốp Chắn Khe Cửa Đa Năng Thông Minh",28000,35000,7000,20
TIKI,nha-cua-doi-song,45838799,"Túi lưới giặt đồ lót siêu tiện lợi",45000,45000,0,0
TIKI,nha-cua-doi-song,145667317,"Bộ 5 Tấm Xốp Dán Tường Hoạt Hình Cầu Vòng Dễ Thương, Kích Thước 70cm x 77cm",85000,85000,0,0
TIKI,nha-cua-doi-song,131244888,"Combo 5 bộ dụng cụ sửa đế âm tường chữ nhật hỏng nhanh chóng ",90250,95000,4750,5
TIKI,nha-cua-doi-song,12409490,"PHÍCH CẮM ĐIỆN THÔNG MINH 1 CHIA 5 ",34000,34000,0,0
TIKI,nha-cua-doi-song,160132761,"Dụng cụ mở nắp chai, nắp rượu vang, khui hộp nhanh chóng Nhật Bản",26000,26000,0,0
TIKI,nha-cua-doi-song,153546308,"Phân bón hoa lan BIOGROW kích thân mầm lá, siêu kích kie lan, mầm to, cành khỏe, dung tích 500ml, chính hãng DOCNEEM",119000,119000,0,0
TIKI,nha-cua-doi-song,3305561,"Bộ Cưa Đa Năng 6 Lưỡi Kèm Hộp Đựng Tiện Dụng ",51999,51999,0,0
TIKI,nha-cua-doi-song,259319648,"1 Mét Vecrlo May Mặc, Rèm Loại Có Keo, Loại Không Có Keo",9999,9999,0,0
TIKI,nha-cua-doi-song,60202866,"Bộ 5 Miếng móc dán tường treo đồ dùng cho nhà bếp, phòng tắm GNG",2563,2698,135,5
TIKI,nha-cua-doi-song,173903547,"Khăn lau nhà bếp siêu thấm hút 2 mặt đa năng mềm mịn - Henrysa",20000,40000,20000,50
TIKI,nha-cua-doi-song,11205190,"Công Tắc Hẹn Giờ Điện Tử KG316T2 25A/220v",67500,67500,0,0
TIKI,nha-cua-doi-song,142239175,"Thanh Đôi Dán Tường Treo Khăn Nhà Tắm Có Móc MOHI - Hàng chính hãng (giao màu ngẫu nhiên)",35000,35000,0,0
TIKI,nha-cua-doi-song,191911136,"Kệ gỗ 5 tầng đa năng màu trắng đen, kệ sách đặt góc tường gỗ MDF phủ Melamine chống xước 50 x 20 x 120 TAGO ND24",135000,135000,0,0
TIKI,nha-cua-doi-song,28079716,"Hộp đựng xà phòng dầu gội sữa tắm Xinda ZYQ138 White",135000,135000,0,0
TIKI,nha-cua-doi-song,26348819,"Ổ cắm điện du lịch đa năng",159000,159000,0,0
TIKI,nha-cua-doi-song,111998312,"Tấm Silicon chà lưng massage lưng, massage chân",41000,41000,0,0
TIKI,nha-cua-doi-song,57030102,"Móc treo đồ dán tường cao cấp hình Gạc Hươu Etravel",34000,45000,11000,24
TIKI,nha-cua-doi-song,4464525,"Bộ lọc nước thô đầu nguồn 2 cấp lọc 10inch Yamato YMTH10-2TX",285000,285000,0,0
TIKI,nha-cua-doi-song,10111459,"Ổ cắm Điện Quang ECO ĐQ ESK 5BR 8ECO (8 Lỗ, dây dài 5m, màu đen đỏ)",160000,212700,52700,25
TIKI,nha-cua-doi-song,56459420,"Bộ Hộp Cơm Giữ Nhiệt Thủy Tinh Văn Phòng Cao Cấp - Kèm Túi Xách và Hộp Đựng Đũa Thìa (Tùy chọn màu)",148999,148999,0,0
TIKI,nha-cua-doi-song,185448924,"Máy rửa vệ sinh kính, đồng hồ, trang sức đa năng 3 in 1- Hộp tẩy rửa làm sạch bằng sóng siêu âm chạy pin dùng sạc",99500,199000,99500,50
TIKI,nha-cua-doi-song,183910532,"Cốc thủy tinh hổ phách GorGous bọc da 450ml sang chảnh chống bỏng có nắp kín cao cấp thời trang Qimato - NGẨU NHIÊN",23000,25799,2799,11
TIKI,nha-cua-doi-song,37929600,"Đèn bắt muỗi Đại Sinh D6 tặng kèm 1 bóng thay thế",655000,655000,0,0
TIKI,nha-cua-doi-song,172940012,"Bộ Dao Nhà Bếp Nhật 6 Món Cao Cấp - Chính hãng DODODIOS, dao nhà bếp Nhật Bản - Logo trên thân dao ngẫu nhiên",184000,184000,0,0
TIKI,nha-cua-doi-song,172566210,"Tủ gỗ thấp kê cửa sổ, ban công , dọc tường nhiều ngăn có cánh cửa tiện lợi đa chức năng giá xưởng Kagu",265998,265998,0,0
TIKI,nha-cua-doi-song,177081678,"Cây Hoa Giấy Ngũ Sắc (Chuẩn đẹp 100%) - cây cảnh để bàn + tặng phân bón cho cây",19000,38000,19000,50
TIKI,nha-cua-doi-song,169191699,"Bình đựng nước Gốm sứ Bát Tràng",450000,450000,0,0
TIKI,nha-cua-doi-song,169043847,"Xốp hơi bọc hàng, màng xốp khí gói hàng, bọc chống sốc, xốp nổ loại dày, KT 50cm*1m",2000,8000,6000,75
TIKI,nha-cua-doi-song,83398300,"MXK1B - 20x10x10 cm - 100 Thùng hộp carton",168000,168000,0,0
TIKI,nha-cua-doi-song,71057267,"Combo 2 Hộp Muối Dưa Cà - Ngâm Hoa Quả Lock&Lock INL413 (2.1 Lit) và INL412 (1.3Lit) Có Thể Để Trong Tủ Lạnh",199000,296000,97000,33
TIKI,nha-cua-doi-song,154880475,"Bàn Gaming, Bàn làm việc chân sắt TI-GM01",790000,790000,0,0
TIKI,nha-cua-doi-song,105137438,"Bàn học làm việc, bàn gaming chân sắt chữ Z hiện đại 1m2 - Chính hãng TIDO",690000,690000,0,0
TIKI,nha-cua-doi-song,60709422,"Cây Treo Quấn Áo Phong Cách Hàn Quốc Thương Hiệu IGEA - GP60",254600,268000,13400,5
TIKI,nha-cua-doi-song,150902332,"Bộ chăn ga gối cotton LIDACO PL1 - Kẻ ô xanh dương nhỏ SP001454",197000,289000,92000,32
TIKI,nha-cua-doi-song,152446360,"Cây Trầu Bà Hồng - Cây cảnh mini để bàn + Tặng phân bón cho cây",39000,58000,19000,33
TIKI,do-choi-me-be,12425734,"Lốc 4 Gói Khăn Giấy Cao Cấp Tempo Softpack Không Mùi, 4 Lớp, Không Gây Kích Ứng Da (90 Tờ/ Gói) - Thương Hiệu Đức",105000,105000,0,0
TIKI,do-choi-me-be,73854854,"Bộ Cờ Cá Ngựa Hộp Nhựa Chắc Chắn 30Cmx30Cm",38000,38000,0,0
TIKI,do-choi-me-be,55961916,"Bột Giặt LIX Extra Hương Hoa 2.4Kg EB024 - Tẩy Sạch Vết Bẩn Cực Mạnh",72000,72000,0,0
TIKI,do-choi-me-be,105778887,"Đồ chơi mô hình 6 xe cảnh sát hình sự KAVY No.8807 nhiều màu sắc bằng kim loại",132000,132000,0,0
TIKI,do-choi-me-be,116572117,"Thùng 6 lon sữa bột dinh dưỡng công thức HiPP 2 Organic Combiotic chất lượng hữu cơ tự nhiên an toàn, bổ sung Omega 3 (DHA & ALA) dành cho trẻ từ 6 đến 12 tháng tuổi (6 lon x 800g)",4320000,4320000,0,0
TIKI,do-choi-me-be,94728359,"Gối cao su non cho bé 100% Cotton hữu cơ có lỗ chống ngạt cho bé Comfybaby 6201 - Đồ dùng cho bé từ sơ sinh tới 8 tuổi - CF062018N03 & CFN01",299000,380000,81000,21
TIKI,do-choi-me-be,97856241,"Bộ Quây Cũi Nhựa Gấp Gọn Cho Bé Yêu- Tặng Thảm Xốp, Bóng Và Sọt Đựng Bóng",1390000,1390000,0,0
TIKI,do-choi-me-be,273180228,"Sure Prevent Gold HT",605000,630904,25904,4
TIKI,do-choi-me-be,3005389,"Dung Dịch Giặt Quần Áo Cho Bé D-Nee - Chai 3000ml (Xanh lá)",196000,245000,49000,20
TIKI,do-choi-me-be,116572134,"Thùng 4 lon sữa bột dinh dưỡng công thức HiPP 2 Organic Combiotic chất lượng hữu cơ tự nhiên an toàn, bổ sung Omega 3 (DHA & ALA) dành cho trẻ từ 6 đến 12 tháng tuổi (4 lon x 800g)",2880000,2880000,0,0
TIKI,do-choi-me-be,108550701,"Lều công chúa cho Bé Ngủ chơi Lều công chúa, lều hoàng tử s5 vải mềm siêu đẹp cho bé hàng loại 1",265000,265000,0,0
TIKI,do-choi-me-be,115483447,"Sữa bột Enfamil A+ NeuroPro 2 với 2’-FL HMO cho trẻ từ 6 –12  tháng tuổi– 400g",266000,266000,0,0
TIKI,do-choi-me-be,96608806,"Nước giặt đồ lót Lingerie Soap 120ml",94500,94500,0,0
TIKI,do-choi-me-be,74512193,"Gấu Bông Gối Ôm Khủng Long Đuôi Tim Bông Gòn Cao Cấp",50000,50000,0,0
TIKI,do-choi-me-be,10710902,"Sữa bột Vinamilk Dielac Alpha 4 - Hộp thiếc 1500g (dành cho trẻ 2-6 tuổi)",343000,389000,46000,12
TIKI,do-choi-me-be,1380475,"Combo 3 Gói Khăn Giấy Ướt 100 Tờ Không Mùi Kháng Khuẩn An Toàn Cho Bé Mamamy ( 100 Tờ Nắp x 3)",101000,101000,0,0
TIKI,do-choi-me-be,50256293,"Nước Tẩy Trắng Quần Áo Lix Javel 1kg",20000,20000,0,0
TIKI,do-choi-me-be,629921,"Bộ 2 Gói Nước Rửa Bình Sữa Wesser (500ml x 2)",160000,160000,0,0
TIKI,do-choi-me-be,13566900,"Combo 3 hộp khăn khô đa năng Mamamy",165000,165000,0,0
TIKI,do-choi-me-be,49232078,"Gạc Rơ Lưỡi Dr Papie Vệ Sinh Răng Miệng Cho Bé , Gạc Răng Miệng Dr Papie Làm Sạch Răng Miệng Cho Bé Hộp 30 Miếng",110000,110000,0,0
TIKI,do-choi-me-be,20024063,"Thùng 48 Hộp x 110ml Sữa Bột Pha Sẵn GrowPLUS+ Đỏ 110ml Suy Dinh Dưỡng - Hàng Chính Hãng",385000,385000,0,0
TIKI,do-choi-me-be,151745410,"Ghế ăn dặm cho bé gấp gọn nâng hạ độ cao Mastela 07110 / 07112  - Ghế tập ăn dặm cho bé chuẩn ASTM Mỹ BPA Free",579000,579000,0,0
TIKI,do-choi-me-be,53627304,"Chất tẩy xi măng trên nhiều chất liệu, tẩy ron gạch siêu mạnh HT01-TVS -5 Lit (sản phẩm mới hoạt chất bảo vệ bề mặt 100%, chất lượng cao)",350000,399000,49000,12
TIKI,do-choi-me-be,49495083,"Tã/Bỉm quần cao cấp MIJUKU gói 50 miếng - M",165000,165000,0,0
TIKI,do-choi-me-be,80358747,"Đồ Chơi Nhập Vai Bác Sĩ Cho Bé Từ 3 Tuổi Bowa",239000,239000,0,0
TIKI,do-choi-me-be,58457905,"Tấm lót chống thấm cho bé cao cấp - Kích thước 70x120cm. Miếng lót chống thấm thoáng khí, siêu thấm và an toàn cho trẻ sơ sinh và trẻ nhỏ - TLCTCB00001",245000,245000,0,0
TIKI,do-choi-me-be,191620753,"Máy in con lăn tạo phép tính cộng trừ,máy tạo phép tính đơn giản ra bài tập cho bé học toán",25998,25998,0,0
TIKI,do-choi-me-be,49957356,"Bánh Ăn Dặm Gạo Lứt Phô Mai Bebedang Cho Bé Nhập Khẩu Hàn Quốc",43500,55000,11500,21
TIKI,do-choi-me-be,129458810,"Trà cốm hoa quả Burine dinh dưỡng dành cho bé - Vị Cam Nam Mỹ giúp hỗ trợ giảm viêm nhiễm, tăng cường đề kháng (Không dành cho trẻ dưới 8 tháng tuổi)",155000,155000,0,0
TIKI,do-choi-me-be,192202449,"100 sleeve bọc bài UNO 5.9x9cm , Mèo nổ 6.5x9cm",20000,20000,0,0
TIKI,do-choi-me-be,127197584,"Xe đồ chơi mô hình đầu kéo container vận chuyển KAVY No.8807 đầu hợp kim tháo rời kích thước lớn tỷ lệ 1:48 - nhiều màu",125000,125000,0,0
TIKI,do-choi-me-be,99043326,"Mèo Nổ Mini Exoloding Kittens cơ bản Tặng Kèm Móc Khóa TTH",70000,139000,69000,50
TIKI,do-choi-me-be,113767814,"Sữa Bột Meiji 1-3 Growing Up Formula (800g)",479000,479000,0,0
TIKI,do-choi-me-be,95035849,"Bột ăn dặm dinh dưỡng Sữa, Ngũ cốc & rau củ - Cà rốt HiPP Organic 250g",145000,145000,0,0
TIKI,do-choi-me-be,96912147,"Bịch 10 Khăn sữa Cotton viền màu 4 lớp an toàn cho trẻ sơ sinh - Aiko (Hàng Việt Nam xuất Nhật) (Khăn kích thước 27cm x 25cm)",45000,45000,0,0
TIKI,do-choi-me-be,171833960,"Viên Xông Giúp Thông Mũi Họng Giảm Nghẹt Mũi Sổ Mũi Tinh Dầu Hương Tràm ( Hộp 20 viên )",59400,59400,0,0
TIKI,do-choi-me-be,51730775,"Hộp quà búp bê Sweet days, thích hợp làm quà tặng,quà sinh nhật cho bé yêu (màu ngẫu nhiên) ",110000,110000,0,0
TIKI,do-choi-me-be,196177336,"Khăn Giấy Lụa Rút 2 lớp Bless You À La Vie cao cấp x 250 tờ",26000,40000,14000,35
TIKI,do-choi-me-be,52588245,"Combo 2 lon Sữa Morinaga số 2 (Chilmil) 850g",954000,1156000,202000,17
TIKI,do-choi-me-be,79008843,"[COMBO 6 GÓI] KHĂN VẢI KHÔ ĐA NĂNG AIKO 270 TỜ/ GÓI",192000,192000,0,0
TIKI,do-choi-me-be,40889382,"Tẩy mốc HT01 (Tẩy mốc quần áo, mốc tường đậm đặc H+T01-1,8L)",109000,120000,11000,9
TIKI,do-choi-me-be,68554792,"Tấm lót chống thấm cho bé dùng được 2 mặt. Miếng lót chống thấm xuống nệm, thoáng khí, hàng chính hãng - 50x70",139000,199000,60000,30
TIKI,do-choi-me-be,129976841,"Gối Ôm Bà Bầu Chữ U vải nhung mềm mại hỗ trợ giảm đau lưng, gối bà bầu đa năng cực tiện hàng cao cấp - Màu xám ghi",275000,275000,0,0
TIKI,do-choi-me-be,147527644,"Áo trắng học sinh nam tay ngắn, đồng phục đi học cho bé trai từ 20-95 kg, vải KT Silk mềm mướt",97000,154000,57000,37
TIKI,do-choi-me-be,124174883,"Tã/bỉm dán Molfix Thiên nhiên Super Jumbo M (6kg - 11kg) - Gói 76+8 miếng",340000,340000,0,0
TIKI,do-choi-me-be,10000117,"Sáp thơm phòng Hando 87g hương hoa hồng",17000,17000,0,0
TIKI,do-choi-me-be,119706878,"Sữa tắm dưỡng ẩm dịu lành cho bé Cetaphil Baby Moisturizing Bath & Wash 230ml",170000,170000,0,0
TIKI,do-choi-me-be,7020189,"Rubik Gan356 R 3x3 Stickerless",350000,350000,0,0
TIKI,do-choi-me-be,109331107,"Ty ngậm silicon chuẩn y tế Philips Avent (silicon nguyên khối) cho trẻ 3-18 tháng tuổi 194.03",285000,285000,0,0
TIKI,do-choi-me-be,505901,"Combo 3 Vỉ Tẩy Diệt Khuẩn Vệ Sinh Bồn Cầu Cao Cấp Hàn Quốc Blueshot",129000,150000,21000,14
TIKI,do-choi-me-be,77665180,"Máy hâm sữa tiệt trùng điện tử Duo 3 Fatz baby FB3093VN Hàn Quốc",498000,498000,0,0
TIKI,do-choi-me-be,110681205,"Cốc trữ sữa Philips Avent dung tích 180ml/cốc",605000,605000,0,0
TIKI,do-choi-me-be,108003928,"Bộ 2 Bình sữa mô phỏng tự nhiên hiệu Philips Avent (260ml) cho trẻ từ 1 tháng tuổi 693.23",525000,525000,0,0
TIKI,do-choi-me-be,127120922,"đồng hồ trẻ em - có đèn",60000,60000,0,0
TIKI,do-choi-me-be,20959663,"Dầu Tràm cho bé loại 1 phòng ngẹt mũi và sổ mũi cho bé 100ml - trắng vàng nhạt",150000,150000,0,0
TIKI,do-choi-me-be,99056835,"Kẹp tóc, cột tóc, dây buộc tóc sét 780 chi tiết kẹp tóc cho bé OLAPLE",99000,99000,0,0
TIKI,do-choi-me-be,107961508,"CỜ THÚ HỘP GIẤY LIÊN HIỆP THÀNH NEW",73000,73000,0,0
TIKI,do-choi-me-be,116142695,"Phô Mai Hoa Quả Sấy Lạnh YOMIT Cho Bé Nhập Khẩu Hàn Quốc",73500,82000,8500,10
TIKI,do-choi-me-be,72549297,"Gối chống trào ngược cho bé Rototo bebe cao cấp khắc phục tình trạng trào ngược dạ dày trẻ sơ sinh hiệu quả - Loại Cotton lụa mẫu mới nhất",1545000,1720000,175000,10
TIKI,do-choi-me-be,52588247,"Combo 2 lon Sữa Morinaga số 2 (Chilmil) 320g (6 - 36 tháng)",427000,556000,129000,23
TIKI,do-choi-me-be,163574256," Bộ Bài Board Game Splendor Độc Đáo Không Thấm Nước",300000,300000,0,0
TIKI,do-choi-me-be,56699120,"Thùng 35 Gói - 7 Vị Cháo Tươi Cây Thị: Gà Ác Đậu Xanh, Cá Hồi, Cá Lóc, Lươn Đậu Xanh, Thịt Bò, Rau Củ, Thịt Heo ",686375,842500,156125,19
TIKI,do-choi-me-be,60192179,"Balo Bỉm Sữa Cao Cấp Mama's Choice 4in1 | Balo Cho Mẹ Bỉm Sữa và Bé Yêu | Lớp Giữ Nhiệt Dày Dặn và Chống Thấm | Nhiều Ngăn Siêu Tiện Dụng",299000,340000,41000,12
TIKI,do-choi-me-be,14319391,"Đai Đi Xe Máy Cho Bé Autoru",190000,190000,0,0
TIKI,do-choi-me-be,95035875,"Bột ăn dặm dinh dưỡng Sữa, Hoa quả tổng hợp - Táo, Chuối, Lê, Mơ HiPP Organic 250g",145000,145000,0,0
TIKI,do-choi-me-be,197600292,"Que Thử Thai Cao Cấp Dùng Một Lần Power Test - Chính Xác Và Tiện Dùng",19000,19000,0,0
TIKI,do-choi-me-be,74871616,"Bộ đồ chơi lắp ráp xe công trình KAVY  gồm 6 xe kèm hộp đựng, tua vít, nhựa nguyên sinh kích thích tính thực hành của bé",255000,255000,0,0
TIKI,do-choi-me-be,67550669,"Bộ đồ chơi nhà bếp cho bé nấu nướng có vòi nước và bảng vẽ Toyshouse - đồ hướng nghiệp cho bé từ 3 tới 8 tuổi",329000,529000,200000,38
TIKI,do-choi-me-be,32042103,"Áo Choàng Cắt Tóc Chống Nước Tiện Dụng",30000,35000,5000,14
TIKI,do-choi-me-be,172300775,"Núm Ty Philips Avent - Núm Vú Philips Avent - Thay Bình Sữa dòng Natural - Đủ Size 1 / 2 / 3 / 4 / Y Lỗ - Tặng 1 Khăn Sữa Gạc Vải thương hiệu Unmei",115000,115000,0,0
TIKI,do-choi-me-be,17450924,"ĐỆM NGỦ CHỐNG GIẬT MÌNH CHO BÉ",231000,300000,69000,23
TIKI,do-choi-me-be,145176658,"Yếm Bonny Vải Xô 6 Lớp Có Cúc Bấm Bên Vai Giúp Bé Thấm Rớt, Giữ Ấm Ngực (10 Tháng - 3 Tuổi)",30000,30000,0,0
TIKI,do-choi-me-be,41400962,"SỮA BỘT GROWPLUS+ DINH DƯỠNG HIỆU QUẢ GIÚP TRẺ TĂNG CÂN KHỎE MẠNH - LON 1.5KG",389000,389000,0,0
TIKI,do-choi-me-be,38590945,"Thanh chắn giường cao cấp Umoo",199000,199000,0,0
TIKI,do-choi-me-be,37954830,"Ghế Rung Nhún Đa Năng Cho Bé",199000,199000,0,0
TIKI,do-choi-me-be,57520029,"Xe Thăng Bằng Tập Đi Cho Bé, Xe Chòi Chân Cho Bé Từ 18 Tháng Đến 5 Tuổi, Giúp Bé Ham Vận Động, Phát Triển Thể Chất Tối Ưu EBV GROUP An Toàn, Bền Đẹp - Hàng Chính Hãng",469000,690000,221000,32
TIKI,do-choi-me-be,94728152,"Hộp đồ dụng cụ sửa chữa cơ khí, bác sĩ, nấu ăn. trang điểm Toys House 008-916 - Đồ chơi hướng nghiệp phát triển trí tuệ và vận động",199000,250000,51000,20
TIKI,do-choi-me-be,24724062,"BỘT ĂN DẶM RIDIELAC GOLD GẠO SỮA - HỘP THIẾC 350G",80000,80000,0,0
TIKI,do-choi-me-be,73683244,"Combo 2 Túi Nước Giặt Xả Maxkleen Hương Hoa Nắng (2.4kg/túi)",276000,300000,24000,8
TIKI,do-choi-me-be,73287456,"Nước giặt LIX Đậm đặc (Đỏ) chai 3.8L",111000,111000,0,0
TIKI,do-choi-me-be,41178397,"Sữa Nucalci Gold bổ sung canxi cho người từ 51 tuổi trở lên - 800g",260000,260000,0,0
TIKI,do-choi-me-be,35873120,"Ghế Ăn Dặm Glosby Babyhop 2 nấc Chân Điều Chỉnh,ăn dặm kiểu nhật và BLW, cho bé từ 6 tháng, được làm từ nhựa nguyên sinh an toàn cho sức khỏe của bé -  Hàng chính hãng",615000,750000,135000,18
TIKI,do-choi-me-be,4334121,"Nước thơm lau sàn nhà 1L Hando (hương quế)",25000,25000,0,0
TIKI,do-choi-me-be,75620679,"Gấu bông mèo béo, gấu bông sang trọng, đồ chơi thú bông cực đáng yêu chất liệu vải nhung co dãn nhồi bông gòn cao cấp",380000,760000,380000,50
TIKI,do-choi-me-be,115483204,"Sữa bột Enfagrow A+ NeuroPro 3 với 2’-FL HMO cho trẻ từ 1 – 3 tuổi– 1.7kg",927000,927000,0,0
TIKI,do-choi-me-be,124716612,"Thùng 6 lon Sữa bột công thức HiPP 4 Organic Combiotic 800g (6 lon x 800g)",4050000,4050000,0,0
TIKI,do-choi-me-be,186529420,"Kem đánh răng Colgate trẻ em khủng long hương dâu 40g",10000,10000,0,0
TIKI,do-choi-me-be,71112405,"Body cho bé sơ sinh vải sợi tre cao cấp siêu mềm mịn - body suit cho trẻ sơ sinh - bé trai - bé gái , Bộ áo liền quần bodysuit cho bé , body dài tay cài giữa phối thân trước size cho bé từ newborn đến 12 tháng (2.5- 10kg) HAKI BB030",196000,220000,24000,11
TIKI,do-choi-me-be,73943160,"Khối Rubik 3x3",18400,18400,0,0
TIKI,do-choi-me-be,148005729,"Giường Cũi/ Nôi Cũi Đa Năng Cho Bé 6 Chế Độ Cỡ Lỡn RxDxC (67x120x102) Lọt Lòng 62x114",2180000,3080000,900000,29
TIKI,do-choi-me-be,126022179,"Tã Bỉm Dán/Quần YOULI XANH Đủ Size S56/M48/M44/L42/XL40/XXL36/XXXL34",125000,125000,0,0
TIKI,do-choi-me-be,820405,"Sữa Tắm Gội Toàn Thân Cetaphil Baby 2 In 1 (230ml)",159000,168000,9000,5
TIKI,do-choi-me-be,79608435,"Nhộng chũn Quấn chũn sợi tre Bamboo Life BL069 hàng chính hãng cho bé Túi ngủ cho bé giúp bé ngủ sâu chống giật mình",349000,349000,0,0
TIKI,do-choi-me-be,205293897,"Dung dịch vệ sinh máy rửa bát Finish 250ml (thị trường Đức) - Giao ngẫu nhiên",99000,99000,0,0
TIKI,do-choi-me-be,179512961,"Túi Viên Giặt Xả Đa Năng 4 Trong 1 KA Universal (5 Viên/ Túi)",40000,50000,10000,20
TIKI,do-choi-me-be,55102682,"Bàn xây dựng đa năng 2020",980000,980000,0,0
TIKI,do-choi-me-be,174257987,"[Tặng 6 Miếng Tã Dán Sơ Sinh]  Miếng Lót Bé Sơ Sinh Dưới 1 Tháng Bobby 64 Miếng",98000,98000,0,0
TIKI,do-choi-me-be,144188288,"Bộ Đồ Chơi Lắp Ghép STEM Máy bay 2 Cánh Quạt, Đồ Chơi Mô Hình Máy Bay 2 Cánh Quạt, Đồ Chơi Gỗ Cao Cấp Máy Bay 2 Cánh Quạt,Đồ Chơi Khoa Học Tự Làm DIY Wood Steam- Chính Hãng BABYBOSS + Tặng Kèm Tranh Ghép Gỗ",45000,65000,20000,31
TIKI,do-choi-me-be,130336269,"Bộ Bài Tây Poker Chất Liệu Cao Cấp Nhìn Siêu Chất - Chống Thấm Nước",47000,47000,0,0
TIKI,do-choi-me-be,93553646,"Siêu Cứu Hỏa - Rồng Phương Đông (Orient Dragon) Winka DK81044",448500,690000,241500,35
TIKI,do-choi-me-be,73642514,"Máy Hút Sữa Không Dây Mama's Choice, Vắt Sữa Rảnh Tay Mọi Lúc Mọi Nơi, Pin Sạc Tiện Lợi, BH 1 Đổi 1 Mới 12 Tháng - 1 Máy",1690000,1990000,300000,15
TIKI,do-choi-me-be,117399458,"bộ dụng cụ lấy ráy tai Kèm Kẹp Gắp Có Đèn Cho Bé Cao Cấp Mầu Hồng",128000,138000,10000,7
TIKI,do-choi-me-be,111657955,"Tả quần Babies Organic size L 50 miếng ( 9-14kg)",240000,320000,80000,25
TIKI,do-choi-me-be,82895211,"Cây Xương Rồng Nhồi Bông Có Nhạc, Biết Nhảy Biết Múa và Nhại Tiếng",75000,75000,0,0
TIKI,do-choi-me-be,169935553,"Đồ chơi Squishy dạng thú dễ thương giúp giảm căng thẳng",10000,10000,0,0
TIKI,do-choi-me-be,27104287,"Combo 5 Quần bỏ bỉm 6 lớp xuất Nhật",165000,165000,0,0
TIKI,do-choi-me-be,104147948,"Núm vú cổ hẹp silicone siêu mềm Pigeon (2 cái/vỉ)",77000,102000,25000,25
TIKI,do-choi-me-be,116841132,"Healthy Care Kids Gummy Multivitamin 250v Của Úc - Kẹo Dẻo Bổ Sung Vitamin Cho Bé ",388000,415000,27000,7
TIKI,do-choi-me-be,2983783,"Bột Giặt Lix Extra Hương Chanh 6Kg EC006 - Tẩy Sạch Vết Bẩn Cực Mạnh",129000,129000,0,0
TIKI,do-choi-me-be,2563681,"Bột Ăn Dặm Vinamilk Ridielac Cá Hồi Bông Cải Xanh (200g)",72000,72000,0,0
TIKI,do-choi-me-be,187393405,"Máy hút sữa điện rảnh tay và không dây Fatz Baby- Freemax 2- FB1202CW (1 chiếc)",1099000,1099000,0,0
TIKI,do-choi-me-be,178755035,"Nước Giặt Xả Đậm Đặt HYGIENE Túi 1800ml Sạch mọi viết bẩn - hương thơm tươi mát cả ngày dài",135000,135000,0,0
TIKI,do-choi-me-be,42023052,"Sữa Non Non ILDong Foodis CHOYUMEAL Plus: Số 1 - 100gr (Hàn Quốc)",249850,263000,13150,5
TIKI,do-choi-me-be,85754700,"Thảo mộc vệ sinh cho mẹ, xông vùng kín thơm tho, se khít Wonmom ( 10 Túi/Hộp )",171000,180000,9000,5
TIKI,do-choi-me-be,116572118,"Thùng 4 lon sữa bột dinh dưỡng công thức HiPP 1 Organic Combiotic chất lượng hữu cơ, hỗ trợ, tăng cường sức khoẻ hệ miễn dịch, bổ sung omega 3,6 (DHA&ARA) dành cho trẻ dưới 6 tháng tuổi (4 lon x 800g)",2920000,2920000,0,0
TIKI,do-choi-me-be,48182043,"Dung dịch tẩy rửa máy rửa chén Finish Dishwasher Cleaner Lemon 250ml PTT006774 - hương chanh",109000,109000,0,0
TIKI,do-choi-me-be,108914869,"Súp uống vi chất Fomeal Care hấp thu nhẹ bụng , bồi bổ sức khỏe",112500,112500,0,0
TIKI,do-choi-me-be,72577686,"03 bộ tranh xếp hình 70 mảnh ghép khổ A3 – đồ chơi trí tuệ cho bé từ 3 tuổi – Combo 3",85000,110000,25000,23
TIKI,do-choi-me-be,92901201,"Combo Tiết Kiệm: 10 Gói Khăn Ướt Bobby Care Không Hương 100 Miếng/Gói",375000,375000,0,0
TIKI,do-choi-me-be,35043557,"Sữa Bột Abbott Similac 4 900g",539000,539000,0,0
TIKI,thiet-bi-kts-phu-kien-so,273908702,"Bộ sạc nhanh IP công suất 20W chuẩn PD iCybernet IC-3001 (C to L cho IP14 trở xuống) - Hàng chính hãng",192000,300000,108000,36
TIKI,thiet-bi-kts-phu-kien-so,273908828,"Bộ sạc nhanh IP, Android chuẩn PD 20W iCybernet IC-3002 cáp C to C 1,2m (Cáp hỗ trợ sạc tối đa 100W cho mọi thiết bị typeC) - Hàng chính hãng",192000,300000,108000,36
TIKI,thiet-bi-kts-phu-kien-so,273908414,"Cáp sạc nhanh IP chuẩn PD 20W iCybernet IC-1003 TypeC to IP chiều dài 1,2m - Hàng chính hãng",98000,150000,52000,35
TIKI,thiet-bi-kts-phu-kien-so,73179180,"Thẻ Nhớ microSD SanDisk Ultra 128GB UHS-I - 100MB/s (New 2020) - Hàng Nhập Khẩu",229000,229000,0,0
TIKI,thiet-bi-kts-phu-kien-so,273906522,"Cáp sạc USB to IP iCybernet IC-1001 sạc 2.4A và truyền dữ liệu đồng thời, chiều dài 1,2m - Hàng chính hãng",58000,100000,42000,42
TIKI,thiet-bi-kts-phu-kien-so,273906695,"Cáp sạc và truyền dữ liệu 2.4A iCybernet IC-1002 USB to TypeC - Hàng chính hãng",58000,100000,42000,42
TIKI,thiet-bi-kts-phu-kien-so,123836523," Adapter Sạc 1 Cổng USB Type-C 20W Apple MHJE3ZA/A",450000,790000,340000,43
TIKI,thiet-bi-kts-phu-kien-so,73315307,"Thẻ Nhớ microSD SanDisk Ultra 64GB UHS-I - 100MB/s (New 2020) - Hàng Nhập Khẩu",129000,129000,0,0
TIKI,thiet-bi-kts-phu-kien-so,97547734,"Giá Đỡ Để Bàn Điện Thoại Di Động, Máy Tính Bảng, Ipad Hợp Kim Nhôm Cao Cấp Hai Trục Xoay 180 Độ Chống Đổ Hàng Chính Hãng Tamayoko",390000,450000,60000,13
TIKI,thiet-bi-kts-phu-kien-so,102391960,"Giá Đỡ Máy Tính, Laptop, iPad, Macbook Hợp Kim Nhôm Cao Cấp. Hỗ Trợ Tản Nhiệt Chống Mỏi Cổ, Vai, Gáy. Hàng Chính Hãng Tamayoko",450000,500000,50000,10
TIKI,thiet-bi-kts-phu-kien-so,174593826,"Lót chuột máy tính PixLink kích thước 22x18cm hàng chính hãng",14000,39000,25000,64
TIKI,thiet-bi-kts-phu-kien-so,72796676,"Giá Đỡ Laptop Hợp Kim Nhôm Cao Cấp Có Thể Gấp Gọn, Giúp Tản Nhiệt Laptop, Macbook, Máy Tính Xách Tay. 07 Vị Trí Điều Chỉnh Góc Độ. Hàng Chính Hãng Tamayoko FS060",179000,179000,0,0
TIKI,thiet-bi-kts-phu-kien-so,273891515,"Cáp sạc siêu nhanh PD 100W iCybernet IC-1004 C to C chiều dài 1m - Hàng chính hãng",98000,150000,52000,35
TIKI,thiet-bi-kts-phu-kien-so,389145,"Chuột không dây Logitech B175 - đầu thu USB 2.4Ghz, pin 1 năm, nhỏ gọn, thiết kế thuận cả 2 tay, phù hợp PC/ Laptop - Hàng chính hãng",199000,199000,0,0
TIKI,thiet-bi-kts-phu-kien-so,102782859,"Tai nghe In Ear Remax RM330 - Hàng chính hãng",212000,250000,38000,15
TIKI,thiet-bi-kts-phu-kien-so,109393113,"Tai nghe bluetooth nhét tai chống ồn cao cấp V5.0 chính hãng dùng cho iPhone Samsung OPPO VIVO HUAWEI XIAOMI tai nghe không dây Hàng Chính Hãng PKCB",280000,500000,220000,44
TIKI,thiet-bi-kts-phu-kien-so,146266186,"Miếng Lót Chuột Kai Hình Chữ Nhật Siêu Dễ thương Nhiều Mẫu Mới",23000,28000,5000,18
TIKI,thiet-bi-kts-phu-kien-so,174593860,"Chuột Không Dây Bluetooth PIX-LINK P100B Chống Ồn, DPI 1600, Chế Độ Kép Wireless Usb 2.4Ghz, Bluetooth Dùng Cho Macbook, Laptop, PC - Hàng chính Hãng",133000,299000,166000,56
TIKI,thiet-bi-kts-phu-kien-so,299431,"Chuột Không Dây Logitech M221",280000,280000,0,0
TIKI,thiet-bi-kts-phu-kien-so,142439870,"Cáp sạc Baseus Cafule sạc nhanh dùng cho iPhone - Hàng chính hãng",89000,159000,70000,44
TIKI,thiet-bi-kts-phu-kien-so,56859344,"Chuột không dây sạc điện HXSJ M103 - Hàng chính hãng",119000,199000,80000,40
TIKI,thiet-bi-kts-phu-kien-so,19419738,"Bộ Thu Phát Bluetooth TP-Link UB400 USB Nano Bluetooth 4.0 - Hàng Chính Hãng",102000,102000,0,0
TIKI,thiet-bi-kts-phu-kien-so,123838761,"Apple AirPods 2 - MV7N2 - Hộp Sạc Thường",2690000,5390000,2700000,50
TIKI,thiet-bi-kts-phu-kien-so,1060082,"Dây Cáp Sạc Li.ght.ning Cho i.Phone Anker PowerLine II 1.8m - A8433H22",320000,380000,60000,16
TIKI,thiet-bi-kts-phu-kien-so,123847933,"Apple Pencil 2 - MU8F2",2690000,4890000,2200000,45
TIKI,thiet-bi-kts-phu-kien-so,113568856,"Tai nghe chụp tai không dây Remax RB-660HB - Hàng chính hãng",563500,700000,136500,20
TIKI,thiet-bi-kts-phu-kien-so,216238849,"Bộ sạc nhanh cho IP công suất 18W Remax RP-U37 - Hàng chính hãng",249000,300000,51000,17
TIKI,thiet-bi-kts-phu-kien-so,201437484,"Giá Đỡ Máy Tính, Laptop, iPad, Macbook Hợp Kim Nhôm Cao Cấp. Hỗ Trợ Tản Nhiệt Chống Mỏi Cổ, Vai, Gáy. Hàng Chính Hãng Tamayoko",489000,489000,0,0
TIKI,thiet-bi-kts-phu-kien-so,251518071,"Cáp sạc nhanh chuẩn PD 20W cho IP Remax RC-183i chiều dài 2m - Hàng chính hãng",144550,200000,55450,28
TIKI,thiet-bi-kts-phu-kien-so,143957287,"HUB Type C và HUB USB 3.0 tốc độ cao 4 in 1 Sidotech bộ chia cổng usb mở rộng kết nối chuyển đổi cho Macbook Pro Laptop PC máy tính hỗ trợ sạc pin kết nối đa năng ổ cứng bàn phím chuột máy in, thiết bị ổ chia usb - Hàng chính hãng",399000,399000,0,0
TIKI,thiet-bi-kts-phu-kien-so,123518348,"Tai nghe Remax RM-201 - Hàng chính hãng",112250,150000,37750,25
TIKI,thiet-bi-kts-phu-kien-so,158868703,"[Miễn Phí 12 Tháng] SIM MAX DATA 4G VIETNAMOBILE 6GB/Ngày. Trọn Gói 1 Năm - Hàng Chính Hãng",368000,650000,282000,43
TIKI,thiet-bi-kts-phu-kien-so,76480235,"Bao Tay Chơi Game Cảm Ứng Chống Mồ Hôi SIDOTECH Siêu Mỏng Vải Sợi Carbon Siêu Bền Chống Giãn Xù, Cảm Ứng Nhạy Thuộc Dòng Găng Tay Chơi Game Bao Ngón Tay Cho PUBG Tốc Chiến Freefire Liên Quân mobile - Hàng Chính Hãng",26000,26000,0,0
TIKI,thiet-bi-kts-phu-kien-so,110850007,"Tai nghe nhét tai có dây jack 3.5mm Remax RM-512 (New Package) - Hàng chính hãng",106550,150000,43450,29
TIKI,thiet-bi-kts-phu-kien-so,72796676,"Giá Đỡ Laptop Hợp Kim Nhôm Cao Cấp Có Thể Gấp Gọn, Giúp Tản Nhiệt Laptop, Macbook, Máy Tính Xách Tay. 07 Vị Trí Điều Chỉnh Góc Độ. Hàng Chính Hãng Tamayoko FS060",199000,229000,30000,13
TIKI,thiet-bi-kts-phu-kien-so,174490279,"Chuột không dây bluetooth Logitech Signature M650 - Dành cho tay có kích cỡ từ nhỏ tới trung bình, Cuộn SmartWheel, giảm ồn, các nút bên có thể tùy chỉnh - Hàng chính hãng",576000,869000,293000,34
TIKI,thiet-bi-kts-phu-kien-so,172146754,"Ốp lưng chống sốc lưng trong phong cách mới dành cho iPhone 11 / 12 / 13 / 11 Pro / 12 Pro / 13 Pro / 11 Pro Max / 12 Pro Max / 13 Pro Max / 12 Mini / 13 Mini - Hàng chính hãng",179000,250000,71000,28
TIKI,thiet-bi-kts-phu-kien-so,162772687,"Chuột không dây Logitech SIGNATURE M650 Wireless/Bluetooth - Hàng Chính Hãng",650000,650000,0,0
TIKI,thiet-bi-kts-phu-kien-so,126697,"Tai Nghe Nhét Tai Sony MDR-EX15AP",190000,199000,9000,5
TIKI,thiet-bi-kts-phu-kien-so,137864606,"Tấm Lót Chuột, Thảm Da Trải Bàn Làm Việc VinBuy, Miếng Di Chuột Cỡ Lớn 40cmx80cm - Hàng Chính Hãng",90000,180000,90000,50
TIKI,thiet-bi-kts-phu-kien-so,1059892,"Dây Cáp Sạc Lightning Cho iPhone Anker PowerLine II 0.9m - A8432H21",255000,330000,75000,23
TIKI,thiet-bi-kts-phu-kien-so,272913331,"Thiết bị theo dõi thông minh Samsung Galaxy SmartTag2-Hàng Chính hãng",355000,355000,0,0
TIKI,thiet-bi-kts-phu-kien-so,36007224,"Bàn phím có dây Dell KB216 USB - Hàng Chính Hãng",160000,160000,0,0
TIKI,thiet-bi-kts-phu-kien-so,201437484,"Giá Đỡ Máy Tính, Laptop, iPad, Macbook Hợp Kim Nhôm Cao Cấp. Hỗ Trợ Tản Nhiệt Chống Mỏi Cổ, Vai, Gáy. Hàng Chính Hãng Tamayoko",479000,489900,10900,2
TIKI,thiet-bi-kts-phu-kien-so,195999085,"Cáp sạc siêu nhanh 100W Remax RC-183c chiều dài 2m - Hàng chính hãng",144550,200000,55450,28
TIKI,thiet-bi-kts-phu-kien-so,134364129,"Bộ Thu Phát Bluetooth TP-Link UB500 USB Nano Bluetooth 5.0 - Hàng Chính Hãng",118000,118000,0,0
TIKI,thiet-bi-kts-phu-kien-so,56889347,"Chuột Không Dây HXSJ X50 Plus - Hàng Chính Hãng",129000,245000,116000,47
TIKI,thiet-bi-kts-phu-kien-so,88798139,"Dây Cáp Dù Lõi HDMI 2.1 8K 48Gbps, 4K 165Hz Dài 2M CHOETECH XHH01 Dùng Cho Tivi/ Máy Tính/ Playstation - Hàng Chính Hãng",219000,390000,171000,44
TIKI,thiet-bi-kts-phu-kien-so,71672203,"Thẻ Nhớ microSDHC SanDisk Ultra 32GB UHS-I - 100MB/s (New 2020) - Hàng Nhập Khẩu",108000,108000,0,0
TIKI,thiet-bi-kts-phu-kien-so,71091864,"Đồng Hồ Pomodoro Hẹn Giờ 60 Phút Kim Loại Nhiều Kiểu Dáng",75000,75000,0,0
TIKI,thiet-bi-kts-phu-kien-so,1935009,"Tai Nghe Apple EarPods Cổng Lightning - MMTN2",480000,790000,310000,39
TIKI,thiet-bi-kts-phu-kien-so,3671793,"Sim 4G Mobifone 12FD50 Tặng 150GB/Tháng(5GB/Ngày) Trọn Gói 1 Năm- Hàng Chính Hãng - Mẫu ngẫu nhiên",750000,750000,0,0
TIKI,thiet-bi-kts-phu-kien-so,299461,"Chuột Không Dây Logitech M331 Silent",389000,389000,0,0
TIKI,thiet-bi-kts-phu-kien-so,171657209,"Thẻ Nhớ Micro SDXC Samsung Evo Plus U3 130MB/s 128GB New  - Hàng Nhập Khẩu",295000,295000,0,0
TIKI,thiet-bi-kts-phu-kien-so,174593840,"Chuột Không Dây PIX-LINK P100 Wireless 2.4Ghz Sạc Pin, Chống Ồn, DPI1600 Dùng Cho Máy Tính, Laptop, Tivi-Hàng Chính Hãng",115000,230000,115000,50
TIKI,do-choi-me-be,94726851,"Thú nhún trẻ em cao cấp Toyshouse PA1012 - Tiêu chuẩn Xuất khẩu Mỹ (ASTM) và Châu Âu (EN71)- Đồ chơi vận động cho bé từ 8 tháng",309000,410000,101000,25
TIKI,do-choi-me-be,84598543,"LOẠI XỊN - Cây Xương Rồng Nhồi Bông Có Nhạc, Biết Nhảy Biết Múa và Nhại Tiếng - PHÁT SÁNG",64000,64000,0,0
TIKI,do-choi-me-be,53210144,"Bộ 2 Gói Nước Rửa Bình Sữa D-nee (550ml x 2)",105000,105000,0,0
TIKI,do-choi-me-be,170154837,"Đồ Bơi Liền Thân Tay Dài - Black Bodysuit",442000,520000,78000,15
TIKI,do-choi-me-be,74769722,"Kutieskin 30gr Kem mẩn ngứa – hăm Kutieskin",96000,96000,0,0
TIKI,do-choi-me-be,168778815,"Gạc Rơ Lưỡi Dr.Papie Vệ Sinh Răng Miệng Cho Bé",160000,160000,0,0
TIKI,do-choi-me-be,72014622,"Khoá Chặn Cửa Tủ , Tủ Lạnh Bảo Vệ An Toàn Cho Bé",7499,7499,0,0
TIKI,do-choi-me-be,119706876,"Sữa tắm gội dịu lành cho bé Cetaphil Baby Gentle Wash & Shampoo 400ml",245000,245000,0,0
TIKI,do-choi-me-be,95082972,"Sữa bột Enfamil A2 Neuropro 2 cho trẻ từ 6 - 12 tháng tuổi – 350g",303000,303000,0,0
TIKI,do-choi-me-be,121678667,"Đồ Chơi Đèn Pin Kể Chuyện Mideer Phiên Bản 12 Truyện - Mideer StoryBook Torch (có bản dịch tiếng Việt)",319000,450000,131000,29
TIKI,do-choi-me-be,171666472,"Cánh bướm thiên thần CÓ ĐÈN kèm Gậy và vương miện cho bé gái",33000,33000,0,0
TIKI,do-choi-me-be,129727791,"Ghế Bô Cho Bé Đi Vệ Sinh Có Tựa Lưng,Chân Đế Chống Trượt,Có Ngăn Chứa Dễ Tháo Lắp Cọ Rửa",95000,95000,0,0
TIKI,do-choi-me-be,48331524,"FITOBIMBI IMMUNO – SIRO THẢO DƯỢC CHUẨN HÓA CHÂU ÂU TĂNG CƯỜNG MIỄN DỊCH TOÀN CHO TRẺ (200ML)",365000,365000,0,0
TIKI,do-choi-me-be,435761,"Sữa Bột Abbott Grow Gold 3+ cho trẻ từ 3 - 6 tuổi (900g)",469000,469000,0,0
TIKI,do-choi-me-be,173768941,"Boardgame Lớp Học Mật Ngữ - Khu Rừng Kim Cương",485200,599000,113800,19
TIKI,do-choi-me-be,189673426,"Nước giặt Lix Hương Nước Hoa Túi 3.5Kg - Tẩy Sạch Cực Mạnh Vết Bẩn - NGH07",115000,115000,0,0
TIKI,do-choi-me-be,173751815,"Quần áo bé trai, đồ bộ in 3D thấm hút mồ hôi tốt, co giãn 4 chiều mềm mại, in hoạt hình cực hót, set, thời trang, bộ đồ, đồ cho trẻ em, bé trai từ 8-28kg",66000,66000,0,0
TIKI,do-choi-me-be,110138019,"MÁY ĐA NĂNG ĐIỆN TỬ (ALL-IN-ONE) FATZBABY - MULTIMAX 1 - FB9002SJ CHÍNH HÃNG BẢO HÀNH 12 THÁNG",999000,999000,0,0
TIKI,do-choi-me-be,177274317,"Mũ bảo vệ đầu chống va đập an toàn cho bé yêu từ 7 tháng đến 48 tháng_RUBIK",78750,105000,26250,25
TIKI,do-choi-me-be,190547367,"Đai, địu lưới thoáng khí thoải mái cho bé",83888,83888,0,0
TIKI,do-choi-me-be,26612371,"Tã quần cao cấp Bobby Extra Soft Dry thun chân ngăn hằn",377300,377300,0,0
TIKI,do-choi-me-be,23643074,"Đồ chơi gỗ - Giáo cụ Montessori Ghép hình tư duy Four color Game",102000,102000,0,0
TIKI,do-choi-me-be,89643366,"Boardgame Cờ Tỷ Phú Việt Nam Sato Cỡ Lớn 42x42 Tặng Kèm Xúc Xắc Gỗ-Trò Chơi Rèn Luyện Tư Duy Làm Giàu",87000,87000,0,0
TIKI,do-choi-me-be,85366318,"Xương Rồng Nhại Giọng Nói Phiên Bản Cao Cấp Nhảy Theo Điệu Nhạc",99000,99000,0,0
TIKI,do-choi-me-be,116572142,"Thùng 6 lon sữa bột dinh dưỡng công thức HiPP 3 Organic Combiotic chất lượng hữu cơ tăng cường sức khoẻ hệ miễn dịch, bổ sung Canxi và vitamin D dành cho trẻ trên 12 tháng tuổi (6 lon x 800g)",4320000,4320000,0,0
TIKI,do-choi-me-be,94762046,"Túi Trữ Sữa Mama's Choice, Túi Đựng Sữa Mẹ Loại 250ml và 120ml, Kiểm Định An Toàn Bởi Bureau Veritas, Hộp 30 Túi",115000,125000,10000,8
TIKI,do-choi-me-be,68328015,"Bệ Thu Nhỏ Bồn Cầu Cho Bé Cleverbees - Nhựa PVC Cao Cấp",209000,249000,40000,16
TIKI,do-choi-me-be,90654128,"Set đồ sơ sinh cotton 18 chi tiết mùa xuân hè thu cho bé trai và bé gái (3 bộ bồ, 1 yếm choàng lớn, 1 gối, 1 yếm tròn nhỏ, 1 yếm tam giác, 4 khăn sữa, 1 mũ, 1 đôi tất tay, 1 đôi tất chân)",349000,349000,0,0
TIKI,do-choi-me-be,184437908,"Túi Viên Giặt Xả Đa Năng 4 Trong 1 KA Universal (1 Viên/ Túi)",25000,25000,0,0
TIKI,do-choi-me-be,249578221,"Đồ bộ 3 lỗ bé trai chất cotton bộ mùa hè cho bé hàng Quảng Châu chất lượng cao",59000,59000,0,0
TIKI,do-choi-me-be,272412284,"1 con dao Đồ chơi dao cà rốt động lực in 3d phản quang đồ chơi giải trí giảm street",25000,25000,0,0
TIKI,do-choi-me-be,154702528,"Nôi ru ngủ thư giãn kết hợp ghế ngồi đọc sách cho bé nhạc trắng Mastela 8104/8106 - điều khiển từ xa - kết hợp Bluetooth",2190000,2190000,0,0
TIKI,do-choi-me-be,85030214,"Áo dài tay MIOMIO (0m-24m) phom rộng",64000,64000,0,0
TIKI,do-choi-me-be,27657637,"Khăn vải khô đa năng Mama 240 tờ",53000,53000,0,0
TIKI,do-choi-me-be,95035914,"Dinh dưỡng 100% Trái cây nghiền Organic HiPPiS Chuối, Lê, Xoài",60000,60000,0,0
TIKI,do-choi-me-be,273155095,"Philips Avent Bình sữa mô phỏng tự nhiên mới - dung tích 330ml cho bé từ 3 tháng SCY906.01 SCY906.02",315000,315000,0,0
TIKI,do-choi-me-be,95035935,"Dinh dưỡng 100% Trái cây nghiền Organic HiPPiS Kiwi, Lê, Chuối",60000,60000,0,0
TIKI,do-choi-me-be,116149803,"Áo Polo Trẻ Em Mắt Chim Phối Bo Thoải Mái Và Thoáng Mát APK5177",219000,219000,0,0
TIKI,do-choi-me-be,1008834,"Máy đưa võng em bé VINANOI - Vn365",550000,550000,0,0
TIKI,do-choi-me-be,270796181,"Vitamin tổng hợp cho trẻ L'il Critters Gummy Vites Daily Mỹ chứa vitamin và khoáng chất hỗ trợ miễn dịch, mắt, chống oxy hóa và tăng sức khỏe tổng thể - QuaTangMe Extaste",593000,1186000,593000,50
TIKI,do-choi-me-be,2540045,"Nước tẩy xi măng HT 1,8LIT",138000,138000,0,0
TIKI,do-choi-me-be,115483441,"Sữa bột Enfamil A+ NeuroPro 1 với 2’-FL HMO cho trẻ từ 0 – 6 tháng tuổi– 400g",260000,260000,0,0
TIKI,do-choi-me-be,127504359,"Dầu ăn dặm cho bé - Dầu cá Nutra Omega 3 (HiPP) nhập khẩu Chi Lê - cung cấp DHA & EPA giúp phát triển trí thông minh trẻ nhỏ",165000,165000,0,0
TIKI,do-choi-me-be,95035807,"Bột ăn dặm dinh dưỡng Sữa, Ngũ cốc hoa quả tổng hợp - Mận Tây HiPP Organic 250g",145000,145000,0,0
TIKI,do-choi-me-be,53521709,"Trò chơi rút kiếm đâm hải tặc BY9037",34000,45000,11000,24
TIKI,do-choi-me-be,74915440,"Đồ chơi lắp ghép xe công trình KAVY gồm 4 xe kèm vít, rất nhiều màu sắc, nhựa nguyên sinh an toàn",98000,98000,0,0
TIKI,do-choi-me-be,805558,"Cháo Ăn Dặm Mabu Nguyên Hạt (400g)",99000,99000,0,0
TIKI,do-choi-me-be,59258002,"Chất thông tắc Cống sifa chống hôi siêu mạnh 5 phút 700gr thế hệ mới cao cấp ",46000,46000,0,0
TIKI,do-choi-me-be,57844916,"Túi Nước Giặt Xả Maxkleen Hương Nước Hoa Huyền Diệu (3.8kg)",194000,210000,16000,8
TIKI,do-choi-me-be,146845862,"Miếng lót sơ sinh Bobby NB1-108( Tặng 9m tã dán sơ sinh)",140000,140000,0,0
TIKI,do-choi-me-be,146517995,"Bộ Cờ Vua Nam Châm Cao Cấp Chính Hãng dododios - Nhiều Kích Cỡ",95000,95000,0,0
TIKI,do-choi-me-be,74554678,"Bộ Cờ Búng Bàn Đấu Ice Hockey Bằng Gỗ - Chọn Size -  Foosball Winner, Sling Puck - Bắn Bi Gỗ Xuyên Lỗ Chính Hãng",113050,119000,5950,5
TIKI,do-choi-me-be,121231921,"Mũ tắm mũ gội đầu cho bé",99000,129000,30000,23
TIKI,do-choi-me-be,153912537,"Ghế ăn dặm cho bé đi du lịch Mastela 1013 ăn dặm kèm mặt bàn - tiêu chuẩn ASTM Mỹ, BPA FREE an toàn cho bé",630000,630000,0,0
TIKI,do-choi-me-be,255174867,"Cờ Vây Nam Châm Chọn size, Cờ Caro Cao Cấp, Có Bàn Là Hộp Đựng Rộng 28.5cm Và 37cm - Hàng chính hãng Amalife",142000,159000,17000,11
TIKI,do-choi-me-be,165220829,"Bộ dụng cụ lấy ráy tai có đèn thông minh 10 món chuyên nghiệp HBH",99000,99000,0,0
TIKI,do-choi-me-be,150805917,"Đai Chống Gù Lưng Trẻ Em Có Nẹp Cho Bé Cân Nặng Từ 15 kg Đến 40 Kg - Chính Hãng miDoctor - M",147000,147000,0,0
TIKI,do-choi-me-be,137599351,"Nước lau sàn chuyên dụng dành cho Robot hút bụi lau nhà ",70000,70000,0,0
TIKI,do-choi-me-be,543025,"Dung Dịch Giặt Quần Áo Cho Bé D-Nee - Chai 3000ml (Hồng)",202000,245000,43000,18
TIKI,do-choi-me-be,25982539,"Đồ Chơi Cờ Trí Tuệ UNO W2085",169000,169000,0,0
TIKI,do-choi-me-be,198915804,"Đá Khô Bảo Quản Sữa Mama’s Choice, Giữ Lạnh Sữa Mẹ Lên Đến 14 Tiếng, Chất Liệu Gel Y Tế Cao Cấp, Độ Bền Cao Từ 4-5 Năm",160000,180000,20000,11
TIKI,do-choi-me-be,104154761,"Phấn rôm sẩy Pigeon nắp màu 100g/200g",42000,49000,7000,14
TIKI,do-choi-me-be,100285006,"Gấu Bông Kì Lân Unicorn Nằm Siêu Dễ Thương 30cm Quà Tặng Siêu Hot",159000,318000,159000,50
TIKI,do-choi-me-be,576195,"Nước Giặt Cổ Áo Mao Bao 600ml",46000,60000,14000,23
TIKI,do-choi-me-be,179757537,"Combo 3 Quần áo bé gái, đồ bộ Mimykid in 3D hoạt hình dễ thương, đáng yêu co giãn 4 chiều mềm mại, thấm hút mồ hôi tốt, thời trang, set, bộ đồ, đồ cho trẻ em, bé gái từ 8-28kg (GIAO MÀU NGẪU NHIÊN)",199000,199000,0,0
TIKI,do-choi-me-be,805454,"Cháo Ăn Dặm Mabu Hạt Vỡ (900g)",199000,199000,0,0
TIKI,do-choi-me-be,116756088,"Rút Gỗ - Đồ Chơi Rút Gỗ Loại To 48-51 Thanh VIVITOYS An Toàn, Hàng Cao Cấp Sắc Nét Rèn Luyện Trí Tuệ Thông Minh - TINA",88000,88000,0,0
TIKI,do-choi-me-be,87834867,"Combo 4 miếng dán thanh chắn giường chuyên dụng siêu chắc, siêu dính",35150,37000,1850,5
TIKI,do-choi-me-be,160821055,"Đồ chơi xếp hình, lắp ráp 6 in 1 Qman 1414 - Siêu Robot khủng long Sura",269000,359000,90000,25
TIKI,do-choi-me-be,56815496,"Bộ tranh xếp hình 150 mảnh – Pokémon",45000,65000,20000,31
TIKI,do-choi-me-be,195873262,"Đai đi xe máy cho bé đảm bảo an toàn chống ngã ra sau",79000,79000,0,0
TIKI,do-choi-me-be,270697757,"Kẽm cho bé Úc Healthy Care Kids Chewable Zinc + Vitamin C Hỗ trợ tăng trưởng, phát triển sức khỏe và hệ thống miễn dịch cho trẻ - QuaTangMe Extaste",177400,426000,248600,58
TIKI,do-choi-me-be,198345095,"Áo giữ nhiệt 4LOVA thu đông dài tay cổ cao cho bé trai",69000,69000,0,0
TIKI,do-choi-me-be,612898,"Kệ Chữ A Nhựa Chợ Lớn K2 (Có nhạc) - M1476-BB9",341000,341000,0,0
TIKI,do-choi-me-be,137533149,"Túi Xách Cho Bé Pop It Bóp Bong Bóng Giải Trí Hỗ Trợ Giảm Căng Thẳng Nhiều Màu Sắc Và Kiểu Dáng Dễ Thương",87970,87970,0,0
TIKI,do-choi-me-be,190702377,"Sữa bột Enfagrow A2 Neuropro 3 dành cho trẻ từ 1 - 6 tuổi –800g",611000,611000,0,0
TIKI,do-choi-me-be,19944401,"Tã Quần Moony Natural Bông Organic XL32 (32 Miếng)",280000,280000,0,0
TIKI,do-choi-me-be,273720404,"Sữa Ensure Úc hồi phục sức khỏe cho người già, người ốm yếu, suy dinh dưỡng, người sau phẫu thuật - QuaTangMe Extaste",1039000,2078000,1039000,50
TIKI,do-choi-me-be,15608790,"Thú Bông Lạc Đà Alpaca Siêu Hot",94100,94100,0,0
TIKI,do-choi-me-be,108915932,"Bộ 3 Bình Trữ Sữa Mẹ FATZBABY 150ml FB0120N",115000,115000,0,0
TIKI,thiet-bi-kts-phu-kien-so,113568856,"Tai nghe chụp tai không dây Remax RB-660HB - Hàng chính hãng",563500,700000,136500,20
TIKI,thiet-bi-kts-phu-kien-so,248539405,"Tai Nghe Bluetooth Baseus WM01 TWS Không Dây - Công Nghệ Chống Tiếng Ồn Mới Nhất - Thiết Kế Nhỏ Gọn Xinh Xắn - Tương Thích Nhiều Thiết Bị - Điều Khiển Cảm Ứng - Hàng Chính Hãng",450000,450000,0,0
TIKI,thiet-bi-kts-phu-kien-so,201308561,"Chuột game có dây Logitech G102 Lightsync - Tùy chỉnh RGB, 6 nút lập trình, nhẹ, 8000 DPI, PC/Mac - Hàng Ch��nh Hãng",398000,590000,192000,33
TIKI,thiet-bi-kts-phu-kien-so,221256638,"Kính cường lực full màn hình G5 cho iPhone 14/ 14 pro/ 14 pro max - Hàng nhập khẩu",65000,65000,0,0
TIKI,thiet-bi-kts-phu-kien-so,170273830,"Thẻ nhớ Micro SD Hikvision 32GB 64GB 128GB Class 10 tốc độ 92MB/s - Hàng chính hãng",120000,160000,40000,25
TIKI,thiet-bi-kts-phu-kien-so,135284107,"Headphone Tai Nghe Chụp Tai bluetooth Rockspace O2 kết nối không dây có mic nghe nhạc liên tục 15h - Hàng chính hãng",465000,595000,130000,22
TIKI,thiet-bi-kts-phu-kien-so,272913331,"Thiết bị theo dõi thông minh Samsung Galaxy SmartTag2-Hàng Chính hãng",355000,355000,0,0
TIKI,thiet-bi-kts-phu-kien-so,132144149,"Cường Lực Chống Nhìn Trộm KingKong Dành Cho iPhone X-XS, XS Max, iPhone 11, 11Pro, 11ProMax, iPhone 12, 12Mini, 12Pro, 12Pro Max, iPhone 13, 13Mini, 13Pro, 13Pro Max - Dán Full Màn - Hàng Chính Hãng",151000,151000,0,0
TIKI,thiet-bi-kts-phu-kien-so,188189139,"Case Ốp Vỏ Vệ Vịt Boss dành cho Airpods Pro/ Airpods 3 kèm móc treo- Hàng chính hãng",99000,99000,0,0
TIKI,thiet-bi-kts-phu-kien-so,13119283,"Bút Cảm Ứng Dành  Cho SMARTPHONE VÀ IPAD -Giao  Màu  Ngẩu Nhiên",6430,8788,2358,27
TIKI,thiet-bi-kts-phu-kien-so,161007768,"Ốp lưng dẻo mỏng dành cho iPhone 11 / 12 / 13 / 11 Pro / 12 Pro / 13 Pro / 11 Pro Max / 12 Pro Max / 13 Pro Max / 12 Mini / 13 Mini - Hàng chính hãng",49000,69000,20000,29
TIKI,thiet-bi-kts-phu-kien-so,191502436,"Dây Đeo Thay Thế Viền Dành Cho Vòng Đeo Tay Thông Minh Xiaomi Mi Band 5/ Miband 6 - Hàng chính hãng",42000,45000,3000,7
TIKI,thiet-bi-kts-phu-kien-so,855600,"Tai Nghe Nhét Tai Sony MDR-EX155AP",350000,390000,40000,10
TIKI,thiet-bi-kts-phu-kien-so,123843835,"Cây chọt sim điện thoại, que chọc sim để sau ốp lưng dành cho iphone 5/5s/6/6plus/6s/6s plus/6/7/7plus/8/8plus/x/xs/xs max",3900,3900,0,0
TIKI,thiet-bi-kts-phu-kien-so,56885648,"Đầu Chuyển Đổi USB Type C Sang USB 3.0 Hàng Chính Hãng Helios",59000,59000,0,0
TIKI,thiet-bi-kts-phu-kien-so,125781,"Tai Nghe Nhét Tai Sony Fontopia MDR-E9LP",143000,159000,16000,10
TIKI,thiet-bi-kts-phu-kien-so,270747030,"Cáp sạc USB to IP Remax RC-152i chiều dài 1m sạc 2.4A và truyền dữ liệu đồng thời 480MB/s có đèn tiện lợi - Hàng chính hãng",115000,150000,35000,23
TIKI,thiet-bi-kts-phu-kien-so,209386109,"Tai Nghe Bluetooth FIRO FI5 Pro2 - Tai Nghe Không Dây FIRO Công Nghệ Bluetooth V5.3 - Kháng Nước IPX5 - Điều Khiển Cảm Ứng Thông Minh - Âm Bass Cực Hay - Tai Nghe FIRO FI5 Pro2 Tương Thích Với Tất Cả Dòng Máy - Hàng Chính Hãng",385000,739000,354000,48
TIKI,thiet-bi-kts-phu-kien-so,56608719,"Chuột không dây Bluetooth  HXSJ M90 - Hàng chính hãng",139000,168000,29000,17
TIKI,thiet-bi-kts-phu-kien-so,181772131,"Tai Nghe Bluetooth Chụp Tai Sony WH-1000XM5 Hi-Res Noise Canceling - Hàng Chính Hãng",6890000,7990000,1100000,14
TIKI,thiet-bi-kts-phu-kien-so,113835505,"Giá Đỡ Máy Tính Bảng, Ipad, Điện Thoại - Chất Liệu Hợp Kim Nhôm Cao Cấp - Hàng Chính Hãng Tamayoko",450000,450000,0,0
TIKI,thiet-bi-kts-phu-kien-so,179541784,"Cáp sạc nhanh siêu bền C to IP Baseus Dynamic Series FAST CHARGING DATA CABLE 20W dùng cho IP 13,12,... - Hàng chính hãng",101000,159000,58000,36
TIKI,thiet-bi-kts-phu-kien-so,35420153,"Cáp sạc nhanh, truyền dữ liệu tốc độ cao Baseus Cafule Type C cho Samsung S8/S9/ Note8/ Note9/ Xiaomi/ Huawei/ Oppo/Nokia ( 3A, Sạc nhanh Quick charge 3.0, Siêu bền)- Hàng nhập khẩu",87000,159000,72000,45
TIKI,thiet-bi-kts-phu-kien-so,262034792,"Hub USB 3.0 FIRO Và Hub Type C FIRO - Bộ Chia Cổng USB FIRO - HUB Chuyển Đổi Dành Cho Laptop, PC - Hỗ Trợ Sạc Pin, Kết Nối Đa Năng Ổ Cứng , Bàn Phím, Chuột, Máy In, Thiết Bị Ổ Chia USB - FIRO Type C Adapter 4in1 - Hàng Chính Hãng",133000,319000,186000,58
TIKI,thiet-bi-kts-phu-kien-so,154835064,"Đồng hồ Thông minh Trẻ em AMA Watch Q15 lắp SIM nghe gọi 2 chiều 3 màu Xanh Hồng Đen Hàng chinh hãng",400000,400000,0,0
TIKI,thiet-bi-kts-phu-kien-so,195300861,"Cáp ANKER Powerline III Flow USB-C To USB-C - A8552 / A8553 - Siêu Mềm Mại và Bền Bỉ - Hàng Chính Hãng",180000,300000,120000,40
TIKI,thiet-bi-kts-phu-kien-so,176752662,"Kính Cường Lực Kingkong iPhone, Màn Nhám Chống Vân Tay Dành Cho Game Thủ - Full Hộp - Hàng Chính Hãng",88000,135000,47000,35
TIKI,thiet-bi-kts-phu-kien-so,73324095,"Bộ điều khiển thông minh Google Chromecast with Google TV - Hàng Nhập Khẩu",1300000,1610000,310000,19
TIKI,thiet-bi-kts-phu-kien-so,56049649,"CỐC SẠC NHANH 15W 2 CỔNG CHỐNG CHÁY NỔ HOCO C73 - CỦ SẠC ĐA NĂNG 2.4A CHO CÁC DÒNG ĐIỆN THOẠI CHÍNH HÃNG",69000,119000,50000,42
TIKI,thiet-bi-kts-phu-kien-so,112287571,"Đồng Hồ Thông Minh cho Trẻ em 6 tuổi, 7 tuổi, 8 tuổi, 9 tuổi, 10 tuổi, 11 tuổi Lắp Sim Độc lập nghe gọi 2 chiều AMA Watch Y92 Chống nước Định vị Wifi độ chính xác cao Hàng nhập khẩu",577000,577000,0,0
TIKI,thiet-bi-kts-phu-kien-so,192432383,"Case Silicon dành cho Airpods Pro 2/ Airpods 1,2/ Airpods Pro/ Airpods 3 Hình Gấu Brown_ Hàng Chính Hãng",85000,85000,0,0
TIKI,thiet-bi-kts-phu-kien-so,145495427,"Thẻ Nhớ Lexar MICRO 633X Tốc Độ 100mb/s - Hàng Chính Hãng",88000,88000,0,0
TIKI,thiet-bi-kts-phu-kien-so,107071890,"Miếng Kê tay, Thanh Kê Tay Bàn Phím Cực Dễ Thương Nhiểu Mẫu Mới_ Hàng Chính Hãng",136843,144045,7202,5
TIKI,thiet-bi-kts-phu-kien-so,80857582,"Kính Cường Lực Chống Nhìn Trộm KingKong Dành Cho iPhone - Full Hộp - Dán Full Màn - Hàng Chính Hãng ",34000,34000,0,0
TIKI,thiet-bi-kts-phu-kien-so,112087792,"Thẻ nhớ chuyên camera Mirco SD HIKVISION  64G - 32GB - 92MB/s, chuyên ghi hình cho camera, máy ảnh, ... Hàng nhập khẩu",71900,71900,0,0
TIKI,thiet-bi-kts-phu-kien-so,67907870,"Chuột Bluetooth Silent Logitech Pebble M350 - Hàng chính hãng",418000,599000,181000,30
TIKI,thiet-bi-kts-phu-kien-so,53977774,"Phụ kiện giữ dây cáp sạc Giá Silicon mini cố định dây cáp sạc cho các thiết bị điện tử trên bàn làm việc - Hàng Chính Hãng",20000,69000,49000,71
TIKI,thiet-bi-kts-phu-kien-so,107067035,"Thẻ Nhớ SanDisk Ultra MicroSDXC UHS-1 100 MB/s Class 10 32GB/64GB/128GB - Hàng Chính Hãng",110000,141000,31000,22
TIKI,thiet-bi-kts-phu-kien-so,111978854,"Hub Chuyển Đổi USB Type C to HDMI CHOETECH HUB-H10 Độ Phân Giải 4K 60Hz, 1080P Cho Tivi/Laptop/Playstation/PC - Hàng Chính Hãng",299000,590000,291000,49
TIKI,thiet-bi-kts-phu-kien-so,111484548,"Dây cáp VGA 1.5M Đen chống nhiễu loại cực tốt",19470,19470,0,0
TIKI,thiet-bi-kts-phu-kien-so,167528098,"HUB TYPE C Và HUB USB 3.0 Tốc Độ Cao Chia 4 Cổng VinBuy, HUB Chuyển Đổi Dành Cho Macbook Pro Laptop PC Hỗ Trợ Sạc Pin Kết Nối Đa Năng Ổ Cứng Bàn Phím Chuột Máy In, Thiết Bị Ổ Chia USB - Hàng Chính Hãng",88000,300000,212000,71
TIKI,thiet-bi-kts-phu-kien-so,272349163,"Micro thu âm không dây Remax K02 / K03 Dành cho điện thoại, hỗ trợ quay video, Livestream - Hàng Chính Hãng",595000,595000,0,0
TIKI,thiet-bi-kts-phu-kien-so,192977208,"Đồng hồ Thông minh Chống nước IP67 Dành cho Trẻ em nhuẩn AMA Watch Q16S Hàng chính hãng",395000,395000,0,0
TIKI,thiet-bi-kts-phu-kien-so,76067387,"Đầu đọc thẻ nhớ 2.0 Hoco HB20 Mindful - hỗ trợ khe microSD/SD (Hàng chính hãng)",79000,79000,0,0
TIKI,thiet-bi-kts-phu-kien-so,88796437,"Dây Cáp Nối Dài Âm Thanh 2 Đầu Đực 3.5mm Dài 1.2M CHOETECH AUX002 - Hàng Chính Hãng",99000,150000,51000,34
TIKI,thiet-bi-kts-phu-kien-so,102782859,"Tai nghe In Ear Remax RM330 - Hàng chính hãng",212000,250000,38000,15
TIKI,thiet-bi-kts-phu-kien-so,67517393,"Thẻ Nhớ Camera Hikvision 64Gb Class 10 ( Chuyên dùng cho Camera IP ) - Hàng Chính hãng",84000,84000,0,0
TIKI,thiet-bi-kts-phu-kien-so,49658272,"Đen - Dây cáp sạc nhanh Type-C dài 2M hiệu Baseus Cafule Type C to Type C PD truyền data tốc độ cao  cho Smartphone / Tablet / Macbook / Laptop Type C Samsung Huawei Oppo Xiaomi (3A, 60W, Sạc nhanh PD, Sạc nhanh QC 4.0 Quick Charge)-Hàng nhập khẩu",93000,109000,16000,15
TIKI,thiet-bi-kts-phu-kien-so,63912442,"Giá Đỡ Điện Thoại Gấp Gọn, Tùy Chỉnh Độ Cao - DT056",16676,16676,0,0
TIKI,thiet-bi-kts-phu-kien-so,132144149,"Cường Lực Chống Nhìn Trộm KingKong Dành Cho iPhone X-XS, XS Max, iPhone 11, 11Pro, 11ProMax, iPhone 12, 12Mini, 12Pro, 12Pro Max, iPhone 13, 13Mini, 13Pro, 13Pro Max - Dán Full Màn - Hàng Chính Hãng",35000,35000,0,0
TIKI,thiet-bi-kts-phu-kien-so,74343712,"Dây Nguồn Laptop 1.5m",18945,37890,18945,50
TIKI,thiet-bi-kts-phu-kien-so,113568856,"Tai nghe chụp tai không dây Remax RB-660HB - Hàng chính hãng",563500,700000,136500,20
TIKI,thiet-bi-kts-phu-kien-so,133637826,"CÂY CHỌC SIM ĐIỆN INOX - QUE CHỌC SIM INOX HÌNH GIỌT NƯỚC",1000,3000,2000,67
TIKI,thiet-bi-kts-phu-kien-so,15251528,"Đầu Chuyển HDMI ra VGA",25300,25300,0,0
TIKI,thiet-bi-kts-phu-kien-so,359484,"Bàn phím có dây Logitech K120 - Hàng chính hãng",146000,179000,33000,18
TIKI,do-choi-me-be,88257240,"Gối Xô Bonny 10 Lớp Thấm Hút Mồ Hôi, Mềm Mịn, Gối Cho Bé Sơ Sinh Từ 0 Đến 1 Tuổi",55000,55000,0,0
TIKI,do-choi-me-be,140938570,"Bộ đồ chơi hộp búp bê Barbie nhiều phụ kiện kèm tủ giầy cho bé gái",69000,69000,0,0
TIKI,do-choi-me-be,52873241,"Mẫu mới 2020 Bình sữa Wesser PPSU cao cấp cổ hẹp cổ rộng các cỡ",238000,238000,0,0
TIKI,do-choi-me-be,123532413,"Xe chòi chân cho bé loại đẹp",119000,119000,0,0
TIKI,do-choi-me-be,176937847,"Medela - Kem Purelan 7g - Dùng cho mẹ bị khô, nứt, chảy máu đầu ty - 100% chiết xuất thiên nhiên, an toàn tuyệt đối",260000,260000,0,0
TIKI,do-choi-me-be,105139766,"Đồ chơi câu cá trẻ em 45 con cá 4 cần có thể điều chỉnh nhạc",229000,229000,0,0
TIKI,do-choi-me-be,151838910,"Lều Xông Hơi cao cấp Và Nồi Xông Hơi 4L công suất lớn giúp giải cảm, chữa cúm tại nhà hiệu quả",839000,839000,0,0
TIKI,do-choi-me-be,144193072,"Đồ Chơi Gỗ Cao Cấp Cân Thăng Bằng - Mô Phỏng Cán Cân Đòn Hỗ Trợ Bé Học Toán Và Nhận Biết Các Con Số - Hàng Chính Hãng",108900,110000,1100,1
TIKI,do-choi-me-be,146336800,"Xe cần cẩu điện CHO BÉ 2-10 TUỔI TLY - 1618 (HSD-6105)  - xe cần cẩu điện trẻ em",1149000,1149000,0,0
TIKI,do-choi-me-be,191945212,"Sữa Bột Pediasure 10+ Hương Vani 850g (cho trẻ từ 10 tuổi trở lên)",749000,749000,0,0
TIKI,do-choi-me-be,8038349,"Cốc Hứng Sữa Mama’s Choice, Hút Sữa Rảnh Tay, Chất Liệu Silicone Cao Cấp, Chứng Nhận An Toàn FDA - 1 Cốc",339000,389000,50000,13
TIKI,do-choi-me-be,41767514,"Gối Ôm Thú Nhồi Bông Cho Bé Loại Siêu Mềm Hình Thỏ Con Size 60cm Siêu Dễ Thương",75000,75000,0,0
TIKI,do-choi-me-be,124276850,"Bộ 1000 Thun Cột Tóc Cho Bé Kèm Túi Đựng",13000,13000,0,0
TIKI,do-choi-me-be,4748469,"Boardgame Lớp Học Mật Ngữ - Cuộc Đua Sao Chổi ",376300,459000,82700,18
TIKI,do-choi-me-be,4879479,"Đồ Chơi Xếp Hình Cho Bé Mầm Non Sato 72 Chi Tiết",104000,130000,26000,20
TIKI,do-choi-me-be,106967633,"Quần Chip Đùi, Combo 5 Quần Lót Lưng Thun Cho Bé, Quần Lót Cotton Họa Tiết Đáng Yêu Xinh Xắn Cho Bé Gái QLTE01",149000,149000,0,0
TIKI,do-choi-me-be,95035801,"Sữa bột công thức HiPP 4 Organic Combiotic 800g",675000,675000,0,0
TIKI,do-choi-me-be,122286944,"Xe chòi chân cho bé",121000,121000,0,0
TIKI,do-choi-me-be,51840515,"Combo 2 hộp muối rửa bát finish dùng cho máy rửa bát 1,5kg (1.5kg x 2)",220000,220000,0,0
TIKI,do-choi-me-be,272310041,"Sữa tăng cân cho trẻ 1-3 tuổi Meiji Nhật giàu dưỡng chất kèm DHA giúp phát triển cân đối chiều cao, cân nặng, trí não trẻ - OZ Slim Store",493000,1002000,509000,51
TIKI,do-choi-me-be,152547966,"Đồ Chơi - Xe Cảnh Sát DK 81040",125000,180000,55000,31
TIKI,do-choi-me-be,74880858,"Bộ đồ chơi bác sĩ KAVY kèm cặp đựng tiện lợi, giúp bé nhận biết dụng cụ, quan sát học hỏi",153000,153000,0,0
TIKI,do-choi-me-be,23413563,"Máy Tiệt Trùng Bình Sữa Mama’s Choice 5in1 Tích Hợp Chức Năng Sấy Khô Phụ Kiện và Hâm Sữa Cho Bé, BH Chính Hãng 12 Tháng",1250000,1690000,440000,26
TIKI,do-choi-me-be,73378458,"Bộ tranh xếp hình cao cấp 1000 mảnh 50x80cm – Paris Vào Xuân",201000,280000,79000,28
TIKI,do-choi-me-be,173383478,"Bộ Nghiền Thức Ăn Cho Bé Pigeon",330000,471000,141000,30
TIKI,do-choi-me-be,51948609,"Combo Bột rửa bát finish 2.5kg+Nước làm bóng finish 800ml+Muối rửa bát finish 1.5kg dùng cho Máy rửa bát",720000,720000,0,0
TIKI,do-choi-me-be,107792091,"Váy Bé Gái Dáng Xòe 3 Tâng Tiểu Thư QATE727",100000,100000,0,0
TIKI,do-choi-me-be,180852776,"Nước tẩy bồn cầu VIM Trắng Sáng Than hoạt tính và hoa oải hương (Tím) 880ml",39000,39000,0,0
TIKI,do-choi-me-be,158095160,"Búp bê Barbie 3D 30cm xinh xắn cho bé gái",95000,95000,0,0
TIKI,do-choi-me-be,158894056,"Set 3 băng đô bé gái dính tóc nhiều màu Mixi Kids PKT002C",27300,39000,11700,30
TIKI,do-choi-me-be,78955128,"SIRO ĂN NGON BABY PLUS - Giúp bé hết biếng ăn, tăng cân, tiêu hóa tốt - Bí Quyết Nuôi Con Nhàn Tênh",358000,358000,0,0
TIKI,do-choi-me-be,5422589,"Sữa bột Nutricare Bone phòng loãng xương cải thiện xương khớp (400g, 900g)",185000,199000,14000,7
TIKI,do-choi-me-be,143948628,"Combo 12 hộp pha sẵn Nutren Junior 200ml/hộp cho trẻ từ 1-10 tuổi tăng trưởng 3 chuẩn: Thế chất, Đề kháng, Tư duy - Tặng gối con mèo",369000,378000,9000,2
TIKI,do-choi-me-be,6464029,"Cháo Tươi Lươn Đậu Xanh Cây Thị",20700,24000,3300,14
TIKI,do-choi-me-be,56960573,"Viên kẹo bổ sung canxi và vitamin D thơm ngon Ostelin Ostelin Kids Calcium & Vitamin D3 nhập khẩu Úc 90 viên",254000,335000,81000,24
TIKI,do-choi-me-be,136025117,"Thùng 12 gói ăn dặm trái cây nghiền mix vị Fruto Nyanya 90g/gói",433152,541440,108288,20
TIKI,do-choi-me-be,113299654,"Viên Uống Milk Calcium Healthy Care Bổ Sung Canxi Cho Trẻ Trên 4 Tháng Tuổi, 60 viên, Hỗ Trợ Phát Triển Xương và Răng Giúp Cao Lớn và Khỏe Mạnh, Bé Hết Khóc Đêm, Rụng Tóc, Tóc Dựng Ngược - Ăn Ngon Ngủ Ngoan",211000,228000,17000,7
TIKI,do-choi-me-be,127802450,"Gel thơm làm sạch khử mùi vệ sinh Diệt khuẩn khử trùng bồn cầu hình bông hoa",10000,11000,1000,9
TIKI,do-choi-me-be,55647274,"Trò chơi cờ cá ngựa SPIN MASTER 6038084",149000,149000,0,0
TIKI,do-choi-me-be,132684152,"Dung Dịch Giặt Quần Áo Cho Bé D-Nee - Túi 600ml (Xanh Lá)",79000,79000,0,0
TIKI,thiet-bi-kts-phu-kien-so,194458001,"Tai nghe bluetooth nhét tai chống ồn cao cấp V5.3 chính hãng dùng cho iPhone Samsung OPPO VIVO HUAWEI XIAOMI tai nghe không dây - Hàng Chính Hãng PKCB",313000,500000,187000,37
TIKI,thiet-bi-kts-phu-kien-so,127695415,"Loa Bluetooth HXSJ V6 Bản Mở Rộng Hỗ Trợ Kết Nối Bluetooth 5.0, Thẻ Nhớ, USB, Công suất 2 loa 10W Nhiều Màu Sắc - Hàng chính hãng",349000,689000,340000,49
TIKI,thiet-bi-kts-phu-kien-so,169196334,"Bàn Di Chuột Cỡ Lớn 30-80cm,Pad Chuột,Lót Chuột Phím Tắt Văn Phòng Cao Cấp - Bàn Di Công Thức",39000,39000,0,0
TIKI,thiet-bi-kts-phu-kien-so,78010530,"Adapter Củ Sạc CHOETECH PD5005 PD 20W Chuyên Sạc Nhanh iPhone, iPad - Hàng Chính Hãng",199000,390000,191000,49
TIKI,thiet-bi-kts-phu-kien-so,128678712,"Apple Watch Series 7 GPS Sport Band (Viền Nhôm, Dây Cao Su)",7890000,12990000,5100000,39
TIKI,thiet-bi-kts-phu-kien-so,24865067,"Bút laser trình chiếu Slide VSON N35 - Hàng nhập khẩu",172000,172000,0,0
TIKI,thiet-bi-kts-phu-kien-so,195305655,"Adapter Sạc ANKER 511 Nano Pro 20W Type-C Sạc Nhanh Tích Hợp PIQ 3.0 A2637 Tương Thích iPhone 13 series và iPhone 12 series, Galaxy, Pixel 4/3, iPad / iPad mini - Hàng Chính Hãng",250000,450000,200000,44
TIKI,thiet-bi-kts-phu-kien-so,195277333,"Ốp lưng dẻo cho iPhone 8 / SE 2020 / 8 Plus / X / XS / XR / XS Max / 11 / 11 Pro / 11 Pro Max / 12 / 12 Pro / 12 Pro Max / 12 Mini / 13 / 13 Pro / 13 Pro Max / 13 Mini / 14 / 14 Pro / 14 Pro Max / 14 Max -Hàng chính hãng-Photodesign VN",149000,250000,101000,40
TIKI,thiet-bi-kts-phu-kien-so,102391960,"Giá Đỡ Máy Tính, Laptop, iPad, Macbook Hợp Kim Nhôm Cao Cấp. Hỗ Trợ Tản Nhiệt Chống Mỏi Cổ, Vai, Gáy. Hàng Chính Hãng Tamayoko",450000,500000,50000,10
TIKI,thiet-bi-kts-phu-kien-so,637038,"Chuột Có Dây Dell MS116 (Đen) - Hàng Chính Hãng",82000,82000,0,0
TIKI,thiet-bi-kts-phu-kien-so,1517005,"Thẻ Nhớ Micro SDHC SanDisk UHS-1 32GB Class 10 - Hàng Chính Hãng",108000,108000,0,0
TIKI,thiet-bi-kts-phu-kien-so,88796298,"Dây Cáp Nối Dài Âm Thanh 3.5mm Dài 2M CHOETECH AUX001-BK - Hàng Chính Hãng",99000,150000,51000,34
TIKI,thiet-bi-kts-phu-kien-so,87106876,"Dây Cáp Sạc Nhanh USB Type C to Type C 100W Dài 1.8M Chuyên Sạc iPhone 15, Macbook, Laptop, Smartphone CHOETECH XCC-1002-GY - Hàng Chính Hãng",189000,280000,91000,33
TIKI,thiet-bi-kts-phu-kien-so,191684818,"Tai Nghe Bluetooth True Wireless AMOI F9 Cảm Ứng Vân Tay, Nâng Cấp Dock Sạc có Led Báo Pin Kép - Hàng Nhập Khẩu",89000,94000,5000,5
TIKI,thiet-bi-kts-phu-kien-so,53547831,"Lót chuột  siêu bền 26x21 cm - Hàng chính hãng",19000,19000,0,0
TIKI,thiet-bi-kts-phu-kien-so,52945747,"Giá đỡ laptop nhôm có thể gấp gọn dành cho Macbook Ipad Surface và máy tính xách tay",109000,109000,0,0
TIKI,thiet-bi-kts-phu-kien-so,95085073,"Dây Cáp Chuyển Đổi USB Type C To HDMI 4K 60Hz Dài 1.8M CHOETECH CH0019 - Hàng Chính Hãng",369000,590000,221000,37
TIKI,thiet-bi-kts-phu-kien-so,188998014,"Ốp Bảo Vệ Chống Sốc Armor TPU PC Cho Airpods 1,2 / Airpods 3/ Airpods Pro/ Airpods Pro 2 Kèm Móc Treo- Hàng Chính Hãng",99000,99000,0,0
TIKI,thiet-bi-kts-phu-kien-so,26029929,"Bàn di,tấm lót chuột chơi game Mouse pad",11900,11900,0,0
TIKI,thiet-bi-kts-phu-kien-so,68985833,"Dây sạc Cáp sạc Nam châm Đồng hồ Thông minh Q12, Q16, Q19, Q100, TD26, A28, DS60, DS66, Y95, D06, DF39 Hàng nhập khẩu",57000,57000,0,0
TIKI,thiet-bi-kts-phu-kien-so,192364741,"Miếng Lót Chuột ,Bàn Di Chuột Huqu -Chất Liệu Sợi Fiber -Hàng Chính Hãng ",28500,30000,1500,5
TIKI,thiet-bi-kts-phu-kien-so,201437397,"Giá Đỡ Laptop Hợp Kim Nhôm Cao Cấp Dễ Dàng Gấp Gọn, Giúp Tản Nhiệt Laptop, Máy Tính Xách Tay - 07 Nấc Điều Chỉnh Góc Độ. Hàng Chính Hãng Tamayoko",160000,160000,0,0
TIKI,thiet-bi-kts-phu-kien-so,87675294,"Đồng Hồ Thông Minh Trẻ Em Chống Nước Chuẩn IP67 AMA Watch Q12 Hàng nhập khẩu",280000,280000,0,0
TIKI,thiet-bi-kts-phu-kien-so,104268199,"Chuột không dây kiểu đứng sạc pin HXSJ T22 wireless USB 2.4GHz chống mỏi tay chuyên dùng cho pc laptop macbook ipad tivi - Hàng chính hãng",349000,599000,250000,42
TIKI,thiet-bi-kts-phu-kien-so,107338360,"Bàn Di Chuột - Miếng Lót Chuột Cỡ Lớn Doron-HDC01 Size 40x80, 45x90 cm - Kiêm Deskpad Thảm Da, Trải Bàn Làm Việc Chống Nước Dùng Được Hai Mặt - Hàng Nhập Khẩu",99000,99000,0,0
TIKI,thiet-bi-kts-phu-kien-so,360660,"Bộ Bàn Phím Và Chuột Logitech MK220 Không Dây - Hàng chính hãng",419000,419000,0,0
TIKI,thiet-bi-kts-phu-kien-so,125652874,"Combo củ cáp sạc nhanh chuẩn PD 20W cho IP12,IP13 Remax RPU88i-RC188i- Hàng chính hãng",450000,500000,50000,10
TIKI,thiet-bi-kts-phu-kien-so,116783441,"5in1 - Bộ vệ sinh Laptop, Macbook, Máy ảnh Cao Cấp - Hàng Nhập Khẩu - Chính Hãng JRC",228800,228800,0,0
TIKI,thiet-bi-kts-phu-kien-so,110169574,"Thảm Lót Chuột Cỡ Lớn, Dùng Được Hai Mặt - Da PU Chống Nước - Doron HD01 - Kiêm Deskpad Thảm Da, Trải Bàn Làm Việc - Hàng Nhập Khẩu",79000,79000,0,0
TIKI,thiet-bi-kts-phu-kien-so,122158068,"Tẩu sạc nhanh 20W trên xe hơi ô tô HOCO Z42 PD QC 3.0 Dành cho điện thoại iPhone iP Samsung Oppo cốc củ cóc sạc oto  - Hàng chính hãng",159000,159000,0,0
TIKI,thiet-bi-kts-phu-kien-so,111983048,"Dây Cáp HDMI 2.1 CHOETECH XHH03-BK Dài 2M Phân Giải Tối Đa 8K 48Gbps, 4K 120Hz Dùng Cho Tivi/Laptop/Playstation/PC - Hàng Chính Hãng",179000,260000,81000,31
TIKI,thiet-bi-kts-phu-kien-so,72540740,"Ốp lưng dẻo thoát nhiệt dành cho iPhone 11 PRO MAX - Đen - Hàng chính hãng",49000,69000,20000,29
TIKI,thiet-bi-kts-phu-kien-so,895314,"Tai Nghe Nhét Tai Langsdom Super Bass JM26",45000,50000,5000,10
TIKI,thiet-bi-kts-phu-kien-so,135410778,"Ốp Lưng Trong Suốt Hoco Dành Cho iPhone - Hàng Chính Hãng ",86000,86000,0,0
TIKI,thiet-bi-kts-phu-kien-so,117987260,"Loa Máy Tính Doron V-196 - Âm Thanh Siêu Trầm 4D, Bass Êm - Hàng Chính Hãng",190000,190000,0,0
TIKI,thiet-bi-kts-phu-kien-so,189474023,"Sạc dự phòng không dây từ tính Remax RPP-65 10000mAh - Hàng chính hãng",753500,990000,236500,24
TIKI,thiet-bi-kts-phu-kien-so,193209851,"Pin Sạc Dự Phòng 20000mAh Sạc Nhanh PD 20W QC 18W RAVPower RP-PB1205 - Hàng Chính Hãng",699000,1190000,491000,41
TIKI,thiet-bi-kts-phu-kien-so,91013563,"Remote Quạt Senko Điều Khiển (Tất Cả Các Loại như TR1683, DR1608, TR1628, DH1600) Hàng Chính Hãng",70000,70000,0,0
TIKI,thiet-bi-kts-phu-kien-so,199165708,"Giá đỡ laptop tuỳ chỉnh góc nghiêng để phù hợp góc nhìn của bạn chất liệu hợp kim nhôm, hỗ trợ tản nhiệt tốt cho máy tính laptop, macbook và máy tính bảng",109000,109000,0,0
TIKI,thiet-bi-kts-phu-kien-so,126032985,"Ốp Lưng Trong Suốt MIPOW TEMPERED GLASS Dành Cho iPhone 13 Mini, Iphone 13/ 13 Pro, 13 Pro Max - Hàng Chính Hãng",68000,290000,222000,77
TIKI,do-choi-me-be,125393624,"Địu ngồi trẻ em cao cấp siêu mềm - siêu thoáng 4 tư thế Comfybaby CF119HC003 cho bé từ sơ sinh tới 36 tháng có mũ đỡ đầu",1190000,1190000,0,0
TIKI,do-choi-me-be,129665687,"(HCM) Tã quần người già Caryn size M gói lớn 32 miếng siêu tiết kiệm",355000,355000,0,0
TIKI,do-choi-me-be,59547957,"Chất thống tắc nghẽn SIFA cầu W.C - CỐNG bicro phốt siêu tốc trị nghẹt chống hối 1.6kg thể tích thực 900ml cao cấp",65000,65000,0,0
TIKI,do-choi-me-be,156718469,"Thùng 30 hộp thực phẩm Formeal dinh dưỡng y học (dạng lỏng)  - Thay thế bữa ăn, dễ hấp thu -  dành cho người bệnh - Orgalife",2265000,2265000,0,0
TIKI,do-choi-me-be,36376687,"Ghế rung nhún đa năng có giá treo đồ chơi (giao màu ngẫu nhiên)",189000,189000,0,0
TIKI,do-choi-me-be,160392423,"Đầm công chúa bé gái Họa tiết Nơ vàng tafta ánh nhủ - AICDBG1SQCZK - AIN Closet",260000,370000,110000,30
TIKI,do-choi-me-be,175950822,"Khăn Lau Hạ Sốt 0Y+ Oribebe Cho Bé Giúp Hạ Nhiệt Giảm Sốt Hộp 4 Túi x 6 Khăn",125000,195000,70000,36
TIKI,do-choi-me-be,74734667,"BỘT NGŨ CỐC 5 LOẠI ĐẬU 100% NGUYÊN CHẤT (VITAPRO) - SIÊU GIẢM CÂN -500 GR",67000,67000,0,0
TIKI,do-choi-me-be,4105507,"Kem Dưỡng Da Mặt Cho Trẻ Sơ Sinh Và Em Bé Da Thường Mustela (40ml)",222750,225000,2250,1
TIKI,do-choi-me-be,7485231,"Nước thông tắc đường ống thoát nước Hando 570ml xuất khẩu",27000,27000,0,0
TIKI,do-choi-me-be,72895955,"Mô hình Đồng hồ cơ hình Cú Owl Clock LK503 Battery Mechanical",699000,899000,200000,22
TIKI,do-choi-me-be,155050154,"Bộ Trò Chơi Bingo Loto Lô Tô Vui Nhộn Dịp Lễ Tết",260000,260000,0,0
TIKI,do-choi-me-be,100899836,"Bộ tranh xếp hình 150 mảnh – Cars ",45000,65000,20000,31
TIKI,do-choi-me-be,73495955,"Bộ Đồ Bơi Bé Gái Hai Mảnh Sắc Màu BB033 MayHomes Set Áo Tắm Tay Dài Và Quần Bơi Dài Thun Lạnh Cao Cấp",199000,199000,0,0
TIKI,do-choi-me-be,3048073,"Khăn vải  khô đa năng StayDry (350 gram)",44100,49000,4900,10
TIKI,do-choi-me-be,195658191,"Áo thun hồng in hình Poppy Playtime Mommy Long Legs bé gái",110000,110000,0,0
TIKI,do-choi-me-be,22828434,"Balo chống gù siêu nhẹ",281997,281997,0,0
TIKI,do-choi-me-be,198739898,"Túi Đá Khô Trữ Sữa Mama’s Choice, Giữ Lạnh Sữa Mẹ Lên Đến 14 Tiếng, Túi Giữ Nhiệt Bình Sữa, Đựng Và Giữ Ấm Đồ Ăn Cho Bé",225000,290000,65000,22
TIKI,do-choi-me-be,9805627,"Combo 03 hộp Bột Tẩy Quần Áo Thiên Nhiên Baking Soda (12g x 5 gói)",122000,165000,43000,26
TIKI,do-choi-me-be,74871579,"Bộ xếp hình lắp ráp bóng lăn KAVY với 101 chi tiết nhiều màu sắc kích thích giác quan, sáng tạo của trẻ",110000,110000,0,0
TIKI,do-choi-me-be,130361460,"(VẢI XUẤT DƯ XỊN) QUẦN LEGGING TRƠN DÀI THUN COTTON 4 CHIỀU CHO BÉ GÁI 21-41KG",52000,52000,0,0
TIKI,do-choi-me-be,399372,"Xe Buýt Nội Thành Siku - 1021",99000,99000,0,0
TIKI,do-choi-me-be,249171583,"Bình sữa cổ hẹp PP Wesser 60ml/140ml/250ml",115240,134000,18760,14
TIKI,do-choi-me-be,153979181,"Vali Kéo Du lịch Trẻ Em MCN Beddy Bear 17 inch - họa tiết Kỳ Lân dập nổi 3D chống va đập, bánh xoay 360 - Khóa TSA cố định trên Vali - Bảo hành 5 năm MIỄN PHÍ",1790000,1790000,0,0
TIKI,do-choi-me-be,7243389,"Nhà búp bê Ngôi nhà thu nhỏ lắp ghép Pink Girl",280000,280000,0,0
TIKI,do-choi-me-be,38103316,"Thảm xốp 2 mặt chống va đập 1.8mx2m hình hươu cho bé",92999,92999,0,0
TIKI,do-choi-me-be,49332681,"Set Đệm + Gối Chống Trào Ngược -DQ01",240000,240000,0,0
TIKI,do-choi-me-be,108762440,"Bộ đồ siêu nhân nhện cho bé trai từ 12-43Kg tay dài quần dài-Chất liệu thun cotton-HNStore",199000,289000,90000,31
TIKI,do-choi-me-be,205291413," vệ sinh máy rửa bát finish vỉ 3 viên",105900,105900,0,0
TIKI,do-choi-me-be,137995977,"Đồ Chơi Tranh Cát Cho Bé",10000,10000,0,0
TIKI,do-choi-me-be,263440754,"Túi 54 Viên Giặt Xả 3D Gel Ball Nội Địa Nhật Bản",189000,189000,0,0
TIKI,do-choi-me-be,33007594,"Đồ chơi -  SÁCH VẢI SƠ SINH ĐEN TRẮNG BUMBLE BEE",155000,155000,0,0
TIKI,do-choi-me-be,13759805,"Khăn Choàng Cho Bé Bú, Khăn Choàng Che Nắng,Khăn Choàng Cho Trẻ Sơ Sinh - Tặng Khẩu Trang (Màu và Mẫu Ngẫu Nhiên)",48000,48000,0,0
TIKI,do-choi-me-be,120805779,"Lều Xông Hơi Tự Bung Sau Sinh Cao Cấp - Loại 1, Hàng Chuẩn Đẹp  Bảo Hành 18 tháng (màu ngẫu nhiên)",163188,163188,0,0
TIKI,do-choi-me-be,15491007,"Đai An Toàn Xe Máy Cho Bé",98000,98000,0,0
TIKI,do-choi-me-be,191436940,"Đầm bé gái họa tiết Nơ xám cotton - AICDBGHE3UQH - AIN Closet",155000,255000,100000,39
TIKI,do-choi-me-be,117832423,"Đồ bộ bé gái xinh️vải cotton 4 chiều,thoáng mát,vận động,thấm hụt mồ hôi",39000,39000,0,0
TIKI,do-choi-me-be,113592665,"Bộ ( 1 bộ) Quần áo Tole, lanh bé TRAI | Mẫu Tay dài cài nút trước | Size 1-12 cho bé 5-34 kg| Chất vải tole, lanh 2 da loại 1 mềm, mịn, mát cho bé TRAI | Hàng Việt Nam | Đồ bộ bé TRAI | quần áo trẻ em | Đồ tôn trẻ em",52000,52000,0,0
TIKI,do-choi-me-be,74907002,"Con Quay Đèn Led Spinner Trong Suốt",48000,48000,0,0
TIKI,do-choi-me-be,72646408,"Combo 10 quần bé trai từ 3-32kg - Cotton thiên nhiên. Giao màu ngẫu nhiên",89000,89000,0,0
TIKI,do-choi-me-be,59236455,"Chất thông tắc cực mạnh 5 phút siêu nhanh SIFA Cầu  - Cống  1.06kg thể tích thực 900ml cao cấp - phiên bản kết nối yêu thương",50000,50000,0,0
TIKI,do-choi-me-be,180502061,"Đầm bé gái gắn nơ trước ngực vải đũi từ 14-34 kg - MEEJENA - 2012",159000,159000,0,0
TIKI,do-choi-me-be,192730486,"Đồ chơi lắp ráp mô hình phi hành gia phát sáng - xếp hình nhà du hành vũ trụ có đèn led phát sáng 3 chế độ",29000,29000,0,0
TIKI,do-choi-me-be,190135894,"Đồ chơi xếp hình, lắp ráp tàu chiến Qman 1720 - Cuộc xung đột bờ biển (235 mảnh ghép)",169000,208950,39950,19
TIKI,do-choi-me-be,99669795,"03 bộ tranh xếp hình 70 mảnh ghép khổ A3 – đồ chơi trí tuệ cho bé từ 3 tuổi – Combo 15",85000,110000,25000,23
TIKI,do-choi-me-be,136342676,"Đồ Chơi Giáo Dục Ghép Hình Gỗ Nổi 3D - Tranh Ghép Hình Cho Bé Lắp Ráp Tranh Ghép Gỗ 3D - Phát Triển Trí Tuệ",26000,26000,0,0
TIKI,do-choi-me-be,68920900,"Cháo Tươi Bào Ngư Nấm Bào Ngư Cây Thị",33300,38000,4700,12
TIKI,do-choi-me-be,212938771,"Dây Bọt Biển Bọc Cạnh Bàn Bảo Vệ Bé - Giao màu ngẫu nhiên",45000,50000,5000,10
TIKI,do-choi-me-be,48948620,"Máy Báo Khóc kèm Camera giám sát, không dây, tần số sóng 2.4G Corky Baby – mbk03",1299000,1299000,0,0
TIKI,do-choi-me-be,113623641,"Sữa Tắm, Dầu Gội 2in1 Bubchen Đức - Hương Thơm Tự Nhiên, Không Cay Mắt (hàng chuẩn Đức)",105000,105000,0,0
TIKI,do-choi-me-be,30679548,"Bộ 6 Gói Khăn Ướt Không Hương Agi (100 Tờ x 6) - Giao Mẫu Ngẫu Nhiên",240000,240000,0,0
TIKI,do-choi-me-be,160370448,"Bộ quần dài áo tay ngắn bé gái Cam nơ cotton dệt - AICDBGTG38YR - AIN Closet",165000,220000,55000,25
TIKI,do-choi-me-be,133546079,"Bộ que tính đồ chơi Toán học bằng gỗ 100 que, hộp số và dấu cho bé phát triển kĩ năng tính toán",42999,42999,0,0
TIKI,do-choi-me-be,90799920,"Set 5 cái khăn xô sữa 6 lớp cho bé sơ sinh - Thích hợp để lau người, tắm, lau mồ hôi và làm khăn quảng cổ cho bé",59500,59500,0,0
TIKI,do-choi-me-be,98819920," COMBO 10 VIÊN TẨY BỒN CẦU HÀN QUỐC",12800,12800,0,0
TIKI,do-choi-me-be,169260316,"Đồ Bơi Bé Gái Một Mảnh Họa Tiết Hoạt Hình Dễ Thương BBO11 MAYHOMES Cute Baby Girl Swimsuit",148000,175000,27000,15
TIKI,do-choi-me-be,13304072,"Đồ chơi rút gỗ số loại lớn nhất - 53001",31349,31349,0,0
TIKI,do-choi-me-be,10210851,"Thùng sữa nước pha sẵn Nutricare Metacare - phát triển toàn diện cho trẻ từ 1 tuổi (110ml x 48 hộp)",335000,335000,0,0
TIKI,do-choi-me-be,84331242,"Sữa Oggi 0+ 800g - Giúp trẻ khoẻ mạnh phát triển toàn diện",298000,298000,0,0
TIKI,do-choi-me-be,127121275,"Đồ Chơi Cho Trẻ Em Đoàn Tàu Nam Châm Chở Chữ, Chở Số Bằng Gỗ Đẹp An Toàn Cho Bé Trai Bé Gái - Đồ Chơi Gỗ Thông Minh",335000,335000,0,0
TIKI,do-choi-me-be,113771783,"Áo sơ mi trắng đi học cho bé trai , đồng phục học sinh các cấp, size từ 20-95kg, form suông, vạt bầu, thương hiệu Amazing",97000,154000,57000,37
TIKI,do-choi-me-be,56420320," Bộ Đồ Chơi Rút Gỗ Loại Lớn - Đồ Chơi Xếp Khối 48 Thanh Kèm 4 Xúc Xắc",37050,39000,1950,5
TIKI,do-choi-me-be,157164283,"áo khoác bé gái dù 2 lớp thiết kế hình in xinh xắn phối chữ cute 5 đến 14 tuổi D211",110000,110000,0,0
TIKI,do-choi-me-be,173383480,"Bình Sữa PP Streamline Pigeon Hình Chuột Mickey 150ml/250ml",121000,201000,80000,40
TIKI,do-choi-me-be,45551545,"3 Hộp Sữa Bột VitaDairy Nepro 1 (900g)",1380000,1380000,0,0
TIKI,do-choi-me-be,188534057,"Bộ Cờ Tướng Cao Cấp Bằng Ngọc 4cm",165000,165000,0,0
TIKI,do-choi-me-be,58918466,"Viên Giặt Kirkland Signature Ultra Clean 152 Viên Của Mỹ - Mẫu mới",850000,850000,0,0
TIKI,do-choi-me-be,543915,"Dung Dịch Xả Quần Áo Cho Bé D-nee - Chai 3000ml (Xanh)",205000,205000,0,0
TIKI,do-choi-me-be,121345168,"Nhà bìa carton lắp ghép cho bé/Nhà giấy carton lắp ráp cho bé siêu đẹp, chắc chắn.",90250,95000,4750,5
TIKI,do-choi-me-be,59323136,"Combo 10 bịch Sữa Óc Chó, Hạnh Nhân, Đậu Đen, Macca tăng chiều cao và cân nặng hiệu Golden Health Hàn Quốc",139000,139000,0,0
TIKI,do-choi-me-be,58547125,"Đồ Bơi Bé Trai, Đồ Bơi Trẻ Em BB012 MayHomes, Họa Tiết Mạnh Mẽ, Chất Liệu Bền Đẹp",135000,159000,24000,15
TIKI,do-choi-me-be,89823330,"Khóa gài tủ lạnh, tủ đồ đa năng",5199,5199,0,0
TIKI,do-choi-me-be,68257367,"Nước rửa chén hữu cơ Bồ hòn Ecocare tinh dầu Chanh Gừng 2000ml ",280000,280000,0,0
TIKI,do-choi-me-be,170751631,"Bộ (1 bộ) đồ bộ bé GÁI Sát Nách chất vải tole lanh 2 da loại 1 mềm mịn, thoáng mát - Nhiều size cho bé từ 5-30 kg",42000,42000,0,0
TIKI,do-choi-me-be,56536143,"Combo Bộ 4 Miếng Dụng Cụ Silicone Chặn Và Bịt Góc Bàn Tủ Cửa Bảo Vệ Bé Legaxi",7000,7000,0,0
TIKI,do-choi-me-be,51041357,"Đồ chơi thiếu nhi - Đồ chơi giáo dục phát triển kĩ năng cơ bản - Ống heo tiết kiệm mô hình nhà cho bé",41097,76000,34903,46
TIKI,do-choi-me-be,72912775,"Bộ tranh xếp hình jigsaw puzzle cao cấp 330 mảnh – Lâu Đài Himeji",78000,100000,22000,22
TIKI,do-choi-me-be,121162050,"Kẹp tóc, cặp tóc chất liệu nhựa PVC hình ngộ nghĩnh cho bé gái",22000,22000,0,0
TIKI,do-choi-me-be,169191270,"Sữa Smatie Canxi Xương Khớp cho người tiểu đường",435000,435000,0,0
TIKI,do-choi-me-be,195286657,"Đồ chơi đâm hải tặc size lớn 20cm 24 kiếm",90000,90000,0,0
TIKI,thiet-bi-kts-phu-kien-so,130084156,"Cáp sạc cho iPhone/ iPad Baseus Superior Series Fast Charging Data Cable USB to iP (2.4A, 480Mbps, Fast charge, ABS/ TPE Cable)",69000,69000,0,0
TIKI,thiet-bi-kts-phu-kien-so,138489704,"Găng tay chơi game MEMO - Sợi Carbon cao cấp siêu bền, co dãn, đàn hồi tốt , độ nhạy cao - Hàng nhập khẩu",13000,20000,7000,35
TIKI,thiet-bi-kts-phu-kien-so,162028506,"Ốp lưng thoát nhiệt dành cho iPhone 11 / 12 / 13 / 11 Pro / 12 Pro / 13 Pro / 11 Pro Max / 12 Pro Max / 13 Pro Max / 12 Mini / 13 Mini - Hàng chính hãng",59000,99000,40000,40
TIKI,thiet-bi-kts-phu-kien-so,52769271,"SIM 4G Vinaphone VD149 12T Trọn Gói 1 Năm Không Cần Nạp Tiền, Khuyến Mãi 120GB/Tháng, Gọi + SMS Miễn Phí Nội Mạng, Cộng Thêm 200 Phút Gọi Ngại Mạng Mỗi Tháng - Hàng Chính Hãng (Giao mẫu ngẫu nhiên)",1179000,1179000,0,0
TIKI,thiet-bi-kts-phu-kien-so,5511229,"Tấm lót chuột  (22 x 18cm)",9300,9300,0,0
TIKI,thiet-bi-kts-phu-kien-so,131338682,"Túi Dây rút Chống Thấm kỹ thuật Bảo vệ tai nghe,Pin Sạc điện thoại nhỏ,Các vật dụng Cá Nhân",13000,13000,0,0
TIKI,thiet-bi-kts-phu-kien-so,122393354,"Hub chuyển đổi USB TypeC 6 trong 1 SEASY SS26, Cổng chuyển đổi HUB USB TypeC to HDMI, 1 cổng HDMI 4k UHD , 3 cổng USB 3.0, 2 khe đọc thẻ nhớ SD và TF, Kết nối nhiều thiết bị với tốc độ cao, Dùng cho Điện thoại/Laptop/PC/Macbook – Hàng chính hãng",279500,279500,0,0
TIKI,thiet-bi-kts-phu-kien-so,72008056,"Đế Sạc Không Dây Apple MagSafe Charger Hỗ Trợ Sạc Nhanh 15W MHXH3 - Trắng",1150000,1990000,840000,42
TIKI,thiet-bi-kts-phu-kien-so,126003,"Tai Nghe Chụp Tai Sony MDR-ZX310AP",675000,890000,215000,24
TIKI,thiet-bi-kts-phu-kien-so,145124952,"Kính cường lực full màn hình Hoco G5 cho iPhone 13/ 13 pro/ 13 pro max - Hàng nhập khẩu",44999,51998,6999,13
TIKI,thiet-bi-kts-phu-kien-so,19336345,"Dây Đeo Thay Thế Cho Vòng Đeo Tay Thông Minh Xiaomi Mi Band 3 / Mi Band 4 Dẻo TPU",32000,32000,0,0
TIKI,thiet-bi-kts-phu-kien-so,139713984,"Tai nghe không dây gaming X15 TWS công nghệ Bluetooth 5.0 cảm biến chạm, không có độ trễ, thiết kế thể thao ( Chip Jerry 6976D5)",199000,199000,0,0
TIKI,thiet-bi-kts-phu-kien-so,75655835,"Chuột không dây A2 Pro, chuột máy tính không tạo tiếng ồn, có thể sạc lại, hiệu ứng đèn Led RGB- Hàng nhập khẩu",62800,62800,0,0
TIKI,thiet-bi-kts-phu-kien-so,191501918,"Dây Cao Su Thay Thế cho Samsung Galaxy Fit 2 (SM-R220)- Hàng chính hãng",75000,75000,0,0
TIKI,thiet-bi-kts-phu-kien-so,33651679,"Ốp Lưng Silicon TPU trong suốt GOR cho Samsung Note 10/ Note 10 Plus_Hàng NHập Khẩu",40000,40000,0,0
TIKI,thiet-bi-kts-phu-kien-so,47470738,"Giá đỡ điện thoại kẹp điện thoại cao cấp 126  - Hàng Chính Hãng",99500,159000,59500,37
TIKI,thiet-bi-kts-phu-kien-so,136042337,"Cáp chuyển đổi Seasy, Type-c ra 4 cổng HDMI/ VGA/ USB và cổng sạc hỗ trợ chế độ Dex - Hàng chính hãng",289000,389000,100000,26
TIKI,thiet-bi-kts-phu-kien-so,10784603,"Tai nghe chuyên game có Mic Plextone G25",189000,189000,0,0
TIKI,thiet-bi-kts-phu-kien-so,57282867,"Tay cầm chơi game Fifa online 4 trên pc, laptop -black",153400,153400,0,0
TIKI,thiet-bi-kts-phu-kien-so,87740824,"Thẻ nhớ MicroSD có bảo hành 12 tháng dùng kèm cho các thiết bị Điện thoại, máy ảnh, camera ip - NPD-MicroSD (Nhiều loại)",65000,100000,35000,35
TIKI,thiet-bi-kts-phu-kien-so,130172342,"Cáp sạc nhanh siêu bền IP 20W Baseus Superior Series Fast Charging Data Cable Type-C to iP PD (480Mbps)-Hỗ trợ sạc nhanh PD 20W trên iPhone 12 / PD 18W trên iP11/ iP XS Max- Hàng chính hãng",109000,109000,0,0
TIKI,thiet-bi-kts-phu-kien-so,168122417,"Hub chuyển đổi USB Type C 3in1 sang HDMI, USB 3.0, cổng sạc nhanh PD Type-C dành cho Laptop, Macbook, Điện thoại, Samsung Dex",115000,159000,44000,28
TIKI,thiet-bi-kts-phu-kien-so,147125769,"Lót Chuột Phím Tắt Văn Phòng 80x30cm - Bàn Di Chuột Cỡ Lớn",44900,44900,0,0
TIKI,thiet-bi-kts-phu-kien-so,192127239,"Đầu Chuyển Đổi USB Type C Sang USB 3.0 Hàng Chính Hãng, Hub Type C, Hub chuyển đổi USB Type-C Sang USB 3.0 - Hàng Chính Hãng",29000,90000,61000,68
TIKI,thiet-bi-kts-phu-kien-so,180912,"Bàn Phím Bluetooth Logitech K380 - Hàng Chính Hãng",600000,809000,209000,26
TIKI,thiet-bi-kts-phu-kien-so,900466,"Miếng Lót Chuột Logitech G440 - Hàng Chính Hãng",439000,449000,10000,2
TIKI,thiet-bi-kts-phu-kien-so,3237483,"Bàn Phím Gaming DareU LK145 USB - Hàng Chính Hãng",380000,380000,0,0
TIKI,thiet-bi-kts-phu-kien-so,87107826,"Dây Cáp Sạc Type C To Lightning CHOETECH IP0039 MFI C94 Dài 1.2M Sạc Nhanh 20W Dành Cho iPhone 11, 12, IP13, IP14, Cho iPad - Hàng Chính Hãng",269000,450000,181000,40
TIKI,thiet-bi-kts-phu-kien-so,45579046,"Adapter Sạc 2 Cổng Tích Hợp Type-C In/Out Hỗ Trợ Sạc Nhanh PD Power Delivery 61W RAVPower RP-PC105 - Hàng Chính Hãng",499000,850000,351000,41
TIKI,thiet-bi-kts-phu-kien-so,112984330,"Giá Đỡ Laptop Để Bàn Hợp Kim Nhôm Cao Cấp - Gấp Gọn Tiện Lợi - Tản Nhiệt Mang Đến Góc Độ Nhìn Khoa Học Khi Làm Việc Học Tập-Hàng Chính Hãng",298000,298000,0,0
TIKI,thiet-bi-kts-phu-kien-so,36729773,"Dây sạc USB Type C sạc nhanh Qualcomm Quick Charge cho dòng Samsung và các máy có cổng Type-C khác",19000,19000,0,0
TIKI,thiet-bi-kts-phu-kien-so,103637245,"Dây sạc type C to C PROLiNK GCC_60_01 dài 1M, sạc siêu nhanh 60W, dành cho Samsung, Xiaomi, iPad Pro - Hàng chính hãng",69000,100000,31000,31
TIKI,thiet-bi-kts-phu-kien-so,74165192,"Giá Đỡ Laptop Đế Tản Nhiệt Laptop Để Bàn Chất Liệu Hợp Kim Nhôm Cao Cấp Tản Nhiệt – Nâng Hạ Điều Chỉnh Độ Cao - Gấp Gọn Cho Kích Cỡ 10-18 Inches Hàng Chính Hãng",599000,599000,0,0
TIKI,thiet-bi-kts-phu-kien-so,161541791,"Miếng Dán Bảo Vệ Viền PDF Kai dành cho iPhone 13 / 13 Pro / 13 Pro Max - Hàng Chính Hãng",23750,25000,1250,5
TIKI,thiet-bi-kts-phu-kien-so,73822516,"Đầu Ngòi Bút Thay Thế Cao Cấp Cho Apple Pencil 1 / Apple Pencil 2 - Apple Pencil Tips",94000,94000,0,0
TIKI,thiet-bi-kts-phu-kien-so,87108370,"Dây Cáp Sạc Nhanh USB Type C To Type C 60W Dài 1.2M Hỗ Trợ Sạc Nhanh iPhone 15 CHOETECH XCC-1003 - Hàng Chính Hãng",119000,210000,91000,43
TIKI,thiet-bi-kts-phu-kien-so,72818491,"Giá Đỡ Điện Thoại, Máy Tính Bảng Hợp Kim Nhôm Gập Hai Chỗ Có Thể Gấp Gọn Hàng Chính Hãng Tamayoko",249000,400000,151000,38
TIKI,thiet-bi-kts-phu-kien-so,25410296,"Chuột Không Dây Wireless 2.4G HXSJ T21 - Hàng chính hãng",129000,249000,120000,48
TIKI,thiet-bi-kts-phu-kien-so,20075565,"Cáp chia nguồn sata 1 ra 2 vuông góc 90 độ",25000,25000,0,0
TIKI,thiet-bi-kts-phu-kien-so,184783198,"Bộ sạc nhanh 10W (5V/2A) chân dẹt màu trắng tặng kèm cáp sạc USB micro dùng cho samsung, sony, nokia, vivo, oppo, redmi...",75000,75000,0,0
TIKI,do-choi-me-be,171153525,"Hộp 6 bộ đồ chơi lắp ráp Robot biến hình - Thiết bị quân sự Qman 1412",329000,359000,30000,8
TIKI,do-choi-me-be,129710218,"HOT: Chó Shiba XẢ STRESS - Chó Shiba silicon co dãn, dẻo, đàn hồi ngộ nghĩnh, giải tỏa căng thẳng, xả STRESS",20000,20000,0,0
TIKI,do-choi-me-be,126243917,"Chậu Xông Vùng Kín Sau Sinh, Chậu xông hơi vùng kín Gấp Gọn, gắn bồn cầu, bô xông vùng kín Tiện Lợi kèm Vòi xịt phụ khoa",83900,83900,0,0
TIKI,do-choi-me-be,95035825,"Bột ăn dặm dinh dưỡng Ngũ cốc bắp non HiPP Organic 200g",135000,135000,0,0
TIKI,do-choi-me-be,118494409,"Siro Uống Nature's Way Kids Smart Drops DHA Dạng Giọt Giúp Tăng IQ, Phát Triển Não Bộ Cho Bé 20ml",350000,350000,0,0
TIKI,do-choi-me-be,2173351,"Combo 3 Bịch Khăn Vải Khô Likado (300g)",109000,120000,11000,9
TIKI,do-choi-me-be,105219052,"Mút Cao Su Dán, Bọc Cạnh, Góc Bàn An Toàn Cho Bé - KUB",74000,74000,0,0
TIKI,do-choi-me-be,59049510,"Chất thông tắc Cống và Cầu Sifa chống hôi Siêu nhanh siêu mạnh 5 phút 425ml cao cấp",50000,50000,0,0
TIKI,do-choi-me-be,191678954,"Đèn lồng trung thu hình thú phát sáng, Đèn led phát sáng vui nhộn",33377,33377,0,0
TIKI,do-choi-me-be,94728752,"Đồ chơi giáo dục sớm thả hình khối có quai xách cho bé Toyshouse 0702-TH-HE0218",139000,160000,21000,13
TIKI,do-choi-me-be,102262521,"Phao bơi chống lật Swim Bobo cho bé từ 1 tuổi đến 5 tuổi",319000,346020,27020,8
TIKI,do-choi-me-be,165846177,"XE ĐẨY GẤP GỌN CHO BÉ HAKAWA HK-B07 - HÀNG CHÍNH HÃNG",1200000,1200000,0,0
TIKI,do-choi-me-be,174624883,"Giấy vệ sinh 3 lớp cao cấp có lõi JAPANI SILK | Thế Giới Giấy | 100% bột giấy nguyên sinh | 10 cuộn",64000,86000,22000,26
TIKI,do-choi-me-be,58141815,"Bột Thông Tắc Cống, Đường Ống - EcoSock Hộp 0.5Kg - Hàng Chính Hãng Từ Mỹ",362000,362000,0,0
TIKI,do-choi-me-be,75996180,"Đồ chơi lò xo cầu vồng ma thuật bằng nhựa (đường kính 7 cm)",15600,15600,0,0
TIKI,do-choi-me-be,116572109,"Combo 3 Trà cốm lợi sữa hoà tan HiPP Mama Herbal Nursing Tea 100% thảo mộc, dành cho mẹ sau sinh và đang cho con bú giúp bồi bổ cơ thể, hỗ trợ và tăng cường lượng sữa (2 hộp x 200g)",525000,525000,0,0
TIKI,do-choi-me-be,133545034,"Combo 6 Gói Khăn Ướt Yuniku 90 Tờ Hương Lài ( 90 Tờ x 6 )",145000,250800,105800,42
TIKI,do-choi-me-be,74850451,"Đồ chơi mô hình xe ô tô cảnh sát chạy pin, nhựa nguyên sinh an toàn, chạy rất nhanh và xa",36000,36000,0,0
TIKI,do-choi-me-be,127993576,"Đồ Chơi Gỗ Cao Cấp Hộp thả hình, đồ chơi gỗ thông minh - hàng chính hãng",134640,136000,1360,1
TIKI,do-choi-me-be,90584712,"Bệ Thu Nhỏ Bồn Cầu Cho Bé - Nhựa PVC Cao Cấp",179000,179000,0,0
TIKI,do-choi-me-be,180714377,"Đồ bộ bé gái, quần áo Mimykid in 3D hoạt hình và trái cây dễ thương, đáng yêu chất liệu thun dày mịn mát, được các bé gái yêu thích, thời trang, set, đồ cho trẻ em, bé gái từ 8kg-28kg",66000,66000,0,0
TIKI,do-choi-me-be,49498423,"Combo 2 bịch bỉm/tã quần cao cấp MIJUKU - M",335000,335000,0,0
TIKI,do-choi-me-be,177751108,"MÁY HÚT SỮA ĐIỆN ĐÔI FATZ BABY - CHORUS 2 - FB1182MX",666000,666000,0,0
TIKI,do-choi-me-be,147588060,"Bộ Bài Tây Poker Mạ Si Vàng 24K Cao Cấp Phủ Nhũ Vàng Chính Hãng Dododios – Bộ 54 Lá Bài Tây Pocker Nhựa Dẻo Chống Thấm Nước Chống Gãy",29000,29000,0,0
TIKI,do-choi-me-be,55461311,"Tinh dầu tràm Huế Kim Vui 125ml - Tinh dầu dùng cho trẻ sơ sinh",190000,190000,0,0
TIKI,do-choi-me-be,72577100,"03 bộ tranh xếp hình 70 mảnh ghép khổ A3 – đồ chơi trí tuệ cho bé từ 3 tuổi – Combo 1 (Giao mẫu ngẫu nhiên)",85000,110000,25000,23
TIKI,do-choi-me-be,88924605,"Sữa Bột Frisolac Gold 1 380g Dành Cho Trẻ Từ 0 - 6 Tháng Tuổi",253000,253000,0,0
TIKI,do-choi-me-be,190108309,"Đồ chơi lắp ráp xếp hình 8 trong 1 chủ đề quân sự Qman 42301 - Xe tăng quân sự (642 chi tiết)",359000,489000,130000,27
TIKI,do-choi-me-be,179992878,"Thanh Sữa Meiji Ezcube Infant Formula Dạng Viên (5 Viên)",30000,30000,0,0
TIKI,do-choi-me-be,3525963,"Đồ Chơi Bé Trai, Đồ Chơi Dụng Cụ Sửa Chữa Cơ Khí Toyshouse",170000,170000,0,0
TIKI,do-choi-me-be,133790543,"Gối Mẹ Bầu Đậu Khuyết Đa Năng Linen Bông Gòn Lông Vũ Cao Cấp | 159",599000,599000,0,0
TIKI,do-choi-me-be,134440669,"Ghế ăn dặm gấp gọn cao cấp Umoo mới nhất 2021, có bánh xe và điều chỉnh được độ cao",647000,699999,52999,8
TIKI,do-choi-me-be,17461315,"Sữa bột Nutricare Fine dinh dưỡng y học tăng cường miễn dịch cho bệnh nhân ung thư (900g)",519000,565000,46000,8
TIKI,do-choi-me-be,97856619,"Chậu tắm gấp gọn cho bé mẫu mới 2020",279000,279000,0,0
TIKI,do-choi-me-be,45552968,"Bột Giặt Lix Extra Hương Nước Hoa 5.5Kg EH055 - Tăng Gấp Đôi Sức Mạnh Giặt Tẩy",139000,139000,0,0
TIKI,do-choi-me-be,42411606,"Cuộn bọc cạnh bàn ghế, cạnh tủ cao su non bảo vệ an toàn cho bé vui chơi trong nhà (2 mét) tặng kèm băng dính -giao màu ngẫu nhiên",31998,31998,0,0
TIKI,do-choi-me-be,74689863,"Đồ chơi mô hình xe cần cẩu nâng hàng KAVY chất liệu hợp kim và nhựa nguyên sinh an toàn, chi tiết sắc sảo các khớp chuyển động",98000,98000,0,0
TIKI,do-choi-me-be,17702472,"4 Bịch Khăn vải khô đa năng LIKADO 400g (20 x 22cm)",220000,240000,20000,8
TIKI,do-choi-me-be,52667114,"Nước giặt 3.5Kg Surf Nước giặt thơm Hương Sương Mai Dịu Mát ",129000,129000,0,0
TIKI,do-choi-me-be,56815790,"Bộ tranh xếp hình 150 mảnh – Totoro",45000,65000,20000,31
TIKI,do-choi-me-be,77161871,"Nước Rửa Chén Hữu Cơ Sinh Học ENZYCO Lên Men Từ Dứa Và Bồ Hòn Làm Sạch Chén Bát Không Gây Dị Ứng Da - Hương Cam 100ml",50000,50000,0,0
TIKI,do-choi-me-be,176937782,"Bình trữ sữa Medela 150ml/250ml - Nắp bình tách rời có thể nắp núm ty vào cho bé bú",155000,155000,0,0
TIKI,do-choi-me-be,10117533,"Vi sinh thông cống, xử lý hầm cầu, bể phốt, tự hoại BIO - SEPTIC - Chai 350ml",100000,100000,0,0
TIKI,do-choi-me-be,70839639,"Bàn Tỷ Phú Lớn",115000,115000,0,0
TIKI,do-choi-me-be,197656019,"Bánh quy ăn dặm hữu cơ HiPP Organic Baby's Biscuit 180g (4 gói/hộp)",145000,145000,0,0
TIKI,do-choi-me-be,64984596,"Combo 10 Gói Khăn Ướt Yuniku 20 Tờ Hương Trà Xanh ( 20 Tờ x 10 )",95000,137000,42000,31
TIKI,do-choi-me-be,197329427,"Cuộn 2m Mút Xốp Bọc Cạnh Bàn Ghế Giường Tủ Bảo Vệ An Toàn Cho Bé",65000,65000,0,0
TIKI,do-choi-me-be,48184895,"Dung dịch tẩy rửa máy rửa chén Finish Dishwasher Cleaner Lemon 2x250ml QT04441 - hương chanh",179000,179000,0,0
TIKI,do-choi-me-be,45551664,"2 Hộp Sữa Bột Meiji 1-3 Growing Up Formula (800g)",930000,930000,0,0
TIKI,do-choi-me-be,101359142,"Combo 2 Cốc thả bồn cầu tẩy xanh toilet Hàn Quốc Mr Fresh 180g hương ngàn hoa",78000,78000,0,0
TIKI,do-choi-me-be,107972572,"Bình sữa mô phỏng tự nhiên hiệu Philips Avent (125 ml - đơn) cho trẻ từ 0 tháng tuổi 690.13",285000,285000,0,0
TIKI,do-choi-me-be,1380479,"Combo 3 Gói Khăn Giấy Ướt 100 Tờ, Hương Thơm Mát Kháng Khuẩn An Toàn Cho Bé Mamamy (100 Tờ x 3)",97500,97500,0,0
TIKI,do-choi-me-be,41340859,"Cờ Tướng Úp Gồm Nắp",110000,110000,0,0
TIKI,do-choi-me-be,96708638,"Máy xịt thơm phòng cảm biến Glade nội địa Nhật (gồm máy & 01 lõi tinh dầu)",175000,175000,0,0
TIKI,do-choi-me-be,118090342,"Set 4 Dụng Cụ Lấy Ráy Tai Có Đèn Led Kèm Hộp Đựng Tiện Dụng Sử Dụng Cổng Sạc USB",165000,165000,0,0
TIKI,do-choi-me-be,95035851,"Trà cốm lợi sữa HiPP dành cho phụ nữ cho con bú 200g",175000,175000,0,0
TIKI,do-choi-me-be,730491,"Nước Rửa Bình Thảo Mộc Arau Baby Dạng Túi (450ml)",109650,129000,19350,15
TIKI,do-choi-me-be,74769754,"Đồ chơi mô hình xe trộn bê tông KAVY NO.8809 chất liệu hợp kim và nhựa nguyên sinh an toàn, chi tiết sắc sảo",68000,68000,0,0
TIKI,do-choi-me-be,15519960,"Men Vi Sinh Xử Lý Hầm Cầu Ecoclean septic 1 gói 100g",82000,82000,0,0
TIKI,do-choi-me-be,23610135,"GEL BÔI GIẢM SƯNG NƯỚU VÀ BỆNH TAY CHÂN MIỆNG KIN BABY 30ML",162000,162000,0,0
TIKI,do-choi-me-be,73088843,"Combo 10 gói Khăn Giấy Ướt Aiko 100 tờ/gói không hương màu Hồng",270000,270000,0,0
TIKI,do-choi-me-be,174072592,"Combo 2 thùng 24 hộp pha sẵn Nutren Junior 200ml/hộp cho trẻ từ 1-10 tuổi tăng trưởng 3 chuẩn: Thế chất, Đề kháng, Tư duy - Tặng balo con voi xanh",1469000,1512000,43000,3
TIKI,do-choi-me-be,130361634,"(VẢI XUẤT DƯ XỊN) SET 5 QUẦN LEGGING DÀI/ QUẦN DÀI HOẠ TIẾT THUN COTTON 4 CHIỀU CHO BÉ GÁI 9-41KG",189000,189000,0,0
TIKI,do-choi-me-be,49884590,"Sữa Morinaga Số 2 - Chilmil (320g)",198000,278000,80000,29
TIKI,do-choi-me-be,267261033,"Bộ Đồ Bơi Khủng Long Dành Cho Bé Trai Cao Từ 85cm - 125cm chất vải Polyeste thân thiện với trẻ em, mau khô, thấm hút mồ hôi tốt, thiết kế thời trang bắt mắt - Tặng kèm nón bơi vải cùng màu",124000,215000,91000,42
TIKI,do-choi-me-be,138375113,"Bộ Xếp Hình Nam Châm Cho Bé (64 chi tiết) || Montessori cao cấp || Đồ chơi Gỗ - Giáo dục - An toàn - Thông minh",149000,149000,0,0
TIKI,do-choi-me-be,130361694,"(VẢI XUẤT DƯ XỊN) SET 3 QUẦN LEGGING DÀI/QUẦN DÀI HOẠ TIẾT THUN COTTON 4 CHIỀU CHO BÉ GÁI 9-41KG",115000,115000,0,0
TIKI,do-choi-me-be,129665688,"(HCM) Tấm đệm lót người già Caryn khổ lớn 60x70cm gói 14 miếng",98000,98000,0,0
TIKI,do-choi-me-be,53629912,"Tã/bỉm dán Moony Natural Size M-46 miếng( bé 6-11kg)",289000,329000,40000,12
TIKI,do-choi-me-be,37890717,"Nước làm bóng Finish 750ml",149000,149000,0,0
TIKI,do-choi-me-be,24704442,"BỘT ĂN DẶM RIDIELAC GOLD 4 VỊ MẶN - HỘP GIẤY 200G",66000,66000,0,0
TIKI,do-choi-me-be,25141443,"Combo 2 Hộp Vệ Sinh Lồng Giặt Mao Bảo Ag+ 306g - Tặng 1 chai Nước Giặt Kháng Khuẩn Mao Bao 200g",84000,100000,16000,16
TIKI,do-choi-me-be,72744238,"Chai tẩy bồn cầu, gạch men siêu nhanh siêu sạch Sabo-S loại 100ml. Tẩy trắng bồn cầu, bồn sứ,sàn gạch men bị ố vàng cáu cặn lâu năm,an toàn tuyệt đối với bồn sứ tráng men.",29500,59000,29500,50
TIKI,do-choi-me-be,543147,"Dung Dịch Giặt Quần Áo Cho Bé D-Nee - Túi 600ml (Tím)",80000,80000,0,0
TIKI,do-choi-me-be,205290855,"Muối rửa bát Finish 1.2kg, muối finish 1,2kg là muối làm mềm nước trong máy rửa chén bát ly 1200g",104428,104428,0,0
TIKI,do-choi-me-be,23067533,"Đai Đỡ Bụng Bầu Chính Hãng miDoctor",117000,117000,0,0
TIKI,do-choi-me-be,168160974,"Khăn Lau Hạ Sốt 0+ Dr.Papie Cho Bé Hạ Nhiệt Giảm Sốt Ngăn Ngừa Co Giật",185000,185000,0,0
TIKI,do-choi-me-be,87483010,"Miếng Lót Sơ Sinh Bobby Fresh Newborn 2 - 60 (60 Miếng)",115000,140300,25300,18
TIKI,do-choi-me-be,38063658," NỆM GỐI CHO BÉ ĐI HỌC VẢI KARA",260000,260000,0,0
TIKI,do-choi-me-be,199053626,"Dây Hút Sữa Medela Pump Thương Hiệu Maymom, Không Chứa BPA, An Toàn 100%, Vệ Sinh Dễ Dàng",95000,100000,5000,5
TIKI,do-choi-me-be,173830829,"Xe địa hình điều khiển từ xa KAVY BS009A có đèn LED, phun được khói tỷ lệ 1: 14 chất liệu hợp kim tốc độ cao tần số 2.4 GHZ",410000,410000,0,0
TIKI,do-choi-me-be,2791853,"Kem nghệ tươi dưỡng da trắng mịn, sạch sạm nám Wonmom 50g",170000,170000,0,0
TIKI,do-choi-me-be,24499123,"Bột men vi sinh Sifa xử lý hầm cầu chống hôi và đầy bồn cầu 300g",29000,29000,0,0
TIKI,do-choi-me-be,104157878,"[MUA LÀ CÓ QUÀ] Bánh ăn dặm cho bé vị cá Pigeon 24g (6 túi/hộp)",72000,72000,0,0
TIKI,do-choi-me-be,74901695,"Xe ô tô điều khiển từ xa KAVY tốc độ cao, vượt mọi địa hình, bền bỉ chắc chắn",126000,126000,0,0
TIKI,do-choi-me-be,114008155,"Sữa đêm ngũ cốc Fruto Nyanya 200ml",28800,36000,7200,20
TIKI,do-choi-me-be,162148529,"Đồ chơi mô hình xe ô tô Mercedes Benz AMG G63 KAVY No. 8810 tỷ lệ 1:36 hợp kim chạy cót",142000,142000,0,0
TIKI,do-choi-me-be,161211248,"nước giặt Fuwa3e hữu cơ organic từ chế phẩm Enzyme sinh học 4.06L an toàn cho bé",365000,365000,0,0
TIKI,do-choi-me-be,99846006,"Bộ đồ chơi nấu ăn nhà bếp KAVY NO.8808 cho bé gái nhiều chi tiết, nhựa nguyên sinh an toàn - màu hồng",109000,109000,0,0
TIKI,do-choi-me-be,152875697,"Sữa Bột Cho Người Lớn Phục Hồi Sức Khỏe Sau Khi Ốm Tăng Sức Đề Kháng Bổ Sung Vitamin Khoáng Chất Pillow Care A",427350,427350,0,0
TIKI,do-choi-me-be,69180169,"Sữa bột GrowPLUS+ Đỏ 900 Gr : sữa dành cho trẻ từ 1- 10 tuổi bị suy dinh dưỡng thấp còi (mẫu mới) của NutiFood",355000,355000,0,0
TIKI,do-choi-me-be,48632517,"Que Thử Thai QUICKSTICK MIDSTREAM",74900,74900,0,0
TIKI,do-choi-me-be,103744242,"Thanh chắn giường Umoo bản nâng cấp 2021, thanh chặn giường dạng trượt 1 bên và ngồi không bị kênh đệm  (Giá 1 thanh)",445000,445000,0,0
TIKI,do-choi-me-be,113394177,"Sữa tăng chiều cao A2 High In Calcium Úc - Giúp trẻ phát Triển chiều cao, Chống loãng xương ở người lớn, Hỗ Trợ tăng sức khỏe tổng thể - Massel Official",461000,922000,461000,50
TIKI,do-choi-me-be,59051156," Đồ chơi lắp ghép - BỘ LẮP RÁP  MÊ CUNG THẢ BI GỒM 30 VIÊN BI",174000,174000,0,0
TIKI,do-choi-me-be,190590858," [MẪU MỚI]-Balo 3D hình công chúa ELSA cho bé gái học mẫu giáo– CHỌN MẪU- Cặp ELSA 3D cho bé đi học, size 25x7cm",159000,206700,47700,23
TIKI,do-choi-me-be,164032821,"Đồ chơi cho bé xe tăng địa hình KAVY No. 8807 chạy đà biến hình có bắn đạn quay 360 độ",55000,55000,0,0
TIKI,do-choi-me-be,48151056,"Nhiệt Kế Đa Năng Đo Nhiệt Độ Sữa, Nước Và Đồ Ăn Cho Bé",34000,34000,0,0
TIKI,do-choi-me-be,114042520,"Trái cây nghiền vị táo, mâm xôi và phomai tươi Fruto Nyanya 90g",37600,47000,9400,20
TIKI,do-choi-me-be,189867447,"Đồ chơi vô lăng phát nhạc cho bé, vô lăng tập lái có đèn và còi xe",65000,65000,0,0
TIKI,do-choi-me-be,57454854,"COMBO 2 Bỉm - Tã quần Moony Natural size L-36 miếng (cho bé 9-14kg)",560000,560000,0,0
TIKI,do-choi-me-be,48316369,"Đồ Chơi Khám Răng Cá Sấu Cỡ Lớn",80000,80000,0,0
TIKI,do-choi-me-be,94728818,"Ghế ăn dặm cho bé gấp gọn và nâng hạ độ cao Mastela 7110 - 7112 - Ghế tập ăn dặm đạt chuẩn ASTM Mỹ BPA Free",689000,890000,201000,23
TIKI,do-choi-me-be,75529967,"Dây bọt biển bọc cạnh bàn chống va đập, bịt góc bàn, ghế, tường, tủ, giường  Chính hãng",52250,55000,2750,5
TIKI,do-choi-me-be,755371,"Bàn Cờ Tướng Nhỏ Có Cờ Liên Hiệp Thành BTNCC",91000,91000,0,0
TIKI,do-choi-me-be,63169904,"Lều Công Chúa Hoàng Tử S2 Cho Bé Hình Lâu Đài - Hàng chính hãng",249000,249000,0,0
TIKI,do-choi-me-be,74861731,"Bộ 24 Nút Bịt Ổ Cắm Điện Chất Liệu Chống Cháy, Có Khóa An Toàn - KUB",168000,168000,0,0
TIKI,do-choi-me-be,173299847,"Bài Ma Sói Ultimate Deluxe 64 Lá Giá Rẻ Việt Hóa",50000,50000,0,0
TIKI,do-choi-me-be,168806831,"Nước giặt hữu cơ Fuwa3e organic sinh học 100ml giặt quần áo đồ lót, an toàn cho em bé",17000,17000,0,0
TIKI,do-choi-me-be,22474417,"Combo 2 bộ đồ bộ bé gái vải tole, lanh tay dài mềm, mịn, mát size 5-34 kg",96000,96000,0,0
TIKI,do-choi-me-be,41547550,"Xí ngầu uống bia set 10 viên (HAO-XNUB)",52000,52000,0,0
TIKI,do-choi-me-be,193416489,"Balo chống gù cho bé gái đi học cặp sách học sinh tiểu học form hộp vải chống nước bền đẹp 63201",510000,510000,0,0
TIKI,do-choi-me-be,100514714," Kính bơi dễ thương cho bé trai, bé gái",85000,85000,0,0
TIKI,do-choi-me-be,71056048,"Tất vớ cho bé trai 1-12 tuổi Set 5 đôi tất trẻ em cao cổ chống trượt phong cách Hàn cực đẹp",77000,77000,0,0
TIKI,do-choi-me-be,1549545,"Nước Giặt Arau Baby Túi (720ml) ",125000,125000,0,0
TIKI,do-choi-me-be,121231249,"Tấm Thảm Nhung Khăn Trải Bài Tarot Vải Nhung Mẫu Eight Array 50x50 Cm",80000,80000,0,0
TIKI,do-choi-me-be,109775207,"Bờm tóc, xược tóc, kẹp tóc mái hoa Có Kẹp Giữ Tóc Tạo Độ Phồng Cho Bé Gái",19000,19000,0,0
TIKI,do-choi-me-be,73237619,"Ghép Hình - Trực Thăng Cứu Hỏa (252 Chi Tiết) CRESTA DK81027",172500,230000,57500,25
TIKI,do-choi-me-be,79322432,"Thảm Nhạc Nằm Chơi Cho Bé, Nhạc Tiếng Anh, Đèn Và Nhiều Phụ Kiện, Vãi Mềm, Hình Sắc Nét, Mẫu Mới Về",158400,158400,0,0
TIKI,do-choi-me-be,77248791,"Áo khoác lông cho bé gái 1-10t",193750,193750,0,0
TIKI,do-choi-me-be,89241824,"MŨ KÈM KHĂN VOAN CHO BÉ",34000,34000,0,0
TIKI,do-choi-me-be,180847776,"Combo 2 Gói Khăn Ướt Max Cool 25 Tờ Có Hương ( 25 Tờ x 2 )",17800,27400,9600,35
TIKI,do-choi-me-be,6702545,"Nutifood GrowPLUS+ Đỏ 1500 Gr : sữa dành cho trẻ từ 1- 10 tuổi bị suy dinh dưỡng thấp còi",545000,545000,0,0
TIKI,do-choi-me-be,196339522,"Dây Đai Đeo Tay Chống Lạc KUNBE Dài 2.5M Khóa Nam Châm Cảm Ứng An Toàn Cho Bé",139000,139000,0,0
TIKI,do-choi-me-be,68612769,"Giầy đi biển cho trẻ em Water Shoes for Kids",129000,136470,7470,5
TIKI,do-choi-me-be,41178419,"Bộ 5 Lon Sữa Bột NutiFood Diabet Care Gold Lon 900g Cho Người Tiểu Đường, Đái Tháo Đường Và Tiền Đái Tháo Đường",2495000,2495000,0,0
TIKI,do-choi-me-be,107457718,"CỜ TỶ PHÚ + CỜ CÁ NGỰA",90000,90000,0,0
TIKI,do-choi-me-be,436067,"Bình Tập Uống Bằng Ống Hút Kuku Có Tay Cầm KU5452A - 200ml Hồng",177450,195000,17550,9
TIKI,do-choi-me-be,21724541,"SPECIAL KID FER & VITAMINES - Siro Bổ sung sắt và các vitamin C, B2, B9, B12 - Giúp giảm thiếu máu do thiếu sắt - Nhập khẩu Pháp (125ml)",239000,360000,121000,34
TIKI,do-choi-me-be,147413751,"Dây vải khóa tủ chốt an toàn cho trẻ em dây màu trắng",4000,9000,5000,56
TIKI,do-choi-me-be,128787777,"Dây bọt biển bọc cạnh bàn bảo vệ bé - Giao màu ngẫu nhiên - Hàng Chất Lượng",54999,54999,0,0
TIKI,do-choi-me-be,213876215,"Mô hình Búa Mjolnir và StormBreaker của Thor cực đẹp và chắc chắn",289000,289000,0,0
TIKI,do-choi-me-be,4757407,"Đồ Chơi Ô Ăn Quan Chất Liệu Gỗ Tự Nhiên",63999,63999,0,0
TIKI,do-choi-me-be,36978940,"25 món đồ dùng 5 nón và 10 bao tay 10 bao chân bo màu cho bé từ 0-6 tháng tuổi",51000,51000,0,0
TIKI,do-choi-me-be,106230836,"Búp Bê 30cm 23 Khớp Mắt 4D Nhắm Mở Điệu Đà",93000,93000,0,0
TIKI,do-choi-me-be,2173353,"Combo 4 Bịch Khăn Vải Khô Likado (300g)",142000,200000,58000,29
TIKI,do-choi-me-be,62736327,"Đồ Chơi Xếp Hình Thế Giới Thú Cưng 102 Chi Tiết",221000,221000,0,0
TIKI,do-choi-me-be,107889979,"Bình sữa mô phỏng tự nhiên hiệu Philips Avent (60 ml - đơn) cho trẻ từ 0 tháng tuổi SCF039.17",215000,215000,0,0
TIKI,do-choi-me-be,108362580,"Nước xông ngâm rửa phụ phu GSPA - Dứt điểm viêm phụ khoa dai dẳng, giảm đau, nhanh hết sản dịch, tăng co cơ tử cung, rẻ hóa và làm hồng vùng kín",153000,165000,12000,7
TIKI,do-choi-me-be,54008643,"Trống Lục Lạc Baby Rock Star- Màu ngẫu nhiên",73000,148000,75000,51
TIKI,do-choi-me-be,200732636,"Kính Trẻ Em Aoron, Mắt Kính Cho Bé Trai/ Bé Gái Chống Ánh Sáng Xanh, Chống Cận Thị Gọng Dẻo Chống Gãy, Nhiều Màu Độc Đáo - AK074",220000,280000,60000,21
TIKI,do-choi-me-be,36701907,"Combo 2 hộp muối rửa Bát - Ly Somat 1.2kg - Đức",179000,179000,0,0
TIKI,do-choi-me-be,248394823,"Đồ chơi khảo cổ học giáo dục dành cho trẻ em bộ cướp biển, khám phá đại dương và thế giới ma thuật",125000,125000,0,0
TIKI,do-choi-me-be,149124670,"Dép Sục Cho Bé Trai Và Bé Gái Bạch Tuộc Đáng Yêu - Giày Sục Trẻ Em Tặng Kèm 10 Sticker Ngộ Nghĩnh, Siêu Mềm Nhẹ Chống Trơn Trượt Cho Bé",129000,129000,0,0
TIKI,do-choi-me-be,94761783,"SỮA BỘT OPTIMUM GOLD 3 850G (CHO TRẺ TỪ 1 - 2 TUỔI)",385000,385000,0,0
TIKI,do-choi-me-be,193556654,"Đồ Chơi Điện Thoại Có Gặm Nướu - Phát Nhạc - Phát Sáng An Toàn Cho Bé Phát Triển Trí Tuệ",88000,88000,0,0
TIKI,do-choi-me-be,479464,"Đồ Chơi Gỗ Winwintoys - Đàn Mộc Cầm 7 Thanh 63062",149000,149000,0,0
TIKI,do-choi-me-be,56405129,"XỊT DA CHỐNG MUỖI PLASMAKARE 100ml xua đuổi Muỗl, xẹp vết đốt, Viện Sốt rét - KST -Côn trùng TƯ đã chứng nhận hiệu quả",125000,125000,0,0
TIKI,do-choi-me-be,173175571,"Bỉm Dùng Thử BABIES ORGANIC Size S66/M54/M56/L50/XL46 Tinh Chất Lô Hội, Siêu Mỏng, Thấm Hút Nhanh, Thương Hiệu Việt Nam",4750,5000,250,5
TIKI,do-choi-me-be,197694008,"Gối Ôm Cho Bé Sơ Sinh Đa Năng Chữ U Chống Giật Mình Chống Méo Bẹp Đầu Chất Liệu Cao Cấp Siêu Tiện Lợi",159000,159000,0,0
TIKI,do-choi-me-be,273042837,"[MUA 3 TẶNG 1] Combo 3 bịch khăn ướt 100 Sunbaby SBB2020",24800,31000,6200,20
TIKI,do-choi-me-be,53648146,"COMBO 5 ÁO LÁ DÀI DÀNH CHO HỌC SINH",81000,90000,9000,10
TIKI,do-choi-me-be,84080008,"Ghế Lưới Tắm Dành Cho Bé Sơ Sinh Loại 1 Kèm Gối / Kệ Tắm",69999,69999,0,0
TIKI,do-choi-me-be,183032037,"Đồ Bơi Bé Trai Bé Gái Họa Tiết Cá Mập Shark BB037 MayBlue Thun Lạnh Co Giãn Và Không Phai Màu",190650,205000,14350,7
TIKI,do-choi-me-be,29190039,"COMBO 6 bảng ghép hình núm gỗ(Trái cây, Rau củ, Chữ, Số, Thú rừng, Thú biển)",188000,188000,0,0
TIKI,do-choi-me-be,9999303,"Xe Jeep cảnh sát tuần tra hộ tống đồ chơi - Polesie Toys",239000,239000,0,0
TIKI,do-choi-me-be,91743932,"Mũ len tai bèo cho bé",39990,39990,0,0
TIKI,do-choi-me-be,15356110,"Thùng 48 Hộp Sữa Bột Pha Sẵn Vinamilk Optimum Gold 180ml",710000,710000,0,0
TIKI,do-choi-me-be,198895998,"Bộ dài tay thu đông cho bé Easy Baby, đồ ngủ cho bé trai, bé gái chất vải cotton từ 7-17kg (ASS-322)",75000,125000,50000,40
TIKI,do-choi-me-be,115245999,"Set 2 núm ti cho bình PUR Advanced (size L) (1813)",85000,85000,0,0
TIKI,thiet-bi-kts-phu-kien-so,173058453,"Chuột không dây bluetooth Logitech POP MOUSE - giảm ồn, nút emoji tùy chỉnh - Hàng chính hãng",529000,899000,370000,41
TIKI,thiet-bi-kts-phu-kien-so,191817608,"Bộ Bàn Phím Chuột không dây W201 nhỏ gọn",218500,230000,11500,5
TIKI,thiet-bi-kts-phu-kien-so,116125939,"Dán màn hình dành cho iPad Paper-like Kai Cao Cấp chống vân tay cho cảm giác vẽ như trên giấy",145000,145000,0,0
TIKI,thiet-bi-kts-phu-kien-so,270767050,"[Mới 100%] Sim VIETNAMOBILE Chuyên Dùng Để Nghe Gọi & Tạo Tài Khoản TMĐT, Laz, Sope, Sen, Face, ZaL0, Momo, Tw, Tele, Game... TK 0đ Giá Rẻ - Cam Kết Chưa Từng Đăng Ký Dịch Vụ Gì. Hàng Chính Hãng",55900,110000,54100,49
TIKI,thiet-bi-kts-phu-kien-so,111748361,"Lót chuột phím tắt văn phòng đã Việt hóa khổ lớn cực tiện dụng - Hàng chính hãng",55000,55000,0,0
TIKI,thiet-bi-kts-phu-kien-so,52602232,"Combo Sạc cáp nhanh 25w Type C dùng cho SS Note10 / S10plus 5G / A80, OPPO, VIVO, HUAWEI",110000,110000,0,0
TIKI,thiet-bi-kts-phu-kien-so,51059393,"Tai Nghe Dây Cho Các Dòng Sản Phẩm Phân Khúc Galaxy J Của Samsung",27900,27900,0,0
TIKI,thiet-bi-kts-phu-kien-so,126998612,"Loa Bluetooth JBL Charge 5 - Hàng Chính Hãng",3790000,3990000,200000,5
TIKI,thiet-bi-kts-phu-kien-so,13781962,"Bút trình chiếu Lazer- Bút thuyết trình- Bút trình chiếu silde- Bút điều khiển trình chiếu- Bút trình chiếu powerpoint",93000,93000,0,0
TIKI,thiet-bi-kts-phu-kien-so,86018342,"Kính Cường Lực KingKong 9D Trong Suốt Dành Cho iPhone - Full Hộp Sắt Cao Cấp - Dán Full Màn - Hàng Chính Hãng",105991,211982,105991,50
TIKI,thiet-bi-kts-phu-kien-so,122949142,"Tai nghe Bluetooth True Wireless Samsung Galaxy Buds 2 - Hàng Chính Hãng",1590000,2990000,1400000,47
TIKI,thiet-bi-kts-phu-kien-so,55210024,"Giá Đỡ Dành Cho Laptop Macbook Để Bàn Chất Liệu Hợp Kim Nhôm Cao Cấp Hàng Nhập Khẩu Helios",219000,400000,181000,45
TIKI,thiet-bi-kts-phu-kien-so,158848954,"Chuột không dây Wireless Bluetooth sạc pin SIDOTECH PM1 không cần thay pin, sạc 1 lần dùng 30 ngày thiết kế công thái học không mỏi tay, silent chống ồn ban đêm tương thích Laptop Macbook Máy tính bảng PC- Hàng Chính Hãng",182000,182000,0,0
TIKI,thiet-bi-kts-phu-kien-so,158868825,"[FREE 6 Tháng - Đầu Số 092] SIM MAX DATA 4G VIETNAMOBILE - 6GB/Ngày. Trọn Gói 6 Tháng Không Cần Nạp Tiền - Hàng Chính Hãng",268000,350000,82000,23
TIKI,thiet-bi-kts-phu-kien-so,72725402,"Combo chuột phím không dây Logitech MK295 Silent - Chống ồn 90%, có phím số, mắt đọc cải tiến, bền bỉ, không lag - Hàng chính hãng",694000,694000,0,0
TIKI,thiet-bi-kts-phu-kien-so,7734288,"SIM 4G Mobifone MDT250A Trọn Gói 1 Năm Không Cần Nạp Tiền - Hàng chính hãng - Mẫu ngẫu nhiên",299000,299000,0,0
TIKI,thiet-bi-kts-phu-kien-so,115847303,"Giá Đỡ Để Bàn Điện Thoại Di Động, Máy Tính Bảng. Chất Liệu Hợp Kim Nhôm Cao Cấp. Xoay 270 Độ Tự Do Điều Chỉnh Góc Nhìn Model Z4. Hàng Chính Hãng Tamayoko",120000,149000,29000,19
TIKI,thiet-bi-kts-phu-kien-so,195998782,"Cáp sạc và truyền dữ liệu 2.4A Remax RC-138a USB to TypeC  - Hàng chính hãng",59000,99000,40000,40
TIKI,thiet-bi-kts-phu-kien-so,95681232,"Adapter Sạc Anker 1 cổng 65W Hỗ Trợ Sạc Nhanh PIQ 3.0 PowerPort III Pod Lite - A2718 - Hàng chính hãng",594000,750000,156000,21
TIKI,thiet-bi-kts-phu-kien-so,97034068,"Tai Nghe Nhét Tai XSmart HiFi S2000 Pro Super Bass Chống Ồn Cực Tốt, Âm Thanh Khủng, Chơi Game Ngon - Hàng Chính Hãng",69000,69000,0,0
TIKI,thiet-bi-kts-phu-kien-so,3416201,"Bảng Vẽ Wacom Intuos S CTL-4100 - Hàng Chính Hãng",2147000,2147000,0,0
TIKI,thiet-bi-kts-phu-kien-so,173034520,"Combo chuột phím không dây Logitech MK345 - 1 đầu thu USB, pin lâu, chống tràn, fullsize - Hàng chính hãng",565000,749000,184000,25
TIKI,thiet-bi-kts-phu-kien-so,96595575,"Cáp USB nối dài 1.5M 3M 5M CHỐNG NHIỄU",12000,12000,0,0
TIKI,thiet-bi-kts-phu-kien-so,150205187,"Que Chọc Sim",1490,1490,0,0
TIKI,thiet-bi-kts-phu-kien-so,68467585,"Đồng Hồ Thông Minh Trẻ Em ngôn ngữ Tiếng Việt, Pin sử dụng được 2 ngày, dây đeo có Hoa văn hình Trái tim Dễ thương Model Y85 Pro - Hàng nhập khẩu",490000,490000,0,0
TIKI,thiet-bi-kts-phu-kien-so,356188,"Chuột Có Dây Logitech B100 - Hàng Chính Hãng",89000,89000,0,0
TIKI,thiet-bi-kts-phu-kien-so,71291990,"Giá Đỡ Laptop Nhôm Gấp Gọn, Laptop Stand Dùng Cho Máy Từ 11~17 inch, Có Thể Điều Chỉnh Nhiều Mức Độ Cao, Chất Liệu Hợp Kim Nhôm Cao Cấp",65000,65000,0,0
TIKI,thiet-bi-kts-phu-kien-so,115105801,"Thiết Bị Đọc Thẻ Nhớ ROBOT CR202 - 2 Đầu Type-C Và USB 3.0, Khe Cắm Thẻ Nhớ SD/Micro SD - Hàng Chính Hãng",220000,220000,0,0
TIKI,thiet-bi-kts-phu-kien-so,54616399,"Giá đỡ điện thoại để bàn gấp Điện thoại di động Giá đỡ bàn cho iPhone ipad pro mini Samsung Xiaomi Tablet Đứng tăng và giảm Giá đỡ có thể điều chỉnh",13007,13007,0,0
TIKI,thiet-bi-kts-phu-kien-so,1457747,"Thẻ Nhớ Micro SDXC SanDisk UHS-1 64GB Class 10 - Hàng Chính Hãng",173000,173000,0,0
TIKI,thiet-bi-kts-phu-kien-so,4539349,"Bộ Vệ Sinh Laptop ",19000,19000,0,0
TIKI,thiet-bi-kts-phu-kien-so,183119284,"Case Silicon dành cho Airpods 1,2/ Airpods Pro/ Airpods 3 Hình Chó Cori_ Hàng Chính Hãng",85000,85000,0,0
TIKI,thiet-bi-kts-phu-kien-so,148824604,"Bộ thu phát Bluetooth, thiết bị hỗ trợ thu phát nhạc không dây Nano USB 5.0 Bluetooth dành cho Laptop, Máy tính để bàn, Tivi",30000,39000,9000,23
TIKI,thiet-bi-kts-phu-kien-so,73261935,"Giá Đỡ Để Bàn Điện Thoại Di Động, Máy Tính Bảng, Ipad Mini. Chất Liệu Hợp Kim Nhôm Cao Cấp. Hàng Chính Hãng Tamayoko",119200,149000,29800,20
TIKI,thiet-bi-kts-phu-kien-so,148813604,"Chuột không dây Logitech M331 SILENT-Hàng chính hãng",397000,397000,0,0
TIKI,thiet-bi-kts-phu-kien-so,135412837,"Đế Sạc Nhanh Không Dây Đa Năng 3in1 Remax RP-W53 - Hỗ Trợ Sạc Nhanh Lên Đến 15W - Hàng Chính Hãng",550000,550000,0,0
TIKI,thiet-bi-kts-phu-kien-so,135716055,"Ốp da cao cấp dành cho iPhone 13 / 13 Pro / 13 Pro Max / 13 Mini - Hàng chính hãng",149000,250000,101000,40
TIKI,thiet-bi-kts-phu-kien-so,175104946,"Thẻ Nhớ Micro SDXC Samsung Evo Plus U3 130MB/s 256GB New - Hàng Nhập Khẩu",480000,480000,0,0
TIKI,thiet-bi-kts-phu-kien-so,22633043,"Dây 2 Đầu HDMi 5M UNITEK - Cáp HDMI 5M UNITEK Full HD 4K - Hàng Nhập Khẩu",155000,155000,0,0
TIKI,thiet-bi-kts-phu-kien-so,195977274,"Bàn phím cơ gaming 5TECH Led RGB 10 chế độ nháy cực đẹp, chơi game gõ siêu đã, thiết kế nhỏ gọn dùng cho máy tính, laptop hàng chính hãng",449000,449000,0,0
TIKI,thiet-bi-kts-phu-kien-so,190824210,"Giá Đỡ Máy Tính, Laptop, Hợp Kim Nhôm Cao Cấp. Hỗ Trợ Tản Nhiệt Chống Mỏi Cổ, Vai, Gáy",147760,184700,36940,20
TIKI,thiet-bi-kts-phu-kien-so,105829753,"(Tặng túi đựng TOPK) Củ sạc nhanh Baseus mini 20W, hai cổng sạc USB và Type-C sạc nhanh cho iPhone, Samsung, Xiaomi, Huawei,...-Hàng chính hãng",175000,189000,14000,7
TIKI,thiet-bi-kts-phu-kien-so,152011359,"Bao Da Case Cover Dành Cho iPad Full Dòng Mini 1/2/3/4/5/6 - Air 1/2/3/4 - Gen 5/6/7/8/9 - Pro 11 Inch 2018/2020 - Pro 12.9 Inch",136800,159494,22694,14
TIKI,thiet-bi-kts-phu-kien-so,195781100,"Chuột không dây Gaming E-Dra EM6102w - Hàng chính hãng",179000,179000,0,0
TIKI,thiet-bi-kts-phu-kien-so,196946349,"Ốp Lưng dành cho iPhone 14 / 14 Plus / 14 Pro / 14 ProMax Nillkin S.Frosted Shield Pro- Hàng chính hãng",189050,199000,9950,5
TIKI,thiet-bi-kts-phu-kien-so,1570185,"Bảng Vẽ Wacom Intuos Pro Medium PTH-660",8890000,8890000,0,0
TIKI,thiet-bi-kts-phu-kien-so,73837518,"Tai Nghe Không Dây True Wireless Nhét Tai – Hàng Chính Hãng",248000,500000,252000,50
TIKI,thiet-bi-kts-phu-kien-so,109983015,"Cáp sạc iPhone Baseus Superior Series Fast Charging Data Cable (2.4A, 480Mbps, Fast charge, ABS/ TPE Cable) -  Hàng Chính Hãng ",79899,79899,0,0
TIKI,thiet-bi-kts-phu-kien-so,197387432,"Ốp Lưng MIPOW SOFT TPU CRYSTAL CLEAR Nguyên Liệu Đức (DROPTEST 1.8M, Chống Ố Vàng) dành cho iPhone 14 / iPhone 14 Plus/ iPhone 14 Pro/ iPhone 14 ProMax- Hàng chính hãng",228000,240000,12000,5
TIKI,thiet-bi-kts-phu-kien-so,16262699,"Bút Trình Chiếu laser PP-927",150000,175000,25000,14
TIKI,thiet-bi-kts-phu-kien-so,25775437,"Bao Da Cover Cho Máy Tính Bảng Huawei MediaPad T3 10 (2017) Hỗ Trợ Smart Cover",129000,129000,0,0
TIKI,thiet-bi-kts-phu-kien-so,197620972,"Ốp lưng Trong Suốt dành cho Samsung Galaxy Z Fold 4 Chống Sốc, Chống Ố - Hàng chính hãng",96999,96999,0,0
TIKI,thiet-bi-kts-phu-kien-so,17038778,"Cáp Chuyển Đổi Từ USB-C Sang USB 3.0/HDMI-Type C",91000,99000,8000,8
TIKI,thiet-bi-kts-phu-kien-so,11886645,"Đế Tản Nhiệt Laptop N66 (2 quạt chạy cực êm)",118400,118400,0,0
TIKI,thiet-bi-kts-phu-kien-so,32208871,"Hub Chia Cổng USB Thành 4 Cổng Cao Cấp AZONE",28600,28600,0,0
TIKI,thiet-bi-kts-phu-kien-so,57511280,"Giá đỡ cho điện thoại máy tính bảng lắp sau ghế dùng cho ô tô xe hơi(xoay 360 độ, tiện dụng, phù hợp nhiều dòng xe)",143928,199900,55972,28
TIKI,thiet-bi-kts-phu-kien-so,197653378,"Ốp lưng Trong Suốt dành cho Samsung Galaxy Z Flip 4 Chống Sốc, Chống Ố Vàng - Hàng chính hãng",109000,118999,9999,8
TIKI,thiet-bi-kts-phu-kien-so,107212953,"Giá Đỡ Máy Tính Bảng Ipad Stand 201 Đa Năng Điều Chỉnh Độ Cao Dành Cho Điện Thoại, Ipad",286598,530000,243402,46
TIKI,thiet-bi-kts-phu-kien-so,190703469,"Túi chống sốc 2 ngăn vải chống thấm đựng ổ cứng di động size 2.5inch, máy chụp hình du lịch, phụ kiện cáp sạc - Hàng chính hãng",54000,54000,0,0
TIKI,thiet-bi-kts-phu-kien-so,101843905," Giá Đỡ Điện Thoại livestream xem video Ổn Định Xoay 360 Độ dùng để Quay Phim Ghi Hình Đa Dụng",21999,21999,0,0
TIKI,thiet-bi-kts-phu-kien-so,53631890,"Miếng lót chuột, Pad chuột 90x40 cm Siêu rộng - Hàng chính hãng",68000,68000,0,0
TIKI,do-choi-me-be,51116839,"Bình Uống Nước Cho Bé Bằng Nhựa PP KuKu KU5485",211650,249000,37350,15
TIKI,thiet-bi-kts-phu-kien-so,123779650,"Cáp chuyển đổi HDMI To DVI 1.5m bọc lưới siêu bền",41900,41900,0,0
TIKI,do-choi-me-be,56437318,"Bộ tranh xếp hình cao cấp 330 mảnh ghép – Giai Nhân Và Quái Vật",78000,100000,22000,22
TIKI,do-choi-me-be,103265678,"Đồ chơi bảng chữ số xếp hình gỗ trí tuệ thông minh 5 trong 1 dành cho bé học chữ số đếm kèm câu cá hình khối",98500,98500,0,0
TIKI,do-choi-me-be,57211159,"Lắp Ghép Mô Hình Đường Ray Xe Ô Tô",80000,80000,0,0
TIKI,thiet-bi-kts-phu-kien-so,63536208,"Túi chống nước điện thoại đi biển, bao đựng điện thoại chống nước cao cấp 4 lớp, đạt chuẩn chất lượng GoodFit GF202WP - Hàng chính hãng",79000,120000,41000,34
TIKI,do-choi-me-be,59491835,"Set 5 áo sơ sinh cotton Tay Ngắn cài Xéo Họa Tiết JOU-Tomtom Baby cho bé trai, bé gái",163000,163000,0,0
TIKI,do-choi-me-be,263396342,"Lều Xông Hơi Cao Cấp Mộc Miên ( Nhiều Màu Lựa Chọn)",499000,499000,0,0
TIKI,do-choi-me-be,120472035,"Tranh Ghép Hình 1000 Mảnh Gỗ Kích Thước Lớn 75x50cm/Tranh Ghép Hình Jigsaw Puzzle/Tranh Ghép Hình Đa Dạng Mẫu/Tranh Ghép Phát Triển Tư Duy",289000,289000,0,0
TIKI,do-choi-me-be,205293724,"Muối rửa chén Finish Dishwasher Salt 1,5kg PTT017383",107000,107000,0,0
TIKI,thiet-bi-kts-phu-kien-so,120462495,"Loa vi tính 2.0 để bàn Leerfei E-350T Công Suất Lớn Dùng Cho Máy Vi Tính PC, Laptop, Tivi",85000,85000,0,0
TIKI,do-choi-me-be,101078515,"Set 10 dây buộc tóc, thun cột tóc cho bé gái hình con vật hoa quả sắc màu tươi sáng SC26",42000,42000,0,0
TIKI,do-choi-me-be,148841024,"Mũ nón len cột dây màu trơn phong cách hàn quốc đáng yêu cho bé Mimo Baby ML60",158000,158000,0,0
TIKI,do-choi-me-be,90846783,"5 Quần lót  Cotton bé gái - quần sịp trẻ em",125000,125000,0,0
TIKI,do-choi-me-be,72799097,"Trợ Phễu Silicone Mama's Choice NewFit, Đệm Hạ Size Phễu Size 15-17-19-21mm, Hút Sữa Hiệu Quả và Êm Ái - 2 Cái GIÁ TỐT",180000,270000,90000,33
TIKI,do-choi-me-be,124273393,"Miếng Xốp Chặn Cửa Hình Thú An Toàn Cho Bé",5700,6000,300,5
TIKI,do-choi-me-be,77756316,"Nồi xông hơi 3.0 lít dùng cho lều xông hơi, thùng xông đầu, phòng xông hơi",408000,408000,0,0
TIKI,thiet-bi-kts-phu-kien-so,184297059,"Bao da dành cho SamSung Galaxy Tab A7 Lite T225/T220 chính hãng Onjess lưng silicone mềm - Hàng chính hãng",222000,222000,0,0
TIKI,do-choi-me-be,80367850,"Đồ chơi lắp ráp, xếp hình Qman 32012: Căn phòng công chúa - 282 mảnh ghép",179000,199000,20000,10
TIKI,thiet-bi-kts-phu-kien-so,186199392,"Loa bluetooth 5TECH BS2 hàng chính hãng, loa mini cầm tay di động nghe nhạc cực hay hỗ trợ cắm thẻ nhớ, USB dành cho điện thoại, máy tính...",399000,399000,0,0
TIKI,thiet-bi-kts-phu-kien-so,195305683,"Adapter Sạc ANKER PowerPort III Nano 20W Phiên Bản Marvel Giới Hạn - A2633 - Hàng Chính Hãng",400000,480000,80000,17
TIKI,do-choi-me-be,91883013,"Đồ Bộ Thun Lạnh Có Tay In 3D cho bé trai hình Những Chú Chó Cứu Hộ Paw Patrol",139000,240000,101000,42
TIKI,do-choi-me-be,148670951,"Trò chơi toán học 4 màu có đồng hồ - Four color game",125000,125000,0,0
TIKI,thiet-bi-kts-phu-kien-so,144534656,"Loa Thanh LG 2.1ch SP2 (100W) - Hàng chính hãng",1099000,1099000,0,0
TIKI,do-choi-me-be,26020327,"Gối Ôm Chữ U Cho Bà Bầu Ngủ Ngon, Đỡ Chuột Rút, Tê Chân - Họa tiết ngẫu nhiên",147997,147997,0,0
TIKI,do-choi-me-be,8001205,"Combo Set 2 viên thả bồn cầu hương lavender nội địa Nhật Bản",62000,62000,0,0
TIKI,thiet-bi-kts-phu-kien-so,58393093,"Loa Bluetooth 60W công suất lớn Super Bass chống nước IPX5 pin 6600MAH sạc nhanh Type C công nghệ AI Hàng Chính Hãng PKCB",1250000,2500000,1250000,50
TIKI,thiet-bi-kts-phu-kien-so,151521113,"Bút Trình Chiếu Nhỏ Gọn RAPOO XR200 - Hàng Chính Hãng",449000,449000,0,0
TIKI,thiet-bi-kts-phu-kien-so,25248696,"Combo Bộ Vệ Sinh 4 Món + Tặng Kèm Hút Bụi Mini Cho Bàn Phím",29000,29000,0,0
TIKI,do-choi-me-be,74616401,"TPBVSK Special Kid Vision - Siro tăng cường thị lực, cơ chế bảo vệ mắt 3 lớp, hỗ trợ ngăn ngừa ánh sáng xanh (125ml) [Nhập khẩu Pháp]",239000,360000,121000,34
TIKI,do-choi-me-be,2610755,"Hộp 2 gói bột tẩy cặn canxi cây nước, ấm đun nước, bình nóng lạnh Hando",29000,29000,0,0
TIKI,do-choi-me-be,14236820,"Cốc đựng hộp sữa tươi chống bóp cho bé quai cầm cho bé (màu hồng) - Hàng Nội Địa Nhật",42000,42000,0,0
TIKI,do-choi-me-be,38063927,"YÊN ( THAY THẾ )  XE TẬP ĐI CHO BÉ",90000,90000,0,0
TIKI,do-choi-me-be,157833253,"Combo 2 Túi ngũ cốc Navan ",409000,409000,0,0
TIKI,do-choi-me-be,48324723,"FITOBIMBI OMEGA JUNIOR – SIRO THẢO DƯỢC CHUẨN HÓA CHÂU ÂU HỖ TRỢ PHÁT TRIỂN NÃO BỘ VÀ THỊ GIÁC CHO TRẺ (30ML)",390000,390000,0,0
TIKI,do-choi-me-be,178461150,"Đồng Hồ Trẻ Em HD02",75000,75000,0,0
TIKI,thiet-bi-kts-phu-kien-so,70524690,"Giá Đỡ Máy Tính Laptop Macbook Hợp Kim Nhôm Cao Cấp Giúp Tản Nhiệt Có Thể Tháo Rời Hàng Chính Hãng Tamayoko",390000,600000,210000,35
TIKI,do-choi-me-be,55348883,"Đồ Chơi Bé Gái Xe bán kém lưu động Bằng nhựa ABS an toàn",200000,200000,0,0
TIKI,thiet-bi-kts-phu-kien-so,113835505,"Giá Đỡ Máy Tính Bảng, Ipad, Điện Thoại - Chất Liệu Hợp Kim Nhôm Cao Cấp - Hàng Chính Hãng Tamayoko",390000,450000,60000,13
TIKI,thiet-bi-kts-phu-kien-so,105144403,"Ốp lưng chống sốc toàn phần dành cho iPhone 12 Mini / 12 / 12 pro / 12 Pro Max - Hàng chính hãng",9000,18000,9000,50
TIKI,thiet-bi-kts-phu-kien-so,68823687,"Giá Đỡ Để Bàn Máy Tính Bảng Ipad Điện Thoại (Lớn) Hợp Kim Nhôm Cao Cấp - Điều Chỉnh Góc Độ - Trục Kép- Gấp Lại Tiện Lợi Hàng Chính Hãng",388000,399000,11000,3
TIKI,do-choi-me-be,94727540,"Yếm ăn dặm silicon có máng, chống rơi vãi, chống bám bẩn và dễ dàng điều chỉnh kích cỡ cho bé Royalcare TH601",55000,90000,35000,39
TIKI,do-choi-me-be,72597497,"Nước rửa chén hữu cơ Bồ hòn Ecocare - 100% thực vật, không hóa chất, tinh dầu khử mùi, chăm sóc da tay, tiết kiệm nước 30% - Chai 4000ml",394000,394000,0,0
TIKI,do-choi-me-be,116048235,"ÁO LÓT LÁ HỌC SINH COTTON KHÔNG ĐỆM MÚT THOÁNG MÁT KHÔNG KÍCH ỨNG DA CỦA BÉ",17000,17000,0,0
TIKI,do-choi-me-be,99247197,"Bộ tranh xếp hình cao cấp 500 mảnh ghép – Hoa Lily",115000,150000,35000,23
TIKI,thiet-bi-kts-phu-kien-so,54485907,"Giá Đỡ Để Bàn Điện Thoại Di Động, Máy Tính Bảng, Ipad Hợp Kim Nhôm Hàng Chính Hãng Helios",29000,29000,0,0
TIKI,do-choi-me-be,140333881,"Đồ Chơi Ô Ăn Quan, Trò Chơi Dân Gian Mẫu Mới Vân Gỗ Thuần Mộc Họa Tiết Lộc Thọ Ngộ Nghĩnh",229000,287000,58000,20
TIKI,do-choi-me-be,86406630,"Đồ chơi nhạc cụ- Đàn gõ Xylophone hình cú mèo đáng yêu Toyshouse C601 - Dụng cụ phát triển năng khiếu âm nhạc dành cho bé yêu",59000,72000,13000,18
TIKI,thiet-bi-kts-phu-kien-so,150937588,"Cáp Sạc Nhanh 20W Dành Cho iPhone Remax RC-171, Chuẩn TypeC to IP,  Sử Dụng Chip E-marker, Chống Sạc Quá Tải, Chống Gãy Cáp - Hàng Chính Hãng",120000,139000,19000,14
TIKI,thiet-bi-kts-phu-kien-so,15665489,"Dây Cáp Sạc Li.ght.ning Chuẩn M.F.i Cho i.Phone Anker Li.ght.ning PowerLine Select+ A8012 0.9m / A8013 1.8m - Hàng Chính Hãng",340000,360000,20000,6
TIKI,do-choi-me-be,86305279,"Bộ chăm sóc mẹ đẹp như tiên, giúp da mặt sáng khỏe và trắng hồng mịn màng Wonmom (1 sữa rửa mặt hữu cơ+ 1 kem nghệ tươi)",440000,505000,65000,13
TIKI,do-choi-me-be,196832223,"Thẻ học rèn luyện trí nhớ cho bé Memo HiPP - Nhập khẩu Đức",100000,100000,0,0
TIKI,do-choi-me-be,21174803,"Tẩy dầu mỡ két lâu năm trên thiết bị bếp chai Sabo-M 500ml không mùi ",109000,149000,40000,27
TIKI,thiet-bi-kts-phu-kien-so,72793524,"Giá đỡ laptop tuỳ chỉnh góc nghiêng để phù hợp góc nhìn của bạn chất liệu hợp kim nhôm, hỗ trợ tản nhiệt tốt cho máy tính laptop, macbook và máy tính bảng",63700,63700,0,0
TIKI,thiet-bi-kts-phu-kien-so,103660293,"Dây sạc type A To C PROLiNK GCA_40_01 dài 1M, sạc siêu nhanh 40W, dành cho iPad, Samsung, Huawei, Xiaomi - Hàng chính hãng",75000,110000,35000,32
TIKI,do-choi-me-be,152528795,"Ghép Hình 4 Mùa - Mùa Xuân 24 Chi Tiết DK81074",95200,136000,40800,30
TIKI,do-choi-me-be,180499694,"Quần chip bé trai combo 4  chất mát co giãn siêu đẹp từ 9- 43kg",105000,105000,0,0
TIKI,do-choi-me-be,43076793,"Bộ tranh xếp hình 330 mảnh – Cậu Bé Rừng Xanh (30x44cm)",78000,100000,22000,22
TIKI,do-choi-me-be,54014700,"Trống Thả Hình Đa Năng Happy Baby",62000,125000,63000,50
TIKI,do-choi-me-be,53308234,"Combo 6 Gói Khăn Ướt AGI Không Mùi Gấu Nâu (100 tờ x 6 gói)",222000,222000,0,0
TIKI,do-choi-me-be,2118851,"Set 640 tờ giấy ướt Moony nội địa Nhật Bản",345000,345000,0,0
TIKI,do-choi-me-be,118123800,"Đồ chơi sơ sinh an toàn - Cuốn sách vải tương tác với bé chủ đề:"Một ngày vui vẻ của tôi"-My happy day-Hàng xuất khẩu",144500,144500,0,0
TIKI,do-choi-me-be,53547869,"Combo Muối rửa bát finish 1.5kg+Nước làm bóng finish 750ml dùng cho Máy rửa bát",219999,219999,0,0
TIKI,do-choi-me-be,75424785,"Quần chip đùi cotton hình cô bé nhiều màu sắc cho bé gái 2-12 tuổi - C005",14000,20000,6000,30
TIKI,do-choi-me-be,21380743,"Bộ 8 Miếng Bọt Biển Bịt Góc Bàn Bảo Vệ Trẻ",28000,28000,0,0
TIKI,do-choi-me-be,40632464,"SỮA HOÀNG GIA ÚC PREGNANT MOTHER FORMULA - DÀNH CHO PHỤ NỮ MANG THAI",594000,660000,66000,10
TIKI,do-choi-me-be,46470963,"Đồ bơi bé trai liền thân bao gồm nón size cho bé từ 9kg đến 27kg",209540,209540,0,0
TIKI,do-choi-me-be,40750355,"Bộ 5 Túi Sữa Bột Nguyên Kem Nutifood (400g)",390000,390000,0,0
TIKI,do-choi-me-be,10091498,"Combo 03 chai Nước Tẩy Đa Năng Mao Bao 600ml",120000,150000,30000,20
TIKI,do-choi-me-be,124509259,"Đồ chơi lắp ráp Poli Robot biến hình cho bé 2 in 1",35000,35000,0,0
TIKI,do-choi-me-be,95035802,"Sữa bột công thức HiPP 3 Organic Combiotic 800g",720000,720000,0,0
TIKI,do-choi-me-be,421291,"Đồ Chơi Lắp Ráp LEGO Thùng Gạch Trung Classic Sáng Tạo 10696 Cho Bé Trên 1 Tuổi (484 chi tiết)",1269000,1269000,0,0
TIKI,do-choi-me-be,115483202,"Sữa bột Enfagrow A+ NeuroPro 4 với 2’-FL HMO cho trẻ từ 2 – 6 tuổi – 830g",470000,490000,20000,4
TIKI,do-choi-me-be,94727097,"Đồ chơi nấu ăn cho bé/ bộ nhà bếp nấu nướng có vòi nước và bảng vẽ Toyshouse  889-169: đồ chơi hướng nghiệp cho bé",399000,490000,91000,19
TIKI,do-choi-me-be,63525556,"TẢ QUẦN CARYN L28 (28 MIẾNG)",345000,345000,0,0
TIKI,do-choi-me-be,154702807,"Thanh chắn cửa, chắn cầu thang chính hãng Mastela D04 bảo vệ an toàn cho bé, Không cần khoan tường, có thể thanh mở rộng",985000,985000,0,0
TIKI,do-choi-me-be,116572135,"Combo 2 lon sữa bột dinh dưỡng công thức HiPP 3 Organic Combiotic chất lượng hữu cơ, tăng cường sức khoẻ hệ miễn dịch, bổ sung Canxi và vitamin D dành cho trẻ trên 12 tháng tuổi (2 lon x 800g)",1440000,1440000,0,0
TIKI,do-choi-me-be,121376981,"Gel Diệt Gián Blattanex Chính Hãng",192000,192000,0,0
TIKI,do-choi-me-be,19944398,"Tã Quần Moony Natural Bông Organic M46 (46 Miếng)",280000,280000,0,0
TIKI,do-choi-me-be,55792037,"COMBO 3 bộ Quần áo Tole Lanh Bé Trai | Mẫu đùi Tay Ngắn cài 2 nút trước | Size 1-16 cho bé 5-55kg | Hàng Việt Nam chất lượng",117000,117000,0,0
TIKI,do-choi-me-be,4819361,"Sữa bột Nutricare Glucare Gold dinh dưỡng cho người tiểu đường (900g)",410000,410000,0,0
TIKI,do-choi-me-be,114445481,"Sữa Bột Namyang Imperial Kid XO GT 800g",619000,619000,0,0
TIKI,do-choi-me-be,88240500,"Ghế gội đầu cho bé có tay vịn",108000,108000,0,0
TIKI,do-choi-me-be,6464037,"Cháo Tươi Thịt Bò Cà Rốt Cây Thị",19800,23000,3200,14
TIKI,do-choi-me-be,181512506,"Nón tập đi cho bé. Mũ bảo vệ đầu cho bé tập đi. Nón bảo vệ đầu cho bé, tập đi và tập ngồi. Mũ bảo hiểm an toàn cho bé tập ngồi, tập bò, tự chơi",139000,139000,0,0
TIKI,do-choi-me-be,77154216,"Vitamin bầu Elevit chính hãng Úc mẫu mới",1073500,1130000,56500,5
TIKI,do-choi-me-be,112194231,"Thùng sữa nước Nutricare Smarta Grow dinh dưỡng cho trẻ thấp còi (110ml)",335000,335000,0,0
TIKI,do-choi-me-be,160402509,"Kẹp tóc cho bé, Kẹp tóc mini càng cua nhiều màu sắc đáng yêu (10psc) – SP153",19000,25000,6000,24
TIKI,do-choi-me-be,127052671,"Smartbibi ZINC siro bổ sung Kẽm và Vitamin C hỗ trợ tăng đề kháng cải thiện tình trạng biếng ăn, chậm lớn ở trẻ nhỏ 30ml",275000,275000,0,0
TIKI,do-choi-me-be,2983649,"Sữa Bột Namyang Imperial Dream XO 4 GT 800g",619000,619000,0,0
TIKI,do-choi-me-be,99845987,"Đồ chơi mô hình xe tăng  KAVY NO.8807 chất liệu nhựa an toàn tỷ lệ 1:32 so với phiên bản thực - màu xanh",67000,67000,0,0
TIKI,do-choi-me-be,22376486,"Bộ cờ vua nam châm (Quân cờ màu vàng và bạc)",76500,85000,8500,10
TIKI,do-choi-me-be,145613741,"Combo 3 Nước Rửa Chén Bát Sunlight Extra Thiên Nhiên Muối Khoáng Và Lô Hội 2.1kgx3",205000,205000,0,0
TIKI,do-choi-me-be,23442496,"Combo 5 đôi tất bảo vệ đầu gối cho bé tập bò (Màu ngẫu nhiên)",74099,77999,3900,5
TIKI,do-choi-me-be,68909222,"Combo Đủ Vị Cháo Tươi Dinh Dưỡng Cây Thị",244905,292500,47595,16
TIKI,do-choi-me-be,104153016,"Bình sữa cổ hẹp PP vuông Pigeon 120ml/240ml",84000,120000,36000,30
TIKI,do-choi-me-be,89221865,"Hai lốc giấy lụa Japani Silk10 ba lớp - 10 cuộn / lốc",125000,174000,49000,28
TIKI,do-choi-me-be,11253530,"Túi Đựng Sữa Mẹ (Trữ Sữa Mẹ) Unimom Compact Không Có BPA UM870268 210ml (60 Túi/Hộp)",125000,125000,0,0
TIKI,do-choi-me-be,33471484,"Tấm lót chống thấm cỡ lớn (Size 120 x 80 cm) thoáng khí, tiện lợi, an toàn cho bé (Giao màu ngẫu nhiên)",92000,112800,20800,18
TIKI,thiet-bi-kts-phu-kien-so,110153980,"Cáp sạc Baseus PD20W Baseus High Density kết nối Type-C sang iPhone dài 100CM ( 3 màu ) - Hàng chính hãng",105450,111000,5550,5
TIKI,thiet-bi-kts-phu-kien-so,16217285,"Đầu Đọc Thẻ Nhớ xoay Đa Năng 4in1 NS 5660",29450,31000,1550,5
TIKI,thiet-bi-kts-phu-kien-so,174510703,"Adapter Sạc Samsung 25W Type C EP-TA800 - Hàng Chính Hãng",290000,390000,100000,26
TIKI,thiet-bi-kts-phu-kien-so,20202128,"Bàn di chuột R5",11730,11730,0,0
TIKI,thiet-bi-kts-phu-kien-so,14520200,"Tai Nghe HOCO M34 - Hàng Chính Hãng",33000,39900,6900,17
TIKI,thiet-bi-kts-phu-kien-so,174674004,"Khăn Lau Màn Hình Polishing Cloth cho iPhone / Macbook / iPad / Laptop / Smartphone / Lens Camera",60000,60000,0,0
TIKI,thiet-bi-kts-phu-kien-so,56606433,"Chuột Không Dây Sạc Điện HXSJ M80 - Hàng chính hãng",79000,126000,47000,37
TIKI,thiet-bi-kts-phu-kien-so,157710380,"Bao Da Cover Cho Máy Tính Bảng Nokia T20 10.4 Inch 2021 Hỗ Trợ Smart Cover",115000,115000,0,0
TIKI,thiet-bi-kts-phu-kien-so,189700428,"Tai nghe bluetooth gaming S10, cảm ứng, hỗ trợ đàm thoại, nghe nhạc, kiêm sạc dự phòng 2200mAh - Hàng Chính Hãng",159000,159000,0,0
TIKI,thiet-bi-kts-phu-kien-so,151564798,"Chuột Không Dây Silent Wireless Và Bluetooth RAPOO M300 - Hàng chính hãng",369000,369000,0,0
TIKI,thiet-bi-kts-phu-kien-so,26341625,"Hub chuyển đổi USB Type-C Sang USB 3.0/HDMI-Type C (Bạc)",97000,97000,0,0
TIKI,thiet-bi-kts-phu-kien-so,56260034,"Sạc dự phòng Energizer 10,000mAh /3.7V Li-Polymer - UE10054 - Hàng Chính Hãng",299000,299000,0,0
TIKI,thiet-bi-kts-phu-kien-so,191477357,"Ốp lưng dẻo trong phong cách mới dành cho iPhone 12 / 13 / 14 / 12 Pro / 12 Pro Max / 13 Pro / 13 Pro Max / 13 Mini / 14 / 14 Max / 14 Pro / 14 Pro Max  - Hàng chính hãng",139000,199000,60000,30
TIKI,thiet-bi-kts-phu-kien-so,177548270,"Chuột không dây DareU LM115B Silent, kết nối Bluetooth, 2,4Ghz - Hàng chính hãng",269000,269000,0,0
TIKI,thiet-bi-kts-phu-kien-so,148845180,"Hub chuyển đổi USB-Type C 5in1 tích hợp cổng mạng Lan , cổng sạc nhanh PD Type C 3.0, 2 cổng  USB 3.0 và cổng HDMI chuẩn 4K dành cho Macbook, SamSung Dex, HP, Acer, Asus",269000,269000,0,0
TIKI,thiet-bi-kts-phu-kien-so,34339386,"Cáp sạc thay thế cho các dòng đồng hồ Garmin",67000,67000,0,0
TIKI,thiet-bi-kts-phu-kien-so,190602137,"Dây Cáp Sạc Từ Tính cho Đồng Hồ Xiaomi Mi Band 5/ Mi Band 6/ Mi Band 7- Hàng chính hãng",33000,39000,6000,15
TIKI,thiet-bi-kts-phu-kien-so,72811865,"Dây Cáp Sạc Nhanh Type-C To Light.ning 20W Dành Cho iPhone, Cho iPad Chuẩn MFI C94, Dài 1.2 Mét RAVPower RP-CB1004 - Hàng Chính Hãng",299000,500000,201000,40
TIKI,thiet-bi-kts-phu-kien-so,23442433,"Đài USB NGHE NHẠC XB-521URT RADIO AM\FM\SW",165000,165000,0,0
TIKI,thiet-bi-kts-phu-kien-so,118424390,"Chuột không dây DAREU LM115G Black - Pink - Hàng Chính Hãng",123000,123000,0,0
TIKI,thiet-bi-kts-phu-kien-so,42648299,"Cáp chuyển USB Type-c ra 4 cổng HDMI/ VGA/ USB và cổng sạc hỗ trợ chế độ Dex - UHV41160",125000,125000,0,0
TIKI,thiet-bi-kts-phu-kien-so,171183734,"Cáp sạc nhanh, truyền dữ liệu tốc độ cao siêu bền Baseus Crystal Shine Series Fast Charging Data Cable IP 2.4A - Hàng chính hãng",125000,139000,14000,10
TIKI,thiet-bi-kts-phu-kien-so,11509625,"Bộ chuyển đổi VGA sang HDMI",67000,67000,0,0
TIKI,thiet-bi-kts-phu-kien-so,188685608,"Chuột không dây Bluetooth Logitech MX Master 3s - Hàng Chính Hãng",2086000,3299000,1213000,37
TIKI,thiet-bi-kts-phu-kien-so,119068085,"Bàn Phím Có Dây Dell KB216 - Đen - Hàng Chính Hãng",160000,160000,0,0
TIKI,thiet-bi-kts-phu-kien-so,111231167,"Thanh Kẹp Giữ Cố Định Dây Cáp Sạc Dây Điện Silicon - Hàng Nhập Khẩu",40000,90000,50000,56
TIKI,thiet-bi-kts-phu-kien-so,111031533,"Cáp sạc nhanh 2.4A và truyền dữ liệu chân type-C Remax Colorful Light RC-152a [Hàng chính hãng",112250,150000,37750,25
TIKI,thiet-bi-kts-phu-kien-so,76473301,"Kính Cường Lực KingKong Chống Nhìn Trộm Dành Cho iPhone 12Mini, 12-12Pro, 12Pro Max - Dán Full Màn - Hàng chính hãng",73888,73888,0,0
TIKI,thiet-bi-kts-phu-kien-so,3424667,"Bảng vẽ Wacom Intuos Bluetooth S CTL-4100WL/E0 (hàng phân phối chính thức)",2703000,2703000,0,0
TIKI,thiet-bi-kts-phu-kien-so,162475814,"Giá đỡ điện thoại trên ô tô Hoco CA86 - Gắn cửa điều hòa - Hàng chính hãng",99000,99000,0,0
TIKI,thiet-bi-kts-phu-kien-so,122012,"Combo chuột phím không dây Logitech MK240 - nhỏ gọn, 1 đầu thu USB, không dây 10m, pin lâu vượt trội - Màu",429000,435000,6000,1
TIKI,thiet-bi-kts-phu-kien-so,188941352,"Quạt Mini Cầm Tay Tích Điện Cao Cấp Không Gây Ồn Với 5 Tốc Độ Gió, Dung Lượng Pin Cao, Màn Hình Led Hiển Thị Mức Pin Tiện Dụng - Hàng Nhập Khẩu",255000,255000,0,0
TIKI,thiet-bi-kts-phu-kien-so,50237107,"[Miễn phí 1 năm] Sim 4G/5G Vinaphone VD149 Tặng 120GB/Tháng Và 200 Phút Gọi Ngoại Mạng (Hàng Chính Hãng) - Mẫu ngẫu nhiên",1179000,1179000,0,0
TIKI,thiet-bi-kts-phu-kien-so,152383399,"Tay Cầm Chơi Game RAPOO Dây Cắm USB Tương Thích PC, Laptop, PS, XBOX, Android - V600 - Hàng Chính Hãng",489000,489000,0,0
TIKI,thiet-bi-kts-phu-kien-so,13745119,"Bảng Vẽ Điện Tử Gaomon 1060Pro - 10x6 inch phiên bản mới nhất 2019 bút không cần sạc - Hàng nhập khẩu",635000,635000,0,0
TIKI,thiet-bi-kts-phu-kien-so,82955918,"Tai Nghe Bluetooth Nhét Tai PKCB True Wireless - Hàng Chính Hãng VN/A",195000,500000,305000,61
TIKI,thiet-bi-kts-phu-kien-so,88778074,"Chân Đế Đỡ Laptop Nillkin Bolster Portable Stand cho Laptop Macbook / Laptop Surface / Laptop Asus / Laptop HP / Laptop Dell / Laptop Lenovo / Laptop LG / Laptop Acer / Laptop MSI - Hàng Nhập Khẩu",129000,129000,0,0
TIKI,thiet-bi-kts-phu-kien-so,43161355,"Cáp chuyển đổi HDMI sang VGA cao cấp vỏ nhôm",139000,139000,0,0
TIKI,thiet-bi-kts-phu-kien-so,183111772,"Dây Đeo Sport Loop Kai Dành Cho Apple Watch- Hàng Chính Hãng",99000,99000,0,0
TIKI,thiet-bi-kts-phu-kien-so,50937043,"Giá đỡ kẹp điện thoại kim loại gắn gương chiếu hậu xe máy C2",36600,36600,0,0
TIKI,thiet-bi-kts-phu-kien-so,69238917,"Dây cáp sạc nhanh 100W chuẩn PD 2.0 Type C to type-c QC 3.0 hiệu Baseus Cafule type c to Type C cho iPad Pro 2018 / 2020 / Samsung / Huawei / Xiaomi / Tablet / Macbook / Laptop Type C - Hàng nhập khẩu",159000,299000,140000,47
TIKI,thiet-bi-kts-phu-kien-so,195531282,"Ốp lưng dành cho iPhone 14 / 14 Max / 14 Pro / 14 Pro Max - Hàng chính hãng",179000,250000,71000,28
TIKI,thiet-bi-kts-phu-kien-so,77673897,"Tai Nghe Bluetooth Nhét Tai True Wireless Không Dây PKCB - Hàng Chính Hãng H309",190000,500000,310000,62
TIKI,thiet-bi-kts-phu-kien-so,1011253,"Tai Nghe Chụp Tai Logitech H370 - Hàng Chính Hãng",685000,685000,0,0
TIKI,thiet-bi-kts-phu-kien-so,187118836,"Bộ 2 miếng kính cường lực Gor cho iPhone 13 Mini / 13 / 13 Pro / 13 Pro Max - Full Box - Gor - Hàng chính hãng",109000,109000,0,0
TIKI,thiet-bi-kts-phu-kien-so,130448805,"Tai nghe Hoco M60 Perfect với cáp đàn hồi cao TPE mic -Hàng nhập khẩu",65000,75000,10000,13
TIKI,thiet-bi-kts-phu-kien-so,50317255,"TAI NGHE DÂY DẸT NHÉT TAI  - Màu ngẫu nhiên - Hàng nhập khẩu",11672,12286,614,5
TIKI,thiet-bi-kts-phu-kien-so,107195030,"Tai nghe nhét tai dành cho Samsung S21 Ultra - Jack Type C công nghệ AKG dùng cho máy Samsung Galaxy S21 Ultra, S21, S20, Note 10, Ipad Pro - Âm thanh chân thực, sống động - Tặng Que Chọc Sim Đa Năng",116994,233988,116994,50
TIKI,thiet-bi-kts-phu-kien-so,143275339,"Tai Nghe dây Gaming Nhét Tai Ecoking,âm thanh nổi Chơi Game Chống Ồn Có Micro lõi bằng đông nguyên chất - Hàng Chính Hãng",19800,19800,0,0
TIKI,thiet-bi-kts-phu-kien-so,173800279,"Đầu đổi Type C sang USB Unitek - Hàng chính hãng",93000,93000,0,0
TIKI,thiet-bi-kts-phu-kien-so,72636913,"Jack chuyển Type C to 3.5 chính hãng Baseus chính hãng",119000,199000,80000,40
TIKI,thiet-bi-kts-phu-kien-so,88073058,"Túi chống nước UAG WaterProof cho điện thoại - Hàng Chính Hãng",140000,200000,60000,30
TIKI,thiet-bi-kts-phu-kien-so,58736477,"Giá Đỡ Kẹp Điện Thoại, Máy Tính Bảng Có Chân Kẹp Đầu Giường, Cạnh Bàn Hàng Chính Hãng Helios",49000,49000,0,0
TIKI,thiet-bi-kts-phu-kien-so,95469305,"Thanh nhớ ngoài USB 3.2 Kingston DataTraveler Exodia _DTX 32GB - Hàng Chính Hãng",104000,104000,0,0
TIKI,thiet-bi-kts-phu-kien-so,19772753,"Dây cáp sạc nhanh Type-c truyền data tốc độ cao Baseus Cafule Type C to Type C PD cho Smartphone / Tablet / Macbook / Laptop Type C (3A, 60W, Sạc nhanh PD, Sạc nhanh QC 4.0 Quick Charge)",94050,99000,4950,5
TIKI,thiet-bi-kts-phu-kien-so,22072676,"Combo 5 cuộn dây 1 mét dây băng gai dính, băng nhám loại dài đa năng quấn gọn gàng dây cáp loại sử dụng nhiều lần",75000,75000,0,0
TIKI,thiet-bi-kts-phu-kien-so,191354473,"Chuột Không Dây Mô Hình Ôtô Huqu V2-Kết Nối USB  2.4GHz -Hàng Chính Hãng",218500,230000,11500,5
TIKI,thiet-bi-kts-phu-kien-so,109214551,"Miếng Lót Chuột Da Kai (Mouse Pad) 2 Mặt 2 Màu 270x210mm  - Hàng Chính Hãng",42750,45000,2250,5
TIKI,thiet-bi-kts-phu-kien-so,164494978,"ốp lưng dẻo trong suốt điện thoại dành cho OPPO RENO 5  hàng chính hãng",9000,9000,0,0
TIKI,thiet-bi-kts-phu-kien-so,195166291,"Case ốp cho Samsung Galaxy Buds 2 Pro/ Buds 2/ Buds Pro/ Buds Live TPU Kai Trong Suốt Animal Kèm Móc Treo_ Hàng Chính Hãng",85000,85000,0,0
TIKI,thiet-bi-kts-phu-kien-so,74860644,"Tai Nghe Bluetooth Cảm Ứng Thông Minh - Hàng Chính Hãng",195000,500000,305000,61
TIKI,thiet-bi-kts-phu-kien-so,149797747," Đồng Hồ Thông Minh Trẻ em AMA Q12S Model mới nhất ra mắt tháng 12/2021 - Hàng nhập khẩu",591000,591000,0,0
TIKI,thiet-bi-kts-phu-kien-so,7739073,"SIM 4G Vinaphone D500 Trọn Gói 1 Năm Tặng 5GB/Tháng - Hàng Chính Hãng- Mẫu Ngẫu Nhiên",419000,419000,0,0
TIKI,thiet-bi-kts-phu-kien-so,115105450,"Thiết Bị Đọc Thẻ Nhớ ROBOT CR102 USB 3.0/Khe Cắm Thẻ Nhớ SD/Micro SD 5.0 - Hàng Chính Hãng",109000,109000,0,0
TIKI,thiet-bi-kts-phu-kien-so,152810169,"Cáp sạc nhanh, truyền dữ liệu tốc độ cao Baseus Cafule Type C cho Samsung S9/S10/ Note8/ Note9/ Xiaomi/ Huawei/ Oppo/Nokia ( 3A, Sạc nhanh Quick charge 3.0, Siêu bền) - Hàng Chính Hãng",65000,65000,0,0
TIKI,thiet-bi-kts-phu-kien-so,47243022,"Ốp lưng dẻo trong sần nhám dành cho iPhone 11",29000,37000,8000,22
TIKI,thiet-bi-kts-phu-kien-so,73551514,"Ốp Lưng Chống Sốc Và Kính Cường Lực Cho Iphone 12 , 12 Pro, 12 Mini, 12 ProMax",9000,9000,0,0
TIKI,thiet-bi-kts-phu-kien-so,129519046,"Gậy chụp ảnh selfie, tripod hỗ trợ livestream K10, kết nối bluetooth, xoay 360 độ dành cho Iphone, Samsung",132000,189000,57000,30
TIKI,thiet-bi-kts-phu-kien-so,77558147,"Giá Đỡ Điện Thoại Ô Tô Xe Hơi Hợp Kim Nhôm Hàng Không – Tự Động – Thông Minh - Xoay Chuyển Đa Góc Độ -– Mini Hàng Chính Hãng ",599000,599000,0,0
TIKI,thiet-bi-kts-phu-kien-so,91412768,"[Hàng nhập khẩu] Bộ vệ sinh Laptop, Macbook Cao Cấp JRC 5 Trong 1",229200,229200,0,0
TIKI,thiet-bi-kts-phu-kien-so,58251130,"Tai Nghe Gaming Dareu EH416 RGB (Phiên Bản Nâng Cấp Với Led RGB) - Hàng Chính Hãng",399000,399000,0,0
TIKI,thiet-bi-kts-phu-kien-so,17629257,"Miếng Lót Chuột Dễ Thương Chữ Nhật ( 20 x 26 cm )",30000,30000,0,0
TIKI,thiet-bi-kts-phu-kien-so,190565076,"Ốp Case LOLIFO Kai Protective Dành Cho Airpods 3 và Airpods PRO Khoá Thông Minh- Hàng chính hãng",151050,159000,7950,5
TIKI,thiet-bi-kts-phu-kien-so,32933095,"Đế Tản Nhiệt Laptop 2 Fan Có Led - Quạt Tản Nhiệt Laptop Thay Đổi Độ Dốc (Màu Đen)",117500,117500,0,0
TIKI,thiet-bi-kts-phu-kien-so,56313543,"[Giá đỡ] Chân đế để bàn kẹp điện thoại tiện dụng dùng livestream, quay video và giải trí",20000,20000,0,0
TIKI,thiet-bi-kts-phu-kien-so,181473036,"Bộ Chuyển Đổi Baseus Mini OTG Từ Type-C Sang USB-A 3.1 - Hàng Chính Hãng",49000,52500,3500,7
TIKI,thiet-bi-kts-phu-kien-so,32049575,"Ốp Lưng Sần Chống Sốc Cho Samsung Galaxy Note 10 Plus hiệu Nillkin (tặng kèm giá đỡ hoặc miếng dán từ tính) - Hàng Chính Hãng",98999,98999,0,0
TIKI,thiet-bi-kts-phu-kien-so,156634748,"	Cáp Sạc truyền dữ liệu 2.4 chống dối, dây dù dành cho Iphone,Ipad Hoco X14 Giao màu ngẫu nhiên- Hàng chính hãng",50000,50000,0,0
TIKI,thiet-bi-kts-phu-kien-so,191389901,"Chuột Máy Tính Bọ Cạp Huqu HQ-T37-Tương Thích Với Nhiều Hệ Điều Hành -Hàng Chính Hãng",389500,410000,20500,5
TIKI,thiet-bi-kts-phu-kien-so,87451243,"Ốp lưng silicon  có gờ bảo vệ camera dành cho Apple iPhone 12 series - Hàng Chính Hãng",9000,9000,0,0
TIKI,do-choi-me-be,95035798,"Sữa bột công thức HiPP 1 Organic Combiotic 800g",730000,730000,0,0
TIKI,do-choi-me-be,110695767,"Combo 2 Tã quần Bobby có đệm lưng thấm mồ hôi đủ size",1213000,1213000,0,0
TIKI,do-choi-me-be,143787771,"Tã Quần Huggies Dry Size XXL28 (28 Miếng+ khuyến mãi) - Từ 12-17kg",215000,215000,0,0
TIKI,do-choi-me-be,173187941,"Khăn ướt con vịt vàng 10 gói kèm thùng nhựa tiện dụng siêu đáng yêu",24699,24699,0,0
TIKI,do-choi-me-be,119690674,"Áo len gile bé trai từ 10 đến 30kg",185000,185000,0,0
TIKI,do-choi-me-be,195351504,"Bộ quần áo trẻ em MIMYKID sọc ngang kiểu lửng vải cotton thun dày mịn mát co giãn tốt, set đồ cho bé từ 4-16kg - (Giao màu ngẫu nhiên)",30000,30000,0,0
TIKI,do-choi-me-be,137480754,"COMBO 3 Túi Nước rửa chén Sunlight Thiên nhiên (trắng) Túi 750gx3",82000,82000,0,0
TIKI,do-choi-me-be,195435014,"Combo 3 bộ quần áo trẻ em MIMYKID sọc ngang kiểu lửng, chất liệu thun dày mịn co giãn và thấm hút cực tốt, set đồ thời trang cho bé từ 4-16kg - ( Giao Màu Ngẫu Nhiên )",109000,109000,0,0
TIKI,do-choi-me-be,845242,"Miếng Lót Sơ Sinh Huggies Dry Newborn 2 - 40 (40 Miếng) - Bao Bì Mới",75000,75000,0,0
TIKI,do-choi-me-be,3690577,"Chăn Lưới Chống Ngạt, Thoáng Mát Cho Bé Dùng Quanh Năm Xuất Xứ Thái Lan (100 x 150cm) - Xanh",287000,287000,0,0
TIKI,do-choi-me-be,182556168,"Địu em bé Bamboo Life BL031, địu 4 tư thế có đỡ cổ địu bé sơ sinh 0-36 tháng trợ lực, đa chức năng có ghế chống gù siêu nhẹ cho trẻ em đi xe máy, đi chơi, đi siêu thị an toàn",499000,499000,0,0
TIKI,do-choi-me-be,23542945,"Quây cũi kiêm nhà bóng cho bé (100 bóng nhựa cho bé)",225000,225000,0,0
TIKI,do-choi-me-be,51953954,"Combo Muối rửa bát finish 1.5kg+Nước làm bóng finish800ml dùng cho Máy rửa bát",258667,517334,258667,50
TIKI,do-choi-me-be,67195612,"Đai Chống Gù Lưng Cho Trẻ Em Cao Cấp Chính Hãng miDoctor – Đai Lưng Chống Gù Trẻ Em (Từ 5 – 13 Tuổi) - mi03TR",159000,159000,0,0
TIKI,do-choi-me-be,94727038,"Bộ đồ chơi hướng nghiệp nấu ăn nhà bếp cho bé từ 3 tới 8 tuổi Toyshouse 889-173",219000,280000,61000,22
TIKI,do-choi-me-be,89298871,"Combo 10 cuộn giấy vệ sinh An khang Soft 700 hai lớp một cuộn 700gr",468000,760000,292000,38
TIKI,do-choi-me-be,124861852,"Lineabon bổ sung K2 và vitamin D3 - Có tem tích điểm đổi quà, giúp hấp thụ canxi, giảm còi xương, tăng chiều cao cho bé",295000,500000,205000,41
TIKI,do-choi-me-be,173761565,"Combo 5 quần áo bé trai, đồ bộ in 3D co giãn 4 chiều thấm hút mồ hôi tốt cho bé trai từ 8-28kg - Giao màu ngẫu nhiên",383000,383000,0,0
TIKI,do-choi-me-be,82092184,"Nước thông cống Hando 1000ml nội địa",39000,39000,0,0
TIKI,do-choi-me-be,185447602,"Bộ body đùi cộc tay phối màu vải sợi tre cao cấp cho bé 4-12kg + Set body liền thân cho bé chất liệu Bamboo siêu mềm mịn, hàng chính hãng xuất khẩu HAKI BB047",168000,189000,21000,11
TIKI,do-choi-me-be,94587831,"Combo 2 hộp lá xông giúp khử mùi, giải cảm, lưu thông khí huyết Wonmom",92000,104000,12000,12
TIKI,do-choi-me-be,117835749,"Gấu Bông Heo Cute Xịn Giá Rẻ Cute Dễ Thương Áo Bông Cao Cấp Size 30 - 70 - HUMI",199000,199000,0,0
TIKI,do-choi-me-be,190460283,"Nước rửa chén LIX 3.5KG siêu sạch hương trà xanh loại túi N8101 sạch bóng vết bẩn dầu mỡ không hại da tay",89000,89000,0,0
TIKI,do-choi-me-be,3219881,"Sữa Nutifood Grow Plus+ Xanh 900 gr: Sữa cho trẻ từ 12 tháng bị thiếu cân, còi cọc",275000,275000,0,0
TIKI,do-choi-me-be,176937761,"Bộ 2 bình trữ sữa Medela 250ml",450000,450000,0,0
TIKI,do-choi-me-be,154532842,"Hộp quà tặng cao cấp Súp uống vi chất Fomeal Care Gold Yến Sào Thiên Nhiên hấp thu nhẹ bụng, bổ sung HMB - bồi bổ sức khỏe",280000,280000,0,0
TIKI,do-choi-me-be,17602936,"Bộ 4 Khoá Chặn Cửa Tủ , Tủ Lạnh Bảo Vệ An Toàn Cho Bé Milliken NL-3021 - Màu Ngẫu Nhiên",54000,54000,0,0
TIKI,do-choi-me-be,191928645,"váy công chúa bé gái trắng hoa bướm , váy công chúa cho bé lụa từ 8-40kg ( mã 041 )",165300,285000,119700,42
TIKI,do-choi-me-be,181462617,"Cốc tập uống 3 giai đoạn AQ Richell Nhật Bản | Baby",283745,283745,0,0
TIKI,do-choi-me-be,23524745,"Ao hút sữa rảnh tay có dây cho mẹ (Freesize)",55000,55000,0,0
TIKI,do-choi-me-be,129976744,"Núm ty Mô Phỏng tự nhiên Philips Avent dùng cho thức ăn đặc 656.23 (rãnh chữ Y - phù hợp bé từ 6 tháng tuổi)",225000,225000,0,0
TIKI,do-choi-me-be,110262359,"Sữa bột tốt cho bé Care 100 GOLD dành cho trẻ thấp còi, biếng ăn",373000,373000,0,0
TIKI,do-choi-me-be,55349100,"Mô Hình Nhà Búp Bê Cỡ Lớn Cho Các Bé Chơi Đồ Chơi Barbie",400000,400000,0,0
TIKI,do-choi-me-be,73287132,"COMBO 3 chai nước giặt LIX Đậm đặc (Đỏ) 3.8LX3",315000,315000,0,0
TIKI,do-choi-me-be,80403862,"Combo Tiết Kiệm 3 Gói Khăn Ướt Bobby Care Không Hương 100 Tờ/Gói - Tặng 1 Gói Cùng Loại",148000,148000,0,0
TIKI,do-choi-me-be,112169671,"Thùng sữa nước Nutricare Hanie Kid cho trẻ biếng ăn suy dinh dưỡng (110ml)",395000,395000,0,0
TIKI,do-choi-me-be,8347252,"Bột Ăn Dặm Vinamilk Ridielac Gold Vị Heo Bó Xôi (200g)",62000,62000,0,0
TIKI,do-choi-me-be,81587571,"ta quan yubest gold size xl 46 mieng",250000,250000,0,0
TIKI,do-choi-me-be,152785704,"Thun cột tóc cho bé, Dây thun cột tóc xinh xắn nhiều màu kẹo ngọt cho bé yêu Baby-S – SP152",7500,7500,0,0
TIKI,do-choi-me-be,112099914,"Dép lê cho bé - Dép bé trai bé gái đi nhà 3 - 12 tuổi hươu cao cổ quai ngang mềm êm nhựa dẻo chống trơn trượt cho bé D44",90000,90000,0,0
TIKI,do-choi-me-be,42802929,"Combo 3 bộ quần áo Bé Gái Nơ Xòe chất vải Tole, lanh 2 da loại 1, mềm, mịn, thoải mái, thoáng mát, nhiều size từ 5-30kg, hàng Việt Nam chất lượng, chính hãng",123000,123000,0,0
TIKI,do-choi-me-be,142339285,"Hộp 50 túi trữ sữa Sunmum Thái Lan 250ml",74000,74000,0,0
TIKI,do-choi-me-be,42253094,"Combo 7 món đồ chơi cho bé phát triển trí tuệ",141000,141000,0,0
TIKI,do-choi-me-be,187618596,"Đồ chơi trẻ em: Xe vệ sinh môi trường điều khiển từ xa DK81091. Màu ngẫu nhiên",225000,300000,75000,25
TIKI,do-choi-me-be,167420710,"Mẫu mới - Balo họa tiết hoạt hình, thời trang, xinh xắn Hàn Quốc cho bé mẫu giáo, nhà trẻ",110000,110000,0,0
TIKI,do-choi-me-be,141905850,"Đồ chơi trẻ em xe đổ rác chạy bằng dây cót - Xe mô hình gôm hốt rác - Quà Tặng Sinh Nhật Cho Bé",149000,149000,0,0
TIKI,do-choi-me-be,74769720,"Kutieskin 30gr giành cho da bé bị chàm sữa",225000,225000,0,0
TIKI,do-choi-me-be,129584815,"Thảm xốp ghép EVA trải sàn cho bé chất lượng Châu Âu EN71 - Toys House",319000,479000,160000,33
TIKI,do-choi-me-be,187610227,"Đồ chơi trẻ em: Máy xúc lật điều khiển từ xa  DK81094, Màu ngẫu nhiên",224000,320000,96000,30
TIKI,do-choi-me-be,76198177," Bộ Bài Ma Sõi Ultimate Deluxe Edition 64 Lá Đầy Đủ Chức Năng",60000,100000,40000,40
TIKI,do-choi-me-be,94060606,"Quần dài xanh đen học sinh Amazing, lưng thun, xếp 2 ly, dây kéo, form rộng, size từ 20 đến 95kg",101000,160000,59000,37
TIKI,do-choi-me-be,104850838,"Váy đầm bé gái xanh nhí nhún viền tay - Từ 11kg-45kg - K141",499000,499000,0,0
TIKI,do-choi-me-be,106006188,"Đồ Chơi Tranh Ghép Hình 3D Bằng Gỗ Nhiều Hình Ngộ Nghĩnh - Phát Triển Trí Tuệ Cho Bé",7500,7500,0,0
TIKI,do-choi-me-be,14330183,"Đồ chơi gỗ giáo cụ Montessori combo 3 bảng lắp ghép hình khôi - TotdepreHH1042",28900,28900,0,0
TIKI,do-choi-me-be,140363010,"Tháp Hà Nội, tháp dời 8 vòng đồ chơi gỗ tự nhiên siêu đẹp ",77000,77000,0,0
TIKI,do-choi-me-be,41343230,"Vitamin tổng hợp Wellbaby cho bé từ 6 tháng đến 4 tuổi 150ml",230000,335000,105000,31
TIKI,do-choi-me-be,190541850,"Ghế hơi tập ngồi cho bé chống ngã cao cấp Baby-S, Ghế phao tập ngồi cho bé phong cách Hàn Quốc – SSS031",219000,248999,29999,12
TIKI,do-choi-me-be,52178168,"Gối cho bé bú kê tay Rototo Bebe - Gối bú sữa giúp bố, mẹ đỡ mỏi tay",395000,520000,125000,24
TIKI,do-choi-me-be,53989978,"Mô hình nhà DIY Doll House A Cozy Little Courtyard Kèm Hộp nhạc và Mica Chống bụi",799000,999000,200000,20
TIKI,do-choi-me-be,68936268,"Cháo Tươi Ếch Đậu Hà Lan Cây Thị",21600,25000,3400,14
TIKI,do-choi-me-be,80981497,"Bộ bài tây mạ vàng cao cấp, chống nước - Bài lá bằng nhựa PVC - Hàng chính hãng",39000,39000,0,0
TIKI,do-choi-me-be,179805280,"Đồ bơi size đại cho bé trai, cỡ lớn đến 63kg, mẫu cao cấp chất đẹp dày dặn, dáng đẹp phom xịn | BT47",410000,410000,0,0
TIKI,do-choi-me-be,74922383,"NORIKID PLUS – GIẢI PHÁP HỖ TRỢ CẢI THIỆN BIẾNG ĂN, TÁO BÓN, TĂNG SỨC ĐỀ KHÁNG Ở TRẺ 06 THÁNG -12 TUỔI (HỘP 20 ỐNG)",245000,245000,0,0
TIKI,do-choi-me-be,84709888,"Gạc Rơ Lưỡi, Vệ Sinh Răng Miệng Cho Bé Dr Papie (Tách lẻ 10 gói)",33000,33000,0,0
TIKI,do-choi-me-be,184817101,"Đai đi xe máy cho bé, Đai nịt an toàn cho bé khi ngồi xe máy với 2 tư thế ngồi",75000,75000,0,0
TIKI,do-choi-me-be,161618806,"Ba lô học sinh cấp 1&2 siêu nhẹ chống gù chống nước cao cấp phong cách châu âu",449000,498000,49000,10
TIKI,do-choi-me-be,113245073,"Canxi cho bé Healthy Care Kids Milk Calcium Úc, Hỗ trợ tăng trưởng chiều cao, hệ thống xương, răng, bé ngủ ngon không trằn trọc đêm - OZ Slim Store",204000,484000,280000,58
TIKI,do-choi-me-be,17038421,"BÔNG CẮT 5X5CM - 1KG ",205200,216000,10800,5
TIKI,do-choi-me-be,59131835,"Bảng Viết Điện Tử Thông Minh Tự Xóa VNBoard Đa Sắc 12 inch",280000,280000,0,0
TIKI,do-choi-me-be,122948984,"Đồ chơi Trung Thu - Gậy phát sáng quả cầu pha lê nhiều màu - Đèn Trung Thu cho bé",39000,39000,0,0
TIKI,do-choi-me-be,191689280,"Đồ chơi trống cho bé Jazz Drum Toyshouse - Đồ chơi âm nhạc cho bé trai và bé gái chính hãng",89000,160000,71000,44
TIKI,do-choi-me-be,131421772,"Nón tai bèo tạo hình dễ thương gồm miếng chắn bụi, miếng chắn có thể tháo rời và điều chỉnh",162500,250000,87500,35
TIKI,do-choi-me-be,194445768,"Dụng cụ lấy ráy tai nhiều đầu sử dụng cổng sạc USB Có Đèn Cho Bé Cao Cấp ",79000,89000,10000,11
TIKI,do-choi-me-be,71344672,"Bộ 2 tấm tranh xếp hình 48 mảnh: Baby bus và Heo Pepa. Sản xuất tại Việt Nam.",69000,69000,0,0
TIKI,do-choi-me-be,123248329,"ÁO DÀI CÁCH TÂN CHO BÉ TRAI - ÁO DÀI NHUNG ĐÁP RỒNG",265000,265000,0,0
TIKI,do-choi-me-be,180236417,"Cháo Tươi Cá Chẽm Khoai Môn Cây Thị Mở Gói Ăn Ngay 240G",24300,28000,3700,13
TIKI,do-choi-me-be,170494744,"Sữa Bột Hoàng Gia Úc GROW UP MILK POWDER Hỗ Trợ Phát Triển Chiều Cao Cho Trẻ Từ 3-14 Tuổi 500g",890000,890000,0,0
TIKI,do-choi-me-be,191683194,"Túi đồ chơi xúc xắc lục lạc cho bé set 5 món Toys House 776-1  giúp bé sơ sinh kích thích phát triển giác quan",109000,170000,61000,36
TIKI,do-choi-me-be,184603015,"(8-20kg) Váy maxi dây điều chỉnh bé gái TB19 Váy Maxi Đi Biển Cho Bé Váy 2 Dây Đũi Siêu Mềm",95000,95000,0,0
TIKI,do-choi-me-be,127585838,"Đồ chơi xúc cát, đi biển - vận động ngoài trời cho bé - Toys House 035",89000,140000,51000,36
TIKI,thiet-bi-kts-phu-kien-so,55445629,"Đế tản nhiệt cho Laptop, Macbook - Giá đỡ, kệ đỡ, phụ kiện cao cấp cho Macbook, Laptop bằng hợp kim nhôm thông minh gấp gọn Horizen N3 - Hàng chính hãng",72600,72600,0,0
TIKI,thiet-bi-kts-phu-kien-so,51442066,"Miếng Lót Chuột, Bàn Di Chuột, mouse pad cỡ lớn (80x30x0.3)",87000,87000,0,0
TIKI,thiet-bi-kts-phu-kien-so,26708402,"Bộ chia USB 1 ra 4 cổng 3.0 - Hub USB 4 Port 3.0",35800,35800,0,0
TIKI,thiet-bi-kts-phu-kien-so,23790776,"Thảm da trải bàn làm việc 2 mặt cỡ 40 x 80 cm Deskpad - Hàng nhập khẩu",109000,109000,0,0
TIKI,thiet-bi-kts-phu-kien-so,11443614,"Sim 4G Vinaphone D500 Vào Mạng Trọn Gói 1 Năm Miễn Phí Không Nạp Tiền - Mẫu ngẫu nhiên",419000,419000,0,0
TIKI,thiet-bi-kts-phu-kien-so,15677446,"Tai Nghe Gaming Có Mic Plextone G20 New Edition - Hàng Chính Hãng",165000,165000,0,0
TIKI,thiet-bi-kts-phu-kien-so,196187316,"Chuột Không Dây Hình  OTO Huqu V3- Độ Phân Giải Quang Học 1200DPI- Hàng Chính Hãng",256500,270000,13500,5
TIKI,thiet-bi-kts-phu-kien-so,191377941,"Chuột Không Dây Ôtô Huqu V1- Kết Nối Không Dây 2.4Ghz- Hàng Chính Hãng",133000,140000,7000,5
TIKI,thiet-bi-kts-phu-kien-so,23476288,"Tai nghe gaming có mic G901 dùng được cho điện thoại và máy tính + Tặng đế xem phim cho điện thoại",139000,139000,0,0
TIKI,thiet-bi-kts-phu-kien-so,174673994,"Miếng Vải Lót Phím Microfiber dành cho Macbook chống bụi bẩn bàn phím, vệ sinh màn hình Macbook",99000,99000,0,0
TIKI,thiet-bi-kts-phu-kien-so,8004965,"Cáp Sạc Nhanh Micro USB Cho Smartphone Android 2.4A Baseus Cafule",39299,65499,26200,40
TIKI,thiet-bi-kts-phu-kien-so,93395080,"Adapter Củ Sạc 38W CHOETECH PD5002 USB-A Quick Charge 3.0, USB Type C PD 20W - Hàng Chính Hãng",299000,590000,291000,49
TIKI,thiet-bi-kts-phu-kien-so,91189740,"Dây dán tiên lợi Velcro làm gọn dây sạc, dây tai nghe,... UGREEN 50370- Hàng chính hãng",15000,19000,4000,21
TIKI,thiet-bi-kts-phu-kien-so,72907962,"Giá Đỡ Laptop, Máy Tính Bảng Hợp Kim Nhôm 7 Mức Điều Chỉnh Chiều Cao Thông Thoáng Hỗ Trợ Tản Nhiệt Hàng Chính Hãng Tamayoko",259000,299000,40000,13
TIKI,thiet-bi-kts-phu-kien-so,115786359,"Giá Đỡ Để Bàn Dành Cho Laptop, Máy Tính Xách Tay Chất Liệu Hợp Kim Nhôm Cao Cấp Model HL001- Hàng Chính Hãng Tamayoko",169000,169000,0,0
TIKI,thiet-bi-kts-phu-kien-so,57705006,"Micro karaoke kèm Loa bluetooth nhập khẩu cao Cấp Cắm thẻ nhớ 3 trong 1 Hàng chính hãng",880000,1100000,220000,20
TIKI,thiet-bi-kts-phu-kien-so,32400627,"Lót Chuột Chữ Nhật Có Kê Tay Họa Tiết Dễ Thương 17.5 x 21.5 cm",85000,85000,0,0
TIKI,thiet-bi-kts-phu-kien-so,91865173,"Bàn phím cơ E-DRA EK384 Led RGB - Hàng chính hãng",799000,799000,0,0
TIKI,thiet-bi-kts-phu-kien-so,88778021,"Ốp Lưng Silicon TPU trong suốt GOR cho Samsung Galaxy S21 / S21 Plus / S21 Ultra - Hàng Nhập Khẩu",50000,50000,0,0
TIKI,thiet-bi-kts-phu-kien-so,89692612,"Tai nghe Bluetooth 5.0 không dây Bluetooth chống nước Tai nghe âm thanh nổi TWS - Hàng Chính Hãng PKCB",245000,500000,255000,51
TIKI,thiet-bi-kts-phu-kien-so,51510460,"Cáp chuyển đổi HDMI sang VGA FULL HD 1080P dây chuyển đổi từ hdmi sang vga",23900,23900,0,0
TIKI,thiet-bi-kts-phu-kien-so,168918231,"Ốp Lưng Nillkin CamShield Armor cho Samsung Galaxy S22 Ultra - Hàng Nhập Khẩu",299000,299000,0,0
TIKI,thiet-bi-kts-phu-kien-so,766342,"Dây Cáp Âm Thanh AUX 3.5mm Anker 2.4m - A8220011 (Đen) - Hàng Chính Hãng",152000,180000,28000,16
TIKI,thiet-bi-kts-phu-kien-so,124975226,"Webcam máy tính fullHD 1080p sắc nét, có mic thu âm hỗ trợ học online, livestream giảng bài. Có kẹp, cổng usb",159900,159900,0,0
TIKI,thiet-bi-kts-phu-kien-so,195915487,"Thẻ Nhớ MicroSDXC SanDisk Extreme Pro V30 A2 128GB 200MB/s SDSQXCD-128G (New 2022) - Hàng Nhập Khẩu",425000,425000,0,0
TIKI,thiet-bi-kts-phu-kien-so,136816295,"Thiết bị thu phát âm thanh Usb bluetooth 5.0 đa chức năng jack cắm 3.5mm cho loa, Tivi, máy tính, laptop, xe ô tô tặng kèm que chọc sim",62000,67000,5000,7
TIKI,thiet-bi-kts-phu-kien-so,113063452,"Ốp lưng chống sốc phong cách mới dành cho iPhone 11 / 12 / 11 Pro / 12 Pro / 11 Pro Max / 12 Pro Max - Hàng chính hãng",129000,199000,70000,35
TIKI,thiet-bi-kts-phu-kien-so,161944157,"Loa máy trợ giảng Aporo T21 UHF, 2.4G công suất 30W Bluetooth 5.0 không dây cao cấp (gồm 3 micro)- Hàng chính hãng",780000,780000,0,0
TIKI,thiet-bi-kts-phu-kien-so,147400127,"Thiết bị thu phát âm thanh Usb bluetooth 5.0 âm thanh đa chức năng jack cắm 3.5mm  KitAcoom cho loa, ô tô tai nghe bluetooth, biến loa thường thành loa Bluetooth, Hàng Chính Hãng",99999,99999,0,0
TIKI,thiet-bi-kts-phu-kien-so,4252075,"Bộ Bàn Phím Giả Cơ và Chuột Chuyên Game G21 Led 7 Màu - Màu trắng",108191,108191,0,0
TIKI,thiet-bi-kts-phu-kien-so,185946121,"Bàn phím cơ không dây E-DRA EK361W V2 (Black/White/Bluetooh) -Hàng Chính Hãng",880000,880000,0,0
TIKI,thiet-bi-kts-phu-kien-so,11212346,"Chuột Fuhlen Gaming G90 - Hàng chính hãng",348000,349000,1000,0
TIKI,thiet-bi-kts-phu-kien-so,58168209,"Miếng đệm kê tay chuột chống mỏi, chống thoái hóa cổ tay xoay 180 độ tiện dụng khi sử dụng máy tính văn phòng, chơi game GD333-ketayban",87999,87999,0,0
TIKI,thiet-bi-kts-phu-kien-so,185409375,"Bao Case Dành Cho Airpods 3/ Airpods Pro Kai TPU Họa Tiết Kaws- Hàng Chính Hãng",92000,99000,7000,7
TIKI,thiet-bi-kts-phu-kien-so,37547304,"Tấm lót bàn làm việc bằng da chống nước nhiều màu cao cấp",69000,69000,0,0
TIKI,thiet-bi-kts-phu-kien-so,193061719,"Giá đỡ điện thoại trên ô tô,giá kẹp điện thoại ô tô cảm ứng cao cấp thông minh xoay 360 độ",147510,149000,1490,1
TIKI,thiet-bi-kts-phu-kien-so,32858950,"Tai nghe nhét tai Langsdom JM26 Super Bass cho android/iphone/ipad (Trắng) - Hàng Chính Hãng",44900,44900,0,0
TIKI,thiet-bi-kts-phu-kien-so,187657388,"Case Dành Cho Airtag Chống sốc Hình Animal Kai- Hàng Chính Hãng",59000,59000,0,0
TIKI,thiet-bi-kts-phu-kien-so,73258986,"Chuột LED RGB 3200 DPI Gaming Mouse A868",150000,150000,0,0
TIKI,thiet-bi-kts-phu-kien-so,95085487,"Giá đỡ laptop bằng nhôm gấp gọn dùng cho nhiều máy từ 11-17 inch, có thể điều chỉnh nhiều mức độ cao chất liệu hợp kim",66800,66800,0,0
TIKI,thiet-bi-kts-phu-kien-so,14449573,"Cáp chuyển đổi Usb ra âm thanh cổng 3.5",27000,28500,1500,5
TIKI,thiet-bi-kts-phu-kien-so,145304290,"Bao Case Ốp Dành Cho Tai Nghe Airpods 3 Kai Liquid Silicon Color_ Hàng Chính Hãng",40000,89000,49000,55
TIKI,thiet-bi-kts-phu-kien-so,126937631,"Túi chống nước điện thoại di động",24000,24000,0,0
TIKI,thiet-bi-kts-phu-kien-so,31520324,"Bao Da Cover Dành Cho Apple Ipad Mini 4 Mini 5 2019 Vân Da Tuần Lộc",111000,111000,0,0
TIKI,thiet-bi-kts-phu-kien-so,80932325,"Kệ Dán Tường Để Remote - Giá Đỡ Sạc Điện Thoại Có Móc Treo Giữ Dây Điện",3900,3900,0,0
TIKI,thiet-bi-kts-phu-kien-so,71505389,"Đồng hồ Điện thoại có 7 GAME Giải trí, Hỗ trợ Thẻ nhớ 32G Music, lắp Sim không cần Đăng ký 4G, Thêm danh bạ dễ dàng không cần ứng dụng - Hàng nhập khẩu",570000,570000,0,0
TIKI,thiet-bi-kts-phu-kien-so,55850715,"Giá đỡ laptop stand nhôm cho máy tính xách tay",369000,369000,0,0
TIKI,thiet-bi-kts-phu-kien-so,151605868,"Chuột Không Dây Chống Ồn Genius NX-8000S - Hàng Chính Hãng ",175000,199000,24000,12
TIKI,thiet-bi-kts-phu-kien-so,136818264,"Ốp lưng kéo nắp kiểu mới dành cho iPhone 11 / 12 / 13 / 14 / 11 Pro / 12 Pro / 13 Pro / 14 Pro / 11 Pro Max / 12 Pro Max / 13 Pro Max / 14 Pro Max / 12 Mini / 13 Mini / 14 Plus - Hàng chính hãng",99000,150000,51000,34
TIKI,thiet-bi-kts-phu-kien-so,71656427,"Ốp Lưng Dẻo TPU Trong Suốt Dành Cho Iphone 12/ 12 Pro/ 12Promax/ SE 2020/ iPhone11/ 11Pro/ 11Promax/ X / XS/ XS Max / XR / 7 8 Plus. Hàng Chính Hãng Helios",9000,9000,0,0
TIKI,thiet-bi-kts-phu-kien-so,584798,"Webcam Logitech C922 Full HD 1080p - 720p/60FPS micro kép to rõ, tự động lấy nét và chỉnh sáng HD, phù hợp PC/ Laptop/ Mac - Hàng chính hãng",2350000,2350000,0,0
TIKI,thiet-bi-kts-phu-kien-so,127236876,"Giá đỡ Laptop, Macbook, Ipad gấp gọn bằng nhôm, Kệ đỡ laptop 13.3-14-15.6 inch có thể chỉnh độ cao, hỗ trợ tản nhiệt",69000,69000,0,0
TIKI,thiet-bi-kts-phu-kien-so,177613972,"Tai nghe Bluetooth TWS không dây Jlab Go Air Pop thời gian nghe 32H EQ3 Sound chuẩn IPX4 chống ồn tích hợp dây sạc - Hàng chính hãng BH đổi mới 2 năm",890000,890000,0,0
TIKI,thiet-bi-kts-phu-kien-so,134656521,"USB OTG SanDisk Ultra Dual Drive m3.0 - Hàng Chính Hãng",100000,100000,0,0
TIKI,thiet-bi-kts-phu-kien-so,21857291,"Hub chia USB Type-C 5 Cổng HDMI/USB 3.0/SD/TF",175000,250000,75000,30
TIKI,thiet-bi-kts-phu-kien-so,188318615,"Case Ốp Bảo Vệ Gấu Nice dành cho Tai Nghe AIRPODS 3/Airpods Pro/Airpods 1/2 Kèm Khóa treo hình- Hàng chính hãng",94050,99000,4950,5
TIKI,thiet-bi-kts-phu-kien-so,56033,"Chuột Không Dây Logitech M187 - Hàng chính hãng",265000,265000,0,0
TIKI,thiet-bi-kts-phu-kien-so,184217870,"Chuột Không Dây Silent Wireless RAPOO 1680 - Hàng chính hãng",135000,135000,0,0
TIKI,thiet-bi-kts-phu-kien-so,184132996,"Cốc Sạc Đa Năng 3 Cổng Sạc Baseus Compact Charger 17W - Hàng chính hãng",195000,259000,64000,25
TIKI,thiet-bi-kts-phu-kien-so,35277311,"Giá Đỡ Điện Thoại Thông Minh Hoco CAD01 - Hàng Chính Hãng",150000,150000,0,0
TIKI,thiet-bi-kts-phu-kien-so,216406375,"Bút cảm ứng ESR Digital iPad Stylus Pencil dành cho iPad Pro/ Ipad Air/ Ipad Mini/ Ipad Gen 6,7,8,9 - Hàng chính hãng",890000,890000,0,0
TIKI,thiet-bi-kts-phu-kien-so,135284107,"Headphone Tai Nghe Chụp Tai bluetooth Rockspace O2 kết nối không dây có mic nghe nhạc liên tục 15h - Hàng chính hãng",453000,595000,142000,24
TIKI,thiet-bi-kts-phu-kien-so,164266659,"Tai nghe bluetooth không dây nhét tai True Wireless thể thao pin trâu kết nối nhanh, ổn định kèm mic hỗ trợ đàm thoại, chống ồn tốt tương thích với điện thoại, laptop, máy tính 5Tech hàng chính hãng",75000,139000,64000,46
TIKI,thiet-bi-kts-phu-kien-so,179444874,"Ốp lưng chống sốc dành cho iPhone 11 / 12 / 13 / 11 Pro / 12 Pro / 13 Pro / 11 Pro Max / 12 Pro Max / 13 Pro Max / 12 Mini / 13 Mini - Hàng chính hãng",79000,150000,71000,47
TIKI,thiet-bi-kts-phu-kien-so,74890302,"Ốp lưng da chống sốc dành cho iPhone 7 / 8 / SE 2020 / 7 PLUS / 8 PLUS / X / XS / XS MAX / XR / 11 / 11 PRO / 11 PRO MAX / 12 MINI / 12 / 12Pro / 12 Pro Max - Hàng chính hãng",119000,199000,80000,40
TIKI,thiet-bi-kts-phu-kien-so,49498981,"Tai nghe dành cho Samsung Galaxy S10/S10 Plus",46000,46000,0,0
TIKI,thiet-bi-kts-phu-kien-so,554912,"Chuột Chơi Game Có Dây Logitech G102 8000DPI RGB 6 Phím - Hàng Chính Hãng",389000,399000,10000,3
TIKI,thiet-bi-kts-phu-kien-so,50424465,"Dán màn hình dành cho iPad Paper-like chống vân tay cho cảm giác vẽ như trên giấy",82000,82000,0,0
TIKI,thiet-bi-kts-phu-kien-so,54665,"Chuột không dây Logitech M185 - Hàng chính hãng - Màu",250000,250000,0,0
TIKI,thiet-bi-kts-phu-kien-so,29238111,"Tai Nghe Bluetooth True Wireless TaoTronics SoundLiberty 53 (TT-BH053) - Hàng Chính Hãng",499000,950000,451000,47
TIKI,thiet-bi-kts-phu-kien-so,107457318,"Thiết bị Earldom W18 hỗ trợ chuyển đổi từ cổng USB TypeC 6 in 1(USB TypeC 6 to HDMI + 3 USB 3.0 + SD Card Reader + TF Card Earldom W18) - hàng chính hãng",326000,629000,303000,48
TIKI,thiet-bi-kts-phu-kien-so,141502002,"[Xả Kho]Sim 4G mobifone  sim mạng 1 năm không phải nạp tiền",299000,299000,0,0
TIKI,thiet-bi-kts-phu-kien-so,56264868,"Bộ Adapter 25W sạc siêu nhanh + cable USB-C dành cho điện thoại Samsung S10, S20, Ipad, Iphone (Tặng kèm que chọt sim) có ảnh thật kèm theo",109000,109000,0,0
TIKI,thiet-bi-kts-phu-kien-so,192376330,"Vỏ Ốp silicon bọc bút dành cho Apple Pencil 2 Hình Mèo Carton- Hàng chính hãng",90250,95000,4750,5
TIKI,thiet-bi-kts-phu-kien-so,4365045,"Dây HDMI 1,5M Tròn",17000,17000,0,0
TIKI,thiet-bi-kts-phu-kien-so,77754757,"Ốp lưng Silicon cho iPhone 12 Mini / 12 / 12 Pro / 12 Pro Max Chó Shiba Kèm Móc Ring",71900,71900,0,0
TIKI,thiet-bi-kts-phu-kien-so,108202304,"Củ sạc nhanh chuẩn kép PD+QC 20W Remax RP-U64 - Hàng chính hãng",239000,239000,0,0
TIKI,thiet-bi-kts-phu-kien-so,109455098,"Cáp sạc nhanh PD20W truyền dữ liệu Baseus Metal Data Type-C sang iPhone ( 2 size ) - Hàng chính hãng",145000,259000,114000,44
TIKI,thiet-bi-kts-phu-kien-so,83749783,"Bao Da Cover Dành Cho Máy Tính Bảng Huawei MatePad T10s 10.1 Inch AGS3-L09 / AGS3-W09 Hỗ Trợ Smart Cover",129000,129000,0,0
TIKI,thiet-bi-kts-phu-kien-so,29575776,"Dây Cáp USB 2 Đầu Dương 1.5m ( Đen )",15800,15800,0,0
TIKI,thiet-bi-kts-phu-kien-so,97547734,"Giá Đỡ Để Bàn Điện Thoại Di Động, Máy Tính Bảng, Ipad Hợp Kim Nhôm Cao Cấp Hai Trục Xoay 180 Độ Chống Đổ Hàng Chính Hãng Tamayoko",390000,450000,60000,13
TIKI,thiet-bi-kts-phu-kien-so,169548885,"Chuột không dây Logitech B175 -Hàng chính hãng",165000,165000,0,0
TIKI,thiet-bi-kts-phu-kien-so,112190913,"Dây Cáp chuyển Hdmi Sang Dvi-D 1080p",43530,43530,0,0
TIKI,thiet-bi-kts-phu-kien-so,136868821,"lót chuột văn phòng",23700,23700,0,0
TIKI,thiet-bi-kts-phu-kien-so,161397226,"Miếng dán màn hình GOR cho Apple Watch Series 7 / Apple Watch Series 8 / Apple Watch Series 9 Size 41mm / 45mm (Hộp 3 Miếng) - Hàng Nhập Khẩu",119000,119000,0,0
TIKI,thiet-bi-kts-phu-kien-so,65367594,"Dây đeo điện thoại/móc khóa/máy ảnh Ringke Lanyard Wrist Strap - Hàng Chính Hãng",104000,119000,15000,13
TIKI,thiet-bi-kts-phu-kien-so,536965,"Tai nghe chụp tai Logitech H111 - Hàng chính hãng",243000,243000,0,0
TIKI,thiet-bi-kts-phu-kien-so,59044820,"Thẻ nhớ MicroSD Kioxia 64GB Class 10 - Hàng Nhập Khẩu",113050,119000,5950,5
TIKI,thiet-bi-kts-phu-kien-so,91271958,"Giá, Kệ Dán Tường Để Sạc điện thoại, Remote Đồ Dùng Giá Đỡ Sạc Điện Thoại Có Móc Treo Giữ Dây Điện",6600,6600,0,0
TIKI,thiet-bi-kts-phu-kien-so,182129885,"Bàn Phím Cơ Gaming Cao Cấp XSmart K1 Có 20 Chế Độ Nháy LED RGB Cực Đẹp, 104 Phím Full Size Sử Dụng Trục Cơ Red Switch Gõ Siêu Êm Bản Nâng Cấp Mới Nhất Tương Thích Với Các Dòng Máy Tính, Laptop, PC - Hàng Chính Hãng",549000,549000,0,0
TIKI,thiet-bi-kts-phu-kien-so,124702774,"Adapter Củ Sạc 40W 2 Cổng Type C PD 3.0 & QC 3.0 Nhỏ Gọn RAVPower RP-PC152 - Hàng Chính Hãng",499000,800000,301000,38
TIKI,thiet-bi-kts-phu-kien-so,95998092,"Chuột bi xoay không dây ERGO M575 Wireless - Hàng Chính Hãng",938000,939000,1000,0
TIKI,thiet-bi-kts-phu-kien-so,56799621,"Ốp lưng dẻo chống bụi dành cho iPhone 7 Plus / 8 Plus - Xanh rêu",49000,68000,19000,28
TIKI,thiet-bi-kts-phu-kien-so,11257847,"Dây Nguồn Dẹt 3 Chấu Cho Cục Sạc Laptop",17000,17000,0,0
TIKI,thiet-bi-kts-phu-kien-so,63171394,"Miếng Lót Chuột Da 26x21 cm Màu Sắc Tinh Tế YORN - Hàng Nhập Khẩu",24000,24000,0,0
TIKI,thiet-bi-kts-phu-kien-so,111050867,"Cáp sạc nhanh 2.4A và truyền dữ liệu cho android Remax Colorful Light RC-152m [Hàng chính hãng",112250,150000,37750,25
TIKI,thiet-bi-kts-phu-kien-so,73644584,"Dây Đeo Thay Thế Silicone Vòng Tay Thông Minh Mi Band 5 Mi Band 6 - Hàng Chính Hãng",33000,69000,36000,52
TIKI,thiet-bi-kts-phu-kien-so,177085650,"Ốp lưng dẻo trong chống sốc dành cho SamSung Galaxy A13 4G, A53 5G, A23, A73, A33",12499,24998,12499,50
TIKI,thiet-bi-kts-phu-kien-so,75397375,"Tai Nghe Chụp Tai Bluetooth Chống Ồn GS-H3 Cao Cấp, Headphone Bluetooth Chụp Tai Có Mic Đàm Thoại Tiện Lợi, Tai Nghe Bluetooth Không Dây Pin Cực Khỏe Bluetooth 5.0 Cao Cấp - Hàng Chính Hãng",220000,220000,0,0
TIKI,thiet-bi-kts-phu-kien-so,165807250,"Tai Nghe True Wireless OPPO Enco Air 2 | Chống Ồn Thông Minh Ai | Màng Loa Mạ Titan 13.4mm | Hàng Chính Hãng",795000,1590000,795000,50
TIKI,thiet-bi-kts-phu-kien-so,88778005,"Dây Cao Su Thay Thế cho Samsung Galaxy Fit 2 (SM-R220)",29000,29000,0,0
TIKI,thiet-bi-kts-phu-kien-so,119003179,"Chuột Không Dây DAREU LM115G SPARROW ARTIC White (Màu Trắng) - Hàng Chính Hãng",125000,125000,0,0
TIKI,thiet-bi-kts-phu-kien-so,15432912,"Bộ 5 Dây Quấn Bảo Vệ Cáp Sạc Và Tai Nghe ",7000,7000,0,0
TIKI,thiet-bi-kts-phu-kien-so,9843514,"Dây HDMI 10m Bọc Lưới Full HD",79900,79900,0,0
TIKI,thiet-bi-kts-phu-kien-so,38997194,"[Miếng dán màn hình] Kính cường lực chống nhìn trộm dành cho Iphone 6/7/8/X/11 6Plus 7Plus 8Plus XS MAX Iphone 11 Pro Max chất lượng",20000,39998,19998,50
TIKI,thiet-bi-kts-phu-kien-so,59482840,"Bộ Hub QGeeM đa năng 5 trong 1 dành cho MacBook Pro 13/15 Surface Go, USB C Adapter - Hàng chính hãng",276000,299000,23000,8
TIKI,thiet-bi-kts-phu-kien-so,118722616,"Chuột có dây LOGITECH B100 - Hàng chính hãng",65000,65000,0,0
TIKI,thiet-bi-kts-phu-kien-so,71087453,"Củ Sạc Điện Thoại 2 Cổng USB-A và 2 Cổng Type-C PD 65W QC 3.0 RAVPower RP-PC136 - Hàng Chính Hãng",999000,1450000,451000,31
TIKI,thiet-bi-kts-phu-kien-so,42422432,"Giá đỡ nhôm, kệ đỡ laptop, đế tản nhiệt cho macbook, máy tính 9 nấc điều chỉnh độ cao",84400,84400,0,0
TIKI,thiet-bi-kts-phu-kien-so,47271303,"Ốp lưng dẻo mỏng dành cho iPhone 6 Plus / iPhone 6s Plus - Màu đen",29500,29500,0,0
TIKI,thiet-bi-kts-phu-kien-so,33142561,"Củ sạc HOCO 1A UH102 - Hàng nhập khẩu",20000,20000,0,0
TIKI,thiet-bi-kts-phu-kien-so,17913419,"Tai nghe Moxpad X3 in-ear Monitor - Hàng chính hãng",440000,440000,0,0
TIKI,thiet-bi-kts-phu-kien-so,166545922,"Dây Cáp Chuyển Đổi Type C To HDMI 4K 60Hz CHOETECH XCH-M180 Dây Nylon Dài 1.8M, Tương Thích Thunderbolt 3 Dành Cho Macbook, Kèm Cổng Type C Sạc Nhanh 60W - Hàng Chính Hãng",389000,750000,361000,48
TIKI,thiet-bi-kts-phu-kien-so,50253867,"Lót Chuột, Pad Chuột Bền Đẹp 80x30 cm - Hàng Chính Hãng",52000,52000,0,0
TIKI,thiet-bi-kts-phu-kien-so,73166945,"Bàn phím không dây Bluetooth Logitech MX Keys - đa thiết bị, sạc nhanh, Mac/ PC - Hàng chính hãng",2459000,3499000,1040000,30
TIKI,thiet-bi-kts-phu-kien-so,176718538,"Pad Chuột Cỡ Lớn, Miếng Lót Chuột Gaming Cỡ Lớn 90x40, 120x60cm Thảm Nỉ Trải Bàn Làm Việc Phong Cách Decor Sang Trọng",80000,150000,70000,47
TIKI,thiet-bi-kts-phu-kien-so,73992109,"USB Bluetooth 5.0 tốc độ 5Mbps Orico BTA-508 – Hàng Phân Phối Chính Hãng",109000,109000,0,0
TIKI,thiet-bi-kts-phu-kien-so,107971562,"Cáp âm thanh nối dài AUX 3.5mm Remax RL-L100/L200 - Hàng chính hãng",90000,100000,10000,10
TIKI,thiet-bi-kts-phu-kien-so,379462,"Loa Vi Tính Microlab B51 - Hàng Chính Hãng",259000,259000,0,0
TIKI,thiet-bi-kts-phu-kien-so,96811310,"Tai nghe chụp tai máy tính GAMING XSmart MC Q9 có đèn LED đổi màu, mic đàm thoại, headphone chơi game trên laptop, pc - Hàng Chính Hãng",349000,349000,0,0
TIKI,do-choi-me-be,101898024,"Bộ romper linen lưng chun cho bé trai bé gái Haki, bộ body cho bé, baby bodysuit, set áo liền quần cho bé từ 6-13kg BL001",156000,175000,19000,11
TIKI,do-choi-me-be,412767,"Tã Quần Cao Cấp Moony Nhật Bản Bé Gái L44 (44 Miếng)",339000,466400,127400,27
TIKI,do-choi-me-be,117434350,"Khăn Khô Đa Năng Yuniku 270 Tờ",39500,57000,17500,31
TIKI,do-choi-me-be,178937381,"Xếp Hình Lắp Ráp Máy Xúc Hộp Nhỏ 30 Chi Tiết Mã 1219",6000,6000,0,0
TIKI,do-choi-me-be,173768518,"Xe địa hình điều khiển từ xa KAVY 3699-L6 có 3 đèn LED tỷ lệ 1:20 dẫn động 2 bánh tốc độ cao nhiều màu sắc",225000,225000,0,0
TIKI,do-choi-me-be,107018282,"Điện Thoại Khúc Khích",97500,130000,32500,25
TIKI,do-choi-me-be,76067268,"Xe đồ chơi đầu kéo vận chuyển gỗ KAVY, nhựa ABS an toàn, kích thước lớn",182000,182000,0,0
TIKI,do-choi-me-be,76283100,"Tuyển tập xe đồ chơi mô hình ô tô kim loại KAVY chạy cót có led phát sáng, nhiều loại mẫu  (màu ngẫu nhiên)",78000,78000,0,0
TIKI,do-choi-me-be,114080423,"Đồ chơi mô hình xe cảnh sát KAVY NO.8808 có nhạc và đèn chạy đà nhiều màu sắc",42000,42000,0,0
TIKI,do-choi-me-be,109340542,"(HÀ NỘI ĐÃ BÁN 462) GIẢM GIÁ !!!! NÔI TRE ĐẶT VÕNG CHO BÉ HÀNG LOẠI 1. SIZE 85/ 90/ 95 chữ nhật/100/ 110/120",130000,130000,0,0
TIKI,do-choi-me-be,94072972,"Túi Nước Giặt Xả MaxKleen Thiên Nhiên 2.2kg",138000,150000,12000,8
TIKI,do-choi-me-be,167427142,"Xe đồ chơi chạy đà hình con vật KAVY No.8808 gồm 2 xe vui nhộn, chứa đựng lẫn nhau",58000,58000,0,0
TIKI,do-choi-me-be,83691211,"Ô tô xe điện trẻ em Z4 tự lái và remote cho bé vận động ngoài trời",3100000,3100000,0,0
TIKI,do-choi-me-be,184857887,"Bộ quần áo lửng bé gái họa tiết Sọc xám linen cotton - AICDBGO2C8RB - AIN Closet",155000,225000,70000,31
TIKI,do-choi-me-be,43863262,"Sữa Bột Hoàng Gia Úc Royal Ausnz Kids Fomula Bổ Sung Dưỡng Chất Cho Trẻ Từ 3 Tuổi Trở Lên 900G",640000,640000,0,0
TIKI,do-choi-me-be,193418821,"Đồ chơi gỗ cao cấp Bản đồ Việt Nam, kích thích các giác quan của bé, rèn luyện sự khéo léo, đồng thời cho bé làm quen với những kiến thức cơ bản về địa lý Việt Nam - Sản xuất tại Việt Nam",99000,145000,46000,32
TIKI,do-choi-me-be,273156032,"Men vi sinh hỗ trợ tiêu hóa Ildong Hàn ngừa rối loạn tiêu hóa, tăng hấp thụ dinh dưỡng và bổ sung vitamin, khoáng chất từ sữa non - QuaTangMe Extaste",265000,265000,0,0
TIKI,do-choi-me-be,213974796,"Ensure Đức cho người lớn tuổi Ensure Vanille Geschmask - Giúp hồi phục sức khỏe cho người gầy yếu, người suy dinh dưỡng - QuaTangMe Extaste",496000,992000,496000,50
TIKI,do-choi-me-be,24509814,"Bộ đồ chơi rút gỗ Wood Toys loại lớn",37050,39000,1950,5
TIKI,do-choi-me-be,108091465,"Thảm Chơi cho bé Umoo xốp XPE, Dày, Cuộn Tròn, Không Mùi, Không Thấm Nước",650000,780000,130000,17
TIKI,do-choi-me-be,200039253,"Xe Đạp Trẻ Em Nhựa Chợ Lớn 12 inch K106 Dành Cho Bé Từ 2 - 3 tuổi - M1820-X2B",756000,756000,0,0
TIKI,do-choi-me-be,72957942,"Đồ Chơi LEAPFROG Laptop Màu Xanh 80-19150",819000,819000,0,0
TIKI,do-choi-me-be,89463513,"Combo 6 Hộp Sữa đêm gạo sữa Fruto Nyanya 200ml",169344,211680,42336,20
TIKI,do-choi-me-be,178584425,"Bộ quấn áo ngắn bé gái Vàng be đũi xược - AICDBGEQANLZ - AIN Closet",155000,220000,65000,30
TIKI,do-choi-me-be,49276997,"Combo 2 Túi Nước Giặt Xả Maxkleen Hương Nước Hoa Huyền Diệu (2.4kg/túi)",276000,300000,24000,8
TIKI,do-choi-me-be,165938187,"[SIÊU HOT] Nước Hoa HanLu Mẫu Mới Nhất, Xịt Thơm Body HanLu Bear BaBy Hương Nhẹ Nhàng Cho Bé Giúp Chống Muỗi",68000,68000,0,0
TIKI,do-choi-me-be,94688533,"Giày trượt patin Papaison XZY-309 phát sáng 8 bánh, Bánh Cao su cao cấp",649000,649000,0,0
TIKI,do-choi-me-be,171322092,"Quần bé trai, Quần kaki bé trai size đại cho bé đi học đi chơi, có Size  từ 15-35kg",129000,129000,0,0
TIKI,do-choi-me-be,54361765,"Tã/Bỉm Quần Moony Natural Size M- 46 miếng( bé 5-10kg)",286900,286900,0,0
TIKI,do-choi-me-be,2563665,"Bột Ăn Dặm Vinamilk Ridielac Gạo Sữa (200g)",55000,55000,0,0
TIKI,do-choi-me-be,91656731,"Đồ chơi mô hình xe đầu kéo xe xúc và xe xúc đất KAVY NO.8807 gồm 2 xe ( đầu kéo chạy đà, nhựa ABS an toàn bền đẹp)",180000,180000,0,0
TIKI,do-choi-me-be,32311209,"Gối định hình cho bé",219000,284400,65400,23
TIKI,do-choi-me-be,271304593,"Xe Mô Hình Hợp Kim S650, BM-M8-50i, Toyotasupra Đồ Chơi Quà Tặng Trưng Bày",241000,288000,47000,16
TIKI,do-choi-me-be,168232105,"Mũ Bảo Vệ Đầu Cho Bé Tập Bò, Tập Đi Hạn Chế Va Đập Cho Bé",47497,49997,2500,5
TIKI,do-choi-me-be,63516988,"Nôi em bé cao cấp Prota (không có máy đưa nôi)",725000,725000,0,0
TIKI,do-choi-me-be,112970086,"Xe tập đi tròn Thỏ siêu xịn mẫu mới nhất 2021",264000,264000,0,0
TIKI,do-choi-me-be,20267467,"Quần mặc trong váy cho bầu cạp chéo chân ren",42750,45000,2250,5
TIKI,do-choi-me-be,205416813,"Muối Rửa Bát Finish 4.0kg",107600,107600,0,0
TIKI,do-choi-me-be,50388689,"Đầm Bé Gái KIKA Ren Tay K122 - Xanh Nhạt",499000,499000,0,0
TIKI,do-choi-me-be,52109918,"COMBO 3 bộ quần áo Tole lanh Bé Gái | Mẫu Tay Dài cài nút sau |Size 1-14 cho bé 5-38kg| Chất vải tole lanh 2 da loại 1 mềm mịn mát cho bé Gái| Hàng Việt Nam | Đồ bộ bé gái |quần áo trẻ em| Đồ tôn trẻ em",156000,156000,0,0
TIKI,do-choi-me-be,74687385,"Đồ chơi mô hình xe lu KAVY NO.8810 chất liệu hợp kim và nhựa an toàn, chi tiết sắc sảo",82000,82000,0,0
TIKI,do-choi-me-be,805326,"Cháo Ăn Dặm Mabu Hạt Vỡ (400g)",99000,99000,0,0
TIKI,do-choi-me-be,109866598,"Túi đựng sữa mẹ sunmum 250ml (Hộp 50 túi) tặng 2 túi zipper bảo quản",95000,119000,24000,20
TIKI,do-choi-me-be,50422449,"Sản phẩm dinh dưỡng công thức Nestlé NAN SUPREME 3 lon 800g (CÔNG THỨC BỔ SUNG 2HM-O)",549000,549000,0,0
TIKI,do-choi-me-be,59404601,"VÒNG DÂY ĐAI ĐEO TAY DẮT TRẺ EM CHỐNG ĐI LẠC - DÂY LÕI THÉP SIÊU NHẸ - PHÁT SÁNG BUỔI TỐI – DÂY CUỘN LÒ XO GỌN GÀNG - DH2011",135000,135000,0,0
TIKI,do-choi-me-be,37012832,"Viên rửa bát Finish All in one 100 viên",458900,458900,0,0
TIKI,do-choi-me-be,130392474,"Thảm Trải Sàn Cho Bé Xốp XPE 2 Mặt Phủ Silicone Hàn Quốc Mẫu Đẹp Chống Thấm, Chống Va Đập Trơn Trượt-1m8*2m Hàng Chính Hãng MINIIN ",136000,219000,83000,38
TIKI,do-choi-me-be,106542231,"Bàn Cờ Tướng Gỗ Vân không gấp",169000,169000,0,0
TIKI,do-choi-me-be,205290063,"Muối rửa bát Finish 4kg - Muối finish 4.0kg cho Máy rửa bát chén ly, Muối rửa chén finish hay gọi là Muối làm mềm nước Finish gói 1.5kg, 4 kg, 1.2kg",153000,153000,0,0
TIKI,do-choi-me-be,26292675,"Thảm xốp silicone XPE nằm chơi cho Bé- chống nóng, chống trơn trượt và chống nước ( giao hình ngẫu nhiên)",79200,99000,19800,20
TIKI,do-choi-me-be,102107836,"Nước tẩy xi măng Sifa  , nước tẩy gạch vệ sinh nhà cửa cao cấp ",42000,42000,0,0
TIKI,do-choi-me-be,193770955,"Bộ quần áo lửng bé gái họa tiết Baby shark nền vàng cotton - AICDBG2TR9QL - AIN Closet",130000,210000,80000,38
TIKI,do-choi-me-be,113935189,"Xe Tập Đi Bằng Gỗ Con Gà, Xe Đẩy Bằng Gỗ Cho Bé Nhanh Biết Đi",95995,95995,0,0
TIKI,do-choi-me-be,196198488,"Bộ quần áo ngắn họa tiết Nhún đỏ viền caro cotton - AICDBGRHCO0R - AIN Closet",165000,225000,60000,27
TIKI,do-choi-me-be,51875169,"Bộ Đồ Chơi Câu Cá Cho Bé - Bể phao 62*47*7 cm",66599,66599,0,0
TIKI,do-choi-me-be,117829843,"Đồ bộ quần áo trẻ em bé trai chất liệu cotton thấm hút mồ hôi thoáng mát thanh lịch",39000,39000,0,0
TIKI,do-choi-me-be,141789828," Combo 100 túi trữ sữa mẹ Sunmum 250ml (2 hộp) + tặng 2 lót thấm sữa sunmum",153000,153000,0,0
TIKI,do-choi-me-be,37883466,"Muối rửa bát Finish 4.0 kg",255000,255000,0,0
TIKI,do-choi-me-be,179198582,"Combo 6 Gói Trái cây nghiền mix ngẫu nhiên FrutoNyanya 90g/gói",276360,276360,0,0
TIKI,do-choi-me-be,155987378,"Que thử thai bản to 4mm của Traphaco - Allisa - Test nhanh, chính xác - Giao hàng kín đáo, che tên",9000,12000,3000,25
TIKI,do-choi-me-be,180380038,"Nước biển sâu Xisat xịt sạch, thông mũi dành cho trẻ em (75ml)",33000,33000,0,0
TIKI,do-choi-me-be,17463773,"Sữa bột Nutricare Gastro dinh dưỡng y học cho người viêm dạ dày, rối loạn tiêu hoá (900g)",455000,455000,0,0
TIKI,do-choi-me-be,84207896,"Bộ bơi chống nắng toàn thân đẹp cho bé trai và gái, đồ bơi đôi dài tay quần dài trẻ em, có size người lớn để mặc gia đình | BT22",410000,410000,0,0
TIKI,do-choi-me-be,152517175,"Đồ chơi: Ghép Hình Khí Tài Quân Sự - Xe Bọc Thép 131 Chi Tiết DK81059",81000,108000,27000,25
TIKI,do-choi-me-be,54406649,"Combo 5 Quần Bỏ Bỉm Goodmama",177000,177000,0,0
TIKI,do-choi-me-be,181367051,"ING Organic After Balm - Kem Hữu Cơ Thoa Vết Muỗi Và Côn Trùng Đốt - Không Ngứa - Không Sưng Đỏ - Không Sẹo Thâm",369000,369000,0,0
TIKI,do-choi-me-be,150999102,"Set 10 miếng băng keo cá nhân y tế họat hình dễ thương cho bé – I001",20000,20000,0,0
TIKI,do-choi-me-be,19641366,"Cuộn xốp 2m bọc cạnh bàn an toàn cho bé (màu ngẫu nhiên)",25000,25000,0,0
TIKI,do-choi-me-be,25597768,"Sữa bột Nutricare Gastro dinh dưỡng y học cho người viêm dạ dày, rối loạn tiêu hoá 2 Hộp (900g)",925000,925000,0,0
TIKI,do-choi-me-be,184070140,"Áo Hero team đầy đủ nhân vật màu đen",169000,169000,0,0
TIKI,do-choi-me-be,168352541,"Tấm lót chống thấm cho người già Longlife size 50x70cm",199000,199000,0,0
TIKI,do-choi-me-be,95650376,"Túi đựng gối chống trào ngược Rototo bebe chính hãng Hàn Quốc (80x80cm)",115000,128000,13000,10
TIKI,do-choi-me-be,20620548,"Combo 5 bịch khăn vải đa năng likado 300g (kt14x20)",179000,200000,21000,11
TIKI,do-choi-me-be,40366433,"BỘ DỤNG CỤ GẮP RÁY TAI THÔNG MINH CÓ ĐÈN",38999,38999,0,0
TIKI,do-choi-me-be,26089220,"Tranh ghép gỗ 60 mảnh - Đội chó cứu hộ ",27300,27300,0,0
TIKI,do-choi-me-be,39447362," Combo 5 đôi bao tay, bao chân, phụ kiên thời trang sơ sinh 100% cotton, mềm, mịn, thoáng mát, giữ ấm cho bé tốt",78000,78000,0,0
TIKI,do-choi-me-be,205376849,"[HCM] Nước làm bóng chén bát Finish Eco 0% - 400ml/ chai",145000,145000,0,0
TIKI,do-choi-me-be,186199881,"Đồ Bơi Bé Gái Hồng Xinh Tươi BBO29 MayHomes Thun Lạnh Bền Chắc Không Phai Màu Dây Khóa Trước Girl One-Piece Swimwear",176720,188000,11280,6
TIKI,do-choi-me-be,95357521,"Con Quay Có Đèn Trong Suốt",56898,56898,0,0
TIKI,do-choi-me-be,146518353,"Sữa Glico Icreo Balance Milk (Icreo Số 0) - Hộp 10 Thanh Tiện Dụng",114000,114000,0,0
TIKI,do-choi-me-be,104155144,"[MUA LÀ CÓ QUÀ] Bình tập ăn Pigeon 120ml/240ml",65000,72000,7000,10
TIKI,do-choi-me-be,35572705,"Set 2 khăn tắm xô cho bé (kt 120x120cm)",114000,114000,0,0
TIKI,do-choi-me-be,4105713,"Sữa Tắm Gội Cho Trẻ Sơ Sinh Và Em Bé Da Thường Mustela (500ml)",321750,325000,3250,1
TIKI,do-choi-me-be,147349363,"Quần xanh học sinh lưng thun, dây kéo trước, xếp mỗi bên 2 ly, dáng Baggy, size từ 20-85kg, Amazing",101000,160000,59000,37
TIKI,do-choi-me-be,53629279,"Nước tẩy trắng  bồn bệ men sứ, lavabo, bồn rửa , sen vòi inox nhà tắm HT01-TVS-500ML",169000,200000,31000,16
TIKI,do-choi-me-be,89588896,"Set dán móng tay cho bé họa tiết hoạt hình 3D mẫu mới đáng yêu tiện lợi không cần dùng nước – J063",8000,10000,2000,20
TIKI,do-choi-me-be,95035901,"Dinh dưỡng 100% Trái cây nghiền Organic HiPPiS Lê, Táo",60000,60000,0,0
TIKI,do-choi-me-be,53116100,"Thảm nhạc nằm chơi cho bé từ sơ sinh đến 24 tháng, phát nhạc, có khung treo đồ chơi, vải thông thoáng, êm ái",154198,154198,0,0
TIKI,do-choi-me-be,146250772,"Bộ Đồ Chơi Lắp Ghép Xếp Hình Nam Châm 64 Chi Tiết Phát Triển Trí Tuệ",153000,153000,0,0
TIKI,do-choi-me-be,192173058,"Đồ chơi con quay Beyblade 167",120000,120000,0,0
TIKI,do-choi-me-be,46600215,"Hộp kẹp tóc cho bé - Màu cam (Quà tặng đáng yêu cho bé gái) - kèm hộp có quai xách",67000,67000,0,0
TIKI,do-choi-me-be,51513972,"Bộ cờ tướng cỡ lớn kích thước hộp 44x44cm",109000,149000,40000,27
TIKI,do-choi-me-be,21509748,"Áo lót bầu và sau sinh cho con bú- Sunbaby",49600,62000,12400,20
TIKI,do-choi-me-be,51855358,"combo 3 chai Nước làm bóng bát finish 800ml dùng cho máy",396500,396500,0,0
TIKI,do-choi-me-be,129706404,"Gối Ôm Bà Bầu Chữ U vải nhung mềm mại hỗ trợ giảm đau lưng, gối bà bầu đa năng cực tiện hàng cao cấp - Màu Xám Xanh",270000,270000,0,0
TIKI,do-choi-me-be,91882004,"2 Miếng Đá Khô Frozen 1 Fatzbaby FB0020VN",79000,79000,0,0
TIKI,do-choi-me-be,89463566,"Combo 6 Hộp Sữa đêm ngũ cốc Fruto Nyanya 200ml",169344,211680,42336,20
TIKI,do-choi-me-be,10737297,"Khăn Giấy Bỏ Túi Petit Icy Methol Tempo (Lốc 18)",78000,78000,0,0
TIKI,do-choi-me-be,132209270,"Rubik 4x4 - Đồ chơi trí tuệ - DK81084",87500,125000,37500,30
TIKI,do-choi-me-be,88998734,"Xe mô hình mô tô cảnh sát KAVY NO.8808 bằng hợp kim và nhựa có nhạc và đèn",112000,112000,0,0
TIKI,do-choi-me-be,25178683,"Bộ đồ chơi rút gỗ mini 54 thanh ",51000,54000,3000,6
TIKI,do-choi-me-be,89652289,"Dầu bôi đuổi muỗi côn trùng của Thái lan",19000,19000,0,0
TIKI,do-choi-me-be,5448935,"Sữa bột Nutricare Gold Mới phục hồi bồi bổ cơ thể (400g, 900g)",405000,405000,0,0
TIKI,do-choi-me-be,35926891,"Tranh Ghép Gỗ 60 Mảnh Nhiều Mẫu Mới - TẶNG Kèm 1 Túi Zip Đựng Mảnh Ghép",29000,29000,0,0
TIKI,do-choi-me-be,32049452,"Giấy Thơm Quần Áo - Kirkland Fabric Softener Sheets (250 tờ x 1 hộp)",210000,210000,0,0
TIKI,do-choi-me-be,21442721,"Bộ 5 quần lót giấy miễn giặt cho mẹ bầu- Sunbaby",20800,26000,5200,20
TIKI,do-choi-me-be,95082970,"Sữa bột Enfagrow A2 Neuropro 3 dành cho trẻ từ 1 - 6 tuổi – 350g",288000,288000,0,0
TIKI,do-choi-me-be,50072481,"Bộ 170 Chi Tiết Đồ Chơi Lắp Ráp Dạng Ống Sáng Tạo Cho Bé",99000,99000,0,0
TIKI,do-choi-me-be,273595369,"Bộ cờ vua nam châm 25*25cm gấp gọn cao cấp- Hàng Chính Hãng",124000,188000,64000,34
TIKI,do-choi-me-be,15356104,"Thùng 48 Hộp Sữa Bột Pha Sẵn Vinamilk Optimum Gold 110ml",425000,425000,0,0
TIKI,do-choi-me-be,147003827,"Bình tập uống bằng nhựa có ống hút hiệu Philips Avent (300ml/10oz) cho bé từ 12 tháng tuổi 798/00",295000,295000,0,0
TIKI,do-choi-me-be,28604727,"Thẻ bài Lầy - Trò chơi vui nhất dành cho nhóm bạn - Party game",104500,129000,24500,19
TIKI,do-choi-me-be,154492643,"Bột Gạo Lức Đậu Đỏ Mè Đen (Không Đường) Vitapro (350gr) Thơm Ngon Dinh Dưỡng, Hỗ Trợ Giảm Cân, Giảm Cholesterol – Hàng Chính Hãng",59000,59000,0,0
TIKI,do-choi-me-be,130361543,"(VẢI XUẤT DƯ) QUẦN LEGGING DÀI/ QUẦN DÀI TRƠN THUN COTTON 4 CHIỀU CHO BÉ GÁI 9-41KG",119000,119000,0,0
TIKI,do-choi-me-be,34158514,"Combo 15 Nút bịt ổ điện",20000,20000,0,0
TIKI,do-choi-me-be,112101672,"Thùng sữa nước Nutricare Metacare ECO giúp trẻ phát triển toàn diện (110ml)",296000,296000,0,0
TIKI,do-choi-me-be,191726145,"Máy tiệt trùng sấy khô nấu cháo thông minh tích hợp máy hâm sữa - CAPTAIN 2 - FB4315SL",1222000,1222000,0,0
TIKI,do-choi-me-be,71958496,"Kids smart drops dha - siro bổ sung dha dạng nước",350000,350000,0,0
TIKI,do-choi-me-be,175549412,"Viên uống DHA Bio Island cho bà bầu (60 viên)",530000,530000,0,0
TIKI,do-choi-me-be,174252888,"Đồ chơi con quay spiner robot biến hình 6 cánh có đèn led phát sáng",25000,25000,0,0
TIKI,do-choi-me-be,152477312,"Đồ chơi: Ghép Hình Khí Tài Quân Sự - Chiến Đấu Cơ 140 Chi Tiết DK81056",81000,108000,27000,25
TIKI,do-choi-me-be,31824189,"Sữa bột Nutifood DiabetCare Gold 900g – DD cho người bị tiểu đường",549000,549000,0,0
TIKI,do-choi-me-be,84698911,"Nước Tắm Gội Thảo Dược Dr Papie",99000,145000,46000,32
TIKI,do-choi-me-be,129710217,"HOT: Sóc trốn gốc cây XẢ STRESS - Sóc trốn gốc cây silicon co dãn,dẻo đàn hồi ngộ nghĩnh, giải tỏa căng thẳng, xả STRESS",20000,20000,0,0
TIKI,do-choi-me-be,155723630,"Khăn Sữa Unmei 6 lớp 30x30cm - Khăn Lau cho Bé - Khăn Vải Xô - Dày dặn - Thấm Hút Tốt - Màu Trắng Hoa văn ngẫu nhiên",15000,15000,0,0
TIKI,do-choi-me-be,22099539,"Sữa Bột VitaDairy ColosBaby Gold 0+ (800g)",505000,505000,0,0
TIKI,do-choi-me-be,133619577,"Hộp 12 que thử thai Amestick - Tes nhanh, chính xác, đơn giản - Giao hàng kín đáo, che tên",44000,75000,31000,41
TIKI,do-choi-me-be,6464025,"Cháo Tươi Gà Ác Đậu Xanh Cây Thị",23850,27500,3650,13
TIKI,do-choi-me-be,88192153,"Set dán móng tay 3D mẫu mới đáng yêu cho bé gái – J012",9000,10000,1000,10
TIKI,do-choi-me-be,270845411,"Sữa cho bé 1 đến 3 tuổi Meiji Nhật giúp phát triển cân đối chiều cao, cân nặng, trí não - QuaTangMe Extaste",623400,1268000,644600,51
TIKI,do-choi-me-be,180995998,"Kính mát gọng tròn chống tia UV400 phong cách Hàn Quốc dễ thương cho bé",35000,50000,15000,30
TIKI,do-choi-me-be,20106619,"Bộ Cờ Vua Nam Châm Đen Trắng  hút dính đồ chơi trí tuệ, giải trí",39000,39000,0,0
TIKI,do-choi-me-be,73291754,"Bộ Bài Ma Sói Ultimate Deluxe Việt Hoá Bản Dày (Phiên bản mới)",90000,130000,40000,31
TIKI,do-choi-me-be,91389165,"Bộ Đồ Chơi Ô Ăn Quan Việt Nam Bằng Gỗ Board Game Dân Gian Trí Tuệ",155000,219000,64000,29
TIKI,do-choi-me-be,71691342,"NÓN / MŨ BẢO HIỂM CHO BÉ TẬP ĐI/ NGỒI CHO BÉ 8 THÁNG - 5 TUỔI - GIAO MÀU NGẪU NHIÊN",189000,189000,0,0
TIKI,do-choi-me-be,121315462,"Viên rửa chén bát Finish All In One 120 viên - Hàng chính hãng [6 chức năng]",449000,499800,50800,10
TIKI,do-choi-me-be,88792871,"Sticker hình xăm dán chống nước cho bé trai và bé gái nhiều họa tiết ngộ nghĩnh đáng yêu cho bé thỏa sức sáng tạo – SST006",8000,12000,4000,33
TIKI,do-choi-me-be,180855734,"Sữa Tắm Gội Toàn Thân Cho Bé Natural Botanical Pigeon 200ml/500ml",70000,70000,0,0
TIKI,do-choi-me-be,73935895,"Chăn đũi cho bé, Chăn cotton đũi bốn mùa trẻ em nhiều mẫu",59000,59000,0,0
TIKI,do-choi-me-be,1030565,"Khăn Giấy Ướt Hương Thơm Mát, Kháng Khuẩn An Toàn Cho Bé Mamamy (100 Tờ) - Hồng",33000,33000,0,0
TIKI,do-choi-me-be,37545724,"Khăn Tắm Em Bé Sợi Tre Bonny Cỡ Lớn 1m2x1m2 Siêu Mềm Và Thấm Hút (Được Chọn Họa Tiết)",98000,98000,0,0
TIKI,do-choi-me-be,54848249,"Chất Tẩy Rửa Cốc Chén Siêu Sáng Bóng Mao Bao 15g x4 gói",47000,55000,8000,15
TIKI,do-choi-me-be,98103420,"Siro Ăn Ngon BaBy Plus-Cải Thiện Tình Trạng Biếng Ăn Giúp Bé Tăng Cân Khỏe Mạnh",358000,358000,0,0
TIKI,do-choi-me-be,69194167,"Tã quần Bobby - Đệm Lưng Thấm Mồ Hôi XXL56 (56 miếng) - Tặng 8 miếng trong gói",319000,319000,0,0
TIKI,do-choi-me-be,113494050,"Tranh Ghép Hình Hình Ảnh Đa Dạng, Ngộ Nghĩnh Nhiều Chủ Đề Cho Bé( 1 Tranh Hình ngẫu Nhiên) Loại 9 Miếng Ghép Mới 2021",6800,6800,0,0
TIKI,do-choi-me-be,54562562,"Combo 3 gói Khăn Giấy Rút See-U, 2 Lớp, 250 Tờ/gói",72000,72000,0,0
TIKI,do-choi-me-be,131138312,"Tự lắp ráp khủng long - Khủng long bạo chúa DK81087",82500,110000,27500,25
TIKI,do-choi-me-be,89821916,"Lưới bọc quạt in hình cao cấp giữ an toàn cho bé",19000,19000,0,0
TIKI,do-choi-me-be,204745983,"Ecoclean Septic - Men Vi Sinh Xử Lý Hầm Cầu Bể Phốt - Khử mùi, phân hủy chất thải, hết nghẹt hầm, hiệu quả sau 1 đêm - Gói 100g - 1 gói 100g",86000,86000,0,0
TIKI,do-choi-me-be,136387363,"2 Hộp Sữa Bột Meiji 1-3 Growing Up Formula (800g)",1018000,1018000,0,0
TIKI,do-choi-me-be,182739555,"Sữa bột Similac Total Protection 3 cho trẻ 1-2 tuổi 900g",547000,547000,0,0
TIKI,do-choi-me-be,51567691,"Muối rửa bát finish 1.5kg",99000,99000,0,0
TIKI,thiet-bi-kts-phu-kien-so,8286521,"Đế kẹp 2in1 điện thoại máy tính bảng tablet ipad gắn chân máy ảnh tripod",31900,31900,0,0
TIKI,thiet-bi-kts-phu-kien-so,149653443,"Giá Đỡ Tản Nhiệt Laptop/ Máy tính bảng/ Ipad để bàn chất liệu hợp kim nhôm loại cao cấp nhất (Giao màu ngẫu nhiên) - Hàng Chính Hãng ",66100,66100,0,0
TIKI,do-choi-me-be,104806945,"Combo 5 Quần Lót Bé Gái ATUNER QLG023, Quần Chip Đùi Bé Gái 3-10 Tuổi, Vải Cotton Mềm Mại, Thoáng Mát, Kháng Khuẩn, Màu Sắc, Họa Tết Tươi Sáng, Đáng Yêu - Hàng Chính Hãng",279000,345000,66000,19
TIKI,do-choi-me-be,193777844,"Đồ bơi trẻ em, đồ bơi bé gái liền thân dài tay quần dài full body chống nắng bao gồm nón bơi họa tiết kỳ lân cho bé đến 30kg",169000,198920,29920,15
TIKI,do-choi-me-be,46183076,"3 Hộp Sữa bột nguyên kem của NutiFood 900 Gr",539000,539000,0,0
TIKI,thiet-bi-kts-phu-kien-so,67975846,"Giá đỡ kẹp điện thoại cho xe máy/ xe mô tô C2 - Chống trộm, chống rung lắc, dễ dàng lắp đặt - Hàng chính hãng",36600,36600,0,0
TIKI,do-choi-me-be,38064385," COMBO 5 QUẦN DÀI MÀU CHO BÉ MẶC NHÀ 100% cotton",95000,95000,0,0
TIKI,thiet-bi-kts-phu-kien-so,70895043,"      Sạc Dự Phòng 15000mAh Đa Năng 18W Remax RPP-20 - Hàng Chính Hãng",729000,729000,0,0
TIKI,thiet-bi-kts-phu-kien-so,100868879,"Dây Đeo Thay Thế Dành Cho Đồng Hồ Thông Minh Mi Watch Lite / Redmi Watch",110000,110000,0,0
TIKI,thiet-bi-kts-phu-kien-so,196675011,"Tai Nghe Dẫn Xương Huqu HQ-HS2 - Giảm Ồn Hiệu Quả - Hàng Chính Hãng .",780000,780000,0,0
TIKI,thiet-bi-kts-phu-kien-so,113078398,"Hộp Đựng Tai Nghe, Cáp Sạc, Pin Sạc Dự Phòng, Ổ Cứng, Cáp USB, Pin Dự Phòng – Túi Đựng Củ Sạc Điện Thoại Đồng Hồ Thông Minh Bảo Vệ Phụ Kiện Di Động LapTop Hàng Chính Hãng miDoctor",55000,55000,0,0
TIKI,thiet-bi-kts-phu-kien-so,25739052,"Chuột Có Dây Genius DX-110 cổng USB (Màu Đen) - Hàng Nhập Khẩu",125000,125000,0,0
TIKI,do-choi-me-be,104129421,"Ty ngậm đôi Pigeon size M",95000,158000,63000,40
TIKI,do-choi-me-be,171666381,"Cát màu 500g - Cát tô tranh cát giá rẻ túi lớn",10000,10000,0,0
TIKI,thiet-bi-kts-phu-kien-so,96466997,"Chuột Game Có Dây XSmart FREE WOLF V5 LED 7 màu cực đẹp chuyên gaming, siêu bền, chỉnh được dpi - Hàng Chính Hãng",129000,129000,0,0
TIKI,thiet-bi-kts-phu-kien-so,193054094,"Case Silicon dành cho Airpods 1,2/ Airpods Pro/ Airpods 3 Hình Mimion_ Hàng Chính Hãng",99000,99000,0,0
TIKI,do-choi-me-be,168183965,"Khăn Lau Hạ Sốt Dr.Papie 3+ Cho Bé Hạ Nhiệt Giảm Sốt Ngăn Ngừa Co Giật",185000,185000,0,0
TIKI,thiet-bi-kts-phu-kien-so,47270547,"Ốp lưng dẻo mỏng dành cho iPhone 6 / iPhone 6s - Màu đen",45000,45000,0,0
TIKI,thiet-bi-kts-phu-kien-so,51716152,"Bao da caro nữ kiêm ví cao cấp",99000,179000,80000,45
TIKI,thiet-bi-kts-phu-kien-so,21561796,"Tay Cầm Chơi Game Xbox 360 - Trắng",190000,250000,60000,24
TIKI,thiet-bi-kts-phu-kien-so,15198599," Cục Sạc Pin Điện Thoại Đa Năng - màu ngẫu nhiên",25000,25000,0,0
TIKI,do-choi-me-be,192692117,"2 Bộ Hồ Sơ Học Sinh, Sinh Viên ( Mẫu Mới 2021)",25000,25000,0,0
TIKI,thiet-bi-kts-phu-kien-so,74730315,"Tai Nghe Gaming Có Mic Rời xMOWI RX3 Dùng Được Cho Cả Máy Tính Và Điện Thoại - Hàng Chính Hãng",99000,139000,40000,29
TIKI,thiet-bi-kts-phu-kien-so,120364526,"Chuột máy tính gaming SIDOTECH G5S chuyên chơi game Esport đèn Led Rgb / 6 Nút Bấm / DPI 3200 / tuổi thọ 30 triệu lần click cao thiết kế công thái học cho game thủ streamer FPS Moba lướt web thiết kế làm việc văn phòng tương  - Hàng chính hãng",89000,89000,0,0
TIKI,thiet-bi-kts-phu-kien-so,73753804,"Combo RAVPower Củ Sạc Điện Thoại 2 Cổng 30W RP-PC132 + Dây Cáp Sạc Type-C To C RP-CB047 - Hàng Chính Hãng",399000,750000,351000,47
TIKI,thiet-bi-kts-phu-kien-so,6917335,"Bình xịt khí nén vệ sinh bàn phím Macbook",100000,100000,0,0
TIKI,thiet-bi-kts-phu-kien-so,129728774,"Mút đệm tai nghe JBL Tune 500BT",141900,141900,0,0
TIKI,thiet-bi-kts-phu-kien-so,77232030,"Tai nghe gaming có Mic, LED AMOI PC68, Tai nghe chuyên game, Tai nghe siêu bass jack 3.5 cổng USB dùng cho PC/Laptop-Hàng chính hãng",170000,170000,0,0
TIKI,thiet-bi-kts-phu-kien-so,186907112,"[FREE 1 Tháng] Sim MAX DATA 4G VIETNAMOBILE 6GB/Ngày - 180GB/Tháng. Sản Phẩm Độc Quyền VIETNAMOBILE - SIMTHE.VN. Dùng Trên Toàn Quốc - Hàng Chính Hãng",79900,140000,60100,43
TIKI,thiet-bi-kts-phu-kien-so,195891910,"Miếng Lót Chuột Mouse Pad Tròn Dùng Trong Văn Phòng Học Tập Mẫu Hoạt Hình Cute",27550,29000,1450,5
TIKI,thiet-bi-kts-phu-kien-so,130170343,"Cáp Sạc Nhanh Type C SuperVOOC DL129 - Hàng Chính Hãng",133000,133000,0,0
TIKI,thiet-bi-kts-phu-kien-so,33598239,"Ốp lưng chống sốc cho Samsung Galaxy Note 10 Plus hiệu Likgus Crashproof (siêu mỏng, chống chịu mọi va đập) - Hàng nhập khẩu",72706,145412,72706,50
TIKI,thiet-bi-kts-phu-kien-so,173137800,"Thẻ Nhớ Micro SDXC Samsung Evo Plus U3 130MB/s 512GB New - Hàng Nhập Khẩu",850000,850000,0,0
TIKI,thiet-bi-kts-phu-kien-so,57842537,"Củ Sạc Nhanh Cho Iphone Hoco C80 - Hỗ trợ sạc nhanh 20W PD QC3.0 - Hàng Chính Hãng",139000,209000,70000,33
TIKI,thiet-bi-kts-phu-kien-so,96224276,"Tai Nghe Phone Nhét Tai Nghe Nhạc Chơi Game XSmart QKZ AK2 Pro 2021 Mới Nhất Âm Thanh Super Bass, Dây Chống Rối, Có Mic Đàm Thoại Tương Thích Điện Thoại Máy Tính Bảng Laptop PC, Hàng Chính Hãng",99000,99000,0,0
TIKI,thiet-bi-kts-phu-kien-so,76474502,"[Loại Tốt] Bút Chỉ Laser Trình Chiếu Điều Khiển Không Dây Từ Xa KhoNCC-R400 2.4ghz Hàng Chính Hãng Dùng Khi Thuyết Trình PowerPoint - KLVQ-BTC-R400-200 (Đen)",201880,206000,4120,2
TIKI,thiet-bi-kts-phu-kien-so,43349411,"Chuột gaming không dây cao cấp ( màu ngẫu nhiên )",59000,59000,0,0
TIKI,thiet-bi-kts-phu-kien-so,95681214,"Adapter sạc Anker 4 cổng 63W / 45W GaN + PIQ 3.0 PowerPort Atom III Slim Tích Hợp USB Type-C - A2046 - Hàng chính hãng - Đen",1110000,1200000,90000,8
TIKI,thiet-bi-kts-phu-kien-so,74257819,"Tai nghe Bluetooth M9, tai nghe không dây cảm ứng thông minh. âm thanh HiFi trung thực, màn hình hiển thị sắc nét, tích hợp thêm đèn pin soi sáng- Hàng nhập khẩu",230000,230000,0,0
TIKI,thiet-bi-kts-phu-kien-so,160664361,"Bộ Hub QGeeM USB-C 4 trong1, 1xHDMI 4K, 1xUSB-C 100W PD Charger, 1xUSB 3.0, 1xUSB 2.0, tương thích với MacBook Pro, Dell XPS, iPad Pro, Type-C Adapter - Hàng Chính Hãng",243000,243000,0,0
TIKI,thiet-bi-kts-phu-kien-so,90082542,"Tai nghe bluetooth Lanith F9 Pro 5.0 - Tai nghe nhét tai kết nối không dây phiên bản quốc tế - Âm bass êm và sâu, chip AIC chống gây chói tai - Thiết kế thời thượng, hiện đại - Hàng nhập khẩu - TAI0F9PRO",78000,149000,71000,48
TIKI,thiet-bi-kts-phu-kien-so,214154015,"Giá Đỡ Dành Cho Điện Thoại, Máy Tính Bảng Chất Liệu Hợp Kim Nhôm Cao Cấp Model T002 - Hàng Chính Hãng Tamayoko",249000,259000,10000,4
TIKI,thiet-bi-kts-phu-kien-so,195444597,"Thẻ Nhớ MicroSDXC SanDisk Extreme V30 A2 128GB 190MB/s SDSQXAA-128G (New 2022) - Hàng Nhập Khẩu",315000,315000,0,0
TIKI,thiet-bi-kts-phu-kien-so,52889826,"Tai Nghe Bluetooth Không Dây 5.0, AMOI F9, Cảm Ứng Vân Tay, Màn Led Báo Pin, Kháng Nước, Chống Ồn, Âm Thanh Cực Chất - Hàng Nhập Khẩu",64000,78000,14000,18
TIKI,thiet-bi-kts-phu-kien-so,73188683,"Giá Đỡ Máy Tính, Laptop, iPad, Macbook Hợp Kim Nhôm Cao Cấp. Hỗ Trợ Tản Nhiệt Chống Mỏi Cổ, Vai, Gáy. Hàng Chính Hãng Tamayoko",279000,279000,0,0
TIKI,thiet-bi-kts-phu-kien-so,96230088,"Lót chuột XSmart đẹp, pad bàn di mouse 21 * 25cm độ dày 2mm đa dạng hình game, giao hàng ngẫu nhiên, may viền chắc chắn, Chính Hãng",9000,9000,0,0
TIKI,thiet-bi-kts-phu-kien-so,193638840,"Vang số chỉnh cơ Acnos Mi30 – Kết hợp 2 micro không dây UHF – Đầy đủ kết nối bluetooth, Optical (cổng quang), AUX – Thiết kế nhỏ gọn, sử dụng nguồn 5V dễ dàng di chuyển mọi nơi – Kết nối dễ dàng với mọi thiết bị âm thanh – Hàng chính hãng",1890000,1890000,0,0
TIKI,thiet-bi-kts-phu-kien-so,15232225,"Loa Vi Tính Mini D-02A 2.0",40510,40510,0,0
TIKI,do-choi-me-be,176380437,"Bộ Bài Tây Mạ Vàng",33250,35000,1750,5
TIKI,do-choi-me-be,29552845,"Đồ chơi lắp ghép xếp hình Siêu Robot khủng long  6 trong 1 Qman 1414",299000,299000,0,0
TIKI,do-choi-me-be,45262820,"Bộ cờ Vua nam châm Quân Nhũ Bạc Vàng cao cấp  - 16.5 x 16.5 cm",100000,100000,0,0
TIKI,do-choi-me-be,194133876,"Đồ chơi gỗ cao cấp Đường luồn đôi, giúp bé rèn luyện tính khéo léo, tỉ mỉ và chính xác khả năng quan sát phối hợp tốt giữa tay và mắt, hỗ trợ phân biệt màu sắc - Sản xuất tại Việt Nam",155000,219000,64000,29
TIKI,do-choi-me-be,51509874,"Bộ cờ vua cao cấp hộp lớn 42x42cm đồ chơi trí tuệ giải trí",125000,164000,39000,24
TIKI,do-choi-me-be,152465544,"GHÉP HÌNH 4 MÙA - MÙA ĐÔNG 24 CHI TIẾT DK81077",95200,136000,40800,30
TIKI,do-choi-me-be,48012718,"Bộ Đồ Chơi Bác Sĩ - Màu Xanh Có Đèn Và Âm Thanh Giả Lập DUKA - 660-67",182500,250000,67500,27
TIKI,do-choi-me-be,193788048,"Mô hình giấy 3D mô hình lắp ráp SCAR-Ll tỉ lệ 1:1",56050,56050,0,0
TIKI,do-choi-me-be,56094336,"Bộ 10 Nút Che Ổ Điện Dài 2.5 CM Thiết Kế Vừa Khít Ổ Cắm Điện An Toàn Cho Bé Và Gia Đình",6605,9026,2421,27
TIKI,do-choi-me-be,1347579,"Phấn Gạo Chống Hăm, Rôm, Sảy, Da Khô Hương Hoa Cỏ ReisCare Floral Sweet (50g)",64900,64900,0,0
TIKI,do-choi-me-be,183913622,"(chính hãng) 01 van chân không / van lưỡi gà máy hút sữa fatzbaby Resonance 3",26000,26000,0,0
TIKI,do-choi-me-be,158783421,"Xếp Hình 25 - 45 Chi Tiết Shop Giao Mẫu Ngẫu Nhiên",15000,15000,0,0
TIKI,do-choi-me-be,76776189,"Đồ Chơi Xe Tải Hali, Đồ Chơi Châu Âu, An Toàn, Phát Triển Tư Duy, Sáng Tạo Cho bé - Polesie Toys 3294",199000,199000,0,0
TIKI,do-choi-me-be,56314975,"Máy đưa võng /đưa nôi tự động cho bé - sức đưa 100kg",380000,380000,0,0
TIKI,do-choi-me-be,83387667," Nước hoa xịt phòng cao cấp 500ml - Sản xuất bởi Hando Việt Nam",35000,35000,0,0
TIKI,do-choi-me-be,479467,"Cân Bập Bênh Winwintoys 61072",88000,88000,0,0
TIKI,do-choi-me-be,117477504,"Gấu bông heo ôm bình sữa siêu dễ thương – Quà tặng thú nhồi bông lợn má phệ bú bình – Size từ 40 cm đến 80 cm – Gối ôm heo milk cho bé ngủ ngon",142000,225000,83000,37
TIKI,do-choi-me-be,19802553,"Dầu gội & xả trẻ em Milmil Kids hương Vani 500ml tặng kèm móc khóa",103550,109000,5450,5
TIKI,do-choi-me-be,172686603,"COMBO 2 Nước Tẩy TRẮNG QUẦN ÁO Javel LIX 2Kgx2",115000,115000,0,0
TIKI,do-choi-me-be,145678655,"Áo Nỉ Bông Cho bé, Áo Nỉ Bông Master 1 Lớp Dày Dặn Cho Bé Trai Và Bé Gái - Moon House",79000,79000,0,0
TIKI,do-choi-me-be,103265658,"Đồ chơi thông minh, Đồ chơi Domino Cờ Các Nước bằng gỗ",93000,93000,0,0
TIKI,do-choi-me-be,52393121,"Tẩy mốc tường, mốc quần áo đậm đặc HT01-5LIT (dùng cho nhà nghỉ, khách sạn, giặt là, vệ sinh công nghiệp...)",199000,220000,21000,10
TIKI,do-choi-me-be,160269937,"Bút Ký Nhật Bản Pentel Energel BLN75 / BL77 / BL80 ngòi 0.5 0.7 1.0",42000,42000,0,0
TIKI,do-choi-me-be,192127454,"Nôi gấp gọn cho bé KAWAII HOME, Nôi em bé sơ sinh - Bảo hành 12 tháng (TẶNG: Nệm + Màn)",939000,939000,0,0
TIKI,do-choi-me-be,76199379,"Xe Đạp Trẻ Em Nhựa Chợ Lớn K85 - K86 - K87 - K89 - K90",981000,981000,0,0
TIKI,do-choi-me-be,4618495,"Chai nước hoa xịt thơm phòng khử mùi Hando 200ml",20000,20000,0,0
TIKI,do-choi-me-be,41300533,"Đồ chơi mô hình Pokemon vui nhộn (24 chi tiết)",59000,79000,20000,25
TIKI,do-choi-me-be,66400819,"Nón kết mềm cho bé trai gắn logo lốc xoáy kèm nhiều sò cao cấp, dành cho các bé từ 1 đến 3 tuổi - Trắng",125000,125000,0,0
TIKI,do-choi-me-be,56751312,"Đồ Bộ Thun Có Tay In 3D cho bé trai hình xe đua",139000,240000,101000,42
TIKI,do-choi-me-be,58718784,"Bộ tranh xếp hình jigsaw puzzle cao cấp 1000 mảnh ghép – Hội An, Việt Nam",201000,280000,79000,28
TIKI,do-choi-me-be,70637195,"Túi 46 viên giặt xả Gelball 3D màu Xanh Dương Nội địa NHẬT BẢN",269000,269000,0,0
TIKI,do-choi-me-be,66587571,"Nước Lau Sàn Hữu Cơ Bồ Hòn Ecocare - 100% thực vật, tinh dầu khử mùi, đuổi muỗi, chống trượt, kháng khuẩn - Chai 2000ml",124000,128000,4000,3
TIKI,do-choi-me-be,154533194,"Bột Gạo Lức Mè Đen Vitapro 300gr, Thơm Ngon Uống Liền – Hàng Chính Hãng",41000,41000,0,0
TIKI,do-choi-me-be,7678272,"Viên giặt quấn áo siêu sạch thơm mát nhập khẩu Nhật Bản",105000,105000,0,0
TIKI,do-choi-me-be,148680448,"Lều Công Chúa Cho Bé Cao Cấp - Lều Ngôi Nhà Vui Chơi - Lều Cắm Trại Công Chúa Hoàng Tử",273000,273000,0,0
TIKI,do-choi-me-be,133817290,"Địu 4 tư thế , Đai Địu Em Bé Sơ Sinh Mua Ngay Địu Em Bé Đa Năng 4 Tư Thế Việt Nam Xk 100% Cotton Mềm Mại",71999,71999,0,0
TIKI,do-choi-me-be,183727568,"Tranh xếp Hình Tia Sáng Trang viên Ánh Sáng(925 mảnh ghép)",129500,129500,0,0
TIKI,do-choi-me-be,111443392,"Bộ body sơ sinh liền tất, tay lật vải tre (Bamboo) cao cấp BB034, sleepsuit cho bé, set body dài tay cho bé sơ sinh chính hãng HAKI",195000,219000,24000,11
TIKI,do-choi-me-be,108957913,"Combo 5 Gói Khăn Vải Khô Đa Năng AIKO - Gói 300g",175000,175000,0,0
TIKI,do-choi-me-be,165070054,"(TẶNG BỘ Ô TÔ ĐỒ CHƠI) Combo 2 lon sữa mát tăng cân, cải thiện biếng ăn Babego 12-36 tháng",1040000,1040000,0,0
TIKI,do-choi-me-be,180993333,"CẦU TRƯỢT TRẺ EM CÓ THÊM MÁNG NỐI DÀI TẶNG KÈM BÓNG RỔ",459000,459000,0,0
TIKI,do-choi-me-be,51599206,"Gối Ôm Chữ U Đa Năng cho Bà Bầu - Gối Ngủ cho Mẹ Bầu chính hãng Zcare - chứng nhận Độc Quyền bởi bộ Khoa học công nghệ; Gối bà bầu có hình chữ U nâng đỡ 6 điểm, giúp bà bầu thoải mái khi ngủ; Gối chuyên dụng cho bà bầu nên các nguyên vật liệu an toàn và c",619000,619000,0,0
TIKI,do-choi-me-be,94790055,"Áo khoác bé gái Cúc xanh kaki mềm - AICDBG6YZYSQ - AIN Closet",235000,260000,25000,10
TIKI,do-choi-me-be,88001293,"Bóng nhựa mềm 5.5cm (100 bóng,50 bóng,20 bóng)",14000,14000,0,0
TIKI,do-choi-me-be,145389002,"BỘ ĐỒ CHƠI NẤU ĂN 36 MÓN PLAY HOUSE CHO BÉ",129000,129000,0,0
TIKI,do-choi-me-be,51953436,"Combo Viên rửa bát Finish 110 viên+Nước làm bóng finish 800ml dùng cho máy rửa bát",468322,632000,163678,26
TIKI,do-choi-me-be,168479576,"Bàn chải đánh răng Colgate họa tiết Batman dành cho trẻ",33000,36000,3000,8
TIKI,do-choi-me-be,152475770,"Ghép hình lực lượng cảnh sát - xe cứu hộ 146 chi tiết DK81064",81000,108000,27000,25
TIKI,do-choi-me-be,118989260,"BẢNG CHỮ CÁI TIẾNG VIỆT BẰNG GỖ CAO CẤP",119000,119000,0,0
TIKI,do-choi-me-be,13408700,"Mô Hình Xe Harley Davidson 2015 Street Glide Special Black 1:12 Maisto MH-32328",369000,369000,0,0
TIKI,do-choi-me-be,16611348,"Bộ đồ chơi phát triển tư duy cho bé ",33600,33600,0,0
TIKI,do-choi-me-be,90143580,"Kem Bôi Da Chống Hăm Ngăn Ngừa Rôm Sảy Cho Bé Oribebe Giúp Dưỡng Ẩm Và Làm Mịn Da Bé - An Toàn Cho Da Nhạy Cảm",98000,109000,11000,10
TIKI,do-choi-me-be,4775257,"Sữa Nutricare Care 100 Gold cho trẻ biếng ăn suy dinh dưỡng 1-10 tuổi (900g)",340000,340000,0,0
TIKI,do-choi-me-be,158409197,"Xếp Hình Gỗ Khám Phá cho bé 2+ - 3+ Mideer & TOI",289000,289000,0,0
TIKI,do-choi-me-be,116300265,"Gối ôm bà bầu chữ U vải nhung và cotton cao cấp",265000,265000,0,0
TIKI,do-choi-me-be,76472933,"Đồ chơi SLIMY Slime kỳ lân ánh kim-vàng hồng 33911/YE-PK",119000,119000,0,0
TIKI,do-choi-me-be,58719908,"Bộ 4 sách vải song ngữ ANH - VIỆT kích thích thị giác cho bé sơ sinh dưới 1 tuổi (PiPô Việt Nam)",80000,80000,0,0
TIKI,do-choi-me-be,147920050,"Bộ Xếp Hình Lắp Ráp Qman 479 Mảnh Robot Người Máy Kĩ Thuật 1417 Cho Trẻ Từ 6 Tuổi",259000,259000,0,0
TIKI,do-choi-me-be,205293575,"Nước làm bóng Finish 750 ml+ muối rửa bát Finish 1200 g",129000,129000,0,0
TIKI,do-choi-me-be,114783359,"Đồ chơi rút gỗ màu, xếp hình domino loại size to 48",68000,68000,0,0
TIKI,do-choi-me-be,109955676,"Quây bóng lều chơi bóng cho bé, Nhà bóng cho bé khung inox chữ nhật tặng 100 quả bóng",140000,140000,0,0
TIKI,do-choi-me-be,85763973,"Nôi cũi trẻ em, nôi vải cho bé từ sơ sinh.  Có màn, có thể ghép cạnh giường cha mẹ, gấp gọn, giỏ đựng đồ tầng dưới",1599000,1599000,0,0
TIKI,do-choi-me-be,127527778,"Balo Mẫu Giáo Dành Cho Bé Trai Mr Vui 876",231000,265000,34000,13
TIKI,do-choi-me-be,66608827,"Bộ bé trai công tử, set sơmi quần âu kèm dây đai lịch lãm, dùng cho sinh nhật, sự kiện, dịp lễ tết | MB10",330000,330000,0,0
TIKI,do-choi-me-be,47153712,"Cờ Domino Gỗ Walnut Kết Hợp Da Bò Sáp Cao Cấp - The Craft House",962200,962200,0,0
TIKI,do-choi-me-be,51110091,"Bộ 2 Khóa Cửa Tủ An Toàn Cho Bé - Nhiều Loại",50000,50000,0,0
TIKI,do-choi-me-be,1473453,"Mô Hình Máy Bay Trưng Bày Boeing 747 Klm Airlines Everfly",169000,169000,0,0
TIKI,do-choi-me-be,145678780,"Bộ đồ ngủ cho bé trai bé gái mặc đều xinh, Đồ bộ Pijama in hình cute cho bé từ 9-28kg Moon House",119000,119000,0,0
TIKI,do-choi-me-be,176146243,"Bộ đồ bé trai cộc tay vải đũi quần đũi in hình Suzuku Cực Mát Cho Bé Từ 7-26kg",111800,111800,0,0
TIKI,do-choi-me-be,48083480,"ĐỒ CHƠI LÒ XO CẦU VÒNG  (7cm x 7cm x 7cm)",15000,15000,0,0
TIKI,do-choi-me-be,103812916,"Yếm tròn xoay hình thú cho bé, cotton 100%, style Hàn quốc cho bé",109000,109000,0,0
TIKI,do-choi-me-be,43237770,"Bình sữa cổ rộng McGOLDSON Premium 180ml",185400,206000,20600,10
TIKI,do-choi-me-be,246161713,"Tranh xếp hình bằng giấy, đồ chơi xếp hình 30 mảnh (A4) cho bé từ 3 tuổi - Chứng nhận hợp quy Tia Sáng thuộc loại sản phẩm: Xếp hình số mảnh ghép lên đến 250 mảnh. Số hiệu kiểu loại: Xếp hình",19000,19000,0,0
TIKI,do-choi-me-be,1715279,"Bình Xịt Côn Trùng Jumbo Vape Super A1 Hương Lavender 100712618 (600ml)",61000,61000,0,0
TIKI,do-choi-me-be,88769864,"Bộ cờ vua nam chân loại 25*25*2cm - HENRYSA",125000,186000,61000,33
TIKI,do-choi-me-be,122910442,"Muối Rửa Bát Finish 4.0kg",105000,105000,0,0
TIKI,do-choi-me-be,19700480,"Bộ 12 ngựa Pony loại cao 6-7cm",115000,115000,0,0
TIKI,do-choi-me-be,132201095,"Rubik 2x2 Mã  DK81082",50000,68000,18000,26
TIKI,do-choi-me-be,100586366,"Tã Quần Siêu Mỏng UniDry Ultrathin Gói Cực Đại Size M74 (74 miếng)",298000,389000,91000,23
TIKI,do-choi-me-be,114260590,"Áo thun thể dục thương hiệu Amazing cho bé gái, cổ bẻ và cổ tròn, đồng phục thể thao cho học sinh nam nữ các cấp",59000,94000,35000,37
TIKI,do-choi-me-be,13372458,"Bộ Quần Áo Trẻ Em In 3D Gấu TP0031",139000,240000,101000,42
TIKI,do-choi-me-be,114363128,"Rubik tam giác Pyraminx",105000,105000,0,0
TIKI,do-choi-me-be,201926880,"Gối chữ u - Gối chặn cho bé chống chào ngược, méo đầu khi ngủ",179000,179000,0,0
TIKI,do-choi-me-be,107311314,"Búp bê 2019 2017 2018 2020 Holiday Barbie Doll model muse chính hãng",900000,900000,0,0
TIKI,do-choi-me-be,93225430,"Trò xếp gỗ hình khối cao thấp | Đồ chơi xây lắp xếp khối hình học bằng gỗ",179000,179000,0,0
TIKI,do-choi-me-be,87521738,"Trò chơi Board Game Talk, Flirt and Dare cho các cặp đôi",350000,350000,0,0
TIKI,do-choi-me-be,172269332,"Đồ chơi đánh đàn loại đẹp nhiều phím kèm mic hát cho bé tập làm ca sĩ",148000,148000,0,0
TIKI,do-choi-me-be,190539188,"Combo 10 con Lật đật mini, đồ chơi lật đật mini cho bé cute dễ thương giá rẻ 10 mẫu khác nhau",15000,15000,0,0
TIKI,do-choi-me-be,161925317,"Bộ sơ sinh cài giữa tay dài vải visco siêu mềm mại cho bé",95000,95000,0,0
TIKI,do-choi-me-be,77730568,"Thanh nối cầu thang, nối chắn cửa 7cm, 14cm, 21cm, 28cm... 77cm, 80cm",250000,250000,0,0
TIKI,do-choi-me-be,188835548,"Sữa bột Gluvita Gold – Dinh dưỡng dành cho người bệnh ĐÁI THÁO ĐƯỜNG 900G",539000,539000,0,0
TIKI,do-choi-me-be,29362805,"Combo 6 Quần bỏ bĩm Goodmama - 6 lớp cho bé từ 5-18kg",212000,212000,0,0
TIKI,do-choi-me-be,74561065,"SỮA TẮM GỘI TOÀN THÂN TRẺ EM  MISTINE  KIDDY HEAD TO TOE BATH STAWBERRY",149000,149000,0,0
TIKI,do-choi-me-be,163029675,"Mặt nạ giấy bồi quà cho bé vẽ trang trí combo 10 cái",90000,90000,0,0
TIKI,do-choi-me-be,83438534,"Đầm Thun cho bé gái hình Elsa",139000,200000,61000,31
TIKI,do-choi-me-be,52130455,"Bảng bận rộn mini",198750,265000,66250,25
TIKI,do-choi-me-be,26098065,"Combo Tinh dầu xịt phòng chanh sả 100ml + Lọ treo tinh dầu chanh sả",122550,129000,6450,5
TIKI,do-choi-me-be,86406635,"Đồ chơi giáo dục sớm thả hình khối có quai xách cho bé Toyshouse 0702-TH-HE0218. - BPA free",95000,129000,34000,26
TIKI,do-choi-me-be,73228364,"Khăn khô khử khuẩn McGOLDSON-St.Bro 310g",44100,49000,4900,10
TIKI,do-choi-me-be,262673461,"Sữa dinh dưỡng Morinaga Nutritional Milk Powder PLUS 200g",420000,445000,25000,6
TIKI,do-choi-me-be,51637879,"Nón beret cho bé yêu mỏ cụt độc đáo, dành cho các bé từ 1 đến 3 tuổi, dễ dàng tăng giảm size theo cỡ đầu của bé",33000,33000,0,0
TIKI,do-choi-me-be,40443862,"Nước Giặt Xả Quần Áo Em Bé Docilee 2IN1 Xanh 3000ml ",160000,160000,0,0
TIKI,do-choi-me-be,193274042,"[Kèm Video] Mắt Kính Trẻ Em SiPU Chính Hãng Cao Cấp MK26 Chống UV400 + Chống gãy - Bé Trai Bé Gái (Kèm Hộp Ô Tô)",169000,169000,0,0
TIKI,do-choi-me-be,45825606,"Đồ chơi đập bóng 4 quả màu sắc - Đồ chơi gỗ",50000,50000,0,0
TIKI,do-choi-me-be,755385,"Bàn 3T1 Nhỏ Liên Hiệp Thành B31NVCCN (Vây - Caro - Cá Ngựa) ",91000,91000,0,0
TIKI,do-choi-me-be,192878866,"Gấu bông cáo đuôi dài cực đẹp - Thú nhồi bông siêu dễ thương",360000,590000,230000,39
TIKI,do-choi-me-be,32001950,"Xe trượt scooter 3 bánh cho bé(giao màu ngẫu nhiên)",175672,175672,0,0
TIKI,do-choi-me-be,188189577,"Khăn Xô Tắm Xô 2 Lớp In Hình Unmei Kích Thước 80x85cm, Dùng Để Lau Mình, Quấn Cho Bé",55000,55000,0,0
TIKI,do-choi-me-be,14518614,"Hộp phụ kiện kẹp tóc 18 chi tiết phong cách Hàn Quốc cho bé",51300,51300,0,0
TIKI,do-choi-me-be,123532979,"Thảm Maboshi LOẠI 1",89000,89000,0,0
TIKI,do-choi-me-be,124276385,"Chat Bột Thông Cống Cực Mạnh Nhật Bản Loại Lớn 268gr",30400,32000,1600,5
TIKI,do-choi-me-be,8078786,"Tranh xếp Hình Tia Sáng Đất Nước Hà Lan (2035 Mảnh Ghép)",187000,247000,60000,24
TIKI,do-choi-me-be,142872653,"Bộ xếp hình nam châm cho bé 64 chi tiết Magnetic Stick, đồ chơi giáo dục,  phát triển tư duy, trí thông minh cho bé",175000,175000,0,0
TIKI,do-choi-me-be,65028610,"Combo 10 Gói Khăn Ướt Max Cool 25 Tờ Hương Trà Xanh ( 25 Tờ x 10 )",89000,137000,48000,35
TIKI,do-choi-me-be,138907432,"Combo 2 hộp sữa bột Hi-CANXI của hãng GIGO giành cho người trưởng thành ngăn ngừa loãng xương, tiểu đường-> tặng khăn mềm mịn",480000,760000,280000,37
TIKI,do-choi-me-be,53978253,"Súng thông tắc cống đa năng - Dụng cụ thông tắc bồn cầu",310000,310000,0,0
TIKI,do-choi-me-be,22428358,"Set 5 Khăn Sữa 6 Lớp Vải Xô Nhăn Mềm Thấm Hút Tốt Hàng Cao Cấp",50000,50000,0,0
TIKI,do-choi-me-be,154993721,"Gấu Bông Heo Ngủ Mắt Hip Siêu Mềm Size 40cm/80cm - Đồ Chơi Thú Bông Heo Mắt Hip Ngủ Lờ Đờ",125000,125000,0,0
TIKI,do-choi-me-be,38063911,"SET 5 QUẦN DÀI TRẮNG  SƠ SINH",79000,79000,0,0
TIKI,do-choi-me-be,138910820,"ĐỒ CHƠI TÀU HOẢ ÔNG GIÀ NOEL CHẠY TRÊN ĐƯỜNG RAY,SET QUÀ TẶNG NOEL CỰC CHẤT",195000,195000,0,0
TIKI,do-choi-me-be,14929781,"Bình Tập Uống Cho Trẻ Philips Avent 551.05 (200ml) - Màu Xanh",250000,250000,0,0
TIKI,do-choi-me-be,184589109,"Bảng chữ cái cho bé bằng gỗ, đồ chơi giáo dục giúp trẻ học nhanh các chữ cái và số",44000,44000,0,0
TIKI,do-choi-me-be,143117551,"Bộ Đồ Chơi Lắp Ghép STEAM Robot Kéo Xe, Đồ Chơi Gỗ Cao Cấp Robot Kéo Xe, Đồ Chơi Khoa Học Tự Làm DIY Wood Steam-Chính Hãng BABYBOSS + Tặng Kèm Tranh Ghép Gỗ",60000,90000,30000,33
TIKI,do-choi-me-be,75752949,"Nước xả vải khô tinh dầu Comfort Sona",42000,42000,0,0
TIKI,do-choi-me-be,172482945,"[Size Gốc] Bài Tarot Clow Sakura CardRaptor Phiên Bản Màu Nâu Tặng Đá Thanh Tẩy Và Link Hướng Dẫn Tiếng Việt",100000,100000,0,0
TIKI,do-choi-me-be,145678087,"Bộ Đồ Ngủ Cho Bé, Bộ Pijama Chất Đũi Dài Tay Cho Bé, Bộ Đồ Ngủ Nhà Cực Xinh Cho Bé Trai Và Bé Gái",109000,109000,0,0
TIKI,do-choi-me-be,89652206,"Ghế gội đầu cỡ đại cho bé",140000,140000,0,0
TIKI,do-choi-me-be,137002716,"Đàn Tơ Rưng 8 Thanh Bằng Gỗ Cho Bé - Đồ Chơi Nhạc Cụ Cho Bé - Miễn Phí Vận Chuyển",37000,37000,0,0
TIKI,do-choi-me-be,127785500,"Combo Nôi Tre & Nệm Bọc Nôi 60x90( Cho Bé Từ 0-18 tháng)",235000,235000,0,0
TIKI,do-choi-me-be,68108221,"Bộ quần áo sơ sinh cho bé vải bamboo + cotton mềm mịn cao cấp - đồ sơ sinh cho bé (6kg - 12kg) - bộ dài tay cho bé - thiết kế vai chồm Haki BB013",196000,220000,24000,11
TIKI,do-choi-me-be,58799159,"Bảng Viết, Vẽ Thông Minh Tự Xóa VNBoard Đa Sắc 8.5 inch",220000,220000,0,0
TIKI,do-choi-me-be,58837842,"Bộ tranh xếp hình jigsaw puzzle cao cấp 1000 mảnh ghép – Thị Trấn Hallstatt, Áo",201000,280000,79000,28
TIKI,do-choi-me-be,106771008,"Máy báo khóc Corky Baby MBK601 – 4.3inh – Bản nâng cấp đáng giá 2021",1990000,1990000,0,0
TIKI,do-choi-me-be,104155209,"Bình uống nước tay cầm có ống hút Pigeon 330ml (HSD 06/2024)",190000,316000,126000,40
TIKI,do-choi-me-be,70520391,"Bộ Chăm Sóc Love Mom, Khử Mùi Vùng Kín Và Dưỡng Trắng Da Body Wonmom (1 Hộp Thảo Mộc Xông Vùng Kín + 1 Cốt Nghệ Hạ Thổ)",275000,275000,0,0
TIKI,do-choi-me-be,8029359,"Rubik YJ Guanhu Megaminx",121505,127900,6395,5
TIKI,do-choi-me-be,197347620,"Balo học sinh cấp 1 và 2 siêu nhẹ chống gù chống nước cao cấp phong cách mới",513000,570000,57000,10
TIKI,do-choi-me-be,49884586,"Sữa Morinaga Số 1 - Hagukumi (320g)",234000,234000,0,0
TIKI,do-choi-me-be,79671794,"Túi Nước Giặt Lix Siêu Sạch Hương Hoa Anh Đào 2.4Kg N2502 - Tẩy Sạch Vết Bẩn Cực Mạnh",80000,80000,0,0
TIKI,do-choi-me-be,188175360,"Khăn Tắm Xô Unmei  100% Cotton 4 Lớp Kích Thước 75x80 - Giao Viền Ngẫu Nhiên",49000,49000,0,0
TIKI,do-choi-me-be,179206519,"Quần chục bé gái nhiều họa tiết ngẫu nhiên cho bé tiện thay đổi MamLa",15000,15000,0,0
TIKI,do-choi-me-be,30065305,"Thú nhồi bông gối ôm ếch xanh 66cm BA00055",140000,140000,0,0
TIKI,do-choi-me-be,173439526,"Đồ bơi bé gái đi biển 2 mảnh tay ngắn quần rời cho bé gái đến 8 tuổi",189000,198000,9000,5
TIKI,do-choi-me-be,99199487,"Ba lô - Cặp Sách Đi Học Cho Bé Trai In Hình Nổi 3D-38cmx28cmx16cm",209000,209000,0,0
TIKI,do-choi-me-be,57839451,"Đồ Chơi Rút Gỗ 48 Thanh Mộc",66000,66000,0,0
TIKI,do-choi-me-be,176937785,"Chổi cọ bình và núm ty Medela - 2 đầu cọ bình và núm ty riêng biệt, có đế dựng thẳng",195000,195000,0,0
TIKI,do-choi-me-be,20878893,"Set 4 Quần Lót Bầu Cotton Cao Cấp QLB01",101000,101000,0,0
TIKI,do-choi-me-be,248396007,"Đồ chơi lắp ráp xe cứu hỏa, cánh sát, máy bay trực thăng, cứu thương, xe công trình nhiều chi tiết",65000,65000,0,0
TIKI,do-choi-me-be,250029875,"Đũa phép thuật Harry potter tạo ra lửa phép thuật",550000,550000,0,0
TIKI,do-choi-me-be,131174711,"Đồ chơi tự lắp ráp khủng long - Khủng long ba sừng DK81088",82500,110000,27500,25
TIKI,do-choi-me-be,146249312,"(Gói 10 viên) Viên Thả Bồn Cầu Khử Mùi, Tự làm sạch, dễ nhìn Hàn Quốc",8000,12000,4000,33
TIKI,do-choi-me-be,12080528,"Đồ Chơi Dinosauria Mô Hình Khủng Long Bay Lượn Thời Tiền Sử New4all 8018",139000,189000,50000,26
TIKI,do-choi-me-be,83489556,"Đồ Bộ Thun Có Tay In 3D cho bé trai hình Spiderman",139000,240000,101000,42
TIKI,do-choi-me-be,11256698,"Bộ Cờ Vua Bằng Gỗ + Hộp Đựng Kiêm Bàn Cờ",119000,119000,0,0
TIKI,do-choi-me-be,100181872," Bộ đồ chơi cờ ô ăn quan 6 trong 1",90000,90000,0,0
TIKI,do-choi-me-be,71537999,"	 Bộ body cài giữa phối nửa thân vải sợi tre cao cấp BB029 HAKI",187000,210000,23000,11
TIKI,do-choi-me-be,192794234,"Nước rửa chén siêu sạch chanh 1,4kg NS140 sạch bóng vết dầu mỡ hương chanh thơm mát",45000,45000,0,0
TIKI,do-choi-me-be,107016385,"Đồ Chơi Cắt Rau Quả - Susu",90000,120000,30000,25
TIKI,do-choi-me-be,186862710,"Bộ quần áo dài bé gái họa tiết Hoa caro đỏ cotton - AICDBGMDMQAQ - AIN Closet",155000,210000,55000,26
TIKI,do-choi-me-be,202606089,"Xe Lắc Nhựa Chợ Lớn hình Chú Ong Con (Có nhạc) - M1786B-X3B",486000,486000,0,0
TIKI,do-choi-me-be,273532024,"[Combo 3 lon còn 1tr440] Sữa Bột Nutifood GrowPLUS+ Suy Dinh Dưỡng 1.5kg - Tăng Cân, Tăng Chiều Cao (Lon 1.5kg)",568000,884000,316000,36
TIKI,do-choi-me-be,184101589,"Combo 2 TúI Nước Giặt Omo Matic Cho Quần Áo Bé Yêu Chiết Xuất Tràm Trà Và Nha Đam Dịu Nhẹ, Sạsh Khuẩn , túi 3.6Kg",350000,454000,104000,23
TIKI,do-choi-me-be,116407424,"Combo 2 túi nước giặt OMO Matic cho máy giặt cửa trên giúp quần áo sạch bẩn khử mùi toàn diện, túi 3.9kg",350000,454000,104000,23
TIKI,do-choi-me-be,181426565,"Nước xả làm mềm vải Comfort chăm sóc chuyên sâu phơi trong nhà Hương nắng mới",215000,271000,56000,21
TIKI,do-choi-me-be,145976954,"[CỘNG 6 MIẾNG] Tã quần Moony cao cấp XL38+6 (Girl) - Nhập khẩu từ Nhật Bản",339000,475000,136000,29
TIKI,do-choi-me-be,115483206," Sữa bột Enfagrow A+ NeuroPro 3 với 2’-FL HMO cho trẻ từ 1 – 3 Tuổi - Vị Nhạt Dễ Uống (2.2kg)",997000,997000,0,0
TIKI,do-choi-me-be,181452377,"Combo 2 túi Nước xả làm mềm vải Comfort chăm sóc chuyên sâu phơi trong nhà Hương nắng mới",422000,542000,120000,22
TIKI,do-choi-me-be,6840059,"Combo 2 Tã Dán Người Lớn SunMate G2 Size M10 (10 Miếng)",146000,182620,36620,20
TIKI,do-choi-me-be,6840059,"Combo 2 Tã Dán Người Lớn SunMate G2 Size M10 (10 Miếng)",146000,182620,36620,20
TIKI,do-choi-me-be,57044932,"Thùng 48 Hộp Sữa Nước Abbott Pediasure Vani 180ml cho trẻ từ 1 - 10 tuổi",1470000,1633728,163728,10
TIKI,do-choi-me-be,175953067,"Combo 4 Tã Quần Người Lớn SunMate Mềm Mại",293000,399997,106997,27
TIKI,do-choi-me-be,573673,"Thùng 48 Hộp Sữa Nước Abbott Grow Gold 180ml cho trẻ 1 tuổi trở lên",813000,904224,91224,10
TIKI,do-choi-me-be,95269395,"Tã Quần Siêu Cao Cấp Huggies Platinum Nature Made L44 (44 Miếng)",329000,460000,131000,28
TIKI,do-choi-me-be,498670,"Combo 2 Tã Dán Người Lớn SunMate G2 Size XL10 (10 Miếng)",202000,261163,59163,23
TIKI,do-choi-me-be,199903945,"Combo 2 Tấm lót SunMate cải tiến mới (45 x 70cm)",99000,130680,31680,24
TIKI,do-choi-me-be,145976954,"[CỘNG 6 MIẾNG] Tã quần Moony cao cấp XL38+6 (Girl) - Nhập khẩu từ Nhật Bản",339000,475000,136000,29
TIKI,do-choi-me-be,124708784,"Nước Giặt Ariel Hương Downy Túi 3.2Kg",236500,236500,0,0
TIKI,do-choi-me-be,25026925,"Combo 2 Gói Tã Quần Người Lớn Sunmate Khô Thoáng M8 (8 Miếng/ Gói)",161000,199999,38999,19
TIKI,do-choi-me-be,126022163,"Bột thông tắc cống, bồn cầu, bồn rửa bát, đường ống cực mạnh HGO Super 250g",49000,75000,26000,35
TIKI,do-choi-me-be,25027164,"Combo 2 Gói Tã Quần Người Lớn Sunmate Khô Thoáng L7 (7 Miếng/ Gói)",151000,199999,48999,24
TIKI,do-choi-me-be,59143355,"Combo Tiết Kiệm: 6 Gói Khăn Ướt Bobby Care Bổ Sung 80 Miếng/Gói",159000,231000,72000,31
TIKI,do-choi-me-be,199903947,"Combo 4 Tấm lót SunMate cải tiến mới (45 x 70cm)",197000,240451,43451,18
TIKI,do-choi-me-be,10054452,"Thùng 48 Hộp Sữa Bột Pha Sẵn Friso Gold Rtd Vani (48 Hộp X 110ml)",438000,505000,67000,13
TIKI,do-choi-me-be,68612510,"Combo 2 Túi nước giặt xả Maxkleen Hương Huyền Diệu 3.8kg/túi ",369000,420000,51000,12
TIKI,do-choi-me-be,23957447,"Combo 2 Tã Quần Người Lớn Sunmate Mềm Mại M9 (9 Miếng)",166000,203702,37702,19
TIKI,do-choi-me-be,498670,"Combo 2 Tã Dán Người Lớn SunMate G2 Size XL10 (10 Miếng)",202000,261163,59163,23
TIKI,do-choi-me-be,175953067,"Combo 4 Tã Quần Người Lớn SunMate Mềm Mại",293000,399997,106997,27
TIKI,do-choi-me-be,413088,"Miếng Lót Sơ Sinh Bobby Fresh Newborn 2 - 40 (40 Miếng)",79000,98000,19000,19
TIKI,do-choi-me-be,184101589,"Combo 2 TúI Nước Giặt Omo Matic Cho Quần Áo Bé Yêu Chiết Xuất Tràm Trà Và Nha Đam Dịu Nhẹ, Sạsh Khuẩn , túi 3.6Kg",350000,454000,104000,23
TIKI,do-choi-me-be,117836946,"[Mới] Hộp giấy 2 Kg Frisolac Gold 3",939000,939000,0,0
TIKI,do-choi-me-be,72924801,"Combo 3 Hộp 4 Viên Nén Vệ Sinh Lồng Giặt OMO Matic 80gr",227000,276000,49000,18
TIKI,do-choi-me-be,181452377,"Combo 2 túi Nước xả làm mềm vải Comfort chăm sóc chuyên sâu phơi trong nhà Hương nắng mới",422000,542000,120000,22
TIKI,do-choi-me-be,24026125,"Thùng 30 Chai Sữa Nước Abbott Glucerna Vani 220ml",1440000,1567500,127500,8
TIKI,do-choi-me-be,88949152,"Sữa Bột Frisolac Gold 3 1400g (Dành Cho Trẻ Từ 1 - 2 Tuổi)",735000,735000,0,0
TIKI,do-choi-me-be,25099352,"Combo 02 Hộp Bột Tẩy Vệ Sinh Lồng Máy Giặt Ag+ Mao Bao 306g - Tặng 01 hộp Bột Tẩy Quần Áo Thiên Nhiên 12g x 2 gói",84000,110000,26000,24
TIKI,do-choi-me-be,32030382,"Combo 12 Gói Khăn Ướt Huggies Cacao và Bơ Hạt Mỡ (72 Miếng/ Gói)",369000,408000,39000,10
TIKI,do-choi-me-be,130997754,"Combo 2 túi nước giặt dưỡng vải Comfort 3.8kg",390000,390000,0,0
TIKI,do-choi-me-be,213586941,"Combo 3 Tấm lót SunMate cải tiến mới 20 miếng/gói size M (45 x 70cm)",271000,350510,79510,23
TIKI,do-choi-me-be,23957447,"Combo 2 Tã Quần Người Lớn Sunmate Mềm Mại M9 (9 Miếng)",166000,203702,37702,19
TIKI,do-choi-me-be,116407424,"Combo 2 túi nước giặt OMO Matic cho máy giặt cửa trên giúp quần áo sạch bẩn khử mùi toàn diện, túi 3.9kg",350000,454000,104000,23
TIKI,do-choi-me-be,57044926,"Thùng 48 Hộp Sữa Nước Abbott Pediasure Vani 110ml cho trẻ từ 1 - 10 tuổi",1009000,1111824,102824,9
TIKI,do-choi-me-be,24030105,"Sữa bột Abbott Pediasure 850g cho trẻ từ 1 - 10 tuổi",665000,755948,90948,12
TIKI,do-choi-me-be,84304880,"Tẩy cặn canxi vách kính, vòi sen inox, bồn sứ, gạch men HGO Plus 500ml",95000,95000,0,0
TIKI,do-choi-me-be,435762,"Sữa Bột Abbott Grow Gold 3+ cho trẻ từ 3 - 6 tuổi (1.7Kg)",674000,781380,107380,14
TIKI,do-choi-me-be,181426565,"Nước xả làm mềm vải Comfort chăm sóc chuyên sâu phơi trong nhà Hương nắng mới",215000,271000,56000,21
TIKI,do-choi-me-be,159387940,"Đai đi xe máy cho bé phản quang, thoáng khí sử dụng khóa 2 cấp bền chắc, chống bui bẩn",129000,179000,50000,28
TIKI,do-choi-me-be,88924594,"Sữa Bột Frisolac Gold 1 850g Dành Cho Trẻ Từ 0 - 6 Tháng Tuổi",531000,531000,0,0
TIKI,do-choi-me-be,7178671,"Bột Tẩy Quần Áo Thiên Nhiên Baking Soda Mao Bao (12 g x 5 gói)",43000,55000,12000,22
TIKI,do-choi-me-be,118123582,"Giấy vệ sinh PREMIER VinaRoll không lõi - Combo 3 lốc",225000,225000,0,0
TIKI,do-choi-me-be,145974290,"[CỘNG 4 MIẾNG] Tã dán Moony cao cấp L54+4 - Nhập khẩu từ Nhật Bản",339000,475000,136000,29
TIKI,do-choi-me-be,130461479,"Sữa Bột Similac Einstein 4 cho trẻ từ 2 - 6 tuổi",499000,547560,48560,9
TIKI,do-choi-me-be,24028484,"Sữa bột Abbott Pediasure cho trẻ từ 1 - 10 tuổi (400g)",321000,346500,25500,7
TIKI,do-choi-me-be,35043572,"Thùng 48 Hộp Sữa Nước Abbott Similac 110ml cho trẻ từ 1 tuổi",605000,699600,94600,14
TIKI,do-choi-me-be,98276143,"Thùng 3 Gói Tã/ Bỉm Quần PAMPERS Nhật Thượng Hạng, Size M (144 miếng, 6-12kg), Siêu Mềm Mịn & Thoáng Khí",964000,1410000,446000,32
TIKI,do-choi-me-be,160299782,"Nước Lau Sàn Sunlight Tinh Dầu Thảo Mộc Hương Hoa Hạ & Bạc Hà 3,6 Kg - Sạch Thơm Thư Thái - Nhà Thêm Trong Lành",92900,93000,100,0
TIKI,do-choi-me-be,159962663,"Xe tăng điều khiển từ xa bánh xích đan nhựa PP pin sạc có đèn và âm thanh",314000,409000,95000,23
TIKI,do-choi-me-be,142711935,"[COMBO 2 Hộp 1KG] Ngũ Cốc Cao Cấp Lợi Sữa Min Min 30 Hạt _ Chuyên Lợi Sữa và Phụ Hồi Sức Khỏe Sau Sinh (1 Hộp 500Gr)",480000,480000,0,0
TIKI,do-choi-me-be,22198197,"Combo 08 Miếng Bọt Biển Bọc Cạnh Góc Bàn",19900,19900,0,0
TIKI,do-choi-me-be,147003701,"Núm ty cổ hẹp Pigeon silicon siêu mềm (LL) - 2 cái/vỉ",77000,102000,25000,25
TIKI,do-choi-me-be,148073878,"KHĂN ƯỚT BOBBY KHÔNG MÙI/CÓ MÙI LOẠI 100 TỜ CÓ NẮP",35000,35000,0,0
TIKI,do-choi-me-be,174114983,"Xe ô tô địa hình điều khiển từ xa  KAVY 609 tỷ lệ 1:8 kích cỡ siêu khủng bằng hợp kim có đèn tốc độ cao tần số 2.4 GHz",910000,910000,0,0
TIKI,do-choi-me-be,60261409,"Mũ nón bảo hiểm bảo vệ đầu cho bé tập đi chống va đập cho bé tùy ý chỉnh to nhỏ, vải bọc thoáng khí",65000,65000,0,0
TIKI,do-choi-me-be,119706874,"Sữa tắm gội dịu lành cho bé Cetaphil Baby Gentle Wash & Shampoo 230ml",170000,170000,0,0
TIKI,do-choi-me-be,167382264,"LEGO Creator 31124 Siêu Rô Bốt (159 chi tiết)",209000,299000,90000,30
TIKI,do-choi-me-be,90897526,"Combo 4 quần chip đùi màu cho bé gái T-TomTombaby | Size 3-5 cho bé 10-16kg| Chất vải thun cotton 4 chiều 100%, mềm, mịn, thoáng mát, co giãn 4 chiều | Quần chip bé gái | Quần đùi bé gái",101000,101000,0,0
TIKI,do-choi-me-be,127120202,"Đồ chơi lắp ráp gundam 04",200000,200000,0,0
TIKI,do-choi-me-be,75424391,"Kính mát chống tia UV cho bé 3-8 tuổi gọng nhựa chắc chắn nhiều họa tiết đáng yêu BBShine – K020",29000,58000,29000,50
TIKI,do-choi-me-be,16386201,"Sáp Giữ Ấm Cho Bé Giúp Chống Cảm Giảm Ho Giúp Bé Không Bị Nhiễm Lạnh Khi Tắm Khi Ngủ Đêm Hoặc Đi Chơi Ngoài Trời Gió Bí Quyết Chăm Con Của Mẹ 10g",90000,90000,0,0
TIKI,do-choi-me-be,77160799,"Nước Lau Sàn Sinh Học ENZYCO Lên Men Từ Dứa Và Bồ Hòn Làm Sạch Sàn Nhà Không Chất Hóa Học An Toàn Lành Tính - Hương Sả Chanh",169000,169000,0,0
TIKI,do-choi-me-be,178007097,"TÃ DÁN NGƯỜI GIÀ CARYN SIZE XL20 MIẾNG",259000,259000,0,0
TIKI,do-choi-me-be,158409967,"Bộ Xếp Hình TOI Thăng Cấp Từ Dễ Đến Khó Cho Bé 1-7 TUỔI - TOI LEVELED PUZZLE",199000,199000,0,0
TIKI,do-choi-me-be,145613736,"Nước rửa chén Sunlight Trà xanh( Khử mùi tanh) Can 3.6KG",109000,109000,0,0
TIKI,do-choi-me-be,188453611,"Đồ chơi lắp ráp, xếp hình chủ đề quân sự Qman 42301 – Xe Tăng Quân Sự (642 chi tiết, 8 trong 1)",369000,489000,120000,25
TIKI,do-choi-me-be,22978392,"Sữa Bột Nutifood Grow Plus+ Đỏ (900g)",392000,392000,0,0
TIKI,do-choi-me-be,97990859,"Set 2 Khăn Tắm Bonny 4 Lớp 90x90Cm Chất Liệu Tre Lụa Mềm Mại Kháng Khuẩn Siêu Thấm Hút An Toàn Cho Da Bé (Hàng Cao Cấp)",275000,275000,0,0
TIKI,do-choi-me-be,107482552,"Đồ bơi cho bé gái kiểu Hàn Quốc màu hồng phấn size từ 14kg đến 43kg",229000,251850,22850,9
TIKI,do-choi-me-be,134642555,"Chela Ferr Forte - Bổ sung sắt hữu cơ, Acid Folic cho bà bầu, người thiếu máu - Dễ hấp thụ, không gây táo bón - Nhập khẩu chính hãng",280000,400000,120000,30
TIKI,do-choi-me-be,170751734,"Bộ (1 bộ) đồ bộ bé GÁI Tay Dài chất vải tole lanh 2 da loại 1 mềm mịn, thoáng mát - Nhiều size cho bé từ 5-40 kg",52000,52000,0,0
TIKI,do-choi-me-be,144637608,"Lều xông hơi tự bung kèm nồi xông dung tích lớn",539000,539000,0,0
TIKI,do-choi-me-be,184318114,"Combo 2 kem đánh răng Colgate trẻ em kỳ lân Unicorn hương dâu 40g",17000,17000,0,0
TIKI,do-choi-me-be,191717242,"[BẢN VIỆT HOÁ 2022 - KÈM FILE NGHE] Đèn Pin Kể Chuyện kết hợp đèn ngủ KIDS STORYBOOK TORCH - MIDEER",109000,109000,0,0
TIKI,do-choi-me-be,270699074,"Canxi cho bé Healthy Care Kids Milk Calcium Úc, Hỗ trợ tăng trưởng chiều cao, hệ thống xương, răng, bé ngủ ngon không trằn trọc ban đêm - QuaTangMe Extaste",242000,484000,242000,50
TIKI,do-choi-me-be,39178258,"Mũ bảo vệ đầu cho bé - Màu ghi",138500,138500,0,0
TIKI,do-choi-me-be,132339708,"Đồ chơi mô hình máy bay dân dụng chạy trớn",40000,40000,0,0
TIKI,do-choi-me-be,94449373," Tấm Lót Chống Thấm 4 Lớp Cho Bé Sơ Sinh",38000,38000,0,0
TIKI,thiet-bi-kts-phu-kien-so,13556522,"Đồng Hồ Hẹn Giờ 60 Phút Pomodoro Kim Loại",74000,74000,0,0
TIKI,do-choi-me-be,74861070,"Búp bê Barbie công chúa-Cô dâu",94000,94000,0,0
TIKI,thiet-bi-kts-phu-kien-so,57345342,"Giá Đỡ Điện Thoại Bằng Kim Loại Đa Năng, Tùy Chỉnh Nhiều Góc Độ, Dành Cho Giải Trí, Livestream, Học Online",118000,118000,0,0
TIKI,do-choi-me-be,140938781,"ĐỒ CHƠI XE LỬA CO ĐƯỜNG RAY PIN NHẠC ĐÈN, CÓ KHÓI",299000,299000,0,0
TIKI,do-choi-me-be,117208992,"Hút Mũi Dây Silicon UPASS Tự Điều Chỉnh Lực Hút Cho Bé / UP1006C",63000,63000,0,0
TIKI,do-choi-me-be,57759234,"Bộ Bài Tarot of Sexual Magic New",119000,119000,0,0
TIKI,thiet-bi-kts-phu-kien-so,75477912,"Bộ Chuyển Đổi Cáp Ổ Cứng USB SATA III Đen (3.0) Có đèn báo tín hiệu tốc độ cao",128000,128000,0,0
TIKI,thiet-bi-kts-phu-kien-so,55045867,"Miếng Lót Chuột Bàn Phím Trải Bàn Size Lớn Da PU Size 300 x 800 mm",130000,130000,0,0
TIKI,do-choi-me-be,104158078,"Bình uống nước tay cầm có ống hút Pigeon 150ml",190000,211000,21000,10
TIKI,do-choi-me-be,53252195,"Núm Ty Silicon Siêu Mềm Tự Nhiên Cho Bé Tommee Tippee Natural Start Fast Flow Từ 6 Tháng (Vỉ đôi, tách lẻ)",195000,195000,0,0
TIKI,do-choi-me-be,41382916,"Combo 3 bịch Khăn vải khô đa năng Mama (bịch 240 tờ)",149000,149000,0,0
TIKI,do-choi-me-be,112109438,"Thùng sữa nước pha sẵn Nutricare Care 100 GOLD cho trẻ thấp còi, biếng ăn từ 1 tuổi (180ml)",610000,610000,0,0
TIKI,do-choi-me-be,70799583,"Kẹp Tóc  Cho Bé Bộ 10 Cái,  Nhiều Hình Ngộ Nghĩnh, Giao Hình Ngẫu Nhiên",16000,16000,0,0
TIKI,thiet-bi-kts-phu-kien-so,57900120,"Loa bluetooth mini 5.0 nhỏ gọn PKCB PF1002 - Hàng chính hãng",136000,400000,264000,66
TIKI,thiet-bi-kts-phu-kien-so,359480,"Combo chuột phím có dây Logitech MK120 - Hàng chính hãng",214000,214000,0,0
TIKI,do-choi-me-be,172814768,"Leanpro Thyro LID 900G - DINH DƯỠNG CHUYÊN BIỆT CHO NGƯỜI KIÊNG I-ỐT",748000,748000,0,0
TIKI,thiet-bi-kts-phu-kien-so,171939157,"Lót chuột Logitech Mouse Pad - Đế cao su chống trượt, lướt dễ dàng, bề mặt chống đổ tràn, bền bỉ, nhỏ gọn - Hàng chính hãng - Màu",220000,220000,0,0
TIKI,do-choi-me-be,117832165,"Áo váy bé gái quần ca rô chất liệu cao cấp thoáng mát",39000,39000,0,0
TIKI,do-choi-me-be,82073505,"Máy Massage Thông Tắc Tia Sữa Kích Sữa Lavie Tự Làm Tại Nhà Chữa Tắc Nhanh An Toàn Không Đau Ngừa Tái Phát Hàng Đầu Hoa Kỳ",1189000,1189000,0,0
TIKI,do-choi-me-be,88924591,"Sữa Bột Frisolac Gold 3 380g Dành Cho Trẻ Từ 1 - 2 Tuổi",239000,239000,0,0
TIKI,thiet-bi-kts-phu-kien-so,114243462,"Giá Đỡ Máy Tính, Laptop Máy Tính Bảng Chất Liệu Hợp Kim Nhôm Cao Cấp Hỗ Trợ Tản Nhiệt Chống Mỏi Cổ, Vai, Gáy. Hàng Chính Hãng Tamayoko",600000,600000,0,0
TIKI,do-choi-me-be,55982681,"Bột Giặt LIX Extra Hương Nước Hoa 7Kg EH070 - Tăng Gấp Đôi Sức Mạnh Giặt Tẩy",183000,183000,0,0
TIKI,do-choi-me-be,253237751,"Sữa bột công thức HiPP 2 Organic Combiotic 350g",325000,325000,0,0
TIKI,do-choi-me-be,12429669,"Combo 3 bộ Tole Lanh Bé Gái Sát Nách Xòe - Size 1-10 cho bé 5-30kg- Chất vải tole lanh 2 da loại 1",109000,109000,0,0
TIKI,do-choi-me-be,96995992,"Đồ Chơi DISCOVERY Bộ Khảo Cổ Truy Tìm Xương Khủng Long - T.Rex 1423004871",343000,399000,56000,14
TIKI,thiet-bi-kts-phu-kien-so,19989837,"Bình Xịt Bụi Khí Nén Air Duster Vệ Sinh Laptop Hàng Màu Xanh Cao Cấp - Khí Xịt Cực Mạnh",98000,98000,0,0
TIKI,do-choi-me-be,118894866,"Thảm nhạc cho bé, đàn piano đồ chơi cho trẻ từ sơ sinh",149999,149999,0,0
TIKI,thiet-bi-kts-phu-kien-so,149248566,"Bao da iPad Gen 9 10.2 inch 2021 chính hãng Mutural kèm khay đựng bút - Hàng nhập khẩu",191000,285000,94000,33
TIKI,thiet-bi-kts-phu-kien-so,70847754,"Bộ 2 miếng kính cường lực Gor cho iPhone 12 Mini / 12 / 12 Pro / 12 Pro Max - Full Box - Gor - Hàng nhập khẩu",99000,99000,0,0
TIKI,do-choi-me-be,134840327,"Bản đồ Việt Nam 52 mảnh ghép gỗ cao cấp, Tranh ghép hình các tỉnh Việt Nam bằng gỗ có hộp và học liệu cho bé chơi và học tập hữu ích",415000,415000,0,0
TIKI,thiet-bi-kts-phu-kien-so,115266252,"Bao Case Vỏ Bảo Vệ Silicone TPU Trong Suốt KAI cho Apple AirTag- Loại Bảo Vệ 2 Mặt_ Hàng Chính Hãng",43700,46000,2300,5
TIKI,thiet-bi-kts-phu-kien-so,73526371,"Bao Da Cover Nam Châm Dành Cho Apple Ipad Air 4 10.9 Inch 2020 Hỗ Trợ Pencil 2",250000,250000,0,0
TIKI,do-choi-me-be,125046835,"[Combo 2 Sản Phẩm] Gel Diệt Kiến Maxforce Quantum Chính Hãng",320000,320000,0,0
TIKI,thiet-bi-kts-phu-kien-so,183559913,"Micro có dây Nhật Bản  TOMAHAWK - Hàng nhập khẩu  - Hàng cao cấp Nhật Bản",250000,500000,250000,50
TIKI,do-choi-me-be,57793181,"Pregnacare Breast-feeding Bổ Sung Vitamin Và Lợi Sữa cho mẹ sau sinh số 1 Anh chính hãng",350000,460000,110000,24
TIKI,do-choi-me-be,109365794,"Philips Avent Núm Ty Ngậm Thông Khí / Siêu Mềm dành cho Bé 0-6 và 6-18 Tháng (Hộp Đơn/Hộp Đôi)",185000,185000,0,0
TIKI,do-choi-me-be,129767102,"Bình sữa cổ rộng thuỷ tinh Plus Pigeon 240ml (M)",362000,362000,0,0
TIKI,do-choi-me-be,132301165,"Dây Bọt Biển Bọc Cạnh Bàn, Góc Tủ, Ghế- Tránh Va Đập Góc Cạnh Sắt Dài 2M Chữ L Kèm Băng Dán ( Giao Màu Ngẫu Nhiên )- Hàng Loại 1- Chính Hãng MINIIN",39000,49000,10000,20
TIKI,thiet-bi-kts-phu-kien-so,92922305,"Adapter Củ sạc nhanh 20W USB-C Power Adapter PD 3.0 -  Chuẩn Sock EU ( Chân Tròn )",64798,129596,64798,50
TIKI,thiet-bi-kts-phu-kien-so,25748826,"Đầu chuyển usb type-C ra USB 3.0 chính hãng Ugreen 50283",80000,80000,0,0
TIKI,thiet-bi-kts-phu-kien-so,150763505,"Bao Case Ốp Bảo Vệ Có Khóa Dành Cho Tai Nghe Galaxy Buds 2 Pro/ Buds 2/ Buds Pro/ Buds Live Chống Sốc Kai Switch Key Kèm Móc Treo_ Hàng Chính Hãng",150000,150000,0,0
TIKI,thiet-bi-kts-phu-kien-so,25554844,"Dây Đeo Thay Thế Cho Vòng Đeo Tay Thông Minh Xiaomi Mi Band 3 / Mi Band 4 Dẻo TPU - 2 màu",35000,35000,0,0
TIKI,do-choi-me-be,485783,"Sữa Công Thức Glico Icreo Follow Up Milk Số 9 (820g)",544909,544909,0,0
TIKI,thiet-bi-kts-phu-kien-so,359483,"Bàn Phím Không Dây Logitech K270 - Hàng Chính Hãng",469000,469000,0,0
TIKI,do-choi-me-be,28590277,"Ba lô kéo hoc sinh, tiện dụng cho bé Màu Hồng -  H2L",167200,209000,41800,20
TIKI,do-choi-me-be,95035832,"Bột ăn dặm dinh dưỡng Sữa, Hoa quả, Bắp HiPP Organic 250g",145000,145000,0,0
TIKI,do-choi-me-be,7487847,"Bộ bơi liền dài than tay hồng bé gái từ 2 đến 11 tuổi",289000,345920,56920,16
TIKI,thiet-bi-kts-phu-kien-so,83982862,"Dây Cáp Sạc Type C to C Sạc Nhanh 60W, Dài 1m, Dây Dù Nylon Siêu Bền RAVPower RP-CB047 - Hàng Chính Hãng",129000,250000,121000,48
TIKI,do-choi-me-be,52633326,"Sách vải cho bé",75000,75000,0,0
TIKI,thiet-bi-kts-phu-kien-so,252906668,"Case Silicon dành cho Airpods 3/ Airpods Pro 2 Hình Rồng Răng Sún_ Hàng Chính Hãng",80750,85000,4250,5
TIKI,do-choi-me-be,73661886,"Sữa Tắm Gội Trẻ Em Lactacyd Baby Extra Milky Làm Sạch Dịu Nhẹ và Dưỡng Ẩm Vượt Trội 250ml",97000,101000,4000,4
TIKI,do-choi-me-be,136294080,"Quây bóng cho bé, nhà bóng cho bé chơi tặng kèm bóng nhựa",399000,399000,0,0
TIKI,thiet-bi-kts-phu-kien-so,24319638,"Dây Cáp Sạc Thay Thế Cho Đồng Hồ Thông Minh Garmin Forerunner 945 / 245 / Fenix ​​5X / Vivoactive 3 / Instinct / Fenix ​​5S / Approach S60",63000,63000,0,0
TIKI,thiet-bi-kts-phu-kien-so,54639263,"Bao Case Silicon Dành Cho Tai Nghe Apple Airpods Pro Có Móc Khóa Hàng Chính Hãng Helios",19000,19000,0,0
TIKI,do-choi-me-be,181423476,"ING ORGANIC NATURE MELA KIDS - SERUM MỜ SẸO THÂM DO MUỖI ĐỐT, ĐẶC VIỆT DO MỤN LÀM THÂM - HIỆU QUẢ SAU 3 NGÀY SỬ DỤNG",171500,245000,73500,30
TIKI,thiet-bi-kts-phu-kien-so,37655545,"Bao Da Cover Dành Cho Apple Ipad 10.2 Inch 2019 Hỗ Trợ Smart Cover",140000,140000,0,0
TIKI,do-choi-me-be,94653029,"Hộp kẹp tóc, dây cột tóc cho bé kèm lược chải tóc phong cách Hàn quốc nhiều chi tiết, chọn màu theo ý",99000,99000,0,0
TIKI,thiet-bi-kts-phu-kien-so,47081914,"Hộp Túi Vải Đựng Phụ Kiện Công Nghệ Đa Năng Nhiều Ngăn Chống Thấm Nước Túi Phụ Kiện Du Lịch Cho Cáp Sạc Di Động, Sạc Dự Phòng, Điện Thoại, Tai Nghe, Thẻ Nhớ - Hàng Chính Hãng + Kèm 1 Mét Dây Gai Dính Tròn Buộc Gọn Cáp",72000,89000,17000,19
TIKI,do-choi-me-be,55572761,"Con Quay Hand Fidget Spinner 3 Cánh Nhôm Cao Cấp",155000,155000,0,0
TIKI,do-choi-me-be,59140234,"Combo 2 chai xịt xả vải khô hương nước hoa Lâm Đại Phúc",99000,99000,0,0
TIKI,do-choi-me-be,522683,"Combo 2 Hộp Chất Làm Sạch Lồng Máy Giặt Ag+ Mao Bao 306g - Tặng 1 Chai Nước Giặt Cao Cấp 86g",84000,100000,16000,16
TIKI,thiet-bi-kts-phu-kien-so,2993273,"Sim Du Lịch 35 Nước Châu Âu Three-Mẫu ngẫu nhiên",479000,479000,0,0
TIKI,do-choi-me-be,97823805,"Set 3 Khăn Sữa Sợi Tre Lụa 4 Lớp Bonny Hàng Cao Cấp Thấm Hút Tốt, Kháng Khuẩn (Kích thước: 30x30Cm)",55000,55000,0,0
TIKI,do-choi-me-be,87986625,"Lọ hình heo thả bồn cầu diệt khuẩn, khử mùi, tẩy siêu sạch, mùi thơm diệu nhẹ giúp giữ vệ sinh bồn cầu luôn sạch sẽ GD459-Heoboncau",15879,15879,0,0
TIKI,thiet-bi-kts-phu-kien-so,94304443,"Đồng Hồ Thông Minh AMA Watch Nam Nữ chống nước | Gọi điện thoại Xem tin nhắn Theo dõi Sức khỏe vận động Thiết kế nhỏ gọn Thời trang Hàng nhập khẩu",1258000,1258000,0,0
TIKI,thiet-bi-kts-phu-kien-so,129986551,"Tai Nghe Bluetooth Tai Mèo, Có Đèn LED Headphone - Tai Nghe Mèo Bluetooth Không Dây Dễ Thương Có Mic Đàm Hội Cao Cấp -  Tai Nghe Bluetooth Chụp Tai Không Dây - Hàng Chính Hãng Besti",130000,130000,0,0
TIKI,thiet-bi-kts-phu-kien-so,157132867,"Ốp Lưng Silicon TPU trong suốt GOR cho iPhone 13 Mini / 13 / 13 Pro / 13 Pro Max - Hàng Chính Hãng",51000,70000,19000,27
TIKI,do-choi-me-be,148701867,"[VIDEO]- Hộp kẹp tóc 17 món cột tóc, kẹp tóc, nơ cài theo phong cách Hàn Quốc an toàn cho bé- CHỌN MÀU",79000,110600,31600,29
TIKI,do-choi-me-be,140930469,"Đồ Chơi Khủng Long Lắp Ráp Có Tua Vít Tháo Lắp - Mô Hình Size To Cho Bé",55000,55000,0,0
TIKI,do-choi-me-be,249168957,"Dụng cụ vệ sinh bình sữa Wesser",61060,71000,9940,14
TIKI,do-choi-me-be,49362845,"Com bo 4 bịch khăn vải đa năng LIKADO 300g gấp tư  kích thước 14 *20cm (khoảng 270 tờ)",142000,160000,18000,11
TIKI,do-choi-me-be,186526784,"Kem đánh răng Colgate trẻ em kỳ lân Unicorn hương dâu 40g",10000,10000,0,0
TIKI,thiet-bi-kts-phu-kien-so,270493352,"Bàn phím cơ Gaming DAREU EK87 v2 (2 sides RGB strip, Black: Rainbow light , White: Single blue Backlight) - Hàng Chính Hãng",512050,539000,26950,5
TIKI,thiet-bi-kts-phu-kien-so,104261141,"Chuột không dây chơi game HXSJ X801 thiết kế độc lạ Led RGB đổi màu click chống ồn DPI 1600 - Hàng chính hãng",259000,499000,240000,48
TIKI,thiet-bi-kts-phu-kien-so,192431673,"Vỏ Bút dành cho Apple Pencil 2 Retro Hình Bút Chì- Hàng Chính Hãng",160550,169000,8450,5
TIKI,do-choi-me-be,45813716,"Hộp 40 Dây Cột Tóc Hello Kitty Cho Bé ",29000,29000,0,0
TIKI,thiet-bi-kts-phu-kien-so,56196502,"Chuột game có dây Logitech G102 Lightsync - Tùy chỉnh RGB, 6 nút lập trình, nhẹ, 8000 DPI, PC/Mac - Màu",440000,440000,0,0
TIKI,do-choi-me-be,116910063,"Bộ Thẻ Cờ Các Nước Trên Thế Giới, Có Phiên Âm Song Ngữ [ Loại 1 giấy đẹp]",115000,135000,20000,15
TIKI,thiet-bi-kts-phu-kien-so,195445913,"Thẻ Nhớ MicroSDXC SanDisk Extreme V30 A2 256GB 190MB/s SDSQXAV-256G (New 2022) - Hàng Nhập Khẩu",570000,570000,0,0
TIKI,thiet-bi-kts-phu-kien-so,69931916,"Cáp HDMI to USB 3.0 Video Capture Earldom ET-W17 - Hỗ Trợ Live Stream, Ghi Hình Từ Điện Thoại, Camera, PS4, XBOX - Hàng Chính Hãng",330000,330000,0,0
TIKI,do-choi-me-be,67370852,"Nước giặt xả hữu cơ Bồ Hòn Ecocare tinh dầu Hoa Bưởi  4000ml",399000,399000,0,0
TIKI,thiet-bi-kts-phu-kien-so,178737463,"Kính Cường Lực KingKong Full Màn Chính Hãng WEKOME Chống Vỡ Viền cho ĐT Hàng chính hãng",45000,45000,0,0
TIKI,thiet-bi-kts-phu-kien-so,73261273,"Sim 4G Vinaphone Trọn Gói 1 Năm (Có 2Gb/ngày, 1000 phút nội mạng/tháng) - Hàng Chính Hãng",750000,750000,0,0
TIKI,do-choi-me-be,176937772,"Medela - Kem Purelan 37g - Dành cho mẹ có đầu ty khô, nứt, chảy máu - 100% chiết xuất thiên nhiên, an toàn tuyệt đối.",395000,395000,0,0
TIKI,do-choi-me-be,119720069,"Set 5 tã vải sơ sinh cotton TOMTOM BABY | Size 1,2,3 cho bé sơ sinh - 9kg | Miếng dán bo viền, chất vải mềm mịn",110000,110000,0,0
TIKI,do-choi-me-be,44959788,"Sữa Bột Namyang Imperial Mom XO GT 800g",594000,594000,0,0
TIKI,thiet-bi-kts-phu-kien-so,7574741,"Bao Da Smart Case Gen2 TPU Dành Cho iPad Mini 1/ 2/ 3/ 4",121000,251984,130984,52
TIKI,do-choi-me-be,70355651," Bộ đồ chơi câu cá là lắp ráp bằng gỗ",95000,95000,0,0
TIKI,thiet-bi-kts-phu-kien-so,177337039,"Chuột Có Dây HXSJ S200 - Hàng chính hãng",69000,129000,60000,47
TIKI,thiet-bi-kts-phu-kien-so,57108743,"Cáp sạc thay thế cho các dòng đồng hồ Garmin Fenix 6, Fenix 5, Forerunner 945, 935, Instinct, Viviactive 3, Venu",57000,57000,0,0
TIKI,do-choi-me-be,25096869,"Bột Tẩy Quần Áo Thiên Nhiên Mao Bao chứa Baking Soda (12g x 2 gói)",22000,32000,10000,31
TIKI,do-choi-me-be,249054309,"Sữa Ensure Vanila Úc cho người già, người suy dinh dưỡng, cấp đầy đủ dinh dưỡng giúp hồi phục sức khỏe - Massel Official (850g/lon)",1039000,2078000,1039000,50
TIKI,do-choi-me-be,453774,"Kem Dưỡng Da Chứa Sữa Và Gạo Johnson’s Baby 20309343 (50g)",66000,66000,0,0
TIKI,do-choi-me-be,47961612,"Combo 2 Que Thử Thai QuickStick",40000,40000,0,0
TIKI,do-choi-me-be,75435459,"Tã Quần Caryn Loại Mỏng Nhẹ M32",315000,350400,35400,10
TIKI,do-choi-me-be,543122,"Nước Giặt Quần Áo Em Bé D-nee Hương Lavender 3L - [8851989061535]",203000,245000,42000,17
TIKI,do-choi-me-be,92496752,"Combo tẩy cặn canxi nhà tắm HGO Plus + tẩy dầu mỡ nhà bếp HGO bình xịt 500ml, sử dụng tiện lợi hiệu quả tiết kiệm",179000,265000,86000,32
TIKI,do-choi-me-be,68088749,"Combo 2 Túi Nước Giặt Xả Maxkleen Hương Hoa Nắng (3.8kg/túi)",369000,420000,51000,12
TIKI,do-choi-me-be,576239,"Nước Tẩy Đa Năng Kháng Khuẩn Mao Bao 600ml",43000,50000,7000,14
TIKI,do-choi-me-be,52293405,"Khăn Giấy Rút See-U, 2 Lớp 250 Tờ/gói",27000,27000,0,0
TIKI,do-choi-me-be,124722427,"Xịt đuổi chuột  200ml Thái Lan",48500,48500,0,0
TIKI,do-choi-me-be,133040504,"Combo 3 viên giặt xả MaxKleen hương ngày thư thái (34 viên/túi)",374000,420000,46000,11
TIKI,do-choi-me-be,135328955,"Sữa Bột Nestlé NAN SupremePro 1 lon 400g với 5HMO & đạm Gentle Optipro nhập khẩu nguyên lon từ Đức",299000,299000,0,0
TIKI,do-choi-me-be,182709739,"Combo 2 Sữa tắm gội dịu lành cho bé Cetaphil Baby Gentle Wash & Shampoo 400ml/chai",490000,490000,0,0
TIKI,do-choi-me-be,168662602,"Sữa bột NAN INFINIPRO A2 Thụy Sĩ 3 800g với đạm quý A2 tiêu hóa tốt sau 7 ngày và 5HMO tăng cường đề kháng (2 - 6 tuổi)",559000,600000,41000,7
TIKI,do-choi-me-be,95269446,"Tã Dán Siêu Cao Cấp Huggies Platinum Naturemade L54 (54 Miếng)",329000,460000,131000,28
TIKI,do-choi-me-be,77858363,"Nước Súc Miệng Listerine Kids dành riêng cho trẻ trên 6 tuổi 250ml - ",49000,55000,6000,11
TIKI,do-choi-me-be,75435457,"Tã Quần Caryn Loại Mỏng Nhẹ L28",315000,391200,76200,19
TIKI,do-choi-me-be,730944,"Sữa Tắm Gội Trẻ Em Lactacyd Milky BẢO VỆ, NUÔI DƯỠNG DA và TÓC BÉ VƯỢT TRỘI 500ml",183000,183000,0,0
TIKI,do-choi-me-be,135325550,"Combo 2 Nước Tẩy Bồn Cầu Vim 880ml Diệt 99,9% Vi Khuẩn",67100,76000,8900,12
TIKI,do-choi-me-be,106307519,"1 VIÊN TẨY BỒN CẦU",2299,2299,0,0
TIKI,do-choi-me-be,48964146,"Set 2 Khăn Tắm Em Bé Sợi Tre Bonny Siêu Mềm Và Thấm Hút (KT: 1m2x1m2) - Giao họa tiết ngẫu nhiên",190000,190000,0,0
TIKI,do-choi-me-be,68268748,"Viên sắt, acid folic, DHA, vitamin & khoáng chất Fe-NANA - Hộp 20 viên",84000,110000,26000,24
TIKI,do-choi-me-be,88949156,"Sữa Bột Friso Gold 4 850g (Dành Cho Trẻ Từ 2 - 6 Tuổi)",495000,600000,105000,18
TIKI,do-choi-me-be,61292593,"Combo 4 Gói Khăn Ướt Yuniku 90 Tờ Hương Lài ( 90 tờ x 4 )",99000,167200,68200,41
TIKI,do-choi-me-be,1744989,"Tã Quần Mỏng Nhẹ Caryn Gói Siêu Lớn L14 (14 Miếng)",180000,181600,1600,1
TIKI,do-choi-me-be,142115663,"Tranh Cát Cho Bé Tập Làm Họa Sỹ",5000,5000,0,0
TIKI,do-choi-me-be,82525136,"Combo 3 lon Sữa Morinaga số 2 Chilmil 850g và 1 lon sữa Morinaga số 2 320gr dành cho bé từ 6-36 tháng tuổi",1450000,1734000,284000,16
TIKI,do-choi-me-be,7827140,"Chất thông tắc bồn cầu toilet chống hôi Siêu tốc 5 phút Sifa (1400g)",53000,53000,0,0
TIKI,do-choi-me-be,17888580,"Cờ Vua Cao Cấp miDoctor (Chính Hãng) - NHỎ 3810A:  25 x 25 x 2 cm - Hàng chính hãng",92000,92000,0,0
TIKI,do-choi-me-be,1744997,"Tã Dán Siêu Thấm Caryn Gói Siêu Lớn M20 (20 Miếng)",180000,201800,21800,11
TIKI,do-choi-me-be,34402891,"Viên Thả Làm Sạch Bồn Cầu (1 Gói 10 Viên)",8000,10869,2869,26
TIKI,do-choi-me-be,175953079,"Combo 4 Gói Tã Quần Người Lớn SunMate Khô Thoáng",299000,399997,100997,25
TIKI,do-choi-me-be,76099465,"Chế phẩm diệt kiến gián sinh học Anbio - lọ 10ml",16800,16800,0,0
TIKI,do-choi-me-be,274034133,"Bộ Bài Drink Game Say sưa 84 lá đầy đủ thử thách vui nhộn",90000,165000,75000,45
TIKI,do-choi-me-be,145677986,"Bộ cờ vua tiêu chuẩn thi đấu, quân cờ nhựa đặc ruột cao cấp (tặng thêm 2 Hậu thuận tiện phong cấp)",250000,250000,0,0
TIKI,do-choi-me-be,146556777,"Cờ Vua Gỗ - Cờ Vua Cao Cấp - Đồ Chơi Bằng Gỗ Tự Nhiên - Chính hãng dododios",138000,138000,0,0
TIKI,do-choi-me-be,53135547,"Lọ Tẩy Vệ Sinh Bồn Cầu Nhật Bản SPEVI - Khử Mùi Nhà Vệ Sinh, Diệt Sạch 99,9% Vi Khuẩn Thiết Kế Thông Minh Giúp Dễ Dàng Sử Dụng, Lọ Thả Bồn Cầu Hiệu Quả Rất Nhiều So Với Viên Thả Bồn Câ·",19000,19000,0,0
TIKI,do-choi-me-be,35043549,"Thùng 48 Hộp Sữa Nước Abbott Similac 180ml cho trẻ từ 1 tuổi",875000,1003200,128200,13
TIKI,do-choi-me-be,25027164,"Combo 2 Gói Tã Quần Người Lớn Sunmate Khô Thoáng L7 (7 Miếng/ Gói)",151000,199999,48999,24
TIKI,do-choi-me-be,118946346,"Nước rửa chén bát hữu cơ Golden Life 1L - Hương",42000,42000,0,0
TIKI,do-choi-me-be,95269416,"Tã Dán Siêu Cao Cấp Huggies Platinum Naturemade M64 (64 Miếng)",329000,460000,131000,28
TIKI,do-choi-me-be,146499353,"Bộ Bài Tây Poker Nền Đen Cao Cấp Chọn Màu – Bài Tây Đen Bằng Nhựa PVC Chống Thấm Nước Chống Gập Chính Hãng Dododios",29000,29000,0,0
TIKI,do-choi-me-be,19944519,"Tã dán người lớn Caryn XL10 (10 Miếng)",130000,144400,14400,10
TIKI,do-choi-me-be,214238333,"Sữa tăng chiều cao và tăng cân cho trẻ Milo Úc và A2 Full Cream High In Calcium Úc - Chống loãng xương ở người lớn, tăng sức khỏe tổng thể - Massel Official",461000,922000,461000,50
TIKI,do-choi-me-be,17459641,"Hộp xếp hình lắp ráp sáng tạo 460 chi tiết Qman 2901",179000,214000,35000,16
TIKI,do-choi-me-be,48040396,"Muối rửa chén Finish Dishwasher Salt 4kg PTT017389",228000,228000,0,0
TIKI,do-choi-me-be,89144736,"Xe Tập Đi Bằng Gỗ 3 Con Gà Cao Cấp Cho Bé Yêu",88000,88000,0,0
TIKI,do-choi-me-be,74973224,"Đồ chơi xe địa hình điều khiển từ xa KAVY tỷ lệ 1:16 bằng hợp kim tốc độ cao, bền bỉ chắc chắn, dẫn động 2 bánh",360000,360000,0,0
TIKI,do-choi-me-be,82482707,"GẤU BÔNG KHỦNG LONG LỬA NGỦ SAY (30 CM) GB73",99000,99000,0,0
TIKI,do-choi-me-be,143503334,"BA LÔ CHỐNG GÙ HÌNH GẤU CHO BÉ",109000,109000,0,0
TIKI,do-choi-me-be,179764120,"Đồ bộ bé gái, quần áo Mimykid in 3D hoạt hình dễ thương, đáng yêu chất liệu thun dày mịn mát, được các bé gái yêu thích, thời trang, set, đồ cho trẻ em, bé gái từ 8kg-28kg",66000,66000,0,0
TIKI,do-choi-me-be,196757806,"Set 2 Miếng Silicon Bọc Góc Bàn, Góc Tủ, Cạnh Giường Giữ An Toàn Cho Bé",39000,39000,0,0
TIKI,do-choi-me-be,116448455,"Nước hoa Johnson's Baby Cho Bé - Dung Tích 125ml",81000,81000,0,0
TIKI,do-choi-me-be,54477959,"Đồ chơi trẻ em bằng nhựa ABS Vô Lăng Tập Lái Cho Bé Có 2 màu cho bé trai và gái",300000,300000,0,0
TIKI,do-choi-me-be,184101593,"Combo 2 túi nước xả vải làm mềm vải Comfort Chăm sóc Chuyên sâu Hương nước hoa thiên nhiên Bella túi 3.8L",420000,542000,122000,23
TIKI,do-choi-me-be,25026925,"Combo 2 Gói Tã Quần Người Lớn Sunmate Khô Thoáng M8 (8 Miếng/ Gói)",161000,199999,38999,19
TIKI,do-choi-me-be,122234661,"Đồ chơi lắp ráp tháp trượt lăn bi, trò chơi thách thức trí tuệ và vui nhộn cho bé từ 3 tuổi",180000,180000,0,0
TIKI,do-choi-me-be,20088699,"Dầu dưỡng ẩm mát xa Johnson's Baby (200ml)",105000,105000,0,0
TIKI,do-choi-me-be,130015080,"[MUA LÀ CÓ QUÀ] Tấm Lót Thấm Sữa Nha Đam Pigeon 12 miếng/30 miếng/50 miếng",42000,52000,10000,19
TIKI,do-choi-me-be,67546214,"Sữa Tắm Gội Toàn Thân Cetaphil Baby Gentle Wash Shampoo 2 in 1 (400ml)",221000,226000,5000,2
TIKI,do-choi-me-be,194017033,"Balo Tiểu Học Dành Bé Trai Mr Vui 838",337000,398000,61000,15
TIKI,do-choi-me-be,184101603,"Combo 2 túi nước xả vải làm mềm vải Comfort Chăm sóc Chuyên sâu Hương nước hoa thiên nhiên Sophia túi 3.8L",420000,542000,122000,23
TIKI,do-choi-me-be,67729762,"Sữa tắm gội toàn thân Cetaphil Baby Gentle Wash & Shampoo 2 in 1 400ml",221000,226000,5000,2
TIKI,do-choi-me-be,62315154,"Hộp 12 viên diệt gián tận gốc Nhật Bản",35999,35999,0,0
TIKI,do-choi-me-be,87378190,"Nước giặt LIX Đậm đặc Hương Nước hoa (Cam) tẩy sạch vết bẩn cực mạnh túi 3.5KGX2",189000,189000,0,0
TIKI,do-choi-me-be,164075691,"Tả quần Kitin Natural size L40 (9-14kg)",153000,225000,72000,32
TIKI,do-choi-me-be,576191,"Nước Giặt Kháng Khuẩn Mao Bao 3200g",124500,159000,34500,22
TIKI,do-choi-me-be,273235757,"Sữa dành cho người tiểu đường Glucerna Úc Bổ sung dinh dưỡng, cân bằng đường huyết, tạo sức khỏe tim, tăng sức khỏe chung - QuaTangMe Extaste",1045000,2090000,1045000,50
TIKI,do-choi-me-be,103881069,"Miếng Bịt Góc Bàn Ghế Hình Chân Mèo",56250,56250,0,0
TIKI,do-choi-me-be,3708857,"Combo 5 gói giấy ướt không mùi Mamamy mẫu mới nhất (Gói 100 tờ)",162500,162500,0,0
TIKI,do-choi-me-be,72875812,"Combo 20 gói khăn giấy lau tay Roto eco20-2 hai lớp 100% bột giấy nguyên sinh, dài 20cm, họa tiết chấm bi xốp, thấm hút 2 chiều, gồm 102 tờ/gói",232000,360000,128000,36
TIKI,do-choi-me-be,117720148,"Combo 4 miếng bịt góc bàn silicon an toàn cho trẻ - TIDO",20000,20000,0,0
TIKI,do-choi-me-be,125628724,"Cờ Tỉ Phú Monopoly – Cờ Tỷ Phú Vui Nhộn Cao Cấp, An Toàn Cỡ Cực Đại 42x42 – Hàng Chính Hãng",96000,180000,84000,47
TIKI,do-choi-me-be,188126560,"Combo 3 Viên Tẩy Bồn Cầu VIM Power 5 Hương Trà Xanh Chanh Vàng 55G",83000,84000,1000,1
TIKI,do-choi-me-be,101148136,"Bột Thông Cống YUHAO 280gr - Thông Tắc Cực Mạnh, Đường Ống, Bồn Cầu, Bồn Rửa Mặt - Hàng Chính Hãng",31000,39000,8000,21
TIKI,do-choi-me-be,115483438,"Sữa bột Enfamil A+ NeuroPro 1 với 2’-FL HMO cho trẻ từ 0 – 6 tháng tuổi– 830g",567000,567000,0,0
TIKI,do-choi-me-be,55512044,"Sữa Bột Anlene Gold Movepro 3X Hương Vanilla (Hộp Giấy 1,2kg)",455000,455000,0,0
TIKI,do-choi-me-be,104144223,"Tắm gội dịu nhẹ Pigeon Hoa hướng dương 200ml/700ml",60000,79000,19000,24
TIKI,do-choi-me-be,115483446,"Sữa bột Enfagrow A+ NeuroPro 3 với 2’-FL HMO cho trẻ từ 1 – 3 tuổi– 400g",239000,239000,0,0
TIKI,do-choi-me-be,173164598,"Sữa Bột Anlene Gold 5X Hương Vanilla (Hộp Thiếc 800g)",469000,508000,39000,8
TIKI,do-choi-me-be,147246867,"Sữa Bột Anlene Gold 5X Hương Vanilla (Hộp Thiếc 400g)",249000,268000,19000,7
TIKI,do-choi-me-be,435855,"Sữa Bột Abbott Grow Gold 6+cho trẻ từ 6 tuổi trở lên (900g)",464000,472500,8500,2
TIKI,do-choi-me-be,175953065,"Combo 4 Tã Dán Người Lớn SunMate G2 size M10, M/L10, XL10, M/L18",267000,365234,98234,27
TIKI,do-choi-me-be,967305,"Sữa Bột Abbott Similac Mom Vani 900g",465000,493020,28020,6
TIKI,do-choi-me-be,115483434,"Sữa bột Enfamil A+ NeuroPro 2 với 2’-FL HMO cho trẻ từ 6 –12  tháng tuổi– 1.7kg",979000,979000,0,0
TIKI,do-choi-me-be,52774130,"Bộ 2 chai chất thông tắc Cầu, Cống Sifa chống hôi Siêu nhanh Siêu mạnh 5 phút",110000,110000,0,0
TIKI,do-choi-me-be,88949150,"Sữa Bột Frisolac Gold 3 850g (Dành Cho Trẻ Từ 1 - 2 Tuổi)",484000,484000,0,0
TIKI,do-choi-me-be,105901380,"Vitamin k2 d3 hỗ trợ tăng chiều cao, hết còi xương cho trẻ sơ sinh - LINEABON K2D3 - Sản phẩm từ Châu Âu - Công nghệ mới giúp hấp thu tối đa canxi tự nhiên",271000,369000,98000,27
TIKI,do-choi-me-be,84705786,"Gạc Rơ Lưỡi, Vệ Sinh Răng Miệng Cho Bé Dr Papie (1 hộp 30 gói)",102000,102000,0,0
TIKI,do-choi-me-be,114958267,"Bộ Bài Tình Yêu Game Card Lovetouch - Love card game, board games, bài cho cặp đôi, bài thấu hiểu [Kim Ngọc Thuỷ]",155000,300000,145000,48
TIKI,do-choi-me-be,75357776,"Hộp quà cặp tóc dây buộc tóc công chúa bé gái nhiêu màu cực xinh",69000,69000,0,0
TIKI,do-choi-me-be,146555381,"Đồ Chơi Rút Gỗ Trẻ Em - 2 Cỡ (Lớn và Nhỏ) - 54 Thanh Rút Gỗ Kèm 4 Con Súc Sắc Cho Bé – Bộ Đồ Chơi Rút Gỗ Cao Cấp Chính Hãng dododios",49000,49000,0,0
TIKI,do-choi-me-be,185262304,"Kem đánh răng Colgate Batman 40g dành cho bé",23000,23000,0,0
TIKI,do-choi-me-be,177436965,"Đồ bơi trẻ em, đồ bơi bé trai chất vải chống nắng size lớn 45kg cho bé trai đến 10 tuổi",199000,224130,25130,11
TIKI,do-choi-me-be,68925517,"Cháo Tươi Tôm Rau Ngót Cây Thị",21600,25000,3400,14
TIKI,do-choi-me-be,49884598,"Sữa Morinaga Số 2 - Chilmil (850g) dành cho bé từ 6 đến 36 tháng tuổi",495000,578000,83000,14
TIKI,do-choi-me-be,76372614,"Đồ chơi trí tuệ Smart Games Thử thách IQ hạt tròn",279000,279000,0,0
TIKI,do-choi-me-be,89261232,"Combo 20 gói khăn giấy lau tay An Khang AK20-2 loại hai lớp dài 20cm - 102 tờ/gói",308000,440000,132000,30
TIKI,do-choi-me-be,86155733,"Bộ đồ chơi nhập vai BOWA – Bộ Trang điểm ( BOWA 8252 / BOWA 8255P )",259000,259000,0,0
TIKI,do-choi-me-be,61290431,"Combo 4 Gói Khăn Ướt Yuniku 90 Tờ Hương Phấn ( 90 tờ x 4 )",99000,167200,68200,41
TIKI,do-choi-me-be,6464021,"Cháo Tươi Cá Lóc Đậu Xanh Cây Thị",21600,25000,3400,14
TIKI,do-choi-me-be,12425736,"Lốc 4 Gói Khăn Giấy Cao Cấp Tempo Softpack Mùi Bạc Hà, 4 Lớp, Không Gây Kích Ứng Da (90 Tờ/ Gói) - Thương Hiệu Đức",105000,105000,0,0
TIKI,do-choi-me-be,6632811,"Cháo Tươi Thịt Heo Bí Đỏ Cây Thị",18000,21000,3000,14
TIKI,do-choi-me-be,88928340,"Combo 10 khăn ướt Mamamy ( 80 tờ )",285000,300000,15000,5
TIKI,do-choi-me-be,158887692,"Đồ chơi lắp ráp, xếp hình Qman 1801 - Trực thăng chiến đấu - 381 mảnh ghép",199000,269000,70000,26
TIKI,do-choi-me-be,2173355,"Combo 5 Bịch Khăn Vải Khô Likado (300g)",169000,169000,0,0
TIKI,do-choi-me-be,7459815," Thuốc diệt gián hộp 12 viên - Nội địa Nhật",55000,55000,0,0
TIKI,do-choi-me-be,85239904,"Cuộn Xốp Bọc Cạnh Bàn 2M - Dây Cao Su Che Bịt Cạnh Bàn, Ghế An Toàn Cho Bé",25000,25000,0,0
TIKI,do-choi-me-be,54619802,"Chai Thả Bồn Cầu Nhật bản, Vệ Sinh Bồn Cầu, Giúp Hỗ Trợ Giảm Thông Tắc Bồn Cầu Và Khử Mùi, Diệt Sạch 99% Vi Khuẩn (Combo 02 Lọ) - Hàng Chính Hãng",53000,58000,5000,9
TIKI,do-choi-me-be,57302858,"Bột Thông Cống, Thông Tắc Bồn Cầu Hàn Quốc Cao Cấp combo ( Hộp 5 Gói )",35192,35192,0,0
TIKI,do-choi-me-be,152469540,"Ghép Hình Lực Lượng Cảnh Sát - Xe Tuần Tra 158 Chi Tiết DK81063",81000,108000,27000,25
TIKI,do-choi-me-be,50131768,"Set 12 miếng silicon bọc cạnh, góc bàn bảo vệ bé không bị thương khi va đập",19000,19000,0,0
TIKI,do-choi-me-be,61285745,"Combo 4 Gói Khăn Ướt Yuniku 90 Tờ Không Hương ( 90 tờ x 4 )",99000,167200,68200,41
TIKI,do-choi-me-be,270229665,"Sách nói điện tử song ngữ trẻ em (Bản nâng cấp 1+) - Sách quý điện tử song ngữ Anh – Việt cho bé - Có lựa chọn lấy thêm pin",122000,140000,18000,13
TIKI,do-choi-me-be,75521920,"Combo 10 cuộn giấy vệ sinh lớn An Khang AKC500 hai lớp loại 500gr",320000,480000,160000,33
TIKI,do-choi-me-be,19944439,"Tã Dán Moony Natural Bông Organic M46 (46 Miếng)",379000,569400,190400,33
TIKI,do-choi-me-be,435891,"Sữa Bột Abbott Glucerna Vani 850g",890000,890000,0,0
TIKI,do-choi-me-be,20088701,"Dầu gội Johnson's Baby dịu nhẹ (800ml)",159000,192000,33000,17
TIKI,do-choi-me-be,79672168,"Sữa Bột Enfagrow Premium Toddler Hương Sữa Tự Nhiên cho trẻ 1-3 tuổi (907g)",691000,691000,0,0
TIKI,thiet-bi-kts-phu-kien-so,144973012,"Chuột không dây Bluetooth 5.0 Dareu LM115B + Wireless 2.4GHz ( Silent Switch ) - Hàng chính hãng",210000,210000,0,0
TIKI,thiet-bi-kts-phu-kien-so,67503564,"Thẻ Nhớ Camera Hikvision 32Gb Class 10 - Hàng nhập khẩu",69000,69000,0,0
TIKI,thiet-bi-kts-phu-kien-so,136312573,"Dây Đeo RINGKE Lanyard Finger Strap - Hàng Chính Hãng",72000,80000,8000,10
TIKI,thiet-bi-kts-phu-kien-so,74191048,"Sạc nhanh 20W cho iPhone và điện thoại Android - Baseus Super Si Quick Charger - Hàng chính hãng",148296,148296,0,0
TIKI,thiet-bi-kts-phu-kien-so,10126332,"Radio Sony ICF-P36 (Hàng nhập khẩu)",850000,850000,0,0
TIKI,thiet-bi-kts-phu-kien-so,192407176,"Cường Lực Cho Iphone Có Khung Tự Dán Nano Full Màn Kingkog Baiko Màng Bảo Vệ Loa Điện Thoại Chống Bụi",35000,35000,0,0
TIKI,thiet-bi-kts-phu-kien-so,195300846,"Cáp Sạc ANKER Powerline+ II USB-C To USB-C Phiên Bản Marvel - A9547 / A9549 - Hàng Chính Hãng",250000,300000,50000,17
TIKI,thiet-bi-kts-phu-kien-so,26292596,"Cáp gộp tai nghe và mic ra jack 3,5mm âm",33000,33000,0,0
TIKI,thiet-bi-kts-phu-kien-so,59091343,"Pin Sạc Dự Phòng Nhỏ Gọn RAVPower 10000mAh Quick Charge 3.0 + PD 20W, In/Out Type-C - RP-PB186 - Hàng Chính Hãng",666000,1100000,434000,39
TIKI,thiet-bi-kts-phu-kien-so,177207837,"Củ Sạc Type C Samsung 25W (không kèm cáp) - Hàng chính hãng, Mới 100",386000,490000,104000,21
TIKI,thiet-bi-kts-phu-kien-so,148840448,"Hộp Đựng Tai Nghe Cáp Sạc Củ Sạc Pin Sạc Dự Phòng, Ổ Cứng, Cáp USB, Pin Dự Phòng – Hộp Đựng Phụ Kiện Điện Thoại Đồng Hồ Thông Minh – Bảo Vệ Phụ Kiện Di Động LapTop Hàng Chính Hãng Dododios",69000,69000,0,0
TIKI,thiet-bi-kts-phu-kien-so,53639147,"Cáp chuyển đổi VGA sang HDMI VS - hỗ trợ FullHD 1080P (đen)",57900,57900,0,0
TIKI,thiet-bi-kts-phu-kien-so,4889007,"Tai Nghe Nhét Tai Langsdom Super Bass JM26 cho iPhone/Samsung/Oppo - Hàng Nhập Khẩu 2018",45000,55000,10000,18
TIKI,thiet-bi-kts-phu-kien-so,175901359,"Củ Sạc Nhanh 20W PD & QC3.0 2 Cổng Hoco C80/C80A - Cốc Sạc Siêu Nhanh Cho iPhone, Samsung, Xiaomi,... - Hàng Chính Hãng",89000,89000,0,0
TIKI,thiet-bi-kts-phu-kien-so,195032585,"Dụng cụ vệ sinh bàn phím máy tính, điện thoại, tai nghe đa năng gọn nhẹ cầm tay 7 trong 1 bản đặc biệt 2022",46800,46800,0,0
TIKI,thiet-bi-kts-phu-kien-so,157148921,"Giá treo màn hình Human Motion T6 Black - Hàng Chính Hãng ",630000,630000,0,0
TIKI,thiet-bi-kts-phu-kien-so,109764211,"Ốp lưng kéo nắp cao cấp dành cho iPhone 12 Pro Max / 11 Pro Max / XR / X/XS / XS Max / 7 Plus/ 8 Plus / 11 Pro / 12 Pro / 11/ 12 / 12 Mini - Hàng chính hãng",49000,69000,20000,29
TIKI,thiet-bi-kts-phu-kien-so,56515226,"Bút Cảm Ứng V-Tech Dành Cho Điện Thoại Ipad Máy Tính Bảng - Hàng Nhập Khẩu (Tặng Đầu Cảm Ứng Thay Thế)",125000,250000,125000,50
TIKI,thiet-bi-kts-phu-kien-so,174397451,"Ốp lưng kéo nắp kiểu mới dành cho iPhone 7 / 8 / SE 2020 / SE 2022 / 7 Plus / 8 Plus / X / XS / XR / XS Max - Hàng chính hãng",99000,150000,51000,34
TIKI,thiet-bi-kts-phu-kien-so,59253777,"Ốp lưng dẻo silicon cho Samsung Galaxy Note 10 Plus hiệu Ultra Thin (siêu mỏng 0.6mm, chống trầy, chống bụi) - Hàng nhập khẩu",34999,34999,0,0
TIKI,thiet-bi-kts-phu-kien-so,82861299,"Loa Bluetooth PKCB Bản Mở Rộng, chống nước IPX5 Hỗ Trợ Kết Nối Bluetooth ,Thẻ Nhớ, USB - Hàng chính hãng",189000,550000,361000,66
TIKI,thiet-bi-kts-phu-kien-so,109601744,"Gậy Chụp Hình Tripod 3 Chân Đa Năng 1688 Có Remote Bluetooth - Gậy Tự Sướng Kiêm Chân Đế Kẹp Điện Thoại, Máy Ảnh",164000,164000,0,0
TIKI,thiet-bi-kts-phu-kien-so,178044028,"Tai Nghe Chụp Tai HUQU HQ33 - Chống Ồn, Âm Bass Mạnh Mẽ, Âm Thanh Vòm 360 - Hàng Chính Hãng",351500,370000,18500,5
TIKI,thiet-bi-kts-phu-kien-so,180580800,"Tai Nghe Có Dây HuQu HQ-XB450 - Thiết Kế Đệm Tai Êm Ái - Hàng Chính Hãng",161500,170000,8500,5
TIKI,thiet-bi-kts-phu-kien-so,180576829,"Tai Nghe Chống Ồn HuQu HQ-P30 Giảm Tiếng Ồn - Hàng Chính Hãng",332500,350000,17500,5
TIKI,thiet-bi-kts-phu-kien-so,555019,"Bàn phím game có dây Logitech G213 Prodigy RGB Lightsync - Hàng chính hãng",879000,879000,0,0
TIKI,thiet-bi-kts-phu-kien-so,155289779,"Dây Cáp Type C To HDMI 4K 60Hz Dài 1.8M, Dây Nylon Dù Thunderbolt 3 CHOETECH CH0021 - Hàng Chính Hãng",379000,690000,311000,45
TIKI,thiet-bi-kts-phu-kien-so,72575224,"Ốp lưng dẻo mỏng màu đen dành cho iPhone 7 Plus / 8 Plus - Hàng chính hãng",39000,45000,6000,13
TIKI,thiet-bi-kts-phu-kien-so,29362759,"Tai Nghe Bluetooth không dây K23 - Tai Nghe Đàm Thoại Một Bên + Tặng Tai Nghe Để Nghe Hai Bên",149000,149000,0,0
TIKI,thiet-bi-kts-phu-kien-so,56713451,"Chuột Game Không Dây Sạc Điện HXSJ T30  3600DPI Wireless 2.4GHz, USB Type C - Hàng chính hãng",299000,540000,241000,45
TIKI,thiet-bi-kts-phu-kien-so,73768914,"Ốp lưng Memumi cho iPhone 12 mini / 12 Pro /12 Pro Max bảo vệ camera, siêu mỏng 0.3 mm Hàng nhập khẩu",84797,84797,0,0
TIKI,thiet-bi-kts-phu-kien-so,142135437,"Ngòi Bút Cho Spen Samsung Note 10, Note 10 plus, Note 20, Note 20 Ultra, Tab S6, S7, S7 Plus, S21 Ultra",65000,65000,0,0
TIKI,thiet-bi-kts-phu-kien-so,181908744,"Tai Nghe Bluetooth Thời Trang HUQU HQ-K6131 Hỗ Trợ Nghe FM -Hàng Chính Hãng",418000,440000,22000,5
TIKI,thiet-bi-kts-phu-kien-so,85306600,"Máy Nghe Nhạc MP3 Lossless Bluetooth 5.1 Ruizu D51 Bộ Nhớ Trong 8GB (Có Loa Ngoài) - Hàng Chính Hãng",539000,539000,0,0
TIKI,thiet-bi-kts-phu-kien-so,107362350,"Cốc sạc nhanh Baseus Dual Quick Charger 20W - Hàng chính hãng",178900,178900,0,0
TIKI,thiet-bi-kts-phu-kien-so,137547912,"Cáp DVI to DVI 2 đầu dương 1,5M",61646,64890,3244,5
TIKI,thiet-bi-kts-phu-kien-so,47272512,"Ốp lưng dẻo mỏng dành cho iPhone 11 - Màu đen",49000,69000,20000,29
TIKI,thiet-bi-kts-phu-kien-so,111977850,"Bộ Cáp Type C to HDMI Phân Giải 4K 60Hz Dài 1.8M Kèm Đầu Chuyển C to HDMI Thunderbolt 3 CHOETECH CH0033-BK - Hàng Chính Hãng",599000,1090000,491000,45
TIKI,thiet-bi-kts-phu-kien-so,195254839,"Loa thanh Soundbar Samsung 2.1 HW-T420 - Hàng chính hãng",1379000,1379000,0,0
TIKI,thiet-bi-kts-phu-kien-so,4216157,"Sim Và Esim 3G/4G/5G True Move Du Lịch Thái Lan 50GB (5G) Và 100 Phút Gọi Thái Lan  - Hàng Chính Hãng-Mẫu ngẫu nhiên",165000,165000,0,0
TIKI,do-choi-me-be,25769067,"Cờ Vua Nam Châm Cỡ Lớn miDoctor 4812A",175000,175000,0,0
TIKI,do-choi-me-be,66615105,"Bộ bài Uno Giấy cứng giải trí",18800,18800,0,0
TIKI,do-choi-me-be,6464017,"Cháo Tươi Cá Hồi Rong Biển Cây Thị",22500,26000,3500,13
TIKI,do-choi-me-be,17114404,"Sữa tắm gội toàn thân Johnson's Baby mềm mịn (500ml)",145000,178000,33000,19
TIKI,do-choi-me-be,104131972,"Núm vú cổ rộng silicone siêu mềm Plus Pigeon 2 Cái/Vỉ",120000,199000,79000,40
TIKI,do-choi-me-be,88928273,"Combo 10 Gói Khăn Ướt Trẻ Em MAMAMY 100 Tờ",296000,323000,27000,8
TIKI,do-choi-me-be,145512639,"Nút Che Bịt Ổ Điện Chắc Chắn An Toàn Cho Bé",1881,1900,19,1
TIKI,do-choi-me-be,270845223,"Sữa cho bé 1 đến 3 tuổi Meiji nội địa Nhật giúp bé phát triển cân đối chiều cao, cân nặng, trí não - QuaTangMe Extaste",415000,415000,0,0
TIKI,do-choi-me-be,130461472,"Sữa Bột Similac Einstein 3 cho trẻ 1 – 2 tuổi",510000,510000,0,0
TIKI,do-choi-me-be,71080136,"Sure Prevent Gold HT 900g",615000,615000,0,0
TIKI,do-choi-me-be,68179518,"Nước Tẩy Nhà Tắm Mao Bao 600ml",42500,50000,7500,15
TIKI,do-choi-me-be,76072139,"Xe công trình xây dựng bằng kim loại  KAVY gồm 6 xe chi tiết sắc sảo, an toàn cho bé, dùng làm đồ chơi trẻ em hoặc trang trí",129000,129000,0,0
TIKI,do-choi-me-be,104140783,"Tắm gội dịu nhẹ Pigeon Hương Jojoba 200ml/700ml",60000,79000,19000,24
TIKI,do-choi-me-be,1744987,"Tã Quần Mỏng Nhẹ Caryn Gói Siêu Lớn M16 (16 Miếng)",180000,181600,1600,1
TIKI,do-choi-me-be,10054502,"Thùng 48 Hộp Sữa Bột Pha Sẵn Friso Gold Rtd Vani (48 x 180Ml)",685000,807000,122000,15
TIKI,do-choi-me-be,73638976,"Tẩy dầu mỡ máy hút mùi, mặt bếp, tường gạch ốp, bồn rửa bát HGO 500ml",105000,105000,0,0
TIKI,do-choi-me-be,184217978,"Nước Giặt ARIEL Cửa Trên Sạch Sâu",214000,236500,22500,10
TIKI,do-choi-me-be,102738895,"Muối Rửa Bát Finish 1,2kg - Hàng Nhập Khẩu Đức",109000,109000,0,0
TIKI,do-choi-me-be,57967652,"Viên Thả Bồn Cầu Nhật Bản Dạng Nén Cao Cấp HOMI Mã HC01 Thế Hệ 2 Giúp Diệt Sạch Vi Khuẩn Khử Mùi Hiệu Quả Tuyệt Đối An Toàn Khi Sử Dụng (Hộp 10 viên) - Hàng Chính Hãng",26000,89000,63000,71
TIKI,do-choi-me-be,34537693,"Tã Dán Siêu Thấm Caryn Gói Siêu Tiết Kiệm L40 (40 Miếng)",369000,403300,34300,9
TIKI,do-choi-me-be,10021552,"Sữa Bột Meiji 0-1 Infant Formula (800g)",519000,519000,0,0
TIKI,do-choi-me-be,249030271,"Ensure Úc sữa cho người lớn Giúp hồi phục sức khỏe cho người gầy yếu, người suy dinh dưỡng - QuaTangMe Extaste",903000,2078000,1175000,57
TIKI,do-choi-me-be,170331247,"Gạc Rơ Lưỡi Oribebe Vệ Sinh Răng Miệng Cho Bé Hộp 30 Gói",115000,165000,50000,30
TIKI,do-choi-me-be,68612841,"Combo 2 túi nước giặt xả Maxkleen hương Vườn Sớm Mai 3.8kg/túi ",291000,420000,129000,31
TIKI,do-choi-me-be,116452634,"Khăn giấy bếp PREMIER VinaRoll 2 cuộn/gói - Combo 3 gói",68000,99000,31000,31
TIKI,do-choi-me-be,29540357,"Đồ chơi lắp ghép xếp hình  Trực thăng chiến đấu 8 trong 1 Qman 1801",229000,229000,0,0
TIKI,do-choi-me-be,53039237,"Combo 2 Túi Nước rửa bình sữa Arau Baby (450ml x 2 túi)",229000,229000,0,0
TIKI,do-choi-me-be,6464033,"Cháo Tươi Rau Củ Thập Cẩm Cây Thị",18900,22000,3100,14
TIKI,do-choi-me-be,76507811,"Đồ Chơi Rút Gỗ Trẻ Em - 2 Cỡ (Lớn và Nhỏ) - 54 Thanh Rút Gỗ Kèm 4 Con Súc Sắc Cho Bé – Bộ Đồ Chơi Rút Gỗ Cao Cấp Chính Hãng Amalife",39000,39000,0,0
TIKI,do-choi-me-be,97008405,"Combo 02 Hộp Vệ Sinh Lồng Máy Giặt Ag+ Mao Bao 306g - Tặng Chất Làm Sạch Bình Đun Nước 25g x 1 gói",84000,100000,16000,16
TIKI,do-choi-me-be,543129,"Dung Dịch Giặt Quần Áo Cho Bé D-Nee - Chai 3000ml (Xanh)",196000,245000,49000,20
TIKI,do-choi-me-be,95035819,"Bột ăn dặm dinh dưỡng Sữa - Ăn dặm khởi đầu HiPP Organic 250g",145000,145000,0,0
TIKI,do-choi-me-be,97846795,"Set 5 Khăn Rửa Mặt 4 Lớp Sợi Tre Lụa Mềm, Thấm Hút Tốt, Kháng Khuẩn 100% Thương Hiệu Bonny (KT: 30x30 Cm)",98000,98000,0,0
TIKI,do-choi-me-be,52344942,"Combo 4 gói Khăn Giấy Rút See-U 2 Lớp 200 Tờ/gói",66000,66000,0,0
TIKI,do-choi-me-be,129577440,"Bột Tẩy Rong Rêu Trên Nền Xi Măng ROC",38997,38997,0,0
TIKI,do-choi-me-be,104125144,"Ty ngậm đôi Pigeon size L (HSD: 11/2025)",95000,158000,63000,40
TIKI,do-choi-me-be,189657651,"Nước giặt Lix Đậm Đặc Hương Hoa Túi 3.5Kg - Tẩy Sạch Cực Mạnh Vết Bẩn - NG350",115000,115000,0,0
TIKI,do-choi-me-be,43191091,"Thùng 48 Hộp Sữa Anlene Đậm Đặc 4X Ít Béo Hương Vani (12 x 4 x 125 ml)",509000,552000,43000,8
TIKI,do-choi-me-be,412772,"Tã Quần Cao Cấp Moony Nhật Bản Bé Gái XL38 (38 Miếng)",339000,466400,127400,27
TIKI,do-choi-me-be,109882431,"BẤM MÓNG TAY AN TOÀN CHO TRẺ SƠ SINH NUK DÙNG CHO BÉ TỪ 0 THÁNG TUỔI",65000,69000,4000,6
TIKI,do-choi-me-be,114465568,"Nước Tắm Tinh Dầu Bảo Linh Dành Cho Trẻ Em 70ml",120000,165000,45000,27
TIKI,do-choi-me-be,94392344,"Cây Xương Rồng Khiêu Vũ Nhảy Múa Phát Ra Âm Thanh Vui Nhộn - Xương rồng nhại tiếng",79000,79000,0,0
TIKI,do-choi-me-be,196048058,"Hộp 300 sợi chun buộc tóc nhiều màu siêu dễ thương cho bé",45000,60000,15000,25
TIKI,do-choi-me-be,5865883,"Nước thơm lau sàn nhà Hando 1L hương nhài",25000,25000,0,0
TIKI,do-choi-me-be,57751883,"Combo 3 Xịt da chống muỗi PlasmaKare chống muỗi 24/7",380000,380000,0,0
TIKI,do-choi-me-be,195707718,"Bộ Cổ Bo Màu Tay Ngắn BN0014 - Xanh Rêu Nhạt - Size 4 (12-13) kgs",129000,129000,0,0
TIKI,do-choi-me-be,117296501,"Đồ chơi an toàn cho bé 100 quả bóng nhựa Việt Nam Chất lượng cao cho nhà bóng lều bóng quây bóng",92999,92999,0,0
TIKI,do-choi-me-be,161540109,"Mũ nồi dạ màu trơn cho bé 4-12y Mimo baby MN62",189000,189000,0,0
TIKI,do-choi-me-be,120761658,"Bộ quần áo bé trai cộc tay BIGFOX - MISS MEOW size đại mùa hè vải cotton phong cách Âu Mỹ in cá sấu  LATER ALIGATOR size trẻ em 3-11 tuổi 10 - 38 kg QATE",159000,200000,41000,21
TIKI,do-choi-me-be,20547120,"Dây Bọc Cạnh Bàn Chống Va Chạm Cho Bé",46023,46023,0,0
TIKI,do-choi-me-be,805618,"Cháo Ăn Dặm  Mabu Nguyên Hạt (900g)",199000,199000,0,0
TIKI,do-choi-me-be,193891171,"Balo tiểu học- Siêu nhân",176000,280000,104000,37
TIKI,do-choi-me-be,103514028,"04 bộ tranh xếp hình 35 mảnh khổ A4 20x30cm – đồ chơi trí tuệ cho bé từ 2 tuổi – Combo 1",75000,100000,25000,25
TIKI,do-choi-me-be,123353396,"Gối Ôm Bà Bầu Chữ U Vải Nhung Mềm Mại (màu ngẫu nhiên)",250000,250000,0,0
TIKI,do-choi-me-be,53872113,"Ngũ Cốc Mẹ Bầu Pregnlife Long Liên Cao Cấp Siêu Dinh Dưỡng Gồm 14 Loại Hạt - Tặng Kèm Muỗng Gỗ ",256000,320000,64000,20
TIKI,do-choi-me-be,191654241,"Nước giặt xả Hiclass 3500ml - Hàng Thái Lan",199000,199000,0,0
TIKI,do-choi-me-be,55498362,"Combo 10 Quần bỏ bỉm vải cotton 6 lớp siêu thấm, thoáng mát hiệu Goodmama cho Bé Gái từ 5-17 kg",370000,370000,0,0
TIKI,do-choi-me-be,51117816,"Gối Em Bé KuKu KU2084",262990,289000,26010,9
TIKI,do-choi-me-be,13288021,"Set 100 dây buộc tóc dễ thương cho bé (Giao mẫu ngẫu nhiên)",29000,29000,0,0
TIKI,do-choi-me-be,13943439,"Mũ gội đầu hà mã - Royalcare 
(Màu",75000,109000,34000,31
TIKI,do-choi-me-be,58392954,"Combo 20 cuộn Giấy vệ sinh ALPHA, 2 Lớp, 60g/cuộn",74000,74000,0,0
TIKI,do-choi-me-be,196312554,"Máy hâm nóng sữa đôi điện tử Yoboo YB-0042 có 6 chức năng, điều khiển cảm ứng, hẹn giờ trước - Hàng chính hãng",559000,559000,0,0
TIKI,do-choi-me-be,107792123,"Đồ bộ quần áo cộc tay cho bé hoạt tiết động vật QATE636 cho bé 8kg - 18kg",66000,66000,0,0
TIKI,do-choi-me-be,72913355,"Bộ tranh xếp hình jigsaw puzzle cao cấp 330 mảnh – Trà Chiều",78000,100000,22000,22
TIKI,do-choi-me-be,52796364,"Đồ Chơi Rubik 4x4x4 Không Viền Sắc Màu",54000,57000,3000,5
TIKI,do-choi-me-be,127190390,"SÉT 4 ÁO LÓT LÁ HỌC SINH XUẤT HÀN COTTON  cho bé gái từ 20-50kg",175000,175000,0,0
TIKI,do-choi-me-be,102123817,"Quần lót bầu cạp chéo Azuno Chất Liệu Đũi Xước Thoáng Khí, Kháng Khuẩn Cho Mẹ",45000,55000,10000,18
TIKI,do-choi-me-be,149490983,"Dây mực in PLA cho bút vẽ 3D: 50m 5 cuộn 5 màu khác nhau",75000,75000,0,0
TIKI,do-choi-me-be,128783539,"Thảm nằm 2 mặt cao cấp XPE loại 1 (hình ngẫu nhiên) đủ kích thước - 1m6 x 2m - Hàng Chất Lượng",139000,139000,0,0
TIKI,do-choi-me-be,72693442,"02 bộ tranh xếp hình 70 mảnh ghép khổ A3 – đồ chơi trí tuệ cho bé từ 3 tuổi – Combo 10",55000,75000,20000,27
TIKI,do-choi-me-be,13312863,"BÌNH SỮA Y TẾ CỔ THƯỜNG 250 ML DR.BROWN'S",386000,386000,0,0
TIKI,do-choi-me-be,37295439,"Bộ mài dũa móng tay 6  đầu dũa đa năng dành cho bé",87299,87299,0,0
TIKI,do-choi-me-be,51597263,"Gối Ôm Chữ U Đa Năng cho Bà Bầu - Gối Ngủ cho Mẹ Bầu chính hãng Zcare - chứng nhận Độc Quyền bởi bộ Khoa học công nghệ; Gối bà bầu có hình chữ U nâng đỡ 6 điểm, giúp bà bầu thoải mái khi ngủ; Gối chuyên dụng cho bà bầu nên các nguyên vật liệu an toàn và c",619000,619000,0,0
TIKI,do-choi-me-be,96924122,"BỊCH KHĂN VẢI KHÔ ĐA NĂNG 500GR - AIKO (HÀNG VIỆT NAM CHẤT LƯỢNG CAO)",60000,60000,0,0
TIKI,do-choi-me-be,54014704,"Đồ Chơi Baby Rock Star Happy Baby - Organ Điện Tử",82500,110000,27500,25
TIKI,do-choi-me-be,150868398,"Quần thun thể dục 3 sọc Amazing, lưng thun, dây rút, vải cotton co giãn, hút mồ hôi, đủ size từ 20-100kg, Unisex",71000,114000,43000,38
TIKI,do-choi-me-be,35266659,"Combo 2 Áo Lót Mẹ Bầu Và Cho Con Bú Thông Hơi Cao Cấp (Giao Mầu Ngẫu Nhiên)",75000,75000,0,0
TIKI,do-choi-me-be,47422932,"Lắp ráp đồng hồ biến hình Robot",77000,77000,0,0
TIKI,do-choi-me-be,29830344,"Gấu bông pokemon Rồng Dragonair",100000,100000,0,0
TIKI,do-choi-me-be,16555626,"Ngựa bập bênh kiêm xe chòi chân cho bé (có nhạc + bánh xe + đệm lót)",194000,194000,0,0
TIKI,thiet-bi-kts-phu-kien-so,173116772,"Ốp lưng cho Samsung A12 A32 A52 A52s A72 A02 A02S M12 4G 5G chống sốc 2 lớp kèm nhẫn iring làm giá đỡ",59000,59000,0,0
TIKI,thiet-bi-kts-phu-kien-so,140135744,"Bộ 2 miếng kính cường lực Gor cho iPhone 13 Mini / 13 / 13 Pro / 13 Pro Max - Full Box - Gor - Hàng nhập khẩu",93000,119898,26898,22
TIKI,thiet-bi-kts-phu-kien-so,73161165,"Thẻ Nhớ MicroSD SanDisk Ultra 32GB 100MB/s - Hàng Chính Hãng",126000,126000,0,0
TIKI,thiet-bi-kts-phu-kien-so,138374307,"Bộ bàn phím và chuột không dây bluetooth cho điện thoại máy tính bảng ipad laptop macbook tivi Windows/Android/IOS",131900,131900,0,0
TIKI,thiet-bi-kts-phu-kien-so,177835953,"Ốp Lưng dành cho Galaxy Z Flip 3 vải sợi thời trang",85000,85000,0,0
TIKI,thiet-bi-kts-phu-kien-so,191571013,"Dây Cao Su Sport Color dành cho Samsung Galaxy Fit 2 (SM-R220)- Hàng chính hãng",94050,99000,4950,5
TIKI,thiet-bi-kts-phu-kien-so,4482101,"Cáp nối dây máy in dài 1,5m",11400,11400,0,0
TIKI,thiet-bi-kts-phu-kien-so,272420279,"Cáp sạc nhanh thay thế cho các dòng đồng hồ Garmin cổng Type C- Hàng Chính Hãng",67000,75000,8000,11
TIKI,thiet-bi-kts-phu-kien-so,158165120," Dây Cáp Sạc Micro USB Dành Cho Samsung, OPPO- Hàng Nhập khẩu",33000,42898,9898,23
TIKI,thiet-bi-kts-phu-kien-so,183502973,"Cáp Sạc Nhanh Baseus Horizontal Data Cable - Dùng Cho iPhone iPad - Trang Bị Đèn Led - Công Nghệ Chống Đứt Gãy SR - Hàng Chính Hãng",75000,75000,0,0
TIKI,thiet-bi-kts-phu-kien-so,130969202,"Kính Cường Lực Chống Nhìn Trộm KingKong Dành Cho iPhone 13, 13Mini, 13Pro, 13Pro Max, iPhone 14, 14Plus, 14Pro, 14Pro Max - Dán Full Màn - Full Hộp - Hàng chính hãng",81000,139999,58999,42
TIKI,thiet-bi-kts-phu-kien-so,195741816,"Kính Cường Lực Kingkong 3D Trong Suốt Cho iPhone - Dán Full Màn - Full Hộp Sắt Cao Cấp - Hàng Chính Hãng",84000,149999,65999,44
TIKI,thiet-bi-kts-phu-kien-so,114359470,"Cáp sạc 3.5A Baseus Rapid Series kết nối 2 Type-C/ Micro/ iPhone tiện lợi dài 1.2M - Hàng chính hãng",130000,130000,0,0
TIKI,thiet-bi-kts-phu-kien-so,76149479,"Dây cáp quang Toslink âm thanh kỹ thuật số SPDIF dùng cho TV smart, bộ khuếch đại, Xbox One, PS4, PlayStation, Soundbar, đầu phát Blu-Ray, đầu CD UGREEN AV122 - Hàng chính hãng",90000,90000,0,0
TIKI,thiet-bi-kts-phu-kien-so,136796491,"Bộ Chuyển Đổi Quang Điện Netlink 3100 AB 25KM - Converter Quang",108000,108000,0,0
TIKI,thiet-bi-kts-phu-kien-so,52333193,"Tai nghe bluetooth không dây F9 True wireless Dock Sạc có Led Báo Pin Kép",64900,64900,0,0
TIKI,thiet-bi-kts-phu-kien-so,190240726,"Pad chuột cỡ lớn lót bàn phím, miếng lót chuột, bàn di siêu mượt trải bàn kích thước lớn - Hàng chính hãng",55000,55000,0,0
TIKI,thiet-bi-kts-phu-kien-so,82874789,"Loa Bluetooth PKCB Bản Mở Rộng, chống nước IPX5 Hỗ Trợ Kết Nối Bluetooth ,Thẻ Nhớ, USB - Hàng chính hãng",194000,500000,306000,61
TIKI,thiet-bi-kts-phu-kien-so,73165085,"Chuột không dây Bluetooth Logitech MX Anywhere 3 - Màu",1550000,1550000,0,0
TIKI,thiet-bi-kts-phu-kien-so,57897567,"Sạc dự phòng Energizer 10,000mAh /3.7V Li-Polymer - UE10053 - Hàng Chính Hãng",550000,550000,0,0
TIKI,thiet-bi-kts-phu-kien-so,142793158,"Bảng Vẽ One by Wacom Small CTL-472 - Hàng Chính Hãng",1325000,1325000,0,0
TIKI,thiet-bi-kts-phu-kien-so,31547651,"Adapter Sạc 1 Cổng 18W Xiaomi ZMI HA612 Hỗ Trợ Sạc Nhanh QC 3.0 - HÀNG NHẬP KHẨU",123500,123500,0,0
TIKI,thiet-bi-kts-phu-kien-so,66708181,"Miếng Lót Chuột Khổ Lớn Chất Liệu Da, Pad Chống Nước, Bàn Di Chuột YORN - Hàng Chính Hãng",80000,80000,0,0
TIKI,thiet-bi-kts-phu-kien-so,577028,"Loa Bluetooth Harman Kardon Go + Play mini 100W",5290000,6490000,1200000,18
TIKI,thiet-bi-kts-phu-kien-so,202793622,"Chuột Chơi Game Có Dây Logitech G102 8000DPI RGB 6 Phím - Hàng Chính Hãng",390000,390000,0,0
TIKI,thiet-bi-kts-phu-kien-so,195305637,"Adapter Sạc ANKER Nano II 45W Type-C 713 GaN II PPS Có Thể Gấp Gọn Tương Thích Nhiều Thiết Bị - A2664 - Hàng Chính Hãng",800000,950000,150000,16
TIKI,thiet-bi-kts-phu-kien-so,142477644,"Adapter Củ Sạc 33W PPS/ PD 30W / QC 3.0 1 Cổng Type C 1 Cổng USB Nhỏ Gọn CHOETECH PD5006 Sạc Nhanh iPhone, iPad, Samsung - Hàng Chính Hãng",329000,550000,221000,40
TIKI,thiet-bi-kts-phu-kien-so,112316466,"Bàn phím cơ không dây Newmen GM610 - Hàng chính hãng",1019000,1019000,0,0
TIKI,thiet-bi-kts-phu-kien-so,91189530,"Cáp chuyển đổi USB type C sang cổng mạng LAN 1Gbps RJ45 UGREEN CM199 50737- Hàng chính hãng",546000,546000,0,0
TIKI,thiet-bi-kts-phu-kien-so,59355019,"Bộ Củ Cáp Sạc Siêu Nhanh 45W  Dành Cho  Samsung Galaxy Note10 Plus, S20 Ultra - Adapter Fast Charging",190000,359000,169000,47
TIKI,thiet-bi-kts-phu-kien-so,74265058,"Bộ Chuyển Âm Thanh TV 4K Quang Optical Sang Audio AV Ra Amply + Cáp Optical (1m) HÀNG CHÍNH HÃNG NETBOX",139000,139000,0,0
TIKI,thiet-bi-kts-phu-kien-so,58889100,"Cáp Chuyển Đổi USB Type-C Sang Jack 3.5 mm Cho Tai Nghe",18826,18826,0,0
TIKI,thiet-bi-kts-phu-kien-so,91192959,"Dây máy in USB 2.0 chuẩn A đực sang chuẩn B đực độ dài từ 1-5m UGREEN US135 - Hàng Chính hãng",50000,84000,34000,40
TIKI,thiet-bi-kts-phu-kien-so,150936608,"Bàn phím cơ không dây Dareu EK807G Black - Hàng Chính Hãng",649000,649000,0,0
TIKI,thiet-bi-kts-phu-kien-so,48550354,"Dây nguồn 1 đầu USB ra đầu tròn cỡ trung 3.5mm",19980,19980,0,0
TIKI,thiet-bi-kts-phu-kien-so,142238727,"Bàn phím không dây bluetooth Logitech MX Keys Mini - Hàng Chính Hãng",2250000,2250000,0,0
TIKI,thiet-bi-kts-phu-kien-so,8387126,"Máy ghi âm Sony ICD-PX470 - Hàng Nhập Khẩu",1750000,1750000,0,0
TIKI,thiet-bi-kts-phu-kien-so,111156743,"Bộ cáp sạc nhanh đa năng REMAX Wanbo Series 60W RC-190 - Hàng chính hãng",199000,300000,101000,34
TIKI,thiet-bi-kts-phu-kien-so,152288798,"Tai Nghe Gaming Chụp Tai RAPOO VH160 Âm Thanh 7.1, Đèn LED, Micro Khử Ồn ENC - Hàng Chính Hãng",399000,399000,0,0
TIKI,thiet-bi-kts-phu-kien-so,190093953,"Miếng Dán Mặt Đồng Hồ Hydrogel Film Siêu Mỏng dành cho Apple Watch- Hàng chính hãng",19000,27498,8498,31
TIKI,do-choi-me-be,42957984,"Bộ tranh xếp hình cao cấp 1500 mảnh – Nhà Thờ St. Basil, Nga (60x100cm)",285000,360000,75000,21
TIKI,do-choi-me-be,197544914,"Gấu bông khủng long đeo tai nghe cao cấp - Thú nhồi bông siêu dễ thương",215000,430000,215000,50
TIKI,do-choi-me-be,125681962,"Combo 5 Quần sơ sinh dài mặc bỉm bo gấu Babiboo BB44",190000,190000,0,0
TIKI,do-choi-me-be,145703441,"Áo ô tô 95 mc queen cực đẹp cho bé trai",62000,62000,0,0
TIKI,do-choi-me-be,108760703,"Áo khoác bé gái hình ngựa Pony 11-43kg - Áo lạnh nữ - PONY - Thun cotton da cá in 3D cực chất- Hương Nhiên",149000,241000,92000,38
TIKI,do-choi-me-be,501433,"Nước Lau Sàn Mrs McKenic Chai 2L",163150,251000,87850,35
TIKI,do-choi-me-be,109850209,"Lều cho bé – Lều tự bung",215000,215000,0,0
TIKI,do-choi-me-be,260806630,"Bộ đồ chơi xếp hình Macaron 4D hót nhất 2023 đồ chơi lắp ghép que nối 4d cho bé",75000,75000,0,0
TIKI,do-choi-me-be,7591655,"Đồ Chơi Gỗ Chàng Trai Gỗ - Máy Bay BABY 94006",105000,105000,0,0
TIKI,do-choi-me-be,108746629,"Hộp đựng phấn rơm cho bé kuku ku5345",131950,145000,13050,9
TIKI,do-choi-me-be,195695590,"Bộ Đồ Chơi Lắp Ghép STEM Mô Hình Chim Gõ Kiến, Bộ Đồ Chơi Khoa Học Tự Làm Chim Gõ Kiến, Bộ Đồ Chơi Gỗ Cao Cấp Khoa Học Tự Làm DIY Wood Steam - Chính Hãng BABYBOSS.",55000,75000,20000,27
TIKI,do-choi-me-be,94790570,"Áo khoác dạ bé gái Chuột đỏ - AICDBGTWWQVT - AIN Closet",165000,220000,55000,25
TIKI,do-choi-me-be,34359233,"Combo 3 Áo Lót Bầu Và Cho Con Bú",140001,140001,0,0
TIKI,do-choi-me-be,94728806,"Thìa cán ngắn chất liệu bột tre Bamboo kháng khuẩn D7066 ROYALCARE - ăn dặm an toàn cho cho sức khỏe của bé",28000,28000,0,0
TIKI,do-choi-me-be,27930462,"Giày patin trẻ em thời trang có đèn led - Đầy đủ bảo hộ và phụ kiện",404940,404940,0,0
TIKI,do-choi-me-be,141567690,"đồng hồ bé gái có đèn",60000,60000,0,0
TIKI,do-choi-me-be,196343078,"Thảm Nhạc Cho Bé Sơ Sinh Nằm Chơi Kích Thích THị Giác Thính Giác Phát Triển Thể Chất",159000,159000,0,0
TIKI,do-choi-me-be,43183462,"Bộ tranh xếp hình 330 mảnh – Thu Vàng (30x44cm) ",78000,100000,22000,22
TIKI,do-choi-me-be,175956084,"Túi đeo chéo túi xách bé gái mẫu giáo hình trái tim siêu xin cute phong cách Hàn Quốc 2022",125000,125000,0,0
TIKI,do-choi-me-be,193741716,"Cờ tướng nam châm bỏ túi cao cấp - Cờ tướng nam châm hộp da có bàn là hộp đựng - Hàng chính hãng  D Danido",59000,59000,0,0
TIKI,do-choi-me-be,183930455,"Đồ Chơi Lắp Ráp Mô Hình Nhân Vật Thanh Gươm Diệt Quỷ - LinkGo 68291 - Tsuyuri Kanao (253 Mảnh Ghép)",80000,93000,13000,14
TIKI,do-choi-me-be,206141099,"Khóa tủ lạnh, khoá ngăn kéo, tủ đồ chống kẹp tay an toàn cho bé hình cá chất liệu nhựa ABS cao cấp",20000,25000,5000,20
TIKI,do-choi-me-be,54084855,"Combo 3 Đồ Chơi Lúc Lắc Cho Trẻ Happy Baby  - Giao màu ngẫu nhiên",84000,120000,36000,30
TIKI,do-choi-me-be,197545185,"Gấu bông cá mập mặt chó husky dễ thương - Thú nhồi bông cao cấp",104000,165000,61000,37
TIKI,do-choi-me-be,173444046,"Gạc Rơ Lưỡi Cao Cấp Vệ Sinh Răng Miệng Cho Bé Sơ Sinh - Trẻ Nhỏ (Hộp 5 Chiếc Tiệt Trùng)",5000,5000,0,0
TIKI,do-choi-me-be,121535015,"Bộ 2 bình sữa Mô phỏng tự nhiên bằng nhựa Philips Avent cho trẻ từ 6 tháng 330ml (SCF696/23)",565000,565000,0,0
TIKI,do-choi-me-be,177755610,"[602 CHI TIẾT-HÀNG CHUẨN] BỘ ĐỒ CHƠI LẮP GHÉP XẾP HÌNH Mô Hình Người Sắt,  ROBOT",189000,189000,0,0
TIKI,do-choi-me-be,112103259,"Váy bé gái cánh tiên nơ cổ. Từ 11kg - 45kg. K125",499000,499000,0,0
TIKI,thiet-bi-kts-phu-kien-so,50508330,"Chai xịt màn hình đa năng, chai vệ sinh màn hình tivi, máy tính, laptop, máy ảnh, kính...650ml",85000,85000,0,0
TIKI,do-choi-me-be,56707108,"Đồ Bộ Thun Ba Lỗ In 3D cho bé trai hình chú khủng long",125000,200000,75000,38
TIKI,thiet-bi-kts-phu-kien-so,127463196,"Ốp lưng KST Viền Vuông Cho iphone 12/ 11 Pro Max/ 11 Pro/ 11/ XS Max/ XS/ X/ 7 Plus/ 8 Plus",80000,110000,30000,27
TIKI,do-choi-me-be,152470348,"Bộ đồ chơi phát triển trí não BDC30 - Thương hiệu Hinata Nhật Bản",544500,544500,0,0
TIKI,do-choi-me-be,19918617,"Nút Bịt Ổ Điện An Toàn",22000,22000,0,0
TIKI,do-choi-me-be,107018280,"Trống Bi Bô - Nốt Nhạc Xanh",84000,120000,36000,30
TIKI,do-choi-me-be,106699606,"Mũ, nón rộng vành hình chú hươu hoạt hình 3D họa tiết chấm bị rất xinh cho bé",58000,58000,0,0
TIKI,thiet-bi-kts-phu-kien-so,54624824,"Đầu Chuyển Đổi USB 3.0 Sang USB Type C Hàng Chính Hãng Helios",49000,49000,0,0
TIKI,thiet-bi-kts-phu-kien-so,112249487,"Đồng Hồ Thông Minh Định vị Trẻ em AMA Watch Y79 Pin khỏe Ngôn ngữ Tiếng Việt sài Sim 4G gọi Điện thoại 2 chiều Hàng nhập khẩu",550000,550000,0,0
TIKI,do-choi-me-be,116572809,"Đồ Chơi Khám Răng Cá Sấu Cắn Tay Cho Bé",42900,42900,0,0
TIKI,do-choi-me-be,54619207,"Túi ngủ cotton mùa hè cho bé cỡ 3 tháng đến 5 tuổi",230000,230000,0,0
TIKI,thiet-bi-kts-phu-kien-so,125161825,"Đế sạc không dây Remax RP-W36 - Hàng chính hãng",490000,550000,60000,11
TIKI,thiet-bi-kts-phu-kien-so,43159421,"Dây Đeo Thay Thế Dành Cho Vòng Đeo Tay Thông Minh Xiaomi Mi Band 3 / Mi Band 4 Dẻo TPU - Dây 2 Màu Có Viền",30900,30900,0,0
TIKI,thiet-bi-kts-phu-kien-so,108207113,"Cáp USB type C sang Micro B dài 1m UGREEN US312 20103 tốc độ truyền dữ liệu nhanh - Hàng chính hãng",85000,110000,25000,23
TIKI,thiet-bi-kts-phu-kien-so,5096207,"Dây Cáp Chuyển Đổi DisplayPort Sang HDMI màu đen ",33900,33900,0,0
TIKI,thiet-bi-kts-phu-kien-so,143397923,"Miếng lót chuột Kai hình tròn siêu dễ thương nhiều mẫu mới",22800,24000,1200,5
TIKI,do-choi-me-be,7972027,"Đồ Bộ Bé Trai Hình Spider Man In 3D 09  (Size",139000,240000,101000,42
TIKI,thiet-bi-kts-phu-kien-so,19821434,"Cáp OTG USB Type C to USB 3.0 Ugreen 30701 - Hàng chính hãng",86000,99000,13000,13
TIKI,thiet-bi-kts-phu-kien-so,17914711,"Tai nghe Moxpad X6 in-ear Monitor Bass HD - Hàng chính hãng",550000,550000,0,0
TIKI,thiet-bi-kts-phu-kien-so,36710007,"Giá Đỡ Điện Thoại, Máy Tính Bảng Kim Loại Nguyên Khối Basic Stand",88000,88000,0,0
TIKI,thiet-bi-kts-phu-kien-so,3953455,"Bộ Bàn Phím Giả Cơ và Chuột Chuyên Game G21 Led 7 Màu",91000,111000,20000,18
TIKI,thiet-bi-kts-phu-kien-so,68418553,"Cáp Thunderbolt 3 Belkin 0.8m, hỗ trợ truyền tải 40Gbps, sạc PD 100W, xuất hình ảnh 4K/5K/UltraHD, chứng nhận bởi Intel - F2CD084BT - Hàng chính hãng",803000,1099000,296000,27
TIKI,do-choi-me-be,126508624,"Quần áo búp bê 60 cm - đầm có tay",60000,60000,0,0
TIKI,thiet-bi-kts-phu-kien-so,75349649,"Chuột Gaming G5 6D 4 Tốc Độ DPI Cho Dân PUBG",60070,60070,0,0
TIKI,thiet-bi-kts-phu-kien-so,71771600,"Ốp lưng lụa mỏng dành cho iPhone 12/ 12 Pro /12 Pro Max bảo vệ camera, siêu mỏng 0.3 mm - Hàng Chính Hãng Memumi",85000,177798,92798,52
TIKI,thiet-bi-kts-phu-kien-so,26312778,"Dây sạc 4 IN 1 đa năng của Baseus  (3.5A, 120cm , Fast charge 4 in 1 Cable) cho iPhone/ iPad, Smartphone Android  - Hàng chính hãng",104499,104499,0,0
TIKI,thiet-bi-kts-phu-kien-so,129061270,"Cáp chuyển Displayport sang HDMI, DP ra HDMI hỗ trợ 4K 30hz/ 1080p 60hz cáp dài 1m8",94050,99000,4950,5
TIKI,thiet-bi-kts-phu-kien-so,192257703,"Ốp Case Kính Cường Lực Curved Glass Dành Cho Apple Watch- Hàng Chính Hãng",94050,99000,4950,5
TIKI,thiet-bi-kts-phu-kien-so,174181848,"Tai Nghe Bluetooth True Wireless Havit TW967 - Bluetooth 5.1, Thiết Kế Công Thái Học, Driver 10mm, Nghe Nhạc Đến 5H - Hàng Chính Hãng",295000,590000,295000,50
TIKI,thiet-bi-kts-phu-kien-so,170334689,"Chuột Không Dây Sạc Điện HXSJ Siêu Mỏng Chống Ồn - HÀNG CHÍNH HÃNG",97000,189000,92000,49
TIKI,thiet-bi-kts-phu-kien-so,62266000,"Đầu bút thay thế ngòi dành cho Apple Pencil 1, 2 - Apple Pencil Tips",57000,57000,0,0
TIKI,thiet-bi-kts-phu-kien-so,125773832,"Miếng Dán Cường Lực Mipow Kingbull Chống Nhìn Trộm Premium HD (2.7D) iPhone 13 Mini / iPhone 13/ iPhone 13 Pro/ iPhone 13 ProMax_ Hàng Chính Hãng",191000,290000,99000,34
TIKI,do-choi-me-be,26499571,"Đồ Chơi Rèn Luyện Trí Tuệ Phát Triển Tư Duy Logic Four color game",96000,96000,0,0
TIKI,thiet-bi-kts-phu-kien-so,9385401,"Tai nghe không dây bluetooth V8 đẳng cấp",154900,154900,0,0
TIKI,thiet-bi-kts-phu-kien-so,262464103,"Bộ chia 4 Cổng USB OTG HUB Chuẩn Type-C Kiêm Giá Đỡ Kết Nối Điện Thoại Với Chuột Và Bàn Phím Chơi Game Mobile - Hàng Chính Hãng",99000,99000,0,0
TIKI,thiet-bi-kts-phu-kien-so,11237843,"Dây cáp HDMI tròn (10m)",73900,73900,0,0
TIKI,thiet-bi-kts-phu-kien-so,54549048,"Miếng Phủ Bàn Phím Laptop 12-13/13-14/15-17 inch Silicon Chống Nước, Chống Bụi Bẩn Hàng Chính Hãng Helios",14000,14000,0,0
TIKI,thiet-bi-kts-phu-kien-so,73811766,"Loa thanh soundbar Samsung HW-T420 - Hàng chính hãng",1150000,1150000,0,0
TIKI,do-choi-me-be,51095972,"Đồ chơi xếp hình Domino 1000 chi tiết bằng gỗ nhiều màu sắc cho bé yêu thỏa sức sáng tạo đồ chơi thông minh ",399999,399999,0,0
TIKI,thiet-bi-kts-phu-kien-so,132776348,"Bộ Bàn Phím Và Chuột Bluetooth Không Dây Mini - Thích Hợp Cho iPad, Máy Tính Bảng - Nhiều Màu Sắc - Siêu Kute",138900,138900,0,0
TIKI,thiet-bi-kts-phu-kien-so,118220588,"Cáp Sạc nhanh Baseus B01 (dài 1m 2.4A, Sạc nhanh, Siêu bền) có đèn LED Cho Iphone / Ipad - Hàng chính Hãng",79000,79000,0,0
TIKI,do-choi-me-be,15587886,"Bột ăn dặm dinh dưỡng Metacare 8 loại hỗ trợ phát triển toàn diện (200g)",55000,61000,6000,10
TIKI,thiet-bi-kts-phu-kien-so,176670457,"Bao Da  dành cho Samsung Galaxy Tab S8/S8 Plus/S8 Ultra,Tab S7/S7 FE/S7 Plus, TabS6 Lite Case Flip Cover Có Khay Đựng Bút Tiện Lợi",300000,300000,0,0
TIKI,thiet-bi-kts-phu-kien-so,150921536,"Ốp Case Siêu Mỏng Kai Thinfit Dành cho Apple Watch Series 6/ Apple Watch SE/ Apple Watch Series 5/4 Size 40/44mm- Hàng Chính Hãng",75050,79000,3950,5
TIKI,thiet-bi-kts-phu-kien-so,160946538,"Ốp lưng da thời trang kết hợp MICA dành cho iPhone 13 / 13 Pro / 13 Pro Max / 13 Mini - Hàng nhập khẩu",149000,250000,101000,40
TIKI,thiet-bi-kts-phu-kien-so,73744564,"Loa Bluetooth Di động Không Dây Thể Thao Chống Nước Ngoài Trời 5W Cột Nghe Nhạc - Hàng Chính Hãng",189000,500000,311000,62
TIKI,thiet-bi-kts-phu-kien-so,106234919,"Bảng Vẽ Cảm Ứng Điện Tử 8.5 Inch – Hàng Chính Hãng ",65000,130000,65000,50
TIKI,thiet-bi-kts-phu-kien-so,54894940,"Baseus LV119-A01 Đầu Chuyển USB Type A Sang USB Type C Tốc Độ Cao Baseus | Chính hãng Baseus",53000,53000,0,0
TIKI,thiet-bi-kts-phu-kien-so,185127917,"[KINDLE] Miếng dán màn hình cho Kindle Basic, Kindle Paperwhite, Kindle Oasis - nhám, chống trầy xước",50000,50000,0,0
TIKI,thiet-bi-kts-phu-kien-so,93936518,"Túi hộp EVA bọc da khung cứng chống sốc đựng phụ kiện điện thoại, tai nghe, bộ sạc điện thoại, pin dự phòng mini (11,5x9x4cm)- Hàng chính hãng",45000,45000,0,0
TIKI,thiet-bi-kts-phu-kien-so,142467213,"Cáp sạc nhanh USB Type C - Light ning BOOST↑CHARGE Belkin 30W vỏ nhựa 1M - Hàng chính hãng",299000,425000,126000,30
TIKI,thiet-bi-kts-phu-kien-so,119528333,"Bộ chia cổng HUB USB 3.0 Sidotech mở rộng kết nối đa năng 6 cổng USB tốc độ cao 2.0/3.0 cổng Audio đầu đọc thẻ nhớ đèn LED kết nối đa cổng cho chuột không dây, bàn phím không dây, tai nghe 3.5mm, hub chuyển đổi mở rộng USB cổng chia USB",118000,118000,0,0
TIKI,do-choi-me-be,1000538,"Sữa Bột Anlene Gold Movepro 3X Hương Vanilla (Hộp Thiếc 400g)",217000,224000,7000,3
TIKI,do-choi-me-be,56957583,"Bio Island DHA cho bà bầu chính hãng Úcs",535000,668750,133750,20
TIKI,do-choi-me-be,130470106,"Similac Einstein 1 cho trẻ từ 0 - 6 tháng tuổi",287000,287000,0,0
TIKI,do-choi-me-be,196177335,"Lốc 10 Cuộn Giấy Vệ Sinh Bless You À La Vie Cao Cấp Mềm Mịn",92000,160000,68000,43
TIKI,do-choi-me-be,89249057,"Combo 10 hộp khăn giấy lụa Japani Silk180 hai lớp kích thước 19x20cm hộp xanh - 180 tờ/hộp",196000,280000,84000,30
TIKI,do-choi-me-be,134560687,"Balo bỉm sữa đựng đồ đa năng cho mẹ và bé , balo giữ nhiệt đựng đồ cho bé sơ sinh",95999,95999,0,0
TIKI,do-choi-me-be,71972984,"Thảm nằm chơi thông minh cao cấp cho bé Kinderkraft",1120000,1120000,0,0
TIKI,do-choi-me-be,54509649,"Viên Khử Trùng và Vệ Sinh Bồn Cầu, Hỗ Trợ Diệt Khuẩn Giảm Thông Tắc Bồn Cầu Xuất Xứ Nhật Bản - Diệt Khuẩn, Khử Mùi, Vệ Sinh Bồn Cầu Cực Kì Hiệu Quả",31000,32000,1000,3
TIKI,do-choi-me-be,66065160,"Sữa Bột Abbott Glucerna Lúa Mạch 850g",929000,929000,0,0
TIKI,do-choi-me-be,45841290,"Bộ 4 thìa ăn dặm báo nóng Munchkin Mỹ tặng 5 túi zipper",189000,189000,0,0
TIKI,do-choi-me-be,32835143,"Combo Bộ Bài Bói The Rider Waite Tarot và Túi Nhung Cao Cấp",119000,119000,0,0
TIKI,do-choi-me-be,21682818,"Tranh ghép gỗ 200 mảnh - Thế giới ô tô",49000,49000,0,0
TIKI,do-choi-me-be,160880625,"Kẹp tóc cho bé gái, Set 14 kẹp tóc mái cho bé nhiều màu sắc họa tiết dễ thương (14psc) – SP154",28000,28000,0,0
TIKI,do-choi-me-be,17041941,"Combo gối nằm + chặn vỏ đậu xanh Sunny (dành cho trẻ sơ sinh)",132000,132000,0,0
TIKI,do-choi-me-be,182709864,"Combo 2 Sữa tắm gội dịu lành cho bé Cetaphil Baby Wash & Shampoo with Organic Calendula 400ml/chai",590000,590000,0,0
TIKI,do-choi-me-be,152534382,"Ghép Hình 4 Mùa - Mùa Thu 24 Chi Tiết DK81076",95200,136000,40800,30
TIKI,do-choi-me-be,58866536,"Sữa Tắm Gừng Nghệ Cho bé COCAYHOALA Với 9 Loại Thảo Mộc An Toàn, Lành Tính - Giúp Phòng Cảm, Tránh Gió, Giữ Ấm Cơ Thể chai 300ml",180000,180000,0,0
TIKI,do-choi-me-be,77655899,"Tìm cặp hình giống nhau phương tiện giao thông",93500,110000,16500,15
TIKI,do-choi-me-be,24510746,"Chất thông tắc Cầu, Cống Sifa chống hôi Siêu nhanh Siêu mạnh 5 phút",62000,62000,0,0
TIKI,do-choi-me-be,53281844,"100 Quân Domino Cờ Các Quốc Gia, Xếp Hình Tập Nhận Biết Quốc Kì, Đồ Chơi Bằng Gỗ Tự Nhiên - Hàng Chính Hãng miDoctor",99000,99000,0,0
TIKI,do-choi-me-be,171666243,"Set 5 KÈN THỔI SINH NHẬT",16000,16000,0,0
TIKI,do-choi-me-be,142422033,"Combo 3 Túi Nước Rửa Bình Sữa Dnee 600ml/túi",149000,149000,0,0
TIKI,do-choi-me-be,118288089,"Sữa Dành Cho Người Tiểu Đường Abbott Glucerna Úc Bổ Sung Đầy Đủ Dinh Dưỡng Và Cân Bằng Đường Huyết - Lon 850g - Massel Official",875000,2090000,1215000,58
TIKI,do-choi-me-be,107404777,"Màn chụp cho bé",153000,153000,0,0
TIKI,do-choi-me-be,72693652,"03 bộ tranh xếp hình 70 mảnh ghép khổ A3 – đồ chơi trí tuệ cho bé từ 3 tuổi – Combo 12",85000,110000,25000,23
TIKI,do-choi-me-be,56596932,"Combo Viên rửa bát Finish 77 viên hương chanh + Nước làm bóng finish 750ml dùng cho máy rửa bát",399000,399000,0,0
TIKI,do-choi-me-be,180847833," Xúc Xắc Xí Ngầu Trong Suốt Nhiều Màu Sắc Size 14 Mm",15000,15000,0,0
TIKI,do-choi-me-be,129540643,"Kem chống hăm tã em bé Sudocrem hộp 60g",109000,109000,0,0
TIKI,do-choi-me-be,107018284,"Trống Bi Bô - Bé Nói Cười",90000,120000,30000,25
TIKI,thiet-bi-kts-phu-kien-so,2002793,"Bộ Switch Ugreen Vào 3 HDMI Ra 1 HDMI 40234",495000,519000,24000,5
TIKI,do-choi-me-be,174280412,"ÁO THUN BÉ TRAI NGẮN TAY CATRIO in PARK là áo phông trẻ em từ 9T_12T(32kg_50kg)",111200,111200,0,0
TIKI,do-choi-me-be,119706884,"Sữa tắm gội dịu lành cho bé Cetaphil Baby Wash & Shampoo with Organic Calendula 400ml",295000,295000,0,0
TIKI,do-choi-me-be,97983190,"Kính bơi trẻ em Sinca có lớp tráng gương, chống sương mù, dây silicon dễ dàng điều chỉnh cho bé từ 5 tuổi - 15 tuổi",149000,163330,14330,9
TIKI,thiet-bi-kts-phu-kien-so,58080959,"Túi đựng dây sạc củ sạc chuột máy tính, tai nghe và phụ kiện công nghệ Baona - Hàng nhập khẩu",141840,177300,35460,20
TIKI,do-choi-me-be,44140382,"Túi Ngũ Cốc NAVAN (800G) -  Dinh Dưỡng Thiết Yếu Cho Mẹ",199000,199000,0,0
TIKI,do-choi-me-be,114852429,"Bộ đồ chơi câu cá gỗ 7 in 1 cho bé yêu",98900,98900,0,0
TIKI,do-choi-me-be,118014025,"Đồ Lam Đi Chùa # La Hán Cho Bé Iu # Đồ Bộ Bé Trai Gái # Quần Áo Bé Trai Gái",88000,88000,0,0
TIKI,do-choi-me-be,127120446,"Quần áo búp bê 60 cm",60000,60000,0,0
TIKI,do-choi-me-be,187636884,"Chăn Mền Cotton Đũi cho bé Thu Hè, chăn mền điều hòa trẻ em mỏng thoáng mát - Tặng 10 chiếc chun",75000,75000,0,0
TIKI,do-choi-me-be,73661266,"Bộ 2 chai Sữa Tắm Gội Trẻ Em Lactacyd Milky BẢO VỆ, NUÔI DƯỠNG DA và TÓC BÉ VƯỢT TRỘI 500ml/chai",366000,366000,0,0
TIKI,do-choi-me-be,168190330,"Combo 5 quần ngắn Babiboo họa tiết xinh xắn cho bé",180000,180000,0,0
TIKI,do-choi-me-be,53548111,"Bộ đồ chơi lắp ráp đường trượt và đội đua xe chó cứu hộ - Bãi đỗ xe chó cứu hộ (mẫu ngẫu nhiên)",239000,239000,0,0
TIKI,do-choi-me-be,113864742,"Bỉm Aikuu Bear CHÍNH HÃNG Dán/Quần đủ size S112,M100/M100,L96,XL92,XXL88,XXXL84",278000,300000,22000,7
TIKI,thiet-bi-kts-phu-kien-so,74908430,"Bàn phím cơ E-Dra EK3104 Huano Switch(Blue/Brown",1118600,1118600,0,0
TIKI,thiet-bi-kts-phu-kien-so,110152488,"Bao Da Samsung Galaxy Tab S7 FE T730 / T736 12.4 Inch Cover Cho Máy Tính Bảng Hỗ Trợ Smart Cover",179000,179000,0,0
TIKI,do-choi-me-be,66767666,"Ống Bón Sữa, Bón Thuốc Tiện Lợi Dễ Sử Dụng Cho Bé Yêu Loại 3ml",10000,10000,0,0
TIKI,do-choi-me-be,120784448,"Đồ bộ bé trai cộc tay BIGFOX - MISS MEOW size đại chất cotton phong cách Âu Mỹ in Báo GAME DAY 10 - 37 kg QATE",159000,200000,41000,21
TIKI,do-choi-me-be,84999798,"Thùng 18 Hộp Sữa đêm ngũ cốc Fruto Nyanya 200ml",497664,622080,124416,20
TIKI,thiet-bi-kts-phu-kien-so,20633527,"Cáp Tín Hiệu Chuyển Đổi VGA sang HDMI Có Audio - VGA to HDMI có AV",46000,71300,25300,35
TIKI,do-choi-me-be,48494290,"Bộ 2 tấm xếp hình A3 :1 Tranh đội bay siêu đẳng và 1 tranh Doremon (48 mảnh ghép). Đồ chơi trí tuệ cho bé từ 3 tuổi. Tia Sáng Việt Nam. Chứng nhận hợp quy Tia sáng tên chủng loại: Xếp hình số mảnh ghép lên đến 250 mảnh. Ký hiệu kiểu loại: Xếp hình.",78000,78000,0,0
TIKI,thiet-bi-kts-phu-kien-so,168586745,"Ốp lưng dành cho iPhone 13 Pro Max/13 Pro/ 13 Lucky Tiger Cat chống sốc bảo vệ camera _ Hàng Chính Hãng",94050,99000,4950,5
TIKI,do-choi-me-be,51299324,"Áo thun Xe MC Queen bé trai",110000,110000,0,0
TIKI,thiet-bi-kts-phu-kien-so,21315699,"Sim Du Lịch Trung Quốc - HongKong - MaCao Không Giới Hạn Internet Trong 10 Ngày",350000,350000,0,0
TIKI,do-choi-me-be,173164596,"Combo 03 Sữa Bột Anlene Gold 3X Hương Vanilla (Hộp thiếc 800g) - Tặng nồi inox",1190000,1230000,40000,3
TIKI,do-choi-me-be,262974809,"Sữa Bột Nestle Milo Value Pack  Úc, Bổ Sung vitamin và khoáng chất giúp bé phát triển chiều cao và cân năng, thông minh và sáng tạo năng động vượt trội - Massel Official",364000,728000,364000,50
TIKI,do-choi-me-be,248544526,"Lốc 6 lọ nước yến sào Nunest Kid 4 hương vị (70ml)",202000,202000,0,0
TIKI,do-choi-me-be,102459754,"Đồ Chơi Xếp Hình Thông Minh Bằng Gỗ 180 Miếng Ghép Tangram Có Hộp Đựng Cho Bé Tư Duy Sáng Tạo Và Học Hình Khối Màu Sắc",130000,163000,33000,20
TIKI,do-choi-me-be,56741558,"Đồ Bộ Thun Ba Lỗ In 3D cho bé trai hình khủng long",139000,240000,101000,42
TIKI,do-choi-me-be,93754507,"Đồ Bộ Thun Lạnh Có Tay In 3D cho bé trai hình Đại Học Quái Vật",139000,240000,101000,42
TIKI,thiet-bi-kts-phu-kien-so,56026597,"Hộp đựng phụ kiện công nghệ SmileBox form cứng đựng ổ cứng, pin sạc, tai nghe, bộ sạc điện thoại nhiều size- Hàng chính hãng",45000,45000,0,0
TIKI,do-choi-me-be,187216804,"Sữa dê HiPP Organic 400g - Nhập khẩu Đức, giúp bé phát triển chiều cao, trí não, tăng cường hấp thu",544000,544000,0,0
TIKI,do-choi-me-be,260817020,"Sữa bột công thức HiPP 2 Organic Combiotic 800g",720000,720000,0,0
TIKI,thiet-bi-kts-phu-kien-so,189580427,"Chuột Không Dây Logitech M221 White - Hàng Chính Hãng",249000,249000,0,0
TIKI,thiet-bi-kts-phu-kien-so,177883578,"Vải lưới vải ê căng ê-căng bảo vệ loa kích thước 1m x 1.5m",90000,90000,0,0
TIKI,do-choi-me-be,115483435,"Sữa bột Enfamil A+ NeuroPro 2 với 2’-FL HMO cho trẻ từ 6 –12  tháng tuổi– 830g",541000,541000,0,0
TIKI,do-choi-me-be,22304706,"Combo 2 bộ tã vải Đêm Siêu chống tràn BabyCute size S, M, L, XL, XXL - Giao mẫu ngẫu nhiên",260000,260000,0,0
TIKI,do-choi-me-be,48897589,"Đồ Chơi Rubik Megaminx Biến Thể 12 Mặt Xoay Trơn",80000,80000,0,0
TIKI,thiet-bi-kts-phu-kien-so,15254795,"Ốp Lưng cao cấp Auto Focus Vân da cho điện thoại SAMSUNG: Note 8/ Note 9 (Màu Đen) - Hàng nhập khẩu",12000,12000,0,0
TIKI,do-choi-me-be,43867118,"Đồ chơi gỗ,đồ chơi phát triển trí tuệ - Khóa Luban",39000,39000,0,0
TIKI,do-choi-me-be,123861521,"Bộ Thẻ Học Thông Minh 19 Chu Đề Loại To Song ngữ tiếng Anh loại chuẩn Glenn Doman Flashcard cho bé từ 0-6 tuổi",145000,145000,0,0
TIKI,thiet-bi-kts-phu-kien-so,115487957,"Giá Đỡ Để Bàn Cho Điện Thoại, Máy Tính Bảng P10 - Chất Liệu Hợp Kim Nhôm Cao Cấp Gấp Gọn Siêu Di Động Model P10- Hàng Chính Hãng Tamayoko",129000,129000,0,0
TIKI,thiet-bi-kts-phu-kien-so,73500929,"Bộ chia 4 cổng USB 3.0 có cổng cấp nguồn phụ Orico TWU3-4A - Hàng Chính Hãng",204000,204000,0,0
TIKI,thiet-bi-kts-phu-kien-so,212981756,"Giá đỡ máy tính, macbook, laptop giúp tản nhiệt có thể mang đi tiện lợi -Funu Home",119000,135000,16000,12
TIKI,do-choi-me-be,53626561,"Chất tẩy mốc xi măng trên nhiều chất liệu, tẩy rong rêu, tẩy gạch cũ bẩn, tẩy ron gạch siêu mạnh  HT01-TVS -1,8L (sản phẩm mới hoạt chất bảo vệ bề mặt 100%, chất lượng cao)",149000,180000,31000,17
TIKI,thiet-bi-kts-phu-kien-so,34520643,"[COMBO] Bộ vệ sinh laptop 6 món + Tặng kèm máy hút bui bàn phím (màu ngẫu nhiên) - Hàng nhập khẩu",52500,52500,0,0
TIKI,do-choi-me-be,194082754,"CHONG CHÓNG 3 TẦNG",79200,79200,0,0
TIKI,do-choi-me-be,194182186,"Đồ bơi dáng lửng cho nữ và bé gái lớn size từ 38-75kg",275000,275000,0,0
TIKI,thiet-bi-kts-phu-kien-so,108753341,"Cốc sạc siêu nhỏ gọn 20W Baseus Compact Quick Charger (USB + Type C, công suất 20W) - Hàng Chính Hãng",165000,199000,34000,17
TIKI,do-choi-me-be,59196226,"Dầu húng chanh Minion 30ml",259000,259000,0,0
TIKI,do-choi-me-be,41465659,"Đồ bơi cho bé trai quần short size lớn đến 55kg",299000,343350,44350,13
TIKI,thiet-bi-kts-phu-kien-so,115529829,"SD/TF chuẩn USB 3.1 Type C Đầu đọc thẻ nhớ vỏ nhôm cao cấp Ugreen đt401n80888CM - Hàng chính hãng",270000,270000,0,0
TIKI,thiet-bi-kts-phu-kien-so,8031566,"Bộ sạc điện thoại gắn trực tiếp cho xe máy",34900,34900,0,0
TIKI,do-choi-me-be,1745007,"Tấm Đệm Lót Siêu Thấm Caryn (10 Miếng)",55000,60400,5400,9
TIKI,do-choi-me-be,66393163,"Mũ lưỡi trai mỏ mềm bít đuôi cho bé từ 1 đến 3 tuổi gắn logo chữ Z kèm đục 3 lỗ sò ở mỏ kết độc đáo - Đỏ",130000,130000,0,0
TIKI,thiet-bi-kts-phu-kien-so,16654097,"Bộ Chuyển Đổi Vga Sang HDMI Có Audio - Tặng Dây HDMI 1.5m ( Vga To HDMI Full HD 1080 )",93000,93000,0,0
TIKI,do-choi-me-be,125603951,"Combo 5 Bộ Xếp Hình ",50000,50000,0,0
TIKI,do-choi-me-be,191387813,"Nước xả làm mềm vải Comfort Hương Nước Hoa Thiên Nhiên Jennie túi 3.8L",215000,243900,28900,12
TIKI,thiet-bi-kts-phu-kien-so,23410785,"Ốp Lưng Kính Cường Lực Trong Suốt Hoàn Toàn. Lưng Kính Không Ố Vàng, Viền Máy Dẻo Cho Iphone X/ XS/ XS Max/ XR/ 7/8 Plus",85499,89999,4500,5
TIKI,do-choi-me-be,53088383,"Combo Bột Rửa Bát Finish Nhật 2,2kg + Bóng Finish 400ml + Muối Finish 1,2kg",606487,606487,0,0
TIKI,do-choi-me-be,148670228,"Set 4 Nút bần cho bé tập đóng đinh hoặc nút bình",12000,12000,0,0
TIKI,do-choi-me-be,32444316,"Đồ bộ 3D cho bé trai hình Supper Wing",139000,240000,101000,42
TIKI,do-choi-me-be,95035879,"Dinh dưỡng 100% Trái cây nghiền Organic HiPPiS Dâu rừng, Táo, Đào",60000,60000,0,0
TIKI,do-choi-me-be,3774051,"Gói bột thông tắc hầm cầu M. phốt 300g Hando",25000,25000,0,0
TIKI,do-choi-me-be,412763,"Tã Quần Cao Cấp Moony Nhật Bản Bé Trai L44 (44 Miếng)",339000,466400,127400,27
TIKI,do-choi-me-be,127120653,"Đầm học sinh búp bê 60 cm",35000,35000,0,0
TIKI,thiet-bi-kts-phu-kien-so,97821182,"Dây Cáp Sạc Từ Tính cho Đồng Hồ Xiaomi Mi Band 6",35000,35000,0,0
TIKI,do-choi-me-be,157446182,"Áo khoác lông mềm có mũ cho bé trai bé gái",99000,200000,101000,51
TIKI,thiet-bi-kts-phu-kien-so,2431785,"Máy Trợ Giảng Không Dây Shidu SD-S611 (UHF)",712999,712999,0,0
TIKI,thiet-bi-kts-phu-kien-so,52620058," Kẹp Điện Thoại Xe Máy Hợp Kim C2 Cao Cấp PKS - Giao màu ngẫu nhiên ",35084,47420,12336,26
TIKI,thiet-bi-kts-phu-kien-so,3571519,"Bộ Thu Phát Âm Thanh Chuyển Đổi Bluetooth 4.1 TP-Link HA100 (Đen) - Hàng Chính Hãng",389000,699000,310000,44
TIKI,do-choi-me-be,44246534,"Bộ Cờ Tướng Gỗ Sồi + Bàn Cờ Tướng 40*35cm, Cờ Tướng Gỗ Có Bàn Là Hộp Đựng Chính Hãng",259000,450000,191000,42
TIKI,thiet-bi-kts-phu-kien-so,14605245,"Cáp Chuyển Đổi USB 3.0 To Lan - USB Sang Lan ",98500,98500,0,0
TIKI,thiet-bi-kts-phu-kien-so,157215759,"Chuột Không Dây GX9 - Bluetooth + Wireless 2.4G  - Pin sạc  - Chống ồn - hàng nhập khẩu",310000,310000,0,0
TIKI,thiet-bi-kts-phu-kien-so,54356554,"Thẻ nhớ microSDXC 64GB OEM tốc độ class 10 U3",75000,110000,35000,32
TIKI,thiet-bi-kts-phu-kien-so,177191449,"Ốp lưng chống sốc dành cho Xiaomi Redmi 10C nhựa dẻo, túi khí chống sốc 4 góc, bảo vệ Camera ",28900,28900,0,0
TIKI,thiet-bi-kts-phu-kien-so,14701982,"Đầu DVI(24+1) to HDMI",21185,22300,1115,5
TIKI,do-choi-me-be,213517312,"Sữa Ensure cho người già Úc - Cung cấp dinh dưỡng giúp hồi phục sức khỏe cho người suy dinh dưỡng, ốm yếu, người già - QuaTangMe Extaste",1039000,2078000,1039000,50
TIKI,thiet-bi-kts-phu-kien-so,57799633,"Thiết Bị Thu Phát Nhạc Không Dây Bluetooth 5.0 BT-2IN1 AZONE",133000,138000,5000,4
TIKI,do-choi-me-be,242526640,"MÔ HÌNH HÀ TRỤ TOKITO MUICHIRO - KIMETSU NO YAIBA - thanh gươm diệt quỷ - Cao 15,5cm",54900,54900,0,0
TIKI,thiet-bi-kts-phu-kien-so,120462971,"Cáp chuyển đổi USB ra 2 cổng PS/2 dành cho phím chuột",32000,37990,5990,16
TIKI,thiet-bi-kts-phu-kien-so,136029610,"Hub chuyển đổi mở rộng USB Typec sang USB 3.0 – Hàng chính hãng",189000,370000,181000,49
TIKI,thiet-bi-kts-phu-kien-so,72646091,"Giá Đỡ Điện Thoại Gương Chiếu Hậu Trong Xe Hơi Chất Liệu Nhựa ABS Hoco CA70 - Siêu Chắc Chắn - Hàng Nhập Khẩu",48888,66813,17925,27
TIKI,do-choi-me-be,66193472,"Bộ 2 tấm tranh xếp hình đội chó cứu hộ và Heo Peppa, 48 mảnh ghép, kích thước A3. Tia Sáng Việt Nam.",78000,78000,0,0
TIKI,thiet-bi-kts-phu-kien-so,5911431,"Cáp Chuyển Đổi Displayport To HDMI 4K Ugreen 40363 - Hàng Chính Hãng",220000,220000,0,0
TIKI,thiet-bi-kts-phu-kien-so,103539803,"Ốp lưng dành cho Samsung M51 silicon dẻo trong suốt cao cấp A+",12000,12000,0,0
TIKI,thiet-bi-kts-phu-kien-so,195305688,"Adapter Sạc 2 Cổng ANKER 521 Nano Pro 40W Type-C Sạc Nhanh Nhỏ Gọn Tích Hợp PIQ 3.0 Tương Thích Iphone 13/13 Mini / 13 Pro / 13 Pro Max / 12, Galaxy, Pixel 4/3, Ipad / Ipad Mini A2038 - Hàng Chính Hãng",800000,950000,150000,16
TIKI,thiet-bi-kts-phu-kien-so,4167993,"Bàn phím gấp gọn Bluetooth tích hợp chuột touchpad hỗ trợ chơi game B033 Aturos (màu Đen) - Hàng chính hãng",445000,445000,0,0
TIKI,thiet-bi-kts-phu-kien-so,102766392,"Loa Bluetooth thông minh kháng nước Remax RB-M28 hàng chính hãng",1190000,1300000,110000,8
TIKI,thiet-bi-kts-phu-kien-so,196559521,"Loa Nghe Nhạc Mini Cầm Tay Huqu HQ-M10- Thiết Kế Nhỏ Gọn, Cầm Tay -Hàng Chính Hãng",275500,290000,14500,5
TIKI,thiet-bi-kts-phu-kien-so,188565088,"Loa Bluetooth JBL Flip 6 - Hàng Chính Hãng",2840000,2990000,150000,5
TIKI,do-choi-me-be,116727410,"Sữa Hữu Cơ Miwako Nhập Khẩu Malaysia Hộp 700g Vị Gạo, Sữa Hạt Dinh Dưỡng Cho Bé Biếng Ăn Tiêu Hóa Kém Thấp Còi",507000,675000,168000,25
TIKI,do-choi-me-be,52664603,"GỐI ÔM BÀ BẦU CHỮ U Zcare - màu tím sang trọng",619000,619000,0,0
TIKI,do-choi-me-be,27655440,"Dung dịch làm sạch canxi vách kính tắm Smart - TK",200000,200000,0,0
TIKI,do-choi-me-be,77032298,"Bài Tây Poker Copag 100% Plastic Chính Hãng Siêu Bền",90000,90000,0,0
TIKI,do-choi-me-be,46132344,"Phao Bơi Chống Lật Đỡ Cổ Sắc Màu Siêu Cute Cho Bé Siêu An Toàn PB01",28000,28000,0,0
TIKI,do-choi-me-be,43388390,"Bộ đồ thú Khủng Long xanh liền thân lông mịn Pijama dành Cho Người Lớn và Trẻ Em Đầy Đủ Các Kích Cỡ kiểu dáng Động Vật Hoạt Hình Cosplay",189000,189000,0,0
TIKI,do-choi-me-be,24495867,"Bột Thông Tắc Bồn Cầu, Thông Tắc Cống Sifa Đa Năng Siêu Nhanh 200g",27000,27000,0,0
TIKI,do-choi-me-be,176937904,"Medela - Trợ ti hỗ trợ cho trẻ bú, size S/M/L - Dùng cho các mẹ đầu ty bị nứt hoặc phẳng, tụt, ngắn - Giúp cho trẻ ngậm bú dễ dàng",495000,495000,0,0
TIKI,do-choi-me-be,112947411,"Hít nền quây cũi nhựa 10 miếng",25000,25000,0,0
TIKI,do-choi-me-be,2705073,"Vỉ 6 viên tẩy và làm thơm toilet siêu tiện lợi Hando",65000,65000,0,0
TIKI,do-choi-me-be,103524399,"04 bộ tranh xếp hình 35 mảnh khổ A4 20x30cm – đồ chơi trí tuệ cho bé từ 2 tuổi – Combo 2",75000,100000,25000,25
TIKI,do-choi-me-be,9796292,"Combo 03 túi Nước Thơm Lau Sàn Mao Bao 1000ml - Gỗ Đàn Hương",109000,120000,11000,9
TIKI,thiet-bi-kts-phu-kien-so,82948143,"Đèn livestream/Đèn Hỗ Trợ Sáng Livestream Để Bàn Có 2 Kẹp Điện Thoại (3 in 1)",81968,81968,0,0
TIKI,do-choi-me-be,19841467,"Quây cũi kiêm nhà bóng",189000,189000,0,0
TIKI,do-choi-me-be,85827114,"Bộ hóa trang người nhện liền thân Homecoming cho bé trai",350000,350000,0,0
TIKI,thiet-bi-kts-phu-kien-so,144643830,"Ốp lưng kính cường lực nhám chống vân tay Baseus Frosted Glass Protective Case dành cho iPhone 13 Series_ Hàng Chính Hãng",240000,274998,34998,13
TIKI,do-choi-me-be,188835460,"Sữa bột CaloSure Gold – dinh dưỡng dành cho người cao tuổi 900G",529000,529000,0,0
TIKI,thiet-bi-kts-phu-kien-so,101187475," Chuột Gaming không dây Chuột DareU EM901 RGB (Đen/Hồng) - CHÍNH HÃNG",599000,599000,0,0
TIKI,do-choi-me-be,249346935,"Bột canxi cá tuyết Fine Japan Nhật Bản (140g)",149000,149000,0,0
TIKI,do-choi-me-be,104155217,"Khẩu trang em bé Pigeon",91000,180000,89000,49
TIKI,do-choi-me-be,40863685,"Đai Đỡ Bụng Bầu Cho Mẹ Bầu Chính Hãng Amalife - Nhiều size",109000,109000,0,0
TIKI,thiet-bi-kts-phu-kien-so,5911429,"Cáp Chuyển Displayport Sang HDMI Ugreen 40362 - Hàng Chính Hãng",158000,167000,9000,5
TIKI,thiet-bi-kts-phu-kien-so,136215560,"Giá đỡ laptop - máy tính bảng tản nhiệt để bàn tiện lợi nhỏ gọn - Hàng chính hãng ( Giao màu ngẫu nhiên )",98000,180000,82000,46
TIKI,do-choi-me-be,755471,"Cờ Domino Ngà Nhỏ Liên Hiệp Thành KDNN",66000,66000,0,0
TIKI,do-choi-me-be,40369453,"Gối đi xe máy nhồi bông hình con chó",83000,83000,0,0
TIKI,do-choi-me-be,68251375,"Nước rửa chén hữu cơ Bồ hòn Ecocare tinh dầu Quế 2000ml ",250000,250000,0,0
TIKI,thiet-bi-kts-phu-kien-so,1819263,"Mini Displayport To HDMI Ugreen (10460) - Hàng chính hãng",145000,145000,0,0
TIKI,thiet-bi-kts-phu-kien-so,56024494,"Kẹp điện thoại vặn bằng đinh ốc, kẹp ngang kẹp dọc điện thoại gắn lên tripod chuẩn ren 1/4 - Hàng chính hãng",55000,55000,0,0
TIKI,thiet-bi-kts-phu-kien-so,58298176,"Loa bluetooth Zealot không dây nghe nhạc cực hay, âm thanh chất lượng cao, thẻ nhớ, USB - Hàng chính hãng",298000,298000,0,0
TIKI,do-choi-me-be,125393656,"Set đồ chơi Xúc xắc, lục lạc, kèn, trống Toyshouse dành cho bé từ sơ sinh TH1220-733A giúp bé phát triển thính giác",79000,110000,31000,28
TIKI,thiet-bi-kts-phu-kien-so,24702220,"Máy Nghe Nhạc,Loa Mini Nghe Nhạc Thẻ Nhớ, Usb, Nghe Kinh Phật, Đài Fm, Radio V8",122455,128900,6445,5
TIKI,thiet-bi-kts-phu-kien-so,132783127,"Ốp lưng dẻo cho  Samsung Galaxy Z Flip 3 trong suốt, chống sốc 4 góc",35000,35000,0,0
TIKI,thiet-bi-kts-phu-kien-so,163281226,"Cáp Sạc OPPO Micro USB  DL109 - Hàng Chính Hãng",79000,120000,41000,34
TIKI,do-choi-me-be,119370022,"Combo 10 Tấm Lót Khử Mùi Bồn Tiểu & Lỗ Sàn ECODEALS P1 Fresher - Khử mùi gấp 3 sáp thơm - Mùi ngẫu nhiên",409000,475000,66000,14
TIKI,thiet-bi-kts-phu-kien-so,174944729,"Miếng Dán Bàn Phím Laptop In Chữ Tiếng Anh",20000,20000,0,0
TIKI,do-choi-me-be,95010190,"Đồ chơi xếp hình, lắp ráp Qman 1720 - Cuộc xung đột bờ biển  (235 mảnh ghép)",199000,199000,0,0
TIKI,thiet-bi-kts-phu-kien-so,195032632,"Bao da cao cấp dành cho iPhone 13 / 13 Pro / 13 Pro Max - Hàng chính hãng - Photodesign VN",239000,300000,61000,20
TIKI,thiet-bi-kts-phu-kien-so,58531344,"Đầu cáp chuyển đổi đầu USB Type C sang HDMI Chất lượng 4K",92150,97000,4850,5
TIKI,do-choi-me-be,181455505,"Thùng 48 hộp IQLac Colostrum Biếng Ăn Suy Dinh Dưỡng Premium 110ml cho trẻ biếng ăn, thấp còi, suy dinh dưỡng từ 1 tuổi",508800,508800,0,0
TIKI,do-choi-me-be,109454010,"Thảm đàn Piano cho bé  Thảm nằm chơi nhạc hình thú ngộ nghĩnh cho bé",128999,128999,0,0
TIKI,do-choi-me-be,142212910,"Lều xông hơi tự bung chui đầu tại nhà chống thấm nước ( giao màu ngẫu nhiên)",198000,198000,0,0
TIKI,thiet-bi-kts-phu-kien-so,184410513,"Chuột công thái học không dây Logitech Lift Vertical Ergonomic - Hàng Chính Hãng",1249000,1599000,350000,22
TIKI,thiet-bi-kts-phu-kien-so,21569900,"THẢM DA TRẢI BÀN LÀM VIỆC, TẤM LÓT CHUỘT, MIẾNG DI CHUỘT KHỔ LỚN, HAI MẶT 90 X 45 CM",105000,105000,0,0
TIKI,do-choi-me-be,94655416,"Balo đi học hình siêu nhân 3D cho bé- Cặp siêu nhân nhện cao cấp cho bé- Balo in hình siêu nhân mẫu mới",169000,169000,0,0
TIKI,thiet-bi-kts-phu-kien-so,59045788,"Thẻ nhớ MicroSD Kioxia 128GB Class 10 - Hàng Nhập Khẩu",200000,200000,0,0
TIKI,thiet-bi-kts-phu-kien-so,98149754,"Bao Da Dành Cho iPad Pro 11 inch 2021/2022 và iPad Pro 12.9 inch 2021/2022 ESR Rebound Magnetic Slim Case - Hàng Nhập Khẩu",850000,850000,0,0
TIKI,thiet-bi-kts-phu-kien-so,81550021,"Cáp sạc Nhanh Type C to Type C dùng cho Galaxy S21, Note 20",36955,38900,1945,5
TIKI,do-choi-me-be,77052616,"Mũ cục bông cho bé hàng QC ( 0-12m) MD160",139000,139000,0,0
TIKI,do-choi-me-be,88002619,"Thanh chắn cửa, cầu thang 75-85cm Không khoan tường mẫu mới 2020",399000,399000,0,0
TIKI,thiet-bi-kts-phu-kien-so,97057371,"Pin sạc dự phòng Hoco J72-10.000mAh-HÀNG CHÍNH HÃNG",135000,135000,0,0
TIKI,thiet-bi-kts-phu-kien-so,4250293,"Ốp Lưng Dẻo Giả Da Chống Sốc Dành Cho Samsung Galaxy S7 Edge",12500,12500,0,0
TIKI,do-choi-me-be,19252574,"Combo 8 miếng mút chặn góc bàn chống va chạm bảo vệ bé",29000,29000,0,0
TIKI,thiet-bi-kts-phu-kien-so,361279,"Bàn Phím Game Fuhlen L411 - Hàng Chính Hãng",175000,175000,0,0
TIKI,thiet-bi-kts-phu-kien-so,174300967,"Ốp điện thoại dành cho iphone 13 promax, 13,12 promax,12,12 pro, 11 promax, 11, Xsmax, X, Xs, 8plus, 7plus,6plus_A161_1",66000,129999,63999,49
TIKI,thiet-bi-kts-phu-kien-so,195305652,"Adapter Sạc ANKER Powerport III Pod 735 3 Cổng 65W Type-C và USB-A Có Thể Gấp Gọn - A2667 - Hàng Chính Hãng",830000,1300000,470000,36
TIKI,do-choi-me-be,154703056,"Áo yếm máng dài tay Cotton chống thấm nước cho bé tập ăn, tập vẽ Mastela",49200,49200,0,0
TIKI,thiet-bi-kts-phu-kien-so,19339428,"Dây Đeo Thay Thế Cho Đồng Hồ Thông Minh Smart Watch Size 20mm Xiaomi Amazfit Bip / Huawei Watch 2 / Garmin Vivomove HR / Samsung Galaxy Watch (42mm) / TICWATCH 2",67900,67900,0,0
TIKI,do-choi-me-be,141502205,"Bộ 3 thanh chắn giường chống kẹt, cao tới 105cm, 24 nắc điều chỉnh, hạ 1 góc KidAndMom BR02 mẫu mới nhất trượt lên xuống",1999000,1999000,0,0
TIKI,thiet-bi-kts-phu-kien-so,2850663,"Gá Kẹp Điện Thoại Ulanzi Phone Tripod Mount 360 - Hàng Chính Hãng",78000,78000,0,0
TIKI,do-choi-me-be,127067531,"Siro Phát Triển Trí Não Cho Bé FITOBIMBI OMEGA JUNIOR Giúp Trẻ Thông Minh, Sáng Mắt Italia Chai 30ml",390000,390000,0,0
TIKI,do-choi-me-be,145678526,"Bộ Pijama Lụa Dài Tay Cho Bé Từ 6-28kg MOON HOUSE, Bộ Lụa Họa Tiết Gấu Cho Bé Trai Và Bé Gái Mặc Nhà Cực Yêu",125000,125000,0,0
TIKI,do-choi-me-be,2790305,"Gel gừng thảo dược, massage tan mỡ bụng, săn chắc eo Wonmom 70g",212000,212000,0,0
TIKI,thiet-bi-kts-phu-kien-so,98073814,"Tai Nghe Không Dây Nhét Tai, Tai Nghe Stereo Rảnh Tay ABS TWS Bluetooth 5.0 - Hàng Chính Hãng PKCB",198000,500000,302000,60
TIKI,do-choi-me-be,412776,"Tã Quần Cao Cấp Moony Nhật Bản Bé Trai XL38 (38 Miếng)",339000,466400,127400,27
TIKI,thiet-bi-kts-phu-kien-so,163919783,"Ốp lưng chống sốc trong suốt siêu mỏng 1mm cho iPhone 13 Pro Max hiệu Memumi Glitter (độ trong tuyệt đối, chống trầy xước, chống ố vàng, tản nhiệt tốt) - hàng nhập khẩu",100000,114947,14947,13
TIKI,do-choi-me-be,137951929,"[Bé 6-10 Tuổi] Nón Kết Mũ Lưỡi Trai Cho Bé Trai Từ 6 7 8 9 10 Tuổi Vòng Đầu 53cm Hiphop Cá Tính NK47 - Doni House",80000,80000,0,0
TIKI,do-choi-me-be,100512902,"Set 5 dây cột tóc xinh xắn cho bé gái",29500,29500,0,0
TIKI,thiet-bi-kts-phu-kien-so,360759,"Tai nghe có dây Logitech H340 - Hàng chính hãng",595000,595000,0,0
TIKI,do-choi-me-be,91861978,"Nhà Lắp Ghép Thông Minh Nhà Giấy Carton Lắp Ráp Cho Bé _ Hộp Quà Kỳ Bí",87400,92000,4600,5
TIKI,thiet-bi-kts-phu-kien-so,23518127,"Chuột Không Dây Microsoft 1850 Receiver USB - Hàng Chính Hãng",269000,269000,0,0
TIKI,thiet-bi-kts-phu-kien-so,172369953,"Loa Bluetooth PKCB Bản Mở Rộng, chip DSP, Hỗ Trợ Kết Nối Bluetooth, USB, Thẻ Nhớ,  dây 3.5mm 100W TWS Âm Thanh Sống Động - Hàng chính hãng",2500000,5000000,2500000,50
TIKI,thiet-bi-kts-phu-kien-so,87233516,"Củ Sạc Điện Thoại Ô Tô 38W CHOETECH TC0005 V2 USB Quick Charge 3.0 18W, Type-C PD 20W - Hàng Chính Hãng",249000,390000,141000,36
TIKI,thiet-bi-kts-phu-kien-so,92808691,"Bút Chỉ Bảng thuyết trình đa năng Trình Chiếu laze 4 chức năng trong 1 có thể kéo dài",50000,50000,0,0
TIKI,thiet-bi-kts-phu-kien-so,155325545,"Loa máy tính vi tính, Loa laptop mini 2.0 ,Loa LED Rgp -1046  để bàn bass giá rẻ",76000,81300,5300,7
TIKI,thiet-bi-kts-phu-kien-so,145296443,"Bao da dành cho ipad gen 9 10.2 2021 cute",115000,115000,0,0
TIKI,thiet-bi-kts-phu-kien-so,48967928,"Cáp Chuyển Đổi USB Type-C Sang Jack 3.5 mm Cho Tai Nghe",25000,25000,0,0
TIKI,thiet-bi-kts-phu-kien-so,76357325,"Giá Đỡ Điện Thoại Ô Tô Xe Hơi Gắn Trên Cánh Quạt Điều Hòa - Khóa Thông Minh - Xoay 360 Độ - Tiện Lợi - Hàng Chính Hãng",475000,479000,4000,1
TIKI,thiet-bi-kts-phu-kien-so,145243977,"Bao da cho Samsung Galaxy Z Flip 3 có ngăn đựng thẻ",75000,75000,0,0
TIKI,thiet-bi-kts-phu-kien-so,109889661,"Cáp chuyển Type-C 3.1 ra cổng LAN RJ45",149000,149000,0,0
TIKI,thiet-bi-kts-phu-kien-so,16991546,"Kính cường lực iPhone Xs Max chống nhìn trộm - Viền đen",23888,47776,23888,50
TIKI,do-choi-me-be,10021580,"Sữa Bột Meiji 1-3 Growing Up Formula (800g)",455000,455000,0,0
TIKI,do-choi-me-be,7250239,"Chất Thông Cống Siêu Mạnh SiFa (1.6kg)",65000,65000,0,0
TIKI,do-choi-me-be,138581421,"Combo 10 Gói Khăn Ướt Yuniku 20 Tờ Hương Hoa Lài ( 20 Tờ x 10 )",95000,137000,42000,31
TIKI,do-choi-me-be,55294509,"Đồ Chơi Lắp Ghép Bộ Chữ Số Biến Hình Từ 1 2 3 4 5 6 7 8 9 Thành Robot",299000,400000,101000,25
TIKI,do-choi-me-be,89802357,"Nước Rửa Bát Hữu Cơ ENZYCO Lên Men Từ Bồ Hòn Và Dứa Không Chất Tẩy Công Nghiệp Không Gây Dị Ứng Cho Tay An Toàn Cho Trẻ Nhỏ Mùi Hương - Chai",180000,180000,0,0
TIKI,do-choi-me-be,107935064,"Bình sữa mô phỏng tự nhiên hiệu Philips Avent (260 ml - đơn) cho trẻ từ 1 tháng tuổi 693.13",295000,295000,0,0
TIKI,do-choi-me-be,109372981,"Hộp 6 bộ đồ chơi lắp ráp Robot biến hình - Khủng long (553 chi tiết) Qman 1414",339000,349000,10000,3
TIKI,do-choi-me-be,81227999,"Xe Cứu Hoả Duka DK81039",135000,180000,45000,25
TIKI,do-choi-me-be,104341333,"Xe đẩy cho bé, Xe Đẩy Gấp Gọn 2 Chiều Thông Minh Cho Bé, Xe Đẩy Dạo Chơi Cho Bé Du Lịch",309999,309999,0,0
TIKI,do-choi-me-be,26303479,"Cốc Hút Sữa Silicon NatureBond Chính Hãng Hoa Kỳ, số 1 tại Anh, Canada + Nút chặn chống đổ sữa, túi nhung cao cấp",499000,499000,0,0
TIKI,do-choi-me-be,77014311,"Nước Rửa Chén Sinh Học ENZYCO Lên Men Tự Nhiên Từ Dứa Và Bồ Hòn An Toàn Cho Da Tay Và Diệt Khuẩn - Hương Cam 480ml",100000,100000,0,0
TIKI,do-choi-me-be,116727455,"(Date mới) Sữa Hữu Cơ Miwako A+ Hộp 700g Vị Vani Nhập Khẩu Malaysia, Sữa Hạt Organic Dinh Dưỡng Phát Triển Trí Não & Chiều Cao Cho Bé Từ 1-6 Tuổi Vị Ngọt Thanh Dễ Uống",649000,675000,26000,4
TIKI,do-choi-me-be,104883479,"Nước Rửa Chén Gốc Thực Vật Peace Mass Công Nghệ Enzyme Rửa Sạch & Không Lưu Mùi (Thuộc nhóm Sản phẩm Lành tính / Hữu cơ) Can 3.6 Lít",162450,171000,8550,5
TIKI,do-choi-me-be,2682725,"Thuốc viên diệt gián nội địa Nhật Bản",66000,77000,11000,14
TIKI,do-choi-me-be,30911702,"Bộ Bài Tarot Bói Smith Waite Tarot  Cao Cấp",89000,89000,0,0
TIKI,do-choi-me-be,51661295,"Vitamin k2 d3 Lineabon từ Châu Âu chứa MK7 giúp hấp thụ calci – Hỗ trợ hấp thu canxi tự nhiên cho trẻ, giúp tăng chiều cao, hết còi xương - Hết ngay khóc đêm, trằn trọc, mồ hôi trộn",275000,369000,94000,25
TIKI,do-choi-me-be,173910843,"Xe ô tô điều khiển từ xa KAVY 058 bằng cử chỉ có nhạc, đèn phun được khói xoay 360 độ cao",525000,525000,0,0
TIKI,do-choi-me-be,108598576,"[LOẠI XỊN - CÓ CHỌN SIZE] Cờ Vây Nam Châm Cao Cấp, Cờ Caro Tiện Dụng Chính Hãng - Chọn Nhiều Cỡ",155000,155000,0,0
TIKI,do-choi-me-be,109123361,"Combo 60 túi trữ sữa mẹ Sunmum mini hồng 100ml (2 hộp) tặng 2 zipper bảo quản",125000,138000,13000,9
TIKI,do-choi-me-be,150565149,"Bộ Dụng Cụ Lấy Ráy Tai Có Đèn Led Cao Cấp Kèm Hộp Đựng Sịn Sò Sử Dụng Cổng Sạc USB",179000,179000,0,0
TIKI,do-choi-me-be,64978053,"Combo 4 Gói Khăn Ướt Max Cool 80 Tờ Có Hương Tặng 2 Gói Cùng Loại",124000,124000,0,0
TIKI,do-choi-me-be,171666372,"[Tặng 12 màu + 2 cọ] Combo 20 tượng thạch cao size 5cm - Tô tượng cho bé",55000,55000,0,0
TIKI,do-choi-me-be,74871422,"Đồ chơi xe ô tô địa hình chạy đà KAVY quán tính bằng nhựa nguyên sinh an toàn, chạy rất xa và khỏe",24000,24000,0,0
TIKI,do-choi-me-be,198614354,"Bình Trữ Sữa Cổ Rộng Mama's Choice 180ml–240ml, Tương Thích Máy Hút Sữa Spectra, Avent, Fatz, Rozabi, Cimilre",92000,95000,3000,3
TIKI,do-choi-me-be,197529904,"Học liệu bóc dán thông minh cho bé, học liệu busy book 17 chủ đề đa dạng dùng nhiều lần",89500,89500,0,0
TIKI,do-choi-me-be,196675403,"Cốc tập uống bằng nhựa HiPP - Nhập khẩu Đức (Màu ngẫu nhiên)",75000,75000,0,0
TIKI,do-choi-me-be,54412956,"Bộ Cờ Cá Ngựa – Cờ Cá Ngựa Nam Châm – Chính Hãng An Toàn Vui Nhộn Cho Bé (Vỏ Hộp Màu Ngẫu Nhiên)",95000,130000,35000,27
TIKI,do-choi-me-be,108753317,"Núm ty Silicon mô phỏng tự nhiên hiệu Philips Avent cho trẻ sơ sinh",225000,225000,0,0
TIKI,do-choi-me-be,144121555,"Túi Trữ Sữa Và Bảo Quản Sữa Mẹ Mama’s Choice, Bịch Đựng Sữa Mẹ, Có Khóa Zip Tiện Lợi An Toàn, Lẻ 10 Túi",65000,87000,22000,25
TIKI,do-choi-me-be,184101595,"Combo 2 túi Nước giặt OMO Matic Comfort Hương Hoa Hồng Ecuador cho máy giặt cửa trên, túi 3.6kg",350000,454000,104000,23
TIKI,do-choi-me-be,115694868,"Đồ chơi lắp ráp xếp hình robot người máy Qman 1414 - Siêu Robot khủng long (456 mảnh ghép) dành cho bé trên 6 tuổi",259000,359000,100000,28
TIKI,do-choi-me-be,879798,"3 Gói Khăn Ướt Yuniku Max Cool YK20-02 (20 Tờ x 3) - 3 Màu",29000,41100,12100,29
TIKI,do-choi-me-be,50615508,"Xe gà cho bé tập đi bằng gỗ siêu bền",95997,95997,0,0
TIKI,do-choi-me-be,435753,"Sữa Bột Abbott Grow 3 cho trẻ từ 1- 2 tuổi (900g)",295000,295000,0,0
TIKI,do-choi-me-be,78283430,"Đồ chơi mô hình xe bus 2 tầng mui trần  KAVY có nhạc và đèn chạy cót bằng kim loại bền bỉ, xe thăm quan du lịch thành phố",185000,185000,0,0
TIKI,do-choi-me-be,115483210,"Sữa bột Enfagrow A+ NeuroPro 3 với 2’-FL HMO cho trẻ từ 1 – 3 tuổi – 830g",492000,492000,0,0
TIKI,do-choi-me-be,95035813,"Bột ăn dặm dinh dưỡng Sữa, Chuối, Đào HiPP Organic 250g",145000,145000,0,0
TIKI,do-choi-me-be,104850929,"Váy đầm bé gái Hồng Chấm Bi Cổ Vàng KIKA - Size 11-45kg - K139",199000,199000,0,0
TIKI,do-choi-me-be,263388843,"Viên giặt xả Bold Gel Ball 3D hương hoa túi 44 viên của Nhật Bản",179000,179000,0,0
TIKI,do-choi-me-be,57930183,"Hộp 8 bộ đồ chơi lắp ráp Trực thăng tấn công 8in1 Qman 1801 (381 chi tiết)",199000,269000,70000,26
TIKI,thiet-bi-kts-phu-kien-so,52087768,"Sim 4G MAY V77 (Vinaphone-Itelecom) gói cước 90GB/ tháng tốc độ cao – Hàng chính hãng - Giao mẫu ngẫu nhiên",79000,79000,0,0
TIKI,thiet-bi-kts-phu-kien-so,77868208,"Webcam HXSJ S4 HD 1080P USB3.0 2.0 Có Thể Điều Chỉnh 360° Kèm Mic Cho Cuộc Gọi Video - Hàng Chính Hãng",399000,699000,300000,43
TIKI,thiet-bi-kts-phu-kien-so,193006708,"Định vị GPS không dây Thông minh FA81 Dành cho Trẻ em, Học sinh, Người già, Hàng hóa, Ô tô, Xe máy Hàng nhập khẩu",1255000,1255000,0,0
TIKI,thiet-bi-kts-phu-kien-so,15170396,"Máy Nghe Nhạc MP3 Ruizu X02 Bộ Nhớ Trong 8GB AZONE - Hàng Nhập Khẩu",445000,445000,0,0
TIKI,thiet-bi-kts-phu-kien-so,127202818,"Miếng Dán PPF Full viền dành cho iphone 13 pro max / 13 pro / 13 / 13 mini / 12 pro max/ 12 pro / 12 / 11pro max / 11 / 11pro max",27000,69986,42986,61
TIKI,thiet-bi-kts-phu-kien-so,136096397,"Ốp lưng da cổ điển dành cho iPhone 11 / 12 / 13 / 11 Pro / 12 Pro / 13 Pro / 11 Pro Max / 12 Pro Max / 13 Pro Max / 12 Mini / 13 Mini - Hàng chính hãng",149000,250000,101000,40
TIKI,thiet-bi-kts-phu-kien-so,59549110,"Cáp sạc nhanh hiển thị đèn LED dành cho iphone dây dù 1,2M siêu bền ( Màu ngẫu nhiên )",29000,50000,21000,42
TIKI,thiet-bi-kts-phu-kien-so,119404695,"Đồng Hồ Định Vị Trẻ Em Y92 ️️ Hỗ Trợ Tiếng Việt, Kháng Nước IP67 - Lắp Sim Nghe Gọi, Định Vị LPS, 4G/WIFI",399000,399000,0,0
TIKI,thiet-bi-kts-phu-kien-so,58207084,"Tai nghe nhét tai Hoco M64 Melodious jack kết nối 3.5, âm thanh tuyệt vời - HÀNG NHẬP KHẨU",82500,82500,0,0
TIKI,thiet-bi-kts-phu-kien-so,550418,"Loa Vi Tính Logitech Z333 2.1 80W - Hàng Chính Hãng",1890000,1890000,0,0
TIKI,thiet-bi-kts-phu-kien-so,149437533,"Bao da Cover cho Kindle Paperwhite 5 - Họa tiết vải, ốp sau PVC, có kẹp tay giữ máy",160000,160000,0,0
TIKI,thiet-bi-kts-phu-kien-so,49060453,"Loa Bluetooth Bose Soundlink Mini II Special Edition - Hàng Chính Hãng",4290000,4990000,700000,14
TIKI,thiet-bi-kts-phu-kien-so,73936929,"Bộ Củ Sạc Nhanh 30W PD 3.0, 2 Cổng Sạc Và Cáp Type-C To Light.ning Dài 1m Chứng Nhận MFI RAVPower RP-PC144 Dành Cho iPhone, Cho iPad - Hàng Chính Hãng",459000,459000,0,0
TIKI,thiet-bi-kts-phu-kien-so,32399542,"Lót Chuột Tròn Có Kê Tay Chống Chai Họa Tiết Dễ Thương 18 x 23 cm",45220,45220,0,0
TIKI,thiet-bi-kts-phu-kien-so,54609191,"Túi Chống Sốc Dành Cho Ipad Pro 11 inch Chống Thấm Nước, Chống Xước, Bụi Bẩn Hàng Chính Hãng Helios",99000,99000,0,0
TIKI,thiet-bi-kts-phu-kien-so,140220861,"Tai nghe chụp tai bluetooth Cute Cat V2, tai nghe mèo không dây siêu dễ thương có đèn led đổi màu cực đẹp, tai mèo đáng yêu có mic đàm thoại cao cấp",369000,369000,0,0
TIKI,thiet-bi-kts-phu-kien-so,126075524,"Củ sạc nhanh 30W Remax RP-U82 chuẩn kép QC+PD - Hàng chính hãngg",316500,390000,73500,19
TIKI,thiet-bi-kts-phu-kien-so,59044202,"Thẻ nhớ MicroSD Kioxia 32GB Class 10 - Hàng Nhập Khẩu",99000,99000,0,0
TIKI,thiet-bi-kts-phu-kien-so,14096858,"Bút trình chiếu VP 101",90000,90000,0,0
TIKI,thiet-bi-kts-phu-kien-so,97319439,"Ốp lưng da kính cao cấp dành cho iPhone 12 Mini / 12 / 12 Pro / 12 Pro Max - Hàng chính hãng",149000,199000,50000,25
TIKI,thiet-bi-kts-phu-kien-so,52049435,"Bút cảm ứng stylus thông minh hiệu WIWU Pencil Magic Gen 2 cho màn hình cảm ứng iPad / iPhone / Samsung Xiaomi Huawei Oppo Sony LG (cảm ứng siêu mượt mà, dung lượng pin cao, thiết kế thời trang) - Hàng nhập khẩu - Trắng",639000,639000,0,0
TIKI,thiet-bi-kts-phu-kien-so,2462825,"Chuột game không dây Lightspeed Logitech G304 - Cảm biến Hero, 12k DPI, nhẹ, 6 nút lập trình, on-board memory, pin 250h - Hàng chính hãng",850000,850000,0,0
TIKI,thiet-bi-kts-phu-kien-so,202465273,"Bàn Phím Gaming Cơ RAPOO V500Pro Thiết Kế Cá Tính ( Rapoo V500 Pro ) - Hàng Chính Hãng",699000,699000,0,0
TIKI,thiet-bi-kts-phu-kien-so,21572053,"THẢM DA TRẢI BÀN LÀM VIỆC, TẤM LÓT CHUỘT, MIẾNG DI CHUỘT KHỔ LỚN HAI MẶT 120 X 60 CM",279000,279000,0,0
TIKI,thiet-bi-kts-phu-kien-so,191757014,"Cáp sạc nhanh đa năng Remax RC-190 - Hỗ trợ sạc nhanh lên đến 60W - Hàng Chính Hãng",219000,219000,0,0
TIKI,thiet-bi-kts-phu-kien-so,138226190,"Cáp HDMI dài 3m cao cấp hỗ trợ Ethernet + 4k 2k chính hãng Ugreen 10108 10109 - Hàng chính hãng",95000,95000,0,0
TIKI,thiet-bi-kts-phu-kien-so,57656568,"Miếng Lót Chuột Da 2 mặt ( Mouse pad ) 270x210mm",42800,42800,0,0
TIKI,thiet-bi-kts-phu-kien-so,21325869,"Miếng Lót Chuột, Bàn Di Chuột, mouse pad anime One Piece cỡ lớn (80x30x0.3)",87000,87000,0,0
TIKI,thiet-bi-kts-phu-kien-so,75574549,"Tai nghe Bluetooth nhét tai không dây có hộp sạc - Tai nghe âm thanh nổi 3D có tính năng chống ồn - IPX5 - Chống nước - Hàng Chính Hãng PKCB",250000,500000,250000,50
TIKI,thiet-bi-kts-phu-kien-so,138226961,"Giá đỡ điện thoại dán tường khi sạc MW5 kiêm khay đựng remote ( Màu ngẫu nhiên) Hàng chính hãng",7899,7899,0,0
TIKI,thiet-bi-kts-phu-kien-so,140323745,"Tai Nghe Dây Nhét Tai Chống Ồn XSmart X6 Âm Thanh Siêu Bass Nghe Nhạc, Xem Phim, Chơi Game Cực Đã Tích Hợp Mic Lọc Âm, jack 3.5 - Hàng Chính Hãng",169000,169000,0,0
TIKI,thiet-bi-kts-phu-kien-so,15186378,"USB OTG SanDisk Ultra Dual 128GB Type-C USB 3.1 DDC2 SDDDC2-128G-G46 - Hàng Chính Hãng",369000,389000,20000,5
TIKI,thiet-bi-kts-phu-kien-so,127930319,"Ốp lưng dành cho iPhone 13 Pro Max Memumi mỏng trong suốt (không ố màu) - Hàng nhập khẩu",87990,167000,79010,47
TIKI,thiet-bi-kts-phu-kien-so,6610413,"Đầu jack chuyển đổi âm thanh từ cổng 3.5mm cái sang cổng 6.5mm đực chính hãng UGREEN 20503 - Hàng chính hãng",56000,56000,0,0
TIKI,thiet-bi-kts-phu-kien-so,183719378,"Kính cường lực 21D full màn hình dành cho Samsung A03 /A13 4g 5g / A23/ A33",25000,25000,0,0
TIKI,thiet-bi-kts-phu-kien-so,162144193,"Ốp lưng chống sốc trong suốt cho Samsung Galaxy Note 9 hiệu Likgus Crashproof giúp chống chịu mọi va đập - hàng nhập khẩu",93500,93500,0,0
TIKI,thiet-bi-kts-phu-kien-so,184100707,"Ốp lưng chống sốc trong suốt cho Samsung Galaxy S21 FE hiệu Likgus Crashproof giúp chống chịu mọi va đập - hàng nhập khẩu",94049,94049,0,0
TIKI,thiet-bi-kts-phu-kien-so,25325318,"Giá Đỡ Điện Thoại Để Bàn Hình Ghế Thời Trang - Giao Màu Ngẫu Nhiên",6761,6761,0,0
TIKI,thiet-bi-kts-phu-kien-so,134522531,"Ốp Lưng dành cho Google Pixel 7a/7/7 Pro/6/6 Pro RINGKE Fusion - Hàng Chính Hãng",243000,243000,0,0
TIKI,thiet-bi-kts-phu-kien-so,190703528,"Dây đeo Magnetic Silicone Strap Dành Cho Apple Watch- Hàng chính hãng",180500,190000,9500,5
TIKI,thiet-bi-kts-phu-kien-so,176213226,"Micro Karaoke kèm loa Bluetooth iCore YM99 - Hàng chính hãng",990000,1290000,300000,23
TIKI,thiet-bi-kts-phu-kien-so,21297952,"Tai nghe nhét tai không dây cao cấp bluetooth v 4.1 Roman z6000,  hỗ trợ rung khi có cuộc gọi - Hàng Nhập Khẩu",550000,700000,150000,21
TIKI,thiet-bi-kts-phu-kien-so,35951535,"Tay Cầm Chơi Game Không Dây Cho PC / Xbox360 / Android TV / Smartphone/ Laptop 850M - cổng OTG Type-C",177555,186900,9345,5
TIKI,thiet-bi-kts-phu-kien-so,51640190,"Bàn Phím Bluetooth có mặt di chuột cho Laptop tablet điện thoại AB033",488000,488000,0,0
TIKI,thiet-bi-kts-phu-kien-so,15280632,"Giá đỡ điện thoại, máy tính bảng có chân kẹp đầu giường, cạnh bàn",78890,78890,0,0
TIKI,thiet-bi-kts-phu-kien-so,170105386,"Thẻ Nhớ Micro SDXC Samsung Evo Plus 130MB/s 64GB New - Hàng Nhập Khẩu",155000,155000,0,0
TIKI,thiet-bi-kts-phu-kien-so,33360472,"Đầu Chuyển Đổi USB 3.0 Sang USB Type C",19000,25000,6000,24
TIKI,thiet-bi-kts-phu-kien-so,271419201,"Giá đỡ, chân đế kẹp giữ cho Macbook có thể điều chỉnh",250000,250000,0,0
TIKI,thiet-bi-kts-phu-kien-so,139462714,"Tai Nghe Bluetooth Tai Mèo Phát Sáng VinBuy, Tai Nghe Không Dây, Tai Nghe Chụp Tai, Tai Nghe Mèo Có Mic, Đèn LED Và Âm Bass Mạnh Mẽ - Chính Hãng",133000,300000,167000,56
TIKI,thiet-bi-kts-phu-kien-so,25106346,"Bút trình chiếu văn phòng powerpoint Vesine VP101  ",180405,189900,9495,5
TIKI,thiet-bi-kts-phu-kien-so,160566577,"Bao Da Dành Cho Ipad 2-3-4 / Air 1- 2 - 3 -4 / Mini 1- 2- 3 - 4 / New 2017-2018 / Air 3 / 10.5 / 10.9 Họa Tiết Deer - Da Lộn",180000,180000,0,0
TIKI,thiet-bi-kts-phu-kien-so,120782190,"Giá đỡ / Đế đỡ tản nhiệt dành cho laptop, macbook, máy tính bảng gấp gọn tiện dụng + tặng kèm túi đựng, ( Giao màu ngẫu nhiên )- Hàng chính hãng",67700,67700,0,0
TIKI,thiet-bi-kts-phu-kien-so,195915991,"Thẻ Nhớ MicroSDXC SanDisk Extreme Pro V30 A2 256GB 200MB/s SDSQXCD-256G (New 2022) - Hàng Nhập Khẩu",665000,665000,0,0
TIKI,thiet-bi-kts-phu-kien-so,25749035,"Tai nghe chụp tai Bluetooth P47",69900,69900,0,0
TIKI,thiet-bi-kts-phu-kien-so,169809666,"Micro Karaoke Bluetooth kèm loa kết nối điện thoại, máy tính bảng Hát Không Dây, Nghe Nhạc, Hỗ Trợ Kết Nối Thẻ Nhớ, USB Pin sạc - Hàng Chính Hãng",410000,900000,490000,54
TIKI,thiet-bi-kts-phu-kien-so,72217122,"Ốp Lưng TPU Dẻo Viền Vuông Giả iPhone 12 Dành Cho iPhone 6,7,6 Plus,7Plus,X,Xr,Xs Max,11,11 Pro, 11 Pro Max- Hàng Chính Hãng",79000,79000,0,0
TIKI,thiet-bi-kts-phu-kien-so,108207118,"Cáp mạng Cat6 hỗ trợ truyền dữ liệu lên đến 1000Mbps dài 1-5m UGREEN NW135 - Hàng chính hãng",100000,125000,25000,20
TIKI,thiet-bi-kts-phu-kien-so,181796865,"Tai nghe Bluetooth True Wireless Go Air Pop JLab màu xám xanh (slate) - Hàng chính hãng",890000,890000,0,0
TIKI,thiet-bi-kts-phu-kien-so,197574571,"Ốp Lưng Elago Clear Case Dành Cho iPhone 14 ProMax / 14 Pro / 14 Plus / 14 - Hàng Chính Hãng",330000,373000,43000,12
TIKI,thiet-bi-kts-phu-kien-so,165938610,"Miếng Dán Bảo Vệ Viền PDF Kai dành cho iPhone 13 / 13 Pro / 13 Pro Max Hình Animal - Hàng Chính Hãng",46550,49000,2450,5
TIKI,thiet-bi-kts-phu-kien-so,5050641,"Tay Cầm Chơi Game PC Đầu USB Có Rung, Joystick",71100,71100,0,0
TIKI,thiet-bi-kts-phu-kien-so,29655357,"Giá đỡ, Kẹp Ipad đầu giường - Điện thoại máy tính bảng",66900,66900,0,0
TIKI,thiet-bi-kts-phu-kien-so,7555917,"Bao Da Smart Case Gen2 TPU Dành Cho iPad Air / Air 2 / Pro 9.7inch / The New 2017 / 9.7 2018",116000,289986,173986,60
TIKI,thiet-bi-kts-phu-kien-so,25300596,"Sim Và Esim Du lịch 42 nước Châu Âu (10 ngày) - Mẫu ngẫu nhiên",350000,350000,0,0
TIKI,thiet-bi-kts-phu-kien-so,54626520,"Giá Đỡ Để Bàn Điện Thoại Di Động, Máy Tính Bảng Hợp Kim Nhôm Cao Cấp - 02 Vị Trí Điều Chỉnh Góc Nhìn Hàng Chính Hãng Helios",39000,39000,0,0
TIKI,thiet-bi-kts-phu-kien-so,174211215,"Bộ Bàn phím chuột không dây K835 - pin sạc - đa kết nối bluetooth 5.0 + 3.0 + Usb wireless 2.4g",520000,520000,0,0
TIKI,thiet-bi-kts-phu-kien-so,136032899,"Loa máy trợ giảng Aporo T18  2.4G công suất 30W Bluetooth 5.0 không dây cao cấp",950000,950000,0,0
TIKI,thiet-bi-kts-phu-kien-so,49548834,"Tai Nghe Có Dây Nhét Tai Sennheiser CX 80S - Hàng Chính Hãng",490000,629000,139000,22
TIKI,thiet-bi-kts-phu-kien-so,50295352,"Đầu chuyển đổi HDMI to VGA có hỗ trợ cổng audio 3.5mm VENTION AIDB0 - Hàng chính hãng",230500,230500,0,0
TIKI,thiet-bi-kts-phu-kien-so,71986961,"Tai nghe KZ EDX - Bản nâng cấp mới, Bass tốt hơn, có micro - hàng chính hãng",178000,178000,0,0
TIKI,thiet-bi-kts-phu-kien-so,115129397,"VINETTEAM Bộ Chuyển Đổi Âm Thanh Không Dây K16 Bluetooth 5.0 Thiết Bị Thu Phát Bluetooth Từ Tivi, Amply Ra RAC, AV3.5 Hỗ Trợ Ứng Dụng Đĩa TF/U Sạc Nhanh 220V/2A - Hàng Chính Hãng",399000,450000,51000,11
TIKI,thiet-bi-kts-phu-kien-so,212986152,"Dụng Cụ Silicon Cố Định Đầu Dây Sạc, Dùng Keo 3M Xịn Giúp Tăng Cường Độ Chắc Chắn Khi Cố Định - Funu Home",45000,45000,0,0
TIKI,thiet-bi-kts-phu-kien-so,56558512,"COMBO 5 Dây Quấn Tai Nghe-Cáp Xạc-  Nhiều Màu Đa năng-Chống rối",8996,8996,0,0
TIKI,thiet-bi-kts-phu-kien-so,181680005,"Bút cảm ứng điện dùng cho Smartphone, iPad 2 đầu cảm ứng nhỏ gọn",65000,88000,23000,26
TIKI,thiet-bi-kts-phu-kien-so,162168764,"Bao Da Dành Cho iPad Pro 11 inch M1 2021/ Pro 11 inch M2 2022 ESR Rebound Pencil Case- Hàng Chính Hãng",750000,750000,0,0
TIKI,thiet-bi-kts-phu-kien-so,190336881,"Ốp lưng dành cho Xiaomi POCO C40 silicon dẻo trong suốt cao cấp A+",18000,18000,0,0
TIKI,thiet-bi-kts-phu-kien-so,114629126,"Giá Đỡ Điện Thoại Trên Ô Tô - Kẹp Điện Thoại Ô Tô, Xe Máy Hít Nam Châm Cực Chắc",40000,40000,0,0
TIKI,thiet-bi-kts-phu-kien-so,35431989,"Loa Karaoke Bluetooth Xách Tay KMS-S1 (Đen) Tặng Kèm 1 Mic Hát Có Dây Cắm Trực Tiếp, Bass Không Dây, Đèn Led Sống Động",298997,298997,0,0
TIKI,thiet-bi-kts-phu-kien-so,20022917,"Bút Trình Chiếu Vesine VP-101 - Hàng Nhập Khẩu",91000,91000,0,0
TIKI,do-choi-me-be,120170572,"Xe chòi chân B.Duck yên da cho bé từ 1 đến 2 tuổi - Xe thăng bằng khung thép, bánh cao su an toàn cho trẻ DC019",249000,249000,0,0
TIKI,do-choi-me-be,90526567," Váy đầm thun bé gái dễ thương - Size 11-45kg - K134",150000,150000,0,0
TIKI,thiet-bi-kts-phu-kien-so,14116368,"Dây Audio chuyển tai nghe 3.5mm đầu cái sang 2 đầu Mic và Tai nghe đầu đực",11000,11000,0,0
TIKI,do-choi-me-be,64029864,"Bộ Thẻ Nhân Quả (Cấp Độ Trung Bình) | Game Tư Duy Nhân Quả Số 1 Tại Việt Nam",200000,200000,0,0
TIKI,do-choi-me-be,153820898,"Bộ bóc dán thông minh cho bé 17 chủ đề (loại cao cấp), dùng nhiều lần, giúp bé vừa chơi, vừa học tiếng Anh",99000,198000,99000,50
TIKI,do-choi-me-be,16374640,"Tấm Lót Chống Thấm Tiện Lợi An Toàn Cho Bé (80 x 120 cm)",88000,117000,29000,25
TIKI,do-choi-me-be,70844277,"Bộ Thẻ Bài Pokemon 324 Thẻ Cao Cấp Nhiều Loại",198000,198000,0,0
TIKI,do-choi-me-be,74944614,"Đồ chơi hình cú mèo chạy cót KAVY nhấn là chạy đáng yêu dễ thương nhựa nguyên sinh an toàn",22000,22000,0,0
TIKI,do-choi-me-be,52579303,"[COMBO 4 GÓI] KHĂN VẢI KHÔ ĐA NĂNG AIKO X 270 TỜ/ GÓI",140000,140000,0,0
TIKI,do-choi-me-be,73272562,"Combo 4 Gói Khăn Ướt Max Cool 80 Tờ Tặng 2 Gói Cùng Loại",99000,124000,25000,20
TIKI,do-choi-me-be,181184380,"Ghế ăn dặm cho bé gập gọn và nâng hạ độ cao Mastela 7331 - Ghế tập ăn dặm cho bé đạt chuẩn ASTM Mỹ BPA Free",660000,660000,0,0
TIKI,do-choi-me-be,89752727,"Bộ bơi bé gái lớn, dáng 2 mảnh cộc tay quần sooc đùi thể thao, màu sắc trẻ trung, áo tắm trẻ em nữ size đại từ 25 đến 60kg | BT37",299000,314420,15420,5
TIKI,do-choi-me-be,44885577,"Đồ Chơi Gỗ Bộ Domino 100 Quốc Gia Trên Thế Giới",95000,150000,55000,37
TIKI,do-choi-me-be,48477021,"Combo Bộ Bài Tarot Bói Smith Waite Tarot Cao Cấp và Túi Nhung Đựng Tarot và Khăn Trải Bàn Tarot",119000,119000,0,0
TIKI,do-choi-me-be,55576959,"Tinh dầu tràm Con Dơi ( Nguyên chất 100%)",137000,137000,0,0
TIKI,do-choi-me-be,104559720,"Kính bơi cho trẻ em độ tuổi từ 4 tuổi đến 10 tuổi",89000,94240,5240,6
TIKI,do-choi-me-be,24448316,"Nước rửa bình sữa D-nee Mild & Care chai 500ml",79000,91000,12000,13
TIKI,do-choi-me-be,70904714,"Tã Dán Siêu Thấm Caryn Gói Siêu Tiết Kiệm M40 (40 Miếng) - MẪU MỚI",349000,349000,0,0
TIKI,do-choi-me-be,144278087,"Lều Xông Hơi Tự Bung 3 Lớp Và Nồi Xông Hơi Cao Cấp Dùng Tại Nhà Spa",698000,698000,0,0
TIKI,do-choi-me-be,205719867,"Combo muối rửa bát Finish 1,5kg+viên rửa bát Finish 120 viên+Nước làm bóng bát chén finish 800ml",519000,519000,0,0
TIKI,do-choi-me-be,205290276,"Nước làm bóng Finish 750ml",118000,118000,0,0
TIKI,do-choi-me-be,68462933,"Bỉm - Tã Quần Moony Natural Size XL- 32 miếng ( bé 12- 22Kg)",286900,286900,0,0
TIKI,do-choi-me-be,184522257,"Đồ chơi lắp ráp, xếp hình tàu chiến Qman 1411 cho bé trai - Tàu tuần dương biển (700 mảnh ghép)",359000,459000,100000,22
TIKI,do-choi-me-be,68142209,"Nutifood GrowPLUS+ Đỏ 1500 Gr : sữa dành cho trẻ từ 1- 10 tuổi bị suy dinh dưỡng thấp còi (mẫu mới)",555000,555000,0,0
TIKI,do-choi-me-be,274536010,"[Combo Tiện Lợi] Gói Men Bể Phốt EcoClean Septic - Men Vi Sinh Xử Lý Hầm Cầu, Bể Phốt Đầy, Tràn - Túi Gói 100gram",246000,246000,0,0
TIKI,do-choi-me-be,115694932,"Đồ chơi lắp ráp xếp hình tên lửa chiến đấu Qman 1728 - Tên lửa đánh chặn (409 mảnh ghép) dành cho bé trai trên 6 tuổi",279000,359000,80000,22
TIKI,do-choi-me-be,94728826,"Áo yếm máng dài tay Cotton chống thấm nước cho bé tập ăn dặm, tập vẽ Mastela Dành cho bé từ 0-4 tuổi - Có chọn màu và size",69000,95000,26000,27
TIKI,do-choi-me-be,90475777,"Thuốc diệt chuột thái lan tiêu diệt cả đàn sau 3 ngày tặng kèm bịt thuốc diệt dán và kiến",31900,31900,0,0
TIKI,do-choi-me-be,247474808," Bàn Chải Đánh Răng Trẻ Em Jodily 1-4 Tuổi Siêu Mền Mại (Dành Cho Bé Tập Đánh Răng)",55000,55000,0,0
TIKI,do-choi-me-be,135478535,"Nước giặt Dnee cho bé chai 3000ml-hàng chính hãng có hoá đơn",195000,195000,0,0
TIKI,do-choi-me-be,755394,"Cờ Domino Ngà Lớn Liên Hiệp Thành KDNL",78000,78000,0,0
TIKI,do-choi-me-be,146399059,"Sữa bột Nutricare Care 100 Plus phục hổi dinh dưỡng cho trẻ biếng ăn (900g)",335000,335000,0,0
TIKI,do-choi-me-be,107693416,"Nước rửa bát hữu cơ Fuwa3e organic Enzyme sinh học 500ml an toàn cho bé bảo vệ da tay",58000,58000,0,0
TIKI,do-choi-me-be,130362474,"SET 10 QUẦN ĐÙI THUN COTTON NHIỀU HOẠ TIẾT CHO BÉ GÁI",197000,197000,0,0
TIKI,do-choi-me-be,146366199,"MÁY ĐA NĂNG ĐIỆN TỬ (ALL-IN-ONE) FATZBABY - MULTIMAX 2 - FB9013SLTHẾ HỆ MỚI",1099000,1099000,0,0
TIKI,do-choi-me-be,117031983,"Áo Hút Sữa Rảnh Tay Mama’s Choice, Mặc Hút Sữa Cho Mẹ, Có Dây Giữ Bình Hút Sữa Chắc Chắn, Chất Liệu Thoáng Khí, Freesize - MÀU ĐEN",350000,390000,40000,10
TIKI,do-choi-me-be,57933293,"Hộp 8 bộ đồ chơi lắp ráp Biệt đội cứu hỏa vòi rồng 8in1 Qman 1805 (313 chi tiết)",177000,256000,79000,31
TIKI,do-choi-me-be,16862593,"Bài Tarot - Bài Bói The Rider Tarot Deck (kèm túi)",75000,75000,0,0
TIKI,do-choi-me-be,104156562,"Sữa tắm dịu nhẹ Jojoba Pigeon 200ml/700ml",47000,67000,20000,30
TIKI,do-choi-me-be,89233900,"Lưới bọc quạt loại to có dây kéo an toàn cho trẻ nhỏ . Đường kính tối đa 50cm",20500,20500,0,0
TIKI,do-choi-me-be,95035841,"(date T6.24) Dinh dưỡng đóng lọ ăn dặm Trái cây nhiệt đới HiPP Organic 125g",45000,45000,0,0
TIKI,thiet-bi-kts-phu-kien-so,30744379,"Loa Nghe Nhạc Xách Tay DB16 Hỗ Trợ Bluetooth, USB, Thẻ Nhớ",86600,86600,0,0
TIKI,thiet-bi-kts-phu-kien-so,72745925,"Bộ Bàn Phím Chuột không dây W201 white nhỏ gọn",236550,249000,12450,5
TIKI,thiet-bi-kts-phu-kien-so,515550,"Bộ Bàn Phím Và Chuột Không Dây Logitech MK235 - Hàng chính hãng",480000,480000,0,0
TIKI,thiet-bi-kts-phu-kien-so,20201881,"Kính Cường Lực Full Màn Hình Cho Redmi Note 7 / Redmi Note 7 Pro",12000,12000,0,0
TIKI,thiet-bi-kts-phu-kien-so,41873601,"Cáp chuyển Thunderbolt 3 ra HDMI/USB/ PD cho Macbook TH0531",107000,112999,5999,5
TIKI,thiet-bi-kts-phu-kien-so,76176924,"VINETTEAM Giá Đỡ Laptop Nhôm N8 Màu Bạc Thiết Kế Thông Minh 2 Tầng Điều Chỉnh Độ Cao, Gấp Gọn Và Tản Nhiệt Cho Laptop, Surface, Ipad, Macbook Cho Máy Từ 12~17inch - Hàng Chính Hãng",250067,263228,13161,5
TIKI,thiet-bi-kts-phu-kien-so,48483174,"Dây cáp sạc 3 đầu đa năng Type C, Iphone, Android S04 - Hàng chính hãng",28384,28384,0,0
TIKI,thiet-bi-kts-phu-kien-so,10881983,"Tai nghe Bluetooth V9 4.0",92780,92780,0,0
TIKI,thiet-bi-kts-phu-kien-so,14265753,"Bút trình chiếu Lazer - Bút thuyết trình- Bút trình chiếu slide, powerpoint tặng kèm bao da",112000,117000,5000,4
TIKI,thiet-bi-kts-phu-kien-so,50604824,"Cáp sạc Type C dành cho Macbook",173995,347990,173995,50
TIKI,thiet-bi-kts-phu-kien-so,174593834,"Chuột bluetooth PIXLINK P103BL 2 chế độ sạc pin siêu mỏng không gây tiếng ồn chuyên dùng cho Máy tính, pc, Laptop, Tivi Hàng Chính Hãng",131000,299000,168000,56
TIKI,thiet-bi-kts-phu-kien-so,174511679,"Cổng chuyển đổi Ugreen USB 3.0 to USB-C Adapter US276 50533 - Hàng chính hãng",100000,130000,30000,23
TIKI,thiet-bi-kts-phu-kien-so,23013305,"Giá đỡ thông minh cho điện thoại, máy tính bảng có chân kẹp đầu giường, cạnh bàn - Tặng giá hình thú để điện thoại",78782,78782,0,0
TIKI,thiet-bi-kts-phu-kien-so,102050246,"GIÁ ĐỠ ĐIỆN THOẠI, ĐỂ ĐIỂU KHIỂN DÁN TƯỜNG CÓ KHE LUỒN DÂY SẠC TIỆN DỤNG",5300,5300,0,0
TIKI,thiet-bi-kts-phu-kien-so,116754406,"Băng dính gai làm gọn dây điện, băng dán gai đa năng băng nhám làm gọn góc PC, dây cáp sạc, tai nghe - Hàng nhập khẩu",8000,8000,0,0
TIKI,thiet-bi-kts-phu-kien-so,22814377,"Hub USB 4 Port Hoco ( Hàng chính hãng )",120000,120000,0,0
TIKI,thiet-bi-kts-phu-kien-so,172341289,"Bao Da Dành Cho iPad Pro 11 inch 2021/ 2022 ESR Rebound Magnetic Slim Case - Hàng Chính Hãng",713450,751000,37550,5
TIKI,thiet-bi-kts-phu-kien-so,122901569,"Bao da cao cấp dạng ví dành cho iPhone 13 Pro Max hàng chính hãng Caseme",120000,120000,0,0
TIKI,thiet-bi-kts-phu-kien-so,112056051,"Dây Cao Su Thay Thế Viền Color cho Samsung Galaxy Fit 2 (SM-R220)",79000,79000,0,0
TIKI,thiet-bi-kts-phu-kien-so,195916600,"Thẻ Nhớ MicroSDXC SanDisk Extreme Pro V30 A2 64GB 200MB/s SDSQXCU-064G (New 2022) - Hàng Nhập Khẩu",260000,260000,0,0
TIKI,thiet-bi-kts-phu-kien-so,114680946,"Bao da kèm bàn phím Logitech Combo Touch dành cho iPad Pro 12.9 inch (gen 5) - Bàn phím Backlit có thể tháo rời, Trackpad siêu nhạy - Hàng chính hãng",4227000,5400000,1173000,22
TIKI,thiet-bi-kts-phu-kien-so,84340413,"Dây Đeo Thay Thế Dành Cho Vòng Đeo Tay Thông Minh Samsung Galaxy Fit 2 SM-R220 Dẻo TPU",59000,59000,0,0
TIKI,thiet-bi-kts-phu-kien-so,151420174,"Loa Bluetooth JBL Go 3 JBLGO3 - Hàng chính hãng",1019000,1090000,71000,7
TIKI,thiet-bi-kts-phu-kien-so,128710027,"Giá Kẹp - Giá Đỡ Điện Thoại, Máy Tính Bảng Ipad Dài 1 Mét Kẹp Bàn, Kẹp Đầu Giường",95000,95000,0,0
TIKI,thiet-bi-kts-phu-kien-so,192445205,"Củ sạc nhanh GaN công suất 33W Remax RP-U25 chuẩn kép PD + QC 3.0 - Hàng chính hãng",334550,390000,55450,14
TIKI,thiet-bi-kts-phu-kien-so,95484013,"Bàn Phím gaming mini Led RGB V700 giả cơ nhỏ gọn - hàng nhập khẩu",521800,521800,0,0
TIKI,thiet-bi-kts-phu-kien-so,11240845,"Dây cáp HDMI - Chuẩn 1.4 full HD (10m)",55880,55880,0,0
TIKI,thiet-bi-kts-phu-kien-so,5986499,"Cáp HDMI 2.0 hỗ trợ 3D , 4K dài 1.5m UGREEN HD118 40409 - Hàng Chính Hãng",100000,110000,10000,9
TIKI,thiet-bi-kts-phu-kien-so,21748106,"Ốp lưng cho Samsung Galaxy S9 Plus dẻo, trong suốt",12000,12000,0,0
TIKI,thiet-bi-kts-phu-kien-so,168869275,"Bao da dành cho iPad Gen 9 10.2 inch 2021 có nắp bảo vệ camera Nillkin Bumper Leather - Hàng chính hãng",340000,340000,0,0
TIKI,thiet-bi-kts-phu-kien-so,7810517,"Cáp nối dài dây loa 2 đầu 3.5 dài 1m5 ( 1,5 mét ) - Hàng Nhập Khẩu",8950,8950,0,0
TIKI,thiet-bi-kts-phu-kien-so,122755113,"Cây chọt sim điện thoại, que chọc sim để sau ốp lưng dành cho iphone 5/5s/6/6plus/6s/6s plus/6/7/7plus/8/8plus/x/xs/xs max",3990,3990,0,0
TIKI,thiet-bi-kts-phu-kien-so,144465073,"Dây đeo điện thoại các hình (đeo cổ)",15000,15000,0,0
TIKI,thiet-bi-kts-phu-kien-so,192198514,"Pin sạc dự phòng không dây WEKOME tích hợp sạc nhanh PD20W + QC22.5W nhiều cổng 10000mAh 287 289 Hàng nhập khẩu",375000,375000,0,0
TIKI,thiet-bi-kts-phu-kien-so,192986165,"Đồng hồ Thông minh SOS Gọi điện thoại Định vị GPS Chống nước IP67 AMA Watch D06S cho Trẻ con 4 tuổi 5 tuổi 6 tuổi 7 tuổi 8 tuổi 9 tuổi 10 tuổi 11 tuổi Hàng nhập khẩu",950000,950000,0,0
TIKI,thiet-bi-kts-phu-kien-so,75434583,"Túi đựng điện thoại chống nước hình thú - Chính hãng",23750,25000,1250,5
TIKI,thiet-bi-kts-phu-kien-so,20647351,"GIÁ ĐỠ ĐIỆN THOẠI + IPAD",8900,8900,0,0
TIKI,thiet-bi-kts-phu-kien-so,176082185,"Ốp Lưng TPU trong suốt Siêu Mỏng Thinfit cho iPhone 13 / 13 Pro / 13 Pro Max - Hàng Chính Hãng",37990,37990,0,0
TIKI,thiet-bi-kts-phu-kien-so,184076146,"Loa bluetooth mini Remax RB-M7 tích hợp FM Radio, MIcroSD- Hàng chính hãng",630000,700000,70000,10
TIKI,thiet-bi-kts-phu-kien-so,144684441,"Ốp lưng kháng khuẩn Baseus Liquid Silica Gel Protective Case dành cho iPhone 13 Promax/ 13/ 13 Pro_ Hàng Chính Hãng",182000,274998,92998,34
TIKI,thiet-bi-kts-phu-kien-so,189386912,"SIM ĐẸP VIETTEL 09 TRẢ TRƯỚC - CHỌN SỐ - NGHE GỌI - 4G - MỚI 100% - HÀNG CHÍNH HÃNG",129000,129000,0,0
TIKI,thiet-bi-kts-phu-kien-so,33755957,"Ốp lưng dành cho Vsmart Live silicone dẻo trong siêu bền",20000,20000,0,0
TIKI,thiet-bi-kts-phu-kien-so,48693427,"loa phóng thanh loại tốt có khe usb và thẻ nhớ",159000,159000,0,0
TIKI,thiet-bi-kts-phu-kien-so,3159365,"Bộ 2 Tay Cầm Chơi Game Đôi Controller Cho PC - Hàng Nhập Khẩu",134900,134900,0,0
TIKI,thiet-bi-kts-phu-kien-so,67056051,"Giá Đỡ Để Bàn Điện Thoại Máy Tính Bảng Ipad Hợp Kim Nhôm ABS Cao Cấp Nâng Hạ - Xoay Tròn - Điều Chỉnh Góc Độ - KT 95x95x20 Cm - Hàng Chính Hãng",178000,178000,0,0
TIKI,thiet-bi-kts-phu-kien-so,14852255,"Đầu thu bluetooth receiver tạo kết nối âm thanh 4.1",34296,34296,0,0
TIKI,thiet-bi-kts-phu-kien-so,152709645,"Bao Da Cover Cho Máy Tính Bảng Xiaomi Mi Pad 5 / Mi Pad 5 Pro 2021 11 Inch Hỗ Trợ Smart Cover Gấp 3",129000,129000,0,0
TIKI,thiet-bi-kts-phu-kien-so,67930401,"Tai Nghe Gaming Rapoo VH310 Virtual 7.1 - Hàng Chính Hãng",429000,429000,0,0
TIKI,thiet-bi-kts-phu-kien-so,59205693,"Dây thay thế cho Xiaomi Miband 5 Mijobs kim loại nhuyễn TF, Nam Châm - Hàng Nhập Khẩu",89000,89000,0,0
TIKI,thiet-bi-kts-phu-kien-so,162590649,"Đài Fm ĐẠI CÁT-515 Japan- thẻ nhớ, usb, nghe đài Radio trên sóng FM được thiết kế nhỏ gọn-Hàng CHính Hãng",210000,210000,0,0
TIKI,thiet-bi-kts-phu-kien-so,56943532,"Tai nghe Nhét Tai Dành Cho Samsung Note 10/ 10 Plus - Jack Cắm Type C - Trắng",185000,185000,0,0
TIKI,thiet-bi-kts-phu-kien-so,15267057,"Bút Trình Chiếu Laser Vesine VP-101 Hàng Nhập Khẩu",99560,104800,5240,5
TIKI,thiet-bi-kts-phu-kien-so,15656690,"Giá đỡ điện thoại trên khe gió ô tô cao cấp",39000,48000,9000,19
TIKI,thiet-bi-kts-phu-kien-so,58575948,"Ốp lưng cho Xiaomi Redmi Note 9 - Redmi 10X 4G gương cứng 2 màu Gradient Ver 2 , viền TPU dẻo đen",69000,69000,0,0
TIKI,thiet-bi-kts-phu-kien-so,58019622,"Cáp chuyển Type C ra 4 cổng USB - HUB USB Type c to 4 Port USB",82000,97000,15000,15
TIKI,thiet-bi-kts-phu-kien-so,13625297,"Cáp chuyển Usb Type C sang VGA",79900,79900,0,0
TIKI,thiet-bi-kts-phu-kien-so,165032162,"Ốp lưng dành cho Samsung Galaxy S21 FE Rugged Shield Cao Cấp - Hàng Nhập Khẩu",95998,95998,0,0
TIKI,thiet-bi-kts-phu-kien-so,14790642,"Tai nghe Bluetooth nhét tai không dây SS315",33800,33800,0,0
TIKI,thiet-bi-kts-phu-kien-so,43067527,"Ốp lưng da cao cấp dành cho iPhone 11 Pro Max - Màu nâu",122000,199000,77000,39
TIKI,thiet-bi-kts-phu-kien-so,74456975,"Ốp Lưng Silicon TPU trong suốt GOR cho iPhone 12 Mini / 12 / 12 Pro / 12 Pro Max - Hàng Nhập Khẩu",38000,79998,41998,52
TIKI,thiet-bi-kts-phu-kien-so,169331126,"Kính cường lực cho Samsung S21 FE 5G nhám Chống vân tay/ Chống nhìn trộm/ Full màn hình/ Không viền màu/ Ốp chống sốc",30000,30000,0,0
TIKI,thiet-bi-kts-phu-kien-so,41256946,"Ốp lưng dẻo chống sốc cao cấp dành cho iPhone 11 - Màu đen mờ",49000,49000,0,0
TIKI,thiet-bi-kts-phu-kien-so,161216600,"Ốp bảo vệ tai nghe Gà Trống dành cho case airpod 1/2/Pro /3 chống va đập",50000,50000,0,0
TIKI,thiet-bi-kts-phu-kien-so,11241276,"Dây cáp HDMI tròn ( 3m )",24000,24000,0,0
TIKI,thiet-bi-kts-phu-kien-so,32895068,"Bao Da Case Cover Cho Máy Đọc Sách Kindle 2019 (All New Kindle 2019 10th) Màu Xanh",159000,159000,0,0
TIKI,thiet-bi-kts-phu-kien-so,2528827,"Tai nghe nhét tai earphone Langsdom JM26 Super Bass cho điện thoại android/iphone/ipad (đen) - hàng chính hãng",43000,43000,0,0
TIKI,thiet-bi-kts-phu-kien-so,51718870,"Chân đế kẹp Micro NB35 tặng kèm màng lọc âm (chuyên dành cho phòng thu âm)",101920,115080,13160,11
TIKI,thiet-bi-kts-phu-kien-so,32160250,"Giá đỡ 3 chân đa năng siêu cao 2 mét gắn đèn led, gắn điện thoại, máy tính bảng hỗ trợ livestream, quay video",68340,68340,0,0
TIKI,thiet-bi-kts-phu-kien-so,52235985,"Cáp Chuyển Đổi Mini Displayport To HDMI, VGA, DVI",162000,167200,5200,3
TIKI,thiet-bi-kts-phu-kien-so,140523443,"Chuột Bluetooth Dareu LM115B Pink (Màu Hồng) - Kết Nối Điện Thoại, iPad, Macbook - Hàng Chính Hãng",265000,265000,0,0
TIKI,thiet-bi-kts-phu-kien-so,80950282,"Ốp lưng chống sốc trong suốt siêu mỏng cho iPhone 12 Pro Max (6.7 inch) bảo vệ camera hiệu Likgus Crashproof giúp chống chịu mọi va đập - hàng nhập khẩu",79999,79999,0,0
TIKI,thiet-bi-kts-phu-kien-so,17533229,"Bao Da Smart Case Gen2 TPU Dành Cho iPad Mini 5 - Hàng nhập khẩu",101000,257998,156998,61
TIKI,thiet-bi-kts-phu-kien-so,44836348,"Ốp lưng da vải kiêm ví cao cấp dành cho iPhone 11 Pro",69000,119000,50000,42
TIKI,thiet-bi-kts-phu-kien-so,54889765,"Baseus LV106-B01 Đầu Chuyển OTG USB Type C Sang USB | Chính hãng Baseus",84499,84499,0,0
TIKI,thiet-bi-kts-phu-kien-so,7690576,"Dây cáp loa 3.5mm to AV 2 RCA Audio",4900,4900,0,0
TIKI,thiet-bi-kts-phu-kien-so,137118482,"SIM 4G VINAPHONE 500GB/THÁNG - U1500 KHÔNG GIỚI HẠN DATA ( CÓ 500Gb/tháng tốc độ 4G, hết vẫn tiếp tục dùng KHÔNG GIỚI HẠN DUNG LƯỢNG với tốc độ cao 5Mbps) - Hàng chính hãng",990000,990000,0,0
TIKI,thiet-bi-kts-phu-kien-so,68535273,"KỆ Ampli - Cục Đẩy Loại Nhỏ 50CM",390000,390000,0,0
TIKI,thiet-bi-kts-phu-kien-so,156205354,"Jack Cắm 2 Đầu 3.5mm - Dây Cáp Âm Thanh AUX 2 Đầu 3.5mm - Cáp Dù Siêu Bền",16731,16900,169,1
TIKI,thiet-bi-kts-phu-kien-so,113768961,"Giá Kẹp Đọc Sách Chống Cận Giá Đỡ Ipad Điều Chỉnh 180",180000,180000,0,0
TIKI,thiet-bi-kts-phu-kien-so,174593799,"Chuột Bluetooth Không Dây PIX-LINK  P90A Wireless USB Tự Sạc Pin Siêu Mỏng, Chống Ồn - Hàng Chính Hãng",116000,229000,113000,49
TIKI,thiet-bi-kts-phu-kien-so,129586149,"Dây Audio chuyển tai nghe 3.5mm đầu cái sang 2 đầu Mic và Tai nghe đầu đực mạ vàng dài 20CM UGREEN AV140 20899,20897 hàng chính hãng",92000,92000,0,0
TIKI,thiet-bi-kts-phu-kien-so,8130816,"Bộ Chuyển Âm Thanh TV 4K Quang Optical Sang Audio AV Ra Amply + Cáp Optical (1m)",74000,74000,0,0
TIKI,thiet-bi-kts-phu-kien-so,36189773,"Chuột Bluetooth không dây loại xịn ADGX2 kết nối qua cổng USB không dây và Bluetooth đều được 2 trong 1 - Hàng nhập khẩu",75800,75800,0,0
TIKI,thiet-bi-kts-phu-kien-so,203734,"Chuột Không Dây Logitech M325 - Hàng Chính Hãng",432000,432000,0,0
TIKI,thiet-bi-kts-phu-kien-so,57518181,"Webcam HYSJ A849S cho máy tính - hàng nhập khẩu",150000,150000,0,0
TIKI,thiet-bi-kts-phu-kien-so,19611388,"Cáp Chuyên Đổi USB Ra Tai nghe Và Mic 7.1 Cao Cấp AZONE - Hàng Nhập Khẩu",35900,35900,0,0
TIKI,thiet-bi-kts-phu-kien-so,56879851,"Chuột Quang MACRO HXJS J900 RGB Bề Mặt Lưới Xuyên Thấu Cực Đẹp DPI 6400 - Hàng chính hãng",299000,399000,100000,25
TIKI,thiet-bi-kts-phu-kien-so,23044885,"Đồng hồ cà chua Pomodoro - Tối ưu hóa hiệu quả làm việc của bạn",41000,41000,0,0
TIKI,thiet-bi-kts-phu-kien-so,14011811,"Loa Bluetooth mini BS-01 - Loa Bluetooth Thời Trang Nhỏ Gọn ( Màu Ngẫu Nhiên )",119999,119999,0,0
TIKI,thiet-bi-kts-phu-kien-so,35223515,"Cáp máy in 5M chống nhiễu cao cấp",44900,44900,0,0
TIKI,thiet-bi-kts-phu-kien-so,50586261,"Hub chia 1 ra 3 cổng USB",79000,79000,0,0
TIKI,thiet-bi-kts-phu-kien-so,165519983,"Dán cường lực Zeelot Pure Shield Glass Cho Galaxy Tab S8/ S8 Plus/ S8 Ultra - Hàng Chính Hãng",450000,450000,0,0
TIKI,thiet-bi-kts-phu-kien-so,84883551,"Tay cầm chơi game không dây E-dra EGP7601 Bluetooth/Receiver  - Hàng Chính Hãng",459000,459000,0,0
TIKI,thiet-bi-kts-phu-kien-so,196478933,"Tai Nghe Bluetooth True Wireless Cảm Ứng Không Dây TCT-HGD-X10 Dung Lượng Pin Lớn-Điều Chỉnh Âm Lượng - Hàng Chính Hãng",599000,599000,0,0
TIKI,thiet-bi-kts-phu-kien-so,196479355,"Tai Nghe Bluetooth True WIreless TWS Cảm Ứng TCT-S18 Chống Ồn ENC - Mic Đàm Thoại- Chế Độ Nhạc vs Gaming - Điều Chỉnh Tăng Giảm Âm Lượng - Hàng Chính Hãng",599000,800000,201000,25
TIKI,thiet-bi-kts-phu-kien-so,5993887,"Dây cáp DisplayPort 2 đầu đực tốc độ 21.6Gbps dài 3M UGREEN DP102 10212 - Hàng Chính Hãng",190000,190000,0,0
TIKI,thiet-bi-kts-phu-kien-so,76551611,"Miếng Dán Kính Cường Lực Camera chống trầy GOR cho iPhone 12 Mini / 12 / 12 Pro / 12 Pro Max (Bộ 2 Miếng) - Hàng Nhập Khẩu",65994,65994,0,0
TIKI,thiet-bi-kts-phu-kien-so,101847035,"Loa Bluetooth Không Dây Cao Cấp XSmart A36 PRO BASS 2021 Âm Thanh Nghe Nhạc Siêu Đã Tương Thích Điện Thoại Máy Tính Laptop Tivi - Hàng Chính Hãng",179000,179000,0,0
TIKI,thiet-bi-kts-phu-kien-so,72295922,"Bàn Phím LED LANGTU L1 Black - hàng nhập khẩu",346000,346000,0,0
TIKI,thiet-bi-kts-phu-kien-so,105513634,"Tai Nghe Bluetooth Tai Nghe Cảm Ứng Không Dây Wireless Headset - Hàng Chính Hãng PKCB",200000,500000,300000,60
TIKI,thiet-bi-kts-phu-kien-so,20265205,"Bao Da Cover Cho Máy Tính Bảng Samsung Galaxy Tab A 10.1 (2019) T510 / T515 Hỗ Trợ Smart Cover",129000,129000,0,0
TIKI,thiet-bi-kts-phu-kien-so,2292695,"Ốp lưng iPhone 7 plus / iPhone 8 Plus dẻo trong suốt mỏng 0.6mm chống trầy xước",29000,29000,0,0
TIKI,thiet-bi-kts-phu-kien-so,92084797,"Củ Sạc Adapter Baseus Super Si 20W Mini Type C Blue - PD/QC 3.0 - Tự Động Điều Chỉnh Ổn Định Dòng Điện - Hàng Chính Hãng",149000,149000,0,0
TIKI,thiet-bi-kts-phu-kien-so,20206058,"Bao Da Cover Cho Apple Ipad Mini 4 Mini 5 2019 Hỗ Trợ Smart Cover Gấp Chéo",160000,160000,0,0
TIKI,thiet-bi-kts-phu-kien-so,195134097,"Ốp lưng chống sốc cho Samsung Galaxy Z Fold 3 hiệu Likgus Glitter siêu mỏng 1.5mm độ trong tuyệt đối, chống trầy xước, chống ố vàng, tản nhiệt tốt - hàng nhập khẩu",108999,108999,0,0
TIKI,thiet-bi-kts-phu-kien-so,33577507,"Ốp lưng silicon dẻo trong suốt dành cho SamSung Galaxy A50s siêu mỏng 0.5 mm",17000,17000,0,0
TIKI,thiet-bi-kts-phu-kien-so,33552972,"Chân Giá Đỡ Kẹp Micro",74420,74420,0,0
TIKI,thiet-bi-kts-phu-kien-so,56248615,"Dây Đeo Thay Thế Cho Vòng Đeo Tay Thông Minh Xiaomi Mi Band 3 Mi Band 4 - Hàng Chính Hãng",28000,90000,62000,69
TIKI,thiet-bi-kts-phu-kien-so,129728635,"Pad da dành cho tai nghe beats studio 3 - mút cao cấp",290000,290000,0,0
TIKI,thiet-bi-kts-phu-kien-so,174665988,"Bộ Bàn Phím Và Chuột Không Dây Wireless Microsoft 850 - PY9-00018 - Hàng Chính Hãng",599000,890000,291000,33
TIKI,thiet-bi-kts-phu-kien-so,16051164,"Vô Lăng Logitech G29 Kèm Cần Số Rời - Hàng chính hãng",7700000,7999000,299000,4
TIKI,thiet-bi-kts-phu-kien-so,97968242,"Đồng hồ thông minh trẻ em Q20, Lắp sim nghe gọi, định vị trẻ, chụp ảnh, giao diện Tiếng Việt - Hàng Nhập Khẩu",223000,223000,0,0
TIKI,thiet-bi-kts-phu-kien-so,56458881,"Giá Đở Điện Thoại Và Máy Tính Bảng",13998,13998,0,0
TIKI,thiet-bi-kts-phu-kien-so,120462537,"CÁP MÁY IN CHỐNG NHIỄU LOẠI TỐT CHUẨN USB 2.0 CHIỀU DÀI 1,5M / 3M /5M",10000,10000,0,0
TIKI,thiet-bi-kts-phu-kien-so,140376071,"Tai nghe bluetooth True Wireless thiết kế retro Remax TWS-38 - Hàng chính hãng",550000,990000,440000,44
TIKI,thiet-bi-kts-phu-kien-so,117927658,"Máy chơi game cầm tay 4 nút Game stick 4k HDMI PS3000 kết nối không dây 3500 trò chơi",560000,580000,20000,3
TIKI,thiet-bi-kts-phu-kien-so,110948021,"Tai nghe HiFi Headphone có dây siêu nhẹ Remax RM-595 [Hàng chính hãng",230050,330000,99950,30
TIKI,thiet-bi-kts-phu-kien-so,112055244,"Đầu ngòi thay thế cho bút Apple Pencil 1/ Pencil 2 - Dùng như ngòi gốc Apple pencil tips_ Hàng Chính Hãng",89000,99000,10000,10
TIKI,thiet-bi-kts-phu-kien-so,117091126,"Bao da kèm bàn phím Bluetooth dành cho Samsung Galaxy Tab S7 FE cao cấp - Hàng nhập khẩu",550000,550000,0,0
TIKI,thiet-bi-kts-phu-kien-so,50254961,"Ốp lưng dẻo cho Samsung Galaxy S20 Plus hiệu Nillkin mỏng 0.6mm, chống trầy xước - Hàng chính hãng",88000,88000,0,0
TIKI,thiet-bi-kts-phu-kien-so,418636,"Webcam Logitech C270 720P - Hàng chính hãng",475000,475000,0,0
TIKI,thiet-bi-kts-phu-kien-so,120348071,"Quạt tản nhiệt điện thoại gaming SIDOTECH FL1 / FL5 / DL5 / DL6 ( 2 phiên bản sò lạnh và quạt gió) làm mát hạ nhiệt nhanh khi chơi game bị nóng phù hợp cho game thủ mobile Liên Quân Tốc Chiến FF PUBG - Hàng Chính Hãng",156000,156000,0,0
TIKI,thiet-bi-kts-phu-kien-so,135350327,"Giá Đỡ Kiêm Đế Kẹp Nhôm Dựng Đứng Hai Khe Dành Cho Laptop Macbook Ipad Surface Điều Chỉnh Được Độ Rộng – Hàng Chính Hãng",289000,289000,0,0
TIKI,thiet-bi-kts-phu-kien-so,137032276,"Mixer F4 Pro - Tích hợp vang số 16 chế độ vang- Chuyển đổi thành soundcard livestream karaoke",799000,799000,0,0
TIKI,thiet-bi-kts-phu-kien-so,155287338,"Ốp lưng cho Xiaomi 11T - 11T Pro chống sốc trong viền nhựa dẻo XunDD - Hàng nhập khẩu",99000,99000,0,0
TIKI,thiet-bi-kts-phu-kien-so,4268915,"Chân đế tản nhiệt laptop",11800,11800,0,0
TIKI,thiet-bi-kts-phu-kien-so,20201745,"Giá Đỡ Điện Thoại Kim Loại Siêu Đẹp",18700,18700,0,0
TIKI,thiet-bi-kts-phu-kien-so,72455227,"Ốp lưng chống sốc lưng trong cao cấp dành cho",149000,199000,50000,25
TIKI,thiet-bi-kts-phu-kien-so,71088250,"Củ Sạc Điện Thoại 30W 1 Cổng USB Và 1 Type-C PD 18W RAVPower RP-PC132 - Hàng Chính Hãng",349000,550000,201000,37
TIKI,thiet-bi-kts-phu-kien-so,33762008,"Miếng Dán Kính Cường Lực Cho Iphone 11 - Màu Đen - Full Màn Hình - Hàng Chính Hãng",26999,53998,26999,50
TIKI,thiet-bi-kts-phu-kien-so,141418529,"Ốp iPhone 13 pro max/ 12 trong suốt chống sốc đệm khí 4 góc",80590,150000,69410,46
TIKI,thiet-bi-kts-phu-kien-so,165600360,"Bộ sạc Samsung 45W - T4510  màu đen - Kèm cáp Type C  5A,  dài 1.8m - Hàng Chính Hãng",599000,599000,0,0
TIKI,thiet-bi-kts-phu-kien-so,97030109,"Tai Nghe Chống Ồn XSmart QKZ AK6 PRO Bass Siêu Khủng, Âm Thanh Cực Đỉnh, Giải Trí Chơi Game Siêu Thích - Hàng Chính Hãng",119000,119000,0,0
TIKI,thiet-bi-kts-phu-kien-so,3159363,"Tay Cầm Chơi Game Đơn Cho PC Vibration Joypad - Hàng Nhập Khẩu",63900,63900,0,0
TIKI,thiet-bi-kts-phu-kien-so,142419605,"Bao Case Ốp Mèo Lucky dành cho Airpods 1&2 / Airpods Pro / AirPods 3",149000,149000,0,0
TIKI,thiet-bi-kts-phu-kien-so,159604316,"Combo Củ Sạc Nhanh Type-C 25W RAVPower RP-PC156-B Và Cáp C to Light.ning MFI C94 Sạc Nhanh 20W Cho iPhone, Cho iPad RP-CB1017 - Hành Chính Hãng",529000,890000,361000,41
TIKI,thiet-bi-kts-phu-kien-so,42351698,"Túi chống sốc cho pin sạc dự phòng (dạng rút) màu xám - Hàng chính hãng",50000,50000,0,0
TIKI,thiet-bi-kts-phu-kien-so,188114301,"Ốp lưng dẻo cho Samsung Galaxy A52S 5G (đen) bảo vệ Camera",35000,35000,0,0
TIKI,thiet-bi-kts-phu-kien-so,7090463,"Loa Bluetooth Anker SoundCore Motion B - A3109011",890000,1400000,510000,36
TIKI,thiet-bi-kts-phu-kien-so,14116324,"Dây cáp máy in 5M (Đen)",23900,23900,0,0
TIKI,thiet-bi-kts-phu-kien-so,249936991,"Bộ điều khiển thông minh Google Chromecast with Google TV - Hàng Nhập Khẩu",1390000,1590000,200000,13
TIKI,thiet-bi-kts-phu-kien-so,98653521,"Miếng dán màn hình kính cường lực cho iPad Pro 11 inch 2021/2022 hiệu Nillkin Amazing H+ (mỏng 0.2 mm, vát cạnh 2.5D, chống trầy, chống va đập) - Hàng Chính Hãng",199992,399984,199992,50
TIKI,thiet-bi-kts-phu-kien-so,173786567,"Ốp điện thoại dành cho iphone 13 promax, 13,12 promax,12,12 pro, 11 promax, 11, Xsmax, X, Xs, 8plus, 7plus,6plus_A161",70000,70000,0,0
TIKI,thiet-bi-kts-phu-kien-so,95995050,"Tai nghe True Wireless Energizer UB2609 Bluetooth V5.0 - tích hợp sạc dự phòng, kháng nước - HÀNG CHÍNH HÃNG",600000,1200000,600000,50
TIKI,thiet-bi-kts-phu-kien-so,2246543,"Máy Nghe Nhạc Mp3 Ruizu X02 (Trắng) - Hàng Chính Hãng",410000,410000,0,0
TIKI,thiet-bi-kts-phu-kien-so,160797845,"Cáp Sạc Cho iPhone, iPad Hoco X14 - Cáp Sạc Dây Dù Siêu Bền - Dài 1M/2M - Hàng Chính Hãng",38000,40000,2000,5
TIKI,thiet-bi-kts-phu-kien-so,179230827,"Ốp Lưng Màu Cao Cấp Cho SamSung Galaxy A73 5G , A53 5G, A33, A23 4G, A13 4G/5G Dẻo Silicon Bảo Vệ Camera Sau",26000,26000,0,0
TIKI,thiet-bi-kts-phu-kien-so,54021862,"Chuột Không Dây Gaming Led Siêu Đẹp FREE WOLF X13 Pin Sạc Dùng Siêu Trâu Chuột Máy Tính Không Dây Đẹp- 4089-Hàng Nhập Khẩu (màu ngẫu nhiên)",174000,199000,25000,13
TIKI,thiet-bi-kts-phu-kien-so,111857937," Đài FM Caraven836S  đài nghe nhạc niệm Phật. Thẻ nhớ mp3 cho người già",155000,155000,0,0
TIKI,thiet-bi-kts-phu-kien-so,41799459,"Chuột Chơi Game Asus TUF Gaming M3 RGB gaming mouse with 7000-dpi - Hàng Chính Hãng",449000,449000,0,0
TIKI,thiet-bi-kts-phu-kien-so,57825125,"Chuột Không Dây Kiểu Đứng HXSJ T24X, Chống Mỏi Tay 2400DPI - Hàng chính hãng",249000,490000,241000,49
TIKI,thiet-bi-kts-phu-kien-so,58943519,"Cáp Chuyển Đổi Belkin từ USB Type-C Sang HDMI / USB Type-C PD 60W - Hàng Chính Hãng",495000,990000,495000,50
TIKI,thiet-bi-kts-phu-kien-so,73622188,"Kẹp Dán Cố Định Dây Cáp, Dây Sạc Điện Thoại - Hàng Chính Hãng",30000,99000,69000,70
TIKI,thiet-bi-kts-phu-kien-so,72633695,"Túi phụ kiện điện thoại, túi công nghệ khung cứng chống sốc chuyên dụng đựng ổ cứng, pin sạc dự phòng, bộ sạc tai nghe có quai xách",215000,215000,0,0
TIKI,thiet-bi-kts-phu-kien-so,141122603,"Pad Chuột Logitech Desk Mat Studio Series - Hàng Chính Hãng",440000,440000,0,0
TIKI,thiet-bi-kts-phu-kien-so,174851864,"Ốp lưng cho Xiaomi Redmi Note 11 Pro 4G 5G quốc tế Nillkin CamShield che camera - hàng nhập khẩu",149000,149000,0,0
TIKI,thiet-bi-kts-phu-kien-so,13325997,"Tay Cầm chơi game cho Laptop và PC cổng USB - Hàng Nhập Khẩu",73100,73100,0,0
TIKI,thiet-bi-kts-phu-kien-so,56078205,"Ốp lưng dành cho Samsung A50 / A50s mẫu Ngày Bình An",42000,55000,13000,24
TIKI,thiet-bi-kts-phu-kien-so,21147349,"Tay Cầm Chơi Game Không Dây Cho PC / Xbox360 / Android TV / Smartphone/ Laptop 850M",177555,186900,9345,5
TIKI,thiet-bi-kts-phu-kien-so,34177220,"Bộ gộp-chia HDMI 2 chiều hỗ trợ 4K2K@30Hz hàng chính hãng Ugreen mã UG-50966",249000,249000,0,0
TIKI,thiet-bi-kts-phu-kien-so,160418295,"Dock Sạc Dành Cho Samsung Galaxy Watch 4",199000,199000,0,0
TIKI,thiet-bi-kts-phu-kien-so,31602057,"Tai Nghe Nhét Tai Dùng Cho Các Dòng Điện Thoại OPPO âm thanh trung thực âm bass mạnh mẽ độ bền cao",22700,22700,0,0
TIKI,thiet-bi-kts-phu-kien-so,97036830,"Tai Nghe Gaming 2021 Chống Ồn Cao Cấp XSmart GH5 Gamer Pro Phiên Bản Nâng Cấp sendem S2 , Tặng Bộ Phụ Kiện Mic Rời - Hàng Chính Hãng",189000,189000,0,0
TIKI,thiet-bi-kts-phu-kien-so,72850683,"cáp USB Type-C ra Micro USB 2 đầu đực Ugreen 243CT50444US 1m màu đen hàng chính hãng",126000,126000,0,0
TIKI,thiet-bi-kts-phu-kien-so,35716768,"Cáp chuyển USB ra HDMI có âm thanh UTH1080 - FullHD (Đen)",178990,178990,0,0
TIKI,thiet-bi-kts-phu-kien-so,111726388,"Đầu bút thay thế ngòi cao cấp dành cho Apple Pencil 1, 2 - Apple Pencil Tips_ Hàng Chính Hãng",58000,64000,6000,9
TIKI,thiet-bi-kts-phu-kien-so,182797700,"Miếng dán kính cường lực full màn hình cho điện thoại Xiaomi Redmi 10C, bảo vệ màn hình chống trầy xước",23787,23787,0,0
TIKI,thiet-bi-kts-phu-kien-so,193771445,"Ốp Lưng dành cho Samsung Galaxy Z Flip 4 5G RINGKE Slim - Hàng Chính Hãng",274000,274000,0,0
TIKI,thiet-bi-kts-phu-kien-so,210427335,"Takstar E300W- Tặng túi rút đựng máy trợ giảng - Máy Trợ Giảng Không Dây UHF, Kết Nối Bluetooth, Công Suất 10W Cho Giáo Viên, Bán Hàng- Hàng chính hãng",990000,990000,0,0
TIKI,thiet-bi-kts-phu-kien-so,58884030,"Giá đỡ kẹp điện thoại, máy tính bảng Vocal Stents để bàn đế tròn",116880,116880,0,0
TIKI,thiet-bi-kts-phu-kien-so,6411193,"Cáp chuyển đổi mini HDMI đực sang HDMI cái dài 25CM UGREEN 20137 - Hàng Chính Hãng",89000,89000,0,0
TIKI,thiet-bi-kts-phu-kien-so,135347317,"Bao Da Cover Cho Máy Tính Bảng Lenovo Tab P11 / P11 Plus 11 Inch TB-J606 / TB-J607 Hỗ Trợ Smart Cover",139000,139000,0,0
TIKI,thiet-bi-kts-phu-kien-so,159971506,"Bàn phím cơ Newmen GE87 TKL N-Box Outemu Switch - Hàng chính hãng",459000,459000,0,0
TIKI,thiet-bi-kts-phu-kien-so,40691443," Bộ Vệ Sinh Laptop, Máy Tính Bảng, Điện Thoại",14900,14900,0,0
TIKI,thiet-bi-kts-phu-kien-so,37318109,"Miếng Lót Chuột Liên Minh Huyền Thoại 80 x 30 cm",38500,38500,0,0
TIKI,thiet-bi-kts-phu-kien-so,105613083,"Cáp loa 1 đầu jack 3.5 ra 2 đầu AV hoa sen dài 1.8M 3M 5M 10M 15M cao cấp (dây loa 1 ra 2)",28000,28000,0,0
TIKI,thiet-bi-kts-phu-kien-so,158461967,"Tai nghe bluetooth, tai nghe chụp tai mèo đáng yêu có mic đàm thoại và đèn LED headphone bluetooth dùng được cho cả điện thoại, laptop, máy tính 5Tech hàng chính hãng",189000,189000,0,0
TIKI,thiet-bi-kts-phu-kien-so,72127109,"Dây Cao Su Cho Galaxy Watch 3 41mm / 45mm (Dây Size 20mm và 22mm)",85000,85000,0,0
TIKI,thiet-bi-kts-phu-kien-so,130269035,"Củ sạc nhanh Baseus compact quick charger 3 cổng 2A1C 30W- hàng chính hãng",299000,299000,0,0
TIKI,thiet-bi-kts-phu-kien-so,79600205,"Thiết Bị Chuyển Đổi Ethernet Adapter ROBOT EA10 USB 2.0 to LAN Tốc Độ  10/100Mbps - Hàng chính hãng",199000,199000,0,0
TIKI,thiet-bi-kts-phu-kien-so,98262037,"GIÁ ĐỠ KẸP ĐIỆN THOẠI GẮN XE MÁY INOX C2 CHỐNG RUNG, CHỐNG CƯỚP GIẬT",39900,39900,0,0
TIKI,thiet-bi-kts-phu-kien-so,91909097,"Bàn Phím Cơ chuyên GAME EDRA EK384 - Keycaps PBT - LED RGB - Hàng Chính Hãng",799000,799000,0,0
TIKI,thiet-bi-kts-phu-kien-so,121242259,"Chuột có dây Dell MS116-Hàng chính hãng",88000,88000,0,0
TIKI,thiet-bi-kts-phu-kien-so,82033657,"Bao Da Case Cover Dành Cho iPad Mini 5/ iPad Pro 11 inch/ iPad Air 3 / iPad Pro 3/ iPad Air 4 / iPad 7/8 / iPad Pro 12.9 inch - Hàng Chính Hãng Có Khe Cắm Apple Pencil",99000,99000,0,0
TIKI,thiet-bi-kts-phu-kien-so,89625320,"Cáp gộp Audio và mic ra 1 cổng 3.5mm",19000,19000,0,0
TIKI,thiet-bi-kts-phu-kien-so,144278436,"Miếng dán cường lực trong suốt dành cho Samsung A03s/ A02s/ A12",15000,15000,0,0
TIKI,thiet-bi-kts-phu-kien-so,191719745,"Loa Bluetooth Marshall Willen Portable - Hàng chính hãng",2649000,2790000,141000,5
TIKI,thiet-bi-kts-phu-kien-so,6082263,"Bộ USB thu bluetooth cho dàn amly ra loa",41899,41899,0,0
TIKI,thiet-bi-kts-phu-kien-so,191809663,"Sạc dự phòng không dây từ tính Remax RPP-281 dung lượng 10000mAh kèm cáp sạc nhanh 2 chiều tiện lợi - Hàng chính hãng",753500,990000,236500,24
TIKI,thiet-bi-kts-phu-kien-so,70820558,"Ốp cho Samsung Galaxy Note 10 Plus - Silicon trong suốt hãng GOR Hàng nhập khẩu",39000,39000,0,0
TIKI,thiet-bi-kts-phu-kien-so,77125504,"Bàn Phím Không Dây Đa Năng HiBow - Hàng Chính Hãng",190000,190000,0,0
TIKI,thiet-bi-kts-phu-kien-so,101530842,"Pin Sạc Dự Phòng Xiaomi Redmi 20000mAh sạc nhanh 18W - Hàng chính hãng",550000,550000,0,0
TIKI,thiet-bi-kts-phu-kien-so,49625458,"Bút trình chiếu laser giảng dạy, thuyết trình không dây R400",117000,117000,0,0
TIKI,thiet-bi-kts-phu-kien-so,58875726,"SIM 4G Mobifone VPB51 Tặng 500GB/Tháng",750000,750000,0,0
TIKI,thiet-bi-kts-phu-kien-so,112020137,"Tai nghe Samsung AKG giắc cắm Type C cho máy  Fold / Flip / Note 10, Note 20, S20, S21 - Hàng chính hãng",479000,479000,0,0
TIKI,thiet-bi-kts-phu-kien-so,114699896,"Kê tay gỗ Óc Chó HyperWork Màu Nâu Đậm - Hàng Chính Hãng",221000,260000,39000,15
TIKI,thiet-bi-kts-phu-kien-so,59090334,"Pin Sạc Dự Phòng RAVPower 20000mAh Quick Charge 3.0 + PD 60W, In/Out Type-C, Sạc Được Macbook - RP-PB201 - Hàng Chính Hãng",1190000,1690000,500000,30
TIKI,thiet-bi-kts-phu-kien-so,14707617,"Bộ chuyển VGA to HDMI (Có Adapter)",62000,66200,4200,6
TIKI,thiet-bi-kts-phu-kien-so,169925849,"Hộp Đựng Linh Kiện 36 Ngăn",42000,42000,0,0
TIKI,thiet-bi-kts-phu-kien-so,167419581,"Tấm Da Lót Bàn Làm Việc Lót Chuột Văn Phòng",99000,99000,0,0
TIKI,do-choi-me-be,77032355,"Bài Poker Texas Hold'em Hold em Siêu bền siêu đàn hồi",90000,90000,0,0
TIKI,do-choi-me-be,47170208,"Set đồ bơi bé trai dài tay cá tròn, vải bơi co giãn 4 chiều, có mũ bơi | BT13",210000,210000,0,0
TIKI,do-choi-me-be,183375257,"Bộ Đồ Chơi Khoa Học Tự Làm Máy Bay Vận Tải, Bộ Đồ Chơi Lắp Ghép STEM Máy Bay Vận Tải F-12, Bộ Đồ Chơi Gỗ Cao Cấp Khoa Học Tự Làm DIY Wood Steam-Chính Hãng BABYBOSS + Tặng Kèm Tranh Ghép Gỗ.",55000,65000,10000,15
TIKI,do-choi-me-be,112232071,"Thau tắm, bồn tắm, chậu tắm cho bé gấp gọn từ 0-10 tuổi, có 2 nấc, có rãnh cắm vòi sen tiện lợi cho bé (loại lớn dày)",689000,894000,205000,23
TIKI,do-choi-me-be,51928840,"Sữa tắm gội toàn thân cho bé Sebamed pH5.5 - SBB08",199000,239000,40000,17
TIKI,do-choi-me-be,197656014,"Bình sữa Pigeon PPSU Plus thế hệ III phiên bản Nhật hình Gấu 160ml/240ml",364000,438000,74000,17
TIKI,do-choi-me-be,197656233,"Bình sữa Pigeon PPSU Plus thế hệ III phiên bản Nhật hình Cây 160ml/240ml",351000,438000,87000,20
TIKI,do-choi-me-be,135562551,"Bảng bận rộn 6 mặt cho bé",121500,135000,13500,10
TIKI,do-choi-me-be,144250902,"Cây xương rồng nhảy múa 120 bài hát có đèn, Xương rồng biết nói nhại tiếng vui nhộn cho bé",68900,68900,0,0
TIKI,do-choi-me-be,3784615,"Bài Mèo Nổ 06020 KA521",90000,159000,69000,43
TIKI,do-choi-me-be,145640853,"Nệm/ Đệm Cũi Cho Bé Dùng Cho Nhiều Kích Thước Cũi Đa Năng - Chất Liệu Nệm Bông Ép 5cm Hoặc Mút Trứng 7cm - Nệm Vỏ Có Khoá Kéo Tiện Lợi",140000,140000,0,0
TIKI,do-choi-me-be,76167120,"Chắn giường, chặn giường UMOO thanh trượt 01 bên an toàn cho bé, bản Nâng cấp 2020, Màu Ghi Xám sang trọng",99000,99000,0,0
TIKI,do-choi-me-be,152005911,"Quần Áo Trẻ Em, Quần Áo Trẻ Em Thu Đông Cá Tính Dễ Thương Cho Bé 16-40KG",195000,195000,0,0
TIKI,do-choi-me-be,58222108,"Xe chòi chân thăng bằng đa năng BABY kết hợp xe đạp 3 bánh cho bé tập đi (nhiều màu sắc lựa chọn)",198000,198000,0,0
TIKI,do-choi-me-be,104154828,"[MUA LÀ CÓ QUÀ] Bánh ăn dặm cho bé vị rong biển Pigeon 24g (6 túi/hộp)",72000,72000,0,0
TIKI,do-choi-me-be,146479340,"Bộ lắp ráp năng lượng mặt trời - Đồ chơi robot sáng tạo 14 in 1",245000,245000,0,0
TIKI,do-choi-me-be,63137257,"Set đồ sơ sinh quà tặng cho bé 18-22 chi tiết coton có hộp sang chảnh",550000,550000,0,0
TIKI,do-choi-me-be,104134007,"Bình uống nước và nước trái cây Pigeon 50ml",73000,103000,30000,29
TIKI,do-choi-me-be,108916688,"Tã Dán Người Lớn Caryn Siêu Thấm Size Xl - 10 Miếng/ 20 Miếng Dành Cho Người Hạn Chế Khả Năng Đi Lại",130000,130000,0,0
TIKI,do-choi-me-be,188551130,"Bộ cờ tướng Đá Ngọc pha nhựa melamine cao cấp 4cm",120000,120000,0,0
TIKI,do-choi-me-be,4655703,"Dầu Tràm Cung Đình - Diamond (50ml)",235000,250000,15000,6
TIKI,do-choi-me-be,15254237,"Set 5 Đôi Vớ Tất Lưới Mùa Hè Cao Cấp ( Đồ Cho Bé Sơ Sinh 5-10kg )",35000,35000,0,0
TIKI,do-choi-me-be,196141398,"Chà bông tôm thượng hạng phamnghiafood hũ 40gr - Ruốc tôm với trên 90% thịt tôm chuẩn VietGap cho bé dinh dưỡng, cho mẹ nhàn tênh",69000,69000,0,0
TIKI,do-choi-me-be,167013284,"Đồ Chơi Lắp Ráp Mô Hình Thanh Kiếm Dạ Quang Phát Sáng Magic Knife Thousand Blades No.720 Với 836 Mảnh Ghép",699000,699000,0,0
TIKI,do-choi-me-be,118962950,"Cờ tỷ phú Monopoly Ultimate Banking , Monopoly Here & Now The World Edition",450000,450000,0,0
TIKI,do-choi-me-be,74466514,"Gel Làm Sạch Đa Năng Cho Cặn Canxi, Nước Cứng Stanhome Deep Gel 25ml/gói",18000,20000,2000,10
TIKI,do-choi-me-be,143375081,"XE ĐẠP THỂ THAO CỠ 22 INCH dành cho bé 8 tuổi - 12 TUỔI + Tặng kèm giỏ xe, gácbaga, túi, bình nước",1349000,1349000,0,0
TIKI,do-choi-me-be,45184509,"Khăn vải khô đa năng cho bé Oma Baby ( 1 Hộp/ 80 Miếng) - Oma & Baby Premium Baby Dry Multi-Functional Cloths ( 80 cloths per box)",75225,88500,13275,15
TIKI,do-choi-me-be,110685473,"Thảm nhạc cho bé nằm chơi hình khỉ",159999,159999,0,0
TIKI,do-choi-me-be,184799865,"Quây cũi nhựa cho bé gấp gọn, hình Tên Lửa KÈM cầu trượt xích đu cho bé hàng NEW",3990000,3990000,0,0
TIKI,do-choi-me-be,435749,"Sữa Bột Abbott Grow 1 900g",345000,345000,0,0
TIKI,do-choi-me-be,184754695,"GHẾ NGỒI XE MÁY TAY GA DÙNG CHUNG CHO XE LEAD - SCR - ACRUZO - SHARK CHO BÉ , GHẾ GA XẾP SẮT SƠN TĨNH ĐIỆN",199500,285000,85500,30
TIKI,do-choi-me-be,161956645,"GHẾ ĐI XE MÁY CÓ VÒNG BẢO HIỂM AN TOÀN CHO BÉ DÀNH CHO CÁC LOẠI XE TAY GA , GHẾ GA XẾP SẮT SƠN TĨNH ĐIỆN",199500,285000,85500,30
TIKI,do-choi-me-be,138488367,"Thảm Cotton Trải Sàn Họa Tiết Sắc Màu Cho Bé Hiện Đại",213000,213000,0,0
TIKI,do-choi-me-be,31924698,"Đồ Bà Ba Cho Bé Kèm Khăn Rằn",160000,160000,0,0
TIKI,do-choi-me-be,27924971,"Thả hình thông minh 16 khối gỗ",44000,44000,0,0
TIKI,do-choi-me-be,820411,"Sữa Dưỡng Thể Toàn Thân Cetaphil Baby (400ml)",254000,270000,16000,6
TIKI,do-choi-me-be,2627115,"Đồ gặm nướu silicon cho bé Sensory Marcus & Marcus, từ 6 tháng",188000,188000,0,0
TIKI,do-choi-me-be,125393799,"Thảm xốp ghép EVA trải sàn cho bé chất lượng Châu Âu EN71 - Toys House",169000,245000,76000,31
TIKI,do-choi-me-be,174605509,"TÃ DÁN CARYN NGƯỜI GIÀ SIZE L40 MIẾNG",398000,398000,0,0
TIKI,do-choi-me-be,190726246,"Áo thun ngắn tay, áo thun sát nách ba lỗ không tay, tanktop kiểu Hàn bé trai bé gái 10-38kg",84000,84000,0,0
TIKI,do-choi-me-be,249272520,"Sách vải cho bé Tiếng anh, đa tương tác kích thích trí não, các giác quan cho bé, an toàn tuyệt đối",59000,59000,0,0
TIKI,do-choi-me-be,142310492,"Túi Dụng Cụ Sakos Poke Dành Cho Bé - Hàng Chính Hãng - Giao Màu Ngẫu Nhiên",46000,55000,9000,16
TIKI,do-choi-me-be,183354010,"Combo 2 áo dây cho bé gái áo hai dây cho bé thun cotton SG loại đẹp co giãn mềm mịn 10-25kg",95000,95000,0,0
TIKI,do-choi-me-be,58804151,"Bột Giặt OMO Đỏ (6kg)",219000,219000,0,0
TIKI,do-choi-me-be,38444012,"Bài Tarot Kèm Túi Đựng Bài – Bài Bói Tarot Chính Hãng Amalife - The Rider Waite Deck",69900,69900,0,0
TIKI,do-choi-me-be,249521726,"Áo thun bé trai BETOP 100% cotton mềm mại hàng xuất Âu",69000,69000,0,0
TIKI,do-choi-me-be,140930706,"Búp Bê Barbie Xinh Xắn Cao 30cm Với 21 Khớp Linh Hoạt - Đồ Chơi Búp Bê Công Chúa Cho Bé Gái",110000,110000,0,0
TIKI,do-choi-me-be,113234813,"DHA cho bé từ 4 tháng - 12 tuổi Healthy Care Kids High Strength  - Úc, Giúp trẻ phát triển trí tuệ, thông minh, mắt sáng khỏe - QuaTangMe Extaste",238400,482000,243600,51
TIKI,do-choi-me-be,58722050," Bộ 6 sách vải Song ngữ VIỆT - ANH kích thích thị giác cho bé (PiPô Việt Nam)",115000,115000,0,0
TIKI,do-choi-me-be,91613941,"Set 3 đồ chơi con quay spinner hình côn trùng vui nhộn cho bé",54400,54400,0,0
TIKI,do-choi-me-be,100910712,"Bột ăn dặm dinh dưỡng Sữa, Hoa quả rừng HiPP Organic 250g",145000,145000,0,0
TIKI,do-choi-me-be,75424691,"Dây thun cột tóc hình tai thỏ phong cách Hàn Quốc đáng yêu thun co giãn tốt không gây đau khi cột tóc – P147",5000,10000,5000,50
TIKI,do-choi-me-be,180715040,"Combo 3 quần áo bé gái, đồ bộ Mimykid in 3D hoạt hình và trái cây dễ thương, đáng yêu co giãn 4 chiều mềm mại, thấm hút mồ hôi tốt, thời trang, set, bộ đồ, đồ cho trẻ em, bé gái từ 8-28kg (Giao màu ngẫu nhiên)",199000,199000,0,0
TIKI,do-choi-me-be,55771564,"Viên dầu cá bổ sung DHA cho trẻ thông minh, mắt sáng tinh anh Bioisland DHA For Kids nhập khẩu Úc",371000,475000,104000,22
TIKI,do-choi-me-be,180715051,"Combo 5 đồ bộ bé gái, quần áo Mimykid in 3D hoạt hình và trái cây dễ thương, đáng yêu chất liệu thun dày mịn mát, được các bé gái yêu thích, thời trang, set, đồ cho trẻ em, bé gái từ 8kg-28kg - Giao màu ngẫu nhiên",332000,332000,0,0
TIKI,do-choi-me-be,54619198,"Cũi em bé bằng gỗ đã qua hấp sấy, cũi gỗ với các nan bo tròn cạnh cùng với 4 bánh xe có khóa an toàn cho bé yêu - giá xưởng",655000,655000,0,0
TIKI,do-choi-me-be,109084626,"Núm ty ngậm thông khí Philips Avent hình thú (phiên bản Lime) cho trẻ từ 0-6 tháng tuổi _ vỉ đôi",245000,245000,0,0
TIKI,do-choi-me-be,272050409,"Sữa tăng chiều cao cho trẻ biếng ăn từ 1-10 tuổi Úc Pediasure Vanilla giúp phát triển cân đối chiều cao, cân nặng, trí não - QuaTangMe Extaste",859400,1720000,860600,50
TIKI,do-choi-me-be,26274580,"Nước xông tắm sau sinh Dao'spa mama người Dao đỏ 750ml - DK Pharma",350000,350000,0,0
TIKI,do-choi-me-be,147987171,"[HÀNG CAO CẤP - CÓ CHỌN SIZE] Cờ Cá Ngựa Nam Châm, Bộ Cờ Cá Ngựa Cao Cấp Kích Thước 28x28 và 38x38cm - Chính Hãng dododios",84000,84000,0,0
TIKI,do-choi-me-be,84667516,"Bộ Lấy Ráy Tai Có Đèn LED INOX Cao Cấp - Lấy Ráy Tai Trẻ Em An Toàn, Tiện Lợi, Vệ Sinh ,Tặng Kèm + 2 Pin AAA + 3 Pin Cúc Áo [ Video Sản Phẩm ]",39999,39999,0,0
TIKI,do-choi-me-be,98631378,"Đồ chơi xếp hình, lắp ráp Qman 1928 - Truy bắt tội phạm trên biển (473 mảnh ghép)",279000,339000,60000,18
TIKI,do-choi-me-be,45086636,"Kem dưỡng Aveeno Baby cho da khô và nhạy cảm 227g - 101016747",289000,400000,111000,28
TIKI,do-choi-me-be,140743265,"1 hộp 12 hủ slime chất nhờn ma quái",45000,45000,0,0
TIKI,do-choi-me-be,170753976,"[TẶNG QUÀ] Ti Ngậm, Ti Giả BIBS Chính Hãng Đan Mạch Cao Cấp, Chất Liệu Silicon An Toàn Cho Bé Từ 0-3 Tuổi, Tặng Kèm Hộp Đựng Ti",199000,199000,0,0
TIKI,do-choi-me-be,45207940,"Khăn ướt làm sạch tinh khiết dành cho bé Oma&Baby với công thức Chlorhexidine Digluconate kháng khuẩn an toàn, dịu nhẹ trong khăn ( 25 tờ ) - Oma&Baby premium baby wet wipes ( 25 sheets per package)",16150,19000,2850,15
TIKI,do-choi-me-be,50218043,"Đồ Chơi Siêu Xe Điều Khiển Từ Xa Veyron Sport DK81001 - Màu Xanh",225000,250000,25000,10
TIKI,do-choi-me-be,114117410,"Búp Bê 30cm 22 Khớp Tỉ Lệ 1/6 Đáng Yêu",88000,88000,0,0
TIKI,do-choi-me-be,44962467,"BỘT NGŨ CỐC 5 THỨ ĐẬU KHÔNG ĐƯỜNG VITAPRO (350 gr)",46000,46000,0,0
TIKI,do-choi-me-be,88001896,"Bộ quây cũi nhựa TẶNG bóng, thảm ( GIAO 2H HCM)",1100000,1100000,0,0
TIKI,do-choi-me-be,124275111,"Hộp 50 Kẹp Tóc Và Dây Cột Tóc Cho Bé Gái Hình Mèo Kute",59000,63000,4000,6
TIKI,do-choi-me-be,129710160,"Tắm gội dịu nhẹ 2 in 1 Sakura Pigeon 200ML/700ML",67000,89000,22000,25
TIKI,do-choi-me-be,15444884,"Thảm xốp lót sàn cho bé - chữ cái Pastel (26 miếng, diện tích 2.4m2) Smile Puzzle",344100,370000,25900,7
TIKI,do-choi-me-be,48490790,"Bộ xếp hình 2 tấm 48 mảnh ghép khổ A3, Xì trum và Doremon . Tia Sáng Việt Nam. Đồ chơi trí tuệ cho bé từ 3 tuổi. Ký hiệu: Xếp hình.",78000,78000,0,0
TIKI,do-choi-me-be,137119518,"Combo 10 Nút Bịt Ổ Điện An Toàn Cho Bé - Loại 2 Chạc Như Hình",30000,30000,0,0
TIKI,do-choi-me-be,2791837,"Cốt nghệ hạ thổ dưỡng trắng body, sạch thâm rạn, thơm tho body sau sinh Wonmom 200ml",225000,250000,25000,10
TIKI,do-choi-me-be,188128745,"Đồ chơi trẻ em: Xe ô tô mô hình hợp kim chống bạo động DK 81104. Kiểu dáng, mẫu xe, màu sắc ngẫu nhiên.",93750,125000,31250,25
TIKI,do-choi-me-be,249161079,"Núm ty Cổ Rộng Wesser S/M/L (2 cái/hộp)",100050,115000,14950,13
TIKI,do-choi-me-be,109229242,"Nệm cho bé sơ sinh mầm non tiểu học, nệm chống thấm, vải Tencel mềm mịn mát, nhiều họa tiết đáng yêu",199000,199000,0,0
TIKI,thiet-bi-kts-phu-kien-so,11719645,"Radio Panasonic RF-562DD (Hàng chính hãng)",1250000,1250000,0,0
TIKI,thiet-bi-kts-phu-kien-so,97057377,"Pin sạc dự phòng Hoco J75 10000mAh 2 cổng Input/Output max 2A,HÀNG CHÍNH HÃNG",150000,150000,0,0
TIKI,thiet-bi-kts-phu-kien-so,32292159,"ốp lưng cho iphone 11 pro và iphone 11 max pro chống sốc - chính hãng Xundd",88999,88999,0,0
TIKI,thiet-bi-kts-phu-kien-so,103850348,"Tai Nghe Không Dây Mẫu Mới Thiết Kế Màn Hình Led Ấn Tượng Sử Dụng Cảm Biến Vân Tay Thông Minh - Hàng Chính Hãng PKCB",194000,500000,306000,61
TIKI,thiet-bi-kts-phu-kien-so,76551460,"Miếng Dán Kim Loại bảo vệ Camera cho iPhone 12 Mini / 12 / 12 Pro / 12 Pro Max",56000,56000,0,0
TIKI,thiet-bi-kts-phu-kien-so,186206677,"Túi hộp Smilebox khung cứng chống sốc đựng tai nghe chụp đầu, tai nghe chụp 2 tai bluetooth loại lớn - Hàng chính hãng",89000,89000,0,0
TIKI,thiet-bi-kts-phu-kien-so,181361823,"Tai Nghe Bluetooth  F9 Pro Cảm Ứng Cao Cấp Tích Hợp Sạc Dự Phòng 2500mAh, Bass Cực Hay, Kháng Nước IPX7, Kiêm Giá Đỡ Điện Thoại",59000,75000,16000,21
TIKI,thiet-bi-kts-phu-kien-so,176473066,"Kính cường lực cho Samsung A53 5G nhám Chống vân tay/ Chống nhìn trộm/ Full màn hình/ Không viền màu/ Ốp trong chống sốc",29400,29400,0,0
TIKI,thiet-bi-kts-phu-kien-so,34339077,"Bàn di chuột, miếng lót chuột, mouse pad size 80x30, 90x40 (mẫu mới)",95000,95000,0,0
TIKI,thiet-bi-kts-phu-kien-so,107212360,"loa phóng thanh, rao bán hàng rong, hướng dẫn viên du lịch( bh 6 tháng lỗi đổi 1)",168000,175000,7000,4
TIKI,thiet-bi-kts-phu-kien-so,150936706,"Bàn phím cơ không dây Dareu EK807G White- Hàng Chính Hãng",649000,649000,0,0
TIKI,thiet-bi-kts-phu-kien-so,45648516,"Tai nghe L21 Bluetooth 5.0 Kiềm Sạc Dự Phòng",149000,200000,51000,26
TIKI,thiet-bi-kts-phu-kien-so,95466098,"Bao da kèm bàn phím Bluetooth Samsung Tab S6 Lite P610 Smart Keyboard - Hàng nhập khẩu",338990,338990,0,0
TIKI,thiet-bi-kts-phu-kien-so,100485308,"Kê Tay Bàn Phím Máy Tính Cao Xu Non 3D Siêu Êm Hình Cute Dễ Thương, Giúp Chống Mỏi Gõ Nhanh Và Thuận Lợi - Hàng Chính Hãng",199000,199000,0,0
TIKI,thiet-bi-kts-phu-kien-so,179911051,"Micro không Dây F18 cho điện thoại , máy tính bảng , android , ios chất lượng cao - hàng nhập khẩu",140000,140000,0,0
TIKI,thiet-bi-kts-phu-kien-so,73751947,"Tai Nghe Bluetooth không dây True Wireless PKCB, Màn Hình Led hiển Thị Pin - Hàng chính hãng",194000,500000,306000,61
TIKI,thiet-bi-kts-phu-kien-so,190506536,"Miếng Dán Mặt Lưng Và Cạnh Viền Film Hydrogel Dành Cho Iphone 14/ 14pro/ 14 promax/ 13/13 Pro/ 13 Promax/ 12 Promax- Hàng chính hãng",37050,39000,1950,5
TIKI,thiet-bi-kts-phu-kien-so,21922020,"Hub chuyển đổi USB Type-C Sang USB 3.0/HDMI-Type C (Xám)",115000,159000,44000,28
TIKI,thiet-bi-kts-phu-kien-so,89656348,"Giá đỡ điện thoại Giá đỡ máy tính bảng để bàn Giá Đỡ Kẹp Điện Thoại LiveStream",14597,14597,0,0
TIKI,thiet-bi-kts-phu-kien-so,22167367,"Tai Nghe Có Dây Chụp Tai Over-ear Sennheiser HD 400S - Hàng Chính Hãng",1259100,1399000,139900,10
TIKI,thiet-bi-kts-phu-kien-so,141526577,"Bút Cảm Ứng Spen Cho Samsung Galaxy Note10 Plus",350000,450000,100000,22
TIKI,thiet-bi-kts-phu-kien-so,121603766,"Micro Có Dây Cao Cấp SHURE KSM8A- chính hãng",380000,380000,0,0
TIKI,thiet-bi-kts-phu-kien-so,150921519,"Ốp Case Chống Shock Kai Rugged Armor cho Apple Watch Series 6/ SE/ Series 5/4 Size 40/44mm- Hàng Chính Hãng",94050,99000,4950,5
TIKI,thiet-bi-kts-phu-kien-so,16766952,"Miếng Lót Chuột Gaming RGB Bo Viền Led Sáng Cỡ Lớn (80 x 30 cm) - Bàn Di Chuột Chơi Game Led Nhiều Màu",117700,117700,0,0
TIKI,thiet-bi-kts-phu-kien-so,171050057,"Bao da dành cho ipad gen 9 10.2 2021 khe đựng bút",155000,155000,0,0
TIKI,thiet-bi-kts-phu-kien-so,191725990,"Thẻ nhớ Samsung Evo Plus MicroSDXC 32GB | 64GB | 128GB | 256GB | 512GB - Hàng chính hãng",155000,155000,0,0
TIKI,thiet-bi-kts-phu-kien-so,123367765,"Ốp Nillkin Camshield bảo vệ Camera cho iPhone 13 Pro Max - Hàng nhập khẩu",128000,297994,169994,57
TIKI,thiet-bi-kts-phu-kien-so,78011688,"Adapter Củ Sạc 100W 2 Cổng Type C cho Macbook, Laptop, Smartphone CHOETECH PD6008 Kèm Dây Cáp Type C to C 100W - Hàng Chính Hãng",899000,1500000,601000,40
TIKI,thiet-bi-kts-phu-kien-so,74305795,"Ốp Lưng Case TPU Dẻo Chống Sốc Dành Cho iPhone 12/12Pro / iPhone 12 Promax / iPhone 12 Mini - Hàng Chính Hãng Meliya accessories",9000,9000,0,0
TIKI,thiet-bi-kts-phu-kien-so,655484,"Chuột Game Có Dây Fuhlen X102S - Hàng Chính Hãng",129000,129000,0,0
TIKI,thiet-bi-kts-phu-kien-so,360738,"Tay cầm chơi game console có dây Logitech F310 - 4 phím di chuyển D-Pad, tương thích TV Android, dây 1.8m - Hàng chính hãng",449000,460000,11000,2
TIKI,thiet-bi-kts-phu-kien-so,141304837,"Kính cường lực Nillkin CP+ PRO cho iPhone 13 Mini / 13 / 13 Pro / 13 Pro Max - Hàng Nhập Khẩu",124000,269999,145999,54
TIKI,thiet-bi-kts-phu-kien-so,17946135,"Đài  836s USB thẻ nhớ nghe đài FM có đèn pin hàng nhập khẩu",147900,147900,0,0
TIKI,thiet-bi-kts-phu-kien-so,177809138,"Kệ Dán Tường Để Remote, Đồ Dùng/ Giá Đỡ Sạc Điện Thoại/ Điều khiển tivi, Đa Năng Cao Cấp có 2 móc treo tiện lợi",10000,10000,0,0
TIKI,thiet-bi-kts-phu-kien-so,153814643,"Bao Silicon Cao Cấp Kiểu Dáng Bút Chì Bảo Vệ Cho Bút Apple Pencil 2 Kai.N Kèm Nắp Đậy_ Hàng Chính Hãng",67000,79000,12000,15
TIKI,thiet-bi-kts-phu-kien-so,33115720,"Micro Ghi Âm Cài Áo BOYA BY-M - Hàng nhập khẩu",265000,265000,0,0
TIKI,thiet-bi-kts-phu-kien-so,1600005,"Tai Nghe Nhét Tai Mi Basic Xiaomi",117000,117000,0,0
TIKI,thiet-bi-kts-phu-kien-so,178315901,"HUB Chuyển Đổi Type C To HDMI 4K/ PD 100W/ USB 3.0/ Rj45 Ethernet/ VGA/ TF/ SD (9 Trong 1) CHOETECH HUB-M15 - Hàng Chính Hãng",990000,1690000,700000,41
TIKI,thiet-bi-kts-phu-kien-so,57287349,"Đài USB THẺ NHỚ NGHE NHẠC WAXIBA XB-521URT RADIO AM\FM\SW LOA TO X-BASS CÓ ĐÈN PIN GIAO MÀU NGẪU NHIÊN HÀNG CHÍNH HÃNG",165000,165000,0,0
TIKI,thiet-bi-kts-phu-kien-so,132782814,"Bao da lưng cứng cho Xiaomi Mi Pad 5 , Mi Pad 5 Pro",130000,130000,0,0
TIKI,thiet-bi-kts-phu-kien-so,47466797,"Đầu cắm cho sạc Macbook, Ipad dạng 2 chấu chân dẹt",28000,28000,0,0
TIKI,thiet-bi-kts-phu-kien-so,272420302,"Cáp sạc thay thế cho các dòng đồng hồ Garmin Fenix 7, Fenix 6, Fenix 5, Forerunner 955, 945, 935, 245, 265, 255, 45, 645, Instinct, Viviactive 3, Venu/ Garmin Epix Gen 2- Hàng Chính Hãng",71000,79000,8000,10
TIKI,thiet-bi-kts-phu-kien-so,142323009,"Dây Cáp DisplayPort 2 Đầu Đực Dài 2M 1.2 Phân Giải 8K 60hz Tốc Độ 32.4Gbps CHOETECH XDD01 - Hàng Chính Hãng",229000,390000,161000,41
TIKI,thiet-bi-kts-phu-kien-so,2989999,"{ Lắp Là Dùng } Sim 5G Thái Lan 10 Ngày 50GB Và 100 Phút Gọi Thái Lan - Mẫu ngẫu nhiên",165000,165000,0,0
TIKI,thiet-bi-kts-phu-kien-so,195888467,"Miếng Lót Chuột Mouse Pad Kích Thước 26x21cm Dùng Trong Văn Phòng Học Tập Mẫu Hoạt Hình Anime Chibi",37050,39000,1950,5
TIKI,thiet-bi-kts-phu-kien-so,17903752,"Bao Da Cover Máy Đọc Sách Dành Cho Kindle Paperwhite Gen 4 (10th) Hoa Văn",130000,130000,0,0
TIKI,thiet-bi-kts-phu-kien-so,418620,"Bộ Bàn Phím Và Chuột Có Dây Logitech MK200 - Hàng Chính Hãng",298000,298000,0,0
TIKI,thiet-bi-kts-phu-kien-so,74891073,"giá kê laptop/macbook hợp kim nhôm gập gọn, tùy chỉnh độ cao tầm nhìn, đế tản nhiệt laptop",66700,66700,0,0
TIKI,thiet-bi-kts-phu-kien-so,74498670,"Bộ sạc nhanh 20W USB Type C Baseus Super SI Quick Charger QC3.0 cho iPhone 12 (1C, 20W, Chân dẹt) - Hàng chính hãng",142898,142898,0,0
TIKI,thiet-bi-kts-phu-kien-so,153821917,"Đồng hồ Thông minh Gọi Video Call 4G, GPS, Wifi Chống nước Định vị Chuẩn AMA Watch LT36 có 3 màu Đen Hồng Xanh Hàng nhập khẩu",1050000,1050000,0,0
TIKI,thiet-bi-kts-phu-kien-so,98687501,"Kính Cường Lực  Chống Nhìn Trộm Iphone Full Màn 6_6s_6plus_6splus_7plus_8plus_X_Xs_Xsmax_11_11pro_11pro max",26000,52000,26000,50
TIKI,thiet-bi-kts-phu-kien-so,195300886,"Cáp Sạc ANKER PowerLine+ II USB-C to Lightning - Phiên Bản Marvel - A9548 - Hàng Chính Hãng",396000,550000,154000,28
TIKI,thiet-bi-kts-phu-kien-so,21316309,"Chuột quang không dây Fuhlen A09 - Hàng Chính Hãng",139000,139000,0,0
TIKI,thiet-bi-kts-phu-kien-so,186817879,"Loa máy trợ giảng Aporo T30 UHF, công suất 20W không dây cao cấp (gồm 3 micro)- Hàng chính hãng",850000,850000,0,0
TIKI,thiet-bi-kts-phu-kien-so,158641574,"[xả hàng cuối năm]Tai nghe nhét tai có Mic Texet-Crossloop E3169 hàng nhập khẩu",90000,90000,0,0
TIKI,thiet-bi-kts-phu-kien-so,68354444,"Tai nghe Bluetooth F9 TWS pin trâu sạc nhanh, chống nước",61000,79000,18000,23
TIKI,thiet-bi-kts-phu-kien-so,167596574,"HÀNG CHÍNH HÃNG-  Kính cường lực Kingkong iP hộp sắt, không hộp WEKOME cho IP 6 Plus 7 8 X XS Max 11 12 Pro 13 13pro 13 PROMAX",20998,41996,20998,50
TIKI,thiet-bi-kts-phu-kien-so,45608421,"Bao Da Cover Dành Cho Apple Ipad 10.2 Inch 2019 Vân Da Tuần Lộc",133900,133900,0,0
TIKI,thiet-bi-kts-phu-kien-so,193005797,"Đồng hồ Thông minh 25 GAME Y8S gắn thẻ nhớ 32G Nghe nhạc Lắp Sim gọi Điện thoại không cần App Quản lý Hàng nhập khẩu",1000000,1000000,0,0
TIKI,thiet-bi-kts-phu-kien-so,114100979,"Chuột Không Dây Không Ồn E-DRA EM603W (Silent Switch) - Hàng Chính Hãng",85000,85000,0,0
TIKI,thiet-bi-kts-phu-kien-so,33744638,"Bàn di chuột, miếng lót chuột, mouse pad RGB size 80x30, 90x40",124000,160000,36000,23
TIKI,thiet-bi-kts-phu-kien-so,5987217,"Cáp HDMI 2.0 hỗ trợ 3D, 4K dài 5m UGREEN HD118 40412 - Hàng chính hãng",210000,273000,63000,23
TIKI,thiet-bi-kts-phu-kien-so,214802387,"Quạt tản nhiệt MEMO DL05 - Thiết bị hạ nhiệt gaming dành cho điên thoại siêu lạnh, hiển thị nhiệt độ, LED RGB, Kẹp thu vào 2 chiều - Hàng Nhập Khẩu",219000,250000,31000,12
TIKI,thiet-bi-kts-phu-kien-so,143860118,"Sạc dự phòng 20000mAh sạc nhanh không dây 15W Remax RPP-207 sạc nhanh 22.5W QC3.0 - Hàng chính hãng",619550,900000,280450,31
TIKI,thiet-bi-kts-phu-kien-so,140742956,"Sạc nhanh AUKEY PA-Y30S PD 30W - Hàng chính hãng",268000,268000,0,0
TIKI,thiet-bi-kts-phu-kien-so,181922008,"Case Silicon Dành Cho Airpods Pro In Hình Tai Nghe-Kèm Móc Khóa_ Hàng Chính Hãng",65550,69000,3450,5
TIKI,thiet-bi-kts-phu-kien-so,144803533,"Chuột không dây bluetooth Logitech POP Mouse - Hàng chính hãng",579000,579000,0,0
TIKI,thiet-bi-kts-phu-kien-so,53547999,"Miếng lót chuột hình tròn siêu dễ thương - Hàng chính hãng",12000,12000,0,0
TIKI,thiet-bi-kts-phu-kien-so,81613252,"Micro Karaoke Bluetooth cao cấp PKCB Chính Hãng",990000,2300000,1310000,57
TIKI,thiet-bi-kts-phu-kien-so,119450638,"Kệ để màn hình máy tính, laptop Dovaty KM3",138000,138000,0,0
TIKI,thiet-bi-kts-phu-kien-so,157490476,"Bút Vệ Sinh Tai Nghe Bluetooth 3 Trong 1 Cao Cấp MIFAN - Làm sạch bụi bẩn trong hộp đựng, loa, cổng sạc, điện thoại - Hàng chính hãng",69000,100000,31000,31
TIKI,thiet-bi-kts-phu-kien-so,114271326,"Tai nghe Bluetooth F9 Pro V5.0 cảm biến vân tay",59000,79000,20000,25
TIKI,thiet-bi-kts-phu-kien-so,35278834,"Hàng Chính Hãng- Loa Máy Vi Tính SADA V-196, Hỗ Trợ Đèn Led, Âm Thanh Siêu Trầm",196000,196000,0,0
TIKI,thiet-bi-kts-phu-kien-so,109988967,"Chuột không dây HXSJ T15 wireless 2.4G tự sạc pin siêu mỏng không gây tiếng ồn chuyên dùng cho Máy tính, pc, Laptop, Tivi - Hàng chính hãng",179000,349000,170000,49
TIKI,thiet-bi-kts-phu-kien-so,73406907,"Tai Nghe Không Dây Chống Nước Ipx5, Tai Nghe Nhét Tai Mini Bluetooth PKCB - Hàng Chính Hãng",250000,500000,250000,50
TIKI,thiet-bi-kts-phu-kien-so,59306865,"Tai nghe KZ ZSN Pro X - Bản nâng cấp tốt hơn, đẹp hơn có micro - Hàng chính hãng",389000,389000,0,0
TIKI,thiet-bi-kts-phu-kien-so,178031593,"Tai Nghe Không Dây HUQU F.808 Âm Thanh Sống Động Chân Thực, Đường Truyền Ổn Định - Hàng chính hãng ",560500,590000,29500,5
TIKI,thiet-bi-kts-phu-kien-so,178735823,"Tai Nghe Nhét Tai Đa Năng HuQu HQ-ProX6 Kiêm Sạc Không Dây Cho Điện Thoại Di Động -Hàng Chính Hãng",750500,790000,39500,5
TIKI,thiet-bi-kts-phu-kien-so,112734786,"Giá Đỡ Để Bàn Dành Cho Máy Tính Bảng, Ipad T003 - Chất Liệu Hợp Kim Nhôm Cao Cấp Hàng Chính Hãng Tamayoko",279000,279000,0,0
TIKI,thiet-bi-kts-phu-kien-so,45464404,"Đồng hồ báo thức điện tử thông minh để bàn mini DH89",52000,52000,0,0
TIKI,do-choi-me-be,10710955,"Sữa Bột Vinamilk Sure Prevent - Hộp Thiếc 900g",615000,615000,0,0
TIKI,do-choi-me-be,20021601,"Thùng 48 Hộp x 180ml Sữa Bột Pha Sẵn GrowPLUS+ Đỏ 180ml Suy Dinh Dưỡng - Hàng Chính Hãng",560000,560000,0,0
TIKI,do-choi-me-be,55139034,"Gấu Bông Gối Ôm Thú Bông, Nhồi Bông Hình Ly Trà Sữa Xinh Xắn Ngộ Nghĩnh Siêu Hot",59000,59000,0,0
TIKI,do-choi-me-be,38220113,"TPBVSK Special kid Multivitamin - Siro Bổ sung vitamin và khoáng chất - Hỗ trợ nâng cao sức khỏe, tăng cường sức đề kháng (125ml) [Siro - Nhập khẩu Pháp]",239000,360000,121000,34
TIKI,do-choi-me-be,28747389,"Nam châm vĩnh cửu - Bi nam châm xếp hình - Đồ chơi thông minh an toàn cho trẻ tử 13 tuổi, một hộp 216 viên, đường kính bi 5mm, có nhiều màu",150000,150000,0,0
TIKI,do-choi-me-be,88928270,"Combo 7 Gói Khăn Ướt Trẻ Em Mamamy 100 Tờ-Nắp",228000,228000,0,0
TIKI,do-choi-me-be,189990461,"Bột Giặt LIX Extra Hương Nước Hoa 5.5Kg EH554 - Tăng Gấp Đôi Sức Mạnh Giặt Tẩy",155000,155000,0,0
TIKI,do-choi-me-be,164075673,"Tả quần Kitin Natural size M44 (6-10kg)",153000,225000,72000,32
TIKI,do-choi-me-be,127364356,"Thanh chắn cửa, chắn cầu thang chính hãng Mastela D04 bảo vệ an toàn cho bé, Không cần khoan tường, có thể thanh mở rộng",249000,360000,111000,31
TIKI,do-choi-me-be,57804868,"Viên sắt cho bà bầu  Blackmores Pregnancy Iron 30 viên chính hãng Úc",198000,247500,49500,20
TIKI,do-choi-me-be,57471545,"Combo 3 bộ đồ Tole, lanh Bé Trai - Mẫu Tay Dài, cài 2 nút trước - Size 1-14 cho bé 5-45kg-  Chất vải tole, lanh 2 da loại 1 mềm, mịn, mát cho bé trai-  Hàng Việt Nam",147000,147000,0,0
TIKI,do-choi-me-be,78490166,"Đồ chơi mô hình xe cứu thương KAVY có nhạc và đèn chạy cót mở được tất cả các cảnh cửa",189000,189000,0,0
TIKI,do-choi-me-be,58767957,"Miếng lót siêu thấm Bobby Newborn 1 - 108 miếng",173200,173200,0,0
TIKI,do-choi-me-be,119706886,"Sữa dưỡng ẩm dịu lành hằng ngày cho bé Cetaphil Baby Daily Lotion with Organic Calendula 400ml",330000,330000,0,0
TIKI,do-choi-me-be,24699281,"BỘT ĂN DẶM RIDIELAC GOLD 3 VỊ NGỌT - HỘP GIẤY 200G",58000,58000,0,0
TIKI,do-choi-me-be,114140785,"Trái cây nghiền vị táo, mơ và kem tươi Fruto Nyanya 90g",37600,47000,9400,20
TIKI,do-choi-me-be,175722019,"Đầm thun hồng chấm bi rút nơ eo SoraChan - M043",199000,199000,0,0
TIKI,do-choi-me-be,67821209,"b.box Disney Bình nước 360 độ cho bé tập uống nước 240ml",315000,315000,0,0
TIKI,do-choi-me-be,72040205,"Áo ngực cho con bú chống chảy xệ. Áo lót cho con bú siêu mềm, thoáng khí, mát mẻ. Áo lót không gọng cho bé bú sau sinh. Áo ngực cho bà bầu cao cấp Vemoda",99000,109000,10000,9
TIKI,do-choi-me-be,35223069,"GỐI CAO SU NON CHO BÉ HÌNH HOẠT HÌNH MẪU MỚI 2019 HB673",133000,195000,62000,32
TIKI,do-choi-me-be,36622949,"Combo 10 miếng silicon bọc cạnh bàn, góc bàn",19389,19389,0,0
TIKI,do-choi-me-be,104144579,"Máy hút sữa điện đôi GoMini Pigeon (HSD: 03/2025)",990000,2893000,1903000,66
TIKI,do-choi-me-be,73636252,"TPBVSK Special Kid Zinc - Bổ sung Kẽm cho cơ thể, hỗ trợ tăng cường sức đề kháng (125ml) [Siro – Nhập khẩu Pháp]",244000,360000,116000,32
TIKI,do-choi-me-be,80098785,"ta quan hingig 100 mieng size 5XL",250000,250000,0,0
TIKI,do-choi-me-be,59445073,"Bảng gỗ cho bé,Bộ Đồ Chơi Câu Cá Và Ghép Số Học Đếm 63 Chi Tiết Cho Bé giúp phát triển trí tuệ",82990,82990,0,0
TIKI,do-choi-me-be,16659020,"Nước giặt Layer Clean hương Ocean Breeze 5L",207000,207000,0,0
TIKI,do-choi-me-be,122740501,"Sữa bột Vinamilk Dielac Grow Plus 2+ Hộp thiếc 850g (Sữa Non)",345000,378886,33886,9
TIKI,do-choi-me-be,76265391,"Bộ đồ chơi máy bay  KAVY chở đồ kèm 4 xe cảnh sát bằng kim loại, có giàn cẩu, thang trượt, biển báo đa chức năng chạy pin",395000,395000,0,0
TIKI,do-choi-me-be,104159464,"Cây súc rửa bình sữa và núm vú Pigeon - Tay xoay hai chiều/một chiều (HSD:08/2024)",54000,76000,22000,29
TIKI,do-choi-me-be,116572108,"Combo 3 lon sữa bột dinh dưỡng công thức HiPP 2 Organic Combiotic chất lượng hữu cơ tự nhiên an toàn, bổ sung Omega 3 (DHA & ALA) dành cho trẻ từ 6 đến 12 tháng tuổi (3 lon x 800g)",2160000,2160000,0,0
TIKI,do-choi-me-be,121231159,"Bài Mèo Nổ Giá Rẻ Việt Hóa Lá Bài 2021 Exploding Kittens 56 Lá Cán Màng Chất Giấy Dày Dặn Rẻ Sập Sàn",70000,70000,0,0
TIKI,do-choi-me-be,969619,"Sữa Bột Friso mum Gold Hương Vani (900g)",509000,616000,107000,17
TIKI,do-choi-me-be,125426737,"Gấu bông trà sữa mini 18cm",19000,19000,0,0
TIKI,do-choi-me-be,59456617,"Bỉm - Tã Quần Moony Natural Size L- 36 miếng ( bé 9-14Kg)",286900,286900,0,0
TIKI,do-choi-me-be,131170228,"Bộ đất sét nặn 3D Deli 24 màu - Chất liệu an toàn cho trẻ nhỏ, màu sắc tươi sáng đa dạng, kèm phụ kiện khuôn nặn - 67825",52000,117000,65000,56
TIKI,do-choi-me-be,48332026,"FITOBIMBI BRONCAMIL – SIRO THẢO DƯỢC CHUẨN HÓA CHÂU ÂU GIẢM HO 3 TRONG 1 CHO TRẺ (200ml)",320000,320000,0,0
TIKI,do-choi-me-be,79847161,"Đồ chơi lắp ráp, xếp hình Qman 10 in 1 (Combo 10 hộp) – mô hình xe, máy bay, thú, khủng long",129000,149000,20000,13
TIKI,do-choi-me-be,23047533,"Sữa Bột Vinamilk Dielac Grow Plus 2+ (1500g / Hộp Thiếc)",565000,565000,0,0
TIKI,do-choi-me-be,133792282,"Bộ cờ tứ mã, cờ cá ngựa bằng gỗ cho mọi lứa tuổi, boardgames trí tuệ, đồ chơi gỗ trong nhà",299000,299000,0,0
TIKI,do-choi-me-be,45998865,".Nước hoa xịt phòng cao cấp Paris by night 500ml",34000,34000,0,0
TIKI,thiet-bi-kts-phu-kien-so,89951686,"Thẻ nhớ Kingston microSDHC Canvas Select Single Pack no Adapter 32GB - Hàng Chính Hãng",88000,88000,0,0
TIKI,thiet-bi-kts-phu-kien-so,38151960,"Cáp sạc nhanh Micro USB Hoco X14, dây sạc bọc dù chống đứt, chống rối, hỗ trợ truyền dữ liệu dành cho Samsung/Huawei/Xiaomi/Oppo/Sony, sạc nhanh 2A Max - Hàng chính hãng",28300,28300,0,0
TIKI,thiet-bi-kts-phu-kien-so,99335704,"Cáp loa Jack 3.5 ra 2 đầu bông sen AV dài 10M cao cấp chống nhiễu",88000,88000,0,0
TIKI,thiet-bi-kts-phu-kien-so,35906107,"Cáp chuyển đổi điện áp từ cổng USB 5V sang 9V hoặc 12V",23000,23000,0,0
TIKI,thiet-bi-kts-phu-kien-so,178331551,"ĐÀI RADIO USB NGHE NHẠC WAXIBA XB-402 BT CÓ ĐỒNG HỒ ,NGHE FM/AM/SW LOA SIÊU LỚN hàng chính hãng",220000,220000,0,0
TIKI,thiet-bi-kts-phu-kien-so,85118373,"Cáp sạc Baseus Type C 100W, Cáp sạc siêu nhanh 100W Baseus Metal Data Cable Type C to Type C (100W) - Hàng nhập khẩu",89000,89000,0,0
TIKI,thiet-bi-kts-phu-kien-so,5812981,"Webcam Logitech C310 720p HD - Hàng chính hãng",729000,729000,0,0
TIKI,thiet-bi-kts-phu-kien-so,56718615,"Bao da Samsung Galaxy Tab S6 Lite P610/P615 DUX DUCIS Smartcover - Hàng nhập khẩu",290000,290000,0,0
TIKI,thiet-bi-kts-phu-kien-so,17629146,"Miếng Lót Chuột Dễ Thương Tròn Họa Tiết ( 20cm )",23789,23789,0,0
TIKI,thiet-bi-kts-phu-kien-so,12705281,"Chuột Chơi Game Có Dây X3 (Đen Phối Xanh)",85405,89900,4495,5
TIKI,thiet-bi-kts-phu-kien-so,88796681,"Dây Cáp Nối Dài USB 3.0 Dài 2M CHOETECH XAA001-BK - Hàng Chính Hãng",119000,190000,71000,37
TIKI,thiet-bi-kts-phu-kien-so,116753482,"Kẹp dán cố định dây cáp sạc, tai nghe, dây phụ kiện đa năng làm gọn bàn làm việc, taplo xe hơi cực tiện dụng - Hàng nhập khẩu",15000,15000,0,0
TIKI,thiet-bi-kts-phu-kien-so,184707950,"Bao Case ESR Air Ripple Chống Sốc Dành Cho Airpods Pro- Hàng Chính Hãng",152000,160000,8000,5
TIKI,thiet-bi-kts-phu-kien-so,65773450,"Hộp đựng dành cho chuột Logitech MX Master/ Master 2S/ Master 3/ MX",99000,99000,0,0
TIKI,thiet-bi-kts-phu-kien-so,196200052,"Bộ Vệ Sinh Laptop Đa Năng 7 in 1 Cao Cấp Vệ Sinh Tai Nghe, Bàn Phím, Điện Thoại, Máy Tính, Màn Hình, Máy ảnh",49900,49900,0,0
TIKI,thiet-bi-kts-phu-kien-so,72014868,"Ốp lưng da cao cấp dành cho",149000,199000,50000,25
TIKI,thiet-bi-kts-phu-kien-so,106188383,"Giá đỡ Dành Cho LAPTOP, MACBOOK, IPAD bằng nhôm có thể điều chỉnh được độ cao, đế tản nhiệt laptop, đế kê laptop nhôm",65800,65800,0,0
TIKI,thiet-bi-kts-phu-kien-so,152709674,"Bao Da Cover Cho Máy Tính Bảng Tab Samsung Galaxy Tab A8 10.5 (2021) SM-X200 / X205 Hỗ Trợ Smart Cover",119000,119000,0,0
TIKI,thiet-bi-kts-phu-kien-so,192726528,"Ốp Case Siêu Mỏng Thinfit cho Apple Watch Series 7/ Series 8 Size 41/45mm- Hàng chính hãng",75050,79000,3950,5
TIKI,thiet-bi-kts-phu-kien-so,190086553,"Miếng Dán Mặt Đồng Hồ Cường Lực Dẻo 3D Kai dành cho Apple Watch- Hàng chính hãng",40000,40000,0,0
TIKI,thiet-bi-kts-phu-kien-so,161395935,"Bao da dành cho Nokia T20 2021 10.4 inch - Gập dựng được - Tặng kèm bút",119000,119000,0,0
TIKI,thiet-bi-kts-phu-kien-so,23490593,"Bộ bàn phím Logitech K120 + chuột Logitech B100 - Hàng chính hãng",289000,289000,0,0
TIKI,thiet-bi-kts-phu-kien-so,160800567,"Kính cường lực chống nhìn trộm cho Iphone từ Iphone 6 đến IP 13ProMax",25000,79000,54000,68
TIKI,thiet-bi-kts-phu-kien-so,20495992,"Sạc dự phòng Energizer UE10046 Dung Lượng 10,000mAh - Hàng Chính Hãng",550000,550000,0,0
TIKI,thiet-bi-kts-phu-kien-so,144641277,"Bao Da Cover Cho Máy Đọc Sách Kindle Paperwhite Gen 5 11th 2021 Nhựa Xước Smart Cover",134000,134000,0,0
TIKI,thiet-bi-kts-phu-kien-so,19932819,"Pin thay thế dành cho máy galaxy Grand Prime G530 BG530CBE,J3, J5, J2 Prime",90000,90000,0,0
TIKI,thiet-bi-kts-phu-kien-so,158498862,"Tai Nghe Gaming Plextone xMOWi RX3 Type-c Tích Hợp Micro Chuyên Dụng Dành Cho Chơi Game PUBG COD - Hàng Nhập Khẩu",177821,187180,9359,5
TIKI,thiet-bi-kts-phu-kien-so,31174410,"Chuột chơi game Dare U LM115G Pink - Hàng chính hãng",139000,139000,0,0
TIKI,thiet-bi-kts-phu-kien-so,26289675,"Cáp chuyển đổi HDMI sang VGA, HDMI to VGA có âm thanh (20cm)",33000,33000,0,0
TIKI,thiet-bi-kts-phu-kien-so,101617544,"Jack dây chuyển 2 đầu 3.5 audio và Micro ra 1 đầu 3.5 cho PC laptop",34900,34900,0,0
TIKI,thiet-bi-kts-phu-kien-so,190936461,"Cáp sạc USB-C to Light.ning BOOST↑CHARGE PRO Flex Belkin vỏ silicone bọc dù 60W - Hàng chính hãng - CAA011bt",660000,899000,239000,27
TIKI,thiet-bi-kts-phu-kien-so,71710995,"Bộ Lót Chuột Đệm Kèm Kê Tay Bàn Phím Hoạt Tiết Dễ Thương",266900,266900,0,0
TIKI,thiet-bi-kts-phu-kien-so,106752892,"Giá Đỡ Laptop Hợp Kim Nhôm Cao Cấp Có Thể Gấp Gọn, Giúp Tản Nhiệt Laptop, Macbook, Máy Tính Xách Tay. 07 Vị Trí Điều Chỉnh Góc Độ",74200,74200,0,0
TIKI,thiet-bi-kts-phu-kien-so,186608758,"Ốp lưng silicon dẻo trong suốt cho Samsung Galaxy A52 / A52 5G / A52s hiệu Ultra Thin mỏng 0.6mm độ trong tuyệt đối chống trầy xước - Hàng nhập khẩu",39000,39000,0,0
TIKI,thiet-bi-kts-phu-kien-so,554401,"Đầu Nối HDMI Ugreen (20107) - Hàng Chính Hãng",55000,60000,5000,8
TIKI,thiet-bi-kts-phu-kien-so,78973621,"Vỏ Bao Silicon Cao Cấp Cho Tay Cầm Sony PS5",45000,45000,0,0
TIKI,thiet-bi-kts-phu-kien-so,33786496,"Loa vi tính xí ngầu mini dành cho điện thoại, cho máy tính bảng, cho laptop và cho máy tính để bàn aman",40200,40200,0,0
TIKI,thiet-bi-kts-phu-kien-so,82668652,"Tai nghe Bluetooth nhét tai không dây True wireless earbuds PKCB Hàng Chính Hãng",205000,500000,295000,59
TIKI,thiet-bi-kts-phu-kien-so,273582323,"Dây Đeo Kim Loại Mắt To Cho Mi Band 8/ 7/ 6/ 5/ 4/ 3",125000,199000,74000,37
TIKI,thiet-bi-kts-phu-kien-so,173484024,"Loa thông minh OLLI MAIKA - Đen Nguyên Bản - Hàng Chính Hãng",2390000,2390000,0,0
TIKI,dien-gia-dung,147903537,"Bếp Từ Đơn Sunhouse SHD6157 (1800W) - Kèm Nồi Lẩu - Hàng Chính Hãng",679000,1094000,415000,38
TIKI,dien-gia-dung,57456756,"Máy Lọc Nước RO Hydrogen Ion Kiềm Kangaroo KG100ES 7 Lõi - Hàng Chính Hãng",3980000,12790000,8810000,69
TIKI,dien-gia-dung,173550857,"Máy ép chậm Elmich JEE - 1855OL - Hàng chính hãng (New)",1850000,3890000,2040000,52
TIKI,dien-gia-dung,3140341,"Máy Lọc Nước RO Kangaroo VTU KG108A 8 Lõi - Hàng Chính Hãng",3240000,7570000,4330000,57
TIKI,dien-gia-dung,102432143,"Ấm Đun Siêu Tốc Inox 2 Lớp Sunhouse SHD1351 (1.8 Lít) - Hàng Chính Hãng",239000,422000,183000,43
TIKI,dien-gia-dung,72825272,"Máy Hút Bụi Cầm Tay Không Dây Damas XC628 - Chính Hãng",439000,850000,411000,48
TIKI,dien-gia-dung,52293499,"Máy Cạo Râu Xiaomi Enchen BlackStone 3 - Hàng Nhập Khẩu",250000,500000,250000,50
TIKI,dien-gia-dung,48537880,"Ấm Siêu Tốc Inox SUNHOUSE HAPPY TIME HTD1055 (1.5L) - Hàng Chính Hãng",145000,190000,45000,24
TIKI,dien-gia-dung,91565152,"Máy Lọc Không Khí ULTTY SKJ-CR021 Dạng Quạt, Chế Độ Làm Mát 9 Cấp, Bộ Lọc HEPA H13 Loại Bỏ 99,97% Bụi Mịn, Vi Khuẩn, Virut - Màu Đen - Hàng Chính Hãng",4580000,5850000,1270000,22
TIKI,dien-gia-dung,167433084,"Máy Nấu Chậm Sous Vide SVM11. Kiểm Soát Thời Gian Và Nhiệt Độ Chuẩn Xác. Hàng Nhập Khẩu Chính Hãng SGE Thái Lan",1750000,2900000,1150000,40
TIKI,dien-gia-dung,273310816,"Máy Vắt Cam Lock&Lock EJJ231 (40W) - Hàng chính hãng",223000,452000,229000,51
TIKI,dien-gia-dung,143498816,"Combo Máy Lọc Không Khí U ULTTY SKJ CR021 Dạng Quạt Màu Trắng + Màng lọc HEPA H13 Nano Phân Tử Bạc - Hàng Chính Hãng",4850000,6250000,1400000,22
TIKI,dien-gia-dung,72286199,"Máy UỐN, ÉP, LÀ Tóc Đa Năng 3 Trong 1 Cao Cấp Sang Trọng Kiểu Hàn Quốc - Kết Hợp Duỗi, Uốn, Tạo Kiểu Tóc Thông Minh – Dùng Cho Salon Tóc & Tại Nhà – Chính Hãng VinBuy (Tùy Chọn 2 Màu Trắng Đen)",214000,400000,186000,47
TIKI,dien-gia-dung,72543784,"Máy Sấy Tóc Damas JT3377 (Chính Hãng) - Tay cầm gấp gọn tiện dụng, chế độ bảo vệ nguồn điện, tự động ngắt nguồn chống cháy thiết bị",129000,280000,151000,54
TIKI,dien-gia-dung,3480333,"Bình Đun Siêu Tốc 2 lớp Lock&Lock EJK738WHT (1.7 Lít) - Trắng - Hàng chính hãng",391000,797000,406000,51
TIKI,dien-gia-dung,57588481,"Nồi Điện Đa Năng Lock&Lock EJP116BLK (0.8 Lít) - Hàng Chính Hãng",439000,888000,449000,51
TIKI,dien-gia-dung,73955526,"Máy Lọc Nước Pureit Lavita - CR5240 Chức Năng Làm Nóng Nhiều Cấp Độ Tích Hợp Công Nghệ RO+UV - Hàng Chính Hãng",8125000,12500000,4375000,35
TIKI,dien-gia-dung,33494720,"Máy Sấy Tóc Nagakawa NAG1606 (2000W) - Hàng Chính Hãng",295000,590000,295000,50
TIKI,dien-gia-dung,1644719,"Máy Lọc Nước Pureit Ultima Lọc Nguyên Khối Tích Hợp Công Nghệ RO + UV + MF - Hàng chính hãng",8379000,12400000,4021000,32
TIKI,dien-gia-dung,186272720,"Quạt mini để bàn, quạt tích điện, quạt cầm tay chính hãng CWELL, động cơ không tiếng ồn, xoay 210 độ, pin khủng, bản mới",139000,199000,60000,30
TIKI,dien-gia-dung,4701559,"Ấm Điện Thủy Tinh Siêu Tốc Có Điều Chỉnh Nhiệt Độ Lock&Lock EJK341 (1.8L) - Hàng chính hãng",562000,1145000,583000,51
TIKI,dien-gia-dung,33414955,"Tông đơ cắt tóc xiaomi Enchen Boost phiên bản mới 2020 hàng chính hãng",189000,198900,9900,5
TIKI,dien-gia-dung,55442805,"Máy Lọc Nước Pureit Casa G2 Công Suất Lớn Lọc Nguyên Khối Tích Hợp Công Nghệ RO+MF - Hàng chính hãng",5625000,7500000,1875000,25
TIKI,dien-gia-dung,79410098,"Nồi Cơm Điện Lock&Lock EJR716IVY 0.8L - Hàng Chính Hãng",842000,1703000,861000,51
TIKI,dien-gia-dung,66512832,"Máy Hút Bụi Lock&Lock ENV336BLK (400W) - Hàng Chính Hãng",1599000,3258000,1659000,51
TIKI,dien-gia-dung,20882633,"Máy Hút Bụi Cầm Tay Deerma-Deerma Vacuum Cleaner DX700 - Hàng Chính Hãng",655000,666000,11000,2
TIKI,dien-gia-dung,414764,"Lò Vi Sóng Sharp R-205VN(S) - 20L - Hàng chính hãng",1349000,1690000,341000,20
TIKI,dien-gia-dung,20366631,"Bàn Ủi Hơi Nước Sunhouse SHD2063P (1600W) – Hàng Chính Hãng",230000,332000,102000,31
TIKI,dien-gia-dung,31252905,"Ấm Siêu Tốc Nagakawa NAG0308 (1.8 Lít) - Hàng Chính Hãng",159000,240000,81000,34
TIKI,dien-gia-dung,185860447,"Nồi điện đa năng LocknLock 2 trong 1 nướng lẩu tối ưu 4 chế độ nhiệt (4 Lít)- EJP544WHT - Hàng chính hãng",1089000,2200000,1111000,51
TIKI,dien-gia-dung,885374,"Bàn Ủi Hơi Nước Đứng Philips GC518 (1600W) - Xanh Ngọc - Hàng chính hãng",1399000,2159000,760000,35
TIKI,dien-gia-dung,31252905,"Ấm Siêu Tốc Nagakawa NAG0308 (1.8 Lít) - Hàng Chính Hãng",159000,240000,81000,34
TIKI,dien-gia-dung,71159450,"Máy Lọc Không Khí ULTTY SKJ-CR021 Dạng Quạt, Chế Độ Làm Mát 9 Cấp, Bộ Lọc HEPA H13 Loại Bỏ 99,97% Bụi Mịn, Vi Khuẩn, Virut - Màu Trắng - Hàng Chính Hãng",4550000,5850000,1300000,22
TIKI,dien-gia-dung,186708921,"Máy pha cà phê espresso CF07-PLUS tích hợp xay hạt cà phê 20 mức, đánh bọt sữa, pha espresso 20 bar mạnh mẽ, 4 trong 1 tiện lợi, 2 boilers và DIY kiểm soát nhiệt độ 3 cấp, họng pha chuyên nghiệp 58mm",9790000,9790000,0,0
TIKI,dien-gia-dung,31276266,"Máy Hút Bụi Mini Cầm Tay DEERMA - Hàng Chính Hãng",489000,699000,210000,30
TIKI,dien-gia-dung,684651,"Ấm Siêu Tốc Inox Happy Time Sunhouse HTD1081 (1.8 lít)- Hàng chính hãng",141000,220000,79000,36
TIKI,dien-gia-dung,392067,"Bàn Ủi Khô Philips HD1172/01 (1000W) - Hàng chính hãng",299000,369000,70000,19
TIKI,dien-gia-dung,35216213,"Máy cạo râu Xiaomi Enchen BlackStone - Hàng Nhập Khẩu",189000,214500,25500,12
TIKI,dien-gia-dung,68771348,"Nồi Cơm Điện Mini Lock&Lock EJR426 Dung Tích 0.8 lít (Hàng chính hãng)",569000,1000000,431000,43
TIKI,dien-gia-dung,10597625,"Máy Xay Thịt 2 Lưỡi Dao Kép Lock&Lock EJM171 (2 Lít - 300W) - Hàng Chính Hãng",706000,1434000,728000,51
TIKI,dien-gia-dung,48025254,"Máy Xay Sinh Tố Lock&Lock EJM436MIT (250W - 600ml) - Hàng chính hãng",457000,920000,463000,50
TIKI,dien-gia-dung,630207,"Bình Đun Siêu Tốc Sunhouse HTD1088 (1.8 lít) - Hàng chính hãng",150000,220000,70000,32
TIKI,dien-gia-dung,71159586,"Nồi Chiên Không Dầu Điện Tử Lock&Lock EJF296BLK (7.2 Lít) - Kèm Chảo Nướng - Hàng Chính Hãng",2089000,5625000,3536000,63
TIKI,dien-gia-dung,104850983,"Quạt mini để bàn, quạt USB tích điện cầm tay CTFAST - M109 : Thiết kế thông minh 3 tốc độ làm mát, chất liệu cao cấp bền bỉ, điều chỉnh 360 độ, không gây ồn, pin sạc 1200mah, dễ dàng mang theo sử dụng - hàng chính hãng",140000,199000,59000,30
TIKI,dien-gia-dung,91978576,"Nồi cơm điện áp suất Cuckoo CRP-PK1000S 1,8 lít nhiều màu - Hàng chính hãng",3990000,4990000,1000000,20
TIKI,dien-gia-dung,36626940,"Nồi Chiên Không Dầu Điện Tử Lock&Lock EJF357BLK (5.2 Lít) - Hàng Chính Hãng",1899000,5215000,3316000,64
TIKI,dien-gia-dung,48962414,"Lò Vi Sóng Sharp R-208VN-WS (20L) - Hàng Chính Hãng",1250000,1560000,310000,20
TIKI,dien-gia-dung,193916643,"Lõi Lọc RO Pureit Delica UR5840 Âm Tủ Bếp (DIY), Hàng Chính Hãng",2375000,2500000,125000,5
TIKI,dien-gia-dung,36785535,"Bếp Từ Đơn Lock&Lock EJI411 (2000W) - Hàng Chính Hãng",1083000,2188000,1105000,51
TIKI,dien-gia-dung,59479717,"Máy sấy tóc Philips BHC010/10 - Hàng Chính Hãng",289000,395000,106000,27
TIKI,dien-gia-dung,272895791,"Nồi cơm điện thông minh GAABOR dung tích lớn lòng nồi 1.2L - 1.8L - Hàng chính hãng",459000,879000,420000,48
TIKI,dien-gia-dung,147903536,"Bếp Từ Đơn Sunhouse SHD6803 (1800W) - Kèm Nồi Lẩu - Hàng Chính Hãng",894000,1187000,293000,25
TIKI,dien-gia-dung,8420020,"Nồi Cơm Điện Kangaroo KG822 (1.2L) - Hàng chính hãng",625000,1150000,525000,46
TIKI,dien-gia-dung,794609,"Máy Nướng Bánh Mì Lock& Lock EJB221BLU (730 - 870 W) - Hàng chính hãng",512000,1043000,531000,51
TIKI,dien-gia-dung,22095571,"Bàn Ủi Khô Nagakawa NAG1502 (1200W) - Màu Ghi - Hàng Chính Hãng",151000,255000,104000,41
TIKI,thiet-bi-kts-phu-kien-so,184573164,"Ốp Lưng Dành Cho Samsung Galaxy A73 5G Chính Hãng Nillkin Dạng Sần Viền Dẻo Chống Sốc - Hàng Chính Hãng",119997,119997,0,0
TIKI,thiet-bi-kts-phu-kien-so,195959922,"Ốp Bảo Vệ Case TPU Dành Cho Airpods 3 Nhiều Mẫu Cute",80750,85000,4250,5
TIKI,thiet-bi-kts-phu-kien-so,20610969,"Ốp lưng da cao cấp dành cho iPhone XR",129000,159000,30000,19
TIKI,thiet-bi-kts-phu-kien-so,136684907,"Tai Nghe Nhét Tai Chống Ồn Gaming XSmart G10 Cao Cấp Siêu Ngầu Dùng Cho Cả Máy Tính, Điện Thoại, Có Mic Rời, Tặng Bộ Phụ Kiện - Hàng Chính Hãng",199000,199000,0,0
TIKI,thiet-bi-kts-phu-kien-so,88916772,"Bộ Củ Sạc CHOETECH PD 3.0 20W PD5005-W Và Cáp Type-C To Lightning MFI Apple 1.2M IP0039 Sạc Nhanh 20W cho iPhone, cho iPad - Hàng Chính Hãng",429000,790000,361000,46
TIKI,thiet-bi-kts-phu-kien-so,50721406,"Micro có dây jack 6.5 ly dành cho loa bluetooth có kèm chức năng hát karaoke P88,P89... (JULY) HÀNG NHẬP KHẨU",24000,24000,0,0
TIKI,thiet-bi-kts-phu-kien-so,192795616,"Chuột không dây HXSJ T67 Receiver USB 2.4G - Hàng Chính Hãng",149000,289000,140000,48
TIKI,thiet-bi-kts-phu-kien-so,139398766,"COMBO KÍNH CƯỜNG LỰC DẺO CAMERA + VIỀN KIM LOẠI BẢO VỆ CAMERA DÀNH CHO IPHONE 6/6S/6+/6S+ 7/8 7/8+ X XR XSMAX",29000,29000,0,0
TIKI,thiet-bi-kts-phu-kien-so,184768998,"Dây nguồn số 8 cao cấp Honjianda - Hàng chính hãng",66000,66000,0,0
TIKI,thiet-bi-kts-phu-kien-so,124976828,"Đầu Chuyển Đổi OTG Cổng Type-C Sang USB 3.0 - ROBOT RT-OTG04 - Chất Liệu Vỏ Kim Loại - Hàng Chính Hãng",65000,65000,0,0
TIKI,thiet-bi-kts-phu-kien-so,160068422,"Đầu đọc thẻ nhớ  USB 2.0 tốc độ cao dành cho mọi hệ điều hành ",79000,79000,0,0
TIKI,thiet-bi-kts-phu-kien-so,92910950,"Bao Case TPU Trong Suốt Colour cho tai nghe Galaxy Buds Live/ Buds Pro/ Buds 2/ Buds2 Pro Kèm Móc Treo",79000,79000,0,0
TIKI,thiet-bi-kts-phu-kien-so,140634860,"Tai Nghe Bluetooth Cảm Ứng Cao Cấp Tích Hợp Sạc Dự Phòng 2500mAh + Giá Đỡ Điện Thoại, Bass Cực Hay Và Kháng Nước Tốt F9",87000,87000,0,0
TIKI,thiet-bi-kts-phu-kien-so,103670110,"Rapoo C280 Webcam 2K HD với USB2.0 với nắp đậy camera có thể xoay mic - hàng Chính Hãng",820000,820000,0,0
TIKI,thiet-bi-kts-phu-kien-so,125772028,"Case ốp dành cho macbook kèm tấm phủ phím - Hàng chính hãng",279000,279000,0,0
TIKI,thiet-bi-kts-phu-kien-so,6608141,"Bộ chuyển đổi USB Type C sang LAN 10/100 Mbps Ethernet UGREEN 30287 - Hàng chính hãng",301000,320000,19000,6
TIKI,thiet-bi-kts-phu-kien-so,178329646,"Ốp Silicone Kai Full Color cho Sony WF-1000XM4 - Hàng Chính Hãng",113050,119000,5950,5
TIKI,thiet-bi-kts-phu-kien-so,158693009,"Combo 2 kính cường lực Gor cho iPhone 14 Promax/ 14 Pro/ 14 Plus/ 14/ 13 Mini / 13 / 13 Pro / 13 Pro Max - Hàng Chính Hãng",142500,150000,7500,5
TIKI,thiet-bi-kts-phu-kien-so,143963350,"Micro karaoke Bluetooth cao Cấp Cắm thẻ nhớ 3 trong 1 Hàng chính hãng",406000,900000,494000,55
TIKI,thiet-bi-kts-phu-kien-so,191375629,"Tai Nghe Phone Nhét Tai Nghe Nhạc Chơi Game Teement Qkz Ak2 Pro Mới Nhất Âm Thanh Super Bass, Dây Chống Rối, Có Mic Đàm Thoại Tương Thích Điện Thoại Máy Tính Bảng Laptop Pc - Hàng Chính Hãng",125000,125000,0,0
TIKI,thiet-bi-kts-phu-kien-so,21264038,"Chuột Gaming Bluetooth Sạc Pin e-sports, Led 7 màu - Tặng lót chuột siêu đẹp",220600,220600,0,0
TIKI,thiet-bi-kts-phu-kien-so,184245802,"Tai nghe chụp tai/ Monitor Headphones - Hoco W21 - Jack 3.5mm, Loa ngoài 40mm, Mic đàm thoại, Dây dài 1.2m, Mút đệm chống ồn và chống đau tai - Màu ngẫu nhiên - Hàng chính hãng",210000,210000,0,0
TIKI,thiet-bi-kts-phu-kien-so,192155214,"Kính Cường Lực Dán Màn Hình Cho iPad 7.9 inch / iPad 9.7 inch/ iPad 10.2 inch / iPad 10.9 inch / iPad 11 inch",48000,48000,0,0
TIKI,thiet-bi-kts-phu-kien-so,60823301,"Deskpad kiêm tấm lót di chuột 90 x 45cm thảm trải bàn làm việc 2 mặt 2 màu",110000,110000,0,0
TIKI,thiet-bi-kts-phu-kien-so,129728670,"Mút dành cho tai nghe sony MDR-XB450, XB450AP, XB550AP, XB650BT",163900,163900,0,0
TIKI,thiet-bi-kts-phu-kien-so,107939646,"[VIDEO]- Hộp đựng dây sạc, cóc sạc điện thoại bằng mica trong suốt- Khay đựng remote, phụ kiện đa năng mẫu mới, sang trọng- Chọn mẫu theo ý",89000,89000,0,0
TIKI,thiet-bi-kts-phu-kien-so,56461019,"Giá đỡ điện thoại gập gọn 180 độ - đế đỡ 90 độ - NH41",18800,18800,0,0
TIKI,thiet-bi-kts-phu-kien-so,32744415,"Nguồn điện biến thế adapter 220V ra 12V 2A 24W",49000,49000,0,0
TIKI,thiet-bi-kts-phu-kien-so,26273641,"Ốp Dẻo Trong Suốt Dành Cho Huawei Nova 3i",12000,12000,0,0
TIKI,thiet-bi-kts-phu-kien-so,155292688,"Giá Đỡ Tản Nhiệt Dành Cho Macbook, Laptop Từ 9 Đến 17 Inch Khung Nhôm Cao Cấp CHOETECH H033 - Hàng Chính Hãng",269000,490000,221000,45
TIKI,thiet-bi-kts-phu-kien-so,102103822,"TỤ QUẠT 2,5UF 400VAC 50/60HZ",7990,7990,0,0
TIKI,thiet-bi-kts-phu-kien-so,155631011,"Bàn Phím Cơ Gaming K80 LED RGB 20 Chế Độ Nháy Cực Đẹp, Phím CƠ Gõ Siêu Đã, Thiết Kế Nhỏ Gọn Dùng Cho Máy Tính, Laptop - Hàng Chính Hãng",499000,499000,0,0
TIKI,thiet-bi-kts-phu-kien-so,36723120,"Ốp lưng silicon dẻo trong suốt dành cho Nokia 7.2 siêu mỏng 0.6mm",12000,12000,0,0
TIKI,thiet-bi-kts-phu-kien-so,2774949,"Túi Chống Sốc Lưới (Size 14 inch / 15.6 inch)",23531,23531,0,0
TIKI,thiet-bi-kts-phu-kien-so,192354940,"Ốp Lưng dành cho iPhone 11 RINGKE Fusion - Hàng Chính Hãng",270000,270000,0,0
TIKI,thiet-bi-kts-phu-kien-so,145243983,"Bộ 2 kính cường lực cho Google Pixel 6 trong suốt, siêu mươt ( hộp 2 kính) Hàng nhập khẩu",99000,99000,0,0
TIKI,thiet-bi-kts-phu-kien-so,76195375,"Giá Đỡ Để Bàn Điện Thoại Di Động, Máy Tính Bảng, Ipad Hợp Kim Nhôm Cao Cấp, Có Thể Điều Chỉnh 7 Góc Nghiêng; Mầu Trắng S650- Hàng Nhập Khẩu",225998,350000,124002,35
TIKI,thiet-bi-kts-phu-kien-so,15704389,"Ốp lưng nhám siêu mỏng 0.3mm cho Samsung Galaxy Note 8 có gờ bảo vệ camera",85000,85000,0,0
TIKI,thiet-bi-kts-phu-kien-so,165865088,"Tai nghe bluetooth Sabbat X12 ultra - Sabbat X12 pro - Hàng chính hãng",880000,880000,0,0
TIKI,thiet-bi-kts-phu-kien-so,143416791,"Loa Bluetooth nghe nhạc không dây 100W công suất lớn Super Bass có cổng usb, thẻ nhớ, line 3.5mm pin 10400MAH sạc Type C Chip DSP TWS lên 200W cao cấp Hàng Chính Hãng PKCB",2300000,4600000,2300000,50
TIKI,o-to-xe-may-xe-dap,1254663,"Dung Dịch Vệ Sinh Ghế Da Ghế Nỉ Liqui Moly 1539 (300ml)",166250,175000,8750,5
TIKI,o-to-xe-may-xe-dap,45228856,"gương chiếu hậu 744 dành cho các loại xe máy",189000,189000,0,0
TIKI,o-to-xe-may-xe-dap,176419459,"BẠT TRÙM / TẤM PHỦ TẤT CẢ CÁC LOẠI XE MÁY KÍCH THƯỚC 220x115cm, LÀM TỪ VẢI DÙ 2 DA CAO CẤP ,BỀN ĐẸP, CHỐNG MƯA NẮNG",140000,140000,0,0
TIKI,o-to-xe-may-xe-dap,118298081,"Đệm lót baga sau xe đạp bọc da Kích thước 32x16x5cm",99000,99000,0,0
TIKI,o-to-xe-may-xe-dap,94421463,"Máy phun sương tạo ẩm, xông tinh dầu trên xe ô tô, xe hơi nhãn hiệu Baseus DHSG-OG Công suất: 5W - Hàng nhập khẩu",332899,332899,0,0
TIKI,o-to-xe-may-xe-dap,147587752,"Trang trí cửa gió điều hòa, màn hình DVD Oto Set tình nhân vô cùng dễ thương",75050,79000,3950,5
TIKI,o-to-xe-may-xe-dap,95548201,"Rèm che nắng cửa xe ô tô xe hơi rèm lụa hít nam châm mẫu mới cao cấp",143998,143998,0,0
TIKI,o-to-xe-may-xe-dap,55776431,"Miếng Lót Ghế Tản Nhiệt",318000,318000,0,0
TIKI,o-to-xe-may-xe-dap,142430480,"Xi nhan led kiểu ( cho xe vario, click, ex, winnerx...) ( 1 cặp)",60000,60000,0,0
TIKI,o-to-xe-may-xe-dap,150494298,"Bộ sạc điện thoại trên xe máy kèm đồng hồ báo vôn ắc quy 2in1 gắn chân gương mẫu mới loại tốt lắp các xe",177000,177000,0,0
TIKI,o-to-xe-may-xe-dap,45557646,"Đệm Ngồi Cao Cấp Bullsone (43 x 41.5 x 2.5 cm)",2322000,2500000,178000,7
TIKI,o-to-xe-may-xe-dap,89399623,"Dụng cụ đa năng Lezyne RAP II Tool",650000,650000,0,0
TIKI,o-to-xe-may-xe-dap,140747833,"Găng tay đa năng rửa xe ô tô và lau dọn nội thất",15000,15000,0,0
TIKI,o-to-xe-may-xe-dap,129224172,"Gương chiếu hậu 5 cạnh dành cho xe máy.lẻ 1 cái trái",89500,89500,0,0
TIKI,o-to-xe-may-xe-dap,74418639,"Bộ Móc Treo Xe Đạp Giúp Nâng Xe Đạp/ Vật Dụng Treo Lên Trần Nhà Gọn Gàng Với Móc Dây Ròng Rọc Polly Mai Lee",192000,209000,17000,8
TIKI,o-to-xe-may-xe-dap,142858485,"DẦU ĐÁNH BÓNG ĐÁ HOA CƯƠNG, DẦU ĐÁNH BÓNG ĐÁ SELF",280000,382500,102500,27
TIKI,o-to-xe-may-xe-dap,31417953,"Bộ 4 Miếng Decal Phản Quang Dán Cánh Cửa Ô Tô OPEN Cao Cấp AZONE",13000,13000,0,0
TIKI,o-to-xe-may-xe-dap,36132352,"Đồng Hồ Đo Áp Suất Lốp Chuyên Dụng Cho Ô Tô, Xe Máy",96000,96000,0,0
TIKI,o-to-xe-may-xe-dap,143427270,"XE ĐẠP THỂ THAO CỠ 20 INCH cho bé 7 tuổi - 11 TUỔI + Tặng kèm giỏ xe, gácbaga, túi, bình nước",1159000,1159000,0,0
TIKI,o-to-xe-may-xe-dap,131337378,"Túi Hành Lý Sau Xe Đạp - Túi Đôi Đựng Gác ba Ga Xe Đạp Loại Tốt",199000,199000,0,0
TIKI,o-to-xe-may-xe-dap,113404939,"Kính Chắn Gió Xe Máy Cao Cấp, kính chắn bụi chắn gió xe máy",175000,175000,0,0
TIKI,o-to-xe-may-xe-dap,33388584,"Cặp Phuộc kiểu Lò Xo Màu dành cho Wave,Dream BẢO LONG RACING",365000,365000,0,0
TIKI,o-to-xe-may-xe-dap,58400468,"Kính thay cho nón bảo hiểm kính âm Royal M139 - Chỉ có kính",123000,150000,27000,18
TIKI,o-to-xe-may-xe-dap,3151283,"Nước Rửa Kính Ô Tô Focar Screen Wash (2.75L)",98000,119000,21000,18
TIKI,o-to-xe-may-xe-dap,182830496,"Thảm taplo xe ô tô da carbon Tâm Luân chống nắng và chống nóng không thấm nước (26 dòng xe - đời xe)",196000,300000,104000,35
TIKI,o-to-xe-may-xe-dap,96036139,"Bộ Sửa Xe Đạp Đa Năng SAHOO Kèm Bơm Và Miếng Vá",239000,239000,0,0
TIKI,o-to-xe-may-xe-dap,113406436,"Đệm yên sau xe đạp có tựa lưng",114400,114400,0,0
TIKI,o-to-xe-may-xe-dap,21031001,"KÍNH CHIẾU HẬU YAZ ( YAZ ) DÀNH CHO CÁC DÒNG XE YA - LOẠI 1",47000,47000,0,0
TIKI,o-to-xe-may-xe-dap,35966309,"Túi Ghi Đông Treo Đầu Xe Máy_ xem điện thoại, chứa đồ. Đi phượt, chạy Grab 4.7",75000,75000,0,0
TIKI,o-to-xe-may-xe-dap,53468704,"Xi cana đánh bóng vết xước xe máy, ô tô",44460,46800,2340,5
TIKI,o-to-xe-may-xe-dap,34155820,"Đèn 5 LED Cảnh báo sau Xe Đạp giúp đạp xe an toàn ban đêm 4 chế độ sáng (Đèn Đỏ) Mai Lee - Hàng chính Hãng",27550,29000,1450,5
TIKI,o-to-xe-may-xe-dap,18003080,"Kính rời mũ bảo hiểm GRS",119000,119000,0,0
TIKI,o-to-xe-may-xe-dap,15464116,"Đèn 5 LED Cảnh báo sau Xe Đạp giúp đạp xe an toàn ban đêm 4 chế độ sáng (Đèn Xanh)",24800,24800,0,0
TIKI,o-to-xe-may-xe-dap,25968384,"ĐÈN HẬU NHÁY XE MÁY 33 TIM (CHIẾC)",27549,28999,1450,5
TIKI,o-to-xe-may-xe-dap,230247648,"Máy bơm lốp ô tô, xe hơi tự ngắt Michelin 4398ML (12266) động cơ mạnh mẽ 180W cho áp suất tối đa 150PSI, tốc độ bơm nhanh 35l/phút",1034000,1034000,0,0
TIKI,o-to-xe-may-xe-dap,273320873,"Đồng hồ trang trí xe hơi đủ logo các hãng xe (dán táp lô hoặc gắn cửa gió) - Tặng thêm 1 pin",94000,129000,35000,27
TIKI,o-to-xe-may-xe-dap,139949826,"Nước hoa ô tô xe hơi cao cấp đặt taplo ô tô khử mùi chống say xe chiết xuất hoàn toàn từ thiên",220000,220000,0,0
TIKI,o-to-xe-may-xe-dap,71542488,"Máy xông tinh dầu xe ô tô vân gỗ cao cấp chuyên dụng, Máy khuếch tán tinh dầu xe hơi lan tỏa hương thơm, khử mùi và trang trí cho xe",198000,556000,358000,64
TIKI,o-to-xe-may-xe-dap,272129048,"Kem đánh bóng sơn xe ô tô (Car Cream) Karshine 250g KA-CC250",79000,79000,0,0
TIKI,o-to-xe-may-xe-dap,38078759,"Bộ Đổi Nguồn Từ 220V Sang Ổ Cắm Ô Tô 12V, Bộ chuyển đổi có giắc cắm tẩu chuyên dụng giống hệt với giắc cắm trên xe",68000,68000,0,0
TIKI,lam-dep-suc-khoe,84872693,"Set 6 Lô Cuốn Tóc Nhiều Màu Tiện Dụng Cho Nữ",34900,34900,0,0
TIKI,lam-dep-suc-khoe,41263241,"Vitamin tổng hợp cho bà bầu Pregnacare Max 84 viên",395000,531250,136250,26
TIKI,lam-dep-suc-khoe,178559962,"Xà Bông Nghệ MELA Thiên Nhiên, Làm Sạch Da Sáng Khoẻ, Tẩy Da Chết Thoáng Lỗ Chân Lông Hỗ Trợ Giảm Mụn Lưng - ML05",80000,80000,0,0
TIKI,lam-dep-suc-khoe,83423219,"Khẩu trang y tế 4 lớp kháng khuẩn May 10 chính hãng",40000,40000,0,0
TIKI,lam-dep-suc-khoe,631042,"Miếng làm sạch da mặt ngăn ngừa mụn, tẩy tế bào chết Oxy Perfect Clear Pad 55 miếng",89100,93500,4400,5
TIKI,lam-dep-suc-khoe,94583728,"DỤNG CỤ CẦM TAY LÀM ĐẸP CẮT TỈA LÔNG MŨI CAO CẤP AKMEI",35000,50000,15000,30
TIKI,lam-dep-suc-khoe,98675681,"Hộp Khẩu Trang 2D Trẻ Em 3 Lớp ANYGUARD Chính Hãng - Lọc 99% Vi Khuẩn - Họa Tiết Cá - Dành Cho Bé Từ 2 Đến 4 tuổi (Hộp 50 cái) - Đạt Tiêu Chuẩn QCVN 01:2017/BTC, ISO 9001:2015, ISO 13485:2016",135000,150000,15000,10
TIKI,lam-dep-suc-khoe,271570469,"Canxi cho người lớn Kirkland Calcium thêm: Mange, Kẽm, Vitamin B6, D, B6 giúp giảm đau nhức xương khớp, phòng loãng xương, ngủ ngon - Massel Official",254000,598000,344000,58
TIKI,lam-dep-suc-khoe,45033442,"Máy phun tinh dầu phòng ngủ Thiên Ý Tạo Ẩm Khuếch Tán Tinh Dầu Kèm Đèn Ngủ,  không gây ồn, tặng kèm điều khiển từ xa và tinh dầu sả chanh Kobi",339000,652000,313000,48
TIKI,lam-dep-suc-khoe,175830661,"Dung dịch nhỏ mắt Sanlein Dry Eye 0.1% hỗ trợ giảm khô mắt (5ml)",63000,63000,0,0
TIKI,lam-dep-suc-khoe,77749623,"Tinh Dầu Quế 50ML + Tinh Dầu Quế Treo Xe ô Tô Treo Phòng Gia Đình (Cinnamon) - Tinh Dầu Vỏ Quế Nguyên Chất Xông Phòng Giúp Bảo Vệ Sức Khỏe, Kháng Khuẩn Và Thư Giãn Tinh Thần",128000,256000,128000,50
TIKI,lam-dep-suc-khoe,184767648,"Tinh dầu thiên nhiên treo xe hơi, tủ áo Lorganic, hương thơm thiền tịnh",45000,45000,0,0
TIKI,lam-dep-suc-khoe,270687455," Dung dịch vệ sinh phụ khoa cao cấp Femfresh giúp làm sạch thơm, kháng viêm, kháng khuẩn, phòng viêm nhiễm cho cả nữ và nam - QuaTangMe Extaste",99000,99000,0,0
TIKI,lam-dep-suc-khoe,78021090,"Hộp 10 miếng mặt nạ dưỡng trắng và ngừa lão hoá Truesky Integrated Mask chiết xuất hoa hồng đá 25g/miếng",250000,250000,0,0
TIKI,lam-dep-suc-khoe,193916624,"Bộ 4 đầu thay thế máy tăm nước Lock&Lock ENR126WHT_RB - Hàng chính hãng - JoyMall",129000,186000,57000,31
TIKI,dien-gia-dung,37709143,"Tông đơ cắt tóc KEMEI 1997",599000,599000,0,0
TIKI,lam-dep-suc-khoe,102007801,"Máy massage cầm tay 5 đầu  Relax & tone masage toàn thân",134999,134999,0,0
TIKI,lam-dep-suc-khoe,40769633,"Dầu gội hỗ trợ trị gàu ALCORAL 60ml",57000,68000,11000,16
TIKI,lam-dep-suc-khoe,68188298,"Khẩu Trang Y Tế 5D Trẻ Em Nam Anh - Hộp 10 cái",9900,18000,8100,45
TIKI,lam-dep-suc-khoe,31494288,"The Ordinary Caffeine Solution 5% + EGCG - Thần Dược Giải Quyết Mọi Vấn Đề Của Mắt 30ml",339000,339000,0,0
TIKI,dien-gia-dung,23411036,"Máy Hút Bụi DEERMA DX700 ( hàng nhập khẩu )",655000,658500,3500,1
TIKI,lam-dep-suc-khoe,116583499,"Mật Ong Nguyên Chất Hoa Vải Cvdbeheoney loại 90ml(125g) ",15000,15000,0,0
TIKI,lam-dep-suc-khoe,76120881,"Combo 2 Tinh Dầu Sả Chanh + Tinh Dầu Vỏ Quế TIDAMO Nguyên Chất Nhập Khẩu - Tinh Dầu Xông Phòng Cao Cấp Giúp Thư Giãn, Thơm Phòng, Bảo Vệ Sức Khỏe và Đuổi Muỗi (2 chai 10ML)",66300,118000,51700,44
TIKI,lam-dep-suc-khoe,83344090,"Combo 4 Nước súc miệng Colgate diệt 99% vi khuẩn Plax trà xanh và Plax bạc hà 500ml/chai",416000,416000,0,0
TIKI,lam-dep-suc-khoe,143786928,"Combo 2 Tinh Dầu Oải Hương 50ML + Tinh Dầu Bạc Hà 50ML Nguyên Chất Chính Hãng TIDAMO, Xông Thơm Phòng Giúp Thư Giãn và Nâng Cao Sức Khỏe, Rất Tốt Khi Sử Dụng Với Máy Xông Tinh Dầu",158000,436000,278000,64
TIKI,dien-gia-dung,230086770,"Máy Trộn Bột Đánh Trứng Đa Năng UNIE EM2 Cao Cấp Tiêu Chuẩn Đức Dung Tích 5 Lít Công Suất 1000 W - Hàng Chính Hãng",3029000,6039000,3010000,50
TIKI,lam-dep-suc-khoe,105774928,"Hộp 2 nhíp inox cao cấp nhổ tỉa lông mày Kai (1 nhíp đầu to & 1 nhíp đầu nhỏ) tặng thun buộc tóc 10g",119000,119000,0,0
TIKI,dien-gia-dung,50363603,"Bàn ủi du lịch xịn - Bàn là hơi nước mini hàng hiệu màu Trắng Sữa",530000,530000,0,0
TIKI,lam-dep-suc-khoe,157208662,"Túi Refill Cà phê Đắk Lắk làm sạch da chết cơ thể Cocoon cho làn da mềm mại & rạng rỡ 600ml",250000,250000,0,0
TIKI,lam-dep-suc-khoe,116189274,"Kìm cắt móng tay, móng chân, kìm cắt da chết bằng thép không gỉ siêu sắc  tặng kèm thanh nạy móng (mầu sắc ngẫu nhiên)",79000,79000,0,0
TIKI,lam-dep-suc-khoe,52139397,"Combo 3 Tinh dầu SENSELAB nhập khẩu Ấn Độ: Tinh Dầu Sả Chanh (10ml) + Tinh Dầu Oải Hương (10ml) + Tinh Dầu Bạc Hà (10ml) - Tinh dầu thiên nhiên nguyên chất",150000,150000,0,0
TIKI,dien-gia-dung,73607646,"Bếp gas mini nhỏ gọn, tiện lợi, chất liệu cao cấp dễ dàng mang theo khi đi du lịch, cắm trại ",73000,73000,0,0
TIKI,lam-dep-suc-khoe,878391,"Tỏi Đen Kim Cương Đông Á - Tỏi Đen Cô Đơn (Túi 200g)",230000,230000,0,0
TIKI,dien-gia-dung,176716144,"Quạt điều khiển và quạt nút vặn cơ- 3 Tốc độ- Hướng xoay và kích thước quạt điều chỉnh linh hoạt- Hàng chính hãng",680000,680000,0,0
TIKI,dien-gia-dung,1860525,"Nồi Áp Suất Điện Đa Năng Sunhouse SHD1562 (6L) - Cafe - Hàng chính hãng",992000,992000,0,0
TIKI,dien-gia-dung,39186205,"Bếp gas đôi dương Rinnai RV-375 SW(N) (Trắng)- Hàng chính hãng",967939,967939,0,0
TIKI,lam-dep-suc-khoe,205014161,"Bao cao su Rocmen Long Shock - Kéo dài thời gian - Hộp 12 cái",60000,60000,0,0
TIKI,dien-gia-dung,186742016,"Bình Đun Siêu Tốc Panasonic NC-K301SRA (1,7 lít) - Hàng chính hãng",980000,1002000,22000,2
TIKI,lam-dep-suc-khoe,77026005,"Dầu Gội Thảo Dược Bồ Kết Tóc Mây Ngăn Ngừa Tóc Gãy Rụng An Toàn Từ Thiên Nhiên Không Chứa Hóa Chất Giảm Gàu Và Ngứa Da Đầu Cỏ Mềm 300g",325000,325000,0,0
TIKI,lam-dep-suc-khoe,36261358,"Kem tan mỡ Missha Hot Burning Perfect Body Gel Hàn Quốc",145000,159000,14000,9
TIKI,lam-dep-suc-khoe,12478891,"Gel Rửa Mặt Cho Da Mụn Ducray Keracnyl Gel Innova Myrtacine (200ml)",412000,485000,73000,15
TIKI,dien-gia-dung,2890867,"Lò vi sóng inverter có nướng Panasonic PALM-NN-GD37HBYUE (23L) - Hàng chính hãng",4290000,4290000,0,0
TIKI,lam-dep-suc-khoe,8142233,"Kềm Cắt Móng Thép Chuyên Dụng Kềm Nghĩa M-306",69000,69000,0,0
TIKI,dien-gia-dung,128820551,"Máy xay hạt và phê và các loại hạt ngũ cốc Shardor CG638B công suất 150W - Hàng Nhập Khẩu",1005000,1005000,0,0
TIKI,lam-dep-suc-khoe,149975014,"Hộp Quà Tặng Tinh Dầu TOKI MORI Cao Cấp, Xuất Khẩu Nhật Bản 6x10ml, Nguyên Chất Thiên Nhiên - Cam Ngọt, Bạc Hà, Sả Chanh, Vỏ Quế, Tràm Gió, Vỏ Bưởi",499000,499000,0,0
TIKI,lam-dep-suc-khoe,74854269,"Tinh Dầu Vỏ Quế Nguyên Chất Nhập Khẩu Ấn Độ 100ML. Tinh Dầu Quế Cao Cấp Để Xông Phòng Kháng Khuẩn, Phòng Tránh Cảm Cúm - Dùng Với Máy Khuếch Tán Tinh Dầu",198000,396000,198000,50
TIKI,lam-dep-suc-khoe,180322040,"Dầu chăm sóc da từ Thiên Nhiên giúp giảm rạn dạ, mờ sẹo cho da nhạy cảm - BIO-OIL SKINCARE OIL (NATURAL) (chai 60ml)",230000,250000,20000,8
TIKI,lam-dep-suc-khoe,270885590,"Tinh chất dưỡng Mi DHC Eyelash Tonic giúp dày và dài lông mi, chống gãy rụng lông mi - QuaTangMe Extaste",345000,690000,345000,50
TIKI,lam-dep-suc-khoe,39089019,"Sữa Dưỡng Ẩm Toàn Thân Và Da Mặt Cetaphil Moisturizing Lotion (200ml)",289000,316000,27000,9
TIKI,lam-dep-suc-khoe,52625719,"Đai Chống Gù Lưng Cải Thiện Cột Sống người lớn dân văn phòng giúp cải thiện gù lưng tăng chiều cao và thân hình cân đối",145000,145000,0,0
TIKI,dien-gia-dung,189702459,"Bộ chổi lăn thay thế Máy hút bụi lau sàn khô và ướt Roborock Dyad - Hàng chính hãng",590000,590000,0,0
TIKI,lam-dep-suc-khoe,71669650,"Tinh chất kháng mụn mờ thâm The INKEY List Niacinamide 30ml",329000,329000,0,0
TIKI,dien-gia-dung,185578084,"Bàn ủi hơi nước Philips GC482 - Hàng Chính Hãng",1440000,1860000,420000,23
TIKI,dien-gia-dung,146097554,"Combo 3 lõi lọc nước Karofi 1,2,3 dùng cho máy S-S038 - Hàng chính hãng",175000,175000,0,0
TIKI,lam-dep-suc-khoe,241982269,"Máy mát xa cổ cao cấp, có chườm nóng - 4 đầu tiếp xúc, 6 chế độ massage khác nhau, 9 cường độ massage - Màu Trắng",130000,130000,0,0
TIKI,lam-dep-suc-khoe,2869347,"La Roche-Posay - Gel Rửa Mặt Tạo Bọt Cho Da Dầu Nhạy Cảm Effaclar Purifying Foaming Gel 200ml",340000,410000,70000,17
TIKI,lam-dep-suc-khoe,2254547,"Viên uống điều hòa nội tiết tố nữ, nuôi dưỡng da Solgar Dầu Anh Thảo Evening Primrose Oil 1300 mg - NHẬP KHẨU USA",981818,981818,0,0
TIKI,lam-dep-suc-khoe,77655821,"MÁY KHUẾCH TÁN TINH DẦU CỔ CAO MODEL 4G CAO CẤP CHUYÊN DỤNG - MÁY XÔNG TINH DẦU PHUN SƯƠNG, GIÚP TỎA HƯƠNG TINH DẦU, THƯ GIẢN, THÍCH HỢP DÙNG CHO PHÒNG LỚN - TẶNG KÈM REMOTE",286000,286000,0,0
TIKI,lam-dep-suc-khoe,29345245,"Dầu gội Paul Mitchell Tea Tree Special shampoo trà xanh bạc hà ngăn gàu kháng khuẩn Mỹ 300ml",450000,450000,0,0
TIKI,lam-dep-suc-khoe,58105443,"HỘP 30 CHIẾC BÀN CHẢI ĐÁNH RĂNG THAN TRE HOẠT TÍNH",139000,139000,0,0
TIKI,lam-dep-suc-khoe,136690839,"Dầu Gội Head Và Shoulders",212000,239000,27000,11
TIKI,dien-gia-dung,52789747,"Quạt điều hòa hơi nước 40 Lít  YH38A  mặt kính cường lực",1300000,1300000,0,0
TIKI,dien-gia-dung,101972521,"LƯỚI LỌC THÔ CHO MÁY LỌC KHÔNG KHÍ HAFELE/532.86.236 - HÀNG CHÍNH HÃNG (DÒNG MÁY CF-8116/ CF-8126S/ CF- 8209)",990000,990000,0,0
TIKI,dien-gia-dung,51200047,"Nồi Chiên Không Dầu Philips HD9745 (1500W) - Hàng Chính Hãng",4999000,5985000,986000,16
TIKI,dien-gia-dung,165286204,"ĐẦU QUẠT ĐỨNG 3HT - HÀNG CHÍNH HÃNG",160000,160000,0,0
TIKI,dien-gia-dung,20914429,"Máy xay sinh tố cối thủy tinh Comet CM9953 - Hàng chính hãng",455000,569000,114000,20
TIKI,dien-gia-dung,35242894,"Tông Đơ Cắt Tóc Philips HC3520 - Hàng chính hãng",1422000,1422000,0,0
TIKI,lam-dep-suc-khoe,51095498,"Kem mắt chống lão hóa The INKEY List Retinol Eye Cream 15ml",399000,399000,0,0
TIKI,dien-gia-dung,52695660,"Máy cạo râu Kemei 1102",199000,199000,0,0
TIKI,lam-dep-suc-khoe,188964498,"SPECIAL COMBO 2 chai Nước Dưỡng Tóc Tinh Dầu Bưởi Cocoon 140ml - tặng Serum Sachi phục hồi tóc Cocoon 70ml",330000,330000,0,0
TIKI,dien-gia-dung,115324059,"Máy Xay Sinh Tố Cầm Tay YOICE REKKY (150W - 300ml- loại SẠC PIN ). máy xay sinh tố mini - Hàng Chính Hãng",292000,369000,77000,21
TIKI,dien-gia-dung,129750096,"Bộ chân đế ấm siêu tốc loại tốt-PT",30000,30000,0,0
TIKI,lam-dep-suc-khoe,144176873,"Máy xông tinh dầu siêu âm cao cấp 550ml  - Đèn LED 7 màu - Chế độ máy khuếch tán tinh dầu mạnh - Hẹn giờ tự tắt - Xông hơi liên tục 24h - Kèm Remote -  Tặng 1 tinh dầu 10ml",192000,349000,157000,45
TIKI,lam-dep-suc-khoe,10771483,"Kem Dưỡng Ẩm Cho Da Khô Klairs Rich Moist Soothing Cream",450000,450000,0,0
TIKI,dien-gia-dung,10369519,"[Hàng chính hãng]- Máy hút bụi dùng pin(18v) Makita DCL180ZB(chưa kèm pin sạc)",1269000,1269000,0,0
TIKI,lam-dep-suc-khoe,54004408,"Dầu Gội Rejoice Siêu Mượt Chai 1800ML",358000,375000,17000,5
TIKI,dien-gia-dung,121739784,"Nồi Chiên, Nướng, Quay Không Dầu Điện Tử BIYI AF-60A, Dung Tích Lớn 11L, màu đen - Hàng Chính Hãng",1769000,4290000,2521000,59
TIKI,dien-gia-dung,95064261,"Máy lọc không khí Ozone Ion Âm 4 chế độ lọc không khí, khử mùi ,khử trùng cho nhà bếp,nhà vệ sinh ,phòng ngủ",375000,375000,0,0
TIKI,lam-dep-suc-khoe,68860538,"Bao cao su LifeStyles Zero làm từ cao su thiên nhiên cao cấp siêu mỏng truyền nhiệt tốt cho cảm giác chân thật ( 3 Bao / Hộp ) - Xuất xứ Úc ( Hàng Chính Hãng )",44000,88000,44000,50
TIKI,lam-dep-suc-khoe,91752078," BỘ DỤNG CỤ LÀM MÓNG BẤM MÓNG - BỘ KỀM CẮT MÓNG TAY CAO CẤP",62793,85817,23024,27
TIKI,lam-dep-suc-khoe,26096771,"Thực phẩm bảo vệ sức khỏe Maxxhair New hộp 30 viên- Bổ sung Vitamin và khoáng chất giúp tăng cường sức khỏe của tóc; giúp tóc mọc nhanh, chắc khỏe, suôn mượt và bóng đẹp, ngăn ngừa rụng tóc, đồng thời giúp thải độc do ảnh hưởng của các hóa chất sử dụng ch",226000,226000,0,0
TIKI,lam-dep-suc-khoe,119700381,"Bộ 6 Kem Đánh Răng Colgate Sensitive Pro Relief ngăn ê buốt và bảo vệ toàn diện 110g/hộp",359000,414000,55000,13
TIKI,dien-gia-dung,130063458,"Quạt treo Toshiba F-WSA20(H)VN - Hàng chính hãng",1490000,1490000,0,0
TIKI,lam-dep-suc-khoe,13778270,"Tinh chất kích thích mọc tóc L’Oréal Serioxyl Denser Hair 90ml",931000,980000,49000,5
TIKI,lam-dep-suc-khoe,20201723,"NƯỚC SÚC MIỆNG KIN B5 LÀM SẠCH MẢNG BÁM VÀ PHỤC HỒI NƯỚU RĂNG 500ML",292000,292000,0,0
TIKI,lam-dep-suc-khoe,12084494,"Nước Tẩy Trang Eucerin Hỗ Trợ Trị Mụn Làm Trắng Da (200ml)",261000,349000,88000,25
TIKI,lam-dep-suc-khoe,38372056,"Viên uống Vitamin C sáng da, tăng cường đề kháng, giảm cảm cúm, cảm lạnh Mega We Care NAT C 1000 (30 viên)",138000,155000,17000,11
TIKI,lam-dep-suc-khoe,73772610,"Saffron Kingdom Herb nhụy hoa nghệ tây Iran hộp 0.2 gram, hàng chính hãng super negin thượng hạng (Tặng bình nước thủy tinh)",70000,155000,85000,55
TIKI,dien-gia-dung,217291175,"Máy xay thịt đa năng SOKANY LB7005A 3L- Hàng chính hãng",474050,499000,24950,5
TIKI,lam-dep-suc-khoe,166389092,"Sữa tắm gội Romano cho nam 2 trong 1 Gentleman 180g",56000,65000,9000,14
TIKI,lam-dep-suc-khoe,192880305,"Máy cắt tỉa lông mũi pin sạc Enchen hàng cao cấp phiên bản quà tặng hộp đẹp",200000,400000,200000,50
TIKI,lam-dep-suc-khoe,89753515,"DUNG DỊCH VỆ SINH PHỤ NỮ HANA SOFT SILK HANAYUKI",108000,108000,0,0
TIKI,dien-gia-dung,188513963,"Linh kiện máy xay sinh tố công nghiệp của Osako Os-1800 1800W-hàng chính hãng",99000,99000,0,0
TIKI,lam-dep-suc-khoe,119988682,"Uốn mi cong thân nhựa cao cấp KAI màu hồng kèm miếng đệm thay thế",139000,152000,13000,9
TIKI,lam-dep-suc-khoe,21760234,"Sữa rửa mặt Sắc Ngọc Khang 50g giúp loại bỏ bụi bẩn và bã nhờn dư thừa, cung cấp các dưỡng chất cho da, giúp da trắng sáng, mịn màng",40000,50000,10000,20
TIKI,dien-gia-dung,185495919,"Nồi cơm điện Sunhouse SHD8305 3L - Hàng chính hãng",979000,1580000,601000,38
TIKI,dien-gia-dung,143359444,"Bàn là quần áo hơi nước cầm tay, bàn ủi mini siêu tiện ích dễ dàng mang theo khi đi du lịch",60083,60083,0,0
TIKI,lam-dep-suc-khoe,24828338,"Gel ngừa mụn diệt khuẩn Floslek Pharma Antibacterial Intense Gel 20ml",230000,329000,99000,30
TIKI,lam-dep-suc-khoe,77339534,"Kem Đánh Răng Colgate Sensitive ngăn ngừa ê buốt toàn diện 110g/tuýp",65000,69000,4000,6
TIKI,dien-gia-dung,51059438,"Ấm đun siêu tốc Sharp 1.7 lít EKJ-17EVPS-BK - Hàng chính hãng",529000,529000,0,0
TIKI,lam-dep-suc-khoe,24862534,"Tinh Chất Tế Bào Gốc Tái Tạo Phục Hồi Trẻ Hoá Da Cấp Ẩm Dưỡng Trắng Chống Lão Hoá Cellkey-Scien White Serum 30ml",790500,930000,139500,15
TIKI,lam-dep-suc-khoe,56389444,"Bộ đôi Nước súc miệng Colgate diệt 99% vi khuẩn Plax trà xanh 500ml/chai",155000,165000,10000,6
TIKI,lam-dep-suc-khoe,177516306,"Set 5 Son Kem Lì Thỏ LEADUU lâu trôi mềm mịn",75000,125000,50000,40
TIKI,lam-dep-suc-khoe,73574991,"Dego Pharma - Dầu gội sạch vảy gàu mảng trắng, hết ngứa chiết xuất thiên nhiên từ vỏ cây Zizyphus, sản xuất theo tiêu chuẩn và dưới sự giám sát của công ty dược phẩm Châu Âu (80ml)",192000,390000,198000,51
TIKI,dien-gia-dung,101075601,"Nồi Chiên Không Dầu BIYI AF25A (6,4L) - Hàng Chính Hãng",1539000,2980000,1441000,48
TIKI,lam-dep-suc-khoe,272918313,"Omega 3-6-9 Úc Healthy Care Ultimate 1000mg Tạo sức khỏe cho tim, não, khớp, mắt và cải thiện da khô - QuaTangMe Extaste",413400,866000,452600,52
TIKI,dien-gia-dung,186495131,"Nồi chiên không dầu điện tử Xiaomi Mi Smart Air Fryer 3.5 lít BHR4849EU MAF02 - Hàng chính hãng",1399000,2390000,991000,41
TIKI,lam-dep-suc-khoe,185817287,"Xịt Thơm Miệng MEXI Quyên Lara - Giúp Hơi Thở Thơm Mát, Hết Hôi Miệng, Giảm Tình Trạng Viêm Lợi, Viêm Chân Răng, Dung Tích 15ml",139000,230000,91000,40
TIKI,lam-dep-suc-khoe,50698010,"Serum dưỡng trắng da, mờ đốm nâu, đều màu da - Vitamin C, Vitamin E, Bisabolol - NNO VITE Mega We Care (30 viên)",390000,390000,0,0
TIKI,dien-gia-dung,68692812,"Máy Lọc Trực Tiếp Đầu Vòi Eurolife EL-LS-D20 - Hàng Chính Hãng",578000,680000,102000,15
TIKI,dien-gia-dung,76124825,"Máy Xay Thịt Làm Giò Chả Ruốc, Xay Cua, Xay Cá Gia Đình NEWSUN 1 Kg/ Mẻ, Inox Cao Cấp, Công Suất 900W, Chân vuông",3050000,3050000,0,0
TIKI,dien-gia-dung,126863127,"Lõi Lọc PPCF Pureit Lavita Nóng Thông Minh (DIY) - Hàng Chính Hãng",446500,470000,23500,5
TIKI,dien-gia-dung,66546602,"Máy Uốn Tóc, Ép Duỗi Tóc 2in1 PA001 Có Chỉnh Được Nhiệt Độ Giúp Duỗi Thẳng, Làm Xoăn 2in1 Chuẩn Salon tại Nhà",599000,599000,0,0
TIKI,lam-dep-suc-khoe,14336296,"Combo 2 hộp nước uống vị hồng sâm Hàn Quốc 10 chai x 100ml",150920,154000,3080,2
TIKI,lam-dep-suc-khoe,15262824,"Tinh dầu dưỡng tóc Nashi Argan Oil - trattamento di bellezza per tutti i tipi di capello 100ml",720000,720000,0,0
TIKI,dien-gia-dung,249859672,"Bình Thủy Giữ Nhiệt, Bình Thủy Điện KALITE KL-888 Pha Trà Pha Sữa, Mức Nhiệt Cài Sẵn Dung Tích 2.7 Lít Công Suất 2200 W - Hàng Chính Hãng",1999000,3989000,1990000,50
TIKI,dien-gia-dung,78487832,"Quạt Lửng Thân Sắt Senko LTS1632 - Màu ngẫu nhiên - Hàng Chính Hãng",490000,490000,0,0
TIKI,lam-dep-suc-khoe,114467695,"Combo Dầu Gội X-Men Nước hoa Fire 650G và Sữa Tắm X-Men Nước hoa Fire 650G",382000,382000,0,0
TIKI,lam-dep-suc-khoe,83608793,"Kem đánh răng Colgate Thiên Nhiên 180g",50000,55000,5000,9
TIKI,lam-dep-suc-khoe,36768495,"Bàn chải thông minh Xiaomi Mijia T100 - Hàng nhập khẩu",208000,208000,0,0
TIKI,o-to-xe-may-xe-dap,68480278,"[Mẫu Mới] Motul Scooter 10W40 800ml tặng Motul Gear Oil 80W90 120ml nhớt hợp số nhớt máy xe tay ga",149000,149000,0,0
TIKI,o-to-xe-may-xe-dap,186124514,"Mũ bảo hiểm Fullface 2 kính GRO ST11 thời trang, cá tính- Hàng chính hãng",369000,369000,0,0
TIKI,o-to-xe-may-xe-dap,53328659,"Bơm lốp ô tô xe máy xe đạp đạp chân ROCK",225000,225000,0,0
TIKI,o-to-xe-may-xe-dap,162766875,"Sơn phủ vết xước xe ô tô, sơn ô tô, xe máy, chai xịt sơn ô tô, xe máy, vật dụng cần sơn tĩnh điện",135000,135000,0,0
TIKI,o-to-xe-may-xe-dap,75490727,"Đèn LED Xi Nhan Không Dây Rẽ Trái Phải Gắn Đuôi Xe Đạp Điều Khiển Không Dây Từ Xa Sạc Điện USB Mai Lee",215000,249000,34000,14
TIKI,o-to-xe-may-xe-dap,35810240," Túi thơm cà phê Việt Nam treo xe ô tô -Robusta Đaklak -100G",39000,39000,0,0
TIKI,o-to-xe-may-xe-dap,49195399,"Bộ 2 Chai Dung Dịch Tẩy Keo, Nhựa Đường 3M 08987 (425 g)",280000,280000,0,0
TIKI,lam-dep-suc-khoe,72759100,"Bao cao su Ôm sát Siêu mỏng Powermen Kéo dài thời gian quan hệ cho Nam ( Size 49mm)",120000,120000,0,0
TIKI,lam-dep-suc-khoe,103555074,"Máy Đẩy Tinh Chất Halio Ion Hot & Cool Beauty Device Nâng Cơ Mặt - Màu White",1959000,2500000,541000,22
TIKI,o-to-xe-may-xe-dap,100414919,"Cảm biến áp suất lốp ô tô xe hơi gắn ngoài cao cấp Car365 Cảnh báo tiếng Việt độc quyền - Pin mặt trời, Màn LCD",199000,199000,0,0
TIKI,o-to-xe-may-xe-dap,68611487,"Túi Tam Giác Treo Sườn Xe Đạp Chống Nước Treo Khung Xe Đa Năng Chứa Đồ Cá Nhân Mai Lee",99000,139000,40000,29
TIKI,lam-dep-suc-khoe,568277,"Lăn Nách Dành Cho Nam Aquaselin Extreme For Men Antiperspirant For Excessive Perspiration 50ml - 3936",290000,362500,72500,20
TIKI,lam-dep-suc-khoe,37545731,"Bột Khử Mùi Wings-Up Khử Mùi Hôi Chân Hôi Nách Ngăn Tiết Mồ Hôi Hôi Khử Mùi Giày Không Mùi An Toàn Từ Thiên Nhiên Cỏ Mềm 25g",115000,115000,0,0
TIKI,lam-dep-suc-khoe,4115555,"Sữa tắm nước hoa Tesori d'Oriente Hoa sen 500ml chính hãng kèm vòi nhập khẩu trực tiếp từ Ý",275000,275000,0,0
TIKI,o-to-xe-may-xe-dap,131337978,"Túi treo hành lý đằng sau chống nước-Túi đôi phía sau yên xe Đồ dùng và thiết bị đi xe đạp Màu Đỏ",135000,135000,0,0
TIKI,o-to-xe-may-xe-dap,43741683,"Bao Tay, Găng Tay Xe Đạp Và Thể Thao Mùa Hè Hở Ngón",35000,35000,0,0
TIKI,o-to-xe-may-xe-dap,77580607,"Bọc vô lăng da vân carbon cao cấp TTAUTO cho xe ô tô 4 đến 7 chỗ (Đen)",159000,250000,91000,36
TIKI,lam-dep-suc-khoe,43108211,"Hấp ủ phục hồi cấp tốc LUJO KERATIN MASK & COLLAGEN cho mái tóc",180000,180000,0,0
TIKI,o-to-xe-may-xe-dap,74441824,"Bộ Dụng Cụ Vá Săm Lốp Xe Đạp Có Săm 11 Miếng Du Lịch Tiện Dụng Sử Dụng Khẩn Cấp Cho Xe Đạp Mai Lee",51000,59000,8000,14
TIKI,lam-dep-suc-khoe,1601631,"Gel Cho Da Thâm The Body Shop Tea Tree (2.5ml)",125000,250000,125000,50
TIKI,o-to-xe-may-xe-dap,142419138,"Cặp dây quấn ghi đông xe đạp thể thao 2 mét/cuộn + 2 nút chặn - Dây quấn tay cầm xe đạp địa hình - Handle Bar Tape Chính Hãng",49000,49000,0,0
TIKI,o-to-xe-may-xe-dap,82378075,"Lót (bọc) chân chống xe máy kèm thắt cổ dê - chống trầy nền nhà, Chống lún cát khi dựng xe - NKLUBE",19000,19000,0,0
TIKI,lam-dep-suc-khoe,7615194,"Sữa tắm cá ngựa Algemarin Perfume Shower Gel  300ml",75000,75000,0,0
TIKI,o-to-xe-may-xe-dap,186743659,"[1 chiếc] Gương Xe Đạp Chiếu Hậu Giá rẻ 8 cm Cho Xe Đạp Thể Thao Địa Hình 360 Độ Giúp Đạp Xe An Toàn Mai Lee",26000,29000,3000,10
TIKI,lam-dep-suc-khoe,67810097,"Bộ Máy Đo Đường Huyết Acon On Call Plus + Tặng hộp 25 que thử",619000,850000,231000,27
TIKI,lam-dep-suc-khoe,149410184,"Bông tẩy trang Tétra Medical Pháp - loại 600 miếng",109000,109000,0,0
TIKI,o-to-xe-may-xe-dap,53629453,"DUNG DỊCH RỬA KHOANG MÁY VÀ VỎ XE KHÔNG CHẠM EKOKEMIKA BIO 35 - 1L",162750,175000,12250,7
TIKI,o-to-xe-may-xe-dap,143779186,"Sticker Baby In Car dán xe ô tô",11825,12500,675,5
TIKI,o-to-xe-may-xe-dap,110171383,"Sạc bình acquy 12V/6A 4Ah-100Ah tự ngắt khi đầy chức năng bảo dưỡng phục hồi ắc quy bằng khử sunfat chống ngược cực",175000,175000,0,0
TIKI,lam-dep-suc-khoe,117170051,"Combo 2 Sữa rửa mặt Simple giúp kiềm dầu và ngừa mụn hiệu quả - cho da mụn nhạy cảm 150ml [CHÍNH HÃNG ĐỘC QUYỀN] [DIỆN MẠO MỚI]",198000,264000,66000,25
TIKI,lam-dep-suc-khoe,48085908,"Phấn Nước M.O.I 5M BABY SKIN CUSHION Hồ Ngọc Hà (Chính Hãng)",391020,399000,7980,2
TIKI,o-to-xe-may-xe-dap,155245390,"Bao Da Chìa Khoá KIA Carnival 2021, 2022 handmade Da Thật 013",200000,200000,0,0
TIKI,lam-dep-suc-khoe,88967146,"Bao Cao Su Gai Kéo Dài Thời Gian Của Nhật Bản Sagami Xtreme Feel Long (Hộp 10 Chiếc) Không Mùi Cao Su  - Tặng 1 Chiếc BCS Power Men - Che Tên Sản Phẩm",75000,75000,0,0
TIKI,o-to-xe-may-xe-dap,107360982,"Khay Đựng Đồ Đa Năng Cắm Khe Ghế Ô Tô, Hộc Để Đồ Cao Cấp Trên Xe Hơi",99000,99000,0,0
TIKI,lam-dep-suc-khoe,136935260,"[SIZE DU LỊCH] Sữa rửa mặt Sắc Ngọc Khang 30g giúp loại bỏ bụi bẩn và bã nhờn dư thừa, cung cấp các dưỡng chất cho da, giúp da trắng sáng, mịn màng",20000,30000,10000,33
TIKI,lam-dep-suc-khoe,25917935,"Gel Chăm Sóc Sẹo Mụn Và Mụn Thâm Hiruscar Post Acne 5G",170000,190000,20000,11
TIKI,lam-dep-suc-khoe,208303315,"Combo máy khuếch tán/ máy xông tinh dầu bình hoa + tinh dầu sả chanh + tinh dầu cam Lorganic (10ml x2 chai)",275000,550000,275000,50
TIKI,o-to-xe-may-xe-dap,43838038,"Cảm biến áp suất lốp xe ô tô TPMS thông minh màn hình LCD màu, chạy bằng năng lượng mặt trời lắp van ngoài T3 ",372000,372000,0,0
TIKI,o-to-xe-may-xe-dap,59557653,"Khăn lau ô tô chuyên dụng chống trầy xước Microfiber 3M 30x30cm Nhiều màu sắc",20000,22000,2000,9
TIKI,lam-dep-suc-khoe,83202928,"Bộ 5 Bàn chải đánh răng Colgate than hoạt tính kháng khuẩn SlimSoft Charcoal mềm mảnh",140000,153000,13000,8
TIKI,o-to-xe-may-xe-dap,146903570,"Sạc điện thoại xe máy 2 cổng USB 12-24V",95040,95040,0,0
TIKI,lam-dep-suc-khoe,192339772,"Bàn chải đánh răng điện cho bé LocknLock ENR226WHT-5V, 1.5W - Màu trắng",569000,1090000,521000,48
TIKI,lam-dep-suc-khoe,21408570,"Kem Dưỡng Giảm Thâm Quầng Mắt Himalaya 15ml",149000,149000,0,0
TIKI,lam-dep-suc-khoe,103498447,"Kem Tẩy Lông Cho Da Thường Veet Silk Fresh 25G",40000,42200,2200,5
TIKI,lam-dep-suc-khoe,126795077,"Viên uống JEX giảm đau, bảo vệ xương khớp với Eggshell Membrane, Collagen Peptide, Collagen Type II không biến tính (60 viên)",630000,630000,0,0
TIKI,o-to-xe-may-xe-dap,183110799,"CAO SU BỌC TAY CẦM, TAY THẮNG XE MÁY MỘT BỘ",49000,49000,0,0
TIKI,o-to-xe-may-xe-dap,91648881,"Đèn Led Gắn Tăm Căm Xe Đạp Trang Trí Đẹp Mắt Với Pin Cr2032 (bên trong) MaiLee",26000,29000,3000,10
TIKI,lam-dep-suc-khoe,7221953,"Sữa Rửa Mặt Cân Bằng Độ Ẩm Và Giảm Dầu Skin Balancing Oil Reducing Cleanser 237ml",595000,699000,104000,15
TIKI,o-to-xe-may-xe-dap,96055661,"Kính Trang Trí Mũ Bào hiểm 1/2 và 3/4 đầu Thời Trang Cực Chất -  Kính Phi Công Bảy Màu Chống Tia UV ",89000,89000,0,0
TIKI,lam-dep-suc-khoe,75842514,"Hà Thủ Ô Mật Ong Phúc Khang",150000,350000,200000,57
TIKI,lam-dep-suc-khoe,170066637,"Combo 3 Hộp Khẩu trang Bông Bạch Tuyết 3 lớp Trẻ Em 6 -11 tuổi (30 cái/ hộp)",110400,138000,27600,20
TIKI,lam-dep-suc-khoe,3490333,"Tinh chất chống nám và nếp nhăn độc đáo Paula's Choice Clinical 1% Retinol Treatment 30ml",1655000,1950000,295000,15
TIKI,o-to-xe-may-xe-dap,57759195,"Tấm bạt che nắng oto, chống chói oto, chống hâm nóng xe khi đậu dưới trời nắng, hàng Việt Nam chất lượng cao, có sự lựa chọn mẫu",155000,155000,0,0
TIKI,o-to-xe-may-xe-dap,37498512,"ĐÈN XI NHAN XE MÁY BÓNG LED L17 CHẠY HIỆU ỨNG AUDI SIÊU ĐẸP (MÀU VÀNG) DXNL17",65550,69000,3450,5
TIKI,o-to-xe-may-xe-dap,85752639,"Đèn Báo Xi Nhan Rẽ Trái Phải Gắn Đuôi Cho Xe Đạp Với LED SMD Cao Cấp Và Remote Điều Khiển Từ Xa Không Dây Sạc USB Chống Nước Mai Lee",208000,229000,21000,9
TIKI,o-to-xe-may-xe-dap,165597765,"Bọc khóa smartkey dành cho Honda Lead, Airblade, Vision 2018-2020, Vario 150, Bezen Classic",59000,59000,0,0
TIKI,lam-dep-suc-khoe,24924199,"Son kem lì Bbia Last Velvet Lip Tint Version 1 5g (5 màu)",150000,290000,140000,48
TIKI,o-to-xe-may-xe-dap,190516568,"Thùng Rác Mini Đa Năng Dùng Trên Xe Ô Tô, Bàn Học, Bàn Làm Việc, Hình Ngộ Nghĩnh Đáng Yêu",75000,75000,0,0
TIKI,o-to-xe-may-xe-dap,69360356,"Đèn Pha Xe Đạp Chiếu Sáng Cao Cấp Chống Nước Gắn Ghi-Đông Siêu Sáng Sạc Điện Type-C Có Đồng Hồ Hiển Thị Thời Gian Lượng Pin Có Hỗ trợ Sạc Khẩn Cấp C30ML Mai Lee - Combo A",359000,359000,0,0
TIKI,lam-dep-suc-khoe,55891956,"Bigsize - Kem dưỡng trắng da toàn thân Truesky Whitening Body Lotion chiết xuất lựu 200g",250000,250000,0,0
TIKI,lam-dep-suc-khoe,25738219,"Floslek Sữa Rửa Mặt Dạng Gel Cho Da Nhờn Mụn Anti Acne Bacterial Face Cleansing Gel 200ml",277000,396000,119000,30
TIKI,o-to-xe-may-xe-dap,105184333,"Gương xe máy thời trang, thể thao cho SH, Exciter, Vario, CBR300, winner X",166500,166500,0,0
TIKI,o-to-xe-may-xe-dap,74083498,"Cảo Xích Xe Đạp Giúp Tháo Mở Cảo Cắt Mắt Dây Sên Xe Đạp Nhỏ Gọn, Tiện Lợi Mai Lee",88000,99000,11000,11
TIKI,o-to-xe-may-xe-dap,34531222,"Bộ Hộp Dụng Cụ Vá Lốp Xe Lốp Không Săm Vá Lụi (vá ngoài) Bằng Thép Không Gỉ Cho Xe Oto, Xe Hơi Và Xe Máy Mai Lee - Hàng Chính Hãng",139000,139000,0,0
TIKI,o-to-xe-may-xe-dap,104469261,"Đèn Pha Trước Xe Đạp NX3 Có Sạc USB Siêu Sáng Cao Cấp Chống Nước Dành Cho Xe Đạp Địa Hình, Xe Đạp Thể Thao Giúp Đạp Xe An Toàn Ban Đêm",254000,279000,25000,9
TIKI,o-to-xe-may-xe-dap,75554546,"Kẹp Đèn Pin Xe Đạp, Kẹp Giữ Đèn Pin Gắn Ghi Đông Cho Xe Đạp Thể Thaom Leo Núi Lắp Đặt Dễ Dàng Mai Lee",35000,49000,14000,29
TIKI,o-to-xe-may-xe-dap,6288513,"Nhớt liqui Moligen 5W40 dành cho xe ga",265000,265000,0,0
TIKI,o-to-xe-may-xe-dap,59441423,"Kính rời dành cho Mũ bảo hiểm 3/4 - CHITA",150000,150000,0,0
TIKI,lam-dep-suc-khoe,42559192,"Eucerin Pro ACNE Solution Cleansing Gel: Gel Rửa Mặt Da Mụn (400 ml)",396000,529000,133000,25
TIKI,o-to-xe-may-xe-dap,52337956,"Bộ kích điện xe ô tô khẩn cấp Xiaomi , Tích hợp pin dự phòng 11100 mAh - 70Mai Midrive PS01 - Hàng Nhập Khẩu",1189000,1189000,0,0
TIKI,lam-dep-suc-khoe,385469,"Bao cao su Durex Fetherlite Ultima Hộp 3 bao",69000,76000,7000,9
TIKI,lam-dep-suc-khoe,55361011," Kem Nền Che Khuyết Điểm Tặng Kèm Bông Đánh VEN ZEN",75000,145000,70000,48
TIKI,o-to-xe-may-xe-dap,80850302,"Gối tựa đầu cao xu non sử dụng cho ô tô , xe hơi hàng cao cấp , tựa đầu chống mỏi cổ gáy, thoải mái lái xe",120000,120000,0,0
TIKI,lam-dep-suc-khoe,56388178,"Bộ 4 Kem đánh răng Colgate bạc hà the mát Maxfresh 230g/tuýp tặng bàn chải đánh răng lông mềm",190000,190000,0,0
TIKI,o-to-xe-may-xe-dap,74552910,"Bóng led H4 tích hợp bi cầu mini có COS - PHA",55000,55000,0,0
TIKI,lam-dep-suc-khoe,1687623,"Kem chống muỗi Rohto Metholatum Remos Hương Lavender 70g",23100,27000,3900,14
TIKI,o-to-xe-may-xe-dap,191950394,"Găng tay Pro-Biker - Găng tay phượt cao cấp",135000,135000,0,0
TIKI,lam-dep-suc-khoe,117089684,"Gương trang điểm để bàn bằng gỗ Dovaty G3 phong cách hàn quốc",100000,100000,0,0
TIKI,o-to-xe-may-xe-dap,105525660,"Nón bảo hiểm xe đạp có kính Protec Win 018, nón bảo hiểm chơi thể thao ngoài trời tiêu chuẩn châu âu, kính mát, chống tia UV",505000,568000,63000,11
TIKI,lam-dep-suc-khoe,59085169,"Bình (Bộ Dụng Cụ) Rửa Mũi Xoang Người Lớn NeilMed SinusRinse Adult Kit -Xuất Xứ Mỹ(1 bình + 10 gói)",327000,327000,0,0
TIKI,o-to-xe-may-xe-dap,38148090,"Bộ 4 Miếng Dán Gương Kính Bên Ô Tô Chống Nước Chống Lóa Gồm 2 Miếng Elip 150x100mm Và 2 Miếng Chữ Nhật 200x160mm",48000,48000,0,0
TIKI,o-to-xe-may-xe-dap,50512779,"Nón bảo hiểm 3/4 kính âm Royal M139 Xanh Mực Nhám cao cấp Lót tháo rời, che hết mặt",499000,499000,0,0
TIKI,o-to-xe-may-xe-dap,85236398,"khung biển số dài cho ô tô kích thước mới đế nhựa viền thép",160000,160000,0,0
TIKI,o-to-xe-may-xe-dap,68442580,"Nệm hơi xe ô tô Nhà của Mẹ cao cấp chất liệu vải nhung kích thước 140 x 90 x 50 cm tặng kèm bơm điện - Màu sắc giao ngẫu nhiên",395000,420000,25000,6
TIKI,o-to-xe-may-xe-dap,72555849,"Cuộn Đề Can (Decal) Phản Quang Dán Trang Trí Viền Thân Xe Đạp, Xe Máy, Ô tô An Toàn Ban Đêm Nổi Bật (8 mét) Mai Lee",23000,27000,4000,15
TIKI,lam-dep-suc-khoe,193742017,"Băng vệ sinh AO2 siêu mỏng nhẹ mặt lưới có cánh - Dùng cho ngày (23cm), đêm (28cm) 7 miếng/gói",11875,12500,625,5
TIKI,o-to-xe-may-xe-dap,25969322,"Mũ bảo hiểm nửa đầu Bulldog Gang",598000,598000,0,0
TIKI,o-to-xe-may-xe-dap,190468714,"gác để chân sau xe đạp loại cao cấp, bắt thẳng vào sườn xe (nhắn shop để được tư vấn)",39000,50000,11000,22
TIKI,o-to-xe-may-xe-dap,25973334,"Sạc Điện Thoại Trên Xe Máy ",33000,33000,0,0
TIKI,o-to-xe-may-xe-dap,25933443,"Bộ 2 Gối Tựa Đầu Ô Tô - Gối Chống Mỏi Cổ Trên Xe Hơi AZONE - Màu Chỉ Đỏ",114000,114000,0,0
TIKI,o-to-xe-may-xe-dap,56842434,"Thiết bị tiện ích cho ô tô đế hút nam châm giữ điện thoại thiết kế thông minh trên vô lăng hoặc tất cả vị trí trên ô tô dễ dàng lắp đặt",89000,89000,0,0
TIKI,o-to-xe-may-xe-dap,52179904,"máy sạc bình ắc quy 12v 2a từ 4-20ah sạc bình ắc quy xe máy sạc bình ắc quy 12V(Đen)",47000,47000,0,0
TIKI,o-to-xe-may-xe-dap,11781042,"Khóa đĩa xe máy zcon",110000,110000,0,0
TIKI,o-to-xe-may-xe-dap,145398874,"Găng Tay Cụt Ngón Chạy Xe Đạp, Xe Máy MCFK 0101 | Bao Tay Cụt Ngón Thể Thao | Găng Tay Phượt Nam/Nữ - Theyanch Half-Finger Gloves",99000,105000,6000,6
TIKI,o-to-xe-may-xe-dap,35457234,"Dung Dịch Tẩy Nhựa Đường, Keo Băng Dính SONAX Tar remover 334200 (300ml)",170000,170000,0,0
TIKI,lam-dep-suc-khoe,174045178,"Kem chống nắng nâng tông Skin Aqua Tone up Latte Beige cho mọi tông da, dạng tinh chất Sunplay Skin Aqua Tone Up UV Essence Latte Beige SPF 50+ PA++++ 50g",161000,199000,38000,19
TIKI,o-to-xe-may-xe-dap,130861049,"[BỘ 8 MIẾNG 4 CỬA] Miếng dán chống trầy xước bậc cửa xe hơi ô tô sợi carbon bền đẹp có in logo hãng",169000,169000,0,0
TIKI,o-to-xe-may-xe-dap,52432561,"Bơm lốp xe đạp xe máy chính hãng CMART l0005",175000,175000,0,0
TIKI,o-to-xe-may-xe-dap,68877509,"Dụng Cụ Kìm (Kềm) Cắt Mở Đóng Dây Sên Xích Xe Đạp Thể Thao Mini Tiện Lợi Nhanh Chóng Mai Lee",46550,49000,2450,5
TIKI,o-to-xe-may-xe-dap,96910845,"Gương cầu lồi xoay 360 độ có viền và không viền HT-1003 gắn gương chiếu hậu xe hơi ô tô xe máy loại cao cấp",19000,29000,10000,34
TIKI,o-to-xe-may-xe-dap,48303234,"Mũ Bảo Hiểm 3/4 Napoli SH1 Free Size 5-58 cm - Nâu Lót Nâu - Bảo hành 12 tháng",359000,359000,0,0
TIKI,o-to-xe-may-xe-dap,105184045,"Combo Móc và Bao da khóa Yamaha Smartkey Grande, NVX, Janus, Nozza, Exciter 155",90250,90250,0,0
TIKI,o-to-xe-may-xe-dap,172948856,"BỘ CHẮN BÙN SAU XE NVX 155",199000,199000,0,0
TIKI,o-to-xe-may-xe-dap,111589429,"Nón bảo hiểm trẻ em 1/2 đầu Protec Kitty, họa tiết siêu anh hùng Captain American",305000,358000,53000,15
TIKI,o-to-xe-may-xe-dap,10085871,"Tem dán sườn xe ô tô phong cách thể thao TS02",239000,239000,0,0
TIKI,o-to-xe-may-xe-dap,102654330,"VÍ DA ĐỰNG ĐĂNG KIỂM, GIẤY TỜ Ô TÔ CAO CẤP",20000,20000,0,0
TIKI,o-to-xe-may-xe-dap,139001015,"Gạt mưa Silicone UP nhiều SIZE cho các dòng xe phổ biến tại Việt Nam",88000,88000,0,0
TIKI,o-to-xe-may-xe-dap,102445310,"Hộp đựng khăn giấy chất liệu da trên ô tô và bàn làm việc,kèm bảng số điện thoại",139990,139990,0,0
TIKI,lam-dep-suc-khoe,217412334,"Bao Cao Su LifeStyles SKYN ELITE Non-latex Siêu Mỏng, Siêu Mềm, Nhiều Gel Bôi Trơn, Không Mùi Cao Su - Hộp 3 bao",75000,120000,45000,38
TIKI,o-to-xe-may-xe-dap,174121364,"Chai xịt khử mùi - diệt khuẩn 3M Air Freshener Spray 38660 200ml",218500,230000,11500,5
TIKI,lam-dep-suc-khoe,58668263,"Combo 2 Sữa tắm hương nước hoa Enchanteur Delightful 650gr/ Chai",392000,392000,0,0
TIKI,lam-dep-suc-khoe,117175571,"Máy Massage Lưng Cao Cấp KINGTECH KB-920  - Mát xa Thắt Lưng, Eo, Cột Sống - Hỗ Trợ Điều Trị Thoát Vị Đĩa Đệm, Thoái Hóa, Đau Đốt Sống, Vai Gáy - Tích Hợp Tính Năng Nhiệt Hồng Ngoại 45 - 65 độ - Hàng Chính Hãng",1778000,3350000,1572000,47
TIKI,o-to-xe-may-xe-dap,89052647,"kem xóa vết xước ô tô xe máy",22000,22000,0,0
TIKI,o-to-xe-may-xe-dap,16201969,"Túi treo đầu ghi đông xe máy xem điện thoại, chứa đồ",77000,77000,0,0
TIKI,o-to-xe-may-xe-dap,137555914,"Sạc bình acquy 12V tự động ngắt khi đầy-đen",60800,64000,3200,5
TIKI,o-to-xe-may-xe-dap,71075907,"Bộ Dụng Cụ Chùi Chải Vệ Sinh Sên Xích Nhông Đĩa Cho Xe Đạp Thể Thao, Địa Hình (Kèm nước rửa tẩy rửa vệ sinh sên xích) Vệ Sinh Xích Líp Mai Lee",142000,159000,17000,11
TIKI,o-to-xe-may-xe-dap,85117078,"Nón Bảo Hiểm Xe Đạp Cao Cấp Protec Win 066, Siêu Phẩm Phượng Hoàng Lửa, Mạnh Mẽ, Cá Tính - Hàng Chính Hãng",469000,569000,100000,18
TIKI,o-to-xe-may-xe-dap,95548246,"Thùng đựng đồ cốp sau ô tô 56 lít, tặng kèm túi lót chứa nước bên trong",144000,144000,0,0
TIKI,o-to-xe-may-xe-dap,94725525,"Màn hình Ôtô xe hơi đặt táp lô, hút kính 5 inch độ phân giải cao 800*480p LCD dùng cho camera lùi, camera căn lề",399000,399000,0,0
TIKI,o-to-xe-may-xe-dap,92133666,"Ví đựng giấy tờ xe ô tô Hyundai Da Cao Cấp, Ví da đựng giấy tờ xe ô tô - OTOALO",30000,30000,0,0
TIKI,lam-dep-suc-khoe,53686030,"Gel vệ sinh phụ nữ X2 Nano Nghệ Cocayhoala Giảm Mùi Hôi - Giảm Ngứa - Giảm Khí Hư 150ml",199000,330000,131000,40
TIKI,lam-dep-suc-khoe,1751879,"Bộ nẹp gỗ sơ cấp cứu gồm 10 thanh",96000,96000,0,0
TIKI,lam-dep-suc-khoe,271441960,"Dung dịch vệ sinh phụ khoa cao cấp Femfresh giúp kháng khuẩn, làm sạch, khử mùi, tạo hương thơm mát cả ngày, cho cả nữ và nam - Massel Official",123000,258000,135000,52
TIKI,lam-dep-suc-khoe,194946999,"Nhíp Lấy Ráy Tai Chuyên Dụng Có Đèn, Hộp Đựng ( Tặng Kèm Pin) - Chính Hãng GROFA",58905,112200,53295,48
TIKI,lam-dep-suc-khoe,34315208,"Dao Cạo Râu 4 Lưỡi Dorco Pace 4 FRA 1001-PT",135000,135000,0,0
TIKI,lam-dep-suc-khoe,1679099,"Khẩu Trang Y Tế Meriday Bông Bạch Tuyết TP-KT04 (50 Cái)",59000,63000,4000,6
TIKI,lam-dep-suc-khoe,170066930,"Combo 3 Hộp Tăm bông trẻ em Bông Bạch Tuyết (336 que/hộp tròn)",76582,76582,0,0
TIKI,lam-dep-suc-khoe,35787205,"Combo 6 Băng Vệ Sinh Whisper Ultra Clean Siêu Mỏng Có Cánh Ngày Vừa 24cm (Gói 10 Miếng) ",165000,165000,0,0
TIKI,lam-dep-suc-khoe,89839177,"Bộ Dung Dịch Vệ Sinh Phụ Nữ Lactacyd Soft & Silky Dưỡng Ẩm 250ml + Odor Fresh Ngăn Mùi 24H 150ml",133000,142000,9000,6
TIKI,lam-dep-suc-khoe,14695045,"Xà Phòng hỗ trợ Trị Thâm Nách Pelican nội địa Nhật Bản",137000,139860,2860,2
TIKI,lam-dep-suc-khoe,271613379,"Sbody Green Coffee Hỗ Trợ Giảm Cân  - 100% Thiên Nhiên - Cà Phê Xanh Hỗ Trợ Giảm Cân AN TOÀN & HIỆU QUẢ (Hộp 12 gói /180G)",528000,550000,22000,4
TIKI,lam-dep-suc-khoe,148824107,"Serum sâu răng hôi miệng INOD Huyền Phi Tặng Kèm Gội (Xả) Mini Weilaiya Ngẫu Nhiên",182000,182000,0,0
TIKI,lam-dep-suc-khoe,14423069,"Tấm thảo dược thay thế của đai chườm vai cắm điện - Hapaku",148000,180000,32000,18
TIKI,lam-dep-suc-khoe,8756585,"Combo 5 Bông tẩy trang Ipek 130 miếng (Thổ Nhĩ Kì)",134000,134000,0,0
TIKI,lam-dep-suc-khoe,3045839,"Tinh bột nghệ Quê Việt - 100% nghệ đỏ nguyên chất, hàm lượng curmim cao.",259000,395000,136000,34
TIKI,lam-dep-suc-khoe,37880214,"phấn trang điểm trắng da twoway cake",153000,153000,0,0
TIKI,lam-dep-suc-khoe,187606879,"Combo Kem Rửa Mặt Tẩy Da Chết Tế Bào Gốc Thực Vật Kiềm Dầu Làm Sạch Sâu Dưỡng Ẩm Da Dầu Mụn Nhạy Cảm Cellkey-Scien 230ml",620500,730000,109500,15
TIKI,lam-dep-suc-khoe,1754691,"Dung dịch vệ sinh khử mùi phụ khoa nam giới SERENYS - 100ml",129000,129000,0,0
TIKI,lam-dep-suc-khoe,7721152,"Đai Thắt Lưng Orbe H1 - Xanh Đen",150000,150000,0,0
TIKI,lam-dep-suc-khoe,160299522,"Tinh chất dưỡng phục hồi da innisfree Retinol Cica Repair Ampoule 30 mL (New2023)",810000,900000,90000,10
TIKI,lam-dep-suc-khoe,119927437,"Lược sừng kiểu dáng Châu Âu sang trọng (Size: XL - 20cm) COH175 - Lược sừng xuất Nhật - Chăm sóc tóc",99000,99000,0,0
TIKI,lam-dep-suc-khoe,73180505,"Băng vệ sinh Diana Sensi dạng quần size M-L gói 5 miếng",80000,80000,0,0
TIKI,lam-dep-suc-khoe,138181029,"Viên nang mềm hồng sâm hàn quốc",488000,488000,0,0
TIKI,lam-dep-suc-khoe,175687094,"Calci B12 hộp 20 ống 10ml - Tăng cường sức khỏe - Bổ sung vitamin, cải thiện tình trạng thiếu hụt canxi",39000,60000,21000,35
TIKI,lam-dep-suc-khoe,125722009,"Combo bếp đốt thảo mộc bồ kết + 500gr sả + 10 viên nến",125000,125000,0,0
TIKI,lam-dep-suc-khoe,8142295,"Kềm Cắt Da Thép Chuyên Dụng Kềm Nghĩa D-23",60000,60000,0,0
TIKI,lam-dep-suc-khoe,3613769,"Nước Cân Bằng Shiseido Treatment Softener Enriched (150ml) - 14532",1350000,1350000,0,0
TIKI,lam-dep-suc-khoe,33600476,"Máy Tạo Kiểu Râu Philips BT1214	",1098250,1098250,0,0
TIKI,lam-dep-suc-khoe,119251241,"Sữa rửa mặt dịu lành cho da nhạy cảm Cetaphil Gentle Skin Cleanser 250ml",276000,276000,0,0
TIKI,lam-dep-suc-khoe,162196352,"Kem Dưỡng Ẩm Dành Cho Da Dầu Và Da Hỗn Hợp Laneige Water Bank Blue HA Cream Oily 50ml",852000,1000000,148000,15
TIKI,lam-dep-suc-khoe,147731249,"Hỗ trợ giảm đau nhức xương khớp Move Free Ultra 3xTriple Action Mỹ  phòng loãng xương, tăng trưởng và hồi phục sụn, tăng chất nhầy khớp - Massel Official 75Viên/Hộp",747000,1530000,783000,51
TIKI,lam-dep-suc-khoe,24752546,"Sáp Dưỡng Ẩm Vaseline 100% Pure Petroleum Jelly 368g",122000,122000,0,0
TIKI,lam-dep-suc-khoe,25442377,"Son kem lì Bbia Last Velvet Lip Tint - 17 More Pleasant 5g (Màu cam san hô)",150000,290000,140000,48
TIKI,lam-dep-suc-khoe,121322953,"Chai xịt diệt khuẩn Nano Bạc AHT - dùng rửa tay, phun khử khuẩn toàn thân",89375,137500,48125,35
TIKI,lam-dep-suc-khoe,68577434,"TINH CHẤT VITAMIN C TRẮNG DA, CẤP NƯỚC, PHỤC HÔI DA  300SKIN HYALURONIC ACID SERUM 50ML ",295000,295000,0,0
TIKI,lam-dep-suc-khoe,270846005,"Canxi 600mg và Vitamin D3 Kirkland cho xương và răng - QuaTangMe Extaste",531000,1062000,531000,50
TIKI,lam-dep-suc-khoe,175654421,"Rutin C Đại Uy - bổ sung vitamin C, giúp tăng cường sức đề kháng, phòng ngừa nhiệt miệng, táo bón - Hộp 100 viên",19000,50000,31000,62
TIKI,lam-dep-suc-khoe,50699275,"Kem Se Nhỏ Lỗ Chân Lông Bioderma Sebium Pore Refiner - 30ml",461000,485000,24000,5
TIKI,lam-dep-suc-khoe,125874560,"Túi chườm cao su nước NÓNG , LẠNH ĐA NĂNG",54000,69000,15000,22
TIKI,lam-dep-suc-khoe,173998496,"Lược gội đầu massage MASEKI",230000,230000,0,0
TIKI,thoi-trang-nu,101342997,"Combo 5 Quần Lót Nữ Cotton Thiên Nhiên BeingMe Miley Lingerie - Màu Đen",237000,475000,238000,50
TIKI,thoi-trang-nu,273357490,"Set Váy Ngủ Cosplay Bikini Sexy Gợi Cảm Độc Lạ Freebra Freesize (40~60kg)",438000,438000,0,0
TIKI,thoi-trang-nu,192303246,"Quần Độn Mông Hông Thông Hơi Cao Cấp Không Viền Mặc Váy Áo Dài 2 Màu Da Đen Đúc Su Hàng Loại 1",295000,335000,40000,12
TIKI,thoi-trang-nu,181247693,"Quần Legging Nữ Dài Cạp Cao Đẹp Cao Cấp PINKAHA Nâng Mông Vải Thun Cotton Siêu Co Giãn 4 Chiều Ôm Sát",205000,285000,80000,28
TIKI,thoi-trang-nu,95312684,"Combo 2 bộ (4 dây) dây áo ngực bản dẹt có thể điều chỉnh tiện lợi LYPK02",12000,20000,8000,40
TIKI,thoi-trang-nu,186677676,"Quần Lót Nữ, quần lót Ren nữ Cao Cấp Mềm Mịn, Quần Lót Nữ Co Dãn Tốt Thoáng Mát VILADY 2026",25000,45000,20000,44
TIKI,thoi-trang-nu,104050175,"Quần Lengging Lửng Nữ Chất Thun Co Dãn 4 Chiều , Quần Ngố Chất Đẹp Dễ Phối Đồ Màu",45000,45000,0,0
TIKI,thoi-trang-nu,82700793,"Bộ 5 Quần Lót Cotton Không Đường May thương hiệu BAW Kháng Khuẩn Thoáng Mát Màu Sắc Tùy Chọn Cho Nữ QLN15",199000,199000,0,0
TIKI,thoi-trang-nu,145289939,"Chân Váy Dài Lưng Cao New Design ,Thiết Kế Dài 62cm, Phối Nút Phong Cách Váy Công Sở,  Chất Vải Tốt Co Giãn Nhẹ CV19",170000,349000,179000,51
TIKI,thoi-trang-nu,177320879,"Miếng Dán Cố Định Quần Áo, Miếng Băng Dính 2 Mặt Thời Trang Cố Định Quần Áo, Dán Kín Khe Hở Ngực LYPK003",26600,28000,1400,5
TIKI,thoi-trang-nu,183058686,"Miếng Dán Ngực Silicon siêu chắc chắn ,tiện lợi cho phái đẹp - giao màu ngẫu nhiên - Hàng chính hãng",13000,16000,3000,19
TIKI,thoi-trang-nu,172915665,"PARIS, mã G108. Hãy tỏa sáng như kim cương, qua chiếc áo thun Goking siêu hot cho nam nữ trẻ em, áo phông cặp đôi, gia đình, đội nhóm",69000,69000,0,0
TIKI,thoi-trang-nu,58067930,"Combo 7 Quần Lót Nữ Phối Ren Miley Lingerie Active FMM0205-2x0405-0905-2x1105-1205 - Giao màu ngẫu nhiên",240000,595000,355000,60
TIKI,thoi-trang-nu,167598461,"Quần Đùi Mặc Trong Váy Gen Bụng Xuất Nhật MUNAFIE Quần Lót Nữ Đẹp Pinkaha",85000,85000,0,0
TIKI,thoi-trang-nu,82700777,"Bộ 5 Quần lót nữ O2 Cotton Ép Không Đường May, chất liệu thoáng mát thương hiệu BAW QLN14",149000,149000,0,0
TIKI,thoi-trang-nu,82700848,"Bộ 5 Quần Lót Cotton 365 không hăn chống HPV 10 màu big size đến 65kg cạp vừa thương hiệu Baw QLN17",199000,199000,0,0
TIKI,thoi-trang-nu,85184191,"Đồ bơi nữ dài tay, chân váy may liền quần sooc đùi kín đáo, size từ 43 đến 68kg, chất thun bơi cao cấp dày đẹp | KT025",396000,445000,49000,11
TIKI,thoi-trang-nu,97758054,"Áo lót không gọng nâng ngực cao cấp, Áo lót nhún nơ thông hơi không gọng sexy thương hiệu BAW TN741",159000,159000,0,0
TIKI,thoi-trang-nu,145289760,"Chân Váy Công Sở New Design Thiết Kế Dáng Váy chữ A, Dài Qua Gối ,Phối Nút, Phom Chuẩn Tôn Dáng Sang Trọng Vải Tốt co Giãn, Màu Đen CV0066",179000,333000,154000,46
TIKI,thoi-trang-nu,82700818,"BỘ 5 QUẦN LÓT LỤA LẠNH FABIC CẠP CAO KHÁNG KHUẨN KHÔNG LỘ VIỀN CAO CẤP thương hiệu BAW QLN16",199000,199000,0,0
TIKI,thoi-trang-nu,181247126,"Quần Lót Độn Mông Hông Thông Hơi Siêu Thoáng Mát Mềm Mại 2IN1 Sexy Quyễn Rũ",295000,335000,40000,12
TIKI,thoi-trang-nu,21145963,"Bộ 2 Quần Lót Nữ Cotton Phối Ren Miley Lingerie FCB_04",104000,250000,146000,58
TIKI,thoi-trang-nu,272556413,"Chân váy lụa dài dáng đuôi cá cạp trễ cao cấp",208000,380000,172000,45
TIKI,thoi-trang-nu,252657874,"Áo thun Nữ croptop cổ tròn tay ngắn 7 màu cotton lạnh chất đẹp siêu co giãn chống bai xù",75000,75000,0,0
TIKI,thoi-trang-nu,74855108,"Combo 10 Quần Lót Nữ Cotton Thái Siêu Mịn, Kháng khuẩn BLAZEL - Chất Liệu Thấm Hút Và Co Giãn 4 Chiều Tốt (Nhiều Màu)  - Hàng Chính Hãng",99000,99000,0,0
TIKI,thoi-trang-nu,95877962,"Quần ngắn ngủ nữ, thun cotton, thoáng mát, mặc nhà, đi chơi, ống rộng, lưng thun, co dãn, họa tiết đa dạng",59000,59000,0,0
TIKI,thoi-trang-nu,55042458,"Đồ Bơi Nữ Hai Mảnh Đa Năng AT168 MayHomes Áo Bơi Nữ Và Quần Bơi Short Nữ",159000,165000,6000,4
TIKI,thoi-trang-nu,132171331,"Áo Lót Nữ, Áo Ngực Dán Cài Trước, Áo Ngực Dán Xòa Đệm Thông Hơi Sexy Quyến Rũ Thương Hiệu Baw MS2",159000,159000,0,0
TIKI,thoi-trang-nu,106002718,"Hộp 5 Đôi 10 Miếng Dán Ti, Dán Ti Silicon Sử Dụng Nhiều Lần Dính Cực Chắc DT01",159000,159000,0,0
TIKI,thoi-trang-nu,44248342,"Combo 10 quần lót nữ cao cấp, hàng đẹp loại tốt, co giãn đàn hồi tốt, không gây khó chịu khi mặc,đồ lót nữ phù hợp mọi lứa tuổi",219000,219000,0,0
TIKI,thoi-trang-nu,180347781,"Combo 2 quần lót lọt khe ren hở mông, quần chip nữ, quần lót nữ sexy hở đáy đầy cám dỗ LYEQ073 (MÀU NGẪU NHIÊN)",62000,86000,24000,28
TIKI,thoi-trang-nu,106765137,"Áo Ngực Đúc Su Không Gọng Xuất Nhật đệm mỏng chống ung thư Thương Hiệu Baw mã AN031",159000,159000,0,0
TIKI,thoi-trang-nu,1752845,"Bộ 10 Quần Lót Nữ Modal Miley Lingerie - Giao Màu Ngẫu Nhiên - Size",398000,398000,0,0
TIKI,thoi-trang-nu,70816541,"COMBO 5 quần đùi nữ May 10, quần mặc nhà, quần ngủ",115000,135000,20000,15
TIKI,thoi-trang-nu,173015547,"Váy ngủ nữ, váy lụa 2 dây VILADY - V127 dáng suông màu xanh rêu, chất liệu lụa Pháp cao cấp ( lụa latin)",199000,250000,51000,20
TIKI,thoi-trang-nu,187657697,"Quần Ghen Nịt Bụng, Quần Lót Đùi Mặc Váy Có Khuy Nịt Bụng Ôm Bụng Dưới, Quần Lót Su Cạp Cao Giảm Eo Và Mỡ Bụng Sau Sinh QG13",119000,119000,0,0
TIKI,thoi-trang-nu,101439243,"Combo 5 Quần Lót Thun Lạnh Ren Sườn Active Miley Lingerie FMM05 - Giao Màu Ngẫu Nhiên",189000,360000,171000,48
TIKI,thoi-trang-nu,21164740,"Váy ngủ lưới phối ren sexy, kèm quần lót lọt khe VN04, Freesize",85500,90000,4500,5
TIKI,thoi-trang-nu,73243081,"Áo Lót Không Gọng Đệm Mỏng LOIRE BRFC13 thiết kế Đệm Liền",149000,189000,40000,21
TIKI,thoi-trang-nu,193920267,"Áo Lót Dán Nâng Ngực Silicon - Áo Bra Dán Ngực Silicon Cài Trước Không Gọng Hình Bàn Tay  (Tặng Kèm Dây Trong)",52500,55000,2500,5
TIKI,thoi-trang-nu,42712220,"Quần Jean Nữ Lưng Cao AAA JEANS",429000,429000,0,0
TIKI,thoi-trang-nu,45600236,"Combo 5 Chiếc Quần Lót Nữ Không Đường May Cao Cấp iBasic V189 - Hàng Chính Hãng",325000,445000,120000,27
TIKI,thoi-trang-nu,171760300,"Bộ đồ Pyjama nữ, đồ mặc nhà VILADY - B106 kiểu quần đùi tay ngắn họa tiết lá xanh, chất liệu lụa Pháp (lụa latin) cao cấp",319000,499000,180000,36
TIKI,thoi-trang-nu,55578594,"Hộp 10 Miếng Dán Ngực Silicon",59000,59000,0,0
TIKI,thoi-trang-nu,84721263,"Áo Thun Nữ Trắng Tay Ngắn Cổ Tròn Aaa Jeans Vải Modal",189000,189000,0,0
TIKI,thoi-trang-nu,83907537,"Áo Ngực Lụa Sữa Tàng Hình Không Gọng Đệm Mỏng Chống Hở Viền Phong Cách Nhật Bản Ôm Trọn Ngực Thương Hiệu Baw mã AN11",89000,89000,0,0
TIKI,thoi-trang-nu,172998034,"Váy ngủ nữ, váy lụa 2 dây VILADY - V129 dáng suông màu ĐEN huyền bí, chất liệu lụa Pháp cao cấp ( lụa latin)",199000,250000,51000,20
TIKI,thoi-trang-nu,172926829,"Váy ngủ nữ, váy 2 dây lụa VILADY - V128 dáng suông màu đỏ đô  chất liệu lụa Pháp cao cấp",199000,250000,51000,20
TIKI,thoi-trang-nu,84446029,"Áo Ngực Không Dây Nâng Ngực dành cho áo ống, kèm dây trong dành cho áo hở lưng thương hiệu BAW mã AN16",159000,159000,0,0
TIKI,thoi-trang-nu,106782807,"Áo Lót Nữ, Áo Ngực Dán Cài Trước, Áo Ngực Dán Đệm Bàn Tay Sexy Quyến Rũ Thương Hiệu Baw MS1",159000,159000,0,0
TIKI,thoi-trang-nu,160221521,"Áo croptop nữ tay lỡ , from rộng, freesize , thun cotton mềm mịn",78000,78000,0,0
TIKI,thoi-trang-nu,11339281,"Combo 5 Quần Nữ Ren Ép Bông Miley Lingerie Lily Flower - S",198000,198000,0,0
TIKI,thoi-trang-nu,88000356,"Combo 10 Quần Lót Nữ Su Thông Hơi không đường may, hàng đẹp loại xịn thương hiệu Baw, nhiều màu, vải thun lạnh, thông hơi, co giãn đàn hồi tốt, thấm hút tốt, phù hợp mọi lứa tuổi",189000,189000,0,0
TIKI,thoi-trang-nu,82695200,"Bộ 5 Quần Lót Su đúc viền sóng Vanvene cạp vừa không hằn viền lót may chắc chắn đủ size thương hiệu BAW QLN02",199000,199000,0,0
TIKI,thoi-trang-nu,178062830,"Cặp Miếng Dán Ngực Miley Lingerie GSB0100",20000,25000,5000,20
TIKI,thoi-trang-nu,132125952,"Áo gia đình Love you Đồ đôi mẹ và bé Đồng phục gia đình 3/4/5 người Thun cotton Màu xanh lá GD291XL",49000,49000,0,0
TIKI,thoi-trang-nu,120519525,"Áo lưới thun cực Sexy",55000,55000,0,0
TIKI,thoi-trang-nu,132138506,"Áo gia đình 3/4/5 người dễ thương Đồng phục gia đình giá rẻ Thun cotton đủ size Màu trắng GD329T",25000,25000,0,0
TIKI,thoi-trang-nu,84574514,"Áo Ngực Cài Trước Siêu Nâng Ngực Tạo Khe sexy quyến rũ thương hiệu BAW mã AN28",159000,159000,0,0
TIKI,thoi-trang-nu,184521972,"Váy ngủ bodysuit ren sexy cao cấp Q426 - Đồ ngủ bodysuit hở đáy gợi cảm - Đầm ngủ bodysuit nữ - Bodysuit ren quyến rũ",99000,190000,91000,48
TIKI,thoi-trang-nu,169135603,"Áo ngực nữ kiểu dáng basic trơn cao cấp Lylylorem AL088",150000,150000,0,0
TIKI,thoi-trang-nu,146222727,"Áo polo nữ ADINO màu trắng phối viền xẻ lai vải cotton co giãn dáng slimfit trẻ trung APN02",139000,278000,139000,50
TIKI,thoi-trang-nu,84985042,"Gen nịt bụng Latex dáng chuẩn - Đai nịt bụng eo thon 9 khuy  Hy Lạp",320000,320000,0,0
TIKI,thoi-trang-nu,167957548,"Combo 2 quần lót nữ, quần lót tam giác ren thêu hoa xuyên thấu lọt khe quyến rũ hấp dẫn ( màu ngẫu nhiên) LYEQ043",74000,78000,4000,5
TIKI,thoi-trang-nu,70738824,"Combo 5 Quần Lót Nữ Cotton Flexi Miley Lingerie - Giao màu ngẫu nhiên",179000,395000,216000,55
TIKI,thoi-trang-nu,181247408,"Quần Legging Lửng Siêu Co Giãn Thoáng Mát Nâng Mông Siêu Hót Siêu Đẹp Ngố Nữ Cạp Cao Vải Cotton Cao Cấp",118000,185000,67000,36
TIKI,thoi-trang-nu,105657199,"Quần Lót Nữ, Quần Gen Nịt Bụng Eo Thon, Quần Ghen Chống Cuộn Cạp Cao Giảm Eo Và Mỡ Bụng Sau Sinh QG3",129000,129000,0,0
TIKI,thoi-trang-nu,106756612,"Áo Lót Nữ, Áo Lót Đúc Su Đệm Dày Siêu Nâng Ngực Tạo Khe Quyến Rũ, Áo Ngực Su Thương Hiệu BAW Mã AN373",109000,109000,0,0
TIKI,thoi-trang-nu,95014142,"Áo thun nữ trơn Gold Rhino cao cấp, 2 màu Trắng / Đen, hàng xuất khẩu Nhật Bản, 100% cotton chất xịn, áo phông nữ trơn mềm mịn, thấm hút mồ hôi, kháng khuẩn, khử mùi hôi triệt để - Hàng chính hãng - Đen",175000,350000,175000,50
TIKI,thoi-trang-nu,119239576,"Bộ đồ linen nữ sát nách trẻ trung, thời trang phong cách trẻ",289000,289000,0,0
TIKI,thoi-trang-nu,180000758,"Váy ngủ ngắn tay, đầm mặc nhà freesize vải lanh cotton lụa tự nhiên thoáng mát nhiều màu mã VAV0269",119000,119000,0,0
TIKI,thoi-trang-nu,102121667,"Bộ Đồ Ngủ Nữ Lụa Satin Có Mút Ngực Phối Ren Cao Cấp, Bộ Đồ Ngủ Nữ, Bộ Đồ Ngủ Nữ 2 dây, Đồ Ngủ Gợi Cảm, Đồ Ngủ Sexy, Đồ Ngủ Lụa Mặc Nhà 2 Dây Phối Ren Sexy Quyến Rũ Thương Hiệu Baw Mã DN29 (hình thật shop tự chụp)",199000,199000,0,0
TIKI,thoi-trang-nu,163477532,"Quần Đùi Nữ New Design, Quần Short Nữ Cạp Chun, Vải Lụa Mịn, Thoáng Mát ,Mặc Thoải Mái Nhiều Màu ( 40-65 kg) QA0003",41000,69000,28000,41
TIKI,thoi-trang-nu,97033776,"Áo hoodie có dây kéo in chữ missout thời trang, Áo Khoác Nỉ Bông Loại 1 Missout, Áo Khoác Nỉ Bông Loại 1 Missout, Áo khoác Hoodie dây kéo chất nỉ ngoại form rộng có mũ",99000,99000,0,0
TIKI,thoi-trang-nu,28390948,"Quần tây nữ công sở kiểu quần tây dáng đứng GOTI 3089",161000,189000,28000,15
TIKI,thoi-trang-nu,54619232,"Set BIKINI 2 Mảnh Dáng Đẹp Tươi Trẻ AT165 MayHomes, Chất Liệu Bền Và Co Giãn Tốt, Không Phai Màu",217550,229000,11450,5
TIKI,thoi-trang-nu,111694609,"Áo sơ mi nữ cộc tay dáng cánh dơi cá tính",79000,79000,0,0
TIKI,thoi-trang-nu,189181218,"Đầm 8 mảnh phối bèo cổ dễ thương-D029",205000,390000,185000,47
TIKI,thoi-trang-nu,151898685,"áo khoác nỉ nữ NÓN 2 LỚP phong cách cực cute THÊU GẤU HOT TREND 2022, áo khoác Nỉ kéo khoá thêu hình gấu 2 nón, Áo Khoác Nỉ Khoá Kéo Hình Gấu Unisex Mặc Ấm, Áo KHOÁC NỈ thêu Gấu CHẤt nỉ cotton dày dặn có lót lông",109000,109000,0,0
TIKI,thoi-trang-nu,191987016,"Áo Khoác Chống Nắng Nữ Couple TX Phối Lưới Thoáng Khí WOK 2022",679000,679000,0,0
TIKI,thoi-trang-nu,190538075,"Đầm ngủ, Váy ngủ lụa Pháp (Lụa Latin) thiết kế 2 dây chéo lưng phối ren cao cấp VILADY - V147 (Màu Trắng gạo)",299000,479000,180000,38
TIKI,thoi-trang-nu,180590012,"Đầm nữ dự tiệc màu trắng dáng xòe cổ V",300000,300000,0,0
TIKI,thoi-trang-nu,105393105,"Quần Lót Nữ, Bộ 5 Quần Lót Nữ Cạp Cao Giảm Eo, Quần Lót Nữ Kháng Khuẩn, Quần Lót Nữ  Phối Ren Cao Cấp Mềm Mịn Thương Hiệu Baw Mã QLN0303",229000,229000,0,0
TIKI,thoi-trang-nu,146365730,"Đai Nịt Bụng Vita Latex "Thế Hệ Mới" Cao Cấp Che Mỡ Lưng, Định Hình Eo",599000,599000,0,0
TIKI,thoi-trang-nu,216199950,"Áo Hoodie Kéo Khóa Siêu Sang, Giá Tận Gốc, áo khoác hoodie nỉ nam nữ chất thun nỉ mềm mịn from rộng (có khóa kéo), Áo khoác Hoodie Nam Nữ form rộng - Basic Oversize Zip, Aó hoodie nam , áo hoodie nữ , áo khoác áo hoodie cặp đôi nam nữ mặc",100000,100000,0,0
TIKI,thoi-trang-nu,59205628,"COMBO 5 ÁO LÁ DÀI THUN LỤA DÀNH CHO HỌC SINH",110000,130000,20000,15
TIKI,thoi-trang-nu,134416711,"Bộ Đồ Nữ Mặc Trong Nhà Bộ Đồ Ngủ Hình Bò Sữa Dễ Thương DB003 MayBlue Chất Liệu Cate",75050,79000,3950,5
TIKI,thoi-trang-nu,160819392,"Bồ đồ lót, Set nội y ren xuyên thấu, không gọng mỏng, nhẹ, thêu hoa đầy nữ tính và gợi cảm LYEB024",65550,69000,3450,5
TIKI,thoi-trang-nu,82700771,"Bộ 5 Quần Lót Đúc Su Ren, chất Su phối ren thoáng mát thương hiệu BAW QLN013",199000,199000,0,0
TIKI,thoi-trang-nu,103433177,"Quần ống rộng khóa sườn dáng dài éo thon, mặc cực mát, tôn dáng",85000,85000,0,0
TIKI,thoi-trang-nu,155792751,"Váy ngủ hai dây nữ, đầm ngủ nữ cổ V freesize thoải mái chất vải lanh lụa cotton tự nhiên thoáng mát nhiều màu mã VAV0221",139000,139000,0,0
TIKI,thoi-trang-nu,166531902,"Áo Ngực Nữ, Áo ngực không dây, Áo ngực dây lưng trong có dây rút và bàn tay cúp ngang chống tụt mang đầm hở lưng cúp ngực thương hiệu Baw CT01",159000,159000,0,0
TIKI,thoi-trang-nu,176184092,"Váy ngủ ren hai dây sexy gợi cảm BT0157 - Đầm ngủ nữ xuyên thấu quyến rũ - Đồ ngủ nữ mạc nhà - Váy ngủ nữ",107000,107000,0,0
TIKI,thoi-trang-nu,102508214,"Áo Chống Nắng Dáng Ngắn Có Túi Cuộn Atuner AT 029, Vải Cotton, Mỏng Nhẹ, Thông Hơi, Chống Tia UV",79000,149000,70000,47
TIKI,thoi-trang-nu,58255254,"Combo 4 Quần Lót Nữ Lưng Cao Modal Phối Ren Active Miley Lingerie FDS0125-0225-0925-1225 - Giao màu ngẫu nhiên",154000,380000,226000,59
TIKI,lam-dep-suc-khoe,20701571,"Tinh dầu dưỡng tóc AURANE Softliss Fantastic Repair hair oil 125ml",123500,130000,6500,5
TIKI,lam-dep-suc-khoe,137253587,"Máng Trainer ( Niềng răng chỉnh nha)|DỤNG CỤ NIỀNG RĂNG",56000,56000,0,0
TIKI,lam-dep-suc-khoe,8057340,"Xà Phòng Giảm Mụn Lưng For Back 135g Nội Địa Nhật Bản",96000,98280,2280,2
TIKI,lam-dep-suc-khoe,190290564,"Khẩu trang y tế VN95 an tâm, Lẻ 10 cái. sỉ thùng 500 cái, kháng khuẩn chống virus Corona chủng BA5, chuyên dụng cho bệnh viện",7000,7000,0,0
TIKI,lam-dep-suc-khoe,176048170,"Thực phẩm bảo vệ sức khỏe Thảo mộc cải thiện cân nặng Slimming Care X3 ( số 2) hộp 15 viên - dành cho người béo lâu năm, cơ địa chai lì",473000,550000,77000,14
TIKI,lam-dep-suc-khoe,91565658,"Combo 6 Băng Vệ Sinh Quần Peppy Shana Siêu Thấm Free Size (12 miếng)",79550,89000,9450,11
TIKI,lam-dep-suc-khoe,108535201,"Bao cao su Sagami White box - Có gai - Hộp 10 chiếc",69000,120000,51000,43
TIKI,lam-dep-suc-khoe,190641506,"Sữa Rửa Mặt Dịu Nhẹ Cho Da Dầu CeraVe Foaming Cleanser 473ml",386000,455000,69000,15
TIKI,lam-dep-suc-khoe,76564284,"Xịt Họng Keo Ong 3T 25ml Giảm Đau Họng, Ho Khan, Ngứa Rát Họng",49500,99000,49500,50
TIKI,lam-dep-suc-khoe,11874956,"Viên Uống Cân Bằng Nội Tiết Tố, Cải Thiện Sinh Lý Nữ Marilyn (Hộp 30 viên)",198000,198000,0,0
TIKI,lam-dep-suc-khoe,192704831,"Kem che khuyết điểm Mochi Nhật Bản",99000,99000,0,0
TIKI,lam-dep-suc-khoe,46643670,"Cho máy Oral-B Braun,  Bộ 4 đầu bàn chải đánh răng điện - Trẻ em, cho mọi loại máy - EB10A",115000,115000,0,0
TIKI,lam-dep-suc-khoe,169585264,"Obagi Retinol 1.0 (28g)",1280000,1750000,470000,27
TIKI,lam-dep-suc-khoe,176296819,"Nước Cân Bằng Giảm Mụn Và Thông Thoáng Lỗ Chân Lông SVR Sebiaclear Micro - Peel 150ml",312000,390000,78000,20
TIKI,lam-dep-suc-khoe,188785183,"Saffron mật ong đông trùng hạ thảo Kingdom Herb chính hãng thượng hạng hộp 312g (tặng bình thuỷ tinh và cây lấy mật)",400000,789000,389000,49
TIKI,lam-dep-suc-khoe,29496992,"FLOSLEK PHARMA GEL RỬA MẶT DIỆT KHUẨN NGỪA MỤN ANTIBACTERIAL FACE CLEANSING GEL 200ML",277000,396000,119000,30
TIKI,lam-dep-suc-khoe,106969437,"Dầu Gội Dược Liệu Nguyên Xuân Bồng Bềnh - Thơm Ngát Hương Hoa Tự Nhiên",78400,78400,0,0
TIKI,lam-dep-suc-khoe,144208515,"Dầu gội khô Girlz Only Dry Shampoo 200ml",89000,89000,0,0
TIKI,lam-dep-suc-khoe,118090021,"Bộ 2 Hộp Viên Sủi Bổ Sung Vitamin Berocca Performance Mango 10 Viên/Hộp",196000,196000,0,0
TIKI,lam-dep-suc-khoe,186272570,"Đôi Giày Chườm Nóng Thảo Dược Giảm Đau Bàn Chân Dùng Điện Phiên Bản Vỏ Đai Bằng Vải Da Lộn - Hapaku",995000,1300000,305000,23
TIKI,lam-dep-suc-khoe,270548759,"Omega 3 Úc Healthy Care Fish Oil giúp bổ mắt, kháng viêm, tốt cho trí não, tim mạch - QuaTangMe Extaste",378400,910000,531600,58
TIKI,lam-dep-suc-khoe,190119292,"Bấm Móng Tay Thép Carbon Chuyên Dụng KỀM NGHĨA B.939 - Lưỡi Cong (Loại Lớn)",27550,29000,1450,5
TIKI,lam-dep-suc-khoe,118089805,"Kem Chống Hăm Bepanthen Balm Dạng Kem Mỡ 30G/Tuýp",95500,95500,0,0
TIKI,lam-dep-suc-khoe,74192960,"Máy Massage Cổ Vai Gáy Chuyên Sâu 3D KINGTECH KS460 - Hỗ Trợ Mát xa Đùi, Chân, Lưng Dưới - Tích Hợp Nhiệt Hồng Ngoại - Tiện Sử Dụng Tại Nhà, Văn Phòng, Du Lịch - Quà Tặng Tuyệt Vời Dành Cho Người Thân - Chính Hãng",1038000,1750000,712000,41
TIKI,lam-dep-suc-khoe,132081941,"Mặt Nạ Ngủ Dưỡng Ẩm Laneige Water Sleeping Mask EX",270000,310000,40000,13
TIKI,lam-dep-suc-khoe,180303300,"Dầu chăm sóc da giúp cải thiện rạn da, mờ sẹo và đều màu da - BIO-OIL SKINCARE OIL (chai 200ml)",435000,460000,25000,5
TIKI,lam-dep-suc-khoe,273217865,"Combo Máy khuếch tán/ máy xông tinh dầu Bí Ngô Lorganic FX2027 + tinh dầu sả chanh + tinh dầu cam Lorganic (10ml x2)",250000,400000,150000,38
TIKI,lam-dep-suc-khoe,8011746,"Tinh Chất Hàu Biển OYSTER MAN Tăng Cường Sinh Lý Nam, Cải Thiện Xuất Tinh Sớm, Yếu Sinh Lý (Hộp 30 Viên)",109500,219000,109500,50
TIKI,lam-dep-suc-khoe,126959538,"Serum hôi nách INOD Huyền Phi 5ml tác dụng triệt hôi nách, hôi chân , mồ hôi tay chân vĩnh viên",161400,161400,0,0
TIKI,lam-dep-suc-khoe,34315213,"Dao Cạo Râu 2 Lưỡi Dorco TG 710YL-5P (05 Dao Cạo)",28000,28000,0,0
TIKI,lam-dep-suc-khoe,631026,"Dung dịch dưỡng ẩm tối ưu Hada Labo Advanced Nourish Lotion dùng cho da thường và da khô 170ml",168000,208000,40000,19
TIKI,lam-dep-suc-khoe,2775397,"Bao Cao Su Có Gai Nhật Bản Sagami Extreme White (10 Cái / Hộp)",56000,56000,0,0
TIKI,lam-dep-suc-khoe,10639651,"Thực Phẩm Chức Năng Heposal - Phục hồi tổn thương viêm gan xơ gan",350000,360000,10000,3
TIKI,lam-dep-suc-khoe,147420070,"Bộ quà tặng cho nam FULL-HOUSE BOX-Sữa tắm gội hương nước hoa 3in1 350ml & Dung dịch vệ sinh nam giới 50g & Gel rửa mặt Nano Curcumin 100ml",476000,595000,119000,20
TIKI,lam-dep-suc-khoe,164410334,"Son Môi M.O.I Hồ Ngọc Hà Son Thỏi LOVE BY THUỲ TIÊN 2022 (Bản Giới Hạn)",249000,359000,110000,31
TIKI,lam-dep-suc-khoe,166369511,"Sữa tắm gội cho nam Romano 2 trong 1 Gentleman 650g",154000,191000,37000,19
TIKI,lam-dep-suc-khoe,76210034,"Combo 2 Tinh Dầu Sả Chanh 50ML (Lemongrass) + Tinh Dầu Oải Hương 50ML (Lavender) - Tinh Dầu TIDAMO Nguyên Chất Xông Phòng Giúp Thư Giãn, Thơm Phòng và Nâng Cao Sức Khỏe - Rất Tốt Khi Sử Dụng Với Máy Xông Tinh Dầu",184000,436000,252000,58
TIKI,lam-dep-suc-khoe,11625471,"Titan Gel Nga - Gel bôi trơn  tăng kích thước 50ml - hàng chuẩn Nga",230000,230000,0,0
TIKI,lam-dep-suc-khoe,2775387,"Bao Cao Su Sagami Xtreme Super Thin (10 Cái / Hộp)",95000,95000,0,0
TIKI,lam-dep-suc-khoe,53410887,"Cân Điện Tử Sức Khỏe Hình Chú Heo Xinh Xắn Dành Cho Gia Đình + Tặng kèm 1 thước dây",60191,60191,0,0
TIKI,o-to-xe-may-xe-dap,84543545,"Tấm Phản Quang Gắn Baga Sau Xe đạp",19000,25000,6000,24
TIKI,o-to-xe-may-xe-dap,166208742,"Máy thiết bị quét đọc xóa lỗi xe hơi OBD2 ô tô wifi tex nhanh bản cao cấp , cách khắc phục đèn báo lỗi trên ô tô",269000,269000,0,0
TIKI,o-to-xe-may-xe-dap,1254631,"Chai Vệ Sinh Động Cơ Và Hệ Thống Phun Xăng Cao Cấp Bluechem Fuel System Cleaner (250ml)",251000,265000,14000,5
TIKI,o-to-xe-may-xe-dap,2050479,"Băng keo cường lực siêu dính 3M  4229P-20 20mm x10m",126000,126000,0,0
TIKI,o-to-xe-may-xe-dap,3654231,"Đèn LED Trợ Sáng L5 Cho Xe Máy",53000,59000,6000,10
TIKI,o-to-xe-may-xe-dap,21766582,"Bộ Gương Chiếu Hậu Rizoma 5 cạnh",136000,145000,9000,6
TIKI,o-to-xe-may-xe-dap,191755621,"Chai phục hồi nhựa đen cho xe ô tô, dung dịch làm mới nhựa nhám thật hiệu quả, cho xế yêu của bạn luôn đen bóng như mới.",120000,120000,0,0
TIKI,o-to-xe-may-xe-dap,41502149,"Chai xịt chăm sóc và bảo dưỡng nội thất ô tô 3M 39040LT tặng khăn lau ô tô chuyên dụng 3M màu ngẫu nhiên",225000,225000,0,0
TIKI,o-to-xe-may-xe-dap,141513879,"Bộ Đổi Điện Sóng Sin Chuẩn, Bộ Kích Điện 12V Lên 220V Chuẩn Như Điện Lưới, inverter 12v 220v công suất 1000W 2000W 3000W",999000,999000,0,0
TIKI,o-to-xe-may-xe-dap,131590590,"Miếng Dán Bảo Vệ Sườn Xe Đạp - Khung Xe Đạp - Chống Trầy Xước -  Chống Thấm Nước",27000,27000,0,0
TIKI,o-to-xe-may-xe-dap,58911643,"2 túi thơm cà phê khử mùi, treo xe hơi (130gram x 2)",53000,53000,0,0
TIKI,o-to-xe-may-xe-dap,58877049,"Bình Xịt Dưỡng Bóng Lốp Ô Tô Flamingo (500ml)",84900,84900,0,0
TIKI,o-to-xe-may-xe-dap,107337725,"Nước Hoa Ô Tô Chính Hãng Nhập Khẩu Khử Mùi Xe Hơi Cao Cấp ETONNER E1701D (60ml)",1200000,1200000,0,0
TIKI,o-to-xe-may-xe-dap,7816027,"Còi hú 3 chế độ cho xe máy oto",67000,75000,8000,11
TIKI,o-to-xe-may-xe-dap,105742301,"Bộ sạc ắc quy 12v/24v 3AH - 200ah máy sạc bình xe máy ôtô xe tải thông minh tự động ngắt khi đầy",255000,255000,0,0
TIKI,o-to-xe-may-xe-dap,16648124,"Mũ bảo Hiểm Royal M139 (Size XL) - Đen Nhám  - Hàng chính hãng",540000,700000,160000,23
TIKI,o-to-xe-may-xe-dap,71149087,"Miếng Đệm Lót Bao Yên Xe Đạp Rộng Cao Cấp Với Mút Mềm Foam Đàn Hồi, Bao Yên Silicon Gel Cho Xe Đạp Thể Thao Địa Hình MTB, Xe Đạp Leo Núi",159000,179000,20000,11
TIKI,o-to-xe-may-xe-dap,124992544,"Nhớt Tổng Hợp Motul H Tech 100 4T 10W40 Có Chiêt Lẻ",225000,225000,0,0
TIKI,o-to-xe-may-xe-dap,249418419," Bộ 2 đèn LED van bánh xe đạp, xe máy, ô tô ( Xanh Dương )",18600,18600,0,0
TIKI,o-to-xe-may-xe-dap,4893545,"Máy bơm lốp xe hơi, ô tô, xe máy đạp chân",69900,69900,0,0
TIKI,o-to-xe-may-xe-dap,34701184,"Chai xịt vệ sinh máy điều hòa (máy lạnh) Sandokkaebi 330ml nhập khẩu trực tiếp từ Hàn Quốc",99000,99000,0,0
TIKI,o-to-xe-may-xe-dap,158774476,"Còi Điện Xe Đạp - Còi Điện Tử Gắn Tay Lái Chống Mưa Gắn Tay Lái Xe Đạp tặng kèm chuông xe đạp",95000,95000,0,0
TIKI,o-to-xe-may-xe-dap,25914840,"Ví đựng giấy tờ ô tô có logo theo xe,logo hyundai",23000,23000,0,0
TIKI,o-to-xe-may-xe-dap,97829174,"Khóa xe máy chữ U inox chống trộm size nhỏ - Bảo vệ xe an toàn",89000,89000,0,0
TIKI,o-to-xe-may-xe-dap,165675797,"Khăn Lau Đa Năng Khăn Lau Xe Ô Tô, Khăn Lau Tay, Khăn Lau Bếp Nhiều Size,  Nhiều Màu Ngẫu Nhiên",19000,19000,0,0
TIKI,o-to-xe-may-xe-dap,91630190,"Gối Tựa Lưng Ghế Văn Phòng Ghế Ô Tô Vỏ Bằng Vải Lưới Có Đai Cài Và Viền Sang Trọng Backrest Pillow",138000,138000,0,0
TIKI,o-to-xe-may-xe-dap,253212043,"Khóa dây xe đạp 4 số chống trộm dài 1m5 tặng túi đựng treo xe - Khoá đa năng",75000,75000,0,0
TIKI,o-to-xe-may-xe-dap,14381819,"Đèn led trang trí gầm đổi màu cho xe ô tô xe hơi - đèn led đổi nhạc",87000,87000,0,0
TIKI,o-to-xe-may-xe-dap,87534113,"Bộ Dụng Cụ Sửa Chữa Xe Đạp Di Động Bơm Lốp Đa Năng Mini Và Vá Săm Xe Đạp Gắn Sườn Xe (Dạng Bình Nước) MaiLee",303050,319000,15950,5
TIKI,o-to-xe-may-xe-dap,153960176,"Bọc khóa smartkey dành cho Honda SH, SHmode mode, PCX Bezen Armor",79000,79000,0,0
TIKI,o-to-xe-may-xe-dap,53626220,"Miếng Đệm Trợ Lực Tay Ga Chống Mỏi Cổ Tay",25000,25000,0,0
TIKI,lam-dep-suc-khoe,173224715,"Kem đánh răng Colgate thiên nhiên muối hồng Himalaya 180g",50000,55000,5000,9
TIKI,lam-dep-suc-khoe,59052059,"Viên uống tăng cường nội tiết tố nữ Marilyn Plus 30 viên",229000,229000,0,0
TIKI,o-to-xe-may-xe-dap,171502562,"Combo 2 Móc Treo Đồ Chữ S Gắn Sau Ghế Ô Tô Xe Hơi Tiện Lợi - Chịu Lức Đến 20 KG",32000,32000,0,0
TIKI,o-to-xe-may-xe-dap,72050492,"Bộ 2 Gương Lồi Car365 Xoay 360 độ Gắn Cho Kính Gương Chiếu Hậu Tránh Điểm Mù Cho Xe Hơi, Xe Ô tô - Hàng Chính Hãng",39000,39000,0,0
TIKI,lam-dep-suc-khoe,194465122,"Bàn chải đánh răng điện LocknLock Smart oscillating electric toothbrush ENR626BLK - 3 chế độ, đế sạc cảm ứng, chống nước - Màu đen - Hàng Chính Hãng",777000,1490000,713000,48
TIKI,lam-dep-suc-khoe,59289658,"Miếng Dán Say Tàu Xe Say Sóng Say Tàu Máy Bay ( Hộp 10 miếng )",130350,130350,0,0
TIKI,lam-dep-suc-khoe,11254937,"Kem dưỡng trắng da ban đêm White Lucent Overnight Cream & Mask 75mL",2300000,2300000,0,0
TIKI,o-to-xe-may-xe-dap,80877051,"Sú.ng xịt rửa cao áp kiểu dài 86cm cho máy rửa xe Bos.ch, Bos.ch- AQT(HÀNG OEM)",295000,295000,0,0
TIKI,lam-dep-suc-khoe,272284946,"Vitamin E Mỹ Kirkland Signature giúp đẹp da, tóc, làm chậm quá trình lão hóa, chậm nhăn da, tốt cho tim mạch, hỗ trợ sức khỏe sinh sản- OZ Slim Store",463000,1002000,539000,54
TIKI,lam-dep-suc-khoe,84920809,"Dầu gội dược liệu Thái Dương 7 Plus",74800,74800,0,0
TIKI,lam-dep-suc-khoe,217417613,"Bao Cao Su LifeStyles ZERO Cao Cấp Siêu Mỏng Tuyệt Đối, Dẻo Dai  - Hộp 3 bao",75000,75000,0,0
TIKI,lam-dep-suc-khoe,41352350,"Mặt nạ giấy Maycreate HA Mask (hộp 20 miếng)",89000,125000,36000,29
TIKI,lam-dep-suc-khoe,135973753,"Kem Dưỡng Ẩm A-Derma Cho Viêm Da Cơ Địa & Da Khô Exomega Allergo Emollient Cream 200ml",654000,770000,116000,15
TIKI,lam-dep-suc-khoe,136029472,"Combo 30 bàn chải đánh răng Sunree",149000,149000,0,0
TIKI,lam-dep-suc-khoe,1600023,"Combo 6 Băng Vệ Sinh Diana Siêu Thấm Siêu Mỏng Không Cánh (Gói 8 Miếng)",120000,126000,6000,5
TIKI,o-to-xe-may-xe-dap,3871403,"Băng keo cường lực 3M 5952-5 size 12mmx5m",75000,75000,0,0
TIKI,o-to-xe-may-xe-dap,2589483,"Chai Xịt Rửa Sên Xe Máy Thunder MC-40 (400ml)",53000,53000,0,0
TIKI,lam-dep-suc-khoe,79411383,"Kem chống nắng Skin Aqua dưỡng da cho mặt khi hoạt động ngoài trời dạng gel Sunplay Skin Aqua Clear White Outdoor+ SPF50+ PA++++ 30g",102000,126000,24000,19
TIKI,lam-dep-suc-khoe,56648484,"Bigsize - Bộ sản phẩm tan mỡ bụng an toàn và hiệu quả Truesky gồm 1 kem tan mỡ bụng quế gừng 200g + 1 đại nịt bụng quấn nóng",320000,320000,0,0
TIKI,lam-dep-suc-khoe,97435337,"Cho máy Oral B Braun Cross Action EB-50A, Set Bộ 4 đầu bàn chải đánh răng điện đánh tan mảng bám",165000,165000,0,0
TIKI,lam-dep-suc-khoe,251275874,"Gel bôi trơn KLY Gốc nước Thổ Nhĩ Kỳ",50000,55000,5000,9
TIKI,o-to-xe-may-xe-dap,76132671,"Bình Xịt Làm Bóng Dàn Áo Lube71 Wink",200000,200000,0,0
TIKI,lam-dep-suc-khoe,13722426,"Lọ Tinh Dầu Thơm Phòng (khử mùi)",14000,22989,8989,39
TIKI,lam-dep-suc-khoe,76053236,"Combo 2 Sữa Tắm L'amont En Provence Rose (Hoa Hồng) Shower Gel 1000ml",329000,500000,171000,34
TIKI,lam-dep-suc-khoe,22052319,"Sữa rửa mặt cho nam Oxy sạch sâu giảm mụn kiểm soát nhờn dạng kem Oxy Total Anti Acne 100g",70000,86000,16000,19
TIKI,lam-dep-suc-khoe,35019646,"COMBO 10 MẶT NẠ 3W CLINIC 5 LOẠI DƯỠNG TRẮNG DA 7 NGÀY –CHIẾT XUẤT DƯA LEO, NHAU CỪU, ỐC SÊN , SỮA ONG CHÚA, NIACINAMIDE 3W CLINIC MASK SHEET 23ML/ MIẾNG",53000,53000,0,0
TIKI,thoi-trang-nu,146635373,"Áo sơ mi nữ form rộng kiểu tay lỡ cổ tròn NeSa Shop, chất liệu Đũi tơ thấm hút mồ hôi, áo sơ mi nữ nhiều màu, SMH.34",145000,219000,74000,34
TIKI,lam-dep-suc-khoe,653804,"Lưỡi Dao Cạo Gillette Vector 4",50000,50000,0,0
TIKI,lam-dep-suc-khoe,108693621,"Gel chống nắng dưỡng ẩm Hada Labo Koi-Gokujyun Perfect Uv Gel (Sunscreen) SPF50+ PA++++ 50g",252000,280000,28000,10
TIKI,thoi-trang-nu,145289939,"Chân Váy Dài Lưng Cao New Design ,Thiết Kế Dài 62cm, Phối Nút Phong Cách Váy Công Sở,  Chất Vải Tốt Co Giãn Nhẹ CV19",170000,349000,179000,51
TIKI,thoi-trang-nu,183588024,"Quần Lót Nữ, Bộ 5 Quần Lót Nữ Ren Cao Cấp Mềm Mịn, Quần Lót Nữ Co Dãn Tốt Thoáng Mát VILADY 5516",150000,150000,0,0
TIKI,lam-dep-suc-khoe,176554059,"Siro ho bổ phế Đ.Y chai 125ml - Giảm ho, ngứa rát cổ họng, khàn tiếng, bổ phổi từ thảo dược",18000,39000,21000,54
TIKI,lam-dep-suc-khoe,11255782,"Kem bôi da Thuần Mộc 13g giảm bong tróc, mẩn ngứa, dị ứng da...",109000,109000,0,0
TIKI,thoi-trang-nu,82874281,"Áo Ngực Đúc Su Không Gọng Xuất Nhật đệm mỏng chống ung thư Thương Hiệu Baw mã AN03",180000,180000,0,0
TIKI,thoi-trang-nu,72298386,"COMBO 4 Quần Lót Su Đúc LOIRECHIC QSD04 Không Viền May + Mỏng Nhẹ Thoải Mái",169000,295000,126000,43
TIKI,o-to-xe-may-xe-dap,192807451,"Dụng cụ vệ sinh sên / xích xe đạp cao cấp Hatsu FL14- Kiêm Dụng Cụ Tra Nhớt Sên/Xích - dòng cao cấp - hàng chính hãng",132000,132000,0,0
TIKI,lam-dep-suc-khoe,53585343,"Dụng cụ cắt móng tay của nhật - Giao màu ngẫu nhiên",20549,38000,17451,46
TIKI,lam-dep-suc-khoe,14422618,"Gối ngải cứu giảm đau xương khớp dùng lò vi sóng Hapaku",198000,230000,32000,14
TIKI,thoi-trang-nu,71929064,"Mút ngực cho Áo tập Yoga Gym Hibi Sports MUT007 - Loại bầu siêu nâng - 1 cặp",32000,40000,8000,20
TIKI,o-to-xe-may-xe-dap,162217847,"Ắc quy khô miễn bảo dưỡng Đồng Nai PTX5L | 12V - 3,5Ah",227000,227000,0,0
TIKI,thoi-trang-nu,213885378,"Đồ Bộ Mặc Nhà Trung Niên Chất Liệu Lanh Cao Cấp Đã Qua Xử Lý Co Size từ 47-70kg 2023 - Tuấn Tú Store",162000,162000,0,0
TIKI,o-to-xe-may-xe-dap,54046823,"Set 2 Khăn Lau Xe Hơi, Xe Ô Tô, Xe Máy Đa Năng, Kích Thước 30x60cm và 30x30cm, Thấm Hút Tốt Màu Sắc Ngẫu Nhiên",35000,35000,0,0
TIKI,lam-dep-suc-khoe,158564552,"Cold Wax - Wax Lông An Lành (Tặng 50 tờ giấy và 2 que wax)",55000,55000,0,0
TIKI,thoi-trang-nu,157054985,"Quần lót nữ định hình gen nịt bụng cạp cao nâng mông chất su không lộ viền Lylylorem",180000,180000,0,0
TIKI,thoi-trang-nu,182148167,"Váy ngủ bodysuit ren cổ yếm xẻ đáy sexy gợi cảm Q530 - Đầm ngủ nữ bodysuit quyến rũ - Đồ ngủ nữ",99000,180000,81000,45
TIKI,lam-dep-suc-khoe,453901,"Nước Súc Miệng Ngăn Ngừa Vôi Răng Listerine Tartar Protection (750ml) - 8850007811695",135000,173000,38000,22
TIKI,thoi-trang-nu,116150083,"Áo Phông Polo Nữ YODY Tay Ngắn Phối Bo Chất Liệu Pique Mắt Chim Co Giãn Thoải Mái - APN3340",289000,289000,0,0
TIKI,thoi-trang-nu,112686727,"Đầm dập li cổ vét sang trọng-MS0025",99000,190000,91000,48
TIKI,lam-dep-suc-khoe,1600057,"Combo 6 Băng Vệ Sinh Diana Super Night 35cm (Gói 3 Miếng)",103000,126000,23000,18
TIKI,lam-dep-suc-khoe,142762405,"Sữa dưỡng thể Vaseline dưỡng trắng da 725ml",155000,155000,0,0
TIKI,thoi-trang-nu,164545149,"Break all the rules, mã G41. Hãy tỏa sáng như kim cương, qua chiếc áo thun Goking siêu hot cho nam nữ trẻ em, áo phông cặp đôi, gia đình, đội nhóm",69000,69000,0,0
TIKI,thoi-trang-nu,172911485,"PARIS, mã G113. Hãy tỏa sáng như kim cương, qua chiếc áo thun Goking siêu hot cho nam nữ trẻ em, áo phông cặp đôi, gia đình, đội nhóm",69000,69000,0,0
TIKI,thoi-trang-nu,144324230,"Quần tây nữ Hiền Trần BOUTIQUE lưng cạp cao âu công sở đẹp màu đen đồ đi học form chuẩn tôn dáng",126000,350000,224000,64
TIKI,thoi-trang-nu,165193110,"Quần Ghen Định Hình, Quần Gen Nịt Bụng Dưới Su Pha Ren Có Móc Cài Và Size, Quần Ghen Cạp Cao Siêu Giảm Eo Và Mỡ Bụng Sau Sinh QG5",189000,189000,0,0
TIKI,thoi-trang-nu,172915665,"PARIS, mã G108. Hãy tỏa sáng như kim cương, qua chiếc áo thun Goking siêu hot cho nam nữ trẻ em, áo phông cặp đôi, gia đình, đội nhóm",69000,69000,0,0
TIKI,thoi-trang-nu,72030136,"Combo 5 quần lót nữ không đường may iBasic V188",379000,445000,66000,15
TIKI,thoi-trang-nu,104050175,"Quần Lengging Lửng Nữ Chất Thun Co Dãn 4 Chiều , Quần Ngố Chất Đẹp Dễ Phối Đồ Màu",45000,45000,0,0
TIKI,lam-dep-suc-khoe,10795648,"Serum Chống Nắng Dưỡng Thể Kháng Bụi - Trắng Sáng Mịn Màng Biore (150ml)",172000,216000,44000,20
TIKI,thoi-trang-nu,174086636,"Mút ngực định hình Oval cho Áo tập yoga gym Hibi Sports MUT009 - 1 cặp",32000,40000,8000,20
TIKI,thoi-trang-nu,164548324,"Có đồng đội ta chấp hết, mã TB2. Áo thun Team Building đồng đội, form unisex cho nam nữ, trẻ em, bé trai gái. Áo phông hàng hiệu Goking cho hội nhóm, trường lớp, đồng phục công ty",119000,119000,0,0
TIKI,lam-dep-suc-khoe,106082135,"Viên uống rau củ DHC Nhật Bản bổ sung chất xơ, giảm nổi mụn giảm nóng trong và làm đẹp da JN-DHC-VEG",265000,297330,32330,11
TIKI,thoi-trang-nu,74342785,"Áo Lót Nữ Không Gọng Nâng ngực nhẹ LOIRECHIC BRFC02 Kẻ Caro",139000,189000,50000,26
TIKI,lam-dep-suc-khoe,7979047,"Bột tẩy trắng răng Eucryl 50g (Chính hãng)",45000,45000,0,0
TIKI,thoi-trang-nu,144870196,"Quần jean nữ ống Baggy YODY phối cạp cao phong cách tôn dáng - QJN3076",399000,399000,0,0
TIKI,thoi-trang-nu,51033486,"Combo 5 Chiếc Quần Lót Nữ Không Đường May Thời Trang iBasic V188, Mềm Mịn, Thoáng Mát - Hàng Chính Hãng",325000,445000,120000,27
TIKI,lam-dep-suc-khoe,130774948,"Kem dưỡng trắng da toàn thân Yococi giúp da trắng mịn, ngăn ngừa lão hoá White Perfect Body Lotion",153000,300000,147000,49
TIKI,lam-dep-suc-khoe,59080318,"Sữa Dưỡng Thể Hatomugi Body Lotion 400ml",97700,144900,47200,33
TIKI,lam-dep-suc-khoe,114682899,"Mật ong nguyên chất Duy Anh Bee 1400 g",194000,194000,0,0
TIKI,thoi-trang-nu,172911144,"Once you become fearless life becomes limitless, mã G121. Trở nên cá tính và ấn tượng cùng chiếc áo phông Goking cho nam nữ trẻ em. Áo phông hàng hiệu cho cặp đôi, gia đình, đội nhóm",69000,69000,0,0
TIKI,lam-dep-suc-khoe,1192875,"Bút Kẻ Mắt Nét Siêu Mảnh Không Trôi Suri Waterproof Eyeliner Pen",74100,78000,3900,5
TIKI,lam-dep-suc-khoe,170404655,"Combo 5 Hộp Khẩu trang Bông Bạch Tuyết KF94 4 lớp trắng (10 cái/hộp)",100000,100000,0,0
TIKI,thoi-trang-nu,97705793,"Áo Lót Đúc Su Siêu Nâng Ngực Tạo Khe Quyến Rũ, Áo Lót Su Không Gọng Không Đường May Thương Hiệu BAW Mã AN37",109000,109000,0,0
TIKI,thoi-trang-nu,273357490,"Set Váy Ngủ Cosplay Bikini Sexy Gợi Cảm Độc Lạ Freebra Freesize (40~60kg)",438000,438000,0,0
TIKI,thoi-trang-nu,108365031,"Áo Khoác Hoodie Nam Nữ Chú Chó Tâm Sự Siêu Cute Có Dây Kéo -Chất Nỉ Ngoại UNisex thoitrangsihienlinh",97000,97000,0,0
TIKI,thoi-trang-nu,164546449,"Ăn chơi là phải có hội, mã TB1. Áo thun team building đồng đội, form unisex cho nam nữ, trẻ em, bé trai gái. Áo phông hàng hiệu Goking, quà tặng cao cấp cho gia đình, hội nhóm, doanh nghiệp",69000,69000,0,0
TIKI,thoi-trang-nu,180931684,"Miếng dán ngực silicon nhiệt tự thân , có thể sử dụng nhiều lần Lylylorem",100000,100000,0,0
TIKI,thoi-trang-nu,145289939,"Chân Váy Dài Lưng Cao New Design ,Thiết Kế Dài 62cm, Phối Nút Phong Cách Váy Công Sở,  Chất Vải Tốt Co Giãn Nhẹ CV19",170000,349000,179000,51
TIKI,thoi-trang-nu,45347477,"Combo 10 Quần Lót Nữ Cotton Thái Siêu Mịn (Freesize 40-57kg) - Chất Liệu Thấm Hút Và Co Giãn 4 Chiều Tốt - N07",89000,89000,0,0
TIKI,lam-dep-suc-khoe,112106515,"Máy tăm nước cầm tay FAIRYWILL FW-5020E máy tăm nước chính hãng Mỹ vệ sinh răng miệng cao cấp Thiết kế nhỏ gọn Sạc bằng USB Dễ mang đi du lịch Hàng Chính Hãng",812250,855000,42750,5
TIKI,thoi-trang-nu,74844904,"Combo 10 Quần Lót Thông Hơi Hoa Hồng Mềm Mại Nữ Tính – Giao nhiều màu ngẫu nhiên – Tặng kèm thun cột tóc",110000,110000,0,0
TIKI,thoi-trang-nu,36904256,"Bikini Hai Mảnh Đồ Bơi Tay Dài Che Nắng MHAT045 MayHomes Form Chuẩn Thun Bốn Chiều Co Giãn Tốt",231400,260000,28600,11
TIKI,thoi-trang-nu,166530485,"Áo Ngực Không Gọng Chất Liệu Ren Cao Cấp, Áo Lót Bra Ren Mềm Mẫu Mới Siêu Đẹp Thương Hiệu Baw mã BA1",159000,159000,0,0
TIKI,thoi-trang-nu,97681797,"Bộ 5 Quần Lót Ren Nữ Thiết Kế tinh Tế, Quần Chip Nữ Kháng Khuẩn Cao Cấp Thương Hiệu BAW NT725",199000,199000,0,0
TIKI,thoi-trang-nu,160883922,"TOKYO, mã G23. Hãy tỏa sáng như kim cương, qua chiếc áo thun Goking siêu hot cho nam nữ trẻ em, áo phông cặp đôi, gia đình, đội nhóm",119000,119000,0,0
TIKI,thoi-trang-nu,106750367,"Áo Lót Nữ, Áo Lót Đúc Su Đệm Dày Siêu Nâng Ngực Tạo Khe Quyến Rũ, Áo Ngực Su Bàn Tay Không Gọng Không Đường May Thương Hiệu BAW Mã AN371",159000,159000,0,0
TIKI,lam-dep-suc-khoe,2738479,"Bộ 2 Hộp Silcot Bông Trang Điểm (bông tẩy trang) Nhật Bản Cao Cấp (66 Miếng/Hộp)",80000,94000,14000,15
TIKI,thoi-trang-nu,164547509,"TIME TO GO, mã G67. Hãy tỏa sáng như kim cương, qua chiếc áo thun Goking siêu hot cho nam nữ trẻ em, áo phông cặp đôi, gia đình, đội nhóm",129000,129000,0,0
TIKI,thoi-trang-nu,199579469,"LEMME-Đầm sơ mi tay ngắn fom rộng xẻ tà",265000,265000,0,0
TIKI,thoi-trang-nu,172908437,"NEVER GIVE UP, LIFE IS A FIGHT, mã G118. Áo thun hàng hiệu Goking, form unisex cho nam nữ, trẻ em, bé trai gái. Áo phông in đẹp, quà tặng cao cấp",119000,119000,0,0
TIKI,thoi-trang-nu,96305953,"ĐẦM MẶC NHÀ - NGỦ - VẢI MỀM - COTTON -  MÁT - HỌA TIẾT ĐA DẠNG - FREE SIZE (45-70KG)",139000,139000,0,0
TIKI,thoi-trang-nu,109687196,"Áo Lót Teen, Áo Bra Học Sinh Màu Trắng Atuner ANT08 Chất Liệu Cotton Kèm Lưới Thoáng Khí",109000,139000,30000,22
TIKI,thoi-trang-nu,83812939,"Áo Ngực không dây nâng ngực chống tụt dây rút loại 1, cúp ren sexy quyến rũ thương hiệu Baw mã AN07",159000,159000,0,0
TIKI,thoi-trang-nu,112815972,"CHÂN VÁY CÔNG SỞ DÀI XẺ SAU [ CHÂN VÁY BÚT CHÌ ] CAO CẤP , SIÊU SANG",159000,300000,141000,47
TIKI,thoi-trang-nu,172914001,"This Girl Rules the World, mã G129. Hãy tỏa sáng như kim cương, qua chiếc áo thun Goking siêu hot cho nam nữ trẻ em, áo phông cặp đôi, gia đình, đội nhóm",188000,188000,0,0
TIKI,thoi-trang-nu,111646610,"Chân váy công sở xếp ly đính khuy 3 màu xinh xắn",75000,75000,0,0
TIKI,thoi-trang-nu,172917864,"Váy ngủ nữ, váy lụa cao cấp VILADY - V119 kiểu cổ V tay lỡ phối viền màu San hô, chất liệu lụa Pháp ( lụa latin)",279000,420000,141000,34
TIKI,thoi-trang-nu,47868710,"Bộ đồ bơi cho nữ chân váy rời size từ 40kg đến 64kg",279000,279000,0,0
TIKI,thoi-trang-nu,83757503,"Bộ 10 Quần Lót Su không đường may thương hiệu BAW hàng loại 1  QLNTOP1",179000,179000,0,0
TIKI,thoi-trang-nu,169831933,"Áo quây/áo ngực nữ không dây/áo lót quây dây/áo ngực mặc váy cúp ngực nâng ngực, dây lưng mảnh cá tính khoe lưng trần gợi cảm và năng động (kèm quai/dây áo ngực trong) LYEA027",113905,119900,5995,5
TIKI,thoi-trang-nu,82704606,"Bộ 3 Quần Lót Nữ Cạp Cao, quần gen bụng giảm mỡ mang cảm giác thoải mái dễ chịu khi hoạt động mạnhthương hiệu BAW QLN28",199000,199000,0,0
TIKI,thoi-trang-nu,132137191,"Áo gia đình mặt cười đồ đồng phục gia đình 3/4/5 người thun mềm mịn màu xanh lá GD314XL DONGPHUCSG",49000,49000,0,0
TIKI,thoi-trang-nu,188134497,"Miếng dán ngực sinh nhiệt tự thân Hàn Quốc - cơ chế tự dính khít khi tiếp xúc với bề mặt da có nhiệt",124000,270000,146000,54
TIKI,thoi-trang-nu,166532192,"Áo Ngực Nữ, Áo Cúp Ngực, Áo Ngực Không Dây Chống Tụt, Áo Lót Mặc Váy Hở Vai Hàng Cao Cấp Thương Hiệu Baw CN02",159000,159000,0,0
TIKI,thoi-trang-nu,95142133,"Combo 2 Bộ Dây Áo Ngực Trong Suốt Sợi  Bún, Điều Chỉnh Tùy Ý LYPK01",38000,38000,0,0
TIKI,lam-dep-suc-khoe,116409375,"Dầu Xả Ogx Biotin & Collagen Conditioner 385ml",190000,295000,105000,36
TIKI,lam-dep-suc-khoe,193669272,"Sáp wax lông lạnh UMIHA 135ML dùng cho wax lông Nách, Chân, Tay, Body an toàn hiệu quả",160000,300000,140000,47
TIKI,lam-dep-suc-khoe,140537916,"Kem mụn thịt mụn gạo Tsububoron Nhật Bản/Kem xóa nốt ruồi Tsubuporon 20g - Nhật Bản",329000,450000,121000,27
TIKI,lam-dep-suc-khoe,56404021,"Kem Ngừa Đồi Mồi Và Dưỡng Trắng Da Tay KPEM 50ml NGA",125000,135000,10000,7
TIKI,lam-dep-suc-khoe,12107911,"Nước Hoa Nữ Versace Bright Crystal - Eau De Toilette (30ml)",1799000,1799000,0,0
TIKI,lam-dep-suc-khoe,166766373,"Thuốc nhỏ mắt Pharmacity Eye Drops xuất xứ Anh Quốc (10ml)",49000,49000,0,0
TIKI,lam-dep-suc-khoe,21741235,"Cân Sức Khỏe Điện Tử Vuông Mặt Kính Cường Lực MJ-25 Tặng Kèm 2 Pin AAA",58000,65907,7907,12
TIKI,lam-dep-suc-khoe,1679047,"Bông Bạch Tuyết - Bông Y Tế Cắt Miếng 1kg (10 x 10 cm)",237500,300000,62500,21
TIKI,lam-dep-suc-khoe,190472560,"Khẩu trang trẻ em 5D An Tâm, trẻ em 0-10 tuổi, kháng khuẩn, kháng virus, ôm vừa mặt,chứng nhận tiêu chuẩn sản phẩm",6900,6900,0,0
TIKI,lam-dep-suc-khoe,150285632,"[HỘP - FAMAPRO VN95 KIDS] - Khẩu trang y tế trẻ em kháng khuẩn 4 lớp Famapro VN95 KIDS đạt chuẩn N95 (10 cái/ hộp)",10900,17000,6100,36
TIKI,lam-dep-suc-khoe,58667454,"Combo 2 Sữa tắm hương nước hoa Enchanteur Sensation 650gr/ Chai",392000,392000,0,0
TIKI,lam-dep-suc-khoe,26115341,"Viên uống Làm Đẹp Da DHC Collagen Nhật Bản",165000,195000,30000,15
TIKI,lam-dep-suc-khoe,14758377,"Thực phẩm bổ sung: KIRKLAND SIGNATURE VITAMIN E 400 I.U",370000,370000,0,0
TIKI,lam-dep-suc-khoe,105626104,"Bộ 4 Bao Cao Su Durex Jeans - Hộp 3 Bao ",168000,196000,28000,14
TIKI,lam-dep-suc-khoe,500669,"Mascara Dài Mi Và Tơi Mi Tự Nhiên Maybelline New York Lash Sensational Waterproof Chuốt Mi Không Lem Không Trôi 10ml",149000,149000,0,0
TIKI,lam-dep-suc-khoe,73674536,"Máy Khuếch Tán Tinh Dầu Tặng Kèm Tinh Dầu Sả Chanh Cao Cấp - Máy Xông Tinh Dầu Có Remote Điều Khiển Từ Xa, Dung Tích Lớn Chuyên Dụng Cho Phòng Rộng",270300,598000,327700,55
TIKI,lam-dep-suc-khoe,72049088,"Kem chống nắng Decumar Advaced Sunblock hoàn toàn mới 50g",115000,130000,15000,12
TIKI,lam-dep-suc-khoe,97079398,"Máy Hút Mụn Loại Bụi Bẩn – Bã Nhờn – Làm Sạch Lỗ Chân Lông Ngăn Ngừa Hình Thành Mụn Cám – Đầu Đen – 3 Cấp Độ Lực Hút - 5 Đầu Ống Hút Mini Cầm Tay Tiện Lợi Sử Dụng.",599000,599000,0,0
TIKI,lam-dep-suc-khoe,178561374,"Muối tẩy tế bào chết làm sạch da đầu Dr.FORHAIR Sea Salt Scaler 50g",139000,178000,39000,22
TIKI,lam-dep-suc-khoe,113737706,"Glucosamine Mỹ Schiff Move Free Joint Health Advanced Glucosamine + Chondroitin - Giảm các triệu chứng đau nhức xương khớp hiệu quả - Massel Official -200 Viên",790000,1652000,862000,52
TIKI,lam-dep-suc-khoe,26115743,"Viên Uống Hỗ Trợ Giảm Cân Bổ Sung Dầu Dừa DHC FORSKOHLII SOFT CAPSULE",395000,450000,55000,12
TIKI,lam-dep-suc-khoe,3705851,"Combo 2 Tuýp Kem Đánh Răng Lô Hội Forever Bright Toothgel 130g/tuýp",380000,380000,0,0
TIKI,lam-dep-suc-khoe,16214309,"Tắm gội 2 trong 1 Romano Force mạnh mẽ tự tin phiên bản Deluxe nhanh chóng tiện dụng 650gr",150000,191000,41000,21
TIKI,lam-dep-suc-khoe,159849436,"Tăm bông người lớn Pharmacity",5000,5000,0,0
TIKI,lam-dep-suc-khoe,4423591,"Thực Phẩm Chức Năng Tinh Chất Hàu Tươi Nhật Bản Orihiro 120 Viên",284000,352800,68800,20
TIKI,lam-dep-suc-khoe,14245533,"Nước uống Collagen làm trắng da Pure White Nhật Bản ",478000,478000,0,0
TIKI,lam-dep-suc-khoe,49195772,"Dao Cạo Râu Gillette 5",661000,661000,0,0
TIKI,lam-dep-suc-khoe,102576061,"Gối massage hồng ngoại trị liệu 16 bi - Máy massage Cổ, Vai, Gáy, Lưng, Eo",194723,194723,0,0
TIKI,lam-dep-suc-khoe,15778022,"Bột rửa mặt Thảo mộc TAP TAP Từ Bột Đậu Đỏ Trà Xanh Yến Mạch Cám Gạo Giảm Mụn Ẩn Mụn Cám Mụn Đầu Đen An Toàn Từ Thiên Nhiên Cỏ Mềm 50g",90000,90000,0,0
TIKI,lam-dep-suc-khoe,186271173,"Khẩu trang y tế 4D (KF94) NPCARE Hope Xanh  hy vọng (H/10c)",30000,30000,0,0
TIKI,lam-dep-suc-khoe,35578333,"Cân Sức Khỏe Điện Tử Vuông Mặt Kính Cường Lực MJ-25 Tặng Kèm 2 Pin AAA",66682,70192,3510,5
TIKI,lam-dep-suc-khoe,173564760,"Combo 4 hộp ALIPAS tăng cường sinh lý nam 30 viên tặng 1 hộp 15 viên",3000000,3380000,380000,11
TIKI,lam-dep-suc-khoe,548296,"Xịt Khoáng Giúp Làm Sạch Và Dịu Da La Roche-Posay Serozinc (150ml)",311000,375000,64000,17
TIKI,lam-dep-suc-khoe,180223850,"Dầu chăm sóc da giúp cải thiện rạn da, mờ sẹo và đều màu da - BIO-OIL SKINCARE OIL (chai 60ml)",195000,205000,10000,5
TIKI,lam-dep-suc-khoe,7541267,"Set 2 Dao Cạo Lông Mày Kai 01-158",51000,52920,1920,4
TIKI,lam-dep-suc-khoe,76776118,"Nước Hồng Sâm Linh Chi Pocheon Hàn Quốc 6 Năm Tuổi (70ml X 30 Gói)",705000,900000,195000,22
TIKI,lam-dep-suc-khoe,911355,"Nước Hoa Hồng Ori'be",73000,80000,7000,9
TIKI,lam-dep-suc-khoe,877310,"Combo 5 Miếng Dán hỗ trợ điều trị Mụn Mayancare 12 Miếng (1.0cm)",144000,175000,31000,18
TIKI,lam-dep-suc-khoe,192988869,"300 cái khẩu trang KF94 - 4D Hoa Tuyết An Tâm, khẩu trang có giấy phép bộ y tế cấp",8500,8500,0,0
TIKI,lam-dep-suc-khoe,83352993,"Dầu gội có dầu xả Palmolive Naturals suôn mượt và dưỡng ẩm thiên nhiên 180ml",37000,37000,0,0
TIKI,dien-gia-dung,171816262,"Nồi chiên không dầu KIPOR KP-AF657 - 15L - Lò nướng điển tử công nghệ RAPID AIR nhiệt tối đa 230 độ lòng nồi inox 304- Hàng chính hãng",3704000,5549000,1845000,33
TIKI,dien-gia-dung,42958544,"Biến áp (Adaptor) - chuyển nguồn",139000,150000,11000,7
TIKI,dien-gia-dung,165345772,"ĐẦU QUẠT TREO SẮT ĐỘNG CƠ 100% ĐỒNG - HÀNG CHÍNH HÃNG 3HT",220000,220000,0,0
TIKI,dien-gia-dung,186756297,"Nồi chiên không dầu hơi nước Elmich 7L AFE-3945 - Hàng chính hãng",3644000,3899000,255000,7
TIKI,dien-gia-dung,449515,"Bếp Hồng Ngoại Cảm Ứng Sunhouse SHD6017 - Hàng chính hãng",1100000,1480000,380000,26
TIKI,dien-gia-dung,119967922,"Máy hút bụi không dây siêu nhẹ Panasonic MC-SBV01W246 – Hút sạch mọi lúc mọi nơi – Dễ dàng tháo lắp - Tích hợp đèn LED phát hiện bụi - Hàng chính hãng",4489000,4489000,0,0
TIKI,dien-gia-dung,229806089,"Máy Ép Trái Cây, Máy Ép Chậm Cao Cấp KALITE KL-599 Tiêu Chuẩn Châu Âu , Dung Tích 400 ML Công Suất 400 W - Hàng Chính Hãng",4849000,9659000,4810000,50
TIKI,dien-gia-dung,362105,"Máy Sấy Tóc Panasonic PAST-EH-ND13-V645",469000,469000,0,0
TIKI,dien-gia-dung,76184310,"Máy Làm Sạch Thảm Karcher SE 4002",10842000,11990000,1148000,10
TIKI,dien-gia-dung,75558085,"Máy hút bụi khô và ướt HiClean HC30 NEW (30L) - Hàng chính hãng",3100000,3100000,0,0
TIKI,dien-gia-dung,161241984,"Quạt treo Mitsubishi W16-RA CY-GY - Hàng chính hãng",1739000,1739000,0,0
TIKI,dien-gia-dung,48436325,"LÕI LỌC NƯỚC SỐ 3 CARBON BLOCK MÁY LỌC NƯỚC RO - lõi lọc số 3",22000,22000,0,0
TIKI,dien-gia-dung,106378953,"Bếp Gas Dương Kính Sunhouse SHB2106 - Hàng Chính Hãng",570000,570000,0,0
TIKI,dien-gia-dung,101845731,"Đèn khò gas ECO 20 công suất cao TS2022RN - HÀNG CHÍNH HÃNG NAMILUX (MP)",169000,169000,0,0
TIKI,dien-gia-dung,110035573,"Chân kệ để máy lọc nước R.O (free size) - Hàng chính hãng",76000,82000,6000,7
TIKI,dien-gia-dung,658108,"Quạt Bàn Đảo 3 Tấc Senko BD8860 - Màu Ngẫu Nhiên - Hàng chính hãng",365000,365000,0,0
TIKI,dien-gia-dung,272420836,"Máy Làm Đá Gia Đình CASO IceMaster Ecostyle 3301 Pro/3304 Icemaster Ecostyle - Nhập Khẩu Đức Cao Cấp, Thời Gian Làm Đá 0.5 Kg/Giờ Dung Tích 2.2 Lít Công Suất 90 W - Hàng Nhập Khẩu",4899000,9759000,4860000,50
TIKI,dien-gia-dung,1368631,"Nồi Nấu Cháo Đa Năng BBCooker BS25 (2.5L) - Hàng Chính Hãng",515000,515000,0,0
TIKI,dien-gia-dung,72802933,"Máy hút bụi cầm tay Deerma Vacuum Cleaner DX118C - Hàng Nhập Khẩu",859000,859000,0,0
TIKI,dien-gia-dung,7170571,"Bình Đun Siêu Tốc Điện Inox Sunhouse SHD1057 (1.5L) - Hàng chính hãng",170000,240000,70000,29
TIKI,dien-gia-dung,19241570,"Nồi Tiềm Nấu Cháo Chậm Kho Cá Hầm Chưng Yến Đa Năng NK Media (2,5 lít) - Màu Ngẫu Nhiên - Hàng Chính Hãng",243000,250000,7000,3
TIKI,dien-gia-dung,176762199,"Máy Xay Sinh Tố Công Nghiệp Uniblend UB - 712 ( Hàng Nhập Khẩu)",2595000,2595000,0,0
TIKI,dien-gia-dung,56274878,"Củ lọc vòi nước đa chiều nhựa trắng",33000,33000,0,0
TIKI,dien-gia-dung,22476084,"Quạt đèn trần cao cấp có điều khiển TOP192",1490000,1490000,0,0
TIKI,dien-gia-dung,191044822,"Quạt Tích Điện Đeo Cổ Không Cánh USB Mini Tiện Lợi Parrot  , Thời Trang, Dáng Thể Thao 3 Tốc Độ Gió Dung Lượng Pin Lớn Sử Dụng 3-6 Giờ",63000,63000,0,0
TIKI,dien-gia-dung,56946211,"Miếng lọc bụi Hepa 13 VC 3 - Hàng chính hãng",380000,380000,0,0
TIKI,dien-gia-dung,193748334,"Quạt không cánh lọc không khí bù độ ẩm- 2 chiều nóng lạnh màn hình LED có điều khiển",2469050,2599000,129950,5
TIKI,dien-gia-dung,173771927,"Máy Nướng Bánh Mì YG-3088 650W",610000,610000,0,0
TIKI,dien-gia-dung,253498875,"Bộ Lọc Thay Thế Pureit Ultima 1 - Hàng Chính Hãng",1187500,1250000,62500,5
TIKI,dien-gia-dung,103914497,"Combo 3 lõi lọc thô 123 + 1 màng RO Karofi - Hàng chính hãng",543000,543000,0,0
TIKI,dien-gia-dung,117571940,"Nồi điện đa năng ăn lẩu, nướng, làm bánh,... DKL-D12A1 tặng ổ cắm 3 chấu",720000,720000,0,0
TIKI,dien-gia-dung,44467818,"Máy sấy tóc Panasonic EH-NE81-K645 - tạo ion dòng Ionity - Công suất 2500W - Hàng chính hãng - Đen",1245000,1414800,169800,12
TIKI,dien-gia-dung,449130,"Bình Thủy Điện Sunhouse SH1535 (3.5 lít) - Hàng chính hãng",889000,889000,0,0
TIKI,dien-gia-dung,50643212,"Quạt bàn đảo 4 Tấc chuyển hướng điện cao cấp Senko ( Hàng Chính Hãng ) BD1410",490000,490000,0,0
TIKI,dien-gia-dung,264014444,"Máy Hút Bụi Lau Sàn Khô Uớt Tự Giặt Giẻ Diệt Khuẩn TINECO Floor 3 Thương Hiệu Mỹ Lực Hút 12,000 Pa Công Suất 190 W - Hàng Chính Hãng",6999000,13939000,6940000,50
TIKI,dien-gia-dung,35283819,"Máy Sấy Tóc Panasonic Máy Sấy Tóc Panasonic EH-ND11-W645 Hàng Chính Hãng",290000,290000,0,0
TIKI,dien-gia-dung,680672,"Máy Xay Sinh Tố Electrolux EMB3025 (600ml) - Hàng Chính Hãng",769000,769000,0,0
TIKI,dien-gia-dung,196305556,"Máy hút bụi cầm tay GAABOR GVCC-M4A2 lực hút mạnh 4500pa cắm ô tô dây nguồn dài 4.5m - Hàng chính hãng",149500,299000,149500,50
TIKI,dien-gia-dung,192177674,"Máy Nấu Sữa Hạt, Máy Làm Sữa Hạt OLIVO CB22 PRO Thương Hiệu Mỹ Gồm 14 Chức Năng Xay Nấu Với Khả Năng Chống Trào Dung Tích 1.75 Lít Công Suất 1000 W - Hàng Chính Hãng",2679000,5339000,2660000,50
TIKI,dien-gia-dung,50820171,"Bếp điện từ điện tử Iruka I-78 (2000W) - Hàng chính hãng",1910000,2790000,880000,32
TIKI,thoi-trang-nu,73832910,"Miếng nối áo ngực loại 2 móc có thun co dãn tiện lợi",15000,15000,0,0
TIKI,thoi-trang-nu,199059670,"ĐỒ LAM CHO BÉ IU # Mẫu Bé Vạt Hò In Hoa Sen",80000,80000,0,0
TIKI,thoi-trang-nu,170499291,"Quần Lót Băng Lụa Satin Kết Hợp Ren Phong Cách Nhật Bản WL72",35000,35000,0,0
TIKI,thoi-trang-nu,16239211,"Áo ngực nữ không gọng nâng ngực hàng xuất Nhật",29000,29000,0,0
TIKI,thoi-trang-nu,109917737,"Quần Lót Lọt Khe Bóng Viền Gấp",33000,33000,0,0
TIKI,thoi-trang-nu,107353638,"Quần jogger nữ bo gấu chất đũi siêu mát cá tính",88000,88000,0,0
TIKI,thoi-trang-nu,102782853,"QUẦN THUN SHORT NỮ - FREESIZE - LƯNG CO GIÃN THOẢI MÁI - HOA CÚC - NHIỀU MÀU",59000,59000,0,0
TIKI,thoi-trang-nu,119613745,"Áo Bra Nữ Bra Tăm Siêu Xịn, Co Giãn Siêu Tốt",54000,54000,0,0
TIKI,thoi-trang-nu,95049498,"Áo phông nữ Áo thun nữ form rộng tay lỡ Will Be Fine chất thun 4 chiều co giãn dễ thương",29000,29000,0,0
TIKI,thoi-trang-nu,172665283,"Váy ngủ nữ, váy 2 dây quyến rũ VILADY - V117 màu đỏ thiết kế cổ đổ sang chảnh sexy, chất liệu lụa Pháp (lụa latin) cao cấp",259000,390000,131000,34
TIKI,thoi-trang-nu,55279177,"Đồ Bơi Cặp Đồ Bơi Tay Dài Che Nắng Đi Biển AT172 MayHomes Long Sleeve Couple Swimsuits",279300,285000,5700,2
TIKI,thoi-trang-nu,82704547,"Bộ 5 Quần Lót Cotton Gân Tăm Không Đường May Kháng Khuẩn thương hiệu BAW QLN27",149000,149000,0,0
TIKI,thoi-trang-nu,186677617,"Quần Lót Nữ, quần lót Ren nữ Cao Cấp Mềm Mịn, Quần Lót Nữ Co Dãn Tốt Thoáng Mát VILADY 5516",25000,45000,20000,44
TIKI,thoi-trang-nu,78032841,"Áo Lót Cho Phụ Nữ Trung Niên Azuno Az400 Cao Cấp Chất Liệu Cotton Không Gọng Nâng Ngực",85000,85000,0,0
TIKI,thoi-trang-nu,182601565,"Áo sơ mi linen nữ form rộng trẻ trung ArcticHunter, thời trang thương hiệu chính hãng",250000,250000,0,0
TIKI,thoi-trang-nu,167598351,"Quần lót cotton nữ đúc su thun lạnh trơn không đường may mặc trong váy dễ thương Q1",20500,22500,2000,9
TIKI,thoi-trang-nu,73390971," Áo ba lỗ croptop Ulzzang Quảng Châu ATB18",35000,35000,0,0
TIKI,thoi-trang-nu,56112479,"Combo 5 Quần Lót Nữ Ren Hoa Miley Lingerie Lily Flower FLS03",218000,395000,177000,45
TIKI,thoi-trang-nu,97708021,"Áo Ngực Không Gọng Chất Liệu Cotton Cao Cấp, Áo Lót Bra Không Gọng dây mảnh Thương Hiệu Baw mã NT730",159000,159000,0,0
TIKI,thoi-trang-nu,146635392,"Áo sơ mi váy dáng dài, chất liệu đũi mềm mịn, áo váy nữ, form dài rộng kiểu Hàn Quốc, NeSa Shop AKH.35",133000,229000,96000,42
TIKI,thoi-trang-nu,51020524,"ÁO LÁ THUN LẠNH NHIỀU SIZE",29000,32000,3000,9
TIKI,thoi-trang-nu,193904238,"Miếng Dán Ngực Silicon Hình Hoa Siêu Chắc Chắn Tiện Lợi Cho Phái Đẹp Hàng Chính Hãng",23000,25000,2000,8
TIKI,thoi-trang-nu,1921261,"Áo Ngực Triumph D179 LZ-VN - Da (Size",240900,240900,0,0
TIKI,thoi-trang-nu,14436268,"Áo vest công sở bèo 2 tầng -MS0042AK",240000,240000,0,0
TIKI,thoi-trang-nu,102394898,"[ HOT 2021] Quần short, quần đùi nữ ️ chất đũi Thái, có bigsize 40-80kg️",47000,90000,43000,48
TIKI,thoi-trang-nu,95112933,"Quần Lót Nữ ️️ Quần Mặc Váy Đúc Su cao cấp mềm mại thoáng mát mẫu 901",44000,44000,0,0
TIKI,thoi-trang-nu,82700704,"Bộ 5 Quần Chip Nữ Cotton kháng khuẩn thoáng mát thương hiệu BAW mẫu QLN09",149000,149000,0,0
TIKI,thoi-trang-nu,116150095,"Áo Polo Nữ YODY Phối Nẹp Thoải Mái Năng Động Chất Liệu Cafe  Khử Mùi Tốt - APN3700",299000,299000,0,0
TIKI,thoi-trang-nu,979203,"Combo 5 Quần Lót Nữ Modern Brief Miley Lingerie BC042 - Màu Ngẫu Nhiên",188000,188000,0,0
TIKI,thoi-trang-nu,98280452,"Quần lót nữ không đường may iBasic V188",79000,89000,10000,11
TIKI,thoi-trang-nu,92145164,"Đồ Bơi Nữ Hai Mảnh Kiểu Váy Tay Dài Dành Cho Cân Nặng 37Kg-50Kg AT216 MayHomes Chất Liệu Thun Poly",182360,188000,5640,3
TIKI,thoi-trang-nu,88913399,"Chân váy công sở lưng cao, xếp ly siêu tôn dáng Eva Design",39000,39000,0,0
TIKI,thoi-trang-nu,71923579,"Combo 5 quần lót nữ không đường may mềm mại iBasic V189",379000,445000,66000,15
TIKI,thoi-trang-nu,184311838,"Đầm suông trung niên đẹp dáng suông đi tiệc, sang trọng váy đầm trung niên Cho Mẹ U50 U60, Đầm Suông Cổ Tim Phối Viền Cách Điệu",298000,298000,0,0
TIKI,thoi-trang-nu,74163057,"Combo 3 Quần Lót Nữ Ren Hoa, Phối Lưới Cao Cấp Atuner QL016, Quần Lót Nữ Gợi Cảm, Ngọt Ngào - Hàng Chính Hãng",169000,225000,56000,25
TIKI,thoi-trang-nu,9982241,"Áo khoác nữ thoát nhiệt Nhật Bản Goking, 6 túi to tiện dụng, vải thun 100% cotton mỏng nhẹ thoáng mát, thấm hút mồ hôi. Áo chống nắng hàng hiệu cao cấp",275000,275000,0,0
TIKI,thoi-trang-nu,173449732,"Combo 5 quần đùi nữ mặc nhà thoải mái thoáng mát họa tiết ngẫu nhiên JAMANO",229000,350000,121000,35
TIKI,thoi-trang-nu,90688093,"Bộ 5 Quần Lót Cotton dễ thương mềm mại tôn dáng, Hàng xuất nhập thương hiệu Baw mẫu QLN01 (one size 40-60kg)",223500,223500,0,0
TIKI,thoi-trang-nu,196596468,"Quần baggy nữ Linen bột Premium dáng lửng cạp khóa trước ArcticHunter",230000,230000,0,0
TIKI,thoi-trang-nu,90174963,"COMBO 5 quần đùi nữ May 10, quần mặc nhà, quần ngủ 2XL",115000,135000,20000,15
TIKI,o-to-xe-may-xe-dap,166549606,"Gương Cầu Lồi Có Viền Xoay 360 ,Gương Cầu Lồi Ô Tô Xóa Tan Mọi Điểm Mù",19000,19000,0,0
TIKI,o-to-xe-may-xe-dap,31705542,"Búa Thoát Hiểm Cho Xe Ô Tô, Xe Hơi R7116",155000,155000,0,0
TIKI,o-to-xe-may-xe-dap,23010613,"Bảng Số Kiêm Giá Đỡ Điện Thoại Trên Taplo Xe Hơi",29999,29999,0,0
TIKI,o-to-xe-may-xe-dap,11959155,"Bảng số điện thoại trên ô tô nhãn hiệu Baseus ACNUM-01",264499,264499,0,0
TIKI,o-to-xe-may-xe-dap,128957380,"Bộ Dụng Cụ 2 Bàn Chải Vệ Sinh Sên / Xích / Líp Xe Đạp Tiện Dụng",45000,45000,0,0
TIKI,o-to-xe-may-xe-dap,189535971,"Miếng dán PPF TPU hõm cửa xe ô tô chống xước tự hồi phục",110000,110000,0,0
TIKI,o-to-xe-may-xe-dap,2900861,"Bộ 2 găng tay lau rửa xe siêu mềm thấm hút tốt chuyên dụng cho ô tô xe máy (Màu ngẫu nhiên)",19000,19000,0,0
TIKI,o-to-xe-may-xe-dap,1254603,"Đất Sét Tẩy Bụi Sơn 3M Perfect It III Cleaner Clay 38070 - Xanh",480000,480000,0,0
TIKI,o-to-xe-may-xe-dap,71100674,"Hộp để đồ đa năng gấp gọn để cốp sau ô tô, xe hơi cao cấp dung tích 30 lít",180000,180000,0,0
TIKI,o-to-xe-may-xe-dap,3162815,"Áo trùm xe máy họa tiết cao cấp",39000,39000,0,0
TIKI,o-to-xe-may-xe-dap,174549619,"Mũ Bảo Hiểm Nửa Đầu Thời Trang SUNDY HP-01, Nón Bảo Hiểm Tem Bò Sữa Cute Nhiều Màu, An Toàn, Chất Lượng - Hàng Chính Hãng",105000,180000,75000,42
TIKI,o-to-xe-may-xe-dap,274597343,"Bơm Hơi Hợp Kim Dùng Chân Cho Xe Máy , Xe Đạp NHONOR - Hàng Chính Hãng ( Tặng Kèm Kim Bơm Banh Và Bơm Thú Hơi )",164000,242000,78000,32
TIKI,o-to-xe-may-xe-dap,75705805,"Combo bảo dưỡng sên Megacools rửa sên 500ML+dưỡng sên 300ml  tặng bàn chải vệ sinh sên",165000,165000,0,0
TIKI,o-to-xe-may-xe-dap,189866686,"Combo đèn trước và Đèn led sau xe đạp, tiện lợi, loại tốt",79000,120000,41000,34
TIKI,o-to-xe-may-xe-dap,53708717,"Combo Đèn Pha Xe Đạp LED Q5 Gắn Phía Trước Có Sạc USB Chống Nước Mini Siêu Sáng (Kèm Chân Đế Gắn Đèn Pin) Và Đèn LED Cảnh Báo Sau Xe Đạp 4 chế độ Mai Lee - Đèn Q5+ Led Xanh",104000,119000,15000,13
TIKI,o-to-xe-may-xe-dap,20722132,"CẶP GƯƠNG CHIẾU HẬU GÙ TRÒN CÁN XOAY CRG GẮN NHIỀU LOẠI XE MÁY SIÊU ĐẸP - MÀU ĐEN ( 1 CHIẾC BÊN TRÁI ) LOẠI 1",90250,95000,4750,5
TIKI,o-to-xe-may-xe-dap,95306035,"Xe đạp địa hình Thống Nhất MTB 26-07 (Tặng kèm chắn bùn trước và sau) - Hàng chính hãng",3449000,3449000,0,0
TIKI,o-to-xe-may-xe-dap,20798577,"Combo 3 khăn lau xe chuyên dụng Microfiber siêu hút nước",19999,19999,0,0
TIKI,o-to-xe-may-xe-dap,16330403,"Mũ bảo hiểm 1/2 đầu Napoli nón kết tem caro cao cấp có mút xốp loại EPS giảm xung chấn Freesize 56-60cm - Bảo hành 12 tháng",259000,259000,0,0
TIKI,o-to-xe-may-xe-dap,36601741,"Chai xịt tẩy rửa, bôi trơn và chống rỉ sét 310g 3M 5W",83000,83000,0,0
TIKI,o-to-xe-may-xe-dap,117722638,"Khăn lau ô tô xe hơi 3M chất vải Microfiber màu vàng 2 lớp cao cấp siêu mịn siêu sạch siêu thấm hút",6000,6000,0,0
TIKI,o-to-xe-may-xe-dap,50573598,"Ghế Xe Đạp, Xe Điện cho Trẻ Em - màu ngẫu nhiên",130000,130000,0,0
TIKI,o-to-xe-may-xe-dap,5172187,"Dung dịch vệ sinh và làm trong kính lái Sonax Xtreme Clear View 1:100 NanoPro 271141 250ml",200000,200000,0,0
TIKI,o-to-xe-may-xe-dap,131337644,"Mẫu Túi Hành Lý Sau Xe Đạp - Túi Đôi Đựng Sau Xe Đựng Đồ dùng,Thiết Bị, hàng hóa(lựa mẫu)",125000,125000,0,0
TIKI,o-to-xe-may-xe-dap,2646875,"Nước Rửa Xe Mẫu Mới Sumo Wash & Wax (1L)",69000,69000,0,0
TIKI,o-to-xe-may-xe-dap,150494412,"Dung dịch đánh bóng phục hồi nhựa nhám xe máy ô tô như mới hàng cao cấp siệu đậm đặc",68000,68000,0,0
TIKI,o-to-xe-may-xe-dap,6974859,"Nước Rửa Xe Không Chạm Ekokemika Bio 25 (5L) - Hàng Chính Hãng",550000,550000,0,0
TIKI,o-to-xe-may-xe-dap,111223259,"Máy Hút Bụi Xe Hơi Mini Cao Cao Cấp AIKESI 8001",322000,322000,0,0
TIKI,o-to-xe-may-xe-dap,56650569,"Mũ Bảo Hiểm ¾ Napoli Sh2 Ruby Thời Thượng Nhiều Màu Cá Tính",247500,247500,0,0
TIKI,o-to-xe-may-xe-dap,54021554,"Giá Đỡ Điện Thoại Trên Ô Tô, Kẹp điện thoại trên xe hơi, Kẹp giữ điện thoại trên xe hơi, giá đỡ ô tô, đế điện thoại xe hơi, giá treo điện thoại trên ô tô, phụ kiện di động trên xe hơi ( Màu Đỏ)",65000,65000,0,0
TIKI,o-to-xe-may-xe-dap,48141839,"Dụng cụ bơm hơi bánh xe đạp chân đa năng mini tiện dụng dùng cho xe đạp, xe máy - màu giao ngẫu nhiên",79000,79000,0,0
TIKI,o-to-xe-may-xe-dap,91173044,"Bộ chia tẩu sạc ô tô QC3.0 chia 4 cổng USB tẩu sạc ô tô",85000,85000,0,0
TIKI,o-to-xe-may-xe-dap,172067622,"Dung dịch NANO phục hồi nhựa nhám xe máy ô tô đẹp như mới siêu đậm đặc loại tốt",77000,85000,8000,9
TIKI,o-to-xe-may-xe-dap,1219871,"Nhớt Ô Tô Cao Cấp Mobil Super 5000 5W30 SN  (5L)",550000,550000,0,0
TIKI,o-to-xe-may-xe-dap,94725255,"Bộ camera căn lề không khoan gương + Màn hình LCD 4.3 inch cắm nguồn tẩu, tự lắp đặt trong vòng 5 phút",699000,699000,0,0
TIKI,o-to-xe-may-xe-dap,136265463,"Nhớt Xe Số Motul 3000 Plus 4t 20w50 20x0.8l",105000,105000,0,0
TIKI,o-to-xe-may-xe-dap,38510294,"Bộ 2 Gương Chiếu Hậu Tròn Lớn Cho Xe Đạp Thể Thao Địa Hình Xoay 360 Độ Giúp Đạp Xe An Toàn - Hàng Chính Hãng",82000,89000,7000,8
TIKI,o-to-xe-may-xe-dap,85801194,"túi hồ sơ xe - ví đựng giấy tờ xe ô tô mazda ",24800,24800,0,0
TIKI,o-to-xe-may-xe-dap,163023757,"ỐP KHOÁ TOYOTA CAMRY  - CROSS -ALTIS",379000,379000,0,0
TIKI,o-to-xe-may-xe-dap,118297639,"Nâng cổ xe đạp địa hình bằng hợp kim nhôm",149000,149000,0,0
TIKI,o-to-xe-may-xe-dap,193136739,"Tinh dầu thơm trang trí táp lô xe hơi, ô tô mô hình máy bay chiến đấu chạy bằng năng lượng mặt trời",265000,279000,14000,5
TIKI,o-to-xe-may-xe-dap,57808776,"Combo 5 khăn lau xe hơi chuyên dụng , thấm hút tốt , rửa xe, lau khô, lau sáp đánh bóng, vệ sinh các vết bẩn",40000,40000,0,0
TIKI,o-to-xe-may-xe-dap,99463625,"Ô Che Nắng Kính Lái Xe Ô tô - Bảo vệ nội thất ô tô - Dù che nắng kính lái xe hơi - chống tia UV",98000,98000,0,0
TIKI,o-to-xe-may-xe-dap,131183383,"Lọc gió điều hòa ô tô HONDA CITY 1.5L 2013-",91000,91000,0,0
TIKI,o-to-xe-may-xe-dap,114744981,"Combo 2 Lưỡi Gạt Mưa Loại A VIAIR R15 (24 Inch/600 mm)",101000,101000,0,0
TIKI,o-to-xe-may-xe-dap,85804367," nước hoa đầu chó Pitbull 15ml",248000,248000,0,0
TIKI,o-to-xe-may-xe-dap,71150931,"Chổi Quét Bụi Ô TÔ Đa Năng NB 64cm",179000,179000,0,0
TIKI,o-to-xe-may-xe-dap,52318177,"Bảng số điện thoại trên ô tô nhãn hiệu Baseus ACNUM - Hàng nhập khẩu",266000,280000,14000,5
TIKI,o-to-xe-may-xe-dap,69691769,"Khóa dây số đường kính 15mm",78999,78999,0,0
TIKI,o-to-xe-may-xe-dap,11251519,"Combo 2 Lót Chân Chống Xe Máy",14000,14000,0,0
TIKI,o-to-xe-may-xe-dap,50462792,"Bộ chuyển nguồn 220V ra 12V tẩu sạc ô tô",75000,75000,0,0
TIKI,o-to-xe-may-xe-dap,22035789," Bộ 2 Móc Treo Đồ Sau Ghế Ô Tô",28000,28000,0,0
TIKI,o-to-xe-may-xe-dap,118180539,"Khóa Dây Xe Đạp 5 Số Mật Mã Dây Cáp Lõi Sợi Thép Bọc PVC Dài 120cm (kèm pát đế gắn cốt yên) (mật khẩu mặc định 00000) Mai Lee",131000,139000,8000,6
TIKI,o-to-xe-may-xe-dap,11503718,"CHAI XỊT BỌT TUYẾT VỆ SINH NÓN BẢO HIỂM, YÊN, RỬA XE KHÔ NHANH CHÓNG LUBE71 WELL FOAM SPRAY 600ML",230000,230000,0,0
TIKI,o-to-xe-may-xe-dap,11203861,"Combo 2 Gối Tựa Đầu Xe Hơi",76995,76995,0,0
TIKI,o-to-xe-may-xe-dap,4776047,"Móc treo đồ sau ghế chuyên dụng cho xe hơi",30000,30000,0,0
TIKI,o-to-xe-may-xe-dap,7371421,"Cặp 2 cái ruột xe đạp 24 X 1.75/2.125 AV35mm",120000,120000,0,0
TIKI,o-to-xe-may-xe-dap,22761385,"Tấm lưới tựa lưng ghế ô tô, hạn chế tối đa sự chịu lực của cột sống",24700,24700,0,0
TIKI,o-to-xe-may-xe-dap,43952392,"XI NHAN WINNER X KIỂU MAI RÙA, (1 ĐÔI)",51000,55000,4000,7
TIKI,o-to-xe-may-xe-dap,33784257,"GƯƠNG CẦU LỒI 360 CAO CẤP GẮN XE Ô TÔ HỖ TRỢ ĐIỂM MÙ",19000,19000,0,0
TIKI,o-to-xe-may-xe-dap,176969649,"Vỏ chai đựng tinh dầu lục lăng TTAUTO 8ml treo xe ô tô, phòng ngủ, tủ quần áo, nhà vệ sinh",18000,18000,0,0
TIKI,o-to-xe-may-xe-dap,270478483,"VÍT GẮN DÀN ÁO XE MÁY 5 Li _ INOX 304",18000,18000,0,0
TIKI,o-to-xe-may-xe-dap,785183,"Mũ Bảo Hiểm 1/2 Đầu Napoli NS-N088 màu trắng nhám Freesize 54 -57 cm - Bảo hành 12 tháng",250000,250000,0,0
TIKI,o-to-xe-may-xe-dap,167153607,"Khay đựng đồ ghế sau ô tô gấp gọn - Hàng Kpro chất lượng cao",125000,125000,0,0
TIKI,o-to-xe-may-xe-dap,116455573,"Bao Da Chìa Khoá Mitsubishi Xpander, Outlander, Triton, Attrage, Pajero Sport handmade Da Thật 003",199000,199000,0,0
TIKI,o-to-xe-may-xe-dap,16366954,"Đèn Led L4X 40W Trợ sáng xe máy Tặng 5 món phụ kiện",277000,299000,22000,7
TIKI,o-to-xe-may-xe-dap,85399844,"Túi thơm ô tô Greenleaf - Lưu hương 6 tháng-Khử sạch hiệu quả mùi hôi trên ô tô, tủ quần áo, phòng làm việc",129000,129000,0,0
TIKI,o-to-xe-may-xe-dap,71105002,"Thanh Mở Rộng Gắn Ghi Đông Xe Đạp Thể Thao Địa Hình Đa Chức Năng Dùng Gắn Cho Phụ Kiện Đồ Chơi Xe Đạp (Loại dài 2 nhánh đỡ chắc chắn) Mai Lee",99000,107100,8100,8
TIKI,o-to-xe-may-xe-dap,198126634,"Xe máy điện VinFast EVO 200 (tặng 02 tháng thuê pin)",18000000,18000000,0,0
TIKI,o-to-xe-may-xe-dap,89580999,"Đèn Xe Đạp Đuôi Led Nhấp Nháy Chớp Vuông Gắn Sau Xe Đạp, Gắn Mũ Bảo Hiểm MaiLee",113050,119000,5950,5
TIKI,o-to-xe-may-xe-dap,57450089,"Bạt trùm xe máy vải dù loại dày che mưa nắng nhiều màu lựa chọn",105000,105000,0,0
TIKI,o-to-xe-may-xe-dap,14656151,"Nhớt Xe Tay Ga Motul Scooter Expert Le 10w40 20x0.8l Vn (800ml)",119000,119000,0,0
TIKI,o-to-xe-may-xe-dap,176825442,"Xe máy điện VinFast Theon S (tặng 05 tháng thuê pin)",63000000,63000000,0,0
TIKI,o-to-xe-may-xe-dap,58066078,"Đèn Pha LED Bi Cầu Mini Y6D 36W Chống Chói Mắt Green Networks Group ( 1 Bóng )",349000,349000,0,0
TIKI,o-to-xe-may-xe-dap,153468318,"Xe đạp gấp 20 icnh, chính hãng Phượng Hoàng",3550000,3550000,0,0
TIKI,o-to-xe-may-xe-dap,176147612,"Túi than hoạt tính TTAUTO 100% từ gáo dừa Bến Tre khử mùi diệt khuẩn trên ô tô, tủ đồ, phòng tắm - Túi 100 Gram",25000,50000,25000,50
TIKI,o-to-xe-may-xe-dap,146370121,"Bọc Chìa Khoa Smartkey Xe SH , Sh Mode , Vision 2021 Bọc Smartkey mẫu Mới 2022",169000,169000,0,0
TIKI,o-to-xe-may-xe-dap,143427476,"XE ĐẠP TRẺ EM CỠ 24 INCH cho bé 9 tuổi - 15 TUỔI + Tặng kèm giỏ xe, gácbaga, túi, bình nước",1399000,1399000,0,0
TIKI,o-to-xe-may-xe-dap,44137803,"CHÂN CHỐNG CẠNH XE MÁY, CÓ THỂ TĂNG CHỈNH ĐỘ DÀI",103550,109000,5450,5
TIKI,o-to-xe-may-xe-dap,119718975,"Bình Ắc Quy Khô LONG 12V-9AH WP1236W dùng cho ups, lưu điện cửa cuốn, lưu điện máy tính, loa kéo",319000,319000,0,0
TIKI,lam-dep-suc-khoe,6398571,"Kem phục hồi dịu da và kháng khuẩn Dermalibour + Repairing Cream A-Derma 50ml",354000,417000,63000,15
TIKI,lam-dep-suc-khoe,44106900,"Máy tăm nước Panasonic cầm tay dùng pin sạc EW1211 - Hàng Chính Hãng",2200000,2200000,0,0
TIKI,lam-dep-suc-khoe,75409136,"Tinh Dầu Lavender Nguyên Chất Nhập Khẩu 50ML (Oải Hương), Tinh Dầu Xông Phòng Oải Hương Giúp Thư giản, Khử Trùng Và Bảo Vệ Sức Khỏe, Sử Dụng Với Máy Xông Tinh Dầu Cho Gia Đình Và Văn Phòng",98000,296000,198000,67
TIKI,lam-dep-suc-khoe,108535183,"Bao cao su Sagami Are Are - Có gai - Hộp 10 chiếc",115000,160000,45000,28
TIKI,lam-dep-suc-khoe,71200200,"Viên tinh nghệ mật ong (MS) -250g",159000,200000,41000,21
TIKI,lam-dep-suc-khoe,74561072,"Tinh dầu Sả Chanh Nguyên Chất Nhập Khẩu 10ML - Tinh dầu Xông Phòng Sả Chanh (Lemongrass) Giúp Bảo Vệ Sức Khỏe, Kháng Khuẩn, Đuổi Muỗi Và Thư Giãn Tinh Thần",29000,76000,47000,62
TIKI,lam-dep-suc-khoe,120318503,"Khẩu trang 5d mask Nam Anh (Famapro) - Hộp 10 cái",15000,15000,0,0
TIKI,lam-dep-suc-khoe,185940709,"[SIZE DU LỊCH] Nước tẩy trang Sắc Ngọc Khang 30ml giúp làm sạch da bụi bẩn, bã nhờn, ngăn ngừa mụn hiệu quả",20000,30000,10000,33
TIKI,lam-dep-suc-khoe,7980446,"Combo kem đánh răng 62g và bột tẩy trắng răng Eucryl 50g (Chính hãng)",109000,109000,0,0
TIKI,lam-dep-suc-khoe,80469655,"Dầu dừa tinh khiết mỹ phẩm Vietcoco 250ml",112000,112000,0,0
TIKI,lam-dep-suc-khoe,13415779,"Nước Súc Miệng Thái Dương Hương Bạc Hà (500ml)",30100,35000,4900,14
TIKI,lam-dep-suc-khoe,577147,"Dầu Gội Hỗ Trợ Trị Gàu Stanhome Balance Shampoo 200ml - 07482",379000,379000,0,0
TIKI,lam-dep-suc-khoe,73532408,"Gel Bôi Trĩ Giúp Co Búi Trĩ, Hỗ Trợ Giảm Sưng Đỏ Và Ngứa Rát Hậu Môn Do Trĩ Trimaxgel 20g - Nguyên Liệu Nhập Khẩu Từ Châu Âu",103000,103000,0,0
TIKI,lam-dep-suc-khoe,24161391,"Dầu gội ngăn ngừa gàu Davines Naturaltech Purifying shampoo 250ml",270750,285000,14250,5
TIKI,lam-dep-suc-khoe,80780129,"Combo 3 Khẩu Trang 3D MONA MASK N99 Chống Nắng Tia Uv Lọc 99% Bụi Mịn Pm 2.5",60000,60000,0,0
TIKI,lam-dep-suc-khoe,108535211,"Bao cao su Sagami Tight Fit - Thiết kế lượn sóng - Hộp 12 chiếc",110000,160000,50000,31
TIKI,lam-dep-suc-khoe,8211888,"Nhíp Vỉ Giấy N-409 - Kềm Nghĩa",38000,40000,2000,5
TIKI,lam-dep-suc-khoe,125838068,"Combo 8 gói Băng Vệ Sinh Kotex Hằng ngày Kháng khuẩn 20 miếng",120000,120000,0,0
TIKI,lam-dep-suc-khoe,217174306,"[+Tặng mũ trùm] Kem ủ tóc Collagen Karseell Maca phục hồi siêu mượt 100ml/500ml",64000,64000,0,0
TIKI,lam-dep-suc-khoe,877404,"Combo 5 Giấy Thấm Dầu Mayan  (100 Tờ / Gói)",90100,110000,19900,18
TIKI,lam-dep-suc-khoe,118959851,"Gel rửa mặt tạo bọt cho da hỗn hợp và da dầu Bioderma Sebium Gel Moussant dạng tuýp - 200ml",309000,325000,16000,5
TIKI,lam-dep-suc-khoe,55622025,"Nước Hoa Hồng Kiềm Dầu Kiểm Soát Bã Nhờn Cân Bằng Độ Ẩm Da Dầu Mụn Nhạy Cảm Dewytree The Clean Lab AC DEW Calamine Toner 200ml",414000,460000,46000,10
TIKI,lam-dep-suc-khoe,44140593,"MẶT NẠ THẢI ĐỘC HỖ TRỢ TRỊ MỤN TẬN GỐC THAN HOẠT TÍNH, BÙN KHOÁNG DOUBLE DETOX MASK (20 GR) LÀM DỊU MỤN ĐỎ, LÀM SẠCH SÂU, THẢI ĐỘC DA, TRẮNG DA, MỜ NÁM.",249000,315000,66000,21
TIKI,lam-dep-suc-khoe,10640154,"Sữa rửa mặt kiểm soát nhờn ngăn ngừa mụn dạng gel Acnes Oil Control Cleanser 100g",55400,70000,14600,21
TIKI,lam-dep-suc-khoe,21038056,"Băng Vệ Sinh Diana Băng Đêm Quần Size S-M-1807",31000,31000,0,0
TIKI,lam-dep-suc-khoe,189697892,"Kem dưỡng ẩm sáng da Caryophy Glass Skin Cream 50ml",660000,660000,0,0
TIKI,lam-dep-suc-khoe,70661243,"Gel rửa mặt tạo bọt làm sạch & giảm nhờn cho da dầu nhạy cảm La Roche-Posay Effaclar Purifying Foaming Gel (400ml)",468000,625000,157000,25
TIKI,lam-dep-suc-khoe,143709242,"Dầu xả Nguyên xuân từ thảo dược - Dưỡng tóc mềm mượt, bồng bềnh, giảm chẻ ngọn, gãy rụng - Tặng thêm 30ml, Tổng 180ml",74000,130000,56000,43
TIKI,lam-dep-suc-khoe,55614663,"Kem Nền Che Khuyết Điểm Kiềm Dầu Chống Nắng Dưỡng Da Ngăn Ngừa Lão Hóa Công Nghệ Nano Vàng Cellkey-Scien Multi Action BB Cream (30ml)",578000,680000,102000,15
TIKI,lam-dep-suc-khoe,14708536,"Bộ máy đo đường huyết Safe Accu tặng 1 hộp 50 que thử và hộp 50 kim chích máu",200000,200000,0,0
TIKI,lam-dep-suc-khoe,16631908,"Xà Phòng Rửa Mặt Và Giảm Mụn Acne-Aid Bar 100g",79000,96000,17000,18
TIKI,lam-dep-suc-khoe,73351823,"Sáp vuốt tóc BY VILAIN DYNAMITE CLAY 65 ml",419000,419000,0,0
TIKI,lam-dep-suc-khoe,70664831,"Nước Tẩy Trang Làm Sạch Sâu & Kiểm Soát Bã Nhờn Cho Da Dầu Nhạy Cảm La Roche-Posay Micellar Water Ultra Oily Skin 200ml",357000,420000,63000,15
TIKI,lam-dep-suc-khoe,71523904,"KÉO CẮT TÓC 6.0 Inch CHUYÊN NGHIỆP HAND MADE JAPAN (1 Bộ)",185000,189000,4000,2
TIKI,lam-dep-suc-khoe,119289800,"Dao Cạo Râu Chuyên Nghiệp NQ88",69000,69000,0,0
TIKI,lam-dep-suc-khoe,16107344,"BỘ 10 MẶT NẠ LÔ HỘI DABO FIRST SOLUTION MASK PACK ALOEVERA",89000,89000,0,0
TIKI,lam-dep-suc-khoe,8142287,"Kềm Cắt Da Thép Chuyên Dụng Kềm Nghĩa D-18",80000,80000,0,0
TIKI,lam-dep-suc-khoe,141354715,"Dầu gội gừng Weilaiya cao cấp 400ml - trị rụng tóc, kích thích mọc tóc",275000,345000,70000,20
TIKI,lam-dep-suc-khoe,53061315,"Combo 10 Túi mặt nạ giấy dưỡng trắng da - mặt na dưỡng trắng da chiết xuất Than Hoạt Tính 3w Clinic Hàn Quốc 23ml x 10",56000,56000,0,0
TIKI,lam-dep-suc-khoe,30157357,"Nước bí đao cân bằng da (Winter melon toner) Cocoon 140ml",156000,195000,39000,20
TIKI,lam-dep-suc-khoe,72710940,"Bao cao su Powermen Ôm sát, 250 Gai nhỏ, Kéo dài thời gian",39000,39000,0,0
TIKI,lam-dep-suc-khoe,15654981,"Cây Lấy Khóe Đầu Cong Inox Hỗ Trợ Móc Khóe và Vệ Sinh Khóe KỀM NGHĨA",7000,7000,0,0
TIKI,lam-dep-suc-khoe,1679039,"Bông Cắt Bông Bạch Tuyết TPM-25 (500g)",116000,200000,84000,42
TIKI,lam-dep-suc-khoe,104323277,"Tinh Dầu Sả Chanh Treo Xe TOKI MORI Xuất Khẩu Nhật Bản (10ml) 100% Thiên Nhiên, An Toàn Cho Trẻ, Xông Phòng, Khử Mùi, Thơm Xe, Chống Ói, Kháng Khuẩn",99000,99000,0,0
TIKI,lam-dep-suc-khoe,79411386,"Kem chống nắng nâng tông Skin Aqua Tone up Rose cho da trắng, khuyết điểm xanh hoặc tái xanh, dạng tinh chất Sunplay Skin Aqua Tone Up UV Essence Happiness Aura (Rose) SPF 50+ PA++++ 50g",161000,199000,38000,19
TIKI,lam-dep-suc-khoe,43334084,"Trial Tinh chất Làm Mờ Vết Nám và Đốm Nâu Paula's Choice Clinical 1% Retinol Treatment 5 ml",449000,449000,0,0
TIKI,lam-dep-suc-khoe,37974580,"Viên uống Trắng da DHC Adlay Extract Nhật Bản - 60 Ngày (60 viên)",425000,500000,75000,15
TIKI,lam-dep-suc-khoe,140107223,"Sữa dưỡng thể Vaseline Healthy White UV Lightening Body Lotion 725ml",150000,150000,0,0
TIKI,lam-dep-suc-khoe,137847856," Nước Hoa Nam Dạng Sáp Khô Cao Cấp Meidian Hương Thơm Cuốn Hút,Nam Tính(Combo 3 mùi)",60000,120000,60000,50
TIKI,lam-dep-suc-khoe,111874128,"Bộ 4 Kem đánh răng Colgate bạc hà the mát Maxfresh 225g/tuýp tặng bàn chải đánh răng lông mềm",190000,263000,73000,28
TIKI,lam-dep-suc-khoe,73322326,"Nước Tẩy Trang Simple Micellar Cleansing Water 200ml",119000,119000,0,0
TIKI,lam-dep-suc-khoe,58053818,"Bấm Móng Tay Chân Thép Không Gỉ KỀM NGHĨA B.904 - Lưỡi Cong (Loại Nhỏ)",40000,40000,0,0
TIKI,lam-dep-suc-khoe,96199726,"NAKIZ LIVELY BUTT kem ngừa mụn, mờ thâm Mông bẹn nách Thái Lan 100g",299000,299000,0,0
TIKI,lam-dep-suc-khoe,113500007,"Đai Chống Gù Lưng Có Rung Cảm Biến Ba Chiều Nhắc Nhở Sửa Tư Thế Thông Minh - Nẹp Lưng Chống Gù Cho Trẻ Em, Nam, Nữ",141550,149000,7450,5
TIKI,o-to-xe-may-xe-dap,184599329,"KEO XỬ LÝ CÁC VẾT RẠN NỨT VỠ NHẸ Ở KÍNH CHẮN GIÓ XE HƠI ÔTÔ MẪU MỚI HÀNG CAO CẤP",138000,138000,0,0
TIKI,lam-dep-suc-khoe,148895418,"Khẩu trang chống nắng Anti UV Soteria Ebony đạt chuẩn UPF 50+, chống khuẩn chống bụi siêu mịn 0.1 micro - Size S,M,L",171990,171990,0,0
TIKI,o-to-xe-may-xe-dap,31437572,"Bộ Dụng Cụ Chăm Sóc Vệ Sinh Cọ Rửa Bánh Xe Ô Tô Đa Năng",46000,46000,0,0
TIKI,lam-dep-suc-khoe,185591384,"Mặt nạ dưỡng ẩm chuyên sâu Hada Labo Premium Hydrating Serum Mask 23g/ miếng",38500,44000,5500,13
TIKI,lam-dep-suc-khoe,58451261,"Gói Bột Uống Giảm Nhanh Ợ Nóng Ợ Chua Trào Ngược Dạ Dày Fobe-AD (Hộp 20 gói).",272250,272250,0,0
TIKI,lam-dep-suc-khoe,1628055,"Lăn Khử Mùi Giúp Khô Thoáng Vùng Da Dưới Cánh Tay 72h Vichy Detransprirant Intensif 72h Transpiration Excessive (50ml)",272000,320000,48000,15
TIKI,o-to-xe-may-xe-dap,58545007,"Combo rửa sên WillF1 Chain Cleaner 500ml, Dưỡng sên WillF1 Chain Lube 400ml Tặng kèm bàn chải vệ sinh sên 3D",119000,119000,0,0
TIKI,lam-dep-suc-khoe,2616909,"Nước Tẩy Trang Làm Sạch Sâu & Kiểm Soát Bã Nhờn Cho Da Dầu Nhạy Cảm La Roche-Posay Micellar Water Ultra Oily Skin 400ml",390000,520000,130000,25
TIKI,lam-dep-suc-khoe,40935834,"Dầu gội Sunsilk Óng Mượt Rạng Ngời 1.4kg dành cho tóc khô xơ với tinh chất Bồ Kết truyền thống",205000,205000,0,0
TIKI,lam-dep-suc-khoe,106503541,"Máy mát xa cổ vai gáy trị liệu cao cấp - Máy matxa cổ",144000,144000,0,0
TIKI,lam-dep-suc-khoe,46644605,"Cho máy Braun Oral-B, Bộ 4 đầu bàn chải đánh răng điện - Đánh bật cao răng- EB-25A-Cho răng sáng bóng",165000,165000,0,0
TIKI,o-to-xe-may-xe-dap,59548941,"Phủ kính nano chống bám nước gương kính ô tô Nhật Bản",210000,210000,0,0
TIKI,o-to-xe-may-xe-dap,117202092,"Ốc lục giác Inox chuyên dùng cho xe đạp thể thao",32000,32000,0,0
TIKI,lam-dep-suc-khoe,247300543,"Tinh dầu Treo 100% Thiên nhiên - Nhà của Thời Thanh Xuân",132000,132000,0,0
TIKI,o-to-xe-may-xe-dap,20131181,"Miếng Che Yên Xe Máy",11500,11500,0,0
TIKI,lam-dep-suc-khoe,36678762,"Combo 6 gói Băng vệ sinh Diana Siêu thấm siêu mỏng cánh 8 miếng",120000,132000,12000,9
TIKI,lam-dep-suc-khoe,1313893,"Xịt khử mùi chiết xuất thiên nhiên Refre Natural Rosemary Hương Thảo (30ml)",59000,65000,6000,9
TIKI,lam-dep-suc-khoe,32237380,"Kem dưỡng ban đêm Sắc Ngọc Khang dưỡng sáng và mờ thâm nám 30g",279000,300000,21000,7
TIKI,o-to-xe-may-xe-dap,131192931,"Baga Jupiter FI 10ly titan, đen, inox siêu chất",95000,95000,0,0
TIKI,o-to-xe-may-xe-dap,1254601,"Khăn Lau Xe Hơi 3M Perfect-It Super Soft Microfiber PN05400 (32 x 36 cm)",59000,59000,0,0
TIKI,lam-dep-suc-khoe,89139805,"[TÚI - FAMAPRO 4D] - Khẩu trang y tế kháng khuẩn cao cấp Famapro 4D tiêu chuẩn KF94 (5 cái/ túi)",10000,10000,0,0
TIKI,o-to-xe-may-xe-dap,36213946,"Bộ 2 dây cáp 2.5m 1800A câu điện bình ắc quy ô tô 4-8 chỗ kích nổ acquy xe hơi ô tô có bảo vệ",149000,149000,0,0
TIKI,lam-dep-suc-khoe,212317103,"Vitamin E Mỹ Kirkland Signature E 180mg  – Chống Oxy hóa mạnh, làm chậm quá trình lão, đẹp da, tóc và tốt cho tim mạch - Massel Official - 500 Viên",501000,1002000,501000,50
TIKI,o-to-xe-may-xe-dap,34513035,"Đèn LED Cảnh báo sau Xe Đạp giúp đạp xe an toàn ban đêm 4 chế độ sáng (Đèn Xanh) Mai Lee - Hàng chính hãng",19000,19000,0,0
TIKI,o-to-xe-may-xe-dap,68850833,"Chổi Lau Rửa Xe Ô Tô 360 Độ Sợi Siêu Mịn Có Thể Điều Chỉnh Chiều Dài",66000,66000,0,0
TIKI,o-to-xe-may-xe-dap,175414765,"Dây bơm xe đạp xe máy, dây thay thế cho bơm tay, bơm chân",14000,14000,0,0
TIKI,lam-dep-suc-khoe,3490281,"Nước Hoa Hồng Cân Bằng Và Điều Chỉnh Lỗ Chân Lông Paula's Choice Skin Balancing Pore Reducing Toner (190ml)",619000,729000,110000,15
TIKI,o-to-xe-may-xe-dap,184332961,"Gờ cao su chặn lùi xe ô tô, cố định bánh xe",189000,189000,0,0
TIKI,o-to-xe-may-xe-dap,171871414,"Nón bảo hiểm xe đạp trẻ em Protec SMILE cho bé trai từ 1-12 tuổi, họa tiết mạnh mẽ, năng động, có đèn hậu an toàn- Hàng chính hãng",338000,438000,100000,23
TIKI,o-to-xe-may-xe-dap,88027315,"Giá điện thoại trên ô tô",37521,51278,13757,27
TIKI,lam-dep-suc-khoe,136816203,"Saffron ngâm mật ong Kingdom Herb chính hãng thượng hạng hộp 311g",305000,599000,294000,49
TIKI,o-to-xe-may-xe-dap,33545274,"Bơm xe đạp, xe máy cầm tay nhỏ gọn",39000,50000,11000,22
TIKI,lam-dep-suc-khoe,270886117,"Vitamin E Mỹ Kirkland Signature E 180mg (400 IU) – Giúp đẹp da, tóc, làm chậm quá trình lão hóa và tăng sức khỏe tổng thể - QuaTangMe Extaste",451400,1002000,550600,55
TIKI,lam-dep-suc-khoe,152709665,"Máy Tăm Nước Cầm Tay - Tăm Nước Vệ Sinh Răng Miệng Oral Irrigator - Bản Quốc Tế Chuẩn Châu Âu",169000,169000,0,0
TIKI,o-to-xe-may-xe-dap,92153825,"Nguồn camera hành trình chuyển 12-36V xuống 5V 3.5A dây dài 3m5 kèm 2 cổng USB sạc điện thoại",128700,128700,0,0
TIKI,o-to-xe-may-xe-dap,113406380,"Chốt Khóa Dây An Toàn Cho Xe Ô Tô - TB",30800,30800,0,0
TIKI,o-to-xe-may-xe-dap,63861428,"Khánh Phật Tọa Liên Hoa Trang Trí Xe Hơi , Dây Treo Phật Sen Gỗ Hoàng Dương Trang Trí Ô Tô",215000,215000,0,0
TIKI,lam-dep-suc-khoe,51696125,"Combo 2 Xịt toàn thân Romano Force tươi mát năng động 150ml",206000,206000,0,0
TIKI,lam-dep-suc-khoe,117222715,"Máy Triệt Lông Vĩnh Viễn Tại Nhà Halio IPL Hair Removal Device 999999 Xung Ánh Sáng",2759000,3549000,790000,22
TIKI,o-to-xe-may-xe-dap,37874087,"Cần số Xi 7 Màu Titan cho Exciter 150 Cao Cấp Siêu Thị Đức Anh",68000,68000,0,0
TIKI,o-to-xe-may-xe-dap,159880336,"Bàn ăn trên ô tô, Bàn làm việc đa năng gấp gọn trên ô tô xe hơi",294000,329000,35000,11
TIKI,lam-dep-suc-khoe,75621730,"Viên Uống Hỗ Trợ Co Thắt Búi Trĩ Trimax Hủ 30 Viên Nguyên Liệu Từ Thiên Nhiên",179000,210000,31000,15
TIKI,lam-dep-suc-khoe,271473344,"Viên uống bổ não Healthy Care Ginkgo Biloba 100 viên",300000,300000,0,0
TIKI,o-to-xe-may-xe-dap,196381326,"Mũ bảo hiểm lưỡi trai loại nón kết Napoli N08 size 56-59 cm",259000,259000,0,0
TIKI,lam-dep-suc-khoe,107323260,"Combo 2 Chai Dầu Gội Và Xả Hoa Bưởi Thorakao 400ml",139900,139900,0,0
TIKI,o-to-xe-may-xe-dap,51062644,"Bộ 2 Gương Cầu Lồi Góc Rộng 360 Độ Cho Xe Ô Tô",75000,75000,0,0
TIKI,o-to-xe-may-xe-dap,68455523,"VÒNG XOAY VÔ CỰC - SÁP THƠM GALAXY KIM LOẠI GẮN TAPLO TỰ QUAY BẰNG NĂNG LƯỢNG MẶT TRỜI",110000,110000,0,0
TIKI,o-to-xe-may-xe-dap,33438072,"Bộ gối tựa đầu và tựa lưng xe hơi chất liệu cao su non cao cấp Lucky Bobi",249000,249000,0,0
TIKI,o-to-xe-may-xe-dap,41195385,"Xịt khử mùi hôi Tinh dầu xá xị 100ml",104500,110000,5500,5
TIKI,o-to-xe-may-xe-dap,111362293,"Thảm lót sàn cao su không mùi dành cho Kia Cerato 2019 2020",488000,488000,0,0
TIKI,o-to-xe-may-xe-dap,147975649,"Bảng Số Điện Thoại Ô Tô - Bảng Số Điện Thoại Trên Ô Tô - Đặt Trên Taplo",14000,14000,0,0
TIKI,lam-dep-suc-khoe,140440052,"Máy Massage Chân VISPO VP-C21G - Máy Massage Lòng Bàn Chân, Mu Bàn Chân Công Nghê Hiện Đại, Xoa Bóp, Trườm Ấm Thư Giãn, giải tỏa Căng Thằng Mệt Mỏi",1659000,2980000,1321000,44
TIKI,lam-dep-suc-khoe,144191635,"Sáp Wax Lông An Lành / Wax Lông Nách Tay / Chân (Tặng giấy và que )",55000,55000,0,0
TIKI,o-to-xe-may-xe-dap,106680580,"Đèn Hậu Phía Sau Cảnh báo an toàn Đuôi Xe Đạp DC918 Sạc USB Có Thể Sạc Lại MaiLee",33000,37000,4000,11
TIKI,o-to-xe-may-xe-dap,107798998,"Vam tháo nắp bình xăng ô tô 2 chân",120000,125000,5000,4
TIKI,o-to-xe-may-xe-dap,153770768,"Túi để đồ đa năng gắn ghế sau xe hơi chống nước, có thể xếp gọn",139000,139000,0,0
TIKI,o-to-xe-may-xe-dap,10397229,"Dung Dịch Rửa Xe Không Chạm Ekokemika Bio 35 (5L) - Hàng Chính Hãng",855000,855000,0,0
TIKI,o-to-xe-may-xe-dap,59436625,"Đèn Đuôi LED Xe Đạp Thông Minh Cảnh Báo Ban Đêm Có Cảm Biến Chuyển Động Và Báo Đèn Khi Phanh Xe Chống Nước Sạc Điện USB MAILEE - Hàng Chính Hãng",246050,259000,12950,5
TIKI,o-to-xe-may-xe-dap,145658918,"Nón bảo hiểm 3/4 Royal M125K thiết kế nhỏ gọn, nhiều màu sắc, phù hợp mọi độ tuổi, hàng chính hãng - M",489000,490000,1000,0
TIKI,o-to-xe-may-xe-dap,157118111,"Bao da chìa khoá Toyota Raize 2021 2022 handmade da thật 011",200000,200000,0,0
TIKI,lam-dep-suc-khoe,158788377,"COMBO 5 GÓI 400 CÂY Tăm chỉ nha khoa ENVIRONTMENT  - Chỉ Đức công nghệ Nhật ENVIRONTMENT",150000,175000,25000,14
TIKI,o-to-xe-may-xe-dap,130552330,"Gạt mưa kính hậu xe KIA MORNING 2012-2019",87000,87000,0,0
TIKI,o-to-xe-may-xe-dap,987019,"Dầu Bôi Trơn Chống Rỉ Sét WD-40 840531 (300ml)",104000,104000,0,0
TIKI,o-to-xe-may-xe-dap,107369450,"Chốt Khóa Dây Đai An Toàn Theo Logo Các Hãng Xe CKAT",39000,39000,0,0
TIKI,o-to-xe-may-xe-dap,10796772,"Khăn lau xe hơi oto 3M Microfiber (4 khăn).",39000,39000,0,0
TIKI,o-to-xe-may-xe-dap,72722988,"Dụng Cụ Vệ Sinh Lau Chùi Bảo Dưỡng Xe Đạp Gồm Chổi Lau Sên Xích, Chổi Cọ Lốp, Găng Tay Vải (Nhiều Món) Giúp Lau Chùi Vệ Sinh Nhanh Chóng",139000,149000,10000,7
TIKI,thoi-trang-nu,145802049,"Áo thun nữ trơn dáng croptop Eva design, áo phông nữ vải thun co giãn 4 chiều cổ V",29000,29000,0,0
TIKI,thoi-trang-nu,72005544,"Bộ Đồ Nữ Mặc Trong Nhà Bộ Đồ Ngủ Hoa Cúc Dễ Thương DB002 MayBlue Chất Liệu Cate, Nhiều Họa Tiết",84550,89000,4450,5
TIKI,thoi-trang-nu,67862731,"Áo croptop nữ xoắn ngực siêu đẹp",84000,84000,0,0
TIKI,thoi-trang-nu,105343063,"Quần Lót Nữ, Bộ 5 Quần Lót Nữ Lụa Phối Ren Cao Cấp Mềm Mịn, Quần Lót Nữ Kháng Khuẩn, Quần Lót Nữ Co Dãn Tốt Thoáng Mát Thương Hiệu Baw Mã QLN2606",199000,199000,0,0
TIKI,thoi-trang-nu,82865098,"Áo Ngực Su Hình Lá Nâng Ngực Không Gọng Đệm 3cm Tạo Khe Quyến Rũ Thương Hiệu Baw mã AN02",159000,159000,0,0
TIKI,thoi-trang-nu,98290860,"Quần lót nữ không đường may iBasic V189",79000,89000,10000,11
TIKI,thoi-trang-nu,72204483,"Áo Lót Chống Tụt  Đệm Mỏng LOIRECHIC BRQ02 Dây Đầm Có Viền Cao Su Tặng kèm dây áo",169000,195000,26000,13
TIKI,thoi-trang-nu,172920086,"Váy ngủ nữ, váy lụa cao cấp VILADY - V120 màu Đen quý phái, kiểu cổ V tay lỡ phối viền, chất liệu lụa Pháp ( lụa latin)",279000,420000,141000,34
TIKI,thoi-trang-nu,82700722,"Bộ 5 Quần Lót Nữ, quần lót cotton siêu thấm mút mồ hôi thương hiệu Baw mẫu QLN10",139000,139000,0,0
TIKI,thoi-trang-nu,134931750,"Quần Lót Nữ Su Thông Hơi (Hàng Loại 1) Không Đường May, Thun Lạnh, SIêu Co Dãn, Được Chọn Màu",15500,15500,0,0
TIKI,thoi-trang-nu,111058227,"Quần Lót Nữ, Bộ 5 Quần Lót Nữ Cotton Mềm Mịn, Quần Lót Nữ Kháng Khuẩn, Quần Lót Nữ Co Giãn Tốt Thương Hiệu Baw Mã QLN03000",129000,129000,0,0
TIKI,thoi-trang-nu,37833320,"Set 10 Quần Lót Nữ Cotton Pulo Siêu Thoải Mái",85000,85000,0,0
TIKI,thoi-trang-nu,68628797,"Combo 10 Quần Lót Nữ Modal Phối Ren Trước Remix - Giao Màu Ngẫu Nhiên FCM04",419000,790000,371000,47
TIKI,thoi-trang-nu,7166595,"Bộ 4 Quần Lót Cotton Cho Bà Bầu Mềm Mịn (Đủ mầu) -5Star",88000,88000,0,0
TIKI,thoi-trang-nu,72093578,"Áo Ngực Không Gọng Đệm Mỏng LOIRECHIC BRTS14 chất liệu Su Đúc Đệm liền",260000,325000,65000,20
TIKI,thoi-trang-nu,172666766,"Váy ngủ nữ, váy 2 dây quyến rũ VILADY - V118 kiểu cổ đổ sang chảnh màu đen, chất liệu Lụa Pháp (lụa latin) cao cấp",259000,390000,131000,34
TIKI,thoi-trang-nu,82916256,"Bộ 5 Quần Lót Ren cao cấp cạp chéo thương hiệu BAW NT12",149000,149000,0,0
TIKI,thoi-trang-nu,197010897,"Quần lót ren lọt khe sexy gợi cảm 5 màu 02",15000,15000,0,0
TIKI,thoi-trang-nu,154135275,"Quần Đùi Nữ Mặc Nhà Chất vải Lụa Hàn Quốc ,Mịn ,Mặc Mát, Hàng Thiết kế Cao Cấp (45-65kg)  Nhiều Màu New design  QA0003",39000,79000,40000,51
TIKI,thoi-trang-nu,86881186,"( HÀNG SẴN) Váy Đầm Nữ Trung Niên Dáng Suông Thời Trang VH88 - Hàng Quảng Châu Cao Cấp(Ảnh thật cuối hình)",345000,345000,0,0
TIKI,thoi-trang-nu,82698680,"Bộ 5 Quần Lót Nữ Cotton gân tăm kháng khuẩn thương hiệu BAW hoạ tiết viền ren sexy điệu đà QLN04",208500,208500,0,0
TIKI,thoi-trang-nu,167906833,"Bikini Tay Dài Dễ Thương Hot Trending AT218 MayHomes Đồ Bơi Hai Mảnh Long Sleeves Women Swimwear Set",250000,250000,0,0
TIKI,thoi-trang-nu,169628004,"Đồ Bơi Nữ Một Mảnh Ôm Thân Khỏe Khoắn ATI86 MAYHOMES Tay Dài Che Nắng, Long-Sleeve Rashguard, UV Protection",199000,255000,56000,22
TIKI,thoi-trang-nu,97685241,"Áo Lót Đúc Su Siêu Nâng Ngực Tạo Khe Quyến Rũ, Áo Lót Su Không Gọng Không Đường May Thương Hiệu BAW Mã AN36",159000,159000,0,0
TIKI,thoi-trang-nu,70662805,"Combo 8 Quần Lót Nữ Cotton Flexi Miley Lingerie - Giao màu ngẫu nhiên",256000,632000,376000,59
TIKI,thoi-trang-nu,7162313,"Quần Độn Mông Su Cao Cấp 135 - 5Star",56000,56000,0,0
TIKI,thoi-trang-nu,107540897,"ĐẦM ELIZABET MẪU MỚI SANG CHẢNH CÓ HAI MÀU",165000,165000,0,0
TIKI,thoi-trang-nu,142994619,"Áo 2 dây sợi bún thun gân đẹp 100% cotton đen trắng , áo croptop ôm mặc trong siêu mát DA099",13750,13750,0,0
TIKI,thoi-trang-nu,101278887,"COMBO 5  ÁO LÁ  HỌC SINH CẤP 1 HOẶC CẤP 2 .(40KG-77KG)",151200,151200,0,0
TIKI,thoi-trang-nu,171929698,"Combo 2 quần lót nữ, quần lọt khe, quần lót tam giác ren lưới xuyên thấu sexy, đính nơ xinh xắn ( màu ngẫu nhiên) LYEQ052",74000,78000,4000,5
TIKI,thoi-trang-nu,166537332,"Chân Váy Nữ, Chân Váy Ngắn Dập Ly Xòe Tầng Có Lót Quần Trong Cao Cấp Thương Hiệu Baw CV01",219000,219000,0,0
TIKI,thoi-trang-nu,82875023,"Áo Ngực Su Đệm Dày Nâng Ngực Tạo Khe Siêu Quyến Rũ Thương Hiệu Baw mã AN04",159000,159000,0,0
TIKI,thoi-trang-nu,192303246,"Quần Độn Mông Hông Thông Hơi Cao Cấp Không Viền Mặc Váy Áo Dài 2 Màu Da Đen Đúc Su Hàng Loại 1",295000,335000,40000,12
TIKI,thoi-trang-nu,115643270,"Áo kiểu hoa nhí dễ thương-MS017",185000,185000,0,0
TIKI,thoi-trang-nu,187657313,"Quần Lót Nữ, Quần Gen Nịt Bụng Eo Thon, Quần Ghen Chống Cuộn Cạp Cao Giảm Eo Và Mỡ Bụng Sau Sinh QG12",129000,129000,0,0
TIKI,thoi-trang-nu,83757870,"Quần Lót Nữ Su không đường may thương hiệu Baw hàng loại 1 LOT1",25000,25000,0,0
TIKI,thoi-trang-nu,181247667,"Quần Legging Cạp Siêu Cao Siêu Co Giãn Chất Đẹp Hàng Loại 1 Nâng Mông Tôn Dáng Dấu Bụng",195000,225000,30000,13
TIKI,thoi-trang-nu,142994617,"Áo ống quây ngực croptop len tăm 100% cotton 2 màu đen trắng free size dưới 53 kg AQ 099",16500,16500,0,0
TIKI,thoi-trang-nu,48970691,"Áo Sơ Mi Nữ Kiểu Cổ V Cài Nút 2 túi xinh xắn",170050,179000,8950,5
TIKI,thoi-trang-nu,19646743,"Áo khoác ren tà ngắn 06 C107",133000,149000,16000,11
TIKI,thoi-trang-nu,172671066,"Bộ đồ ngủ nữ 2 dây mặc nhà dễ thương VILADY - B111 kiểu 2 dây quần cộc màu trắng gạo mềm mát, chất liệu Lụa Pháp ( lụa latin) cao cấp",179000,249000,70000,28
TIKI,thoi-trang-nu,148640368,"Áo lót bầu- áo lót cho con bú chống chảy xệ mặc bầu và sau sinh AL06",66000,66000,0,0
TIKI,thoi-trang-nu,73517557,"Áo thun in tay lỡ nữ freesize phông form rộng dáng Unisex - Ulzzang mặc cặp, nhóm, lớp hình BƯỚM MISSOUT BUTTERFLY",36000,36000,0,0
TIKI,thoi-trang-nu,140212788,"Áo khoác blazer, áo vest nữ kiểu Hàn Quốc tay lỡ, chất vải đẹp, nhiều màu - Thời trang công sở WFstudios",345000,345000,0,0
TIKI,thoi-trang-nu,121258407,"Áo polo nữ màu trắng phối viền chìm ADINO vải cotton polyester mềm dáng slimfit công sở hơi ôm trẻ trung APN03",159000,318000,159000,50
TIKI,thoi-trang-nu,136240916,"Combo 3 cặp dán ti/ ngực silicon siêu mềm, chắc chắn, sử dụng nhiều lần",82650,87000,4350,5
TIKI,thoi-trang-nu,1818717,"Áo Ngực Triumph Maxi M039 LZ-VN - Màu Da (Size",520000,520000,0,0
TIKI,thoi-trang-nu,66390534,"Đầm Nữ Trung Niên Ngắn Tay Dáng Suông",248000,248000,0,0
TIKI,thoi-trang-nu,192801978,"Áo ngực có gọng mút vừa demi daily iBasic BRAW087",199000,199000,0,0
TIKI,thoi-trang-nu,182543023,"Quần mặc váy bảo hộ, quần mặc trong váy 2 lớp che vùng tam giác an toàn khắc phục mọi nhược điểm -CCC166",23999,23999,0,0
TIKI,thoi-trang-nu,10280258,"Combo 10 Quần Lót Nữ Modal Miley Lingerie (Màu ngẫu nhiên)",395000,395000,0,0
TIKI,thoi-trang-nu,106987516,"Áo Khoác bomber dù Gió Angel Land Cặp Nam Nữ Form Unisex siêu xinh- Bomber jackets thoitrangsihienlinh",100000,100000,0,0
TIKI,thoi-trang-nu,165211929,"Áo Lót Nữ, Áo Ngực Đúc Su Không Gọng Xuất Nhật đệm bàn tay thông hơi siêu nâng ngực, áo lót chống ung thư Thương Hiệu Baw mã AN039",129000,129000,0,0
TIKI,thoi-trang-nu,84824248,"Áo Lót Dán Silicon- Miếng Dán Ngực Hình Xoài Chữ U Dán 1/2 Ngực Gom Ngực Tạo Khe B416",37000,37000,0,0
TIKI,thoi-trang-nu,97676376,"Bộ 5 Quần Lót Nữ Cotton Lót May Chống Viêm, Quần Chip Nữ Kháng Khuẩn Cao Cấp Thương Hiệu BAW NT722",199000,199000,0,0
TIKI,thoi-trang-nu,48357722,"Váy ngủ lưới phối ren xẻ tà trước sexy kèm quần lót lọt khe VN16, Đồ lót đồ ngủ gợi cảm, Freesize",85500,90000,4500,5
TIKI,thoi-trang-nu,124874229,"Có size đến 85kg-Đồ bộ mặc ở nhà cho nữ quần dài co giãn thoáng mát",99000,99000,0,0
TIKI,thoi-trang-nu,84698240,"Quần Lót Lọt Khe đúc su in chữ mát mịn thương hiệu BAW mã QLN56",159000,159000,0,0
TIKI,thoi-trang-nu,13745082,"Bộ 10 Quần Lót Nữ Thun Lạnh Fashion Miley Lingerie - BMS_01 - Giao Màu Ngẫu Nhiên",311000,395000,84000,21
TIKI,thoi-trang-nu,84544893,"Áo Lót Bra Ren Cao Cấp mẫu mới 2021 có móc cài thay đổi kích cỡ thương hiêu BAW mã AN21",159000,159000,0,0
TIKI,thoi-trang-nu,67381250,"Váy ngủ 2 dây liền thân ôm sát xẻ đáy gợi cảm",90000,90000,0,0
TIKI,thoi-trang-nu,38150888,"Combo Quần Lót Nữ Kháng Khuẩn Xuất Nhật 100% Cotton Cao Cấp",29000,29000,0,0
TIKI,thoi-trang-nu,118015056,"Đồ Lam Đi Chùa # Thun Bà Lai Lắc Sen # Đồ Bộ Nữ # Quần Áo Nữ",186000,186000,0,0
TIKI,thoi-trang-nu,87671213," Áo Khoác Nữ 6 Túi Chống Nắng Cao Cấp Vải Thun Cotton (Li01M) [ 40-80kg",163000,163000,0,0
TIKI,thoi-trang-nu,73929481,"Áo thun unisex tay lỡ form rộng - Áo phông trái bơ",49000,79000,30000,38
TIKI,thoi-trang-nu,42735160,"Combo 2 Quần Bầu Đùi Mặc Trong Váy Cạp Chéo Ren Chân Cao Cấp - 5Star",75000,75000,0,0
TIKI,thoi-trang-nu,1921295,"Áo Ngực Triumph D151 VV-VN - Da Sậm (Size",219000,299000,80000,27
TIKI,thoi-trang-nu,97719473,"Áo Lót Đúc Su Bàn Tay Siêu Nâng Ngực Tạo Khe Quyến Rũ, Áo Lót Su Kẻ Sọc Thông Hơi Không Gọng Không Đường May Thương Hiệu BAW Mã AN38",159000,159000,0,0
TIKI,thoi-trang-nu,13894753,"Áo khoác nữ thoát nhiệt Nhật Bản GOKING, 100% cotton siêu thoáng mát, thấm hút mồ hôi, khử mùi, kháng khuẩn, chống UV, chống nắng nhẹ",275000,275000,0,0
TIKI,thoi-trang-nu,89493186,"Đầm suông đũi cổ sen vuông ArcticHunter, form suông rộng không kén dáng mặc, thời trang thương hiệu chính hãng",230000,230000,0,0
TIKI,thoi-trang-nu,118026606,"Đồ Lam Đi Chùa # Áo Tràng Phật Tử Vải Đài Loan Cao Cấp# Nam Nữ",360000,360000,0,0
TIKI,thoi-trang-nu,1921281,"Áo Ngực Triumph D151 CS-VN - Da (Size",219000,299000,80000,27
TIKI,thoi-trang-nu,165206693,"Áo Ngực Nữ, Áo Bra Học Sinh Su Lạnh Trơn Có Đệm Mặc Thoáng Mát Thương Hiêu BAW mã AHS2",150000,150000,0,0
TIKI,thoi-trang-nu,143362784,"Áo khoác nỉ CERTAIN kéo khóa (ảnh thật), Áo Khoác hoodie Mũ Nỉ CERTAIN from rộng unisex ulzzang phong cách hàn quốc, Áo khoác nỉ, áo kiểu dáng hoodie form rộng cho nam nữ in chữ đẹp",99000,99000,0,0
TIKI,thoi-trang-nu,27880579," Áo Ngực Triumph D151 CS-VN - Da",189000,189000,0,0
TIKI,thoi-trang-nu,155790235,"Quần nữ mặc nhà, quần tập yoga chất liệu vải Modal tự nhiên thân thiện nhiều màu mã VAQ0110",122000,122000,0,0
TIKI,thoi-trang-nu,195148746,"ÁO KHOÁC VEST 2 LỚP STYLE KOREA",190000,190000,0,0
TIKI,thoi-trang-nu,273023956,"MIMI BigSize [45KG-100KG] Đầm Bigsize Cổ Vuông dáng xòe-Bs108",199000,199000,0,0
TIKI,thoi-trang-nu,170831596,"Quần Jean Nữ, Quần Jean Nữ Lưng Cao, Quần Jean Nữ Siêu Hack Dáng thương hiệu Chandi, Jean Nữ co dãn tôn dáng phụ nữ eo thon mẫu KV671",171000,350000,179000,51
TIKI,thoi-trang-nu,197830004,"Bộ Cọ Rửa Bình Sữa Và Núm Ti 360 Độ Đa Năng Cao Cấp Cho Bé Siêu Tiện Dụng",29000,29000,0,0
TIKI,o-to-xe-may-xe-dap,74429077,"[Tặng Bộ Đồ Bảo Hộ 6 Món Cho Bé] Mũ Bảo Hiểm Xe Đạp Trẻ Em, Nón Bảo Hiểm Chơi Thể Thao, Trượt Patin Cao Cấp Protec Smile W024 - Hàng Chính Hãng",338000,438000,100000,23
TIKI,o-to-xe-may-xe-dap,196177019,"Ốp Chìa Khóa Xe KIA K3 2021 - 2022 K5 Sportage 22 Sorento Cerato Hợp Kim Kẽm",209000,219000,10000,5
TIKI,o-to-xe-may-xe-dap,146577316," Cốc sạc ô tô, Tẩu sạc nhanh điện thoại tự ngắt thông minh Qualcom 3.0 4 cổng USB 12v-24v mẫu mới cho các xe",69000,69000,0,0
TIKI,o-to-xe-may-xe-dap,77967952,"Keo dán xe máy, 5 Mét keo trong dán xe, dán điện thoại, keo siêu dính, bền bỉ, , có độ dẻo dai và đàn hồi",105000,105000,0,0
TIKI,o-to-xe-may-xe-dap,33361119,"Mũ Bảo Hiểm 1/2 Đầu Thời Trang NS - N0448 - Nhiều Màu",139000,139000,0,0
TIKI,o-to-xe-may-xe-dap,87830999,"Máy Hút Bụi Và Bơm Lốp Ô Tô - Công Suất 120W 4 in 1 Bơm/Hút/Đèn Chiếu Sáng/Đồng Hồ Đo Áp Suất Lốp - K1014",265850,265850,0,0
TIKI,o-to-xe-may-xe-dap,115478739,"Dung Dịch Phục Hồi Nhựa Nhám Plastic Remover 10ml Tặng Kèm Xốp - MSN388401",57900,57900,0,0
TIKI,o-to-xe-may-xe-dap,63860106,"Khánh Liên Hoa Trang Trí Xe Hơi , Dây Treo Sen Gỗ Hoàng Dương Trang Trí Ô Tô",215000,215000,0,0
TIKI,o-to-xe-may-xe-dap,16868657,"Tem Decal Phản Quang Dán Dè Chắn Bùn Xe Máy Thể Thao Cao Cấp AZONE",33250,35000,1750,5
TIKI,o-to-xe-may-xe-dap,107075129,"Ống Nâng Tay Lái Xe Đạp Bằng Nhôm Cao 12cm Phù hợp Ống trong phi 28,6mm Điều Chỉnh Độ Cao Ghi Đông Xe Đạp MaiLee",149000,169000,20000,12
TIKI,o-to-xe-may-xe-dap,32428499,"Găng tay sợi mịn lau, rửa xe cao cấp",16000,16000,0,0
TIKI,o-to-xe-may-xe-dap,88053584,"Matít (bột trét) Morolac Polyester Putty 1Kg",95000,95000,0,0
TIKI,o-to-xe-may-xe-dap,150494169,"Sáp dung dịch đánh bóng vết xước ô tô xe máy như mới loại tốt",99000,99000,0,0
TIKI,o-to-xe-may-xe-dap,11741161,"Chổi Lau Xe  Ô Tô Sợi Dầu,  Điều Chỉnh Được Độ Dài - Tròn ( Có Túi Đựng )",52000,52000,0,0
TIKI,o-to-xe-may-xe-dap,80624267,"Pedal bàn đạp xe đạp có thể xếp gọn",120000,120000,0,0
TIKI,o-to-xe-may-xe-dap,68524327,"Chân đế kẹp đèn pin, đèn pha gắn ghi đông cho Xe Đạp (chất liệu Nhựa ABS, không kèm đèn pin) chắc chắn, xoay 360 độ dễ dàng lắp đặt Mai Lee",8550,9000,450,5
TIKI,o-to-xe-may-xe-dap,96704994,"Vòi bơm hơi thay thế bơm đạp chân Honor và BMB [AMT]",38000,38000,0,0
TIKI,o-to-xe-may-xe-dap,25191981,"Súc béc xăng vệ sinh ô tô 300ml",160000,160000,0,0
TIKI,o-to-xe-may-xe-dap,92154112,"Cáp Sạc, Dây Nguồn Camera Hành Trình Mini USB Dài 3.5m",99000,99000,0,0
TIKI,o-to-xe-may-xe-dap,13611860,"Thảm cao su lót chân xe cho xe Vision",28000,28000,0,0
TIKI,o-to-xe-may-xe-dap,19737606,"Túi tam giác gắn sườn xe đạp (size L gắn được bình nước)",125000,125000,0,0
TIKI,o-to-xe-may-xe-dap,16094270,"Bộ vá lụi (vá ngoài) dùng cho lốp không xăm xe hơi và xe máy",18090,18090,0,0
TIKI,o-to-xe-may-xe-dap,113966974,"COMBO 3 Túi thơm hạt cà phê treo xe ô tô, tủ quần áo, phòng khách, phòng bếp khử mùi ẩm mốc",57999,57999,0,0
TIKI,o-to-xe-may-xe-dap,146663540,"Thảm taplo da vân cacbon cho xe Honda City 2016-2020",195000,195000,0,0
TIKI,o-to-xe-may-xe-dap,92047685,"Mũ Bảo Hiểm ¾ Napoli Sh2 Ruby Xanh Mint Free Size 55-58cm",359000,359000,0,0
TIKI,o-to-xe-may-xe-dap,125818443,"Bộ vào xéc măng piston",275000,400000,125000,31
TIKI,o-to-xe-may-xe-dap,64043014,"NƯỚC RỬA XE KHÔNG CHẠM CHUYÊN DỤNG  [1 Lít] ",99000,109000,10000,9
TIKI,o-to-xe-may-xe-dap,58706399,"Cảm Biến Áp Suất Lốp  Ô Tô Van Ngoài CAR365TMS01 Chính Hãng",329000,329000,0,0
TIKI,o-to-xe-may-xe-dap,31847215,"Dầu Bôi Trơn Chống Rỉ Sét Làm Sạch Thẩm Thấu Chống Ẩm Bảo Vệ WD-40 (412ml)",130000,130000,0,0
TIKI,o-to-xe-may-xe-dap,23228335,"Combo 2 Túi than hoạt tính khử mùi trong ô tô, phòng ngủ, nhà bếp",35000,35000,0,0
TIKI,o-to-xe-may-xe-dap,82458195,"Flash Sale Khay Để Đồ Chèn Khe Ghế Ô Tô, Giá Để Đồ Chèn Khe Ghế, Hộp Đựng Đồ Xe Ô Tô, Bọc Da PU Cao Cấp",125000,125000,0,0
TIKI,o-to-xe-may-xe-dap,21598538,"Relay Còi Ô Tô 12V 4 Chân Nhật Xịn",49000,49000,0,0
TIKI,o-to-xe-may-xe-dap,116853216,"Bộ sạc điện thoại gắn trên Mô tô, xe máy, xe đạp điện 2.1A 206668 F ",44900,44900,0,0
TIKI,o-to-xe-may-xe-dap,90640998,"Bộ sạc xe đạp điện 48V 12AH",162500,162500,0,0
TIKI,o-to-xe-may-xe-dap,162530446,"Combo 2 Chiếc Dụng Cụ Kéo Sửa Vết Lõm Xe Ô Tô Dụng Cụ Hút Tháo Bảng Điều Khiển Thân Xe, Dụng Cụ Loại Bỏ Vết Lõm Sửa Chữa",85000,85000,0,0
TIKI,o-to-xe-may-xe-dap,163842715,"Bạt Trùm Xe Máy Vải Dù Chống Thấm Siêu Bền, Trùm Được Tất Cả Các Đời Xe Máy - Áo trùm xe (Nhiều màu)",105000,105000,0,0
TIKI,o-to-xe-may-xe-dap,74598199,"BÌNH XỊT PHỦ BÓNG SƠN XE G-20  [511ml]",119000,129000,10000,8
TIKI,o-to-xe-may-xe-dap,21903345,"Combo 3 Khăn Rửa Xe Siêu Dầy 70x30 - 80g",50200,50200,0,0
TIKI,o-to-xe-may-xe-dap,14656137,"Nhớt Xe Số Motul H-Tech 100 4T 10W40 12x1l Vn (1L)",209000,209000,0,0
TIKI,o-to-xe-may-xe-dap,73515888,"Hộp đựng khăn giấy hình thú nhồi bông dễ thương , hộp đựng khăn giấy sáng tạo trên ô tô",189050,199000,9950,5
TIKI,o-to-xe-may-xe-dap,189588928,"Tủ lạnh ô tô Kemin K9A - 9L Chính Hãng- Dùng ở nhà và ô tô - Hai chiều nóng lạnh",1018000,1350000,332000,25
TIKI,o-to-xe-may-xe-dap,53296107,"Bảng Hiển Thị Số Điện Thoại Gắn Trên Taplo Xe Ô TÔ  Giúp Người Đi Đường Dễ Dàng Liên Hệ Với Bạn Khi Cần Thiết",10000,10000,0,0
TIKI,o-to-xe-may-xe-dap,48216836,"Bộ 5 tấm miếng che nắng ô tô",65000,65000,0,0
TIKI,o-to-xe-may-xe-dap,50451856,"Bạt Phủ Xe 3D Chống Nắng Xe Máy Tay Ga",98997,98997,0,0
TIKI,o-to-xe-may-xe-dap,57520399,"Bộ kích bình ắc quy dùng cho xe ô tô Baseus Super Energy Car Jump Starter",1500000,1500000,0,0
TIKI,o-to-xe-may-xe-dap,5755547,"Móc treo đồ titan dành cho xe máy",9000,9000,0,0
TIKI,o-to-xe-may-xe-dap,1254623,"Chai Xịt Chăm Sóc Da, Nội Thất Ô Tô- 3M Leather & Vinyl Restorer PN39040LT (400ml) - Đen",148000,165000,17000,10
TIKI,o-to-xe-may-xe-dap,23182365,"Bộ 2 Túi Đựng Đồ Lưng Ghế Ô Tô Da Cao Cấp YE-136",169000,169000,0,0
TIKI,o-to-xe-may-xe-dap,31984811,"Cây Thông Tạo Mùi Thơm Treo Trên Ô Tô",11000,11000,0,0
TIKI,o-to-xe-may-xe-dap,123561575,"Màn Hình Android Oled C2 chip TS18 chia đôi màn hình",2250000,2250000,0,0
TIKI,o-to-xe-may-xe-dap,51009122,"Nón bảo hiểm Royal kính âm M139 xanh lính",550000,700000,150000,21
TIKI,o-to-xe-may-xe-dap,171125271,"Mũ Bảo Hiểm 3/4 Đầu Royal M139 Kính Âm Thời Thượng Tiện Nghi - M",549000,700000,151000,22
TIKI,o-to-xe-may-xe-dap,20721745,"CẶP GƯƠNG CHIẾU HẬU GÙ TRÒN CÁN XOAY CRG GẮN NHIỀU LOẠI XE MÁY SIÊU ĐẸP - MÀU XANH ĐEN ( 1 CHIẾC BÊN TRÁI ) LOẠI 1",80000,89000,9000,10
TIKI,o-to-xe-may-xe-dap,127792464,"Bộ 4 Decal phản quang OPEN dán cửa oto cảnh báo an toàn, chống va chạm TÂM LUÂN Chổi lau tẩm dầu - Hàng chính hãng",19000,30000,11000,37
TIKI,o-to-xe-may-xe-dap,91474483,"Rổ hông xe Winner Exciter 135 150 155 Wave Sirius Jupiter Fi RSX Blade Green Networks Group ( 1 cái )",39000,39000,0,0
TIKI,o-to-xe-may-xe-dap,132351873,"(Nhiều Kích Thước )Decan dán xe chuột mickey dán trang trí bàn học, xe 4 chỗ, 7 chỗ, xe khách, xe tải, decal xe sắc nét",13000,13000,0,0
TIKI,o-to-xe-may-xe-dap,117202358,"Bọc yên xe đạp Gel cao cấp siêu êm",129000,129000,0,0
TIKI,o-to-xe-may-xe-dap,84870183,"Combo chai vệ sinh sên Megacools 500ml và xịt bảo dưỡng sên Megacools 300ml tặng bàn chải 3D cao cấp",165000,165000,0,0
TIKI,o-to-xe-may-xe-dap,80695685,"Bộ ốc dàn áo xe máy (Sirius,Wave Alpha,Wave A/Rs/S 100)",45000,45000,0,0
TIKI,o-to-xe-may-xe-dap,12064795,"Miếng tựa lưng ghế hạt gỗ massage cao cấp",99000,99000,0,0
TIKI,o-to-xe-may-xe-dap,12277440,"Tấm da treo ghế để giấy ăn, chai lọ tiện lợi giúp nội thất xe gọn gàng - màu ngẫu nhiên ",99000,99000,0,0
TIKI,o-to-xe-may-xe-dap,189574286,"Đèn LED hậu chớp nháy liên tục gắn cho mọi loại xe ô tô xe gắn máy",15000,15000,0,0
TIKI,o-to-xe-may-xe-dap,105525662,"Mũ bảo hiểm xe đạp thể thao Protec Win 037, tiêu chuẩn Châu Âu, an toàn, mạnh mẽ, vòng đầu từ 57-62cm",389000,459000,70000,15
TIKI,o-to-xe-may-xe-dap,87861406,"Chân chống titan cho Wave Dream Future Blade Cub Sirius Chân chống độ - Chất liệu inox dày",74000,74000,0,0
TIKI,o-to-xe-may-xe-dap,84543438,"Dè Chắn Bùn bản nhỏ có phản quang cho xe đạp City/Touring/ thể thao.",39000,55000,16000,29
TIKI,o-to-xe-may-xe-dap,105183798,"Gương gù bắt chân gương - thời trang nhỏ gọn cho xe máy SH, Vision, AB, Wave, Vario, Exciter",118750,118750,0,0
TIKI,o-to-xe-may-xe-dap,35236544,"KHÓA CHỐNG TRỘM XE MÁY CAO CẤP 2 KHIỂN",217550,229000,11450,5
TIKI,o-to-xe-may-xe-dap,132026986,"COMBO 2 chai xịt bọt tẩy vệ sinh nội thất xe ô tô đa năng Flamingo 650ml",119000,119000,0,0
TIKI,o-to-xe-may-xe-dap,68229894,"Máy phun sương tạo ẩm, xông tinh dầu mini dùng cho xe hơi Baseus Time Aromatherapy Humidifier (75ml , Alloy Air Humidifier Aroma for Car) - Hàng chính hãng",370025,389500,19475,5
TIKI,o-to-xe-may-xe-dap,150493215,"Đèn trợ sáng xe máy ô tô bi cầu XP60 cốt vàng pha trắng 2 màu mini siêu sáng tặng công tắc loại tốt",199000,199000,0,0
TIKI,o-to-xe-may-xe-dap,56046755,"Tấm Chắn Nắng Kính Lái Xe Ô Tô, Xe Hơi Chất Liệu Xốp Phủ Bạc",43000,43000,0,0
TIKI,o-to-xe-may-xe-dap,19699766,"Chong Chóng Mèo Doreamon Gắn Mũ Bảo Hiểm - Nhiều Màu",9000,9000,0,0
TIKI,o-to-xe-may-xe-dap,143170837,"Sáp Thơm Cafe Khử Mùi ô tô - Sáp Thơm Cốc Cà Phê Mocha Hàn Quốc",42000,42000,0,0
TIKI,o-to-xe-may-xe-dap,22152720,"BỘ VÁ XE ĐẠP, XE MÁY ",89000,100000,11000,11
TIKI,o-to-xe-may-xe-dap,105184009,"Gương xe máy tròn phẳng kiểu Vespa - cho tất cả xe máy",65550,65550,0,0
TIKI,o-to-xe-may-xe-dap,56206948,"Đồng Hồ Thương Hiệu Trang Trí Ô Tô Xe Hơi Sang Trọng",79000,79000,0,0
TIKI,o-to-xe-may-xe-dap,87789165,"Đệm Ghế Yên Sau Gắn Baga Xe Đạp Có Tựa Lưng An Toàn Cho Trẻ Em/ Trẻ Nhỏ MaiLee",142000,189000,47000,25
TIKI,o-to-xe-may-xe-dap,100256806,"Xe đạp Thống Nhất GN 06-24 - Hàng chính hãng",2130000,2130000,0,0
TIKI,o-to-xe-may-xe-dap,66740494,"DUNG DỊCH RỬA KHOANG MÁY, MÂM XE, KHUNG GẦM Ô TÔ KM20  [5 Lit]",322000,349000,27000,8
TIKI,o-to-xe-may-xe-dap,208206909,"Mũ bảo hiểm lỗ thông gió chính hãng NÓN SƠN TG-HG359",340000,650000,310000,48
TIKI,o-to-xe-may-xe-dap,23380848,"Giá kẹp điện thoại chống trộm, chống rung lắc cho xe máy",37550,37550,0,0
TIKI,o-to-xe-may-xe-dap,54719657,"Mũ Bảo Hiểm Trẻ Em 1/2 Đầu Có Kính Họa Tiết Siêu Anh Hùng Marvel CapTain American, An Toàn, Thời Trang, Nhẹ Nhàng, Chắc Chắn Protec Kitty - Hàng Chính Hãng",368000,442000,74000,17
TIKI,o-to-xe-may-xe-dap,112866031,"Đèn Xe Đạp Có Còi T6 350lumens (nút chạm cảm ứng) Pin 2000mAh Còi âm thanh lớn 140dB MaiLee",193000,209000,16000,8
TIKI,o-to-xe-may-xe-dap,42283206,"Khăn lau ô tô chuyên dụng Microfiber 3M 36x36cm",36000,39000,3000,8
TIKI,o-to-xe-may-xe-dap,184518754,"Sticker dán nắp xăng dầu, trang trí ô tô, xe tải",18000,18000,0,0
TIKI,o-to-xe-may-xe-dap,14756331,"Bọc vô lăng ô tô - Bọc vô lăng cao cấp - Bọc vô lăng",71000,71000,0,0
TIKI,o-to-xe-may-xe-dap,50561795,"HỘC ĐỰNG ĐỒ CHO XE AIRBLADE 2020",33000,33000,0,0
TIKI,o-to-xe-may-xe-dap,116016828,"(hàng mới về) Bình xịt tạo bọt tuyết rửa xe ô tô cầm tay 1.8 lít tiện dụng",248000,248000,0,0
TIKI,o-to-xe-may-xe-dap,69218770,"Bọc Vô Lăng Ô Tô Size 38 Bằng Da PU Cao Cấp VERSION 1",95000,95000,0,0
TIKI,o-to-xe-may-xe-dap,14506990,"Máy bơm lốp  ô tô, xe hơi STEEL MATE cài đặt được thông số bơm, tự ngắt khi đủ áp - Hàng nhập khẩu",435000,435000,0,0
TIKI,o-to-xe-may-xe-dap,86613770,"Bộ 2 Gù tay Lái INOX gắn mọi loại xe máy",72000,72000,0,0
TIKI,o-to-xe-may-xe-dap,45188578,"Đèn Led Xe Đạp, Đèn Hậu Cảnh Báo Xe Đạp Gắn Phía Sau Siêu Sáng Có Sạc Điện USB Chống Nước Giúp Đạp Xe An Toàn Ban Đêm 3 Màu Nhiều Chế Độ - Hàng Chính Hãng",111000,119000,8000,7
TIKI,o-to-xe-may-xe-dap,132351949,"(Chọn màu) Tem ĐÔI MẮT xe tải,trang trí dán xe tải, nắp capo, gương chiếu hậu, độc lạ, decal ô tô chất lượng cao",35000,35000,0,0
TIKI,o-to-xe-may-xe-dap,195621917,"ỐP KHOÁ TOYOTA Camry - Cross - Altis 2022",399000,399000,0,0
TIKI,o-to-xe-may-xe-dap,162528707,"Combo 8 Miếng Đệm Giảm Xóc Cách âm, Giảm lực đóng bảo vệ Ô Tô",39000,39000,0,0
TIKI,o-to-xe-may-xe-dap,82473369,"GỐI TỰA ĐẦU, TỰA LƯNG 3D CHẤT LIỆU CAO SU NON BỌC  DA TRÊN XE Ô TÔ - NHIỀU MÀU",125000,125000,0,0
TIKI,o-to-xe-may-xe-dap,58206719,"Chai vá lốp xe khẩn cấp Michelin 92423 / W32699 tặng kèm 1 móc khóa",312000,329000,17000,5
TIKI,o-to-xe-may-xe-dap,22373404,"Combo đèn pin + đèn chiếu hậu xe đạp tặng đèn led van xe",48264,48264,0,0
TIKI,o-to-xe-may-xe-dap,105525678,"Nón bảo hiểm xe đạp thể thao Protec Win 069 (WT 069), mũ bảo hiểm xe đạp sang trọng, Size L cho vòng đầu từ 58 đến 61cm",599000,750000,151000,20
TIKI,o-to-xe-may-xe-dap,131337900,"Găng Tay Sport Cụt Ngón, Đi Xe Máy Đi Phượt",45000,45000,0,0
TIKI,o-to-xe-may-xe-dap,57625930,"Bộ Khung Biển Số Trước & Sau Xe Ô tô Lá Cờ Inox 304 + Tặng 01 Móc Gắng Chìa Khóa Xe Ngẫu Nhiên",250000,250000,0,0
TIKI,o-to-xe-may-xe-dap,134230810,"Giá chở hàng - Baga xe máy đa năng dành cho các loại xe mở cốp không cần tháo",248000,248000,0,0
TIKI,o-to-xe-may-xe-dap,176417606,"[Vải Dù Dày Nặng 1kg]Bạt Phủ - Áo Trùm Xe Máy Cao Cấp Vải Dù 2 Mặt Che Nắng, Mưa Giữ Xe Luôn Như Mới Vừa Tất Cả Loại Xe",140000,140000,0,0
TIKI,o-to-xe-may-xe-dap,178089164,"Chai xịt tẩy rửa hợp kim nhôm, tẩy lốc máy, đầu bò, dàn chân xe máy, xịt sên SprayKing REPAIR 1000ml",65000,65000,0,0
TIKI,o-to-xe-may-xe-dap,24865306,"Mũ bảo hiểm GRS A368K",369000,369000,0,0
TIKI,o-to-xe-may-xe-dap,72623540,"Nón bảo hiểm 3/4 kính âm Royal M139 Đen vân carbon cao cấp Lót tháo rời, che hết mặt",499000,499000,0,0
TIKI,o-to-xe-may-xe-dap,73398588,"Nhớt động có Total Quartz 5000 10W40 (4 lít) - Dầu nhớt Total",379000,379000,0,0
TIKI,o-to-xe-may-xe-dap,170484247,"CẢNG SAU,BAGA SAU,NHÔM ĐÚC NGUYÊN KHỐI CHO WINNERX,WINNER EX150 EX155 EXCITER 150 EXCITER 155 SIÊU ĐẸP MALAY",179000,179000,0,0
TIKI,o-to-xe-may-xe-dap,72640260,"Mắt Kính Xe Đạp Thể Thao Phân Cực Chống Ánh Nắng (5 Mắt Kính) Chống Tia UV Cực Tím Ánh Nắng UV400 (Kèm hộp và phụ kiện, gọng phụ cho kính cận) Đạp Xe, Thể Thao Ngoài Trời, Câu Cá Mai Lee",189000,199000,10000,5
TIKI,o-to-xe-may-xe-dap,12123643,"Mũ Bảo Hiểm 3/4 Đầu Asia MT-115",304000,304000,0,0
TIKI,o-to-xe-may-xe-dap,68005711,"Nước rửa xe đậm đặc BZ Gloss Shampoo 1000ml",95000,95000,0,0
TIKI,o-to-xe-may-xe-dap,111589469,"Nón Bảo Hiểm Trẻ Em Nửa Đầu Protec KITTY, Họa Tiết Nữ Hoàng Băng Giá Elsa xinh xắn, Siêu Thoáng Khí",305000,358000,53000,15
TIKI,o-to-xe-may-xe-dap,150494093,"Đèn trợ sáng ô tô xe máy 16 tim led siêu sáng loại tốt",95000,95000,0,0
TIKI,o-to-xe-may-xe-dap,40567862,"Thảm sàn, lót sàn cao su không mùi Cao cấp dành cho xe Toyota Vios 2014-2019",458000,458000,0,0
TIKI,o-to-xe-may-xe-dap,73802977,"Giá Bình Nước Xe Đạp Siêu Nhẹ Gắn Khung Cho Xe Đạp Leo Núi, Thể Thao Giá Rẻ Bằng Nhựa Chất Lượng Cao Mai Lee",43000,69000,26000,38
TIKI,o-to-xe-may-xe-dap,115478671,"Nước Rửa Xe Sonax Gloss Shampoo 1000ml Chính Hãng Nhập Đức",139000,170000,31000,18
TIKI,o-to-xe-may-xe-dap,83348129,"Nón bảo hiểm 3/4 ROYAL M139 có kính âm V5 TRẮNG",565000,730000,165000,23
TIKI,o-to-xe-may-xe-dap,139289469,"Đầu bơm hơi lốp ô tô xe máy đa năng",34000,34000,0,0
TIKI,o-to-xe-may-xe-dap,35915397,"Chổi Lau Xe Rửa Vệ Sinh Ô Tô Điều Chỉnh Được Độ Dài Cao Cấp",58000,58000,0,0
TIKI,o-to-xe-may-xe-dap,7465245,"Bộ ổ khóa đĩa xe máy",35900,35900,0,0
TIKI,thoi-trang-nu,157055978,"Áo lót nữ đệm vừa áo ngực siêu nâng đẩy ngực tốt Lylylorem AL082",164000,164000,0,0
TIKI,thoi-trang-nu,84558773,"Áo khoác Hoodie Nỉ Lót Bông FUNNY Unisex, Áo khoác nỉ hoodie Funny unisex liền mũ, Áo hoodie cừu funny day , Áo hoodie nam nữ dáng tay phồng, form rộng in hình chú cừu xinh xắn, Hoodie cừu Dáng tay bồng mặc lên xinh xĩu, Áo hoodie cừu",100000,100000,0,0
TIKI,thoi-trang-nu,124489980,"Đồ ngủ sexy / Yếm ngủ không mút ngực, chất liệu phi mềm, kèm quần ren gợi cảm",59000,59000,0,0
TIKI,thoi-trang-nu,119125984,"Quần Ống Rộng Sapphire Blue Aaa Jeans",449000,449000,0,0
TIKI,thoi-trang-nu,120553436,"Bộ Đồ Ngủ Lụa 2 Dây Bèo Nhún Xẻ Cao Cách Điệu BDN07",219000,399000,180000,45
TIKI,thoi-trang-nu,45585251,"Áo Khoác Hoodie Nỉ Nữ Tay Dài Form Rộng In Hình Khủng Long Mũ Trùm Đầu Dễ Thương Phong Cách Hàn Quốc Chất Liệu Cao Cấp-Trắng",59000,59000,0,0
TIKI,thoi-trang-nu,101949563,"Quần lót nữ JONES cotton  ren 002",12000,12000,0,0
TIKI,thoi-trang-nu,68196229,"Váy Ngủ Ren Sexy Tặng Kèm Quần Chip  Lọt Khe",34000,90000,56000,62
TIKI,thoi-trang-nu,182148354,"Đầm ngủ body hai dây xuyên thấu kèm mút ngực sexy cao cấp Q305 - Váy ngủ ôm body sexy gợi cảm - Đồ ngủ nữ",139000,220000,81000,37
TIKI,thoi-trang-nu,108314567,"Quần Lót Nữ, Bộ 5 Quần Lót Nữ Phối Ren Cao Cấp Mềm Mịn, Quần Lót Nữ Kháng Khuẩn, Quần Lót Nữ Co Giãn Tốt Thương Hiệu Baw Mã QLN032",199000,199000,0,0
TIKI,thoi-trang-nu,59180714,"Quần lót lọt khe nữ buộc dây quyến rũ - Đen",29000,29000,0,0
TIKI,thoi-trang-nu,184638951,"Áo ngực nữ có gọng cực mềm nâng ngực cao cấp Lylylorem AL090",200000,200000,0,0
TIKI,thoi-trang-nu,83857418,"Áo khoác Hoodies tay phồng, Áo Hoodie Nỉ ERON, Áo Khoác Hoodie Nỉ In Chữ ERON Form Rộng 2 Màu Hồng Xanh Siêu, Áo hoodie nam / áo hooodie nữ / áo hoodie form rộng / áo khoác nam có nón trùm đầu / áo hoodie cặp đôi / áo khoác cặp đôi",100000,100000,0,0
TIKI,thoi-trang-nu,102394990,"Quần short nữ lưng cao, ngang đùi bằng vải cao cấp thoàng mát [ BEST SELLER ] Mặc thoải mái không kén tuổi, dễ phối đồ",135000,199000,64000,32
TIKI,thoi-trang-nu,111956514,"Quần short nữ , quần đùi nữ, chất đũi , big size 40-80kg , 8 màu siêu đẹp",39000,39000,0,0
TIKI,thoi-trang-nu,74389326,"Áo Ngực Nâng Ngực Ren Nữ Mút Dày 4cm Active Miley Lingerie - Trắng Kem BRL14001",257000,350000,93000,27
TIKI,thoi-trang-nu,136091102,"váy trễ vai trắng tay bồng dáng dài, đầm trễ vai tiểu thư dự tiệc màu trắng điệu đà",90000,90000,0,0
TIKI,thoi-trang-nu,84544002,"Áo Lót Bra Satin Bóng Trơn Dây Mảnh cao cấp thương hiệu BAW mã AN20",89000,89000,0,0
TIKI,thoi-trang-nu,122437275,"Quần lót ren gợi cảm sexy siêu mỏng xuyên thấu",35000,35000,0,0
TIKI,thoi-trang-nu,177272170,"Đồ bộ nữ quần ống suông áo sơ mi 2 túi sang trọng",165000,165000,0,0
TIKI,thoi-trang-nu,144933174,"Áo Hoodie Nam Nữ Unisex , Áo nỉ Sweater có Mũ 2 lớp cao cấp chui đầu Form Rộng Chất Liệu Nỉ Bông Trơn Nhiều Màu",59000,59000,0,0
TIKI,thoi-trang-nu,51580298,"Áo Sơ Mi Nữ Sọc Công Sở Cao Cấp",157000,157000,0,0
TIKI,thoi-trang-nu,104908173,"chân váy A dáng dài xếp ly phối 3 khuy chất tuyết mưa",115000,115000,0,0
TIKI,thoi-trang-nu,83765673,"Áo Ngực, Áo Lót Bra thiết kế khóa cài trước với đệm mút hình bàn tay có thể nâng đỡ ngực độc đáo quyến rũ Thương Hiệu Baw mă AN06",159000,159000,0,0
TIKI,thoi-trang-nu,113256243,"Quần ống rộng thô đũi cạp cao",71250,71250,0,0
TIKI,thoi-trang-nu,157431916,"Quần độn mông cạp cao đúc su Lylylorem QD04",300000,300000,0,0
TIKI,thoi-trang-nu,152783795,"Đồ Bộ BIGSIZE 2 Dây Nữ, Đồ Ngủ Sexy Nữ, Bộ Mặc Nhà Nữ lụa 100d tầng, freesize 45_75kg, tuỳ chiều cao",124000,124000,0,0
TIKI,thoi-trang-nu,51407838,"Đầm Suông Trung Niên Kiểu Đầm Suông BigSize In Hoa Lá Cột Eo GOTI 3285",295000,329000,34000,10
TIKI,thoi-trang-nu,141835496,"Áo thun tay lỡ form rộng unisex - Áo phông nam nữ oversize - T shirt The Band",79000,125000,46000,37
TIKI,thoi-trang-nu,82880654,"Áo Ngực Không Gọng, Áo Lót Bra Không Gọng dây mảnh Thương Hiệu Baw mã AN05",159000,159000,0,0
TIKI,thoi-trang-nu,124489767,"Đầm ngủ, váy ngủ phi không mút 2 dây viền ren 2 bên sexy quyến rũ 834",56000,56000,0,0
TIKI,thoi-trang-nu,116575084,"Quần ống rộng nữ,quần ống suông nữ chun lưng cúc khóa chất đũi kiểu hàn quốc",69000,69000,0,0
TIKI,thoi-trang-nu,148840283,"Chân váy ngắn công sở xẻ sau dáng chữ a Eva design vải umi cao cấp co giãn siêu xinh",149000,290000,141000,49
TIKI,thoi-trang-nu,78586004,"Đầm suông linen tay lỡ kèm đai rời ArcticHunter, thời trang thương hiệu chính hãng - Đỏ đô",250000,250000,0,0
TIKI,thoi-trang-nu,125502044,"Áo Khoác Thun Nỉ Bông Tay Dài Chống Nắng Sunday Nam nữ Cặp HOT RẺ ĐẸP Áo Hoodie Unisex kiểu Hàn Quốc Rộng Couple Jackets [ẢNH THẬT]Ư - HIÊN LINH SHOP ÁO KHOÁC HOODIE NỈ BÔNG",100000,100000,0,0
TIKI,thoi-trang-nu,74444966,"Áo Lót Nữ, Áo Bra Ren Su Đúc Azuno AZB85 Quai Bản To Mặc Mùa Hè Cực Mát, Thoải Mái",61000,61000,0,0
TIKI,thoi-trang-nu,85705020,"Áo Chống Nắng Nữ Cotton Laroma| UPF50+ | Vải Thơm | Làm Mát | Thời Trang | Đa Dụng",389000,569000,180000,32
TIKI,thoi-trang-nu,58067930,"Combo 7 Quần Lót Nữ Phối Ren Miley Lingerie Active FMM0205-2x0405-0905-2x1105-1205 - Giao màu ngẫu nhiên",240000,595000,355000,60
TIKI,thoi-trang-nu,87670396," Áo Khoác Nữ Chống Nắng Cao Cấp 6 Túi USSA [40-80kg",159000,159000,0,0
TIKI,thoi-trang-nu,84532478,"Áo Lót Bra dây chất liệu ren hoa lá siêu hót sang chảnh cho mùa hè thương hiệu BAW mã AN19",159000,159000,0,0
TIKI,lam-dep-suc-khoe,126689830,"Viên Uống Phụ Khoa- Men Vi Sinh Vùng Chữ Y LAVIMA BIOTIC",210000,210000,0,0
TIKI,lam-dep-suc-khoe,55890380,"Bộ 2 Kem đánh răng trẻ em Colgate Kid Free From 6-9 80g/tuýp",87000,104000,17000,16
TIKI,lam-dep-suc-khoe,272919105,"Khẩu Trang Trẻ Em Tenamyd Chính Hãng",62500,125000,62500,50
TIKI,lam-dep-suc-khoe,116522296,"HÀNG CHÍNH HÃNG- Cân điện tử Camry EB5681, trọng tải tối đa 150kg- Thiết kế sang trọng, hiện đại",179000,179000,0,0
TIKI,lam-dep-suc-khoe,68554897,"Gel Rửa Mặt La Roche-Posay Hỗ Trợ Giảm Mụn Cho Mặt & Toàn Thân Effaclar Micro-Peeling Purifying Gel 50Ml",41000,85000,44000,52
TIKI,lam-dep-suc-khoe,12084498,"Tẩy Tế Bào Chết Ngăn Ngừa Mụn Eucerin (100ml)",291000,389000,98000,25
TIKI,lam-dep-suc-khoe,8142273,"Kềm Cắt Da Thép Không Gỉ Kềm Nghĩa D-04(14)",175000,175000,0,0
TIKI,lam-dep-suc-khoe,3928213,"Kềm Cắt Móng Thép Chuyên Dụng M-205 Kềm Nghĩa",72200,76000,3800,5
TIKI,lam-dep-suc-khoe,198324072,"Dầu gội Matrix gội là đen - gội là nâu",27000,27000,0,0
TIKI,lam-dep-suc-khoe,74465822,"	 Nước Hoa Hồng Dr.Pepti+ Dưỡng Da Căng Bóng  Centella Toner (180ml )",315000,350000,35000,10
TIKI,lam-dep-suc-khoe,83349366,"Sữa tắm Palmolive Naturals chiết xuất 100% thiên nhiên 500g",99000,99000,0,0
TIKI,lam-dep-suc-khoe,108971623,"Băng quấn cổ chân đàn hồi Dr.MED DR-A135",155000,155000,0,0
TIKI,lam-dep-suc-khoe,120777637,"Protein Bar đến từ KIND - công ty bánh dinh dưỡng lớn nhất thế giới  : Hộp 12 thanh",435000,435000,0,0
TIKI,lam-dep-suc-khoe,58488552,"Tinh Dầu Hoa Anh Thảo Blackmores Evening Primrose Oil 190 viên - mẫu 2020",480000,480000,0,0
TIKI,lam-dep-suc-khoe,187845877,"Máy mát xa massage mini đa năng cầm tay 6 chế độ tặng kèm 4 đầu massage",127998,127998,0,0
TIKI,lam-dep-suc-khoe,16620681,"Bàn lăn gỗ massage chân 5x6",180000,180000,0,0
TIKI,lam-dep-suc-khoe,548110,"Sữa Tắm L'amont En Provence Cherry Blossom Shower Gel Hương Hoa Anh Đào Chai 500ml ",98100,149000,50900,34
TIKI,lam-dep-suc-khoe,270549724,"Xịt keo Ong Vitatree Super Propolis Spray Complex tăng sức đề kháng, kháng khuẩn, nấm, giảm viêm họng, ho, nhiệt miệng - QuaTangMe Extaste",122400,258000,135600,53
TIKI,lam-dep-suc-khoe,135266767,"Bộ 4 Kem đánh răng Colgate Maxfresh Bamboo Charcoal 225g kèm bàn chải lông tơ phủ than",190000,263000,73000,28
TIKI,lam-dep-suc-khoe,1628057,"Lăn khử mùi và giúp khô thoáng vùng da dưới cánh tay 48h Vichy 50ml",272000,320000,48000,15
TIKI,lam-dep-suc-khoe,63690465,"Combo 3 Hộp Bột Lá Nhuộm Tóc Ogatic Màu Nâu",280000,450000,170000,38
TIKI,lam-dep-suc-khoe,4354111,"Bột lá nhuộm tóc màu Nâu Đỏ Lá Móng Ogatic 50gr thảo dược",96000,150000,54000,36
TIKI,lam-dep-suc-khoe,113843414,"Máy Cạo Lông / Máy Tẩy Lông Không Dây Đời Mới Pin Lithium Tích Điện - Có Thời Gian Sử Dụng Liên Tục Trong 1 Giờ - Sạc Điện Bằng Cáp USB (Đã Bao Gồm) - Hàng Chính Hãng",182000,219000,37000,17
TIKI,lam-dep-suc-khoe,118124195,"Viên uống RITANA trắng da mờ sạm nám với L-Glutathion, Sakura, Pomegranate, P.Leucotomos, collagen (30 viên)",330000,330000,0,0
TIKI,lam-dep-suc-khoe,142904041,"Tinh Chất Phục Hồi, Cấp Ẩm Smas Pro Vitamin B5 Hydra Serum 120ml",465000,750000,285000,38
TIKI,lam-dep-suc-khoe,10770097,"Gel Dưỡng Da I’m From Vitamin Tree Water Gel",315000,315000,0,0
TIKI,lam-dep-suc-khoe,59476479,"Bao cao su Liebe kéo dài thời gian, gai nổi lớn - Hộp 12 cái",40000,40000,0,0
TIKI,lam-dep-suc-khoe,150718926,"COMBO bộ 9 Dụng Cụ day ấn Huyệt Mát xa toàn thân kiểu Thái (MH849) bằng gỗ Bách Xanh - Chăm sóc sức khỏe gia đình",189050,199000,9950,5
TIKI,lam-dep-suc-khoe,198102288,"Lăn khử mùi Perspirex Strong: khử mùi hôi nách và ngăn tiết mồ hôi loại mạnh",290000,290000,0,0
TIKI,lam-dep-suc-khoe,270813246,"Vitamin cho bà bầu Prenatal Folic Acid+ DHA Nature Made giúp mẹ khỏe, bé phát triển não bộ, hệ thần kinh và thể lực - QuaTangMe Extaste",794400,1664000,869600,52
TIKI,lam-dep-suc-khoe,73207101,"Mật ong nguyên chất - Mật hoa cafe (1L)",111000,111000,0,0
TIKI,lam-dep-suc-khoe,158222388,"Viên uống đẹp da Collagen Sắc Ngọc Khang 120 viên thế hệ mới giúp sáng da, giảm nếp nhăn - đốm nâu, nuôi dưỡng và làm đẹp da , tóc, móng",640000,730000,90000,12
TIKI,lam-dep-suc-khoe,73237382,"Dầu gội Head&Shoulders Bạc hà 1800ml",319000,319000,0,0
TIKI,lam-dep-suc-khoe,58916813,"Lăn Khử Mùi ETIAXIL Détranspirant Traitement Aisselles Peaux Normales 15ml (Dành Cho Da Thường) + Tặng 1 Móc Khóa Nhựa 2 Mặt",249000,320000,71000,22
TIKI,lam-dep-suc-khoe,89931480,"Bộ 3 chai Dung Dịch Vệ Sinh Phụ Nữ Lactacyd Odor Fresh Ngăn Mùi 24H 250ml/chai",243000,243000,0,0
TIKI,lam-dep-suc-khoe,74308679,"Máy Đo Đường Huyết Safe Accu Chính Hãng Sinocare Tặng Kèm 50 Que Thử+50 Kim Chích Máu",225000,360000,135000,38
TIKI,lam-dep-suc-khoe,75425181,"Set miếng dán móng cho bé gái đáng yêu – J007",8000,12000,4000,33
TIKI,lam-dep-suc-khoe,100265407,"Cao Gừng Nghệ Đỏ Thanh Lăn Tan Mỡ 180ml",240000,480000,240000,50
TIKI,lam-dep-suc-khoe,177518984,"Saffron mật ong Kingdom Herb chính hãng thượng hạng nguyên chất 100% hộp 311g (tặng que lấy mật và bình thuỷ tinh)",319000,629000,310000,49
TIKI,lam-dep-suc-khoe,158762711,"Combo hoàn hảo Oniiz - Bọt vệ sinh nam giới dung dịch tạo bọt mịn 100ml & Nước hoa nam giới THE PARIS & THE MIAMI 10ml",299000,299000,0,0
TIKI,o-to-xe-may-xe-dap,74385617,"Cây chống nâng yên xe máy tự động",46500,46500,0,0
TIKI,o-to-xe-may-xe-dap,128123890,"Bộ 2 Vè che mưa gương chiếu hậu ô tô hạn chế nước mưa đọng vào gương, gia tăng tầm nhìn TÂM LUÂN Chổi lau tẩm dầu - Hàng chính hãng",23000,50000,27000,54
TIKI,o-to-xe-may-xe-dap,53708171,"Đèn Pha Gắn Phía Trước Xe Đạp Siêu Sáng Sạc Điện USB Chống Nước (Bản Nâng Cấp Kèm Chân Đế Trượt) Mai Lee",120000,149000,29000,19
TIKI,o-to-xe-may-xe-dap,108937941,"Nón bảo hiểm Royal M139 Kính Âm Trơn Sành Điệu, Trẻ Trung, Thời Thượng",549000,700000,151000,22
TIKI,o-to-xe-may-xe-dap,125425768,"Mũ Bảo Hiểm Nửa Đầu Kính Ẩn ANDES 139 - Nhiều Màu",355000,440000,85000,19
TIKI,o-to-xe-may-xe-dap,13860493,"Hệ thống cảm biến đo áp suất lốp năng lượng mặt trời cho ô tô Michelin 4834",1599000,1599000,0,0
TIKI,o-to-xe-may-xe-dap,70815706,"Lót ghế và tựa lưng hạt gỗ ô tô văn phòng massage cao cấp chống nóng hiệu quả",348000,348000,0,0
TIKI,o-to-xe-may-xe-dap,83347203,"Nón bảo hiểm ANDES 109 có kính đi xe máy chính hãng",424000,500000,76000,15
TIKI,o-to-xe-may-xe-dap,53550107,"Đèn Pin Gắn Phía Trước Cho Xe Đạp Siêu Sáng Q5 Phóng Zoom To, Nhỏ Có Sạc Điện USB Chống Nước (kèm Chân Đế Gắn Đèn Pha) Giúp Đạp Xe Ban Đêm Mai Lee",94050,99000,4950,5
TIKI,o-to-xe-may-xe-dap,16147531,"Mũ Bảo Hiểm Nửa Đầu Có Kính SUNDA 136A",265000,265000,0,0
TIKI,o-to-xe-may-xe-dap,113404575,"Bộ 04 Chắn Bùn Cho Xe Ô Tô Toyota Vios",132000,132000,0,0
TIKI,o-to-xe-may-xe-dap,90326089,"Ba lô Treo Trước Xe Đạp Gắn Ghi Đông Xe Đạp Cho Du Lịch Đạp Xe Cất Trữ Phụ Kiện MaiLee ",217550,229000,11450,5
TIKI,o-to-xe-may-xe-dap,112363205,"Sạc Điện Thoại Trên Xe Máy",43400,43400,0,0
TIKI,o-to-xe-may-xe-dap,48898243,"Đèn Trợ Sáng Dành Cho Xe Máy LeD BulB L4 - CYT (Có Pát, Ốc Vít Và Công Tắc) ",49000,49000,0,0
TIKI,o-to-xe-may-xe-dap,150954569,"Nút cao su giảm chấn cánh cửa ô tô ,có dạ quang phát sáng đệm silicon chống va đập giảm tiếng ồn bảo vệ cửa, capo, cốp xe",9000,9000,0,0
TIKI,o-to-xe-may-xe-dap,83347589,"Lót nón bảo hiểm 3/4 Royal M139 gồm 1 lót và 2 ốp tai phiên bản mới",118000,150000,32000,21
TIKI,o-to-xe-may-xe-dap,115622558,"Cuộn nẹp mạ Chrome dán trang trí viền chân kính ô tô xe hơi dài 15M",53910,53910,0,0
TIKI,o-to-xe-may-xe-dap,32979033,"Bình dầu tay thắng BẢO LONG RACING",45000,45000,0,0
TIKI,o-to-xe-may-xe-dap,118089405,"Bộ 2 đèn led gắn van bánh xe đạp, xe máy",24200,24200,0,0
TIKI,o-to-xe-may-xe-dap,54902090,"Mũ bảo hiểm 3/4 Royal M139 kính âm đen nhám - Tháo lót được - Kèm balo rút chống trầy thương hiệu",499000,499000,0,0
TIKI,o-to-xe-may-xe-dap,10116626,"Chai xịt vệ sinh hệ thống điều hòa ô tô 3M 3M-ACC (250ml)",163000,175000,12000,7
TIKI,o-to-xe-may-xe-dap,55129703,"Mũ Bảo hiểm nửa đầu Bulldog Pug đủ màu",679000,679000,0,0
TIKI,o-to-xe-may-xe-dap,50255242,"Nón bảo hiểm 3/4 kính âm Royal M139 Vàng Cam Nhám tem V7 Cafe Racer cao cấp Lót tháo rời, che hết mặt",525000,525000,0,0
TIKI,o-to-xe-may-xe-dap,186621755,"Vietmap AP1 Máy lọc Không khí ô tô - Khử mùi iON -Diệt khuẩn- Lọc bụi PM2.5 - Tận hưởng cuộc sống xanh - Hàng Chính Hãng",1660000,1660000,0,0
TIKI,o-to-xe-may-xe-dap,50739908,"Bộ nhông sên dĩa xe Honda Wave RS / Wave A / Wave RSX / Wave S / Future Neo / Blade",290000,290000,0,0
TIKI,o-to-xe-may-xe-dap,176450514,"Chai xịt dạng bọt làm sạch bảo vệ khoang máy động cơ ô tô chuyên dụng Liqui Moly 21277 - Chống oxy hóa và ăn mòn, chống tĩnh điện, dùng được nhiều bề mặt, không để lại vết ố",150000,158000,8000,5
TIKI,o-to-xe-may-xe-dap,83347915,"Nón bảo hiểm nửa đầu ANDES có kính 126K chính hãng",427500,450000,22500,5
TIKI,o-to-xe-may-xe-dap,5348189,"Baga sau ngắn dành cho xe wave 110 ",104000,104000,0,0
TIKI,o-to-xe-may-xe-dap,132352332,"Decan sticker chữ Diesel Only 12x12cm",20000,20000,0,0
TIKI,o-to-xe-may-xe-dap,20723261,"CẶP GƯƠNG CHIẾU HẬU GÙ TRÒN CÁN XOAY CRG GẮN NHIỀU LOẠI XE MÁY SIÊU ĐẸP - MÀU VÀNG ĐEN ĐEN ( 1 CHIẾC BÊN TRÁI ) LOẠI 1",80750,85000,4250,5
TIKI,o-to-xe-may-xe-dap,44072283,"Củ sạc nhanh QC3.0 dành cho ô tô 4 cổng sạc",103550,109000,5450,5
TIKI,o-to-xe-may-xe-dap,170075709,"Bao da dành cho chìa khoá Toyota Veloz 2022, AVANZA 2022 handmade da thật 011",200000,200000,0,0
TIKI,o-to-xe-may-xe-dap,34845206,"Nước rửa xe bọt tuyết Car Shampoo 5 lít cho ô tô xe máy ",135000,135000,0,0
TIKI,o-to-xe-may-xe-dap,45354917,"Dây cáp khóa xe máy, xe đạp bọc nhựa chắc chắn tiện lợi",32975,32975,0,0
TIKI,o-to-xe-may-xe-dap,147855004,"Chổi Lau Xe Ô Tô, Xe Tải Xe Khách Làm Bằng Sợi Quang Dầu, Điều Chỉnh Được Độ Dài – Bộ Chổi Lau Bụi Xe Ô Tô Kèm Túi Đựng Cao Cấp Chính Hãng Dododios",69000,69000,0,0
TIKI,o-to-xe-may-xe-dap,126960262,"1 Đèn USB Nội Thất Xe Hơi Ô tô mini - Đèn LED USB Trang Trí Xe hơi  Ô tô (Size: 2x15x08cm)",35000,35000,0,0
TIKI,o-to-xe-may-xe-dap,14656147,"Nhớt Xe Tay Ga Motul Scooter Power Le 4t 5w40 20x0.8l Vn (800ml)",165000,165000,0,0
TIKI,o-to-xe-may-xe-dap,84883244,"Nón Bảo Hiểm Xe Đạp Thể Thao Hiện Đại, Siêu Phẩm Mũ Bảo Hiểm Xe Đạp Sang Trọng Protec Win 069, Size L Cho Vòng Đầu Từ 58 - 61cm - Hàng Chính Hãng",599000,780000,181000,23
TIKI,o-to-xe-may-xe-dap,105328552,"Combo 2 can Nước rửa xe bọt tuyết chuyên dụng Car Shampoo 5L cho ô tô xe máy",255000,255000,0,0
TIKI,o-to-xe-may-xe-dap,119962942,"Bình đun nước trên ô tô nguồn 12V và 24V inox thép không gỉ",210000,210000,0,0
TIKI,o-to-xe-may-xe-dap,145780366,"Bơm xe đạp xe máy xe hơi đạp chân di động có đồng hồ đo áp suất",129000,129000,0,0
TIKI,o-to-xe-may-xe-dap,139948369,"Khoá dây xe đạp xe máy 4 số chống trộm",50000,50000,0,0
TIKI,o-to-xe-may-xe-dap,143225953,"Bơm hợp kim nhôm loại đạp chân dùng cho xe đạp, xe máy, ô tô tặng kèm kim bơm banh và bơm thú hơi - Bơm đa năng",139000,139000,0,0
TIKI,o-to-xe-may-xe-dap,5314233,"Bộ túi thơm cà phê khử mùi treo xe ô tô kèm chai xịt tinh dầu Hàn Quốc",41082,41082,0,0
TIKI,o-to-xe-may-xe-dap,84447296,"Túi Treo Sườn Xe Đạp",35000,35000,0,0
TIKI,o-to-xe-may-xe-dap,118297778,"Bọc yên xe đạp GIANT loại dầy (Chính Hãng)",352800,352800,0,0
TIKI,o-to-xe-may-xe-dap,10704407,"Bộ Combo bảo dưỡng sên Thunder 400ml, rửa sên TS-40 450ml tặng kèm bản chải chà sên",119000,119000,0,0
TIKI,o-to-xe-may-xe-dap,2430315,"Súc Rửa Động Cơ Xe Máy Liqui Moly 7901 (80ml)",79000,79000,0,0
TIKI,o-to-xe-may-xe-dap,167981636,"Gói 100 viên bi sắt đủ kích cỡ",15000,15000,0,0
TIKI,o-to-xe-may-xe-dap,22474176,"Decal 3D Cacbon màu đen trang trí cho xe hơi, xe máy, điện thoại, máy tính ( 40 x 120 cm)",44000,44000,0,0
TIKI,o-to-xe-may-xe-dap,115622064,"Keo Dán Cường Lực 2 Mặt 3M VHB 4229P (nhiều size - cuộn dài 1.5 mét)",36000,36000,0,0
TIKI,o-to-xe-may-xe-dap,50701326,"Ghế ngồi cho trẻ dành cho xe Wave ",169000,169000,0,0
TIKI,o-to-xe-may-xe-dap,110146659,"Bộ Adapter Chuyển Đổi Điện AC 220V Sang DC 12V Dùng Cho Máy Bơm Máy Hút Bụi Ô Tô Xe Hơi 60W 100W",75999,75999,0,0
TIKI,o-to-xe-may-xe-dap,32593431,"Lưới ràng buộc hàng đồ xe máy và hành lý xe máy, xe mô tô 40x40cm Mai Lee - Hàng chính hãng",45600,48000,2400,5
TIKI,o-to-xe-may-xe-dap,1237293,"Chai Xịt Chống Rỉ, Chống Ẩm Bảo Dưỡng WD-40 (191ml)",85000,85000,0,0
TIKI,o-to-xe-may-xe-dap,51330433,"Bình cứu hỏa, chữa cháy cho ô tô nhiều dung tích",43800,43800,0,0
TIKI,o-to-xe-may-xe-dap,192628519,"Bao da Chìa Khóa ô tô kèm móc khóa Xe Suzuki XL7 - Mẫu Chìa Thông Minh",95000,95000,0,0
TIKI,o-to-xe-may-xe-dap,85804860," Bộ tựa đầu tựa lưng cao su non nguyên khối - bộ gối đầu tựa lưng trên ô tô",99000,99000,0,0
TIKI,o-to-xe-may-xe-dap,76106000,"SPRAYKING combo vệ sinh sên , dưỡng sên , dưỡng nhám",139000,139000,0,0
TIKI,o-to-xe-may-xe-dap,89402958,"Xích xe đạp - sên xe đạp - Chất liệu cao cấp",79000,79000,0,0
TIKI,o-to-xe-may-xe-dap,129224303,"Trợ sáng bi cầu mini cos vàng-pha trăng..nguồn nhôm dành cho xe máy",199000,199000,0,0
TIKI,o-to-xe-may-xe-dap,162592103,"Ắc quy Đèn sạc JP PA 6-4.5 | 6V - 4,5Ah",113000,113000,0,0
TIKI,o-to-xe-may-xe-dap,54675284,"Dung dịch vệ sinh buồng lái Michelin Dash & Trim cleaner 31463 - 650ml - Hàng chính hãng",152000,160000,8000,5
TIKI,o-to-xe-may-xe-dap,147975139,"Móc Treo Đồ Gài Sau Ghế Ô Tô, Móc Treo Đồ Tiện Dụng Sau Lưng Ghế Ô Tô, Xe Hơi",24900,24900,0,0
TIKI,o-to-xe-may-xe-dap,4312357,"Búa Thoát Hiểm Đa Năng",79000,79000,0,0
TIKI,o-to-xe-may-xe-dap,80850054,"Combo 2 Khăn lau xe chuyên dụng Microfiber siêu thấm không bị sơ, rối sử dụng cho ô tô - xe hơi kích thước 30x60",25900,25900,0,0
TIKI,o-to-xe-may-xe-dap,81508747,"Ống bơm hơi điện tử mini YANTU A05 không dây dành cho ô tô xe máy xe đạp Hàng chính hãng",711550,749000,37450,5
TIKI,o-to-xe-may-xe-dap,58523167,"Bình Xịt Vệ Sinh Điều Hòa Ô Tô - Flamingo",112000,112000,0,0
TIKI,o-to-xe-may-xe-dap,120220101,"Bộ 4 viên pin đồng xu CR1632-3V pin cảm biến áp suất lốp pin chìa khóa ô tô",25000,25000,0,0
TIKI,o-to-xe-may-xe-dap,11053096,"Tẩu sạc ô tô kiêm nghe nhạc MP3, kết nối điện thoại qua bluetooth, kết nối dàn âm thanh trên xe qua sóng FM",67000,67000,0,0
TIKI,o-to-xe-may-xe-dap,4697159,"Máy Lọc Không Khí Ô TÔ BONECO P50 màu Trắng Khử mùi thuốc lá hiệu quả - Hàng Nhập Khẩu",2860000,2860000,0,0
TIKI,o-to-xe-may-xe-dap,176147975,"COMBO Mũ Bảo Hiểm 1/2 Napoli Haley N120 Kèm Kính Phi Công ( 55-58cm) - Bảo hành 12 tháng",299000,299000,0,0
TIKI,o-to-xe-may-xe-dap,59548143,"Bơm lốp Ô tô Baseus Inflator Pump Energy Source ( phiên bản mới 2020 ) Baseus CRCQB02",870000,939000,69000,7
TIKI,o-to-xe-may-xe-dap,55362664,"Túi treo đầu xe máy vải bố mẫu đứng, túi ghi đông treo đầu xe máy chuyên dụng cho Grap,Goviet, bee anh em xe ôm công nghệ",85000,85000,0,0
TIKI,o-to-xe-may-xe-dap,121397854,"Găng tay rửa xe ô tô san hô siêu mềm mịn tiện dụng",15000,15000,0,0
TIKI,o-to-xe-may-xe-dap,5757605,"Mũ bảo Hiểm Royal M139 Kính Âm",550000,700000,150000,21
TIKI,o-to-xe-may-xe-dap,42738449," Thùng Rác Gấp Gọn Trên Xe Hơi Tiện Dụng",29000,29000,0,0
TIKI,o-to-xe-may-xe-dap,54013356,"bao tay daytuna dành cho xe máy",30000,30000,0,0
TIKI,o-to-xe-may-xe-dap,54675045,"Dung Dịch Làm Sạch & Bảo Dưỡng Da  Michelin Leather Cleaner 32187-250Ml Hàng Chính Hãng",121000,170000,49000,29
TIKI,o-to-xe-may-xe-dap,124113000,"Biển số titan 7 màu kèm ốp inox và mica Hàng Loại 1 Dày Dặn Dành Cho Xe Máy",58000,58000,0,0
TIKI,o-to-xe-may-xe-dap,46578885,"Nước Rửa Xe Không Chạm Đặc Biệt T-rex 80 Ekokemika - (1l) - Hàng Chính Hãng",182000,208000,26000,13
TIKI,o-to-xe-may-xe-dap,75831153,"Phục hồi nhựa nhám SPRAYKING - Chất lượng cao",50000,50000,0,0
TIKI,o-to-xe-may-xe-dap,158492480,"Nón bảo hiểm nửa đầu Gro ST04 phong cách, màu sắc trẻ trung cho nam nữ,  hai mẫu kính an toàn, thời trang- Hàng chính hãng",245000,335000,90000,27
TIKI,o-to-xe-may-xe-dap,101425351,"[CHÍNH HÃNG] XWash - Xịt tẩy rửa, khử mùi nội thất ô tô KHÔNG HÓA CHẤT  - Tặng khăn lông cừu cao cấp",599000,599000,0,0
TIKI,o-to-xe-may-xe-dap,119719081,"Ắc quy khô GS GTZ5S 3,5Ah Wave RS Rsx Rsv S, Nouvo456, Airblade110, Hayate X-Bike SKY Exciter Luvias Cub acquy Yuasa",320000,320000,0,0
TIKI,o-to-xe-may-xe-dap,142442642,"Bộ Dụng Cụ Sữa Chữa Xe Đạp Chuyên Dụng - Dụng Cụ Mở Xích Xe Đạp , Mở Căm Xe Đạp Chuyên Dụng Tiện Dụng 6 món",247000,247000,0,0
TIKI,o-to-xe-may-xe-dap,72537637,"Tẩu Chuyển Đổi Dòng Điện 12V sang 220V Trong Xe Ô Tô ",223250,235000,11750,5
TIKI,o-to-xe-may-xe-dap,37862107,"Bộ Tem Hợp Kim Nhôm Cao Cấp Trang Trí Ô Tô, Xe Máy  - Cờ Đức",29000,45000,16000,36
TIKI,o-to-xe-may-xe-dap,178531102,"[Giá 1 đôi]Ốc chân gương hình mặt cười, ốc chân kính cho xe máy nhiều màu lựa chọn-OCG",11400,12000,600,5
TIKI,o-to-xe-may-xe-dap,10711088,"Giá Đỡ Điện Thoại Xe Ô Tô Thông Minh Longneck",37521,51278,13757,27
TIKI,o-to-xe-may-xe-dap,11787164,"Bọc vô lăng cao cấp ô tô mẫu VL012",95000,95000,0,0
TIKI,o-to-xe-may-xe-dap,110821447,"Bút thử điện ô tô 6V - 12V - 24V bóng led",39000,55000,16000,29
TIKI,o-to-xe-may-xe-dap,90463152,"Cặp Đèn xi nhan mini 3 led sáng vàng dành cho các dòng xe winner X, ex 150, NVX, MSX, CBR",83990,83990,0,0
TIKI,o-to-xe-may-xe-dap,54566742,"Chân chỗng xe đạp - Tặng kèm chuông CC01",64900,64900,0,0
TIKI,o-to-xe-may-xe-dap,48248904,"TẤM LƯỚI TỰA LƯNG GHẾ Ô TÔ HẠT GỖ MẪU 1",95000,99000,4000,4
TIKI,o-to-xe-may-xe-dap,1237305,"Chai Xịt Dưỡng Sên Thunder Chain Lube (400ml)",55000,55000,0,0
TIKI,o-to-xe-may-xe-dap,184593239,"1 CHAI KEO CHUYÊN XỬ LÝ CÁC VẾT NỨT VỠ KÍNH CHẮN GIÓ XE HƠI ÔTÔ CHUYÊN NGHIỆP LÀM LÀNH NHƯ MỚI HÀNG CAO CẤP",128000,128000,0,0
TIKI,o-to-xe-may-xe-dap,1176295,"Chai Phục Hồi, Làm Mới Nhựa Ngoài Liqui Moly 1552 (250ml)",206000,219000,13000,6
TIKI,o-to-xe-may-xe-dap,168563284,"Túi treo điện thoại đúng Sunha gắn đầu xe máy bằng chất liệu vải bố chuyên dụng Sunha SIGATO SGT 3679",74000,74000,0,0
TIKI,o-to-xe-may-xe-dap,119695037,"Nút dán giảm lực đóng bảo vệ cửa xe ô tô, miếng dán Silicon bảo vệ cửa ô tô",4000,4000,0,0
TIKI,o-to-xe-may-xe-dap,16991782,"Bình xịt tạo bọt tuyết rửa xe",300000,300000,0,0
TIKI,o-to-xe-may-xe-dap,135111875,"Bảng ghi số trên ô tô tự động phát sáng khi trời tối, miếng hít dính chắc chắn TÂM LUÂN Chổi lau tẩm dầu - Hàng chính hãng",20000,30000,10000,33
TIKI,o-to-xe-may-xe-dap,206623766,"Thảm lót sàn ô tô KATA cho xe Hyundai Creta (2022-2023) - Khít với sàn xe, Chống trơn, Không mùi, Không ẩm mốc",1990000,1990000,0,0
TIKI,o-to-xe-may-xe-dap,48246569,"Búa Thoát Hiểm Thông Minh Chuyên Dụng Cho Ô Tô",105000,105000,0,0
TIKI,o-to-xe-may-xe-dap,52504811,"Cuộn cacbon dán cốp, dán bước chân chống xước xe hơi, ô tô",134000,134000,0,0
TIKI,o-to-xe-may-xe-dap,137523906,"Thùng Xăng Dự Phòng An Toàn Mastersea Úc. Dung Tích 5 Lít. Chống Va Đập, Chống Bay Hơi Xăng. Siêu an toàn",550000,550000,0,0
TIKI,o-to-xe-may-xe-dap,108198041,"[TẶNG ỐC CHÂN KÍNH] Gương chiếu hậu Rizoma 5 cạnh nhôm CNC  Màu Đỏ dành cho các loại xe máy siêu chất - TKA-DG66do",115000,187200,72200,39
TIKI,o-to-xe-may-xe-dap,85805399,"Thảm lót sàn ô tô - thảm sàn xe 4-5 chỗ cao su loại 1",263000,263000,0,0
TIKI,o-to-xe-may-xe-dap,1378123,"Găng Tay Chống Cắt 3M Cấp Độ 5 Cut Resistant Gloves",113000,126000,13000,10
TIKI,o-to-xe-may-xe-dap,55480529,"Dụng cụ móc đá lốp xe đa năng 5 trong 1",38899,38899,0,0
TIKI,o-to-xe-may-xe-dap,108925554,"Nón bảo hiểm 3/4 cao cấp Royal M20C Thời trang, Cá tính, Bảo hành chính hãng 12 tháng",449000,550000,101000,18
TIKI,o-to-xe-may-xe-dap,72909593,"Găng tay phượt Blackhawk dài ngón găng tay bảo hộ xe máy",115000,115000,0,0
TIKI,o-to-xe-may-xe-dap,50456405,"Bảng Số Điện Thoại Gắn Taplo Ô Tô Đa Năng ",26000,26000,0,0
TIKI,o-to-xe-may-xe-dap,192715269,"Đệm Ngồi 3D Nệm Lót Ghế Gel Silicon Tổ Ong Cao Cấp Thoáng Khí Chống Đau Mỏi 220",87998,87998,0,0
TIKI,o-to-xe-may-xe-dap,53772645,"Nẹp U Lõi Thép Gioăng Cao Su CHữ U Lõi Thép - Nẹp U Viền Cửa Xe Chống Va Đập Cuộn 15m",113800,113800,0,0
TIKI,o-to-xe-may-xe-dap,46555782,"Đầu vòi bơm oto xe máy - Kiêm đồng hồ đo áp suất lốp - Hàng nhập khẩu",108000,108000,0,0
TIKI,o-to-xe-may-xe-dap,161524240,"Tẩy ố kính ô tô TOKO 60, không cháy kính, làm sạch ố mốc kính, ố 7 màu, cặn canxi | Lựa chọn hàng đầu của GARAGE, Chăm sóc xe",149000,270000,121000,45
TIKI,o-to-xe-may-xe-dap,52114119,"Bạt Phủ Xe Ô tô 7 chỗ Innova, Bạt Che Xe, Trùm Xe Hơi ",324000,324000,0,0
TIKI,o-to-xe-may-xe-dap,130287501,"Chống Xe Đạp Thể Thao - Xe Đạp Đường Phố Soldier - Chất Liệu Nhôm Chắc Chắn - Kiểu Dáng Hiện Đại (tặng kèm lục giác để lắp sản phẩm)",78000,78000,0,0
TIKI,o-to-xe-may-xe-dap,78895833,"Đệm lót ghế ô tô hạt gỗ Pơ Mu 100% tự nhiên tựa lưng massage trên ô tô - Dạng Cài Đàn - Kích thước: 1,25x0,46m - Trọng lượng: 2,7Kg - Mã: PM-D",249900,249900,0,0
TIKI,thoi-trang-nu,57942548,"Đồ Bơi Tay Dài Chống Nắng Lưng Áo Cao Váy Xòe AT188 MayHomes, Thun Lạnh Co Giãn Tốt, Bền Chắc",216000,239000,23000,10
TIKI,thoi-trang-nu,72225788,"Áo Ngực Sớ Gỗ Không Gọng Lưng Logo Sporty Chic Miley Lingerie BRW",180000,330000,150000,45
TIKI,thoi-trang-nu,86873994,"set 10 quần lót su đúc thông hơi cao cấp nữ",125500,125500,0,0
TIKI,thoi-trang-nu,109224752,"Jumpsuit (Áo Liền Quần) Lụa Cổ Tròn Tay Ngắn Sang Trọng",390000,390000,0,0
TIKI,thoi-trang-nu,176881225,"Đồ Bơi Nữ Tay Dài Quần Ôm Thân Tôn Dáng AT221 MayHomes Long Sleeves And Long Pants Women Swimwear Set With UPF 50 Sun Protection",341050,359000,17950,5
TIKI,thoi-trang-nu,189737693,"Quần Lót Lọt Khe Su Đúc Không Đường May Không Lộ Viền Gợi Cảm Quyến Rũ Sexy Q7",20500,22500,2000,9
TIKI,thoi-trang-nu,155924226,"Quần Gen Bụng Cạp Cao Định Hình Chống Cuộn Lylylorem QG05- HÀNG CHÍNH HÃNG",310000,310000,0,0
TIKI,thoi-trang-nu,181248536,"Áo Phông Áo Thun From Rộng Tay Lỡ Cổ Tròn Vải Cotton Co Dãn Unisex Liarry's Nam Nữ",244000,244000,0,0
TIKI,thoi-trang-nu,97732361,"Bộ 5 Quần Lót Nữ Cotton Lót May Chống Viêm, Quần Chip Nữ Kháng Khuẩn Cao Cấp Thương Hiệu BAW NT737",199000,199000,0,0
TIKI,thoi-trang-nu,174888263,"Quần dài suông ống rộng mặc nhà mùa hè chất vải cotton lụa thoáng mát thoải mái mã Q0271",89000,89000,0,0
TIKI,thoi-trang-nu,58493562,"Combo 2 Quần Lót Nữ Lưng Cao Modal Phối Ren Active Miley Lingerie Màu Da & Hồng FDS0925-1225",132000,190000,58000,31
TIKI,thoi-trang-nu,181248217,"Quần Lót Cotton Sợi Tăm Tre Viền Ren Đính Nơ Thông Hơi Xuất Nhật Sexy Quyễn Rũ",28000,28000,0,0
TIKI,thoi-trang-nu,181247581,"Quần Legging Cạp Cao Lót Lông Mùa Đông Nâng Ôm Mông Cạp Chéo Dấu Bụng Hàng Loại 1 Đẹp",285000,325000,40000,12
TIKI,thoi-trang-nu,101132256,"Áo lót liner corset chuẩn",43000,43000,0,0
TIKI,thoi-trang-nu,193910202,"Hộp 2 Miếng Dán Ngực Nhủ Hoa Silicon Siêu Dính Dễ Thương Thoải Mái Tiện  Lợi Tái Sử Dụng Nhiều Lần",25000,25000,0,0
TIKI,thoi-trang-nu,42869288,"Combo 2 Quần Lót Nữ Mặc Trong Váy Có Túi Bên - 5Star",78000,78000,0,0
TIKI,thoi-trang-nu,105192727,"Dây áo trong suốt - Dây vai trong áo ngực nữ Triumph",35000,40000,5000,13
TIKI,thoi-trang-nu,103431559,"Quần ống rộng nữ 1 cúc trước chất tuyết mưa nhiều màu tự nhiên",85000,85000,0,0
TIKI,thoi-trang-nu,41588409,"Áo nữ, kiểu dáng hoodie, chất liệu nỉ, freesize dưới 55kg 1m60, nhiều màu họa tiết khủng long béo, hàng chất lượng",108000,108000,0,0
TIKI,thoi-trang-nu,181247724,"Áo Lót Đúc Su Nâng Ngực Không Gọng Xuất Nhật Áo Ngực Đệ Thông Hơi Chống Ung Thư",65000,65000,0,0
TIKI,thoi-trang-nu,107036163,"Đồ Lam Đi Chùa # Mẫu Thun Phối",152150,152150,0,0
TIKI,thoi-trang-nu,84487723,"Áo Ngực Bra 3 dây cotton có đệm mặc thoáng mát thương hiêu BAW mã AN18",159000,159000,0,0
TIKI,thoi-trang-nu,175151515,"Váy ngủ choàng kimono in hoa cao cấp Q418 - Áo choàng ngủ sexy gợi cảm - Đầm ngủ nữ - Đồ ngủ mạc nhà",149000,210000,61000,29
TIKI,thoi-trang-nu,97755383,"Áo lót phối ren đệm dày siêu nâng ngực, áo ngực tạo khe quyến rũ thương hiệu BAW NT740",159000,159000,0,0
TIKI,thoi-trang-nu,88913284,"Quần short nữ , quần đùi nữ vải đũi có bigsize 40-80kg,lưng chun, ống rộng thoải mái , form rất đẹp️",75000,150000,75000,50
TIKI,thoi-trang-nu,13893263,"Áo khoác nữ thoát nhiệt Nhật Bản GOKING, 6 túi to tiện dụng. Áo chống nắng nhẹ, vải thun 100% cotton thoáng mát, thấm hút mồ hôi",275000,275000,0,0
TIKI,thoi-trang-nu,79437188,"Combo 5 Quần Lót Nữ Thun Lạnh Phối Ren Trước",294000,475000,181000,38
TIKI,thoi-trang-nu,116577315,"Quần ống rộng nữ, quần culottes nữ chất đũi chun lưng cúc khóa dáng lỡ",65000,65000,0,0
TIKI,thoi-trang-nu,107056436,"Áo ngực có gọng mút dày cài trước iBasic VA149",279000,279000,0,0
TIKI,thoi-trang-nu,34316617,"Siêu giảm giá. Áo phông trơn GOKING form ôm đẹp cho nữ, chất liệu thun 100% cotton siêu thoáng mát. Áo phông nữ hàng hiệu cao cấp",99000,99000,0,0
TIKI,thoi-trang-nu,146636028,"Áo kiểu nữ đẹp, chất liệu Đũi, vải mềm mát, thấm mồ hôi, áo kiểu form rộng, áo kiểu nữ Hàn Quốc NeSa Shop. AKH.46",145000,229000,84000,37
TIKI,thoi-trang-nu,68201195,"Áo Ngực Nữ Cotton Không Gọng Miley Lingerie - Màu Trắng Kem BRW02115",199000,290000,91000,31
TIKI,thoi-trang-nu,132815390,"Quần Bơi Nữ 2 Lớp Layer Legging Women Sobie",365500,430000,64500,15
TIKI,thoi-trang-nu,21753390,"Quần jean nữ cạp cao vải co giãn mềm mại- Xanh đen",105000,105000,0,0
TIKI,thoi-trang-nu,170276357,"VÁY LÓT VÁY THUN HAI DÂY ĐẦM LÓT",70000,70000,0,0
TIKI,thoi-trang-nu,195849938,"Áo Vest Croptop Nữ Dáng Ngắn Cá Tính Áo khoác Blazer Nữ Chất Tuyết Mưa Cao Cấp Hàng Thiết Kế Tay Lỡ Phong Cách Hàn Quốc",169000,300000,131000,44
TIKI,thoi-trang-nu,53549767,"Áo Sơ Mi Nữ Áo Nữ Áo Kiểu Phối Ren Hành Chính (42-65kg) - N615",158000,158000,0,0
TIKI,thoi-trang-nu,73487627,"Đồ Bơi Nữ Hai Mảnh Bigsize Kèm Áo Lưới AT198 MayHomes Cho Cân Nặng 67Kg-85Kg",199000,199000,0,0
TIKI,thoi-trang-nu,176021615,"Áo bralette ren iBasic BRAY042",183000,359000,176000,49
TIKI,thoi-trang-nu,118017395,"Đồ Lam Đi Chùa# Lãnh Tụ Nam Nữ # Đồ Bộ Nam Nữ # Quần Áo Nam Nữ",166578,166578,0,0
TIKI,lam-dep-suc-khoe,57942548,"Đồ Bơi Tay Dài Chống Nắng Lưng Áo Cao Váy Xòe AT188 MayHomes, Thun Lạnh Co Giãn Tốt, Bền Chắc",216000,239000,23000,10
TIKI,lam-dep-suc-khoe,72225788,"Áo Ngực Sớ Gỗ Không Gọng Lưng Logo Sporty Chic Miley Lingerie BRW",180000,330000,150000,45
TIKI,lam-dep-suc-khoe,109224752,"Jumpsuit (Áo Liền Quần) Lụa Cổ Tròn Tay Ngắn Sang Trọng",390000,390000,0,0
TIKI,lam-dep-suc-khoe,176881225,"Đồ Bơi Nữ Tay Dài Quần Ôm Thân Tôn Dáng AT221 MayHomes Long Sleeves And Long Pants Women Swimwear Set With UPF 50 Sun Protection",341050,359000,17950,5
TIKI,lam-dep-suc-khoe,155924226,"Quần Gen Bụng Cạp Cao Định Hình Chống Cuộn Lylylorem QG05- HÀNG CHÍNH HÃNG",310000,310000,0,0
TIKI,lam-dep-suc-khoe,86873994,"set 10 quần lót su đúc thông hơi cao cấp nữ",125500,125500,0,0
TIKI,lam-dep-suc-khoe,97732361,"Bộ 5 Quần Lót Nữ Cotton Lót May Chống Viêm, Quần Chip Nữ Kháng Khuẩn Cao Cấp Thương Hiệu BAW NT737",199000,199000,0,0
TIKI,lam-dep-suc-khoe,193910202,"Hộp 2 Miếng Dán Ngực Nhủ Hoa Silicon Siêu Dính Dễ Thương Thoải Mái Tiện  Lợi Tái Sử Dụng Nhiều Lần",25000,25000,0,0
TIKI,lam-dep-suc-khoe,189737693,"Quần Lót Lọt Khe Su Đúc Không Đường May Không Lộ Viền Gợi Cảm Quyến Rũ Sexy Q7",20500,22500,2000,9
TIKI,lam-dep-suc-khoe,79437188,"Combo 5 Quần Lót Nữ Thun Lạnh Phối Ren Trước",294000,475000,181000,38
TIKI,lam-dep-suc-khoe,58493562,"Combo 2 Quần Lót Nữ Lưng Cao Modal Phối Ren Active Miley Lingerie Màu Da & Hồng FDS0925-1225",132000,190000,58000,31
TIKI,lam-dep-suc-khoe,42869288,"Combo 2 Quần Lót Nữ Mặc Trong Váy Có Túi Bên - 5Star",78000,78000,0,0
TIKI,lam-dep-suc-khoe,181248217,"Quần Lót Cotton Sợi Tăm Tre Viền Ren Đính Nơ Thông Hơi Xuất Nhật Sexy Quyễn Rũ",28000,28000,0,0
TIKI,lam-dep-suc-khoe,181247581,"Quần Legging Cạp Cao Lót Lông Mùa Đông Nâng Ôm Mông Cạp Chéo Dấu Bụng Hàng Loại 1 Đẹp",285000,325000,40000,12
TIKI,lam-dep-suc-khoe,195849938,"Áo Vest Croptop Nữ Dáng Ngắn Cá Tính Áo khoác Blazer Nữ Chất Tuyết Mưa Cao Cấp Hàng Thiết Kế Tay Lỡ Phong Cách Hàn Quốc",169000,300000,131000,44
TIKI,lam-dep-suc-khoe,181248536,"Áo Phông Áo Thun From Rộng Tay Lỡ Cổ Tròn Vải Cotton Co Dãn Unisex Liarry's Nam Nữ",244000,244000,0,0
TIKI,lam-dep-suc-khoe,107036163,"Đồ Lam Đi Chùa # Mẫu Thun Phối",152150,152150,0,0
TIKI,lam-dep-suc-khoe,181247724,"Áo Lót Đúc Su Nâng Ngực Không Gọng Xuất Nhật Áo Ngực Đệ Thông Hơi Chống Ung Thư",65000,65000,0,0
TIKI,lam-dep-suc-khoe,116577315,"Quần ống rộng nữ, quần culottes nữ chất đũi chun lưng cúc khóa dáng lỡ",65000,65000,0,0
TIKI,lam-dep-suc-khoe,176021615,"Áo bralette ren iBasic BRAY042",183000,359000,176000,49
TIKI,lam-dep-suc-khoe,68201195,"Áo Ngực Nữ Cotton Không Gọng Miley Lingerie - Màu Trắng Kem BRW02115",199000,290000,91000,31
TIKI,lam-dep-suc-khoe,175151515,"Váy ngủ choàng kimono in hoa cao cấp Q418 - Áo choàng ngủ sexy gợi cảm - Đầm ngủ nữ - Đồ ngủ mạc nhà",149000,210000,61000,29
TIKI,lam-dep-suc-khoe,170276357,"VÁY LÓT VÁY THUN HAI DÂY ĐẦM LÓT",70000,70000,0,0
TIKI,lam-dep-suc-khoe,97755383,"Áo lót phối ren đệm dày siêu nâng ngực, áo ngực tạo khe quyến rũ thương hiệu BAW NT740",159000,159000,0,0
TIKI,lam-dep-suc-khoe,174888263,"Quần dài suông ống rộng mặc nhà mùa hè chất vải cotton lụa thoáng mát thoải mái mã Q0271",89000,89000,0,0
TIKI,lam-dep-suc-khoe,13893263,"Áo khoác nữ thoát nhiệt Nhật Bản GOKING, 6 túi to tiện dụng. Áo chống nắng nhẹ, vải thun 100% cotton thoáng mát, thấm hút mồ hôi",275000,275000,0,0
TIKI,lam-dep-suc-khoe,88913284,"Quần short nữ , quần đùi nữ vải đũi có bigsize 40-80kg,lưng chun, ống rộng thoải mái , form rất đẹp️",75000,150000,75000,50
TIKI,lam-dep-suc-khoe,103431559,"Quần ống rộng nữ 1 cúc trước chất tuyết mưa nhiều màu tự nhiên",85000,85000,0,0
TIKI,lam-dep-suc-khoe,84487723,"Áo Ngực Bra 3 dây cotton có đệm mặc thoáng mát thương hiêu BAW mã AN18",159000,159000,0,0
TIKI,lam-dep-suc-khoe,73487627,"Đồ Bơi Nữ Hai Mảnh Bigsize Kèm Áo Lưới AT198 MayHomes Cho Cân Nặng 67Kg-85Kg",199000,199000,0,0
TIKI,lam-dep-suc-khoe,41588409,"Áo nữ, kiểu dáng hoodie, chất liệu nỉ, freesize dưới 55kg 1m60, nhiều màu họa tiết khủng long béo, hàng chất lượng",108000,108000,0,0
TIKI,lam-dep-suc-khoe,53549767,"Áo Sơ Mi Nữ Áo Nữ Áo Kiểu Phối Ren Hành Chính (42-65kg) - N615",158000,158000,0,0
TIKI,lam-dep-suc-khoe,146636028,"Áo kiểu nữ đẹp, chất liệu Đũi, vải mềm mát, thấm mồ hôi, áo kiểu form rộng, áo kiểu nữ Hàn Quốc NeSa Shop. AKH.46",145000,229000,84000,37
TIKI,lam-dep-suc-khoe,105192727,"Dây áo trong suốt - Dây vai trong áo ngực nữ Triumph",35000,40000,5000,13
TIKI,lam-dep-suc-khoe,21753390,"Quần jean nữ cạp cao vải co giãn mềm mại- Xanh đen",105000,105000,0,0
TIKI,lam-dep-suc-khoe,101132256,"Áo lót liner corset chuẩn",43000,43000,0,0
TIKI,lam-dep-suc-khoe,34316617,"Siêu giảm giá. Áo phông trơn GOKING form ôm đẹp cho nữ, chất liệu thun 100% cotton siêu thoáng mát. Áo phông nữ hàng hiệu cao cấp",99000,99000,0,0
TIKI,lam-dep-suc-khoe,132815390,"Quần Bơi Nữ 2 Lớp Layer Legging Women Sobie",365500,430000,64500,15
TIKI,lam-dep-suc-khoe,107056436,"Áo ngực có gọng mút dày cài trước iBasic VA149",279000,279000,0,0
TIKI,lam-dep-suc-khoe,118017395,"Đồ Lam Đi Chùa# Lãnh Tụ Nam Nữ # Đồ Bộ Nam Nữ # Quần Áo Nam Nữ",166578,166578,0,0
TIKI,lam-dep-suc-khoe,270808501,"Xịt họng keo Ong Úc Vitatree Super Propolis Spray Complex with Honey 15+ Giúp bổ sung kháng khuẩn tự nhiê, Giảm đau rát viêm họng, ho, nhiệt lỡ miệng - OZ Slim Store",110000,258000,148000,57
TIKI,lam-dep-suc-khoe,181687259,"Viên Uống DHC Melilot Hỗ Trợ Thon Chân 60 Ngày (120 Viên)",550000,650000,100000,15
TIKI,lam-dep-suc-khoe,145221424,"Bộ 6 Khẩu trang dành cho bé Unicharm 3D Mask Kid (Ngăn được bụi mịn PM2.5) gói 5 miếng",149000,149000,0,0
TIKI,lam-dep-suc-khoe,14901584,"Tặng kèm nhiệt kế điện tử - Máy Xông Khí Dung OMRON NE-C803 - Trị Liệu Hô Hấp - Trọng Lượng Nhẹ 180g",1050000,1350000,300000,22
TIKI,lam-dep-suc-khoe,154262538,"Viên uống chống nắng UV Screen Rejuvicare - hộp 30 viên ",119800,119800,0,0
TIKI,lam-dep-suc-khoe,7240315,"Bộ 10 Gói Mặt Nạ Tuyết Dưỡng Trắng Da 3W Clinic Fresh White Mask Sheet (23ml X 10)",55000,55000,0,0
TIKI,lam-dep-suc-khoe,95934490,"Combo 16 gói Băng Vệ Sinh Quần Peppy Shana Siêu Thấm Free Size (32 miếng)",221000,456000,235000,52
TIKI,lam-dep-suc-khoe,96136115,"100 Cái Bao Ngón Tay Cao Su Làm Nail",23399,23399,0,0
TIKI,lam-dep-suc-khoe,105042382,"Tinh chất giảm thâm nám và dưỡng sáng da Eucerin Spotless Brightening Booster Serum",1094000,1459000,365000,25
TIKI,lam-dep-suc-khoe,104398857,"Kem Tẩy Lông Cho Da Thường Veet Silk Fresh 50G",63000,70100,7100,10
TIKI,lam-dep-suc-khoe,112509290,"tinh dầu dạ Thảo liên 20ml",160000,160000,0,0
TIKI,lam-dep-suc-khoe,389688,"Gel Bôi Trơn Cao Cấp Sagami Original (60g)",179000,210000,31000,15
TIKI,lam-dep-suc-khoe,53653425,"Dầu gội thảo dược HÀ THỦ Ô Chiết xuất từ 6 loại thảo dược - Cân Bằng Sắc Tố Melanin Khỏi lo bạc tóc rụng tóc Cocayhoala 300g",209000,300000,91000,30
TIKI,lam-dep-suc-khoe,977111,"Hộp 5 Đôi Nút Bịt Tai Đặc Biệt Dreamgirl™ Cho Nữ Mack's #935",129000,129000,0,0
TIKI,lam-dep-suc-khoe,173836553,"Bao cao su Safefit 4in1 hộp 12 cái tặng hộp 3 cái",100000,100000,0,0
TIKI,lam-dep-suc-khoe,100128908,"Lăn Khử Mùi Ngăn Mồ Hôi Perspi-Guard Maximum Strength Antiperspirant Roll-on 30ml - Giải Pháp Khử Mùi & Ngăn Tiết Mồ Hôi Cơ Thể Đến Từ Anh",165000,165000,0,0
TIKI,lam-dep-suc-khoe,10685635,"Cao Gừng Tan Mỡ Thiên Nhiên Việt (200g) Tặng Kèm Đai Nịt Bụng Cao Cấp An Nhiên",299000,299000,0,0
TIKI,lam-dep-suc-khoe,157027735,"Combo 4 Miếng Dán Dùng Cho Máy Massage Xung Điện PEAFLO",33000,49000,16000,33
TIKI,lam-dep-suc-khoe,37159632,"Bộ dụng cụ nặn mụn lấy ráy tai 4 cây 8 đầu đa năng và tiện dụng",16000,16000,0,0
TIKI,lam-dep-suc-khoe,94118574,"Băng vệ sinh ban đêm Doctor Care chiết suất thảo dược 33.8cm the mát sảng khoái",16500,18000,1500,8
TIKI,lam-dep-suc-khoe,186370235,"Kem Body Lục Tảo Luxury Body Cream Dưỡng Trắng Da SOO YOUNG (250g)",100000,210000,110000,52
TIKI,lam-dep-suc-khoe,85660175,"Sữa Rửa Mặt Nghệ Hưng Yên Cocoon 140ml",195000,195000,0,0
TIKI,lam-dep-suc-khoe,24252400,"Mặt nạ ngủ dưỡng da Dear Klairs Freshly Juiced Vitamin E Mask 90ml",259000,259000,0,0
TIKI,lam-dep-suc-khoe,1601705,"Nước Hoa Hồng Dưỡng Ẩm The Body Shop Vitamin E (250ml)",319000,399000,80000,20
TIKI,lam-dep-suc-khoe,78510217,"Combo 3 Tinh Dầu Oải Hương + Tinh Dầu Bạc Hà + Tinh Dầu Cam Ngọt Nguyên Chất - Tinh Dầu TIDAMO Cao Cấp Xông Phòng Giúp Thư Giãn, Thơm Phòng Và Nâng Cao Sức Khỏe (3 chai 10ML)",84000,236000,152000,64
TIKI,lam-dep-suc-khoe,144737655,"Khẩu trang Người lớn, Trẻ em Mayan 3D Mask 5 cái/túi",20000,20000,0,0
TIKI,lam-dep-suc-khoe,128633299,"Phấn Phủ Dạng Nén Kiềm Dầu The Saem Saemmul Perfect Pore Pact (12g)",240000,240000,0,0
TIKI,lam-dep-suc-khoe,73400011,"Bàn chải kẽ răng SGS loại L nhập khẩu Hàn Quốc",35000,100000,65000,65
TIKI,lam-dep-suc-khoe,74215409,"Túi chườm nóng lạnh MOHI - Chính hãng",27550,29000,1450,5
TIKI,lam-dep-suc-khoe,8098630,"Kem Giảm Mụn, Thâm Mụn, Sẹo Mụn White Doctors Acne Pro",380000,380000,0,0
TIKI,lam-dep-suc-khoe,158100770,"Tinh Dầu Hoa Nhài Treo Phòng, Treo Xe Hơi Tạo Hương Thơm Dịu Nhẹ Quý Phái - Tinh Dầu Hoa Lài TIDAMO (Jasmine) Nhập Khẩu, Có Kiểm Nghiệm Giúp Thơm Phòng, Thư Giãn và Tốt Cho Sức Khỏe",64000,128000,64000,50
TIKI,lam-dep-suc-khoe,107321782,"Combo 2 Chai Dầu Gội Và Xả Bồ Kết Thorakao 400ml",143800,143800,0,0
TIKI,lam-dep-suc-khoe,137672666,"Sữa rửa mặt tẩy tế bào da chết ngừa mụn St.Ives Hoa Hồng & Lô Hội 170g",149000,149000,0,0
TIKI,lam-dep-suc-khoe,54141246,"Tinh dầu hoa Lài (nhài) 100ml Mộc Mây - tinh dầu nguyên chất 100% từ thiên nhiên - chất lượng và mùi hương vượt trội",299000,299000,0,0
TIKI,lam-dep-suc-khoe,21602792,"Dầu gội suôn mượt cho tóc khô L'oreal Hair Spa Deep Nourishing shampoo 600ml",215000,215000,0,0
TIKI,lam-dep-suc-khoe,1679109,"Khẩu Trang Y Tế Meriday Bông Bạch Tuyết TP-KT21 (50 Cái)",36000,43000,7000,16
TIKI,lam-dep-suc-khoe,520953,"Dao Cạo Râu Gillette Super Click",16000,16000,0,0
TIKI,lam-dep-suc-khoe,163826941,"Một chiếc khẩu trang N99 có Van ngăn đến 99% hạt bụi siêu mịn có kích thước từ 0,3 Mircromet #MONA MASK",30000,30000,0,0
TIKI,lam-dep-suc-khoe,15252312,"Trà Thảo mộc Hỗ Trợ Giảm cân Hera Plus (30 viên)",347000,347000,0,0
TIKI,lam-dep-suc-khoe,2616297,"Kem hỗ trợ Trị Thâm Và Dưỡng Sáng Vùng Mắt Milky Dress (15ml)",225000,225000,0,0
TIKI,lam-dep-suc-khoe,175779580,"Sữa Chống Nắng Dưỡng Da Shiseido Urban Environment Triple Beauty Suncare EmulsionSPF50+ PA++++ 30ml",1250000,1250000,0,0
TIKI,lam-dep-suc-khoe,205080744,"Viên uống tăng cường sinh lý nam giới Powergra (Super Gold Magic) - Vỉ 3 viên",550000,550000,0,0
TIKI,lam-dep-suc-khoe,175106243,"Xịt Khử Mùi Nam Body Mist Nam Gatsby Perfume Body Spray - Tặng móc khoá chính hãng",119000,119000,0,0
TIKI,lam-dep-suc-khoe,522617,"Kem Làm Giảm Mụn Và Loại Bỏ Dầu Cho Da SVR Sebiaclear Active Tuýp 40ml - SAC",380000,475000,95000,20
TIKI,lam-dep-suc-khoe,933535,"Bao Cao Su Tâm Thiện Chí Guardian Gia Đình (Hộp 144 Cái)",129000,129000,0,0
TIKI,lam-dep-suc-khoe,878387,"Tỏi Kim Cương Đông Á - Tỏi Đen Cô Đơn - Hộp 200g",270000,390000,120000,31
TIKI,lam-dep-suc-khoe,175721249,"Vitamin 3B - Trivitamin B1-B6-B12 Hộp 100 Viên Nén Đ.Y - Bổ Sung Vitamin Nhóm B Giúp Tăng Cường Sức Đề Kháng",19000,35000,16000,46
TIKI,lam-dep-suc-khoe,158744112,"Tăm bông thân giấy Pharmacity",25000,25000,0,0
TIKI,lam-dep-suc-khoe,63597395,"Kem dưỡng da nhập khẩu ÚC Redwin Cream with Vitamin E 300g",115000,148000,33000,22
TIKI,lam-dep-suc-khoe,96305219,"Máy xông tinh dầu mẫu mới công nghệ hiện đại mã máy DK-LH NEW - Hình Lọ hoa - Kèm remote, nâng cấp chức năng , chế độ phun mạnh, khuếch tán tinh dầu trong không gian rộng",245000,245000,0,0
TIKI,lam-dep-suc-khoe,7722302,"Combo 10 đắp mặt nạ hàn quốc trắng da hỗ trợ điều trị mụn BENEW ( 22ml/ gói) MIX VỊ NGẪU NHIÊN",95000,95000,0,0
TIKI,lam-dep-suc-khoe,118528516,"Viên Uống Bổ Sung Vitamin C DHC Vitamin C Hard Capsule Tăng Sức Đề Kháng",105000,105000,0,0
TIKI,lam-dep-suc-khoe,8211890,"Dũa Móng Giấy DG-402A - Kềm Nghĩa",30000,30000,0,0
TIKI,lam-dep-suc-khoe,55615086,"Kem Dưỡng Ẩm Trắng Da Ban Đêm Tế Bào Gốc Phục Hồi Trẻ Hoá Da Và Chống Lão Hoá Cellkey-Scien White Cream (30g)",833000,980000,147000,15
TIKI,lam-dep-suc-khoe,113827043,"Bộ lấy ráy tai đa năng 6 món Cao cấp bằng thép không rỉ KitAcoom, hàng nhập khẩu cao cấp có hộp đựng",39999,39999,0,0
TIKI,lam-dep-suc-khoe,6884515,"Sữa rửa mặt dạng bùn Trà tràm – Naruko Tea Tree Purifying Clay Mask and Cleanser in 1 (120g)",185000,239000,54000,23
TIKI,lam-dep-suc-khoe,3950339,"Sữa Dưỡng Thể Cho Da Nhạy Cảm Eucerin pH5 Skin Protection Lotion (250 ml) (Không Mùi)",184000,231000,47000,20
TIKI,lam-dep-suc-khoe,69244368,"Combo Sữa Tắm L'amont En Provence Rose Shower Gel + Almond Shower Gel (500ml/chai)",189000,280000,91000,33
TIKI,lam-dep-suc-khoe,8094768,"Nước Cân Bằng Giàu Khoáng Dành Cho Da Nhạy Cảm La Roche-Posay Soothing Lotion Sensitive Skin - 200ml",419000,505000,86000,17
TIKI,lam-dep-suc-khoe,911335,"Sữa Rửa Mặt Dưỡng Ẩm, Làm Sạch Sâu Chiết Xuất Hoa Cúc - Oribe Facial Cleanser 100g",68000,68000,0,0
TIKI,lam-dep-suc-khoe,115698893,"1 Hộp Vitamin E Đỏ Mirrolla 400Mg 30 viên của Nga",92900,150000,57100,38
TIKI,lam-dep-suc-khoe,5812635,"Phấn chống lão hóa mới màu da Phấn Nụ Hoàng Cung",150000,180000,30000,17
TIKI,lam-dep-suc-khoe,169956184,"Glutathione 600 - Viên Uống Trắng Da Glutathione Dr.Lacir :Đẹp Da, Mờ Nám, Cân Bằng Nội Tiết Tố (Chính Hãng Dr Lacir)",580000,580000,0,0
TIKI,lam-dep-suc-khoe,159060347,"[HỘP - D&J] Khẩu Trang Y Tế Kháng Khuẩn 4 Lớp D&J/Tiêu Chuẩn Quốc Tế/Hộp 50 Cái Màu Đen",35000,35000,0,0
TIKI,lam-dep-suc-khoe,156193998,"Combo 3 Bộ Kit Test Covid 19 Tại nhà HUMASIS Hàn Quốc (Chính hãng)",210000,210000,0,0
TIKI,lam-dep-suc-khoe,184773476,"Gối Massage Đa Năng VISPO VP-G22 - Máy Mát xa Toàn Thân Nhiệt Hồng Ngoại - Chuyên Sâu Cho Cổ, Vai Gáy, Lưng Dưới, Đùi, Chân - Sử Dụng Tại Nhà, Văn Phòng, Trên Ô Tô",997500,1050000,52500,5
TIKI,lam-dep-suc-khoe,1860269,"Kem Dưỡng Trắng Da Và Se Khít Lỗ Chân Lông Zoley 10g",79000,150000,71000,47
TIKI,lam-dep-suc-khoe,9849188,"Máy xông khí dung Omron NE-C101",885000,1250000,365000,29
TIKI,lam-dep-suc-khoe,186271043,"Khẩu trang y tế 4D (KF94) NPCARE Dreamy Tím (H/10c)",30000,30000,0,0
TIKI,lam-dep-suc-khoe,137005295,"Kem Dưỡng Phục Hồi Da Rau Má GoodnDoc Centella Repair Cream 50ml",399000,485000,86000,18
TIKI,lam-dep-suc-khoe,104397933,"Combo 2 Kem tẩy lông cho da nhạy cảm Veet Silk Fresh 50g",122000,140200,18200,13
TIKI,lam-dep-suc-khoe,150310982,"Viên Uống Sáng Mắt Flopti Eye Giảm Khô Mắt, Mờ Mắt, Mỏi Mắt Hộp 30 viên",272000,355000,83000,23
TIKI,lam-dep-suc-khoe,51551162,"Son Dưỡng Táo Hữu Cơ Cỏ Mềm",120000,120000,0,0
TIKI,lam-dep-suc-khoe,131504789,"Dầu xả dược liệu Thái Dương 3 200ml/ 600ml/ 1100ml",60000,60000,0,0
TIKI,lam-dep-suc-khoe,50326939,"Kem Dưỡng Ngăn Lão Hóa, Sáng Da Vichy Collagen Liftactiv Collagen Specialist Chuyên Biệt (50ml)",1048000,1165000,117000,10
TIKI,lam-dep-suc-khoe,82738970,"Gương trang điểm để bàn gương làm đẹp cao cấp gương soi di động bằng gỗ xoay gập tiện lợi phong cách châu Âu 4 mẫu tùy chọn - Tặng 1 băng đô trang điểm vải nhung/lụa màu ngẫu nhiên",65000,65000,0,0
TIKI,lam-dep-suc-khoe,8639764,"Kem dưỡng ngăn ngừa nứt gót chân Kpem Cream for Carcks in the feet 50ml",65000,98000,33000,34
TIKI,lam-dep-suc-khoe,58436883,"Túi Chườm Thỏ Bông 350ml - Chườm Đa Năng Nóng Lạnh- Vải Lông Cừu Mềm Mại Ấp Áp- Chườm Bụng Cho Các Nàng Khi Đau Bụng Kinh Nguyệt",59000,59000,0,0
TIKI,lam-dep-suc-khoe,84593352,"Que thử đường huyết On-call plus (25 que/hộp)",154500,230000,75500,33
TIKI,lam-dep-suc-khoe,10082226,"Dầu Gội Đen Tóc Thảo Dược LICH 5",215000,215000,0,0
TIKI,lam-dep-suc-khoe,196851276,"Tinh Dầu Khóm Homer 100ml- Tinh Dầu Xông Thơm Phòng, Thư Giãn Khử Mùi- Tinh Dầu Trái Cây Thiên Nhiên",69000,69000,0,0
TIKI,lam-dep-suc-khoe,196559916,"Tinh Dầu Hoa Bưởi Homer 100ml - Chính Hãng, Đạt Chuẩn Kiểm Định Cao Cấp - Tinh Dầu Xông Thơm Phòng, Thư Giãn, Khử Mùi hiệu quả",149000,149000,0,0
TIKI,lam-dep-suc-khoe,196855083,"Tinh Dầu Me Homer 100ml - Tinh Dầu Xông Thơm Phòng, Thư Giãn Khử Mùi - Tinh Dầu Trái Cây Thiên Nhiên",69000,69000,0,0
TIKI,lam-dep-suc-khoe,58545954,"Mặt nạ hỗ trợ trị mụn Caryophy Portulaca Mask Sheet 3IN1 22g",50000,50000,0,0
TIKI,lam-dep-suc-khoe,103376023,"Tinh Dầu Thiên Nhiên Nguyên Chất HOMER Sả Chanh/ Quế/ Oải hương/ Bưởi/ Cam/ Hoa Lài/ Quýt/ Tràm Huế/ Hoa Hồng/ Lavender/ Ngọc Lan Tây/ Tràm Trà/ Sả Java/ Trà Xanh/ Cà Phê/ Chanh (20ml)",66000,66000,0,0
TIKI,lam-dep-suc-khoe,3490097,"Tinh chất thu nhỏ lỗ chân lông Paula's Choice 10% Niacinamide Booster 20ml",1519000,1790000,271000,15
TIKI,lam-dep-suc-khoe,77924648,"Serum (Tinh Chất) Vitamin C Zakka Naturals GlowFruit+ Brightening 20g",490000,490000,0,0
TIKI,lam-dep-suc-khoe,115960176,"Tinh bột nghệ nhiều curcumin  HNT 500g - Đã được kiểm nghiệm an toàn chất lượng thực phẩm- dùng khi, dưỡng da, đau dạ dày",319000,319000,0,0
TIKI,lam-dep-suc-khoe,191683087,"Son Kem Lì Bbia Last Velvet Lip Tint ASIA EDITION Version 2 (6 Màu) 5g Bbia Official Store",150000,290000,140000,48
TIKI,lam-dep-suc-khoe,196472716,"Tinh Dầu Dưa Hấu Homer 100ML - Tinh Dầu Xông Thơm Phòng, Thư Giãn Khử Mùi - Tinh Dầu Trái Cây Thiên Nhiên",69000,69000,0,0
TIKI,lam-dep-suc-khoe,11254935,"Gel dưỡng trắng da Shiseido White Lucent Brightening Gel Cream 50mL",1850000,1850000,0,0
TIKI,lam-dep-suc-khoe,169585227,"Serum B5 Basic Hydration DrCeutics Cho Da Dầu Mụn",126000,140000,14000,10
TIKI,lam-dep-suc-khoe,114778830,"[Chính Hãng] Combo 2 Bàn Chải Đánh Răng Điện Zenyum Sonic - BxP - Bàn Chải Điện HOT - Công Nghệ Singapore",1959000,2600000,641000,25
TIKI,lam-dep-suc-khoe,83341326,"Bộ đôi bàn chải Colgate Cushion Clean công nghệ tạo bọt kem siêu mịn",122000,122000,0,0
TIKI,lam-dep-suc-khoe,73607516,"Sữa Rửa Mặt Dịu Nhẹ Cetaphil Gentle Skin Cleanser 500ml",368000,419000,51000,12
TIKI,lam-dep-suc-khoe,67242465,"Kem Dưỡng Mắt Tích Hợp Máy Rung Massage JOMTAM Hỗ Trợ Giảm Quầng Thâm Bọng Mắt",65000,95000,30000,32
TIKI,lam-dep-suc-khoe,22293001,"Combo sữa rửa mặt kiểm soát bã nhờn chiết xuất từ than hoạt tính , sửa rữa mặt ngăn ngừa mụn, phục hồi da chiết xuất từ trà xanh, sửa rữa mặt làm sáng mịn da chiết xuất từ lúa mạch 3W CLINIC ",87000,87000,0,0
TIKI,lam-dep-suc-khoe,39180106,"Tinh chất chống lão hóa da The Ordinary Retinol 1% in Squalane 30ml",349000,349000,0,0
TIKI,lam-dep-suc-khoe,176254169,"Nhụy hoa nghệ tây saffron Kingdom Herb chính hãng loại super negin thượng hạng hộp 1 gram (tặng bình thuỷ tinh cao cấp)",275000,539000,264000,49
TIKI,lam-dep-suc-khoe,114458769,"Máy nâng cơ mặt, Giảm nhăn, Tăng sinh collagen, Công nghệ Nhật Bản 2021 Cổ thiên nga",339700,339700,0,0
TIKI,lam-dep-suc-khoe,102017943,"Bổ gan cà gai leo - Hộp 60 viên - Hỗ trợ giải độc, bảo vệ gan, thanh nhiệt từ thảo dược",99000,190000,91000,48
TIKI,lam-dep-suc-khoe,152015621,"Cho máy Oral B Braun Cross Action EB-50A, Set 4 cái/ vỉ, Bộ 4 đầu bàn chải đánh răng điện đánh tan mảng bám. Tặng kèm móc khóa – Minh House",155000,155000,0,0
TIKI,lam-dep-suc-khoe,270549484,"Mần đậu nành Healthy Care Super Lecithin Úc Tăng cường chức năng gan khỏe mạnh, nâng cao sức khỏe, sắc đẹp từ bên trong - QuaTangMe Extaste",298000,596000,298000,50
TIKI,lam-dep-suc-khoe,185812640,"Lăn Khử Mùi Perspirex (Strong / Original / Comfort) Roll-On Chính Hãng",270000,270000,0,0
TIKI,lam-dep-suc-khoe,12478881,"Dầu Gội hỗ trợ điều trị Gàu Mảng, Vảy Nến Ducray Kertyol P.S.O Shampoo (125ml)",297000,350000,53000,15
TIKI,lam-dep-suc-khoe,154861307,"Khẩu trang y tế kháng khuẩn cao cấp, công nghệ Hàn Quốc, đạt chuẩn KF94 4D - Ngăn chặn 94% bụi mịn và vi khuẩn, ôm sát mặt - Màu trắng",9000,50000,41000,82
TIKI,lam-dep-suc-khoe,118124169,"Viên uống WIT bổ mắt (30 viên)",330000,330000,0,0
TIKI,lam-dep-suc-khoe,73429228,"Lăn khử mùi cho nam Degree Men Cool Comfort 48H Antiperspirant 76g ",105000,105000,0,0
TIKI,lam-dep-suc-khoe,876442,"Tẩy Trang Bioderma Sensibio H2O (500ml)",446000,525000,79000,15
TIKI,lam-dep-suc-khoe,9858922,"Máy khuếch tán tinh dầu giọt nước lớn gỗ nâu Lorganic FX2023 + tinh dầu sả chanh + tinh dầu cam Lorganic (10ml x2)/ Phun sương sóng siêu âm.",300000,550000,250000,45
TIKI,lam-dep-suc-khoe,77749869,"Tinh Dầu Xông Phòng BẠC HÀ 50ML + Tinh Dầu Treo Phòng Treo Xe ô tô Bạc Hà (Peppermint) - Tinh Dầu Bạc Hà TIDAMO Nguyên Chất Giúp Bảo Vệ Sức Khỏe, Kháng Khuẩn, Thư Giãn Tinh Thần Và Xua Đuổi Côn Trùng",128000,256000,128000,50
TIKI,lam-dep-suc-khoe,11261516,"Gel Rửa Mặt Tràm Trà, 0.5% BHA COSRX Low pH Good Morning Gel Cleanser 150ml",339000,339000,0,0
TIKI,lam-dep-suc-khoe,89785222,"Dung Dịch Vệ Sinh Phụ nữ Lactacyd Odor Fresh Ngăn Mùi 24H 150ml",52000,54000,2000,4
TIKI,lam-dep-suc-khoe,161256063,"Sữa tắm cho nam sạch sâu, khử mùi cơ thể Oxy Deep Shower",71000,74000,3000,4
TIKI,lam-dep-suc-khoe,14773441,"Combo 2 Kem bôi da Thuần Mộc 13g dưỡng ẩm da, giảm bong tróc, mẩn ngứa",211000,211000,0,0
TIKI,lam-dep-suc-khoe,73341539,"Tinh Dầu BẠC HÀ Cao Cấp TIDAMO 10ML - Tinh Dầu Bạc Hà Nguyên Chất Nhập Khẩu Sử Dụng Với Máy Xông Tinh Dầu Giúp Bảo Vệ Sức Khỏe, Kháng Khuẩn, Thư Giãn Tinh Thần và Xua Đuổi Côn Trùng",29000,76000,47000,62
TIKI,lam-dep-suc-khoe,86539325,"Combo 6 Băng vệ sinh thảo dược Doctor Care, BVS ban ngày 24cm siêu khô thoáng cả ngày dài",177000,198000,21000,11
TIKI,lam-dep-suc-khoe,131194676,"Son Lì Dưỡng Nhẹ Môi Luxury Mộc An Không Chứa Chì Giúp Dưỡng Hồng Bền Màu 4g",200000,200000,0,0
TIKI,lam-dep-suc-khoe,131504691,"Bột nhuộm tóc dược liệu màu đen Sao Thái Dương hộp 5 gói",90000,90000,0,0
TIKI,lam-dep-suc-khoe,136664045,"Dầu Xả PANTENE Chai 650ml - Ngăn rụng tóc",125000,125000,0,0
TIKI,o-to-xe-may-xe-dap,74987084,"Bộ 08 Miếng Dán Chống Xước Cao Cấp Bảo Vệ Tay Nắm Và Hõm Cửa Xe Ô Tô",59000,59000,0,0
TIKI,o-to-xe-may-xe-dap,74172634,"Đèn trợ sáng xe máy L4 L4X L6 L6X L9X Cr.ee(1 Đèn ) Green Networks Group",79000,79000,0,0
TIKI,o-to-xe-may-xe-dap,5077223,"Bộ tự vá lốp không săm cao cấp chuyên dụng cho xe máy, ô tô",78000,78000,0,0
TIKI,o-to-xe-may-xe-dap,104191669,"Đèn Đuôi Xe Đạp Cảnh Báo Phía Sau Cho Xe đạp Sạc Điện USB Chống Nước Trang Trí",91000,119000,28000,24
TIKI,o-to-xe-may-xe-dap,1378161,"Mỡ Bò Nước Dạng Xịt Bôi Trơn Chịu Nhiệt Wurth Hhs 2000 (500ml)",175000,175000,0,0
TIKI,o-to-xe-may-xe-dap,53640184,"Tấm lót và ghế tựa lưng hạt gỗ có chống trựơt  xe ô tô ",347000,347000,0,0
TIKI,o-to-xe-may-xe-dap,94702864,"Khử mùi xe ô tô, khử mùi xe hơi nano bạc Nano Xclean For Car 500ML AHT Corp - chai xịt diệt khuẩn khử mùi ô tô, mùi hải sản, mùi ẩm mốc, mùi hôi khó chịu không gian nội thất xe ô tô - công nghệ nano an toàn, thân thiện",99000,165000,66000,40
TIKI,o-to-xe-may-xe-dap,168562527,"Đệm Lót Yên Xe Máy 3D Chống Ê Mong, Làm Mát Chống Hầm,Êm Chảo, Chất Liệu Mút Xốp Cao Cấp Chuyên Dụng SIGATO3079",249000,249000,0,0
TIKI,o-to-xe-may-xe-dap,190463824,"Mũ bảo hiểm cho bé SRT lót ép nhiệt cao cấp - Nón bảo hiểm trẻ em từ 4 đến 8 tuổi",209000,209000,0,0
TIKI,o-to-xe-may-xe-dap,53265128,"Bảng số điện thoại dạ quang trên ô tô, xe hơi nhãn hiệu Baseus cao cấp ACNUM-B0S",93549,93549,0,0
TIKI,o-to-xe-may-xe-dap,119927716,"Bộ 2 móc treo đồ INOX sau ghế xe hơi ô tô",29000,29000,0,0
TIKI,o-to-xe-may-xe-dap,50185672,"full bộ đĩa trước cho xe sirius tặng bao tay trợ lực ga",1139000,1139000,0,0
TIKI,o-to-xe-may-xe-dap,91471480," Túi đeo hông chống nước đi xe máy GIVI RWB04",448000,448000,0,0
TIKI,o-to-xe-may-xe-dap,31613796,"KHÓA ĐĨA CAO CẤP HÚ BÁO ĐỘNG CHỐNG TRỘM DÀNH CHO XE MÁY",216999,216999,0,0
TIKI,o-to-xe-may-xe-dap,1254639,"Dung Dịch Súc Rửa Động Cơ Cho Mô Tô Xe Máy Bluechem Oil System Cleaner (50ml)",79000,79000,0,0
TIKI,o-to-xe-may-xe-dap,43177240,"Xe Đạp Điện Osakar A10",13000000,13000000,0,0
TIKI,o-to-xe-may-xe-dap,116767231,"Líp vặn SHIMENG 7 Speed",105000,105000,0,0
TIKI,o-to-xe-may-xe-dap,80624447,"Bơm xe đạp 160PSI/11KG GF-31PV nhôm xi bóng, van thông minh - GIYO Đài Loan",500000,500000,0,0
TIKI,o-to-xe-may-xe-dap,26460661,"Đèn led hậu chớp gắn cho xe máy ",28000,28000,0,0
TIKI,o-to-xe-may-xe-dap,192738375,"Thảm taplo da HYUNDAI I10 đời 2017 - 2020 cao cấp, Form màn hình thấp, chống nóng chống trơn trượt",199000,199000,0,0
TIKI,o-to-xe-may-xe-dap,163023746,"ỐP KHOÁ SMART MERCEDES 2024",399000,399000,0,0
TIKI,o-to-xe-may-xe-dap,49543124,"Dung Dịch Tẩy Ố, Tẩy Nano Kính Ô Tô Glaco Compound Roll On G-47T Soft99 Japan 100ml",320000,320000,0,0
TIKI,o-to-xe-may-xe-dap,7125675,"Chai xịt bảo dưỡng lốp ô tô 3M 39042 (Hàng Mỹ)",305000,305000,0,0
TIKI,o-to-xe-may-xe-dap,150491098,"MIẾNG THẢM TAPLO CHỐNG TRƯỢT KIÊM ĐỠ ĐIỆN THOẠI VÀ PHỤ KIỆN TIỆN DỤNG TRÊN XE HƠI ÔTÔ HÀNG CHUẨN ĐẸP",75000,75000,0,0
TIKI,o-to-xe-may-xe-dap,74492106,"BỘ KÍCH NỔ ẮC QUY KIÊM SẠC DỰ PHÒNG HIGHPOWER CHO XE Ô TÔ",850000,850000,0,0
TIKI,o-to-xe-may-xe-dap,72189654,"Bảng số điện thoại dùng trên xe hơi Baseus All Metal Temporary Parking Number Plate Series 2 (Dual-number Version) - Hàng chính hãng",249899,249899,0,0
TIKI,o-to-xe-may-xe-dap,118297928,"Đèn pin xe đạp siêu sáng X1T6, Độ sáng 1800 Lumen (Bộ Pin 8.4V+ Sạc + Đèn X1T6)",250000,250000,0,0
TIKI,o-to-xe-may-xe-dap,31140597,"Gạt mưa Bosch Advantage Honda City 26" 14" (Đen)",269000,269000,0,0
TIKI,o-to-xe-may-xe-dap,138341114,"Gối Tựa Lưng Ô Tô Cao Su Non Bọc Da Cao Cấp , Gối Tựa Đầu Dùng Cho Xe Ô Tô, Ghế Văn Phòng",115000,115000,0,0
TIKI,o-to-xe-may-xe-dap,45818076,"Tấm Lưới Tựa Lưng Ô Tô Văn Phòng Siêu Hot TL01",24000,24000,0,0
TIKI,o-to-xe-may-xe-dap,102722437,"Gối Tựa Lưng Ghế Văn Phòng Ghế Ô Tô Bằng Cao Su Non Có Đai Cài Vỏ Hoạt Hình Xinh Xắn",329000,329000,0,0
TIKI,o-to-xe-may-xe-dap,125138775,"Giá kẹp đỡ điện thoại xoay 360 độ chống rung gắn taplo tấm chắn nắng gương chiếu hậu xe ô tô, xe hơi",60001,60001,0,0
TIKI,o-to-xe-may-xe-dap,54160152,"Giường đệm, nệm hơi thông minh du lịch cho ôtô, xe hơi + Kèm bơm điện, vòi bơm đa năng",299996,299996,0,0
TIKI,o-to-xe-may-xe-dap,10120303,"Nước hoa kẹp cửa gió điều hòa ô tô AREON VANI (NEW) - NHẬP KHẨU BULGARIA",304000,320000,16000,5
TIKI,o-to-xe-may-xe-dap,6703871,"Bình Ắc Quy Siêu Nhỏ 12V - 1.3Ah",149899,149899,0,0
TIKI,o-to-xe-may-xe-dap,150493655,"Đèn bi cầu 2 màu cốt vàng pha trắng F20xp 60w siêu sáng chống nước dành cho khách vip",439000,439000,0,0
TIKI,o-to-xe-may-xe-dap,52322221,"Thiết Bị Định Vị GPS GF-09 Dành Cho Xe Hơi Người Cao Tuổi Trẻ Nhỏ Tự Động Gửi Báo Động Cho Bạn",385000,385000,0,0
TIKI,o-to-xe-may-xe-dap,47271718,"Đệm Giường Hơi Ô Tô Cao Cấp, Đệm hơi xe SUV M168 7 chỗ 175x130CM phủ 2 hàng ghế tạo giường rộng rãi",790000,790000,0,0
TIKI,o-to-xe-may-xe-dap,142871457,"Dây ràng D-Ring buộc đồ đi phượt trên xe máy",80000,80000,0,0
TIKI,o-to-xe-may-xe-dap,58362173,"Đèn hậu nhấp nháy phanh chớp liên tục gắn cho mọi loại xe ( Đầu Trong ) Green Networks Group",69000,69000,0,0
TIKI,o-to-xe-may-xe-dap,154135319,"Bao Da dành cho Chìa Khoá KIA Seltos 2021 2022, Sonet luxury, Premium logo KIA mới 006 B",199000,199000,0,0
TIKI,o-to-xe-may-xe-dap,56255757,"Quạt Sắt 4 Cánh Mini Có Kẹp Treo Xe Ô Tô Siêu Chắc Chắn SDLG",249000,249000,0,0
TIKI,o-to-xe-may-xe-dap,84870178,"Kem phủ bóng PALLAS NANO Polish Cream 250g - dùng đánh bóng xe máy, ô tô, bóng nhựa, da, simili, hạn chế bám bụi",49000,49000,0,0
TIKI,o-to-xe-may-xe-dap,170679511,"Bao Da Chìa Khóa dành cho xe ô tô TOYOTA ( Chìa gấp altis 14-18, Innova 17-20, Fortuner )Da Thật",170000,170000,0,0
TIKI,o-to-xe-may-xe-dap,70934701,"Nắp Két Nước Làm Mát Động Cơ Ô Tô",69000,69000,0,0
TIKI,o-to-xe-may-xe-dap,173911192,"BẠT PHỦ XE MÁY XE ĐẠP CHỐNG MƯA CHỐNG NẮNG - HENRYSA",62000,98000,36000,37
TIKI,o-to-xe-may-xe-dap,91390896," Bình xịt vệ sinh nội thất ô tô dưỡng bóng ghế da, taplo, cao su, nhựa sần",210000,210000,0,0
TIKI,o-to-xe-may-xe-dap,3856963,"Kính Bulldog Eagle",179000,179000,0,0
TIKI,o-to-xe-may-xe-dap,74911710," Túi Treo Đầu Ghi Đông Xe Máy Chiều Dọc Xem Google Map, Chứa Đồ, Chạy Grab, Nowship, GoJet",82000,82000,0,0
TIKI,o-to-xe-may-xe-dap,32371106,"Công Tắc Mở Cốp Hậu Dành Cho Huyndai I10 Grand - Kia Morning",69000,69000,0,0
TIKI,o-to-xe-may-xe-dap,14350394,"Túi treo ghế ô tô",89000,89000,0,0
TIKI,o-to-xe-may-xe-dap,135642277,"Ví đựng giấy tờ ô tô Honda Da Cao Cấp, Ví da đựng giấy tờ xe ô tô",55000,55000,0,0
TIKI,o-to-xe-may-xe-dap,192340025,"gương cầu lồi cho xe ô tô, Bộ 2 Gương Cầu Lồi Tràn Viền Xoay 360 độ Gắn Cho Kính Gương Chiếu Hậu Tránh Điểm Mù Cho Xe Hơi, Xe Ô tô - Hàng Chính Hãng dododios",29000,29000,0,0
TIKI,o-to-xe-may-xe-dap,192514345,"BAGA GIỮA ( KẸP MẠNH ) DÙNG CHO ĐỜI XE AB 2020 2021 VÀ AB 2022 2023 2024 - AB 125 150 160cc BAGA ĐEN",180000,180000,0,0
TIKI,o-to-xe-may-xe-dap,198119464,"Máy hút bụi, bơm lốp, đo áp suất lốp ô tô xe hơi cao cấp công suất 120W có đèn led chiếu sáng",429000,429000,0,0
TIKI,o-to-xe-may-xe-dap,74363092,"Găng tay bảo hộ xe máy OAKLEY",68000,68000,0,0
TIKI,o-to-xe-may-xe-dap,48563549,"Bộ Chốt Khóa Dây An Toàn 4S dành cho ô tô Logo theo xe",50999,50999,0,0
TIKI,o-to-xe-may-xe-dap,3690167,"Thiết bị kiểm tra Acquy 12V ANSMANN - Hàng Nhập Khẩu",298000,298000,0,0
TIKI,o-to-xe-may-xe-dap,53505348,"BAO DA CHÌA KHOÁ FORD EXPLORER - CHÍNH HÃNG KHẮC TÊN",400000,400000,0,0
TIKI,o-to-xe-may-xe-dap,21050937,"Bộ Tự Vá Lốp Không Săm Cao Cấp Cho Ô Tô Xe Máy",85000,85000,0,0
TIKI,o-to-xe-may-xe-dap,10697900,"Búa Thoát Hiểm Cho Ô Tô",49000,49000,0,0
TIKI,o-to-xe-may-xe-dap,192738336,"Thảm Taplo Da Cacbon XPANDER đời 2019-2022 cao cấp, chống nóng chống trơn trượt",208000,208000,0,0
TIKI,o-to-xe-may-xe-dap,22322969,"BỘ VÁ LỤI XE MÁY, Ô TÔ ",19400,19400,0,0
TIKI,o-to-xe-may-xe-dap,93884213,"Túi Xe Đạp Treo Sườn Xe Dài 1 Ngăn ML02 Chống Nước Vải Oxford Chống Mài Mòn MaiLee",109000,119000,10000,8
TIKI,o-to-xe-may-xe-dap,229793267,"BỌC VÔ LĂNG THƯƠNG HIỆU FASTERMO, CHẤT DA Ô TÔ CAO CẤP, ĐỦ KÍCH CỞ, FORM ÔM KÍNH THEO XE",179000,179000,0,0
TIKI,o-to-xe-may-xe-dap,54566453,"Dung Dịch Xông Khử Mùi Ô Tô 100ml",17000,17000,0,0
TIKI,o-to-xe-may-xe-dap,139445465,"Đèn trợ sáng xe máy ô tô L2 mắt cú siêu sáng mẫu mới chống nước loại tốt vỏ hợp kim",167990,167990,0,0
TIKI,o-to-xe-may-xe-dap,56372404,"Bộ 02 Gương Cầu Nồi Gương Chiếu Hậu Khắc Phục Điểm Mù Ô Tô Xe Hơi ",29000,29000,0,0
TIKI,o-to-xe-may-xe-dap,89940920,"Đèn Led Vây Cá Mập Trang Trí Xe Hơi - Dùng Năng Lượng Mặt Trời 206019",61100,73000,11900,16
TIKI,o-to-xe-may-xe-dap,104812371,"Khóa bánh xe chống trộm ô tô",360000,360000,0,0
TIKI,o-to-xe-may-xe-dap,143053995,"Bảng số điện thoại gắn taplo ô tô hỗ trợ đỗ xe",45000,45000,0,0
TIKI,o-to-xe-may-xe-dap,181772892,"Bạt Phủ Xe Ô Tô Mazda 2, Mazda 3, Mazda 6, CX5, CX8, CX9, BT50, Chất Liệu Bạt Tráng Nhôm 3 lớp",128000,128000,0,0
TIKI,o-to-xe-may-xe-dap,73519197,"Nhớt Xe Số 4T Mobil Super Moto 20W-50 Tiêu Chuẩn JASO MA2 API SL (0.8L) - Hàng Chính Hãng",85000,85000,0,0
TIKI,o-to-xe-may-xe-dap,4405991,"Ruột xe đạp Schwalbe 26” SV13 (40mm)",130000,130000,0,0
TIKI,o-to-xe-may-xe-dap,801350,"Máy Lọc Không Khí Cho Xe Hơi Sharp IG-GC2E-N - Vàng - Hàng Chính Hãng",2100000,2100000,0,0
TIKI,o-to-xe-may-xe-dap,171651830,"Máy bơm lốp mini đa năng tự ngắt Michelin 3321 - Bơm xe đạp, xe máy, ô tô, bóng, xe hơi 4 bánh, có đèn LED, nhỏ gọn, thông minh, sạc Micro USB",835000,835000,0,0
TIKI,o-to-xe-may-xe-dap,97541467," Khóa xe máy chữ U, khóa chống trộm chữ U an toàn LK605",249000,249000,0,0
TIKI,o-to-xe-may-xe-dap,5471023,"Bộ gác chân sau màu titan dành cho xe máy",65000,65000,0,0
TIKI,o-to-xe-may-xe-dap,100279543,"Thanh gạt mưa Bosch Aerotwin Plus - Hàng Chính Hãng",460000,686000,226000,33
TIKI,o-to-xe-may-xe-dap,25708089,"Chai vệ sinh làm sạch ghế da, vải nỉ ô tô Gold Class 650ml",80000,80000,0,0
TIKI,lam-dep-suc-khoe,140621871,"Trà đốt mỡ và kiểm soát cân nặng Night Diet Tea Orihiro Nhật Bản thải độc cơ thể, cải thiện chất lượng giấc ngủ gói 24 túi lọc JN-OR-NI01",164000,195300,31300,16
TIKI,lam-dep-suc-khoe,166764904,"Nước muối sinh lý Vĩnh Phúc Natriclorid 0.9% (500ml)",9500,9500,0,0
TIKI,lam-dep-suc-khoe,7609680,"Kéo Cắt Tỉa Lông Mũi Đầu Tròn Kềm Nghĩa KM 604- Thép Không Gỉ Cao Cấp - Thiết Kế Nhỏ - Gọn - Nhẹ - An toàn",51000,51000,0,0
TIKI,lam-dep-suc-khoe,135282855,"Miếng Dán Hạ Sốt Bye Bye Ferver- Made In Japan - Làm Mát Tức Thì, Dùng Trong Các Trường Hợp Sốt, Say Nắng, Đau Cơ",56800,56800,0,0
TIKI,lam-dep-suc-khoe,166084645,"KEM BODY COLLAGEN X3 WHITENING BODY CREAM MIX SAFFRON",90000,199000,109000,55
TIKI,lam-dep-suc-khoe,271617029,"Kẽm hỗ trợ trị mụn, làm đẹp da mụn Puritan'S Pride Premium Zinc For Acne Mỹ gồm kẽm và Vitamin C, B-6, A và E - OZ Slim Store",310000,620000,310000,50
TIKI,lam-dep-suc-khoe,176098197,"Sữa tắm mụn lưng ELDAS, sữa tắm giảm viêm nang lông, tinh chất TRÀM TRÀ KHỔ QUA diệt khuẩn ngăn ngừa mụn cơ thể 550ml",121000,189000,68000,36
TIKI,lam-dep-suc-khoe,1218467,"Thực Phẩm Chức Năng Thuốc hỗ trợ Giảm Cân Học Viện Quân Y Slimtosen Extra (100 Viên)",170000,170000,0,0
TIKI,lam-dep-suc-khoe,272043408,"Mầm đậu nành Úc Healthy Care Super Lecithin 1200mg tăng cường chức năng gan khỏe mạnh, nâng cao sức khỏe, sắc đẹp từ bên trong - OZ Slim Store",298000,596000,298000,50
TIKI,lam-dep-suc-khoe,74492258,"Bộ 2 Diana Sensi Băng quần size M-L (5 miếng/ gói)",160000,160000,0,0
TIKI,lam-dep-suc-khoe,8142225,"Kềm Cắt Móng Thép Chuyên Dụng Kềm Nghĩa M-555",105000,105000,0,0
TIKI,lam-dep-suc-khoe,126945359,"Bao cao su LifeStyles Fantasy Gân Ngang, Nhiều Gel Bôi Trơn tăng Khoái Cảm - Hộp 12 bao",99000,135000,36000,27
TIKI,lam-dep-suc-khoe,55136157,"Sữa Rữa Mặt SIMPLE Kind To Skin Dạng Gel Cho Da Nhạy Cảm UK",89000,89000,0,0
TIKI,lam-dep-suc-khoe,113714799,"Viên kẹo ngậm ho bạc hà Eucatana hộp 24 viên, kẹo ngậm bạc hà tiêu đờm, giảm đau họng",39900,39900,0,0
TIKI,lam-dep-suc-khoe,1082080,"Bao Cao Su Sagami Extreme Superthin (10 Chiếc)",60400,60400,0,0
TIKI,lam-dep-suc-khoe,161029307,"Máy massage đầu gối không dây thông minh CTFAST: Công nghệ mát xa rung kết hợp nhiệt hồng ngoại, hỗ trợ điều trị đau khớp gối, pin sạc 6000mAh, chất liệu dễ dàng vệ sinh",699000,749000,50000,7
TIKI,lam-dep-suc-khoe,123582725,"Serum Dưỡng Ẩm Phục Hồi Da GoodnDoc Hydra B5 - Serum B5 GoodnDoc 30ml",395000,450000,55000,12
TIKI,lam-dep-suc-khoe,58173357,"Kem Body Mềm Dưỡng Trắng Da Acosmetics 250G",110000,175000,65000,37
TIKI,lam-dep-suc-khoe,214661875,"Gel rửa mặt ngăn ngừa mụn Nerman Nano Curcumin 60s Fresh dành riêng cho nam làm sạch sâu, ngăn ngừa vi khuẩn gây mụn (100ml)",99000,178000,79000,44
TIKI,lam-dep-suc-khoe,411327,"Nước Xịt Khoáng Dưỡng Da Vichy 150ml - 100829485",288000,339000,51000,15
TIKI,lam-dep-suc-khoe,104799777,"Nhíp Inox Đầu Xéo Nhổ Lông Mày Cao Cấp Kềm Nghĩa N.425",19950,21000,1050,5
TIKI,lam-dep-suc-khoe,271408234,"Hỗ trợ mọc tóc Natrol Biotin Beauty giúp tóc mọc nhanh dài, dày hơn,   làn da rạng rỡ và móng tay chắc khỏe - Massel Official",290000,646000,356000,55
TIKI,lam-dep-suc-khoe,20470519,"Băng vệ sinh ban ngày Laurier có cánh -Hàng nội địa Nhật nhập khẩu",75000,75000,0,0
TIKI,lam-dep-suc-khoe,1601791,"Tinh Dầu Cho Da Mụn The Body Shop Tea Tree Oil (20ml)",449000,449000,0,0
TIKI,lam-dep-suc-khoe,56363000,"Bộ 2 Sữa tắm Palmolive sảng khoái dịu êm 100% chiết xuất từ hoa anh đào 500g",216000,216000,0,0
TIKI,lam-dep-suc-khoe,75946733,"Combo Cà phê đắk lắk Tẩy da chết Body cocoon 200ml + Tẩy da chết Mặt cocoon 150ml",232000,290000,58000,20
TIKI,lam-dep-suc-khoe,50926033,"Nước Hoa Hồng Ý Dĩ HATOMUGI 500ml",101000,240000,139000,58
TIKI,lam-dep-suc-khoe,50326501,"Combo 2 Xịt toàn thân Romano Attitude nồng ấm cá tính 150ml",159000,206000,47000,23
TIKI,lam-dep-suc-khoe,196857071,"Tinh Dầu Táo Xanh Homer 100ml - Tinh Dầu Xông Thơm Phòng, Thư Giãn Khử Mùi - Tinh Dầu Trái Cây Thiên Nhiên",79000,79000,0,0
TIKI,lam-dep-suc-khoe,43763060,"Kem bôi da Thuần Mộc Thanh Mộc Hương combo 2 Hộp",210000,210000,0,0
TIKI,lam-dep-suc-khoe,197416463,"Combo Bao cao su Durex Fetherlite Ultima Hộp 12 bao và Hộp 3 bao",288000,380000,92000,24
TIKI,lam-dep-suc-khoe,43822645,"Tinh Chất Dưỡng Trắng Da Giảm Thâm Nám Eucerin Double Bosster Serum (30ml)",1094000,1459000,365000,25
TIKI,lam-dep-suc-khoe,57783000,"Natureine AQUA PEEL Moisture Peeling Gel - Gel tẩy tế bào da chết, cấp ẩm Nhật Bản - Chính Hãng",400000,550000,150000,27
TIKI,lam-dep-suc-khoe,694481,"Tinh Dầu Vỏ Quế Nguyên Chất Lorganic (10ml)",80000,80000,0,0
TIKI,lam-dep-suc-khoe,186094161,"Bọt vệ sinh nam giới Oniiz Dung dịch vệ sinh nam tạo bọt Amorous (Hương Đam Mê) 100ml",120000,120000,0,0
TIKI,lam-dep-suc-khoe,10117454,"Nước Gội Đầu Bồ Kết Và Vỏ Bưởi Mộc Nhu Hỗ Trợ Trị Rụng Tóc Trị Gàu 300ml",169000,169000,0,0
TIKI,lam-dep-suc-khoe,185591376,"Tinh chất dưỡng tóc, ngăn rụng tóc 50 Megumi Hair Essence 30ml",133000,165000,32000,19
TIKI,lam-dep-suc-khoe,195669496,"Thanh Lăn Mụn MS Lighting Acne Spot Roller (5ml), Hỗ Trợ Giảm Mụn, Mờ Vết Thâm, Thông Thoáng Lỗ Chân Lông - MỸ PHẨM MS COSMETIC",129000,129000,0,0
TIKI,lam-dep-suc-khoe,16279231,"Dầu gội cao cấp Romano Classic cổ điển lịch lãm tóc chắc khỏe 900gr",185000,234000,49000,21
TIKI,lam-dep-suc-khoe,157271444,"Kem dưỡng trắng da mặt Truesky Whitening Face Cream chiết xuất sữa ong chúa 20g",170000,170000,0,0
TIKI,o-to-xe-may-xe-dap,52110803,"Phụ gia nhớt súc rửa động cơ cao cấp Liqui Moly 2427 - Tặng kèm 1 khăn lau chuyên dụng 3M",239000,239000,0,0
TIKI,o-to-xe-may-xe-dap,208212997,"Mũ bảo hiểm lỗ thông gió NÓN SƠN chính hãng TG-XM151",340000,650000,310000,48
TIKI,lam-dep-suc-khoe,522736,"Sữa Rửa Mặt Tẩy Tế Bào Chết SVR Sebiaclear Gel Moussant Tuýp 200ml - SGM",273000,390000,117000,30
TIKI,o-to-xe-may-xe-dap,49983451,"cảng sau kiểu MiO dùng cho xe sirius màu đen",114000,114000,0,0
TIKI,lam-dep-suc-khoe,54016974,"Combo 20 Bộ 40 Miếng Dán Mồ Hôi Tay Áo Cao Cấp , Thoải Mái Cho Người Dùng, Tiện Lợi Cho Nhân Viên Công Sở, Miếng thấm hút mồ hôi, Miếng dán mồ hôi dưới cánh tay khử mùi",99000,99000,0,0
TIKI,o-to-xe-may-xe-dap,2185043,"Nón Bảo Hiểm Giro Isode",1100000,1100000,0,0
TIKI,lam-dep-suc-khoe,10131586,"Combo 4 Hộp Viên Uống Đạm Tăng Cân AVITA Dành Cho Người Gầy, Giúp Tăng Cường Sức Đề Kháng, Nâng Cao Thể Trạng, An Toàn Hiệu Quả 60 Viên/Hộp",650000,792000,142000,18
TIKI,o-to-xe-may-xe-dap,53838863,"Dây câu bình ắc quy ô tô dài 4m dòng 2500A",195000,195000,0,0
TIKI,o-to-xe-may-xe-dap,154234336,"Nhớt Motul GP Power 800ml Cho Xe Máy Số Và Côn Tay ",115000,115000,0,0
TIKI,o-to-xe-may-xe-dap,96615231,"Bơm xe đạp xe máy 180psi/12kg GIYO 2730 thân thép đồng hồ siêu to",440000,440000,0,0
TIKI,o-to-xe-may-xe-dap,1176233,"Bình Súc Béc Xăng Liqui Moly 1803 (300ml)",165000,165000,0,0
TIKI,o-to-xe-may-xe-dap,74689554,"24 Miếng Vá Săm Lốp Xe Đạp Dự Phòng Tự Vá Tại Nhà (Gồm Keo) Mai Lee",34000,38000,4000,11
TIKI,lam-dep-suc-khoe,82403186,"Combo 3 lọ Dưỡng Tâm An Lafon - Viên uống hỗ trợ mất ngủ, giúp ngủ ngon và sâu giấc (30 viên/lọ)",500000,500000,0,0
TIKI,lam-dep-suc-khoe,131504612,"Sữa rửa mặt nghệ sạch mụn, ngừa vết thâm Thái Dương 90g",35000,35000,0,0
TIKI,o-to-xe-may-xe-dap,100989205,"Bộ 5 Tem Cảnh Báo Dán Xe Máy, Sticker Dán Nón Bảo Hiểm Chống Thấm Nước Green Networks Group",12000,12000,0,0
TIKI,o-to-xe-may-xe-dap,186269678,"Bộ kích điện ắc quy 12V lên 220V 500W INVERTER",252000,269000,17000,6
TIKI,o-to-xe-may-xe-dap,139718328,"Bạt che phủ bảo vệ ô tô xe hơi 4 chỗ, 5 chỗ, 7 chỗ vải Dù cao cấp siêu bền chống xước, chống nắng nóng, chống cháy, chống mưa, chống bụi bẩn",430000,430000,0,0
TIKI,lam-dep-suc-khoe,26350332,"Xịt Khoáng Khử Clo Sau Khi Bơi SwimRinse",160000,160000,0,0
TIKI,lam-dep-suc-khoe,4423229,"Nước rửa tay Premium Hand Soap Mr Fresh Hàn Quốc 5L",162000,162000,0,0
TIKI,o-to-xe-may-xe-dap,1378109,"Dung Dịch Tẩy Và Làm Sạch Đánh Bóng Inox 3M Stainless Steel Cleaner & Polish 126080 (600g)",270000,270000,0,0
TIKI,o-to-xe-may-xe-dap,66682012,"Bộ dụng cụ sửa chữa xe đạp - Dụng cụ tháo trục giữa, cắt sên, tháo líp xe đạp ( 4 chi tiết)",120000,120000,0,0
TIKI,o-to-xe-may-xe-dap,122436826,"Chắn bùn xe đạp thể thao Kiotool trước sau đầy đủ phụ kiện chắc chắn",75000,75000,0,0
TIKI,lam-dep-suc-khoe,1022207,"Que Thử Đường Huyết Accu-Chek Instant 25",274000,330000,56000,17
TIKI,lam-dep-suc-khoe,636922,"Bao Cao Su 4 in 1 Gân, Gai, Mỏng, Kéo Dài Quan Hệ Azodra (12 Gói)",55000,55000,0,0
TIKI,lam-dep-suc-khoe,84596223,"Kim chích máu máy đo đường huyết Acon On-call (100 kim / hộp)",39000,125000,86000,69
TIKI,o-to-xe-may-xe-dap,1237331,"Chai Xịt Bóng Da, Bóng Gỗ Toyo (500ml)",61000,76700,15700,20
TIKI,o-to-xe-may-xe-dap,4643829,"Mũ Bảo Hiểm 3/4 Napoli SH (Size L) - Đen Lót Nâu",251000,251000,0,0
TIKI,lam-dep-suc-khoe,146086160,"Dầu Tắm Gội Dapper Dan Hair & Body Shampoo 300ml",330000,330000,0,0
TIKI,o-to-xe-may-xe-dap,141772466,"Máy bơm lốp xe hơi kỹ thuật số thông minh Baseus Mini Air Compressor 12V 150PSI (hàng chính hãng)",525899,525899,0,0
TIKI,o-to-xe-may-xe-dap,133431341,"Thùng đựng đồ gấp gọn để đồ trên ô tô, xe hơi, văn phòng, gia đình 45L và 75L có nhiều ngăn đựng riêng bi",368000,400000,32000,8
TIKI,lam-dep-suc-khoe,58744960,"Nước tẩy trang L'Oreal Paris 3-in-1 Micellar Water 400ml",189000,189000,0,0
TIKI,o-to-xe-may-xe-dap,87392058,"Túi xe đạp cao cấp,túi treo sườn xe đạp chống nước bọc cảm ứng phù hợp với mọi dòng xe Thương hiệu KIOTOOL",65000,65000,0,0
TIKI,lam-dep-suc-khoe,176098198,"Combo Sữa tắm mụn lưng ELDAS diệt khuẩn ngừa mụn 24 giờ &amp; Sữa rửa mặt Eldas mờ thâm da sáng mịn đều màu",174000,279000,105000,38
TIKI,o-to-xe-may-xe-dap,57842174,"Ốp Nắp Bình Xăng Mạ Crom Chống Xước Trang Trí Bảo Vệ Ô Tô - Kia Carens",129000,129000,0,0
TIKI,o-to-xe-may-xe-dap,184518746,"Miếng dán decal nắp bình xăng dầu cho xe oto Oil-8",19000,19000,0,0
TIKI,o-to-xe-may-xe-dap,31843672,"Dầu Bôi Trơn Chống Rỉ Sét Làm Sạch Thẩm Thấu Chống Ẩm Bảo Vệ WD-40 (300ml)",100000,100000,0,0
TIKI,o-to-xe-may-xe-dap,801326,"Máy Lọc Không Khí Cho Xe Hơi Sharp IG-GC2E-B - Đen - Hàng chính hãng",2130000,2190000,60000,3
TIKI,o-to-xe-may-xe-dap,96911021,"Bộ 4 ốc - nắp chụp chân van, đầu vòi xe hơi, xe máy, ô tô chất lượng cao chống rỉ nhiều màu",10000,17500,7500,43
TIKI,o-to-xe-may-xe-dap,46235477,"Giá đỡ gối đệm kê ngủ tựa đầu 2 bên gắn xe hơi, ô tô, giá có thể điều chỉnh độ cao thấp phù hợp cho người lớn và trẻ em",429000,429000,0,0
TIKI,lam-dep-suc-khoe,7805771,"Thực Phẩm Chức Năng Tảo Tăng Chiều Cao Shinshin Kakumei Nhật Bản",375000,520000,145000,28
TIKI,lam-dep-suc-khoe,2079709,"Sữa Dưỡng Thể 200Ml Vaseline Dưỡng Ẩm Sáng Da Chống Nắng Spf24Pa++ Sun + Pollution Protection Bảo Vệ Da Tới 4H Với Spf 24 Pa++",98000,98000,0,0
TIKI,o-to-xe-may-xe-dap,108204619,"{TẶNG ỐC CHÂN GƯƠNG} Gương (kính) chiếu hậu Rizoma 5 cạnh nhôm CNC cao cấp  Màu xanh dành cho các dòng xe máy - TKA-DG66xanh",108000,176000,68000,39
TIKI,o-to-xe-may-xe-dap,155245299,"Bao Da Chìa Khoá New KIA K3 2021 Luxury, Premium, K5, New Sportage 2022, Sorento, cerato logo mới handmade Da Thật 010",199000,199000,0,0
TIKI,lam-dep-suc-khoe,25440933,"Kẻ mắt nước Bbia Last Pen Eyeliner 0.6g (5 màu)",120000,200000,80000,40
TIKI,lam-dep-suc-khoe,11961980,"Sữa rửa mặt nghệ nano NeoCleanser",158000,158000,0,0
TIKI,lam-dep-suc-khoe,191365627,"Combo 2 Sữa dưỡng thể với thành phần ngừa lão hóa dưỡng sáng VASELINE Healthy Bright Perfect Youth 350ML/chai",211000,300000,89000,30
TIKI,lam-dep-suc-khoe,95067213,"Chai xịt diệt khuẩn Nano bạc AHT trà trắng dùng rửa tay, xịt màn hình, vệ sinh phòng ngủ",76700,76700,0,0
TIKI,o-to-xe-may-xe-dap,138387597,"Bộ vam tháo vòng bi 2 đĩa chặn, bộ cảo bi kiểu bán nguyệt",750000,750000,0,0
TIKI,o-to-xe-may-xe-dap,136191275,"Nhớt Xe Tay Ga Motul Scooter Le 4t 10w40 20x",109000,109000,0,0
TIKI,o-to-xe-may-xe-dap,57454794,"Bình Xịt Dung Dịch Phủ Bóng Sơn Xe Ô Tô Chống Thấm Nước 500ml",63000,63000,0,0
TIKI,lam-dep-suc-khoe,134821636,"Bông phấn,mút phấn trang điểm vuông nhỏ tiện lợi và dễ sử dụng Nhật 727 SDS Sponge",61000,90000,29000,32
TIKI,lam-dep-suc-khoe,76182173,"Chống nắng dạng thỏi Shiseido GSC Clear Suncare Stick SPF50+ 20G",780000,780000,0,0
TIKI,o-to-xe-may-xe-dap,75982771,"Bộ gù chống đổ Trước Sau xe máy - Combo Gù chống đổ Trước và Gù chống đổ Sau Green Networks Group",159000,159000,0,0
TIKI,o-to-xe-may-xe-dap,150493324,"Chíp nhại còi xe máy loại tốt chống nước kích âm còi to rõ láy tiếng cực hay",66000,66000,0,0
TIKI,o-to-xe-may-xe-dap,4405975,"Ruột xe đạp Impac 26’’ AV (40mm)",69000,69000,0,0
TIKI,o-to-xe-may-xe-dap,154173062,"Lót cốp dành cho xe Honda City 2021 không mùi, chất liệu TPO cao cấp",315000,315000,0,0
TIKI,lam-dep-suc-khoe,33605570,"Kem Chống nắng cho da mụn, bị mụn trứng cá Eucerin Sun Gel-Creme oil control Dry Touch SPF50+ 50ml + tặng máy massage mặt ion",466650,549000,82350,15
TIKI,o-to-xe-may-xe-dap,141917212,"Băng dính 3m 2 mặt trong suốt Acrylic Foam Tapes AFT - Băng keo 3m chuyên dụng ô tô siêu chắc",18000,18000,0,0
TIKI,lam-dep-suc-khoe,7146751,"Combo 5 hộp dầu gội thảo dược đen tóc TOSMEDY – Đen tóc không đen da đầu",119000,119000,0,0
TIKI,o-to-xe-may-xe-dap,59132691,"Ví simili đựng giấy tờ xe ô tô V06Si",38000,38000,0,0
TIKI,o-to-xe-may-xe-dap,116396323,"Quạt đôi ô tô công suất lớn xoay 360 độ 3 tốc độ gió chân cắm usb dùng cho ô tô ,bàn làm việc máy tính F303",189000,189000,0,0
TIKI,o-to-xe-may-xe-dap,271997504,"Yên Xe Đạp Phoenix Êm Ái Chống Nước Phù Hợp Với Mọi Dòng Xe Đạp Thể Thao Địa Hình",250000,250000,0,0
TIKI,o-to-xe-may-xe-dap,119719000,"Sạc Ắc Quy Tự Động AST 10A 12V, Bộ sạc bình ắc quy từ 3ah - 200ah, sạc bình ắc quy cho xe máy đến ô tô",1181000,1181000,0,0
TIKI,o-to-xe-may-xe-dap,45653568,"Áo ghế ô tô, Áo ghế xe hơi, bọc da ghế xe 3D TD01",650000,650000,0,0
TIKI,o-to-xe-may-xe-dap,50348260,"Mũ bảo hiểm Chita 3/4 - CT1 Nón cặp size M",420000,420000,0,0
TIKI,o-to-xe-may-xe-dap,14563208,"Nón bảo hiểm ¾ GRS A318K kính dài",580000,580000,0,0
TIKI,o-to-xe-may-xe-dap,115707800,"Bao tay nắm chống mỏi xe đạp siêu êm",36000,39000,3000,8
TIKI,o-to-xe-may-xe-dap,38649410,"Thảm sàn, lót sàn cao su không mùi Cao cấp dành cho xe Hyundai Grand i10",528000,528000,0,0
TIKI,lam-dep-suc-khoe,63481337,"Bộ 3 Kem đánh răng Colgate Than tre sạch thuần khiết từ Hàn Quốc 180g/ tuýp",147000,165000,18000,11
TIKI,o-to-xe-may-xe-dap,5434623,"Baga trước dành cho xe Exciter 150 dày 10 ly",110000,110000,0,0
TIKI,o-to-xe-may-xe-dap,104799820,"Chai xịt bảo dưỡng cao su, ron cửa và lốp xe ô tô nhãn hiệu Sonax 340200 dung tích 300 ml - Hàng Chính Hãng",274000,274000,0,0
TIKI,o-to-xe-may-xe-dap,54626236,"Dầu nhớt Mobil 5W30 EP 946ml - Chính hãng Mobil nhập khẩu từ Mỹ",295000,295000,0,0
TIKI,lam-dep-suc-khoe,118896544,"Nến thơm tinh dầu cao cấp không khói an toàn Candle Cup - GINGERGRASS/GỪNG SẢ - S - 100G (KG NẮP)",120000,120000,0,0
TIKI,lam-dep-suc-khoe,178297539,"Sáp tạo kiểu tóc giữ nếp tự nhiên Romano Restyleable Matte Wax 68g/hộp ",82000,82000,0,0
TIKI,o-to-xe-may-xe-dap,147084619,"Bình xịt vệ sinh ghế nỉ  ô tô, vệ sinh sofa nỉ",68000,68000,0,0
TIKI,o-to-xe-may-xe-dap,83347244,"Nón bảo hiểm 3/4 ROYAL M139 có kính âm màu ĐỎ ĐÔ",540000,700000,160000,23
TIKI,lam-dep-suc-khoe,155286036,"Son Dưỡng Môi Hồng Xinh Vaseline Lip Therapy Rosy Lip (7g)",59000,59000,0,0
TIKI,o-to-xe-may-xe-dap,19272818,"Bạt phủ xe máy - Bạt 3D che nắng cao cấp",70990,70990,0,0
TIKI,o-to-xe-may-xe-dap,197218624,"Củ cùi đề xe đạp sang líp sau TX-35 6/7/8 speed",135000,135000,0,0
TIKI,o-to-xe-may-xe-dap,183268561,"Xe Đạp Điện DK Sparta",15400000,15400000,0,0
TIKI,o-to-xe-may-xe-dap,30986829,"Máy Hút Bụi Cầm Tay Xe Hơi Và Gia Đình ",299000,299000,0,0
TIKI,lam-dep-suc-khoe,55477587,"Viên Uống Hỗ Trợ Chức Năng Phổi, Phế Quản, Xoang Olympian Labs L3 Support - Hộp 30 Viên",490000,490000,0,0
TIKI,o-to-xe-may-xe-dap,115599656,"Nón Bảo Hiểm 1/2 Đầu Có Kính Protec VIC, Size Lớn, Độ Che Phủ Sâu Hơn",338000,398000,60000,15
TIKI,lam-dep-suc-khoe,31894793,"Tinh Chất Hỗ Trợ Giảm Mụn & Giảm Thâm The Ordinary Niacinamide 10% + Zinc 1% 30ml",228000,350000,122000,35
TIKI,lam-dep-suc-khoe,188127814,"Nước uống collagen thảo dược giúp đẹp da, hỗ trợ ngủ ngon Blossomy Premium lốc 10 chai x 50ml",737000,945000,208000,22
TIKI,o-to-xe-may-xe-dap,185710604,"Gương gắn xe máy Honda,Yamaha",81000,81000,0,0
TIKI,lam-dep-suc-khoe,126102307,"Viên Uống Rau Củ DHC Perfect Vegetable Premium Giúp Tiêu Hoá Tốt, Nâng Cao Sức Khoẻ Gói 60 Viên/120 Viên/360 Viên",155000,155000,0,0
TIKI,o-to-xe-may-xe-dap,26080515,"Chổi lau ô tô - Rửa xe ô tô lụa mềm cao cấp đa chức năng -  điểu chỉnh được độ dài LT132",67000,67000,0,0
TIKI,o-to-xe-may-xe-dap,120214757,"Đầu chốt cài khóa dây an toàn trên ô tô có khe cắm chồng-1 Chiếc",59000,59000,0,0
TIKI,o-to-xe-may-xe-dap,1663701,"Khóa Chìa Xe Đạp Thể Thao Tonyon",74159,74159,0,0
TIKI,o-to-xe-may-xe-dap,53824535,"CHAI XỊT VỆ SINH LÀM SẠCH VÀ TRONG KÍNH LÁI CAO CẤP SONAX CLEAR GLASS 338241 500ML",180000,180000,0,0
TIKI,o-to-xe-may-xe-dap,8075340,"Kính Chiếu Hậu Tròn Gắn Các Loại Xe Máy",45000,45000,0,0
TIKI,lam-dep-suc-khoe,217007520,"Trắng da Glutathione Puritan’s Pride L-Glutathione 500mg Hỗ trợ trắng da, Giảm nám, tàn nhang, Thải độc , Tăng hệ miễn dịch - QuaTangMe Extaste",446000,892000,446000,50
TIKI,lam-dep-suc-khoe,107443285,"Serum Xóa Mụn V9Queen, Giúp Mờ Thâm Nám Dưỡng Trắng Da 20ml",159000,159000,0,0
TIKI,o-to-xe-may-xe-dap,21798216,"Găng Tay Xe Máy",85000,85000,0,0
TIKI,o-to-xe-may-xe-dap,102144190,"Cần số Titan dành cho xe Sirius",89000,89000,0,0
TIKI,lam-dep-suc-khoe,68165960,"Máy tăm nước di động, sạc cảm ứng Golden Care GC-89",999000,999000,0,0
TIKI,o-to-xe-may-xe-dap,124605012,"Phụ Gia Tăng Chỉ Số Octan cho Xăng Bluechem Octane Booster 250ml",245000,245000,0,0
TIKI,o-to-xe-may-xe-dap,24453956,"Bảng số điện thoại gắn táp lô ô tô kiêm giá để điện thoại (Màu ngẫu nhiên)",17000,17000,0,0
TIKI,o-to-xe-may-xe-dap,10713827,"Túi Đựng Đồ Cốp Sau Ô Tô DC-TDD – Hàng Nhập Khẩu",125000,125000,0,0
TIKI,lam-dep-suc-khoe,9800871,"Viên Uống Olympian Labs Green Calcium Bổ Sung Canxi Hữu Cơ Cho Bà Bầu, Trẻ Em, Người Lớn Hộp 100 Viên",510000,510000,0,0
TIKI,o-to-xe-may-xe-dap,68448439,"Tinh dầu thơm xe hơi mô hình máy bay chiến đấu chạy bằng năng lượng mặt trời",137000,189000,52000,28
TIKI,lam-dep-suc-khoe,75933856,"Chì Kẻ Mày 2in1 NoVo Makeup Seduce (Kẻ Mày + Kẻ Mắt)",75000,85000,10000,12
TIKI,o-to-xe-may-xe-dap,84882531,"Nón Bảo Hiểm Xe Đạp Có Kính Protec Win 018, Mũ Bảo Hiểm Xe Đạp Tiêu Chuẩn Châu Âu, Kính Mát, Chống Nắng, Chống Tia UV - Hàng Chính Hãng",499000,568000,69000,12
TIKI,o-to-xe-may-xe-dap,75331538,"Phuộc Sau Gắn CLICK, VARIO, VISION 330mm 01M0169Y, 01M0169R, 01M0169B Hiệu RCB",1300000,1300000,0,0
TIKI,lam-dep-suc-khoe,26710011,"Combo 10 Túi mặt nạ giấy dưỡng ẩm -Mặt nạ dưỡng da chiết xuất từ lô hội 3W Clinic Hàn Quốc 23mlx10",52000,52000,0,0
TIKI,lam-dep-suc-khoe,68698970,"Nước Súc Miệng Cai Thuốc Lá Xuân Vinh 400ml - Làm mất cảm giác thèm thuốc, ngăn ngừa các bệnh về răng miệng, thành phần thiên nhiên, an toàn + Tặng kèm móc khoá CLĐ",189000,320000,131000,41
TIKI,o-to-xe-may-xe-dap,178089418,"Sprayking Super Wash 1L nước rửa xe tạo bọt tuyết, xà phòng rửa xe siêu sáng bóng ",69000,69000,0,0
TIKI,lam-dep-suc-khoe,104745477,"Tăng Cường Sinh Lý Nam Supo Maca Genki Fami Nhật Bản, Chiết Xuất Nhân Sâm, Baba, Hàu Biển - Hộp 90 viên",743000,830000,87000,10
TIKI,o-to-xe-may-xe-dap,190754301,"Nâng ghế lái Xpander ( i10) và nhiều dòng xe Loại 5cm _ Bộ 4 cái",250000,250000,0,0
TIKI,o-to-xe-may-xe-dap,127123702,"Mỡ Bò Chống Nước Maxima WaterProof Grease 454g Đa Năng Chịu Nhiệt Độ Và Áp Suất Cao",280000,280000,0,0
TIKI,o-to-xe-may-xe-dap,72642551,"Bơm xe máy  - Bơm xe đạp chân - Bơm đạp chân 2 ống đa năng - Bơm hơi đạp chân mini cho ô tô, xe máy, xe đạp, bơm bóng, phao bơi",225000,225000,0,0
TIKI,o-to-xe-may-xe-dap,62874426,"NƯỚC RỬA KÍNH Ô TÔ CHUYÊN DỤNG [5 Lít] ",209000,229000,20000,9
TIKI,o-to-xe-may-xe-dap,38716521,"Thảm sàn, lót sàn cao su không mùi Cao cấp dành cho xe KIA Morning 2012-2019",458000,458000,0,0
TIKI,o-to-xe-may-xe-dap,88821558,"Miếng lót đệm bọc yên xe đạp (Màu đỏ) chất liệu bọt biển siêu êm giảm trượt thiết kế thoáng khí thoát mồ hôi tặng kèm chuông kiêm la bàn dành cho xe đạp (Màu Ngẫu Nhiên)",35400,35400,0,0
TIKI,o-to-xe-may-xe-dap,8047878,"Gương chiếu hậu 5 cạnh có chân gập",74000,135000,61000,45
TIKI,o-to-xe-may-xe-dap,172842303,"Tẩu đực cắm lỗ sạc trên ô tô (Không cầu chì)",33000,33000,0,0
TIKI,lam-dep-suc-khoe,67195678,"Trà Genpi Orihiro 60 gói/túi",165000,300000,135000,45
TIKI,o-to-xe-may-xe-dap,1254635,"Dung Dịch Vệ Sinh Hệ Thống Xăng Cho Mô Tô Xe Máy Bluechem Fuel Sysem Cleaner (50ml)",80000,85000,5000,6
TIKI,o-to-xe-may-xe-dap,158021789,"Bộ 2 gương lồi tràn viền xoay 360 độ gắn cho kính gương chiếu hậu tránh điểm mù cho xe Hơi, Xe Ô tô - Hàng nhập khẩu",89000,89000,0,0
TIKI,o-to-xe-may-xe-dap,5485879,"Chai xịt bóng nhanh dùng cho sơn bóng, sơn mờ, wrap Sonax Xtreme Brilliant Shine Detailer 287400 750ml",229000,240000,11000,5
TIKI,o-to-xe-may-xe-dap,110885061,"Miếng Dán Chống Trầy Xước Hõm Cửa Xe Hơi/Tay Nắm Cửa Xe Hơi/Gương Chiếu Hậu Xe Hơi Cho Logo Nhiều Hãng Xe [Hàng Loại Tốt",54000,54000,0,0
TIKI,o-to-xe-may-xe-dap,184414971,"Túi Smilebox đựng thẻ, tiền, mắt kính, giấy tờ xe treo tấm chắn nắng của ô tô, xe hơi nhiều ngăn",159000,159000,0,0
TIKI,o-to-xe-may-xe-dap,48248987,"Ghế ngồi trước em bé xe Wave Greennetwoks",180000,180000,0,0
TIKI,o-to-xe-may-xe-dap,53470955,"Gắp nhôm cho xe wave drem sirius DBS tặng bao tay xe máy",480000,480000,0,0
TIKI,o-to-xe-may-xe-dap,83347621,"Nón bảo hiểm 3/4 ROYAL M139 có kính âm V5 ĐEN",570000,730000,160000,22
TIKI,o-to-xe-may-xe-dap,13293809,"Bộ 2 Tấm Chắn Bùn Xe Đạp Thể Thao Cao Cấp AZONE",44500,89000,44500,50
TIKI,o-to-xe-may-xe-dap,116409215,"Bao da dành cho chìa khoá Mercedes phom cũ handmade da thật 001",199000,199000,0,0
TIKI,o-to-xe-may-xe-dap,92154071,"Chân Đế Xoay 360 Gắn Camera Hành Trình Ô Tô, Go Pro, Ezviz Sports, SJ Cam 6mm Loại To",80000,80000,0,0
TIKI,o-to-xe-may-xe-dap,142870880,"Cao su bọc cần số xe máy để không bị hư giày khi móc côn",15000,15000,0,0
TIKI,o-to-xe-may-xe-dap,15413517,"Đĩa thắng xe máy Future 1",118000,118000,0,0
TIKI,thoi-trang-nu,53838863,"Dây câu bình ắc quy ô tô dài 4m dòng 2500A",195000,195000,0,0
TIKI,thoi-trang-nu,96615231,"Bơm xe đạp xe máy 180psi/12kg GIYO 2730 thân thép đồng hồ siêu to",440000,440000,0,0
TIKI,thoi-trang-nu,1176233,"Bình Súc Béc Xăng Liqui Moly 1803 (300ml)",165000,165000,0,0
TIKI,o-to-xe-may-xe-dap,41592916,"Bộ Máy Bơm Lốp Ô Tô, Xe Hơi Kèm Phụ Kiệm Ứng Cứu Sửa Chữa Cao Cấp BL-01",498000,498000,0,0
TIKI,o-to-xe-may-xe-dap,115622402,"Tấm cách âm 3M ACOUSTIC 3 lớp màu đen và 2 lớp màu vàng siêu chống ồn hàng nhập",105000,105000,0,0
TIKI,o-to-xe-may-xe-dap,118299663,"Gương chiếu hậu xe đạp DX-002 - GƯƠNG CẦU LỒI XE ĐẠP 360 ĐỘ (chiếc)",50652,50652,0,0
TIKI,o-to-xe-may-xe-dap,78290547,"Cục nhôm đôn nâng phuộc sau xe máy Green Networks Group ( 1 Cặp )",59000,59000,0,0
TIKI,thoi-trang-nu,49983451,"cảng sau kiểu MiO dùng cho xe sirius màu đen",114000,114000,0,0
TIKI,thoi-trang-nu,2185043,"Nón Bảo Hiểm Giro Isode",1100000,1100000,0,0
TIKI,thoi-trang-nu,96911021,"Bộ 4 ốc - nắp chụp chân van, đầu vòi xe hơi, xe máy, ô tô chất lượng cao chống rỉ nhiều màu",10000,17500,7500,43
TIKI,o-to-xe-may-xe-dap,150494511,"Sạc điện thoại trên xe máy 3in1 kèm đồng hồ báo vôn- báo nhiệt độ đa năng loại tốt màn hình led",169000,169000,0,0
TIKI,thoi-trang-nu,52110803,"Phụ gia nhớt súc rửa động cơ cao cấp Liqui Moly 2427 - Tặng kèm 1 khăn lau chuyên dụng 3M",239000,239000,0,0
TIKI,o-to-xe-may-xe-dap,151615669,"Ốp dè chắn bùn ex 155 -150 titan bản đặc biệt siêu dày chắc chắn hàng cao câp chống rung lắc",178000,178000,0,0
TIKI,o-to-xe-may-xe-dap,194788781,"Bộ kích điện xe ô tô khẩn cấp Xiaomi 70Mai 11100 mAh- kích điện oto-Cứu hộ xe hơi Car Jump Starter",1800000,1800000,0,0
TIKI,o-to-xe-may-xe-dap,14975706,"Bạt phủ chống nắng kính lái loại lớn dùng cho mọi loại xe ô tô",190000,190000,0,0
TIKI,thoi-trang-nu,104799820,"Chai xịt bảo dưỡng cao su, ron cửa và lốp xe ô tô nhãn hiệu Sonax 340200 dung tích 300 ml - Hàng Chính Hãng",274000,274000,0,0
TIKI,thoi-trang-nu,4405975,"Ruột xe đạp Impac 26’’ AV (40mm)",69000,69000,0,0
TIKI,thoi-trang-nu,68448439,"Tinh dầu thơm xe hơi mô hình máy bay chiến đấu chạy bằng năng lượng mặt trời",137000,189000,52000,28
TIKI,o-to-xe-may-xe-dap,174450787,"Máy Lọc Không Khí Xe Hơi Tạo Plasmacluster ion Sharp IG-GC2E-B - Màu Đen - Hàng chính hãng",2130000,2700000,570000,21
TIKI,o-to-xe-may-xe-dap,1565453,"Chai xịt tăng độ bóng sơn ô tô 3M 39034 LT 3M Gloss Enhancer 400ml",169000,169000,0,0
TIKI,o-to-xe-may-xe-dap,138892730,"Vỏ Lốp Camel cho xe Vario-Vision-AB-Noja-14 in Không Ruột-gai 635",348000,348000,0,0
TIKI,o-to-xe-may-xe-dap,17039165,"Lá Thơm Xe AREON BLUE CRYSTAL - Pha Lê Xanh (Nam tính)",71250,75000,3750,5
TIKI,thoi-trang-nu,26080515,"Chổi lau ô tô - Rửa xe ô tô lụa mềm cao cấp đa chức năng -  điểu chỉnh được độ dài LT132",67000,67000,0,0
TIKI,o-to-xe-may-xe-dap,92084838,"Led Đuôi Sau Xe Đạp BK820 100Lumens Led COB 4 Chế Độ Có Đèn Phanh Cảm Biến Thông Minh Gia Tốc Sạc USB Chống Nước và Bụi Bẩn Cho Xe Đạp Thể Thao MaiLee",227050,239000,11950,5
TIKI,thoi-trang-nu,184518746,"Miếng dán decal nắp bình xăng dầu cho xe oto Oil-8",19000,19000,0,0
TIKI,thoi-trang-nu,31843672,"Dầu Bôi Trơn Chống Rỉ Sét Làm Sạch Thẩm Thấu Chống Ẩm Bảo Vệ WD-40 (300ml)",100000,100000,0,0
TIKI,thoi-trang-nu,139718328,"Bạt che phủ bảo vệ ô tô xe hơi 4 chỗ, 5 chỗ, 7 chỗ vải Dù cao cấp siêu bền chống xước, chống nắng nóng, chống cháy, chống mưa, chống bụi bẩn",430000,430000,0,0
TIKI,o-to-xe-may-xe-dap,107353581,"[CHÍNH HÃNG] 2 CHAI 500ML: XWash - Xịt tẩy rửa, khử mùi nội thất ô tô KHÔNG HÓA CHẤT - Tặng khăn lông cừu cao cấp",799000,799000,0,0
TIKI,thoi-trang-nu,108204619,"{TẶNG ỐC CHÂN GƯƠNG} Gương (kính) chiếu hậu Rizoma 5 cạnh nhôm CNC cao cấp  Màu xanh dành cho các dòng xe máy - TKA-DG66xanh",108000,176000,68000,39
TIKI,o-to-xe-may-xe-dap,41296396,"Bình chữa cháy Mini cho ô tô FMS-25 1000ml",128000,128000,0,0
TIKI,o-to-xe-may-xe-dap,73873352,"Dụng Cụ Bảo Dưỡng Kiểm Tra Sên Xích Xe Đạp, Đo Độ Mòn Xích, Vam Sên Cắt Tháo Mắt Sên Và Kềm Cắt Dây Xích Chuyên Dụng Cho Xe Đạp Mai Lee (3 món)",189050,199000,9950,5
TIKI,thoi-trang-nu,271997504,"Yên Xe Đạp Phoenix Êm Ái Chống Nước Phù Hợp Với Mọi Dòng Xe Đạp Thể Thao Địa Hình",250000,250000,0,0
TIKI,thoi-trang-nu,124605012,"Phụ Gia Tăng Chỉ Số Octan cho Xăng Bluechem Octane Booster 250ml",245000,245000,0,0
TIKI,thoi-trang-nu,138387597,"Bộ vam tháo vòng bi 2 đĩa chặn, bộ cảo bi kiểu bán nguyệt",750000,750000,0,0
TIKI,thoi-trang-nu,21798216,"Găng Tay Xe Máy",85000,85000,0,0
TIKI,thoi-trang-nu,801326,"Máy Lọc Không Khí Cho Xe Hơi Sharp IG-GC2E-B - Đen - Hàng chính hãng",2130000,2190000,60000,3
TIKI,thoi-trang-nu,83347244,"Nón bảo hiểm 3/4 ROYAL M139 có kính âm màu ĐỎ ĐÔ",540000,700000,160000,23
TIKI,thoi-trang-nu,88821558,"Miếng lót đệm bọc yên xe đạp (Màu đỏ) chất liệu bọt biển siêu êm giảm trượt thiết kế thoáng khí thoát mồ hôi tặng kèm chuông kiêm la bàn dành cho xe đạp (Màu Ngẫu Nhiên)",35400,35400,0,0
TIKI,thoi-trang-nu,208212997,"Mũ bảo hiểm lỗ thông gió NÓN SƠN chính hãng TG-XM151",340000,650000,310000,48
TIKI,thoi-trang-nu,1663701,"Khóa Chìa Xe Đạp Thể Thao Tonyon",74159,74159,0,0
TIKI,o-to-xe-may-xe-dap,184410429,"Ốp Khóa, Ốp Chìa Khóa, Ốp Bảo Vệ Khóa Xe Vinfast Fadil, Vinfast Lux Hợp Kim Kẽm",209000,279000,70000,25
TIKI,thoi-trang-nu,127123702,"Mỡ Bò Chống Nước Maxima WaterProof Grease 454g Đa Năng Chịu Nhiệt Độ Và Áp Suất Cao",280000,280000,0,0
TIKI,thoi-trang-nu,75982771,"Bộ gù chống đổ Trước Sau xe máy - Combo Gù chống đổ Trước và Gù chống đổ Sau Green Networks Group",159000,159000,0,0
TIKI,o-to-xe-may-xe-dap,157146609,"Ốp Bảo Vệ Chìa Khóa Dành Cho Xe Honda Civic, City, CRV, HRV, Brio, Accord Hợp Kim Kẽm Cao Cấp",209000,219000,10000,5
TIKI,o-to-xe-may-xe-dap,23442303,"Phụ Kiện Tay Cầm Đa Năng Ghế Sau Ô Tô Móc Treo Đồ Đa Năng Xe Hơi Tay Nắm An Toàn Cho Người Già, Trẻ Em",89000,89000,0,0
TIKI,lam-dep-suc-khoe,101034119,"Dung dịch vệ sinh nam Serenys Optimus làm sạch khử mùi làm sáng phụ khoa nam giới",299000,299000,0,0
TIKI,o-to-xe-may-xe-dap,89951675,"Combo 5 Cái Khăn lau chuyên dụng siêu mềm thấm hút tốt, lau rửa xe ô tô, dùng trong spa..",74700,74700,0,0
TIKI,thoi-trang-nu,8075340,"Kính Chiếu Hậu Tròn Gắn Các Loại Xe Máy",45000,45000,0,0
TIKI,o-to-xe-may-xe-dap,193643505,"Bộ 9 miếng dán bậc cửa trong ngoài và Cốp Sau Ô tô Chống trầy bằng Sợi Carbon ( chọn mẫu)",119000,119000,0,0
TIKI,o-to-xe-may-xe-dap,155833203,"Nước Làm Mát Pha Sẵn Màu Đỏ Liqui Moly 6924 1L",185000,185000,0,0
TIKI,lam-dep-suc-khoe,196857628,"Tinh Dầu Kiwi Homer 100ml - Tinh Dầu Xông Thơm Phòng, Thư Giãn Khử Mùi - Tinh Dầu Trái Cây Thiên Nhiên",79000,79000,0,0
TIKI,thoi-trang-nu,14563208,"Nón bảo hiểm ¾ GRS A318K kính dài",580000,580000,0,0
TIKI,o-to-xe-may-xe-dap,119624961,"Chốt cài khóa dây an toàn trên ô tô bằng thép có thương hiệu xe 1 chiếc",41999,41999,0,0
TIKI,o-to-xe-may-xe-dap,13384939,"Cốc Đun Nước Bằng Tẩu Sạc Trên Ô Tô AZONE",137750,145000,7250,5
TIKI,o-to-xe-may-xe-dap,69657128,"Bộ 2 Dung dịch chống bám nước trên kính xe 3M 08889LT và dung dịch rửa kính ô tô 3M 08888",281000,299000,18000,6
TIKI,thoi-trang-nu,54626236,"Dầu nhớt Mobil 5W30 EP 946ml - Chính hãng Mobil nhập khẩu từ Mỹ",295000,295000,0,0
TIKI,thoi-trang-nu,84882531,"Nón Bảo Hiểm Xe Đạp Có Kính Protec Win 018, Mũ Bảo Hiểm Xe Đạp Tiêu Chuẩn Châu Âu, Kính Mát, Chống Nắng, Chống Tia UV - Hàng Chính Hãng",499000,568000,69000,12
TIKI,o-to-xe-may-xe-dap,157146259,"Bộ 4 Miếng Dán Nano Chống Đọng Nước Gương, Kính Ô Tô (Loại 1)",25000,25000,0,0
TIKI,thoi-trang-nu,172842303,"Tẩu đực cắm lỗ sạc trên ô tô (Không cầu chì)",33000,33000,0,0
TIKI,lam-dep-suc-khoe,51420955,"Kem chống lão hóa chuyên sâu chứa Retinol và Bakuchiol- 8015",1445000,1699000,254000,15
TIKI,o-to-xe-may-xe-dap,50116790,"Tẩu Nghe Nhạc MP3  Bluetooth X8 Trên Xe Hơi Cao Cấp Kèm Sạc Nhanh 3.1A",145000,145000,0,0
TIKI,thoi-trang-nu,119719000,"Sạc Ắc Quy Tự Động AST 10A 12V, Bộ sạc bình ắc quy từ 3ah - 200ah, sạc bình ắc quy cho xe máy đến ô tô",1181000,1181000,0,0
TIKI,thoi-trang-nu,115707800,"Bao tay nắm chống mỏi xe đạp siêu êm",36000,39000,3000,8
TIKI,thoi-trang-nu,5434623,"Baga trước dành cho xe Exciter 150 dày 10 ly",110000,110000,0,0
TIKI,thoi-trang-nu,154173062,"Lót cốp dành cho xe Honda City 2021 không mùi, chất liệu TPO cao cấp",315000,315000,0,0
TIKI,o-to-xe-may-xe-dap,114984646,"Mũ bảo hiểm xe đạp người lớn, nón bảo hiểm xe đạp Protec Win 002 tiêu chuẩn Châu Âu, thời trang, cá tính, an toàn- Hàng Chính Hãng",389000,479000,90000,19
TIKI,lam-dep-suc-khoe,105622045,"Bộ 3 Bao Cao Su Durex Fetherlite – Hộp 12 bao",597000,828000,231000,28
TIKI,thoi-trang-nu,178089418,"Sprayking Super Wash 1L nước rửa xe tạo bọt tuyết, xà phòng rửa xe siêu sáng bóng ",69000,69000,0,0
TIKI,lam-dep-suc-khoe,33254716,"Kem dưỡng ẩm chống nắng ban ngày Hada Labo Koi-Gokujyun UV White Gel SPF50+ PA++++ 90g",415000,415000,0,0
TIKI,lam-dep-suc-khoe,82107182,"Bộ Dao Cạo Râu 38 Món",28000,28000,0,0
TIKI,lam-dep-suc-khoe,73609586,"Máy xông tinh dầu VINBUY bầu tiên, máy phun sương tạo ẩm, máy xông tinh dầu phòng ngủ, spa, tự động, chuyên dụng phòng lớn led 07 màu - Hàng chính hãng",250000,500000,250000,50
TIKI,thoi-trang-nu,133431341,"Thùng đựng đồ gấp gọn để đồ trên ô tô, xe hơi, văn phòng, gia đình 45L và 75L có nhiều ngăn đựng riêng bi",368000,400000,32000,8
TIKI,lam-dep-suc-khoe,71161537,"[ MUA 1 TẶNG 1] Viên ăn ngon Multi Vitamin Plus hộp 30 viên_ Hỗ trợ cải thiện biếng ăn, cải thiện cân nặng, giúp ăn ngon ngủ ngon, tăng cường sức đề kháng",485000,485000,0,0
TIKI,lam-dep-suc-khoe,103757761,"Khẩu Trang Y Tế Cao Cấp SUN CLOUD - 4 Lớp Kháng Khuẩn / 99% Lọc Khuẩn, Bụi, Virus Tốt Nhất / Người Lớn",29800,29800,0,0
TIKI,lam-dep-suc-khoe,273457539,"Đệm Massage Toàn Thân VP-N20D - Máy Massage Chất Liệu Da Cao Cấp, Công Nghệ Massage Hiện Đại 10 Điểm Rung Kết hợp Nhiệt Hồng Ngoại Và Bi Massage Cổ VaI, Gáy",1336000,1699000,363000,21
TIKI,lam-dep-suc-khoe,214691217,"Nước hoa nam chính hãng Nerman - hương thơm nhẹ nhàng, tinh tế thu hút nữ giới, phù hợp đi hẹn hò, đi chơi, đi làm lưu hương tới 8h 10ml",109000,218000,109000,50
TIKI,thoi-trang-nu,141917212,"Băng dính 3m 2 mặt trong suốt Acrylic Foam Tapes AFT - Băng keo 3m chuyên dụng ô tô siêu chắc",18000,18000,0,0
TIKI,lam-dep-suc-khoe,55108914,"Combo 2 Sữa Tắm Cherry Blossom 500ml - L'amont En Provence",189000,298000,109000,37
TIKI,lam-dep-suc-khoe,190641510,"Sữa Rửa Mặt Dịu Nhẹ Cho Da Dầu CeraVe Foaming Cleanser 236ml",289000,340000,51000,15
TIKI,lam-dep-suc-khoe,270845561,"Collagen Type 1,2,3 Youtheory Mỹ tăng độ đàn hồi da, đẹp tóc, móng, duy trì sức khỏe sụn, gân, dây chằng, khớp - QuaTangMe Extaste",471400,1074000,602600,56
TIKI,lam-dep-suc-khoe,196560436,"Tinh Dầu Hoa Mộc Lan Homer 100ml - Chính Hãng, Đạt Chuẩn Kiểm Định Cao Cấp - Tinh Dầu Xông Thơm Phòng, Thư Giãn, Khử Mùi hiệu quả",119000,119000,0,0
TIKI,lam-dep-suc-khoe,11239286,"Gel tẩy da chết Arrahan Lemon White Peeling Gel (180ml)",61900,61900,0,0
TIKI,lam-dep-suc-khoe,143222291,"Kem Đánh Răng Crest 3D White Advanced 147gr",139000,139000,0,0
TIKI,lam-dep-suc-khoe,161234656,"Tinh chất làm mờ thâm nám và đều màu da tối ưu Paula's Choice Clinical Discoloration Repair Serum 30ml 8040",1279000,1599000,320000,20
TIKI,lam-dep-suc-khoe,94474520,"Cây Lấy Khóe Đầu Nhọn Inox Hỗ Trợ Móc Khóe và Vệ Sinh Khóe KỀM NGHĨA",8000,8000,0,0
TIKI,lam-dep-suc-khoe,12421675,"Son lì lâu trôi không khô môi hàng nội địa Nhật Bản cao cấp Naris Cosmetic Ailus Smooth Lipstick Long Lasting – Hàng Chính Hãng",175000,175000,0,0
TIKI,o-to-xe-may-xe-dap,35129432,"Thảm Nhựa Lót Cốp Sau Dành Cho Xe Ô Tô Honda City",302000,302000,0,0
TIKI,lam-dep-suc-khoe,75409313,"Tinh Dầu Lavender Cao Cấp Nhập Khẩu 10ML, Tinh Dầu Xông Phòng Oải Hương Giúp Thư giản, Khử Trùng Và Bảo Vệ Sức Khỏe, Sử Dụng Với Máy Xông Tinh Dầu Cho Gia Đình Và Văn Phòng",38000,116000,78000,67
TIKI,lam-dep-suc-khoe,273010004,"Hỗ trợ giảm đau nhức xương khớp Schiff Move Free Mỹ nâng cao sức khỏe khớp, sụn và xương, tăng khả năng vận động linh hoạt thoải mái-QuaTangMe Extaste",734400,1530000,795600,52
TIKI,thoi-trang-nu,10713827,"Túi Đựng Đồ Cốp Sau Ô Tô DC-TDD – Hàng Nhập Khẩu",125000,125000,0,0
TIKI,lam-dep-suc-khoe,169812757,"Sữa chống nắng mỏng nhẹ lâu trôi giúp bảo vệ da tối ưu khỏi tia UVA dài La Roche-Posay Anthelios Uvmune 400 Invisible Fluid 50ml",448000,560000,112000,20
TIKI,lam-dep-suc-khoe,160762447,"Tinh Dầu Oải Hương Treo Phòng, Treo Xe ô tô (Lavender) Chính Hãng TIDAMO Giúp Thơm Thư giản, Kháng Khuẩn Và Bảo Vệ Sức Khỏe",38000,76000,38000,50
TIKI,thoi-trang-nu,116396323,"Quạt đôi ô tô công suất lớn xoay 360 độ 3 tốc độ gió chân cắm usb dùng cho ô tô ,bàn làm việc máy tính F303",189000,189000,0,0
TIKI,lam-dep-suc-khoe,160534770,"Kem Đa Năng Lucas Papaw Ointment 25g(Hàng nội địa Úc)",128000,185000,57000,31
TIKI,lam-dep-suc-khoe,192325645,"Viên uống WIT bổ mắt (60 viên)",590000,590000,0,0
TIKI,lam-dep-suc-khoe,66786807,"Trunature Ginkgo Biloba 340 Viên hàng Mỹ - Mẫu 2020",465000,465000,0,0
TIKI,lam-dep-suc-khoe,196562071,"Tinh Dầu Linh Lan Homer 100ml - Chính Hãng, Đạt Chuẩn Kiểm Định Cao Cấp - Tinh Dầu Xông Thơm Phòng, Thư Giãn, Khử Mùi hiệu quả",129000,129000,0,0
TIKI,lam-dep-suc-khoe,22052322,"Sữa rửa mặt cho nam Oxy sạch sâu giảm nhờn dạng kem có hạt massage Oxy Deep Wash 100g",70000,86000,16000,19
TIKI,lam-dep-suc-khoe,68553320,"Tinh bột nghệ nguyên chất Beemo - Đắp mặt, điều trị dạ dày đau bao tử, làm viên tinh nghệ mật ong",69000,105000,36000,34
TIKI,lam-dep-suc-khoe,62758138,"Kem dưỡng giúp làm dịu, làm mượt, làm mát & phục hồi da phù hợp cho trẻ em La Roche-Posay Cicaplast Baume B5 100ml",532000,665000,133000,20
TIKI,lam-dep-suc-khoe,8294948,"Thực phẩm chức năng Viên uống bổ sung Collagen Youtheory (Collagen Type 1-2-3) 390 Viên",549000,549000,0,0
TIKI,lam-dep-suc-khoe,73517801,"Kem Dưỡng Trắng Da Chống Nắng Ban Ngày Oribe Chống Lão Hóa Mờ Thâm Nám Dưỡng Ẩm 30g",247000,320000,73000,23
TIKI,lam-dep-suc-khoe,71925436,"Mặt nạ ngủ dạng thạch Collagen nâng cơ chính hãng YANJIAYI (Hộp 20 gói)",48000,95000,47000,49
TIKI,lam-dep-suc-khoe,16994625,"Tinh dầu để thơm phòng hương thơm dễ chịu và rất là thơm khử được mọi loại mùi",24000,24000,0,0
TIKI,lam-dep-suc-khoe,50017132,"Cây Massage Đầu Thư  Giản Xả Stress - Màu Ngẫu Nhiên",3900,3900,0,0
TIKI,lam-dep-suc-khoe,77543516,"Son lì Bbia Last Powder Lipstick 3.5g ( 6 màu )",160000,290000,130000,45
TIKI,lam-dep-suc-khoe,108535195,"Bao cao su Sagami Feel Long - Có gai nhỏ - Hộp 10 chiếc",95000,120000,25000,21
TIKI,lam-dep-suc-khoe,15456663,"Titan Gel phiên bản Gold giới hạn giúp tăng kích thước, kéo dài thời gian, tăng ham muốn cho nam giới (hàng chuẩn Nga)",290000,290000,0,0
TIKI,lam-dep-suc-khoe,76369248,"Tinh Dầu Ngọc Lan Tây Nguyên Chất 50ML TIDAMO (Ylang Ylang) - Tinh Dầu Cao Cấp Nhập Khẩu Từ Ấn Độ, Xông Hương Thơm Phòng, Thư Giãn, Nâng Cao Sức Khỏe - Kiểm Nghiệm Chất Lượng Tại Trung Tâm Quatest 3",128000,256000,128000,50
TIKI,thoi-trang-nu,6941827,"Bộ 2 Gù chống đổ sau cho xe máy ( xanh dương )",45000,45000,0,0
TIKI,thoi-trang-nu,150493582,"Thiết bị đồng hồ đo áp suất lốp ô tô xe máy mini treo móc khóa đa năng tiện dụng màn hình led mẫu mới loại tốt",136000,136000,0,0
TIKI,thoi-trang-nu,1176131,"Nhớt Xe Máy 4T Synth 10W50 Race Liqui Moly 1502 (1L)",309000,309000,0,0
TIKI,thoi-trang-nu,44874923,"Gối Tựa Đầu AM01 Trên Xe Hơi - NHIỀU MÀU",75000,75000,0,0
TIKI,thoi-trang-nu,21726245,"Công tắc hazar chớp nháy 4 bóng xi nhan",35000,35000,0,0
TIKI,thoi-trang-nu,97979802,"Bọc da vô lăng ô tô thể thao loại tốt bám tay thiết kế đẹp mắt phù hợp các loại xe phổ thông",128690,128690,0,0
TIKI,thoi-trang-nu,30150394,"Tem xe ô tô thể thao Transformer",229000,229000,0,0
TIKI,thoi-trang-nu,22475700,"Bộ Tay công vặn lốp xe 04 đầu lục giác",103000,103000,0,0
TIKI,thoi-trang-nu,15285822,"Bộ 4 nắp chụp chân van, đầu vòi xe hơi, xe máy, ô tô",9800,9800,0,0
TIKI,thoi-trang-nu,48332376,"DUNG DỊCH VỆ SINH BUỒNG ĐỐT ICHINEN NX5000 240ml (JAPAN) - 1 chai",185000,185000,0,0
TIKI,thoi-trang-nu,529457,"Xi Đánh Bóng Cana 220G",70000,70000,0,0
TIKI,thoi-trang-nu,116875498,"Còi Điện Xe Đạp 120dB Chống Mưa Gắn Tay Lái Xe Đạp",95000,95000,0,0
TIKI,thoi-trang-nu,1237295,"Bàn Chải Vệ Sinh Sên Chuyên Nghiệp",16000,16000,0,0
TIKI,thoi-trang-nu,140009099,"Bộ Hộp Dụng Cụ Vá Lốp Xe Lốp Không Săm Vá Lụi (vá ngoài) Bằng Thép Không Gỉ Cho Xe Oto, Xe Hơi Và Xe Máy",150000,202050,52050,26
TIKI,thoi-trang-nu,96910538," MÓC TREO ĐỒ TRÊN Ô TÔ",12512,13600,1088,8
TIKI,thoi-trang-nu,3308227,"Combo 2 Chai Xịt Thơm Phòng Khử Mùi Hàn Quốc Hương Cafe Hazelnut 370ml cho xe hơi (Nâu)",105000,105000,0,0
TIKI,thoi-trang-nu,142904077,"DUNG DỊCH VỆ SINH NỘI THẤT Ô TÔ H25 (5 Lit)",369000,379000,10000,3
TIKI,thoi-trang-nu,142871814,"Túi treo đầu xe máy Pro-Biker",210000,210000,0,0
TIKI,o-to-xe-may-xe-dap,22753760,"Bộ 5 Tấm Lưới Chắn Nắng Chống Nóng Ô Tô - Chắn Nắng Hiệu Quả",69000,69000,0,0
TIKI,thoi-trang-nu,147371419,"Bạt Phủ Ô Tô - Bạt Trùm Xe Ô Tô 3 Lớp Vải Dù Cao Cấp Chống Mưa, Chống Nắng, Chống Cháy",257600,280000,22400,8
TIKI,thoi-trang-nu,31962521,"Thảm sàn, lót sàn cao su 3D không mùi Cao cấp dành cho xe Ford Everest 2016-2019",685000,685000,0,0
TIKI,o-to-xe-may-xe-dap,18003631,"Thùng, hộp đựng đồ co giãn trên Ô tô, Xe hơi - thể tích 40L",224000,224000,0,0
TIKI,thoi-trang-nu,126097513,"Lót cốp nhựa ô tô cho dòng xe mazda 3D CX5 2019+",321000,321000,0,0
TIKI,thoi-trang-nu,49543118,"Phủ Nano Kính Ô Tô Đa Năng Glaco Blave G-100 Soft99 Japan",239000,239000,0,0
TIKI,o-to-xe-may-xe-dap,135344276,"NƯỚC HOA XE HƠI NHẬP KHẨU CAO CẤP TRANG TRÍ, KHỬ MÙI, LÀM THƠM XE HƠI | CỬA HÀNG NƯỚC HOA Ô TÔ LEVISTORE",429000,650000,221000,34
TIKI,o-to-xe-may-xe-dap,139444838,"Sạc độ xe máy HSB -Shilan cực mạnh thông minh tự ngắt khi đầy điều chỉnh dòng sạc loại tốt",141550,149000,7450,5
TIKI,thoi-trang-nu,52614788,"Khóa u siêu chống cắt chính hãng ABUS - CHLB Đức tặng khóa tủ cá nhân",511000,549000,38000,7
TIKI,thoi-trang-nu,77015395,"Gương cầu lồi 360 độ cao cấp dành cho ô tô ACP-035",19000,19000,0,0
TIKI,thoi-trang-nu,65466769,"Gía đỡ điện thoại gắn taplo hoặc kính lái ô tô nhãn hiệu Baseus SUYL-JY01 - Khóa, mở tự động",325000,325000,0,0
TIKI,thoi-trang-nu,6501581,"Bạt phủ ô tô cách nhiệt cao cấp, bạt trùm xe hơi, chống nóng, chống nước vân 3D",180969,180969,0,0
TIKI,thoi-trang-nu,171468901,"(Đèn 3 IN 1) Đèn xe đạp siêu sáng đa năng có Đồng hồ đo tốc độ và Còi cao cấp",299000,299000,0,0
TIKI,o-to-xe-may-xe-dap,116014096,"Combo 4 miếng dán gương ôtô(chống bám nước)",45000,45000,0,0
TIKI,thoi-trang-nu,27851066,"Máy Hút Bụi Xe Hơi, Gia Đình Cầm Tay",309000,309000,0,0
TIKI,thoi-trang-nu,55323617,"Mũ Bảo Hiểm Trẻ Em 1/2 Đầu Có Kính Protec Kitty Họa Tiết Nữ Hoàng Băng Giá Frozen Thời Trang, An Toàn, Chất Lượng - Hàng Chính Hãng - Màu Xanh",368000,442000,74000,17
TIKI,thoi-trang-nu,57109174,"Mỡ cao cấp Mobilgrease XHP 222 - nhập khẩu từ Mỹ",139000,139000,0,0
TIKI,o-to-xe-may-xe-dap,46307104,"Khung kẹp xoay dọc ngang kẹp điện thoại, ipad treo thanh tựa đầu sau ghế xe hơi, ô tô và điều chỉnh máy theo góc nhìn",185000,185000,0,0
TIKI,thoi-trang-nu,182139552,"Đồ Trang Trí Xe Hơi Chú Chó Lắc Đầu Đáng Yêu",61750,65000,3250,5
TIKI,o-to-xe-may-xe-dap,119252927,"Bơm lốp KO DÂY Suitu, bơm ô tô, bơm xe máy, bơm xe đạp Suitu, pin sạc siêu khỏe 6000Mah,- SẠC USB tiện lợi",465000,465000,0,0
TIKI,o-to-xe-may-xe-dap,176681268,"Ốp Bảo Vệ Chìa Khóa Xe Toyota Cross Hợp Kim Kẽm",190000,190000,0,0
TIKI,o-to-xe-may-xe-dap,131192839,"Cảng Vision SH 300i nhôm đúc đời 2014-2020",329000,329000,0,0
TIKI,o-to-xe-may-xe-dap,111000260,"Bao tay rửa xe 2 mặt chuyên dụng Găng Tay Rửa Xe loại dày",15000,15000,0,0
TIKI,o-to-xe-may-xe-dap,162247197,"Bạt Phủ Xe Máy, Áo Trùm Xe Vải Dù Che Mưa, Che Nắng, Bảo Vệ Xe _ Vừa Với Tất Cả Các Loại Xe Máy AM14",105000,105000,0,0
TIKI,o-to-xe-may-xe-dap,62747178,"Mũ Bảo Hiểm Nửa Đầu Có Kính Cao Cấp Protec Hiway Họa Tiết Đen Xanh Tem Hình COOL Ngầu (Mẫu Mới) - Hàng Chính Hãng",389000,498000,109000,22
TIKI,thoi-trang-nu,153941018,"Thảm sàn, lót sàn cao su 3D cho Hyundai Santafe 2019",688000,688000,0,0
TIKI,o-to-xe-may-xe-dap,10685866,"Tấm bạt phủ xe máy",39000,39000,0,0
TIKI,o-to-xe-may-xe-dap,83346764,"Nón bảo hiểm 3/4 ROYAL M139 có kính âm V10 TRẮNG",570000,730000,160000,22
TIKI,o-to-xe-may-xe-dap,119307757,"Bộ tay công vặn ốc tháo lốp ô tô xe máy (Tròng 2 đầu 17/19 và 21/23)",249000,249000,0,0
TIKI,thoi-trang-nu,52341415,"Vỏ Lốp Trước Casumina 2.50 - 17 - 8 Lớp Bố Gai Tải CA102A, Chuyên Dùng Chở Nặng, Địa Hình Xấu, Chịu Lực Tải Trọng Lớn",220000,220000,0,0
TIKI,o-to-xe-may-xe-dap,119085509,"Lọc gió trụ K3 gắn thông dụng các dòng xe",98990,98990,0,0
TIKI,thoi-trang-nu,167891988,"Nước Rửa Xe Đậm Đặc Flamingo Car Wash Shampoo 1:500 F332 Chai 2L",260000,260000,0,0
TIKI,o-to-xe-may-xe-dap,102057427,"Bọc vô lăng TTAUTO cho xe ô tô từ 4 đến 7 chỗ chất liệu da vân carbon cao cấp có logo MITSUBISHI (Đen)",159000,250000,91000,36
TIKI,o-to-xe-may-xe-dap,56657785,"Bình Ăc Quy Vuông Dùng Cho Xe Điện Trẻ Em 6V 4.5Ah",125000,125000,0,0
TIKI,thoi-trang-nu,109023254,"Đệm Gel Lót Ghế Văn Phòng, Lót yên xe máy xe ô tô Thoáng Khí Siêu mềm",96000,96000,0,0
TIKI,thoi-trang-nu,51909068,"KẸP ẮC QUY CHUYỂN ĐỔI SANG TẨU 12V TRÊN Ô TÔ",25000,25000,0,0
TIKI,o-to-xe-may-xe-dap,108998777,"Cụm vào xéc măng piston xe con, xe du lịch , xe tải",145000,160000,15000,9
TIKI,o-to-xe-may-xe-dap,195249283,"Meguiar's Xịt khử mùi, diệt khuẩn nội thất xe hơi Mùi hương nam tính - Air Refesher - Black Chrome Scent - G181302, 57 g",350000,410000,60000,15
TIKI,thoi-trang-nu,28410817,"Combo 2/3/4 cái giá móc treo đa năng gắn tựa đầu treo đồ vật sau ghế ô tô, xe hơi chịu tải đến 5kg",3999,3999,0,0
TIKI,thoi-trang-nu,115707491,"Cặp 2 gương xe đạp chiếu hậu tròn",80000,80000,0,0
TIKI,o-to-xe-may-xe-dap,50822791,"Áo trùm xe máy, bạt trùm xe máy, xe đạp chống mưa 210 x 100 cm+ Tặng quà hình dán ngẫu nhiên",45000,45000,0,0
TIKI,o-to-xe-may-xe-dap,85804603,"Bạt Che Phủ Xe Ô Tô Cao Cấp 3 Lớp Chống Nắng Nóng Chống Nước Chống xước",425000,425000,0,0
TIKI,o-to-xe-may-xe-dap,163710187,"Dung dịch đánh bóng nhựa nhám xe máy ô tô phục hồi màu như mới loại tốt siêu đậm dặc",110200,116000,5800,5
TIKI,o-to-xe-may-xe-dap,115079434,"Lót cốp dành cho xe  Mazda CX-5 2018-2021 không mùi, chất liệu TPO cao cấp",334000,334000,0,0
TIKI,o-to-xe-may-xe-dap,59340645,"Đôi Gối Da Tựa Đầu Xe Hơi Ô Tô Chống Mỏi Cổ Siêu Bền",69000,69000,0,0
TIKI,o-to-xe-may-xe-dap,41230340,"RÈM CHE NẮNG KÍNH LÁI XE Ô TÔ TỰ CUỐN CAO CẤP",121000,121000,0,0
TIKI,o-to-xe-may-xe-dap,49976893,"cặp túi treo bênh hông cho xe moto tặng bao tay xe máy",179000,179000,0,0
TIKI,thoi-trang-nu,49892166,"Tấm, miếng lót massage ghế xe ô tô,xe hơi, ghế văn phòng hạt gỗ tròn hương cao cấp 45x45 tạo cảm giác thoải mái khi ngồi chống mệt mỏi-DL01",69000,125000,56000,45
TIKI,o-to-xe-may-xe-dap,16202304,"GĂNG TAY CHIẾN THUẬT BLACKHAWK CỤT NGÓN",85000,85000,0,0
TIKI,o-to-xe-may-xe-dap,113967039,"Búa đập kính thoát hiểm ô tô 7 trong 1 cao cấp kèm túi đựng",145000,145000,0,0
TIKI,o-to-xe-may-xe-dap,14957941,"Hộp tỳ tay ô tô cho mọi loại xe tặng tẩu sạc 2 cổng usb",318762,318762,0,0
TIKI,o-to-xe-may-xe-dap,50226569,"Dung dịch nano bảo vệ động cơ xe máy BLUECHEM BC33047",99000,99000,0,0
TIKI,o-to-xe-may-xe-dap,29568534,"Cần số 2 chiều gắn xe Winner X BẢO LONG RACING",75000,75000,0,0
TIKI,o-to-xe-may-xe-dap,114935699,"Bao Da Chìa Khóa xe ô tô MAZDA 3 allnew, Mazda 2, Mazda Cx8, Mazda CX5 khoá cạnh hình chữ nhật",170000,170000,0,0
TIKI,o-to-xe-may-xe-dap,190463822,"Săm Ruột Xe Đạp 20x1.75 (47 - 406) CASUMINA",59000,59000,0,0
TIKI,thoi-trang-nu,154234342,"Thanh gạt mưa 3 khúc UP Hybrid Luxury dùng cho xe cần gạt tay móc chữ U",184000,184000,0,0
TIKI,o-to-xe-may-xe-dap,89301516,"GIÁ ĐỠ ĐIỆN THOẠI KẸP KHE GIÓ ĐIỀU HOÀ Ô TÔ (MẪU 5)",45000,45000,0,0
TIKI,o-to-xe-may-xe-dap,151683748,"Ví đựng giấy tờ ô tô Toyota Da Cao Cấp, Ví da đựng giấy tờ xe ô tô",45000,45000,0,0
TIKI,o-to-xe-may-xe-dap,115622643,"Chổi lau ô tô - Rửa xe ô tô lụa mềm cao cấp đa chức năng - điểu chỉnh được độ dài siêu thấm hút 125 CM",84000,84000,0,0
TIKI,o-to-xe-may-xe-dap,20519923,"Kính chiếu hậu tai mèo chân 10 ly dành cho xe máy ",28000,28000,0,0
TIKI,o-to-xe-may-xe-dap,93027827,"Nước làm mát Prestone Honda AF6300 - Nước làm mát Prestone nhập khẩu từ Mỹ",459000,459000,0,0
TIKI,o-to-xe-may-xe-dap,174185898,"Cảng sau nhôm WINNER X Kiểu V1 ko cần chế / tay dắt / baga sau",165000,165000,0,0
TIKI,thoi-trang-nu,119252927,"Bơm lốp KO DÂY Suitu, bơm ô tô, bơm xe máy, bơm xe đạp Suitu, pin sạc siêu khỏe 6000Mah,- SẠC USB tiện lợi",465000,465000,0,0
TIKI,thoi-trang-nu,29568534,"Cần số 2 chiều gắn xe Winner X BẢO LONG RACING",75000,75000,0,0
TIKI,thoi-trang-nu,49976893,"cặp túi treo bênh hông cho xe moto tặng bao tay xe máy",179000,179000,0,0
TIKI,thoi-trang-nu,56657785,"Bình Ăc Quy Vuông Dùng Cho Xe Điện Trẻ Em 6V 4.5Ah",125000,125000,0,0
TIKI,thoi-trang-nu,111000260,"Bao tay rửa xe 2 mặt chuyên dụng Găng Tay Rửa Xe loại dày",15000,15000,0,0
TIKI,thoi-trang-nu,116014096,"Combo 4 miếng dán gương ôtô(chống bám nước)",45000,45000,0,0
TIKI,thoi-trang-nu,139444838,"Sạc độ xe máy HSB -Shilan cực mạnh thông minh tự ngắt khi đầy điều chỉnh dòng sạc loại tốt",141550,149000,7450,5
TIKI,thoi-trang-nu,102057427,"Bọc vô lăng TTAUTO cho xe ô tô từ 4 đến 7 chỗ chất liệu da vân carbon cao cấp có logo MITSUBISHI (Đen)",159000,250000,91000,36
TIKI,thoi-trang-nu,176681268,"Ốp Bảo Vệ Chìa Khóa Xe Toyota Cross Hợp Kim Kẽm",190000,190000,0,0
TIKI,thoi-trang-nu,135344276,"NƯỚC HOA XE HƠI NHẬP KHẨU CAO CẤP TRANG TRÍ, KHỬ MÙI, LÀM THƠM XE HƠI | CỬA HÀNG NƯỚC HOA Ô TÔ LEVISTORE",429000,650000,221000,34
TIKI,thoi-trang-nu,20519923,"Kính chiếu hậu tai mèo chân 10 ly dành cho xe máy ",28000,28000,0,0
TIKI,thoi-trang-nu,119307757,"Bộ tay công vặn ốc tháo lốp ô tô xe máy (Tròng 2 đầu 17/19 và 21/23)",249000,249000,0,0
TIKI,thoi-trang-nu,119085509,"Lọc gió trụ K3 gắn thông dụng các dòng xe",98990,98990,0,0
TIKI,thoi-trang-nu,46307104,"Khung kẹp xoay dọc ngang kẹp điện thoại, ipad treo thanh tựa đầu sau ghế xe hơi, ô tô và điều chỉnh máy theo góc nhìn",185000,185000,0,0
TIKI,thoi-trang-nu,113967039,"Búa đập kính thoát hiểm ô tô 7 trong 1 cao cấp kèm túi đựng",145000,145000,0,0
TIKI,thoi-trang-nu,50822791,"Áo trùm xe máy, bạt trùm xe máy, xe đạp chống mưa 210 x 100 cm+ Tặng quà hình dán ngẫu nhiên",45000,45000,0,0
TIKI,thoi-trang-nu,115622643,"Chổi lau ô tô - Rửa xe ô tô lụa mềm cao cấp đa chức năng - điểu chỉnh được độ dài siêu thấm hút 125 CM",84000,84000,0,0
TIKI,thoi-trang-nu,16202304,"GĂNG TAY CHIẾN THUẬT BLACKHAWK CỤT NGÓN",85000,85000,0,0
TIKI,thoi-trang-nu,162247197,"Bạt Phủ Xe Máy, Áo Trùm Xe Vải Dù Che Mưa, Che Nắng, Bảo Vệ Xe _ Vừa Với Tất Cả Các Loại Xe Máy AM14",105000,105000,0,0
TIKI,thoi-trang-nu,131192839,"Cảng Vision SH 300i nhôm đúc đời 2014-2020",329000,329000,0,0
TIKI,thoi-trang-nu,108998777,"Cụm vào xéc măng piston xe con, xe du lịch , xe tải",145000,160000,15000,9
TIKI,thoi-trang-nu,190463822,"Săm Ruột Xe Đạp 20x1.75 (47 - 406) CASUMINA",59000,59000,0,0
TIKI,thoi-trang-nu,83346764,"Nón bảo hiểm 3/4 ROYAL M139 có kính âm V10 TRẮNG",570000,730000,160000,22
TIKI,thoi-trang-nu,195249283,"Meguiar's Xịt khử mùi, diệt khuẩn nội thất xe hơi Mùi hương nam tính - Air Refesher - Black Chrome Scent - G181302, 57 g",350000,410000,60000,15
TIKI,thoi-trang-nu,50226569,"Dung dịch nano bảo vệ động cơ xe máy BLUECHEM BC33047",99000,99000,0,0
TIKI,thoi-trang-nu,174185898,"Cảng sau nhôm WINNER X Kiểu V1 ko cần chế / tay dắt / baga sau",165000,165000,0,0
TIKI,thoi-trang-nu,59340645,"Đôi Gối Da Tựa Đầu Xe Hơi Ô Tô Chống Mỏi Cổ Siêu Bền",69000,69000,0,0
TIKI,thoi-trang-nu,22753760,"Bộ 5 Tấm Lưới Chắn Nắng Chống Nóng Ô Tô - Chắn Nắng Hiệu Quả",69000,69000,0,0
TIKI,thoi-trang-nu,10685866,"Tấm bạt phủ xe máy",39000,39000,0,0
TIKI,thoi-trang-nu,41230340,"RÈM CHE NẮNG KÍNH LÁI XE Ô TÔ TỰ CUỐN CAO CẤP",121000,121000,0,0
TIKI,thoi-trang-nu,151683748,"Ví đựng giấy tờ ô tô Toyota Da Cao Cấp, Ví da đựng giấy tờ xe ô tô",45000,45000,0,0
TIKI,thoi-trang-nu,14957941,"Hộp tỳ tay ô tô cho mọi loại xe tặng tẩu sạc 2 cổng usb",318762,318762,0,0
TIKI,thoi-trang-nu,89301516,"GIÁ ĐỠ ĐIỆN THOẠI KẸP KHE GIÓ ĐIỀU HOÀ Ô TÔ (MẪU 5)",45000,45000,0,0
TIKI,thoi-trang-nu,18003631,"Thùng, hộp đựng đồ co giãn trên Ô tô, Xe hơi - thể tích 40L",224000,224000,0,0
TIKI,thoi-trang-nu,163710187,"Dung dịch đánh bóng nhựa nhám xe máy ô tô phục hồi màu như mới loại tốt siêu đậm dặc",110200,116000,5800,5
TIKI,thoi-trang-nu,93027827,"Nước làm mát Prestone Honda AF6300 - Nước làm mát Prestone nhập khẩu từ Mỹ",459000,459000,0,0
TIKI,thoi-trang-nu,114935699,"Bao Da Chìa Khóa xe ô tô MAZDA 3 allnew, Mazda 2, Mazda Cx8, Mazda CX5 khoá cạnh hình chữ nhật",170000,170000,0,0
TIKI,thoi-trang-nu,115079434,"Lót cốp dành cho xe  Mazda CX-5 2018-2021 không mùi, chất liệu TPO cao cấp",334000,334000,0,0
TIKI,thoi-trang-nu,62747178,"Mũ Bảo Hiểm Nửa Đầu Có Kính Cao Cấp Protec Hiway Họa Tiết Đen Xanh Tem Hình COOL Ngầu (Mẫu Mới) - Hàng Chính Hãng",389000,498000,109000,22
TIKI,o-to-xe-may-xe-dap,150493582,"Thiết bị đồng hồ đo áp suất lốp ô tô xe máy mini treo móc khóa đa năng tiện dụng màn hình led mẫu mới loại tốt",136000,136000,0,0
TIKI,o-to-xe-may-xe-dap,44874923,"Gối Tựa Đầu AM01 Trên Xe Hơi - NHIỀU MÀU",75000,75000,0,0
TIKI,o-to-xe-may-xe-dap,1237295,"Bàn Chải Vệ Sinh Sên Chuyên Nghiệp",16000,16000,0,0
TIKI,o-to-xe-may-xe-dap,6941827,"Bộ 2 Gù chống đổ sau cho xe máy ( xanh dương )",45000,45000,0,0
TIKI,o-to-xe-may-xe-dap,21726245,"Công tắc hazar chớp nháy 4 bóng xi nhan",35000,35000,0,0
TIKI,thoi-trang-nu,85804603,"Bạt Che Phủ Xe Ô Tô Cao Cấp 3 Lớp Chống Nắng Nóng Chống Nước Chống xước",425000,425000,0,0
TIKI,o-to-xe-may-xe-dap,97979802,"Bọc da vô lăng ô tô thể thao loại tốt bám tay thiết kế đẹp mắt phù hợp các loại xe phổ thông",128690,128690,0,0
TIKI,o-to-xe-may-xe-dap,1176131,"Nhớt Xe Máy 4T Synth 10W50 Race Liqui Moly 1502 (1L)",309000,309000,0,0
TIKI,o-to-xe-may-xe-dap,48332376,"DUNG DỊCH VỆ SINH BUỒNG ĐỐT ICHINEN NX5000 240ml (JAPAN) - 1 chai",185000,185000,0,0
TIKI,o-to-xe-may-xe-dap,30150394,"Tem xe ô tô thể thao Transformer",229000,229000,0,0
TIKI,o-to-xe-may-xe-dap,116875498,"Còi Điện Xe Đạp 120dB Chống Mưa Gắn Tay Lái Xe Đạp",95000,95000,0,0
TIKI,o-to-xe-may-xe-dap,52614788,"Khóa u siêu chống cắt chính hãng ABUS - CHLB Đức tặng khóa tủ cá nhân",511000,549000,38000,7
TIKI,o-to-xe-may-xe-dap,22475700,"Bộ Tay công vặn lốp xe 04 đầu lục giác",103000,103000,0,0
TIKI,o-to-xe-may-xe-dap,27851066,"Máy Hút Bụi Xe Hơi, Gia Đình Cầm Tay",309000,309000,0,0
TIKI,o-to-xe-may-xe-dap,182139552,"Đồ Trang Trí Xe Hơi Chú Chó Lắc Đầu Đáng Yêu",61750,65000,3250,5
TIKI,o-to-xe-may-xe-dap,529457,"Xi Đánh Bóng Cana 220G",70000,70000,0,0
TIKI,o-to-xe-may-xe-dap,153941018,"Thảm sàn, lót sàn cao su 3D cho Hyundai Santafe 2019",688000,688000,0,0
TIKI,o-to-xe-may-xe-dap,77015395,"Gương cầu lồi 360 độ cao cấp dành cho ô tô ACP-035",19000,19000,0,0
TIKI,o-to-xe-may-xe-dap,49892166,"Tấm, miếng lót massage ghế xe ô tô,xe hơi, ghế văn phòng hạt gỗ tròn hương cao cấp 45x45 tạo cảm giác thoải mái khi ngồi chống mệt mỏi-DL01",69000,125000,56000,45
TIKI,o-to-xe-may-xe-dap,147371419,"Bạt Phủ Ô Tô - Bạt Trùm Xe Ô Tô 3 Lớp Vải Dù Cao Cấp Chống Mưa, Chống Nắng, Chống Cháy",257600,280000,22400,8
TIKI,o-to-xe-may-xe-dap,142904077,"DUNG DỊCH VỆ SINH NỘI THẤT Ô TÔ H25 (5 Lit)",369000,379000,10000,3
TIKI,o-to-xe-may-xe-dap,3308227,"Combo 2 Chai Xịt Thơm Phòng Khử Mùi Hàn Quốc Hương Cafe Hazelnut 370ml cho xe hơi (Nâu)",105000,105000,0,0
TIKI,o-to-xe-may-xe-dap,6501581,"Bạt phủ ô tô cách nhiệt cao cấp, bạt trùm xe hơi, chống nóng, chống nước vân 3D",180969,180969,0,0
TIKI,o-to-xe-may-xe-dap,154234342,"Thanh gạt mưa 3 khúc UP Hybrid Luxury dùng cho xe cần gạt tay móc chữ U",184000,184000,0,0
TIKI,o-to-xe-may-xe-dap,15285822,"Bộ 4 nắp chụp chân van, đầu vòi xe hơi, xe máy, ô tô",9800,9800,0,0
TIKI,o-to-xe-may-xe-dap,140009099,"Bộ Hộp Dụng Cụ Vá Lốp Xe Lốp Không Săm Vá Lụi (vá ngoài) Bằng Thép Không Gỉ Cho Xe Oto, Xe Hơi Và Xe Máy",150000,202050,52050,26
TIKI,o-to-xe-may-xe-dap,28410817,"Combo 2/3/4 cái giá móc treo đa năng gắn tựa đầu treo đồ vật sau ghế ô tô, xe hơi chịu tải đến 5kg",3999,3999,0,0
TIKI,o-to-xe-may-xe-dap,96910538," MÓC TREO ĐỒ TRÊN Ô TÔ",12512,13600,1088,8
TIKI,o-to-xe-may-xe-dap,52341415,"Vỏ Lốp Trước Casumina 2.50 - 17 - 8 Lớp Bố Gai Tải CA102A, Chuyên Dùng Chở Nặng, Địa Hình Xấu, Chịu Lực Tải Trọng Lớn",220000,220000,0,0
TIKI,o-to-xe-may-xe-dap,167891988,"Nước Rửa Xe Đậm Đặc Flamingo Car Wash Shampoo 1:500 F332 Chai 2L",260000,260000,0,0
TIKI,o-to-xe-may-xe-dap,31962521,"Thảm sàn, lót sàn cao su 3D không mùi Cao cấp dành cho xe Ford Everest 2016-2019",685000,685000,0,0
TIKI,o-to-xe-may-xe-dap,171468901,"(Đèn 3 IN 1) Đèn xe đạp siêu sáng đa năng có Đồng hồ đo tốc độ và Còi cao cấp",299000,299000,0,0
TIKI,o-to-xe-may-xe-dap,49543118,"Phủ Nano Kính Ô Tô Đa Năng Glaco Blave G-100 Soft99 Japan",239000,239000,0,0
TIKI,o-to-xe-may-xe-dap,126097513,"Lót cốp nhựa ô tô cho dòng xe mazda 3D CX5 2019+",321000,321000,0,0
TIKI,o-to-xe-may-xe-dap,51909068,"KẸP ẮC QUY CHUYỂN ĐỔI SANG TẨU 12V TRÊN Ô TÔ",25000,25000,0,0
TIKI,o-to-xe-may-xe-dap,55323617,"Mũ Bảo Hiểm Trẻ Em 1/2 Đầu Có Kính Protec Kitty Họa Tiết Nữ Hoàng Băng Giá Frozen Thời Trang, An Toàn, Chất Lượng - Hàng Chính Hãng - Màu Xanh",368000,442000,74000,17
TIKI,o-to-xe-may-xe-dap,142871814,"Túi treo đầu xe máy Pro-Biker",210000,210000,0,0
TIKI,o-to-xe-may-xe-dap,57109174,"Mỡ cao cấp Mobilgrease XHP 222 - nhập khẩu từ Mỹ",139000,139000,0,0
TIKI,o-to-xe-may-xe-dap,115707491,"Cặp 2 gương xe đạp chiếu hậu tròn",80000,80000,0,0
TIKI,o-to-xe-may-xe-dap,65466769,"Gía đỡ điện thoại gắn taplo hoặc kính lái ô tô nhãn hiệu Baseus SUYL-JY01 - Khóa, mở tự động",325000,325000,0,0
TIKI,o-to-xe-may-xe-dap,109023254,"Đệm Gel Lót Ghế Văn Phòng, Lót yên xe máy xe ô tô Thoáng Khí Siêu mềm",96000,96000,0,0
TIKI,lam-dep-suc-khoe,1951095,"Nước Đông Trùng Hạ Thảo Hàn Quốc",90000,90000,0,0
TIKI,lam-dep-suc-khoe,11954438,"Dung Dịch Vệ Sinh Phụ Nữ Kháng Khuẩn Khử Mùi Oriss Làm Sạch Dịu Nhẹ Chiết Xuất Lá Trầu Không Cân Bằng pH - 150ml",50000,63000,13000,21
TIKI,lam-dep-suc-khoe,107144886,"[CHÍNH HÃNG] Khẩu trang y tế trẻ em quai vải Famapro 5D Mask Kid - Bé Dưới 10 Tuổi [ HỘP",11900,11900,0,0
TIKI,lam-dep-suc-khoe,149425187,"Sữa tắm trắng da cánh hoa hồng Damask Weilaiya Grand Rose Extracts Whitening Shower Gel 450ml",342000,488000,146000,30
TIKI,lam-dep-suc-khoe,96271731,"Máy xông tinh dầu siêu âm công nghệ hiện đại  - Chế độ phun mạnh - Khuếch tán tinh dầu trong không gian rộng - Hoạt động liên tục 18h",239000,360000,121000,34
TIKI,lam-dep-suc-khoe,177897403,"Thạch nghệ Saffron Daily Curcumin 247 Nhật Bản vị chuối tăng cường sức khỏe, làm đẹp da hiệu quả",40000,40000,0,0
TIKI,lam-dep-suc-khoe,56986002,"Dầu Gội Tăng Cường Dưỡng Chất Giúp Giảm Rụng Tóc Vichy Dercos Energising Shampoo Hairloss 200ml ( Mẫu mới)",332000,415000,83000,20
TIKI,lam-dep-suc-khoe,270866437,"DHC rau củ nhật bổ sung chất sơ, vitamin, dưỡng chất từ 32 loại rau+củ+hạt hỗ trợ tăng cường sức khỏe chung - QuaTangMe Extaste",710000,1420000,710000,50
TIKI,lam-dep-suc-khoe,16344389,"Dầu gội tím khử ánh vàng cho tóc trắng bạch kim Elgon Silver Colorcare Silver shampoo Italy 300ml",330000,330000,0,0
TIKI,lam-dep-suc-khoe,185096114,"Kem Xoá Mờ Sẹo Actiscar, Mờ Sẹo Lồi, Sẹo Lõm, Sẹo Thâm, Sẹo Rỗ lâu năm 20g",499000,499000,0,0
TIKI,lam-dep-suc-khoe,36385805,"Mỡ Trăn N'store Nguyên Chất Triệt Lông Vĩnh Viễn, Giảm Bỏng Da, Dưỡng Da, Ngăn Ngừa Rạn Nứt Da (1 Chai 100ML)",63000,90000,27000,30
TIKI,lam-dep-suc-khoe,56918293,"Son Dưỡng Dầu Dừa Bến Tre Cocoon ",32000,32000,0,0
TIKI,lam-dep-suc-khoe,131504615,"Dầu gội dược liệu Thái Dương 7 200ml / 480ml / 1100ml",100000,100000,0,0
TIKI,lam-dep-suc-khoe,76168193,"[HỘP - FAMAPRO 5D MASK] - Khẩu trang y tế kháng khuẩn 3 lớp Famapro 5D Mask (10 cái/ hộp) - COMBO 5 HỘP",49500,49500,0,0
TIKI,lam-dep-suc-khoe,104401469,"Combo 2 Kem Tẩy Lông Cho Da Thường Veet Silk Fresh 50G",122000,140200,18200,13
TIKI,lam-dep-suc-khoe,74853177,"Tinh Dầu Xông Phòng Cam Ngọt Cao Cấp (ORANGE) - Tinh dầu Cam Nguyên Chất Sử Dụng Với Máy Khuếch Tán Tinh Dầu Giúp Thư Giãn Tinh Thần, Khử Mùi, Xua Đuổi Côn Trùng",38000,76000,38000,50
TIKI,lam-dep-suc-khoe,191319822,"Dầu gội sạch gàu Mochi Medical Nhật Bản. Sạch gàu, sạch ngứa trong 2 tuần",99000,99000,0,0
TIKI,lam-dep-suc-khoe,135349213,"Túi trườm nóng bụng kinh nguyệt PUHA 350ml, túi chườm ấm bụng cho bạn nữ giảm đau",149000,149000,0,0
TIKI,lam-dep-suc-khoe,157856445,"Kem Dưỡng Hatomugi Chiết Xuất Ý Dĩ Làm Sáng Da 300g Moisturizing Conditioning The Milky Cream",133000,135000,2000,1
TIKI,lam-dep-suc-khoe,272283366,"Glucosamine 1500mg Kirkland Signature Mỹ Giảm đau nhức xương khớp, tạo chất nhầy bôi trơn khớp, hỗ trợ vận động linh hoạt hiệu quả - OZ Slim Store",655000,1310000,655000,50
TIKI,lam-dep-suc-khoe,186516401,"Gối Chườm Nóng Thảo Mộc Đa Năng Hapaku Giảm Đau Mỏi Cổ Vai Gáy, Lưng Hông, Giúp Ngủ Ngon Hơn, Gối Thảo Mộc Đa Năng - Size Lớn",349000,580000,231000,40
TIKI,lam-dep-suc-khoe,71512916,"Dầu gội thảo dược gừng dừa Cocayhoala hỗ trợ trị gàu, hết ngứa, dung tích 440g-95% thành phần từ gừng tươi hữu cơ còn nguyên xơ gừng, hỗ trợ trị rụng tóc, kích thích mọc tóc vượt trội, an toàn cho mẹ bầu mẹ sau sinh",349000,349000,0,0
TIKI,lam-dep-suc-khoe,140628020,"Xịt Chống Nắng Bảo Vệ Da Tối Ưu Summer SUN Spray SPF 50 PA++++ 100ml",231000,231000,0,0
TIKI,lam-dep-suc-khoe,694391,"Tinh Dầu Sả Chanh Lorganic Hương Thơm Thiền Tịnh (50ml)",115000,195000,80000,41
TIKI,o-to-xe-may-xe-dap,146904148,"Đai ghế giữ an toàn cho bé trên xe ô tô - địu gắn ghế cho bé",139000,139000,0,0
TIKI,o-to-xe-may-xe-dap,33227275,"Băng keo 2 mặt chịu nhiệt dán linh kiện điện tử 3M khổ 6mm x 50m 9448A",89000,89000,0,0
TIKI,lam-dep-suc-khoe,75440616,"Bộ 3 Kem Đánh Răng Colgate Herbal Salt Muối Thảo Dược 225g/tuýp x 3",123000,123000,0,0
TIKI,lam-dep-suc-khoe,52853259,"TPBVSK hỗ trợ Tăng Chiều Cao NuBest Tall Cho Độ Tuổi Từ 5-20",1090000,1450000,360000,25
TIKI,o-to-xe-may-xe-dap,164430657,"Mỡ bôi trơn dạng xịt Grease Spray Bosny",95000,120000,25000,21
TIKI,o-to-xe-may-xe-dap,113355572,"Tấm miếng đệm lót ghế xe ô tô, xe hơi, ghế văn phòng hạt gỗ tròn hương cao cấp 45x45",246000,500000,254000,51
TIKI,lam-dep-suc-khoe,257857032,"Đầu Bàn Chải Điện LocknLock ENR546BLK (4pcs) - Màu Đen",133000,252000,119000,47
TIKI,lam-dep-suc-khoe,119706866,"Sữa tắm dưỡng ẩm cho viêm da cơ địa Cetaphil Pro AD Derma Wash 295ml",480000,480000,0,0
TIKI,lam-dep-suc-khoe,3598571,"Bộ 10 gói mặt nạ dưỡng ẩm da chiết xuất nha đam 3W Clinic Fresh Aloe Mask Sheet 23ml X 10",56000,56000,0,0
TIKI,o-to-xe-may-xe-dap,83618256,"Bộ đế gắn + lông cừu + xốp đánh bóng 5 inches 3 món đánh bóng ô tô",99999,99999,0,0
TIKI,lam-dep-suc-khoe,178302264,"Sáp tạo kiểu tóc giữ nếp lâu vượt trội Restyleable Clay Wax 68g/hộp",74000,82000,8000,10
TIKI,lam-dep-suc-khoe,76169379,"[HỘP - FAMAPRO 5D BABY] - Khẩu trang y tế trẻ em kháng khuẩn 3 lớp Famapro 5D Baby (10 cái/ hộp) - COMBO 3 HỘP",26500,26500,0,0
TIKI,o-to-xe-may-xe-dap,56650976,"Đầu khóa chốt cắm móc đai dây an toàn ô tô cao cấp HC-888 Chất liệu Hợp kim inox cao cấp dùng cho các loại xe",90000,90000,0,0
TIKI,o-to-xe-may-xe-dap,135464990,"Combo 3 chai Sprayking Dưỡng nhám,Rửa sên và dưỡng sên 400ML",139000,139000,0,0
TIKI,lam-dep-suc-khoe,23485049,"Dầu gội ngăn ngừa rụng tóc Davines Naturaltech Energizing shampoo chính hãng Ý 250ml",285000,285000,0,0
TIKI,o-to-xe-may-xe-dap,55502522,"Bao tay, Găng tay Xe đạp, Xe máy, Câu cá, Du lịch, Leo núi, Ngoài trời Hở Ngón GT-005",90000,135000,45000,33
TIKI,o-to-xe-may-xe-dap,111198562,"Túi Treo Xe Đạp 2 Ngăn Chống Nước Có Mặt Để Điện Thoại",69000,69000,0,0
TIKI,o-to-xe-may-xe-dap,108968070,"Xịt dưỡng cao su, gioăng cửa ô tô Silicone Spray Senfineco 9990",210000,210000,0,0
TIKI,o-to-xe-may-xe-dap,56109845,"Giá Đỡ Điện Thoại Chân Gắn Và Hút Chân Không Trên Xe Ô Tô ",79000,79000,0,0
TIKI,o-to-xe-may-xe-dap,97427510,"Cản sau - tay dắt xe Winner X nhôm nguyên khối sơn tĩnh điện",365000,365000,0,0
TIKI,o-to-xe-may-xe-dap,75637147,"SẠC CHUYÊN DỤNG DÀNH CHO XE ĐẠP ĐIỆN M133 - SIÊU BỀN - SẠC DÒNG ĐIỆN CHUẨN - NGẮT ĐIỆN TUYỆT ĐỐI - BẢO VỆ XE - KÉO DÀI TUỔI THỌ ẮC QUY - LOẠI 48V-12AH CHÂN ĐẶC HOẶC CHÂN CHỤP (RỖNG)",200000,200000,0,0
TIKI,o-to-xe-may-xe-dap,152875193,"SIÊU SÁNG VỚI 1 BÓNG ĐÈN PHA LED 6TIM LẮP XE MÁY XE HƠI ÔTÔ SÁNG CỰC CHUẨN HÀNG CHUẨN CHẤT LƯỢNG",229000,229000,0,0
TIKI,o-to-xe-may-xe-dap,10099198,"Ổ khóa phanh đĩa chống trộm cho xe máy, xe đạp thể thao (Giao màu ngẫu nhiên)",30000,30000,0,0
TIKI,o-to-xe-may-xe-dap,117219775,"Bộ Dưỡng Sên Xe Máy Maxima Chain Guard Và Chai Rửa Sên Voltronic IX69 Kèm Bàn Chải 3 Mặt Tiện Dụng",35000,35000,0,0
TIKI,lam-dep-suc-khoe,2579159,"Máy đo huyết áp tự động bắp tay Omron JPN600",1750000,1750000,0,0
TIKI,o-to-xe-may-xe-dap,91925236,"Bộ đo áp suất buồng đốt động cơ xăng ô tô, xe máy 8PC- 300 PSI - Đồng hồ đo áp suất buồng đốt ô tô",295000,295000,0,0
TIKI,lam-dep-suc-khoe,104288718,"Viên uống trắng da DHC Nhật Bản dưỡng ẩm và làm mịn da thực phẩm chức năng 30 ngày JN-DHC-ADL30",199000,274890,75890,28
TIKI,o-to-xe-may-xe-dap,141490275,"NƯỚC HOA XE HƠI NHẬP KHẨU DÀNH CHO XẾ XỊN - NƯỚC HOA TRANG TRÍ TAPLO, LÀM THƠM KHỬ MÙI Ô TÔ HIỆU QUẢ",152000,152000,0,0
TIKI,o-to-xe-may-xe-dap,139444390,"Mạch stop chớp nháy đèn hậu Ex 150 - Winner X siêu đẹp chống nước sẵn giắc cắm loại tốt không cần độ chế",94050,99000,4950,5
TIKI,lam-dep-suc-khoe,68743966,"Nước hoa bỏ túi Romano Vip Vision sang trọng cuốn hút 18ml",48000,54000,6000,11
TIKI,lam-dep-suc-khoe,10122631,"Nước Đông Trùng Hạ Thảo Hector Sâm ( Hộp 10 chai ) - Bổ Sung Năng Lượng, Tăng Cường Sinh Lý Và Sinh Lực Cho Người Làm Việc Cường Độ Cao, Chơi Thể Thao",435000,450000,15000,3
TIKI,lam-dep-suc-khoe,15863570,"Dầu gội kích thích mọc tóc Obsidian Orzen Loss Control shampoo 320ml",315000,315000,0,0
TIKI,lam-dep-suc-khoe,59078477,"Máy Xông Khí Dung Omron NE-C106",739000,1083000,344000,32
TIKI,o-to-xe-may-xe-dap,92515054,"Bánh phụ xe đạp trẻ em 12, 16inh- 18, 20inh <1đôi",59000,80000,21000,26
TIKI,lam-dep-suc-khoe,76217766,"Xịt mọc tóc nhanh tinh dầu vỏ bưởi Tabaha 120ml dành cho Nam giới bị rụng tóc, tóc thưa",80000,80000,0,0
TIKI,o-to-xe-may-xe-dap,71694022,"Dây Treo Xe Ô Tô Phong Thủy Cá Chép Ngậm Đồng Tiền Tài Lộc May Mắn",125000,125000,0,0
TIKI,o-to-xe-may-xe-dap,84695243,"Mũ Bảo Hiểm Nửa Đầu SRT Xám Xước",199000,199000,0,0
TIKI,o-to-xe-may-xe-dap,11533657,"Đèn led trần xe ô tô - đèn cốp xe ô tô",150000,150000,0,0
TIKI,lam-dep-suc-khoe,562334,"Xịt Ngăn Mùi Toàn Thân Romano Gentleman 150ml",103000,103000,0,0
TIKI,o-to-xe-may-xe-dap,50415606,"Hộp tỳ tay ô tô dành cho Mitsubishi Xpander tích hợp 7 cổng USB ( DUSB-EXPD )",378000,378000,0,0
TIKI,o-to-xe-may-xe-dap,119719045,"Máy Sạc Bình Ắc Quy Foxsur 12V 12A - 24V 6A, Sạc Pin Lithium, Khử Sunfat, Sạc Ắc Quy Xe Máy Ô Tô, MẪU MỚI 2021",388000,388000,0,0
TIKI,o-to-xe-may-xe-dap,122412513,"Móc treo áo trên xe ô tô cao cấp  JT-G03",623000,623000,0,0
TIKI,o-to-xe-may-xe-dap,180985971,"Máy bơm lốp xe máy, ô tô- siêu tốc tự ngắt Michelin 12314 -12V- 360W",1699000,1699000,0,0
TIKI,o-to-xe-may-xe-dap,173342081,"Mũ Bảo Hiểm Xe Đạp Cho Bé Từ 4 - 10 Tuổi Free size",192500,350000,157500,45
TIKI,o-to-xe-may-xe-dap,112084875,"Hộp xích dành cho xe Wave RSX - S110 màu Bạc - TKB8510",167000,270400,103400,38
TIKI,o-to-xe-may-xe-dap,94584853,"Bình tạo bọt tuyết vệ sinh xe ô tô gắn máy dung tích 1L - HanruiOffical",158000,158000,0,0
TIKI,o-to-xe-may-xe-dap,96046576,"Túi Treo Sườn Xe Đạp Thể Thao Cảm Ứng Chống Nước Tặng Kèm Trùm Đi Mưa",69000,69000,0,0
TIKI,o-to-xe-may-xe-dap,53390147,"Tem dán kính lái chống nắng ô tô Value",89000,89000,0,0
TIKI,o-to-xe-may-xe-dap,57036504,"Cặp Kính chiếu hậu Dành cho xe Wave RS có thể điều chỉnh ",45000,45000,0,0
TIKI,o-to-xe-may-xe-dap,178787797,"Xe đạp đua GIANT OCR 5300 2019",15900000,15900000,0,0
TIKI,o-to-xe-may-xe-dap,153937726,"COMBO Nẹp bước chân và ốp chống trầy cốp Honda CRV, CR-V vân Carbon",1486000,1486000,0,0
TIKI,o-to-xe-may-xe-dap,2872303,"Bộ 2 găng tay lau rửa xe chuyên dụng siêu mềm thấm hút tốt (Màu ngẫu nhiên)",13000,29000,16000,55
TIKI,o-to-xe-may-xe-dap,9820675,"Sáp thơm ô tô hương cà phê AREON Ken Coffee - NHẬP KHẨU BULGARIA",197000,270000,73000,27
TIKI,o-to-xe-may-xe-dap,54476107,"Nón bảo hiểm 3/4 kính âm Royal M139 Đỏ Đô Nhám cao cấp Lót tháo rời, che hết mặt",499000,499000,0,0
TIKI,o-to-xe-may-xe-dap,53803359,"Đèn Xe Đạp Thể Thao Chính Hãng | Đèn Led Sạc USB Chống Nước | Pin Polymer | Đèn Siêu Sáng | Phụ Kiện Đèn Xe Đạp Đa Chức Năng Kết Hợp Còi Và Đồng Hồ Đo Tốc Độ  - 10. Đèn Pha Machfally - Đen",141550,149000,7450,5
TIKI,o-to-xe-may-xe-dap,85368098,"Nệm Giường hơi để xe ô tô- nệm hơi xe hơi-Đệm xe hơi vải nhung",348000,348000,0,0
TIKI,thoi-trang-nu,79445330,"Đồ Ngủ Body Sexy Cosplay Thư Ký Gợi Cảm Vải Mịn Hai Dây Có Kèm Dây Kẹp Tất Và Tất Màu Đen Sexy Women Stockings Transparent Exposed Nipple Mesh Brave Man Mã BCS21 15 8022 12",88000,117000,29000,25
TIKI,thoi-trang-nu,72515929,"COMBO 5 QUẦN LỌT KHE REN MỀM DÀNH CHO NỮ 8001",116000,116000,0,0
TIKI,thoi-trang-nu,140921150,"Đồ bộ mặc nhà,đồ bộ mặc nhà đẹp, đồ bộ mặc nhà cao cấp, chất đũi lạnh",191250,191250,0,0
TIKI,thoi-trang-nu,165206570,"Áo Ngực Không Gọng Chất Liệu Ren Cao Cấp, Áo Lót Bra Ren Mềm Mẫu Mới Siêu Đẹp Thương Hiệu Baw mã NT71",159000,159000,0,0
TIKI,thoi-trang-nu,108508923,"Áo croptop dài tay siêu tôn vòng 2",75000,75000,0,0
TIKI,thoi-trang-nu,132928231," CHÂN VÁY CARO XẾP LY NÚT",138000,138000,0,0
TIKI,thoi-trang-nu,123870482,"Áo khoăc len lông nhung mềm áo nữ trẻ trung mùa thu đông",315000,315000,0,0
TIKI,thoi-trang-nu,58120819,"Quần lót BARE S1030263-HA",99000,359000,260000,72
TIKI,thoi-trang-nu,195708587,"Đầm Hoa Trung Niên đẹp Che Bụng VH64 - Hàng Quảng Châu Cao Cấp",345000,345000,0,0
TIKI,thoi-trang-nu,10576055,"Quần tây công sở_Q02",239000,239000,0,0
TIKI,thoi-trang-nu,25781648,"hộp 10 miếng dán nâng ngực trong suốt Bare Lifts",23000,23000,0,0
TIKI,thoi-trang-nu,7301977,"Chân Váy Dập Li MS0306V",175000,175000,0,0
TIKI,thoi-trang-nu,102944214,"(286) áo lót cotton thái mỏng ko gọng",25650,27000,1350,5
TIKI,thoi-trang-nu,54392195,"ĐAI NỊT BỤNG ĐỊNH HÌNH GIẢM MỠ M+ MỚI NHẤT",73000,73000,0,0
TIKI,thoi-trang-nu,195241850,"Áo croptop ôm nữ tay lỡ cổ cao cài khuy gợi cảm OZENKA , crt kiểu hàn quốc thun 100% cotton tự nhiên đen trắng dưới 55kg",17500,17500,0,0
TIKI,thoi-trang-nu,91753598,"Áo Khoác Bomber 2020 Nỉ ULLANG",103000,103000,0,0
TIKI,thoi-trang-nu,166533565,"Quần Độn Mông Nữ, Quần Độn Mông Lưng Ren Thông Hơi Siêu Thoáng Mát Mềm Mại Thương Hiệu Baw DM01",129000,189000,60000,32
TIKI,thoi-trang-nu,189337830,"COMBO 4 QUẦN MW COTTON CẠP CAO",156000,156000,0,0
TIKI,thoi-trang-nu,31603612,"Crazy sales. Áo thun nữ GOKING in hình dễ thương, áo phông thoát nhiệt Nhật Bản 100 cotton thoáng mát, thấm hút mồ hôi, đánh bay cơn nóng mùa hè",111000,111000,0,0
TIKI,thoi-trang-nu,188835606,"Đầm linen nữ dáng suông không tay, Váy suông đuôi cá chất đũi thoáng mát Đũi Việt DV38",216405,229000,12595,6
TIKI,thoi-trang-nu,185712822,"Áo khoác hoodie zip XÁM form rộng nam nữ vải nỉ lót bông thêu chữ CHAOS",102000,102000,0,0
TIKI,thoi-trang-nu,167146834,"Áo lót đúc chất cotton quả vuông cao cấp Lylylorem AL160",178000,178000,0,0
TIKI,thoi-trang-nu,168505953,"Bộ Đồ Bơi Nữ Bikini 2 Mảnh ATI61 MAYHOMES Set Áo Và Short, One Size, Kiểu Dáng Thể Thao",117000,155000,38000,25
TIKI,thoi-trang-nu,146573650,"QUẦN BẦU CÓ ĐÁP BỤNG - QUẦN LEGGING BẦU CÓ ĐÁP BỤNG",74340,74340,0,0
TIKI,thoi-trang-nu,67911260,"CHÂN VÁY HOA NHÍ TIGOON DỊU DÀNG - Hoa Vàng - S",136000,136000,0,0
TIKI,thoi-trang-nu,193180698,"Áo hoodie The White",105000,105000,0,0
TIKI,thoi-trang-nu,192222724,"Áo thun nữ cổ tim tay dài vải cotton đẹp, dễ mặc dễ phối đồ, mặc bốn mùa",49000,49000,0,0
TIKI,thoi-trang-nu,181247543,"Áo Phông Ngắn Tay Cotton Áo Phông Nữ Xinh Xuân Hè Hot Hit Phong Cách Mới",295000,295000,0,0
TIKI,thoi-trang-nu,6535821,"Quần Lót Nữ - Quần Đùi Mặc Trong Váy Su Thông Hơi",28500,30000,1500,5
TIKI,thoi-trang-nu,189686374,"Váy ngủ hai dây nữ vải Cotton lụa tự nhiên thoáng mát mềm mại, đầm mặc nhà mùa hè freesize mã VAV0288",159000,159000,0,0
TIKI,thoi-trang-nu,48094460,"Áo sơ mi đũi nữ cổ V có túi Đũi Việt DVSM172",159705,169000,9295,6
TIKI,thoi-trang-nu,32380868,"Áo len nữ trơn ôm dáng Haint Boutique Al31",149000,161000,12000,7
TIKI,thoi-trang-nu,179980829,"Đầm ngủ nữ cotton iBasic SW008",203000,399000,196000,49
TIKI,thoi-trang-nu,95050539,"Áo Thun Unisex Nam Nữ Cờ Mỹ American Flag T-Shirt 100% tagless cotton",20000,20000,0,0
TIKI,thoi-trang-nu,51714933,"Áo Sơ Mi Nữ Tay Dài Công Sở",166250,175000,8750,5
TIKI,thoi-trang-nu,145081215,"Áo khoác bomber unisex CLOSET , áo khoác nỉ thu đông nam nữ phối tàn lạ mắt",95000,95000,0,0
TIKI,thoi-trang-nu,128123093,"Áo khoác bomber unisex thu đông nam nữ deepen 3 màu năng động,trẻ trung",160000,160000,0,0
TIKI,thoi-trang-nu,11088243," Bộ đồ ngủ pyjama nữ Hàn Quốc cao cấp 109",139300,199000,59700,30
TIKI,thoi-trang-nu,204050216,"Cuộn Băng Dán Nâng Ngực Có Thể Tạo Nhiều Kiểu Đa Dụng Cho Nữ, Băng keo dán ngực, nâng ngực quyến rũ dành cho nữ dododios, bám dính chắc chắn tuyệt đối có thể tạo nhiều kiểu - Chính hãng dododios",29000,29000,0,0
TIKI,thoi-trang-nu,7595728,"Áo Sơ Mi Nữ Sọc Thêu Mùa Thu MS0111A",185000,185000,0,0
TIKI,o-to-xe-may-xe-dap,1254755,"Chai Xịt Tẩy Gỉ Sét, Bôi Trơn Đa Năng Liqui Moly Multi-Spray Plus 7 3305 (500ml)",147250,155000,7750,5
TIKI,o-to-xe-may-xe-dap,36278697,"Nước Rửa Kính ô Tô Xuất Xứ Châu Âu Xglass Hương Bạc Hà (3.2l) - Hàng Chính Hãng",145000,145000,0,0
TIKI,o-to-xe-may-xe-dap,31139580,"Gạt mưa Bosch Advantage Chevrolet Cruze 24" - 18" (Đen)",251000,251000,0,0
TIKI,o-to-xe-may-xe-dap,157146707,"Băng Keo Nano Vân Carbon Bóng Phủ Acrylic Chống Trầy Xước Xe",55200,60000,4800,8
TIKI,o-to-xe-may-xe-dap,92131546,"Ví đựng giấy tờ xe ô tô Ford Da Cao Cấp, Ví da đựng giấy tờ xe ô tô - OTOALO",22990,22990,0,0
TIKI,o-to-xe-may-xe-dap,5483523,"Xịt khử mùi xe hơi Sonax SmokeEx 292241 500ml",220000,220000,0,0
TIKI,o-to-xe-may-xe-dap,101826179,"Bộ vam đĩa chặn, tháo vòng bi, bạc đạn - Bộ Vam đĩa, Cảo mặt trăng 14 chi tiết",657000,657000,0,0
TIKI,o-to-xe-may-xe-dap,32834656,"Bạt phủ xe máy loại dày che nắng mưa bụi bẩn - ghi",50138,50138,0,0
TIKI,o-to-xe-may-xe-dap,137789282,"Chai Xịt Tẩy Keo Băng Dính, Nhựa Đường, v.v Hiệu Quả Cực Mạnh - GD249",69000,69000,0,0
TIKI,o-to-xe-may-xe-dap,137548049,"Dung Dịch Nước Tẩy Rửa Dầu Nhớt",220000,220000,0,0
TIKI,o-to-xe-may-xe-dap,49968115,"Đệm lưới tựa lưng ghế ô tô",30300,30300,0,0
TIKI,o-to-xe-may-xe-dap,32322882,"Bộ chia tẩu sạc ô tô USB Huyndai HY36 loại tốt - Hàng nhập khẩu",73500,73500,0,0
TIKI,o-to-xe-may-xe-dap,41507312,"Chai xịt bảo dưỡng lốp ô tô 3M 39042LT tăng khăn lau ô tô chuyên dụng 3M màu ngẫu nhiên",219000,219000,0,0
TIKI,o-to-xe-may-xe-dap,159881199,"Bàn Đa Năng Treo Lưng Ghế, Vô Lăng Trên Xe Ô Tô, Bàn ăn gấp gọn trên ô tô",312550,329000,16450,5
TIKI,o-to-xe-may-xe-dap,21679101,"Tem Dán 3D Trang Trí Xe Ô Tô Chữ LIMITED ",79986,85000,5014,6
TIKI,o-to-xe-may-xe-dap,84592882,"Bộ cọ tròn rửa xe đa năng",65000,65000,0,0
TIKI,o-to-xe-may-xe-dap,114744998,"Combo 2 Lưỡi Gạt Mưa Loại A VIAIR R15 (22 Inch/550 mm)",83000,83000,0,0
TIKI,o-to-xe-may-xe-dap,41970060,"Khóa Xe Đạp, Xe Máy 5 Số, Siêu Bền, Khó Cắt - Giao Màu Ngẫu Nhiên",49596,49596,0,0
TIKI,o-to-xe-may-xe-dap,23354943,"ĐÁNH BÓNG BƯỚC 3 CAO CẤP 3M 06068 PERFECT-IT EX ULTRAFINE MACHINE POLISH, 1 QUART (946ML)",620000,620000,0,0
TIKI,o-to-xe-may-xe-dap,70838439,"Combo đèn led trước sau cho xe đạp Jett Blazers",199000,199000,0,0
TIKI,o-to-xe-may-xe-dap,25271628,"Tẩu cấp nguồn cho camera hành trình, kèm 02 cổng USB sạc điện thoại",75000,75000,0,0
TIKI,o-to-xe-may-xe-dap,26099433,"Bạt Phủ Chống Mưa - Nắng Bảo Vệ Xe Máy, Xe Đạp Có In Hình",32997,32997,0,0
TIKI,o-to-xe-may-xe-dap,55063136,"Bộ 2 miếng dán chống bám nước kính xe ô tô",52000,52000,0,0
TIKI,o-to-xe-may-xe-dap,52214298,"Bộ Gác Chân Trước Sau Cao Su Nhựa Màu cho xe Dream Wave Greennetwokrs",83000,83000,0,0
TIKI,o-to-xe-may-xe-dap,182404309,"Nước hoa ô tô hương cafe cao cấp Buckingham nhập khẩu Hàn Quốc",149000,149000,0,0
TIKI,o-to-xe-may-xe-dap,44350491,"Bạt Phủ Xe Máy Xe Đạp Che Mưa Nắng Cao Cấp KH06",34998,34998,0,0
TIKI,o-to-xe-may-xe-dap,24085827,"Túi Da Xịn Đựng Đăng Kiểm, Giấy Tờ Cho Ô tô logo Hyundai",22000,22000,0,0
TIKI,o-to-xe-may-xe-dap,69611729,"Cuộn Phản Quang 2 Màu Đỏ Trắng Bóc Dán Cho Xe Tải, Xe Container, Xe Hơi, Xe Ô tô Dài 45 Mét/ Cuộn Giúp An Toàn Ban Đêm Mai Lee",145000,179000,34000,19
TIKI,o-to-xe-may-xe-dap,35372429,"Cảng sau civi cho Wave A 100,WAVE A 110,WINNER,EXCITER 135,EXCITER 150,AXELO,WAVE BLADE,WAVE S110,SIRIUS BẢO LONG RACING",105000,105000,0,0
TIKI,o-to-xe-may-xe-dap,102410326,"Bộ gối tựa đầu và tựa lưng ô tô 3D cao su non Cao cấp",109995,109995,0,0
TIKI,o-to-xe-may-xe-dap,110199193,"Bộ đồng hồ đo áp suất dầu nhớt hộp số động cơ",455000,550000,95000,17
TIKI,o-to-xe-may-xe-dap,12289770,"Bộ chia tẩu sạc Huyndai HY-29",155000,155000,0,0
TIKI,o-to-xe-may-xe-dap,195540764,"Đệm Tỳ Tay ô Tô",69000,69000,0,0
TIKI,o-to-xe-may-xe-dap,150494364,"ĐỒNG HỒ GẮN Ô TÔ XE MÁY LOẠI TỐT SIÊU ĐẸP , ĐỒNG HỒ XE MÁY SIÊU HÓT",159000,159000,0,0
TIKI,o-to-xe-may-xe-dap,119718972,"Máy Sạc Ắc Quy 12V 5A Kèm Phục Hồi Bình, Bộ Sạc Bình Acquy Tự Ngắt Khi Đầy, Khử Sunfat",158000,158000,0,0
TIKI,o-to-xe-may-xe-dap,155005380,"Gối tựa đầu cao cấp chống mỏi cổ khi ngủ trên xe hơi, ô tô",474050,499000,24950,5
TIKI,o-to-xe-may-xe-dap,3527581,"Nước hoa ô tô cao cấp AREON Car Blue Perfume 100ml - NHẬP KHẨU BULGARIA",712500,750000,37500,5
TIKI,o-to-xe-may-xe-dap,34341611,"Bình chữa cháy/ cứu hỏa mini 500ml dành cho xe hơi ( HSD dùng 2023)",45000,45000,0,0
TIKI,o-to-xe-may-xe-dap,4280917,"Bàn chải vệ sinh sên xe máy Cao cấp 3D",25000,25000,0,0
TIKI,o-to-xe-may-xe-dap,174303241,"YÊN ĐI XE SỐ DREAM - WAVE - SIRIUS CHO BÉ",115000,115000,0,0
TIKI,o-to-xe-may-xe-dap,122830493,"Bộ 4 miếng cao su dán cánh cửa xe Chống va đập Logo SPORT",79000,79000,0,0
TIKI,o-to-xe-may-xe-dap,32282805,"Dụng Cụ Làm Mềm Làm Mới Lưỡi Gạt Nước Xe Ô Tô Cao Cấp AZONE",30000,30000,0,0
TIKI,o-to-xe-may-xe-dap,109191096,"Ốp, bọc bảo vệ chìa khóa cho xe Mercedes-Benz GLC-Class 2020-2021, E-Class 2020-2021, C-Class 2020-2021",188000,188000,0,0
TIKI,o-to-xe-may-xe-dap,51574367,"Keo vá lốp (Super Valkarn) thương hiệu Maruni - Nhật Bản (lọ 200cc)",200000,200000,0,0
TIKI,o-to-xe-may-xe-dap,192812313,"Combo 2 Miếng Dán Chống Trượt Thảm Ô Tô Miếng Lót Chân Miếng Kẹp Thảm Sàn Phụ Kiện Miếng Dán Cố Định Nội Thất Ô Tô",35000,35000,0,0
TIKI,o-to-xe-may-xe-dap,177299335,"Ty hãm cốp thuỷ lực cho xe bán tải Ford Ranger",350000,350000,0,0
TIKI,o-to-xe-may-xe-dap,151681304,"Bạt trùm che phủ xe ô tô Toyota Corolla Cross Cao Cấp 3 Lớp Chống Nắng Nóng Chống Nước Chống xước",255000,255000,0,0
TIKI,o-to-xe-may-xe-dap,170280815,"Đèn ưu tiên 12 bóng led xanh đỏ gắn kính lái ô tô",250000,250000,0,0
TIKI,o-to-xe-may-xe-dap,83366581,"pô cup DD Cao cấp dành cho xe cup DD 50 70 81 82 84 86 90",849500,849500,0,0
TIKI,o-to-xe-may-xe-dap,38993920,"Thảm lót sàn ô tô T25.3 50x150 cm, Thảm Lót Cốp Ô Tô",134000,134000,0,0
TIKI,o-to-xe-may-xe-dap,172068762,"Thảm taplo ô tô để đồ đa năng chống trượt kiêm giá đỡ và bảng ghi số điện thoại mẫu mới loại tốt siêu đẹp",58000,58000,0,0
TIKI,o-to-xe-may-xe-dap,22536664,"Bơm hút tự động nước, rượu, xăng dầu, chất lỏng, hóa chất đủ loại - loại mini chạy pin tự động chỉ 1 nút bấm",68799,68799,0,0
TIKI,o-to-xe-may-xe-dap,10007167,"Chai dưỡng sên, xịt sên Liqui Moly 1508 250ml",212000,212000,0,0
TIKI,o-to-xe-may-xe-dap,124385409,"Vè Che Mưa Ô Tô SUZUKI XL7 Ertiga Chỉ Inox ",367000,367000,0,0
TIKI,o-to-xe-may-xe-dap,188927209,"Dung Dịch Chống Thấm Nước Trên Kính Senfineco 9945 Water Repellant",225000,225000,0,0
TIKI,o-to-xe-may-xe-dap,128543422,"Giá Đỡ Bình Nước Xe Đạp Siêu Bền",19000,19000,0,0
TIKI,o-to-xe-may-xe-dap,19662320,"Hộp tỳ tay ô tô dành cho xe Mitsubishi Attrage và Mirage tích hợp 7 cổng USB (DUSB-ATG)",384995,384995,0,0
TIKI,o-to-xe-may-xe-dap,117927078,"BIOION AIR SANITIZER AEROSOL REFILL - Bình Xịt Khử Khuẩn, Khử Mùi (Dùng cho máy xịt tự động RX900) 250ML",125000,125000,0,0
TIKI,o-to-xe-may-xe-dap,75709451,"Dưỡng bóng dàn áo ,kim loại MEGACOOLS SiO2 Slick WAX 250ml, dễ sử dụng, an toàn, hiệu quả cao",104000,104000,0,0
TIKI,o-to-xe-may-xe-dap,21311957,"Kem xoá vết xước ô tô, xe máy F1-CC",19000,19000,0,0
TIKI,o-to-xe-may-xe-dap,19899873,"Bộ Rèm Chắn Nắng Nam Châm dành cho xe KIA Morning 2012-2019",259700,259700,0,0
TIKI,o-to-xe-may-xe-dap,157146235,"Bao Da Chìa Khóa Cho Xe Ford Ecosport, Everest, Ranger, Explorer (Da Thật)",138000,138000,0,0
TIKI,o-to-xe-may-xe-dap,139445907,"Sạc điện thoại xe máy kèm đồng hồ báo vôn ắc quy 2in1 mẫu mới lắp các loai xe siêu tiện loại tốt",169000,169000,0,0
TIKI,o-to-xe-may-xe-dap,189941368,"Tấm che nắng kính lái ô tô 5 lớp tráng bạc phản quang chống nóng tia UV",79000,79000,0,0
TIKI,o-to-xe-may-xe-dap,13306810,"Combo Đệm Tựa Lưng Massage Và Gối Tựa Đầu",268000,268000,0,0
TIKI,o-to-xe-may-xe-dap,90574279,"Bảng Số Điện Thoại Kiêm Giá Điện Thoại Đa Năng Để Taplo Ô Tô Kim Loại Cao Cấp",65000,65000,0,0
TIKI,o-to-xe-may-xe-dap,15832262,"Dây An Toàn Dùng Cho Ô Tô Tiện Lợi ( rộng 5 cm ) - Ghi",85000,85000,0,0
TIKI,o-to-xe-may-xe-dap,23291784,"Súng bơm lốp xe ô tô dùng khí Total TAT11601",186000,186000,0,0
TIKI,o-to-xe-may-xe-dap,72026298,"Hộp đựng khăn giấy kiêm bảng số điện thoại và đồng hồ cao cấp đặt taplo ô tô, xe hơi TB-6137",196997,196997,0,0
TIKI,o-to-xe-may-xe-dap,53900678,"Sạc Pin Dành Cho Xe Ô Tô & Xe Máy Điện Trẻ Em 12V Có Đèn Báo Pin",91000,91000,0,0
TIKI,o-to-xe-may-xe-dap,113352117,"Nước Hoa Ô Tô Cao Cấp Etonner E1801D 60ml thiết kế để taplo xe sang trọng, phù hợp với nhiều dòng xe.",980000,980000,0,0
TIKI,o-to-xe-may-xe-dap,177301126,"Nẹp bước chân trong TITAN ô tô Vinfast Lux A 2.0 2020-2021-2022 chống trầy bảo vệ trang trí xe",288000,288000,0,0
TIKI,o-to-xe-may-xe-dap,116057963,"Thảm Taplo Da Carbon xe Mitsu Xpander 2018 2019 2020 cao cấp",268000,268000,0,0
TIKI,o-to-xe-may-xe-dap,54141077,"Bộ 2 Gương Chiếu Hậu Cho Xe Đạp Thể Thao Địa Hình Xoay 360 Độ Giúp Lái Xe An Toàn",68200,68200,0,0
TIKI,o-to-xe-may-xe-dap,130470626,"Gạt mưa Silicone xương cứng Mazda 3 -2018",231000,231000,0,0
TIKI,o-to-xe-may-xe-dap,36689130,"ĐÈN XI NHAN  WINNER X , BỘ ĐÈN XI NHAN TAM GIÁC CHO XE WINNER X ĐẸP QUÊN LỐI VỀ - MÀU VÀNG-XNTG",52000,52000,0,0
TIKI,o-to-xe-may-xe-dap,27883304,"Quạt Đôi Mini 12V Xoay 360 Dành Cho Xe Ô Tô",118000,118000,0,0
TIKI,o-to-xe-may-xe-dap,74214137,"Gối tựa đầu ô tô và gối tựa lưng ô tô cao su non đúc nguyên khối,đàn hồi cực tốt,bọc da cao cấp-SIÊU ÊM-SIÊU BỀN-KHÔNG NỔ DA",323997,323997,0,0
TIKI,o-to-xe-may-xe-dap,48110441,"ghi đông cho xe 68 72 tặng bao tay xe máy",169000,169000,0,0
TIKI,o-to-xe-may-xe-dap,102511519,"Giá đỡ điện thoại hút chân không gắn kính hoặc táp lô ô tô Baseus SUYL-TK01 Tank gravity car mount holder with suction base - Hàng chính hãng",342000,360000,18000,5
TIKI,o-to-xe-may-xe-dap,56329666,"Nẹp Chữ U Mạ Crom Trang Trí Và Chống Xước Viền Ô Tô",68997,68997,0,0
TIKI,o-to-xe-may-xe-dap,84446103,"Kính Phi Công Chống Nắng Chống Bụi Chống Tia UV",59000,59000,0,0
TIKI,o-to-xe-may-xe-dap,10681029,"Pin Camera Hành Trình Xe Máy 900mAh",70000,70000,0,0
TIKI,o-to-xe-may-xe-dap,165635891,"Hộp bộ dụng cụ siết ốc vít, bugi cơ khí sửa chữa ô tô ( oto) xe máy 40 món chi tiết GD640",75000,75000,0,0
TIKI,o-to-xe-may-xe-dap,8512185,"Mũ 3/4 Bulldog Heli Carbon",2600000,2600000,0,0
TIKI,o-to-xe-may-xe-dap,132899137,"Bóng đèn LED 12V T10 COB T10C-1",4000,4000,0,0
TIKI,o-to-xe-may-xe-dap,147931967,"Phôi chìa khóa xe mô tô Yamaha FZ150i",70000,70000,0,0
TIKI,o-to-xe-may-xe-dap,117469914,"Cặp bao tay dành cho xe máy RCB gù nhôm CNC",115000,115000,0,0
TIKI,o-to-xe-may-xe-dap,52150469,"Ổ Khóa 8 Cạnh Dành Cho Xe Máy Future",173000,185000,12000,6
TIKI,o-to-xe-may-xe-dap,1254567,"Chất Tấy Rửa, Bôi Trơn, Chống Rỉ Sét 3M 5 Way (400ml)",70000,70000,0,0
TIKI,o-to-xe-may-xe-dap,9834560,"Dầu nhớt tổng hợp dành cho xe côn Liqui Moly Synth Street  Race10W40 ",309000,309000,0,0
TIKI,o-to-xe-may-xe-dap,173447770,"Bộ dụng cụ kiểm tra áp bơm nhiên liệu xăng",199000,250000,51000,20
TIKI,o-to-xe-may-xe-dap,136187475,"RÈM CHE NẮNG NAM CHÂM CHO XE TOYOTA FORTUNER 2008-2015",248000,248000,0,0
TIKI,o-to-xe-may-xe-dap,1254699,"Chai Xịt Phủ Gầm Đen Liqui Moly Stoneguard Black 6113 (500ml)",229000,229000,0,0
TIKI,o-to-xe-may-xe-dap,97427098,"(HÀNG CHÍNH HÃNG) Kem đánh bóng kim loại Autosol Metal Polish 75ml - - ",59000,59000,0,0
TIKI,o-to-xe-may-xe-dap,161527916," Kem tẩy gương, kính chiếu hậu ô tô TOKO 60 M - Tẩy ố gương, tẩy cặn canxi, ố mốc kính, đảm bảo an toàn gương có lớp chống chóa | Lựa chọn hàng đầu của GARAGE, Chăm sóc xe",199000,362000,163000,45
TIKI,o-to-xe-may-xe-dap,131192953,"Dè nối 2 râu dành cho ex 150 & 155",65000,65000,0,0
TIKI,o-to-xe-may-xe-dap,68521434,"Dụng Cụ Móc Lốp Xe, Lấy Đinh Gảy Đinh, Loại Bỏ Đá Trên Lốp 2 in 1 Với Cây Tua Vít Giúp Lấy Cạy Đinh, Loại Bỏ Đá Dăm/ Cát Lốp Xe Hơi Bảo Vệ Lốp Xe Hơi, Ô tô, Xe Tải",26900,26900,0,0
TIKI,o-to-xe-may-xe-dap,5554157,"Bộ Đèn Led Xi Nhan 2 tầng Siêu Sáng Đẹp cho xe máy Exciter",45000,45000,0,0
TIKI,o-to-xe-may-xe-dap,2841255,"Bộ sạc Acquy đa năng ANSMANN ALCT 6-24V - Hàng Nhập Khẩu",2145000,2145000,0,0
TIKI,o-to-xe-may-xe-dap,81794754,"Sơn Xịt Phủ Gầm Chống Ồn Chống Rỉ Sét Flamingo F021 500ml - Hãng Phân Phối Chính Thức",118990,118990,0,0
TIKI,o-to-xe-may-xe-dap,1378139,"Paste Đánh Bóng 1 Bước Nhanh Chóng 3M Polish Finishing Material 81235 (1L)",620000,620000,0,0
TIKI,o-to-xe-may-xe-dap,37466648,"Hộp đựng khăn giấy hình chú khỉ siêu dể thương treo xe hơi ,bàn làm việc phòng ăn. Shop giao mầu ngẫu  nhiên",88683,164000,75317,46
TIKI,o-to-xe-may-xe-dap,189175790,"FULL ỐP PHỤ KIỆN TRANG TRÍ DÙNG CHO ĐỜI XE AB 2022 2023 2024 - 125 160cc CACBON",44200,44200,0,0
TIKI,o-to-xe-may-xe-dap,3121057,"Dung Dịch Làm Sạch Mâm Vành SONAX Rim Cleaner 429200 (500ml)",190000,190000,0,0
TIKI,o-to-xe-may-xe-dap,98030779,"Bạt Phủ Xe Máy Chống Mưa, Nắng, Bụi Bẩn Chất Lượng Cao Chống Thấm Tuyệt Đối, Bao Trùm Cả Xe",63000,63000,0,0
TIKI,o-to-xe-may-xe-dap,13389629,"Bộ Sửa Chữa Vá Xăm Xe Đạp, Xe Máy Tiện Dụng",21000,21000,0,0
TIKI,o-to-xe-may-xe-dap,144097800,"Phuộc Sau - Vision ",265000,265000,0,0
TIKI,o-to-xe-may-xe-dap,177642752,"Găng tay nam mùa đông cảm ứng điện thoại lót lông cực ấm, lòng bàn tay chống trượt cao cấp - Phong cách nam tính GTN68",278000,278000,0,0
TIKI,o-to-xe-may-xe-dap,87159024,"Chân chống cạnh - chống nghiêng dành cho xe Sirius, Jupiter (dễ dàng lắp đặt tại nhà ) - TA2425 ",211000,340480,129480,38
TIKI,o-to-xe-may-xe-dap,38354744,"NƯỚc RỬa Xe KhÔng ChẠm VÀ RỬa Khoang ĐỘng CƠ Ekokemika Italy Bio 45 - (5l) - Hàng Chính Hãng",1050000,1050000,0,0
TIKI,o-to-xe-may-xe-dap,31716671,"Bộ Đổi Nguồn 220v Sang 12v Chân Tẩu 10A-120W Cao Cấp AZONE",220000,220000,0,0
TIKI,o-to-xe-may-xe-dap,153941749,"Thảm sàn, lót sàn cao su 3D cho Toyota Innova 2016-2019",856000,856000,0,0
TIKI,o-to-xe-may-xe-dap,155225591,"Bao Da Ép Phom dành cho Chìa Khoá Mercedes, Mec đời 2019 trở lên màu nâu 002e",399000,399000,0,0
TIKI,o-to-xe-may-xe-dap,38164829,"Kem Đánh Bóng Và Bảo Vệ Sơn Xe Màu Đen Sonax Polish & Wax Color Black 296141 250ml",180000,180000,0,0
TIKI,o-to-xe-may-xe-dap,152833353,"Kem xóa vết xước, đánh bóng ô tô xe máy",18900,18900,0,0
TIKI,o-to-xe-may-xe-dap,53450914,"Bảng số điện thoại dạ quang ACNUM-B0S gắn taplo ô tô, xe hơi nhãn hiệu Baseus - Hàng Nhập Khẩu",98499,98499,0,0
TIKI,o-to-xe-may-xe-dap,72592679,"Mobin dành cho xe SH Việt - 2848",197000,318400,121400,38
TIKI,o-to-xe-may-xe-dap,90832568,"Combo bộ bơm điện và vá xe STOP&GO dùng cho xe máy, ô tô - thích hợp đi phượt đường dài, xe mô tô PKL, xe hơi",899000,899000,0,0
TIKI,o-to-xe-may-xe-dap,50584349,"Pô lon 4road inox dành cho xe vario / shvn / air blade 125",2199000,2199000,0,0
TIKI,lam-dep-suc-khoe,119253125,"Sữa dưỡng ẩm cho da nhạy cảm Cetaphil Moisturizing Lotion 200ml",316000,316000,0,0
TIKI,lam-dep-suc-khoe,5902347,"Kem dưỡng trắng da Acnes Whitening+ Cream 50g",80200,99000,18800,19
TIKI,lam-dep-suc-khoe,6759739,"Bộ 3 Kem đánh răng Colgate Sensitive ngăn ê buốt và bảo vệ toàn diện 110g/tuýp",189000,207000,18000,9
TIKI,lam-dep-suc-khoe,172111067,"DẦU GỘI TÍM ELGON COLOR CARE SILVER SHAMPOO KHỬ ÁNH VÀNG CHO TÓC BẠCH KIM",330000,330000,0,0
TIKI,lam-dep-suc-khoe,270988813,"Vitamin C Puritan's Pride with Bioflavonoids & Rose Hips -1000mg tăng sức đề kháng, làm đẹp da - QuaTangMe Extaste",335000,670000,335000,50
TIKI,lam-dep-suc-khoe,10795646,"Serum Chống Nắng Dưỡng Thể Kháng Bụi - Trắng Sáng Mịn Màng Biore (50ml)",68000,86000,18000,21
TIKI,lam-dep-suc-khoe,11590559,"Kem dưỡng ẩm, mờ nếp nhăn - Vitamin E, Jojoba, Vitamin A - ENAT NATURAL VITAMIN E Mega We Care (Tuýp 30g)",100000,110000,10000,9
TIKI,lam-dep-suc-khoe,138037552,"Combo 3 Chai Nước Muối Vĩnh Phúc Smiles - Natri Clorid 0,9",42800,42800,0,0
TIKI,lam-dep-suc-khoe,37405722,"Cà Phê Xanh Hỗ Trợ Giảm Cân Thiên Nhiên Việt (Hộp 10 Gói)",130000,130000,0,0
TIKI,lam-dep-suc-khoe,16441917,"Son Gạo Hương Dâu ",90000,90000,0,0
TIKI,lam-dep-suc-khoe,74763869,"Bao cao su Ritex Longtime - kéo dài thời gian bằng vòng đôi cao su, hộp 3 chiếc",87000,87000,0,0
TIKI,lam-dep-suc-khoe,113165937,"Bộ 3 Bàn chải Colgate Slimsoft Between Charcoal lông chải mềm mảnh xen sợi phủ than hoạt tính",76000,76000,0,0
TIKI,lam-dep-suc-khoe,35933597,"Sữa Rửa Mặt Làm Sạch Và Giảm Mụn Acne-Aid Liquid Cleanser 100ml",175000,175000,0,0
TIKI,lam-dep-suc-khoe,113215733,"[5 Trong 1- Mờ Nám- Tàn Nhang, Tăng Vòng 1, Cân Bằng Nội Tiết Tố, Sinh Lý Nữ ]] - Viên Uống Glutathione - Hàng Chính Hãng Dr Lacir",580000,580000,0,0
TIKI,lam-dep-suc-khoe,126945372,"Bao Cao Su LifeStyles Classic Thiết Kế Mỏng, Ôm sát vừa vặn, Nhiều Gel Bôi Trơn - Hộp 3 bao",29000,35000,6000,17
TIKI,lam-dep-suc-khoe,76184280,"Bộ bao da dụng cụ 16 món cắt móng",79000,79000,0,0
TIKI,lam-dep-suc-khoe,247955149,"Collagen Cho Nam Youtheory Mỹ Chứa Collagen, Vitamin C, Biotin… Tạo Sức Khỏe Từ Bên Trong Cho Da, Tóc, Móng, Sụn, Gân, Dây Chằng, Khớp, Tim Mạch Và Tăng Hệ Miễn Dịch - QuaTangMe Extaste",627000,1254000,627000,50
TIKI,lam-dep-suc-khoe,195899280,"Bao cao su nam Feelex 2 in 1 gân gai hương dâu nhiều gel bôi trơn",109000,109000,0,0
TIKI,lam-dep-suc-khoe,96709378,"Viên nang mềm Nano curcumin Cumargold new 150 mg cùng gừng chuẩn hóa hỗ trợ cải thiển trào ngược, viêm loét dạ dày tá tràng",275000,275000,0,0
TIKI,lam-dep-suc-khoe,58452001,"Viên Sủi FOFLUU Giảm Cảm Lạnh Tăng Sức Đề Kháng Giảm Các Triệu Chứng Ho Sốt Hắt Xì ( Hộp 20 viên sủi vị trái cây )",150000,150000,0,0
TIKI,lam-dep-suc-khoe,10225411,"Bông tẩy trang bề mặt mịn Bông Bạch Tuyết (180 Miếng)",36000,68000,32000,47
TIKI,lam-dep-suc-khoe,442980,"Dầu Gội Dove Phục Hồi Hư Tổn (900g) - 21062569",179000,179000,0,0
TIKI,lam-dep-suc-khoe,72556249,"Viên uống DHC Bổ Sung Vitamin E Nhật Bản 20 Ngày",99000,110000,11000,10
TIKI,lam-dep-suc-khoe,116244839,"Máy Massage Cao Cấp KINGTECH ST-502B - Giúp Tuần Hoàn, Giảm Đau Mỏi - Mát xa Thư Giãn Bàn Và Bắp Chân Tích Hợp Nhiệt Kèm Điều Khiển Cầm Tay - Quà Tặng Ý Nghĩa Cho Người Thân",2005000,3350000,1345000,40
TIKI,lam-dep-suc-khoe,113407575,"Combo 3 bánh xà phòng gạo trắng da Thái Lan",24000,24000,0,0
TIKI,lam-dep-suc-khoe,73921463,"Dầu gội tím khử vàng chăm sóc và làm sáng màu tóc RRline Therapy Sliver Shampoo 350ml",216000,270000,54000,20
TIKI,lam-dep-suc-khoe,167129299,"Máy đo huyết áp điện tử bắp tay Sinocare BA-801 Đức + Tặng bộ đổi nguồn ( Adapter )",320000,320000,0,0
TIKI,lam-dep-suc-khoe,171873291,"Bộ đôi sản phẩm Siêu Nghệ Decumar Advanced sạch các loại mụn và sáng da sau 2 tuần sử dụng",170000,182000,12000,7
TIKI,lam-dep-suc-khoe,4485287,"Vớ/tất y khoa gối hỗ trợ điều trị suy giãn tĩnh mạch chân JOBST Relief chuẩn áp lực 20-30mmHg",650000,700000,50000,7
TIKI,lam-dep-suc-khoe,191726092,"Sữa tắm Bioré Dưỡng Ẩm Đủ Hương 530g",81000,102000,21000,21
TIKI,lam-dep-suc-khoe,270881660,"Vitamin C Mỹ Puritan's Pride  500 mg giúp tăng sức đề kháng, tăng sản xuất collagen, nhanh lành bệnh, vết thương - QuaTangMe Extaste",254400,534000,279600,52
TIKI,lam-dep-suc-khoe,1601735,"Sữa Rửa Mặt Tea Tree Skin Clearing Facial Wash (250ml)",174500,349000,174500,50
TIKI,lam-dep-suc-khoe,71909258,"Nước Hoa Hồng Cho Da Mụn La Roche Posay Effaclar Astringent Lotion 200ml",377000,455000,78000,17
TIKI,lam-dep-suc-khoe,92159205,"Combo Bao cao su Durex Pleasuremax Hộp 12 Bao và hộp 3 bao",260000,350000,90000,26
TIKI,lam-dep-suc-khoe,105515020,"Gel Bí Đao Rửa Mặt Cocoon 310ml",295000,295000,0,0
TIKI,lam-dep-suc-khoe,102108970,"Viên Nghệ Mật Ong Cao Cấp HNT 300g – Viên Tinh Bột Nghệ Mật Ong Tự Nhiên – 100% Nguyên Liệu Tụ Nhiên – Hoàn Toàn An Toàn Cho Sức Khỏe -  Sản Phẩm Chính Hãng – Uy Tín",179000,179000,0,0
TIKI,lam-dep-suc-khoe,127152384,"Kem đánh răng trắng răng Eucryl Anh Quốc Giúp răng trắng sáng bền lâu , sạch bóng và thơm mát cả nhà - OZ Slim Store - 62g/tuýt",160000,336000,176000,52
TIKI,lam-dep-suc-khoe,57666220,"Kem Phục Hồi Da, Lành Sẹo, Chống Nhiễm Khuẩn Avène Cicalfate Cream 15ml",212000,249000,37000,15
TIKI,lam-dep-suc-khoe,175097284,"Kem đánh răng Sensodyne Rapid Action Whitening 100g",98000,100000,2000,2
TIKI,lam-dep-suc-khoe,8094477,"Túi Chườm Lạnh Greetmed",48000,48000,0,0
TIKI,o-to-xe-may-xe-dap,41862396,"Lót Cốp Nhựa TPO Cao Cấp Dành Cho Hyundai Accent 2018/2020",352000,352000,0,0
TIKI,o-to-xe-may-xe-dap,97431774,"Chai xịt làm bóng da, dưỡng nhựa Telox Wax 500ml",45000,45000,0,0
TIKI,o-to-xe-may-xe-dap,138043464,"(Chọn mẫu) Decal dán nắp capo xe ô tô chữ ký Sport mind, decan trang trí xe hơi, sticker Sport mind các đời xe,màu xe",60000,60000,0,0
TIKI,o-to-xe-may-xe-dap,50385956,"Bộ 3 phụ gia thay định kì bao gồm nhớt 33017, xăng 33027, nano 33047 cao cấp cho xe máy Bluechem - 33017_33027_33047",258000,258000,0,0
TIKI,o-to-xe-may-xe-dap,22828165,"Cần Số 2 Chiều Sơn Tỉnh Điện Cho Xe Exciter 150 MS1565 - Tặng Thêm 1 Pin AAA Maxell",78000,78000,0,0
TIKI,o-to-xe-may-xe-dap,127546179,"Nút dán giảm lực đóng bảo vệ cửa xe ô tô, miếng dán Silicon bảo vệ cửa ô tô có logo các hãng",4000,4000,0,0
TIKI,o-to-xe-may-xe-dap,74238245,"Đệm hạt gỗ tựa lưng massage lót ghế ô tô, xe hơi làm từ 100% gỗ Hương Đỏ tự nhiên cao cấp (HD-D)",240997,240997,0,0
TIKI,o-to-xe-may-xe-dap,52236917,"Khay để đồ cài khe ghế ô tô cao cấp GK21",108998,108998,0,0
TIKI,o-to-xe-may-xe-dap,124274270,"Bọc Chân Thắng Cao Su Dùng Cho Xe Máy",9500,10000,500,5
TIKI,o-to-xe-may-xe-dap,3148327,"Túi Treo Sườn Xe Đạp",34900,34900,0,0
TIKI,o-to-xe-may-xe-dap,116105880,"Bao da dành cho chìa khoá gập Ford Focus, Ecosport, Fiesta, Ranger handmade da thật 002",199000,199000,0,0
TIKI,o-to-xe-may-xe-dap,115623326,"Gioăng cao su chống ồn chữ B cho ô tô | Cuộn Ron cao su chữ B dài 10 mét cách âm chống ồn cho xe hơi",109000,109000,0,0
TIKI,o-to-xe-may-xe-dap,95937734,"Chốt cốp chữ T dành cho xe Honda -Dream -TKAs.505",69000,112320,43320,39
TIKI,o-to-xe-may-xe-dap,14867643,"Đèn Trợ Sáng Led Power 20W Dành Cho Xe Máy - SIÊU SÁNG - TIẾT KIỆM - Loại 1",73000,81949,8949,11
TIKI,o-to-xe-may-xe-dap,49941007,"Bộ Gối Tựa Đầu Và Tựa Lưng Xe Hơi, Chất Liệu Cao Su Non Cao Cấp",270000,270000,0,0
TIKI,o-to-xe-may-xe-dap,35736205,"NANO SEALANT DẠNG XỊT BẢO VỆ LÀM MỚI SƠN MỜ CHEMICAL GUYS METICULOUS MATTE DETAILER 16OZ",650000,650000,0,0
TIKI,o-to-xe-may-xe-dap,3259639,"Chân chống xe đạp 2 điểm pat cực chắc chắn",128000,128000,0,0
TIKI,o-to-xe-may-xe-dap,169926866,"Bộ Ty Thủy Lực, Ben Hơi, Ty Cốp Sau Cho Xe Huyndai Accent 2016-2020",329000,329000,0,0
TIKI,o-to-xe-may-xe-dap,48303526,"Chổi Lông Rửa Xe Cao Cấp Tiện Dụng",30000,30000,0,0
TIKI,o-to-xe-may-xe-dap,47255806,"heo dầu trước cho xe hayate tặng bao tay xe máy",195000,195000,0,0
TIKI,o-to-xe-may-xe-dap,138617419,"ống bơm bánh xe đạp và xe máy",35000,35000,0,0
TIKI,o-to-xe-may-xe-dap,22230660,"DUNG DỊCH BẢO VỆ VÀ TĂNG CƯỜNG ĐỘ BÓNG  Sealing Wax Protection",859000,859000,0,0
TIKI,o-to-xe-may-xe-dap,196537660,"Tấm thảm lót chân xe máy điện Klara S 2019",150000,150000,0,0
TIKI,o-to-xe-may-xe-dap,92133107,"Ví đựng giấy tờ xe ô tô Mazda Da Cao Cấp, Ví da đựng giấy tờ xe ô tô - OTOALO",49000,49000,0,0
TIKI,o-to-xe-may-xe-dap,21088438,"Bình 1L tạo bọt tuyết sử dụng cho máy cao áp",268880,336100,67220,20
TIKI,o-to-xe-may-xe-dap,176236651,"Cặp đèn xi nhan độ cho xe classic cafe",56000,56000,0,0
TIKI,o-to-xe-may-xe-dap,92983558," ️Túi treo để đồ lưng ghế bằng da cao cấp, thiết kế thông minh có kèm bàn ăn gắp gọn cho xe ô tô️",240900,240900,0,0
TIKI,o-to-xe-may-xe-dap,26017460,"Bộ 2 ốp gương theo xe Vios 2019",243000,243000,0,0
TIKI,o-to-xe-may-xe-dap,197926157,"Khóa Xe Đạp Khóa Mật Khẩu Xe Đạp Chống Trộm - Khóa dây 4 số bảo mật - Dây Xích Khóa Xe Đạp, Phụ Kiện Xe Đạp",55000,55000,0,0
TIKI,o-to-xe-may-xe-dap,25564858,"Thẻ Ghi Số Điện Thoại Kiêm Giá Để Điện Thoại Trên Taplo Ô Tô",56000,60000,4000,7
TIKI,o-to-xe-may-xe-dap,100418392,"Ốc dàn áo dành cho xe exciter 150",159990,159990,0,0
TIKI,o-to-xe-may-xe-dap,84870095,"Dung Dịch Rửa Lốc Máy Siêu Mạnh, Tẩy Khoang Máy, Đầu Bò PALLAS 500ml",39000,39000,0,0
TIKI,o-to-xe-may-xe-dap,196586398,"Dè chắn bùn xe đạp thể thao MTB leo núi, vè trước sau full hộp",120000,120000,0,0
TIKI,o-to-xe-may-xe-dap,116965760,"Bao Da dành cho Chìa Khóa dày Vespa, Piaggio handmade da thật",100000,100000,0,0
TIKI,o-to-xe-may-xe-dap,74895570,"YÊN GHẾ DÀNH CHO CÁC LOẠI XE TAY GA VÀ XE SỐ ( YÊN RỜI )",65000,65000,0,0
TIKI,o-to-xe-may-xe-dap,7005929,"Bộ 3 sản phẩm xịt bảo dưỡng nội thất 39040, bảo dưỡng lốp 39042 và tăng độ bóng sơn 39034 3M COMBO-3DD-USA",854050,899000,44950,5
TIKI,o-to-xe-may-xe-dap,99275571,"Tấm Chắn Nắng, Chống Nóng Ngoài Kính Lái Ô Tô 3 Lớp, Tráng Bạc Cỡ Lớn 118cm x 148cm, Có Trùm Gương - Hàng chính hãng",119000,180000,61000,34
TIKI,o-to-xe-may-xe-dap,36068156,"Vè Che Mưa Dành Cho Xe Ô Tô Innova 2018",287500,287500,0,0
TIKI,o-to-xe-may-xe-dap,105184892,"Pat gắn đèn trợ sáng - lắp chân gương chữ L",18000,18000,0,0
TIKI,o-to-xe-may-xe-dap,54157945,"Bộ 4 decal phản quang dán tay nắm cửa xe ô tô",89000,89000,0,0
TIKI,o-to-xe-may-xe-dap,49408703,"Khóa số Xe đạp, xe máy Chống Trộm có mã 5 số bảo mật cao Tặng bộ vá xe đạp",98900,98900,0,0
TIKI,o-to-xe-may-xe-dap,130173588,"Tẩu sạc nhanh dùng trên ô tô xe hơi có đèn led báo điện áp Ác Quy",145000,145000,0,0
TIKI,o-to-xe-may-xe-dap,141917127,"Bạt che / Bạt phủ ô tô. chống nắng-mưa, cách nhiệt bảo vệ xe hơi 5D tráng nhôm cao cấP. (CHE NỬA)",180995,180995,0,0
TIKI,o-to-xe-may-xe-dap,131183458,"Lọc gió điều hòa ô tô HONDA CIVIC 1.8/2.0L 2007-2017",103000,103000,0,0
TIKI,o-to-xe-may-xe-dap,162581887,"Máy bơm lốp ô tô Tâm Luân động cơ DÂY ĐỒNG, chip chống quả tải và ngắn mạch, máy bơm lốp xe ô tô công suất 120w, máy bơm ô tô 12V",194000,350000,156000,45
TIKI,o-to-xe-may-xe-dap,105043763,"Bảng Hiển Thị Số Điện Thoại Gắn Trên Taplo Xe Ô TÔ + Tặng 1 móc khóa xinh xắn",27000,27000,0,0
TIKI,o-to-xe-may-xe-dap,113230601,"GĂNG TAY RỬA XE SIÊU MỀM MÀU XANH SỢI MICROFIBER GIỮ BỌT MAXSHINE CRAZY MICRO-CHENILLE WASH MITT 24X17CM 1120003G",179000,179000,0,0
TIKI,o-to-xe-may-xe-dap,119356183,"Tẩu chia sạc 12V-24V trên ô tô thành 2 cổng và 2 chân USB",129000,129000,0,0
TIKI,o-to-xe-may-xe-dap,184124859,"Đèn LED bi cầu mini Y6D 72W 6000K model 2022 chân H4 cho ô tô, xe máy(giá 1 cái)",450000,450000,0,0
TIKI,o-to-xe-may-xe-dap,5524557,"Đèn LED trợ sáng C6 cho xe máy ",49000,49000,0,0
TIKI,o-to-xe-may-xe-dap,25555995,"Gối tựa đầu xe hơi, ô tô  chất liệu cao su non cao cấp V2",74997,74997,0,0
TIKI,o-to-xe-may-xe-dap,47136035,"Gương cầu lồi 2 mặt xóa điểm mù quan sát 2 bánh xe trước sau, gương xoay 360 độ, dán lên gương kính chiếu hậu chính cho xe hơi, ô tô",49000,49000,0,0
TIKI,o-to-xe-may-xe-dap,186109604,"Thảm Taplo dành cho xe Daewoo Magnus chất liệu Nhung",210000,210000,0,0
TIKI,o-to-xe-may-xe-dap,95306007,"Xe đạp địa hình Thống Nhất MTB 24-04 - Hàng chính hãng - Màu",3250000,3250000,0,0
TIKI,o-to-xe-may-xe-dap,273238535,"xe đạp thể thao tuaring Thống Nhất MTB 26-05 - Hightway  ( mẫu cải tiến mới 2023 ) - HÀNG CHÍNH HÃNG ( TẶNG THÊM 1 BƠM XE + KHÓA DÂY MÃ SỐ )",4800000,4800000,0,0
TIKI,o-to-xe-may-xe-dap,174134202,"Xe đạp địa hình Thống Nhất SLX 27,05-1 - Hàng chính Hãng (Kèm khóa dây mã số và chắn bùn trước sau)",6750000,6750000,0,0
TIKI,o-to-xe-may-xe-dap,146904119,"Logo Vương Miện Đính Đá Gắn Trang Trí Xe Ô Tô",95060,95060,0,0
TIKI,o-to-xe-may-xe-dap,49241132,"Bảng để lại số điện thoại trên ô tô khi đỗ xe",9000,9000,0,0
TIKI,o-to-xe-may-xe-dap,140919290,"xe đạp nữ mini Thống Nhất New 24 inch - hàng chính hãng",2890000,2890000,0,0
TIKI,o-to-xe-may-xe-dap,52987923,"Bộ 2 Bọc Cầm Tay Lái Xe Đạp Cao Su Chống Trơn Trượt (phi 2.2 cm) Dễ Dàng Lắp Đặt Cho Xe Đạp Địa Hình Mai Lee",107000,119000,12000,10
TIKI,o-to-xe-may-xe-dap,96325586,"Bóng Đèn Led gầm xe hơi Demi Đờ mi chân H8 H9 H11 cho xe hơi ô tô siêu tiết kiệm Toyota Innova Vios Honda City Sương mù",79000,79000,0,0
TIKI,o-to-xe-may-xe-dap,191356034,"Xe Đạp Thể Thao Gấp Gọn FS Bike NS-001 Vành 26inch 24 Tốc Độ Nhập Khẩu Đại Nam Sport + Tặng Mũ Bảo Hiểm,Khóa Chống Trộm Và Chắn Bùn",5000000,5000000,0,0
TIKI,o-to-xe-may-xe-dap,57986998,"Nhớt Động Cơ Xe Máy Fuchs Silkolene 10W40 JASO MA2 API SM&SN 1 Lít",270000,270000,0,0
TIKI,o-to-xe-may-xe-dap,179948270,"Búa Cứu Hộ Xe Hơi Đa Năng 7 Trong 1 Cao Cấp",94050,99000,4950,5
TIKI,o-to-xe-may-xe-dap,274608436,"Miếng Đệm Hạt Gỗ PaKaSa Massage Ghế Ô TÔ , Xe Hơi , Ghế Văn Phòng KT 45 x 45 cm - Chính Hãng",145000,210000,65000,31
TIKI,o-to-xe-may-xe-dap,186162539,"Thảm taplo cho Transit 2014-2015-2016-2017-2018-2019-2020-2021-2022 chống nắng nóng làm mát xe mở rộng tầm nhìn",195000,195000,0,0
TIKI,o-to-xe-may-xe-dap,75793488,"Đèn hậu xe máy, đèn hậu xe máy nhiều màu, đèn nhiều màu dành cho hậu xe máy, đèn LED xe máy 12V, dùng điện bình ác quy, công suất nhỏ, đèn phụ tùng xe máy hậu nhiều led - DHNDM",35131,36980,1849,5
TIKI,o-to-xe-may-xe-dap,118298199,"Xe đạp đường phố Giant Ineed Latte 2021",10300000,10300000,0,0
TIKI,o-to-xe-may-xe-dap,157936018,"XE ĐẠP THỂ THAO FORNIX FR307",3217000,3490000,273000,8
TIKI,o-to-xe-may-xe-dap,43378362,"Bộ 2 Phuộc Sau DBS Giảm Xóc Gắn Cho Sirius ",290000,290000,0,0
TIKI,o-to-xe-may-xe-dap,7923502,"Lốp Xe Máy 80/90-17 Không Ruột",360000,360000,0,0
TIKI,o-to-xe-may-xe-dap,86284720,"Xe đạp thể thao khung nhôm 27,5" 21 speed",3695500,3890000,194500,5
TIKI,o-to-xe-may-xe-dap,55097704,"Nón bảo hiểm Lật hàm Fullface Royal M179 - Xanh lính - 2 ốp tai tháo rời",549000,549000,0,0
TIKI,o-to-xe-may-xe-dap,11221458,"Lốp Xe Piago Vespa LX DPLUS",450000,450000,0,0
TIKI,o-to-xe-may-xe-dap,59210353,"Bộ 4 móc treo đồ tiện dụng trên xe OTOS-4C",32000,32000,0,0
TIKI,o-to-xe-may-xe-dap,135156169,"XE ĐẠP THỂ THAO SIZE 20 INCH dành cho bé 7 tuổi - 11 TUỔI + Tặng kèm giỏ xe, gácbaga, túi, bình nước",1159000,1159000,0,0
TIKI,thoi-trang-nu,102939016,"(6530)quần mặc trong váy ko lằn mông ,thông hơi ,thoáng mát",28500,30000,1500,5
TIKI,thoi-trang-nu,25135599,"Áo Croptop Nữ Tay Dài Z_8",118000,118000,0,0
TIKI,thoi-trang-nu,157530150,"(HÀNG SẴN KHO) Áo khoác len cardigan dáng dài chất liệu len dệt kim mềm mịn",209000,209000,0,0
TIKI,o-to-xe-may-xe-dap,113125263,"Xe đạp thể thao Thống Nhất MTB24-03 (Phù hợp với người cao từ 1m40 đến 1m55)",2490000,2490000,0,0
TIKI,thoi-trang-nu,195536456,"Áo Thun Cho Mẹ Sang Trọng SM28 - Hàng Quảng Châu Cao Cấp",235000,235000,0,0
TIKI,o-to-xe-may-xe-dap,274362517,"Bình Ắc quy khô GS GTZ5S E 3,5Ah Wave RS Rsx Rsv S, Nouvo456, Airblade110, Hayate X-Bike SKY Exciter Luvias Cub",290000,290000,0,0
TIKI,o-to-xe-may-xe-dap,43177224,"Xe Đạp Điện Osakar Star",13500000,13500000,0,0
TIKI,thoi-trang-nu,72639866,"Aó định hình sau hút mỡ cánh tay Aó gen vai cánh tay áo nịt bắp tay",550000,550000,0,0
TIKI,thoi-trang-nu,193639435,"Áo kiểu hoa nhí Ceri Top Gem Clothing SP060629",470000,470000,0,0
TIKI,thoi-trang-nu,146511096,"ÁO HOODIE NỮ BÒ SỮA THỜI TRANG MẪU MỚI THỊNH HÀNH B.BY",83000,83000,0,0
TIKI,thoi-trang-nu,176797644,"Đồ Bơi Nữ Một Mảnh Kiểu Dáng Xinh Họa Tiết Da Beo Trắng Đen ATI34 MayHomes Women One-Piece Swimwear",159250,175000,15750,9
TIKI,thoi-trang-nu,185977874,"Đầm suông linen cổ V thắt eo 2 màu,thời trang nữ phong cách trẻ trung Haint Boutique Hb72",299000,299000,0,0
TIKI,thoi-trang-nu,175428288,"Áo sơ mi nữ công sở, áo sơ mi nữ tay lỡ, áo sơ mi trơn đơn giản, màu xanh cốm hot trend HB116",147075,159000,11925,8
TIKI,thoi-trang-nu,73722483,"Áo ngực nữ cúp ngang Elegant Miley Lingerie BRM04002 - Màu đỏ đô",218000,315000,97000,31
TIKI,thoi-trang-nu,113050911,"Áo khoác nữ Áo khoát nữ kaki chống nắng CHAO KIOS đẹp cá tính hàng rất đẹp-A114",156450,156450,0,0
TIKI,thoi-trang-nu,169907377,"SÉT BỘ VEST BỘ 3 CAO CẤP",320000,320000,0,0
TIKI,thoi-trang-nu,146574315,"Quần bầu cạp chéo - Thoải mái hơn, tiện lợi hơn",74340,74340,0,0
TIKI,thoi-trang-nu,162169780,"SÉT BỘ CỔ VEST TAY VOAN CAO CẤP",290000,290000,0,0
TIKI,thoi-trang-nu,155182479,"Miếng đệm nâng ngực miếng đệm nâng ngực Hình tròn MD02",8910,8910,0,0
TIKI,thoi-trang-nu,155182902,"Áo thun croptop form rộng tay lở Unisex màu trắng / đen CRA023",61750,61750,0,0
TIKI,thoi-trang-nu,105605594,"Áo kiểu nữ dài tay xinh xắn - có nhiều size và màu thích hợp mặc đi làm, dạo phố",180000,180000,0,0
TIKI,thoi-trang-nu,146276974,"Quần lót nâng mông thật tự nhiên Quần định hình nâng mông",250000,250000,0,0
TIKI,thoi-trang-nu,9968477,"Đầm Nữ Trung Niên Tay Con TB-67",288000,288000,0,0
TIKI,thoi-trang-nu,167543231,"(HÀNG SẴN) Áo Khoác Dạ Mùa Xuân Ngắn Giản Dị AD54 - Hàng Quảng Châu Cao Cấp",295000,295000,0,0
TIKI,thoi-trang-nu,56806254,"ÁO THUN BA LỖ NGƯỢC CROPTOP",36000,36000,0,0
TIKI,thoi-trang-nu,128287091,"Áo khoác sweater nỉ ngoại in khủng long unisex ulzzang nam nữ",85000,85000,0,0
TIKI,o-to-xe-may-xe-dap,163869971,"Đèn pha LED S11 100W 20000LM chip LED LASER 3570 6 NHÂN hiệu suất cao cho ô tô(giá 1 bóng)",700000,700000,0,0
TIKI,thoi-trang-nu,89571725,"GOTI - Quần Trung Niên Nữ Cao Cấp Lưng Thun Kiểu Quần Tây Trung Niên Ống Ôm Có Size Lớn 3Q12",166000,189000,23000,12
TIKI,thoi-trang-nu,170917575,"Set áo 2 lớp bèo cài nút thật kèm chân váy xẻ tà dễ thương",173000,173000,0,0
TIKI,thoi-trang-nu,103498666,"quần ống rộng cúc khóa chun lưng kiểu nhật mềm mát",69000,69000,0,0
TIKI,thoi-trang-nu,90642830,"Quần tây nữ vải co giãn QT01",141550,149000,7450,5
TIKI,thoi-trang-nu,174379848,"Áo Thun Cá Sấu Nữ Có Cổ -Màu Xanh Đen(45-75kg)",96000,96000,0,0
TIKI,thoi-trang-nu,80020477," Áo Thun Trơn Icon Nhiều Màu Couple Nam Nữ Họa Tiết Cô Bé Quàng Khăn Đỏ - Unisex - Cotton - AT011",82500,82500,0,0
TIKI,thoi-trang-nu,20907379,"Áo Croptop Nữ Tay Dài Tay Ngắn",102000,102000,0,0
TIKI,thoi-trang-nu,146773062,"Chân váy xếp ly có quần trong (BIG SIZE) C001",180000,180000,0,0
TIKI,thoi-trang-nu,167213799,"Áo thun nữ in vịt MÔI TỀU HOT TREND",65000,65000,0,0
TIKI,thoi-trang-nu,120857109,"Quần su độn mông quần lót nâng mông tăng vòng 3 gợi cảm",87750,87750,0,0
TIKI,thoi-trang-nu,175173030,"Đồ Bơi Nữ Một Mảnh Kín Đáo Kiểu Váy Thể Thao ATI32 MayHomes Women One-Piece Swimwear",162890,179000,16110,9
TIKI,thoi-trang-nu,176710545,"Đồ Bơi Nữ Hai Mảnh Kiểu Dáng Thể Thao Đa Năng ATO67 MayHomes Set Áo Và Short Women Swimwear",139500,155000,15500,10
TIKI,thoi-trang-nu,83685398,"Áó Giảm Béo Vùng Lưng, Vai, Bắp Tay Cho Bạn, Đai nit giảm mỡ vùng lưng, vai, bắp tay",175000,175000,0,0
TIKI,thoi-trang-nu,73675168,"Gen nịt bắp đùi giảm mỡ, gen định hình bắp đùi sau hút mỡ,Gen nịt bắp chân(hút mỡ bắp chân)",588000,588000,0,0
TIKI,thoi-trang-nu,82129940,"Đồ bơi liền thân nữ cutout xanh rêu lạ mắt, bikini một mảnh sexy quyến rũ, hàng chuẩn chất đẹp | KT077",420000,420000,0,0
TIKI,thoi-trang-nu,181248564,"Quần Lót Nữ Cotton Dệt Kim 100% Kháng Khuẩn Thoáng Mát Đính Nơ Xinh Tôn Vòng 3 Gợi Cảm",30000,30000,0,0
TIKI,thoi-trang-nu,195113770," Váy Đầm Dự Tiệc Thời Trang Cho Mẹ VH21 - Hàng Quảng Châu Cao Cấp",355000,355000,0,0
TIKI,lam-dep-suc-khoe,59506958,"Viên uống hỗ trợ mất ngủ, giúp ngủ ngon và sâu giấc Dưỡng Tâm An Lafon (lọ 30 viên)",200000,200000,0,0
TIKI,lam-dep-suc-khoe,100158366,"Kem Chống Nắng Thiên Nhiên Thấm Nhanh An Toàn Cho Da Hây Hây SPF 40, PA ++ Cỏ Mềm 60g",260000,260000,0,0
TIKI,lam-dep-suc-khoe,118520833,"Bàn chải đánh răng điện Fairywill P11- phiên bản nâng cấp với trục truyền lực bằng thép, 8 đầu bàn chải đi kèm",649000,1200000,551000,46
TIKI,lam-dep-suc-khoe,70383861,"Combo 4 bịch dao cạo râu 3 lưỡi Tiger We're Men (5 cây/ bịch) - xài 1 lần tiện lợi mang lên máy bay đi du lịch được, 3 lưỡi dao kép  sắt bén, không gỉ sét",99000,99000,0,0
TIKI,lam-dep-suc-khoe,85779614,"Viên uống hỗ trợ giấc ngủ Nature's Bounty Super Strength Melatonin 5mg 60 viên (Cam Kết Chính Hãng)",154000,175000,21000,12
TIKI,lam-dep-suc-khoe,81897334,"Kem dưỡng giúp sáng da, mờ thâm nám ban đêm Vichy LIFTACTIV COLLAGEN SPECIALIST NIGHT",1048000,1165000,117000,10
TIKI,lam-dep-suc-khoe,57377257,"Mật ong nguyên chất Beemo, mật ong hoa cà phê từ thiên nhiên - Làm đẹp,hỗ trợ giảm cân, hỗ trợ điều trị ho, gia vị",59000,82000,23000,28
TIKI,lam-dep-suc-khoe,68267208,"Combo 2 Xịt toàn thân Romano ngăn mồ hôi và mùi cơ thể 150ml x 2 Gentleman",206000,206000,0,0
TIKI,lam-dep-suc-khoe,184518312,"Collagen HeiHwa Dạng nước 1.500mg Collagen Tripeptide nhập khẩu từ Hàn Quốc, hấp thu nhanh giúp đẹp - Hộp 5 chai 30ML",450000,450000,0,0
TIKI,lam-dep-suc-khoe,55893367,"Bigsize - Bộ tắm trắng toàn thân Truesky gồm 1 kem ủ trắng toàn thân 200g và 1 kem dưỡng trắng toàn thân 200g",450000,450000,0,0
TIKI,lam-dep-suc-khoe,568256,"Lăn Nách Dành Cho Nữ Aquaselin Insensitive Women Antiperspirant For Increased Perspiration 50ml - 3934",288900,361125,72225,20
TIKI,lam-dep-suc-khoe,11861302,"Viên Uống Hỗ Trợ Điều Trị Bệnh Suy Giãn Tĩnh Mạch Vascovein (Hộp 30 viên), Chiết Xuất Từ Hạt Dẻ Ngựa - Nguyên Liệu Nhập Khẩu Châu Âu ",200000,215000,15000,7
TIKI,lam-dep-suc-khoe,77150777,"Tinh Dầu Xông Phòng VỎ BƯỞI Nguyên Chất Nhập Khẩu - Tinh dầu Bưởi TIDAMO Giúp Bảo Vệ Sức Khỏe, Kháng Khuẩn,Thư Giãn Tinh Thần và Khử Mùi Hiệu Quả",44000,88000,44000,50
TIKI,lam-dep-suc-khoe,155099959,"Serum Mờ Thâm Trắng Da Kiềm Dầu Se Khít Lỗ Chân Lông  Oriskin O’vita Light Serum 30ml",175000,175000,0,0
TIKI,lam-dep-suc-khoe,69174556,"Đầu Bàn Chải Điện Portable Electric Toothbrush Heads ENR536WHT (2pcs) - Màu Trắng",51400,84000,32600,39
TIKI,lam-dep-suc-khoe,162978700,"Viên bổ sung vitamin tổng hợp và khoáng chất Berocca Performance (Tuýp 10 viên)",75000,75000,0,0
TIKI,lam-dep-suc-khoe,51398122,"Serum Trắng Da Mờ Nám Tàn Nhang Chống Lão Hóa Oribe - Vi Tảo Lục và Tinh Dầu Thông Trắng Nhật Bản (Dạng Viên, Hộp 36 Viên)",330000,380000,50000,13
TIKI,lam-dep-suc-khoe,10678629,"Kem Chống Nắng Da Dầu Bioderma Photoderm AKN Mat SPF 30 (40ml)",461000,485000,24000,5
TIKI,lam-dep-suc-khoe,94118478,"Combo 6 Băng vệ sinh ban đêm Doctor Care tinh chất thảo dược 33.8cm siêu thấm hút",97000,108000,11000,10
TIKI,lam-dep-suc-khoe,72711795,"Kem dưỡng trắng dạng gel Hada Labo Koi-Gokujyun Whitening Perfect Gel 100g",405000,405000,0,0
TIKI,lam-dep-suc-khoe,7967603,"Dầu Gội Head & Shoulders Ngăn Rụng Tóc (625ml)",149000,149000,0,0
TIKI,lam-dep-suc-khoe,76357288,"Máy tỉa lông mũi, râu, lông mày đa năng 4 in 1 - Dùng pin sạc tiện lợi – Sắt không gỉ, Chống nước, Cắt tóc, cạo râu, tỉa lông mũi và tỉa lông mày",116980,116980,0,0
TIKI,lam-dep-suc-khoe,71355851,"Bộ dầu gội thảo dược gừng dừa Cocayhoala hỗ trợ trị gàu, giảm nấm ngứa, dung tích 440g/chai- 95% thành phần từ gừng tươi hữu cơ còn nguyên xơ gừng, hỗ trợ trị rụng tóc, kích thích mọc tóc vượt trội",441000,465000,24000,5
TIKI,lam-dep-suc-khoe,84225555,"Lăn khử mùi cho nách - chân, mồ hôi tay, thâm nách Kwangdong Sweatclor 30ml",148000,250000,102000,41
TIKI,lam-dep-suc-khoe,68427702,"Kem Nhuộm Dưỡng Tóc Phủ Bạc L'Oreal Paris Excellence Crème 172ml",208050,219000,10950,5
TIKI,lam-dep-suc-khoe,131504643,"Dầu gội dược liệu Thái Dương 3 200ml/480ml",150000,150000,0,0
TIKI,lam-dep-suc-khoe,72133478,"Viên uống DHC Bổ sung Vitamin C Nhật Bản 30 ngày (60 viên/ gói)",85000,105000,20000,19
TIKI,lam-dep-suc-khoe,162116326,"Máy tăm nước cầm tay FAIRYWILL F30 siêu phẩm mới ra Dung tích 300ml Sạc nhanh 4 tiếng Thời gian sử dụng lên tới 70 ngày Tặng kèm 6 đầu tăm - Hàng Chính Hãng",854050,899000,44950,5
TIKI,lam-dep-suc-khoe,54459799,"Dầu gội thảo dược Hà Thủ Ô Cỏ Cây Hoa Lá chiết xuất 100% từ thiên nhiên giúp làm chậm quá trình bạc tóc, phục hồi tóc hư tổn COCAYHOALA 300g",209000,300000,91000,30
TIKI,lam-dep-suc-khoe,260804538,"Khẩu Trang Y Tế 4 Lớp Tenamyd Chính Hãng",30600,34000,3400,10
TIKI,lam-dep-suc-khoe,20363893,"CÂN SỨC KHỎE NHƠN HÒA CHÍNH HÃNG( ĐƯỢC CHỌN MÀU)",410000,410000,0,0
TIKI,lam-dep-suc-khoe,76406994,"Combo 2 Tinh Dầu Sả Chanh 50ML + Tinh Dầu Cam Ngọt 50ML (Lemongrass + Orange) - Tinh Dầu TIDAMO Cao Cấp Nhập Khẩu Giúp Thư Giãn, Đuổi Muỗi Và Thơm Phòng",148000,396000,248000,63
TIKI,lam-dep-suc-khoe,54415583,"Bột lá nhuộm tóc thiên nhiên OGATIC Màu Nâu- 50g ( Bao Bì Mới)",96000,150000,54000,36
TIKI,lam-dep-suc-khoe,3818443,"Son dưỡng ẩm không mùi, hỗ trợ trị thâm, lẻ môi DHC Nhật Bản",182000,199000,17000,9
TIKI,lam-dep-suc-khoe,192305641,"Đầu tăm nước thay thế và phụ kiện dây sạc cho máy tăm nước h2ofloss",14000,25000,11000,44
TIKI,lam-dep-suc-khoe,1679129,"Tăm Bông Meriday Bông Bạch Tuyết TP154 (200 Que)",10800,13500,2700,20
TIKI,lam-dep-suc-khoe,10579630,"Cao Gừng Tan Mỡ Thiên Nhiên Việt  (250g) Tặng Kèm Thước Dây An Nhiên",233000,233000,0,0
TIKI,lam-dep-suc-khoe,41221033,"Bộ 5 hộp bao cao su Storm hương dâu | Hộp 10 cái",85500,95000,9500,10
TIKI,lam-dep-suc-khoe,190645318,"Sữa Rửa Mặt Dịu Nhẹ Cho Da Khô CeraVe Hydrating Cleanser 88ml",148000,165000,17000,10
TIKI,lam-dep-suc-khoe,1581117,"Bộ Giác Hơi Không Dùng Lửa Duy Thành YGH05 (6 ống giác)",186000,186000,0,0
TIKI,o-to-xe-may-xe-dap,56318825,"Mũ bảo hiểm Chita 1/2 - CT6B1 Nón cặp Tem chìa khóa",260000,260000,0,0
TIKI,o-to-xe-may-xe-dap,192117424,"Xà bông rửa xe siêu bọt 3M Car Wash With Wax PN39000W- 1Lít",205000,205000,0,0
TIKI,o-to-xe-may-xe-dap,178832716,"Bơm xe đạp cầm tay mini treo xe LC - Hợp kim nhôm - Xách tay siêu nhẹ - hỗ trợ van Mỹ và van Pháp",149000,149000,0,0
TIKI,o-to-xe-may-xe-dap,5483493,"Dung dịch vệ sinh nội thất xe Sonax 321200 500ml",179000,190000,11000,6
TIKI,o-to-xe-may-xe-dap,147080186,"Miếng mút rửa xe bọt biển tạo bọt, siêu mịn  3M",59000,65000,6000,9
TIKI,o-to-xe-may-xe-dap,116768956,"Chai xịt tẩy nội thất ghế da, nỉ ô tô - văn phòng FOAM CLEANER",58000,58000,0,0
TIKI,o-to-xe-may-xe-dap,73521963,"Bộ Gối Tựa Đầu, Lưng Ô Tô 100% Cao Su Non Đặc Biệt Bọc Da Cao Cấp XG-NNSM01",324000,324000,0,0
TIKI,o-to-xe-may-xe-dap,173671769,"Mũ Bảo Hiểm 3/4 HPro HP04 - Giao Nhanh - Hàng Chính Hãng",279000,320000,41000,13
TIKI,o-to-xe-may-xe-dap,106225531,"Khăn Lau Xe Rửa Xe OTO Xe Máy Siêu Thấm Đa Năng, Khăn Lau Nội Thất Xe Hơi Xe Máy Sợi Siêu Mịn",35000,55000,20000,36
TIKI,o-to-xe-may-xe-dap,156632384,"Bộ 4 nắp chụp van vòi lốp xe ô tô,xe máy",22986,26900,3914,15
TIKI,o-to-xe-may-xe-dap,165707326,"Chai xịt phủ nano chống nước kính ô tô, phủ bóng sơn xe hơi - Chống nước bề mặt kính cận, mũ bảo hiểm 100ML",59000,59000,0,0
TIKI,o-to-xe-may-xe-dap,193568479,"Đèn xe đạp Kiotool thế hệ mới nhiều chế độ sáng chống nước",125000,125000,0,0
TIKI,o-to-xe-may-xe-dap,144197271,"BÌNH XỊT RP7MIỄN PHÍ VẬN CHUYỂNCHAI XỊT CHỐNG RỈ SÉT RP7 150G CHỐNG RỈ BÔI TRƠN TIỆN DỤNG",33700,33700,0,0
TIKI,o-to-xe-may-xe-dap,56104928,"Giá Đỡ Điện Thoại Có Đế Hút Cao Su Để Trên Ô Tô ",79000,79000,0,0
TIKI,o-to-xe-may-xe-dap,92982560,"Nệm giường hơi cho xe ô tô, xe hơi 5, 7 chỗ cao cấp, tiện dụng có thành chắn an toàn cho trẻ nhỏ kèm theo bơm điện 12V",590000,590000,0,0
TIKI,o-to-xe-may-xe-dap,10713805,"Bảng Số Điện Thoại Trên Ô Tô Baseus ACNUM-01",268499,268499,0,0
TIKI,o-to-xe-may-xe-dap,16287857,"Dung DỊch Rửa Xe Không Chạm Bio 30 - (1l) - Hàng Chính Hãng",127000,150000,23000,15
TIKI,o-to-xe-may-xe-dap,147349342,"Bộ 5 Khăn Lau Xe Ô Tô Chuyên Dụng Kích Thước 30cm x 50cm Chất Liệu Vải Microfiber Siêu Mềm Và Thấm Hút Tốt, Dùng Được Trong Gia Đình Không Để Lại Vệt",99000,99000,0,0
TIKI,o-to-xe-may-xe-dap,28467118,"NƯỚC RỬA XE BỌT TUYẾT ĐẬM ĐẶC - PH CÂN BẰNG - NHIỀU BỌT 3M CAR WASH SHAMPOO 1 LIT 305860",210000,210000,0,0
TIKI,o-to-xe-may-xe-dap,115521323,"Lưới ràng buộc đồ xe máy và hành lý xe mô tô (40x40cm)",45000,45000,0,0
TIKI,o-to-xe-may-xe-dap,78017031,"Máy sạc bình ắc quy 12V có chức năng khử sunfat sạc từ 4-100Ah TIANYE thông minh tự ngắt khi đầy dòng sạc 6A sạc bình ắc quy 12V sạc bình ắc quy ô tô sạc bình ắc quy xe máy(Vàng)",175000,175000,0,0
TIKI,o-to-xe-may-xe-dap,19748905,"Bộ 2 đèn LED gắn van bánh xe đạp, xe máy, ô tô",16700,16700,0,0
TIKI,o-to-xe-may-xe-dap,263416079,"XE ĐẠP TRẺ EM KIỂU DÁNG THỂ THAO CỠ 20 INCH cho bé 7 tuổi - 11 TUỔI + Tặng kèm giỏ xe, gácbaga, túi, bình nước",1069000,1069000,0,0
TIKI,o-to-xe-may-xe-dap,164458921,"Bọc khóa smartkey dành cho Honda Lead, Airblade, Vision 2022, Vario 160, Winner X Bezen Classic",59000,59000,0,0
TIKI,o-to-xe-may-xe-dap,10000461,"Bình xịt chống chuột 3M",239000,239000,0,0
TIKI,o-to-xe-may-xe-dap,72109275,"Kem Đánh Bóng Xóa Trầy Xước Sơn Ô tô - Xe Máy Cana Car Cream 100g - đánh bóng bề mặt kim lọai, đồ gỗ, mặt đá",42000,42000,0,0
TIKI,o-to-xe-may-xe-dap,41098208,"Bạt che nắng kính lái xe ô tô - dày 3 lớp, tráng nhôm.",50500,50500,0,0
TIKI,o-to-xe-may-xe-dap,38903048,"Bộ 2 Đèn LED Van Xe Đạp. Xe Máy, Moto ( Màu Giao Ngẫu Nhiên )",22000,22000,0,0
TIKI,o-to-xe-may-xe-dap,1254679,"Bình Xịt Bảo Dưỡng Dây Curoa Liqui Moly V-Belt Spray 4085 (400ml)",275000,275000,0,0
TIKI,o-to-xe-may-xe-dap,10152416,"Giá Đỡ Điện Thoại Gắn Trên Cửa Gió Điều Hòa Ô Tô Baseus SUYL-D01",249499,249499,0,0
TIKI,o-to-xe-may-xe-dap,177517963,"Bọc Chìa Khóa Smartkey Airblade SH Vision Lead 2021 - 2022 Chất Liệu Nhựa TPU Đàn Hồi Chống Va Đập",134000,134000,0,0
TIKI,o-to-xe-may-xe-dap,204280857,"Dây treo xe ô tô tượng Phật Quan Âm bằng gỗ cao cấp của nhà HÀ XÁ",350000,700000,350000,50
TIKI,o-to-xe-may-xe-dap,10794376,"Máy Bơm Xe Đạp, Xe Honda, Xe Hơi Đạp Chân",79000,79000,0,0
TIKI,o-to-xe-may-xe-dap,35292967,"Combo 10 giá móc treo đa năng gắn tựa đầu treo đồ vật sau ghế ô tô, xe hơi ",63000,63000,0,0
TIKI,o-to-xe-may-xe-dap,75337440,"Yên xe đạp thể thao , Carbon siêu êm , Chính hãng Sengxin , da PU cao cấp - Tặng kèm chuông 02",199000,199000,0,0
TIKI,o-to-xe-may-xe-dap,57837428,"Móc Treo, Giá Đỡ Treo Xe Đạp Dựng Đứng Lên Tường, Vách Tường Siêu Chắc Xoay 180 Độ Cho Xe Đạp Đua, Xe Đạp Địa Hình Leo Núi Mai Lee",77000,99000,22000,22
TIKI,o-to-xe-may-xe-dap,108695117,"DUNG DỊCH RỬA XE BỌT TUYẾT [5 Lít]",199000,249000,50000,20
TIKI,o-to-xe-may-xe-dap,196923505,"Yên xe đạp . yên béo cực êm , chính hãng ShengXin 02",199000,199000,0,0
TIKI,o-to-xe-may-xe-dap,35736730,"NƯỚC RỬA CHUYÊN CHO XE SƠN ĐẶC BIỆT CHEMICAL GUYS METICULOUS MATTE AUTO WASH FOR SATIN FINISH (16 OZ)",550000,550000,0,0
TIKI,o-to-xe-may-xe-dap,131254067,"Lọc gió động cơ ô tô MAZDA 3 - 3S 2004-2013",90000,90000,0,0
TIKI,o-to-xe-may-xe-dap,52696657,"Bộ 4 miếng nẹp bước chân chống trơn trượt, trày xước xe ô tô, xe hơi cao cấp",43000,43000,0,0
TIKI,o-to-xe-may-xe-dap,52110029,"Phụ gia xúc béc dầu cao cấp Liqui Moly 1806 - Tặng kèm 1 khăn lau chuyên dụng 3M",209000,209000,0,0
TIKI,o-to-xe-may-xe-dap,166208963,"Đèn trợ sáng L4 moto hàng loại tốt siêu sáng chống nước tặng phụ kiện",256000,256000,0,0
TIKI,o-to-xe-may-xe-dap,9802835,"Bộ 4 ốp tay cửa chống xước và trang trí xe Mazda 2, Mazda 3, Mazda 6 và CX-5",188500,188500,0,0
TIKI,o-to-xe-may-xe-dap,111361008,"Nẹp Chân Kính Inox Dành Cho Xe VIOS 2019 2020 2021 - chất liệu inox - 6 chi tiết",209000,209000,0,0
TIKI,o-to-xe-may-xe-dap,118235411,"Bố Thắng Trước Ford Transit (2000-2006) - Bosch BP 4047",254000,254000,0,0
TIKI,o-to-xe-may-xe-dap,72880242,"Tẩu sạc ô tô nhãn hiệu Hyundai HY-10 công suất 80W, một đầu chia tẩu và 3 cổng usb - Hàng nhập khẩu",121500,121500,0,0
TIKI,o-to-xe-may-xe-dap,14654930,"Decal Logo 3D Chữ Nổi AMG Dán Đuôi Xe Ô Tô",109000,109000,0,0
TIKI,o-to-xe-may-xe-dap,127363851,"Hạn chế cửa (Dẫn hướng cửa ) dành cho Kia K3, Cerato 2012-2018",165000,165000,0,0
TIKI,o-to-xe-may-xe-dap,154127086,"Bộ dụng cụ 12 món tháo mở nội ngoại thất xe ô tô",139286,149000,9714,7
TIKI,o-to-xe-may-xe-dap,32901910,"Củ sạc điện thoại trên ô tô 2USB QC3.0 - Hàng nhập khẩu",150000,150000,0,0
TIKI,o-to-xe-may-xe-dap,105184591,"Tem vành phản quang xe máy",61750,61750,0,0
TIKI,o-to-xe-may-xe-dap,105185322,"Ốp pô Winner X- vân cacbon, màu",114000,114000,0,0
TIKI,o-to-xe-may-xe-dap,11487635,"Tinh dầu treo xe hơi hương dưa hấu – Areon Fresco Watermelon (Dịu nhẹ)",237500,250000,12500,5
TIKI,o-to-xe-may-xe-dap,34961418,"Thảm Nhựa Lót Cốp Sau Dành Cho Xe Ô Tô Xpander",239000,239000,0,0
TIKI,o-to-xe-may-xe-dap,8147615,"Giá Đỡ Điện Thoại trên ô tô Hình Mặt Cười Kẹp Trực Tiếp Vào Khe Gió Của Điều Hòa Xe Hơi YE-R054",84000,84000,0,0
TIKI,o-to-xe-may-xe-dap,157146868,"Ốp Bảo Vệ Chìa Khóa Xe Chevrolet Cruze, Colorado Hợp Kim Cao Cấp",209000,279000,70000,25
TIKI,o-to-xe-may-xe-dap,36160831,"Combo 02 Chai xịt vệ sinh máy điều hòa (máy lạnh) Sandokkaebi 330ml nhập khẩu trực tiếp từ Hàn Quốc",189000,189000,0,0
TIKI,o-to-xe-may-xe-dap,141799019,"Tem rời Exciter 2006-2010 Vàng đen (i)",189000,189000,0,0
TIKI,o-to-xe-may-xe-dap,6349635,"Mũ Bảo Hiểm 3/4 M139 - Cam Tem (Size",529000,529000,0,0
TIKI,o-to-xe-may-xe-dap,33175224,"Logo Cánh Chim Ưng 3D Dán Cho Các Loại Xe Ô Tô Màu Vàng",32000,32000,0,0
TIKI,o-to-xe-may-xe-dap,169929622,"Còi Chip 5V - Loại 9,5x12mm",5000,5000,0,0
TIKI,o-to-xe-may-xe-dap,120999272,"ic công suất LA4440",16990,16990,0,0
TIKI,o-to-xe-may-xe-dap,28948798,"Túi đựng đồ cao cấp treo sau ghế ô tô - Hàng nhập khẩu",155000,155000,0,0
TIKI,o-to-xe-may-xe-dap,66205480,"NƯỚC RỬA XE BỌT TUYẾT CHUYÊN DỤNG BT01 [1Lít]",89000,99000,10000,10
TIKI,o-to-xe-may-xe-dap,49055424,"bộ chụp xi nhan cho xe DYLAN tặng bao tay xe máy",139000,139000,0,0
TIKI,o-to-xe-may-xe-dap,157146564,"Bao Da Chìa Khóa Dành Cho Xe Ford Ecosport, Focus, Fiesta Da Thật Mẫu Chìa Thông Minh",128000,128000,0,0
TIKI,o-to-xe-may-xe-dap,123434088,"{Giá sỉ} Vòng bi, bạc đạn 606,607,608, RBI mới 100%, -Giadung24h",9450,9450,0,0
TIKI,o-to-xe-may-xe-dap,107457947,"Bộ gối ghế tựa lưng và đầu xe hơi,ô tô chất liệu cao su non cao cấp",120000,120000,0,0
TIKI,o-to-xe-may-xe-dap,1254641,"Dung Dịch Tăng Chỉ Số Octan Cho Xăng Bluechem Octane Booster (250ml)",250000,250000,0,0
TIKI,o-to-xe-may-xe-dap,110146534,"Biển Cảnh Báo Nguy Hiểm Tam Giác Phản Quang Cho Xe Hơi (loại tốt)",69000,75000,6000,8
TIKI,o-to-xe-may-xe-dap,98678475,"Xe đạp địa hình Thống Nhất trẻ em MTB 20-04 (Dành cho bé từ 5 đến 10 tuổi) - Hàng chính hãng",2599000,2599000,0,0
TIKI,o-to-xe-may-xe-dap,3668285,"Dung dịch chống bán nước kính lái 3M 08889LT",179000,179000,0,0
TIKI,o-to-xe-may-xe-dap,10914298,"Tinh dầu quế treo xe oto, treo tủ quần áo, treo phòng, treo nhà vệ sinh, khử mùi xe mới ",17800,50978,33178,65
TIKI,o-to-xe-may-xe-dap,174490313,"￼Đệm Lót Yên Xe Máy Siêu Êm, Độ Đàn Hồi Cao, Lắp Được Cho Mọi Loại Xe Máy",89000,89000,0,0
TIKI,o-to-xe-may-xe-dap,172068042,"ĐÈN HẬU LED STOP CHỚP NHÁY F1 - ĐÈN HẬU XE MÁY - Ô TÔ",39000,39000,0,0
TIKI,o-to-xe-may-xe-dap,108883595,"Đèn xi nhan LED T10 đúc sứ - xi nhan demi cho xe máy T10 6 Led ( 6smd 3030 ) DC 12V Green Networks Group ( 1 Đèn )",25000,25000,0,0
TIKI,o-to-xe-may-xe-dap,162590572,"Ắc quy khô miễn bảo dưỡng Đồng Nai PTZ6HL | 12V - 6Ah",254000,254000,0,0
TIKI,o-to-xe-may-xe-dap,40745733,"Bình xăng con OKO ga dẹp PWK 32 ",459000,459000,0,0
TIKI,o-to-xe-may-xe-dap,168067539,"Mũ bảo hiểm nửa đầu RONA hali viền bạc chính hãng, nón bảo hiểm freesize cho nam và nữ",133000,200000,67000,34
TIKI,o-to-xe-may-xe-dap,98030784,"Bình Xịt Dưỡng Bóng Vỏ Lốp Oto – Phục Hồi Nhựa Đen FLAMINGO 500Ml",78000,78000,0,0
TIKI,o-to-xe-may-xe-dap,117221161,"Xe đạp Thống Nhất GN06-26 - Hàng chính hãng",2190000,2190000,0,0
TIKI,o-to-xe-may-xe-dap,169099437,"Combo 5 bóng đèn sợi đôt BA15D 24V 25W (2 tim)",80000,80000,0,0
TIKI,o-to-xe-may-xe-dap,160749647,"Hộp đựng khăn giấy ô tô xe hơi chất liệu da cao cấp có đồng hồ và bảng số điện thoại",202000,202000,0,0
TIKI,o-to-xe-may-xe-dap,195959595,"Loại tốt) Đèn Hậu Led Nháy Xe Máy Stop F1 30 Tim Chạy Đuổi Audi Bản Cao Cấp Mẫu Mới",68000,68000,0,0
TIKI,o-to-xe-may-xe-dap,74643387,"Đèn led Bi cầu H4 Mini siêu sáng cos vàng pha trắng (loại rẻ , không BH ) Green Networks Group",89000,89000,0,0
TIKI,o-to-xe-may-xe-dap,186161140,"Bộ ốp nẹp sườn Xpander 2018-2019-2020-2021-2022 mạ crom trang trí làm đẹp xe",449000,449000,0,0
TIKI,o-to-xe-may-xe-dap,28390801,"Bộ gối tựa đầu và tựa lưng xe hơi, xe ô tô V2 chất liệu cao su non cao cấp màu be",270000,270000,0,0
TIKI,o-to-xe-may-xe-dap,136191331,"Nhớt Xe Số Motul 3100 Gold 4t 10w40 20x0.8l Vn",119000,119000,0,0
TIKI,o-to-xe-may-xe-dap,8315863,"Mũ Bảo Hiểm Nửa Đầu GRS A760K",359000,359000,0,0
TIKI,o-to-xe-may-xe-dap,192124544,"Găng Tay Sport BeastFashion - Găng tay tập GYM - Đen",55000,55000,0,0
TIKI,o-to-xe-may-xe-dap,55709275,"Kính chắn gió mũ bảo hiểm Sunda",89000,89000,0,0
TIKI,o-to-xe-may-xe-dap,56221826,"Bảng Ghi Số Điện Thoại Có Giá Đỡ Điện Thoại Trên Xe Ô Tô Xe Hơi",31500,45000,13500,30
TIKI,o-to-xe-may-xe-dap,1510677,"Chai Vá Lốp Xe Khẩn Cấp Michelin 92423 (500ml)",259000,259000,0,0
TIKI,o-to-xe-may-xe-dap,97979641,"Bộ 2 Miếng dán Công nghệ NANO chống lóa- bám -đọng - tụ hơi nước mờ gương xe ô tô xe hơi loại một| Xe hơi cá tính",22816,24800,1984,8
TIKI,o-to-xe-may-xe-dap,190109836,"Tấm đệm hạt gỗ Trắc 100% tự nhiên massage lót ghế làm việc, ghế sofa, ghế ô tô, yên xe máy",571000,571000,0,0
TIKI,o-to-xe-may-xe-dap,270543566,"XE ĐẠP TRẺ EM THỂ THAO BÁNH 12-20 INCH CHO BÉ TRAI 3-10 TUỔI - tặng kèm giỏ + Gacbaga",749000,749000,0,0
TIKI,o-to-xe-may-xe-dap,91297584,"Bộ dụng cụ sửa xe đạp mini đa dụng Crankbrothers M17 multi-tools",799000,799000,0,0
TIKI,o-to-xe-may-xe-dap,50703279,"Bao Da Chìa Khóa dành cho Ô Tô Mitsubishi outlander 3 Nút Da Bò Dạng Hộp",241530,249000,7470,3
TIKI,o-to-xe-may-xe-dap,95222640,"LÓT CỐP NHỰA DÀNH CHO XE KIA RIO SEDAN 2014-2019",328000,328000,0,0
TIKI,o-to-xe-may-xe-dap,126037294,"Cây Thông Thơm - Lá Thông Thơm Little Trees - Cao Cấp, Treo Xe, Khử Mùi Trên Xe Ô Tô",15000,15000,0,0
TIKI,o-to-xe-may-xe-dap,102012041,"Đèn xi nhan led, đèn led xi nhan cho xe máy, đèn xi nhan hình cúc áo-DXNCA",37050,39000,1950,5
TIKI,o-to-xe-may-xe-dap,23599590,"Bộ 02 Gương Cầu Lồi Đa Cực 360 Độ Gắn Gương Chiếu Hậu Ô Tô, Xe Máy Cao Cấp AZONE",19000,19000,0,0
TIKI,o-to-xe-may-xe-dap,13380326,"Đèn Pin LED Trên Xe Đạp Kèm Đế Kẹp Hiện Đại - Giao Màu Ngẫu Nhiên",89000,115000,26000,23
TIKI,o-to-xe-may-xe-dap,196586384,"Tay đề xe đạp bấm xả 3x7. kèm tay thắng full nhôm có dây đề đi kèm bọ tay trái tay phải",150000,150000,0,0
TIKI,o-to-xe-may-xe-dap,35603061," Đèn Pin Gắn Xe Đạp 5 Led Và Đèn Hậu Sau Xe",37800,200250,162450,81
TIKI,o-to-xe-may-xe-dap,85236295,"COMBO 5 Lá thơm treo gương xe hơi.miếng thơm treo ô tô hương vani",85000,85000,0,0
TIKI,o-to-xe-may-xe-dap,90852651,"Xe Đạp Thể Thao Địa Hình Kèm Giỏ, Garbaga, Bình Nước Bánh To Kèm Ảnh Thật",1100000,1100000,0,0
TIKI,o-to-xe-may-xe-dap,47301111,"BÌNH TẠO BỌT TUYẾT CẦM TAY EPOCA TEC TWO 2000ml  MADE IN ITALY",579000,579000,0,0
TIKI,o-to-xe-may-xe-dap,49302134,"Kệ Yên Sau Gác Ba Ga Gắn Thêm Phía Sau Cho Xe Đạp Vào Cốt Yên (Tích Hợp Kèm Chắn Bùn) Đa Năng Điều Chỉnh Hợp Kim Nhôm Cao Cấp Cho Xe Đạp Leo Núi Địa Hình Mai Lee",316000,379000,63000,17
TIKI,o-to-xe-may-xe-dap,83347924,"Kính thẳng gắn nón bảo hiểm 3/4 Royal có 3 nút bấm",130000,130000,0,0
TIKI,o-to-xe-may-xe-dap,2581833,"Dầu Bảo Quản Và Chống Rỉ Sét Sonax MOS 2 Oil (400ml)",170000,170000,0,0
TIKI,o-to-xe-may-xe-dap,182848858,"XE ĐẠP TRẺ EM DÁNG THỂ THAO CHO BÉ 3-10 TUỔI - XE ĐẠP THỂ THAO - XE ĐẠP ĐỊA HÌNH TRẺ EM",749000,749000,0,0
TIKI,o-to-xe-may-xe-dap,147763773,"Tay nắm xe đạp thể thao Kiotool có sừng chống mỏi , trơn tay",75000,75000,0,0
TIKI,o-to-xe-may-xe-dap,89877588,"Bộ 2 Thanh Nạy Móc Lốp Xe Đạp Giúp Vá Lốp Săm Xe Đạp Chất Liệu Thép Không Gỉ (dài 12cm) MaiLee",25650,27000,1350,5
TIKI,o-to-xe-may-xe-dap,137672159,"Keo dán đa năng Scotch 3M siêu dính, siêu bền, keo trong suốt tính thẩm mỹ cao, keo loãng mau khô, dễ sử dụng AD113",30000,35000,5000,14
TIKI,o-to-xe-may-xe-dap,105183996,"Gương xe máy - Gương gù chân gương cho mọi xe máy",90000,90000,0,0
TIKI,o-to-xe-may-xe-dap,1254595,"Chai Xịt Chăm Sóc Da, Nội Thất Ô Tô- 3M Leather & Vinyl Restorer PN39040 (473ml) - Đen",310000,310000,0,0
TIKI,o-to-xe-may-xe-dap,51918522,"Bộ kích gầm ô tô và máy tháo lốp dùng điện 12V",1699000,1699000,0,0
TIKI,o-to-xe-may-xe-dap,89300422," COMBO 10 KHĂN LAU XE SIÊU THẤM CHUYÊN DỤNG 2 MẶT 30 x 60CM",125000,125000,0,0
TIKI,o-to-xe-may-xe-dap,143962145,"Bộ Dụng Cụ Sửa Chữa Khắc Phục Kính Lái Ô Tô Bị Nứt, Vỡ",109000,109000,0,0
TIKI,o-to-xe-may-xe-dap,117597712,"COMBO 2 Bình xịt dưỡng bóng lốp xe ô tô, xe máy Flamingo Tire Shine 500ml",193000,193000,0,0
TIKI,o-to-xe-may-xe-dap,511348,"Che Chống Nắng Phản Quang Tròn Hando",62000,62000,0,0
TIKI,o-to-xe-may-xe-dap,122411885,"Hộp tỳ tay xe hơi Hyundai Accent 2014 - 2016 tích hợp 6 cổng USB, chất liệu nhựa ABS và da PU cao cấp",521000,521000,0,0
TIKI,o-to-xe-may-xe-dap,138387794,"Đồng hồ đo áp suất động cơ dầu, dụng cụ đo áp suất động cơ diesel TU -15B",641000,641000,0,0
TIKI,o-to-xe-may-xe-dap,68442066,"bố thắng trước wave s110 recto",78000,78000,0,0
TIKI,o-to-xe-may-xe-dap,97979747," Gioăng B zoăng B CUỘN 5m giảm chấn chống ồn cửa xe nắp capo nắp cốp ô tô xe hơi",56580,61500,4920,8
TIKI,o-to-xe-may-xe-dap,188705625,"Sơn xịt phủ gầm xe hơi ô tô chống rỉ mọt bảo vệ gầm xe, flamingo rubberized undercoat F021 hàng chính hãng",117600,117600,0,0
TIKI,o-to-xe-may-xe-dap,11499357,"Khóa chống trộm có còi báo động",74700,74700,0,0
TIKI,o-to-xe-may-xe-dap,83809831,"Bao da chìa khóa Ducati Diavel 1260S - CHÍNH HÃNG KHACTEN.COM",400000,400000,0,0
TIKI,o-to-xe-may-xe-dap,89951217,"Túi đựng đồ treo thành ghế ô tô 3P Auto 206142",31100,43500,12400,29
TIKI,o-to-xe-may-xe-dap,165145585,"Đèn led mini DJ cảm ứng nháy theo nhạc trang trí ô tô, quả cầu ma thuật",199000,199000,0,0
TIKI,o-to-xe-may-xe-dap,186577204,"Thảm Taplo dành cho xe Mercedes C180 chất liệu Nhung, da Carbon, da vân gỗ",210000,210000,0,0
TIKI,o-to-xe-may-xe-dap,92132737,"Bọc Vô Lăng Da dành cho Xe Nissan XTrail Lót Cao Su Non Cao Cấp Chống Trượt Tay",249339,249339,0,0
TIKI,o-to-xe-may-xe-dap,186551532,"Thảm Taplo dành cho xe Mazda CX5 2014 đến 2019 chất liệu Nhung, da Carbon, da vân gỗ",210000,210000,0,0
TIKI,o-to-xe-may-xe-dap,80696783,"Dàn áo dành cho Honda Wave nhỏ loại 1 màu Xanh Nhớt",950000,950000,0,0
TIKI,o-to-xe-may-xe-dap,140217822,"Đệm hơi ô tô tiện dụng phiên bản mới cao cấp từ 4 đến 7 chỗ - nệm hơi, giường hơi xe hơi",415000,415000,0,0
TIKI,o-to-xe-may-xe-dap,5032663,"Combo 1 túi thơm cafe Hàn Quốc kèm chai xịt tinh dầu Korea và Bộ 2 gel thơm cà phê Status cho ô tô",239000,239000,0,0
TIKI,o-to-xe-may-xe-dap,132820357,"Dù Che Kính Lái Ô Tô- Chống Nắng, Bảo Vệ Nội Thất Xe Hơi",73981,73981,0,0
TIKI,o-to-xe-may-xe-dap,32166615,"Sạc ắc quy 12V-2A ô tô xe máy thông minh tự ngắt khi đầy chống ngược cực có màn hình hiển thị (Vàng)",64000,64000,0,0
TIKI,o-to-xe-may-xe-dap,136187554,"RÈM CHE NẮNG NAM CHÂM CHO XE KIA SOLUTO",238000,238000,0,0
TIKI,o-to-xe-may-xe-dap,186161147,"Bộ ốp tapli CR-V, CRV 2018-2019-2020-2021-2022 vân Titan chống xước va đập khi mở cửa và làm đẹp xe",479000,479000,0,0
TIKI,o-to-xe-may-xe-dap,144324725,"(HÀNG ĐẸP) Dù Che Nắng Ô Tô Cao Cấp, Dù Che Kính Lái Xe Hơi (Tặng BAO DA) - Chống Nắng, Bảo Vệ Nội Thất",98978,98978,0,0
TIKI,o-to-xe-may-xe-dap,41293830,"Bộ ốp tay nắm hõm cửa VINFAST FADIL 2019/2020",136800,136800,0,0
TIKI,o-to-xe-may-xe-dap,139444501,"Bộ dè chắn bùn xe máy siêu cấp XP2 mẫu mới siêu ngầu loại dày đẹp hàng cao cấp chống rung",186200,196000,9800,5
TIKI,o-to-xe-may-xe-dap,136879029,"Máy bơm lốp xe ô tô di động A03 đồng hồ điện tử ( KIÊM ĐO ÁP SUẤT LỐP, ĐÈN PIN, SẠC DỰ PHÒNG )",1650000,1650000,0,0
TIKI,o-to-xe-may-xe-dap,121330050,"Đèn led chợ sáng cao cấp L5-9 mắt chống nước tuyệt đối cho xe máy xe điện",59000,59000,0,0
TIKI,o-to-xe-may-xe-dap,34556159,"Bọc vô lăng tay lái ô tô da vân Carbon 4S logo HONDA cao cấp",145000,250000,105000,42
TIKI,o-to-xe-may-xe-dap,118085211,"Bố Thắng (Bố Càng Sau) Ford Transit (-2006) - Bosch BP 1542",637000,637000,0,0
TIKI,o-to-xe-may-xe-dap,54779162,"Chai xịt làm bóng và bảo dưỡng lốp xe ô tô Sonax 235300 dung tích 400 ml",280000,280000,0,0
TIKI,o-to-xe-may-xe-dap,54476251,"Nón bảo hiểm 3/4 kính âm Royal M139 Vàng Cam cao cấp Lót tháo rời, che hết mặt",499000,499000,0,0
TIKI,o-to-xe-may-xe-dap,92316799,"Bình chữa cháy mini Foam 500ml 1000ml dùng cho xe hơi",39000,39000,0,0
TIKI,o-to-xe-may-xe-dap,14643363,"Rèm che nắng ô tô 6 tấm cao cấp gấp gọn tiện lợi",98000,98000,0,0
TIKI,o-to-xe-may-xe-dap,117598485,"COMBO 2 chiếc Lọc gió điều hòa Chevrolet Colorado, Trailblazer than hoạt tính",299000,299000,0,0
TIKI,o-to-xe-may-xe-dap,108246627,"Sáp thơm xe Yankee Candle - Beach Walk",199000,279000,80000,29
TIKI,o-to-xe-may-xe-dap,23944229,"Decal Tem Chữ Discovery 3D Kim Loại Dán Trang Trí Ô Tô - màu Crom",59000,59000,0,0
TIKI,o-to-xe-may-xe-dap,20542142,"Tem Logo Nổi Chữ 3D Dán Trang Trí Ô Tô Xe Máy SPORT AZONE",50000,69000,19000,28
TIKI,o-to-xe-may-xe-dap,7798220," Combo Dây Xịt Rửa Xe Áp Lực (15m) Và Súng",208050,219000,10950,5
TIKI,o-to-xe-may-xe-dap,244290102,"Gạt mưa ô tô xe Toyota Vios  2020",130000,130000,0,0
TIKI,o-to-xe-may-xe-dap,24004833,"Túi Da Xịn Đựng Đăng Kiểm, Giấy Tờ Cho Ô tô logo Toyota",27000,27000,0,0
TIKI,o-to-xe-may-xe-dap,68119570,"XE ĐẠP THỂ THAO CHO NAM TỪ 6 TUỔI ĐẾN 15 TUỔI TẶNG GIỎ VÀ GÁCBAGA HÀNG CHUẨN",1299000,1299000,0,0
TIKI,o-to-xe-may-xe-dap,12491810,"Ghế ngồi trên ô tô cho bé, giữ bé trên ô tô cao cấp",1599000,1599000,0,0
TIKI,o-to-xe-may-xe-dap,87094424,"Quạt ô tô 12v /24v loại lớn sải cánh 18cm, lồng quạt inox chống gỉ",189000,189000,0,0
TIKI,o-to-xe-may-xe-dap,197264187,"Gạt mưa ô tô silicon Tâm Luân, KHÔNG XƯƠNG - Thân mềm, gạt sạch - không tiếng ồn - độ bền cao - không bị oxi hoá, độ bền lên đến 10 năm",78000,100000,22000,22
TIKI,o-to-xe-may-xe-dap,119719101,"Ắc quy khô GLOBE WP5-6 6V-5AH Bình ắc quy khô 6v cho xe điện trẻ em ,đèn khẩn cấp,quạt sạc",140000,140000,0,0
TIKI,o-to-xe-may-xe-dap,131337686,"Găng Tay Xe Máy, Đi Phượt Cụt Ngón Blackhawk",83000,83000,0,0
TIKI,o-to-xe-may-xe-dap,8148607,"Quần đệm đạp xe Jett UnderAlls",525000,525000,0,0
TIKI,o-to-xe-may-xe-dap,6651669,"Mũ bảo hiểm 3/4 đầu Napoli SH1 trắng lót hồng Freesize 55-58 cm - Bảo Hành 12 tháng",359000,359000,0,0
TIKI,o-to-xe-may-xe-dap,174131359,"Bộ nhựa dàn áo nhựa ABS cao cấp Màu Đỏ dành cho xe FUTURE NEO - TKA-564",1317000,2139968,822968,38
TIKI,o-to-xe-may-xe-dap,10007194,"Chai dưỡng sên, xịt sên liqui 1591 400mL",275000,275000,0,0
TIKI,o-to-xe-may-xe-dap,142477859,"Thiết Bị Theo Dõi Ắc Quy Fides FBM100 Dùng Cho Ắc Quy Ô Tô, Xe Máy, Xe Tải. Kết Nối Ứng Dụng Bằng Bluetooth iOS Android",570000,570000,0,0
TIKI,o-to-xe-may-xe-dap,118297628,"Xe đạp thể thao nữ GIANT LIV ALIGHT 2 2021",10050000,10050000,0,0
TIKI,o-to-xe-may-xe-dap,1378101,"Chai Xịt Bọt Rửa Xe Không Cần Nước Và Làm Bóng Nhanh 3M Waterless Wash & Wax 39110 (453g)",154000,169000,15000,9
TIKI,o-to-xe-may-xe-dap,270539232,"XE ĐẠP TRẺ EM ĐỊA HÌNH CỠ 20/22/24INCH dành cho 7 - 15 TUỔI  có đề + Tặng kèm giỏ xe, gácbaga, túi, bình nước",1099000,1099000,0,0
TIKI,o-to-xe-may-xe-dap,98738578," Bộ 2 Đèn LED Bar Pha siêu sáng cho ô tô Bán Tải tiêu chuẩn CE, RoHS, IP67",414000,414000,0,0
TIKI,o-to-xe-may-xe-dap,72959609,"Cặp Đèn Led Xi Nhan 7 Màu Nhấp Nháy - DXN7M",14250,15000,750,5
TIKI,o-to-xe-may-xe-dap,80413027,"Tem dán xe máy king drag",18000,18000,0,0
TIKI,o-to-xe-may-xe-dap,7543321,"Mũ Bảo Hiểm 3/4 Đầu Royal M139 Design",570000,730000,160000,22
TIKI,o-to-xe-may-xe-dap,36300673,"Túi treo đồ trên ô tô kiêm giá để đồ bằng da",265000,265000,0,0
TIKI,o-to-xe-may-xe-dap,13331760,"Thanh ghi số điện thoại trên kính ô tô có dạ quang",12900,12900,0,0
TIKI,o-to-xe-may-xe-dap,766711,"Chai xịt phủ bóng nhanh, chống bám nước sơn xe ô tô Luxury Gloss W-207 500ml Soft99",260000,260000,0,0
TIKI,o-to-xe-may-xe-dap,52229792,"Khay để đồ khe ghế đa năng trên ô tô",79000,79000,0,0
TIKI,o-to-xe-may-xe-dap,270543520,"XE ĐẠP TRẺ EM THỂ THAO CHO BÉ 3-10 TUỔI - tặng kèm giỏ + Gacbaga",749000,749000,0,0
TIKI,o-to-xe-may-xe-dap,72749902,"Kính chiếu hậu dành cho dòng xe Air Blade 2016-2019 Green Networks Group ( 1 Cặp )",99000,99000,0,0
TIKI,o-to-xe-may-xe-dap,1229357,"Mũ Bảo Hiểm Phong Cách Thể Thao Kính Gương Asia M115 KK",320000,320000,0,0
TIKI,o-to-xe-may-xe-dap,49083192,"Set 4 khăn lau rửa xe chuyên dụng Microfiber-Caro,màu ngẫu nhiên",149000,149000,0,0
TIKI,o-to-xe-may-xe-dap,48039658,"CHÚ CHÓ ĐEN TRẮNG THAN HOẠT TÍNH KHỬ MÙI & TRANG TRÍ TAPLO Ô TÔ LOẠI LỚN 28CM X 21CM",99000,99000,0,0
TIKI,o-to-xe-may-xe-dap,33392037,"Phuộc BULL FIRE 2 lò xo dành cho Wave,Dream BẢO LONG RACING",365000,365000,0,0
TIKI,o-to-xe-may-xe-dap,5432257,"Chống đổ trước dành cho xe exciter và winner",48000,48000,0,0
TIKI,o-to-xe-may-xe-dap,13294488,"Bô 2 Tấm Chắn Bùn Xe Đạp Thể Thao Cao Cấp AZOE",55000,80000,25000,31
TIKI,o-to-xe-may-xe-dap,53498362,"bao tay cho xe máy daytona tặng bao tay xe máy",26000,26000,0,0
TIKI,o-to-xe-may-xe-dap,80489923,"Bơm điện 2 chiều bơm và hút chân không",75000,75000,0,0
TIKI,o-to-xe-may-xe-dap,194372826,"THANH GIỮ ỐNG PHANH",109963,109963,0,0
TIKI,o-to-xe-may-xe-dap,48139870," Bộ 2 Bao Tay, Găng Tay Rửa Xe, Lau Xe Ô tô, Xe Máy Cao Cấp LX-001",75000,105000,30000,29
TIKI,o-to-xe-may-xe-dap,120069787,"Tẩu đực cắm lỗ sạc trên ô tô (Không cầu chì)",33000,33000,0,0
TIKI,o-to-xe-may-xe-dap,150493967,"Đèn hậu led stop chớp nháy F1 lắp các loại xe máy siêu đẹp",49000,49000,0,0
TIKI,o-to-xe-may-xe-dap,109310799,"Đèn xi nhan demi thủy tinh T10 12V ô tô xe máy Green Networks Group ( 1 Cái )",15000,15000,0,0
TIKI,o-to-xe-may-xe-dap,14340750,"Bộ 2 gương chiếu hậu toàn cảnh cho ô tô Baseus Full-Vision Blind-Spot Car Miror - Hàng nhập khẩu.",84049,84049,0,0
TIKI,o-to-xe-may-xe-dap,3261751,"Mũ bảo hiểm nửa đầu GRS A966K - 2 Lớp kính - Tháo được lót",459000,459000,0,0
TIKI,o-to-xe-may-xe-dap,23485532,"Mũ bảo hiểm nam nữ nửa đầu Sunda 136 cao cấp có kính âm nhiều màu",275000,275000,0,0
TIKI,o-to-xe-may-xe-dap,23427653,"Dây Câu Bình Ắc Quy Ô Tô 2000A Dài 4M",125000,125000,0,0
TIKI,o-to-xe-may-xe-dap,54814572,"Móc treo đồ đa năng, giá đỡ điện thoại gắn lưng ghế ô tô",45000,45000,0,0
TIKI,o-to-xe-may-xe-dap,118299286,"Xe đạp GIANT ESCAPE 1 2022",13150000,13150000,0,0
TIKI,o-to-xe-may-xe-dap,45376591,"Bộ 2 tem dán gương chiếu hậu ô tô Performance 02",49000,49000,0,0
TIKI,o-to-xe-may-xe-dap,113404847,"Bộ 02 Tay Nắm Xe Đạp Cao Cấp Có Tay Nghỉ TN02",87120,87120,0,0
TIKI,o-to-xe-may-xe-dap,36213935,"Lọc Động Cơ Dành Cho Xe Ô Tô Honda City 2015-2018, HRV 2016-2018 Lọc sạch bụi bẩn, Bảo vệ tuổi thọ động cơ",126700,126700,0,0
TIKI,o-to-xe-may-xe-dap,155282733,"Nhớt Xe Ga Motul Scooter Power 5W40 MB Chai 800ml Chính Hãng",165000,165000,0,0
TIKI,o-to-xe-may-xe-dap,37513973,"Quạt Ô Tô Có Lồng Sắt Bảo Vệ 12V Mini Có Kẹp Treo Xe Cao Cấp",158000,158000,0,0
TIKI,o-to-xe-may-xe-dap,58213358,"CẦN GẠT MƯA 3 KHÚC Ô TÔ CAO CẤP DENSO JANPAN",256000,256000,0,0
TIKI,o-to-xe-may-xe-dap,52957945,"Đèn led usb led cắm vào xe oto",35000,35000,0,0
TIKI,o-to-xe-may-xe-dap,69246611,"Bơm Xe Đạp Mini Treo Xe Gắn Khung Sườn Có Đế Gắn Sử Dụng Khẩn Cấp 120Psi 8 Bar Siêu Nhẹ Xy Lanh Lõi Nhôm (Kèm 2 Đầu Bơm) Mai Lee",94000,99000,5000,5
TIKI,o-to-xe-may-xe-dap,136187606,"RÈM CHE NẮNG NAM CHÂM CHO XE FORD LASER",290000,290000,0,0
TIKI,o-to-xe-may-xe-dap,109377151,"Dàn áo dành cho Sirius loại 1 màu Đỏ Đen kiểu Zin",990000,990000,0,0
TIKI,o-to-xe-may-xe-dap,22210236,"Bộ dụng cụ sửa chữa xe đạp mini 15 in 1 đa năng tiện lợi Mai Lee - Hàng chính hãng",44000,59000,15000,25
TIKI,o-to-xe-may-xe-dap,186534300,"Xe Scooter điện người lớn - Xe Scooter xếp gọn cao cấp Phiên Bản Giới Hạn ",4199000,4199000,0,0
TIKI,o-to-xe-may-xe-dap,34321151,"Pô ahm 7 Màu + Cổ lon gắn Sirius, wave, dream BẢO LONG RACING",205000,205000,0,0
TIKI,o-to-xe-may-xe-dap,136104158,"Ghế Ngồi Gắn Xe Đạp An Toàn Cho Bé ( tặng hộp đựng mini )",132000,132000,0,0
TIKI,o-to-xe-may-xe-dap,196350797,"Bộ phanh thắng đùm xe đạp bánh sau",80000,80000,0,0
TIKI,o-to-xe-may-xe-dap,53218129,"cặp phuộc sau cho wave nice tặng bao tay xe máy",308000,308000,0,0
TIKI,o-to-xe-may-xe-dap,11423248,"Bao da chìa khóa xe Hyundai Tucson, Elantra, I10 bản chìa thông minh - kèm móc khóa",118000,118000,0,0
TIKI,o-to-xe-may-xe-dap,138181738,"CẶP MÂM-VÀNH ĐÚC 5 CÂY 2 THẮNG ĐÙM( PHANH CƠ) GẮN CHO XE  YAMAHA SIRIUS,JUPITER, TAURUS...",1388450,1388450,0,0
TIKI,o-to-xe-may-xe-dap,103121485,"LED T10 SMD 4014LED cao cấp Ô tô xe máy",26000,26000,0,0
TIKI,o-to-xe-may-xe-dap,170065040,"Nón Thể Thao POC 01 FREESIZE Đủ Màu",749000,749000,0,0
TIKI,o-to-xe-may-xe-dap,184829920,"Xe đạp trẻ em các cỡ cho bé 7 đến 15 tuổi - xe đạp trẻ em thể thao có đề - xe đạp địa hình",1069000,1069000,0,0
TIKI,o-to-xe-may-xe-dap,162766615,"Bao chìa khóa bằng TPU, ốp chìa khóa, móc khóa ô tô dùng riêng cho xe Kia Soluto, Rio, Morning, Optima, Carens, sorento",108000,108000,0,0
TIKI,o-to-xe-may-xe-dap,42644230,"Bình phun rửa xe tự tạo bọt tuyết Dung tích 1L 2020",168000,168000,0,0
TIKI,o-to-xe-may-xe-dap,10640589,"Đồng hồ đo tốc độ xe đạp không dây 548C",150000,150000,0,0
TIKI,o-to-xe-may-xe-dap,181772426,"Bạt Phủ Xe Ô Tô Chevrolet Spark, Colorado, Trailblazer, Aveo, Cruze - Chất Liệu Bạt Tráng Nhôm 3 Lớp",285000,285000,0,0
TIKI,o-to-xe-may-xe-dap,162250600,"Ắc quy khô miễn bảo dưỡng Đồng Nai PTZ6L ISS dành cho xe có Idling Stop | 12V - 6Ah",295000,295000,0,0
TIKI,o-to-xe-may-xe-dap,108313277,"GƯƠNG 5 CẠNH XE MÁY LOẠI ĐẸP (GIÁ 1 CHIẾC TRÁI)",89000,89000,0,0
TIKI,o-to-xe-may-xe-dap,15533487,"Bộ 2 mang cá giả hốc gió dán xe ô tô MC012",125000,125000,0,0
TIKI,o-to-xe-may-xe-dap,55638163,"Combo Đèn Pha Trước Cho Xe Đạp Siêu Sáng Sạc Được USB Chống Nước (Kèm Chân Đế Trượt) Và Đèn Hậu Cảnh Báo (Màu Đỏ) Xe Đạp Led Gắn Đuôi Phía Sau Mai Lee",146000,179000,33000,18
TIKI,o-to-xe-may-xe-dap,72841292,"Bộ tay thắng tay côn 6 số kèm bao tay xe máy gù pha lê cho xe Winner 150 Green Networks Group",199000,199000,0,0
TIKI,o-to-xe-may-xe-dap,28418822,"Thiết bị chuyển nguồn 220v sang điện 12V Trắng - Hàng Nhập Khẩu",194000,194000,0,0
TIKI,o-to-xe-may-xe-dap,105184559,"Gương chiếu hậu xe máy, mặt trắng, thời trang, nhỏ gọn",165000,165000,0,0
TIKI,o-to-xe-may-xe-dap,20206548,"Đế cao su bọc chân chống cho xe máy",5000,5000,0,0
TIKI,o-to-xe-may-xe-dap,135572233,"Máy khử mùi, lọc không khí dạng cốc trên xe ô tô Philips GP3601 công nghê SaniFiler Plus - HÀNG NHẬP KHẨU",2079000,2079000,0,0
TIKI,o-to-xe-may-xe-dap,172949797,"MŨ BH 1/2 KIỂU 2 FREE SIZE",507600,507600,0,0
TIKI,o-to-xe-may-xe-dap,119719097,"Bình Ắc Quy Khô Xe Máy GLOBE WTZ6V 12V6AH dùng cho NOZZA, AirBlade, SH MODE, SH Việt Nam",340000,340000,0,0
TIKI,o-to-xe-may-xe-dap,134527132,"Chai xịt Khử mùi ô tô Clean Shu! Shu! 500mL nước ion kiềm tẩy rửa, diệt khuẩn từ Nhật Bản",295000,295000,0,0
TIKI,thoi-trang-nu,97586335,"Đồ Ngủ Hai Dây Lụa Satin Sexy Quyến Rũ Thương Hiệu Baw, Chất Liệu Lụa Mát Mịn Nhẹ Nhàng Cực Kỳ Lôi Cuốn NT701 (hình thật shop tự chụp)",169000,169000,0,0
TIKI,thoi-trang-nu,112250895,"Sét Đồ Bộ Thể Thao Nam Nữ Mặc Nhà Phong Cách Ulzzang Unisex, Freesize Chất Cotton Không Phai, Đồ bộ mặc nhà dạo phố chất thun cotton I LIKE tay phối raplang trẻ trung năng động, Set đồ bộ nữ chất thun cotton co giản thoáng mát",99000,99000,0,0
TIKI,thoi-trang-nu,74360894,"Quần Lót Nữ Modal Trơn Comfort Miley Lingerie BCS-04",32000,79000,47000,59
TIKI,thoi-trang-nu,150213944,"Áo bảo hộ lao động nam nữ màu than phối xanh khóa kéo SHUNI -005A vải kaki liên doanh loại dày, đồng phục kỹ sư,xây dựng",149000,149000,0,0
TIKI,thoi-trang-nu,7595959,"Áo Thun Nữ Phối Ren Thời Trang MS0084A",170000,170000,0,0
TIKI,thoi-trang-nu,254097845,"Túi Đi Chùa # Túi Đi Chùa # Nam Nữ # Bị",25000,25000,0,0
TIKI,thoi-trang-nu,132126269,"Đồ đi biển gia đình 3 4 5 người đồng phục du lịch nam nữ đủ size áo và quần nổi bật DDB08 | SG",99000,99000,0,0
TIKI,thoi-trang-nu,59205406,"COMBO 5 ÁO LÁ NGẮN THUN LỤA MẶT TRƯỚC 2 LỚP DÀNH CHO HỌC SINH",93000,98000,5000,5
TIKI,thoi-trang-nu,124489997,"Đồ ngủ sexy nữ Đồ ngủ hai dây có mút ngực, cột nơ chất phi hai dây chất mịn quyến rũ",56000,56000,0,0
TIKI,thoi-trang-nu,140213462,"Áo hai dây nữ lụa cao cấp, mát, mịn, không nhăn - AD01 - wfstudios",180000,180000,0,0
TIKI,thoi-trang-nu,96994606,"Váy ngủ ren hoa xuyên thấu thoáng mát+ Quần lót sexy",69000,69000,0,0
TIKI,thoi-trang-nu,87582606,"Áo Lót Mút Mỏng Vừa Màu Trơn Habpy Lady By Sabina HBXLP0004",229000,383000,154000,40
TIKI,thoi-trang-nu,116117817,"Quần Lót Giấy cho các mẹ sau khi sinh, 1 gói 5 chiếc (MSP: Đáy Liền)",30000,30000,0,0
TIKI,thoi-trang-nu,84437281,"áo sweater nữ in quả địa cầu , áo hoodie nữ, áo thun tay dài form rộng ,áo sweater nam nữ đều mặc được, áo chui đầu, áo khoác nữ chống nắng chống lạnh tốt",92000,92000,0,0
TIKI,thoi-trang-nu,82914112,"Bộ 5 Quần Lót Su Viền Lượn Sóng Không Viền Mẫu mới 2021 thương hiệu BAW NT10",199000,199000,0,0
TIKI,thoi-trang-nu,109190787,"Đầm xòe đỏ kết hoa trắng-MS0605D",190000,190000,0,0
TIKI,thoi-trang-nu,161556077,"Choàng Chống Nắng Nữ 2 Lớp Laroma| UPF50+ | Vải Thơm | Làm Mát | Thời Trang | Đa Dụng",629000,899000,270000,30
TIKI,thoi-trang-nu,162526714,"Quần short nữ ống rộng cạp cao vắt chéo xếp ly quần đùi bigsize đến 80kg mặc ở nhà, đi chơi,dạo phố vào mùa xuân hè thu",125000,250000,125000,50
TIKI,thoi-trang-nu,182100187,"[MUA ÁO TẶNG QUẦN] Áo ngực có gọng mút vừa T-Shirt smothie iBasic BRAW130",279000,299000,20000,7
TIKI,thoi-trang-nu,145289760,"Chân Váy Công Sở New Design Thiết Kế Dáng Váy chữ A, Dài Qua Gối ,Phối Nút, Phom Chuẩn Tôn Dáng Sang Trọng Vải Tốt co Giãn, Màu Đen CV0066",179000,299000,120000,40
TIKI,thoi-trang-nu,190229023,"( Miễn phí áo liner + thanh nới ) Đai nịt bụng latex VORONIN SIÊU SIẾT EO che mỡ lưng-Sự lựa chọn để có 1 body hoàn hảo",330000,330000,0,0
TIKI,thoi-trang-nu,193099535,"Áo khoác vest nữ cổ lụa ngắn tay lỡ, blazer nữ công sở form suông thiết kế trẻ trung chất tuyết mưa màu đen trắng xanh dễ phối đồ đi chơi dạo phố sự kiện tiệc cưới lễ hội",400000,400000,0,0
TIKI,thoi-trang-nu,107352272,"Quần ống rộng nữ, quần ống suông đũi Gu chun lưng chất mát",69000,69000,0,0
TIKI,thoi-trang-nu,182993124,"Đồ Bơi Nữ Tay Dài Quần Dài Ôm Thân Khoe Dáng AT227 MayHomes Long Sleeves And Long Pants Women Swimwear With UPF 50 Sun Protection",343000,350000,7000,2
TIKI,thoi-trang-nu,114317990,"Áo khoác bomber dù unisex form rộng 2 lớp 23 nam nữ",88000,88000,0,0
TIKI,thoi-trang-nu,76563546,"Váy ngủ lụa phối ren xẻ tà cao cấp ĐỦ MÀU ĐỦ SIZE",175000,175000,0,0
TIKI,thoi-trang-nu,99219054,"Quần âu nữ công sở Hiền Trần BOUTIQUE vải trượt Thái mềm mại, co giãn, tôn dáng chuẩn VNXK",151000,350000,199000,57
TIKI,thoi-trang-nu,109137583,"ÁO HOODIE NỮ IHAN FORM RỘNG CHẤT NỈ NGOẠI DÀY DẶN THOÁNG MÁT, ÁO KHOÁC HOODIE ULZZANG PHONG CÁCH CÁ TÍNH, Aó hoodie nam , áo hoodie nữ , áo khoác áo hoodie cặp đôi nam nữ mặc",100000,100000,0,0
TIKI,thoi-trang-nu,179412723,"Áo khoác vest blazer nữ phong cách hàn quốc 2 túi chất đũi xước cao cấp ( mã SP11)",190000,190000,0,0
TIKI,thoi-trang-nu,110896759,"Quần ống rộng nữ vải đũi cạp cao 2 cúc suông dài tôn dán chun sau co dãn thoải mái Thời trang BANAMO sớ đũi 2khuy 922",89000,89000,0,0
TIKI,thoi-trang-nu,150693634,"(HÀNG SẴN) Áo Thun Len Mềm Đẹp Co Giãn Lịch Sự SM79 - Hàng Quảng Châu Cao Cấp",245000,245000,0,0
TIKI,thoi-trang-nu,174622348,"Chân váy chữ A ngắn xẻ tà MADELA ,kiểu dáng công sở basic chất vải dày dặn, có quần trong chống lộ ,phong cách trẻ trung năng động có nhiều màu và đủ size lựa chọn- CVAX02",110000,110000,0,0
TIKI,thoi-trang-nu,116965781,"Cặp Miếng Dán Ngực Giấy Mỏng Tiện Lợi Loirechic MD08",5000,5000,0,0
TIKI,thoi-trang-nu,75390523,"Đầm xòe voan cổ tròn tay loe ArcticHunter, thời trang thương hiệu chính hãng",89000,89000,0,0
TIKI,thoi-trang-nu,49293177,"Áo Tắm Hai Mảnh Cá Tính AT146 MayHomes Thun Co Giãn, Không Phai Màu",243460,259000,15540,6
TIKI,thoi-trang-nu,132128941,"Áo thun hội nhóm lớp chữ TEAM nổi bật form unisex nam nữ phông màu trắng chất cotton mềm mịn ANL290 | SG",49000,49000,0,0
TIKI,thoi-trang-nu,73278835,"Combo 10 Quần Lót Nữ Modal Trơn Comfort BCS-04 - Giao màu ngẫu nhiên",419000,790000,371000,47
TIKI,thoi-trang-nu,81186470,"Áo Thun Xanh Ngọc Vải Dày Đủ Size",24000,24000,0,0
TIKI,thoi-trang-nu,42737728,"Bộ Áo Ngực Và Quần Lót Nữ Ren Không Gọng Miley Lingerie BRL_FLS_03",237000,385000,148000,38
TIKI,thoi-trang-nu,54869790,"Váy ngủ 2 dây, đầm mặc nhà nữ DV18",207900,220000,12100,6
TIKI,thoi-trang-nu,162089271,"Áo Chống Nắng Nữ 2 Lớp Laroma| UPF50+ | Vải Thơm | Làm Mát | Thời Trang | Đa Dụng",429000,569000,140000,25
TIKI,thoi-trang-nu,102262050," [ Ảnh Thật ] Áo khoác cardigan nam nữ kiểu bomber Summer Unisex Ulzzang chất nỉ bông cao cấp - Áo Khoác Thiên Hà",87000,87000,0,0
TIKI,thoi-trang-nu,97606021,"Đồ Ngủ Hai Dây Lụa Satin Cao Cấp Sexy Quyến Rũ Thương Hiệu Baw, Chất Liệu Lụa Mát Mịn Nhẹ Nhàng Cực Kỳ Lôi Cuốn NT707 (hình thật shop tự chụp)",169000,169000,0,0
TIKI,thoi-trang-nu,146785266,"(Big size) chân A caro dài xẻ trước đính cúc",160000,160000,0,0
TIKI,thoi-trang-nu,55023823,"Set Đồ Bơi 3 Mảnh Rực Rỡ Nắng Hè AT167 MayHomes Bộ Đồ Áo Bơi Nữ, Quần Bơi Nữ Và Váy Bơi Nữ",145000,159000,14000,9
TIKI,thoi-trang-nu,155180491,"Miếng đệm nâng ngực Hình bán nguyệt MD04",19800,19800,0,0
TIKI,thoi-trang-nu,168092538,"Đồ Bơi Hai Mảnh Thể Thao Trẻ Trung AT219 Áo Tắm Đa Năng Women Short Swimwear Set For Swimming And Sports",239700,255000,15300,6
TIKI,thoi-trang-nu,113332193,"váy suông nữ ,đầm suông nữ sát nách dáng dài chất đũi 3 màu xinh xắn",80000,80000,0,0
TIKI,thoi-trang-nu,98065619,"[HCM] (40-56kg, P5) Đồ bộ TNQN chất LATIN in 3D. Đồ bộ đùi LATIN nữ. Đồ bộ LATIN mặc nhà. Đồ bộ mặc ngủ LATIN. Đồ bộ pizama/pijama/pyjma TNQN LATIN. Đồ bộ LATIN cao cấp nữ. Đồ bộ LATIN đùi nữ. (PIJAMA/PIZAMA/PYJAMA). LATIN2TNQN",155000,155000,0,0
TIKI,thoi-trang-nu,97537678,"Chân váy chữ A ngắn xẻ trước kèm quần trong 3 màu",62000,62000,0,0
TIKI,thoi-trang-nu,146782691,"(BIG SIZE phom rộng) Chân váy xếp ly bản to cạp cao có quần trong C041",180000,180000,0,0
TIKI,thoi-trang-nu,191052909,"Chân váy nữ ngắn xếp ly lưng cao chữ a, chân váy tennis xếp li bản nhỏ màu đen trắng be vải kaki mịn mặc đi học đi chơi dạo phố vào mùa hè",149000,250000,101000,40
TIKI,thoi-trang-nu,194456479,"Sét bộ đồ đùi bigsize nữ đi chơi sang chảnh, sét bộ đùi nữ sát nách mẫu mới siêu hot",149000,149000,0,0
TIKI,thoi-trang-nu,55096570,"Combo 10 Quần Lót Nữ Cotton Thái Họa Tiết Trơn Cao Cấp - Co Giãn - Mềm Mịn - Nhiều Màu - Freesize 42-57 kg - Tặng kèm set 10 thun cột tóc xinh xắn",77500,77500,0,0
TIKI,thoi-trang-nu,44580442,"Áo len nữ thêu hình kiểu dáng Hàn Quốc",179000,179000,0,0
TIKI,thoi-trang-nu,110165804,"Áo thun nữ ngắn tay phong cách Hàn Quốc 206352",29000,29000,0,0
TIKI,thoi-trang-nu,153409167,"Áo polo unisex tay lỡ form rộng Yinxx, áo thun có cổ nam nữ màu xanh ATP01",75050,79000,3950,5
TIKI,thoi-trang-nu,97709959,"Áo Ngực Không Gọng Chất Liệu Ren Cao Cấp, Áo Lót Bra Không Gọng dây mảnh Thương Hiệu Baw mã NT731",159000,159000,0,0
TIKI,thoi-trang-nu,110751447,"Áo thun Unisex 20We Basic Tee phông trơn nam nữ RP_01 tay lỡ oversize form rộng 4 màu",24000,24000,0,0
TIKI,thoi-trang-nu,126678940,"Áo khoác len 2 đầu kéo khoá",105000,105000,0,0
TIKI,thoi-trang-nu,72207184,"Áo Ngực Không Gọng LOIRECHIC BRTS19 Đệm Mỏng",249000,315000,66000,21
TIKI,thoi-trang-nu,132139806,"Áo thun tết gia đình màu đỏ đồng phục gia đình 3/4/5 người nổi bật thun cotton mềm mịn SGY156D",49000,49000,0,0
TIKI,thoi-trang-nu,106753082,"Áo Lót Nữ, Áo Lót Đúc Su Đệm Dày Siêu Nâng Ngực Tạo Khe Quyến Rũ, Áo Ngực Su Bàn Tay Không Gọng Không Đường May Thương Hiệu BAW Mã AN372",159000,159000,0,0
TIKI,thoi-trang-nu,155181863,"Miếng đệm nâng siêu dày (dùng cho bikini/ đồ tập gym - yoga) MDN12 + MDN11",27000,27000,0,0
TIKI,thoi-trang-nu,85011303," Áo Croptop Nữ UNI Tay Ngắn Form Rộng Ulzzang (ẢNH THẬT)",69000,69000,0,0
TIKI,thoi-trang-nu,117105650,"áo khoác nỉ hoodie Unisex phong cách Hàn SOMEDAY, áo khoác nam nữ có túi from rộng ulzzang có khoá kéo, ÁO KHOÁC CHỐNG NẮNG CÓ MŨ - ÁO KHOÁC HOODIE NAM NỮ ULZZANG COUPLE",100000,100000,0,0
TIKI,thoi-trang-nu,137741723,"Combo 5 chiếc Quần lót dùng một lần cotton hàng cao cấp thấm hút mồ hôi",60000,60000,0,0
TIKI,thoi-trang-nu,7189977,"Đai Nịt Bụng Giảm Mỡ - MS31 - 5Star",58900,58900,0,0
TIKI,thoi-trang-nu,9670279,"Áo khoác nữ 4 túi dây kéo Phúc An 4045 size",190000,190000,0,0
TIKI,thoi-trang-nu,185713822,"Áo Khoác Windbreaker Nữ Giordano 05372002",705000,940000,235000,25
TIKI,thoi-trang-nu,146636313,"Áo sơ mi nữ kiểu tay lỡ NeSa, chất liệu Đũi tơ thấm mồ hôi, áo kiểu form rộng phong cách Hàn Quốc, AKH.45",145000,229000,84000,37
TIKI,thoi-trang-nu,179417985,"Áo trung niên nữ cổ tròn chất đũi dáng rộng, họa tiết thêu độc đáo. R4",185000,185000,0,0
TIKI,thoi-trang-nu,67241193,"Đầm suông linen cổ V túi hộp thắt eo ArcticHunter, thời trang thương hiệu chính hãng",280000,280000,0,0
TIKI,thoi-trang-nu,85400189,"Quần lót nữ cotton du lịch Etravel dùng một lần",122550,129000,6450,5
TIKI,thoi-trang-nu,97730654,"Bộ 5 Quần Lót Ren Nữ Viền Tinh Tế, Quần Chip Nữ Kháng Khuẩn Cao Cấp Thương Hiệu BAW NT734",199000,199000,0,0
TIKI,thoi-trang-nu,82291729,"Áo thun nữ cổ tim trơn",29000,29000,0,0
TIKI,thoi-trang-nu,95181024," Hộp 60 miếng dán ngực giấy lụa 164  tàng hình giá rẻ tiện lợi",52000,52000,0,0
TIKI,thoi-trang-nu,77152815,"Đầm ngủ lụa sexy quyến rũ gợi cảm tặng kèm quần chip lọt khe",179000,179000,0,0
TIKI,thoi-trang-nu,116206931,"Quần ống rộng nữ,quần ống suông nữ lưng cao dáng dài 1 khuy chất tuyết mưa dày dặn",85000,85000,0,0
TIKI,thoi-trang-nu,132137825,"Áo gia đình 3/4/5 người mẫu bắn tim màu vàng cúc làm đồ đồng phục nổi bật thun cotton mềm mịn GD322VD DONGPHUCSG",49000,49000,0,0
TIKI,o-to-xe-may-xe-dap,188687979,"Decal dán đèn pha ô tô nhiều màu đỏ,xanh, vàng, đen thể thao và thời trang",60000,60000,0,0
TIKI,o-to-xe-may-xe-dap,196350897,"Chân chống xe đạp dựng chữ L kệ kẹp bánh xe",220000,220000,0,0
TIKI,o-to-xe-may-xe-dap,157117905,"Ví đựng giấy tờ xe, đăng kiểm da bò thật handmade Mẫu 02",350000,350000,0,0
TIKI,o-to-xe-may-xe-dap,172948836,"BỘ CHẮN BÙN SAU EXCITER 155",199000,199000,0,0
TIKI,o-to-xe-may-xe-dap,202329754,"Bình Ắc Quy Khô WTZ5S 12V,4.2Ah/WTD 4V,3.5Ah hiệu GLOBE Cho Xe WAVE RS100/ WAVE RS 110/ AIRBLADE/ EXCITER 135",250000,250000,0,0
TIKI,o-to-xe-may-xe-dap,195845757,"Tai Mèo Gắn Nón Bảo Hiểm",15000,15000,0,0
TIKI,o-to-xe-may-xe-dap,68565448,"Đèn đuôi nhấp nháy đèn cảnh báo sau cho xe đạp thể thao màu đỏ A02 siêu sáng, chống nước, thời gian sáng lên đến 200h Mai Lee",132000,159000,27000,17
TIKI,o-to-xe-may-xe-dap,68230952,"Phễu thay nhớt cán dài Thái Lan Loại Tốt( Giao Màu Ngẫu Nhiên )",19000,19000,0,0
TIKI,o-to-xe-may-xe-dap,15476774,"Nắp van xe",18865,22000,3135,14
TIKI,o-to-xe-may-xe-dap,136187531,"RÈM CHE NẮNG NAM CHÂM CHO XE TOYOTA CROSS.",248000,248000,0,0
TIKI,o-to-xe-may-xe-dap,192398261,"Gương cầu lồi ô tô dán trên gương chiếu hậu tăng góc nhìn chống nước - Gương mini chống điểm mù oto xe hơi, Gương Cầu Lồi Ô Tô Xe Hơi Chiếu Hậu Chống Điểm Mù Cho Xe",35000,35000,0,0
TIKI,o-to-xe-may-xe-dap,57485566,"Đèn Pha Led Bi Cầu 2 Màu Cos Vàng Pha Trắng ",119002,119002,0,0
TIKI,o-to-xe-may-xe-dap,54675049,"Dung Dịch Làm Sạch Không Khí Trong Xe Và Hệ Thống Giàn Lạnh Michelin Clean Air 31449-150mL Hàng Chính Hãng",128250,135000,6750,5
TIKI,o-to-xe-may-xe-dap,42459109,"Đèn LED Gắn Trần Nội Thất Xe Ô Tô ( 2 cái )",72000,72000,0,0
TIKI,o-to-xe-may-xe-dap,138387695,"Bộ dụng cụ tháo nội thất ô tô đầy đủ chi tiết, bộ cậy taplo, nạy nhựa ô tô",130000,130000,0,0
TIKI,o-to-xe-may-xe-dap,25092849,"Cần trợ lực tay lái, vô lăng cao cấp BAUHAUS (có vòng bi)",182000,182000,0,0
TIKI,o-to-xe-may-xe-dap,106586221,"Kính Rizoma Elisse Hàng loại 1",239000,239000,0,0
TIKI,o-to-xe-may-xe-dap,153078292,"Biển Tam Giác Phản Quang Cảnh Báo nguy Hiểm Led Nháy Sáng Cho Ô tô Loại To Sử Dụng Năng Lượng Mặt Trời",179000,179000,0,0
TIKI,o-to-xe-may-xe-dap,31436523,"Bộ 2 Miếng Dán Kính Ô Tô Chống Nước Chống Lóa Hình Chữ Nhật 20x17.5cm",47000,47000,0,0
TIKI,o-to-xe-may-xe-dap,114745004,"Combo 2 Lưỡi Gạt Mưa Loại A VIAIR R15 (16 Inch/400 mm)",66000,66000,0,0
TIKI,o-to-xe-may-xe-dap,75575928,"Cảm biến áp suất lốp van trong không dây STEELMATE Chính Hãng",1399000,1399000,0,0
TIKI,o-to-xe-may-xe-dap,2453873,"Chai xịt dưỡng sên/xích Repsol 400ml",144000,144000,0,0
TIKI,o-to-xe-may-xe-dap,78971181,"Combo dưỡng sên chống văng Megacools Chain Lube Ultra MOLY WAX 300ml +vệ sinh sên 500ml Penetrate tặng bàn chải chải",169000,169000,0,0
TIKI,o-to-xe-may-xe-dap,91589775,"Tấm miếng đệm lót yên xe máy bằng hạt gỗ cho xe số",99995,99995,0,0
TIKI,o-to-xe-may-xe-dap,89945283,"Đèn Led Gắn  Xe Đạp Siêu Sáng Kèm Gía Kẹp 206212",50000,65000,15000,23
TIKI,o-to-xe-may-xe-dap,119719091,"Bình ắc quy khô cho xe máy Dream, Wave, Future, Sirius, Jupiter, Taurus, Mio GS GT6A (12V - 6AH)",330000,330000,0,0
TIKI,o-to-xe-may-xe-dap,55059741,"Ắc quy Vision CP1270 12V 7Ah",339200,339200,0,0
TIKI,o-to-xe-may-xe-dap,191444540,"Xe đạp thời trang nữ Giant Momentum Ineed Latte 24/26 2023",10950000,10950000,0,0
TIKI,o-to-xe-may-xe-dap,54784099,"Chai xịt làm sạch và bảo dưỡng nhựa trong và ngoài xe Sonax 380041 dung tích 300ml",200000,200000,0,0
TIKI,o-to-xe-may-xe-dap,128710000,"Chuông Xe Đạp Kim Loại Âm Thanh Lớn Lắp Mọi Dòng Xe",59000,59000,0,0
TIKI,o-to-xe-may-xe-dap,122412711,"Đầu khóa chốt cắm móc đai dây an toàn ô tô dạng cắm nối tiếp chống kêu HC-999: Dòng sản phẩm cao cấp",212000,212000,0,0
TIKI,o-to-xe-may-xe-dap,46653898,"Dầu chống rỉ sét và bôi trơn thiết bị động cơ RX9 300g",101270,106600,5330,5
TIKI,o-to-xe-may-xe-dap,110905749,"Vam tháo cốc lọc dầu 23pc",630000,630000,0,0
TIKI,o-to-xe-may-xe-dap,270539307,"XE ĐẠP TRẺ EM THỂ THAO CỠ 20/22/24INCH dành cho bé 7 - 15 TUỔI  có đề + Tặng kèm giỏ xe, gácbaga, túi, bình nước",1099000,1099000,0,0
TIKI,o-to-xe-may-xe-dap,130470706,"Gạt mưa Silicone xương cứng Misubishi Xpander",231000,231000,0,0
TIKI,o-to-xe-may-xe-dap,7644433,"Rổ/giỏ xe máy WAVE 110 lắp hông RXM0036 ",29000,29000,0,0
TIKI,o-to-xe-may-xe-dap,97979866,"Bộ 2 Gương Cầu Lồi Xóa Điểm Mù Gương Chiếu Hậu Xe Hơi, Xe Máy, gương xoay 360 độ sẵn 3m bóc dính",18000,29000,11000,38
TIKI,o-to-xe-may-xe-dap,46409039,"cặp kiếng hậu cho xe win 100 tặng bao tay xe máy",139000,139000,0,0
TIKI,o-to-xe-may-xe-dap,120427158,"Bộ khẩu tuýp vặn 1/4 inch đa năng 46 chi tiết, chuyên tháo ốc nội thất xe",215000,245000,30000,12
TIKI,o-to-xe-may-xe-dap,71963359,"Tẩy ố mốc kính xe hơi Hg X1 250ml",250000,250000,0,0
TIKI,o-to-xe-may-xe-dap,2799693,"Giá Đỡ Điện Thoại Trên Ô TÔ One -  Touch",30999,30999,0,0
TIKI,o-to-xe-may-xe-dap,182456852,"Túi than hoạt tính TTAUTO 100% từ gáo dừa Bến Tre khử mùi diệt khuẩn trên ô tô, tủ đồ, phòng tắm - Túi 150 Gram",33000,65000,32000,49
TIKI,o-to-xe-may-xe-dap,196525119,"Tấm thảm lót chân xe máy điện VinFast Vento S 2022",150000,150000,0,0
TIKI,o-to-xe-may-xe-dap,271370123,"Xe đạp địa hình Thống Nhất MTB26-05 đen mờ - Hàng chính hãng",3390000,3390000,0,0
TIKI,o-to-xe-may-xe-dap,208206856,"Mũ bảo hiểm lỗ thông gió chính hãng NÓN SƠN TG-XM151",340000,650000,310000,48
TIKI,o-to-xe-may-xe-dap,53626686,"Ghế Ngồi Gắn Xe Đạp An Toàn Cho Bé Song Long",129000,129000,0,0
TIKI,o-to-xe-may-xe-dap,14289778,"Cần số Titan dành cho xe Wave",75000,75000,0,0
TIKI,o-to-xe-may-xe-dap,181908818,"Xe đạp Thống Nhất thể thao M26-01 - Hàng chính hãng",3549000,3549000,0,0
TIKI,o-to-xe-may-xe-dap,87848828,"Đệm Hơi ô tô,Nệm hơi xe ô tô Cao Cấp Chất Liệu Vải Nhung",301000,555000,254000,46
TIKI,o-to-xe-may-xe-dap,7543371,"Mũ Bảo Hiểm 3/4 Đầu Royal M139",542000,700000,158000,23
TIKI,o-to-xe-may-xe-dap,127198691,"MIẾNG DECAL CÓ LOGO DÁN BẢO VỆ BẬC CHÂN XE Ô TÔ , MIẾNG DÁN CHỐNG TRẦY XƯỚC BẬC CHÂN XE ÔTÔ CÓ LOGO Theo Xe",90000,90000,0,0
TIKI,o-to-xe-may-xe-dap,35930998,"Khung Gắn Biển Số ( Khung, Viền, Kính, Ốc Gắn ) Cho Tất Cả Loại Xe STĐA Hoàng Long - Hàng Cao Cấp",36000,36000,0,0
TIKI,o-to-xe-may-xe-dap,128710056,"Combo 2 Đèn LED Gắn Van Bánh Xe Đạp, Xe Máy, Ô Tô",26499,26499,0,0
TIKI,o-to-xe-may-xe-dap,72333316,"Máy Khuếch Tán Tinh Dầu Xe Hơi Cao Cấp và Chuyên Dụng, Máy Xông Tinh Dầu Dùng Điện USB Trên Xe ô tô, Đèn LED Cực Đẹp, Không Dùng Lõi Bông",198000,556000,358000,0
TIKI,o-to-xe-may-xe-dap,139445958,"Móc Treo Đồ Xe Máy -2 Móc Xoay 180 độ mẫu mới loại dày đẹp hàng cao cấp lắp cho các xe máy xe điện",65550,69000,3450,5
TIKI,o-to-xe-may-xe-dap,83429308,"Bộ 2 gương cầu lồi gắn kính chiếu hậu xe hơi và xe máy",25800,25800,0,0
TIKI,o-to-xe-may-xe-dap,44000599,"Sạc điện thoại trên xe máy thông qua bình xe",69000,69000,0,0
TIKI,o-to-xe-may-xe-dap,125010167,"Nhớt Hộp Số Nhớt Láp Xe Tay Ga Motul Scooter Gear Oil Plus 120ml",55000,55000,0,0
TIKI,o-to-xe-may-xe-dap,91973091,"Gối tựa cổ cao su non trên ô tô bảo vệ cổ, lưng, cột sống khi lái xe -Gối tựa cổ cao su non trên ô tô bảo vệ cổ, lưng",175000,175000,0,0
TIKI,o-to-xe-may-xe-dap,118298811,"Giỏ xe đạp Khung thép",250000,250000,0,0
TIKI,o-to-xe-may-xe-dap,95548243,"Tẩu sạc nhanh ô tô QC 3.0 chia 2 nguồn sạc usb 5V/6.2A nguồn DC 12V/24V sử dụng cho tất cả các dòng xe ô tô",88000,88000,0,0
TIKI,o-to-xe-may-xe-dap,177830682,"Chắn bùn xe đạp Kiotool Touring, Fixed, 700c",65000,65000,0,0
TIKI,o-to-xe-may-xe-dap,3172271,"Chai Xịt Bôi Trơn Sên Chống Văng Tơ Nhện Spider Spray 600ml",220000,220000,0,0
TIKI,o-to-xe-may-xe-dap,177479143,"Mũ bảo hiểm 1/2 đầu Napoli N088 New vòng đầu từ 54 -57cm chất liệu nhựa ABS, xốp EPS giảm xung chấn cực tốt",229000,229000,0,0
TIKI,o-to-xe-may-xe-dap,71918313,"Bộ 12 miếng decal phản quang dán ô tô, xe máy",19000,19000,0,0
TIKI,o-to-xe-may-xe-dap,13239149,"Đệm ngồi lót ghế ô tô cao su thoáng khí hỗ trợ tuần hoàn máu E3-L206",74794,74794,0,0
TIKI,o-to-xe-may-xe-dap,130168640,"Đèn Led Xe Đạp nhấp nháy gắn đuôi xe đạp, tay lái, nón bảo hiểm, báng xe - siêu sáng, tuổi thọ dài, chống nước, tăng độ an toàn khi đạp xe ban đêm",25000,25000,0,0
TIKI,o-to-xe-may-xe-dap,18288302,"Ghế Xe Đạp Trẻ Em Song Long - Màu Ngẫu Nhiên",126000,126000,0,0
TIKI,o-to-xe-may-xe-dap,143292192,"Túi Treo Xe Đạp Thể Thao B-Soul01 40cm - Túi Đeo Xe Đạp Địa Hình Chống Nước - Phụ Kiện Xe Đạp Chính Hãng",112000,112000,0,0
TIKI,o-to-xe-may-xe-dap,134230819,"Giá chở hàng đa năng- Baga- Cáng chở hàng dành cho các loại xe máy, mở cốp tiện lợi 60x70cm",289000,289000,0,0
TIKI,o-to-xe-may-xe-dap,35911745,"Bộ 4 Khăn lau xe hơi, ô tô, xe máy đa năng chuyên dụng cao cấp siêu thấm hút nước mạnh giúp vệ sinh chăm sóc ô tô/ xe máy sạch sẽ - Hàng chính hãng",84550,89000,4450,5
TIKI,o-to-xe-may-xe-dap,75548106,"Tẩu sạc nhanh ô tô cao cấp tự điều chỉnh độ dài dây sạc usb",199000,199000,0,0
TIKI,o-to-xe-may-xe-dap,11204849,"Túi treo đầu xe máy mẫu mới siêu bền",189000,189000,0,0
TIKI,o-to-xe-may-xe-dap,25454895,"Bộ 2 miếng dán chống nước gương chiếu hậu xe hơi",37000,37000,0,0
TIKI,o-to-xe-may-xe-dap,22027685,"Gương Cầu Lồi Đa cực 360 Độ Gắn Gương Chiếu Hậu Ô Tô",10000,10000,0,0
TIKI,o-to-xe-may-xe-dap,125009528,"Nhớt Tổng Hợp Cho Xe Tay Ga 4 Thì Motul Scooter Power LE 5W40 Có Chiết Lẻ",175000,175000,0,0
TIKI,o-to-xe-may-xe-dap,1254773,"Kem Xóa Vết Xước Sơn Xe Hơi Liqui Moly Kratzer Stop 2320 (200ml)",179000,179000,0,0
TIKI,o-to-xe-may-xe-dap,82459827,"Đèn Hậu Xe Đạp 3 Bóng Đèn Sau Xe Đạp Giúp Cảnh Báo Đạp Xe/Chạy Bộ Ban Đêm Sạc USB Mai Lee",94000,99000,5000,5
TIKI,o-to-xe-may-xe-dap,48887218,"Combo Xịt Dưỡng sên Thunder Chain Lube 400ml, Vệ sinh sên MC-40 400ml tặng bàn chải chà sên 3D",117000,117000,0,0
TIKI,o-to-xe-may-xe-dap,146240539,"1 ĐÈN PHA LED 6 TIM SIÊU SÁNG XE MÁY XE HƠI ÔTÔ MẪU MỚI LOẠI TỐT",199000,199000,0,0
TIKI,thoi-trang-nu,72556311,"Áo Ngực Nữ Không Gọng Cotton Lụa Flexi Miley Lingerie BRC",203000,290000,87000,30
TIKI,thoi-trang-nu,121253282,"Áo Lót Nữ, Áo Lót Su Nước Đệm Mỏng Không Gọng Nâng Ngực, Áo Ngực Su Chất Su Mỏng Mát Mịn Thương Hiệu BAW Mã ANN1",159000,159000,0,0
TIKI,thoi-trang-nu,87534240,"Bikini dài tay, đồ bơi nữ dáng thể thao dài tay, quần đùi sooc khỏe khoắn",269000,269000,0,0
TIKI,thoi-trang-nu,191316591,"Set bộ 3 món vest blazer Linen ve vuông công sở + Quần short + Áo 2 dây trẻ trung ArcticHunter - Trắng",300000,300000,0,0
TIKI,thoi-trang-nu,147196959,"Áo Blouse Trắng, Bác Sĩ (Ngắn Tay, Cộc Tay), Nam Nữ, Áo Choàng Phòng Thí Nghiệm -VT0173",144000,144000,0,0
TIKI,thoi-trang-nu,73528213,"Áo Lót Mút Dày Siêu Nâng Ngực Màu Trơn Basic Doomm Doomm By Sabina SBA7998",359000,579000,220000,38
TIKI,thoi-trang-nu,70087428,"Áo Sơ Mi Nữ Trơn Dài Tay Công Sở CV088 Chất Kate Mềm Mịn Chuẩn Form Thời trang nữ cao cấp",138000,138000,0,0
TIKI,thoi-trang-nu,167461360,"Đồ bơi bigsize nữ, áo tắm cộc tay cùng quần boxer cho người béo mập, mẫu thể thao khỏe khoắn, chất đẹp phom đẹp | KT110",480000,480000,0,0
TIKI,thoi-trang-nu,181689964,"Áo kiểu cánh dơi nữ Hàn Quốc Thu Hà chất liệu đũi tơ mềm mịn mát thấm mồ hôi, form vừa xinh AKH.46",159000,159000,0,0
TIKI,thoi-trang-nu,174621843,"Áo 2 Dây nữ MADELA Lụa Hàn cao cấp, phong cách Vintage dễ mix đồ, áo có nhiều màu và đủ size để lựa chọn",100000,100000,0,0
TIKI,thoi-trang-nu,49905157,"Combo 5 Dây Nối Áo Ngực 3 Móc Co Giãn Tiện Dụng",33000,35000,2000,6
TIKI,thoi-trang-nu,67279949,"Quần short nữ kiểu mới chất đũi chun",30400,30400,0,0
TIKI,thoi-trang-nu,132133780,"Áo gia đình We are 1 Đồng phục gia đình 3/4/5 người giá rẻ Thun cotton dày dặn Màu trắng GD320T",49000,49000,0,0
TIKI,thoi-trang-nu,55524590,"Đầm suông chất đũi cổ trụ phối túi bên hông, chất vải mềm mát thích hợp mùa hè, thời trang Hàn Quốc",199000,199000,0,0
TIKI,thoi-trang-nu,73785311,"Quần lót lọt khe ren + kẹp tất sexy",35000,35000,0,0
TIKI,thoi-trang-nu,132133729,"Đồ đi biển nam nữ set nguyên bộ gồm áo thun và quần short có thể mặc gia đình hội nhóm hay cặp đôi DDB46 | DONGPHUCSG",99000,99000,0,0
TIKI,thoi-trang-nu,68939197,"Áo Thu Trắng Đủ Size Cho Mọi Lứa Tuổi",37000,37000,0,0
TIKI,thoi-trang-nu,169307799,"Quần baggy nữ Hiền Trần BOUTIQUE ống đứng, phom dáng Hàn Quốc màu đen xám, đồ công sở đi học",312000,350000,38000,11
TIKI,thoi-trang-nu,261948617,"Áo Bà Ba Màu Trơn_AM1 (Không Quần)",75000,75000,0,0
TIKI,thoi-trang-nu,116384748,"Áo thun nữ cộc tay phối màu in số 11 phong cách hàn quốc phom rộng",59000,59000,0,0
TIKI,thoi-trang-nu,192912833,"Chân váy nữ bigsize quần váy dancer hai lớp dáng a cạp cao tôn dáng thoải mái xẻ đùi độc đáo che khuyết điểm eo bụng",169000,280000,111000,40
TIKI,thoi-trang-nu,172677701,"Váy ngủ nữ, váy 2 dây lụa mềm quyến rũ VILADY - V121 thiết kế siêu sang màu Trắng gạo, chất liệu lụa Pháp ( lụa latin) cao cấp",289000,400000,111000,28
TIKI,thoi-trang-nu,96990192,"Quần lót lọt khe tua rua chuỗi ngọc sexy",29000,29000,0,0
TIKI,thoi-trang-nu,108926118,"Bộ Đồ Pijama Nữ Mặc Nhà Ngắn Tay Azuno ABN2606 Chất Liệu Cotton Lụa Có Lót Ngực Tiện Lợi Cho Mùa Hè",265000,390000,125000,32
TIKI,thoi-trang-nu,162161966,"QUẦN ỐNG RỘNG NỮ BIGSIZE CẠP CAO TÔN DÁNG KÉO DÀI CHÂN MÀU ĐEN TRẮNG NÂU DỄ PHỐI ĐỒ VÀO MÙA XUÂN HÈ THU ĐÔNG QUẦN ÂU DÀI SUÔNG HOT TREND HÀN",175000,300000,125000,42
TIKI,thoi-trang-nu,46654253,"Bikini Hai Mảnh Hoa Hồng Trẻ Trung Dễ Thương AT143 MayHomes",231830,239000,7170,3
TIKI,thoi-trang-nu,125939310,"Đồ mặc nhà đồ ngủ nữ vải đũi nhăn mềm có túi cách điệu nút áo xinh xắn size từ 40-70kg",133000,133000,0,0
TIKI,thoi-trang-nu,192459630," Áo phông, áo thun nam nữ form rộng tay lỡ Unisex BÉ GÁI CÔ ĐƠN Từ 50-70kg",49000,49000,0,0
TIKI,thoi-trang-nu,186293039,"Combo 5 - 10 quần lót nữ cao cấp, quần chíp nữ co giãn 4 chiều -TADA",70000,70000,0,0
TIKI,thoi-trang-nu,68419614,"Áo Thun Nữ Màu Trắng Cổ Tròn Lên Dáng Phong Cách Siêu Đẹp",21000,21000,0,0
TIKI,thoi-trang-nu,84471379,"Áo khoác hoodie chống nắng 123SHOP dành cho nam nữ Thuê Trái Tim, Nỉ ngoại form rộng Có Dây Kéo unisex ulzzang",100000,100000,0,0
TIKI,thoi-trang-nu,3579913,"Áo Ngực Triumph Sloggi ZERO WHU - Da (Size",529000,529000,0,0
TIKI,thoi-trang-nu,74439423,"Quần Lót Nữ Lưng Cao Modal Phối Ren Active Miley Lingerie FDS-25",60000,109000,49000,45
TIKI,thoi-trang-nu,98084034,"Áo thun unisex tay lỡ nam nữ form rộng, cổ tròn, oversize, cotton co giãn 4 chiều, họa tiết đa dạng, thoải mái khi mặc hàng ngày",159000,159000,0,0
TIKI,thoi-trang-nu,107393162,"Bộ Đồ Pijama Nữ Mặc Nhà, Quần Áo Ngủ Nữ Ngắn Tay Azuno BN196 Chất Liệu Cotton Lụa Cho Mùa Hè",275000,275000,0,0
TIKI,thoi-trang-nu,118014408,"Đồ Lam Đi Chùa# Một Nút Nơ Phối # Quần Áo Nữ # Đồ Bộ Nữ",186000,186000,0,0
TIKI,thoi-trang-nu,78918979,"Áo Sơ Mi Nữ Đẹp Hàn Quốc Kiểu Công Sở Điệu Họa Tiết Hoa HATI",178000,178000,0,0
TIKI,thoi-trang-nu,62360188,"Quần Jeans Pha Sợi Cà Phê Aaa Jeans Dáng Skinny lưng cao  - UCSD COFFEE",549000,549000,0,0
TIKI,thoi-trang-nu,93100635,"ÁO LÁ HỌC SINH COTTON TĂM 2 LỚP MÚT MỎNG 007",23000,30000,7000,23
TIKI,thoi-trang-nu,4426799,"Quần thun dài nữ jogger Phúc An 3008_den",99000,99000,0,0
TIKI,thoi-trang-nu,108896350,"Quần Tây nữ ống loe chất liệu tuyết mưa sang chảnh",80000,80000,0,0
TIKI,thoi-trang-nu,98604901,"Quần gen bụng/ định hình body lưng vừa chống cuộn, nâng mông, mềm mịn cho nữ LYEQ015",189000,199000,10000,5
TIKI,thoi-trang-nu,109393443,"Đầm body hoa nhí dễ thương-MS08",121000,121000,0,0
TIKI,thoi-trang-nu,89560821,"Áo Khoác bomber summer, ÁO BOMBER NỈ IN CHỮ SUMMER, Áo Khoác Bomber Unisex, áo cardigan bomber phối màu, Áo cardigan nữ , áo cardigan nam , áo khoác cardigan nam nữ mặc vải nỉ ngoại chống nắng chống lạnh tốt",95000,95000,0,0
TIKI,thoi-trang-nu,151425630,"váy trễ vai trắng tay bồng dáng dài, đầm trễ vai tiểu thư dự tiệc màu trắng điệu đà",80000,80000,0,0
TIKI,thoi-trang-nu,248270980,"Đồ đôi đi biển xinh xắn chất thun đẹp- HÀNG LOẠI 1- giá nguyên bộ luôn quần và áo",109000,109000,0,0
TIKI,thoi-trang-nu,182308585,"ĐẦM HOA PHỐI DẬP LY TAY LỒNG ĐÈN - DAM 0019",219000,398000,179000,45
TIKI,thoi-trang-nu,59234719,"Combo 10 Quần Lót Nữ Cotton Thông Hơi Viền Lượn Sóng – Free size 40 - 58kg  - Giao Nhiều Màu Khác Nhau – Tặng 2 kẹp tóc mini xinh xinh",109000,109000,0,0
TIKI,thoi-trang-nu,143306359,"Váy/đầm ngủ 2 dây sexy, ren hoa voan mỏng quyến rũ LYEN003",94000,99000,5000,5
TIKI,thoi-trang-nu,165106956,"Combo 2 quần lót ren nữ sexy cạp thấp, dây hông mảnh đầy gợi cảm ( màu ngẫu nhiên) LYEQ051",81700,86000,4300,5
TIKI,thoi-trang-nu,152646087,"Đầm CS phối hoa sang trọng - DAM002",270000,270000,0,0
TIKI,thoi-trang-nu,155833290,"Hộp 7 cái quần lót nữ thun lạnh iBasic V110",319000,343000,24000,7
TIKI,thoi-trang-nu,187336369,"Đầm suông linen tưng gân sát nách cổ bẻ thêu hoa trẻ trung ArcticHunter, thời trang thương hiệu chính hãng",380000,380000,0,0
TIKI,thoi-trang-nu,195549407,"Đầm xòe phối hoa ngực quyến rũ D025- Lady fashion",198000,390000,192000,49
TIKI,thoi-trang-nu,130867193,"Áo khoác hoodie trơn xanh form rộng/Nam nữ unisex Jaystoree",93000,93000,0,0
TIKI,thoi-trang-nu,121038488,"váy maxi hở lưng, đầm maxi hở lưng đan dây",315000,315000,0,0
TIKI,thoi-trang-nu,14378329,"Set áo hoa cổ yếm và chân váy ôm – MS0456D",420000,420000,0,0
TIKI,thoi-trang-nu,108329137,"Áo Lót Nữ, Combo 2 Áo Lót Đúc Su Đệm Mỏng Phối Ren Siêu Quyến Rũ, Áo Ngực Su Không Gọng Không Đường May Thương Hiệu BAW Mã AN3721",159000,159000,0,0
TIKI,thoi-trang-nu,83033277,"Áo Ngực Quai Trong Đệm Dày Mặc Đầm Hở Lưng Hở Vai",125000,185000,60000,32
TIKI,thoi-trang-nu,169833290,"Áo quây/áo ngực nữ không dây/áo lót quây dây/áo ngực mặc váy cúp ngực nâng ngực, dây lưng mảnh cá tính khoe lưng trần gợi cảm và năng động (kèm quai/dây áo ngực trong) LYEA028",122550,129000,6450,5
TIKI,thoi-trang-nu,108857591,"Váy đầm voan thời trang Hàn Quốc dáng ngắn thắt eo trẻ trung dự tiệc, dạo phố (tay lỡ)",265000,265000,0,0
TIKI,thoi-trang-nu,36574256,"1 Quần tây công sở ống suông rộng, ống đứng, dạng cullotes sang trọng, nữ tính",266000,280000,14000,5
TIKI,thoi-trang-nu,182995569,"Đồ Bơi Hai Mảnh Nữ Tay Dài Quần Dài Họa Tiết Lovely Và Hoa Xinh AT228 MayHomes Long Sleeves And Long Pants Women Swimwear With UPF 50 Sun Protection",289100,295000,5900,2
TIKI,thoi-trang-nu,167597953,"Quần lót nữ cotton đúc su không đường may cao cấp chất liệu thun lạnh mềm mại kháng khuẩn được chọn màu mẫu Q1",35000,35000,0,0
TIKI,thoi-trang-nu,173449599,"Combo 2 quần đùi nữ mặc nhà thoải mái thoáng mát họa tiết ngẫu nhiên JAMANO",99000,140000,41000,29
TIKI,thoi-trang-nu,84119398,"Quần lót giấy mặc 1 lần KACHOO, 5 cái/bịch,thoáng mát, tiện lợi khi đi du lịch hay những ngày ấy",25870,25870,0,0
TIKI,thoi-trang-nu,82704480,"Bộ 5 Quần Lót Ren Sexy quyến rủ thương hiệu BAW, đính nơ xì teen mẫu QLN25",199000,199000,0,0
TIKI,thoi-trang-nu,74168825,"Đồ bộ lụa satin loại 1 SBORG 2 dây cổ đổ",171150,171150,0,0
TIKI,thoi-trang-nu,102743436,"Áo khoác DirtyCoins Print Cardigan, ÁO KHOÁC CARDIGAN BẢN PHỐI TƯƠI TRẺ LẪN HOÀI NIỆM CHO GEN Z, Áo cardigan nữ phong cách hàn quốc xinh xắn, áo khoác thu đông nữ chất liệu gân form rộng, vải đẹp không xù",99000,99000,0,0
TIKI,thoi-trang-nu,66487798,"Đồ lót liền thân sexy Đồ ngủ ren gợi cảm",54600,54600,0,0
TIKI,thoi-trang-nu,113786017,"Áo sơ mi đũi nữ dài tay kẻ sọc trẻ trung S05",150255,159000,8745,6
TIKI,thoi-trang-nu,108431580,"Combo 2 quần lót ren  che mông, lọt khe siêu quyến rũ LYEQ031",74000,78000,4000,5
TIKI,thoi-trang-nu,134231076,"Đồ bơi nữ có đệm mút dài tay liền thân kín đáo chống nắng đi biển thanh lịch",199000,199000,0,0
TIKI,thoi-trang-nu,145575873,"Áo khoác blazer, áo vest nữ kiểu Hàn Quốc tay lỡ, chất vải đẹp, nhiều màu Blz02 - Thời trang công sở WFstudios",361000,361000,0,0
TIKI,thoi-trang-nu,109567589,"Combo 5 Quần Lót Nữ Cotton Lưng Miley Lingerie - FDS1104",282000,475000,193000,41
TIKI,thoi-trang-nu,192650522,"YU CHERRY | Áo Pattern Flying Off Top YA416",390000,390000,0,0
TIKI,thoi-trang-nu,147043717,"váy len suông dài tay bo tay,đầm suông nữ len gân dáng dài thu đông 3 màu cá tính",85000,85000,0,0
TIKI,thoi-trang-nu,55211860,"Đồ Bơi Cặp Đồ Bơi Tay Dài Chống Nắng Kiểu Hàn Quốc AT173 MayHomes Đồ Bơi Nam Nữ",282240,288000,5760,2
TIKI,thoi-trang-nu,87642260,"Áo Lót Mút Mỏng Vừa Phối Ren Habpy Lady By Sabina HBXLP0001",229000,383000,154000,40
TIKI,thoi-trang-nu,75447661,"Đồ Bơi Nữ Tay Dài Quần Dài Nắng Hồng Ôm Thân Gợi Cảm AT204 MayHomes Pink Colored Long Sleeves And Long Pants Women Swimware Set, UPF 50 Sun Protection",391020,399000,7980,2
TIKI,o-to-xe-may-xe-dap,72556311,"Áo Ngực Nữ Không Gọng Cotton Lụa Flexi Miley Lingerie BRC",203000,290000,87000,30
TIKI,o-to-xe-may-xe-dap,121253282,"Áo Lót Nữ, Áo Lót Su Nước Đệm Mỏng Không Gọng Nâng Ngực, Áo Ngực Su Chất Su Mỏng Mát Mịn Thương Hiệu BAW Mã ANN1",159000,159000,0,0
TIKI,o-to-xe-may-xe-dap,87534240,"Bikini dài tay, đồ bơi nữ dáng thể thao dài tay, quần đùi sooc khỏe khoắn",269000,269000,0,0
TIKI,o-to-xe-may-xe-dap,191316591,"Set bộ 3 món vest blazer Linen ve vuông công sở + Quần short + Áo 2 dây trẻ trung ArcticHunter - Trắng",300000,300000,0,0
TIKI,o-to-xe-may-xe-dap,147196959,"Áo Blouse Trắng, Bác Sĩ (Ngắn Tay, Cộc Tay), Nam Nữ, Áo Choàng Phòng Thí Nghiệm -VT0173",144000,144000,0,0
TIKI,o-to-xe-may-xe-dap,174621843,"Áo 2 Dây nữ MADELA Lụa Hàn cao cấp, phong cách Vintage dễ mix đồ, áo có nhiều màu và đủ size để lựa chọn",100000,100000,0,0
TIKI,o-to-xe-may-xe-dap,73528213,"Áo Lót Mút Dày Siêu Nâng Ngực Màu Trơn Basic Doomm Doomm By Sabina SBA7998",359000,579000,220000,38
TIKI,o-to-xe-may-xe-dap,70087428,"Áo Sơ Mi Nữ Trơn Dài Tay Công Sở CV088 Chất Kate Mềm Mịn Chuẩn Form Thời trang nữ cao cấp",138000,138000,0,0
TIKI,o-to-xe-may-xe-dap,167461360,"Đồ bơi bigsize nữ, áo tắm cộc tay cùng quần boxer cho người béo mập, mẫu thể thao khỏe khoắn, chất đẹp phom đẹp | KT110",480000,480000,0,0
TIKI,o-to-xe-may-xe-dap,68939197,"Áo Thu Trắng Đủ Size Cho Mọi Lứa Tuổi",37000,37000,0,0
TIKI,o-to-xe-may-xe-dap,109393443,"Đầm body hoa nhí dễ thương-MS08",121000,121000,0,0
TIKI,o-to-xe-may-xe-dap,113786017,"Áo sơ mi đũi nữ dài tay kẻ sọc trẻ trung S05",150255,159000,8745,6
TIKI,o-to-xe-may-xe-dap,55524590,"Đầm suông chất đũi cổ trụ phối túi bên hông, chất vải mềm mát thích hợp mùa hè, thời trang Hàn Quốc",199000,199000,0,0
TIKI,o-to-xe-may-xe-dap,96990192,"Quần lót lọt khe tua rua chuỗi ngọc sexy",29000,29000,0,0
TIKI,o-to-xe-may-xe-dap,132133729,"Đồ đi biển nam nữ set nguyên bộ gồm áo thun và quần short có thể mặc gia đình hội nhóm hay cặp đôi DDB46 | DONGPHUCSG",99000,99000,0,0
TIKI,o-to-xe-may-xe-dap,186293039,"Combo 5 - 10 quần lót nữ cao cấp, quần chíp nữ co giãn 4 chiều -TADA",70000,70000,0,0
TIKI,o-to-xe-may-xe-dap,261948617,"Áo Bà Ba Màu Trơn_AM1 (Không Quần)",75000,75000,0,0
TIKI,o-to-xe-may-xe-dap,73785311,"Quần lót lọt khe ren + kẹp tất sexy",35000,35000,0,0
TIKI,o-to-xe-may-xe-dap,248270980,"Đồ đôi đi biển xinh xắn chất thun đẹp- HÀNG LOẠI 1- giá nguyên bộ luôn quần và áo",109000,109000,0,0
TIKI,o-to-xe-may-xe-dap,132133780,"Áo gia đình We are 1 Đồng phục gia đình 3/4/5 người giá rẻ Thun cotton dày dặn Màu trắng GD320T",49000,49000,0,0
TIKI,o-to-xe-may-xe-dap,155833290,"Hộp 7 cái quần lót nữ thun lạnh iBasic V110",319000,343000,24000,7
TIKI,o-to-xe-may-xe-dap,134231076,"Đồ bơi nữ có đệm mút dài tay liền thân kín đáo chống nắng đi biển thanh lịch",199000,199000,0,0
TIKI,o-to-xe-may-xe-dap,151425630,"váy trễ vai trắng tay bồng dáng dài, đầm trễ vai tiểu thư dự tiệc màu trắng điệu đà",80000,80000,0,0
TIKI,o-to-xe-may-xe-dap,169307799,"Quần baggy nữ Hiền Trần BOUTIQUE ống đứng, phom dáng Hàn Quốc màu đen xám, đồ công sở đi học",312000,350000,38000,11
TIKI,o-to-xe-may-xe-dap,108926118,"Bộ Đồ Pijama Nữ Mặc Nhà Ngắn Tay Azuno ABN2606 Chất Liệu Cotton Lụa Có Lót Ngực Tiện Lợi Cho Mùa Hè",265000,390000,125000,32
TIKI,o-to-xe-may-xe-dap,93100635,"ÁO LÁ HỌC SINH COTTON TĂM 2 LỚP MÚT MỎNG 007",23000,30000,7000,23
TIKI,o-to-xe-may-xe-dap,74168825,"Đồ bộ lụa satin loại 1 SBORG 2 dây cổ đổ",171150,171150,0,0
TIKI,o-to-xe-may-xe-dap,67279949,"Quần short nữ kiểu mới chất đũi chun",30400,30400,0,0
TIKI,o-to-xe-may-xe-dap,187336369,"Đầm suông linen tưng gân sát nách cổ bẻ thêu hoa trẻ trung ArcticHunter, thời trang thương hiệu chính hãng",380000,380000,0,0
TIKI,o-to-xe-may-xe-dap,181689964,"Áo kiểu cánh dơi nữ Hàn Quốc Thu Hà chất liệu đũi tơ mềm mịn mát thấm mồ hôi, form vừa xinh AKH.46",159000,159000,0,0
TIKI,o-to-xe-may-xe-dap,49905157,"Combo 5 Dây Nối Áo Ngực 3 Móc Co Giãn Tiện Dụng",33000,35000,2000,6
TIKI,o-to-xe-may-xe-dap,116384748,"Áo thun nữ cộc tay phối màu in số 11 phong cách hàn quốc phom rộng",59000,59000,0,0
TIKI,o-to-xe-may-xe-dap,147043717,"váy len suông dài tay bo tay,đầm suông nữ len gân dáng dài thu đông 3 màu cá tính",85000,85000,0,0
TIKI,o-to-xe-may-xe-dap,192912833,"Chân váy nữ bigsize quần váy dancer hai lớp dáng a cạp cao tôn dáng thoải mái xẻ đùi độc đáo che khuyết điểm eo bụng",169000,280000,111000,40
TIKI,o-to-xe-may-xe-dap,36574256,"1 Quần tây công sở ống suông rộng, ống đứng, dạng cullotes sang trọng, nữ tính",266000,280000,14000,5
TIKI,o-to-xe-may-xe-dap,108431580,"Combo 2 quần lót ren  che mông, lọt khe siêu quyến rũ LYEQ031",74000,78000,4000,5
TIKI,o-to-xe-may-xe-dap,162161966,"QUẦN ỐNG RỘNG NỮ BIGSIZE CẠP CAO TÔN DÁNG KÉO DÀI CHÂN MÀU ĐEN TRẮNG NÂU DỄ PHỐI ĐỒ VÀO MÙA XUÂN HÈ THU ĐÔNG QUẦN ÂU DÀI SUÔNG HOT TREND HÀN",175000,300000,125000,42
TIKI,o-to-xe-may-xe-dap,192459630," Áo phông, áo thun nam nữ form rộng tay lỡ Unisex BÉ GÁI CÔ ĐƠN Từ 50-70kg",49000,49000,0,0
TIKI,o-to-xe-may-xe-dap,59234719,"Combo 10 Quần Lót Nữ Cotton Thông Hơi Viền Lượn Sóng – Free size 40 - 58kg  - Giao Nhiều Màu Khác Nhau – Tặng 2 kẹp tóc mini xinh xinh",109000,109000,0,0
TIKI,o-to-xe-may-xe-dap,145575873,"Áo khoác blazer, áo vest nữ kiểu Hàn Quốc tay lỡ, chất vải đẹp, nhiều màu Blz02 - Thời trang công sở WFstudios",361000,361000,0,0
TIKI,o-to-xe-may-xe-dap,127238506,"Thùng rác trên xe ô tô, loại nhỏ gắn cửa xe, gắn ghế sau",75000,75000,0,0
TIKI,o-to-xe-may-xe-dap,49537959,"Bơm hợp kim nhôm loại đạp chân dùng cho xe đạp, xe máy, ô tô, tặng kèm kim bơm banh và bơm thú hơi - Màu giao ngẫu nhiên",99000,99000,0,0
TIKI,o-to-xe-may-xe-dap,125013850,"Combo Nhớt Xe Tay Ga và Nhớt Hộp Số Motul Scooter Power LE 5W40 Và Motul Scooter Gear Oil 120ml",211000,211000,0,0
TIKI,o-to-xe-may-xe-dap,25208495,"Máy bơm lốp ô tô 2 xilanh Air Compressor, Đèn LED, Có hộp đựng, bộ dụng cụ",456220,456220,0,0
TIKI,o-to-xe-may-xe-dap,131402469,"ĐÈN TRỢ SÁNG L4 ngắn 3 chế độ lắp cho xe máy xe đạp điện",79000,79000,0,0
TIKI,o-to-xe-may-xe-dap,32146027,"Máy sạc bình ắc quy 12V 5A FOXSUR 4-100Ah có khử sunfat phục hồi ắc quy",158000,180000,22000,12
TIKI,o-to-xe-may-xe-dap,22293088,"Găng Tay Xe Máy Oakley Có Gù Ngón Cụt - Xanh",65000,65000,0,0
TIKI,o-to-xe-may-xe-dap,1254625,"Chai Xịt Đánh Bóng Nhanh 3M Gloss Enhancer 39034LT (400ml)",152000,170000,18000,11
TIKI,o-to-xe-may-xe-dap,13644131,"Nước hoa sáp thơm kèm đèn led nháy, khử mùi hôi trong xe hơi,ô tô, phòng ngủ, phòng làm việc",36000,36000,0,0
TIKI,o-to-xe-may-xe-dap,131531524,"Bọc yên xe đạp thể thao HT-SPORTS bọc silicone dày êm thoáng khí, có phản quang đi đêm tặng kèm bọc mưa",109000,109000,0,0
TIKI,thoi-trang-nu,67234787,"Áo bra nữ đẹp Áo bra thun gân hở lưng siêu mát, áo bra thun gân",17000,17000,0,0
TIKI,o-to-xe-may-xe-dap,529456,"Xi Đánh Bóng Cana 100G",37000,37000,0,0
TIKI,o-to-xe-may-xe-dap,73364277,"1 Tấm Bạt Đệm Miếng Phủ Trùm Lót Che Yên Xe Máy SIZE LỚN Chống Nóng Nắng Mưa 3 Lớp Cao Cấp",48000,48000,0,0
TIKI,thoi-trang-nu,68961845,"Quần lót nữ ren lọt khe cực sexy nóng bỏng",28000,28000,0,0
TIKI,thoi-trang-nu,99698447,"Áo Ngực Không Gọng Chất Liệu Ren Cao Cấp, Áo Lót Bra Ren Mềm Cao Cấp Không Gọng dây mảnh Thương Hiệu Baw mã NT7",159000,159000,0,0
TIKI,thoi-trang-nu,1921045,"Áo Ngực Triumph Maxi M025 JN-TL - Da (Size",528000,528000,0,0
TIKI,o-to-xe-may-xe-dap,162227264,"Ắc quy khô miễn bảo dưỡng Đồng Nai PTZ5L | 12V - 4Ah",241000,241000,0,0
TIKI,o-to-xe-may-xe-dap,117201628,"Bộ nâng cổ xe đạp thể thao ",150000,150000,0,0
TIKI,o-to-xe-may-xe-dap,34585636,"Cặp Đèn Xinhan Led L14 Gắn Vario , WINNER X và mọi loại xe máy BẢO LONG RACING",55000,55000,0,0
TIKI,o-to-xe-may-xe-dap,107522197,"Bạt Phủ Toàn Xe 3 Lớp Chống Xước, Chống Nắng, Chống Cháy Cho Ô Tô",249999,249999,0,0
TIKI,thoi-trang-nu,148963418,"Áo bra/lót  2 dây phối ren, mút mỏng dùng hàng ngày cho nữ LYEA018",119000,119000,0,0
TIKI,o-to-xe-may-xe-dap,62905859,"Máy Bơm Lốp Ô Tô, Xe Hơi Điện Tử Thông Minh YD787 tích hợp đèn pin",395000,395000,0,0
TIKI,thoi-trang-nu,97819167,"Cosplay Học Sinh Sexy - Đồ Lót Cosplay Học Sinh - Set đồ ngủ cosplay học sinh",124000,124000,0,0
TIKI,thoi-trang-nu,82913283,"Bộ 5 Quần Lót Cotton 15 Màu Siêu Đẹp thương hiệu BAW TN08",199000,199000,0,0
TIKI,thoi-trang-nu,82642292,"Áo Sơ Mi Nữ Dài Tay Công Sở Thời Trang PONIVA",124000,124000,0,0
TIKI,thoi-trang-nu,181247693,"Quần Legging Nữ Dài Cạp Cao Đẹp Cao Cấp PINKAHA Nâng Mông Vải Thun Cotton Siêu Co Giãn 4 Chiều Ôm Sát",150000,150000,0,0
TIKI,thoi-trang-nu,58027810,"Set Đồ Bơi 2 Chi Tiết Form Sport AT190, Thoải Mái Và Tiện Dụng",135590,149000,13410,9
TIKI,thoi-trang-nu,53501916,"Combo 6 Quần Lót Nữ Sớ Gỗ Miley Lingerie FWS (Size",239000,390000,151000,39
TIKI,o-to-xe-may-xe-dap,157150852,"Chuông Xe Đạp Retro Thể Thao Nhỏ Gọn - Làm Bằng Hợp Kim Nhôm - Âm Thanh Vang 90 - 100dB Gắn Tay Lái (Ghi Đông) - Bigbull Retro Phụ Kiện Xe Đạp Chính Hãng",45000,45000,0,0
TIKI,o-to-xe-may-xe-dap,105185009,"Khung biển số xe máy - viền trơn trắng, inox, meca chống nước",35000,35000,0,0
TIKI,o-to-xe-may-xe-dap,169885717,"[Vải Dù Dày Nặng 1kg3]Bạt Phủ - Áo Trùm Xe Máy Cao Cấp Vải Dù 2 Mặt Che Nắng, Mưa Giữ Xe Luôn Như Mới Vừa Tất Cả Loại Xe",135000,135000,0,0
TIKI,o-to-xe-may-xe-dap,82473496,"Bộ gối tựa đầu và dựa lưng cao su non cao cấp siêu đàn hồi",135000,135000,0,0
TIKI,o-to-xe-may-xe-dap,50731632,"Thùng đựng đồ ở giữa dành cho xe Winner 150.",188000,188000,0,0
TIKI,o-to-xe-may-xe-dap,20918089,"Bộ Combo Dưỡng sên Thunder Chain Lube 400ml, Vệ sinh sên MC-40 400ml tặng bàn chải chà sên 3D",112000,112000,0,0
TIKI,thoi-trang-nu,96061253,"Quần Lót Nữ gợi cảm quần chíp nữ đồ lót sexy chất liệu ren thêu cao cấp 1136",32224,33920,1696,5
TIKI,o-to-xe-may-xe-dap,96910002," 2 miếng dán chống bám nước mưa trên kính hậu xe ô tô - hình bầu dục",24000,28700,4700,16
TIKI,o-to-xe-may-xe-dap,172167246,"Nước rửa kính đậm đặc Senfineco Windschield Cleaner 9964",48000,48000,0,0
TIKI,thoi-trang-nu,192934185,"Đồ Bộ Nữ New Design Chất Lụa Satin Mịn  Mặc Mát  Nhiều Màu, Freesize (40 - 65kg) Quần Đùi Áo Hai Dây CB0001",151000,249000,98000,39
TIKI,thoi-trang-nu,89611971,"Áo Chống Nắng Nữ  Atuner MN001 Dáng Ngắn, Thông Hơi, Ngăn Chặn Tia UV- Hàng Chính Hãng",259000,499000,240000,48
TIKI,thoi-trang-nu,180994575,"Bộ đồ bơi nữ 3 mảnh cao cấp QB03 - Đồ bơi nữ sexy gợi cảm - Đồ bơi bikini",169000,260000,91000,35
TIKI,o-to-xe-may-xe-dap,33544494,"Bộ 4 miếng dán chống đọng nước kính hông và gương chiếu hậu ô tô, xe hơi",58400,58400,0,0
TIKI,o-to-xe-may-xe-dap,120562215,"Khóa Xe Máy Caps Lock Khóa Tay Ga Tay Phanh KH78 Shalla Tặng móc khóa hình búa",121109,121109,0,0
TIKI,thoi-trang-nu,88913061," Quần short nữ , quần đùi nữ [Video + ảnh thật] chất liệu vải cao cấp form rộng đẹp",65000,129000,64000,50
TIKI,thoi-trang-nu,120761234,"Áo khoác nữ lót lông",236000,236000,0,0
TIKI,thoi-trang-nu,155791696,"Váy ngủ hai dây nữ, đầm ngủ mặc nhà nữ cổ V dáng chữ A sẻ vạt cách điệu chất vải lanh lụa cotton thoáng mát  mã V0252",159000,159000,0,0
TIKI,thoi-trang-nu,50691251,"Áo Croptop Form Rộng Tay Ngắn Cổ Tim Cá Tính",58000,58000,0,0
TIKI,o-to-xe-may-xe-dap,2788431,"Bọt biển rửa xe ô tô chuyên dụng (Màu ngẫu nhiên)",24000,24000,0,0
TIKI,o-to-xe-may-xe-dap,68480807,"Sáp thơm trang trí táp lô xe hơi, ô tô chạy bằng năng lượng mặt trời mô hình trực thăng",199000,259000,60000,23
TIKI,thoi-trang-nu,34493312,"Đai Định Hình Chân Bị Cong Vòng Kiềng Tùy Chỉnh Cao Cấp AZONE",105000,112000,7000,6
TIKI,o-to-xe-may-xe-dap,3665771,"Dầu bôi trơn chống rỉ sét đa năng 3M 5-W",79000,79000,0,0
TIKI,o-to-xe-may-xe-dap,126960923,"Bao Da Chìa Khóa Honda SH 2021, SH 2022, SH 350i (loại 2 nút bấm) handmade da thật",100000,100000,0,0
TIKI,o-to-xe-may-xe-dap,87393586,"Túi xe đạp cao cấp,túi treo sườn xe đạp chống nước bọc cảm ứng phù hợp với mọi dòng xe - Thương Hiệu KIOTOOL",75000,75000,0,0
TIKI,thoi-trang-nu,116039232,"Đầm suông chữ A 2 hàng khuy ngực trẻ trung ArcticHunter, thời trang thương hiệu chính hãng",199000,199000,0,0
TIKI,thoi-trang-nu,74527032,"Quần Lót Thun Lạnh Viền Ren Comfort Miley Lingerie BMS",41000,72000,31000,43
TIKI,o-to-xe-may-xe-dap,189632921,"Băng Keo 2 Mặt Dán Phụ Kiện Oto Xe Máy - Keo Nano Đỏ Siêu Dính",30000,30000,0,0
TIKI,o-to-xe-may-xe-dap,7982124,"Bộ 4 Tấm Che Nắng Ô Tô",33000,33000,0,0
TIKI,o-to-xe-may-xe-dap,45555276,"Nước Hoa Grasse L'Esterel - Bulgarian Rose Bullsone HQST30 (110ml)",396000,396000,0,0
TIKI,thoi-trang-nu,146228143,"Áo polo nữ ADINO màu vàng phối viền xẻ lai vải cotton co giãn dáng slimfit trẻ trung APN02",139000,278000,139000,50
TIKI,thoi-trang-nu,117032561,"Dây Áo Ngực Trong Suốt Loirechic DT02",20000,20000,0,0
TIKI,o-to-xe-may-xe-dap,4698547,"Bọc chân chống xe máy",5900,5900,0,0
TIKI,o-to-xe-may-xe-dap,142783294,"Đèn Hậu Xe Đạp - Đèn Led Nháy Tín Hiệu Gắn Xe Đạp Giant Xe Đạp Thể Thao MTB Địa Hình Cảnh Báo An Toàn Trong Đêm Với 3 Chế Độ Sáng",61000,61000,0,0
TIKI,thoi-trang-nu,104791485,"Quần lót nữ thái lan 702 – Lưng cao, thun lạnh- Form L",40000,40000,0,0
TIKI,thoi-trang-nu,19761901,"Đồ ngủ nữ sexy tinh tế kiểu áo choàng hoạ tiết hoa mẫu đơn - CDAN39",105000,105000,0,0
TIKI,thoi-trang-nu,109125528,"Combo 2 quần lót ren lọt khe hình bướm cực kì quyến rũ, gợi cảm LYEQ033",74000,78000,4000,5
TIKI,o-to-xe-may-xe-dap,110483410,"Combo 3 Khăn lau xe ô tô Muses (33x70cm) - Màu ngẫu nhiên",78000,78000,0,0
TIKI,thoi-trang-nu,7159565,"Bộ 2 Quần Gen Bụng Sau Sinh Hàn Quốc Làm Eo Thon (Da + Đen) - 5Star",85000,85000,0,0
TIKI,thoi-trang-nu,73238895,"Áo Cardigan Nữ Duyên Dáng ALN040 MayHomes Áo Khoác Kiểu Nhẹ Và Cute",148800,155000,6200,4
TIKI,thoi-trang-nu,46250423," Áo Ngực Nữ Có Gọng Mút Vừa Miley Lingerie Sporty Chic - Da",210000,315000,105000,33
TIKI,thoi-trang-nu,113334161,"váy suông nữ,váy cộc tay cổ đính nơ dáng dài đuôi cá",98000,98000,0,0
TIKI,thoi-trang-nu,45468948," Quần lót nữ lọt khe dây hạt - đỏ",29000,29000,0,0
TIKI,thoi-trang-nu,74421501,"ÁO LÓT NỮ MỎNG CÓ GỌNG CÀI TRƯỚC VIỀN REN",91000,96000,5000,5
TIKI,o-to-xe-may-xe-dap,122437189,"Chân Chống Xe Đạp Thể Thao Kiotool Thay đổi kích thước phù hợp với mọi dòng xe đạp địa hình",65000,65000,0,0
TIKI,thoi-trang-nu,117032496,"Áo Lót Không Gọng Su Đúc Đệm Mỏng Mát Lạnh Loirechic BRDE64",260000,325000,65000,20
TIKI,thoi-trang-nu,76692477,"Áo Lót Cúp Ngực Chống Tuột LOIRECHIC BRQ12",292500,325000,32500,10
TIKI,thoi-trang-nu,137953125,"Đồ Ngủ Nữ Pijama Tay Ngắn Quần Dài Vải Kate Thái Loại 1, Bộ Mặc Nhà Thu Đông HATIBO",140000,140000,0,0
TIKI,thoi-trang-nu,103432350,"Quần ống rộng suông kiểu nhật, mặc mát lạnh trong ngày hè",69000,69000,0,0
TIKI,thoi-trang-nu,84685068,"Bộ 5 Quần Lót Su Phối Ren sexy quyến rũ thương hiệu BAW mã QLN51",199000,199000,0,0
TIKI,o-to-xe-may-xe-dap,44884682,"Gối Tựa Đầu Cao Su Non Cho Mọi Loại Xe Ô tô",120000,120000,0,0
TIKI,thoi-trang-nu,38233264," Quần lót ren lọt khe buộc dây - Đỏ tím",29000,29000,0,0
TIKI,thoi-trang-nu,178787824,"Bikini cho người lớn tuổi, đồ bơi trung niên trang nhã, bộ bơi đi biển đẹp cho các mẹ các bà, quần rời V0062",199000,199000,0,0
TIKI,thoi-trang-nu,14435891,"Chân váy ôm xếp pilly – MS0305CV ( có lớp lót)",99000,99000,0,0
TIKI,thoi-trang-nu,186632606,"ĐẦM VOAN HOA CỔ LỆCH PHỐI VIỀN– M07",199000,390000,191000,49
TIKI,thoi-trang-nu,92387305,"Đồ bộ bigsize - Đồ bộ trung niên - Bộ đồ trung niên mặc nhà bigsize Vicci DGD.02  thiết kế áo cộc quần dài chất liệu đũi cao cấp (dành cho người béo)",139000,299000,160000,54
TIKI,thoi-trang-nu,119104221,"Dây áo ngực trong suốt sợi bún - sợi phở siêu bền",9000,9000,0,0
TIKI,thoi-trang-nu,181991402,"Áo sơ mi nữ Đũi Việt thiết kế cổ V thời trang ALE12",150255,159000,8745,6
TIKI,thoi-trang-nu,4267525,"Combo 2 quần mặc trong váy SU cao cấp",52000,52000,0,0
TIKI,thoi-trang-nu,184518602,"Quần lót nữ lọt khe ren hình con bướm sexy Q405 - Quần lọt khe nữ gợi cảm - Quần chip nữ - Quần lót nữ - Freesize 45kg - 57kg - Đỏ",50000,99000,49000,49
TIKI,thoi-trang-nu,52045769,"Đồ Bơi Tay Dài Liền Thân Kiểu Dáng Thể Thao AT153 MayHomes Thun Co Giãn Tốt, Thiết Kế Một Mảnh, Áo Ngực Rời, Gợi Cảm",199000,246000,47000,19
TIKI,thoi-trang-nu,113543251,"GOTI - ÁO KIỂU GIẤU BỤNG BIGSIZE DẠNG ÁO SƠ MI QUÝ BÀ ĐÍNH NÚT - ÁO KIỂU THỜI TRANG U50-60 CHO NGƯỜI MẬP 3A01",130000,179000,49000,27
TIKI,thoi-trang-nu,186693678,"ĐẦM MAXI OVERSIZE NHÚN TẦNG – M030",259000,420000,161000,38
TIKI,thoi-trang-nu,194406809,"Quần lót nữ mặc váy không đường may bonding iBasic V187",89000,99000,10000,10
TIKI,thoi-trang-nu,67151410,"Áo Sơ Mi Nữ Ngắn Tay Công Sở Phối Viền Màu Đẹp",157000,157000,0,0
TIKI,thoi-trang-nu,53303807,"30 Miếng Dán Nhũ Hoa Dán Ngực Hoa Mai Vải Cotton Mềm Thấm Hút Mồ Hôi ( 15 cặp )",36000,36000,0,0
TIKI,thoi-trang-nu,138749319,"Áo Thun Nữ Cổ Tim Tay ngắn , Trẻ Trung, Mẫu Mới nhất",29000,29000,0,0
TIKI,thoi-trang-nu,103437019,"Quần ống rộng vải đũi siêu Hot chất dày dặn ko bai dão ko xù lông và ko mỏng nha",66000,66000,0,0
TIKI,thoi-trang-nu,104105306,"Áo Khoác Dù 7ZIA Ulzzang Nam Nữ Unisex Form Rộng Bomber Jacket",100000,100000,0,0
TIKI,thoi-trang-nu,114475273,"Áo Ngực Không Dây Dán Silicon",74000,74000,0,0
TIKI,thoi-trang-nu,153037833,"Bộ niềng răng tại nhà | Cho bé từ 6-13 tuổi",165000,165000,0,0
TIKI,thoi-trang-nu,101278726,"Combo 3 BỊCH QUẦN LÓT GIẤY VẢI COTTON Mỗi bịch 6 cái (42-80 Kg )",97440,97440,0,0
TIKI,thoi-trang-nu,177204918,"Bộ Bikini Cô gái gợi cảm",49000,49000,0,0
TIKI,thoi-trang-nu,144236336,"COMBO 5 ÁO LÓT VẢI KHÔNG GỌNG KHÔNG MÚT (SIZE 32-42)",129000,136000,7000,5
TIKI,thoi-trang-nu,104793592,"Áo lót Bra vải cotton Thái Lan vải  B.1134 – Form Cup A, không gọng",65000,65000,0,0
TIKI,thoi-trang-nu,148000166,"quần ống loe nữ cạp cao dáng dài legging, quần tây ống loe nữ ôm vải mềm lưng chun cá tính",82000,82000,0,0
TIKI,thoi-trang-nu,186105036,"Áo 2 Dây New Design Thiết Kế Cổ V Gợi Cảm, Kiểu Áo Nữ Hiện Đại , Vải Lụa Hàn Quốc Trơn, Nhiều Màu, Mịn ,Thoáng Mát  AO0002",123000,199000,76000,38
TIKI,thoi-trang-nu,243258806,"Quần legging ngố nữ,quần legging nữ mặc tôn dáng",66000,66000,0,0
TIKI,thoi-trang-nu,107040848,"Đồ Lam Đi Chùa # La Hán Nam - đồ phật tử",206000,206000,0,0
TIKI,thoi-trang-nu,176200330,"Bộ đồ ngủ mặc nhà nữ áo hai dây quần dài suông rộng chất vải lanh lụa cotton thoáng mát mã VABD0123",149500,149500,0,0
TIKI,thoi-trang-nu,116574971,"Quần sooc nữ,quần đùi nữ ống rộng chun lưng khóa trước chất kaki nhiều màu",65000,65000,0,0
TIKI,thoi-trang-nu,33787385,"Quần Legging dáng dài 4 túi giả bò",69000,199000,130000,65
TIKI,thoi-trang-nu,20443808,"Áo thun UNISEX nữ chữ kiểu",21000,24000,3000,0
TIKI,thoi-trang-nu,178071097,"2 Cặp Miếng Dán Ngực Miley Lingerie",39000,100000,61000,61
TIKI,thoi-trang-nu,84552947,"Bộ Đồ Lót (Gồm Quần + Áo Đúc Su Trơn) Cài Trước Không Gọng mẫu mới dây lưới cao cấp thương hiệu BAW mã AN26",199000,199000,0,0
TIKI,thoi-trang-nu,47420560,"Váy Ngủ Sexy Gợi Cảm Voan Mỏng Trong Suốt",123500,123500,0,0
TIKI,thoi-trang-nu,85902335,"Quần Lót Mềm Giấu Đường May Phối Ren Cho Nữ - Quần lót xẻ dáy sexy - quần lót lọt khe C53",34320,34320,0,0
TIKI,thoi-trang-nu,129408208,"Combo 10 Quần Lót Su Đúc Thông Hơi Không Đường May - Quần Lót Su Ép Lạnh Hàng Loại 1",72000,72000,0,0
TIKI,thoi-trang-nu,73386136,"Áo sơ mi nữ cổ trụ tay bồng vai bồng ArcticHunter, chất vải thô mềm mát, thời trang thương hiệu chính hãng",159000,159000,0,0
TIKI,thoi-trang-nu,163907297,"(NỮ) SCRUBS QUẦN ÁO BÁC SĨ, ĐIỀU DƯỠNG, KỸ THUẬT VIÊN, ĐỒ PHẪU THUẬT, ĐỒ CHỐNG DỊCH, QUẦN ÁO PHÒNG MỔ, SPA, LÂM SÀNG",185000,185000,0,0
TIKI,thoi-trang-nu,68197574,"Áo croptop dài tay phối khuy cá tính",50000,50000,0,0
TIKI,thoi-trang-nu,14436071,"Áo sơ mi caro phối năng động – MS0059A",175000,175000,0,0
TIKI,thoi-trang-nu,76045124,"Chân váy vải mềm mại dễ thương free size VAY19",185000,185000,0,0
TIKI,thoi-trang-nu,122483987,"Đầm Hàn Quốc xuất khẩu cao cấp Bigsize May 10 mã 050221353XKT",156000,156000,0,0
TIKI,thoi-trang-nu,105278580,"Set/Bộ đồ lót ren cúp tam giác, không gọng, khóa cài trước LYEB020",140000,140000,0,0
TIKI,thoi-trang-nu,141087603,"Áo giữ nhiệt nữ thu đông cổ lọ vải cotton co giãn nhiều màu cá tính",28000,28000,0,0
TIKI,thoi-trang-nu,55524516,"Combo 10 Quần Lót Nữ Cotton Thái Phom To - Họa Tiết Trơn - Mềm Mịn - Co Giãn Tốt - Nhiều Màu - Freesize 48-65kg - Tặng kèm set 10 thun cột tóc trẻ trung",102000,102000,0,0
TIKI,thoi-trang-nu,121327541,"Quần lót nữ thun lạnh iBasic PANW130",45000,49000,4000,8
TIKI,thoi-trang-nu,77029858,"Đầm suông linen tay lỡ kèm đai rời túi sườn ArcticHunter, thời trang trẻ, phong cách Hàn - Trắng",250000,250000,0,0
TIKI,thoi-trang-nu,74864797,"Áo Lót Nữ Không Gọng Nâng ngực nhẹ LOIRECHIC BRFC02 Kẻ Caro",139000,189000,50000,26
TIKI,thoi-trang-nu,174638530,"Bộ đồ ngủ mặc nhà nữ áo hai dây quần dài suông rộng chất vải lanh lụa cotton thoáng mát, đồ bộ lanh nữ mã BD0123",159000,159000,0,0
TIKI,thoi-trang-nu,111043184,"Quần Lót Nữ, Bộ 5 Quần Lót Ren Nữ Cao Cấp Mềm Mịn Hàng Thương Gia, Quần Lót Nữ Kháng Khuẩn, Quần Lót Nữ Co Giãn Tốt Thương Hiệu Baw Mã QLN8813",199000,199000,0,0
TIKI,thoi-trang-nu,146362137,"CHÂN VÁY CÔNG SỞ DÁNG DÀI XẺ TRƯỚC [ SIÊU HOT ] ĐIỀU CHỈNH THEO THÔNG SỐ NGƯỜI MẶC , CHE KHUYẾT ĐIỂM , TÔN DÁNG",167000,320000,153000,48
TIKI,thoi-trang-nu,25975275,"Áo khoác da cá GOKING 6 túi, form unisex cho nữ nam, trẻ em. Chống lạnh, giữ ấm, chống nắng, chống tia UV. Hàng hiệu vnxk",281000,281000,0,0
TIKI,thoi-trang-nu,129956281,"Áo thun nữ ngắn tay cổ tròn kiểu trơn vải tăm thời trang Hàn Quốc",78000,78000,0,0
TIKI,thoi-trang-nu,55023696,"Đồ Bơi Nữ Hai Mảnh Form Xinh Họa Tiết Chessboard AT178 MayHomes",144690,159000,14310,9
TIKI,thoi-trang-nu,103359268,"Quần lọt khe nữ – Quần lọt khe ren sexy C10 - Quần chíp ren sexy - Quần lót lọt khe nữ sexy - Quần lót nữ lọt khe xẻ dáy",30000,30000,0,0
TIKI,thoi-trang-nu,137666729,"Áo Sơ Mi Nhung Gân Mặt Cười Form Rộng Unisex Nam Nữ Phong Cách Hàn Quốc Ulzzang",136000,136000,0,0
TIKI,thoi-trang-nu,147960965,"Quần Lót Nữ Tam Giác Cao Cấp. Lưng Thấp Siêu Gợi Cảm. Quần Lót Nữ Sexy",55000,55000,0,0
TIKI,thoi-trang-nu,160796434,"Combo 2 Quần Lót Lọt Khe Phối Ren Hở Đáy Đính Hạt Ngọc Trai Gợi Cảm Cho Nữ (màu ngẫu nhiên) LYEQ059",64600,68000,3400,5
TIKI,thoi-trang-nu,150114365,"Áo Croptop DOGA In Họa Tiết chữ AB Nhiều Mầu",79000,79000,0,0
TIKI,thoi-trang-nu,45869915,"Áo thun nam nữ form rộng tay lỡ Unisex No Freesize dưới 69kg",28000,28000,0,0
TIKI,thoi-trang-nu,143861102,"Quần lót nữ thun lạnh iBasic V199-3",54000,69000,15000,22
TIKI,thoi-trang-nu,106874190,"Quần Lót Nữ, Quần Gen Nịt Bụng Eo Thon, Quần Ghen Cạp Cao Giảm Eo Và Mỡ Bụng Sau Sinh QG21",129000,129000,0,0
TIKI,thoi-trang-nu,36577792,"Corset inside - Áo lót mặc trong gen nịt bụng",65000,65000,0,0
TIKI,thoi-trang-nu,83857402,"áo khoác hoodie cặp đôi, combo 2 cái, Áo khoác hoodie Chống Rét Cho Nam nữ Cho Cặp Đôi in hình WIND Chất Nỉ Unisex Form rộng Có 4 Màu Ulzzang, Áo Khoác hoodie FTITOH Họa Tiết Hoạt Hình Unisex",185000,185000,0,0
TIKI,thoi-trang-nu,165205422,"Quần Lót Nữ, Quần Gen Nịt Bụng Eo Thon, Quần Ghen Chống Cuộn Cạp Cao Giảm Eo Và Mỡ Bụng Sau Sinh QG6",129000,129000,0,0
TIKI,thoi-trang-nu,84551050,"Áo Lót Bra Ren không dây siêu hot thương hiệu BAW mã AN23",89000,159000,70000,44
TIKI,thoi-trang-nu,145290025,"Chân Váy Công Sở New Design Thiết Kế Dáng Váy chữ A, Dài Qua Gối , Tôn Dáng Sang Trọng, Vải Tốt co Giãn CV0053",179000,333000,154000,46
TIKI,thoi-trang-nu,169191209,"Combo 2 quần lót xuyên thấu, quần lót nữ, quần lọt khe nữ cột dây hở đáy sexy và hư hỏng ( màu ngẫu nhiên) LYEQ047 ",84550,89000,4450,5
TIKI,thoi-trang-nu,11276123,"Đầm suông kẻ sọc cổ Tàu 2 túi bên - DS97",245000,245000,0,0
TIKI,thoi-trang-nu,98599085,"Quần gen bụng/ định hình body lưng cao chống cuộn, nâng mông, mềm mịn cho nữ LYEQ-015",227000,239000,12000,5
TIKI,thoi-trang-nu,112193938,"áo sơ mi nữ dài tay vạt tôm chất đũi nhiều màu",89000,89000,0,0
TIKI,thoi-trang-nu,26165644,"Áo sơ mi công sở kiểu áo sơ mi đơn giản tay lỡ cổ V GOTI 3084",219000,219000,0,0
TIKI,thoi-trang-nu,91249750,"Áo khoác hoodie basic nam nữ SmileZ dáng unisex form rộng chất nỉ bông chống nắng tốt",39000,39000,0,0
TIKI,thoi-trang-nu,79606998,"Áo hoodie nữ hình KHỦNG LONG BẮN TIM đáng yêu freesize chất liệu nỉ TiC083",79000,79000,0,0
TIKI,thoi-trang-nu,107035770,"Bộ Đi Lễ Chùa - Đồ Lam Nữ Đi Chùa Đẹp Cao Cấp Trang Nhã Trang Phục Truyền Thống 2021 Dành Cho Phật Tử - AL009",228000,228000,0,0
TIKI,thoi-trang-nu,128276501,"Quần kaki nam nữ chất đẹp, co giãn",189000,189000,0,0
TIKI,thoi-trang-nu,167951497,"Đồ ngủ bigsize/ Đồ ngủ gợi cảm sexy có mút ngực cột dây sau lưng mã 3",61000,61000,0,0
TIKI,thoi-trang-nu,176784406,"Đồ Bơi Hai Mảnh Nữ Kiểu Dáng Sport Đa Năng ATO43 MayHomes Two-Piece Swimwear",148500,165000,16500,10
TIKI,thoi-trang-nu,43996362,"Sét 4 quần lót nữ ren thêu hoa",99000,99000,0,0
TIKI,thoi-trang-nu,83604167,"Đồ Bơi Nữ Hai Mảnh Áo Bơi Tay Ngắn Quần Bơi Kiểu Váy AT211 MAYBLUE Tiện Lợi Và Kín Đáo",170050,179000,8950,5
TIKI,thoi-trang-nu,70818334,"Áo thun nữ form rộng, tay lỡ, cổ tròn, dáng suông in họa tiết cá tính màu đen M92",128000,128000,0,0
TIKI,thoi-trang-nu,73244551,"Áo Ngực Đệm Dày Chữ U Mặc Đầm Hở Lưng LOIRECHIC BRL04",260000,325000,65000,20
TIKI,thoi-trang-nu,170154797,"Áo Bơi Nữ Tay Dài - Sea Foam Sobie",365500,430000,64500,15
TIKI,thoi-trang-nu,73521773," QUẦN JEAN DÀI ỐNG RỘNG LƯNG CAO XÁM ĐEN TRƠN BASIC - QUẦN BÒ NỮ CULOTTES SUÔNG 60 - S<45Kg",144000,144000,0,0
TIKI,thoi-trang-nu,131419223,"áo kiểu nữ chất đũi - hàng VNXK (A17)",142000,142000,0,0
TIKI,thoi-trang-nu,145290013,"Chân Váy Công Sở  New Design Thiết Kế 2 Tầng Váy Xòe Tôn Dáng Midi Che Khuyết Điểm, Vải Tốt Màu Đen Co Giãn Mặc Mát",179000,328000,149000,45
TIKI,thoi-trang-nu,134020411,"Set Váy Ngủ Ren Áo Choàng Ngủ Sexy 3 Chi Tiết",199000,398000,199000,50
TIKI,thoi-trang-nu,54345259,"Quần thể dục nam nữ học sinh dài ba sọc trắng",64000,64000,0,0
TIKI,thoi-trang-nu,118126502,"Bộ đồ lửng thun lạnh trung niên nữ cao cấp_ bộ đồ nữ mặc nhà",158000,158000,0,0
TIKI,thoi-trang-nu,185591424,"Đầm suông linen dáng yếm nơ lưng vạt tròn trẻ trung ArctcicHunter, thời trang thương hiệu chính hãng",260000,260000,0,0
TIKI,thoi-trang-nu,69932425,"Quần jogger kaki nữ line to, phản quang khi chụp flash, kèm hình thật",89000,89000,0,0
TIKI,thoi-trang-nu,78283255,"Đầm suông linen tay lỡ basic sang trọng, thời trang xuân hè 2021",220000,220000,0,0
TIKI,thoi-trang-nu,142322427,"Quần Lót Đùi Nữ Su Đúc Mặc Trong Váy - Không Đường May. Không Lộ Viền. Nhiều size từ 40 - 70kg",32000,32000,0,0
TIKI,thoi-trang-nu,112506256,"Đầm suôn chữ A phối hoa Xanh dễ tươi trẻ-MS027",250000,250000,0,0
TIKI,thoi-trang-nu,192725467,"Áo Quây Ngực CCHAT Không Đệm Thun Trơn Croptop Dáng Ôm Cao Cấp Phong Cách Trẻ Trung 22ZQC2001OT",189000,189000,0,0
TIKI,thoi-trang-nu,25766384,"Áo khoác vest nữ caro phong cách Hàn Quốc NA66",368000,368000,0,0
TIKI,thoi-trang-nu,87616279,"Áo Lót Không Gọng Mút Dày Siêu Nâng Ngực Màu Trơn Habpy Lady By Sabina HBXLP0005",229000,383000,154000,40
TIKI,thoi-trang-nu,185005658,"Áo lá học sinh cấp 1 cấp 2 cao cấp áo ngực trẻ em tuổi mới lớn dậy thì chất cotton mềm mại thoáng mát Lá Bralette A23",38000,38000,0,0
TIKI,thoi-trang-nu,67556616,"Hộp 60 miếng dán ti giấy",57000,57000,0,0
TIKI,thoi-trang-nu,185006832,"Áo bra nữ học sinh cấp 2 cấp 3 chất cotton trơn cao cấp mềm mại thoáng mát kiểu dáng thể thao Lá Bralette A24 áo ngực học sinh",49000,89000,40000,45
TIKI,thoi-trang-nu,99664264," Hộp 10 Miếng Dán Ngực Silicon Miếng Dán Ti Tàng Hình",27999,27999,0,0
TIKI,thoi-trang-nu,196184595,"Bộ Quần Áo Blouse CỘC TAY, Dáng Dài Ngang Mông NAM NỮ Cho Điều Dưỡng, Y tá ,Dược Sĩ, Vải Lon Nhật Và Thô Cotton (Giá Sỉ)",99000,99000,0,0
TIKI,thoi-trang-nu,97930097,"Đồ bộ đi biển. đồng phục gia đình. mẫu bông dừa",58000,58000,0,0
TIKI,thoi-trang-nu,83489669,"COMBO 2 QUẦN LÓT REN NƠ XUYÊN THẤU SEXY ( màu ngẫu nhiên) LYEQ008",58000,58000,0,0
TIKI,thoi-trang-nu,74532262,"Combo 3 Quần Lót Nữ Bikini Melange Active Miley Lingerie - Vàng, Da và Trắng Kem FCB0300-0900-1400",179000,285000,106000,37
TIKI,thoi-trang-nu,182479802,"Quần nữ ống rộng, dài, chất liệu Đũi mát, vải mềm mịn, form rộng, thoải mái, phong cách trẻ trung QKH.51",133000,259000,126000,49
TIKI,thoi-trang-nu,142717766,"Áo khoác hoodie chống nắng dành cho nam nữ Thêu Trái Tim, Nỉ ngoại form rộng Có Dây Kéo unisex ulzzang",97000,97000,0,0
TIKI,thoi-trang-nu,24031994,"Combo 5 quần lót nữ basic Comfort Modal MILEY LINGERIE - Màu sắc ngẫu nhiên",179000,395000,216000,55
TIKI,thoi-trang-nu,138479370,"Quần Giảm Mỡ bụng tráng bạc NaNo, Quần Tan Mỡ ĐÙI",29000,29000,0,0
TIKI,thoi-trang-nu,116407392,"váy suông nữ, đầm suông cộc tay in chữ cest chic phom rộng 4 màu",75000,75000,0,0
TIKI,thoi-trang-nu,117694143,"Quần đùi nữ ống rộng Eva design , quần short nữ lưng cao mặc nhà có bigsize",115000,210000,95000,45
TIKI,thoi-trang-nu,84077317,"Đồ bơi áo tắm cho người trung tuổi, dáng váy quần sooc đùi dài, tôn dáng tránh lộ bụng, bikini trung niên cho mẹ cho bà size lớn | KT007",350000,350000,0,0
TIKI,thoi-trang-nu,16171715,"Áo Ngực Thể Thao Seamless, Áo Ngực Tập Yoga Thời Trang Cao Cấp, Cá Tính, Co Giãn Tốt, Ôm Gọn Vòng 1 Khi Vận Động Ibasic IBX019 - Hàng Chính Hãng",169000,199000,30000,15
TIKI,thoi-trang-nu,128523060,"Quần áo dài nữ ống suông chất liệu lụa mỹ cao cấp",100000,100000,0,0
TIKI,thoi-trang-nu,147016979,"Quần mặc áo dài",55000,55000,0,0
TIKI,thoi-trang-nu,52241970,"Miếng dán ngực silicon loại dày nâng ngực",85000,85000,0,0
TIKI,thoi-trang-nu,160897585,"Áo kiểu nữ form rộng fullsize M đến 2XL, áo đũi nữ thêu hoa họa tiết dễ mix đồ Haint Boutique ALe17",151050,159000,7950,5
TIKI,thoi-trang-nu,7618209,"Áo Sơ Mi Nữ Alyssa 2 In 1 MS0073A",150000,150000,0,0
TIKI,thoi-trang-nu,170487504,"Quần legging nữ Hiền Trần BOUTIQUE nâng mông lưng cạp cao vải thun dày dặn đùi ngố lửng ôm body bó mặc nhà tập gym yoga",151000,170000,19000,11
TIKI,thoi-trang-nu,180923786,"Bộ đồ mặc nhà nữ lanh (tole) Vicci BN181 thiết kế áo tay ngắn nhún bèo cách điệu phối quần lửng in họa tiết",155000,269000,114000,42
TIKI,thoi-trang-nu,104792356,"Quần lót nữ thái lan  5134  – big size, Chất cotton mềm mại",33000,33000,0,0
TIKI,thoi-trang-nu,106685195,"Áo dài trắng học sinh 2 tà lụa nhật / áo dài nữ sinh / áo dài truyền thống",180000,180000,0,0
TIKI,thoi-trang-nu,172693435,"Váy ngủ nữ, váy 2 dây lụa mềm quyến rũ VILADY - V123 màu đen huyền bí, thiết kế siêu sang, chất liệu lụa Pháp ( lụa latin) cao cấp",289000,400000,111000,28
TIKI,thoi-trang-nu,111695417,"Áo sơ mi nữ dài tay vạt tôm chất đũi nhẹ, thoáng mát nhiều màu",95000,95000,0,0
TIKI,thoi-trang-nu,152494664,"Áo thun Teeworld Saigonese Cô Ba Version 2 Form Rộng Nam Nữ Unisex",299000,299000,0,0
TIKI,thoi-trang-nu,109190543,"Đầm suông linen tay lỡ cổ đức túi sườn ArcticHunter, chất vải linen mềm mát, thời trang thương hiệu chính hãng",259000,259000,0,0
TIKI,thoi-trang-nu,84551549,"Áo Lót Bra Lụa Bóng 8 nấc cài nâng ngực siêu sexy thương hiệu BAW mã AN24",99000,99000,0,0
TIKI,thoi-trang-nu,69050999,"ÁO THUN NỮ TRƠN ÔM BODY CỔ TRÒN NGẮN TAY",60000,60000,0,0
TIKI,o-to-xe-may-xe-dap,173691197,"Combo Che Pô Xe WINNER V1 + Đít pô / Đuôi pô",80000,80000,0,0
TIKI,thoi-trang-nu,69175339,"Quần short kaki nữ GOKING, lưng thun và dây rút co giãn thoải mái. Túi sâu rộng bỏ điện thoại",185000,185000,0,0
TIKI,o-to-xe-may-xe-dap,54902025,"Mũ Bảo Hiểm Xe Đạp Thời Trang, Nón Bảo Hiểm Xe Đạp Thể Thao Cao Cấp Protec Win 037 Thiết Kế Thông Minh, An Toàn, Siêu Nhẹ - Hàng Chính Hãng",498000,498000,0,0
TIKI,thoi-trang-nu,77123173,"Combo 2 Quần Lót Nữ Không Đường May Phối Ren Mềm Mịn Quyến Rũ ( màu ngẫu nhiên) LYEQ006",98000,98000,0,0
TIKI,o-to-xe-may-xe-dap,8090579,"Nước Rửa Kính FOCAR Screen Wash 2.75L",97000,119000,22000,18
TIKI,o-to-xe-may-xe-dap,68479904,"Combo nhớt xe tay ga cao cấp Repsol Scooter 10W40 800ml tặng nhớt hộp số Repsol Gear Oil 120ml",199000,199000,0,0
TIKI,o-to-xe-may-xe-dap,95071251,"Kẹp Gắn Đèn Pin ML10 Xe Đạp Gắn Ghi Đông Tay Lái Xoay 360 Độ Chắc Chắn Mai Lee (không kèm đèn pin)",56050,59000,2950,5
TIKI,o-to-xe-may-xe-dap,67632864,"Màn rèm che nắng hít nam châm dán cửa ô tô xe hơi, rèm vải dầy 2 lớp cản sáng mẫu hoạt hình dễ thương - Hàng chính hãng",128000,128000,0,0
TIKI,thoi-trang-nu,165205923,"Quần Ghen Định Hình, Quần Ghen Nữ Su Lạnh Cạp Cao Có Chiết Eo Chống Cuộn Siêu Giảm Eo Thương Hiệu Baw QG07",189000,189000,0,0
TIKI,o-to-xe-may-xe-dap,20845674,"Khóa dây Master Lock 8143",125000,125000,0,0
TIKI,o-to-xe-may-xe-dap,884776,"Nón Bảo Hiểm Lưỡi Trai 1/2 Đầu Tem V2 Xanh Lá Napoli N077-V2XL-LT",299000,299000,0,0
TIKI,o-to-xe-may-xe-dap,32135232,"Sạc bình ắc quy 12V 2A tự ngắt khi đầy 4-20Ah (Đen)",59000,59000,0,0
TIKI,o-to-xe-may-xe-dap,55981934,"Hộp Đựng Khăn Giấy Da Cao Cấp Trên Xe Ô Tô",179000,179000,0,0
TIKI,thoi-trang-nu,103357147,"Quần lọt khe nữ – Quần lọt khe ren sexy C23 - Quần chíp ren sexy - Quần lót lọt khe nữ sexy - Quần lót nữ lọt khe xẻ dáy",21000,21000,0,0
TIKI,o-to-xe-may-xe-dap,53706056,"Ổ Khóa 8 Cạnh Dành Cho Xe Dream 50cc 100cc Các Đời (Bộ Có Khóa Yên)",137000,159000,22000,14
TIKI,thoi-trang-nu,141260416,"váy suông nữ,đầm suông nữ cổ V dáng dài xẻ tà 3 màu siêu xinh",89000,89000,0,0
TIKI,thoi-trang-nu,171123754,"Set đồ nữ bao gồm áo khoác vest 1 lớp nữ ngắn dáng croptop và quần short lưng chun ống rộng thoải mái form cực đẹp cá tính sang chảnh đi chơi dạo phố vào mùa hè màu đen chất tuyết mưa cao cấp",149000,200000,51000,26
TIKI,o-to-xe-may-xe-dap,24792574,"Găng Tay Xe Máy Oakley Dài Ngón",92000,92000,0,0
TIKI,o-to-xe-may-xe-dap,22670599,"Đèn led xe đạp chống nước- Hati1",28000,28000,0,0
TIKI,thoi-trang-nu,59470004,"Quần Đùi Lót Nữ Mặc Trong Chân Váy Dài 32cm Miley Lingerie - Màu Đen FDS0116",59000,74000,15000,20
TIKI,thoi-trang-nu,85705352,"Choàng Chống Nắng Nữ Cotton Laroma| UPF50+ | Vải Thơm | Làm Mát | Thời Trang | Đa Dụng",499000,899000,400000,44
TIKI,thoi-trang-nu,82704404,"Bộ 5 Quần Lót Nữ Cotton tăm tre đính nơ gân 2 mặt siêu thấm hút mồ hôi thương hiệu BAW QLN20",139000,139000,0,0
TIKI,o-to-xe-may-xe-dap,59355732,"Máy lọc không khí thông minh dùng trên xe hơi FujiE AP100",871000,1700000,829000,49
TIKI,thoi-trang-nu,90070163,"Áo khoác nhung nữ , áo khoác nữ kiểu croptop vải nhung túi hộp , hàng chuẩn shop",165000,165000,0,0
TIKI,thoi-trang-nu,157827091,"Quần bò ống rộng nữ cạp cao, quần jeans ống rộng lưng cao, dáng suông baggy ống đứng, kiểu ulzzang Cherry T008",120000,120000,0,0
TIKI,thoi-trang-nu,193099510,"Áo khoác vest nữ cổ lụa ngắn tay lỡ, blazer nữ công sở form suông thiết kế trẻ trung chất tuyết mưa màu đen trắng xanh dễ phối đồ đi chơi dạo phố sự kiện tiệc cưới lễ hội",400000,400000,0,0
TIKI,o-to-xe-may-xe-dap,20006398,"Chong chóng doremon gắn mũ bảo hiểm siêu cute",10000,10000,0,0
TIKI,thoi-trang-nu,111749144,"quần giả váy",79000,79000,0,0
TIKI,o-to-xe-may-xe-dap,22477937,"Bộ Chia tẩu sạc, Adapter Sạc Huyndai HY - I0 Cao cấp",115000,115000,0,0
TIKI,o-to-xe-may-xe-dap,114695617,"Thùng đựng đồ ô tô - gấp gọn đa năng 56 lít cao cấp",280000,280000,0,0
TIKI,thoi-trang-nu,93828649," Áo Khoác Bomber Nỉ 199 Chất Nỉ Bông Mịn Đẹp Form rộng Unisex Nam Nữ Couple",93000,93000,0,0
TIKI,o-to-xe-may-xe-dap,10784564,"Đồng hồ đo áp suất lốp ô tô xe máy điện tử R6802",88000,88000,0,0
TIKI,o-to-xe-may-xe-dap,58407886,"Bộ Chuyển Nguồn 12V ra 220V Dùng Trên Ô Tô Công Suất 150W với 2 Cổng Sạc USB 1A và 2.1A AnZ",459000,459000,0,0
TIKI,thoi-trang-nu,102504815,"Quần Jean Nữ, Quần Jean Nữ Lưng Cao, Quần Jean Nữ Siêu Hack Dáng thương hiệu Chandi, Jean Nữ co dãn tôn dáng phụ nữ eo thon mẫu KVK11",171000,299000,128000,43
TIKI,o-to-xe-may-xe-dap,55193006,"Mũ bảo hiểm 3/4 Bulldog POM",1099000,1099000,0,0
TIKI,o-to-xe-may-xe-dap,2220389,"Ghế ngồi oto cho bé, ghế giữ bé trên ô tô, ghế ngồi ô tô màu ngẫu nhiên",128000,135000,7000,5
TIKI,o-to-xe-may-xe-dap,57647330,"Kính chiếu hậu TRÒN xe tay ga kiểu ves-pa - 1 bên trái ",99000,99000,0,0
TIKI,o-to-xe-may-xe-dap,114685134,"Màn hình hắt kính HUD M8 hiển thị tốc độ và cảnh báo ô tô xe hơi cắm cổng OBD2",430000,430000,0,0
TIKI,thoi-trang-nu,90890885," Đầm Ôm Body Cổ Lọ Tay Dài - Đầm Thun Gân Xịn [ ẢNH THẬT 100",118000,118000,0,0
TIKI,o-to-xe-may-xe-dap,125644043,"Nhớt Xe Máy Động Cơ 4 Thì Motul 300V Factory Line 10W40 Có Chiết Lẻ Nhập Pháp Tem 3 Lớp Chạy Bốc",450000,450000,0,0
TIKI,thoi-trang-nu,117573855,"set đồ nữ chất đũi,bộ đồ nữ hè áo yếm quần đùi chât đũi xinh xắn",99000,99000,0,0
TIKI,o-to-xe-may-xe-dap,21921069,"Khóa đĩa có báo động chống trộm Alarm Disc Lock NC303",213000,213000,0,0
TIKI,o-to-xe-may-xe-dap,97763540,"Bạt phủ che nóc xe ô tô, xe hơi, 3 lớp tráng nhôm cách nhiệt, chống nắng, chống xước, chống cháy",189999,189999,0,0
TIKI,thoi-trang-nu,28700363,"Áo sơ mi nữ cổng sở kiểu áo cột nơ cổ chữ v tay lật GOTI 3091",229000,229000,0,0
TIKI,o-to-xe-may-xe-dap,50386528,"Bộ 2 phụ gia xăng 33017 và nhớt 33027 cao cấp cho xe máy Bluechem - 33017_33027",149000,149000,0,0
TIKI,o-to-xe-may-xe-dap,75622991,"Bút xóa vết trầy xước sơn ô tô xe máy",17000,17000,0,0
TIKI,thoi-trang-nu,169881065,"Set bộ sát nách linen trẻ trung áo dáng yếm nút xẻ sau ArcticHunter, thời trang thương hiệu chính hãng",289000,289000,0,0
TIKI,o-to-xe-may-xe-dap,51697825,"Lọ Xịt Khử Mùi Nội Thất Ô Tô Hương Cà Phê Hàn Quốc",63000,63000,0,0
TIKI,thoi-trang-nu,140458206,"Áo khoác nữ form rộng hoodie có mũ trơn tay bồng có khóa kéo phong cách Hàn Quốc Áo khoác nữ mùa đông YiiL K01",114000,114000,0,0
TIKI,o-to-xe-may-xe-dap,74912599,"Megacools Ultra Lube MOLY WAX 300ml - Xịt bảo dưỡng sên siêu cao cấp, chống vắng, chống rít,chống kêu sên",80000,80000,0,0
TIKI,thoi-trang-nu,121400723,"Quần lót nữ, combo 10 quần lót thun lạnh phối ren",170000,170000,0,0
TIKI,thoi-trang-nu,167598461,"Quần Đùi Mặc Trong Váy Gen Bụng Xuất Nhật MUNAFIE Quần Lót Nữ Đẹp Pinkaha",85000,85000,0,0
TIKI,o-to-xe-may-xe-dap,20146496,"Găng tay xe máy, xe đạp có đệm bảo vệ tay Xanh Trắng",99000,99000,0,0
TIKI,o-to-xe-may-xe-dap,87457129,"Giá Treo Bình Nước Xe Đạp Có Điều Chỉnh Tiện Lợi Cho Xe Đạp Thể Thao, MTB (Không kèm ốc vít) MaiLee",49000,59000,10000,17
TIKI,o-to-xe-may-xe-dap,141582530,"Máy hút bụi cao cấp cho ô tô nguồn 12v Michelin ML204 - độ ồn thấp, máy gọn nhẹ, nhiều đầu hút, công xuất cao",759050,799000,39950,5
TIKI,thoi-trang-nu,180102611,"Đầm suông trung niên, đầm linen dáng suông ĐŨI VIỆT thời trang thương hiệu chính hãng D60",235305,249000,13695,6
TIKI,o-to-xe-may-xe-dap,4136669,"Túi đựng đồ treo sau ghế xe ô tô",215000,215000,0,0
TIKI,o-to-xe-may-xe-dap,115935630,"Bộ 2 Ty Gác Chân Sau Xe Đạp Chất Liệu Nhôm (đường kính lỗ 1cm) cho xe đạp MTB, xe địa hình chống trượt, chắc chắn Mai Lee",64000,79000,15000,19
TIKI,thoi-trang-nu,38840285,"Combo 10 quần lót tàng hình trộn màu sexy cho phái nữ",185000,185000,0,0
TIKI,o-to-xe-may-xe-dap,87706942,"Thùng nhựa đựng đồ cho cốp xe ô tô có thể gấp xếp gọn có chốt gài | 30L + 55L + túi chống nước",175000,175000,0,0
TIKI,o-to-xe-may-xe-dap,22258742,"Phụ kiện đựng chai nước trên xe hơi",50000,50000,0,0
TIKI,thoi-trang-nu,83852768,"Bộ Đồ Lót Nữ, Áo Ngực Đúc Su Không Gọng mút kép nâng ngực cúp ngang tạo khe siêu quyến rũ thương hiêu Baw mã AN10",199000,199000,0,0
TIKI,thoi-trang-nu,138755296,"Áo Thun Nữ Cổ Tim Tay ngắn , Trẻ Trung, Mẫu Mới nhất",73320,79000,5680,7
TIKI,o-to-xe-may-xe-dap,146256721,"SIÊU SÁNG VỚI 1 BÓNG ĐÈN PHA LED 3 TIM KIỂU ĐUÔI CÔNG LẮP XE MÁY XE HƠI ÔTÔ HÀNG CHUẨN SÁNG",179000,179000,0,0
TIKI,o-to-xe-may-xe-dap,21612450,"Bugi Sấy 12V GM4(Dài)-9.5cm",19000,19000,0,0
TIKI,thoi-trang-nu,106514404,"Áo Ngực Không Gọng, Áo Lót Bra Lụa Satin Phối Ren Không Gọng  dây mảnh Thương Hiệu Baw mã AN051",159000,159000,0,0
TIKI,thoi-trang-nu,187048171,"Bộ đồ bơi bikini nữ 2 mảnh kín đáo đi tắm biển, đi tập yoga, đi tập gym tay dài - B.43",198550,209000,10450,5
TIKI,thoi-trang-nu,83832124,"Áo Ngực, Áo Lót cho con bú chống chảy xệ, Áo Ngực cho mẹ bầu siêu hot thương hiệu Baw mã AN08",129000,129000,0,0
TIKI,thoi-trang-nu,134389408,"Áo Khoác Hoodie Nỉ Bông SHINING MOON Dây Kéo Form Rộng Unisex Nam Nữ Phong Cách Hàn Quốc Ulzzang KUN",96000,96000,0,0
TIKI,thoi-trang-nu,170969419,"Đồ Bơi Một Mảnh Ôm Thân Dáng Lá ATO25 MAYHOMES Natural Color Women One-Piece Swimsuit",171080,188000,16920,9
TIKI,thoi-trang-nu,176285798,"Quần short nữ ống rộng lưng cao có túi rộng độc đáo siêu xinh, quần đùi ngắn bigsize chất vải kaki cao cấp mặc ở nhà đi chơi dạo phố vào mùa hè",139000,250000,111000,44
TIKI,o-to-xe-may-xe-dap,68837160,"Gối Tựa Lưng Ghế Văn Phòng, Ghế Ô Tô Bằng Cao Su Non Giảm Đau Mỏi Lưng Mẫu Mới",418000,418000,0,0
TIKI,thoi-trang-nu,124874010,"Đồ bộ nữ mặc ở nhà bộ lửng co giãn thoáng mát",88000,88000,0,0
TIKI,lam-dep-suc-khoe,66618934,"Natureine AQUA PEEL Moisture Peeling Gel - Chai 30ml - Gel tẩy tế bào da chết, cấp ẩm Nhật Bản - Chính Hãng",90000,120000,30000,25
TIKI,lam-dep-suc-khoe,82040987,"Bột tiệt trùng cốc nguyệt san Lincare đánh bay 99,9% vi khuẩn, tẩy ố và khử khuẩn siêu tốc (Hộp 12 gói x 2g)",125000,149000,24000,16
TIKI,lam-dep-suc-khoe,87378418,"Kissing Spray Juicy Kiss vị Đào chai 20ml - LOLI & THE WOLF, Tặng Kèm Mút Rửa Mặt",139000,139000,0,0
TIKI,lam-dep-suc-khoe,182557965,"Siro ho bổ phế Đ.Y Combo 2 chai 100ml - Giảm ho, ngứa rát cổ họng, khàn tiếng, bổ phổi từ thảo dược",36000,70000,34000,49
TIKI,lam-dep-suc-khoe,249029146,"Viên Uống Ăn Ngủ Ngon Dân Khang",103000,155000,52000,34
TIKI,lam-dep-suc-khoe,559924,"Tinh Chất Serum Làm Trắng Da Dew&Dew 24k Gold Collagen Serum Whitening - DEW&DEW01 - 50ml",230000,230000,0,0
TIKI,lam-dep-suc-khoe,77014770,"Kem Bôi Trơn Khi Quan Hệ Của Nhật Bản Sagami 60g - Không Mùi Không Vị - Gốc Nước Dễ Rửa Sạch - Tặng Kèm Gel Jex Nhật - Hàng Chính Hãng 100% - Che Tên Sản Phẩm",250000,250000,0,0
TIKI,lam-dep-suc-khoe,113083508,"Máy Đo Nhiệt Kế Kachi JXB-315 Cảm Biến Hồng Ngoại có chứng nhận FDA Mỹ",799000,799000,0,0
TIKI,lam-dep-suc-khoe,75551920,"Viên Uống Giữ Ẩm Cấp Nước DHC Hyaluronic Acid",299000,350000,51000,15
TIKI,lam-dep-suc-khoe,82250462,"Bột Nghệ nguyên chất UMIHOME 40G dùng uống hỗ trợ sức khỏe và đắp mặt nạ dưỡng da hiệu quả",53000,100000,47000,47
TIKI,lam-dep-suc-khoe,127153070,"Bột Trắng Răng Eucryl Tooth Powder Nhập Khẩu Anh Quốc (50g) - Massel Official",93000,204000,111000,54
TIKI,lam-dep-suc-khoe,5744713,"Đèn Hồng Ngoại TNE Lamp",349000,349000,0,0
TIKI,lam-dep-suc-khoe,54418197,"Bột lá nhuộm tóc OGATIC 50g ( Bao Bì Mới)- Đen tự nhiên",96000,150000,54000,36
TIKI,lam-dep-suc-khoe,9979100,"Combo 10 Gói Mặt Nạ Chiết Xuất Lựu 3W Clinic Fresh Pomeranate Mask Sheet (23ml x 10)",55000,55000,0,0
TIKI,lam-dep-suc-khoe,25202449,"Avène Kem Dưỡng Da Làm Dịu Cơn Ngứa Tức Thời XeraCalm AD Lipid-Replenishing Cream 200ml",591000,739000,148000,20
TIKI,lam-dep-suc-khoe,145177161,"Dầu massage body Sả Gừng giảm cảm giác mệt mỏi vai gáy, lưng, đầu gối Tinh Dầu 100 200ml",190000,190000,0,0
TIKI,lam-dep-suc-khoe,267098650,"Xịt Chống Nắng Dạng Phun Sương Kiểm Soát Dầu La Roche-Posay Anthelios Invisible Fresh Mist SPF 50+ UVB & UVA (75ml)",475000,575000,100000,17
TIKI,lam-dep-suc-khoe,196889653,"Máy Massage Cầm Tay VinBuy - 6 Cấp Độ, Hỗ Trợ Mát Xa Chuyên Sâu, Giảm Đau Cơ, Cứng Khớp - Quà Tặng Cho Sức Khỏe",509000,1000000,491000,49
TIKI,lam-dep-suc-khoe,24503369,"Gậy chống batoong 1 chân xếp gọn Lucass Y597",210000,210000,0,0
TIKI,lam-dep-suc-khoe,118124179,"Viên uống ANGELA GOLD tăng cường sinh lý nữ với Lepidium Meyenii, P.Leucotomos (60 viên)",720000,720000,0,0
TIKI,lam-dep-suc-khoe,78498187,"Dụng Cụ Cạo Lưỡi Người Lớn Sản Xuất Tại Thụy Sĩ Trisa Double Action - Hồng",86000,110000,24000,22
TIKI,lam-dep-suc-khoe,186267943,"Bộ đai chườm nóng thảo dược giảm đau khuỷu tay dùng điện - Hapaku",499000,650000,151000,23
TIKI,lam-dep-suc-khoe,31292406,"Nhiệt Ẩm Kế Tanita TT-513 đo nhiệt độ phòng, độ ẩm",220000,220000,0,0
TIKI,lam-dep-suc-khoe,141367783,"Dầu gội gừng hà thủ ô Weilaiya 400ml - Nuôi dưỡng và phục hồi hư tổn cho mái tóc",267000,345000,78000,23
TIKI,lam-dep-suc-khoe,5136595,"Sữa rửa mặt Fixderma Non Drying Cleanser (60g)",205000,205000,0,0
TIKI,lam-dep-suc-khoe,141470309,"Sét Giấy Và 2 Que Wax",4200,7000,2800,40
TIKI,lam-dep-suc-khoe,6312781,"Nước rửa tay khử mùi Mr.Fresh 5L Hương Táo",162000,162000,0,0
TIKI,lam-dep-suc-khoe,491312,"Bông Tẩy Trang Jomi 80 Miếng/Túi",25000,25000,0,0
TIKI,lam-dep-suc-khoe,10023457,"Dầu gội nhuộm tóc thảo dược Dexe",112000,220000,108000,49
TIKI,lam-dep-suc-khoe,204877913,"Cân sức khỏe Life360",169000,290000,121000,42
TIKI,lam-dep-suc-khoe,125818440,"LƯỢC GỘI MASSAGE TẨY TẾ BÀO CHẾT THƯ GIẢN DA ĐẦU HỖ TRỢ KÍCH THÍCH MỌC TÓC",14700,14700,0,0
TIKI,lam-dep-suc-khoe,68819486,"Tinh Dầu Xịt Bưởi Vijully Hỗ Trọ Kích Thích Mọc Tóc Chai 150ml(Mẫu mới)",120000,150000,30000,20
TIKI,lam-dep-suc-khoe,115129321,"SỮA DƯỠNG THỂ CHỐNG NẮNG, DƯỠNG ẨM VÀ LÀM SÁNG DA HATOMUGI SPF50+ PA",115000,115000,0,0
TIKI,lam-dep-suc-khoe,179158883,"Máy đo đường huyết OneTouch Select Plus Simple",1000000,1000000,0,0
TIKI,lam-dep-suc-khoe,165988088,"Nước súc miệng Colgate kháng 99% vi khuẩn Plax 500ml/chai",104000,104000,0,0
TIKI,lam-dep-suc-khoe,33229675,"Nẹp ngón tay kín United Medicare (E01)",120000,150000,30000,20
TIKI,lam-dep-suc-khoe,164430917,"Cạo lưỡi TONGUE CLEANER Thụy sĩ - sạch khuẩn, hết hôi miệng (Bộ 3 chiếc)",85000,85000,0,0
TIKI,lam-dep-suc-khoe,11891804,"Thực phẩm chức năng bảo vệ hệ tiêu hóa - Men vi sinh USANTIBIOPRO FORT MDP dạng nước - Hộp 20 ống x 5ml",150000,150000,0,0
TIKI,lam-dep-suc-khoe,2775371,"Bao Cao Su Sagami Xtreme White (3 Cái / Hộp)",23000,23000,0,0
TIKI,lam-dep-suc-khoe,87703885,"Combo 4 gói (360 cây) tăm chỉ nha khoa Okamura (90 cây/gói)",169000,179000,10000,6
TIKI,o-to-xe-may-xe-dap,58444444,"Bộ Chuyển Đổi Nguồn Điện DC 12V Sang AC 220V 150W Cho Xe Ô Tô Cao Cấp",236550,249000,12450,5
TIKI,o-to-xe-may-xe-dap,63706090,"Cờ Lê Lắp Chéo, Chữ T dùng Tháo Lốp Ô Tô, Xe Hơi",240000,240000,0,0
TIKI,o-to-xe-may-xe-dap,23881791,"Tem xe ô tô thể thao TS027",239000,239000,0,0
TIKI,o-to-xe-may-xe-dap,149238728,"Găng tay phượt, găng tay đi xe máy - Hàng chính hãng",60000,60000,0,0
TIKI,o-to-xe-may-xe-dap,109015505,"Nón bảo hiểm fullface M138B Thời Trang, Cá tính",760000,760000,0,0
TIKI,o-to-xe-may-xe-dap,90836292,"Nón bảo hiểm 3/4 Royal XH 01 cao cấp Lót tháo rời, che hết mặt",389000,389000,0,0
TIKI,o-to-xe-may-xe-dap,97890211,"Phễu Thay Nhớt Xe Máy",15000,15000,0,0
TIKI,o-to-xe-may-xe-dap,143225978,"Giá Đỡ Bình Nước Xe Đạp, Lồng Đựng Chai Nước Gắn Khung Xe Đạp Thể Thao Chắc Chắn",25000,25000,0,0
TIKI,o-to-xe-may-xe-dap,3004439,"Đèn LED Trợ Sáng Xe Máy L4X (40W)",165000,165000,0,0
TIKI,o-to-xe-may-xe-dap,5182479,"Combo 10 viên sủi nước rửa kính xe hơi",8999,8999,0,0
TIKI,o-to-xe-may-xe-dap,34623929,"Kính chiếu hậu Ya Z dành cho các loại xe máy (gương Yaz) BẢO LONG RACING",46000,46000,0,0
TIKI,o-to-xe-may-xe-dap,71197334,"Vỏ Bọc lót yên xe đạp thể thao thoáng khí với bọt biển mềm dày cho xe đạp địa hình/ xe đạp đua đường trường Mai Lee - Thân Hẹp (xe đạp đua)",179000,179000,0,0
TIKI,o-to-xe-may-xe-dap,35841278,"Mũ bảo hiểm nửa đầu SUNDA 135D kính râm nhẹ có thể giấu vào trong thân mũ, tác dụng chống tia uv, chống chói, lớp lót mũ tháo giặt, có 4 lỗ thông gió trên mũ, kiểu dáng gọn nhẹ thời trang - hàng chính hãng SUNDA",365000,365000,0,0
TIKI,o-to-xe-may-xe-dap,130172028,"Chuông Xe Đạp Thể Thao Nhỏ Gọn - Làm Bằng Hợp Kim Kẽm - Âm Thanh Vang 90 - 100dB Gắn Tay Lái (Ghi Đông)",19000,19000,0,0
TIKI,o-to-xe-may-xe-dap,51299173,"Sạc Điện Thoại 3 trong 1 Gắn Các Dòng Xe ",142000,142000,0,0
TIKI,o-to-xe-may-xe-dap,129147873,"Miếng Phản Quang Cảnh Báo Dành Cho Xe Đạp - Xe Đạp Spoke Plsatic Ống Kính Phản Quang Bánh Xe - Vành Phản Xạ Cảnh Báo An Toàn ",15000,15000,0,0
TIKI,o-to-xe-may-xe-dap,11506461,"Bơm MICHELIN 4398ml 12266 bơm ô tô, xe hơi mini tự ngắt",1049000,1049000,0,0
TIKI,o-to-xe-may-xe-dap,186092078,"Bạt Phủ Nửa Xe Ô Tô Che Cả Nắp Capo, Bạt Che Nóc Xe Hơi Chống Nắng, Chống Xước Cho Các Dòng Xe",219000,219000,0,0
TIKI,o-to-xe-may-xe-dap,139578655,"Nước rửa kính và vệ sinh kính xe ô tô đa năng TH CLEAN can 2.5 Lít",48990,48990,0,0
TIKI,o-to-xe-may-xe-dap,56720792,"Combo 2 Bóng Đèn Halogen Tăng Sáng 150% OSRAM Night Breaker Laser H4 12V 60/55W",968000,968000,0,0
TIKI,o-to-xe-may-xe-dap,111198553,"Yên Xe Đạp, Đệm Yên Xe Đạp Thể Thao Siêu Êm, Chống Nước Cao Cấp",97988,97988,0,0
TIKI,o-to-xe-may-xe-dap,26074025,"Kẹp Điện Thoại Gấp Gọn Trên Ô Tô",199000,199000,0,0
TIKI,o-to-xe-may-xe-dap,119420828,"Đai ghế ngồi trên ô tô cho bé (Dành cho bé dưới 20kg)",175000,175000,0,0
TIKI,o-to-xe-may-xe-dap,3935969,"Bọc khóa Smartkey Honda Lead, Airblade (Màu đen)",19000,19000,0,0
TIKI,o-to-xe-may-xe-dap,105085632,"Bóng Đèn Pha Bi Cầu Mini Chân H4 Siêu Sáng , 2 Chế Độ Vàng Và Trắng",91000,91000,0,0
TIKI,o-to-xe-may-xe-dap,35895193,"Thảm Lót Sàn Cao Su Theo Dành Cho Ô Tô Toyota Fortuner",788000,788000,0,0
TIKI,o-to-xe-may-xe-dap,127677589,"Đèn led cảnh báo mở cửa ô tô chống va chạm, gắn cửa xe TÂM LUÂN Chổi lau tẩm dầu - Hàng chính hãng",68000,100000,32000,32
TIKI,o-to-xe-may-xe-dap,33279105,"Bao da chìa khóa cao cấp dành cho xe Mitsu Xpander kèm móc khóa mẫu RO",137500,137500,0,0
TIKI,o-to-xe-may-xe-dap,134362466,"Đèn đuôi nhấp nháy đèn cảnh báo sau cho xe đạp thể thao siêu sáng, chống nước",29000,29000,0,0
TIKI,o-to-xe-may-xe-dap,181623378,"(LOẠI TỐT) Hộp 2 bóng đèn pha Xenon ô tô siêu sáng H4 100W HOD 6000K dành cho xe hơi sáng trắng mẫu mới, đồ chơi ô tô",198000,198000,0,0
TIKI,o-to-xe-may-xe-dap,116828251,"Khóa Số Xe Đạp 4 Số Mật Mã Vỏ PVC Bọc Lõi Thép (dạng tròn cứng) (mật khẩu mặc định 0000) Mai Lee",61000,69000,8000,12
TIKI,o-to-xe-may-xe-dap,190516458,"Bình Xịt phủ Nano Chống Nước  Ceramic Wax - Phủ Nano Chống Nước Kính Ô tô - Phủ Bóng Xe Hơi Xe Máy(200ml)",88000,88000,0,0
TIKI,o-to-xe-may-xe-dap,84694878,"Mũ Bảo Hiểm Nửa Đầu Kính Âm SRT -Kính chống tia UV",199000,199000,0,0
TIKI,o-to-xe-may-xe-dap,11949113,"Bọc vô lăng cao cấp ô tô mẫu VL011",88000,88000,0,0
TIKI,o-to-xe-may-xe-dap,20357325,"Biển Cảnh Báo Nguy Hiểm - Biển Tam Giác cảnh báo cho xe hơi Phản quang kích cỡ 43Cm",49000,49000,0,0
TIKI,o-to-xe-may-xe-dap,105184008,"Bọc chìa khóa Smartkey Honda Air Blade, Vision, Lead, Vario- 2 nút silicon ( mẫu cũ to)",18050,18050,0,0
TIKI,o-to-xe-may-xe-dap,35582464,"Dụng cụ đi tiểu khi đi ô tô / dã ngoại hoặc cho người bệnh",58000,58000,0,0
TIKI,o-to-xe-may-xe-dap,154273998,"Đèn led pha siêu sáng chân hs5 dành cho xe airblade, lead, pcx",212000,212000,0,0
TIKI,o-to-xe-may-xe-dap,90439133,"Khoá Chống Trộm Chữ U Cho Xe Máy Kèm 2 Chìa Tiện Lợi",54000,54000,0,0
TIKI,o-to-xe-may-xe-dap,149919468,"Dè con nối dài 2 râu (kiểu mơi) chăn bùn dành cho xe ex 150 ex 155 exciter 150 exciter 155 (CHỮ NGẪU NHIÊN)",70000,70000,0,0
TIKI,o-to-xe-may-xe-dap,35965768,"Giá đỡ bình nước xe đạp Jett",90000,90000,0,0
TIKI,o-to-xe-may-xe-dap,22084392,"CHAI XỊT DƯỠNG LÀM BÓNG VÀ BẢO VỆ BỀ MẶT GỖ, NHỰA, CAO SU, DA NỘI THẤT XE SONAX 380041 300ML",210000,210000,0,0
TIKI,o-to-xe-may-xe-dap,97822196,"Ô che nắng, kiêm chắn nắng kính lái ô tô đa năng 2 trong 1. Chống nắng nóng và tia UV MÃ ZYS",81690,81690,0,0
TIKI,o-to-xe-may-xe-dap,53351883,"Kính mũ bảo hiểm SUNDA CA-110 loại dài gắn cho các mũ có 3 khuy bấm trên đầu",129000,129000,0,0
TIKI,o-to-xe-may-xe-dap,64266130,"Bộ 2 thanh gạt nước mưa ô tô Nano xương mềm cao cấp hãng xe Chevrolet, Daewoo",127000,127000,0,0
TIKI,o-to-xe-may-xe-dap,54680124,"Hộp tỳ tay theo xe dành cho xe Mitsubishi Xpander",348995,348995,0,0
TIKI,o-to-xe-may-xe-dap,119719201,"Ắc Quy LONG WP5-6 6V-5AH Bình ắc quy khô 6V cho xe điện trẻ em ,đèn khẩn cấp,quạt sạc",130000,130000,0,0
TIKI,o-to-xe-may-xe-dap,15292948,"Bao Da Chìa Khóa Ô Tô Hyundai Grand I10 Da Bò Dạng Hộp",241530,249000,7470,3
TIKI,o-to-xe-may-xe-dap,76204670,"Tinh dầu thơm pha nhớt xe 2 thì - Phụ gia pha nhớt xe Yazz , Xipo , Novaa Green Networks Group",139000,139000,0,0
TIKI,o-to-xe-may-xe-dap,56629175,"Máy Đo Chất Lượng Pin - Ác Quy - YR1035+ Nguồn 0-100V Kiểm Tra Dòng Xả Pin Ác Quy Chính Xác 99.9%",949000,949000,0,0
TIKI,o-to-xe-may-xe-dap,54675288,"Dung dịch vệ sinh vải, da Michelin Fabric Cleaner 31425 - 650ml - Hàng chính hãng",144000,160000,16000,10
TIKI,o-to-xe-may-xe-dap,42662455,"Bảng Hiện Số Điện Thoại Khi Đỗ Xe Ôtô",17000,17000,0,0
TIKI,o-to-xe-may-xe-dap,52980205,"Bình xịt vệ sinh máy điều hòa Mr Mckenic Air-Conditioner Cleaner",179000,190000,11000,6
TIKI,o-to-xe-may-xe-dap,101778165,"Đế cao su bọc chân chống cổ dê loại tốt, đế dày, nhựa siêu bền",12000,12000,0,0
TIKI,o-to-xe-may-xe-dap,34584716,"Nhớt xe tay ga Repsol Moto Scooter 5w40 1L",179000,179000,0,0
TIKI,o-to-xe-may-xe-dap,22887539,"Dè cater chắn bùn dành cho xe Winner ",98934,98934,0,0
TIKI,o-to-xe-may-xe-dap,85170993,"Nhớt xe số cao cấp Repsol Moto MXR 7 4T 10W40 1L (Mẫu Mới}",119000,119000,0,0
TIKI,o-to-xe-may-xe-dap,28468463,"CHAI XỊT VỆ SINH KÍNH Ô TÔ, KÍNH XE ĐA DỤNG 3M GLASS CLEANER 500ML 305921",119000,119000,0,0
TIKI,o-to-xe-may-xe-dap,74568066,"Dây Quấn Ghi Đông Xe Đạp Cuộc (2 Cuộn/ bộ) Giả Vân Carbon Chống Nước Mai Lee",99000,119000,20000,17
TIKI,o-to-xe-may-xe-dap,160289549,"Gối Tựa Đầu Vải Da Gài Cổ Ghế Ô Tô",38000,38000,0,0
TIKI,o-to-xe-may-xe-dap,22754498,"Bộ 2 Lò Xo Hỗ Trợ Nâng Cốp Cho Xe Ô Tô Sedan - Giao Màu Ngẫu Nhiên",49000,49000,0,0
TIKI,o-to-xe-may-xe-dap,119308981,"Sáp thơm khử mùi giảm SAY XE ô tô Hando 230g",49000,49000,0,0
TIKI,o-to-xe-may-xe-dap,15261794,"Bao Da Chìa Khóa Ô Tô Mitsubishi Outlander 3 Nút Da Bò Dạng Hộp",241530,249000,7470,3
TIKI,o-to-xe-may-xe-dap,52488148,"thùng giữa dành cho xe winner 150",188000,188000,0,0
TIKI,o-to-xe-may-xe-dap,32161648,"Sạc bình ắc quy 12V 24V 4-150Ah có chức năng khử sunfat phục hồi bảo dưỡng ắc quy",265000,265000,0,0
TIKI,o-to-xe-may-xe-dap,58801113,"Tem dán cửa xe ô tô WRC",79000,79000,0,0
TIKI,o-to-xe-may-xe-dap,102654782,"Ô Che Nắng Kính Lái Xe Ô Tô Cao Cấp – Bảo Vệ Nội Thất Ô Tô – Dù Che Nắng Kính Lái Xe Hơi – Chống Tia UV",85999,85999,0,0
TIKI,o-to-xe-may-xe-dap,48595001,"Túi Than Hoạt Tính Lọc Không Khí Diệt Khuẩn Khử Mùi Giảm Sóng Điện Từ Cho Ô Tô",179000,179000,0,0
TIKI,o-to-xe-may-xe-dap,193564860,"Nút PVC hút chân không gắn cửa kính xe hơi để gắn miếng che nắng NQC01",18000,25000,7000,28
TIKI,o-to-xe-may-xe-dap,11709658,"Combo 2 Chai Nước Rửa Ô Tô Xe Máy Bọt Tuyết 1L",79000,79000,0,0
TIKI,o-to-xe-may-xe-dap,37874082,"Bộ dây câu bình ắc quy ô tô, xe hơi dài 4m dòng 2000A (2000AMP)",99000,99000,0,0
TIKI,o-to-xe-may-xe-dap,151685056,"Bạt trùm che phủ xe ô tô Honda CITY chuẩn 3 Lớp Cao Cấp Chống Nắng Nóng Nước Mưa Cháy Chống Bụi",290977,290977,0,0
TIKI,o-to-xe-may-xe-dap,175215137,"Pas sắt bảng tên Raider Satria",55000,55000,0,0
TIKI,o-to-xe-may-xe-dap,56003258,"Khóa Xe Đạp, Xe Máy Chống Trộm - Khóa Dây 5 Mã Bảo Mật",53788,53788,0,0
TIKI,o-to-xe-may-xe-dap,787926,"Mũ Bảo Hiểm GRS A102K - Xanh Nhám Line Xanh",279000,279000,0,0
TIKI,o-to-xe-may-xe-dap,58969670,"Bao Da Chìa Khóa Ô Tô Handmade dành cho Vinfast LUX A2.0 / SA2.0 Da Bò",290030,299000,8970,3
TIKI,o-to-xe-may-xe-dap,189556560,"Nước rửa kính ô tô siêu sạch đậm đặc INOCY bình 2L",39000,39000,0,0
TIKI,o-to-xe-may-xe-dap,132886969,"Đèn LED lùi xe hơi T15 chip 2835 Canbus T152835-15",35000,35000,0,0
TIKI,o-to-xe-may-xe-dap,80850635,"Dây treo xe ô tô phật Quan Âm phong thủy may mắn bình an, mặt đá thủy tinh, dây obsidian",283100,298000,14900,5
TIKI,o-to-xe-may-xe-dap,131338743,"Túi treo đằng trước chống nước ghi đông xe đạp-Màu Đen",55000,55000,0,0
TIKI,thoi-trang-nu,192224123,"Áo thun nữ cổ tim tay dài vải cotton đẹp, dễ mặc dễ phối đồ, mặc bốn mùa",84600,90000,5400,6
TIKI,thoi-trang-nu,21029987,"Quần jean thun nữ",300000,300000,0,0
TIKI,thoi-trang-nu,22986374,"Áo lót 7 tư thế tạo khe chữ U",67000,67000,0,0
TIKI,thoi-trang-nu,261830575,"Bộ_AM2 (Áo Bà Ba Màu + Quần Đen Rộng)",135000,135000,0,0
TIKI,thoi-trang-nu,185863930,"Quần Lót Lọt Khe Chữ Y Ren Mềm Gợi Cảm P489",32000,32000,0,0
TIKI,thoi-trang-nu,26425331,"Dây áo ngực bra cao cấp đính đá hình nơ lấp lánh sang chảnh DA32",95000,95000,0,0
TIKI,thoi-trang-nu,69988346," Quần Mặc Váy Bigsize",64000,64000,0,0
TIKI,thoi-trang-nu,198351229,"Áo sát nách nữ cổ tròn 4LOVA chất lụa satin cao cấp phong cách Hàn Quốc",85000,85000,0,0
TIKI,thoi-trang-nu,103431636,"Quần ống rộng hot trend 2021 khóa trước QUÀ TẶNG LÀ 1 GÓI XẢ VẢI NHÉ",89000,89000,0,0
TIKI,thoi-trang-nu,244332201,"Áo croptop vạt bầu cổ tim tay ngắn ôm nữ ozenka , áo crt basic chất cotton màu đen trắng mặc đi học đi chơi dưới 55 cân",59000,59000,0,0
TIKI,thoi-trang-nu,97819131,"Cosplay Sườn Xám - Bộ đồ cosplay sườn xám nhung hở vai sexy gợi cảm - Set sườn xám thêu hoạ tiết",117000,117000,0,0
TIKI,thoi-trang-nu,12710511,"Quần Legging Vicci Cao Cấp Màu Đen Vân Xước Cạp Cao 11P",135000,449000,314000,70
TIKI,thoi-trang-nu,30696465,"chân váy ren bút chì công sở",125000,125000,0,0
TIKI,thoi-trang-nu,79862343,"Áo khoác len nữ Cardigan áo khoác len dày chenille nữ tính",259000,259000,0,0
TIKI,thoi-trang-nu,192781082,"YU CHERRY | Đầm Ruffle Neck Tank Dress YD147",395000,395000,0,0
TIKI,thoi-trang-nu,58686358,"Áo len nữ dệt kim phối màu thời trang ALN07",117000,149000,32000,21
TIKI,thoi-trang-nu,51507409,"Quần lót hình bướm lọt khe sexy",25000,25000,0,0
TIKI,thoi-trang-nu,115872905,"Quần short kaki ống rộng mốt mới 2021",65000,65000,0,0
TIKI,thoi-trang-nu,56232767,"Áo Sơ Mi Nữ Kiểu Tay Ngắn Cổ Peter Pan",141550,149000,7450,5
TIKI,thoi-trang-nu,247254116,"Bộ Đũi Trung Niên Hoa Thêu Cực Đẹp Cực Sang Trọng Dành Cho Phụ Nữ Việt Nam 2023 - Laddy Store",271000,271000,0,0
TIKI,thoi-trang-nu,56231028,"Áo nữ trung niên cao cấp kiểu dáng sang trọng - NP841",293000,293000,0,0
TIKI,thoi-trang-nu,125400909,"ÁO DÀI CÁCH TÂN LỤA HOA ĐÀO 3D - AD23",340000,340000,0,0
TIKI,thoi-trang-nu,50004697,"Bộ đồ liền thân Cá Sấu (Khủng long) xanh",239000,239000,0,0
TIKI,thoi-trang-nu,104792323,"Quần lót thái lan 262 , chất thun lạnh, co giản 4 chiều, size lớn",35000,35000,0,0
TIKI,thoi-trang-nu,270241312,"Áo bà ba thun - Có bộ bà ba Bigsize- may sỉ bà ba toàn quốc - May bộ bà ba theo yêu cầu",89000,89000,0,0
TIKI,thoi-trang-nu,68644273,"Áo Thun Nữ-NAM in hình LÙN KỆ TAO cực dễ thương , thích hợp cho các cặp đôi trẻ trung, năng động, cho các nhóm bạn đi đêm, đi phượt, bão, nhìn đã mắt, bao ngầu, bao chất",29000,29000,0,0
TIKI,thoi-trang-nu,177058579,"Áo lót nữ cotton đệm vừa cao cấp AL183 Lylylorem",200000,200000,0,0
TIKI,thoi-trang-nu,78523044,"Aó nỉ hoodie full zip ( dây kéo) EGYPTIAN mặc cả thu đông và chống nắng",52000,54800,2800,5
TIKI,thoi-trang-nu,106771166,"Áo Lót Nữ, Áo Bra Không Dây Không Gọng Cực Êm, Bra Nữ Đệm Bàn Tay Nâng Ngực Siêu Quyến Rũ thương hiệu Baw ABR1 (tặng kèm dây trong)",159000,159000,0,0
TIKI,thoi-trang-nu,107124545,"Quần ống rộng nữ cúc khoá kiểu nhật dáng lỡ chất đũi",60000,60000,0,0
TIKI,thoi-trang-nu,57318339,"Đầm Dạ Hội Trọng MS 122",339440,339440,0,0
TIKI,thoi-trang-nu,13862233,"Áo khoác nữ thoát nhiệt Nhật Bản Goking 6 túi, áo chống nắng nhẹ, thấm hút mồ hôi, thoải mái vận động",275000,275000,0,0
TIKI,thoi-trang-nu,94654403,"Quần ống rộng jean nữ xám trơn size eo to MS 3072",120000,120000,0,0
TIKI,thoi-trang-nu,117003535,"Bộ Đồ Ngủ Nữ Mùa Hè Cao Cấp Loirechic BDN03",219000,399000,180000,45
TIKI,thoi-trang-nu,166118146,"Quần gen bụng khóa trước chất su cao cấp Lylylorem QG08",266000,266000,0,0
TIKI,thoi-trang-nu,130866362,"Quần sọc caro XANH ống suông ️ Nam nữ unisex Quần baggy caro Jaystoree",100000,100000,0,0
TIKI,thoi-trang-nu,43951059,"Áo len nữ thời trang kiểu dáng Hàn Quốc",149000,149000,0,0
TIKI,thoi-trang-nu,174891426,"Váy ngủ bodysuit ren sexy cao cấp Q426 - Đồ ngủ bodysuit hở đáy gợi cảm - Đầm ngủ bodysuit nữ - Bodysuit ren quyến rũ",99000,190000,91000,48
TIKI,thoi-trang-nu,97541137,"Đầm suông cổ tàu bổ trụ đính cúc không tay đuôi tôm dáng dài",190000,190000,0,0
TIKI,thoi-trang-nu,84821649,"Quần Lót Đúc Chống Lộ Viền Chống Cuộn Chống Lọt Khe Kháng Khuẩn Ôm Full Vòng 3 Cao Cấp P427",64000,64000,0,0
TIKI,thoi-trang-nu,176200238,"Váy ngủ ren hai dây nút cài xẻ trước kèm chip lọt khe gợi cảm Q438 - Đầm ngủ nữ xuyên thấu quyến rũ - Đồ ngủ sexy",139000,210000,71000,34
TIKI,thoi-trang-nu,158754960,"Quần kaki nữ lưng cao ống loe cực kỳ quý phái 91100",139300,199000,59700,30
TIKI,thoi-trang-nu,207326855,"Đồ gia đình , Áo đi biển , Đồng phục nhóm . Chất liệu vải Cotton loại 1 thoáng mát đủ size từ 8 đến 100kg",45000,45000,0,0
TIKI,thoi-trang-nu,83685898,"Đai quấn giảm mỡ bắp tay",134900,134900,0,0
TIKI,thoi-trang-nu,178509162,"Áo croptop nữ kiểu buộc dây tay ngắn, áo thun cổ bẻ crt đẹp cài khuy buộc nơ 2022 màu đen trắng size 40 -55 cân",107800,107800,0,0
TIKI,thoi-trang-nu,84826649,"Áo Lót Bralette SepSweet lụa mỏng mềm mịn B048",125000,125000,0,0
TIKI,thoi-trang-nu,89662122,"Áo sơ mi nữ cổ tầu bổ trụ tay lỡ ArcticHunter, chất đũi lụa mềm mát, thời trang phong cách trẻ",159000,159000,0,0
TIKI,thoi-trang-nu,3075099,"Bộ mặc nhà lanh (tole) Vicci BNXT.078.1 vải Thái 3D cao cấp họa tiết hoa đỏ nền trắng (Size",120000,349000,229000,66
TIKI,thoi-trang-nu,11447496,"Sơ mi nữ vải đũi, tay dài có túi Haint Boutique S172",170050,179000,8950,5
TIKI,thoi-trang-nu,107036659,"Đồ Lam Nữ Đi Chùa - Bộ Đi Lễ Chùa 2AL018 Trang Nhã Thêu Cá Ngọc Xinh Lung Linh Dành Cho Phật Tử 4.8",197000,197000,0,0
TIKI,thoi-trang-nu,73344921,"Dán Nâng Ngực Silicon dán nâng ngực Tạo Khe Loại miếng dán nâng ngực có độn dán chắc dùng nhiều lần",64999,64999,0,0
TIKI,thoi-trang-nu,45447798,"Miếng Dán Nhũ Hoa Giấy Gói 10 Miếng Giao Hình Ngẩu Nhiên",30900,30900,0,0
TIKI,thoi-trang-nu,84749445,"Áo Khoác Hoodie Nỉ Ngoại Tai Thỏ dành cho nữ",101000,101000,0,0
TIKI,thoi-trang-nu,165237235,"Áo Sơ Mi Nữ Trắng Tay Dài Cao Cấp Mola Sơmi Công Sở Hàn Quốc Đi Học Đi Làm Màu Trắng Đen Kem Hàng Thiết Kế Không Nhăn",180000,180000,0,0
TIKI,thoi-trang-nu,161209448,"BIGSIZE 50-140KG Quần Lót Chống Tràn Nguyệt San Bigsize",68000,68000,0,0
TIKI,thoi-trang-nu,118023217,"ĐỒ LAM ĐI CHÙA # Lãnh Tụ Phối Nam # Đồ Bộ Nam Nữ # Quần Áo Nam Nữ",196000,196000,0,0
TIKI,thoi-trang-nu,103215555,"Quần lót ren nữ lọt khe sexy cao cấp",27500,27500,0,0
TIKI,thoi-trang-nu,66897847,"ÁO KHOÁC KAKI THỜI TRANG NỮ AK61120",450000,450000,0,0
TIKI,thoi-trang-nu,168271329,"Áo Lót Su Đúc Không Gọng, ️️️ Nâng Ngực Siêu Cao Siêu Đẹp Áo Ngưc Nữ-A560",45000,45000,0,0
TIKI,thoi-trang-nu,146957711,"Quần Jean Nữ Ống Rộng Lưng Cao Aaa Jeans",449000,449000,0,0
TIKI,thoi-trang-nu,146774437,"( Big size) Chân váy chữ A nhún có lót quần trong",160000,160000,0,0
TIKI,thoi-trang-nu,74500648,"Hộp Quà Combo 5 Quần Lót Nữ Modal Phối Ren Trước Remix FCM-04",218000,250000,32000,13
TIKI,thoi-trang-nu,263487572,"[HCM] Đầm maxi phối ren tầng duyên dáng D081 - Lady Fashion -Khánh Linh Style",240000,480000,240000,50
TIKI,thoi-trang-nu,110801615,"Đầm dự tiệc bo eo cánh dơi sang trọng - nhiều size, form dáng chuẩn thích hợp mặc đi làm, đi tiệc",250000,250000,0,0
TIKI,thoi-trang-nu,57709128,"Quần lót ren hoa lọt khe thời trang nữ tính - Đỏ",25000,25000,0,0
TIKI,thoi-trang-nu,134390163,"Áo Sơ Mi Nhung Gân Mặt Cười Form Rộng Unisex Nam Nữ Phong Cách Hàn Quốc Ulzzang",137000,137000,0,0
TIKI,thoi-trang-nu,21145963,"Bộ 2 Quần Lót Nữ Cotton Phối Ren Miley Lingerie FCB_04",104000,250000,146000,58
TIKI,thoi-trang-nu,191044627,"Đồ bơi nữ 2 mảnh, bikini nữ kín đáo chất vải mềm mại, co giãn",149000,149000,0,0
TIKI,thoi-trang-nu,145297132,"Áo vest nữ blazer hàn quốc  [HÀNG CAO CẤP] form chuẩn công sở dễ phối đồ",299000,530000,231000,44
TIKI,thoi-trang-nu,69991534,"Áo Lót Ngực Bigsize Có Gọng Cho Chị Em Quả Ngực To",162000,162000,0,0
TIKI,thoi-trang-nu,181712764,"Áo croptop Hiền Trần BOUTIQUE cổ vuông cộc tay vải thun ôm body crotop nữ cotton co giãn tốt",218500,230000,11500,5
TIKI,thoi-trang-nu,115832954,"áo thun nữ,áo phông nữ cộc tay phối màu in số 11 dáng rộng giấu quần năng động",63000,63000,0,0
TIKI,thoi-trang-nu,25204286,"COMBO 3 QUẦN ĐÙI MẶC TRONG VÁY CAO CẤP- QUẦN LÓT SU DẠNG ĐÙI-CHẤT VẢI ĐẸP MÁT MỊN",79500,79500,0,0
TIKI,thoi-trang-nu,138854714,"Quần tất lót lông nữ - lớp lót lông dày, mềm, chịu nhiệt âm 5 độ",125000,125000,0,0
TIKI,thoi-trang-nu,55959625,"Áo ren lưới đi biển thời trang, mặc ngoài bikini, croptop, dáng lửng tay lỡ xinh xắn, mẫu cao cấp mới 2020 | AR003",240000,240000,0,0
TIKI,thoi-trang-nu,132700179,"Áo Sweater nỉ in chữ Hàn Quốc- Nỉ ngoại dài tay dáng rộng Ulzzang, Áo Nỉ Sweater Chữ Nhật Sô-cô-la Form To Thụng - Áo Nỉ Nam Nữ, áo chui đầu tay dài gấu quần unisex, áo khoác hoodie nam nữ",99000,99000,0,0
TIKI,thoi-trang-nu,196378773,"Áo ba lỗ nữ có đệm ngực nâng đỡ vải Viscose (gỗ tự nhiên) mềm mại thoáng mát tự nhiên 100% mã VAA0094",139000,139000,0,0
TIKI,thoi-trang-nu,118099916,"Quần lót nữ lọt khe ren không đáy hở đũng sexy",29000,29000,0,0
TIKI,thoi-trang-nu,137952852,"Đồ ngủ pijama nữ dáng dài tay chất kate thái cao cấp, Bộ quần áo mặc nhà pyjama- pizama HATIBO",170000,170000,0,0
TIKI,thoi-trang-nu,111620794,"Đồ mặc nhà quần lửng COTTON 5007",292000,292000,0,0
TIKI,lam-dep-suc-khoe,52053647,"Combo 02 Dầu Gội Ngăn Ngừa Gàu Clear Mát Lạnh Bạc Hà",473000,473000,0,0
TIKI,lam-dep-suc-khoe,105631257,"Bộ 3 Bao Cao Su Durex Sensual Strawberry - Hộp 3 chiếc",135000,153000,18000,12
TIKI,lam-dep-suc-khoe,5925677,"Miếng dán tẩy lông Beauty Formulas Wax Strips Legs and Body - hộp 20 miếng",157000,157000,0,0
TIKI,lam-dep-suc-khoe,178560001,"Combo Xà Bông + Sữa Rửa Mặt Nghệ MELA Thiên Nhiên, Làm Sạch Tẩy Da Chết Thoáng Lỗ Chân Lông Giảm Mụn - ML18",260000,260000,0,0
TIKI,lam-dep-suc-khoe,58852974,"Tinh Bột Cám Gạo Nguyên Chất UMIHOME (135g) Dùng cho dưỡng da loại bỏ mụn, tẩy da chết hiệu quả tại nhà",141000,195000,54000,28
TIKI,lam-dep-suc-khoe,10104718,"Cây Nặn Mụn 2 Đầu Inox - Nội Địa Nhật Bản",34000,34000,0,0
TIKI,lam-dep-suc-khoe,58615306,"Tinh dầu Sả chanh cao cấp 50ML Lemongrass. Tinh dầu xông phòng Vemoda giúp thanh lọc không khí, khử mùi, kháng khuẩn, đuổi muỗi, giải cảm, làm đẹp. Tinh dầu thiên nhiên sả chanh",149000,149000,0,0
TIKI,lam-dep-suc-khoe,1362447,"Sữa Rửa Mặt Cetaphil Gentle Skin Cleaner (500ml) - 8394107341305,9318637069637",367900,499000,131100,26
TIKI,lam-dep-suc-khoe,150269406,"Bộ Dưỡng Trắng Da Tế Bào Gốc Phục Hồi Trẻ Hoá Da Và Chống Lão Hoá Cellkey-Scien Repair System White Set (60ml)",1581000,1860000,279000,15
TIKI,lam-dep-suc-khoe,50700392,"Nước hoa hồng Dưỡng Ẩm Và Làm Dịu Da Bioderma Sensibio Tonique",414000,435000,21000,5
TIKI,lam-dep-suc-khoe,42953037,"Bột Tạo Phồng Apestomen Volcanic Clay Ash 25g",249000,249000,0,0
TIKI,lam-dep-suc-khoe,94474533,"Kềm Cắt Da Thép Chuyên Dụng Mạ Vàng KỀM NGHĨA D.777",90000,90000,0,0
TIKI,lam-dep-suc-khoe,70495152,"Son dưỡng môi dạng sáp chuyên biệt dành cho môi khô, nứt nẻ Mentholatum Medi Lip Balm 7g",64200,79000,14800,19
TIKI,lam-dep-suc-khoe,108535241,"Bao cao su Sagami Super Dot 009 - Có gai nhỏ - Dày - Hộp 10 chiếc",95000,120000,25000,21
TIKI,lam-dep-suc-khoe,44073861,"Dầu Gội Tresemmé Keratin Smooth Tinh Dầu Argan Và Keratin Vào Nếp Suôn Mượt (640g)",149000,149000,0,0
TIKI,lam-dep-suc-khoe,837895,"Nước Hoa Hồng Sắc Ngọc Khang MNH01 (145ml)",92000,115000,23000,20
TIKI,lam-dep-suc-khoe,114532904,"[FAMAPRO - PREMIUM] Khẩu trang y tế cao cấp 4 lớp kháng khuẩn Famapro Premium (40 cái/ hộp)",26900,26900,0,0
TIKI,lam-dep-suc-khoe,58407534,"Hộp 50 que thử đường huyết dùng cho máy đo đường huyết OGCare",271000,455000,184000,40
TIKI,lam-dep-suc-khoe,88223765,"Viên uống Collagen Sắc Ngọc Khang thế hệ mớI Hộp 60 viên giúp sáng da, giảm nếp nhăn - đốm nâu, nuôi dưỡng và làm đẹp da , tóc, móng",353000,390000,37000,9
TIKI,lam-dep-suc-khoe,76134019,"[HỘP - FAMAPRO MAX KID] - khẩu trang y tế trẻ em kháng khuẩn 3 lớp Famapro Max Kid (50 cái/ hộp) - 1 HỘP",25000,36000,11000,31
TIKI,lam-dep-suc-khoe,39607755,"Kem ủ phục hồi tóc Olaplex Hair Perfector No.3 chính hãng Mỹ 100ml",590000,590000,0,0
TIKI,lam-dep-suc-khoe,80468377,"Dầu dừa tinh khiết mỹ phẩm Vietcoco 130ml",82000,82000,0,0
TIKI,lam-dep-suc-khoe,4704655,"Vớ/tất y khoa đùi Hỗ Trợ Điều Trị suy giãn tĩnh mạch chân JOBST Relief chuẩn áp lực 20-30mmHg",989000,989000,0,0
TIKI,lam-dep-suc-khoe,156957796,"[HCM] Bộ kit FLOWFLEX ACON MỸ test nhanh COVID19 tại nhà, nhập chính hãng được BYT công nhận xuất VAT khi khách yêu cầu",66000,66000,0,0
TIKI,lam-dep-suc-khoe,58678128,"Dầu Cá Blackmores Oudourless Fish Oil 1000 Mg Hộp 400 Viên không tanh chính hãng Úc mẫu mới 2020",523000,687500,164500,24
TIKI,lam-dep-suc-khoe,75380136,"Mẫu mới - Tinh chất dưỡng The Ordinary Alpha Arbutin 2% + HA 30ml  ",348000,385000,37000,10
TIKI,lam-dep-suc-khoe,3483365,"Thực Phẩm Chức Năng Green Swan Imunostim Junior - Tăng Cường Chức Năng Hệ Miễn Dịch Cho Trẻ Em",325000,325000,0,0
TIKI,lam-dep-suc-khoe,210146716,"Bột Trà Xanh nguyên chất UMIHOME 40G bột đắp mặt nạ, tắm trắng, dưỡng ẩm da và ngừa mụn hiệu quả",51000,100000,49000,49
TIKI,lam-dep-suc-khoe,118090109,"Viên Sủi Bổ Sung Vitamin C, D, Và Kẽm Redoxon Triple Action 10 Viên",85000,85000,0,0
TIKI,lam-dep-suc-khoe,120427473,"Vitamin C 250mg Kirkland Adult Gummies tăng sức đề kháng, sáng da, thúc đẩy sản xuất collagen, làm chậm quá trình lão hóa - QuaTangMe Extaste - 1lọ",388400,802000,413600,52
TIKI,lam-dep-suc-khoe,56252523,"(Package mới) Kem dưỡng Simple Kind To Skin Hydrating Light Moisturizer - Thường 125ml",159000,159000,0,0
TIKI,lam-dep-suc-khoe,145839587,"Bàn Chải Đánh Răng Điện sóng âm Kachi Sonic MK309",637000,900000,263000,29
TIKI,lam-dep-suc-khoe,36664922,"Túi chườm nóng lạnh Thiên Thanh size lớn 28cm x 38cm (Màu sắc ngẫu nhiên)",170000,170000,0,0
TIKI,lam-dep-suc-khoe,162966798,"Sáp wax lông nóng dạng hạt đậu",29000,29000,0,0
TIKI,lam-dep-suc-khoe,73784845,"Sữa rửa mặt tạo bọt dịu nhẹ, kiềm dầu, cân bằng độ ẩm, ngừa mụn Rainbow L'affair Multi-Care V5 Facial Foaming Cleanser 150ml",175000,350000,175000,50
TIKI,lam-dep-suc-khoe,12219979,"Tảo Xoắn Spirulina nội địa Nhật Bản (2200 viên)",350000,350000,0,0
TIKI,lam-dep-suc-khoe,167019461,"Kem Face Collagen X3 dưỡng Trắng da - Ngừa mụn - Nám",155000,190000,35000,18
TIKI,lam-dep-suc-khoe,40657228,"Combo 10 dũa móng tay không làm xước da",30000,35000,5000,14
TIKI,lam-dep-suc-khoe,270813315,"Vitamin cho bà bầu Prenatal Folic Acid+ DHA Nature Made giúp mẹ khỏe, bé phát triển não bộ, hệ thần kinh và thể lực - QuaTangMe Extaste",832000,1664000,832000,50
TIKI,lam-dep-suc-khoe,164075481,"An Trĩ Vương Hỗ Trợ Cải Thiện Táo Bón Giúp Thanh Nhiệt, Giải Độc Có Thể Sử Dụng Cho Phụ Nữ Có Thai Hộp 30 Viên",185000,185000,0,0
TIKI,o-to-xe-may-xe-dap,111463541,"BAO CHÌA KHÓA CACBON XE MAZDA CX5, MAZDA 3, MAZDA 6",195000,195000,0,0
TIKI,o-to-xe-may-xe-dap,6940529,"Bộ 2 gù chống đổ sau dành cho xe máy ( màu đỏ )",45000,45000,0,0
TIKI,o-to-xe-may-xe-dap,44973674,"tiu tiện giảm thanh mẫu pô leovince hình tròn",47000,47000,0,0
TIKI,o-to-xe-may-xe-dap,52481364,"nhông sên đĩa vàng dành cho xe exciter 150",253000,253000,0,0
TIKI,o-to-xe-may-xe-dap,185923587,"Ổ cắm tẩu sạc đầu cái trên Oto ổ thêm tẩu cho camera hành trình 12V-24V 10A",29999,29999,0,0
TIKI,o-to-xe-may-xe-dap,58566956,"Bộ bao tay xe máy kiểu Exciter Green Networks Group",55000,55000,0,0
TIKI,o-to-xe-may-xe-dap,52026570,"Bút Cảm Ứng Che Mờ Vết Xước Sơn Xe Ô Tô Xe Máy Theo Màu Sơn",49000,49000,0,0
TIKI,o-to-xe-may-xe-dap,1176327,"Dầu Bôi Trơn Đa Năng Liqui Moly 3305 (500ml)",120650,127000,6350,5
TIKI,o-to-xe-may-xe-dap,20531183,"Bọc vô lăng ô tô - Bọc vô lăng ",67000,67000,0,0
TIKI,o-to-xe-may-xe-dap,74769626,"1 cặp ốc kiểu vặn gấp tăng sên xe máy xe đạp xe điện lổ 6li nhôm CNC tặng bao tay kiểu dáng ngẫu nhiên",26150,26150,0,0
TIKI,o-to-xe-may-xe-dap,153469257,"Bộ sửa chữa vết nứt kính chắn gió",234000,234000,0,0
TIKI,o-to-xe-may-xe-dap,172068633,"Đèn pha led xe máy mẫu mới xài trực tiếp điện máy không bị chớp ga loại xịn lắp không cần độ chế",188100,198000,9900,5
TIKI,o-to-xe-may-xe-dap,105184439,"Khung viền biển số titan xe máy - 7 màu",31500,31500,0,0
TIKI,o-to-xe-may-xe-dap,117597788,"Lọc gió máy lạnh than hoạt tính Kia Carens, Forte, Rio, Sportage, Soluto, Accent",89000,89000,0,0
TIKI,o-to-xe-may-xe-dap,92154102,"Đèn Chớp Cảnh Sát 16 Bóng Xanh Đỏ Nguồn Tẩu - Đèn LED Police Cho Xe Chuyên Dụng",499000,499000,0,0
TIKI,o-to-xe-may-xe-dap,88801541,"Khóa chữ U chống trộm chịu lực tốt cho xe máy - Khóa chữ U báo động âm thanh chống trộm LK605",246000,246000,0,0
TIKI,o-to-xe-may-xe-dap,80697192,"Rổ lưới và bát gắn cho các dòng xe Wave, Sirius",180000,180000,0,0
TIKI,o-to-xe-may-xe-dap,25409933,"Vòi bơm bánh xe có đồng hồ ",124000,124000,0,0
TIKI,o-to-xe-may-xe-dap,13310533,"Bơm ô tô xe máy đạp chân đa năng",70977,70977,0,0
TIKI,o-to-xe-may-xe-dap,26425278,"Mỡ bò xịt khô Wurth HHS Drylube 400ml 08931066 Adhesive Lubricant HHS Drylube",291000,291000,0,0
TIKI,o-to-xe-may-xe-dap,10152418,"Giá Đỡ Điện Thoại Gắn Trên Cửa Gió Điều Hòa Ô Tô Baseus SUYL-01",160000,160000,0,0
TIKI,o-to-xe-may-xe-dap,56066025,"Nẹp carbon chống xước bậc lên xuống cửa xe ô tô loại 7cm x 250cm",74000,74000,0,0
TIKI,o-to-xe-may-xe-dap,54056877,"Nón bảo hiểm 3/4 Bulldog Perro 4U cao cấp Chính hãng, Lót tháo rời, Tặng khóa số chống trộm, túi xách và balo rút Bulldog",899000,899000,0,0
TIKI,o-to-xe-may-xe-dap,208195485,"Mũ bảo hiểm có kính NÓN SƠN chính hãng KP-TR083",600000,1000000,400000,40
TIKI,o-to-xe-may-xe-dap,20877173,"Gối Tựa Đầu Ô Tô Cao Su Non Cao Cấp Lucky Bobi AZONE",75000,75000,0,0
TIKI,o-to-xe-may-xe-dap,131253973,"Lọc gió động cơ ô tô HONDA CITY 2013-2018",120000,120000,0,0
TIKI,o-to-xe-may-xe-dap,188964502,"Chai xịt diệt khuẩn khử mùi ô tô xe khách bằng nano bạc Nano Reiwa 100ml được chứng nhận viện Pasteur an toàn cho trẻ em - Hàng chính hãng",42240,70400,28160,40
TIKI,o-to-xe-may-xe-dap,45950561,"Ghế ngồi cho bế gắn xe đạp, xe đạp điện đa năng",229000,229000,0,0
TIKI,o-to-xe-may-xe-dap,13850031,"Thùng Đựng Đồ Co Giãn 40L Cho Ô Tô - Thùng đựng đồ co giãn cho xe ô tô",220000,220000,0,0
TIKI,o-to-xe-may-xe-dap,15202177,"Kính chiếu hậu Dream Thái",65000,65000,0,0
TIKI,o-to-xe-may-xe-dap,147975332,"TỰA LƯNG LÓT GHẾ Ô TÔ, XE HƠI HẠT GỖ CHỐNG NÓNG, TRƯỢT VÀ MASSAGE CAO CẤP",284000,284000,0,0
TIKI,o-to-xe-may-xe-dap,6388093,"Mũ Bảo Hiểm 3/4 Đầu Royal M139 Trơn - Trắng Bóng",540000,700000,160000,23
TIKI,o-to-xe-may-xe-dap,92515320,"YÊN XE ĐẠP TRẺ EM - TTH257",63000,63000,0,0
TIKI,o-to-xe-may-xe-dap,67893019,"Túi treo đồ có khay bàn ăn xếp gọn móc sau ghế ô tô, xe hơi kiểu mẫu hoạt hình dễ thương cho trẻ em- Hàng chính hãng",295000,295000,0,0
TIKI,o-to-xe-may-xe-dap,72954635,"Thùng đựng đồ đa năng cốp sau ô tô bọc da cao cấp , có nắp gấp, gọn gàng , ngăn nắp chứa được nhiều đồ size 50x32x30",426550,449000,22450,5
TIKI,o-to-xe-may-xe-dap,514210,"Nước Rửa Kính Chống Bám Nước FORMULA 1 - TRF1615807 - 710Ml",175750,185000,9250,5
TIKI,o-to-xe-may-xe-dap,6942675,"Bộ 2 Gù chống đổ sau dành cho các dòng xe máy ( màu bạc )",45000,45000,0,0
TIKI,o-to-xe-may-xe-dap,126725195,"Combo 2 chai xịt diệt khuẩn khử mùi ô tô, xe hơi Nano Xclean For Car 500ml-Khử mùi Hải Sản, ẩm mốc-Vệ sinh, khử mùi nội thất-Nano Bạc AHT Corp",181500,330000,148500,45
TIKI,o-to-xe-may-xe-dap,8266088,"Rổ xe máy WAVE A INOX RXM0018 10mm",99000,99000,0,0
TIKI,o-to-xe-may-xe-dap,196537847,"Tấm thảm lót chân xe máy điện Vinfast Theon 2022",150000,150000,0,0
TIKI,thoi-trang-nu,177078253,"Bikini Tay Dài Hai Mảnh Năng Động Trẻ Trung A158T MayHomes Áo Croptop Thun Lạnh Co Giãn Không Phai Màu",239700,255000,15300,6
TIKI,thoi-trang-nu,155791840,"Váy ngủ, đầm ngủ, đầm mặc nhà nữ tính chất vải lanh lụa cotton tự nhiên thoáng mát nhiều màu mã VAV0226",139000,139000,0,0
TIKI,thoi-trang-nu,86967442,"Quần Jean Nữ Lưng Cao thương hiệu Chandi, chất jean cotton co dãn tôn dáng phụ nữ eo thon mẫu KV617",171000,299000,128000,43
TIKI,thoi-trang-nu,172667744,"Đồ ngủ nữ 2 dây mặc nhà dễ thương VILADY - B122 kiểu áo hai dây quần cộc màu hồng ruốc, chất liệu Lụa Pháp (lụa latin) mềm mát",179000,249000,70000,28
TIKI,thoi-trang-nu,82704419,"Combo 3 Quần Lót Nữ Cotton Nọt Ne Màu Trơn Gợi Cảm Cho Nữ Size thương hiệu BAW QLN22",133500,133500,0,0
TIKI,thoi-trang-nu,110900438,"Quần short nữ nhung tăm quần sooc nữ cạp khóa siêu hot (không kèm belt,) thời trang Banamo Fashion, short nhung tăm 651",79000,79000,0,0
TIKI,thoi-trang-nu,73166774,"COMBO 3 Quần Lót Su Đúc Không Đường May LOIRECHIC QSD03 Thoải Mái",270000,270000,0,0
TIKI,thoi-trang-nu,73274182,"Áo Quây Nâng Ngực Chống Tụt Tặng Kèm Dây Trong LOIRECHIC BRQ06",349000,349000,0,0
TIKI,thoi-trang-nu,5183093,"Combo 5 Quần Lót Nữ Cotton Thiên Nhiên Being Me Miley Lingerie- Màu Xám Nhạt",161000,475000,314000,66
TIKI,thoi-trang-nu,7595750,"Áo Vol Nữ Sọc Tay Loe MS0109A",150000,150000,0,0
TIKI,thoi-trang-nu,72568681,"Đồ Bơi Nữ Hai Mảnh Họa Tiết Sọc Trắng Xinh AT195 MayHomes One Size, Kiểu Dáng Thể Thao",158860,169000,10140,6
TIKI,thoi-trang-nu,32214212,"Bộ 10 quần lót su đúc TRƠN không lộ viền cao cấp",141000,141000,0,0
TIKI,thoi-trang-nu,147203631,"Áo Blouse Trắng, Bác Sĩ (Dài Tay), Nam Nữ, Áo Choàng Phòng Thí Nghiệm -VT0172",144000,144000,0,0
TIKI,thoi-trang-nu,173630073,"Váy ngủ sexy BT0060 -  váy ngủ, đầm ngủ nữ hai dây - Đồ ngủ mặc nhà",89000,160000,71000,44
TIKI,thoi-trang-nu,171038173,"Bộ ngủ lụa nhẹ mát không nhăn không phai màu, thiết kế nhẹ nhàng  Lyly Lorem BN101",398000,398000,0,0
TIKI,thoi-trang-nu,57299395,"Combo 2 quần lọt khe nữ ren sexy",85000,85000,0,0
TIKI,thoi-trang-nu,177266853,"Bikini Hai Mảnh Họa Tiết Hoa Nhí AT223 MayHomes Đồ Bơi Nữ Thun Lạnh Co Giãn Tốt Two-Piece Swimwear",235600,248000,12400,5
TIKI,thoi-trang-nu,146230660,"Áo polo nữ ADINO màu xanh đen phối viền xẻ lai vải cotton co giãn dáng slimfit trẻ trung APN02",139000,278000,139000,50
TIKI,thoi-trang-nu,76589170,"Quần lót cotton nữ ren siêu xịn cực chất dưới 80kg (Combo 4 quần lót cotton gây thương nhớ)",90490,90490,0,0
TIKI,thoi-trang-nu,52052476,"Set Đồ Bơi Tay Dài Ba Chi Tiết AT154 MayHomes, Form Sport, Thun Co Giãn, Bền Chắc, Không Phai Màu",240640,256000,15360,6
TIKI,thoi-trang-nu,3146305,"Quần Lót Triumph Blissy D10 Midi - Da (Size",60500,60500,0,0
TIKI,thoi-trang-nu,172024147,"Đồ bộ pyjama nữ, đồ mặc nhà VILADY - B115 kiểu tay dài quần dài họa tiết lá xanh, chất liệu lụa Pháp ( lụa latin) siêu mát",399000,550000,151000,27
TIKI,thoi-trang-nu,174897065,"Váy ngủ lụa cổ V đan dây hông cao cấp Q407 - Đầm ngủ 2 dây sexy gợi cảm - Đồ ngủ lụa quyến rủ - Đồ ngủ mạc nhà",138000,138000,0,0
TIKI,thoi-trang-nu,82905115,"Bộ 5 Quần Lót Đùi, quần mặc váy nâng mông, kháng khuẩn thương hiệu BAW NT03",199000,199000,0,0
TIKI,thoi-trang-nu,168356585,"Đồ Bơi Nữ Hai Mảnh Cute Tôn Dáng Kiểu Croptop AT220 MayHomes Áo Tắm Women Swimwear Set",242500,250000,7500,3
TIKI,thoi-trang-nu,116827792,"Quần mặc trong váy chất liệu cotton phối ren, nâng mông quyến rũ LYEQ021",56000,59000,3000,5
TIKI,thoi-trang-nu,181247126,"Quần Lót Độn Mông Hông Thông Hơi Siêu Thoáng Mát Mềm Mại 2IN1 Sexy Quyễn Rũ",185000,335000,150000,45
TIKI,thoi-trang-nu,40939641,"ÁO VEST BLAZER PHỐI SỌC",189000,189000,0,0
TIKI,thoi-trang-nu,73588007,"Áo ngực nữ Triumph 2505 có gọng, mút mỏng, bản lưng to định hình ôm nâng đẩy ngực",859000,1199000,340000,28
TIKI,thoi-trang-nu,97819163,"Cosplay công chúa baby doll  váy ngủ sexy",213400,213400,0,0
TIKI,thoi-trang-nu,90475984,"Đầm suông linen xanh rêu cổ vuông ArcticHunter, thời trang xuân hè 2021",250000,250000,0,0
TIKI,thoi-trang-nu,155351222,"Váy/đầm ngủ ren lưới mềm mại, cao cấp,  khoét ngực sâu đầy quyến rũ, gợi cảm LYEN015",179550,189000,9450,5
TIKI,thoi-trang-nu,174131331,"Quần Bò Nữ Cạp Cao Ôm Dáng Skinny Xanh Đậm Aaa Jeans",429000,429000,0,0
TIKI,thoi-trang-nu,92018956," Móc nối áo ngực    Miếng nới rộng áo ngực",2600,2600,0,0
TIKI,thoi-trang-nu,74421965,"Áo Lót Không Gọng Mút Đệm Vừa Thời Trang Pretty Perfect By Sabina SBU8510",304500,609000,304500,50
TIKI,thoi-trang-nu,195848336,"Áo Khoác Blazer Nữ Cổ Vest Chất Tuyết Mưa Cao Cấp Hàng Thiết Kế Tay Lỡ Dáng Croptop Phong Cách Thời Trang Hàn Quốc Mặc Đi Chơi Dạo Phố Du Lịch",169000,300000,131000,44
TIKI,thoi-trang-nu,114730657,"Áo thun croptop - áo ngắn nữ cộc tay cổ tròn cài khuy chất tăm nhiều màu cá tính",98000,98000,0,0
TIKI,thoi-trang-nu,172922829,"Bộ đồ Pyjama, đồ mặc nhà nữ VILADY - B107 kiểu tay ngắn quần dài họa tiết VẰN thanh lịch chất liệu lụa Pháp cao cấp (lụa latin)",390000,499000,109000,22
TIKI,thoi-trang-nu,14766645,"Áo Thun Nữ Form Rộng, Áo Phông Nữ In Họa Tiết",40000,40000,0,0
TIKI,thoi-trang-nu,73277365,"Đầm suông đũi cổ tròn 2 túi trước, chất đũi mềm mát, thời trang công sở ArcticHunter",199000,199000,0,0
TIKI,thoi-trang-nu,171020678,"Quần Jean Nữ, Quần Jean Nữ Lưng Cao, Quần Jean Nữ Siêu Hack Dáng thương hiệu Chandi, Jean Nữ co dãn tôn dáng phụ nữ eo thon mẫu KV60",171000,350000,179000,51
TIKI,thoi-trang-nu,84821702," Quần Lót Chất Mềm Mát Lạnh Co Giãn Nhiều P047",35000,35000,0,0
TIKI,thoi-trang-nu,38529529,"Đồ Bơi Nữ Hai Mảnh Kiểu Thể Thao AT031 MayHomes",139500,155000,15500,10
TIKI,thoi-trang-nu,166466133,"Bộ đồ lót/set đồ lót/ bộ quần áo lót/đồ lót thể thao không gọng chất cotton mềm mại thoải mái cho bạn nữ LYEB025",132000,139000,7000,5
TIKI,thoi-trang-nu,119398079,"Chân váy xòe sang chảnh - CV01",140000,140000,0,0
TIKI,thoi-trang-nu,83159474,"Quần Kaki Basic Pants Unisex Nữ Cá Tính-Thời Trang PONIVA",88000,88000,0,0
TIKI,thoi-trang-nu,55213894,"Đồ Bơi Nữ Hai Mảnh Tôn Dáng Trẻ Trung AT185 MayHomes, Áo Bơi Lưng Cao, Quần Bơi Váy Xòe",166470,179000,12530,7
TIKI,thoi-trang-nu,52172650," Đồ ngủ Sexy kiểu áo sơ mi che quần quyến rũ - Màu da",85000,85000,0,0
TIKI,thoi-trang-nu,78629416,"Áo kiểu peplum cổ tim phối nơ sang trọng thích hợp mặc đi làm hoặc dạo phố - M",180000,180000,0,0
TIKI,thoi-trang-nu,108412530,"Quần tây nữ Hiền Trần BOUTIQUE chất vải cao cấp 3 màu, âu công sở mặc tôn dáng",133000,350000,217000,62
TIKI,thoi-trang-nu,145290257,"Chân váy bút chì - Váy công sở cao cấp có túi form chuẩn dáng đẹp",189000,299000,110000,37
TIKI,thoi-trang-nu,134799309,"Áo khoác nỉ hoodie sadboiz signature , tee local brand basic sadboy sad cry form rộng unisex nam nữ ulzzang TTUN STORE",105000,105000,0,0
TIKI,thoi-trang-nu,58120614,"Quần lót BARE Q1030001-YZ",99000,399000,300000,75
TIKI,thoi-trang-nu,84439625,"Quần Độn Mông Và Hông Thông Hơi Cao Cấp Xuất Nhật - 5STAR",75000,75000,0,0
TIKI,thoi-trang-nu,129557861,"Đồ bộ nữ mặc nhà, Đồ ngủ nữ áo cánh tiên quần cạp chun vải đũi xước mềm mịn siêu xinh (FREESIZE cho nữ từ 40kg - 60kg)",70000,70000,0,0
TIKI,thoi-trang-nu,186534256,"Đầm suông thêu hoa linen tưng premium sang trọng ArticHunter, thời trang thương hiệu chính hãng",450000,450000,0,0
TIKI,thoi-trang-nu,84819925,"Quần Lót Cạp Cao Ren Mềm Không Lộ Viền Cao Cấp P361",75000,75000,0,0
TIKI,thoi-trang-nu,111005927,"Quần Lót Nữ, Bộ 5 Quần Lót Nữ Thun Lạnh Phối Ren Cao Cấp Mềm Mịn Hàng Thương Gia, Quần Lót Nữ Kháng Khuẩn, Quần Lót Nữ Co Giãn Tốt Thương Hiệu Baw Mã QLN888",199000,199000,0,0
TIKI,thoi-trang-nu,104795185,"Set/Bộ Đồ Lót Một Mảnh Vải Nhung Cài Trước Thiết Kế Quyến Rũ, Gợi Cảm LYEB018",189000,199000,10000,5
TIKI,thoi-trang-nu,67873261,"Combo 10 Quần Lót Nữ Thun Lạnh Trơn Comfort Miley Lingerie BMS - Giao màu ngẫu nhiên",319000,790000,471000,60
TIKI,thoi-trang-nu,185867063,"Bộ quần áo ngắn cho mẹ Xanh golf đũi xước - AICDMEI3QI1X - AIN Closet",310000,415000,105000,25
TIKI,thoi-trang-nu,148640744,"Quần đùi bầu cạp chéo Mặc ngủ và mặc trong váy cho bà bầu mùa hè (Hàng đẹp, cao cấp)",35000,35000,0,0
TIKI,thoi-trang-nu,114056192,"Áo khoác nỉ nữ cao cấp/ Áo khoác hoodie form rộng in hoạ tiết dễ thương khoá kéo nhiều màu thời trang teen hè",97000,97000,0,0
TIKI,thoi-trang-nu,101949464,"Combo 5 quần lót nữ   Jones 003 cotton 100",45000,45000,0,0
TIKI,thoi-trang-nu,179765132,"Combo 2 quần lót nữ, quần lót tam giác, quần lót nữ ren mềm mịn đính nơ sau mông xinh xắn, gợi cảm LYEQ072 ( MÀU NGẪU NHIÊN)",84550,89000,4450,5
TIKI,thoi-trang-nu,73862702,"ÁO LÓT NỮ REN MÚT DÀY 2CM DÂY TRƠN NÂNG NGỰC 024B",109000,115000,6000,5
TIKI,thoi-trang-nu,55826853,"Đồ Bơi Nữ 1 Mảnh Tay Dài Đen Phối Trắng AT182 MayHomes Chất Liệu Cao Cấp, Bền Đẹp",199000,249000,50000,20
TIKI,thoi-trang-nu,182148370,"Bộ Đồ Lót Nữ Gợi Cảm Tặng Kèm Vớ - Trắng",185000,185000,0,0
TIKI,thoi-trang-nu,130865785,"Áo hoodie nỉ bông form rộng HAPPY ️/Nam nữ unisex/Jaystoree",96000,96000,0,0
TIKI,thoi-trang-nu,22157787,"Quần jean nữ Thời Trang QJN17",139000,139000,0,0
TIKI,thoi-trang-nu,186693795,"ĐẦM HOA TIỂU THƯ CỔ SEN PHỐI VIỀN REN – M04",199000,390000,191000,49
TIKI,thoi-trang-nu,152374845,"Hàng Sẵn_ Áo khoác cardigan nữ áo len dệt kim dáng rộng họa tiết hình quả trám",189000,189000,0,0
TIKI,thoi-trang-nu,51526856,"Quần lót ren nữ thanh lịch sexy mềm mại",25000,25000,0,0
TIKI,thoi-trang-nu,193909439,"Hộp 10 Miếng Dán Ngực Silicon Siêu Tiện Lợi Tái Sử Dụng Nhiều Lần",48000,48000,0,0
TIKI,thoi-trang-nu,83857592,"ÁO KHOÁC HOODIE PURBSSO tay phồng nhúng, Áo Hoodie Nỉ Bông Unisex PURBSSO [ FREESHIP ] form nam nữ unisex,hoodie PURBSO, Áo hoodie nam / áo hooodie nữ / áo hoodie form rộng / áo khoác nam có nón trùm đầu / áo hoodie cặp đôi / áo khoác cặp đôi",100000,100000,0,0
TIKI,thoi-trang-nu,105794899,"Quần Lót Nữ, Bộ 3 Quần Mặc Váy Chất Liệu Cotton Thông Hơi Siêu Mát Mịn, Quần Chip Nữ Kháng Khuẩn Cao Cấp Thương Hiệu BAW NT7261",199000,199000,0,0
TIKI,thoi-trang-nu,175551986,"ĐẦM HỌA TIẾT SAO PHỐI DẬP LY - DAM02",199000,390000,191000,49
TIKI,thoi-trang-nu,122092299,"Áo khoác cardigan len nữ pha gấu thổ cẩm, chất len dày dặn thích hợp thu đông, thời trang phong cách trẻ",230000,230000,0,0
TIKI,thoi-trang-nu,108915738,"Áo Lót Thể Thao Màu Trơn Thời Trang Basic Sport By Sabina SBB1204",191500,383000,191500,50
TIKI,thoi-trang-nu,175847781,"Vải Áo Dài Bà Sui, Hoa Tiết Hoa Tà Và Hoa Ngực, Siêu Sang",230000,230000,0,0
TIKI,thoi-trang-nu,183745169,"Quần vải ống loe xẻ trước cạp cao dáng xinh thời trang Banamo Fashion quần loe xẻ gấu 435",98000,98000,0,0
TIKI,thoi-trang-nu,14815845,"Chân Váy Xòe Phối Nút",135000,135000,0,0
TIKI,thoi-trang-nu,131177375,"Áo khoác len nữ, áo cardigan len thiết kế phối ren mẫu mới thu đông AH02",199000,199000,0,0
TIKI,thoi-trang-nu,190155812,"Quần jean nữ boyfriend baggy trơn dài đen và trắng co giãn HQJEANS",350000,350000,0,0
TIKI,thoi-trang-nu,98807520,"Áo phông ngắn tay, áo thun nữ cộc tay Vicci AP.01.6 chất liệu cotton vân gỗ in hoạ kẻ",78000,168000,90000,54
TIKI,thoi-trang-nu,194498328,"Váy len body chiết eo, Đầm xinh dáng ôm chất liệu len dệt kim cao cấp- VL01",289000,289000,0,0
TIKI,thoi-trang-nu,50377359,"Combo 4 quần lót nữ ren hoa sexy (Màu ngẫu nhiên)",81000,81000,0,0
TIKI,thoi-trang-nu,113933468,"váy suông nữ - đầm suông sát nách dáng dài 3 màu chất đũi",89000,89000,0,0
TIKI,thoi-trang-nu,180924959,"Bộ đồ mặc nhà nữ lanh (tole) Vicci BN10 thiết kế tay ngắn xẻ cách điệu phối quần lửng in họa tiết",155000,269000,114000,42
TIKI,thoi-trang-nu,67140446,"Áo Sơ Mi Nữ Dài Tay Phối Họa Tiết Star Thanh Lịch",89000,89000,0,0
TIKI,thoi-trang-nu,103797449,"Quần Lót Chống Tràn Nguyệt San Trơn Cotton Thoáng Khí Cạp Vừa P471",42000,42000,0,0
TIKI,thoi-trang-nu,52602257,"Đầm Ngủ Cho Người Mập",345450,345450,0,0
TIKI,thoi-trang-nu,179930716,"Đồ Bộ Nữ, Đồ Bộ Nữ Mặc Nhà, Đồ Bộ Nữ Thun Cotton Siêu Đẹp, Đồ Bộ Ngủ Nữ, Đồ Bộ Nữ lửng, Đồ Ngủ Nữ Thoáng Mát ( hình thật shop tự chụp), đồ bộ thể thao nam nữ, đồ bộ unisex ulzzang hàn quốc",99000,99000,0,0
TIKI,thoi-trang-nu,175810444,"Đồ bộ pijama lụa, đồ mặc nhà nữ Vilady - B137  kiểu đồ bộ ngắn họa tiết hình học siêu dễ thương, chất liêu lụa Pháp ( lụa latin) cao cấp - Màu hồng",299000,450000,151000,34
TIKI,thoi-trang-nu,192894272,"Áo kiểu nữ Linen tưng Premium tay cánh rới form rộng trẻ trung, không kén dáng mặc",250000,250000,0,0
TIKI,thoi-trang-nu,107154707,"Quần lót ren nữ xuyên thấu gợi cảm",25000,25000,0,0
TIKI,thoi-trang-nu,113200266,"Đầm suông dài tay linen cổ tim kèm đai rời ArcticHunter, thời trang thương hiệu chính hãng - Đỏ bã trầu",250000,250000,0,0
TIKI,thoi-trang-nu,56343693,"Đầm Hoa Dễ Thương Phong Cách Retro DN077 MayHomes, Thời Trang, Dịu Dàng",146850,165000,18150,11
TIKI,thoi-trang-nu,113835396,"Áo sơ mi đũi nữ kẻ caro thiết kế tay dài có túi SH02",166649,179000,12351,7
TIKI,thoi-trang-nu,118026605,"Đồ Lam Đi Chùa # Lãnh Tụ Phối # Đồ Bộ Nam Nữ # Quần Áo",102000,102000,0,0
TIKI,thoi-trang-nu,108915574,"Áo Lót Thể Thao Màu Xám Viền Sọc Xám Trắng Thời Trang Basic Sport By Sabina SBB1201",191500,383000,191500,50
TIKI,thoi-trang-nu,25077402,"Áo Croptop Nữ Tay Dài Z_18",118000,118000,0,0
TIKI,thoi-trang-nu,177264017,"Bikini Hai Mảnh Tôn Dáng Dễ Thương AT222 MayHomes Đồ Bơi Nữ Two-Piece Swimwear",235600,248000,12400,5
TIKI,thoi-trang-nu,185858451,"Đầm Ngủ Bodysuit Ren đồ ngủ sexy cosplay xuyên thấu gợi cảm",65000,65000,0,0
TIKI,thoi-trang-nu,56263154,"Áo Tắm Một Mảnh Carô AT1O5 MayHomes Bikini Một Mảnh Váy Xòe",156750,165000,8250,5
TIKI,thoi-trang-nu,176212596,"Bộ đồ lửng mặc nhà tole (lanh) Vicci BN93 thiết kế áo sát nách peplum phối quần lửng in họa tiết",135000,269000,134000,50
TIKI,thoi-trang-nu,144191819,"Áo lót nữ cotton không gọng đệm mỏng cao cấp, áo bra nữ sinh chất mềm mại thoáng mát",65000,120000,55000,46
TIKI,thoi-trang-nu,53118531,"Áo Công Sở Nữ Kiểu Áo Sơ Mi Tay Bo Đơn Giản GOTI 3119",199000,199000,0,0
TIKI,thoi-trang-nu,175194995,"Đồ Bơi Nữ Hai Mảnh Dễ Thương Xuân Hè ATO98 MayHomes Pretty Two-Piece Swimwear",159250,175000,15750,9
TIKI,thoi-trang-nu,196052695,"Quần short nữ Linen bột Premium sắn gấu trẻ trung ArcticHuntẻ",169000,169000,0,0
TIKI,thoi-trang-nu,74039214,"Combo 5 Quần Lót Nữ Thun Lạnh Phối Ren Atuner QL012, Hàng Đẹp, Co Giãn Đàn Hồi Tốt - Hàng Chính Hãng",170000,340000,170000,50
TIKI,thoi-trang-nu,177726628,"Đồ Bơi Nữ Một Mảnh Họa Tiết Chú Voi Xinh AT076 MAYHOMES Kiểu Hở Lưng Dây Đan Chéo",159250,175000,15750,9
TIKI,thoi-trang-nu,121244310,"Áo polo nữ màu xanh biển nhạt phối viền chìm ADINO vải cotton polyester mềm dáng slimfit công sở hơi ôm trẻ trung APN03",159000,318000,159000,50
TIKI,thoi-trang-nu,90655330,"Quần lót G-String Sexy đẹp xuyên thấu",29000,29000,0,0
TIKI,thoi-trang-nu,162256801,"Đầm body đỏ sườn xám cổ tàu đính cườm xịn xò",173000,173000,0,0
TIKI,thoi-trang-nu,112764875,"ĐAI NỊT BỤNG (GEN SIẾT GIẢM EO) GILE LATEX THÔNG HƠI HI LẠP DÀI 29cm (giải pháp giành cho những bạn có nhiều mỡ lưng)",330000,330000,0,0
TIKI,thoi-trang-nu,162019191,"Set đồ bộ đi chơi linen áo dáng yếm nút sau trẻ trung ArcticHunter - Áo cam quần trắng",289000,289000,0,0
TIKI,thoi-trang-nu,174843854,"Áo thun Teeworld Saigon Traffic T-shirt Trắng Đen Form Rộng Unisex Nam Nữ",339000,339000,0,0
TIKI,thoi-trang-nu,112764896,"Áo lót corset Liner ( Áo lót mặc trong gen bụng cao cấp chống hằn ngứa)",45000,45000,0,0
TIKI,thoi-trang-nu,73521771," QUẦN JEAN DÀI ỐNG RỘNG LƯNG CAO XÁM ĐEN TRƠN BASIC - QUẦN BÒ NỮ CULOTTES SUÔNG 60 - L<55Kg",144000,144000,0,0
TIKI,the-thao-da-ngoai,163789038,"Lưới Lồng Bát Quái Đánh bắt cá - lồng bát quái xăm, chã - docauDuli",84988,84988,0,0
TIKI,the-thao-da-ngoai,69189101,"Đồ Bộ Thun Nam Phối Sọc Tay DRK Chất Thun Mè Cao Cấp Form Thể Thao Hiện Đại",98000,98000,0,0
TIKI,the-thao-da-ngoai,160831813,"Dụng cụ day ấn huyệt mát xa hình đầu Trâu gỗ Bách Xanh (MH885) Chăm sóc sức khỏe cho gia đình",37050,39000,1950,5
TIKI,the-thao-da-ngoai,137014820,"Mồi Câu Cá Siêu Nhạy Sanami Fishing Chuyên Dùng Câu Trắm , Trôi, Chép, Mè SOG-2",20000,20000,0,0
TIKI,the-thao-da-ngoai,196232450,"Quả cầu lông Fuwin giá rẻ",76000,110000,34000,31
TIKI,the-thao-da-ngoai,94304318,"Quần leggings tập gym cho nam Hibi Sports M103 - Loại đùi không đường phối",224000,320000,96000,30
TIKI,the-thao-da-ngoai,55654730,"Băng cánh tay thể thao – Băng cánh tay chơi bóng rổ",68000,79000,11000,14
TIKI,the-thao-da-ngoai,82829816,"Phao tập bơi liền thân cho bé 2-10 tuổi Phao tay đỡ ngực bé trai bé gái",91994,91994,0,0
TIKI,the-thao-da-ngoai,139932384,"Siêu Khuyến Mãi 1 kg Bi Sắt 6mm, 7mm, 8mm - Đồ câu 24h - Cần Câu Top1 VN",41900,41900,0,0
TIKI,the-thao-da-ngoai,92806730,"La Bàn Đa Năng 10 Chức Năng T10",195000,195000,0,0
TIKI,the-thao-da-ngoai,69459760,"Dụng Cụ Chống Đẩy - Dụng Cụ Hít Đất TT017 Mặt Bằng, Tay Cầm Bọc Cao Su",199000,199000,0,0
TIKI,the-thao-da-ngoai,47489300,"Bó gối thể thao bảo vệ đầu gối co giãn xanh đen AB022",79000,79000,0,0
TIKI,the-thao-da-ngoai,639504,"Phao Tim Tập Bơi Sportslink PHAOTIM - Màu Ngẫu Nhiên",70000,113000,43000,38
TIKI,the-thao-da-ngoai,6623979,"Kìm bóp tay điều chỉnh lực SW ( 10-60kg)-Đại Nam Sport",69000,120000,51000,43
TIKI,the-thao-da-ngoai,146509394,"Bộ 5 Dây Đàn Hồi - 5 Dây Kháng Lực Tập Gym Tập Yoga Tập Thể Thao Cao Su Non Cao Cấp Chính Hãng dododios - Có Túi Đựng Cao Cấp Hướng Dẫn Sử Dụng, dây kháng lực tập bóng đá",89000,89000,0,0
TIKI,the-thao-da-ngoai,69247519,"Giày bơi, đi nước, đi biển, chơi các trò vận động trên biển, trên cát, đế không trơn trượt, bảo vệ chân khỏi vật sắc nhọn, nhẹ, mềm, nhanh khô (SA072)",199000,199000,0,0
TIKI,the-thao-da-ngoai,167941049,"[Tặng Dây Đeo] Thảm Tập Yoga Định Tuyến 2 Lớp TPE 6mm Cao Cấp - YOGA QG, Đường Định Tuyến In Rõ Nét Có Lớp Lưới Chống Trơn Trượt, Mềm Mại, Thấm Hút Mồ Hôi Hiệu Quả - Hàng chính hãng",108000,155000,47000,30
TIKI,the-thao-da-ngoai,90184311,"Vợt bóng bàn 729 Very 9 sao cao cấp",1090000,1090000,0,0
TIKI,the-thao-da-ngoai,58007243,"MỘT CẶP HEAD 5 INCH TENNIS WRISTBAND -BĂNG MỒ HÔI TAY (285065)Màu ngẫu nhiên",230000,279000,49000,18
TIKI,the-thao-da-ngoai,141630422,"Hot Bát Đựng Mồi, Trộn Mồi Câu Cá Gấp Gọn Cực Kỳ Tiện Lợi - Minh Phú",12200,12200,0,0
TIKI,the-thao-da-ngoai,68793194,"Găng Tay Tập GYM Hở Mu Da Bò Wrist Guard Aolikes (1 Đôi)",185000,185000,0,0
TIKI,the-thao-da-ngoai,195557260,"Bếp Ga Dã Ngoại Mini Xếp Gọn Naturehike NH21RJ009",410000,410000,0,0
TIKI,the-thao-da-ngoai,144403827,"Găng X | Găng Tay Nam Nữ Thể Thao, Tập Gym",69000,69000,0,0
TIKI,the-thao-da-ngoai,15228054,"Mũ chống nắng nam trùm mặt cao cấp",135000,135000,0,0
TIKI,the-thao-da-ngoai,168576432,"Nẹp duỗi thẳng cho người vẹo ngón chân cái, bộ 2 cái",78000,78000,0,0
TIKI,the-thao-da-ngoai,170920305,"Chống Cần Câu Cá LEO-27887 - Hot",117000,117000,0,0
TIKI,the-thao-da-ngoai,146905027,"Xiên Bắt Cá 5 Tiêu Có Ngạch - Kèm Cán 3M",86400,86400,0,0
TIKI,the-thao-da-ngoai,92746100,"Combo 5 Bộ Lăng Xê Câu Cá Lò Xo 2 Lưỡi Số 9 Câu Cá Chép, Mè, Trắm, Trôi",48000,48000,0,0
TIKI,the-thao-da-ngoai,46556207,"Bình Nước Xe đạp thể thao cách nhiệt Camelbak Podium Chill 620ml",299000,299000,0,0
TIKI,the-thao-da-ngoai,58331661,"Băng Đô Băng Trán Thể Thao | Gym | YoGa [Tặng Kèm Dây Cột Tóc Hoa Mặt Trời",65000,65000,0,0
TIKI,the-thao-da-ngoai,161461541,"Tạ Tay Nhựa 3kg Bát Giác REEFIT (1 cái)",21000,21000,0,0
TIKI,the-thao-da-ngoai,143174055,"Banh bóng rổ Gentra 8500 PVC- size 7 – Quả bóng rổ da số 7 – Tặng bộ phụ kiện bơm mini, kim bơm, túi lưới, túi rút",152000,199000,47000,24
TIKI,the-thao-da-ngoai,119985869,"Khăn thể thao POÊMY sọc gân, kích thước 36x78cm, siêu mềm mịn, thấm hút tốt, phù hợp sử dụng khi tập Gym, chạy bộ",85000,99900,14900,15
TIKI,the-thao-da-ngoai,37437384,"Thảm tập YOGA TPE Cao Cấp 2 lớp- 6mm dộ bám cao , chống trơn trượt",68000,68000,0,0
TIKI,the-thao-da-ngoai,188916562,"Quần Đùi Nam FASVIN Vải Gió Nhẹ Mát Hàng Nhà Máy Chất Lượng Cao Thể Thao Hay Mặc Nhà Q22508.HN",89000,170000,81000,48
TIKI,the-thao-da-ngoai,14034657,"Đai Quấn Chân Tập Gym Hỗ Trợ Tập Chân, Mông, Đùi Leg Wight Training Foot Ring AOLIKES YE-7129",67000,109000,42000,39
TIKI,the-thao-da-ngoai,2339281,"Đồ Chơi Bóng Rổ Trẻ Em (Trụ Sắt Kèm 2 Bóng)",300000,300000,0,0
TIKI,the-thao-da-ngoai,169568346,"ĐỒ BƠI NAM TAY DÀI CAO CẤP",320000,320000,0,0
TIKI,the-thao-da-ngoai,126071232,"Trụ Đấm Bốc FED - 8725 --- Hàng Chính Hãng",3380000,3380000,0,0
TIKI,the-thao-da-ngoai,112977692,"[MUA 1 TẶNG 1] Set bộ thể thao cầu lông nữ badminton NEW02, cao cấp, chất lượng, chuẩn form",299000,299000,0,0
TIKI,bach-hoa-online,8020749,"Tuýp Nhỏ Lưng Diệt Ve Ghẻ Bọ Chét Chó Mèo Kéo Dài (Hộp 5 ống 0.67ml)",44412,44412,0,0
TIKI,bach-hoa-online,58947287,"Siro Pha Chế Vị Đào Đỏ Torani Classic Peach Syrup 750ml Mỹ",199800,199800,0,0
TIKI,bach-hoa-online,135390014,"MẬT DỪA NƯỚC ÔNG SÁU - 375g - MEKONG HOME",109000,109000,0,0
TIKI,bach-hoa-online,69174535,"SIRO ĐƯỜNG ĐEN LOFACO - 2.5KG - NGUYÊN LIỆU DÙNG PHA CHẾ ĐỒ UỐNG - TRÀ SỮA (Trà Lộc Phát)",210000,210000,0,0
TIKI,bach-hoa-online,111198838,"LẠC RANG HÚNG LÌU KHANG HY 500g",60000,60000,0,0
TIKI,bach-hoa-online,144034988,"Cá sợi cho hamster, sóc, bọ, nhím 100g",10000,10000,0,0
TIKI,bach-hoa-online,172161856,"[CHÍNH HÃNG] Bột Rau Má Uống Liền Quảng Thanh có đường 10 gói - 15g mỗi gói - rau má tươi nguyên chất, tăng cường dinh dưỡng",89000,135000,46000,34
TIKI,bach-hoa-online,149520454,"Cây lăn lông mèo, chó - mẫu đơn giản (giao màu ngẫu nhiên)",15900,15900,0,0
TIKI,bach-hoa-online,120523357,"Bột chiên chuối BKB",60000,60000,0,0
TIKI,bach-hoa-online,162195527,"Xốt Gia Vị Hoàn Chỉnh Barona - Rô-Ti 80g",12800,12800,0,0
TIKI,bach-hoa-online,9840084,"Mắm tôm Lê Gia can 4,8L",268800,268800,0,0
TIKI,bach-hoa-online,138040121,"Dung Dịch Diệt Nấm API Pond Pimafix Cao Cấp",1697000,1697000,0,0
TIKI,bach-hoa-online,134286375,"(Combo 02 chai) Nước Mắm Tĩn Cá Cơm Vàng Ruột Đỏ Độ Đạm 60N Tự Nhiên Chai Thuỷ Tinh 250ml Nước Mắm Rin Nguyên Chất Truyền Thống Sạch Nước Mắm Nhỉ Từ Thùng Lều Gỗ Cốt Nhĩ Đặc Biệt Cá Cơm Vàng Ruột Đỏ Muối Tinh Khiết, Sánh Đặc Thịt Cá, Không Chất Bảo Quản",220000,360000,140000,39
TIKI,bach-hoa-online,155561798,"Sốt Cà Ri Ông Chà Và 100g (Curry Paste)",21000,21000,0,0
TIKI,bach-hoa-online,76470616,"Bột cỏ lúa mì hữu cơ Dragon superfoods 150gr Wheat grass Dragon superfoods 150gr",300000,410000,110000,27
TIKI,bach-hoa-online,10928422,"Trà Ô Long Tứ Quý Long Đỉnh (hộp 250 gram)",230000,230000,0,0
TIKI,bach-hoa-online,172632083,"Muối Sả Ớt Natas Hũ 60g-Muối Đa Năng",23000,23000,0,0
TIKI,bach-hoa-online,45544101,"Bột rau câu dẻo Jelly Rovin (Hộp 12 gói x 10g)",96000,96000,0,0
TIKI,bach-hoa-online,155560912,"Combo 2 Loại Tương Ông Chà Và 10g (1 Hộp Tương Ớt Gói 10g Và 1 Hộp Tương Cà Gói 10g)",135000,135000,0,0
TIKI,bach-hoa-online,111188304,"LẠC RANG HÚNG LÌU KHANG HY 400g",48000,48000,0,0
TIKI,bach-hoa-online,117101347,"Combo 02 bánh mỳ hoa cúc Harrys Brioche Mini 210g",201880,206000,4120,2
TIKI,bach-hoa-online,143911969,"tấm lót thảm lót vệ sinh cho chó mèo (miếng lẻ)",1248,1248,0,0
TIKI,bach-hoa-online,2245159,"Bắp Rang Uncle Jax Vị Trà Xanh (70g)",21000,21000,0,0
TIKI,bach-hoa-online,19910872,"Mắm Tép Ba Làng Thanh Hóa 1kg loại đặc biệt",139000,139000,0,0
TIKI,bach-hoa-online,64216049,"Hộp quà Cà phê Sáng tạo 8 Trung Nguyên",880000,880000,0,0
TIKI,bach-hoa-online,184297124,"Thức ăn cho mèo Reflex 2 kg - Hạt cho mèo",195555,195555,0,0
TIKI,bach-hoa-online,191476099,"Combo 5 Thanh Xúc Xích Cho Chó Mèo Giá Rẻ",1234,1234,0,0
TIKI,bach-hoa-online,166088529,"Combo 3 Đường đen nữ hoàng Biên Hòa 1kg/túi",165000,165000,0,0
TIKI,bach-hoa-online,189083423,"Lõi ngô/Cùi bắp (hàng nhập đã qua xử lý) lót chuồng hamster, bò sát, thỏ, bọ",75000,75000,0,0
TIKI,bach-hoa-online,95101277,"3 Túi Trà Thảo Mộc Kingtea( 2 túi 500g + 01 túi 200g) Tốt Cho Người Đau Dạ Dày, Ổn Định Huyết Áp, Hạ Men Gan , Mỡ Máu Và Ngăn Ngừa Ung Thư Giúp Ngủ Ngon",299000,299000,0,0
TIKI,bach-hoa-online,22881960,"1KG ĐẬU NÀNH SẤY GIÒN HIỆU TÂN LỘC PHÁT ( 2 HŨ PET)",92000,99000,7000,7
TIKI,bach-hoa-online,2154977,"Nước Ép Cherry Và Hỗn Hợp Rau Quả Malee 1L (Thái Lan)",72700,72700,0,0
TIKI,bach-hoa-online,143912875,"túi nilon đựng phân rác cho chó mèo thú cưng tự phân hủy",5000,5000,0,0
TIKI,bach-hoa-online,181361249,"Combo 2 Hộp Cà Phê Rang Xay Pha Phin Premium Blend - Lon 425gr (Vị đậm, mùi thơm, cafein 1%)",404000,404000,0,0
TIKI,bach-hoa-online,86803689,"Hạnh nhân sấy Hodi - NaVi hũ nhựa 250g",73950,87000,13050,15
TIKI,bach-hoa-online,138956329,"[Combo 20 lọ] Nước Yến sào Khánh Hòa Sanest đóng lọ 70ml",720000,720000,0,0
TIKI,bach-hoa-online,162735882,"Cà phê Rang Xay Arabica Cầu Đất 500g  - The Kaffeine Coffee",149000,149000,0,0
TIKI,bach-hoa-online,271400533,"Dầu Cá Omega 3 Kirkland Signature Fish Oil Bổ não, bổ mắt, Hỗ trợ sức khỏe tim mạch, khớp - Massel Official",776000,1552000,776000,50
TIKI,bach-hoa-online,5327521,"Trà Lúa Mạch Hàn Quốc Dongsuh Hộp 300G",86000,86000,0,0
TIKI,bach-hoa-online,165150035,"5kgCát Trắng Thạch Anh - Cát Trắng Sạch - Trang Trí cây cảnh  Bonsai - Phụ Kiện Hồ Cá - Thủy sinh - Cát lư hương",30000,30000,0,0
TIKI,thoi-trang-nam,48591554,"Quần Short Kaki Nam TO01",140000,140000,0,0
TIKI,thoi-trang-nam,15711596,"Áo Khoác Da Nam",438000,438000,0,0
TIKI,thoi-trang-nam,3714719,"Combo 5 Quần Lót Nam Freeman 6017CB5-XL (Size",356000,445000,89000,20
TIKI,thoi-trang-nam,106769474,"BỘ PIJAMA NAM cộc tay, PYJAMA COTTON 100%, PIZAMA họa tiết kẻ sọc-Shop Thủy Bông",410000,410000,0,0
TIKI,thoi-trang-nam,52251398,"Áo Thun Nam Cổ Bẻ Doka 4 Chiều Cao Cấp, Trẻ Trung (Nhiều Màu)",83000,119000,36000,30
TIKI,thoi-trang-nam,76416270,"Ao Ba Lỗ Nam Cao Cấp ABL01",28000,28000,0,0
TIKI,thoi-trang-nam,111710758,"Áo thun nam Áo polo nam ngắn tay có cổ PN02 Cotton 100% cao cấp phong cách Hàn Quốc",125000,125000,0,0
TIKI,thoi-trang-nam,176217605,"Quần Quần Đùi Nam Nữ Mặc Nhà Tắm Biển Quần Ngủ SATU Vải Thun Cotton Co Giãn Thoải Mái Thoáng Mát",29000,29000,0,0
TIKI,thoi-trang-nam,9354828,"Quần Jean Nam Xanh Đậm S20",145000,145000,0,0
TIKI,thoi-trang-nam,176769589,"Quần bơi big size cho nam giới béo mập, có size lớn đến 125kg, dáng sooc đùi dài, chất thun bơi lạnh dày dặn co giãn 4 chiều | BN017",180000,180000,0,0
TIKI,thoi-trang-nam,113705603,"QUẦN KAKI NAM TÚI MỸ VIỀN DÁNG SUÔNG TRUNG NIÊN",165000,165000,0,0
TIKI,thoi-trang-nam,76047427,"Áo thun Polo nam Novelty 200029N",252000,399000,147000,37
TIKI,thoi-trang-nam,82306488,"Quần Jean Nam cao cấp chất bò siêu co dãn Thương Hiệu Chandi, form đứng dáng đẹp mẫu mới siêu hot MR9083",194000,299000,105000,35
TIKI,thoi-trang-nam,151801252,"QUẦN LÓT NAM - Dạng Dây NỔI BẬT- Nâng Mông Nhẹ - Mặc Cực Đã",59000,59000,0,0
TIKI,thoi-trang-nam,15054816,"Áo Sơ Mi Nam Ngắn Tay SMH98 - SMH98",180000,180000,0,0
TIKI,thoi-trang-nam,98102105,"Quần short thể thao nam from rộng chất nỉ da cá dầy dặn",50000,50000,0,0
TIKI,thoi-trang-nam,163731428,"Quần bơi boxer nam loại đẹp dầy dặn, thiết kế chuyên nghiệp, chất thun bơi lạnh cao cấp mau khô, ôm gọn chống lộ | BN002",120000,120000,0,0
TIKI,thoi-trang-nam,78544461,"Áo Thun Ba Lỗ Nam Phong Cách Hàn Nhiều Màu",84000,84000,0,0
TIKI,thoi-trang-nam,55778935,"Áo Ba Lỗ Tank Top Thoáng Mát Không Viền Không Đường May Phong Cách Độc Lạ - Thời Trang Nam SZone SA485",49000,49000,0,0
TIKI,thoi-trang-nam,105304392,"Áo Phông Nam Polo Có Cổ Tay Ngắn Trơn Mùa Hè Cao Cấp ZERO",189000,300000,111000,37
TIKI,thoi-trang-nam,179162268,"(big size <140kg) Quần thể thao viền chân big size nam",180000,180000,0,0
TIKI,thoi-trang-nam,141000723,"Combo 3 quần lót nam không đường may Trunk Seamless iBasic PANM095 - 3",394000,477000,83000,17
TIKI,thoi-trang-nam,130773565,"Combo 4 quần lót nam Boxer thun lạnh lưng Thái cạp 4cm thấm hút mồ hôi, co giãn 4 chiều CITYMEN ( Màu Ngẫu Nhiên )",187000,187000,0,0
TIKI,thoi-trang-nam,183690994,"Áo Sơ Mi, Sơ Mi Nam Tay lỡ, cổ Vest phối Vai cách điệu, chất liệu không nhăn, không phai màu, mát mẻ sang trọng lịch lãm, trẻ trung, co giãn nhẹ hàng thiết kế tại xưởng mã T1",199000,199000,0,0
TIKI,thoi-trang-nam,30028312,"Áo sơ mi nam ngắn tay màu trắng cổ trụ chui đầu",159000,159000,0,0
TIKI,thoi-trang-nam,46694543,"QUẦN TÂY NAM QUẦN ÂU NAM THỜI TRANG DN20010513",99000,99000,0,0
TIKI,thoi-trang-nam,20104129,"Quần Jean Nam Slimfit S2222",137000,137000,0,0
TIKI,thoi-trang-nam,187900055,"Áo gile nam, áo gile nam túi hộp lính 1215",440000,440000,0,0
TIKI,thoi-trang-nam,95059774,"Áo khoác dù unisex form rộng trơn sọc phong cách ulzzang Wind",107000,107000,0,0
TIKI,thoi-trang-nam,188914141,"Tất Nam Cổ Thấp FASVIN Mềm Mịn Co Giãn Tốt TCT22904.HN",28000,28000,0,0
TIKI,thoi-trang-nam,22543488,"Quần Jogger Nam Chất Kaki Ống Bó Kiểu Dáng Thể Thao",89000,89000,0,0
TIKI,thoi-trang-nam,189596330,"Áo sơ mi nam xếp ly mặc Tuxedo Anlimen & Gentle Spread Collar",1370000,1370000,0,0
TIKI,thoi-trang-nam,163582097,"Áo sơ mi nam dài tay công sở trung niên thương hiệu Anton sợi tre họa tiết màu ghi -X8551",265000,325000,60000,18
TIKI,thoi-trang-nam,73398416,"Combo 4 Quần Sịp Nam Quần Lót Đùi Nam Boxer Thun lạnh Mềm Mịn Siêu Thoáng Mát, Co Giãn 4 Chiều Cao Cấp",89000,89000,0,0
TIKI,thoi-trang-nam,151799545,"QUẦN LÓT NAM - Tam Giác Nửa Mông - Thun Lạnh Siêu Mát",49000,49000,0,0
TIKI,thoi-trang-nam,106700067,"Quần jean baggy Vonesa nam nữ ống rộng , dáng xuông , không phai màu Q1",115000,115000,0,0
TIKI,thoi-trang-nam,3714765,"Combo 3 Quần Lót Nam Freeman 6023-CB3 (Size",213300,237000,23700,10
TIKI,thoi-trang-nam,129298361,"Quần kaki trung niên 2li túi thẳng chất cực đẹp",329000,329000,0,0
TIKI,thoi-trang-nam,172482571,"Áo PoLo Nam Ngắn Tay 5 Màu Thiết Kế Phong Cách Thời Trang Cao Cấp ZERO",100000,200000,100000,50
TIKI,thoi-trang-nam,151802696,"QUẦN LÓT NAM - TAM GIÁC THUN LẠNH - LƯỚI NHỎ THOÁNG MÁT",59000,59000,0,0
TIKI,the-thao-da-ngoai,163852970,"Mồi Câu Giả Cá Mồi Mềm 2 Lưỡi Mồi Cá Câu Lure, Mồi Câu Cá",22100,22100,0,0
TIKI,the-thao-da-ngoai,57383103,"Bộ đánh lửa sinh tồn mini cho những chuyến dã ngoại (tặng kèm còi chuyên dụng)",45000,45000,0,0
TIKI,the-thao-da-ngoai,272297441,"Sữa hổ trợ tăng cân tăng cơ Muscle Mass Gainer Chocolate 5,4kg + tặng Bình lắc",1650000,1650000,0,0
TIKI,the-thao-da-ngoai,163801652,"Trục Câu Đài Bộ Dây Câu Đơn Câu Đài Buộc Sẵn Cước Tàng Hình Dài 3m6 - 7m2",4700,4700,0,0
TIKI,the-thao-da-ngoai,33399458,"Dây Kéo Lưng Trợ Lực Cổ Tay Tập Gym Bản Cải Tiến Aolikes Lifting Straps AL-7633 (1 Đôi) ",175000,175000,0,0
TIKI,the-thao-da-ngoai,149606586,"Mồi cắm câu cá , trắm , chép , rô phi , trôi",16600,16600,0,0
TIKI,the-thao-da-ngoai,70564866,"Đèn Pin Đội Đầu 3 Bóng Led, 04 Chức Năng, Pin Sạc 9800Mah, 18650 4.2V - Hàng Chính Hãng",142600,155000,12400,8
TIKI,the-thao-da-ngoai,189591573,"Combo 3 Đôi Vớ Xỏ Ngón Thể Thao Chạy Bộ  Đạp Xe Leo Núi Aonijie E4802 Chất Liệu Coolmax  Thoáng Khí",524000,524000,0,0
TIKI,the-thao-da-ngoai,151676187,"CHÍNH HÃNG - ĐAI NẸP KHUỶU TAY NÂNG CAO Adv Sports Elbow - BONBONE NHẬT BẢN - Hỗ trợ chấn thương.",300000,500000,200000,40
TIKI,the-thao-da-ngoai,896407,"Túi Đeo Bụng Đựng Điện Thoại Tập Thể Dục Đại Việt Sport (39 x 10 cm) - Màu Ngẫu Nhiên ",120000,145000,25000,17
TIKI,the-thao-da-ngoai,36229722,"Gậy Bẻ Cơ Tay Lò Xo Tập Cơ Tay Power Twister 30 Kg PT30",46498,46498,0,0
TIKI,the-thao-da-ngoai,149591136,"  Bộ Phụ Kiện Câu Đài_Bộ Phụ Kiện Làm Trục,Thẻo Câu Đài_ Đồ Câu Cá ",32000,32000,0,0
TIKI,the-thao-da-ngoai,57154950,"Con lăn tập cơ bụng 1 bánh - màu ngẫu nhiên",169000,169000,0,0
TIKI,the-thao-da-ngoai,141075138,"Đầu Kim Bơm Bóng Đá Cao Cấp, Bơm Bóng Rổ, Bơm Bóng Chuyền, Bơm Bóng Ném - Cứng Cáp, Thiết Kế Vừa Vặn Các Loại Bóng",5000,5000,0,0
TIKI,the-thao-da-ngoai,163742920,"Cần Câu Lure Dyawa Carbon Cần Câu Cá Máy Ngang Và Máy Đứng Chống Xoắn Cao Cấp",186000,186000,0,0
TIKI,the-thao-da-ngoai,45852948,"Quần Thể Thao Nam Đen Sọc ONGTHUONG98 (Ống Thường)",75000,75000,0,0
TIKI,the-thao-da-ngoai,195524317,"Võ phục võ cổ truyền dành cho người lớn và trẻ em",200000,200000,0,0
TIKI,the-thao-da-ngoai,142251473,"Quần legging thể thao nam ngắn Devops CÓ TÚI form ôm lưng thun cao bó cơ combat tập gym đá bóng yoga",180000,180000,0,0
TIKI,the-thao-da-ngoai,52257480,"Bộ đồ tập gym - thể thao nam Freesize dưới 70kg -HM2020",90000,90000,0,0
TIKI,the-thao-da-ngoai,144405215,"Bóng Đôi Giãn Cơ, Massage Trị Liệu",69000,69000,0,0
TIKI,the-thao-da-ngoai,141637623,"Siêu Khuyến Mãi 1 kg Bi Sắt 6mm, 7mm, 8mm - Đồ câu 24h - Cần Câu Top1 VN",41900,41900,0,0
TIKI,the-thao-da-ngoai,162522813,"Túi đựng cần câu 3 ngăn lớn và ngăn phụ chống thấm nước cao cấp Wago",279998,279998,0,0
TIKI,the-thao-da-ngoai,141827877,"DỒ CÂU LINH NGỌC xả hàng Vó Bắt Tôm, Cua, Cá, Tép.. ĐỒ CÂU LINH NGỌC",39987,39987,0,0
TIKI,the-thao-da-ngoai,162519554,"DÂY NHẢY CAO CẤP ADIDAS ADRP-13011",347000,359000,12000,3
TIKI,the-thao-da-ngoai,5061787,"Túi chống nước Ocean Pack Sportslink",78000,86000,8000,9
TIKI,the-thao-da-ngoai,173844720,"quả bóng bàn DHS hộp 6 quả",75000,75000,0,0
TIKI,the-thao-da-ngoai,72869927,"Bóng tập Yoga Nửa Gai + Nửa Trơn 3D -65cm Cao Cấp 1200Gram – Tặng kèm bơm( Hàng Cao Cấp Chính hãng)",135000,240000,105000,44
TIKI,the-thao-da-ngoai,139936481,"BỘ MỒI HƠI 6 CON MỒI SIÊU NHẠY CÁ KÈM PHỤ KIỆN CHUYÊN CÂU LURE, LÓC, RÔ, MƯƠNG",120000,120000,0,0
TIKI,the-thao-da-ngoai,162167458,"Giày Bóng Rổ Thời Trang Thể Thao PEAK Taichi Colorful 6371 E13747E",819000,1590000,771000,48
TIKI,the-thao-da-ngoai,156058625,"Mồi Câu Giả Tôm Mềm",22100,22100,0,0
TIKI,the-thao-da-ngoai,58723933,"ÁO SÁT NÁCH FITNESS THỂ THAO TẬP GYM - BÓNG RỔ CAO CẤP THUN LỖ KIM SZONE SA473",105000,105000,0,0
TIKI,the-thao-da-ngoai,138706067,"Vợt Cá Carbon Vành Tròn Có thể thu gọn chuyên dụng câu đài vợt cá câu đài",130175,130175,0,0
TIKI,the-thao-da-ngoai,73173470,"Chai xịt chống mờ kính bơi, kính cận SAEKO - Chống bám hơi nước và sương mù AS04 - SHOP TOÀN CHÂU",135000,135000,0,0
TIKI,the-thao-da-ngoai,190487966,"Túi Ngủ NH LW180",380000,380000,0,0
TIKI,the-thao-da-ngoai,82484211,"Còi Thổi Báo Động Khẩn Cấp Khi Đi Cắm Trại, Dã Ngoại (Màu Ngẫu Nhiên)",6900,6900,0,0
TIKI,the-thao-da-ngoai,132777706,"Tấm tăng ,tấm trải ngồi lót lều hay che võng Rằn ri",99000,99000,0,0
TIKI,the-thao-da-ngoai,100369483," Quần đùi nam Fasvin Q21461.HN vải gió chun co giãn mềm mại thoải mái vận động",99000,198000,99000,50
TIKI,the-thao-da-ngoai,35324160,"Đệm Lót Mút Xốp Hỗ Trợ Gánh Tạ Squat Barbell Pad Valeo",125000,125000,0,0
TIKI,the-thao-da-ngoai,156001889,"SALE LỚN ô dù đội đầu 2 tầng ô câu cá loại 1 siêu mát",48500,48500,0,0
TIKI,the-thao-da-ngoai,151450936,"Túi Đeo Bụng, Đai Đeo Bụng Nam Nữ Đa Năng Đựng Điện Thoại Tập Gym Chạy Bộ, Đi Xe Đạp, Leo Núi Chơi Thể Thao Tiện Lợi",22106,31931,9825,31
TIKI,thoi-trang-nam,141109930,"Quần jogger unisex thể thao, quần ống rộng kiểu dáng jogger mặc nhà nam nữ vải TỔ ONG 3 màu năng động",83000,83000,0,0
TIKI,thoi-trang-nam,107338883,"Áo thun Nam Nữ Vonesa, áo phông Unisex Nam Nữ có Size từ 25-84kg B7",40000,40000,0,0
TIKI,thoi-trang-nam,172120849,"Áo Polo Nam kiểu dáng Vintage Slub hãng JohnSton&Murphy hàng xuất Mỹ đủ màu phù hợp cả trang phục công sở lịch lãm",375000,375000,0,0
TIKI,thoi-trang-nam,113233457,"Quần đùi nam xuất khẩu, quần đùi mặc nhà chất kate cotton cao cấp  thương hiệu Fezzio",42500,85000,42500,50
TIKI,thoi-trang-nam,66683004,"Áo Khoác Nam Vải Kaki 2 Lớp Mặc Bốn Mùa Kiểu Dáng Thời Trang",474050,499000,24950,5
TIKI,thoi-trang-nam,31594559,"Áo khoác da cá GOKING 6 túi, form unisex cho nam nữ, trẻ em. Áo chống lạnh, giữ ấm, chống nắng. Hàng hiệu cao cấp vnxk",295000,295000,0,0
TIKI,thoi-trang-nam,181113990,"Áo polo nam có cổ cao cấp LADOS-9089 thêu đầu hươu, phối 2 màu trắng đen sang trọng, thoáng khí siêu mát mẻ",169000,318000,149000,47
TIKI,thoi-trang-nam,83489010,"Áo Khoác Nam, Khoác Dù Nam 2 lớp phối nón thời trang hàn quốc trẻ trung cuốn hút Thương Hiệu Chandi chất liệu thấm hút mồ hôi dày dặn mặc thoáng mát mẫu M123",143000,299000,156000,52
TIKI,thoi-trang-nam,75945178,"áo hoodie hoạt hình, áo hoodie cute, áo hoodie han quốc, áo hoodie cá tính, áo hoodie nam nữ, áo hoodie nữ, áo hoodie nam, áo hoodie ulzzang, áo hoodie unisex",100000,100000,0,0
TIKI,thoi-trang-nam,74385119,"Áo Khoác Nam Big Size Áo Khoác Dù Nam Hai Lớp Cổ Cao Chống Nắng Chống Lạnh Chống Gió Chống Tia UV Hàn Quốc Cao Cấp QD62 - ShopN6 (Nhiều Màu)",135000,240000,105000,44
TIKI,thoi-trang-nam,100868615,"Áo sơ mi FLANNEL kẻ caro Unisex phong cách streetswear, Kẻ Caro Nam Nữ Form rộng Phong Cách, Áo Sơ Mi Khoác Ngoài Cao Cấp Siêu Đẹp, Áo khoác sowmi unisex form rộng CARO nam nữ phong cách ulzzang",95000,95000,0,0
TIKI,thoi-trang-nam,176789536,"Áo bơi tay ngắn nam 401",119000,119000,0,0
TIKI,thoi-trang-nam,59556296,"Combo 3 Chiếc Quần Lót Nam Cao Cấp Aristino ABF01807 Chất liệu Cotton Chitosan Thuần Khiết (Giao Màu Ngẫu Nhiên) - Hàng Chính Hãng",255000,315000,60000,19
TIKI,thoi-trang-nam,14450071,"Quần Bò Nam Đen Rách Gối RACHGOI97 (Rách Gối)",168000,168000,0,0
TIKI,thoi-trang-nam,196603717,"Quần tây nam 0Ply Novelty màu đen Regular fit NQTMMDNTRR2202880",479000,479000,0,0
TIKI,thoi-trang-nam,87094676,"Bộ bơi đôi dài tay Nam và Nữ, set 3 chi tiết quần dài chống nắng, đồ bơi cho couple, có size nhỏ cho bé mặc đồ gia đình | KT022 | BN022",520000,520000,0,0
TIKI,thoi-trang-nam,19639438,"quần jean dài nam trơn thời trang",110000,110000,0,0
TIKI,thoi-trang-nam,197675716,"Áo sơ mi nam dài tay màu đen dáng suông May 10 mã 010122912L2",295000,295000,0,0
TIKI,thoi-trang-nam,98986504,"Áo thun Teeworld Sài Gòn - Everything you need to know Form Rộng Unisex Nam Nữ",299000,299000,0,0
TIKI,thoi-trang-nam,163896997,"Áo Sơ Mi Nam Trắng Trơn Dài Tay Công Sở Trung Niên Thương Hiệu Anton Vải Nano Chống Nhăn - SRD05",295000,355000,60000,17
TIKI,thoi-trang-nam,150748227,"Áo Thể Thao Nam TSIMPLE cổ tròn tay ngắn tập gym vải thun lạnh thoáng mát co giãn chuẩn form MSSAHP5",165000,165000,0,0
TIKI,thoi-trang-nam,92807600,"Quần short kaki Amazing, lưng thun có giây rút, vải kaki dày dặn, co giãn nhẹ, nhiều màu, có size lớn",159000,239000,80000,33
TIKI,thoi-trang-nam,13677604,"Áo khoác nam không bo lai Phúc An 2026",195000,195000,0,0
TIKI,thoi-trang-nam,67201856,"Set 2 áo ba lỗ nam, áo 3 lỗ nam, sợi cotton mềm mịn, thấm hút mồ hôi tốt, thoáng mát, mặc thoải  mái",36000,36000,0,0
TIKI,thoi-trang-nam,13629284,"Quần Short unisex Nam Cotton SV2",63000,63000,0,0
TIKI,thoi-trang-nam,195192891,"Quần Gió Nam Thể Thao FASVIN Vải Gió Đẹp Hàng Nhà Máy Chất Lượng Cao Dùng Khi Thể Thao Hay Mặc Nhà DC20423.HN",185000,298000,113000,38
TIKI,thoi-trang-nam,169621343,"Viettien - Áo sơ mi nam ngắn tay họa tiết vạt bầu 1N1868 regular",395000,395000,0,0
TIKI,thoi-trang-nam,174001966,"Quần Jean nam Leman xanh trơn JD03 - Slim Form",455000,549000,94000,17
TIKI,thoi-trang-nam,74554228,"Áo Khoác Big Size Áo Khoác Dù Dày Bomber Nam Nữ Chống Nắng Chống Lạnh Chống Gió Lót Nỉ Hai Lớp Hàn Quốc Cao Cấp QD66 - ShopN6",155000,235000,80000,34
TIKI,thoi-trang-nam,84872072,"Set đồ bơi nam full 5 chi tiết kèm túi đựng, Quần bơi da cá + Kính bơi + Mũ + Bịt tai + Kẹp mũi, hàng xịn đẹp chuẩn | BN009",320000,320000,0,0
TIKI,thoi-trang-nam,111990270,"Quần Kaki Nam Đẹp Dáng Hàn Lưng Thun Tiện Dụng Form Slim Fit Cực Đẹp QK045",103000,103000,0,0
TIKI,thoi-trang-nam,193976862,"Quần Jean nam Leman xanh mài rêu JD12 - Slim Form",455000,549000,94000,17
TIKI,thoi-trang-nam,75358011,"Big size, short kaki lưng thun unisex, quần sọt nam thương hiêu Amazing, phong cách thể thao",159000,239000,80000,33
TIKI,thoi-trang-nam,98624377,"Quần Sọt Nam ️️ Quần Short Jean Nam Đen Phối Rách Chất Bò Cao Cấp Chuẩn Hàng Shop Tô Tồ Shop - QSJNM232",138000,138000,0,0
TIKI,thoi-trang-nam,52863921,"Áo vest nam phong cách Hàn Quốc nhiều màu",185000,185000,0,0
TIKI,thoi-trang-nam,190154616,"Quần kaki dài nam việt tiến màu xám sáng có 1ly và không ly 6R6013 - 6R6012 Regular",785000,785000,0,0
TIKI,thoi-trang-nam,130029611,"Áo Hoodie Nỉ Nam Nữ From Rộng Unisex In Dạ Quang Phát Sáng Hình Gấu Cực Hot Chất Nỉ Ngoại Dày Dặn (bear)",109000,109000,0,0
TIKI,thoi-trang-nam,72747384,"Áo khoác dù nam form rộng",127900,127900,0,0
TIKI,thoi-trang-nam,196207027,"Áo thun Teeworld Sài Gòn Retro Nam Nữ Trắng Đen Form Rộng Unisex",359000,359000,0,0
TIKI,thoi-trang-nam,31202048,"Quần tây nam không ply ống đứng Khatoco Q1M528R0-CNMA032-2105-0",422400,528000,105600,20
TIKI,the-thao-da-ngoai,193894382,"Tất Xỏ 5 Ngón Thể Thao Aonijie E4825 - Thoáng Khí, Chống Phồng Rộp, Công Nghệ Coolmax",180000,180000,0,0
TIKI,the-thao-da-ngoai,141634929,"Máy câu cá yf có sẵn 100 m cước 4000-7000",120550,120550,0,0
TIKI,the-thao-da-ngoai,25761844,"Băng đô thể thao co dãn (Đen)",19000,19000,0,0
TIKI,the-thao-da-ngoai,142262505,"Quần legging thể thao nam Devops body poly cao cấp co giãn  bó cơ chạy bộ đạp xe gym fitness work out bơi DET1005",180000,180000,0,0
TIKI,the-thao-da-ngoai,139946663,"Lăng xê lò so câu cá Siêu rẻ, siêu đẹp, siêu chất lượng [ docau.abc ]",1200,1200,0,0
TIKI,the-thao-da-ngoai,137015847,"Cước Câu Cá 500m dây câu cá Siêu Bền - Sanami Fishing",27776,27776,0,0
TIKI,the-thao-da-ngoai,144404357,"Găng Tay Tập Gym Nam Nữ SND | Găng Tay Thể Thao Bảo Vệ Cổ Tay",115000,115000,0,0
TIKI,the-thao-da-ngoai,162157152,"Băng thun bó ống quần nịt chân bảo hộ",9999,9999,0,0
TIKI,the-thao-da-ngoai,190093770,"Dây tập yoga cotton dài 1,8m POPO YGT11 đa năng tập cơ tay, chân, lưng",30000,30000,0,0
TIKI,the-thao-da-ngoai,188694961,"Lều cắm trại Tenda Compass 4 người",850000,850000,0,0
TIKI,the-thao-da-ngoai,52317413,"Dây Nhảy Thể Dục Có Bộ Đếm Số Vòng Nhảy -  Giúp Bạn Dễ Dàng Tập Thể Dục Khi Ở Nhà (1 Cái, Màu Ngẫu Nhiên)",18000,20200,2200,11
TIKI,the-thao-da-ngoai,8157257,"Combo Bộ ván trượt mặt nhám cao cấp + Bộ bảo hộ an toàn (Giao màu ngẫu nhiên)",399000,600000,201000,34
TIKI,the-thao-da-ngoai,149757140,"Dụng cụ tập cơ bụng đa năng hỗ trợ gym gập tại nhà có đế hút chân không giúp cho dáng chuẩn vòng eo thon",64000,64000,0,0
TIKI,the-thao-da-ngoai,77753970,"Áo bra tập gym nữ Fitme Zeta chất thun co giãn thấm hút tốt, chuyên tập gym và yoga cao cấp",89000,89000,0,0
TIKI,the-thao-da-ngoai,54089240,"Quần legging nữ CLEACCO  tập gym, quần yoga chất vải Dệt thoáng mát , co giãn 4 chiều",118000,201000,83000,41
TIKI,the-thao-da-ngoai,93289804,"Bộ Tạ Tay 3kg Bọc Cao Su Trơn Lõi Thép Cao Cấp Chính Hãng Đại Nam Sport (Tổng 6kg)-Giao Màu Ngẫu Nhiên",419000,550000,131000,24
TIKI,the-thao-da-ngoai,192563145,"Băng quấn cổ tay KUNOSPORT bảo vệ trật khớp tay thể thao, băng quấn cổ tay xỏ ngón - KN16",65000,105000,40000,38
TIKI,the-thao-da-ngoai,72010896,"Đai nịt bụng thể thao hỗ trợ giảm mỡ khi tập Gym HY012",99000,99000,0,0
TIKI,the-thao-da-ngoai,5199493,"Túi đeo hông thể thao GTXSports Sportslink",60000,66000,6000,9
TIKI,the-thao-da-ngoai,148941881,"Bộ cần câu máy rút gọn giá rẻ 1m8, 2m1, 2m4, 2m7, 3m0, 3m6 kèm máy và phụ kiện",35000,35000,0,0
TIKI,the-thao-da-ngoai,28730936,"Giỏ Lưới Đựng Cá gấp gọn (3 Vòng) có dây rút  ,  lồng phơi rau củ, trái cây",29000,29000,0,0
TIKI,the-thao-da-ngoai,75950830,"Bộ tạ miếng nhựa đen PVC 10KG đa năng thiết kế mới nhất Cao Cấp ",290000,400000,110000,28
TIKI,the-thao-da-ngoai,33915901,"Giày Đá Bóng Sân Cỏ Nhân Tạo MS12 Trắng Sọc Đen",160000,160000,0,0
TIKI,the-thao-da-ngoai,184415359,"Set đồ tập yoga gym Hibi Sports H142 quần lửng lưng cao, áo bra dây đan kèm mút ngực",499000,590000,91000,15
TIKI,the-thao-da-ngoai,131395994,"Ghế Câu Cá, Câu Đài, Ghế Xếp Dã Ngoại Thu Gọn Tiện Lợi",102000,102000,0,0
TIKI,the-thao-da-ngoai,38436746,"Thảm Tập Yoga Định Tuyến Da PU Cao Cấp Amalife + Túi Đựng Thảm Tập Yoga Định Tuyến + Dây Buộc Thảm Tập Yoga Định Tuyến",359000,359000,0,0
TIKI,the-thao-da-ngoai,186753061,"Giày Bóng Rổ Cổ Cao Cury06- Giày Sneaker chơi bóng rổ",425000,628000,203000,32
TIKI,the-thao-da-ngoai,273942102,"Thực phẩm tăng cơ Rule 1 Protein Isolate/Hydrolysate 9.8lb tặng bình lắc R1 Shaker",2821500,2970000,148500,5
TIKI,the-thao-da-ngoai,140101715,"Thảm Yoga Định Tuyến Cao Su Thiên Nhiên PU Cao Cấp - YOGA QG, Chống Trơn Trượt, Độ Đàn Hồi Tốt, Thấm Hút Mồ Hôi, Thân Thiện Với Môi Trường, An Toàn Với Làn Da, Đường Định Tuyến In Rõ Rét - Hàng chính hãng",358000,415000,57000,14
TIKI,the-thao-da-ngoai,62721597,"Kính bơi Cleacco Polycarbonate cao cấp chống sương mù , tia cực tím tặng kèm bịt tai và đệm mũi",279000,404000,125000,31
TIKI,the-thao-da-ngoai,92083709,"BG Máy chạy bộ điện đơn năng Model M2 TREADMILL (hàng nhập khẩu)",5692000,5692000,0,0
TIKI,the-thao-da-ngoai,12269351,"Xe đạp tập thể dục thể thao tại nhà BG Mẫu S303 (hàng nhập khẩu)",1799000,2999000,1200000,40
TIKI,the-thao-da-ngoai,18006553,"Xà Đơn Gắn Cửa Treo Tường Có Chốt Chống Xoay 2018 size 60-100,80-130 (màu sọc xanh)",156000,250000,94000,38
TIKI,the-thao-da-ngoai,192047006,"Giày thể thao nữ Anta Lifestyle Anta 822328063",700000,1359000,659000,48
TIKI,the-thao-da-ngoai,94038174,"Đĩa xoay giảm eo 360 độ, bàn xoay lắc massage tập bụng eo thon, tập gym tại nhà đường kính 25cm",37780,37780,0,0
TIKI,the-thao-da-ngoai,141617894,"Cước câu cá cước mỹ triline 500m tàng hình siêu tải",48000,48000,0,0
TIKI,the-thao-da-ngoai,131396038,"Nhái Hơi Câu Lure, Nhái Giả Câu Cá Lóc, Cá Chuối",13489,13489,0,0
TIKI,the-thao-da-ngoai,104669374,"GIÀY ĐÁ BÓNG SÂN CỎ NHÂN TẠO PEACE PS1217",499000,499000,0,0
TIKI,the-thao-da-ngoai,54700131,"Giày đá bóng sân cỏ nhân tạo 3 sọc khâu full đế",109000,109000,0,0
TIKI,the-thao-da-ngoai,75781135,"Quả Bóng Đá (BoMa_32_Đỏ) - Số 5 - Tiêu chuẩn thi đấu - Tặng Bơm, Kim bơm, Túi Lưới",89000,89000,0,0
TIKI,cross-border-hang-quoc-te,185329850,"Thắt lưng da bò CAMEL khóa tự động cho nam",457000,457000,0,0
TIKI,cross-border-hang-quoc-te,196949836,"Áo Thun Thể Thao Nữ CAMEL, Áo Hở Eo Làm Mát Thường Ngày Mùa Hè Áo Trơn Tập Yoga Tay Ngắn Cho Nữ Dành Cho Nữ",417000,417000,0,0
TIKI,cross-border-hang-quoc-te,190320464,"Giày chạy bộ nam CAMEL CROWN Lớp Có đệm không trượt Chịu mài mòn Thở nhẹ",961000,961000,0,0
TIKI,cross-border-hang-quoc-te,207005187,"CAMEL CROWN Cốc Titan Cắm Trại Bộ Đồ Ăn Du Lịch Ngoài Trời Thiết Bị Nấu Ăn Dã Ngoại Đi Bộ Đường Dài Du Lịch",788000,788000,0,0
TIKI,cross-border-hang-quoc-te,191004714,"Ba lô leo núi chuyên nghiệp ngoài trời CAMEL CROWN 40L",1492000,1492000,0,0
TIKI,cross-border-hang-quoc-te,11534299,"It Ends With Us",359000,359000,0,0
TIKI,cross-border-hang-quoc-te,209568752,"Streetwear Casual Jogger Cargo Pants  Hiking Trousers Outdoor Gray_S",379000,379000,0,0
TIKI,cross-border-hang-quoc-te,204601749,"Vỏ Bọc Ghế Ngồi Bàn Ăn Co Giãn Dày Dặn Tiện Dụng Cho Gia Đình",238200,238200,0,0
TIKI,cross-border-hang-quoc-te,201505379,"CAMEL thể thao nữ quần tất mỏng chạy thể dục quần cạp cao cạp cao",390000,390000,0,0
TIKI,cross-border-hang-quoc-te,17965475,"Steal Like an Artist: 10 Things Nobody Told You About Being Creative",438000,438000,0,0
TIKI,cross-border-hang-quoc-te,115902462,"Phích chuyển đổi sạc 3 chân - Giắc cắm điện chuyển đổi ổ 3 chấu thành 2 chấu",15000,15000,0,0
TIKI,cross-border-hang-quoc-te,113954381,"4 chiếc Giày chống thấm nước, chống trượt cho chó-Size",369000,369000,0,0
TIKI,cross-border-hang-quoc-te,189594348,"Thảm tập yoga CAMEL hai mặt chống trượt (5mm)",2130000,2130000,0,0
TIKI,cross-border-hang-quoc-te,191316017,"Đồ bơi Nữ CAMEL CROWN Bikini Hai Mảnh Tam Giác Sling",500000,500000,0,0
TIKI,cross-border-hang-quoc-te,186633889,"Ba Lô CAMEL CROWN Thể Thao Ngoài Trời 30L Ba Lô Giải Trí Cắm Trại Du Lịch Đi Bộ Đường Dài",1215000,1215000,0,0
TIKI,cross-border-hang-quoc-te,170692846,"Sách - On Earth We're Briefly Gorgeous : A Novel by Ocean Vuong (US edition, paperback)",473000,473000,0,0
TIKI,cross-border-hang-quoc-te,207966543,"Áo khoác nam CAMEL Mùa xuân và mùa thu áo khoác thể thao nam chống gió chống nước ngoài trời quần áo áo khoác leo núi quần áo",1530000,1530000,0,0
TIKI,cross-border-hang-quoc-te,176304381,"Sách - Tuesdays with Morrie: an Old Man, a Young Man, and Life's Greatest Lesson by Mitch Albom (US edition, paperback)",247650,247650,0,0
TIKI,cross-border-hang-quoc-te,248885790,"Đồ bơi một mảnh CAMEL CROWN thời trang tùy chọn kích thước dành cho nữ",807000,807000,0,0
TIKI,cross-border-hang-quoc-te,151548619,"Sách - The Song of Achilles : Bloomsbury Modern Classics by Madeline Miller - (UK Edition, paperback)",439000,439000,0,0
TIKI,cross-border-hang-quoc-te,203812989,"Quần đùi short gió nam CAMEL thể thao Basic trẻ trung năng động",403000,403000,0,0
TIKI,cross-border-hang-quoc-te,17970408,"How to Love (Mindfulness Essentials) - New Cover ",291000,291000,0,0
TIKI,cross-border-hang-quoc-te,109435197,"Loa máy tính có cáp âm thanh 2 * 3,5mm cho Mic SADA V-103-Màu đen",416000,416000,0,0
TIKI,cross-border-hang-quoc-te,17970237,"Picture Of Dorian Gray (Feb 03)",289200,289200,0,0
TIKI,cross-border-hang-quoc-te,108227401,"Tấm bảo vệ màn hình chống ánh sáng xanh cho máy tính với khung hình 16: 9 -Size 14 "16 & 9",172000,172000,0,0
TIKI,cross-border-hang-quoc-te,205405312,"Áo Thun Lông Cừu Nam CAMEL, Áo Dài Tay Cổ Tròn Mùa Thu Áo Thun Ấm Áp Đơn Giản Mùa Đông",686000,686000,0,0
TIKI,cross-border-hang-quoc-te,109164159,"Túi đựng hành lí khi đi xe đạp, Túi Trunk, túi đặt yên sau xe đạp",464000,464000,0,0
TIKI,cross-border-hang-quoc-te,191781146,"Sách - Beyond O.rder : 12 More Rules for Life by Jordan B. Peterson (UK edition, paperback)",396000,396000,0,0
TIKI,cross-border-hang-quoc-te,205051050,"Áo Khoác Gió CAMEL Cho Nam Áo Áo Khoác Nam Mùa Đông Thể Thao Có Mũ Chống Gió Mùa Thu Nam Thường Ngày Áo Khoác Gió Chữ",1401000,1401000,0,0
TIKI,cross-border-hang-quoc-te,114051039,"Sách - High Output Management by Andrew S. Grove - (US Edition, paperback)",469000,469000,0,0
TIKI,cross-border-hang-quoc-te,195282895,"Nước Uống Đẹp Da Liquid Collagen One Per Day Drink Mix Mỹ",589000,589000,0,0
TIKI,cross-border-hang-quoc-te,17966282,"Wine Folly: Magnum Edition",999000,999000,0,0
TIKI,cross-border-hang-quoc-te,176463031,"Sách - Prisoners of Geography : Ten Maps That Tell You Everything You Need to Kn by Tim Marshall (UK edition, paperback)",394000,394000,0,0
TIKI,cross-border-hang-quoc-te,170695688,"Sách - A Good Girl's Guide to Murder by Holly Jackson (US edition, paperback)",406000,406000,0,0
TIKI,cross-border-hang-quoc-te,7917829,"Good To Great: Why Some Companies Make The Leap",394000,394000,0,0
TIKI,cross-border-hang-quoc-te,190320464,"Giày chạy bộ nam CAMEL CROWN Lớp Có đệm không trượt Chịu mài mòn Thở nhẹ",961000,961000,0,0
TIKI,cross-border-hang-quoc-te,113401672,"Sách - Your Money or Your Life: 9 Steps to Transforming Your Relationship with Money and Achieving Financial Independence: Fully Revised and Updated by Vicki Robin,Joe Dominguez,Mr. Money Mustache - (US Edition, paperback)",529000,529000,0,0
TIKI,cross-border-hang-quoc-te,46362176,"Tai Thay Thế Miếng Lót Đệm Tai Nghe Sony MDR-V150 V250 V300 V100 V200 V400 ZX100 ZX300 Tai Nghe",157000,157000,0,0
TIKI,cross-border-hang-quoc-te,163159382,"Sách - The Concise Mastery by Robert Greene (UK edition, paperback)",354000,354000,0,0
TIKI,cross-border-hang-quoc-te,17966869,"The 48 Laws Of Power by Robert Greene",549000,549000,0,0
TIKI,cross-border-hang-quoc-te,52834154,"Thông Gió Miếng Dán Mũi Cho Nghẹt Mũi Giảm Ngáy",167000,167000,0,0
TIKI,cross-border-hang-quoc-te,7917827,"Intelligent Investor, The",545000,545000,0,0
TIKI,cross-border-hang-quoc-te,273115068,"Christmas Tabletop Decorations Christmas Centerpiece for Home Office Kitchen",209000,209000,0,0
TIKI,cross-border-hang-quoc-te,113349197,"Sách - How to Fight by Thich Nhat Hanh Jason Deantonis - (UK Edition, paperback)",236000,236000,0,0
TIKI,cross-border-hang-quoc-te,11573091,"HOLY BIBLE: King James Version (KJV) Popular Gift & Award Black Leatherette Edition: Authorized King James Version (Bible Akjv)",439000,439000,0,0
TIKI,the-thao-da-ngoai,89476448,"Bộ Tạ Loại 1kg bọc cao su (Tổng 2kg)",116000,230000,114000,50
TIKI,cross-border-hang-quoc-te,112018071,"Giá đỡ bánh xe đạp chuyên dụng chất lượng cao trong nhà có thể gập lại được",587000,587000,0,0
TIKI,the-thao-da-ngoai,158615618,"Bàn Xếp Gấp Gọn Du Lịch Và Dã Ngoại Dễ Mang Theo Khi Đi Cắm Trại Picnic Ăn Uống Cùng Gia Đình - Hàng Chính Hãng",626000,626000,0,0
TIKI,cross-border-hang-quoc-te,165017868,"Sách - Seven Husbands of Evelyn Hugo : Tiktok made me buy it! by TAYLOR JENKINS REID (UK edition, paperback)",399000,399000,0,0
TIKI,the-thao-da-ngoai,55463985,"Ống lăn massage gai 33cm- CON LĂN MASSAGE TẬP YOGA GAI  Thể Dục Thẩm Mỹ Gym Massage Giãn Cơ Tập Tạ - Chất liệu EVA PVC Cao Cấp",200000,200000,0,0
TIKI,the-thao-da-ngoai,173277026,"Giày Thể Thao Nam Biti's Hunter Core 3D-Airmesh Grey DSMH08700XAL (Xám)",662000,736000,74000,10
TIKI,the-thao-da-ngoai,180567273,"Đồ bơi nam quần lửng áo cộc tay đẹp",330000,330000,0,0
TIKI,cross-border-hang-quoc-te,2043735,"The Culture Map: Decoding How People Think, Lead, And Get Things Done Across Cultures",481000,481000,0,0
TIKI,the-thao-da-ngoai,143808230,"Đai dù (phụ kiện) cho dụng cụ kéo giãn đốt sống cổ, vật liệu vải dù DAIKC01",79000,79000,0,0
TIKI,cross-border-hang-quoc-te,195520240,"Áo thun polo CAMEL áo thun có cổ mùa hè ngắn tay ve áoáo thun nam XBB192157",586000,586000,0,0
TIKI,the-thao-da-ngoai,146763912,"Gối Ngủ Du Lịch Chất Liệu Memory Foam Mật Độ Cao - Gối Ngủ Văn Phòng Thông Minh Cao Cấp Chính Hãng Dododios – Kèm Túi Vải Nhung Đựng Gối Ngủ Chữ U Văn Phòng",349000,349000,0,0
TIKI,the-thao-da-ngoai,185966772,"Bộ Tăng Dã Ngoại Cắm Trại Lục Giác Naturehike NH16T012-S",1490000,1490000,0,0
TIKI,the-thao-da-ngoai,177061983,"Bộ đồ chơi bóng rổ trẻ em",115000,115000,0,0
TIKI,cross-border-hang-quoc-te,102428769,"2 Piece Replacement  Wrist Strap for Misfit Ray Fitness Tracker",119000,119000,0,0
TIKI,the-thao-da-ngoai,213868966,"Sữa Tăng Cân Tăng Cơ Mass Tech Elite 6lbs (~2.72kg) - Nhiều Hương Vị - Hàng Nhập Khẩu Chính Hãng Muscletech - Kèm Quà Tặng",1495000,1875000,380000,20
TIKI,the-thao-da-ngoai,117391192,"Lưỡi Câu Cá Đôi Buộc Sẵn Chuyên Câu Đài",33000,33000,0,0
TIKI,the-thao-da-ngoai,56866299,"Túi ngủ văn phòng du lịch V2108 (Giao màu ngẫu nhiên)",115000,115000,0,0
TIKI,the-thao-da-ngoai,92807916,"La bàn kim loại cầm tay bỏ túi 70mm ",33950,33950,0,0
TIKI,the-thao-da-ngoai,162042284,"Giàn Tạ Đa Năng Zasami Có xà đơn xà kép gồm 1 đòn tạ 1m5 - Lựa chọn mức tạ đĩa nhựa ngẫu nhiên",5500000,7250000,1750000,24
TIKI,the-thao-da-ngoai,271392535,"Viên Sủi GU ENERGY Hydration Drink Tabs - Ống 12 Viên - Bổ Sung Nước Và Điện Giải Khi Hoạt Động Thể Thao - Ống 12 viên",185000,185000,0,0
TIKI,the-thao-da-ngoai,10689279,"Thảm tập yoga định tuyến PU Liforme 4.2mm",4197000,4617000,420000,9
TIKI,cross-border-hang-quoc-te,174400333,"Sách - The Power of Geography : Ten Maps That Reveal the Future of Our World by Tim Marshall (UK edition, paperback)",384000,384000,0,0
TIKI,cross-border-hang-quoc-te,109435783,"Nút tai silicon Bluedio NE -40dB Giảm tiếng ồn Cách âm Bảo vệ tai Chống ồn khi ngủ và đi bơi",150000,150000,0,0
TIKI,the-thao-da-ngoai,10785162,"Lều 2 Người Phượt Cắm Trại Du Lịch Galaxy Store Tetragon 2PLE01 Hàng Xuất Khẩu Châu Âu (Màu Ngẫu Nhiên)",579000,920000,341000,37
TIKI,the-thao-da-ngoai,76696769,"Thảm Fitness Yoga Adidas 10mm ADMT-11015",1098000,1208000,110000,9
TIKI,cross-border-hang-quoc-te,190229589,"Vỉ 6 Hộp Chỉ Nha Khoa Oral-B Glide Advanced Multi-Protection Floss Mỹ 44m(hộp)",446000,446000,0,0
TIKI,the-thao-da-ngoai,16997248,"Bình Nước Xếp Gọn Du Lịch Cắm Trại Dã Ngoại Naturehike NH14S002-T",90000,90000,0,0
TIKI,bach-hoa-online,24941640,"Combo 2 hủ gạo lứt cháy tỏi Dương Cát 300gr",127200,127200,0,0
TIKI,the-thao-da-ngoai,89477087,"Xà Đơn – Xà kép Đa Năng EX30 Bản Cao Cấp Tiêu Chuẩn Phòng Gym(Tặng Kìm Bóp Cơ Tay 5-60kg)",2789000,5000000,2211000,44
TIKI,bach-hoa-online,182981008,"Combo 2 Hộp Bánh Bông Lan Tròn Kem SOLITE 360g",113000,115000,2000,2
TIKI,cross-border-hang-quoc-te,46386341,"Sunnimix 1 Glockenspiel Đàn Xylophone Đập Nhựa Cứng Nhám Đầu Cái Vồ Gậy Be",244000,244000,0,0
TIKI,the-thao-da-ngoai,176166906,"Dây Nhảy FED XM0105 - Dây Nhảy Tăng Thể Lực Giúp Thân Hình Cân Đối Săn Chắc Và Đẹp - Hàng Chính Hãng",385000,450000,65000,14
TIKI,the-thao-da-ngoai,92533531,"Mũ Bơi Người Lớn,Nón Bơi Cho Nữ Tóc Dài Chất Liệu 100% Silicon Co giãn,Chống Nước,Thoải Mái Đại Nam Sport",89000,150000,61000,41
TIKI,the-thao-da-ngoai,34811029,"Banh Bóng Rổ Geru Cam",97000,97000,0,0
TIKI,the-thao-da-ngoai,75722804,"Túi Đấm Bốc Boxing Cho Trẻ Em Hình Người Nhện Đỏ Size Trung 37*18*18 cm, Kèm 2 Găng Tay Cho Bé+Tặng Kèm Hình Dán",139000,139000,0,0
TIKI,bach-hoa-online,2385977,"Muối Tôm Tây Ninh Tinh Nguyên (150g)",24000,24000,0,0
TIKI,the-thao-da-ngoai,138725435,"Mồi câu cá giả mềm 90mm/14g có 6 màu",13300,13300,0,0
TIKI,the-thao-da-ngoai,20847679,"Bật lửa ZIPPO 207 –Bật lửa ZIPPO STREET CHROME",535000,535000,0,0
TIKI,bach-hoa-online,156933920,"Dung dịch bảo vệ cây trồng hoa lan cây kiểng SAIZOLE bình 650ML",35000,35000,0,0
TIKI,the-thao-da-ngoai,38074373,"Găng Bao Tay Xỏ Ngón MMA Boxing Đấm Bốc Người Lớn Amalife - Găng Tay Xỏ Ngón MMA Cao Cấp",102000,102000,0,0
TIKI,bach-hoa-online,85307011,"Bột Gia Vị Cajun Thương Hiệu Hava Foodies Gói 100g – Cajun Spice",66000,66000,0,0
TIKI,the-thao-da-ngoai,152074922,"Ghế Vớt Tạ đa năng Zasami ",590000,850000,260000,31
TIKI,cross-border-hang-quoc-te,192709820,"30 Pieces Polymer Clay Tools Pottery Modeling Smoothing for Beginners with Carrying Case DIY Ceramic Clay Carving Tool Set Clay Tools",187000,187000,0,0
TIKI,bach-hoa-online,145493340,"Gà cao su đồ chơi cho chó mèo",11000,11000,0,0
TIKI,the-thao-da-ngoai,83783760,"Dụng cụ cầm tay đa năng Leatherman Free T4 (12 tools)",1950000,1950000,0,0
TIKI,the-thao-da-ngoai,198522142,"Khung Hỗ Trợ Tập Lưng, Nắn Chỉnh Cột Sống, Khung Định Hình Cột Sống, Hỗ Trợ Điều Trị Thoát Vị Đĩa Đệm, Đau Lưng, Vai Gáy - Chính Hãng",95000,95000,0,0
TIKI,the-thao-da-ngoai,144611597,"Bình nước thể thao | Bình nước xe đạp thể thao Sahoo 700ml ",87000,87000,0,0
TIKI,the-thao-da-ngoai,53926218,"Túi Đai Đeo Bụng Hông Chạy Bộ Có Ngăn Đựng Bình Nước JP1",175000,175000,0,0
TIKI,bach-hoa-online,35606302,"BỘT SẮN DÂY NGUYÊN CHẤT MẸ KEN (1kg) (BÁN THEO MÙA)",175000,175000,0,0
TIKI,bach-hoa-online,86757015,"Trà tim sen sấy khô Cao Cấp gói 250G - Tốt cho người bị khó ngủ, mất ngủ kinh niên - Quà tặng cho người lớn tuổi - Nhập mã khuyến mãi khi mua từ 2 gói để tiết kiệm hơn",95000,95000,0,0
TIKI,bach-hoa-online,74195239,"Đường Erythritol 100% Tự Nhiên Không Calo 500G JC BLUEMOON",178000,178000,0,0
TIKI,bach-hoa-online,111757171,"Muối Tôm Siêu Cay Fadely (65g)",13000,13000,0,0
TIKI,bach-hoa-online,5444933,"Muối tôm Natas Hũ 70g-Muối Đa Năng",18000,18000,0,0
TIKI,bach-hoa-online,173657766,"Hỗn dịch thuốc tiêm BIO- CODEXIN T.rị nhiễm trùng đường hô hấp, đường ruột, sinh dục,sưng phù đầu, tụ huyết trùng, thương hàn trên gia súc, gia cầm",58560,58560,0,0
TIKI,bach-hoa-online,8711440,"Combo 2 gói kẹo hồng sâm Hàn Quốc Kgs 300g",129000,129000,0,0
TIKI,bach-hoa-online,90111470,"Trà Diệp hạ châu ĐB dược liệu sạch chuẩn GACP, Mát gan, giải độc gan Hộp 20 túi lọc tiện lợi",60000,60000,0,0
TIKI,the-thao-da-ngoai,133772727,"Túi Ngủ Văn Phòng Du Lịch, Phượt Cá Nhân, Túi Ngủ Mùa Đông - 3 Lớp Cao Cấp - Gói Gọn Tiện Ích- Hàng Chính Hãng MINIIN",199000,199000,0,0
TIKI,bach-hoa-online,1717725,"Canxi Cho Chó Mèo Calcium Phosphorus Petag (50 Viên)",270000,270000,0,0
TIKI,the-thao-da-ngoai,159906214,"Áo bơi nữ Zoggs Quay - 462347",430000,859000,429000,50
TIKI,the-thao-da-ngoai,188377225,"Phao câu đài Nano Tăm To Độ Ổn Định Cao Truyền Tin Nhanh Chính Xác PC28",29000,29000,0,0
TIKI,bach-hoa-online,151523604,"1KG HẠT HƯỚNG DƯƠNG LOẠI SỌC CHO TẤT CẢ DÒNG VẸT VÀ THÚ CƯNG",54999,54999,0,0
TIKI,bach-hoa-online,76145335,"Trà Oolong (Ô Long/Olong) Cao Cấp Nguyên Chất Vũ Gia (200g/hũ)",180000,250000,70000,28
TIKI,the-thao-da-ngoai,254091226,"BỘ ĐÔI TẠ 30KG BG Tạ Tập Tay Đa Năng Điều Chỉnh 2 in 1 Kết Hợp Tạ Đẩy ( hàng nhập khẩu)",699000,999000,300000,30
TIKI,the-thao-da-ngoai,111928268,"Bộ quần áo bóng đá câu lạc bộ Liverpool mùa giải mới - Áo bóng đá CLB ngoại hạng Anh - Bộ đồ bóng đá đẹp",95000,150000,55000,37
TIKI,bach-hoa-online,189174022,"Mì Soba Nhật Bản 200G",37000,37000,0,0
TIKI,bach-hoa-online,111779121,"Muối Hồng Tiêu Fadely (65g)",13500,13500,0,0
TIKI,bach-hoa-online,58212601,"TRÀ DÂY TÂM ĐỨC",100000,100000,0,0
TIKI,the-thao-da-ngoai,105791646,"Bảng phi tiêu 40cm  + 6 phi tiêu nam châm",430000,430000,0,0
TIKI,bach-hoa-online,173534076,"Tinh Bột Nghệ Mộc Sắc Siêu Thị Thiên Nhiên Sấy Lạnh Nguyên Chất Tốt Cho Dạ Dày Nâng Cao Sức Khỏe, Tốt Cho Phụ Nữ Sau Sinh – Hàng Chính Hãng",160000,160000,0,0
TIKI,bach-hoa-online,156935304,"5 khúc gỗ vú sữa ghép lan đường kính 7-8cm dài 20 cm",75000,75000,0,0
TIKI,bach-hoa-online,115273254,"Bộ 6 túi thức ăn cho chó lớn dạng sốt Pedigree vị gan nướng và rau 130g",114000,114000,0,0
TIKI,the-thao-da-ngoai,108480875,"Mã hàng KT1.HT – Xà đơn xếp Khánh Trình hai tầng dành cho cả trẻ em và người lớn",1820000,1820000,0,0
TIKI,the-thao-da-ngoai,150342336,"Bó Cổ Chân, Băng Cổ Chân, Bảo Vệ Mắt Cá Chân, Bảo Vệ Tránh Băng Gân",69000,69000,0,0
TIKI,bach-hoa-online,153404093,"Trà Gừng Mật Ong Thanh Bình - Hộp 320g/20 gói, ấm bụng ngừa cảm cúm, tăng đề kháng, sản phẩm hỗ trợ tốt trong mùa dịch",51000,51000,0,0
TIKI,bach-hoa-online,169193258,"Thùng Sữa Hạt Vegemil Đậu Đen 190ml (16 Hộp/Thùng)",239000,239000,0,0
TIKI,bach-hoa-online,51659257,"Combo 5 Gói Kẹo Cứng Sâm Đen DWI Korean Black Ginseng Candy (300g/Gói)",165000,230000,65000,28
TIKI,bach-hoa-online,1701837,"Xịt Khử Mùi Chuồng Trại Fay Deodor (350ml)",47997,47997,0,0
TIKI,bach-hoa-online,3630615,"Bàn cào móng cho mèo ",38888,38888,0,0
TIKI,bach-hoa-online,93949838,"Bánh Đa Nem Đa năng Hà Nội Xưa (ăn sống/cuộn nem)- Hàng xuất khẩu Nhật- 200G",27000,27000,0,0
TIKI,bach-hoa-online,129753372,"Lược Chải Lông Cho Chó Mèo - Lược Lấy Lông Rụng Cao Cấp (Có Nút Bấm Lấy Lông)",36999,36999,0,0
TIKI,bach-hoa-online,193588547,"Bắp Sấy Hành Viettinmart 500g",48400,70000,21600,31
TIKI,bach-hoa-online,26812103,"Tã giấy vệ sinh cho chó - dùng lót khay vệ sinh hoặc lót chuòng chó",34319,34319,0,0
TIKI,bach-hoa-online,151522857,"HẠT TRỘN CHO YẾN PHỤNG, MANH MANH, 7 MÀU, FINCH",26250,26250,0,0
TIKI,bach-hoa-online,59091309,"Combo 6 + TẶNG 1 Lọ cùng loại (7 lọ x 70ml Nước yến sào SkyNest Kid Gold 15% Tổ Yến cho trẻ nhỏ",209000,364000,155000,43
TIKI,bach-hoa-online,128302707,"[CHÍNH HÃNG] Bột Lá Sen Quảng Thanh 100% Nguyên Chất Sấy Lạnh - Ngủ ngon, giảm mỡ máu, giảm cân  - Gói 100 gr",219000,300000,81000,27
TIKI,bach-hoa-online,14980082,"Đậu Hà Lan vàng tách đôi Yellow Split Peas",20900,22000,1100,5
TIKI,bach-hoa-online,54282693,"Combo 12 hũ tiêu ngào đường đặc sản Phú Quốc",310000,310000,0,0
TIKI,bach-hoa-online,100287124,"Kẹo the Fres Apple Peach (xanh lá) Bịch 150g",19000,19000,0,0
TIKI,bach-hoa-online,178034608,"SỮA CHUA DỪA SÁP SẤY KHÔ GIÒN TAN",73000,95000,22000,23
TIKI,bach-hoa-online,197544241,"Khăn ướt đa năng cho chó mèo Borammy",29000,29000,0,0
TIKI,bach-hoa-online,5996879,"Cacao sữa 3in1 thơm ngon, tiện lợi Light Cacao - hũ 550g",227000,227000,0,0
TIKI,bach-hoa-online,155042526,"Bộ Test Nước Seachem Alert Combo Theo Dõi Thông Số",285000,285000,0,0
TIKI,bach-hoa-online,94262405,"Sữa tắm Bio Lovely Pet (450ml) dưỡng lông chó mèo siêu mượt, khử mùi hôi",88000,88000,0,0
TIKI,bach-hoa-online,173971619,"Sốt Mì Ý Cà Chua & Nấm Prego 300g (Thương Hiệu Mỹ - SX Malaysia)",45200,45200,0,0
TIKI,bach-hoa-online,110021941,"Combo 2 hộp khô bò miếng 500gr tặng 1 gói 50gr",940000,940000,0,0
TIKI,bach-hoa-online,3528981,"Sữa bột giúp phòng ngừa loãng xương, xơ vữa động mạch và tiểu đường GIGO SURE Hồng sâm 900 Gr (JISENG)",244000,380000,136000,36
TIKI,bach-hoa-online,136186279,"CATSRANG -  Thức ăn cho mèo trưởng thành",77000,150000,73000,49
TIKI,bach-hoa-online,6570263,"Dung dịch nhỏ mắt trị viêm mắt chó mèo genta drop 10ml",7844,7844,0,0
TIKI,bach-hoa-online,46766582,"Ống hút cặn hồ cá cảnh",39000,39000,0,0
TIKI,bach-hoa-online,99084276,"Combo Ngon miệng đưa cơm 2 chai 340g",187000,187000,0,0
TIKI,bach-hoa-online,2637801,"Cao hồng sâm 365 Hàn Quốc Daedong Korea Ginseng hộp 480g-PP",415000,415000,0,0
TIKI,bach-hoa-online,118947861,"(Thùng) Nước tăng lực RedBull Việt Nam Lon 250ml",232000,232000,0,0
TIKI,bach-hoa-online,105655443,"Thùng 48 hộp Sữa Chua Uống Yomost cam 100ml - HSD Luôn Mới",235000,235000,0,0
TIKI,bach-hoa-online,64000297,"1Kg Khô Bò Miếng Loại Cay Mềm Cao Cấp Thương Hiệu SK FOOD",365000,499000,134000,27
TIKI,bach-hoa-online,51498472,"Cà Phê Sữa Hòa Tan 3IN1 KING COFFEE - Túi 50 gói x 24g",180000,180000,0,0
TIKI,bach-hoa-online,169920643,"Đường mía thiên nhiên Biên Hòa 1kg/túi",39100,39100,0,0
TIKI,bach-hoa-online,165997262,"Cát mèo Việt Nam cao cấp túi 10kg",80000,80000,0,0
TIKI,bach-hoa-online,14397805,"10 hũ nước Yến Sào Sanest Có Đường (70ml)",375000,375000,0,0
TIKI,bach-hoa-online,154698853,"Kẹo hương thập cẩm dẻo L'angfarm, 350g, bịch, mẫu kraft 1 mặt trong",48000,48000,0,0
TIKI,bach-hoa-online,272055472,"Nước diệp lục cô đặc Úc Swisse Chlorophyll hỗ trợ làm chậm quá trình lão hóa, cải thiện sức khỏe da, tăng cường sức khỏe chung - QuaTangMe Extaste",251400,554000,302600,55
TIKI,bach-hoa-online,154699098,"Đậu hoà lan muối L'angfarm, 225g, bịch, mẫu kraft 1 mặt trong",39000,39000,0,0
TIKI,bach-hoa-online,114197919,"[TÂM CHÂU] Trà Xanh Móc Câu Đặc Biệt 250G",75000,75000,0,0
TIKI,bach-hoa-online,70520632,"Nước Yến Sào win'sNest Đường Phèn 12% (6 Lọ * 70 ml / Hộp) Kèm túi xách",158100,310000,151900,49
TIKI,bach-hoa-online,76688320,"Combo 2 sản phẩm Gạo Ông Thọ - Lứt Ngọc Đỏ túi 1kg hút chân không cao cấp. Gạo sạch hữu cơ dinh dưỡng cho sức khỏe",71000,71000,0,0
TIKI,bach-hoa-online,63999595,"Khô Bò Miếng Cay Mềm Thương Hiệu SK FOOD - Bịch 500G",215000,340000,125000,37
TIKI,bach-hoa-online,148635468,"Gạo Lứt Tím đóng túi 1KG Vinh Hiển - Đạt chuẩn HACCP - Ngọt cơm, dinh dưỡng",42000,48000,6000,13
TIKI,bach-hoa-online,116391615,"Combo TRÀ HIBISCUS VÔ THƯỜNG giúp giảm cân và TRÀ LẠC TIÊN giúp ngủ ngon",144000,160000,16000,10
TIKI,bach-hoa-online,154699057,"Thập cẩm sấy L'angfarm, 400g, bịch, mẫu mawashi",95000,95000,0,0
TIKI,bach-hoa-online,76450798,"Sữa Tiệt Trùng Ít Đường VPMilk Grow+ Hộp 180ml (Thùng 48 Hộp)",423100,423100,0,0
TIKI,bach-hoa-online,145178134,"Đặc Sản Phan Thiết - [Mua 3 Tặng 3] Mua 3 Nước Tương Shiitake Tặng 3 Nước Mắm Shiitake Chai Nhựa Cao Cấp 525Ml Từ Nấm Ngọt Shiitake Và Đậu Nành Nhật Bản",360000,720000,360000,50
TIKI,bach-hoa-online,106381086,"Thùng 24 lon Cà Phê sữa HIGHLANDS COFFEE 235ml",349000,349000,0,0
TIKI,bach-hoa-online,19762202,"Đồ chơi cho chó cao su dạng bóng Kún Miu",29999,29999,0,0
TIKI,bach-hoa-online,154698832,"Mận sấy dẻo L'angfarm, 300g, bịch, mẫu kraft 1 mặt trong",103000,103000,0,0
TIKI,bach-hoa-online,190170723,"Thùng 72 lọ Yến sào wins'Nest 20% chưng sẵn nguyên chất nhân sâm ít đường (70ml/lọ)",2350080,4608000,2257920,49
TIKI,bach-hoa-online,106685390,"Bột socola đen ăn kiêng GUfoods - Eat Clean, Làm đẹp, Giảm cân",74000,139000,65000,47
TIKI,bach-hoa-online,116692791,"Thùng 24 chai Nước Khoáng Thiên Nhiên Có Ga Đảnh Thạnh Khoáng Chanh 430ml (Đảnh Thạnh Ngọt)",192000,192000,0,0
TIKI,bach-hoa-online,99077932,"Rong biển tẩm gia vị ăn liền Ottogi 12.6g (lốc 3 gói)",26000,26000,0,0
TIKI,bach-hoa-online,33544809,"Hạt Mix 3 Loại (Óc chó - Hạt Macca - Hạnh Nhân)",155000,179000,24000,13
TIKI,bach-hoa-online,146392461,"1 hộp(500g) Ngũ Cốc Lợi Sữa Min Min Care dạng lon- Chuyên Lợi Sữa và Phục Hồi Sức Khỏe Sau Sinh",265000,270000,5000,2
TIKI,bach-hoa-online,161493652,"Thùng 48 hộp sữa chua uống tiệt trùng hương việt quất tự nhiên TH True Yogurt 180ml (180ml x 48)",385223,385223,0,0
TIKI,thoi-trang-nam,160407346,"Viettien - Quần dài kaki nam màu xám sáng có 1ly regular 6Q6051",630000,630000,0,0
TIKI,thoi-trang-nam,90078837,"Đồ bộ nam ba lỗ GINE EBMIN chất vải cao cấp, Bộ Áo Thun Cotton Sát Nách Dáng Rộng Phong Cách Hip-hop Cho Nam, Set Đồ Bộ Thể Thao Unisex Nam Nữ Vải Thun Lạnh, ĐỒ BỘ NAM ÁO THUN BA LỖ QUẦN ĐÙI, NGUYÊN BỘ ĐỦ SẮC MÀU, CHẤT THUN LẠNH MÁT, BỘ QUẦN ÁO THỂ THAO 3",99000,99000,0,0
TIKI,thoi-trang-nam,174024710,"Quần Short Jean nam Leman xanh trơn JL07 - Slim straight Form",380000,459000,79000,17
TIKI,thoi-trang-nam,193322207,"Quần lót nam cotton Mỹ kháng khuẩn khử mùi thoáng khí dáng trungk ONOFF -18UO23A018",74000,89000,15000,17
TIKI,thoi-trang-nam,34148045,"Combo 3 quần lót nam tam giác Bamboo organic mềm mịn thoáng mát MRM Manlywear - Màu Ngẫu Nhiên",189000,240000,51000,21
TIKI,thoi-trang-nam,102107857,"Áo đũi nam cổ tầu mở khuy tay lỡ trẻ trung ArcticHunter, thời trang thương hiệu chính hãng",199000,199000,0,0
TIKI,thoi-trang-nam,22595534,"Quần short jean nam xanh đen Q413 Muidoi",132000,132000,0,0
TIKI,thoi-trang-nam,50602762,"Áo Sweater Nỉ Chui Trơn Nam Nữ Đều Mặc Được Dễ Dàng Phối Đồ",93000,93000,0,0
TIKI,thoi-trang-nam,86724843,"Áo SOMI Đen TRƠN DÀI TAY BASIC Nam Nữ Unisex (1 TÚI TRƯỚC NGỰC)",76000,76000,0,0
TIKI,thoi-trang-nam,125803140,"Quần đùi nam mặc ở nhà, đi biển chất liệu linner nhẹ mát phom dáng trẻ trung trên gối thương hiệu Fezzio chính hãng",87500,175000,87500,50
TIKI,thoi-trang-nam,6927817,"Quần thun dài jogger nam Phúc An 1011 màu xám",82800,82800,0,0
TIKI,thoi-trang-nam,94776620,"Đồ bộ nam nữ unisex mùa hè chất mè xịn co giãn 4 chiều thoáng mát",92000,92000,0,0
TIKI,thoi-trang-nam,6707617,"Quần Jogger nam",167000,167000,0,0
TIKI,thoi-trang-nam,117920406,"Áo phông unisex form rộng nữ nam thun unisex cổ tròn cotton oversize giá rẻ in hình Henri Martis",52000,52000,0,0
TIKI,thoi-trang-nam,176067897,"Quần Bơi Nam Thể Thao Swimming KUNBE, Kiểu Dáng Năng Động Khỏe Khoắn Chất Liệu Co Dãn Thoáng Khí Nhanh Khô",79000,79000,0,0
TIKI,thoi-trang-nam,4359739,"Áo thun sát nách cổ tròn nam UB08",100000,100000,0,0
TIKI,thoi-trang-nam,148599093,"Mẫu quần jean nam đen ống đứng tôn dáng - vải jeans bò co giãn 4 chiều cao cấp",142000,142000,0,0
TIKI,thoi-trang-nam,105735946,"Quần Kaki Nam Kiểu Dáng Hàn Quốc Ống Côn Phong Cách Thể Thao Kết Hợp giày Sneaker cực đẹp",85000,85000,0,0
TIKI,thoi-trang-nam,138752676,"Áo phông nam trơn cổ tim ngắn tay vải cotton thun lạnh mềm mịn dáng body thời trang",109980,117000,7020,6
TIKI,thoi-trang-nam,72517190,"Áo sơ mi nam trắng dài tay công sở cao cấp chất lụa Hamino form slimfit ôm dáng thời trang Hàn Quốc màu trắng đen hàng VNXK, áo sơ mi nam dài tay công sở Hàn quốc cao cấp đen trắng  - Đen - XL",68000,68000,0,0
TIKI,thoi-trang-nam,57979142,"Quần Thun Nam Dài Vải Thun Nỉ",75000,75000,0,0
TIKI,thoi-trang-nam,183727360,"Áo sơ Mi, Áo sơ Mi Nam thiết kế nhún vai tạo điểm nhấn mạnh mẽ thu hút mọi ánh nhìn mã H41",199000,199000,0,0
TIKI,thoi-trang-nam,183734155,"Quần kaki dài nam việt tiến màu xám có 1ly 6R6025 Regular",665000,665000,0,0
TIKI,thoi-trang-nam,82643340,"Quần Sọt Kaki Nam Túi Hộp Phối Họa Tiết Lính",188000,188000,0,0
TIKI,thoi-trang-nam,165709094,"Quần sịp nam Thái Lan dệt kim cao cấp, Quần lót nam Lihana",60000,60000,0,0
TIKI,thoi-trang-nam,76700434,"QUẦN TÂY NAM TRUNG NIÊN VẢI DÀY BỀN SIZE 50-85KG",111000,111000,0,0
TIKI,thoi-trang-nam,7707691,"Quần short thun nam phối sọc hông Phúc An N0001 màu đen có big size",71100,71100,0,0
TIKI,thoi-trang-nam,83517269,"Bộ áo khoác thể thao thu đông cao cấp",505700,505700,0,0
TIKI,thoi-trang-nam,84480914,"Sơ mi đũi nam kẻ caro cao cấp cổ bẻ thời trang Hàn Quốc dáng slimfit trẻ trung",118000,118000,0,0
TIKI,thoi-trang-nam,146231795,"Quần lót nam tam giác cao cấp thun lạnh thông hơi thoáng co giãn 4 chiều sexy loại xịn(ms051)",22000,33000,11000,33
TIKI,thoi-trang-nam,23453145,"Áo sơ mi nam a06",120000,120000,0,0
TIKI,thoi-trang-nam,118900403,"Áo sơ mi nam tay dài ADINO màu xanh than vải sợi sồi modal dáng slimfit trẻ trung S305",279000,350000,71000,20
TIKI,thoi-trang-nam,69660130,"Áo Sơ Mi Nam Form Rộng Sọc Caro GOAT MENSWEAR",460000,460000,0,0
TIKI,thoi-trang-nam,91339522,"Áo chống nắng nam thông hơi vải kim cương cao cấp hàng xuất khẩu Micado",150000,150000,0,0
TIKI,thoi-trang-nam,22559742,"Áo Thun nam mẫu mới logo trước ngực, combo 3 áo -  ĐB3QC11",509000,509000,0,0
TIKI,thoi-trang-nam,15518228,"Áo len nam loại dày BS33",250000,250000,0,0
TIKI,thoi-trang-nam,134739638,"Áo Hoodie nỉ  Couple nam nữ - Form rộng",106000,106000,0,0
TIKI,thoi-trang-nam,187579216,"Combo 3 quần lót đùi nam boxer CITYMEN lưng Thái cao cấp vải thun lạnh co dãn mềm mại thoáng khí thấm hút tốt, quần xịp sịp đùi nam bao đổi trả 90 ngày",140000,140000,0,0
TIKI,thoi-trang-nam,20735027,"Áo khoác gió cách nhiệt GOKING có mũ, form unisex cho nam nữ. Ngoài vải dù, trong lót vải cào cách nhiệt. 3 túi to rộng. Chống nắng gió lạnh",255000,255000,0,0
TIKI,thoi-trang-nam,28310952,"Áo sơ mi nam Flanel Caro Victory đen trắng ASM3016C",90000,90000,0,0
TIKI,thoi-trang-nam,24388904,"áo hoodie nam unisex from rộng BHD6",79000,79000,0,0
TIKI,thoi-trang-nam,113065450,"Áo sơ mi CARO UNISEX nam nữ đa năng (kèm ảnh thật)",70000,70000,0,0
TIKI,thoi-trang-nam,138381315,"Áo thun dài tay nam giữ nhiệt co giãn mặc lót chơi thể thao, đá bóng Micado",60000,60000,0,0
TIKI,thoi-trang-nam,101656788,"Áo Măng Tô Kaki Nam Dáng Dài Áo Khoác Nam Kaki Dáng Dài Sans20 Sans Shop",1090000,1090000,0,0
TIKI,thoi-trang-nam,67428731,"Quần thể thao 3 sọc nam nữ ( hình thật ) , quần jogger nỉ nam 3 sọc, quần jogger thun, quần thể thao nam, quần nỉ nam",60000,60000,0,0
TIKI,thoi-trang-nam,108223146,"Áo Đông Xuân Nam Xuất Nhật Maxtino Chất Cotton Thoáng Mát (Cộc Tay / Ba Lỗ)",19000,19000,0,0
TIKI,thoi-trang-nam,3952347,"Áo Gile Aligro Cổ Tim Màu Tím ALENGL009",373450,533500,160050,30
TIKI,thoi-trang-nam,19775682,"Quần Jogger Nam Kaki Thời Trang Trẻ Trung Năng Động",88000,88000,0,0
TIKI,thoi-trang-nam,188382147,"Áo sơ mi nam, Áo sơ mi tay lỡ cúc bấm mang phóng cách trẻ trung lịch lãm H55",209000,209000,0,0
TIKI,thoi-trang-nam,76705070,"combo 3 thun 3 lỗ nam đẹp loại cotton loại 1 mềm mịn mát hút mồ hôi cực tốt",132000,132000,0,0
TIKI,thoi-trang-nam,181566777,"Áo sơ mi nam sọc tay ngắn dáng ôm body chuẩn form nhiều màu sắc - MON01",135000,250000,115000,46
TIKI,thoi-trang-nam,124863665,"OWEN - Áo sơ mi trắng dài tay Owen chất sồi siêu mềm mịn (Regularfit / Slimfit)",420000,420000,0,0
TIKI,thoi-trang-nam,145763510,"Combo 5 quần lót Nam Thái Lan (Body 2 Lưng)",285000,285000,0,0
TIKI,thoi-trang-nam,56002837,"Quần nam Jogger vải kaki thoáng mát giặt không ra màu cao cấp - QB057",49000,49000,0,0
TIKI,thoi-trang-nam,85086748,"Áo sơ mi nam cổ trụ dài tay",159000,159000,0,0
TIKI,thoi-trang-nam,79723089,"Bộ quần áo thể thao thun lạnh nam nữ",90000,90000,0,0
TIKI,thoi-trang-nam,117684777,"Combo 4 Quan lot nam cotton boxer đùi cao cấp lụa in thoáng khí BIG SIZE SIZE LỚN (80 ĐẾN 135 KG) quần lót nam quan chip",108000,108000,0,0
TIKI,thoi-trang-nam,177713082,"Quần Đùi Nam Kate Dày Quần Sọt Nam Có 2 Túi Hông Túi Khoá Kéo Sau Hàng Xịn Đẹp",46200,46200,0,0
TIKI,thoi-trang-nam,130969557,"Quần thun nam mặc ngủ, thể thao, tập gym - A077",120000,120000,0,0
TIKI,thoi-trang-nam,99192463,"Quần Short Jean Nam, Quần Bò Ngố Nam Cao Cấp Mẫu Mới Siêu Đẹp OBOK Fashion QSN1006",149000,149000,0,0
TIKI,thoi-trang-nam,151843234,"áo Hoodie nỉ WZSOFF màu đen xám unisex ảnh thật SSSTore ( nam nữ mặc đều được )",120000,120000,0,0
TIKI,thoi-trang-nam,15137091,"Áo Khoác Dù Nam  2 Lớp Chống Tia Cực Tím Khói Bụi Cao Cấp SM19",149000,265000,116000,44
TIKI,thoi-trang-nam,104064765,"Quần Jean Nam , Quần Bò Màu Xanh Co Giãn Phong Cách Thời Trang Hàn Quốc Cao Cấp ms668",59000,59000,0,0
TIKI,thoi-trang-nam,196093567,"Áo May Ô Ba Lỗ Nam Vicci Màu Trắng, Chất Liệu 100% Sợi Cotton Mềm Mịn, Co Giãn 4 Chiều, Thấm Hút Mồ Hôi, Siêu Thoáng Mát",50000,60000,10000,17
TIKI,thoi-trang-nam,35593659,"Combo 5 Quần Lót Nam Boxer Thời Trang Aristino ABX 16 03",469000,625000,156000,25
TIKI,thoi-trang-nam,67708834,"Quần Bơi Nam Đen Họa Tiết Vảy Cá Phong Cách Chuyên Nghiệp SZone SQB109",55000,55000,0,0
TIKI,thoi-trang-nam,71171098,"Áo thun nam cổ bẻ vải cá sấu thời trang SITAKI cao cấp ATN09",125000,125000,0,0
TIKI,thoi-trang-nam,78503787,"Quần Short Jean Nam co dãn kiểu dáng trẻ trung đơn giản thêu họa tiết Thương Hiệu Chandi, quần sọt mẫu hot nhất HD219",176000,299000,123000,41
TIKI,thoi-trang-nam,174037994,"Áo thun nam tay ngắn họa tiết LOS ANGELES LADOS - 9081, vải cotton thoáng mát, form rộng, siêu đẹp",339000,339000,0,0
TIKI,thoi-trang-nam,39853665,"Áo khoác nỉ Hoodie Hot",89000,89000,0,0
TIKI,thoi-trang-nam,101861199,"Quần Baggy Nam Nữ Kaki Ống Suông Unisex",85000,85000,0,0
TIKI,thoi-trang-nam,174037915,"Áo thun cotton in họa tiết LADOS - 9076, vải cotton mát, có thể mặc nhóm, mặc cặp",339000,339000,0,0
TIKI,thoi-trang-nam,52198192,"Combo 3 Quần Lót Nam Quần Sịp Nam Sợi Cotton Cao Cấp MRM FASHION 1 Màu TẶNG Đôi Tất Nam Cao Cấp",199000,255000,56000,22
TIKI,thoi-trang-nam,32849715,"Quần lót nam kiểu boxer ống ngắn Voga Hàng Ngày vải cotton thoáng mát, hút mồ hôi",99000,99000,0,0
TIKI,thoi-trang-nam,176298191,"Combo đồ bơi nam giới, set 4,5 chi tiết Quần boxer 2 lớp + Kính bơi anti fog + Mũ + Bịt tai kẹp mũi + Túi đựng, mẫu cao cấp đẹp | BN007",350000,350000,0,0
TIKI,thoi-trang-nam,60343372,"ÁO SƠ MI CẶP ĐÔI NAM NỮ I LOVE YOU HOT TREND HÀN QUỐC",70000,70000,0,0
TIKI,thoi-trang-nam,68938308,"Áo  Sơ Mi Nam Vải Lụa Thái Không Nhăn Dài Tay Nhiều Màu",157000,157000,0,0
TIKI,thoi-trang-nam,22514777,"Áo sơ mi nam",99000,99000,0,0
TIKI,thoi-trang-nam,139607008,"Bộ 6 Quần Lót Nam Dạng Tam Giác Giordano Cotton Briefs 0117701437",519000,640000,121000,19
TIKI,thoi-trang-nam,181422591,"Áo sơ mi nam chất đũi cổ tầu túi lật, chất đũi mềm mát, thời trang phong cách Hàn",179000,179000,0,0
TIKI,cross-border-hang-quoc-te,185329850,"Thắt lưng da bò CAMEL khóa tự động cho nam",457000,457000,0,0
TIKI,cross-border-hang-quoc-te,186580962,"CAMEL CROWN Chạy túi xách tay điện thoại di động Bao tay điện thoại thể thao",271000,271000,0,0
TIKI,cross-border-hang-quoc-te,191004714,"Ba lô leo núi chuyên nghiệp ngoài trời CAMEL CROWN 40L",1492000,1492000,0,0
TIKI,cross-border-hang-quoc-te,225267601,"Giày Chạy Bộ Nam CAMEL Mới Siêu Nhẹ Giày Đế Mềm Lưới Hấp Thụ Thể Dục Dây Nhảy Giày",1403000,1403000,0,0
TIKI,cross-border-hang-quoc-te,213715307,"Đệm Ngủ Giường Hơi Cắm Trại Ngoài Trời CAMELCROWN Nệm Hơi Nâng Cao Pvc Có Bơm Tích Hợp",1938000,1938000,0,0
TIKI,cross-border-hang-quoc-te,185329850,"Thắt lưng da bò CAMEL khóa tự động cho nam",457000,457000,0,0
TIKI,cross-border-hang-quoc-te,46442360,"Phép Lạ Chiếu 4 Hành Lý Vali Thay Thế Bánh Xe Trục Bánh Xe và Ốc Vít Bộ Dụng Cụ Sửa Chữa Bộ 10",254000,254000,0,0
TIKI,cross-border-hang-quoc-te,17965467,"Show Your Work! (Backlist)",403000,403000,0,0
TIKI,cross-border-hang-quoc-te,11777090,"Collins Classics: The Art Of War",192000,192000,0,0
TIKI,cross-border-hang-quoc-te,200735975,"Túi leo núi chống thấm nước ngoài trời CAMEL Balo đi bộ đường dài 30L dành cho nam và nữ Balo du lịch thể thao giải trí",828000,828000,0,0
TIKI,cross-border-hang-quoc-te,111062477,"Bàn phím số không dây Ajazz 2.4G kỹ thuật số cho Window XP Win7 8 10 ios Máy tính xách tay",325000,325000,0,0
TIKI,cross-border-hang-quoc-te,134791132,"Sách - Radical Candor : How to Get What You Want by Saying What You Mean by Kim Scott - (UK Edition, paperback)",411000,411000,0,0
TIKI,cross-border-hang-quoc-te,212461402,"CAMELCROWN LềU Nhà Cắm Trại Tinh Tế Ngoài Trời Lều Tự Động Cắm Trại Công Viên Dã Ngoại Hai Lớp Dày Gấp Gọn Di Động",7165000,7165000,0,0
TIKI,cross-border-hang-quoc-te,205051050,"Áo Khoác Gió CAMEL Cho Nam Áo Áo Khoác Nam Mùa Đông Thể Thao Có Mũ Chống Gió Mùa Thu Nam Thường Ngày Áo Khoác Gió Chữ",1401000,1401000,0,0
TIKI,cross-border-hang-quoc-te,95535945,"3 Pieces Sports Golf Club Headcover 460cc Driver Wood Head Cover No. 1 3 5",493000,493000,0,0
TIKI,cross-border-hang-quoc-te,216098661,"Túi leo núi ngoài trời CAMEL Dung tích lớn 50L Ba lô du lịch chống thấm nước",2317000,2317000,0,0
TIKI,cross-border-hang-quoc-te,200039803,"Ba lô CAMEL CROWN ba lô túi leo núi 36L túi du lịch ngoài trời leo núi nhẹ cho phụ nữ leo núi cắm trại ba lô cắm trại công suất lớn ba lô leo núi nam",1488000,1488000,0,0
TIKI,cross-border-hang-quoc-te,185341219,"Túi Đựng Điện Thoại Đeo Cánh Tay Khi Chạy Bộ Thể Thao Dành Cho Nam Và Nữ",225000,225000,0,0
TIKI,the-thao-da-ngoai,52873171,"PTP Băng Tập Đàn Hồi - Bảng Trung Bình MICRO X HEAVY",425000,425000,0,0
TIKI,the-thao-da-ngoai,81609944,"Nón Bơi Silicone UNISEX SPEEDO",195000,195000,0,0
TIKI,cross-border-hang-quoc-te,11505543,"Building A Story Brand",689000,689000,0,0
TIKI,the-thao-da-ngoai,192774683,"Gậy bẻ tập cơ tay lò xo đàn hồi Guang Yu lực từ 20kg đến 60kg",140000,145000,5000,3
TIKI,cross-border-hang-quoc-te,51200834,"Call Center Monaural Office Điện Thoại Tai Nghe \u0026 Cáp Cuộn Cắm RJ9 Cho Avaya",229000,229000,0,0
TIKI,the-thao-da-ngoai,144897408,"combo 10 bộ thẻo lưỡi đôi câu đài câu đơn buộc sẵn, phụ kiện câu đài - Cần Câu Top1 VN",25500,25500,0,0
TIKI,the-thao-da-ngoai,12728215,"Bể Bơi 4 Tầng Cho Bé Intime Cao Cấp Cỡ Lớn + Kèm Phao Đỡ Cổ",540000,540000,0,0
TIKI,cross-border-hang-quoc-te,186579292,"COXO SOCO SC-Plus Tệp quay kênh rễ nội nha Công cụ nha khoa",410000,410000,0,0
TIKI,the-thao-da-ngoai,149578363,"Chì Lá Câu Cá Cuốn Sẵn Chuyên Câu Đài Câu Đơn -sét 10 viên",21000,21000,0,0
TIKI,cross-border-hang-quoc-te,196675328,"Ba Lô Ngoài Trời Chống Mòn CAMEL CROWN 40L Túi Thể Thao Du Lịch Leo Núi Cắm Trại Đi Bộ Đường Dài",1494000,1494000,0,0
TIKI,the-thao-da-ngoai,101651414," Đệm Hơi Liền Gối Một Người Naturehike Dành Cho Văn Phòng, Du Lịch, Dã Ngoại NH15Q002-D",480000,480000,0,0
TIKI,the-thao-da-ngoai,52292808,"Móc Khóa Đa Năng 17in1 ( 17 chức năng trong 1)",125000,125000,0,0
TIKI,cross-border-hang-quoc-te,170610748,"Sách - Eat That Frog! 21 Great Ways to Stop Procrastinating and Get More Done in Less T by Tracy (US edition, paperback)",458000,458000,0,0
TIKI,cross-border-hang-quoc-te,170695922,"Sách - The Summer I Turned Pretty by Jenny Han (UK edition, paperback)",341000,341000,0,0
TIKI,cross-border-hang-quoc-te,161036131,"Sách - The Love Hypothesis by Ali Hazelwood - (US Edition, paperback)",524000,524000,0,0
TIKI,cross-border-hang-quoc-te,189573294,"Sách - Good Girl, Bad Blood by Holly Jackson (UK edition, paperback)",394000,394000,0,0
TIKI,cross-border-hang-quoc-te,46334965,"Sunnimix 5 Ban Nhạc EQ Guitar Preamp Cân Bằng AMP Cho Đàn Acoustic Dân Gian Classcial Đàn Guitar",383000,383000,0,0
TIKI,the-thao-da-ngoai,167386240,"mồi mềm câu lure mồi cá mềm 9cm 5g",16600,16600,0,0
TIKI,cross-border-hang-quoc-te,111287818,"Đài Phun Nước Trang Trí Trong Nhà Giúp Thư Giãn Thích Hợp Trang Trí Bàn Máy Tính Fountain Desktop Decor - Ổ Căm Eu",334000,334000,0,0
TIKI,the-thao-da-ngoai,74430510,"Giày bóng rổ trẻ em, giày bóng rổ học sinh nam basketball SST-A223BL màu đen phối trắng, đủ size từ 36-40",589000,620000,31000,5
TIKI,cross-border-hang-quoc-te,188127691,"CAMEL CROWN Túi Đựng Điện Thoại Đa Năng Đeo Thắt Lưng Mỏng Nhẹ In Hình Vương Miện Thể Thao Chạy",219000,219000,0,0
TIKI,cross-border-hang-quoc-te,134441362,"Sách - A Little Life : Shortlisted for the Man Booker Prize 2015 by Hanya Yanagihara - (UK Edition, paperback)",369000,369000,0,0
TIKI,the-thao-da-ngoai,34317815,"Đai bó đầu gối co giãn khi chơi thể thao",69000,79000,10000,13
TIKI,cross-border-hang-quoc-te,213714540,"CAMEL CROWN Gối Không Ồn 3D Chống Latex Thoải Mái Di Động Gối Bơm Hơi Dễ Mang Đi Cắm Trại",653000,653000,0,0
TIKI,cross-border-hang-quoc-te,97503440,"Đệm Quần Lót Đi Xe Đạp Có Thể Co Dãn Cho Nam Nữ",195700,195700,0,0
TIKI,the-thao-da-ngoai,16258135,"Bộ đồ tập GYM nam - HM 111",97000,97000,0,0
TIKI,cross-border-hang-quoc-te,163163704,"Sách - The Concise 33 Strategies of War by Robert Greene (UK edition, paperback)",345000,345000,0,0
TIKI,cross-border-hang-quoc-te,94961578,"PU Leather Case for Samsung Galaxy Tab A7 10.4'' 2020 with Detachable Bluetooth Keyboard - 3-in-1 functionality keyboard case",181000,181000,0,0
TIKI,cross-border-hang-quoc-te,170717583,"Sách - Statistics 101 : From Data Analysis and Predictive Modeling to Measuring  by David Borman (US edition, paperback)",422000,422000,0,0
TIKI,cross-border-hang-quoc-te,76893043,"3Panel Microphone Isolation Shield Vocal Recording Microphone Isolation Shield Panel Soundproofing Panel for Home Office Studio",811000,811000,0,0
TIKI,the-thao-da-ngoai,4594673,"Xà Đơn Treo Tường Gắn Cửa 2018 80-130cm",176000,219000,43000,20
TIKI,cross-border-hang-quoc-te,112015377,"Bộ đèn xe đạp gồm Đèn pha trước Đèn hậu Đèn sau Dynamo",165100,165100,0,0
TIKI,the-thao-da-ngoai,90526870,"Bộ Giày Trượt Patin Trẻ Em Người Lớn DNS906 Tăng Giảm Size Bánh Cao Su Phát Sáng Đại Nam Sport + Kèm Full Bộ Bảo Hộ",599000,800000,201000,25
TIKI,cross-border-hang-quoc-te,108603660,"Giá đỡ bình nước để xe đạp, chạy thể thao ngoài trời bằng nhôm, siêu nhẹ và bền-Màu Bạc",180000,180000,0,0
TIKI,cross-border-hang-quoc-te,17966855,"Life Of A Stupid Man",173000,173000,0,0
TIKI,cross-border-hang-quoc-te,170678248,"Sách - People We Meet On Vacation by Emily Henry (US edition, paperback)",379000,379000,0,0
TIKI,the-thao-da-ngoai,147764196,"Quả Bóng Bàn Luyện Tập Thi Đấu 3W 40+ 2 Sao Độ Cứng Cao Tròn Đều Túi 100 quả.",390000,390000,0,0
TIKI,the-thao-da-ngoai,52715548,"Thảm tập yoga định tuyến cao cấp DOPI DP1102-2 Chất liệu TPE siêu bám",109000,109000,0,0
TIKI,cross-border-hang-quoc-te,17970192,"Meditations",378200,378200,0,0
TIKI,cross-border-hang-quoc-te,17965556,"Call Me By Your Name",377000,377000,0,0
TIKI,the-thao-da-ngoai,14113629,"Trụ Hơi Đấm Bốc Tự Cân Bằng kèm bơm",160550,169000,8450,5
TIKI,cross-border-hang-quoc-te,10755339,"Why Men Love Bitches",578000,578000,0,0
TIKI,the-thao-da-ngoai,20931393,"Bóng Chuyền Hơi Jatan 250gr ",101990,101990,0,0
TIKI,the-thao-da-ngoai,111509764,"Đai Nẹp Cố Định Khớp Cổ Tay Với 2 Thanh Nẹp Trên Dưới AOLIKES AL1671 1671 Cho Người Chấn Thương Bong Gân Cổ Tay",115000,115000,0,0
TIKI,the-thao-da-ngoai,421912,"Tạ Nhập Khẩu - TNK-2Kg - Xanh Dương",205000,205000,0,0
TIKI,the-thao-da-ngoai,170752375,"Mũ Lưỡi Trai Chống Tia UV UPF50+ Naturehike NH18H009-T",180000,180000,0,0
TIKI,cross-border-hang-quoc-te,18011331,"The Daily Stoic: 366 Meditations on Wisdom, Perseverance, and the Art of Living",497000,497000,0,0
TIKI,the-thao-da-ngoai,126414776,"Kính bơi nữ Speedo Futura Biofuse Flexiseal - 8-11314B978",495000,495000,0,0
TIKI,the-thao-da-ngoai,159730811,"Kính bơi trẻ em Zoggs Sonic Air Junior 2.0",277000,395000,118000,30
TIKI,cross-border-hang-quoc-te,162156987,"Sách - The Midnight Library by Matt Haig (UK edition, paperback)",368000,368000,0,0
TIKI,the-thao-da-ngoai,46760802,"Sét vỏ bao cát đấm bốc boxing 3 lớp + găng mma hở ngón cao cấp + băng đa 5 m siêu bền - Tặng kèm dây xích + móc treo + vít nở sắt",350000,350000,0,0
TIKI,the-thao-da-ngoai,192122947,"Cần Câu Cá Bỏ Túi Cầm Tay Dạng Ống Lồng Mini - Cần Câu Cá Hợp Kim Nhôm + Cần Câu",135000,135000,0,0
TIKI,cross-border-hang-quoc-te,51200716,"Thumb Piano Bridge Yên 17 Phím Set Kit Cho Bộ Phận Thay Thế DIY Của Kalimba",136000,136000,0,0
TIKI,cross-border-hang-quoc-te,95648852,"EMF Meter Kii Ghost Hunting Magnetic Field Detector Paranormal Equipment",326000,326000,0,0
TIKI,cross-border-hang-quoc-te,200833114,"Ba lô ngoài trời CAMEL của nam giới 40L công suất lớn túi leo núi chuyên nghiệp đi bộ đường dài cắm trại của phụ nữ ba lô chống thấm nước đa chức năng",1071000,1071000,0,0
TIKI,cross-border-hang-quoc-te,170579211,"Sách - ReWork : Change the Way You Work Forever by Jason Fried,David Heinemeier Hansson (UK edition, paperback)",483000,483000,0,0
TIKI,cross-border-hang-quoc-te,262326983,"2023 Đồng hồ thông minh đo đường huyết mới Đồng hồ gọi Bluetooth cho nam Điện tâm đồ PPG Đo huyết áp Đồng hồ thông minh thể thao Nam nữ Màu sắc: Xanh dương Silicon",1806477,1806477,0,0
TIKI,the-thao-da-ngoai,43699172,"Giày Đá Bóng Sân Cỏ Nhân Tạo Cổ Thun Mới",265000,265000,0,0
TIKI,the-thao-da-ngoai,69518151,"Dây Nhảy Thể Dục( Lõi Thép bện ) Dài 2,9m Cải Tiến Cao Cấp Dây Nặng Tay Cầm Chắc Chắn Đủ Màu Sắc",47000,79000,32000,41
TIKI,the-thao-da-ngoai,132200007,"Dây thừng tập thể lực phòng gym cao cấp",750000,750000,0,0
TIKI,the-thao-da-ngoai,162340921,"Quấn Cán Vợt Bóng Bàn - Cực Bám, Chống Trơn Do Mồ Hôi Tay",50000,50000,0,0
TIKI,the-thao-da-ngoai,149635464,"Siêu Khuyến Mãi 1 kg Bi Sắt 6mm, 7mm, 8mm - Đồ câu 24h - Cần Câu Top1 VN",38500,38500,0,0
TIKI,the-thao-da-ngoai,196911677,"Combo 3 dụng cụ hỗ rợ tập Yoga :  2 gạch tập Yoga in hoa văn họa tiết Mandala+ 1 dây đai tập Yoga sợi cotton , gạch cứng cáp đàn hồi thấm hút chịu lực tốt",97850,103000,5150,5
TIKI,the-thao-da-ngoai,87666653," hộp mồi câu trắm, chép dạng viên siêu nhạy",17000,17000,0,0
TIKI,the-thao-da-ngoai,2282183,"Quần áo lặn biển 3mm NAM (size M) - BLACK 1070 giữ ấm, bộ đồ lặn thoáng khí, chống thầm nước - POKI",1150000,1150000,0,0
TIKI,the-thao-da-ngoai,149584336,"XẢ KHO Thùng đựng cá GW gấp gọn siêu bền",75241,75241,0,0
TIKI,the-thao-da-ngoai,125603331,"Bảng Phi Tiêu Bóng Gai An Toàn Cho Bé",42000,42000,0,0
TIKI,cross-border-hang-quoc-te,161030316,"Sách - The Psychology of Money : Timeless lessons on wealth, greed, and happiness by Morgan Housel - (UK Edition, paperback)",531000,531000,0,0
TIKI,the-thao-da-ngoai,184634737,"Găng tay tập gym, bao tay hở ngón bảo vệ bàn tay, có dây quấn trợ lực cổ tay BTFA01",37050,39000,1950,5
TIKI,cross-border-hang-quoc-te,100267511,"Silicone Snorkeling Fins Short Fins Light Swim Fins Comfortable Scuba Diving Flippers Snorkeling Gear Snorkeling",242000,242000,0,0
TIKI,cross-border-hang-quoc-te,18011335,"Mastery (New in paperback)",696000,696000,0,0
TIKI,cross-border-hang-quoc-te,262340916,"Horse Riding Gloves Outdoor Breathable Equestrian Gloves Equipment for Cycling Biking Running",335000,335000,0,0
TIKI,cross-border-hang-quoc-te,46334361,"Có Thể Gấp Lại Được Điều Chỉnh Microphone Phòng Thu Cách Ly Bảng Điều Khiển, Cách Âm Micro Shield",454000,454000,0,0
TIKI,the-thao-da-ngoai,12755007,"Túi ngủ văn phòng (giao màu ngẫu nhiên)",104991,104991,0,0
TIKI,the-thao-da-ngoai,148040904,"Mồi Câu Cá Tổng Hợp Huỳnh Khoa Chuyên Tra Trê Chim Chép Trắm Rô Phi Hồ Dịch Vụ, Sông Tự Nhiên",50000,50000,0,0
TIKI,the-thao-da-ngoai,1747449,"Phao Tay Trẻ Em Roll-Ups",42000,52000,10000,19
TIKI,the-thao-da-ngoai,177190834,"Con Lăn Foam Roller Massage Gai 33cm - Ống Lăn Dãn Cơ Tập Gym, Yoga, Thể Hình",218000,218000,0,0
TIKI,thoi-trang-nam,19290138,"Quần Jean Bạc Phong Cách Trẻ Trung JEANBAC02",145000,145000,0,0
TIKI,thoi-trang-nam,164309510,"The Cycling Lion, mã G73. Áo thun nam nữ in siêu đẹp. Áo phông thoát nhiệt GOKING hàng hiệu cao cấp",168000,168000,0,0
TIKI,thoi-trang-nam,158757427,"Quần đùi nam 2 lớp dù thoáng mát form chuẩn",135000,135000,0,0
TIKI,thoi-trang-nam,96363295,"[TUYỆT CHIÊU ] Quần Sịp Sơ Vin Thông Minh cao cấp AJIKO, Cuốn Hút, Độc Đáo",230000,230000,0,0
TIKI,thoi-trang-nam,194022042,"Áo sơ mi nam ngắn tay Sans311 chất linen đũi trơn nhẹ thoáng mát đẹp cổ tàu trụ trắng xanh dương xám nhạt than be",189999,189999,0,0
TIKI,thoi-trang-nam,78488562,"Quần Jean Nam siêu cấp thương hiệu Chandi,  chất jean co dãn mẫu mới mã HD89",194000,299000,105000,35
TIKI,thoi-trang-nam,160814776,"quần lót nam relax thun lạnh cao cấp chính hãng, quần sipn nam relax rltk07 - M",104000,104000,0,0
TIKI,thoi-trang-nam,48101769,"Quần Lót Nam Boxer Kiểu Jean 5964",75000,75000,0,0
TIKI,thoi-trang-nam,76725581,"Áo thun Polo nam Novelty màu đỏ NATMMTMT3R180079N",286000,395000,109000,28
TIKI,thoi-trang-nam,207394337,"OPEN YOUR MIND, mã G164. Áo thun nam nữ in chữ siêu đẹp. Áo phông GOKING hàng hiệu cao cấp, vải cotton và thun lạnh giá rẻ",99000,99000,0,0
TIKI,thoi-trang-nam,168303685,"Áo sơ mi nam vải lụa cao cấp không nhăn, form hàn quốc, phù hợp đi làm, đi tiệc, đi học, đi chơi",159000,159000,0,0
TIKI,thoi-trang-nam,196954475,"Áo thun thời trang nam New Balance LIFESTYLE T-SHIRT M BLACK - MT23901BK (form quốc tế)",299000,299000,0,0
TIKI,thoi-trang-nam,115593847,"Quần Jogger Đen/Trắng Hoạ Tiết Hoạt Hình Ulzzang Nam Nữ 1hit_Unisex",147000,147000,0,0
TIKI,thoi-trang-nam,171046883,"Quần Bò Nam cao cấp thương hiệu Chandi, chất jean co dãn mẫu mới nhất  MS64",194000,350000,156000,45
TIKI,thoi-trang-nam,16311563,"Áo ba lỗ nam cao cấp mặc nhà, mặc ngủ Voga vải Modal",149000,149000,0,0
TIKI,thoi-trang-nam,149684587,"ÁO KHOÁC DÙ BOMBER CAO CỔ 7ZIA",105000,105000,0,0
TIKI,thoi-trang-nam,118159890,"ÁO GIỮ NHIỆT NAM CỔ 3 PHÂN HÀNG CAO CẤP",150000,150000,0,0
TIKI,thoi-trang-nam,115754343,"Áo Sơ Mi Nam Dài Tay SM004",79000,79000,0,0
TIKI,thoi-trang-nam,38629581,"Áo khoác nam",474000,499000,25000,5
TIKI,thoi-trang-nam,19403766,"Áo sơ mi nam sọc trắng đen dài tay cổ vest",108000,108000,0,0
TIKI,thoi-trang-nam,251562339,"JAPAN, mã G273. Áo thun in đẹp cho nam nữ, cặp đôi, gia đình. Áo phông Goking hàng hiệu cao cấp",69000,69000,0,0
TIKI,thoi-trang-nam,54916506,"Áo thun nam form rộng unisex tay lỡ in chữ BJHG, chất thun cotton dày dặn thấm hút mồ hôi, thời trang trẻ, phong cách Hàn Quốc",89000,89000,0,0
TIKI,thoi-trang-nam,192678290,"ÁO SƠ MI TAY NGẮN-V46-014618-BL3",3190000,3190000,0,0
TIKI,thoi-trang-nam,113234818,"Combo 4 quần đùi nam xuất khẩu vải kate cotton 100% thương hiệu Fezzio",249500,499000,249500,50
TIKI,thoi-trang-nam,83158705,"Áo Thun Nam Có Cổ Phối Logo",124000,124000,0,0
TIKI,thoi-trang-nam,22603926,"Quần short jean nam xanh bạc Q414 Muidoi",132000,132000,0,0
TIKI,thoi-trang-nam,164308730,"TOKYO JAPAN, mã G53. Áo thun nam nữ siêu đẹp. Áo phông thoát nhiệt Goking hàng hiệu",168000,168000,0,0
TIKI,thoi-trang-nam,95334507,"Quần short tây nam Novelty in họa tiết 2100090",284050,299000,14950,5
TIKI,thoi-trang-nam,177603771,"Quần Lót Nam Boxer Thun Lạnh Cao Cấp LUXIS, Quần Sịp Đùi Nam Co Giãn 4 Chiều Mềm Mịn Siêu thoáng mát - LD023",65000,85000,20000,24
TIKI,thoi-trang-nam,114415816,"Áo khoác dù nam nữ mặc in nổi hình sói , áo khoác gió , áo khoác unisex vải dù 2 lớp, Áo khoác kiểu bomber nam , Áo khoác dù nam , áo khoác kiểu bomber nam , áo dù bomber , áo khoác nam vải dù 2 lớp",95000,95000,0,0
TIKI,thoi-trang-nam,197720684,"Áo khoác hoodie Kill System So Sad oversize có nón nam nữ, vải nỉ bông chân cua phong cách unisex, Hoodie Nỉ Ngoại Too Young Toneso Sad Unisex Jacket form rộng tay bồng kiểu dáng đường phố hàn quốc",100000,100000,0,0
TIKI,thoi-trang-nam,85445120,"Áo thun nam tay lỡ có cổ vải cá sấu loại cao cấp mềm mịn co giãn tốt thấm hút mồ hôi mặc mát có nhiều size 55-85kg",39000,39000,0,0
TIKI,thoi-trang-nam,83518858,"ÁO KHOÁC KAKI NAM 2 LỚP",349700,349700,0,0
TIKI,thoi-trang-nam,107039457,"Set Đồ Lam Đi Chùa Cao Cấp Cho Nam S1 #đồ lam đi chùa - đồ phật tử",300000,300000,0,0
TIKI,thoi-trang-nam,78965186,"Đồ bộ thể thao nam vải thun lạnh mềm mịn, Thời Trang Phong Cách Hàn - Lee’s Home (Freesize từ 45-70kg)-Nhiều kiểu lựa chọn",75000,75000,0,0
TIKI,thoi-trang-nam,148680632,"QUẦN LÍNH TÚI HỘP HÀN QUỐC CỰC ĐẸP, Quần Kaki Lính Rằn Ri Chất Vải kaki, Quần jogger kaki rằn ri - lính nam túi hộp, QUẦN JOGGER KAKI CO GIÃN HOẠT TIẾT LÍNH CAO CẤP, Quần kaki dài basic nam nữ lính",95000,95000,0,0
TIKI,thoi-trang-nam,198304036,"SHORT THUN BIG SIZE NAM 80 ĐẾN 140KG CHỮ SPORT PRO",185000,185000,0,0
TIKI,thoi-trang-nam,68936826,"Áo Sơ Mi Mam Dài Tay Hàn Quốc Dáng Ôm Sơ Cổ Bẻ Vải Lụa Thái Chống Nhăn Chống Xù",124000,124000,0,0
TIKI,thoi-trang-nam,170270845,"Áo Polo Tay Ngắn Thiết Kế Phong Cách Năng Động Thời Trang AVIANO",99000,198000,99000,50
TIKI,thoi-trang-nam,165150012,"Quần tắm biển nam phong cách Nhật Bản 9850",99500,199000,99500,50
TIKI,the-thao-da-ngoai,14762149,"Bạt Kiêm Túi Miscato Đa Năng Tiện Dụng Đi Picnic, Phượt, Hoạt Động Ngoài Trời",53000,53000,0,0
TIKI,the-thao-da-ngoai,19686868,"GIÀY Trượt Patin Trẻ Em - Papaison A3",699000,699000,0,0
TIKI,the-thao-da-ngoai,124275874,"Dây Dù Siêu Chắc Dài 10m",14000,15000,1000,7
TIKI,the-thao-da-ngoai,189468141,"Xà Đơn Gắn Cửa FED-0228 | Kích thước 115-140cm (Chịu lực 400kg - Có chốt khóa an toàn khi gắn xà - Dễ dàng tháo lắp không cần khoan tường)",690000,790000,100000,13
TIKI,the-thao-da-ngoai,132713006,"Đũa Phíp Đen Soắn chống trơn trượt - Hàng Việt Nam",15000,15000,0,0
TIKI,the-thao-da-ngoai,33348363,"Sữa tăng cơ Rule 1 Casein 28 servings - 952g tặng 1 gói thử hãng Rule 1 bất kì",700000,700000,0,0
TIKI,the-thao-da-ngoai,58078050,"Phao Bơi Trẻ Em xỏ chân Sportslink - Hình Con Vịt",92000,102000,10000,10
TIKI,the-thao-da-ngoai,48696566,"Ống tay thun lạnh co giãn 4 chiều chống nắng và tia UV 3M PS2000",139000,139000,0,0
TIKI,the-thao-da-ngoai,78563386,"Balo Tennis Babolat PURE DRIVE 2021 (753089)",1699000,1990000,291000,15
TIKI,the-thao-da-ngoai,40770111,"Bó gối chân trong bóng đá, bóng chuyền",25000,25000,0,0
TIKI,the-thao-da-ngoai,2282593,"Bộ 4 Vỉ Đá Zippo",200000,200000,0,0
TIKI,the-thao-da-ngoai,107617019,"Combo Khăn trùm đầu Ninja Fullface + Găng Tay Chống Nắng Xỏ Ngón màu đen",24900,24900,0,0
TIKI,the-thao-da-ngoai,115270977,"Dây Nhảy Tập Thể Dục Cao Cấp Tại Nhà Lõi Thép Cao Cấp, Viền Tay Cầm Hình Kim Cương Chính Hãng Cao Cấp KitAcoom",89000,89000,0,0
TIKI,the-thao-da-ngoai,153610317,"TEE ĐỠ BÓNG GOLF - PGM - QT001",40000,40000,0,0
TIKI,the-thao-da-ngoai,176530434,"Dây Thun Quấn Chân Gối Đa Năng Aolikes Dài 120cm (1 Chiếc)",55000,55000,0,0
TIKI,the-thao-da-ngoai,147411482,"Đai quấn lưng tập gym bảo vệ lưng và cột sống lõi thép trợ lực bảo vệ giúp  tránh chấn thương hiệu quả HY008 - Hành chính hãng BORO SPORT",350000,350000,0,0
TIKI,the-thao-da-ngoai,139055367,"Bộ Vợt Cầu Lông Trẻ Em Vợt Cầu Lông Cho Bé - LYLY SPORTS",139000,139000,0,0
TIKI,the-thao-da-ngoai,49374148,"Cước câu cá chuyên dụng - Chất lượng siêu bền - Cước dài 500m  CCH04",179000,179000,0,0
TIKI,the-thao-da-ngoai,6625365,"Khung bóng rổ thi đấu - có kèm lưới",129000,129000,0,0
TIKI,the-thao-da-ngoai,160409520,"Giày đá bóng Dagger đã khâu Full Đế size từ 38 đến 43",250000,250000,0,0
TIKI,the-thao-da-ngoai,57780501,"Đai lưng tập gym GoodFit GF721WS",249000,300000,51000,17
TIKI,the-thao-da-ngoai,118007668,"Áo bó giữ nhiệt áo body áo tập gym AKKA co dãn 4 chiều",80000,95000,15000,16
TIKI,the-thao-da-ngoai,125573023,"Golf Strike Spray - Bình Xịt Mặt Gậy Golf Phân Tích Điểm Tiếp Xúc Bóng Golf Với Mặt Gậy Golf",331500,390000,58500,15
TIKI,the-thao-da-ngoai,103744213,"BĂNG CHẶN MỒ HÔI ĐẦU HEAD (285085) Giao màu ngẫu nhiên",149000,149000,0,0
TIKI,the-thao-da-ngoai,83484683,"Dụng cụ luyện tập sức mạnh ngón tay(tặng kèm pick)",59000,59000,0,0
TIKI,the-thao-da-ngoai,141634318,"Bao Đựng Cần Câu Tay Giá Rẻ 1m2",39700,39700,0,0
TIKI,the-thao-da-ngoai,110151809,"Bọc đầu cơ Bida cao cấp",65000,65000,0,0
TIKI,the-thao-da-ngoai,11020657,"Quần bơi nam boxer Deenyt A1807",198000,218000,20000,9
TIKI,the-thao-da-ngoai,57703479,"Combo 2 kẹp bịt mũi kèm 4 cái bịt tai ngăn nước đi bơi Legaxi",37000,37000,0,0
TIKI,the-thao-da-ngoai,58530328,"Kính Bảo Vệ Chơi Thể Thao, Bóng Rổ, Bóng Đá Chống Sương Mù, Mồ Hôi Cao Cấp REXCHI",125000,125000,0,0
TIKI,the-thao-da-ngoai,72455190,"Combo 5 Khăn Đa Năng Chống Nắng Có Thể Làm Khẩu Trang Nhiều Màu Sắc Dài 47CM",39000,39000,0,0
TIKI,the-thao-da-ngoai,26670886,"Cán cờ du lịch dành cho hướng dẫn viên dẫn đoàn, công ty lữ hành, loại  2m đầu đồng",120000,120000,0,0
TIKI,the-thao-da-ngoai,141613584,"Combo đầy đủ đi câu thuận lợi",164550,164550,0,0
TIKI,the-thao-da-ngoai,23229090,"2 Băng bảo vệ đầu gối - Băng gối thể thao cao cấp (SP073)",85000,85000,0,0
TIKI,the-thao-da-ngoai,16256787,"Bật lửa Zippo Armor High Polish Chrome 167",835000,835000,0,0
TIKI,the-thao-da-ngoai,147192876,"Bi Lăn Tay Inox, Dùng Tập Cơ Tay Vật Lý Trị Liệu -VT0227",93700,93700,0,0
TIKI,the-thao-da-ngoai,144404607,"Dây Kéo Lưng Cải Tiến Aolikes AL-7633 | Quấn Cổ Tay Nâng Tạ, Đu Xà, Tập Gym Chính Hãng",149000,149000,0,0
TIKI,the-thao-da-ngoai,31864103,"Quần thể thao Tennis nam",131100,138000,6900,5
TIKI,the-thao-da-ngoai,23013042,"Túi thể thao, Túi đeo bụng chạy bộ (SP041)",32670,47190,14520,31
TIKI,the-thao-da-ngoai,56902119,"Dụng cụ tập thể dục cho lưng, bụng có dây kéo lò xo đơn REXCHI( Màu ngẫu nhiên)",75000,75000,0,0
TIKI,the-thao-da-ngoai,5777583,"Túi ngủ du lịch dã ngoại (Giao màu ngẫu nhiên)",117000,117000,0,0
TIKI,the-thao-da-ngoai,57010114,"Lều 2 Lớp 4 - 5 Người Dã Ngoại Phượt Cắm Trại Galaxy Store GSL07 Chống Nước Tốt - Màu Ngẫu Nhiên",1175000,1950000,775000,40
TIKI,the-thao-da-ngoai,75396049,"Khăn trùm đầu Ninja Fullface đi phượt (Màu đen)",15000,15000,0,0
TIKI,the-thao-da-ngoai,95524187,"Lưỡi Câu Cá Maruseigo Thép Trắng Siêu Cứng Cực Bén Không Gỉ Sét",40000,40000,0,0
TIKI,the-thao-da-ngoai,136029752,"Tất Bóng Rổ, Tất Bóng Chuyền Chuyên Nghiệp V-pro. Dòng Tất Thể Thao Cao Cấp Có Độ Ôm Và Bảo Vệ Cổ Chân Tốt - Thấm Hút Mồ Hôi Và Rất Êm (1 Đôi)",85000,120000,35000,29
TIKI,the-thao-da-ngoai,104884872,"Bột Câu Cá Ngũ Vị Hương Hiệu Quả Với Cá Tra, Chép, Rô Phi Chuyên Dùng Ủ Cơm Thiu, Trộn Cháo Rết, Ủ Bún, Trộn Cám",55000,55000,0,0
TIKI,the-thao-da-ngoai,135815532,"Quả bóng đá EURO 2021 số 5, số 4 da PU - Tặng kim bơm bóng ( bóng may )",157000,157000,0,0
TIKI,the-thao-da-ngoai,146370515,"Dụng Cụ Hít Đất Chống Đẩy Đa Năng 14 Bài Tập – Dụng Cụ Chống Đẩy 18 Lỗ - Chính Hãng dododios",146000,146000,0,0
TIKI,the-thao-da-ngoai,35454276,"Bao Tay, Găng Tay Tập Gym, Tập YoGa Cho Nam, Nữ Cao Cấp - GT002",136000,136000,0,0
TIKI,the-thao-da-ngoai,111859855,"Bộ 5 Dây Ngũ Sắc Đàn Hồi Tập Gym, Tập Thể Hình Đa Năng Tại Nhà Amalife ",88000,88000,0,0
TIKI,the-thao-da-ngoai,169984115,"Bộ quần áo bóng đá - Áo đấu các câu lạc bộ bóng đá MU, PSG, Mancity, Liverpool...  mùa giải 2022 - Bộ đồ đá banh",95000,150000,55000,37
TIKI,the-thao-da-ngoai,20847671,"Bật lửa Zippo 352B –Bật lửa Zippo Venetian Brass",1050000,1050000,0,0
TIKI,the-thao-da-ngoai,11378700,"Mũ nón chống nắng nam, mũ nón đi câu cá, cắm trại cho Nam – chống tia UV – bảo vệ da đầu",132000,132000,0,0
TIKI,the-thao-da-ngoai,17909353,"Bàn bóng bàn Đức Long TL-05",4400000,4400000,0,0
TIKI,the-thao-da-ngoai,140333347,"Băng Đội Trưởng Captain C Bóng Đá",20000,20000,0,0
TIKI,the-thao-da-ngoai,60229542,"Dây Câu Cá Leader Daiwa D-Fron 100% Fluoro Carbon Cuộn 100m Made In Japan",278000,278000,0,0
TIKI,the-thao-da-ngoai,138898017,"Túi đeo bụng đựng điện thoại đi tập thể dục, chạy bộ",22106,31931,9825,31
TIKI,the-thao-da-ngoai,167025735,"Máy câu cá, câu tôm giá rẻ",40800,40800,0,0
TIKI,the-thao-da-ngoai,92806758,"La bàn cầm tay 4cm",15000,15000,0,0
TIKI,the-thao-da-ngoai,135539059,"Lọ chiết mỹ phẩm dầu gội du lịch Silicon 89ml",55000,55000,0,0
TIKI,the-thao-da-ngoai,33370060,"DỤNG CỤ KÌM BÓP TAY LÒ XO TẬP TAY CHẮC KHỎE",25000,25000,0,0
TIKI,the-thao-da-ngoai,8493528,"Xà đơn gắn cửa cải tiến có chốt chống xoay (83cm-130cm) - Đen Xanh Dương",312000,344000,32000,9
TIKI,the-thao-da-ngoai,148823403,"Bộ Đôi Găng Bao Tay Đấm Bốc Trẻ Em 5-13 Tuổi Cao Cấp – Găng Tay Tập Boxing MMA Trẻ Em Chính Hãng Dododios",109000,109000,0,0
TIKI,the-thao-da-ngoai,49267678,"Gel Uống Bổ Sung Năng Lượng Và Vitamin ENERGY GEL BiotechuSA",600000,600000,0,0
TIKI,the-thao-da-ngoai,25118084,"Dây cước câu cá Trilene Big Game",265000,265000,0,0
TIKI,the-thao-da-ngoai,169692394,"Bộ Cần Câu Bút Mini 1M Fish Pen",229000,229000,0,0
TIKI,the-thao-da-ngoai,33257269,"Thảm Yoga Fitness Adidas 7mm",810000,839000,29000,3
TIKI,the-thao-da-ngoai,21299541,"TÚI NGỦ VĂN PHÒNG CAO CẤP EDENA 75CM X 190CM",370000,370000,0,0
TIKI,the-thao-da-ngoai,122379441,"Tất thể thao Bendu hàng chính hãng cao cấp, nhiều 3 màu lựa chọn",35000,35000,0,0
TIKI,the-thao-da-ngoai,59213855,"Giày Trượt Patin 2 Hàng Bánh Chính Hãng LongFeng Cho Trẻ Em Và Người Lớn",593000,593000,0,0
TIKI,the-thao-da-ngoai,272445832,"Sữa tăng cơ hương vị tự nhiên Rule 1 Protein Isolate/ Hydrolysate Naturally Flavored 1.68 - 1.72lb tặng Rule 1 Sample",700000,700000,0,0
TIKI,the-thao-da-ngoai,170758060,"Tăng Bạt Trải Dã Ngoại Naturehike NH15D004-X Thảm Dã Ngoại Đa Năng",195000,195000,0,0
TIKI,the-thao-da-ngoai,149598355,"Dây cáp câu cá kèm sẵn lưỡi câu",2300,2300,0,0
TIKI,the-thao-da-ngoai,34278045,"Đai bó ống chân co giãn khi chơi thể thao loại dài (Màu ngẫu nhiên)",65550,69000,3450,5
TIKI,the-thao-da-ngoai,148567017,"Mồi Câu Cá Giả Bằng Nhựa Mềm 90mm/14g MG-15",12200,12200,0,0
TIKI,the-thao-da-ngoai,58450152,"Dây kéo lưng tập gym Lifting Straps GoodFit GF731LS",119000,149000,30000,20
TIKI,the-thao-da-ngoai,87094552,"Vợt Tennis Babolat PURE STRIKE LiTE 265gram 3rd Gen (101408)",4106000,4490000,384000,9
TIKI,the-thao-da-ngoai,191073426,"Kính bơi người lớn nam nữ + Mũ Bơi - hãng chính hãng dododios - Mã 2030",89000,89000,0,0
TIKI,the-thao-da-ngoai,181247253,"Túi Chiết Nhựa Đựng Mỹ Phẩm Lotion Dầu Gội Tiện Lợi Đi Du Lich 30ml / 50ml / 100ml",57000,57000,0,0
TIKI,the-thao-da-ngoai,148570608,"Chống cần Câu Đài Câu Đơn Cao Cấp Ultra Light KK-13",44100,44100,0,0
TIKI,the-thao-da-ngoai,42895584,"Gậy Massage Triggerpoint Acucurve",700000,700000,0,0
TIKI,the-thao-da-ngoai,187182785,"Đai bảo vệ cột sống ",238000,238000,0,0
TIKI,the-thao-da-ngoai,56407340,"GẬY TẬP THỂ LỰC SWING - PGM SOFT SWING BAR - HGB011",350000,550000,200000,36
TIKI,the-thao-da-ngoai,12110417,"Dụng cụ tập bắp cổ tay zeno",89000,89000,0,0
TIKI,the-thao-da-ngoai,76359754,"Găng Tay Thể Thao Glofit GFST012 Siêu Nhẹ, Siêu Thoáng (WORKOUT GLOVES)",345000,450000,105000,23
TIKI,the-thao-da-ngoai,189063341,"Chân Cắm Đất Gác Cần Câu Đài Chống Cần Câu Đài Cao Cấp DCC2",55000,55000,0,0
TIKI,the-thao-da-ngoai,136826840,"Quần đùi chạy bộ AERDIDA137725 nhẹ,thoáng khí, khô nhanh",249000,249000,0,0
TIKI,the-thao-da-ngoai,184783770,"hot - Ghế câu cá địa hình vải dù khung inox gấp gọn để du lịch dã ngoại cắm trại camping ngoài trời , cafe trà chanh",118999,118999,0,0
TIKI,the-thao-da-ngoai,169935973,"Gậy bơm hơi cổ vũ bóng đá, thể thao vui nhộn",10000,10000,0,0
TIKI,the-thao-da-ngoai,33454921,"Đai Lưng Mềm Tập GYM Valeo Bản To 15cm EVA-2",165000,165000,0,0
TIKI,the-thao-da-ngoai,146905558,"Mồi Câu Cá Dạng Viên Cám Câu Cá Trắm, Chép, Chôi, Rô Phi,..Loại Hạt To, Hạt Nhỏ Siêu Nhậy - thegioidocau",39000,39000,0,0
TIKI,the-thao-da-ngoai,90527569,"Bộ 10 Nấm Chiến Thuật Bóng Đá,Cone Tập Luyện Thể Thao Chiều Cao 16cm DNS002 Chính Hãng Đại Nam Sport (Giao Màu Ngẫu Nhiên)",89000,99000,10000,10
TIKI,the-thao-da-ngoai,161451921,"Bộ 2 vỏ tạ tay nhựa bát giác 5kg REEFIT (2 vỏ 5kg, tổng 10kg)",59000,59000,0,0
TIKI,the-thao-da-ngoai,67539013,"Đai bảo vệ, cố định khớp vai có điều chỉnh GoodFit GF702S  - Trái",149000,199000,50000,25
TIKI,the-thao-da-ngoai,195624120,"Dây nhảy thể dục lõi thép AOLIKES A-3201 Sport Jump Rope",92000,159000,67000,42
TIKI,the-thao-da-ngoai,6495813,"Bật Lửa Zippo 1935 Replica Brushed Chrome 1935.25",955000,955000,0,0
TIKI,the-thao-da-ngoai,191648646,"Dây giày thông minh phản quang 3 vạch LiveFit Lock Laces không cần buột I vừa với mọi loại giày I Chất liệu dây Nylon bền chắc với thời gian",99000,99000,0,0
TIKI,the-thao-da-ngoai,491591,"Tạ Nhập Khẩu - TNK- 4Kg - Đen",410000,410000,0,0
TIKI,the-thao-da-ngoai,13644922,"Đấm bốc trẻ em Boxing Suit - Bộ đồ tập đấm bốc boxing chuyên nghiệp cho trẻ em",220999,220999,0,0
TIKI,the-thao-da-ngoai,138737865,"Ghế câu cá. Ghế dã ngoại gấp ngọn tiện lợi - Cần Câu Top1 VN",106800,106800,0,0
TIKI,the-thao-da-ngoai,74814137,"Cần câu tay Carbon Daiwa Dao chính hãng 39 (3m9), Dao 45 (4m5), Dao 54 (5m4), Dao 63 (6m3)",1981000,1981000,0,0
TIKI,the-thao-da-ngoai,132777616,"TÚI CHỐNG NƯỚC BỌC BALO",29000,29000,0,0
TIKI,the-thao-da-ngoai,124274396,"Túi Bọc Balo Chống Thấm Nước",33000,35000,2000,6
TIKI,the-thao-da-ngoai,14370033,"Bộ dây tập thể lực TRX P1 SUSPENSION THIENTRUONG",699000,699000,0,0
TIKI,the-thao-da-ngoai,115085981," ỐNG CẦU LÔNG HẢI YẾN XÁM BẠC CHUYÊN NGHIỆP, CHẤT LƯỢNG CAO",115000,115000,0,0
TIKI,the-thao-da-ngoai,88822152,"Lều 2 Lớp 4 - 5 Người Dã Ngoại Phượt Cắm Trại Galaxy Store GSL07 Chống Nước Tốt Kèm Quà Tặng - Hàng Chính Hãng (Màu Ngẫu Nhiên)",1175000,2000000,825000,41
TIKI,the-thao-da-ngoai,44005347,"Đồng hồ thi đấu cờ PS-1688 (42 chế độ chỉnh thời gian) màu Xanh",380000,380000,0,0
TIKI,the-thao-da-ngoai,92807055,"Còi cứu sinh có la bàn và nhiệt kế",29000,29000,0,0
TIKI,the-thao-da-ngoai,131395791,"Khóa Linh Chống Xoắn, Khóa Link Chữ U Cao Cấp - Phụ kiện câu cá",60000,60000,0,0
TIKI,the-thao-da-ngoai,167422373,"Bộ 2 tạ tay cao su Reefit màu đen 3kg (gồm 2 cục)",360000,360000,0,0
TIKI,the-thao-da-ngoai,186558684,"Bục Nhảy Tập GYM Aerobic Có Thể Điều Chỉnh Kích Thước",495000,495000,0,0
TIKI,the-thao-da-ngoai,180046042,"Quần Short Legging Nam Ngắn Ôm Bó Cơ Giữ Nhiệt - LocalBrand X9 - Tập Gym Đá Bóng Yoga Chạy Bộ - X004",320000,320000,0,0
TIKI,the-thao-da-ngoai,69025166,"Bó cổ chân có đai thể thao bảo vệ gót mắt cá co giãn tránh chấn thương H010",79000,79000,0,0
TIKI,the-thao-da-ngoai,156047442,"Cần câu lục xa bờ Comando USA 4m25 và 4m5 Hàng loại 1 Độ Cứng 45 Top1vn",503000,503000,0,0
TIKI,the-thao-da-ngoai,149614364,"Cần câu máy rút gọn Percast đủ size 2m1 đến 3m6 - cần câu cá giá rẻ",104050,104050,0,0
TIKI,the-thao-da-ngoai,115344720,"Áo phao bơi, áo phao lính người lớn và trẻ em",130000,130000,0,0
TIKI,the-thao-da-ngoai,63493859,"Quấn cổ chân tập GYM tập mông với cáp phụ kiện Gym chuyên nghiệp AK_26",70000,70000,0,0
TIKI,the-thao-da-ngoai,144221631,"Bộ dụng cụ tập luyện đánh bóng Tennis tại nhà kèm đế  cực kì tiện dụng tập mọi lúc mọi nơi",99000,99000,0,0
TIKI,the-thao-da-ngoai,7879077,"Ghế xếp du lịch siêu gọn nhẹ",59000,59000,0,0
TIKI,the-thao-da-ngoai,1694657,"Áo Hỗ Trợ Đốt Mỡ Giảm Cân Cho Nam Giới Sportslink SK Fitness (Size",106000,142000,36000,25
TIKI,cross-border-hang-quoc-te,14762149,"Bạt Kiêm Túi Miscato Đa Năng Tiện Dụng Đi Picnic, Phượt, Hoạt Động Ngoài Trời",53000,53000,0,0
TIKI,cross-border-hang-quoc-te,124275874,"Dây Dù Siêu Chắc Dài 10m",14000,15000,1000,7
TIKI,cross-border-hang-quoc-te,58078050,"Phao Bơi Trẻ Em xỏ chân Sportslink - Hình Con Vịt",92000,102000,10000,10
TIKI,cross-border-hang-quoc-te,19686868,"GIÀY Trượt Patin Trẻ Em - Papaison A3",699000,699000,0,0
TIKI,cross-border-hang-quoc-te,132713006,"Đũa Phíp Đen Soắn chống trơn trượt - Hàng Việt Nam",15000,15000,0,0
TIKI,cross-border-hang-quoc-te,189468141,"Xà Đơn Gắn Cửa FED-0228 | Kích thước 115-140cm (Chịu lực 400kg - Có chốt khóa an toàn khi gắn xà - Dễ dàng tháo lắp không cần khoan tường)",690000,790000,100000,13
TIKI,cross-border-hang-quoc-te,40770111,"Bó gối chân trong bóng đá, bóng chuyền",25000,25000,0,0
TIKI,cross-border-hang-quoc-te,115270977,"Dây Nhảy Tập Thể Dục Cao Cấp Tại Nhà Lõi Thép Cao Cấp, Viền Tay Cầm Hình Kim Cương Chính Hãng Cao Cấp KitAcoom",89000,89000,0,0
TIKI,cross-border-hang-quoc-te,107617019,"Combo Khăn trùm đầu Ninja Fullface + Găng Tay Chống Nắng Xỏ Ngón màu đen",24900,24900,0,0
TIKI,cross-border-hang-quoc-te,153610317,"TEE ĐỠ BÓNG GOLF - PGM - QT001",40000,40000,0,0
TIKI,cross-border-hang-quoc-te,176530434,"Dây Thun Quấn Chân Gối Đa Năng Aolikes Dài 120cm (1 Chiếc)",55000,55000,0,0
TIKI,cross-border-hang-quoc-te,6625365,"Khung bóng rổ thi đấu - có kèm lưới",129000,129000,0,0
TIKI,cross-border-hang-quoc-te,147411482,"Đai quấn lưng tập gym bảo vệ lưng và cột sống lõi thép trợ lực bảo vệ giúp  tránh chấn thương hiệu quả HY008 - Hành chính hãng BORO SPORT",350000,350000,0,0
TIKI,cross-border-hang-quoc-te,118007668,"Áo bó giữ nhiệt áo body áo tập gym AKKA co dãn 4 chiều",80000,95000,15000,16
TIKI,cross-border-hang-quoc-te,33348363,"Sữa tăng cơ Rule 1 Casein 28 servings - 952g tặng 1 gói thử hãng Rule 1 bất kì",700000,700000,0,0
TIKI,cross-border-hang-quoc-te,48696566,"Ống tay thun lạnh co giãn 4 chiều chống nắng và tia UV 3M PS2000",139000,139000,0,0
TIKI,cross-border-hang-quoc-te,16256787,"Bật lửa Zippo Armor High Polish Chrome 167",835000,835000,0,0
TIKI,cross-border-hang-quoc-te,141613584,"Combo đầy đủ đi câu thuận lợi",164550,164550,0,0
TIKI,cross-border-hang-quoc-te,160409520,"Giày đá bóng Dagger đã khâu Full Đế size từ 38 đến 43",250000,250000,0,0
TIKI,cross-border-hang-quoc-te,139055367,"Bộ Vợt Cầu Lông Trẻ Em Vợt Cầu Lông Cho Bé - LYLY SPORTS",139000,139000,0,0
TIKI,cross-border-hang-quoc-te,78563386,"Balo Tennis Babolat PURE DRIVE 2021 (753089)",1699000,1990000,291000,15
TIKI,cross-border-hang-quoc-te,49374148,"Cước câu cá chuyên dụng - Chất lượng siêu bền - Cước dài 500m  CCH04",179000,179000,0,0
TIKI,cross-border-hang-quoc-te,125573023,"Golf Strike Spray - Bình Xịt Mặt Gậy Golf Phân Tích Điểm Tiếp Xúc Bóng Golf Với Mặt Gậy Golf",331500,390000,58500,15
TIKI,cross-border-hang-quoc-te,2282593,"Bộ 4 Vỉ Đá Zippo",200000,200000,0,0
TIKI,cross-border-hang-quoc-te,72455190,"Combo 5 Khăn Đa Năng Chống Nắng Có Thể Làm Khẩu Trang Nhiều Màu Sắc Dài 47CM",39000,39000,0,0
TIKI,cross-border-hang-quoc-te,26670886,"Cán cờ du lịch dành cho hướng dẫn viên dẫn đoàn, công ty lữ hành, loại  2m đầu đồng",120000,120000,0,0
TIKI,cross-border-hang-quoc-te,57780501,"Đai lưng tập gym GoodFit GF721WS",249000,300000,51000,17
TIKI,cross-border-hang-quoc-te,56902119,"Dụng cụ tập thể dục cho lưng, bụng có dây kéo lò xo đơn REXCHI( Màu ngẫu nhiên)",75000,75000,0,0
TIKI,cross-border-hang-quoc-te,57703479,"Combo 2 kẹp bịt mũi kèm 4 cái bịt tai ngăn nước đi bơi Legaxi",37000,37000,0,0
TIKI,cross-border-hang-quoc-te,23229090,"2 Băng bảo vệ đầu gối - Băng gối thể thao cao cấp (SP073)",85000,85000,0,0
TIKI,cross-border-hang-quoc-te,103744213,"BĂNG CHẶN MỒ HÔI ĐẦU HEAD (285085) Giao màu ngẫu nhiên",149000,149000,0,0
TIKI,cross-border-hang-quoc-te,144404607,"Dây Kéo Lưng Cải Tiến Aolikes AL-7633 | Quấn Cổ Tay Nâng Tạ, Đu Xà, Tập Gym Chính Hãng",149000,149000,0,0
TIKI,cross-border-hang-quoc-te,58530328,"Kính Bảo Vệ Chơi Thể Thao, Bóng Rổ, Bóng Đá Chống Sương Mù, Mồ Hôi Cao Cấp REXCHI",125000,125000,0,0
TIKI,cross-border-hang-quoc-te,147192876,"Bi Lăn Tay Inox, Dùng Tập Cơ Tay Vật Lý Trị Liệu -VT0227",93700,93700,0,0
TIKI,cross-border-hang-quoc-te,110151809,"Bọc đầu cơ Bida cao cấp",65000,65000,0,0
TIKI,cross-border-hang-quoc-te,11020657,"Quần bơi nam boxer Deenyt A1807",198000,218000,20000,9
TIKI,cross-border-hang-quoc-te,83484683,"Dụng cụ luyện tập sức mạnh ngón tay(tặng kèm pick)",59000,59000,0,0
TIKI,cross-border-hang-quoc-te,141634318,"Bao Đựng Cần Câu Tay Giá Rẻ 1m2",39700,39700,0,0
TIKI,cross-border-hang-quoc-te,23013042,"Túi thể thao, Túi đeo bụng chạy bộ (SP041)",32670,47190,14520,31
TIKI,cross-border-hang-quoc-te,31864103,"Quần thể thao Tennis nam",131100,138000,6900,5
TIKI,thoi-trang-nam,54762609,"Quần kaki nam 1 ply Khatoco Q2M528R1-INMA003-2106-1",422400,528000,105600,20
TIKI,thoi-trang-nam,189467654,"Quần Jeans nam dáng regular fit 6Q7092 - thương hiệu Viettien",645000,645000,0,0
TIKI,thoi-trang-nam,37650433,"ÁO KHOÁC KAKI NAM UNISEX -LLQAK01",120000,120000,0,0
TIKI,thoi-trang-nam,95053766,"Áo Khoác Big Size Nam Nữ Áo Khoác Kaki Unisex Chống Nóng Chống Nắng Chống Lạnh Chống Gió 2 Lớp Có Cổ Cao Thời Trang Nam Tính Hàn Quốc Cao Cấp QK36 - ShopN6",169000,235000,66000,28
TIKI,thoi-trang-nam,197600242,"Hộp 4 quần lót nam boxer CITYMEN lưng Thái cao cấp vải thun lạnh co giãn 4 chiều - Giao màu ngẫu nhiên",180000,180000,0,0
TIKI,thoi-trang-nam,186290944,"Áo Sơ Mi nam sọc caro tím trắng dài tay NSMMCLMTCR212807D",303000,319000,16000,5
TIKI,thoi-trang-nam,85086742,"Áo sơ mi nam cổ trụ dài tay sọc đẹp",159000,159000,0,0
TIKI,thoi-trang-nam,7823134,"Bộ 3 Quần Boxer Đúc Nam Nhật Bản (Nhiều màu) - 5Star",120000,120000,0,0
TIKI,thoi-trang-nam,67545395,"Quần tây nam vải co giãn , quần âu nam vải tuyết mưa hàn quốc - xanh than - 33",115000,115000,0,0
TIKI,thoi-trang-nam,52311502,"Áo Khoác Cao Cấp, Áo Khoác Kaki Nam Hàn Quốc",163000,163000,0,0
TIKI,thoi-trang-nam,187861992,"Quần bơi dài, lửng",95000,95000,0,0
TIKI,thoi-trang-nam,181422834,"Áo thun Classic nam 2018, hàng nhập Quảng Châu",69000,69000,0,0
TIKI,thoi-trang-nam,114285672,"Hộp 5 cái quần lót tam giác thông hơi nam - Sịp lưới nam thoáng mát",86600,86600,0,0
TIKI,thoi-trang-nam,192413381,"Quần short đùi nam cao cấp TC với thiết kế logo thêu bền đẹp, chất cotton co dãn tốt, năng động, thể thao,thời trang-362",450000,450000,0,0
TIKI,thoi-trang-nam,161539220,"quần lót nam relax cotton cao cấp chính hãng, quần sịp nam relax underwear rltk23",89000,89000,0,0
TIKI,thoi-trang-nam,174369429,"Áo đũi nam cổ tầu phối túi ngực xếp ly trẻ trung, thời trang xuân hè 2022",179000,179000,0,0
TIKI,thoi-trang-nam,21190890,"Áo Sơ Mi Nam Ngắn Tay Hình Logo NTLG6895",165000,165000,0,0
TIKI,thoi-trang-nam,98023604,"ĐỒ BỘ NAM MẶC Ở NHÀ, ĐI CHƠI ÁO BA LỖ IN CHỮ OFF CHẤT THUN LẠNH, QUẦN KAKI TÚI KHÓA, LÊN FORM CỰC ĐẸP, ĐỒ BỘ MẠC NHÀ SÁT NÁCH CHỮ OFF, BỘ ĐỒ THỂ THAO SÁT NÁCH, BỘ ĐỒ ĐÔI NAM NỮ,  BỘ ĐỒ NAM NỮ",115000,115000,0,0
TIKI,thoi-trang-nam,190321094,"Áo sơ mi, Áo sơ mi nam cổ đứng thêu hoa văn, vạt chéo tạo điểm nhấn cho chiếc áo của bạn, sang trọng, lịch lãm H37",199000,199000,0,0
TIKI,thoi-trang-nam,147444526,"Áo Sơ Mi Nam Dài Tay Sọc Ngang Bảng To PONIVA",164000,164000,0,0
TIKI,thoi-trang-nam,192367917,"Quần short đùi nam cao cấp TC với thiết kế họa tiết logo thêu, kết hợp phần sọc bên hông quần tạo điểm nhấn, chất cotton mát, co dãn, phong cách trẻ trung, năng động, thể thao-364",450000,450000,0,0
TIKI,thoi-trang-nam,140579763,"QUẦN KAKI NAM NỮ CHẤT VẢI DÀY",229000,229000,0,0
TIKI,thoi-trang-nam,67733705,"Áo thun dài tay nam nữ",86000,86000,0,0
TIKI,thoi-trang-nam,137912762,"Áo Sơ Mi Nam Dài Tay Caro MR265 Thời Trang PONIVA Thiết Kế Nam Tính Lịch Lãm Hàng Chất Lượng XNK",169000,169000,0,0
TIKI,thoi-trang-nam,10776493,"Áo thun trơn basic, form unisex cho nam nữ. Áo phông hàng hiệu Goking, quà tặng cao cấp cho gia đình, cặp đôi, lớp nhóm, doanh nghiệp, người nước ngoài",138000,138000,0,0
TIKI,thoi-trang-nam,2630799,"Áo thun nam trơn cổ tròn - ( trắng)",39000,39000,0,0
TIKI,thoi-trang-nam,129297930,"quần short đũi nam trung niên ống suông đũng dài chất đẹp không nhăn không nhàu",199000,199000,0,0
TIKI,thoi-trang-nam,114056064,"Quần jogger 2 da cao cấp in hoạ tiết unisex nam nữ có dây rút ống thời trang Hàn",99000,99000,0,0
TIKI,thoi-trang-nam,34158949,"Áo Sơ Mi Nam Sọc Trắng",99000,99000,0,0
TIKI,thoi-trang-nam,177750772,"Bộ bơi nam 3 chi tiết quần áo dài tay chống nắng cao cấp",460000,460000,0,0
TIKI,thoi-trang-nam,30768234,"Áo sơ mi nam cổ trụ chui đầu dài tay kẻ sọc trắng đen",159000,159000,0,0
TIKI,thoi-trang-nam,170726691,"Viettien - Áo sơ mi nam ngắn tay vạt bầu chấm bi 1Q1180 regular",490000,490000,0,0
TIKI,thoi-trang-nam,216901915,"Áo đồng phục công nhân, kỹ sư vải kaki Nam Định phối phản quang",110000,110000,0,0
TIKI,thoi-trang-nam,124554704,"Quần tây vải quần tây nam ống côn vải dãn dành cho học sinh, sinh viên có big size từ 26 đến 37",139000,139000,0,0
TIKI,thoi-trang-nam,73611098,"Quần tây âu nam dáng ôm trẻ trung năng động, chất tuyết mưa dày dặn không bai xù, size từ 45-80 kg, quần baggy đen co dãn",117000,117000,0,0
TIKI,thoi-trang-nam,48427720,"Quần Lót Nam Boxer Body Thể Thao Cam Đen 5969",61000,69000,8000,12
TIKI,thoi-trang-nam,181423159,"Áo thun nam cotton cơ bản in hình sóc, chất vải cotton dày dặn, thời trang xuân hè 2021",35000,35000,0,0
TIKI,thoi-trang-nam,99485511,"Quần jean nam rách cao cấp vải jean co dãn hàng chuẩn shop Phuongnamshop20 kvp58",125000,125000,0,0
TIKI,thoi-trang-nam,124749863,"QUẦN TÂY MÀU XANH ĐEN VIỆT TIẾN",580000,580000,0,0
TIKI,thoi-trang-nam,126156231,"quần đi biển 1 hàng cao cấp , nhóm, du lịch mùa hè.hàng đẹp, vải mát, đồng phục đủ size cho cả nhà",45000,45000,0,0
TIKI,thoi-trang-nam,56903242,"Quần Short Nam Kaki Phong Cách Thời Trang VICERO",159000,298000,139000,47
TIKI,thoi-trang-nam,114323545,"Áo Khoác Dù Nam Nữ Kiểu Bomber Thêu TM 21 Unisex Form Rộng",96000,96000,0,0
TIKI,thoi-trang-nam,133875924,"Quần Lót Nam Boxer Thun Lạnh 4 Chiều Lưng Thái Cao Cấp, Quần Sịp Đùi Co Giãn Và Thấm Hút Tốt CITYMEN ( Màu Ngẫu Nhiên )",54000,54000,0,0
TIKI,thoi-trang-nam,68354319,"Áo khoác dù 2 mặt thời trang nam M.O.N Boutique",109000,109000,0,0
TIKI,thoi-trang-nam,164344210,"Áo PoLo Nam Ngắn Tay 7 Màu Thiết Kế Phong Cách Thời Trang Cao Cấp AVIANO",189000,360000,171000,48
TIKI,thoi-trang-nam,163553232,"Áo Phông Nam PoLo Ngắn Tay 4 Màu Kiểu Dáng Thời Trang Cao Cấp AVIANO",129000,258000,129000,50
TIKI,thoi-trang-nam,81159816,"Quần Jean Nam cao cấp chất bò siêu co dãnThương Hiệu Chandi, form đứng dáng đẹp mẫu mới siêu hot MR9034",184000,299000,115000,38
TIKI,thoi-trang-nam,73236732," Áo thun tay lỡ cotton trơn [ áo thun tay lỡ unisex nam nữ mặc được",34000,34000,0,0
TIKI,thoi-trang-nam,144232133,"Quần Jean nam baggy Ống Rộng - quần bò nam- Jean nam dày phong cách ( màu đen)",120000,120000,0,0
TIKI,thoi-trang-nam,168994241,"Áo sơ mi nam Novelty ngắn tay trơn màu 171140N vạt ngang",169000,469000,300000,64
TIKI,thoi-trang-nam,105231685,"đồ bộ thể thao mặc nhà, đồ bộ dạo phố chất thun thoáng mát, set bộ thể thao unisex ulzzang phong cách hàn quốc, đồ bộ hàn quốc, đồ bộ nam nữ, BỘ ĐỒ NAM / BỘ ĐỒ NỮ / BỘ QUẦN ÁO NAM /BỘ QUẦN ÁO THỂ THAO BỘ ĐỒ NAM NỮ",99000,99000,0,0
TIKI,thoi-trang-nam,76301321,"Quần Lót Nam tam giác vải cotton 2 chiều lưng CITYMEN, đồ lót - LMTK-CTM2C",25000,25000,0,0
TIKI,thoi-trang-nam,171049945,"Quần Bò Nam cao cấp thương hiệu Chandi, chất jean co dãn mẫu mới nhất MD22",194000,350000,156000,45
TIKI,thoi-trang-nam,20146794,"Quần Jean Nam Xanh Đậm Hàn Quốc XANHDAM52 - Xanh Đậm",134000,134000,0,0
TIKI,thoi-trang-nam,160902809,"Quần Jogger Nam LAMPOS, Cotton Cao Cấp, Siêu Co Giản - Thoáng Mát - Siêu Bền (Màu đen)",195000,195000,0,0
TIKI,thoi-trang-nam,105678723,"Quần jean nam quần bò màu trắng trơn và trắng rách gối cá tính dễ phối đồ chất jean bò co dãn thoải mái vận động",199000,199000,0,0
TIKI,thoi-trang-nam,76538210,"Áo Sơ Mi Nam Trắng Trơn cao cấp lụa không nhắn thương hiệu Chandi, Dáng ôm phong cách trẻ trung Mẫu A1111",151000,220000,69000,31
TIKI,thoi-trang-nam,70937555,"Áo khoác kaki nam 2 lớp thời trang SITAKI cao cấp AKK18",175000,175000,0,0
TIKI,thoi-trang-nam,122559240,"Quần đùi đũi nam,quần short nam mát mẻ QD06",149000,149000,0,0
TIKI,thoi-trang-nam,13690239,"Áo Khoác Da Nam Đen Black Leather ShopN6 Cao Cấp AKD21",269000,299000,30000,10
TIKI,thoi-trang-nam,90219503,"Áo Thun Nam Nữ From Rộng - Hình Con Mèo Cực Dễ Thương",26000,26000,0,0
TIKI,thoi-trang-nam,137611546,"Áo Thun Thể Thao Nam TSIMPLE cổ tròn tay ngắn tập gym vải thun lạnh thoáng mát co giãn chuẩn form MSSAHRBC",109000,149000,40000,27
TIKI,thoi-trang-nam,182134920,"Viettien - Áo sơ mi công sở nam dài tay màu trắng mới 390 regular",390000,390000,0,0
TIKI,thoi-trang-nam,177309367,"Combo 2 quần đùi nam mở moi May 10 - màu ngẫu nhiên",90000,90000,0,0
TIKI,thoi-trang-nam,151801291,"MIẾNG ĐỘN QUẦN LÓT NAM - ĐỘN TRƯỚC SEXY - Loaị Nổi 3D",29000,29000,0,0
TIKI,thoi-trang-nam,107707462,"Quần Lót Nam vải thun lạnh 4 chiều lưng Hàn Quốc hiệu CITYMEN cao cấp, sịp nam - LMTK-HANAL (Giao màu ngẫu nhiên)",21000,21000,0,0
TIKI,thoi-trang-nam,48275273,"COMBO 05 Quần đùi nam c mềm mát (mẫu caro < 80kg )",93000,93000,0,0
TIKI,thoi-trang-nam,104913896,"áo khoác dù JACKET KILL SYSTEM, Áo khoác dù kiểu bomber logo Kill System phong cách, ÁO KHOÁC DÙ NAM NỮ FORM RỘNG KILL SYSTEM SIÊU CHẤT MỚI VỀ, ÁO KHOÁC DÙ CÓ NÓN UNISEX ULZZANG PHONG CÁCH HÀN QUỐC",99000,99000,0,0
TIKI,thoi-trang-nam,98902559,"Quần lót nam đùi ngắn cotton iBasic PANM078",79000,119000,40000,34
TIKI,thoi-trang-nam,145757423,"Quần Tây Nam Oscar Slim Fit - OCMPKSE 012 - GRY",449000,1290000,841000,65
TIKI,thoi-trang-nam,3714775,"Combo 5 Quần Lót Nam Freeman 6023-CB5-M (Size",316000,395000,79000,20
TIKI,thoi-trang-nam,81938009,"Áo hoodie nam / áo hooodie nữ / áo hoodie form rộng / áo khoác nam có nón trùm đầu / áo hoodie cặp đôi / áo khoác cặp đôi in con hạc",59000,59000,0,0
TIKI,thoi-trang-nam,112099693,"Áo Sơ Mi Dài Tay Lính Mỹ U458 US ARMY, Chất Liệu Vải Kaki Cao Cấp Thiết Kế Túi Hộp Phong Cách Loại Xịn- HÀNG CHÍNH HÃNG",379000,800000,421000,53
TIKI,thoi-trang-nam,115453581,"Quần Kaki Nam Lính Mỹ USARMY U629 Cao Cấp, Kiểu Dáng Quần Túi Hộp Phong Cách Cực Ngầu -HÀNG CHÍNH HÃNG",538000,1139000,601000,53
TIKI,thoi-trang-nam,107453690,"OWEN - Áo sơ mi trắng OWEN chất Nano không nhăn (REGULAR/SLIM)",580000,580000,0,0
TIKI,thoi-trang-nam,114536004,"Combo 3 quần lót nam thun brief Espresso iBasic PANM102",228000,297000,69000,23
TIKI,thoi-trang-nam,22620760,"Quần Jean Nam Cao Cấp Co Giản Mạnh m 5 6 7 8",105000,105000,0,0
TIKI,thoi-trang-nam,134647757,"Quần lót nam ARISTINO dáng Brief, quần sịp tam giác nam chất liệu cotton mềm mại, thoáng mát - ABF03707",79500,95000,15500,16
TIKI,thoi-trang-nam,190515998,"Quần lót nam boxer CITYMEN lưng Hàn Quốc cao cấp vải cotton co dãn 4 chiều mềm mại thoáng khí thấm hút tốt, quần xịp sịp đùi nam bao đổi trả 90 ngày",56000,56000,0,0
TIKI,thoi-trang-nam,107643677,"Quần Lót Nam lưng Hàn Quốc vải cotton co giãn 4 chiều hiệu CITYMEN cao cấp, đồ lót - LMTK-HANAC",46000,46000,0,0
TIKI,cross-border-hang-quoc-te,10732338,"Mindset - Updated Edition: Changing The Way You think To Fulfil Your Potential ",399000,399000,0,0
TIKI,cross-border-hang-quoc-te,11714322,"Stone Fox 30th Anniversary Edition",255000,255000,0,0
TIKI,cross-border-hang-quoc-te,178787714,"Sad Light Therapy Lamp 10000 Lux UV Free Adjustable Brightness Touch Control",586000,586000,0,0
TIKI,cross-border-hang-quoc-te,17968918,"Letters From A Stoic",421000,421000,0,0
TIKI,cross-border-hang-quoc-te,170656768,"Sách - The Jesus Storybook Bible : Every Story Whispers His Name by Sally Lloyd-Jones (US edition, hardcover)",813000,813000,0,0
TIKI,cross-border-hang-quoc-te,109165144,"Túi xe đạp Khung trước Chất lượng cao WEST BIKING với thiết kế Màn hình chống thấm nước",337000,337000,0,0
TIKI,cross-border-hang-quoc-te,185341219,"Túi Đựng Điện Thoại Đeo Cánh Tay Khi Chạy Bộ Thể Thao Dành Cho Nam Và Nữ",225000,225000,0,0
TIKI,cross-border-hang-quoc-te,134550925,"Không Dây Dây Nhảy Cho Thể Dục, Trong Nhà Tập Thể Dục Dây Nhảy, Không Bị Rối Ropeless Dây Nhảy Thể Thao Dành Cho Huấn Luyện - one",452571,452571,0,0
TIKI,cross-border-hang-quoc-te,98114939,"1Piece Laptop Internal Cooling Fan M.2 NGFF SSD Caddy Adapter 9.5mm SATA Drive Bay",651000,651000,0,0
TIKI,cross-border-hang-quoc-te,11504677,"Learn To Earn",391000,391000,0,0
TIKI,cross-border-hang-quoc-te,58727623,"Bluetooth Smart Watch Wrist Watch Blood Pressure Monitor Smartwatch Bracelet",175000,175000,0,0
TIKI,cross-border-hang-quoc-te,97752364,"Carburetor for Yamaha PW80 Dirt Bike Carb 1983 84 85 86 87 88 89 00-06",380000,380000,0,0
TIKI,cross-border-hang-quoc-te,6292539,"Dung Dịch Vệ Sinh Phụ Nữ Chiết Xuất Tự Nhiên HH (200ml)",720000,720000,0,0
TIKI,cross-border-hang-quoc-te,11544637,"The Monk Who Sold His Ferrari",291000,291000,0,0
TIKI,cross-border-hang-quoc-te,170725864,"Sách - Beating the Street by Peter Lynch (US edition, paperback)",476000,476000,0,0
TIKI,cross-border-hang-quoc-te,11708850,"Put Your Dream To The Test: 10 Questions To Help You See It And Seize It",519000,519000,0,0
TIKI,cross-border-hang-quoc-te,109442075,"Thiết bị chống nghiến răng cho nam nữ được làm từ chất liệu EVA cao cấp, bền lâu, hợp vệ sinh, mềm mại",115000,115000,0,0
TIKI,cross-border-hang-quoc-te,76387786,"Military Backpack for Men Large Capacity Rucksacks Daypack Tactical Travel Shoulder Bags for Work, School, Camping, Hunting, Hiking",754000,754000,0,0
TIKI,cross-border-hang-quoc-te,95724020,"Bộ 4 Đầu Chuyển Đổi Van Hơi Cho Xe Đạp",284000,284000,0,0
TIKI,cross-border-hang-quoc-te,175843768,"2 in 1 Wireless Charger Stand Dock for MagSafe (Chargers Not Included)",218000,218000,0,0
TIKI,cross-border-hang-quoc-te,94930766,"Stainless Steel Portable Cigar Cutter Double Blades Scissors for Most size of Cigarette",153000,153000,0,0
TIKI,cross-border-hang-quoc-te,46388483,"Sunnimix Trẻ Em Tay Bộ Gõ Nhạc Học Giáo Dục Đồ Chơi Cát Maracas Lắc Trống",527000,527000,0,0
TIKI,cross-border-hang-quoc-te,111389931,"Túi du lịch thời trang cho nam MARK RYDEN, thiết kế chống nước, nhiều ngăn, dung tích lớn",758000,758000,0,0
TIKI,cross-border-hang-quoc-te,170582810,"Sách - The Essential Cocktail Book : A Complete Guide to Modern Drinks with 15 by Megan Krigbaum (US edition, paperback)",684000,684000,0,0
TIKI,cross-border-hang-quoc-te,76903350,"Stylus Pen for iPad Active Pencil Compatible for Apple iPad Pro (2018-2020) for Precise Writing and Drawing",202000,202000,0,0
TIKI,cross-border-hang-quoc-te,253061544,"Wart soothing corns cream Ke wart cream",106000,106000,0,0
TIKI,cross-border-hang-quoc-te,183348763,"Helmet Light Lamp Torch Headlamp Helmet Mount Flashlight for Outdoor Accessories",459000,459000,0,0
TIKI,cross-border-hang-quoc-te,96327718,"Celluloid Guitar Binding Purfling Strip for Acoustic Classical Guitar Parts Accessories",130000,130000,0,0
TIKI,cross-border-hang-quoc-te,174053711,"Protective Shockproof Case Cover for Apple TV 4th Remote Controller",100000,100000,0,0
TIKI,cross-border-hang-quoc-te,165215929,"Áo Vest Balo Đựng Nước, Điện Thoại Chạy Bộ, Đạp Xe Siêu Nhẹ Thoáng Khí, Nhiều Ngăn Nhỏ Tiện Dụng Inoxto Dung Tích 12L - Trắng",549000,549000,0,0
TIKI,cross-border-hang-quoc-te,130305995,"LED Gyroscopic Powerball Autostart Range Gyro Power Wrist Ball With Counter Arm Hand Muscle Force Trainer Fitness Equipment",428500,428500,0,0
TIKI,cross-border-hang-quoc-te,108784363,"Đồng hồ đeo tay TEVISE Nam Thương hiệu Sang trọng Không thấm nước-Màu Vàng đen",537000,537000,0,0
TIKI,cross-border-hang-quoc-te,108601935,"Túi sau Xe đạp 3 trong 1 đa chức năng Không thấm nước gắn yên xe",980000,980000,0,0
TIKI,cross-border-hang-quoc-te,272925686,"Wallpaper  Professional DIY Supplies Cutting Tool Compact Utility",231000,231000,0,0
TIKI,cross-border-hang-quoc-te,71050514,"Lưới thép không gỉ Hấp thụ từ tính Dây đeo tay thay thế cho FB Charge 3 / Charge 4",368000,368000,0,0
TIKI,cross-border-hang-quoc-te,95717077,"Túi Đeo Chéo Dệt Kim Phối Khoá Kéo Phong Cách Retro",241800,241800,0,0
TIKI,cross-border-hang-quoc-te,250524150,"Tai nghe nhét tai mới khuyến mại phù hợp với tai nghe kẹp tai chống ồn amb bông tai tai nghe bluetooth không dây dẫn truyền qua xương",375800,375800,0,0
TIKI,cross-border-hang-quoc-te,170654324,"Sách - Little Kids First Big Book of The World by Elizabeth Carney (US edition, hardcover)",636000,636000,0,0
TIKI,cross-border-hang-quoc-te,104520506,"Iron Wire Coffee Pod Holder Rack Tower for Nespresso Pods Coffee Bar 40 Pods",330000,330000,0,0
TIKI,cross-border-hang-quoc-te,116465184,"Boho Sofa Lumbar Pillow Cover, Woven Tufted Decorative Pillow Covers Geometric Pillowcase for Couch Bedroom Living Room Car",177000,177000,0,0
TIKI,cross-border-hang-quoc-te,170722326,"Sách - What to Expect When You're Expecting by unknown,Heidi Murkoff (US edition, paperback)",839000,839000,0,0
TIKI,cross-border-hang-quoc-te,113486419,"PBT Keycaps, Thermal Dye Sublimation PBT Keycaps Set OEM Profile 108 Keycap Set for MX for Switches Mechanical Gaming Keyboard",246000,246000,0,0
TIKI,cross-border-hang-quoc-te,170721330,"Sách - What Got You Here Won't Get You There : How Successful People Be by Dr Marshall Goldsmith (US edition, paperback)",397000,397000,0,0
TIKI,cross-border-hang-quoc-te,147169491,"Thiết Bị Khuếch Đại Âm Thanh Cho Đàn Guitar / Violin / Mandolin / Ukulele",244500,244500,0,0
TIKI,cross-border-hang-quoc-te,17970189,"Letters From A Stoic (New Cover)",356000,356000,0,0
TIKI,cross-border-hang-quoc-te,184412812,"Quick Release Plate Clamp for Camera Tripod with 2x Spirit Level Plate Mount Adapter",361000,361000,0,0
TIKI,cross-border-hang-quoc-te,177496878,"D110 Label Maker Machine with 1 Roll Printer Paper Portable Bluetooth Thermal Printer for Home Office",834000,834000,0,0
TIKI,cross-border-hang-quoc-te,170625575,"Sách - Meditations : A New Translation by Marcus Aurelius (US edition, paperback)",361000,361000,0,0
TIKI,cross-border-hang-quoc-te,52837911,"Áo Khoác Nam Unisex áo Khoác Dài Tay áo Sơ Mi Nhà Bếp đồng Phục Bảo Hộ Lao động",239000,239000,0,0
TIKI,the-thao-da-ngoai,46607075,"Lưỡi lăng xê - Bộ 4 lưỡi - Ảnh thật sản phẩm LC02",89000,89000,0,0
TIKI,the-thao-da-ngoai,196578753,"Thảm Tập Yoga TPE 2 Lớp 6mm, Thảm Mềm Mại, Thấm Hút Mồ Hôi, Chống Trơn Trượt",78000,78000,0,0
TIKI,the-thao-da-ngoai,114011202,"Đai Lưng Mềm Lục Giác Hỗ trợ tập Gym Bản To 19.5cm",232650,255000,22350,9
TIKI,the-thao-da-ngoai,135462907,"Kìm Gỡ Cá Đa Năng Kẹp Cá Gỡ Cá Cao Cấp PK12",29000,29000,0,0
TIKI,the-thao-da-ngoai,10650902,"Khung Bóng Rổ + Lưới",163000,329000,166000,50
TIKI,the-thao-da-ngoai,106503398,"Lều cắm trại, lều du lich dã ngoại, câu cá 2- 5 người, dễ dàng gập mở, đóng gói nhỏ gọn, thuận tiện",449000,449000,0,0
TIKI,cross-border-hang-quoc-te,108600088,"Áo khoác phản quang cho nam đi xe đạp và các hoạt động thể thao ngoài trời",430000,430000,0,0
TIKI,the-thao-da-ngoai,160449809,"Kính bơi bé trai Zoggs Superman Character - 382437",495000,555000,60000,11
TIKI,cross-border-hang-quoc-te,194807248,"Canxi Nước cho bé Naturade Liquid Calcium Magnesium & Vitamin D3 474ml (01/2024) (Chai)",331000,331000,0,0
TIKI,thoi-trang-nam,132814989,"Quần Đi Biển Nam 2 lớp Sobie Black",331500,390000,58500,15
TIKI,the-thao-da-ngoai,54059328,"Thảm tập GOLF tại nhà tặng hộp 06 bóng tập chuyên dụng",150000,250000,100000,40
TIKI,the-thao-da-ngoai,107615359,"22 mét Dây Dù Dã Ngoại Loại To và Dầy",80000,80000,0,0
TIKI,thoi-trang-nam,75955335,"Áo Khoác Hoodie Heavy Màu Vàng [ TẶNG 1 NÓN HEAVY ] Chất Nỉ Mềm Mịn Kiểu Dáng Trẻ Trung Dành Cho Cả Nam Và Nữ Đủ Size Team Heavy",159000,159000,0,0
TIKI,cross-border-hang-quoc-te,175886322,"Sách - I Used to Have a Plan : But Life Had Other Ideas by Alessandra Olanow (US edition, hardcover)",576000,576000,0,0
TIKI,thoi-trang-nam,178554426,"Áo sơ mi màu hồng pastel hiệu Amazing, dáng trẻ slim fit, phong cách Hàn Quốc, vải bamboo mềm mịn",185000,269000,84000,31
TIKI,the-thao-da-ngoai,84446604,"20 mét Dây Dù Dã Ngoại Loại To và Dầy",65000,65000,0,0
TIKI,cross-border-hang-quoc-te,51202213,"4Pcs/Set PU Leather Sports Golf Club Headcover Wood Putter Driver Head Cover",219000,219000,0,0
TIKI,thoi-trang-nam,138557111,"Bộ PIJAMA CAO CẤP chất liệu cotton SIÊU MỀM MỊN, Full size L-3XL, trơn màu phù hợp mọi lứa tuổi",540000,540000,0,0
TIKI,cross-border-hang-quoc-te,191268792,"Viên uống Kirkland Signature CoQ10 300 mg, 100 viên",633000,633000,0,0
TIKI,thoi-trang-nam,19550754,"Áo sơ mi nam trơn, tay dài - Trắng - XXL",90000,90000,0,0
TIKI,the-thao-da-ngoai,164943026,"Tấm Chắn Gió Dã Ngoại 8 Tấm Naturehike NH15F008-B Hợp Kim Nhôm Gấp Gọn ",215000,215000,0,0
TIKI,the-thao-da-ngoai,9263020,"Combo xà đơn treo tường DNS  (KT 60-110cm) + Kìm bóp tay điều chỉnh lực",189000,350000,161000,46
TIKI,cross-border-hang-quoc-te,170600668,"Sách - The Rise and Fall of the Great Powers by Paul Kennedy (UK edition, paperback)",704000,704000,0,0
TIKI,cross-border-hang-quoc-te,112016134,"Quần dành cho nam đi xe đạp 4D có đệm-Màu đen-Size",444100,444100,0,0
TIKI,cross-border-hang-quoc-te,95729051,"1 Cặp đệm tai nghe audio-technica ath-m50x",262500,262500,0,0
TIKI,cross-border-hang-quoc-te,174400347,"Sách - Divided : Why We're Living in an Age of Walls by Tim Marshall (UK edition, paperback)",398000,398000,0,0
TIKI,cross-border-hang-quoc-te,126022275,"Sách - Discourses and Selected Writings by Epictetus - (UK Edition, paperback)",386000,386000,0,0
TIKI,the-thao-da-ngoai,8338009,"Dây tập thể lực BLACK Yellow, thang dây thể thao tập bóng cao cấp - DONGDONG",75000,75000,0,0
TIKI,cross-border-hang-quoc-te,184951515,"Bộ 10 Dụng Cụ Pha Chế Cocktail",463000,463000,0,0
TIKI,thoi-trang-nam,34327056,"Quần short đũi nam phối màu phong cách Hàn Quốc sq502",90000,90000,0,0
TIKI,thoi-trang-nam,20991311,"Áo sơ mi trơn tay ngắn",300000,300000,0,0
TIKI,the-thao-da-ngoai,37298571,"Đèn đội đầu Q5",50831,94000,43169,46
TIKI,thoi-trang-nam,195622075,"Quần nỉ Jogger thể thao nam hàng Quảng Châu cao cấp - Quần nỉ nam nót lông cừu siêu ấm - Hàng chính hãng D Danido",189000,300000,111000,37
TIKI,cross-border-hang-quoc-te,115286437,"Cốc có quay bằng đồng đựng cocktail, nước trái cây, trà đá, bia và các loại đồ uống khác cho gia đình quán bar, nhà hàng",319000,319000,0,0
TIKI,the-thao-da-ngoai,52325239,"Băng Trán Làng Lá NARUTO combo 2 màu đen và xanh ",100000,100000,0,0
TIKI,cross-border-hang-quoc-te,184995159,"30 Tone Glockenspiel Xylophone Percussion Gift with Carrying Bag Mallets",716000,716000,0,0
TIKI,thoi-trang-nam,193132125,"Áo Hoodie Nỉ Nam Nữ Trơn From Rộng Unisex Chất Nỉ Cotton Bao Dày Không Đổ Lông",88000,88000,0,0
TIKI,thoi-trang-nam,82940840,"Hộp 3 quần lót 5D nam cao cấp 3A-Quần lót nam boxer kháng khuẩn cao cấp",149000,149000,0,0
TIKI,cross-border-hang-quoc-te,7917818,"Multipliers",440000,440000,0,0
TIKI,the-thao-da-ngoai,17891598,"Bóng tập yoga trơn 75cm",124740,237600,112860,48
TIKI,cross-border-hang-quoc-te,175886807,"Sách - Why Has Nobody Told Me This Before? by Dr Julie Smith (US edition, hardcover)",819000,819000,0,0
TIKI,thoi-trang-nam,173718599,"Quần jean nam co giãn dáng suông đẹp màu xanh đậm mẫu mới jean nam co gian",240000,240000,0,0
TIKI,thoi-trang-nam,152348255,"Quần short Nam sọc caro vải kate - A102",149000,149000,0,0
TIKI,thoi-trang-nam,196033255,"Áo sơ mi nam form rộng tay dài kiểu trẻ trung hàn quốc chất lụa mềm mịn mát ít nhăn- MRD04",105000,210000,105000,50
TIKI,the-thao-da-ngoai,59164406,"Combo 20 Viên Khăn Giấy Nén Viên Du Lịch Cao Cấp",28875,55000,26125,48
TIKI,thoi-trang-nam,155269199,"Áo thun nam Novelty dài tay cổ tròn 4 màu lựa chọn",189000,269000,80000,30
TIKI,the-thao-da-ngoai,197900282,"Còi trọng tài",25000,25000,0,0
TIKI,thoi-trang-nam,47312339,"Bộ 4 quần lót nam Munafie hàng dệt kim cao cấp (Có túi zip) - Quần sịp tam giác- WS17",66000,66000,0,0
TIKI,thoi-trang-nam,171939108,"Quần jogger nam nữ thể thao 3 sọc form ống rộng để suông hoặc rút dây bo gấu vải mịn mềm mát",120000,120000,0,0
TIKI,the-thao-da-ngoai,68604999,"Thực phẩm bổ sung Creatine không mùi Rule 1 Creatine Unflavored 150 servings - 750g tặng Rule 1 Shaker",1453500,1530000,76500,5
TIKI,the-thao-da-ngoai,192880480,"KHÓA AN TOÀN CHO MÁY CHẠY BỘ ",50000,50000,0,0
TIKI,the-thao-da-ngoai,176435316,"Túi lưới đựng bóng chuyên nghiệp sợi dù đan (giao màu ngẫu nhiên)",70000,77000,7000,9
TIKI,the-thao-da-ngoai,138810337,"Bột chống mồ hôi tay VS, victor, taan",120000,120000,0,0
TIKI,thoi-trang-nam,91927413,"Áo Thun Chibi Hero Team Mini World",59000,59000,0,0
TIKI,thoi-trang-nam,6963665,"Set 3 quần sịp đùi trunks Voga",219000,219000,0,0
TIKI,thoi-trang-nam,20678306,"Quần short thun nam vải da cá nhập Phúc An 1065 có size lớn  (oversize)",79000,79000,0,0
TIKI,the-thao-da-ngoai,9415395,"Thảm định tuyến PU 5mm (kèm túi đựng ) Cao Cấp",438000,699000,261000,37
TIKI,the-thao-da-ngoai,154930022,"[Chính Hãng] Máy Câu Cá Deukio AC, Máy AC, Máy Câu Cao Cấp",114269,114269,0,0
TIKI,thoi-trang-nam,76705826,"Sơ mi dài tay trung niên hàng loại 1 cao cấp vải mịn siêu mát sơ mi nam trung niên somi trắng",112000,112000,0,0
TIKI,cross-border-hang-quoc-te,112016001,"Bàn đạp xe đạp bằng hợp kim nhôm siêu nhẹ thiết kế bản to có đinh chống trượt",197000,197000,0,0
TIKI,thoi-trang-nam,203930542,"You steal my heart, mã G126. Áo thun polo Goking, form unisex cho nam nữ, đội nhóm, công ty. Áo phông cổ bẻ đồng phục cao cấp, vải cá sấu 3D",178000,178000,0,0
TIKI,thoi-trang-nam,194205679,"Quần tây short nam 0 ply màu rêu Regular fit NQSMMDMT3R2201180",356000,375000,19000,5
TIKI,the-thao-da-ngoai,53472886,"Bộ Trò Chơi Phóng Phi Tiêu Bảng Từ Nam Châm Thiết Kế Cuộn Tròn Thông Minh 15 Inch 2 Mặt Tặng Kèm 6 Phi Tiêu_NC15 Cao Cấp",143000,143000,0,0
TIKI,cross-border-hang-quoc-te,169018565,"Sách - If We Were Villains by M. L. Rio (UK edition, paperback)",411000,411000,0,0
TIKI,the-thao-da-ngoai,112108843,"Đầu cơ Tpro 11.5mm - 12mm - 13mm",220000,220000,0,0
TIKI,the-thao-da-ngoai,53840753,"Dụng Cụ Tăng Cơ Tay Hiệu Quả Gậy Bẻ Cơ Tay Lò Xo Lực 40kg PT40",74000,79000,5000,6
TIKI,thoi-trang-nam,19550746,"Áo sơ mi nam trơn, tay dài - Trắng - S",90000,90000,0,0
TIKI,thoi-trang-nam,113235477,"Quần đùi nam kate, quần đùi mặc nhà nam cotton Fezzio chính hãng big size",119000,238000,119000,50
TIKI,thoi-trang-nam,117583592,"(XẢ KHO DIỆP TẾT) ÁO KHOÁC DÙ DẦY MỚI PHONG CÁCH CAO CẤP",155000,155000,0,0
TIKI,thoi-trang-nam,98623160,"Quần Jean Nam Đẹp ️️ Quần Bò Nam Mẫu Mới Chất Liệu Denim Cao Cấp Thời Trang Chuẩn Hàng Shop Tô Tồ Shop - QJN44",135000,135000,0,0
TIKI,thoi-trang-nam,191127039,"Áo Khoác Dù Unisex Chống Nắng Phối Hoa Văn Nam Nữ RẺ ĐẸPÁo Khoác Gió Mùa Đông Cặp Đôi Couple Cực Ngầu Jacktes",94000,94000,0,0
TIKI,cross-border-hang-quoc-te,95728714,"Cặp đệm tai thay thế cho tai nghe BOSE QuietComfort qc35",262500,262500,0,0
TIKI,cross-border-hang-quoc-te,17968980,"The Elements Of Style Illustrated",552000,552000,0,0
TIKI,the-thao-da-ngoai,16178414,"Thảm tập Yoga định tuyến PU cao cấp",438000,699000,261000,37
TIKI,the-thao-da-ngoai,69511948,"Dây Nhảy Thể Dục Dài 2,9m  Có Thể Điều Chỉnh Được Độ Dài Của Dây Hàng Đủ Màu Siêu Bền Đẹp",38000,49000,11000,22
TIKI,cross-border-hang-quoc-te,135229882,"Hoạt Hình Túi Xách Thời Trang Mới Hello Kitty Túi Nữ Da Đeo Chéo Túi Đeo Vai Cinnamoroll Dây Kéo Túi Đựng Điện Thoại - one",458197,458197,0,0
TIKI,cross-border-hang-quoc-te,129220702,"Sách - The Song of Achilles by Madeline Miller - (UK Edition, hardcover)",772000,772000,0,0
TIKI,thoi-trang-nam,71926285,"BỘ QUẦN ÁO THỂ THAO BỘ ĐỒ NAM NỮ SIZE M L CHẤT THUN LẠNH",103000,103000,0,0
TIKI,cross-border-hang-quoc-te,188976683,"CAMEL CROWN Đèn Cắm Trại Ngoài Trời Đèn Lồng LED Sạc Trực Tiếp USB Cầm Tay Cắm Trại Chống Nước",1761000,1761000,0,0
TIKI,the-thao-da-ngoai,148560053,"SALE KỊCH SÀN Bao đựng cần câu cá tùy chọn size từ 75cm tới 165cm",62173,62173,0,0
TIKI,cross-border-hang-quoc-te,170661823,"Sách - The 7 Habits of Highly Effective People : 30th Anniversary Card Deck by Stephen R. Covey (US edition, paperback)",606000,606000,0,0
TIKI,the-thao-da-ngoai,162548486,"Băng Cổ Tay Thấm Mồ Hôi  - Vải Mềm Mịn , Thấm Hút Mồ Hôi Cực Tốt",45000,45000,0,0
TIKI,thoi-trang-nam,97099486,"Áo sơ mi trơn tay dài Amazing, form slimfit Hàn Quốc, màu sắc đa dạng, trẻ trung, vải bamboo mềm mượt, thoáng mát",185000,269000,84000,31
TIKI,thoi-trang-nam,51563792,"Combo 3 Chiếc Quần Lót Nam Tam Giác Thời Trang Kwin KBF037, Mềm Mại, Kháng Khuẩn, Khử Mùi - Hàng Chính Hãng",155000,195000,40000,21
TIKI,cross-border-hang-quoc-te,46334728,"Tay Cầm Bằng Gỗ Dương Cầm Chỉnh Cờ Lê Grand Piano Sửa Chữa Bảo Trì Dụng Cụ",747000,747000,0,0
TIKI,thoi-trang-nam,179575398,"Áo thun Polo nam Novelty 210060 màu xanh da trời",274550,289000,14450,5
TIKI,the-thao-da-ngoai,190081577,"Mũ bơi cho bé POPO 1179 phù hợp trẻ em trên 3 tuổi hình ngộ nghĩnh chất liệu an toàn",88500,88500,0,0
TIKI,cross-border-hang-quoc-te,51200738,"Dây Cáp Sạc USB 5Pin Cho Máy Ảnh Kỹ Thuật Số Canon",123000,123000,0,0
TIKI,thoi-trang-nam,155564740,"Quần bò dài nam trung niên dáng thụng có đến size 36+ẢNH THẬT",523500,523500,0,0
TIKI,the-thao-da-ngoai,101642318,"Đèn cắm trại ngoài trời Desert&Fox G-85 Rechargeable camping lantern",224000,369000,145000,39
TIKI,cross-border-hang-quoc-te,175851291,"Keyboard case with integrated pen holder, detachable, wireless Bluetooth",231000,231000,0,0
TIKI,the-thao-da-ngoai,170148515,"Combo 10 Gói Pre-Workout Abe Hỗ Trợ Tăng Sức Mạnh Tăng Năng Lượng Trong Quá Trình Tăng Cơ Giảm Mỡ",250000,250000,0,0
TIKI,cross-border-hang-quoc-te,59222616,"Solid CornHole Toss Game Set and 8 Pieces Cornhole Bean Bag Pouch Toss Toy for Family Parties Kindergarten",764000,764000,0,0
TIKI,thoi-trang-nam,28544814,"Áo Thun Nam Cotton Xanh Rêu",54000,54000,0,0
TIKI,cross-border-hang-quoc-te,11466602,"First Thousand Words In Chinese",281000,281000,0,0
TIKI,the-thao-da-ngoai,16510019,"Nẹp Định Vị Một Tay Giúp Luyện Chơi Golf PGM - JZQ006",225000,225000,0,0
TIKI,cross-border-hang-quoc-te,170726435,"Sách - Six of Crows : Book 1 by Leigh Bardugo (UK edition, paperback)",443000,443000,0,0
TIKI,thoi-trang-nam,144227349,"Quần jean baggy nam MĐ Q902 form rộng, trẻ trung phong cách",179000,179000,0,0
TIKI,cross-border-hang-quoc-te,178060756,"Sách - Layla by Colleen Hoover (US edition, paperback)",488000,488000,0,0
TIKI,thoi-trang-nam,111710197,"Áo Sơ Mi Nam Ngắn Tay Mẫu TNFS Thời Trang Cao Cấp PONIVA Phong Cách Hàn Quốc Trẻ Trung, Lịch Lãm",125000,125000,0,0
TIKI,thoi-trang-nam,98186464,"Hộp 3 Quần sịp Đùi Nam Sợi Nano Kháng Khuẩn Thoáng Mát Thấm Hút Mồ Hôi 3A",45900,45900,0,0
TIKI,thoi-trang-nam,168856937,"Viettien - Áo sơ mi nam dài tay họa tiết 1N2012 regular",580000,580000,0,0
TIKI,the-thao-da-ngoai,2371655,"Nón bơi, mũ bơi BL - XANH mềm mại CHỐNG thấm nước, chất liệu PU co giãn cao cấp - POKI",49000,49000,0,0
TIKI,the-thao-da-ngoai,176504497,"Mồi Câu Cá Tra Pioner Mekong Catfish Gói 200g Dùng Câu Sông Tự Nhiên Hồ Dịch Vụ",25000,25000,0,0
TIKI,cross-border-hang-quoc-te,95367701,"Thẻ nhớ USB 3.0 dung lượng 2TB",325000,325000,0,0
TIKI,the-thao-da-ngoai,14903415,"Phao Tay Tập Bơi An Toàn Nhỏ Gọn 22x19.5cm",39000,39000,0,0
TIKI,thoi-trang-nam,79721593,"Áo khoác sơ mi nam nữ có nón",104000,104000,0,0
TIKI,thoi-trang-nam,66370023,"Áo Khoác Dù Nam Cho Mưa LẠnh",134000,134000,0,0
TIKI,thoi-trang-nam,186080721,"Áo Gile Nam Màu Đen 8 Nút Form Ôm Body",250000,500000,250000,50
TIKI,the-thao-da-ngoai,139664764,"Bó Gối Thể Thao Một Dây - Đai Bảo Vệ Khớp Gối - AOLIKES AL7912",100000,100000,0,0
TIKI,the-thao-da-ngoai,186932334,"Bình Nước Camelbak Podium Chill 21OZ (620ml)",299000,299000,0,0
TIKI,thoi-trang-nam,125831790,"Quần Jogger nam jean co giãn JN351",250000,250000,0,0
TIKI,thoi-trang-nam,50614559,"Combo 4 Sịp Đúc Nam Lụa Sữa Cao Cấp Vải Siêu Mát thiết kế U Lồi phía trước mặc Thoải Mái Dễ Chịu - Nhiều Size Nhiều Màu để lưa chọn",319000,319000,0,0
TIKI,thoi-trang-nam,156199686,"Combo 4 quần lót nam Briefs Mr Mitas Basics viền êm ái",159000,299000,140000,47
TIKI,thoi-trang-nam,181785318,"Áo bay dài tay màu cỏ úa - vàng cốm, áo lao động, áo tập QS loại đẹp",130000,130000,0,0
TIKI,thoi-trang-nam,273187200,"Miếng Dán, Băng Keo Dán Lai Quần Ống Quần, Sửa Quần Áo, Cắt Ngắn Không Cần May Legaxi",11000,11000,0,0
TIKI,thoi-trang-nam,112646706,"ÁO KHOÁC NỈ HOODIES NAM NỮ PHONG CÁCH SIÊU ĐẸP , HỌA TIẾT CỰC MỚI , DÀNH CHO CÁC BẠN TRẺ THỜI TRANG 1HITSTORE1",95000,95000,0,0
TIKI,thoi-trang-nam,105275706,"Áo Thun Nam Polo Có Cổ Tay Ngắn Trơn Cao Cấp ZERO 5 Màu Hàn Quốc",189000,300000,111000,37
TIKI,thoi-trang-nam,77239444,"Áo Ba Lỗ Nam Thoáng Mát ABL01",29000,29000,0,0
TIKI,thoi-trang-nam,54446837,"Quần dài nam thể thao GOKING, lưng thun và dây rút co giãn thoải mái. Hàng hiệu cao cấp xuất khẩu",225000,225000,0,0
TIKI,thoi-trang-nam,67294572,"Áo Sơ Mi Nam Dài Tay Vải Lụa Chống Nhăn",109000,109000,0,0
TIKI,thoi-trang-nam,97823540,"Áo Khoác Big Size Áo Khoác Dù Nam Có Cổ Trụ Chống Nắng Chống Nóng Chống Lạnh Chống Gió 2 Lớp Phối Logo Sọt Thời Trang Nam Tính Hàn Quốc Giá Tốt AD70",169000,169000,0,0
TIKI,thoi-trang-nam,176599627,"Áo polo nam ngắn tay có cổ Vicenzo regular fit chuẩn hàng xuất, áo phông thun polo nam tay ngắn",75000,75000,0,0
TIKI,thoi-trang-nam,85305836,"Áo ba lỗ nam trơn đủ màu chất cotton co dãn mềm mịn mát mẻ",98000,98000,0,0
TIKI,thoi-trang-nam,30031323,"Quần Tây Nam Không Ply Ống Ôm xám đậm Khatoco Q1M528S0-CNMA006-2007-0",199000,528000,329000,62
TIKI,thoi-trang-nam,138748093,"Áo thun nam cổ tim ngắn tay đẹp nhiều màu đủ size ( có size lớn cho người 100 kg )",74260,79000,4740,6
TIKI,thoi-trang-nam,21242706,"Áo Sơ Mi Trắng Nam Họa Tiết Bên Vai Phải",95000,95000,0,0
TIKI,thoi-trang-nam,169120359,"Combo 5 quần sịp nam, kiểu dáng ôm mông chất thun cotton thấm hút co giãn tốt - FORMEN SHOP - FM5QS005",139000,245000,106000,43
TIKI,thoi-trang-nam,37580438,"Quần Jogger Kaki Nam Phong Cách Trẻ Trung Năng Động Thời Trang VICERO",144000,250000,106000,42
TIKI,thoi-trang-nam,85086740,"Áo sơ mi nam màu trắng ngắn tay vải chống nhăn",108000,108000,0,0
TIKI,thoi-trang-nam,144171958,"Quần đùi ngủ  nam chất kate cotton mặc mát",52000,56000,4000,7
TIKI,thoi-trang-nam,176599682,"Quần kaki Nam Cao Cấp, Quần jogger kaki nam Chuẩn Hàng Xuất - QJKN01",97000,97000,0,0
TIKI,thoi-trang-nam,35193606,"[FREEMAN] Combo 5 quần lót nam 6034",156000,195000,39000,20
TIKI,thoi-trang-nam,68918584," Áo thun phối tay Cali",79000,125000,46000,37
TIKI,thoi-trang-nam,161455980,"Áo Thun Nam PoLo Phối Màu Kẻ Chéo Cao Cấp Thời Trang ZERO",189000,360000,171000,48
TIKI,thoi-trang-nam,141259191,"Quần jogger unisex thể thao, quần ống rộng kiểu dáng jogger mặc nhà nam nữ vải TỔ ONG 3 màu năng động",80000,80000,0,0
TIKI,thoi-trang-nam,128276418,"Quần jogger kaki nam nữ chất đẹp, co giãn",90000,90000,0,0
TIKI,thoi-trang-nam,115125727,"áo lót nam_áo ba lỗ nam ledatex chất cotton thấm hút mồ hôi",24000,24000,0,0
TIKI,thoi-trang-nam,150685095,"Áo Thun Nam Cổ Tròn TSIMPLE phông trơn tay ngắn vải Cotton cao cấp chống nhăn chuẩn form MSSATTCX",149000,215000,66000,31
TIKI,thoi-trang-nam,161413668,"Bộ Quần Áo Thể Thao Nam Thời Trang Thiết Kế Cao Cấp Kiểu Dáng ZERO",219000,430000,211000,49
TIKI,thoi-trang-nam,164085080,"Áo Thể Thao Nam TSIMPLE cổ tròn tay ngắn tập gym vải thun lạnh thoáng mát co giãn chuẩn form AHRBC002",99000,149000,50000,34
TIKI,thoi-trang-nam,23296068,"Quần Lót BOXER Nam",199000,199000,0,0
TIKI,thoi-trang-nam,32389756,"QUẦN SHORT KAKI NAM CO GIÃN CAO CẤP LƯNG THUN BT02",39000,39000,0,0
TIKI,thoi-trang-nam,162212127,"Quần lót nam quyến rũ sexy gợi cảm",45000,45000,0,0
TIKI,thoi-trang-nam,110730140,"Áo thun nam có cổ tay ngắn vải Thun Cotton Mềm mịn co giãn thoáng mát",74000,78000,4000,5
TIKI,thoi-trang-nam,14847948,"Áo thun nam thoát nhiệt Nhật Bản GOKING siêu thoáng mát, áo phông nam cao cấp thấm hút mồ hôi, mặc như không mặc",159000,159000,0,0
TIKI,thoi-trang-nam,151922857,"Áo khoác Cardigan Unisex Nam Nữ Thêu gấu - Chất Nỉ Bông Ngoại Mềm Mịn Bomber Cardigan, áo cardigan phối viền, áo cardigan phối 2 túi đẹp, áo khoác cardigan chống nắng, mặc ấm màu thu đông dễ phối đồ",95000,95000,0,0
TIKI,thoi-trang-nam,111477677,"Áo Sơ Mi Nam Ngắn Tay Kiểu Dáng Cơ Trưởng U886 Thời Trang Hàn Quốc Chất Cotton Pha Lụa Mềm Mại, Thoáng Mát, Chống Nhăn, Trẻ Trung, Năng Động- HÀNG CHÍNH HÃNG",219000,498000,279000,56
TIKI,thoi-trang-nam,20534277,"Áo Sơ Mi Nam Tay Ngắn Khatoco A1MN378S1-CNCR009-2101-N-M - Hồng Phối Xá",302400,378000,75600,20
TIKI,thoi-trang-nam,104064189,"Quần Jean Nam Co Giãn Phong Cách Thời Trang Hàn Quốc Cao Cấp T&L store ms46",128000,128000,0,0
TIKI,thoi-trang-nam,132097555,"Áo Đồng Phục Đầu Bếp Màu Đen Tay Ngắn",97000,97000,0,0
TIKI,the-thao-da-ngoai,46248186,"Bóng gai  cao su bóp tập tay phục hồi chức năng sau tai biến",4000,13379,9379,70
TIKI,the-thao-da-ngoai,26287806,"Dây nhảy thể dục Sportslink 2.7m (Màu ngẫu nhiên)",44000,142000,98000,69
TIKI,the-thao-da-ngoai,139915099,"Đầu bu chống xoắn dùng cho cần câu máy đủ kích cỡ",10000,10000,0,0
TIKI,the-thao-da-ngoai,40798649,"BÓNG TẬP YOGA GAI MÀU XANH DƯƠNG VNS017 (Tặng kèm bơm bóng và khóa van)",285000,380000,95000,25
TIKI,the-thao-da-ngoai,124942479,"Băng Chặn mồ hôi trán , Thể Thao sành điệu co dãn chống trượt TT17",35000,35000,0,0
TIKI,the-thao-da-ngoai,154961350,"Lưới đánh cá săn cá mương loại lưới chìm",329550,329550,0,0
TIKI,the-thao-da-ngoai,149605597,"Hộp đựng phụ kiện câu cá, mồi giả , hộp đựng mồi câu lure giá rẻ tiện lợi",16600,16600,0,0
TIKI,the-thao-da-ngoai,157117939,"Dây Trục câu đài buộc sẵn cước câu cá 3260 , tảng hình cao cấp , cước trục fluorocacboncao chống mài mòn cực cao ( đồ câu a lâm )",14998,14998,0,0
TIKI,the-thao-da-ngoai,146924756,"Quần Dài Jogger Nữ Thể Thao Chất Vải Thun Lạnh Co Dãn Mềm Mịn",204250,215000,10750,5
TIKI,the-thao-da-ngoai,42043190,"Dây thừng kéo co Thiên Trường tầm trung 7,6kg đến 8kg",810000,810000,0,0
TIKI,the-thao-da-ngoai,16257273,"Bật lửa Zippo  Clover High Polish Chrome Design 24699",1025000,1025000,0,0
TIKI,the-thao-da-ngoai,196597277,"Băng dán cơ thể thao Kinesiology Tape AOLIKES A-MT002",134000,199000,65000,33
TIKI,the-thao-da-ngoai,163851339,"Phao Câu Ngày Đêm Săn Hàng Fuwang",104600,104600,0,0
TIKI,the-thao-da-ngoai,104935216,"Tạ gang đen 5kg",260000,260000,0,0
TIKI,the-thao-da-ngoai,68909224,"Quần Nam thể thao kiểu dáng Hàn Quốc - Q0010",185000,185000,0,0
TIKI,the-thao-da-ngoai,54898667,"Áo bóng rổ Los Angeles Lakers - Mùa giải mới nhất - Bộ quần áo bóng rổ thi đấu",136000,259000,123000,47
TIKI,the-thao-da-ngoai,96521842," Khung trợ lực khớp gối cao cấp giúp bảo vệ đầu gối luôn chắc khỏe",175000,175000,0,0
TIKI,the-thao-da-ngoai,34316790,"Đôi đai bó đầu gối co dãn thể thao - Đen cam",68000,73500,5500,7
TIKI,the-thao-da-ngoai,154934362,"Phao Câu Đài Ngày Đêm SHADOWLESS, phao câu đêm Phao câu cá PC-14",27600,27600,0,0
TIKI,the-thao-da-ngoai,35148054,"Bộ Kính Bơi Cận View V510 (Đen) Và Nút Bơi Nhét Tai EP405 - Hàng Chính Hãng",495000,725000,230000,32
TIKI,the-thao-da-ngoai,146904732,"Bạt Phủ Đất Chống Cỏ Mọc, Chống Sói Mòn Đất 500*100CM",55000,55000,0,0
TIKI,the-thao-da-ngoai,70161865,"Bộ 6 dây kháng lực tập Gym ,dây đàn hồi Miniband đa năng tập Mông Đùi Chân, độ kháng lực cao Mã 02-RED",97000,180000,83000,46
TIKI,the-thao-da-ngoai,26664936,"Cán cờ đi tour 2,5m chuyên dành cho hướng dẫn viên du lịch công ty lữ hành",120000,120000,0,0
TIKI,the-thao-da-ngoai,1694261,"Băng Bảo Vệ Đầu Gối Khi Chơi Thể Thao Sportslink Litian Loại Dài - Màu Lính",70000,99000,29000,29
TIKI,the-thao-da-ngoai,90321741,"Băng đô Kpop, Bigbang, băng đô thể thao chặn mồ hôi siêu co giãn TB37",11570,11570,0,0
TIKI,the-thao-da-ngoai,139939138,"cần câu tay GW VÂN LONG 6h bạo lực - chuyên săn hàng",208550,208550,0,0
TIKI,the-thao-da-ngoai,57352382,"Băng vải đeo cổ tay thấm mồ hôi thể thao (giao ngẫu nhiên)",19000,19000,0,0
TIKI,the-thao-da-ngoai,183064756,"Bóng đá Futsal AKpro AF3800",387030,399000,11970,3
TIKI,the-thao-da-ngoai,191529358,"Kính Bơi Có Thể Điều Chỉnh Ucle Bills – Swimming Goggles (Màu sắc Ngẫu Nhiên)",66000,66000,0,0
TIKI,the-thao-da-ngoai,140767517,"Khung nắn chỉnh kéo dãn cột sống cổ điện chuẩn từ chuyên thoái hóa đốt sống cổ, mỏi cổ do cúi nhiều-tuehanshoop-A11",225000,225000,0,0
TIKI,the-thao-da-ngoai,423988,"Bộ Chì Chân 1.6kg (Giao Màu Ngẫu Nhiên)",170000,170000,0,0
TIKI,the-thao-da-ngoai,197669061,"Chai Xịt Găng Tay Thủ Môn Bóng Đá - Hỗ Trợ Mặt Mút Bám Dính , Bám Chắc Banh",220000,220000,0,0
TIKI,the-thao-da-ngoai,138701914,"Giỏ Đựng Cá Rọng đựng cá",86450,86450,0,0
TIKI,the-thao-da-ngoai,180035841,"Áo Ba Lỗ Tanktop Thể Thao Nam - LocalBrand X9 - Tập Gym Chạy Bộ Yoga - X002",380000,380000,0,0
TIKI,the-thao-da-ngoai,190093414,"Quấn cán tennis, cầu lông Bộ 5 cái có gân chống trơn POPO chất liệu thoáng khí thoát mồ hôi",133500,133500,0,0
TIKI,the-thao-da-ngoai,195864929,"PUMA - Áo bra thể thao nữ ULTRAFORM Cropped Running 522150",1199000,1199000,0,0
TIKI,the-thao-da-ngoai,6565249,"Giày đá bóng Prowin RX + tặng kèm tất bóng đá cao cổ",218000,218000,0,0
TIKI,the-thao-da-ngoai,167025862,"Khóa Link Nhật - Bộ 10 mani nhật - Khóa Linh Chống Xoăn cao cấp - Phụ kiện câu cá",13300,13300,0,0
TIKI,the-thao-da-ngoai,149631058,"Bộ vợt câu cá inox siêu bền dài 1.7m-3m",148600,148600,0,0
TIKI,thoi-trang-nam,191055924,"Áo thun polo thời trang nam phong cách trẻ trung, lịch lãm - FORMEN SHOP - FMPS191",189000,250000,61000,24
TIKI,the-thao-da-ngoai,26304327,"Túi Ngủ Văn Phòng, Du Lịch Thông Minh Gấp Gọn Tiện Lợi",124900,124900,0,0
TIKI,thoi-trang-nam,19553990,"Combo 5 Quần Sịp Nam Xuất Nhật Thông Hơi Co Giãn 4 Chiều Thoáng Mát Chất Sịn",85000,85000,0,0
TIKI,thoi-trang-nam,138207299,"Quần tây nam dáng ôm Hàn Quốc vải chống nhăn co giãn nhẹ",114000,114000,0,0
TIKI,thoi-trang-nam,138749879,"Áo phông nam cổ tròn chất cotton thun lạnh mềm, mịn , dáng body thời trang",109980,117000,7020,6
TIKI,thoi-trang-nam,46694203,"QUẦN TÂY NAM CO GIÃN CAO CẤP DN20010510 - đen - 31",85000,85000,0,0
TIKI,thoi-trang-nam,72308045,"Quần kaki nam chất kaki co giãn 4 chiều, ống côn thời trang, dáng ôm body trẻ trung, không bai xù, giặt được máy giặt",119000,119000,0,0
TIKI,thoi-trang-nam,137668107,"Áo Bomber Jacket/ Áo Khoác Dù 2 Lớp Style Bóng Chày in Bmoody Unisex Nam Nữ Couple Hot Trend",107000,107000,0,0
TIKI,thoi-trang-nam,181990263,"Quần jeans dài Vistino",165000,165000,0,0
TIKI,thoi-trang-nam,251563600,"I DO WHAT I WANT, mã G239. Áo thun in đẹp cho nam nữ, cặp đôi, gia đình. Áo phông Goking hàng hiệu cao cấp",69000,69000,0,0
TIKI,thoi-trang-nam,165219220,"Quần Jean Nam Co Giãn Ống Đứng Dáng Đẹp Màu Xanh Đậm",180000,180000,0,0
TIKI,thoi-trang-nam,93212275,"Áo Khoác Kaki Jean Wash Nam Nữ Unisex Có Cổ Bẻ Chống Lạnh Chống Nắng Chống Gió Chống Tia Uv Dày 2 Lớp Thời Trang Hàn Quốc Cao Cấp KK52 - ShopN6",199000,245000,46000,19
TIKI,thoi-trang-nam,21532933,"Áo Khoác Da Lót Lông Nam AN92",298000,298000,0,0
TIKI,thoi-trang-nam,71942265,"Bộ quần áo thể thao nam nữ in DINK",90000,90000,0,0
TIKI,thoi-trang-nam,132084938,"Áo Bếp Tay Dài Đồng Phục Đầu Bếp Màu Trắng Đen",126000,126000,0,0
TIKI,thoi-trang-nam,115093722,"Quần boxer nam cotton mịn mỏng thoáng khí co giãn tốt cao cấp, quần lót nam, sịp cotton trẻ trung K117",59000,59000,0,0
TIKI,thoi-trang-nam,167429610,"Bộ Pijama nam kẻ caro chất liệu cotton cao cấp dày mịn, thoáng mát, size L-3XL",660000,660000,0,0
TIKI,thoi-trang-nam,117090822,"Set Bộ Mặc nhà Gấu Cặp Đôi Nam Nữ HOT RẺ ĐẸP Quần Đùi Phối Áo Thun Form Rộng Tay Lỡ -Đồ Bộ Thun Hoạt Hinh siêu Cute",91000,91000,0,0
TIKI,thoi-trang-nam,100369140," Quần đùi ngắn nam Fasvin R21448.HN vải gió chun mềm mại co giãn thoải mái vận động",129000,159000,30000,19
TIKI,thoi-trang-nam,14997358,"Quần Bò Nam Trắng Trơn Chất Co Giãn JEANTRANG98 (Jean Trắng)",125000,125000,0,0
TIKI,thoi-trang-nam,195302427,"Áo thun ba lỗ NAM HOẠ TIẾT HOẠT HÌNH CỰC ĐẸP 2021 MẪU MỚI NHẤT HIỆN NAY",73000,73000,0,0
TIKI,thoi-trang-nam,86310871," Quần lót nam boxer sịp đùi nam dạng lưới thông hơi cao cấp",114000,114000,0,0
TIKI,thoi-trang-nam,99483979,"Quần jean nam xước cao cấp vải jean co dãn hàng chuẩn shop Phuongnamshop20 kvp13",199000,199000,0,0
TIKI,thoi-trang-nam,22760805,"Áo thun nam cổ bẻ vải cá sấu,combo 3 áo - EZ306",397000,397000,0,0
TIKI,thoi-trang-nam,133916548,"Quần short jean co giãn cho nam, màu trắng và đen, phong cách Hàn Quốc trẻ trung, năng động",145000,145000,0,0
TIKI,thoi-trang-nam,16546849,"Combo 5 Quần Lót Nam Tam Giác Nhật",108000,108000,0,0
TIKI,thoi-trang-nam,192217886,"VẢI COTTON 100% ÁO THUN NAM TAY DÀI CỔ TRÒN VÀ CỔ TIM MÀU ĐEN TRẮNG THỜI TRANG",66740,90000,23260,26
TIKI,thoi-trang-nam,98623465,"Quần Jean Nam Đẹp️️ Quần Bò Nam Mẫu Mới Chất Liệu Denim Cao Cấp Thời Trang Chuẩn Hàng Shop Tô Tồ Shop - QJN65",199000,199000,0,0
TIKI,thoi-trang-nam,166081740,"Combo 6 quần sip đùi kháng khuẩn AAA chất coton cao cấp co giãn 4 chiều",89000,99000,10000,10
TIKI,thoi-trang-nam,46640497,"QUẦN JOGGER NỈ NAM 1 SỌC JG02",75000,75000,0,0
TIKI,thoi-trang-nam,128125119,"Quần short, đùi chất linner nam thương hiệu Fezzio chính hãng",69500,139000,69500,50
TIKI,thoi-trang-nam,79876518,"Quần Lót Nam Dạng Lưới Mềm Mại Thoáng Mát - Thiết Kế 2 Màu Kết Hợp Ấn Tượng - Co Dãn 4 Chiều Cao Cấp Brave Person B1139",130000,289000,159000,55
TIKI,thoi-trang-nam,148848665,"Đồ bộ thun thể thao nam",249000,249000,0,0
TIKI,thoi-trang-nam,144381066,"Quần Lửng Nam Dáng Alibaba Thụng Chất Liệu Thô Đũi",360000,360000,0,0
TIKI,thoi-trang-nam,183491271,"Quần Jean nam hàng cao cấp kiểu rách bụi ống ôm vừa co giãn",294000,294000,0,0
TIKI,thoi-trang-nam,180990072,"ÁO SƠ MI TAY NGẮN MÀU XANH ĐEN BIG SIZE NAM TỚI 130KG",185000,185000,0,0
TIKI,thoi-trang-nam,100369201," Quần short Big Size thể thao nam Fasvin D20267.HN chất liệu cao cấp mềm mịn, co giãn tốt",169000,209000,40000,19
TIKI,thoi-trang-nam,197172576,"Áo hoodie nỉ bông WISH NOW unisex nam nữ (Ảnh thật/Có sẵn)",108000,108000,0,0
TIKI,thoi-trang-nam,183916651,"Áo Khoác Nỉ Bomber Cardigan Form Rộng Nam Nữ Logo Kiểu Dáng Bóng Chày Thời Trang",120000,120000,0,0
TIKI,thoi-trang-nam,172284477,"ALWAYS COOL, mã G106. Áo thun nam nữ in siêu đẹp. Áo phông thoát nhiệt GOKING hàng hiệu cao cấp",168000,168000,0,0
TIKI,thoi-trang-nam,55045485,"Áo sơ mi nam cổ sơ mi dài tay chất vải thô đũi, thời trang trẻ, phong cách lịch lãm",159000,159000,0,0
TIKI,thoi-trang-nam,119286524,"Áo sơ mi nam trắng Amazing, vạt bầu, đồng phục học sinh, công sở, form suông Regular, chất liệu KT silk mềm mượt, size từ 45-105kg",175000,259000,84000,32
TIKI,thoi-trang-nam,72462368,"Áo Khoác Nam Áo Khoác Dù Dày Nam Hai Lớp Lót Nỉ Chống Lạnh Chống Gió Chống Nắng Tia UV Cao Cấp AD64 - ShopN6 (Nhiều Màu)",149000,225000,76000,34
TIKI,thoi-trang-nam,191820527,"Áo Polo Nam Trẻ Trung 7 Màu Hiện Đại Thời Trang Nam AVIANO",189000,360000,171000,48
TIKI,thoi-trang-nam,97823018,"Áo khoác dù Happiness Ulzzang chất dù cao cấp 2 lớp , Form Rộng Unisex size M  L  XL  Nam Nữ Couple Đều Mặc Được - Áo khoác gió nam nữ mặc",97000,97000,0,0
TIKI,thoi-trang-nam,147205396,"Áo Y Tá, Dược Sĩ, Điều Dưỡng Trắng (Ngắn Tay) Nam Nữ -VT0175",98000,98000,0,0
TIKI,thoi-trang-nam,110751076,"Quần jean nam đen ống đứng dáng slim Fit- vải jeans bò co giãn 4 chiều cao cấp",199000,199000,0,0
TIKI,thoi-trang-nam,55135761,"Áo Sơ Mi Nam Nữ Dài Tay Thiêu Họa Tiết Cực Xinh Thời Trang Cao Cấp (Gía 1 Aó)",95000,95000,0,0
TIKI,thoi-trang-nam,83767993,"Áo thun đen nam form rộng FAST AND FURIOUS ( Quá nhanh quá nguy hiểm )",83000,83000,0,0
TIKI,thoi-trang-nam,44802421,"Áo hoodie nam trơn ST02",79000,79000,0,0
TIKI,thoi-trang-nam,93969398,"Áo sơ mi nam tay ngắn-V46-014531-PK1",3090000,3090000,0,0
TIKI,thoi-trang-nam,98690795,"ÁO CHỐNG NẮNG NAM THÔNG HƠI",105000,105000,0,0
TIKI,thoi-trang-nam,21789530,"Áo thun cổ lọ nam dài tay TAS13",118000,118000,0,0
TIKI,thoi-trang-nam,145763153,"Combo 5 quần lót Nam Thái Lan (Thun Lạnh co giãn 4 chiều)",200000,200000,0,0
TIKI,thoi-trang-nam,17635350,"Quần Jean Rách Nam QB9873",320000,320000,0,0
TIKI,thoi-trang-nam,186547206,"Áo bomber nam nữ unisex khoác gió jacket dù 2 lớp cúc bấm form rộng local brand ulzzang phong cách hàn quốc đep PENTA.Q",96000,96000,0,0
TIKI,thoi-trang-nam,133815093,"ÁO PHÔNG áo thun nam trung niên cộc tay cổ bẻ có túi góc",189000,189000,0,0
TIKI,thoi-trang-nam,54018254,"Set 5 Quần Lót Đùi, Tam Giác Munafie Cho Nam Cao Cấp Kèm Túi Zip",74000,74000,0,0
TIKI,thoi-trang-nam,67905114,"Quần Âu nam Xám Ngà(CAM KẾT ĐẸP) Quần Tây nam Xám Ngà dáng hàn quốc, vải không xù nhăn",93000,93000,0,0
TIKI,thoi-trang-nam,196537029,"Áo thun Teeworld Classic - Saigonese T-shirt Tay Lỡ Nam Nữ Form Rộng Unisex",219000,219000,0,0
TIKI,thoi-trang-nam,22158405,"Áo sơ mi trắng dài tay vải kate",430000,430000,0,0
TIKI,thoi-trang-nam,45242530,"áo thun nam đơn giản",99000,99000,0,0
TIKI,thoi-trang-nam,21512112,"Quần sịp đùi nam Voga vải thun Rayon tự nhiên thoáng mát, hút ẩm",99000,99000,0,0
TIKI,thoi-trang-nam,31265339,"Quần short jean nam ống suông Q415 MuiDoi",132000,132000,0,0
TIKI,thoi-trang-nam,90414622,"Áo Phông Agatsuma Zenitsu",79000,79000,0,0
TIKI,thoi-trang-nam,15362990,"Quần Short Nam Winfa TỪ 50-95KG 4 Màu",109000,109000,0,0
TIKI,thoi-trang-nam,178584562,"Áo Khoác Dù Nam Nữ Cao Cấp SWEED Kiểu Cổ Bẻ Phối Zip Kéo Dáng Rộng Phong Cách Cá Tính Độc Lạ Hot Trend",102000,102000,0,0
TIKI,thoi-trang-nam,12232466,"Quần Jean Nam Đen Dáng Body JEAN02",135000,135000,0,0
TIKI,thoi-trang-nam,173832691,"Áo khoác bóng chày phong cách vintage đường phố thời trang 2022 cho nam, Áo Jacket, Áo Khoác Dày Dặn Sành Điệu M Nam, Áo Cardigan Chữ M Thêu Unisex, Áo khoác nỉ Cardigan M nỉ ngoại mềm mịn, áo khoác thời trang nam nữ",99000,99000,0,0
TIKI,thoi-trang-nam,163544556,"Áo Sơ Mi Nam Thương Hiệu Anton Dài Tay Công Sở Trung Niên Vải Cotton Họa Tiết Kẻ Caro Màu Xanh - 8566",265000,355000,90000,25
TIKI,thoi-trang-nam,126814544,"Quần âu nam kẻ caro Công sở chất cotton xịn chống nhăn, chống nóng, chống bám bụi MADE IN VIETNAM",139000,139000,0,0
TIKI,thoi-trang-nam,33108259,"Quần lót nam kiểu boxer Voga vải cao cấp Modal thoáng mát",129000,129000,0,0
TIKI,thoi-trang-nam,127352139,"Áo Khoác Nỉ Nam Nữ Form Rộng Siêu Hot Chất Nỉ Dày Dặn Siêu Đẹp Áo Khoác Jackets Thun Unisex POWR",96000,96000,0,0
TIKI,thoi-trang-nam,195801442,"Áo sơ mi nam màu hồng ADINO vải nến lụa sợi sồi modal dáng công sở slimfit hơi ôm trẻ trung S06",279000,400000,121000,30
TIKI,thoi-trang-nam,15363095,"Quần Short Nam Winfa Từ 50-95kg 5 Màu",109000,109000,0,0
TIKI,thoi-trang-nam,93961252,"Áo sơ mi tay dài-V18-014565-BL2",3190000,3190000,0,0
TIKI,thoi-trang-nam,178585332,"Áo Khoác Hoodie 2 Nón In Gấu SATUDR Kiểu Khóa Zip Kéo Phối 2 Nón Giữ Nhiệt Che Nắng Đa Năng Phong Cách Thời Trang Cá Tín",102000,102000,0,0
TIKI,thoi-trang-nam,74547453,"Áo One Piece Luffy ATT-07, Áo thun Anime Manga One Piece Monkey D. Luffy Unisex Nam Nữ",16000,16000,0,0
TIKI,thoi-trang-nam,156652130,"Quần kaky danh cho be trai va gai điều được",100000,100000,0,0
TIKI,thoi-trang-nam,179161819,"(big size <130kg) Short jean đen không rách big size nam",270000,270000,0,0
TIKI,thoi-trang-nam,181785465,"Áo sơ mi trắng lễ phục",150000,150000,0,0
TIKI,the-thao-da-ngoai,73871478,"Túi tập gym XBAGS XB 6003 cho nam và nữ Túi đựng đồ thể thao cao cấp (Có ngăn đựng giày riêng)",259000,299000,40000,13
TIKI,the-thao-da-ngoai,53084624,"Giày đi biển lội nước chống trơn trượt, gọn nhẹ, sử dụng nhiều lần, phù hợp đi du lich, leo núi, thân thiện với môi trường, chịu nước tốt và nhanh khô, nhiều màu lựa chọn  SA051-BLF",259000,259000,0,0
TIKI,the-thao-da-ngoai,173166793,"Băng Đeo Cổ Tay Thấm Mồ Hôi Cho Hoạt Động Thể Thao",10000,10000,0,0
TIKI,the-thao-da-ngoai,148177023,"[LOẠI TỐT - ĐỊNH TUYẾN] Thảm tập Yoga định tuyến TPE cao cấp tặng kèm túi đựng - chống trơn trượt thấm hút mồ hôi tốt chính hãng DODODIOS - Dây Buộc Chuyên Dụng Tập Yoga",169000,169000,0,0
TIKI,the-thao-da-ngoai,2852275,"Combo Vớ tập yoga + Bao tay chống trượt Sportslink",114000,126000,12000,10
TIKI,the-thao-da-ngoai,25974467,"Băng Keo Thể Thao, Bóng Đá Chuyên Dụng",9000,29000,20000,69
TIKI,the-thao-da-ngoai,144170683,"10 TÚI LỤA DÂY RÚT NÂU TÚI DU LỊCH CHỐNG THẤM NƯỚC",19000,19000,0,0
TIKI,the-thao-da-ngoai,52377020,"Đai Bảo Vệ Khủy Tay Tập GYM, Chơi Thể Thao Elbow Support Có Lò  Xo Chịu Lực Aolikes 7946 (1 Chiếc)",115000,115000,0,0
TIKI,the-thao-da-ngoai,197185177,"Combo 3 sảm phẩm tập Yoga hiệu quả tại nhà : 1 Vòng tập Yoga có gai masage 34x34x20cm chuyên dụng + 2 Gạch tập Yoga in hoa văn 240gr",522000,539000,17000,3
TIKI,the-thao-da-ngoai,144870906,"GẬY BẺ TẬP CƠ TAY LỰC 30 (tặng dây nhảy thể dục)",205000,205000,0,0
TIKI,the-thao-da-ngoai,169313718,"Băng thun bó ống quần phản quang du lịch, phượt, dã ngoại",10000,10000,0,0
TIKI,the-thao-da-ngoai,273180663,"Sữa tăng cơ BPI Iso HD 100% Pure Isolate Protein 2.2kg tặng bình Shaker 800ml",1325000,1390000,65000,5
TIKI,the-thao-da-ngoai,131029527,"Đai cố định cổ tay bonbone wrist bandage",193600,220000,26400,12
TIKI,the-thao-da-ngoai,188382359,"Áo hoodie cotton mùa hè. áo thể thao có mũ trùm đầu mỏng cộc tay hợp thời trang có khóa N1",199000,199000,0,0
TIKI,the-thao-da-ngoai,109979735,"[ Set 10 cái ] Phíp Cơ Bida Sừng 11.5mm, 12mm, 13mm",110000,110000,0,0
TIKI,the-thao-da-ngoai,53284223,"Lưới Cầu Lông - Giao Màu Ngẫu Nhiên",80000,80000,0,0
TIKI,the-thao-da-ngoai,197086149,"Thảm tập Yoga TPE 2 lớp 8mm thảm dầy dặn đàn hồi cao bám dính tốt dễ dàng vệ sinh không mùi chống trơn trượt cao su tự nhiên ",128000,128000,0,0
TIKI,the-thao-da-ngoai,424001,"Găng Tạ 0606 (Freesize)",100000,100000,0,0
TIKI,the-thao-da-ngoai,183579598,"Nẹp định vị cổ tay giúp tập chơi Golf – PGM JZQ010",320000,320000,0,0
TIKI,the-thao-da-ngoai,141653851,"10 Tee Golf Gỗ Và Nhựa- Trụ Bóng Golf",38000,38000,0,0
TIKI,the-thao-da-ngoai,106791443,"Áo thun nam cổ tròn tay ngắn, chất thun lạnh mềm mát, thấm hút mồ hôi, thoải mái vận động – FORMEN SHOP – FMTY001",149000,149000,0,0
TIKI,the-thao-da-ngoai,154952309,"Bộ cần câu cá lure máy đứng 1.68m - 1.8m - 2.1m - 2.4m + Máy kim loại + dây câu lure + hộp mồi lure B-lu-D01",134000,134000,0,0
TIKI,the-thao-da-ngoai,132364112,"HẠ LÓNG CẦN TAY ĐA NĂNG",49000,49000,0,0
TIKI,the-thao-da-ngoai,135464016,"Túi Đựng Cần Câu Cá Rằn Ri 2-3 Ngăn Chống Thấm Nước Siêu Bền TDC5",114998,114998,0,0
TIKI,the-thao-da-ngoai,197189064,"[ Dùng thử 14 ngày ] Thảm tập Yoga TPE 2 lớp 8mm dễ dàng vệ sinh bề mặt êm ái dầy dặn độ đàn hồi tốt không mùi có bám dính chống trơn trượt tính ổn định cao chất liệu cao su tự nhiên rất an toàn ",99000,99000,0,0
TIKI,the-thao-da-ngoai,271959823,"Máy tập gym đa năng - Ghế tập cơ bụng tại nhà",1399000,1399000,0,0
TIKI,the-thao-da-ngoai,167422301,"Vỏ bao đấm boxing dây dù không ruột 6 tấc đến 1m2",109000,109000,0,0
TIKI,the-thao-da-ngoai,144870937,"VÒNG TẬP YOGA CAO CẤP(TẶNG KÈM SÁCH HƯỚNG DẪN TẬP)",259000,259000,0,0
TIKI,the-thao-da-ngoai,170775516,"Găng Tay Lò Nướng Chịu Nhiệt Chống Nóng Dụng Cụ Nhà Bếp 1 Đôi - GANGTAY",24500,24500,0,0
TIKI,the-thao-da-ngoai,63918266,"Thảm Tập Golf Tại Nhà - 2 trong 1 Thế Hệ Mới 2020",149000,149000,0,0
TIKI,thoi-trang-nam,190360964,"Album 8 - Bst áo thun unisex form rộng 3 con gấu dễ thương thời trang vải dày mịn",39900,39900,0,0
TIKI,the-thao-da-ngoai,90868843,"Bàn bóng bàn Đức Long 3418 kèm cọc lưới",3600000,3600000,0,0
TIKI,the-thao-da-ngoai,155763668,"Mặt bàn bóng bàn mới ( 1 đôi ) dùng thay mặt bàn cũ",2400000,2400000,0,0
TIKI,the-thao-da-ngoai,149609725,"Chuông Báo Cá Điện Tử Yolo Báo Động Cá Cắn Câu",63262,63262,0,0
TIKI,the-thao-da-ngoai,187785883,"Dây Nhảy Có Tay Cầm Xốp Tiện Lợi ( Giao màu ngẫu nhiên)",65000,65000,0,0
TIKI,the-thao-da-ngoai,107615969,"Khăn trùm Mặt Nạ Ninja Chuyên Phượt",15000,15000,0,0
TIKI,the-thao-da-ngoai,269983720,"Ống Thở Bơi Lặn Biển Ngắm San Hô Đáy Biển Dã Ngoại Picnic",63000,63000,0,0
TIKI,thoi-trang-nam,5757757,"Bộ 4 Quần Boxer Đúc Cao Cấp Nhật Bản Cho Nam",120000,120000,0,0
TIKI,thoi-trang-nam,138751080,"️️ Áo phông nam màu xanh tím than vải cotton mềm mịn dáng body thời trang",74260,79000,4740,6
TIKI,thoi-trang-nam,66709381,"Quần sịp boxer kháng khuẩn Hàn Quốc",25000,25000,0,0
TIKI,the-thao-da-ngoai,10412016,"Bộ 2 Đai Quấn Đầu Gối Thể Thao AOLIKES YE-7912",298000,559000,261000,47
TIKI,thoi-trang-nam,98624906,"Quần Bò Nam Mẫu Mới Chất Liệu Denim Cao Cấp Thời Trang Chuẩn Hàng Shop Tô Tồ Shop - QJN75",199000,199000,0,0
TIKI,the-thao-da-ngoai,107072858,"Cần câu lure ul ultralight siêu dẻo máy ngang 3 mẫu lựa chọn độ dài 1m68 và 1m8",140000,140000,0,0
TIKI,thoi-trang-nam,26146703,"Áo Sơ Mi Nam Dài Tay AD19 - Trắng - XXL",78000,78000,0,0
TIKI,thoi-trang-nam,19340532,"Áo sơ mi nam màu trắng kẻ sọc đen (MS5778358)",136000,136000,0,0
TIKI,thoi-trang-nam,186826593,"Áo Polo nam Novelty Regular fit NATMINMCLR210085N",379000,399000,20000,5
TIKI,thoi-trang-nam,57083703,"Combo 10 Quần Sịp Nam Tam Giác Thông Hơi Xuất Nhật Cao Cấp",145000,145000,0,0
TIKI,thoi-trang-nam,162029329,"QUẦN JEAN NAM WASH NHẸ PHONG CÁCH SANG TRỌNG",224000,224000,0,0
TIKI,thoi-trang-nam,147443767,"Áo Sơ Mi Nam Ngắn Tay Phối Họa Tiết DG448",134000,134000,0,0
TIKI,thoi-trang-nam,128280872,"Áo Rock: áo phông My Chemical Romance ROX SP066",245000,245000,0,0
TIKI,thoi-trang-nam,88197823,"Áo cộc tay và áo 3 lỗ nam",50000,50000,0,0
TIKI,thoi-trang-nam,179161649,"Quần kaki dài nam big size tới 130kg",310000,310000,0,0
TIKI,thoi-trang-nam,15519104,"Áo len nam loại dày BS35 - BS35",250000,250000,0,0
TIKI,thoi-trang-nam,95313870,"Quần short khaki nam 0Ply Novelty trơn màu NSKMMNMCSR2101240",253000,339000,86000,25
TIKI,thoi-trang-nam,72911700,"Áo Phông Hero Team Phong Cận Tv",109000,109000,0,0
TIKI,thoi-trang-nam,6720079,"Quần jean Nam đen",145000,145000,0,0
TIKI,thoi-trang-nam,196470991,"Quần short kaki nam BLOOK chất vải kaki phom lửng ngang gối 30081",389000,389000,0,0
TIKI,thoi-trang-nam,14945619,"Quần Bò Nam Trắng Rách Gối TRANGRACH02",199000,199000,0,0
TIKI,thoi-trang-nam,2374655,"Quần sịp đùi trunks Voga",149000,149000,0,0
TIKI,thoi-trang-nam,111711378,"Áo Sơ Mi Nam Ngắn Tay Đính Nút Mẫu ZF01 Thời Trang Cao Cấp PONIVA Phong Cách Hàn Quốc Trẻ Trung, Cá Tính",105000,105000,0,0
TIKI,thoi-trang-nam,73675246,"Quần Short Nam Lưng Thun Co Dãn, Chất Kaki In Hình Họa Tiết Thời Trang Cao Cấp NamMinh",109000,109000,0,0
TIKI,thoi-trang-nam,111587907,"Áo sơ mi đũi nam tay lỡ, chất liệu vải đũi mềm mát, thích hợp mùa hè, thời trang trẻ, phong cách Hàn Quốc",189000,189000,0,0
TIKI,thoi-trang-nam,85086882,"Áo sơ mi nam dài tay màu vàng nhạt",159000,159000,0,0
TIKI,thoi-trang-nam,76087213,"Áo khoác dù nam nữ mặc / áo khoác gió nam nữ mặc / áo khoác dù kiểu bomber / áo khoác cặp đôi / áo khoác form rộng",128000,128000,0,0
TIKI,thoi-trang-nam,147446186,"Áo Sơ Mi Nam Dài Tay Phối Họa Tiết Mèo YH211 Thời Trang TOP FASHION SHOP Cao Cấp",110000,110000,0,0
TIKI,the-thao-da-ngoai,144904410,"Bộ Cần 2 Khúc Đặc, Máy Câu CL6000 Và Bộ Phụ Kiện Giá Rẻ",66996,66996,0,0
TIKI,thoi-trang-nam,158893978,"JAPAN, mã G55. Áo thun nam nữ siêu đẹp. Áo phông thoát nhiệt Goking hàng hiệu",168000,168000,0,0
TIKI,thoi-trang-nam,94774234,"Quần jogger túi hộp chất kaki mịn, đẹp, cực ngầu",95000,95000,0,0
TIKI,thoi-trang-nam,179162795,"(Big size <130kg) Áo sơ mi nam big size màu đỏ",185000,185000,0,0
TIKI,thoi-trang-nam,190359213,"Áo phông nam nữ họa tiết khủng long dễ thương form rộng vải dày mịn 2020T2877",53000,53000,0,0
TIKI,thoi-trang-nam,98622716,"Quần Tây Âu Mẫu Mới ️️ Quần  Âu Nam Cao Cấp Thời Trang Hàn Quốc Co Giãn Nhẹ Chuẩn Hàng Shop Tô Tồ Shop - QTA2",115000,115000,0,0
TIKI,thoi-trang-nam,196314768,"Áo Polo nam cổ bẻ phối sọc BLOOK vải cá sấu Cotton CVC cao cấp co giãn đa chiều thấm hút nhanh bền màu slimfit 35620",429000,429000,0,0
TIKI,thoi-trang-nam,34159128,"Áo Sơ Mi Nam Sọc Đen",120000,120000,0,0
TIKI,thoi-trang-nam,31267238,"Quần short jean Q417 MuiDoi",132000,132000,0,0
TIKI,thoi-trang-nam,184236673,"Áo sơ mi trắng tay dài, đồng phục học sinh nam, chất vải KT Silk mềm mại, size từ 20-95kg",97000,154000,57000,37
TIKI,thoi-trang-nam,148680020,"ÁO KHOÁC NỈ BOMBER CẬU BÉ JACKET CÚC BẤM HỒNG ĐEN IN VIỀN SỌC, áo khoác nỉ bomber đen chạy viền trắng unisex, Áo Khoác Cadigan Nam Nữ Form Rộng Thêu Chữ Ngực phối viền Phong Cách Mới",99000,99000,0,0
TIKI,thoi-trang-nam,207268845,"Áo Đoàn Thanh Niên Việt Nam Cộc tay hàng loại 1 - Có sẵn",135000,135000,0,0
TIKI,thoi-trang-nam,194198359,"Quần tây short nam 0 ply Caro lớn Regular fit NQSMCLMT3R2201250",356000,375000,19000,5
TIKI,thoi-trang-nam,25045069,"Combo 5 chiếc Quần lót Boxer nam SQB200 - 1",147000,147000,0,0
TIKI,thoi-trang-nam,126689876,"quần thể thao nam, quần 3 sọc ống suông, chất liệu thoáng mát",79000,79000,0,0
TIKI,thoi-trang-nam,106886116,"OWEN - Áo sơ mi dài tay Owen REGULAR FIT 20862 chất sợi tre",568000,568000,0,0
TIKI,thoi-trang-nam,43131073,"Áo sơ mi cọc tay với thiết kế hai mặt vải đặc biệt",178900,178900,0,0
TIKI,thoi-trang-nam,77329940,"Sơ mi nam họa tiết sói và đại bàng thời trang",175000,175000,0,0
TIKI,thoi-trang-nam,71881757,"Áo sơ mi nam dài tay vải mát chống nhăn body LOẠI ĐẸP VNXK kiểu dáng Hàn Quốc",77000,77000,0,0
TIKI,thoi-trang-nam,192193672,"Quần short đùi nam cao cấp TC với chất cotton co dãn tốt, kết hợp họa tiết logo chữ in nổi, độc đáo được may chắc chắn, phong cách trẻ trung, lịch lãm, hợp thời trang-21293",350000,350000,0,0
TIKI,thoi-trang-nam,140308361,"Quần baggy nam nữ unisex vải kaki TRƠN ống suông tây đen công sở đi học lưng cao ulzzang hàn quốc dây rút đẹp",89000,89000,0,0
TIKI,thoi-trang-nam,25196817,"Quần đũi nam sọc ngang phong cách SQ502",129000,129000,0,0
TIKI,thoi-trang-nam,45657448,"Áo Khoác Nam Trung Niên 2 Lớp Cổ Bẻ Chất Vải Dày Và Ấm Cao Cấp",450000,450000,0,0
TIKI,thoi-trang-nam,197745833,"Áo thun nam cổ trụ thời trang phong cách Hàn Quốc BLOOK 35617",489000,489000,0,0
TIKI,thoi-trang-nam,22369258,"Set 3 quần sịp đùi nam Voga Hàng Ngày vải thun 100% cotton thoáng mát, hút mồ hôi",249000,249000,0,0
TIKI,thoi-trang-nam,94776001,"Áo sơ mi caro unisex chất dày dặn cực đẹp, y ảnh",93000,93000,0,0
TIKI,thoi-trang-nam,20303730,"Combo 4 Quần Sịp Tam Giác Thông Hơi Nam Cao Cấp Nhật Bản (Giao Nhiều Mầu)",90000,90000,0,0
TIKI,thoi-trang-nam,104112050,"(SIÊU HOT) Áo Thun LUFFY MŨ RƠM Siêu Cute - Áo Phông One Piece LUFFY Hải Tặc Đẹp OP144",57000,57000,0,0
TIKI,thoi-trang-nam,156199083,"Combo 5 quần lót nam Brief Mr Mitas Basics viền êm ái",229000,359000,130000,36
TIKI,thoi-trang-nam,105622376,"Áo sơ mi nam kẻ sọc BBR vàng",128000,128000,0,0
TIKI,thoi-trang-nam,134833377,"Quần Lót Nam nhiều lưng vải thun lạnh co giãn 4 chiều hiệu CITYMEN màu ngẫu nhiên, đồ lót - LMTK-MULTIAL",16000,16000,0,0
TIKI,thoi-trang-nam,48059879,"Quần Jean Nam Đen Xước Thời Trang DENXUOC99 (Đen Xước)",134000,134000,0,0
TIKI,thoi-trang-nam,132137295,"Quần đi biển gia đình màu cam kiểu short ngắn thun da cá dày dặn có thể mặc cặp đôi nam nữ hội nhóm SGQC DONGPHUCSG",70000,70000,0,0
TIKI,thoi-trang-nam,15054852,"Áo Sơ Mi Nam Dài Tay SMH91 - SMH91",180000,180000,0,0
TIKI,thoi-trang-nam,78967228,"Đồ bộ thể thao nam vải thun tuyết mưa mềm mịn, Thời Trang Phong Cách Hàn aloha style (Freesize từ 45-70kg) -Bộ UZUMAKI-Nhiều kiểu lựa chọn",95000,95000,0,0
TIKI,thoi-trang-nam,184794779,"JEAN DÀI MÀU XANH BẠC CHÂN BIG SIZE NAM TỚI 130KG",370000,370000,0,0
TIKI,thoi-trang-nam,76369205,"Áo thun nam Novelty cổ tròn 190166",104000,169000,65000,38
TIKI,thoi-trang-nam,205993470,"SAMURAI, mã G78. Áo thun nam nữ in siêu đẹp. Áo phông thoát nhiệt GOKING hàng hiệu cao cấp",69000,69000,0,0
TIKI,thoi-trang-nam,20909077,"Quần Jean Nam BYQ153",129000,129000,0,0
TIKI,thoi-trang-nam,43724000,"Quần jean họa tiết thêu nổi hình con vật đặc biệt",263100,263100,0,0
TIKI,thoi-trang-nam,57750597,"Quần Bơi Nam Thể Thao - Đi Biển Siêu Đẹp kèm nón bơi",99000,99000,0,0
TIKI,thoi-trang-nam,193229397,"Quần Lót Vận Động Nam Siêu Mỏng Nhẹ Thoáng Khí Aonijie E7004 Dáng Trunk Combo 3 Cái Màu Hỗn Hợp",660000,660000,0,0
TIKI,thoi-trang-nam,156655278,"Áo thun cổ bẻ thêu ngực, áo polo trắng full size vải cá sấu form chuẩn-Thesize95-TSSTORE95",150000,150000,0,0
TIKI,thoi-trang-nam,47493022,"Áo thun Nam họa tiết in hình khỉ độc đáo chất liệu vải Cotton cao cấp dáng ôm co giãn dễ phối đồ hợp thời trang giới trẻ - Mẫu HOT",99000,99000,0,0
TIKI,thoi-trang-nam,154103860,"Combo 3 Quần sịp xì đùi nam cao cấp quần lót nam đùi co giãn 4 chiều 5D 45-70kg alex",44999,44999,0,0
TIKI,thoi-trang-nam,117082001,"Quần kaki nam nữ túi hộp lửng cá tính, năng động,ống rộng phong cách,thời trang",95000,95000,0,0
TIKI,thoi-trang-nam,260920006,"áo sơ mi, áo sơ mi nam họa tiết thêu cực sang chảnh và độc lạ, thiết kết dáng cổ vest tinh tế và trẻ trung - N53",223155,234900,11745,5
TIKI,thoi-trang-nam,13587414,"Quần short jean nam xanh cào xước Q37",132000,132000,0,0
TIKI,thoi-trang-nam,2371949,"Áo ba lỗ Voga",149000,149000,0,0
TIKI,the-thao-da-ngoai,183333358,"Máy Chạy Bộ Gập Gọn Có Điều Khiển Từ Xa,Có Tay Vịn HC3001 Chống Rung,Chống Ồn Đại Nam Sport",4499000,7000000,2501000,36
TIKI,thoi-trang-nam,102524057,"áO Khoác Dù Bomber Nam Nữ ZZA Unisex 2 lớp đủ Size, Áo khoác dù in logo TMS bao đẹp, Áo khoác bomber dù unisex 2 lớp,Áo khoác dù TMS LOGO JACKET, áo khoác dù gió thể thao unisex ulzzang from rộng phong cách hàn quốc",101000,101000,0,0
TIKI,thoi-trang-nam,147388088,"HỘP 4 QUẦN SỊP TAM GIÁC NAM MEN’S THÔNG HƠI",70563,70563,0,0
TIKI,thoi-trang-nam,98165465,"Quần Đùi Nam Chất Vải Cotton Thoáng Mát,Quần Short Nam 5 Màu Form Dáng Cực Đẹp",70000,70000,0,0
TIKI,thoi-trang-nam,172457784,"Quần Jogger Thun  Unisex Trẻ Trung Năng Động [Đen",169000,169000,0,0
TIKI,thoi-trang-nam,73503238,"Quần shorts jeans nam ngắn phong cách",182000,182000,0,0
TIKI,the-thao-da-ngoai,163793752,"Kính bơi gọng lớn, mắt kính rộng, chống nước và sương mù khi bơi, bảo vệ mắt hiệu quả, có dây chỉnh theo vòng đầu | MK03",150000,150000,0,0
TIKI,the-thao-da-ngoai,197829587,"Posture Corrector for Women and Men - Invisible & Adjustable Upper Back Brace for Clavicle Support - Effective Straightener and Providing Pain Relief from Neck, Back, Shoulder - Đai chống gù lưng - Hàng chính hãng DoDoDios",69000,69000,0,0
TIKI,the-thao-da-ngoai,78010442,"Bộ Bảo Hộ An Toàn Cho Bé Protection Gear, bộ bảo hộ tay, chân, đầu gối, bộ bảo hộ trượt patin, trượt ván, nhựa pvc, có đệm mút",79000,79000,0,0
TIKI,the-thao-da-ngoai,131170890,"Đai cố định cổ chân Bonbone Free support AM",255000,310000,55000,18
TIKI,the-thao-da-ngoai,129675237,"Bộ Tập Chống Đẩy Đa Năng PARALLETTES - Bộ Tập Hít Đất Tập Gym Tại Nhà Tăng Cơ Ngực Tay Vai Lưng",98000,195000,97000,50
TIKI,the-thao-da-ngoai,165624848,"Đồ cắm trại tấm chắn gió bếp Naturehike campoutvn du lịch dã ngoại kín không rỉ sét xếp gấp gọn A125",210000,210000,0,0
TIKI,the-thao-da-ngoai,167402037,"Bột Tơ Nhện T5 Câu Mồi Vuốt, Mồi Vê Câu Tay Đơn Đài Cá Chép, Rô Phi",70000,70000,0,0
TIKI,the-thao-da-ngoai,26028666,"Khung nắn chỉnh cột sống, điều trị thoát vị đĩa đệm, thoái hóa, đau lưng, vai gáy (Giao màu ngẫu nhiên)",45000,56000,11000,20
TIKI,the-thao-da-ngoai,167981431,"Thẻo 2 tầng , 3 tầng buộc sẵn lưỡi- thẻo câu cá 2 tầng, 3 tầng cột sẵn lưỡi",8000,8000,0,0
TIKI,the-thao-da-ngoai,189163913,"Dây nhảy thể lực cán nhựa dẻo 0.9 mm CLEACCO Dây làm từ sợi Polyester lõi PVC cao cấp , chắc chắn , tay cầm bọc nhựa dẻo PVC cảm giác đầm tay BORO SPORT",129000,228000,99000,43
TIKI,the-thao-da-ngoai,169313290,"Giày bảo hộ lao động JB905 dáng thể thao siêu nhẹ màu vàng đen ,có mũi thép chống va đập, đế lót thép chống đâm xuyên",420000,420000,0,0
TIKI,the-thao-da-ngoai,111177032,"VÒNG TẬP YOGA CAO CẤP SUNNY - BẢNG 20cm",435000,450000,15000,3
TIKI,the-thao-da-ngoai,20505985,"Kìm Bóp Tay Luyện Cơ Tay Cao Cấp",25000,25000,0,0
TIKI,the-thao-da-ngoai,180725024,"Set Đồ Bơi Nam Dài Tay Quần Đùi",216000,270000,54000,20
TIKI,the-thao-da-ngoai,190093685,"Quấn cán Tennis POPO (Hộp 30 cái) Cầu lông, thoáng khí, thoát mồ hôi",358500,358500,0,0
TIKI,the-thao-da-ngoai,172125154,"Khăn lau bếp đa năng AnPa",22500,22500,0,0
TIKI,the-thao-da-ngoai,114011066,"Dây đàn hồi kháng lực tập mông - Dây miniband chuyên tập mông - Độ mông trái đào (Combo)",57420,65000,7580,12
TIKI,the-thao-da-ngoai,5111169,"Dụng cụ tập cổ tay cải tiến mới Sportslink",54000,120000,66000,55
TIKI,the-thao-da-ngoai,169693610,"Dụng Cụ Bắt Cá 5 Tiêu Có Ngạch - Có Cán",99000,99000,0,0
TIKI,the-thao-da-ngoai,21976154,"Giày Patin Centosy Kids Pro",1650000,1650000,0,0
TIKI,the-thao-da-ngoai,7509725,"Giày Patin Cougar 835LSG - Đỏ",899000,899000,0,0
TIKI,the-thao-da-ngoai,77772658,"Túi Đeo Tay Chạy Bộ Chống Thấm Nước, Đựng Điện Thoại 6 - 7 inch Màn Hình Cảm Ứng Cao Cấp",35000,35000,0,0
TIKI,the-thao-da-ngoai,163852099,"Trục Câu Đài Săn Hàng Dây Trục Câu Cá Chất Lượng Phụ Kiện Câu Đài Cao Cấp",87000,87000,0,0
TIKI,the-thao-da-ngoai,123221822,"Nẹp Định Vị Khuỷu Tay Chơi Golf Chính Xác Cao Cấp",207000,240000,33000,14
TIKI,the-thao-da-ngoai,21093616,"Bóng Tập đấm phản xạ tốc độ đội đầu cao cấp cao mút đúc ",65000,65000,0,0
TIKI,the-thao-da-ngoai,70832081,"Đèn Pin Đội Đầu Led Đa Năng CG-5 Chống Nước",44900,44900,0,0
TIKI,the-thao-da-ngoai,163862098,"Cần Câu Lure Dyawa Carbon Cần Câu Cá Máy Ngang Và Máy Đứng Chống Xoắn Cao Cấp",186000,186000,0,0
TIKI,the-thao-da-ngoai,154952857," Kềm Gỡ Lưỡi Câu Cá Bằng Thép Không Gỉ Chuyên Đồ Câu Lure ",36400,36400,0,0
TIKI,the-thao-da-ngoai,89950450,"Túi Đeo Ngực Thể Thao Dã Ngoại Phối Da Phong Cách Thành Long 208071",44400,75400,31000,41
TIKI,the-thao-da-ngoai,143067940,"Cước câu cá hộp sắt, cước hộp sắt tàng hình Maiteli dài 100m buộc link buộc thẻo",64000,64000,0,0
TIKI,the-thao-da-ngoai,74530829,"Áo tank top sát nách thể thao nữ tập gym, yoga nhiều màu",152000,152000,0,0
TIKI,the-thao-da-ngoai,10398970,"Băng Thun Gối ORBE H2 (Size",125000,125000,0,0
TIKI,the-thao-da-ngoai,140406945,"Lưỡi câu cá CJ Seiko Nhật Bản ( Vỉ 15 Chiếc ) Cao Cấp Chuyên Câu Đài, Câu Đơn LC-7",30000,30000,0,0
TIKI,the-thao-da-ngoai,36061857,"Giày đá bóng, giày sân cỏ nhân tạo Mitre 181045 mẫu mới chính hãng size",672000,672000,0,0
TIKI,the-thao-da-ngoai,122470484,"Một đôi đai bảo vệ đầu gối bendu PK6001 hàng chính hãng, bó gối thể thao cao cấp, bó gối tập gym, vải đàn hồi co dãn 4 chiều",105000,105000,0,0
TIKI,the-thao-da-ngoai,154942215,"Quấn Cần Câu Tay Cao Cấp, Quấn Cán Vợt Cầu Lông Dài 1.5 Mét",30900,30900,0,0
TIKI,the-thao-da-ngoai,156004335,"THÙNG ĐỰNG CÁ đa năng phụ kiện câu cá KK-9",70885,70885,0,0
TIKI,the-thao-da-ngoai,141816705," Bình nước xe đạp thể thao 500ml Cách Nhiệt Có Ống Hút",165000,165000,0,0
TIKI,the-thao-da-ngoai,5939557,"Đai bó cơ khuỷu tay khi chơi Tennis, golf, cầu lông, bóng bàn AOLIKES TC-7949",146000,219000,73000,33
TIKI,the-thao-da-ngoai,198334367,"đai chống gù lưng cho trẻ em cao cấp mi03  - Chính hãng DoDoDios",155000,155000,0,0
TIKI,the-thao-da-ngoai,144404437,"Găng Tay Aolikes A-112 | Găng Tay Tập Gym Thể Thao Nam Nữ Cao Cấp Chính Hãng",119000,119000,0,0
TIKI,the-thao-da-ngoai,34562466,"Bật Lửa ZIPPO KHẮC HỔ 05 – ZIPPO 250.HO05",790000,790000,0,0
TIKI,the-thao-da-ngoai,43836845,"Dụng cụ tập cơ tay cổ tay quay tay Benchmade lưỡi trơn an toàn cho người mới chơi",56469,56469,0,0
TIKI,the-thao-da-ngoai,139916709,"Phao Câu Đài Ngày Đêm SHADOWLESS, phao câu đêm Phao câu cá PC-14",26500,26500,0,0
TIKI,the-thao-da-ngoai,138810347,"Bóng tập cổ tay loại khởi động bằng cót, Không đèn",125000,125000,0,0
TIKI,the-thao-da-ngoai,192711106,"Phấn SPORTS CHALK làm khô tay, tập gym, street workout, calisthenics, thể dục dụng cụ, leo núi",34000,34000,0,0
TIKI,the-thao-da-ngoai,16336236,"Băng bảo vệ cổ tay PJ-633",32000,32000,0,0
TIKI,the-thao-da-ngoai,202413292,"Vợt Cầu Lông SPORTHOUSE MC3 Lực căng dây tối đa 15.4kg Màu Xanh Lam",950000,950000,0,0
TIKI,the-thao-da-ngoai,186881763,"Móc Khóa Leo Núi , Dã Ngoại , Treo Võng hợp kim nhôm có gàm khóa Chịu Lực Tốt",10000,10000,0,0
TIKI,the-thao-da-ngoai,183375288,"Túi đựng bình nước giữ nhiệt có dây đeo tiện ích - HENRYSA",29000,58000,29000,50
TIKI,the-thao-da-ngoai,163876959,"Bó gối phòng ngừa 75580-DAY Actimove Mild Knee Support",390000,450000,60000,13
TIKI,the-thao-da-ngoai,194124619,"Dây kháng lực tập gym, Power Band đa năng, hỗ trợ luyện tập thể dục, tiện lợi tại nhà, văn phòng- hàng chính hãng",65000,65000,0,0
TIKI,the-thao-da-ngoai,173443010,"Quần Đùi Tập Gym Yoga Nữ, Quần Short Thể Thao Lưng Cao Ôm Body Co Giãn Tốt",120000,120000,0,0
TIKI,the-thao-da-ngoai,173168366,"Túi dây rút du lịch chống nước tiện dụng cho hoạt động thể thao dã ngoại,leo núi ngoài trời",19000,19000,0,0
TIKI,the-thao-da-ngoai,186690063,"Bộ tập Alibaba, gym yoga aerobic nữ chất vải mềm - ALibaba 2023",249000,249000,0,0
TIKI,the-thao-da-ngoai,75603295,"Đai gen bảo vệ khớp gối, Gen bảo vệ khớp gối",185000,185000,0,0
TIKI,the-thao-da-ngoai,16555048,"Túi Đựng Gậy Tập Golf - PGM Standing Gun Bag - QIAB001",745000,745000,0,0
TIKI,the-thao-da-ngoai,2425157,"Thảm Tập Yoga Eco Friendly TPE - Tím Hồng",78000,78000,0,0
TIKI,the-thao-da-ngoai,85025758,"Quả bóng rổ cao su gerustar số 5",100000,199000,99000,50
TIKI,the-thao-da-ngoai,162523057,"Vợt Bắt Cá Cảnh Kéo Dài 110cm - Chuôi Bọc Nhựa",29600,29600,0,0
TIKI,the-thao-da-ngoai,174849218,"Đĩa Xoay Eo Tập Cơ Bụng, Dụng Cụ Tập Bụng Giảm Mỡ, Cải Thiện Tuần Hoàn Máu Amalife",33000,33000,0,0
TIKI,the-thao-da-ngoai,114885408,"DÂY NHẢY TẬP THỂ DỤC CHUYÊN NGHIỆP TỰ ĐỘNG ĐẾM SỐ VÒNG NHẢY, HỖ TRỢ LUYỆN TẬP THỂ DỤC, THỂ THAO TẠI NHÀ ( MÀU NGẪU NHIÊN) - 6131",29000,29000,0,0
TIKI,the-thao-da-ngoai,5509635,"Khăn trải thảm yoga cao cấp - Màu",107000,200000,93000,47
TIKI,the-thao-da-ngoai,12481403,"Thảm yoga định tuyến PIDO (tặng túi đựng)",643000,1250000,607000,49
TIKI,the-thao-da-ngoai,144193795,"[MUA 1 TẶNG 1] ÁO THỂ THAO NỮ VINA AUTHENTIC CAO CẤP VNT04W CHẤT LƯỢNG, MỀM MẠI, CO GIẢN, CHUẨN FORM, HỢP THỜI TRANG",179000,179000,0,0
TIKI,thoi-trang-nam,97932472,"Quần áo team đi biển_ Dừa nền trắng (ảnh thật, vải kate thái)",58000,58000,0,0
TIKI,the-thao-da-ngoai,1632469,"Bóng Rổ 3×3 Molten B33T5000",939930,969000,29070,3
TIKI,the-thao-da-ngoai,72933955,"Bộ Bảo Hộ An Toàn Cho Bé Protection Gear, bộ bảo hộ tay, chân, đầu gối, bộ bảo hộ trượt patin, trượt ván, nhựa pvc, có đệm mút",78000,78000,0,0
TIKI,thoi-trang-nam,85185248,"Giảm Giá Sốc Combo 2 quần tây âu nam hàn quốc ống suông đen và xám, quần tay nam công sở ống đứng chất liệu vải dày dặn - MSTCOMBO2",188000,188000,0,0
TIKI,the-thao-da-ngoai,178298738,"Bộ quần áo đá banh, đá bóng có Logo CLB Real Madrid 2022_2023",160000,160000,0,0
TIKI,the-thao-da-ngoai,167652418,"Kính bơi trẻ em bé trai bé gái dễ thương",85000,85000,0,0
TIKI,the-thao-da-ngoai,137442306,"Vòng Lắc Eo Giảm Mỡ Bụng Massage Bụng - Có Thể Thao Rời Mang Đi Tiên Lợi- Hàng Chính Hãng MINIIN",131000,185000,54000,29
TIKI,the-thao-da-ngoai,174610643,"Vòng Tập Kháng Lực  Yoga,Pilate Đường Kính 38cm Cao Cấp Đại Nam Sport",119000,200000,81000,41
TIKI,thoi-trang-nam,35193591,"[FREEMAN] Combo 4 quần boxer nam BO501",221200,316000,94800,30
TIKI,the-thao-da-ngoai,138462219,"Túi ĐỰNG GIÀY (giao màu và CLB ngẫu nhiên)",76500,76500,0,0
TIKI,thoi-trang-nam,73332663,"Áo Khoác Nam Big Size Áo Khoác Dù Nam Dày Hai Lớp Cổ Cao Chống Nắng Tia Uv Chống Gió Chống Lạnh Hàn Quốc Cao Cấp QD28 - ShopN6 (Nhiều Màu)",179000,255000,76000,30
TIKI,thoi-trang-nam,154917738,"Áo ba lỗ nam chính hãng May 10",135000,135000,0,0
TIKI,thoi-trang-nam,94794850,"Áo thun nam trơn Gold Rhino cao cấp, 2 màu Trắng / Đen, hàng xuất khẩu Nhật Bản, 100% cotton chất xịn, áo phông nam trơn mềm mịn, thấm hút mồ hôi, kháng khuẩn, khử mùi hôi triệt để - Hàng chính hãng - Đen",170000,350000,180000,51
TIKI,thoi-trang-nam,132143960,"Áo Đồng Phục Đầu Bếp Màu Trắng Tay Ngắn",150000,150000,0,0
TIKI,thoi-trang-nam,22661551,"QUẦN JEAN NAM RÁCH THỜI TRANG  QJ019",140000,140000,0,0
TIKI,thoi-trang-nam,195162325,"Sơ mi nam, Áo sơ mi nam phối màu cực chất, siêu mát, mềm mịn, phong cách trẻ trung năng động H61",230000,230000,0,0
TIKI,thoi-trang-nam,169467998,"Quần kaki nam dáng suông túi mỹ chất lượng cao màu xám trung niên co dáng đẹp",140000,140000,0,0
TIKI,the-thao-da-ngoai,149595579,"phao câu đài giá rẻ ",11100,11100,0,0
TIKI,thoi-trang-nam,99954850,"Quần Jean Baggy nam xanh sáng nhạt ống xuông rộng TR03 style hàn quốc 2021",130000,130000,0,0
TIKI,thoi-trang-nam,75407543,"Quần Jean nam kiểu dáng Slim fit Chất Jean cao cấp xuất khẩu Màu Xám - Màu Xanh nhạt",59000,59000,0,0
TIKI,thoi-trang-nam,56465215,"Áo Khoác Kaki Nam Hai Lớp Hàn Quốc Đơn Giản Cao Cấp KK36 - ShopN6 (Nhiều Màu)",169000,240000,71000,30
TIKI,thoi-trang-nam,76705126,"Áo thun nam có cổ cá sấu vải loại 1 nhập từ thái lan loại áo thun tay lỡ size 55kg đến 85kg",39000,39000,0,0
TIKI,thoi-trang-nam,114307325,"Áo thun nam ngắn tay cổ tròn đẹp chất vải cotton co giãn 4 chiều thoáng mát ZAVAS  Z02",189000,289000,100000,35
TIKI,the-thao-da-ngoai,51939035,"Bộ 2 đai bảo vệ đầu gối có lò xo hỗ trợ xương bánh chè Four spring Sport knee protector Aolikes YE-7618",267000,499000,232000,46
TIKI,thoi-trang-nam,34328573,"Áo thun nam thoát nhiệt Nhật Bản GOKING, chất liệu tự nhiên 100% cotton thoáng mát, thấm hút mồ hôi",159000,159000,0,0
TIKI,thoi-trang-nam,10920839,"Combo 3 Áo thun trơn basic, form unisex cho nam nữ. Áo phông hàng hiệu Goking, quà tặng cao cấp cho gia đình, cặp đôi, lớp nhóm, doanh nghiệp, người nước ngoài",385000,385000,0,0
TIKI,the-thao-da-ngoai,33421889,"Quấn Cổ Chân GYM Hỗ Trợ Tập Mông Chân Với Cáp Kickback Aolikes (1 Đôi)",99000,99000,0,0
TIKI,the-thao-da-ngoai,163781858,"Khay Đựng Mồi Câu Đài Câu Đơn HPK-4",56200,56200,0,0
TIKI,thoi-trang-nam,76143101,"Áo sơ mi nam dài tay nam cổ bẻ cao cấp, áo sơ mi trắng vải lụa thái co giãn nhẹ không nhăn thời trang cao cấp, size áo từ 45-80 kg",83000,83000,0,0
TIKI,thoi-trang-nam,4399961,"Quần Dài Jogger Nam Phối Sọc 1041 xám",95000,95000,0,0
TIKI,thoi-trang-nam,24250579,"Quần lót boxer nam hình sao",199000,199000,0,0
TIKI,the-thao-da-ngoai,35346876,"Áo thể thao, đồ tập GYM nam ngắn tay 02",141550,149000,7450,5
TIKI,thoi-trang-nam,192367709,"ÁO THUN POLO NAM TAY NGẮN BIG SIZE TỚI 130KG CHẤT VẢI CÁ SẤU",250000,250000,0,0
TIKI,thoi-trang-nam,11246610,"Aó thun nam SITAKI có cổ thêu logo ATN02-XANHDEN",130000,130000,0,0
TIKI,thoi-trang-nam,80978495,"Áo thun nam cổ bẻ phối viền vai, thêu kim tuyến trước ngực hàng cao cấp, chất thun mềm mát  - M",75000,100000,25000,25
TIKI,thoi-trang-nam,125485858,"Áo khoác dù nam 2 lớp có nón không thêu LADOS - 2030, chống trượt nước tốt, form đẹp",329000,329000,0,0
TIKI,thoi-trang-nam,74421745,"Áo One Piece Zoro ATT-02, Áo thun Anime Manga One Piece Ronoa Zoro Unisex Nam Nữ",32000,32000,0,0
TIKI,thoi-trang-nam,76699368,"quần bò nam ống suông cao cấp co dãn hàng đẹp xuất khẩu",59000,59000,0,0
TIKI,thoi-trang-nam,15784024,"Áo Khoác Nam Áo Khoác Dù Dày Nam Trơn  Cao Cấp ShopN6 - AD34",159000,245000,86000,35
TIKI,thoi-trang-nam,146265626,"Áo hoodie nỉ bông unisex Homies liền mũ có túi in hình UNFL, Áo hoodie unisex nam nữ nỉ Unfl Studio video thật tại Shop ,Áo nỉ bông ulzzang unisex nam nữ siêu đẹp, Áo khoác Nỉ Có Mũ Túi Bụng Phong Cách Hàn Quốc",100000,100000,0,0
TIKI,thoi-trang-nam,134580006,"Quần lót nam ARISTINO dáng Brief, quần sịp tam giác nam chất liệu Bamboo tự nhiên, mềm mại và thoáng mát - AC-06",69500,80000,10500,13
TIKI,thoi-trang-nam,67908439,"Áo sơ mi nam Đen không nhăn, Sơ mi nam trơn dáng ôm Body Hàn quốc",68000,68000,0,0
TIKI,thoi-trang-nam,22559187,"Quần Lót Nam Thun Lạnh - Q006",99000,99000,0,0
TIKI,the-thao-da-ngoai,102549888,"Chai Dung Dịch Bôi Chống Mờ Kính Bơi Kính Thể Thao Ngăn Đọng Sương Bám Vào Kính Gây Mờ",85000,85000,0,0
TIKI,thoi-trang-nam,76121693,"Áo khoác nam áo gió vải dù DOKA STORE cao cấp 2 lớp chống nắng tia UV và chống nước khoát phong cách Hàn Quốc - PS21",209000,209000,0,0
TIKI,thoi-trang-nam,103596464,"Áo blazer tay lỡ unisex áo vest form rộng nam hè thu phong cách Hàn Quốc-BZ05",279000,279000,0,0
TIKI,thoi-trang-nam,131375331,"Áo Thun Nam Dài Tay Unisex, áo thu đông trơn tay dài cổ tròn basic",75000,75000,0,0
TIKI,cross-border-hang-quoc-te,108603603,"Mũ bảo hiểm đa năng ba trong một có đèn nền, tấm che mặt có thể tháo rời, đèn hậu-Màu đỏ",492000,492000,0,0
TIKI,thoi-trang-nam,67805177,"Áo thun tay lỡ cotton thoáng mát form rộng  viền chữ nhật (unisex nam nữ đều mặc được)",82000,82000,0,0
TIKI,thoi-trang-nam,94775547,"Đồ bộ nam nữ unisex mùa hè chất mè xịn co giãn 4 chiều thoáng mát (sports)",92000,92000,0,0
TIKI,the-thao-da-ngoai,149590169,"5 MỒI NHÁI HƠI CHUYÊN CÂU LURE LÓC",153000,153000,0,0
TIKI,thoi-trang-nam,99508026,"Áo Ba Lỗ Tank Top Thể Thao Nam TSIMPLE Ver.02 Nhiều màu",99000,170000,71000,42
TIKI,thoi-trang-nam,138752406,"Áo thu đông nam cổ tròn dài tay chất cotton co giãn dáng body thời trang",70500,99000,28500,29
TIKI,thoi-trang-nam,72497132,"Áo sơ mi nam đen trắng dài tay công sở cao cấp Hamino chất vải lụa co giãn nhẹ form slimfit ôm dáng thời trang Hàn Quốc, áo sơ mi nam dài tay đen trắng lụa cao cấp công sở Hàn Quốc",85000,85000,0,0
TIKI,thoi-trang-nam,82288770,"Áo Tank Top Nam H&H-ATBL06 Áo Thun Ba Lỗ In Họa Tiết Ngôi Sao Đầy Nam Tính - 3 Màu",110000,110000,0,0
TIKI,cross-border-hang-quoc-te,180899224,"2x for  S50 Cleaner Mopping Cloth",164000,164000,0,0
TIKI,cross-border-hang-quoc-te,108603307,"Túi sườn xe đạp Fream, thiết kế dạng ống,nhỏ gọn,chất liệu vải cao cấp chống thấm nước",313000,313000,0,0
TIKI,thoi-trang-nam,74404407,"Quần jogger kaki nam cao cấp Amazing, sắc màu trẻ trung, phong cách thể thao cá tính, gấu quần bo chun, có big size",239000,349000,110000,32
TIKI,thoi-trang-nam,73552136," Áo thun nam tay lỡ form rộng phong cách Hàn Quốc",93000,93000,0,0
TIKI,thoi-trang-nam,113066078,"Áo khoác sơ mi caro tay dài thời trang phong cách Hàn Quốc cho nam",84000,84000,0,0
TIKI,thoi-trang-nam,106855457,"Quần Thể Dục Học Sinh - Quần 1 sọc Bo gấu,2( 15-18kg)",50700,50700,0,0
TIKI,cross-border-hang-quoc-te,11778281,"The Troop",462000,462000,0,0
TIKI,cross-border-hang-quoc-te,149897161,"Túi đựng phấn leo núi chống thấm nước có thể điều chỉnh tiện lợi",208000,208000,0,0
TIKI,cross-border-hang-quoc-te,109164618,"Bơm Xe Đạp mini WEST BIKING 120PSI thiết kế khóa cài có độ bèn tốt, không bị rơi khi bơm",198000,198000,0,0
TIKI,cross-border-hang-quoc-te,114427236,"Hộp Đựng Sạc Usb Có Thể Tháo Rời - RANDOM",108000,108000,0,0
TIKI,thoi-trang-nam,20534153,"Áo Sơ Mi Nam Tay Dài Khatoco A1MD568S1-CNMK003-2102-D",454400,568000,113600,20
TIKI,cross-border-hang-quoc-te,51211495,"Móc Khóa Lò Xo Bằng Thép Không Gỉ 304",143000,143000,0,0
TIKI,thoi-trang-nam,74532752,"Áo One Piece Luffy ATT-02, Áo thun Anime Manga One Piece Monkey D. Luffy Unisex Nam Nữ",43000,43000,0,0
TIKI,cross-border-hang-quoc-te,94978815,"Soft Planet Bouncy Ball Relieve Tension for Kids Universe Elastic Planetary",184000,184000,0,0
TIKI,cross-border-hang-quoc-te,76235627,"8pcs Reusable Finger Cots Cut Resistant Protection Fingertip Sleeves Caps Covers",135000,135000,0,0
TIKI,cross-border-hang-quoc-te,176112032,"Marine Fuel Line Assembly for Tohatsu 240cm Outboard Motors, Black",780000,780000,0,0
TIKI,thoi-trang-nam,21659759,"Áo Khoác da nam lót lông thu đông phối 2 túi AN63",298000,298000,0,0
TIKI,thoi-trang-nam,143694820,"Áo Sơ Mi Nam Sọc Chữ Dài Tay Mã Q889 Thời Trang Nam Công Sở PONIVA Cao Cấp Chất Liệu Mềm Mịn Thoáng Mát Hàng Chất Lượng VNXK",122000,122000,0,0
TIKI,cross-border-hang-quoc-te,10756812,"How To Be A Stoic",598000,598000,0,0
TIKI,thoi-trang-nam,163550992,"Bộ Thể Thao Nam Có Cổ Phối Màu Sọc Ngang Thời Trang Thiết Kế AVIANO",269000,458000,189000,41
TIKI,thoi-trang-nam,83401596,"Quần đùi nam mặc nhà vải MÁT co dãn tốt mặc cực kỳ thoải mái loại quần đùi nam thông dụng",23000,23000,0,0
TIKI,cross-border-hang-quoc-te,76517544,"Kids Car Safety Seatbelt Adjuster Universal Seat Belt Triangle Holder  Gray",151000,151000,0,0
TIKI,thoi-trang-nam,99482937,"Áo khoác jean nam rách cao cấp vải jean denim không nóng hàng chuẩn shop Phuongnamshop20 rkv23",279000,279000,0,0
TIKI,cross-border-hang-quoc-te,176587754,"Vintage Charm Brass Pocket Compass for Keychain Cycling Cycle Hiking Camping",164000,164000,0,0
TIKI,cross-border-hang-quoc-te,116462758,"Adjustable Clamp-On Beach Umbrella Sun Parasol Lounge Chair Strollers Hiking",634000,634000,0,0
TIKI,cross-border-hang-quoc-te,98910904,"Silicone Protective Cover for DJI FPV Combo  Motion Controller Skin Case Protector with Anti-Lost Lanyard Accessories",122000,122000,0,0
TIKI,cross-border-hang-quoc-te,110301546,"Đế đĩa cứng Đa chức năng 2,5 / 3,5 "IDE & SATA USB 3.0 Ổ cứng HDD Ổ cắm ba-ngăn -Size Cắm AU",680800,680800,0,0
TIKI,cross-border-hang-quoc-te,170726266,"Sách - Meditations by Marcus Aurelius (UK edition, paperback)",202000,202000,0,0
TIKI,thoi-trang-nam,12239104,"Quần Tây Nam Đen Công Sở DEN02",85000,85000,0,0
TIKI,thoi-trang-nam,108772138,"Áo Thun Nam Ngắn Tay Không Cổ US ARMY U229, Chất Liệu Cotton Thoáng Mát, Mềm Mịn, Mát, Bền Màu-HÀNG CHÍNH HÃNG",199000,398000,199000,50
TIKI,cross-border-hang-quoc-te,165085487,"Độ bền của dây đeo tay silicon cho Garmin Instinct2/Esports/Tide/Tactical/Dual Power Surf",274000,274000,0,0
TIKI,cross-border-hang-quoc-te,55972431,"40 Pcs Stainless Steel Roth Second 2nd Molar Buccal Tube Packs",345000,345000,0,0
TIKI,cross-border-hang-quoc-te,94959059,"Motorcycle Headlight Head Light Mount Bracket For Harley Sportster XL 883 1200 Models",477000,477000,0,0
TIKI,thoi-trang-nam,91467052,"Quần bơi nam boxer cao cấp, dáng ngắn thể thao, eo kép dễ chịu, chất thun bơi đẹp không thấm nước nhanh khô, đàn hồi cao | BN006",240000,240000,0,0
TIKI,cross-border-hang-quoc-te,108226029,"Máy nghe nhạc CD Điều khiển từ xa Bluetooth Đài FM Loa HiFi với USB 3.5mm YHS-08C-Màu Hồng-Size Cắm EU",814900,814900,0,0
TIKI,cross-border-hang-quoc-te,11471978,"Thick Face, Black Heart",598000,598000,0,0
TIKI,the-thao-da-ngoai,52184069,"Áo Tập Gym Ba Lỗ Rộng Nách Nam Cotton SA475",99000,99000,0,0
TIKI,thoi-trang-nam,176561403,"Quần Short Gió Nam Kiểu Dáng Năng Động Phong Cách Thể Thao Trẻ Trung 5 Màu Thời Trang AVIANO",129000,258000,129000,50
TIKI,cross-border-hang-quoc-te,99064784,"Modern Canvas Prints Artwork Painting Picture Wall Art Decor",133000,133000,0,0
TIKI,cross-border-hang-quoc-te,170605629,"Sách - Piano Exam Pieces 2021 & 2022, ABRSM Grade 6 : Selected from the 2021 & 2022 syl by ABRSM (UK edition, paperback)",480000,480000,0,0
TIKI,thoi-trang-nam,113052759,"Áo khoác nam Áo khoát nam kaki chống nắng rẻ from rộng trơn cực chất siêu chất",145000,145000,0,0
TIKI,cross-border-hang-quoc-te,204602235,"Vỏ Bọc Ghế Sofa Co Giãn Chống Trượt Thiết Kế Đơn Giản",208476,208476,0,0
TIKI,thoi-trang-nam,189648166,"Áo sơ mi nam ngắn tay trắng Regular fit NSMMMWMSPR210261N",303000,319000,16000,5
TIKI,thoi-trang-nam,163713265,"Áo Sơ Mi Nam Công Sở Trung Niên Thương Hiệu Anton Dài Tay Vải Cotton Xanh Đậm Trơn Có Túi -XA13",225000,280000,55000,20
TIKI,cross-border-hang-quoc-te,189351064,"Đèn màn hình 5 màu với đèn nền RGB, đèn máy tính USB",663000,663000,0,0
TIKI,cross-border-hang-quoc-te,96357561,"10x Waterproof Golf Iron Headcover with Numbers 4-9 A,S,P Club Covers Protect Sleeves Anti-Scratch Protection Head Cover Outdoor Sport Accessories",527000,527000,0,0
TIKI,cross-border-hang-quoc-te,104417785,"Heavy Duty Multi-Purpose Thumb Screw Tarp Clips Tent Tarpaulin Clamps for Holding Up Tarp, Canopy Car Pool Cover Boat Cover Temporary Projector Screen",226000,226000,0,0
TIKI,cross-border-hang-quoc-te,177667069,"Túi 15 Gói Cà Phê Trắng Kem Sữa Hòa Tan 3-In-1 Cao Cấp Killiney 3-In-1 Premium White Coffee (15 gói x 40g)",350000,350000,0,0
TIKI,thoi-trang-nam,78923837,"Hộp 5 Quần Lót Nam nhiều lưng hiệu CITYMEN vải thun lạnh co giãn 4 chiều màu ngẫu nhiên, sịp nam - LMTK-MULTIAL",75000,75000,0,0
TIKI,cross-border-hang-quoc-te,52843346,"High Quality Silicone Rig Tube Sleeve Anti- Rig Tubing for Carp Fishing",125000,125000,0,0
TIKI,cross-border-hang-quoc-te,177733986,"2 chiếc Hộp bảo vệ TPU cho Huawei Freebuds Pro",263000,263000,0,0
TIKI,cross-border-hang-quoc-te,116490495,"Voice Recorder Pen 128Kbps Digital Audio Voice Recorder with One Button",239000,239000,0,0
TIKI,thoi-trang-nam,129301896,"Quần ngố kaki túi hộp nam trung niên chất siêu mềm nhẹ size 100kg hàng nội địa trung",223000,223000,0,0
TIKI,cross-border-hang-quoc-te,11844285,"The Boy In The Dress",332000,332000,0,0
TIKI,cross-border-hang-quoc-te,108778020,"Đồng hồ BOBO BIRD bằng gỗ Quartz Movement 2 Múi giờ Quà tặng kèm hộp cho Nam Nữ - Loại A-Size Loại A",996000,996000,0,0
TIKI,thoi-trang-nam,155764985,"Áo len nam May 10 mã 200119453ON Ghi-202",129000,129000,0,0
TIKI,thoi-trang-nam,40979664,"Combo 3 quần sịp đùi nam Cao Cấp Boxer Cạp Nhỏ MRM FASHION cùng màu",195000,255000,60000,24
TIKI,cross-border-hang-quoc-te,116422852,"2 Folding Sofa Hinges 180 Adjustable Connector And 5  ​​Ratchet Hinges",200000,200000,0,0
TIKI,cross-border-hang-quoc-te,11777249,"Collins Classics: Selected Stories",227000,227000,0,0
TIKI,cross-border-hang-quoc-te,76174953,"Printing Label Supermarket Waterproof Price Label Pure Color Scratch-Resistant Label Paper Roll for D11 Thermal Printers",214000,214000,0,0
TIKI,thoi-trang-nam,93828594,"Áo Khoác Big Size Nam Nữ Unisex Áo Khoác Nỉ Có Nón Cổ Cao Chống Nắng Chống Nóng Chống Lạnh Chống Gió Đi Phượt Racing Thời Trang Hàn Quốc Cao Cấp AN14 - ShopN6",169000,190000,21000,11
TIKI,cross-border-hang-quoc-te,95723532,"Túi Đựng Điện Thoại Chống Nước Gắn Ghi Đông Xe Đạp",260000,260000,0,0
TIKI,thoi-trang-nam,19814067,"Áo Thun Đen Trơn Nam Nữ",44000,44000,0,0
TIKI,thoi-trang-nam,75329760,"ÁO THUN NAM NGẮN TAY CỔ BẺ MẪU MỚI",79800,84000,4200,5
TIKI,cross-border-hang-quoc-te,46362317,"Tai Nghe Tai Thay Thế Miếng Lót/Bịt Tai/Tai Ly/Vành Che Tai/Nút Tai Nghe Bằng Chi Tiết Sửa Chữa Cho Sony MDR-10",226000,226000,0,0
TIKI,thoi-trang-nam,22774390,"Áo Thun nam cá sấu mẫu mới, combo 4 áo - ĐB437",623000,623000,0,0
TIKI,cross-border-hang-quoc-te,52653105,"Dây đeo thay thế cho Misfit Ray Fitness Tracker - Đen",144000,144000,0,0
TIKI,cross-border-hang-quoc-te,100553713,"Skull Figurine Spooky Desktop Statue Hand Curved Party Cosplay Ornaments",274000,274000,0,0
TIKI,cross-border-hang-quoc-te,10732402,"The Lean Startup",455000,455000,0,0
TIKI,cross-border-hang-quoc-te,111066739,"Máy tính bảng đồ họa VEIKK VK640 kỹ thuật số với 8192 mức Độ nhạy áp suất 5080LPI Độ phân giải 250RPS",996000,996000,0,0
TIKI,cross-border-hang-quoc-te,94974552,"10Pcs Handmade Xuan Paper Washi Paper Stationery Paper",135000,135000,0,0
TIKI,cross-border-hang-quoc-te,130382827,"Aqumotic Tre Gối Cổ Gỗ Hình Chữ U Gỗ Vật Lý Trị Liệu Thắt Lưng Đặt Lại Gối Lực Kéo Sửa Chữa Ngủ Cứng - height 7cm",685690,685690,0,0
TIKI,cross-border-hang-quoc-te,147187974,"Còi Kim Loại Cho Trọng Tài Thể Thao",252000,252000,0,0
TIKI,cross-border-hang-quoc-te,108511475,"3.5mm Wireless Controller Keyboard Bluetooth Gamepad Chat Pad Keypad for PS5",327000,327000,0,0
TIKI,thoi-trang-nam,133689539,"Áo khoác gió nam trung niên chất đẹp+ẢNH THẬT",375000,375000,0,0
TIKI,thoi-trang-nam,118015579,"Đồ Lam Đi Chùa # Lãnh Tụ Nam Thêu 3 Túi # Đồ Bộ Nam # Quần Áo Nam",222000,222000,0,0
TIKI,thoi-trang-nam,188382189,"Áo phông, Áo phông nam có khóa tạo kiểu nam tính trẻ trung, ôm body nam tính, chắc chăn thu hút các nàng, h44",260000,260000,0,0
TIKI,cross-border-hang-quoc-te,174222565,"Sách - The Book You Wish Your Parents Had Read (and Your Children Will Be Glad by Philippa Perry (UK edition, paperback)",378000,378000,0,0
TIKI,thoi-trang-nam,120507563,"Áo chống nắng nam 2 lớp kèm khẩu trang",76000,76000,0,0
TIKI,cross-border-hang-quoc-te,108599526,"Giá đỡ điện thoại dùng cho xe đạp GUB, thiết kế bằng nhôm-Màu Titan",262000,262000,0,0
TIKI,cross-border-hang-quoc-te,111304062,"Scorch Pen Marker Chemical Wood Burning Pen Wood Burning Markers Pens Stationery for DIY Wood Crafts Projects",207000,207000,0,0
TIKI,thoi-trang-nam,96160421,"Áo thun nam thể thao tay lỡ, cổ tròn đẹp, trẻ trung, mặc thoáng mát, thấm hút tốt CHANDI HH14",89000,89000,0,0
TIKI,cross-border-hang-quoc-te,77727239,"Waterproof Tactical Waist Bag Belt Fanny Pack Phone Molle Pouch Camping Hiking",271000,271000,0,0
TIKI,cross-border-hang-quoc-te,46351495,"4mm Chuối Cắm Thử Dẫn Với Kẹp Cá Sấu Và Spade Ổ",227000,227000,0,0
TIKI,cross-border-hang-quoc-te,170578822,"Sách - The Right Side of History : How Reason and Moral Purpose Made the West Gre by Ben Shapiro (US edition, hardcover)",838000,838000,0,0
TIKI,cross-border-hang-quoc-te,99615367,"Memory Foam Explosions Octopus Nap Pillow Support for Office Travelling Desk",434000,434000,0,0
TIKI,cross-border-hang-quoc-te,108780054,"Đồng hồ Quartz Thể thao đơn giản Dây da 3ATM chống nước Chronograph MEGIR 2094 Nam-Màu Bạc",497000,497000,0,0
TIKI,cross-border-hang-quoc-te,189506590,"Giá đỡ máy quay hành trình DVR xoay 360 độ cho xe hơi
",206369,206369,0,0
TIKI,cross-border-hang-quoc-te,181266933,"Compound Bow Case Holder Bow Bag Adjustable Equipment Arrow Quiver Pocket Archery for Shooting",626000,626000,0,0
TIKI,cross-border-hang-quoc-te,189281656,"Bút Vẽ Xóa Vết Xước Cho Xe Hơi",181000,181000,0,0
TIKI,cross-border-hang-quoc-te,51380831,"18pcs/lot Large Disposable Plastic Cutlery Set Forks Knives Spoons",160000,160000,0,0
TIKI,cross-border-hang-quoc-te,76174257,"Dao Cạo An Toàn Hai Lưỡi Cho Nam Giới, Chất Liệu Hợp Kim Kẽm An Toàn Với 5 Chiếc Lưỡi Thay Thế Bằng Thép Không Gỉ Double Edge Safety Razor For Men",152000,152000,0,0
TIKI,cross-border-hang-quoc-te,176763376,"Keyboard Storage Bag, Handheld Carrying Case Waterproof Shockproof Simple Nylon Storage Shell for Logitech Bluetooth Mechanical Keyboard",378000,378000,0,0
TIKI,thoi-trang-nam,178006905,"Đồ Bơi Nam Nữ Set Bơi Cặp Tay Dài Chống Nắng AT226 MayHomes Thun Lạnh Bền Chắc Và Co Giãn Tốt UPF 50+, Long-Sleeve Couple Swimsuit",293020,299000,5980,2
TIKI,thoi-trang-nam,158905125,"quần lót nam relax thun lạnh cao cấp chính hãng, quần sip nam relax underwear rltk22 - M",81000,81000,0,0
TIKI,cross-border-hang-quoc-te,108604328,"1 găng tay chơi Bida-Màu đỏ-Size",209000,209000,0,0
TIKI,cross-border-hang-quoc-te,229967545,"Cặp Mút Đệm Thay Thế Cho Tai Nghe Chụp Tai SteelSeries Arctis 1 3 5 7 PRO",283320,283320,0,0
TIKI,cross-border-hang-quoc-te,253275501,"Máy hút chân không bảo quản thực phẩm Hút mạnh Di động 10-20s",227000,227000,0,0
TIKI,cross-border-hang-quoc-te,196025794,"Bìa bàn phím silicon cho Surface Pro 4/5/6/7",257000,257000,0,0
TIKI,cross-border-hang-quoc-te,163882906,"Sách - Pusheen Coloring Book by Claire Belton (US edition, paperback)",490000,490000,0,0
TIKI,cross-border-hang-quoc-te,10764061,"Goodbye, Things: The New Japanese Minimalism",555000,555000,0,0
TIKI,thoi-trang-nam,20518713,"Quần Kaki Nam Khatoco Q2M528S0-CNMA003-2006-0- Nâu",199000,528000,329000,62
TIKI,thoi-trang-nam,104921367,"Quần đùi thun nam, quần tập gym, quần mặc nhà chất thun cotton 100% thương hiệu Fezzio",69500,139000,69500,50
TIKI,thoi-trang-nam,87250655,"Áo Sơ Mi Flannel Sơ Mi Caro Áo Khoác Nam Nữ Form Rộng Cá Tính Unisex SM11",110000,110000,0,0
TIKI,cross-border-hang-quoc-te,169858713,"Wireless Bluetooth Cable Upgrade Wire MMCX Connector For Shure SE215",169000,169000,0,0
TIKI,thoi-trang-nam,110945267,"Quần đùi nam xuất khẩu vải kate cotton mềm mát thương hiệu Fezzio",64500,129000,64500,50
TIKI,cross-border-hang-quoc-te,97451076,"Star Projector  Light Skylight for Bedroom Ceiling, LED Starlights Sky Light Starry Night Light Nebula Projector for Kids Adults",206000,206000,0,0
TIKI,cross-border-hang-quoc-te,51206254,"Dành Cho Fujifilm Instax Mini 9 Camera PU Case Filter + Đóng Lên Bộ Quà Tặng ống Kính",188000,188000,0,0
TIKI,thoi-trang-nam,163716172,"Áo Sơ Mi Nam Xanh Tím Than Ngắn Tay Công Sở Trung Niên Anton Kẻ Caro Thoáng Mát, Thấm Hút Mồ Hôi - NT201",295000,425000,130000,31
TIKI,thoi-trang-nam,117582667,"Áo Giữ Nhiệt Nam",49000,49000,0,0
TIKI,cross-border-hang-quoc-te,120769126,"9x Shark Golf Iron Head Covers Leather PU Golf Club Headcovers",512000,512000,0,0
TIKI,cross-border-hang-quoc-te,46329976,"Bao Trống Cajon Bán EQ Bộ Gõ Hộp Trống Phụ Kiện Nhạc Cụ",620000,620000,0,0
TIKI,cross-border-hang-quoc-te,111066708,"Túi lưu trữ cầm tay đa chức năng BUBM Dung lượng lớn kỹ thuật số hai lớp-Màu Xám-Size N",283000,283000,0,0
TIKI,thoi-trang-nam,20521761,"Áo Sơ Mi Nam Tay Ngắn Khatoco A1MN538T1-CNCR116-2010-N",149000,538000,389000,72
TIKI,cross-border-hang-quoc-te,96409779,"20 Sheets Colorful Photo Instant Films Sticker for FujiFilm Instax Mini 9/ 8/ 7s/ 70/ 26/ 50s/ 90 Camera Film",124000,124000,0,0
TIKI,cross-border-hang-quoc-te,165221607,"Sunset Projection Lamp, Adjustable Brightness Sunset Light, Sunset Lamp Projector Night Light for Home Bedroom Decoration",315000,315000,0,0
TIKI,cross-border-hang-quoc-te,189275238,"Hộp Đựng Đồ Gắn Bảng Điều Khiển Xe Hơi Suzuki Jimny 2019 2020",322500,322500,0,0
TIKI,cross-border-hang-quoc-te,170649679,"Sách - White Bird : A Graphic Novel by R J Palacio (UK edition, paperback)",552000,552000,0,0
TIKI,cross-border-hang-quoc-te,164333219,"Shade Sail Hardware Kit for Triangle Square Heavy Duty Stainless Steel with 4x Turnbuckle, 4x Pad Eye, 4x Snap Hook, 16x Screw, 16x Plastic Expansion",324000,324000,0,0
TIKI,cross-border-hang-quoc-te,230302107,"Ổ Cứng Ngoài 8TB / 16TB 3.0",390700,390700,0,0
TIKI,cross-border-hang-quoc-te,111688026,"Ống kính góc rộng kỹ thuật số 67mm Độ nét cao 0,43 × SuPer với Quang học Macro Nhật Bản cho Canon Rebel T5i T4i T3i 18-135mm",743000,743000,0,0
TIKI,cross-border-hang-quoc-te,93494771,"100% Cotton Original U-Shaped Feeding Pillow for Newborn Breastfeeding Boppy",212000,212000,0,0
TIKI,cross-border-hang-quoc-te,176760042,"2Pcs 2 Pin Beeper Motorcycle Indicator Flasher Relay Turn Signal LED Blinker",144000,144000,0,0
TIKI,cross-border-hang-quoc-te,248916639,"Intelligent Electric Soldering Iron Portable Soldering Pen 0.91inch OLED Display PC Housing High Precise Temperature Control with 0-450℃ Temperature Adjustment Function",978000,978000,0,0
TIKI,cross-border-hang-quoc-te,11863524,"Lonely Planet Seoul (Travel Guide)",606000,606000,0,0
TIKI,cross-border-hang-quoc-te,254882217,"Bướm dao kết hợp có thể gập bằng thép không gỉ tập luyện rèn r lục bộ ria mép salon salon công cụ tạo kiểu làm tóc Màu sắc",587033,587033,0,0
TIKI,cross-border-hang-quoc-te,93106836,"Anti-fog Dog Puppy Mouth Mask Pet Adjustable Muzzle For Small Dog Labrador",90000,90000,0,0
TIKI,cross-border-hang-quoc-te,98043755,"Màn Hình Máy Chiếu Di Động 120 Inch H120 HD 16: 9 Màu Trắng Dacron Có Thể Gập Lại",238900,238900,0,0
TIKI,cross-border-hang-quoc-te,11708956,"How To Fix A Broken Heart",527000,527000,0,0
TIKI,cross-border-hang-quoc-te,170672854,"Sách - The Little Prince : Colour Illustrations by Antoine de Saint-Exupery (UK edition, hardcover)",386000,386000,0,0
TIKI,cross-border-hang-quoc-te,123523440,"Quạt tản nhiệt 0604DR cn-0604DR cho Laptop Dell XPS18 1810 604DR-A00 KDB0705HB CH63 NEW",675200,675200,0,0
TIKI,cross-border-hang-quoc-te,170625321,"Sách - The Consolation of Philosophy by Ancius Boethius (UK edition, paperback)",359000,359000,0,0
TIKI,cross-border-hang-quoc-te,142628179,"Sáp Đóng Dấu Niêm Phong Bì Thư Phong Cách Vintage",186000,186000,0,0
TIKI,cross-border-hang-quoc-te,11385039,"First Thousand Words In English",310000,310000,0,0
TIKI,cross-border-hang-quoc-te,122144232,"Aluminum Metal Pizza Peel for Easy Storage, Gourmet Luxury Pizza Paddle for Baking Homemade Pizza Bread",657000,657000,0,0
TIKI,cross-border-hang-quoc-te,173744100,"Sách - The Art of War by Sun Tzu Thomas Cleary (US edition, paperback)",471000,471000,0,0
TIKI,cross-border-hang-quoc-te,109441943,"Đồng hồ treo tường đa chức năng báo thức, hiển thị nhiệt độ, độ ẩm",588100,588100,0,0
TIKI,cross-border-hang-quoc-te,130383736,"Tự Nhiên Kiều Mạch Vỏ Gối Ngủ Vật Có Gối Cổ Chăm Sóc Sức Khỏe",811923,811923,0,0
TIKI,cross-border-hang-quoc-te,107856580,"1 Pair Silicone Bunion Hallux Valgus Protector Finger Toe Separator Divider Spreader 4 Holes Thumb Valgus Guard Feet",91000,91000,0,0
TIKI,cross-border-hang-quoc-te,170726292,"Sách - The Odd 1s Out : How to Be Cool and Other Things I Definitely Learned f by James Rallison (UK edition, paperback)",494000,494000,0,0
TIKI,cross-border-hang-quoc-te,170625647,"Sách - The China Study: Revised and Expanded Edition : The Most Comprehensi by T. Colin Campbell (US edition, paperback)",931000,931000,0,0
TIKI,cross-border-hang-quoc-te,114421363,"Máy Cắt Chai Thủy Tinh Bằng Kim Loại Kích Thước Có Thể Điều Chỉnh",398000,398000,0,0
TIKI,cross-border-hang-quoc-te,94980431,"10Pc/Set Finger Sponge Daubers Foam for Applying Painting Ink Craft Art Tool",183000,183000,0,0
TIKI,cross-border-hang-quoc-te,112591516,"Giày nước Thể thao Khô nhanh để bơi Lặn Lướt sóng, đi bộ, tập Yoga cho nam nữ-Màu xanh dương-Size Size 38",200200,200200,0,0
TIKI,cross-border-hang-quoc-te,179583877,"Sách - No Hard Feelings : Emotions at Work and How They Help U by Liz Fosslien Mollie West Duffy (UK edition, paperback)",687000,687000,0,0
TIKI,cross-border-hang-quoc-te,11667724,"Harvard Business Review: Smart Business",553000,553000,0,0
TIKI,cross-border-hang-quoc-te,160398010,"Portable Cordless Grinding Machine Handheld Rechargeable Grinder Mini Polishing Engraving Pen Set",582000,582000,0,0
TIKI,cross-border-hang-quoc-te,167685312,"Triangle Quilting Cutting Template DIY Sewing Tools Cutting Mats Patchwork Ruler",226000,226000,0,0
TIKI,cross-border-hang-quoc-te,184506576,"Universal Golf Blade Putter Head Cover Embroidered Golf Club Headcovers",277000,277000,0,0
TIKI,cross-border-hang-quoc-te,97507707,"Chắn Bùn Trước Sau Cho Xe Đạp MTB",115000,115000,0,0
TIKI,cross-border-hang-quoc-te,189561742,"Sách - American Psycho by Bret Easton Ellis (UK edition, paperback)",395000,395000,0,0
TIKI,cross-border-hang-quoc-te,99093414,"Bàn Phím Số Không Dây Bằng Nhôm 34 Phím BT Tích Hợp Pin Sạc Cho Windows / IOS / Android",620000,620000,0,0
TIKI,cross-border-hang-quoc-te,59095247,"Ultrasonic Mosquito Bracelet Wrist Watch Insect Repellent Band Outdoor Camping",187000,187000,0,0
TIKI,cross-border-hang-quoc-te,189518445,"Hộp Đựng Kính Ô Tô / Hộp Đựng Kính Râm Ô Tô",399998,399998,0,0
TIKI,cross-border-hang-quoc-te,172631307,"Sách - The Life-Changing Manga of Tidying Up : A Magical Story to Spark Joy in Li by Marie Kondo (UK edition, paperback)",354000,354000,0,0
TIKI,cross-border-hang-quoc-te,181253762,"2.4G Wireless Guitar System Transmitter & Receiver 4 Channels for Speaker Electric Guitar",796000,796000,0,0
TIKI,cross-border-hang-quoc-te,170726415,"Sách - Killing Commendatore by Haruki Murakami (US edition, paperback)",661000,661000,0,0
TIKI,cross-border-hang-quoc-te,111063679,"VEIKK Drawing Glove Two-finger Drawing Glove Lightweight Sweatproof Soft Glove for VEIKK Graphics Tablet Graphic Monitor",66000,66000,0,0
TIKI,the-thao-da-ngoai,138721325,"Rọng Cá Câu Đài , Giỏ Đựng Cá Siêu Bền Cao Cấp",357050,357050,0,0
TIKI,the-thao-da-ngoai,82187136,"Băng bảo vệ khuỷu tay, bó khuỷu tay, cùi chỏ - 2 cái [Tặng dây cột tóc hoa mặt trời]",55000,55000,0,0
TIKI,the-thao-da-ngoai,206820394,"Áo tạ thể lực Suteng, Áo tạ tập thể lực 10kg",850000,850000,0,0
TIKI,cross-border-hang-quoc-te,249067890,"Máy Cắt Cỏ Không Dây Cầm Tay 21V, Máy Cắt Cỏ Điện 2 Gói, Pin Sạc 1500MAh, Bộ Sạc Nhanh, Tông Đơ Lithium Đa Chức Năng, Có Lưỡi Nhựa/Thép Không Gỉ, Lưỡi Cưa Tròn",791000,791000,0,0
TIKI,cross-border-hang-quoc-te,124252410,"Z6 Trẻ Em SOS Đồng Hồ Thông Minh IP67 Chống Nước SIM Đồng Hồ Trẻ Em Định Vị GPS Chống Mất Tay Thông Minh Dành Cho IOS android PK Q12 Q50 - one",579117,579117,0,0
TIKI,the-thao-da-ngoai,124273395,"Bộ 100 Túi Nilon Bọc Giày Đi Mưa Tiện Lợi",46000,49000,3000,6
TIKI,the-thao-da-ngoai,46441425,"Mồi Cá giả câu cá Minow siêu nhạy, 2 lưỡi câu siêu cứng dài 9.5cm ( 1 con ) - màu ngẫu nhiên",16000,16000,0,0
TIKI,the-thao-da-ngoai,135094035,"Cuốn cán vợt cầu lông và TENNIS Joto màu ngẫu nhiên",17000,19000,2000,11
TIKI,the-thao-da-ngoai,12121290,"Bộ bóng tập phản xạ boxing treo đầu",65000,65000,0,0
TIKI,the-thao-da-ngoai,160073423,"Dây Đeo Kính Dạng Cao Su Chống Trượt - Siêu Đàn Hồ - Trẻ Trung- Nhiều Màu Sắc",30000,30000,0,0
TIKI,the-thao-da-ngoai,192034637,"Mũ trùm - Khăn khẩu trang Nija",15000,15000,0,0
TIKI,the-thao-da-ngoai,93924519,"GIÀY TENNIS CHÍ PHÈO CAO CẤP SIÊU ĐẸP,SIÊU ÊM",430000,430000,0,0
TIKI,the-thao-da-ngoai,109296346,"VỢT CẦU LÔNG PROKENNEX THUNDER 7003 CHẤT LƯỢNG CHÍNH HÃNG ĐÃ ĐAN LƯỚI TRỢ LỰC (1 cây) - Tặng kèm quấn cán",848000,1098000,250000,23
TIKI,the-thao-da-ngoai,72646135,"Giày bóng rổ PEAK Basketball DA920231",869000,1090000,221000,20
TIKI,the-thao-da-ngoai,169437421,"Phao Tim TẬP BƠI MẪU LỖ Mới - Giao màu ngẫu nhiên",48900,48900,0,0
TIKI,the-thao-da-ngoai,186203612,"GIƯỜNG GẤP ĐƠN VĂN PHÒNG NGHỈ TRƯA, GIƯỜNG CẮM TRẠI DI ĐỘNG",660000,660000,0,0
TIKI,the-thao-da-ngoai,46759655,"Combo Vỏ bao cát đấm bốc boxing 4 lớp dài 105cm, Ø=35cm + Găng tay đấm bốc mma hở ngón + Băng đa cuốn tay - Tặng kèm thêm 7 món bao gồm dây xích + móc treo + vít nở sắt + lót tay chân",350000,350000,0,0
TIKI,the-thao-da-ngoai,41164879,"Bao đeo bắp tay cho điện thoại khi tập thể dục, chơi thể thao",24800,24800,0,0
TIKI,the-thao-da-ngoai,11559751,"[Hình Thật] Túi Ngủ Cao Cấp Văn Phòng + Đi Phượt Galaxy Store GSTN03 (Hàng Xuất Khẩu)",280000,450000,170000,38
TIKI,the-thao-da-ngoai,139917732,"Vợt Vớt Cá Inox 1m7 Tới 7m Kèm Vành Lưới - Cần Câu Top1 VN",117800,117800,0,0
TIKI,the-thao-da-ngoai,80322921,"Thực phẩm bổ sung gia tăng sức bền và phục hồi cơ Myprotein Essential BCAA 250g – Nutrition Depot Vietnam",450000,470000,20000,4
TIKI,the-thao-da-ngoai,103870517,"Giày Thể Thao Cao Cấp Nữ Biti's Hunter Layered Upper DSWH02800DEN (Đen)",830000,902000,72000,8
TIKI,the-thao-da-ngoai,146905505,"Chống Cần Câu Cá LEO-27887- Ngoe Chống Cần Câu Đài, Gác cần Câu cá",116100,116100,0,0
TIKI,the-thao-da-ngoai,5885625,"Miếng đệm hỗ trợ bảo vệ đầu gối khi đá bóng, bóng chuyền, đi xe đạp AOLIKES TC-0217",173000,269000,96000,36
TIKI,the-thao-da-ngoai,139946584,"Mồi Dụ Cá cho lồng bát quái",5600,5600,0,0
TIKI,the-thao-da-ngoai,160080745,"Dây Đeo Kính Dạng Cao Su Chống Trượt - Siêu Đàn Hồ - Trẻ Trung- Nhiều Màu Sắc",30000,30000,0,0
TIKI,the-thao-da-ngoai,113912862,"combo dã ngoại, picnic gồm bạt + võng + dây dù",259000,259000,0,0
TIKI,the-thao-da-ngoai,192926552,"Băng quấn bảo vệ đầu gối AOLIKES A-1516 Sport Knee Protector",86000,159000,73000,46
TIKI,the-thao-da-ngoai,163747847,"Hạt Chặn Silicon Cao Cấp Hạt Chặn Câu Đài Phụ Kiện Câu Đài",6700,6700,0,0
TIKI,the-thao-da-ngoai,163746740,"(sale) Sạc Pin Phao Câu Đài Tặng Kèm 2 Pin Câu Đài CR-425 | uy tín chất lượng",63680,63680,0,0
TIKI,the-thao-da-ngoai,129723913,"Lều Cắm Trại Lều Du Lịch Tự Bung Gấp Gọn Chống Nước 2-3 Người ( 2X 1.5 X 1.4 M) Giao Màu Ngẫu Nhiên - Hàng Loại 1",185000,185000,0,0
TIKI,the-thao-da-ngoai,156028499,"Lưỡi câu Titan vẩy rồng 7 màu gân xoắn có ngạnh hàng Japan",30000,30000,0,0
TIKI,the-thao-da-ngoai,175775340,"Bộ Tạ Tay Điều Chỉnh Khóa Số Tự Động 24kg Cao Cấp TP Tienphatsmart",3500000,3500000,0,0
TIKI,the-thao-da-ngoai,138716797,"10 Khóa Link Câu Cá Chống Xoắn",16600,16600,0,0
TIKI,the-thao-da-ngoai,167683581,"Tất Bóng Đá Dài Chứa Ống Đồng - Cực Êm, Dày Dặn, Chống Trơn, Dài Qua Đầu Gối",90000,90000,0,0
TIKI,the-thao-da-ngoai,190082058,"Kính bơi cận thị có độ từ 1.5 đến 8.0 mắt trong suốt cản tia UV cho người lớn, trẻ em, cho bé từ 6 tuổi",223500,223500,0,0
TIKI,the-thao-da-ngoai,35544990,"Thảm Tập Yoga 2 Lớp 6mm + Gạch Tập Yoga + Bao Đựng Thảm Tập Yoga + Dây Thảm Tập Yoga miDoctor (màu ngẫu nhiên)",155000,155000,0,0
TIKI,the-thao-da-ngoai,99471750,"Bộ quần Áo Gym Nam Thun Lạnh Co Giãn 4 Chiều Thấm Hút Mồ Hôi,Đồ Tập Gym Nam Chất",215000,215000,0,0
TIKI,the-thao-da-ngoai,197628989,"Cần Câu Tay Ngọc Tiêu Kiếm 5H Cần Câu Đài Câu Đơn Carbon Cần Câu Cá Cao Cấp",195000,195000,0,0
TIKI,the-thao-da-ngoai,190354510,"Giày thể thao nam Anta Lifestyle Anta 812328063",700000,1359000,659000,48
TIKI,the-thao-da-ngoai,138461770,"BÓP TAY GỖ 2 cái",60000,60000,0,0
TIKI,the-thao-da-ngoai,126246559,"Lều Dã Ngoại Cắm Trại Du Lịch Tự Động 4-5 người, Chống Muỗi, Chống Nước, Chống Nắng Cao Cấp, Tự Bung TẶNG 2 GỐI HƠI",899000,899000,0,0
TIKI,thoi-trang-nam,73096116,"Áo Hoodie Nỉ Bông Unisex Streetwear Lục Lăng ( unisex nam nữ đều mặc được)",97000,97000,0,0
TIKI,thoi-trang-nam,77604572," Bộ Vest nam Hàn Quốc phong cách, mốt trẻ (áo vest + quần + cà vạt nơ)",550000,998000,448000,45
TIKI,thoi-trang-nam,149916600,"Quần đùi nam thể thao 3 sọc vải co dãn tốt mặc thoải mái loại quần đùi thể thao mặc cực bền (giao màu ngẫu nhiên) QD3S",32000,32000,0,0
TIKI,thoi-trang-nam,97930297,"Đồng phục đi biển, gia đình trái cây đủ size",45500,45500,0,0
TIKI,thoi-trang-nam,95063635,"quần thể thao nam nữ, quần thun lửng in hoa cúc đủ màu, quần short unisex nam nữ, quần lửng ulzzang đẹp, quần đùi nam nữ, quần thun nam ngắn mặc mát",89000,89000,0,0
TIKI,thoi-trang-nam,73255201,"Áo vest blazer Linen nam dáng lửng, chất vải linen tự nhiên mềm mại, thời trang phong cách lịch lãm - Trắng",320000,320000,0,0
TIKI,thoi-trang-nam,163677493,"Áo Sơ Mi Nam Dài Tay Công Sở Trung Niên Anton Xanh Caro Sợi Tre Thoáng Mát, Thấm Hút Mồ Hôi - AC130",325000,425000,100000,24
TIKI,thoi-trang-nam,66578126,"Áo vest Blazer Linen nam dáng lửng LAHstore, thời trang phong cách trẻ trung",320000,320000,0,0
TIKI,thoi-trang-nam,84826901,"Quần Sịp Nam Chữ V Nâng Mông Siêu Thoáng K367 - Đen,M",65000,65000,0,0
TIKI,thoi-trang-nam,7707600,"Quần short thun nam phối sọc hông Phúc An N0001 màu xám",63000,63000,0,0
TIKI,thoi-trang-nam,164081070,"TOKYO JAPAN, mã G27. Áo thun in chữ siêu đẹp, form unisex cho nam nữ, trẻ em. Áo phông GOKING hàng hiệu. Quà tặng cao cấp cho gia đình, cặp đôi, hội nhóm, doanh nghiệp",69000,69000,0,0
TIKI,thoi-trang-nam,78968320,"Áo vest nam Hàn Quốc giá chỉ 289K - DUKI STORE",285000,285000,0,0
TIKI,thoi-trang-nam,110813116,"Áo Khoác Big Size Nam Nữ Áo Khoác Kaki Bomber Nam Nữ Chống Nắng Chống Lạnh Chống Gió Chống Nóng Hai lớp Thời Trang FS Hàn Quốc Nam Tính Giá Rẻ Cao Cấp WK46 - ShopN6",199000,235000,36000,15
TIKI,thoi-trang-nam,20731450,"Áo khoác gió cách nhiệt GOKING có mũ, form unisex cho nam nữ. Ngoài vải dù, trong lót vải cào cách nhiệt. 3 túi to rộng. Hàng hiệu Việt Nam xuất khẩu",255000,255000,0,0
TIKI,thoi-trang-nam,50239323,"Quần bơi nam dáng lửng cao cấp",99000,99000,0,0
TIKI,thoi-trang-nam,72639228,"Áo Sơ Mi Nam Sọc Caro Phong Cách Hàn Quốc GOAT MENSWEAR",82000,82000,0,0
TIKI,thoi-trang-nam,169916705,"Viettien - Áo sơ mi nam dài tay ca rô 1N0527 form regular",475000,475000,0,0
TIKI,thoi-trang-nam,90078906,"Đồ bộ thể thao chất thun lạnh ETINONUC, Set Thể thao nam nữ, Đồ bộ thể thao mặc nhà etinonuc, Đồ bộ mặc nhà chất thun lạnh cá tính, BỘ QUẦN ÁO THỂ THAO BỘ ĐỒ NAM NỮ SIZE M L CHẤT THUN LẠNH, BỘ QUẦN ÁO THỂ THAO BỘ ĐỒ MẶC NHÀ / ĐỒ BỘ NAM NỮ / BỘ ĐỒ NAM NỮ -",99000,99000,0,0
TIKI,thoi-trang-nam,106700106,"Quần jean baggy Vonesa nam nữ ống rộng , dáng xuông , không phai màu Q2",115000,115000,0,0
TIKI,thoi-trang-nam,73101749,"Áo Hoodie Nỉ Bông Trơn Đủ Màu ( unisex nam nữ đều mặc được)",39000,39000,0,0
TIKI,thoi-trang-nam,90071296,"BỘ QUẦN ÁO THỂ THAO BỘ ĐỒ MẶC NHAD THỜI TRANG NAM NỮ",93000,93000,0,0
TIKI,thoi-trang-nam,167491747,"Áo Polo Nam 3 Màu Nanh Sói Phong Cách Thời Trang Thiết Kế AVIANO",129000,258000,129000,50
TIKI,thoi-trang-nam,35236973,"Combo 3 quần lót nam Freeman 6053 - Chất liệu thun lạnh cao cấp",240300,267000,26700,10
TIKI,thoi-trang-nam,43950321,"Áo Khoác Gió Thu Đông Nam Trung Niên 2 Lớp Cổ Bẻ",175000,175000,0,0
TIKI,thoi-trang-nam,21191213,"Áo Polo nam cổ bẻ ngắn tay, chất liệu cao cấp, thoáng mát, bền màu, thiết kế trẻ trung – FORMEN SHOP – FMPS086 - ĐEN - M",159000,239000,80000,33
TIKI,thoi-trang-nam,192208918,"Quần Short Nam Nhung Tăm 6 Màu Thiết Kế Thời Trang Cao Cấp AVIANO",149000,298000,149000,50
TIKI,thoi-trang-nam,73552931," Áo thun nam tay lỡ form rộng in nhiệt cực chất phong cách Hồng Kông",49000,49000,0,0
TIKI,thoi-trang-nam,183742098,"Áo Vest Nam ,Vest Nam Tay lỡ 2 lớp lót, Chất liệu cao cấp không xù, không nhăn. Trẻ trung mới lạ H48",309000,309000,0,0
TIKI,thoi-trang-nam,160609385,"Quần lót nam sexy STUD Jockstrap U1051BJS01",965000,965000,0,0
TIKI,thoi-trang-nam,85087342,"Áo sơ mi nam ngắn tay màu xanh navy vải không nhăn",108000,108000,0,0
TIKI,thoi-trang-nam,83617921,"Quần lót nam không viền may siêu mỏng túi lồi thoải mái",79000,79000,0,0
TIKI,thoi-trang-nam,77199974,"Quần đùi nam chất kate cotton thương hiệu Fezzio",59500,119000,59500,50
TIKI,thoi-trang-nam,57099959,"ÁO THUN NAM DÀI TAY",190000,190000,0,0
TIKI,thoi-trang-nam,71669337,"Áo thun nam tay dài",157000,157000,0,0
TIKI,thoi-trang-nam,2812943,"Áo Gió Thể Thao Nam Salomon Agile Jacket M - L39423900 Size",1440000,2400000,960000,40
TIKI,thoi-trang-nam,41216023,"Áo khoác chống nước, giữ ấm, 2 áo kết hợp trong 1, KTOM Mã K97 - Màu Navy",760000,760000,0,0
TIKI,thoi-trang-nam,233090408,"Áo thun polo nam cổ trụ bẻ chất vải cá sấu cotton dày dặn co giãn 4chiều size to 75kg đến 125kg",149250,149250,0,0
TIKI,thoi-trang-nam,72011248,"Quần Tây Hàn Quốc Vải Giản Ống Ôm - Màu Đen,32",84000,84000,0,0
TIKI,thoi-trang-nam,196382333,"Combo 4 quần lót nam boxer CITYMEN lưng Sọc vải thun lạnh 4 chiều - Giao màu ngẫu nhiên",160000,160000,0,0
TIKI,thoi-trang-nam,3058503,"Áo Sơ Mi Nam Cổ Tàu Form Rộng",199000,199000,0,0
TIKI,the-thao-da-ngoai,117064215,"Combo 3 Sản Phẩm Tập Yoga Tại Nhà - YOGA QG: 1 Vòng Tập Yoga Có Gai Massage Chuyên Dụng+ 2 Gạch Tập Yoga Trơn",355000,385000,30000,8
TIKI,the-thao-da-ngoai,158902907,"Võng Đôi Dã Ngoại Siêu Nhẹ Chống Lật Naturehike NH21DC011",350000,350000,0,0
TIKI,the-thao-da-ngoai,156023187,"bộ cần câu bút mini máy đứng máy ngang bộ cần câu bút máy đứng máy ngang",154815,154815,0,0
TIKI,the-thao-da-ngoai,57691365,"Xe đạp thể thao, máy đạp xe, xe đạp tập thể dục tại nhà GoodFit tùy chỉnh độ nặng, đồng hồ điện tử đo lường vòng đạp GF001PA",799000,1200000,401000,33
TIKI,the-thao-da-ngoai,196155333,"Set đồ tập yoga gym Hibi Sports H152 áo bra phối V, lưng xoắn nơ, kèm mút ngực",434000,620000,186000,30
TIKI,the-thao-da-ngoai,192562955,"Băng Keo Thể Thao Tự Dính, Băng Keo Quấn Cổ Chân, Băng keo Quấn Cổ Tay KUNOSPORT Cho Các Bộ Môn Thể Thao",15000,15000,0,0
TIKI,the-thao-da-ngoai,188458594,"Gậy Trekking Leo Núi Gấp Gọn Naturehike NH17D001-Z",198000,198000,0,0
TIKI,the-thao-da-ngoai,162421482,"Lều Cắm Trại Du Lịch Dã Ngoại, Lều Phượt Tự Bung 4 đến 6 người Chống Thấm Nước Chống Muỗi Gấp Gọn Tiện Lợi",659000,659000,0,0
TIKI,the-thao-da-ngoai,135202423,"[LOẠI XỊN TRẦN BÔNG] (FREE SHIP) Túi ngủ văn phòng du lịch cao cấp có trùm đầu - Chính hãng Amalife",186000,186000,0,0
TIKI,the-thao-da-ngoai,193321958,"Giày Thể Thao Nam - Nữ Biti's Hunter Core DSMH09400DEN (Đen)",715000,794000,79000,10
TIKI,the-thao-da-ngoai,197670955,"Bao tay đấm bốc trẻ em FREESHIP găng tay đấm bốc trẻ em, dành cho các bé từ 3 đến 10 tuổi, chất liệu bền bỉ thân thiện",109000,109000,0,0
TIKI,the-thao-da-ngoai,147209398,"Tạ Tay Thép King Box Loại 7.5KG",525000,525000,0,0
TIKI,the-thao-da-ngoai,202413356,"Vợt cầu lông LIGHTSPORT GY-GUANGYU Khung Carbon Căng Cước Sẵn - Màu Đen",399000,399000,0,0
TIKI,the-thao-da-ngoai,164434888,"Bình nước Muscletech 2.2 lít",149000,250000,101000,40
TIKI,the-thao-da-ngoai,147209390,"Tạ Tay Thép King Box Loại 15KG",1050000,1050000,0,0
TIKI,the-thao-da-ngoai,185710016,"Huy chương thể thao chất lượng giá rẻ",14000,20000,6000,30
TIKI,the-thao-da-ngoai,8271204,"Máy chạy bộ tại chỗ Mini Stepper BG Máy Chạy Bộ Điện Gia Đình Nhỏ Gọn Màn Hình Điện Tử (hàng nhập khẩu)",449000,799000,350000,44
TIKI,the-thao-da-ngoai,154942390,"Phao Câu Đài, Phao Câu Đơn, Phao Câu Cá Cao Cấp Giá Rẻ Đủ Màu",32000,32000,0,0
TIKI,the-thao-da-ngoai,113737638,"Xà Đơn Gắn Cửa ,Treo Tường Cải Tiến mới + Có Nivo cân bằng xà(Mẫu Đầu Vuông Siêu To)- 022",251000,518000,267000,52
TIKI,the-thao-da-ngoai,125603717,"Bộ Bóng Rổ Mini Cho Bé Tặng Kèm Móc Dán Treo Tường",48000,48000,0,0
TIKI,the-thao-da-ngoai,42820746,"Quần bơi nam Boxer YESURE  Chất liệu  polyester Spandex cao cấp , chống thấm , nhanh khô form Fitness thời trang (Tặng kèm nón bơi + bịt tai silicon)",133000,228000,95000,42
TIKI,the-thao-da-ngoai,161912607,"Tạ Tay Nhựa 10kg Bát Giác REEFIT (1 cái)",80000,80000,0,0
TIKI,the-thao-da-ngoai,43812290," Cần câu - Cần câu tay carbon siêu cứng 3m6  - Tặng Kèm nhiều phụ kiện DC08",199000,199000,0,0
TIKI,cross-border-hang-quoc-te,97372950,"Eyelash Curler With advanced Silicone Pressure Pad & Fits All Eye Shapes Get the Perfect Curl",135000,135000,0,0
TIKI,the-thao-da-ngoai,154951461,"Lưỡi Câu Cá Lưỡi Đài CJ SEIKO Có Ngạnh Siêu Khỏe",56200,56200,0,0
TIKI,the-thao-da-ngoai,33260595,"Thảm Yoga Training Fitness Adidas 10mm",1303000,1350000,47000,3
TIKI,the-thao-da-ngoai,48583619,"Giày lội nước dã ngoại chống trượt PAN Goinglink M-1888",348000,383000,35000,9
TIKI,cross-border-hang-quoc-te,176784883,"Multitool Knives Pliers Multifunctional Wire Cutter Survival Tool for Hiking",276000,276000,0,0
TIKI,cross-border-hang-quoc-te,179121866,"3pcs Waterproof Golf Head Cover Club Headcover Guard Sleeve",866000,866000,0,0
TIKI,cross-border-hang-quoc-te,78892405,"3pcs Black Double Pedal Patch for Bass Drum Percussion Instrument Accessories",222000,222000,0,0
TIKI,cross-border-hang-quoc-te,51226132,"Ladies Belly Dance Wrap Belt Gold Coins Tassel Hip Scarf Costume",227000,227000,0,0
TIKI,cross-border-hang-quoc-te,147483811,"MARVEL Chậu Cây Hình Nhân Vật Groot Trong Phim Vệ Binh Dải Ngân Hà",391239,391239,0,0
TIKI,cross-border-hang-quoc-te,101200797,"Travel Wet and Dry Cloth Diapers Wet Bags Waterproof Reusable",106000,106000,0,0
TIKI,the-thao-da-ngoai,157076949,"Giày Thể Thao Nam spost đế trơn chống trượt đi bộ thể dục dễ đi phù hợp 4 mùa k3",85491,89990,4499,5
TIKI,cross-border-hang-quoc-te,170625474,"Sách - Ninth House by Leigh Bardugo (UK edition, paperback)",408000,408000,0,0
TIKI,cross-border-hang-quoc-te,135098463,"1set Compact Guitar Repair Tools Kit Maintenance Tool Kit Maintenance Set",529000,529000,0,0
TIKI,cross-border-hang-quoc-te,115932998,"Dây Cáp Nguồn Cho Hp Elitedesk 600 800 400 G1 G2 Sff Sata 710825-002 / 710825-001",815596,815596,0,0
TIKI,the-thao-da-ngoai,75636087,"2 Hộp TENDOACTIVE - Thực phẩm Bảo vệ sức khỏe gân & dây chằng",765800,765800,0,0
TIKI,cross-border-hang-quoc-te,164295601,"ADF4351 OLED Display Development Board RF Professional 35M-4.4G Accurate Signal Generator Module USB Port Frequency",912000,912000,0,0
TIKI,cross-border-hang-quoc-te,98044227,"Cáp sạc đồng hồ thông minh cho Pebble Time với USB",122000,122000,0,0
TIKI,the-thao-da-ngoai,6475717,"Bật Lửa Zippo Black Ice (Dark Chrome) With Zippo Logo 150ZL",990000,990000,0,0
TIKI,cross-border-hang-quoc-te,99537939,"Waterproof Camping Backpack Rain Cover With Reflective Strip 30-40 L Yellow",104000,104000,0,0
TIKI,cross-border-hang-quoc-te,130089543,"Jaw Line Exerciser Face Facial Muscle Jaw Trainer Chew Beauty Fitness Equipment Face Training Fitness Ball",217472,217472,0,0
TIKI,the-thao-da-ngoai,118007740,"Giày đá bóng nam giày đá banh chính hãng AKKA SPEED 2",520000,690000,170000,25
TIKI,the-thao-da-ngoai,150945416,"Mồi nhái giả câu lure cá lóc Thái Lan - Mồi nhái giả SUPER FROG Thái Lan",14999,14999,0,0
TIKI,cross-border-hang-quoc-te,177281296,"Mosfet  for  883/1200 2014-2015 Replace 74700012",842000,842000,0,0
TIKI,cross-border-hang-quoc-te,99627099,"1pc White No Holes Sealed Single Coil Pickup Electric Guitar Pickups Accs",460000,460000,0,0
TIKI,cross-border-hang-quoc-te,94384257,"Office Computer Carpet Protector Chair Mat 1.5mm Thick PVC Mat 40x60cm",219000,219000,0,0
TIKI,cross-border-hang-quoc-te,116560117,"50x Tarp Clips Tarpaulin Clamps Holder Windproof Canopy Plastic Snap Grip",171000,171000,0,0
TIKI,cross-border-hang-quoc-te,101058690,"Fordable Soccer Training Hurdles Speed Agility Hurdle Football Hurdle Yellow",195000,195000,0,0
TIKI,cross-border-hang-quoc-te,177829782,"Elastic Tubular Bandages Retainer for Wound Dressing’s Restraint, Prevent Stretching, Breathable",178000,178000,0,0
TIKI,cross-border-hang-quoc-te,51205656,"Ultra Flat CAT6 RJ45 Patch Ethernet LAN Lead Network Retractable Cable",175000,175000,0,0
TIKI,cross-border-hang-quoc-te,175840992,"Professional Video Fluid Head Tripod Head with 1/4 Screws Release Plate",800000,800000,0,0
TIKI,cross-border-hang-quoc-te,181376976,"Thermostat Seal 2712000015 2712030575 Fit for Mercedes C180 C200 C230",252000,252000,0,0
TIKI,cross-border-hang-quoc-te,168145534,"128MB  for   2 PS2",213000,213000,0,0
TIKI,cross-border-hang-quoc-te,46340393,"Ngang Guitar/Bass Móc Treo Tường Móc An Toàn Treo Tường Giá Đỡ Slatwall Đen",251000,251000,0,0
TIKI,cross-border-hang-quoc-te,101854419,"Charming Garden Fairy Figurine Decoration Fountain Statue Ornament",198000,198000,0,0
TIKI,the-thao-da-ngoai,42825377,"Quần bơi nam Boxer YESURE SOC Chất liệu polyester Spandex cao cấp , chống thấm , nhanh khô form Fitness thời trang (Tặng kèm nón bơi + bịt tai silicon)",133000,228000,95000,42
TIKI,cross-border-hang-quoc-te,108603895,"Bàn đạp xe đạp ZTTO MTB hợp kim nhôm cao cấp, chống trượt-Màu tía",542000,542000,0,0
TIKI,the-thao-da-ngoai,136096156,"bóng rổ molten bằng da GG7x tiêu chuẩn Thi Đấu",239000,279000,40000,14
TIKI,cross-border-hang-quoc-te,94926698,"12V Waterproof Cigarette Lighter Power Socket Plug Outlet For Car Motorcycle",119000,119000,0,0
TIKI,cross-border-hang-quoc-te,51226734,"Adjustable Elbow Support Brace Tennis Golf Sports Neoprene Straps",218000,218000,0,0
TIKI,the-thao-da-ngoai,117625018,"Phao bơi chống lật không bơm hơi cho bé 3 tháng đến 2 tuổi",599000,1050000,451000,43
TIKI,cross-border-hang-quoc-te,122157480,"Iron Bike Hook Bicycle Holder Rack Stand Storage Wall Mount Garage Hanger",216000,216000,0,0
TIKI,the-thao-da-ngoai,170485945,"Vợt Tennis Head Speed Team L 2022 265g (233642)",4115000,4980000,865000,17
TIKI,cross-border-hang-quoc-te,177061791,"Slide on End Clasp Tubes Slider End Caps Slider Clasp for DIY Earrings Chokers Accessories",207000,207000,0,0
TIKI,cross-border-hang-quoc-te,120769363,"Golf Iron Headcover Club Head Cover Protection Sticker Closure Black+Red",449000,449000,0,0
TIKI,the-thao-da-ngoai,41823253,"Gậy Bóng Chày Hợp Kim miDoctor – Chọn Size - Kèm Túi Đựng gậy Bóng Chày – Màu Ngẫu Nhiên",200000,200000,0,0
TIKI,the-thao-da-ngoai,183531039,"[Mẫu mới ]Bộ quần áo bóng đá câu lạc bộ Barcelona 2023 - Áo bóng đá CLB Laliga",95000,150000,55000,37
TIKI,cross-border-hang-quoc-te,164494543,"2 Multi-Controller Joystick Button For Canon 5D Mark III Camera Repair Part",175000,175000,0,0
TIKI,the-thao-da-ngoai,118007639,"Túi rút thể thao túi dây rút AKKA",40000,40000,0,0
TIKI,cross-border-hang-quoc-te,113201930,"Cable Storage Box Case Power Strip Cord Wire Management Tidy Box",274000,274000,0,0
TIKI,cross-border-hang-quoc-te,113781201,"4 Heads Super Sonic Scrubber Cleaner Electric Brush House Dust Helper Kitchen",322329,322329,0,0
TIKI,cross-border-hang-quoc-te,11471619,"My Husband And I",400000,400000,0,0
TIKI,the-thao-da-ngoai,163812424,"Ghế Xếp Du Lịch, Dã Ngoại, Ngủ Trưa Văn Phòng Vải Oxford",850000,850000,0,0
TIKI,the-thao-da-ngoai,193610017,"Giày Thể Thao Nữ Biti's Hunter Core DSWH09400DEN (Đen)",596000,794000,198000,25
TIKI,cross-border-hang-quoc-te,96344508,"3.5'' IDE to Sata Hard Drive Adapter Converter HDD Parallel to Serial ATA",227000,227000,0,0
TIKI,cross-border-hang-quoc-te,55223103,"Silver Z Shape Boom Cymbal Arm for Drum Set Replacement Parts",220000,220000,0,0
TIKI,cross-border-hang-quoc-te,210446642,"Dụng Cụ Tách Lõi Táo/ Lê/ Táo Tàu/ Mận, v...v.. Đường Kính 1cm. - Dụng Cụ Tách Lõi Hoa Quả DUASHOP",198000,198000,0,0
TIKI,cross-border-hang-quoc-te,173738558,"Golf Travel Plane Bags, Wheeled Golf Travel Cover Case with Adjustable Shoulder Straps, Golf Travel Bag for Airlines",645000,645000,0,0
TIKI,the-thao-da-ngoai,19700091,"Combo 4 Bánh Đèn Led Đơn Sắc (Màu Ngẫu Nhiên)",140000,140000,0,0
TIKI,the-thao-da-ngoai,149585251,"Hạ Lóng Cần Tay CHIXUAN Đại Lý Đồ Câu Cá Chất Liệu Hợp Kim Nhôm Chống Gỉ Sét Chuyên Dụng Câu Đài",55100,55100,0,0
TIKI,the-thao-da-ngoai,138701224,"Phao Câu Cá",3400,3400,0,0
TIKI,the-thao-da-ngoai,10784674,"Ghế xếp du lịch, dã ngoại cao cấp ( GX01 )",100000,100000,0,0
TIKI,the-thao-da-ngoai,196853380,"Dụng Cụ Tập Cơ Hàm Mặt Nâng Cơ Mặt Làm Săn Chắc Da",22000,22000,0,0
TIKI,the-thao-da-ngoai,148570091,"cước câu cá cước trục thẻo 3D tàng hình 100m NANO",22100,22100,0,0
TIKI,the-thao-da-ngoai,198326138,"đai chống gù lưng cao cấp mi01 - Chính hãng DoDoDios",249000,249000,0,0
TIKI,the-thao-da-ngoai,139919299,"Cước Câu Cá 500m của Mỹ Trilene Big Game đủ size siêu bền chống sờn hàng cao cấp",59499,59499,0,0
TIKI,the-thao-da-ngoai,156013691,"Chuông Báo Cá Điện Tử Gắn Đèn LED Báo Động Cá Cắn Câu PK15 đồ câu FISHING_HD",30900,30900,0,0
TIKI,the-thao-da-ngoai,163780335,"Lưỡi Lục Đồng Đúc Hàng Thửa Cao Cấp - Đồ Câu DULI",38000,38000,0,0
TIKI,the-thao-da-ngoai,193760886,"Quần Jogger Nam Thể Thao - Thương Hiệu X9 - Tập Gym Chạy Bộ Đi Chơi Cotton Co Giãn - X007",720000,720000,0,0
TIKI,the-thao-da-ngoai,189476021,"Lều thú tự bung có kèm túi đựng gấp gọn- Lều cho bé vui chơi trong nhà- Cắm trại ngoài trời- Kích thước 86*96*182",240000,240000,0,0
TIKI,the-thao-da-ngoai,68375583,"Lưới tập đánh golf di động 3M-LXW013: Thiết kế mới với 3 lỗ đục, hai màu lựa chọn",800000,950000,150000,16
TIKI,the-thao-da-ngoai,23442506,"Bộ Nhảy Dây Tập Thể Dục - Giao màu ngẫu nhiên",32998,32998,0,0
TIKI,the-thao-da-ngoai,149628951,"Hộp bộ phao câu đài kèm phao và phụ kiện câu đài- cần tay_hộp phao xanh+tặng kèm phao câu đêm",105733,105733,0,0
TIKI,the-thao-da-ngoai,95195162,"Thảm tập yoga, tập gym 2 lớp TPE cao cấp chống trượt 6MM không bám mùi - giao màu ngẫu nhiên",103950,142065,38115,27
TIKI,the-thao-da-ngoai,12000549,"Bảo Hộ Tay Chân Trẻ Em Chính Hãng Cougar",155000,155000,0,0
TIKI,the-thao-da-ngoai,172075918,"Máy tập phục hồi chức năng 4 trong 1 (4 IN1) cho người tai biến",3149000,3149000,0,0
TIKI,the-thao-da-ngoai,127120578,"Cầu đá cao cấp Hải đông",40000,40000,0,0
TIKI,the-thao-da-ngoai,812325,"Túi Đựng Cho Thảm Yoga Từ Sportslink (8mm) - Chấm Bi Đen",54000,60000,6000,10
TIKI,the-thao-da-ngoai,262726083,"Băng Khuỷu Tay bóng chuyền, cầu lông, Đôi Băng bảo vệ tay chính hãng Aolikes 7146 (1 đôi) magic",46700,46700,0,0
TIKI,the-thao-da-ngoai,140951541,"Bàn gấp dã ngoại NH19Z027-Z phù hợp du lịch dã ngoại, cắm trại, câu cá",775000,775000,0,0
TIKI,the-thao-da-ngoai,195968541,"Ba lô leo núi Sportslink - 68L",627000,690000,63000,9
TIKI,the-thao-da-ngoai,42832927,"Bình nước chạy bộ, dã ngoại, đạp xe Rimix 3302 (2 Lít)",139000,215000,76000,35
TIKI,thoi-trang-nam,29616695,"Áo sơ mi nam cổ trụ chui đầu dài tay",159000,159000,0,0
TIKI,the-thao-da-ngoai,196280275,"Máy Phát Hiện Nói Dối Gian Xảo Polygrapha ",184000,184000,0,0
TIKI,the-thao-da-ngoai,243032258,"Gậy vẩy mồi câu cá chất liệu cacbon  siêu nhẹ",69000,69000,0,0
TIKI,thoi-trang-nam,119396619,"Quần Tây Beggi Kẻ Caro VitinoVic 399 - Cạp - Quần Âu Nam - Lim Wen",245000,245000,0,0
TIKI,the-thao-da-ngoai,138713408,"Bịch 20 Hạt Chặn Phao Câu Cá",3400,3400,0,0
TIKI,the-thao-da-ngoai,9972345,"Quần dài Jogger thể thao nữ tập gym yoga Angel01 xám",249000,249000,0,0
TIKI,the-thao-da-ngoai,160872466,"Túi đựng điện thoại Túi chạy bộ Túi đeo hông Túi đựng bình nước chạy bộ Túi đeo bình nước Túi đeo điện thoại thể thao ye",60000,60000,0,0
TIKI,the-thao-da-ngoai,126509392,"CẦU ĐÁ CAO CẤP số 1",55000,55000,0,0
TIKI,the-thao-da-ngoai,139941935,"Chuông báo cá đẹp",1200,1200,0,0
TIKI,thoi-trang-nam,21972366,"Quần jogger kaki nam phong cách lính New arrival 05",175000,175000,0,0
TIKI,thoi-trang-nam,103573520,"Áo khoác chống nắng nam vải cotton mềm mại",80000,80000,0,0
TIKI,thoi-trang-nam,75404518,"Áo khoác kaki nam phong cách",249000,249000,0,0
TIKI,thoi-trang-nam,197352209,"Áo polo ngắn tay nam, chất thun poly mềm mịn co giãn 4 chiều, họa tiết phối màu trẻ trung - FORMEN SHOP - FMPS195",189000,350000,161000,46
TIKI,the-thao-da-ngoai,101323855,"Bộ 2 sản phẩm bình lắc shake bottle và hộp đựng whey ishake protein funnel ON Gold Standard",69000,69000,0,0
TIKI,the-thao-da-ngoai,45597085,"Giày Đá Bóng Vải TL Cỏ Nhân Tạo - Trắng",89000,89000,0,0
TIKI,thoi-trang-nam,7078819,"Bộ 5 Quần Lót Nam Nhật Thông Hơi Cao Cấp (Giao Màu Ngẫu Nhiên) - XL (chéo có hộp MJ)",58998,58998,0,0
TIKI,thoi-trang-nam,106857000,"QUẦN THỂ DỤC HỌC SINH - Xanh đen,Size 5( 27-30kg)",54000,54000,0,0
TIKI,thoi-trang-nam,77626708,"Áo đũi nam cổ bổ trụ 5 khuy tay cộc, thời trang trẻ, phong cách Hàn",179000,179000,0,0
TIKI,the-thao-da-ngoai,127120536,"Cầu đá cao cấp - số 1",55000,55000,0,0
TIKI,thoi-trang-nam,35193626,"[FREEMAN] Combo 3 Quần lót nam 6051 - Quần dệt cao cấp",357600,447000,89400,20
TIKI,thoi-trang-nam,82643089,"Áo Sơ Mi Nam Dài Tay Sọc Ngang Bảng To PONIVA",157000,157000,0,0
TIKI,thoi-trang-nam,44271125,"Áo khoác da cho nam cao cấp J09",365000,365000,0,0
TIKI,thoi-trang-nam,12108954,"Áo Khoác Da Nam Đen Lót Lông Cao Cấp ShopN6 AKD06",275000,425000,150000,35
TIKI,thoi-trang-nam,84774634,"áo thun 100% COTTON cổ tròn mềm mịn, thấm hút tốt",38000,38000,0,0
TIKI,thoi-trang-nam,119639482,"Quần tây nam việt tiến màu đen có 1ly regular 495",495000,495000,0,0
TIKI,thoi-trang-nam,117918685,"Áo cotton nam nữ unisex phông tay lỡ ulzzang thun đen cotton oversize form rộng in hình cool ngầu VISA",55000,55000,0,0
TIKI,the-thao-da-ngoai,217519103,"Khăn choàng tắm , đi biển , đi bơi có mũ trùm , hình ngộ nghĩnh , màu sắc tươi sáng",79000,79000,0,0
TIKI,thoi-trang-nam,155701494,"Viettien - Quần jeans nam smart casual regular fit 6Q7119",720000,720000,0,0
TIKI,thoi-trang-nam,131396456,"Áo khoác bomber gió chữ R trắng in hình họa tiết cực nổi nam nữ mặc cực chất,, Áo Khoác Dù BomBer Phối Cúc Bấm Thời Trang in Họa Tiết Trẻ Trung Năng Động",99000,99000,0,0
TIKI,the-thao-da-ngoai,138711658,"(Combo 5 Chiếc) Chân Cắm Phao Câu Cá Dùng Cho Câu Đơn, Đài Có Khóa Link",6700,6700,0,0
TIKI,thoi-trang-nam,196686994,"Viettien - Áo sơ mi nam dài tay kẻ sọc 1Q0511 fom regular - Áo sơ mi nam công sở Việt Tiến",580000,580000,0,0
TIKI,thoi-trang-nam,10047542,"Bộ 4 Quần Boxer Nam Chất Lụa",98000,98000,0,0
TIKI,thoi-trang-nam,83617770,"Quần ngủ nam lưới sexy thoáng mát có miếng lót nâng đỡ bên trong - Quan ngu luoi nam",99000,99000,0,0
TIKI,thoi-trang-nam,15055025,"Áo Sơ Mi Nam Ngắn Tay SMH77 - SMH77",180000,180000,0,0
TIKI,the-thao-da-ngoai,172573862,"Báo động cá cắn câu V3",100000,100000,0,0
TIKI,thoi-trang-nam,31202082,"Quần tây nam không ply ống đứng Khatoco Q1M528R0-CNMA033-2105-0",422400,528000,105600,20
TIKI,thoi-trang-nam,78020771,"Quần ống suông kaki nam trung niên chất vải dày mềm mịn co giãn hàng xuất khẩu quần dài kaki cao cấp bền đẹp có nhiều màu nhiều size 50- 85kg",165000,165000,0,0
TIKI,thoi-trang-nam,191657786,"Áo polo nam slimfit BLOOK Vải thun cotton thêu logo đơn giản 33086 (HÌNH THẬT)",469000,469000,0,0
TIKI,thoi-trang-nam,35536468,"Áo len nam cổ lọ BS29D",250000,250000,0,0
TIKI,thoi-trang-nam,197139408,"Áo khoác gió 2 lớp cao cấp chống nắng, chống nước thiết kế phối sọc trẻ trung - FORMEN SHOP - FMTHT051",179000,350000,171000,49
TIKI,thoi-trang-nam,198536564,"Viettien - Áo sơ mi nam dài tay màu xanh đen 1R0412 vải có hoa văn ca rô chìm form regular",710000,710000,0,0
TIKI,the-thao-da-ngoai,172668957,"Quần lửng Minatex nâng mông chất đẹp 3 màu tập gym yoga chạy bộ",148000,148000,0,0
TIKI,thoi-trang-nam,152882456,"Quần tây nam đen và xanh than, ống đứng, form truyền thống, không ly, phong cách công sở, big size tới 100kg",209000,309000,100000,32
TIKI,thoi-trang-nam,129451322,"Áo Khoác Nam Nữ Hoodie Gấu - In Phản Quang 7 Màu From Unisex, Áo khoác hoodie phản quang Gấu Teddy, Áo Hoodie Crush Thỏ/Gấu - Thỏ Bảy Màu, áo hoodie ulzzang nam nữ đều mặc được",129000,129000,0,0
TIKI,thoi-trang-nam,140865500,"Áo khoác Hoodie Nam, Hoodie Basic Unisex Nỉ From Rộng NÓN 2 LỚP PHẢN QUANG 7 MÀU, Áo khoác Nỉ form rộng HÀN QUỐC,có nón và dây kéo HOODIE ZIP, 7 MÀU kiểu dáng UNISEX NAM NỮ",129000,129000,0,0
TIKI,thoi-trang-nam,97932647," ĐỒ BỘ TRÁI CÂY ĐI BIỂN, NHIỀU MẪU TƯƠI SÁNG",75000,75000,0,0
TIKI,thoi-trang-nam,73105039,"áo sơ mi nam thời trang",144000,144000,0,0
TIKI,thoi-trang-nam,191474727,"Áo sơ mi măng sét trắng Anlimen Cuff Shirt - AGS02",790000,790000,0,0
TIKI,the-thao-da-ngoai,101324171,"Bình lắc 3 ngăn bình nước thể thao Spider Bottle - màu Đỏ",89000,89000,0,0
TIKI,thoi-trang-nam,105644329,"áo khoác dù bomber đầu lâu hot trend, ÁO KHOÁC DÙ BOMBER CỰC HOT, áo khoác bóng chày hàn quốc, áo khoác bomber chữ K, áo bomber jacket kill system, áo khoác dù đẹp, áo bomber unisex from rộng phong cách ullzang",99000,99000,0,0
TIKI,thoi-trang-nam,155763970,"Áo len nam May 10 mã 200119453ON Bộ đội-129",129000,129000,0,0
TIKI,the-thao-da-ngoai,140961662,"Vèo nuôi cá, ếch - Không nắp - 2x1, Cao 1 mét",89380,109000,19620,18
TIKI,thoi-trang-nam,86378916,"ÁO BA LỖ NAM, TRẮNG TRUYỀN THỐNG CAO CẤP",24000,24000,0,0
TIKI,thoi-trang-nam,107962165,"Quần sịp nam xuất EU thun lạnh kháng khuẩn cao cấp TG",8500,8500,0,0
TIKI,thoi-trang-nam,162097090,"QUẦN KAKI NAM TÚI MỸ DÁNG SUÔNG",150000,150000,0,0
TIKI,thoi-trang-nam,179746796,"Simple Box - 2 Áo ba lỗ nam, 3 quần lót nam Boxer, 5 đôi tất cao cấp MRM Manlywear",499000,699000,200000,29
TIKI,the-thao-da-ngoai,149635797,"{Xả kho} máy câu cá yomoshi AL 3000-7000",45200,45200,0,0
TIKI,the-thao-da-ngoai,169731291,"Set đồ tập yoga - tập gym PYM Sports - PYMS005 áo croptop tay lửng buộc vạt sau eo, quần dáng alibaba - 2 màu đen và đỏ",225000,450000,225000,50
TIKI,the-thao-da-ngoai,33789344,"Bộ Ván trượt mặt nhám cỡ nhỏ trẻ em + Kèm bộ bảo hộ (Giao màu ngẫu nhiên)",269000,400000,131000,33
TIKI,the-thao-da-ngoai,127201377,"HỘP QUẸT BẬT LỬA Z660 HỘP QUÀ CAO CẤP",264000,264000,0,0
TIKI,the-thao-da-ngoai,148925566,"CẦN CÂU CÁ 8h  HAN-DING",305495,305495,0,0
TIKI,the-thao-da-ngoai,117391753,"cần câu tay xích long 6H catbon tặng ngọn phụ",161000,161000,0,0
TIKI,the-thao-da-ngoai,107034349,"Vòng treo gỗ Gymnastic Rings Cleacco có vạch kẻ số , khóa cài thông minh tiện lợi , chắc chắn treo xà đơn , các bài tập dip rings , street workout , bảo hành 12 tháng - BORO SPORT",499000,799000,300000,38
TIKI,the-thao-da-ngoai,97883098,"Áo tập gym nữ, áo tanktop phối lưới lưng siêu đẹp (TY)",125000,125000,0,0
TIKI,the-thao-da-ngoai,69307352,"Quần short nam thể thao đồ gym thun cotton 4 chiều, quần đùi nam mặc nhà thể thao cao cấp ShopN6 - QSB2 (Nhiều Màu)",59000,105000,46000,44
TIKI,the-thao-da-ngoai,45777072,"Combo Bao trụ đấm bốc tự đứng thế hệ mới + Găng tay đấm bốc mma hở ngón cao cấp - Thiết bị tập đấm bốc chuyên nghiệp dành cho boxing, mma, muay, sparring, trainning, và đối kháng",1700000,1700000,0,0
TIKI,the-thao-da-ngoai,163741693,"Túi Đựng Cần Câu Gấp Gọn Túi Đựng Cần Câu Có Túi Phụ, Đồ ĐỰng Cần Câu Cá",45000,45000,0,0
TIKI,the-thao-da-ngoai,67240015,"Bộ Dây Cao Su Đàn Hồi Ngũ Sắc Tập Gym Tại Nhà Móc To (Tặng kèm Kìm Bóp Cơ Tay) Bộ Dây Kháng Lực Tập Thể Hình Ngẫu Nhiên Dành Cho Mọi Đối Tượng Dễ Dàng Sử Dụng Có Hướng Dẫn Đi Kèm",195000,209000,14000,7
TIKI,the-thao-da-ngoai,140744653,"100 Quả Bóng Bàn Tập Luyện Hueison / Loki 3 sao 40+ - Hàng Chính Hãng",180000,180000,0,0
TIKI,the-thao-da-ngoai,160744859,"Giày Chạy Bộ Nam Biti's Hunter Running TIGER DSMH08300CAM (Cam)",903000,981000,78000,8
TIKI,the-thao-da-ngoai,100270977,"Lưỡi Câu Cá Titan 7 Màu CJF Có Ngạnh Đuôi Dẹp siêu cứng, siêu bén",45000,45000,0,0
TIKI,the-thao-da-ngoai,52247278,"Áo tập Yoga Gym croptop 2 dây đan chéo Hibi Sports Mã CR806 có mút nâng ngực bên trong",182000,260000,78000,30
TIKI,the-thao-da-ngoai,21388705,"Túi Đai Đeo Bụng Chạy Bộ Chống Nước Có Dải Phát Quang",32670,47190,14520,31
TIKI,the-thao-da-ngoai,165640986,"Móc Khóa Kèm Dao Mini Có Túi Đựng",55000,59000,4000,7
TIKI,the-thao-da-ngoai,76753500,"Bảng Dụng Cụ Tập Hít Đất , Tập Chống Đẩy Theo Màu Sắc, Mỗi Màu Sắc Sẽ Tương Ứng Với Bài Tập Khác Nhau Thiết Kế Dày Nhiều Bài Tập - Hàng Chính Hãng BORO SPORT",164000,389000,225000,58
TIKI,the-thao-da-ngoai,118324307,"Phao bơi naturehike đồ cắm trại thể thao du lịch kiêm túi tắm chống nước phao hồ bơi campout A070",550000,550000,0,0
TIKI,the-thao-da-ngoai,117391128,"máy câu cá yomoshi.máy câu LC7000 .máy câu cá yomoshi LC-7000",139000,139000,0,0
TIKI,the-thao-da-ngoai,186748592,"[HÀNG CÓ SẴN][CAIRBULL] Nón Bảo Hiểm Xe Đạp Thoáng Khí Dành Cho Nam Nữ Đạt Tiêu Chuẩn, An Toàn, Chất Lượng Chính Hãng_Rubik/Mũ Bảo Hiểm Đi Xe Đạp Leo Núi Chuyên Nghiệp",330000,550000,220000,40
TIKI,the-thao-da-ngoai,117002169,"Dây Kéo Đàn Hồi Tập Tay Vai Hình Số 8 - YOGA QG, Chất Liệu Cao Su Dẻo Dai, Đàn Hồi Tốt, Giúp Bạn Có Một Cơ Thể Cân Đối, Khỏe Mạnh",33000,44900,11900,27
TIKI,thoi-trang-nam,159100290,"Áo sơ mi nam Oscar tay ngắn - OCMSCSF 046",349000,1990000,1641000,82
TIKI,the-thao-da-ngoai,2066915,"Viên sủi điện giải  -  Hammer  Nutrition Endurolytes Fizz Vị  Chanh HM299",179000,179000,0,0
TIKI,cross-border-hang-quoc-te,168666676,"Sách - Deep Work : Rules for Focused Success in a Distracted World by Cal Newport (UK edition, paperback)",589000,589000,0,0
TIKI,thoi-trang-nam,46688721,"Áo Khoác Da Bomber Nam",175000,175000,0,0
TIKI,the-thao-da-ngoai,163863432,"Cước Câu Cá Tàng Hình Nylon CF Dây Câu Cá 500m Siêu Bền, Dây Dù Câu Cá",143100,143100,0,0
TIKI,the-thao-da-ngoai,103209804,"Vợt Cầu Lông Cán Liền Chính Hãng Agnite - Khung Carbon Cao Cấp - Kèm Túi Đựng Vợt - F2115",359000,790200,431200,55
TIKI,cross-border-hang-quoc-te,230195629,"Bộ Chuyển Đổi M2 SSD SATA Chassis M.2 Sang USB 3.0 SSD Cho NGFF SATA / B Key",279680,279680,0,0
TIKI,thoi-trang-nam,181136946,"Áo sơ mi nam Slim fit ngắn tay xanh cổ vịt 171424N",445550,469000,23450,5
TIKI,the-thao-da-ngoai,91750863,"Máy Chạy Bộ,Máy Đi Bộ Trên Không Cỡ Lớn DNS008 Đại Nam Sport Chịu Lực 150kg Hàng Việt Nam Chất Lượng Cao",1399000,2000000,601000,30
TIKI,thoi-trang-nam,125355106,"Áo sơ mi đoàn thanh niên nam nữ dài tay Ocean Uniform hàng thường",75000,75000,0,0
TIKI,thoi-trang-nam,81825319,"Quần đùi nam mặc ở nhà quần thun lạnh mềm mát hút mồ hôi tốt size 50-80kg",28000,28000,0,0
TIKI,thoi-trang-nam,84750552,"QUẦN LÓT BOXER NAM ROSSO 0002 - UNDERWEAR",120000,120000,0,0
TIKI,cross-border-hang-quoc-te,253491858,"2Pcs Piano Finger Trainer Finger Pressing Tool for Practicing Training",396000,396000,0,0
TIKI,thoi-trang-nam,74037420,"Áo khoác da nam , áo da nam . áo khoác nam",155000,155000,0,0
TIKI,the-thao-da-ngoai,154944451,"ô dù câu cá 1m8 xoay 360° cao cấp",147346,147346,0,0
TIKI,thoi-trang-nam,195305781,"Combo 3 quần đùi mặc nhà - Giao màu ngẫu nhiên",270750,285000,14250,5
TIKI,the-thao-da-ngoai,2282609,"Bộ Đá Và Bấc Cho Bật Lửa Zippo",90000,90000,0,0
TIKI,cross-border-hang-quoc-te,101158710,"Memory Foam Mouse Wrist Rest Pad Slow Rising Silicone Gel Wrist Support Mat for Gamers, White Collars, Programmers-Gray",107000,107000,0,0
TIKI,thoi-trang-nam,20518200,"Quần Kaki Nam Khatoco Q2M528S0-VNMA007-1811-0003",199000,528000,329000,62
TIKI,cross-border-hang-quoc-te,93558306,"4pcs Large Seam Ripper Lot Handy Stitch Ripper for DIY Crafts Sewing Tools",117000,117000,0,0
TIKI,thoi-trang-nam,63037905,"Áo khoác gió cách nhiệt GOKING có mũ, form unisex cho nam nữ. Ngoài vải dù, trong lót vải cào cách nhiệt. 3 túi to rộng",255000,255000,0,0
TIKI,the-thao-da-ngoai,149618003,"Phao Câu Đài_ Bộ 3 Phao Câu Đài Nano_ Phao Kim Câu Cá",54000,54000,0,0
TIKI,cross-border-hang-quoc-te,115285272,"Bộ lọc dầu bằng thép không gỉ Bộ lọc dầu ăn gia đình có nắp đậy-Size Tay cầm 410 & 1.3L & PP",190000,190000,0,0
TIKI,the-thao-da-ngoai,273868091,"Sữa Tăng Cân Labrada Muscle Mass Gainer 12Lbs (5.4kg), Hỗ Trợ Tăng Cân Tăng Cơ Nhanh",1595000,1920000,325000,17
TIKI,thoi-trang-nam,150184854,"( Sale 30%)Quần tây nam màu đen mix kẹp vuông phom hàn chuẩn, chất vải chéo cao cấp dáng ôm body.quần tây rẻ, bền",109000,109000,0,0
TIKI,thoi-trang-nam,169332884,"Áo chống nắng nam mặc 2 mặt thun lạnh lỗ kim thoáng mát, thấm hút mồ hôi mẫu mới Micado",250000,250000,0,0
TIKI,cross-border-hang-quoc-te,95874719,"Foam Supportive Bed Wedge Pillow Orthopedic Positioning Elevation Cushion",354000,354000,0,0
TIKI,cross-border-hang-quoc-te,110300237,"Bộ chuyển đổi mô-đun Asus UX31 UX21 XM11 SSD sang SATA III",126000,126000,0,0
TIKI,cross-border-hang-quoc-te,170705019,"Sách - Where Are the Customers' Yachts? : or A Good Hard Look at Wall Street by Fred Schwed (US edition, paperback)",556000,556000,0,0
TIKI,cross-border-hang-quoc-te,147525512,"(Hàng Mới Về) 1 Cặp Dụng Cụ Silicone Điều Chỉnh Ngón Chân Cái",207000,207000,0,0
TIKI,the-thao-da-ngoai,139912196,"Mồi giả ruồi nhỏ chuyên câu cá rô cá lóc cá chuối  cá thiểu  cá chim",21660,21660,0,0
TIKI,cross-border-hang-quoc-te,93542824,"Pack of 12 Plaid Pattern Handkerchiefs Soft Square Pocket Towel for Men",182000,182000,0,0
TIKI,the-thao-da-ngoai,156039630,"Bộ cần câu tay trúc nâu dài 2m7, 3m6, 4m5, 5m4, 6m3 kèm đủ phụ kiện",86120,86120,0,0
TIKI,thoi-trang-nam,54762167,"Quần kaki nam không ply Khatoco Q2M528R0-INMA009-2107-0",199000,528000,329000,62
TIKI,the-thao-da-ngoai,36710696,"Móc khoá đa năng tiện ích",98000,98000,0,0
TIKI,the-thao-da-ngoai,194864438,"[Chính hãng] OstroVit BCAA Instant (400g) Hỗ trợ phục hồi - Chống dị hóa - Giảm đau nhứt cơ",420000,420000,0,0
TIKI,cross-border-hang-quoc-te,95756586,"Waterproof Golf Club Blade Putter Head Cover Magnetic  Protector",356000,356000,0,0
TIKI,thoi-trang-nam,117921774,"Áo thun nam nữ unisex tay lỡ phông form rộng teen cổ tròn oversize cotton giá rẻ basic đen trắng tee pull 1997",38000,38000,0,0
TIKI,cross-border-hang-quoc-te,170675232,"Sách - Bond 11+: Non-verbal Reasoning: Assessment Papers : 11+-12+ years Book 2 by Nic Morgan (UK edition, paperback)",379000,379000,0,0
TIKI,cross-border-hang-quoc-te,94303573,"4FT USB Charger Charging Power Cable Cord For Nintendo WII U Gamepad Controller",128000,128000,0,0
TIKI,thoi-trang-nam,30030737,"Quần Khaki Nam Không Ply Ống Ôm Khatoco Q2M528S0-VNMA002-1811-0004",199000,528000,329000,62
TIKI,cross-border-hang-quoc-te,98109361,"USB to RCA Cable1.5m USB Male to 3 RCA Male Jack Splitter AV Adapter Cable",144000,144000,0,0
TIKI,cross-border-hang-quoc-te,230324493,"Ổ cứng MSATA - USB 3.0 SSD vỏ nhôm kèm phụ kiện",291666,291666,0,0
TIKI,cross-border-hang-quoc-te,171046655,"Dog Training Collar with Remote with Beep Vibration Shock Flashlight Dog Shock Collar for Small Medium Large Dogs",516000,516000,0,0
TIKI,thoi-trang-nam,19395506,"Quần tây âu nam dáng ôm vải co giãn nhẹ bền đẹp phong cách Hàn Quốc - Đen - 32",80000,80000,0,0
TIKI,thoi-trang-nam,21601483,"Combo 4 quần lót nam quần sịp tam giác nam đúc tàng hình cao cấp",319000,319000,0,0
TIKI,cross-border-hang-quoc-te,174576054,"Wireless Mini Keyboard Mouse Multi-media Remote Control for PC",206000,206000,0,0
TIKI,cross-border-hang-quoc-te,112401140,"Quạt Tản Nhiệt Cpu Máy Tính Asus F3J A8 A8J Z99 X80 N80 F8S Z53 M51 4 Pin Gc056015Vh-A 13.1.b2433f.n 5v 3w",283619,283619,0,0
TIKI,cross-border-hang-quoc-te,180294580,"Pet Dog Training Shock Collar Anti-Bark Vibration Collar Bark Trainer",731000,731000,0,0
TIKI,cross-border-hang-quoc-te,120766947,"Multimeter Tester 6000 Counts AC/DC Voltage Meter Pen",424000,424000,0,0
TIKI,thoi-trang-nam,155147237,"QUẦN KAKI NAM TÚI HỘP MÀU LÍNH",180000,180000,0,0
TIKI,cross-border-hang-quoc-te,98571770,"Túi Đựng Nước Tiện Dụng Dung Tích 2L Có Thể Gập Lại Cho Đi Xe Chạy Bộ Leo Núi",182200,182200,0,0
TIKI,thoi-trang-nam,83377872,"Quần Bò Nam cao cấp thương hiệu Chandi, chất jean co dãn mẫu mới nhất MA195",194000,289000,95000,33
TIKI,thoi-trang-nam,121635925,"Áo Khoác Nam Cách Nhiệt Vải Kaki Cao Cấp US ARMY U559, Áo Khoác Kaki Lính Lót Bông Cừu Siêu Ấm Phong Cách Cực Ngầu  -HÀNG CHÍNH HÃNG",520000,1198000,678000,57
TIKI,cross-border-hang-quoc-te,159427816,"AMAZFIT Dây Đeo Silicon Cho Đồng Hồ Thông Minh Huami Amazfit Gtr 42mm 47mm GTR2 GTR 2e GTR 3 pro",220000,220000,0,0
TIKI,thoi-trang-nam,106700331,"Quần Jean Nam Vovesa Mẫu Mới, Dáng Ôm Trẻ Trung, Nam Tính Q3",99000,99000,0,0
TIKI,thoi-trang-nam,87895026,"Bộ bơi nam họa tiết da cá, phom dáng đẹp ôm sát người, chất thun bơi dày đẹp, ít thấm nước, mau khô | BN010",350000,350000,0,0
TIKI,cross-border-hang-quoc-te,109164824,"Dụng cụ sửa xe đạp đa năng WEST BIKING-Màu vàng",192000,192000,0,0
TIKI,thoi-trang-nam,73915026,"Áo thun nam tay dài mặc thu đông giữ nhiệt chất cotton, áo giữ nhiệt nam co giãn, 5 màu lựa chọn, size áo từ 40-80kg, không bị bai xù khi giặt máy",94000,94000,0,0
TIKI,thoi-trang-nam,80885842,"Quần Đùi Nam Kaki 6 Màu Trẻ Trung Phong Cách Hàn Quốc VICERO",159000,238000,79000,33
TIKI,cross-border-hang-quoc-te,186366168,"Scalp Applicator Comb for Medicine Scalp Head Fluid Comb Essential Oil Hair Treatment Device Hair Scalp Massager Brush",314000,314000,0,0
TIKI,thoi-trang-nam,131906300,"Áo Thun Tay Lỡ Freesize Nam Nữ 40-70kg",31000,31000,0,0
TIKI,cross-border-hang-quoc-te,113937943,"Cửa trượt dành cho vật nuôi, có khóa từ tính, tự động cho chó lớn, vừa",567400,567400,0,0
TIKI,thoi-trang-nam,197656502,"Quần  đũn EF34234560---545 jh hjk",20000,20000,0,0
TIKI,cross-border-hang-quoc-te,113938697,"Jebao Doser Dosing Pump Titration Pump Automatic Doser 3.4WiFI Auto Dosing Pump for Saltwater Aquarium Plant Feeding",869800,869800,0,0
TIKI,the-thao-da-ngoai,103209960,"[TẶNG 3 CẦU + QUẤN CÁN] Vợt cầu lông siêu nhẹ Agnite tặng kèm hộp cầu và túi đựng vợt - 2 chiếc - F2136",466200,466200,0,0
TIKI,thoi-trang-nam,109150516,"Quần thun jogger logo in không bong tróc chất thun da cá mềm mịn form đẹp, quần dài nam heroes, Quần thể thao nam nữ mặc , quần thun nam ,quần dài nam, quần nỉ , quần jogger 2 sọc, quần thun",99000,99000,0,0
TIKI,cross-border-hang-quoc-te,99688749,"Vintage Hanging Sunflower Welcome Sign Wall Plaque Front Door Wreath Hanging",291000,291000,0,0
TIKI,thoi-trang-nam,105708174,"Áo Khoác Big Size Áo Khoác Dù Nam Có Nón Cổ Trụ Chống Nắng Chống Nóng Chống Lạnh Chống Gió 2 Lớp Phối Logo Thời Trang Nam Tính Hàn Quốc Giá Tốt ShopN6 - QD58",199000,245000,46000,19
TIKI,thoi-trang-nam,103596737,"Áo Blazer Caro 2 Lớp Nam Nữ Form Dáng Rộng Phong Cách Hàn Quốc BZ15",349000,349000,0,0
TIKI,thoi-trang-nam,18012630,"Quần dài thun jogger nam bo lưng thun Phúc An 1042",90000,90000,0,0
TIKI,thoi-trang-nam,97752488,"Quần đùi nam mặc ở nhà, đi ngủ chất cotton 100% phom dáng trẻ trung năng động thương hiêu Fezzio chính hãng",49500,99000,49500,50
TIKI,the-thao-da-ngoai,187057014,"Cần câu đài Hắc Điếu Sư độ dài từ 4m5 đến 12m độ cứng 8H mã CD35",690000,690000,0,0
TIKI,the-thao-da-ngoai,139830479,"Nutrex Outlift Pre-Workout 30 Liều, Tăng Sức Mạnh Sức Bền, Năng Lượng Trước Tập, Citrulline, BCAA, Creatine, Beta-Alanine, Taurine",990000,1150000,160000,14
TIKI,cross-border-hang-quoc-te,11779410,"And To Think That I Saw It: Dr Seuss Green Back Bk",464000,464000,0,0
TIKI,thoi-trang-nam,151799923,"QUẦN LÓT NAM - Tam Giác Lưới Nhỏ Thoáng Mát - Thun Lạnh",59000,59000,0,0
TIKI,thoi-trang-nam,104110965,"Áo khoác jean nam cao cấp không phai không xù, áo khoác bò thiết kế trẻ trung năng động AK06",225000,225000,0,0
TIKI,cross-border-hang-quoc-te,96709599,"Plastic Microwave Food Cover Vented Splatter Protector Lid Safe Vent Yellow",137000,137000,0,0
TIKI,thoi-trang-nam,105833043,"Áo khoác nam, Áo khoác jean, bò nam rách from rộng_màu xanh",170000,170000,0,0
TIKI,thoi-trang-nam,142570557,"Áo Thể Thao Nam Polo TSIMPLE cổ bẻ tay ngắn vải thun lạnh thoáng mát phong cách trẻ trung chuẩn form MSSAHCBC",109000,192000,83000,43
TIKI,thoi-trang-nam,167421285,"Quần Tây Âu Nam Co Giãn Nhẹ Dáng Ôm, Quần Nam Công Sở Lịch Sự Phù Hợp Mọi Hoàn Cảnh Thương Hiệu Chandi Mã MT2",189000,350000,161000,46
TIKI,thoi-trang-nam,73842105,"Áo Polo nam cổ bẻ ngắn tay, chất liệu cao cấp, thoáng mát, bền màu, thiết kế trẻ trung – FORMEN SHOP – FMPS147",159000,199000,40000,20
TIKI,thoi-trang-nam,81188534,"Áo Thun Youtube",37000,37000,0,0
TIKI,cross-border-hang-quoc-te,94919773,"Stainless Steel Ball Lock Quick Release Pins with Pull Ring, Easy to Use",223000,223000,0,0
TIKI,thoi-trang-nam,73815577,"Quần Đũi Dài Đẹp Cho Nam",418950,418950,0,0
TIKI,thoi-trang-nam,6982965,"Quần Jogger Kaki Nam Chất Mát - Rằn Ri T06",72000,72000,0,0
TIKI,thoi-trang-nam,117081856,"Áo khoác dù nam kiểu bomber logo 90 cá tính form chuẩn thoải mái năng động,Áo khoác dù nam nữ mặc / áo khoác gió nam nữ mặc / áo khoác dù kiểu bomber / áo khoác cặp đôi / áo khoác form rộng",102000,102000,0,0
TIKI,thoi-trang-nam,125614162,"OWEN - Quần kaki nam Owen chất thô giấy mềm mại co dãn màu đen 21993/22006",595000,595000,0,0
TIKI,thoi-trang-nam,136173457,"Áo phông nam, áo thun nam có cổ tay ngắn vải thun cotton 100% mặc thoáng mát - ATN05",83000,83000,0,0
TIKI,thoi-trang-nam,155240548,"Quần tây âu công sở nam ADINO màu đen vải cotton dày không bai không xù co giãn nhẹ dáng công sở slimfit ống đứng hơi côn Q02",329000,420000,91000,22
TIKI,cross-border-hang-quoc-te,108475493,"3xLED Camping Lantern Portable Folding Night Lights USB Charging Steel Gray",531000,531000,0,0
TIKI,thoi-trang-nam,73776140,"Quần Đũi Dài Màu Đen Cho Chàng Bigsize",418950,418950,0,0
TIKI,cross-border-hang-quoc-te,109698648,"Miếng đệm tai Thay thế Tương thích với Tai nghe Edifier W800BT W830BT G1 G2 G21-Màu đen",126000,126000,0,0
TIKI,cross-border-hang-quoc-te,179076200,"2Pcs Leg Stretcher Dance Door Stretch Strap Flexibility Training Belt Trainer",363000,363000,0,0
TIKI,thoi-trang-nam,195948130,"Quần tây nam hàn quốc màu ghi đậm ADINO vải rayon polyester co giãn không bai không xù dáng công sở ống đứng hơi côn QA131",359000,450000,91000,20
TIKI,cross-border-hang-quoc-te,270931572,"Halloween Pumpkin Light DIY Halloween Lantern for Outdoor Home Indoor",158000,158000,0,0
TIKI,thoi-trang-nam,33008560,"Áo Sơ Mi Tay Ngắn Sọc Caro To Bản",157000,157000,0,0
TIKI,thoi-trang-nam,141982305,"Quần thể thao nam -quần Jogger Nam chất UMI loại 1 da cao cấp",69000,69000,0,0
TIKI,thoi-trang-nam,68919995," Áo thun tay dài trơn",79000,155000,76000,49
TIKI,thoi-trang-nam,160608177,"Quần lót nam Private Structure Underwear Trunk MIUY3855 Blue",895000,895000,0,0
TIKI,thoi-trang-nam,51375262,"Áo Sơ Mi Nam Sọc Bản To Cao Cấp",157000,157000,0,0
TIKI,thoi-trang-nam,151801974,"QUẦN LÓT NAM - Tam Giác Lưới Nhỏ Thoáng Mát - Thun Lạnh",59000,59000,0,0
TIKI,cross-border-hang-quoc-te,51685927,"Wooden Display Easels Tea Cake Display Stands Picture Frame Stand Holder",147000,147000,0,0
TIKI,cross-border-hang-quoc-te,77723411,"Posture Corrector for Men and Women, Adjustable Upper Back Brace for Clavicle Support and Providing Pain Relief Neck Shoulder Upright Straightener - L",212000,212000,0,0
TIKI,thoi-trang-nam,30795991,"Áo sơ mi nam dài tay kẻ sọc xanh",159000,159000,0,0
TIKI,cross-border-hang-quoc-te,96384517,"Quick Release Adjustable Fire Extinguisher Holder Mount Bracket, for  Wrangler UTV Camper Van",404000,404000,0,0
TIKI,thoi-trang-nam,44834030,"Áo Hoodie  Phong Cách Nam Màu Trơn Dễ Mặc - FMGV16_05",75000,75000,0,0
TIKI,thoi-trang-nam,221231536,"Áo blazer nam Hàn Quốc kiểu dáng thời trang năng động",320000,320000,0,0
TIKI,thoi-trang-nam,103683048,"ÁO BA LỖ NAM, TRẮNG TRUYỀN THỐNG CAO CẤP",78000,78000,0,0
TIKI,thoi-trang-nam,55911268,"Áo Thun Nam Cổ Polo Họa Tiết KO888 Cao Cấp",157000,157000,0,0
TIKI,the-thao-da-ngoai,8582344,"Bộ 2 tạ nhựa tay 10kg",160000,265000,105000,40
TIKI,cross-border-hang-quoc-te,77692604,"CNC Aluminum Rear Suspension Lowering Kit 20mm lowering for  1290 Super Adventure 2015-2016 S R 2017-2019, make 20 mm lowering your suspension",163000,163000,0,0
TIKI,thoi-trang-nam,90066874,"Áo khoác dù , áo khoác gió , áo khoác unisex , áo khoác dù bomber",102000,102000,0,0
TIKI,thoi-trang-nam,97929721,"Áo sơ mi biển - Dừa vàng",68000,68000,0,0
TIKI,thoi-trang-nam,20908900,"Quần Jean Nam BYQ63",187000,187000,0,0
TIKI,thoi-trang-nam,212974525,"Áo Đũi Nam Ngắn Tay Cổ Tàu Cao Cấp Đũi Việt DV01",250000,250000,0,0
TIKI,cross-border-hang-quoc-te,110301618,"Bàn phím cơ 87 phím Bàn phím có dây, có đèn nền RGB Công tắc màu xanh lam, kết hợp đa phương tiện-Màu trắng",609000,609000,0,0
TIKI,thoi-trang-nam,68891547,"[ Có Ảnh Thật ] Áo thun unisex tay lỡ form rộng - Áo phông hình học",47000,47000,0,0
TIKI,thoi-trang-nam,9796365,"Aó khoác Jacket Aligro ALGAKG10",979000,979000,0,0
TIKI,thoi-trang-nam,117083129,"Áo khoác dù nam nữ chạy sọc tay siêu đẹp,phong cách cá tính tự tin,vải dù 2 lớp chống nắng giử nhiệt hiệu quả,Áo khoác dù 1 sọc ,áo khoù dù , áo khoác gió",102000,102000,0,0
TIKI,thoi-trang-nam,13781320,"Quần Jean Nam Rách Gối TS_Rach",150000,150000,0,0
TIKI,thoi-trang-nam,68603245,"Áo Free Fire In 3D Màu Đen Alok",75900,75900,0,0
TIKI,thoi-trang-nam,56919853,"Áo Len Cổ Lọ Nam SZone SAL222 Phong Cách Hàn Quốc",129000,129000,0,0
TIKI,thoi-trang-nam,139023174,"Quần âu nam kẻ sọc chất vải cotton cao cấp, quần tây kẻ cực tôn dáng, lịch sự, trẻ trung, chuẩn thiết kế hàn quốc",149000,149000,0,0
TIKI,thoi-trang-nam,16910398,"Combo 5 Quần Lót Nam vải cotton 2 chiều lưng CITYMEN, màu ngẫu nhiên, đồ lót - LMTK-CTM2C",100000,100000,0,0
TIKI,thoi-trang-nam,137209511,"quần sọt kaki nam túi hộp",150000,150000,0,0
TIKI,the-thao-da-ngoai,179445531,"Túi đeo bụng, đai đeo điện thoại chạy bộ chính hãng Goodfit GF10X chống nước, phản quang, sức chứa lớn",129000,199000,70000,35
TIKI,thoi-trang-nam,129299572,"Quần thô Kaki Nam Trung Niên hàng chuẩn đẹp ẢNH THẬT",279000,279000,0,0
TIKI,thoi-trang-nam,109840857,"Quần Jocker ống rộng bo gót in hình Heroes có túi sau sành điệu, quần thun nỉ dài ống rộng nam phong cách Hàn Quốc",92000,92000,0,0
TIKI,thoi-trang-nam,187842142,"Áo khoác kaki nam nữ phối miếng ghép khác màu",123000,123000,0,0
TIKI,thoi-trang-nam,160882838,"GOKING-1985-JAPAN-TOKYO, mã Goking4. Áo thun in chữ đẹp cho nam nữ, áo phông thoát nhiệt GOKING hàng hiệu cao cấp",168000,168000,0,0
TIKI,thoi-trang-nam,95910337,"Áo gia đình ngộ nghĩnh - THUN COTTON - có size lớn (GD275T)",91000,91000,0,0
TIKI,thoi-trang-nam,35752589,"Combo 5 Quần Lót Nam Boxer Thời Trang Aristino ABX 16 16",489000,650000,161000,25
TIKI,thoi-trang-nam,195890920,"Quần Jogger nam nữ rằn ri kaki, Quần JOGGER kaki thể thao nam nữ chất dày dặn - PROMAN",10000,10000,0,0
TIKI,thoi-trang-nam,15505672,"Quần short jeans nam xanh đậm vải dày đẹp Q392 MĐ thời trang",114000,114000,0,0
TIKI,thoi-trang-nam,52079043,"Quần bò nam, dày dặn, lót bông, size lớn, thời trang, phong cách Nhật Bản TA254",225548,225548,0,0
TIKI,thoi-trang-nam,116777200,"Quần sịp đùi nam xuất nhật loại 1",45000,45000,0,0
TIKI,thoi-trang-nam,155400020,"Áo Chống Nắng Nam 2 Lớp Big Size Thiết Kế Họa Tiết Kẻ Caro Form Từ 75-90kg - Chất Liệu Kaki 2 Lớp Mềm Mịn - Thoáng Khí",115000,115000,0,0
TIKI,thoi-trang-nam,248602540,"Áo sơ mi nam Vitimen ngắn tay form Slim fit",540000,540000,0,0
TIKI,thoi-trang-nam,22101060,"Hộp 5 quần lót nam quần sịp tam giác nam Nhật Bản cao cấp",75000,75000,0,0
TIKI,thoi-trang-nam,127267574,"Áo Khoác Nỉ Hoodie PURBSSO KNN36",100000,100000,0,0
TIKI,thoi-trang-nam,269895252,"Quần đùi nam tập gym DO GYM SHOP quần ống rộng chất thun poly thoáng mát khi chơi thể thao",159000,159000,0,0
TIKI,thoi-trang-nam,69000357,"MỚI  ÁO HOODIE NỈ NGOẠI Basic (HD810 - Trơn)",94900,94900,0,0
TIKI,thoi-trang-nam,267475466,"Quần jogger nam tập gym DO GYM SHOP logo thêu, thun poly 4 chiều thoáng mát",179000,179000,0,0
TIKI,thoi-trang-nam,198262051,"Áo khoác nam Aligro 2 lớp màu xanh lá chất liệu vải cotton mịn, đanh không xù, thoáng khí ALGAKG8",890000,890000,0,0
TIKI,thoi-trang-nam,14694657,"Áo khoác gió cách nhiệt GOKING, form unisex cho nữ nam. Ngoài vải dù, trong lót vải cào cách nhiệt. Hàng Việt Nam chất lượng cao",235000,235000,0,0
TIKI,thoi-trang-nam,108651943,"Áo thun Polo nam trơn cổ bẻ vải cá sấu Cotton (45-85kg)",29000,29000,0,0
TIKI,thoi-trang-nam,158758292,"Áo thun nam dập vân cao tần siêu mát siêu mềm",75000,75000,0,0
TIKI,thoi-trang-nam,71288437,"Áo Sơ Mi Nam Sọc Caro Form Dài GOAT MENSWEAR",495000,495000,0,0
TIKI,thoi-trang-nam,170502080,"Quần Kaki Nam Chất Cao Cấp Siêu nhẹ Dáng Âu Phong Cách Công Sở VICERO",200000,318000,118000,37
TIKI,thoi-trang-nam,132139664,"Bộ quần áo đi biển nổi bật cho gia đình hội nhóm cặp đôi nam nữ thun dày dặn DDB114 DONGPHUCSG",99000,99000,0,0
TIKI,thoi-trang-nam,242618109,"Quần jogger unisex thể thao chạy viền , quần ống rộng kiểu dáng jogger mặc nhà nam nữ vải TỔ ONG mềm mại",85000,85000,0,0
TIKI,thoi-trang-nam,163919880,"Áo Sơ Mi Nam Xanh Ngọc Ngắn Tay Công Sở Thương Hiệu Anton Trung Niên Sợi Tre Họa Tiết -GD560",265000,325000,60000,18
TIKI,thoi-trang-nam,160608079,"Quần lót nam Private Structure Underwear Size Up Mini Brief MOUX4088 Melange",595000,595000,0,0
TIKI,thoi-trang-nam,176608368,"Áo Sơ Mi Oxford Nam Dài Tay Logo Classics Giordano 01042043",887000,940000,53000,6
TIKI,thoi-trang-nam,52343026,"Áo Sơ Mi Nam Phối Caro Phong Cách Trẻ Trung",115000,115000,0,0
TIKI,thoi-trang-nam,107890267,"Áo khoác dù bomber nam nữ cúc bấm logo chữ K sắc nét",94000,94000,0,0
TIKI,thoi-trang-nam,87053075,"Quần lót boxer nam thun lưới thoáng mát - A037",85000,85000,0,0
TIKI,thoi-trang-nam,160608049,"Quần lót nam Private Structure Underwear Size Up Mini Brief MOUX4088 Black",595000,595000,0,0
TIKI,thoi-trang-nam,163903477,"Áo Sơ Mi Nam Xanh Dương Ngắn Tay Anton Công Sở Trung Niên Vải Sợi Tre Kẻ Trắng – GD553",265000,355000,90000,25
TIKI,thoi-trang-nam,91861046,"Áo sơ mi nam tay dài form slim ôm sọc xanh Khatoco A1MD388S1-THSC039-2009-D",388000,388000,0,0
TIKI,thoi-trang-nam,67233692,"Áo thun tay lỡ cotton thoáng mát viền chữ nhật (unisex nam nữ đều mặc được)",47000,47000,0,0
TIKI,thoi-trang-nam,130287356,"Quần Tây Nam Oscar Regular Fit OCMPKR 007 - Quần Âu nam công sở dáng đứng giữ form, mềm mịn, thoáng mát, chống nhăn, thấm hút hiệu quả",449000,1290000,841000,65
TIKI,thoi-trang-nam,191778890,"Áo polo nam May 10 mã 140122033",265000,265000,0,0
TIKI,thoi-trang-nam,19550745,"Áo sơ mi nam trơn, tay dài",98000,98000,0,0
TIKI,thoi-trang-nam,86813448,"Hộp 5 quần boxer, sịp đùi nam không đường may chất liệu thun lạnh mịn mát",250000,350000,100000,29
TIKI,thoi-trang-nam,68292008,"Quần jean nam đen trơn form chất cực đẹp - body (rách gối)",59000,59000,0,0
TIKI,thoi-trang-nam,186263847,"Áo sơ mi nam ngắn tay in họa tiết cao cấp LADOS-8075 vải lụa không nhăn, form đẹp, màu sắc tươi trẻ",299000,299000,0,0
TIKI,thoi-trang-nam,14678664,"Quần Jogger Kaki Nam Đen JOGGER98 (Jogger)",95000,95000,0,0
TIKI,thoi-trang-nam,76165828,"Quần tây nam 1 ply ống đứng đen Khatoco Q1M478R1-CNMA026-2411-0",382400,478000,95600,20
TIKI,thoi-trang-nam,67526051,"MAY 10 - Quần ĐÙI mặc nhà + mặc ngủ (HÀNG HIỆU GIÁ SHOCK)",65000,65000,0,0
TIKI,thoi-trang-nam,3714983,"Combo 5 Quần Lót Boxer Nam Freeman 6513-CB5-XL (Size",396000,495000,99000,20
TIKI,thoi-trang-nam,163905753,"Áo Sơ Mi Nam Xám Ghi Ngắn Tay Công Sở Trung Niên Thương Hiệu Anton Vải Sợi Tre Kẻ Caro Trắng – GD551",265000,355000,90000,25
TIKI,thoi-trang-nam,97861287,"COMBO 3 Áo thun trơn nam form rộng phong cách hàn quốc vải poly cotton mịn MÀU ĐEN-TRẮNG-XÁM SIÊU SALE !! SIÊU SALE",80800,80800,0,0
TIKI,thoi-trang-nam,160291057,"OWEN - Áo sơ mi dài tay Owen Sợi Sồi mềm mát màu xanh bạc hà 23417",598000,598000,0,0
TIKI,thoi-trang-nam,191343507,"Viettien - Áo sơ mi nam dài tay màu xanh da trời Áo sơ mi công sở nam vạt bầu Việt Tiến",410000,410000,0,0
TIKI,thoi-trang-nam,73125633,"Áo khoác dạ nam hàn quốc dáng dài NAD67 - M",1450000,1450000,0,0
TIKI,thoi-trang-nam,38496061,"Combo 7 Quần lót nam tam giác cotton xịn nhiều lưng có size lớn màu ngẫu nhiên cao cấp mặc cực thoãi mái underwear SỊP HN7",135000,135000,0,0
TIKI,thoi-trang-nam,164312116,"UNSTOPABLE đa sắc, mã G61. Áo thun hàng hiệu Goking, form unisex cho nam nữ, trẻ em, bé trai gái. Áo phông in đẹp, quà tặng cao cấp",119000,119000,0,0
TIKI,thoi-trang-nam,22492292,"Áo polo nam ngắn tay có cổ ( TẶNG QUẦN LÓT NAM CAO CẤP ) , Combo 2 áo, DokaFashion regular fit chuẩn hàng xuất, áo phông thun polo nam tay ngắn – EZ235",157000,285000,128000,45
TIKI,thoi-trang-nam,154298071,"Combo 2 quần đùi nam, quần Short Gió nam thể thao Họa Tiết Rằn Ri trẻ trung năng động, thoáng mát co giãn 4 chiều MRM Manlywear",269000,399000,130000,33
TIKI,thoi-trang-nam,90979601,"Áo Khoác Dù Nam chống nước ( TẶNG QUẦN LÓT HÀNG HIỆU ) Dokafashion Cao Cấp 2 Lớp Vải Dù Ấm Áp Cản Gió Đi Nắng, Chống Nước EZDS23",147000,209000,62000,30
TIKI,thoi-trang-nam,124635780,"Áo sơ mi nam trơn tay dài cao cấp Lados - 779 chất kate lụa mềm mát, thấm hút mồ hôi",116000,235000,119000,51
TIKI,thoi-trang-nam,145680551,"Hộp 5 Quần Lót Nam lưng Hàn Quốc hiệu CITYMEN vải thun lạnh 4 chiều cao cấp, sịp nam - LMTK-HANAL ( Giao màu ngẫu nhiên )",115000,115000,0,0
TIKI,thoi-trang-nam,52133729,"Quần Lót Nam lưng CITYMEN vải lạnh co giãn 4 chiều cao cấp, đồ lót - LMTK-CTMAL",30000,30000,0,0
TIKI,thoi-trang-nam,31638135,"Combo 4 quần lót nam Boxer sợi cạp 1cm sợi tre tự nhiên mềm mịn thấm hút mồ hôi, co giãn 4 chiều MRM Manlywear - Màu ngẫu nhiên",255000,340000,85000,25
TIKI,thoi-trang-nam,67538621,"COmbo 5 quần ĐÙI May 10",135000,135000,0,0
TIKI,thoi-trang-nam,162033134,"Combo 5 quần đùi nam mặc nhà Cotton thoải mái thoáng mát Họa Tiết Ngẫu Nhiên - JAMANO",229000,350000,121000,35
TIKI,thoi-trang-nam,170400732,"SET 5 Chiếc Quần Lót Nam Không đường may cao cấp BADBIRD, quần lót nam, quần sịp nam dạng boxer, Thương hiệu Việt",315000,315000,0,0
TIKI,thoi-trang-nam,169619782,"SET 3 Chiếc Quần Lót Nam Không đường may cao cấp BADBIRD, quần lót nam, quần sịp nam dạng boxer, Thương hiệu Việt",189000,199000,10000,5
TIKI,thoi-trang-nam,31638135,"Combo 4 quần lót nam Boxer sợi cạp 1cm sợi tre tự nhiên mềm mịn thấm hút mồ hôi, co giãn 4 chiều MRM Manlywear - Màu ngẫu nhiên",255000,340000,85000,25
TIKI,thoi-trang-nam,172210350,"Hộp 4 quần boxer nam thun lạnh, quần lót nam co dãn 4 chiều- Formen Shop- FMQS017",179000,280000,101000,36
TIKI,thoi-trang-nam,99325284,"Áo Thể Thao Nam TSIMPLE thun nam tập gym ngắn tay vải thun lạnh thoáng mát, co giãn, chuẩn form nhiều màu",89000,113000,24000,21
TIKI,thoi-trang-nam,99183754,"Áo Polo Nam cổ bẻ TSIMPLE thun có cổ tay lỡ vải cá sấu cotton phong cách trẻ trung, chuẩn form, nhiều màu",149000,170000,21000,12
TIKI,thoi-trang-nam,88011606,"Quần Sịp Nam Quần Lót Nam ( từ 40kg đến 100kg )  Dokafashion Sợi Cotton Mềm Mịn Siêu Thoáng Mát, Co Giãn 4 Chiều Cao Cấp EZQLH01",21000,49000,28000,57
TIKI,thoi-trang-nam,99968881,"Set 2 quần đùi nam, quần Short Gió nam thể thao Basic trẻ trung năng động, thoáng mát co giãn 4 chiều MRM Manlywear",255000,399000,144000,36
TIKI,thoi-trang-nam,111972654,"Quần Túi Hộp Tháo Ống US ARMY U880 Chuyên Phượt Chất Vải Gió Cao Cấp Mau Khô Ống Có Thể Tháo Rời Làm Quần Short -HÀNG CHÍNH HÃNG",284000,699000,415000,59
TIKI,thoi-trang-nam,99958075,"Quần đùi short gió nam thể thao Basic trẻ trung năng động, thoáng mát co giãn 4 chiều MRM Manlywear",129000,199000,70000,35
TIKI,thoi-trang-nam,110704393,"Combo 2 quần đùi nam Cotton mặc nhà thoải mái thoáng mát JAMANO- MÀU NGẪU NHIÊN",99000,140000,41000,29
TIKI,thoi-trang-nam,164338704,"Áo Thun Nam Ngắn Tay 8 Màu Thiết Kế Thời Trang Cao Cấp AVIANO",129000,258000,129000,50
TIKI,thoi-trang-nam,111850645,"Bộ Quần Áo KaKi Lính Mỹ US ARMY U569 Kiểu Dáng Túi Hộp Chiến Thuật, Chất Liệu Kaki Cao Cấp Phong Cách Lính Cực Ngầu - HÀNG CHÍNH HÃNG",855000,1798000,943000,52
TIKI,thoi-trang-nam,87981660,"Combo 2 áo ba lỗ nam, áo 3 lỗ nam, sợi cotton mềm mịn, thấm hút mồ hôi tốt, thoáng mát, mặc thoải mái JAMANO",149000,198000,49000,25
TIKI,thoi-trang-nam,186133766,"Quần Short Kaki Nam US ARMY, Quần Túi Hộp Nam Phong Cách Lính Chất Liệu KaKi Cao Cấp, Kiểu Dáng Trẻ Trung Năng Động -HÀNG CHÍNH HÃNG",283000,598000,315000,53
TIKI,thoi-trang-nam,22610869,"Combo 3 Áo Thun nam HÀNG HIỆU đa phong cách -  ĐB3QC16 (Chọn Màu)- Vải thun cotton có điểm đặc biệt, thân thiện với làn da, co giãn và khả năng thấm hút tốt",300000,300000,0,0
TIKI,thoi-trang-nam,31637590,"Combo 4 quần lót nam tam giác Bamboo Organic mềm mịn thoáng mát thấm hút mồ hôi - MRM Manlywear - Màu Ngẫu Nhiên",249000,340000,91000,27
TIKI,thoi-trang-nam,104080625,"Combo 4 Quần Lót Nam hiệu CITYMEN vải thun lạnh 4 chiều lưng Hàn Quốc cao cấp, đồ lót - LMTK-HANAL ( Giao màu ngẫu nhiên )",136000,136000,0,0
TIKI,thoi-trang-nam,154298071,"Combo 2 quần đùi nam, quần Short Gió nam thể thao Họa Tiết Rằn Ri trẻ trung năng động, thoáng mát co giãn 4 chiều MRM Manlywear",269000,399000,130000,33
TIKI,thoi-trang-nam,99156609,"Áo Thun Nam cổ tròn TSIMPLE áo phông trơn basic tay ngắn vải cotton co giãn, dày dặn , form chuẩn nhiều màu",89000,113000,24000,21
TIKI,thoi-trang-nam,79435123,"Áo chống nắng nam cao cấp, thông hơi, chống nắng, chống tia UV, chống bám bụi – FORMEN SHOP – FMTHT024",129000,215000,86000,40
TIKI,thoi-trang-nam,76537581,"Quần Jean Nam Đen Trơn cao cấp thương hiệu Chandi, phong cách tôn dáng nam tính chất jean co dãn Mẫu J20",165000,280000,115000,41
TIKI,thoi-trang-nam,7599073,"Combo 5 Quần Lót Nam tam giác vải cotton co giãn 2 chiều hiệu CITYMEN, màu ngẫu nhiên, sịp nam - LMTK-MULTI2C",100000,100000,0,0
TIKI,thoi-trang-nam,144162512,"Combo 3 quân sịp đùi nam, set 3 quần lót boxer nam Aristino chất liệu cotton kháng khuẩn, khử mùi, co giãn 4 chiều thấm hút mồ hôi cực tốt ABX03707",298000,390000,92000,24
TIKI,thoi-trang-nam,114571809,"Quần Sịp Nam Cao Cấp, Quần Lót Nam Thun Lạnh, Hộp 4 Sịp Đùi Nam Vải Sợi Tự Nhiên Thun Lạnh, Thoáng Khí, Co Giãn 4 Chiều, Không Phai Màu, Không Xù Lông, Thấm Hút Mồ Hôi, Thoát Hơi Và Kháng Khuẩn Rất Tốt",115500,115500,0,0
TIKI,thoi-trang-nam,99968881,"Set 2 quần đùi nam, quần Short Gió nam thể thao Basic trẻ trung năng động, thoáng mát co giãn 4 chiều MRM Manlywear",255000,399000,144000,36
TIKI,thoi-trang-nam,49165591,"Đồ bơi cho nam quần lửng",299000,314480,15480,5
TIKI,thoi-trang-nam,52184516,"Combo 3 quần lót nam Boxer sợi Organic mềm mịn thoáng mát co giãn 4 chiều MRM Manlywear ( TẶNG Đôi Tất Nam Cao Cấp Giao Ngẫu Nhiên)",199000,285000,86000,30
TIKI,thoi-trang-nam,82819910,"Áo Polo nam cổ bẻ ngắn tay, chất liệu vải cá sấu cotton cao cấp, trẻ trung, năng động – FORMEN SHOP – FMPS150",159000,219000,60000,27
TIKI,thoi-trang-nam,99329103,"Quần Thể Thao Nam TSIMPLE, quần short tập gym vải thun lạnh thoáng mát, co giãn, chuẩn form nhiều màu",89000,113000,24000,21
TIKI,thoi-trang-nam,110704393,"Combo 2 quần đùi nam Cotton mặc nhà thoải mái thoáng mát JAMANO- MÀU NGẪU NHIÊN",99000,140000,41000,29
TIKI,thoi-trang-nam,162033134,"Combo 5 quần đùi nam mặc nhà Cotton thoải mái thoáng mát Họa Tiết Ngẫu Nhiên - JAMANO",229000,350000,121000,35
TIKI,thoi-trang-nam,187574051,"Combo 3 quần lót nam boxer CITYMEN lưng Thái cao cấp vải cotton 100% co dãn mềm mại thoáng khí thấm hút tốt, quần xịp sịp đùi nam - Giao màu ngẫu nhiên",140000,140000,0,0
TIKI,thoi-trang-nam,160393397,"Áo thun polo nam ngắn tay, chất thun vải mềm mịn, thiết kế phần bo tay và cổ áo phối màu độc lạ - FORMEN SHOP - FMPS176",179000,250000,71000,28
TIKI,thoi-trang-nam,176251118,"Combo 2 Áo thun nam Cotton Compact Premium trẻ trung thấm hút mồ hôi, co giãn 4 chiều MRM Manlywear",289000,499000,210000,42
TIKI,thoi-trang-nam,125800026,"Áo khoác dù 2 mặt chống Nước LADOS - 2027 , Form đẹp, chống nắng, chống nước tốt",203000,379000,176000,46
TIKI,thoi-trang-nam,31637590,"Combo 4 quần lót nam tam giác Bamboo Organic mềm mịn thoáng mát thấm hút mồ hôi - MRM Manlywear - Màu Ngẫu Nhiên",249000,340000,91000,27
TIKI,thoi-trang-nam,14694284,"Áo khoác nam 2 lớp GOKING, vải dù ấm áp, cản gió hiệu quả, thích hợp đông và thu đông (Màu xanh đen)",235000,235000,0,0
TIKI,thoi-trang-nam,126700166,"Quần Jean nam basic cao cấp LADOS - 4035 form slimfit, vải đẹp",265000,500000,235000,47
TIKI,thoi-trang-nam,176250783,"Áo thun nam Cotton Compact Premium trẻ trung năng động thấm hút mồ hôi co giãn 4 chiều MRM Manlywear",149000,249000,100000,40
TIKI,thoi-trang-nam,14702607,"Áo Thun Nam Tay Lỡ Unisex Hạc JaPan",37000,37000,0,0
TIKI,thoi-trang-nam,52720544,"Quần Lót Nam Thun lạnh 4 chiều cao cấp màu ngẫu nhiên",25000,30000,5000,17
TIKI,thoi-trang-nam,133821238,"Combo 5 Quần Lót Nam Boxer Cotton Lưng Thái Cao Cấp, Quần Sịp Đùi Nam Co Giãn 4 Chiều CITYMEN - ( Màu Ngẫu Nhiên )",230000,230000,0,0
TIKI,thoi-trang-nam,97057130,"Áo Thun nam Polo Bảo Bảo Store chất thun cotton cá sấu hàng xuất khẩu form Quốc tế có bigsize - Form rộng giảm 2 size",75050,79000,3950,5
TIKI,thoi-trang-nam,94881128,"Áo sơ mi việt tiến dài tay  màu xanh đen",350000,350000,0,0
TIKI,thoi-trang-nam,99866147,"Bộ nỉ nam nữ thu đông dài tay thể thao thiết kế 3 sọc QTD003",235000,235000,0,0
TIKI,thoi-trang-nam,74811114,"Quần baggy nam Amazing, chất liệu kaki, lưng thun có giây rút, form ôm Unisex, tôn dáng đẹp, trẻ trung",239000,349000,110000,32
TIKI,thoi-trang-nam,72542893,"Áo khoác nam lót lông cừu vải dù gió cao cấp chống nước có mũ tháo rời mặc mùa đông siêu ấm chống gió giữ nhiệt unisex nam nữ, áo phao nam lót lông cừu, áo gió lót lông cừu nam vải dù cao cấp",269000,269000,0,0
TIKI,thoi-trang-nam,89266198,"ÁO KHOÁC NỈ HOODIE GẤU NAM NỮ UNISEX - GIN STORE",114000,114000,0,0
TIKI,thoi-trang-nam,172482304,"Áo PoLo Ngắn Tay 5 Màu Thiết Kế Phong Cách Thời Trang Cao Cấp ZERO",100000,200000,100000,50
TIKI,thoi-trang-nam,123204495,"Quần lót nam thun brief Espresso iBasic PANM102",79000,99000,20000,20
TIKI,thoi-trang-nam,194040292,"Áo sơ mi nam tay ngắn cổ vest hoạ tiết đường phố LADOS - 8081 co giãn, thấm hút mồ hôi, sang trọng",259000,259000,0,0
TIKI,thoi-trang-nam,11988942,"Áo Khoác Nam Jean / Denim Jacket - AKB1 Xanh Bò",170000,170000,0,0
TIKI,thoi-trang-nam,68961746,"Quần lót nam lưng thấp dạng dây thiết kế siêu gợi cảm - Màu đen",45000,45000,0,0
TIKI,thoi-trang-nam,190490081,"Áo Khoác Việt Tiến Phom mới 6Q5006 Áo Jacket nam Áo khoác 2 lớp Viettien",650000,650000,0,0
TIKI,thoi-trang-nam,103243177,"Quần Sịp Nam Chữ V Nâng Mông Siêu Thoáng K367 - Trắng - L",65000,65000,0,0
TIKI,thoi-trang-nam,76698842,"quần jean nam cao cấp co giãn loại quần jean xuất khẩu form chuẩn",145000,145000,0,0
TIKI,thoi-trang-nam,169647134,"Viettien - Áo sơ mi nam ngắn tay kẻ sọc vạt bầu 1N3556 regular",490000,490000,0,0
TIKI,thoi-trang-nam,117583504,"ÁO KHOÁC KAKI CARO NAM THƠI TRANG CHO MUA XUÂN",179000,179000,0,0
TIKI,thoi-trang-nam,67516773,"Áo sơ mi nam tay ngắn form slim sọc ngang tím Khatoco A1MN538S1-CNSC006-2102-N",430400,538000,107600,20
TIKI,thoi-trang-nam,29115771,"Quần Jogger Nỉ Nam trơn",45000,45000,0,0
TIKI,thoi-trang-nam,103595875,"Set Blazer Nam, Áo Blazer Kèm Quần Âu Nam phong cách Hàn Quốc SET2",499000,499000,0,0
TIKI,thoi-trang-nam,195781338,"Viettien - Quần kaki nam màu xanh đen 0ly 6R6076 regular dáng rộng - Quần kaki cao cấp trung niên Việt Tiến",695000,695000,0,0
TIKI,thoi-trang-nam,108359020,"Áo Hoodie Họa Tiết Con Bò Sữa Cặp Nam Nữ Chất Nỉ PE Cotton Cao Cấp, Áo khoác Hoodie Zip Nỉ Bông Bò Sữa unisex nam nữ đều mặc được Có Clip Cận Chất,  Áo hoodie nam / áo hooodie nữ /Áo Hoodie/ Áo Khoác Nỉ Bông Bò Sữa Form Rộng Unisex Nam Nữ HOT TREND 2021",100000,100000,0,0
TIKI,thoi-trang-nam,197092121,"Quần đùi thun sport 5 màu",35000,35000,0,0
TIKI,thoi-trang-nam,111850645,"Bộ Quần Áo KaKi Lính Mỹ US ARMY U569 Kiểu Dáng Túi Hộp Chiến Thuật, Chất Liệu Kaki Cao Cấp Phong Cách Lính Cực Ngầu - HÀNG CHÍNH HÃNG",841000,1798000,957000,53
TIKI,thoi-trang-nam,20521238,"Áo Sơ Mi Nam Tay Ngắn Khatoco A1MN538T1-CNCR115-2010-N",149000,538000,389000,72
TIKI,thoi-trang-nam,53789518,"Quần Đùi Thun Thể Thao Nam Mát Lạnh Cao Cấp",61000,61000,0,0
TIKI,thoi-trang-nam,112990508,"ÁO KHOÁC HOODIE. ÁO KHOÁT HOOIDE STICK NAM NỮ",101000,101000,0,0
TIKI,thoi-trang-nam,8155370,"Áo Khoác Chống Nắng Nam",137500,137500,0,0
TIKI,thoi-trang-nam,76703891,"Quần đùi nam sọc caro chất vai otton mềm co giãn thấm hút tốt mặc thoải mái khi ở nhà khi đi ngủ size 50kg - 70kg",22000,22000,0,0
TIKI,thoi-trang-nam,67656086,"Quần Jogger thể thao Quần tập gym nam 3 sọc dài Q-01",68000,68000,0,0
TIKI,thoi-trang-nam,14695097,"Áo sơ mi trắng dài tay Việt Tiến 500",590000,590000,0,0
TIKI,thoi-trang-nam,198115338,"Quần lính, quần dài nam, quần kaki nam, Quần chiến thuật lính S.archon cao cấp ARM-1056",600000,600000,0,0
TIKI,thoi-trang-nam,52655031,"Áo vest nam 1 nút ôm body màu đen chất liệu co dãn , thoáng mát",450000,450000,0,0
TIKI,thoi-trang-nam,84422060,"Combo 3 Áo Thun Trơn Nam  Màu Trắng Đen Xám",222000,222000,0,0
TIKI,thoi-trang-nam,101657805,"Áo Khoác Dạ Nam Hàn Quốc Dáng Dài Áo Măng Tô Nam Hàn Quốc Sans01 Sans Shop",399000,399000,0,0
TIKI,thoi-trang-nam,121797935,"ÁO BA LỖ LƯỚI NAM THÔNG SÁT NÁCH HƠI CO DÃN 4 CHIỀU - CO VIDEO THẬT- MINHSTORE66",43000,43000,0,0
TIKI,thoi-trang-nam,120149868,"Quần Lót Nam Tam Giác 3D Sexy Gợi Cảm, Siêu Thoáng Mát Dành Cho Phái Mạnh",64000,64000,0,0
TIKI,thoi-trang-nam,124766236,"Áo khoác gió nam nữ cao cấp 2 lớp, áo khoác dù chống nắng, chống gió, ngăn tia UV",165000,165000,0,0
TIKI,thoi-trang-nam,85086751,"Áo sơ mi nam trắng chuẩn soái ca",115000,115000,0,0
TIKI,thoi-trang-nam,162865525,"áo khoác Bomber, Áo khoác bomber 2 lớp phối tay đen trắng freesize form rộng nam nữ mặc đồ đôi cực ngầu",99000,99000,0,0
TIKI,thoi-trang-nam,30684522,"Áo Sơ Mi Nam Tay Ngắn Form Slim Khatoco A1MN438S1-CNMA001-2102-N - Size",350400,438000,87600,20
TIKI,thoi-trang-nam,79546542,"Quần Short Nam Kaki Vicero 6 Màu Phong Cách Hàn Quốc",159000,298000,139000,47
TIKI,thoi-trang-nam,179534840,"[SIÊU GỌN] PARALLETTES GỖ - DỤNG CỤ HÍT ĐẤT, CHỐNG ĐẨY",150000,150000,0,0
TIKI,thoi-trang-nam,183530633,"[Mẫu mới] Bộ quần áo bóng đá câu lạc bộ Real Madrid - Áo bóng đá chất vải thun lạnh, dệt kim cao cấp",95000,175000,80000,46
TIKI,thoi-trang-nam,270766582,"Cần câu tay rút gọn 45cm đút cốp hạ lóng có thể thay đổi chiều dài cần tặng kèm ngọn phụ",320000,320000,0,0
TIKI,thoi-trang-nam,188318508,"Dây Trục Câu Đài Buộc Sẵn 3260 Cước Câu Cá Tàng Hình Chuyên Câu Đài Cao Cấp DC28",7000,7000,0,0
TIKI,thoi-trang-nam,158587773,"Balo túi rút chống nước bụi TSLA phù hợp đi tập Gym bơi lội chạy bộ chơi thể thao",60000,60000,0,0
TIKI,thoi-trang-nam,58341210,"Khăn Trùm Mặt Che Nắng Đi Phượt Đa Năng Cao Cấp Vải Thoáng Khí, Mau Khô, Dễ Mặc Cho Nam Và Nữ Dành Cho Phượt Thủ - Mai Lee",65892,69360,3468,5
TIKI,thoi-trang-nam,94930202,"Mồi Câu Cá Rô Phi , Combo 1kg Cám CNF + 1 Chai Tinh Mùi Thái Lan M21 Chuyên Câu Cá Rô Phi",115000,115000,0,0
TIKI,thoi-trang-nam,138171420,"Lồng lưới phơi khô thực phẩm phơi cá chống côn trùng treo 4 tầng để phơi cá khô có thể xếp gọn",54997,54997,0,0
TIKI,thoi-trang-nam,186803059,"Quần Chạy Bộ Nam 2 Lớp DK22001 Có Túi Đựng Điện Thoại Bên hông,Túi Hậu Có Khóa Kéo",199000,199000,0,0
TIKI,thoi-trang-nam,43993416,"Viên Uống Giúp Tăng Tập Trung Và Tỉnh Táo - Mutant Caffeine Hộp 240 Viên",300000,300000,0,0
TIKI,thoi-trang-nam,166123372," Thanh rung thể thao đàn hồi có thể tháo rời Sportslink Feilishi Rod (Hàng loại 1)",222000,245000,23000,9
TIKI,thoi-trang-nam,127947330,"Gậy Rung Đàn Hồi Tập Gym Tập Toàn Thân Cao Cấp Chính Hãng Đại Nam Sport",129000,200000,71000,36
TIKI,thoi-trang-nam,12723399,"Bóng Rổ Prostar size 7 màu cam tặng kèm kim bơm bóng",115000,169000,54000,32
TIKI,thoi-trang-nam,2431543,"Nón cổ động bóng đá các đội tuyển Sportslink - Brasil",42000,47000,5000,11
TIKI,thoi-trang-nam,432921,"Kính Bơi Trẻ Em Balance F268 - Hồng",35000,35000,0,0
TIKI,thoi-trang-nam,155759318,"Vành Mũ Bảo Hộ Che Nắng - Màu Ghi Đậm",45000,45000,0,0
TIKI,thoi-trang-nam,96211952,"Đai điều chỉnh cột sống AOLIKES A-3106 Back Posture Corrector chống gù lưng",292000,489000,197000,40
TIKI,thoi-trang-nam,156628745,"Cầu đá lông gà, Cầu đá ống tuyển trắng HD111 Sportslink",19000,21000,2000,10
TIKI,thoi-trang-nam,41825814,"GĂNG TAY THỂ THAO ADIDAS ADGB-1315",441000,456000,15000,3
TIKI,thoi-trang-nam,26106763,"Bộ 2 Vợt Bóng Bàn Chính Hãng miDoctor + Túi Đựng Vợt Bóng Bàn + 3 Bóng ",179000,179000,0,0
TIKI,thoi-trang-nam,191829779,"[Tặng Dây Đeo] Thảm Yoga Định Tuyến Cao Su Thiên Nhiên PU - YOGA QG, Chống Trơn Trượt, Độ Đàn Hồi Tốt, Mềm Mại, Thấm Hút Mồ Hôi, Đường Định Tuyến In Rõ Rét",351000,415000,64000,15
TIKI,thoi-trang-nam,79445921,"Custom Ring -1 vòng cao su Babolat băng cán vợt màu ngẫu nhiên  (710026)",33000,35000,2000,6
TIKI,thoi-trang-nam,190081204,"Kính bơi trẻ em POPO 360 góc nhìn PANORAMA bảo vệ mắt cản tia UV, hạn chế sương mờ ngăn nước tuyệt đối",82000,87000,5000,6
TIKI,thoi-trang-nam,34411016,"Đai bó đầu gối co dãn có đai cao cấp Sport AB30 - Đen trắng",79000,79000,0,0
TIKI,thoi-trang-nam,81926362,"1 CUỘN  CUỐN CÁN  PRO OVERGRIP - Quấn cán cuộn 15 (WRZ4017WH) 15 DÂY MÀU NGẪU NHIÊN",549000,590000,41000,7
TIKI,thoi-trang-nam,139055358,"Tạ Chì đeo chân và tay Tập Thể Lực loại tốt 2kg - 1 cặp - LYLYSPORTS",149000,149000,0,0
TIKI,thoi-trang-nam,87789122,"Balo cầu lông chính hãng ProKennex PRO21B01",648000,888000,240000,27
TIKI,the-thao-da-ngoai,26106763,"Bộ 2 Vợt Bóng Bàn Chính Hãng miDoctor + Túi Đựng Vợt Bóng Bàn + 3 Bóng ",179000,179000,0,0
TIKI,the-thao-da-ngoai,138171420,"Lồng lưới phơi khô thực phẩm phơi cá chống côn trùng treo 4 tầng để phơi cá khô có thể xếp gọn",54997,54997,0,0
TIKI,the-thao-da-ngoai,127947330,"Gậy Rung Đàn Hồi Tập Gym Tập Toàn Thân Cao Cấp Chính Hãng Đại Nam Sport",129000,200000,71000,36
TIKI,thoi-trang-nam,74152643,"Giày patin thê thao BEAR dành cho bé có 3 màu hấp dẫn",450000,450000,0,0
TIKI,thoi-trang-nam,58625585,"Quần Tập GYM Nam Cao Cấp SZone SQ492",69000,69000,0,0
TIKI,thoi-trang-nam,132815026,"Áo Bơi Nam Tay Dài Grey Navy Sobie",430000,430000,0,0
TIKI,the-thao-da-ngoai,58341210,"Khăn Trùm Mặt Che Nắng Đi Phượt Đa Năng Cao Cấp Vải Thoáng Khí, Mau Khô, Dễ Mặc Cho Nam Và Nữ Dành Cho Phượt Thủ - Mai Lee",65892,69360,3468,5
TIKI,the-thao-da-ngoai,166123372," Thanh rung thể thao đàn hồi có thể tháo rời Sportslink Feilishi Rod (Hàng loại 1)",222000,245000,23000,9
TIKI,the-thao-da-ngoai,188318508,"Dây Trục Câu Đài Buộc Sẵn 3260 Cước Câu Cá Tàng Hình Chuyên Câu Đài Cao Cấp DC28",7000,7000,0,0
TIKI,the-thao-da-ngoai,96211952,"Đai điều chỉnh cột sống AOLIKES A-3106 Back Posture Corrector chống gù lưng",292000,489000,197000,40
TIKI,thoi-trang-nam,188914638,"Quần Đùi Nam BIG SIZE FASVIN Từ 80 Đến 120KG Vải Gió Đẹp Hàng Nhà Máy Dùng Khi Thể Thao Hay Mặc Nhà D22173.HN",119000,238000,119000,50
TIKI,the-thao-da-ngoai,2431543,"Nón cổ động bóng đá các đội tuyển Sportslink - Brasil",42000,47000,5000,11
TIKI,the-thao-da-ngoai,179534840,"[SIÊU GỌN] PARALLETTES GỖ - DỤNG CỤ HÍT ĐẤT, CHỐNG ĐẨY",150000,150000,0,0
TIKI,thoi-trang-nam,24244892,"Đĩa Xoay Eo Sắt Tập Thể Dục Giảm Mỡ Bụng Thanh Xuân (Tặng 10 Khẩu Trang Màu Sắc Ngẫu Nhiên)",186000,186000,0,0
TIKI,thoi-trang-nam,88802057,"Bông Chuyên Dụng Zippo",37000,39000,2000,5
TIKI,the-thao-da-ngoai,183530633,"[Mẫu mới] Bộ quần áo bóng đá câu lạc bộ Real Madrid - Áo bóng đá chất vải thun lạnh, dệt kim cao cấp",95000,175000,80000,46
TIKI,the-thao-da-ngoai,158587773,"Balo túi rút chống nước bụi TSLA phù hợp đi tập Gym bơi lội chạy bộ chơi thể thao",60000,60000,0,0
TIKI,thoi-trang-nam,147962437,"Giày Bóng Bàn Cao Cấp Màu Xanh , Màu Trắng",520000,520000,0,0
TIKI,the-thao-da-ngoai,191829779,"[Tặng Dây Đeo] Thảm Yoga Định Tuyến Cao Su Thiên Nhiên PU - YOGA QG, Chống Trơn Trượt, Độ Đàn Hồi Tốt, Mềm Mại, Thấm Hút Mồ Hôi, Đường Định Tuyến In Rõ Rét",351000,415000,64000,15
TIKI,the-thao-da-ngoai,88802057,"Bông Chuyên Dụng Zippo",37000,39000,2000,5
TIKI,the-thao-da-ngoai,133933412,"[Combo] Xỏ Khuỷu Tay và Bó gối có miếng đệm bảo vệ - Hỗ trợ tập Yoga, Gym, chơi thể thao",127710,129000,1290,1
TIKI,the-thao-da-ngoai,185466935,"Khung Hỗ Trợ Tập Lưng, Nắn Chỉnh Cột Sống, Khung Định Hình Cột Sống, Hỗ Trợ Điều Trị Thoát Vị Đĩa Đệm, Đau Lưng, Vai Gáy - Chính Hãng Amalife",48000,48000,0,0
TIKI,the-thao-da-ngoai,186803059,"Quần Chạy Bộ Nam 2 Lớp DK22001 Có Túi Đựng Điện Thoại Bên hông,Túi Hậu Có Khóa Kéo",199000,199000,0,0
TIKI,thoi-trang-nam,133933412,"[Combo] Xỏ Khuỷu Tay và Bó gối có miếng đệm bảo vệ - Hỗ trợ tập Yoga, Gym, chơi thể thao",127710,129000,1290,1
TIKI,the-thao-da-ngoai,270766582,"Cần câu tay rút gọn 45cm đút cốp hạ lóng có thể thay đổi chiều dài cần tặng kèm ngọn phụ",320000,320000,0,0
TIKI,thoi-trang-nam,196960178,"Vòng tập Yoga bản rộng 33 x 20cm nhựa ABS cao cấp không gai , chịu lực 200kg hỗ trợ tập các tư thế khó trong Yoga ,  bề mặt TPE 8mm , phù hợp tập ở nhà và các CLB trung tâm Yoga",277000,295000,18000,6
TIKI,the-thao-da-ngoai,41825814,"GĂNG TAY THỂ THAO ADIDAS ADGB-1315",441000,456000,15000,3
TIKI,the-thao-da-ngoai,94930202,"Mồi Câu Cá Rô Phi , Combo 1kg Cám CNF + 1 Chai Tinh Mùi Thái Lan M21 Chuyên Câu Cá Rô Phi",115000,115000,0,0
TIKI,thoi-trang-nam,75345767,"Banh Bóng Rổ Da Geru Star Federation - Size 7 - Tặng kèm Balo rút + Bơm tay + Kim Bơm + Túi lưới",399000,399000,0,0
TIKI,thoi-trang-nam,94107848,"Bộ Quần Áo Gym Nam,Chạy Bộ,Chơi Thể ThaoTanktop Kết Hợp Quần 2 Lớp Và Áo 3 Lỗ",219000,219000,0,0
TIKI,the-thao-da-ngoai,190081204,"Kính bơi trẻ em POPO 360 góc nhìn PANORAMA bảo vệ mắt cản tia UV, hạn chế sương mờ ngăn nước tuyệt đối",82000,87000,5000,6
TIKI,the-thao-da-ngoai,24244892,"Đĩa Xoay Eo Sắt Tập Thể Dục Giảm Mỡ Bụng Thanh Xuân (Tặng 10 Khẩu Trang Màu Sắc Ngẫu Nhiên)",186000,186000,0,0
TIKI,the-thao-da-ngoai,132815026,"Áo Bơi Nam Tay Dài Grey Navy Sobie",430000,430000,0,0
TIKI,the-thao-da-ngoai,196960178,"Vòng tập Yoga bản rộng 33 x 20cm nhựa ABS cao cấp không gai , chịu lực 200kg hỗ trợ tập các tư thế khó trong Yoga ,  bề mặt TPE 8mm , phù hợp tập ở nhà và các CLB trung tâm Yoga",277000,295000,18000,6
TIKI,the-thao-da-ngoai,94107848,"Bộ Quần Áo Gym Nam,Chạy Bộ,Chơi Thể ThaoTanktop Kết Hợp Quần 2 Lớp Và Áo 3 Lỗ",219000,219000,0,0
TIKI,the-thao-da-ngoai,155759318,"Vành Mũ Bảo Hộ Che Nắng - Màu Ghi Đậm",45000,45000,0,0
TIKI,thoi-trang-nam,185466935,"Khung Hỗ Trợ Tập Lưng, Nắn Chỉnh Cột Sống, Khung Định Hình Cột Sống, Hỗ Trợ Điều Trị Thoát Vị Đĩa Đệm, Đau Lưng, Vai Gáy - Chính Hãng Amalife",48000,48000,0,0
TIKI,the-thao-da-ngoai,81926362,"1 CUỘN  CUỐN CÁN  PRO OVERGRIP - Quấn cán cuộn 15 (WRZ4017WH) 15 DÂY MÀU NGẪU NHIÊN",549000,590000,41000,7
TIKI,the-thao-da-ngoai,432921,"Kính Bơi Trẻ Em Balance F268 - Hồng",35000,35000,0,0
TIKI,the-thao-da-ngoai,139055358,"Tạ Chì đeo chân và tay Tập Thể Lực loại tốt 2kg - 1 cặp - LYLYSPORTS",149000,149000,0,0
TIKI,the-thao-da-ngoai,188914638,"Quần Đùi Nam BIG SIZE FASVIN Từ 80 Đến 120KG Vải Gió Đẹp Hàng Nhà Máy Dùng Khi Thể Thao Hay Mặc Nhà D22173.HN",119000,238000,119000,50
TIKI,the-thao-da-ngoai,79445921,"Custom Ring -1 vòng cao su Babolat băng cán vợt màu ngẫu nhiên  (710026)",33000,35000,2000,6
TIKI,the-thao-da-ngoai,74152643,"Giày patin thê thao BEAR dành cho bé có 3 màu hấp dẫn",450000,450000,0,0
TIKI,the-thao-da-ngoai,58625585,"Quần Tập GYM Nam Cao Cấp SZone SQ492",69000,69000,0,0
TIKI,thoi-trang-nam,794378,"Cầu Lông Nhựa A Ngắn OAN6 - Giao Màu Ngẫu Nhiên",85000,85000,0,0
TIKI,the-thao-da-ngoai,12723399,"Bóng Rổ Prostar size 7 màu cam tặng kèm kim bơm bóng",115000,169000,54000,32
TIKI,the-thao-da-ngoai,75345767,"Banh Bóng Rổ Da Geru Star Federation - Size 7 - Tặng kèm Balo rút + Bơm tay + Kim Bơm + Túi lưới",399000,399000,0,0
TIKI,the-thao-da-ngoai,43993416,"Viên Uống Giúp Tăng Tập Trung Và Tỉnh Táo - Mutant Caffeine Hộp 240 Viên",300000,300000,0,0
TIKI,the-thao-da-ngoai,147962437,"Giày Bóng Bàn Cao Cấp Màu Xanh , Màu Trắng",520000,520000,0,0
TIKI,the-thao-da-ngoai,794378,"Cầu Lông Nhựa A Ngắn OAN6 - Giao Màu Ngẫu Nhiên",85000,85000,0,0
TIKI,the-thao-da-ngoai,34411016,"Đai bó đầu gối co dãn có đai cao cấp Sport AB30 - Đen trắng",79000,79000,0,0
TIKI,the-thao-da-ngoai,156628745,"Cầu đá lông gà, Cầu đá ống tuyển trắng HD111 Sportslink",19000,21000,2000,10
TIKI,the-thao-da-ngoai,87789122,"Balo cầu lông chính hãng ProKennex PRO21B01",648000,888000,240000,27
TIKI,the-thao-da-ngoai,113056592,"Quần thể dục 3 sọc cho nam, đồ thể thao nam nữ các cấp, vải thun co giãn, thương hiệu Amazing",71000,114000,43000,38
TIKI,the-thao-da-ngoai,105619969,"[Chính Hãng BBT] Sữa Tăng Cân Tăng Cơ Labrada Muscle Mass Gainer (5.4kg)",1660000,1660000,0,0
TIKI,the-thao-da-ngoai,222705121,"Tạ Tay + Tạ Đẩy kết hợp (2 in 1), 20kg bộ sản phẩm",510000,510000,0,0
TIKI,the-thao-da-ngoai,50351507,"Vỏ bao cát boxing tập đấm bốc boxing mma dài 105cm, Ø=35cm + găng bao tay đấm bốc boxing mma + bằng đa boxing mma + full 7 món phụ kiện đi kèm",350000,350000,0,0
TIKI,the-thao-da-ngoai,71518366,"Quần thể thao nam nữ phối sọc có size đại",59000,59000,0,0
TIKI,the-thao-da-ngoai,194372515,"Giày tập thể thao nam Super Flexi Anta 812237701",799000,1359000,560000,41
TIKI,the-thao-da-ngoai,192139394,"Phao Câu Đài Săn Hàng DW tăm phao lớn, siêu nhạy, chống lóa mắt, mỏi mắt cao cấp PC12",53000,53000,0,0
TIKI,the-thao-da-ngoai,95200246,"Bình nước cứng thể thao, chạy bộ GoodFit dung tích 250ml GF03RA",25000,35000,10000,29
TIKI,the-thao-da-ngoai,178226148,"Combo 2 tạ tay nhựa đúc hoàn chỉnh - Tạ tay nhựa Việt Nam Sportslink",18000,20000,2000,10
TIKI,the-thao-da-ngoai,98032682,"Giảm rung Babolat phát ra tiếng kêu vi vu khi vung vợt, vung vợt càng nhanh , tiếng kêu càng lớn Vỉ : 2 cái 2 màu",166000,199000,33000,17
TIKI,the-thao-da-ngoai,161368303,"Giày Trượt Patin Trẻ Em, Giày Patin 4 Bánh Tặng Kèm Bảo Hộ cùng màu - Giày Batin khung hợp kim+ nhựa PP cứng chịu lực, chống mài mòn - Phù Hợp Cho Bé từ 5 tuổi trở lên",329000,329000,0,0
TIKI,the-thao-da-ngoai,51300180,"Ruột Zippo Gas Butane - Một Tia Lửa 65826",510000,510000,0,0
TIKI,the-thao-da-ngoai,58310856,"Bình Lắc Tập Gym Shaker Wave BiotechUSA - Hàng Chính Hãng",200000,200000,0,0
TIKI,the-thao-da-ngoai,149612981,"Ghế ngồi câu cá đài đa năng, ghế dã ngoại xếp gọn cao cấp giá rẻ",22100,22100,0,0
TIKI,the-thao-da-ngoai,117371966,"Bộ 5 dây ngũ sắc kháng lực tập Gym - Dây cao su kháng lực hỗ trợ tập toàn thân",265000,265000,0,0
TIKI,the-thao-da-ngoai,66721817,"Đai Bảo Vệ Đầu Gối Đàn Hồi Amber (1 Đôi)",89000,89000,0,0
TIKI,the-thao-da-ngoai,155624556,"Dụng cụ luyện vung vợt tennis racquet drop assistant",255500,255500,0,0
TIKI,the-thao-da-ngoai,48601188,"Xà đơn treo tường, gắn tường chốt chống xoay mẫu mới nhất(Màu ngẫu nhiễn-Mã TG)-2020",251000,329000,78000,24
TIKI,the-thao-da-ngoai,147209389,"Tạ Tay Thép King Box Loại 2.5KG",175000,175000,0,0
TIKI,the-thao-da-ngoai,115090166,"Vòng Tập YOGA Pilates Myring - YOGA QG, Nhựa ABS Cao Cấp, Hỗ Trợ Tập Yoga Và Massage Đa Năng",42750,45000,2250,5
TIKI,the-thao-da-ngoai,135537810,"Lọ chiết mỹ phẩm, dầu gội du lịch 60ml Colorful X4 ROBNLIFE LN641",29000,29000,0,0
TIKI,the-thao-da-ngoai,12102753,"Tạ tay nhựa 5kg (1 chiếc)",46000,51000,5000,10
TIKI,the-thao-da-ngoai,141299015,"Banh bóng chuyền da Parabol VB3300 - Loại da mềm - Quả bóng chuyền dán size 5",139000,139000,0,0
TIKI,the-thao-da-ngoai,51433824,"Giày Bata Vải Thể Thao Bình Minh",89900,89900,0,0
TIKI,the-thao-da-ngoai,116899852,"Mồi câu cá Lk Hòa | Thính Lk Câu cá chép trắm trôi siêu nhạy",50000,50000,0,0
TIKI,the-thao-da-ngoai,170097878,"Parallettes - Dụng cụ hỗ trợ hít đất, chống đẩy (Một đôi)",129000,129000,0,0
TIKI,the-thao-da-ngoai,170753798,"Mũ Rộng Vành Dã Ngoại Naturehike NH17M005-A",220000,220000,0,0
TIKI,the-thao-da-ngoai,707405,"Thảm Tập Gym Và Yoga TPE 2 Lớp 6MM2L (6mm) - Tím",75000,75000,0,0
TIKI,the-thao-da-ngoai,33393166,"Bộ Giày Trượt Patin Đại Nam Sport T20096 Bánh  Phát Sáng + Kèm bảo hộ (Chân,tay, mũ bảo hiểm)",569000,600000,31000,5
TIKI,the-thao-da-ngoai,114819576,"Bộ quần áo bóng đá đội tuyển quốc gia Việt Nam 2021 - Đồ bóng đá tuyển Việt Nam- Bộ đồ bóng đá đẹp",95000,150000,55000,37
TIKI,the-thao-da-ngoai,104100270,"Thiết Bị Phục Hồi Chức Năng Zasami KZ cải tiến có đai giữ cố định người bệnh 3 trong 1 ",2800000,3590000,790000,22
TIKI,the-thao-da-ngoai,198111491,"SET 3 dây tập gym, tập mông mini band GoodFit GF914MB",99000,99000,0,0
TIKI,the-thao-da-ngoai,160745517,"Giày Chạy Bộ Nữ Biti's Hunter Running TIGER DSWH08300CAM (Cam)",736000,981000,245000,25
TIKI,the-thao-da-ngoai,57789139,"Túi đeo hông, đai chạy bộ nhiều ngăn chống nước, có phản quang Goodfit GF102RB",129000,200000,71000,36
TIKI,the-thao-da-ngoai,54387636,"Bóng Tập Yoga, Bóng Yoga Tròn Cỡ Đại 65cm Cao Cấp - Chính Hãng (Hàng nhập khẩu)",154000,200000,46000,23
TIKI,the-thao-da-ngoai,108883244,"Cặp vợt cầu lông giá rẻ chất lượng 7588 - ",350000,350000,0,0
TIKI,the-thao-da-ngoai,20996392,"Bộ 5 mồi câu cá giả hình tôm có kèm lưỡi câu - Màu ngẫu nhiên",17000,17000,0,0
TIKI,the-thao-da-ngoai,3661963,"Sữa tăng cân MASS TECH EXTREME 2000 của MuscleTech hương chocolate thùng 10kg",2795000,3600000,805000,22
TIKI,the-thao-da-ngoai,11947863,"Xà đơn treo tường ",84440,84440,0,0
TIKI,the-thao-da-ngoai,149597911,"Hộp Lưỡi Câu Cá ,Lưỡi Câu Đơn,Lưỡi Câu Đài, Lưỡi Câu Chép,Rô Phi",12200,12200,0,0
TIKI,thoi-trang-nam,177477747,"MLB - Áo thun phom suông ngắn tay Diamond Monogram 3ATSM3023",2490000,2490000,0,0
TIKI,thoi-trang-nam,181169393,"Áo khoác hoodie nam nữ mặc được hình mặt cười cực đẹp",120000,120000,0,0
TIKI,thoi-trang-nam,149642389,"Quần nỉ lót lông cừu jogger, quần jogger nỉ lông nam nữ cao cấp, vải trơn không xù giữ ấm mùa đông",377000,377000,0,0
TIKI,thoi-trang-nam,59519839,"QUẦN LÓT BOXER NAM ROSSO - APPLE 0303",39000,39000,0,0
TIKI,thoi-trang-nam,110751081,"Quần Jean Baggy nam đen+ xanh sky rách gấu+ rách gối style hàn quốc 2021",59000,59000,0,0
TIKI,thoi-trang-nam,183736730,"Quần kaki dài nam việt tiến màu be không ly 6R6020 Regular",665000,665000,0,0
TIKI,thoi-trang-nam,194099667,"Quần short kaki nam cao cấp, dáng đứng form, chất liệu mềm mại thoáng mát - FORMENSHOP - FMQL014",175000,350000,175000,50
TIKI,thoi-trang-nam,103382821,"Quần Short Gió Nam 5S (4 màu) Vải Mềm, Siêu Nhẹ, Dáng Thể Thao",46000,46000,0,0
TIKI,thoi-trang-nam,163580450,"Áo Sơ Mi Nam Công sở Trung Niên Ngắn Tay Thương Hiệu Anton Kẻ Caro Màu Nâu Sợi Tre Thấm Hút NC135",295000,425000,130000,31
TIKI,thoi-trang-nam,185709557,"Áo thun Polo nam Novelty màu đỏ in họa tiết NATMHTMPSR190213N",227000,239000,12000,5
TIKI,thoi-trang-nam,8822029,"Áo Khoác Da Nam Thái AKD125",199000,199000,0,0
TIKI,thoi-trang-nam,90063534,"Áo khoác sơ mi nam , áo sơ mi nam , áo khoác nam kiểu sơ mi vải dù",118000,118000,0,0
TIKI,thoi-trang-nam,47815627,"Combo 2 Quần shorts thể thao nam ( Tặng 1 áo thun nam ngẫu nhiên theo cân nặng ) dạng sọt sport đùi chất thun lạnh 4 chiều cao cấp phù hợp tập gym hay mặc nhà màu trắng và đen DUI-P101",174000,255000,81000,32
TIKI,thoi-trang-nam,88081909,"Quần Áo Thể Thao, Sét Bộ Thể Thao Nam DINKBHAYS, Bộ Đồ Thể Thao Nam Chất Đẹp, Đồ bộ thể thao nam, set quần áo thể thao nam nữ mặc nhà Unisex tay ngắn phong cách Ulzzang, Set Bộ Quần Áo Thể Thao Nam Mùa hè Co Dãn, SÉT ĐỒ BỘ THỂ THAO MẶC NHÀ, đồ bộ mặc nhà ",99000,99000,0,0
TIKI,thoi-trang-nam,91955446," ÁO SƠ MI NAM THÊU CON ONG TAY DÀI",99000,99000,0,0
TIKI,thoi-trang-nam,117922480,"Áo phông nam nữ unisex tay lỡ thun form rộng teen cổ tròn oversize cotton giá rẻ basic đen trắng tee pull freesize KHỦNG LONG DỄ THƯƠNG",55000,55000,0,0
TIKI,thoi-trang-nam,197629059,"COUPLE TX - Áo Khoác Nam Anti UV MOK 1025",699000,699000,0,0
TIKI,thoi-trang-nam,90723093,"Áo Khoác Big Size Nam Nữ Áo Khoác Dù Nam Nữ Chống Nắng Chống Nóng Chống Tia Cực Tím UV Chống Lạnh Gió Hàn Quốc Cao Cấp ShopN6 - TM19",149000,169000,20000,12
TIKI,thoi-trang-nam,95071979,"Quần Short Jean Nam co dãn kiểu dáng trẻ trung đơn giản Thương Hiệu Chandi, quần sọt mẫu mới xu hướng QSJN250",176000,299000,123000,41
TIKI,thoi-trang-nam,160609387,"Quần lót nam sexy STUD Underwear U1044BJS21",965000,965000,0,0
TIKI,thoi-trang-nam,117902589,"ÁO HOODIE NÓN NAM NỮ MÀU ĐEN VẢI NỈ POLY IN SÚNG NƯỚC Unisex hoodie,Áo Khoác Nỉ Hoodie In Datlity, Áo Khoác Nỉ Hoodie Unisex Nam Nữ Cao Cấp",100000,100000,0,0
TIKI,thoi-trang-nam,159054187,"ÁO KHOÁC BOMBER NAM NỮ CỰC CHẤT",108000,108000,0,0
TIKI,thoi-trang-nam,193738850,"Áo Thun Local Brand Teeworld Love Yourself Premium T-shirt Nam Nữ Form Rộng Unisex",350000,350000,0,0
TIKI,thoi-trang-nam,163543299,"Áo Thun Nam PoLo Ngắn Tay 8 Màu Thời Trang Cao Cấp AVIANO",129000,258000,129000,50
TIKI,thoi-trang-nam,91929124,"Áo Sơ Mi Nam Rồng Họa Tiết",95000,95000,0,0
TIKI,thoi-trang-nam,82947907,"Bộ Mặc Nhà Thể Thao Nam Chất Liệu Cao Cấp Mùa Hè 4 Màu ZERO",199000,300000,101000,34
TIKI,thoi-trang-nam,71153341,"Áo thun nam ngắn tay cổ tim cúc ngực thời trang Sitaki cao cấp ATN04-5 màu",80000,80000,0,0
TIKI,thoi-trang-nam,94522304,"Quần tây truyền thông Amazing, ống xuông, không ly, vải dày có vân chìm, thấm hút tốt, có size lớn 105kg",325000,499000,174000,35
TIKI,thoi-trang-nam,115093792,"Sịp đùi- Quần lót nam boxer băng lụa kháng khuẩn siêu thoáng khí K118",69000,69000,0,0
TIKI,thoi-trang-nam,14838760,"Áo thun nam tay dài thời trang Hàn Quốc MT-01",75000,75000,0,0
TIKI,thoi-trang-nam,193978418,"Quần Jean nam Leman xám khói trơn JD13 - Slim Form",455000,549000,94000,17
TIKI,thoi-trang-nam,117184946,"Áo sơ mi nam trắng, sơ mi Nano cao cấp CAVINO SMT0365 chống nhăn chống nhàu, thấm hút mồ hôi thoáng khí",99000,99000,0,0
TIKI,thoi-trang-nam,99482495,"Quần kaki nam trơn basic cao cấp vải kaki xịn hàng xuất dư Phuongnamshop20 z31",199000,199000,0,0
TIKI,thoi-trang-nam,160609382,"Quần lót nam sexy STUD Jockstrap U1051AJS02",965000,965000,0,0
TIKI,thoi-trang-nam,91003470," Quần Baggy Ống Rộng - Quần Jean Nam - CHuẩn Hotboy Hàn quốc",168000,168000,0,0
TIKI,thoi-trang-nam,136008180," [HCM]Áo Thun Nam Có Túi Trung Niên Loại Trơn Cổ Bẻ From Rộng Tay Lỡ SUNMEN ATNTN001 Đủ Màu Size Từ 50 - 85kg,Áo thun phù hợp đi chơi,đi làm,mặc nhà thoáng mát",65000,65000,0,0
TIKI,thoi-trang-nam,7252979,"Áo thun nam cổ tròn 100% cotton cao cấp Doka CT-01 ( Xám lợt )",104000,104000,0,0
TIKI,thoi-trang-nam,94879183,"Áo sơ mi ngắn tay việt tiến màu đỏ đô",300000,300000,0,0
TIKI,thoi-trang-nam,117583112,"ÁO KHOÁC BOMBER NAM CHẤT LIỆU DÙ CAO CẤP THỜI TRANG NAM 2021",155000,155000,0,0
TIKI,thoi-trang-nam,13306746,"Quần Jogger Nam Ống Bó Thời Trang Hàn Quốc JOGGER04",49000,49000,0,0
TIKI,cross-border-hang-quoc-te,177477747,"MLB - Áo thun phom suông ngắn tay Diamond Monogram 3ATSM3023",2490000,2490000,0,0
TIKI,cross-border-hang-quoc-te,183736730,"Quần kaki dài nam việt tiến màu be không ly 6R6020 Regular",665000,665000,0,0
TIKI,cross-border-hang-quoc-te,181169393,"Áo khoác hoodie nam nữ mặc được hình mặt cười cực đẹp",120000,120000,0,0
TIKI,cross-border-hang-quoc-te,103382821,"Quần Short Gió Nam 5S (4 màu) Vải Mềm, Siêu Nhẹ, Dáng Thể Thao",46000,46000,0,0
TIKI,cross-border-hang-quoc-te,149642389,"Quần nỉ lót lông cừu jogger, quần jogger nỉ lông nam nữ cao cấp, vải trơn không xù giữ ấm mùa đông",377000,377000,0,0
TIKI,cross-border-hang-quoc-te,59519839,"QUẦN LÓT BOXER NAM ROSSO - APPLE 0303",39000,39000,0,0
TIKI,cross-border-hang-quoc-te,194099667,"Quần short kaki nam cao cấp, dáng đứng form, chất liệu mềm mại thoáng mát - FORMENSHOP - FMQL014",175000,350000,175000,50
TIKI,cross-border-hang-quoc-te,94522304,"Quần tây truyền thông Amazing, ống xuông, không ly, vải dày có vân chìm, thấm hút tốt, có size lớn 105kg",325000,499000,174000,35
TIKI,cross-border-hang-quoc-te,110751081,"Quần Jean Baggy nam đen+ xanh sky rách gấu+ rách gối style hàn quốc 2021",59000,59000,0,0
TIKI,cross-border-hang-quoc-te,91003470," Quần Baggy Ống Rộng - Quần Jean Nam - CHuẩn Hotboy Hàn quốc",168000,168000,0,0
TIKI,cross-border-hang-quoc-te,163580450,"Áo Sơ Mi Nam Công sở Trung Niên Ngắn Tay Thương Hiệu Anton Kẻ Caro Màu Nâu Sợi Tre Thấm Hút NC135",295000,425000,130000,31
TIKI,cross-border-hang-quoc-te,193738850,"Áo Thun Local Brand Teeworld Love Yourself Premium T-shirt Nam Nữ Form Rộng Unisex",350000,350000,0,0
TIKI,cross-border-hang-quoc-te,160609382,"Quần lót nam sexy STUD Jockstrap U1051AJS02",965000,965000,0,0
TIKI,cross-border-hang-quoc-te,117922480,"Áo phông nam nữ unisex tay lỡ thun form rộng teen cổ tròn oversize cotton giá rẻ basic đen trắng tee pull freesize KHỦNG LONG DỄ THƯƠNG",55000,55000,0,0
TIKI,cross-border-hang-quoc-te,136008180," [HCM]Áo Thun Nam Có Túi Trung Niên Loại Trơn Cổ Bẻ From Rộng Tay Lỡ SUNMEN ATNTN001 Đủ Màu Size Từ 50 - 85kg,Áo thun phù hợp đi chơi,đi làm,mặc nhà thoáng mát",65000,65000,0,0
TIKI,cross-border-hang-quoc-te,193978418,"Quần Jean nam Leman xám khói trơn JD13 - Slim Form",455000,549000,94000,17
TIKI,cross-border-hang-quoc-te,90723093,"Áo Khoác Big Size Nam Nữ Áo Khoác Dù Nam Nữ Chống Nắng Chống Nóng Chống Tia Cực Tím UV Chống Lạnh Gió Hàn Quốc Cao Cấp ShopN6 - TM19",149000,169000,20000,12
TIKI,cross-border-hang-quoc-te,91955446," ÁO SƠ MI NAM THÊU CON ONG TAY DÀI",99000,99000,0,0
TIKI,cross-border-hang-quoc-te,117902589,"ÁO HOODIE NÓN NAM NỮ MÀU ĐEN VẢI NỈ POLY IN SÚNG NƯỚC Unisex hoodie,Áo Khoác Nỉ Hoodie In Datlity, Áo Khoác Nỉ Hoodie Unisex Nam Nữ Cao Cấp",100000,100000,0,0
TIKI,cross-border-hang-quoc-te,8822029,"Áo Khoác Da Nam Thái AKD125",199000,199000,0,0
TIKI,cross-border-hang-quoc-te,47815627,"Combo 2 Quần shorts thể thao nam ( Tặng 1 áo thun nam ngẫu nhiên theo cân nặng ) dạng sọt sport đùi chất thun lạnh 4 chiều cao cấp phù hợp tập gym hay mặc nhà màu trắng và đen DUI-P101",174000,255000,81000,32
TIKI,cross-border-hang-quoc-te,95071979,"Quần Short Jean Nam co dãn kiểu dáng trẻ trung đơn giản Thương Hiệu Chandi, quần sọt mẫu mới xu hướng QSJN250",176000,299000,123000,41
TIKI,cross-border-hang-quoc-te,117184946,"Áo sơ mi nam trắng, sơ mi Nano cao cấp CAVINO SMT0365 chống nhăn chống nhàu, thấm hút mồ hôi thoáng khí",99000,99000,0,0
TIKI,cross-border-hang-quoc-te,82947907,"Bộ Mặc Nhà Thể Thao Nam Chất Liệu Cao Cấp Mùa Hè 4 Màu ZERO",199000,300000,101000,34
TIKI,cross-border-hang-quoc-te,163543299,"Áo Thun Nam PoLo Ngắn Tay 8 Màu Thời Trang Cao Cấp AVIANO",129000,258000,129000,50
TIKI,cross-border-hang-quoc-te,185709557,"Áo thun Polo nam Novelty màu đỏ in họa tiết NATMHTMPSR190213N",227000,239000,12000,5
TIKI,cross-border-hang-quoc-te,91929124,"Áo Sơ Mi Nam Rồng Họa Tiết",95000,95000,0,0
TIKI,cross-border-hang-quoc-te,90063534,"Áo khoác sơ mi nam , áo sơ mi nam , áo khoác nam kiểu sơ mi vải dù",118000,118000,0,0
TIKI,cross-border-hang-quoc-te,88081909,"Quần Áo Thể Thao, Sét Bộ Thể Thao Nam DINKBHAYS, Bộ Đồ Thể Thao Nam Chất Đẹp, Đồ bộ thể thao nam, set quần áo thể thao nam nữ mặc nhà Unisex tay ngắn phong cách Ulzzang, Set Bộ Quần Áo Thể Thao Nam Mùa hè Co Dãn, SÉT ĐỒ BỘ THỂ THAO MẶC NHÀ, đồ bộ mặc nhà ",99000,99000,0,0
TIKI,cross-border-hang-quoc-te,14838760,"Áo thun nam tay dài thời trang Hàn Quốc MT-01",75000,75000,0,0
TIKI,cross-border-hang-quoc-te,197629059,"COUPLE TX - Áo Khoác Nam Anti UV MOK 1025",699000,699000,0,0
TIKI,cross-border-hang-quoc-te,94879183,"Áo sơ mi ngắn tay việt tiến màu đỏ đô",300000,300000,0,0
TIKI,cross-border-hang-quoc-te,99482495,"Quần kaki nam trơn basic cao cấp vải kaki xịn hàng xuất dư Phuongnamshop20 z31",199000,199000,0,0
TIKI,cross-border-hang-quoc-te,7252979,"Áo thun nam cổ tròn 100% cotton cao cấp Doka CT-01 ( Xám lợt )",104000,104000,0,0
TIKI,cross-border-hang-quoc-te,117583112,"ÁO KHOÁC BOMBER NAM CHẤT LIỆU DÙ CAO CẤP THỜI TRANG NAM 2021",155000,155000,0,0
TIKI,cross-border-hang-quoc-te,160609387,"Quần lót nam sexy STUD Underwear U1044BJS21",965000,965000,0,0
TIKI,cross-border-hang-quoc-te,159054187,"ÁO KHOÁC BOMBER NAM NỮ CỰC CHẤT",108000,108000,0,0
TIKI,cross-border-hang-quoc-te,13306746,"Quần Jogger Nam Ống Bó Thời Trang Hàn Quốc JOGGER04",49000,49000,0,0
TIKI,cross-border-hang-quoc-te,71153341,"Áo thun nam ngắn tay cổ tim cúc ngực thời trang Sitaki cao cấp ATN04-5 màu",80000,80000,0,0
TIKI,cross-border-hang-quoc-te,76173405,"4pcs/Set Waterproof Golf Club Head Cover NO. 13 5 UT Wood Driver Headcover",630000,630000,0,0
TIKI,cross-border-hang-quoc-te,115093792,"Sịp đùi- Quần lót nam boxer băng lụa kháng khuẩn siêu thoáng khí K118",69000,69000,0,0
TIKI,cross-border-hang-quoc-te,184628639,"Diving Fill Arm Ball Head Bracket Arm Underwater Connector Ball Head Extension Buoyancy Arm Action Camera Photography Bracket Equipment",288000,288000,0,0
TIKI,cross-border-hang-quoc-te,113949342,"Máy rút khăn giấy nhà bếp, nhà vệ sinh-Màu đen",243000,243000,0,0
TIKI,cross-border-hang-quoc-te,253000066,"Smart Watch Bluetooth  Monitor Digital Smartwatch for Men Women Black",277000,277000,0,0
TIKI,cross-border-hang-quoc-te,97450699,"480x Electrical Connector Assorted Insulated Crimp Terminals",391000,391000,0,0
TIKI,cross-border-hang-quoc-te,249408325,"Small Rolling Salon Stool Rotatable Furniture Gift Movable for Salon Garage",673000,673000,0,0
TIKI,cross-border-hang-quoc-te,170700535,"Sách - Rescue and Jessica: A Life-Changing Friends by Jessica Kensky Patrick Downes Scott Magoon (US edition, paperback)",303000,303000,0,0
TIKI,cross-border-hang-quoc-te,109699314,"Giá đỡ điện thoại di động trên ô tô-Màu đỏ",168700,168700,0,0
TIKI,cross-border-hang-quoc-te,122084481,"Bàn phím Nec LL750 / FS LL750 / ES LL850 / ES6W LL770, màu trắng và đen",606500,606500,0,0
TIKI,cross-border-hang-quoc-te,46343145,"Vải Da May Giày Công Cụ Sửa Chữa Bộ Awl Khâu Tay Leathercraft Kim Bộ Dụng Cụ Da Thủ Công MaY Tiếp Liệu",150000,150000,0,0
TIKI,cross-border-hang-quoc-te,115282372,"Bình đựng thực phẩm bằng thép không gỉ 304 với van CO2-Màu Bạc-Size",350000,350000,0,0
TIKI,cross-border-hang-quoc-te,150120213,"Túi đựng xe scooter điện cỡ lớn 10 inch có thể gấp gọn tiện dụng
",755058,755058,0,0
TIKI,cross-border-hang-quoc-te,203961420,"US Power Extension Cord Cable 5-15P to 5-15R Universal Multifunctional",154000,154000,0,0
TIKI,cross-border-hang-quoc-te,51221827,"Công Cụ Mát Xa Bằng Gỗ Mô Sâu Scigger Point Massage Toàn Thân",112000,112000,0,0
TIKI,cross-border-hang-quoc-te,111389734,"Túi đeo ngực thời trang MARK RYDEN cho nam giới-Màu đen-Size",412000,412000,0,0
TIKI,cross-border-hang-quoc-te,170726234,"Sách - Everything Is F*cked : A Book About Hope by Mark Manson (US edition, paperback)",624000,624000,0,0
TIKI,cross-border-hang-quoc-te,253435456,"Lige không xâm lấn đường huyết thông minh đồng hồ nam ECG Nhiệt kế nhịp tim Nhiệt kế máy đo nhiệt kế 1.91 inch HD thể thao không thấm nước smartwatch",1261611,1261611,0,0
TIKI,cross-border-hang-quoc-te,95721716,"Cặp đệm tai thay thế cho tai nghe marshall major On",263250,263250,0,0
TIKI,cross-border-hang-quoc-te,95712958,"Đèn Led Phá Sương Mù H11 5630 33snd Chất Lượng Cao",315900,315900,0,0
TIKI,cross-border-hang-quoc-te,94963411,"Car Key Signal Blocker Case Faraday Cage Fob Pouch RFID Blocking Bag, Black",175000,175000,0,0
TIKI,cross-border-hang-quoc-te,170602874,"Sách - Whisky A Tasting Course : A New Way to Think - and Drink - Whisky by Eddie Ludlow (UK edition, hardcover)",863000,863000,0,0
TIKI,cross-border-hang-quoc-te,96613101,"Adults Rubber Open Mouth O Ring Gag Body Restraints Adjustable Strap Costume",196000,196000,0,0
TIKI,cross-border-hang-quoc-te,158006136,"Sách - Ikigai: The Japanese secret to a long and happy life by Hector Garcia,Francesc Miralles - (US Edition, hardcover)",481000,481000,0,0
TIKI,cross-border-hang-quoc-te,205659709,"Trailer  Toolbox Handle  Door Lock 85x75mm",268000,268000,0,0
TIKI,cross-border-hang-quoc-te,250418831,"Máy bay không người lái gấp thuận lợi nhất LSRC-XT6 mini chiều cao cố định máy bay bốn trục ống kính kép máy bay đồ chơi điều khiển từ xa",303000,303000,0,0
TIKI,cross-border-hang-quoc-te,188728290,"Áo khoác thể thao CAMEL T0S218149 chống nắng/ chống tia UV thoáng khí cho nam",830000,830000,0,0
TIKI,cross-border-hang-quoc-te,92528432,"Dầu lăn chống ngứa Xiaomi Mijia khi bị muỗi/ cô trùng cắn chiết xuất từ thực vật, Phù hợp cho trẻ sơ sinh Phụ nữ mang thai Người lớn",145000,249000,104000,42
TIKI,cross-border-hang-quoc-te,253568179,"VGA Swicther Box 2 In 1 Out with Manual Switch Button 1920x1440 for Computer",113000,113000,0,0
TIKI,cross-border-hang-quoc-te,114049525,"Sách - They Both Die at the End by Adam Silvera - (UK Edition, paperback)",361000,361000,0,0
TIKI,cross-border-hang-quoc-te,17966899,"Ego Is The Enemy",464000,464000,0,0
TIKI,cross-border-hang-quoc-te,51674774,"Tấm Trải Giường Massage Toàn Cầu SPA Với Lỗ Thở Mặt",172000,172000,0,0
TIKI,cross-border-hang-quoc-te,52832681,"3 Phù Dây Chỉnh Chốt Chỉnh Âm Hoa Nút Cho Guitar Cổ Điển 3R 3L",176000,176000,0,0
TIKI,cross-border-hang-quoc-te,177989535,"2Pcs Mens G-string Underwear Hollow Ring Pouch Jockstrap Thong Briefs",193000,193000,0,0
TIKI,cross-border-hang-quoc-te,177081630,"Sách - Tales from the Cafe : Before the Coffee Gets Cold by Toshikazu Kawaguchi (UK edition, paperback)",343000,343000,0,0
TIKI,cross-border-hang-quoc-te,134780405,"Sách - Find Me André Aciman by Andre Aciman - (UK Edition, paperback)",389000,389000,0,0
TIKI,cross-border-hang-quoc-te,159034159,"Sách - The Laws of Human Nature by Robert Greene - (US Edition, paperback)",978000,978000,0,0
TIKI,cross-border-hang-quoc-te,94961199,"Camel Toe Hiding Gaff Panty Shaping Brief For Crossdresser Transgender",244000,244000,0,0
TIKI,cross-border-hang-quoc-te,249063627,"Tuya Wifi 7in1 Máy đo chất lượng không khí đa chức năng PM2.5 CO2 TVOC HCHO AQI Máy kiểm tra độ ẩm nhiệt độ Màn hình màu di động Máy dò khí carbon dioxide với chức năng ngưỡng báo động",632000,632000,0,0
TIKI,cross-border-hang-quoc-te,17964242,"Girl In Pieces",429000,429000,0,0
TIKI,cross-border-hang-quoc-te,46337174,"Footful 1 Xoay Vali Hành Lý Bánh Xe Thay Thế Bánh Đúc Cho Xe Đẩy Đen-Lắp Đặt Dễ Dàng",182000,182000,0,0
TIKI,thoi-trang-nam,55353337,"Áo thun nam nữ form rộng tay lỡ Unisex Hinerets dưới 69kg",89000,89000,0,0
TIKI,thoi-trang-nam,91929167," Áo Sơ Mi Nam PHối Màu Họa Tiết US ARMY",99000,99000,0,0
TIKI,thoi-trang-nam,109783750,"Áo thun nam nữ unisex tay lỡ phông form rộng teen cổ tròn oversize cotton giá rẻ basic đen trắng tee pull YOUNG BOY",45000,45000,0,0
TIKI,thoi-trang-nam,20737439,"Áo khoác gió cách nhiệt GOKING, có mũ dấu sau cổ. Form unisex cho nam nữ. Ngoài vải dù, trong lót vải cào cao cấp. Chống nắng gió bụi",255000,255000,0,0
TIKI,thoi-trang-nam,87010975,"Áo Thun Nam Ngắn Tay Chandi, Chất Thun Cotton Xịn Mẫu Mới NT17",123000,199000,76000,38
TIKI,thoi-trang-nam,46486493,"Áo thun nam nữ form rộng tay lỡ Unisex Hi Freesize dưới 69kg",30000,30000,0,0
TIKI,thoi-trang-nam,174593731,"Quần Short NamThể Thao Thanh Lịch US ARMY 8898 Trẻ Trung, Năng Động, Nam Tính -HÀNG CHÍNH HÃNG",100000,300000,200000,67
TIKI,thoi-trang-nam,101655941,"Áo Măng Tô Nam Dáng Dài - Áo Khoác Dạ Nam Dài Sans13 Sans Shop San Shop",499000,499000,0,0
TIKI,thoi-trang-nam,114536014,"Combo 3 quần lót nam thun boxer Espresso iBasic PANM103",228000,297000,69000,23
TIKI,thoi-trang-nam,140464696,"Áo Sơ Mi Nam Dài Tay Họa Tiết Caro Màu Xanh Lá Mẫu Không lên lai Thời Trang PONIVA Chất Vải Mềm Mại Thấm Hút Mồ Hôi",97500,97500,0,0
TIKI,thoi-trang-nam,46698977,"Quần jogger nam phối dây kéo Phúc An 1068 màu",129000,129000,0,0
TIKI,thoi-trang-nam,84903806,"QUẦN LÓT BOXER NAM ROSSO 0001 - UNDERWEAR",120000,120000,0,0
TIKI,thoi-trang-nam,163545116,"Áo Phông Nam PoLo Ngắn Tay 8 Màu Thời Trang AVIANO",129000,258000,129000,50
TIKI,thoi-trang-nam,105663776,"Quần lót nam boxer ren lưới thoáng mát - A064",99000,99000,0,0
TIKI,thoi-trang-nam,7045887,"Áo khoác nam cá tính  3313 nhiều màu",449000,449000,0,0
TIKI,thoi-trang-nam,19701519,"Áo sơ mi nam tay dài SMH102",104000,104000,0,0
TIKI,thoi-trang-nam,11270937,"Áo thun nam dài tay cổ sơ mi SITAKI - ATD01",130000,130000,0,0
TIKI,thoi-trang-nam,48622497,"Áo Hoodie Nỉ trơn đơn giản cá tính",89000,89000,0,0
TIKI,thoi-trang-nam,137666840,"Áo Khoác Nhung Gân Tăm Bomber Jackets Thêu Logo G.O.N.Z Cúc Bấm Unisex Nam Nữ Form Rộng Ulzzang",152000,152000,0,0
TIKI,thoi-trang-nam,66611059,"Áo sơ mi đũi nam cổ trụ tay ngắn 3 khuy ngực ArcticHunter, thời trang trẻ, thương hiệu chính hãng",189000,189000,0,0
TIKI,thoi-trang-nam,72568280,"Áo thun nam dài tay cổ tròn mặc thu đông, giữ nhiệt, chất cotton co giãn, dáng ôm, nhiều màu lựa chọn, không bai xù, giặt được máy giặt",114400,114400,0,0
TIKI,thoi-trang-nam,95056670,"Áo khoác dù 7Zia - Trắng/Đen, ÁO 7ZIA Windbreaker Jacket, ÁO KHOÁC DÙ BOMBER NAM NỮ",99000,99000,0,0
TIKI,thoi-trang-nam,172474618,"Áo Polo Nam Ngắn Tay 5 Màu Thiết Kế Thời Trang Cao Cấp  ZERO",100000,200000,100000,50
TIKI,thoi-trang-nam,162844085,"Áo Sơ Mi Nam Công Sở Trung Niên thương hiệu Anton Ngắn Tay màu Xanh Tím Than Vải Cotton Họa Tiết Hoa Nhí – X809",325000,325000,0,0
TIKI,thoi-trang-nam,74151584,"Quần tây nam Amazing màu đen và xanh đen, size 28 đến 40, form công sở truyền thống, không ly, ống suông",325000,499000,174000,35
TIKI,thoi-trang-nam,52274294,"QUẦN LÓT NAM CAO CẤP, QUẦN SỊP NAM chất cotton thấm hút mồ hôi, khử mùi kháng khuẩn L-28990",69000,69000,0,0
TIKI,thoi-trang-nam,167473781,"Áo Polo Nam Nanh Sói 3 Màu Phong Cách Thời Trang Thiết Kế AVIANO",129000,258000,129000,50
TIKI,thoi-trang-nam,183948383,"Áo khoác Nam, Áo khoác nam phối cổ Vest trẻ trung, và năng động. Mặc vừa đi làm, vừa đi chơi. Mã T8",270000,270000,0,0
TIKI,thoi-trang-nam,181787243,"Áo thun lót trắng nam cổ tim 100% cotton loại 1",55000,55000,0,0
TIKI,thoi-trang-nam,53281166,"Áo gile nam ôm body màu đen chất liệu vải dày mịn",199000,398000,199000,50
TIKI,thoi-trang-nam,163904210,"Áo Sơ Mi Nam Ngắn Tay Anton Công Sở Trung Niên Vải Cotton Màu Xanh Dương Kẻ Trắng – XGD553",265000,355000,90000,25
TIKI,thoi-trang-nam,118020324,"Đồ Lam Đi Chùa # Xéo Nhật Viền Nam # Đồ Bộ Nam # Quần Áo Nam",210000,210000,0,0
TIKI,thoi-trang-nam,163034644,"Áo Sơ Mi Nam Công Sở Trung Niên Ngắn Tay Anton Màu Xanh Than Thoáng Mát, Thấm Hút Mồ Hôi - NC130",295000,405000,110000,27
TIKI,thoi-trang-nam,98625491,"Quần Short Nam Rách️️ Quần Short Bò Nam Cao Cấp - Sọt Jean Co Giãn Mẫu Mới Hàng VNXK Tô Tồ Shop-QSJN10-Mã 204",179000,179000,0,0
TIKI,thoi-trang-nam,170498978,"Bộ Quần Áo Thể Thao Nam Cao Cấp Nhiều Màu Thời Trang Thiết Kế AVIANO",269000,458000,189000,41
TIKI,thoi-trang-nam,111710567,"Áo Thun Nam Áo Thun Nam Cổ Polo phối hai sọc thẳng trắng Thiết kế trẻ trung, năng động và lịch lãm",125000,125000,0,0
TIKI,thoi-trang-nam,83638546,"Hộp 3 quần sịp nam boxer 5D cao cấp ",44788,44788,0,0
TIKI,thoi-trang-nam,52657053,"Combo bộ vest nam 1 nút và gile ôm body màu đen chất liệu co dãn , thoáng mát  tặng kèm combo phụ kiện",850000,1700000,850000,50
TIKI,thoi-trang-nam,58613402,"QUẦN LÓT NAM ROSSO",79000,79000,0,0
TIKI,thoi-trang-nam,36194934,"áo thun polo nam tay lỡ chính hãng dokafashion dáng thể thao nam cao cấp được thuê logo sắc xảo  sắc tông màu cơ bản -combo 3 áo xám trắng đen - DBM307",488000,488000,0,0
TIKI,thoi-trang-nam,111676895,"OWEN - Quần kaki Owen màu xanh navy 91735 - Quần kaki nam",595000,595000,0,0
TIKI,thoi-trang-nam,111681558,"- Áo thun nam trơn vải cá sấu cotton cao cấp ngắn tay tông màu cực hot",78000,78000,0,0
TIKI,thoi-trang-nam,169267594,"Viettien - Áo sơ mi nam ngắn tay ca rô 1N0452 regular",395000,395000,0,0
TIKI,thoi-trang-nam,141111076,"Quần jogger unisex thể thao, quần ống rộng kiểu dáng jogger mặc nhà nam nữ vải TỔ ONG",79000,79000,0,0
TIKI,thoi-trang-nam,160814353,"quần lót nam relax thun lạnh cao cấp chính hãng, quần sịp nam relax underwear rl036",69000,69000,0,0
TIKI,thoi-trang-nam,181114107,"Quần đùi kate nam trơn co giãn có túi LADOS - 4071 thoáng mát, nhiều màu sắc lựa chọn",61000,129000,68000,53
TIKI,thoi-trang-nam,94808483,"Quần Baggy, quan jean xuong,quần bò nam, nữ ,dáng ống suông, rộng nam- hot trend 2021",121000,121000,0,0
TIKI,thoi-trang-nam,73939094,"Áo khoác da nam áo khoác nam có khoá kéo ngực hình thật",225000,225000,0,0
TIKI,thoi-trang-nam,32397590,"QUẦN ÂU NAM TRUNG NIÊN",170000,170000,0,0
TIKI,thoi-trang-nam,182139764,"Viettien - Quần kaki nam màu be có 1ly 6R6021 regular",665000,665000,0,0
TIKI,thoi-trang-nam,75390033,"ÁO SƠ MI LỤA NAM BODY CỰC ĐẸP THỜI TRANG PHONG CÁCH HÓA NAM THẦN NĂM MỚI",98000,98000,0,0
TIKI,thoi-trang-nam,98642493,"Áo thun Teeworld Outer Space T-shirt Form Rộng Unisex Nam Nữ",339000,339000,0,0
TIKI,thoi-trang-nam,159382032,"quần lót nam relax dệt kim cao cấp chính hãng, quần sịp nam relax underwear rltk14",102000,102000,0,0
TIKI,thoi-trang-nam,49733157,"Quần bơi nam dáng lửng, mẫu mới 2020, vải bơi dày dặn đẹp, co giãn 4 chiều | BN005",115000,115000,0,0
TIKI,thoi-trang-nam,68962426,"Quần lót nam dạng lưới gợi cảm chữ T - màu đen",39000,39000,0,0
TIKI,thoi-trang-nam,163895036,"Áo Sơ Mi Nam Trắng Ngắn Tay Công Sở Trung Niên Thương Hiệu Anton Vải Nano SRN01",265000,380000,115000,30
TIKI,thoi-trang-nam,125725750," Áo lót Nam cotton trắng siêu đẹp",54000,54000,0,0
TIKI,thoi-trang-nam,144317186,"Bộ vest nam Viettien màu xám regular 1Q9503",2605000,2605000,0,0
TIKI,thoi-trang-nam,764366,"Quần Short Nam Phúc An 1001 - Đen",79000,79000,0,0
TIKI,thoi-trang-nam,212325126,"Áo gió nam thể thao 2 lớp Fasvin chất liệu cao cấp mềm mại co giãn ABC22540.HN",349000,558000,209000,37
TIKI,cross-border-hang-quoc-te,17970317,"The Design Of Everyday Things",598000,598000,0,0
TIKI,cross-border-hang-quoc-te,195283049,"Viên Uống Bổ Sung Collagen Youtheory 390 viên - Mỹ",610000,610000,0,0
TIKI,thoi-trang-nam,147003835,"Áo Blazer Caro Form Rông Dài Tay BZ09, Áo Khoác Vest Blazer Học Sinh Hàn Quốc Nam Nữ Thời Trang HERO",249000,399000,150000,38
TIKI,thoi-trang-nam,67516552,"Áo sơ mi nam tay ngắn form slim sọc ngang hồng Khatoco A1MN538S1-CNSC004-2102-N",430400,538000,107600,20
TIKI,cross-border-hang-quoc-te,192689327,"Giày Thể Thao Giày Sneakers CAMEL Cho Nam Giày Chạy Bộ Thoáng Khí Đế Mềm Lưới Thường Ngày",1171000,1171000,0,0
TIKI,thoi-trang-nam,108849574,"Quần Kaki Dáng Âu Nam Thời Trang Thanh Lịch 4 Màu Thời Thượng ZERO",239000,350000,111000,32
TIKI,thoi-trang-nam,105357458,"Áo Phông Nam Polo Phong Cách Hiện Đại Trẻ Trung Cao Cấp VICERO",189000,300000,111000,37
TIKI,cross-border-hang-quoc-te,170582962,"Sách - The Art Of Seduction by Robert Greene (UK edition, paperback)",810000,810000,0,0
TIKI,thoi-trang-nam,110751243,"Quần Jeans, baggy jean đen nam ống suông, rộng, hottrend 2021",147000,147000,0,0
TIKI,cross-border-hang-quoc-te,253061608,"Footbath package Foot Bath Bag",102000,102000,0,0
TIKI,cross-border-hang-quoc-te,173585995,"Sách - Studio Ghibli: 100 Collectible Postcards by Studio Ghibli (US edition, paperback)",953000,953000,0,0
TIKI,thoi-trang-nam,85087603,"Áo sơ mi nam ngắn tay vải không nhăn",108000,108000,0,0
TIKI,thoi-trang-nam,77315179,"Combo 3 áo ba lỗ nam từ 55-68kg, áo ôm body , áo thun tập gym chất thun lụa mặc cực mát giao mẫu và màu ngẫu nhiên ",88000,88000,0,0
TIKI,thoi-trang-nam,173998078,"Quần Jean nam Leman xanh trơn JD04 - Slim Form",455000,549000,94000,17
TIKI,cross-border-hang-quoc-te,170725075,"Sách - It's Not How Good You Are, It's How Good You Want to Be : The world's best- by Paul Arden (UK edition, paperback)",386000,386000,0,0
TIKI,cross-border-hang-quoc-te,136894092,"ROCKBROS Đi Xe Đạp Chống Trượt Chống Mồ Hôi Nam Nữ Găng Tay Nửa Ngón Thoáng Khí Chống Sốc-Găng Tay Thể Thao MTB xe Đạp Xe Đạp Găng Tay - M",376257,376257,0,0
TIKI,cross-border-hang-quoc-te,11465059,"Collins Cobuild Advance Learners Dict 9Ed.",942000,942000,0,0
TIKI,thoi-trang-nam,98622640,"Quần Jean Nam Mẫu Mới ️️ Quần Bò Nam Chất Liệu Denim Cao Cấp Thời Trang Chuẩn Hàng Shop Tô Tồ Shop - QJNTT22",199000,199000,0,0
TIKI,cross-border-hang-quoc-te,11504804,"Rich Dad's Guide To Investing",270000,270000,0,0
TIKI,cross-border-hang-quoc-te,166147421,"USB External Sound Card 5.1 Surround Sound Optical Audio Sound Card,",284000,284000,0,0
TIKI,thoi-trang-nam,36275674,"Áo khoác kaki nam phong cách lính, chất liệu vải kaki dày dặn, bền đẹp, thời trang trung niên",595000,595000,0,0
TIKI,cross-border-hang-quoc-te,108600724,"Quần lót thoáng khí có đệm MTB cho xe đạp-Màu xanh dương-Size",255000,255000,0,0
TIKI,thoi-trang-nam,115981807,"Áo Khoác Dù Bomber Bóng Chày 23 Nam Nữ Áo Khoác Gió Phối Màu Cặp đôi Couple Rẻ Đẹp - Bomber Jacket",97000,97000,0,0
TIKI,thoi-trang-nam,84821897,"Sịp Đùi- Quần Lót Nam Boxer Cotton Siêu Mềm Form To Thoáng Khí Họa Tiết Chữ 3D K459",50000,50000,0,0
TIKI,cross-border-hang-quoc-te,46373957,"7 Chiếc Nhiều Kích Cỡ Khác Nhau Cần Câu Cá Hướng Dẫn Đầu Dây Câu Cá Con Quay Hướng Dẫn Mắt Nhẫn Đầu Hàng Đầu B",152000,152000,0,0
TIKI,cross-border-hang-quoc-te,170657673,"Sách - Life of Pi (International Edition) by Yann Martel (US edition, paperback)",609000,609000,0,0
TIKI,cross-border-hang-quoc-te,11708848,"TED Talks: The Official TED Guide To Public Speaking",483000,483000,0,0
TIKI,thoi-trang-nam,86107760,"Áo Sơ Mi Đen  Áo Sơ Mi Nam nữ unisex",139000,139000,0,0
TIKI,cross-border-hang-quoc-te,10732450,"The Infographic Guide To Personal Finance",578000,578000,0,0
TIKI,cross-border-hang-quoc-te,94352398,"Clutch Spring Compressor-Compression Tool for Harley 1340 XL1200 883 72 48",708000,708000,0,0
TIKI,cross-border-hang-quoc-te,146553822,"CINCATDY Tai Nghe Bluetooth V5.0 Earbuds Gaming Headphone True Wireless Headset E6S - Hàng Chính Hãng",175000,175000,0,0
TIKI,cross-border-hang-quoc-te,170694296,"Sách - Five Lessons : The Modern Fundamentals of Golf by Ben Hogan (US edition, paperback)",406000,406000,0,0
TIKI,cross-border-hang-quoc-te,177304002,"11 Inch Female & Male Anatomy Figure Model Anatomical Reference For Artists - White",539000,539000,0,0
TIKI,cross-border-hang-quoc-te,94960761,"Oil Change Replacement Kit Primary Case Oil Fill + Drip-Free Oil Funnel for Harley Orange",194000,194000,0,0
TIKI,thoi-trang-nam,158790337,"Quần jogger nam túi hộp chất kaki polyster mỏng mềm mịn, phong cách đường phố",128500,128500,0,0
TIKI,cross-border-hang-quoc-te,46345981,"22 chiếc Da Thủ Công Khâu Tay Dụng Cụ May Vá Awl Sáp Chủ Đề Đầu Kẹp Bộ",238000,238000,0,0
TIKI,thoi-trang-nam,174315711,"Áo Thun Polo Nam Tay Ngắn Unisex thương hiệu Chandi thiết kế cố bẻ thêu không bong tróc khi giặt PLN7",151000,220000,69000,31
TIKI,cross-border-hang-quoc-te,207741949,"Áo mưa bít kín người siêu nhẹ siêu bền, phong cách Nhật Bản",369999,369999,0,0
TIKI,thoi-trang-nam,162734469,"Quần tây nam không ly màu xanh Khatoco Q1M478R0-INMA041-2211-0",382400,478000,95600,20
TIKI,cross-border-hang-quoc-te,116563792,"Set of 2 Butterfly Balisong Trainer Training Knife Tool Safe Use Gifts",167000,167000,0,0
TIKI,cross-border-hang-quoc-te,198094796,"Maid Costume Apron Cosplay Maid Dresses Waitress for Stage Halloween",601000,601000,0,0
TIKI,cross-border-hang-quoc-te,97503208,"Phụ Kiện Bôi Trơn Dây Sên Xích Xe Đạp",124600,124600,0,0
TIKI,cross-border-hang-quoc-te,19247662,"Plato And A Platypus Walk Into A Bar",457000,457000,0,0
TIKI,thoi-trang-nam,45300477,"Áo thun nam cá sấu tay dài dây kéo SITAKI ATD06",130000,130000,0,0
TIKI,cross-border-hang-quoc-te,170582988,"Sách - The Montessori Method by Maria Montessori (US edition, paperback)",598000,598000,0,0
TIKI,thoi-trang-nam,164817080,"Áo thun sweater Tay Dài LADOS 9071 - trẻ trung, năng động, form rộng thoải mái",259000,259000,0,0
TIKI,cross-border-hang-quoc-te,17964262,"Hooked: How to Build Habit-Forming Products",504000,504000,0,0
TIKI,cross-border-hang-quoc-te,170706306,"Sách - The Daily Laws : 366 Meditations on Power, Seduction, Mastery, Strategy, by Robert Greene (US edition, hardcover)",958000,958000,0,0
TIKI,cross-border-hang-quoc-te,170693470,"Sách - Until the End of Time : Mind, Matter, and Our Search for Meaning in an Ev by Brian Greene (US edition, paperback)",525000,525000,0,0
TIKI,thoi-trang-nam,97360861,"Combo 4 quần lót nam, sịp đùi nam hàng đẹp",87000,87000,0,0
TIKI,cross-border-hang-quoc-te,170698954,"Sách - Venus in the Blind Spot by Junji Ito (US edition, hardcover)",745000,745000,0,0
TIKI,cross-border-hang-quoc-te,17970416,"Educated",680000,680000,0,0
TIKI,cross-border-hang-quoc-te,165218707,"Túi Thể Thao Rhinowalk Treo Phía Trước Xe Đạp Tiện Lợi Chống Thấm Nước Thích Hợp Cho Thể Thao Handlebar Bag Bicycle - Xanh",363000,363000,0,0
TIKI,cross-border-hang-quoc-te,174582188,"WIFI Wireless Signal Amplifier Repeater AP 300M Signal Enhancement UK Plug",57000,57000,0,0
TIKI,thoi-trang-nam,162832750,"Áo khoác trái tym chất nỉ cotton giá rẻ bất ngờ có video và ảnh thật, Áo Khoác Nỉ Bomber Cardigan Form Rộng Chất Nỉ Bông Dày Dặn Nữ Unisex",100000,100000,0,0
TIKI,cross-border-hang-quoc-te,95836073,"Giày thể thao chạy bộ năng động dành cho nam",612805,612805,0,0
TIKI,cross-border-hang-quoc-te,124654744,"Trẻ Em Bắn Cung Cung Mang Xuống Nơ Cho Trẻ Em Chụp Hình Ngoài Trời Thực Hành Cung Cho Trò Chơi Con Quay Quy Hồi Cung 15/18lbs - Bow-black",917217,917217,0,0
TIKI,cross-border-hang-quoc-te,93472058,"2pcs Women Mens Shoes Angel Wings Charm Wings For Sneakers Shoes Decorations",130000,130000,0,0
TIKI,cross-border-hang-quoc-te,113475857,"8cm  Engraved Solar System Crystal Ball with a Touch Switch LED Light Base Cosmic Model 3D Miniature Planets Model Sphere Glass Globe Ornament",261000,261000,0,0
TIKI,cross-border-hang-quoc-te,11505576,"Harvard Business Review: 10 Must Reads On Communication",629000,629000,0,0
TIKI,thoi-trang-nam,103596761,"Áo Dạ Nam, Áo Blazer dạ nam dáng phong cách Hàn quốc -AKD10",519000,519000,0,0
TIKI,thoi-trang-nam,110024559,"QUẦN KAKI NAM TÚI HỘP MÀU RỆU",170000,170000,0,0
TIKI,thoi-trang-nam,84462082,"COMBO 5 QUẦN ĐÙI NAM MẶC NHÀ TỪ 43-75KG",97000,97000,0,0
TIKI,thoi-trang-nam,109407224,"ÁO KHOÁC DÙ ,ÁO KHOÁC DÙ BOMBER NAM CỰC ĐẸP - PHONG CÁCH HÀN QUỐC - 2021 THỜI TRANG MỚI KINGSHOP79",107000,107000,0,0
TIKI,thoi-trang-nam,41953571,"Quần Jean Nam Trung Niên Ống Suông TH012",179000,179000,0,0
TIKI,thoi-trang-nam,73100612,"Áo khoác dù nam 2 lớp thêu N",89000,89000,0,0
TIKI,thoi-trang-nam,91938943," ÁO SƠ MI NAM VIỀN CỔ THÊU LOGO CON ONG",95000,95000,0,0
TIKI,thoi-trang-nam,181136924,"Áo sơ mi nam Slim fit ngắn tay tím nhạt NSMMMTMMMR171426N",455000,479000,24000,5
TIKI,thoi-trang-nam,58732140,"Áo gile nam",370000,370000,0,0
TIKI,thoi-trang-nam,181142190,"Áo sơ mi nam Slim fit ngắn tay hồng đậm 170284N",426550,449000,22450,5
TIKI,thoi-trang-nam,179746188,"Áo Khoác Dù Nam Basic Dây Kéo Sọc Màu Couple TX MOP 1021",559000,559000,0,0
TIKI,thoi-trang-nam,178247910,"Áo Khoác ACOVER dù Jacket Form Rộng PALY Phong Cách Ulzzang, Áo Khoác Dù Logo In Chữ ACOVER Vô Cùng Đẹp Mắt,Chất Dù 2 Lớp Cao Cấp Hót Trend, Áo Khoác Dù Jacket 2 Lớp ACOVER Unisex Nam Nữ, Áo Jacket dây kéo Ulzzang",99000,99000,0,0
TIKI,thoi-trang-nam,169051826,"Áo sơ mi nam Novelty ngắn tay 171435 vạt bầu Form Slim Fit ôm Body",199000,469000,270000,58
TIKI,thoi-trang-nam,171901581,"Áo khoác nam mới đẹp lót lông nhung cao cấp thời trang thời trang-A1018",177450,177450,0,0
TIKI,thoi-trang-nam,15135625,"Áo Khoác Dù Nam Chống Nắng Chống Lạnh Phối Cổ Cao Cấp AB21",159000,265000,106000,40
TIKI,thoi-trang-nam,49268992,"QUẦN JOGGER KAKI NAM",89000,89000,0,0
TIKI,thoi-trang-nam,114278010,"Áo thun Teeworld TW x Vietnamese Food - Ca Phe Sua Da Nam Nữ Trắng Đen Form Rộng Unisex",359000,359000,0,0
TIKI,thoi-trang-nam,163436248,"Áo Sơ Mi Nam Công Sở Trung Niên Ngắn Tay Anton Màu Xanh Than Thoáng Mát, Thấm Hút Mồ Hôi - XNC130",295000,425000,130000,31
TIKI,thoi-trang-nam,20868566,"Áo Thun Nam Tay Dài D402",95000,95000,0,0
TIKI,thoi-trang-nam,111709266,"Áo thun nam Áo polo nam ngắn tay có cổ PN03 Cotton 100% cao cấp phong cách Hàn Quốc",125000,125000,0,0
TIKI,thoi-trang-nam,117585187,"Áo Khoác Dù Nam Kiểu Bomber",59000,59000,0,0
TIKI,thoi-trang-nam,73409755,"ÁO LEN GILE NAM ALIGRO - MÀU XANH DƯƠNG ALENGL012",254800,364000,109200,30
TIKI,thoi-trang-nam,118119619,"Quần Jean Nam Suông, Quần Jean Ống Rộng - Mã 1303",189000,189000,0,0
TIKI,thoi-trang-nam,174012874,"Quần Jean nam Leman xanh rách JD07 - Slim Form",372000,449000,77000,17
TIKI,thoi-trang-nam,71979063,"Áo len gile nam aligro đỏ đô kẻ viền",350350,500500,150150,30
TIKI,thoi-trang-nam,85705434,"Áo Chống Nắng Nam Cotton Laroma| UPF50+ | Vải Thơm | Làm Mát | Thời Trang | Đa Dụng",389000,569000,180000,32
TIKI,thoi-trang-nam,95064066,"Quần Short Jean Nam co dãn kiểu dáng trẻ trung đơn giản Thương Hiệu Chandi, quần sọt mẫu mới xu hướng QSJN300",141550,149000,7450,5
TIKI,thoi-trang-nam,73853795,"Quần thể thao ống rộng,Quần Jogger,quần thể thao nam ống rộng,quần thể thao nữ rộng Unisex , Hàng Nhập Cao Cấp QT3",185000,185000,0,0
TIKI,thoi-trang-nam,164310643,"UNSTOPABLE, mã G60. Áo thun siêu đẹp cho cả gia đình. Form unisex cho nam nữ, trẻ em, bé trai gái. Quà tặng ý nghĩa cho bố mẹ, con cái, bạn bè, doanh nghiệp, hội nhóm",69000,69000,0,0
TIKI,thoi-trang-nam,66878540,"Áo sơ mi đũi nam form rộng cổ đức chui đầu ArticHunter, thời trang trẻ, thương hiệu chính hãng",189000,189000,0,0
TIKI,thoi-trang-nam,73926312,"Áo sơ mi kẻ sọc thời trang nam, size áo từ 50-75 kg ,áo sơ mi nam cao cấp phong cách nam tính 3 màu, dáng áo ôm nhẹ trẻ trung, chất vải thô dày dặn mềm mịn, không bị bai xù",159000,159000,0,0
TIKI,thoi-trang-nam,91006325,"Quần jean nam  Baggy ống rộng thời trang  hợp thời trang Quần ống suông thẳng",149000,149000,0,0
TIKI,thoi-trang-nam,193367063,"OWEN - Áo sơ mi dài tay Owen regular fit chất sợi tre kẻ ca rô xanh - Áo sơ mi nam dài tay kẻ ca rô",598000,598000,0,0
TIKI,thoi-trang-nam,104909650,"Quần đùi mặc nhà chất thun cotton 100% thương hiệu Fezzio",69500,139000,69500,50
TIKI,thoi-trang-nam,114313026,"Áo khoác da nam dây kéo đồng da xịn KHÔNG BONG TRÓC hàng xịn cao cấp nhất 2021",199000,199000,0,0
TIKI,thoi-trang-nam,168957775,"Đồ Bơi Nam Và Nữ Couple Tay Dài Che Nắng Kiểu Korea ATI81 MayHomes Chuẩn UPF 50+, Long-Sleeve Rash Guard Swimsuit",286150,295000,8850,3
TIKI,thoi-trang-nam,51144277,"Áo đoàn thanh niên việt nam dài tay chất đẹp",82000,82000,0,0
TIKI,thoi-trang-nam,30030428,"Quần Khaki Nam Không Ply Ống Ôm Khatoco Q2M528S0-VNMA001-1907-006",199000,528000,329000,62
TIKI,thoi-trang-nam,106764912,"Quần Lót Nam Boxer Xuyên Thấu Thông Hơi Lưng Nhật Thoáng Mát, Quần Sịp Đùi Thông Hơi Cao cấp",40000,40000,0,0
TIKI,thoi-trang-nam,33393793,"QUẦN ÂU NAM TRUNG NIÊN",134000,134000,0,0
TIKI,thoi-trang-nam,106886142,"OWEN - Áo sơ mi ngắn tay Owen vải sợi sen AS90774 - Áo sơ mi nam ngắn tay",628000,628000,0,0
TIKI,thoi-trang-nam,168872132,"Đồ Bơi Nam Nữ Đồ Tắm Couple Mùa Hè ATI80 MayHomes Tay Dài Chống Nắng UPF 50+, Long-Sleeve Rash Guard Swimsuit",261000,289000,28000,10
TIKI,thoi-trang-nam,52251333,"Áo Thun Nam Cổ Bẻ Doka 4 Chiều Cao Cấp, Trẻ Trung ( 8 Màu)",198000,198000,0,0
TIKI,thoi-trang-nam,194284327,"Quần Jean nam Leman xanh wash bụi JD11 - Slim Form",455000,549000,94000,17
TIKI,thoi-trang-nam,15132079,"Áo Khoác Da Nam Đen Lót Lông Cao Cấp AKD22",269000,420000,151000,36
TIKI,thoi-trang-nam,51492842,"Quần Jean Nam Quần Bò Nam Rách Gối Màu Đen Trơn, Thời trang Cao cấp",125000,125000,0,0
TIKI,thoi-trang-nam,117919459,"Áo phông tay lỡ form rộng unisex nam nữ thun teen cổ tròn oversize cotton giá rẻ basic đen trắng tee pull GKKRT",52000,52000,0,0
TIKI,thoi-trang-nam,116024135,"Áo sơ mi nam tay dài ADINO màu xanh nhạt dáng slimfit vải modal trẻ trung S304",279000,350000,71000,20
TIKI,thoi-trang-nam,105342665,"Áo Thun Nam Polo Có Cổ Tay Ngắn Mùa Hè Thời Trang VICERO",189000,300000,111000,37
TIKI,thoi-trang-nam,154785711,"Áo khoác nhung bomber NAM CỰC CHẤT",157000,157000,0,0
TIKI,thoi-trang-nam,107153975,"Quần lót nam kiểu dáng sexy họa tiết hình con voi",35000,35000,0,0
TIKI,thoi-trang-nam,31202193,"Quần tây nam không ply ống đứng Khatoco Q1M528R0-CNMA035-2105-0",422400,528000,105600,20
TIKI,thoi-trang-nam,22514873,"Quần tây nam quần nam",89000,89000,0,0
TIKI,thoi-trang-nam,189595382,"Quần lót nam Under Armour TECH 6IN 2 - 1363619-600",907000,1295000,388000,30
TIKI,thoi-trang-nam,106700356,"Quần Jean Nam Vovesa Mẫu Mới, Dáng Ôm Trẻ Trung, Nam Tính Q4",115000,115000,0,0
TIKI,thoi-trang-nam,111586228,"Áo vest Blazer Linen nam dáng lửng, thời trang phong cách trẻ trung",320000,320000,0,0
TIKI,thoi-trang-nam,183731008,"Áo sơ mi nam, Áo sơ mi Nam dài tay cổ Đức, Thêu viền tay - cổ áo sang trọng lịch sự N10",199000,199000,0,0
TIKI,thoi-trang-nam,19760096,"Quần jean dài nam co giãn - vải dày - B005",115000,115000,0,0
TIKI,thoi-trang-nam,178006534,"Đồ Bơi Cặp Nam Nữ Tay Dài Chống Nắng AT225 MayHomes Thun Lạnh Co Giãn Tốt UPF 50+, Long-Sleeve Rash Guard Swimsuit",322420,329000,6580,2
TIKI,thoi-trang-nam,195866795,"Áo khoác gió đôi nam nữ cao cấp unisex chống nước, chống gió, chống bụi, chống nắng ngăn tia UV AG01 - PROMAN",199000,199000,0,0
TIKI,thoi-trang-nam,28621391,"Áo sơ mi nam dài tay  màu vàng nhạt",159000,159000,0,0
TIKI,thoi-trang-nam,124765809,"Áo khoác nam nữ chất liệu gió cao cấp 2 lớp dày dặn, bên trong lót lưới, áo khoác dù chống nước",171000,180000,9000,5
TIKI,thoi-trang-nam,101582147,"Áo KHOÁC DÙ 2 LỚP unisex form rộng cặp đôi ulzzang Hàn Quốc dành cho nam nữ, Áo khoác dù 2 lớp màu đen, có nón Glean local brand ONTOP JACKET cho nam nữ cho cặp đôi,Áo khoác dù unisex Glean Mark 2 local brand ONTOP",99000,99000,0,0
TIKI,thoi-trang-nam,151801574,"QUẦN LÓT NAM - TAM GIÁC LƯỚI - THOÁNG MÁT",59000,59000,0,0
TIKI,thoi-trang-nam,84558587,"Áo nỉ hoodie nam nữ in hình độc lạ form rộng hàn quốc dưới 70kg, chất nỉ mềm mịn, Áo nỉ hoodie nam nữ form rộng,Aó hoodie nam , áo hoodie nữ , áo khoác áo hoodie cặp đôi nam nữ mặc",100000,100000,0,0
TIKI,thoi-trang-nam,19638485,"Quần jean nam đen tuyền rách gối - B00",127000,127000,0,0
TIKI,thoi-trang-nam,162617092,"Áo Sơ Mi Nam Công Sở Trung Niên Dài Tay Trắng Vải Cotton Họa Tiết Chấm Bi Nhỏ Thương Hiệu Anton - X302",225000,295000,70000,24
TIKI,thoi-trang-nam,116273173,"Quần Bơi Nam Tam Giác Thời Trang Desmiit S324 - Thiết Kế Thời Trang Hợp Xu Hướng - Màu Sắc Kết Hợp Cực Cá Tính, Đa Dạng Cho Bạn Lựa Chọn",207000,400000,193000,48
TIKI,thoi-trang-nam,129024656,"Áo len nam cổ tròn phối màu cơ bản ArcticHunter, thời trang phong cách Hàn",160000,160000,0,0
TIKI,thoi-trang-nam,87896252,"Đồ bơi cao cấp cho Nam giới, áo bơi dài tay & cộc tay cùng quần sooc đùi dài mạnh mẽ, chất thun bơi lạnh dày đẹp | BN012",320000,320000,0,0
TIKI,thoi-trang-nam,3715005,"Combo 3 Quần Lót Boxer Nam Freeman 6517-CB3 (Size",213300,237000,23700,10
TIKI,thoi-trang-nam,182710825,"áo khoác kaki nam lót dù caro trơn thấm hút tốt phong cách trẻ 2022",185000,185000,0,0
TIKI,thoi-trang-nam,72747421,"Áo hoodie, áo sweater trơn nam nữ",99000,99000,0,0
TIKI,thoi-trang-nam,43743154,"Quần Jean Nam Trung Niên Ống Suông H234",120000,120000,0,0
TIKI,thoi-trang-nam,187830454,"Quần jean, baggy nam ống rộng hot boy hàn quốc 2021",135000,135000,0,0
TIKI,thoi-trang-nam,68962509,"Quần lót nam mặt voi sexy gợi cảm cho nam - Màu vằn",39000,39000,0,0
TIKI,thoi-trang-nam,19822775,"Quần Jean Nam Đen Chất Co Giãn JEAN51 - Jean",175000,175000,0,0
TIKI,thoi-trang-nam,56658409,"ÁO KHOÁC KAKI NAM HAI LỚP CAO CẤP THỜI TRANG",135000,135000,0,0
TIKI,thoi-trang-nam,174842957,"Áo Khoác Varsity Local Brand Bomber Chữ A thêu cả Áo phù hợp cho cả Nam và Nữ, Áo khoác bomber jacket nam nữ phối Nâu Boin shop thêu nỉ 2 lớp, chất nỉ bông siêu đẹp",123000,123000,0,0
TIKI,thoi-trang-nam,111710381,"Áo Thun Nam Áo Thun Nam Có Cổ Phối Boa Tay Mẫu TR01 Chất Vải Đẹp Chuẩn Form",125000,125000,0,0
TIKI,cross-border-hang-quoc-te,101760881,"Pet Dog Cat Food Dispensing Toy Interactive Puzzle Toy Slow Feeder, Bear Head Shaped",130000,130000,0,0
TIKI,cross-border-hang-quoc-te,100215817,"bộ phụ kiện câu cá 350 cái các loại đựng trong hộp nhựa trong suốt chắc chắn-Size 164 chiếc",211000,211000,0,0
TIKI,cross-border-hang-quoc-te,113941031,"Nhà chống sủa được thiết kế để ngăn chặn tiếng sủa không đúng lúc của con chó của bạn",503000,503000,0,0
TIKI,cross-border-hang-quoc-te,173878224,"Wireless Numeric Keypad 2.4 GHz Bluetooth Mini with Touchpad 2.4G USB Receiver Numpad for Tablet",571000,571000,0,0
TIKI,cross-border-hang-quoc-te,138018748,"Dây đeo tay Silicon Strap cho Samsung Galaxy Watch 4/Classic 40/44/42/46MM",251000,251000,0,0
TIKI,cross-border-hang-quoc-te,46405710,"1/12 Nhà Búp Bê Mini Piano Với Phân Cho Phòng Âm Nhạc Đồ Nội Thất Trang Trí",652000,652000,0,0
TIKI,cross-border-hang-quoc-te,18011391,"Difficult Conversations (10th Anni. Edition)",517000,517000,0,0
TIKI,cross-border-hang-quoc-te,189273683,"Gương Chiếu Hậu Cầu Lồi Xoay 360 Độ Cho Xe Hơi",293000,293000,0,0
TIKI,cross-border-hang-quoc-te,269954621,"Butterfly Training Accessories Butterfly Comb for Practicing Flipping Tricks",183000,183000,0,0
TIKI,cross-border-hang-quoc-te,109442464,"Set 24 dụng cụ mở khóa kèm ổ khóa Cho Người Mới Bắt Đầu Trong Suốt Luyện Tập Mở Khóa Chuyên Nghiệp",439600,439600,0,0
TIKI,cross-border-hang-quoc-te,115285558,"Mặt nạ đầu cá xanh vui nhộn, hóa trang bữa tiệc, lễ hội chất liệu cao su an toàn",244000,244000,0,0
TIKI,cross-border-hang-quoc-te,107858279,"100 miếng vải chống ngáy ngủ dùng 1 lần, bằng vải không dệt ",202000,202000,0,0
TIKI,cross-border-hang-quoc-te,170693730,"Sách - X-Treme Sudoku by Nikoli Publishing (US edition, paperback)",381000,381000,0,0
TIKI,cross-border-hang-quoc-te,76390167,"32/36/37 Key Plastic Flexible Melodica Blowpipe Tube Parts Replacement",149000,149000,0,0
TIKI,cross-border-hang-quoc-te,11778387,"Beartown",532000,532000,0,0
TIKI,cross-border-hang-quoc-te,11504725,"Harvard Business Review: Guide To Persuasive Presentations",394000,394000,0,0
TIKI,cross-border-hang-quoc-te,189499245,"2 Bóng Đèn Led H1 H3 H4 H7 H11 H8 3030smd 9005 9006 Dc12V Ánh Sáng Trắng Cho Xe Hơi",375500,375500,0,0
TIKI,cross-border-hang-quoc-te,170683960,"Sách - Pillow Thoughts III : Mending the Mind by Courtney Peppernell (US edition, paperback)",417000,417000,0,0
TIKI,cross-border-hang-quoc-te,95712224,"Túi Tam Giác Treo Sườn Xe Đạp Đựng Điện Thoại Tiện Lợi",309400,309400,0,0
TIKI,cross-border-hang-quoc-te,108603984,"Túi trước cho xe đạp có nắp chống thấm, dung tích lớn",537000,537000,0,0
TIKI,cross-border-hang-quoc-te,170623454,"Sách - Six Pillars Of Self-Esteem by Nathaniel Branden (US edition, paperback)",525000,525000,0,0
TIKI,cross-border-hang-quoc-te,88841157,"Còi Gắn Ống Pô Xe Ô Tô",270000,270000,0,0
TIKI,cross-border-hang-quoc-te,108778224,"Đồng hồ ONOLA ON6811 Nam Quartz Transpaernt Hollow Dial Silica Gel Band Thời trang đa năn,Phát sáng",505000,505000,0,0
TIKI,cross-border-hang-quoc-te,116465319,"Thermal Pad 12.8 W/mK 85x45mm Heat Resistance High-Temperature Resistance Non-Conductive Silicone Thermal Pads for Laptop Heatsink GPU CPU",171000,171000,0,0
TIKI,cross-border-hang-quoc-te,248920147,"Tuya Wifi 7in1 Máy Đo Chất Lượng Không Khí Đa Năng PM2.5 CO2 TVOC HCHO AQI Nhiệt Độ Độ Ẩm Kiểm Tra",632000,632000,0,0
TIKI,cross-border-hang-quoc-te,241644828,"Ổ Cứng Di Động M.2 SSD 2TB 4TB 8TB Cổng USB 3.1 - Bạc",549939,549939,0,0
TIKI,cross-border-hang-quoc-te,147476439,"Dụng Cụ Mở Nắp Chai Lọ Bằng Thép Không Gỉ",185000,185000,0,0
TIKI,cross-border-hang-quoc-te,95710788,"Yên Sau Xe Đạp Điện",240000,240000,0,0
TIKI,cross-border-hang-quoc-te,112994107,"Bộ Softbox Godox FL-SF3045 với Túi đựng bằng vải mềm dạng lưới tổ ong cho Godox FL60 Linh hoạt LED Light Roll-Flex Photo",583000,583000,0,0
TIKI,cross-border-hang-quoc-te,51682220,"PU Leather Shoulder Bag Dây đeo Thay Thế Xử Lý DIY Túi Xách Ví",139000,139000,0,0
TIKI,cross-border-hang-quoc-te,95682147,"Microphone Isolation  with Stand Studio Sound Absorbing Foam Reflector",929000,929000,0,0
TIKI,cross-border-hang-quoc-te,250861746,"Khuyến mại mới 360 led đèn pha ô tô 6 mặt đèn led dạ quang xe hơi 4 mặt đèn pha led h11 đèn pha bán hàng trực tiếp",443000,443000,0,0
TIKI,cross-border-hang-quoc-te,51679112,"Lưu Lượng Kế đo Lưu Lượng Oxy Với Van điều Khiển Cho Không Khí 1-10LPM",248000,248000,0,0
TIKI,cross-border-hang-quoc-te,109436694,"Loa kết hợp có dây SADA D-203 USB siêu trầm cho máy tính để bàn ",288000,288000,0,0
TIKI,cross-border-hang-quoc-te,76898875,"USB Microphone PC Laptop Stereo Omnidirectional Condenser for for Business Video Conference, Recording, Chat, Skype, Online Meeting, Gaming",388000,388000,0,0
TIKI,cross-border-hang-quoc-te,147542573,"Bàn chải chà gót chân bằng thép không gỉ
",350000,350000,0,0
TIKI,cross-border-hang-quoc-te,262463275,"Sách - Origami Design Secrets : Mathematical Methods for an Ancient Art, Secon by Robert J. Lang (UK edition, hardcover)",6048000,6048000,0,0
TIKI,cross-border-hang-quoc-te,200618498,"Sách - The Fall of the Ottomans : The Great War in the Middle East, 1914-1920 by Eugene Rogan (UK edition, paperback)",498000,498000,0,0
TIKI,cross-border-hang-quoc-te,241962293,"Dây Cáp Tai Nghe 3.5mm AUX Giắc Cắm 3.6Ft Chuyên Dụng Cho Sony WH-1000XM5 WH-1000XM4 WH-1000XM3",467200,467200,0,0
TIKI,cross-border-hang-quoc-te,111415945,"Túi câu cá iLure đa năng không thấm nước, nhiều ngăn 32x39x12 cm-Màu đen",367000,367000,0,0
TIKI,thoi-trang-nam,193981069,"Quần Jean nam Leman đen mài xám JD14 - Slim Form",455000,549000,94000,17
TIKI,thoi-trang-nam,160910728,"Áo Hoodie TMAG - BLUE WORLD HOODIE - Hàng Chính Hãng",325000,480000,155000,32
TIKI,thoi-trang-nam,22835214,"Áo Thun Nam - ĐEN - XL",69000,69000,0,0
TIKI,thoi-trang-nam,43006502,"Áo len nam cổ lọ ArcticHunter, chất len mềm mịn, thời trang trẻ, thương hiệu chính hãng",189000,189000,0,0
TIKI,thoi-trang-nam,76093557,"Áo thun One Piece Zoro T11 mẫu mới cực đẹp, có size bé cho trẻ em / áo thun Anime Manga Unisex Nam Nữ, áo phông thiết kế cổ tròn basic cộc tay thoáng mát",59000,59000,0,0
TIKI,thoi-trang-nam,182312924,"Viettien - Áo sơ mi nam ngắn tay màu xanh đen vải sợi tre vạt bầu regular",445000,445000,0,0
TIKI,thoi-trang-nam,97861305," Áo thun trơn nam form rộng vải poly cotton cho mọi lứa tuổi NHIÊU MÀU SIÊU SALE",11000,11000,0,0
TIKI,thoi-trang-nam,136790793,"OWEN - Áo khoác gió nam 2 lớp màu xÁM 61035- Áo khoác gió thể thao",1100000,1100000,0,0
TIKI,thoi-trang-nam,94879800,"Quần tây nam việt tiến màu đen có 1ly regular 1P4058",540000,540000,0,0
TIKI,thoi-trang-nam,101656387,"Áo Khoác Dạ Nam Dáng Dài - Áo Mangto Nam Hàn Quốc Sans16",629000,629000,0,0
TIKI,thoi-trang-nam,21436280,"Áo dơ mi việt tiến",410000,410000,0,0
TIKI,thoi-trang-nam,72625960,"Đồ Bơi Cặp Năng Động Tay Dài Che Nắng Biển Xanh ATI72 MayBlue Couple Swimsuit, Long Sleeves, UPF50 Sun Protection, Đồ Bơi Nam Nữ",284050,299000,14950,5
TIKI,thoi-trang-nam,187936785,"Áo gile túi hộp, áo gile nam, áo phóng viên",450000,450000,0,0
TIKI,thoi-trang-nam,16721295,"VEST NAM PHONG CÁCH - CÓ 3 MÀU - ĐEN-XANH-XÁM - AVN009-200",185000,185000,0,0
TIKI,thoi-trang-nam,10922941,"Áo phông hàng hiệu Goking, quà tặng cao cấp cho gia đình, cặp đôi, lớp nhóm, doanh nghiệp, người nước ngoài. Áo thun trơn basic, form unisex cho nam nữ",138000,138000,0,0
TIKI,thoi-trang-nam,124766433,"Quần thể thao nam nữ, quần jogger ống suông 3 sọc 1 sọc chất dày dặn, vải cao cấp Joger",70000,70000,0,0
TIKI,thoi-trang-nam,101656322,"Áo khoác kaki nam hàn quốc manto Sans12 măng tô dáng ngắn khaki blazer bigsize to 3xl 4xl 5xl cỡ đại 80kg 90kg 100kg",659000,659000,0,0
TIKI,thoi-trang-nam,58625400,"Áo gile nam",500000,500000,0,0
TIKI,thoi-trang-nam,145717645,"Áo măng tô nam trẻ trung dáng lửng NMT53",1450000,1450000,0,0
TIKI,thoi-trang-nam,109415295,"Áo khoác da nam bomber xịn xò cao cấp cho các bạn cool ngầu , bao bảnh THỜI TRANG KING FASHION",177000,177000,0,0
TIKI,thoi-trang-nam,13326027,"Quần lót nam thun lạnh - QL005",99000,99000,0,0
TIKI,thoi-trang-nam,76700332,"quần jean nam ống suông vải mềm cao cấp big size cho người 55-100kg",95000,95000,0,0
TIKI,thoi-trang-nam,54761601,"Áo sơ mi nam tay dài trơn Khatoco A1MD360T1- CNTR011-2409-D - Trắng",342000,360000,18000,5
TIKI,thoi-trang-nam,95310196,"Áo thun nam Polo NOVELTY dệt họa tiết 210136N",294000,469000,175000,37
TIKI,thoi-trang-nam,90066029,"Áo khoác dù nam nữ mặc , áo khoác gió",103000,103000,0,0
TIKI,thoi-trang-nam,72193426,"[VIDEO THẬT] Áo khoác nỉ Hoodie 2 màu đen be (unisex nam nữ đều mặc được)",199000,199000,0,0
TIKI,thoi-trang-nam,67545401,"Quần tây nam vải co giãn , quần âu nam vải tuyết mưa hàn quốc - ghi đậm - 29",99000,99000,0,0
TIKI,thoi-trang-nam,174006978,"Quần Jean nam Leman xanh trơn JD05 - Slim Form",455000,549000,94000,17
TIKI,thoi-trang-nam,143868074,"Áo thun nam có cổ tay ngắn vải Cotton 100% co giãn. mềm mịn mặc mát - ATNFA",150000,150000,0,0
TIKI,thoi-trang-nam,108568459,"Áo Thun Nam Form Rộng HSANGHIU",49000,49000,0,0
TIKI,thoi-trang-nam,188382107,"Áo khoác nam, Áo khoác demi mùa xuân phiên bản hàn quốc. Phong cách body trẻ trung, nam tính lịch lãm đễ phối đồ, Mã T6",299000,299000,0,0
TIKI,thoi-trang-nam,176292713,"Áo Bomber Nhung Gân Thêu G Chất Nhung Mịn Đẹp Form rộng Unisex Nam Nữ Couple jacket Varsity",160000,160000,0,0
TIKI,thoi-trang-nam,106886067,"OWEN - Áo sơ mi dài tay Owen SLIMFIT màu trắng in vân AS 90017 - áo sơ mi trắng",620000,620000,0,0
TIKI,thoi-trang-nam,124748904,"quần tây đen việt tiến",690000,690000,0,0
TIKI,thoi-trang-nam,25084178,"Hộp combo 5 sịp đùi boxer SQB101 BLACK",199000,199000,0,0
TIKI,thoi-trang-nam,75370715," Quần Kaki Nam Dài Cao Cấp, Form Chuẩn Slimfit (Nhiều Màu)",350000,350000,0,0
TIKI,thoi-trang-nam,162214070,"Quần Âu Nam-Quần Tây Nam Dài Form Slimfit 4 màu Chất vải Cao Cấp Co Giãn",145000,145000,0,0
TIKI,thoi-trang-nam,146363551,"Áo khoác nam blazer dạ lót lông cừu Sans04 dáng ngắn dày cao cấp mangto hàn quốc trần bông bigsize màu đen xám",899000,899000,0,0
TIKI,thoi-trang-nam,117082039,"ÁO KHOÁC KAKI NAM NỮ 2 LỚP NGOẠI, FORM RỘNG DÀY CHỐNG NẮNG LẠNH CAO CẤP,Áo Khoác Nữ và Nam KaKi Cao Cấp cặp đôi 2 lớp Form rộng Free Size từ 65kg trở xuống",140000,140000,0,0
TIKI,thoi-trang-nam,64275643,"Quần lót boxer nam Khatoco Q5M085R0-VNMA019-2112-B",68000,85000,17000,20
TIKI,thoi-trang-nam,76703202,"quần jean nam ống suông cao cấp, co dãn tốt",59000,59000,0,0
TIKI,thoi-trang-nam,145263868,"Combo 3 quần sịp đùi, set 3 quần lót nam ARISTiNO chất liệu Cotton Organic mềm mại, thoáng mát, kháng khuẩn, khử mùi cực tốt ABX056",298000,375000,77000,21
TIKI,thoi-trang-nam,114671372,"Áo thun nam cổ tròn cao cấp ngắn tay đẹp chất vải cotton co giãn 4 chiều thoáng mát ZAVAS  Z13",289000,289000,0,0
TIKI,thoi-trang-nam,91829352,"Quần Âu, Quần Tây Nam Công Sở Vải Cao Cấp Phom Dáng hàn quốc, chất vải dãn chống nhăn, quần baggy nam",59000,59000,0,0
TIKI,thoi-trang-nam,29408823,"Combo 10 Quần Lót Nam vải cotton lưng Thái 2 chiều co giãn hiệu CITYMEN, màu ngẫu nhiên, đồ lót - LMTK-THAI2C",200000,200000,0,0
TIKI,thoi-trang-nam,163543524,"Bộ Thể Thao Nam Ngắn Tay Phối 3 Màu Cao Cấp Thiết Kế Thời Trang AVIANO",219000,430000,211000,49
TIKI,cross-border-hang-quoc-te,63204908,"L13 Smart Watch Men IP68 Waterproof ECG PPG Bluetooth Call Notification Reminder",736000,736000,0,0
TIKI,cross-border-hang-quoc-te,170703895,"Sách - Will Shortz Presents Killer Sudoku : 200 Hard Puzzles by Will Shortz (US edition, paperback)",399000,399000,0,0
TIKI,cross-border-hang-quoc-te,11504707,"Harvard Business Review: 10 Must Reads On Leadership",473000,473000,0,0
TIKI,thoi-trang-nam,84826006,"Quần Lót Nam- Sịp Lụa Nam Trơn Không Đường May Mỏng Mát K176",74000,74000,0,0
TIKI,cross-border-hang-quoc-te,174361452,"Hệ Thống Ròng Rọc Kèm Dây Cáp Nâng Tạ Chuyên Dụng Cho Vai",407000,407000,0,0
TIKI,cross-border-hang-quoc-te,109164819,"Phụ kiện chuyển đổi vòng bàn đạp cho xe đạp, giúp tiết kiệm sức",602000,602000,0,0
TIKI,cross-border-hang-quoc-te,184995741,"High Output Guitar Pickup Single Coil Humbucker Pickups Neck Middle Bridge Set for ST Beige",286000,286000,0,0
TIKI,thoi-trang-nam,117083556,"Áo khoác dù nam bomber 2 lớp thoáng mát thêu logo TM cá tính năng động,Áo khoác dù nam , áo khoác gió nam , áo bomber dù 2 lớp - Đen,XL",100000,100000,0,0
TIKI,thoi-trang-nam,14995599,"Combo 3 Chiếc Quần Lót Nam Boxer Cao Cấp Aristino ABX 16 15",325000,405000,80000,20
TIKI,thoi-trang-nam,110114383,"Quần Short Nam Chất Gió Co Giãn Siêu Nhẹ Thoáng Mát,Quần Đùi Nam 4 Màu Mặc Nhà Năng Động",39000,39000,0,0
TIKI,cross-border-hang-quoc-te,182806397,"Rotary Tools Accessories Kit for Jewelry Polishing DIY Hobby Craft Projects",223000,223000,0,0
TIKI,cross-border-hang-quoc-te,81280977,"2 Cotton Chair Seat Cushion Pad Home Bistro Kitchen Cushion",270000,270000,0,0
TIKI,cross-border-hang-quoc-te,94919111,"Novelty Doggiy Golf Driver Headcover 460 Cc Golf  Driver Fairway Hybrid Rescue Head Covers",427000,427000,0,0
TIKI,cross-border-hang-quoc-te,111389384,"Túi đeo vai đơn MARK RYDEN phong cách mới được làm bằng vải oxford cao cấp, độ dai cao",654000,654000,0,0
TIKI,thoi-trang-nam,74982138,"Quần jean nam HSS46",109000,109000,0,0
TIKI,cross-border-hang-quoc-te,11845638,"Insight Guides Nepal",786000,786000,0,0
TIKI,cross-border-hang-quoc-te,96615207,"Mountain Bike Cleats Replacement Bicycle SPD Cleat Set for Eggbeater Pedals",244000,244000,0,0
TIKI,thoi-trang-nam,30763873,"Quần short kaki nam Khatoco Q3M378R0-VNIN002-2011-019",149000,378000,229000,61
TIKI,cross-border-hang-quoc-te,242391741,"[ZVPT] Quả Cân Bằng Bạc 1g 5g 10g 50g 100g 200g 500g",146920,146920,0,0
TIKI,cross-border-hang-quoc-te,176805208,"MagiDeal 10 Pairs Crankset  Chainring Bolts Chainwheel Bolts for Bike",165000,165000,0,0
TIKI,cross-border-hang-quoc-te,100529132,"Mountain Bike Self-locking Pedal Lock Plate Cleats Cycling Pedals Eggbeater",135000,135000,0,0
TIKI,thoi-trang-nam,100899778,"ÁO KHOÁC DÙ NAM CHỐNG NƯỚC PHỐI MÀU",219000,219000,0,0
TIKI,cross-border-hang-quoc-te,120768072,"Animal Golf Club Head Cover Headcover 460cc/No.1 Wood Driver Covers Bear",501000,501000,0,0
TIKI,thoi-trang-nam,163031972,"Áo Sơ Mi Nam Công Sở Trung Niên Thương Hiệu Anton Dài Tay Công Sở Vải Cotton Xanh Dương -A14",225000,280000,55000,20
TIKI,thoi-trang-nam,83616147,"Quần ngủ nam có miếng lót nâng đỡ - vải lỗ thoáng mát - quần lót 2in1 cao cấp - quan ngu nam co lot trong",88900,88900,0,0
TIKI,cross-border-hang-quoc-te,134563183,"KYTO Nhảy Dây Kỹ Thuật Số Chống Lại Trong Nhà/Ngoài Trời Thể Dục Huấn Luyện Quyền Anh Có Thể Điều Chỉnh Lượng Calo Dây Nhảy Tập Luyện - one",758310,758310,0,0
TIKI,cross-border-hang-quoc-te,118124293,"Thay thế dây đeo tay bằng silicon cho Suunto Ambit 1/2/2S/2R/3P/3S/3R",350000,350000,0,0
TIKI,thoi-trang-nam,134522829,"Quần lót nam ARISTINO dáng boxer, quần sịp đùi nam chất liệu cotton thoáng khí, co giãn 4 chiều thoải mái - ABX03707",98500,125000,26500,21
TIKI,thoi-trang-nam,99994626," QUẦN ÁO THỂ THAO NAM    BỘ HÈ CHO NAM NỮ IN CHỮ FULUA ĐỒ CẶP ĐÔI 2020",96000,96000,0,0
TIKI,thoi-trang-nam,181114097,"Quần jean nam co giãn cao cấp trơn Lados-4068 Form slimfit chuẩn, thoải mái, không xù lông, ra màu",256000,519000,263000,51
TIKI,thoi-trang-nam,87941257,"Quần Bò Nam cao cấp thương hiệu Chandi, chất jean co dãn mẫu mới nhất mã NT301",194000,299000,105000,35
TIKI,thoi-trang-nam,100897235,"Bộ Quần Áo Nam Thể Thao Viền Tay Cao Cấp thời Trang ZERO",209000,300000,91000,30
TIKI,cross-border-hang-quoc-te,124394857,"Mùa Đông Nón Lưỡi Trai Cho Bé Trai Bé Gái Dễ Thương Mũ Lưỡi Trai Sang Trọng Vịt Nón Quà Tặng Cho Trẻ Em Bé Gái Bọc Ấm Nón Lưỡi Trai Trẻ Em Beanies siêu Ấm - 48-52cm",507463,507463,0,0
TIKI,cross-border-hang-quoc-te,250958909,"Đảm bảo chất lượng điện xe pin lithium 48v24v pin lithium 36v dung lượng lớn 20ah pin lithium xe đạp pin lithium 48v",1574144,1574144,0,0
TIKI,thoi-trang-nam,105344835,"Áo Phông Nam Polo Có Cổ Tay Ngắn Trơn Mùa Hè Nhiều Màu VICERO",189000,300000,111000,37
TIKI,cross-border-hang-quoc-te,116500962,"Mount Adapter Frame Bracket for Insta360 Go 2 Camera",207000,207000,0,0
TIKI,cross-border-hang-quoc-te,110131733,"Ba lô câu cá đa chức năng,chất liệu vải cao cấp chống thấm, bền với hộp đựng đồ câu cá",965000,965000,0,0
TIKI,cross-border-hang-quoc-te,194683492,"mới bán Áo Thi Đấu Đạp Xe Dài Tay Quần Áo Xe Đạp Đường Trường Mtb Cho Nữ Áo Chạy Đua Xuống Dốc Áo Đi Xe Đạp Áo Chạy Xe Máy Xe Đạp Leo Núi Quần Áo Thể Thao Đua Xe Đạp",699999,699999,0,0
TIKI,thoi-trang-nam,34911128,"Hộp 4 chiếc quần sịp đùi nam thông hơi CAO CẤP kèm hộp",90881,90881,0,0
TIKI,thoi-trang-nam,112086654,"Quần Túi Hộp Nam Lính Mỹ US ARMY U768 Cao Cấp, Chất Liệu Vải Kaki,Bền Màu, Ống Rộng Phong Cách, Thiết kế Túi Hộp- HÀNG CHÍNH HÃNG",438000,1000000,562000,56
TIKI,thoi-trang-nam,7925353,"Quần Lót Nam KENDO TOGO Classic",35000,70000,35000,50
TIKI,thoi-trang-nam,20518591,"Quần Short Nam Khatoco Q3M318R0-VNMA035-2009-020",318000,318000,0,0
TIKI,cross-border-hang-quoc-te,96687902,"Short Fracture Ankle Walker Boot for Stable Foot / Ankle Fracture Post Op S",196000,196000,0,0
TIKI,cross-border-hang-quoc-te,164296388,"Multifunctional Grinder Mini Electric Belt Sander DIY Polishing Grinding Machine Cutter Edges Sharpener",717000,717000,0,0
TIKI,thoi-trang-nam,151801517,"QUẦN NGỦ NAM - CÓ TÚI 2 BÊN, CHẤT COTTON CO DÃN - Màu Trơn",119000,119000,0,0
TIKI,cross-border-hang-quoc-te,94967454,"Celluloid Guitar Binding Purfling Strip for Guitar Parts Accessories 1620x6x1.5mm",142000,142000,0,0
TIKI,thoi-trang-nam,52344373,"Áo Sơ Mi Nam Dài Tay Kẻ Caro Phong Cách Unisex Thời Trang PONIVA Mẫu Mới Hot Trend",157000,157000,0,0
TIKI,cross-border-hang-quoc-te,80620627,"2x Screen Printing Frame Silk Print Mesh for Printed Circuit Boards 120T",389000,389000,0,0
TIKI,thoi-trang-nam,136792823,"Áo phông nam ngắn tay cao cấp đẹp cổ tròn chất vải cotton co giãn 4 chiều thoáng mát ZAVAS  Z14",189000,289000,100000,35
TIKI,thoi-trang-nam,73570874,"Áo Thun Nam Cổ Tròn Nhiều Màu - SIZE",21000,21000,0,0
TIKI,cross-border-hang-quoc-te,100217019,"Giá đỡ cần câu cá báo động cá cắn câu, bằng thép không gỉ 35-60cm",159000,159000,0,0
TIKI,cross-border-hang-quoc-te,95847903,"Speedometer side mount Relocation Kit Speed Gauge bracket for Harley Sportster XL883 X1200",516000,516000,0,0
TIKI,cross-border-hang-quoc-te,184952612,"Vòng Cổ Cho Chó Lớn Vừa Có Thể Điều Chỉnh - Xanh Lá Quân Đội",226700,226700,0,0
TIKI,thoi-trang-nam,154292862,"Quần đùi short gió nam thể thao Họa Tiết Rằn Ri trẻ trung năng động, thoáng mát co giãn 4 chiều MRM Manlywear",139000,199000,60000,30
TIKI,cross-border-hang-quoc-te,116417938,"4xResistive pen Touch Screen Stylus Replacement for Console/Tab/ Phone",96000,96000,0,0
TIKI,thoi-trang-nam,103850371,"Quần Lót nam thông hơi, Quần Boxer nam vải thun lụa băng co giãn thoáng mát thương hiệu BAW (Combo 5 quần màu ngẫu nhiên) NT7979",159000,159000,0,0
TIKI,cross-border-hang-quoc-te,165218566,"Cần câu cá cầm tay TFR006 bằng sợi carbon",292000,292000,0,0
TIKI,thoi-trang-nam,49009139,"ÁO SƠ MI NAM HỌA TIẾT THÊU CAO CẤP CHẠY NHẤT THỊ TRƯỜNG",77000,77000,0,0
TIKI,cross-border-hang-quoc-te,96676623,"4 String Electric Guitar Music Bass Tremolo Bridge for Headless Bass Guitar",949000,949000,0,0
TIKI,cross-border-hang-quoc-te,177989263,"Universal 8 Billiard Round Car M12X1.25 Gear Shift Knob with M10x1.5 Nut",280000,280000,0,0
TIKI,thoi-trang-nam,42424755,"Quần Jogger Nam Thể Thao - Quần Nỉ Nam Lót Lông Cao Cấp Chính Hãng",197000,350000,153000,44
TIKI,thoi-trang-nam,20464385,"Combo 3 quần lót nam brief iBasic PANM077 - Đen/Xám/Xanh",189000,297000,108000,36
TIKI,cross-border-hang-quoc-te,146553974,"CINCATDY Tai Nghe Bluetooth V5.0 Earbuds Gaming Headphone True Wireless Headset SE-6 - Hàng Chính Hãng",368000,368000,0,0
TIKI,thoi-trang-nam,29436675,"Combo 5 Quần Lót Nam lưng Thái 2 chiều vải cotton hiệu CITYMEN, màu ngẫu nhiên, đồ lót - LMTK-THAI2C",100000,100000,0,0
TIKI,thoi-trang-nam,99995337,"Áo thun nam nữ unisex from rộng in hình chú mèo cầm chảo may mắn",11000,11000,0,0
TIKI,cross-border-hang-quoc-te,109633752,"100 Pieces Wholesale Vintage Silver Rose Flower Pattern Loose Spacer Beads Jewelry Making",110000,110000,0,0
TIKI,cross-border-hang-quoc-te,116500619,"2xOutboard Boat Dual Water Feed Motor Flusher Round Ear Muff Cup Universal",744000,744000,0,0
TIKI,thoi-trang-nam,90979601,"Áo Khoác Dù Nam chống nước ( TẶNG QUẦN LÓT HÀNG HIỆU ) Dokafashion Cao Cấp 2 Lớp Vải Dù Ấm Áp Cản Gió Đi Nắng, Chống Nước EZDS23",139000,209000,70000,33
TIKI,cross-border-hang-quoc-te,253645977,"Kllisre DDR4 RAM 8GB 4GB 16GB 2400 2666 3200 Bộ nhớ máy tính để bàn DRIM",347045,347045,0,0
TIKI,thoi-trang-nam,143666661,"Áo Sơ Mi Ngắn Tay Cổ Vest Trơn Vải Lụa Nam Nữ Unisex",99000,99000,0,0
TIKI,cross-border-hang-quoc-te,170608628,"Sách - Hardball for Women : Winning at the Game of Business by Pat Heim (paperback)",578000,578000,0,0
TIKI,thoi-trang-nam,162148842,"Áo sơ mi nam công sở trung niên dài tay trắng thương hiệu Anton- XA12",225000,325000,100000,31
TIKI,thoi-trang-nam,13781471,"Quần Jean Nam TS351",123000,123000,0,0
TIKI,cross-border-hang-quoc-te,271024273,"Weatherproof Outlet Cover Durable for Swimming Pools Bathroom Indoor Outdoor",151000,151000,0,0
TIKI,thoi-trang-nam,183691492,"Quần Âu Nam Hàn Quốc Màu Đen Mẫu Mới 2022",115000,115000,0,0
TIKI,thoi-trang-nam,19242497,"Bộ 5 Chiếc Quần Đùi Nam Mắc Nhà Phối Sọc",96000,96000,0,0
TIKI,thoi-trang-nam,52150342,"Bộ vest nam màu đen form ôm body chất liệu vải mềm mịn tặng combo phụ kiện",650000,1300000,650000,50
TIKI,thoi-trang-nam,76091452,"Áo thun One Piece Luffy Mũ Rơm T13 mẫu mới cực đẹp, có size bé cho trẻ em / áo thun Anime Manga Unisex Nam Nữ, áo phông thiết kế cổ tròn basic cộc tay thoáng mát",45000,45000,0,0
TIKI,thoi-trang-nam,74531596,"Quần khaki nam 1 ply ống đứng màu da bò Khatoco Q2M468R1-VNMA016-1908-1",169000,468000,299000,64
TIKI,thoi-trang-nam,164157919,"Áo Thể Thao Nam TSIMPLE cổ tròn tay ngắn tập gym vải thun lạnh thoáng mát co giãn chuẩn form MSSAHP009",95000,165000,70000,42
TIKI,thoi-trang-nam,110309352,"ÁO LÓT TAY NGẮN COTTON CATRIO LÀ ÁO THUN, ÁO PHÔNG, ÁO NGẮN TAY CỦA NAM TỪ 50KG ĐẾN 83KG thuộc đồ mặc đi ngủ, mặc ở nhà, mặc lót bên trong áo sơ mi, vải 100% cotton an toàn",65000,65000,0,0
TIKI,thoi-trang-nam,146935717,"[HÀNG XỊN ] Quần âu nam, quần tây nam chất vải chéo cao cấp co giãn , đường may chuẩn, kiểu dáng sang trọng ,lịch lãm",59000,59000,0,0
TIKI,thoi-trang-nam,14064627,"Combo 2 Áo phông ba lỗ thoát nhiệt Nhật Bản , áo lót nam hàng hiệu cao cấp xuất khẩu",258000,258000,0,0
TIKI,thoi-trang-nam,73667467,"Áo sơ mi cổ bẻ dài tay hàn quốc, sơ mi nam trắng dáng ôm body chất lụa thái thấm hút mồ hôi, co giãn nhẹ, size áo từ 45-80 kg",68000,68000,0,0
TIKI,thoi-trang-nam,133864555,"Quần Lót Nam Boxer Cotton 4 Chiều Lưng Thái Cao Cấp, Quần Sịp Đùi Nam, Co Giãn Và Thấm Hút Tốt CITYMEN - ( Màu Ngẫu Nhiên )",56000,56000,0,0
TIKI,thoi-trang-nam,196551211,"Áo polo nam YODY phông tay ngắn basic, cổ bẻ mắt chim co giãn 4 chiều thoải mái APM5431",349000,349000,0,0
TIKI,thoi-trang-nam,67516317,"Áo Khoác Kaki Nam Áo Khoác Nam Hai Lớp FS Chống Nắng Chống Lạnh Cao Cấp KK46 - ShopN6 (Nhiều Màu)",189000,240000,51000,21
TIKI,thoi-trang-nam,174029817,"ÁO SƠ MI KAKI NAM NỮ",259000,259000,0,0
TIKI,thoi-trang-nam,114144333,"Quần đùi MAY 10 loại mở moi, có cúc cài thuận tiện (giao màu ngẫu nhiên)",45000,45000,0,0
TIKI,thoi-trang-nam,164756938,"Áo thun nam Polo có cổ ngắn tay Atuner ATN01 (4 Màu) trẻ trung, năng động, áo phông nam cao cấp chất liệu mềm mịn, siêu thấm hút mồ hôi, thoáng mát – Hàng chính hãng",145000,229000,84000,37
TIKI,thoi-trang-nam,7170169,"Bộ 5 Quần Sịp Tam Giác Nam Nhật Bản (Nhiều mầu) - 5Star",100000,100000,0,0
TIKI,thoi-trang-nam,73214429,"Áo Khoác Nam Áo Khoác Dù Nam Nữ Hai Lớp Chống Nước Chống Nắng Chống Gió Phối Nón Cao Cấp QD54 - ShopN6 (Nhiều Màu)",159000,189000,30000,16
TIKI,thoi-trang-nam,73335809,"Áo Khoác Nam Big Size Áo Khoác Dù Nam Cổ Cao Chống Lạnh Chống Gió Chống Nắng Tia UV Cao Cấp Nam Tính Hàn Quốc QM19 - ShopN6 (Nhiều Màu)",169000,255000,86000,34
TIKI,thoi-trang-nam,178107571,"Quần tây học sinh việt tiến cấp 2 - 3",162000,162000,0,0
TIKI,thoi-trang-nam,157256582,"Áo lót nam đông xuân xuất khẩu 100% COTTON đủ size",39000,39000,0,0
TIKI,thoi-trang-nam,115124831,"áo ba lỗ nam áo lót nam chất cotton mỏng siêu mát hàng Hà Nội Việt Nam",15000,15000,0,0
TIKI,thoi-trang-nam,140523294,"Quần Tây Âu Nam - dáng hàn quốc Slim Fit không đường ly vải co giãn form ôm",99000,99000,0,0
TIKI,thoi-trang-nam,99482156,"Quần jean nam rách vảy sơn cao cấp vải co dãn hàng quảng châu PHUONGNAMSHOP cao cấp kv51x",199000,199000,0,0
TIKI,thoi-trang-nam,81141012,"Quần Jean Nam cao cấp chất bò siêu co dãnThương Hiệu Chandi, form đứng dáng đẹp mẫu mới siêu hot MR9031",160550,169000,8450,5
TIKI,thoi-trang-nam,91009116,"Quần Kaki Ống Suông Unisex Nam Nữ  Kiểu quần Baggy nam nữ mềm co dãn",76000,76000,0,0
TIKI,thoi-trang-nam,75142258,"Quần jean nam cao cấp vải xịn",110000,110000,0,0
TIKI,thoi-trang-nam,85087452,"Áo sơ mi nam ngắn tay vải chống nhăn",108000,108000,0,0
TIKI,thoi-trang-nam,176663149,"Áo khoác dù cách nhiệt GOKING cho nam nữ, áo khoác gió hàng hiệu Việt Nam cao cấp, chống gió lạnh, giữ ấm cơ thể",222000,222000,0,0
TIKI,thoi-trang-nam,67905472,"Quần Tây nam Đen, Quần âu nam dáng côn hàn quốc, vải không xù, nhăn, loại đẹp",39000,39000,0,0
TIKI,thoi-trang-nam,81513561,"Quần Kaki Nam Chất Cao Cấp Siêu nhẹ Dáng Âu ZERO Phong Cách Công Sở",200000,338000,138000,41
TIKI,thoi-trang-nam,97809476,"áo khoác dù chữ Seven zia, áo khoác dù chữ S, áo khoác bomber chữ S tay phối, Áo khoác dù nam nữ mặc / áo khoác gió nam nữ mặc / áo khoác dù kiểu bomber / áo khoác cặp đôi / áo khoác form rộng unisex ullzang",99000,99000,0,0
TIKI,thoi-trang-nam,20518214,"Quần Short Nam Khatoco Q3M318R0-VNMA034-2009-020",129000,318000,189000,59
TIKI,thoi-trang-nam,110751273,"Quần jean baggy nam, quan jeans bò ống suông rộng SR_01 HotHit 2021",59000,59000,0,0
TIKI,thoi-trang-nam,125777295,"Bộ bơi nam 408(30_100kg)",209000,209000,0,0
TIKI,thoi-trang-nam,85256106,"Áo sơ mi nam dài tay hai màu đen trắng, chất vải cotton cao cấp chống nhăn",145000,145000,0,0
TIKI,thoi-trang-nam,78924987,"Quần Jean Nam đẹp dẫn đầu xu hướng Thương Hiệu Chandi , mẫu mới form đẹp tôn dáng không quá ôm mẫu MR9007",165000,250000,85000,34
TIKI,thoi-trang-nam,4027231,"Áo Khoác Dù Nam Phối Dây Kéo - K2015",124000,124000,0,0
TIKI,thoi-trang-nam,20518136,"Quần Short Nam Khatoco Q3M378R0-CNMK005-2103-021",302400,378000,75600,20
TIKI,thoi-trang-nam,82518270," Quần jean nam đen trơn chất bò mỏng nhẹ ống côn cao cấp, phù hợp mùa hè, alex cool",129000,129000,0,0
TIKI,the-thao-da-ngoai,3188297,"Võng mùng, Túi ngủ Biệt Kích Mỹ Phối Mùng Chống Muỗi 2 lớp siêu bền Ánh Sao",200000,205000,5000,2
TIKI,the-thao-da-ngoai,94095103,"Tạ tay nhựa loại đơn 10kg",102000,113000,11000,10
TIKI,the-thao-da-ngoai,160072781,"Dây Đeo Kính Nhựa Cứng Chống Trượt - Thiết Kế Sang Trọng - Có Thể Điều Chỉnh Ôm Sát Đầu Không Bị Thừa Dây",45000,45000,0,0
TIKI,the-thao-da-ngoai,192287932,"Giày Thể Thao Nữ Biti's Hunter X LITEPLEX DSWH09800KEL",855000,1069000,214000,20
TIKI,the-thao-da-ngoai,73339363,"1 Bộ Đai Băng Bảo Vệ Đầu Gối Thể Thao",25000,25000,0,0
TIKI,the-thao-da-ngoai,189574232,"Băng gối thể thao có đệm xương bánh chè GoodFit GF523K bó gối dành cho Gym, bóng đá, cầu lông",89000,149000,60000,40
TIKI,the-thao-da-ngoai,117624345,"Phao bơi luồn tay không cần bơm hơi cho bé tập bơi",499000,790000,291000,37
TIKI,the-thao-da-ngoai,182786646,"Xà Đơn,Xà kép Đa Năng EX30 Bản Cao Cấp Tiêu Chuẩn Phòng Gym(Tặng Bộ 5 Dây đàn Hồi Cao Cấp 11 chi tiết)Ảnh Thật chi tiết dưới mô tả",4878000,4878000,0,0
TIKI,the-thao-da-ngoai,79008249,"Tăng cơ Whey Protein 100% Isolate BiPro Elite Chứng nhận "NSF Certified" - Made in USA",749000,749000,0,0
TIKI,the-thao-da-ngoai,14521206,"Bộ 2 Khăn Bịt Mặt Trơn Đen Đa Chức Năng",28000,28000,0,0
TIKI,the-thao-da-ngoai,14058016,"Bộ đồ tập GYM nam cao cấp - HM",97000,97000,0,0
TIKI,the-thao-da-ngoai,150959730,"Phao Câu Đài Ngày Đêm, phao câu đêm Phao câu cá PC-3",33100,33100,0,0
TIKI,the-thao-da-ngoai,272444481,"Sữa tăng cơ Rule 1 Whey Blend 64-69 servings - 2.2kg tặng Rule 1 Shaker",1175000,1175000,0,0
TIKI,the-thao-da-ngoai,189938605,"Túi Ngủ Cao Cấp Văn Phòng + Đi Phượt (Hàng Xuất Khẩu) - Túi Ngủ Dã Ngoại, Túi Ngủ Du Lịch - Chính hãng dododios",179000,179000,0,0
TIKI,the-thao-da-ngoai,145372670,"Máy Tập Thể Dục- Máy Tập cơ bụng, Máy Tập Toàn Thân, Ghế Tập cơ Bụng,Máy tập bụng, Ghế tập lực , máy gập cơ bụng",1289000,1289000,0,0
TIKI,the-thao-da-ngoai,71905148,"Ván Trượt Trẻ Em Mặt Nhám Kích Thước 60cm Cho Trẻ Dưới 10 Tuổi ,Chịu Lực 100kg (Màu Ngẫu Nhiên)",169000,300000,131000,44
TIKI,the-thao-da-ngoai,149586449,"Chì Câu Cá, Chì Tròn Xuyên Tâm Chất Lượng",2300,2300,0,0
TIKI,the-thao-da-ngoai,106503022,"Lều cắm trại tự bung, lều phượt du lịch dã ngoại dành cho 4-6 người, chống nước, thông gió 2 chiều",479000,479000,0,0
TIKI,the-thao-da-ngoai,1812245,"Thực phẩm bổ sung Optimum Nutrition Platinum HydroWhey 3.5lb (1.59kg)",1510500,1590000,79500,5
TIKI,the-thao-da-ngoai,71936228,"Phao bơi chống lật cho bé từ 1 tuổi đến 3 tuổi",177980,177980,0,0
TIKI,the-thao-da-ngoai,66576225,"Ruột Zippo mới chính hãng USA – màu vàng KHÔNG KÈM VỎ ZIPPO",450000,450000,0,0
TIKI,the-thao-da-ngoai,36646641,"Dụng Cụ Thể Thao Kìm Bóp Tay Mouse MS01",13000,13000,0,0
TIKI,the-thao-da-ngoai,4227213,"Bình Nước Thể Thao Chute Mag Camelbak (0.75L)",375000,375000,0,0
TIKI,the-thao-da-ngoai,130320757,"Băng Cổ Tay Thể Thao Thấm Mồ Hôi Co Giãn Thoáng Khí Mềm Mại - Bảo Vệ Cổ Tay, Hỗ Trợ Tập Thể Thao - Hàng Chính Hãng",17000,17000,0,0
TIKI,the-thao-da-ngoai,44178429,"Dụng Cụ Tập Cơ Sàn Chậu Kegel Nâng Mông - Tight & Beautiful Hip Clamp",500000,500000,0,0
TIKI,the-thao-da-ngoai,57692545,"Băng quấn trợ lực khớp cổ tay tập gym, tập boxing GoodFit co giãn 4 chiều, khóa dán chắc chăn GF301W",119000,150000,31000,21
TIKI,the-thao-da-ngoai,116813717,"Dây nhảy có bộ đếm kỹ thuật số tiện dụng 2 in 1 Sportslink",94000,104000,10000,10
TIKI,the-thao-da-ngoai,115091282,"Khăn Trải Thảm Yoga Cao Cấp Chống Trượt - YOGA QG, Độ Bám Dính Cao, Thấm Hút Mồ Hôi - Tặng Kèm Túi Đựng Khăn",145000,155000,10000,6
TIKI,the-thao-da-ngoai,1811825,"Thực phẩm bổ sung Optimum Nutrition Serious Mass 12lb (5.44kg) Vanilla",1640000,1640000,0,0
TIKI,the-thao-da-ngoai,94521913,"Mũ bơi nữ chống nước, nón bơi Silicon co giãn đa chiều, hoạt tiết đẹp, sang trọng, bảo vệ tóc và da đầu khi bơi | MM04",90000,90000,0,0
TIKI,the-thao-da-ngoai,101644212,"Giày Đi Mưa Ủng Đi Mưa Silicon Chống Trơn Trượt",41000,41000,0,0
TIKI,the-thao-da-ngoai,149608799,"Dụng Cụ Gỡ Lưỡi Câu Cá Chuyên Dụng Cao Cấp",26500,26500,0,0
TIKI,the-thao-da-ngoai,189573901,"[Loại Cao Cấp] Vòng Lắc Eo Ống Thép Mọc Mút Xốp Lắp Ghép Cao Cấp Chính Hãng DoDoDios - Vòng Lắc Eo Giảm Mỡ Bụng Ống Thép Bọc Mút Xốp - Tùy Chỉnh Độ Nặng",179000,179000,0,0
TIKI,the-thao-da-ngoai,43179685,"Bộ 2 băng quấn cổ tay,đeo cổ tay tập gym chơi thể thao LT6638 (Giao màu ngẫu nhiên)",99000,150000,51000,34
TIKI,the-thao-da-ngoai,25272876,"Lều cắm trại chống nước tự bung dành cho 2 người cỡ lớn 1m5x2m",282268,282268,0,0
TIKI,the-thao-da-ngoai,195881881,"Giày leo núi, giày trekking, giày lội nước 1045 Nâu",550000,550000,0,0
TIKI,the-thao-da-ngoai,57517299,"Băng trán thể thao nam, nữ thấm hút mồ hôi chuyên nghiệp REXCHI",45000,45000,0,0
TIKI,the-thao-da-ngoai,77149840,"Quấn cốt Babolat UPTAKE nhiều màu - thay cho một vợt (671001 màu ngẫu nhiên)",159000,159000,0,0
TIKI,the-thao-da-ngoai,43041368,"Quả bóng chuyền Thăng Long thi đấu VB7700 tặng kèm lưới đựng bóng+bim bơm bóng",738000,1499000,761000,51
TIKI,the-thao-da-ngoai,193536174,"Giày Thể Thao Trung Cấp Nữ Biti's Êmbrace DSW066300HOD (Hồng đậm)",494000,549000,55000,10
TIKI,thoi-trang-nam,32988061,"Hộp Combo 5 Sịp Đùi Loại Đẹp",199000,199000,0,0
TIKI,thoi-trang-nam,34543749,"ÁO SƠ MI NAM HỌA TIẾT CHIẾC LÁ - HÀNG CAO CẤP 100% UY TÍN",92000,92000,0,0
TIKI,thoi-trang-nam,48042781,"Áo sơ mi nam form rộng cổ 2 ve, thời trang trẻ, phong cách Hàn Quốc",159000,159000,0,0
TIKI,thoi-trang-nam,66897309,"ÁO THUN NAM CỔ LỌ",170000,170000,0,0
TIKI,thoi-trang-nam,95059515," Áo thu sát nách unisex form rộng 1975 nam nữ ulzzang Wind",88000,88000,0,0
TIKI,thoi-trang-nam,196297504,"Áo thun cổ tròn tay ngắn thời trang nam, chất cotton 100%, thấm mồ hôi cực tốt, thun co giãn 4 chiều - FORMEN SHOP - FMPS194",179000,350000,171000,49
TIKI,thoi-trang-nam,71659029,"Áo Khoác Nam Nữ form cực rộng, Áo cặp hoodie nam nữ từ 46kg đến 68kg",96900,96900,0,0
TIKI,thoi-trang-nam,14848656,"Combo 2 Áo phông trơn basic, form unisex cho nam nữ. Áo thun hàng hiệu Goking, quà tặng cao cấp cho gia đình, cặp đôi, lớp nhóm, doanh nghiệp, người nước ngoài",259000,259000,0,0
TIKI,thoi-trang-nam,6187707,"Bộ 5 quần sịp đùi xuất Nhật chất lụa cao cấp",74098,74098,0,0
TIKI,thoi-trang-nam,12218705,"Áo sơ mi caro nam nữ 4young phong cách Hàn Quốc SM13",117000,117000,0,0
TIKI,thoi-trang-nam,169679982,"Quần jean nam CO GIÃN chất bò ống suông trung niên rộng rãi thoải mái loại quần jean ống đứng QJEAN22",155000,155000,0,0
TIKI,thoi-trang-nam,51638534,"Áo Sơ Mi Nam Trơn Ngắn Tay Form Chuẩn",138000,138000,0,0
TIKI,thoi-trang-nam,192032418,"Quần nam lửng, lưng thun kaki Amazing, sọt lưng thun nam dáng thể thao unisex, quần đùi có dây rút",159000,239000,80000,33
TIKI,thoi-trang-nam,52848986,"Combo 2 quần short nam thể thao thun lạnh cao cấp thoải mái, năng động, trẻ trung - FORMEN SHOP - FMCB3PS094",279000,380000,101000,27
TIKI,thoi-trang-nam,15054744,"Áo Sơ Mi Nam Ngắn Tay SMH98 - SMH98D",180000,180000,0,0
TIKI,thoi-trang-nam,192683632,"ÁO SƠ MI TAY NGẮN-V46-014619-GY5",2990000,2990000,0,0
TIKI,thoi-trang-nam,161494286,"quần lót nam relax underwear thun lạnh cao cấp chính hãng, quần sip nam rltk16",86000,86000,0,0
TIKI,thoi-trang-nam,195949063,"Quần âu nam hàn quốc màu đen ADINO vải cotton không bai không xù co giãn dáng công sở slimfit ống đứng hơi côn QA140",249000,380000,131000,34
TIKI,thoi-trang-nam,84866436,"Quần Lót Nam Lọt Khe Siêu Gợi Cảm Boxers Brave Person B1181",99000,200000,101000,51
TIKI,thoi-trang-nam,184072326,"Áo Gile nam, Áo Gile phối dây đai 2 bên Ngực cách điệu, lịch lãm, trẻ trung, phong cách. Mã N41",269000,269000,0,0
TIKI,thoi-trang-nam,90415269,"ÁO SƠ MI NAM XẾP LY",99000,99000,0,0
TIKI,thoi-trang-nam,111586884,"Áo sơ mi đũi nam cổ tầu form rộng mở khuy tay lỡ, thời trang phong cách trẻ",189000,189000,0,0
TIKI,thoi-trang-nam,68961881,"Quần lót boxer nam thun lạnh cực mát Nhật Bản",39000,39000,0,0
TIKI,thoi-trang-nam,163928733,"Ăn chơi là phải có hội, mã TB1. Áo thun team building đồng đội, áo phông đẹp cho lớp nhóm, công ty. Áo phông hàng hiệu Goking, form unisex cho nam nữ, trẻ em, bé gái trai",69000,69000,0,0
TIKI,thoi-trang-nam,263040176,"Bộ áo bà nam truyền thống đỏ đô - Có bộ bà ba Bigsize- may sỉ bà ba toàn quốc - May bộ bà ba theo yêu cầu",199000,199000,0,0
TIKI,thoi-trang-nam,93233783,"Áo Khoác Big Size Nam Nữ Unisex Áo Khoác Dù Nam 2 Lớp Chống Nắng Chống Lạnh Chống Gió Thời Trang Phom Body Phối Màu Hàn Quốc Cao Cấp AD73 - ShopN6",149000,180000,31000,17
TIKI,thoi-trang-nam,87011090,"Áo Thun Nam Ngắn Tay Chandi, Chất Thun Cotton Xịn Mẫu Mới NT18",123000,199000,76000,38
TIKI,thoi-trang-nam,98625822,"Quần Short Nam Rách️️ Quần Short Bò Nam Cao Cấp - Sọt Jean Co Giãn Mẫu Mới Hàng VNXK Tô Tồ Shop-QSJN02-Mã 211",179000,179000,0,0
TIKI,thoi-trang-nam,130745782,"Combo 4 Quần Lót Nam Boxer Cotton 4 Chiều Lưng Thái Cao Cấp, Quần Sịp Đùi Nam Thoáng Mát - ( Giao Màu Ngẫu Nhiên )",190000,190000,0,0
TIKI,thoi-trang-nam,179163908,"(Big size <130kg) quần tây nam form slim fit big size đủ màu",330000,330000,0,0
TIKI,thoi-trang-nam,151799597,"QUẦN LÓT NAM - Tam Giác Bikini Bản Nhỏ Gọn - Thun Lạnh Sọc Siêu Mát",39000,39000,0,0
TIKI,thoi-trang-nam,163902635,"Áo Sơ Mi Nam Xanh Dương Kẻ Caro Ngắn Tay Công Sở Trung Niên Thương Hiệu Anton Vải Sợi Tre - GD566",355000,355000,0,0
TIKI,thoi-trang-nam,149684151,"ÁO KHOÁC DÙ CAO CỔ NAM NỮ TMS MIDSIDE",95000,95000,0,0
TIKI,thoi-trang-nam,193762563,"Viettien - Quần tây nam màu xám sáng 1R4034 - 1R4035 - 1R4036 loại có ly và không ly - Quần âu cao cấp Việt Tiến",710000,710000,0,0
TIKI,thoi-trang-nam,188579845,"Áo Thun Trơn Couple TX Cổ Tròn Basic Nam MTS 1132",159000,159000,0,0
TIKI,thoi-trang-nam,177275239,"Áo sơ mi form rộng nam nữ tay dài unisex phong cách hàn quốc trẻ trung vải lụa mềm mịn mát - MRD02",105000,190000,85000,45
TIKI,thoi-trang-nam,112969165,"COMBO 4 QUẦN LÓT BOXER NAM ROSSO 0002 - UNDERWEAR MÀU NGẪU NHIÊN",480000,480000,0,0
TIKI,thoi-trang-nam,144526512,"Áo dạ nam - kiểu dáng hiện đại, style Hàn Quốc (R8)",299000,299000,0,0
TIKI,thoi-trang-nam,179161511,"SƠ MI BBR TAY NGẮN BIG SIZE NAM TỚI 130KG ĐỦ MÀU",255000,255000,0,0
TIKI,thoi-trang-nam,74493882,"Áo thun unisex tay lỡ form rộng - phông thêu 4 logo",79000,125000,46000,37
TIKI,the-thao-da-ngoai,42741070,"Bộ 10 Ống Kim Bơm Xe Đạp, Bơm bóng",22000,22000,0,0
TIKI,the-thao-da-ngoai,123491030,"Xe đạp thể dục toàn thân Airbike Sport - Hàng chính hãng",1543000,2990000,1447000,48
TIKI,the-thao-da-ngoai,193613966,"Giày bóng rổ cổ cao siêu Kyri7 - Sneaker bóng rổ",425000,768000,343000,45
TIKI,the-thao-da-ngoai,66401966,"Xà Đơn Gắn Cửa Hoặc Treo Tường Chốt Chống Xoay Màu Đen Xanh Dương(Chọn Kích Thước)- Mẫu Cải Tiến Chất Lượng Vượt Trội",232000,450000,218000,48
TIKI,the-thao-da-ngoai,139419650,"Dây Đai Thổ Cẩm Cotton Tập Yoga, Dây Kéo Tập Yoga - YOGA QG, Có Họa Tiết, Hoa Văn Bắt Mắt, Độc Lạ; Hỗ Trợ Tập Các Bài Giãn Cơ, Uốn Dẻo, Kéo Giãn Cơ Thể - Hàng chính hãng",40000,55000,15000,27
TIKI,the-thao-da-ngoai,66646093,"Dụng Cụ Tập Hít Đất Cầm Tay Thép Cứng Cao Cấp – Đen - mi02 - Dụng Cụ Chống Đẩy miDoctor (Đường Kính Khung 18MM)",72000,72000,0,0
TIKI,the-thao-da-ngoai,150560014,"Chì Lá Câu Đài Cuốn Sẵn Thanh Cuốn Chì Cao Cấp (Sét 10 viên) PK33",18000,18000,0,0
TIKI,the-thao-da-ngoai,17616979,"ĐAI LƯNG MỀM TẬP THỂ HÌNH, GYM",140000,140000,0,0
TIKI,the-thao-da-ngoai,42895484,"Đai Lưng Tập Gym Harbinger Padded Leather Belt 4 Inch – Loại Da",750000,750000,0,0
TIKI,the-thao-da-ngoai,149435042,"Lưới Bát Quái Bắt Cá, Tôm, Cua, Lươn, Trạch Lồng bát quái, lưới đánh cá LDC-1",30000,30000,0,0
TIKI,the-thao-da-ngoai,20629152,"Găng chống nắng chống tia UV- PGM XT002",105000,105000,0,0
TIKI,the-thao-da-ngoai,95023415,"Kính Bơi Cận Thị Từ 2 Độ Tới 8 Độ Cleacco Dành Cho Người Cận Nam Nữ Dùng Được , Thấu Kính Trong HD Chống Sương Mờ - Hàng Chính Hãng",279000,404000,125000,31
TIKI,the-thao-da-ngoai,124068115,"Dụng Cụ Hỗ Trợ Tập Cổ Tay Và Cơ Tay Cao Cấp Loại 1 Đại Nam Sport",89000,150000,61000,41
TIKI,the-thao-da-ngoai,186805865,"Combo Pre-Workout Vapor X5 của MuscleTech hỗ trợ Tăng Sức Bền, Sức Mạnh đốt mỡ giảm cân & bình lắc 600 ml (Mẫu Ngẫu Nhiên)",575000,1250000,675000,54
TIKI,the-thao-da-ngoai,20869561,"Trụ hơi đấm bốc tự cân bằng cho người lớn + tặng kèm bơm hơi đa năng",165000,165000,0,0
TIKI,the-thao-da-ngoai,130398012,"Gậy Gập Bẻ Tập Cơ Tay Tower Twister XB-1030",210000,231000,21000,9
TIKI,the-thao-da-ngoai,106503489,"Ghế gấp dã ngoại du lịch gọn tiện lợi",299000,299000,0,0
TIKI,the-thao-da-ngoai,35147989,"Bộ Kính Bơi View V500S Và Nút Bơi Nhét Tai EP405 - Hàng Chính Hãng",365000,575000,210000,37
TIKI,the-thao-da-ngoai,46567662,"Bình Nước Xe Đạp Thể Thao Camelbak Podium Dirt Series 620ml Có Nắp Đậy Chống Đất Cát",299000,299000,0,0
TIKI,the-thao-da-ngoai,6559555,"Bật Lửa Zippo Armor Brushed Brass 168",870000,870000,0,0
TIKI,the-thao-da-ngoai,43864594,"Băng bảo vệ cổ-gót chân 6624",25000,25000,0,0
TIKI,the-thao-da-ngoai,15160381,"Trụ Đấm Bốc UFC99 - Trụ Đấm Cao Cấp",345000,345000,0,0
TIKI,the-thao-da-ngoai,173383171,"Kìm Bóp Tay, Dụng Cụ Tập Cơ Tay Tập Gym Tại Nhà Điều Chỉnh Lực Có Đếm 10-60kg",120000,120000,0,0
TIKI,the-thao-da-ngoai,186477773,"COMBO BỘ 2 BÓ GỐI TẬP THỂ DỤC THỂ THAO ,YOGA,BÓNG CHUYỀN NAM NỮ(1ĐÔI)ẢNH THẬT DƯỚI MÔ TẢ",158000,158000,0,0
TIKI,the-thao-da-ngoai,19554519,"Bảng chiến thuật bóng đá gấp New 6135",102743,190000,87257,46
TIKI,the-thao-da-ngoai,68821395,"Dụng Cụ Bẻ Cổ Tay Cao Cấp Hỗ Trợ Rèn Luyện Cơ Tay,Bắp Tay Hàng Đẹp Giá Tốt Lực Tập 25-30kg",76000,89000,13000,15
TIKI,the-thao-da-ngoai,69748679,"Dây quấn cổ tay có móc nâng tạ GoodFit GF732LS",199000,299000,100000,33
TIKI,the-thao-da-ngoai,178107558,"Khăn Trùm Đầu UPF 50+ Ninja Fullface Chống Nắng WU101 - Cản Tia Cực Tím - Thoáng Khí - Đàn Hồi | Phụ kiện đi phượt, chạy xe",80750,85000,4250,5
TIKI,the-thao-da-ngoai,182805036,"Bóng tập yoga có gai đường kính 75cm chịu lực 200kg(tặng bơm Bóng)",258000,258000,0,0
TIKI,the-thao-da-ngoai,2282589,"Bộ 3 Sản Phẩm Xăng, Đá, Bấc Zippo",195000,195000,0,0
TIKI,the-thao-da-ngoai,125525741,"Bộ 2 đai bảo vệ đầu gối AOLIKES YE-7901 hỗ trợ khớp gối Knee Support Braces",356000,489000,133000,27
TIKI,the-thao-da-ngoai,77329853,"Giày trượt patin cao cấp bánh cao su phát sáng có size từ 38-44 cho thanh niên và người lớn",850000,850000,0,0
TIKI,the-thao-da-ngoai,147943549,"[Hàng Cao Cấp] Thảm Tập Yoga Định Tuyến Da PU Cao Cấp Chính Hãng dododios + Túi Đựng Thảm Tập Yoga + Dây Buộc Thảm Yoga Định Tuyến",449000,449000,0,0
TIKI,the-thao-da-ngoai,36093464,"Đĩa Xoay Eo 360 Tập Thể Dục XE11",36000,36000,0,0
TIKI,the-thao-da-ngoai,141619690,"dù câu cá câu lure x8 siêu bền",35000,35000,0,0
TIKI,the-thao-da-ngoai,35131225,"Đai Lưng Có Xích Treo Tạ Dip Belt Valeo",255000,255000,0,0
TIKI,the-thao-da-ngoai,163748506,"Bao Đựng Cần Câu Đông Hải 1m2 Túi Đựng Cần Câu Cá Chất Liệu Vải PU Và Nhựa ABS Phụ Kiện Câu Cá Cao Cấp",158500,158500,0,0
TIKI,the-thao-da-ngoai,57307581,"Bộ vòng xà tay tập thể dục Ring Dip ",410000,410000,0,0
TIKI,the-thao-da-ngoai,428882,"Hộp 3 Banh Bóng Bàn",39989,39989,0,0
TIKI,the-thao-da-ngoai,13849819,"Túi đeo hông,Túi đeo bụng nam, nữ thể thao",29999,29999,0,0
TIKI,thoi-trang-nam,42629498,"Quần kaki ống côn nam chất kaki mềm",85000,85000,0,0
TIKI,thoi-trang-nam,42876060,"Áo sơ mi nam tay dài SM00009",98000,98000,0,0
TIKI,thoi-trang-nam,189677243,"Áo sơ mi nam ngắn tay trắng Classic NSMMMWNTCC220128N",293550,309000,15450,5
TIKI,thoi-trang-nam,90066960,"(Video ) Áo khoác dù , áo khoác cặp đôi  , áo khoác gió , áo khoác nam kiểu bomber vải dù ngoại 2 lớp",98000,98000,0,0
TIKI,thoi-trang-nam,135232410,"Combo 5 Quần đùi mặc nhà nam ( giao màu ngẫu nhiên )",124000,124000,0,0
TIKI,thoi-trang-nam,188916034,"Quần Đùi Nam Thun Lạnh Cao Cấp FASVIN HL22497.HN Hàng Nhà Máy Chất Lượng Đặc Biệt",179000,338000,159000,47
TIKI,thoi-trang-nam,171477321,"Áo Thun Nam Ngắn Tay Có Cổ Chandi, Chất Thun Cotton Xịn Thấm Hút Mồ Hôi Mẫu Mới Hot Trend NT11",151000,220000,69000,31
TIKI,thoi-trang-nam,199105217,"Áo khoác trung niên nam có lót phao VARDINO cực ấm vải nhẹ cao cấp có 2 túi trong dáng suông và séc chống kẹt AK56, AK57",1250000,1250000,0,0
TIKI,thoi-trang-nam,3714895,"Combo 5 Quần Lót Nam Freeman 6041-CB5-M (Size",260000,325000,65000,20
TIKI,thoi-trang-nam,35193565,"[FREEMAN] Combo 3 quần boxer nam BO501",213300,237000,23700,10
TIKI,thoi-trang-nam,71020058,"Combo 4 quần đùi mặc nhà chất liệu thun cotton cao cấp phom dáng năng động trẻ trung chính hãng Fezzio",238000,476000,238000,50
TIKI,thoi-trang-nam,190195064,"Sơ mi măng sét Anlimen Gentle Cuff Shirt - AGS04",890000,890000,0,0
TIKI,thoi-trang-nam,70327515,"Combo 5 Quần Đùi Nam Mặc Nhà Vải Cotton Thông Thoáng - giao màu ngẫu nhiên ",150000,150000,0,0
TIKI,thoi-trang-nam,183729019,"Áo Sơ Mi Nam, Áo Sơ Mi dài tay Cổ Vest phối 2 màu Đen Trắng phong cách trẻ trung, lịch lãm mã H50",199000,199000,0,0
TIKI,thoi-trang-nam,101656078,"Áo Dạ Nam Áo Măng Tô Nam Dáng Dài Sẵn Hàng Chất Đẹp Sans Shop Sans02",639000,639000,0,0
TIKI,thoi-trang-nam,80620917,"Áo Khoác Dù Chống Nắng dành cho nam nữ và cặp đôi Có 2 Màu, Unisex Form Rộng DELLI Jacket Ulzzang",99000,99000,0,0
TIKI,thoi-trang-nam,71920655,"Áo khoác dù , áo khoác gió  nam nữ mặc , áo khoác nam nữ mặc vài dù 2 lớp size L và XL",97000,97000,0,0
TIKI,thoi-trang-nam,70903617,"Áo sơ mi nam ngắn tay cổ trụ thời trang SITAKI vải siêu chất SM801",175000,175000,0,0
TIKI,thoi-trang-nam,4616527,"Áo thun ba lỗ cổ vuông nam Facioshop UB07",48000,48000,0,0
TIKI,thoi-trang-nam,72673381,"Áo sơ mi nam trơn nhiều màu Amazing, vải Bamboo mềm mịn thấm hút, dáng truyền thống, vạt bầu, tay dài",239000,349000,110000,32
TIKI,thoi-trang-nam,43161858,"Combo 4 quần sịp đùi nam quần lót nam Cao Cấp Boxer MRM FASHION (2 màu)",265000,360000,95000,26
TIKI,thoi-trang-nam,11270133,"Quần Jean Nam Đen Dáng Ôm Chất Co Giãn JEAN01",158000,158000,0,0
TIKI,thoi-trang-nam,53303559,"Bộ vest nam 2 nút form suông màu đen chất liệu co dãn , thoáng mát tặng kèm combo phụ kiện",650000,1300000,650000,50
TIKI,thoi-trang-nam,72524903,"Aó hoodie nam , áo hoodie nữ , áo khoác áo hoodie cặp đôi nam nữ mặc",103000,103000,0,0
TIKI,thoi-trang-nam,24755349,"Bộ 4 quần lót nam xuất Nhật thông hơi - thoáng khí",77900,77900,0,0
TIKI,thoi-trang-nam,19455735,"Aó vest da nam đẹp AKD345",720000,720000,0,0
TIKI,thoi-trang-nam,130787763,"OWEN - Áo sơ mi dài tay Owen Slimfit chất sợi tre màu trắng sọc xanh 23305",568000,568000,0,0
TIKI,thoi-trang-nam,134490721,"Quần lót nam Tam giác chất thun mềm LADOS - 4113",21000,38000,17000,45
TIKI,thoi-trang-nam,161952378,"Áo Khoác Nỉ Nam Cao Cấp - Vải Nỉ Nhập Mặt Thoáng Mát,Có Nón Che Rộng Cao Cấp AK016",105000,105000,0,0
TIKI,thoi-trang-nam,97932700,"Đồ bộ đi biển (vải kate thái, ảnh chụp thật) giá cực tốt, đủ size cho cả gia đình",58000,58000,0,0
TIKI,thoi-trang-nam,197693327,"Quần tây nam 0Ply Novelty màu đen Classic NQTMMDNTRC2203020",479000,479000,0,0
TIKI,thoi-trang-nam,26729467,"Áo thun nam tay dài cao cấp",145000,145000,0,0
TIKI,thoi-trang-nam,197899578,"Áo gile nam, áo gile phóng viên nhiếp ảnh, áo gile công trường ARM-945",450000,450000,0,0
TIKI,thoi-trang-nam,20518837,"Quần Kaki Nam Khatoco Q2M528S0-CNMA002-2006-0- Nâu Nhạt",199000,528000,329000,62
TIKI,thoi-trang-nam,91533035,"Áo Hoodie Nỉ - Áo Khoác Nỉ Nam Nữ Unisex Nỉ BECHY 4 Màu Cực Hot, ÁO HOODIE GẤU BECHY, ÁO HOODIE UNISEX NAM NỮ ĐẦU MẶC ĐƯỢC, ÁO HOOIDE TAY PHỒNG ULZZANG, áo hoodie tránh mưa, chống nắng",99000,99000,0,0
TIKI,thoi-trang-nam,57786091,"Áo Khoác Kaki Nam 2 Lớp Giả Vest Phối Khóa Ngực Cao Cấp ShopN6 - KK42 (Nhiều Màu)",169000,245000,76000,31
TIKI,thoi-trang-nam,216900984,"Quần áo điện lực tiêu chuẩn màu cam vải Pangrim EVNSPC (miền nam)",485000,485000,0,0
TIKI,thoi-trang-nam,183371659,"Áo sơ mi nam vải đũi tay dài thời trang",139500,139500,0,0
TIKI,thoi-trang-nam,146515449,"Áo Khoác Nhung Gân Tăm Bomber Jackets Thêu Logo G.O.N.Z Cúc Bấm Unisex Nam Nữ Form Rộng Ulzzang, Áo Khoác Nhung Tăm Thêu Chữ G, Áo BomBer Bóng Chày Nam Nữ Phong Cách Hàn Quốc",166000,166000,0,0
TIKI,thoi-trang-nam,97822276,"Áo khoác dù Handes cặp đôi nam nữ mặc siêu ngầu hình sói , chất dù 2 cao cấp 2 lớp - Form rộng Unisex size M  L  XL nam nữ mcawj tôn dáng đep - Áo khoác gió nam nữ",97000,97000,0,0
TIKI,thoi-trang-nam,197603511,"Áo Khoác Da Nam, Áo Khoác Da Lót Lông Siêu Ấm Mùa Thu Đông Phối Khóa Đồng Cao Cấp Thời Trang Dokafashion EZAD28",289000,499000,210000,42
TIKI,thoi-trang-nam,172280664,"Stay STRONG, never give up, mã G117. Áo thun in chữ siêu đẹp cho nam nữ, form unisex. Áo phông hàng hiệu Goking. Quà tặng cao cấp cho gia đình, cặp đôi, doanh nghiệp",99000,99000,0,0
TIKI,thoi-trang-nam,196548162,"Áo khoác trung niên nam VARDINO cổ bẻ kiểu cúc đóng dòng công sở cao cấp có 2 túi trong dáng suông AK55",1350000,1350000,0,0
TIKI,thoi-trang-nam,167402284,"Viettien - Áo sơ mi nam dài tay họa tiết 1N2094 chất liệu sợ tre regular",580000,580000,0,0
TIKI,thoi-trang-nam,94878988,"Viettien - Quần tây màu đen regulat fit 8P4037",540000,540000,0,0
TIKI,thoi-trang-nam,160608094,"Quần lót nam sexy STUD underwear U1044AJS22",965000,965000,0,0
TIKI,thoi-trang-nam,80975175,"Áo Thun Nam Có Cổ Tay Ngắn Polo Trơn Thời Trang VICERO 6 Màu",99000,198000,99000,50
TIKI,thoi-trang-nam,34909799,"Hộp 4 chiếc quần sịp đùi nam thông hơi ( KÈM HỘP GIẤY )",92000,92000,0,0
TIKI,thoi-trang-nam,253293783,"Áo khoác nam trung niên TRAZ chống nhăn, chống thấm nước, quà tặng bố, tặng ông",1100,1100,0,0
TIKI,thoi-trang-nam,100897026,"Bộ Mặc Nhà Nam Mùa Hè Mát Mẻ Cao Cấp Thời Trang ZERO",209000,300000,91000,30
TIKI,thoi-trang-nam,104109417,"Hộp 5 Quần Lót Nam lưng Hàn Quốc hiệu CITYMEN vải cotton co giãn 4 chiều cao cấp, sịp nam - LMTK-HANAC",190000,190000,0,0
TIKI,thoi-trang-nam,111586430,"Áo thun nam cổ bẻ cơ bản phối túi ngực, hàng nhập Quảng Châu",134000,134000,0,0
TIKI,thoi-trang-nam,53283479,"Áo gile nam ôm body màu xanh đen chất liệu vải dày mịn",220000,220000,0,0
TIKI,thoi-trang-nam,20868674,"Áo Thun Nam Tay Dài D404",95000,95000,0,0
TIKI,thoi-trang-nam,109545851,"Quần đùi nam xuất khẩu mặc nhà, quần đùi nam, quần short, quần sọc nam vải kate cotton 100% thương hiệu Fezzio",64500,129000,64500,50
TIKI,thoi-trang-nam,35193581,"[FREEMAN] Combo 5 quần lót nam 639",196000,245000,49000,20
TIKI,thoi-trang-nam,191926050,"Quần đùi nam thể thao vải gió siêu nhẹ, quần short nam vải gió cao cấp QD01 - PROMAN",80000,80000,0,0
TIKI,thoi-trang-nam,114744071,"Áo thun Teeworld Bánh Mì T-shirt Màu Trắng Đen Nam Nữ Form Rộng Unisex",339000,339000,0,0
TIKI,thoi-trang-nam,178058234,"Áo thun nam có cổ trơn cao cấp LADOS-9084 vải poli siêu mát mẻ, thấm hút mồ hôi tốt, form đẹp",139000,199000,60000,30
TIKI,thoi-trang-nam,168224742,"[COMBO 3 QUẦN] Quần Lót Nam Boxer Thun Lạnh Lados 4116 - Thun lụa co giãn, dai, thoáng mát, thấm hút mồ hôi tốt",180000,180000,0,0
TIKI,thoi-trang-nam,89264090,"Áo khoác bomber nam nữ kaki oversize Áo bomber form rộng Áo khoác bóng chày Candle unisex - Gin Store",98000,98000,0,0
TIKI,thoi-trang-nam,52132212,"áo khoác jean nam sước",175000,175000,0,0
TIKI,thoi-trang-nam,164239110,"Áo Thể Thao Nam TSIMPLE cổ tròn tay ngắn tập gym vải thun lạnh thoáng mát co giãn chuẩn form MSSAHP010",165000,165000,0,0
TIKI,thoi-trang-nam,78945617,"Quần Jean Nam cao cấp co dãn 4 chiều Thương Hiệu Chandi, phong cách hàn quốc trẻ trung cá tính MR9019",184000,299000,115000,38
TIKI,thoi-trang-nam,76702054," Quần đùi nam loại caro nhỏ chất vải mềm mịn free size dưới 65kg",18000,18000,0,0
TIKI,thoi-trang-nam,110139205,"Áo Gile Nam Lính Mỹ U869 Phong Cách US ARMY - HÀNG CHÍNH HÃNG",361000,798000,437000,55
TIKI,thoi-trang-nam,144231872,"Baggy ống rộng Nam - Quần Jean Nam Phong cách hàn quốc- quần bò nam ( ống rộng xám cg 1 bên)",185000,185000,0,0
TIKI,thoi-trang-nam,121622214,"Áo khoác dù 2 mặt 2 lớp chống trượt nước Lados - 2015 form unisex trẻ trung đơn  dễ phối",229000,399000,170000,43
TIKI,thoi-trang-nam,162089085,"QUẦN KAKI NAM TÚI MỸ DÁNG SUÔNG",160000,160000,0,0
TIKI,thoi-trang-nam,94851422,"Quần Lót Nam Thun Lạnh Thương Hiệu Brave Person B1141 - Chất vải thun lạnh cao cấp, mềm mịn, siêu thoáng mát, co dãn 4 chiều, thấm hút mồ hôi tốt",143000,199000,56000,28
TIKI,thoi-trang-nam,98622969,"Quần Short Nam Rách️️ Quần Short Bò Nam Cao Cấp - Sọt Jean Co Giãn Mẫu Mới Hàng VNXK Tô Tồ Shop - QSJN01",179000,179000,0,0
TIKI,thoi-trang-nam,94850989,"Quần Lót Nam Cao Cấp Brave Person B1112 - Chất liệu cotton cao cấp, thoáng mát, thấm hút mồ hôi tối đa - Thiết kế ôm trọn vòng 3, tôn lên vẻ nam tính",133000,199000,66000,33
TIKI,thoi-trang-nam,196288087,"Viettien - Áo sơ mi nam ngắn tay vạt bầu màu vàng chanh regular phom rộng - Áo sơ mi công sở nam Việt Tiến",360000,360000,0,0
TIKI,thoi-trang-nam,111587011,"Quần short thể thao nam (Đen)",99000,99000,0,0
TIKI,thoi-trang-nam,102386244,"Combo 2 áo thun Tiedye nam Novelty Full Size 100% Cotton",296000,390000,94000,24
TIKI,thoi-trang-nam,111193800,"Quần thể thao nam 3 sọc ống xuông có túi khóa",150000,150000,0,0
TIKI,thoi-trang-nam,125355171,"Áo sơ mi đoàn thanh niên nam nữ cao cấp dài tay Ocean Uniform",220000,220000,0,0
TIKI,thoi-trang-nam,134615733,"Quần lót nam ARISTINO dáng Brief, quần sịp tam giác chất liệu Modal tự nhiên, mềm mại và thoáng mát gấp 2 lần so với sợi vải thông thường - ABF1616",79500,95000,15500,16
TIKI,thoi-trang-nam,150695791,"Áo Thể Thao Nam TSIMPLE cổ tròn tay ngắn tập gym vải thun lạnh thoáng mát co giãn chuẩn form For Run MSSAHP3",95000,165000,70000,42
TIKI,thoi-trang-nam,76258517,"Quần jocker nỉ chạy sọc caro, quần jogger chạy sọc, quần jogger phối sọc caro",89000,89000,0,0
TIKI,thoi-trang-nam,178000089,"Quần bơi nam cao cấp may 2 lớp chắc chắn chất thun đẹp trẻ trung lưng có dây rút rất tiện lợi khi mặc",126300,126300,0,0
TIKI,thoi-trang-nam,160417810,"quần lót nam relax cotton siêu xin cao cấp chính hãng, quần sịp nam relax underwear rltk48",99000,99000,0,0
TIKI,thoi-trang-nam,56446427,"Quần Bơi Lửng Nam Phong Cách Chuyên Nghiệp Thời Trang Thể Thao SZone SQB119",99000,99000,0,0
TIKI,thoi-trang-nam,137643038,"Áo Sơ Mi Nam Tay Ngắn Phối Caro In 3D Một Túi Thời Trang Nam Công Sở Cao Cấp Tạo Cảm Giác Thoải Mái Cho Người Mặc",169000,169000,0,0
TIKI,thoi-trang-nam,45818196,"Quần Short Đùi Nam Boxer Tập Gym Mặc Ngủ Super Body New Colour",75050,79000,3950,5
TIKI,thoi-trang-nam,44003425,"Áo sơ mi nam tay dài thêu họa tiết mới nhất",85000,85000,0,0
TIKI,thoi-trang-nam,102122394,"Combo 4 Quần lót boxer nam - Quần sịp đùi su đúc lụa sữa cao cấp không đường may Micado",280000,280000,0,0
TIKI,thoi-trang-nam,183731843,"Áo sơ mi nam, Áo sơ mi nam cổ Đức tay Lỡ, Phối sọc Nhấn vai nam tính, trẻ trung, lịch lãm h46",199000,199000,0,0
TIKI,thoi-trang-nam,4382605,"Quần Dài Jogger Nam Phối Sọc 1041",95000,95000,0,0
TIKI,thoi-trang-nam,90961454,"Combo 3 Quần Lót Nam Cotton Mềm Mịn Siêu Thoáng Mát, Co Giãn 4 Chiều Cao Cấp Dokafashion EZQLH03",61000,109000,48000,44
TIKI,thoi-trang-nam,17898669,"Áo khoác kaki jean Nam UNISEX - 6 màu căn bản",122000,122000,0,0
TIKI,thoi-trang-nam,163712959,"Áo Sơ Mi Nam Công Sở Trung Niên Thương Hiệu Anton Dài Tay Vải Cotton Xanh Đậm Trơn Có Túi - A13",225000,280000,55000,20
TIKI,thoi-trang-nam,98675410,"Quần Short Nam Mặc Ngủ, Quần Thun Nam Mặc Nhà Brave Person B1164 - Form dáng trẻ trung, năng động, nam tính - Chất liệu thoáng mát, co dãn 4 chiều",109000,250000,141000,56
TIKI,thoi-trang-nam,4426117,"Quần Dài Jogger Nam Phối Sọc 1041_xanh",95000,95000,0,0
TIKI,thoi-trang-nam,113115714,"Áo lót nam 100% cotton trắng LEDATEX siêu rẻ, siêu đẹp",54000,54000,0,0
TIKI,thoi-trang-nam,116775291,"Áo phông trắng nam cổ tròn",26000,26000,0,0
TIKI,thoi-trang-nam,76013601,"ÁO KHOÁC KAKI NAM 020",195000,195000,0,0
TIKI,thoi-trang-nam,46699028,"Quần short thun nam có lưới thông hơi Phúc An 1051 màu",71100,71100,0,0
TIKI,thoi-trang-nam,163716292,"Bộ bơi nam khóa kéo size lớn, quần áo bơi bigsize cho nam giới, chất thun bơi lạnh Hàn dầy dặn, dáng thể thao mạnh mẽ | BN016",480000,480000,0,0
TIKI,thoi-trang-nam,183718179,"Áo sơ Mi, Áo sơ Mi Nam cổ Vest, dài tay, mới lạ và sang trọng. Chất liệu Cotton cao cấp, nhẹ, mát mẻ, thấm mồ hôi, không nhăn, không nhàu,mã N34",199000,199000,0,0
TIKI,thoi-trang-nam,25277963,"Áo len dài tay nam thời trang Hàn Quốc SAL214",189000,189000,0,0
TIKI,thoi-trang-nam,87267258,"Quần lót dùng 1 lần Procare Cotton Nam",32000,32000,0,0
TIKI,thoi-trang-nam,133810672,"Áo Khoác Nam Trung Niên Chất Đẹp Không Nhăn Mẫu Mới",450000,450000,0,0
TIKI,thoi-trang-nam,20526128,"Áo Sơ Mi Nam Tay Dài Khatoco A1MD568S1-CNMK002-2102-D",454400,568000,113600,20
TIKI,thoi-trang-nam,117583109,"ÁO KHOÁC DÙ DÀY NAM PHONG CÁCH HÀN QUỐC",169000,169000,0,0
TIKI,thoi-trang-nam,75320881,"Quần short kaki nam Amazing, màu sắc trẻ trung, bigsize, vải co giãn, lưng thun có dây rút",239000,239000,0,0
TIKI,thoi-trang-nam,28938947,"Áo sơ mi nam dài tay màu xanh navy",125000,125000,0,0
TIKI,thoi-trang-nam,193988328,"Quần Jean nam Leman xanh trơn JD16 - Slim Form",455000,549000,94000,17
TIKI,thoi-trang-nam,114193983,"Quần dài thể thao nam Jogger 3 sọc ống bo trẻ trung năng động Micado",150000,150000,0,0
TIKI,thoi-trang-nam,171682049,"BOMBER NỈ PHỐI TAY, GIÓ 2 LỚP UNISEX NAM NỮ",145000,145000,0,0
TIKI,thoi-trang-nam,41083401,"Combo 3 quần sịp nam quần lót nam Cao cạp nhỏ MRM FASHION",175000,225000,50000,22
TIKI,thoi-trang-nam,82646137,"Áo Sơ Mi Nam Ngắn Tay Phối Caro",163000,163000,0,0
TIKI,thoi-trang-nam,73161713,"áo hoodie nam nữ",100000,100000,0,0
TIKI,thoi-trang-nam,179164054,"(big size < 130kg) quần kaki jogger nam dài big size có túi hộp",330000,330000,0,0
TIKI,thoi-trang-nam,184910578,"Viettien - Quần kaki nam màu be không ly 6R6008 regular",785000,785000,0,0
TIKI,thoi-trang-nam,172283627,"BORN TO BE BRAVE, mã G130. Áo thun nam nữ in siêu đẹp. Áo phông thoát nhiệt GOKING hàng hiệu cao cấp",168000,168000,0,0
TIKI,thoi-trang-nam,167431552,"Quần Bò Nam cao cấp thương hiệu Chandi, chất jean co dãn mẫu mới nhất MS27",165000,300000,135000,45
TIKI,thoi-trang-nam,20518565,"Quần Short Nam Khatoco Q3M318R0-VNMA031-2009-018",129000,318000,189000,59
TIKI,thoi-trang-nam,197170229,"Áo khoác nam unisex cổ đứng vải dù 2 lớp phối màu độc lạ họa tiết chữ HEBFN đi mưa,cản gió,chống nắng, Áo khoác dù nam nữ màu 3 sọc chất liệu dù gió 2 lớp cao cấp dáng from bóng chày bomber đẹp",95000,95000,0,0
TIKI,thoi-trang-nam,273121056,"QUẦN JEAN TRUNG NIÊN ỐNG SUÔNG CO GIÃN TG",270000,270000,0,0
TIKI,thoi-trang-nam,15659073,"Quần Short Nam Jean TS305",123000,123000,0,0
TIKI,thoi-trang-nam,189980959,"Viettien - Quần tây nam màu xám đậm không ly 1R4157 regular fit quần âu việt tiến phom vừa không ôm không rộng",650000,650000,0,0
TIKI,thoi-trang-nam,134796301,"Quần Jogger Túi Hộp 4 Màu Thể Thao Năng Động Cao Cấp VICERO",179000,358000,179000,50
TIKI,thoi-trang-nam,108701320,"Quần baggy nam cạp chun ống côn chất đũi mát mẻ",80000,80000,0,0
TIKI,thoi-trang-nam,83394094,"Quần đùi nam mặc nhà vải MÁT co dãn tốt mặc cực kỳ thoải mái loại quần đùi nam thông dụng",23000,23000,0,0
TIKI,thoi-trang-nam,148845226,"Đồ bộ thể thao nam thun lạnh siêu mát",249000,249000,0,0
TIKI,thoi-trang-nam,102531428,"Quần âu nam Hiền Trần BOUTIQUE công sở chất vải chéo 79 cao cấp",227000,499000,272000,55
TIKI,thoi-trang-nam,117605926,"Quần Short thun Nam Nữ Unisex phối 3 sọc Trắng, Đen - Quần đùi lửng ống suông",55000,55000,0,0
TIKI,thoi-trang-nam,177269891,"Viettien - Áo sơ mi nam dài tay họa tiết 1R0445 regular chất liệu sợi sen",670000,670000,0,0
TIKI,thoi-trang-nam,25097546,"ÁO KHOÁC DA NAM LÓT LÔNG - AD14 NÂU",299000,299000,0,0
TIKI,thoi-trang-nam,163497845,"Áo sơ mi nam dài tay công sở trung niên thương hiệu Anton vải sợi tre kẻ caro màu xanh dương – 8553",265000,355000,90000,25
TIKI,thoi-trang-nam,11850854,"Áo Len Nam Cao Cổ Lót Nỉ Bs62",350000,350000,0,0
TIKI,thoi-trang-nam,75409629,"Áo Da Nam Cao Cấp Form Chuẩn",469000,469000,0,0
TIKI,thoi-trang-nam,134702556,"Áo Sơ Mi Form Rộng Unisex Nam Nữ Tay Dài Hàn Quốc Kiểu Cổ Vest Cổ Ve Áo Khoác Ngoài Vải Lụa Mềm Mịn - SMV01",99000,99000,0,0
TIKI,thoi-trang-nam,54548198,"Quần Short Nam Đũi Đen SHORTDEN52 (Short Đen)",99000,99000,0,0
TIKI,thoi-trang-nam,30764036,"Quần lót boxer nam Khatoco Q5M085R0-VNMA011-2101-B",68000,85000,17000,20
TIKI,thoi-trang-nam,127197643,"Bộ Quần Áo Nam Lính Mỹ US ARMY  Kiểu Dáng Túi Hộp, Chất Liệu Kaki Cao Cấp Phong Cách Lính Cực Ngầu (Tặng dây lưng) - HÀNG CHÍNH HÃNG",899000,1798000,899000,50
TIKI,cross-border-hang-quoc-te,10732408,"Winning The Game Of Stocks!",599000,599000,0,0
TIKI,cross-border-hang-quoc-te,171705738,"Wireless Touchpad for Macbook Pro Retina 15 Inch Replacement Accessory Black",316000,316000,0,0
TIKI,thoi-trang-nam,160556315,"quần lót nam relax cotton cao cấp chính hãng, quần sịp đùi nam relax underwear rltk49",104000,104000,0,0
TIKI,thoi-trang-nam,197170201,"Áo Khoác Phối 2 Màu Nam Nữ Cao Cấp | Áo Khoác thể thao | áo khoác gió cổ cao unisex, Áo khoác gió học sinh kiểu Unisex cổ đứng vải dù 2 lớp phối màu độc lạ họa tiết chữ AGGSRMAN cản gió,chống nắng",95000,95000,0,0
TIKI,thoi-trang-nam,121626976,"Áo sơ mi nam dài tay có túi LADOS - 8024 chất OXFORD mịn mát form chuẩn dễ mặc",209000,329000,120000,36
TIKI,thoi-trang-nam,14973295,"Áo khoác lính US ARMY",474000,499000,25000,5
TIKI,thoi-trang-nam,22774900,"Áo Thun nam cá sấu mẫu mới - ĐB441 - Đỏ đô, Xanh Môn, Xanh Dương, Xanh Đen  - L",659000,659000,0,0
TIKI,thoi-trang-nam,109783945,"Áo thun nam nữ unisex tay lỡ PEACE phông form rộng teen cổ tròn oversize cotton giá rẻ basic đen trắng tee pull",56000,56000,0,0
TIKI,cross-border-hang-quoc-te,197427723,"Tai Nghe Bluetooth Không Dây Chống ồn Blutooth Chơi Chơi Game Tai Nghe Pro Disney Mickey Mouse Gấu Dâu TWS",759000,759000,0,0
TIKI,cross-border-hang-quoc-te,178723796,"Car Terminal Removal Tool Kit Connector Pin Release Puller",172000,172000,0,0
TIKI,thoi-trang-nam,164083716,"Don't be afraid, show your true colours, mã G30. Áo thun LGBT cho người đồng tính",168000,168000,0,0
TIKI,cross-border-hang-quoc-te,113345721,"Sách - Usborne Young Reading Series 3 - Pride and Prejudice by Jane Austen - (UK Edition, paperback)",340000,340000,0,0
TIKI,thoi-trang-nam,53408141,"Áo thun nam cổ bẻ chính hãng DOKA dáng thể thao nam cao cấp được thêu logo sắc xảo tông màu cơ bản - Combo 3 áo",509000,509000,0,0
TIKI,thoi-trang-nam,91281538,"Áo thun Luffy mũ rơm    Áo phông cotton tay ngắn hoạt hình One piece đảo hải tặc unisex nam nữ bận đều đẹp",59000,59000,0,0
TIKI,thoi-trang-nam,47099868,"Quần Biển Nam",109000,109000,0,0
TIKI,cross-border-hang-quoc-te,51386664,"Phenovo Tibet Buddhism Pure Copper 5 stocks cross Vajra Pestle Pendant Magic Amulet Handmade Durable Fashion Pendants",205000,205000,0,0
TIKI,thoi-trang-nam,129297742,"áo khoác nam trung niên lót lông hàng cao cấp dày dăn cưc ấm shop Trung Niên",499000,499000,0,0
TIKI,cross-border-hang-quoc-te,77979941,"SATA to USB Adapter, USB 3.0 SATA III Hard Drive Adapter Cable, SATA to USB 3.0 Adapter Cable, for 2.5 inch SSD & HDD High Quality",193000,193000,0,0
TIKI,thoi-trang-nam,157086106,"Quần tây nam - Quần Âu Nam Size 45-70Kg, Dáng SlimFit không đường ly Cao Cấp",59000,59000,0,0
TIKI,thoi-trang-nam,94487534,"Quần Lót Nam Tam Giác Brave Person B1144 - Chất Liệu Thun Lạnh Co Dãn 4 Chiều Thoáng Mát Mềm Mịn Siêu Kháng Khuẩn",143000,199000,56000,28
TIKI,thoi-trang-nam,3714865,"Combo 3 Quần Lót Nam Freeman 6040-CB3 (Size",175500,195000,19500,10
TIKI,thoi-trang-nam,24744552,"Quần Lót Nam Vải Lụa Sữa Cao Cấp LS2088",95000,95000,0,0
TIKI,thoi-trang-nam,117583489,"ÁO KHOÁC DÙ NAM ÁO KHOÁC NAM CHO MỌI THÒI ĐẠI",145000,145000,0,0
TIKI,thoi-trang-nam,214153022,"Áo sweater nam nữ dài tay phom rộng, Áo sweater form rộng nam nữ cổ tròn AD02 - MINHSTORE66",145000,145000,0,0
TIKI,cross-border-hang-quoc-te,109442500,"Bộ 15 công cụ mở ổ khóa với 3 ổ khóa trong suốt cho người mới thực hành",353200,353200,0,0
TIKI,cross-border-hang-quoc-te,270356291,"Butterfly Training Accessories Butterfly Comb for Practicing Flipping Tricks",183000,183000,0,0
TIKI,cross-border-hang-quoc-te,95384788,"USB 3.0 dung lượng 2TB cao cấp",325000,325000,0,0
TIKI,cross-border-hang-quoc-te,108601298,"Bộ đề trước của xe đạp leo núi 31.8-34.9MM-Size 9 tốc độ",193000,193000,0,0
TIKI,cross-border-hang-quoc-te,107904975,"Loa đeo cổ bluetooth 5.0 không dây, rảnh tay ôm vừa vặn cổ và đường cong vai, tạo cảm giác thoải mái",554000,554000,0,0
TIKI,cross-border-hang-quoc-te,109165456,"Bộ dụng cụ sửa chữa xe đạp WEST BIKING-Màu mờ-Size",180000,180000,0,0
TIKI,thoi-trang-nam,48526213,"Áo thun ba lỗ nam chất vải cotton 100% thoáng mát co giãn",36000,36000,0,0
TIKI,cross-border-hang-quoc-te,46412566,"Trẻ Em Khối Xây Dựng Trí Tuệ/Bộ Đồ Chơi Bảng Ghép Hình Bằng Gỗ Xếp Hình Trò Chơi Đồ Chơi",151000,151000,0,0
TIKI,cross-border-hang-quoc-te,95727605,"2 Bóng Đèn Pha Xenon D2R 55w Cho Xe Hơi",322000,322000,0,0
TIKI,cross-border-hang-quoc-te,116562247,"2xTibetan Buddhism Dorje Vajra Phurba Amulet Handmade Nepal Collectibles",396000,396000,0,0
TIKI,thoi-trang-nam,52198505,"Combo 4 Quần Lót Nam Quần Sịp Nam Sợi Cotton Cao Cấp MRM FASHION Mix 2 Màu TẶNG Đôi Tất Nam Cao Cấp",249000,340000,91000,27
TIKI,cross-border-hang-quoc-te,253443148,"Đồng hồ thông minh F57L Glucose Glucose huyết áp 24 giờ Giám sát nhiệt độ nhịp tim Giám sát thể thao màn hình 1,91 inch",875841,875841,0,0
TIKI,cross-border-hang-quoc-te,11708858,"Leadershift: The 11 Essential Changes Every Leader Must Embrace",490000,490000,0,0
TIKI,thoi-trang-nam,15777699,"Áo Sweater Nam bigsize SST14",86000,86000,0,0
TIKI,thoi-trang-nam,85087738,"Áo sơ mi nam ngắn tay nhiều màu",159000,159000,0,0
TIKI,cross-border-hang-quoc-te,108603523,"Nón bảo hiểm dành cho nam giới đi xe đạp, leo núi, hoặc hoạt động ngoài trời",461000,461000,0,0
TIKI,cross-border-hang-quoc-te,116487895,"50pcs Cable Cord Tie Straps Reusable Cable Ties Adjustable Cord Straps Sticky Cord Wrap and Hook Loop Cords",98000,98000,0,0
TIKI,cross-border-hang-quoc-te,112017568,"Giày đi xe đạp chuyên nghiệp MTB cho nam có khóa bàn đạp,mũi giày có lỗ thoáng khí,Đế được làm bằng chất liệu chống trơn trượt không lo bị trượt ngã.-Màu Xám-Size Size 40",734800,734800,0,0
TIKI,cross-border-hang-quoc-te,170725260,"Sách - Antifragile: Things That Gain from Disor.der (Incerto) by Nassim Nicholas Taleb (US edition, paperback)",643000,643000,0,0
TIKI,thoi-trang-nam,179575330,"Áo thun Polo nam Novelty 210059 màu xanh đen",274550,289000,14450,5
TIKI,cross-border-hang-quoc-te,116560509,"2x Tibetan Buddhism Dorje Vajra Phurba Amulet Handmade Nepal Collectibles",396000,396000,0,0
TIKI,cross-border-hang-quoc-te,112995053,"đèn LED trợ sáng Godox LITEMONS LED6Bi có thể sạc lại 3200K-6500K Hỗ trợ điều chỉnh",549000,549000,0,0
TIKI,cross-border-hang-quoc-te,46341337,"Sunnimix Âm Xốp Cách Âm Tiếng Ồn Giảm Chấn Xốp Tấm Lót Cho Phòng Thu Âm Tại Nhà Hát KTV 11.81X11.81 Inch",238000,238000,0,0
TIKI,cross-border-hang-quoc-te,241695048,"Bàn phím USB không dây làm từ silicon mềm linh hoạt có thể gấp gọn",518883,518883,0,0
TIKI,cross-border-hang-quoc-te,140294221,"Tai Nghe Chụp Tai Bluetooth Không Dây Cổ-Phong Cách Dành Cho Thể Thao Bluetooth 5.0 Loại Bỏ Tiếng Ồn Âm Thanh Stereo Âm Nhạc Dành Cho Android IOS - one",719017,719017,0,0
TIKI,cross-border-hang-quoc-te,11855829,"Lagom",573000,573000,0,0
TIKI,cross-border-hang-quoc-te,110302624,"Bàn phím không dây mỏng 12,2 inch cho Surface Software Pro3/4/5/6 (2017)",798700,798700,0,0
TIKI,thoi-trang-nam,162241771,"Quần Âu Nam-Quần Tây Nam Dài Form Slimfit 4 màu Vải Vintek Cao Cấp Co Giãn Nhẹ",129000,129000,0,0
TIKI,cross-border-hang-quoc-te,109165109,"Túi xe đạp thể thao chống nước treo sườn có ngăn đựng điện thoại cảm ứng",298000,298000,0,0
TIKI,cross-border-hang-quoc-te,10756942,"Power Of Habit (Onsale:7Feb13)/Bp",365000,365000,0,0
TIKI,cross-border-hang-quoc-te,110110332,"Balo du lịch đường dài trọng lượng nhẹ 30L,chất liệu Chống nước-Màu mòng két",384000,384000,0,0
TIKI,cross-border-hang-quoc-te,190460399,"Giày chạy bộ chuyên nghiệp sneakers nam CAMEL lưới thoáng khí hấp thụ sốc",1255000,1255000,0,0
TIKI,cross-border-hang-quoc-te,170563828,"Sách - Lonely Planet Morocco by Lonely Planet (paperback)",811000,811000,0,0
TIKI,cross-border-hang-quoc-te,10769311,"Man'S Search For Meaning: The Classic Tribute To Hope From The Holocaust (With New Material)",578000,578000,0,0
TIKI,cross-border-hang-quoc-te,191986562,"Giày thể thao nữ CAMEL CROWN của phụ nữ 2022 mùa hè lưới mới thoáng khí đệm giày chạy bộ nhẹ",1213000,1213000,0,0
TIKI,cross-border-hang-quoc-te,52826741,"Kim Loại Nhiệm Vụ Nặng Kệ Treo Tường Kệ Treo Tường Hình Chữ L Hỗ Trợ",193000,193000,0,0
TIKI,cross-border-hang-quoc-te,94958532,"2X Universal H11 H8 H9 100W 20LED Car Fog Driving DRL Light Bulbs Yellow",132000,132000,0,0
TIKI,cross-border-hang-quoc-te,28601543,"Data Science For Dummies 2Nd Edition",934000,934000,0,0
TIKI,cross-border-hang-quoc-te,77723135,"2 Pieces H8/H11-3570 LED Headlights Bulb High/Low Beam 80W 1700-1800LM 6000K",251000,251000,0,0
TIKI,cross-border-hang-quoc-te,170706560,"Sách - The Eclectic Witch's Book of Shadows : Witchy Wisdom at Your Fingertips by Deborah Blake (US edition, hardcover)",667000,667000,0,0
TIKI,cross-border-hang-quoc-te,46384709,"Cao Su Sống Động Như Thật Loài Rắn Đáng Sợ Bịt Miệng Chích Đáng Sợ Đồ Chơi Trẻ Em Quà Tặng Halloween",137000,137000,0,0
TIKI,cross-border-hang-quoc-te,190322226,"Giày chạy bộ nữ CAMEL CROWN Lớp Có đệm không trượt Chịu mài mòn Thở nhẹ",896000,896000,0,0
TIKI,cross-border-hang-quoc-te,188694343,"Lều cắm CAMEL CROWN 3-4 Người Lều Dã Ngoại Hai Lớp Chống Nắng Mưa Tự Động Có Thể Gấp Gọn Cho",3271000,3271000,0,0
TIKI,cross-border-hang-quoc-te,193993661,"Kem Dưỡng Ẩm Cerave Moisturizing Cream *Hũ Không Vòi*",298000,298000,0,0
TIKI,cross-border-hang-quoc-te,172975165,"2Pcs 12/24V to 5V/2.1A in Car  Cam DVR Hardwire OBD Tools Cord",257000,257000,0,0
TIKI,cross-border-hang-quoc-te,186239070,"Camel Võng Ngoài Trời Võng Xích Đu Du Lịch Cắm Trại Ngoài Trời Chống Lật Tải Trọng Cao",650000,650000,0,0
TIKI,cross-border-hang-quoc-te,127515847,"Sách - Atomic Habits : An Easy and Proven Way to Build Good Habits and Break Bad Ones by James Clear - (US Edition, paperback)",499000,499000,0,0
TIKI,cross-border-hang-quoc-te,95715452,"Phụ Kiện Kết Nối Xích Xe Đạp 116 Links 10 / 30 Speed Hg95 Mtb",271700,271700,0,0
TIKI,cross-border-hang-quoc-te,95726988,"Túi Tam Giác B-SOUL Vỏ Cứng Sức Chứa Lớn Chống Thấm Nước Gắn Phía Trước Treo Xe Đạp Leo Núi",260000,260000,0,0
TIKI,cross-border-hang-quoc-te,11573113,"Silence: The Power Of Quiet In A World Full Of Noise",447000,447000,0,0
TIKI,cross-border-hang-quoc-te,162105952,"Sách - The Green Witch : Your Complete Guide to the Natural Magic of Herb by Arin Murphy-Hiscock (US edition, hardcover)",525000,525000,0,0
TIKI,cross-border-hang-quoc-te,170682467,"Sách - The Concise Seduction by Robert Greene (UK edition, paperback)",394000,394000,0,0
TIKI,cross-border-hang-quoc-te,111061686,"Loa không dây di động Bluedio HS Bluetooth gắn trên cổ với hỗ trợ âm thanh vòm trung thực Chức năng FM Thẻ SD",487000,487000,0,0
TIKI,cross-border-hang-quoc-te,95712914,"Ổ Cắm Tẩu Thuốc Lá 12 / 24v Dc Cho Xe Hơi",195000,195000,0,0
TIKI,cross-border-hang-quoc-te,174912197,"2Piece USB Type C Converter Adapter Charge Data Sync for iPhone",96000,96000,0,0
TIKI,cross-border-hang-quoc-te,10769313,"Wabi Sabi: Japanese Wisdom For A Perfectly Imperfect Life",578000,578000,0,0
TIKI,cross-border-hang-quoc-te,170583751,"Sách - The Inferno by Dante Alighieri (paperback)",220000,220000,0,0
TIKI,cross-border-hang-quoc-te,101853498,"Wall Statues Sculpture Figurines Keychain Wall Mount Pub Halloween Decor",318000,318000,0,0
TIKI,cross-border-hang-quoc-te,108603917,"Túi đựng đồ xe đạp 20L gắn yên sau không thấm nước va đọ bền cao",610000,610000,0,0
TIKI,cross-border-hang-quoc-te,99513637,"Ukulele Finger Exerciser Chord Trainer Hawaiian Guitar Uke Learning Tool",424000,424000,0,0
TIKI,cross-border-hang-quoc-te,113196512,"Túi đựng tài liệu chống cháy,chống nước có khóa kéo-Màu Bạc-Size Có khóa",466600,466600,0,0
TIKI,cross-border-hang-quoc-te,149894794,"Dụng cụ bóng tập luyện cơ tay chuyên dụng",242000,242000,0,0
TIKI,cross-border-hang-quoc-te,229848198,"Ổ cứng ngoài SSD 1TB 2TB 500GB cổng USB 3.1 4TB",297100,297100,0,0
TIKI,cross-border-hang-quoc-te,197332705,"Women Maid Outfit Cute Girl Cosplay French Apron Maid Fancy Dress Costume Halloween Costumes",601000,601000,0,0
TIKI,cross-border-hang-quoc-te,178521174,"Vertical Cat Scratcher Kitty Scratching Toy Lounge Bed Thickened for Kitten",351000,351000,0,0
TIKI,cross-border-hang-quoc-te,99511898,"4Packs Jack Support Plug Lift Block For BMW 3-series E46 Hatchback 2001-2005",662000,662000,0,0
TIKI,cross-border-hang-quoc-te,179371946,"Sách - The Almanack of Naval Ravikant : A Guide to Wealth and Happiness by Eric Jorgenson (paperback)",529000,529000,0,0
TIKI,cross-border-hang-quoc-te,71893356,"Mô phỏng Mèo lông thú ngồi xổm đáng yêu làm quà tặng trang trí nhà cửa và văn phòng",461000,461000,0,0
TIKI,cross-border-hang-quoc-te,170682794,"Sách - The Tyranny of Merit : Can We Find the Common Good? by Michael J Sandel (paperback)",395000,395000,0,0
TIKI,cross-border-hang-quoc-te,162405954,"Sách - Good Vibes, Good Life : How Self-Love Is the Key to Unlocking Your Greatness by Vex King (UK edition, paperback)",470000,470000,0,0
TIKI,cross-border-hang-quoc-te,117425345,"Professional 96-Hole Molecular Gastronomy Caviar Maker with Tube & Spoon",242000,242000,0,0
TIKI,thoi-trang-nam,94808227,"Quần ống rộng kẻ caro nam nữ - quần vải unisex- năng động thoải mái - Đổi trả free nếu không ưng hoặc hàng lỗi",97000,97000,0,0
TIKI,cross-border-hang-quoc-te,51227329,"Guitar Bass Pickup Threaded Xi Lanh Jack Đầu Ra Ổ Cắm đầu Vào",147000,147000,0,0
TIKI,thoi-trang-nam,205050356,"Áo sơ mi nam SlimFit tay dài cao cấp BELLUNI vải sợi tre thoải mái thanh lịch - ADS.BPS.BE.157.O2",750000,750000,0,0
TIKI,thoi-trang-nam,34702589,"Áo khoác dạ nam dáng dài hàn quốc cổ lông NAD79",1250000,1250000,0,0
TIKI,cross-border-hang-quoc-te,52837590,"Kéo Dài Ngắn Ghế Lưng Thấp Bar Bar Stool Trượt",106000,106000,0,0
TIKI,cross-border-hang-quoc-te,116112716,"Quạt đeo cổ mini cổng usb tiện lợi Quạt mini cầm tay sạc điện, 3 tốc độ-Màu xanh lá",278500,278500,0,0
TIKI,cross-border-hang-quoc-te,101144223,"Round Stool Chair Cushion Pad Memory Foam Meditation Pillow Matrress 40cm",190000,190000,0,0
TIKI,cross-border-hang-quoc-te,11625771,"Ogilvy On Advertising In The Digital Age",948000,948000,0,0
TIKI,thoi-trang-nam,52293352,"Áo Polo nam cổ bẻ ngắn tay, chất liệu vải cá sấu cotton cao cấp, trẻ trung, năng động – FORMEN SHOP – FMPS105",149000,199000,50000,25
TIKI,thoi-trang-nam,138563568,"áo khoác Bomber",93000,93000,0,0
TIKI,cross-border-hang-quoc-te,28601438,"Algorithms For Dummies",858000,858000,0,0
TIKI,thoi-trang-nam,67515641,"Áo sơ mi nam tay dài form slim màu xanh caro Khatoco A1MD388S1-CNCR007-2101-D",310400,388000,77600,20
TIKI,thoi-trang-nam,167025428,"Viettien - Áo sơ mi nam dài tay màu xanh đen 1M2808 chất liệu sợ tre regular",525000,525000,0,0
TIKI,thoi-trang-nam,178058271,"Áo thun tank top nam trơn LADOS-9085 vải cotton siêu mát mẻ,tập gym, chạy bộ, đi chơi",179000,179000,0,0
TIKI,thoi-trang-nam,189648805,"Quần short jeans nam trơn 4 màu chất liệu jean cao cấp co giãn bền màu SJDF | LASTORE MENSWEAR",420000,420000,0,0
TIKI,thoi-trang-nam,86993760,"QUẦN JEAN NAM ĐEN HAY CÒN GỌI QUẦN BÒ NAM VỚI CHẤT LIỆU JEAN CO GIÃN RẤT THÍCH HỢP CHO CÁC BẠN NAM THÍCH ĐƠN GIẢN",349000,349000,0,0
TIKI,thoi-trang-nam,162146048,"QJ062 - QUẦN JEAN BAGGY NAM BÁIC XANH BẠC",195000,195000,0,0
TIKI,thoi-trang-nam,68581385,"Áo thun nam tay lỡ form rộng in hình Naruto cực chất",60000,60000,0,0
TIKI,thoi-trang-nam,176301640,"Áo thun tay lỡ form rộng - phông nam nữ cotton oversize - T shirt summer - 2N Unisex",49000,79000,30000,38
TIKI,thoi-trang-nam,98985299,"Áo thun Teeworld TW x Vietnamese Food - Hot Vit Lon Form Rộng Unisex Nam Nữ",359000,359000,0,0
TIKI,thoi-trang-nam,145029744,"áo khoác cadigan nam nữ mẫu viền vàng xinh xắn Sumisu shop",120000,120000,0,0
TIKI,thoi-trang-nam,36573622,"Áo Sơ Mi Nam",115000,115000,0,0
TIKI,thoi-trang-nam,83160055,"Áo sơ mi nam caro",157000,157000,0,0
TIKI,thoi-trang-nam,108850741,"Quần Dài Nam Chất Kaki Co Giãn Thời Trang Cao Cấp VICERO",239000,350000,111000,32
TIKI,thoi-trang-nam,174015918,"Quần Short Jean nam Leman đen trơn JL02 - Slim Form",380000,459000,79000,17
TIKI,thoi-trang-nam,94879492,"Áo sơ mi việt tiến dài tay màu kem",350000,350000,0,0
TIKI,thoi-trang-nam,184309258,"Áo sơ mi casual tay dài sọc dọc WS21FH88C-LC - RED, RED",700000,700000,0,0
TIKI,thoi-trang-nam,67429010,"Quần jogger nỉ nam ( hình thật ) , quần nỉ nam, quần thể thao nam, quần nỉ nữ, quần thể thao, quần jogger,quần 1sọc phối",82000,82000,0,0
TIKI,thoi-trang-nam,88020921,"Áo khoác dù kiểu bomber in ENJOG cá tính, thời trang, Áo khoác dù Bomber chữ phối màu Unisex nam nữ, Áo khoác dù nam nữ mặc / áo khoác gió nam nữ mặc / áo khoác dù kiểu bomber / áo khoác cặp đôi / áo khoác form rộng, Áo Khoác Nam Nữ Unisex - Áo Jacket Bom",99000,99000,0,0
TIKI,thoi-trang-nam,189892112,"Áo khoác DirtyCoins Special Letters Monogram Hoodie",599000,790000,191000,24
TIKI,thoi-trang-nam,85269397,"(ảnh chụp thật)  Áo nam trung niên cho bố",84500,84500,0,0
TIKI,cross-border-hang-quoc-te,104417298,"HandMade Hindu Ganesha Statue Tabletop Water Fountain Led Meditation Relaxing Water Sound Small Size Living Room Decor Arts Gift",739000,739000,0,0
TIKI,thoi-trang-nam,84594046,"Quần shorts Nam siêu mỏng vải dù - A029",190000,190000,0,0
TIKI,thoi-trang-nam,195775262,"Viettien - Áo sơ mi nam ngắn tay xẻ tà lai ngang 8N3631 ca rô phom slim fit may ôm dành cho giới trẻ hoặc trung niên thích phong cách trẻ",490000,490000,0,0
TIKI,thoi-trang-nam,17915042,"ÁO KHOÁC NAM GIẢ VEST KAKI -HÀNG CHUẨN",179000,179000,0,0
TIKI,thoi-trang-nam,113066232,"Sét đồ bộ mặc nhà nam- đồ thể thao nam in hình GẤU",83000,83000,0,0
TIKI,thoi-trang-nam,39088060,"Quần Jogger Nam Nữ - Cực Chất",182000,182000,0,0
TIKI,thoi-trang-nam,26091790,"Quần đũi nam phong cách jogger thời trang đẹp",89000,89000,0,0
TIKI,thoi-trang-nam,12705470,"Quần Tây ( Âu ) Nam Dáng Hàn Quốc - Đen - 33",80000,80000,0,0
TIKI,thoi-trang-nam,79007628,"Quần Short Jean cao cấp co dãn tốt Thương Hiệu Chandi, phong cách hàn quốc mẫu mới nhất MR8010",176000,299000,123000,41
TIKI,cross-border-hang-quoc-te,114425789,"Máy giặt mini tự động thích hợp cho giặt đồ cá nhân-Màu trắng",640000,640000,0,0
TIKI,thoi-trang-nam,3970625,"Áo Sơ Mi Nam Aligro Màu Sọc Trắng ALG1008",599500,599500,0,0
TIKI,thoi-trang-nam,163882883,"Áo Sơ Mi Nam Công Sở Trung Niên Dài Tay Anton Vải Sợi Tre Xanh Lục Thấm Hút Mồ Hôi - AT204",325000,395000,70000,18
TIKI,thoi-trang-nam,169617467,"Viettien - Áo sơ mi nam ngắn tay ca rô vạt bầu 1N0526 regular",395000,395000,0,0
TIKI,thoi-trang-nam,169744387,"Viettien - Áo sơ mi nam ngắn tay kẻ sọc vạt bầu 1N3562 regular",485000,485000,0,0
TIKI,thoi-trang-nam,70790578,"Quần Baggy Nam Kaki Ống Suông Unisex - Kiểu quần baggy kaki nam nữ thun vải đen và be tan, xám",79000,79000,0,0
TIKI,thoi-trang-nam,20832274,"Áo Khoác Da Nam Lót Lông Simple Cao Cấp KD06",275000,435000,160000,37
TIKI,thoi-trang-nam,51835059,"Áo khoác lông vũ/Áo khoác nam, dáng dài, dày dặn, ôm sát, thời trang, kiểu dáng rộng rãi, phù hợp cho mùa đông TA95",814583,857456,42873,5
TIKI,cross-border-hang-quoc-te,95723113,"Túi Chống Nước Gắn Ghi Đông Xe Đạp",285000,285000,0,0
TIKI,cross-border-hang-quoc-te,95876755,"Car Audio Amplifier Subwoofer Bass 12V 150W Module PCB Board Kit",472000,472000,0,0
TIKI,cross-border-hang-quoc-te,197387661,"Professional Bike Bottom Bracket Removal Tool Lock Ring Spanner Headset Hook Wrench Portable",198000,198000,0,0
TIKI,cross-border-hang-quoc-te,95878726,"Cigar Punch Keychain – Stainless Steel Silver - Pocket Cigar Punch Tool Double Blades - Key Ring Holder for Men - 4.4cm",165000,165000,0,0
TIKI,cross-border-hang-quoc-te,95727515,"Đệm tai nghe cho Sennheiser HD 4.50 hd4.50 btnc",188500,188500,0,0
TIKI,cross-border-hang-quoc-te,51206873,"Đồng Hồ đeo Tay Thể Dục Thông Minh Huyết áp Vòng đeo Tay Theo Dõi Nhịp Tim",185000,185000,0,0
TIKI,cross-border-hang-quoc-te,111066566,"Chuột quang chơi game có dây ZELOTES T-30 công thái học với 4 DPI có thể điều chỉnh ",262000,262000,0,0
TIKI,cross-border-hang-quoc-te,46334200,"Sunnimix Led Giả Ngọn Lửa Đèn Đèn Pin Đèn Điện Tử Ngọn Lửa Đèn Đảng Câu Lạc Bộ Trang Trí Nhà",351000,351000,0,0
TIKI,cross-border-hang-quoc-te,118983351,"◊> Lư hương chảy ngược làm quà tặng cho gia đình Tháp hương trầm hương đồ trang trí gốm sứ màu",343000,343000,0,0
TIKI,cross-border-hang-quoc-te,179583789,"Sách - Terms and Conditions : TikTok made me buy it! Meet the Dreamland Billiona by Lauren Asher (UK edition, paperback)",530000,530000,0,0
TIKI,cross-border-hang-quoc-te,95727457,"Phụ Kiện Nâng Tay Cầm Xe Đạp",270400,270400,0,0
TIKI,cross-border-hang-quoc-te,250330768,"Máy bay trực thăng điều khiển từ xa phong cách mới nhất Đồ chơi mô hình cậu bé sạc điều khiển từ xa không dây hai chiều Sản phẩm mới của Amazon",269400,269400,0,0
TIKI,cross-border-hang-quoc-te,189272064,"Bộ Chuyển Đổi Nguồn Điện 3000w Dc 12v Sang Ac 220v Chuyên Dụng Cho Xe Hơi",664520,664520,0,0
TIKI,cross-border-hang-quoc-te,46335510,"Amagogo Tay Cầm Mở Rộng Cánh Tay Cho DJI Ronin SC Gimbal Với Góc Điều Chỉnh",805000,805000,0,0
TIKI,cross-border-hang-quoc-te,97032352,"Đệm Yên Xe Đạp MTB Silicon Bọt Biển Thoáng Khí",283000,283000,0,0
TIKI,cross-border-hang-quoc-te,183290969,"Mobile Phone Fill Light 15x Macro Lens Mini 53 LED for Android Photography",375000,375000,0,0
TIKI,cross-border-hang-quoc-te,46320230,"Sunnimix Bộ 2 Âm Đàn Guitar Máy Đầu",182000,182000,0,0
TIKI,cross-border-hang-quoc-te,46352728,"100% Cotton Chắc Chắn Khăn Tay Hanky Bỏ Túi Vuông Dành Cho Nam Nữ 40X40 Cm",214000,214000,0,0
TIKI,cross-border-hang-quoc-te,204571033,"Vỏ Bọc Ghế Sofa Co Giãn Tốt Không Tay Tiện Dụng",291619,291619,0,0
TIKI,cross-border-hang-quoc-te,11476924,"Cristiano Ronaldo: The Ultimate Fan Book",281000,281000,0,0
TIKI,cross-border-hang-quoc-te,140294115,"Nga & Tiếng Anh Bàn Phím Bluetooth Không Dây Nga Bàn Phím Siêu Mỏng Tắt Tiếng Mạc iPad iPhone IOS Android Windows Smart Tivi - one",628383,628383,0,0
TIKI,cross-border-hang-quoc-te,46337300,"Yotijar 1 Đa Năng Xoay Vali Hành Lý Kép Con Lăn Bánh Đúc Thay Thế Bánh Xe Travelling Túi",185000,185000,0,0
TIKI,cross-border-hang-quoc-te,10769408,"Man's Search For Meaning",552000,552000,0,0
TIKI,cross-border-hang-quoc-te,46332775,"Sunnimix Tường Đàn Guitar Núi Cổ Khóa Đàn Guitar Móc Treo Cho Đàn Guitar Bass Đàn Banjo Phụ Kiện",317000,317000,0,0
TIKI,cross-border-hang-quoc-te,10732570,"Zero To One",434000,434000,0,0
TIKI,cross-border-hang-quoc-te,46337475," 1 Thay Thế Hành Lý Bánh Xe Vali Sửa Chữa Tắt Tiếng Kiêm Phụ Kiện D047",210000,210000,0,0
TIKI,cross-border-hang-quoc-te,46396676,"1 Cuộn 125 chiếc Tủ Đông Tủ Lạnh Bảo Quản Thực Phẩm Nhãn Dán Miếng Dán",122000,122000,0,0
TIKI,cross-border-hang-quoc-te,196675328,"Ba Lô Ngoài Trời Chống Mòn CAMEL CROWN 40L Túi Thể Thao Du Lịch Leo Núi Cắm Trại Đi Bộ Đường Dài",1494000,1494000,0,0
TIKI,cross-border-hang-quoc-te,112019250,"Balo dung tích 5l để đi xe đạp, chạy bộ, leo núi, thiết kế gọn nhẹ-Màu xanh dương-Size Chỉ ba lô",382000,382000,0,0
TIKI,cross-border-hang-quoc-te,190737872,"Sách - Piano Exam Pieces 2023 & 2024, ABRSM Grade 8 : Selected from the 2023 & 2024 syl by ABRSM (UK edition, paperback)",693000,693000,0,0
TIKI,cross-border-hang-quoc-te,241705884,"Đồng Hồ Thông Minh M4 M Band 4 Màn Hình OLED Chống Thấm Nước",219240,219240,0,0
TIKI,cross-border-hang-quoc-te,134829328,"Mới Sanrio Sang Trọng Anime Hoạt Hình Kitty Mỹ Giai Điệu Cinnamoroll Pompom Purin Dễ Thương Làm Đẹp Du Lịch Sang Trọng Ba Lô Quà Tặng Sinh Nhật Cho Trẻ Em - one",488313,488313,0,0
TIKI,cross-border-hang-quoc-te,76231817,"Useful Piano Chord Poster Learn to Play Piano and Compose Music",234000,234000,0,0
TIKI,cross-border-hang-quoc-te,95721148,"Túi Đựng Điện Thoại Chống Nước Gắn Sườn Xe Đạp",243000,243000,0,0
TIKI,cross-border-hang-quoc-te,177667083,"Túi 15 Gói Cà Phê Rang Xay Nguyên Chất Cao Cấp Không Đường Killiney 2-In-1 Premium White Coffee (15 gói x 30g)",350000,350000,0,0
TIKI,cross-border-hang-quoc-te,109434854,"Bộ sạc pin LiitoKala lii-600 Li-ion-3.7V Ni-MH1.2V 4 khe cắm-Màu đen-Size Cắm EU",914000,914000,0,0
TIKI,cross-border-hang-quoc-te,136930029,"OZERO Găng Tay Xe Máy Dê Vàng Da Chống Gió Lái Xe Thể Thao Đua Xe Moto Đi Bộ Đường Dài Săn Vườn Công Việc Dành Cho Nam 5002 - one",586362,586362,0,0
TIKI,cross-border-hang-quoc-te,46366548,"Đen 1 "Xe Máy Tay Cầm Thanh Tay Cầm cho Harley XL883 1200X48",258000,258000,0,0
TIKI,cross-border-hang-quoc-te,170708811,"Sách - The Bell Jar by Sylvia Plath (UK edition, paperback)",350000,350000,0,0
TIKI,cross-border-hang-quoc-te,271692134,"Vacuum Cleaner Household Handheld Wireless GHA-605 Portable Small 18KPA Wet and Dry Dual Use Vacuum Machine",1327000,1327000,0,0
TIKI,cross-border-hang-quoc-te,95728479,"Tua Bin 65-74mm Cho Động Cơ Xe Hơi",263900,263900,0,0
TIKI,cross-border-hang-quoc-te,99624639,"Tactical Vest Pouch Pack Bag Chest Recon Bag Utility Gadget Pouch Black",437000,437000,0,0
TIKI,cross-border-hang-quoc-te,17968550,"On The Road",373000,373000,0,0
TIKI,cross-border-hang-quoc-te,109164170,"Kính Lái Xe Phân Cực WEST BIKING, Chống Gió, Thiết Bị Xe Đạp Leo Núi-Màu đỏ",337000,337000,0,0
TIKI,cross-border-hang-quoc-te,170725930,"Sách - Autumn Baking: Natural Yeast by Chiew See by Chiew See (paperback)",539000,539000,0,0
TIKI,cross-border-hang-quoc-te,172857699,"Nắp gập và bàn phím không dây Bluetooth  cho Xiaomi Pad5/ Pad5 Pro 11",676400,676400,0,0
TIKI,cross-border-hang-quoc-te,76387142,"Starter Kit Module Sensor with LCD Display,Relay,Servo Motor,Ultrasonic,Module for  UNO R3 Mega 2560 Nano Raspberry Pi Starter Projects",276000,276000,0,0
TIKI,cross-border-hang-quoc-te,112014946,"Quần bảo hộ cho nam có miếng lót đệm dùng đi xe đạp/cưỡi ngựa-Màu đỏ-Size",330000,330000,0,0
TIKI,cross-border-hang-quoc-te,46337466,"Footful 1 Đa Năng Vali Hành Lý Viên Xếp Hình Thay Thế Bánh Xe Du Lịch Cửa Chịu Lực",183000,183000,0,0
TIKI,cross-border-hang-quoc-te,189503032,"Bộ dụng cụ sửa chữa vết lõm xe hơi chuyên dụng",278490,278490,0,0
TIKI,cross-border-hang-quoc-te,230278157,"Ổ Cứng Di Động SSD Loại C Usb 3.1 Kích Thước Nhỏ Gọn 4TB / 2TB / 1Tbg asiutong2",310750,310750,0,0
TIKI,cross-border-hang-quoc-te,108601127,"Túi đựng đồ yên sau xe đạp, chất liệu vải chống thấm nước, sức chứa lớn",283000,283000,0,0
TIKI,cross-border-hang-quoc-te,170693287,"Sách - Practical Sigil Magic : Creating Personal Symbols for Success by U.D. Frater (US edition, paperback)",537000,537000,0,0
TIKI,cross-border-hang-quoc-te,52843434,"Professional Athletics Outdoor Sports Sprint Running Games Passover Relay Ba",147000,147000,0,0
TIKI,cross-border-hang-quoc-te,98031467,"Bút Cảm Ứng JD06 Tương Thích Với Thiết Bị Màn Hình Cảm Ứng Di Động IOS / AnDroid / Windows",417000,417000,0,0
TIKI,cross-border-hang-quoc-te,95711120,"Phụ Kiện Bảo Vệ Ngón Tay Khi Chơi Đàn Guitar",257400,257400,0,0
TIKI,cross-border-hang-quoc-te,95728076,"Bếp Ga Dã Ngoại Mini Chống Gió",260000,260000,0,0
TIKI,cross-border-hang-quoc-te,111388663,"Dụng cụ nướng đồ ăn, cắm trại BBQ ngoài trời, dã ngoại, du lịch-Màu A",216000,216000,0,0
TIKI,cross-border-hang-quoc-te,109443064,"Bộ 24 Dụng Cụ Mở Khóa Chuyên Nghiệp với 2 ổ khóa Thực Hành Kèm Bao Da Dành Cho Người Mới Bắt Đầu",396000,396000,0,0
TIKI,cross-border-hang-quoc-te,139250621,"TWS 100 Giờ Tai Nghe Không Dây Bluetooth Từ Tính Cổ Tai Nghe IPX5 Chống Nước Thể Thao Tai Nghe Loại Bỏ Tiếng Ồn Micophone - one",547722,547722,0,0
TIKI,cross-border-hang-quoc-te,121438468,"(Hàng Mới Về) Tông Đơ Cắt Tóc / Cạo Râu Bằng Điện Chất Lượng Caochạy",288443,288443,0,0
TIKI,cross-border-hang-quoc-te,99533347,"Women Nipple Breast Clamps Metal Chain Clips Adults Flirt Party Game Toys",146000,146000,0,0
TIKI,cross-border-hang-quoc-te,170041326,"Máy Đo Khoảng Cách Bằng Laser Cầm Tay Tiện Lợi",799990,799990,0,0
TIKI,cross-border-hang-quoc-te,229902687,"Bút Cảm Ứng 9 Màu Dành Cho Máy Tính Bảng Samsung Galaxy Tab A8 10.5 A7 S8 Ultra S8 S7 Plus FE S6 Lite S5E S4 T220 T290",200156,200156,0,0
TIKI,cross-border-hang-quoc-te,52653484,"Ấm Pha Trà Kiểu Nhật Nhỏ ấm đun Nước ấm Tetsubin Ấm Trà Nhỏ ấm Trà 50ml",179000,179000,0,0
TIKI,cross-border-hang-quoc-te,95719070,"Thiết Bị Tạo Hiệu Ứng Âm Thanh Cho Đàn Ghi Ta B6 5 Trong 1",837200,837200,0,0
TIKI,cross-border-hang-quoc-te,95722713,"Cặp đệm bọc thay thế cho tai nghe Sennheiser HD201 HD180 HD201S",262500,262500,0,0
TIKI,cross-border-hang-quoc-te,127159631,"Bluetooth Không Dây Magic Mouse 2 Im Lặng Sạc Laser Máy Tính Mỏng Thiết PC Văn Phòng Mause Dành Cho Apple Mac Microsoft - one",596000,596000,0,0
TIKI,cross-border-hang-quoc-te,11573207,"The Other Miss Bridgerton",367000,367000,0,0
TIKI,cross-border-hang-quoc-te,204721055,"26 Wooden Letters Alphabet Wall/Art/Craft/Kids Learning/Spelling/Decorations",126000,126000,0,0
TIKI,cross-border-hang-quoc-te,263018180,"Tấm Pin Năng Lượng Mặt Trời 300W Pin Năng Lượng Mặt Trời 12V Bộ Điều Khiển Tấm Pin Năng Lượng Mặt Trời 10A-60A Cho Điện Thoại RV Xe Đoàn Lữ Hành Tại Nhà, Cắm Trại Ngoài Trời Màu Pin: G",1156369,1156369,0,0
TIKI,cross-border-hang-quoc-te,209902865,"108 Keys Set  for Mechanical Keyboard  Letters",408000,408000,0,0
TIKI,cross-border-hang-quoc-te,108599887,"Mũ bảo hiểm MTB đi xe đạp dành cho nam nữ, có tấm che nắng có thể tháo rời",576000,576000,0,0
TIKI,cross-border-hang-quoc-te,108600941,"Bàn đạp xe đạp bằng hợp kim nhôm chống trượt-Màu đen",341000,341000,0,0
TIKI,cross-border-hang-quoc-te,111415625,"Cần câu cá bằng hợp kim Titan siêu nhẹ, bền, hàng chất lượng cao-Size",380000,380000,0,0
TIKI,cross-border-hang-quoc-te,262010661,"FFC Type-C Micro Micro USB Ribbon Ribbon Cáp 90",374204,374204,0,0
TIKI,cross-border-hang-quoc-te,17968526,"Wine Bible",950000,950000,0,0
TIKI,cross-border-hang-quoc-te,137484731,"Xe Đạp Xe Máy Cho Bé Trẻ Em An Toàn Dây Đai Dây Lectric Đai Ngồi Xe Máy An Toàn Dây Đeo Cho Bé Phụ Cho Xe Máy",393475,393475,0,0
TIKI,cross-border-hang-quoc-te,46426919,"Đa Năng Xe Máy Xe Máy Mũ Nón Bảo Hiểm Xe Đạp Khóa Móc Treo Móc Kèm 2 Chìa Khóa",164000,164000,0,0
TIKI,cross-border-hang-quoc-te,11715910,"Harvard Business Review: Nine Things Successful People Do Differently",383000,383000,0,0
TIKI,cross-border-hang-quoc-te,170717679,"Sách - Pitch Anything: An Innovative Method for Presenting, Persuading, and Winnin by Oren Klaff (US edition, paperback)",699000,699000,0,0
TIKI,cross-border-hang-quoc-te,96359939,"2x H11 H8 3030 LED Bright White Fog Lights Driving",203000,203000,0,0
TIKI,cross-border-hang-quoc-te,204663144,"Tai nghe bluetooth chống ồn khi ngủ có trọng lượng nhẹ Màn hình hiển thị pin kỹ thuật số",306000,306000,0,0
TIKI,cross-border-hang-quoc-te,146553907,"CINCATDY Tai Nghe Bluetooth True Wireless TWS A6S pro Phiên Bản Nâng Cấp - Hàng Chính Hãng",162000,162000,0,0
TIKI,cross-border-hang-quoc-te,94299116,"108-KeyABS Colorful Translucent Keycaps Key Cap Replace for Mechanical Keyboard Custom",169000,169000,0,0
TIKI,cross-border-hang-quoc-te,170706778,"Sách - The Mythology Book by DK (US edition, paperback)",727000,727000,0,0
TIKI,cross-border-hang-quoc-te,170672353,"Sách - The Witches' Love Spell Book : For Passion, Romance, and Desire by Cerridwen Greenleaf (US edition, hardcover)",240000,240000,0,0
TIKI,cross-border-hang-quoc-te,97506079,"Túi Đựng Hành Lý 40L Treo Yên Sau Xe Đạp",362000,362000,0,0
TIKI,cross-border-hang-quoc-te,141455429,"Ốp lưng điện thoại dạng ví da lật dành cho OPPO Reno 3 Pro Reno 4 Pro 5G Reno 5 Pro Reno 6 Pro",157000,157000,0,0
TIKI,cross-border-hang-quoc-te,52832505,"17 Rods Plastic Beads Abacus Soroban Count Number Tool Educational Toy",150000,150000,0,0
TIKI,cross-border-hang-quoc-te,94381840,"Adults Sitz Bath f Hemorrhoid Postpartum Post-Episiotomy Patient All Toilets",291000,291000,0,0
TIKI,cross-border-hang-quoc-te,110109368,"Bộ dụng cụ nấu ăn cắm trại bao gồm chảo, ấm trà, bếp và dao kéo.. Có thể gấp gon với túi đựng tiện lợi-Màu quả cam",685300,685300,0,0
TIKI,cross-border-hang-quoc-te,46394603,"Giấy Gỗ Làm Khuôn Mẫu Khung Màn Hình Cho Tự Làm Giấy Thủ Công 25X19 Cm",118000,118000,0,0
TIKI,cross-border-hang-quoc-te,95708107,"Bộ Chuyển Đổi Nguồn Điện Dc 12v Sang 5v 3a",206000,206000,0,0
TIKI,cross-border-hang-quoc-te,108598793,"Máy bơm xe đạp nhỏ INBIKE, máy bơm lốp xe đạp",206000,206000,0,0
TIKI,cross-border-hang-quoc-te,134443753,"Sách - Kafka on the Shore by Haruki Murakami - (UK Edition, paperback)",381000,381000,0,0
TIKI,cross-border-hang-quoc-te,188135079,"Sách - Malibu Rising : THE SUNDAY TIMES BESTSELLER AS SEEN ON TIKTOK by Taylor Jenkins Reid (UK edition, paperback)",322000,322000,0,0
TIKI,cross-border-hang-quoc-te,109436054,"Loa Cyboris S5 IPX7 không dây,chống bụi,siêu trầm và không thấm nước",604000,604000,0,0
TIKI,cross-border-hang-quoc-te,159404248,"Dây đồng hồ silicon 22mm cho đồng hồ thông minh Garmin Forerunner 935",268000,268000,0,0
TIKI,cross-border-hang-quoc-te,46427078,"Xe Ô Tô Xe Máy Lốp Xe Máy Nén Bơm Hơi Với Lốp Đồng Hồ Đo Áp Lực Khí Màn Hình",250000,250000,0,0
TIKI,cross-border-hang-quoc-te,170583476,"Sách - The Mysteries of the Universe : Discover the Best-Kept Secrets of Space by DK (paperback)",727000,727000,0,0
TIKI,cross-border-hang-quoc-te,11708750,"Follow Your Heart: Finding A Purpose In Your Life",628000,628000,0,0
TIKI,cross-border-hang-quoc-te,167932988,"Multifunctional Electronics Audio Music Tesla Coil Module Plasma Speaker Sound Solid Science Experimental Toy with BT",994999,994999,0,0
TIKI,cross-border-hang-quoc-te,96478443,"Signal Blocker Case Keychain Bag Faraday Bag Cell Phone Radiation Protection",238000,238000,0,0
TIKI,cross-border-hang-quoc-te,267514231,"LSYAAAAA Giày bóng đá cao gót MG/TF Giày bóng đá chống trượt ngoài trời Đào tạo mắt cá chân chống trượt Giày thể thao bóng đá Chaussures De Foot",900095,900095,0,0
TIKI,cross-border-hang-quoc-te,95565563,"Throttle Cable Wire for XL883",438000,438000,0,0
TIKI,cross-border-hang-quoc-te,229909712,"Đệm Bọc Tai Nghe Nâng Cấp Thay Thế Cho Sennheiser HD380 Pro/ HD555/ HD558/ HD559/ HD599/ HD569",429700,429700,0,0
TIKI,cross-border-hang-quoc-te,241972906,"Chuột Không Dây G304 USB 2.4G 6 Nút Dành Cho Game Thủ",591800,591800,0,0
TIKI,cross-border-hang-quoc-te,230274334,"Ổ Cứng di động  SSD  4TB  ổ di động  Usb 3.0 Loại-c  HD ổ cứng ngoài  2TB  Đĩa cứng di động  1TB/8TB/16TB - Màu xanh da trời",312700,312700,0,0
TIKI,cross-border-hang-quoc-te,95723206,"Set 13 Bóng Đèn Led Cho Nội Thất Xe Ô Tô",257400,257400,0,0
TIKI,cross-border-hang-quoc-te,189942636,"Giày Chạy Bộ Nam Giày thể thao CAMEL thoáng khí siêu nhẹ thời trang cho",1076000,1076000,0,0
TIKI,cross-border-hang-quoc-te,11708738,"Blink: The Power Of Thinking Without Thinking",546000,546000,0,0
TIKI,cross-border-hang-quoc-te,96654307,"Full Covered Leather Harness Hood Mask Buckled Lockable Headgear Costume",361000,361000,0,0
TIKI,cross-border-hang-quoc-te,116464899,"Smart 2.4G Wireless Mechanical Numeric Keypad Numpad Gaming Keyboard, Black",601000,601000,0,0
TIKI,cross-border-hang-quoc-te,170568922,"Sách - Same Soul, Many Bodies : Discover the Healing Power of Future Lives  by M D Brian L Weiss (US edition, paperback)",483000,483000,0,0
TIKI,cross-border-hang-quoc-te,96538924,"Sexy Mens Underwear Thong Briefs Bulge G-String Bikinis Underpants Nightwear",174000,174000,0,0
TIKI,cross-border-hang-quoc-te,137066720,"Mới Quần Short Đạp Xe Nâng Cấp 5D Gel Pad Đi Xe Đạp Quần Lót Chống Sốc Đi Xe Đạp Underpant Xe Đạp Quần Short Xe Đạp Quần Lót - XXXL",510048,510048,0,0
TIKI,cross-border-hang-quoc-te,170625849,"Sách - Emotional Intelligence : 25th Anniversary Edition by Daniel Goleman (UK edition, paperback)",414000,414000,0,0
TIKI,cross-border-hang-quoc-te,46350896,"In Lụa Lưới Chất Liệu Vải Lưới Bá Tước 160 M, Chiều Dài 1 M, Rộng 1.45 M",223000,223000,0,0
TIKI,cross-border-hang-quoc-te,263814679,"Hot Bán Twitter M6 Xe Đạp 29 Inch 27.5Inch MTB Phanh Đĩa Qua Trục F15×110_R12×148mm SUNSHINE-12S Sợi Carbon Xe Đạp Leo Núi Color: White Size: 29-17  Number of speeds: RS-12S",21361781,21361781,0,0
TIKI,the-thao-da-ngoai,152705777,"Bộ Dây Cáp Ròng Rọc Tập Gym Tại Nhà Tiện Lợi",495000,495000,0,0
TIKI,the-thao-da-ngoai,91149157,"Vợt cầu lông carbon 4U Quangyu công thủ toàn diện cao cấp 80g",400000,400000,0,0
TIKI,the-thao-da-ngoai,161458870,"Bộ 2 tạ tay nhựa bát giác 1kg REEFIT (2 tạ 1kg, tổng 2kg)",16000,16000,0,0
TIKI,the-thao-da-ngoai,181776455,"Bộ Xà Đơn Xà Kép Treo Tường Di Động Đa Năng 8 IN 1",1390000,1390000,0,0
TIKI,the-thao-da-ngoai,119962865,"Đèn Pin Siêu Sáng Với 3 Màu Ánh Sáng Khác Nhau XPE Q5(đèn pin đội đầu)",218500,230000,11500,5
TIKI,the-thao-da-ngoai,35717946,"Găng tay nửa ngón tập gym, tập tạ Aolikes AL113B (1 đôi)",145000,145000,0,0
TIKI,the-thao-da-ngoai,144446121,"Iso HD 2,3kg 100% Isolate tinh khiết - Sữa bổ sung Protein, hỗ trợ phục hồi, tăng Cơ cho người tập thể thao",1549500,1549500,0,0
TIKI,the-thao-da-ngoai,4281325,"Giàn tạ đa năng DV-2014 - Tặng kèm bao tay",2489000,2790000,301000,11
TIKI,the-thao-da-ngoai,117374610,"Bộ thể thao nữ mùa hè áo croptop nữ tay ngắn và quần dài vải thun dẻo",129000,129000,0,0
TIKI,the-thao-da-ngoai,25068523,"Tất Vớ Bóng Đá Bảo Vệ Ống Đồng Kiểu Legging Thoáng Khí Football Leg Guard Plate Socks YE-7968",116000,239000,123000,51
TIKI,the-thao-da-ngoai,139925901,"Cần câu cá Gw Yf 6H đủ sz - Sz cần hoặc lóng,Lóng thứ 2 của cần",57300,57300,0,0
TIKI,the-thao-da-ngoai,163717105,"Bó gối thể thao Băng bảo vệ đầu gối có đệm chống chấn thương chơi Đá Bóng Bóng rổ Tennis Bóng chuyền Gym Chạy bộ - Redikick",129000,169000,40000,24
TIKI,the-thao-da-ngoai,12505834,"Bộ quần áo mưa Givi RRS06",760000,760000,0,0
TIKI,the-thao-da-ngoai,139916809,"Vợt Cá Carbon Vành Tròn Có thể thu gọn chuyên dụng câu đài vợt cá câu đài",139000,139000,0,0
TIKI,the-thao-da-ngoai,68541859,"Bộ đồ tập Gym nữ - Set quần đùi và áo Bra thể thao",168000,168000,0,0
TIKI,the-thao-da-ngoai,132781394,"Đồ tập gym nữ, bộ tập gym yoga aerobic nữ chất vải co giãn thấm hút mồ hôi tốt( bộ sát nách)",195000,195000,0,0
TIKI,the-thao-da-ngoai,154978371,"Chống cần Câu Đài Đại Lý Đồ Câu Cá Chống Cần Câu Đơn Cao Cấp Ultra Light Đồ Câu Cá",38899,38899,0,0
TIKI,the-thao-da-ngoai,121156985,"Vòng lắc eo thông minh với đầu massage từ tính có màn hình led đếm số lần, số vòng quay, lượng calo tiêu thụ, điều chỉnh kích cỡ theo cân nặng",765000,765000,0,0
TIKI,the-thao-da-ngoai,149586182,"máy câu ngang proberos, máy câu lure có tay phải và tay trái",212433,212433,0,0
TIKI,the-thao-da-ngoai,134336080,"Bộ cần câu cá lure máy đứng 1.68m - 1.8m - 2.1m - 2.4m + Máy kim loại + dây câu lure + hộp mồi lure B-lu-D01",400000,400000,0,0
TIKI,the-thao-da-ngoai,135462422,"Rọng Đựng Cá Khung Kim Loại Siêu Bền Rọng Cá Câu Đài KK2",85000,85000,0,0
TIKI,the-thao-da-ngoai,5816817,"Túi ngủ dã ngoại, văn phòng, ngủ trưa",200000,200000,0,0
TIKI,the-thao-da-ngoai,138827740,"HỘP 50 MIẾNG DÁN CHÂN NGẢI CỨU THẢI ĐỘC BẮC KINH",31925,31925,0,0
TIKI,the-thao-da-ngoai,169343144,"Tạ tay nữ 1kg-6kg lõi gang đặc bọc cao su tập gym,yoga chống trơn trượt, xước vỡ sàn Nhà",55000,60000,5000,8
TIKI,the-thao-da-ngoai,208404505,"Combo bao cát trụ đấm bốc boxing tự đứng UFC + găng tay đấm bốc boxing + băng đa cuốn tay + bóng phản xạ + lót tay chân - Thiết bị đấm bốc boxing dành cho dân chuyên, phòng tập, võ đường",1999000,1999000,0,0
TIKI,the-thao-da-ngoai,131395889,"Cần Câu Máy Huntman, Cần Câu Cá, Cần Câu Lancer Cao Cấp",129990,129990,0,0
TIKI,the-thao-da-ngoai,189591425,"Kính bơi unisex Speedo HYDROPURE MIRROR - 8-126683487",645000,645000,0,0
TIKI,the-thao-da-ngoai,59292929,"Bình nước thể thao thân tháo rời tiện lợi chất liệu nhựa Cleacco",169000,255000,86000,34
TIKI,the-thao-da-ngoai,193330051," Giày Bóng Đá Nam Biti's Hunter Football DSMH09600CAM (CAM)",537000,716000,179000,25
TIKI,the-thao-da-ngoai,74177441,"Băng bảo vệ đầu gối Reebok Knee Support - RRSU-1332ㅌ",445000,445000,0,0
TIKI,the-thao-da-ngoai,88269489,"Bộ Dụng Cụ Giúp Luyện Tập Cơ Cổ Tay, Cơ Bắp Tay To Khoẻ Wrist Arm Trainer Cao Cấp",295000,295000,0,0
TIKI,the-thao-da-ngoai,135462135,"Hộp Đựng Lưỡi Câu Đài Lưỡi Câu Đôi, Thẻo câu cá chuyên dành cho câu đài HPK8",99000,99000,0,0
TIKI,the-thao-da-ngoai,195701219,"Áo croptop tập Yoga Gym Hibi Sports có tay CR816 kiểu xoắn nơ, Kèm mút ngực",252000,360000,108000,30
TIKI,the-thao-da-ngoai,15098291,"Combo khuyến mãi 2 gạch tập và 1 dây yoga cotton",127900,127900,0,0
TIKI,the-thao-da-ngoai,14800841,"Lều cắm trại tự bung cao cấp dành cho 2 - 3 người",191989,191989,0,0
TIKI,the-thao-da-ngoai,15219166,"Phao Tay Bơi Cho Bé Cực Chất MAY_PH001",30000,30000,0,0
TIKI,cross-border-hang-quoc-te,100549600,"Insulated Stainless Steel Wine Double Wall Vacuum Cup 12oz",109000,109000,0,0
TIKI,cross-border-hang-quoc-te,109165745,"Đèn pin xe đạp siêu sáng WEST BIKING 6 chế độ sáng không thấm nước sạc USB-Màu đen",343000,343000,0,0
TIKI,the-thao-da-ngoai,149604354,"Dây trục câu đài buộc sẵn đầy đủ các kích thước, cước câu, DC-3",8900,8900,0,0
TIKI,cross-border-hang-quoc-te,113345605,"Sách - Talking to Strangers : What We Should Know about the People We Don&#x27;t Know by Malcolm Gladwell - (US Edition, paperback)",299200,299200,0,0
TIKI,cross-border-hang-quoc-te,191281216,"Cặp 2 - Kẹo Bổ Sung Vitamin Cho Bé Kirkland Children’s Multivitamin 160V x 2 Hũ - Mỹ",469000,469000,0,0
TIKI,cross-border-hang-quoc-te,95716633,"Túi Lưới Đựng Đồ Trong Xe Hơi",284000,284000,0,0
TIKI,cross-border-hang-quoc-te,163282613,"Sách - Make Your Bed : 10 Life Lessons from a Navy SEAL by Admiral William H. McRaven (UK edition, hardcover)",436000,436000,0,0
TIKI,the-thao-da-ngoai,183535386,"[Loại Cao Cấp] dây nhảy thể lực, dây nhảy đếm số tự động tính calo, dây nhảy boxing, dây nhảy không dây - Hãng DODODIOS",20500,20500,0,0
TIKI,the-thao-da-ngoai,55029295,"Xe Đạp Tập Thể Dục Đa Năng Tại Nhà Air Bike MK207 + Kèm Máy Massage Xung Điện",1629000,1629000,0,0
TIKI,cross-border-hang-quoc-te,170042469,"Bộ Dụng Cụ Mài Dao Gồm 4 Đá Mài Chuyên Nghiệp",650962,650962,0,0
TIKI,the-thao-da-ngoai,119911424,"Dây nhảy thể dục cho bé Agnite - Dây lõi bông, cán gỗ an toàn cho bé - Xanh da trời/ Hồng- Hàng chính hãng - 18702",225000,225000,0,0
TIKI,cross-border-hang-quoc-te,113953883,"Vỏ bọc ghế sofa bằng vải thun polyester co giãn cao, bền màu,thiết kế hoa văn sang trọng,tinh tế-Size 45X45cm",124000,124000,0,0
TIKI,cross-border-hang-quoc-te,176771084,"Skull Head Skeleton Halloween Statue Figurine Ornament 14.5x12.5x17.5 White",178000,178000,0,0
TIKI,cross-border-hang-quoc-te,116562718,"1080P 4K HDMI to USB 3.0 Video Capture Card Video Live Streaming",248000,248000,0,0
TIKI,cross-border-hang-quoc-te,170725207,"Sách - Marketing Made Simple : A Step-by-Step StoryBrand Guide for by Donald Miller J.J Peterson (US edition, hardcover)",466000,466000,0,0
TIKI,cross-border-hang-quoc-te,113195144,"Ngăn kéo đựng tiền quầy thu ngân POS-Màu trắng",917000,917000,0,0
TIKI,cross-border-hang-quoc-te,189290871,"Máy khuếch tán tinh dầu thơm khử mùi chống trượt dành cho xe hơi",409010,409010,0,0
TIKI,cross-border-hang-quoc-te,17966574,"Antifragile (New In Paperback)
 (Osd: 7 Nov 13)",525000,525000,0,0
TIKI,cross-border-hang-quoc-te,166340437,"Travel Carrying Bag for iMac Desktop Computer Protective Storage Case Monitor  for iMac Screen and Accessories",713000,713000,0,0
TIKI,cross-border-hang-quoc-te,112019024,"Băng đeo thấm mồ hôi cho xe đạp tập thể dục tại nhà bảo vệ khung xe chống bị ăn mòn, Được làm bằng lưới và vải lặn-Màu đỏ",179000,179000,0,0
TIKI,cross-border-hang-quoc-te,109164826,"Mặt nạ đi xe đạp, khăn che mặt cổ chống tia cực tím, chất liệu vải thoáng khí, hút ẩm-Màu Sọc đen",120000,120000,0,0
TIKI,cross-border-hang-quoc-te,10769329,"Getting To Yes: Negotiating An Agreement Without Giving In",387000,387000,0,0
TIKI,cross-border-hang-quoc-te,170725142,"Sách - How Successful People Think : Change Your Thinking, Change Your Life by John C. Maxwell (US edition, hardcover)",341000,341000,0,0
TIKI,cross-border-hang-quoc-te,52653433,"Dây đeo đàn Guitar Dày Cho Dây đeo Hộp đàn Guitar Khác Nhau",548000,548000,0,0
TIKI,cross-border-hang-quoc-te,108598918,"Máy đo tốc độ INBIKE 2.8inch bằng thép không gỉ-Màu xanh lá",434000,434000,0,0
TIKI,cross-border-hang-quoc-te,11504758,"Nice Girls Still Don't Get The Corner Office",316000,316000,0,0
TIKI,cross-border-hang-quoc-te,113401016,"Sách - The Ride of a Lifetime : Lessons in Creative Leadership from the CEO of the Walt Disney Company by Robert Iger - (US Edition, paperback)",708000,708000,0,0
TIKI,cross-border-hang-quoc-te,17970181,"In Order To Live",387000,387000,0,0
TIKI,cross-border-hang-quoc-te,179422388,"Sách - Daily Inspiration for the Purpose Driven Life : Scriptures and Reflections from the 4 by (US edition, paperback)",246000,246000,0,0
TIKI,cross-border-hang-quoc-te,192231247,"Bơm lốp xe đạp WEST BIKING 160psi bằng thép không gỉ",207000,207000,0,0
TIKI,cross-border-hang-quoc-te,170675421,"Sách - Given, Vol. 3 by Natsuki Kizu (US edition, paperback)",370000,370000,0,0
TIKI,cross-border-hang-quoc-te,251865915,"Giá thấp nhất rèm giường sinh viên ký túc xá giường tầng trên dày bóng mạnh giường tầng dưới ký túc xá nữ đơn giản lưới chống muỗi tích hợp rèm che cửa sổ - Gấu Dâu + Rèm Sheer",191448,191448,0,0
TIKI,cross-border-hang-quoc-te,176066133,"HEPA Filter Replacement fit Sharp FZ-F30HFE Air Purifier Accessory Durable",322000,322000,0,0
TIKI,cross-border-hang-quoc-te,95720815,"Miếng Phản Quang Gắn Căm Xe Đạp",278000,278000,0,0
TIKI,cross-border-hang-quoc-te,176223242,"Guitar Transducer 1/4 Jack Pickup for Acoustic Guitar Violin Banjo Mandolin",132000,132000,0,0
TIKI,cross-border-hang-quoc-te,51678416,"10 Chiếc Cần Câu Cá",136000,136000,0,0
TIKI,cross-border-hang-quoc-te,108784191,"Đồng hồ nam FORSINING 291 cơ khí,phát sáng,chống nước 3ATM-Màu Vàng",688000,688000,0,0
TIKI,cross-border-hang-quoc-te,170269089,"Sách - The Octonauts Explore The Great Big Ocean by Meomi (UK edition, paperback)",361000,361000,0,0
TIKI,cross-border-hang-quoc-te,116471864,"Đồ chơi Cà Rốt cho trẻ em sáng tạo",473000,473000,0,0
TIKI,cross-border-hang-quoc-te,95723504,"Dụng Cụ Tháo Lắp Líp Xe Đạp",190000,190000,0,0
TIKI,cross-border-hang-quoc-te,125590850,"Sách - The Master Key System : Your Step-by-Step Guide to Using the Law of Attraction by Charles F. Haanel - (US Edition, paperback)",394000,394000,0,0
TIKI,cross-border-hang-quoc-te,230025405,"Google Chromecast 3 Nguyên Thế Hệ Thứ Ba Full HD Đen 3rd Thế Hệ Nhập Khẩu Từ Mỹ ^ MK ^",291360,291360,0,0
TIKI,cross-border-hang-quoc-te,109436301,"Loa Bluetooth không dây Rolton E500 6W Máy nghe nhạc âm thanh nổi HiFi Đài FM kỹ thuật số di động với màn hình LED đèn pin-Màu xanh dương",395000,395000,0,0
TIKI,cross-border-hang-quoc-te,137596810,"Xe Tập Đi Dành Cho Giáo Dục Cho Bé Tập Đi Cho Bé Dây Trợ Lý Ba Lô Dây Xích Cho Trẻ Em Bé Đai An Toàn Trẻ Em Dây Cương - one",506184,506184,0,0
TIKI,cross-border-hang-quoc-te,111063307,"Chuột dọc không dây YWYT 2.4G  3 mức DPI có thể điều chỉnh",179000,179000,0,0
TIKI,cross-border-hang-quoc-te,170682191,"Sách - Origami Animal Sculpture : Paper Folding Inspired by Nature: Fold and Dis by John Szinger (US edition, paperback)",741000,741000,0,0
TIKI,cross-border-hang-quoc-te,176763353,"24 Fret Guitar Neck Headless Electric Guitar Neck Guitar Body Unfinished for DIY Guitar",952000,952000,0,0
TIKI,cross-border-hang-quoc-te,51687066,"Xúc Xắc Bằng Gỗ Cực Lớn Với Góc Tròn D6 Xúc Xắc Sáu Mặt 5cm",128000,128000,0,0
TIKI,cross-border-hang-quoc-te,176109233,"7 Colors Bike Chain Fixed Gear Track BMX Single Speed Chains 1/2'' x 1/8",158000,158000,0,0
TIKI,cross-border-hang-quoc-te,101290844,"Đồng Hồ Thông Minh 1.4 inch Cảm Ứng Đầy Đủ IP67 Chống Nước, đo được nhịp tim oxy-Màu đen",557000,557000,0,0
TIKI,cross-border-hang-quoc-te,99503195,"3/4 Natural Wooden Basswood Violin Fiddle Violin Bow Rosin Bag for Student",479000,479000,0,0
TIKI,cross-border-hang-quoc-te,98036697,"Đồng hồ thông minh G28 Bluetooth 5.0 theo dõi nhịp tim chống thấm nước-Màu Hồng",664000,664000,0,0
TIKI,cross-border-hang-quoc-te,97483028,"Tank Chiller Cooling Fan   Tank Adjustable  Temperature Control",447000,447000,0,0
TIKI,cross-border-hang-quoc-te,46353128,"3 Nam VINTAGE KẺ SỌC Khăn Tay Bỏ Túi Vuông Tiệc Cưới Hanky Rất Nhiều",202000,202000,0,0
TIKI,cross-border-hang-quoc-te,101798274,"Pair LED 9006 HB4 Headlight Kit 4000LM FOG Light Bulb 6000K Driving DRL Lamp",288000,288000,0,0
TIKI,cross-border-hang-quoc-te,190087363,"Giày thể thao nữ sneaker CAMEL CROWN lưới nhẹ thoáng khí (METEOR)",1094000,1094000,0,0
TIKI,cross-border-hang-quoc-te,229891813,"Máy tính bảng vẽ VEIKK VK430",652000,652000,0,0
TIKI,cross-border-hang-quoc-te,95722181,"Khăn Trùm Mặt Và Cổ Chống Nắng Đi Xe Đạp",262500,262500,0,0
TIKI,cross-border-hang-quoc-te,101296048,"Cuộn dây thả diều có bánh xe quay-Màu Pha lê tím-Size",165000,165000,0,0
TIKI,cross-border-hang-quoc-te,225316619,"Bọc vô lăng cho xe hơi Mazda 2 3 5 6 8 Cx5 Cx7 Cx3 Cx9 Rx Mx Cx30 Atenza Axela Bt-50",559243,559243,0,0
TIKI,cross-border-hang-quoc-te,51382485,"100 Pieces Decorative Flag Toothpicks Party Food Decorations",127000,127000,0,0
TIKI,cross-border-hang-quoc-te,46336777,"Sunnimix Cao Su Tắt Tiếng Bánh Xe Vali 360 Xoay Hành Lý Thay Thế Bánh Phụ Kiện 10",152000,152000,0,0
TIKI,cross-border-hang-quoc-te,46403963,"12 Chiếc Quần Áo Dán Sắt Trên Hoặc May, bướm Miếng Dán Miếng Dán DIY Quần Áo Miếng Dán Sắt-Trên Miếng Dán Cho",149000,149000,0,0
TIKI,cross-border-hang-quoc-te,109438375,"Bộ Khuếch Đại Tín Hiệu Dvb-T Hd Tv Với Ăng-Ten Kỹ Thuật Số 4K Trong Nhà 3600 Dặm",190000,190000,0,0
TIKI,cross-border-hang-quoc-te,108602189,"Bộ đề sau cho xe đạp leo núi 9S/10S/11S 9 tốc độ-Size 9 tốc độ",350000,350000,0,0
TIKI,cross-border-hang-quoc-te,98046878,"2 Miếng Đệm Tai Thay Thế Cho Beats Studio Cho Tai Nghe Có Dây / Không Dây",163300,163300,0,0
TIKI,cross-border-hang-quoc-te,170578660,"Sách - The Untethered Soul : The Journey Beyond Yourself by unknown,Michael A. Singer (US edition, paperback)",551000,551000,0,0
TIKI,cross-border-hang-quoc-te,95711037,"Bộ 10 Đèn Led 12v T10 W5W Chất Lượng Cao Cho Xe Hơi",262500,262500,0,0
TIKI,cross-border-hang-quoc-te,170682273,"Sách - Weave the Liminal : Living Modern Traditional Witchcraft by Laura Tempest Zakroff (US edition, paperback)",619000,619000,0,0
TIKI,cross-border-hang-quoc-te,170726297,"Sách - Attached : Are you Anxious, Avoidant or Secure? How the science of adult a by Amir Levine (UK edition, paperback)",403000,403000,0,0
TIKI,cross-border-hang-quoc-te,97437783,"Acoustic Guitar Preamp 3 Band EQ Piezo Pickup for Guitar Parts Accessories",277000,277000,0,0
TIKI,cross-border-hang-quoc-te,113042015,"Sách - The Body Keeps the Score : Mind, Brain and Body in the Transformation of Trauma by Bessel van der Kolk - (UK Edition, paperback)",490800,490800,0,0
TIKI,cross-border-hang-quoc-te,170040469,"Ăng ten kỹ thuật số DVB-T/T2Antena HDTV DTA-180 HD",255110,255110,0,0
TIKI,cross-border-hang-quoc-te,17968728,"Civilization And Its Discontents",422000,422000,0,0
TIKI,cross-border-hang-quoc-te,109436605,"Loa máy tính có dây USB SADA V-193 siêu trầm âm thanh vòm 3.5mm",305000,305000,0,0
TIKI,cross-border-hang-quoc-te,109270686,"Đồng hồ thể thao thông minh kỹ thuật số đo nhịp tim huyết áp theo dõi hoạt động thể dục dành cho Nam-Màu đỏ",820000,820000,0,0
TIKI,cross-border-hang-quoc-te,95568111,"18pcs Step Up Down Lens Filter Ring Adapter Set 37 - 82mm for Canon Nikon",365000,365000,0,0
TIKI,cross-border-hang-quoc-te,46427063,"Cho Xe Hơi Xe Máy Máy Bơm Hơi Lốp Xe 1/4 Cao Su Không Đường Ống Vòi & Kẽm Van",135000,135000,0,0
TIKI,cross-border-hang-quoc-te,190701473,"Mật Ong Raw Honey Cao Cấp 500g 100% Nguyên Chất Vị Ngon Thuần Túy Từ New Zealand 500g",421000,421000,0,0
TIKI,cross-border-hang-quoc-te,11777163,"Collins Classics: The Iliad",313000,313000,0,0
TIKI,cross-border-hang-quoc-te,95716086,"Túi Đựng Điện Thoại Chống Nước Gắn Khung Trước Xe Đạp Wheel Up Mtb",262600,262600,0,0
TIKI,cross-border-hang-quoc-te,179799742,"USB WiFi Adapter 1800Mbps Dual Band for Win11/10/7 WiFi 6 Wireless Network Adapter for Desktop Gaming PC",402000,402000,0,0
TIKI,cross-border-hang-quoc-te,101167073,"3Inch 64 Pockets Photo Album for Polaroid Fuji Instax Mini 8/25/50/90",88000,88000,0,0
TIKI,cross-border-hang-quoc-te,141115826,"Túi đựng bút bằng vải Canvas nhiều ngăn đa năng sáng tạo",360000,360000,0,0
TIKI,cross-border-hang-quoc-te,109698514,"Máy nghe nhạc T1 MP3 MP4 kỹ thuật số Màn hình 1,8 inch  -Màu trắng",330000,330000,0,0
TIKI,cross-border-hang-quoc-te,11709099,"Everybody Lies: Big Data, New Data, And What The Internet Can Tell Us About Who We Really Are",510000,510000,0,0
TIKI,cross-border-hang-quoc-te,46379101,"2 Cổng USB 3.0 Loại A Nữ Cho Bo Mạch Chủ 20Pin Cáp Dây 50 Cm",215000,215000,0,0
TIKI,cross-border-hang-quoc-te,17966174,"Benjamin Graham On Value Investing",595000,595000,0,0
TIKI,cross-border-hang-quoc-te,46365579,"MÀN HÌNH LCD Kỹ Thuật Số Đồng Hồ Đo Tốc Độ Đo Tốc Độ cho Kawasaki Ninja 300",821000,821000,0,0
TIKI,cross-border-hang-quoc-te,146554010,"CINCATDY Tai Nghe Bluetooth Earbuds Gaming Headset True Wireless Headphone Dock Sạc có Led Báo Pin Kép S6 PLUS",240000,240000,0,0
TIKI,cross-border-hang-quoc-te,247455798,"Mechanical Keyboard White",524000,524000,0,0
TIKI,cross-border-hang-quoc-te,169758663,"124-Key PBT Keycaps Cover for 87 98 104 108 61 63 64 68 75 Keyboard",450000,450000,0,0
TIKI,cross-border-hang-quoc-te,186285079,"Lều cắm trại ngoài trời CAMEL CROWN Dày Dày Di động Hoàn toàn tự động Cửa sổ bật lên Chống mưa",2865000,2865000,0,0
TIKI,cross-border-hang-quoc-te,164568117,"Mechanical Keyboard Dust Cover Transparent Easy to Use Home",371000,371000,0,0
TIKI,cross-border-hang-quoc-te,124621177,"Trẻ Em Nàng Tiên Cá Đồ Bơi Nữ Bikini Đuôi Nàng Tiên Cá Với Vây Bơi Của Bé Mặc Chia Đồ Bơi Nàng Tiên Cá Đuôi Quần Áo Đồ Bơi - 10T(140)",772317,772317,0,0
TIKI,cross-border-hang-quoc-te,115284117,"Máy ép Tortilla , dụng cụ ép mỏng bột làm bánh bền và dễ sử dụng-Màu Xám-Size 6,5in",320800,320800,0,0
TIKI,cross-border-hang-quoc-te,96474539,"Pro 13.3" A1502 Retina 2015 Trackpad Touchpad",463000,463000,0,0
TIKI,cross-border-hang-quoc-te,248898457,"Máy bay điều khiển từ xa mini chống rơi QS5013 phong cách mới nhất Máy bay trực thăng 2.5 kênh với con quay hồi chuyển",324000,324000,0,0
TIKI,cross-border-hang-quoc-te,113349248,"Sách - Sapiens (Graphic Edition) : A Brief History of Humankind by Yuval Noah Harari - (US Edition, paperback)",897000,897000,0,0
TIKI,cross-border-hang-quoc-te,97444893,"Folding Cooler Car Trunk Organizer Camping Insulated Bag Carry Lunch Box",207000,207000,0,0
TIKI,cross-border-hang-quoc-te,170703826,"Sách - 8 Little Planets by Chris Ferrie (US edition, paperback)",399000,399000,0,0
TIKI,cross-border-hang-quoc-te,28602041,"Zero Limits: The Secret Hawaiian System For Wealth, Health, Peace, And More",576000,576000,0,0
TIKI,cross-border-hang-quoc-te,271351433,"Toilet Roll Holder Stand with Toilet Brush Industrial Toilet Paper Dispenser",494000,494000,0,0
TIKI,cross-border-hang-quoc-te,170724875,"Sách - Originals : How Non-Conformists Move the World by Adam Grant (US edition, paperback)",385000,385000,0,0
TIKI,cross-border-hang-quoc-te,99639866,"1 Gang Brush Style Wall Plate Bristles Port Insert Cover Outlet Mount Panel",117000,117000,0,0
TIKI,cross-border-hang-quoc-te,46427293,"50w H3 LED SMD Fog Light Daytime Running Light Bulbs Headlight for BMW Honda - Intl",101000,101000,0,0
TIKI,cross-border-hang-quoc-te,110303517,"Bao da bàn phím thông minh F19B Flip Cover Thay thế cho iPad Air 1 2 5 6 Pro 9.7 -Màu đen",620000,620000,0,0
TIKI,cross-border-hang-quoc-te,170719765,"Sách - Ivermectin. A Cure For Covid 19? Book. : Covid 19 Book. A Guide To Treatment by Bethany Jayne Roberts (paperback)",642000,642000,0,0
TIKI,cross-border-hang-quoc-te,271352330,"Toilet Roll Holder Stand with Toilet Brush Industrial Toilet Paper Dispenser",550000,550000,0,0
TIKI,cross-border-hang-quoc-te,109436747,"Tai nghe Bluetooth không dây Fineblue với micrô Đen",346000,346000,0,0
TIKI,cross-border-hang-quoc-te,263841379,"Hoka Sport Chạy giày Bondi 8 Chống trượt đệm Trượt Đường chạy Giày Men Thể thao Giày thể thao Lối sống Phụ nữ Sneaker ngoài trời Color: Orange Shoe Size: 36",1991266,1991266,0,0
TIKI,cross-border-hang-quoc-te,46442182,"Phép Lạ Chiếu 3 2 Pin/4Pin Sương Mù Trên/Tắt Nút Nhấn Đính Đá Công Tắc cho Xe Ô Tô Xe Tải",180000,180000,0,0
TIKI,cross-border-hang-quoc-te,230230683,"Tai Nghe Máy Tính USB Có Mic Chống Ồn Cho PC/Nhà Ở/Văn Phòng/Điện Thoại",450497,450497,0,0
TIKI,cross-border-hang-quoc-te,95715514,"Dụng Cụ Vệ Sinh Dây Đàn Guitar",247500,247500,0,0
TIKI,cross-border-hang-quoc-te,184990116,"Analog Chorus Guitar  Effect Pedal DC 9V True Bypass For Electric Guitar",609000,609000,0,0
TIKI,cross-border-hang-quoc-te,95715472,"Dụng Cụ Bảo Vệ Ngón Tay Khi Chơi Đàn Guitar",280000,280000,0,0
TIKI,cross-border-hang-quoc-te,189310892,"Bút Xóa Vết Trầy Xước Sơn Xe Hơi Chống Thấm Nước",190000,190000,0,0
TIKI,cross-border-hang-quoc-te,192009755,"Ấm đun nước điện bằng thép không gỉ di động, Nồi hơi điện du lịch mini và Ấm đun nước",582999,647666,64667,10
TIKI,cross-border-hang-quoc-te,46334893,"Sunnimix Chuyên Nghiệp 6.35 Mm Cắm Đàn Guitar Pickup Cho Đàn Acoustic Guitar Cổ Điển Phần",184000,184000,0,0
TIKI,cross-border-hang-quoc-te,46386008,"Sunnimix Bạc 3L3R Semiclosed Đàn Guitar Chỉnh Chốt Chỉnh Âm Cho Đàn Acoustic Guitar Điện Phần",201000,201000,0,0
TIKI,cross-border-hang-quoc-te,241665821,"Ổ Cứng Di Động SSD Cổng Usb 3.1 Kích Thước Nhỏ Gọn 4TB / 2TB / 1Tb",342018,342018,0,0
TIKI,cross-border-hang-quoc-te,170725133,"Sách - Leadership Presence (HBR Emotional Intelligence Series) by Harvard Business Review (US edition, paperback)",446000,446000,0,0
TIKI,cross-border-hang-quoc-te,46349023,"95 Mm Đường Kính 300 Mm Vành Đai Kim Loại Lốp Xe Bánh Xe, xe Thông Minh Robot Lốp Bánh Xe Tải Trọng Lớn Cho Di",262000,262000,0,0
TIKI,cross-border-hang-quoc-te,208392553,"Tai nghe không dây bluetooth S11 trong tai của các hoạt động kinh doanh theo dõi một tai TWS tai nghe stereo",443275,443275,0,0
TIKI,thoi-trang-nam,117583764,"Áo Khoác Dù Nam Cao Cấp STYLE Hàn Quốc",189000,189000,0,0
TIKI,thoi-trang-nam,80660525,"Áo Phông Nam Trắng Trơn Chất Cotton Mát THUNTRANG59 - Thun Trắng",21000,21000,0,0
TIKI,thoi-trang-nam,178058273,"Quần kaki dài nam cao cấp form đẹp LADOS-4069 vải kaki co giãn, không bay màu",329000,329000,0,0
TIKI,thoi-trang-nam,73456416,"Áo Khoác Nam Big Size Áo Khoác Kaki Nam Hai Lớp Big Size Chống Lạnh Chống Nắng Chống Gió Hàn Quốc Cao Cấp WK35 - ShopN6 (Nhiều Màu)",168000,260000,92000,35
TIKI,cross-border-hang-quoc-te,112593064,"Chân vịt ngắn nhẹ cho trẻ em tập bơi, lặn-Màu Vàng xanh-Size",246100,246100,0,0
TIKI,cross-border-hang-quoc-te,149806447,"Dụng Cụ Tập Đàn Guitar 2019",180000,180000,0,0
TIKI,cross-border-hang-quoc-te,51378329,"Album ảnh 64 Túi Cho Phim Fujifilm Instax Mini 8, 9 7s 50 90",143000,143000,0,0
TIKI,cross-border-hang-quoc-te,147153616,"Set 2 Gậy Leo Núi Chống Sốc Có Thể Gấp Gọn Tiện Lợi",630150,630150,0,0
TIKI,cross-border-hang-quoc-te,253440664,"Hifar 2023 K52 Đồng hồ thông minh Dial tùy chỉnh BLUETOOTOT CALL Nhịp tim Oxy không thấm nước pin dài thời gian",1037048,1037048,0,0
TIKI,thoi-trang-nam,77198910,"Quần đùi nam mặc nhà chất kate cotton 100% mềm mại thoáng mát thương hiệu FEZZIO",64500,129000,64500,50
TIKI,thoi-trang-nam,51551126,"Áo Sơ Mi Nam Cao Cấp Túi Hộp Ngắn Tay Siêu Hot",163000,163000,0,0
TIKI,cross-border-hang-quoc-te,80620406,"2 Pair Unisex Shoes Angel Accessories For Sneakers Shoes",158000,158000,0,0
TIKI,thoi-trang-nam,28634261,"Áo sơ mi nam ngắn tay vải sơ mi  chống nhăn cao cấp",108000,108000,0,0
TIKI,cross-border-hang-quoc-te,94283256,"6 Pieces Grip Rubber Unit Repair Part  For Nikon D700 Front/Rear/Side Cover - Black",472000,472000,0,0
TIKI,cross-border-hang-quoc-te,176662794,"Neck and Shoulder Relaxer, Traction Pillow, Relief the Pain, Chiropractic Pillow, Muscle Relax Cervical Spine Alignment Posture Corrector Stiffness",397000,397000,0,0
TIKI,cross-border-hang-quoc-te,28731805,"Instagram For Business For Dummies",999000,999000,0,0
TIKI,thoi-trang-nam,68090341,"Áo khoác gió chống nước Áo dù thể thao nam G-01",139000,139000,0,0
TIKI,thoi-trang-nam,52188800,"Combo 4 Quần Lót Nam Quần Sịp Đùi Sợi Cotton Cao Cấp MRM FASHION Mix 3 Màu TẶNG Đôi Tất Nam Cao Cấp",265000,380000,115000,30
TIKI,thoi-trang-nam,16915984,"Combo 10 Quần Lót Nam co giãn 2 chiều vải cotton lưng CM hiệu CITYMEN, màu ngẫu nhiên, sịp nam - LMTK-CM2C",200000,200000,0,0
TIKI,cross-border-hang-quoc-te,11842316,"Gravity Falls Dipper's And Mabel's Guide To Mystery And Nonstop Fun! (Guide to Life) ",482000,482000,0,0
TIKI,thoi-trang-nam,167431460,"Quần Bò Nam, Phối Rách Cao Cấp Thương Hiệu Chandi, Chất Jean Co Dãn Mẫu Mới Nhất 2023 MS86",184000,299000,115000,38
TIKI,cross-border-hang-quoc-te,109164938,"Gương chiếu hậu dành cho xe đạp",194000,194000,0,0
TIKI,cross-border-hang-quoc-te,154716781,"Combo 3 Hộp Viên Nén Cà Phê Sữa, Trà Sữa Matcha, Trà Sữa Truyền Thống Killiney Latte Mixed 3 -  Tương Thích Máy Pha Cà Phê Dolce Gusto - (3 Hộp X 10 Viên)",1185000,1185000,0,0
TIKI,cross-border-hang-quoc-te,95723986,"2 miếng đệm tai nghe cho Sony mdr-7506 mdr-v6 mdr-cd 900st Universal",278000,278000,0,0
TIKI,thoi-trang-nam,148994401,"Quần Lót Nam Tam Giác Thun Lạnh, Quần Sịp Nam Tam Giác Cao Cấp, Chất Thun Lạnh Đẹp, Co Dãn 4 Chiều",40000,40000,0,0
TIKI,thoi-trang-nam,102521005,"HÌNH SHOP CHỤP THẬT - Quần short nhung lửng có túi sau bao đẹp, Quần Short  Vải Nhung Cao cấp, QUẦN SHORT NHUNG , QUẦN THỂ THAO  NAM NỮ, QUẦN LỬNG MẶC NHÀ , QUẦN ĐÙI , QUẦN LỬNG, quần lửng ngố , quần short nam nữ",99000,99000,0,0
TIKI,cross-border-hang-quoc-te,46337933,"Hilabee + Tập Trung Vòng Cao Su Cho Ống Kính Tamron 28-75 F2.8 A09 Mới",272000,272000,0,0
TIKI,thoi-trang-nam,77868132,"Quần Đùi Nam Vải Kaki Cao Cấp Thời Trang Vicero",159000,298000,139000,47
TIKI,cross-border-hang-quoc-te,46335137,"Sunnimix 6 Chỉnh Âm Cho Buổi Hòa Nhạc Đàn Guitar (3li/3re) Đàn Guitar Chỉnh Âm, Guitar Chỉnh Chốt",173000,173000,0,0
TIKI,thoi-trang-nam,66721969,"Quần tây nam vải Tuyết Mưa",109000,109000,0,0
TIKI,thoi-trang-nam,160903200,"Quần Jogger Nam LAMPOS Túi Hộp, Ống Zipper Cao Cấp, Cotton Co Giản 4 Chiều",195000,195000,0,0
TIKI,cross-border-hang-quoc-te,108227461,"Bộ Lọc Màn Hình Chống Tia Uv Phim Bảo Vệ Mắt Độ Truyền Cao Widescreen Monitor Hanging Privacy Screen - 20-22''",910000,910000,0,0
TIKI,thoi-trang-nam,174651544,"Quần Sọt Jean nam co dãn 4 chiều Thương Hiệu Chandi, phong cách hàn quốc mẫu mới nhất MS218",176000,220000,44000,20
TIKI,cross-border-hang-quoc-te,128518941,"Sách - Code Name Bananas by David Walliams, Tony Ross - (UK Edition, paperback)",573000,573000,0,0
TIKI,cross-border-hang-quoc-te,137597413,"Xe Máy Điện Dây Đai Đai An Toàn Cho Trẻ Con Vỡ Chịu Ghế Dây Đeo Cho Bé Dây Đai Xe Máy An Toàn Cho Bé - one",469789,469789,0,0
TIKI,thoi-trang-nam,67488235,"Quần dài thể thao nam, jogger 3 sọc ống bo có khóa túi size đại hơn 80kg",55500,55500,0,0
TIKI,cross-border-hang-quoc-te,95847506,"Giày thể thao leo núi chống thấm nước cho nam",555805,555805,0,0
TIKI,cross-border-hang-quoc-te,272492290,"Butterfly  Trainer Kids Adults Folding Training  for Hiking Sports",109000,109000,0,0
TIKI,cross-border-hang-quoc-te,95711653,"Giá Đỡ Chai Nước Cho Xe Đạp",240000,240000,0,0
TIKI,cross-border-hang-quoc-te,55217990,"Đồ chơi cho trẻ em con quay tốc độ chiến đấu 4D trò chơi an toàn",142000,142000,0,0
TIKI,thoi-trang-nam,175551923,"Quần Lót Nam vải lạnh co giãn 4 chiều lưng CITYMEN cao cấp, sịp nam - LMTK-CTMAL",30000,30000,0,0
TIKI,cross-border-hang-quoc-te,111389920,"Võng cắm trại ngoài trời siêu nhẹ-Màu quả cam",615000,615000,0,0
TIKI,thoi-trang-nam,123204494,"Quần lót nam thun boxer Espresso iBasic PANM103",79000,99000,20000,20
TIKI,thoi-trang-nam,162734324,"Quần tây nam không ly màu xám Khatoco Q1M478R0-INMA040-2211-0",382400,478000,95600,20
TIKI,cross-border-hang-quoc-te,247263673,"Máy bay không người lái XT-1 phong cách mới nhất gấp máy bay quang học độ nét cao bốn trục wifi máy bay điều khiển từ xa chụp ảnh trên không độ nét cao thời gian thực",240000,240000,0,0
TIKI,thoi-trang-nam,82947350,"Bộ Mặc Nhà Thể Thao Nam Mùa Hè Năng Động ZERO",199000,300000,101000,34
TIKI,cross-border-hang-quoc-te,247380467,"Giày bóng rổ giá rẻ nhất giày đôi giày lưới đỏ giày đôi giày giảm giá mới nhất giày thể thao giảm giá mới nhất - đen đỏ",497000,497000,0,0
TIKI,thoi-trang-nam,163032507,"Áo Sơ Mi Nam Công Sở Trung Niên Thương Hiệu Anton Dài Tay Công Sở Vải Cotton Xanh Dương -XA14",225000,280000,55000,20
TIKI,cross-border-hang-quoc-te,271876591,"Áo Phản Quang Có Thể Điều Chỉnh Lưới Dành Cho Nam Nữ Đạp Xe Chạy Bộ",184000,184000,0,0
TIKI,cross-border-hang-quoc-te,108602395,"Túi Đựng Đồ Phía Sau Xe Đạp Bền Sức Chứa Lớn Sức Chứa Lớn",580000,580000,0,0
TIKI,cross-border-hang-quoc-te,115285939,"đồng hồ cát 30 phút,chất liệu thủy tinh trong suốt, đồ trang trí, quà tặng-Màu đỏ",310000,310000,0,0
TIKI,cross-border-hang-quoc-te,11625767,"Harvard Business Review: Guide To Data Analytics Basics For Managers",580000,580000,0,0
TIKI,thoi-trang-nam,183901382,"Viettien - Áo sơ mi công sở nam ngắn tay màu trắng mới 340 vạt bầu regular",340000,340000,0,0
TIKI,cross-border-hang-quoc-te,109435554,"Tai nghe Fineblue F970 Pro Kẹp trên tai,không dây Bluetooth 5.0-Màu trắng",422000,422000,0,0
TIKI,thoi-trang-nam,78488663,"Quần Bò Nam cao cấp thương hiệu Chandi, chất jean co dãn mẫu mới nhất mã HD26",160550,169000,8450,5
TIKI,thoi-trang-nam,83160842,"Áo Thun Nam Cổ Polo Phối Viền Ngang Lịch Lãm",157000,157000,0,0
TIKI,thoi-trang-nam,71918836,"Áo Khoác Kaki Nam Hai Lớp Cổ Bẻ Túi Hộp Chống Nắng Chống Lạnh Chống Gió Cao Cấp KK48 - ShopN6 (Nhiều Màu)",189000,240000,51000,21
TIKI,cross-border-hang-quoc-te,140296071,"Tai Nghe Bluetooth Chụp Tai 5.1 TWS Không Dây Headphons Tai Nghe Tai Nghe Nhét Tai Stereo Tai Nghe Chơi Game Với Hộp Sạc Cho Điện Thoại Thông Minh Cảm Ứng - one",465442,465442,0,0
TIKI,cross-border-hang-quoc-te,109436358,"Tai nghe Bluetooth không dây Fineblue F2 Pro 5.0 cảnh báo rung với mic cho điện thoại thông minh -Màu đen",522000,522000,0,0
TIKI,cross-border-hang-quoc-te,95808405,"Đồ Bơi Dài Tay Cho Cặp Đôi",458443,458443,0,0
TIKI,cross-border-hang-quoc-te,271016374,"Woman Dance Shoes Gymnastic Shoes Practice Ballet Dance Shoes for Girls Kids",160000,160000,0,0
TIKI,thoi-trang-nam,102872512,"Quần short lưng thun nam Novelty 1910560",126000,265000,139000,52
TIKI,thoi-trang-nam,178102021,"Quần tây học sinh việt tiến cấp 2 - 3 loại tốt",223000,223000,0,0
TIKI,cross-border-hang-quoc-te,98105918,"Silicone Breast Forms False Boobs For Crossdresser Transgender Mastectomy",573000,573000,0,0
TIKI,cross-border-hang-quoc-te,108599345,"Áo khoác không tay đi xe đạp Jersey chống gió thoáng khí dành cho Nam Nữ-Size",412000,412000,0,0
TIKI,thoi-trang-nam,151800486,"QUẦN NGỦ NAM - CÓ TÚI 2 BÊN, CHẤT COTTON CO DÃN",95000,95000,0,0
TIKI,cross-border-hang-quoc-te,112996823," Đèn Godox LITEMONS LED6R RGB LED có thể thay đổi 13 hiệu ứng ánh sáng",599000,599000,0,0
TIKI,thoi-trang-nam,116105914,"Áo Khoác Dù Bomber TSM Túi Có Khóa Kéo Áo Khoác Gió Nam Nữ Couple Rẻ Đẹp Chống Nắng - Bomber Jacket -HIỀN LINH SHOP ÁO KHOÁC",105000,105000,0,0
TIKI,thoi-trang-nam,50347611,"Combo 2 Quần shorts thể thao nam dạng sọt sport đùi chất thun lạnh 4 chiều cao cấp phù hợp tập gym hay mặc nhà màu trắng và đen DUI-P101 - tặng 1 khẩu trang chống nắng",130000,130000,0,0
TIKI,thoi-trang-nam,97861165,"COMBO 5 Áo thun trơn nam form rộng phong cách hàn quốc vải poly cotton mịn MÀU NGẪU NHIÊN SIÊU SALE !! SIÊU SALE",149000,149000,0,0
TIKI,cross-border-hang-quoc-te,97452471,"Gương Chiếu Hậu Phụ Kiện Cho Xe Đạp",97000,97000,0,0
TIKI,cross-border-hang-quoc-te,11504779,"The Power Of Moments",398000,398000,0,0
TIKI,thoi-trang-nam,150731971,"Áo Thể Thao Nam TSIMPLE cổ tròn tay ngắn tập gym vải thun lạnh thoáng mát co giãn chuẩn form MSSAHP4",95000,149000,54000,36
TIKI,thoi-trang-nam,160407460,"Viettien - Quần dài kaki nam màu xám sáng không ly regular 6Q6050",630000,630000,0,0
TIKI,cross-border-hang-quoc-te,111389880,"Balo đi xe đạp dung tích 10L, vải nylon siêu nhẹ chống thấm nước và chống rách.-Màu quả cam",320000,320000,0,0
TIKI,thoi-trang-nam,134529805,"Quần lót nam ARISTINO dáng boxer, quần sịp đùi nam chất liệu Cotton Oganic mềm mại, thấm hút và khử mùi vượt trội - ABX056",98500,125000,26500,21
TIKI,thoi-trang-nam,119056035,"Áo polo nam màu trắng phối viền chìm ADINO vải cotton polyester mềm dáng slimfit trẻ trung năng động AP81",159000,318000,159000,50
TIKI,thoi-trang-nam,168224759,"[COMBO 3 QUẦN] Quần Lót Nam Thun Lạnh Lados 4115 - Thun lụa co giãn 4 chiều, siêu mềm, siêu thoải mái",63000,140000,77000,55
TIKI,thoi-trang-nam,103596425,"Áo khoác Nam, Áo Blazer Nam phong cách Hàn Quốc BZ01",459000,459000,0,0
TIKI,thoi-trang-nam,130301550,"Quần Tây Nam Oscar Regular Fit OCMPKR 009 - Quần Âu nam công sở dáng đứng giữ form, mềm mịn, thoáng mát, chống nhăn, thấm hút hiệu quả",449000,1290000,841000,65
TIKI,cross-border-hang-quoc-te,123161790,"Phụ Nữ Thông Thoáng Độn Hông Nâng Quần Lót Quần Mông Quần Lót Tam Giác Mông To Quần Đùi Dày Giả Mông Miếng Lót Quần Lót - XXL",490245,490245,0,0
TIKI,cross-border-hang-quoc-te,95722139,"Đồng Hồ Đo Áp Suất Bánh Xe",280800,280800,0,0
TIKI,cross-border-hang-quoc-te,191356451,"Viên Uống Bổ Sung Dầu Cá DHA, EPA, Efamol Efalex Tăng Cường Trí Nhớ, Hỗ Trợ Trí Não, Tim Mạch, Thị Lực (240 Viên Nang)",1654000,1654000,0,0
TIKI,cross-border-hang-quoc-te,188061819,"3pcs Golf Club Headcover 460cc Hybrid Driver Wood Head Cover No. 1 3 5",436000,436000,0,0
TIKI,cross-border-hang-quoc-te,170703015,"Sách - The Lion King Read-Along Storybook by Disney Books Disney Storybook Art Team (US edition, paperback)",275000,275000,0,0
TIKI,cross-border-hang-quoc-te,95713834,"Bộ Đề Xe Đạp Leo Núi 6 7 8 Tốc Độ Tx35",254800,254800,0,0
TIKI,cross-border-hang-quoc-te,11730003,"Sideways Stories From Wayside School",265000,265000,0,0
TIKI,cross-border-hang-quoc-te,17966325,"Death Of Money",416000,416000,0,0
TIKI,cross-border-hang-quoc-te,189280644,"Túi Giả Da Đựng Chìa Khóa Xe Hơi",80000,80000,0,0
TIKI,cross-border-hang-quoc-te,144317558,"Dây đeo tay từ tính bằng thép không gỉ cho Fitbit Charge 5",298000,298000,0,0
TIKI,cross-border-hang-quoc-te,52833976,"Ghế Sofa Bọc Da PU Chống Nước",267000,267000,0,0
TIKI,cross-border-hang-quoc-te,192858530,"Máy hút bụi để bàn, Máy hút cặn bẩn, Máy hút bụi mini",385999,429333,43334,10
TIKI,cross-border-hang-quoc-te,52836696,"Đồng Hồ đeo Tay Thông Minh Bluetooth Đồng Hồ đeo Tay Cho IPhone IOS / Samsung Android",193000,193000,0,0
TIKI,cross-border-hang-quoc-te,46362167,"Tai Thay Thế Miếng Lót Đệm Tai Nghe Tai Nghe Sony MDR 1R 1RNC 1RMK2 1RBTMK2 1A Đắc 1ABT Tai Nghe",211000,211000,0,0
TIKI,cross-border-hang-quoc-te,99098001,"Bộ Chuyển Đổi 2,5 Inch SATA Sang IDE Hỗ Trợ Ổ Đĩa Cứng HDD Ata Và SSD Sang Cổng Male 44 Chân (Loại Ngang)",125000,125000,0,0
TIKI,cross-border-hang-quoc-te,52653436,"Miếng Lót Thấm Mồ Hôi Nách Có Thể Giặt Lại được",134000,134000,0,0
TIKI,cross-border-hang-quoc-te,173372266,"Sách - Fear : Essential Wisdom for Getting Through The Storm by Thich Nhat Hanh (UK edition, paperback)",496000,496000,0,0
TIKI,cross-border-hang-quoc-te,17966310,"Psycho-Cybernetics (Updated And Expanded)",507000,507000,0,0
TIKI,cross-border-hang-quoc-te,46390562,"Thực Tế Động Vật Vẹt Hình Cho Khu Vườn Nhà Tượng Bãi Cỏ Sân Trang Trí",458000,458000,0,0
TIKI,cross-border-hang-quoc-te,18011466,"Problem Solving 101",716000,716000,0,0
TIKI,cross-border-hang-quoc-te,229841217,"Bo Mạch Chủ Chuyển Đổi SATA M.2 SSD SFF-8643 22 Pins Sang NVMe M.2 NGFF",300090,300090,0,0
TIKI,cross-border-hang-quoc-te,95724909,"Túi Tam Giác Chống Nước B-Soul Treo Sườn Xe Đạp",354900,354900,0,0
TIKI,cross-border-hang-quoc-te,229797707,"Bút cảm ứng thích hợp cho máy tính bảng XiaoMi MiPad 5 Pro 11 inch NEW 2021 MiPad5 Mi Pad 5 Pro",216472,216472,0,0
TIKI,cross-border-hang-quoc-te,170641406,"Sách - Dear Mr. Henshaw by Beverly Cleary (US edition, paperback)",276000,276000,0,0
TIKI,cross-border-hang-quoc-te,112015498,"Quần lót đi xe đạp leo núi cho nữ có đệm thoáng khí 3D-Màu đen-Size",218200,218200,0,0
TIKI,cross-border-hang-quoc-te,46352995,"12X Cotton Kẻ Sọc Khăn Tay Mềm Mại Túi Vuông Khăn Dành Cho Nữ",223000,223000,0,0
TIKI,cross-border-hang-quoc-te,17970353,"Jony Ive (Backlist)",413000,413000,0,0
TIKI,cross-border-hang-quoc-te,53376925,"Pipet Tốt Nghiệp Thủy Tinh Với Nắp Cao Su Phòng Thí Nghiệm Hóa Học Nhỏ Giọt",142000,142000,0,0
TIKI,cross-border-hang-quoc-te,174400108,"Sách - Red, White and Royal Blue by Casey McQuiston (UK edition, paperback)",400000,400000,0,0
TIKI,cross-border-hang-quoc-te,11779524,"Allegiant: Divergent #3",366000,366000,0,0
TIKI,cross-border-hang-quoc-te,169845107,"50 PACK M6 CAGE NUTS WASHER for RACK MOUNT DATA CABINETS 20mm THREAD",264000,264000,0,0
TIKI,cross-border-hang-quoc-te,17968994,"Inward",441000,441000,0,0
TIKI,cross-border-hang-quoc-te,171677867,"Bluetooth Headphones Wireless Bluetooth 5.0 Headphones In Ear Earphones With 400mAh Charging Box, Built-in Microphone",59000,59000,0,0
TIKI,cross-border-hang-quoc-te,95714412,"Tay Nắm Cần Số Xe Hơi Hình Chữ Nhật Đính Pha Lê",378300,378300,0,0
TIKI,cross-border-hang-quoc-te,98031235,"Chân Đế Loa Có Giá Đỡ Bằng Hợp Kim Nhôm Cho Amazon Echo Show 8, Nằm Ngang",422000,422000,0,0
TIKI,cross-border-hang-quoc-te,46411471,"14*12*5 Cm Trẻ Em Nhựa Mô Hình Khủng Long Biến Dạng Thành Một Quả Trứng Đồ Chơi",142000,142000,0,0
TIKI,cross-border-hang-quoc-te,177987491,"20pcs Cotton Plaid Men Handkerchief Square Decorative Suits Grid Hanky",354000,354000,0,0
TIKI,cross-border-hang-quoc-te,111067634,"Máy tính bảng vẽ đồ họa chuyên nghiệp Huion H420 với 3 phím tắt 2048 mức Độ nhạy áp lực Bút 4000LPI",703000,703000,0,0
TIKI,cross-border-hang-quoc-te,97487911,"Man's Silky soft Solid  Brief Men's Underwear S M L XL - XL",100000,100000,0,0
TIKI,cross-border-hang-quoc-te,150064542,"Hộp Đựng Ổ Cắm Điện Chống Bụi Đa Năng",298455,298455,0,0
TIKI,thoi-trang-nam,188794495,"Bộ bơi nam cộc tay quần sooc đùi thể thao khỏe khoắn, chất bơi thun lạnh Spandex cao cấp dày đẹp, co giãn đa chiều | BN011",480000,480000,0,0
TIKI,thoi-trang-nam,162162250,"QUẦN KAKI NAM TÚI MỸ DÁNG SUÔNG",140000,140000,0,0
TIKI,thoi-trang-nam,87056067,"BỘ QUẦN ÁO THỂ THAO , bộ quần áo nam ,BỘ ĐỒ NAM CHẤT THUN LẠNH MÀU ĐEN , ĐỎ , TRẮNG",97000,97000,0,0
TIKI,thoi-trang-nam,115101947,"quần baggy nam dài ống côn chất đũi mềm mại nhiều màu",85000,85000,0,0
TIKI,thoi-trang-nam,188382161,"Áo sơ Mi, Áo sơ Mi Nam dài tay, chất liệu Cotton cao cấp có giãn, mát mẻ, thấm mồ hôi, không nhăn, không nhàu,mã N35",199000,199000,0,0
TIKI,thoi-trang-nam,91640238,"Bộ bơi nam dài tay cao cấp, tay phối họa tiết cá tính, chất bơi chuyên dụng co giãn tốt, dày dặn đẹp, có mẫu nữ để mặc đôi | BN020",420000,420000,0,0
TIKI,thoi-trang-nam,10083296,"Áo sơ mi caro nam tay dài cá tính - SMNHHP045",83000,83000,0,0
TIKI,thoi-trang-nam,177274778,"Áo sơ mi rộng tay dài nam nữ unisex phong cách trẻ trung hàn quốc vải lụa mềm mịn mát ít nhăn -MRD01",105000,190000,85000,45
TIKI,thoi-trang-nam,3714905,"Combo 3 Quần Lót Nam Freeman 6042-CB3 (Size",202500,225000,22500,10
TIKI,thoi-trang-nam,117918797,"Áo phông nam nữ unisex form rộng tay lỡ thun teen cổ tròn oversize cotton giá rẻ basic đen trắng tee pull SENSOLIST",53000,53000,0,0
TIKI,thoi-trang-nam,118985353,"Áo polo nam ADINO màu xanh đen vải cotton co giãn thiết kế basic trẻ trung PL42",159000,318000,159000,50
TIKI,thoi-trang-nam,172006037,"Áo phông nam cổ bẻ, áo polo nam ngắn tay BAT cao cấp Chất thun cá sấu vải cotton 100% co giãn 4 chiều cực mềm mịn mát",85000,85000,0,0
TIKI,thoi-trang-nam,138414268,"Combo 3 Quần Lót Nam NOVELTY Chất Liệu Polyamide Mềm Mại Thoáng Mát Dễ Chịu Co Giãn Thoải Mái",209000,477000,268000,56
TIKI,thoi-trang-nam,72469860,"Áo sơ mi nam công sở cao cấp dài tay màu trắng đẹp chất lụa form slìmit thời trang Hàn Quốc chất lụa không nhăn mềm mại màu trắng đen ôm dáng đẹp hàng VNXK, Sơ mi nam cao cấp công sở dài tay trắng đen",64000,64000,0,0
TIKI,thoi-trang-nam,112064344,"Combo 3 áo ba lỗ nam, áo 3 lỗ nam, sợi cotton mềm mịn, thấm hút mồ hôi tốt, thoáng mát, mặc thoải mái JAMANO",219000,297000,78000,26
TIKI,thoi-trang-nam,87110346,"Quần Lót 2 người siêu co giãn quyến rũ cho cặp đôi",47000,47000,0,0
TIKI,thoi-trang-nam,21065997,"Áo Phông Nam Trắng Trơn Chất Cotton Mát THUNTRANG59 - Thun Trắng",21000,21000,0,0
TIKI,thoi-trang-nam,14848906,"Combo 2 Áo thun basic, form unisex cho nam nữ. Áo phông hàng hiệu Goking, quà tặng cao cấp cho gia đình, cặp đôi, lớp nhóm, doanh nghiệp, người nước ngoài",259000,259000,0,0
TIKI,thoi-trang-nam,76469417,"Áo sơ mi nam cổ lãnh tụ dài tay màu xanh biển vải oxford",159000,159000,0,0
TIKI,thoi-trang-nam,104935833,"Quần short nam có túi thun cotton 100% thương hiệu Fezzio",69500,139000,69500,50
TIKI,thoi-trang-nam,86025135,"Áo khoác gió đẹp️️Áo khoác Mùa đông Nam Hàn Quốc Cao Cấp",207000,207000,0,0
TIKI,thoi-trang-nam,20818779,"Áo sơ mi nam cổ bẻ Quốc Dân dài tay viền tay áo  Hot Trend trắng",95000,95000,0,0
TIKI,thoi-trang-nam,85087388,"Áo sơ mi nam cổ tàu kẻ sọc thời trang",159000,159000,0,0
TIKI,thoi-trang-nam,186290739,"Áo Sơ Mi nam sọc caro NSMMCLMTCR210233D",303000,319000,16000,5
TIKI,thoi-trang-nam,134389875,"Quần Jogger\Quần Nỉ Ống Rộng Bo Chân Nam Nữ Unisex HIPHOP Ulzzang KUN",103000,103000,0,0
TIKI,thoi-trang-nam,20990241,"Áo sơ mi trơn tay dài",440000,440000,0,0
TIKI,thoi-trang-nam,58801338,"Áo Thun Nam Dài Tay Trơn ôm body nam hot 2020",108000,108000,0,0
TIKI,thoi-trang-nam,30764045,"Quần lót nam Khatoco Q4M075R0-VNMA011-2101-T",60000,75000,15000,20
TIKI,thoi-trang-nam,105514108,"Quần đùi nam xuất khẩu, quần mặc nhà, quần short chất vải thun 100% thương hiệu Fezzio",64500,129000,64500,50
TIKI,thoi-trang-nam,144231604,"QUẦN JEANS NAM ĐEN ZIPPER TRƠN VÀ RÁCH GỐI SKINNY - Jean dày co giãn cao cấp",175000,175000,0,0
TIKI,thoi-trang-nam,184916117,"áo may ô nam CATRIO là áo lót 3 lỗ cho bố cho ông người trung tuổi người cao tuổi từ 55kg đến 83kg, vải 100% cotton chất lượng thật, áo lót màu trắng cho nam mặc bên trong áo sơ mi, mặc ở nhà, mặc khi ngủ",59000,59000,0,0
TIKI,thoi-trang-nam,82642262,"Áo Sơ Mi Nam Ngắn Tay Ô Kẻ Thời Trang Poniva",169000,169000,0,0
TIKI,thoi-trang-nam,125355182,"Áo thun đoàn thanh niên nam nữ cổ bẻ cao cấp Ocean Uniform vải cotton thoáng mát, form dáng đẹp",115000,115000,0,0
TIKI,thoi-trang-nam,113769576,"Áo sơ mi nam màu trắng, tay ngắn, đồng phục học sinh các cấp, size từ 20-95kg, form suông, vạt bầu, thương hiệu Amazing",97000,154000,57000,37
TIKI,the-thao-da-ngoai,90951513,"Cần câu cá Daiwa Phantom Catfish Cần 2 khúc máy đứng 2m1, 2m4, 2m7, 3m0",665000,665000,0,0
TIKI,the-thao-da-ngoai,36094502," Bàn Xoay Eo Giữ Dáng Tho Gọn 360 XE11",37800,37800,0,0
TIKI,the-thao-da-ngoai,31820910,"Dụng Cụ Đánh Lửa Sinh Tồn",30960,38700,7740,20
TIKI,thoi-trang-nam,192020577,"Bộ Thể Thao Nam mùa hè mặc ở nhà chất Cotton Xốp Thái siêu xịn, Đồ Bộ Quần Áo mùa hè cộc tay BX01- PROMAN",199000,199000,0,0
TIKI,the-thao-da-ngoai,197517572,"Ghế Gấp Gọn, Ghế Xếp Giã Ngoại- Du Lịch-Cắm trại-Câu cá-YZ002",210000,210000,0,0
TIKI,thoi-trang-nam,3714885,"Combo 3 Quần Lót Nam Freeman 6041-CB3 (Size",175500,195000,19500,10
TIKI,the-thao-da-ngoai,156057567,"Bộ Cần Câu Lure 2 Khúc Đặc Ruột Siêu Bạo Lực tặng kèm Máy và Phụ kiện giá cực rẻ",114000,114000,0,0
TIKI,the-thao-da-ngoai,159482532,"Bịt tai unisex Zoggs Silicone - 300650",155000,155000,0,0
TIKI,thoi-trang-nam,164251213,"NEVER SAY LOSE, mã G43. Áo thun nam nữ siêu đẹp. Áo phông thoát nhiệt Goking hàng hiệu",168000,168000,0,0
TIKI,the-thao-da-ngoai,163776645,"Cần Câu Đài Phượng Cửu 6H Cần Câu Tay Câu Đơn Carbon Cần Câu Cá Chất Lượng",197000,197000,0,0
TIKI,thoi-trang-nam,126596446,"Áo thun cổ tròn vải xịn, form đẹp Lados - 29021, unisex, chất thun 100% cotton 4 chiều, không ra màu, không xù lông",103000,199000,96000,48
TIKI,the-thao-da-ngoai,172307441,"Áo thun thể thao nam cổ tròn LADOS - 9073 - Vải thun mát mẻ co giãn, thoải mái, mặc đi chơi, tập gym, dạo phố",189000,189000,0,0
TIKI,the-thao-da-ngoai,149617802,"Lưỡi Lục Chân Đồng, Lưỡi Câu Lục Tỳ, Lưỡi Câu Lục Bềnh Hàng Thửa",30000,30000,0,0
TIKI,the-thao-da-ngoai,154929360,"Hạt chặn phao Silicon Trong suốt hạt chặn phao câu đài cao cấp PK-26",7800,7800,0,0
TIKI,the-thao-da-ngoai,81609916,"Nón Bơi Silicone UNISEX SPEEDO",195000,195000,0,0
TIKI,the-thao-da-ngoai,73498108,"Dây câu lươn kèm sẵn 2 lưỡi",26000,26000,0,0
TIKI,the-thao-da-ngoai,46689768,"Vợt vớt cá -  Chất liệu inox cao cấp VVC01",129000,129000,0,0
TIKI,the-thao-da-ngoai,255430373,"[Chính hãng] Labrada | Muscle Mass Gainer (5.4kg) Sữa Tăng Cân Tăng Cơ Bổ Sung 1265 Calo, 52g Protein & Vitamin",1750000,1750000,0,0
TIKI,the-thao-da-ngoai,72928495,"Đĩa Xoay Tập Eo - Bàn Xoay Tập Eo - Đĩa Xoay Eo Giảm Cân - Bàn Xoay Eo Tập Thể Dục Hiệu Quả, dụng cụ thể dục thể thao, dụng cụ tập gym tại nhà, nhựa pvc thân thiện môi trường",36000,36000,0,0
TIKI,the-thao-da-ngoai,149602197,"Cước câu cá cước mỹ triline 500m tàng hình",50000,50000,0,0
TIKI,the-thao-da-ngoai,197047626,"[1 Đôi] Găng tay tập Gym -Dây kéo lưng NINE STUDY - Hỗ trợ Deadlift, nâng tạ, lên xà",119000,119000,0,0
TIKI,the-thao-da-ngoai,67320997,"Bó gối thể thao, băng đầu gối đệm silicone, co giãn 4 chiều, thanh trợ lực lò xo GoodFit GF513K",139000,220000,81000,37
TIKI,the-thao-da-ngoai,50872986,"Whey Protein tăng cơ giảm mỡ Prostar 100% Ultimate Nutrition - Whey Isolate cao cấp hấp thụ protein (Hũ 907g)",900000,900000,0,0
TIKI,thoi-trang-nam,2372543,"Áo thun Voga cổ tròn có tay",190000,190000,0,0
TIKI,the-thao-da-ngoai,145607056,"máy câu cá yumoshi LC 7000 máy cực khoẻ y hình ( giảm giá rẻ vô địch )",123000,123000,0,0
TIKI,the-thao-da-ngoai,102154941,"Thảm Tập Yoga TPE 2 Lớp PEAFLO Cao Cấp dày 6mm Kèm Túi",119000,195000,76000,39
TIKI,the-thao-da-ngoai,141299052,"Bóng Chuyền Da PU Gentra 4600 - Tặng bơm, kim bơm, túi lưới - Quả bóng chuyền tiêu chuẩn thi đấu",194000,194000,0,0
TIKI,the-thao-da-ngoai,90624576,"Xà cạp bó ống quần chống côn trùng, chuyên đi phượt, đi rừng",19000,19000,0,0
TIKI,the-thao-da-ngoai,138736880,"Mồi cá giả Minow có bi siêu nhạy ",12200,12200,0,0
TIKI,the-thao-da-ngoai,2282577,"Bộ 3 Bình Xăng Zippo (125ml)",300000,300000,0,0
TIKI,the-thao-da-ngoai,66164751,"Dây kéo đàn hồi 4 ống cao su tập thể dục REXCHI ( Màu Ngẫu Nhiên )- Hàng chính hãng",99000,99000,0,0
TIKI,the-thao-da-ngoai,174331306,"Chì Câu Cá Tròn Xuyên Tâm Đủ Size 3g,7g,10g PK-7 Chuyên Dùng Câu Mọi Mặt Trận Có Nước Và Cá",6700,6700,0,0
TIKI,thoi-trang-nam,34964186,"Áo phông cổ bẻ Goking, form unisex cho nam nữ, công ty, đội nhóm, đồng phục cao cấp. Áo thun polo cá sấu hàng hiệu xuất khẩu",138000,138000,0,0
TIKI,the-thao-da-ngoai,49675062,"Lều trại du lịch tự bung 1 cửa có lớp màn chống muỗi BS",187699,187699,0,0
TIKI,the-thao-da-ngoai,273124562,"gậy lò xo tập cơ tay 7kg cho trẻ em - thanh lò xo tập cơ tay 7kg cho bé - gậy lò xo 7kg trẻ em - Chính hãng dododios",39000,39000,0,0
TIKI,the-thao-da-ngoai,163719002,"Dây Tập Thể Dục Đa Năng Tại Nhà 5 Lò Xo",102977,102977,0,0
TIKI,the-thao-da-ngoai,2282573,"Bộ 4 Bình Xăng Zippo (125ml)",380000,380000,0,0
TIKI,the-thao-da-ngoai,257861645,"Ghế tập bụng cong muse - Ghế Tập cơ Bụng,Máy tập bụng, Ghế tập lực , máy gập cơ bụng (hàng nhập khẩu)",659000,1040000,381000,37
TIKI,the-thao-da-ngoai,166088838,"Giày đá bóng sân cỏ nhân tạo, giày đá bóng X19.1 TF, khâu toàn bộ đế",245000,245000,0,0
TIKI,the-thao-da-ngoai,70661377,"Bộ 2 Đòn Tạ Tay 35cm Bọc Cao Su Cao Cấp Đại Nam Sport",319000,500000,181000,36
TIKI,the-thao-da-ngoai,194483881,"Đèn Bão Cắm Trại Dã Ngoại Phong Cách Cổ Điển Pin Sạc - Đèn Du Lịch Tích Điện",129000,129000,0,0
TIKI,the-thao-da-ngoai,47275093,"Bộ cần câu - Cần câu cá kèm máy NL Máy 4000 - Kèm nhiều phụ kiện CM401",289000,289000,0,0
TIKI,the-thao-da-ngoai,58904616,"Giầy Bóng Đá Bata tau",109900,109900,0,0
TIKI,the-thao-da-ngoai,138323525,"Combo 2 Bánh tạ gang 5kg , nơi bán bánh tạ gang giá rẻ",320000,320000,0,0
TIKI,the-thao-da-ngoai,17615770,"Thảm Yoga miDoctor Dày 6mm + Bao Thảm Yoga +Dây Buộc Thảm Yoga (Giao màu ngẫu nhiên)",109000,109000,0,0
TIKI,the-thao-da-ngoai,141624280,"Vợt Cá Inox Vành Tròn Gấp Gọn Mắt Lưới Nhỏ Chuyên Vớt Cá To Cá Bé KK-4",82050,82050,0,0
TIKI,dien-tu-dien-lanh,459524,"Máy Nước Nóng Ferroli Divo SDN 4.5S (4500W) - Hàng Chính Hãng",1929000,1929000,0,0
TIKI,dien-tu-dien-lanh,46614660,"Điều khiển dành cho tivi sony tìm kiếm giọng nói RMF-TX300P",198000,198000,0,0
TIKI,dien-tu-dien-lanh,76366460,"Đầu thu kỹ thuật số DVB T203 HD VNPT Technology chính hãng",349000,349000,0,0
TIKI,dien-tu-dien-lanh,115679935,"Giá treo tivi 50-65 inch",170500,170500,0,0
TIKI,dien-tu-dien-lanh,126702016,"Remote Điều khiển từ xa điều hòa dành cho Panasonic các dòng Panasonic CU/CS- 9000BTU 12000BTU 18000BTU 1 chiều 2 chiều Inverter",42000,42000,0,0
TIKI,dien-tu-dien-lanh,193670855,"jack truyền hình cáp,truyền hình số,truyền hình vệ tinh đủ loại số lượng mỗi loại một con",3900,3900,0,0
TIKI,dien-tu-dien-lanh,62754437,"Giá treo ti vi có tay kéo XOAY TRÁI PHẢI NBP6- 2021 cho ti vi 45 -75 inch (Northbayou VIỆT NAM phân phối chính hãng )",356000,356000,0,0
TIKI,dien-tu-dien-lanh,102088301,"Máy Nước Nóng Gián Tiếp Ariston Vitaly 15L Hàng chính hãng",1739000,1739000,0,0
TIKI,dien-tu-dien-lanh,11510490,"Điều Khiển Remote Bluetooth G20S, Tìm Kiếm Giọng Nói, có chuột bay, Air Mouse Remote Voice - Hàng Nhập Khẩu",126000,155000,29000,19
TIKI,dien-tu-dien-lanh,174369476,"REMOTE ĐIỀU KHIỂN SMART TIVI LG MODEL 2021, ANMR21, MR21GA – HÀNG CHÍNH HÃNG",595000,595000,0,0
TIKI,dien-tu-dien-lanh,114696020,"Băng quấn bảo ôn, Simili cuốn ống cách nhiệt, băng quấn ống",15000,15000,0,0
TIKI,dien-tu-dien-lanh,230368598,"Máy Nước Nóng Ariston SL2 20 LUX WIFI (2500W)",3799000,3799000,0,0
TIKI,dien-tu-dien-lanh,162736008,"Máy sấy Electrolux 8.5 kg EDS854N3SB - Chỉ giao Hà Nội",10890000,10890000,0,0
TIKI,dien-tu-dien-lanh,6524737,"Tủ lạnh Samsung Inverter 280 lít RB27N4010S8/SV",8549000,8549000,0,0
TIKI,dien-tu-dien-lanh,126702197,"Điều khiển tivi dành cho Panasonic  tivi dầy,LCD cổ",33250,35000,1750,5
TIKI,dien-tu-dien-lanh,34465326,"REMOTE ĐIỀU KHIỂN TIVI ĐA NĂNG",61900,61900,0,0
TIKI,dien-tu-dien-lanh,126701921,"Remote Điều khiển TV dành cho Samsung giọng nói",155000,155000,0,0
TIKI,dien-tu-dien-lanh,459562,"Máy Nước Nóng Gián Tiếp FERROLI QQ EVO 30L M (2500W) - Hàng Chính Hãng",2395000,2395000,0,0
TIKI,dien-tu-dien-lanh,112944289,"Đế treo dành cho remote máy lạnh ",15000,15000,0,0
TIKI,dien-tu-dien-lanh,169277333,"GIÁ TREO TIVI DI ĐỘNG 3 CHÂN 32-60 INCH",399000,399000,0,0
TIKI,dien-tu-dien-lanh,270651284,"Remote TV Điều Khiển Dành Cho SAMSUNG Internet Smart Tivi BN59-01178F",48000,48000,0,0
TIKI,dien-tu-dien-lanh,119054153,"điều khiển điều hoà dành cho panasonic/ remote máy lạnh panasonic/ điều hoà/ điều khiển điều hoà panasonic/ remote panasonic/ remote panasonic 2 chiều inverter",46000,46000,0,0
TIKI,dien-tu-dien-lanh,56317627,"Tủ Đông Inverter LG GN-F304PS (165L) - Hàng chính hãng - Chỉ giao tại Hà Nội",7200000,7200000,0,0
TIKI,dien-tu-dien-lanh,75626438,"ANTEN KHUẾCH ĐẠI HOÀNH KIẾN ĐẠT MODEL H7,HÀNG CHÍNH HÃNG.",99000,99000,0,0
TIKI,dien-tu-dien-lanh,271848173,"Remote Điều Khiển Dành Cho Tivi SHARP Nhận Giọng Nói Android Smart TV GB326WJSA GB345WJSA GB346WJSA",98000,98000,0,0
TIKI,dien-tu-dien-lanh,91100406,"Remote Điều Khiển Giọng Nói Smart TV, Tivi Thông Minh Dành Cho SONY BRAVIA RMF-TX310P",165000,165000,0,0
TIKI,dien-tu-dien-lanh,144684151,"[Rẻ vô địch] Remote Điều khiển từ xa điều hòa Daikin-Dùng cho các dòng ATKA ATKQ ATKC ATF FTHF FTC FTV FTKQ Tặng kèm Pin",77000,77000,0,0
TIKI,dien-tu-dien-lanh,46695151,"Điều khiển tivi tìm kiếm giọng nói dành cho sam@sung 2020",185000,185000,0,0
TIKI,dien-tu-dien-lanh,4175491,"Máy Nước Nóng Ferroli VERDI 30L AE (2500W)",2698000,2698000,0,0
TIKI,dien-tu-dien-lanh,154496269,"Mạch điều khiển quạt từ xa v1",45000,45000,0,0
TIKI,dien-tu-dien-lanh,153535636,"Remote điều khiển tất cả máy lạnh nội địa Nhật, Việt Nam",32000,32000,0,0
TIKI,dien-tu-dien-lanh,76394751,"DÂY ANTEN DÙNG CHO ĐẦU THU KỸ THUẬT SỐ HOẶC TIVI KỸ THUẬT SỐ CÓ 2 ĐẦU RẮC SẴN NHƯ HÌNH",39000,39000,0,0
TIKI,dien-tu-dien-lanh,174371501,"REMOTE ĐIỀU KHIỂN INTERNET TIVI LG  – HÀNG CHÍNH HÃNG",240000,240000,0,0
TIKI,dien-tu-dien-lanh,172360156,"Anten trong nhà, để bàn chất lượng cao, bắt sóng siêu khoẻ",99000,99000,0,0
TIKI,dien-tu-dien-lanh,23467038,"TỦ LẠNH FUNIKI HÒA PHÁT FR - 71CD- Hàng Chính Hãng",2535000,2630000,95000,4
TIKI,dien-tu-dien-lanh,120218600,"Remote Điều Khiển Tivi Giọng Nói Dành Cho SONY Smart TV RMF-TX500P",260000,260000,0,0
TIKI,dien-tu-dien-lanh,184488225,"Hộp lạnh di động Chính hãng Kemin K1 Pin 10400mah- Bảo quản Insulin, vacxin, thuốc, filer,botox- Tặng kèm túi đeo",2691000,2950000,259000,9
TIKI,dien-tu-dien-lanh,55543490,"Remote Điều Khiển Cho Smart TV, Internet TV, TV Thông Minh SAMSUNG BN59-01268D (Kèm Pin AAA Maxell)",36900,36900,0,0
TIKI,dien-tu-dien-lanh,20959740,"Điều khiển từ xa dùng cho điều hòa SHARP A1",49000,49000,0,0
TIKI,dien-tu-dien-lanh,94857614,"Chuyển hướng gió bằng sắt hoặc nhựa cao cấp, mặt nạ dành cho cục nóng điều hoà",255000,255000,0,0
TIKI,giay-dep-nam,82858419,"Giày Tây Nam Công Sở Happyshoes Da Bò Thật Vân Cá Sấu HS19",650000,650000,0,0
TIKI,giay-dep-nam,207510922,"Giày hở gót nam cao cấp giá đẹp thị trường S001",159000,159000,0,0
TIKI,giay-dep-nam,135852529,"Giày lười nam da bóng chuông màu đen tăng chiều cao 3cm gea giày tây nam trẻ trung cao cấp da thật - Mã GEADLM01",199000,199000,0,0
TIKI,giay-dep-nam,161404101,"Dép kẹp nam và nữ đế trắng quai trắng phối màu",82999,82999,0,0
TIKI,giay-dep-nam,141767983,"Dép quai ngang nam Đông Hải chất da bò cao cấp với thiết kế đơn giản, tiện dụng - D1103",650000,650000,0,0
TIKI,giay-dep-nam,168955221,"Dép Da Nam Thời Trang Đế Cao Su Đúc Nguyên Khối Cao Cấp-DDTT",109000,109000,0,0
TIKI,giay-dep-nam,57890643,"Giày mọi nam Trường Hải màu đen bò da bò thật cao cấp không bong tróc đế cao su chống mòn không trơn GMTH096",507000,599000,92000,15
TIKI,giay-dep-nam,41335268,"Giày Da Nam Cao Cấp Germano Bellesi Italia_GB 1317",8880000,8880000,0,0
TIKI,giay-dep-nam,88818771,"Giày lười giày mọi nam da bóng kiểu dáng hàn quốc đai én",210000,210000,0,0
TIKI,giay-dep-nam,33053104,"Giày lười nam",1700000,1700000,0,0
TIKI,giay-dep-nam,176896414,"Giày tây nam công sở cao cấp GT111 Manzo store",180000,180000,0,0
TIKI,giay-dep-nam,125271467,"Giày Da nam cực chất xả kho giá gốc - giày lười nam x076",210000,210000,0,0
TIKI,giay-dep-nam,198353931,"Giày lười (sục) nam da mềm đế cao su được khâu chắc chắn, dễ phối đồ (màu đen)",240000,240000,0,0
TIKI,giay-dep-nam,19750669,"Giày Lười Vải Nam Happyshoes HPS001",150000,150000,0,0
TIKI,giay-dep-nam,176896373,"Giày Oxford nam cao cấp - Giày công sở da bò sang trọng - MANZO LUX 104 - Manzo Store",180000,180000,0,0
TIKI,giay-dep-nam,149410045,"Giày lười công sở da cao cấp ChristinA-Q GNA368",1199000,1199000,0,0
TIKI,giay-dep-nam,207508680,"Giày hở gót nam da Pu phong cách trẻ trung lịch lãm mã S002",159000,159000,0,0
TIKI,giay-dep-nam,115576332,"Giày Da Nam Buộc Dây, Da Bò Bảo Hành 12 Tháng Mã MBH02",500000,1000000,500000,50
TIKI,giay-dep-nam,261960384,"Giày Sneaker Converse Chuck Taylor All Star Seasonal Color - 1J793C",1550000,1550000,0,0
TIKI,giay-dep-nam,129942758,"Giày nam nữ Converse cổ cao màu trắng cổ điển Chuck Taylor All Star Classic - 121184C / M7650C",1550000,1550000,0,0
TIKI,giay-dep-nam,59395267,"Giày 101 thể thao nam phong cách mạnh mẽ trẻ trung năng động",199000,369000,170000,46
TIKI,giay-dep-nam,119287919,"Dép Nam Quai Ngang TiTi ĐÔ Da Bò Thật Cao Cấp DNA2118a",380000,380000,0,0
TIKI,giay-dep-nam,113779677,"Dép Bít Mũi Nam HÀ NAM Da Bò Thật Cao Cấp GSB2089",460000,460000,0,0
TIKI,giay-dep-nam,66628606,"Giày lười da bò thật nam cao cấp trang trọng, lịch lãm mã 8836",599000,799000,200000,25
TIKI,giay-dep-nam,49614118,"Giày Da Nam Công Sở Da Bò Thật Vân Cá Sấu - HS52",648000,648000,0,0
TIKI,giay-dep-nam,129352209,"Dép Vento Quai Ngang Thời Trang AD22",205000,205000,0,0
TIKI,giay-dep-nam,10047160,"Dép Xỏ Ngón Nam BIGGBEN Da Bò Thật DK30",400000,400000,0,0
TIKI,giay-dep-nam,100869043,"Giày Da Nam Buộc Dây Da Bò Đế Khâu Mã BH-730",650000,1300000,650000,50
TIKI,giay-dep-nam,175886036,"Dép Quai Ngang Nam Mẫu Mới KEEDO-KD2809 - Đen",480000,480000,0,0
TIKI,giay-dep-nam,55457002,"Giày tây nam Trường Hải không dây da bò  thật màu đen mềm mại đế cao su không trơn may chắc chắn GT810",436000,515000,79000,15
TIKI,giay-dep-nam,20507532,"Bộ 3 dụng cụ xỏ giày cao cấp - Hàng nội địa Nhật",127000,127000,0,0
TIKI,giay-dep-nam,109787786,"Giày tây nam da bóng Đồ Da Thành Long 20393",469000,469000,0,0
TIKI,giay-dep-nam,124244266,"Dép Massage khảm đá Bấm huyệt bàn chân trên gỗ tự nhiên, Bấm Huyệt chân Giảm căng thẳng mệt mỏi cao câpz",175000,175000,0,0
TIKI,giay-dep-nam,271520629," Giày Mọi Màu Trắng Da Thật MR08 Giày Lười Trắng Mềm Êm Chân Giày SAGO’S Bảo hành 12 tháng",691000,691000,0,0
TIKI,giay-dep-nam,167931335,"Giày Lười Nam Công Sở Da Bóng Cao Cấp Quai Vàng dập vân, Giày Nam giá Rẻ,đê khâu - Giảm 5",160000,160000,0,0
TIKI,giay-dep-nam,249719045,"Giày Tây Nam Cao Cấp Kiểu Dáng Oxford Brogues Đế Phíp, Da Bò Thật, Thiết Kế Họa Tiết Sang Trọng SCC-03",892000,892000,0,0
TIKI,giay-dep-nam,115680579,"Giày Lười Nam Da Bò Đế Khâu, Kiểu Giày Mọi Mã MGL66-L",450000,900000,450000,50
TIKI,giay-dep-nam,164042031,"giày da nam cổ cao... đế cao su chất liệu da bò nguyên tấm Giày, bốt nam cổ cao Da Bò",610000,610000,0,0
TIKI,giay-dep-nam,24240414,"Giày sandal nam Việt Thủy quai ngang VT02 - đen",199000,199000,0,0
TIKI,giay-dep-nam,127580930,"Giày Doc.588 lửng da bò nguyên tấm",669000,669000,0,0
TIKI,giay-dep-nu,73120993,"IÀY BÚP BÊ TRƯỜNG HẢI DA BÒ MỀM MÀU VÀNG BÒ SANG TRỌNG MŨI GIÀY TRÒN, ĐẾ MỀM DẺO BÊN CHẮC VÀ THỜI TRANGBB025",217000,289000,72000,25
TIKI,giay-dep-nu,252596684,"Giày búp bê mũi tròn trơn da bò mềm mại Trường Hải GBB118 có 2 màu đen, đỏ",241000,285000,44000,15
TIKI,giay-dep-nu,252563249,"Giày Nữ Đế Xuồng 5cm Da Bò Màu Đen Trường Hải DX115Đ",285000,285000,0,0
TIKI,giay-dep-nu,252596105,"Giày búp bê trơn da bò mũi vuông Trường Hải có 2 màu xanh ,đen GBB115",241000,285000,44000,15
TIKI,giay-dep-nu,213724172,"Giày búp bê da bò mũi tròn Trường Hải đính nơ xinh da mềm mại GBB110",259000,299000,40000,13
TIKI,giay-dep-nu,108747100,"Chai xịt giày khử mùi hôi giày hôi chân Nano Xclean For Shoes 100ml - Hương Trà Xanh - Nano Bạc AHT Corp (AHTC)",59000,99000,40000,40
TIKI,giay-dep-nu,43118520,"Bộ 2 cặp lót giày 4D bảo vệ gót chân và chống tuột gót giày (loại vuông) - buybox - BBPK53",30000,60000,30000,50
TIKI,giay-dep-nu,254903581,"Giày Sục nữ da bò đế xuồng 5cm mũi nhọn màu xanh đen Trường Hải S129 CÓ SIZE LỚN",261000,299000,38000,13
TIKI,giay-dep-nu,32726343,"2 cặp miếng lót giày cao gót mũi tròn cho giày bị rộng, giúp giảm size cao cấp - buybox - BBPK11",70000,140000,70000,50
TIKI,giay-dep-nu,20117907,"Bộ 02 cặp gồm 04 miếng lót gót giày silicon chống trầy bảo vệ gót chân, giảm size giày",16999,16999,0,0
TIKI,giay-dep-nu,110140477,"Giày đi mưa giày đi biển chống trơn trượt đế bằng phù hợp cho mùa hè V283",59000,59000,0,0
TIKI,giay-dep-nu,133617832,"Dép Đi Trong Nhà, Căn Hộ Chung Cư, Văn Phòng, Nhà Tắm Siêu Êm Chống Trơn Trượt Mẫu Mới",95000,140000,45000,32
TIKI,giay-dep-nu,103940142,"5 Cặp miếng lót bảo vệ chân khi đi giày cao gót",47000,59000,12000,20
TIKI,giay-dep-nu,209305648,"Dép Lông Bông Plush Đi Trong Nhà, Phòng Ngủ - Hàng Chính Hãng",87400,95000,7600,8
TIKI,giay-dep-nu,200519451,"Giày búp bê  da bò mũi tròn màu xám đính nơ Trường Hải da mềm mại BB130",253000,299000,46000,15
TIKI,giay-dep-nu,105159478,"Chai Xịt Khử Mùi Giày Nano Xclean Nano Bạc 100ml AHT Corp Hương Bạc Hà - Khử Mùi, Diệt Khuẩn, Làm Sạch Giày Dép Hiệu Quả An Toàn",42000,99000,57000,58
TIKI,giay-dep-nu,28590683,"Miếng lót giảm size cho giày bị rộng Cao Cấp - buybox - BBPK11",35000,70000,35000,50
TIKI,giay-dep-nu,158631445,"Dép Đi Trong Nhà Cói Mây Đế Cao Su Chống Trơn, Thoáng Mát Mã DP07",49000,49000,0,0
TIKI,giay-dep-nu,161943939,"Dép Quai Ngang Nam Nữ Siêu Nhẹ Tăng Chiều Cao Chống Trơn DP02",75000,75000,0,0
TIKI,giay-dep-nu,177164437,"Giày Lười Nữ NATIVE AD Jericho",1400000,1400000,0,0
TIKI,giay-dep-nu,252563621,"Giày Đế Xuồng nữ 5cm Da Bò khóa vuông Màu Đen Trường Hải DX116Đ",241000,285000,44000,15
TIKI,giay-dep-nu,206123708,"Giày thể thao nam nữ phong cách mới – G1009NY",874000,1960000,1086000,55
TIKI,giay-dep-nu,28731166,"2 cặp lót giày chống tuột gót, chống trầy gót cực êm chân - buybox - BBPK09",45000,60000,15000,25
TIKI,giay-dep-nu,205299054,"Chai xịt tạo bọt vệ sinh giày cao cấp, chất tẩy rửa giày, làm sạch, trắng sáng và khử mốc giày hiệu quả - Hàng chính hãng",47000,55000,8000,15
TIKI,giay-dep-nu,63145867,"Giày Thể Thao Nữ Màu Trắng Bằng Da Không Bong Tróc Đế Cao 4cm, Đế Êm Nhẹ, phù hợp đi chơi đi làm đi học , vận động bảo vệ đôi chân tránh tổn thương S352",299000,350000,51000,15
TIKI,giay-dep-nu,71027758,"Giày sneaker thể thao nữ hàn quốc buộc dây siêu nhẹ V254",55000,55000,0,0
TIKI,giay-dep-nu,184955659,"Lót giày Mizuno chính hãng",80000,80000,0,0
TIKI,giay-dep-nu,140573000,"Dép Bông Đi Trong Nhà Đế Cao Su Đúc Cao Cấp LACEVA DP95",99000,99000,0,0
TIKI,giay-dep-nu,120970633,"Dép Nữ Gấu Trúc Cực Cute, Dép Nữ Thời Trang Chống Trơn Mã DP06",89000,89000,0,0
TIKI,giay-dep-nu,108747100,"Chai xịt giày khử mùi hôi giày hôi chân Nano Xclean For Shoes 100ml - Hương Trà Xanh - Nano Bạc AHT Corp (AHTC)",59000,99000,40000,40
TIKI,giay-dep-nu,184910652,"Dép bánh mì Cross nữ đế 6cm siêu nhẹ kèm Sticker dễ thương - dép nữ hot trend 2022",104500,110000,5500,5
TIKI,giay-dep-nu,90519531,"Giày thể thao nữ ZAVAS đế cao 3cm màu trắng bằng da không bong tróc mang êm chân S411 - Giày Sneaker Nữ Chính Hãng",349000,420000,71000,17
TIKI,giay-dep-nu,21040605,"Combo 2 Bộ Miếng Dán Đế Giày Chống Trơn Trợt (4 Miếng Dán)",30000,30000,0,0
TIKI,giay-dep-nu,92161380,"Chai xịt giày diệt khuẩn khử mùi hôi giày hôi chân nano bạc Nano Xclean For Shoes",39000,60500,21500,36
TIKI,giay-dep-nu,43126126,"Bộ 2 cặp lót giày 4D bảo vệ gót chân và chống tuột gót giày (loại bầu) - buybox - BBPK54",30000,60000,30000,50
TIKI,giay-dep-nu,197643943,"Giày công sở nữ, giày cao gót HT.NEO gót vuông 5p chất liệu da cao cấp, đi cực êm chân, thoải mái, giày được thiết kế trẻ trung với khuy CD CS256",435000,900000,465000,52
TIKI,giay-dep-nu,54354661,"Combo 4 miếng lót đế giày tăng chiều cao Air có đệm khí siêu êm ái, giày đế cao, giày độn gót GD233-LGIAYTCC",61000,61000,0,0
TIKI,giay-dep-nu,103879065,"Dép quai ngang nam nữ, dép đi trong nhà, dép văn phòng siêu êm đúc nguyên khối, dép bánh mì, dép lê siêu nhẹ - Hàng nhập khẩu",43000,43000,0,0
TIKI,giay-dep-nu,86860057,"Giày Sandal Cao Gót Da Bò BIGGBEN Cao 5 Phân SDCG60",299000,550000,251000,46
TIKI,giay-dep-nu,252597179,"Giày búp bê đế bằng da bò trơn Trường Hải da mềm GBB120 có 2 màu đen, trắng",241000,285000,44000,15
TIKI,giay-dep-nu,92161380,"Chai xịt giày diệt khuẩn khử mùi hôi giày hôi chân nano bạc Nano Xclean For Shoes",39000,60500,21500,36
TIKI,giay-dep-nu,162027539,"Dép Đi Trong Nhà, Văn Phòng, Nhà Tắm Chống Trơn Đúc Liền DP03",85000,85000,0,0
TIKI,giay-dep-nu,128086059,"NÚT BẢO VỆ GÓT GIÀY CAO GÓT DẠNG BÚT TRÒN NHIỀU SIZE KHÁC NHAU",19000,19000,0,0
TIKI,giay-dep-nu,73989137,"Giày thể thao sneaker nữ màu trắng đế êm nhẹ thoáng khí thương hiệu ZAVAS - S393 - Hàng chính hãng",349000,360000,11000,3
TIKI,giay-dep-nu,105159478,"Chai Xịt Khử Mùi Giày Nano Xclean Nano Bạc 100ml AHT Corp Hương Bạc Hà - Khử Mùi, Diệt Khuẩn, Làm Sạch Giày Dép Hiệu Quả An Toàn",42000,99000,57000,58
TIKI,giay-dep-nu,70175132,"Dép Đi Trong Nhà Chống Trơn Trượt Phong Cách Hiện Đại, Sang Trọng YORN - Hàng Nhập Khẩu",39000,39000,0,0
TIKI,giay-dep-nu,31593583,"Lót mũi giày cao gót cao su non đệm êm ngón chân - buybox - BBPK50",25000,50000,25000,50
TIKI,giay-dep-nu,68857080,"Dép đi nhà tắm, trong nhà chống trơn kiểu mới Hàn Quốc ghép hình",27500,55000,27500,50
TIKI,giay-dep-nu,32859444,"Lót giày cao gót chống rộng, chống trầy gót cực êm chân cao cấp- buybox - BBPK09",25000,40000,15000,38
TIKI,giay-dep-nu,73988252,"Giày thể thao sneaker nữ màu đen đế êm nhẹ thoáng khí thương hiệu ZAVAS - S392 - Hàng chính hãng",349000,360000,11000,3
TIKI,giay-dep-nu,88979578,"[Ảnh Thật] Dép Quai Ngang, Dép Đi Trong Nhà, Ngoài Trời Họa Tiết Cá Sấu Siêu Dễ Thương, Logo Nổi. Form Nhỏ Các Bạn Đặt Tăng 1 Size Nha Mã DP19",89000,89000,0,0
TIKI,giay-dep-nu,197419814,"Giày Sandal Nữ Đế Xuồng BIGGBEN Da Bò Cao Cấp SDX11",329000,450000,121000,27
TIKI,giay-dep-nu,180999168,"Dép Bánh Mì Nữ Nam EVA Cao Cấp Đế Cao Mát xa Siêu Nhẹ Siêu Bền",48000,48000,0,0
TIKI,giay-dep-nu,107801529,"Cặp Lót Gót Giày XIMO XC03 Chống Rộng, Chống Nhấc Gót và Bảo Vệ Gót Tránh Trầy Xước",12000,21600,9600,44
TIKI,giay-dep-nu,71680262,"Giày nhựa đi mưa chịu nước chống trơn trượt dáng búp bê công sở V258",55000,55000,0,0
TIKI,laptop-may-vi-tinh-linh-kien,56719923,"Quạt tản nhiệt, Fan Case Led RGB Coolmoon V5 - Hàng Chính Hãng",85000,85000,0,0
TIKI,laptop-may-vi-tinh-linh-kien,198571398,"Ổ cứng SSD di động Kingston XS2000 1TB - SXS2000/1000G - Hàng Chính Hãng",2999000,2999000,0,0
TIKI,laptop-may-vi-tinh-linh-kien,459248,"Máy In Laser Đa Năng Brother MFC-L2701D - Hàng chính hãng",5472000,5700000,228000,4
TIKI,laptop-may-vi-tinh-linh-kien,88050388,"Thanh Led RGB Aorus Rog đồng bộ Hub , Dùng độ trang trí cho VGA máy tính - hàng nhập khẩu",120000,120000,0,0
TIKI,laptop-may-vi-tinh-linh-kien,159971558,"Màn hình máy tính Dell E2422H ( 24 inch/ IPS/ Full HD/ 60Hz ) - Hàng Chính Hãng",3150000,3150000,0,0
TIKI,laptop-may-vi-tinh-linh-kien,134947044,"Laptop Dell Vostro 3400 70253900 (Core i5-1135G7/ 8GB/ 256GB SSD/ 14 FHD/ Win 11 + Office) - Hàng Chính Hãng",13850000,13850000,0,0
TIKI,laptop-may-vi-tinh-linh-kien,114211157,"Máy In Laser Màu Đơn Năng BROTHER HL-L8360CDW - Hàng Chính Hãng",10450000,10450000,0,0
TIKI,laptop-may-vi-tinh-linh-kien,561879,"Kaspersky Internet Security Cho 1 Máy Tính - KIS1U - Hàng chính hãng",279000,279000,0,0
TIKI,laptop-may-vi-tinh-linh-kien,9794165,"Máy In Canon Selphy CP1300 (Trắng) - Hàng Chính Hãng",3680000,3680000,0,0
TIKI,laptop-may-vi-tinh-linh-kien,11864859," Máy Chiếu Mini YG-300 Smart LED Độ Phân Giải 1920×1080",783750,825000,41250,5
TIKI,laptop-may-vi-tinh-linh-kien,51521510,"DrayTek Vigor2926 Hàng Chính Hãng",3720000,3720000,0,0
TIKI,laptop-may-vi-tinh-linh-kien,183262949,"Máy Chủ Server - Hàng nhập khẩu",3500000,3500000,0,0
TIKI,laptop-may-vi-tinh-linh-kien,41694647,"Máy Chiếu Mini LCD LED Projector PD300 Cao Cấp AZONE",645000,645000,0,0
TIKI,laptop-may-vi-tinh-linh-kien,179408253,"Laptop Acer Aspire 3 A315-56-38B1 i3 1005G1/4GB/256GB/15.6"FHD/Win11 - Hàng Chính Hãng",8990000,8990000,0,0
TIKI,laptop-may-vi-tinh-linh-kien,101778693,"Màn hình LCD LG 27MP60G-B.ATV 27inch FullHD 5ms 75Hz IPS - Hàng Chính Hãng",3645000,3645000,0,0
TIKI,laptop-may-vi-tinh-linh-kien,46183198,"Máy chiếu i-Projector chất lượng 1080P độ nét cao - Hàng nhập khẩu",4500000,4500000,0,0
TIKI,laptop-may-vi-tinh-linh-kien,28057130,"Card màn hình ZOTAC GAMING GeForce GTX 1650 AMP - HÀNG CHÍNH HÃNG",4970000,4970000,0,0
TIKI,laptop-may-vi-tinh-linh-kien,13758732,"Bàn Vẽ Màn Hình Tinh Thể Lỏng Kĩ Thuật Số Gaomon GM185 - Hàng nhập khẩu",6700000,6700000,0,0
TIKI,laptop-may-vi-tinh-linh-kien,161266256,"Nhân mạng, hạt ổ cắm cat5 cat6 âm tường lắp mặt âm tường chuẩn WIDE (hạt to) dành cho mặt Panasonic",66000,66000,0,0
TIKI,laptop-may-vi-tinh-linh-kien,157078205,"Màn hình LG 27MP400-B (27inch/FHD/IPS/75hz/5ms/250nits/HDMI+Dsub/Freesync) -Hàng Chính Hãng",3190000,3190000,0,0
TIKI,laptop-may-vi-tinh-linh-kien,156188433,"Bộ máy tính để bàn Vlimited chơi game trọn độ đầy đủ  Case/8G/SSD/HDD/Vga rời/Màn hình - Hàng chính hãng",4450000,4450000,0,0
TIKI,laptop-may-vi-tinh-linh-kien,61027361,"Máy chiếu Projector mini đa năng (Độ nét cao) phù hợp phòng ánh sáng yếu - Thunder",2900000,2900000,0,0
TIKI,laptop-may-vi-tinh-linh-kien,95484338,"Bộ vi sử lý Core i3 6100 / i5 6500 / i7 6700 cpu socket 1151. Tặng kèm keo tản nhiệt",1086000,1086000,0,0
TIKI,laptop-may-vi-tinh-linh-kien,80983401,"Két nước tản nhiệt 8cm kèm quạt gió 12V",195000,195000,0,0
TIKI,laptop-may-vi-tinh-linh-kien,174216794,"Laptop HP ProBook 450 G8 51X30PA (i7-1165G7/ 8GB/ 512GB SSD/ 15.6FHD/ VGA ON/ Win10/ Silver/ LEB_KB/ Vỏ nhôm) - Hàng chính hãng",36396000,36396000,0,0
TIKI,laptop-may-vi-tinh-linh-kien,3920565,"Ổ cứng SSD Western Digital Blue 3D-NAND M.2 2280 SATA III 500GB WDS500G2B0B - Hàng Chính Hãng",1650000,1650000,0,0
TIKI,laptop-may-vi-tinh-linh-kien,126091177,"Anten thu sóng 3g/4g của thiết bị Netgear- Hàng Chính Hãng ",99000,99000,0,0
TIKI,laptop-may-vi-tinh-linh-kien,44003475,"Quạt tản nhiệt CPU Jonsbo CR1200 - Hàng nhập khẩu",230000,230000,0,0
TIKI,laptop-may-vi-tinh-linh-kien,195687591,"Ổ ĐĨA DVD RW CẮM NGOÀI CHO LATOP DESTOP OS  ĐỜI MỚI 3.0 Hỗ trợ cổng Type C",350000,350000,0,0
TIKI,laptop-may-vi-tinh-linh-kien,112499909,"Máy in laser đen trắng Brother HL-B2080DW - Hàng chính hãng",4850000,4850000,0,0
TIKI,laptop-may-vi-tinh-linh-kien,142656943,"Card màn hình VGA Asus GT730-SL-2GD5 BRK - Hàng Chính Hãng",1490000,1490000,0,0
TIKI,laptop-may-vi-tinh-linh-kien,193549202,"máy in bluetooth A4-A5 cầm tay kết nối được tất cả các dòng điện thoại-latop-pc-máy tính bảng androi và ios pin lithium 30000 mah cổng sạc typec tốc độ in nhanh 20 tờ/1p nhỏ gọn tiện lợi dễ dàng mang đi sử dụng không cần đến nguồn điện 220v mực lưu 10 năm",2400000,2400000,0,0
TIKI,laptop-may-vi-tinh-linh-kien,452118,"Ổ cứng Di Động Transcend StoreJet H3B 1TB USB 3.0/3.1 - TS1TSJ25H3B - Hàng Chính Hãng",1959000,1959000,0,0
TIKI,laptop-may-vi-tinh-linh-kien,87959768,"USB Phát Wifi 4G LTE U80 – Tốc Độ 150Mb – Kết Nối 10 User",519000,519000,0,0
TIKI,laptop-may-vi-tinh-linh-kien,188007796,"[HÀNG CHÍNH HÃNG] Combo Máy in laser đơn sắc Brother HL-L2321D và 2 Mực in laser trắng đen Brother TN-2385",4144000,4144000,0,0
TIKI,laptop-may-vi-tinh-linh-kien,102901250,"Sạc dành cho Laptop Dell (Các loại) 19.5V 3.34A 65W - chân kim nhỏ ",179995,350000,170005,49
TIKI,laptop-may-vi-tinh-linh-kien,50086320,"Màn Hình Gaming Samsung LS27R350FHEXXV 27 inch FullHD 5ms 75Hz IPS - Hàng Chính Hãng",3490000,3490000,0,0
TIKI,laptop-may-vi-tinh-linh-kien,164494570,"Ram máy tính ddr4 Asgard V5 8gb Bus 3200 RGB Sync- Hàng chính hãng",1000000,1000000,0,0
TIKI,laptop-may-vi-tinh-linh-kien,179539811,"Card mở rộng ổ cứng SSD M.2 qua khe PCI-E 3.0 X16 Orico PSM2-X16 - Hàng chính hãng",133000,133000,0,0
TIKI,laptop-may-vi-tinh-linh-kien,81222214,"Bộ phát Wifi 4G Netgear Aircard AC800S - Cat9 - tốc độ 450Mbps - Phiên Bản Quốc Tế - hàng chính hãng",1881000,1980000,99000,5
TIKI,giay-dep-nam,180228967,"Máy sấy giày đa năng bằng tia cực tím cao cấp MSG01",389000,600000,211000,35
TIKI,giay-dep-nam,181454853,"Giày Mọi, giày lười, giày tây nam da mềm lịch lãm màu đen",199000,199000,0,0
TIKI,giay-dep-nam,39997426,"Dép bít mũi nam da bò cao cấp Trường Hải BM213",341000,399000,58000,15
TIKI,giay-dep-nam,20639773,"Chai vệ sinh giày dép, túi xách - 100ml",9599,9599,0,0
TIKI,giay-dep-nam,155008229,"Dép 2 Quai Ngang cao cấp KEEDO BH00505 da bò thật siêu bền",960000,960000,0,0
TIKI,giay-dep-nam,55107216,"Giày Tây Nam Da Bò BIGGBEN Cao Cấp GT172",599000,730000,131000,18
TIKI,giay-dep-nam,196849302,"Giày tây nam Pierre Cardin - PCMFWLG 758",1495000,2990000,1495000,50
TIKI,giay-dep-nam,196215025,"Giày/dép Sandal Vento DARIUS Nam màu Tro đi học/đi làm SD-NB10607",395000,395000,0,0
TIKI,giay-dep-nam,50390802,"Lót độn đế silicon nguyên khối trong suốt tăng 3cm chiều cao - buybox - BBPK47",72000,120000,48000,40
TIKI,giay-dep-nam,190537769,"Dép quai kẹp xốp Bitis nam",90000,90000,0,0
TIKI,giay-dep-nam,162994213,"Dép quai ngang Lihsing nam",429000,429000,0,0
TIKI,giay-dep-nam,122712021,"Giày Lười Da Bò Nam, Kiểu Dáng Bắt Mắt, Thiết Kế Giữ Phong Dáng, Đế Cao Su, Da Chuẩn GD19",229000,430000,201000,47
TIKI,giay-dep-nam,55085257,"Giày sandal nam Trường Hải da bò thật mềm mại màu nâu đế PU nhẹ nhàng không trơn hình ảnh thật SD0474",285000,319000,34000,11
TIKI,dien-tu-dien-lanh,197574476,"Máy Rửa Chén Độc Lập Ecalite EDW-JA6014ABUV - 14 Bộ - 9 Chương Trình Rửa - Có Rửa Diệt Khuẩn - Hàng Chính Hãng",22975500,27030000,4054500,15
TIKI,dien-tu-dien-lanh,33544944,"ANTEN CHUYÊN DÙNG CHO TIVI VÀ ĐẦU THU TRUYỀN HÌNH SỐ MẶT ĐẤT (DVB T2)",39000,39000,0,0
TIKI,dien-tu-dien-lanh,181185164,"Android Tivi Box X96 Max plus ultra S905X4 Ram 4G Rom 32G Wifi Kép Có Bluetooth Cài Sẵn Ứng Dụng Xem Phim HD Và Truyền Hình Cáp miễn phí vĩnh viễn",1510500,1590000,79500,5
TIKI,dien-tu-dien-lanh,3739003,"Máy Nước Nóng Gián Tiếp FERROLI VERDI 30L SE (2500W) - Hàng Chính Hãng",2689000,2689000,0,0
TIKI,dien-tu-dien-lanh,54723855,"Điều khiển điều hoà Panasonic Model CS-PU9VKH-8- Hàng chính hãng",399000,399000,0,0
TIKI,giay-dep-nam,176896324,"Giày Chelsea Boots cổ cao cho nam - Da bò thật 100% bảo hành 12 tháng - MANZO CHEL 101 - Manzo Store",120000,120000,0,0
TIKI,giay-dep-nam,9810961,"Giày Slip On Unisex Vans - VN000EYEBWW",1305000,1450000,145000,10
TIKI,dien-tu-dien-lanh,3819821,"Tủ Lạnh Sharp Inverter 556L SJ-FX631V-SL",15449000,15449000,0,0
TIKI,dien-tu-dien-lanh,170331227,"Đầu Android TVbox Mytv net Phiên bản Ram 2G/16G 4G/32G điều khiển IR- Xem 200 Kênh truyền hình miễn phí - Hàng Chính Hãng",695000,695000,0,0
TIKI,giay-dep-nam,31208721,"Dép nam bít mũi da bò cao cấp TH_QN054",280000,339000,59000,17
TIKI,giay-dep-nam,71693900,"Giày Tây Nam Cao Cấp Mã  BH73",550000,1100000,550000,50
TIKI,dien-tu-dien-lanh,89309727,"Smart Tivi Crystal Samsung 4K 43 inch UA43AU8100 Mới 2021",11900000,11900000,0,0
TIKI,giay-dep-nam,4418135,"Giày Chelsea Boot Tathanium Nam Màu Đen Da Lộn TFBKS8812",750000,750000,0,0
TIKI,dien-tu-dien-lanh,58530889,"Tủ lạnh Samsung Inverter 595 lít RS64T5F01B4/SV - Chỉ giao Hà Nội",39800000,39800000,0,0
TIKI,giay-dep-nam,161496598,"Giày lười vải nam trung niên cao cấp form dáng đẹp - giày lười vải nam thoáng khí",155000,155000,0,0
TIKI,dien-tu-dien-lanh,171616937,"Điều Hòa Funiki 12000Btu HSC12TMU - Chỉ giao Hà Nội",5999000,5999000,0,0
TIKI,dien-tu-dien-lanh,35413420,"Remote Điều Khiển Dùng Cho Máy Lạnh, Máy Điều Hòa SHARP CRMC-A669JBEZ",65000,65000,0,0
TIKI,dien-tu-dien-lanh,1954729,"Bình nước nóng Ferroli Verdi AE20L, 3 công suất, thanh đốt siêu bền, hiển thị nhiệt độ, 2.500W - Hàng chính hãng",3050000,3050000,0,0
TIKI,giay-dep-nam,96242641,"Sandal Bitis nam",325000,325000,0,0
TIKI,dien-tu-dien-lanh,107223650,"Smart Tivi LG Full HD 43 inch 43LM5750PTC",7850000,7850000,0,0
TIKI,dien-tu-dien-lanh,129407126,"Tivi Box BEST TV R10 (2021) - Cấu Hình Khủng - Bắt Sóng Wifi Cực Mạnh - Truyền Hình OTT Miễn Phí",768000,768000,0,0
TIKI,dien-tu-dien-lanh,195227155,"Mâm máy giặt, mâm dành cho máy giặt Sanyo Aqua Điện Lạnh Thuận Dung",180000,180000,0,0
TIKI,giay-dep-nam,145455290,"Giày nam, giày sneaker nam cao cấp mới nhất CỰC HOT",229000,229000,0,0
TIKI,giay-dep-nam,109885929,"Dép quai ngang nam Đông Hải da bò cao cấp thiết kế quai bản to dễ phối đồ - D1811",590000,590000,0,0
TIKI,dien-tu-dien-lanh,169814137,"Smart Tivi QLED The Serif Samsung 4K 55 inch QA55LS01B - Model 2022",23800000,23800000,0,0
TIKI,dien-tu-dien-lanh,90148845,"Máy giặt Samsung Inverter 9 Kg WW90TP54DSH/SV - Chỉ giao Hà Nội",7890000,7890000,0,0
TIKI,giay-dep-nam,184068704,"HAVAIANAS - Dép nam Brasil Logo 4110850",749000,749000,0,0
TIKI,giay-dep-nam,117492220,"Chai xịt giày Aht Nano Bạc khữ mùi diệt khuẩn, chống thối chân hôi giày - XITGIAY-AHT",49000,69000,20000,29
TIKI,giay-dep-nam,20333597,"Dép cao su 5 quai ngang",300000,300000,0,0
TIKI,dien-tu-dien-lanh,169277259,"GIÁ TREO TIVI DI ĐỘNG AVA1800 (55-80INCH)",1718000,1718000,0,0
TIKI,giay-dep-nam,164491354,"(Kèm Video )Giày Thể Thao Nam MS042 Tăng Chiều Cao Phong Cách  Thời Trang Trẻ Trung có 2 màu",99000,99000,0,0
TIKI,giay-dep-nam,67367689,"Dép quai hậu nam công sở da bò thật giản dị đế mềm êm thoáng khí kiểu dáng Hàn Quốc mã 50335",359000,689000,330000,48
TIKI,giay-dep-nam,85386059,"GIày Sandal Nam Da Bò BIGGBEN Cao Cấp SD112",339000,450000,111000,25
TIKI,giay-dep-nam,156216262,"GIÀY LƯỜI NAM KHÂU VIỀN DA BÒ THẬT 100",750000,750000,0,0
TIKI,dien-tu-dien-lanh,171616925,"Tủ lạnh LG Inverter 635 Lít GR-D257WB - Chỉ giao Hà Nội",24500000,24500000,0,0
TIKI,dien-tu-dien-lanh,197344890,"Máy Rửa Chén Công Nghiệp CLASSEQ D500 Duo - Hàng Chính Hãng",83902500,83902500,0,0
TIKI,dien-tu-dien-lanh,195506310,"Smart Tivi LG 4K 50 inch 50UQ7550PSF - Model 2022",9950000,9950000,0,0
TIKI,giay-dep-nam,179060663,"Dép sục cross nam nữ oflaod màu đen đi mưa, thoáng, bền, hàng xịn, full box",405000,405000,0,0
TIKI,dien-tu-dien-lanh,28297613,"GIÁ TREO MÀN HÌNH MÁY TÍNH NB F100A (19"- 32")",486900,486900,0,0
TIKI,giay-dep-nam,155221895,"Giày đốc nam da bò cao cấp Giày gồ cột dây đế nâu cá tính- G88 Giày SAGO’S",650000,650000,0,0
TIKI,giay-dep-nam,115768012,"Giày Sục Nam Da Bóng Có Đai Vàng Kết Hợp Da Lộn Mã L194 Màu Đen",199000,199000,0,0
TIKI,dien-tu-dien-lanh,171616926,"Tủ lạnh LG Inverter 635 Lít GR-D257JS - Chỉ giao Hà Nội",27500000,27500000,0,0
TIKI,dien-tu-dien-lanh,99091268,"Remote Arirang AR-3600S/DH-3600Elite - Hàng chính hãng",140000,140000,0,0
TIKI,dien-tu-dien-lanh,53307540,"Tủ lạnh Funiki Hòa Phát FR 156ISU 150 lít - Hàng Chính Hãng",4089000,4089000,0,0
TIKI,giay-dep-nam,6396781,"Sandal Nam Bít Mũi BIGGBEN Da Bò Thật SD44",419000,470000,51000,11
TIKI,dien-tu-dien-lanh,116135563,"Sò lạnh tủ lạnh  Nhật âm 4 loại tốt",30000,30000,0,0
TIKI,dien-tu-dien-lanh,197853158,"[Giao toàn quốc] Máy giặt Bosch WGG234E0SG - Khối Lượng Giặt 8kg - 9 Chương Trình Giặt - Hàng Chính Hãng",13890000,13890000,0,0
TIKI,dien-tu-dien-lanh,127346977,"BỘ 2 TẤM LƯỚI LỌC MÁY LẠNH PANASONIC 2HP – 2.5HP – HÀNG CHÍNH HÃNG",255000,255000,0,0
TIKI,dien-tu-dien-lanh,217613478,"Remote Điều Khiển Dành Cho Smart TV, Internet TV, TV Thông Minh SONY RMT-TX300P",35000,35000,0,0
TIKI,dien-tu-dien-lanh,4597127,"Giá Treo Tivi Sát Tường Nhập Khẩu North Bayou C3F (40-60 inch)",208000,208000,0,0
TIKI,dien-tu-dien-lanh,73952674,"Chuột Bay NETBOX B2 Tìm Kiếm Giọng Nói 1 Chạm 1 Nút Học Lệnh HÀNG CHÍNH HÃNG",130000,130000,0,0
TIKI,dien-tu-dien-lanh,53448035,"Tủ đông Hòa Phát HCF 506S2N2 205 lít - Hàng Chính Hãng",6700000,6700000,0,0
TIKI,dien-tu-dien-lanh,192326260,"tủ rượu vang vinocave  52 chai-hàng nhập khẩu",13000000,13000000,0,0
TIKI,dien-tu-dien-lanh,191061231,"Máy Giặt Cửa Trước Panasonic 10 Kg NA-V10FR1BVT (Đen) - Diệt khuẩn đến 99.99% - Tính năng sấy tiện ích - Hàng Chính Hãng - Giao Toàn Quốc",18490000,18490000,0,0
TIKI,dien-tu-dien-lanh,58796546,"Remote Điều Khiển Dành Cho Internet TV, Smart TV SONY RM-L1165 Grade A+ (Kèm Pin AAA Maxell)",30000,30000,0,0
TIKI,dien-tu-dien-lanh,56742165,"Remote Điều Khiển Dành Cho TV Skyworth",40000,40000,0,0
TIKI,dien-tu-dien-lanh,10067305,"Khung treo tivi đa năng 37''-43''",65000,65000,0,0
TIKI,dien-tu-dien-lanh,41863600,"Remote Điều Khiển Dùng Cho TV LCD, TV LED Panasonic RM-1020M",28000,28000,0,0
TIKI,dien-tu-dien-lanh,89637551,"Remote điều khiển cho smart TV Sony loại ngắn tặng kèm pin",51000,51000,0,0
TIKI,dien-tu-dien-lanh,119822248,"Remote Điều khiển tivi dành cho Mobell LED/LCD/Smart TV",39900,39900,0,0
TIKI,dien-tu-dien-lanh,162105846,"Bộ Chuyển Hướng Gió Dàn Nóng Điều Hoà",199000,199000,0,0
TIKI,giay-dep-nam,14380825,"Dép nam saldalda bò cao cấp Trường hải SD038",290000,339000,49000,14
TIKI,dien-tu-dien-lanh,115444964,"Remote dành cho Máy Lạnh SANYO Nội Địa NHẬT",150000,150000,0,0
TIKI,giay-dep-nam,59436595,"Sandal  nam cao cấp Pierre Cardin PCMFWL 127 - màu nâu",945000,1890000,945000,50
TIKI,dien-tu-dien-lanh,192331654," Sò nóng lạnh TEC1-12706 40x40mm",65000,65000,0,0
TIKI,dien-tu-dien-lanh,113911986,"FPT Play Box S 2021 – Chính hãng FPT Telecom (Mã T590) – Kết hợp Tivi Box và Loa thông minh",210000,210000,0,0
TIKI,dien-tu-dien-lanh,126702048,"Remote Điều khiển từ xa tivi dành cho Samsung Smart TV Samsung UA 32 40 43 49 50 55 QA65 4K KU NU RU Smart QLED ",49000,49000,0,0
TIKI,dien-tu-dien-lanh,126702179,"Remote điều khiển tivi dành cho Sharp RM-L1046",40850,43000,2150,5
TIKI,dien-tu-dien-lanh,217749631,"Remote Điều Khiển Dành Cho Tivi SONY Internet Smart TV RM-L1275 Kèm Pin",45000,45000,0,0
TIKI,giay-dep-nam,270460979,"Giày sandal unisex Crocs All Terrain - 207711-001",1395000,1395000,0,0
TIKI,dien-tu-dien-lanh,87864517,"Remote Điều Khiển Dành Cho Đầu Thu Truyền Hình Số K+ HD",38000,38000,0,0
TIKI,dien-tu-dien-lanh,54620445,"Điều khiển quạt trần Panasonic Model F-56MZGTBGAVH- Hàng chính hãng",277000,277000,0,0
TIKI,dien-tu-dien-lanh,145246621,"Máy giặt mini công suất hỗ trợ tới 4kg đồ giặt.Diệt khuẩn UV và Ozone",281000,281000,0,0
TIKI,giay-dep-nam,113574574,"(Có 3 Màu) Giầy xăng đan nam nữ 35-44 3 quai ngang Sport - Sandal nam mẫu mới hot 2020",159000,159000,0,0
TIKI,dien-tu-dien-lanh,25212221,"Remote Điều Khiển Cho Máy Lạnh, Điều Hòa SHARP AH-X12VEW, AH-X18VEW",43000,43000,0,0
TIKI,giay-dep-nam,183110561,"Giày Thể Thao Nam Đế Em SK012 Thoáng Khí- Có 2 Màu",54000,54000,0,0
TIKI,dien-tu-dien-lanh,55844681,"Remote Điều Khiển Cho Smart TV, Internet TV TCL Grade A+ (Kèm Pin AAA Maxell)",69000,69000,0,0
TIKI,dien-tu-dien-lanh,57730882,"Van cấp nước đôi dành cho máy giặt toshiba",95000,95000,0,0
TIKI,dien-tu-dien-lanh,188487752,"NẸP NHỰA BÁN NGUYỆT NHẬT BẢN - 1M/Cây - 10 Cây/Thùng - HÀNG CHÍNH HÃNG",583000,583000,0,0
TIKI,dien-tu-dien-lanh,62723102,"Máy Giặt Samsung Inverter 9 kg WA90T5260BY/SV - Chỉ giao Hà Nội",5350000,5350000,0,0
TIKI,dien-tu-dien-lanh,119821991,"Remote Điều khiển TV dành cho Panasonic đa năng các dòng tivi  LCD/LED/Smart TV",29000,29000,0,0
TIKI,dien-tu-dien-lanh,155340837,"Remote Điều Khiển Giọng Nói Dành Cho TCL Smart TV, Tivi Thông Minh TCL Netflix",198000,198000,0,0
TIKI,dien-tu-dien-lanh,100099998,"ĐIỀU KHIỂN GIỌNG NÓI NETBOX V6,KÈM PIN AAA CÓ NÚT SỐ BẤM MẬT KHẨU DỄ DÀNG DÙNG CHO TIVI SMART,ANDROIL TIVI BOX ,HÀNG CHÍNH HÃNG",139000,139000,0,0
TIKI,giay-dep-nam,70373722,"Dép sức khỏe nam Spenco Kholo Black Carbon 450",1695000,1695000,0,0
TIKI,dien-tu-dien-lanh,80896501,"Rơ le máy bơm tăng áp,công tắc cảm biến dòng chảy 220v",86000,86000,0,0
TIKI,giay-dep-nam,116819962,"Dép sandal nam và nữ đế đen quai bố đen",82500,82500,0,0
TIKI,dien-tu-dien-lanh,51368046,"Remote Điều Khiển Cho Hộp TV FPT Play Box + (FPT Play Box 2019) Giọng Nói",160000,160000,0,0
TIKI,dien-tu-dien-lanh,15507023,"Điều Khiển Dùng Cho Điều Hòa SAMSUNG",62000,62000,0,0
TIKI,dien-tu-dien-lanh,70033278,"Máy giặt mini tại xô HW-150WAC tiết kiệm điện cho sinh viên và em bé có hẹn giờ",845000,845000,0,0
TIKI,dien-tu-dien-lanh,15246396,"Kê chân máy giặt, tủ lạnh, tủ sấy điều chỉnh được kích thước TXL9154",60800,60800,0,0
TIKI,dien-tu-dien-lanh,87909064,"Smart Tivi Samsung 4K 50 inch UA50AU7000",8549000,8549000,0,0
TIKI,dien-tu-dien-lanh,20540219,"Chuột Bay G20S – Hỗ Trợ Tìm Kiếm Bằng Giọng Nói - Hệ Điều Hành Android TV",141550,149000,7450,5
TIKI,dien-tu-dien-lanh,165964558,"Ron Tủ lạnh  dành cho tủ lạnh Sanyo Model : SR 15JN(Ron bắt vít )",187000,187000,0,0
TIKI,dien-tu-dien-lanh,29771066,"Remote Điều Khiển Cho Máy Lạnh, Điều Hòa Samsung DB93-14195A, DB93-14195G, DB93-14195F",41900,41900,0,0
TIKI,dien-tu-dien-lanh,94902034,"REMOTE ĐIỀU KHIỂN DÀNH CHO MÁY LẠNH ĐIỀU HOÀ TOSHIBA (nắp kéo 3nut)",55000,55000,0,0
TIKI,dien-tu-dien-lanh,197340889,"lnb ku band AVG, Hàng Chính Hãng.",50000,50000,0,0
TIKI,dien-tu-dien-lanh,96459311,"Dụng cụ đo áp xuất gas điều hòa - Đồng hồ đôi đo áp suất gas máy lạnh CT536G",315000,315000,0,0
TIKI,dien-tu-dien-lanh,126701908,"Điều khiển điều hòa dành cho LG ",66000,66000,0,0
TIKI,dien-tu-dien-lanh,119194169,"Remote dành cho đầu thu VNPT SmartBox",57000,57000,0,0
TIKI,dien-tu-dien-lanh,102806513,"Quạt tản nhiệt dành cho tủ lạnh PANASONIC 2 dây loại 8V và 12V",142000,142000,0,0
TIKI,dien-tu-dien-lanh,119088645,"(REMOTE MÁY LẠNH ) ĐIỀU KHIỂN ĐIỀU HÒA CASPER ĐỜI MỚI - HÀNG CHÍNH HÃNG",73000,73000,0,0
TIKI,dien-tu-dien-lanh,119821950,"Remote Điều khiển tivi dành cho TCL các dòng tivi CRT LCD LED Smart TV",40000,40000,0,0
TIKI,dien-tu-dien-lanh,209390346,"Sò lạnh dành cho tủ lạnh TOSHIBA",30000,30000,0,0
TIKI,dien-tu-dien-lanh,98165016,"Remote điều khiển cho quạt trần Vinawind điện cơ Thống Nhất QT1400X",90000,90000,0,0
TIKI,dien-tu-dien-lanh,126702172,"Remote Điều khiển tivi từ xa dành cho Samsung các dòng UA32 UA40 UA43 UA 49 UA50 UA55 QA65 4K Smart QLED ",22000,22000,0,0
TIKI,dien-tu-dien-lanh,53296097,"Tủ lạnh Funiki Hòa Phát FR 71CD 70 lít - Hàng Chính Hãng",2370000,2370000,0,0
TIKI,dien-tu-dien-lanh,20241698,"Điều Khiển dành cho Tivi LG Smart Internet AKB 75095307",19000,19000,0,0
TIKI,giay-dep-nam,73721553,"Dép quai ngang nam Trường Hải da bò cao cấp mềm mại không bong tróc màu đen đế PU siêu nhẹ cao 5cm QN025",247000,289000,42000,15
TIKI,giay-dep-nam,181362510,"Cây Giữ Form Giày Shoe Tree Nhựa PE Loại 1 Tự Nhiên Cao Cấp Không Mùi Hút Ẩm Hiệu Quả Chống Hôi Chân - B21 Shoemaker",36000,36000,0,0
TIKI,giay-dep-nam,147265032,"Dép Nam POLITE-ART chữ H biểu thượng thời trang, năng động màu đen DEP04LE",199000,299000,100000,33
TIKI,giay-dep-nam,75637226,"Crep Protect Ultimate Shoes Gift Box - Bộ Vệ Sinh Chăm Sóc Giầy Dép",1250000,1250000,0,0
TIKI,giay-dep-nam,50357599,"Lót giầy nam chất da dục lỗ thoáng khí PKG03",42000,42000,0,0
TIKI,giay-dep-nam,51233107,"Dép cao su 3 quai chéo đế dày",800000,800000,0,0
TIKI,giay-dep-nam,83170012,"Dép cao su 2 quai",300000,300000,0,0
TIKI,giay-dep-nam,196869322,"[Phiên Bản Kỷ Niệm 40 Năm] Giày Thể Thao Nam Hunter X DSMH09700TRG (Trắng)",1092000,1187000,95000,8
TIKI,giay-dep-nam,206713180,"Giày lười nam da Pu - mã NA25",159000,159000,0,0
TIKI,giay-dep-nam,108142084,"Giày lười da nam, Da mềm cao cấp không bóng, Có chuông, Đế cao su non cao 3cm, Khâu đế, Màu đen, Mã l192, Hàng Việt Nam",198000,198000,0,0
TIKI,giay-dep-nam,22663140,"Giày Sneaker Unisex Vans Old Skool 36 DX VN0A38G2PXC",2090000,2200000,110000,5
TIKI,giay-dep-nam,76164156,"HAVAIANAS - Dép unisex Brasil Logo 4110850",749000,749000,0,0
TIKI,giay-dep-nam,168944874,"Giày Lười Vải Cao Cấp Peace PO1226",429000,429000,0,0
TIKI,giay-dep-nam,74988388,"Giày da nam Pierre Cardin PCMFWL 702 - màu nâu",2990000,2990000,0,0
TIKI,giay-dep-nam,5887283,"Combo 3 đôi Vớ nam mang giày lười, giày bệt Màu ngẫu nhiên A177",46000,49000,3000,6
TIKI,giay-dep-nam,75632053,"Miếng Lót Giầy Nam Gel Crep Protect Ultimate Gel Insole",700000,700000,0,0
TIKI,giay-dep-nam,10054396,"Giày Sandal Bít Mũi Nam BIGGBEN Da Bò Thật SD77",349000,500000,151000,30
TIKI,giay-dep-nam,69177937,"Dép nam xỏ ngón HÀ NAM da bò thật cao cấp DXN2035",450000,450000,0,0
TIKI,giay-dep-nam,96846714,"Lót giày tăng chiều cao, độn giày nửa bàn êm chân",15000,15000,0,0
TIKI,giay-dep-nam,179879904,"Dép Xỏ Ngón Nam HÀ NAM Da Bò Thật Cao Cấp DXN2063c",390000,390000,0,0
TIKI,giay-dep-nam,192890340,"MLB - Giày sneaker Bigball Chunky Mesh 3ASHCE12N",2590000,2590000,0,0
TIKI,giay-dep-nam,8407912,"Sandal Doctor Nam BIGGBEN Da Bò Thật SD70",329000,500000,171000,34
TIKI,giay-dep-nam,36955095,"Dép cao su nam nữa 3 quai ngang",400000,400000,0,0
TIKI,giay-dep-nam,161393205,"Gel vệ sinh giày Sneaker, Đậm đặc, Siêu Sạch, Thơm Mát, Dễ sử dụng CHONGIAY",83000,83000,0,0
TIKI,giay-dep-nam,44935336,"Giày tây nam Trường Hải da bò cao cấp GTN0596",456000,539000,83000,15
TIKI,giay-dep-nam,160686509,"Dép Quai Ngang WAA. - Gô Sandals - Màu Nâu",590000,590000,0,0
TIKI,giay-dep-nam,196874210,"[Phiên Bản Kỷ Niệm 40 Năm] Giày Thể Thao Nam Hunter X DSMH09700DOO (Đỏ)",1068000,1187000,119000,10
TIKI,giay-dep-nam,160686493,"Dép quai ngang Unisex Basic Sandals WAA.- DA THẬT 100% - Sản phẩm thiết kế - Màu đen",590000,590000,0,0
TIKI,giay-dep-nam,145650235,"Bình Xịt Nano Khử Mùi Hôi Giày Dép Hiệu Quả - Có Thể Sử Dụng Nhiều Lần.",12000,28999,16999,59
TIKI,giay-dep-nam,110993105,"Giày thể thao nam, giày nam thời trang da cá sấu đế khí DQ05",220000,220000,0,0
TIKI,giay-dep-nam,194445817,"Dép sục nam.. da mềm.. màu nâu..đế khâu sẵn rất chắc chắn.. mã SP19",145000,145000,0,0
TIKI,giay-dep-nam,161393115,"Keo Dán Giày Dép Chuyên Dụng SEAGLUE, Không Màu, Chịu Lực, Chịu Nước tốt",131000,131000,0,0
TIKI,giay-dep-nam,41342414,"Giày Tây Da Nam Germano Bellesi Italia GB 804",8480000,8480000,0,0
TIKI,giay-dep-nam,10063550,"Giày Sandal Bít Mũi  Nam BIGGBEN Da Bò Thật SD78",349000,500000,151000,30
TIKI,giay-dep-nam,14816328,"GIÀY DA BÒ CAO CẤP - LEX23",590000,590000,0,0
TIKI,giay-dep-nam,73325521,"Giày da nam Pierre Cardin PCMFWLE 714 - màu nâu",1190000,2490000,1300000,52
TIKI,giay-dep-nam,113022420,"[SIÊU NHẸ_CHẤT LƯỢNG] Dép nhựa nam quai kẹp chất lượng, đúc nguyên chiếc, đi mưa, không thấm nước SM006",61000,65000,4000,6
TIKI,giay-dep-nam,80798404,"Giày tây nam, giày công sở da thật cao cấp thời trang mới nhất PABNO - PN137",950000,950000,0,0
TIKI,giay-dep-nam,156215140,"GIÀY THỂ THAO NAM DA BÒ THẬT 100% CAO CẤP HÀNG CÔNG TY XNK",955883,955883,0,0
TIKI,giay-dep-nam,6398613,"Giày Tây Nam BIGGBEN Da Bò Thật Cao Cấp GT23",500000,500000,0,0
TIKI,giay-dep-nam,179555780," GIÀY DA LƯỜI NAM ĐẾ  CAO 3CM DONAVY CAO CẤP MAY FULL QUAI VÀ ĐẾ RẤT CHẮC CHẮN DGKM",169000,280000,111000,40
TIKI,giay-dep-nam,105698535,"Combo 5 đón gót giày siêu xinh- DG003",23000,23000,0,0
TIKI,giay-dep-nam,101656937,"Bàn Chải Đánh Giày Đồ Da 2 Mặt Lông Ngựa Sans908 Sans Shop",44000,44000,0,0
TIKI,giay-dep-nam,58893939,"Giày tây nam đế cao",210000,210000,0,0
TIKI,giay-dep-nam,135840113,"Giày tây nam da nhám, Da mềm cao cấp, Đế cao 3cm, Có khâu đế chắc chắn, Mã X084 màu đen, Hàng Việt",199000,199000,0,0
TIKI,giay-dep-nam,119288017,"Dép Nam Quai Ngang TiTi ĐÔ Da Bò Thật Cao Cấp DN2074a",420000,420000,0,0
TIKI,giay-dep-nam,117717569,"Giày Thể Thao Sneaker Nam Da Lì Trơn Phong Cách Hàn Quốc AVI - 381",99000,99000,0,0
TIKI,giay-dep-nam,171183715,"GIÀY TÂY DA BÒ CAO CẤP VA2002",399000,399000,0,0
TIKI,giay-dep-nam,115831227,"Giày Lười Nam - Dép Hở Gót ,Sục Nam chất liệu da pu đế cao su mã sản phẩm l195",160000,160000,0,0
TIKI,giay-dep-nam,156212202,"Giày thể thao nam , giày dệt kim, giày thể thao thời trang , giày đi chơi, đi làm mã J11",199500,399000,199500,50
TIKI,giay-dep-nam,115831164,"GIÀY LƯỜI NAM CÔNG SỞ - GIÀY DA NAM THỜI TRANG, CHẤT LIỆU DA PU MỀM 100%, ĐẾ CAO SU ĐÚC - MÃ L192 ĐEN",199000,199000,0,0
TIKI,giay-dep-nam,9839769,"Giày sneaker TOMOYO TMN10901",1400000,1400000,0,0
TIKI,giay-dep-nam,91281178,"Giày Unisex Crocs - CLASSIC 10001-001",1495000,1495000,0,0
TIKI,giay-dep-nam,192196939,"Dép Thái Lan nam quai Da dây chéo KITO A02M , Dép sandan quai da dành cho nam",295000,295000,0,0
TIKI,giay-dep-nam,66505395,"Dép Nam Da Bò BIGGBEN Cao Cấp DN259",299000,450000,151000,34
TIKI,giay-dep-nam,170125203,"MLB - Giày thể thao Big Ball Chunky A 3ASHC101N",2490000,2490000,0,0
TIKI,giay-dep-nam,171009847,"Dép tổ ong ĐEN vật liệu EVA siêu bền, siêu nhẹ, chống trơn trượt, Form SIZE LỚN CHÂU ÂU",65000,85000,20000,24
TIKI,giay-dep-nam,161393070,"Đón Gót Giày Bằng Gỗ Nguyên Khối Họa Tiết Khảm Trai Cao Cấp Đủ Size - Cho giày Nam & Nữ",42000,42000,0,0
TIKI,giay-dep-nam,120657027,"HC9131 - Xi nước đánh bóng Huy Hoàng màu vàng bò",99000,99000,0,0
TIKI,giay-dep-nam,156217059,"DÉP NAM QUAI NGANG DA BÒ KHÂU ĐẾ CHẮC CHẮN",317334,317334,0,0
TIKI,giay-dep-nam,138747321,"Nước lau giày thần thánh PLAC chai 100ml",11000,11000,0,0
TIKI,giay-dep-nam,126516907,"Tẩy trắng giày dép, túi xách - Đánh giày dép - Dung dịch đánh giày - Rửa giày dép - Chất tẩy đa năng - 1 lọ - GDHN Loại Tốt",10999,10999,0,0
TIKI,giay-dep-nam,53313944,"Dép nam xỏ ngón Trường Hải da bò thật cao cấp mềm mại đế âm mặt đế cao su không trơn  THXN074",312000,369000,57000,15
TIKI,giay-dep-nam,107804180,"Giày Thể Thao Nam_Giày Sneakes cao 4cm mang đi nhẹ thoáng khí s65",65550,69000,3450,5
TIKI,giay-dep-nam,167013211,"Giày Thể Thao Nam Màu Đen, Sneaker Nam Màu Đen, Đế Êm, Nhẹ Thoáng Khí SGN5010",175000,250000,75000,30
TIKI,giay-dep-nam,14326747,"Giày mọi nam vàng  trơn da bò cao cấp đế cao su GM025",453000,529000,76000,14
TIKI,giay-dep-nam,170125122,"MLB - Giày thể thao Big Ball Chunky A 3ASHC101N-50BGS",2490000,2490000,0,0
TIKI,giay-dep-nam,181485400,"Dép nam quai ngang một bản cao 3.5cm chính hãng Trường Hải da bò thật màu đen QN178",278000,379000,101000,27
TIKI,giay-dep-nam,162507471,"Dép Nam Quai Ngang, Dép nam Chống Trơn Trượt SD66",99000,99000,0,0
TIKI,giay-dep-nam,186909676,"Giày sục nam, sục nam Da bóng Moca - Da Pu Bảo hành 12 tháng ( Mã SN010 - Có hộp )",159000,159000,0,0
TIKI,giay-dep-nam,17970850,"Lót giày bằng Gel êm chân Woly Gel Ultraflat - NK Đức",99000,99000,0,0
TIKI,giay-dep-nam,83191375,"Dép quai ngang nam ALDO DINMORE",1150000,1150000,0,0
TIKI,giay-dep-nam,178467029,"Giày lười nam 2 màu: Nâu và Xanh Đen",190000,190000,0,0
TIKI,giay-dep-nam,179497830,"Dép kẹp nam Đông Hải chất da bò cao cấp thiết kế tối giản đế cao su chống trượt - D3221",690000,690000,0,0
TIKI,giay-dep-nam,179411890,"Dép kẹp nam da bò thật 100% DONAVY cao cấp kiểu 3 tam giác cách  điệu may full quai và đế rất chắc chắn DK3G",169000,290000,121000,42
TIKI,giay-dep-nam,206713208,"Giày tá Như Ý chất liệu da Pu cao cấp, tặng kèm tất xanh + lót quế",159000,159000,0,0
TIKI,giay-dep-nam,21730413,"Miếng lót giày đủ size Uncle Bills AG0016",69000,69000,0,0
TIKI,giay-dep-nam,207383539,"Giày lười nam, giày sục nam đẹp giá rẻ phông cách trẻ trung lăng động L204",160000,160000,0,0
TIKI,giay-dep-nam,208387272,"Giày đá cầu mỏ vịt",549000,549000,0,0
TIKI,giay-dep-nam,12119213,"Dép bít mũi nam da bò đen cao cấp TH011",273000,319000,46000,14
TIKI,dien-tu-dien-lanh,56719923,"Quạt tản nhiệt, Fan Case Led RGB Coolmoon V5 - Hàng Chính Hãng",85000,85000,0,0
TIKI,dien-tu-dien-lanh,198571398,"Ổ cứng SSD di động Kingston XS2000 1TB - SXS2000/1000G - Hàng Chính Hãng",2999000,2999000,0,0
TIKI,dien-tu-dien-lanh,459248,"Máy In Laser Đa Năng Brother MFC-L2701D - Hàng chính hãng",5472000,5700000,228000,4
TIKI,dien-tu-dien-lanh,88050388,"Thanh Led RGB Aorus Rog đồng bộ Hub , Dùng độ trang trí cho VGA máy tính - hàng nhập khẩu",120000,120000,0,0
TIKI,dien-tu-dien-lanh,134947044,"Laptop Dell Vostro 3400 70253900 (Core i5-1135G7/ 8GB/ 256GB SSD/ 14 FHD/ Win 11 + Office) - Hàng Chính Hãng",13850000,13850000,0,0
TIKI,dien-tu-dien-lanh,159971558,"Màn hình máy tính Dell E2422H ( 24 inch/ IPS/ Full HD/ 60Hz ) - Hàng Chính Hãng",3150000,3150000,0,0
TIKI,dien-tu-dien-lanh,61027361,"Máy chiếu Projector mini đa năng (Độ nét cao) phù hợp phòng ánh sáng yếu - Thunder",2900000,2900000,0,0
TIKI,dien-tu-dien-lanh,179408253,"Laptop Acer Aspire 3 A315-56-38B1 i3 1005G1/4GB/256GB/15.6"FHD/Win11 - Hàng Chính Hãng",8990000,8990000,0,0
TIKI,dien-tu-dien-lanh,561879,"Kaspersky Internet Security Cho 1 Máy Tính - KIS1U - Hàng chính hãng",279000,279000,0,0
TIKI,dien-tu-dien-lanh,114211157,"Máy In Laser Màu Đơn Năng BROTHER HL-L8360CDW - Hàng Chính Hãng",10450000,10450000,0,0
TIKI,dien-tu-dien-lanh,28057130,"Card màn hình ZOTAC GAMING GeForce GTX 1650 AMP - HÀNG CHÍNH HÃNG",4970000,4970000,0,0
TIKI,dien-tu-dien-lanh,9794165,"Máy In Canon Selphy CP1300 (Trắng) - Hàng Chính Hãng",3680000,3680000,0,0
TIKI,dien-tu-dien-lanh,46183198,"Máy chiếu i-Projector chất lượng 1080P độ nét cao - Hàng nhập khẩu",4500000,4500000,0,0
TIKI,dien-tu-dien-lanh,156188433,"Bộ máy tính để bàn Vlimited chơi game trọn độ đầy đủ  Case/8G/SSD/HDD/Vga rời/Màn hình - Hàng chính hãng",4450000,4450000,0,0
TIKI,dien-tu-dien-lanh,126091177,"Anten thu sóng 3g/4g của thiết bị Netgear- Hàng Chính Hãng ",99000,99000,0,0
TIKI,dien-tu-dien-lanh,174216794,"Laptop HP ProBook 450 G8 51X30PA (i7-1165G7/ 8GB/ 512GB SSD/ 15.6FHD/ VGA ON/ Win10/ Silver/ LEB_KB/ Vỏ nhôm) - Hàng chính hãng",36396000,36396000,0,0
TIKI,dien-tu-dien-lanh,95484338,"Bộ vi sử lý Core i3 6100 / i5 6500 / i7 6700 cpu socket 1151. Tặng kèm keo tản nhiệt",1086000,1086000,0,0
TIKI,dien-tu-dien-lanh,51521510,"DrayTek Vigor2926 Hàng Chính Hãng",3720000,3720000,0,0
TIKI,dien-tu-dien-lanh,193549202,"máy in bluetooth A4-A5 cầm tay kết nối được tất cả các dòng điện thoại-latop-pc-máy tính bảng androi và ios pin lithium 30000 mah cổng sạc typec tốc độ in nhanh 20 tờ/1p nhỏ gọn tiện lợi dễ dàng mang đi sử dụng không cần đến nguồn điện 220v mực lưu 10 năm",2400000,2400000,0,0
TIKI,dien-tu-dien-lanh,188007796,"[HÀNG CHÍNH HÃNG] Combo Máy in laser đơn sắc Brother HL-L2321D và 2 Mực in laser trắng đen Brother TN-2385",4144000,4144000,0,0
TIKI,dien-tu-dien-lanh,44003475,"Quạt tản nhiệt CPU Jonsbo CR1200 - Hàng nhập khẩu",230000,230000,0,0
TIKI,dien-tu-dien-lanh,3920565,"Ổ cứng SSD Western Digital Blue 3D-NAND M.2 2280 SATA III 500GB WDS500G2B0B - Hàng Chính Hãng",1650000,1650000,0,0
TIKI,dien-tu-dien-lanh,87959768,"USB Phát Wifi 4G LTE U80 – Tốc Độ 150Mb – Kết Nối 10 User",519000,519000,0,0
TIKI,dien-tu-dien-lanh,41694647,"Máy Chiếu Mini LCD LED Projector PD300 Cao Cấp AZONE",645000,645000,0,0
TIKI,dien-tu-dien-lanh,142656943,"Card màn hình VGA Asus GT730-SL-2GD5 BRK - Hàng Chính Hãng",1490000,1490000,0,0
TIKI,dien-tu-dien-lanh,102901250,"Sạc dành cho Laptop Dell (Các loại) 19.5V 3.34A 65W - chân kim nhỏ ",179995,350000,170005,49
TIKI,dien-tu-dien-lanh,452118,"Ổ cứng Di Động Transcend StoreJet H3B 1TB USB 3.0/3.1 - TS1TSJ25H3B - Hàng Chính Hãng",1959000,1959000,0,0
TIKI,dien-tu-dien-lanh,50086320,"Màn Hình Gaming Samsung LS27R350FHEXXV 27 inch FullHD 5ms 75Hz IPS - Hàng Chính Hãng",3490000,3490000,0,0
TIKI,dien-tu-dien-lanh,183262949,"Máy Chủ Server - Hàng nhập khẩu",3500000,3500000,0,0
TIKI,dien-tu-dien-lanh,11864859," Máy Chiếu Mini YG-300 Smart LED Độ Phân Giải 1920×1080",783750,825000,41250,5
TIKI,dien-tu-dien-lanh,81222214,"Bộ phát Wifi 4G Netgear Aircard AC800S - Cat9 - tốc độ 450Mbps - Phiên Bản Quốc Tế - hàng chính hãng",1881000,1980000,99000,5
TIKI,dien-tu-dien-lanh,157078205,"Màn hình LG 27MP400-B (27inch/FHD/IPS/75hz/5ms/250nits/HDMI+Dsub/Freesync) -Hàng Chính Hãng",3190000,3190000,0,0
TIKI,dien-tu-dien-lanh,112499909,"Máy in laser đen trắng Brother HL-B2080DW - Hàng chính hãng",4850000,4850000,0,0
TIKI,dien-tu-dien-lanh,80983401,"Két nước tản nhiệt 8cm kèm quạt gió 12V",195000,195000,0,0
TIKI,dien-tu-dien-lanh,164494570,"Ram máy tính ddr4 Asgard V5 8gb Bus 3200 RGB Sync- Hàng chính hãng",1000000,1000000,0,0
TIKI,dien-tu-dien-lanh,179539811,"Card mở rộng ổ cứng SSD M.2 qua khe PCI-E 3.0 X16 Orico PSM2-X16 - Hàng chính hãng",133000,133000,0,0
TIKI,dien-tu-dien-lanh,161266256,"Nhân mạng, hạt ổ cắm cat5 cat6 âm tường lắp mặt âm tường chuẩn WIDE (hạt to) dành cho mặt Panasonic",66000,66000,0,0
TIKI,dien-tu-dien-lanh,13758732,"Bàn Vẽ Màn Hình Tinh Thể Lỏng Kĩ Thuật Số Gaomon GM185 - Hàng nhập khẩu",6700000,6700000,0,0
TIKI,dien-tu-dien-lanh,195687591,"Ổ ĐĨA DVD RW CẮM NGOÀI CHO LATOP DESTOP OS  ĐỜI MỚI 3.0 Hỗ trợ cổng Type C",350000,350000,0,0
TIKI,dien-tu-dien-lanh,101778693,"Màn hình LCD LG 27MP60G-B.ATV 27inch FullHD 5ms 75Hz IPS - Hàng Chính Hãng",3645000,3645000,0,0
TIKI,laptop-may-vi-tinh-linh-kien,34497832,"Máy in nhiệt - in hóa đơn ( bill) Xprinter -N160I LAN - Hàng chính hãng",1089000,1089000,0,0
TIKI,laptop-may-vi-tinh-linh-kien,171729035,"Màn hình Dell P2423D 23.8 inch 2K IPS 60Hz - Hàng Chính Hãng",6490000,6490000,0,0
TIKI,laptop-may-vi-tinh-linh-kien,159396730,"Màn hình Gigabyte M34WQ-EK (34inch/ WQHD/ IPS/ 144Hz/ 1ms/ 400nits/ HDMI+DP+USBC/ Freesync/ Loa) - Hàng Chính Hãng",11850000,11850000,0,0
TIKI,laptop-may-vi-tinh-linh-kien,78629390,"Quạt tản nhiệt Case Xigmatek X20F (EN45457) - Led RGB CIRCLE - Hàng chính hãng",99000,99000,0,0
TIKI,laptop-may-vi-tinh-linh-kien,189941565,"PC All In One MCC 4541P19 CPU G4560, 4GB DDR4, 120GB SSD, 19" HD+, WIFI, BLUETOOTH, MIC, CAMERA 3.1Mpx - Hàng chính hãng",9900000,9900000,0,0
TIKI,laptop-may-vi-tinh-linh-kien,7239205,"Bộ lưu điện UPS CyberPower BU600 600VA/360W - Hàng Chính Hãng",750000,750000,0,0
TIKI,laptop-may-vi-tinh-linh-kien,3044703,"Màn Hình BenQ Zowie XL2411P 24inch Full HD 1ms 144Hz TN - Hàng Chính Hãng",7546000,7546000,0,0
TIKI,laptop-may-vi-tinh-linh-kien,22050384,"Bo Mạch Chủ Mainboard ASUS PRIME H310M-K Intel LGA-1151 mATX DDR4 2666MHz - Hàng Chính Hãng",1590000,1590000,0,0
TIKI,laptop-may-vi-tinh-linh-kien,52161959,"Màn Hình Viewsonic VA2223-H 22 inch Full HD - Hàng Chính Hãng",2150000,2150000,0,0
TIKI,laptop-may-vi-tinh-linh-kien,98051315,"Máy POS cầm tay SP01 - Hàng nhập khẩu ",2700000,2700000,0,0
TIKI,laptop-may-vi-tinh-linh-kien,31129176,"Máy Tính Dell Optiplex 9020, Hàng Nhập Khẩu",1990000,1990000,0,0
TIKI,laptop-may-vi-tinh-linh-kien,190725467,"Laptop Laptop Dell Inspiron 16 5620 i7 1260P/16GB/512GB/2GB MX570/OfficeHS/Win11 (N6I7000W1) - Hàng chính hãng",36528000,36528000,0,0
TIKI,laptop-may-vi-tinh-linh-kien,208120476,"MÀN CHIẾU ĐIỆN TỬ TREO TƯỜNG TỰ ĐỘNG 136 INCH - 2,44M X 2,44M - P96ES HÀNG NHẬP KHẨU",1550000,1550000,0,0
TIKI,laptop-may-vi-tinh-linh-kien,29172843,"Box Chuyển SSD M2 Sata Sang Ổ Cứng Di Động SSK SHE-C320 Chuẩn 3.0 Hỗ Trợ Đến 5Gbps  - Hàng Nhập Khẩu",239000,239000,0,0
TIKI,laptop-may-vi-tinh-linh-kien,106318753,"Máy tính xách tay Laptop Dell Latitude 3420 (Intel Core i5-1135G7 | 14 Inch | RAM 8GB | 256GB SSD NVMe | Intel Iris Xe Graphics | Fedora Os) - Hàng chính hãng",14590000,19900000,5310000,27
TIKI,laptop-may-vi-tinh-linh-kien,196410736,"[HÀNG CHÍNH HÃNG] Máy in phun màu đa năng Brother DCP-T426W",4275000,4275000,0,0
TIKI,laptop-may-vi-tinh-linh-kien,70985791,"Card màn hình MSI GeForce GTX 1650 D6 VENTUS XS OC 4GB GDDR6 - Hàng Chính Hãng",5810000,5810000,0,0
TIKI,laptop-may-vi-tinh-linh-kien,90522993,"Vỏ Case Máy Tính Golden Field N27W (RGB, Vách Mica) - Hàng Chính Hãng ",650000,650000,0,0
TIKI,laptop-may-vi-tinh-linh-kien,195341179,"Máy tính All in one 20inch CPU I3 2.40Ghz 4 nhân 2G DDR3 32GB SSD - Home and Garden",8328000,8328000,0,0
TIKI,laptop-may-vi-tinh-linh-kien,191426395,"Màn hình Dahua DHI-LM22-B200 (22 inch/FHD/IPS/60Hz/6ms/200nits/HDMI+VGA+Audio)- Hàng chính hãng",2200000,2200000,0,0
TIKI,laptop-may-vi-tinh-linh-kien,167150431,"Ổ cứng HDD Seagate IronWolf 2TB ST2000VN004 3.5 inch, 5900RPM, SATA, 64MB Cache - Hàng chính hãng",2990000,2990000,0,0
TIKI,laptop-may-vi-tinh-linh-kien,173712052,"Màn hình LCD Dell Ultrasharp U2422H 23.8 inch FHD chuyên đồ họa - Hàng Chính Hãng",5790000,5790000,0,0
TIKI,laptop-may-vi-tinh-linh-kien,102106715,"Quạt Tản Nhiệt Sunon 9X9X2.5CM 12VDC - 2.6W",28000,28000,0,0
TIKI,laptop-may-vi-tinh-linh-kien,136676515,"Máy in HP LaserJet M211d (9YF82A) - Hàng Chính Hãng",3090000,3090000,0,0
TIKI,laptop-may-vi-tinh-linh-kien,192295100,"Ổ cứng di động WD Black D10 12TB Game Drive For Xbox (Desktop) Hàng Chính Hãng",15000000,15000000,0,0
TIKI,laptop-may-vi-tinh-linh-kien,132893952,"Máy chiếu thông minh XGIMI Horizon (Bản Quốc Tế) - Hàng chính hãng",30999000,30999000,0,0
TIKI,laptop-may-vi-tinh-linh-kien,22403604,"Card chuyển đổi PCI-Express 7 Port USB 3.0 cho máy tính bàn ORICO PVU3-502I (Đen)- Hàng nhập khẩu",699000,750000,51000,7
TIKI,laptop-may-vi-tinh-linh-kien,91272143,"Máy in phun màu đa năng Brother DCP-T820DW - Hàng chính hãng",6240000,6500000,260000,4
TIKI,laptop-may-vi-tinh-linh-kien,53048871,"Máy tính để bàn chuyên GAME Viettech Core i5 4570, Ram 8gb, SSD 120+ HDD 500gb - Hàng Nhập Khẩu",2950000,2950000,0,0
TIKI,laptop-may-vi-tinh-linh-kien,192199747,"Thiết bị lưu trữ mạng WD My Cloud PR2100 Hàng Chính Hãng",16680000,16680000,0,0
TIKI,laptop-may-vi-tinh-linh-kien,197604628,"Màn hình di động Lenovo ThinkVision M14t 14-inch FHD WLED Backlit LCD Monitor 62A3UAR1WW BH 36T - Hàng chính hãng",8405000,8405000,0,0
TIKI,laptop-may-vi-tinh-linh-kien,185654769,"Bộ PC All In One MCC 3341P19 CPU Core i3 Processor, 4GB, 120GB SSD, WIFI, 19" - Hàng chính hãng",7900000,7900000,0,0
TIKI,laptop-may-vi-tinh-linh-kien,931617,"Bộ Phát Wifi Di Động 4G LTE 150Mbps Tenda 4G180 - Hàng Chính Hãng",900000,900000,0,0
TIKI,laptop-may-vi-tinh-linh-kien,72758004,"CPU AMD Ryzen 7 5800X (8C/16T, 3.80 GHz - 4.70 GHz, 32MB) - AM4 - Hàng Chính Hãng",9660000,9660000,0,0
TIKI,laptop-may-vi-tinh-linh-kien,217316853,"Màn hình thông minh Samsung M7 43 inch Smart Monitor LS43BM702UEXXV - Hàng chính hãng",8450000,8450000,0,0
TIKI,laptop-may-vi-tinh-linh-kien,178100133,"Cáp quang treo 1FO( cuộn 1000m) giá chưa vat",700000,700000,0,0
TIKI,laptop-may-vi-tinh-linh-kien,464218,"Máy In Phun Màu Canon PIXMA IX6770 Chính Hãng Lê Bảo Minh",5880000,5880000,0,0
TIKI,laptop-may-vi-tinh-linh-kien,186755051,"Bộ Chuyển Đổi Quang Điện 3100 AB 25KM - Converter Quang",171000,180000,9000,5
TIKI,laptop-may-vi-tinh-linh-kien,117196258,"Đèn treo màn hình bảo vệ mắt Baseus i-Work Series (3 Light Mode, Anti Bluelight, USB Stepless Dimming Screen Hanging Light, New Model) - Hàng chính hãng - Đen",525000,539000,14000,3
TIKI,laptop-may-vi-tinh-linh-kien,55472283,"Quạt tản nhiệt điện thoại FL01",119000,129000,10000,8
TIKI,giay-dep-nu,252563621,"Giày Đế Xuồng nữ 5cm Da Bò khóa vuông Màu Đen Trường Hải DX116Đ",241000,285000,44000,15
TIKI,giay-dep-nu,252596684,"Giày búp bê mũi tròn trơn da bò mềm mại Trường Hải GBB118 có 2 màu đen, đỏ",241000,285000,44000,15
TIKI,giay-dep-nu,252597179,"Giày búp bê đế bằng da bò trơn Trường Hải da mềm GBB120 có 2 màu đen, trắng",241000,285000,44000,15
TIKI,giay-dep-nu,213724172,"Giày búp bê da bò mũi tròn Trường Hải đính nơ xinh da mềm mại GBB110",259000,299000,40000,13
TIKI,giay-dep-nu,101773571," Giày múa bale (Size 23 -> 33)",38000,38000,0,0
TIKI,giay-dep-nu,146989025,"Giày múa bale có gót 3cm bọc da lộn cực êm ái và bền",110000,110000,0,0
TIKI,giay-dep-nu,144191547,"Giày Khiêu Vũ Dance Sport, Giày Nhảy Latin Người Lớn",200000,200000,0,0
TIKI,giay-dep-nu,55060972,"Combo 2 cặp Lót gót giày 4D hình cánh bướm có mặt gai silicone chống trầy rách da và chống tuột gót chân - buybox - BBPK70_2",45000,90000,45000,50
TIKI,giay-dep-nu,177164437,"Giày Lười Nữ NATIVE AD Jericho",1400000,1400000,0,0
TIKI,giay-dep-nu,73120993,"IÀY BÚP BÊ TRƯỜNG HẢI DA BÒ MỀM MÀU VÀNG BÒ SANG TRỌNG MŨI GIÀY TRÒN, ĐẾ MỀM DẺO BÊN CHẮC VÀ THỜI TRANGBB025",217000,289000,72000,25
TIKI,giay-dep-nu,56377212,"Lót giày tăng chiều cao silicon đúc nguyên khối siêu êm ái, giày đế cao, giày độn gót",48000,48000,0,0
TIKI,giay-dep-nu,187188390,"Sơn Repaint giày - Phục hồi đế giày và che vết nứt  trên đế giày (30ml) - buybox - BBPK213",75000,100000,25000,25
TIKI,giay-dep-nu,72640100,"Dép bông đi trong nhà chống trơn trượt cao cấp - Hàng nhập khẩu",80000,80000,0,0
TIKI,giay-dep-nu,105159478,"Chai Xịt Khử Mùi Giày Nano Xclean Nano Bạc 100ml AHT Corp Hương Bạc Hà - Khử Mùi, Diệt Khuẩn, Làm Sạch Giày Dép Hiệu Quả An Toàn",42000,99000,57000,58
TIKI,giay-dep-nu,200519451,"Giày búp bê  da bò mũi tròn màu xám đính nơ Trường Hải da mềm mại BB130",253000,299000,46000,15
TIKI,giay-dep-nu,92161380,"Chai xịt giày diệt khuẩn khử mùi hôi giày hôi chân nano bạc Nano Xclean For Shoes",39000,60500,21500,36
TIKI,giay-dep-nu,148932524,"giày nữ đẹp giá rẻ đế bằng,giày thể thao nữ đế cao su SUNO STORE GTTN04",152000,152000,0,0
TIKI,giay-dep-nu,74003235,"Giày thể thao sneaker nữ đế êm nhẹ thoáng khí thương hiệu ZAVAS - S396",180000,360000,180000,50
TIKI,giay-dep-nu,179235641,"Dép Bánh Mì Nam , Dép Bánh Mì Nữ , Dép Quai Ngang Nữ , Dép Nữ Thời Trang",65550,69000,3450,5
TIKI,giay-dep-nu,54362596,"Dép Sandal nữ đi mưa cao 3.5p thời trang mới nhất V241",54000,54000,0,0
TIKI,giay-dep-nu,59465312,"Giày búp bê nhựa nữ đi mưa, đi biển, dạo phố siêu xinh GN09",59000,59000,0,0
TIKI,giay-dep-nu,11333235,"Giày cao gót bít chân thời thượng cho chân nang thêm dài-160",139300,199000,59700,30
TIKI,giay-dep-nu,252563249,"Giày Nữ Đế Xuồng 5cm Da Bò Màu Đen Trường Hải DX115Đ",285000,285000,0,0
TIKI,giay-dep-nu,72851806,"Dép Bông Ulzang Caityn Hình Mèo Dễ Thương Cực Êm, Đế Nhựa Dẻo Được Khâu Rất Chắc Chắn. DP97",79000,79000,0,0
TIKI,giay-dep-nu,254903581,"Giày Sục nữ da bò đế xuồng 5cm mũi nhọn màu xanh đen Trường Hải S129 CÓ SIZE LỚN",261000,299000,38000,13
TIKI,giay-dep-nu,141490261,"Giày sandal nữ da bò thật BIGGBEN cao cấp SDN70",339000,450000,111000,25
TIKI,giay-dep-nu,180323823,"Giày thể thao nữ độn đế, sneaker loại cao cấp, 9cm tôn chiều cao, bằng da PU, SIÊU ÊM - SIÊU ĐẸP - SIEU BỀN",239000,239000,0,0
TIKI,giay-dep-nu,180104810,"Dép quai ngang đế cao nữ và nam, dép đi trong nhà nữ quai ngang đế cao chất liệu eva chống ngấm nước",54150,57000,2850,5
TIKI,giay-dep-nu,107667053,"Lót giày nam nữ êm chân bằng EVA cấu trúc vòm nâng đỡ lòng bàn chân, chống thốn và bảo vệ gót chân - buybox - BBPK177",55000,65000,10000,15
TIKI,giay-dep-nu,149969265,"Dép nhựa siêu nhẹ Bitis nữ",104000,104000,0,0
TIKI,giay-dep-nu,137966974,"Giày Cao Gót Nữ Pierre Cardin - PCWFWS159",490000,1690000,1200000,71
TIKI,giay-dep-nu,20235117,"Xi đánh giày Kangaroo Hàn Quốc - Nhập khẩu chính hãng",39000,39000,0,0
TIKI,giay-dep-nu,68385143,"Giày Mọi Moccasin Da Bò Thật Đế Cao Su Pixie X482",475000,475000,0,0
TIKI,giay-dep-nu,177482245,"Dép HT.NEO thiết kế mới lạ, độc đáo, trẻ trung, da cao cấp đi êm chân, thoải mái SDN100",140000,180000,40000,22
TIKI,giay-dep-nu,47293616,"Combo 01 cặp lót mũi giày cao su non và 01 cặp lót gót chân 2 trong 1 - buybox - BBPK09&50",45000,90000,45000,50
TIKI,giay-dep-nu,252596105,"Giày búp bê trơn da bò mũi vuông Trường Hải có 2 màu xanh ,đen GBB115",241000,285000,44000,15
TIKI,giay-dep-nu,196233252,"Dép quai ngang nữ hình gấu TEDDY MILK TEA thời trang hottrend năm 2022 Form nhỏ tăng 1-2 Size",53865,56700,2835,5
TIKI,giay-dep-nu,189266374,"Miếng lót giày cao cấp ép vải, hạt lồi tặng độ bám giúp giảm size giày và chống đau gót sau - BuyBox - BBPK198",25000,35000,10000,29
TIKI,giay-dep-nu,50182055,"Giày búp bê nữ đế bằng nhựa đi mưa siêu bền đi thoáng và êm chân full size nhiều màu V217",55000,55000,0,0
TIKI,giay-dep-nu,206123708,"Giày thể thao nam nữ phong cách mới – G1009NY",874000,1960000,1086000,55
TIKI,giay-dep-nu,197663700,"Dép Lông Mang Trong Nhà Hình Trái Cây- Hàng Chính Hãng",146280,159000,12720,8
TIKI,giay-dep-nu,199520284,"Dép nhà tắm Emhome, Dép đi trong nhà hình ô vuông chống trượt, hấp thụ sốc giúp êm mềm thoải mái bàn chân - Hàng chính hãng",72680,79000,6320,8
TIKI,giay-dep-nu,104438755,"Giày nhựa đi mưa, đi biển - Chất liệu siêu nhẹ - GN10",51000,51000,0,0
TIKI,giay-dep-nu,73980665,"Giày thể thao nữ giày sneaker nữ màu trắng đế 3cm bằng da màu trắng hiệu ZAVAS - S387",339000,360000,21000,6
TIKI,giay-dep-nu,108747100,"Chai xịt giày khử mùi hôi giày hôi chân Nano Xclean For Shoes 100ml - Hương Trà Xanh - Nano Bạc AHT Corp (AHTC)",59000,99000,40000,40
TIKI,giay-dep-nu,41805495,"Giày thể thao nữ - giày sneaker nữ mầu trắng đế cao ST008W",168000,250000,82000,33
TIKI,giay-dep-nu,106605092,"Giày búp bê nữ BIGGBEN da bò cao cấp BB99",289000,400000,111000,28
TIKI,giay-dep-nu,177772693,"Giày sandal nữ BIGGBEN cao 4,5cm SDN76",349000,500000,151000,30
TIKI,giay-dep-nu,178470868,"Sét 2 miếng lót gót chân cao su mềm bảo vệ gót chân khi mang giày ,chống nứt gót ,bảo vệ mắt cá ,chống đau chân",49000,49000,0,0
TIKI,giay-dep-nu,128086563,"NÚT BỌC GÓT GIÀY CAO GÓT CÓ LINE CỐ ĐỊNH",35000,35000,0,0
TIKI,giay-dep-nu,57382862,"Dép Đi Trong Văn Phòng - Trong Nhà Tắm Chống Trơn Trượt Lock&Lock ETM645",96000,170000,74000,44
TIKI,giay-dep-nu,205299054,"Chai xịt tạo bọt vệ sinh giày cao cấp, chất tẩy rửa giày, làm sạch, trắng sáng và khử mốc giày hiệu quả - Hàng chính hãng",47000,55000,8000,15
TIKI,giay-dep-nu,107675669,"Lót giày vòm cao ốp nhựa chuyên dùng cho bàn chân bẹt phẳng cải thiện dáng đi chân chữ X, giảm đau mỏi lòng bàn chân - buybox - V01BBPK179",63000,69000,6000,9
TIKI,giay-dep-nu,195536360,"Giày Sandal Nữ Da Bò Thật BIGGBEN Cao Cấp SDN84",319000,350000,31000,9
TIKI,giay-dep-nu,195465100,"1 Đai nẹp hỗ trợ định hình ngón chân cái phiên bản CAO CẤP, điều chỉnh dễ dàng, tiện dụng #52",130000,130000,0,0
TIKI,giay-dep-nam,121309092,"Giầy la hán",320000,320000,0,0
TIKI,giay-dep-nam,180364178,"Dép tông lào, Dép kẹp nam Thái Lan siêu nhẹ Mixstar - (MV 2012 - 2111 - 2059)",60000,60000,0,0
TIKI,giay-dep-nam,144181471,"Dép tổ ong xịn màu đen siêu bền dép nhựa nam chống trơn trượt dép nam quai nganh dép nhựa mang lao động dép đi biển",59500,59500,0,0
TIKI,giay-dep-nam,107801745,"Cây giữ form giày bằng gỗ nguyên bản bền bỉ cho nam nữ XIMO Hemu (XCGFG10)",149000,288000,139000,48
TIKI,giay-dep-nam,96308272,"Giày sục nam da bò cao cấp,sapo nam trẻ trung năng động khoá chống rỉ sét màu đen-S051 Bảo hành 12 tháng",493000,493000,0,0
TIKI,giay-dep-nam,144916491," Giày nam trẻ trung hiện đại phong cách Hàn Quốc - 5560",429000,799000,370000,46
TIKI,giay-dep-nam,72595725,"Giày mọi nam đế âm HÀ NAM da bò thật cao cấp GDA2026",692000,692000,0,0
TIKI,giay-dep-nam,196200363,"Giày Thể Thao Nam Sneaker Vải Lưới Thoáng Khí Mát Chân Không Mùi, Đế Cao Su Non G190",59000,100000,41000,41
TIKI,giay-dep-nam,171535712,"Dép quai ngang nam nữ M Masler-MT màu xanh dương 4 sọc xám với lớp đế êm chân và chống trượt XD4X",298000,298000,0,0
TIKI,giay-dep-nam,116631768,"Giày Boots Chelsea zip Boot Black da bò",720000,720000,0,0
TIKI,giay-dep-nam,126257693,"Đón gót giày gỗ tự nhiên nguyên khối - Dài 22cm (DGH906) Cho giày Nam & Nữ",40000,40000,0,0
TIKI,giay-dep-nam,183068284,"Dép kẹp nam quai dù siêu bền KEEDO KD1396",280000,280000,0,0
TIKI,giay-dep-nam,41863795,"Giày Da Nam Cao Cấp Phong Cách Trẻ Trung Năng Động Lịch lãm, Giày Tây Nam Da Bò HS08",350000,350000,0,0
TIKI,giay-dep-nam,206230645,"Giày Sneaker Thời Trang Converse Chuck Taylor All Star All White - 1U647",1450000,1450000,0,0
TIKI,giay-dep-nam,175567406,"(5 Màu) Dép nữ nam độn đế 2 Ulzang Gấu XX, chất liệu eva siêu bền không ngấm nước( xả hàng)",43000,43000,0,0
TIKI,giay-dep-nam,56921537,"Dép kẹp Crocs Crocband  UNISEX 11033",767000,1095000,328000,30
TIKI,giay-dep-nam,21981293,"Giày rọ nam Huy Hoàng da bò màu nâu HT7787",909000,909000,0,0
TIKI,giay-dep-nam,127388483,"Giày nam cao cổ da thật cao cấp giày nam thời trang kiểu dáng Hàn Quốc mã 78788",999000,1690000,691000,41
TIKI,giay-dep-nam,167501148,"Giày Da Nam Mã CK02 Loại Cổ Lửng, Da Bò",550000,1100000,550000,50
TIKI,giay-dep-nam,113304468,"CHAI NƯỚC ĐÁNH GIÀY THẦN THÁNH ",19000,19000,0,0
TIKI,giay-dep-nam,172472682,"Giày Sandal Nam The Bily 3 Quai Ngang - Màu Xám Thổ Cẩm BL04",349000,349000,0,0
TIKI,giay-dep-nam,96305940,"Giày sục nam da bò cao cấp,sapo nam trẻ trung năng động khoá chống rỉ sét màu đen dập vân cá sấu-S05 Bảo hành 12 tháng",483000,483000,0,0
TIKI,giay-dep-nam,35880826,"Giày tây công sở nam PU3",150000,150000,0,0
TIKI,giay-dep-nam,14241563,"Dép bít mũi nam da bò cao cấp đen",290000,339000,49000,14
TIKI,giay-dep-nam,58134837,"GIẦY THỂ THAO NAM SIÊU NHẸ KIỂU DÁNG CAO CẤP",150000,150000,0,0
TIKI,giay-dep-nam,76171558,"DÉP DA BÒ NAM 100%, QUAI LƯNG CÁ SẤU",229000,370000,141000,38
TIKI,giay-dep-nam,181922052,"Dép nam Đông Hải quai ngang da bò cao cấp thiết kế  quai dán thời trang đế cao su chắc chắn - D3218",690000,690000,0,0
TIKI,giay-dep-nam,145236482,"Giày Nhựa Nam Cột Dây Cao Cấp Siêu Êm GIAY-003-2",527000,527000,0,0
TIKI,giay-dep-nam,172472575,"Giày Sandal Nam The Bily 3 Quai Ngang - Màu Xám BL04",349000,349000,0,0
TIKI,giay-dep-nam,129354450,"Sandal Vento Nam Nữ Quai Ngang Xuất Khẩu  NB02",385000,385000,0,0
TIKI,giay-dep-nam,110992969,"Giày thể thao nam, giày sneaker nam Trắng xám off dream k553",250000,250000,0,0
TIKI,giay-dep-nam,105524091,"Lót Giày Vải Quế Thơm Nam Thấm Hút Mồ Hôi Êm Chân Rất Bền L07",10000,10000,0,0
TIKI,giay-dep-nam,108432652,"GIày Sandal Nam Da Bò BIGGBEN Cao Cấp SD115",369000,450000,81000,18
TIKI,giay-dep-nam,149780792,"Giày oxford nam ORSIL chất liệu da lộn thời trang - ORSIL08",299000,509000,210000,41
TIKI,giay-dep-nam,5435571,"Dép bít đầu- dép sục da bò thật VO Shoes_KK42",400000,450000,50000,11
TIKI,giay-dep-nam,89933080,"Giầy tây nam công sở 20498",523600,582100,58500,10
TIKI,giay-dep-nam,171733897,"HAVAIANAS - Dép nam Top Fortnite 4146366",749000,749000,0,0
TIKI,giay-dep-nam,98355398,"Dép quai ngang thời trang nam siêu bền đẹp",139000,275000,136000,49
TIKI,giay-dep-nam,67291183,"LÓT GIÀY BẰNG DA BÒ MIẾNG",31000,31000,0,0
TIKI,giay-dep-nam,106305229,"Giày Nam S69 Kiểu Dáng Thể Thao Màu Đen Năng Động",80000,80000,0,0
TIKI,giay-dep-nam,87108557,"Giày Sneaker Nam Da Bê Siêu Nhẹ TOMOYO TMN60701",2890000,2890000,0,0
TIKI,giay-dep-nam,206266313,"Giày Nam Doctor Matin - Giày đốc trơn da mềm sang trọng phong cách Hàn Quốc Da trơn",199000,199000,0,0
TIKI,giay-dep-nam,168273906,"Lót giày thể thao êm chân tăng 0,5 Size Thoáng khí XLGTT01",30000,50000,20000,40
TIKI,giay-dep-nam,107016933,"Dép Xỏ Ngón Nam Da Bò BIGGBEN DK82",299000,450000,151000,34
TIKI,giay-dep-nam,180365695,"Giày Sneaker Nam, Giày Nam Da Thật Hàng Cao Cấp Kiểu Mới 2022",189000,189000,0,0
TIKI,giay-dep-nam,69535199,"Lót giày độn đế Silicon tăng chiều cao, chống đau chân ( Bộ chuẩn 10 miếng lắp ghép 1 đôi giày) ",39000,39000,0,0
TIKI,giay-dep-nam,173234115,"Giày nam Da bò Giày Thời Trang cỡ lớn giày nam công sở sang trọng 20893",423900,423900,0,0
TIKI,giay-dep-nam,59168538,"Dép Xỏ Ngón Nam Da Bò BIGGBEN DK68",319000,400000,81000,20
TIKI,giay-dep-nam,8421386,"Dép Nam Bảng Ngang BIGGBEN Da Bò Thật DN137",319000,400000,81000,20
TIKI,giay-dep-nam,129352307,"Giày Sandal Nam Vento Quai Chéo Xuất Khẩu NV4538",320000,320000,0,0
TIKI,giay-dep-nam,167011221,"MLB - Giày mule thời trang Playball Origin 3AMUUA11N",1690000,1690000,0,0
TIKI,giay-dep-nam,97585553,"Giày Lười Da Nam Cao Cấp - Chất Liệu Da Mềm 100% - Đế Cao Su CAO 3CM - Mã G004 Màu Đen",210000,210000,0,0
TIKI,giay-dep-nam,15638856,"Giày Lười Nam Tomoyo da đế âm TMN05601",2490000,2490000,0,0
TIKI,giay-dep-nam,6605805,"Dép SaBo Nam BIGGBEN Da Bò Thật Cao Cấp SB26",339000,450000,111000,25
TIKI,giay-dep-nam,111586475,"Giày thể thao Sneaker nam thấp cổ mẫu 03 hàng nhập Quảng Châu",50000,50000,0,0
TIKI,giay-dep-nam,13365811,"Giày Lười Nam Da Bò Cao Cấp D006",210000,210000,0,0
TIKI,giay-dep-nam,55954576,"Giày tây nam Trường Hải da bò cao cấp GTN0123",405000,479000,74000,15
TIKI,giay-dep-nam,115958499,"Giày Sandal Nam HÀ NAM Da Bò Thật Cao Cấp DNA2136",496000,496000,0,0
TIKI,giay-dep-nam,125782082,"Dép lào thái",59999,59999,0,0
TIKI,giay-dep-nam,177772830,"Dép Nam Xỏ ngón Thái Lan Quai Kẹp GM 11401",240000,240000,0,0
TIKI,giay-dep-nam,184467582,"Giày Sneaker Đế Cao Nam Nữ màu trắng sang, đủ size từ 36 đến 43 khâu mũi phối sọc thời trang",280000,280000,0,0
TIKI,giay-dep-nam,191908085,"GIÀY SỤC VẢI CROSS LITERIDE MESH MULE MÀU NAVY dành CHO NAM",450000,450000,0,0
TIKI,giay-dep-nam,143221499,"Giày thể thao nam Sneaker03, đế casu chống trơn trượt, thời trang phong cách trẻ - Trắng",50000,50000,0,0
TIKI,giay-dep-nam,22917827,"Dép Nam BIGGBEN Da Bò Thật Cao Cấp DN175",309000,400000,91000,23
TIKI,giay-dep-nam,100128769,"Sandal nam quai ngang da bò Đông Hải - S3216",790000,790000,0,0
TIKI,giay-dep-nam,169100704,"Dép Nam Quai Da Bò Loại Bền Đẹp Đây ( Mã DE01)",300000,600000,300000,50
TIKI,giay-dep-nam,105522183,"Giày Sneaker nam, Giày thể thao da nam, ba màu đen - xanh - trắng, đế cao su nguyên khối, đế nén khí đàn hồi G147",149000,149000,0,0
TIKI,giay-dep-nam,189172796,"Giày Sneakers Nam GEOX U Kennet A",4100000,4100000,0,0
TIKI,giay-dep-nam,63238091,"GIÀY SANDAL NAM GIAVY QUAI NGANG SL474",200000,200000,0,0
TIKI,giay-dep-nam,6012203,"Dép Nam Quai Ngang",169000,169000,0,0
TIKI,giay-dep-nam,153257924,"Giầy Sandal Nam Đế Chữ - quai hậu nam học sinh quai ngang Đế Chữ",138000,138000,0,0
TIKI,giay-dep-nam,8189688,"Lót Giày Nam Cao Cấp Run Sport - Lót Giầy Thể Thao Chuyên Dụng",45000,45000,0,0
TIKI,giay-dep-nam,99944957," Giày thể thao nam, giày sneaker nam Trắng xám off dream k553",250000,250000,0,0
TIKI,giay-dep-nam,178608393,"SandaI Vento Bít Bũi Dã Ngoại NV7604",330000,330000,0,0
TIKI,giay-dep-nam,184418758,"Giày tây nam cổ thấp da bò Lucas Derby Black 01",720000,720000,0,0
TIKI,giay-dep-nam,90883247," Giày thể thao nam, giày sneaker nam Trắng xám off dream k553",250000,250000,0,0
TIKI,giay-dep-nam,104616280,"Giày thể thao nam thoáng khi phong cách hàn quốc ts03",50000,50000,0,0
TIKI,giay-dep-nam,84936233,"Giày thể thao nam sneaker đế 2 lớp nam tính G183",55000,90000,35000,39
TIKI,giay-dep-nam,171536365,"Dép quai ngang nam nữ M Masler-MT đan mạch vàng với lớp đế chống nước, chống trượt và quai êm chân DMV",458000,458000,0,0
TIKI,giay-dep-nam,144347672,"Giày nam mũi tròn bigsize da bò cao cấp Trường Hải đế cao su may chắc chắn không trơn",439000,550000,111000,20
TIKI,dien-tu-dien-lanh,171616994,"Điều Hòa Funiki Inverter 18000Btu HIC18TMU - Chỉ giao Hà Nội",10800000,11720000,920000,8
TIKI,dien-tu-dien-lanh,113490577,"TV QLED 55'' 4K Android 11 Tivi TCL 55C725 - Gam Màu Rộng , HDR 10+, MEMC , Dolby Audio - HÀNG CHÍNH HÃNG",12500000,12500000,0,0
TIKI,dien-tu-dien-lanh,186516727,"Tủ Lạnh Sanaky 140 Lít VH-148HPD - Hàng chính hãng- Giao tại Hà Nội",5550000,5550000,0,0
TIKI,dien-tu-dien-lanh,120462218,"Chuột bay điều khiển giọng nói G10s",99000,99000,0,0
TIKI,dien-tu-dien-lanh,170492909,"Bình Nước Nóng Atlantic Nanto WIFI - Hàng chính hãng",3790000,3790000,0,0
TIKI,dien-tu-dien-lanh,126702135,"Điều khiển tivi dành cho Samsung BN7700 dùng cho các series 6990\7300\7700\8800\8900\9800 ",550000,550000,0,0
TIKI,dien-tu-dien-lanh,94902444,"REMOTE ĐIỀU KHIỂN DÀNH CHO TIVI SONY CÓ TÌM KIẾM GIỌNG NÓI TX310p",175000,175000,0,0
TIKI,dien-tu-dien-lanh,459580,"Máy Nước Nóng Ferroli QQ EVO 30L TE (2500W)",2450000,2450000,0,0
TIKI,dien-tu-dien-lanh,54400391,"Tủ Lạnh Inverter Samsung RB30N4010BU/SV (310L) - Hàng Chính Hãng - Chỉ Giao tại Hà Nội",10900000,10900000,0,0
TIKI,dien-tu-dien-lanh,126702145,"Điều khiển cho điều hòa dành cho LG 1 chiều (ngắn) ",57000,60000,3000,5
TIKI,dien-tu-dien-lanh,91171876,"Công tắc bật tắt máy bớm nước từ xa công suất lớn 30A/220V khoảng cách 1Km 6220ZR- CHÍNH HÃNG HONEST,điều khển từ xa",125000,125000,0,0
TIKI,dien-tu-dien-lanh,90163723,"Máy giặt Samsung AI Inverter 10kg WW10T634DLX/SV - Chỉ giao Hà Nội",10200000,10200000,0,0
TIKI,dien-tu-dien-lanh,96013656,"Công tắc cửa dành cho máy giặt Electrolux 3 chân inverter đuôi 43 44",275000,275000,0,0
TIKI,dien-tu-dien-lanh,195480645,"Smart Tivi LG 4K 70 inch 70UQ8000PSC - Model 2022",14590000,14590000,0,0
TIKI,dien-tu-dien-lanh,197574524,"Máy Rửa Chén Độc Lập Ecalite EDW-SMS6015AS - 14 Bộ - 8 Chương Trình Rửa - Tự Động Hé Cửa - Hàng Chính Hãng",8000000,15300000,7300000,48
TIKI,dien-tu-dien-lanh,10640238,"Máy Giặt Cửa Trên Inverter Aqua AQW-D90CT-BK (9kg) - Hàng Chính Hãng",7690000,7690000,0,0
TIKI,dien-tu-dien-lanh,197150207,"Máy rửa bát TEXGIO TGFPCM795B Dung tích 14 bộ Rút ngắn thời gian rửa Có thể chọn giàn rửa Sấy khô chén đĩa Rửa sạch sâu - Hàng Chính Hãng",13000000,13000000,0,0
TIKI,dien-tu-dien-lanh,114993684,"Tủ lạnh Panasonic Inverter 234 lít NR-TV261APSV - Chỉ giao tại Hà Nội",7250000,7250000,0,0
TIKI,dien-tu-dien-lanh,126702220,"Remote Điều khiển điều hoà dành cho Gree các dòng GWC GWH 1 chiều 2 chiều Inverter",95950,101000,5050,5
TIKI,dien-tu-dien-lanh,53243578,"Tủ đông Hòa Phát HCF 666S1Đ2 352 lít - Hàng Chính Hãng",7870000,7870000,0,0
TIKI,dien-tu-dien-lanh,53611301,"Điều khiển thay thế điều khiển FPT Play box 2018",113000,113000,0,0
TIKI,dien-tu-dien-lanh,32925581,"Tủ Lạnh Inverter Electrolux EBE4500B-G (421L) - Hàng Chính Hãng (Vàng)",13590000,13590000,0,0
TIKI,dien-tu-dien-lanh,195959418,"Tủ lạnh Toshiba Inverter 249 lít GR-RT325WE-PMV(06)-MG - Hàng chính hãng [Giao hàng toàn quốc]",7490000,9990000,2500000,25
TIKI,dien-tu-dien-lanh,16861594,"Điều khiển dùng cho quạt cây Panasonic",76000,76000,0,0
TIKI,dien-tu-dien-lanh,13674032,"Máy nước nóng trực tiếp Ferroli Slim Divo SSN 4500W - Hàng Chính Hãng",1864800,1864800,0,0
TIKI,dien-tu-dien-lanh,53450133,"Tủ đông Hòa Phát HCF 656S2N2 271 lít - Hàng Chính Hãng",7650000,7650000,0,0
TIKI,dien-tu-dien-lanh,113761486,"Quạt dành cho  tủ lạnh Nidec 8x8 cm 2 dây 12V",120000,120000,0,0
TIKI,dien-tu-dien-lanh,17882661,"Điều khiển đầu KTS Hùng Việt cho các model thường-hàng chính hãng",29000,29000,0,0
TIKI,dien-tu-dien-lanh,192725846,"Máy rửa bát hiện đại BAUER SBW21EU13F - Hàng chính hãng",20680000,20680000,0,0
TIKI,dien-tu-dien-lanh,1502125,"Tủ lạnh Sharp Inverter 165 lít SJ-X196E-DSS",4729000,4729000,0,0
TIKI,dien-tu-dien-lanh,188829115,"Ron cửa cho tủ lạnh Panasonic model NR BC369Q",273000,273000,0,0
TIKI,dien-tu-dien-lanh,32977521,"Máy đun nước nóng Hải Âu NHA30",8960000,8960000,0,0
TIKI,dien-tu-dien-lanh,126702015,"Remote Điều khiển từ xa điều hòa dành cho LG-Dùng cho các dòng J V10 V13 V18 9000BTU 12000BTU 18000BTU 1 chiều 2 chiều Inverter",54150,57000,2850,5
TIKI,dien-tu-dien-lanh,19480120,"Anten GPS/SMA GPS-001",69000,69000,0,0
TIKI,dien-tu-dien-lanh,119822216,"Remote Điều khiển tivi dành cho Samsung giọng nói BN59-01298G năm 2015,2016,2017,2018",165000,165000,0,0
TIKI,dien-tu-dien-lanh,460183,"Tủ Đông Sanaky VH-2899W1 (220L) - Hàng Chính Hãng",7600000,7600000,0,0
TIKI,dien-tu-dien-lanh,186740265,"Tủ lạnh Samsung Inverter 302 Lít RT29K503JB1/SV -Hàng chính hãng- Giao tại Hà Nội",9500000,9500000,0,0
TIKI,dien-tu-dien-lanh,114963528,"Remote dành cho máy lạnh TOSHIBA",68000,68000,0,0
TIKI,dien-tu-dien-lanh,102108848,"Thanh magie trong máy nước nóng năng lượng mặt trời",125000,125000,0,0
TIKI,dien-tu-dien-lanh,113048674,"Điều khiển điều hòa đa năng K-100ES",59800,59800,0,0
TIKI,giay-dep-nu,87142469,"Giày Lười Nam Penny Loafer Tomoyo TMN07401",2890000,2890000,0,0
TIKI,giay-dep-nu,73215208,"Giày Da Nam Mã CS003",450000,900000,450000,50
TIKI,giay-dep-nu,101655661,"Giày Tây Tăng Chiều Cao 6cm Đệm Khí Giầy Da Tăng Chiều Cao Sans111",369000,369000,0,0
TIKI,giay-dep-nu,156214474,"GIÀY LƯỜI ĐÍNH KHUY NAM DA BÒ THẬT 100% CAO CẤP",750000,750000,0,0
TIKI,giay-dep-nu,42899678,"Giày Sneaker thể thao nam cổ cao trắng đen phố họa tiết ST018",259000,411000,152000,37
TIKI,giay-dep-nu,248400066,"Giày sĩ quan công ty 32 cấp tướng, giày da nam Aseco 32 mã 729 đế hơi",1180000,1180000,0,0
TIKI,giay-dep-nu,193735877,"Giày Lười Nam Màu Ghi s046 Đế bệt",105000,150000,45000,30
TIKI,giay-dep-nu,190541766,"Dép quai kẹp đế cao su Bitis nam",280000,280000,0,0
TIKI,giay-dep-nu,149492536,"Giày thể thao màu trắng Converse Chuck Taylor 1970s Low 162065C",1900000,1900000,0,0
TIKI,giay-dep-nu,119288071,"Dép Nam Quai Ngang TiTi ĐÔ Da Bò Thật Cao Cấp DNA2132a",420000,420000,0,0
TIKI,giay-dep-nu,67247490,"Giày Lười Nam BANULI K1ML1T0 (Giày Nam Da Bò Nhập Khẩu Nguyên Con, Đế Siêu Nhẹ Siêu Êm)",1500000,1500000,0,0
TIKI,giay-dep-nu,57381733,"Giày Thể Thao Sneaker Nam Pettino GT03T (Trắng - Đen)",109000,200000,91000,46
TIKI,giay-dep-nu,105521937,"Lót giày trơn, lót giày nam nữ cực êm, không bong màu đen",9000,9000,0,0
TIKI,giay-dep-nu,175969848,"Dép Quai Ngang Nam Cao Cấp Da Bò Thật KEEDO-KD3304 - Đen",340000,340000,0,0
TIKI,giay-dep-nu,153995579,"Giày lười nam da thật đẳng cấp  thời trang-26134",529000,899000,370000,41
TIKI,giay-dep-nu,96180083,"Đông Hải - Giày Tây Nam G01A4",1690000,1690000,0,0
TIKI,giay-dep-nu,11502185,"Giày Sneaker Nam GV008",99000,99000,0,0
TIKI,giay-dep-nu,171535923,"Dép quai ngang nam nữ M Masler-MT đan mạch xám với lớp đế chống nước bền bỉ và quai êm chân DMX",458000,458000,0,0
TIKI,dien-tu-dien-lanh,35905883,"Remote Điều Khiển Dùng Cho Máy Lạnh, Điều Hòa DAIKIN ARC433A7, ARC433A8",47000,47000,0,0
TIKI,giay-dep-nu,151952872,"Dép nam quai ngang da bò cao cấp",239000,239000,0,0
TIKI,dien-tu-dien-lanh,65410481,"Máy giặt LG Inverter 9 kg FV1409S4W - Chỉ giao HCM",9150000,9150000,0,0
TIKI,dien-tu-dien-lanh,56105954,"Máy sấy cửa trước Electrolux EDC704GEWA (7kg) - Hàng chính hãng - Chỉ giao tại Hà Nội",14990000,14990000,0,0
TIKI,dien-tu-dien-lanh,66370486,"Máy Rửa Bát Sevilla SV-R08 - HÀNG CHÍNH HÃNG",7550000,7550000,0,0
TIKI,giay-dep-nu,55106110,"Giày Tây Nam Da Bò BIGGBEN Cao Cấp GT170",599000,600000,1000,0
TIKI,giay-dep-nu,55062727,"Dép Nam Da Bò BIGGBEN Cao Cấp DN251",349000,400000,51000,13
TIKI,dien-tu-dien-lanh,164092631,"Android Tivi Sharp 4K 70 inch 4T-C70CK3X",27000000,27000000,0,0
TIKI,giay-dep-nu,180574439,"Dép xỏ ngón Vento ARROW Nữ đi biển/đi chơi NB0508",245000,245000,0,0
TIKI,dien-tu-dien-lanh,3738813,"Máy Nước Nóng Gián Tiếp FERROLI VERDI 15L AE (2500W) - Hàng Chính Hãng",2518000,2518000,0,0
TIKI,giay-dep-nu,50242384,"Combo 2 chai tẩy trắng vệ sinh giày dép đánh bóng túi xách có đầu chà màu ngẫu nhiên",24000,24000,0,0
TIKI,dien-tu-dien-lanh,55750909,"MÁY NƯỚC NÓNG TRỰC TIẾP AMORE GSP có bơm tăng áp - Hàng Chính Hãng",2888000,2888000,0,0
TIKI,giay-dep-nu,135898801,"Giày Tây Nam Trung Niên Giả Dây",199000,199000,0,0
TIKI,giay-dep-nu,71961824,"Giày mọi nam đế âm HÀ NAM da bò thật cao cấp GDA2020",692000,692000,0,0
TIKI,giay-dep-nu,170384383,"Dép Nam Quai Ngang TiTi ĐÔ Da Bò Thật Cao Cấp DNA2175c",389000,389000,0,0
TIKI,dien-tu-dien-lanh,119692012,"CÔNG TẮC CỬA MÁY GIẶT ELECTROLUX EWF 10843, 10844, 10744, 12843, 85743, 12944 - HÀNG CHÍNH HÃNG",320000,320000,0,0
TIKI,dien-tu-dien-lanh,53452464,"Tủ đông Hòa Phát Inverter 205 lít HCFI 506S2Đ2 - Hàng Chính Hãng",7550000,7550000,0,0
TIKI,dien-tu-dien-lanh,71950259,"Máy Nước Nóng Gián Tiếp Ariston Vitaly Slim 20L",2069000,2069000,0,0
TIKI,dien-tu-dien-lanh,186740377,"Tủ lạnh Samsung Inverter 322 Lít RT32K503JB1/SV- Hàng chính hãng- Giao tại Hà Nội",9300000,9300000,0,0
TIKI,giay-dep-nu,97754334,"Giày Sandal phong cách thời trang  Nhật Bản đế mềm chất liệu da bò thật phù hợp với các mùa trong năm mã 12129",219000,429000,210000,49
TIKI,dien-tu-dien-lanh,119821943,"Điều khiển điều hòa dành cho Daikin Inverter",55000,55000,0,0
TIKI,giay-dep-nu,15333267,"Sandal Nam Bít Đầu BIGGBEN Da Bò Thật SD85",449000,550000,101000,18
TIKI,giay-dep-nu,110448724,"Giày lười vải nam thời trang - GN07",99000,99000,0,0
TIKI,giay-dep-nu,92901105,"Giày quai ngang nam/ dép quai hậu quai ngang thời trang trẻ trung năng động -mã 58020",399000,759000,360000,47
TIKI,giay-dep-nu,14272935,"Dép bít mũi rọ đen nam trường hải da bò cao cấp BM033",273000,319000,46000,14
TIKI,giay-dep-nu,58837555,"DÉP NAM QUAI KẸP GIA VY TA121",195000,195000,0,0
TIKI,dien-tu-dien-lanh,86765491,"Lưới lọc máy giặt, túi lọc rác máy giặt",35000,35000,0,0
TIKI,dien-tu-dien-lanh,56015185,"Remote Điều Khiển Cho TV LCD LG, TV LED LG RM-L915 (Kèm Pin AAA Maxell)",48900,48900,0,0
TIKI,dien-tu-dien-lanh,272405971,"Máy giặt mini cao cấp- máy giặt quần áo trẻ em 5 kg",980000,980000,0,0
TIKI,dien-tu-dien-lanh,83673270,"Remote Điều Khiển Tivi LCD, TV LED Dành Cho SHARP RM-L1238",41000,41000,0,0
TIKI,dien-tu-dien-lanh,167549364,"Smart Tivi Crystal Samsung 4K 85 inch UA85BU8000 - Model 2022",39940000,39940000,0,0
TIKI,giay-dep-nu,132372006,"Giày lười nam - Slip on nam da - Mã S193",350000,350000,0,0
TIKI,dien-tu-dien-lanh,188665473,"Tủ lạnh Panasonic NR-CW530XMMV 3 cửa  495 Lấy nước ngoài, Làm đá tự động, Hàng chính hãng, chỉ giao Tại Hà Nội",39500000,39500000,0,0
TIKI,giay-dep-nu,177665631,"Dép Nam Quai Ngang Da Bò Thật BIGGBEN Cao Cấp DN307",289000,400000,111000,28
TIKI,giay-dep-nu,9999100,"Giày tây nam Oxford Tomoyo đen bóng TMN92101",2890000,2890000,0,0
TIKI,dien-tu-dien-lanh,43179426,"Tấm chắn điều chỉnh hướng gió cho máy lạnh",39000,39000,0,0
TIKI,dien-tu-dien-lanh,55067938,"Điều Hòa Inverter Daikin FTKA50UAVMV (17.100Btu) - Hàng Chính Hãng - Chỉ Giao tại Hà Nội",16950000,16950000,0,0
TIKI,dien-tu-dien-lanh,209389670,"Sò lạnh dành cho tủ lạnh SANYO",40000,40000,0,0
TIKI,dien-tu-dien-lanh,113048859,"Điều khiển điều hoà Nagakawa 2 chiều",52000,52000,0,0
TIKI,giay-dep-nu,96299929,"Dép quai hậu nam đế mềm êm, nhẹ thoáng khí  phong cách Nhật Bản mã 58237-8",409000,798000,389000,49
TIKI,giay-dep-nu,147217894,"Giày Sandal Nam The Bily Quai Ngang - Màu Trắng BL03T",339000,339000,0,0
TIKI,dien-tu-dien-lanh,195343304,"Máy tắm nước nóng 3500W NanoShower (Kèm Vòi và Dây) - Home and Garden",1380000,1380000,0,0
TIKI,dien-tu-dien-lanh,88078084,"Smart Tivi Qled The Frame Samsung 4K 50 inch QA50LS03A",27900000,27900000,0,0
TIKI,giay-dep-nu,68155550,"Giày da cao cổ nam và nữ phong cách Hàn Quốc mã 8634-5",859000,1590000,731000,46
TIKI,giay-dep-nu,130412234,"Giày nam, giày thể thao nam G fashion - Z888",200000,200000,0,0
TIKI,dien-tu-dien-lanh,121252492,"Android Tivi TCL 4K 43 inch 43P615 - Hàng chính hãng",7600000,7600000,0,0
TIKI,giay-dep-nu,127580599,"Giày Boots Doc.058 Crazy Horse da bò sáp ngựa",769000,769000,0,0
TIKI,dien-tu-dien-lanh,83344533,"Tủ lạnh Electrolux Inverter 335L EBB3742K-H - Chỉ giao Hà Nội",10790000,10790000,0,0
TIKI,dien-tu-dien-lanh,206232691,"Đế Lót Chân Máy Giặt, Bàn Ghế, Tủ Lạnh Chống Trơn, Trượt, Rung Chất Liệu Silicon Cao Cấp K73",6800,12000,5200,43
TIKI,dien-tu-dien-lanh,91272435,"Giá Treo TiVi Xoay North Bayou SP5 Lắp Cho Màn Hình 50 inch - 90 inch Nhập Khẩu",1696000,1696000,0,0
TIKI,dien-tu-dien-lanh,136825958,"Máy giặt LG Inverter 10 kg FV1410S5W - Chỉ giao tại HCM",9890000,9890000,0,0
TIKI,dien-tu-dien-lanh,20521067,"Tủ Lạnh Inverter LG GN-D255BL (255L) – Hàng Chính Hãng",7680000,7680000,0,0
TIKI,dien-tu-dien-lanh,73522270,"Điều khiển Remote dành cho máy lạnh Panasonic Inverter",63000,63000,0,0
TIKI,dien-tu-dien-lanh,71122697,"Remote Điều Khiển Dành Cho Tivi ASANZO, Ti Vi LCD, TV LED Asanzo",26900,26900,0,0
TIKI,dien-tu-dien-lanh,20551119,"Máy Giặt Cửa Trên Aqua AQW-U91CT-N (9kg) - Hàng Chính hãng",6190000,6190000,0,0
TIKI,dien-tu-dien-lanh,165964554,"Ron tủ lạnh  dành cho tủ lạnh SHARP Model SJ- X201E-DS",250000,250000,0,0
TIKI,dien-tu-dien-lanh,123602250,"Vỉ mạch Nguồn dành cho tivi LG 47 50 55 dùng cho các model LN LA",386000,386000,0,0
TIKI,dien-tu-dien-lanh,83419095,"Máy Lạnh Casper Inverter 12000 Btu HC-12IA32 - Chỉ giao Hà Nội",6890000,6890000,0,0
TIKI,dien-tu-dien-lanh,68760042,"Máy nước nóng Ariston SL2 20 RS - 2.5 - FE (2500W)",2999900,2999900,0,0
TIKI,dien-tu-dien-lanh,82231255,"Giá Treo Tivi Sát Tường Nhập Khẩu North Bayou NBC3-F (40-65inch)",239000,239000,0,0
TIKI,dien-tu-dien-lanh,155636599,"Máy giặt sấy Electrolux Inverter 9 kg EWW9024P5WB lồng ngang- Hàng chính hãng - Giao tại Hà Nội và 1 số tỉnh toàn quốc",13364000,13364000,0,0
TIKI,dien-tu-dien-lanh,191577328,"Tủ lạnh 20L mặt gương có đèn led, không gần tiếng ồn khi hoạt động, nút bật đèn cảm ứng với 3 chế độ đèn, Tủ lạnh 2 chế độ làm mát và giữ ấm tiên tiến - Giao hàng toàn quốc",1658000,1899000,241000,13
TIKI,giay-dep-nu,26738046,"Giày sneaker thể thao nữ buộc dây phong cách hàn quốc màu đen, trắng size 36 đến 40 V179",59000,59000,0,0
TIKI,giay-dep-nu,115715843,"Dép quai ngang nữ thời trang xinh xắn chống trơn trượt tốt",79000,79000,0,0
TIKI,giay-dep-nu,147340781,"Dép Eva Phun Nữ Biti's DEW007900XAM (Xám)",104000,104000,0,0
TIKI,giay-dep-nu,74300815,"Giày Búp Bê Nữ Da Bò BIGGBEN Cao Cấp BB75",309000,400000,91000,23
TIKI,giay-dep-nu,193614748,"Giày Thể Thao Nữ Biti's Hunter Core DSWH09400HOG (Hồng)",596000,794000,198000,25
TIKI,giay-dep-nu,83479559,"Lót gót giày 4D hình cánh bướm vân tròn chống trầy rách da và chống tuột gót chân - buybox - BBPK164",20000,40000,20000,50
TIKI,giay-dep-nu,68634180,"Giày Cao Gót Nữ 5cm Thời Trang JUNO Mules Mũi Nhọn Gót Trụ CG05097",446000,446000,0,0
TIKI,giay-dep-nu,37703250,"Giày Sandal Cao Gót BIGGBEN Da Bò Thật SDCG37",369000,450000,81000,18
TIKI,giay-dep-nu,36979369,"Giày Sandal Nữ BIGGBEN Da Bò Thật SDN48 - 35",279000,350000,71000,20
TIKI,giay-dep-nu,153257821,"Dép quai ngang bánh mì độn đế hình gấu mặt cười",45000,45000,0,0
TIKI,giay-dep-nu,22896307,"Giày thể thao nữ đi êm chân - GB2.5",159000,159000,0,0
TIKI,giay-dep-nu,129436031,"Giày thể thao sneaker nữ hoa cúc đi bộ cực êm siêu xinh V287",55000,55000,0,0
TIKI,giay-dep-nu,97103260,"Giày búp bê Doris đế bệt, ️️️️giày da mũi vuông có viền màu bò, thời trang cho nữ DR003",199000,199000,0,0
TIKI,giay-dep-nu,79712730,"Dép đúc Thái Lan nữ siêu nhẹ",45000,45000,0,0
TIKI,giay-dep-nu,52236446,"Giày Sandal Nữ Đế Xuồng BIGGBEN Da Bò Thật SDX14",339000,400000,61000,15
TIKI,giay-dep-nu,151952867,"Si đánh giày kèm bàn chải",49000,49000,0,0
TIKI,giay-dep-nu,195791153,"Dép Sục nữ đế độn 6cm siêu nhẹ kèm Sticker dễ thương - dép nữ hot trend 2022",96000,190000,94000,49
TIKI,giay-dep-nu,66499993,"Dép Nữ Da Bò BIGGBEN Cao Cấp DNQN32",299000,350000,51000,15
TIKI,giay-dep-nu,192881949,"Giày Nữ Pierre Cardin - PCWFWSG 175",490000,1490000,1000000,67
TIKI,giay-dep-nu,155024071,"Giày nữ, giày thể thao, giày nữ học sinh sinh viên, giày thời trang nữ mã F11",429000,799000,370000,46
TIKI,giay-dep-nu,8005161,"Giày Sandal Nữ BIGGBEN Da Bò Thật SDN0399",329000,450000,121000,27
TIKI,giay-dep-nu,128087865,"NÚT BỌC GÓT GIÀY KHIÊU VŨ",19000,19000,0,0
TIKI,giay-dep-nu,44784540,"DÉP ĐI TRONG NHÀ - DÉP BÔNG HÌNH LỢN",50000,50000,0,0
TIKI,giay-dep-nu,37719201,"Dép Nữ BIGGBEN Da Bò Thật Cao Cấp DNQN23",299000,450000,151000,34
TIKI,giay-dep-nu,192772454,"Giày Nữ Pierre Cardin - PCWFWSG 168",490000,1490000,1000000,67
TIKI,giay-dep-nu,88085917," Dép nữ xỏ ngón, dép kẹp quai lụa",89000,89000,0,0
TIKI,giay-dep-nu,153259051,"Dép quai ngang bánh mì nam nữ hoạ tiết couple đúc nguyên khối chất liệu EVA siêu nhẹ size đơn siêu đẹp",38000,38000,0,0
TIKI,giay-dep-nu,180380358,"Combo lót giày nam giảm size chống rộng và rớt gót chống đau chân hiệu quả dùng được nhiều loại giày rất tiện dụng",79000,79000,0,0
TIKI,giay-dep-nu,188565226,"Dép sục nữ bít mũi quai chéo",150000,150000,0,0
TIKI,giay-dep-nu,73476846,"Giày sneaker thể thao nữ buộc dây siêu nhẹ thời trang mới nhất V261",69000,69000,0,0
TIKI,giay-dep-nu,148935453,"Giày Thể Thao Nam Sneaker Siêu Nhẹ Êm Chân Mang Đi Làm ,Chạy Bộ,Tập Gym Chơi Thể Thao GNA01 SUNO STORE",149000,149000,0,0
TIKI,giay-dep-nu,147341192,"Dép Eva Phun Nữ Biti's DEW007900XNH",104000,104000,0,0
TIKI,giay-dep-nu,193878434,"Giày nữ giày lười vải đế cao su mềm cao 2p",139000,149000,10000,7
TIKI,giay-dep-nu,66563614,"Giày Sandal Nữ Đế Xuồng BIGGBEN Da Bò Thật SDX21",369000,450000,81000,18
TIKI,giay-dep-nu,76225151,"Quai giày ẩn trong suốt bằng silicon hỗ trợ mang giày dép cao gót chống tuột - buybox - BBPK39",12500,25000,12500,50
TIKI,giay-dep-nu,225933315,"Dép bánh mì Cross nữ đế 6cm siêu nhẹ kèm Sticker dễ thương - dép nữ hot trend 2022",170000,170000,0,0
TIKI,giay-dep-nu,172496517,"Dép Nam Nữ Quai ngang Bánh Mỳ đúc nguyên khối, dép bánh mì hot",56000,56000,0,0
TIKI,giay-dep-nu,6777839,"Combo miếng dán đế giày chống trơn (2 bộ / 4 miếng dán)",30000,30000,0,0
TIKI,giay-dep-nu,108035443,"2 Miếng Lót giày chống rộng đi êm, chống rớt gót, đau phồng rộp gót cao cấp, bảo vệ chân",15000,15000,0,0
TIKI,giay-dep-nu,106546363,"Giày búp bê nữ da bò BIGGBEN cao cấp BB93",299000,400000,101000,25
TIKI,giay-dep-nam,182605387,"Giày Thể Thao Sneaker Nam - Giầy Nam Đế Êm Chân, Da Lì S102 Có 2 màu",189000,189000,0,0
TIKI,giay-dep-nam,10063962,"Dép Nam Bít Mũi BIGGBEN Da Bò ThậtDN146",349000,500000,151000,30
TIKI,giay-dep-nam,175567700,"Dép quai ngang nữ và nam độn đế Ulzang, dép bánh mỳ siêu bền, k ngấm nước",30000,30000,0,0
TIKI,giay-dep-nam,85266535,"Giày lười nam, giày Driver shoes Mã GL333- Da Bò",550000,1100000,550000,50
TIKI,giay-dep-nam,191739529,"Giày Sandal Nam The Bily Quai Chéo Đôi -  Đế Trắng Lót Đen Màu Đen BLDTMD02",329000,329000,0,0
TIKI,giay-dep-nam,134363209,"Giày Sneaker Unisex Đi Êm Chân",150000,150000,0,0
TIKI,giay-dep-nam,36382149,"Combo 3 đôi lót giày vải cotton Hương Quế (CI-14, viền đen CI-13, CI-02) giúp khử hôi chân - phòng cảm cúm tốt cho sức khỏe - Màu khác nhau",75000,75000,0,0
TIKI,giay-dep-nam,107801851,"Bàn chải đánh giày tiện dụng đa năng XIMO (BCDG06)",35000,60000,25000,42
TIKI,giay-dep-nam,170768872,"Xi đánh bóng giày Saphir Pate De Luxe BDC Pháp 50ml (XDG04)",190000,270000,80000,30
TIKI,giay-dep-nam,109244535,"Giày thể thao nam, giày sneaker nam đế trong trẻ trung năng động Q03",220000,220000,0,0
TIKI,giay-dep-nam,195865797,"PUMA - Giày thể thao nam Suede Classic XXI 374915",2499000,2499000,0,0
TIKI,giay-dep-nam,72006736,"Giày mọi nam Trường Hải màu xanh lam bò da bò thật cao cấp không bong tróc đế cao su chống mòn không trơn GMTH098",547000,639000,92000,14
TIKI,giay-dep-nam,91865532,"HAVAIANAS - Dép nam Top Logomania 4144264",699000,699000,0,0
TIKI,giay-dep-nam,110183814,"Giày Thể Thao Nam Spiso S42 Màu Đen Chũ X",170000,250000,80000,32
TIKI,giay-dep-nam,109879019,"Đón Gót Giày Nhựa Màu Đen Giúp Dễ Dàng Khi Mang Giày",12000,12000,0,0
TIKI,giay-dep-nam,188686784,"Lót Giày Thể Thao Chất Liệu Cao Su Non Mềm Êm LGN2024a",45000,45000,0,0
TIKI,giay-dep-nam,193720562,"Giày Martin Boot Nam Cổ Cao Collection của Anh (đế cao 7cm.)",1500000,1500000,0,0
TIKI,giay-dep-nam,129942076,"Giày Sneaker Unisex Vans  đi học chính hãng Sk8 Hi All White - VN000D5IW00",1850000,1850000,0,0
TIKI,giay-dep-nam,117043561,"Jibbitz Crocs JB Junk Foodie 5 Pcs - 10008713",595000,595000,0,0
TIKI,giay-dep-nam,2738963,"Giày sandal nam Teramo TRM10",119000,119000,0,0
TIKI,giay-dep-nam,95253772,"Dép quai kẹp Bitis xốp nam",180000,180000,0,0
TIKI,giay-dep-nam,217765197,"Dép quai ngang nam nữ unisex 2 quai cài Fashion phong cách Hàn Quốc",75000,150000,75000,50
TIKI,giay-dep-nam,182139464,"Giày Thể Thao Sneaker Nam - Giầy Nam Đế Êm Chân, Da Lì S102 Có 2 màu",182500,250000,67500,27
TIKI,giay-dep-nam,180318887,"MLB - Giày mule thời trang Playball Monogram 3AMUM212N",2090000,2090000,0,0
TIKI,giay-dep-nam,44939991,"Giày da nam màu trắng da bò thật  Trường Hải đế cao su GTN0597",490000,549000,59000,11
TIKI,giay-dep-nam,67247892,"Giày Lười Nam BANULI K2DL1T0 (Giày Nam Da Bò Nhập Khẩu Nguyên Con, Đế Siêu Nhẹ Siêu Êm)",1650000,1650000,0,0
TIKI,giay-dep-nam,215201148,"Dép hai quai ngang nam KEEDO KD0505 Full hộp",480000,480000,0,0
TIKI,giay-dep-nam,57155828,"Giày Sneaker nam, Giày thể thao nam, giày da, 2 màu đen - trắng, đế cao su nguyên khối, đế nén khí êm, bền, khâu đế chắc chắn G145",149000,265000,116000,44
TIKI,giay-dep-nam,165595275,"Giày Tây Nam Da Bò Thật BIGGBEN Cao Cấp GT217",749000,800000,51000,6
TIKI,giay-dep-nam,174505058,"Giày nam họa tiết phong cách hiện đại Đồ Da Thành Long 20370",200000,200000,0,0
TIKI,giay-dep-nam,72099855,"Giày thông hơi Urban Footpritn EVA fylon D2001 thời trang-OB001",139000,139000,0,0
TIKI,giay-dep-nam,168878290,"Chai Xịt Khử Mùi Giày Dép, Chống Hôi Chân, Diệt Khuẩn Hiệu Quả Đến 24h Dung Tích 260ml",17000,17000,0,0
TIKI,giay-dep-nam,16109067,"Dép tổ ong",60000,60000,0,0
TIKI,giay-dep-nam,58451856,"Xịt bọt làm sạch giày Sneaker",50000,50000,0,0
TIKI,giay-dep-nam,167011051,"MLB - Giày thể thao Bigball Chunky Monogram 3ASHCM11N",3490000,3490000,0,0
TIKI,giay-dep-nam,115841999,"Giầy sục da nam nót vàng sục xích trơn kèm video",199000,199000,0,0
TIKI,giay-dep-nam,20298474,"Dép cao su nam nữ 1 quai ngang",300000,300000,0,0
TIKI,giay-dep-nam,114647933,"Giày Thể Thao Nam SSN65 MẦU ĐEN chất liệu vải dệt  thoáng khí khử mùi hôi chân,đi chơi,tập gym thể thao",61000,66000,5000,8
TIKI,giay-dep-nam,83169638,"Dép cao su 3 quai ngang",338000,338000,0,0
TIKI,giay-dep-nam,202330673,"Giầy da Nam cao cấp giày buộc dây chuẩn giày nam đẹp kiểu giày tây công sở HS78 chuẩn hàng Việt Nam xuất xịn",800000,800000,0,0
TIKI,giay-dep-nu,192889107,"Sticker nhựa jibbitz unisex Crocs Beer",145000,145000,0,0
TIKI,giay-dep-nu,50694122,"Bọt vệ sinh giày đa năng, sneaker + tặng kèm  bản chải đánh giày",120000,120000,0,0
TIKI,giay-dep-nu,97546164,"Giày Tây Nam Buộc Dây Bảo Hân Mã CS89",295000,590000,295000,50
TIKI,giay-dep-nu,141237392,"Giày Tây nam tăng chiều cao Đông Hải kiểu dáng Derby  thanh lịch da cao cấp đế 6cm cải thiện chiều cao - G0615",1980000,1980000,0,0
TIKI,giay-dep-nu,177748957,"Giày Lười Nam Cao Da Bò Thật BIGGBEN Tăng Chiều Chiều Cao Thêm 6cm GM272",899000,1200000,301000,25
TIKI,giay-dep-nu,135370236,"Chai Làm Sạch Giày Dép Túi Xách, Lọ Xịt Chà Trắng Giày Dép",9998,9998,0,0
TIKI,giay-dep-nu,171202931,"Giày sandal 4 dây quai ngang phối chéo Giavy SL524",198000,198000,0,0
TIKI,giay-dep-nu,135852613,"Giày tây lười nam cao cấp, Giày lười da pu in vân nổi bật trẻ trung tăng chiều cao đế cao su đúc - Mã DR01",199000,199000,0,0
TIKI,giay-dep-nu,179546441," GIÀY TÂY NAM DA BÒ THẬT 100%, DONAVY GTN, HÀNG CÔNG TY CAO CẤP DOGTN",449000,850000,401000,47
TIKI,giay-dep-nu,153792840,"Đón gót giày gỗ",44000,44000,0,0
TIKI,giay-dep-nu,102796815," Giày thể thao nam, giày sneaker nam độn đế mới nhất HOT 2021",169000,169000,0,0
TIKI,giay-dep-nu,186232739,"Dép xỏ ngón nam da cá sấu màu đen chính hãng Trường Hải may viền chắc chắn DCS255",591000,699000,108000,15
TIKI,giay-dep-nu,72770419,"Giày cao cổ nam g12",650000,650000,0,0
TIKI,giay-dep-nu,146414112,"Giày quai nang nam, dép quai hậu nam đẹp phong cách thời trang Hàn Quốc mã DEP11LE",159000,299000,140000,47
TIKI,giay-dep-nu,197618496,"Giày Sneaker Nam Vải Canvas DINCOX E06 Blue Đơn Giản Tinh Tế Sang Trọng",442000,442000,0,0
TIKI,giay-dep-nu,111092834,"Chai xịt khử mùi hôi giày PenGuin; Nhập khẩu Malaysia, diệt vi khuẩn và nấm mốc trong giày",51000,68000,17000,25
TIKI,giay-dep-nu,125244241,"Giày nam công sở phong cách lịch lãm, Giày da nam cao cấp chất liệu da bò pu in vân nổi bật đế cao su đúc - Mã GEA01",210000,210000,0,0
TIKI,giay-dep-nu,139078021,"Chai xịt tẩy trắng giày dép túi xách Plac - Chai xịt tẩy trắng ",6000,15000,9000,60
TIKI,giay-dep-nu,15762316,"Sữa làm sạch và dưỡng đồ da Saphir Creme Universelle 150ml",360000,360000,0,0
TIKI,giay-dep-nu,168587075,"Giày thể thao sneaker nam cổ thấp, giày đế tăng chiều cao mẫu mới k1",155000,155000,0,0
TIKI,giay-dep-nu,98039876,"Giày Thể Thao Nam Màu Đen Đế Cao Su Non Đúc",160000,169990,9990,6
TIKI,giay-dep-nu,13360653,"Giày Da Nam BH002",450000,900000,450000,50
TIKI,giay-dep-nu,191592535,"Giày da nam Boat Shoes Xám da bò sáp cao cấp Hanmade, Lucas Shoes, Bảo hành 1 năm",659000,659000,0,0
TIKI,giay-dep-nu,88081802," Giày thể thao nam, giày nam da lộn 2801",200000,200000,0,0
TIKI,giay-dep-nu,17970831,"Lót giày da mộc êm chân hình chữ T Woly Galant - NK Đức",69000,69000,0,0
TIKI,giay-dep-nu,189233352,"Dép Hai Quai Ngang Nam KEEDO-KD1705 Full hộp siêu bền",480000,480000,0,0
TIKI,giay-dep-nu,191592703,"Dép da bò đế trấu, Sandal da bò sáp, may thủ công Lucas Shoes, bảo hành 6 tháng",375000,375000,0,0
TIKI,giay-dep-nu,13980705,"Giày Mọi Nam BIGGBEN Da Bò Thật Cao Cấp GM159",549000,720000,171000,24
TIKI,giay-dep-nu,141245183,"Dép bít mũi nam da bò thật BIGGBEN cao cấp SB108",459000,600000,141000,24
TIKI,giay-dep-nu,183544565,"Giày Lười Nam Penny Loafer George TMN22801",2890000,2890000,0,0
TIKI,giay-dep-nu,73820375,"Giày Sneaker thể thao nam buộc dây, đế cao su nguyên khối, đế nén khí đàn hồi G147",157000,176000,19000,11
TIKI,giay-dep-nu,272384051,"Giày Sục Nam S92 Da Bò Thật Sục nam trẻ trung năng động Màu Đen Giày hở gót da mềm mại Bảo Hành 12 Tháng",392000,392000,0,0
TIKI,giay-dep-nu,148717398,"Máy đánh bóng giày dép công suất cao Bóng Đẹp Như Mới",222000,222000,0,0
TIKI,giay-dep-nu,193054679,"Giày thể thao nam, giày sneakers nam kẻ bo chun 2 màu C80",200000,200000,0,0
TIKI,giay-dep-nu,13883504,"Giày sneaker TMN05404",1400000,1400000,0,0
TIKI,giay-dep-nu,202708835,"Giày thể thao nam cổ cao GNC-T22-BL, giày thể thao thoáng khí phong cách hàn quốc",299000,299000,0,0
TIKI,giay-dep-nu,156216180,"GIÀY LƯỜI NAM DA BÒ THẬT 100% KHÂU ĐẾ CHẮC CHẮN BAO ĐI NƯỚC",500000,500000,0,0
TIKI,giay-dep-nu,192450907,"GIÀY BOOTS COLE HAAN NAM ZERØGRAND OMNI CITY BOOT WP C34238",2190000,5490000,3300000,60
TIKI,giay-dep-nu,178958545,"Giày Sneaker nam da thật màu trắng cao cấp NEW 2022",189000,189000,0,0
TIKI,giay-dep-nu,13586787,"Lót giày tăng chiều cao eva nguyên bàn cao 3 cm (Màu Xám)",67000,67000,0,0
TIKI,dien-tu-dien-lanh,75721595,"Tấm chắn gió máy lạnh, điều hòa treo tường bằng nhựa cao cấp",86000,86000,0,0
TIKI,dien-tu-dien-lanh,54570736,"Điều Hòa 2 Chiều Panasonic Inverter 9040 BTU CU/CS-YZ9WKH-8",13578000,13578000,0,0
TIKI,dien-tu-dien-lanh,93556734,"Máy giặt Toshiba Inverter 8.5 kg TW-BH95M4V(SK) hàng chính hãng ",10590000,10590000,0,0
TIKI,dien-tu-dien-lanh,172066798,"Android Tivi Sony 4K 50 inch KD-50X80K - Model 2022",14100000,14100000,0,0
TIKI,dien-tu-dien-lanh,195637898,"Smart Tivi OLED LG 4K 65 inch OLED65C2PSA - Model 2022",38000000,38000000,0,0
TIKI,dien-tu-dien-lanh,178264538,"Tủ lạnh Electrolux 94 Lít EUM0930AD-VN",3790000,3790000,0,0
TIKI,dien-tu-dien-lanh,1953951,"Bình nước nóng trực tiếp Ferroli Slim Divo SDP 4.500W, hiển thị điện tử, có bơm tăng áp - Hàng Chính Hãng",2789000,2789000,0,0
TIKI,dien-tu-dien-lanh,169277219,"GIÁ TIVI DI ĐỘNG 3 CHÂN 32-60inch",399000,399000,0,0
TIKI,dien-tu-dien-lanh,76158589,"Van xả dùng cho máy giặt LG 3 chân",115000,115000,0,0
TIKI,dien-tu-dien-lanh,103071840,"Remote máy lạnh Daikin 1 chiều - Hàng Chính Hãng",250000,250000,0,0
TIKI,dien-tu-dien-lanh,65439714,"Máy Giặt Sấy LG Inverter 9 Kg FV1409G4V - Chỉ Giao Hà Nội",12294000,12294000,0,0
TIKI,dien-tu-dien-lanh,171616918,"Điều Hòa Funiki 18000Btu HSC18TMU - Chỉ giao Hà Nội",8990000,9990000,1000000,10
TIKI,dien-tu-dien-lanh,112710417,"[CHỈ GIAO TẠI HCM] - Máy Giặt Cửa Trên Panasonic 11KG NA-FD10XR1LV - Hàng Chính Hãng",10590000,12390000,1800000,15
TIKI,dien-tu-dien-lanh,20052593,"Tủ lạnh Toshiba Inverter 233 lít GR-A28VM UKG (HÀNG CHÍNH HÃNG)",5990000,5990000,0,0
TIKI,dien-tu-dien-lanh,108480870,"Đai giữ ron cao su cửa máy giặt đường kính 33cm",62000,62000,0,0
TIKI,dien-tu-dien-lanh,102108778,"SR609C Bộ điều khiển nhiệt độ thông minh tích hợp điều áp Máy Nước Nóng Năng Lượng Mặt Trời",1800000,1800000,0,0
TIKI,dien-tu-dien-lanh,37551050,"MÁY SẤY LG 8 KG DR-80BW - HÀNG CHÍNH HÃNG",15100000,15100000,0,0
TIKI,dien-tu-dien-lanh,177301598,"Điều khiển TiVi, remote cho Ti Vi - LG AKB75095308",66000,66000,0,0
TIKI,dien-tu-dien-lanh,95917386,"Máy giặt Samsung AI Inverter 10kg WW10TP44DSB/SV - Chỉ giao Hà Nội",10229000,10229000,0,0
TIKI,dien-tu-dien-lanh,101349078,"Ăng ten tivi thu sóng DVB T2- 15m",149000,149000,0,0
TIKI,dien-tu-dien-lanh,3812659,"Tủ lạnh Hitachi Inverter 540 lít R-FW690PGV7 GBK",23500000,23500000,0,0
TIKI,dien-tu-dien-lanh,171550090,"Giá treo màn hình máy tính NB-F120 từ 17 - 27 Inch - Gắn Tường Xoay 360 Độ - Điều Chỉnh Cao Thấp. HÀNG NHẬP KHẨU",389000,389000,0,0
TIKI,dien-tu-dien-lanh,188043850,"Điều hòa không khí Inverter 9000 BTU Karofi KDC-WI309 - hàng chính hãng - Giao và lắp đặt toàn quốc",8692500,11590000,2897500,25
TIKI,dien-tu-dien-lanh,28908890,"Máy Nước Nóng Panasonic DH-30HAMVW (2500W)",4089900,4089900,0,0
TIKI,dien-tu-dien-lanh,72654771,"[Chính Hãng] Bình nước nóng gián tiếp Atlantic NEO Max",3510000,3510000,0,0
TIKI,dien-tu-dien-lanh,161207583,"Máy rửa bát TEXGIO TGFPCM795B Dung tích 14 bộ Rút ngắn thời gian rửa Có thể chọn giàn rửa Sấy khô chén đĩa Rửa sạch sâu - Hàng Chính Hãng",22000000,22000000,0,0
TIKI,dien-tu-dien-lanh,105878508,"TỦ LẠNH INVERTER BOSCH 562L KFN86AA76J - giao hàng toàn quốc",60927000,60927000,0,0
TIKI,dien-tu-dien-lanh,248844526,"Máy hút chân không VALUE hàng nhập khẩu",1415000,1415000,0,0
TIKI,dien-tu-dien-lanh,20552837,"Tủ Lạnh Inverter LG GN-D315BL (315L) – Hàng Chính Hãng",9950000,9950000,0,0
TIKI,dien-tu-dien-lanh,3690369,"Máy Nước Nóng Ariston SL 30 ST 2.5 FE - MT (2500W)",4000000,4000000,0,0
TIKI,dien-tu-dien-lanh,60162272,"Khung treo tivi áp tường cao cấp loại tivi LCD-LED-PLASMA C8.4 55 - 84 inch - HÀNG CHÍNH HÀNG ",179000,179000,0,0
TIKI,dien-tu-dien-lanh,185655713,"Điều khiển TV dành cho LG AN-MR18BA giọng nói, chuột bay-HÀNG CHÍNH HÃNG",445000,445000,0,0
TIKI,dien-tu-dien-lanh,172360139,"Anten thông minh thu sóng DVB T2 + 15m dây cáp + Jack nối dùng cho TiVI và đầu KTS",59000,59000,0,0
TIKI,dien-tu-dien-lanh,5754581,"Hộp Android tivi box MyTVNet Net 1 - Hàng chính Hãng",679000,679000,0,0
TIKI,dien-tu-dien-lanh,90404735,"Khử cặn chân trung 4.6 mm, thanh Ma-giê khử cặn bình nóng lạnh",18000,18000,0,0
TIKI,dien-tu-dien-lanh,186275645,"Smart Tivi Casper 4K 55 inch 55UW6000 - Hàng Chính Hãng - Chỉ Giao Hà Nội",9100000,9100000,0,0
TIKI,dien-tu-dien-lanh,99328337,"Remote Điều Khiển Dành Cho SAMSUNG Smart TV, Internet Tivi BN59-01178F",59000,59000,0,0
TIKI,dien-tu-dien-lanh,74258086,"khung treo tivi xoay 26 inch đến 37 inch",128000,128000,0,0
TIKI,dien-tu-dien-lanh,94841076,"CHÂN ĐẾ TIVI ĐA NĂNG TV02 (36-75 INCH)",279000,279000,0,0
TIKI,dien-tu-dien-lanh,222662861,"Bộ điều khiển trung tâm FPT Play Box S (Hàng chính hãng)",1354500,1354500,0,0
TIKI,dien-tu-dien-lanh,73522306,"Bạc đạn máy giặt 1 chiều có hai mặt xanh-đen",65000,65000,0,0
TIKI,dien-tu-dien-lanh,20630677,"Điều khiển dành cho điều hòa DAIKIN H1",248000,248000,0,0
TIKI,dien-tu-dien-lanh,59432256,"Remote Điều Khiển Dành Cho Smart TV, Internet TV, TV Thông Minh SAMSUNG RM-D1078+1 Grade A+ (Kèm Pin AAA Maxell)",52900,52900,0,0
TIKI,dien-tu-dien-lanh,16398913,"Tủ Đông SANAKY 1 Ngăn VH-1599HY - Hàng Chính Hãng",4901000,5800000,899000,16
TIKI,dien-tu-dien-lanh,52602226,"Máy Giặt Cửa Trên Sharp ES-W95HV-S (9.5kg) - Hàng Chính Hãng - Chỉ giao tại Hà Nội",5490000,5490000,0,0
TIKI,dien-tu-dien-lanh,25693431,"Remote Điều Khiển Cho Máy Lạnh, Điều Hòa ELECTROLUX ESM09CRF, TI07R, TI24R",45000,45000,0,0
TIKI,dien-tu-dien-lanh,188829099,"Ron cửa cho tủ lạnh Panasonic Model NR-BV328",264000,264000,0,0
TIKI,dien-tu-dien-lanh,118053470,"túi lọc dành cho máy giặt sharp",33000,33000,0,0
TIKI,dien-tu-dien-lanh,119088503,"Dàn Anten thông minh cho tivi và thu sóng đầu KTS DVB - T2 ( 15m dây và 1 đầu cắm)",69000,69000,0,0
TIKI,dien-tu-dien-lanh,85296395,"BÌNH NƯỚC NÓNG QQ TE 20 lít -HÀNG CHÍNH HÃNG ",2118000,2118000,0,0
TIKI,dien-tu-dien-lanh,97340060,"Smart Tivi LG 4K 55 inch 55UP7550PTC",9580000,9580000,0,0
TIKI,dien-tu-dien-lanh,140045360,"Bộ đồng hồ nạp ga điều hòa Robinair 40153",3245000,3245000,0,0
TIKI,dien-tu-dien-lanh,813210,"Tủ lạnh Sharp Inverter 315 lít SJ-X346E-DS",7690000,7690000,0,0
TIKI,dien-tu-dien-lanh,169277217,"Giá treo tivi 19-32 inch",51000,51000,0,0
TIKI,dien-tu-dien-lanh,171587861,"Android Tivi Sony 4K 75 inch KD-75X80K - Hàng chính hãng (chỉ giao HCM)",33000000,33000000,0,0
TIKI,dien-tu-dien-lanh,195660649,"Smart Tivi NanoCell LG 4K 43 inch 43NANO76SQA - Model 2022",10500000,10500000,0,0
TIKI,dien-tu-dien-lanh,1935751,"Máy nước nóng Ferroli QQSE20L 3 (2500W) - Hàng Chính Hãng",2550000,2550000,0,0
TIKI,dien-tu-dien-lanh,189151545,"Dây loa, dây tín hiệu âm thanh đồng nguyên chất (5 mét)",145000,145000,0,0
TIKI,dien-tu-dien-lanh,16586720,"Tủ Đông SANAKY VH-4899K (340L) - Hàng Chính Hãng",10950000,10950000,0,0
TIKI,dien-tu-dien-lanh,182457726,"Tủ lạnh Casper Inverter 462 lít RM-520VT Mẫu 2022-Hàng chính hãng-Giao tại Hà Nội",14990000,14990000,0,0
TIKI,dien-tu-dien-lanh,10214414,"Android TV Mi Box S 2018 4K Quốc Tế - Hàng Nhập Khẩu",1490000,1490000,0,0
TIKI,dien-tu-dien-lanh,4921873,"Tủ Đông Sanaky VH-6899K3 (450L) - Hàng Chính Hãng",15500000,15500000,0,0
TIKI,dien-tu-dien-lanh,20539661,"Điều Khiển Hỗ Trợ Tìm Kiếm Bằng Giọng Nói Q6",180000,180000,0,0
TIKI,dien-tu-dien-lanh,1955619,"Bình nước nóng Ferroli Verdi DE15L, 3 công suất, hiển thị nhiệt độ, 2500W - Hàng chính hãng",2440360,2440360,0,0
TIKI,dien-tu-dien-lanh,6289071,"Máy giặt Toshiba 9 Kg AW-H1000GV SB",5590000,5590000,0,0
TIKI,dien-tu-dien-lanh,126702287,"Điều khiển điều hòa dành cho Funiki dùng cho các dòng SC SH HSC 09 12 18 24",55575,58500,2925,5
TIKI,dien-tu-dien-lanh,189151486,"Chân loa đứng- Giá đỡ loa đứng inox (2 chiếc)",409000,409000,0,0
TIKI,dien-tu-dien-lanh,196857718,"Máy giặt Samsung Inverter 13 kg WW13T504DAB/SV - Hàng chính hãng- Giao tại Hà Nội",14800000,14800000,0,0
TIKI,dien-tu-dien-lanh,119822756,"Remote Điều khiển đầu thu dành cho VTVCab HD-  Tặng kèm Pin!!!",124000,124000,0,0
TIKI,dien-tu-dien-lanh,52602226,"Máy Giặt Cửa Trên Sharp ES-W95HV-S (9.5kg) - Hàng Chính Hãng - Chỉ giao tại Hà Nội",5490000,5490000,0,0
TIKI,dien-tu-dien-lanh,176443167,"Máy giặt lồng ngang thông minh LG AI DD 11kg FV1411S4P - Hàng chính hãng (chỉ giao HN và một số khu vực)",12790000,12790000,0,0
TIKI,dien-tu-dien-lanh,118053687,"Lưới lượt Dành Cho Máy Giặt Sharp",33000,33000,0,0
TIKI,dien-tu-dien-lanh,20630677,"Điều khiển dành cho điều hòa DAIKIN H1",248000,248000,0,0
TIKI,dien-tu-dien-lanh,16398913,"Tủ Đông SANAKY 1 Ngăn VH-1599HY - Hàng Chính Hãng",4901000,5800000,899000,16
TIKI,dien-tu-dien-lanh,20539661,"Điều Khiển Hỗ Trợ Tìm Kiếm Bằng Giọng Nói Q6",180000,180000,0,0
TIKI,dien-tu-dien-lanh,171587861,"Android Tivi Sony 4K 75 inch KD-75X80K - Hàng chính hãng (chỉ giao HCM)",33000000,33000000,0,0
TIKI,dien-tu-dien-lanh,44192470,"Cáp HDMI bẻ góc 90 độ chất lượng HD 1080P Tivi smart D774",15000,15000,0,0
TIKI,dien-tu-dien-lanh,73522306,"Bạc đạn máy giặt 1 chiều có hai mặt xanh-đen",65000,65000,0,0
TIKI,dien-tu-dien-lanh,140045360,"Bộ đồng hồ nạp ga điều hòa Robinair 40153",3245000,3245000,0,0
TIKI,dien-tu-dien-lanh,59432256,"Remote Điều Khiển Dành Cho Smart TV, Internet TV, TV Thông Minh SAMSUNG RM-D1078+1 Grade A+ (Kèm Pin AAA Maxell)",52900,52900,0,0
TIKI,dien-tu-dien-lanh,97340060,"Smart Tivi LG 4K 55 inch 55UP7550PTC",9580000,9580000,0,0
TIKI,dien-tu-dien-lanh,107534628,"Con lăn dành cho mâm máy giặt SAMSUNG",72000,72000,0,0
TIKI,dien-tu-dien-lanh,107534628,"Con lăn dành cho mâm máy giặt SAMSUNG",72000,72000,0,0
TIKI,dien-tu-dien-lanh,189151545,"Dây loa, dây tín hiệu âm thanh đồng nguyên chất (5 mét)",145000,145000,0,0
TIKI,dien-tu-dien-lanh,178062048,"Google Tivi Sony 4K 85 inch XR-85X90K - Model 2022",55500000,55500000,0,0
TIKI,dien-tu-dien-lanh,33232596,"Điều Khiển TiVi, Remote Cho Ti Vi Panasonic",38000,38000,0,0
TIKI,dien-tu-dien-lanh,169277217,"Giá treo tivi 19-32 inch",51000,51000,0,0
TIKI,dien-tu-dien-lanh,10214414,"Android TV Mi Box S 2018 4K Quốc Tế - Hàng Nhập Khẩu",1490000,1490000,0,0
TIKI,dien-tu-dien-lanh,172360320,"Dây Cáp Loa Âm Thanh, Dây tín hiệu âm thanh (bán lẻ 10M mét)",109000,109000,0,0
TIKI,dien-tu-dien-lanh,182457726,"Tủ lạnh Casper Inverter 462 lít RM-520VT Mẫu 2022-Hàng chính hãng-Giao tại Hà Nội",14990000,14990000,0,0
TIKI,dien-tu-dien-lanh,178062048,"Google Tivi Sony 4K 85 inch XR-85X90K - Model 2022",55500000,55500000,0,0
TIKI,dien-tu-dien-lanh,6289071,"Máy giặt Toshiba 9 Kg AW-H1000GV SB",5590000,5590000,0,0
TIKI,dien-tu-dien-lanh,118053470,"túi lọc dành cho máy giặt sharp",33000,33000,0,0
TIKI,dien-tu-dien-lanh,189151486,"Chân loa đứng- Giá đỡ loa đứng inox (2 chiếc)",409000,409000,0,0
TIKI,dien-tu-dien-lanh,112695816,"[Chỉ Giao Tại HCM] - Máy Giặt Cửa Trên Panasonic 11KG NA-FD10AR1BV - Hàng Chính Hãng",10190000,12190000,2000000,16
TIKI,dien-tu-dien-lanh,4921873,"Tủ Đông Sanaky VH-6899K3 (450L) - Hàng Chính Hãng",15500000,15500000,0,0
TIKI,dien-tu-dien-lanh,16586720,"Tủ Đông SANAKY VH-4899K (340L) - Hàng Chính Hãng",10950000,10950000,0,0
TIKI,dien-tu-dien-lanh,176443167,"Máy giặt lồng ngang thông minh LG AI DD 11kg FV1411S4P - Hàng chính hãng (chỉ giao HN và một số khu vực)",12790000,12790000,0,0
TIKI,dien-tu-dien-lanh,112695816,"[Chỉ Giao Tại HCM] - Máy Giặt Cửa Trên Panasonic 11KG NA-FD10AR1BV - Hàng Chính Hãng",10190000,12190000,2000000,16
TIKI,dien-tu-dien-lanh,119088503,"Dàn Anten thông minh cho tivi và thu sóng đầu KTS DVB - T2 ( 15m dây và 1 đầu cắm)",69000,69000,0,0
TIKI,dien-tu-dien-lanh,33232596,"Điều Khiển TiVi, Remote Cho Ti Vi Panasonic",38000,38000,0,0
TIKI,dien-tu-dien-lanh,172360320,"Dây Cáp Loa Âm Thanh, Dây tín hiệu âm thanh (bán lẻ 10M mét)",109000,109000,0,0
TIKI,dien-tu-dien-lanh,195660649,"Smart Tivi NanoCell LG 4K 43 inch 43NANO76SQA - Model 2022",10500000,10500000,0,0
TIKI,dien-tu-dien-lanh,25693431,"Remote Điều Khiển Cho Máy Lạnh, Điều Hòa ELECTROLUX ESM09CRF, TI07R, TI24R",45000,45000,0,0
TIKI,dien-tu-dien-lanh,1935751,"Máy nước nóng Ferroli QQSE20L 3 (2500W) - Hàng Chính Hãng",2550000,2550000,0,0
TIKI,dien-tu-dien-lanh,119822756,"Remote Điều khiển đầu thu dành cho VTVCab HD-  Tặng kèm Pin!!!",124000,124000,0,0
TIKI,dien-tu-dien-lanh,107350807,"Bo mạch dành cho máy giặt TOSHIBA các loại",650000,650000,0,0
TIKI,dien-tu-dien-lanh,44192470,"Cáp HDMI bẻ góc 90 độ chất lượng HD 1080P Tivi smart D774",15000,15000,0,0
TIKI,dien-tu-dien-lanh,813210,"Tủ lạnh Sharp Inverter 315 lít SJ-X346E-DS",7690000,7690000,0,0
TIKI,dien-tu-dien-lanh,188829099,"Ron cửa cho tủ lạnh Panasonic Model NR-BV328",264000,264000,0,0
TIKI,dien-tu-dien-lanh,85296395,"BÌNH NƯỚC NÓNG QQ TE 20 lít -HÀNG CHÍNH HÃNG ",2118000,2118000,0,0
TIKI,dien-tu-dien-lanh,118053687,"Lưới lượt Dành Cho Máy Giặt Sharp",33000,33000,0,0
TIKI,dien-tu-dien-lanh,126702287,"Điều khiển điều hòa dành cho Funiki dùng cho các dòng SC SH HSC 09 12 18 24",55575,58500,2925,5
TIKI,dien-tu-dien-lanh,1955619,"Bình nước nóng Ferroli Verdi DE15L, 3 công suất, hiển thị nhiệt độ, 2500W - Hàng chính hãng",2440360,2440360,0,0
TIKI,dien-tu-dien-lanh,107350807,"Bo mạch dành cho máy giặt TOSHIBA các loại",650000,650000,0,0
TIKI,dien-tu-dien-lanh,122419382,"Điều khiển TV  Giọng Nói Dùng Được Cho Tất Cả Các Đời TV Smart có giọng nói",297000,297000,0,0
TIKI,dien-tu-dien-lanh,172359964,"Dây Cấp Nước Máy Giặt Cửa Ngang (dài 3M)",79000,79000,0,0
TIKI,dien-tu-dien-lanh,122419382,"Điều khiển TV  Giọng Nói Dùng Được Cho Tất Cả Các Đời TV Smart có giọng nói",297000,297000,0,0
TIKI,dien-tu-dien-lanh,172359964,"Dây Cấp Nước Máy Giặt Cửa Ngang (dài 3M)",79000,79000,0,0
TIKI,dien-tu-dien-lanh,196857718,"Máy giặt Samsung Inverter 13 kg WW13T504DAB/SV - Hàng chính hãng- Giao tại Hà Nội",14800000,14800000,0,0
TIKI,dien-tu-dien-lanh,105836103,"TỦ LẠNH INVERTER BOSCH 560L KAN93VIFPG - giao hàng toàn quốc",55156000,55156000,0,0
TIKI,dien-tu-dien-lanh,48630418,"Bộ Chia 2 Pacific 4202AP Dùng Chia Chảo, Truyền Hình Cáp, Anten KTS - Hàng Nhập Khẩu",98000,98000,0,0
TIKI,dien-tu-dien-lanh,10585710,"Giá treo tivi thả trần  NBT560-15 dùng cho tivi 32 - 65 inch siêu đẹp",389000,437000,48000,11
TIKI,dien-tu-dien-lanh,74534580,"DÂY CÁP GR6 15M ĐÚC SẴN 2 ĐẦU RẮC F ĐỰC",50000,50000,0,0
TIKI,dien-tu-dien-lanh,73340788,"Máy rửa chén độc lập Hafele Chính Hãng HDW-F60E",16990000,16990000,0,0
TIKI,dien-tu-dien-lanh,176289348,"Máy Giặt Electrolux Inverter 8 kg EWF8024P5SB Cửa Trước - Hàng Chính Hãng - Chỉ Giao HCM",12990000,12990000,0,0
TIKI,dien-tu-dien-lanh,65453420,"Máy giặt LG Inverter 9 Kg FV1409S3W - Chỉ giao HCM",9550000,9550000,0,0
TIKI,dien-tu-dien-lanh,141111461,"Máy giặt Electrolux Inverter 11 kg EWF1141R9SB - chỉ giao Hà Nội",17290000,17290000,0,0
TIKI,dien-tu-dien-lanh,102574928,"Bo mạch dành cho máy giặt SAMSUNG các loại",100000,100000,0,0
TIKI,dien-tu-dien-lanh,102104723,"Hộp Số Quạt Trần 1400 220VAC-50HZ",94000,94000,0,0
TIKI,dien-tu-dien-lanh,189676196,"Android Tivi Aqua 4K 70 inch H70D6UG - Hàng Chính Hãng - Chỉ Giao Hà Nội",10290000,10290000,0,0
TIKI,dien-tu-dien-lanh,99038020,"[Free Lắp HCM] Hệ Thống Máy Lạnh Multi S Daikin Inverter Combo MKC50RVMV/CTKC25RVMV+CTKC25RVMV+CTKC25RVMV Gas R32 Treo Tường 1 Chiều Lạnh Hàng Chính Hãng",38000000,38000000,0,0
TIKI,dien-tu-dien-lanh,179936882,"Điều Hòa Daikin Inverter 11900Btu FTKB35WAVMV - Chỉ giao Hà Nội",11200000,11200000,0,0
TIKI,dien-tu-dien-lanh,32920512,"Máy giặt Electrolux Inverter 9 kg EWF9024BDWB",8890000,8890000,0,0
TIKI,dien-tu-dien-lanh,140826385,"Remote Điều Khiển Giọng Nói FPT Play Box + - Hàng Chính Hãng",185000,185000,0,0
TIKI,dien-tu-dien-lanh,185248285,"Khung treo tivi nghiêng CP từ 19-65 inch có thể điều chỉnh góc 15 độ - Hàng Chính Hãng",114000,114000,0,0
TIKI,dien-tu-dien-lanh,155061686,"Remote Tivi Điều Khiển Dành Cho SAMSUNG Smart TV QLED, 4K BN59-01330F",450000,450000,0,0
TIKI,dien-tu-dien-lanh,16464944,"Tủ Đông Dàn Đồng Sanaky VH-2899A1 1 Ngăn 2 Cánh (280L) - Hàng Chính Hãng",6890000,6890000,0,0
TIKI,dien-tu-dien-lanh,172359439,"Remote Điều khiển dùng cho quạt Vinawind và điện cơ",58000,58000,0,0
TIKI,dien-tu-dien-lanh,104314932,"Điều khiển thông minh smart AN-MR18BA giọng nói, chuột bay",438000,438000,0,0
TIKI,dien-tu-dien-lanh,126701945,"Điều khiển điều hòa dành cho Daikin 1HP 1.5 HP 2HP 2.5HP",76000,80000,4000,5
TIKI,dien-tu-dien-lanh,184449516,"Tấm chắn gió điều chỉnh hướng gió máy lạnh, tấm chắn gió điều hòa cao cấp",125500,125500,0,0
TIKI,dien-tu-dien-lanh,100082079,"Điều Khiển giọng nói NETBOX V2 ,KÈM PIN 3A ,Tích hợp MIC VOICE siêu nhạy - Hàng chính hãng",119000,119000,0,0
TIKI,dien-tu-dien-lanh,176289343,"Máy Nước Nóng Trực Tiếp Electrolux EWE451GX-DWB - Công Suất 4500W - Hàng Chính Hãng ",2390000,2390000,0,0
TIKI,dien-tu-dien-lanh,114985002,"Tủ lạnh Sharp Inverter 572 lít SJ-FXP640VG-MR - Chỉ giao Hà Nội",22500000,22500000,0,0
TIKI,dien-tu-dien-lanh,181906980,"Máy lạnh Casper inverter 1.0HP MC-09IS33 (model 2022) - Hàng chính hãng ( Giao hàng toàn quốc )",6299000,6299000,0,0
TIKI,dien-tu-dien-lanh,89992876,"Sensor tủ lạnh 2K, đầu dò cảm biến Tủ Lạnh",35000,35000,0,0
TIKI,dien-tu-dien-lanh,15486864,"Điều Khiển Dùng Cho Điều Hòa Fujitsu",59000,59000,0,0
TIKI,dien-tu-dien-lanh,126701994,"Remote Điều khiển điều hòa dành cho PANASONIC 1 CHIỀU VÀ 2 CHIỀU Inverter",522500,550000,27500,5
TIKI,dien-tu-dien-lanh,14190599,"Điều khiển điều hòa Funiki (ghi) - Hàng Chính Hãng",68000,68000,0,0
TIKI,dien-tu-dien-lanh,153262015,"Máy Rửa Chén ÂmTủ Malloca WQP6 87CP - 6 Chương Trình Rửa - 87L - Hàng Chính Hãng",21131000,24860000,3729000,15
TIKI,dien-tu-dien-lanh,172205445,"Điều khiển,Remote điêu hòa, máy lạnh Mitsubishi",57000,57000,0,0
TIKI,dien-tu-dien-lanh,74163566,"Tủ đông đứng Hòa Phát Funiki 208 lít 7 ngăn HUF 450SR1 - Hàng chính hãng",7300000,7300000,0,0
TIKI,dien-tu-dien-lanh,122423897,"điều khiển dành cho điều hòa daikin 2 chiều",97000,97000,0,0
TIKI,dien-tu-dien-lanh,169277340,"KHUNG TREO TIVI GẬT GÙ 26-45 INCH HÀNG DÀY ĐẸP",90000,90000,0,0
TIKI,dien-tu-dien-lanh,73174427,"Máy giặt LG Inverter 11.5 kg T2351VSAB - Chỉ giao Hà Nội",7479000,7479000,0,0
TIKI,dien-tu-dien-lanh,195899226,"Anten GSM ( ảnh thật shop chụp)",10000,10000,0,0
TIKI,dien-tu-dien-lanh,75368390,"KIM THU SÓNG VỆ TINH LNB Cband NSLF 5200 dùng cho chảo thu vệ tinh",379000,379000,0,0
TIKI,dien-tu-dien-lanh,53247195,"Tủ đông Hòa Phát HCF 336S1N1 - Hàng chính hãng",5500000,5500000,0,0
TIKI,dien-tu-dien-lanh,119194291,"Điều khiển dành cho điều hoà Daikin (Econo)",80000,80000,0,0
TIKI,dien-tu-dien-lanh,84598089,"Lưới lọc sử dụng cho máy giặt 8 kg, túi lọc rác cho máy giặt 8kg",15000,15000,0,0
TIKI,dien-tu-dien-lanh,133157633,"VinaBox X9 (New 2021) - Ram 2G/16G-  Android 9.0 - Siêu Phẩm Trở Lại Cấu Hinh Vượt Trội - Chất Lượng Bền Lâu - Hàng Chính Hãng",668000,668000,0,0
TIKI,dien-tu-dien-lanh,49202519,"Remote Điều Khiển Dùng Cho Máy Lạnh, Máy Điều Hòa FUNIKI SH-MMC2 (Kèm Pin AAA Maxell)",48700,48700,0,0
TIKI,dien-tu-dien-lanh,6497395,"Túi vệ sinh, bảo dưỡng điều hòa RO plus ROPLUS01",150000,150000,0,0
TIKI,dien-tu-dien-lanh,50885564,"Remote Điều Khiển Tivi UBC Dòng Smart (Đen) - Hàng Chính Hãng",190000,190000,0,0
TIKI,dien-tu-dien-lanh,23174450,"Điều khiển dùng cho đầu K+HD",28000,28000,0,0
TIKI,dien-tu-dien-lanh,126702198,"Remote điều khiển từ xa quạt dành cho Senko",75000,75000,0,0
TIKI,dien-tu-dien-lanh,23621650,"Điều khiển dùng cho tivi JVC - LCD ",60000,60000,0,0
TIKI,dien-tu-dien-lanh,119822471,"ĐỆM CHÂN MÁY GIẶT, TỦ LẠNH, CỤC NÓNG ĐIỀU HÒA CHỐNG RUNG, CHỐNG ỒN SIÊU BỀN",58999,58999,0,0
TIKI,dien-tu-dien-lanh,119194055,"Remote Điều khiển dành cho quạt trần Vinawind QT1400-X",57000,57000,0,0
TIKI,dien-tu-dien-lanh,102943465,"Tủ lạnh Aqua Inverter 212 lít AQR-T239FA(HB) - Hàng chính hãng - Giao tại Hà Nội và 1 số tỉnh toàn quốc",5553000,5553000,0,0
TIKI,dien-tu-dien-lanh,75401781,"Remote Điều Khiển Dành Cho Máy Lạnh, Điều Hòa GREE",55000,55000,0,0
TIKI,dien-tu-dien-lanh,19928605,"Giá Treo Tivi Đa Năng Góc Xoay 180° - Nhập khẩu | Dùng Cho Tivi 32-55 Inch",188000,188000,0,0
TIKI,dien-tu-dien-lanh,12736603,"Điều khiển tivi ASANZO 18K100",138000,138000,0,0
TIKI,dien-tu-dien-lanh,169925975,"Thanh Đai Nhôm Cố Định Tản Nhiệt 40mm Cho Sò Nóng Lạnh",6860,6860,0,0
TIKI,dien-tu-dien-lanh,32005771,"Remote Điều Khiển Cho Máy Lạnh, Máy Điều Hòa FUNIKI AKT-FK3",53000,53000,0,0
TIKI,dien-tu-dien-lanh,126702223,"Điều khiển TV dành cho Samsung BN59 dùng cho các dòng UA32 UA40 UA43 UA 49 UA50 UA55 UA65 4K Smart QLED ",66500,70000,3500,5
TIKI,dien-tu-dien-lanh,70148134,"Máy giặt mini cao cấp - 1 Lồng Giặt - Vàng Trắng Có Tia UV",1199000,1199000,0,0
TIKI,dien-tu-dien-lanh,87909066,"Smart Tivi Samsung 4K 65 inch UA65AU7000",11759000,11759000,0,0
TIKI,giay-dep-nam,125285193,"Giày Tây Nam Da Bò Pull-up Cao Cấp SUNPOLO MU8003 (Đen, Nâu, Đỏ)",1250000,1250000,0,0
TIKI,dien-tu-dien-lanh,68526716,"Remote Điều Khiển Dành Cho Smart TV, Internet TV, TV Thông Minh SONY RMT-TX300P",29900,29900,0,0
TIKI,dien-tu-dien-lanh,10003165,"Máy Rửa Bát Electrolux ESF6010BW - Hàng chính hãng ",7459000,7459000,0,0
TIKI,giay-dep-nam,20477328,"Giày Lười Nam Da Bò Thật Happyshoes HS21",350000,350000,0,0
TIKI,dien-tu-dien-lanh,68706799,"Viên Nén Xử Lý Rêu, Chất Bẩn Máy Lạnh - Clogg Away - Chính Hãng Mỹ - Sử Dụng Cho Hệ Thống Điều Hoà 5 Tấn",70000,70000,0,0
TIKI,giay-dep-nam,171535273,"Dép quai ngang nam nữ M Masler-MT màu đỏ 4 sọc trắng với lớp quai êm chân và đế chống nước DT4",338000,338000,0,0
TIKI,dien-tu-dien-lanh,125591280,"REMOTE ĐIỀU KHIỂN DÙNG CHO ĐẦU THU VNPT (Kèm pin AAA) ",65000,65000,0,0
TIKI,dien-tu-dien-lanh,119194057,"Remote dành cho máy lạnh Aqua ",46000,46000,0,0
TIKI,dien-tu-dien-lanh,157290370,"Máy lạnh-điều hòa Panasonic CU-CS-YZ9WKH-8 - Hai chiều - Inverter tiêu chuẩn - Hàng chính hãng - 1 HP",13840000,15862000,2022000,13
TIKI,giay-dep-nam,19850609,"Dép bít mũi nam da bò cao cấp BM080",324000,379000,55000,15
TIKI,dien-tu-dien-lanh,169927977,"Sò Nóng Lạnh TEC1 - 12706-12708-12710-12715",57820,57820,0,0
TIKI,giay-dep-nam,160686580,"Dép Xỏ Ngón Đế Dày Unisex Waa. - DÀY FLIP-FLOPS - Đen",790000,790000,0,0
TIKI,giay-dep-nam,36493130,"Combo 3 đôi lót giày Hương Quế (CI-01, CI-03, CI-04) giúp khử hôi chân - phòng cảm cúm tốt cho sức khỏe",75000,75000,0,0
TIKI,giay-dep-nam,177750271,"Dép bít mũi nam da bò thật BIGGBEN cao cấp SB112",449000,500000,51000,10
TIKI,dien-tu-dien-lanh,105629831,"Đồng hồ gas đôi R410a",1085000,1085000,0,0
TIKI,giay-dep-nam,175901710,"Dép nam đẹp hai quai cao cấp KEEDO KD2803 Full Box",480000,480000,0,0
TIKI,giay-dep-nam,189173676,"Giày Tây Nam GEOX U Spherica Ec11 W B",4800000,4800000,0,0
TIKI,giay-dep-nam,164270669,"Sandal nam đi học mềm êm chống trơn có quai hậu size to phù hợp cho trẻ em học sinh 10 đến 18 tuổi chân ngoại cỡ LIMIBABY ST64",199000,199000,0,0
TIKI,dien-tu-dien-lanh,272851540,"Điện trở dán 0402 các loại :Từ 750R 820R 910R.....10KR 11KR 12KR 1%.Mới Chính Gốc",8000,8000,0,0
TIKI,dien-tu-dien-lanh,4678979,"Giá Treo Tivi Tay Dài Vuông Góc 90 Độ Nhập Khẩu North Bayou SP2  (40-70 inch)",989800,989800,0,0
TIKI,giay-dep-nam,7331115,"Chai Xịt Chống Thấm Crep Protect Spray 200ml",465000,465000,0,0
TIKI,giay-dep-nam,37664448,"Giày Nam Da Bò Thật Vân Cá Sấu Cao Cấp  SM28",650000,650000,0,0
TIKI,giay-dep-nam,132230449,"Giày Tây Nam Công Sở Oxford Tomoyo TMN22201",2890000,2890000,0,0
TIKI,dien-tu-dien-lanh,196050359,"Google Tivi Coocaa HD 32 Inch - 32Z72 Youtube Netfilx Smart TV 2022 new tv - Hàng Chính Hãng",3190000,4999000,1809000,36
TIKI,giay-dep-nam,169281047,"Dép sục cross nam yukon sport màu đen hàng xịn, full box",380000,380000,0,0
TIKI,giay-dep-nam,125244034,"Giày Lười Nam - Dio Da Cá Sấu Tam Giác",210000,210000,0,0
TIKI,dien-tu-dien-lanh,107981042,"Sensor dành cho tủ lạnh, cảm biến nhiệt độ các loại",20000,20000,0,0
TIKI,giay-dep-nam,215257762,"Dép nam quai ngang KEEDO KD2636 cao cấp đế cao su chống trơn trượt",480000,480000,0,0
TIKI,giay-dep-nam,172474462,"Giày Sandal Nam The Bily 3 Quai Ngang - Màu Trắng BL04",349000,349000,0,0
TIKI,giay-dep-nam,186743859,"Giày Tây Nam Da Bò Thật BIGGBEN Cao Cấp GT224",649000,800000,151000,19
TIKI,giay-dep-nam,6396849,"Sandal Nam Bít Mũi BIGGBEN Da Bò Thật SD45",419000,500000,81000,16
TIKI,giay-dep-nam,113451077,"Giày lười vải nam thời trang - GN05",98000,98000,0,0
TIKI,giay-dep-nam,188658205,"Lót Giày Nam Chất Liệu Cao Su Non Mềm Êm LGN2022b",38000,38000,0,0
TIKI,dien-tu-dien-lanh,194159198,"[Sản Phẩm Mới] GOOGLE TIVI QLED+ 50 INCH - 50Y72 PRO Youtube Netfilx Smart TV 2022 - Hàng Chính Hãng",7590000,15000000,7410000,49
TIKI,dien-tu-dien-lanh,189176771,"Google Tivi Coocaa 4K 55 Inch - Model 55Y72 - Hàng chính hãng",6990000,7290000,300000,4
TIKI,giay-dep-nam,192880343,"Máy sấy và khử trùng giày Sothing LOOP có thể kéo dài dùng cho cả nam và nữ",269000,289000,20000,7
TIKI,giay-dep-nam,57441310,"Dép nam quai ngang Popular hai màu quai đúc siêu êm, siêu bền",139000,275000,136000,49
TIKI,giay-dep-nam,179912274,"Giày Thể Thao Nam Sneaker Kiểu Hàn Quốc Mẫu Mới 2022 Êm Chân Thoáng Khí Cổ Vừa Trẻ Trung Năng Động GNA05",169000,169000,0,0
TIKI,giay-dep-nam,180577337,"Dép kẹp ngón Vento ARROW Nam đi biển/đi chơi NB0501",265000,265000,0,0
TIKI,giay-dep-nam,138381582,"Dép Nam Bít Mũi TiTi ĐÔ Da Bò Thật Cao Cấp GSB2106a",460000,460000,0,0
TIKI,dien-tu-dien-lanh,162815443,"Giá treo tivi di động NB TW100 (60-110 inch) tích hợp hệ thống nâng hạ tự động Hàng Nhập Khẩu ",7500000,7500000,0,0
TIKI,giay-dep-nam,15932351,"Lót giày da đệm vỏ gỗ sồi (cork) SAPHIR",285000,285000,0,0
TIKI,giay-dep-nam,2597791,"Dép Nam Quai Ngang Da Bò Cao Cấp SUNPOLO SUA12D - Đen (Size",550000,550000,0,0
TIKI,dien-tu-dien-lanh,93088617,"Smart Tivi Samsung 4K 50 inch UA50AU7700",9790000,9790000,0,0
TIKI,dien-tu-dien-lanh,72748653,"Máy giặt Samsung Inverter 8 kg WW80T3020WW - Chỉ giao Hà Nội",5495000,5800000,305000,5
TIKI,dien-tu-dien-lanh,75626797,"ANTEN KHUẾCH ĐẠI HOÀNH KIẾN ĐẠT MODEL HKD-H8,CÓ DÂY CẤP NGUỒN 5V ,HÀNG CHÍNH HÃNG.",129000,129000,0,0
TIKI,dien-tu-dien-lanh,98888600,"anten MOBITV ,KÈM DÂY CẤP NGUỒN 5V ,DÂY ANTEN 15M HÀNG CHÍNH HÃNG DÙNG CHO TIVI TÍCH HỢP DVB T2 và ĐẦU THU TRUYỀN HÌNH SỐ DVB T2",99000,99000,0,0
TIKI,giay-dep-nam,139680849,"Giày Cổ Cao Nam Timberland Waterproof Chukka Màu Bò TB02306124",5490000,5490000,0,0
TIKI,dien-tu-dien-lanh,20997533,"Khung treo tivi nghiêng mâm áp tường 19 - 42 inch M43N - Hàng chính hãng",210000,210000,0,0
TIKI,dien-tu-dien-lanh,139048975,"Máy giặt sấy Samsung 9.5kg WD95T4046CE/SV - Chỉ giao tại Hà Nội",9800000,10300000,500000,5
TIKI,giay-dep-nam,129351632,"Giày Sandals Vento Nam Nữ Quai Ngang dạo phố/đi chơi/đi học SD1019",375000,375000,0,0
TIKI,dien-tu-dien-lanh,173661265,"Đầu thu kỹ thuật số DVB T2 VNPT Igate T201HD hãng chính hãng",279000,279000,0,0
TIKI,dien-tu-dien-lanh,128934736,"anten dvb t2 khuếch đại DUNALS dùng cho tivi tích hợp DVB T2 và đầu thu kỹ thuật số DVB T2. Hàng Chính Hãng",45000,45000,0,0
TIKI,dien-tu-dien-lanh,122420956,"Dàn Anten thông minh cho tivi và thu sóng đầu KTS DVB - T2 ( 15m dây và 1 đầu cắm)",99000,99000,0,0
TIKI,dien-tu-dien-lanh,24229382,"Tấm chắn đổi hướng gió điều hòa , máy lạnh DM-224",95000,95000,0,0
TIKI,dien-tu-dien-lanh,108642513,"Tủ lạnh mini 4L (Dùng cả trên oto xe hơi và trong nhà) - KEMI",920000,920000,0,0
TIKI,dien-tu-dien-lanh,109776740,"Máy giặt mini tại xô HW-150W giặt đồ cho bé giặt quần áo trắng đồ lót và cho sinh viên ở trọ",799000,799000,0,0
TIKI,dien-tu-dien-lanh,184466390,"TX3 mini + mới có điều khiển giọng nói tiếng việt 2G Ram 16G Rom S905w2 bluetooth wifi kép 2 băng tần Android 11 cài sẵn chương trình truyền hình cáp và xem phim HD miễn phí vĩnh viễn Hàng nhập khẩu ",874950,921000,46050,5
TIKI,dien-tu-dien-lanh,24429103,"Android Tivi Box MXQ Pro 4K Ram 1GB - Rom 8GB (xem phim, truyền hình, game online thỏa thích)",560000,560000,0,0
TIKI,dien-tu-dien-lanh,114613084,"Tủ lạnh 2 cánh Panasonic 366 lít NR-TL381GPKV - Lấy nước ngoài - Làm đá siêu tốc - Hàng chính hãng",17390000,17390000,0,0
TIKI,dien-tu-dien-lanh,185225942,"[Giao Toàn quốc] Tủ lạnh Panasonic cao cấp 3 cánh NR-CW530XMMV 495L - Lấy nước ngoài  - Làm đá tự động - Hàng chính hãng",49490000,49490000,0,0
TIKI,giay-dep-nam,54632538,"Lót giày Crep (COMFORT INSOLE)",450000,450000,0,0
TIKI,dien-tu-dien-lanh,52695502,"Máy Giặt Cửa Trước Inverter Electrolux EWF8025CQWA (8kg) - Hàng Chính Hãng",7790000,7790000,0,0
TIKI,giay-dep-nam,71925406,"Dép nhựa nam, dép rọ đi mưa nam  hàng chất lượng SM032",71000,75000,4000,5
TIKI,dien-tu-dien-lanh,52780662,"Tủ lạnh Samsung Inverter 236 lít RT22M4032BU/SV - Hàng Chính Hãng",6623000,6623000,0,0
TIKI,dien-tu-dien-lanh,24413651,"Android tivi box TX3 mini bản Ram 2G - Rom 16G (xem phim, truyền hình, game online thỏa thích) - Hàng nhập khẩu",599000,599000,0,0
TIKI,dien-tu-dien-lanh,195715444,"Tủ Lạnh Mini 20L Mặt Gương, Có hệ thống đèn led 3 chức năng, Tủ lạnh 20L mặt gương có đèn led 2 chiều nóng lạnh dùng cho gia đình, xe hơi - Giao hàng toàn quốc",1658000,1899000,241000,13
TIKI,giay-dep-nam,7350393,"Sandal Nam Doctor BIGGBEN Da Bò Thật SD61",339000,500000,161000,32
TIKI,dien-tu-dien-lanh,123179966,"Máy Rửa Bát Texgio 13 Bộ TG21H775B - Có Thể Lắp Âm - Diệt Khuẩn UV - Hàng Chính Hãng",13499000,13499000,0,0
TIKI,dien-tu-dien-lanh,190959102,"Google Tivi Coocaa 4K 65 Inch - Model 65Y72 - Hàng Chính Hãng",9990000,9990000,0,0
TIKI,dien-tu-dien-lanh,65410485,"Máy giặt LG Inverter 9 kg FV1409S4W - Chỉ giao Hà Nội",8699000,8699000,0,0
TIKI,dien-tu-dien-lanh,104744225,"CHÂN CAO SU CHỐNG RUNG CHỐNG LẮC DÙNG CHO MÁY GIẶT ,TỦ LẠNH...BỘ 4 CÁI ,BẢO VỆ THIẾT BỊ GIA ĐINH.",22999,22999,0,0
TIKI,dien-tu-dien-lanh,126702285,"Remote Điều khiển từ xa tivi dành cho Samsung giọng nói BN59-01298G dùng được cho năm 2015,2016,2017,2018",150000,150000,0,0
TIKI,dien-tu-dien-lanh,92680345,"Tủ Lạnh 2 Cánh Panasonic 420 lít NR-BX471WGKV ngăn đá dưới - Ngăn đông mềm siêu tốc - Hàng chính hãng",21290000,24190000,2900000,12
TIKI,giay-dep-nam,161407136,"Xăng đan nam và nữ ( đế đen quai đen phối trắng ) size từ 34 nữ đến 43 nam",82999,82999,0,0
TIKI,giay-dep-nam,246161335,"[Mẫu HOT] Giày Bảo Hộ Lao Động 2 TH Kiểu Thể Thao Mũi Thép, Đế Lót Thép BD0089-Chống Đinh/Trơn Trượt Giày Công Trình",349000,590000,241000,41
TIKI,dien-tu-dien-lanh,131125585,"Máy giặt Aqua Inverter 9.0 KG AQD-A900F W - Hàng chính hãng - Giao hàng toàn quốc",7250000,7250000,0,0
TIKI,dien-tu-dien-lanh,162172161,"Máy sấy thông hơi Casper 7,2kg TD-72VWD-Hàng chính hãng ( Chỉ giao hàng tại Hà Nội)",5049000,5049000,0,0
TIKI,dien-tu-dien-lanh,100168123,"Tủ lạnh Samsung Inverter 488L 4 cửa RF48A4000B4/SV- Hàng chính hãng- Chỉ giao tại Hà Nội",15197000,17200000,2003000,12
TIKI,dien-tu-dien-lanh,19301952,"Máy Giặt Mini Bán Tự Động, Tia UV Khử Khuẩn",1249200,1249200,0,0
TIKI,giay-dep-nam,177772759,"Dép Nam Quai Ngang Thái Lan GB 43114",190000,190000,0,0
TIKI,dien-tu-dien-lanh,121268130,"Máy giặt Aqua Inverter 8 KG AQD-A800F W - Hàng chính hãng(Giao Toàn Quốc)",5890000,5890000,0,0
TIKI,dien-tu-dien-lanh,38101620,"Máy lão hóa rượu Gipwin Luxury máy khử độc rượu, khử Andehit loại bỏ tạp chất, giúp rượu êm, ngon, không gây đâu đầu, cơ thể nhanh phục hồi - Gipwin 1.8L",18500000,18500000,0,0
TIKI,dien-tu-dien-lanh,90835889,"MÁY GIẶT GẤP GỌN 300W siêu mạnh có thể mang đi du lịch",2460000,2460000,0,0
TIKI,dien-tu-dien-lanh,176463750,"Máy lạnh Panasonic 2HP Inverter CU/CS-XPU18XKH-8-HÀNG CHÍNH HÃNG-GIAO HÀNG TOÀN QUỐC",18550000,18550000,0,0
TIKI,dien-tu-dien-lanh,83419101,"Tủ lạnh Panasonic Inverter 377 lít NR-BX421GPKV - Chỉ giao Hà Nội",17350000,17350000,0,0
TIKI,dien-tu-dien-lanh,16463384,"Tủ Đông Dàn Đồng Sanaky VH-2299A1 1 Ngăn 2 Cánh - Hàng Chính Hãng",5990000,5990000,0,0
TIKI,giay-dep-nam,173609788,"DÉP KẸP DA BÒ CAO CẤP VATIS VA2013",199000,379000,180000,47
TIKI,dien-tu-dien-lanh,87941161,"Smart Tivi Crystal Samsung 4K 50 inch UA50AU8000",9900000,9900000,0,0
TIKI,giay-dep-nam,270859803,"Giày Thể Thao Sneaker Goya GY232",495000,950000,455000,48
TIKI,giay-dep-nam,174426170,"Dép quai kẹp Bitis nam",195000,195000,0,0
TIKI,dien-tu-dien-lanh,53135753,"Tủ đông Hòa Phát HCF-106S1N1 - Hàng chính hãng",4900000,4900000,0,0
TIKI,dien-tu-dien-lanh,191093025,"Tủ Lạnh 2 Cánh Panasonic 268L NR-TV301BPKV - Diệt vi khuẩn 99.99% - Hàng Chính Hãng - Giao Toàn Quốc",10390000,11990000,1600000,13
TIKI,dien-tu-dien-lanh,113712375,"Giá treo ti vi xoay 90 độ cho ti vi 32 đến 55 inch KL Q4",550000,550000,0,0
TIKI,dien-tu-dien-lanh,161256222,"Tủ lạnh mini Kemin 22L",2512000,2750000,238000,9
TIKI,dien-tu-dien-lanh,23556596,"Máy Nước Nóng Trực Tiếp Không Bơm Electrolux EWE451GX-DWB (4500W) - Hàng Chính Hãng",1920000,2700000,780000,29
TIKI,giay-dep-nam,195243464,"Dép nam quai ngang, nhựa mềm đi mưa Thái Lan Adda 34G10",150000,150000,0,0
TIKI,dien-tu-dien-lanh,24420855,"Android TV Box X96 mini Ram 2GB - ROM 16GB (xem phim, truyền hình, game online thỏa thích)",508000,508000,0,0
TIKI,dien-tu-dien-lanh,195979566,"Tủ lạnh LG Inverter 635 lít GR-D257WB - Hàng chính hãng [Giao hàng toàn quốc]",27080000,35990000,8910000,25
TIKI,dien-tu-dien-lanh,133736092,"MAGIC REMOTE LG ANMR21, MR21GA (2021) – HÀNG CHÍNH HÃNG",595000,595000,0,0
TIKI,dien-tu-dien-lanh,197175873,"Remote Điều Khiển Tivi Dành Cho SAMSUNG Nhận Giọng Nói Smart TV QLED 8K 4K BN59-01363J",160000,160000,0,0
TIKI,dien-tu-dien-lanh,196978629,"Điều hoà di động 9000BTU FUJIHOME dùng cho phòng 20m2, máy lạnh đứng di động mini có điều khiển từ xa không cần lắp đặt sử dụng app hút ẩm, giao hàng toàn quốc- Hàng Nhập Khẩu",4990000,4990000,0,0
TIKI,dien-tu-dien-lanh,119967866,"Tủ lạnh Samsung Inverter 488 lít RF48A4000B4/SV - Chỉ giao tại HN",16500000,16500000,0,0
TIKI,dien-tu-dien-lanh,144488702,"Tủ lạnh Panasonic 4 cánh ngăn đá dưới 540L NR-YW590YHHV - Hàng chính hãng",65990000,75890000,9900000,13
TIKI,dien-tu-dien-lanh,185227742,"[GIAO TOÀN QUỐC] Tủ lạnh Panasonic dòng cao cấp 2 cánh NR-BW530XMMV 500L - Cảm biến thông minh - Vòi lấy nước ngoài tiện lợi  - Chức năng làm đá tự động - Hàng chính hãng",34490000,34490000,0,0
TIKI,dien-tu-dien-lanh,121268124,"Máy giặt LG Inverter 8.5 kg FV1408S4W - Hàng chính hãng(Giao Toàn Quốc)",8399000,8399000,0,0
TIKI,dien-tu-dien-lanh,23474497,"TỦ LẠNH FUNIKI FR-125CI 120L- Hàng chính hãng",3579000,3579000,0,0
TIKI,dien-tu-dien-lanh,171262021,"Tủ lạnh mini KEMIN 6L CAT HEAD Chính hãng",956000,1200000,244000,20
TIKI,dien-tu-dien-lanh,195927551,"Tủ lạnh Aqua Inverter 456 lít AQR-IG525AM (GB) - Hàng chính hãng [Giao hàng toàn quốc]",17180000,21990000,4810000,22
TIKI,dien-tu-dien-lanh,177629263,"[HCM] Tủ Lạnh Electorlux EUM0930BD-VN / EUM0930AD-VN - Dung Tích 94L - Hàng Chính Hãng",3990000,3990000,0,0
TIKI,dien-tu-dien-lanh,87726503,"Tủ Lạnh 2 Cánh Panasonic 380 lít NR-BX421WGKV ngăn đá dưới - Ngăn đông mềm siêu tốc - Hàng chính hãng",19190000,21890000,2700000,12
TIKI,dien-tu-dien-lanh,29114376,"Tủ Lạnh Side By Side Inverter Samsung RS62R5001M9/SV (647L) - Hàng Chính Hãng",17109000,17109000,0,0
TIKI,dien-tu-dien-lanh,93088626,"Smart Tivi Samsung 4K 55 inch UA55AU7700",10490000,10490000,0,0
TIKI,dien-tu-dien-lanh,3818775,"Tủ lạnh Sharp Inverter 165L SJ-X176E-DSS",4800000,4800000,0,0
TIKI,dien-tu-dien-lanh,83489477,"Tủ Lạnh 2 Cánh Panasonic 417 lít NR-BX471GPKV - Lấy nước ngoài - Hàng chính hãng",20700000,23590000,2890000,12
TIKI,dien-tu-dien-lanh,50560427,"Tủ lạnh mini Aqua 50 lít AQR-D59FA-BS - Chỉ giao tại Hà Nội",2985000,2985000,0,0
TIKI,dien-tu-dien-lanh,178058672,"Google Tivi Sony 4K 65 inch KD-65X75K - Model 2022",14450000,15200000,750000,5
TIKI,dien-tu-dien-lanh,103944310,"Tủ lạnh mini dùng được cả trong nhà và trên xe hơi - 16L (giao hàng Toàn Quốc)",1800000,1800000,0,0
TIKI,dien-tu-dien-lanh,107100928,"Tủ lạnh Panasonic Inverter 550 lít NR-DZ601VGKV - Ngăn đông mềm siêu tốc - Hàng chính hãng",37990000,37990000,0,0
TIKI,dien-tu-dien-lanh,179408975,"Mạch công tắc cảm biến tiệm cận V2 - nguồn nuôi 5V",139000,139000,0,0
TIKI,dien-tu-dien-lanh,166449029,"Máy Rửa Chén Độc Lập Bosch HMH.SMS63L08EA (Series 6) - 12 Bộ - 6 Chương Trình Rửa - Hàng Chính Hãng",12000000,23000000,11000000,48
TIKI,dien-tu-dien-lanh,192387731,"[Sản phẩm mới nhất 2022] GOOGLE Tivi 55'' 4K HDR - 55T66 - Gam Màu Rộng Dolby Audio - Tivi Giá Rẻ Chất Lượng - Bảo Hành 2 Năm - Hàng chính hãng",8095000,14490000,6395000,44
TIKI,dien-tu-dien-lanh,91550407,"Máy Nước Nóng Ariston SL BLU 30 - 2.5 - FE (2500W) Hàng Chính Hãng",2389000,2389000,0,0
TIKI,dien-tu-dien-lanh,20557588,"Tủ lạnh Toshiba Inverter 180 lít GR-B22VU UKG",5232000,5232000,0,0
TIKI,dien-tu-dien-lanh,195936707,"Tủ lạnh Mini Electrolux 94 lít EUM0930BD-VN - Hàng chính hãng [Giao hàng toàn quốc]",3850000,3990000,140000,4
TIKI,dien-tu-dien-lanh,196965336,"Điều hoà di động kiêm hút ẩm 7000BTU FUJIHOME, máy lạnh đứng di động mini có điều khiển từ xa không cần lắp đặt, giao hàng toàn quốc - Hàng Nhập Khẩu",4490000,4490000,0,0
TIKI,dien-tu-dien-lanh,195522179,"Smart Tivi LG Full HD 32 inch 32LQ576BPSA - Model 2022",5250000,5250000,0,0
TIKI,dien-tu-dien-lanh,70359524,"Bình nóng lạnh Panasonic DH-30HBMVW 30L, hàng chính hãng",3449000,3449000,0,0
TIKI,dien-tu-dien-lanh,161255388,"Tủ lạnh mini Kemin 25L",2906000,3150000,244000,8
TIKI,dien-tu-dien-lanh,52695829,"Máy giặt Electrolux Inverter 8 kg EWF8025CQSA",7339000,7339000,0,0
TIKI,dien-tu-dien-lanh,186088491,"Máy rửa bát Bosch SMS6ECI07E serie 6 - 60cm Động cơ EcoSilence Drive - Hàng chính hãng",29235600,29235600,0,0
TIKI,giay-dep-nam,42899678,"Giày Sneaker thể thao nam cổ cao trắng đen phố họa tiết ST018",259000,411000,152000,37
TIKI,giay-dep-nam,119288071,"Dép Nam Quai Ngang TiTi ĐÔ Da Bò Thật Cao Cấp DNA2132a",420000,420000,0,0
TIKI,giay-dep-nam,149492536,"Giày thể thao màu trắng Converse Chuck Taylor 1970s Low 162065C",1900000,1900000,0,0
TIKI,dien-tu-dien-lanh,186740950,"Tủ lạnh Toshiba Inverter 509 lít GR-RF605WI-PMV(06)-MG -Hàng chính hãng- Giao tại Hà Nội",18800000,18800000,0,0
TIKI,giay-dep-nam,73215208,"Giày Da Nam Mã CS003",450000,900000,450000,50
TIKI,dien-tu-dien-lanh,189336414,"Tủ lạnh mini Kemin K15 - 15L Chính Hãng - Chỉnh nhiệt - Công nghệ chống đọng nước",2802500,2950000,147500,5
TIKI,giay-dep-nam,248400066,"Giày sĩ quan công ty 32 cấp tướng, giày da nam Aseco 32 mã 729 đế hơi",1180000,1180000,0,0
TIKI,giay-dep-nam,193735877,"Giày Lười Nam Màu Ghi s046 Đế bệt",105000,150000,45000,30
TIKI,giay-dep-nam,87142469,"Giày Lười Nam Penny Loafer Tomoyo TMN07401",2890000,2890000,0,0
TIKI,dien-tu-dien-lanh,195962659,"[Giao hàng Toàn quốc] Tủ lạnh Panasonic Ngăn đông mềm diệt khuẩn 377L NR-BX421GUS9 - Tiết kiệm điện với bộ đa cảm biến Econavi - Mặt thép - Hàng chính hãng",17230000,21490000,4260000,20
TIKI,dien-tu-dien-lanh,217509839,"Remote Điều Khiển Giọng Nói Smart TV, Tivi Thông Minh Dành Cho SONY BRAVIA RMF-TX310P",220000,220000,0,0
TIKI,dien-tu-dien-lanh,126702089,"Remote Điều khiển từ xa tivi dành cho Smart TV Sharp",90250,95000,4750,5
TIKI,giay-dep-nam,101655661,"Giày Tây Tăng Chiều Cao 6cm Đệm Khí Giầy Da Tăng Chiều Cao Sans111",369000,369000,0,0
TIKI,giay-dep-nam,171535923,"Dép quai ngang nam nữ M Masler-MT đan mạch xám với lớp đế chống nước bền bỉ và quai êm chân DMX",458000,458000,0,0
TIKI,giay-dep-nam,67247490,"Giày Lười Nam BANULI K1ML1T0 (Giày Nam Da Bò Nhập Khẩu Nguyên Con, Đế Siêu Nhẹ Siêu Êm)",1500000,1500000,0,0
TIKI,dien-tu-dien-lanh,170682596,"Tủ lạnh 4 cánh ngăn đá trên Panasonic 550L NR-DZ601YGKV - Hàng chính hãng - Chỉ giao tại HCM",38790000,43690000,4900000,11
TIKI,giay-dep-nam,175969848,"Dép Quai Ngang Nam Cao Cấp Da Bò Thật KEEDO-KD3304 - Đen",340000,340000,0,0
TIKI,dien-tu-dien-lanh,19934584,"Máy Lạnh Di Động KoolMan 1.5HP - Hàng Nhập Khẩu",9900000,9900000,0,0
TIKI,giay-dep-nam,156214474,"GIÀY LƯỜI ĐÍNH KHUY NAM DA BÒ THẬT 100% CAO CẤP",750000,750000,0,0
TIKI,dien-tu-dien-lanh,192384593,"[Sản phẩm mới nhất 2022] GOOGLE Tivi 50'' 4K HDR - 50T66 - Gam Màu Rộng Dolby Audio - Tivi Giá Rẻ Chất Lượng - Bảo Hành 2 Năm - Hàng chính hãng",7295000,12490000,5195000,42
TIKI,giay-dep-nam,97754334,"Giày Sandal phong cách thời trang  Nhật Bản đế mềm chất liệu da bò thật phù hợp với các mùa trong năm mã 12129",219000,429000,210000,49
TIKI,giay-dep-nam,105521937,"Lót giày trơn, lót giày nam nữ cực êm, không bong màu đen",9000,9000,0,0
TIKI,giay-dep-nam,11502185,"Giày Sneaker Nam GV008",99000,99000,0,0
TIKI,giay-dep-nam,127580599,"Giày Boots Doc.058 Crazy Horse da bò sáp ngựa",769000,769000,0,0
TIKI,giay-dep-nam,190541766,"Dép quai kẹp đế cao su Bitis nam",280000,280000,0,0
TIKI,giay-dep-nam,110448724,"Giày lười vải nam thời trang - GN07",99000,99000,0,0
TIKI,giay-dep-nam,57381733,"Giày Thể Thao Sneaker Nam Pettino GT03T (Trắng - Đen)",109000,200000,91000,46
TIKI,giay-dep-nam,177665631,"Dép Nam Quai Ngang Da Bò Thật BIGGBEN Cao Cấp DN307",289000,400000,111000,28
TIKI,giay-dep-nam,14272935,"Dép bít mũi rọ đen nam trường hải da bò cao cấp BM033",273000,319000,46000,14
TIKI,giay-dep-nam,15333267,"Sandal Nam Bít Đầu BIGGBEN Da Bò Thật SD85",449000,550000,101000,18
TIKI,giay-dep-nam,130412234,"Giày nam, giày thể thao nam G fashion - Z888",200000,200000,0,0
TIKI,giay-dep-nam,92901105,"Giày quai ngang nam/ dép quai hậu quai ngang thời trang trẻ trung năng động -mã 58020",399000,759000,360000,47
TIKI,giay-dep-nam,55106110,"Giày Tây Nam Da Bò BIGGBEN Cao Cấp GT170",599000,600000,1000,0
TIKI,giay-dep-nam,55062727,"Dép Nam Da Bò BIGGBEN Cao Cấp DN251",349000,400000,51000,13
TIKI,giay-dep-nam,58837555,"DÉP NAM QUAI KẸP GIA VY TA121",195000,195000,0,0
TIKI,giay-dep-nam,50242384,"Combo 2 chai tẩy trắng vệ sinh giày dép đánh bóng túi xách có đầu chà màu ngẫu nhiên",24000,24000,0,0
TIKI,giay-dep-nam,151952872,"Dép nam quai ngang da bò cao cấp",239000,239000,0,0
TIKI,giay-dep-nam,68155550,"Giày da cao cổ nam và nữ phong cách Hàn Quốc mã 8634-5",859000,1590000,731000,46
TIKI,giay-dep-nam,71961824,"Giày mọi nam đế âm HÀ NAM da bò thật cao cấp GDA2020",692000,692000,0,0
TIKI,giay-dep-nam,96299929,"Dép quai hậu nam đế mềm êm, nhẹ thoáng khí  phong cách Nhật Bản mã 58237-8",409000,798000,389000,49
TIKI,giay-dep-nam,9999100,"Giày tây nam Oxford Tomoyo đen bóng TMN92101",2890000,2890000,0,0
TIKI,giay-dep-nam,147217894,"Giày Sandal Nam The Bily Quai Ngang - Màu Trắng BL03T",339000,339000,0,0
TIKI,dien-tu-dien-lanh,4444269,"Tủ lạnh Samsung Inverter 280 lít RB27N4010S8/SV",8400000,8400000,0,0
TIKI,giay-dep-nam,170384383,"Dép Nam Quai Ngang TiTi ĐÔ Da Bò Thật Cao Cấp DNA2175c",389000,389000,0,0
TIKI,giay-dep-nam,153995579,"Giày lười nam da thật đẳng cấp  thời trang-26134",529000,899000,370000,41
TIKI,giay-dep-nam,180574439,"Dép xỏ ngón Vento ARROW Nữ đi biển/đi chơi NB0508",245000,245000,0,0
TIKI,dien-tu-dien-lanh,247371820,"Điều khiển tivi tìm kiếm giọng nói dành cho tivi Samsung",150000,150000,0,0
TIKI,giay-dep-nam,135898801,"Giày Tây Nam Trung Niên Giả Dây",199000,199000,0,0
TIKI,giay-dep-nam,132372006,"Giày lười nam - Slip on nam da - Mã S193",350000,350000,0,0
TIKI,giay-dep-nam,96180083,"Đông Hải - Giày Tây Nam G01A4",1690000,1690000,0,0
TIKI,giay-dep-nam,74541407,"Giày Thể Thao Nam Sneaker Cổ Thấp Fom chuẩn Ôm chân G169",99000,180000,81000,45
TIKI,giay-dep-nam,51009821,"Dép sục nhựa quai hậu thời trang đen phối đỏ - SN930",85000,85000,0,0
TIKI,giay-dep-nam,137752762,"Giày Lười Vải Nam - Phong Cách Thể Thao TT2001",169000,169000,0,0
TIKI,giay-dep-nam,77444891," Giày Nam Giày Tây Nam Công Sở Phong Cách Lịch Lãm (GNA-004) Tăng Chiều Cao [HÀNG ĐẸP",249000,249000,0,0
TIKI,giay-dep-nam,43350108,"Giày Da Nam Cao Cấp Phong Cách Trẻ Trung Năng Động Lịch lãm, Giày Tây Nam HS22",649000,649000,0,0
TIKI,giay-dep-nam,183069382,"Dép xỏ ngón nam quai dù cao cấp KEEDO KD1808",390000,390000,0,0
TIKI,giay-dep-nam,186877299,"Giày tây lười nam cao cấp, Giày lười da bò pu in vân nổi bật trẻ trung tăng chiều cao đế cao su đúc - Mã DR01",160000,160000,0,0
TIKI,giay-dep-nam,43352682,"Giày Da Nam Cao Cấp Phong Cách Trẻ Trung Năng Động Lịch lãm, Giày Tây Nam HS25",350000,350000,0,0
TIKI,giay-dep-nam,272839167,"Giày Da Nam Trẻ Trung, Thời Trang, Cao Cấp, Mũi Tròn, Derby MD6 GR - TG0923005",599000,599000,0,0
TIKI,giay-dep-nam,176501918,"Dép bé trai quai ngang siêu nhân người nhện 3D Thái Lan 31R2V",160000,160000,0,0
TIKI,giay-dep-nam,141741278,"Xả Kho Giày Lười Da Bò Thật , Đế Cao Su Khâu Cực Bền , Bảo Hành Da, Đổi Size, Hot Trend",229000,350000,121000,35
TIKI,giay-dep-nam,136816245,"Giày Boot nam Doc.022 da bò Lucas Shoes",719000,719000,0,0
TIKI,giay-dep-nam,55953905,"Giày tây tăng chiều cao Trường Hải da bò cao cấp cao 6.5 cm trường Hải GTN0125",546000,645000,99000,15
TIKI,giay-dep-nam,186149136,"Dép da cá sấu nam màu đen chính hãng Trường Hải may viền chắc chắn DN255",591000,699000,108000,15
TIKI,giay-dep-nam,73738400,"Xi Dưỡng Cao Cấp Đánh Bóng Làm Mới Giày, Túi, Áo da, Đồ Da",69000,69000,0,0
TIKI,giay-dep-nam,63205098,"GIÀY SANDAL NAM GIAVY  QUAI DÂY NGANG S340",210000,210000,0,0
TIKI,giay-dep-nam,160686512,"Dép Xỏ Ngón Unisex Waa. - KẸP FLIP-FLOPS",590000,590000,0,0
TIKI,giay-dep-nam,133235025,"Dép Nam Xỏ ngón Thái Lan Quai Kẹp Gambol 41127",230000,230000,0,0
TIKI,giay-dep-nam,144622933,"Giày thể thao nam, giày thể thao thời trang nam, giày đi chơi,  êm chân thoáng khí siêu nhẹ mã 5818",419000,799000,380000,48
TIKI,giay-dep-nam,163827033,"Xăng Đan Quai Ngang, Giày Sandal Nam Da Bò SUNPOLO SDA006 (Đen)",580000,580000,0,0
TIKI,giay-dep-nam,170957632,"[CHẤT LƯỢNG] Giày boot chelsea nam da trơn cao cấp êm chân cá tính SM089CHEL - Đen",183000,195000,12000,6
TIKI,giay-dep-nam,186392335,"GIÀY TÂY NAM GN683",490000,490000,0,0
TIKI,giay-dep-nam,7977133,"Giày Tây Nam Da Bò Sunpolo SUMU07N",680000,680000,0,0
TIKI,giay-dep-nam,204124551,"CONVERSE - Giày sneakers cổ cao unisex Chuck Taylor All Star Classic 159484C",1550000,1550000,0,0
TIKI,giay-dep-nam,32863969,"Giày Lười Nam Công Sở Happyshoes Da Bò Thật  - HS390",550000,550000,0,0
TIKI,giay-dep-nam,111231917,"Dép lê nam đi biển đế xốp LAHstore",138600,138600,0,0
TIKI,giay-dep-nam,107058711,"Dép Nam Sức Khoẻ Spenco Yumi Black Carbon 447 - Dép kẹp nam giảm đau chân",1695000,1695000,0,0
TIKI,giay-dep-nam,88917307,"Giày Converse Chuck Taylor 1970s ​Archive Paint Splatter 170804C",1710000,1900000,190000,10
TIKI,giay-dep-nam,133236076,"Dép kẹp Nam Xỏ ngón Deblu Thái Lan M 7826",220000,220000,0,0
TIKI,giay-dep-nam,163894759,"Dép Da Nam, Dép Nam Quai Ngang Da Bò SUNPOLO SQND36 (Nâu)",490000,490000,0,0
TIKI,giay-dep-nam,88813692,"Giày tây Giày lười nam hàn quốc đai kim loại vàng lịch lãm",222000,222000,0,0
TIKI,giay-dep-nam,192725949,"Giày Nam 2022 Mẫu Mới, Giày Sneaker Nam Trắng Cam, Phong Cách Trẻ Trung Năng Động",1279000,1279000,0,0
TIKI,giay-dep-nam,167433371,"Dép nam cao su Thái Lan quai chữ H - Street 4.1",210000,210000,0,0
TIKI,giay-dep-nam,193642113,"Dép lê nam Loufu 6176, mềm, êm, bền, không sợ nước, size 40-44",116000,145000,29000,20
TIKI,giay-dep-nam,125261582,"Giày Sục Nam Cực Đẹp Đang Được Yêu Thích Nhất Hè 2021 - Mã l194",210000,210000,0,0
TIKI,giay-dep-nam,69178650,"XI ĐÁNH BÓNG CÁC LOẠI GIẦY, DƯỠNG ÁO DA , SALONG DA",65000,65000,0,0
TIKI,giay-dep-nam,57080245,"Giày rọ _ Giày đục lỗ da bò thật cổ điển VO Shoes_PH998",390000,490000,100000,20
TIKI,giay-dep-nam,81136033,"Giày Lười Nam TOMOYO Penny Loafer Star TMN05703",2490000,2490000,0,0
TIKI,giay-dep-nam,63191184,"GIÀY SANDAL NAM GIAVY  2 DÂY NGANG - SL411",225000,225000,0,0
TIKI,giay-dep-nam,69691320,"Giày sneaker cao cổ nam có xích",250000,250000,0,0
TIKI,dien-tu-dien-lanh,197804004,"Công tắc số quạt 4 nút, 5 nút loại đầu bầu dục điều chỉnh tốc độ gió cho quạt cây, quạt bàn",8490,8490,0,0
TIKI,dien-tu-dien-lanh,17483486,"Remote điều khiển dùng cho điều hòa GREE",37000,37000,0,0
TIKI,dien-tu-dien-lanh,98164901,"Remote điều khiển quạt Vinawind điện cơ Thống Nhất ",39900,39900,0,0
TIKI,dien-tu-dien-lanh,103703724,"Chuột Bay Điều Khiển Không Dây ENYBOX MX3 Pro Có Voice - Sử Dụng Cho Các Thiết Bị Android- Hàng chính hãng",261250,275000,13750,5
TIKI,dien-tu-dien-lanh,272848892,"Điện trở dán 0402 các loại : 27R 30R 33R.....560R 620R 680R 1%.Mới Chính gốc",8000,8000,0,0
TIKI,dien-tu-dien-lanh,125348985,"Điều hòa Casper Inverter  HC-18IA32 (18000BTU) - Chỉ giao Hà Nội",13950000,13950000,0,0
TIKI,dien-tu-dien-lanh,134911366,"TẤM CHẮN GIÓ KHE LẠNH ĐIỀU HÒA Kt 60X15cm",750000,750000,0,0
TIKI,dien-tu-dien-lanh,171273557,"Túi trùm vệ sinh máy lạnh treo tường - Áo vệ sinh máy lạnh VẢI DÙ CHỐNG THẤM siêu rẻ - kdxanhbích",55000,55000,0,0
TIKI,dien-tu-dien-lanh,196001920,"Tủ lạnh Casper Inverter 300 lít RB-320VT - Hàng chính hãng [Giao hàng toàn quốc]",11140000,11140000,0,0
TIKI,dien-tu-dien-lanh,145750487,"Máy lạnh Panasonic CU/CS-VU9UKH-8 - Một chiều - Inverter sang trọng Sky series - Hàng Chính Hãng",21150000,21150000,0,0
TIKI,dien-tu-dien-lanh,178058680,"Google Tivi Sony 4K 55 inch KD-55X75K - Model 2022",11800000,11800000,0,0
TIKI,dien-tu-dien-lanh,24348434,"Điều khiển dành cho tivi samsung smart ngắn BN59 - 01268D",65000,65000,0,0
TIKI,dien-tu-dien-lanh,53298450,"Tủ lạnh Funiki Hòa Phát FR 126ISU 125 lít - Hàng Chính Hãng",3690000,3690000,0,0
TIKI,dien-tu-dien-lanh,197574554,"Máy Rửa Chén Độc Lập Ecalite EDW-SMS6014AB - 14 Bộ - 8 Chương Trình Rửa - Tự Động Hé Cửa - Hàng Chính Hãng",7000000,14000000,7000000,50
TIKI,dien-tu-dien-lanh,92712794,"Tủ Lạnh 2 Cánh Panasonic 377 lít NR-BX421GPKV ngăn đá dưới - Lấy nước ngoài - Hàng chính hãng",18690000,21290000,2600000,12
TIKI,dien-tu-dien-lanh,15808813,"Tủ Lạnh Inverter Samsung RS62R5001B4/SV (647L) - Hàng chính hãng",14090000,25090000,11000000,44
TIKI,dien-tu-dien-lanh,77913405,"Tủ lạnh Aqua Inverter 541L AQR-S541XA(BL) - Chỉ Giao tại HCM",15699000,15699000,0,0
TIKI,dien-tu-dien-lanh,196009680,"Tủ lạnh Aqua Inverter 344 lít AQR-T389FA(WGB) - Hàng chính hãng [Giao hàng toàn quốc]",8540000,13490000,4950000,37
TIKI,dien-tu-dien-lanh,102648278,"Điều hòa di động NEW WIDETECH sử dụng app Xiaomi Mihome Hàng chính hãng",5669000,5790000,121000,2
TIKI,dien-tu-dien-lanh,196989644,"Điều hoà di động 12.000BTU FUJIHOME dùng cho phòng 30m2, máy lạnh đứng di động mini có điều khiển từ xa không cần lắp đặt sử dụng app hút ẩm giao hàng toàn quốc - Hàng Nhập Khẩu",7362900,7362900,0,0
TIKI,dien-tu-dien-lanh,143693043,"Smart Tivi Neo QLED  Samsung 8K 65 inch QA65QN700A",34500000,34500000,0,0
TIKI,dien-tu-dien-lanh,12724684,"Tủ Lạnh Inverter Sharp SJ-FX688VG-BK (605L) - Hàng Chính Hãng",22910000,32000000,9090000,28
TIKI,dien-tu-dien-lanh,230031912,"Bình đun nước nóng tức thời Ariston AURES PREMIUM+ 4.5P - Hàng chính hãng",3039000,3039000,0,0
TIKI,dien-tu-dien-lanh,136825948,"Máy giặt LG Inverter 10 kg FV1410S4P - Chỉ giao tại HN",10690000,10690000,0,0
TIKI,dien-tu-dien-lanh,141111452,"Máy giặt Electrolux Inverter 8 kg EWF8024D3WB - chỉ giao Hà Nội",6480000,6480000,0,0
TIKI,dien-tu-dien-lanh,112707854,"[CHỈ GIAO TẠI HCM] - Máy Giặt Cửa Trên Panasonic 11.5KG NA-FD11AR1BV - Hàng Chính Hãng",13790000,13790000,0,0
TIKI,dien-tu-dien-lanh,110931453,"Tuốc năng điện quạt ( motor đảo chiều quay quạt) 3HT - Hàng chính hãng",22000,22000,0,0
TIKI,dien-tu-dien-lanh,132786009,"Máy sấy bơm nhiệt LG 9 Kg DVHP09W - Hàng chính hãng - Giao toàn quốc",18500000,18500000,0,0
TIKI,dien-tu-dien-lanh,121744036,"Máy sấy bơm nhiệt LG 9 Kg DVHP09B - Chỉ giao tại HN",18950000,18950000,0,0
TIKI,dien-tu-dien-lanh,65439718,"Máy Giặt LG Inverter 8.5 Kg FV1408S4V - Chỉ Giao Hà Nội",9690000,9690000,0,0
TIKI,dien-tu-dien-lanh,114441286,"Hàng Chính Hãng - Giao toàn quốc Tủ lạnh mini 25l Moaz BeBe MB-028 gọn nhẹ, dễ dàng di chuyễn, thích hợp với nhiều không gian khác nhau",3880000,3880000,0,0
TIKI,dien-tu-dien-lanh,169267704,"GIÁ TREO TIVI DI ĐỘNG 3 CHÂN CAO CẤP",379000,379000,0,0
TIKI,dien-tu-dien-lanh,87909062,"Smart Tivi Samsung 4K 55 inch UA55AU7000",9619000,9619000,0,0
TIKI,dien-tu-dien-lanh,92939385,"Tủ lạnh Samsung Multidoor Inverter 488 lít RF48A4010B4/SV MỚI 2021 - HÀNG CHÍNH HÃNG - CHỈ GIAO HCM",18218000,18218000,0,0
TIKI,dien-tu-dien-lanh,100042603,"Bộ vỏ quạt b4 + lồng",168000,168000,0,0
TIKI,dien-tu-dien-lanh,167580341,"Smart Tivi QLED Samsung 4K 65 inch QA65Q60BA - Model 2022",15200000,15200000,0,0
TIKI,dien-tu-dien-lanh,176463766,"MÁY LẠNH PANASONIC INVERTER 1.5HP CU/CS-XPU12XKH-8-HÀNG CHÍNH HÃNG-GIAO HÀNG TOÀN QUỐC",11980000,11980000,0,0
TIKI,dien-tu-dien-lanh,65453426,"Máy giặt LG Inverter 8.5 kg FV1408S4W - Chỉ giao Hà Nội",8322000,8322000,0,0
TIKI,dien-tu-dien-lanh,95917573,"Máy giặt Samsung AI Inverter 9kg WW90TP44DSB/SV - Chỉ giao Hà Nội",9119000,9119000,0,0
TIKI,dien-tu-dien-lanh,122905056,"[CHỈ GIAO TẠI HCM] Máy giặt cửa trên Panasonic Inverter 12.5 Kg NA-FD125V1BV - Hàng chính hãng",17390000,17390000,0,0
TIKI,giay-dep-nam,12502667,"Sandal Doctor Nam BIGGBEN Da Bò Thật SD81",339000,450000,111000,25
TIKI,giay-dep-nam,184954375,"Dép Nam Quai ngang, dép nhựa đi mưa Thái Lan Adda 82103",150000,150000,0,0
TIKI,giay-dep-nam,84552064,"Dép dọ bộ đội , dép dọ nam",99000,99000,0,0
TIKI,giay-dep-nam,192197093,"Giày sục Nam Da Bò cao cấp sapo nam trẻ trung năng động Màu Đen-Giày hở gót-S07 Giày SAGO’S",455000,455000,0,0
TIKI,giay-dep-nam,261964617,"Dép Sneaker Buzz Camouflage Sandals 1SB0020",850000,850000,0,0
TIKI,giay-dep-nam,129944894,"GIÀY SNEAKER CONVERSE CLASSIC CỔ CAO FULL ĐEN - M3310",1550000,1550000,0,0
TIKI,giay-dep-nam,181096113,"Giày nam da thật ELLY HOMME – EGTM23",2199000,2199000,0,0
TIKI,giay-dep-nam,72508033,"Dép nam sandal da bò đế cao su cao cấp Trường Hải SDN01275",281000,329000,48000,15
TIKI,giay-dep-nam,27601578,"Giày Mọi Nam BiGGBEN Da Bò Thật Cao Cấp GM196",599000,700000,101000,14
TIKI,giay-dep-nam,49233166,"Giày lười nam Trường Hải  da bò đen đế cao su chống mòn cao 2.5cm  GMN014",355000,420000,65000,15
TIKI,giay-dep-nam,15198799,"Giày lười nam Tomoyo đen bóng TMN03101",2890000,2890000,0,0
TIKI,giay-dep-nam,251395558,"Dép quai ngang Biti's nam",360000,360000,0,0
TIKI,giay-dep-nam,120035812,"HT9129-30-31-32-33 - Xi nước đánh bóng Huy Hoàng màu đen, nâu, vàng bò, trắng, không màu",99000,99000,0,0
TIKI,giay-dep-nam,125777443,"Dép bít nam size 40 đến 45",75000,75000,0,0
TIKI,giay-dep-nam,270955315,"Giày Converse One Star Pro Herringbone Low Top - A03663C",2200000,2200000,0,0
TIKI,giay-dep-nam,88821277,"Giày Da nam cực chất xả kho giá gốc  - giày lười nam MÃ L182",210000,210000,0,0
TIKI,giay-dep-nam,254124101,"Dép nam trung niên bền đẹp thương hiệu KEEDO KDN09",340000,340000,0,0
TIKI,giay-dep-nam,137947824,"Dép Nam Quai Ngang HÀ NAM Da Bò Thật Cao Cấp DNA2148",369000,369000,0,0
TIKI,giay-dep-nam,66606850,"Dép bít mũi nam da bò thật HÀ NAM cao cấp GSB2042g",420000,420000,0,0
TIKI,giay-dep-nam,249860765,"[NEW] Original TIMBERLAND Giày Cổ Cao Nam 6-inch Premium Waterproof Boots Tree Vault TB0A5NGC01",6490000,6490000,0,0
TIKI,giay-dep-nam,56219117,"Dép Da Nam D27 - Dép Lê Nam Quai Ngang, Quai Chéo Cực Đẹp Cho Mùa Hè",155000,155000,0,0
TIKI,giay-dep-nam,110993963,"[Hàng Siêu Hiếm] Giày nam da lộn AK 5851",220000,220000,0,0
TIKI,giay-dep-nam,67071750,"Giày lười nam da bò thật Happyshoes, đế may chất liệu cao su ép nhiệt chắc chắn có rãnh chống trượt an toàn -HS64",350000,350000,0,0
TIKI,giay-dep-nam,114619512,"Dép Nam Da Bò Cao Cấp, Kiểu Dáng Thời Trang, Giá Tốt, Gia Công Tại Xưởng Siêu Êm nhẹ, Bền đẹp",139000,139000,0,0
TIKI,giay-dep-nam,84197998,"Giày Sandals Vento Nam Quai Chéo dạo phố đi chơi đi làm NV4905",260000,260000,0,0
TIKI,giay-dep-nam,187482211,"Giày sandal nam Giavy kiểu quai chéo SL546",200000,200000,0,0
TIKI,giay-dep-nam,40204053,"Miếng lót giày thể thao thoáng khí V.3 - Size nam (41-45)",123000,123000,0,0
TIKI,giay-dep-nam,132080167,"Giày Nam Cổ Cao LMA Màu Đen",192000,192000,0,0
TIKI,giay-dep-nam,48224920,"GIày Sandal Nam Da Bò  BIGGBEN Cao Cấp SD95",269000,269000,0,0
TIKI,giay-dep-nam,48626351,"Giày Sneaker Convere Chuck Taylor All Star 1970s Hi Top 162053C",2000000,2000000,0,0
TIKI,giay-dep-nam,94485961,"Đông Hải - Giày Tây Nam G0601",1590000,1590000,0,0
TIKI,giay-dep-nam,5469269,"Sandal Nam BIGGBEN Da Bò Thật SD13",400000,400000,0,0
TIKI,giay-dep-nam,177200976,"Dép Nam xỏ ngón Thái Lan 5TD57 , Dép đúc nguyên khối siêu bền, đế hạt massage",190000,190000,0,0
TIKI,giay-dep-nam,129351222,"Sandal Vento Hybrid Nữ Quai Ngang NB93",365000,365000,0,0
TIKI,giay-dep-nam,164041223,"giày nam da cồ cao phong cách bụi bặm, giày bốt nam",610000,610000,0,0
TIKI,giay-dep-nam,90576424,"Giày Lười Nam Xuất Dư Da Bò Mã GL-66",325000,650000,325000,50
TIKI,giay-dep-nam,106332932,"Giày sapo nam cao cấp - sản phẩm mới nhất hiện nay- ̣SP11",130000,130000,0,0
TIKI,giay-dep-nam,68106838,"Dép quai hậu nam da bò thật phong cách thời trang đế mềm kiểu dáng mới nhất phiên bản Hàn Quốc mã 10321",259000,399000,140000,35
TIKI,giay-dep-nam,83169491,"Dép cao su kiểu dép lê 2 quai chéo",300000,300000,0,0
TIKI,giay-dep-nam,6277935,"Dép Bít Mũi Nam BIGGBEN Da Bò Thật Cao Cấp SB17",419000,430000,11000,3
TIKI,giay-dep-nam,7976103,"Giày Mọi Nam Da Bò Sunpolo SU007DN",990000,990000,0,0
TIKI,giay-dep-nam,167939874,"Giày Sục Nam Da Bóng Đơn Giản  Mã L196",160000,160000,0,0
TIKI,giay-dep-nam,156215596,"DÉP NAM HAI QUAI NAM DA BÒ THẬT ĐÍNH KHUY CAO CẤP",500000,500000,0,0
TIKI,giay-dep-nam,7658306,"Giày Mọi Nam Da Bò FT8899",318584,335352,16768,5
TIKI,giay-dep-nam,12244913,"Khóa giày nam châm buộc giày tiện lợi thay thế dây cột",33000,33000,0,0
TIKI,giay-dep-nam,250135109,"Dép quai ngang đế cao nam và nữ chất liệu EVA chống thấm SIÊU HOT",139000,139000,0,0
TIKI,giay-dep-nam,38147536,"Giày Tây Nam Da Bóng 20393",669000,669000,0,0
TIKI,giay-dep-nam,100869959,"Giày da sneaker cổ thấp da bò",500000,1000000,500000,50
TIKI,giay-dep-nam,14816261,"GIÀY DA BÒ CAO CẤP - LEX02",590000,590000,0,0
TIKI,giay-dep-nam,12608305,"Siêu phẩm giày quý ông cao cấp - lex211",520000,520000,0,0
TIKI,giay-dep-nam,6278021,"Dép Sục Nam BIGGBEN Da Bò Thật Cao Cấp SB18",439000,500000,61000,12
TIKI,giay-dep-nam,87120433,"Giày Sneaker Nam Tomoyo TMN05007",1400000,1400000,0,0
TIKI,giay-dep-nam,196877315,"Giày cao cổ nam Sans100 giầy bốt vải fullbox độn đế cao tăng 6cm boot buộc dây học sinh viên thời trang trắng đen xanh",249999,249999,0,0
TIKI,giay-dep-nam,159881117,"Giày tây nam Derby Đông Hải da bò cao  cấp thiết kế cột dây thanh lịch đế cao su  3cm chắc chắn - G01A7",1590000,1590000,0,0
TIKI,giay-dep-nam,13733812,"Giày Chelsea boot nam màu đen da lộn Revision 2 TFBKS8826 - Size",900000,900000,0,0
TIKI,giay-dep-nam,177626493,"Giày Tây Nam GEOX U Appiano C BLACK",4300000,4300000,0,0
TIKI,giay-dep-nam,52180308,"Dép Xỏ Ngón Nam BIGGBEN Da Bò Thật DK55",299000,400000,101000,25
TIKI,giay-dep-nam,166495968,"Dép Thái Lan quai xỏ ngón AG30",120000,120000,0,0
TIKI,giay-dep-nam,76274731,"Giày da nam, loại buộc dây mã BH-004",450000,900000,450000,50
TIKI,giay-dep-nam,15519786,"Lót Quế Cho Giày Nam",27000,27000,0,0
TIKI,giay-dep-nam,196410076,"Dép tổ ong [Size 35-43] vật liệu EVA cao cấp siêu bền, siêu nhẹ, chống trơn trượt, FORM LỚN (Nên Lùi 1-2 Size)",65000,85000,20000,24
TIKI,giay-dep-nam,177197091,"Dép thời trang phiên bản mới đế dày chống trơn trượt, dép đi trong nhà các cặp đôi mùa hè mã 095",95000,179000,84000,47
TIKI,giay-dep-nam,42849866,"Xi đánh giày YUPPIES Star Wax Shoe Polish khô 48ml - Neutral (Malaysia)",45000,45000,0,0
TIKI,giay-dep-nam,15186659,"Lót cho giày công sở tránh đau chân Spenco Arch Cushion Full M045",695000,695000,0,0
TIKI,giay-dep-nam,37832710,"Dép cao su Nam Nữ 4 quai chéo kiểu khe sanh",300000,300000,0,0
TIKI,giay-dep-nam,44588788,"Dép tông nam_130240-đen",120000,120000,0,0
TIKI,giay-dep-nam,111092834,"Chai xịt khử mùi hôi giày PenGuin; Nhập khẩu Malaysia, diệt vi khuẩn và nấm mốc trong giày",51000,68000,17000,25
TIKI,giay-dep-nam,101655684,"Giày da nam cao cấp buộc dây Sans136 giầy tây công sở đẹp size nhỏ 37 38 39 40 41 42 bigsize cỡ lớn 43 44 45 46 47 48",329000,329000,0,0
TIKI,giay-dep-nam,173239848,"️ Sandal quai hậu nam cho bé phong cách thời trang 20787",55600,114800,59200,52
TIKI,giay-dep-nam,186232739,"Dép xỏ ngón nam da cá sấu màu đen chính hãng Trường Hải may viền chắc chắn DCS255",591000,699000,108000,15
TIKI,giay-dep-nam,97546164,"Giày Tây Nam Buộc Dây Bảo Hân Mã CS89",295000,590000,295000,50
TIKI,giay-dep-nam,202708835,"Giày thể thao nam cổ cao GNC-T22-BL, giày thể thao thoáng khí phong cách hàn quốc",299000,299000,0,0
TIKI,giay-dep-nam,50694122,"Bọt vệ sinh giày đa năng, sneaker + tặng kèm  bản chải đánh giày",120000,120000,0,0
TIKI,giay-dep-nam,141245183,"Dép bít mũi nam da bò thật BIGGBEN cao cấp SB108",459000,600000,141000,24
TIKI,giay-dep-nam,193054679,"Giày thể thao nam, giày sneakers nam kẻ bo chun 2 màu C80",200000,200000,0,0
TIKI,giay-dep-nam,178466113,"Giày thể thao sneaker nam nữ xám xanh chuối - xám sọc đen",185000,185000,0,0
TIKI,giay-dep-nam,171202931,"Giày sandal 4 dây quai ngang phối chéo Giavy SL524",198000,198000,0,0
TIKI,giay-dep-nam,135852613,"Giày tây lười nam cao cấp, Giày lười da pu in vân nổi bật trẻ trung tăng chiều cao đế cao su đúc - Mã DR01",199000,199000,0,0
TIKI,giay-dep-nam,146414112,"Giày quai nang nam, dép quai hậu nam đẹp phong cách thời trang Hàn Quốc mã DEP11LE",159000,299000,140000,47
TIKI,giay-dep-nam,15762316,"Sữa làm sạch và dưỡng đồ da Saphir Creme Universelle 150ml",360000,360000,0,0
TIKI,giay-dep-nam,13883504,"Giày sneaker TMN05404",1400000,1400000,0,0
TIKI,giay-dep-nam,178958545,"Giày Sneaker nam da thật màu trắng cao cấp NEW 2022",189000,189000,0,0
TIKI,giay-dep-nam,135370236,"Chai Làm Sạch Giày Dép Túi Xách, Lọ Xịt Chà Trắng Giày Dép",9998,9998,0,0
TIKI,giay-dep-nam,125244241,"Giày nam công sở phong cách lịch lãm, Giày da nam cao cấp chất liệu da bò pu in vân nổi bật đế cao su đúc - Mã GEA01",210000,210000,0,0
TIKI,giay-dep-nam,179546441," GIÀY TÂY NAM DA BÒ THẬT 100%, DONAVY GTN, HÀNG CÔNG TY CAO CẤP DOGTN",449000,850000,401000,47
TIKI,giay-dep-nam,183544565,"Giày Lười Nam Penny Loafer George TMN22801",2890000,2890000,0,0
TIKI,giay-dep-nam,189233352,"Dép Hai Quai Ngang Nam KEEDO-KD1705 Full hộp siêu bền",480000,480000,0,0
TIKI,giay-dep-nam,191592535,"Giày da nam Boat Shoes Xám da bò sáp cao cấp Hanmade, Lucas Shoes, Bảo hành 1 năm",659000,659000,0,0
TIKI,giay-dep-nam,192889107,"Sticker nhựa jibbitz unisex Crocs Beer",145000,145000,0,0
TIKI,giay-dep-nam,13980705,"Giày Mọi Nam BIGGBEN Da Bò Thật Cao Cấp GM159",549000,720000,171000,24
TIKI,giay-dep-nam,129350887,"Giày Sandal Vento Nam Quai Ngang dạo phố đi chơi đi học du lịch NB38",435000,435000,0,0
TIKI,giay-dep-nam,139078021,"Chai xịt tẩy trắng giày dép túi xách Plac - Chai xịt tẩy trắng ",6000,15000,9000,60
TIKI,giay-dep-nam,192450907,"GIÀY BOOTS COLE HAAN NAM ZERØGRAND OMNI CITY BOOT WP C34238",2190000,5490000,3300000,60
TIKI,giay-dep-nam,153792840,"Đón gót giày gỗ",44000,44000,0,0
TIKI,giay-dep-nam,156216180,"GIÀY LƯỜI NAM DA BÒ THẬT 100% KHÂU ĐẾ CHẮC CHẮN BAO ĐI NƯỚC",500000,500000,0,0
TIKI,giay-dep-nam,72770419,"Giày cao cổ nam g12",650000,650000,0,0
TIKI,giay-dep-nam,88081802," Giày thể thao nam, giày nam da lộn 2801",200000,200000,0,0
TIKI,giay-dep-nam,148717398,"Máy đánh bóng giày dép công suất cao Bóng Đẹp Như Mới",222000,222000,0,0
TIKI,giay-dep-nam,129944665,"Giày Sneaker Unisex Vans Classic Slip-On All Black - VN000EYEBKA",1450000,1450000,0,0
TIKI,giay-dep-nam,102796815," Giày thể thao nam, giày sneaker nam độn đế mới nhất HOT 2021",169000,169000,0,0
TIKI,giay-dep-nam,105524408,"Giày Thể Thao Nam Sneaker Da Cao Cấp Phong Cách Hàn Quốc Kiểu Dáng Thời Trang G171",129000,129000,0,0
TIKI,giay-dep-nam,133235415,"Dép nam quai ngang Thái Lan Adda 34G03",170000,170000,0,0
TIKI,giay-dep-nam,17970831,"Lót giày da mộc êm chân hình chữ T Woly Galant - NK Đức",69000,69000,0,0
TIKI,giay-dep-nam,188687459,"Lót Giày Thể Thao Chất Liệu Cao Su Non Mềm Êm LGN2024b",45000,45000,0,0
TIKI,giay-dep-nam,196215076,"Giày dép Sandals Vento ALPHA I Teen/Trẻ em màu Đỏ Rượu đi học/đi dã ngoại/đi chơi SD08001",365000,365000,0,0
TIKI,giay-dep-nam,73820375,"Giày Sneaker thể thao nam buộc dây, đế cao su nguyên khối, đế nén khí đàn hồi G147",157000,176000,19000,11
TIKI,giay-dep-nam,108833595,"Độn đế tăng chiều cao 2cm một miếng dành cho nam",25000,25000,0,0
TIKI,giay-dep-nam,272384051,"Giày Sục Nam S92 Da Bò Thật Sục nam trẻ trung năng động Màu Đen Giày hở gót da mềm mại Bảo Hành 12 Tháng",392000,392000,0,0
TIKI,giay-dep-nam,125244179,"Giày Lười Nam vân cá sấu chuông ️ Giày tây nam cao cấp ĐẾ CAO SU, BỀN ️ TẶNG LÓT GIÀY TĂNG CHIỀU CAO",210000,210000,0,0
TIKI,giay-dep-nam,168587075,"Giày thể thao sneaker nam cổ thấp, giày đế tăng chiều cao mẫu mới k1",155000,155000,0,0
TIKI,giay-dep-nam,13586787,"Lót giày tăng chiều cao eva nguyên bàn cao 3 cm (Màu Xám)",67000,67000,0,0
TIKI,giay-dep-nam,149532939,"Dép nam quai ngang da bò thật",239000,239000,0,0
TIKI,giay-dep-nam,191592703,"Dép da bò đế trấu, Sandal da bò sáp, may thủ công Lucas Shoes, bảo hành 6 tháng",375000,375000,0,0
TIKI,giay-dep-nam,184124070,"Dép Bít Mũi Nam HÀ NAM Da Bò Thật Cao Cấp GSB20134",498000,498000,0,0
TIKI,giay-dep-nam,141237392,"Giày Tây nam tăng chiều cao Đông Hải kiểu dáng Derby  thanh lịch da cao cấp đế 6cm cải thiện chiều cao - G0615",1980000,1980000,0,0
TIKI,giay-dep-nam,177748957,"Giày Lười Nam Cao Da Bò Thật BIGGBEN Tăng Chiều Chiều Cao Thêm 6cm GM272",899000,1200000,301000,25
TIKI,giay-dep-nam,98039876,"Giày Thể Thao Nam Màu Đen Đế Cao Su Non Đúc",160000,169990,9990,6
TIKI,giay-dep-nam,197618496,"Giày Sneaker Nam Vải Canvas DINCOX E06 Blue Đơn Giản Tinh Tế Sang Trọng",442000,442000,0,0
TIKI,giay-dep-nam,9810794,"Giày Slip On Unisex Vans - VN000EYEBLK",1305000,1450000,145000,10
TIKI,giay-dep-nam,13360653,"Giày Da Nam BH002",450000,900000,450000,50
TIKI,giay-dep-nu,32113867,"GIÀY ĐI MƯA NHỰA BỀN",47000,47000,0,0
TIKI,giay-dep-nu,32183606,"Giày đi mưa đi biển form chuẩn chống trơn trượt đế bằng 163",48000,48000,0,0
TIKI,giay-dep-nu,187396210,"Giày Sandal Xuồng Nữ Da Bò Thật BIGGBEN Cao 5cm SDX38",349000,400000,51000,13
TIKI,giay-dep-nu,168228817,"Dép Đi Trong Nhà Nam Nữ Massage Chân Cực Êm Chân Tăng Kèm Tất",99000,99000,0,0
TIKI,giay-dep-nu,50493199,"Giày búp bê nữ size chuẩn nhiều màu siêu xinh thắt nơ V222",55000,55000,0,0
TIKI,giay-dep-nu,125099350,"Giày nữ Anh Khoa CH993-4",199000,199000,0,0
TIKI,giay-dep-nu,169372118,"Giày búp bê nữ đế bằng 2cm đi bộ thoáng khi cực êm chân V300",69000,69000,0,0
TIKI,giay-dep-nu,95013392,"Giày thể thao nữ đi bộ cực êm siêu xinh V278",59000,59000,0,0
TIKI,giay-dep-nu,170069022,"Giày cao gót nữ 7 phân gót vuông cao cấp ORSIL",149000,149000,0,0
TIKI,giay-dep-nu,146235133,"Giày sneakers vải canvas họa tiết kẻ đế cao 7cm PS372-1130",372000,372000,0,0
TIKI,giay-dep-nu,127378961,"Gel Vệ Sinh Giày Chuyên Dụng Đậm Đặc 100ml Chính Hãng Dincox X Matteo",150000,150000,0,0
TIKI,giay-dep-nu,133235317,"Dép quai kẹp nữ nhựa đúc liền đế, siêu nhẹ, siêu bền Thái Lan Adda 54E05",150000,150000,0,0
TIKI,giay-dep-nu,86963159,"Giày Sandal Cao Gót Da Bò BIGGBEN Cao 5 Phân SDCG61",359000,400000,41000,10
TIKI,giay-dep-nu,109347133,"Dép đế trấu quai ngang nam nữ thời trang Detaunisex màu Bò - DETA24B",245000,245000,0,0
TIKI,giay-dep-nu,17898018,"Combo 2 cặp lót giày cao gót chống tuột gót chân đệm êm bàn chân và chống thốn gót chân, lót giày giảm size giày bị rộng PK11 - 2",49000,49000,0,0
TIKI,giay-dep-nu,88205112,"(Được chọn Size) Miếng lót giày thể thao Yellow Sport chuyên dụng cao cấp, Lót giày cả bàn siêu êm chân, khoáng khí, khử mùi hôi",79000,79000,0,0
TIKI,giay-dep-nu,8176564,"Miếng Lót Giày Tăng Chiều Cao 4D - 3,5cm",54000,54000,0,0
TIKI,giay-dep-nu,48995818,"Dép lỗ tròn nhỏ đi trong nhà, nhà tắm",25000,25000,0,0
TIKI,giay-dep-nu,125099673,"Giày lười nữ Anh Khoa A83",170000,170000,0,0
TIKI,giay-dep-nu,151976581,"Dây giày dạ quang phản quang bản tròn giầy cao cổ boot thể thao sneaker nam nữ dài 1m 1m2 1m4 1m6 1m8 Sans943",40000,40000,0,0
TIKI,dien-tu-dien-lanh,195226537,"Tụ điều hòa Marrie loại zắc 35uf, tụ điện 35uf",80000,80000,0,0
TIKI,giay-dep-nu,83480711,"Lót giày cao gót 4D chống trượt bàn chân về phía trước - buybox - BBPK165",25000,29000,4000,14
TIKI,giay-dep-nu,51297276,"2 cặp Lót giày cao gót mũi nhọn 4D có gờ giảm sốc đệm êm nguyên bàn chân - buybox - BBPK65-2 - 1 cặp Kem + 1 cặp Đen",70000,140000,70000,50
TIKI,giay-dep-nu,157062466,"Khăn Giấy Lau Giày Sneaker Chuyên Dụng Khăn Ướt Vệ Sinh Giày Dép Dép Da Siêu Sạch 1 Gói 30 Tờ - Hàng Chính Hãng MINIIN",45000,45000,0,0
TIKI,giay-dep-nu,125781034,"Dép Lào xốp trắng mang khách sạn",21000,21000,0,0
TIKI,giay-dep-nu,143858681,"GIÀY MŨI VUÔNG (DA THẬT) DA MỀM - CÔNG SỞ TIẾP VIÊN HÀNG KHÔNG NỮ FFAN STORE",470000,470000,0,0
TIKI,dien-tu-dien-lanh,55366883,"Remote Điều Khiển Cho Máy Lạnh, Điều Hòa Panasonic Nanoe-G CS/CU-PU9UKH, N9UKH (Kèm Pin AAA Maxell)",47000,47000,0,0
TIKI,giay-dep-nu,71027401,"Giày sandal nữ đi mưa đế bánh mỳ siêu bền V256",69000,69000,0,0
TIKI,dien-tu-dien-lanh,82961691,"Remote Điều Khiển Tivi Thông Minh, Android TV Nhận Giọng Nói Dành Cho Panasonic - Hàng Nhập Khẩu",408000,408000,0,0
TIKI,giay-dep-nu,32737711,"2 cặp lót giày cao gót đa năng 4D cực êm chân, chống thốn gót chân và thấm hút mồ hôi - buybox - BBPK56",64000,100000,36000,36
TIKI,giay-dep-nu,65993260,"Dép lông đi trong nhà bít mũi tai thỏ CÓ SIZE CHO MẸ VÀ BÉ SC021",146000,155000,9000,6
TIKI,giay-dep-nu,177793665,"Dép Đi Trong Nhà, Văn Phòng, Dạo Phố Cho Nữ Hình Thỏ Dễ Thương",145000,145000,0,0
TIKI,dien-tu-dien-lanh,118537281,"Smart Tivi Coocaa Android 10 55 inch - Model 55S6G Pro Max - Hàng chính hãng",8299000,8299000,0,0
TIKI,dien-tu-dien-lanh,103278716,"Tủ lạnh Electrolux Inverter 335 lít EBB3702K-H - Hàng chính hãng - Giao tại Hà Nội và 1 số tỉnh toàn quốc",10689000,10689000,0,0
TIKI,dien-tu-dien-lanh,114985016,"Tủ lạnh Sharp Inverter 572 lít SJ-FX640V-SL - Chỉ giao Hà Nội",20200000,20200000,0,0
TIKI,dien-tu-dien-lanh,165964454,"Ron tủ lạnh  dành cho tủ lạnh SANYO SR - P25MN (U,P,S,T)",250000,250000,0,0
TIKI,giay-dep-nu,137253920,"Vớ silicon gai gót chân, Chống Nứt Gót Chân, đau gót chân",35000,35000,0,0
TIKI,dien-tu-dien-lanh,20240805,"Điều khiển dành cho tivi LG - AKB 73715690 ",95000,95000,0,0
TIKI,giay-dep-nu,105631085,"Giày lười thể thao nữ đi bộ cực êm siêu xinh V282",54000,54000,0,0
TIKI,dien-tu-dien-lanh,72714308,"[Chính Hãng] Bình Nước Nóng Atlantic NEO Lite",2570000,2570000,0,0
TIKI,dien-tu-dien-lanh,115124464,"Block Dành Cho Tủ Lạnh QD51 125W từ 160L đến 180L",999000,999000,0,0
TIKI,dien-tu-dien-lanh,1534275,"Máy Lạnh LG Inverter 2 HP V18ENF",18999000,18999000,0,0
TIKI,dien-tu-dien-lanh,32215892,"Remote Điều Khiển Cho Máy Lạnh, Máy Điều Hòa SHARP CRMC-A876JBEZ",65000,65000,0,0
TIKI,giay-dep-nu,133431963,"MIẾNG LÓT SILICON BẢO VỆ GÓT CHÂN | DỤNG CỤ BẢO VỆ GÓT CHÂN",14900,14900,0,0
TIKI,giay-dep-nu,152047531,"Dây giày dẹt đủ size nhiều màu cột giầy thể thao sneaker boot buộc áo quần dài 100cm 150cm 180cm đen trắng xám Sans942",24000,24000,0,0
TIKI,dien-tu-dien-lanh,115914369,"Block dành cho tủ lạnh, máy nén",955000,955000,0,0
TIKI,giay-dep-nu,10733022,"Ủng Đi Mưa Cao Cổ Tiện Lợi",27900,27900,0,0
TIKI,dien-tu-dien-lanh,49246141,"Điều Hòa Panasonic 9040 BTU CU/CS-N9WKH-8 - Chỉ giao tại Hà Nội",8600000,8600000,0,0
TIKI,dien-tu-dien-lanh,149478727,"Máy nước nóng năng lượng mặt trời Solahart 150L - Hàng chính hãng",20020000,20020000,0,0
TIKI,giay-dep-nu,148932554,"giày thể thao nữ đẹp ,giày nữ sneaker đế cao su mềm siêu nhẹ nhiều màu SUNO STORE GTTN02",177000,177000,0,0
TIKI,dien-tu-dien-lanh,124273839,"Túi Đựng Remote Bằng Vải Hình Gấu Teddy 21x8cm Nhiều Màu",9500,10000,500,5
TIKI,dien-tu-dien-lanh,153262056,"Máy Rửa Chén Âm Tủ Hoàn Toàn Malloca WQP12-J7713FB - 8 Chương Trình Rửa - Hàng Chính Hãng",20102500,23650000,3547500,15
TIKI,dien-tu-dien-lanh,197086181,"MÁY RỬA BÁT TEXGIO TGWFD78GB - HÀNG CHÍNH HÃNG",10490000,10490000,0,0
TIKI,dien-tu-dien-lanh,120469901,"PHAO ÁP LỰC MÁY GIẶT ELECTROLUX – HÀNG CHÍNH HÃNG",320000,320000,0,0
TIKI,dien-tu-dien-lanh,72579897,"Android Tivi TCL 4K 43 inch 43P615 Model 2020 - Hàng chính hãng (chỉ giao HCM)",7600000,7600000,0,0
TIKI,dien-tu-dien-lanh,72294932,"Bình nước nóng Panasonic DH-20HAMVW 20 Lít (hàng chính hãng)",3379000,3379000,0,0
TIKI,dien-tu-dien-lanh,195226304,"Áo vệ sinh máy lạnh cao cấp vải tổ ong dùng cho loại máy từ 1HP đến 3HP, áo vệ sinh máy lạnh 1.8m, áo vệ sinh loại trơn",80000,80000,0,0
TIKI,giay-dep-nu,128088051,"GIÀY KHIÊU VŨ MÀU ĐỒNG 7 DÂY ÔM NGÓN ÚT 7 và 5cm",189000,189000,0,0
TIKI,dien-tu-dien-lanh,52663967,"TỦ ĐÔNG MINI HÒA PHÁT HCF-606S2D2 (245 lít) - CHÍNH HÃNG",7400000,7400000,0,0
TIKI,dien-tu-dien-lanh,120462249,"Điều Khiển Chuột Bay Tìm Kiếm Giọng Nói Air Mouse Remote Voice G20 / G20S",176596,185891,9295,5
TIKI,giay-dep-nu,180380379,"Lót giày 4D đệm êm chống rớt gót tránh trượt và bảo vệ bàn chân trước siêu mềm thoáng khí cho giày bít mũi",49000,49000,0,0
TIKI,dien-tu-dien-lanh,178528468,"Truyền hình intenet K+ , Hàng Chính Hãng",25000,25000,0,0
TIKI,dien-tu-dien-lanh,189642858,"Máy lạnh Daikin 1HP inverter FTKY25WAVMV-HÀNG CHÍNH HÃNG-GIAO HÀNG TOÀN QUỐC",12190000,12190000,0,0
TIKI,giay-dep-nu,186553880,"Giày Búp Bê Nữ Da Bò Thật BIGGBEN Cao 5 Phân BB123",319000,400000,81000,20
TIKI,giay-dep-nu,16295209,"Combo 2 cặp lót giày cao gót giảm đau gang bàn chân vị trí dưới các ngón chân, lót giày hút mồ hôi chân khi mang giày bít mũi PK14",42000,42000,0,0
TIKI,giay-dep-nu,19984182,"Xi nước đánh giày Kangaroo Hàn Quốc - Nhập khẩu chính hãng",59000,59000,0,0
TIKI,dien-tu-dien-lanh,3738919,"Máy Nước Nóng Gián Tiếp FERROLI VERDI 20L SE (2500W) - Hàng Chính Hãng",2638000,2638000,0,0
TIKI,dien-tu-dien-lanh,120394970,"Remote Điều Khiển Dành Cho SONY LED TV, Tivi LCD SAMSUNG AA59-00741A",46000,46000,0,0
TIKI,dien-tu-dien-lanh,108554980,"Remote điều khiển cho điều hoà Sharp phím bấm cao su mềm nhạy, vỏ nhựa cao cấp",65000,65000,0,0
TIKI,dien-tu-dien-lanh,195971675,"Tủ lạnh LG Inverter 374 lít GN-D372PS - Hàng chính hãng [Giao hàng toàn quốc]",9370000,15490000,6120000,40
TIKI,dien-tu-dien-lanh,4679003,"Giá Treo Màn Máy Tính Góc Xoay Đa Hướng Nhập Khẩu North Bayou F120 (17-27 inch)",290000,290000,0,0
TIKI,dien-tu-dien-lanh,51248809,"Điều Hòa Daikin Inverter 11900 BTU FTKA35UAVMV - Chỉ giao tại Hà Nội",11190000,11190000,0,0
TIKI,dien-tu-dien-lanh,165964313,"Ron tủ lạnh  dành cho tủ lạnh sharp SJ-166S-SL",215000,215000,0,0
TIKI,dien-tu-dien-lanh,94982837,"REMOTE ĐIỀU KHIỂN DÀNH CHO MÁY LẠNH TOSHIBA (vàng)",59000,59000,0,0
TIKI,dien-tu-dien-lanh,103635780,"Bo mạch máy giặt đa năng XN6688 các loại",366000,366000,0,0
TIKI,dien-tu-dien-lanh,23188003,"Điều khiển dùng cho đầu mytv",45000,45000,0,0
TIKI,dien-tu-dien-lanh,132786021,"Tủ lạnh Toshiba Inverter 407 lít GR-RT535WE-PMV(06)-MG - Hàng chính hãng - Giao toàn quốc",13890000,13890000,0,0
TIKI,dien-tu-dien-lanh,141111324,"Máy giặt Electrolux Inverter 8 kg EWF8024P5SB - chỉ giao Hà Nội",7990000,7990000,0,0
TIKI,dien-tu-dien-lanh,172360095,"Bánh xe quạt hơi nước, quạt điều hoà, ghế xoay văn phòng",50000,50000,0,0
TIKI,dien-tu-dien-lanh,197639229,"combo 40 cây anten dvb t2 khuếch đại AVG, Hàng Chính Hãng.",899000,899000,0,0
TIKI,giay-dep-nam,143363034,"Dép quai ngang nam Pu Buta/dép nam",90000,90000,0,0
TIKI,giay-dep-nam,42850070,"Xi đánh giày đen YUPPIES Glo King Liquid Sheo Polish 75ml-Back (Malaysia)",65000,65000,0,0
TIKI,giay-dep-nam,1589773,"Giày Tây Nam Da Bò SUNPOLO SU3020N - Nâu",890000,890000,0,0
TIKI,giay-dep-nam,225951590,"Giày Thể Thao Nam Trung Niên , Thanh Niên Vải Thoáng Khí , Cổ Chun Co Giãn - Dây Rút Thông Minh , Đế Ma Sát Tốt",168000,168000,0,0
TIKI,giay-dep-nam,177560263,"Giày thể thao nam Giày Vải phong cách Hàn Quốc giày Sinh Viên 21094",87800,193755,105955,55
TIKI,giay-dep-nam,8059116,"Dép Nam BIGGBEN Da Bò Thật Cao Cấp DN131",339000,360000,21000,6
TIKI,giay-dep-nam,159314261,"Giày Sneaker Nam, Giày Nam Da Thật Hàng Cao Cấp NEW 2022",199000,199000,0,0
TIKI,giay-dep-nam,205350671,"Giày lười unisex Crocs Classic - 10001-2Y2",1495000,1495000,0,0
TIKI,giay-dep-nam,67626523,"HAVAIANAS - Dép unisex Top 4000029-0727-378",499000,499000,0,0
TIKI,giay-dep-nam,76164173,"HAVAIANAS - Dép unisex Top 4000029",549000,549000,0,0
TIKI,giay-dep-nam,9810452,"Giày Sneaker Unisex Authentic Vans VN000EE3BLK - Black (Size",1305000,1450000,145000,10
TIKI,giay-dep-nam,57722527,"Giày nam, giày sneaker thể thao nam tăng chiều cao lót thông hơi cao cấp mẫu mới nhất SP-A344",119000,119000,0,0
TIKI,giay-dep-nam,50107109,"Giày Tây công sở Nam Da Thật Cao Cấp Peace PO1027",280000,280000,0,0
TIKI,giay-dep-nam,67626652,"HAVAIANAS - Dép unisex Top 4000029-0555-378",499000,499000,0,0
TIKI,giay-dep-nam,190099603,"Giày Lười Nam Da Nubuck Tomoyo TMN22701",2890000,2890000,0,0
TIKI,giay-dep-nam,175470163,"Giày chạy bộ nam Under Armour Flow Velociti Wind Prizm - 3024896-100",2857000,4395000,1538000,35
TIKI,giay-dep-nam,177635194,"Dép Nam Bít Mũi Da Bò Thật BIGGBEN Cao Cấp DN303",339000,390000,51000,13
TIKI,giay-dep-nam,194961161,"Giày lười da nam Trường Hải màu đen da bò cao cấp  đế cao 2.5cm GM0302",591000,699000,108000,15
TIKI,giay-dep-nam,92480272,"MLB - Giày sneakers Chunky Low 32SHU2111",2590000,2590000,0,0
TIKI,giay-dep-nam,39357560,"Giày Tây Nam Da Bò Mã BH04",450000,900000,450000,50
TIKI,giay-dep-nam,191653859,"Dép nam quai ngang da bò Nappa cao cấp Bụi Leather E103, đế đúc nguyên khối khâu viền thủ công đi êm chân, Bảo hành 12 Tháng",290000,450000,160000,36
TIKI,giay-dep-nam,179060493,"Dép sục cross literide màu đen tuyền êm mềm nam nữa hàng xuất xịn, mẫu mới, full box",349000,349000,0,0
TIKI,giay-dep-nam,107801690,"Xi Kem Đánh Giày Tarrago Shoe Cream Chuyên Đánh Bóng Da, Bổ Sung Màu, Dưỡng Giày, Túi, Áo Da Cao Cấp XVSG70",126000,252000,126000,50
TIKI,giay-dep-nam,72508500,"Giày mọi nam cột dây Trường Hải màu đen bò da bò thật cao cấp không bong tróc đế cao su chống mòn không trơn GMTH01276",564000,659000,95000,14
TIKI,giay-dep-nam,67626473,"HAVAIANAS - Dép unisex Top 4000029-0001-356",499000,499000,0,0
TIKI,giay-dep-nam,75990118,"Dép nam đế cao 3.5cm da bò thật may viền thủ công chắc chắn thời trang cao cấp chính hãng Trường Hải DC150",307000,359000,52000,14
TIKI,giay-dep-nam,171535250,"Dép quai ngang nam nữ M Masler-MT màu trắng sọc đen tinh tế với lớp đế dễ vệ sinh, chống nước và quai êm chân TD1",278000,278000,0,0
TIKI,giay-dep-nam,134777245,"Giày lười da tăng chiều cao nam Bụi Leather G111 - Da bò Nappa cao cấp - Bảo hành 12 tháng",515000,840000,325000,39
TIKI,giay-dep-nam,191694860,"Giày da nam công sở đế cao Bụi Leather G123 - Da bò Nappa cao cấp - Phong cách trẻ trung năng động - Bảo hành 12 tháng",599000,925000,326000,35
TIKI,giay-dep-nam,171177150,"GIÀY LƯỜI DA BÒ CAO CẤP VA2001",349000,549000,200000,36
TIKI,giay-dep-nam,179523966,"Giày lười nam Đông Hải thiết kế Horsebit Loafer đính kim loại ngang mũi giày tăng  vẻ thanh lịch - G2283",1450000,1450000,0,0
TIKI,giay-dep-nam,72513787,"Giày mọi nam cột dây Trường Hải màu đen bò da bò thật cao cấp không bong tróc đế cao su chống mòn không trơn GMTH01277",564000,659000,95000,14
TIKI,giay-dep-nam,84936254,"Giày thể thao nam buộc dây sneaker nam mẫu mới vải dệt cao cấp G179",149000,250000,101000,40
TIKI,giay-dep-nam,169325607,"Giày Mọi Nam Màu Trắng Giày Lười  Nam Da Bò Cao Cấp Mềm Êm Chân -M04 Giày SAGO’S Bảo Hành 12 tháng (tặng vớ khử mùi)",650000,650000,0,0
TIKI,giay-dep-nam,175469846,"Giày chạy bộ nam Under Armour Flow Velociti SE - 3024016",2467000,3795000,1328000,35
TIKI,giay-dep-nam,98611409,"GIÀY THỂ THAO NAM Sneakes S24",50000,50000,0,0
TIKI,giay-dep-nam,7995370,"Giày Converse Chuck Taylor All Star Classic Hi Top - 121186",1395000,1550000,155000,10
TIKI,giay-dep-nam,7995150,"Giày Converse Chuck Taylor All Star 1970s Low Top - 162065V",1710000,1900000,190000,10
TIKI,giay-dep-nam,7995659,"Giày Converse Chuck Taylor All Star Classic Low Top - 121176",1305000,1450000,145000,10
TIKI,giay-dep-nam,106188535,"Giày Thể Thao Nam S33  Thời Trang Full Đen",175000,250000,75000,30
TIKI,giay-dep-nu,55650451,"Tất Độn Lót Gót Chân Tăng Chiều Cao - Tất Chất Liệu Silicone Nhiều Mức Cao Khác Nhau Để Lựa Chọn",59000,59000,0,0
TIKI,giay-dep-nu,40971900,"Giày Nữ Độn Đế Da Thật 7CM PS69527",695000,695000,0,0
TIKI,giay-dep-nu,88085820,"Giày thể thao nữ Hàn Quốc, lót lông siêu ấm ngày lạnh, cổ cao tôn dáng, nhiều màu",246000,246000,0,0
TIKI,giay-dep-nu,10039479,"Sandal Nữ BIGGBEN Da Bò Thật SDN15",349000,400000,51000,13
TIKI,giay-dep-nu,4374455,"Giày Lười Da Nữ SP34",209000,209000,0,0
TIKI,giay-dep-nu,88085793,"Giày thể thao nữ cao cổ Hàn Quốc",246000,246000,0,0
TIKI,giay-dep-nu,21438598,"Giày lười nữ - Giày thời trang nữ",219000,219000,0,0
TIKI,giay-dep-nu,144181296,"Dép lào Thái màu xanh lá loại 1 nhập thái dép tông lào thái huyền thoại dép xỏ ngón dép hai quai dép kẹp thái",87500,87500,0,0
TIKI,giay-dep-nu,191992730,"Sandal cao gót nữ đế 7F",229000,229000,0,0
TIKI,giay-dep-nu,149779905,"Giày cao gót basic 5cm mã 5MN1",249000,279000,30000,11
TIKI,giay-dep-nu,109346679,"Dép chữ H nam nữ đế trấu đi mưa Full Đen Detaunisex - DETA14F",245000,245000,0,0
TIKI,giay-dep-nu,8005362,"Sandal Nữ BIGGBEN Da Bò Thật Cao Cấp SDN04",329000,400000,71000,18
TIKI,giay-dep-nu,169366294,"Giày lười nữ êm chân phong cách thời trang V297",69000,69000,0,0
TIKI,giay-dep-nu,14040284,"Sandal Xuồng Nữ BIGGBEN Da Bò Thật SDX03",249000,400000,151000,38
TIKI,giay-dep-nu,59211896,"Giày Sandal Nữ Đế Xuồng BIGGBEN Da Bò Thật SDX20",369000,420000,51000,12
TIKI,giay-dep-nu,179912115,"Giày Thể Thao Nữ Cao Cấp Mẫu Mới 2022 Siêu Nhẹ Thoáng Khí Êm Chân Kiểu Hàn Quốc Năng Động Cá Tính suno store GTTN11",189000,189000,0,0
TIKI,giay-dep-nu,68464177,"Giầy sục cao gót nữ đi mưa, dạo phố êm chân kiểu dáng dễ thương DN16",79000,79000,0,0
TIKI,giay-dep-nu,91019369,"Giày búp bê nữ BIGGBEN da bò cao cấp BB90",309000,400000,91000,23
TIKI,giay-dep-nu,75993779,"Giày bốt nữ, boot đế vuông 8 phân da trơn viền lazer 2 dây kéo S047",281000,299000,18000,6
TIKI,giay-dep-nu,130069901,"GIÀY LƯỜI DA NỮ CAO CẤP",209000,209000,0,0
TIKI,giay-dep-nu,14040407,"Sandal Xuồng Nữ BIGGBEN Da Bò Thật SDX05",339000,460000,121000,26
TIKI,giay-dep-nu,189313332,"Giày Sandal Nữ The Bily 04W 3 Quai Ngang - Màu Đen BL04WD",339000,339000,0,0
TIKI,giay-dep-nu,91229995,"Dép Sục Nữ Da Bò BIGGBEN Cao Cấp SBN36",309000,400000,91000,23
TIKI,giay-dep-nu,191437048,"Dép quai ngang Bitis nữ đế 4cm",237000,237000,0,0
TIKI,giay-dep-nu,165997328,"Giày sandal xuồng nữ da bò BIGGBEN cao cấp SDX34",359000,400000,41000,10
TIKI,giay-dep-nu,73620542,"Giày boots nữ, giày bốt ống 1 khóa đế thấp S426",230000,245000,15000,6
TIKI,giay-dep-nu,179912273,"Giày Thể Thao Nữ Cao Cấp Xuất Nhật Đế Bằng Cao 4cm Êm Chân Mang Đi Làm ,Chạy Bộ ,Tập Gym gttn16",249000,249000,0,0
TIKI,giay-dep-nu,193110088,"Guốc cao gót nữ, dép cao gót 7p quai mảnh thắt rút",110400,110400,0,0
TIKI,giay-dep-nu,46810419,"Combo 01 cặp lót giày nguyên bàn chân đa năng và 01 cặp lót mũi giày đệm êm ngón chân_buybox_BBPK11&BBPK50",60000,120000,60000,50
TIKI,giay-dep-nu,101773947,"Giày Khiêu Vũ Dance Sport Người Lớn, Giày Nhảy Cao Gót LaTin Hiện Đại",175000,175000,0,0
TIKI,giay-dep-nu,108392260,"Dép Sục Nữ Da Bò BIGGBEN Cao Cấp SBN40",319000,450000,131000,29
TIKI,giay-dep-nu,49504665,"Chai xịt trắng giày Plac kèm đầu cọ, tẩy trắng giày nhanh chóng, tiện dụng",6000,7545,1545,20
TIKI,giay-dep-nu,51579620,"Giày lười nữ đẹp bền êm chân thời trang mới nhất 235",51000,51000,0,0
TIKI,giay-dep-nu,109319125,"Giày sandal đế trấu quai ngang 2 khóa nam nữ Detaunisex màu ĐEN - SATA21D",219000,219000,0,0
TIKI,giay-dep-nu,22969892,"Dép Nữ BIGGBEN Da Bò Thật DNQN21",329000,400000,71000,18
TIKI,giay-dep-nu,194042419,"Dép nữ xỏ ngón, dép kẹp quai lụa, loại cao cấp, đế cao su chống trơn trượt",89000,89000,0,0
TIKI,giay-dep-nu,24422692,"Giày lười slip-on nữ - GIAYF3",119000,119000,0,0
TIKI,giay-dep-nu,125098790,"Giày Lười Nữ Anh Khoa A913-7",199000,199000,0,0
TIKI,giay-dep-nu,20818009,"Giày Lười Nữ , Giày Mọi Nữ , Giày Búp Bê Nữ",219000,219000,0,0
TIKI,giay-dep-nu,176725152,"Dép quai kẹp Bitis nữ đế 5cm",180000,180000,0,0
TIKI,giay-dep-nam,212967073,"Dép nam Aldo POOLSLIDE",1450000,1450000,0,0
TIKI,giay-dep-nam,55503251,"GIÀY TĂNG CHIỀU CAO  GIÀY CAO DÀNH CHO NAM GIỚI T&TRA T63 MỌI-  CAO 5CM GIÀY ĐỘN NAM CAO VƯỢT TRỘI",750000,750000,0,0
TIKI,giay-dep-nam,107151129,"Dép quai ngang nam năng động hình chữ H siêu bền đẹp mã DEP06LE",159000,299000,140000,47
TIKI,giay-dep-nam,37497055,"Giầy thể thao nam_0014",90369,95125,4756,5
TIKI,giay-dep-nam,149780140,"Giày lười nam da bò ORSIL thời trang màu nâu lịch thiệp - ORL D10",299000,309000,10000,3
TIKI,giay-dep-nam,22169041,"Dép nam da bò quai đan ngang Trường Hải màu đen thời trang cao cấp QN165",223000,299000,76000,25
TIKI,giay-dep-nam,164321515,"Dép nam hai quai ngang cao cấp KEEDO BH00404 da bò thật",750000,750000,0,0
TIKI,giay-dep-nam,34612145,"Combo 10 cặp lót giày êm chân size nam - Trắng",25000,25000,0,0
TIKI,giay-dep-nam,122712308,"Giày Lười Sục Nam Da Bò Chuẩn, Có bảo hành nổ da, bong keo , gãy đế, phom dáng siêu đẹp GD18",299000,299000,0,0
TIKI,giay-dep-nam,181785682,"GIÀY DA NAM X26 MÃ G20-07",480000,480000,0,0
TIKI,giay-dep-nam,14272046,"Sục nam da bò Trường Hải màu nâu may đế chắc chắn S132",281000,329000,48000,15
TIKI,giay-dep-nam,72557976,"Miếng Lót Giày Êm Chân Thể Thao Thoáng Khí Thấm Hút Mồ Hôi Size Nam 41-45",128000,128000,0,0
TIKI,giay-dep-nam,27769106,"Dép Nam BIGGBEN Da Bò Thật Cao Cấp DN211",299000,400000,101000,25
TIKI,giay-dep-nam,115769177,"Giày Lười Nam Công Sở Cao Cấp - Da LÌ - Đế Khâu Chắc Chắn - Mã X084",199000,199000,0,0
TIKI,giay-dep-nam,67110433,"Giày lười nam da bò thật Happyshoes, đế khâu chất liệu cao su ép nhiệt chắc chắn có rãnh chống trượt an toàn -HS66",350000,350000,0,0
TIKI,giay-dep-nam,49103889,"Dép da-Valentino Creations-VAB-300-BN",3790000,3790000,0,0
TIKI,giay-dep-nam,50139122,"Giày Sandal Nam thủ công da bò cao cấp TOMOYO TMS09402",1200000,1200000,0,0
TIKI,giay-dep-nam,95854971,"Giày thời trang nam- Mã GIAY.VUAONG",299000,489000,190000,39
TIKI,giay-dep-nam,42157746,"Giày Da Nam Cao Cấp Italia Germano Bellesi GB 220",10550000,10550000,0,0
TIKI,giay-dep-nam,2618687,"Dép Rọ Nam Da Bò Cao Cấp SUNPOLO SUA20D",580000,580000,0,0
TIKI,giay-dep-nam,119718716,"Giày Tây Nam Công Sở TiTi ĐÔ Da Bò Thật Cao Cấp GT2025a",550000,550000,0,0
TIKI,giay-dep-nam,68663120,"Dép sục nam da bò  Trường Hải màu đen đế cao su không trơn hàng may chắc chắn thời trang cao cấp BMN0201",321000,379000,58000,15
TIKI,giay-dep-nam,164041369,"giày chealse boot nam cao cổ - giày bốt nam cổ cao da lộn - Chealsea Boot Da Lộn Cao Cổ Chất Đẹp",450000,450000,0,0
TIKI,giay-dep-nam,9810665,"Giày Sneaker Unisex Authentic Vans - VN000EE3RED",1305000,1450000,145000,10
TIKI,giay-dep-nam,76108478,"Giày cao cổ vải nam G505",120000,120000,0,0
TIKI,giay-dep-nam,84199517,"Giày Sandals Vento Nam Nữ Quai Ngang dạo phố/đi chơi/đi học NB02",385000,385000,0,0
TIKI,giay-dep-nam,197243404,"Giày Sandal Nam The Bily 3 Quai Ngang - Đế Trắng Lót Đen Màu Trắng BLDTMD04",349000,349000,0,0
TIKI,giay-dep-nam,262984097,"Dép nam đế may sẵn quai ngang cao cấp KEEDO KD0607",480000,480000,0,0
TIKI,giay-dep-nam,49103569,"Giày da-Valentino Creations-VAB-302-COF",6190000,6190000,0,0
TIKI,giay-dep-nam,15319346,"Sáp làm mềm và chống thấm nước - Saphir Dubbin Grease BDC 100ml",295000,295000,0,0
TIKI,giay-dep-nam,21929073,"Dép Kẹp Nam Hè",150000,150000,0,0
TIKI,giay-dep-nam,113293693,"Dép Nam Xỏ Ngón HÀ NAM Da Bò Thật Cao Cấp DNA2099",378000,378000,0,0
TIKI,giay-dep-nam,6277121,"Dép Nam Bít Mũi  BIGGBEN Da Bò Thật DN49",399000,450000,51000,11
TIKI,giay-dep-nam,43391534,"Dép quai ngang nam GIAVY - TL450",210000,210000,0,0
TIKI,giay-dep-nam,262051563,"Gìay Vans Authentic 44 DX Anaheim Factory VN0A38ENMR2",2000000,2000000,0,0
TIKI,giay-dep-nam,67400635,"Dép bít mũi nam Trường Hải da bò cao cấp đế cao su màu nâu bò BM217",278000,329000,51000,16
TIKI,giay-dep-nam,171202648,"Giày sandal nam Giavy SL275",200000,200000,0,0
TIKI,giay-dep-nam,40978506,"Giày mọi nam da bò cao cấp Trường Hải GM236",461000,539000,78000,14
TIKI,giay-dep-nam,19389943,"Dụng cụ giữ dáng giày và chống móp méo mũi giày mọi da, giày boot da, giày tây công sở, giày thể thao - size giày nam PK44",52000,52000,0,0
TIKI,giay-dep-nam,14765775,"Giày Rọ nam da bò cao cấp đen GM033",333000,389000,56000,14
TIKI,dien-tu-dien-lanh,166449083,"Máy Rửa Chén Độc Lập Bosch HMH.SMS4IVI01P (Series 4) - 12 Bộ - 6 Chương Trình Rửa - Hàng Chính Hãng ",16600000,16600000,0,0
TIKI,dien-tu-dien-lanh,140964497,"Tủ lạnh mini 10 lít SAST ST10L 2 chế độ làm lạnh hâm nóng cho gia đình và trên ô tô",899000,899000,0,0
TIKI,dien-tu-dien-lanh,114766334,"Tủ lạnh 2 cánh Panasonic 326 lít NR-TL351GPKV - Lấy nước ngoài - Làm đá siêu tốc - Hàng chính hãng",15590000,15590000,0,0
TIKI,dien-tu-dien-lanh,114843316,"[CHỈ GIAO TẠI HCM] - Máy giặt Panasonic Inverter 9.5 Kg NA-FD95X1LRV- Hàng Chính Hãng",8690000,10490000,1800000,17
TIKI,dien-tu-dien-lanh,181780151,"Điều hòa di động Casper PC-09TL33 - Hàng chính hãng",5099000,5099000,0,0
TIKI,dien-tu-dien-lanh,90162784,"Máy Giặt Sấy Samsung Addwash Inverter 9.5kg WD95T754DBX/SV - Chỉ Giao Hà Nội",11990000,11990000,0,0
TIKI,dien-tu-dien-lanh,14472089,"Máy Lạnh Funiki SC09MMC2 (1.0HP) - Hàng Chính Hãng",4650000,4650000,0,0
TIKI,dien-tu-dien-lanh,166449044,"Máy Rửa Chén Độc Lập Bosch HMH.SMS63L02EA (Series 6) - 12 Bộ - 6 Chương Trình Rửa - Hàng Chính Hãng",21000000,21000000,0,0
TIKI,dien-tu-dien-lanh,91272453,"Giá Treo TiVi Di Động North Bayou AVA1800 Màu Đen Lắp Cho Màn Hình Từ 55 inch - 80 inch Nhập Khẩu",1868000,1868000,0,0
TIKI,dien-tu-dien-lanh,19844214,"Hộp Android tivi box MyTVNet Net 1 - Hàng Chính Hãng",690000,690000,0,0
TIKI,dien-tu-dien-lanh,87941147,"Smart Tivi Crystal Samsung 4K 65 inch UA65AU8000",12829000,12829000,0,0
TIKI,dien-tu-dien-lanh,49360002,"Khuếch Đại Truyền Hình Cáp PACIFIC DA20",279000,279000,0,0
TIKI,dien-tu-dien-lanh,114769677,"Tủ lạnh Panasonic Inverter 306 lít NR-TV341VGMV - Lấy nước ngoài - Làm đá siêu tốc - Hàng chính hãng",14490000,14490000,0,0
TIKI,dien-tu-dien-lanh,95923190,"Điều Hòa Di Dộng Casper 9000 Btu PC-09TL33 - Chi Giao Tại Hà Nội",5459000,5459000,0,0
TIKI,dien-tu-dien-lanh,3720913,"Giá treo tivi nhập khẩu NB F120 có thể nâng lên hạ xuống được 17-27 inch",378000,378000,0,0
TIKI,dien-tu-dien-lanh,176289244,"[HCM] Tủ Lạnh Electrolux EME3700H-A - Dung Tích 337 Lít - Công Nghệ Inverter - Hàng Chính Hãng",12890000,12890000,0,0
TIKI,dien-tu-dien-lanh,95992313,"Máy Lạnh Daikin Inverter 1.5 HP FTKA35VAVMV - Chỉ Giao HCM",11329000,11329000,0,0
TIKI,giay-dep-nam,110483322,"Giày Boots Nam Da Sáp Crary Horse",869000,869000,0,0
TIKI,giay-dep-nam,106361646,"Dép Nam Quai Ngang HÀ NAM Da Bò Thật Cao Cấp DN2074",430000,430000,0,0
TIKI,dien-tu-dien-lanh,137675226,"REMOTE ĐIỀU KHIỂN MÁY LẠNH ĐA NĂNG _SLM",32000,32000,0,0
TIKI,dien-tu-dien-lanh,102825920,"Máy giặt Samsung Inverter 8.5 kg WW85T4040CE/SV lồng ngang-Hàng chính hãng- Giao hàng toàn quốc",7290000,13180000,5890000,45
TIKI,dien-tu-dien-lanh,23468514,"TỦ LẠNH FUNIKI FR-91CD 91 LÍT - Hàng chính hãng",2639000,2639000,0,0
TIKI,dien-tu-dien-lanh,68778600,"Máy Nước Nóng Ariston AN2 30 R - 2.5 - FE (2500W)",2979000,2979000,0,0
TIKI,giay-dep-nam,143638161,"Giày Lười Da Bò Nam Cao Cấp, Da Chuẩn, Kiểu Dáng Sang Trọng Quý Ông GD20",299000,299000,0,0
TIKI,giay-dep-nam,98296288,"Giày Sneaker Thể Thao Nam HiNiTi T008 Dáng Đẹp- Năng Động Tặng Tất Khử Mùi",94050,99000,4950,5
TIKI,giay-dep-nam,180590598,"Dép da nam quai ngang 2 dây Trường Hải màu nâu da bò mặt đúc chịu nước QN153",249000,339000,90000,27
TIKI,dien-tu-dien-lanh,123547539,"Ăng-ten TV kỹ thuật số trong nhà, Anten DVB T2 Model TB105 HKD",189000,189000,0,0
TIKI,dien-tu-dien-lanh,191089437,"Máy Giặt Sấy Cửa Trước Panasonic 10 Kg giặt 6kg sấy NA-S106FC1LV - Diệt khuẩn đến 99.99% - Giặt sấy 2 trong 1 - Hàng Chính Hãng (Xám) - Giao Toàn Quốc",16490000,20690000,4200000,20
TIKI,giay-dep-nam,2597759,"Dép Nam Quai Ngang Da Bò Cao Cấp SUNPOLO SUA5D - Đen (Size",550000,550000,0,0
TIKI,giay-dep-nam,248884527,"Giày nam nhựa thời trang cao cấp hàng Việt Nam chất lượng cao, giày siêu nhẹ",60000,60000,0,0
TIKI,giay-dep-nam,72849628,"Giày cao cổ nam G255",595000,595000,0,0
TIKI,giay-dep-nam,39131125,"Xi mút đánh giày, mút lau sạch bóng giày dép, túi xách đa năng, chuyên đánh bóng đồ da tiện lợi an toàn và dễ dàng sử dụng GD238-XiMutDG",15000,15000,0,0
TIKI,dien-tu-dien-lanh,230766480,"Bình đun nước nóng tức thời Ariston AURES PREMIUM 4.5P - Hàng chính hãng",2649000,2649000,0,0
TIKI,giay-dep-nam,168587565,"Giày Thể Thao Nam, Giày Sneaker Nam New 2022.tăng ciều cao 4-5cm(2 mầu)k8",76000,80000,4000,5
TIKI,giay-dep-nam,94583342,"Máy giặt giày cỡ lớn cho gia đình đảo chiều tự động công nghệ mới Dual Brush 260w",2925000,2925000,0,0
TIKI,dien-tu-dien-lanh,195963006,"Tủ lạnh Panasonic 2 cánh ngăn đá trên NR-TV341BPS9 - Dung tích 306L - Hành chính hãng",11890000,11890000,0,0
TIKI,dien-tu-dien-lanh,92165763,"Cáp chuyển đổi từ Type c sang HDMI kết nối tivi máy chiếu + USB 3.0 kết nối phím chuột... Cáp Typec to HDMI",199000,205920,6920,3
TIKI,giay-dep-nam,188684626,"Lót Giày Nam Chất Liệu Cao Su Non Mềm Êm LGN2022a",38000,38000,0,0
TIKI,giay-dep-nam,144538043,"Giày Da Nam Màu Trắng Dáng Thể Thao Cổ Thấp 1993Shop - Giầy Nam Da Pu Đế Bệt Size Từ 38 Đến 44 GD:81",325000,325000,0,0
TIKI,giay-dep-nam,193629642,"Giày dép Sandals Vento ALPHA II Teen/Trẻ em màu Đen Ghi đi học/đi dã ngoại/đi chơi SD08002",365000,365000,0,0
TIKI,giay-dep-nam,184617549,"Giày thể thao nam, giày nam Trắng pha xám G802",230000,230000,0,0
TIKI,giay-dep-nam,160797806,"Giày da nam cao cấp, giày lười nam RJ-30022",257000,570000,313000,55
TIKI,giay-dep-nam,143786897,"Dép nam xỏ ngón màu nâu Trường Hải quai dép da bò thật đế cao 2.5cm  thời trang nam cao cấp D135N",207000,259000,52000,20
TIKI,giay-dep-nam,48357210,"GIày thể thao nam cao cấp có đệm khí trợ lực đế đi rất êm GN27",116000,125990,9990,8
TIKI,giay-dep-nam,42579011,"Dép quai ngang nam GIAVY - TL411",210000,210000,0,0
TIKI,giay-dep-nam,169109284,"Dép Quai Hậu Nam Loại Bền Đẹp ( Mã DEP01)",300000,600000,300000,50
TIKI,dien-tu-dien-lanh,9845366,"Đầu Thu Truyền Hình Kỹ Thuật Số DVB T2 - Hàng Chính Hãng LTP Việt Nam",399000,399000,0,0
TIKI,dien-tu-dien-lanh,141111339,"Máy giặt Electrolux Inverter 9 kg EWF9024P5WB - chỉ giao Hà Nội",8190000,8190000,0,0
TIKI,dien-tu-dien-lanh,172360277,"Thiết bị bảo vệ tủ lạnh Electron TH",159000,159000,0,0
TIKI,dien-tu-dien-lanh,17926677,"Máy Giặt Mini 2 Lồng - Giặt Đồ Trẻ Em",2149400,2149400,0,0
TIKI,dien-tu-dien-lanh,119056014,"Tủ lạnh Beko 93 lít RS9051P - Hàng chính hãng - Chi giao tại HN",3500000,3500000,0,0
TIKI,giay-dep-nam,120168794,"Đón giày bằng sừng tay cầm đốt trúc VIP (Dài 20cm) DGH912 - Chuyên dụng cho giày cao cấp - Cho giày Nam & Nữ - Product of HAHANCO",155000,155000,0,0
TIKI,dien-tu-dien-lanh,119194740,"Remote điều khiển dành cho tivi Sony RMF-TX300U (giọng nói)",170000,170000,0,0
TIKI,dien-tu-dien-lanh,123602257,"cáp 4K dành cho tivi LG",100000,100000,0,0
TIKI,giay-dep-nam,178954514,"GIẦY TÂY GIÀY LƯỜI NAM HÀN QUỐC VÂN CÁ SẤU ĐAI ÉN LỊCH LÃM 2020",200000,200000,0,0
TIKI,giay-dep-nam,76163287,"HAVAIANAS - Dép unisex Brasil Logo 4110850",749000,749000,0,0
TIKI,dien-tu-dien-lanh,103232664,"MÁY RỬA BÁT BOSCH SMS6ZCI42E-HÀNG NHẬP KHẨU",32945000,32945000,0,0
TIKI,giay-dep-nam,19681749,"Dép sandal nam da bò cao cấp Trường Hải SD077",299000,349000,50000,14
TIKI,dien-tu-dien-lanh,167580331,"Smart Tivi QLED Samsung 4K 55 inch QA55Q60BA - Model 2022",11900000,11900000,0,0
TIKI,giay-dep-nam,101656110,"Giày big size nam Sans132 giầy tây công sở derby đen cỡ to bigsize lớn số 43 44 45 46 47 48 âu trơn đẹp cao cấp buộc dây",399000,399000,0,0
TIKI,dien-tu-dien-lanh,459566,"Máy Nước Nóng FERROLI QQ EVO 15L ME (2500W)",1919000,1919000,0,0
TIKI,giay-dep-nam,115011763,"Giày Đốc Da Bò Crazzy Horse",769000,769000,0,0
TIKI,dien-tu-dien-lanh,87941227,"Smart Tivi Crystal Samsung 4K 55 inch UA55AU8000",11300000,11300000,0,0
TIKI,giay-dep-nam,189136565,"Giày sneaker thể thao nam màu xanh ngọc",599000,599000,0,0
TIKI,giay-dep-nam,77926010,"Dép quai ngang chữ M hình nhân vật cho nam - Mã Dep03",159000,298000,139000,47
TIKI,dien-tu-dien-lanh,131498354,"[Lắp đặt trong vòng 24h] Máy Giặt Cửa Trên Panasonic Chăm Sóc Gia Đình 10kg NA-F100A9DRV - Hàng chính hãng",7990000,9290000,1300000,14
TIKI,giay-dep-nam,15769259,"Nước dưỡng da bóng Patent VERNIS RIFE LIQUIDE 100ml",360000,360000,0,0
TIKI,dien-tu-dien-lanh,83419115,"Tủ lạnh Panasonic Inverter 417L NR-BX471GPKV - Chỉ giao Hà Nội",18800000,18800000,0,0
TIKI,giay-dep-nam,129010963,"Chai tẩy trắng giày hiệu quả và an toàn (có cọ chải)",13999,13999,0,0
TIKI,giay-dep-nam,23021195,"Giày Mọi Nam BiGGBEN Da Bò Thật Cao Cấp GM176",649000,700000,51000,7
TIKI,giay-dep-nam,168271050,"Lót giày da bò cao cấp êm chân khử mùi tốt sức khỏe- Tăng 1Size (LGD06)",145000,250000,105000,42
TIKI,dien-tu-dien-lanh,77099713,"KỆ TIVI DI ĐỘNG SÂN KHẤU 37-60ICNH ,CAO 0,8 MÉT HÀNG NHƯ HÌNH",394000,394000,0,0
TIKI,giay-dep-nam,127380104,"Giày Sneaker Da Unisex DINCOX D20 Năng Động Cá Tính Black",550000,550000,0,0
TIKI,giay-dep-nam,155794833,"Giày lười nam Đông Hải da bò cao cấp  thiết kế tối giản với chỉ may nổi ấn tượng  đế cao su 3cm chắc chắn - G0343",1490000,1490000,0,0
TIKI,giay-dep-nam,71962033,"Giày mọi nam đế âm HÀ NAM da bò thật cao cấp GDA2021",692000,692000,0,0
TIKI,giay-dep-nam,87120615,"Giày Sneaker Nam Tomoyo TMN05401",1400000,1400000,0,0
TIKI,giay-dep-nam,92901215,"Giày quai ngang/ giày sandal / dép quai hậu cao cấp siêu bền siêu đẹp -mã 58432",419000,799000,380000,48
TIKI,giay-dep-nam,128812081,"Giày quai nang nam, dép quai hậu nam đẹp phong cách thời trang Hàn Quốc mã DEP10LE",169500,339000,169500,50
TIKI,giay-dep-nam,151952991,"Dép nam da quai ngang cao cấp. Dép được may chắc chắn, SẢN PHẨM được bảo hành. Sỉ giá tốt",239000,239000,0,0
TIKI,giay-dep-nam,114207259,"Giày lười vải nam thời trang - GV010",99000,99000,0,0
TIKI,giay-dep-nu,27170796,"Sandal Nữ Cao Gót BIGGBEN Cao Cấp SDCG28",389000,550000,161000,29
TIKI,giay-dep-nu,175468410,"Giày sandal nữ Teva Hurricane Drift - 1102390",477000,695000,218000,31
TIKI,giay-dep-nu,179912149,"Giày Thể Thao Nữ Cao Cấp Mẫu Mới 2022 Siêu Nhẹ Thoáng Khí Êm Chân Kiểu Hàn Quốc Năng Động Cá Tính SUNO STORE GTTN12",256000,256000,0,0
TIKI,giay-dep-nu,186740219,"Giày Cao Gót Da Bò Thật BIGGBEN Gót 7 Phân SDCG78",299000,400000,101000,25
TIKI,giay-dep-nu,108563064,"Giày Sandal Cao Gót Da Bò BIGGBEN SDCG68",309000,350000,41000,12
TIKI,giay-dep-nu,177873484,"[HOT TREND] Giày sandal bánh mì 3 phân quai ngang bảng to S012 đế đúc chống trượt chắc chắn",183000,195000,12000,6
TIKI,giay-dep-nu,125098597,"Giày Nữ Anh Khoa A960-1",149000,149000,0,0
TIKI,giay-dep-nu,148935522,"giày chạy bộ cho nữ,giày thể thao thời trang thoáng khí siêu nhẹ êm chân SUNO STORE GTTN02",177000,177000,0,0
TIKI,giay-dep-nu,104267648,"Dép xỏ ngón nữ cao cấp đi biển chống trơn trượt",68000,68000,0,0
TIKI,giay-dep-nu,114880748,"Sandal Nữ Biti's Hunter DEWH00900KEM (Kem)",439120,499000,59880,12
TIKI,giay-dep-nu,192134946,"Giày Búp Bê Nữ Da Bò Thật BIGGBEN Cao 5 Phân BB128",309000,450000,141000,31
TIKI,giay-dep-nu,50493091,"Giày búp bê nữ vải caro cao 2cm đi bộ cực êm chân V220",68000,68000,0,0
TIKI,giay-dep-nu,63468302,"Dép Nhựa Cao Su Non Siêu Êm Đúc Nguyên Khối - Hàng Nhập Khẩu",55000,55000,0,0
TIKI,giay-dep-nu,25389174,"Giày Moca giày nhựa đi mưa màu nhiều màu size 36 đến 40 V177",93000,93000,0,0
TIKI,giay-dep-nu,105522235,"Giày Thể Thao Nữ Vải Lưới Thoáng Khí GN10",69000,69000,0,0
TIKI,giay-dep-nu,82918341,"Dép đi trong nhà massage dép đi nhà tắm massage dép đi khách sạn -  Mã N747",49500,99000,49500,50
TIKI,giay-dep-nu,192705088,"Sandal Nữ Biti’s Êmbrace DEW008488",410000,410000,0,0
TIKI,giay-dep-nu,91254419,"Giày Sandal Đế Xuồng Nữ Da Bò BIGGBEN Cao Cấp SDX26",339000,450000,111000,25
TIKI,giay-dep-nu,51523248,"Giày lười nữ thời trang đẹp siêu bền nhiều màu V235",51000,51000,0,0
TIKI,giay-dep-nu,104793449,"Dép Nhựa Thái Lan Quai Ngang  7.6",105000,105000,0,0
TIKI,giay-dep-nu,195528473,"Giày Sandal Nữ Da Bò Thật BIGGBEN Cao Cấp SDN82",339000,400000,61000,15
TIKI,giay-dep-nu,137253877,"Miếng mút lót mũi giày êm chân",20000,20000,0,0
TIKI,giay-dep-nu,193771398,"Giày lười nữ chất liệu vải cotton đế cao su mềm cao 2cm",119000,149000,30000,20
TIKI,giay-dep-nu,192287977,"Giày thể thao nam nữ sneaker cổ cao HOT TREND - GNU1003",282000,600000,318000,53
TIKI,giay-dep-nu,195232747,"Giày Thể Thao Nữ Trắng,Giày Sneaker Nữ Phiên Bản 2022 Cao Cấp Êm Chân Thoáng Khí GTTN22",220000,220000,0,0
TIKI,giay-dep-nu,126126861,"Giày Sandal Quai Hậu Đế Trấu Nam Nữ Detaunisex Quai Chéo Màu Trắng Học Sinh - SATA23T",300000,300000,0,0
TIKI,giay-dep-nu,142263703,"Giày boot nữ cổ thấp 7 phân hàng hiệu rosata hai màu đen nâu ro307",650000,650000,0,0
TIKI,giay-dep-nu,106583924,"Giày búp bê nữ đế xuồng da bò BIGGBEN BB95",309000,400000,91000,23
TIKI,giay-dep-nu,52275051,"Giày Sandal Cao Gót BIGGBEN Da Bò Thật SDCG43",339000,420000,81000,19
TIKI,giay-dep-nu,195874991,"Sét 2 miếng lót giày 4d - Miếng lót gót giày silicon 4 D chống trầy chân vừa chống tuột gót (1 cặp)",13000,15000,2000,13
TIKI,giay-dep-nu,106876783,"Giày Búp Bê Nữ Da Bò BIGGBEN Cao Cấp BB107",309000,400000,91000,23
TIKI,giay-dep-nu,67601050,"Giày Cao Gót 5cm Da Bóng Mũi Nhọn Đế Vuông Phối Mica Pixie P006",420000,420000,0,0
TIKI,giay-dep-nu,56842769,"Giày sneaker nữ thời trang mới nhất buộc dây siêu nhẹ V245",59000,59000,0,0
TIKI,giay-dep-nu,105522030,"Giày Thể Thao Vải Nữ Mềm, Đế Cao Su Có Răng Cưa Ma Sát Cao GN08",59000,59000,0,0
TIKI,giay-dep-nu,144236060,"Dép nữ da bò thật BIGGBEN cao cấp DNQN37",319000,400000,81000,20
TIKI,giay-dep-nu,77926784,"Dép Bệt Nữ 1cm Quai Ngang JUNO Mũi Vuông SD01095",199000,289000,90000,31
TIKI,giay-dep-nu,92024524,"HAVAIANAS - Sandal nữ Luna 4129697",699000,699000,0,0
TIKI,giay-dep-nu,76385061,"Giày sandal nữ kẹp BIGGBEN da bò thật cao cấp SDN67",339000,400000,61000,15
TIKI,giay-dep-nu,117685111,"DÂY GIÀY QUAI GIÀY CHỐNG TUỘT CHỐNG RỘNG GÓT CHÂN PHỤ KIỆN TIỆN LỢI TRANG TRÍ CHO ĐÔI GIÀY CỦA BẠN",55000,55000,0,0
TIKI,giay-dep-nu,176144959,"Chai xịt khử mùi giày, công nghệ Nano Bạc diệt khuẩn chống mùi hôi Nano Xclean For Shoes 50ml",49000,79000,30000,38
TIKI,giay-dep-nu,151757207,"Giày Sandal Cao Gót Da Bò Thật BIGGBEN SDCG69",319000,350000,31000,9
TIKI,giay-dep-nu,151778357,"Giày sandal nữ xỏ ngón da bò thật BIGGBEN cao cấp SDN72",309000,400000,91000,23
TIKI,giay-dep-nu,56360249,"Giày sandal nữ Trường Hải đế cao 2.5cm quai dép da bò thật không nổ da đế cao su không trơn thời trang cao cấp SDN082",244000,289000,45000,16
TIKI,giay-dep-nu,193268704,"Giày nữ giày lười vải đế cao su mềm cao 2p",132000,149000,17000,11
TIKI,giay-dep-nu,140968125,"Dép bánh mì quai ngang nữ mẫu mới Hot trend 2021 hình Boy Girl Cute Mềm Êm Cực Xinh",49500,49500,0,0
TIKI,giay-dep-nu,172574646,"Giày cao gót đế 5 phân mũi nhọn công sở sang trọng",155000,155000,0,0
TIKI,giay-dep-nu,141929095,"Giày cao gót nữ đẹp đế vuông 4 phân hàng hiệu rosata màu đen kem ro363",430000,430000,0,0
TIKI,giay-dep-nu,17628751,"Giày búp bê trơn đen da bò thật TH - BB03",264000,309000,45000,15
TIKI,giay-dep-nu,192704744,"Dép Nhựa Thái Lan, Dép Nữ Quai Ngang nhiều màu sắc Monobo KAREN",160000,160000,0,0
TIKI,giay-dep-nu,176714650,"Dép quai kẹp Bitis nữ đế 1cm",79000,79000,0,0
TIKI,giay-dep-nu,43182509,"Bộ 2 cặp lót giày bảo vệ gót chân và chống tuột gót giày (loại hạt xoài) - buybox - BBPK20",25000,50000,25000,50
TIKI,giay-dep-nu,186993016,"Xịt khử mùi giày dép hương chanh sả, quế cao cấp, giúp chân thông thoáng - buybox - BBPK212 - 75ML",86000,100000,14000,14
TIKI,giay-dep-nu,177651328,"Dép Cao Gót Nữ BIGGBEN Cao 7 Phân DCG60",339000,400000,61000,15
TIKI,giay-dep-nu,190542901,"Dép quai kẹp xốp Bitis nữ đế 7cm",245000,245000,0,0
TIKI,giay-dep-nu,186630810,"Giày Búp Bê Nữ Hỡ Mũi Da Bò Thật BIGGBEN Cao 5 Phân BB126",299000,380000,81000,21
TIKI,giay-dep-nu,189179216,"Giày Sandal Nữ The Bily 01W Quai Chéo Dây Rút - Màu Xám BL01WX",359000,359000,0,0
TIKI,giay-dep-nu,106870156,"Giày Búp Bê Nữ Da Bò BIGGBEN Cao Cấp BB106",309000,450000,141000,31
TIKI,giay-dep-nu,103932676,"Giày lười nữ êm chân phong cách hàn quốc V281",69000,69000,0,0
TIKI,giay-dep-nu,192863678,"Giày Nữ Búp Bê Pierre Cardin - PCWFWSG 172",490000,1490000,1000000,67
TIKI,giay-dep-nu,204761805,"Bốt Đùi Nữ Cao Cổ Da Trơn Bóng Kéo Khóa Sau Đế Vuông Chất Đẹp Thời Trang",550000,885000,335000,38
TIKI,giay-dep-nu,43237480,"DÉP XỐP LỖ ĐI TRONG NHÀ",32299,33999,1700,5
TIKI,giay-dep-nu,55086776,"Combo 5 cặp vớ silicone tổ ong đệm êm lòng bàn chân phía trước - BBPK67_5",70000,90000,20000,22
TIKI,giay-dep-nu,192937948,"Giày Thể Thao Trung Cấp Nữ Biti's DSW066300",519000,519000,0,0
TIKI,giay-dep-nu,68237846,"Dép Thái Lan siêu nhẹ nhiều màu D983 (tặng móc khóa hình trái bơ đáng yêu)",59000,59000,0,0
TIKI,giay-dep-nu,119718791,"Giày Sandal Nữ Đế Xuồng TiTi ĐÔ Da Bò Thật Cao Cấp 5cm DNU2069a",288000,288000,0,0
TIKI,giay-dep-nu,79558697,"Giầy lười nữ vải đẹp đi bộ êm chân giầy slip on vải đế mềm V276",69000,69000,0,0
TIKI,giay-dep-nu,144219043,"Sandal nữ đi mưa Alina cao 3.5p thời trang mới nhất V289",54000,54000,0,0
TIKI,giay-dep-nu,107223787,"Dép Cao Gót Nữ Da Bò BIGGBEN Cao 4 Phân DCG53",319000,450000,131000,29
TIKI,giay-dep-nu,191428560,"Dép quai kẹp Bitis nữ đế 1 cm",79000,79000,0,0
TIKI,giay-dep-nu,167489656,"Dép lào Thái màu xanh lá loại 1 nhập thái dép tông lào thái huyền thoại dép xỏ ngón dép hai quai dép kẹp thái",93500,93500,0,0
TIKI,giay-dep-nu,67598275,"Giày Sandal Cao Gót 5cm Quai Dán Đế Gỗ Pixie 5245",450000,450000,0,0
TIKI,giay-dep-nu,13330144,"Combo 10 miếng lót giày silicon tăng chiều cao",32000,32000,0,0
TIKI,giay-dep-nu,91258729,"Dép Đế Xuồng Nữ Da Bò BIGGBEN Cao Cấp DX30",309000,400000,91000,23
TIKI,giay-dep-nu,58125396,"Dép đế trấu nữ 2 khóa unisex màu Đen - DETA21D",245000,245000,0,0
TIKI,giay-dep-nu,168117353,"Combo 10 đôi dép xốp màu trắng, đen , xanh cho khách sạn, nhà nghỉ",95000,95000,0,0
TIKI,giay-dep-nu,66667498,"Dép đế xuồng nạm đá đen siêu nhẹ siêu êm S158",259000,259000,0,0
TIKI,giay-dep-nu,162593248,"Giày Sneakers độn đế 6cm chất da pu êm nhẹ PS339",388000,388000,0,0
TIKI,giay-dep-nu,175469044,"Giày chạy bộ nữ Under Armour HOVR Machina 2 SE - 3024741",2857000,4395000,1538000,35
TIKI,giay-dep-nu,94230575,"Bộ 6 Miếng Đế Lót Độn Giày- Đế lót tăng chiều cao Silicon Cực Êm Tặng kèm Chai Xịt Khử Mùi Giày Dép",75000,75000,0,0
TIKI,giay-dep-nu,128086523,"Nút bọc đế giày cao gót, nhiều cỡ khác nhau",19000,19000,0,0
TIKI,dien-tu-dien-lanh,142781325,"VinaBox X9 (Phiên Bản Thế Hệ Mới 2022) - Ram 2G/16G - Truyền Hình OTT Miễn Phí - Siêu Phẩm Trở Lại - Chất Lượng Bền Lâu - Hàng Chính Hãng",667000,667000,0,0
TIKI,dien-tu-dien-lanh,53308440,"Tủ mát - Minibar thương hiệu Homesun, Model: BCH-40B, Thể tích 40L, Công suất 65W, Điện áp 220VAC, Không tiếng ồn, Tiết kiệm điện năng, Màu đen sang trọng, Hàng chính hãng",3960000,3960000,0,0
TIKI,dien-tu-dien-lanh,187271835,"Android tivi box MAGICSEE N5 MAX X4 Ram 4G Android 11 điều khiển giọng nói kiêm bàn phím chuột bay có đèn nền dual wifi 2 băng tần bluetooth S905X4 cài sẵn phim, truyền hình cáp miễn phí vĩnh viễn cáp miễn phí vĩnh viễn - Hàng nhập khẩu ",1555000,1555000,0,0
TIKI,dien-tu-dien-lanh,34744943,"Tủ Lạnh AQUA Inverter 456 Lít AQR-IGW525EM GB - HÀNG CHÍNH HÃNG",19249000,19249000,0,0
TIKI,dien-tu-dien-lanh,189204315,"Máy rửa bát 15 bộ cao cấp Nagakawa NAG3601M15 - Made in Malaysia - Hàng chính hãng",11499000,16099000,4600000,29
TIKI,dien-tu-dien-lanh,76053885,"Máy Giặt Sóng Siêu Âm Đảo Chiều Tự Động Có Thể Xếp Gọn",341000,341000,0,0
TIKI,dien-tu-dien-lanh,176289256,"Máy Sấy Thông Hơi Electrolux 8.5 kg EDV854J3WB - Hàng Chính Hãng - Chỉ Giao HCM",11490000,11490000,0,0
TIKI,dien-tu-dien-lanh,165964546,"Ron tủ lạnh dành cho tủ lạnh  Sharp model SJ-165S-GR",153000,153000,0,0
TIKI,dien-tu-dien-lanh,120389915,"Remote Điều Khiển Dùng Cho SONY Smart TV, Internet Tivi RMT-TX100D",56000,56000,0,0
TIKI,dien-tu-dien-lanh,196002803,"Tủ lạnh LG Inverter 335 lít GN-M332PS - Hàng chính hãng [Giao hàng toàn quốc]",12990000,12990000,0,0
TIKI,dien-tu-dien-lanh,71567079,"Điều khiển thông minh dành cho tivi LG 2018",418000,418000,0,0
TIKI,dien-tu-dien-lanh,114830872,"[Lắp đặt trong vòng 24h] Máy Giặt Cửa Trước Panasonic 9.5 Kg NA-FD95V1BRV - Công Suất Xoáy Giặt Nhanh - Hàng chính hãng",10190000,12190000,2000000,16
TIKI,dien-tu-dien-lanh,128628167," Tivi Box  Kiwi S3 Pro - Phiên Bản 2021 - Ram2G/16G - Android 10 -Cầu Hình Siêu Khủng - Hàng Chính Hãng",780000,780000,0,0
TIKI,dien-tu-dien-lanh,109693112,"Máy Nước Nóng Gián Tiếp Ariston Vitaly 30 2.5 FE (2500W) - Hàng chính hãng",2149000,2149000,0,0
TIKI,dien-tu-dien-lanh,3810897,"Máy Nước Nóng Gián Tiếp FERROLI VERDI 20L TE (2500W) - Hàng Chính Hãng",2365000,2365000,0,0
TIKI,dien-tu-dien-lanh,114772016,"Tủ lạnh 2 cánh Panasonic 234 lít NR-TV261BPKV - Diệt khuẩn 99.99% - Tiết kiệm điện - Hàng chính hãng",9140000,10390000,1250000,12
TIKI,dien-tu-dien-lanh,16872971,"Điều khiển dùng cho điều hòa LG 2 chiều ngắn",48000,48000,0,0
TIKI,dien-tu-dien-lanh,146363487,"Hệ Thống Máy Lạnh Multi S Daikin Inverter Combo 2HP + 02 dàn lạnh 1.0HP + 1.5HP - MKC50RVMV/CTKC25RVMV+CTKC35RVMV - Hàng Chính Hãng - Chỉ giao tại TP.HCM",22042000,22042000,0,0
TIKI,dien-tu-dien-lanh,77910697,"Điều Hòa Nagakawa 9000Btu NS-C09R1M05 - Chỉ Giao tại HN",4990000,4990000,0,0
TIKI,dien-tu-dien-lanh,50278870,"Khung treo tivi sát tường 26 - 32 inch",48000,48000,0,0
TIKI,dien-tu-dien-lanh,176289443,"[HCM] Máy Sấy Thông Hơi Electrolux 8.5 kg EDS854J3WB (MODEL 2022) - 12 Chương Trình Sấy - Hàng Chính Hãng",12990000,12990000,0,0
TIKI,dien-tu-dien-lanh,536260,"Tủ Lạnh Inverter Sharp SJ-FX680V-ST (605L)-Hàng Chính Hãng",16950000,16950000,0,0
TIKI,dien-tu-dien-lanh,126702091,"Điều khiển tivi dành cho Toshiba CT-8068",47500,50000,2500,5
TIKI,dien-tu-dien-lanh,126702225,"Remote Điều khiển từ xa Tivi giọng nói dành cho LG AN-MR650A LG 2017",259000,259000,0,0
TIKI,dien-tu-dien-lanh,186117126,"Tủ lạnh Aqua 130 lít AQR-T150FA (BS) - Hàng Chính Hãng [Giao hàng toàn quốc]",4680000,4890000,210000,4
TIKI,dien-tu-dien-lanh,86139384,"MÁY RỬA CHÉN BOSCH HMH.SMS63L08EA - HÀNG CHÍNH HÃNG - chỉ giao tại hcm",13389000,13389000,0,0
TIKI,dien-tu-dien-lanh,195219893,"Máy rửa chén Junger 2100W DWJ-450 - Hàng chính hãng",19950000,19950000,0,0
TIKI,dien-tu-dien-lanh,90148835,"Máy giặt Samsung Inverter 11kg WA11T5260BV/SV - Chỉ giao Hà Nội",8550000,8550000,0,0
TIKI,dien-tu-dien-lanh,167549374,"Smart Tivi Crystal Samsung 4K 65 inch UA65BU8000 - Model 2022",14200000,14200000,0,0
TIKI,dien-tu-dien-lanh,11998183,"Android tivi box VNPT MyTVNet Net 1 - Tặng kèm chuột không dây chính hãng  ",725000,725000,0,0
TIKI,dien-tu-dien-lanh,114856783,"[CHỈ GIAO TẠI HCM] - Máy giặt Panasonic 16kg NA-FD16V1BRV - Hàng Chính Hãng",23090000,23090000,0,0
TIKI,dien-tu-dien-lanh,95515402,"Android Tivi OLED Sony 4K 55 inch XR-55A80J",26204000,26204000,0,0
TIKI,dien-tu-dien-lanh,23419942,"Máy giặt mini tại xô DEKE GT-16AC tiết kiệm điện cho sinh viên và em bé có hẹn giờ và đảo chiều",1099000,1099000,0,0
TIKI,dien-tu-dien-lanh,198573060,"TẤM CHẮN GIÓ KHE LẠNH ĐIỀU HÒA Kt 60X15cm",350000,350000,0,0
TIKI,dien-tu-dien-lanh,23831436,"Máy sấy Electrolux 8 Kg EDV805JQSA - Hàng Chính Hãng",9890000,9890000,0,0
TIKI,dien-tu-dien-lanh,196953412,"MÁY RỬA BÁT TEXGIO TG–DT2022B – Hàng chính hãng",6200000,6200000,0,0
TIKI,dien-tu-dien-lanh,12771188,"Bình nước nóng Ariston Slim2 SL2 20 R - 20 lít - Hàng Chính Hãng",2899000,2899000,0,0
TIKI,dien-tu-dien-lanh,112716880,"Máy giặt 9.5kg Casper WF-95I140BGB Inverter Mới 2021 Xuất xứ Thái Lan -Hàng chính hãng (Chỉ giao Hà Nội)",5990000,5990000,0,0
TIKI,dien-tu-dien-lanh,53304261,"Tủ lạnh Funiki Hòa Phát FR 136ISU 130 lít - Hàng Chính Hãng",3890000,3890000,0,0
TIKI,dien-tu-dien-lanh,167441196,"LỒNG QUẠT MÁY - HÀNG CHÍNH HÃNG 3HT",40000,40000,0,0
TIKI,dien-tu-dien-lanh,176752041,"Máy giặt Toshiba 9kg AW-K1000FV(Cửa trên) - Chỉ giao Hà Nội",6400000,6400000,0,0
TIKI,dien-tu-dien-lanh,25240425,"Remote Điều Khiển Dùng Cho Máy Lạnh Fujitsu Inverter AR-RAE2U, Điều Hòa AR-RY10",63000,63000,0,0
TIKI,dien-tu-dien-lanh,104791222,"Máy giặt Casper 8.5 KG WT-85N68BGA - Hàng chính hãng (chỉ giao HCM)",4290000,4290000,0,0
TIKI,dien-tu-dien-lanh,87571543,"Máy Lạnh Panasonic Inverter 1.5 HP CU/CS-XPU12XKH-8 - Chỉ giao tại HCM",12495000,12495000,0,0
TIKI,dien-tu-dien-lanh,7478727,"Thiết bị đo nhiệt độ từ xa sửa chữa đa năng",227050,239000,11950,5
TIKI,dien-tu-dien-lanh,119195115,"Remote Điều khiển dành cho tivi led Asanzo",37500,37500,0,0
TIKI,dien-tu-dien-lanh,195228162,"Công Tắc Cửa Dành Cho Máy Giặt TOSHIBA E89",285700,285700,0,0
TIKI,dien-tu-dien-lanh,76357858,"khung treo tivi CỐ ĐỊNH 52-62INCH HOÀNG THỊNH ,HÀNG CHÍNH HÃNG.",88000,88000,0,0
TIKI,dien-tu-dien-lanh,106066668,"Motor quạt hơi nước các loại",480000,480000,0,0
TIKI,dien-tu-dien-lanh,77910707,"Điều Hòa Nagakawa Inverter 18000Btu NIS-C18R2H08 - Chỉ Giao tại HN",10290000,10290000,0,0
TIKI,dien-tu-dien-lanh,126702290,"Remote điều khiển dành cho đầu thu truyền hình kĩ thuật số An Viên TV-AVG.",74000,74000,0,0
TIKI,dien-tu-dien-lanh,72722986,"Tủ Đông Kangaroo KG168NC1 - Hàng chính hãng - Chỉ giao hàng tại Hà Nội",5350000,5350000,0,0
TIKI,dien-tu-dien-lanh,48319742,"Điều Hòa Inverter Nagakawa NIS-C18R2T01 (18.000Btu) - Hàng Chính Hãng (Chỉ giao tại Hà Nội)",9390000,9390000,0,0
TIKI,dien-tu-dien-lanh,23476169,"Tủ lạnh Funiki FR-152CI 150L - Hàng chính hãng",4148000,4150000,2000,0
TIKI,dien-tu-dien-lanh,48575548,"Bộ Chia 3 Pacific Dùng Chia Truyền Hình Cáp, Anten KTS - Hàng Nhập Khẩu",44900,44900,0,0
TIKI,dien-tu-dien-lanh,89637543,"Anten thông minh DVB T2 tặng kèm bộ đinh vít",75000,75000,0,0
TIKI,dien-tu-dien-lanh,116075780,"Máy Rửa Bát Bosch SMS4HCI48E Serie 4 Độc Lập - Hàng Nhập Khẩu Đức",28650000,28650000,0,0
TIKI,dien-tu-dien-lanh,195219175,"Máy rửa chén Electrolux ESF6010BW 1480W - Hàng chính hãng",7810000,9990000,2180000,22
TIKI,dien-tu-dien-lanh,243045582,"Remote Điều Khiển Máy Lạnh, Máy Điều Hòa LG AKB73756203, LG S09EN2",50000,50000,0,0
TIKI,dien-tu-dien-lanh,135038787,"Sensor cho tủ lạnh  samsung cảm biến nhiệt tủ lạnh samsung",35000,35000,0,0
TIKI,dien-tu-dien-lanh,165964670,"Ron tủ lạnh cho tủ lạnh SHARP model SJ-186SL",187000,187000,0,0
TIKI,dien-tu-dien-lanh,154745459,"Bình nước nóng hồng ngoại xa Kangaroo KG588W - Hàng Chính Hãng",4200000,4200000,0,0
TIKI,dien-tu-dien-lanh,114985013,"Tủ lạnh Sharp Inverter 525 lít SJ-FXP600VG-MR - Chỉ giao Hà Nội",24290000,24290000,0,0
TIKI,dien-tu-dien-lanh,94584737,"Máy tính bảng 10.1 inch màn hình cong Moocis M5 Android 6.0 Ram3GB Rom32Gb - HanruiOffical",4264000,4264000,0,0
TIKI,dien-tu-dien-lanh,113483268,"Cáp HDMI không dây Chromecast.",310000,310000,0,0
TIKI,dien-tu-dien-lanh,87909068,"Smart Tivi Samsung 4K 75 inch UA75AU7000 Mới 2021",17644000,17644000,0,0
TIKI,dien-tu-dien-lanh,4184251,"Máy Nước Nóng Ferroli VERDI 20L SE (2500W)",2589000,2589000,0,0
TIKI,dien-tu-dien-lanh,32130994,"Remote Điều Khiển Dùng Cho TV LCD, TV LED TCL TC-97E",24900,24900,0,0
TIKI,dien-tu-dien-lanh,141111320,"Máy giặt Electrolux Inverter 9 kg EWF9024P5SB - chỉ giao Hà Nội",10450000,10450000,0,0
TIKI,dien-tu-dien-lanh,113673050,"Càng dành cho máy giặt Elextrolux 10843, 80743, 85743, 12843, 10844 - elec10843",571000,571000,0,0
TIKI,dien-tu-dien-lanh,50560445,"Tủ Lạnh Inverter Aqua AQR-T219FA-PB (186L) - Hàng Chính Hãng - Chỉ giao tại Hà Nội",6040000,6040000,0,0
TIKI,dien-tu-dien-lanh,102824878,"Tủ lạnh Aqua Inverter 291 lít AQR-T329MA (GB) - Hàng chính hãng - Giao tại Hà Nội và 1 số tỉnh toàn quốc",9850000,9850000,0,0
TIKI,dien-tu-dien-lanh,189151843,"Moto, mô tơ đảo gió quạt điều hòa, quạt hơi nước",69000,69000,0,0
TIKI,dien-tu-dien-lanh,191089702,"Máy Giặt Sấy Cửa Trước Panasonic 9 Kg giặt 6kg sấy NA-S96FR1BVT - Diệt khuẩn đến 99.99% - Giặt sấy 2 trong 1 - Hàng Chính Hãng (Đen) - Giao Toàn Quốc",16490000,21390000,4900000,23
TIKI,dien-tu-dien-lanh,29246318,"Máy Sấy Cửa Trước Electrolux EDV805JQSA (8kg) - Hàng Chính Hãng",10590000,10590000,0,0
TIKI,dien-tu-dien-lanh,119822281,"Remote Điều khiển tivi dành cho LG giọng nói 2020 MR20GA các dòng tivi LG 2017,2018,2019,2020",480000,480000,0,0
TIKI,dien-tu-dien-lanh,1956689,"Bình nước nóng Ferroli Verdi DE20L, 3 công suất, hiển thị nhiệt độ, có chống giật, 2500W - Hàng Chính Hãng",2491733,2491733,0,0
TIKI,dien-tu-dien-lanh,74893159,"Magic Remote Điều Khiển Dành Cho Smart TV, Tivi Thông Minh LG AN-MR18BA Chuột Bay, Nhận Giọng Nói ",305000,305000,0,0
TIKI,dien-tu-dien-lanh,140192388,"Giá treo tivi thẳng tường cố định hàng xuất khẩu dùng cho tivi siêu mỏng, Hàng Chính Hãng",166900,166900,0,0
TIKI,dien-tu-dien-lanh,119822270,"Điều khiển tivi dành cho Samsung giọng nói (Có tìm kiếm TIẾNG VIỆT) 2019",170000,170000,0,0
TIKI,dien-tu-dien-lanh,119193686,"Remote Điều khiển dành cho quạt Mitsubishi+ kèm pin 3V",56000,56000,0,0
TIKI,dien-tu-dien-lanh,55584723,"Tủ mát - Minibar, Tủ bảo quản mỹ phẩm, Model: BCH-40B2, Thể tích 40L, Công suất 65W, Điện áp 220VAC, Cửa gương sang trọng, Không tiếng ồn, Tiết kiệm điện năng, Thương hiệu Homesun, Hàng chính hãng",4180000,4180000,0,0
TIKI,dien-tu-dien-lanh,20500053,"Tủ Lạnh Inverter LG GN-M255BL (255L) - Hàng chính hãng",6850000,6850000,0,0
TIKI,dien-tu-dien-lanh,156311446,"Remote Tivi Điều Khiển Dành Cho SAMSUNG Smart TV QLED, 4K BN59-01259B",75000,75000,0,0
TIKI,dien-tu-dien-lanh,103822668,"ĐIỀU KHIỂN TIVI ASANZO CÓ 4 NÚT MÀU PHÍA DƯỚI (SP 1291)HÀNG CHÍNH HÃNG.",74000,74000,0,0
TIKI,dien-tu-dien-lanh,126702248,"Remote Điều khiển từ xa tivi dành cho LG giọng nói 2017 MR650A ",303000,303000,0,0
TIKI,dien-tu-dien-lanh,19389387,"Giá Treo Màn Hình Máy Tính North Bayou F120  (17-27 INCH) - Hàng Chính Hãng",378000,378000,0,0
TIKI,dien-tu-dien-lanh,73174421,"Máy giặt LG Inverter 10.5 kg T2350VSAB - Chỉ giao Hà Nội",6290000,6290000,0,0
TIKI,dien-tu-dien-lanh,52695663,"Máy giặt Electrolux Inverter 8 kg EWF8025CQSA",7390000,7390000,0,0
TIKI,dien-tu-dien-lanh,103121262,"Tủ lạnh Toshiba Inverter 270 lít GR-RB350WE-PMV(30)-BS - Hàng chính hãng - Giao tại Hà Nội và 1 số tỉnh toàn quốc",8500000,8500000,0,0
TIKI,dien-tu-dien-lanh,273533348,"Ron tủ lạnh có sẵn nam châm 1.6 mét màu trắng",25000,25000,0,0
TIKI,dien-tu-dien-lanh,171273605,"ÁO VỆ SINH MÁY LẠNH LOẠI TỐT CÓ ĐUÔI DÀI 2,5met - Xanh bích không dây siêu rẻ",55000,55000,0,0
TIKI,dien-tu-dien-lanh,113490579,"TV QLED 50'' 4K Android 11 Tivi TCL 50C725 - Gam Màu Rộng , HDR 10+, MEMC , Dolby Audio- HÀNG CHÍNH HÃNG",12950000,12950000,0,0
TIKI,dien-tu-dien-lanh,58537376,"Tủ Chăm Sóc Quần Áo Thông Minh Samsung DF60R8600CG/SV - Chỉ Giao Hà Nội",26804000,26804000,0,0
TIKI,dien-tu-dien-lanh,121744043,"Máy giặt LG Inverter 8.5 kg T2185VS2M - Chỉ giao tại HN",6090000,6090000,0,0
TIKI,dien-tu-dien-lanh,195480654,"Smart Tivi LG 4K 75 inch 75UQ8000PSC - Model 2022",19500000,19500000,0,0
TIKI,dien-tu-dien-lanh,186693695,"Điều hòa Casper 1 chiều Inverter 12.000 BTU GC-12IS33 -Hàng chính hãng ( Chỉ giao hàng tại Hà Nội)",6690000,6690000,0,0
TIKI,dien-tu-dien-lanh,184698546,"Dây Cáp AV 1 Ra 3 Dành Cho TV",14000,14000,0,0
TIKI,dien-tu-dien-lanh,32920496,"Máy giặt Electrolux Inverter 9 kg EWF9024ADSA",9450000,9450000,0,0
TIKI,dien-tu-dien-lanh,10191063,"Tủ Lạnh Inverter LG GN-D602BL (475L) - Hàng chính hãng",13800000,13800000,0,0
TIKI,dien-tu-dien-lanh,176289386,"Máy Rửa Chén Độc Lập Electrolux ESF5206LOW - 13 Bộ Chén Đĩa - Hàng Chính Hãng",21990000,21990000,0,0
TIKI,dien-tu-dien-lanh,3813015,"Tủ Lạnh Inverter Hitachi R-FW690PGV7-GBW (540L) - Hàng chính hãng",27500000,27500000,0,0
TIKI,dien-tu-dien-lanh,50189662,"Máy giặt Toshiba 9.5 KG TW-BK105S3V SK",7479000,7479000,0,0
TIKI,dien-tu-dien-lanh,168042358,"Smart Tivi QLED Samsung 4K 65 inch QA65Q70BA - Model 2022",21200000,21200000,0,0
TIKI,dien-tu-dien-lanh,168780538,"Android Box Mytv net  Phiên bản Ram 2G/16G 4G/32G có điều khiển giọng nói - Xem 200 Kênh truyền hình miễn phí - Hàng Chính Hãng",1089000,1089000,0,0
TIKI,dien-tu-dien-lanh,31587116,"MÁY RỬA BÁT FUJISHAN FJVN15- S03AF Hàng Chính Hãng",10990000,10990000,0,0
TIKI,dien-tu-dien-lanh,169748875,"Smart Tivi Neo QLED Samsung 8K 65 inch QA65QN700B - Model 2022",71000000,71000000,0,0
TIKI,dien-tu-dien-lanh,212425712,"Cầu chì lò vi sóng",4700,4700,0,0
TIKI,dien-tu-dien-lanh,117033515,"Remote BN59-01329H Điều Khiển Dành Cho Samsung Smart TV QLED 4K - Nhận Giọng Nói ",155000,155000,0,0
TIKI,dien-tu-dien-lanh,125273731,"Tủ lạnh Casper Inverter 551 lít RS-575VBW - Chỉ giao Hà Nội",14390000,14390000,0,0
TIKI,dien-tu-dien-lanh,89637495,"Remote điều khiển cho smart TV LG, Internet TV, tivi thông minh loại ngắn tặng kèm pin",53000,53000,0,0
TIKI,dien-tu-dien-lanh,126701916,"Điều khiển điều hòa dành cho Daikin hàng mới",58000,58000,0,0
TIKI,dien-tu-dien-lanh,13775999,"Bình nước nóng Ferroli Hotdog E (5L) - Hàng Chính Hãng",1747800,1747800,0,0
TIKI,dien-tu-dien-lanh,126701984,"Remote Điều khiển từ xa dành cho TIVI SAMSUNG SMART BN59-01266A",165000,165000,0,0
TIKI,dien-tu-dien-lanh,80916526,"Bộ 4 Chân Đế Máy Giặt, Tủ Lạnh Cao Su Chống Rung (Tròn)",24999,24999,0,0
TIKI,dien-tu-dien-lanh,135273331,"Máy giặt mini có giặt ngâm, giặt nhẹ kích thước nhỏ 2,5kg đồ giặt",799000,799000,0,0
TIKI,dien-tu-dien-lanh,126701965,"Remote điều khiển thông minh,điều khiển bằng giọng nói tivi dành cho CASPER",220000,220000,0,0
TIKI,dien-tu-dien-lanh,55109192,"Remote Điều Khiển Hộp TV Thông Minh, ANDROID TV BOX (Kèm Pin AAA Maxell)",59000,59000,0,0
TIKI,dien-tu-dien-lanh,170275021,"Bộ phụ kiện của Áo điều hòa Nhật Bản",546000,546000,0,0
TIKI,dien-tu-dien-lanh,126701896,"Điều khiển điều hòa dành cho LG1&2 chiều Inverter dùng cho dòng V10 V13 V18 9000BTU 12000BTU 18000BTU",71000,71000,0,0
TIKI,giay-dep-nu,271696183,"DÉP KẸP XỐP NỮ ĐẾ THẤP SXW109500 - Đen",120000,120000,0,0
TIKI,giay-dep-nu,181914456,"Dép cói hàng đẹp đính nơ thời trang dạo biển, đi trong nhà điệu đà, dép nhẹ đi vô cùng thoải mái",119000,119000,0,0
TIKI,giay-dep-nu,7992647,"Dép Nữ BIGGBEN Da Bò Thật DNQN05",329000,380000,51000,13
TIKI,giay-dep-nu,105522842,"Giày Sục Nữ Mũi Nhọn, Gót Nhọn Cao 3 Phân, Chấm Bi Nữ Tính GN18",109000,109000,0,0
TIKI,giay-dep-nu,143858696,"Giày Tiếp Viên (DA THẬT) Hàng Không Công Sở Văn Phòng Nữ Mũi Nhọn FFAN STORE",430000,430000,0,0
TIKI,giay-dep-nu,190740844,"Dép Nữ Da Bò Thật BIGGBEN Cao Cấp DNQN49",299000,360000,61000,17
TIKI,giay-dep-nu,16883760,"Combo 3 cặp lót giày thể thao dập vân giúp massage chân đem lại cảm giác cực êm chân (size nữ 35 đến 39 hoặc size nam 39 đến 43) PK06_3",45000,45000,0,0
TIKI,giay-dep-nu,150693598,"(HÀNG SẴN) Giày Sục Lưới Đen Thoáng Khí Tăng Chiều Cao AG75 - Hàng Quảng Châu Cao Cấp",195000,195000,0,0
TIKI,giay-dep-nu,34871085,"Giày sandal chiến binh da cắt đế thấp S370",272000,289000,17000,6
TIKI,giay-dep-nu,125270237,"Lót giầy đúc cao su non siêu êm, mềm, bền bỉ Tomshoes",30000,30000,0,0
TIKI,giay-dep-nu,7424745,"Miếng lót giày cao gót - Màu Đen (Size 34-40)",49000,49000,0,0
TIKI,giay-dep-nu,173432989,"Hộp 30 Khăn Giấy Ướt Lau Giày Hàn Quốc Sneaker Wipes",33000,35000,2000,6
TIKI,giay-dep-nu,145771465,"Giày lười nữ da bò thật BIGGBEN cao cấp BB116",309000,400000,91000,23
TIKI,giay-dep-nu,77963515,"Dép Lông Bít Mũi Đế Chống Trơn Giữ Ấm Chân Đi Trong Nhà D43",79000,79000,0,0
TIKI,giay-dep-nu,40160604,"Lót giày tăng chiều cao silicon 1.5cm bảo vệ gót chân, phòng ngừa, giảm đau gai gót chân, chai chân",50900,50900,0,0
TIKI,giay-dep-nu,29809200,"GIÀY NỮ CAO 11CM SIÊU XINH MH99",399000,399000,0,0
TIKI,giay-dep-nu,153258328,"Giày Cao Gót Nữ 5Cm Mũi Bọc Kim Loại",158000,158000,0,0
TIKI,giay-dep-nu,56095220,"Giày Búp Bê Nữ Hồng Trơn TOMOYO TMW20408",699000,699000,0,0
TIKI,giay-dep-nu,125098758,"Giày lười nữ Anh Khoa L992",301000,301000,0,0
TIKI,giay-dep-nu,262818700,"Giày cao gót nữ 8p RO493 ROSATA bít mũi có quai cài ôm cổ chân kiểu dáng thanh lịch và sang trọng - màu da",489000,489000,0,0
TIKI,giay-dep-nu,52635914,"Giày thể thao sneaker nữ phong cách hàn quốc, màu trắng đế cao HMS-HC88",173000,209000,36000,17
TIKI,giay-dep-nu,39961168,"Dép quai ngang mát xa bàn chân",15000,15000,0,0
TIKI,giay-dep-nu,74555528,"Giày slip on độn da PU trơn, Giày lười nữ S065",235000,235000,0,0
TIKI,giay-dep-nu,182111088,"Giầy lười nữ vải mềm thời trang mới nhất V302",118000,118000,0,0
TIKI,giay-dep-nu,197499113,"Giày mọi nữ da mềm đế cao su êm chân cao 1.5cm màu nâu đen trắng",179000,269000,90000,33
TIKI,giay-dep-nu,173450501,"[HOT TREND] Giày sandal bánh mì 5 phân gladiator cá tính êm chân phong cách Korea S087SD",212000,239000,27000,11
TIKI,giay-dep-nu,91029933,"Dép Cao Gót Nữ Da Bò BIGGBEN Cao 5 Phân DCG49",329000,400000,71000,18
TIKI,giay-dep-nu,83615592,"Dép bông đi trong nhà mùa đông lót lông đế chống trơn trợt nhiều màu phù hợp với cả nam và nữ - dep long di trong nha mu",39000,39000,0,0
TIKI,giay-dep-nu,108841610,"Dép đế trấu nam nữ chữ H thời trang màu Đen Detaunisex - DETA14D",245000,245000,0,0
TIKI,giay-dep-nu,144338834,"Dép đi trong nhà tắm văn phòng xốp lỗ siêu bền, siêu nhẹ (nhẹ hơn dép nhựa), chống trơn trượt đi mưa, nước, mùa đông",31999,31999,0,0
TIKI,giay-dep-nu,50610885,"Dép đôi phong cách hàn quốc_DN205N",119000,119000,0,0
TIKI,giay-dep-nu,31132876,"Combo 11 cái Sticker / Jibbitz, nút gắn dép sục, dép cá sấu, hình siêu anh hùng",59000,59000,0,0
TIKI,giay-dep-nu,20063722,"Dép nhựa sọc lưới đi trong nhà siêu bền, siêu nhẹ",31111,31111,0,0
TIKI,giay-dep-nu,23098088,"Giày Vans Authetic Pewter Black VN-000JRAPBQ",1350000,1500000,150000,10
TIKI,giay-dep-nu,169363162,"Giày búp bê nữ đế bằng 2cm đi bộ thoáng khi cực êm chân V292",59000,59000,0,0
TIKI,giay-dep-nu,73116359,"Giày Cao Gót Hở Mũi Thời Trang Cao Cấp Thương Hiệu PABNO PN453",300000,300000,0,0
TIKI,giay-dep-nu,179800000,"Dép Gấu Dạo Phố Nam Nữ 2 Màu- Mẫu Mới, Hàng Có Sẵn",139000,139000,0,0
TIKI,giay-dep-nu,57283747,"Dép chiếu Hương Quế DCQ-49 với nguyên liệu thân thiện môi trường (sợi chiếu, bột quế, sợi đay)",68000,68000,0,0
TIKI,giay-dep-nu,117683025,"SỈ 10 ĐÔI (20 MIẾNG )Lót gót giày giảm size Chống Tuột gót chống phồng Đau Chân Chống rộng cho các loại giày nam nữ",109000,109000,0,0
TIKI,giay-dep-nu,79712620,"Dép Đi Trong Nhà Cao Cấp, Êm Chân, Chống Trơn Trượt",45000,45000,0,0
TIKI,dien-tu-dien-lanh,1892015,"Khung Treo Tivi Áp Tường 40 - 60 Inches North Bayou NBC3-F - Hàng Chính Hãng",204000,204000,0,0
TIKI,dien-tu-dien-lanh,102159105,"Máy giặt Toshiba 7 Kg AW-L805AV(SG) - Hàng chính hãng (chỉ giao HCM)",4090000,4090000,0,0
TIKI,dien-tu-dien-lanh,52021144,"Android Tivi Box T95 hệ điều hành android 10 RAM 4GB  ROM 32GB  điều khiển giọng nói tiếng Việt",653000,999000,346000,35
TIKI,dien-tu-dien-lanh,103699237,"Bo mạch điều hòa đa năng có màn hình LED model YY-U08PGC và QD-U08PGC + (E) - Điện Lạnh Thuận Dung",100000,100000,0,0
TIKI,dien-tu-dien-lanh,16966887,"Máy Rửa Chén Electrolux ESF5512LOX - Hàng Chính Hãng",15800000,15800000,0,0
TIKI,dien-tu-dien-lanh,109109974,"Điều hòa di động Casper PC-09TL33 - Hàng chính hãng -  Chỉ giao hàng Hà Nội",5099000,5099000,0,0
TIKI,dien-tu-dien-lanh,108176128,"Máy Giặt Samsung Inverter 9 kg WW90T634DLN",8690000,14990000,6300000,42
TIKI,dien-tu-dien-lanh,48577764,"Bộ Chia 4 Pacific Dùng Chia Truyền Hình Cáp, Anten KTS - Hàng Nhập Khẩu",51900,51900,0,0
TIKI,dien-tu-dien-lanh,41870097,"Chuột Bay G20s Tìm Kiếm Giọng Nói 1 Chạm 1 Nút Học Lệnh",137750,145000,7250,5
TIKI,dien-tu-dien-lanh,84860356,"Tủ lạnh Panasonic Inverter 170 lít NR-BA190PPVN-Hàng chính hãng- Giao tại HN và 1 số tỉnh toàn quốc",5339000,5339000,0,0
TIKI,dien-tu-dien-lanh,146396084,"Hệ Thống Máy Lạnh Multi S Daikin Inverter Combo 3HP + 02 dàn lạnh 1.0HP + 2.0HP - MKC70SVMV/CTKC25RVMV+CTKC50SVMV - Hàng Chính Hãng - Chỉ giao tại TP.HCM",31162000,31162000,0,0
TIKI,dien-tu-dien-lanh,32105143,"Remote Điều Khiển Máy Lạnh, Máy Điều Hòa LG AKB73756203, LG S09EN2",47000,47000,0,0
TIKI,dien-tu-dien-lanh,169277191,"Chân đế tivi đa năng lắp đặt mọi hãng tivi 32-60 inch - Chân tivi để bàn lắp đặt mọi màn hình",199000,199000,0,0
TIKI,dien-tu-dien-lanh,153262003,"Máy Rửa Chén Malloca WQP12-5201E - 6 Chương Trình Rửa - Hàng Chính Hãng",14960000,17600000,2640000,15
TIKI,dien-tu-dien-lanh,48606367,"Bình nóng lạnh Ferroli QQ AE 20L",2365000,2365000,0,0
TIKI,dien-tu-dien-lanh,58848785,"miếng chắn  điều chỉnh hướng gió điều hòa",354000,354000,0,0
TIKI,dien-tu-dien-lanh,166556366,"Chiết Áp Quạt Điện Dimmer - Quạt Trần Quạt Bàn Quạt Bếp",30070,30070,0,0
TIKI,dien-tu-dien-lanh,4586897,"Máy Giặt Cửa Trên Aqua AQW-S72CT (7.2kg) - Hàng Chính Hãng",3999000,3999000,0,0
TIKI,dien-tu-dien-lanh,143362891,"Smart Tivi LG 4K 43 inch 43UP7500PTC",8950000,8950000,0,0
TIKI,dien-tu-dien-lanh,39371646,"Giá treo màn hình xoay 360 độ - Chân đứng - Tay dài 23 cm, kẹp bàn, hàng nhập khẩu",239000,239000,0,0
TIKI,dien-tu-dien-lanh,23421781,"Giá treo tivi di động AVA1500-60-1P hàng chính hãng màu đen sang trọng",969000,969000,0,0
TIKI,dien-tu-dien-lanh,56713023,"MÁY NƯỚC NÓNG TRỰC TIẾP AMORE GSN 4.500W -HÀNG CHÍNH HÃNG",2114885,2114885,0,0
TIKI,dien-tu-dien-lanh,121250362,"Android Tivi TCL 43 inch L43S5200 - Hàng chính hãng",5450000,5450000,0,0
TIKI,dien-tu-dien-lanh,120313906,"Máy rửa bát gia đình khử trùng 70 độ C, làm khô nhanh màn hình led hiển thị, Máy rửa bát mini công nghệ làm sạch 360 ở nhiệt độ cao",3500000,5500000,2000000,36
TIKI,dien-tu-dien-lanh,50739872,"Tủ đông mini Hòa Phát 107 lít HCF-106S1Đ ĐỒNG (R600A)",5260000,5260000,0,0
TIKI,dien-tu-dien-lanh,126701890,"Điều khiển dành cho đầu thu HDvtv 323 ",41800,44000,2200,5
TIKI,dien-tu-dien-lanh,2921071,"Andoid tivibox TX3 Mini Ram 2GB - ROM 16GB",599000,599000,0,0
TIKI,dien-tu-dien-lanh,50389224,"Anten City 5.1 - Hàng nhập khẩu",330000,330000,0,0
TIKI,dien-tu-dien-lanh,71895779,"TV BOX T95H 4GB RAM 32GB ROM ANDROID 10 CÓ BLUETOOTH CÀI SẴN ỨNG DỤNG XEM PHIM HD VÀ TRUYỀN HÌNH CÁP",838000,899000,61000,7
TIKI,dien-tu-dien-lanh,190558404,"Máy sấy Electrolux 8kg EDH804H5WB - Chỉ giao Hà Nội",17190000,17190000,0,0
TIKI,dien-tu-dien-lanh,126702292,"Điều khiển điều hòa dành cho Panasonic dùng cho CU/CS- 9000BTU 12000BTU 18000BTU 1 chiều 2 chiều Inverter",63000,63000,0,0
TIKI,dien-tu-dien-lanh,71149573,"Máy rửa bát Fujishan FJVN08-S07F (8 Bộ) - Hàng Chính Hãng",8470000,8470000,0,0
TIKI,dien-tu-dien-lanh,166449087,"Máy Rửa Chén Độc Lập Bosch HMH.SMS4HCI48E (Series 4) - 14 Bộ - 6 Chương Trình Rửa - Hàng Chính Hãng ",18000000,18000000,0,0
TIKI,dien-tu-dien-lanh,77030914,"Điều khiển dành cho tivi sony tìm kiếm giọng nói",191000,191000,0,0
TIKI,dien-tu-dien-lanh,54619922,"Điều khiển chính hãng Quạt cây Panasonic Model F-409KNBAKBV",189000,189000,0,0
TIKI,dien-tu-dien-lanh,195912918,"Máy sấy quần áo Electrolux 8.5 kg EDS854J3WB Trắng - Hàng chính hãng [Giao HCM/HN]",10930000,12990000,2060000,16
TIKI,dien-tu-dien-lanh,32920491,"Máy Giặt Cửa Trước Inverter Electrolux EWF8024ADSA (8kg) - Hàng Chính Hãng",9500000,9500000,0,0
TIKI,dien-tu-dien-lanh,126702066,"Remote Điều khiển từ xa tivi dành cho Samsung các dòng Tivi UA32 UA40 UA43 UA 49 UA50 UA55 QA65 4K Smart QLED ",60800,64000,3200,5
TIKI,dien-tu-dien-lanh,20240139,"Điều khiển dành cho tivi Sony smart RMT - TZ120E",35000,35000,0,0
TIKI,dien-tu-dien-lanh,173796960,"TỦ LẠNH INVERTER CASPER 462L RM-520VT - hàng chính hãng ( Chỉ giao HCM )",15406000,15406000,0,0
TIKI,giay-dep-nu,31808202,"Combo xi đánh giày Kangaroo Hàn Quốc + Bàn chải đánh giày cán gỗ",69000,69000,0,0
TIKI,giay-dep-nu,97104498,"Giày búp bê đế xuồng 5cm,️ ️️ ️ giày Doris da thật mũi nhọn trơn màu kem, thời trang cho nữ DR504",364000,364000,0,0
TIKI,giay-dep-nu,89894196,"Dép xỏ ngón nữ loại cao cấp, xăng đan xỏ ngón nữ Hàn Quốc, sandal nữ chất liệu da cao cấp, sang chảnh sịn sò, dễ phối đồ",268000,268000,0,0
TIKI,giay-dep-nu,35717490,"Combo 2 cặp gồm 4 miếng dán gót giày vừa chống trầy chân vừa chống tuột gót",34996,34996,0,0
TIKI,giay-dep-nu,188410416,"Dép quai kẹp Bitis nữ đế 5cm",245000,245000,0,0
TIKI,giay-dep-nu,104792742,"Dép nhựa xỏ ngón Thái Lan  6",105000,105000,0,0
TIKI,giay-dep-nu,196888507,"Dép Quai Ngang Nam Nữ- Dép Đế Bánh Mì Êm Chân",30000,30000,0,0
TIKI,giay-dep-nu,250104261,"Giày Cao Gót Nữ Công Sở Da Bò Thật BIGGBEN GCG9",319000,450000,131000,29
TIKI,giay-dep-nu,109883620,"Sandal Đế Bánh Mì Thời Trang Nữ Tính Kiểu Dáng Hàn Quốc Cao Cấp 21303",177800,299800,122000,41
TIKI,giay-dep-nu,7945326,"Dép lông đi trong nhà đính nơ S053",149000,159000,10000,6
TIKI,giay-dep-nu,96847138,"Miếng lót silicon chống nứt gót chân, tất bảo vệ gót chân",19000,19000,0,0
TIKI,giay-dep-nu,50405052,"2 Miếng độn giầy 5 tầng trong suốt tăng chiều cao (PKG14)",35000,35000,0,0
TIKI,giay-dep-nu,168092875,"Giày lười nữ muca siêu mềm",189860,189860,0,0
TIKI,giay-dep-nu,59208547,"Giày Sandal Cao Gót BIGGBEN Da Bò Thật Cao 4 Phân SDCG52",329000,400000,71000,18
TIKI,giay-dep-nu,13625026,"Miếng bảo vệ gót chân silicon (Màu Trắng)",17500,17500,0,0
TIKI,giay-dep-nu,189192881,"Dép nữ đế trấu da bò thật thiết kế 2 khóa cao cấp Detaunisex - DEBO21",395000,395000,0,0
TIKI,giay-dep-nu,175175330,"Guốc gỗ nữ nam guốc mộc truyền thống siêu đẹp",85000,85000,0,0
TIKI,giay-dep-nu,161393060,"Xịt Khử GIày Mùi Mồ Hôi Chân Mùi Tủ Giày Hương Dịu Nhẹ",12000,31000,19000,61
TIKI,giay-dep-nu,132075308,"Dép Bông Đi Trong Nhà Hình Thú Đáng Yêu",115000,115000,0,0
TIKI,giay-dep-nu,109775011,"[CHẤT LƯỢNG_LÂU MÒN] Dép lông đi trong nhà quai ngang Kitty SC001 dẻo mềm êm chân  CÓ SIZE CHO MẸ VÀ BÉ",136000,145000,9000,6
TIKI,giay-dep-nu,50480487,"Giầy nhựa thời trang đi mưa GN09 tặng vòng chỉ đỏ hạt đào may mắn",59000,59000,0,0
TIKI,giay-dep-nu,152730112,"DÉP LÔNG ĐI TRONG NHÀ LOẠI CỰC ĐẸP ẢNH THẬT",85000,85000,0,0
TIKI,giay-dep-nu,153579477,"Miếng tất vớ độn lót giày tăng chiều cao silicon cho nam nữ 3.5 cm êm chân chống trượt - 1 Cặp",49000,49000,0,0
TIKI,giay-dep-nu,55409944,"Dép nữ quai ngang 2 quai da bò đế đúc cao cấp Trường Hải QNN0157",202000,239000,37000,15
TIKI,giay-dep-nu,155381602,"Dây giày thông minh không cần buộc Sans945 co giãn bản dẹt cho giày thể thao sneaker nam nữ nhiều màu trắng đen xanh xám",59999,59999,0,0
TIKI,giay-dep-nu,886684,"Lót Giày Tăng Chiều Cao 2 Lớp Không Khí Nguyên Bàn Winwinshop88 (5 cm) - Đen",39398,39398,0,0
TIKI,giay-dep-nu,84650646,"Dép #SLine đi trong nhà tắm chống trơn trượt Hàn Quốc - 8809007760632",77420,79000,1580,2
TIKI,giay-dep-nu,61278528,"Giày thể thao nữ hoa cúc đi bộ cực êm siêu xinh V253 - Đen - Size 36",55000,55000,0,0
TIKI,giay-dep-nu,100084336,"[Combo 2] Chai Xịt Khử Mùi Giày Dép Nano Bạc Nano Xclean 50ml Hương Bạc Hà - Khử Mùi hôi giày, khử mùi hôi chân",72600,121000,48400,40
TIKI,giay-dep-nu,107801477,"Cặp Lót Mũi Giày XIMO XLGCGC11 Hỗ Trợ Giày Búp Bê Êm Chân, Thoáng Khí",12000,21600,9600,44
TIKI,dien-tu-dien-lanh,213741550,"Máy sấy thông hơi Electrolux 7.5kg UltimateCare 300 - EDV754H3WB [Hàng chính hãng]",9550000,9990000,440000,4
TIKI,giay-dep-nu,176543836,"Sandal đế xuồng nữ xinh xắn",129500,129500,0,0
TIKI,giay-dep-nu,166495190,"Dép nhựa nữ Quai ngang Thái Lan 11",110000,110000,0,0
TIKI,dien-tu-dien-lanh,93289795,"REMOTE ĐIỀU KHIỂN DÀNH CHO MÁY LẠNH ĐIỀU HOÀ TOSHIBA (Trắng nhỏ)",51000,51000,0,0
TIKI,dien-tu-dien-lanh,33075647,"Remote Điều Khiển Cho TV LED, Smart TV, Ti Vi Thông Minh TCL",23000,23000,0,0
TIKI,giay-dep-nu,187381009,"Giày Cao Gót Gót Vuông (DA THẬT) Da Mềm Như Bún Lót Êm Chân - 677 Màu Đen Be Trắng Sữa FFAN STORE",460000,460000,0,0
TIKI,dien-tu-dien-lanh,111696380,"Khung Treo Tivi 43 - 65 Inch áp tường CP cho tv LCD-LED-PLASMA Cao Cấp - Hàng Chính Hãng",127000,127000,0,0
TIKI,dien-tu-dien-lanh,270141414,"Google Tivi 75'' 4K HDR Dolby Audio - 75T66 - Tivi Giá Rẻ Chất Lượng - OK Google - Điều khiển giọng nói - Hàng chính hãng",17295000,18990000,1695000,9
TIKI,dien-tu-dien-lanh,54349904,"Chuột bay tích hơp điều khiển giọng nói có đèn LED, điều khiển chuột bay, có phím số, chuyên dùng cho Android box ILEPO MT1",206700,206700,0,0
TIKI,giay-dep-nu,146260183,"Dép nữ Quai ngang Thái Lan MONOBO - MONIGA 7.2",105000,105000,0,0
TIKI,dien-tu-dien-lanh,270976595,"Google Tivi iFFALCON 4K 55inch 55U62 - Hàng chính hãng - Bảo hành 2 năm",7395000,9990000,2595000,26
TIKI,giay-dep-nu,186740384,"Giày Cao Gót Nữ Công Sở Da Bò Thật BIGGBEN GCG10",299000,450000,151000,34
TIKI,dien-tu-dien-lanh,262860015,"Tủ Rượu, Tủ Mát - Tủ Uớp, Bảo Quản Rượu Vang WCS24 (Tủ Đựng Rượu Vang 24Chai). Hàng Nhập Khẩu Chính Hãng Thái Lan",5800000,9880000,4080000,41
TIKI,dien-tu-dien-lanh,251889890,"TCL Mini LED All-Round TV - Tivi 75 inch - TCL 75C845 - Google TV - Hàng chính hãng",44295000,47990000,3695000,8
TIKI,giay-dep-nu,96927605,"Dép bò sữa phong cách Hàn cực đáng yêu, thiết kế thời trang, sang trọng,chắc chắn, dễ kết hợp với các trang phục khác ",70000,70000,0,0
TIKI,dien-tu-dien-lanh,142851720,"Mạch điều khiển quạt từ xa dành cho các loại quạt,Bộ mạch điều khiển từ xa cho quạt - Bả",39800,39800,0,0
TIKI,dien-tu-dien-lanh,55515177,"Tủ Lạnh Toshiba Inverter 511 Lít GR-RF610WE-PMV(37)-SG - Hàng chính hãng",17080000,28990000,11910000,41
TIKI,giay-dep-nu,20934077,"Dép nữ bít mũi thời trang T261KG735",49000,49000,0,0
TIKI,dien-tu-dien-lanh,192387731,"[Sản phẩm mới nhất 2022] GOOGLE Tivi 55'' 4K HDR - 55T66 - Gam Màu Rộng Dolby Audio - Tivi Giá Rẻ Chất Lượng - Bảo Hành 2 Năm - Hàng chính hãng",8095000,14490000,6395000,44
TIKI,dien-tu-dien-lanh,249387964,"[SẢN PHẨM MỚI 2023 - Hàng chính hãng] QLED TV 4K UHD - Tivi 75 inch - TCL 75C645 - Google TV - OK Google - tivi 75 inch chât lượng",24295000,29290000,4995000,17
TIKI,dien-tu-dien-lanh,4374799,"Giá Treo Tivi Góc Xoay Nhập Khẩu North Bayou P4 (32-55inch) ",195000,195000,0,0
TIKI,dien-tu-dien-lanh,11230151,"Điều khiển điều hòa đa năng 1000 in 1",29900,29900,0,0
TIKI,dien-tu-dien-lanh,97823773,"Remote Điều Khiển TV Giọng Nói Dành Cho SAMSUNG Smart Tivi 4K, QLED - Grade A",191000,191000,0,0
TIKI,dien-tu-dien-lanh,213771896,"Máy sấy thông hơi Electrolux 8.5kg UltimateCare 300 - EDV854N3SB - Lồng giặt chuyển động luân phiên, giảm nhăn, giảm phai màu, tính năng khóa trẻ em [Hàng chính hãng]",11590000,11990000,400000,3
TIKI,giay-dep-nu,68855100,"Dép đi nhà tắm, trong nhà chống trơn 2020 cả nam và nữ PVC ASIFN",99000,159000,60000,38
TIKI,dien-tu-dien-lanh,110791834,"Giá Treo Màn Hình Máy Tính North Bayou F80 Lắp Cho Màn Hình LCD 17 inch - 30 inch Hàng Nhập Khẩu",334000,334000,0,0
TIKI,dien-tu-dien-lanh,249383861,"[SẢN PHẨM MỚI 2023- Hàng chính hãng] QLED TV 4K UHD - Tivi 50'' - TCL 50C645 - Tivi 50 inch - Tivi cao cấp",11795000,12990000,1195000,9
TIKI,dien-tu-dien-lanh,91272439,"Giá Treo TiVi Di Động North Bayou AVA1500 Màu Đen Lắp Cho Màn Hình 32 inch - 70 inch Nhập Khẩu",988000,988000,0,0
TIKI,dien-tu-dien-lanh,213741091,"[Miễn phí lắp đặt] Máy sấy thông hơi Electrolux 8.5kg UltimateCare 300 - EDV854J3WB - Lồng giặt chuyển động luân phiên, giảm nhăn, giảm phai màu [ Hàng chính hãng]",11090000,11490000,400000,3
TIKI,dien-tu-dien-lanh,49291897,"Chân đế TV LCD 32-75 inch, chân đế TV để bàn cho tất cả các loại tivi Samsung, LG, Sony, TCL, Panasonic, Sharp, vv - Hàng Nhập Khẩu",141000,141000,0,0
TIKI,dien-tu-dien-lanh,216866986,"Remote Đa Năng Điều Khiển Máy Lạnh Panasonic Điều Hòa Không Khí Kèm Pin",54000,54000,0,0
TIKI,giay-dep-nu,35216360,"Chai Xịt Chăm Sóc Giày Sneaker - Vệ sinh tạo bọt, chống thấm và khử mùi",48000,48000,0,0
TIKI,dien-tu-dien-lanh,249384538,"[SẢN PHẨM MỚI 2023 - Hàng chính hãng] QLED TV 4K UHD - Tivi 55'' - TCL 55C645 - Tivi 55 inch - Tivi cao cấp",12495000,14990000,2495000,17
TIKI,dien-tu-dien-lanh,192377628,"GOOGLE Tivi 43'' 4K HDR - TCL 43T66 - Gam Màu Rộng Dolby Audio - Tivi Giá Rẻ Chất Lượng -Hàng chính hãng",6495000,10490000,3995000,38
TIKI,dien-tu-dien-lanh,112055567,"Remote Điều Khiển Giọng Nói Smart TV, Tivi Thông Minh Dành Cho SONY BRAVIA",162000,162000,0,0
TIKI,dien-tu-dien-lanh,34862764,"Remote Điều Khiển Dành Cho Máy Lạnh, Điều Hòa Toshiba Inverter RAS-H10G2KCV, RAS- H10PKCVG",46000,46000,0,0
TIKI,dien-tu-dien-lanh,126702028,"Remote Điều khiển Tivi dành cho Sony RMT-TX300P",22000,22000,0,0
TIKI,dien-tu-dien-lanh,119194548,"Remote dành cho máy lạnh Panasonic",55000,55000,0,0
TIKI,dien-tu-dien-lanh,144121288,"Khung treo tivi NGHIÊNG CP - Hàng chính hãng",115000,115000,0,0
TIKI,dien-tu-dien-lanh,6498249,"Túi vệ sinh máy lạnh RO _ túi bảo dưỡng điều hòa RO _ áo trùm vệ sinh máy lạnh RO _ RO05",99000,99000,0,0
TIKI,dien-tu-dien-lanh,249380991,"[SẢN PHẨM MỚI 2023 - Hàng chính hãng] QLED TV 4K UHD - Tivi 43''- TCL 43C645 - Tivi 43 inch - Tivi cao cấp",8995000,10990000,1995000,18
TIKI,dien-tu-dien-lanh,15672319,"Giá Treo 2 Màn Hình Để Bàn F160 (17-27 inch) - Hàng Nhập Khẩu",528000,528000,0,0
TIKI,dien-tu-dien-lanh,16069502,"Giá Treo Tivi Di Động AVA1500",1040000,1040000,0,0
TIKI,dien-tu-dien-lanh,167558939,"Tấm Chắn Gió Điều Hòa - Hàng Chính Hãng -  Tản Nhiệt Máy Lạnh - Xoay 180 Độ , Thiết Kế Lỗ Thông Gió Nhỏ",139000,200000,61000,31
TIKI,dien-tu-dien-lanh,3218533,"Túi vệ sinh máy lạnh TD01, Áo vệ sinh máy lạnh tại nhà",99000,99000,0,0
TIKI,dien-tu-dien-lanh,109111691,"GIÁ TREO TIVI DI ĐỘNG 32-75 INCH,HÀNG NHƯ HÌNH",749000,749000,0,0
TIKI,dien-tu-dien-lanh,119194341,"Remote Điều khiển dành cho tivi led Samsung Smart UHD",24000,24000,0,0
TIKI,dien-tu-dien-lanh,43951419,"Điều khiển dùng cho điều hòa Daikin 1 chiều đời cũ",47000,47000,0,0
TIKI,giay-dep-nu,173969596,"Giày lười nữ L992",300000,300000,0,0
TIKI,dien-tu-dien-lanh,161956445,"Máy sấy Electrolux EDV754H3WB 7.5 Kg-hàng chính hãng- Giao tại HN",7890000,7890000,0,0
TIKI,dien-tu-dien-lanh,12441864,"Anten tàu bay DVB T2 model TB105 KD 2 mét",189000,189000,0,0
TIKI,dien-tu-dien-lanh,58962575,"Bình xịt vệ sinh điều hòa/máy lạnh & các loại quạt thông gió Hàn Quốc Sandokkaebi - 330ml",85000,85000,0,0
TIKI,dien-tu-dien-lanh,123548101,"Giá Treo Máy Tính Hai Màn Hình NB H180 22-32 Inch -Hàng Chính hãng ",586000,586000,0,0
TIKI,dien-tu-dien-lanh,153027455,"Chân Đế Máy Giặt Chống Rung Lắc Cao Cấp ( Dùng Cho Mọi Loại Máy Giặt )",19000,19000,0,0
TIKI,dien-tu-dien-lanh,118537278,"Smart Tivi Coocaa HD 32 inch 32S3U",4990000,4990000,0,0
TIKI,dien-tu-dien-lanh,270772189,"Máy lạnh TCL Inverter 1 HP TAC-10CSD/XAB1I - Hàng chính hãng - Bảo hành 3 năm",7295000,8290000,995000,12
TIKI,dien-tu-dien-lanh,23171265,"Điều khiển điều hòa panasonic CS 2 Chiều",42000,42000,0,0
TIKI,dien-tu-dien-lanh,192384593,"[Sản phẩm mới nhất 2022] GOOGLE Tivi 50'' 4K HDR - 50T66 - Gam Màu Rộng Dolby Audio - Tivi Giá Rẻ Chất Lượng - Bảo Hành 2 Năm - Hàng chính hãng",7295000,12490000,5195000,42
TIKI,dien-tu-dien-lanh,49989931,"Giá tivi treo tường 40-65 inch",88000,88000,0,0
TIKI,dien-tu-dien-lanh,109190689,"DÂY CUROA 7PH 1930 MÁY SẤY ELECTROLUX - HÀNG CHÍNH HÃNG",135000,135000,0,0
TIKI,dien-tu-dien-lanh,35546717,"Tấm chắn gió máy điều hòa âm trần trong suốt ",292000,292000,0,0
TIKI,dien-tu-dien-lanh,48583111,"BẢO VỆ TỦ LẠNH, THIẾT BỊ LẠNH VỚI STANDA BẢO VỆ AN TOÀN TUYỆT ĐỐI ",122000,122000,0,0
TIKI,dien-tu-dien-lanh,58086409,"Tấm Chăn Gió Điều Hòa, Máy Lạnh, Có Lỗ Nhỏ Tản Nhiệt Lạnh Đều Phòng Xoay 180 Độ",93099,97999,4900,5
TIKI,dien-tu-dien-lanh,94306609,"Khung viền The Frame Samsung VG-SCFA50 (màu ngẫu nhiên) - dành cho Tivi khung tranh 50 inch model QA50LS03B hoặc QA50LS03A - Hàng chính hãng",1450000,1450000,0,0
TIKI,dien-tu-dien-lanh,112636044,"Chân máy giặt tủ lạnh inox CP dùng cho Tủ lạnh và máy giặt cửa đứng",218000,218000,0,0
TIKI,dien-tu-dien-lanh,270772189,"Máy lạnh TCL Inverter 1 HP TAC-10CSD/XAB1I - Hàng chính hãng - Bảo hành 3 năm",7295000,8290000,995000,12
TIKI,dien-tu-dien-lanh,213741550,"Máy sấy thông hơi Electrolux 7.5kg UltimateCare 300 - EDV754H3WB [Hàng chính hãng]",9550000,9990000,440000,4
TIKI,dien-tu-dien-lanh,213771896,"Máy sấy thông hơi Electrolux 8.5kg UltimateCare 300 - EDV854N3SB - Lồng giặt chuyển động luân phiên, giảm nhăn, giảm phai màu, tính năng khóa trẻ em [Hàng chính hãng]",11590000,11990000,400000,3
TIKI,dien-tu-dien-lanh,262860015,"Tủ Rượu, Tủ Mát - Tủ Uớp, Bảo Quản Rượu Vang WCS24 (Tủ Đựng Rượu Vang 24Chai). Hàng Nhập Khẩu Chính Hãng Thái Lan",5800000,9880000,4080000,41
TIKI,dien-tu-dien-lanh,33233321,"Điều Khiển TiVi, Remote Cho Ti Vi SamSung",24000,24000,0,0
TIKI,dien-tu-dien-lanh,161393485,"Moter quạt B4 3HT - HÀNG CHÍNH HÃNG 3HT",109000,109000,0,0
TIKI,dien-tu-dien-lanh,29601707,"Remote Điều Khiển Dùng Cho Máy Lạnh, Điều Hòa DAIKIN FTNE25MV1V9, FTE35LV1V, ARC423A5, ARC423A6",43400,43400,0,0
TIKI,dien-tu-dien-lanh,213741091,"[Miễn phí lắp đặt] Máy sấy thông hơi Electrolux 8.5kg UltimateCare 300 - EDV854J3WB - Lồng giặt chuyển động luân phiên, giảm nhăn, giảm phai màu [ Hàng chính hãng]",11090000,11490000,400000,3
TIKI,dien-tu-dien-lanh,249387964,"[SẢN PHẨM MỚI 2023 - Hàng chính hãng] QLED TV 4K UHD - Tivi 75 inch - TCL 75C645 - Google TV - OK Google - tivi 75 inch chât lượng",24295000,29290000,4995000,17
TIKI,dien-tu-dien-lanh,192384593,"[Sản phẩm mới nhất 2022] GOOGLE Tivi 50'' 4K HDR - 50T66 - Gam Màu Rộng Dolby Audio - Tivi Giá Rẻ Chất Lượng - Bảo Hành 2 Năm - Hàng chính hãng",7295000,12490000,5195000,42
TIKI,dien-tu-dien-lanh,96347307,"Bộ vỉ mạch quạt điều khiển từ xa cho quạt có kèm remote 2020 BẢN TIẾNG VIỆT",35000,35000,0,0
TIKI,dien-tu-dien-lanh,169271401,"Máy sấy thông hơi Electrolux 8.5 kg EDV854J3WB-Hàng Chính Hãng ",8990000,8990000,0,0
TIKI,dien-tu-dien-lanh,192387731,"[Sản phẩm mới nhất 2022] GOOGLE Tivi 55'' 4K HDR - 55T66 - Gam Màu Rộng Dolby Audio - Tivi Giá Rẻ Chất Lượng - Bảo Hành 2 Năm - Hàng chính hãng",8095000,14490000,6395000,44
TIKI,dien-tu-dien-lanh,54620003,"Điều khiển Quạt cây Panasonic Model F-409KBVH - Hàng chính hãng ",189000,189000,0,0
TIKI,dien-tu-dien-lanh,51518382,"Remote Điều Khiển Cho Đầu Thu TV FPT, Truyền Hình Internet FPT (Kèm Pin AAA Maxell)",27000,27000,0,0
TIKI,dien-tu-dien-lanh,270141414,"Google Tivi 75'' 4K HDR Dolby Audio - 75T66 - Tivi Giá Rẻ Chất Lượng - OK Google - Điều khiển giọng nói - Hàng chính hãng",17295000,18990000,1695000,9
TIKI,dien-tu-dien-lanh,192377628,"GOOGLE Tivi 43'' 4K HDR - TCL 43T66 - Gam Màu Rộng Dolby Audio - Tivi Giá Rẻ Chất Lượng -Hàng chính hãng",6495000,10490000,3995000,38
TIKI,giay-dep-nu,153021127,"Dép nữ cao gót sandal quai ngang 2 phân hàng hiệu rosata hai màu đen kem ro381",399000,399000,0,0
TIKI,dien-tu-dien-lanh,74385527,"Thiết bị biến điện 12v ra 220V 40W",95000,95000,0,0
TIKI,dien-tu-dien-lanh,270976595,"Google Tivi iFFALCON 4K 55inch 55U62 - Hàng chính hãng - Bảo hành 2 năm",7395000,9990000,2595000,26
TIKI,dien-tu-dien-lanh,216402685,"Remote Điều Khiển TV Dành Cho SONY Nhận Giọng Nói Internet Smart Tivi BRAVIA",164000,164000,0,0
TIKI,dien-tu-dien-lanh,249258555,"Remote Điều Khiển Dành Cho Tivi LED Samsung Smart TV UHD",35000,35000,0,0
TIKI,giay-dep-nam,68082426,"Dép quai hậu nam da bò thật phong cách thời trang đế mềm kiểu dáng mới nhất phiên bản Hàn Quốc mã 692",359000,499000,140000,28
TIKI,giay-dep-nu,127379674,"Gel Tẩy Ố Đế Giày Và Các Chi Tiết Cao Su Chuyên Dụng 100ml Dincox X Matteo Chính Hãng",60000,60000,0,0
TIKI,dien-tu-dien-lanh,249383861,"[SẢN PHẨM MỚI 2023- Hàng chính hãng] QLED TV 4K UHD - Tivi 50'' - TCL 50C645 - Tivi 50 inch - Tivi cao cấp",11795000,12990000,1195000,9
TIKI,dien-tu-dien-lanh,196049994,"Google Tivi Coocaa HD 40 Inch - 40Z72 Youtube Netfilx Smart TV 2022 new tv - Hàng Chính Hãng",4090000,7990000,3900000,49
TIKI,dien-tu-dien-lanh,73829670,"Remote Điều Khiển Dành Cho Smart TV LG, Internet Tivi, Ti Vi Thông Minh LG AKB75095315",22500,22500,0,0
TIKI,dien-tu-dien-lanh,102683224,"Giá Treo TiVi Di Động AVA1500 Màu Đen Lắp Cho Màn Hình 32 inch - 70 inch Hàng Nhập Khẩu",990000,990000,0,0
TIKI,giay-dep-nam,214160075,"Giày thể thao nam Warrior, giày sneaker nam warrior. Mã W02",420000,420000,0,0
TIKI,giay-dep-nam,186909966,"giày da nam công sở không dây lịch lãm 2022",160000,160000,0,0
TIKI,dien-tu-dien-lanh,251889890,"TCL Mini LED All-Round TV - Tivi 75 inch - TCL 75C845 - Google TV - Hàng chính hãng",44295000,47990000,3695000,8
TIKI,dien-tu-dien-lanh,126702092,"Điều khiển quạt a dùng cho các dòng quạt dành cho Asia L16006, L16012, D16013, D16009, X16002",75000,75000,0,0
TIKI,dien-tu-dien-lanh,13743101,"Kệ chân đế máy giặt tủ lạnh inox cao cấp 55x77cm INOX dày 1mm",99000,99000,0,0
TIKI,dien-tu-dien-lanh,32414731,"Remote Điều Khiển Cho TV LCD, TV LED, TV 3D SONY RM-ED054",33000,33000,0,0
TIKI,giay-dep-nam,186907224,"Giày Lười Nam Dập Vân | SALE SIÊU RẺ | Giày được in vân nổi đính chuông kim loại",160000,160000,0,0
TIKI,dien-tu-dien-lanh,155113398,"khung treo tivi Led cố định 26-60INCH HOÀNG THỊNH ,HÀNG CHÍNH HÃNG",45000,45000,0,0
TIKI,giay-dep-nu,109227966,"Lót mũi giày silicon cao gót chống rộng cho các bạn nữ công sở - LG01",23000,23000,0,0
TIKI,giay-dep-nu,15164012,"Bộ 3 Đôi Vớ Silicon Bảo Vệ Chống Nứt Gót Chân (Màu Be)",45000,62500,17500,28
TIKI,giay-dep-nam,129944449,"Giày Sneaker Unisex Vans Era Classic Black / White - VN000EWZBLK",1450000,1450000,0,0
TIKI,giay-dep-nu,195464913,"Set 6 miếng độn giày, lót đế giày nguyên bàn,có đệm khí siêu êm ái, điều chỉnh theo size chân tăng chiều cao #lot42",95000,95000,0,0
TIKI,giay-dep-nam,115768030,"Giày Lười Nam Đơn Giản Da LÌ - Mã L192",199000,199000,0,0
TIKI,giay-dep-nam,153520013,"Dép chiếu đi trong nhà Hương Quế DCQ-53 thích hợp mang trong nhà, trong văn phòng",68000,68000,0,0
TIKI,dien-tu-dien-lanh,85546433,"Kệ Tivi Cố Định Tím Treo Tường 32 - 42 inch",48000,48000,0,0
TIKI,giay-dep-nam,52104902,"Dép Nam BIGGBEN Da Bò Thật Cao Cấp DN228",339000,360000,21000,6
TIKI,giay-dep-nam,84936293,"Giày thể thao sneaker nam đế nhẹ vải sợi dệt cao cấp mạnh mẽ nam tính G181",129000,245000,116000,47
TIKI,dien-tu-dien-lanh,52780228,"Tủ lạnh Samsung Inverter 208 lít RT20HAR8DBU/SV - HÀNG CHÍNH HÃNG",5620000,8290000,2670000,32
TIKI,giay-dep-nu,76103677,"Giày Búp Bê Đế Xuồng Da Thật 3cm Mũi Nhọn Gắn Nơ Pixie X619",420000,420000,0,0
TIKI,giay-dep-nu,6187099,"Dép Cao Gót Nữ BIGGBEN Da Bò Thật DCG02",349000,400000,51000,13
TIKI,giay-dep-nu,33427965,"Chai tẩy giày luôn giữ cho những đôi giày sáng đẹp",6000,9899,3899,39
TIKI,giay-dep-nu,81132360,"Dép đi trong nhà - nachidu – MT5  ( Xanh dương ).",89000,89000,0,0
TIKI,dien-tu-dien-lanh,113048561,"Điều khiển điều hòa 1 chiều Daikin - Hàng Chính Hãng",57000,57000,0,0
TIKI,giay-dep-nam,23017650,"Giày Mọi Nam BiGGBEN Da Bò Thật Cao Cấp GM170",599000,700000,101000,14
TIKI,dien-tu-dien-lanh,53245166,"Tủ lạnh Funiki Hòa Phát FR 135CD 130 lít - Hàng Chính Hãng",3289000,3289000,0,0
TIKI,giay-dep-nu,119620675,"Dép chiếu cói quai nhung siêu mát",40000,40000,0,0
TIKI,giay-dep-nu,73244757,"Dép Bông Đi Trong Nhà Cho Nữ Hình Trái Cây Dễ Thương",93000,99000,6000,6
TIKI,giay-dep-nam,7412173,"Hộp Khăn Ướt Vệ Sinh Giày Crep Protect Wipes (12 miếng/190g)",320000,320000,0,0
TIKI,giay-dep-nu,150735516,"Dép chiếu Hương Quế DCQ-38 có lớp chiếu tỏa ra hơi ấm, hương thơm nhẹ giúp kích thích các huyệt đạo trong lòng bàn chân",68000,68000,0,0
TIKI,giay-dep-nam,7976948,"Giày Mọi Nam Da Bò Sunpolo SU011N",990000,990000,0,0
TIKI,giay-dep-nam,37947523,"Giày Tây Đông Hải - Gkx0061",1190000,1190000,0,0
TIKI,giay-dep-nu,55027892,"Dép Xỏ Ngón Nữ Da Bò BIGGBEN Cao Cấp DXN30",199000,350000,151000,43
TIKI,giay-dep-nu,121742453,"Dép massage chân khảm đá- Dép đi trong nhà nam, nữ- Hàng nhập khẩu cao câp, hàng có sẵn, ảnh thật",189000,189000,0,0
TIKI,giay-dep-nu,186884426,"Dép vải mang đi trong nhà vệ sinh, phòng tắm, văn phòng, biển, spa, khách sạn, mùa đông đế cao su dày chống trơn CR",45000,45000,0,0
TIKI,dien-tu-dien-lanh,107368771,"Chuột bay Airmouse có điều khiển bằng giọng nói KM900 HN chuyên dụng cho Android TV Box, Smart TV, PC Laptop",134200,134200,0,0
TIKI,giay-dep-nam,179882264,"Giày Rọ Nam Da Bò Thời Trang HÀ NAM Cao Cấp GSB20107c",720000,720000,0,0
TIKI,dien-tu-dien-lanh,137859886,"Giá treo tivi 43-50 inch, 32-42 inch",97000,97000,0,0
TIKI,giay-dep-nu,195667767,"Dép Lông Cho Nam Nữ Đi Trong Nhà, Văn Phòng Cao Cấp Hình Gấu D68",89000,89000,0,0
TIKI,dien-tu-dien-lanh,123548222,"Giá treo màn hình máy tính F80 - Xoay 360 độ",315000,315000,0,0
TIKI,dien-tu-dien-lanh,249384538,"[SẢN PHẨM MỚI 2023 - Hàng chính hãng] QLED TV 4K UHD - Tivi 55'' - TCL 55C645 - Tivi 55 inch - Tivi cao cấp",12495000,14990000,2495000,17
TIKI,dien-tu-dien-lanh,9381544,"Giá treo 2 màn hình máy tính nhập khẩu F160 cho 17 - 27inch",558000,558000,0,0
TIKI,dien-tu-dien-lanh,123547771,"Khung giá treo tivi di động AVA1500 hàng chính hãng model mới từ 32 - 65inch",958000,958000,0,0
TIKI,giay-dep-nu,60165289,"Giày nhựa hoa đi mưa hot hit",95000,95000,0,0
TIKI,giay-dep-nu,226072482,"Giày Cao Gót Trơn Lì 7 Phân H8210-20",390000,390000,0,0
TIKI,giay-dep-nu,164590337,"Giày sục nữ đế xuồng 5cm da bò Trường Hải màu hồng phấn  da mềm mại không bong tróc SN136",239000,299000,60000,20
TIKI,giay-dep-nam,85380226,"Giày Mọi Nam Da Bò BIGGBEN Cao Cấp GM248",599000,700000,101000,14
TIKI,giay-dep-nu,195465186,"Cặp gel tách ngón chân bốn lỗ kẹp chân hallux valgus Điều Chỉnh Chứng Vẹo Ngón Chân Chăm Sóc Bàn Chân #sil74",65000,65000,0,0
TIKI,giay-dep-nam,172995945,"Lót đế giày Silicone trong suốt dính chống trượt nửa trước giày 21646a",7000,7000,0,0
TIKI,giay-dep-nu,53775362,"Lót gót giày 4D hình cánh bướm có mặt gai silicone chống trầy rách da và chống tuột gót chân - buybox - BBPK70",25000,50000,25000,50
TIKI,giay-dep-nam,107801680,"Lót Giày Massage Bàn Chân XIMO XLGEC02 Màu Đen Cao Cấp",120000,240000,120000,50
TIKI,giay-dep-nu,7993385,"Dép Nữ BIGGBEN Da Bò Thật Cao Cấp DNQN06",329000,400000,71000,18
TIKI,dien-tu-dien-lanh,97904406,"Máy giặt mini cao cấp- máy giặt quần áo trẻ em 4,5 kg",980000,980000,0,0
TIKI,dien-tu-dien-lanh,174375243,"LƯỚI LỌC BỤI, LỌC RÁC MÁY SẤY ELECTROLUX – HÀNG CHÍNH HÃNG",295000,295000,0,0
TIKI,giay-dep-nam,171124567,"Dép Tông Nam Xỏ Ngón EVABU siêu nhẹ, êm chân, có vân bám chống trơn trượt",90000,99000,9000,9
TIKI,giay-dep-nam,109787817,"Lót đế giày Silicone trong suốt dính chống trượt nửa trước giày 21646a",11100,24000,12900,54
TIKI,dien-tu-dien-lanh,32505959,"Remote điều khiển đa năng - Dùng được cho tất cả các dòng máy lạnh",39000,39000,0,0
TIKI,giay-dep-nu,151460376,"Dây giày thể thao sneaker đủ màu nhiều size dài 100cm 120cm 140cm nam nữ bản tròn trơn cỡ to 5mm shoelaces 1 đôi Sans941",22499,22499,0,0
TIKI,dien-tu-dien-lanh,123547549,"Giá Treo Tivi Xoay Đa Năng P4 Tivi 32 đến 55 inch -",172900,172900,0,0
TIKI,dien-tu-dien-lanh,249380991,"[SẢN PHẨM MỚI 2023 - Hàng chính hãng] QLED TV 4K UHD - Tivi 43''- TCL 43C645 - Tivi 43 inch - Tivi cao cấp",8995000,10990000,1995000,18
TIKI,giay-dep-nam,115769150,"Giày Lười Nam Đang Được Yêu Thích Nhất - Dập Vân Cá Sấu kết hợp Chuông Vàng - Mã L184",199000,199000,0,0
TIKI,giay-dep-nam,111152032,"Giày thể thao nam SSN8 giày cao 4cm đi lại nhẹ nhàng-chất liệu vải thoáng khí-thấm hút tốt( 2 mầu)",94050,99000,4950,5
TIKI,giay-dep-nam,98039734,"Giày Thể Thao Nam Cao Cấp  màu đen G951",161491,169990,8499,5
TIKI,dien-tu-dien-lanh,1376291,"Android Tivi Box MXQ Pro 4K - Hàng Chính Hãng",429000,509000,80000,16
TIKI,dien-tu-dien-lanh,19401965,"GIÁ TREO TIVI DI ĐỘNG AVA1500 - HÀNG CHÍNH HÃNG",1129000,1129000,0,0
TIKI,giay-dep-nam,162058151,"Dép Nam Quai Ngang Cao Cấp KEEDO BH00606 da bò thật",750000,750000,0,0
TIKI,dien-tu-dien-lanh,56910041,"Combo 4 Cao su chống rung cục nóng điều hòa, máy lạnh",45000,45000,0,0
TIKI,giay-dep-nam,157046419,"Dép khách sạn cao cấp Hương Quế có lớp chiếu mềm, tự nhiên tiếp xúc trực tiếp với da bàn chân",70000,70000,0,0
TIKI,giay-dep-nu,184253870,"Bóng Khử Mùi Và Làm Sạch Mùi Cho Giày, Tủ Giày - Hương Trà - Túi 10 Viên",48510,49000,490,1
TIKI,dien-tu-dien-lanh,119821973,"Remote Điều khiển quạt v Asia",85000,85000,0,0
TIKI,dien-tu-dien-lanh,162105434,"Chuyển Hướng Gió Cục Nóng Hàng Dầy Dặn Đủ Kích Thước",135000,135000,0,0
TIKI,giay-dep-nu,100308053,"Giày Búp Bê Nữ Siêu Nhẹ TOMOYO Đen Hạt Trơn TMW20401",699000,699000,0,0
TIKI,giay-dep-nam,91210262,"Giày tây nam công sở da bò BIGGBEN cao cấp GT207",599000,800000,201000,25
TIKI,giay-dep-nu,169771579,"Dép thổ cẩm hoạ tiết voi style vintage - ND011",40000,40000,0,0
TIKI,giay-dep-nu,52251205,"Dép Nữ Đế Xuồng BIGGBEN Da Bò Thật DX23",339000,400000,61000,15
TIKI,giay-dep-nam,193629700,"Giày dép Sandals Vento ALPHA II Teen/Trẻ em màu Xanh da trời đi học/đi dã ngoại/đi chơi SD08002",365000,365000,0,0
TIKI,dien-tu-dien-lanh,98164252,"Remote điều khiển cho quạt Mitsubishi, các loại quạt đứng và treo tường",50900,50900,0,0
TIKI,giay-dep-nu,124275123,"Combo 6 Miếng Đế Lót Độn Giày Silicon Tăng Chiều Cao",39000,42000,3000,7
TIKI,giay-dep-nam,124915998,"Giày Da Nam - Giày Lười Nam Sinh Viên - Đế Cao Su - Đế Khâu - Mã G02 Màu Đen",199000,199000,0,0
TIKI,giay-dep-nu,119330460,"Giày Nữ Búp Bê Đế Xuồng TiTi ĐÔ Da Bò Thật Cao Cấp 4cm GBBN2047a",380000,380000,0,0
TIKI,giay-dep-nam,48319162,"Dép Nam Da Bò BIGGBEN Cao Cấp DN224",339000,400000,61000,15
TIKI,giay-dep-nam,103463862,"Giày Tây Nam Không Dây Chính Hãng Trường Hải Da Bò Thật Cao Cấp  Màu Đen",491000,539000,48000,9
TIKI,giay-dep-nu,172570527,"Dép quai ngang nữ đế xuồng 10F",220000,220000,0,0
TIKI,giay-dep-nam,177165722,"Giày Lười Trẻ Em NATIVE Miles Print Junior - Shell White/ Shell White/ Itty Bitty Blue Scribble - 32.5",1500000,1500000,0,0
TIKI,giay-dep-nam,112641767,"Dép Nam Quai Ngang HÀ NAM Da Bò Thật Cao Cấp DNA2084",360000,360000,0,0
TIKI,giay-dep-nam,117219158,"Giấy Lau giày SNEAKER - Tẩy Trắng giày - Tẩy Mọi Vết Ố Bẩn Trên Giày Dép ( hộp 30 tờ )",34500,34500,0,0
TIKI,giay-dep-nam,3837347,"Combo miếng lót giầy da và dụng cụ đón gót giày inox nội địa Nhật Bản",79500,79500,0,0
TIKI,giay-dep-nam,6622437,"Dép SaBo Nam BIGGBEN Da Bò Thật SB31",379000,500000,121000,24
TIKI,giay-dep-nam,21477660,"Giày Sneaker Kid Converse Chuck Taylor All Star Classic Low - Red",720000,800000,80000,10
TIKI,giay-dep-nu,125099339,"Giày lười nữ Anh Khoa A688-1 chất liệu cực êm, mềm, co giãn đa chiều",250000,250000,0,0
TIKI,giay-dep-nam,19414099,"Dép Nam BIGGBEN Da Bò Thật Cao Cấp DN164",349000,400000,51000,13
TIKI,giay-dep-nam,95213196,"GD380 Xịt khử mùi giầy dép , mũ bảo hiểm , xịt khử khuẩn giày",11000,16999,5999,35
TIKI,giay-dep-nam,156214551,"DÉP QUAI NGANG NAM DA BÒ KHÂU VIỀN BAO CHẮC CHẮN ÊM CHÂN BAO ĐI MƯA",323530,323530,0,0
TIKI,giay-dep-nam,48319992,"Dép Nam Da Bò BIGGBEN Cao Cấp DN226",299000,400000,101000,25
TIKI,giay-dep-nam,74763638,"Giày Lười Nam Da Bò Vân Cá Sấu, Giày Bệt Nam Da Bò, Đế Cao Su Đi Êm Ái, Phong Cách Hiện Đại.",280000,280000,0,0
TIKI,giay-dep-nam,167549377,"Dung dịch làm sạch giày da Renomat Saphir 100ml (XDG05)",365000,550000,185000,34
TIKI,giay-dep-nam,169281460,"Dép sục cross nam yukon sport  màu kaki hàng xịn, full box",380000,380000,0,0
TIKI,giay-dep-nam,153522071,"Dép chiếu văn phòng Hương Quế DCQ-55 bền và hợp thời trang",68000,68000,0,0
TIKI,giay-dep-nam,189172626,"Giày Lười Nam GEOX U Ascanio A",4400000,4400000,0,0
TIKI,giay-dep-nam,165989862,"Giày sandal nam da bò thật BIGGBEN cao cấp SD122",359000,500000,141000,28
TIKI,giay-dep-nam,181467109,"Giày Lười Nam Chất Liệu Vải Bố Cao Cấp",195000,195000,0,0
TIKI,giay-dep-nam,68026620,"Giày thể thao nam, giày nam da siêu mềm K05",159000,159000,0,0
TIKI,dien-tu-dien-lanh,241736479,"Remote Điều Khiển TV Dùng Cho SAMSUNG Tivi LCD LED AA59-00607A",28000,28000,0,0
TIKI,giay-dep-nam,38149518,"Giày Thể Thao Nam Off  White Siêu Êm Phong Cách Hot Hit OF01",110600,110600,0,0
TIKI,giay-dep-nam,115523861,"BẢO HÀNH 1 NĂM Máy Sấy Giày, Máy Làm Khô Giày, Khử Mùi Hôi, Diệt Vi Khuẩn Cho Dày Của Bạn, Siêu Nhanh Khô, Tiện Dụng",185000,185000,0,0
TIKI,giay-dep-nam,48565043,"Dép Sục Nam Đen Phối Đỏ Kèm 6Jibbitz/Sticker",78000,78000,0,0
TIKI,giay-dep-nam,101656265,"Giày Da Nam Giày Tây Nam Công Sở Sans Shop Sans140",199000,199000,0,0
TIKI,giay-dep-nam,78613917,"Dép xỏ ngón nam da bò thật tông nam da bò thật -TONG.167",189000,359000,170000,47
TIKI,dien-tu-dien-lanh,46691906,"Remote Điều Khiển Dành Cho Smart TV LG, Internet TV LG AKB75095307 - Hàng nhập khẩu",40000,40000,0,0
TIKI,dien-tu-dien-lanh,33425754,"Tấm chắn gió máy lạnh âm trần dành cho dân văn phòng",292000,292000,0,0
TIKI,giay-dep-nam,125271484,"Giày Da nam cực chất xả kho giá gốc- giày lười nam-mã l184",210000,210000,0,0
TIKI,giay-dep-nu,48995733,"Dép tổ ong màu vàng",79000,79000,0,0
TIKI,giay-dep-nam,168069397,"Giày thể thao sneaker nam Sans202 đen sọc trắng",169999,169999,0,0
TIKI,giay-dep-nam,66620504,"Giày tây da bò thật nam phong cách quý ông mã 8865 - Đen - 40",299000,499000,200000,40
TIKI,giay-dep-nam,110859727,"Giày lười vải nam thời trang - GN08",105000,105000,0,0
TIKI,giay-dep-nam,171535218,"Dép quai ngang nam nữ M Masler-MT đan mạch xanh lá với lớp đế chống nước và êm chân, quai bền bỉ DML",458000,458000,0,0
TIKI,giay-dep-nu,143217134,"Giày thể thao nữ GT02, đế casu chống trơn trượt, phong cách trẻ",89000,89000,0,0
TIKI,giay-dep-nam,84936275,"Giày thể thao nam sneaker nam đi chơi đi học bao ngầu G180",119000,220000,101000,46
TIKI,giay-dep-nu,126116874,"Giày Đế Trấu Sandal 2 Quai Ngang Khóa Nam Nữ Detaunisex Màu Bò - SATA21B",300000,300000,0,0
TIKI,giay-dep-nu,143829211,"Giày cao gót nữ đế vuông 4 phân hàng hiệu rosata đẹp màu đen ro364",399000,399000,0,0
TIKI,giay-dep-nam,40364987,"Lót giày quế vải cotton CI-03 hút ẩm, khử mùi hôi chân, cải thiện sức khỏe",25000,25000,0,0
TIKI,giay-dep-nam,173443157,"iày Mọi Nam Da Bò Thật-Giày Lười Da Cao Cấp Màu Trắng Kem-M08 Giày SAGO’S Bảo Hành 12 tháng",695000,695000,0,0
TIKI,giay-dep-nam,101291609,"Giày lười nam - Slip on nam vải - Mã A2270X",350000,350000,0,0
TIKI,giay-dep-nu,13384533,"Giày cao gót 5cm đế vuông đen vá bóng THG09",230000,269000,39000,14
TIKI,giay-dep-nam,21979444,"Giày nam Huy Hoàng da bò màu nâu đỏ-HP7112",909000,909000,0,0
TIKI,giay-dep-nu,15893854,"Combo 2 cặp lót mũi giày cao gót đệm êm ngón chân dùng mang giày tây, giày mũi nhọn, giày bít mũi cực êm chân PK38",35000,35000,0,0
TIKI,giay-dep-nam,2597807,"Dép Nam Quai Ngang Da Bò Cao Cấp SUNPOLO SUA15D - Đen (Size",550000,550000,0,0
TIKI,giay-dep-nam,71973540,"Giày cao cổ nam G3a",199000,199000,0,0
TIKI,giay-dep-nam,31135723,"Dép massage chân khảm đá cho nam",169000,169000,0,0
TIKI,giay-dep-nam,81572518,"Giày nam cao cấp giày da bò giày nam da thật giày nam thời trang giày nam kiểu dáng hiện đại mã T36123 tặng một chiếc vòng đeo tay gỗ quý ngẫu nhiên",559000,899000,340000,38
TIKI,giay-dep-nam,6137977,"Dép Da Nam BIGBEN May Đế Da Bò Thật DN39",339000,450000,111000,25
TIKI,giay-dep-nam,197030743,"Boot nam martin Sans104 giầy cao cổ boost vàng đen nâu bigsize to 43 44 45 46 độn đế 6cm big size đẹp hàn quốc cao cấp",349999,349999,0,0
TIKI,giay-dep-nu,101702262,"Sneaker Nữ Soras ️️ Giày thể thao Nữ Thêu Hoa Đào dáng thể thao cực Sang Chảnh, Dễ Phối Đồ Soras SYF9528",300000,300000,0,0
TIKI,giay-dep-nam,194464712,"Giày sneaker nam trắng Sans200 giầy thể thao sneakers fullbox sport fashion basic đẹp năng động trẻ trung hàn quốc",99999,99999,0,0
TIKI,dien-tu-dien-lanh,15972213,"Giá Treo Tivi Máy Tính Để Bàn F80 (17-27 inch) - Hàng nhập khẩu",334000,334000,0,0
TIKI,giay-dep-nam,129734328,"HJ7103-08 - Giày tây nam Huy Hoàng cột dây màu đen, nâu",909000,909000,0,0
TIKI,giay-dep-nam,50242250,"Giày Tây Nam  - Giày Tây Nam Da Bò Thật 100% - Mã BH0222",450000,900000,450000,50
TIKI,giay-dep-nu,179911922,"Lót Giày Thể Thao Khử Mùi Êm Chân Nhiều Màu Đủ Size Sử Dụng Gho Giày Nam Và Nữ LG01",23000,23000,0,0
TIKI,giay-dep-nam,59171675,"Dép Nam Bít Đầu Da Bò BIGGBEN Cao Cấp DN255",429000,550000,121000,22
TIKI,giay-dep-nam,160748263,"Giày tăng chiều cao nam da bò Sans119 độn đế 8cm công sở cao cấp buộc dây tây đen chú rể mặc vest size nhỏ 37 38 mũi tròn",849000,849000,0,0
TIKI,giay-dep-nam,181786281,"Giày vải bảo hộ lao động thấp cổ đế cao su",100000,100000,0,0
TIKI,giay-dep-nam,113639741,"Dép Bít Mũi Nam HÀ NAM Da Bò Thật Cao Cấp GSB2086",390000,390000,0,0
TIKI,giay-dep-nam,17971673,"Hộp 6 đôi lót giày siêu mỏng Woly Pure Fresh - NK Đức",69000,69000,0,0
TIKI,giay-dep-nam,108314683,"Dép cao su 4 quai khe sanh đế dày mài",1550000,1550000,0,0
TIKI,giay-dep-nam,183081577,"Dép xỏ ngón nam da bò thật KEEDO KD2202",280000,280000,0,0
TIKI,giay-dep-nam,196856729,"Giày tây nam Pierre Cardin - PCMFWLG 761",2990000,2990000,0,0
TIKI,giay-dep-nu,133949863,"Giày boot nữ cổ thấp 4 phân hàng hiệu rosata hai màu đen kem ro302",550000,550000,0,0
TIKI,giay-dep-nam,100466271,"Giày lười sục nam da bò mùa hè mềm mại ôm chân chỉ khâu mạnh mẽ nam tính GD16",249000,350000,101000,29
TIKI,dien-tu-dien-lanh,68760491,"Máy nước nóng Ariston SL BLU 20 - 2.5 - FE (2500W)",2379000,2379000,0,0
TIKI,dien-tu-dien-lanh,87180717,"Áo vệ sinh máy lạnh",50000,50000,0,0
TIKI,dien-tu-dien-lanh,123367112,"Thiết bị khuếch đại tín hiệu sóng Anten KTS Mặt Đất DVB-T2 cùng xem World cup không lo gián đoạn đường truyền",68000,68000,0,0
TIKI,dien-tu-dien-lanh,112365089,"Máy giặt lồng ngang Casper 8.5Kg WF-85I140BGB Xuất xứ Thái Lan  -Hàng chính hãng ( Chỉ giao Hà Nội)",5449000,5449000,0,0
TIKI,dien-tu-dien-lanh,110931958,"MOTER ĐẢO ĐIỆN THAY THẾ SENKO- ĐỒNG 100% - HÀNG CHÍNH HÃNG 3HT",179000,179000,0,0
TIKI,dien-tu-dien-lanh,75538697,"ANTEN BÀN AVG ,NGUỒN 5V HÀNG CHÍNH HÃNG ,DÙNG CHO ĐẦU THU KỸ THUẬT SỐ DVB T2,TIVI TÍCH HỢP DVB T2",149000,149000,0,0
TIKI,dien-tu-dien-lanh,119791273,"Remote Điều Khiển Dành Cho Đầu Thu TV Viettel, Truyền Hình Internet Viettel",42750,45000,2250,5
TIKI,dien-tu-dien-lanh,181447376,"FPT Play Box S 2021 (T590) - Kết hợp Tivi Box và Loa thông minh - Điều khiển giọng nói thông minh không chạm - HÀNG CHÍNH HÃNG",1390000,1390000,0,0
TIKI,dien-tu-dien-lanh,57763181,"BỘ THIẾT BỊ K+ TIVI BOX KÈM 3 THÁNG THUÊ BAO- HÀNG CHÍNH HÃNG",690000,690000,0,0
TIKI,dien-tu-dien-lanh,144681292,"Remote điều khiển dành cho tivi Samsung Smart UHD (4K-hàng đẹp)",28000,28000,0,0
TIKI,dien-tu-dien-lanh,48527132,"ĐIỀU KHIỂN DÀNH CHO TIVI SONY",31000,31000,0,0
TIKI,dien-tu-dien-lanh,74909416,"Remote Điều Khiển Dành Cho Smart TV, Tivi Thông Minh SONY RMF-TX200P Nhận Giọng Nói",162000,162000,0,0
TIKI,dien-tu-dien-lanh,183688624,"đầu thu DVB S2 truyền hình vệ tinh AVG , HÀNG CHÍNH HÃNG",900000,900000,0,0
TIKI,dien-tu-dien-lanh,187844324,"Android tivi box MAGICSEE N5 MAX X4 Ram 4G Android 11, S905X4, wifi 2 băng tần, bluetooth cài sẵn phim HD, truyền hình cáp miễn phí vĩnh viễn - Hàng nhập khẩu",1519050,1599000,79950,5
TIKI,dien-tu-dien-lanh,16876822,"Điều khiển dùng cho điều hòa Panasonic Inverter 2 chiều",42700,42700,0,0
TIKI,dien-tu-dien-lanh,41219182,"Remote Điều Khiển Điều Hòa Đa Năng - Dễ Sử Dụng - Thích Hợp Với Tất Cả  Các Loại Máy Lạnh",32000,32000,0,0
TIKI,dien-tu-dien-lanh,184828915,"Giá Treo Màn Hình Máy Tính NB-F150 Gắn Tường 17-35Inch -Tải trọng 3-12Kg - Xoay Màn 360 Độ. Hàng Nhập Khẩu.",424000,424000,0,0
TIKI,dien-tu-dien-lanh,135038957,"túi trùm vệ sinh điều hòa treo tường bạt bảo dưỡng điều hòa bao trùm máy lạnh tất cả các hãng",129000,129000,0,0
TIKI,dien-tu-dien-lanh,253097850,"Ống thoát nước máy giặt 1,2 mét",14000,14000,0,0
TIKI,dien-tu-dien-lanh,162736054,"Tủ lạnh LG Inverter 394L GN-D392PSA - Chỉ giao Hà Nội",11790000,11790000,0,0
TIKI,dien-tu-dien-lanh,195479247,"Anten khuếch đại ngoài trời DVB T2 DUNALS + dây cáp anten 15m - Hàng Chính Hãng (Tặng kèm đầu thu DVB T2)",288000,288000,0,0
TIKI,dien-tu-dien-lanh,20624245,"Remote dùng cho điều hòa LG Inverter",42000,42000,0,0
TIKI,dien-tu-dien-lanh,43236855," Anten Liền Dây 15M Tích Hợp với TIVI & Đầu Thu KTS, DVB T2 ",39700,39700,0,0
TIKI,dien-tu-dien-lanh,113048208,"Điều khiển điều hoà Dành Cho Samsung",57900,57900,0,0
TIKI,dien-tu-dien-lanh,51436880,"Giá treo, khung treo tivi điều chỉnh độ nghiêng cho tivi từ 26 đến 65 inch",105000,105000,0,0
TIKI,dien-tu-dien-lanh,21154149,"Điều khiển dùng cho tivi toshiba CT - 90336",19000,19000,0,0
TIKI,dien-tu-dien-lanh,216225796,"KHUNG TREO TV CM T65",161000,161000,0,0
TIKI,dien-tu-dien-lanh,73642204,"[Chính Hãng] Bầu Điện Trở Máy Nước Nóng Centon 4.5 kW (Thermostat Lớn)",520000,520000,0,0
TIKI,dien-tu-dien-lanh,6489923,"Túi bảo dưỡng điều hòa RO _ áo trùm vệ sinh máy lạnh RO _ vệ sinh máy lạnh tại nhà _ ống xả dài 2,5m _  RO04",119000,119000,0,0
TIKI,dien-tu-dien-lanh,16871899,"Điều khiển dùng cho điều hòa Nagakawa",62000,62000,0,0
TIKI,dien-tu-dien-lanh,119193613,"Remote dành cho tivi led TCL Smart",57000,57000,0,0
TIKI,dien-tu-dien-lanh,89637523,"Điều khiển Samsung smart TV 4K tặng kèm pin",34000,34000,0,0
TIKI,dien-tu-dien-lanh,142864101,"Ống Dẫn Nước máy RO 6mm",4000,5000,1000,20
TIKI,dien-tu-dien-lanh,102806207,"Máy giặt sấy Samsung Addwash Inverter 9.5 kg WD95T754DBX/SV lồng ngang-Hàng chính hãng- Giao tại HN và 1 số tỉnh toàn quốc",13899000,13899000,0,0
TIKI,dien-tu-dien-lanh,57121246,"CHUỘT BAY KM900 ĐIỀU KHIỂN BẰNG GIỌNG NÓI - lk1984",169900,169900,0,0
TIKI,dien-tu-dien-lanh,100042565,"Motor đảo chậm quạt điện 4w 220v _ Tút năng điện - motor chậm",30000,30000,0,0
TIKI,dien-tu-dien-lanh,195506307,"Smart Tivi LG 4K 43 inch 43UQ7550PSF - Model 2022",6990000,6990000,0,0
TIKI,dien-tu-dien-lanh,165964350,"Ron tủ lạnh  dành cho tủ lạnh  sharp model SJ-195S-SL",234000,234000,0,0
TIKI,dien-tu-dien-lanh,118053307,"tay nắm dành cho máy giặt LG cửa trước",89000,89000,0,0
TIKI,dien-tu-dien-lanh,46791604,"ĐIỀU KHIỂN DÀNH CHO TIVI SSUNG SMART INTERNET ĐỜI K",32000,32000,0,0
TIKI,giay-dep-nu,113787129,"DÉP TÔNG HOA NỮ CHẤT LIỆU CÓI ĐÚC CAO CÂP",199000,199000,0,0
TIKI,giay-dep-nu,57151356,"Dép chiếu xỏ ngón Hương Quế DCQ-47 nguyên liệu tự nhiên (sợi chiếu, bột quế, sợi đay) ngăn ngừa mồ hôi chân - giữ ẩm và mát chân",68000,68000,0,0
TIKI,giay-dep-nu,99089116,"Dép Nữ Quai Ngang Đế Bệt HÀ NAM Da Bò Cao Cấp 2,5cm DNU2066",316000,316000,0,0
TIKI,giay-dep-nu,195714486,"Dép lê thời trang học sinh sinh viên phong cách Châu Âu mã 136, 148, 149",79500,159000,79500,50
TIKI,giay-dep-nu,119669029,"giày Dép bông bộ Đồ thú khủng long xanh liền thân lông mịn Pijama kiểu dáng Động Vật Hoạt Hình Cosplay",119000,119000,0,0
TIKI,giay-dep-nu,177185442,"Chai xịt bọt vệ sinh làm sạch giày Sneaker giày thể thao Hando 300ml",69000,69000,0,0
TIKI,giay-dep-nu,171572914,"Chai xịt lưu hương, khử mùi giày, dép chống hôi chân, diệt khuẩn hiệu quả đến ~24h dung tích 260ml",44999,44999,0,0
TIKI,giay-dep-nu,128876255,"(video) Combo 3 cặp lót mũi giày vải dành cho giày cao gót hoặc giày bị rộng",18000,18000,0,0
TIKI,giay-dep-nu,121332690,"Giầy nhựa cao su siêu đẹp thoáng chân mùa hè, dạo phố, đi biển GN04",104000,104000,0,0
TIKI,giay-dep-nu,195464954,"Set 2 Dây Giày Không Cần Buộc Tiện Lợi thông minh co giãn bản tròn rút buộc giày thể thao sneaker nam nữ #day 79",48000,48000,0,0
TIKI,giay-dep-nu,44744746,"Lót giày silicon bảo vệ mũi chân, miếng đệm lót chống sốc bàn chân trước - phụ kiện giày cao gót ( giao màu ngẫu nhiên )",10000,10000,0,0
TIKI,giay-dep-nu,181417908,"Combo 10 cặp lót giày êm chân size nam",25000,25000,0,0
TIKI,giay-dep-nu,179911970,"Giày Thể Thao Nữ Độn Đế Màu Trắng Cao Cấp Kiểu Hàn Quốc Êm Chân Thoáng Khí Tôn Dáng Cổ Vừa GTTN08",199000,199000,0,0
TIKI,giay-dep-nu,249695172,"Giày búp bê hở mũi",199000,199000,0,0
TIKI,giay-dep-nu,125777532,"Dép trái bắp hot hàng xịn",59000,59000,0,0
TIKI,giay-dep-nu,196382551,"HAVAIANAS - Dép nữ Slim 4000030",599000,599000,0,0
TIKI,giay-dep-nu,172993656,"Đế silicon lót giày 21167",7000,7000,0,0
TIKI,giay-dep-nu,196382488,"HAVAIANAS - Dép nữ Slim 4000030",599000,599000,0,0
TIKI,giay-dep-nu,11543103,"Lót Mũi Giầy Nữ Silicon (Có Dán) Massage Chân",29898,29898,0,0
TIKI,giay-dep-nu,59506779,"Giày Thể Thao Đế Cao 8.5CM PS439",590000,590000,0,0
TIKI,giay-dep-nu,195547325,"Giày Sandal Nữ Da Bò Thật BIGGBEN Cao Cấp SDN85",309000,350000,41000,12
TIKI,giay-dep-nu,53047040,"Giày sandal nữ Trường Hải đế xuồng cao 9.5cm màu kem đế PU nhẹ thời trang cao cấp nữ XDN193",253000,299000,46000,15
TIKI,giay-dep-nu,26848576,"Dép Cao Gót Nữ BIGGBEN Cao Cấp DCG26",329000,400000,71000,18
TIKI,giay-dep-nu,172994522,"Lót giày chống rộng, chống rớt gót cao cấp, bảo vệ chân khi mang giày - lót giày giá sỉ - 21166",13000,13000,0,0
TIKI,giay-dep-nu,170491534,"(HÀNG SẴN KHO) Dép nhựa hoa cúc quai ngang mẫu mới nhất",73000,73000,0,0
TIKI,giay-dep-nu,67725567,"HAVAIANAS - Dép nữ Slim 4000030-0076-356",699000,699000,0,0
TIKI,giay-dep-nu,48614744,"Combo 5 Chai Nước Lau Giày PLAC đa năng , nước tẩy trắng giày Thần thánh nhỏ gọn, dễ sử dụng 100ml GD265-NLGIAY-5",28000,34999,6999,20
TIKI,giay-dep-nu,195464956,"Cặp Lót giày silicone tổ ong đệm êm lòng bàn chân phía trước #sil30",55000,55000,0,0
TIKI,giay-dep-nu,205155554,"Dép Đúc Nguyên Khối Cao Su Dẻo Chống Trơn Trượt Cao Cấp Mẫu Mới Nhất",47000,47000,0,0
TIKI,giay-dep-nu,111821471,"Dép Gấu Đúc Nguyên Khối Nhiều Màu Cho Nam Nữ",108800,108800,0,0
TIKI,giay-dep-nu,53108304,"Dép chiếu Hương Quế DCQ-50 làm từ lụa tơ tằm - vải cotton - lớp đế cao su xốp cho đôi chân thơm - mát và khô thoáng - Đỏ",68000,68000,0,0
TIKI,giay-dep-nu,125098908,"Giày Lười Nữ Anh Khoa A913-4",199000,199000,0,0
TIKI,giay-dep-nu,196443242,"Dép đế trấu quai 2 khóa  / Nam nữ",179000,179000,0,0
TIKI,giay-dep-nu,96036309,"Giày thể thao nữ Fashinon phối lưới siêu thoáng đi chơi đi thể dục siêu hot",135000,135000,0,0
TIKI,giay-dep-nu,188421542,"31 32 Size Bé Giày Cao Gót (DA THẬT) Mềm Mại 42 43 Size Lớn - Đen Be Trắng sữa FFAN STORE",399000,399000,0,0
TIKI,giay-dep-nu,151194678,"Giày cao gót nữ đẹp đế vuông 5 phân hàng hiệu rosata ba màu đen đỏ kem ro375",430000,430000,0,0
TIKI,giay-dep-nu,188140203,"OLV - Giày Rose Gold Straps Heels",350000,350000,0,0
TIKI,giay-dep-nu,179169609,"Dép nữ, dép bánh mì, đế xuồng, quai ngang, bằng da, dùng đi du lịch, đi chơi, trong nhà",115000,115000,0,0
TIKI,giay-dep-nu,104794344,"Dép Thái Lan  quai ngang nữ chữ Z ôm chân, đế cao -  7.0",105000,105000,0,0
TIKI,giay-dep-nu,124275157,"Đôi Tất / Vớ Bảo Vệ Gót Chân Silicon Cực Êm Chống Nứt Gót Chân, Giảm Đau Chân, Ngừa Giãn Dây Chằn",15900,15900,0,0
TIKI,dien-tu-dien-lanh,58331505,"Remote Điều Khiển Dành Cho TV LED, TV 3D, Internet TV SONY RM-ED054 Grade A+ (Kèm Pin AAA Maxell)",23000,23000,0,0
TIKI,dien-tu-dien-lanh,162158003,"Đầu nối dây cấp nước máy giặt",15000,15000,0,0
TIKI,dien-tu-dien-lanh,23465415,"ĐIỀU KHIỂN DÙNG CHO TIVI LG",59900,59900,0,0
TIKI,dien-tu-dien-lanh,126702160,"Remote Điều khiển điều hòa dành cho Panasonic  dùng cho các dòng CS-YZ12SKH-8//YZ9SKH-8",531050,559000,27950,5
TIKI,dien-tu-dien-lanh,74814901,"ĐẦU THU KỸ THUẬT SỐ VỆ TINH MOBITV HÀNG CHÍNH HÃNG",650000,650000,0,0
TIKI,dien-tu-dien-lanh,125499337,"Box Mytv Net (2021) - Ram 4G/32G (Android 10) - Hàng Chính Hãng - Truyền Hình OTT miễn phí 12 tháng - Tích Hợp Tìm Kiếm Giọng Nói",989000,989000,0,0
TIKI,dien-tu-dien-lanh,17633550,"Máy giặt Inverter Electrolux EWF1024BDWA .10Kg ( hàng chính hãng )",10150000,10150000,0,0
TIKI,dien-tu-dien-lanh,70834621,"Máy tắm nước nóng OTTOWA TE45P01 - Hàng chính hãng - Có bơm",2650000,2650000,0,0
TIKI,dien-tu-dien-lanh,756785,"Tủ Lạnh Inverter Sharp SJ-X281E-SL (253L) - Hàng Chính Hãng",5990000,5990000,0,0
TIKI,dien-tu-dien-lanh,95677802,"Đồng hồ đo áp suất gas máy lạnh VALUE R410 hàng chính hãng",1158000,1158000,0,0
TIKI,dien-tu-dien-lanh,117293798,"Máy Giặt Casper cửa trên 8,5kg-WT85N68BGA [ HÀNG CHÍNH HÃNG ] [ CHỈ GIAO HÀ NỘI ]",4250000,4250000,0,0
TIKI,dien-tu-dien-lanh,77578320,"Tụ điện capa nhựa trắng 20 uF 50uF 450 VAC cho điều hòa tủ lạnh mô tơ",38000,38000,0,0
TIKI,dien-tu-dien-lanh,24945084,"Tủ Lạnh Inverter Mitsubishi Electric MR-CGX41EN-GBK-V (330L) - Hàng Chính Hãng",16600000,16600000,0,0
TIKI,dien-tu-dien-lanh,120229738,"Remote Điều Khiển Dùng Cho SONY BRAVIA Smart TV, Internet Tivi RMT-TX200U -Grade A",118000,118000,0,0
TIKI,dien-tu-dien-lanh,195660661,"Smart Tivi NanoCell LG 4K 55 inch 55NANO76SQA - Model 2022",12200000,12200000,0,0
TIKI,dien-tu-dien-lanh,193747215,"Ron tủ mát sana.ky alas.ka chuyên dùng",90000,90000,0,0
TIKI,dien-tu-dien-lanh,115146709,"Van cấp nước đôi dành cho máy giặt TOSHIBA",150000,150000,0,0
TIKI,dien-tu-dien-lanh,556247,"Khung Treo Tivi Xoay 19 Inch - 37 Inch - Hàng Chính Hãng",129900,129900,0,0
TIKI,dien-tu-dien-lanh,195639297,"Remote Điều khiển giọng nói (Voice) dành cho Casper smart TV, tivi thông minh (4 nút) - Hàng chính hãng",209000,209000,0,0
TIKI,dien-tu-dien-lanh,3413457,"Giá treo tivi thẳng tường nhập khẩu NBC3F cho tivi 32-65 inch, siêu mỏng chỉ dầy 2,9cm",204000,204000,0,0
TIKI,dien-tu-dien-lanh,126702159,"Điều khiển tivi dành cho Samsung dùng cho các dòng UA 32 40 43 49 50 55 QA65 4K KU NU RU ",138000,138000,0,0
TIKI,dien-tu-dien-lanh,104806285,"Máy Giặt Inverter Casper 8.5Kg WF-85I140BGB - Hàng chính hãng (Chỉ giao HCM)",5490000,5490000,0,0
TIKI,dien-tu-dien-lanh,196193768,"Máy Rửa Chén Beko DVN05320W ,13 bộ - Hàng chính hãng",18150000,18150000,0,0
TIKI,dien-tu-dien-lanh,75538710,"Remote Điều Khiển Dành Cho Máy Lạnh, Máy Điều Hòa FUJITSU AR-PV1, AR-RAH1U",58000,58000,0,0
TIKI,dien-tu-dien-lanh,13588378,"Tủ Lạnh Toshiba Inverter 359 Lít GR-AG41VPDZ(XK1) - Hàng chính hãng",13250000,13250000,0,0
TIKI,dien-tu-dien-lanh,118053213,"remote dành cho máy lạnh Daikin inverter gas r32 ( tặng kèm pin )",80000,80000,0,0
TIKI,dien-tu-dien-lanh,110686387,"MÁY RỬA CHÉN BÁT BOSCH SMS46GI01P - hàng chính hãng",13590000,13590000,0,0
TIKI,dien-tu-dien-lanh,53386771,"Tủ mát - Minibar thương hiệu Homesun, Model: BCH-36B, Thể tích 36L, Công suất 65W, Điện áp 220VAC, Cửa đen bóng mờ, Không tiếng ồn, Tiết kiệm điện năng, Màu đen sang trọng, Hàng chính hãng",3905000,3905000,0,0
TIKI,dien-tu-dien-lanh,96649299,"Tủ lạnh 20L LCD điều chỉnh nhiệt độ 3 Quạt làm mát PN729",3340000,3340000,0,0
TIKI,dien-tu-dien-lanh,119823791,"Điều khiển điều hòa dành cho Panasonic 1&2 chiều Inverter Nano Eco",159800,159800,0,0
TIKI,dien-tu-dien-lanh,14193014,"Điều khiển điều hòa Fujitsu 01 (trắng) - Hàng Chính Hãng",110000,110000,0,0
TIKI,dien-tu-dien-lanh,128897995,"Tủ đông mini Denver AS 286MDI Inox (100 lít) - Hàng chính hãng (Giao hàng toàn quốc)",5850000,5850000,0,0
TIKI,dien-tu-dien-lanh,75828527,"KHUNG TREO TIVI CỐ ĐỊNH 22-26INCH (VT-22)",77000,77000,0,0
TIKI,dien-tu-dien-lanh,21308093,"Điều khiển dùng cho  tivi SHARP Internet LCD-LED.",67000,67000,0,0
TIKI,dien-tu-dien-lanh,50438593,"Chân đế máy giặt tủ lạnh inox lõi bê tông nặng 5kg chống rung lắc",92000,92000,0,0
TIKI,dien-tu-dien-lanh,153261918,"Máy Rửa Chén Độc Lập Malloca WQP12-7635BS - 15 Bộ Chén Đĩa - Hàng Chính Hãng",23120000,27200000,4080000,15
TIKI,giay-dep-nu,262799957,"Dép kẹp xỏ ngón quai vải đế hoa xốp ép cao su 6cm BXW002500 - Đen",205000,205000,0,0
TIKI,giay-dep-nu,110209324,"Chai Xịt Bọt Vệ Sinh Giày Cao Cấp LKB 200ml - Bình Xịt Bọt Làm Sạch, Làm Trắng Giày Dép Siêu Tốc - Mifan Hàng Chính Hãng",50000,50000,0,0
TIKI,dien-tu-dien-lanh,195341926,"Bộ máy nước nóng IPP 3000w nhỏ gọn kèm Vòi sen (Trắng) - Home and Garden",1140000,1140000,0,0
TIKI,giay-dep-nu,123087214,"Giày Cao Gót Nữ Mũi Đính Xinh Xắn, Trẻ Trung, Năng Động Chuẩn Hàn Quốc Y18",304000,320000,16000,5
TIKI,giay-dep-nu,2642883,"Dụng Cụ Xỏ Giày Chất Liệu Inox - Hàng Nội Địa Nhật Bản",43000,43000,0,0
TIKI,giay-dep-nu,72011746,"Giày cao gót nữ cao 3cm đen Trường Hải da bóng đế vuông CGN124",247000,289000,42000,15
TIKI,giay-dep-nu,50405048,"Bọc bảo vệ ngón và bàn chân silicon siêu mềm PKG16",22000,22000,0,0
TIKI,dien-tu-dien-lanh,48574854,"Bộ Chia 2 Pacific Dùng Chia Truyền Hình Cáp, Anten KTS - Hàng Nhập Khẩu",34900,34900,0,0
TIKI,dien-tu-dien-lanh,162736051,"Tủ lạnh LG Inverter 374L GN-D372PS - Chỉ giao Hà Nội",8290000,8290000,0,0
TIKI,dien-tu-dien-lanh,53247738,"Tủ lạnh Hitachi Inverter 406 lít FVX510PGV9 GBK- HÀNG CHÍNH HÃNG",15500000,15500000,0,0
TIKI,dien-tu-dien-lanh,169277410,"Giá treo tivi di động 1 cọc",795000,795000,0,0
TIKI,dien-tu-dien-lanh,77104174,"KỆ TIVI DI ĐỘNG SÂN KHẤU 26-37INCH ,CAO 1,2 MÉT HÀNG NHƯ HÌNH",402000,402000,0,0
TIKI,dien-tu-dien-lanh,16937166,"Anten 2.4 GB - nRF24L01",24000,24000,0,0
TIKI,giay-dep-nu,4425353,"Combo 2 chai nước giặt giày cao cấp 500ml nội địa Nhật Bản",159500,159500,0,0
TIKI,giay-dep-nu,92688135,"Giày Búp Bê Mũi Tròn Đế Bệt M310 G̳I̳Á̳ ̳X̳Ư̳Ở̳N̳G̳   Da Bò Thật  ÊM và BỀN",259000,259000,0,0
TIKI,giay-dep-nu,148750952,"Dép chiếu mang trong nhà có lớp chiếu tỏa ra hơi ấm, hương thơm nhẹ giúp kích thích các huyệt đạo trong lòng bàn chân, cho đôi chân thơm, mát và khô thoáng",68000,68000,0,0
TIKI,dien-tu-dien-lanh,176289268,"Máy Giặt Electrolux Inverter 10 kg EWF1024P5WB - 15 Chương Trình - Hàng Chính Hãng - Chỉ Giao HCM",15990000,15990000,0,0
TIKI,dien-tu-dien-lanh,41601758,"Máy Giặt Cửa Trên Aqua AQW-FR120CT-W (12kg) - Hàng Chính Hãng",7950000,7950000,0,0
TIKI,giay-dep-nu,6846703,"Combo 2 bộ miếng đệm giày cao gót V.7 - Màu Đen (2 miếng / bộ)",30000,30000,0,0
TIKI,giay-dep-nu,32173380,"Miếng lót giày cao gót",49000,49000,0,0
TIKI,dien-tu-dien-lanh,102818389,"Máy giặt Samsung AI Inverter 9 kg WW90TP44DSH/SV lồng ngang-Hàng chính hãng- Giao tại HN và 1 số tỉnh toàn quốc",9100000,9100000,0,0
TIKI,giay-dep-nu,33024701,"2 cặp miếng lót mũi giày bằng mút đệm êm ngón chân, giảm rộng cho giày - buybox - BBPK38",48000,60000,12000,20
TIKI,dien-tu-dien-lanh,23005346,"Máy Giặt LG Inverter 10.5 kg T2350VS2W Mẫu 2019 - Hàng Chính Hãng ",5874000,5874000,0,0
TIKI,giay-dep-nu,198859055,"Giày cao gót mũi nhọn cao cấp - da mềm - gót cao 5p",250000,250000,0,0
TIKI,giay-dep-nu,80789610,"Boot nữ cổ cao cá tính da xịn gót cao 8P || PABNO PN643 || BH 12 Tháng",945000,945000,0,0
TIKI,giay-dep-nu,112961466,"Dép Tông nữ hot trend 2020 trẻ trung năng động 21358",21100,33000,11900,36
TIKI,giay-dep-nu,192375541,"Giày mọi nữ, giày bệt nữ HT.NEO được thiết kế với kiểu dáng đơn giản, mới lạ với nơ da, chất liệu da cao cấp nên đi vô cùng êm chân, thoải mái NU100",290000,590000,300000,51
TIKI,giay-dep-nu,113545541,"Dép cói nam nữ nhiều màu thời trang",99000,99000,0,0
TIKI,giay-dep-nu,19489080,"Dụng cụ giữ dáng giày và chống xẹp móp mũi giày cao gót nữ, giữ form mũi giày tây giày nam công sở da căng bóng PK45",52000,52000,0,0
TIKI,giay-dep-nu,24934396,"Giày Siêu Nhẹ - F2.1",159000,159000,0,0
TIKI,dien-tu-dien-lanh,197339652,"Tủ lạnh mini Funiki 90l 1 cánh FR-91DSU Mẫu 2022- Hàng chính hãng ( Chỉ giao hàng khu vực Hà Nội)",2690000,2690000,0,0
TIKI,giay-dep-nu,44573667,"Giày nữ hoa văn Huy Hoàng da bò màu nâu đất HT7952",489000,489000,0,0
TIKI,dien-tu-dien-lanh,114993671,"Tủ lạnh Panasonic Inverter 326 lít NR-TL351GPKV - Chỉ giao tại Hà Nội",12529000,12529000,0,0
TIKI,dien-tu-dien-lanh,56115945,"Tủ lạnh Inverter LG GR-B247WB (613L) - Hàng chính hãng - Chỉ giao tại Hà Nội",17500000,17500000,0,0
TIKI,dien-tu-dien-lanh,126702303,"Remote Điều khiển từ xa quạt điều hòa dành cho Sunhouse SHD7756, SHD7721 ",166250,175000,8750,5
TIKI,dien-tu-dien-lanh,536283,"Tủ Lạnh Inverter Sharp SJ-FX680V-WH (605L) - Hàng chính hãng",18750000,18750000,0,0
TIKI,giay-dep-nu,195465069,"2 Miếng Gel Silicon Dụng Cụ Tách Ngón Chân Bunion Dụng Cụ Điều Chỉnh Chứng Vẹo Ngón Chân Chăm Sóc Bàn Chân #sil 28",75000,75000,0,0
TIKI,dien-tu-dien-lanh,3686091,"Tủ lạnh LG Inverter 613 lít GR-B247JDS",16259000,16259000,0,0
TIKI,giay-dep-nu,56344283,"Dép Lông Đi Trong Nhà Cho Nam Nữ Bít Mũi NineRed DB034",99000,99000,0,0
TIKI,dien-tu-dien-lanh,20500065,"Tủ Lạnh Inverter LG GN-M315BL (315L) - Hàng chính hãng",7690000,7690000,0,0
TIKI,giay-dep-nu,168571584,"Bộ 2 miếng dán lót giầy silicon giảm đau gót, free size",41000,41000,0,0
TIKI,giay-dep-nu,109228945,"Miếng lót gót giày silicon chống đau chân cho giày cao gót (LOTGOT01)",9800,9800,0,0
TIKI,dien-tu-dien-lanh,147994598,"Cửa gió khuếch tán 600 x 600 cửa gió cấp cửa gió vuông nhôm miệng gió điều hòa âm trần",380000,380000,0,0
TIKI,giay-dep-nu,143363186,"Dép bít đầu nữ nhơn phong/dép bít đầu nữ",50000,50000,0,0
TIKI,giay-dep-nu,44822174,"Combo 2 đôi lót giày silicon bảo vệ bàn chân trước, miếng đệm lót bàn chân chống sốc - phụ kiện giày cao gót ( giao màu ngẫu nhiên )",34000,34000,0,0
TIKI,dien-tu-dien-lanh,162736026,"Máy sấy Electrolux 8.5 kg EDS854J3WB - Chỉ giao Hà Nội",10490000,10490000,0,0
TIKI,dien-tu-dien-lanh,126701974,"Remote điều khiển tivi dành cho Sony L1165",29000,29000,0,0
TIKI,giay-dep-nu,178339892,"Dép chiếu thổ cẩm quai ngang đỏ - ND017",45000,45000,0,0
TIKI,dien-tu-dien-lanh,125615982,"Smart Tivi Coocaa Android 10 50 inch - Model 50S6G Pro Max - Hàng chính hãng",7306000,7306000,0,0
TIKI,giay-dep-nu,144180490,"Miếng lót giầy quế thơm chân size 37 tới 42 dùng lót đế giầy tây lót giầy thể thao",23500,23500,0,0
TIKI,dien-tu-dien-lanh,122171773,"Máy lạnh 1 HP Casper SC-09FS32 Hàng chính hãng",5150000,5150000,0,0
TIKI,giay-dep-nu,160403634,"Dây Giày Cao Su Đàn Hồi Thắt BuộcThông Minh Sneaker V-Laces 14 Sợi 2 Nút Chỉnh Size Nam Nữ",23000,23000,0,0
TIKI,giay-dep-nu,16591267,"Combo 2 Bộ Miếng Dán Gót Giày 4d Chống Trầy Chân (Màu Kem, 4 Miếng Dán)",30000,30000,0,0
TIKI,dien-tu-dien-lanh,196193868,"Máy Rửa Chén Beko DFN05311W ,13 bộ - Hàng Chính Hãng",17250000,17250000,0,0
TIKI,giay-dep-nu,108035378,"Miếng Lót Mũi Chân Silicone Bảo Vệ chân Khi Đi Giày - Thoáng Khí thiết Kế Dạng Tổ Ong",15000,15000,0,0
TIKI,dien-tu-dien-lanh,125273728,"Máy giặt Casper Inverter 12.5 kg WF-125I140BGB - Chỉ giao Hà Nội",9950000,9950000,0,0
TIKI,dien-tu-dien-lanh,119690594,"CÔNG TẮC CỬA MÁY GIẶT ELECTROLUX EWF 10932, 12942, 14012, 14113, 12853, 12935, 12938 - CHÍNH HÃNG",320000,320000,0,0
TIKI,dien-tu-dien-lanh,126701948,"Điều khiển tivi  dành cho TCL RC311 FMI3 3D",42000,42000,0,0
TIKI,dien-tu-dien-lanh,170357897,"Android Tivi QLED TCL 4K 50 inch 50C725 - Hàng chính hãng - Giao tại Hà Nội và 1 số tỉnh toàn quốc",12950000,12950000,0,0
TIKI,dien-tu-dien-lanh,113048637,"Điều khiển điều hòa dành cho Panasonic -ion",56800,56800,0,0
TIKI,giay-dep-nu,54671476,"Dép chiếu xỏ ngón Hương Quế DKS-10 làm từ lụa tơ tằm - vải cotton - lớp đế cao su xốp cho đôi chân thơm, mát và khô thoáng",68000,68000,0,0
TIKI,giay-dep-nu,53565553,"Dép cói 3 quai chéo thổ cẩm siêu xinh",99000,99000,0,0
TIKI,dien-tu-dien-lanh,65410475,"Máy giặt LG Inverter 9 kg FV1409S2V - Chỉ giao Hà Nội",10950000,10950000,0,0
TIKI,dien-tu-dien-lanh,119195135,"Remote dành cho máy lạnh Sharp (ion)",66000,66000,0,0
TIKI,giay-dep-nu,16610090,"Lót giày độn đế tăng 3cm chiều cao freesize dùng cho cả nam và nữ PK02",29800,29800,0,0
TIKI,giay-dep-nu,77153101,"Dép Nhựa Unisex Đi Trong Nhà Thông Hơi Mẫu Mới Siêu Nhẹ Êm - MSP 3224W",41000,41000,0,0
TIKI,dien-tu-dien-lanh,184886334,"Giá Treo TiVi Áp Tường, Cố Định CP từ 39 - 65 inch C65T- Hàng Chính Hãng",350000,350000,0,0
TIKI,giay-dep-nu,140951227,"Dép xỏ ngón, dép kẹp đôi cho mẹ và bé XMISTUO chống trơn trượt",68000,68000,0,0
TIKI,dien-tu-dien-lanh,123140632,"Máy Rửa Chén Bát Texgio 15 Bộ TGF6019B - Có Thể Lắp Âm - Chống Rò Rỉ Nước - Hàng Chính Hãng",17950000,17950000,0,0
TIKI,giay-dep-nu,115715701,"Dép sandal nữ kiểu xỏ ngón gắn ngọc thời trang dễ thương",105000,105000,0,0
TIKI,dien-tu-dien-lanh,125273724,"Tủ lạnh Toshiba Inverter 325 lít GR-RB410WE-PMV(37)-SG - Chỉ giao HCM",11290000,11290000,0,0
TIKI,dien-tu-dien-lanh,100478475,"Máy rửa bát nhà hàng 2 bồn công nghệ siêu âm siêu sạch Rama SA2B - Hàng Chính Hãng",94940000,94940000,0,0
TIKI,dien-tu-dien-lanh,191066806,"Máy Giặt Cửa Trước Panasonic 10,5 Kg NA-V105FC1LV (Xám) - Diệt khuẩn đến 99.99% - Tính năng sấy tiện ích - Hàng Chính Hãng - Giao Toàn Quốc",17390000,17390000,0,0
TIKI,giay-dep-nu,195464947,"Cặp silicon ngón chân cái, nẹp silicon, bảo vệ chân . chống biến dạng khớp #sil28",85000,85000,0,0
TIKI,giay-dep-nu,81649525,"Combo 2 miếng lót mũi giày",15000,15000,0,0
TIKI,dien-tu-dien-lanh,15505504,"Điều Khiển Dùng Cho Điều Hòa Funiki",45500,45500,0,0
TIKI,dien-tu-dien-lanh,20502795,"Bình tắm nóng lạnh gián tiếp Ferroli Hotdog - 5 lít ( Hàng Chính Hãng)",1615000,1615000,0,0
TIKI,dien-tu-dien-lanh,126701884,"Điều khiển tivi Led dành cho Asanzo",37900,37900,0,0
TIKI,dien-tu-dien-lanh,126734353,"Máy rửa chén độc lập Bosch SMS63L08EA 13 bộ - Series 6 - SX Thổ Nhĩ Kỳ - Hàng chính hãng",11290000,11290000,0,0
TIKI,dien-tu-dien-lanh,113911903,"FPT Play Box S 2021 – Chính hãng FPT Telecom (Mã T590) – Kết hợp Tivi Box và Loa thông minh",2690000,2690000,0,0
TIKI,dien-tu-dien-lanh,149785709,"Remote Thay Thế Điều Khiển Dành Cho PHILIPS Smart TV, Tivi Thông Minh",68000,68000,0,0
TIKI,giay-dep-nu,183115625,"Giày bệt nữ,Giày búp bê nữ đế bệt chất da mềm",99000,99000,0,0
TIKI,dien-tu-dien-lanh,72780070,"[Chính Hãng] Máy Nước Nóng Centon WH8338E/EP 4.5KW",2448000,2448000,0,0
TIKI,dien-tu-dien-lanh,143970784,"Tủ lạnh Hitachi Inverter 569 lít R-WB640VGV0X (MIR) - Hàng chính hãng - Giao tại Hà Nội và 1 số tỉnh toàn quốc",46500000,46500000,0,0
TIKI,dien-tu-dien-lanh,68760491,"Máy nước nóng Ariston SL BLU 20 - 2.5 - FE (2500W)",2379000,2379000,0,0
TIKI,dien-tu-dien-lanh,87180717,"Áo vệ sinh máy lạnh",50000,50000,0,0
TIKI,dien-tu-dien-lanh,123367112,"Thiết bị khuếch đại tín hiệu sóng Anten KTS Mặt Đất DVB-T2 cùng xem World cup không lo gián đoạn đường truyền",68000,68000,0,0
TIKI,dien-tu-dien-lanh,112365089,"Máy giặt lồng ngang Casper 8.5Kg WF-85I140BGB Xuất xứ Thái Lan  -Hàng chính hãng ( Chỉ giao Hà Nội)",5449000,5449000,0,0
TIKI,dien-tu-dien-lanh,110931958,"MOTER ĐẢO ĐIỆN THAY THẾ SENKO- ĐỒNG 100% - HÀNG CHÍNH HÃNG 3HT",179000,179000,0,0
TIKI,dien-tu-dien-lanh,75538697,"ANTEN BÀN AVG ,NGUỒN 5V HÀNG CHÍNH HÃNG ,DÙNG CHO ĐẦU THU KỸ THUẬT SỐ DVB T2,TIVI TÍCH HỢP DVB T2",149000,149000,0,0
TIKI,dien-tu-dien-lanh,119791273,"Remote Điều Khiển Dành Cho Đầu Thu TV Viettel, Truyền Hình Internet Viettel",42750,45000,2250,5
TIKI,dien-tu-dien-lanh,181447376,"FPT Play Box S 2021 (T590) - Kết hợp Tivi Box và Loa thông minh - Điều khiển giọng nói thông minh không chạm - HÀNG CHÍNH HÃNG",1390000,1390000,0,0
TIKI,dien-tu-dien-lanh,57763181,"BỘ THIẾT BỊ K+ TIVI BOX KÈM 3 THÁNG THUÊ BAO- HÀNG CHÍNH HÃNG",690000,690000,0,0
TIKI,dien-tu-dien-lanh,144681292,"Remote điều khiển dành cho tivi Samsung Smart UHD (4K-hàng đẹp)",28000,28000,0,0
TIKI,dien-tu-dien-lanh,48527132,"ĐIỀU KHIỂN DÀNH CHO TIVI SONY",31000,31000,0,0
TIKI,dien-tu-dien-lanh,74909416,"Remote Điều Khiển Dành Cho Smart TV, Tivi Thông Minh SONY RMF-TX200P Nhận Giọng Nói",162000,162000,0,0
TIKI,dien-tu-dien-lanh,183688624,"đầu thu DVB S2 truyền hình vệ tinh AVG , HÀNG CHÍNH HÃNG",900000,900000,0,0
TIKI,dien-tu-dien-lanh,187844324,"Android tivi box MAGICSEE N5 MAX X4 Ram 4G Android 11, S905X4, wifi 2 băng tần, bluetooth cài sẵn phim HD, truyền hình cáp miễn phí vĩnh viễn - Hàng nhập khẩu",1519050,1599000,79950,5
TIKI,dien-tu-dien-lanh,16876822,"Điều khiển dùng cho điều hòa Panasonic Inverter 2 chiều",42700,42700,0,0
TIKI,dien-tu-dien-lanh,41219182,"Remote Điều Khiển Điều Hòa Đa Năng - Dễ Sử Dụng - Thích Hợp Với Tất Cả  Các Loại Máy Lạnh",32000,32000,0,0
TIKI,dien-tu-dien-lanh,20624245,"Remote dùng cho điều hòa LG Inverter",42000,42000,0,0
TIKI,dien-tu-dien-lanh,89637523,"Điều khiển Samsung smart TV 4K tặng kèm pin",34000,34000,0,0
TIKI,dien-tu-dien-lanh,253097850,"Ống thoát nước máy giặt 1,2 mét",14000,14000,0,0
TIKI,dien-tu-dien-lanh,162736054,"Tủ lạnh LG Inverter 394L GN-D392PSA - Chỉ giao Hà Nội",11790000,11790000,0,0
TIKI,dien-tu-dien-lanh,16871899,"Điều khiển dùng cho điều hòa Nagakawa",62000,62000,0,0
TIKI,dien-tu-dien-lanh,184828915,"Giá Treo Màn Hình Máy Tính NB-F150 Gắn Tường 17-35Inch -Tải trọng 3-12Kg - Xoay Màn 360 Độ. Hàng Nhập Khẩu.",424000,424000,0,0
TIKI,dien-tu-dien-lanh,135038957,"túi trùm vệ sinh điều hòa treo tường bạt bảo dưỡng điều hòa bao trùm máy lạnh tất cả các hãng",129000,129000,0,0
TIKI,dien-tu-dien-lanh,113048208,"Điều khiển điều hoà Dành Cho Samsung",57900,57900,0,0
TIKI,dien-tu-dien-lanh,43236855," Anten Liền Dây 15M Tích Hợp với TIVI & Đầu Thu KTS, DVB T2 ",39700,39700,0,0
TIKI,dien-tu-dien-lanh,195479247,"Anten khuếch đại ngoài trời DVB T2 DUNALS + dây cáp anten 15m - Hàng Chính Hãng (Tặng kèm đầu thu DVB T2)",288000,288000,0,0
TIKI,dien-tu-dien-lanh,6489923,"Túi bảo dưỡng điều hòa RO _ áo trùm vệ sinh máy lạnh RO _ vệ sinh máy lạnh tại nhà _ ống xả dài 2,5m _  RO04",119000,119000,0,0
TIKI,dien-tu-dien-lanh,57121246,"CHUỘT BAY KM900 ĐIỀU KHIỂN BẰNG GIỌNG NÓI - lk1984",169900,169900,0,0
TIKI,dien-tu-dien-lanh,73642204,"[Chính Hãng] Bầu Điện Trở Máy Nước Nóng Centon 4.5 kW (Thermostat Lớn)",520000,520000,0,0
TIKI,dien-tu-dien-lanh,100042565,"Motor đảo chậm quạt điện 4w 220v _ Tút năng điện - motor chậm",30000,30000,0,0
TIKI,dien-tu-dien-lanh,142864101,"Ống Dẫn Nước máy RO 6mm",4000,5000,1000,20
TIKI,dien-tu-dien-lanh,165964350,"Ron tủ lạnh  dành cho tủ lạnh  sharp model SJ-195S-SL",234000,234000,0,0
TIKI,dien-tu-dien-lanh,195506307,"Smart Tivi LG 4K 43 inch 43UQ7550PSF - Model 2022",6990000,6990000,0,0
TIKI,dien-tu-dien-lanh,119193613,"Remote dành cho tivi led TCL Smart",57000,57000,0,0
TIKI,dien-tu-dien-lanh,102806207,"Máy giặt sấy Samsung Addwash Inverter 9.5 kg WD95T754DBX/SV lồng ngang-Hàng chính hãng- Giao tại HN và 1 số tỉnh toàn quốc",13899000,13899000,0,0
TIKI,dien-tu-dien-lanh,51436880,"Giá treo, khung treo tivi điều chỉnh độ nghiêng cho tivi từ 26 đến 65 inch",105000,105000,0,0
TIKI,dien-tu-dien-lanh,216225796,"KHUNG TREO TV CM T65",161000,161000,0,0
TIKI,dien-tu-dien-lanh,46791604,"ĐIỀU KHIỂN DÀNH CHO TIVI SSUNG SMART INTERNET ĐỜI K",32000,32000,0,0
TIKI,dien-tu-dien-lanh,118053307,"tay nắm dành cho máy giặt LG cửa trước",89000,89000,0,0
TIKI,dien-tu-dien-lanh,21154149,"Điều khiển dùng cho tivi toshiba CT - 90336",19000,19000,0,0
TIKI,dien-tu-dien-lanh,167549363,"Smart Tivi Crystal Samsung 4K 55 inch UA55BU8000 - Model 2022",10800000,10800000,0,0
TIKI,dien-tu-dien-lanh,169277363,"KHUNG TREO TIVI GẬT GÙ 26-45 INCH HÀNG DÀY",89700,89700,0,0
TIKI,dien-tu-dien-lanh,172816583,"[Chỉ Giao Tại HCM] Máy giặt cửa trên Panasonic 8.5 Kg NA-F85A9BRV - Hàng Chính Hãng",6590000,6590000,0,0
TIKI,dien-tu-dien-lanh,165964317,"Ron tủ lạnh  dành cho tủ lạnh  Panasonic NR-BL307PSVN",238000,238000,0,0
TIKI,dien-tu-dien-lanh,103875490,"Tủ lạnh Toshiba GR-RT395WE-PMV(06)-MG- Hàng chính hãng- Chỉ giao tại Hà Nội",10890000,10890000,0,0
TIKI,dien-tu-dien-lanh,135038751,"Sò Lạnh Nhật / Cảm Biến Âm Tủ lạnh Japan 5 Số",55000,55000,0,0
TIKI,dien-tu-dien-lanh,191077431,"Máy Giặt Cửa Trước Panasonic 9,5 Kg NA-V95FR1BVT - Diệt khuẩn đến 99.99% - Tính năng sấy tiện ích - Hàng Chính Hãng (Đen) - Giao Toàn Quốc",14390000,17890000,3500000,20
TIKI,dien-tu-dien-lanh,121268280,"Máy lạnh Daikin Inverter 1 HP FTKA25VMVMV - Hàng Chính Hãng (Giao Hàng Toàn Quốc)",9950000,9950000,0,0
TIKI,dien-tu-dien-lanh,13152223,"Điều Khiển Tivi Asanzo 32 Inch 32T650",128900,128900,0,0
TIKI,dien-tu-dien-lanh,83849495,"Máy giặt cửa trên Aqua 10kg AQW-U100FT(BK) 2021- Hàng chính hãng (chỉ giao HCM)",5490000,5490000,0,0
TIKI,dien-tu-dien-lanh,39291714,"Remote Điều Khiển Smart TV, TV LED SAMSUNG L1088 Smart Hub",74000,74000,0,0
TIKI,dien-tu-dien-lanh,193206284,"Chân đế tivi đa năng VT02 (36-75INCH)",204000,204000,0,0
TIKI,dien-tu-dien-lanh,35872744,"máy giặt đồ mini",2149000,2149000,0,0
TIKI,dien-tu-dien-lanh,188051659,"Điều hòa không khí Karofi KDC-WF312 công nghệ 4 tự động - Hàng chính hãng - Giao và lắp đặt toàn quốc",11590000,11590000,0,0
TIKI,dien-tu-dien-lanh,170966288,"Tủ lạnh LG Inverter 635 Lít GR-X257JS Mới 2022 - Hàng chính hãng - Giao tại Hà Nội",35800000,35800000,0,0
TIKI,dien-tu-dien-lanh,168586414,"Hamitechz Carplay Android Ai Box - RAM 4G, ROM 64GB HÀNG CHÍNH HÃNG",5800000,5800000,0,0
TIKI,dien-tu-dien-lanh,166078757,"Tủ lạnh mini 2 chiều dùng trên ô tô và gia đình, Tủ lạnh đựng mỹ phẩm màn hình led cao cấp có nhiều dung tích lựa chọn - Có Ảnh Thật",1845000,1845000,0,0
TIKI,dien-tu-dien-lanh,100042563,"COMBO 50 ROTO QUẠT GIÓ b4,b3_46",385000,385000,0,0
TIKI,dien-tu-dien-lanh,72872343,"MÁY RỬA CHÉN BÁT TEXGIO TG-DTW558 8 BỘ, SẢN XUẤT THEO CÔNG NGHỆ CHÂU ÂU,  HÀNG CHÍNH HÃNG",8800000,8800000,0,0
TIKI,dien-tu-dien-lanh,52782388,"Tủ lạnh Samsung Inverter 236 lít RT22M4032BY/SV - HÀNG CHÍNH HÃNG",6200000,6200000,0,0
TIKI,dien-tu-dien-lanh,135456740,"GIÁ TREO MÀN HÌNH MÁY TÍNH KALOC DS90( 17 ''-32'') ARM MONITOR",475000,475000,0,0
TIKI,dien-tu-dien-lanh,102485737,"Máy giặt Aqua Inverter 9 kg AQD-D900F S lồng ngang-Giao tại HN và 1 số tỉnh toàn quốc",8500000,8500000,0,0
TIKI,dien-tu-dien-lanh,54406050,"Tủ lạnh Samsung Inverter 280 lít  RB27N4010BU/SV - Chỉ Giao tại Hà Nội",9200000,9200000,0,0
TIKI,dien-tu-dien-lanh,83432703,"Tủ Lạnh Electrolux Inverter 341L ETB3740K-H - Chỉ Giao Hà Nội",8990000,8990000,0,0
TIKI,dien-tu-dien-lanh,81968353,"Tủ lạnh Toshiba Inverter 233 lít GR-A28VM(UKG1)-Hàng chính hãng- Chỉ Giao Tại Hà Nội",7200000,7200000,0,0
TIKI,dien-tu-dien-lanh,195918337,"Máy sấy quần áo Sunhouse SHD2707 - Hàng chính hãng [Giao HCM/HN]",1870000,2347000,477000,20
TIKI,dien-tu-dien-lanh,74560552,"anten kỹ thuật số DVB T2 HKD 113 ,CÓ DÂY CẤP NGUỒN 5V HÀNG CHÍNH HÃNG ",99000,99000,0,0
TIKI,dien-tu-dien-lanh,153262042,"Máy Rửa Chén Âm Tủ Malloca WQP12-J7309K E5 - 7 Chương Trình Rửa - Hàng Chính Hãng",18275000,21500000,3225000,15
TIKI,dien-tu-dien-lanh,123547513,"Giá Treo Tivi Xoay Đa Năng 32"-65" - Model 2020 NB - P6 [ HÀNG CHÍNH HÃNG ] NHẬP KHẨU",381000,381000,0,0
TIKI,dien-tu-dien-lanh,185347020,"Điều hòa 1 chiều inverter 9000BTU/H NIS-C09R2H11 - Giao hàng toàn quốc - Hàng chính hãng",6390000,10500000,4110000,39
TIKI,dien-tu-dien-lanh,139981173,"MOTUEUR QUẠT HỘP - HỮU THÀNH",198000,198000,0,0
TIKI,dien-tu-dien-lanh,169277246,"GIÁ TREO MÀN MÁY TÍNH GẮN BÀN NB F80 (17-27 INCH) ",334000,334000,0,0
TIKI,dien-tu-dien-lanh,845744,"Tủ lạnh Samsung Inverter 208 lít RT19M300BGS/SV",5139000,5139000,0,0
TIKI,dien-tu-dien-lanh,184767534,"Tấm phân luồng gió máy lạnh loại có lỗ khí giữa 1.5HP trở xuống - tấm đổi hướng gió điều hòa",97000,97000,0,0
TIKI,dien-tu-dien-lanh,270647742,"[Tổng hợp] Tủ lạnh mini KEMIN bán chạy 4L 10L 16L trữ sữa mỹ phẩm (ko đông đá)",960000,960000,0,0
TIKI,dien-tu-dien-lanh,76273941,"Máy Lạnh LG Inverter 1.5 HP V13ENS1 - Chỉ giao tại Hà Nội",8590000,8590000,0,0
TIKI,dien-tu-dien-lanh,121268101,"Máy giặt Samsung Inverter 9 Kg WW90TP54DSH/SV - Hàng chính hãng(Giao Toàn Quốc)",10250000,10250000,0,0
TIKI,dien-tu-dien-lanh,195815333,"Adroid Boxx Ai Thế Hệ Mới Nhất dành cho xe ô tô. Android Chíp 8 nhân, ram 4G, rom 64G  PLC-S21E",5986000,5986000,0,0
TIKI,dien-tu-dien-lanh,123131341,"Tời nâng cục nóng điều hòa - Khung nâng hạ dàn nóng điều hòa",980000,980000,0,0
TIKI,dien-tu-dien-lanh,189138530,"Ron tủ lạnh kiểu ngài nhiều kích thước",280000,280000,0,0
TIKI,giay-dep-nu,155751830,"Boots thời trang nữ cổ cao, da lì cao cấp ROSATA RO307 6.5p gót trụ - BKSTORE",650000,650000,0,0
TIKI,giay-dep-nu,203291056,"Dép Sandal nữ quai ngang hình đan siêu nhẹ êm chân hot 2022 - Mã SP : sandal đan chéo",129000,129000,0,0
TIKI,giay-dep-nu,115715099,"Dép sandal nữ siêu nhẹ trẻ trung phong cách Hàn Quốc",109000,109000,0,0
TIKI,giay-dep-nu,100261715,"Dép xỏ ngón cao gót bebe 9cm  dona21052101",65550,69000,3450,5
TIKI,giay-dep-nu,117684707,"Quai giày chữ y quai hậu chống tuột gót chống rộng phụ kiện trang trí thay thế miếng lót giày rộng mang được nhiều kiểu",55000,55000,0,0
TIKI,giay-dep-nu,39376029,"Giày sneaker nữ thoáng khí êm chân V197",59000,59000,0,0
TIKI,giay-dep-nu,71838483,"Dép nhựa nam nữ đi trong nhà và tolet, Dép đi trong nhà tắm V2 S100",60000,64000,4000,6
TIKI,giay-dep-nu,20638024,"Combo 2 Bộ Miếng Dán Gót Giày 4d Chống Trầy Chân (Màu Đen, 4 Miếng Dán)",30000,30000,0,0
TIKI,giay-dep-nu,198540380,"Giày mọi nữ da mềm êm chân màu trắng đế cao su cao 3cm",179000,295000,116000,39
TIKI,giay-dep-nu,174495110,"Giày Bệt Nữ, Giày Mọi Nữ Siêu Dễ Thương 21670",150000,150000,0,0
TIKI,giay-dep-nu,149452216,"Giày cao gót nữ đẹp đế vuông 9 phân hàng hiệu rosata màu đen da ro377",499000,499000,0,0
TIKI,giay-dep-nu,76537799,"Giày thể thao nữ Fashinon phối lưới siêu thoáng",119000,119000,0,0
TIKI,giay-dep-nu,90797172,"MIẾNG DÁN GÓT GIÀY SILICON V.2 - TRONG SUỐT",26000,26000,0,0
TIKI,giay-dep-nu,98296665,"dép đi trong nhà, dép nam nữ siêu bền(ảnh thật)",28000,28000,0,0
TIKI,giay-dep-nu,89935065,"Giày búp bê nữ da bò 20550",443300,819000,375700,46
TIKI,giay-dep-nu,40826725,"Dép quai ngang nữ đế cao 4cm thời trang cao cấp Trường Hải QN225",230000,269000,39000,14
TIKI,giay-dep-nu,131504788,"Giày boot bốt nữ cổ thấp 7 phân hàng hiệu rosata màu đen ro35",490000,490000,0,0
TIKI,giay-dep-nu,189171198,"Dép đế trấu nam nữ chữ H thời trang màu TRẮNG Detaunisex - DETA14T",300000,300000,0,0
TIKI,giay-dep-nu,34612405,"Combo 10 cặp lót giày êm chân size nữ - Trắng",25000,25000,0,0
TIKI,giay-dep-nu,263115147,"Giày bốt nữ cổ ngắn màu trắng 4p RO301 ROSATA tại BCASHOP nhấn 3 gạch ngang mạ vàng, cùng nơ mảnh thời trang, đẳng cấp",549000,549000,0,0
TIKI,giay-dep-nu,17009614,"Bộ 2 Miếng Đệm Cao Su Non Lót Bàn Chân Chống Đau Chân Khi Đi Giày Cao Gót",32500,32500,0,0
TIKI,giay-dep-nu,78914660,"[HÀNG LOẠI 1] Giày lười nữ vải thô hoa văn, giày slip on vải S079 nhẹ, bền, êm chân",129000,129000,0,0
TIKI,giay-dep-nu,183912629,"Dép xuồng nữ quai ngang êm chân thời trang V305",99000,99000,0,0
TIKI,giay-dep-nu,178724396,"Dép cao gót, dép đi biển, 9 phân, mũi vuông, đế tam giác, thời trang hot trend, chất liệu da cao cấp",145750,145750,0,0
TIKI,giay-dep-nu,171197012,"Giày Cao Gót 11cm",230000,230000,0,0
TIKI,giay-dep-nu,263093204,"Giày bốt nữ cổ ngắn màu đen 4p RO308 ROSATA tại BCASHOP khóa nút tiện lợi, mùi nhọn sang trọng thể hiện đẳng cấp",549000,549000,0,0
TIKI,giay-dep-nu,67600056,"Giày Búp Bê Bệt Da Bò Thật Siêu Êm Gắn Nơ Pixie X424",189000,189000,0,0
TIKI,giay-dep-nu,143835017,"Giày Cao Gót (DA THẬT) Da Mềm Lót Êm Chân - Đính Đá Cao Cấp 517A8 FFAN STORE",450000,450000,0,0
TIKI,giay-dep-nu,193564953,"Giày nữ cao cấp ELLY – EGM176",599500,1199000,599500,50
TIKI,giay-dep-nu,186756607,"[HÀNG XỊN] Giày oxford bánh mì phong cách Korea chất lượng da bóng mềm siêu nhẹ S303",262000,265000,3000,1
TIKI,giay-dep-nu,175797887,"Giày sabo, Dép sục da Pu nguyên tấm siêu êm, mềm mại, thoáng mát cho mùa hè SHOES 2H – S04",160000,160000,0,0
TIKI,giay-dep-nu,42734010,"Giày búp bê nữ xinh xắn TLG 20465-6",434700,483200,48500,10
TIKI,giay-dep-nu,175831449,"Dép Nữ Cao Gót Bít Mũi TiTi Đô Cao Cấp GBBN2056a",390000,390000,0,0
TIKI,giay-dep-nu,263089686,"Giày cao gót nữ 5p RO330 ROSATA tại BCASHOP màu kem, mũi tròn, quai keo gai và có đính nơ nhã nhặn, thanh lịch",399000,399000,0,0
TIKI,giay-dep-nu,270142768,"Dép xỏ ngón nữ đế cao 7cm 9cm 11cm Sans280 bánh mì xuồng tông tăng 7p 9p 11p đen trơn êm chân không dốc basic",69999,69999,0,0
TIKI,giay-dep-nu,178724414,"Dép cao gót nữ, quai trong, 9 phân, đi biển, đi chơi, công sở, loại cao cấp hot trend 2022",145750,145750,0,0
TIKI,giay-dep-nu,217494751,"Lót gót giày nam giảm size chống tuột rớt gót đệm êm bảo vệ gót chống đau chân phù hợp nhiều loại giày",39000,39000,0,0
TIKI,giay-dep-nu,270873952,"Khăn giấy ướt lau giày siêu sạch Sneaker Wipes gói 25 tờ hương quế tạo bọt tự tan làm sạch nhanh chóng mang đi tiện lợi",18000,35000,17000,49
TIKI,giay-dep-nu,121333184,"Giầy búp bê thoáng chân chịu nước dễ thương GN16",104000,104000,0,0
TIKI,giay-dep-nu,194187625,"Giày cao gót đính xoàn sang trọng gót 9cm cao cấp ( giao hỏa tốc - ping - bảo hành 1 năm )",420000,420000,0,0
TIKI,giay-dep-nu,174384911,"Sandal đế bệt nữ Aldo MARASSI",1650000,1650000,0,0
TIKI,giay-dep-nu,89883667,"Sandal đế xuồng 10.5cm X445 da lộn, đế cao su công nghệ mới siêu nhẹ",495000,495000,0,0
TIKI,giay-dep-nu,71048291,"Giầy búp bê siêu mềm chịu nước đế bệt siêu mềm họa tiết vintage dễ thương GN20",89000,89000,0,0
TIKI,giay-dep-nu,68634189,"Juno - Giày sandal gót vuông quai mặt bất đối xứng SD05044",407000,407000,0,0
TIKI,giay-dep-nu,82228784,"HÌNH THẬT - Dép lông bông plush , dép đi trong nhà lông mềm mại có đế cao su chống trơn trượt , dép lông mang trong nhà",45700,45700,0,0
TIKI,giay-dep-nu,91255482,"Giày Sandal Đế Xuồng Nữ Da Bò BIGGBEN Cao Cấp SDX29",339000,400000,61000,15
TIKI,giay-dep-nu,73992156,"Giày thể thao sneaker nữ màu hồng đế êm nhẹ thoáng khí thương hiệu ZAVAS - S394 - Hàng chính hãng",349000,360000,11000,3
TIKI,giay-dep-nu,67600517,"Giày Sandal Đế Xuồng Quai Dán 3cm Pixie 4162",450000,450000,0,0
TIKI,giay-dep-nu,76405600,"Giày Sandal Nữ Đế Xuồng BIGGBEN Da Bò Thật SDX25",299000,450000,151000,34
TIKI,giay-dep-nu,100465418,"Dép Guốc Cao Gót Nữ 5cm Quai Trong Thời Trang Nữ Tính GN15",129000,195000,66000,34
TIKI,giay-dep-nu,72538775,"Bình Xịt Bọt Tuyết Vệ Sinh Giày Sneaker | Chai Tẩy Trắng , Tẩy Ố Vàng Sneaker 9306",59000,59000,0,0
TIKI,giay-dep-nu,26045876,"Giầy nhựa chống trượt đi mưa đi biển thời trang mùa hè nhiều mầu họa tiết hoa GN03",59000,59000,0,0
TIKI,giay-dep-nu,121982801,"SANDAL NHỰA ĐI MƯA BOOKLYM LOW CAO 5CM ĐẾ XUỒNG MÀU BE",450000,450000,0,0
TIKI,giay-dep-nu,74555399,"Giày slip on nữ da trơn đế thấp - Giày lười nữ S150",121000,129000,8000,6
TIKI,giay-dep-nu,195277320,"Giày Thể Thao Nữ Biti's Êmbrace DSW066400HOG (Hồng)",463000,579000,116000,20
TIKI,giay-dep-nu,79555723,"Giày nhựa cao su cho nữ giày nhựa đi mưa Alina cao 3p giá rẻ kiểu dáng thời trang V274",59000,59000,0,0
TIKI,giay-dep-nu,131143005,"Giày sandal nữ hàng hiệu rosata cao gót đế cao 5 phân màu đen za05",399000,399000,0,0
TIKI,giay-dep-nu,192844314,"Giày Nữ Pierre Cardin - PCWFWSG 171",390000,1490000,1100000,74
TIKI,giay-dep-nu,68402723,"Giầy nhựa búp bê dạo phố, đi mưa, đi biển dễ thương GN17 đan nam đính nơ",59000,59000,0,0
TIKI,giay-dep-nu,169914748,"Giày cao gót hở mũi da mềm màu đen Trường Hải gót trụ 5cm",219000,299000,80000,27
TIKI,giay-dep-nu,19728953,"Giày slip on da trơn đế nâu S207",182000,194000,12000,6
TIKI,giay-dep-nu,14046442,"Dép tông Dép đi biển Dép lê nữ kiểu dáng thời trang đế dày full size chuẩn 36 đến 40 nhiều màu phù hợp cho mùa hè V149",55000,55000,0,0
TIKI,giay-dep-nu,59169064,"Dép Cao Gót Nữ Da Bò BIGGBEN Cao Cấp DCG34",249000,400000,151000,38
TIKI,giay-dep-nu,145756821,"GIÀY SANDAL QUAI NGANG NỮ ALDO ADRERAN",1550000,1550000,0,0
TIKI,giay-dep-nu,197418062,"Giày Sandal Nữ BIGGBEN Da Bò Thật SDN08",339000,450000,111000,25
TIKI,giay-dep-nu,22986513,"Dép Xỏ Ngón Nữ BIGGBEN Da Bò Thật DXN20",279000,350000,71000,20
TIKI,giay-dep-nu,193878090,"Giày lười vải nữ đế cao su mềm êm chân cao 2cm",119000,149000,30000,20
TIKI,giay-dep-nu,46818961,"Giày búp bê da lộn nữ phong cách công sở kiểu dáng cơ bản V211",89000,89000,0,0
TIKI,giay-dep-nu,20954982,"Giày lười nữ - giày thời trang nữ",209000,209000,0,0
TIKI,giay-dep-nu,106868938,"Giày Búp Bê Nữ Đế Xuồng Da Bò BIGGBEN Cao Cấp BB105",309000,400000,91000,23
TIKI,giay-dep-nu,197044015,"Giày Sandals Bít mũi Vento OPTIMUS du lịch/trekking SD08003",395000,395000,0,0
TIKI,giay-dep-nu,105274225,"Giày Búp Bê Mũi Nhọn Khoá Tròn Pixie X688",504000,504000,0,0
TIKI,giay-dep-nu,91205516,"Giày Sandal Cao Gót Da Bò BIGGBEN Cao 7 Phân SDCG63",319000,350000,31000,9
TIKI,giay-dep-nu,159437867,"XẢ KHO DÉP đúc nguyên khối mang trong nhà chống trơn trượt cao cấp mới nhất",48000,48000,0,0
TIKI,giay-dep-nu,55995324,"Dép sục nữ phối màu",99000,99000,0,0
TIKI,giay-dep-nu,101264973,"Lót Đế Giày Biti's Hunter X AIUH00100DEN (Đen)",220000,244000,24000,10
TIKI,giay-dep-nu,109332974,"Giày sandal đế trấu quai chéo nam nữ Detaunisex màu ĐEN - SATA23D",219000,219000,0,0
TIKI,giay-dep-nu,75657761,"Giày boots combat nữ, giày bốt nữ cột dây 1 dây kéo cổ lửng S011",202000,215000,13000,6
TIKI,giay-dep-nu,175470069,"Giày chạy bộ nữ Under Armour Flow Velociti Wind Prizm - 3024895-101",2857000,4395000,1538000,35
TIKI,giay-dep-nu,143835373,"Giày Bệt Quai Sau (DA THẬT) Mềm Như Bún Slingback Mũi Nhọn FFAN STORE",470000,470000,0,0
TIKI,dien-tu-dien-lanh,115934736,"CÔNG TẮC NGUỒN MÁY SẤY ELECTROLUX  – HÀNG CHÍNH HÃNG",119000,119000,0,0
TIKI,dien-tu-dien-lanh,76527754,"Điều khiển Smartbox MyTV VNPT Technology hàng chính hãng",150000,150000,0,0
TIKI,dien-tu-dien-lanh,120032201,"Remote Dùng Cho Reetech Điều Khiển Máy Lạnh, Máy Điều Hòa YKR-P002E",65000,65000,0,0
TIKI,dien-tu-dien-lanh,152752966,"Công Tắc Ấm Siêu Tốc",14000,14000,0,0
TIKI,dien-tu-dien-lanh,235368932,"Remote Điều Khiển TV Dành Cho SONY Internet Smart Tivi RM-ED047 Kèm Pin",48000,48000,0,0
TIKI,dien-tu-dien-lanh,43813180,"Remote Điều Khiển dành Cho TV LED, Smart TV, Ti Vi Thông Minh TCL",21000,21000,0,0
TIKI,dien-tu-dien-lanh,188032088,"Tấm chắn gió, chuyển đổi hướng gió máy lạnh máy điều hòa có lỗ thoáng khí kích thước 90cm. Tấm chắn gió điều hòa lắp đặt đơn giản",113000,113000,0,0
TIKI,dien-tu-dien-lanh,171574649,"Tủ lạnh mini KEMIN 32L Chính Hãng - Chỉnh nhiệt có ngăn đá",3187000,3750000,563000,15
TIKI,dien-tu-dien-lanh,2018371,"Điều Hòa Daikin FTC60NV1V/RC60NV1V (22.000Btu) - Hàng Chính Hãng",21890000,21890000,0,0
TIKI,dien-tu-dien-lanh,205988756,"Remote Điều Khiển Dành Cho SAMSUNG Smart Tivi, Internet TV BN59-01315D",32000,32000,0,0
TIKI,dien-tu-dien-lanh,51842523," Anten Để Bàn cho Tivi và Đầu DVB T2 Thu Phát Sóng Tốt Kèm Dây Dài ",99000,99000,0,0
TIKI,dien-tu-dien-lanh,204063064,"Remote Điều Khiển Dùng Cho Smart TV, Internet TV, LED TV SAMSUNG BN59-01303A  - Hàng nhập khẩu",55000,55000,0,0
TIKI,dien-tu-dien-lanh,123547597,"Giá Treo Tivi Xoay Góc đa năng P6 từ 32-70 inch, hàng Nhập Khẩu ",392000,392000,0,0
TIKI,dien-tu-dien-lanh,97791366,"Remote Điều Khiển Giọng Nói Dành Cho Panasonic Smart TV, Android Tivi",398000,398000,0,0
TIKI,dien-tu-dien-lanh,3519947,"Giá treo tivi di động nhập khẩu AVA1500-60-1P (Đ8) màu đen cho tivi 32-65 inch",1030000,1030000,0,0
TIKI,dien-tu-dien-lanh,140944957,"Mytv Net 1C - Ram 2G/16G - Phiên bản 2022 - Android 9.0 - Truyền Hình Bản Quyền Miễn Phí 12 Tháng - Hàng Chính Hãng",695000,695000,0,0
TIKI,dien-tu-dien-lanh,23185068,"Điều khiển dùng cho đầu SCTV",47000,47000,0,0
TIKI,dien-tu-dien-lanh,55464528,"Điều khiển VNPT SmartBox 2 - Chính hãng",99000,99000,0,0
TIKI,dien-tu-dien-lanh,195284843,"Smart Tivi Coocaa Full HD 43 inch 43S3U",3790000,4590000,800000,17
TIKI,dien-tu-dien-lanh,14143226,"Tủ Lạnh Samsung Inverter 647 lít RS62R5001B4/SV",18179000,18179000,0,0
TIKI,dien-tu-dien-lanh,216232335,"Remote Điều Khiển Cho Máy Lạnh, Điều Hòa Panasonic Nanoe-G CS/CU-PU9UKH, N9UKH (Kèm Pin AAA Maxell)",67000,67000,0,0
TIKI,dien-tu-dien-lanh,59494168,"Remote Điều Khiển Dành Cho Smart TV LG, Internet TV, TV Thông Minh LG AKB75095308 (Kèm Pin AAA Maxell)",39000,39000,0,0
TIKI,dien-tu-dien-lanh,73100107,"Remote Điều Khiển Dành Cho Smart TV, Internet Tivi SONY RMT-TZ300A",28000,28000,0,0
TIKI,dien-tu-dien-lanh,251254434,"Remote Điều Khiển TV Dành Cho SONY LED Internet Smart Tivi Youtube NETFLIX",29000,29000,0,0
TIKI,dien-tu-dien-lanh,7633108,"Đầu Thu Kỹ Thuật Số DVB T2 LTP STB-1306 Chính Hãng",295000,295000,0,0
TIKI,dien-tu-dien-lanh,145761987,"Remote Điều khiển từ xa điều hòa dùng cho Hitachi các dòng Hitachi RAS-X RAS- RAS-EJ 1HP 1.5HP 2HP 9000 12000 -Hàng mới 100%",60000,60000,0,0
TIKI,dien-tu-dien-lanh,10949871,"Giá Treo Tivi 26 - 43 inch áp tường - Giá treo TiVi loại thẳng - Hàng chính hãng",69000,69000,0,0
TIKI,dien-tu-dien-lanh,89453306,"Smart Remote TV Nhận Giọng Nói Dành Cho Samsung Tivi 4K, QLED KU6500, MU7000, NU7500",180000,180000,0,0
TIKI,dien-tu-dien-lanh,169277358,"GIÁ TREO TIVI DI ĐỘNG CHÂN 3 CHÂN HÀNG SIÊU DÀY",396000,396000,0,0
TIKI,dien-tu-dien-lanh,119195282,"Remote Điều khiển dành cho tivi led Asanzo Smart",26000,26000,0,0
TIKI,dien-tu-dien-lanh,173243640,"Tấm chắn gió điều hòa - Tấm chắn đổi hướng gió điều hòa máy lạnh (TCG02)",57800,57800,0,0
TIKI,dien-tu-dien-lanh,96347175,"Chiết áp, bộ điều khiển tốc độ động cơ , ánh sáng công suất lớn 4000W 0-220V",78000,78000,0,0
TIKI,dien-tu-dien-lanh,126702199,"Remote Điều khiển từ xa quạt dành cho Vinawind các dòng quạt cây treo tường QTT400X QD",38950,41000,2050,5
TIKI,dien-tu-dien-lanh,188974314,"Máy Rửa Chén Ecalite EDW-UF6080BL (8 Bộ) - Có Rửa Điệt Khuẩn - Lắp Bán Âm Cực Gọn - Điều Khiển Cảm Ứng - Hàng Chính Hãng",6588000,11800000,5212000,44
TIKI,dien-tu-dien-lanh,133057665,"Máy giặt mini gấp gọn thông minh",281000,281000,0,0
TIKI,dien-tu-dien-lanh,16033028,"Máy Rửa Chén Electrolux ESF6010BW - Hàng Chính Hãng",7190000,7190000,0,0
TIKI,dien-tu-dien-lanh,72613545,"Điều khiển thông minh dành cho tivi LG 2019",331000,331000,0,0
TIKI,dien-tu-dien-lanh,263401390,"Remote Điều Khiển TV Dùng Cho TOSHIBA LED Smart Tivi CT-8068",40000,40000,0,0
TIKI,dien-tu-dien-lanh,216332892,"Remote Điều Khiển TV Giọng Nói Dành Cho SAMSUNG Smart Tivi 4K, QLED - Grade A",150000,150000,0,0
TIKI,dien-tu-dien-lanh,49607755,"Bình nước nóng Ariston 15 lít Blu 15R 2.5 FE - Hàng Chính Hãng",1971000,1971000,0,0
TIKI,giay-dep-nu,104261269,"Dép kẹp nữ đế cao 7cm chống trơn trượt",119000,119000,0,0
TIKI,giay-dep-nu,192135155,"Dép Nữ Da Bò Thật BIGGBEN Cao Cấp DNQN51",299000,350000,51000,15
TIKI,giay-dep-nu,106901880,"Giày Búp Bê Nữ Da Bò BIGGBEN Cao Cấp BB109",309000,400000,91000,23
TIKI,giay-dep-nu,74301261,"Giày Búp Bê Nữ Da Bò BIGGBEN Cao Cấp BB76",309000,400000,91000,23
TIKI,giay-dep-nu,177642266,"Giày Búp Bê Nữ Da Bò BIGGBEN Cao Cấp BB122",309000,350000,41000,12
TIKI,giay-dep-nu,179911875,"Giày Thể Thao Nữ Sneaker Kiểu Hàn Quốc Mẫu Mới 2022 Êm Chân Thoáng Khí Cổ Vừa Trẻ Trung Năng Động SUNO STORE GTTN11",199000,199000,0,0
TIKI,giay-dep-nu,77715686,"Lót giày cao gót chống trượt bàn chân về phía mũi và đệm êm gang bàn chân - 1 cặp - buybox - BBPK161",15000,30000,15000,50
TIKI,giay-dep-nu,46760225,"Combo 01 cặp lót giày nguyên bàn chân đa năng và 01 cặp lót giày bảo vệ gót chân 2 trong 1_buybox_BBPK11&09",50000,100000,50000,50
TIKI,giay-dep-nu,137966471,"Giày Nữ Pierre Cardin - PCWFWS160",490000,1690000,1200000,71
TIKI,giay-dep-nu,168117359,"COMBO 10 ĐÔI DÉP XỐP QUAI NGANG CHO KHÁCH SẠN, NHÀ NGHỈ",115000,115000,0,0
TIKI,giay-dep-nu,148072539,"Dép quai ngang hình khủng long siêu hot 2021",49000,49000,0,0
TIKI,giay-dep-nu,151489262,"Giày búp bê nữ da bò cao cấp BIGGBEN BB120",309000,400000,91000,23
TIKI,giay-dep-nu,71681207,"Giày búp bê công sở tôn dáng siêu xinh có khả năng chịu nước chống trơn trượt V259",65000,65000,0,0
TIKI,giay-dep-nu,155381539,"Dây giày thông minh không cần buộc Sans945 co giãn bản dẹt cho giày thể thao sneaker nam nữ nhiều màu trắng đen xanh xám",59999,59999,0,0
TIKI,giay-dep-nu,168282118,"Cặp lót giày cao gót massage êm chân nguyên bàn (XLGCG02)",15000,30000,15000,50
TIKI,giay-dep-nu,80849903,"2 cặp lót mũi giày bằng mút bọc vải đệm êm ngón chân, giảm rộng cho giày - buybox - BBPK38_2",48000,80000,32000,40
TIKI,giay-dep-nu,112861738,"Dép Đi Trong Nhà, Dép Bông Nam Nữ Đế Chống Trơn, Dép Đi Trong Văn Phòng Êm Chân D37",79000,79000,0,0
TIKI,giay-dep-nu,57760484,"Giày Sandals nữ 3 phân chống nước cao su quai chéo V246",55000,55000,0,0
TIKI,giay-dep-nu,68400998,"Hàng Chính Hãng - Pixie Giày Búp Bê Bệt Da Bò Thật Gắn Nơ Độ Bền Cao Siêu Êm Không Đau Chân  X424",189000,189000,0,0
TIKI,giay-dep-nu,24843053,"Dép massage chân cải thiện sức khỏe",119000,119000,0,0
TIKI,giay-dep-nu,159437923,"Dép Đúc Nguyên Khối Cao Su Dẻo Chống Trơn Trượt Mang Trong Nhà Mẫu Mới Nhất",49000,49000,0,0
TIKI,giay-dep-nu,126090214,"Dép Đế Trấu Quai Chéo Nam Nữ Đi Mưa Deaunisex Màu Đen - DETA23F",300000,300000,0,0
TIKI,giay-dep-nu,98069554,"Giày sneaker thể thao nữ buộc dây siêu nhẹ V280",69000,69000,0,0
TIKI,giay-dep-nu,59207075,"Giày Sandal Nữ Da Bò BIGGBEN Cao Cấp SDCG49",349000,400000,51000,13
TIKI,giay-dep-nu,188487235,"Lót giày bảo vệ gót hình vỏ sò tăng độ bám chân chuyên dùng mang giày thể thao - buybox - BBPK224",48000,70000,22000,31
TIKI,giay-dep-nu,144180526,"Dép nhựa nữ quai ngang BS huyền thoại mang trong nhà chống trơn trượt",49500,49500,0,0
TIKI,giay-dep-nu,192832023,"Dép Nữ Pierre Cardin - PCWFWSG 169",490000,1290000,800000,62
TIKI,giay-dep-nu,28737579,"2 cặp miếng lót mũi giày cao gót 4D êm chân thoáng khí - buybox - BBPK14",38000,65000,27000,42
TIKI,giay-dep-nu,97103083,"Giày búp bê Doris đế bệt, ️️️️giày da thật mũi tròn gắn nơ vuông màu kem, thời trang cho nữ DR004",199000,199000,0,0
TIKI,giay-dep-nu,22388687,"Jibbitz Sticker Icon 3D Gắn Dép Sục (Combo 10 sticker) - Giao Mẫu Ngẫu Nhiên",22000,22000,0,0
TIKI,giay-dep-nu,197674887,"Giày cao gót HT.NEO 9p gót trụ khuy nơ viền kim loại, thiết kế trẻ trung, da cao cấp, đi cực tôn dáng, êm chân CS248",450000,980000,530000,54
TIKI,giay-dep-nu,125098879,"Giày lười nữ Anh Khoa D993-7",220000,220000,0,0
TIKI,giay-dep-nu,143799896,"Dép Nữ quai ngang một bản thời trang cao cấp Trường Hải đế PU nhẹ cao 2.5cm Màu Kem thời trang nữ cao cấp N146K",207000,259000,52000,20
TIKI,giay-dep-nu,197668980,"Giày cao gót HT.NEO cao 9p gót trụ vân kẻ, chất liệu da cao cấp, thiết kế đơn giản, mới lạ, đi êm chân, thoải mái CS246",480000,1100000,620000,56
TIKI,giay-dep-nu,172077680,"Giày Nữ Búp Bê Đính Nơ Tomoyo Da Micro Fiber Khắc Hoạ Tiết Laser TMW31105",800000,800000,0,0
TIKI,giay-dep-nu,15000222,"Dép nữ xỏ ngón -Dép kẹp đen  da bò thật mềm mại  XN0016- đen - 35",196000,229000,33000,14
TIKI,giay-dep-nu,193889750,"Bốt Đùi Nữ Da Lì Trắng Đen Thời Trang Khoá Sau Ulzzang Siêu Hót Cao Cổ Giày Boot Xinh",525000,755000,230000,30
TIKI,giay-dep-nu,188486981,"Quai giày thun đan hồi, bản to phối khoen, thiết kế chắc chắn, chống tuột gót giày, dùng cho nữ - buybox - BBPK218",53200,70000,16800,24
TIKI,giay-dep-nu,59107611,"Cầu vai bảo vệ (nền xanh đen-gạch vàng-viền đỏ-sao bạc)",40000,40000,0,0
TIKI,giay-dep-nu,98070256,"Giày lười nữ êm chân phong cách hàn quốc V281",69000,69000,0,0
TIKI,giay-dep-nu,109351968,"Dép quai ngang đế trấu đi mưa chống nước Detaunisex - DETA12F",245000,245000,0,0
TIKI,giay-dep-nu,22968560,"Sandal Xuồng Nữ BIGGBEN Cao Cấp SDX09",339000,400000,61000,15
TIKI,giay-dep-nu,96074857,"Giày Đi Mưa Thời Trang Nữ Cao Cấp",99000,99000,0,0
TIKI,giay-dep-nu,92024652,"HAVAIANAS - Sandal nữ Luna 4129697",699000,699000,0,0
TIKI,giay-dep-nu,187311516,"Dép Sục Nữ Da Bò Thật BIGGBEN Cao 5 phân SBN42",329000,450000,121000,27
TIKI,giay-dep-nu,149779068,"Giày cao gót nữ đẹp đế vuông 5 phân hàng hiệu rosata hai màu trắng vàng ro380",430000,430000,0,0
TIKI,giay-dep-nu,186884396,"Dép lê nam nữ mang đi ở trong nhà văn phòng khách sạn spa mùa đông Hàn quốc đế xốp nhẹ vải bố thô êm chân chống trơn DO",34900,34900,0,0
TIKI,giay-dep-nu,182089784,"Giày nữ cao cấp ELLY – EGM167",649500,1299000,649500,50
TIKI,giay-dep-nu,15515930,"Miếng Bảo Vệ Gót Chân Silicon (Màu Cam)",19000,19000,0,0
TIKI,giay-dep-nu,193602675,"HAVAIANAS - Sandals nữ Luna Premium II 4147009",1049000,1049000,0,0
TIKI,giay-dep-nu,52188508,"Giày Sandal Nữ BIGGBEN Da Bò Thật SDN50",329000,350000,21000,6
TIKI,giay-dep-nu,161404729,"Dép xăng đan nữ ( đế trắng quai trắng ) size từ 34 nữ đến 42 nữ",82999,82999,0,0
TIKI,giay-dep-nu,141680032,"Dép nữ cao gót quai ngang 7 phân hàng hiệu rosata hai màu đen trắng ro342",399000,399000,0,0
TIKI,giay-dep-nu,195520342,"Dép Sục Nữ Da Bò Thật BIGGBEN Cao 3 phân SBN45",329000,450000,121000,27
TIKI,giay-dep-nu,184068875,"HAVAIANAS - Dép nữ Slim Glitter II 4146975",949000,949000,0,0
TIKI,giay-dep-nu,56681799,"Giầy nhựa đi mưa thời trang GNN15",79000,79000,0,0
TIKI,giay-dep-nu,183720585,"Dép cao gót vân cá sấu",250000,250000,0,0
TIKI,giay-dep-nu,12072529,"Giày Cao Gót Nữ Gót Vuông 5P Mũi Nhọn Pixie P055",435000,435000,0,0
TIKI,giay-dep-nu,61278552,"Giày thể thao nữ hoa cúc đi bộ cực êm siêu xinh V253 - Hồng - Size 38",55000,55000,0,0
TIKI,giay-dep-nu,61278556,"Giày thể thao nữ hoa cúc đi bộ cực êm siêu xinh V253 - Hồng - Size 40",55000,55000,0,0
TIKI,giay-dep-nu,48333238,"Dép Xuồng Nữ Da Bò BIGGBEN DX17",339000,450000,111000,25
TIKI,giay-dep-nu,176631755,"Khăn ướt lau giày chuyên dụng Sneaker Clean loại nhỏ 12 miếng bỏ túi tiện lợi",25000,25000,0,0
TIKI,giay-dep-nu,169366358,"Giày lười vải nữ êm chân thời trang mới nhất V298",69000,69000,0,0
TIKI,giay-dep-nu,146226706,"Giày nhựa đi mưa, giày bệt đế bằng chống trơn trượt màu đen, kem size 36 đến 40",63000,63000,0,0
TIKI,giay-dep-nu,192339290,"Giày Keds Nữ- Double Decker Wave Glitter Canvas Cream- KD065932",499000,1490000,991000,67
TIKI,giay-dep-nu,169448716,"Giày thể thao nữ đi bộ cực êm siêu xinh V279",59000,59000,0,0
TIKI,giay-dep-nu,96538042,"Giày nữ cao cổ loại cao cấp, giày sneakers, giày thể thao nữ hàn quốc cổ chun ôm chân dễ mang vào tháo ra, nhiều màu, tặng kèm tất sịn 35k",238000,238000,0,0
TIKI,giay-dep-nu,74307584,"Dép Nữ Cao Gót BIGGBEN Cao Cấp DCG44",319000,450000,131000,29
TIKI,giay-dep-nu,129943006,"Giày Sneaker Unisex Converse Chuck Taylor All Star 1970s - 162058C",1900000,1900000,0,0
TIKI,giay-dep-nu,10037828,"Dép Nữ BIGGBEN Da Bò Thật DNQN12",329000,350000,21000,6
TIKI,giay-dep-nu,57701341,"Dép nữ bít mũi H2854-1",58000,58000,0,0
TIKI,giay-dep-nu,158306862,"Giày sandals nữ gót trụ ChristinA-Q XDN260",699000,699000,0,0
TIKI,giay-dep-nu,176759174,"Dép bánh mì nữ nam quai ngang độn đế siêu nhẹ hot",59565,62700,3135,5
TIKI,giay-dep-nu,173424676,"Giày thời trang nữ Crocs Pacer Literide 360 - 206705-0DD",948000,1895000,947000,50
TIKI,giay-dep-nu,172963321,"Dép Đế Xuồng Nữ Da Bò Thật BIGGBEN Cao Cấp DX36",309000,350000,41000,12
TIKI,giay-dep-nu,89517684,"Sandal đế xuồng 11cm X486004",720000,720000,0,0
TIKI,giay-dep-nu,104793193,"Dép Thái Lan - Dép nhựa xỏ ngón đế thấp 5.3",90000,90000,0,0
TIKI,giay-dep-nu,68872802,"Giày lội nước, giày đi biển, giày đi suối, đi câu cá thoát nước nhanh dành cho nữ",693000,693000,0,0
TIKI,giay-dep-nu,173563018,"Giày Cao Gót Da Bò Thật BIGGBEN Gót 7 Phân SDCG73",369000,450000,81000,18
TIKI,giay-dep-nu,149779946,"Giày cao gót nữ ORSIL mã NV5-BM",249000,259000,10000,4
TIKI,giay-dep-nu,169366473,"Giày lười vải nữ caro êm chân thời trang mới nhất V299",69000,69000,0,0
TIKI,giay-dep-nu,197605023,"Dép đế trấu quai chéo /Nam Nữ",300000,300000,0,0
TIKI,giay-dep-nu,22907286,"Giày cao gót nữ - D280",199000,199000,0,0
TIKI,giay-dep-nu,92454800,"Sticker Gắn Dép",1900,1900,0,0
TIKI,giay-dep-nu,125098693,"Giày lười nữ Anh Khoa L03",300000,300000,0,0
TIKI,giay-dep-nu,171092013,"Sandal nữ Teva Hurricane Xlt 2 - 1019235",1495000,1495000,0,0
TIKI,giay-dep-nu,59561949,"Giày Nữ Búp Bê TOMOYO Da Microfiber Siêu Nhẹ Siêu Thoáng TMW21408",699000,699000,0,0
TIKI,giay-dep-nu,178561961,"DÉP BÁNH MÌ Quai Ngang , Chống Trơn , Tăng Chiều Cao , Siêu Nhẹ Hot Hit",57000,92000,35000,38
TIKI,giay-dep-nu,54384192,"Giày Nữ Búp Bê Da Bò BIGGBEN BB67",289000,400000,111000,28
TIKI,giay-dep-nu,143806855,"Dép quai ngang nữ Hai dây thời trang cao cấp Trường Hải Đế Pu cao 2.5cm nhẹ nhàng êm ái Màu đen N147Đ",207000,259000,52000,20
TIKI,giay-dep-nu,59207843,"Giày Sandal Cao Gót BIGGBEN Da Bò Thật SDCG51",339000,450000,111000,25
TIKI,giay-dep-nu,59206148,"Dép Bít Đầu Nữ Da Bò Cao Cấp SBN30",359000,450000,91000,20
TIKI,giay-dep-nu,67600231,"Giày Cao Gót 7cm Da Bóng Gắn Nơ Pixie P259",515000,515000,0,0
TIKI,giay-dep-nu,192839517,"[ Chính Hãng ] Giày Shondo Sandals F6 sport future xanh vàng F6S0045",479000,479000,0,0
TIKI,giay-dep-nu,61278536,"Giày thể thao nữ hoa cúc đi bộ cực êm siêu xinh V253 - Đen - Size 40",55000,55000,0,0
TIKI,giay-dep-nu,274638952,"Giày thể thao nữ đế êm nhẹ, thoáng khí đế cao su đúc, chống trơn trượt hạn chế mòn – GNU1007",400000,800000,400000,50
TIKI,giay-dep-nu,108833607,"Dép đế trấu nam nữ 2 quai ngang phối khóa màu Bò Detaunisex - DETA21B",245000,245000,0,0
TIKI,giay-dep-nu,152855925,"Giày Mũi Vuông Gót Vuông (DA THẬT) Da Mềm Gót Mềm - Màu Đen",450000,450000,0,0
TIKI,giay-dep-nu,71925376,"Giày loafer bệt, búp bê nobita giày nữ đế bệt S163",75000,75000,0,0
TIKI,giay-dep-nu,195232689,"Giày Thể Thao Nữ Trắng Mẫu Mới Xuất Khẩu Kiểu Hàn Quốc Trẻ Trung Cá Tính Năng Động GTTN21",219000,219000,0,0
TIKI,giay-dep-nu,105656233,"Sandal đế xuồng 9p siêu nhẹ, siêu êm",350000,350000,0,0
TIKI,giay-dep-nu,176544086,"SANDAL XUỒNG QUAI CHÉO",170000,170000,0,0
TIKI,giay-dep-nu,191986995,"Sandal cao gót nữ đế 9F",189000,189000,0,0
TIKI,giay-dep-nu,52242549,"Dép Nữ Đế Xuồng BIGGBEN Da Bò Thật DX18",339000,400000,61000,15
TIKI,giay-dep-nu,70640186,"Dép đi trong nhà siêu nhẹ nam nữ màu xám size M Nội địa NHẬT BẢN",210000,210000,0,0
TIKI,giay-dep-nu,106858097,"Boots nữ cổ lửng chất liệu da bò mềm + lớp lót nhung êm chân, đế 4cm 7918 (Màu đen)- (Tặng 1 đôi tất/ vớ- giao màu ngẫu nhiên)",783750,825000,41250,5
TIKI,giay-dep-nu,192810961,"OLV - Giày Thin Strap Heels",450000,450000,0,0
TIKI,giay-dep-nu,40979455,"Giầy bốt nữ cổ ngắn, chất liệu da lộn lót lông ấm áp, thời trang trẻ, phong cách Hàn Quốc (Đen)",99000,99000,0,0
TIKI,giay-dep-nu,20536352,"Giày cao gót quai dán đính phụ kiện 3049",220000,220000,0,0
TIKI,giay-dep-nu,23013660,"Giày sục đi mưa đi biển màu đen, trắng, hồng, giày nhựa đi mưa chống trơn trượt size 36 đến 40 mẫu V168",49000,49000,0,0
TIKI,giay-dep-nu,152855879,"Giày Gót Nhọn Công Sở Văn Phòng nữ Tiếp Viên Hàng Không Cao Cấp FFAN STORE",399000,399000,0,0
TIKI,giay-dep-nu,263093240,"Giày bốt nữ cổ ngắn màu trắng kem 4p RO308 ROSATA tại BCASHOP khóa nút tiện lợi, mùi nhọn sang trọng thể hiện đẳng cấp",549000,549000,0,0
TIKI,giay-dep-nu,163725460,"Dép Đi Trong Nhà Unisex 2 Mầu, Cao Su Chống Trợt, Siêu Êm FOR HOME",65000,65000,0,0
TIKI,giay-dep-nu,140763187,"Giày boot bốt nữ cổ thấp 5 phân hàng hiệu rosata hai màu đen nâu ro224",450000,450000,0,0
TIKI,giay-dep-nu,56093959,"Giày Búp Bê Nữ Trắng Trơn Tomoyo TMW20407",699000,699000,0,0
TIKI,giay-dep-nu,186632941,"Dép Xỏ Ngón Nữ Da Bò Thật BIGGBEN Cao Cấp DXN40",299000,350000,51000,15
TIKI,giay-dep-nu,144269704,"[CHẤT LƯỢNG] Dép xuồng 8 phân quai chéo da PU cao cấp, nhe, êm chân, tôn dáng S064",253000,269000,16000,6
TIKI,giay-dep-nu,193565094,"Giày nữ cao cấp ELLY – EGM183",549500,1099000,549500,50
TIKI,giay-dep-nu,12584545,"Dép cao gót gót kiểu cao cấp - D994",230000,230000,0,0
TIKI,giay-dep-nu,15460751,"Dép nhựa đính nơ size 35 đến 40 size chuẩn nhiều màu trong suốt siêu cute cho bạn nữ V157",67500,67500,0,0
TIKI,giay-dep-nu,90795098,"MIẾNG LÓT MŨI GIÀY ÊM CHÂN CHO GIÀY CAO GÓT (1 CẶP)",19500,19500,0,0
TIKI,giay-dep-nu,100468457,"Giày Cao Gót Nữ Mũi Vuông Sang Trọng, Da Mềm, Đế 5cm, Mang Đi Làm, Dự Tiệc GN17",119000,200000,81000,41
TIKI,giay-dep-nu,193641538,"Giày vải Thành Phát XP3027, phom đẹp, giá đẹp, phù hơp cho lao động; size 38-43 (màu xanh)",83083,83083,0,0
TIKI,giay-dep-nu,73163125,"Giày Búp Bê Bệt Da Bò Thật Siêu Êm Gắn Nơ Nhỏ Pixie X603",420000,420000,0,0
TIKI,giay-dep-nu,67305886,"Giày cao gót vuông 7p quai ngang da bóng",170000,170000,0,0
TIKI,giay-dep-nu,58366444,"Dép bít mũi nữ Trường Hải đế xuồng cao 4cm da bò thật mềm mại BM177",253000,299000,46000,15
TIKI,giay-dep-nu,125099080,"Giày lười nữ Anh Khoa E993N",220000,220000,0,0
TIKI,giay-dep-nu,10037770,"Dép Nữ BIGGBEN Da Bò Thật DNQN10",329000,400000,71000,18
TIKI,giay-dep-nu,81132356,"Dép đi trong nhà -  dép mát xa -nachidu – MT1  ( TÍM ).",89000,89000,0,0
TIKI,giay-dep-nu,73163054,"Giày Búp Bê Đế Xuồng Da Thật Gắn Khoá Pixie X596",420000,420000,0,0
TIKI,giay-dep-nu,178958502,"Dép quai ngang nam nữ đúc nguyên khối cao 5cm, chất eva siêu bền êm chân không thấm nước 2022",57000,72000,15000,21
TIKI,giay-dep-nu,3328423,"Dép bông đi trong nhà hình gấu  - Hồng",39967,39967,0,0
TIKI,giay-dep-nu,148856253,"Giày lười moca nữ, giày lười nữ da mềm mũi tròn màu đen- trắng",265000,265000,0,0
TIKI,giay-dep-nu,76222994,"Giày Thể Thao Vải Nữ Phong Cách Hàn Quốc, Giày Chạy Bộ Đế Cao Su Cực Êm GN29",69000,110000,41000,37
TIKI,giay-dep-nu,150733008,"Dép chiếu Hương Quế DCQ-12 là một sản phẩm thủ công đẹp, sang trọng và tốt cho sức khoẻ người mang",68000,68000,0,0
TIKI,giay-dep-nu,36978561,"Giày Sandal Nữ Đế Xuồng BIGGBEN Da Bò Thật SDN38 - 36",339000,420000,81000,19
TIKI,giay-dep-nu,89894039,"Dép kẹp nữ đính đá, dép xỏ ngón nữ cao cấp, tông nữ đi biển đẹp, sang, sịn sò",125000,125000,0,0
TIKI,giay-dep-nu,204121099,"CONVERSE - Giày sneakers cổ cao unisex Chuck Taylor All Star M3310C",1550000,1550000,0,0
TIKI,giay-dep-nu,134025988,"Giày boot nữ cổ thấp 5 phân hàng hiệu rosata hai màu đen kem ro289",490000,490000,0,0
TIKI,giay-dep-nu,20817652,"Giày búp bê giày công sở có khả năng chịu nước, chống trơn trượt size 36 đến 40 mẫu V158 chuẩn",53000,53000,0,0
TIKI,giay-dep-nu,173235898,"Giày dép sandal cao gót giày Nữ kiểu dáng Châu Âu Và Hoa Kỳ Giày Sandal Cao Gót Nữ 20737",100000,100000,0,0
TIKI,giay-dep-nu,76538762,"Giày thể thao nữ Fashinon phối lưới siêu thoáng",119000,119000,0,0
TIKI,giay-dep-nu,137421854,"Giày cao gót nữ đẹp đế vuông 5 phân hàng hiệu rosata màu vàng ro172",450000,450000,0,0
TIKI,giay-dep-nu,193109599,"Giày sandal cao gót vuông 5p quai mảnh kết bính chéo chân siêu xinh",135200,135200,0,0
TIKI,giay-dep-nu,176714696,"Sandal cao gót bít mũi 7p gót trụ HT.NEO thiết kế đơn giản, mới lạ, trẻ trung SDN112",450000,960000,510000,53
TIKI,dien-tu-dien-lanh,165964508,"BỘ RON TỦ LẠNH  dành cho tủ lạnh  PANASONIC NR-BU344",238000,238000,0,0
TIKI,giay-dep-nu,110150599,"Giày búp bê nữ phong cách công sở kiểu dáng cơ bản V285",79000,79000,0,0
TIKI,giay-dep-nu,193051523,"[CAO CẤP] Giày sandal cao gót 9 phân quai len dây hậu S155 hàng Quảng Châu chuẩn đẹp",234000,249000,15000,6
TIKI,dien-tu-dien-lanh,191077664,"Máy Giặt Cửa Trước Panasonic 9,5 Kg NA-V95FC1LVT - Diệt khuẩn đến 99.99% - Tính năng sấy tiện ích - Hàng Chính Hãng (Xám) - Giao Toàn Quốc",16090000,16090000,0,0
TIKI,giay-dep-nu,190739763,"Dép Nữ Da Bò Thật BIGGBEN Cao Cấp DNQN48",299000,350000,51000,15
TIKI,giay-dep-nu,176811247,"Giày cao gót nữ đẹp đế vuông 7 phân hàng hiệu rosata hai màu đen trắng ro336",490000,490000,0,0
TIKI,giay-dep-nu,45202482,"Giày Lolita sinh viên nữ Kiểu Nhật",289000,289000,0,0
TIKI,dien-tu-dien-lanh,126702167,"Remote Điều khiển TV dành cho LG AN-MR18BA giọng nói 2017,2018 FULLBOX",353000,353000,0,0
TIKI,giay-dep-nu,58128651,"Dép nữ xỏ ngón đế trấu màu Đen - DETA22D",245000,245000,0,0
TIKI,giay-dep-nu,177643992,"Dép nữ da bò thật BIGGBEN cao cấp DNQN43",299000,350000,51000,15
TIKI,dien-tu-dien-lanh,115765715,"Cảm biến nhiệt độ tủ lạnh, tủ đông, lò sấy THERMOSTAT",75000,75000,0,0
TIKI,giay-dep-nu,105274241,"Dép Xốp Đi Biển Dép Tông Lào Vàng Pixie X719",60000,60000,0,0
TIKI,giay-dep-nu,189318903,"Giày Sandal Nữ The Bily 04W 3 Quai Ngang - Màu Xám BL04WX",339000,339000,0,0
TIKI,dien-tu-dien-lanh,130974681,"Android Tivi TCL 4K 55 inch 55P725 - Hàng chính hãng",11300000,11300000,0,0
TIKI,dien-tu-dien-lanh,191075926,"Máy Giặt Cửa Trước Panasonic 10 Kg NA-V10FC1LVT (Xám) - Diệt khuẩn đến 99.99% - Tính năng sấy tiện ích - Hàng Chính Hãng - Giao Toàn Quốc",12890000,16790000,3900000,23
TIKI,giay-dep-nu,22896294,"Giày cao gót mũi nhọn - GOV3",179000,179000,0,0
TIKI,giay-dep-nu,2683363,"Giày Boot Nữ Cột Dây Huy Hoàng HT7920 - Đen",999000,999000,0,0
TIKI,dien-tu-dien-lanh,75986369,"TX3 mini mới có bộ điều khiển giọng nói tiếng việt hỗ trợ bluetooth 2G Ram 16G Rom Tìm kiếm giọng nói cử chỉ cài sẵn chương trình tivi và xem phim HD miễn phí vĩnh viễn - Hàng nhập khẩu",812250,855000,42750,5
TIKI,giay-dep-nu,175469722,"Giày chạy bộ nữ Under Armour Flow Velociti SE - 3024017",2467000,3795000,1328000,35
TIKI,dien-tu-dien-lanh,247856188,"Motor quạt giải nhiệt dàn nóng 25W",130000,130000,0,0
TIKI,giay-dep-nu,179169630,"Dép nữ thời trang, guốc nữ quai ngang, bằng da, cao 5cm, phù hợp mọi lứa tuổi",135000,135000,0,0
TIKI,dien-tu-dien-lanh,54564368,"Chân kệ kê máy giặt - tủ lạnh - Tặng khăn lau đa năng",49400,52000,2600,5
TIKI,giay-dep-nu,193878566,"Giày lười vải nữ đế cao su mềm cao 2cm",179000,260000,81000,31
TIKI,dien-tu-dien-lanh,23475485,"Tủ lạnh Funiki FR-132I 132L",3850000,3850000,0,0
TIKI,dien-tu-dien-lanh,92760402,"Tủ Lạnh 2 Cánh Panasonic 188 Lít NR-BA229PKVN - Hàng Chính Hãng - Chỉ Giao Tại HCM",6610000,6610000,0,0
TIKI,dien-tu-dien-lanh,104256857," Hệ Thống Máy Lạnh Multi S Daikin Inverter Combo MKC70SVMV/CTKC35RVMV+CTKC35RVMV+CTKC50RVMV Gas R32 Treo Tường 1 Chiều Lạnh Hàng Chính Hãng - Chỉ giao tại HCM",48655000,48655000,0,0
TIKI,dien-tu-dien-lanh,73522114,"Công tắc cánh 2 dây cho tủ lạnh, tủ quần áo",13000,13000,0,0
TIKI,dien-tu-dien-lanh,189634014,"Remote Dành Cho TCL Điều Khiển Tivi Nhận Giọng Nói, Smart TV Netflix Youtube",248000,248000,0,0
TIKI,dien-tu-dien-lanh,203280572,"Android TV 4K UHD Philips 50PUT7906/74- Model 2022- Hàng chính hãng",10900000,10900000,0,0
TIKI,dien-tu-dien-lanh,123430929,"ỐNG DÂY THOÁT NƯỚC MÁY GIẶT, DÂY NHỰA DẺO SUN, ỐNG NHỰA SUN THAY THẾ Ở XI PHÔNG CHẬU RỬA BÁT VÀ MÁY GIẶT",8400,8400,0,0
TIKI,dien-tu-dien-lanh,44043298,"Điều khiển từ xa dành cho quạt cây panasonic ",360000,360000,0,0
TIKI,dien-tu-dien-lanh,113048570,"Điều khiển điều hoà Daikin 2 chiều.",57000,57000,0,0
TIKI,dien-tu-dien-lanh,126702137,"Remote Điều khiển từ xa Tivi dành cho Sony RM ED054",23000,23000,0,0
TIKI,dien-tu-dien-lanh,126702181,"Remote Điều khiển từ xa điều hòa dành cho Sharp 1&2 chiều Inverter dùng cho các dòng AH-X AH-A AY-A",67000,67000,0,0
TIKI,dien-tu-dien-lanh,98735777," Điều hòa thắt lưng mini tiện lợi",897000,897000,0,0
TIKI,dien-tu-dien-lanh,134250875,"Tủ lạnh Toshiba Inverter 311 lít GR-RT395WE-PMV(06)-MG - Hàng chính hãng - Giao hàng toàn quốc",9000000,9000000,0,0
TIKI,dien-tu-dien-lanh,14473287,"Điều Hòa Funiki SC12MMC2 (12.000Btu) - Hàng Chính Hãng",5980000,5980000,0,0
TIKI,dien-tu-dien-lanh,119194489,"Các loại remote dành cho máy lạnh Daikin",75000,75000,0,0
TIKI,dien-tu-dien-lanh,139440698,"Máy giặt sấy LG Inverter 13 kg FV1413H3BA - Chỉ giao tại Hà Nội",20200000,20200000,0,0
TIKI,dien-tu-dien-lanh,270057390,"Remote Điều Khiển TV Dành Cho SHARP GB234WJSA Smart Tivi NETFLIX YOUTUBE Kèm Pin",42000,42000,0,0
TIKI,dien-tu-dien-lanh,172360490,"Remote Điều Khiển Dùng cho Quạt Mitsubishi (Đã có pin)",66000,66000,0,0
TIKI,dien-tu-dien-lanh,35522516,"Tủ lạnh Aqua Inverter 235 lít AQR-T249MA PB  - HÀNG CHÍNH HÃNG",7190000,7190000,0,0
TIKI,dien-tu-dien-lanh,4586663,"Máy giặt Aqua 7.2 kg AQW-S72CT",4600000,4600000,0,0
TIKI,dien-tu-dien-lanh,106419884,"Anten 2.4 GB - nRF24L01 Khớp Nối Hai Loại",32000,32000,0,0
TIKI,dien-tu-dien-lanh,39371927,"Chân đế màn hình đa năng DK5 14 - 27 inch điều chỉnh góc nhìn tiện lợi hàng nhập khẩu",260000,260000,0,0
TIKI,giay-dep-nu,115263779,"Giày sandal nữ Đế cao Thái Lan YW 570",260000,260000,0,0
TIKI,dien-tu-dien-lanh,1892027,"Giá Treo Tivi Đa Năng 40 - 70 Inches North Bayou IN-P6 - Hàng Chính Hãng",390000,390000,0,0
TIKI,giay-dep-nu,67305593,"Giày Cao Gót Đế Xuồng 5p Quai Bính",220000,220000,0,0
TIKI,giay-dep-nu,196342649,"Dép Thái Lan nữ quai đúc siêu nhẹ Monobo moniga 10.5",90000,90000,0,0
TIKI,dien-tu-dien-lanh,75595314,"Chuột Bay g20s pro bản cao cấp mic voice có điều khiển giọng nói và chuột bay đèn nền",284050,299000,14950,5
TIKI,giay-dep-nu,55073373,"Sandal Cao Gót Nữ Da Bò BIGGBEN Cao Cấp SDCG47",349000,450000,101000,22
TIKI,dien-tu-dien-lanh,56105956,"Máy sấy cửa trước Electrolux EDC804CEWA (8kg) - Hàng chính hãng - Chỉ giao tại Hà Nội",15190000,15190000,0,0
TIKI,giay-dep-nu,144358494,"Sandal nữ đi mưa cao 3.5p thời trang mới nhất V289",54000,54000,0,0
TIKI,giay-dep-nu,152070812,"Dây giày dẹt đủ size nhiều màu cột giầy thể thao sneaker boot buộc áo quần dài 100cm 150cm 180cm đen trắng xám Sans942",20000,20000,0,0
TIKI,dien-tu-dien-lanh,273654498,"Ron tủ lạnh kiểu bắt vít dài 2 mét",90000,90000,0,0
TIKI,giay-dep-nu,72039444,"Giày Búp Bê Nữ Da Bò BIGGBEN Cao Cấp BB74",309000,400000,91000,23
TIKI,dien-tu-dien-lanh,162736030,"Tủ lạnh LG Inverter 335L GN-M332PS - Chỉ giao Hà Nội",7890000,7890000,0,0
TIKI,giay-dep-nu,170167867,"Dép Bông Đi Trong Nhà Hình Gấu",42000,45000,3000,7
TIKI,dien-tu-dien-lanh,50412958,"Remote Điều Khiển Cho TV LCD, TV LED TOSHIBA CT-90336 GRADE A+ (Kèm Pin AAA Maxell)",40000,40000,0,0
TIKI,dien-tu-dien-lanh,66810911,"Máy rửa bát Eurosun SMS58EU09BT - NHẬP KHẨU ĐỨC",12999000,12999000,0,0
TIKI,giay-dep-nu,108311449,"Dép Sục Nữ Da Bò BIGGBEN Cao Cấp SBN39",319000,400000,81000,20
TIKI,dien-tu-dien-lanh,113048768,"Điều khiển điều hòa Daikin - Hàng Chính Hãng",65000,65000,0,0
TIKI,giay-dep-nu,171873884,"Giày Sneakers Nữ Sọc Caro Cá Tính TOMOYO "SIÊU NHẸ" TMW31200",800000,800000,0,0
TIKI,giay-dep-nu,50493445,"Giày sneaker thể thao nữ buộc dây siêu nhẹ V223",54000,54000,0,0
TIKI,giay-dep-nu,190705701,"Dép bánh mì đế lượn sóng Sticker gấu HOT",99000,99000,0,0
TIKI,giay-dep-nu,188733884,"Sandal nữ đế bắng 3F",209000,209000,0,0
TIKI,giay-dep-nu,175469644,"Giày thể thao nữ Under Armour HOVR Apex 3 - 3024272",2766000,4255000,1489000,35
TIKI,giay-dep-nu,145771389,"Giày lười nữ da bò thật BIGGBEN cao cấp BB115",309000,400000,91000,23
TIKI,giay-dep-nu,192230457,"Giày thể thao nữ phong cách trẻ trung, năng động – GNU2029",409000,870000,461000,53
TIKI,giay-dep-nu,193564756,"Giày nữ thời trang cao cấp ELLY – EG182",659400,1099000,439600,40
TIKI,giay-dep-nu,11724503,"Giày búp bê nữ SP34",215000,215000,0,0
TIKI,giay-dep-nu,76267112,"Giày Thể Thao Vải Nữ Phong Cách Hàn Quốc, Đế Cao Su Dễ Đi, Dễ Phối Đồ GN31",45000,50000,5000,10
TIKI,giay-dep-nu,198431306,"Dép Đế Xuồng Nữ BIGBEN Da Bò Thật Cao 5 Phân DX40",349000,400000,51000,13
TIKI,giay-dep-nu,197607005,"Dép đế trấu quai bản / Nam nữ",300000,300000,0,0
TIKI,giay-dep-nu,163294294,"Miếng dán lót giày silicon trong suốt êm chân",10000,10000,0,0
TIKI,giay-dep-nu,53112821,"Dép chiếu Hương Quế DCQ-50 làm từ lụa tơ tằm - vải cotton - lớp đế cao su xốp cho đôi chân thơm, mát và khô thoáng - Xanh",68000,68000,0,0
TIKI,dien-tu-dien-lanh,90148837,"Máy giặt Samsung Inverter 8.5kg WW85T554DAX/SV - Chỉ giao Hà Nội",9200000,9200000,0,0
TIKI,giay-dep-nu,153561571,"Giày Sandal Nữ Quai Dây Mảnh TiTi ĐÔ Thời Trang Cao Cấp DNU2111a",320000,320000,0,0
TIKI,giay-dep-nu,67601506,"Dép Sục Bệt Mũi Nhọn Gắn Khóa Màu Trắng Pixie P170",420000,420000,0,0
TIKI,giay-dep-nu,177874061,"[HÀNG XỊN] Giày sandal xuồng 6 phân 4 dây bảng to S018 đế đúc chống trượt chắc chắn",234000,249000,15000,6
TIKI,giay-dep-nu,44573182,"Giày nữ Huy Hoàng màu đỏ HT7065",489000,489000,0,0
TIKI,giay-dep-nu,133811015,"Giày boot nữ cổ thấp 4 phân hàng hiệu rosata hai màu đen trắng ro301",550000,550000,0,0
TIKI,giay-dep-nu,125098821,"Gìay lưới nữ Anh Khoa D85-1",190000,190000,0,0
TIKI,giay-dep-nu,44894526,"Độn giày silicon đệm khí êm chân 3 lớp, lót giày cả bàn tăng chiều cao 7cm siêu tiện ích, mã DG3L - màu ĐEN",59800,59800,0,0
TIKI,giay-dep-nu,47347255,"Miếng lót giày mút giảm đau đầu ngón cho giày bít ngón, đệm êm ngón chân dành cho giày nam và nữ",15000,15000,0,0
TIKI,giay-dep-nu,186633861,"Dép Nữ Da Bò Thật BIGGBEN Cao 3 Phân DNQN45",309000,400000,91000,23
TIKI,giay-dep-nu,98540185,"Giày Thể Thao Nữ Đế Cao 3cm Trẻ Trung, Năng Động 803",350000,350000,0,0
TIKI,giay-dep-nu,201799346,"Bốt Nữ Đế Bánh Mì Boots Da Mềm Lót Nỉ Khóa Sau Cao Cấp Boot Mũi Tròn Thời Trang Đế Độn PINKAHA-GB20 ( Video Thật )",435000,435000,0,0
TIKI,giay-dep-nu,193310462,"Giày lười vải nữ đế cao su mềm, cao 2cm",119000,149000,30000,20
TIKI,giay-dep-nu,14265739,"Giày búp bê da bò cao cấp Trường Hải BB003",240000,280000,40000,14
TIKI,giay-dep-nu,161404584,"xăng đan nữ đế đen quai đen phối trắng size từ 34 đến 42",38999,38999,0,0
TIKI,giay-dep-nu,146136957,"Dây giày sneaker thể thao tròn trơn chất dù ngắn 60cm 70cm dài 1m 1m6 1m8 Sans940",20000,20000,0,0
TIKI,giay-dep-nu,180364499,"Dép nữ quai ngang siêu nhẹ Thái Lan ADDA 82M25",140000,140000,0,0
TIKI,giay-dep-nu,110461293,"Giày Nữ Búp Bê Đế Xuồng HÀ NAM Da Bò Thật Cao Cấp 4cm GBBN2039",379000,379000,0,0
TIKI,giay-dep-nu,191310996,"Dép sục bánh mì Cross nữ đế 6cm siêu nhẹ tặng kèm Sticker dễ thương
Cros-01",119000,119000,0,0
TIKI,dien-tu-dien-lanh,154475972,"Máy Rửa Chén Mini Electrolux ESF6010BW - 6 Chương Trình Rửa - Điều Khiển Cảm Ứng - Hàng Chính Hãng",6990000,9990000,3000000,30
TIKI,dien-tu-dien-lanh,54414908,"Tủ Lạnh Inverter Samsung RT22M4032BU/SV (236L) - Hàng Chính Hãng - Chỉ Giao tại Hà Nội",6050000,6050000,0,0
TIKI,dien-tu-dien-lanh,36457818,"Tủ lạnh Samsung Inverter 236 lít RT22M4040DX/SV",5500000,5500000,0,0
TIKI,dien-tu-dien-lanh,142860651,"TỦ MÁT MINIBAR KHÁCH SẠN BCG-24B ",3850000,3850000,0,0
TIKI,dien-tu-dien-lanh,556124,"Khung treo tivi áp tường 37 - 63 inch C6.4 - Hàng Chính Hãng",98000,98000,0,0
TIKI,dien-tu-dien-lanh,73798564,"Tủ đông đứng Hòa Phát 106l 4 ngăn HUF 300SR1 - Hàng chính hãng",5600000,5600000,0,0
TIKI,dien-tu-dien-lanh,4678991,"Giá Treo 2 Màn Máy Tính Gắn Bàn Đa Năng Nhập Khẩu North Bayou F160 (17-27 inch)",528000,528000,0,0
TIKI,dien-tu-dien-lanh,123602321,"cáp 2K dành cho tivi LG",100000,100000,0,0
TIKI,dien-tu-dien-lanh,50560451,"Tủ Lạnh Aqua AQR-T150FA-BS (130L) - Hàng Chính Hãng - Chỉ giao tại Hà Nội",4277000,4277000,0,0
TIKI,dien-tu-dien-lanh,41298883,"Thanh Magie Lọc Cặn Bình Nóng Lạnh",35000,35000,0,0
TIKI,dien-tu-dien-lanh,161409071,"Máy Rửa Chén Độc Lập HAFELE NERO HDW-F60F 533.23.310 - 15 Bộ - Hàng Chính Hãng",28809000,28809000,0,0
TIKI,dien-tu-dien-lanh,112222836,"Dây Cấp Nước Máy Giặt 3M nhựa cho máy giặt cửa ngang",150000,150000,0,0
TIKI,dien-tu-dien-lanh,157290376,"Máy lạnh-Điều hòa Panasonic CU-CS-YZ18XKH-8 - Hai chiều - Inverter tiêu chuẩn - Hàng chính hãng - 2 HP",25840000,29715500,3875500,13
TIKI,dien-tu-dien-lanh,91536261,"REMOTE ĐIỀU KHIỂN TIVI SAMSUNG SMART 4K ONE REMOTE",29900,29900,0,0
TIKI,dien-tu-dien-lanh,52847555,"Máy Giặt Cửa Trên Toshiba AW-K1005FV-SG (9kg) - Hàng Chính Hãng - Chỉ Giao tại Hà Nội",7100000,7100000,0,0
TIKI,dien-tu-dien-lanh,81183462,"Bộ hàn gió đá mini màu đỏ",1285000,1285000,0,0
TIKI,dien-tu-dien-lanh,93232149,"REMOTE ĐIỀU KHIỂN DÀNH CHO MÁY LẠNH ĐIỀU HOÀ DAIKIN",158500,158500,0,0
TIKI,dien-tu-dien-lanh,108843984,"20 cái nút nhấn 4 chân 6*6*5",10000,10000,0,0
TIKI,dien-tu-dien-lanh,171273508,"(tặng dây sỏ) Túi trùm vệ sinh máy lạnh treo tường - Áo bọc hứng nước rửa điều hòa giá sốc - Xanh đen",60000,60000,0,0
TIKI,dien-tu-dien-lanh,178058676,"Google Tivi Sony 4K 43 inch KD-43X81DK - Model 2022",11500000,11500000,0,0
TIKI,dien-tu-dien-lanh,102108757,"Ty inox (ren+trơn) phi 27 dùng cho máy nước nóng năng lượng mặt trời",33000,35000,2000,6
TIKI,dien-tu-dien-lanh,195740218,"Android tivi box magicsee n5 max x4 Rom 64G Ram 4G  điều khiển giọng nói tiếng Việt kiêm bàn phím chuột bay có đèn nền wifi 2 băng tần bluetooth S905X4 cài sẵn phim, truyền hình cáp miễn phí vĩnh viễn - Hàng nhập khẩu",1804050,1899000,94950,5
TIKI,dien-tu-dien-lanh,123602341,"Cáp tivi từ vỉ chính lên màn hình các loại",200000,200000,0,0
TIKI,dien-tu-dien-lanh,195916564,"Máy sấy quần áo Electrolux 7.5 kg EDV754H3WB Trắng - Hàng chính hãng [Giao HCM/HN]",9370000,9990000,620000,6
TIKI,dien-tu-dien-lanh,20558015,"Tủ lạnh Toshiba Inverter 180 lít GR-B22VU UKG ",5600000,5600000,0,0
TIKI,dien-tu-dien-lanh,56850885,"Tủ lạnh Hitachi 406 lít R-FVX510PGV9(GBK) ",14580000,17010000,2430000,14
TIKI,dien-tu-dien-lanh,184419332,"Tủ lạnh mini Kemin K4 Angry Bear Chính Hãng 4L - Dùng ở nhà và ô tô - Nóng lạnh 2 chiều",1045000,1100000,55000,5
TIKI,dien-tu-dien-lanh,194472138,"Google Tivi Qled+ 65 Inch - 65Y72 PRO - Hàng Chính Hãng",11990000,20000000,8010000,40
TIKI,dien-tu-dien-lanh,50560420,"Tủ lạnh Aqua 90 lít AQR-D99FA(BS)",3290000,3290000,0,0
TIKI,dien-tu-dien-lanh,121268098,"Máy giặt LG Inverter 9 kg FV1409S4W - Hàng chính hãng(Giao Toàn Quốc)",8530000,8530000,0,0
TIKI,dien-tu-dien-lanh,73622933,"Remote Điều Khiển Dành Cho Máy Lạnh, Điều Hòa Panasonic Chức Năng iAUTO",50000,50000,0,0
TIKI,dien-tu-dien-lanh,184414046,"Phuộc dành cho máy giặt Electrolux cửa trước hàng mới 100%",130000,130000,0,0
TIKI,dien-tu-dien-lanh,195961022,"Tủ lạnh Panasonic Inverter 306 lít NR-TV341VGMV - Hàng chính hãng [Giao hàng toàn quốc]",13430000,14490000,1060000,7
TIKI,dien-tu-dien-lanh,126701914,"Remote Điều khiển từ xa điều hòa âm trần dành cho Daikin  FCNQ/RZQ FCQ/RZQ",125000,125000,0,0
TIKI,dien-tu-dien-lanh,166449013,"Máy Rửa Chén Bosch SMS46GI01P - Series 4 - Sức chứa 12 Bộ - Hàng Chính Hãng",13300000,13300000,0,0
TIKI,dien-tu-dien-lanh,126701946,"Điều khiển tivi dành cho Samsung Qled Tivi ",699200,736000,36800,5
TIKI,dien-tu-dien-lanh,144489753,"Tủ lạnh Panasonic 4 cánh ngăn đá dưới 540L NR-YW590YMMV - Hàng Chính Hãng",62990000,72490000,9500000,13
TIKI,dien-tu-dien-lanh,195928027,"Tủ lạnh Toshiba Inverter 322 lít GR-RB405WE-PMV(06)-MG - Hàng chính hãng [Giao hàng toàn quốc]",10410000,17040000,6630000,39
TIKI,dien-tu-dien-lanh,118053324,"Remote điều khiển dành cho máy lạnh Panasonic inverter ( tặng kèm pin )",85000,85000,0,0
TIKI,dien-tu-dien-lanh,53650065,"Điều Hòa 2 Chiều LG Inverter 12000 Btu B13END - Chỉ giao tại Hà Nội",10890000,10890000,0,0
TIKI,giay-dep-nu,48930886,"Miếng lót cho giày rộng V.11 miếng lót giảm size giày cho giày rộng - Màu kem",15000,15000,0,0
TIKI,giay-dep-nu,153515458,"Dép chiếu mang trong nhà Hương Quế",68000,68000,0,0
TIKI,giay-dep-nu,207024183,"Giầy Thể Thao nữ B9811 Thiết Kế Kiểu Lưới Kín",299000,299000,0,0
TIKI,giay-dep-nu,57711487,"Dép đi trong nhà massage MT10 ( xanh cô ban)",89000,89000,0,0
TIKI,giay-dep-nu,8641346,"Bộ 1 cặp lót giày tăng chiều cao gel nửa bàn 2 lớp (cao 4cm)",30600,30600,0,0
TIKI,giay-dep-nu,126092809,"Dép Đế Trấu Nữ Quai Chéo Detaunisex Màu Trắng - DETA23T",300000,300000,0,0
TIKI,giay-dep-nu,153411908,"[Dép nữ][GDSG11] Dép đi trong nhà cực kỳ xinh xắn, Dép trong nhà kẻ sọc [Ảnh thật",46000,46000,0,0
TIKI,giay-dep-nu,138822114,"MỘT ĐÔI MIẾNG LÓT ĐỆM ÊM MŨI GIÀY, GUỐC CHO NỮ",18000,18000,0,0
TIKI,giay-dep-nu,137673823,"Combo 4 miếng lót giày AIR có đệm khí siêu êm ái GIÀY ĐỘN giày cao độn gót",39000,39000,0,0
TIKI,giay-dep-nu,197516391,"COMBO 4 Miếng Đệm Gel Lót Giày Tăng Chiều Cao Hamart Tuyệt Đỉnh Êm Ái Thoải Mái Gấp 4 Lần",41000,90000,49000,54
TIKI,giay-dep-nu,127379464,"Xịt Khử Mùi Hôi Chuyện Dụng Chính Hãng Dincox X Matteo",60000,60000,0,0
TIKI,giay-dep-nu,96011452,"Giày nhựa nữ đi mưa thời trang, giày y tá nữ siêu êm",59000,59000,0,0
TIKI,giay-dep-nu,52252644,"Lót độn đế silicon nguyên khối trong suốt tăng 1cm, 2cm, 3cm chiều cao - buybox - BBPK47",65000,120000,55000,46
TIKI,giay-dep-nu,56747495,"Giày sandal nữ TRƯỜNG HẢI thời trang cao cấp đế kếp siêu nhẹ XDN0159",236000,279000,43000,15
TIKI,giay-dep-nu,191500752,"Giày sandal nữ cao gót 7 phân hàng hiệu rosata hai màu đen kem ro418",430000,430000,0,0
TIKI,giay-dep-nu,163911947,"Combo 10 đôi dép xốp cho khách sạn,nhà nghỉ màu trắng , xanh, đen",112500,112500,0,0
TIKI,giay-dep-nu,168105736,"Chai xịt khử mùi mũ bảo hiểm, giày dép Hando 120ml",26000,26000,0,0
TIKI,giay-dep-nu,50449568,"Giày lười nhựa nữ đi mưa đi biển V163",51000,51000,0,0
TIKI,giay-dep-nu,19761110,"Dán Gót Giày Chống Phồng Rộp Chân Lót Cho Giày Rộng",14500,14500,0,0
TIKI,giay-dep-nu,177553640,"Combo 2 Miếng lót gót giầy hình bướm có keo dán vào giầy  21165 - kaki",38000,65145,27145,42
TIKI,giay-dep-nu,55863950,"Sandal trơn (Tặng kèm kẹp tóc ngẫu nghiên)",170000,170000,0,0
TIKI,giay-dep-nu,126122201,"Giày Đế Trấu Xỏ Ngón Sandal Quai Hậu Nữ Detaunisex Màu Trắng - SATA22T",350000,350000,0,0
TIKI,giay-dep-nu,244691260,"WAO Fashion - Giày sandal cao gót nữ mũi vuông quai nhún cao 4cm - WA01",139000,139000,0,0
TIKI,giay-dep-nu,15879754,"Chai xịt vệ sinh tẩy trắng giày dép  - Xi đánh giày không màu - Phụ kiện thời trang",99000,99000,0,0
TIKI,giay-dep-nu,125021600,"( HÀNG SẴN) Giày Vải Lười Tăng Chiều Cao Phong Cách Châu Âu AG38 - Hàng Quảng Châu Cao Cấp",325000,325000,0,0
TIKI,giay-dep-nu,85137283,"Giày quai ngang nữ giày sandals nữ dép quai hậu nữ cao 2.5 cm-  MÃ 588-61",299000,399000,100000,25
TIKI,giay-dep-nu,11782941,"Giày đế xuồng phối ren nữ cao cấp Kem, Đen 9 phân full size full box có ảnh thật Size 35 đến 40 V68",119000,119000,0,0
TIKI,giay-dep-nu,48995625,"Dép lỗ táo đi trong nhà, nhà tắm nâu",22000,22000,0,0
TIKI,giay-dep-nu,244750140,"WAO Fashion - Giày Sandal nữ xỏ ngón dây mảnh thời trang cao 5cm - WC01",159000,159000,0,0
TIKI,giay-dep-nu,263041569,"Dép lê nam nữ đi trong nhà thêu hoạt tiết Vintage Hàn Quốc , Dép văn phòng vải lanh chống trơn trượt TA.Kẻ Hoa 96",48000,48000,0,0
TIKI,giay-dep-nu,116623618,"Dép Có Lỗ đi trong nhà tắm / đi trong văn phòng siêu êm siêu thoáng TL02",25000,25000,0,0
TIKI,giay-dep-nu,107801853,"Cặp Lót Gót Giày XIMO XC01X Bảo vệ Gót Giày Khỏi Trầy Xước, Chống Nhấc Và Đau Gót",12000,18000,6000,33
TIKI,giay-dep-nu,2600431,"Chai xịt khử mùi giày dép, mũ bảo hiểm 120ml Hando",25000,25000,0,0
TIKI,giay-dep-nu,125098644,"Giày lười nữ Anh Khoa A993",199000,199000,0,0
TIKI,giay-dep-nu,57712064,"Dép đi trong nhà massage huyệt đạo MT1 (TÍM)",89000,89000,0,0
TIKI,giay-dep-nu,2601613,"Bộ 3 chai xịt khử mùi giày dép, mũ bảo hiểm 120ml Hando",68000,68000,0,0
TIKI,giay-dep-nu,160887203,"[Loại Tốt] Chai Tẩy Trắng Vết Dơ - Ố Vàng - Ẩm Mốc Giày Dép KhoNCC Hàng Chính Hãng - Nhanh Chóng và Hiệu Quả Tức Thì",15000,25000,10000,40
TIKI,giay-dep-nu,132820926,"Miếng dán gót giày chống trầy chân silicon trong",10000,10000,0,0
TIKI,giay-dep-nu,115715354,"Giày bata đế bằng thiết kế meow cho nữ dáng thể thao",129000,129000,0,0
TIKI,giay-dep-nu,195465015,"Cặp Miếng mút lót mũi giày êm chân cho giày cao gót , giày bị chật, bị rộng, giảm đau ngón chân cho giày chật #lot38",35000,35000,0,0
TIKI,giay-dep-nu,147754911,"Dép nữ quai ngang Kito Thái Lan AH12 , siêu nhẹ, siêu bền",180000,180000,0,0
TIKI,giay-dep-nu,22896356,"Giày nữ GLC1",220000,220000,0,0
TIKI,giay-dep-nu,162876103,"Sandal trệt Lihsing nữ",369000,369000,0,0
TIKI,giay-dep-nu,24896854,"Giày moca công sở nữ, giày moi nữ đế cao su mềm siêu êm - Mã SP : MC2",199000,199000,0,0
TIKI,giay-dep-nu,76299288,"Giày Búp Bê Nữ Da Bò BIGGBEN Cao Cấp BB78",259000,400000,141000,35
TIKI,giay-dep-nu,126131924,"Miếng Lót Gót Giày Silicon Chống Đau Gót Chân Khi Đi Giày Cao Gót Detaunisex - LGS2",15000,15000,0,0
TIKI,giay-dep-nu,28625283,"Giày đế xuồng phối ren nữ cao cấp 9 phân full size full box có ảnh thật V68",119000,119000,0,0
TIKI,giay-dep-nu,174113244,"Giày Cao Gót (DA THẬT) Da Mềm Lót Êm Chân - Đính Khoá Cao Cấp 517E18 FFAN STORE",450000,450000,0,0
TIKI,giay-dep-nu,107153671,"Dép Xỏ Ngón Nữ Da Bò BIGGBEN Cao Cấp DXN34",289000,350000,61000,17
TIKI,giay-dep-nu,204120782,"CONVERSE - Giày sneakers cổ cao unisex Run Star Hike Platform Global Logo A03776C",2500000,2500000,0,0
TIKI,dien-tu-dien-lanh,73873120,"Remote Điều Khiển Dành Cho Máy Lạnh, Máy Điều Hòa Không Khí LG",56000,56000,0,0
TIKI,dien-tu-dien-lanh,36549940,"[Bản quốc tế] Android Tivi Box Xiaomi Mibox S 4K (Android 8.1) Phân phối bởi Digiword - Hàng chính hãng",1490000,1490000,0,0
TIKI,dien-tu-dien-lanh,32391624,"TỦ LẠNH PANASONIC 322 LÍT NR-BV360QSVN - Hàng Chính Hãng",13900000,13900000,0,0
TIKI,dien-tu-dien-lanh,126702203,"Remote Điều khiển TV dành cho Samsung giọng nói dòng tivi MU 2017",470000,470000,0,0
TIKI,giay-dep-nu,190829000,"Dép bánh mì dép nữ 2 quai da đế Pu siêu nhẹ êm chân đôn 3 phân tôn dáng sandal nữ",179000,179000,0,0
TIKI,giay-dep-nu,161298273,"Giày Đế Xuồng Nữ Quai Chéo, Giày Sandal Quai Ngang Chính Hãng Cao Cấp Cho Nữ Tôn Dáng Dễ Phối Đồ 10Cm",599000,599000,0,0
TIKI,giay-dep-nu,143859187,"Giày Mũi Nhọn Gót Vuông (DA THẬT) Da Mềm Gót Mềm - Màu Đen Be Hồng Trắng FFAN STORE",450000,450000,0,0
TIKI,giay-dep-nu,149147409,"Giày Sandal Nữ HÀ NAM Da Bò Thật Cao Cấp 5cm DNU2093",331000,331000,0,0
TIKI,giay-dep-nu,73287239,"GIÀY BOOT NỮ CỔ THẤP ĐẾ VUÔNG THỜI TRANG HÀN QUỐC GIAY.BOT885",249390,489000,239610,49
TIKI,dien-tu-dien-lanh,19391450,"Tủ Lạnh Samsung Inverter RT32K5932S8/SV (319L) - Hàng chính hãng",9950000,9950000,0,0
TIKI,dien-tu-dien-lanh,191089565,"Máy Giặt Sấy Cửa Trước Panasonic 9,5 Kg giặt 6kg sấy NA-S956FR1BV - Diệt khuẩn đến 99.99% - Giặt sấy 2 trong 1- Hàng Chính Hãng (Đen) - Giao Toàn Quốc",16990000,21990000,5000000,23
TIKI,giay-dep-nu,191725663,"Miếng lót gót giày Sans930 đệm dán êm chân chống rộng bị đau trầy trượt giầy cao búp bê có thể tái sử dụng",4999,4999,0,0
TIKI,giay-dep-nu,133004164,"Giày boot nữ cổ thấp 4 phân hàng hiệu rosata hai màu đen kem ro308",550000,550000,0,0
TIKI,dien-tu-dien-lanh,195961301,"Tủ lạnh Hitachi Inverter 339 lít R-FVX450PGV9(GBK) - Hàng chính hãng [Giao hàng toàn quốc]",12490000,15050000,2560000,17
TIKI,dien-tu-dien-lanh,195218061,"Đầu thu kts truyền hình mặt đất DVB T2 LTP 1306 tặng anten 15m dây",389000,389000,0,0
TIKI,giay-dep-nu,242064585,"Dép quai ngang nữ Skechers Foamies - 111511-PCH",690000,690000,0,0
TIKI,dien-tu-dien-lanh,45025226,"Máy Giặt Sharp ES-W100PV-H 10 Kg - HÀNG CHÍNH HÃNG",5480000,5480000,0,0
TIKI,dien-tu-dien-lanh,186270717,"Smart Tivi 4K UHD Casper 58 Inch 58UX5200 - Hàng Chính Hãng - Chỉ Giao Hà Nội",10000000,10000000,0,0
TIKI,giay-dep-nu,149212138,"Dép lỗ đi trong nhà nhựa VIP siêu mềm( hàng loại 1)",25000,25000,0,0
TIKI,giay-dep-nu,269890051,"Dép bít đầu nữ siêu nhẹ có quai hậu có nơ quai trong model hiện đại cao cấp",80000,80000,0,0
TIKI,dien-tu-dien-lanh,147974855,"Remote Điều Khiển Máy Lạnh, Máy Điều Hòa Dành Cho Midea RG70A1/BGEF",98000,98000,0,0
TIKI,dien-tu-dien-lanh,11598981,"Tủ lạnh Electrolux Inverter 335 lít EME3700H-A",10590000,10590000,0,0
TIKI,giay-dep-nu,55482514,"Dép sục nữ đính 2 nơ",99000,99000,0,0
TIKI,dien-tu-dien-lanh,123431344,"ĂNG TEN TIVI THU SÓNG DVB T2 - DÂY 12M, 15M-Giadung24h",65000,65000,0,0
TIKI,dien-tu-dien-lanh,137542627,"Remote Điều khiển chuột bay giọng nói G20S SmartTV, TV Box, PC- Full Box",126900,126900,0,0
TIKI,giay-dep-nu,87961116,"Giày sandal nữ HÀ NAM đế xuồng gót cao 6cm DNU2025",400000,400000,0,0
TIKI,dien-tu-dien-lanh,76273923,"Máy Lạnh LG Inverter 2.0 HP V18ENF1 - Chỉ giao tại Hà Nội",13690000,13690000,0,0
TIKI,dien-tu-dien-lanh,48606304,"Bình nóng lạnh Ferroli QQ AE 15L",2127000,2127000,0,0
TIKI,dien-tu-dien-lanh,7749111,"Android Tivi Box Xiaomi Mibox S 4K Global Quốc Tế - Hàng Chính Hãng",1590000,1590000,0,0
TIKI,dien-tu-dien-lanh,31514377,"Remote Điều Khiển Cho Máy Lạnh, Máy Điều Hòa LG 6711A90032L, 6711A90091H, L8004R",56000,56000,0,0
TIKI,dien-tu-dien-lanh,1509685,"Tủ Lạnh Inverter Samsung RT38K5982SL/SV (368L) - Bạc - Hàng chính hãng ",12950000,12950000,0,0
TIKI,giay-dep-nu,184069097,"HAVAIANAS - Dép nữ Slim Glitter II 4146975-5178",949000,949000,0,0
TIKI,giay-dep-nu,59453678,"Giày xăng đan nữ quai ngang Trường Hải da bò thật màu  đen gót vuông đế PU siêu nhe  cao 5cm màu đen SDN0741 [HÌNH ẢNH THẬT",253000,299000,46000,15
TIKI,giay-dep-nu,61278540,"Giày thể thao nữ hoa cúc đi bộ cực êm siêu xinh V253 - Đỏ đô - Size 37",55000,55000,0,0
TIKI,dien-tu-dien-lanh,11488721,"Bình Nước Nóng Nishu NS-325KC (30 Lít) - Hàng chính hãng",2950000,2950000,0,0
TIKI,giay-dep-nu,6837287,"Combo 2 bộ miếng lót cho giày rộng V.5 - Màu Đen (2 miếng dán/bộ)",60000,60000,0,0
TIKI,dien-tu-dien-lanh,126702124,"Remote Điều khiển từ xa dành cho Tivi Casper,có điều khiển giọng nói",77000,77000,0,0
TIKI,giay-dep-nu,108703849,"Giày Sandal Đế Xuồng Nữ Da Bò BIGGBEN Cao Cấp SDX32",299000,450000,151000,34
TIKI,giay-dep-nu,67726408,"HAVAIANAS - Dép nữ Slim 4000030-3581-334",699000,699000,0,0
TIKI,giay-dep-nu,143672619,"Dép đi nhà tắm, trong nhà chống trơn thiết kế kiểu Hàn Quốc",99000,99000,0,0
TIKI,dien-tu-dien-lanh,3564301,"Remote Điều Khiển Máy Lạnh, Máy Điều Hòa DAIKIN ARC423A Series, ARC433A2, ARC433A5",51000,51000,0,0
TIKI,giay-dep-nu,190706537,"Giày bít mũi gót vuông da lì cao cấp - Giày gót vuông cao 5p - Giày bít mũi",229000,229000,0,0
TIKI,giay-dep-nu,262058859,"Giày Nữ Búp Bê BIGGBEN Da Bò Thật Cao Cấp BB66",309000,400000,91000,23
TIKI,dien-tu-dien-lanh,119967862,"Tủ lạnh Samsung Inverter 307 lít RB30N4190BU/SV - Chỉ giao tại HN",11229000,11229000,0,0
TIKI,dien-tu-dien-lanh,114993678,"Tủ lạnh Panasonic Inverter 366 lít NR-TL381GPKV- Chỉ giao tại Hà Nội",13599000,13599000,0,0
TIKI,dien-tu-dien-lanh,128354082,"Smart Tivi Casper Full HD 43 inch 43FX5200",4890000,4890000,0,0
TIKI,dien-tu-dien-lanh,83432711,"Tủ Lạnh Electrolux Inverter 308L EBB3442K-A - Chỉ Giao Hà Nội",9490000,9490000,0,0
TIKI,dien-tu-dien-lanh,113253969,"đầu thu kỹ thuật số DVB T2 MOBITV, Hàng Chính Hãng",99000,99000,0,0
TIKI,dien-tu-dien-lanh,174228440,"Bo mạch dành cho máy giặt SAMSUNG DC92 020190",700000,700000,0,0
TIKI,dien-tu-dien-lanh,165964632,"Bộ ron tủ lạnh dành cho tủ lạnh sanyo SR - U21MN",238000,238000,0,0
TIKI,giay-dep-nu,41133003,"Giày lười nữ AK3",600000,600000,0,0
TIKI,dien-tu-dien-lanh,141111337,"Máy giặt Electrolux Inverter 8 kg EWF8024P5WB - chỉ giao Hà Nội",7790000,7790000,0,0
TIKI,giay-dep-nu,45302668,"Giày thời trang dành cho nữ - G03.4 đen",169000,169000,0,0
TIKI,dien-tu-dien-lanh,42316060,"Remote Điều Khiển Dùng Cho Máy Lạnh, Điều Hòa TCL TAC-12CSA/XA41 GYKQ-52",54000,54000,0,0
TIKI,giay-dep-nu,20263555,"Dép Sục Cá Sấu Duet Đen đế Đỏ +8Jibbitz/Sticker",94500,94500,0,0
TIKI,dien-tu-dien-lanh,76022138,"Bánh xe quạt hơi nước, quạt điều hoà, ghế xoay",50000,50000,0,0
TIKI,dien-tu-dien-lanh,169771747,"Smart Tivi QLED The Frame Samsung 4K 75 inch QA75LS03B - Model 2022",29450000,29450000,0,0
TIKI,dien-tu-dien-lanh,186105374,"Máy lạnh Casper 2 HP SC-18TL32 - Hàng Chính Hãng",9600000,9600000,0,0
TIKI,giay-dep-nu,192374490,"GIÀY CAO GÓT COLE HAAN NỮ BRIGIT PUMP (45MM) W22032",2190000,5590000,3400000,61
TIKI,dien-tu-dien-lanh,205920845,"Máy Rửa Chén Bát Độc Lập 13 Bộ Châu Âu BOSCH HMH.SMS6ECI93E - Hàng Chính Hãng",37500000,37500000,0,0
TIKI,giay-dep-nu,134156905,"Giày búp bê nữ cao gót 2 phân hai màu đen xanh hàng hiệu rosata ro300",399000,399000,0,0
TIKI,giay-dep-nu,67600792,"Giày Sandal Đế Xuồng 7cm Quai Chéo Màu Nâu Pixie P207",450000,450000,0,0
TIKI,dien-tu-dien-lanh,45327625,"Remote Điều Khiển Dành Cho TV LED, Smart TV Sony RM-L1275",40000,40000,0,0
TIKI,dien-tu-dien-lanh,123547565,"Giá Treo Màn Hình NB H100 22 - 35 Inch - Tay Treo Màn Hình Máy Tính Gắn Bàn Xoay 360 Độ",385000,385000,0,0
TIKI,dien-tu-dien-lanh,1957433,"Bình nước nóng Ferroli Verdi DE30L, 3 cống suất, hiển thị nhiệt độ, có chống giật, 2500W - Hàng chính hãng",2689515,2689515,0,0
TIKI,dien-tu-dien-lanh,95944668,"Điều Hòa Casper 12000 Btu LC-12FS32 - Chỉ giao Hà Nội",6190000,6190000,0,0
TIKI,giay-dep-nu,251447685,"Sandal Biti's nữ đế 3,5cm",335000,335000,0,0
TIKI,dien-tu-dien-lanh,188111058,"Khung Treo Tivi Từ 42-60 Inch",109000,109000,0,0
TIKI,giay-dep-nu,10063044,"Dép đi trong nhà hình khỉ Homegreen loại đặc biệt - freesize - giao màu ngẫu nhiên",46000,90000,44000,49
TIKI,giay-dep-nu,15246345,"Dép Nữ Đế Xuồng BIGGBEN Da Bò Thật DX7",349000,500000,151000,30
TIKI,giay-dep-nu,171197218,"Giày cao gót mũi nhọn màu bạc bóng 11cm",240000,240000,0,0
TIKI,giay-dep-nu,143858938,"Giày Tiếp Viên Hàng Không (DA THẬT) Nữ Công Sở Văn Phòng Mũi Tròn Gót vuông FFAN STORE",430000,430000,0,0
TIKI,giay-dep-nu,194042458,"Giày thể thao độn đế 6cm, sneaker nữ cao cấp, phong cách Hàn Quốc, hot trend, đi học, đi chơi, đi làm",186800,186800,0,0
TIKI,giay-dep-nu,125098698,"giày lưới nữ anh khoa D115-1",190000,190000,0,0
TIKI,giay-dep-nu,193289614,"Giày búp bê nữ da mềm đế cao 2cm",149000,149000,0,0
TIKI,giay-dep-nu,133811270,"Giày boot bốt nữ cổ thấp 7 phân hàng hiệu rosata màu đen ro179",550000,550000,0,0
TIKI,giay-dep-nu,192894003,"Dép Nữ Pierre Cardin - PCWFWSG 179",490000,1290000,800000,62
TIKI,giay-dep-nu,171753001,"Giày sandal nữ đế bằng cao 4.5cm màu đen Trường Hải Thời trang nữ cao cấp",293000,399000,106000,27
TIKI,giay-dep-nu,193777400,"Giày nữ giày lười vải cotton đế cao su mềm cao 3p",119000,149000,30000,20
TIKI,giay-dep-nu,76165155,"HAVAIANAS - Sandal nữ Flash Urban 4000039",699000,699000,0,0
TIKI,giay-dep-nu,72304182,"Dép nữ quai ngang 1 bản da bò đế đúc cao cấp Trường Hải QNN01262",239000,299000,60000,20
TIKI,giay-dep-nu,188147634,"Giày Quai Ôm Cổ Chân 6 CM (DA THẬT) Da Mềm, Cao Gót Nữ Màu Đen Be Hồng Trắng Sữa FFAN STORE",460000,460000,0,0
TIKI,giay-dep-nu,125098567,"Giày lười nữ Anh Khoa H913",220000,220000,0,0
TIKI,giay-dep-nu,190692929,"Giày sandal nữ cao gót 7 phân hàng hiệu rosata hai màu đen xám ro386",430000,430000,0,0
TIKI,giay-dep-nu,16525871,"Giày búp bê nữ đỏ da bò cao cấp Trường Hải BB208",239000,279000,40000,14
TIKI,giay-dep-nu,195328737,"Giày dép Sandals Vento VESPER Nữ đi học/đi dã ngoại/đi chơi SD09003",395000,395000,0,0
TIKI,giay-dep-nu,252824034,"Giày nhựa đi mưa loại thông hơi UB D2001 thời trang-UB001",139000,139000,0,0
TIKI,giay-dep-nu,50181747,"Dép sục thời trang nữ hở mũi da mềm đi biển thoải mái full size nhiều màu V216",69000,69000,0,0
TIKI,giay-dep-nu,181978965,"[ĐỘC LẠ] Dép nhựa mang trong nhà hoạt hình mèo Kitty Happy Cat dễ thương cute siêu nhẹ mềm dép cross xinh S252",168000,179000,11000,6
TIKI,giay-dep-nu,177274182,"Dép Unisex Quai Ngang Hàng Cao Cấp BEE GEE DN1011- Màu Hồng",183000,390000,207000,53
TIKI,giay-dep-nu,160830653,"Giày thể thao convese all star nam nữ (đen / trắng)",179000,179000,0,0
TIKI,giay-dep-nu,195849868,"Giày Nêm Đế Xuồng Cao Gót Tăng Chiều Cao AG43 - Hàng Quảng Châu Cao Cấp",345000,345000,0,0
TIKI,giay-dep-nu,72913444,"Giày Cao Gót Đúp Mỏng Hở Mũi Quai Hậu Thương Hiệu PABNO PN452",395000,395000,0,0
TIKI,giay-dep-nu,105274289,"Giày Sandal Cao Gót 5cm Xỏ Ngón Pixie X753",348000,348000,0,0
TIKI,giay-dep-nu,163725124,"Dép Bông Đi Trong Nhà Hình Mèo Dễ Thương Đế Cao Su Cực Êm Cực Mềm",84000,84000,0,0
TIKI,giay-dep-nu,107211606,"Dép Cao Gót Nữ Da Bò BIGGBEN Cao 5 Phân DCG52",309000,400000,91000,23
TIKI,giay-dep-nu,196643637,"Dép Mây Cói Đế Cao Su Chống Trơn Đi Trong Nhà / Đi Biển M102",59000,59000,0,0
TIKI,giay-dep-nu,153257324,"Giày lười vải nữ đi bộ - giày lười thể dục thể thao hoa cúc siêu êm đơn giản(T)",95000,95000,0,0
TIKI,giay-dep-nu,172315843,"Giày sandal Nữ Đế Xuồng TiTi ĐÔ Da Bò Thật Cao Cấp 7cm DNU2025c",380000,380000,0,0
TIKI,giay-dep-nu,197186953,"Dép Bông Đi Trong Nhà Hình Gấu- Giao Màu Ngẫu Nhiên",55157,102000,46843,46
TIKI,giay-dep-nu,76822648,"[GIÀY XỊN] Giày sandal chiến binh bánh mì cột dây bảng to cao cấp,hàng chất lượng loại 1 S071 S072",249000,249000,0,0
TIKI,giay-dep-nu,201477673,"Giày thể thao nữ, sneaker độn đế GTT93",598000,598000,0,0
TIKI,giay-dep-nu,50022333,"GIÀY NỮ DA THẬT BALL TRƠN MV3P BÒ",550000,550000,0,0
TIKI,giay-dep-nu,183912904,"Dép sục nữ 3p trong suốt đi mưa mũi nhọn chống trơn siêu bền  V307",72000,72000,0,0
TIKI,giay-dep-nu,62647413,"Sandal nữ  đế bệt Trường Hải da bò thật màu đen SD0133 HÌNH ẢNH THẬT",250000,295000,45000,15
TIKI,giay-dep-nu,72904445,"Dép quai ngang nữ DAS YEEZY SLIDE KAW hot trend",68000,68000,0,0
TIKI,giay-dep-nu,177663066,"Giày Sneaker Nữ GEOX D Nebula C",4800000,4800000,0,0
TIKI,giay-dep-nu,195840987,"Sục Thể Thao Nữ Tăng Chiều Cao Cá Tính AG45 - Hàng Quảng Châu Cao Cấp",325000,325000,0,0
TIKI,giay-dep-nu,173567264,"Giày Cao Gót Da Bò Thật BIGGBEN Gót 7 Phân SDCG74",369000,450000,81000,18
TIKI,giay-dep-nu,183042123,"Giày da bốt nữ cao cổ sang trọng",199000,199000,0,0
TIKI,dien-tu-dien-lanh,23172601,"Điều khiển dùng cho đầu truyền hình FPT-HD",31000,31000,0,0
TIKI,dien-tu-dien-lanh,98992088,"Remote Điều Khiển Dành Cho SAMSUNG Smart Tivi, Internet TV BN59-01315D",34000,34000,0,0
TIKI,dien-tu-dien-lanh,126701897,"Điều khiển điều hòa dành cho Daikin loại dài tốt",67000,67000,0,0
TIKI,dien-tu-dien-lanh,119822990,"Remote Điều khiển  dành cho TV Casper-  Tặng kèm Pin",49800,49800,0,0
TIKI,dien-tu-dien-lanh,91512898,"Remote Điều Khiển Giọng Nói Dành Cho SHARP Smart TV, Android Tivi GB346WJSA",260000,260000,0,0
TIKI,dien-tu-dien-lanh,162736038,"Máy sấy Electrolux 8.5 kg EDV854N3SB - Chỉ giao HCM",10290000,10290000,0,0
TIKI,dien-tu-dien-lanh,70631732,"Remote Điều Khiển Dành Cho Smart TV, Internet Tivi, Ti Vi Thông Minh ASANZO (Kèm pin AAA Maxell)",29900,29900,0,0
TIKI,dien-tu-dien-lanh,168772374,"Điều khiển đầu Kiwibox  tương thích với hầu hết các model đầu, Hàng chính hãng",100000,100000,0,0
TIKI,dien-tu-dien-lanh,50560441,"Tủ Lạnh Aqua 130 lít AQR-T150FA-BS",4804000,4804000,0,0
TIKI,dien-tu-dien-lanh,217139619,"Magic Remote Điều Khiển Smart Tivi, TV OLED 4K Dành Cho LG 2020 MR20GA AKB75855501 -  Có Chuột Bay, Giọng Nói",270000,270000,0,0
TIKI,dien-tu-dien-lanh,94998010,"CHÂN ĐẾ MÁY GIẶT & MÁY SẤY ELECTROLUX - CHÍNH HÃNG",550000,550000,0,0
TIKI,dien-tu-dien-lanh,189658693,"Máy lạnh di động 7000 BTU Fujihome PAC07, điều hòa di động mini 4 trong 1 làm lạnh, hút ẩm, quạt, lọc không khí, điều khiển từ xa - Hàng chính hãng",4445000,6500000,2055000,32
TIKI,dien-tu-dien-lanh,123548187,"Giá treo màn hình máy tính NB F100A 22 - 35 inch -Hàng Chính Hãng",484000,484000,0,0
TIKI,dien-tu-dien-lanh,15817458,"Giá Treo Tivi Gắn Tường Góc Xoay 360 độ - Nhập Khẩu | Dùng cho tivi 45-70"",488000,488000,0,0
TIKI,dien-tu-dien-lanh,74526984,"BỘ ĐẦU THU TRUYỀN HÌNH KỸ THUẬT SỐ K+ 7 MÓN HÀNG CHÍNH HÃNG",300000,300000,0,0
TIKI,dien-tu-dien-lanh,49981979,"Remote Điều Khiển Cho Hộp TV Thông Minh FPT Play Box 2018 (Kèm Pin AAA Maxell)",54000,54000,0,0
TIKI,dien-tu-dien-lanh,183526376,"HCM Máy giặt mini gấp gọn 3.5kg cao cấp tiêu chuẩn xuất Châu Âu và Mỹ",361000,361000,0,0
TIKI,dien-tu-dien-lanh,136389671,"Android TiVi Box X98 Mini Android 11 Kết Nối Bluetooth Ram 4GB Rom 32GB  Chip S905W2 Xem Phim Truyền Hình Game Online Thỏa Thích Phiên Bản 2022 - Hàng Chính Hãng",900000,900000,0,0
TIKI,dien-tu-dien-lanh,44036957,"Điều khiển dành cho smart tivi toshiba CT - 8068",33000,33000,0,0
TIKI,dien-tu-dien-lanh,126701903,"Điều khiển  dành cho đầu kĩ thuật số FPT",55000,55000,0,0
TIKI,dien-tu-dien-lanh,56720370,"Remote Điều Khiển Cho TV BOX Android, Hộp TV Thông Minh TCTEK (Kèm Pin AAA Maxell)",42000,42000,0,0
TIKI,dien-tu-dien-lanh,119088803,"Điều Khiển Remote Dành Cho máy lạnh DAIKIN Cao Cấp",55000,55000,0,0
TIKI,dien-tu-dien-lanh,25410861,"Remote Điều Khiển Cho Máy Lạnh, Điều Hòa DAIKIN FTV, FTN, FTN35JXV1V, FTV25AXV1, FTV60BXV1",44000,44000,0,0
TIKI,dien-tu-dien-lanh,100458166,"Điều Khiển Quạt Đa Năng - Hàng Mới Về",58900,58900,0,0
TIKI,dien-tu-dien-lanh,13943889,"Điều Khiển Dùng Cho Điều Hòa Daikin Inverter",45000,45000,0,0
TIKI,dien-tu-dien-lanh,190631354,"Chai xịt vệ sinh máy lạnh/ máy điều hòa, máy quạt điện và các loại quạt thông gió khác...500ML, loại bỏ vi khuẩn, nấm mốc, mùi hôi khó chịu- Hàng nhập khẩu",59000,59000,0,0
TIKI,dien-tu-dien-lanh,216087176,"Remote TV Điều Khiển Giọng Nói Dành Cho SAMSUNG Smart Tivi 4K, QLED",160000,160000,0,0
TIKI,dien-tu-dien-lanh,126701927,"Điều khiển điều hòa  dành cho Panasonic dùng cho CU/CS- 9000BTU 12000BTU 18000BTU 1 chiều 2 chiều Inverter",51000,51000,0,0
TIKI,dien-tu-dien-lanh,74571266,"Remote Điều Khiển Dành Cho Máy Lạnh, Điều Hòa MITSUBISHI Grade A",55000,55000,0,0
TIKI,dien-tu-dien-lanh,106059507,"ĐIỀU KHIỂN TIVI SAMSUNG SMART CONG IR-1316 NĂM 2020 DÒNG KHÔNG GIỌNG NÓI VÀO MẠNG INTERNET",140000,140000,0,0
TIKI,dien-tu-dien-lanh,216205097,"Remote Điều Khiển Cho TV LED, Smart TV, Ti Vi Thông Minh TCL",30000,30000,0,0
TIKI,dien-tu-dien-lanh,68359249,"Giá Treo Màn Hình Máy Tính North Bayou NB-H80 17-27 inch bền chắc, an toàn cho bạn - Hàng chính hãng",334000,334000,0,0
TIKI,dien-tu-dien-lanh,45209285,"Remote Điều Khiển Dùng Cho Smart TV, Internet TV, LED TV SAMSUNG BN59-01303A  - Hàng nhập khẩu",48000,48000,0,0
TIKI,dien-tu-dien-lanh,17589148,"Giá treo TV nhập khẩu NB-P6 (40"- 80")",418000,418000,0,0
TIKI,dien-tu-dien-lanh,44018311,"ĐIỀU KHIỂN THÔNG MINH DÀNH CHO TIVI LG ",292000,292000,0,0
TIKI,dien-tu-dien-lanh,114078635,"Giá treo 2 màn hình máy tính NB-H180 (Hàng Nhập Khẩu)",588000,588000,0,0
TIKI,dien-tu-dien-lanh,162736036,"Máy sấy Electrolux 8.5 kg EDV854N3SB - Chỉ giao Hà Nội",9600000,9600000,0,0
TIKI,dien-tu-dien-lanh,105901447,"ANTEN TRUYỀN HÌNH SỐ DVB T2 DÙNG CHO TIVI TÍCH HỢP DVB T2 VÀ ĐẦU THU KỸ THUẬT SỐ DVB T2.HÀNG NHƯ HÌNH",39000,39000,0,0
TIKI,dien-tu-dien-lanh,35911550,"Remote Điều Khiển Cho Máy Lạnh, Máy Điều Hòa Không Khí Sanyo SAP-K9AP",44900,44900,0,0
TIKI,dien-tu-dien-lanh,118208821,"Điều khiển tivi tìm kiếm giọng nói dành cho tivi sam@sung",144000,144000,0,0
TIKI,dien-tu-dien-lanh,17485604,"Remote điều khiển dùng cho điều hòa Sumikura",50000,50000,0,0
TIKI,dien-tu-dien-lanh,126701958,"Remote Điều khiển tivi dành cho Sony giọng nói RM-TX500P",165000,165000,0,0
TIKI,dien-tu-dien-lanh,119821921,"Điều khiển tivi dành cho TCL - TV TCL các dòng CRT LCD LED Smart TV ",30900,30900,0,0
TIKI,dien-tu-dien-lanh,115720109,"Quạt dành cho tủ lạnh SANYO",99000,99000,0,0
TIKI,dien-tu-dien-lanh,119823016,"Điều khiển quạt trần 4 cánh  dành cho Panasonic F56MPG/ F56MZG /F564 -  Tặng kèm Pin",142800,142800,0,0
TIKI,dien-tu-dien-lanh,48719113,"Remote Điều Khiển Dùng Cho Đầu Thu TV SCTV - Truyền Hình KTS Cáp SCTV (Kèm Pin AAA Maxell)",31000,31000,0,0
TIKI,dien-tu-dien-lanh,70202311,"Máy tắm nước nóng OTTOWA TH4501- Hàng chính hãng",2749000,2749000,0,0
TIKI,dien-tu-dien-lanh,50359361,"Remote HD02 Dùng Cho Đầu Thu Vệ Tinh Vinasat, Đầu Thu Mặt Đất Miễn Phí",25000,25000,0,0
TIKI,dien-tu-dien-lanh,165964297,"Ron tủ lạnh dành cho tủ lạnh S.A.N.Y.O SR - P25MN",220000,220000,0,0
TIKI,dien-tu-dien-lanh,118053673,"van cấp nước đôi dành cho máy giặt Samsung",149000,149000,0,0
TIKI,dien-tu-dien-lanh,58435769,"Remote Điều Khiển Dành Cho Smart TV LG, Internet TV LG RM-L930+2 Grade A+(Kèm Pin AAA Maxell)",36000,36000,0,0
TIKI,dien-tu-dien-lanh,103744123,"REMOTE ĐIỀU KHIỂN DÀNH CHO MÁY LẠNH ĐIỀU HOÀ MITSUBISHI HEAVY (không 3D)",51000,51000,0,0
TIKI,dien-tu-dien-lanh,118053360,"REMOTE ĐIỀU KHIỂN DÀNH CHO MÁY LẠNH PANASONIC DÒNG MÁY THƯỜNG- Tặng kèm PIN",82400,82400,0,0
TIKI,dien-tu-dien-lanh,126702266,"Remote Điều khiển từ xa điều hòa dành cho LG đa năng tất cả các dòng 1&2 chiều Inverter ",54000,54000,0,0
TIKI,dien-tu-dien-lanh,118053414,"TÚI VỆ SINH MÁY LẠNH CAO CẤP CÓ ỐNG",120000,120000,0,0
TIKI,dien-tu-dien-lanh,126702234,"Remote Điều khiển điều hòa 1 chiều 2 chiều dành cho LG dùng cho các dòng V10 V13 V18 9000BTU 12000BTU 18000BTU",66000,66000,0,0
TIKI,dien-tu-dien-lanh,105362470,"Lưới lọc dành cho máy giặt SANYO 8.5kg ",60000,60000,0,0
TIKI,dien-tu-dien-lanh,249669877,"Đầu chuyển đổi gas R410A, đầu đực phi 6 (R22) chuyển sang đầu cái phi 8 (R410)",25000,25000,0,0
TIKI,dien-tu-dien-lanh,113048335,"Điều khiển TV Sharp Smart",43900,43900,0,0
TIKI,dien-tu-dien-lanh,126702122,"Remote Điều khiển từ xa điều hòa dành cho Sharp dùng cho tất cả các dòng 1&2 chiều Inverter ",52000,52000,0,0
TIKI,dien-tu-dien-lanh,83397142,"10 con rắc đực vuông góc  + f5 hàng như hình",39000,39000,0,0
TIKI,dien-tu-dien-lanh,74955205,"LNB Ku Band PAUXIS HÀNG CHÍNH HÃNG",35000,35000,0,0
TIKI,dien-tu-dien-lanh,36829026,"Remote Điều Khiển Dùng Cho TV LED, Smart TV Panasonic L1268",40000,40000,0,0
TIKI,dien-tu-dien-lanh,164559292,"Tụ đề, tụ quạt điều hòa các loại 5uF, 6uF #phụ tùng thay thế",10500,10500,0,0
TIKI,dien-tu-dien-lanh,46527974,"Remote Điều Khiển Dành Cho Smart TV LG, Internet TV, TV Thông Minh LG AKB73715601 (Kèm Pin AAA Maxell) - Hàng nhập khẩu",48000,48000,0,0
TIKI,dien-tu-dien-lanh,92494309,"Sét 4 đế máy giặt chống rung silicon loại tốt",20999,20999,0,0
TIKI,dien-tu-dien-lanh,32404643,"Remote Điểu Khiển Cho Máy Lạnh, Máy Điều Hòa Reetech ZH/JT-03",53000,53000,0,0
TIKI,dien-tu-dien-lanh,35128178,"Remote Điều Khiển Dùng Cho Máy Lạnh, Điều Hòa DAIKIN FTE25LV1V, FT25GV1G, FT35GV1G, ARC433A55",45000,45000,0,0
TIKI,dien-tu-dien-lanh,73331753,"Remote Điều Khiển Dành Cho Máy Lạnh, Điều Hòa DAIKIN FTKC Series ARC480A1",49900,49900,0,0
TIKI,dien-tu-dien-lanh,32102874,"Remote Điều Khiển Cho Máy Lạnh, Điều Hòa Panasonic Inverter A75C3208, A75C3706, A75C3708 - Hàng nhập khẩu",44900,44900,0,0
TIKI,dien-tu-dien-lanh,73643650,"[Chính Hãng] Bầu Điện Trở Máy Nước Nóng Centon 4.5 kW (Thermostat Nhỏ)",450000,450000,0,0
TIKI,dien-tu-dien-lanh,87916028,"Rờ Le Khởi Động Dành Cho Block Tủ Lạnh 2 Chân",15000,15000,0,0
TIKI,dien-tu-dien-lanh,17872839,"Khung treo tivi mâm áp tường 37 - 65 inch M65T - Hàng chính hãng",115000,115000,0,0
TIKI,dien-tu-dien-lanh,95569676,"Đồng hồ đo áp suất gas máy lạnh VALUE R22 hàng chính hãng",1040000,1040000,0,0
TIKI,dien-tu-dien-lanh,90148833,"Máy giặt Samsung Inverter 10kg WW10TA046AE/SV - Chỉ giao Hà Nội",7850000,9650000,1800000,19
TIKI,dien-tu-dien-lanh,26042238,"Remote Điều Khiển Dùng Cho Máy Lạnh LG 6711A90023B, Điều Hòa 6711A90031L",40600,40600,0,0
TIKI,dien-tu-dien-lanh,50462782,"Remote điều khiển máy lạnh đa năng, điều khiển máy lạnh, remote máy lạnh, máy điều hòa, remote điều khiển cho tất cả các loại máy lạnh+ Tặng kèm pin",29900,29900,0,0
TIKI,dien-tu-dien-lanh,39334661,"Remote Điều Khiển Dùng Cho TV LCD, TV LED TCL RC3000M11",48000,48000,0,0
TIKI,dien-tu-dien-lanh,112687710,"Tủ Ướp  Rượu Vang Kết Hợp Tủ Mát Keplercook BCW69A1D- Hàng Chính Hãng",9100000,9100000,0,0
TIKI,dien-tu-dien-lanh,102108759,"Nút bịt phi 47 đáy bình nước nóng năng lượng mặt trời",141550,149000,7450,5
TIKI,giay-dep-nu,158849476,"Dép đi trong nhà tắm văn phòng xốp lỗ siêu bền, siêu nhẹ (nhẹ hơn dép nhựa), siêu rẻ, chống trơn trượt .",38000,38000,0,0
TIKI,giay-dep-nu,17876193,"Dây giày cao su đàn hồi thông minh bền Goodmice 16 dây",69000,69000,0,0
TIKI,giay-dep-nu,119718555,"Giày Sandal Cao Gót Nữ TiTi ĐÔ Da Bò Thật Cao Cấp 7cm DNU2063a",380000,380000,0,0
TIKI,giay-dep-nu,24934644,"Dép nữ đế cao - Dép quai ngang cao cấp - Mã SP : dép Z",165000,165000,0,0
TIKI,giay-dep-nu,175469247,"Giày chạy bộ nữ Under Armour HOVR Infinite 3 - 3023556-602",2467000,3795000,1328000,35
TIKI,giay-dep-nu,84197046,"Giày Sandals Vento Nam Nữ Quai Ngang dạo phố/đi chơi/đi học NB80",385000,385000,0,0
TIKI,giay-dep-nu,98186207,"Giày Cao Gót Nữ Phong Cách Sang Trọng, Tinh Tế Chuẩn Châu Âu 202-9",250000,250000,0,0
TIKI,giay-dep-nu,114046833,"Giày Cao Gót 7cm Mũi Vuông Gắn Khoá Pixie X776",450000,450000,0,0
TIKI,giay-dep-nu,141297933,"Giày cao gót nữ đẹp đế vuông 8 phân hàng hiệu rosata hai màu đen đỏ ro310",490000,490000,0,0
TIKI,giay-dep-nu,195232962,"Giày Thể Thao Nữ Độn Đế,Giày Nữ Đế Độn Mẫu Mới Nhất Hiện Nay Kiểu Dáng Hàn Quốc Trẻ Trung Năng Động Đế Cao 6,5cm GTTN28",245000,245000,0,0
TIKI,giay-dep-nu,150651745,"Giày Thể Thao Nữ Siêu Nhẹ Thoáng Khí Kiểu Hàn Quốc Dùng Đi Làm,Đi Chơi,Chạy Bộ,Tập Gym GTTN13 SUNO",178000,178000,0,0
TIKI,giay-dep-nu,108849654,"Dép nhựa đi trong nhà quai ngang, Dép lê nữ Eva đi mưa chống trơn trượt - DETA26",69000,69000,0,0
TIKI,giay-dep-nu,70937536,"Dép massage đi trong nhà tắm NachiduMT1-XANH COBAN",89000,89000,0,0
TIKI,giay-dep-nu,115715416,"Dép quai ngang nữ cao gót 7cm thời trang Hàn Quốc",115000,115000,0,0
TIKI,giay-dep-nu,169363887,"Giày sục nữ đi mưa mũi tròn cao 2p V293",59000,59000,0,0
TIKI,giay-dep-nu,192880231,"Giày Nữ Pierre Cardin - PCWFWSG 174",490000,1490000,1000000,67
TIKI,giay-dep-nu,143806909,"Dép nữ quai ngang hai dây màu kem Trường hải Đế Pu nhẹ cao 2.5cm thời trang nữ cao cấp N147K",207000,259000,52000,20
TIKI,giay-dep-nu,76299346,"Giày búp bê nữ BIGGBEN da bò cao cấp BB79",309000,400000,91000,23
TIKI,giay-dep-nu,12696057,"Giày Búp Bê BIGGBEN Da Bò Thật Cao Cấp BB35",299000,350000,51000,15
TIKI,giay-dep-nu,193878528,"Giày lười vải giày nữ đế cao su mềm êm chân cao 2cm",169000,169000,0,0
TIKI,giay-dep-nu,175469025,"Giày chạy bộ nữ Under Armour HOVR Infinite 3 - 3023556-106",2467000,3795000,1328000,35
TIKI,giay-dep-nu,177772556,"Giày sandal nữ BIGGBEN cao 4,5cm SDN75",249000,400000,151000,38
TIKI,giay-dep-nu,192713675,"Giày thể thao Bitis Hunter nữ",690000,690000,0,0
TIKI,giay-dep-nu,191312168,"Dép bánh mì nam nữ Cross tặng kèm Sticker dễ thương bản cao cấp đế 5cm",113050,119000,5950,5
TIKI,giay-dep-nu,196877679,"[Phiên Bản Kỷ Niệm 40 Năm] Giày Thể Thao Nữ Hunter X DSWH09700DEN (Đen)",854000,1138000,284000,25
TIKI,giay-dep-nu,165998023,"Giày sandal xuồng nữ da bò BIGGBEN cao cấp SDX35",319000,500000,181000,36
TIKI,giay-dep-nu,73858319,"Giày Sandal Nữ 5cm Thời Trang JUNO Gót Vuông Quai Ngang SD05003",363000,363000,0,0
TIKI,giay-dep-nu,186740130,"Giày Cao Gót Da Bò Thật BIGGBEN Gót 5 Phân SDCG77",369000,500000,131000,26
TIKI,giay-dep-nu,36681299,"Giày búp bê vải caro đế bằng 2cm đi bộ cực êm chân V189",64900,64900,0,0
TIKI,giay-dep-nu,127379514,"Giày Sneaker Vải Nữ DINCOX C20 Nữ Tính Sang Trọng Chocolate",376000,376000,0,0
TIKI,giay-dep-nu,75829566,"Dép Xỏ Ngón Unisex crocs Bayaband 205393",876000,995000,119000,12
TIKI,giay-dep-nu,177707241,"Giày Sandal Cao Gót BIGGBEN Gót 7cm SDCG76",349000,400000,51000,13
TIKI,giay-dep-nu,173463511,"Sandal nữ Crocs Literide 360 - 206711-02G",1117000,1595000,478000,30
TIKI,giay-dep-nu,141322642,"Dép đi trong nhà, dép văn phòng siêu nhẹ, chống trơn trượt, họa tiết thanh lịch - Hàng nhập khẩu",32000,32000,0,0
TIKI,giay-dep-nu,192937741,"Giày Thể Thao Nữ Êmbrace DSW066400",539000,539000,0,0
TIKI,giay-dep-nu,71088622,"Dép Nữ Thời trang KAWS NEW - Dép YZ Slide Siêu Nhẹ, Siêu Bền [ HOT TREND 2020",59000,59000,0,0
TIKI,giay-dep-nu,130770777,"Giày búp bê vải nữ đế bằng 2cm đi bộ cực êm chân V288",69000,69000,0,0
TIKI,giay-dep-nu,147588439,"Giày búp bê nữ BIGGBEN da bò cao cấp BB117",309000,450000,141000,31
TIKI,giay-dep-nu,45948127,"4 miếng lót gót giày vải êm chân, lót đệm gót",44000,44000,0,0
TIKI,giay-dep-nu,195528889,"Giày Sandal Nữ Da Bò Thật BIGGBEN Cao Cấp SDN83",309000,350000,41000,12
TIKI,giay-dep-nu,38562391,"Giày bốt nữ cổ lông phong cách trẻ trung năng động TRT-GBNU-04",99000,99000,0,0
TIKI,giay-dep-nu,8413988,"Dép Xỏ Ngón Nữ BIGGBEN Da Bò Thật Cao Cấp DXN05",329000,350000,21000,6
TIKI,giay-dep-nu,177468464,"Giày công sở HT.NEO cao 5p gót nhọn da bóng khuy vuông nơ vắt đính đá sang trọng CS234",170000,250000,80000,32
TIKI,giay-dep-nu,70650254,"Dép đi trong nhà siêu mềm siêu nhẹ nam nữ size M màu Ghi Nội địa NHẬT BẢN",210000,210000,0,0
TIKI,giay-dep-nu,205820491,"Dép lê nữ Bitas chữ H DWN.04",220000,220000,0,0
TIKI,giay-dep-nu,98074611,"Giày Nữ Sneake cổ thấp lưới hoa daisy cá tính D95",51503,70387,18884,27
TIKI,giay-dep-nu,105273693,"Giày Sục Cao Gót 5cm Khoá Vuông Pixie X720",504000,504000,0,0
TIKI,giay-dep-nu,84198878,"Sandal Vento Nam Chính Hãng SD10026",375000,375000,0,0
TIKI,giay-dep-nu,73826294,"Dép xốp nhẹ êm đủ size",13000,14000,1000,7
TIKI,giay-dep-nu,114740045,"GIÀY CƯỚI BEJO HOA MAI H80G - WEDDING SHOES",840000,840000,0,0
TIKI,giay-dep-nu,173219007,"Dép bánh mì thông hơi Ulzzang siêu nhẹ đế cao 4cm chống trơn trượt. Sỉ giá tốt",62000,62000,0,0
TIKI,giay-dep-nu,194042466,"Dép xỏ ngón nữ tôn chiều cao 7cm, dép thời trang nữ, đi chơi, dạo phố, du lịch, loại cao cấp",132300,132300,0,0
TIKI,giay-dep-nu,169032414,"Giấy ướt lau giày thần thánh sneaker",50000,50000,0,0
TIKI,giay-dep-nu,112957786,"dép nữ dễ thương,tông thái nữ cao cấp hot trend 2020 trẻ trung năng động 21357",21100,33000,11900,36
TIKI,giay-dep-nu,191592583,"Giày Boots Doc.058 Full Black Da Bò sáp đen size 36->44 Lucas Shoes Bảo hành 1 năm",689000,689000,0,0
TIKI,giay-dep-nu,172844732,"Dép trệt quai ngang nữ",149000,149000,0,0
TIKI,giay-dep-nu,196517635,"Dép Thái Lan nữ quai ngang đúc siêu nhẹ, êm mềm Monobo moniga 10.7",90000,90000,0,0
TIKI,giay-dep-nu,171202970,"Giày sandal nữ 2 dây Giavy SK411",205000,205000,0,0
TIKI,giay-dep-nu,205943417,"Giày cao gót nữ 8p RO466 ROSATA tại BCASHOP bít mũi, hở gót, gót trụ cùng màu thân - màu trắng kem",489000,489000,0,0
TIKI,giay-dep-nu,244738156,"WAO Fashion - Giày sandal cao gót nữ mũi vuông quai nhún thanh lịch cao 8cm - WA02",159000,159000,0,0
TIKI,giay-dep-nu,192687946,"Tất Độn Gót,  Đệm Gót Chân Tăng Chiều Cao Chất Liệu Silicon Chống Trượt - 2 LótMềm chiaLỗ 50mm",72000,72000,0,0
TIKI,giay-dep-nu,1991893,"Dép Nữ Cao Gót Huy Hoàng HT7050 - Xanh (Size",459000,459000,0,0
TIKI,giay-dep-nu,194562978,"Sục Thể Thao Đế Cao 10cm SOD595-2007",595000,595000,0,0
TIKI,giay-dep-nu,146361499,"Dây giày sneaker thể thao tròn trơn chất dù ngắn 60cm 70cm dài 1m 1m6 1m8 Sans940",17999,17999,0,0
TIKI,giay-dep-nu,121334555,"Giầy quai hở gót đi 2 kiểu dễ thương GN11",104000,104000,0,0
TIKI,giay-dep-nu,73327649,"Giầy da mũi tròn đế 5cm basic dễ phối đồ GN32",85000,85000,0,0
TIKI,giay-dep-nu,191721350,"Tất tăng chiều cao silicon không lộ Sans922 êm chân thoáng khí miếng lót giày độn đế nâng gót cao cấp chống trượt",50000,50000,0,0
TIKI,giay-dep-nu,225933549,"Dép quai ngang - dép bánh mì quai lụa đan cao cấp đế mềm",225000,225000,0,0
TIKI,giay-dep-nu,171436096,"Combo 4 miếng lót đế giày tăng chiều cao Air có đệm khí siêu êm ái, giày đế cao, giày độn gót GD233-LGIAYTCC-Air",12000,12000,0,0
TIKI,giay-dep-nu,183113337,"Giày búp bê nữ đế bệt, giầy công sở nữ ( big size 36 đến 42 ) - haigiang3008",99000,99000,0,0
TIKI,giay-dep-nu,185710256,"Bình xịt vệ sinh giày unisex Forcefield - 21115",469000,469000,0,0
TIKI,giay-dep-nu,48995660,"Dép nữ đi ngoài trời hoặc trong nhà tím",28000,28000,0,0
TIKI,giay-dep-nu,190455353,"Dép lê nam nữ đi trong nhà thêu hoạt tiết Vintage Hàn Quốc , Dép văn phòng vải lanh chống trơn trượt TA.Kẻ Hoa 96",59000,59000,0,0
TIKI,giay-dep-nu,252913732,"Miếng lót mũi giày bằng mút đệm êm ngón chân, giảm rộng cho giày, đệm êm ngón chân sử dụng được cho tất các các loại giày bít mũi (1 cặp)",19000,19000,0,0
TIKI,giay-dep-nu,195464905,"Set 2 dụng cụ dụng cụ chỉnh hình bảo vệ ngón Chân, tách ngón chân cái giảm đau hiệu quả #sil43",55000,55000,0,0
TIKI,giay-dep-nu,114277790,"Sandan quai trong siêu đẹp",190000,190000,0,0
TIKI,giay-dep-nu,173237799,"dép nữ,tông thái nữ cao cấp hot trend 2020 siêu dễ thương 21349",21100,38300,17200,45
TIKI,giay-dep-nu,132079541,"Giày Sneaker Cổ Thấp Đỏ Nữ",141000,150000,9000,6
TIKI,giay-dep-nu,25122778,"Giày cao gót nữ đen hở mũi đế vuông cao 5cm TH - CG026",239000,279000,40000,14
TIKI,giay-dep-nu,42564322,"Combo 3 Đôi Dép Xốp Lỗ Đi Trong Nhà - Tặng 1 Món Qùa Bí Mật Cho Gia Đình",84550,89000,4450,5
TIKI,ngon,125577752,"[CHỉ giao HN] Thịt ba chỉ heo rút sườn loại ngon - 1kg",118000,118000,0,0
TIKI,ngon,126768835,"[Chỉ giao HN] Set Móng Heo Giả Cầy ( Đủ vị ) - 1Kg",90000,90000,0,0
TIKI,ngon,127388276,"[Chỉ giao HN] Set lẩu full topping",379000,379000,0,0
TIKI,ngon,126796310,"Cá mối phi lê - gói 500gr",75000,75000,0,0
TIKI,ngon,123575326,"Bánh khúc Việt Trì (sét 10 cái trắng) cấp đông",129000,129000,0,0
TIKI,ngon,173288238,"[Chỉ giao HN] - Ba Chỉ Hun Khói Tây Bắc Ăn Liền - 500g",189000,189000,0,0
TIKI,ngon,169004507,"Dầu tắm SOS cho chó mèo 530ml - Xanh ngọc",79999,79999,0,0
TIKI,ngon,169003745,"Sữa tắm SOS cho chó mèo (100% chính hãng) - Nâu,550ml",79900,79900,0,0
TIKI,ngon,166057773,"Sữa Tắm Dành Cho Mèo SOS (530ml)",79999,79999,0,0
TIKI,ngon,169077695,"Nước Yến Sào Cao Cấp Khánh Hòa Sanest Lọ 70ml",34000,34000,0,0
TIKI,ngon,173381289,"Sữa Tắm Olive Essence 450ml Cho Chó Mèo - 4. Trừ ngứa khử mùi",44444,44444,0,0
TIKI,ngon,170180254,"Bát ăn cho chó - bát nhựa tròn giao màu ngẫu nhiên - M",19000,19000,0,0
TIKI,ngon,170179201,"Tấm lót vệ sinh than hoạt tính cho chó mèo - Loại thường xanh,50 miếng(45x60)",122222,122222,0,0
TIKI,ngon,170179459,"Xẻng hốt phân mèo kèm thùng rác - tặng kèm 15 túi đựng phân (giao màu ngẫu nhiên)",63000,63000,0,0
TIKI,ngon,171833884,"[ Chỉ giao HN] -Snack sấy khô Thực quản bò 100gr",80000,80000,0,0
TIKI,ngon,173382235,"12 Túi Đồ Ăn Cho Chó Nhỏ Vị Thịt Gà Miếng Nấu Xốt SmartHeart (130g)",180000,180000,0,0
TIKI,ngon,170180258,"Miếng lót vệ sinh cho chó mèo S-M-L-XL-79100 - Xanh - S",144000,144000,0,0
TIKI,ngon,169004636,"[CHÍNH HÃNG] Thuốc Nhỏ Tai BIO GENTAZOL Trị Viêm Tai cho Chó Mèo 10ml",35000,35000,0,0
TIKI,ngon,169067375,"Đĩa Bay huấn luyện chó mèo - Đồ chơi cho chó mèo (Màu ngẫu nhiên)",20000,20000,0,0
TIKI,ngon,170180223,"Miếng lót vệ sinh đa năng chó thú cưng nhà bạn 00100 - Xanh - M",149999,149999,0,0
TIKI,ngon,170179965,"Dây cổ công ty cho thú cưng dưới 5kg (giao màu ngẫu nhiên)",45000,45000,0,0
TIKI,ngon,166057915,"Thức ăn hạt cho mèo Me-O - Kitten 400g",45000,45000,0,0
TIKI,ngon,166083106,"Thức ăn hạt cho mèo Me-O - Kitten 400g",45000,45000,0,0
TIKI,ngon,169003960,"Tấm lót vệ sinh cho chó mèo - S",149999,149999,0,0
TIKI,ngon,170180532,"Vòi uống nước gắn chuồng cho chó mèo (Xanh)",38999,38999,0,0
TIKI,ngon,169003972,"Đồ Chơi Cao Su Hình Xương Có Gai Luyện Tập Răng Cho Thú Cưng",19000,19000,0,0
TIKI,ngon,169005937,"Bộ 2 Vòng cổ, dây đeo cổ cho chó mèo -  Màu ngẫu nhiên - VOC-25, Dài 36-52 cm Rộng 2.5 cm",80000,80000,0,0
TIKI,ngon,170180502,"ĐỒ CHƠI Thảm cào móng cho mèo( dạng sóng, hình ngẫu nhiên) - To",59000,59000,0,0
TIKI,ngon,169004207,"Dây Dắt Vòng Cổ Chó Mèo Kún Miu (1.5cm) - Giao Màu Ngẫu Nhiên",28000,28000,0,0
TIKI,ngon,166059240,"Bánh Bi men sữa dinh dưỡng Cho Hamster, Nhím, Sóc - Túi ăn thử",3000,3000,0,0
TIKI,ngon,170179473,"Bát ăn cho chó mèo xuống nước tự động (màu ngẫu nhiên, không kèm bình nước) - Size M",31000,31000,0,0
TIKI,ngon,173359501,"Thức ăn cho mèo ROYAL CANIN BRITISH SHORTHAIR ADULT - 2kg",575000,575000,0,0
TIKI,ngon,169004084,"Thức Ăn Cho Mèo Lớn Me-O Adult (350g)",26999,26999,0,0
TIKI,ngon,169063476,"Bình Nước Gắn Chuồng Cho Thú Cưng - Vàng",25000,25000,0,0
TIKI,ngon,170179891,"ROYAL CANIN URINARY S/O - THỨC ĂN CHO MÈO BỊ SỎI THẬN - 1,5Kg",549000,549000,0,0
TIKI,ngon,169004887,"Vòng cổ đệm cho chó (Chọn 4 màu)  - Xanh Dương - M",32000,32000,0,0
TIKI,ngon,166062959,"Thức ăn cho chó con Smartheart Puppy vị thịt bò và sữa 1.5kg-Tặng kèm 1 gói Pate Smartheart 130g",118888,118888,0,0
TIKI,ngon,173379761,"Cát vệ sinh cho mèo GENKI",55500,55500,0,0
TIKI,ngon,169068480,"Bát ăn nhựa đôi tròn cao cấp cho chó mèo Kún Miu",28710,28710,0,0
TIKI,ngon,169005135,"[Gói 100g] Thức ăn Pháp giúp chăm sóc răng miệng,hỗ trợ tiêu hóa,tiêu búi lông cho mèo con và mèo trưởng thành - RC Indoor 27",23000,23000,0,0
TIKI,phu-kien-thoi-trang,59063838,"Kính không độ unisex chống UV400, ánh sáng xanh UV101910-C4",180500,190000,9500,5
TIKI,phu-kien-thoi-trang,102888651,"Tóc giả kẹp phím phồng ngắn K04 Sỉ 14k",24000,24000,0,0
TIKI,phu-kien-thoi-trang,192713913,"Thắt Lưng Dây Nịt Nam Da Bò Khóa Tự Động Đa Dạng Nhiều Mẫu Mới Lạ Phong Cách Âu Cá Tính  DT116",112500,150000,37500,25
TIKI,phu-kien-thoi-trang,79842942," Băng Đô Turban Thắt Nút Phối 2 Màu Phong Cách Hàn Quốc Vải Lụa - Mã BD003",29000,29000,0,0
TIKI,phu-kien-thoi-trang,86168569," TÓC GIẢ NỮ NGẮN TÉM DÀI TẶNG LƯỚI TRÙM TÓC",159000,159000,0,0
TIKI,phu-kien-thoi-trang,76402289,"Gọng kính chính hãng SARIFA TR90 2477 (Size 52-16-141) nhiều màu",199000,450000,251000,56
TIKI,phu-kien-thoi-trang,139449942,"(HÀNG ĐẸP) Dây nịt Nam vải dù_Tushi siêu bền_Khóa cài tự động chắc chắn, tiện lợi,, Thắt lưng vải bố cao cấp",149000,149000,0,0
TIKI,phu-kien-thoi-trang,136033125,"Gọng kính cận vuông Basic Glasses 01, gọng kính nam, nữ thời trang",152000,160000,8000,5
TIKI,phu-kien-thoi-trang,77181263,"Thắt lưng nữ co giãn khóa kim loại cá tính dễ phối đồ",64000,64000,0,0
TIKI,phu-kien-thoi-trang,11211343,"Dụng cụ che mắt ngủ",19200,24000,4800,20
TIKI,phu-kien-thoi-trang,120431502,"Khăn rằn campuchia",90000,90000,0,0
TIKI,phu-kien-thoi-trang,81992016,"Khăn rằn campuchia xanh dương",75000,75000,0,0
TIKI,phu-kien-thoi-trang,17593177,"Găng tay chống nắng Let's Slim Hàn Quốc 45gr",11000,11000,0,0
TIKI,phu-kien-thoi-trang,13533833,"Khăn Choàng Nữ Thời Trang Cashmere HN19",94000,94000,0,0
TIKI,phu-kien-thoi-trang,58502208,"Băng đô đính đá lấp lánh phong cách Hàn siêu kute",39000,39000,0,0
TIKI,phu-kien-thoi-trang,74387382,"Thắt lưng co giãn khóa tam giác cá tính TL64",45000,45000,0,0
TIKI,phu-kien-thoi-trang,193758447,"Trâm cài tóc bằng sừng hàng VIP siêu đẹp/ tỉa khắc sang chảnh HOT TREND - HH602-40",39000,39000,0,0
TIKI,phu-kien-thoi-trang,164021840,"Kính râm thời trang cho nam dáng kính phi công tròng phân cực chống chói đi ngày và đêm AK002 - Aoron",210000,320000,110000,34
TIKI,phu-kien-thoi-trang,160894064,"Hộp 5 đôi tất đi giày tây nam mẫu Quả Trám, vớ nam công sở cổ cao cao cấp, chất cotton hút ẩm, thoáng khí - GOM-QUATRAM-CB5",179000,250000,71000,28
TIKI,phu-kien-thoi-trang,181693359,"Khay đựng lens Angel Eyes cao cấp không chì",45000,45000,0,0
TIKI,phu-kien-thoi-trang,15387314,"Dụng cụ tạo búi tóc mẫu mới siêu hot (Dễ dàng thực hiện)",18000,18000,0,0
TIKI,phu-kien-thoi-trang,160186129,"mũ cối tàu cốt phíp lòng vàng đinh trắng phiên bản xưa 1966, vải gabadin tô châu chuẩn tàu màu ổi ương",85000,85000,0,0
TIKI,phu-kien-thoi-trang,76904868,"NÓN LƯỠI TRAI TRƠN THỜI TRANG NAM NỮ MŨ BÓNG CHÀY RÁCH TRƠN NHIỀU MÀU KIỂU DÁNG THỂ THAO - SMICE HOUSE",126000,126000,0,0
TIKI,phu-kien-thoi-trang,190152854,"Nón Kết Ông Địa Cầm Đàn F1 Cao Cấp .",219000,219000,0,0
TIKI,phu-kien-thoi-trang,113490079,"Kính Mát ,Mắt Kính Unisex ASARIFA RP18013 c2",800000,800000,0,0
TIKI,phu-kien-thoi-trang,137501545,"Thắt Lưng Da Bò Thật Vân Cá Sấu mặt khóa tự động cao cấp Dây nịt nam sang trọng bản nhỏ 3.5cm bảo hành 24 tháng",210000,210000,0,0
TIKI,phu-kien-thoi-trang,76795155,"Mũ Rộng Vành Gấp Gọn Nón Rộng Vành Đi Biển - DONA21012803",160550,169000,8450,5
TIKI,phu-kien-thoi-trang,190167581,"Băng đô cài tóc, Bờm cài tóc bản nhỏ sóng kép nhiều màu xinh xắn",36000,36000,0,0
TIKI,phu-kien-thoi-trang,186738622,"Bao tay Găng tay Nam Kiểu hở 2 ngón Gắn chữ adiddas Chất liệu vải mềm êm, Chống nắng, Chống tia UV, Bảo vệ đôi tay",42000,42000,0,0
TIKI,phu-kien-thoi-trang,21784158,"Mũ trùm đầu ninja Thái Lan M1",42000,42000,0,0
TIKI,phu-kien-thoi-trang,90473785,"Kính lão thị viễn thị có độ sẵn nam nữ siêu dẻo màu Đen",109000,109000,0,0
TIKI,phu-kien-thoi-trang,53546168,"Kính viễn thị lão thị đa tròng nhìn mọi khoảng cách mắt sẵn độ cao cấp",199000,199000,0,0
TIKI,phu-kien-thoi-trang,165243589,"Mũ phớt cao bồi Fedora MP06 đẹp cho nam và nữ",125000,197000,72000,37
TIKI,phu-kien-thoi-trang,55685304,"Mắt Kính Nam Cao Cấp, Gọng Kính Gấp Gọn Màu Vàng, Tròng Kính Xanh Đen Sang Trọng Chống Tia UV",160000,160000,0,0
TIKI,phu-kien-thoi-trang,15016103,"Kẹp tròn lấp lánh - phụ kiện tóc style Hàn Quốc",34900,34900,0,0
TIKI,phu-kien-thoi-trang,27525458,"Mũ nón len bere lông thỏ đính hạt thời trang Hàn Quốc dn19081815",175000,175000,0,0
TIKI,phu-kien-thoi-trang,102803271,"Sét kẹp tóc 5 món siêu xinh",34900,34900,0,0
TIKI,phu-kien-thoi-trang,89947925,"Khăn choàng nữ, Khăn voan choàng cổ cỡ lớn 206010",27800,44000,16200,37
TIKI,phu-kien-thoi-trang,165192946,"3 đôi tất gấu nữ cổ ngắn hình gấu - tất cổ ngắn nữ - giao màu ngẫu nhiên ",15000,45000,30000,67
TIKI,phu-kien-thoi-trang,24629723,"Kính Mát Nam Cao Cấp Kèm Hộp Và Khăn Lau Sang Trọng Đẳng Cấp Nhất - Phân Phối Cao Cấp",95000,198000,103000,52
TIKI,may-anh,109580308,"Chân máy quay Coman DF-06, Hàng chính hãng",2349999,2349999,0,0
TIKI,may-anh,154590799,"Camera Wifi Ngoài Trời EZVIZ C3W Color Night Pro 4Mp, Đèn Và Còi Báo Động, Tính Năng AI - Hàng chính hãng",1950000,1950000,0,0
TIKI,may-anh,10375024,"Hít kính 3 chân đế mini gắn GoPro Hero lên kính xe hơi",59000,59000,0,0
TIKI,may-anh,134958087,"Dây đeo ngực + Đế chữ J + Ốc vít Kết Nối Khớp Với Gopro Camera Hành Trình",115000,115000,0,0
TIKI,may-anh,2570631,"Bộ Đèn Chụp Sản Phẩm (600W) - Hàng Nhập Khẩu",1399000,1399000,0,0
TIKI,may-anh,34477918,"Camera lùi ô tô siêu nét full HD chống nước",154000,168000,14000,8
TIKI,may-anh,214756796,"Camera quan sát từ xa qua điện thoại, tự động quay lưu",750000,750000,0,0
TIKI,may-anh,74536460,"Kính thiên văn PowerSeeker 50AZ 450x, hiệu Celestron chính hãng Mỹ, kính phủ FMC chống lóa",1620000,1620000,0,0
TIKI,may-anh,3597899,"Bộ Chân Máy Ảnh Bạch Tuộc Lớn Và Đầu Bi Chân Máy Ảnh Thân Kim Loại Q00159",159000,159000,0,0
TIKI,may-anh,22492463,"Tay cầm GoPro và Action Cam tích hợp Pin Kingma - Hàng Nhập Khẩu",469999,469999,0,0
TIKI,may-anh,108341744,"Combo 2 pin 1 sạc đôi Kingma for Canon LP-E17 - Hàng chính hãng",549999,549999,0,0
TIKI,may-anh,104070232,"Đầu ghi 8 kênh Dahua DH-XVR1A08 - Đâu ghi hình camera 1080P - Hàng chính hãng",1350000,1350000,0,0
TIKI,may-anh,4707917,"Đèn LED Yongnuo 600 (Đen) - Hàng Nhập Khẩu",1949999,1949999,0,0
TIKI,may-anh,37155769,"Đèn Flash Godox TT600 Tặng Kèm Bộ Pin Sạc - Hàng Nhập Khẩu",1799999,1799999,0,0
TIKI,may-anh,127187953,"Combo Camera Wi-fi Trong Nhà EZVIZ C6N 2MP và Thẻ Nhớ 32GB/64GB - Hàng Chính Hãng",450000,450000,0,0
TIKI,may-anh,11891323,"Đầu Ghi Hình Dahua NVR2108HS-4KS2-Hàng Chính Hãng",1850000,1850000,0,0
TIKI,may-anh,15927483,"Chân Máy Ảnh Tripod Beike Q999 - Hàng Chính Hãng",1074999,1074999,0,0
TIKI,may-anh,52188469,"Phông vải key hình 2 mặt di động chuyên nghiệp (1.5 x 2m)",1050000,1050000,0,0
TIKI,may-anh,109992240,"Túi máy ảnh Safrotto H1-S, Hàng chính hãng",499999,499999,0,0
TIKI,may-anh,4712551,"Túi Chống Sốc Đựng Chân Đèn Size L - Hàng Nhập Khẩu",499000,499000,0,0
TIKI,may-anh,109083771,"Combo pin sạc Kingma cho Fujifilm NP-W235, Hàng chính hãng",249999,249999,0,0
TIKI,may-anh,28736848,"Combo Tản sáng Godox AK-R1 và ngàm Godox S-R1",1049999,1049999,0,0
TIKI,may-anh,50600150,"Kingma 2 Pin + 1 Sạc 3 Pin Cho Gopro Hero 5/6/7/8 - Hàng nhập khẩu",529999,529999,0,0
TIKI,ngon,177153750,"[ Chỉ giao HN] - Cổ inox lớn",35000,35000,0,0
TIKI,ngon,177154308,"[ Chỉ giao HN] - Xịt Chống ngứa cho chó và mèo 236nl",295000,295000,0,0
TIKI,ngon,177235328,"[ Chỉ giao HN] -Túi vải mặt cảm xúc Size nhỏ",145000,145000,0,0
TIKI,ngon,177153853,"[ Chỉ giao HN]- Áo số đá bóng 2XL",45000,45000,0,0
TIKI,may-anh,14534576,"Bộ 2 pin và đế sạc kép RAVPower RP-BC014 tương thích Canon LP-E10 - Hàng Chính Hãng",649999,649999,0,0
TIKI,ngon,177154226,"[ Chỉ giao HN] - Sữa tắm Pluto Deardor khử mùi hôi 300ml",102000,102000,0,0
TIKI,ngon,177154330,"[ Chỉ giao HN] - Đầm xếp ly size S",105000,105000,0,0
TIKI,may-anh,269900405,"Kính Hiển Vi Điện Tử WIFI W04 1000x",750000,750000,0,0
TIKI,ngon,177479462,"[ Chỉ giao HN ] -  Thức ăn cho mèo sau 3M 500g",64000,64000,0,0
TIKI,ngon,177154186,"[ Chỉ giao HN] - Chén nhựa Melamine Glam 20x19x6 cm (xanh lá)",157000,157000,0,0
TIKI,may-anh,97651658,"Chân đế cao cấp cho máy ảnh, ống nhòm Carson Rock TR-200 - Hàng chính hãng",2780000,2780000,0,0
TIKI,ngon,177154218,"[ Chỉ giao HN] - Sữa tắm 5 sao 300ml",98000,98000,0,0
TIKI,may-anh,4755099,"Dụng Cụ Tháo Mở Lens Chuyên Nghiệp - Hàng Nhập Khẩu",399000,399000,0,0
TIKI,ngon,177783111,"[ Chỉ giao HN] - Sốt cá hồi cho mèo 130g",20000,20000,0,0
TIKI,ngon,177479427,"[ Chỉ giao HN ] - Thuốc xổ giun Rantel Plus 10g/v",15000,15000,0,0
TIKI,may-anh,97649318,"Chân đế cao cấp cho máy ảnh, ống nhòm Carson Rock TR-300 - Hàng chính hãng",3050000,3050000,0,0
TIKI,ngon,177585078,"[Chỉ giao HN ] - Cat Treat Shrimp 50g (vị Tôm)",13000,13000,0,0
TIKI,may-anh,26086283,"KÍNH LỌC HOYA UX UV SIZE 77MM - Hàng Chính Hãng",599999,599999,0,0
TIKI,may-anh,125499125,"Camera WiFi V380 Mini Hành Trình 1080P WiFi Không Dây HD Quan Sát Ban Đêm IR Camera An Ninh Gia Đình Quan Sát Từ Xa Trên Điện Thoại-Tặng kèm cục nguồn sạc 5V-1A",260000,260000,0,0
TIKI,may-anh,124254502,"Ống nhòm 2 Mắt Thiết Kế Chắc Chắn Độ Phóng Đại 10X SA60X90",655500,690000,34500,5
TIKI,ngon,177154146,"[ Chỉ giao HN] -Thức ăn cho chó lớn 1.5kg",180000,180000,0,0
TIKI,ngon,177235762,"[ Chỉ giao HN] - đồ chơi hình xương có gai cỡ nhỏ",75000,75000,0,0
TIKI,may-anh,171055509,"Trọn Bộ 4 Camera Quan Sát Trong Nhà, Ngoài Trời Hikvision 2.0MP Full HD 1080P - Hàng Chính Hãng",6000000,6000000,0,0
TIKI,may-anh,92496723,"Gậy chụp ảnh 3 chân Tripod  TF 3110",54000,60225,6225,10
TIKI,may-anh,218756111,"Camera Lùi 5 Chân Hồng Ngoại Kết Nối Camera Hành Trình Gương Bằng Jack 2.5mm",289000,289000,0,0
TIKI,may-anh,97684079,"Ống nhòm Fomei 10x32 DCF - Hàng chính hãng",3080000,3080000,0,0
TIKI,may-anh,109504357,"Chân máy ảnh Monopod Coman DT286C Carbon, Hàng chính hãng",1249999,1249999,0,0
TIKI,may-anh,186208864,"Tủ chống ẩm Andbon AB-50C, 50 lít - Hàng chính hãng",1549999,1549999,0,0
TIKI,may-anh,2533237,"Bộ Gel 12 Màu For Flash Speedlite",79000,79000,0,0
TIKI,may-anh,19578553,"DDPai MINI 2 Camera hành trình độ nét cao, tích hợp kết nối Wifi không dây. Độ phân giải 2K Ultra HD. Hàng nhập khẩu",1150000,1150000,0,0
TIKI,ngon,177462035,"[ Chỉ giao HN ] - Thức ăn cho chó con CP Classic Vị sữa 2.0kg",130000,130000,0,0
TIKI,ngon,177153935,"[ Chỉ giao HN] - Sữa tắm ngứa do nhiễm nấm Miconazole 355ml",495000,495000,0,0
TIKI,ngon,177153792,"[ Chỉ giao HN]- Áo NOEL size 7",85000,85000,0,0
TIKI,may-anh,206335803,"Túi máy ảnh nhỏ gọn D26",270000,270000,0,0
TIKI,ngon,177154192,"[ Chỉ giao HN] -Canxi phospho 50 viên",276000,276000,0,0
TIKI,ngon,177235307,"[ Chỉ giao HN] - Đồ chơi mèo hình tròn gắm lông vũ",130000,130000,0,0
TIKI,ngon,177665446,"[ Chỉ giao HN] - Thức ăn cho Pet Mini Puppy 800gr",183000,183000,0,0
TIKI,may-anh,72740809,"Thiết Bị Blackmagic ATEM Mini  | Chính hãng",5200000,5200000,0,0
TIKI,may-anh,44841823,"Mắt Camera ngoài trời Hikvision DS-2CE16D0T-IRP 2MP - Hàng chính hãng",438000,438000,0,0
TIKI,may-anh,4708407,"Kẹp Ghi Đông Xe Máy Loại Lớn Gắn Gopro Sjcam Xiaoyi (Đen) - Hàng Nhập Khẩu",59000,59000,0,0
TIKI,may-anh,50598485,"Camera IP Ngoài trời Yoosee PTZ 2 Râu FullHD 1080P 6 LED trợ sáng, 4 LED hồng ngoại, đàm thoại 2 chiều, hỗ trợ xoay 360 (trắng) Hàng Nhập Khẩu",660000,660000,0,0
TIKI,may-anh,91369845,"Kính Xem Phim  3D",84500,84500,0,0
TIKI,phu-kien-thoi-trang,56086461,"Mũ Chống Nắng Vải Dù Dễ Thương MU011 MayHomes Chất Liệu Bền Đẹp, Thời Trang",85000,85000,0,0
TIKI,may-anh,50325159,"Ống nhòm hải tặc một mắt 25x30 - Thiết kế theo khuôn mẫu phục cổ với độ phóng đại cao cùng hình ảnh sắc nét trong một hình hài nhỏ gọn",700000,700000,0,0
TIKI,may-anh,99350400,"Camera DAHUA Dome HAC-T1A21P - Hàng Chính Hãng",320000,320000,0,0
TIKI,may-anh,19565935,"Phụ kiện thanh nối đa năng gắn đến 4 điện thoại lên tripod hỗ trợ livestream, quay video nhiều điện thoại cùng lúc",275000,275000,0,0
TIKI,phu-kien-thoi-trang,91387235,"MẮT KÍNH NAM CAO CẤP P8738",173000,194000,21000,11
TIKI,phu-kien-thoi-trang,1717387,"Mắt Kính Nữ V Hàn Quốc - Đen",67925,71500,3575,5
TIKI,ngon,177154196,"[ Chỉ giao HN] - Thức ăn cho mèo thạch thịt gà 70g",16500,16500,0,0
TIKI,may-anh,140120490,"Camera HDCVI ngoài trời có mic 2MP DAHUA DH-HAC-HFW1200TLP-A-S5 hàng chính hãng DSS Việt Nam",650000,650000,0,0
TIKI,phu-kien-thoi-trang,90871477,"Gọng kính cận mặt vuông 329 dành cho nam và nữ hot trend 2021",89000,89000,0,0
TIKI,phu-kien-thoi-trang,73506685,"Dây Nịt Nam SAM Leather SFDN201- Thắt Lưng Nam Da Bò Cao Cấp/ Mặt Khoá Thắt Lưng Hợp kim kẽm Không Gỉ, Men's belts",499000,499000,0,0
TIKI,may-anh,199020831,"Thẻ Nhớ CompactFlash (CF) SanDisk Extreme 32GB 800X SDCFXSB-032G - Hàng Nhập Khẩu",850000,850000,0,0
TIKI,ngon,177234533,"[ Chỉ giao HN] - Dây dắt mèo kèm nơ 06x130cm",78000,78000,0,0
TIKI,ngon,177589531,"[Chỉ giao HN ] - Thức ăn Meo thường 350g",32000,32000,0,0
TIKI,may-anh,11508815,"Video Balun Chuyên Dùng Camera AHD - CVI- TVI 2MP-Hàng chính hãng",25000,25000,0,0
TIKI,phu-kien-thoi-trang,164021652,"Kính Mát Nam AORON, Tròng phân cực chống chói chống lóa đi xe ngày và đêm, dáng ôm sát mắt thời trang AK020 - AORON",250000,290000,40000,14
TIKI,may-anh,193155101,"Dây Đeo Gắn Cằm Nón Bảo Hiểm Fullface Dành Cho Go-pro Điện Thoại ,Quay Phim, Chụp Ảnh Chất Lượng Cao Điều Chỉnh",49000,49000,0,0
TIKI,ngon,177665447,"[ Chỉ giao HN] - Thức ăn cho PetChihuahua junior 1.5kg",372000,372000,0,0
TIKI,phu-kien-thoi-trang,112605607,"Kính mát phân cực nam NQ007 - Đen",199000,199000,0,0
TIKI,may-anh,74243537,"Ống nhòm quân sự Barska 8x30 WP Battalion (có vạch ly giác) - Hàng chính hãng",9800000,9800000,0,0
TIKI,may-anh,102913207,"Camera nội soi lấy ráy tai có đèn LED hỗ trợ kết nối USB với điện thoại thông minh .",149000,149000,0,0
TIKI,may-anh,66824886,"Dây đeo máy ảnh cổ tay da",84000,84000,0,0
TIKI,ngon,177235207,"[ Chỉ giao HN] - Vòng cổ nơ 1,5cm",40000,40000,0,0
TIKI,ngon,177154126,"[ Chỉ giao HN] - Dây dắt yếm 08x130cm tay cầm tam giác",92000,92000,0,0
TIKI,may-anh,7250287,"Ngàm đảo đầu ống kính chụp Macro Canon EOS",79000,79000,0,0
TIKI,may-anh,4739273,"Lens Hood HB-35 (Đen) - Hàng Nhập Khẩu",89000,89000,0,0
TIKI,may-anh,192292298,"Camera IP Wifi ốp trần không dây V380 Pro Full HD Góc Quay Siêu Rộng 180° hình ảnh chân thực siêu nét",284050,299000,14950,5
TIKI,phu-kien-thoi-trang,190681505,"Nón Lưỡi Trai Trơn Hot Trend Bóng Chày fom Baseball  - Vải loại 1- Chất lượng cao- Onehatshop",195000,195000,0,0
TIKI,phu-kien-thoi-trang,133528694,"Kính Mát Nam Mắt tròn nhỏ Kim loại 2 tròng Phong cách siêu Độc lạ",179550,189000,9450,5
TIKI,may-anh,12389711,"Camera hành động Waterproof Sports Cam 1080 Full HD Chống Nước",249000,249000,0,0
TIKI,may-anh,76514892,"Intel RealSense Depth Camera D455 - Hàng Chính Hãng",16924400,16924400,0,0
TIKI,phu-kien-thoi-trang,194026645,"Thắt Lưng Da Cá Sấu Liền 4 cm",949000,1500000,551000,37
TIKI,may-anh,58614371,"Combo 2 pin 1 sạc đôi Kingma LP-E6 hàng chính hãng.",724999,724999,0,0
TIKI,may-anh,163023310,"Chân Đế Camera Nhôm",42600,42600,0,0
TIKI,ngon,177589513,"[Chỉ giao HN ] - Thức ăn cho mèo cá ngừ thịt đỏ và tôm trong thạch 70g",14000,14000,0,0
TIKI,may-anh,53660250,"Túi đựng máy ảnh thời trang K883",270000,270000,0,0
TIKI,may-anh,216908031,"Kính lọc K&F CONCEPT ND2-400 Fader Variable ND Filter 37mm 40.5mm 43mm 46mm 49mm 52mm 55mm 58mm 62mm 67mm 72mm 77mm 82mm",749000,749000,0,0
TIKI,may-anh,7306517,"Ngàm chuyển lens M42 - Canon EOS Camera ( Black )",79000,79000,0,0
TIKI,ngon,177665425,"[ Chỉ giao HN] - Thức ăn cho Pet Medium Puppy 4kg",610000,610000,0,0
TIKI,may-anh,72182554,"Chân máy ảnh Tripod Beike Q-160S",749999,749999,0,0
TIKI,phu-kien-thoi-trang,193607062,"LINE TÓC GIẢ/ SỢI NỐI MÀU/ HIGHTLIGHT TÓC BẢNG 26 MÀU",6600,6600,0,0
TIKI,may-anh,161497792,"Camera Hành Trình Elitek EJV T666G - HÀNG NHẬP KHẨU",1200000,1200000,0,0
TIKI,ngon,177154242,"[ Chỉ giao HN] - Bóng lật đật",44000,44000,0,0
TIKI,phu-kien-thoi-trang,155273506,"Mắt kính thời trang chống tia bức xạ UV, chống bụi gọng nhựa tròn K0115 unisex nam nữ style giả cận, phong cách tri thức, lịch sự",36000,72000,36000,50
TIKI,phu-kien-thoi-trang,44370563,"Đai váy thắt lưng nữ dây nịt nữ chất liệu da thật hàng cao cấp NT251",199000,199000,0,0
TIKI,ngon,177235514,"[ Chỉ giao HN] - Bánh xương chó con dentastix56g",37000,37000,0,0
TIKI,phu-kien-thoi-trang,107791359,"SET KẸP TÓC 5 MÓN MẪU MỚI HÀN QUỐC SIÊU HOT (HÀNG CHUẨN TO ĐẸP)",50000,50000,0,0
TIKI,may-anh,93021143,"Bộ Thu Phát Không Dây 2 In 1 Bluetooth 5.0 Màn Hình LCD T-013",153900,162000,8100,5
TIKI,phu-kien-thoi-trang,81645160,"Kẹp tóc 5 lá",12000,12000,0,0
TIKI,ngon,177235923,"[ Chỉ giao HN]- Váy 091713 S.5",93000,93000,0,0
TIKI,may-anh,62661853,"Pin Sạc Cổng Micro USB 3.7V 650mAh 16340 Doublepow DP-CR123A - Hàng Chính Hãng",115000,115000,0,0
TIKI,phu-kien-thoi-trang,147328531,"Thắt lưng nam dây nịt không kèm mặt khóa rộng 3,5cm cho khóa tự động và khóa bấm lỗ trơn",129000,129000,0,0
TIKI,phu-kien-thoi-trang,5965063,"Chân váy chống nắng thô 2 lớp chống tia UV (giao màu ngẫu nhiên)",55000,55000,0,0
TIKI,phu-kien-thoi-trang,73385248,"Kính Giả Cận, Gọng Kính Cận Nam Nữ Mắt Vuông Thanh Lịch Không Độ Hàn Quốc - BLUE LIGHT SHOP",171000,180000,9000,5
TIKI,ngon,177623523,"[ Chỉ giao HN] - Wet Food Tuna In Jelly 80g",13000,13000,0,0
TIKI,ngon,177235629,"[ Chỉ giao HN] - Đồ chơi con gấu/chuột/chó",85000,85000,0,0
TIKI,phu-kien-thoi-trang,162036311,"Set Thun Cột Tóc Felling Mềm Mại Siêu Co Giãn",5100,5100,0,0
TIKI,phu-kien-thoi-trang,100858681," Thắt lưng nam vải bố,dây nịt nam vải dù khóa chống gỉ siêu bền cao cấp R17",64080,89000,24920,28
TIKI,ngon,177235198,"[ Chỉ giao HN] - Nhỏ rận cho chó Plus từ 10-20kg",190000,190000,0,0
TIKI,ngon,177153828,"[ Chỉ giao HN] - Vòng cổ dề size 2",45000,45000,0,0
TIKI,may-anh,4727345,"Dây Đeo Cổ Tay Leather Style C - Hàng Nhập Khẩu",59000,59000,0,0
TIKI,may-anh,14119360,"Chân máy Tripod Yunteng VCT 5208 - Hàng Chính Hãng",185000,199590,14590,7
TIKI,may-anh,102516193,"Kính hiển vi mini kẹp điện thoại phóng đại 60 lần siêu nét V2 (Tặng móc khóa tô vít đa năng 3in1 cao cấp)",179550,189000,9450,5
TIKI,phu-kien-thoi-trang,117200633,"Băng đô nhựa dẻo gấp gọn bỏ túi, bờm cài tóc co giãn tiện lợi - tiemcuaxu",29000,34900,5900,17
TIKI,phu-kien-thoi-trang,51654457,"Băng đô turban Hàn Quốc dễ thương chất vải dày đẹp mát",44900,44900,0,0
TIKI,phu-kien-thoi-trang,74387426,"Khăn quàng cổ thời trang lụa mềm Hàn Quốc đa năng AKL71 kẻ sọc",59000,59000,0,0
TIKI,phu-kien-thoi-trang,192683644,"Tất Nữ Cổ Trung Thời Trang Hàn Quốc Mẫu Trái Cây, Vớ Nữ Cổ Lửng Cotton Cao Cấp Êm Mềm Thoáng Khí - LISU13-LUNG-TRAICAY",12900,25000,12100,48
TIKI,phu-kien-thoi-trang,10766711,"Kính mát thể thao Unisex Tifosi Swick - Gọng Satin Black/Crimson, Tròng Smoke Red",950000,950000,0,0
TIKI,phu-kien-thoi-trang,52578305,"THẮT LƯNG NỮ DÂY NỊT NỮ MANG ĐẦM VÁY SQUARE DN20TL0402",73000,88000,15000,17
TIKI,ngon,177462010,"[ Chỉ giao HN ] - Bàn lò xo mèo tập tát đế vuông",84000,84000,0,0
TIKI,ngon,177235860,"[ Chỉ giao HN] -Dây dắt + Vòng cổ nilon khóa màu 1,5 cm",51000,51000,0,0
TIKI,may-anh,179555815,"Camera Ngoài Trời YOOSEE 516-4R 5.0MP 4 râu Xoay ngoài trời 36 LED siêu nét - HÀNG CHÍNH HÃNG",525000,525000,0,0
TIKI,ngon,177623528,"[ Chỉ giao HN] - Đồ chơi dây thừng 23cm",23000,23000,0,0
TIKI,phu-kien-thoi-trang,52125084,"Gọng Kính Cận, Kính Giả Cận Nam Nữ Mắt Mèo Tròn Trong Suốt Gọng Vàng Không Độ Hàn Quốc - BLUE LIGHT SHOP",105000,130000,25000,19
TIKI,may-anh,196562264,"Camera wifi Yoosee 4 Râu 17 Led FULL HD 5.0Mpx, Xoay 360°, Đàm Thoại Hai Chiều, Báo Động Chống Trộm, Chuyên Dụng Ngoài Trời - Hàng Nhập Khẩu",450000,700000,250000,36
TIKI,phu-kien-thoi-trang,181692677,"Lens thẩm mỹ che khuyết điểm Angel Eyes dành cho mắt bị đục thủy tinh thế, kéo mây, cườm",500000,500000,0,0
TIKI,may-anh,109586850,"Chân máy quay Coman DF06Q5Plus, Hàng chính hãng",2449999,2449999,0,0
TIKI,phu-kien-thoi-trang,72463754,"Nón bucket hoa cúc đẹp dành cho nam và nữ hot trend, vải cotton bền đẹp, thêu nổi hoa cúc thời trang - Hạnh Dương",39000,39000,0,0
TIKI,may-anh,114731369,"Chân máy quay Benro KH26 Video Tripod Kit	- Hàng Chính Hãng",3790000,3790000,0,0
TIKI,phu-kien-thoi-trang,48036318,"GỌNG KÍNH UNISEX VIGCOM VG1633",278000,520000,242000,47
TIKI,phu-kien-thoi-trang,7624769,"Gọng Kính Unisex Accede AC2013 MBK",175000,340000,165000,49
TIKI,may-anh,192124206,"Dây Đeo Máy Ảnh Cổ Tay ",99000,99000,0,0
TIKI,phu-kien-thoi-trang,8716190,"Băng Đô Cài Tóc Kim Loại Ngọc Trai",110000,110000,0,0
TIKI,phu-kien-thoi-trang,104415308,"Set kẹp tóc nơ lụa nơ nhung mini xinh xắn",20000,20000,0,0
TIKI,phu-kien-thoi-trang,87621399,"Mũ rộng vành chống nắng đi biển gấp gọn. Nón rộng vành chống nắng đi biển gấp gọn. Mũ đi biển rộng vành. Nón đi biển rộng vành chống tia UV thời trang Hàn Quốc dona21033017",151000,159000,8000,5
TIKI,may-anh,52336847,"Kính hiển vi STV-120M cầm tay",481000,585000,104000,18
TIKI,ngon,177154174,"[ Chỉ giao HN] -Rubber - khay thức ăn",40000,40000,0,0
TIKI,phu-kien-thoi-trang,96312308,"Khăn Choàng Cổ Len (Khăn Cashmere Len) Cao Cấp Giữ Ấm Mùa Đông - 40x180cm - Handmade - Mã LN004",155000,155000,0,0
TIKI,phu-kien-thoi-trang,87623610,"Ghim cài áo, ghim cài quần rộng eo, bóp eo váy hoạ tiết hình khối nhiều màu sắc",26000,26000,0,0
TIKI,phu-kien-thoi-trang,181692834,"Lens cận loạn thị Angel Eyes - Độ cận 0 - 7.00 độ - Độ loạn từ 0.75 đến 2.75 độ - 5 trục cơ bản 0, 20, 90, 160, 180",300000,300000,0,0
TIKI,phu-kien-thoi-trang,177545783,"Khăn Choàng Voan Lụa In Họa Tiết Thời Trang Cao Cấp-Size 90cmx180cm",219000,219000,0,0
TIKI,may-anh,66385255,"Gậy,cây,chân đế TC-88 chuyên dành cho quay video,chụp ảnh [ TITOK,LIVETREAM,VIDEO,CHỤP HÌNH ]",249000,279000,30000,11
TIKI,phu-kien-thoi-trang,100354935,"Ghim/pins cài cố định quần/áo HOT TREND 2021 ulzzang",14000,14000,0,0
TIKI,may-anh,9974013,"Đầu Ghi Hình HD 4MP 4 Kênh Chuẩn H.265 Pro+ HIKVISION DS-7204HQHI-K1 - Hàng chính hãng",1240000,1240000,0,0
TIKI,ngon,160392720,"Tôm Surimi chả tôm định hình",64000,64000,0,0
TIKI,ngon,177235870,"[ Chỉ giao HN] - Vòng cổ chuông 1cm",20000,20000,0,0
TIKI,ngon,109396585,"[CHỈ GIAO HN] - CUA RỐC XAY VITOT FOOD (4- 5túi/kg)",129000,129000,0,0
TIKI,phu-kien-thoi-trang,138337336,"Tất cao cổ len xù chân mèo mềm, dày và ấm",26000,26000,0,0
TIKI,ngon,169843977,"Đặc Sản Nha Trang - Khô Cá Mai Nha Trang, Seavy Gói 500 Gram",180000,180000,0,0
TIKI,ngon,168463044,"Đặc Sản Nha Trang - Mắm Ruột Cá Thu Ngừ Hương Vị Truyền Thống Seavy Hộp 500g",82000,85000,3000,4
TIKI,ngon,104008001,"[Chỉ Giao HN] Cam vàng Navel - 1KG",89000,89000,0,0
TIKI,ngon,179371944,"Phô mai que kéo sợi Mozzarella thơm ngậy Đôi Đũa Vàng 300gr - Giao tại Hà Nội và Hồ Chí Minh",199000,199000,0,0
TIKI,ngon,193881175,"Mỳ 8 vị đặc sản Bắc Giang - 1kg",85000,85000,0,0
TIKI,ngon,118588322,"Bánh nướng thập cẩm nhân lạp xưởng, lá chanh, hạt sen, hạt dưa",50000,50000,0,0
TIKI,ngon,176170680,"[ Chỉ giao HN] - Đùi tháo khớp 2kg",245000,245000,0,0
TIKI,ngon,193881191,"Mỳ chũ rau củ Bắc Giang - 1kg",80000,80000,0,0
TIKI,ngon,177714038,"Bim Bim Que Thái Lan",7000,7000,0,0
TIKI,ngon,176909569,"[Chỉ giao HN] - Xúc xích Đức Việt- Túi 500g",48000,82000,34000,41
TIKI,ngon,118988738,"[Chỉ giao HN] - Trứng Cá Ngừ Đại Dương – 1Kg",319000,319000,0,0
TIKI,ngon,171833835,"[ Chỉ giao HN] -Raw Food Chim cút dứa vừng 250gr",45000,45000,0,0
TIKI,ngon,195329408,"Đặc Sản Nha Trang - Khô Cá Bò Đại Dương Phi Lê Tẩm Gia Vị Sẵn, Seavy Hộp 400g",135000,140000,5000,4
TIKI,ngon,129521030,"Vú Sữa Lò Rèn SKYFRUIT",49000,49000,0,0
TIKI,ngon,126809018,"[ Chỉ giao HN] - Cơm sầu Thái khay 800g - 1,2 kg",267000,267000,0,0
TIKI,ngon,169342826,"Đặc Sản Nha Trang - Nước Mắm Nhĩ Cá Cơm 584 Nha Trang 35 Độ Đạm, Seavy Hộp 6 Chai 180ml",168000,170000,2000,1
TIKI,ngon,108276806,"[Chỉ giao HN] - Giỏ trái cây A 481 -  Giỏ",480000,480000,0,0
TIKI,ngon,155495694,"[Chỉ giao HN]Khoai Tây Baby- 1kg",36000,36000,0,0
TIKI,ngon,184790625,"Cánh gà khúc giữa Ba Lan - 1kg",84000,84000,0,0
TIKI,ngon,116553139,"[Chỉ giao HN] - Bắp Hoa Trâu - Khay 1Kg Hút Chân Không",379000,379000,0,0
TIKI,ngon,179510971,"Pizza nhân thịt heo bằm sốt phô mai Đôi Đũa Vàng hộp 350g đậm đà hương vị truyền thống",205000,205000,0,0
TIKI,ngon,163554369,"[Chỉ giao HN] - Móng heo - Túi 2 chiếc ( 1,1kg)",78000,78000,0,0
TIKI,ngon,144238806,"[Chỉ giao HN] - Hồng Sấy Dẻo - Món Ngon Từ Đà Lạt - Quà Biếu Sang Trọng",199000,199000,0,0
TIKI,ngon,142203019,"[CHỈ GIAO HN] Mận đỏ An Phước 1KG",68000,68000,0,0
TIKI,ngon,163554326,"[Chỉ giao HN] - Ba chỉ bò Mỹ - Khay 500g",119000,160000,41000,26
TIKI,ngon,193128581,"[Chỉ giao HN] - Sụn Gối Gà - Túi 1Kg",135000,167000,32000,19
TIKI,ngon,179711624,"[Chỉ giao HN] - Hạnh nhân Olam sống nhập khẩu Mỹ - 1kg",370000,370000,0,0
TIKI,ngon,125796885,"[ Chỉ giao HN] -Dưa chuột 1kg",40000,40000,0,0
TIKI,ngon,180322246,"Thùng 6 chai nước mắm nhỉ Làng Chài Xưa Nhãn Đỏ 500ml/chai truyền thống vị gu ông bà",590000,590000,0,0
TIKI,ngon,103663765,"[Chỉ giao HN] - Dưa Đài Loan 1 quả - 1 quả",199000,199000,0,0
TIKI,ngon,142315251,"[Chỉ giao HN] Phô mai bào Mozzarella Anchor New Zealand gói 2kg",557000,557000,0,0
TIKI,ngon,114197781,"[Chỉ giao HN] - Khoai Lang Kén Chiên Giòn Túi 250g",50000,50000,0,0
TIKI,ngon,118510736,"Giỏ Quả Trái Cây Nhập Khẩu - Cỡ Bé",399000,399000,0,0
TIKI,ngon,120431072,"[Chỉ giao HN] - Vịt Cỏ Vân Đình Tươi Ngon Thịt Sẵn ",419000,419000,0,0
TIKI,ngon,171833856,"[ Chỉ giao HN] -Raw Food Bò nam việt quất hạt lanh 250gr",45000,45000,0,0
TIKI,ngon,176170681,"[ Chỉ giao HN] - Giò bò Cắt Khoanh 250gr",72000,72000,0,0
TIKI,ngon,168152059,"Đặc Sản Nha Trang - Mắm Ruốc Nguyên Chất Nha Trang Hương Vị Biển Khơi, Seavy Hộp 500g",68000,70000,2000,3
TIKI,ngon,171105628,"Đặc Sản Nha Trang - Cá Mú Khô Phi Lê Hộp Seavy 250G",92000,95000,3000,3
TIKI,dong-ho-va-trang-suc,97902357,"Hộp xoay đồng hồ 4 chế độ xoay - Hộp đựng 2 đồng hồ cơ, lên dây cót đồng hồ cơ",859000,859000,0,0
TIKI,dong-ho-va-trang-suc,97894870,"Hộp đựng đồng hồ - Hộp đựng 6 đồng hồ bằng gỗ màu nâu",275000,275000,0,0
TIKI,dong-ho-va-trang-suc,160424898,"Dây Đồng Hồ Da Bò Cao Cấp, Kiểu VINTAGE THREAD Phẳng Mỏng, Mặt Lót Chống Thấm Mồ Hôi, Tích Hợp Lớp Gia Cố Chống Giãn Đặc Biệt, Phụ Kiện Khóa và Chốt Bằng Thép Không Gỉ 316L - Hàng Chính Hãng SAIGIO",881000,899000,18000,2
TIKI,dong-ho-va-trang-suc,157417398,"Dây Đồng Hồ Da Bò Cao Cấp, Kiểu Dáng Cổ Điển - Phẳng Mỏng - Chỉ Trắng, Mặt Lót Chống Thấm Mồ Hôi, Tích Hợp Lớp Gia Cố Chống Giãn Đặc Biệt, Phụ Kiện Khóa và Chốt Bằng Thép Không Gỉ 316L - Hàng Chính Hãng SAIGIO",881000,889000,8000,1
TIKI,dong-ho-va-trang-suc,7796951,"Dây đồng hồ thép không gỉ dây mesh cao cấp YE-008",90000,90000,0,0
TIKI,dong-ho-va-trang-suc,118521826,"Hộp Đồng Hồ Cao Cấp, Hộp Qùa Tặng Sang Trọng",50000,50000,0,0
TIKI,dong-ho-va-trang-suc,52469205,"Bông tai nam kẹp vành không cần bấm lỗ có nhiều mẫu lựa chọn",35000,35000,0,0
TIKI,dong-ho-va-trang-suc,112084937,"Dây Da Đồng Hồ Nam, 100% Da Bò Thật, Kiểu Dáng Vintage Phẳng Mỏng, Mặt Lót Chống Thấm Mồ Hôi, Tích Hợp Lớp Gia Cố Chống Giãn Đặc Biệt, Phụ Kiện Khóa và Chốt Bằng Thép Không Gỉ 316L - Thương Hiệu SAIGIO",880000,899000,19000,2
TIKI,dong-ho-va-trang-suc,253232795,"Dây đeo đồng hồ da bò màu Xanh Navy Size 14/15/16/17/18/19/20/21/22mm - Dây đồng hồ da bò Thật 100% - Bảo Hành 12 Tháng",449000,449000,0,0
TIKI,dong-ho-va-trang-suc,111306433,"Dây Da Đồng Hồ Cổ Điển, 100% Da Bò Thật, Kiểu Dáng Phẳng Mỏng, Mặt Lót Chống Thấm Mồ Hôi, Tích Hợp Lớp Gia Cố Chống Giãn Đặc Biệt, Phụ Kiện Khóa và Chốt Bằng Thép Không Gỉ 316L - Hàng Chính Hãng SAIGIO",899000,899000,0,0
TIKI,dong-ho-va-trang-suc,67173628,"Pin Đồng hồ đeo tay Maxell SR626SW 1.55V 377",65000,65000,0,0
TIKI,dong-ho-va-trang-suc,177929229,"[5 Mét] Dây Chun Tơ Gân Lụa Co Giãn USA Magicline Dùng Xỏ Vòng Tay, Chuỗi Hạt, Trang Sức 0.5MM, Dây Cước - Bead Art",20000,20000,0,0
TIKI,dong-ho-va-trang-suc,68427641,"Dây Da Đồng hồ Da Bò thật Size Nữ Nhiều Màu [Tặng Hộp Gỗ",120000,120000,0,0
TIKI,dong-ho-va-trang-suc,21754311,"Dây Da Đồng Hồ Đủ Size - Tặng kèm Chốt và Dụng cụ thay dây",46000,46000,0,0
TIKI,dong-ho-va-trang-suc,94997356,"[Da Thật] Dây Đồng Hồ Da Bò Khóa Bướm Chống Gẫy Dây Kèm Hộp Đựng Bằng Gỗ Và Dụng Cụ Thay Dây (Size 18mm, 20mm, 22mm, 24mm) – Chính Hãng VinBuy",110000,220000,110000,50
TIKI,dong-ho-va-trang-suc,111696638,"Dây Da Đồng Hồ Cao Cấp - Sang Trọng, Chất Liệu Da Bê EPSOM Thuộc Thảo Mộc - Nhập Khẩu Từ Châu Âu, Mặt Lót Chống Thấm Mồ Hôi, Tích Hợp Lớp Gia Cố Chống Giãn Đặc Biệt và Chốt Thông Minh, Kiểu Dáng Cổ Điển Phẳng Mỏng",1879000,1899000,20000,1
TIKI,dong-ho-va-trang-suc,54687717,"Dây Đồng Hồ Da Bò Tặng Kèm Chốt và Dụng cụ",120000,120000,0,0
TIKI,dong-ho-va-trang-suc,73420992,"Hộp đựng đồng hồ Hộp dài kt 14,5 x6 x 3 cm - Hộp vuông KT: 9 x 9 x 5,5 cm",23750,25000,1250,5
TIKI,dong-ho-va-trang-suc,113957423,"Đồng Hồ Nam Chính Hãng OLEVS, Tặng Hộp Đựng Chính Hãng, Size Mặt 39mm, Mặt Kính Chống Trầy Xước, Chống Nước 3ATM Tốt, Đồng Hồ Nam Dây Da Kiểu Dáng Sang Trọng, Nam Tính, Bảo Hành 12 Tháng",479000,479000,0,0
TIKI,dong-ho-va-trang-suc,2986081,"Đồng hồ Trẻ Em Cho Bé Trai SKMEI 1266 - DHA487",229000,229000,0,0
TIKI,dong-ho-va-trang-suc,7804969,"Bộ 2 bông tai nam inox khuyên tròn 10mm BT233",35000,35000,0,0
TIKI,dong-ho-va-trang-suc,92817188," Khuyên Tai Nam Không Cần Bấm Lỗ - Bông Tai Kẹp Titan",18000,18000,0,0
TIKI,dong-ho-va-trang-suc,101660316,"Cuộn dây cước chun co dãn để xâu vòng tay",21000,21000,0,0
TIKI,dong-ho-va-trang-suc,159298167,"Dây Đồng Hồ Da Bò Cao Cấp, Kiểu Dáng Cổ Điển - Chỉ Trắng, Mặt Lót Chống Thấm Mồ Hôi, Tích Hợp Lớp Gia Cố Chống Giãn Đặc Biệt, Phụ Kiện Khóa và Chốt Bằng Thép Không Gỉ 316L - Hàng Chính Hãng SAIGIO",983000,989000,6000,1
TIKI,dong-ho-va-trang-suc,143960604,"Dây đồng hồ da bò Vintage Bụi Leather D111 - Da thật khâu tay thủ công cao cấp - Bảo hành 12 tháng",181000,327000,146000,45
TIKI,dong-ho-va-trang-suc,253236766,"Dây đeo đồng hồ da bò màu trắng Size 14/15/16/17/18/19/20/21/22mm - Dây đồng hồ da bò Thật 100% - Bảo Hành 12 Tháng",449000,449000,0,0
TIKI,dong-ho-va-trang-suc,99870574,"Dây chuyền nam 4mm - vĩnh viễn không đen - dây chuyền chuẩn chất đàn ông",85000,85000,0,0
TIKI,dong-ho-va-trang-suc,143838450,"Dây đồng hồ nam da cá sấu đốt tre Bụi Leather D103 - Hàng khâu tay thủ công cao cấp - Bảo hành 12 tháng",208000,320000,112000,35
TIKI,dong-ho-va-trang-suc,253212075,"Dây Đeo đồng hồ Da Cá Sấu Navy Chỉ Trắng Size 19/20/21/22 - Dây Đeo Da Cá Sấu Thật 100% - Bảo Hành 12 Tháng",690000,690000,0,0
TIKI,dong-ho-va-trang-suc,204039014,"Vòng tay phong thủy mix lu thống trầm hương HÀ XÁ vòng đeo tay cặp đôi nam nữ may mắn tài lộc",150000,300000,150000,50
TIKI,dong-ho-va-trang-suc,107959904,"Dây Da Đồng Hồ Cao Cấp - Sang Trọng, Chất Liệu Da Bê EPSOM Nhập Khẩu Từ Pháp, Tiêu chuẩn Châu Âu, Mặt Lót Chống Thấm Mồ Hôi, Tích Hợp Lớp Gia Cố Chống Giãn Đặc Biệt và Chốt Thông Minh Mới Nhất - Hàng Chính Hãng SAIGIO",1980000,1999000,19000,1
TIKI,dong-ho-va-trang-suc,143838450,"Dây đồng hồ nam da cá sấu đốt tre Bụi Leather D103 - Hàng khâu tay thủ công cao cấp - Bảo hành 12 tháng",208000,320000,112000,35
TIKI,dong-ho-va-trang-suc,137946676,"Dây đeo cho Miband 6 và Mi band 5 (Aurora, khóa kim loại) - (DMJA)",56000,56000,0,0
TIKI,dong-ho-va-trang-suc,7799222,"Dây đồng hồ da bò chống nước cao cấp YE-009",45000,45000,0,0
TIKI,dong-ho-va-trang-suc,7802880,"Bộ 2 bông tai nam inox khuyên tròn 14mm BT233",35000,35000,0,0
TIKI,dong-ho-va-trang-suc,35507445,"Nhẫn Nam Chất Liệu Titan Cao Cấp TT 0872",33000,75000,42000,56
TIKI,dong-ho-va-trang-suc,204038070,"Vòng tay hoa sen tốc phong thủy trầm hương HÀ XÁ đeo tay nam nữ may mắn tài lộc",199000,398000,199000,50
TIKI,dong-ho-va-trang-suc,97902357,"Hộp xoay đồng hồ 4 chế độ xoay - Hộp đựng 2 đồng hồ cơ, lên dây cót đồng hồ cơ",859000,859000,0,0
TIKI,dong-ho-va-trang-suc,188377253,"Pin LR41 / AG3 / L736F Maxell Nhật Bản 1,5V Vỉ 10 Viên",55000,55000,0,0
TIKI,dong-ho-va-trang-suc,186359295,"Vòng Dây Đeo Thể Thao Năng Động Cá Tính NBA DD101",22500,30000,7500,25
TIKI,dong-ho-va-trang-suc,145763569,"10 Viên Pin Maxell LR44 AG13 L1154 Cúc Áo 1,5V Nhật Bản",55000,55000,0,0
TIKI,dong-ho-va-trang-suc,40365257,"Dây Chuyền Nữ 1 Hạt Ngọc Trai Chất Liệu Thép Titan Ko Rỉ Ko Dị Ứng TITAN 988",54900,54900,0,0
TIKI,dong-ho-va-trang-suc,214506088,"Dây Đồng Hồ Da Cá Sấu Nâu Size 15/17/19/21/23/25mm - Dây Đeo Da Cá Sấu Thật 100% - Bảo Hành 12 Tháng",840000,840000,0,0
TIKI,dong-ho-va-trang-suc,32589534,"Đồng hồ nam dây da Skmei 90TCK58",179000,240000,61000,25
TIKI,dong-ho-va-trang-suc,16836617,"Vòng tay nam nữ bện chỉ đỏ bản to may mắn CD20",22000,22000,0,0
TIKI,dong-ho-va-trang-suc,145763594,"10 Viên Pin Maxell AG10 LR1130 LR54 Cúc Áo 1,5V Nhật Bản",50000,50000,0,0
TIKI,dong-ho-va-trang-suc,97894870,"Hộp đựng đồng hồ - Hộp đựng 6 đồng hồ bằng gỗ màu nâu",275000,275000,0,0
TIKI,dong-ho-va-trang-suc,33630695,"Vòng tay chỉ đỏ con mèo may mắn",29000,29000,0,0
TIKI,dong-ho-va-trang-suc,204282368,"Vòng tay hoa sen vàng phong thủy trầm hương HÀ XÁ 8li vòng đeo tay cặp đôi nữ may mắn tài lộc",199000,398000,199000,50
TIKI,dong-ho-va-trang-suc,62754527,"Dây Chuyền | Dây Chuyền Nữ Hình Con Bướm Xinh - XBDB46 - Bảo Ngọc Jewelry",110000,110000,0,0
TIKI,dong-ho-va-trang-suc,113403111,"Dây Chun Xâu Vòng Tay, Chuỗi Hạt - Dây Co Giãn 4 Chiều Cực Kì Bền Chắc - (5 MÉT )",99000,99000,0,0
TIKI,dong-ho-va-trang-suc,106966720,"Dây Da Đồng Hồ Cổ Điển, Chất Liệu Da Bò Thật 100%, Mặt Lót Chống Thấm Mồ Hôi, Khóa Bằng Thép Không Gỉ 316L, Nhiều Màu, Nhiều Size - Hàng Chính Hãng SAIGIO",981000,999000,18000,2
TIKI,dong-ho-va-trang-suc,59084567,"Nhẫn Nam Nữ Khui Bia Titan Khui Bia Tiện Lợi, Chuỗi Xích Đẹp Mắt, Siêu Cứng, Êm Tay",9000,11000,2000,18
TIKI,dong-ho-va-trang-suc,70841244,"3 CUỘN THUN CO GIÃN XỎ VÒNG TAY BẰNG ĐÁ MÀU TRẮNG NÂU ĐEN",56000,95000,39000,41
TIKI,dong-ho-va-trang-suc,78946345,"Đồng Hồ Nam Cao Cấp, Đồng Hồ Nam Chính Hãng ECONOMICXI Dây Thép Lụa Đen, Có Lịch Ngày Mặt Mỏng Thời Thượng - Thiết Kế Hiện Đại Và Nam Tính ECN3N",278000,278000,0,0
TIKI,ngon,177235721,"[ Chỉ giao HN]- Áo váy đính nơ 40*32",129000,129000,0,0
TIKI,ngon,177479465,"[ Chỉ giao HN ] - Kháng sinh trị hô hấp viêm phổi Amcoli 5gr",10000,10000,0,0
TIKI,ngon,177234264,"[ Chỉ giao HN] - Chụp bảo vệ khi dùng thuốc size 5",65000,65000,0,0
TIKI,ngon,177783107,"[ Chỉ giao HN] - Sốt gà phô mai rau củ 130gr (cho chó)",20000,20000,0,0
TIKI,ngon,177234934,"[ Chỉ giao HN]- Nail cho Pet XS",48000,48000,0,0
TIKI,ngon,177235500,"[ Chỉ giao HN] -Chén lạnh Chill out XL",415000,415000,0,0
TIKI,ngon,177236223,"[ Chỉ giao HN]- Váy công chúa có nơ size M",150000,150000,0,0
TIKI,ngon,177632123,"[ Chỉ giao HN] - Pate dành cho các loại mèo thịt gà và gà tây 400g",50000,50000,0,0
TIKI,ngon,177235498,"[ Chỉ giao HN] -  Dây dắt tự động dây tròn New Comfort 5m (xám)",584000,584000,0,0
TIKI,ngon,177235295,"[ Chỉ giao HN]- Áo nỉ không mũ hình hoạt hình size 5",80000,80000,0,0
TIKI,ngon,177235854,"[ Chỉ giao HN] - Sữa tắm cho chó con",229000,229000,0,0
TIKI,ngon,272777858,"Đặc Sản Nha Trang - Khô Gà Xé Lá Chanh Seavy 1Kg",340000,350000,10000,3
TIKI,ngon,156937382,"[ Chỉ giao HN] -Nấm sò vàng - 1kg",80000,80000,0,0
TIKI,ngon,273417898,"Rượu vang sủi Tây Ban Nha Sparkling Fogoso Oro 375ml (5.5%)",213000,213000,0,0
TIKI,ngon,270653328,"Đặc Sản Nha Trang - Mắm Mực Nha Trang Nguyên Con Hương Vị Tuyệt Vời , Seavy Hộp 500G",95000,100000,5000,5
TIKI,ngon,158971796,"[ Chỉ giao HN] -NẤM ĐÙI GÀ HỮU CƠ TƯƠI (KHAY) 500g",70000,70000,0,0
TIKI,ngon,258328240,"Cà Phê Tổ Yến Thơm Ngon - Date Mới",95000,95000,0,0
TIKI,ngon,248916253,"[Chỉ giao HN] - Lườn Ngỗng hun khói gói - 250g",33000,40000,7000,18
TIKI,ngon,273172029,"Đặc Sản Nha Trang- Khô Cá Hố Tẩm Nguyên Miếng Size Lớn, Mềm Dai Seavy Gói 500 gram",135000,140000,5000,4
TIKI,ngon,158715329,"Nước dừa đóng hộp Organic 100% dừa tươi nguyên chất - Thương hiệu COCOXIM 330ml",25000,25000,0,0
TIKI,ngon,155495737,"[Chỉ giao HN] Mộc Nhĩ- 100gr",22000,22000,0,0
TIKI,ngon,179711528,"[Chỉ giao HN] - Sữa hạt sen đậu xanh ít đường - size L (1000ml)",131000,131000,0,0
TIKI,ngon,180322195,"Thùng 6 chai nước mắm tôm biển Làng Chài Xưa 525ml Hồng Ngọc Đại Dương 300 năm truyền thống",540000,540000,0,0
TIKI,ngon,176170766,"[ Chỉ giao HN] - Má đùi gà 2kg",230000,230000,0,0
TIKI,ngon,179711793,"[Chỉ giao HN] - Sữa đậu gà đậu đỏ ít đường - size S (325ml)",34000,34000,0,0
TIKI,ngon,158715327,"01 Thùng/ 12 Hộp Sữa Dừa Nguyên Chất Cocoxim 330ml",228000,228000,0,0
TIKI,ngon,158971771,"[ Chỉ giao HN] - Nấm Hầu thủ khô gói 500g",600000,600000,0,0
TIKI,ngon,187658108,"Đặc Sản Nha Trang - Mực Tẩm Gia Vị Nha Trang Size Nhỏ Seavy Hộp 200G",172000,180000,8000,4
TIKI,ngon,155495731,"[Chỉ giao HN]Gạo Lứt Đen -1kg",26000,26000,0,0
TIKI,ngon,114197815,"[Chỉ giao HN] - Đậu Nành Xanh Đông Lạnh Nhật Bản Edamame 500G",139000,139000,0,0
TIKI,ngon,142315233,"Socola Tươi Vị Trà Xanh Nhật Bản H3Q Miki KHÔNG PHẨM MÀU (Từ Bơ Sữa New Zealand) Lọ Thủy Tinh 125g",172000,172000,0,0
TIKI,ngon,171217507,"[ Chỉ giao HN] - Gạo ST25 VinaFood Túi 5kg",205000,205000,0,0
TIKI,ngon,179711471,"[Chỉ giao HN] - Sữa hạnh nhân đậu đỏ không đường - size M (550ml)",65000,65000,0,0
TIKI,ngon,155495719,"[Chỉ giao HN]Rau Muống - 500gr",14000,14000,0,0
TIKI,ngon,142315225,"[Chỉ giao HN] Bơ mặn Anchor New Zealand miếng 200g",122000,122000,0,0
TIKI,ngon,119308619,"[Chỉ Giao Hà Nội] Chân giò hun khói 400g",127000,127000,0,0
TIKI,ngon,155114725," HỒNG TRÀ SỮA 5 IN 1 - 500gr",80000,80000,0,0
TIKI,ngon,159110870,"[Giao nội thành Hà Nội] Củ riềng tươi Vườn Nhà Mẹ - Gia vị tươi, sạch, chất lượng cao, chuẩn VietGap",20000,20000,0,0
TIKI,ngon,177714057,"SỐT MÙ TẠT MẬT ONG CHAI 1KG",105000,105000,0,0
TIKI,ngon,179491061,"Pizza hải sản tươi ngon ngập sốt phô mai Đôi Đũa Vàng hộp 350g - Giao tại Hà Nội và Hồ Chí Minh",219000,219000,0,0
TIKI,ngon,190605428,"[ Chỉ giao HN] - Cánh gà chiên giòn 400gr",74500,74500,0,0
TIKI,ngon,165998121,"[HN] 04 Chai Nước Ép Lạnh Rau Củ Quả Hữu Cơ",280000,280000,0,0
TIKI,ngon,108262820,"[Chỉ giao HN] - Giỏ trái cây A 484 - Giỏ",480000,480000,0,0
TIKI,ngon,179711664,"[Chỉ giao HN] - Sữa đậu gà đậu đỏ ít đường - size L (1000ml)",84000,84000,0,0
TIKI,ngon,116553135,"[Chỉ giao HN] - Ruốc Tôm - 1 Hộp 500g",299000,299000,0,0
TIKI,ngon,173186998,"[Chỉ giao HN] - Thịt Lợn Nạc Vai Nga Say Sẵn - 500g",142000,142000,0,0
TIKI,ngon,109864002,"NutiMilk Thùng 48 Hộp Sữa chua Nha Đam TU.NSCNDTI Nutifood",336000,336000,0,0
TIKI,ngon,126809006,"[ Chỉ giao HN] - Thịt ghẹ 300g",130000,130000,0,0
TIKI,ngon,159728991,"[Chỉ giao HN] - Cánh gà khúc giữa Nhập Khẩu -  1kg",95000,95000,0,0
TIKI,ngon,187636616,"Đặc Sản Nha Trang -️ Mực Tẩm Gia Vị Nha Trang Từ Mực Lá Cay Nhẹ, Thơm Ngon, Size Nhỏ Seavy Gói 500g  ️",435000,450000,15000,3
TIKI,ngon,163554332,"[Chỉ giao HN] - Đùi gà tháo khớp - túi 1 chiếc",89000,89000,0,0
TIKI,ngon,120800175,"[Chỉ giao HN] -Lê Xanh Hàn Quốc - 1Kg",110000,110000,0,0
TIKI,ngon,158971760,"[ Chỉ giao HN] - Linh chi sừng hươu hữu cơ thái lát hộp 200g",400000,400000,0,0
TIKI,ngon,125796861,"[ Chỉ giao HN] -Xà lách rocket 500g",113000,113000,0,0
TIKI,ngon,168373152,"Đặc Sản Nha Trang -Mắm Cá Thu Xay Hương Vị Trọn Vẹn Từ Đại Dương, Đỉnh Cao Ẩm Thực Seavy Hộp 500g",95000,100000,5000,5
TIKI,ngon,158715286,"Nước trái cây thể thao Isotonic Active hương vị Acai Berry đóng hộp từ 100% Dừa tươi nguyên chất - 330ml",19000,19000,0,0
TIKI,ngon,155495741,"[Chỉ giao HN ] Khoai Tây Chiên-1kg",50000,50000,0,0
TIKI,ngon,115833268,"[CHỈ GIAO HN] - CÁ ĐÙI GÀ 1 NẮNG VITOT FOOD (500g/ khay)",139000,139000,0,0
TIKI,ngon,197098459,"Bánh xếp nhân thịt heo Đôi Đũa Vàng dimsum tươi ngon dinh dưỡng 300g",116000,116000,0,0
TIKI,ngon,258327613,"(Yến sào nha trang)Tổ Yến Ăn Liền Gold Nhuỵ Hoa Nghệ Tây 10g Hộp To",1550000,1550000,0,0
TIKI,ngon,108276750,"[Chỉ giao HN] - Giỏ trái cây A 480 - Giỏ",480000,480000,0,0
TIKI,ngon,156937374,"[ Chỉ giao HN] -Nấm sò nâu thái - 1kg",80000,80000,0,0
TIKI,ngon,142315191,"[Chỉ giao HN] Salad rong biển Wakame Nhật Bản đông lạnh Lọ 100g",55000,55000,0,0
TIKI,ngon,196318914,"Đùi tỏi gà-500g",65000,65000,0,0
TIKI,ngon,126962640,"[ Chỉ giao HN] -Khoai lang Nhật 1kg",45000,45000,0,0
TIKI,ngon,157856353,"[ Chỉ giao HN] - Bánh Chưng Nương Bắc Lứt thịt 800gr",190000,190000,0,0
TIKI,ngon,185657618,"Tôm sú nguyên con size 40 - 500g",150000,150000,0,0
TIKI,ngon,187583356,"Đặc Sản Nha Trang -️ Mực Tẩm Gia Vị Nha Trang Từ Mực Lá Cay Nhẹ, Thơm Ngon, Size Trung Seavy Gói 500g",515000,525000,10000,2
TIKI,ngon,108888452,"[CHỈ GIAO HN] - MỰC KHÔ CÁT BÀ VITOT FOOD (500g/ 5- 6 con)",750000,750000,0,0
TIKI,ngon,186521308,"Cá viên chiên Đôi Đũa Vàng 420g, viên thả lẩu hải sản thơm ngon ",117000,117000,0,0
TIKI,ngon,187999176,"Đặc Sản Nha Trang - Khô Cá Bống Biển Hộp Seavy 400G",120000,130000,10000,8
TIKI,ngon,117219760,"[Chỉ giao HN] - Nho xanh không hạt Mỹ - 1KG",299000,299000,0,0
TIKI,ngon,179711414,"[Chỉ giao HN] - Sữa đậu gà đậu đỏ không đường - size M (550ml)",49000,49000,0,0
TIKI,ngon,128635926,"GIỎ QUÀ TẶNG CHÚC MỪNG",550000,550000,0,0
TIKI,ngon,184790613,"Ba chỉ heo rút xương có da Nga - 1kg",115000,115000,0,0
TIKI,ngon,117974084,"[Chỉ giao HN] - Cá Diếc Kho Niêu Với Ba Chỉ Và Trám - 1 Niêu",178000,178000,0,0
TIKI,ngon,171217509,"[ Chỉ giao HN] - Gạo Tám Sóc Trăng VinaFood Túi 3.5kg",120000,120000,0,0
TIKI,ngon,179711618,"[Chỉ giao HN] - Sữa hạt sen cốt dừa không đường - size M (550ml)",78000,78000,0,0
TIKI,ngon,167468284,"Fresh Natto (Gold) - Đậu nành lên men",15000,15000,0,0
TIKI,ngon,179377292,"Pizza phô mai thơm ngậy Đôi Đũa Vàng 350gr - Giao tại Hà Nội và Hồ Chí Minh",189000,189000,0,0
TIKI,phu-kien-thoi-trang,175192213,"Set 5 Đôi Vớ Nữ Cổ Ngắn GOMTAT Phong Cách Vintage, Tất Cổ Ngắn Nữ Nhiều Màu 5 Đôi Sử Dụng Cả Tuần – CB001-5DOI",29000,49000,20000,41
TIKI,phu-kien-thoi-trang,124276845,"Mắt Kính Đi Đường Chống Bụi Và Tia UV",21499,21499,0,0
TIKI,phu-kien-thoi-trang,15491037,"Combo 4 dụng cụ tạo phồng mái, phồng tóc",39900,39900,0,0
TIKI,phu-kien-thoi-trang,136369438,"Dụng cụ kẹp xược búi bới tóc giúp độn phồng mái độn tóc trông dày hơn rất tự nhiên",20000,20000,0,0
TIKI,phu-kien-thoi-trang,91515814,"Bộ Chân đế gắn đầu manocanh, giá đỡ đầu Manocanh, đế 3 chân cao để đầu manocanh cho bạn thực hành cắt và tạo kiểu tóc tóc  ( Sắt )",350000,350000,0,0
TIKI,phu-kien-thoi-trang,195287211,"Bộ dụng cụ tạo kiểu tóc đa năng",24000,24000,0,0
TIKI,phu-kien-thoi-trang,41068611,"Tròng kính viễn VELOCITY 1.56 HMC UV EMI (1 miếng)",72000,90000,18000,20
TIKI,phu-kien-thoi-trang,160898199,"Set 7 Kẹp Tóc Màu Sắc Xinh Xắn Dành Cho Nữ vintag ( giao mầu ngẫu nhiên)",34000,34000,0,0
TIKI,phu-kien-thoi-trang,130735136,"Kính lão thị kính đọc sách nam nữ chống mỏi chống nhức khi đeo lâu mắt sáng rõ",85500,90000,4500,5
TIKI,phu-kien-thoi-trang,125720574,"Bờm cài tóc nhựa nam nữ unisex BN141 và các mẫu khác",14000,14000,0,0
TIKI,phu-kien-thoi-trang,81985683,"khăn quàng cổ, khăn len, khăn quàng cổ nữ, khăn len choàng cổ, khăn len nữ, khăn choàng cổ, khăn choàng cổ nữ, khăn nữ",119000,119000,0,0
TIKI,phu-kien-thoi-trang,57484446,"Mũ bucket cụp vành nhỏ thời trang phong cách cho nữ",45000,45000,0,0
TIKI,phu-kien-thoi-trang,137456492,"Mũ len trùm đầu nữ SIÊU_TO Mũ len dệt kim phiên bản Hàn Quốc cho nữ giữ ấm đầu tai có 4 màu, không phai màu",79000,90000,11000,12
TIKI,phu-kien-thoi-trang,270831375,"90x90cmKhăn bandana lụa quấn áo BlackPink - Khăn quàng cổ lụa vuông họa tiết tranh cổ điển Picaso",59000,59000,0,0
TIKI,phu-kien-thoi-trang,116021256,"Tất nữ búp bê, Vớ Nữ mang giày lười, giày cao gót, giày búp bê giấu vớ, có đệm cao su chống trượt",17900,22000,4100,19
TIKI,phu-kien-thoi-trang,208174760,"( 40cm ) Tóc giả nữ cột xù mì ngắn, tóc giả buộc xoăn sóng",160000,160000,0,0
TIKI,phu-kien-thoi-trang,120431754,"(Hàng Xịn) Thắt lưng vải_siêu bền, Khóa cài tự động thép không gỉ chắc chắn, tiện lợi_ Dây lưng vải dù cao cấp, Dây nịt lính mạnh mẽ TẶNG MÓC CHÌA KHÓA",129000,129000,0,0
TIKI,phu-kien-thoi-trang,248590817,"Thắt lưng nam học sinh DHM-437 | Mặt khoá lăn atimon bóng bản nhỏ 2.3cm | Bảo hành 12 tháng",42000,42000,0,0
TIKI,phu-kien-thoi-trang,166070243,"Gọng kính chính hãng SARIFA 2252",75000,520000,445000,86
TIKI,phu-kien-thoi-trang,93213005,"Combo 3 Miếng độn mái phồng, Kẹp tóc chuyên dụng tạo độ phồng tóc KT23",21000,21000,0,0
TIKI,phu-kien-thoi-trang,163572920,"Thắt lưng da nam cao cấp- dây nịt da bò 2 lớp EMRENEW -Full hộp đựng cao cấp",261000,522000,261000,50
TIKI,phu-kien-thoi-trang,188585455,"Khăn Choàng Lụa Hot Trend Size 90x180CM",280000,280000,0,0
TIKI,phu-kien-thoi-trang,140953128,"Cài tóc gấp gọn, băng đô cài tóc gấp gọn bỏ túi siêu tiện lợi, phong cách Hàn Quốc xinh xắn - Culi accessories",25000,25000,0,0
TIKI,phu-kien-thoi-trang,114700099,"Nón bucket Thuglife - mũ tai bèo Ulzzang phong cách, cá tính Unisex nam nữ",44500,89000,44500,50
TIKI,phu-kien-thoi-trang,2343047,"Đai kẹp giữ áo sơ mi kẹp sắt bấm",68000,68000,0,0
TIKI,phu-kien-thoi-trang,132837171,"Thắt lưng nam, dây nịt nam da bò thật nguyên tấm Bụi Leather L111 - Khóa tự động, nhiều mặt khóa tùy chọn - Bảo hành 12 tháng",225000,398000,173000,43
TIKI,phu-kien-thoi-trang,96032800," Găng tay nam ,bao tay nam cụt ngón lái xe du lịch phượt Mechanix Mpact",55000,55000,0,0
TIKI,phu-kien-thoi-trang,183040760,"Kính Râm Nam Chống Tia UV, Kính Mát Nam Vuông Dáng Thể Thao, Kính Đổi Màu Đi Ngày Đêm AK048- Aoron",250000,390000,140000,36
TIKI,phu-kien-thoi-trang,165602381,"Tất Nữ, Combo 5 Đôi Tất Nữ Cổ Ngắn, Mẫu Tất Nữ Hình Gấu Dễ Thương Thời Trang Baw TN05",59000,99000,40000,40
TIKI,phu-kien-thoi-trang,96298394,"Xược tóc:xược cài tóc con,xược tóc gáy",25000,25000,0,0
TIKI,phu-kien-thoi-trang,111422462,"Khăn Lau Kính Chuyên Dụng Đa Năng Nhiều Màu(Ngẫu Nhiên)",1000,1000,0,0
TIKI,phu-kien-thoi-trang,72649409,"Mũ bucket thêu con vịt siêu dễ thương, đội được 2 mặt độc đáo Hạnh Dương",45000,45000,0,0
TIKI,phu-kien-thoi-trang,90870222,"KÍNH LÃO GẬP TIỆN LỢI GIÁ RẺ",99000,99000,0,0
TIKI,phu-kien-thoi-trang,159034209,"Set 2 kim băng ngọc trai, gim cài quần áo, thu nhỏ eo, khuy cài áo siêu hot, cá tính, dễ sử dụng",31400,31400,0,0
TIKI,phu-kien-thoi-trang,205892995,"Bờm cài tóc nam - nữ màu đen bằng sắt siêu bền",8500,8500,0,0
TIKI,phu-kien-thoi-trang,70796252,"Thắt Lưng Nữ Cute Kiểu Hàn Quốc TL008 MayHomes, Dây Lưng Nữ, Dây Nịt Nữ Chất Liệu Da PU Khóa Kim Loại Dễ Thương, Dùng Cho Đầm, Jeans, Quần Âu Và Short",42300,45000,2700,6
TIKI,phu-kien-thoi-trang,82297874,"  Nón lưỡi trai trơn unisex nhiều màu sắc thời trang, form chuẩn, nón kết dành cho nam và nữ, dáng Hàn Quốc hot",15000,15999,999,6
TIKI,phu-kien-thoi-trang,73360217,"Kính Giả Cận Chống Ánh Sáng Xanh, Chống Mỏi Mắt, Gọng Kính Cận Nam Nữ Không Độ Hàn Quốc - BLUE LIGHT SHOP",170000,170000,0,0
TIKI,phu-kien-thoi-trang,192666115,"KÌM BẤM CÚC, BẤM KHUY ÁO QUẦN TIỆN LỢI (HÀNG ĐẸP ĐÓNG VỈ) KÈM 50 KHUY",29000,32999,3999,12
TIKI,phu-kien-thoi-trang,192666117,"KÌM BẤM CÚC, BẤM KHUY ÁO QUẦN TIỆN LỢI (HÀNG ĐẸP ĐÓNG VỈ) KÈM 50 KHUY",25000,25000,0,0
TIKI,ngon,166063130,"Pate cho mèo Me-o Delite 70g - 1 Gói - Cá ngừ và phomai",19000,19000,0,0
TIKI,ngon,169068232,"Khay ăn và uống nước bán tự động cho Pet (Bát ăn cho Chó, mèo) - Xanh Dương",39999,39999,0,0
TIKI,ngon,166062450,"RỌ MÕM MỎ VỊT THỜI TRANG ( giao màu ngẫu nhiên) - L",55000,55000,0,0
TIKI,ngon,169069158,"Khay uống bán tự động mini cho Pet (Chó, mèo) - Hồng",42000,42000,0,0
TIKI,ngon,169070531,"Vòng cổ đệm cho chó (Chọn 4 màu) - Xanh Bộ đội - M",32000,32000,0,0
TIKI,ngon,169063707,"Bát Ăn Kèm Vòi Gắn Bình Nước Tiện Dụng Cho Thú Cưng (Giao Màu Ngẫu Nhiên)",36666,36666,0,0
TIKI,ngon,166062530,"Thức ăn hạt cho mèo Me-O - Kitten 400g",45000,45000,0,0
TIKI,ngon,169058835,"Bát ăn cho chó mèo xuống nước tự động (màu ngẫu nhiên, không kèm bình nước) - Size S",28799,28799,0,0
TIKI,ngon,169063165,"Bình Sữa Cho Chó Mèo Pet Bottles Kún Miu (60ml) - Màu Ngẫu Nhiên",21000,21000,0,0
TIKI,ngon,169065876,"Dây dắt vòng cổ cho chó mèo - Lớn: 5-10KG",45000,45000,0,0
TIKI,ngon,166063074,"Rọ mõm cho chó mẫu mỏ vịt  - Size L",39000,39000,0,0
TIKI,ngon,169067936,"Bình Nước Tự Động Cho Chó Mèo Kún Miu - Màu Ngẫu Nhiên",44444,44444,0,0
TIKI,ngon,169057035,"Tấm lót vệ sinh than hoạt tính cho chó mèo - Loại thường xanh,50 miếng(45x60)",140000,140000,0,0
TIKI,ngon,169006013,"Bình nước gắn chuồng cho chó mèo",29999,29999,0,0
TIKI,ngon,169070388,"Thức Ăn Cho Mèo lông dài Me-O Gold Persian  - 1,2kg",170000,170000,0,0
TIKI,ngon,169004174,"Bát Ăn Đôi Hình Khúc Xương Có Nút Gắn Bình Nước 0017 Kún Miu",28000,28000,0,0
TIKI,ngon,166062596,"Thức ăn cho chó Proplan mini adult Sensitive skin & coat  - 2.5Kg",620000,620000,0,0
TIKI,ngon,169065671,"Dây cổ công ty cho thú cưng dưới 5kg (giao màu ngẫu nhiên)",45000,45000,0,0
TIKI,ngon,166063128,"Đồ Ăn Cho Chó Con Classic Pets Hương Vị Sữa  - 10kg",520000,520000,0,0
TIKI,ngon,175950824,"Tôm thẻ tươi sz 50-70 con",270000,270000,0,0
TIKI,ngon,179711766,"[Chỉ giao HN] - Đậu tương vàng thuần chủng Cao Bằng - 500gr",40000,40000,0,0
TIKI,ngon,274407111,"[Chỉ giao Hà Nội]Chanh Sành, Chanh Đào Ủ Muối Mật Ong Thực Dưỡng Vị Thơm Dịu Ngọt giảm ho, bổ sung vitamin - Set quà tặng",190000,190000,0,0
TIKI,ngon,169070193,"Đồ Ăn Cho Chó Vị Thịt Gà Và Gan SmartHeart (Hộp 400g)",39999,39999,0,0
TIKI,ngon,179711716,"[Chỉ giao HN] - Hạt điều bình Phước rang muối CÓ vỏ lụa - 1kg",350000,350000,0,0
TIKI,ngon,179711565,"[Chỉ giao HN] - Tinh bột nghệ sạch, nguyên chất Quảng Nam - 500gr",380000,380000,0,0
TIKI,ngon,169004689,"Dây đeo cổ chó mèo dễ điều chỉnh độ dài dùng khi đi dạo & cắm trại - họa tiết dây ngẫu nhiên - Đen",29000,29000,0,0
TIKI,ngon,185761984,"[Chỉ giao HN] Mì cải bó xôi Organic Anpaso 120g",35000,35000,0,0
TIKI,ngon,170179557,"Combo 10 gói thức ăn cho mèo trưởng thành Me-o Adult - Vị cá ngừ - 350g",275000,275000,0,0
TIKI,ngon,185290160,"Bộ kéo cắt tỉa lông cho chó mèo (tặng kèm bao da đựng kéo)",339000,339000,0,0
TIKI,ngon,186166071,"Oliu Đen Nguyên Trái La Pedriza 3kg - EUFOOD Việt Nam- Quả Oliu Tây Ban Nha Nhập Khẩu Chính Hãng",319000,319000,0,0
TIKI,ngon,177714114,"KẸO HÀN QUỐC VỊ MÂM XÔI RASPBERRY 100G",31000,31000,0,0
TIKI,ngon,177663569,"[ Chỉ giao HN] - Pate Instinctive (Gravy) 85g (12x85g)",33000,33000,0,0
TIKI,ngon,170179305,"Xổ Giun Sán Cho Thú Cưng Sanpet Giá 1 Viên - 1 VIÊN",5888,5888,0,0
TIKI,ngon,201696923,"SỦI CẢO NHÂN THỊT",59000,59000,0,0
TIKI,ngon,185290178,"Nhỏ mắt thú cưng dcvet ",90000,90000,0,0
TIKI,ngon,186084406,"Xẻng Hót Phân Mèo Cứng Cáp Lọc Sạch Phân Mèo Trong Chậu Sỉ, Chậu Cát Vệ Sinh Dễ Dàng",15000,15000,0,0
TIKI,ngon,185290369,"Túi lưới vận chuyển thú cưng chó mèo",126000,126000,0,0
TIKI,ngon,177153923,"[ Chỉ giao HN]- Áo hoodie comic XL",115000,115000,0,0
TIKI,ngon,179711614,"[Chỉ giao HN] - Đậu đỏ thuần chủng Sóc Sơn - 500gr",40000,40000,0,0
TIKI,ngon,177153796,"[ Chỉ giao HN] - Dây dắt yên ngựa in hình 1cm",40000,40000,0,0
TIKI,phu-kien-thoi-trang,31259846,"Váy Chống Nắng Jean Cao Cấp Thêu Hoa Cánh Trắng",250000,250000,0,0
TIKI,phu-kien-thoi-trang,163572787,"Thắt lưng da nam cao cấp- dây nịt da bò 2 lớp EMRENEW -Full hộp đựng cao cấp",300000,600000,300000,50
TIKI,phu-kien-thoi-trang,72120344,"Kính Giả Cận, Gọng Kính Cận Nam Nữ Mắt Vuông Gọng Kim Loại Cứng Cáp - BLUE LIGHT SHOP",126000,142000,16000,11
TIKI,phu-kien-thoi-trang,138900300,"Set 10 khuy cài cúc áo, combo 10 khuy cài áo",22400,22400,0,0
TIKI,phu-kien-thoi-trang,168313503,"Tất Giày Tây Nam Cao Cấp Họa Tiết Sọc Chéo, Vớ Nam Cổ Cao Chất Liệu Cotton Hút Ẩm Thoáng Khí - GOM-TAYCHEO-1DOI",26000,50000,24000,48
TIKI,phu-kien-thoi-trang,76035462,"Combo 3 đôi Tất thể thao Redikick Cổ thấp R365 Sợi Cotton Cao Cấp Vớ Nam Nữ Unisex có đệm Cushion Chống hôi chân, Thoáng khí, Thấm mồ hôi phù hợp chơi Bóng Rổ Bóng đá Bóng Chuyền Tennis Chạy Bộ Đá banh - Hàng Chính Hãng",109000,150000,41000,27
TIKI,phu-kien-thoi-trang,138052017,"Hộp 4 đôi tất nam cổ ngắn sợi tre cao cấp, vớ cổ ngắn nam mềm mại thoáng mát - GOMTAT-SOITRE-NGAN",125000,200000,75000,38
TIKI,phu-kien-thoi-trang,94998994,"Khẩu trang ninja vải nỉ có kính chống bụi dán gáy che kín tai chống nắng chồng gió bụi chạy xe phượt nam nữ - khau trang ni",30000,30000,0,0
TIKI,phu-kien-thoi-trang,160395612,"sao huy hiệu gắn mũ cối",12000,12000,0,0
TIKI,phu-kien-thoi-trang,75523746,"Thắt Lưng Nữ Thời Trang Mặt Khóa Kim Loại Hình Oval Chất Liệu Da PU TL010 MayHomes Dây Lưng Nữ, Dây Nịt Nữ Đa Năng Bền Chắc Dùng Cho Đầm, Jeans, Quần Âu Và Shorts",68888,78000,9112,12
TIKI,phu-kien-thoi-trang,172126746,"Khẩu Trang Vải Linen 4D NEMO Collection, Chống Nắng, Lọc Khuẩn, Thoáng Khí Không Gây Mụn - KTDM",25000,50000,25000,50
TIKI,phu-kien-thoi-trang,57523197,"Set 10 Đôi Tất Họa Tiết Hoa Cúc Kèm Túi Đựng Xinh Xắn Cho Nữ",37900,37900,0,0
TIKI,phu-kien-thoi-trang,198584207,"Mũ/ nón lưỡi trai hàn quốc thêu chữ 1987 màu trắng sữa, Nón kết trơn unisex nam nữ hàng chuẩn đẹp",10000,10000,0,0
TIKI,dong-ho-va-trang-suc,22369367,"Vòng Điều Hoà Huyết Áp Taka sku01(vòng nữ)",695000,695000,0,0
TIKI,phu-kien-thoi-trang,58631403,"Khăn lau kính chống mờ hơi nước hộp 30 miếng Ichinen Nhật Bản",189000,189000,0,0
TIKI,phu-kien-thoi-trang,176261734,"Kính lão nhựa gọng dẻo tròng kính chống vỡ from kính đẹp dành cho nam và nữ đủ số từ 0.5-4.0 độ mẫu L02",19000,19000,0,0
TIKI,dong-ho-va-trang-suc,10597090,"Bông tai nam Titan cao cấp chonmua365",45000,45000,0,0
TIKI,phu-kien-thoi-trang,160894097,"Hộp 4 đôi tất sợi tre cổ ngắn, tất vớ nam nữ cổ ngắn sợi tre cao cấp, khử mùi, kháng khuẩn - GOMTAT-SOITRE-NGAN",133000,200000,67000,34
TIKI,phu-kien-thoi-trang,198460229,"Tất Đùi Len Vân Sọc Loại Dày Mẫu Mới Thu Đông Phong Cách Nhật Bản PK214",75000,75000,0,0
TIKI,phu-kien-thoi-trang,212426558,"Tất Đùi Trong Suốt Kèm Dây Đai Quyến Rũ Chống Tuột PK522",92000,92000,0,0
TIKI,phu-kien-thoi-trang,96587894,"Kính mát phân cực nam VEITHDIA",244800,288000,43200,15
TIKI,phu-kien-thoi-trang,108585245,"Set 5 ghim cài áo quần váy cao cấp",25998,25998,0,0
TIKI,dong-ho-va-trang-suc,176073859,"Dây silicon ngàm cong dành cho đồng hồ Samsung Galaxy Watch 4 40mm & Watch 4 44 mm",59000,59000,0,0
TIKI,phu-kien-thoi-trang,184062627,"Gọng kính hợp kim cước thời trang nam nữ siêu nhẹ siêu bền Ouress 58026",202000,280000,78000,28
TIKI,dong-ho-va-trang-suc,47101179,"Dụng Cụ Thay Dây Đồng Hồ 2 Đầu",110000,110000,0,0
TIKI,dong-ho-va-trang-suc,2888357,"Đồng Hồ Trẻ Em Cho Bé Trai SKMEI 1163 - DHA436",199000,199000,0,0
TIKI,dong-ho-va-trang-suc,97902336,"Hộp Đựng Đồng Hồ Cơ - Hộp lên dây cót cho 1 chiếc đồng hồ tự động automatic",489000,489000,0,0
TIKI,dong-ho-va-trang-suc,145763565,"5 Viên Pin CMOS CR2032 Maxell Nhật Bản Lithium 3V",16000,19500,3500,18
TIKI,phu-kien-thoi-trang,84774789,"Kính lão thị viễn thị trung niên mắt thủy tinh chống xước sẵn độ",80000,80000,0,0
TIKI,phu-kien-thoi-trang,155061502,"Mũ lưỡi trai, nón kết big size cỡ lớn cho nam đầu to (chu vi 59-65cm)",40000,40000,0,0
TIKI,dong-ho-va-trang-suc,106391798,"Dây đồng hồ nam nữ size 12mm 14mm 16mm 18mm 20mm 22mm CỰC MỀM",50000,50000,0,0
TIKI,dong-ho-va-trang-suc,100319459,"nhẫn titan trơn giá rẻ",19000,19000,0,0
TIKI,phu-kien-thoi-trang,70795767,"Thắt Lưng Nữ Họa Tiết Hoa Cúc TL007 MayHomes, Dây Lưng Nữ, Dây Nịt Nữ Chất Liệu Da PU Khóa Kim Loại Dễ Thương, Dùng Cho Đầm, Jeans, Quần Âu Và Short",42300,45000,2700,6
TIKI,dong-ho-va-trang-suc,68502142,"Lắc Chân Nữ Bạc Hiểu Minh LC202X cỏ 4 lá dây kép bạc ý",369000,450000,81000,18
TIKI,phu-kien-thoi-trang,75528777,"Thắt Lưng Nữ Bản To Kèm Dây Xích Cá Tính TL012 MayHomes Dây Lưng Nữ Thời Trang, Dây Nịt Nữ Da PU Khóa Kim Loại Bền Chắc Đa Năng Dùng Cho Đầm, Jeans, Quần Âu Và Shorts",85000,85000,0,0
TIKI,phu-kien-thoi-trang,32725930,"Set 100 Dây Thun Cột Tóc, Chun Buộc Tóc Hàn Quốc Nhiều Màu Tiện Dụng",19000,19000,0,0
TIKI,dong-ho-va-trang-suc,74527302,"Dây chuyền nam cao su đen trangsucpt kích cỡ 3mm thiết kế khóa 2 đầu bằng inox thép không gỉ PTDCNA38",38000,38000,0,0
TIKI,dong-ho-va-trang-suc,14971746,"Bông Tai Ngọc Trai Cao Cấp B1932 Cỡ Hạt 11x13 Ly Bảo Ngọc Jewelry",311000,311000,0,0
TIKI,dong-ho-va-trang-suc,176071877,"Dây silicon thể thao mềm mại dành cho các loại Đồng hồ Xiaomi Miwatch",135000,135000,0,0
TIKI,dong-ho-va-trang-suc,204038971,"Vòng tay tỳ hưu đồng phong thủy trầm hương HÀ XÁ đeo tay cặp đôi nam nữ may mắn tài lộc",199000,398000,199000,50
TIKI,dong-ho-va-trang-suc,208645115,"Dây silicon khóa nam châm ngàm cong 20mm dành cho đồng hồ thông minh",105000,105000,0,0
TIKI,dong-ho-va-trang-suc,107348050,"Đồng Hồ Cơ Nam Cao Cấp, Tự Động Lên Dây Cót Khi Đeo, Lộ Cơ Mặt Và Đáy, Dây Da Mềm Bền Đẹp, Mặt Chống Trầy Xước, Đồng Hồ Lộ Máy Có Khả Năng Chống Nước Cực Tốt, Phong Cách Thời Trang Hiện Đại",565000,565000,0,0
TIKI,dong-ho-va-trang-suc,36014644,"Bông tai nam màu trắng",29900,29900,0,0
TIKI,dong-ho-va-trang-suc,81318056,"Đồng Hồ Nam Dây Thép Lưới Đen ECONOMICXI Chính Hãng Đường Kính Mặt 40mm Có lịch Ngày - Phong Cách Doanh Nhân ECNT36",278000,278000,0,0
TIKI,phu-kien-thoi-trang,49048540,"Khẩu trang vải trơn",1900,2000,100,5
TIKI,phu-kien-thoi-trang,70931921,"Nón beret nam, mũ mỏ vịt dành cho người trung niên, không thêu họa tiết, chất liệu vải oát mềm mại, tăng giảm size dễ dàng",65000,65000,0,0
TIKI,phu-kien-thoi-trang,71197467,"Combo lens cận không màu, nước ngâm lens 150ml, gắp lens, khay ngâm lens",200000,200000,0,0
TIKI,dong-ho-va-trang-suc,14971891,"Bông Tai Ngọc Trai Cao Cấp B1933 Cỡ Hạt 11x13 Ly",400000,400000,0,0
TIKI,dong-ho-va-trang-suc,156262628,"Nước rửa trang sức bạc PDJ - Trang sức PDJ  - dung tích 120ml",70000,70000,0,0
TIKI,dong-ho-va-trang-suc,54656485,"Vòng đeo tay chuỗi hạt 108 hạt gỗ hồng phong thủy",54000,54000,0,0
TIKI,dong-ho-va-trang-suc,97927216,"Vòng tay dây chỉ ngũ sắc Tây Tạng may mắn kết hợp đá tự nhiên 100% không qua xử lý. Thích hợp cho cả người lớn lẫn em bé. Mang đến may mắn, tài lộc, thân tâm an lạc",79000,79000,0,0
TIKI,phu-kien-thoi-trang,107344200,"Tất nam nữ - Vớ nam nữ cổ ngắn mã TT70 đẹp cao cấp  kiểu tất chân",3699,3699,0,0
TIKI,dong-ho-va-trang-suc,194784091,"Giá Đỡ Đồng Hồ Đeo Tay Hộp Đựng Đồng Hồ Trong Suốt Chống Bụi Trang Trí Decor GDDH Office Chill",235000,235000,0,0
TIKI,dong-ho-va-trang-suc,90312041,"Cuộn cước thun ( cước chun), dây thun co giãn xỏ vòng cuộn mimi 10m",23000,26000,3000,12
TIKI,dong-ho-va-trang-suc,15662471,"Đồng hồ Casio nam AE-1200WHD-1AVDF",1129500,1506000,376500,25
TIKI,phu-kien-thoi-trang,177997131,"Tất Nam Nữ Cổ Ngắn Thời Trang Hàn Quốc, Vớ Cổ Thấp Unisex 2 Sọc Êm Mềm Thoáng Mát - NGAN-2SOC-1DOI-201",9000,11000,2000,18
TIKI,phu-kien-thoi-trang,110205031,"Băng Đô Bờm Tóc Cài Tóc Quấn Tóc Màu Sắc Tinh Tế Đơn Giản Quà Tặng Xinh Xắn",98000,98000,0,0
TIKI,dong-ho-va-trang-suc,145092650,"Dây đồng hồ nato vải dù D121 cỡ 18mm; 20mm, 22mm thoải mái đi trời mưa, lắp cho dây đeo đồng hồ dw rolex hublot orient seiko casio",38000,55000,17000,31
TIKI,phu-kien-thoi-trang,113912892,"Mũ tai bèo - nón tai bèo - mũ Thanh niên tình nguyện",28000,28000,0,0
TIKI,dong-ho-va-trang-suc,25758447,"Đồng Hồ Trẻ Em Chống Nước SKMEI 0961",179000,179000,0,0
TIKI,dong-ho-va-trang-suc,92817245,"Dây Chuyền Nam Trơn Phối Mặt Nhẫn - Vòng cổ nam cá tính",75000,75000,0,0
TIKI,phu-kien-thoi-trang,191500974,"Tất Đùi Dày Dặn Qua Đầu Gối Dễ Thương Coplay Hàn Quốc Sọc Trắng Đen",39000,79000,40000,51
TIKI,dong-ho-va-trang-suc,150150734,"Dây đeo Garmin Forerunner 165/ 55/ 245/ 255/ 645/ Venu 2/ SQ 2/ SQ/ Vivoactive 5/ 4/ 3 (DG)",180000,180000,0,0
TIKI,dong-ho-va-trang-suc,97889775,"Đồng Hồ Nữ Julius Hàn Quốc JA732C Dây Thép Mesh Thời Thượng",770000,770000,0,0
TIKI,dong-ho-va-trang-suc,62216290,"Đồng Hồ Nữ Julius Hàn Quốc JA-979 Dây Da",689000,689000,0,0
TIKI,dong-ho-va-trang-suc,127461281,"Dây sáp bóng thắt vòng tay đường kính 1,5mm cuộn 10m - Ngọc Quý Gemstones",24000,48000,24000,50
TIKI,phu-kien-thoi-trang,88085836,"Tất nữ cổ ngắn, vớ nữ kẻ đẹp",12500,12500,0,0
TIKI,phu-kien-thoi-trang,146399186,"Kính Giả Cận, Gọng Kính Cận Nam Nữ GM V Mắt Vuông Viền Dày Nhỏ Hàn Quốc Không Độ - BLUE LIGHT SHOP",185000,185000,0,0
TIKI,dong-ho-va-trang-suc,118516302,"Hộp Đựng Đồng Hồ Chất Lượng Cao, Thích Hợp Đựng Đồng Hồ Làm Qùa Tặng",22000,22000,0,0
TIKI,dong-ho-va-trang-suc,44045501,"Vòng cổ choker đính ngọc trai sang trọng cho nữ",26000,41000,15000,37
TIKI,phu-kien-thoi-trang,163572707,"Thắt lưng da nam cao cấp- dây nịt da bò 2 lớp EMRENEW -Full hộp đựng cao cấp",290000,580000,290000,50
TIKI,dong-ho-va-trang-suc,74494910,"Bó 10-20m dây vải dù 0.8mm đan vong đủ màu - Bó dây vải dù 0.8mm handmade Ngọc Quý Gemstones",11500,23000,11500,50
TIKI,dong-ho-va-trang-suc,90719195," Lắc tay nam inox kiểu lặc cá tính thép không gỉ 7mm",26000,26000,0,0
TIKI,phu-kien-thoi-trang,21036436,"Gói dây thun 100 gam nhiều màu cột tóc",21000,35000,14000,40
TIKI,dong-ho-va-trang-suc,90720613,"Nhẫn nam khui bia thép không gỉ đẳng cấp",15000,15000,0,0
TIKI,dong-ho-va-trang-suc,248536961,"Bông Tai Ngọc Trai Nụ, Khuyên Tai Nụ Ngọc Trai Cao Cấp Nhiều Màu - B2510 - Bảo Ngọc Jewelry",200000,200000,0,0
TIKI,dong-ho-va-trang-suc,161523242,"Dây Đeo SILICON dành Cho Huawei Honor Band 6 Chất Lượng cao",25000,25000,0,0
TIKI,phu-kien-thoi-trang,192950066,"Quà tặng 1 cái khẩu trang y tế KF94 4 lớp tiệt trùng túi riêng từng cái Khánh An KA99 vệ sinh và tiện lợi khi mang theo ngăn vi khuẩn 99% thiết kế 4D HÀN QUỐC hợp thời trang và dễ thở",4000,5000,1000,20
TIKI,phu-kien-thoi-trang,166591681,"Dây cột tóc- buộc tóc vải nhiều màu hot nhất hiện nay- màu ngẫu nhiên",28500,30000,1500,5
TIKI,dong-ho-va-trang-suc,185594470,"Dây Chuyền Vòng Cổ Bạc 925 Cỏ 4 Lá May Mắn Đeo 2 Kiểu DMD461",260000,520000,260000,50
TIKI,dong-ho-va-trang-suc,111306433,"Dây Da Đồng Hồ Cổ Điển, 100% Da Bò Thật, Kiểu Dáng Phẳng Mỏng, Mặt Lót Chống Thấm Mồ Hôi, Tích Hợp Lớp Gia Cố Chống Giãn Đặc Biệt, Phụ Kiện Khóa và Chốt Bằng Thép Không Gỉ 316L - Hàng Chính Hãng SAIGIO",899000,899000,0,0
TIKI,dong-ho-va-trang-suc,112084937,"Dây Da Đồng Hồ Nam, 100% Da Bò Thật, Kiểu Dáng Vintage Phẳng Mỏng, Mặt Lót Chống Thấm Mồ Hôi, Tích Hợp Lớp Gia Cố Chống Giãn Đặc Biệt, Phụ Kiện Khóa và Chốt Bằng Thép Không Gỉ 316L - Thương Hiệu SAIGIO",880000,899000,19000,2
TIKI,dong-ho-va-trang-suc,107959904,"Dây Da Đồng Hồ Cao Cấp - Sang Trọng, Chất Liệu Da Bê EPSOM Nhập Khẩu Từ Pháp, Tiêu chuẩn Châu Âu, Mặt Lót Chống Thấm Mồ Hôi, Tích Hợp Lớp Gia Cố Chống Giãn Đặc Biệt và Chốt Thông Minh Mới Nhất - Hàng Chính Hãng SAIGIO",1980000,1999000,19000,1
TIKI,dong-ho-va-trang-suc,111696638,"Dây Da Đồng Hồ Cao Cấp - Sang Trọng, Chất Liệu Da Bê EPSOM Thuộc Thảo Mộc - Nhập Khẩu Từ Châu Âu, Mặt Lót Chống Thấm Mồ Hôi, Tích Hợp Lớp Gia Cố Chống Giãn Đặc Biệt và Chốt Thông Minh, Kiểu Dáng Cổ Điển Phẳng Mỏng",1879000,1899000,20000,1
TIKI,dong-ho-va-trang-suc,157417398,"Dây Đồng Hồ Da Bò Cao Cấp, Kiểu Dáng Cổ Điển - Phẳng Mỏng - Chỉ Trắng, Mặt Lót Chống Thấm Mồ Hôi, Tích Hợp Lớp Gia Cố Chống Giãn Đặc Biệt, Phụ Kiện Khóa và Chốt Bằng Thép Không Gỉ 316L - Hàng Chính Hãng SAIGIO",881000,889000,8000,1
TIKI,dong-ho-va-trang-suc,134364062,"Đồng Hồ Nữ Dây Nhựa Casio Standard LW-204-4ADF Chính Hãng - LW-204-4A",810750,1081000,270250,25
TIKI,dong-ho-va-trang-suc,13246837,"Bông tai nam titan kẹp vành không cần bấm lỗ xỏ lỗ 2 chiếc",26000,26000,0,0
TIKI,dong-ho-va-trang-suc,178027547,"DÂY ĐÔNG HỒ THÉP LƯỚI KHÔNG GỈ CAO CẤP + TẶNG CHỐT",53000,53000,0,0
TIKI,dong-ho-va-trang-suc,145393816,"Dây cước chun cột tháp cây đứng - làm vòng lắc đeo tay - CUOCCHUN",10000,10000,0,0
TIKI,dong-ho-va-trang-suc,105985711,"Nhẫn nam titan đá màu cực đẹp Trang sức Bé Heo BHN115",39000,61000,22000,36
TIKI,dong-ho-va-trang-suc,106966720,"Dây Da Đồng Hồ Cổ Điển, Chất Liệu Da Bò Thật 100%, Mặt Lót Chống Thấm Mồ Hôi, Khóa Bằng Thép Không Gỉ 316L, Nhiều Màu, Nhiều Size - Hàng Chính Hãng SAIGIO",981000,999000,18000,2
TIKI,dong-ho-va-trang-suc,165588816,"Đồng hồ nam cao cấp DEYROS dây thép mành đen chạy lịch ngày - Thiết kế thể thao và nam tính MS559",278000,278000,0,0
TIKI,dong-ho-va-trang-suc,159298167,"Dây Đồng Hồ Da Bò Cao Cấp, Kiểu Dáng Cổ Điển - Chỉ Trắng, Mặt Lót Chống Thấm Mồ Hôi, Tích Hợp Lớp Gia Cố Chống Giãn Đặc Biệt, Phụ Kiện Khóa và Chốt Bằng Thép Không Gỉ 316L - Hàng Chính Hãng SAIGIO",983000,989000,6000,1
TIKI,dong-ho-va-trang-suc,74853731,"Dây Da Thay Thế Dành Cho Đồng Hồ Fossil Casio Samsung Huawei Da Bò Thật Dây Handmade - Tặng Kèm Chốt Và Dụng cụ thay",200000,200000,0,0
TIKI,dong-ho-va-trang-suc,160424898,"Dây Đồng Hồ Da Bò Cao Cấp, Kiểu VINTAGE THREAD Phẳng Mỏng, Mặt Lót Chống Thấm Mồ Hôi, Tích Hợp Lớp Gia Cố Chống Giãn Đặc Biệt, Phụ Kiện Khóa và Chốt Bằng Thép Không Gỉ 316L - Hàng Chính Hãng SAIGIO",881000,899000,18000,2
TIKI,dong-ho-va-trang-suc,93819008,"Dây Thun Co Giản, Dây Cước Đàn Hồi Xỏ Chuỗi Hạt size 1mm dài 100m",68000,68000,0,0
TIKI,dong-ho-va-trang-suc,251446936,"Dây Đồng Hồ Da Bò Italy Cao Cấp Màu Đỏ Size 14/16/18/20/22mm - Dây Da Đồng Hồ Da Bò Thật 100%, Bảo Hành 12T",640000,640000,0,0
TIKI,dong-ho-va-trang-suc,244174048,"Dây Đồng Hồ Da Cá Sấu Nâu Size 14/16/18/20/22/24/26mm - Dây Đeo Da Cá Sấu Thật 100% - Bảo Hành 12 Tháng",840000,840000,0,0
TIKI,dong-ho-va-trang-suc,42194457,"Bông Tai Nam Nữ Đeo 2 Kiểu Chất Liệu Thép Titan Ko Đen Cao Cấp TT 2076 - 1 Cặp",68000,68000,0,0
TIKI,dong-ho-va-trang-suc,253236338,"Dây đeo đồng hồ da bò màu đỏ Size 14/15/16/17/18/19/20/21/22mm - Dây đồng hồ da bò Thật 100% - Bảo Hành 12 Tháng",449000,449000,0,0
TIKI,dong-ho-va-trang-suc,184417199,"Đồng Hồ Nam OLEVS-2858 Mặt Tròn Mạ Vàng 18k Chống Nước Chạy Đủ 6 Kim Có Ô Lịch Ngày Khóa Bướm Có Hộp In Logo Chính Hãng",1500000,1500000,0,0
TIKI,dong-ho-va-trang-suc,56074898,"Vòng tay nam nữ 108 hạt 8 ly gỗ đàn hương",75997,75997,0,0
TIKI,dong-ho-va-trang-suc,115971260,"Đồng Hồ Nam FullBox, Dây Thép Không Gỉ, Mặt Kính Chống Trầy Xước, Chống Nước Tốt, Phong Cách Doanh Nhân Thành Đạt, Nam Tính, Mạnh Mẽ",569000,569000,0,0
TIKI,dong-ho-va-trang-suc,79579718,"ĐỒNG HỒ NAM DBC-32-1ADF DÂY NHỰA",1192500,1590000,397500,25
TIKI,dong-ho-va-trang-suc,253193935,"Dây đeo đồng hồ Da Cá Sấu Xám Size 19/20/21/22 - Dây Đeo Da Cá Sấu Thật 100% - Bảo Hành 12 Tháng",690000,690000,0,0
TIKI,dong-ho-va-trang-suc,253190408,"Dây đeo đồng hồ Da Cá Sấu Nâu Đỏ Size 19/20/21/22 - Dây Đeo Da Cá Sấu Thật 100% - Bảo Hành 12 Tháng",690000,690000,0,0
TIKI,dong-ho-va-trang-suc,37156749,"Bông Tai Nam Loại Kẹp Không Cần Bấm Lỗ Tai Hình Thánh Giá Chất Liệu Thép Titan Không Đen Không Dị Ứng TT 1370 - 1 cặp",55000,55000,0,0
TIKI,dong-ho-va-trang-suc,113957500,"Đồng Hồ Nữ Dây Da Chính Hãng OLEVS, Mặt Kính Chống Trầy Xước, Chống Nước 3ATM Tốt, Đồng Hồ Nữ Đẹp, Sang Trọng, Cá Tính, Phong Cách Nữ Sinh Hàn Quốc",479000,479000,0,0
TIKI,dong-ho-va-trang-suc,242106273,"Dây Đồng Hồ Da Bò Italy Cao Cấp Màu Nâu Size 15/17/19/21/23/25mm - Dây Da Đồng Hồ Da Bò Thật 100%, Bảo Hành 12T",640000,640000,0,0
TIKI,dong-ho-va-trang-suc,7803174,"Bộ 2 bông tai nam inox khuyên tròn 12mm BT233",35000,35000,0,0
TIKI,dong-ho-va-trang-suc,137941919,"Dây đeo Xiaomi Miband 6, Mi band 5 - chính hãng Mijobs",35000,35000,0,0
TIKI,dong-ho-va-trang-suc,188378647,"Pin CR2032 Nhật Bản 3V Date 2032 Hàng Cao Cấp",30000,30000,0,0
TIKI,dong-ho-va-trang-suc,25058248,"Nhẫn nam titanium vòng xoay BHN77",12000,20000,8000,40
TIKI,dong-ho-va-trang-suc,204249337,"Vòng mân côi Công Giáo phong thủy 10 hạt trầm hương HÀ XÁ vòng đeo tay nam nữ may mắn tài lộc",199000,398000,199000,50
TIKI,dong-ho-va-trang-suc,40403870,"Đồng hồ đeo tay nữ unisex vanota thời trang DH24",115000,115000,0,0
TIKI,dong-ho-va-trang-suc,113957408,"Đồng Hồ Nữ Chính Hãng OLEVS, Đồng Hồ Dây Kim Loại Chống Gỉ, Mặt Kính Chống Trầy Xước, Chống Nước 3ATM Tốt, Đồng Hồ Nữ Đẹp, Sang Trọng, Cá Tính, Phong Cách Nữ Sinh Hàn Quốc",569000,569000,0,0
TIKI,dong-ho-va-trang-suc,134441706,"Dây đồng hồ Haylou Solar LS05/ RT LS05S/ Mi Watch (DGNT)",99000,99000,0,0
TIKI,dong-ho-va-trang-suc,190517164,"Dây đeo cho Huawei Band 7 - Dây Thép, khóa nam châm (DTB7)",170000,170000,0,0
TIKI,dong-ho-va-trang-suc,2854757,"Đồng hồ thể thao nam Skmei 1299 chống nước siêu bền",229000,229000,0,0
TIKI,dong-ho-va-trang-suc,27813965,"Đồng Hồ Nam Casio F91W-1DG Chính Hãng",442800,492000,49200,10
TIKI,dong-ho-va-trang-suc,204280498,"Vòng đeo cổ dây chuyền chuỗi hạt trụ trúc phong thủy trầm hương HÀ XÁ 8li vòng đeo tay cặp đôi nam nữ may mắn tài lộc",350000,700000,350000,50
TIKI,dong-ho-va-trang-suc,70203275,"Dây đồng hồ da bò trơn, mềm Italy nhiều size tặng chốt và dụng cụ tháo lắp",120000,120000,0,0
TIKI,dong-ho-va-trang-suc,73648998,"Đồng hồ điện tử Led Mtt5 trẻ em nhân vật hoạt hình ngộ nghĩnh nt7742",18000,18000,0,0
TIKI,dong-ho-va-trang-suc,68428513,"Dây Da Đồng hồ Size Nam Da Bò thật [Tặng Hộp Gỗ] - Hàng Việt Nam Xuất Khẩu",99000,99000,0,0
TIKI,dong-ho-va-trang-suc,72006539,"Pin CR2032 Maxell Lithium 3V vỉ 5 viên",19500,19500,0,0
TIKI,dong-ho-va-trang-suc,72292517,"Dây chuyền inox nam móc xích cao cấp không đen BHDC192",75000,75000,0,0
TIKI,may-anh,15927428,"Đèn LED Godox 170 Bóng - Hàng Chính Hãng",1150000,1150000,0,0
TIKI,dong-ho-va-trang-suc,9850680,"Đồng Hồ Casio Nam Dây Da Phối Vải AE-1200WHB-1BVDF",962000,1218000,256000,21
TIKI,dong-ho-va-trang-suc,214515827,"Dây Đồng Hồ Da Cá Sấu Xanh Navy Size 15/17/19/21/23/25mm - Dây Đeo Da Cá Sấu Thật 100% - Bảo Hành 12 Tháng",840000,840000,0,0
TIKI,dong-ho-va-trang-suc,122436952,"Vòng Tay Trầm Hương tự nhiên Ngọc Nhị Trầm - An nhiên,hạnh phúc - Trầm Tốc Việt Nam Thiên Mộc Hương",212000,350000,138000,39
TIKI,may-anh,271365847,"Quả cầu gương Disco bạc trang trí, chụp ảnh studio",380000,380000,0,0
TIKI,may-anh,272404877,"Camera Xoay 360° YOOSEE Đàm Thoại Hai Chiều, Báo Động Chống Trộm, Wifi Không Dây Trong Nhà",260000,260000,0,0
TIKI,may-anh,197718299,"Camera IP hồng ngoại không dây 2.0 Megapixel EZVIZ C8PF - Hàng chính hãng",1500000,1500000,0,0
TIKI,may-anh,16342891,"Camera KBVISION KX-2012C4 2.0 Megapixel - Hàng nhập khẩu",460000,460000,0,0
TIKI,may-anh,103555494,"Đèn Flash Godox TT600 dùng cho Canon, Nikon, Sony- Hàng chính hãng ",1499999,1499999,0,0
TIKI,dong-ho-va-trang-suc,144368604,"(1 CHIẾC) NHẪN ĐÔI INOX TÌNH NHÂN INOX FOREVER LOVE",21850,21850,0,0
TIKI,dong-ho-va-trang-suc,72095605,"Pin Đồng hồ đeo tay Maxell SR621SW 1.55V 364 vỉ 5 viên",60000,60000,0,0
TIKI,may-anh,55483212,"Thiết bị quay phim slider Zeapon Easylock2 Kit - Hàng Chính Hãng",2190000,2190000,0,0
TIKI,may-anh,2546991,"Dây Bấm Mềm Shoot RR-90 For Fujifilm X-T1 X-T10 X-E2 X-M1 X-A2 X-A1 X100T (Đen)",159000,159000,0,0
TIKI,may-anh,101497268,"Chân máy quay Benro KH25P, Hàng chính hãng",2999999,2999999,0,0
TIKI,phu-kien-thoi-trang,77715163,"MẶT KHÓA THẮT LƯNG NAM KHÓA TÌ TRƯỢT TỰ ĐỘNG CHO DÂY RỘNG 3,5 CM (KO KÈM DÂY)",115000,115000,0,0
TIKI,may-anh,28731968,"Pin Duracell Alkaline D Battery ( Bộ 2 Viên) - Hàng chính hãng",118000,118000,0,0
TIKI,may-anh,3109087,"Ống nhòm hàng hải Steiner Commander 7x50 C - Hàng chính hãng",47300000,47300000,0,0
TIKI,may-anh,194083921,"CAMERA WIFI NGOÀI TRỜI EZVIZ C3W 1080P CÓ ĐÈN CÒI BÁO ĐỘNG, ĐÀM THOẠI 2 CHIỀU - HÀNG CHÍNH HÃNG",950000,950000,0,0
TIKI,phu-kien-thoi-trang,217499890,"Khăn cột tóc turban lụa ,Ruy băng quấn túi xách quàng cổ phụ kiện dễ thương cho nữ đẹp phong cách Hàn Quốc",9000,9000,0,0
TIKI,dong-ho-va-trang-suc,51104756,"Dây chuyền nam tính thời trang vĩnh viễn không đen",74900,74900,0,0
TIKI,may-anh,4707719,"Bộ Tản Sáng 3 Màu Cho Đèn Flash Cóc - Hàng Nhập Khẩu",69000,69000,0,0
TIKI,phu-kien-thoi-trang,89480888,"Mắt kính V nam nữ Hàn Quốc đen sang trọng ",68000,80000,12000,15
TIKI,may-anh,5899107,"Sạc Máy Ảnh Nikon MH-27 (Cho Pin EN-EL20) - Hàng Nhập Khẩu",199999,199999,0,0
TIKI,dong-ho-va-trang-suc,144367849,"Dây AW da bò Saffiano Bụi Leather D117- Da thật khâu tay thủ công cao cấp - chính hãng",199000,341000,142000,42
TIKI,phu-kien-thoi-trang,25917232,"Kính Mát Nữ Gọng Đen Sành Điệu",149000,149000,0,0
TIKI,phu-kien-thoi-trang,64629151,"Dây buộc tóc - Scrunchies hoa thêu mẫu mới hàng đẹp HD63",19000,19000,0,0
TIKI,phu-kien-thoi-trang,97433431,"Tất Vớ Nữ Trơn Cổ Ngắn 100% Cotton Aaa Jeans",29000,29000,0,0
TIKI,phu-kien-thoi-trang,145243704,"Băng đô cài tóc, Cài lượn sóng bản nhỏ nhiều màu xinh xắn - Culi accessories",20900,20900,0,0
TIKI,phu-kien-thoi-trang,5476547,"Set Tất 7 Ngày Cho Nữ (Kèm Túi)",74000,74000,0,0
TIKI,phu-kien-thoi-trang,196910669,"[T2] Tất vớ cổ cao nữ trơn lót lông cực ấm",29000,29000,0,0
TIKI,phu-kien-thoi-trang,173864902,"Khẩu Trang Vải 4D Nemo Collection, Chống Nắng, Lọc Khuẩn, Thoáng Khí Không Gây Mụn, Nam Nữ đều sử dụng được - KTMHG",35750,55000,19250,35
TIKI,may-anh,145087594,"Đầu mạng xuyên thấu DINTEK ezi-PLUG RJ45 (1501-88060) - 100 Đầu/ Bịch.",773300,773300,0,0
TIKI,phu-kien-thoi-trang,133246090,"Nón đầu bếp Nam Nữ Cao Cấp",27500,27500,0,0
TIKI,may-anh,54349786,"Phông nền nhựa PVC chụp ảnh sản phẩm màu xanh dương",62000,62000,0,0
TIKI,phu-kien-thoi-trang,157056967,"Kẹp tóc hình nơ phối lông tua rua xinh xắn phong cách Hàn Quốc hợp thời trang cho nữ",50000,50000,0,0
TIKI,may-anh,98736714," Ghế chụp ảnh sản phẩm lấy sáng Studio 60x100cm",1131000,1131000,0,0
TIKI,may-anh,80952481,"Tủ chống ẩm 250 lít Andbon AD-250S, Hàng chính hãng",9249999,9249999,0,0
TIKI,phu-kien-thoi-trang,102889000,"Tóc giả búi tròn mini dạng kẹp, búi kẹp tròn tóc giả B05 Sỉ 30k",45000,45000,0,0
TIKI,phu-kien-thoi-trang,72566161,"Nón bucket mặt cười Unisex siêu dễ thương, mang phong cách vui vẻ mới - Hạnh Dương",45000,45000,0,0
TIKI,phu-kien-thoi-trang,178031106,"Cà Vạt len trơn Nam Cao Cấp Sang Trọng Nam Tính- Caravat knit tie cá tính bản 6cm",125000,135000,10000,7
TIKI,phu-kien-thoi-trang,48933940,"Quần tất da chân Hàn Quốc",30300,30300,0,0
TIKI,phu-kien-thoi-trang,163170195,"Set 5 đôi tất nữ đi giày lười, tất vớ nữ đi giày búp bê họa tiết trái tim - LUOITRAITIM-CB5",70000,99000,29000,29
TIKI,may-anh,7617487,"Đế thao tác nhanh L Plate Canon EOS 6D",499000,499000,0,0
TIKI,may-anh,130772267,"Camera Giám Sát Imou Bullet 2E 4MP IPC F42FP - Hàng Chính Hãng",1050000,1050000,0,0
TIKI,phu-kien-thoi-trang,170724294,"Khăn Mùi Xoa, Khăn Tay Nam (L3)",55000,55000,0,0
TIKI,dong-ho-va-trang-suc,106390176,"Dây Đồng Hồ Cao Su Mềm Chống Nước Thay Thế Cho Đồng Hồ Đeo Tay",65000,65000,0,0
TIKI,phu-kien-thoi-trang,139449939,"Thắt lưng Nam Tushi vải dù_khóa tự động tiện lợi, siêu bền_Thắt lưng lính_vải bố_cao cấp",139000,139000,0,0
TIKI,phu-kien-thoi-trang,183290600,"[Combo 5 Đôi] Vớ lười Nam Mẫu Sọc Ngang Cotton Cao Cấp, Tất Nam Đi Giày Lười có đệm sao su chống tuột gót - TATLUOI-SOCNGANG",99000,180000,81000,45
TIKI,phu-kien-thoi-trang,243806022,"Cặp tóc mái mỏ vịt phong cách Hàn Quốc xinh xắn thời trang",8000,8000,0,0
TIKI,phu-kien-thoi-trang,90099141,"Thắt lưng CA",140000,280000,140000,50
TIKI,phu-kien-thoi-trang,87960116,"Nón lưỡi trai in logo UAG - Hàng Chính Hãng",150000,150000,0,0
TIKI,phu-kien-thoi-trang,15387324,"Sét 40 dây buộc tóc tròn cao cấp xuất Nhật HD12 hộp giấy sang trọng",85000,85000,0,0
TIKI,may-anh,73354486,"Ống nhòm đơn USCAMEL 7x50 UW075 ( Có thể dùng cho người lớn, trẻ nhỏ ) - HÀNG NHẬP KHẨU",1390000,1390000,0,0
TIKI,may-anh,10848645,"Kẹp nhạc cụ cho Gopro, Sjcam...",279000,279000,0,0
TIKI,may-anh,41215125,"Ống nhòm hai mắt cao cấp12X50 - Hàng nhập khẩu",1250000,1250000,0,0
TIKI,may-anh,191217233,"Boya BY-M1S (Không Dùng Pin) - Micro Cài Áo Cho Smartphone, PC, Laptop, Máy Ảnh, Máy Quay - Hàng Chính Hãng",310000,310000,0,0
TIKI,may-anh,138546125,"Mount gài cơ bản loại thấp cho máy quay hành động GoPro, Sjcam, Yi Action, Osmo Action",9000,9000,0,0
TIKI,may-anh,21479796,"Đèn Flash Bỏ Túi God Cow (GODOX) AD200 Cho Các Dòng Máy Canon, Nikon, Sony - Hàng nhập khẩu",5800000,5800000,0,0
TIKI,may-anh,71907557,"Pin Dành Cho Máy Ảnh Canon LP-E6 2750mAh",255550,269000,13450,5
TIKI,may-anh,50336007,"Bộ Đèn Chụp Sản Phẩm LED360 60w 5500K",1590000,1590000,0,0
TIKI,phu-kien-thoi-trang,26389419,"Hình Xăm Dán Cá Chép QSA046",45000,45000,0,0
TIKI,phu-kien-thoi-trang,186529124,"Kính lão gập gọng rút nhỏ gọn tiện lợi dễ dàng mang theo dành cho nam và nữ",49000,49000,0,0
TIKI,may-anh,4712321,"Tripod Benro Mefoto A0350Q0 - Hàng Nhập Khẩu",1974999,1974999,0,0
TIKI,phu-kien-thoi-trang,77038949,"Set 10 đôi tất da chân cho nữ tiện dụng",28990,28990,0,0
TIKI,phu-kien-thoi-trang,181694721,"Băng đô cài tóc độc lạ: Con cá, cà rốt,tai thỏ. Phụ kiện tóc ở nhà cho bạn",25000,25000,0,0
TIKI,phu-kien-thoi-trang,117692356,"Kính Giả Cận, Gọng Kính Cận Không Độ Dáng Vuông Lớn Nam Nữ ",155800,164000,8200,5
TIKI,may-anh,24950183,"Kính Lọc Filter Hoya Pro ND64 49mm - Hàng Chính Hãng",1099999,1099999,0,0
TIKI,may-anh,3307241,"Gá dù M type pro",199000,199000,0,0
TIKI,phu-kien-thoi-trang,197571874,"Kẹp Tóc Đính Đá Và Ngọc Trai Thời Trang Phong Cách Hàn Quốc",55000,55000,0,0
TIKI,phu-kien-thoi-trang,74636624,"Gọng kính, mắt kính SARIFA 3505 (53-19-145) chính hãng, nhiều màu lựa chọn",199000,520000,321000,62
TIKI,phu-kien-thoi-trang,73123648,"Trâm Cài Áo Pin Cổ Áo Tay Áo Cardigan Mini Nhẹ Nhàng Sang Trọng Unisex Món Quà Nhỏ Đầy Ý Nghĩa Phong Cách Hàn Quốc (Tặng Kèm Hộp Quà Tặng Màu Đen)",118000,118000,0,0
TIKI,phu-kien-thoi-trang,173650726,"Mặt khoá rời thắt lưng CA",99000,99000,0,0
TIKI,may-anh,120562130,"Ống Nhòm 2 Mắt Cao Cấp 15×60 Full Metal ",1852500,1950000,97500,5
TIKI,phu-kien-thoi-trang,43879862,"THẮT LƯNG NỮ CLIME, DÂY NỊT NỮ DN1912322",69000,69000,0,0
TIKI,phu-kien-thoi-trang,24935652,"Bộ 5 đôi tất lưới nữ cổ thuyền Basic",54000,54000,0,0
TIKI,phu-kien-thoi-trang,81555103,"Thắt lưng nam da , dây nịt nam TRƠN - MS-110",55000,110000,55000,50
TIKI,phu-kien-thoi-trang,146381894,"Set Kẹp Tóc Nữ Felling Màu Sắc Siêu Bền",12600,12600,0,0
TIKI,phu-kien-thoi-trang,178112267,"Cà Vạt Nam Cao Cấp Sang Trọng Nam Tính phụ kiện mặc vest, suit đi họp, dự tiệc bản 8cm",145000,145000,0,0
TIKI,may-anh,53294032,"Mic Boya M3 - Hàng Chính Hãng",698000,698000,0,0
TIKI,phu-kien-thoi-trang,164021838,"Kính Mát Nam Thời Trang Phân Cực Polaroid Chống Lóa, Chống Tia UV AK015 - AORON",250000,350000,100000,29
TIKI,phu-kien-thoi-trang,169304683,"Thắt lưng nam ADL04, dây nịt nam thời trang khóa kim đúc đồng siêu đẹp, bảo hành 12 tháng - Adonis Store",249000,249000,0,0
TIKI,phu-kien-thoi-trang,241631539,"Mũ nón len nam nữ mùa thu đông chất dày co dãn tốt giữ ấm tốt tròn thời trang",45000,45000,0,0
TIKI,phu-kien-thoi-trang,96010859,"Thắt lưng nam , dây nịt da nam cao cấp - MCZ",50000,50000,0,0
TIKI,may-anh,168365420,"Ống nhòm hai mắt thương hiệu Asika dòng nâng cấp C2, độ phóng đại 10 lần , đường kính 42 mm cho hình ảnh trong, sáng, rõ nét Hàng chính hãng",1660000,1660000,0,0
TIKI,phu-kien-thoi-trang,101465247,"Kính lão inox gọng xếp màu xám - Mắt kính lão thị phù hợp cho nam và nữ",314000,314000,0,0
TIKI,phu-kien-thoi-trang,26386138,"Kính cận thị gọng hợp kim titan mắt kính đổi màu KDN -KCM10",152000,152000,0,0
TIKI,dong-ho-va-trang-suc,161522862,"Dây Milanese thép dây galaxy watch 4",90000,90000,0,0
TIKI,phu-kien-thoi-trang,83675838,"Kính Mắt Chống Tia UV Từ Điện Thoại, Máy Tính, Chống Mỏi Mắt Nhiều Màu Thoải Mái Lựa Chọn - Kính Thời Trang",1600000,1600000,0,0
TIKI,may-anh,194067352,"Camera Wifi Trong Nhà EZVIZ C6N 2M FHD 1080P Quay 355 độ - Đàm thoại 2 chiều - Hàng Chính Hãng",446500,470000,23500,5
TIKI,phu-kien-thoi-trang,172456630,"DÂY THUN CỘT TÓC Loại size to Co giãn Bịch 40g",9000,9000,0,0
TIKI,phu-kien-thoi-trang,24540381,"Tất nữ cao cổ Basic II",14000,15000,1000,7
TIKI,phu-kien-thoi-trang,147116858,"Kính mát nam kính râm phù hợp mặt to gọng kim loại kính cường lực chống trầy xước",79200,99000,19800,20
TIKI,phu-kien-thoi-trang,91831301,"Kính lão thị viễn thị giả bút cài màu Đen cực tiện lợi",99000,99000,0,0
TIKI,phu-kien-thoi-trang,83616022,"Mũ len nam nữ trùm đầu liền khăn cổ lót nỉ ấm áp mùa đông chống gió lạnh - mu len nam nu lot ni trum co",115000,115000,0,0
TIKI,phu-kien-thoi-trang,31140848,"Băng đô giữ tóc vải mịn Song An Eco TB07",15000,15000,0,0
TIKI,phu-kien-thoi-trang,74676716,"Kính lão thị viễn thị loại tốt kính mắt sáng rõ và không mỏi gọng khoan siêu nhẹ và sang trọng",186000,186000,0,0
TIKI,phu-kien-thoi-trang,48050429,"Bộ 3 Kẹp tóc càng cua mỏ vịt kẹp mái thời trang như hình",35000,35000,0,0
TIKI,phu-kien-thoi-trang,160894063,"Hộp 5 đôi tất đi giày tây họa tiết sọc chéo, vớ nam công sở cổ cao cao cấp, chất cotton hút ẩm, thoáng khí - GOM-TAYCHEO-CB5",179000,250000,71000,28
TIKI,phu-kien-thoi-trang,71161566,"Tóc giả buộc thẳng 60cm FREESHIP tóc cột giả, buộc tóc giả D13L",49000,49000,0,0
TIKI,phu-kien-thoi-trang,159486418,"Vớ Tất Len Nam Nữ Cổ Cao Retro Họa Tiết Thổ Cẩm Phong Cách Vintage Thời Trang Thu Đông - Mã TV024",25000,25000,0,0
TIKI,phu-kien-thoi-trang,146585779,"Kẹp tóc sau - kẹp tóc hoa hồng camellia đính đá dạng dài",49000,49000,0,0
TIKI,phu-kien-thoi-trang,124400004,"Thắt lưng nam dây nịt nam chất liệu da bò thật khóa tự động hàng hiệu cao cấp NT302 - Nutushop",320000,320000,0,0
TIKI,phu-kien-thoi-trang,5919055,"2 Đôi Găng Tay Chống Nắng Let Slim Đen (4 Chiếc)",18000,18000,0,0
TIKI,phu-kien-thoi-trang,109367023,"Kính lão thị viễn thị đọc sách  trung niên HAI TRÒNG nhìn xa và gần tiện lợi PKTMKT92JJH",219000,219000,0,0
TIKI,phu-kien-thoi-trang,146621749,"Kim Loại Sang Trọng Kim Cương - Kẹp Tóc Hình Học Đơn Giản Thiết Kế Mỏ Vịt - Kẹp Tóc Phong Cách Hàn Quốc",34900,34900,0,0
TIKI,phu-kien-thoi-trang,170720661,"Khăn Mùi Xoa, Khăn Tay Nam (L2)",55000,55000,0,0
TIKI,phu-kien-thoi-trang,164947295,"Bờm vải 1 màu bản to phong cách Hàn Quốc",25000,25000,0,0
TIKI,phu-kien-thoi-trang,10765937,"Kính mát thể thao Unisex Tifosi Swank - Gọng Crimson / Onyx, Tròng Smoke Red",950000,950000,0,0
TIKI,phu-kien-thoi-trang,48725015,"GỌNG KÍNH UNISEX VELOCITY VL48471",256000,360000,104000,29
TIKI,phu-kien-thoi-trang,208067236,"Tóc giả nữ búi gấp mini, tóc búi kẹp, tóc búi mini",160000,160000,0,0
TIKI,may-anh,155760150,"Camera hành trình dạng lắp gương hãng PhiSung E08-E/4G/Wifi/GPS/10'' cao cấp - Hàng Nhập Khẩu ",3630000,3630000,0,0
TIKI,phu-kien-thoi-trang,83617329,"Khẩu trang ninja vải nỉ kính bảo vệ mắt dán gáy che kín tai chạy xe phượt nam nữ - khau trang ni - Đỏ đô có kính",49000,49000,0,0
TIKI,phu-kien-thoi-trang,173482223,"Ví da đựng kính thời trang nút bấm kim loại (giao màu ngẫu nhiên)",56000,60000,4000,7
TIKI,may-anh,5895803,"Pin Máy Ảnh Wasabi For Sony NP-F970 - Hàng Nhập Khẩu",236550,249000,12450,5
TIKI,phu-kien-thoi-trang,11427996,"Đai chống gù lưng cho nữ size",199900,199900,0,0
TIKI,phu-kien-thoi-trang,77670404,"Thắt lưng nữ Dress/ dây nịt nữ đẹp phối đầm / Đai váy sang trọng DONA21021704",79000,99000,20000,20
TIKI,may-anh,8647152," Đầu ghi hình camera IP 16 kênh HIKVISION DS-7616NI-K1(B) - Hàng chính hãng",1950000,1950000,0,0
TIKI,phu-kien-thoi-trang,81640112,"Bộ Nhiều Mẫu anime, xăm 3D Hình Xăm Dán, Hình Xăm henna Tattoo Cao Cấp",4900,4900,0,0
TIKI,phu-kien-thoi-trang,169641317,"Móc vít chìa khóa sửa gọng kính",9000,12000,3000,25
TIKI,phu-kien-thoi-trang,54146582,"Kính lão thị viễn thị trung niên gọng khoan nam tính chống bức xạ kv4n cao cấp nhật bản",179000,179000,0,0
TIKI,may-anh,71172359,"Đế plate mini gắn máy ảnh lên tripod dùng cho đầu Ballheath Q01 , Q02 , Q03 - hàng nhập khẩu",129999,129999,0,0
TIKI,phu-kien-thoi-trang,92156856,"Khăn Lụa Vuông Lụa Satin Quàng Cổ Quấn Tóc Quấn Túi Xách Làm Áo Yếm Lụa- 90x90cm - Mã KL060",75000,75000,0,0
TIKI,may-anh,15669044,"Micro Thu Âm Cho Smartphone Rode Videomic Me - Hàng Chính Hãng",1760000,1760000,0,0
TIKI,phu-kien-thoi-trang,95295101,"Thắt lưng chun - độ đàn hồi tốt (dành chuyên cho người vận động thể thao)",360000,360000,0,0
TIKI,phu-kien-thoi-trang,72203600,"Tag Hoa Hồng Lớn Cài Áo, Kiểu Cài Áo Hoa Có Ghim, Có Trâm Cài Áo Váy Màu Nâu Đậm, màu da, Đỏ  - Kích Thước 8-9 CM CH002",48000,54000,6000,11
TIKI,phu-kien-thoi-trang,47301060,"Kính V SOUTHSIDE Mắt vuông unisex cho Nam và Nữ",35000,35000,0,0
TIKI,phu-kien-thoi-trang,99670139,"Kẹp phồng tóc:phụ kiện tóc nữ,miếng độn tóc",30000,30000,0,0
TIKI,phu-kien-thoi-trang,20200845,"Băng đô bông -băng đô đa năng - băng đô tai gấu",41000,41000,0,0
TIKI,phu-kien-thoi-trang,189491970,"Dây Buộc Tóc Vải, Khăn choàng cổ Lụa In Họa Tiết Thắt Nơ Phong Cách Hàn Quốc Cho Nữ",18000,18000,0,0
TIKI,dong-ho-va-trang-suc,37769268,"Bông Tai Nam Khoen Tròn Sơn Tùng Chất Liệu Thép Titan Ko Rỉ Ko Dị Ứng TT 0861 - 1 cặp",19000,19000,0,0
TIKI,dong-ho-va-trang-suc,106107764,"Nhẫn titan nam nữ - nhẫn nam bền màu - Trang sức Bé Heo BHN119",20000,32000,12000,38
TIKI,dong-ho-va-trang-suc,54750296,"Dây đồng hồ kim loại cao cấp Super Engineer Type II",741000,741000,0,0
TIKI,dong-ho-va-trang-suc,44028128,"Đồng hồ điện tử thể thao nam SKMEI SK27 chống sốc chống nước, bơi lội thoải mái",179000,209000,30000,14
TIKI,dong-ho-va-trang-suc,80933783,"Đồng Hồ Nam Casio W-218H-3AVDF Dây Nhựa",629250,839000,209750,25
TIKI,dong-ho-va-trang-suc,8677130,"Nhẫn Bạc Nam Bạc Ta Kiểu Dáng Trơn Đơn Giản Nam Tính BẠC HIỂU MINH NA035",269000,390000,121000,31
TIKI,dong-ho-va-trang-suc,12115034,"Đồng hồ unisex dây nhựa Casio F-200W-9ADF",572800,716000,143200,20
TIKI,dong-ho-va-trang-suc,134364064,"Đồng Hồ Nam Dây Nhựa Casio Standard W-219H-8BVDF Chính Hãng - W-219H-8B",670500,894000,223500,25
TIKI,dong-ho-va-trang-suc,204039338,"Vòng tay trụ trúc 9 trụ 9 tròn phong thủy trầm hương HÀ XÁ đeo tay cặp đôi nam nữ may mắn bình an tài lộc",150000,300000,150000,50
TIKI,dong-ho-va-trang-suc,105803053,"199kVòng Tay Trầm Hương Chuỗi Tràng Hạt 108 7mm Trầm Tốc Mộc Trầm Hương",264000,264000,0,0
TIKI,dong-ho-va-trang-suc,137831158,"Dây đeo Apple Watch series 9/ 8/ 7/ 6/ 5/ 4/ 3/ SE/ Ultra/ Ultra 2 size 38/ 40/ 41mm và 42/ 44/ 45/ 49mm (DAWB)",150000,150000,0,0
TIKI,dong-ho-va-trang-suc,147219086,"Đồng Hồ Nữ Julius Hàn Quốc Dây Da JA 544",489000,489000,0,0
TIKI,dong-ho-va-trang-suc,10588582,"Bông tai nụ ngọc trai chonmua365",28000,35000,7000,20
TIKI,dong-ho-va-trang-suc,45424318,"Bông Tai Bạc Ý S925 Đính Đá Cao Cấp, Khuyên Tai Bạc Mặt Đá Vuông Quý Phái Sang Trọng - B2390 - Bảo Ngọc Jewelry",400000,400000,0,0
TIKI,dong-ho-va-trang-suc,204053194,"Vòng tay phong thủy bánh xe luân hồi trầm hương HÀ XÁ vòng đeo tay cặp đôi nam nữ may mắn tài lộc",300000,600000,300000,50
TIKI,dong-ho-va-trang-suc,41563695,"Bông Tai Nam Hình Tròn Chất Liệu Thép Titan Không Rỉ TT 0956 - 1 Cặp",35000,35000,0,0
TIKI,dong-ho-va-trang-suc,145700782,"Ốp Apple Watch series 7 41/ 45mm - Chất PC + kính cường lực (OAWCL)",99000,99000,0,0
TIKI,dong-ho-va-trang-suc,87093899,"Nhẫn cưới trơn 1 chỉ mạ vàng 24k (Thái Lan)",13000,43000,30000,70
TIKI,dong-ho-va-trang-suc,52318485,"Khóa bướm ĐÔI thép không gỉ dùng cho dây da nhiều SIZE 14 16 18 20 22mm",29000,29000,0,0
TIKI,dong-ho-va-trang-suc,78503804,"Bó 10m-20m dây tim bóng handmade loại 1,5mm - Dây vải bóng 1.5mm để đan vòng, thắt dây handmade - Ngọc Quý Gemstones",13000,26000,13000,50
TIKI,dong-ho-va-trang-suc,35527471,"Nhẫn Nữ Bản Nhỏ Titan Không Đen TT 1471",54000,54000,0,0
TIKI,dong-ho-va-trang-suc,107338668,"Hộp Đựng Đồng Hồ Cơ 4 Xoay Và 6 Trưng Bày Gỗ Cao Cấp",1350000,1350000,0,0
TIKI,dong-ho-va-trang-suc,141658188,"Vòng tay nam/nữ handmade",25000,25000,0,0
TIKI,dong-ho-va-trang-suc,183037703,"Dây Đeo Đồng Hồ Size Nữ 12mm 14mm 16mm 18mm Da Bò Mềm",120000,120000,0,0
TIKI,dong-ho-va-trang-suc,161941928,"Dây Nylon Cao Cấp Apple Watch Series 7/6/5/SE/4/3/2/1 Size 38-40-41-42-44-45",55000,55000,0,0
TIKI,dong-ho-va-trang-suc,113957188,"Đồng Hồ Đôi Dây Kim Loại Chính Hãng OLEVS, Đồng Hồ Đôi Nam Nữ Đẹp, Dây Thép Không Gỉ, Fullbox Chính Hãng, Món Qùa Tặng Sang Trọng Và Ý Nghĩa Cho Các Cặp Đôi",989000,989000,0,0
TIKI,dong-ho-va-trang-suc,149917089,"[1 Hạt] 9MM Đá Thạch Anh Vàng, Citrine Tự Nhiên, Đá Phong Thuỷ, Làm Trang Sức, Vòng Tay, Chuỗi Hạt, Loại A, Mệnh Thổ, Kim - Bead Art",64000,64000,0,0
TIKI,dong-ho-va-trang-suc,12114573,"Đồng hồ unisex dây nhựa Casio F-200W-1ADF",608000,716000,108000,15
TIKI,dong-ho-va-trang-suc,204190122,"Vòng tay phật di lặc phong thủy trầm hương HÀ XÁ vòng đeo tay cặp đôi nam nữ may mắn tài lộc",199000,398000,199000,50
TIKI,dong-ho-va-trang-suc,134270177,"Dây đồng hồ da bò vegtan thảo mộc cao cấp RAM Leather trống đồng nâu medium bền chắc - tặng khóa chốt và cây thay dây",269000,269000,0,0
TIKI,dong-ho-va-trang-suc,144297594,"[1 Hạt] Đá Mặt Trăng, Moonstone Tự Nhiên Ánh Cầu Vồng 6.7MM-7MM Loại A , Hợp Mệnh Kim, Thuỷ, Phối Vòng Tay Phong Thuỷ, Chuỗi Hạt - Bead Art",69600,69600,0,0
TIKI,dong-ho-va-trang-suc,41181982,"Bông Tai Cho Nam Nữ Loại Kẹp 2 Lỗ Ko Cần Bấm Lỗ Tai Chất Liệu Thép Titan Không Rỉ TT 2314 - 1 Cái",49000,49000,0,0
TIKI,dong-ho-va-trang-suc,104148120,"Dây da đồng hồ nam nữ đủ size 12/14/16/18/20/22/24 cực mềm",110000,110000,0,0
TIKI,dong-ho-va-trang-suc,52132586,"DÂY ĐỒNG HỒ DA BÒ THẬT TẶNG KÈM KHÓA VÀ CÂY THAY DÂY - RAM CLASSIC 1950 - CHÍNH HÃNG RAM LEATHER",189000,189000,0,0
TIKI,dong-ho-va-trang-suc,43041524,"Dây Chuyền Phật Quan Âm Bồ Tát  - Vòng cổ Phật Bà Quan Âm",19000,19000,0,0
TIKI,dong-ho-va-trang-suc,175810468,"Đồng Hồ Nam Nữ WR Dây Hợp Kim Thời Trang",42000,45000,3000,7
TIKI,dong-ho-va-trang-suc,65864823,"Nhẫn cưới trơn 2 chỉ mạ vàng 24k ( Thái Lan )",23000,40000,17000,43
TIKI,dong-ho-va-trang-suc,174529251,"Khoá Bướm Dây Đồng Hồ Loại Khoá Bật, Có Vân Chất Liệu Thép 316L Cao Cấp Nhiều Màu, Size 16, 18, 20",95000,95000,0,0
TIKI,dong-ho-va-trang-suc,52206281,"Đồng hồ nữ trái dâu Nhật Bản dây trong suốt 4 màu dễ thương",195000,195000,0,0
TIKI,dong-ho-va-trang-suc,178027654,"Vỉ 10 Pin cúc áo VINNIC AG10 / LR1130/ 389A / CX189 Chính hãng dùng cho đồng hồ đeo tay thiết bị điện tử",17000,17000,0,0
TIKI,phu-kien-thoi-trang,105059034,"GOTI  - Trâm Cài Áo Hình Hoa Xanh Sang Trọng Nữ Tính  Kiểu Phụ Kiện Trang Trí Trâm Cài Váy Đầm Dành Cho Nữ Cài Vest Nữ GOTI CA05",29000,70000,41000,59
TIKI,phu-kien-thoi-trang,150619767,"Gọng kính 8088 nhựa cao cấp siêu bền thời trang cá tính nam nữ OURESS",228000,299000,71000,24
TIKI,phu-kien-thoi-trang,192962017,"Hình xăm cuốn cánh tay, quấn cổ tay, đường thanh kẻ ngang chữ số la mã, Xăm giống Inkaholic",32000,32000,0,0
TIKI,phu-kien-thoi-trang,77638555,"Nón kết chữ S dành cho nam và nữ, chất liệu vải dù trơn bóng, gắn sò to 2 bên hông nón - Hạnh Dương",45000,45000,0,0
TIKI,phu-kien-thoi-trang,159314953,"Khẩu trang che cổ nam nữ chống nắng có tai đeo chống tuột - Vải thoáng khí, dễ thở, tản nhiệt nhanh - Khẩu trang đi phượt không làm rối tóc",55000,55000,0,0
TIKI,phu-kien-thoi-trang,207818719,"Kính Râm, Kính Nam Mắt Phi Công Gọng Khoan Full Đen - BLUE LIGHT",185000,185000,0,0
TIKI,phu-kien-thoi-trang,108685791,"Băng đô rửa mặt loại dày co giãn cực tốt siêu dễ thương - Hàng nhập khẩu",17000,17000,0,0
TIKI,phu-kien-thoi-trang,49953036,"Kính lão thị viễn thị nam nữ siêu dẻo kvn07cpyHJAL",72000,72000,0,0
TIKI,phu-kien-thoi-trang,113835115,"Mắt kính râm kẹp cho người cận, mắt kính thời trang phân cực chống UV cao cấp KitAcoom, hàng nhập khẩu chính hãng cao cấp",89000,89000,0,0
TIKI,phu-kien-thoi-trang,172680850,"ỐNG TAY CHỐNG NẮNG XỎ NGÓN CÁI Dành Cho Nam Nữ",18000,18000,0,0
TIKI,phu-kien-thoi-trang,55133802,"Nón bucket đen trơn thời trang Hàn Quốc dành cho cả nam và nữ NK482",25000,25000,0,0
TIKI,phu-kien-thoi-trang,36470318,"Trâm Cài Áo Hình Bó Hoa Đính Đá Sapphire Dịu Dàng Nữ Quí Phái",258000,258000,0,0
TIKI,phu-kien-thoi-trang,72862878,"Găng Tay Bao Tay Len Giữ Ấm Chống Nắng Cho Nữ",79000,79000,0,0
TIKI,phu-kien-thoi-trang,168964893,"Tất vớ nam công sở cổ cao đi giày tây GOMTAT họa tiết chấm bi, chất liệu cotton cao cấp thoáng khí - GOM-CHAMBI-1DOI",26000,50000,24000,48
TIKI,phu-kien-thoi-trang,38129876,"Mắt kính phân cực dạng kẹp ( Kính râm cho người cận, viễn ) - Đen ( Dùng khi trờ sáng nhiều hơn )",93859,93859,0,0
TIKI,phu-kien-thoi-trang,83616170,"Khẩu trang ninja vải nỉ dán gáy che kín mặt tai chống nắng chạy xe phượt nam nữ hè - khau trang ni",35000,35000,0,0
TIKI,phu-kien-thoi-trang,164021725,"Kính Thể Thao Nam Nữ Đạp Xe, Chạy Bộ Thời Trang, Mắt Kính Phân Cực Polarized Chống Chói, Chống Lóa Đi Đêm AK042 - AORON",250000,390000,140000,36
TIKI,phu-kien-thoi-trang,84094058,"Thắt lưng nam cao cấp, dây nịt nam cao cấp dây da bền bỉ khóa tự động thương hiệu TOPEE phong cách công sở CA56",278000,278000,0,0
TIKI,phu-kien-thoi-trang,83617936,"Mũ len kèm khăn choàng cổ giữ ấm thời trang mùa đông cho nữ",115000,115000,0,0
TIKI,phu-kien-thoi-trang,115893196,"Găng tay cụt ngón nam nữ vải mềm thật tay lái, co giãn, chống nắng | Găng tay đi xe máy, đạp xe, lái xe ô tô hở ngón",70000,80000,10000,13
TIKI,phu-kien-thoi-trang,125158727,"Vớ Tất Xanh vớ CA vớ BĐ vớ SĨ Q hàng cao cấp",25000,25000,0,0
TIKI,phu-kien-thoi-trang,157125346,"Set 5 Đôi Vớ Lười Nam , Tất Nam đi giày lười có đệm cao su chống trượt gót chân - GOMTAT-LUOI02-CB5",35000,60000,25000,42
TIKI,phu-kien-thoi-trang,91534977,"Nón tai bèo vành rộng nam chống nắng tốt bảo vệ da, chất liệu vải kaki oát bền đẹp ,sử dụng khi làm việc ngoài trời - Hạnh Dương",55000,55000,0,0
TIKI,phu-kien-thoi-trang,175838894,"Mũ cói mềm hở chóp nơ sau - nón cói vành rộng chống nắng, đi biển phong cách",53000,106000,53000,50
TIKI,phu-kien-thoi-trang,137847141,"Tất bèo nữ cổ cao, vớ cổ cao vải cotton thêu hình chú Gấu Teddy phong cách thời trang Hàn Quốc - TD68",62000,62000,0,0
TIKI,phu-kien-thoi-trang,87009343,"Kẹp tóc kim loại con bướm treo",44900,44900,0,0
TIKI,phu-kien-thoi-trang,49943035,"Kính lão thị viễn thị sẵn độ mắt cực sáng siêu dẻo nam nữ cực ôm chống uv KVP95JAPA cao cấp",219000,219000,0,0
TIKI,phu-kien-thoi-trang,90871368,"KÍNH LÃO DÀNH CHO NGƯỜI TRÊN 40 TUỔI GỌNG TITAN MẶT KÍNH CÓ HỘP ĐỰNG KHĂN LAU KÍNH",62000,149000,87000,58
TIKI,phu-kien-thoi-trang,108464685,"Mũ nón Miki kiểu thủy thủ không vành Miki hat mẫu Quality",89000,89000,0,0
TIKI,phu-kien-thoi-trang,171289468,"Tất Nam Nữ Cổ Cao Unisex, Vớ Nam Nữ Cao Cổ Cotton Họa Tiết Cổ Sọc Phong Cách Hàn Quốc - GOM10-CAO-3SOC",29000,50000,21000,42
TIKI,phu-kien-thoi-trang,181692405,"Lens xám tây có độ Build a Barbie tự nhiên hiệu Angel Eyes - Độ cận 0-8 - Đường kính màu 13.3mm",150000,150000,0,0
TIKI,phu-kien-thoi-trang,26652354,"Bộ 10 miếng dán thấm mồ hôi vùng nách nội địa Nhật Bản",42000,42000,0,0
TIKI,phu-kien-thoi-trang,164021830,"Kính Mát, Kính Râm Nam, Kính Đổi Màu Nam Chính Hãng Đi Ngày Và Đêm Chống Lóa, Chống UV400 Ôm Mặt Siêu Xịn AK019 - Aoron",220000,370000,150000,41
TIKI,phu-kien-thoi-trang,183727784,"[MẪU MỚI]- Khăn choàng thổ cẩm phong cách Vintage kiểu dài 180x90cm - Khăn choàng cổ Boho đi biển- CHỌN MẪU",148000,148000,0,0
TIKI,phu-kien-thoi-trang,119926509,"Cà Vạt Nam Bản Nhỏ 5cm Hàn Quốc - Cavat kỷ yếu , Cà Vạt Học Sinh , Bán lẻ giá buôn",18000,18000,0,0
TIKI,phu-kien-thoi-trang,182754054,"Kính Mát Nam Nữ, Kính Mát Gọng Vuông, Kính Phân Cực Nhiều Màu Bảo Vệ Mắt Chống Tia UV AK047-Aoron",270000,420000,150000,36
TIKI,phu-kien-thoi-trang,112867102,"Thắt Lưng Nam Vải Bố U729 US ARMY,Dây Nịt Vải Dù Bền Chắc, Khóa Hợp Kim Siêu Bền Cao Cấp -HÀNG CHÍNH HÃNG",79000,178000,99000,56
TIKI,phu-kien-thoi-trang,172123074,"1 CÂY LẤY RÁY TAI Cán nhựa Màu nâu Dài 18cm Sản xuất tại Việt Nam",7000,7000,0,0
TIKI,phu-kien-thoi-trang,72049330,"Khẩu Trang Pitta Màu Xanh Navy Nhật Bản (Gói 3 cái, mẫu mới 2020)",180000,180000,0,0
TIKI,phu-kien-thoi-trang,140575889,"Đai váy thắt lưng nữ dây nịt nữ mã 607",79000,139000,60000,43
TIKI,ngon,124411830,"[GIAO HN & HCM] - CÁ THÁC LÁC RÚT XƯƠNG VITOT FOOD (3- 4 con/kg)",283000,283000,0,0
TIKI,ngon,193881164,"Bún khô gạo lứt đỏ Cao Bằng - 0.5kg",35000,35000,0,0
TIKI,ngon,176256278,"Cánh gà khúc giữa nhập khẩu 500g [Chỉ giao hỏa tốc HN]",60000,60000,0,0
TIKI,ngon,149118483,"Táo Envy Mỹ size 70",199000,199000,0,0
TIKI,ngon,142315240,"[Chỉ giao HN] Thanh Surimi hương vị cua đông lạnh Mayumi hộp 250g",84000,84000,0,0
TIKI,ngon,184634212,"3G-Vịt om sấu",127000,127000,0,0
TIKI,ngon,114197783,"[Chỉ giao HN] - Cánh Gà Khúc Giữa Khay 1Kg Hút Chân Không",199000,199000,0,0
TIKI,ngon,128480130,"GIỎ QUÀ TẶNG CHÂN THÀNH",800000,800000,0,0
TIKI,ngon,149798306,"Sữa chua ít đường - Vỉ 4 hộp",28000,28000,0,0
TIKI,ngon,188964510,"Đậu Hà Lan tươi sạch Đôi Đũa Vàng dinh dưỡng gói 400g",105000,105000,0,0
TIKI,ngon,126962611,"[ Chỉ giao HN] - Củ dền 1kg",45000,45000,0,0
TIKI,ngon,128645765,"GIỎ PHÂN ƯU G-003",2700000,2700000,0,0
TIKI,ngon,179728667,"Nem rán gia đình nhân thịt bò Đôi Đũa Vàng thơm ngọt giòn rụm gói 480g ",138000,138000,0,0
TIKI,ngon,115902844,"[CHỈ GIAO HN] - CÁ HỐ TƯƠI CẮT KHÚC VITOT FOOD (500g/khay)",125000,125000,0,0
TIKI,ngon,160557854,"[ Chỉ giao HN] - Ngũ cốc dinh dưỡng Granola 500gr - Vị Cacao",270000,270000,0,0
TIKI,ngon,190842073,"Cà tím dài",13000,13000,0,0
TIKI,ngon,187580210,"Đặc Sản Nha Trang - Mực Tẩm Gia Vị Nha Trang  Size Đại Gói 500G",785000,790000,5000,1
TIKI,ngon,169074962,"[Combo 10 lọ] Nước yến sào Khánh Hòa Sanest dành cho người cao tuổi đóng lọ 70ml",335000,335000,0,0
TIKI,ngon,193159759,"[Chỉ giao HN] - Duôi heo Cộc - Túi 1kg",114000,114000,0,0
TIKI,ngon,120800177,"[Chỉ giao HN] - Táo AM 90 -1kg",139000,139000,0,0
TIKI,ngon,115802075,"[CHỈ GIAO HN] - CHẢ TÔM VITOT FOOD (500g/ khay)",219000,219000,0,0
TIKI,ngon,186578437,"Bò viên chiên Đôi Đũa Vàng 150g viên thả lẩu đậm đà từ thịt bò sạch",119000,119000,0,0
TIKI,ngon,181918013,"GẠO BẮC HƯƠNG NHÃN FAS LOẠI 5KG",100000,100000,0,0
TIKI,ngon,144803401,"[ Chỉ giao HN] - Chân gà đông tảo loại 1 -1kg (7-8 cái/kg)",750000,750000,0,0
TIKI,ngon,180322231,"Nước Mắm Tĩn Nhãn Đỏ cá cơm than Mini 40N 60ml/chai Rin Nguyên Chất Truyền Thống",35000,35000,0,0
TIKI,ngon,195658367,"Cánh Gà - 1Kg",60000,60000,0,0
TIKI,ngon,121743877,"Bánh Nướng Nhân Trà Xanh - Vỏ Truyền Thống - Không Trứng Muối",45000,45000,0,0
TIKI,ngon,191292334,"Củ gừng",25000,25000,0,0
TIKI,ngon,191292439,"Củ riềng",16000,16000,0,0
TIKI,ngon,197528945,"Khay trái cây mix - KF01",810000,810000,0,0
TIKI,ngon,162386995,"[Chỉ giao HN] - Thịt trâu gác bếp Tây Bắc - 500gr ",380000,380000,0,0
TIKI,ngon,126809014,"[ Chỉ giao HN] - Củ dền 1kg",45000,45000,0,0
TIKI,ngon,127578814,"(Chỉ giao HN) Mắm nêm pha sẵn đặc biệt - Chai 250ml",38000,38000,0,0
TIKI,ngon,196031615,"Gầu bò Canada",115000,115000,0,0
TIKI,ngon,193881183,"Gạo lứt đen tím than Sóc Trăng  - 1kg",45000,45000,0,0
TIKI,ngon,155495743,"[Chỉ giao HN]Cần Tây ĐL -1kg",48000,48000,0,0
TIKI,ngon,193881193,"Bánh canh gạo lứt - 1kg",130000,130000,0,0
TIKI,ngon,184634207,"3G-Khổ qua nhồi thịt 300g",35000,35000,0,0
TIKI,ngon,172025027,"[ Chỉ giao HN] -Dâu tây - 330gr",350000,350000,0,0
TIKI,ngon,116553118,"[Chỉ giao HN] - Cá Nục 1 Nắng - 1Kg 2 Khay",239000,239000,0,0
TIKI,ngon,117916596,"[Chỉ giao HN] - Cá Rô Đồng Lọc Xương - 1Kg",219000,219000,0,0
TIKI,ngon,119465265,"[Chỉ giao HN] - Gà Muối Xông Khói",209000,209000,0,0
TIKI,ngon,155495725,"[Chỉ giao HN]Khoai Lang Sấy Đà Lạt- 500gr",60000,60000,0,0
TIKI,ngon,155495733,"[Chỉ giao HN]Gạo Séng Cù- 5kg",162000,162000,0,0
TIKI,ngon,183035925,"[Mã 8938511152012]Gạo Bắc Hương Vinafood1 3,5kg",92225,92225,0,0
TIKI,ngon,169077579,"[Combo 20 lọ] Nước Yến sào Sanvinest Khánh Hòa đóng lọ 70ml",663000,663000,0,0
TIKI,ngon,159728989,"[Chỉ giao HN] - Bắp Hoa Trâu -  1kg",172000,172000,0,0
TIKI,ngon,120129102,"[Chỉ giao HN] - Rong Biển Tươi Làm Salad Hàn Quốc - 1Kg",399000,399000,0,0
TIKI,ngon,155495680,"[Chỉ giao HN] Cà Chua Bi Đà Lạt- 1kg",75000,75000,0,0
TIKI,ngon,180322232,"Nước Mắm Nhỉ Làng Chài Xưa Xuất Khẩu Nhãn Xanh Chai Thủy Tinh 500ml Cốt Nhỉ Đặc Biệt Vị Dịu Nhẹ",120000,120000,0,0
TIKI,ngon,180322205,"Nước mắm tôm biển Làng Chài Xưa 525ml/chai Hồng Ngọc Đại Dương 300 năm truyền thống",90000,90000,0,0
TIKI,ngon,125796863,"[ Chỉ giao HN] -Cà tím 1kg",35000,35000,0,0
TIKI,ngon,191502065,"Xịt thơm quần áo hương trái cây chai 380ml - Hàng Nhật nội địa- 380ml",55000,55000,0,0
TIKI,ngon,120480662,"[Chỉ Giao Hà Nội] Sườn heo - 1kg",129000,129000,0,0
TIKI,ngon,142120746,"[CHỈ GIAO HN] Dưa hấu Long An",65000,65000,0,0
TIKI,ngon,128124463,"Cá thu phấn cô tô file - gói 500gr",125000,125000,0,0
TIKI,ngon,112192277,"Iberico Tapas Mix 5 - 100g",310000,310000,0,0
TIKI,ngon,195855598,"Dưa hấu",50000,50000,0,0
TIKI,ngon,142315245,"[Chỉ giao HN] Bơ nhạt Anchor New Zealand khối 5kg",1500000,1500000,0,0
TIKI,ngon,116553092,"[Chỉ giao HN] - Chả Ốc - 1Kg 2 Khay",300000,300000,0,0
TIKI,ngon,172021752,"[ Chỉ giao HN]- Gạo Tám Gò Công Vinafood1 túi 3,5kg",130000,130000,0,0
TIKI,ngon,97691617,"[[Chỉ Giao HN]] - Súp gạch trứng tôm hùm",55000,55000,0,0
TIKI,ngon,127388462,"[Chỉ giao HN] Set lẩu đôi ta",199000,199000,0,0
TIKI,ngon,126794326,"[Chỉ giao HN] Sườn Cánh Buồm Heo - 1Kg",115000,115000,0,0
TIKI,ngon,92380614,"Ba rọi Iberico cuộn (khay 300g)",142000,158000,16000,10
TIKI,ngon,126796320,"Chả cá đặc biệt Lan Làn - gói 500gr",130000,130000,0,0
TIKI,ngon,162475492,"[Chỉ giao HN] - Nước lẩu nấm Ashima - 1kg",140000,140000,0,0
TIKI,ngon,162475486,"[Chỉ giao HN] - Nước lẩu nấm Ashima - 0.5kg",85000,85000,0,0
TIKI,ngon,125796859,"[ Chỉ giao HN] -Tai chua khô 500g",75000,75000,0,0
TIKI,ngon,162873949,"Sữa Bledilait Bledina Pháp - Hàng air chính hãng",240000,240000,0,0
TIKI,ngon,120267612,"[Chỉ giao HN] - Muối Vừng Đặc Biệt - 1 Hũ",199000,199000,0,0
TIKI,ngon,173381030,"Khăn tắm khô nhanh cho chó mèo (2 size - màu ngẫu nhiên) Khăn tắm siêu thấm nước cho thú cưng -  66x43cm không hộp",45555,45555,0,0
TIKI,ngon,142315231,"[Chỉ giao HN] Cá trích vàng ép trứng Nhật Bản đông lạnh thanh 130g",211000,211000,0,0
TIKI,ngon,121641695,"Cánh Gà Khúc Giữa - 1kg",125000,125000,0,0
TIKI,ngon,125452823,"Mực 1 nắng Coto 2-3 con 1 kg hút chân không",279000,279000,0,0
TIKI,ngon,173273845,"[Chỉ giao HN] - Cồi Sò Điệp - 500g",215000,215000,0,0
TIKI,ngon,171833840,"[ Chỉ giao HN] -Pate Chín Heo Yến mạch 450gr",40000,40000,0,0
TIKI,ngon,127509716,"[Chỉ giao HN] Sốt chấm thịt nướng 300gr",66000,66000,0,0
TIKI,ngon,155495686,"[Chỉ giao HN] Củ Dền - 1kg",44000,44000,0,0
TIKI,ngon,160219240,"Cá trứng Minh Tiến 400g",69000,69000,0,0
TIKI,ngon,179711424,"[Chỉ giao HN] - Sữa đậu gà đậu đỏ không đường - size L (1000ml)",84000,84000,0,0
TIKI,ngon,180322164,"Muối ớt đỏ chanh tắc cao cấp Làng Chài Xưa, nguyên liệu tươi, thơm ngon đặc biệt, chai thủy tinh 300gr",90000,90000,0,0
TIKI,ngon,252556385,"Tôm thẻ nõn Cà Mau 0.9kg (size 90-100 nõn/kg) - Combo gồm 3 gói 0.3kg + túi giữ nhiệt + thùng xốp + đá khô",420000,420000,0,0
TIKI,ngon,254146688,"Đặc Sản Nha Trang - Mực Khô Câu Size 16 Con/Kg Seavy Gói 500G",669000,675000,6000,1
TIKI,ngon,252392899,"Tôm thẻ Cà Mau 1.5kg (size 30-40 con/kg) - Combo gồm 5 gói 0.3kg + túi giữ nhiệt + thùng xốp + đá khô",650000,650000,0,0
TIKI,ngon,272391104,"Đặc Sản Nha Trang- Cá Đù Rim Nguyên Con Seavy Hộp 200g ️",78000,80000,2000,3
TIKI,ngon,273554539,"Đặc Sản Nha Trang- Hạt Macca Sấy Giòn Seavy, Tốt Cho Mẹ Bầu, Giảm Cân, Seavy Hộp 500 gram",175000,185000,10000,5
TIKI,ngon,272776823,"Đặc Sản Nha Trang - Khô Gà Xé Lá Chanh Seavy Hộp 500G",158000,175000,17000,10
TIKI,ngon,170180792,"Dây Dắt Chó Mèo Chất Liệu Dây Dù Cao Cấp Dây Dẫn Cho Thú Cưng Dưới 4kg Dài 120cm Dày 1cm - Đen",19999,19999,0,0
TIKI,ngon,166058214,"Thức ăn cho mèo Pate me-o gói 80g - Cá ngừ Mèo con - 1 Gói",12500,12500,0,0
TIKI,ngon,166057634,"Pate cho mèo Me-o Delite 70g - 1 Gói - Cá Ngừ & Cá Ngừ Trắng",18999,18999,0,0
TIKI,ngon,169004043,"Thức ăn hạt mềm cho chó trưởng thành Zenith Adult | Không ngũ cốc | Hỗ trợ miễn dịch | Phát triển xương khớp chắc khoẻ - 1.2kg",200000,200000,0,0
TIKI,ngon,272908251,"Đặc Sản Nha Trang -Mực Muối Lạt Phơi Ghe Ít Muối Dẻo Size Trung, Seavy Gói 250gr",82000,85000,3000,4
TIKI,ngon,166062783,"Pate Cho Mèo Me-O Delite Gói 70g - Đỏ",19000,19000,0,0
TIKI,ngon,166058075,"Đồ Ăn Cho Chó Trưởng Thành Classic Pets Hương Vị Thịt Bò Nướng - 400g",17000,17000,0,0
TIKI,ngon,169004517,"Xổ Giun Sán Cho Thú Cưng Sanpet Giá 1 Viên - 1 VIÊN",5888,5888,0,0
TIKI,ngon,169005209,"Dây Dắt Chó Mèo Chất Liệu Dây Dù Cao Cấp Dây Dẫn Cho Thú Cưng Dưới 4kg Dài 120cm Dày 1cm - Xanh Lá",19999,19999,0,0
TIKI,ngon,169068549,"Dây Đai Mỏng 1cm Cho Chó Mèo Kún Miu - Giao Màu Ngẫu Nhiên",18999,18999,0,0
TIKI,ngon,235964460,"Tim heo nhập khẩu nguyên quả 300-400g/quả [Chỉ giao hỏa tốc HN]",55000,55000,0,0
TIKI,ngon,170180558,"Thức Ăn Cho Mèo Me-O Adult Vị Cá Ngừ (350g) - 20 Gói ( 1 Tải 7kg có 20 gói 350gr)",550000,550000,0,0
TIKI,ngon,215967000,"[GIAO NHANH HN - 1H - 0989.780.789] Giỏ Quà Trái Cây Kèm Hoa Tươi - AC166",2600000,2600000,0,0
TIKI,ngon,172143488,"Bột matcha Đài Loan 100g ",98000,98000,0,0
TIKI,ngon,173379939,"Khay đựng cát vệ sinh cho mèo LS224",150000,150000,0,0
TIKI,ngon,170180192,"Combo 10 miếng lót chuồng, vệ sinh cho chó - S",29999,29999,0,0
TIKI,ngon,169005616,"Combo 10 gói thức ăn cho mèo trưởng thành Me-o Adult - Vị hải sản - 350g",250000,250000,0,0
TIKI,ngon,169067031,"Dầu tắm SOS cho chó mèo 530ml - Xanh dương",78888,78888,0,0
TIKI,ngon,214818417,"Khay 3 chùm nho sữa giống Hàn",1255000,1255000,0,0
TIKI,ngon,170179223,"Sữa tắm Hantox Shampoo Xanh Nhũ Bạc 200ml Sữa tắm trị ve rận bọ chét an toàn với chó con và mèo con",39000,39000,0,0
TIKI,ngon,235984859,"Xương ống heo nhập khẩu 500g [Chỉ giao hỏa tốc HN]",30000,30000,0,0
TIKI,ngon,215968704,"[GIAO NHANH HN - 1H - 0989.780.789] Giỏ Quà Trái Cây Kèm Hoa Tươi - AC173",1750000,1750000,0,0
TIKI,ngon,177153833,"[ Chỉ giao HN] - Khăn Pet hình tam giác",150000,150000,0,0
TIKI,ngon,177235484,"[ Chỉ giao HN] - Địu vải ABC 1",136000,136000,0,0
TIKI,ngon,177154274,"[ Chỉ giao HN] - Túi vải sọc đen nhỏ",155000,155000,0,0
TIKI,ngon,169057558,"Con gà đồ chơi cho chó mèo  - 32cm",24888,24888,0,0
TIKI,ngon,177784543,"[ Chỉ Giao HN] - Pate gan thịt heo cho mèo 130g (12goi/hop)",17000,17000,0,0
TIKI,ngon,128707112,"[Chỉ giao HN] Thịt Bò Wagyu Hitachi A5/BMS8-9 – Ribeyes (Thăn Lưng Đầu) - 1KG",4890000,4890000,0,0
TIKI,ngon,177235386,"[ Chỉ giao HN] - Thuốc nhỏ trị ve rận cho mèo 2.6 - 7.5kg",190000,190000,0,0
TIKI,ngon,120480665,"[Chỉ Giao Hà Nội] Gầu bò Úc - 1kg",230000,230000,0,0
TIKI,ngon,170180178,"Pate Hỗn hợp Cá King’s Pet lon 380g Thức Ăn Cho Chó Mèo",45000,45000,0,0
TIKI,ngon,147125726,"[Chỉ giao HN] Sốt chấm chua cay 250gr (lẩu)",35000,35000,0,0
TIKI,ngon,116520772,"[Chỉ Giao Hà Nội] Trâu sốt vang 750g ",69000,69000,0,0
TIKI,ngon,129137342,"[Chỉ giao HN] Sashimi mực - 10 miếng",96000,96000,0,0
TIKI,ngon,117771191,"Chả ốc kinh kỳ - 500gr",120000,120000,0,0
TIKI,ngon,159909091,"Combo 8 Hộp Sữa Dừa Socola - Sự kết hợp độc đáo giữa 100% từ Dừa Nguyên chất & Socola thượng hạng CB8.SD.SCL180TI COCOXIM",72000,72000,0,0
TIKI,ngon,159899606,"Thùng 48 Hộp Sữa dừa hạnh nhân COCOXIM dung tích 180ml/hộp TU.SD.HN01TI ",432000,432000,0,0
TIKI,ngon,159863465,"Combo 3 hộp nước Dừa Thơm  - Sự kết hợp độc đáo giữa 100% nước dừa nguyên chất & Thơm tươi 330ml CB3.THOM0006TI COCOXIM",57000,57000,0,0
TIKI,ngon,159858537,"Nước cốt dừa tươi từ trái dừa nguyên chất 100% Chef's Choice CD.CC160TI COCOXIM",15000,15000,0,0
TIKI,ngon,206250722,"COMBO DELICIOUS ĐỒNG GIÁ 99K",140000,140000,0,0
TIKI,ngon,155975009,"Combo 03 hộp nước dừa hương vị tắc từ 100% nước dừa tươi nguyên chất TAC005TI dung tích 330ml/hộp - THƯƠNG HIỆU COCOXIM ",57000,57000,0,0
TIKI,ngon,159888055,"Thùng 24 Hộp đồ uống thế thao Isotonic Active hương vị Acai Berry đóng hộp từ 100% Dừa tươi nguyên chất CB.ACAI0001TI COCOXIM ",456000,456000,0,0
TIKI,ngon,215981410,"[GIAO NHANH HN - 1H - 0989.780.789] Giỏ Quà Trái Cây Kèm Hoa Tươi - AC193",1100000,1100000,0,0
TIKI,ngon,272967993,"Đặc Sản Nha Trang-️ Xoài Sấy Dẻo Muối Ớt Chua Cay Mặn Ngọt, Không Xơ, Không Cứng, Không Đường, Seavy Gói 500gram",115000,120000,5000,4
TIKI,ngon,215174391,"Hộp quà tết Đại Cát 01",420000,420000,0,0
TIKI,ngon,166058051,"Mỡ kẽm oxyd cho chó mèo thú cưng",42000,42000,0,0
TIKI,ngon,141819305,"[Chỉ giao HN] Bánh Kem tươi đội bay siêu đẳng 06 Size 20cm cao 8cm",305000,305000,0,0
TIKI,ngon,215174407,"Hộp quà tết Đại Cát 05",439000,439000,0,0
TIKI,ngon,166058142,"Đồ Ăn Cho Chó Con Classic Pets Hương Vị Sữa  - 10kg",630000,630000,0,0
TIKI,ngon,214090867,"Gà chiên CP - Đùi gà chiên cay thơm ngon giòn rụm túi 1kg 10 cái ",221100,221100,0,0
TIKI,ngon,215969786,"[GIAO NHANH HN - 1H - 0989.780.789] Giỏ Quà Trái Cây Kèm Hoa Tươi - AC178",1350000,1350000,0,0
TIKI,ngon,117727246,"[ Chỉ giao HN]-Nem tôm/ cái",12000,12000,0,0
TIKI,ngon,236094747,"Đùi gà góc tư nhập khẩu 500g cắt sẵn miếng vừa tiện rang, xào,... [Chỉ giao hỏa tốc HN]",55000,55000,0,0
TIKI,ngon,208318025,"Gối Lót Đầu Điều Hòa Cho Bé Xuất Hàn Có Viền, Thoáng Mát Sử Dụng Được 4 Mùa Cho Trẻ Từ Sơ Sinh Đến 4 Tuổi 25x45 cm",120000,120000,0,0
TIKI,ngon,215966227,"[GIAO NHANH HN - 1H - 0989.780.789] Giỏ Quà Trái Cây Kèm Hoa Tươi - AC165",2150000,2150000,0,0
TIKI,ngon,118895527,"[Chỉ giao HN] Kem hộp vị Dừa sốt Bơ Lạc - Coconut with Peanutbutter Sauce",119000,119000,0,0
TIKI,ngon,272001322,"Đặc Sản Nha Trang -Cá Mai Tẩm Mè Giòn Giòn Thơm Ngon, Seavy Hộp 200 Gram",82000,85000,3000,4
TIKI,ngon,144765396,"[ Chỉ giao HN] - Bưởi Da xanh 1.2 - 1.4 kg / Quả",75000,75000,0,0
TIKI,ngon,222716412,"Giỏ Quà Trái Cây Qh65",750000,750000,0,0
TIKI,ngon,237438142,"Nhân bánh Hamburger TRF 100g x 2 chiếc",49000,49000,0,0
TIKI,ngon,127509713,"[Chỉ giao HN] Xúc xích nấm 5 cái",38500,38500,0,0
TIKI,ngon,191578109,"NEM CHUA RÁN LĂN XÙ MERCI FOODS",75000,75000,0,0
TIKI,ngon,117727055,"[ Chỉ giao HN]-Bánh bao nấm -40 gr/ cái",13000,13000,0,0
TIKI,ngon,160214437,"Thịt ba chỉ bò Mỹ KiwiFood 500g",119700,119700,0,0
TIKI,ngon,119319539,"[Chỉ giao HN] - Cá Saba Fillet Nguyên Miếng Không Xương - 1Kg",215000,215000,0,0
TIKI,ngon,159872737,"Combo 3 hộp nước dừa dứa non tươi từ 100% dừa nguyên chất CB3.DDN02TI COCOXIM ",57000,57000,0,0
TIKI,ngon,126962629,"[ Chỉ giao HN] - Cà chua bi đỏ 1kg",80000,80000,0,0
TIKI,ngon,208318978,"Đồ chơi Luồn thun Robo Winwintoys 60052",88000,88000,0,0
TIKI,ngon,215918036,"[GIAO NHANH HN - 1H - 0989.780.789] Giỏ Quà Trái Cây Kèm Hoa Tươi - AC156",1250000,1250000,0,0
TIKI,ngon,117727031,"[ Chỉ giao HN]-Há cảo phô mai-20gr/ cái",12000,12000,0,0
TIKI,ngon,144238968,"[Chỉ giao HN] - Hồng Treo Gió - Món Ngon Từ Đà Lạt - Quà Biếu Sang Trọng",199000,199000,0,0
TIKI,ngon,128124470,"Chả mực Thoan - 500gr",240000,240000,0,0
TIKI,ngon,191502123,"Bột làm sạch lồng máy giặt cực mạnh Rocket - 120g",50000,50000,0,0
TIKI,ngon,118896445,"[Chỉ giao HN] Kem hộp vị Socola Hạt Phỉ - Chocolate Halzenut",119000,119000,0,0
TIKI,ngon,191502067,"Hộp khử mùi, thơm phòng hương thảo mộc - 300g",48000,48000,0,0
TIKI,ngon,134712740,"[Chỉ giao Hà Nội] Trà hoa cúc chi Mộc Sắc - 80g",95000,95000,0,0
TIKI,ngon,121641699,"Ba Chỉ Bò Mỹ - 500gr",119500,119500,0,0
TIKI,ngon,155221717,"[Chỉ giao HN] - Mứt Dừa Non Bến Tre Sợi Trắng",145000,145000,0,0
TIKI,ngon,177750939,"Thức ăn mèo Whiskas vị cá biển lon 400g",43200,43200,0,0
TIKI,ngon,114197819,"[Chỉ giao HN] - Chả Nem Cua Bể Loại Ngon Khay 12 Chiếc Hút Chân Không",150000,150000,0,0
TIKI,ngon,171833819,"[ Chỉ giao HN] -Snack sấy khô Ức gà 100gr",85000,85000,0,0
TIKI,ngon,126234053,"Thịt dẻ sườn trâu M123 - 1kg",140000,140000,0,0
TIKI,ngon,196318939,"Má đùi gà-500g",60000,60000,0,0
TIKI,ngon,159110935,"[Giao nội thành Hà Nội] Cà rốt Vườn nhà mẹ - 1kg cà rốt ngon ngọt, tươi sạch, đạt tiêu chuẩn VietGAP",44000,44000,0,0
TIKI,ngon,166083184,"Sữa tắm SOS 530ml cho chó mèo - Xanh dương",74888,74888,0,0
TIKI,ngon,172919162,"[Chỉ giao Hà Nội] - Gas Petro Việt Nam Comasit",480000,480000,0,0
TIKI,ngon,160622116,"[ Chỉ giao HN] - Hạt MIX các loại đậu và ngũ cốc hữu cơ cao cấp Davert 500gram (ĐỨC)",195000,195000,0,0
TIKI,ngon,125796881,"[ Chỉ giao HN] -Chân nấm hương 500g",95000,95000,0,0
TIKI,ngon,121603657,"[ Chỉ giao HN] - Bánh xếp Hàn Quốc Nhân Thịt và Bắp 350gr",81600,81600,0,0
TIKI,ngon,208319077,"Set 3 khăn sữa sợi tre siêu mềm Muslin tree 28x28cm",50000,50000,0,0
TIKI,ngon,126795079,"[Chỉ giao HN] Cá Basa cắt khúc - 1Kg",70000,70000,0,0
TIKI,phu-kien-thoi-trang,209899170,"Kính áp tròng màu dùng 1 ngày Clalen Iris (Hàn Quốc) - 1 Miếng",25000,30000,5000,17
TIKI,ngon,176254777,"[Chỉ giao HN] Ba chỉ bò nhập khẩu 500g",135000,135000,0,0
TIKI,ngon,169077708,"[Combo 10 lọ] Nước Yến sào Khánh Hòa Sanest đóng lọ 70ml",335000,335000,0,0
TIKI,phu-kien-thoi-trang,137301180,"500G Chun buộc tóc, nịt buộc tóc màu đen , nhiều màu",10000,10000,0,0
TIKI,phu-kien-thoi-trang,52250449,"Tóc giả nữ ngắn trung niên 601 ❤️FREESHIP❤️ tóc trung niên nữ ngắn, tóc giả trung niên, trung niên tóc giả, tặng lưới chụp",150000,150000,0,0
TIKI,ngon,179422223,"Pizza xúc xích phomai Đôi Đũa Vàng thơm ngon béo ngậy hộp 350g - Giao nhanh tại Hà Nội và Hồ Chí Minh",209000,209000,0,0
TIKI,phu-kien-thoi-trang,48228954,"Kính lão thị trung niên kính đọc sách +100 đến +4.00 đủ độ mắt sáng và rõ PKTMKVM07COPY",219000,219000,0,0
TIKI,phu-kien-thoi-trang,15387305,"Sét 12 dây buộc tóc cao cấp xuất Nhật HD06",42000,42000,0,0
TIKI,ngon,160262981,"Chả mực giã tay Quảng Ninh",142500,142500,0,0
TIKI,ngon,184634187,"3G_Thịt heo xay 300g",49000,49000,0,0
TIKI,phu-kien-thoi-trang,132956083,"KHĂN TRÙM ĐẦU KIỂU NINJA Swat 3 in 1 Chất liệu vải siêu mềm mịn Co giãn Chống nắng Chống bụi",39000,39000,0,0
TIKI,ngon,142315219,"[Chỉ giao HN] Nạm ba chỉ bò Úc cuộn nhúng lẩu đông lạnh khay 500g Dắt mỡ",154000,154000,0,0
TIKI,phu-kien-thoi-trang,139449862,"Thắt lưng Nam vải dù_Tushi_khóa tự động sang trọng_tiện lợi, Thắt lưng lính vải bố_siêu bền đẹp",139000,139000,0,0
TIKI,phu-kien-thoi-trang,138897793,"Set cài áo ngọc trai 7 món mẫu mới ( hàng có sẵn )",29999,29999,0,0
TIKI,phu-kien-thoi-trang,209170971,"Mũ beret nam da cừu cao cấp BHY1965 Mũ nồi nam màu Nâu cà phê",619000,619000,0,0
TIKI,ngon,181904836,"Gạo Lứt đỏ Điện Biên nhãn Fas 1kg",45000,45000,0,0
TIKI,ngon,197089313,"Đặc Sản Nha Trang - Tôm Khô Loại 1 Xịn Size Trung Seavy Gói 500G",560000,575000,15000,3
TIKI,ngon,109516516,"[Chỉ Giao HN] Quýt Đường - Combo 2kg",98000,98000,0,0
TIKI,phu-kien-thoi-trang,82515871,"Thắt lưng nữ Dây nịt nữ đẹp Thời Trang Hàn Quốc dona21031101",94000,99000,5000,5
TIKI,phu-kien-thoi-trang,150931284,"Dây nịt nữ co giãn thắt lưng bản to khóa cá tính",89000,89000,0,0
TIKI,phu-kien-thoi-trang,90870188,"KÍNH ĐỔI MÀU TRÒNG KÍNH GỌNG TITAN DẺO BẺ KHÔNG GÃY",119000,119000,0,0
TIKI,phu-kien-thoi-trang,119104367,"Tất hài nữ Lali Hàn Quốc siêu dai, 1 đôi",3000,3000,0,0
TIKI,phu-kien-thoi-trang,197574767,"Nón CLB MU logo đỏ fom trucker vuông quai cài nút chất đẹp đứng fom",195000,195000,0,0
TIKI,phu-kien-thoi-trang,4100855,"Băng Đô Vải Cài Tóc Họa Tiết Zigzag Màu Xanh Rêu, Đỏ - Mã BD234",22000,22000,0,0
TIKI,ngon,184634178,"3G_Nạc thăn heo 300g",52000,52000,0,0
TIKI,phu-kien-thoi-trang,8294415,"Bộ 5 đôi tất lười, tất thuyền dấu gót, tất có silicon cho nữ P4W5",250000,250000,0,0
TIKI,phu-kien-thoi-trang,162048012,"Dây Thun Cột Tóc Co Giãn Cho Bạn Gái",5300,5300,0,0
TIKI,phu-kien-thoi-trang,138282747,"Cột tóc nơ bản to - hot trend phong cách Hàn Quốc, bánh bèo cho nữ",45000,45000,0,0
TIKI,phu-kien-thoi-trang,86169050," TÓC GIẢ MÁI THƯA CAO CẤP CÓ MAI VÀ KHÔNG MAI SỈ 14K",19900,19900,0,0
TIKI,ngon,196029407,"Ba chỉ bò cuận Canada",115000,115000,0,0
TIKI,phu-kien-thoi-trang,187511669,"Nón Lưỡi Trai logo Tiktok 2 phiên bản chất lượng cao brand One Hat",160000,160000,0,0
TIKI,phu-kien-thoi-trang,63049448,"Mũ rộng vành hở chóp XDM HAT chống nắng, chống tia UV – Nón đi biển dành cho nữ",51000,51000,0,0
TIKI,phu-kien-thoi-trang,54562958,"Kính mát chữ V nam nữ gọng tròn mắt mèo phong cách Hàn Quốc bảo vệ mắt chống tia UV",47500,50000,2500,5
TIKI,phu-kien-thoi-trang,57752704,"Kính mát nữ thời trang,Kính dâm, Kính du lịch MK03",39000,70000,31000,44
TIKI,ngon,119308627,"[Chỉ Giao Hà Nội] Bắp bò hun khói 200g",121000,121000,0,0
TIKI,ngon,129137334,"[Chỉ giao HN] Maki cá hồi - 6 miếng",64000,64000,0,0
TIKI,phu-kien-thoi-trang,110047857,"Kính lão thị viễn thị trung niên kính đọc sách sáng và rõ KV88",109000,109000,0,0
TIKI,phu-kien-thoi-trang,43829676,"Tất vớ nữ hình trái tim cổ ngắn TN07",11100,11100,0,0
TIKI,phu-kien-thoi-trang,52263401,"SET 6 CỘT TÓC SCRUNCHIES VẢI BÓNG NHIỀU MÀU, BUỘC TÓC THỜI TRANG NỮ ",45000,45000,0,0
TIKI,phu-kien-thoi-trang,124911307,"Mũ lưỡi trai thêu chữ SECOND THOUGHT nhiều màu- Nón kết nam nữ",46000,46000,0,0
TIKI,phu-kien-thoi-trang,158756303,"Khẩu trang nhựa dẻo VN68 - Màu đen, thời trang đi mưa, tái sử dụng nhiều lần",75000,75000,0,0
TIKI,ngon,215092421,"Mật Ong Hoa Manuka MGO 83+/NPA 5+ - 500g",550000,550000,0,0
TIKI,phu-kien-thoi-trang,186550355,"Mũ lưỡi trai phối lưới phong cách ullzang cá tính, Nón kết thời trang NKL",99000,99000,0,0
TIKI,phu-kien-thoi-trang,32214090,"Băng đô nữ",35000,35000,0,0
TIKI,phu-kien-thoi-trang,94997536,"Mũ nón chống nắng nữ ninja có chìa rộng chùm kín cổ gáy kiêm khẩu trang chống nắng vải caro thoáng mát",79000,79000,0,0
TIKI,ngon,155253960,"[Chỉ giao HN] - Gà Ủ Muôi Nguyên Con - 1.2-1.3Kg - Món Ngon Ngày Tết",299000,299000,0,0
TIKI,phu-kien-thoi-trang,104415407,"1 kẹp tóc hình bướm, phụ kiện chụp ảnh, kẹp tóc hồ điệp đính đá xinh xắn",6000,6000,0,0
TIKI,phu-kien-thoi-trang,267259915,"Tờ Xăm Miếng Dán Tattoo 15 Ngày Không Trôi Chống Thấm Nước Tạm Thời Thánh giá chữ thập có cánh Legaxi",13000,13000,0,0
TIKI,ngon,142315207,"[Chỉ giao HN] Whipping Cream (kem tươi) Anchor New Zealand hộp 250ml",87000,87000,0,0
TIKI,phu-kien-thoi-trang,181782398,"Tất Thể Thao Nam Nữ GOMTAT Chất Liệu Cotton Cao Cấp, Vớ Cổ Ngắn Unisex Chuyên Dùng Trong Việc Tập Luyện - GOM502-THETHAO",39000,70000,31000,44
TIKI,ngon,179711688,"[Chỉ giao HN] - Túi mix 05 loại hạt cao cấp 1 (óc chó, hạnh nhân, macca, hạt điều, hạt bí) - 500gr",260000,260000,0,0
TIKI,ngon,180322216,"[ Nước Mắm Nhỉ 30 độ đạm ] Làng Chài Xưa truyền thống nhãn đỏ chai thủy tinh 500ml cốt nhỉ đặc biệt",120000,120000,0,0
TIKI,phu-kien-thoi-trang,10347900,"Thắt Lưng/ Dây Nịt Nam Da Bò 3 Lớp, Khóa Kim Lỗ Minh Tâm MT214-09 (120cm x 3,5cm) + Tặng Kèm Hộp Gói Sang Trọng",259000,359000,100000,28
TIKI,ngon,130970436,"Cá Lăng Sông Đà/nguyên con/2-8kg/Minafood",120000,120000,0,0
TIKI,phu-kien-thoi-trang,183290816,"Set 5 Đôi Vớ Nữ Cổ Ngắn Họa Tiết Nhiều Màu, Tất Cổ Ngắn Nữ Sử Dụng Cả Tuần - CB082",39000,50000,11000,22
TIKI,phu-kien-thoi-trang,180340635,"Dụng cụ búi tóc nữ ( Thái Lan )  - 2 cây ",31000,45000,14000,31
TIKI,ngon,171330876,"[Chỉ giao HN] Áo ba lỗ mùa hè in hình cute màu xanh lá cây  - S",33000,33000,0,0
TIKI,phu-kien-thoi-trang,105106346,"GOTI - Cài Áo Hoa Tulip Hạt Đá Kiểu Tag Cài Váy Đẹp Thanh Lịch Dành Cho Nữ Kiểu Dáng Hoa Cao Cấp Đa Dạng GOTI CA11",52000,84000,32000,38
TIKI,ngon,142315193,"[Chỉ giao HN] Phô mai Mozzarella Anchor New Zealand khối 5kg",1517000,1517000,0,0
TIKI,phu-kien-thoi-trang,120480536,"Kính Râm, Kính Mát Nam Nữ Mắt Tròn 2 Tròng Mở Nắp 2in1 Gọng Kim Loại Cao Cấp",179550,189000,9450,5
TIKI,phu-kien-thoi-trang,50252353,"COMBO A Kính Áp Tròng Trong Suốt Mediclear + Nước Ngâm",270000,270000,0,0
TIKI,phu-kien-thoi-trang,84717065,"Kính Mắt Chống Tia UV Từ Điện Thoại, Máy Tính, Chống Mỏi Mắt Gọng kính chính hãng SARIFA 2438 C01",140000,550000,410000,75
TIKI,phu-kien-thoi-trang,188784985,"Nón kết trơn đen lưới fom Baseball cap brand One Hat",145000,145000,0,0
TIKI,phu-kien-thoi-trang,189674822,"Thun cột tóc, chun cột tóc đen, mix màu tiện lợi sỉ - lẻ",15000,15000,0,0
TIKI,phu-kien-thoi-trang,35129584,"Kính mát phân cực Xiaomi Turok TS SM005",341500,348000,6500,2
TIKI,phu-kien-thoi-trang,174380809,"Mũ lưỡi trai - nón Ulzzang thêu chữ N unisex nam nữ chống nắng phong cách thời trang, cá tính",55000,110000,55000,50
TIKI,phu-kien-thoi-trang,125753652,"Gọng Kính Cận Vuông To Dẻo, Kính Giả Cận Không Độ Đen, Ombre, Xám Trong  - BLUE LIGHT SHOP",185000,185000,0,0
TIKI,phu-kien-thoi-trang,163569492,"[Mới][Hàng cao cấp] Thắt lưng da nam cao cấp EMRENEW POLO- dây nịt da bò 2 lớp -Full hộp đựng cao cấp",475000,950000,475000,50
TIKI,phu-kien-thoi-trang,176150199,"Tất Nam Nữ Cổ Cao 25cm GOMTAT Màu Đen Gân Chìm, Vớ Cổ Cao Chất Liệu Cotton Cao Cấp Êm Mềm Đi Thoáng - FIVE-TAY10-DEN",39000,55000,16000,29
TIKI,phu-kien-thoi-trang,77155693,"Thắt lưng nam mặt khóa da dây lưng da bò nguyên tấm cao cấp cá tính",477000,530000,53000,10
TIKI,phu-kien-thoi-trang,115134722,"Thắt Lưng Nam Vải Dù Mặt Khóa Hợp Kim Thép Đúc Liền Khối A989 US ARMY, Dây lưng lính mỹ -HÀNG CHÍNH HÃNG",85000,179000,94000,53
TIKI,phu-kien-thoi-trang,98329657,"Kẹp light tóc giả xoăn + thẳng nhiều màu hót hít ạ",19500,19500,0,0
TIKI,phu-kien-thoi-trang,142699922,"Dây Quai Đeo Khẩu Trang Tiện Dụng Nhỏ Gọn Chống Rơi Chống Thất Lạc Dây Đeo Mắt Kính gọn nhẹ phong cách Hàn Quốc - QueenS",16000,16000,0,0
TIKI,phu-kien-thoi-trang,197744253,"Kẹp Tóc Thời Trang Mùa Hè Đơn Giản 2022",39900,42000,2100,5
TIKI,phu-kien-thoi-trang,15387332,"Kẹp cài phồng cho tóc mái KAH85",15478,15478,0,0
TIKI,phu-kien-thoi-trang,74442050,"[ TẶNG KÈM LƯỚI VÀ LƯỢC ] Tóc giả nữ nguyên đầu cup ngắn. Tóc giả, tóc ngắn, tóc giả có da đầu, tóc vic",280000,280000,0,0
TIKI,phu-kien-thoi-trang,94098680,"Set 2 Kẹp Cài Phồng Tóc Mái Dạng Tròn, Kẹp Độn Phồng Chân Tóc Hàn Quốc KT24",20000,20000,0,0
TIKI,phu-kien-thoi-trang,146589320,"Cài tóc pha lê kim cương sang trọng - bờm tóc pha lê - quà tặng cho bạn gái",68000,68000,0,0
TIKI,phu-kien-thoi-trang,192781632,"Khăn Lụa Satin 2 lớp Choàng Cổ, Buộc Tóc,Thắt Túi Xách... Màu Sắc Vintage",25500,25500,0,0
TIKI,phu-kien-thoi-trang,46448928,"Kính viễn thị kính lão thị cao cấp chống mỏi mắt khi đeo lâu PKTM_KV12",164000,164000,0,0
TIKI,phu-kien-thoi-trang,138333705,"Thùng 300 Khẩu trang Kf94 DC chống bụi mịn kháng khuẩn cao cấp",300000,300000,0,0
TIKI,phu-kien-thoi-trang,74871645,"Kính lão thị viễn thị hai tròng NHÌN XA VÀ GẦN cực tiện không vành siêu nhẹ gọng GOLD vàng tian cao cấp cực sáng và tiện",219000,219000,0,0
TIKI,phu-kien-thoi-trang,113007808,"Kính Mát,Mắt Kính Unisex ASARIFA RP3025 Nhiều Màu",218500,230000,11500,5
TIKI,phu-kien-thoi-trang,190556259,"Kính mát nam nữ mắt vuông màu đen, nâu DKY6035. Tròng phân cực chống nắng, tia UV. Gọng ôm mặt, không kén size mặt",169000,169000,0,0
TIKI,phu-kien-thoi-trang,102889385,"Tóc giả nữ cột xoăn ngắn, cột tóc giả nữ xoăn ngắn 28cm C016 Sỉ 40k",55000,55000,0,0
TIKI,phu-kien-thoi-trang,167435274,"Thắt lưng nam da bò nguyên chất mặt khóa tự động hợp kim cao cấp",423000,470000,47000,10
TIKI,phu-kien-thoi-trang,51987155,"Kính Mát Nam (Kính Râm) Phân Cực Thời Trang đi ngày và đêm chống chói",175750,185000,9250,5
TIKI,phu-kien-thoi-trang,164430659,"Găng Tay Chống Nắng Đi Phượt Siêu Co Giãn Cho Nam,Nữ -  Fullbox Ngăn Tia UV Bảo Vệ Da - Hàng Loại 1 - Chính Hãng MINIIN",25000,25000,0,0
TIKI,phu-kien-thoi-trang,149394770,"Combo 5 đôi Tất cao cổ cotton công sở nam sang trọng",124000,124000,0,0
TIKI,phu-kien-thoi-trang,49946857,"Kính lão thị nam nữ hai tròng sẵn độ nhìn xa và gần cao cấp màu gold cực sang và đẹp KV972T",266000,266000,0,0
TIKI,phu-kien-thoi-trang,90871395,"Mắt Kính lão Gọng Kim Loại giá rẻ",29000,29000,0,0
TIKI,phu-kien-thoi-trang,120667427,"Hình xăm dán bướm 10x6cm",9000,11000,2000,18
TIKI,phu-kien-thoi-trang,71937080,"[MỘT CẶP] Kính áp tròng cận thị không màu MAXIclear, hạn dùng 3 tháng",135000,135000,0,0
TIKI,dong-ho-va-trang-suc,91474188,"Combo Nhẫn Xoàn, Hợp Nam Nữ Phong Phong cách Châu Âu, chất liệu hợp kim mạ vàng 7.999k, đính đá,  Kèm túi đựng Cung Hỷ",136000,153000,17000,11
TIKI,dong-ho-va-trang-suc,27733472,"Vòng điều hoà huyết áp cải thiện sức khỏe FCM001 - Hàng nhập khẩu",179000,179000,0,0
TIKI,dong-ho-va-trang-suc,45972422,"Đồng hồ nam thời trang cao cấp dây da CFHD DH101",39000,39000,0,0
TIKI,phu-kien-thoi-trang,167409061,"Đai Váy Thời Trang Thắt Lưng Nữ Bản Rộng TL019 MayHomes Dây Nịt Nữ Bản Rộng Dành Cho Đầm Váy",47000,50000,3000,6
TIKI,dong-ho-va-trang-suc,178028585,"DÂY ĐỒNG HỒ DA BÒ THẬT DẬP VÂN CÁ SẤU BỀN ĐẸP (NHIỀU SIZE)",49000,49000,0,0
TIKI,phu-kien-thoi-trang,81986620,"HÌNH XĂM DÁN MINI - SET HÌNH XĂM GIẢ TATOO (được chọn mẫu)",8500,8500,0,0
TIKI,dong-ho-va-trang-suc,46289675,"Bông Tai Nam Châm Đính Đá Màu Titan Không Đen TT 2445 – 1 Cặp",49000,49000,0,0
TIKI,dong-ho-va-trang-suc,74894631,"Đồng hồ thời trang nam nữ G1 mặt số la mã dây da,hiển thị giờ,chạy 3 kim",65000,65000,0,0
TIKI,phu-kien-thoi-trang,171101418,"Mũ lưỡi trai - nón chống nắng thêu chữ Tmi unisex nam nữ phong cách thời trang, cá tính",49500,99000,49500,50
TIKI,dong-ho-va-trang-suc,72095740,"Pin Đồng hồ đeo tay Maxell SR920SW 1.55V 371 vỉ 5 viên",85000,85000,0,0
TIKI,dong-ho-va-trang-suc,25925799,"Đồng hồ thể thao trẻ em skmei 1450",155000,189000,34000,18
TIKI,dong-ho-va-trang-suc,31139636,"Đồng hồ nam dây kim loại Casio Standard chính hãng AE-1200WHD-1AVDF",1084000,1373000,289000,21
TIKI,dong-ho-va-trang-suc,41488128,"Vòng tay đá đá mắt hổ xanh đen mix tỳ hưu bạc hạt đá 12mm mệnh thủy, mộc - Ngọc Quý Gemstones",500000,710000,210000,30
TIKI,dong-ho-va-trang-suc,102142890,"Lắc tay nữ bạc ta MS87",150000,150000,0,0
TIKI,dong-ho-va-trang-suc,55805885,"Dây Đồng Hồ Lưới Thép Không Gỉ Dây MESH Cao Cấp",115000,115000,0,0
TIKI,dong-ho-va-trang-suc,73753269,"Bông tai nữ đen đính đá nhiều lựa chọn hình nơ, sao, tròn, vuông",55000,55000,0,0
TIKI,dong-ho-va-trang-suc,72558678,"DÂY SILICON UAG SCOUT CHO ĐỒNG HỒ APPLE WATCH",623000,623000,0,0
TIKI,dong-ho-va-trang-suc,13794059,"Đồng hồ nam dây nhựa Casio AE-1300WH-8AVDF",900000,1140000,240000,21
TIKI,dong-ho-va-trang-suc,123153692,"Vòng tay Trầm Hương Tây Tạng khắc chữ Om Mani Padme Hum mix trụ trúc bọc vàng 18K - Trầm Tốc Việt Nam tự nhiên, thơm dịu - Thiên Mộc Hương",1701000,1990000,289000,15
TIKI,dong-ho-va-trang-suc,27933202,"Vòng tay phong thủy nữ đá aquamarine charm túi như ý 8mm mệnh thủy , mộc - Ngọc Quý Gemstones",1239000,1770000,531000,30
TIKI,phu-kien-thoi-trang,83419005,"Kẹp đỉnh - kẹp tóc sau - kẹp tóc ngọc trai hình trái cây có lá",32000,32000,0,0
TIKI,dong-ho-va-trang-suc,189896968,"Dụng cụ ép đáy đồng hồ chuyên dụng gồm nhiều khuôn ép chất liệu cao cấp",195000,195000,0,0
TIKI,dong-ho-va-trang-suc,10167751,"Bộ Trang Sức Ngọc Trai Nữ Hoàng - BNT611 - Bảo Ngọc Jewelry (Freesize)",1092500,1150000,57500,5
TIKI,dong-ho-va-trang-suc,82412659,"Dây Đồng Hồ Size 20mm 22mm Khóa Nam Châm Lưới Thép Thép Không Gỉ",68000,68000,0,0
TIKI,dong-ho-va-trang-suc,170846521,"Combo  đồng hồ 3 món , mặt tròn màu trơn trang trí kim cương nhân tạo , phong cách thanh lịch thời trang cho nữ",219000,219000,0,0
TIKI,dong-ho-va-trang-suc,35273142,"Vòng Tay Charm Nữ  HNC001",162000,162000,0,0
TIKI,phu-kien-thoi-trang,193346293,"Kính viễn thị kính lão thị cao cấp NQV08",136080,189000,52920,28
TIKI,dong-ho-va-trang-suc,6714885,"Dây vòng đeo cổ đá cẩm thạch xanh DHG3",140000,140000,0,0
TIKI,phu-kien-thoi-trang,86423621," Light tóc giả móc line cao cấp chịu nhiệt",15000,15000,0,0
TIKI,dong-ho-va-trang-suc,15519526,"Vòng tay phong thủy đá opal mắt mèo hợp mệnh, chiêu tài hút lộc, bình an VTO1",80000,80000,0,0
TIKI,dong-ho-va-trang-suc,45859175,"Dây Chuyền Nữ Đính Đá Cao Cấp Bạc Ý DB2391 Bảo Ngọc Jewelry",412500,412500,0,0
TIKI,dong-ho-va-trang-suc,145167618,"Dây đồng hồ AW lynon cao cấp D127 thoải mái đi trời mưa, dây AW series 3, 4, 5, 6, SE, size 38mm-40mm-42mm-44mm",28000,41000,13000,32
TIKI,dong-ho-va-trang-suc,99099975,"[RẺ VÔ ĐỊCH - Bạc Cao Cấp Cam Kết 100% Bạc Ta] Nhẫn bạc lông voi nhân tạo may mắn cho cặp đôi",64000,64000,0,0
TIKI,dong-ho-va-trang-suc,193577368,"Thìa Bạc Cạo Gió Đánh Gió Đánh Cảm Bạc Nguyên Chất S999 Chữ Phúc BẠC HIỂU MINH XDG12",288000,399000,111000,28
TIKI,dong-ho-va-trang-suc,34676509,"Lắc tay nữ thời trang trái tim xinh xắn LT30",48000,79000,31000,39
TIKI,dong-ho-va-trang-suc,157540121,"Vòng tay liền khối đá cẩm thạch phỉ thúy mệnh hỏa, mộc - Ngọc Quý Gemstones",1999000,2500000,501000,20
TIKI,dong-ho-va-trang-suc,13629677,"Đồng hồ nam dây nhựa Casio W-218H-1AVDF",629250,839000,209750,25
TIKI,dong-ho-va-trang-suc,129436386,"Dây chuyền vòng cổ dây dù đeo cổ cao cấp siêu bền đẹp - Dây dù 5ly",56000,56000,0,0
TIKI,dong-ho-va-trang-suc,89854601,"Vòng cổ dây cao su bọc bạc 2 đốt dài 50cm",126000,126000,0,0
TIKI,dong-ho-va-trang-suc,7663929,"Đồng Hồ Trẻ Em Cho Bé Chống Nước SKMEI 1451 - DHA001",142000,159000,17000,11
TIKI,dong-ho-va-trang-suc,66681107,"Dây da đồng hồ SAM Leather SAM101BW",449000,449000,0,0
TIKI,phu-kien-thoi-trang,114586970,"Mắt kính thời trang chống bụi chữ V gọng nhựa vuông tròn K010 unisex nam nữ style giả cận, phong cách tri thức, lịch sự",22500,45000,22500,50
TIKI,dong-ho-va-trang-suc,107352978,"Dụng cụ thay dây đồng hồ tặng kèm 2 chốt xịn size 16mm 17mm 18mm 19mm 20mm 21mm",10000,10000,0,0
TIKI,phu-kien-thoi-trang,51111665,"Trâm Cài Áo Nữ Quà Tặng Hoa Tulip Đính Đá Trang Nhã Sang Trọng (Kèm Hộp Quà Tặng)",83000,83000,0,0
TIKI,dong-ho-va-trang-suc,196207230,"Dây Ceramic dành cho Huawei Watch GT3 Pro 46mm",400000,400000,0,0
TIKI,dong-ho-va-trang-suc,73656184,"Vòng chuỗi hạt đeo tay phong thủy đá Obsidian phát lộc phát tài dành cho nam nữ - VT0009",85000,85000,0,0
TIKI,dong-ho-va-trang-suc,104559421,"Mặt dây chuyền đồng điếu cẩm thạch huyết mệnh hỏa, thổ - Ngọc Qúy Gemstones",459000,900000,441000,49
TIKI,dong-ho-va-trang-suc,15421345,"Nhẫn xoay Bát Nhã Tâm Kinh khắc chữ Vạn - Nhẫn phong thủy Hán ngữ may mắn bình an Ri99",46000,46000,0,0
TIKI,ngon,103955037,"[Chỉ Giao HN] Thanh long trắng - 1KG",29000,29000,0,0
TIKI,ngon,172171417,"Thạch nha đam tươi Đại Lộc ",51000,51000,0,0
TIKI,ngon,122224120,"Chôm Chôm  Kg",50000,50000,0,0
TIKI,ngon,118288047,"[Chỉ giao HN] - Cá Saba Nhật Nguyên Con - Túi 2 Con",139000,139000,0,0
TIKI,ngon,193888892,"Đặc Sản Nha Trang - Cá Chỉ Vàng Rim Sốt Chanh Seavy Hộp 200G",82000,85000,3000,4
TIKI,ngon,172161477,"Bánh mì gối đen Fresh Garden ",44000,44000,0,0
TIKI,ngon,121678003,"[Chỉ Giao HN] Táo Envy 70 (1.2kg - 1.6kg)",199000,199000,0,0
TIKI,ngon,154492605,"Nho sữa Hàn Quốc - 1KG",1100000,1100000,0,0
TIKI,ngon,184634192,"Gà ác tươi tiềm thuốc bắc",51000,51000,0,0
TIKI,ngon,97691546,"[[Chỉ Giao HN]] - Cua hoàng đế tươi sống",6125000,6125000,0,0
TIKI,ngon,179711666,"[Chỉ giao HN]  - Túi mix 03 loại hạt cao cấp 4 (óc chó, hạnh nhân, hạt điều) - 500gr",235000,235000,0,0
TIKI,ngon,179711746,"[Chỉ giao HN]  - Túi mix 02 loại hạt cao cấp 6 (hạt điều, hạnh nhân)- 500gr",210000,210000,0,0
TIKI,ngon,160635047,"[ Chỉ giao HN] - COMBO NGUYÊN LIỆU LÀM GRANOLA",610000,610000,0,0
TIKI,ngon,116553113,"[Chỉ giao HN] - Đuôi Bò Thơm Ngon Đã Làm Sạch - 1Kg",400000,400000,0,0
TIKI,ngon,191429045,"Gà ủ muối nguyên con Thanh Thanh Food ",300000,300000,0,0
TIKI,ngon,125452839,"Khâu nhục Tiên Yên - 1 hộp",150000,150000,0,0
TIKI,ngon,184634200,"3G_Chả lá lốt (Thịt heo) 300g",54000,54000,0,0
TIKI,ngon,172300001,"Trà gừng Cozy ",51000,51000,0,0
TIKI,ngon,128707153,"[Chỉ giao HN] Thịt bò Wagyu Full Blood 2GR Úc MB9+ - Dẻ sườn rút xương - 1KG",2290000,2290000,0,0
TIKI,ngon,149354838,"[Chỉ giao HN] - Lườn Ngỗng Xông Khói - Món Ngon Từ Nga",99000,99000,0,0
TIKI,ngon,121441567,"[Chỉ Giao HN] Bưởi da xanh Bến Tre (1.4-1.5kg/quả)",99000,99000,0,0
TIKI,ngon,177714078,"PHÔ MAI MOZZARELLA 100gr (CHỈ GIAO TẠI SÀI GÒN)",29000,29000,0,0
TIKI,ngon,157856328,"[ Chỉ giao HN] - Bánh Chưng Nương Bắc Cẩm thịt 800gram",190000,190000,0,0
TIKI,ngon,144934483,"[ Chỉ giao HN] - Ngọc kê gà Đông Tảo -1kg",1300000,1300000,0,0
TIKI,ngon,173337615,"[Chỉ giao HN] - Chả Cốm Hà Nội - 500g",169000,169000,0,0
TIKI,ngon,186279132,"Phô mai que rong biển Đôi Đũa Vàng 300g thơm ngon bổ dưỡng",249000,249000,0,0
TIKI,ngon,117139104,"Sốt nướng Steak TRF - 200ml",12000,12000,0,0
TIKI,ngon,127509744,"[Chỉ giao HN] Thăn vai bò Mỹ Steak 150gr",152900,152900,0,0
TIKI,ngon,171833886,"[ Chỉ giao HN] -Snack sấy khô Tim gà 100gr",70000,70000,0,0
TIKI,ngon,164428758,"[ Chỉ giao HN] - Miến ngan ăn liền - 95g",16000,16000,0,0
TIKI,ngon,109088607,"[CHỈ GIAO HN] - TÔM LỚT BÓC NÕN VITOT FOOD (500g/khay)",269000,269000,0,0
TIKI,ngon,147923382,"[Chỉ giao HN] - Bộ Tràng Trứng Tim Gà Ngon - 500g",139000,139000,0,0
TIKI,ngon,121662138,"[Chỉ Giao HN] Nho xanh Mỹ - 1kg",250000,250000,0,0
TIKI,ngon,185657616,"Tôm sú nguyên con size 20 - 500g",190000,190000,0,0
TIKI,ngon,172814844,"[Chỉ giao HN] - Chả Ốc - 500g",138000,138000,0,0
TIKI,ngon,118896401,"[Chỉ giao HN] Kem hộp vị Rum Nho - Rum Grapes",199000,199000,0,0
TIKI,ngon,116553117,"[Chỉ giao HN] - Trứng Gà Non Nguyên Chùm - Túi 1Kg Hút Chân Không",289000,289000,0,0
TIKI,ngon,117571828,"[Chỉ giao HN] - Vụn Cá Hồi Bao Xanh Xuất Nhật - 1Kg 2 Túi Hút Chân Không",399000,399000,0,0
TIKI,ngon,120264065,"[Chỉ giao HN] - Set Xôi Chiên Phồng - 3 Thanh",199000,199000,0,0
TIKI,ngon,184634191,"Gà ta Chí Linh",170000,170000,0,0
TIKI,phu-kien-thoi-trang,21948460,"Combo 2 Bờm Tóc Ngọc Trai Nhân Tạo Đính Đá Sang Chảnh",28500,30000,1500,5
TIKI,phu-kien-thoi-trang,9436980,"Cà Vạt Nam Titishop CA42 (140 x 5.5 cm)",85000,85000,0,0
TIKI,phu-kien-thoi-trang,27416674,"Kính Mát Đi Đường Chống Bụi - Chống Ánh Sáng Đèn Ban Đêm - Màu Ngẫu Nhiên",15000,30000,15000,50
TIKI,phu-kien-thoi-trang,86166073," BỘ CHE HÓI LỬNG NHIỀU MÀU CÓ MÁI",129000,129000,0,0
TIKI,phu-kien-thoi-trang,73100307,"ĐẦU GIẢ (ĐẦU KEN) TÓC GIẢ",180000,180000,0,0
TIKI,phu-kien-thoi-trang,75797470,"Kẹp tóc sau - Kẹp tóc hoa tím ",68000,68000,0,0
TIKI,phu-kien-thoi-trang,99514328,"Tất trơn cao nhiều màu cho nam nữ vintage",13000,13000,0,0
TIKI,phu-kien-thoi-trang,114671394,"Hộp Đựng Gọng Kính/Kính Mát To Bằng Vải Đen ",29900,29900,0,0
TIKI,phu-kien-thoi-trang,43821125,"THẮT LƯNG NỮ SQUARE , DÂY NỊT NỮ  DN1912235",83600,88000,4400,5
TIKI,phu-kien-thoi-trang,86168503," LƯỚI TRÙM ĐỘI TÓC GIẢ",6900,6900,0,0
TIKI,phu-kien-thoi-trang,101469097,"Kính lão gọng xếp inox màu xanh dương - Mắt kính lão thị phù hợp cho nam và nữ",314000,314000,0,0
TIKI,phu-kien-thoi-trang,56266825,"Kẹp tóc đính đá hoa 5 cánh",190000,190000,0,0
TIKI,phu-kien-thoi-trang,98084531," BUCKET 2 MẶT THÊU TIK TOK NAM NỮ",37900,37900,0,0
TIKI,phu-kien-thoi-trang,167136208,"Hộp 5 đôi tất giày tây cổ cao Gom Tất chất liệu cotton cao cấp hút ẩm thoáng khí - TATGIAYTAY01-CB5",129000,245000,116000,47
TIKI,phu-kien-thoi-trang,138283699,"Kẹp tóc, Kẹp gấp, Kẹp càng cua bản vuông nhiều màu kẹo ngọt xinh xắn hot trend - phong cách Hàn Quốc",19000,19000,0,0
TIKI,phu-kien-thoi-trang,130437248,"Bộ mũ len kèm khăn cổ nam nữ",45000,45000,0,0
TIKI,phu-kien-thoi-trang,116391854,"Chun vòng gói 500g buộc tiền cỡ to/nhỡ/nhỏ",79000,79000,0,0
TIKI,phu-kien-thoi-trang,124247737,"Gọng kính GM Southside Tròng 0 độ, có độ",57000,61000,4000,7
TIKI,phu-kien-thoi-trang,139450163,"Dây lưng Nam Tushi vải dù_khóa tự động sang trọng_tiện lợi, Dây lưng lính_Vải bố_siêu bền đẹp",139000,139000,0,0
TIKI,phu-kien-thoi-trang,161952529,"Gọng Kính Cận, Kính Giả Cận GM V Dáng Vuông Nhỏ Hàn Quốc - BLUE LIGHT",185000,185000,0,0
TIKI,phu-kien-thoi-trang,126933626,"Set 2 Miếng dán tóc Hàn Quốc tự dính - Cố định tóc tiện lợi khi trang điểm và rửa mặt( màu ngẫu nhiên )",13000,15000,2000,13
TIKI,phu-kien-thoi-trang,71760294,"Kính lão thị viễn thị trung niên nam nữ sẵn độ màu bạc sáng cực sang toàn viền kiểu dáng nam tính",219000,219000,0,0
TIKI,phu-kien-thoi-trang,96356718,"Thắt lưng/ dây nịt  vải nam cao cấp  thiết kế năng động , trẻ trung - mã AWMN",179000,299000,120000,40
TIKI,phu-kien-thoi-trang,175534129,"Nón bảo hiểm hợp thời trang nam nữ sơn đẹp nửa đầu hàng chất lượng tốt_rubik",55250,65000,9750,15
TIKI,phu-kien-thoi-trang,95294764,"Thắt Lưng Chun Golf",414000,414000,0,0
TIKI,phu-kien-thoi-trang,85752995,"Mẫu Đầu Khóa Thắt Lưng - Mặt Thắt Lưng Đẹp D&D Fashion",50000,100000,50000,50
TIKI,phu-kien-thoi-trang,94894067,"Nón rộng vành nữ Mũ rộng vành nữ đi biển DONA21042804",151000,159000,8000,5
TIKI,phu-kien-thoi-trang,51696671,"9 khẩu trang vải k2",63000,63000,0,0
TIKI,phu-kien-thoi-trang,196703834,"(SIÊU BỀN ĐẸP) Dây Thắt Lưng Nam Cao Cấp, Vải Canvas, Khóa Tự Động Đơn Giản, Tiện Lợi_Dây Nịt Nam Vải Bố_Phong Cách Trẻ Trung, Nam Tính, Dễ Phối Đồ_Nhiều Màu",225000,225000,0,0
TIKI,phu-kien-thoi-trang,44350707,"Bộ 2 quần tất nữ mỏng chất dai ",25000,25000,0,0
TIKI,phu-kien-thoi-trang,106707707,"Tất vớ nam dài cao cấp chất liệu cotton len cao cấp quả trám",45000,80000,35000,44
TIKI,phu-kien-thoi-trang,108151468,"kẹp tóc càng cua nhựa dài phong cách Hàn Quốc",25000,28000,3000,11
TIKI,phu-kien-thoi-trang,96036228,"Găng tay, bao tay cụt ngón có gù bảo vệ lái xe du lịch phượt Sport",45000,45000,0,0
TIKI,phu-kien-thoi-trang,194088336,"[TIKTOK TATTOO] Hình xăm không trôi chủ đề bướm hoa, 6 hình, chống nước 15 ngày, xăm ma thuật, Xăm giống Inkaholic",32000,32000,0,0
TIKI,phu-kien-thoi-trang,4167985,"Bờm cài tóc turban nữ bản to BN21B phối kẻ xanh vàng",25000,25000,0,0
TIKI,phu-kien-thoi-trang,52226818,"Gọng Kính Cận Kính Giả Cận Nam Nữ Không Độ V Mắt Vuông To Viền Dày",88350,93000,4650,5
TIKI,phu-kien-thoi-trang,47272522,"Cài áo và khăn đính hạt các loại - Đính đá tròn GC27-Y44 dài 3.5cm",36000,36000,0,0
TIKI,phu-kien-thoi-trang,71044039,"Tất lưới cơ bản kết hợp váy ngủ vớ lưới sexy",25000,25000,0,0
TIKI,phu-kien-thoi-trang,28324257,"Cặp Kính Áp Tròng Dùng 1 Ngày Eye Secret KM1N - Nagoya Brown",60000,70000,10000,14
TIKI,phu-kien-thoi-trang,192962168,"Hình xăm cuốn cánh tay, quấn cổ tay, con sói, hoạ tiết bộ lạc, Xăm giống Inkaholic",32000,32000,0,0
TIKI,ngon,107375650,"[CHỈ GIAO HN] - VITOT FOOD CÁ NGẦN SÔNG ĐÀ (500g/ khay)",199000,199000,0,0
TIKI,ngon,128124530,"Bề bề nõn đại - 1 khay",190000,190000,0,0
TIKI,ngon,188946836,"Xôi chiên phồng lá dứa Đôi Đũa Vàng 500g thơm ngậy ",107000,107000,0,0
TIKI,ngon,155495745,"[Chỉ giao HN]Gạo Tám Thái đỏ -10kg",200000,200000,0,0
TIKI,ngon,196318917,"Lúc lắc lõi vai bò canada-500g",145000,145000,0,0
TIKI,ngon,191426351,"Hành tây",22000,22000,0,0
TIKI,ngon,118508425,"[Chỉ giao HN] - Nem Bùi Bắc Ninh",189000,189000,0,0
TIKI,ngon,193911517,"Bò  gác bếp Lào Cai -  Ninh Sớp Hộp 500gr",650000,650000,0,0
TIKI,ngon,180322238,"Nước mắm Tĩn nhãn đỏ độ đạm 40N chai thủy tinh 500ml rin nguyên chất truyền thống sạch",190000,190000,0,0
TIKI,ngon,173633785,"Bơ mặn President 200g",106000,106000,0,0
TIKI,ngon,184790621,"Sườn cánh buồm - 1kg",100000,100000,0,0
TIKI,ngon,126962636,"[ Chỉ giao HN] -Nấm hương xiên 200g",78000,78000,0,0
TIKI,ngon,120480686,"[Chỉ Giao Hà Nội] Ba chỉ heo Nga - 1kg",129000,129000,0,0
TIKI,ngon,189268347,"Cá hồi cắt khúc Đôi Đũa Vàng tươi sạch dinh dưỡng 240g",332000,332000,0,0
TIKI,ngon,126962661,"[ Chỉ giao HN] -Chanh vàng 1kg",150000,150000,0,0
TIKI,ngon,191502063,"Xịt thơm quần áo hương hoa trà chai 380ml - Hàng Nhật nội địa",55000,55000,0,0
TIKI,ngon,120480680,"[Chỉ Giao Hà Nội] Cánh gà Brazil - 1kg",107000,107000,0,0
TIKI,ngon,180322147,"Thùng 6 chai nước mắm nhỉ 40 độ đạm Làng Chài Xưa chai thủy tinh 500ml ủ chượp 2 lần không chất bảo quản",720000,720000,0,0
TIKI,ngon,125897202,"Hà Nội - Bơ sáp 1kg",90000,90000,0,0
TIKI,ngon,184634215,"3G-Bò sốt vang khay 500g",156000,156000,0,0
TIKI,ngon,156937372,"[ Chỉ giao HN] - Nấm đùi gà - 1kg",150000,150000,0,0
TIKI,ngon,171833858,"[ Chỉ giao HN] - Pate Chín Cá Yến mạch 450gr",40000,40000,0,0
TIKI,ngon,196175810,"Phù trúc (váng đậu khô, tàu hũ ky) loại đặc biệt gói 1 kg",145000,145000,0,0
TIKI,ngon,114873768,"[Chỉ Giao HN] THỊT BA CHỈ HEO LỢN LIÊN BANG NGA [Thượng hạng] - 1kg",150000,150000,0,0
TIKI,ngon,190842065,"Cà chua bi",30000,30000,0,0
TIKI,ngon,171833828,"[ Chỉ giao HN] -Raw Food Gà dừa hạt chia 250gr",35000,35000,0,0
TIKI,ngon,180322248,"Nước Mắm Tĩn Nhãn Đỏ Độ Đạm 40N Cặp 2 Chai Thủy Tinh 500ml/chai Rin Nguyên Chất Truyền Thống Sạch Không Chất Bảo Quản",350000,350000,0,0
TIKI,ngon,189365488,"Cá trứng nhập khẩu Đôi Đũa Vàng béo bùi thơm ngậy 400g",199000,199000,0,0
TIKI,ngon,91247762,"[Chỉ Giao HN] - Nho Đen Mooi",149500,149500,0,0
TIKI,ngon,116553129,"[Chỉ giao HN] - Râu Bạch Tuộc - 1Kg",239000,239000,0,0
TIKI,ngon,166057712,"Sữa tắm SOS 530ml cho chó mèo - Nâu",78888,78888,0,0
TIKI,ngon,180322251,"Combo 2 Chai Nước Mắm Tĩn cá cơm than Nhãn Đỏ Mini 40N 60ml/chai Rin Nguyên Chất Truyền Thống",70000,70000,0,0
TIKI,ngon,112257310,"Iberico Pluma (Thịt thăn lưng iberico) - Khay 300g",405000,450000,45000,10
TIKI,ngon,119308612,"[Chỉ Giao Hà Nội] Thăn lợn hun khói 300g",90000,90000,0,0
TIKI,ngon,155495755,"[Chỉ giao HN] Đậu cove- 500gr",10000,10000,0,0
TIKI,ngon,191296699,"Dưa chuột",14000,14000,0,0
TIKI,ngon,120480675,"[Chỉ Giao Hà Nội] Nạc đùi heo - 1kg",119000,119000,0,0
TIKI,ngon,180322272,"Nước Mắm Tĩn cá cơm than Nhãn Đỏ Độ Đạm 40N Thùng 6 Chai Thủy Tinh 500ml/chai",990000,990000,0,0
TIKI,ngon,195856310,"Dứa chín 1 quả",14000,14000,0,0
TIKI,ngon,170179345,"Thức ăn cho mèo con và mèo trưởng thành Royal Canin Pháp Hộp 1kg - RC Dry Mix Feeding",225000,225000,0,0
TIKI,phu-kien-thoi-trang,183910786,"Thắt Lưng Nữ Bản To Thời Trang Âu Mỹ Cá Tính TL021 MayHomes Dây Lưng Nữ Thời Trang, Dây Nịt Nữ Da PU Khóa Kim Loại Bền Chắc Đa Năng Dùng Cho Jeans, Quần Âu Và Shorts",82720,88000,5280,6
TIKI,phu-kien-thoi-trang,177163499,"Gọng kính chính hãng A.SARIFA TR90636",199000,520000,321000,62
TIKI,phu-kien-thoi-trang,192302327,"30 cái Khẩu trang y tế 4D Khánh An KA99 ngăn vi khuẩn 99% công nghệ Hàn Quốc KF94 ôm sát khuôn mặt không dính son và dễ thở",54400,68000,13600,20
TIKI,phu-kien-thoi-trang,108892943,"Vớ thể thao Unisex New Balance - LAS82221GRY",117000,195000,78000,40
TIKI,phu-kien-thoi-trang,163717090,"Gọng Kính Cận, Kính Giả Cận Mắt Oval Tròn Ombre, Đen, Gọng Nhựa Cao Cấp - B LUE LIGHT",185000,185000,0,0
TIKI,phu-kien-thoi-trang,13442067,"Găng Tay Chống Nắng Xỏ Ngón - Màu ngẫu nhiên",5000,22000,17000,77
TIKI,phu-kien-thoi-trang,194083868,"Kẹp tóc nữ UYU NASI [Set 5 cái] chất liệu acrylic dễ thương bền đẹp phong cách hàn quốc nhiều màu phụ kiện tóc giao ngẫu nhiên",19000,19000,0,0
TIKI,phu-kien-thoi-trang,86168061," SET 140 SỢI KIM TUYẾN GẮN TÓC SIÊU RẺ",16900,16900,0,0
TIKI,phu-kien-thoi-trang,130437363,"Tất, vớ chia ngón (tất xỏ ngón)",15000,15000,0,0
TIKI,phu-kien-thoi-trang,109902957,"Kẹp tóc dạng dọc - Kẹp đứng me vân ánh xà cừ cao cấp thân kẹp trong",45000,45000,0,0
TIKI,phu-kien-thoi-trang,41883013,"Mũ nón len nữ đẹp dn19111703",128000,135000,7000,5
TIKI,phu-kien-thoi-trang,146214781,"[VIDEO]-Khăn lụa quàng cổ 90x90 cm, khăn lụa dài, khăn choàng lụa, khăn choàng dáng dài cao cấp, khăn mùa đông cho nữ-CHỌN MẪU",119000,119000,0,0
TIKI,phu-kien-thoi-trang,196596369,"Dây buộc tóc nữ mèo thần tài [Set 4 dây] may mắn và tài lộc NASI dễ thương phong cách hàn quốc thun cột tóc nữ co giãn tốt phụ kiện tóc",12000,12000,0,0
TIKI,phu-kien-thoi-trang,172457690,"GĂNG TAY BAO TAY CHỐNG NẮNG NAM 1 Lớp có đệm bông Cụt 5 ngón Chất liệu vải màu đen Amaha",28000,28000,0,0
TIKI,phu-kien-thoi-trang,12022696,"Bờm cài tóc nam nữ bằng sắt siêu bền bản to BV57",22000,22000,0,0
TIKI,phu-kien-thoi-trang,196377820,"Gọng Kính Cận, Kính Giả Cận Nam Nữ, Chrome Heart Mắt Tròn Gọng Titanium Cao Cấp, Chống Ánh Sáng Xanh - BLUE LIGHT",485000,485000,0,0
TIKI,phu-kien-thoi-trang,132074478,"Dung Dịch Ngâm Kính Eye Secret DD120 (120ml)",60000,75000,15000,20
TIKI,phu-kien-thoi-trang,73685156,"Mũ len trùm đầu phong cách Hip Hop NL17, Nón len trơn màu phong cách Hàn Quốc dành cho cả nam và nữ Màu Đen",65000,65000,0,0
TIKI,phu-kien-thoi-trang,192933671,"Đai váy - nịt đầm bản to bản 7,5cm H27",60000,60000,0,0
TIKI,phu-kien-thoi-trang,125927919,"Băng đô cài tóc nhựa xếp gọn bỏ túi du lịch tiện lợi, phụ kiện tóc nữ CT019 - Filibra style",27000,27000,0,0
TIKI,phu-kien-thoi-trang,98329875," Kẹp búi tóc giả thời trang HÀN QUỐC - KẸP TÓC GIẢ",104000,104000,0,0
TIKI,phu-kien-thoi-trang,140613723,"Vớ lolita cô gái nhật bản vớ ren hàn quốc retro VT01",45600,48000,2400,5
TIKI,phu-kien-thoi-trang,100853764,"Nón Tai Bèo Chữ Nhật - Nón Bo - Nón Bucket",33000,33000,0,0
TIKI,phu-kien-thoi-trang,173479737,"Ví da đựng kính mát, kính cận nhiều màu sắc (giao màu ngẫu nhiên)",56000,60000,4000,7
TIKI,phu-kien-thoi-trang,52581113,"Tóc kẹp V thẳng dài 45cm FREESHIP kẹp tóc giả, tóc giả kẹp dải, kẹp U tóc giả",69000,69000,0,0
TIKI,phu-kien-thoi-trang,73771037,"Combo 10 đôi tất da chân nữ loại ngắn loại tốt, mỏng mát, dai khó rách v",49000,49000,0,0
TIKI,phu-kien-thoi-trang,190558080,"Kính Râm Kính Mát Nam Nữ Mắt Phẳng Vuông To Hàn Quốc, Chống Tia UV, Đen, Nâu, Vàng - BLUE LIGHT",185000,185000,0,0
TIKI,phu-kien-thoi-trang,40811103,"nón beret nữ, mũ beret nữ thời trang mới dn19110704",115000,115000,0,0
TIKI,phu-kien-thoi-trang,101980480,"Bờm cài tóc đuôi dài pha lê headband giả bông tai dễ thương (màu ngẫu nhiên )",59000,59000,0,0
TIKI,phu-kien-thoi-trang,120525075,"Dây nịt nam da đà điểu Huy Hoàng đan viền màu nâu đỏ HC4468",1199000,1199000,0,0
TIKI,phu-kien-thoi-trang,171045878,"Tất vớ trơn cổ ngắn, cổ trung, cổ cao, dùng cho Nam Nữ, thời trang Unisex style Hàn Quốc - LISU",7900,15000,7100,47
TIKI,phu-kien-thoi-trang,4210027,"Mắt kính phân cực thể thao 8177",181000,199000,18000,9
TIKI,phu-kien-thoi-trang,113572650,"Mũ bucket nam nữ nón tai bèo vành tròn vải thoáng khí",33000,33000,0,0
TIKI,phu-kien-thoi-trang,178957929,"Khẩu trang che cổ nam nữ chống nắng có tai đeo chống tuột WOSAWE W9 - Vải thoáng khí, cực mát, tản nhiệt nhanh",69000,69000,0,0
TIKI,phu-kien-thoi-trang,84648445,"Khẩu Trang Cao cấp Nhật Bản Kháng Khuẩn, Chống Nắng, Chống Tia UV",45000,45000,0,0
TIKI,phu-kien-thoi-trang,191147088,"Set Ghim Trâm Cài Áo Ngọc Trai 2 Đầu KUNBE, Kiểu Dáng Mới Thiết Kế Sang Trọng Phong Cách Thời Trang",43000,43000,0,0
TIKI,phu-kien-thoi-trang,208044637,"mũ len 3 lỗ trùm mặt CSGO có lót nỉ",67000,67000,0,0
TIKI,phu-kien-thoi-trang,86166322,"  LINE TÓC GIẢ BẢNG 24 MÀU GIÁ RẺ",4000,4000,0,0
TIKI,phu-kien-thoi-trang,44572657,"Quần tất chống xước Regart 20D nội địa Nhật Bản",109000,159000,50000,31
TIKI,phu-kien-thoi-trang,138283663,"Cột tóc nơ phối châu xinh xắn cho nữ, style Hàn Quốc",45000,45000,0,0
TIKI,dong-ho-va-trang-suc,106393508,"Khoá đồng hồ dây da inox đủ size màu vàng giá rẻ nhất thị trường",18000,18000,0,0
TIKI,dong-ho-va-trang-suc,35450693,"Nhẫn Nam Chú Đại Bi Titan Không Đen TT 1425",98999,98999,0,0
TIKI,dong-ho-va-trang-suc,159008604,"[1 Hạt] 9MM Đá Thạch Anh Dâu Tây Hồng ,Strawberry Quartz Tự Nhiên Loại AAA, Phối Vòng Tay Phong Thuỷ, Đá Phong Thuỷ, Chuỗi Hạt, Mệnh Hoả, Thổ - Bead Art",99600,99600,0,0
TIKI,dong-ho-va-trang-suc,11892302,"Vòng Cổ Dây Chuyền Mặt Hoa Ren Nhiều Màu Ép Thủy Tinh Resin",19000,19000,0,0
TIKI,dong-ho-va-trang-suc,51011088," Khuyên Tai Nam Dây Xích Dài Hình Chiếc Lá",43000,43000,0,0
TIKI,dong-ho-va-trang-suc,3973363,"Combo 4 Vòng Đeo Tay Chân Chỉ Đỏ Phong Cách Cho Nam Nữ (Free Size)",18000,18000,0,0
TIKI,dong-ho-va-trang-suc,26503356,"Vòng tay thắt dây đá cẩm thạch mệnh hỏa , mộc - Ngọc Quý Gemstones",299000,586000,287000,49
TIKI,dong-ho-va-trang-suc,48038524,"Vòng chỉ đỏ Tây Tạng may mắn (CD55)",19000,19000,0,0
TIKI,dong-ho-va-trang-suc,163940818,"[1 Hạt] 9MM Đá Mặt Trăng, Moonstone Tự Nhiên Ánh Cầu Vồng Loại A, Vòng Tay Phong Thuỷ, Chuỗi Hạt, Mệnh Kim, Thuỷ - Bead Art",140000,140000,0,0
TIKI,dong-ho-va-trang-suc,56113733,"Combo 2 cái charm bạc hình mặt cú mèo treo - Ngọc Quý Gemstones",118000,200000,82000,41
TIKI,dong-ho-va-trang-suc,56611852,"Combo 2 cái charm bạc chặn hình đồng tiền - Ngọc Quý Gemstones",178000,300000,122000,41
TIKI,dong-ho-va-trang-suc,204231178,"Vòng tay chuỗi tràng 108 hạt phong thủy trầm hương HÀ XÁ vòng đeo tay nam nữ may mắn tài lộc",199000,398000,199000,50
TIKI,dong-ho-va-trang-suc,176072893,"Dây Milanese thép dây Huawei GT3 42 mm/ GT3 46mm",90000,90000,0,0
TIKI,dong-ho-va-trang-suc,160419252,"Pin Đồng Hồ Maxell AG0 SR521SW 379 1.55V Nhật Bản",65000,65000,0,0
TIKI,dong-ho-va-trang-suc,44866428,"Bông Tai Nam Khoen Hình Tam Giác Titan Không Đen TT 2425 - 1 Cặp",52000,52000,0,0
TIKI,dong-ho-va-trang-suc,57419406,"VÒNG TAY HUYẾT ÁP  NHẬT BẢN-HÀNG NHẬP KHẨU",498998,498998,0,0
TIKI,dong-ho-va-trang-suc,48116808,"Vòng tay gốm thời trang Vintage 3 dây VGOM23 (Giao mầu ngẫu nhiên)",19000,19000,0,0
TIKI,dong-ho-va-trang-suc,106391999,"Đầu đột mắt dây đồng hồ - đầu đột thay cắt mắt dây đồng hồ",7000,7000,0,0
TIKI,dong-ho-va-trang-suc,49651098,"Lắc chân kiêm lắc tay ngôi sao rỗng",38000,38000,0,0
TIKI,dong-ho-va-trang-suc,81314457,"Đồng hồ nam cao cấp ECONOMICXI chính hãng dây thép lưới đen có lịch ngày - Đẳng Cấp Phái Mạnh ECNS89",278000,278000,0,0
TIKI,dong-ho-va-trang-suc,58261800,"Vòng cổ thời trang phối sắc đỏ cá tính VN34",182000,182000,0,0
TIKI,dong-ho-va-trang-suc,73572649,"Dây chuyền đá thạch anh ưu linh trắng hạt 1cm mệnh thủy , kim - Ngọc Quý Gemstones",339000,660000,321000,49
TIKI,dong-ho-va-trang-suc,74744560," Nhẫn bạc nữ đá thạch anh tím mệnh hỏa. thổ - Ngọc Quý Gemstones",500000,710000,210000,30
TIKI,dong-ho-va-trang-suc,56830496,"Combo 3 cái charm bạc hình bàn tay hamsa treo - Ngọc Quý Gemstones",157000,180000,23000,13
TIKI,dong-ho-va-trang-suc,127371586,"Nước rửa trang sức bạc PDJ - Trang sức PDJ - SP000415 - dung tích 50ml",20000,20000,0,0
TIKI,dong-ho-va-trang-suc,175213936,"Bông tai dài đính ngọc trai giả thời trang cho nữ",76000,80000,4000,5
TIKI,dong-ho-va-trang-suc,58098394,"Nhẫn Nam Khui Bia Tiện Dụng, Được Làm Bằng Thép Không Gỉ, Chắc Chắn, Cứng, Mịn Êm Tay VNS-KBIA69",8000,9000,1000,11
TIKI,dong-ho-va-trang-suc,78282312,"[ SAM Leather ] Dây Đồng Hồ Da Bò - Dây Đeo Đồng Hồ SAM002NW - Dây Da Bò Size 26/24/22/20mm  Có Nhiều Màu Sắc Lựa Chọn Phù hợp Cho Các Loại Đồng Hồ",289000,289000,0,0
TIKI,dong-ho-va-trang-suc,143829162,"Dây đồng hồ da bò Bụi Leather D101- Da thật khâu tay thủ công cao cấp - Bảo hành 12 tháng",185000,284000,99000,35
TIKI,dong-ho-va-trang-suc,111039158,"Nhẫn inox bản mo tròn 4mm đẹp, khồng đen, hợp thời trang - Tặng hộp đựng xinh xắn (01 chiếc)",19000,19000,0,0
TIKI,dong-ho-va-trang-suc,106390688,"Dây Đồng Hồ Vải Dù Zulu Nato size 18mm 20mm",63700,63700,0,0
TIKI,dong-ho-va-trang-suc,103134752,"dây da đồng hồ apple watch handmade cao cấp",549000,549000,0,0
TIKI,dong-ho-va-trang-suc,169577869,"Đồng hồ nam DEYROS thiết kế thể thao dây thép lưới đen chạy lịch ngày cao cấp Sporty Design",278000,278000,0,0
TIKI,dong-ho-va-trang-suc,70020000,"Đồng hồ trẻ em Silicon nhiều màu, đồng hồ điện tử thông minh cho bé E132",22000,22000,0,0
TIKI,dong-ho-va-trang-suc,111035219,"Dây chuyền inox nam kiểu bông dừa khít 4mm đẹp, không đen, không gỉ, chuẩn thời trang",59000,59000,0,0
TIKI,dong-ho-va-trang-suc,74234330,"Đồng Hồ Nam OLEVS-2871 Phong Cách Doanh Nhân - Lịch Trăng Sao - Chạy Đủ 6 Kim - Hàng Chính Hãng",790000,790000,0,0
TIKI,dong-ho-va-trang-suc,204212145,"Vòng tay tròn đơn phong thủy trầm hương HÀ XÁ đeo tay nam nữ may mắn tài lộc",99000,198000,99000,50
TIKI,dong-ho-va-trang-suc,122310530,"Vòng tay Trầm Hương tự nhiên Bảo Mệnh Trầm - Bình yên, hạnh phúc - Trầm Tốc Việt Nam -Thiên Mộc Hương",813000,990000,177000,18
TIKI,dong-ho-va-trang-suc,55139324,"Lắc Tay Nữ | Lắc Tay Nữ Bạc S925 Thanh Tú Đơn Giản L2536 - Bảo Ngọc Jewelry",200000,200000,0,0
TIKI,dong-ho-va-trang-suc,54815750,"Vòng Tay Trầm Hương 108 Hạt Từ Trầm Tốc Lào Tự Nhiên",199000,199000,0,0
TIKI,phu-kien-thoi-trang,169686025,"Mũ Tàu Siêu Bền Lòng Xanh, lòng vàng - 80kg Đứng Ngồi Lên Mũ Thoải Mái - Cách nhiệt, cách nước",98000,98000,0,0
TIKI,phu-kien-thoi-trang,148811117,"Thắt Lưng Nam Vải Dù U104 US ARMY cao cấp Phong Cách Lính Mỹ, Mặt Khóa Tăng Tự Động Chất Liệu Thép Không Gỉ, Dây Vải Dù Nhiều Màu Dây  lựa chọn- HÀNG CHÍNH HÃNG",85000,178000,93000,52
TIKI,phu-kien-thoi-trang,52580540,"Tóc giả búi cột xoăn kiểu Hàn siêu xinh, Chất tơ Cao cấp có thể dùng nhiệt bấm, uốn, duỗi, gội thoải mái, cam kết y hình, giống tóc thật 100%. mẫu này rất tiện lợi và dễ sử dụng ạ",70000,70000,0,0
TIKI,phu-kien-thoi-trang,26077813,"Mũ nón nồi nữ thời trang phong cách KPOP",96000,96000,0,0
TIKI,phu-kien-thoi-trang,181692627,"Nước ngâm lens Angel Eyes Aqua B5 dung tích 150ml và 360ml",50000,50000,0,0
TIKI,phu-kien-thoi-trang,75355377,"Mũ Nam Nón Nam Nón Kết Sơn Sò Lốc Xoáy Mũ Nam Nữ Vải Dù Chất Liệu Cao Cấp Nhiều Màu Model T0110 UY TÍN VÀ ĐẸP NHẤT TẠI H3L SHOP",69000,69000,0,0
TIKI,phu-kien-thoi-trang,129427364,"Quần tất nữ Hàn Quốc tàng hình siêu dai và mỏng, mặc thu đông, tất da chân chất lưới mỏng co dãn siêu trong",28000,28000,0,0
TIKI,phu-kien-thoi-trang,183689033,"Thắt Lưng Nam Vải Bố Phong Cách Lính US ARMY, Dây Nịt Nam Vải Dù Khóa ZHANBEIKU Chống Ghỉ Siêu Bền Cao Cấp - HÀNG CHÍNH HÃNG",85000,178000,93000,52
TIKI,phu-kien-thoi-trang,72905084,"Thắt Lưng Nam, Dây Nịt Nam, Dây Lưng Nam Công Sở Da Bò Cao Cấp Màu",520000,520000,0,0
TIKI,phu-kien-thoi-trang,117492175,"Set 6 đôi Vớ Nam Cổ Ngắn Cao Cấp, Tất Cổ Ngắn Nam Họa Tiết, Nhiều Màu - NACN-FEEL-CB6",149000,199000,50000,25
TIKI,phu-kien-thoi-trang,148841912,"Nón tai bèo nón tai bèo nam mũ tai bèo vành nhỏ vải kaki tốt, vành xụp chống nắng tốt, đội được 2 mặt tiện dụng - Hạnh Dương",69000,69000,0,0
TIKI,phu-kien-thoi-trang,106893165,"Vớ Nữ Xỏ Ngón, 10 Đôi Vớ Nữ Cổ Cao, Tất Nữ Chống Nắng Màu Da Thời Trang Baw VN01",99000,99000,0,0
TIKI,phu-kien-thoi-trang,74417661,"Vớ tất lười nữ Basic ELLE EBW LINER010",15000,35000,20000,57
TIKI,phu-kien-thoi-trang,99670802," *Cài khăn đẹp siêu ấn tượng:nhiều mẫu,đẹp,rẻ",56050,56050,0,0
TIKI,phu-kien-thoi-trang,6770079,"30 Tờ Hình Xăm Dán Tattoo Tha Thu Từ 55 - 120 Mẫu",21000,21000,0,0
TIKI,phu-kien-thoi-trang,117492142,"Combo 5 đôi Vớ nam CỔ NGẮN Vintage, Tất Nam sử dụng cả tuần - Votuannam",39000,69000,30000,43
TIKI,phu-kien-thoi-trang,104415087,"Kẹp cua Kim loại phong cách hàn quốc size lớn cho nàng tóc dày",25000,25000,0,0
TIKI,phu-kien-thoi-trang,164021757,"Kính Mát, Kính Thời Trang, Mắt Kính Nam Nữ Gọng Tròn Tròng Phân Cực Chống Tia UV Cực Tốt AK001- Aoron",230000,320000,90000,28
TIKI,phu-kien-thoi-trang,192985737,"Móc Cài Tai Silicon Siêu Dẻo, Giúp Giữ Gọng Kính Không Bị Tuột Khi Chạy, Nhảy, Chơi Thể Thao, Màu Đen, Trong Suốt",10000,10000,0,0
TIKI,phu-kien-thoi-trang,72477851,"SET 5 Tất nam dài họa tiết quả trám đi giày tây, giày công sở MM1",350000,350000,0,0
TIKI,phu-kien-thoi-trang,4791907,"Kính râm nam phân cực A8177",182000,225000,43000,19
TIKI,phu-kien-thoi-trang,86658645," Mũ nón bucbet TRƠN 2 mặt- nón tai bèo vành",32400,32400,0,0
TIKI,phu-kien-thoi-trang,132016620,"Thắt lưng nam, dây nịt nam da bò 3 lớp Bụi Leather L104 - Khóa tự động, nhiều mặt khóa tùy chọn - Bảo hành 24 tháng",225000,412000,187000,45
TIKI,phu-kien-thoi-trang,44898237,"Hộp 12 Chun Buộc Tóc Hàn Quốc Sang Trọng",22000,22000,0,0
TIKI,phu-kien-thoi-trang,131415658,"Kính lão thị cao cấp gập gọn NQ06 có bao da sẵn độ mắt cực sáng và rõ",97920,136000,38080,28
TIKI,phu-kien-thoi-trang,1535135,"Nước Nhỏ Mắt Eye Secret NM15 (15ml)",60000,75000,15000,20
TIKI,phu-kien-thoi-trang,114731752,"Mũ cói mềm dây ren buộc cổ - nón cói vành to chống nắng, đi biển phong cách",74000,148000,74000,50
TIKI,phu-kien-thoi-trang,130398062,"[HOT HOT] [ SET 5 đôi ] Tất đi giày bệt, tất ren đi giày búp bê, vớ nữ ren, vớ đi giày búp bê",42000,45000,3000,7
TIKI,phu-kien-thoi-trang,48260426,"Kính lão thị viễn thị trung niên mắt Thủy Tinh chống xước cao cấp JAPAKVN33CP",154000,154000,0,0
TIKI,phu-kien-thoi-trang,96523075,"Thắt lưng nữ dây nịt nữ Nutushop hàng cao cấp bản nhỏ 2.3cm chất liệu da thật, dễ phối đồ với các loại quần jean, váy, đầm NT168",140000,140000,0,0
TIKI,phu-kien-thoi-trang,115547666,"Gọng Kính Mắt Tròn Mắt Kính Nữ Thời Trang",59000,59000,0,0
TIKI,phu-kien-thoi-trang,29206688,"Gọng kính Unisex VELOCITY VL36460 162",141000,420000,279000,66
TIKI,phu-kien-thoi-trang,21537558,"Thanh búi tóc đa năng",19000,19000,0,0
TIKI,phu-kien-thoi-trang,100442521,"Túi 4000c Chun Buộc Tóc Nhiều Màu Tặng Kèm Đựng Trong Túi Rút Gấu Nâu",19000,19000,0,0
TIKI,phu-kien-thoi-trang,68832428,"Tất Gấu 1 Set 10 Đôi Vớ Nữ Hình Gấu Hot",28999,28999,0,0
TIKI,phu-kien-thoi-trang,129218314,"Bộ dụng cụ đeo lens - tháo kính áp tròng - sản xuất tại Hồng Kông",18000,18000,0,0
TIKI,phu-kien-thoi-trang,139450925,"Dây nịt Nam vải dù_Tushi siêu bền đẹp, Dây nịt lính_vải bố_Khóa cài tự động chắc chắn, tiện lợi",149000,149000,0,0
TIKI,phu-kien-thoi-trang,103877600,"Cài tóc ngọc trai phụ kiện xinh - cài tóc ngọc trai nhiều hàng",63000,63000,0,0
TIKI,phu-kien-thoi-trang,134363750,"Khăn Chống Nắng Nam Nữ- Khăn Đa Năng Chống Nắng Bụi Đi Đường",14400,14400,0,0
TIKI,phu-kien-thoi-trang,90870352," Kính lão gọng dẻo có độ 0.5-4 độ cho người già kính viễn thị gọng titan",107000,144000,37000,26
TIKI,phu-kien-thoi-trang,177744843,"[15 Cặp] Kính Áp Tròng Biomedics 1 Day Extra Cận Thị Không Màu Dùng 1 Ngày",675000,675000,0,0
TIKI,phu-kien-thoi-trang,85560471,"Thắt Lưng Nam, Dây Nịt Nam Hàng Hiệu Xịn Cao Cấp Giá Rẻ D&D Fashion",90000,175000,85000,49
TIKI,phu-kien-thoi-trang,172529101,"Khăn che mặt Rockbros - PYMXD002 Đa Năng Thoáng Khí Phong Cách Thể Thao Thời Trang Cho Nam Và Nữ",145000,145000,0,0
TIKI,phu-kien-thoi-trang,130730877,"Kính lão thị kính đọc sách gập gọn mắt sáng và rõ cực nét cho nữ",109000,109000,0,0
TIKI,phu-kien-thoi-trang,87298108,"Kẹp tóc sau - kẹp tóc đính đá thiên nga",89000,89000,0,0
TIKI,phu-kien-thoi-trang,182843650,"Găng tay chống nắng dệt kim cảm ứng điện thoại Hatsu GLJ - Dòng cao cấp - cực thoải mái và vừa vặn Unisex",52000,52000,0,0
TIKI,phu-kien-thoi-trang,189336638,"(Combo) Nước lau rửa kính dạng xịt chuyên dụng cho kính cận/viễn/loạn",10000,15000,5000,33
TIKI,phu-kien-thoi-trang,75677208,"Ghim Cài Áo Vest Hình Mỏ Neo Cao Cấp QT855",85000,85000,0,0
TIKI,phu-kien-thoi-trang,162475475,"[Chỉ giao HN] - Ba chỉ bò Mỹ bào - 500gr",160000,160000,0,0
TIKI,phu-kien-thoi-trang,176688414,"Bộ sưu tập bờm cài tóc nam nữ răng lược bền đẹp",22000,22000,0,0
TIKI,phu-kien-thoi-trang,53324918,"Mắt Kính Giả Cận Thời Trang",112000,120000,8000,7
TIKI,phu-kien-thoi-trang,117986418,"[Chỉ giao HN] - Pho Mai Que - 500g",131000,131000,0,0
TIKI,phu-kien-thoi-trang,45416817,"Kính râm Mắt tròn thầy bói - Tròng thủy tinh",51000,54000,3000,6
TIKI,phu-kien-thoi-trang,76357278,"Cài tóc ngọc trai đính đá KM2",19000,25000,6000,24
TIKI,phu-kien-thoi-trang,120036527,"HP5147-48-49 - Dây thắt lưng nữ Huy Hoàng bát gài 2,5P màu da bò, đen, nâu",279000,279000,0,0
TIKI,phu-kien-thoi-trang,117492373,"Set 5 đôi Tất Nữ Cổ Ngắn Hàn Quốc (Nhiều Mẫu)",29000,50000,21000,42
TIKI,phu-kien-thoi-trang,177589754,"Gọng kính cận đa giác nam nữ Braby thiết kế đăc biệt 2 cầu kim loại mảnh trong suốt tinh tế MK34",171000,180000,9000,5
TIKI,phu-kien-thoi-trang,182557821,"Mũ cói lưỡi trai Chống Nắng Tia Uv nửa đầu Vành rộng Nón hở chóp thời trang nhiều màu cho phái đẹp Phong cách hàn quốc - HỒNG",99000,99000,0,0
TIKI,phu-kien-thoi-trang,165245325,"Vớ Trơn Cổ Ngắn, Tất Cổ Ngắn Nam Nữ GOMTAT-TRONNGAN-VNXK",6500,13000,6500,50
TIKI,phu-kien-thoi-trang,117720224,"[Chỉ giao HN] - Giò Bò 7 Phút Ngon Bất Bại - 10 Cái",139000,139000,0,0
TIKI,phu-kien-thoi-trang,115269812,"Dây cột tóc srunchies mẫu mới màu đen huyền",20000,20000,0,0
TIKI,phu-kien-thoi-trang,90406473,"Gọng kính chính hãng Skechers SE3241D",1260000,1800000,540000,30
TIKI,phu-kien-thoi-trang,92156409,"Khăn Lụa Vuông Làm AóCao Cấp Họa Tiết Thuyền Buồm - Chất Liệu Lụa Chiffon 70x70cm - Mã KL038",125000,125000,0,0
TIKI,phu-kien-thoi-trang,117028550,"[ Chỉ giao HN]- Sườn không cục thịt heo 1kg",220000,220000,0,0
TIKI,phu-kien-thoi-trang,95141807,"Mắt Kính Thời Trang jessica gọng to Trắng Cực Xinh-Chống tia UV400,Tia Cực Tím,Chống Chói Lóa Hiệu Quả",45500,45500,0,0
TIKI,phu-kien-thoi-trang,118179437,"Gọng kính cận thời trang Kính gọng cận 2984",115000,150000,35000,23
TIKI,phu-kien-thoi-trang,181904832,"GẠO TÁM HƯƠNG LÀI NHÃN FAS LOẠI 5KG",90000,90000,0,0
TIKI,phu-kien-thoi-trang,27733727,"Nón mũ rộng vành đi biển đẹp dn19081905",166250,175000,8750,5
TIKI,phu-kien-thoi-trang,68555006,"Kính viễn thị, Kính lão thị, Kính trung niên, Kính đọc sách nam nữ có sẵn độ dn20092702",35000,35000,0,0
TIKI,phu-kien-thoi-trang,111982177,"[Chỉ giao HN] - Vụn Đuôi Cá Thu Na Uy Xuất Nhật – 1KG – Túi Hút Chân Không",185000,185000,0,0
TIKI,phu-kien-thoi-trang,121603672,"[ Chỉ giao HN] - cá Chẽm tẩm sốt bơ chanh đông lạnh 340gr",240000,240000,0,0
TIKI,phu-kien-thoi-trang,170347406,"Đệ nhất mì gia trộn Spaghetti Hương vị bò ",10000,10000,0,0
TIKI,phu-kien-thoi-trang,39305262,"Cài áo kim băng trang trí GC03 - 4 Hạt kèm vòng đá và 1 hạt treo M3",25000,25000,0,0
TIKI,phu-kien-thoi-trang,116553115,"[Chỉ giao HN] - Gà Nấm Bó Xôi Chiên Giòn - 1 Khay 10 Cái - Hút Chân Không",129000,129000,0,0
TIKI,phu-kien-thoi-trang,193881173,"Bún khô trắng Cao Bằng - 0.5kg",31500,31500,0,0
TIKI,phu-kien-thoi-trang,118137937,"Rau cải ngồng - 200g",13000,13000,0,0
TIKI,phu-kien-thoi-trang,144934460,"[ Chỉ giao HN] - Chân gà mái Đông Tảo loại 3 -1kg (11-12 cái/kg)",590000,590000,0,0
TIKI,phu-kien-thoi-trang,165675011,"Lá bạc hà",18000,18000,0,0
TIKI,phu-kien-thoi-trang,118895477,"[Chỉ giao HN] Kem hộp vị Caramen Hạnh Nhân - Caramel Almond",119000,119000,0,0
TIKI,phu-kien-thoi-trang,179711694,"[Chỉ giao HN] - Túi mix 04 loại hạt cao cấp ((óc chó, hạnh nhân, macca, hạt điều) - 500gr",290000,290000,0,0
TIKI,phu-kien-thoi-trang,126809008,"[ Chỉ giao HN] - Dưa leo baby 1kg",50000,50000,0,0
TIKI,phu-kien-thoi-trang,120527170,"Dưa lưới đạm cá - 1 quả 1,2 kg - 1,4 kg",110000,110000,0,0
TIKI,phu-kien-thoi-trang,252395599,"Kẹp cà vạt cao cấp màu bạc - Thomas Nguyen",110000,110000,0,0
TIKI,phu-kien-thoi-trang,157856149,"[ Chỉ giao HN] - Bánh Chưng Nương Bắc Xanh thịt 800gr",190000,190000,0,0
TIKI,phu-kien-thoi-trang,164428783,"[ Chỉ giao HN] - Bò ẩm thảo mộc - gói 200g",125000,125000,0,0
TIKI,phu-kien-thoi-trang,15443644,"Kính mát nam A8521",175750,185000,9250,5
TIKI,phu-kien-thoi-trang,173294225,"[Chỉ giao HN] - Dồi Sụn Non Nổi Tiếng Hà Thành - 500g - Túi Hút Chân Không",109000,109000,0,0
TIKI,phu-kien-thoi-trang,160308151,"Mũ lưỡi trai ️ Nón kết thêu hình chữ OFF chất nỉ nhung cao cấp form unisex nam nữ N41",55000,55000,0,0
TIKI,phu-kien-thoi-trang,185916496,"Ba Chỉ Bò Mỹ Thái Lát Lẩu - Nướng Khay 500g - Cắt lát 2mm",123000,123000,0,0
TIKI,phu-kien-thoi-trang,51965871,"Kính đeo mắt thể thao chống bụi UV - nhiều mầu",79000,79000,0,0
TIKI,phu-kien-thoi-trang,159276769,"Mắt Kính Ray-Ban Chris  - RB4187F 622/8G -Sunglasses",3584000,4480000,896000,20
TIKI,phu-kien-thoi-trang,86164662," HOTTÓC GIẢ MÁI THƯA HÌNH THẬT HÀNG CÓ SẴN",19900,19900,0,0
TIKI,phu-kien-thoi-trang,84892509,"Mũ rộng vành trơn đơn giản dễ phối đồ, vành rộng chống nắng, chất liệu vải mềm mại, thoải mái - Hạnh Dương",34900,34900,0,0
TIKI,phu-kien-thoi-trang,84446340,"Bộ 2 Găng tay hình xăm tattoo (Mẫu ngẫu nhiên)",14900,14900,0,0
TIKI,phu-kien-thoi-trang,185948023,"Dây lưng nữ HT.NEO da cao cấp, thiết kế trẻ trung, màu sắc tươi sáng, khóa kim loại DLN04",100000,150000,50000,33
TIKI,phu-kien-thoi-trang,191778222,"Set chun lông 5 chi tiết gắn icon,Dây Cột Tóc Nhung Lông Họa Tiết Hoạt Hình Phong Cách Hàn Quốc Xinh Xắn",35000,35000,0,0
TIKI,phu-kien-thoi-trang,185657602,"Mực nang nút - 1kg",130000,130000,0,0
TIKI,phu-kien-thoi-trang,179711727,"[Chỉ giao HN] - Túi mix 02 loại hạt cao cấp 6 (hạt điều, hạnh nhân) - 1kg",410000,410000,0,0
TIKI,phu-kien-thoi-trang,117211906,"[Chỉ giao HN] - Khâu Nhục Tiên Yên Quảng Ninh - 350g",299000,299000,0,0
TIKI,phu-kien-thoi-trang,121603682,"[ Chỉ giao HN] - Kim chi hộp 500g",57600,57600,0,0
TIKI,phu-kien-thoi-trang,114584222,"Mắt kính thời trang chống bụi gọng sắt tròn K008 unisex nam nữ",98000,98000,0,0
TIKI,phu-kien-thoi-trang,86422098,"Tóc giả ngoặm xù kẹp ombre 3 màu( ảnh thật)",124000,124000,0,0
TIKI,phu-kien-thoi-trang,22780097,"Kính râm CƠN AO Hồng Kong cao cấp dành cho Nam giới",329000,389000,60000,15
TIKI,phu-kien-thoi-trang,126962685,"[ Chỉ giao HN] -Nấm hương mũ 200g",84000,84000,0,0
TIKI,phu-kien-thoi-trang,98084812," MŨ BUCKET THÊU TIK TOK NAM NỮ",34000,34000,0,0
TIKI,phu-kien-thoi-trang,50298588,"Nón chống nắng cho nữ phong cách Hàn, mũ chống nắng đi biển vành vừa",145000,145000,0,0
TIKI,phu-kien-thoi-trang,136369856,"Kẹp lưới bới tóc búi tóc hoạ tiết cao cấp (7)",70000,70000,0,0
TIKI,phu-kien-thoi-trang,117576472,"[Chỉ giao HN] - Vụn Cá Hồi Có Da - 1Kg 2 Túi Hút Chân Không",409000,409000,0,0
TIKI,phu-kien-thoi-trang,127509728,"[Chỉ giao HN] Kim chi cải thảo 300g",44000,44000,0,0
TIKI,phu-kien-thoi-trang,51061481,"Mũ chống nắng kèm khẩu trang 360 độ cao cấp, nón chống nắng đa năng tạo kiểu",165000,165000,0,0
TIKI,phu-kien-thoi-trang,72487410,"SET 5 tất nam dài đi giày tây công sở  họa tiết caro nhỏ MM2",128000,128000,0,0
TIKI,phu-kien-thoi-trang,41354320,"Mũ nón len nữ đẹp dn19111306",128000,135000,7000,5
TIKI,phu-kien-thoi-trang,35612860,"Nón bucket 2 mặt con vịt Mã: CK0550",44500,44500,0,0
TIKI,phu-kien-thoi-trang,120657582,"HC9421-22-23-24 - Đầu khóa da đà điểu Huy Hoàng da hột 4 phân đầu trắng màu đen, nâu đất, vàng bò, nâu đỏ",169000,169000,0,0
TIKI,phu-kien-thoi-trang,53652522,"Gọng kính chính hãng Emporio Armani EA1086",3040000,3800000,760000,20
TIKI,phu-kien-thoi-trang,164428759,"[ Chỉ giao HN] - Dưa lưới Đà Lạt - 1kg",65000,65000,0,0
TIKI,phu-kien-thoi-trang,127509732,"[Chỉ giao HN] Thăn ngoại bò Mỹ cắt lát sốt BBQ 150gr",163900,163900,0,0
TIKI,phu-kien-thoi-trang,72076768,"[MỘT MIẾNG] Kính áp tròng cận thị không màu MAXIclear, hạn dùng 3 tháng",67500,67500,0,0
TIKI,phu-kien-thoi-trang,103994226,"[Chỉ Giao HN] Bưởi da xanh 1 Trái 1.5kg",85000,85000,0,0
TIKI,phu-kien-thoi-trang,119191989,"1mx1m55 Vải lông nhung cao cấp SunnyThanh 59k",59500,59500,0,0
TIKI,phu-kien-thoi-trang,120480652,"[Chỉ Giao Hà Nội] Đuôi heo Nga - 1kg",148000,148000,0,0
TIKI,phu-kien-thoi-trang,103755949,"Mặt khóa thắt lưng cao cấp khóa tự động dùng cho dây rộng 3,5 cm, có răng cưa phía sau ( không kèm dây đi cùng )",99000,99000,0,0
TIKI,phu-kien-thoi-trang,118896392,"[Chỉ giao HN] Kem hộp vị Phô Mai RedVelvet - Cream Cheese Red Velvet",119000,119000,0,0
TIKI,phu-kien-thoi-trang,184599154,"Khoai môn lệ phố hương cốm Đôi Đũa Vàng 260g",103000,103000,0,0
TIKI,phu-kien-thoi-trang,173669334,"Khăn lụa vuông sang trọng mẫu phong thủy đẹp - Quàng Cổ Nữ Đẹp - Buộc Tóc - Quấn Túi Xách- Làm Áo Yếm- Chùm đầu Cao Cấp",115000,115000,0,0
TIKI,phu-kien-thoi-trang,101464498,"Kính lão inox gọng xếp màu đen - Mắt kính lão thị phù hợp cho nam và nữ",299000,299000,0,0
TIKI,phu-kien-thoi-trang,119398077,"[Chỉ giao HN] - Lưỡi Heo Muối Xông Khói – 1Kg",439000,439000,0,0
TIKI,phu-kien-thoi-trang,116021319,"Tất Cổ Cao Nam họa tiết quả trám, Tất giày tây nam cao cấp phong cách Châu Âu",26000,50000,24000,48
TIKI,phu-kien-thoi-trang,141471936,"Thắt lưng da nam cao cấp mặt elip đính đá xoay 360, khoá tự động phong cách sang trọng, lịch lãm",49500,99000,49500,50
TIKI,phu-kien-thoi-trang,172025039,"[ Chỉ giao HN] -Táo Envy Mỹ -1kg",429000,429000,0,0
TIKI,phu-kien-thoi-trang,179711588,"[Chỉ giao HN]  - Túi mix 03 loại hạt cao cấp 3 (macca, hạnh nhân, hạt điều) - 1kg",600000,600000,0,0
TIKI,phu-kien-thoi-trang,186210004,"Tất Cổ Cao Nam Nữ GOMTAT Họa Tiết Dễ Thương, Vớ Cao Cổ Unisex Chất Liệu Cotton Cao Cấp - FUJI",14000,23000,9000,39
TIKI,phu-kien-thoi-trang,118137940,"Rau mồng tơi - 200g",13000,13000,0,0
TIKI,phu-kien-thoi-trang,172328707,"BAO TAY CHỐNG NẮNG 1 LỚP LOẠI 3 TẤC BÍT NGÓN Không in hình Có ren cổ tay Chất liệu thun lạnh mềm êm co giãn",18000,18000,0,0
TIKI,phu-kien-thoi-trang,86422489,"Tóc giả kẹp - Kẹp dãi thẳng cao cấp chịu nhiệt",45000,45000,0,0
TIKI,phu-kien-thoi-trang,117492233,"Set 5 đôi tất nữ cổ ngắn họa tiết hình gấu trắng đen, vớ nữ cổ ngắn cực dễ thương – NUCN-HINHGAU-CB5-2",150000,150000,0,0
TIKI,phu-kien-thoi-trang,34350866,"Set cài áo nữ 10 chi tiết",42000,42000,0,0
TIKI,phu-kien-thoi-trang,86516160,"Mũ lưỡi trai TRƠN đủ màu Unisex",19990,19990,0,0
TIKI,phu-kien-thoi-trang,154029942,"Mũ rộng vành nón gấp gọn đẹp sang trọng dona21122502",170000,179000,9000,5
TIKI,phu-kien-thoi-trang,163815668,"Tất Nữ, Vớ Nữ Thời Trang Hàng Chuẩn Cá Tính, Hiện Đại",8500,8500,0,0
TIKI,phu-kien-thoi-trang,2777169,"Kính Mát Unisex Exfash EF27758 C35",598000,800000,202000,25
TIKI,phu-kien-thoi-trang,86013728,"Nón rộng vành bò sữa 2 mặt độc đáo, 1 mặt đen trơn 1 mặt họa tiết bò sữa - Hạnh Dương",55000,55000,0,0
TIKI,phu-kien-thoi-trang,83638549,"Nón Kết Cho Bảo Vệ Thêu Logo Security",47000,47000,0,0
TIKI,phu-kien-thoi-trang,157856385,"[ Chỉ giao HN] - Bánh Chưng Nương Bắc Gấc thịt 800gr",190000,190000,0,0
TIKI,phu-kien-thoi-trang,186122898,"Hình xăm dán cao cấp hoa hồng và bướm xinh",8000,10000,2000,20
TIKI,phu-kien-thoi-trang,89457350,"Mũ kết nam nữ cao cấp logo chữ Z, vải cotton 2 lớp oát mềm mại, thoáng mát",96000,96000,0,0
TIKI,phu-kien-thoi-trang,160176764,"Thắt lưng nam D&D Fashion DDF 5132 cao cấp dây da 120cm",120000,200000,80000,40
TIKI,phu-kien-thoi-trang,96312582,"Khăn Lụa Vuông, Khăn Turban Trơn Nhiều Màu - Chất Liệu Satin - Size 60x60cm - SD000",49500,49500,0,0
TIKI,phu-kien-thoi-trang,108076389,"Khăn thắt nơ cổ áo công sở khăn turban dài size 145x7cm",70000,70000,0,0
TIKI,phu-kien-thoi-trang,170527607,"Tony tí hon -  Mũ/nón kết lưỡi trai Snapback JD thời trang nam nữ cao cấp - màu đen",236000,390000,154000,39
TIKI,phu-kien-thoi-trang,139987692,"Bưởi da xanh Bến Tre",88000,88000,0,0
TIKI,phu-kien-thoi-trang,190708889,"Kẹp tóc càng cua 5 chấu nhiều hình",5500,11000,5500,50
TIKI,phu-kien-thoi-trang,77161865,"Thắt lưng nữ kim loại độc đáo dễ phối đồ TTL75",69000,69000,0,0
TIKI,phu-kien-thoi-trang,183066462,"Combo 5 đôi Tất Lười Nam Invisible đệm cao su chống trượt, Vớ Nam đi giày lười phối lưới thoáng khí - VLN-INVISIBLE-CB5",159000,159000,0,0
TIKI,phu-kien-thoi-trang,169083041,"Vớ Teeworld Trắng Đen Unisex Nam Nữ",79000,79000,0,0
TIKI,phu-kien-thoi-trang,191817057,"TẤT VỚ NAM CỔ TRUNG Thêu biểu tượng NIK trên cổ vớ Chất liệu thun cotton Êm Thấm hút mồ hôi Nhãn hiệu SPORT SOCK",28000,28000,0,0
TIKI,phu-kien-thoi-trang,106332749,"Dây Nịt Nữ Thắt Lưng Nữ bản nhỏ Girdle mang đầm váy Dona21061501",72000,89000,17000,19
TIKI,phu-kien-thoi-trang,87093181,"Dây thắt lưng nam da thật dùng cho khóa tự động (không khóa) D&D Fashion",50000,100000,50000,50
TIKI,phu-kien-thoi-trang,136368722,"Cột buộc tóc nhung siêu êm mịn",15000,15000,0,0
TIKI,phu-kien-thoi-trang,190085376,"Nón Kết Ông Địa Cầm Đàn /Hàng Loại 1 ",169000,169000,0,0
TIKI,phu-kien-thoi-trang,162189774,"Hộp 4 đôi tất sợi tre cổ cao GOMTAT cao cấp, chất liệu mềm mại, thoáng khí, khử mùi kháng khuẩn - GOMTAT-SOITRE-CAO",144000,250000,106000,42
TIKI,phu-kien-thoi-trang,270177664,"Mũ trùm đầu y tế tiệt trùng bao tóc con sâu Khánh An ngăn bụi vi khuẩn",42000,59000,17000,29
TIKI,phu-kien-thoi-trang,75524270,"Thắt Lưng Nữ Bản To Mặt Khóa Kim Loại Hình Vuông Chất Liệu Da PU TL011 MayHomes Dây Lưng Nữ Thời Trang Hàn Quốc, Dây Nịt Nữ Đa Năng Bền Chắc Dùng Cho Đầm, Jeans, Quần Âu Và Shorts",68250,75000,6750,9
TIKI,phu-kien-thoi-trang,167139406,"Thắt Lưng Nữ Bản Nhỏ Thời Trang Mặt Khóa Kim Loại Cá Tính Chất Liệu Da PU TL014 MayHomes Dây Lưng Nữ, Dây Nịt Nữ Đa Năng Đục Lỗ Sẵn Dùng Cho Đầm, Jeans, Quần Âu Và Shorts",55000,55000,0,0
TIKI,phu-kien-thoi-trang,41891622,"NÓN MŨ LEN BERE LÔNG THỎ PHIÊN BẢN HÀN QUỐC DN19111706",166000,175000,9000,5
TIKI,phu-kien-thoi-trang,87895641,"Dây Lưng Nam Màu Đen Da Safiano Nhập Khẩu Phong Cách Công Sở Lịch Lãm + Đục Lỗ Cài",754000,754000,0,0
TIKI,phu-kien-thoi-trang,163581696,"Combo 5 đôi Tất Nữ cổ cao Hàn Quốc sử dụng cả tuần - CBCC65",45000,69000,24000,35
TIKI,phu-kien-thoi-trang,109293338,"GOTI  - Set Bộ 5 Món Pin Cài Áo Siêu Hot, Hoặc Set Bộ 3 Trâm Cài Trang Trí Cổ Áo, Váy Đầm, Balo, Nón SET02",18000,20000,2000,10
TIKI,phu-kien-thoi-trang,117085860,"Tròng kính râm dạng kẹp hình chữ nhật chống UV chống chói, dễ dàng tháo lắp",150000,150000,0,0
TIKI,phu-kien-thoi-trang,186796769,"Gọng Kính Cận Unisex Tròng Chống Ánh Sáng Xanh Thời Trang Hàn Quốc VINIEL VINIEL ABL2L + Tặng 8 miếng đệm mũi chống trượt - Hàng Chính Hãng",206000,330000,124000,38
TIKI,phu-kien-thoi-trang,49047974,"Khẩu trang màu trơn ",1900,2000,100,5
TIKI,phu-kien-thoi-trang,74765438,"Kính lão thị viễn thị tiện lợi có bao nam châm 44kv Loại tốt",219000,219000,0,0
TIKI,phu-kien-thoi-trang,144972793,"Mũ lưỡi trai trơn đen unisex chất vải kaki cotton cao cấp, Nón kết đen phom dáng thể thao basic T99",35000,35000,0,0
TIKI,phu-kien-thoi-trang,164021727,"Kính Mát Nam Nhiều Màu Thời Trang Chống Lóa Aoron AK015 AORON",250000,350000,100000,29
TIKI,phu-kien-thoi-trang,31023408,"Váy Chống Nắng Jean Mềm, Mịn Có Chân Váy Dài Phù Hợp Với Người Vừa Lẫn Người Cao Thêu Họa Tiết Chuồn Chuồn",250000,250000,0,0
TIKI,phu-kien-thoi-trang,186529155,"Kính lão thị gọng nhựa dẻo kiểu dáng đẹp dành cho nam và nữ giá rẻ",35000,35000,0,0
TIKI,phu-kien-thoi-trang,195750309,"Mắt Kính Mát Nam Thời Trang Không Khung Siêu Trong Suốt Của Nam Giới Cool Ngầu 7533 [BỘ ĐỰNG KÍNH 5 MÓN]  BK003",135000,180000,45000,25
TIKI,phu-kien-thoi-trang,160324322,"Thắt lưng nam dây nịt nam chất liệu da bò thật khóa tự động hàng hiệu cao cấp NT334 - Nutushop",330000,330000,0,0
TIKI,phu-kien-thoi-trang,168565097,"Tất Cổ Ngắn Sợi Tre Cao Cấp, Vớ Nam Đi Giày Tây Vải Sợi Mềm Mịn, Thoáng Mát - GOMTAT-TRENGAN-1DOI",33000,60000,27000,45
TIKI,phu-kien-thoi-trang,46192806,"THẮT LƯNG NỮ , DÂY NỊT NỮ ĐẸP CAO CẤP MANG ĐẦM VÁY DN19122741",74100,78000,3900,5
TIKI,phu-kien-thoi-trang,182851337,"Khăn Trùm Đầu UPF 50+ Ninja Fullface Nón Kết Chống Nắng WU101 - Cản Tia Cực Tím | Phụ kiện chạy xe",86000,91000,5000,5
TIKI,phu-kien-thoi-trang,59388280,"Bờm cài tóc nam nữ unisex nhựa đơn giản và năng động",17000,17000,0,0
TIKI,phu-kien-thoi-trang,54150373,"Kính Mát Gọng Mắt Mèo Thời Trang Du Lịch Biển Mùa Hè Bảo Vệ Đôi Mắt Cho Bạn KM11",47500,50000,2500,5
TIKI,phu-kien-thoi-trang,16202318,"combo Khăn trùm đầu Ninja Fullface + Găng Tay Chống Nắng Xỏ Ngón màu đen",29000,29000,0,0
TIKI,phu-kien-thoi-trang,103876108,"Cài tóc ngọc trai phong cách Hàn quốc phụ kiện xinh tặng kèm 5g thun cột tóc đen",18000,45000,27000,60
TIKI,phu-kien-thoi-trang,54926055,"Mũ hấp tóc tại nhà loại xịn dùng điện - Giao màu ngẫu nhiên",89000,110000,21000,19
TIKI,phu-kien-thoi-trang,190489697,"SET 10 KẸP TÓC CÀNG CUA MỘT MÀU VINTAGE HÀN QUỐC SANG CHẢNH",48000,120000,72000,60
TIKI,phu-kien-thoi-trang,2460719,"Bộ Mắt Kính Đa Tròng 5 Trong 1 + Tặng kèm bao da đựng kính",145000,163000,18000,11
TIKI,phu-kien-thoi-trang,161550664,"Dụng cụ chăm sóc, khử mùi vùng nách đá khoáng Soft Stone 20g (mẫu mới) Nhật Bản",259000,259000,0,0
TIKI,phu-kien-thoi-trang,135268980,"Nón tai bèo nam Việt Nam vành rộng chống nắng, có nút bấm - Xanh rêu thích hợp cho ace làm ngoài trời nha",42000,42000,0,0
TIKI,phu-kien-thoi-trang,137847104,"Tất Nữ Cổ Cao Vớ tất cổ cao nữ NAGOMY Phong Cách Nhật Bản In Họa Tiết Động Vật Dễ Thương - TO86",95000,95000,0,0
TIKI,phu-kien-thoi-trang,22131959,"NÓN RỘNG VÀNH NỮ - DN19VT0718",160550,169000,8450,5
TIKI,phu-kien-thoi-trang,79242097,"NÓN VÀNH BUCKET THỜI TRANG",30900,30900,0,0
TIKI,phu-kien-thoi-trang,173734361,"Tất đen cổ cao công sở sọc gân - Chất liệu Cotton - Hồ Chí Minh - Có hộp",39000,39000,0,0
TIKI,phu-kien-thoi-trang,118989422,"Bao Tay Chống Nắng / Ống Tay Chống Nắng Chống Tia UV Dành Cho Nam Và Nữ Hàn Quốc",12000,12000,0,0
TIKI,dong-ho-va-trang-suc,177595545,"Hộp đựng kính mắt Braby lót nhung mềm mại chống xước, chất liệu hộp da cao cấp bền đẹp, chống va đập",25000,28000,3000,11
TIKI,dong-ho-va-trang-suc,191358016,"Mũ rộng vành nam tai bèo thêu chữ Columbia, may 2 lớp chống nóng tốt, dây quai rút dễ dàng, vành rộng 8.5cm - Hạnh Dương",76000,76000,0,0
TIKI,dong-ho-va-trang-suc,53057339,"Kính viễn thị lão thị titan siêu nhẹ cực ôm mặt kiểu dáng thể thao nam tính kv991http",219000,219000,0,0
TIKI,dong-ho-va-trang-suc,22670781,"NÓN MŨ ĐI BIỂN ĐẸP - DN19VN0715",94050,99000,4950,5
TIKI,phu-kien-thoi-trang,85557384,"Phụ kiện dây nịt nam thắt lưng D&D Fashion",45000,90000,45000,50
TIKI,dong-ho-va-trang-suc,121106861,"DÂY ĐAI QUẦN CHỮ Y - DÂY YẾM QUẦN - ĐỦ MÀU NAM NỮ",69000,69000,0,0
TIKI,dong-ho-va-trang-suc,52627083,"Tóc giả nữ cột xù 60cm C168 FREESHIP Tóc cột xù mì, buộc tóc giả, cột tóc giả, tóc giả buộc",49000,49000,0,0
TIKI,dong-ho-va-trang-suc,150360346,"Trâm Cài Áo Nữ Hình Bó Hoa TCA11",50000,70800,20800,29
TIKI,dong-ho-va-trang-suc,59388082,"Bờm cài tóc nam nữ phong cách trẻ trung",25000,25000,0,0
TIKI,dong-ho-va-trang-suc,168236584,"cài bờm tóc giả tết bính to 4cm",189000,189000,0,0
TIKI,dong-ho-va-trang-suc,120169123,"Trâm cài tóc bằng gỗ Cẩm Lai/Trắc (Đủ kiểu dáng) HH600 - phong cách cổ trang, điêu khắc sang chảnh HOT TREND cho nữ  - HAHANCO",33000,33000,0,0
TIKI,dong-ho-va-trang-suc,2385127,"Găng tay nữ chống nắng UPF50+ xanh da trời Zigzag GLV00303 size",199000,199000,0,0
TIKI,dong-ho-va-trang-suc,58034056,"Dây buộc tóc lụa mềm vintage Scrunchies loại đẹp HD53",29000,29000,0,0
TIKI,dong-ho-va-trang-suc,75789827," Khăn turban satin vuông size 48*48cm mẫu mới 2020 - Khăn quàng cổ thời trang",45000,45000,0,0
TIKI,dong-ho-va-trang-suc,103856500,"Bộ 02 Ống Tay Chống Nắng, Găng Tay Chống Nắng Hàn Quốc Bằng Chất Liệu Vải Lụa Cao Cấp Siêu Mát",55000,55000,0,0
TIKI,dong-ho-va-trang-suc,191648212,"Voan cài tóc cô dâu màu da ngắn ngang lưng điểm đá hạt bẹt GiangPKC",120000,120000,0,0
TIKI,dong-ho-va-trang-suc,45690934,"Nón len nữ, mũ len nữ thời trang Hàn Quốc dn19122402",55000,55000,0,0
TIKI,dong-ho-va-trang-suc,7959630,"Mũ Tai Bèo Bucket Trơn - Đen",25000,25000,0,0
TIKI,dong-ho-va-trang-suc,162209950,"Găng tay ren dài quyến rũ cho nữ",45000,45000,0,0
TIKI,dong-ho-va-trang-suc,87022922,"Thắt lưng/ dây nịt nam da bò nguyên miếng cao cấp Mã TL.8208",219000,259000,40000,15
TIKI,phu-kien-thoi-trang,4170711,"Bờm cài tóc turban nữ BN23B bản to họa tiết hoa vàng nền xanh lá",25000,25000,0,0
TIKI,dong-ho-va-trang-suc,81139119,"Nón Kết Nam Nữ Thời Trang, Nón Lưỡi Trai Thêu Chữ Chất Vải Đẹp",48500,48500,0,0
TIKI,dong-ho-va-trang-suc,96315314,"Nón cói đi biển panama mũ cói thời trang tua rua thổ cẩm nhiều màu",161000,161000,0,0
TIKI,dong-ho-va-trang-suc,192207758,"Mũ đi biển nón rộng vành nữ đẹp thời trang Hàn Quốc nhiều mẫu dona220701",151000,159000,8000,5
TIKI,dong-ho-va-trang-suc,152376971,"Mũ tai bèo có dây rút trơn BK66 phong cách tối giản cho cả nam và nữ",195000,250000,55000,22
TIKI,dong-ho-va-trang-suc,175412930,"Kim cong khâu thú y khâu da",3000,3000,0,0
TIKI,dong-ho-va-trang-suc,173568000,"Cài tóc nam nữ - Cài tóc dẻo - cài chia tóc mẫu mới",25000,25000,0,0
TIKI,dong-ho-va-trang-suc,1716729,"Gọng Kính V-IDOL V8069 SBG (53/17/141)",175000,340000,165000,49
TIKI,dong-ho-va-trang-suc,82702320,"Găng tay len",70000,70000,0,0
TIKI,dong-ho-va-trang-suc,72665730,"Khăn Choàng Lụa Tổng Hợp HN010 - Size 90cm X 180cm",208000,208000,0,0
TIKI,dong-ho-va-trang-suc,7349543,"Set 3 quần tất chống xước Regart 20D màu da chân (Freesize)",222000,250000,28000,11
TIKI,dong-ho-va-trang-suc,196675854,"Thắt Lưng Ngọc Trai Nịt Móc Xích Chuỗi Hạt Đeo Eo Body Ngọc Trai Dây Kim Loại Mạ Vàng Đầm Váy",28000,28000,0,0
TIKI,phu-kien-thoi-trang,114435291,"Bộ 5 tất dài đi giày tây cho nam họa tiết quả trám, đì giày oxford giày công sở",185000,250000,65000,26
TIKI,dong-ho-va-trang-suc,83617366,"Khẩu trang ninja vải nỉ kính bảo vệ mắt dán gáy che kín tai chạy xe phượt nam nữ - khau trang ni - Hồng che cổ kính",49000,49000,0,0
TIKI,dong-ho-va-trang-suc,74997619,"Thắt lưng nam, dây nịt nam TOPEE khóa tự động dây da cao cấp TP089 - Mẫu HOT",278000,278000,0,0
TIKI,dong-ho-va-trang-suc,85753005,"Mặt thắt lưng nam khóa tự động D&D Fashion",50000,100000,50000,50
TIKI,dong-ho-va-trang-suc,86573206,"Găng Tay Chống Tia UV Nam Nữ Hàn Quốc",16000,20000,4000,20
TIKI,phu-kien-thoi-trang,74871589,"Kính lão thị viễn thị chống uv gọng vàng GOLD cao cấp sang trọng mắt trong nửa viền titan cao cấp KV5p",180500,190000,9500,5
TIKI,dong-ho-va-trang-suc,6129123,"Bộ sản phẩm kính mắt đa tròng 5 in 1 kèm bao da",175000,197000,22000,11
TIKI,dong-ho-va-trang-suc,162405278,"XƯỚC ĐỘN MÁI PHỒNG CHO TÓC ",20000,20000,0,0
TIKI,dong-ho-va-trang-suc,176692544,"Quần tất Nhật SABRINA Tough chống xước siêu dai bền đẹp dùng 4 mùa",125000,125000,0,0
TIKI,dong-ho-va-trang-suc,86166266," MÁI THƯA CÓ MAI SIÊU ĐẸP KÈM ẢNH THẬT, CLIP THẬT",19000,19000,0,0
TIKI,phu-kien-thoi-trang,75556108,"Khăn quàng cổ lụa vuông size 70x70cm - Mã 7054",89000,89000,0,0
TIKI,dong-ho-va-trang-suc,88993407,"MẶT KHÓA THẮT LƯNG NAM KHÓA TÌ TRƯỢT TỰ ĐỘNG CHO DÂY RỘNG 3,5 CM (KO KÈM DÂY)",99000,99000,0,0
TIKI,dong-ho-va-trang-suc,138676623,"Hộp 4 đôi tất vớ nam cổ ngắn GOMTAT chất sợi tre cao cấp, mềm mại thoáng mát, khử mùi kháng khuẩn - GOMTAT-SOITRE-NGAN",132000,200000,68000,34
TIKI,phu-kien-thoi-trang,146989541,"Thắt Lưng Da TL05 Khóa Tự Động Vân Cá Sấu Sang Trọng Nam Tính",60000,120000,60000,50
TIKI,phu-kien-thoi-trang,5913679,"Gọng kính Accede AC2027 GBR - Nâu",177000,340000,163000,48
TIKI,phu-kien-thoi-trang,182834147,"sét 1 đôi tất trơn,tất kẻ cotton mềm daỳ dặn đi thoáng khí thấm hút mồ hôi tốt(tặng)",4750,5000,250,5
TIKI,phu-kien-thoi-trang,172518099,"KHẨU TRANG In hình ếch Chất liệu vải mềm Dày 3 lớp Chống nắng Phòng dịch bệnh Lọc không khí ô nhiễm",18000,18000,0,0
TIKI,phu-kien-thoi-trang,147498476,"Dây nịt nam/ Thắt lưng nam công sở da bò nguyên chất khóa tự động Mã GZA-101",259000,499000,240000,48
TIKI,phu-kien-thoi-trang,116043830,"Nón bucket chiếc lá 2 mặt mũ tai bèo vành nhỏ thêu chiếc lá phù hợp cho nam và nữ",40000,40000,0,0
TIKI,phu-kien-thoi-trang,46680441,"THẮT LƯNG NỮ DÂY NỊT NỮ MANG ĐẦM VÁY DN20010414",94050,99000,4950,5
TIKI,phu-kien-thoi-trang,114431753,"Bộ 5 tất dài cho nam họa tiết caro đi giày công sở oxford",165000,220000,55000,25
TIKI,phu-kien-thoi-trang,86168818," Búi buộc xoăn dễ dùng tiện dụng",39000,39000,0,0
TIKI,phu-kien-thoi-trang,102888171,"Mái kẹp phím thẳng 2 bên M04 Sỉ 30k/1 cặp",50000,50000,0,0
TIKI,phu-kien-thoi-trang,161913948,"Combo 10 Kẹp Tóc Nhí Sắc Màu Siêu Xinh",21600,21600,0,0
TIKI,phu-kien-thoi-trang,22828846,"NÓN MŨ CAO BỒI NỮ FEDORA THỜI TRANG HÀN QUỐC MÀU TRẮNG SỮA - DN19VN0739",94050,99000,4950,5
TIKI,phu-kien-thoi-trang,174529397,"Mũ lưỡi trai - nón Ulzzang vải kết nhung thêu chữ M unisex nam nữ chống nắng phong cách thời trang, cá tính",41000,82000,41000,50
TIKI,phu-kien-thoi-trang,77774766,"COMBO dung dịch NHỎ MẮT & NƯỚC NGÂM kính áp tròng thương hiệu MAXI",160000,160000,0,0
TIKI,phu-kien-thoi-trang,84711643,"Combo 4 khẩu trang UV Nhật Bản - Hàng xuất khẩu",112000,112000,0,0
TIKI,phu-kien-thoi-trang,271446628,"Lược cá mập bằng nhựa chải tóc tạo kiểu tóc dành cho makeup chuyên nghiệp - Hity Beauty",14000,14000,0,0
TIKI,phu-kien-thoi-trang,98868893," Kẹp mỏ vịt Nhựa màu Nano dài 8cm 9.5cm đẹp sang trọng",10000,10000,0,0
TIKI,phu-kien-thoi-trang,161539191,"Mũ cối tàu lòng vàng khuy trắng cốt phíp, vải Gabadin tô châu, rơi va đạp không vỡ, tuyệt đối không ngấm nước, vải không phai, phiên bản cối xưa",75000,75000,0,0
TIKI,phu-kien-thoi-trang,46447934,"Kính viễn thị  kính lão thị mắt cực sáng và trong gọng lò xo đàn hồi nhìn chữ cực nét và không nhức mắt PKTM_139",139000,139000,0,0
TIKI,phu-kien-thoi-trang,152527493,"Thắt Lưng Da Nam TL07 Khóa Kim Gài Đơn Giản Tiện Dụng Dễ Phối Đồ",75000,150000,75000,50
TIKI,phu-kien-thoi-trang,72095725,"Combo gồm 10 đôi tất vớ cổ ngắn nam nữ khử mùi không hôi chân",47733,65235,17502,27
TIKI,phu-kien-thoi-trang,192182869,"Bờm tóc phát sáng, Cài tóc tai thỏ tai mèo lông vũ có đèn, phụ kiện đi chơi nổi bật",32000,32000,0,0
TIKI,phu-kien-thoi-trang,172154220,"Khẩu Trang 3 Lớp Vải Linen NEMO, có nút tăng giảm dây dễ điều chỉnh - KTMTC",30000,50000,20000,40
TIKI,phu-kien-thoi-trang,90324955,"Dây buộc tóc cúc họa mi nhiều kiểu",6000,6000,0,0
TIKI,phu-kien-thoi-trang,22779981,"Kính râm Nam AO Hồng Kong cao cấp",166000,197000,31000,16
TIKI,phu-kien-thoi-trang,50436821,"Găng tay, bao tay nam đi phượt, găng tay dài ngón, nhiều màu ( giao ngẫu nhiên)",59000,59000,0,0
TIKI,phu-kien-thoi-trang,85753013,"Mặt Khóa Thắt Lưng Nam Đẹp Cao Cấp Bằng Inox D&D Fashion - rồng vàng",50000,100000,50000,50
TIKI,phu-kien-thoi-trang,194083124,"Nón Lưỡi Trai Vành Cong fom Trucker logo Raider vải đen Lưới quai cài nút",160000,160000,0,0
TIKI,phu-kien-thoi-trang,177939380,"[Mới] Thắt lưng da nam cao cấp- Dây nịt da hai lớp Jnaji Paul-Full hộp đựng cao cấp-Màu vàng",290000,580000,290000,50
TIKI,phu-kien-thoi-trang,62914172,"Khăn lụa thời trang Hàn Quốc thắt nhiều kiểu AKL25 họa tiết nhỏ",69000,69000,0,0
TIKI,phu-kien-thoi-trang,184240330,"Kẹp tóc càng cua kim loại size lớn cho nàng tóc dày",28000,28000,0,0
TIKI,phu-kien-thoi-trang,191755643,"khăn Lau Kính Nano Hộp 100 Miếng Giấy Lau Kính Chống Bám Hơi Nước, Vân Tay Bụi Bẩn",21000,29000,8000,28
TIKI,phu-kien-thoi-trang,13896075,"Găng tay chống nắng cánh tay nam nữ",10000,10000,0,0
TIKI,phu-kien-thoi-trang,152457869,"Kính Mắt Nam Nữ Chống Ánh Sáng Xanh Mắt Vuông To Oversize Cổ Điển (Nhiều Màu)",142500,150000,7500,5
TIKI,phu-kien-thoi-trang,153066393,"Thắt Lưng Khóa Kim Da Bò TL07 Siêu Bền Đẹp Nam Tính Dễ Phối Quần Áo",75000,150000,75000,50
TIKI,phu-kien-thoi-trang,176661065,"Thắt lưng nam EINHORN khóa tự động - Dây nịt nam mặt khóa bằng thép không gỉ cao cấp E4 - Hàng Chính Hãng",137000,200000,63000,32
TIKI,phu-kien-thoi-trang,171091094,"GỌNG KÍNH HỢP KIM SIÊU NHẸ HỢP THỜI TRANG – HÀNG CHÍNH HÃNG H5007",53000,59000,6000,10
TIKI,phu-kien-thoi-trang,193095309,"Kính Râm, Kính Mát Nam Nữ Mắt Oval Tròn Dáng Nhỏ Gọng Nhựa Dày Dặn, Cứng Cáp, Mắt Vàng, Đỏ, Nâu, Xanh Dương Chống UV",185000,185000,0,0
TIKI,phu-kien-thoi-trang,98084979,"Mũ bucket tai bèo nam nữ thêu icon mặt cười độc đáo, chất vải kaki 2 lớp chống nóng tốt - Hạnh Dương",45000,45000,0,0
TIKI,phu-kien-thoi-trang,38164863,"Combo 12 kẹp tóc càng cua trơn - Không gãy - Hàng Việt Nam chất lượng cao",91000,91000,0,0
TIKI,ngon,185948105,"Thăn Nội Bò Mỹ Choice Cắt Steak (350g)",338000,338000,0,0
TIKI,ngon,92384946,"Thịt đùi Iberico Bellota muối, cắt lát bằng tay - 48 tháng (100g)",761000,761000,0,0
TIKI,ngon,162873922,"Sữa Tươi A2 200ml Nguyên Kem dạng nước - Date xa",559000,559000,0,0
TIKI,ngon,108930491,"[CHỈ GIAO HN] - RAM TÔM ĐẤT BÌNH ĐỊNH VITOT FOOD (500g/ khay)",152000,152000,0,0
TIKI,ngon,155700354,"[Chỉ giao HN] - Lườn Ngỗng Nga Xông Khói - 1Kg - Món Ngon Đãi Khách Tết",299000,299000,0,0
TIKI,ngon,169346163,"Đặc Sản Nha Trang - Rau Câu Nấu Chè Rau Câu Chân Vịt Sạch Không San Hô, Cát Seavy Gói 500G",340000,350000,10000,3
TIKI,ngon,92380640,"Đùi sau Cebo cắt lát - trên 24 tháng (100g)",277000,277000,0,0
TIKI,ngon,155726232,"[Chỉ giao HN] - Dăm Bông Heo Xông Khói – 1Kg – Món Ngon Đãi Khách Tết",409000,409000,0,0
TIKI,ngon,116553081,"[Chỉ giao HN] - Đậu Hũ Cá Phô Mai - Túi 500g",249000,249000,0,0
TIKI,ngon,173243472,"[Chỉ giao HN] - Cá Mối Hương 1 Nắng - 500g - Có Xương",109000,109000,0,0
TIKI,ngon,125577962,"[Chỉ giao HN] Tỏi gà Mỹ - 1kg",75000,75000,0,0
TIKI,ngon,173286832,"[Chỉ giao HN] - Cá Nục 1 Nắng - 500g",129000,129000,0,0
TIKI,ngon,159898338,"[CHỈ GIAO HN] - KHÔ CÁ CHỈ VÀNG VITOT FOOD (500G/ KHAY)",159000,159000,0,0
TIKI,ngon,179711639,"[Chỉ giao HN] - Hạt sen tươi Đồng Tháp/Cam Ranh - 500gr",110000,110000,0,0
TIKI,ngon,144444253,"Xương cá hồi Na Uy đông lạnh khay 1kg",40000,40000,0,0
TIKI,ngon,114197811,"[Chỉ giao HN] - Lươn Nhật Nướng Tẩm Sốt Kabayaki Túi 200gam",300000,300000,0,0
TIKI,ngon,119961438,"[GIAO NHANH HN - 1H - 0989.780.789] Giỏ Quà Trái Cây - AC242",1250000,1250000,0,0
TIKI,ngon,159111634,"[Giao nội thành Hà Nội] Tỏi khô ta Vườn Nhà Mẹ - Gia vị tươi, sạch, chuẩn VietGap",35000,35000,0,0
TIKI,ngon,91248017,"[Chỉ Giao HN] - Nho Xanh Nam Phi",169500,169500,0,0
TIKI,ngon,116971760,"[Chỉ giao HN]Tôm Langoustine Khay 800Grs: 21- 30 Con/Khay ",560000,560000,0,0
TIKI,ngon,98978137,"[Chỉ Giao HCM] - Chân gà rút xương - hộp 300g",59999,59999,0,0
TIKI,ngon,116553141,"[Chỉ giao HN] - Set 3 Cái Pizza - 8 Phút Nướng Pizza Sẵn Sàng Cho Bạn",199000,199000,0,0
TIKI,ngon,117595002,"[Chỉ giao HN] Gạo ST25 đặc biệt hộp 5kg",215000,215000,0,0
TIKI,ngon,117838029,"[Chỉ giao HN] - Cần tây - 200g",39000,39000,0,0
TIKI,ngon,114197795,"[Chỉ giao HN] - Củ Cải Muối Đầm Hà Quảng Ninh Loại Ngon Túi 1Kg Hút Chân Không",119000,119000,0,0
TIKI,ngon,179711710,"[Chỉ giao HN] - Đậu lăng đỏ nhập khẩu Mỹ  - 1kg",150000,150000,0,0
TIKI,ngon,120147414,"[Chỉ giao HN] Set Sashimi cá hồi Na Uy 500g",469000,469000,0,0
TIKI,ngon,168953165,"Thăn vai (Ribeye) bò Úc ăn ngũ cốc Kilcoy Blue Diamond tươi khay 100g",102000,102000,0,0
TIKI,ngon,127509687,"[Chỉ giao HN] Đùi Gà Không Xương Sốt Miso 200gr",64900,64900,0,0
TIKI,ngon,128707110,"[Chỉ giao HN] Thịt bò Wagyu Full Blood 2GR Úc MB6-7 - Tenderloin (Thăn nội) - 1KG",3100000,3100000,0,0
TIKI,ngon,180934944,"[GIAO NHANH HN - 1H - 0989.780.789] Giỏ quà trái cây AC0013",1550000,1550000,0,0
TIKI,ngon,173327924,"[Chỉ giao HN] - Cá Mờm Cơm Sữa Tươi Đông Lạnh – 500g",139000,139000,0,0
TIKI,ngon,96512428,"[Chỉ Giao HN] - Combo 5 quả táo Envy size 100",229000,229000,0,0
TIKI,ngon,129137382,"[Chỉ giao HN] Set Sushi ichiban (phù hợp 2-3 người)",399000,399000,0,0
TIKI,ngon,198606330,"Lê Sữa sz36/40 - 15 kg (Có hóa đơn VAT)",1300000,1300000,0,0
TIKI,ngon,134408990,"Cam vàng Úc",145000,145000,0,0
TIKI,ngon,173330284,"[Chỉ giao HN] - Chả Ram Tôm Đất Bình Định - 500g - Loại To",199000,199000,0,0
TIKI,ngon,125900035,"[Chỉ Giao HN] Cá Trắm Đen (trắm ốc) đang bơi _con 9-10 kg_Minafood_MM0007",1405000,1405000,0,0
TIKI,ngon,181904834,"GẠO LỨT HUYẾT RỒNG NHÃN FAS LOẠI 1KG",45000,45000,0,0
TIKI,ngon,198606319,"Táo Xanh sz80 - 17,5 kg (Có hóa đơn VAT)",1800000,1800000,0,0
TIKI,ngon,198606408,"Cam Vàng Úc sz40 - 16 kg (Có hóa đơn VAT)",2000000,2000000,0,0
TIKI,ngon,197666201,"Niêu rươi kho Thịnh Phát - đặc sản Hải Phòng - 350g",240000,240000,0,0
TIKI,ngon,120860422,"Nước ép roi 350ml",55000,55000,0,0
TIKI,ngon,198606235,"Nho Ngón Tay Mỹ - 8,5 kg (Có hóa đơn VAT)",2400000,2400000,0,0
TIKI,ngon,120860428,"Nước ép bưởi 350ml",55000,55000,0,0
TIKI,ngon,173251690,"[Chỉ giao HN] - Vụn Cá Hồi Bao Xanh Xuất Nhật - 500g - Túi Hút Chân Không",189000,189000,0,0
TIKI,ngon,120866823,"Nước ép dứa 350ml",50000,50000,0,0
TIKI,ngon,121603694,"[ Chỉ giao HN] - Ghẹ thịt 500g",318000,318000,0,0
TIKI,ngon,197858883,"Khay Mực Ống Nguyên Con size ( 15-25cm) 500gr",190000,190000,0,0
TIKI,ngon,180327193,"[GIAO NHANH HN - 1H - 0989.780.789] Giỏ quà trái cây - MSG003",1650000,1650000,0,0
TIKI,ngon,121603648,"[ Chỉ giao HN] - Bề bề khơi bóc nõn nhỏ - 500g",234000,234000,0,0
TIKI,ngon,121603606,"[ Chỉ giao HN] - Viên cá hồi 250gr",64800,64800,0,0
TIKI,ngon,121603704,"[ Chỉ giao HN] - Nõn tôm Bộp 300g",198000,198000,0,0
TIKI,ngon,119988415,"Nem Chua Rán Tẩm Bột (20 Cái)",80000,80000,0,0
TIKI,ngon,205255261,"Bộ 3 dao làm bếp Mishop (Inox)",77500,77500,0,0
TIKI,ngon,123367823,"[Chỉ giao HN] Nem thịt Hà Thành ( hộp 10 chiếc)",80000,80000,0,0
TIKI,ngon,121603712,"[ Chỉ giao HN] - Mực ống nhỏ 500g",198000,198000,0,0
TIKI,ngon,198606228,"Táo Am Newz sz35 - 9 kg (Có hóa đơn VAT)",1550000,1550000,0,0
TIKI,ngon,121603617,"[ Chỉ giao HN] - Rong lá Hàn Quốc 20gr",54000,54000,0,0
TIKI,ngon,198606232,"Quýt Úc sz42 - 9 kg (Có hóa đơn VAT)",1500000,1500000,0,0
TIKI,ngon,205255284,"Vòi rửa bát lạnh Cao Cấp inox 304 cắm chậu (Gân)",125000,125000,0,0
TIKI,ngon,123400782,"[Chỉ giao HN] Thịt heo giả bò  khô 500g",249000,249000,0,0
TIKI,ngon,104771262,"[Chỉ giao HN] Cháo TomHumCa",55000,55000,0,0
TIKI,ngon,121980828,"Bánh Nướng Nhân Sầu Riêng - Vỏ Truyền Thống - Không Trứng Muối",50000,50000,0,0
TIKI,ngon,205255607,"Bếp hơ lá trầu cho bé, bếp điện mini 300W đun nước, pha trà, cafe, hâm sữa, đồ ăn nhanh, nấu lẩu An Toàn",115000,115000,0,0
TIKI,ngon,205255690,"Vòi rửa bát cắm tường cứng SM808 (Bạc)",455000,455000,0,0
TIKI,dong-ho-va-trang-suc,155925399,"Đồng Hồ Nam Dây Nhựa Casio Standard AE-1500WH-8BVDF Chính Hãng - AE-1500WH-8B",971250,1295000,323750,25
TIKI,ngon,205255784,"Vòi rửa bát lạnh Cao Cấp inox 304 cắm chậu (Cần cứng)",185000,185000,0,0
TIKI,dong-ho-va-trang-suc,73535800,"Hộp Đựng Đồng Hồ, Trang Sức 10 Ngăn MOHI MH4 - Hàng Chính Hãng",216200,235000,18800,8
TIKI,dong-ho-va-trang-suc,174182203,"Hoa (Bông) Tai Ngọc Trai Kiểu Nụ Ngọc Trai Thật Cao Cấp",250000,250000,0,0
TIKI,ngon,198606333,"Lê Sữa sz28 - 15 kg (Có hóa đơn VAT)",1450000,1450000,0,0
TIKI,ngon,205255556,"Vòi rửa bát ngỏng cứng nóng lạnh VBI-94",315000,315000,0,0
TIKI,dong-ho-va-trang-suc,74280144,"Đồng hồ trẻ em Silicon nhiều màu, đồng hồ điện tử thông minh cho bé E132 - Người nhện",43999,43999,0,0
TIKI,dong-ho-va-trang-suc,8295103,"Vòng cổ Ngọc Trai chuỗi ngọc trai nước ngọt thiên nhiên cao cấp DB-3904 Bảo Ngọc Jewelry",1111000,1350000,239000,18
TIKI,ngon,205255239,"Dụng cụ hỗ trợ nhà bếp bộ ba dao làm bếp handmade siêu sắc.",65000,65000,0,0
TIKI,ngon,205255909,"Nồi đất kho thịt-cá tráng men chịu nhiệt 1.5L (Đen)",125000,125000,0,0
TIKI,ngon,121603722,"[ Chỉ giao HN] - Rong nho 200g",78000,78000,0,0
TIKI,ngon,205256107,"Đèn Khò Ga Công Nghiệp Phi 4,8cm Cần Dài 58cm-Dây 142cm(size50)",155000,155000,0,0
TIKI,dong-ho-va-trang-suc,75609705,"Đồng Hồ Nữ Julius Hàn Quốc JA482 Dây Da Cá TÍnh",569000,569000,0,0
TIKI,dong-ho-va-trang-suc,74203364,"Đồng Hồ Nữ Julius Hàn Quốc JA544E Dây Da Cá Tính",459000,599000,140000,23
TIKI,dong-ho-va-trang-suc,58404714,"Nhẫn nữ đá mã não trắng mệnh thủy, kim - Ngọc Quý Gemstones",99000,189000,90000,48
TIKI,ngon,205255583,"Bộ 2 thảm chùi chân siêu thấm",55000,55000,0,0
TIKI,dong-ho-va-trang-suc,113373689,"Dây chuyền titan trái tim ghép hình cỏ 4 lá độc đáo - Trang sức Bé Heo BHDC258",70000,85000,15000,18
TIKI,dong-ho-va-trang-suc,12737657,"Vòng tay nam nữ 108 hạt 6 ly gỗ đàn hương",60000,60000,0,0
TIKI,dong-ho-va-trang-suc,194449182,"[5 Mét] Dây Cước Co Giãn Trong Suốt USA Magicline Dùng Xỏ Vòng Tay, Chuỗi Hạt, Trang Sức Lõi 0.6MM/ 0.7MM /0.8MM/1MM - Bead Art",20000,20000,0,0
TIKI,dong-ho-va-trang-suc,152564355,"Đồng hồ nam dây nhựa Casio Standard chính hãng F-91 & F-94 Series",380000,380000,0,0
TIKI,dong-ho-va-trang-suc,90719344,"Nhẫn nam trơn vuông nhiều màu thép không gỉ",12000,27000,15000,56
TIKI,dong-ho-va-trang-suc,135897574,"Dây đeo Xiaomi Mi Watch - Dây thép, khóa nam châm",130000,130000,0,0
TIKI,dong-ho-va-trang-suc,17967720,"Nhẫn nam mạ vàng 24k rồng vàng mặt đỏ N2",70000,70000,0,0
TIKI,ngon,205255905,"Lưỡi kìm cộng lực 42" - lưỡi kìm cộng lực 1050",195000,195000,0,0
TIKI,dong-ho-va-trang-suc,176074309,"Dây đồng hồ cao su silicon cao dấp dành cho Samsung Galaxy watch 3 45mm - Khóa đen",88110,88110,0,0
TIKI,ngon,121603595,"[ Chỉ giao HN] - Bề bề trứng 500g",300000,300000,0,0
TIKI,dong-ho-va-trang-suc,155925409,"Đồng Hồ Nam Dây Nhựa Casio Standard AE-1500WH-1AVDF Chính Hãng - AE-1500WH-1A",971250,1295000,323750,25
TIKI,dong-ho-va-trang-suc,144368397,"(1 CHIẾC) NHẪN ĐÔI TÌNH NHÂN INOX VK CK",23000,23000,0,0
TIKI,dong-ho-va-trang-suc,98634352,"Vòng tay cặp đôi trái tim",29900,29900,0,0
TIKI,dong-ho-va-trang-suc,192880293,"Cuộn dây co giãn xỏ vòng tay, đính cườm, xâu vòng cổ, xâu chuỗi, đàn hồi tốt, siêu bền",25000,50000,25000,50
TIKI,dong-ho-va-trang-suc,25059503,"Nhẫn nam titanium chạm rồng BHN80",37000,83000,46000,55
TIKI,dong-ho-va-trang-suc,59217491,"Đồng hồ thể thao thời trang nam chống nước Skmei 1416",189000,189000,0,0
TIKI,dong-ho-va-trang-suc,127219573,"Dây da đồng hồ Size 14 (Nhiều màu)",150000,150000,0,0
TIKI,dong-ho-va-trang-suc,111885604,"Đồng Hồ Unisex Chính Hãng Casio F-91W-1DG Dây Nhựa",492000,492000,0,0
TIKI,dong-ho-va-trang-suc,114300180,"đồng hồ nam đẹp Baishuns BS033 dây vàng chống nước chống xước,tặng kèm vòng may mắn",216000,255500,39500,15
TIKI,dong-ho-va-trang-suc,52060568,"Vòng tay may mắn vòng tay cặp nam nữ nhịp tim",80000,80000,0,0
TIKI,dong-ho-va-trang-suc,137940304,"Dây đeo cho Miband 6, Mi band 5 - Mijobs (DMJ6)",65000,65000,0,0
TIKI,ngon,205256088,"Vòi Lạnh Lavabo Lạnh Inox Sáng Bóng",89000,89000,0,0
TIKI,dong-ho-va-trang-suc,134412128,"Dây cho Huawei Watch 4/ 4 Pro/ 3/ 3 Pro/ GT2 Pro/ GT2 46mm/ GT/ GT2E/ GS Pro/ Magic (DSG)",140000,140000,0,0
TIKI,dong-ho-va-trang-suc,98634899,"Vòng tay cặp đôi ổ chìa khoá",58500,58500,0,0
TIKI,ngon,205255760,"Đèn pin chiếu sáng 128-004 (đen)",29000,29000,0,0
TIKI,dong-ho-va-trang-suc,113957568,"Đồng Hồ Nữ OLEVS Phong Cách Hàn Quốc Thanh Lịch, Mặt Kính Thạch Anh, Dây Thép Không Gỉ, Chống Nước Tốt, Đồng Hồ Nữ Dây Kim Loại - Tặng Kèm Hộp Cao Cấp Chính Hãng",675000,675000,0,0
TIKI,dong-ho-va-trang-suc,34279848,"Đồng hồ nam dây da Skmei 90TCK70",242000,255000,13000,5
TIKI,dong-ho-va-trang-suc,54925075,"Dây đồng hồ da bò loại mỏng, trơn mờ",130000,130000,0,0
TIKI,dong-ho-va-trang-suc,170846519,"Bộ   đồng hồ 3 món , mặt tròn màu trơn trang trí kim cương nhân tạo , phong cách thanh lịch thời trang cho nữ",219000,219000,0,0
TIKI,dong-ho-va-trang-suc,3244259,"Đồng Hồ Nam Dây Da SKMEI 9058 - DHA278",177000,220000,43000,20
TIKI,dong-ho-va-trang-suc,52172616,"Đồng hồ nữ Gristal Dream dây cao su phát sáng nhiều màu rất đẹp",29999,29999,0,0
TIKI,dong-ho-va-trang-suc,97902261,"Hộp đựng đồng hồ - Hộp đựng 12 đồng hồ 2 hàng bằng gỗ màu nâu",375000,375000,0,0
TIKI,ngon,205255688,"Nồi hấp inox Steam Cooker 30cm",405000,405000,0,0
TIKI,dong-ho-va-trang-suc,110868875,"Dây Da Thay Thế Dành Cho Đồng Hồ Fossil Casio Samsung Huawei Da Bò Thật Dây Handmade",200000,200000,0,0
TIKI,ngon,205255864,"15m-Dây Rửa Xe Cao Áp Dùng Cho Máy Rửa Xe Gia Đình 2 Đầu",165000,165000,0,0
TIKI,dong-ho-va-trang-suc,150602678,"Dây đeo Xiaomi Redmi Watch 2 Lite (DMILI2)",120000,120000,0,0
TIKI,dong-ho-va-trang-suc,87358887,"Đồng Hồ Thể Thao Nam SKMEI 1219 Phiên Bản Sport Chống Nước Tốt, Phong Cách Cực Chất",219900,219900,0,0
TIKI,dong-ho-va-trang-suc,141233382,"Vòng Tay Trầm Hương Chuỗi Tràng Hạt 108 6 7 8mm Trầm Tốc Việt - An Yên - Thịnh Vượng - Trầm Hương Tự Nhiên Tốc Việt",220000,220000,0,0
TIKI,ngon,177589517,"[Chỉ giao HN ] - Thức ăn cho mèo cá ngừ + gà trong thạch lon 170g",35000,35000,0,0
TIKI,ngon,273377930,"Rượu vang đỏ Úc River Retreat Cabernet Sauvignon Red Wine (14%/Vol)",386000,386000,0,0
TIKI,ngon,272043078,"Thịt Đầu Tôm Sú Vitot Hàng Chuẩn Organic Trọng Lượng 500gr, Thịt Tôm Dai, Giòn Sần Sật",159000,159000,0,0
TIKI,ngon,273787333,"Đặc Sản Nha Trang - Dứa Sấy Dẻo Không Đường Ngọt Thanh Tự Nhiên Thơm Ngon Seavy Gói 500gram",158000,160000,2000,1
TIKI,ngon,273301738,"Đặc Sản Nha Trang-Tép Biển Khô Sạch Cát Canxi Dồi Dào, Seavy Gói 250g",55000,55000,0,0
TIKI,ngon,272663074,"Đu đủ sấy dẻo 100g",53000,53000,0,0
TIKI,ngon,271063180,"[CHỈ BÁN HN] - HẾN SÔNG LA VITOT TRỌNG LƯỢNG 500GR SIÊU NGON, SIÊU TIỆN LỢI",169000,169000,0,0
TIKI,ngon,271118043,"KHÔ CÁ DỨA BABY VITOT PHƠI DẺO 2-3 NẮNG, ĐẶC SẢN CẦN GIỜ TRỌNG LƯỢNG 500GR",170000,170000,0,0
TIKI,ngon,172919165,"[Chỉ giao Hà Nội] - Gas Petro TOTALGAS 12kg",485000,485000,0,0
TIKI,ngon,271073774,"[CHỈ BÁN HN] - SET ỐC CHUỐI ĐẬU BA CHỈ VITOT, SIÊU NGON, SIÊU TIỆN LỢI",149000,149000,0,0
TIKI,ngon,206335519,"Combo 7kg rau củ sạch Vinh Hà",350000,350000,0,0
TIKI,ngon,141595617,"[Chỉ giao HN] - Cá Thu Cắt Khúc Ricofood - 500gr",140000,140000,0,0
TIKI,ngon,250929642,"Kem tươi Whipping Cream Avonmore 1L",130000,130000,0,0
TIKI,ngon,128707134,"[Chỉ giao HN]Thịt bò Black Angus Oino 200+ - Ribeyes ( Thăn Lưng Đầu) - 1KG",1500000,1500000,0,0
TIKI,ngon,273498204,"Rượu vang đỏ Úc Estate Merlot Red Wine (13.5%/Vol)",561000,561000,0,0
TIKI,ngon,113216388,"Tôm chiên Hoàng bào - 400g",420000,420000,0,0
TIKI,ngon,127805184,"Sườn Nướng Sốt Khói - 1 Suất",60000,60000,0,0
TIKI,ngon,169004153,"Dây Đai Mỏng 1cm Cho Chó Mèo Kún Miu - Giao Màu Ngẫu Nhiên",10000,10000,0,0
TIKI,ngon,253258897,"[Chỉ giao HN] Nấm Hương Khô Size M - Gói 300g/500g",210000,210000,0,0
TIKI,ngon,262046512,"Combo Chanh leo sấy dẻo [100g] & Dứa sấy dẻo [100g] - Trái cây sấy dẻo Nafoods",86000,86000,0,0
TIKI,ngon,251066203,"Kem tươi Whipping cream Tatua 1L",160000,160000,0,0
TIKI,ngon,92380642,"Thịt cốt lết heo đen Iberico (khay 300g)",245000,272000,27000,10
TIKI,ngon,208319001,"Chăn ủ xô nhăn 4 lớp có mũ, có tai Mipbi 70x70cm",190000,190000,0,0
TIKI,ngon,113216350,"Xôi Bạch Tuyết - 700g",100000,100000,0,0
TIKI,ngon,169062482,"BANH CHUÔNG ĐỒ CHƠI CHO MÈO",4000,4000,0,0
TIKI,ngon,173191092,"[Chỉ giao HN] - Lạp Xưởng Tây Bắc - 500g - Hút Chân Không",150000,150000,0,0
TIKI,ngon,179711580,"[Chỉ giao HN] - Nước chanh tươi - size S (325ml)",34000,34000,0,0
TIKI,ngon,141597839,"[Chỉ giao HN] - Bề Bề Nõn Ricofood - 300gr",130000,130000,0,0
TIKI,ngon,242719059,"Combo Lẩu hải sản",338000,429000,91000,21
TIKI,ngon,208317768,"INOCHI Bộ 4 Hộp Đựng Thực Phẩm Hokkaido nhựa nguyên sinh kháng khuẩn, không mùi dùng trong lò vi sóng nhiều hình dạng",119000,119000,0,0
TIKI,ngon,179711744,"[Chỉ giao HN] - Nước ép cóc ổi - size M (550ml)",78000,78000,0,0
TIKI,ngon,170180871,"Dây + Vòng Cổ Size M (Lớn)(1 sản phẩm)",31000,31000,0,0
TIKI,ngon,140865570,"[ Chỉ giao HN] -  Bánh Mousse Dâu tây Size 18cm",385000,385000,0,0
TIKI,ngon,208317991,"Khăn ủ 1 lớp 2 lớp sơ sinh Mipbi",89000,89000,0,0
TIKI,ngon,166062931,"Sữa Tắm Olive Essence 450ml Cho Chó Mèo - 7. Cho mèo",50000,50000,0,0
TIKI,ngon,197562666,"Nước lẩu Mala Manwal 1kg",125000,125000,0,0
TIKI,ngon,166057998,"Thức ăn khô cho chó trưởng thành Classic Pets vị thịt bò  - 400g",18000,18000,0,0
TIKI,ngon,166062809,"Pate Cho Mèo Me-O Delite Gói 70g - Hồng",19000,19000,0,0
TIKI,ngon,179711718,"[Chỉ giao HN] - Nước ép cóc - size L (1000ml)",131000,131000,0,0
TIKI,ngon,198606328,"Bưởi Da Xanh (1 thùng 12quả 20,5-21kg) (Có hóa đơn VAT)",1600000,1600000,0,0
TIKI,dong-ho-va-trang-suc,129734368,"Vòng cổ dây chuyền vải dù đeo cổ cao cấp thời trang siêu bền đẹp",18000,18000,0,0
TIKI,dong-ho-va-trang-suc,62758016,"Lắc tay | Lắc tay nữ hình cánh bướm xinh XBL45 - Bảo Ngọc Jewelry",110000,110000,0,0
TIKI,dong-ho-va-trang-suc,77558227,"Bộ trang sức ngọc 2 món hình giọt nước BHB86",161509,170009,8500,5
TIKI,dong-ho-va-trang-suc,44032664,"Đồng hồ nam điện tử thể thao SKMEI SK30 chống sốc chống nước, bơi lội thoải mái",177000,285000,108000,38
TIKI,dong-ho-va-trang-suc,26075426,"Nhẫn nam đính xoàn mạ vàng 24k HUH021CD",98500,98500,0,0
TIKI,dong-ho-va-trang-suc,48192183,"Đồng Hồ Nam Halei Dây Da Số La Mã",232750,245000,12250,5
TIKI,dong-ho-va-trang-suc,204282180,"Vòng tay hoa sen đá ngọc bích phong thủy trầm hương HÀ XÁ vòng đeo tay cặp đôi nam nữ may mắn tài lộc",250000,500000,250000,50
TIKI,dong-ho-va-trang-suc,90576435,"Vòng, lắc tay cho bé gái hình con vật, trái cây, trà sữa",25000,25000,0,0
TIKI,dong-ho-va-trang-suc,190181201,"Dây đeo Apple Watch series 9/ 8/ 7/ 6/ 5/ 4/ 3/ SE/ Ultra/ Ultra 2 49mm (DAWB)",150000,150000,0,0
TIKI,dong-ho-va-trang-suc,79467910,"Đồng Hồ Nữ Julius Hàn Quốc JA732A Dây Thép Mesh Thanh Lịch",770000,770000,0,0
TIKI,dong-ho-va-trang-suc,20102436,"Bông tai nam châm",33000,33000,0,0
TIKI,dong-ho-va-trang-suc,137552544,"Vòng cổ dây chuyền dù 3ly bền đẹp đính đá thời trang màu nâu - phụ kiện dây dù đeo cổ MS05112021",18000,18000,0,0
TIKI,dong-ho-va-trang-suc,48564675,"Dây chuyền | Dây chuyền bạc | Dây Chuyền Bạc Nữ Hình Bông Tuyết Trắng - Vòng Cổ Bạc Cho Nữ M1569 Bảo Ngọc Jewelry",240000,240000,0,0
TIKI,dong-ho-va-trang-suc,94887456,"Dây Chuyền Nữ, Dây Chuyền Bạc S925 Vầng Trăng Khuyết Đính Đá - DB2615 - Bảo Ngọc Jewelry",280000,280000,0,0
TIKI,dong-ho-va-trang-suc,178029964,"Dây đồng hồ da bò cao cấp OULANG nhiều size kèm khóa bướm ĐÔi thép không gỉ 316L (Khóa Vàng hồng)",132000,132000,0,0
TIKI,dong-ho-va-trang-suc,55725530,"Combo Nhẫn nam Phong Thủy kèm Hộp đựng lót Nỉ, Khắc Chữ CÁT TƯỜNG, Chữ PHÁT, Chữ LỘC, Hợp Kim không rỉ, mạ vàng 18K, Size Nhẫn 18, Phù Hợp Nam Từ 55 – 80kg",77000,87000,10000,11
TIKI,dong-ho-va-trang-suc,37139753,"Bông Tai Nam Nữ 1 Hạt Đá  Chất Liệu Thép Titan Không Đen Không Dị Ứng TT 1689",19000,44000,25000,57
TIKI,dong-ho-va-trang-suc,48223376,"Dây chuyền | Dây chuyền nữ | Dây Chuyền Bạc S925 Đá Aqua Cho Nữ - DB2365 - Bảo Ngọc Jewelry",375000,375000,0,0
TIKI,dong-ho-va-trang-suc,17010183,"Dây chuyền nam mạ Vàng 24k đốt trúc D8",97000,109000,12000,11
TIKI,dong-ho-va-trang-suc,647383,"Đồng Hồ Nam Dây Da SKMEI 90KCN58 SKE9058-DDD01-01C (Tặng Pin Nhật Và Móc Khóa Khôi Nguyên)",284050,299000,14950,5
TIKI,dong-ho-va-trang-suc,100796375,"vòng tay nam châm phi hành gia",18500,18500,0,0
TIKI,dong-ho-va-trang-suc,26062595,"Nhẫn Nam Bảng Vuông Mạ Vàng 18K - Có 05 Mẫu Cho Quý Khách Lựa Chọn",120000,120000,0,0
TIKI,dong-ho-va-trang-suc,51437655,"Nhẫn Bạc Nữ - Nhẫn Nữ Đính Đá Tự Nhiên N2460",236000,236000,0,0
TIKI,dong-ho-va-trang-suc,137906913,"đồng hồ thơi trang nữ kasiqi cao cấp GTA123",32000,32000,0,0
TIKI,dong-ho-va-trang-suc,22976410,"Vòng tay dâu tằm",25000,25000,0,0
TIKI,dong-ho-va-trang-suc,6997447,"Hộp đựng đồng hồ cao cấp 12 chiếc da PU ",174000,195000,21000,11
TIKI,dong-ho-va-trang-suc,83369106,"Khuyên tai ngọc trai tự nhiên nước ngọt 100%, bông tai ngọc trai nụ đơn giản hay kết hợp với vòng cổ ngọc trai 2510",345000,345000,0,0
TIKI,dong-ho-va-trang-suc,37012811,"Dây Da Đồng Hồ Da Bò - Dây Đeo Đồng Hồ SAM Leather SAM001NW",249000,249000,0,0
TIKI,dong-ho-va-trang-suc,84750921,"Dây đeo cổ bằng vải dù - Ngọc Quý Gemstones",10000,20000,10000,50
TIKI,dong-ho-va-trang-suc,46242432,"Dây chuyền nam",75000,75000,0,0
TIKI,dong-ho-va-trang-suc,14926740,"Dây Chuyền Ngọc Trai Cao Cấp DB2337 Cỡ Hạt 7x7 Bảo Ngọc Jewelry",400000,400000,0,0
TIKI,dong-ho-va-trang-suc,52249680,"Dây đồng hồ da bò cao cấp tặng Hộp Gỗ kèm khóa bướm thép không gỉ 316L (Nhiều màu)",89499,89499,0,0
TIKI,dong-ho-va-trang-suc,98634827,"Vòng tay HandMade cặp đôi",52000,52000,0,0
TIKI,dong-ho-va-trang-suc,11279807,"Nhẫn nam titan đá xanh cực đẹp",29000,29000,0,0
TIKI,dong-ho-va-trang-suc,196207255,"Dây silicon thời trang dành cho đồng hồ Amazfit Bip",59000,59000,0,0
TIKI,dong-ho-va-trang-suc,145763567,"Dây Mesh Lưới Cho Đồng Hồ Fossil Casio Samsung Huawei [Tặng Chốt thông minh & Dụng cụ tháo lắp",120000,120000,0,0
TIKI,dong-ho-va-trang-suc,10787668,"Dây da đồng hồ nam nữ da bò thật dập vân cá sấu bền đẹp",48000,48000,0,0
TIKI,dong-ho-va-trang-suc,45850777,"Đồng hồ nam HALEI 564 mặt vuông thời trang cao cấp",379000,399000,20000,5
TIKI,dong-ho-va-trang-suc,42700970,"Đồng hồ đeo tay nam nữ JIS unisex thời trang DH66",53699,53699,0,0
TIKI,dong-ho-va-trang-suc,162154641,"Đồng Hồ Nữ JA-979D Julius Hàn Quốc Dây Da (Xanh)",619000,619000,0,0
TIKI,ngon,85753005,"Mặt thắt lưng nam khóa tự động D&D Fashion",50000,100000,50000,50
TIKI,ngon,168236584,"cài bờm tóc giả tết bính to 4cm",189000,189000,0,0
TIKI,ngon,52627083,"Tóc giả nữ cột xù 60cm C168 FREESHIP Tóc cột xù mì, buộc tóc giả, cột tóc giả, tóc giả buộc",49000,49000,0,0
TIKI,ngon,53057339,"Kính viễn thị lão thị titan siêu nhẹ cực ôm mặt kiểu dáng thể thao nam tính kv991http",219000,219000,0,0
TIKI,ngon,7959630,"Mũ Tai Bèo Bucket Trơn - Đen",25000,25000,0,0
TIKI,ngon,59388082,"Bờm cài tóc nam nữ phong cách trẻ trung",25000,25000,0,0
TIKI,ngon,6129123,"Bộ sản phẩm kính mắt đa tròng 5 in 1 kèm bao da",175000,197000,22000,11
TIKI,ngon,191358016,"Mũ rộng vành nam tai bèo thêu chữ Columbia, may 2 lớp chống nóng tốt, dây quai rút dễ dàng, vành rộng 8.5cm - Hạnh Dương",76000,76000,0,0
TIKI,ngon,58034056,"Dây buộc tóc lụa mềm vintage Scrunchies loại đẹp HD53",29000,29000,0,0
TIKI,ngon,175412930,"Kim cong khâu thú y khâu da",3000,3000,0,0
TIKI,ngon,121106861,"DÂY ĐAI QUẦN CHỮ Y - DÂY YẾM QUẦN - ĐỦ MÀU NAM NỮ",69000,69000,0,0
TIKI,ngon,74997619,"Thắt lưng nam, dây nịt nam TOPEE khóa tự động dây da cao cấp TP089 - Mẫu HOT",278000,278000,0,0
TIKI,ngon,173568000,"Cài tóc nam nữ - Cài tóc dẻo - cài chia tóc mẫu mới",25000,25000,0,0
TIKI,ngon,22670781,"NÓN MŨ ĐI BIỂN ĐẸP - DN19VN0715",94050,99000,4950,5
TIKI,ngon,176692544,"Quần tất Nhật SABRINA Tough chống xước siêu dai bền đẹp dùng 4 mùa",125000,125000,0,0
TIKI,ngon,192207758,"Mũ đi biển nón rộng vành nữ đẹp thời trang Hàn Quốc nhiều mẫu dona220701",151000,159000,8000,5
TIKI,ngon,152376971,"Mũ tai bèo có dây rút trơn BK66 phong cách tối giản cho cả nam và nữ",195000,250000,55000,22
TIKI,ngon,2385127,"Găng tay nữ chống nắng UPF50+ xanh da trời Zigzag GLV00303 size",199000,199000,0,0
TIKI,ngon,86166266," MÁI THƯA CÓ MAI SIÊU ĐẸP KÈM ẢNH THẬT, CLIP THẬT",19000,19000,0,0
TIKI,ngon,177595545,"Hộp đựng kính mắt Braby lót nhung mềm mại chống xước, chất liệu hộp da cao cấp bền đẹp, chống va đập",25000,28000,3000,11
TIKI,ngon,196675854,"Thắt Lưng Ngọc Trai Nịt Móc Xích Chuỗi Hạt Đeo Eo Body Ngọc Trai Dây Kim Loại Mạ Vàng Đầm Váy",28000,28000,0,0
TIKI,ngon,87022922,"Thắt lưng/ dây nịt nam da bò nguyên miếng cao cấp Mã TL.8208",219000,259000,40000,15
TIKI,ngon,120169123,"Trâm cài tóc bằng gỗ Cẩm Lai/Trắc (Đủ kiểu dáng) HH600 - phong cách cổ trang, điêu khắc sang chảnh HOT TREND cho nữ  - HAHANCO",33000,33000,0,0
TIKI,ngon,86573206,"Găng Tay Chống Tia UV Nam Nữ Hàn Quốc",16000,20000,4000,20
TIKI,ngon,162209950,"Găng tay ren dài quyến rũ cho nữ",45000,45000,0,0
TIKI,ngon,82702320,"Găng tay len",70000,70000,0,0
TIKI,ngon,83617366,"Khẩu trang ninja vải nỉ kính bảo vệ mắt dán gáy che kín tai chạy xe phượt nam nữ - khau trang ni - Hồng che cổ kính",49000,49000,0,0
TIKI,ngon,150360346,"Trâm Cài Áo Nữ Hình Bó Hoa TCA11",50000,70800,20800,29
TIKI,ngon,191648212,"Voan cài tóc cô dâu màu da ngắn ngang lưng điểm đá hạt bẹt GiangPKC",120000,120000,0,0
TIKI,ngon,1716729,"Gọng Kính V-IDOL V8069 SBG (53/17/141)",175000,340000,165000,49
TIKI,ngon,72665730,"Khăn Choàng Lụa Tổng Hợp HN010 - Size 90cm X 180cm",208000,208000,0,0
TIKI,ngon,45690934,"Nón len nữ, mũ len nữ thời trang Hàn Quốc dn19122402",55000,55000,0,0
TIKI,ngon,75789827," Khăn turban satin vuông size 48*48cm mẫu mới 2020 - Khăn quàng cổ thời trang",45000,45000,0,0
TIKI,ngon,81139119,"Nón Kết Nam Nữ Thời Trang, Nón Lưỡi Trai Thêu Chữ Chất Vải Đẹp",48500,48500,0,0
TIKI,ngon,7349543,"Set 3 quần tất chống xước Regart 20D màu da chân (Freesize)",222000,250000,28000,11
TIKI,ngon,138676623,"Hộp 4 đôi tất vớ nam cổ ngắn GOMTAT chất sợi tre cao cấp, mềm mại thoáng mát, khử mùi kháng khuẩn - GOMTAT-SOITRE-NGAN",132000,200000,68000,34
TIKI,ngon,103856500,"Bộ 02 Ống Tay Chống Nắng, Găng Tay Chống Nắng Hàn Quốc Bằng Chất Liệu Vải Lụa Cao Cấp Siêu Mát",55000,55000,0,0
TIKI,ngon,88993407,"MẶT KHÓA THẮT LƯNG NAM KHÓA TÌ TRƯỢT TỰ ĐỘNG CHO DÂY RỘNG 3,5 CM (KO KÈM DÂY)",99000,99000,0,0
TIKI,ngon,96315314,"Nón cói đi biển panama mũ cói thời trang tua rua thổ cẩm nhiều màu",161000,161000,0,0
TIKI,ngon,162405278,"XƯỚC ĐỘN MÁI PHỒNG CHO TÓC ",20000,20000,0,0
TIKI,dong-ho-va-trang-suc,50483842,"Đồng hồ cơ nam Forsining 1030 lộ máy có dây da và dây thép không gỉ",395000,395000,0,0
TIKI,dong-ho-va-trang-suc,137751880,"Nhẫn Thần Chú Om Mani Padme Hum Titan không đen xoay 360 độ - Trang sức Bé Heo BHN129",58000,82000,24000,29
TIKI,dong-ho-va-trang-suc,25620073,"Nhẫn Nam Họa Tiết Lion King Đính Đá",108000,108000,0,0
TIKI,dong-ho-va-trang-suc,7886356,"Bông tai nam châm inox 8mm NC108 (Màu Đen) - 2 chiếc",39900,39900,0,0
TIKI,dong-ho-va-trang-suc,47252045,"Nhẫn cảm biến nhiệt - Nhẫn  hiển thị nhiệt độ cơ thể màu mới",35000,35000,0,0
TIKI,dong-ho-va-trang-suc,73258372,"Dây dù phụ kiện trang sức - Vòng cổ dây dù - Dây vải bện - Vòng cổ dây dù",18000,18000,0,0
TIKI,dong-ho-va-trang-suc,46629197,"Bông tai nam Thánh giá mẫu cổ",35000,35000,0,0
TIKI,dong-ho-va-trang-suc,73998178,"Vòng Tay Phong Thủy Nam Nữ - Vòng Tay Gỗ Đàn Hương 10mm",80000,80000,0,0
TIKI,dong-ho-va-trang-suc,73653236,"Đồng hồ thời trang nam nữ Candycat he4 dây dù 3 màu ngộ nghĩnh cực hot 6faq - Không kèm vòng tay",30000,30000,0,0
TIKI,dong-ho-va-trang-suc,208642661,"Khuyên tai kẹp Nam Nữ GIÁ 1 CHIẾC, khuyên mũi, môi Bông Tai Camcam không cần xỏ nam nữ Hoa tai unisex tròn Circle basic",13000,13000,0,0
TIKI,dong-ho-va-trang-suc,64038554,"Chốt dây đồng hồ SAM Leather SAMCDH001 bộ 10 chiếc",38000,38000,0,0
TIKI,dong-ho-va-trang-suc,74688943,"Vòng đeo tay phật giáo phong thủy, tràng hạt gỗ hương, vòng gỗ phong thủy mã VGH",269000,429000,160000,37
TIKI,dong-ho-va-trang-suc,35459904,"Nhẫn Xoay Khắc Chú Trừ Tà Om Mani Padme Hum Titan Không Rỉ TT 1782",95000,95000,0,0
TIKI,dong-ho-va-trang-suc,82877750,"Dây đeo cổ dạng rút điều chỉnh kích thước - Ngọc Quý Gemstones",20000,40000,20000,50
TIKI,dong-ho-va-trang-suc,196207747,"Dây silicon cao dấp dành cho Garmin Venu/ Garmin Venu 2",84000,84000,0,0
TIKI,dong-ho-va-trang-suc,7809362,"Mặt Phật Văn Thù Bồ Tát thạch anh đỏ 3.6cm - Phật bản mệnh tuổi Mão",200000,200000,0,0
TIKI,dong-ho-va-trang-suc,178028235,"Vỉ 10 Pin cúc áo VINNIC AG13 / L1154 / A76 / 357 / LR44W Chính hãng dùng cho đồng hồ đeo tay, thiết bị điện tử",15000,15000,0,0
TIKI,dong-ho-va-trang-suc,48280343,"Dây đồng hồ da bò sáp ngựa điên Handmade kèm khóa",129000,129000,0,0
TIKI,dong-ho-va-trang-suc,143839272,"Dây đồng hồ nam da đà điểu Bụi Leather D104 - Da thật khâu tay thủ công cao cấp - Bảo hành 12 tháng",191000,350000,159000,45
TIKI,dong-ho-va-trang-suc,75514298,"Đồng hồ thời trang nữ M655 dây kim loại đính đá nhân tạo - không kèm vòng tay",85000,85000,0,0
TIKI,dong-ho-va-trang-suc,178030015,"DÂY DA ĐỒNG HỒ DA BÒ KHÓA BƯỚM CAO CẤP 316L (HỘP GỖ)",41000,41000,0,0
TIKI,dong-ho-va-trang-suc,50090608,"Đồng Hồ Nam Máy Cơ Tevise 795A",475000,475000,0,0
TIKI,dong-ho-va-trang-suc,176073123,"Dây silicon thể thao mềm mại dành cho các loại đồng hồ size dây 20/22mm",135000,135000,0,0
TIKI,dong-ho-va-trang-suc,195951272,"NHẪN NAM INOX MẶT ĐEN 6MM THÉP KHÔNG GỈ",32000,32000,0,0
TIKI,dong-ho-va-trang-suc,65580383,"Vòng tay chỉ đỏ đính ngọc cầu an",18000,19000,1000,5
TIKI,dong-ho-va-trang-suc,164055698,"đồng hồ bé trai - đồng hồ conan - mẫu ngẫu nhiên",100000,100000,0,0
TIKI,dong-ho-va-trang-suc,37940902,"Đồng hồ hàn quốc Julius nữ JA-1112",599000,599000,0,0
TIKI,dong-ho-va-trang-suc,44180436,"Đồng hồ nam dây nhựa Casio G-Shock chính hãng GA-2100-1A1DR",2829000,3628000,799000,22
TIKI,dong-ho-va-trang-suc,10933205,"Vòng cổ choker tattoo V48",16000,16000,0,0
TIKI,dong-ho-va-trang-suc,98954310,"Vòng dâu tằm cho bé vòng dâu giúp bé ngủ ngoan, tránh giật mình vòng đeo cho trẻ sơ sinh",7000,7000,0,0
TIKI,dong-ho-va-trang-suc,106389979,"Bộ Dụng Cụ Tháo Mắt Dây Đồng Hồ Chuyên Dụng Chất Lượng Cao",135000,135000,0,0
TIKI,dong-ho-va-trang-suc,148806003,"Thiết bị tháo mắt dây đồng hồ, Dụng cụ cắt mắt dây đồng hồ",10000,10000,0,0
TIKI,dong-ho-va-trang-suc,66621454,"Đồng Hồ Nữ Julius Hàn Quốc JA-1276 Thời Trang Thể Thao Cá TÍnh",669000,989000,320000,32
TIKI,dong-ho-va-trang-suc,32983594,"Đồng hồ trẻ em",59000,59000,0,0
TIKI,dong-ho-va-trang-suc,15148097,"Vòng Tay 12 Cung Hoàng Đạo Dây Rút Vt03 (Mẫu Ngẫu Nhiên)",17900,17900,0,0
TIKI,dong-ho-va-trang-suc,177783809,"Đồng hồ thể thao trẻ em nữ CITIPLUS . Model: X-CAPTAIN G-2 chất lượng cao, chống nước, kiểu dáng sang trọng, trang nhã phù hợp với học sinh",148000,148000,0,0
TIKI,dong-ho-va-trang-suc,153066111,"5 Viên Pin Đồng Hồ SR626 / SR621 / SR716 / SR521 / SR616 / SR516 / SR721 / SR920 / SR927 Maxell Chính Hãng",80000,80000,0,0
TIKI,dong-ho-va-trang-suc,171070642,"Dây chuyền Phật Như Lai Đại Nhật lá đề bằng trái ngà- Tuổi Mùi, tuổi thân - MN01 (có dây đeo)",97000,150000,53000,35
TIKI,dong-ho-va-trang-suc,3680661,"Vòng tay Trầm hương tự nhiên 108 hạt - Đoạn trừ phiền não - Chuỗi hạt 108- Trầm Tốc Việt Nam tự nhiên 100% - Thiên Mộc Hương - 6mm",2116500,2490000,373500,15
TIKI,dong-ho-va-trang-suc,9881903,"Đồng Hồ Nữ JA-1017 Julius Hàn Quốc Dây Da",499000,690000,191000,28
TIKI,ngon,262797969,"Bò hầm cốt củ quả Truefood hộp 300g - BHCCQ",55000,55000,0,0
TIKI,ngon,139599281,"Sườn cánh buồm heo nhập khẩu 500g",80000,80000,0,0
TIKI,ngon,139599249,"Thịt ba chỉ heo Truefood nhập khẩu 500g [Chỉ giao hỏa tốc HN]",75000,75000,0,0
TIKI,ngon,117075273,"Thịt ba chỉ heo Truefood nhập khẩu 500g [Chỉ giao hỏa tốc HN]",75000,75000,0,0
TIKI,ngon,132815453,"Thịt bò xay TRF khay 200g[Chỉ giao hỏa tốc HN]",45000,45000,0,0
TIKI,ngon,186313825,"Phô mai viên Đôi Đũa Vàng 300g nhân Mozzarella tan chảy béo ngậy",169000,169000,0,0
TIKI,ngon,139599300,"[Chỉ Giao Hà Nội] Tim heo - quả",59000,59000,0,0
TIKI,ngon,176170730,"[ Chỉ giao HN] - Má đùi CP 500g khay",57500,57500,0,0
TIKI,ngon,129021482,"Cánh gà khúc giữa Truefood nhập khẩu 500g [Chỉ giao hỏa tốc HN]",65000,65000,0,0
TIKI,ngon,163554281,"[Chỉ giao HN] - Chân gà rút xương - Khay 1Kg - Net 550g",69000,94000,25000,27
TIKI,ngon,176170794,"[ Chỉ giao HN] - Ức file gà 2kg",275000,275000,0,0
TIKI,ngon,179371944,"Phô mai que kéo sợi Mozzarella thơm ngậy Đôi Đũa Vàng 300gr - Giao tại Hà Nội và Hồ Chí Minh",199000,199000,0,0
TIKI,ngon,179555623,"Nem chua rán Đôi Đũa Vàng đồ ăn vặt giòn rụm đặc sản phố cổ gói 240g",138000,138000,0,0
TIKI,ngon,117075296,"Cá nục Nhật 400-500g/con [Chỉ giao hỏa tốc HN]",65000,65000,0,0
TIKI,ngon,186279132,"Phô mai que rong biển Đôi Đũa Vàng 300g thơm ngon bổ dưỡng",249000,249000,0,0
TIKI,ngon,132815453,"Thịt bò xay TRF khay 200g[Chỉ giao hỏa tốc HN]",45000,45000,0,0
TIKI,ngon,117075279,"Cá ba sa nguyên con làm sạch cắt khúc 1kg [Chỉ giao hỏa tốc HN]",75000,75000,0,0
TIKI,ngon,115796502,"[CHỈ GIAO HN] - CỒI SÒ ĐIỆP VITOT FOOD (500g/ khay)",209000,209000,0,0
TIKI,ngon,173425191,"Bắp hoa trâu thái lát Truefood nhập khẩu 500g [Chỉ giao hỏa tốc HN]",120000,120000,0,0
TIKI,ngon,163554316,"[Chỉ giao HN] - Mực vòng - 1kg",64000,86000,22000,26
TIKI,ngon,215121619,"Dầu Ô Liu Nguyên Chất Chiết Lạnh Nước Cốt Đầu Dòng Classic - Can 3l",1250000,1250000,0,0
TIKI,ngon,139599283,"Sườn sụn heo 500g [Chỉ Giao Hà Nội]",89000,89000,0,0
TIKI,ngon,139599300,"[Chỉ Giao Hà Nội] Tim heo - quả",59000,59000,0,0
TIKI,ngon,193110655,"[Chỉ giao HN] - Thăn bò - Khay 1kg",145000,205000,60000,29
TIKI,ngon,139599287,"[Chỉ Giao Hà Nội] Nạc vai giòn heo 500g",75000,75000,0,0
TIKI,ngon,176170726,"[ Chỉ giao HN] - Dồi sụn non thượng hạng 500g",90000,90000,0,0
TIKI,ngon,167019300,"Thịt heo xay TRF 200gr [Chỉ giao hỏa tốc HN]",35000,35000,0,0
TIKI,ngon,115778173,"[CHỈ GIAO HN] - NEM CUA BỂ HẢI PHÒNG VITOT FOOD (1 khay 12 chiếc)",190000,190000,0,0
TIKI,ngon,163554302,"[Chỉ giao HN] - Cá viên Đức Việt - gói 500g",37000,58000,21000,36
TIKI,ngon,191424880,"Combo Delicious - Mua 1 tặng 1 Đồng Giá 69k - Mua Ức Gà, Tặng Gà Chiên Giòn",126000,126000,0,0
TIKI,ngon,163554279,"[Chỉ giao HN] - Ba chỉ heo có da rút xương - 1kg",105000,137000,32000,23
TIKI,ngon,117075296,"Cá nục Nhật 400-500g/con [Chỉ giao hỏa tốc HN]",65000,65000,0,0
TIKI,ngon,114197821,"[Chỉ giao HN] - Cá Basa Cắt Khúc Tươi Khay 1Kg Hút Chân Không",210000,210000,0,0
TIKI,ngon,163559325,"[Chỉ giao HN] - Cá trứng Nauy - Khay 500g",74000,74000,0,0
TIKI,ngon,195542716,"Cua đồng xay 200g nấu canh thơm mát ngọt tiện lợi [Chỉ giao HN]",29000,29000,0,0
TIKI,ngon,108903007,"[CHỈ GIAO HN] - TÔM LỘT TỰ NHIÊN VITOT FOOOD (500g/khay)",189000,189000,0,0
TIKI,ngon,176170748,"[ Chỉ giao HN] - Xúc xích Phô mai bucher 450g",122400,122400,0,0
TIKI,ngon,176170762,"[ Chỉ giao HN] - Bánh Bao Nhân Thit Heo Xá Xíu 500g",61000,61000,0,0
TIKI,ngon,163559329,"[Chỉ giao HN] - cánh gà khúc giữa - 1kg",105000,127000,22000,17
TIKI,ngon,115907785,"[CHỈ GIAO HN] - RUỐC TÔM THỊT VITOT FOOD (500h/ hộp)",179000,179000,0,0
TIKI,ngon,163565616,"[Chỉ giao HN] - Dồi sụn Hà Thành - gói 500g ",41000,64000,23000,36
TIKI,ngon,177705224,"Mực vòng túi 1kg [Chỉ giao hỏa tốc HN]",110000,110000,0,0
TIKI,ngon,193152191,"[Chỉ giao HN] - Thịt Heo Xay - Khay 500g",58000,67000,9000,13
TIKI,ngon,132815477,"Bắp bò Truefood nhập khẩu 500g [Chỉ giao hỏa tốc HN]",145000,145000,0,0
TIKI,ngon,176170736,"[ Chỉ giao HN] - Xúc Xích Vealz 3A Red 390",68000,68000,0,0
TIKI,ngon,176170792,"[ Chỉ giao HN] - Bánh bao sữa nhân trứng sữa 360gr",57500,57500,0,0
TIKI,ngon,176170764,"[ Chỉ giao HN] - Nem thịt đông lạnh 500g",90000,90000,0,0
TIKI,ngon,176170712,"[ Chỉ giao HN] - Bánh bao sữa nhân thịt heo BBQ 480gr",79000,79000,0,0
TIKI,ngon,176170787,"[ Chỉ giao HN] - Nem lụi ĐL 500g",97000,97000,0,0
TIKI,ngon,139599281,"Sườn cánh buồm heo nhập khẩu 500g",80000,80000,0,0
TIKI,ngon,163554324,"[Chỉ giao HN] - Bắp bò - 1,3kg",195000,241000,46000,19
TIKI,ngon,179711656,"[Chỉ giao HN] - Hạt kê tẻ Nam Định - 500gr",75000,75000,0,0
TIKI,ngon,156937388,"[ Chỉ giao HN] -Ruốc Nấm Hương Chay - 1kg",500000,500000,0,0
TIKI,ngon,179735161,"[Chỉ giao HN] Sốt nướng BBQ TRF 100ml",10000,10000,0,0
TIKI,ngon,179711480,"[Chỉ giao HN] -Đậu đỏ thuần chủng Sóc Sơn - 1kg",73000,73000,0,0
TIKI,ngon,180322245,"Nước mắm Tĩn Tôm Biển Hồng Ngọc Đại Dương độ đạm 45N chai thủy tinh 500ml/chai ngon nguyên chất không chất bảo quản",400000,400000,0,0
TIKI,ngon,120162012,"[Chỉ giao HN] Set tổng hợp 500gr",589000,589000,0,0
TIKI,ngon,108276832,"[Chỉ giao HN] - Giỏ trái cây A 803 - Giỏ",800000,800000,0,0
TIKI,ngon,160290625,"Dồi sụn non Ymmy 500g",68400,68400,0,0
TIKI,ngon,169075046,"[Combo 10 lọ] Nước Yến sào Khánh Hòa Sanest Collagen đóng lọ 70ml - 770",335000,335000,0,0
TIKI,ngon,189340038,"Chả mực giã tay Đôi Đũa Vàngđặc sản Hạ Long nguyên chất từ mực tươi 500g",450000,450000,0,0
TIKI,ngon,186084608,"Bình nước tự động gắn chuồng cho chó mèo",55000,55000,0,0
TIKI,ngon,175718234,"Thịt ba chỉ Lợn",140000,140000,0,0
TIKI,ngon,120442541,"[Chỉ giao HN] - Lườn Bụng Cá Hồi Đông Lạnh - 1Kg 2 Khay - Size Nhỏ",339000,339000,0,0
TIKI,ngon,180322218,"Nước mắm chay cao cấp Làng Chài Xưa nấm ngọt Shiitake Nhật Bản, đậu nành, thơm dứa chai thủy tinh 500ml/chai",190000,190000,0,0
TIKI,ngon,92370127,"Xúc xích Iberico Cebo - Salchichon muối cắt lát (100g)",164000,164000,0,0
TIKI,ngon,142315229,"[Chỉ giao HN] Tôm sú sinh thái Minh Phú size lớn hộp 1kg",796000,796000,0,0
TIKI,ngon,128124497,"Mực ống nháy - 1kg",340000,340000,0,0
TIKI,ngon,186084722,"Đồ Chơi Hình Con Gián Giả Cho mèo Vờn Giá siêu Siêu rẻ",4100,4100,0,0
TIKI,ngon,177153994,"[ Chỉ giao HN] - Thức ăn hạt hữu cơ cho chó vị cừu 400g (15gói/ túi)",95000,95000,0,0
TIKI,ngon,107971525,"[CHỈ GIAO HN] - CÁ THU CẮT KHÚC 1 NẮNG VITOT FOOD (3- 4 khúc/ kg)",359000,359000,0,0
TIKI,ngon,121603702,"[ Chỉ giao HN] - Gừng hồng 1kg",264000,264000,0,0
TIKI,ngon,184634186,"3G Thịt Ba có Rọi Da 300g",59000,59000,0,0
TIKI,ngon,179711781,"[Chỉ giao HN] - Nhân Macca Tây Nguyên - 1kg",920000,920000,0,0
TIKI,ngon,170179759,"Dây Đai Cho Chó Mèo Kún Miu (Rộng 1.5cm) - Giao Màu Ngẫu Nhiên",28000,28000,0,0
TIKI,ngon,129137386,"[Chỉ giao HN] Mỳ xào Yakisoba",96000,96000,0,0
TIKI,ngon,163554286,"[Chỉ giao HN] - Mực trứng size lớn - 1kg",208000,245000,37000,15
TIKI,phu-kien-thoi-trang,150561774,"Gọng kính 8081 nhựa cao cấp siêu bền thời trang nam nữ OURESS",270000,299000,29000,10
TIKI,ngon,128124550,"Ốc Hương 90-100 - 1kg",320000,320000,0,0
TIKI,ngon,186166171,"Giấy Nướng Đa Năng Hiệu Eufood 20cm (50 tờ/ túi) - EUFOOD Việt Nam - Cho Nồi Chiên Không Dầu",30000,30000,0,0
TIKI,ngon,126796318,"Tôm nõn sắt sống - gói 500gr",120000,120000,0,0
TIKI,ngon,126781206,"[Chỉ giao HN] Tỏi Gà K.F.C ( khay 4_5 chiếc )- 1Kg",75000,75000,0,0
TIKI,phu-kien-thoi-trang,117492074,"Vớ nữ cổ ngắn Vintage, Tất Nữ Cute sử dụng cả tuần - CB069",29000,39000,10000,26
TIKI,phu-kien-thoi-trang,197572099,"Kẹp Tóc Nơ Ren Đính Đá Phong Cách Hàn Quốc Thời Trang Cho Nữ",49000,49000,0,0
TIKI,ngon,169003813,"CÁT VỆ SINH HỮU CƠ CHO MÈO VÓN CỤC KHỬ MÙI VÀ VI TRÙNG CAT’S BEST ORIGINAL - 10L-4,3Kg",215000,215000,0,0
TIKI,phu-kien-thoi-trang,164075726,"Kính Lão, Kính Viễn 2 Tròng Gọng Khoan Sang Trọng Vừa Dùng Đi Đường Vừa Dùng Đọc Sách, Chống tia Uv400, Chống Lóa - BLUE LIGHT",185000,185000,0,0
TIKI,ngon,190745394,"Hộp 12 chai sữa hạt L'ORCHATA 236ml",660000,660000,0,0
TIKI,phu-kien-thoi-trang,26703801,"Sét 7 kẹp tóc mái nhiều kiểu cao cấp Song An Eco KAH96",24000,24000,0,0
TIKI,ngon,118101537,"[Chỉ giao HN] - Cá Hồi Fillet Sốt Kabayaki Xuất Nhật",289000,289000,0,0
TIKI,ngon,171307610,"[Chỉ giao HN] Váy cho chó mèo Váy cộc tay - Size L",66000,66000,0,0
TIKI,phu-kien-thoi-trang,137796889,"Bờm cài tóc hình chú ếch xanh xinh xắn - CoCoGift",31800,31800,0,0
TIKI,phu-kien-thoi-trang,73937793,"dây đeo khẩu trang, dây dù, dây vải dài 30 cm dây vải dù dễ dàng sử dụng, giúp bạn: - giữ cho khẩu trang của bạn luôn sạch sẽ trên người , không bỏ lung tung chỗ khác tránh làm mất - có nút thắt co giãn tốt giữ cho dây khẩu trang giãn ra tránh làm đau vàn",20000,20000,0,0
TIKI,ngon,125452821,"Lườn cá hồi sốt kabayaki túi 600gam ăn liền",199000,199000,0,0
TIKI,phu-kien-thoi-trang,127802971,"[Combo O] Dung Dịch Ngâm Kính Áp Tròng 360 ml + Nước Nhỏ Mắt Kính Áp Tròng 15 ml",200000,200000,0,0
TIKI,ngon,116553149,"[Chỉ giao HN] - Chả Mỡ Nướng Phố Cổ - 1Kg 2 Túi Hút Chân Không",229000,229000,0,0
TIKI,phu-kien-thoi-trang,193094564,"Kính Râm, Kính Mát Nam Nữ Mắt Khoan Vuông To Sang Trọng Mắt Xanh Dương, Nâu, Xanh Lá, Chống Chói, Tia UV - BLUE LIGHT",285000,285000,0,0
TIKI,ngon,120293175,"[Chỉ giao HN] - Sốt Me Chua Ngọt Nguyên Chất – 1 Hũ",219000,219000,0,0
TIKI,ngon,172148790,"Lá bạc hà - 200g ",17000,17000,0,0
TIKI,phu-kien-thoi-trang,120966405,"Hình xăm tạm thời bằng mực 20 ngày ( tổng hợp 50 mẫu siêu chất )",69000,69000,0,0
TIKI,ngon,108276804,"[Chỉ giao HN] - Giỏ trái cây A 600 - Giỏ",600000,600000,0,0
TIKI,phu-kien-thoi-trang,197572046,"Kẹp Tóc Hình Bướm Sang Trọng Bằng Hợp Kim Cho Nữ",55000,55000,0,0
TIKI,phu-kien-thoi-trang,73386725,"Kẹp tóc sau kim loại dạng dài trang trí tóc phong cách Vintage",24000,24000,0,0
TIKI,phu-kien-thoi-trang,102006857,"Miếng dán tóc trang điểm giúp cố định tóc khi rửa mặt",1500,1500,0,0
TIKI,ngon,171468329,"[Chỉ giao HN] Bàn cào móng cho mèo hình gợn sóng - 2 Sóng",64000,64000,0,0
TIKI,ngon,155240638,"[Chỉ giao HN] - Nem Bề Bề Nguyên Con - Hộp 10 Cái - Món Ngon Đãi Khách Tết",219000,219000,0,0
TIKI,ngon,118528551,"[Chỉ giao HN] - Sườn Nướng BBQ Ướp Sẵn - 1Kg 2 Khay",499000,499000,0,0
TIKI,phu-kien-thoi-trang,120664743,"Hình xăm dán có ba lá và sen 10x6cm+ quà tặng kèm",9000,11000,2000,18
TIKI,phu-kien-thoi-trang,45870273,"THẮT LƯNG NỮ DÂY NỊT NỮ MANG ĐẦM VÁY DN19122526",79000,99000,20000,20
TIKI,ngon,175950791,"Tôm thẻ tươi sz 40-50 con",300000,300000,0,0
TIKI,phu-kien-thoi-trang,76085326,"Buộc tóc nơ vải lụa 21cm style Hàn Quốc dễ thương",34900,34900,0,0
TIKI,ngon,104370008,"Set 8 macaron thường - 8 cái",130000,130000,0,0
TIKI,phu-kien-thoi-trang,193006668,"Khăn Rằn Nam Bộ - Campuchia/ Khăn Thời Trang NOMAC Đi Phượt, Du Lịch, Trekking/ Hàng Loại 1, Vải Dày Mềm Mịn/ Kích Thước Lớn 170 x 60cm/ MàU TRẮNG ĐEN",55000,55000,0,0
TIKI,phu-kien-thoi-trang,168236756,"Tóc line tóc giả kẹp light xoăn cao cấp chất tóc tơ nhật bản chịu nhiệt",26000,26000,0,0
TIKI,ngon,172173690,"Salad mix Địa Trung Hải- 200g",35000,35000,0,0
TIKI,phu-kien-thoi-trang,135269675,"Mũ tai bèo nam size đầu rộng thoải mái nón tai bèo lính vành to được đóng sò cao cấp kết hợp vải cotton",69000,69000,0,0
TIKI,ngon,170179959,"Xịt trị ve rận cho chó mèo Hantox Spray - 300ml",42999,42999,0,0
TIKI,ngon,169065050,"Dầu Tắm Trị Bọ Chét, Ve, Ghẻ, Rận Chó Mèo Hanvet Hantox 200ml - Hồng",39999,39999,0,0
TIKI,phu-kien-thoi-trang,139492274,"Quần Tất nữ 3D lưới đẹp và thật chân  hàng cao cấp loại 1",113999,113999,0,0
TIKI,phu-kien-thoi-trang,102888855,"Tóc giả mái thưa mai thẳng M02 Sỉ 14k",25000,25000,0,0
TIKI,phu-kien-thoi-trang,55570578,"Băng đô cài tóc màu trơn xanh đen coban phong cách Hàn Quốc",38500,38500,0,0
TIKI,phu-kien-thoi-trang,83617287,"Khẩu trang ninja vải nỉ kính bảo vệ mắt dán gáy che kín tai chạy xe phượt nam nữ - khau trang ni - Đen",35000,35000,0,0
TIKI,ngon,171330907,"[Chỉ giao HN] Áo ba lỗ mùa hè in hình cute doremon - XL",33000,33000,0,0
TIKI,ngon,160286691,"Hải sản ngũ sắc SG food 300g",57000,57000,0,0
TIKI,ngon,166083522,"Pate Smartheart cho chó gói 130g - Chó con",16999,16999,0,0
TIKI,phu-kien-thoi-trang,57084839,"Hộp đựng kính bằng da Pu tặng móc dán PKS",25000,25000,0,0
TIKI,ngon,127388341,"[Chỉ giao HN] Set lẩu sum vầy",299000,299000,0,0
TIKI,ngon,124040221,"[Chỉ giao HN] - Bưởi Da Xanh Bến Tre Loại 2 - Size 1-1.2Kg",169000,169000,0,0
TIKI,phu-kien-thoi-trang,165041792,"Nón beret, mũ nồi nam MN08 đẹp, chất liệu cotton cao cấp",149000,245000,96000,39
TIKI,phu-kien-thoi-trang,103886439,"Thắt Lưng Nam Da Bò Sáp Ngựa Điên Khóa Đồng TM259",420000,420000,0,0
TIKI,ngon,162475671,"[Chỉ giao HN] - Táo Jonagold Nhật sz 36  - 1KG",215000,215000,0,0
TIKI,ngon,185903892,"Cá Hồi Nauy Tươi Phile Phần Bụng + Phần Lưng Khay 500g",378000,378000,0,0
TIKI,phu-kien-thoi-trang,48626053,"Tất Da Chân Combo 10 Đôi Tất Vớ Hàn Quốc",24000,24000,0,0
TIKI,ngon,126243733,"GIÒN SẦN SẬT",80000,80000,0,0
TIKI,ngon,123576350,"chanh leo 500g",42000,42000,0,0
TIKI,ngon,117996340,"[Chỉ giao HN] - Râu Mực Tươi Ngon Đông Lạnh - 1Kg 2 Khay Hút Chân Không",409000,409000,0,0
TIKI,phu-kien-thoi-trang,76726599,"Kính mát nam chống nắng chống tia UV cao cấp AD68",175000,197000,22000,11
TIKI,phu-kien-thoi-trang,109367122,"Nút bấm áo dài ngôi sao vỉ 36 nút",45000,45000,0,0
TIKI,ngon,172297872,"Đường kính trắng xuất khẩu",27000,27000,0,0
TIKI,ngon,168989802,"Khay uống bán tự động mini cho Pet (Chó, mèo) - Xanh Dương",60000,60000,0,0
TIKI,ngon,184790617,"Bắp bò thái lát - 1kg",242000,242000,0,0
TIKI,phu-kien-thoi-trang,192861463,"Khăn buộc tóc Turban , quàng cổ, Cột Tóc, quấn túi",22000,22000,0,0
TIKI,phu-kien-thoi-trang,108412515,"Dây buộc tóc, dây cột tóc siêu xinh phong cách Hàn Quốc - Hàng nhập khẩu",2000,2000,0,0
TIKI,phu-kien-thoi-trang,72582017,"Kính Giả Cận, Gọng Kính Cận Nam Nữ Mắt Mèo Phối Màu Đen, Bạc, Vàng Không Độ Hàn Quốc - BLUE LIGHT SHOP",178000,178000,0,0
TIKI,ngon,121109509,"[Chỉ giao HN] - Trà Hoa Ngũ Cốc Loai 1 - Túi 1Kg",289000,289000,0,0
TIKI,ngon,179540778,"Nem kem bơ Đôi Đũa Vàng giòn tan thơm ngậy gói 250g",95000,95000,0,0
TIKI,phu-kien-thoi-trang,169472994,"KHẨU TRANG NINJA THÔNG HƠI DÁNG NGẮN TIỆN DỤNG",29000,29000,0,0
TIKI,ngon,141595621,"[Chỉ giao HN] - Chả Tôm Ricofood - 500gr",170000,170000,0,0
TIKI,ngon,164428761,"[ Chỉ giao HN] - Nem chua Thanh Hóa - 650g - 700g",60000,60000,0,0
TIKI,phu-kien-thoi-trang,171816758,"Tất Vớ Trơn Nam Nữ Cổ Cao, Cổ Trung, Cổ Ngắn Thời Trang Unisex Style Hàn Quốc - LISU",7900,15000,7100,47
TIKI,ngon,180322201,"Mắm nêm pha sẵn cao cấp Làng Chài Xưa, nguyên liệu tươi, thơm ngon đặc biệt, chai thủy tinh 300g",90000,90000,0,0
TIKI,ngon,116553161,"[Chỉ giao HN] - Cá Dưa Tẩm Ướp Sẵn - 1Kg 2 Khay Hút Chân Không",299000,299000,0,0
TIKI,ngon,169068275,"Dầu Tắm Trị Bọ Chét, Ve, Ghẻ, Rận Chó Mèo Hanvet Hantox  200ml - HỒNG",33000,33000,0,0
TIKI,phu-kien-thoi-trang,201126573,"Set Tất Trắng Cổ Cao Nữ Vớ Cao Cổ Tiêu Thư LOLITA Cổ Bèo Nhún Tất Vớ Nữ ULZZANG STYLE HÀN QUỐC Camcamvintage",24000,24000,0,0
TIKI,ngon,172919163,"[Chỉ giao Hà Nội] - Gas Petrol Việt Nam Hồng 12kg",470000,470000,0,0
TIKI,ngon,173359330,"Sữa Tắm SOS Cho Chó Mèo 530ml",85000,85000,0,0
TIKI,ngon,142315237,"[Chỉ giao HN] Phô mai Cheddar Anchor New Zealand gói 12 lát 200g (giàu canxi và đạm)",74000,74000,0,0
TIKI,ngon,144025849,"[CHỈ GIAO HN] - CHẢ CÁ A RICOFOOD - 300G",85000,85000,0,0
TIKI,phu-kien-thoi-trang,26389503,"Hình Xăm Dán Mặt Quỷ QSA064",48000,48000,0,0
TIKI,phu-kien-thoi-trang,102888257,"Tóc giả kẹp dải 5 phím xoăn 50cm, tóc kẹp nửa đầu F701B Sỉ 45k",60000,60000,0,0
TIKI,ngon,125900033,"[Chỉ Giao HN] Cá Tầm Sapa đang bơi_con 2-3 kg_Minafood_MM0009",499000,499000,0,0
TIKI,ngon,159728983,"[Chỉ giao HN] - Cá Nục Nhật làm sạch -  1kg",85000,85000,0,0
TIKI,ngon,196175724,"Combo gia vị bún bò huế 2 gói dạng bột và muối 500gr - chuẩn vị bún cố đô",165000,165000,0,0
TIKI,phu-kien-thoi-trang,181692528,"Lens xám tây Angel Eyes Fuji Gray có cận - GDia 12.8mm - Độ cận 0-8",200000,200000,0,0
TIKI,phu-kien-thoi-trang,140136268,"sét 50 cái khẩu trang kf94 chuẩn Hàn quốc",35000,35000,0,0
TIKI,ngon,160286553,"Set lẩu thái thượng hạng",96900,96900,0,0
TIKI,phu-kien-thoi-trang,85705173,"LAROMA khẩu trang chống nắng diệt khuẩn",39000,49000,10000,20
TIKI,phu-kien-thoi-trang,115893382,"GĂNG TAY CHỐNG NẮNG AQUAX KHÔNG XỎ MÀU ĐEN / VẢI DÀY DẶN, CHỐNG TIA UV 95%, CO DÃN THOÁNG MÁT",60000,70000,10000,14
TIKI,phu-kien-thoi-trang,177914942,"Tròng kính Cận - Viễn - Loạn - Lão Ouress",120000,120000,0,0
TIKI,ngon,160622139,"Cam vàng Úc ",133000,133000,0,0
TIKI,phu-kien-thoi-trang,119104408,"Chun buộc tóc màu đen - nhiều màu siêu dai 100gr",15000,15000,0,0
TIKI,ngon,180322217,"Nước mắm nhỉ 40 độ đạm Làng Chài Xưa chai thủy tinh 500ml ủ chượp 2 lần không chất bảo quản",150000,150000,0,0
TIKI,ngon,172216304,"Tương cà Heinz 120ml - Tomato Ketchup",17000,17000,0,0
TIKI,phu-kien-thoi-trang,72467500,"Kính Giả Cận, Gọng Kính Cận Nam Nữ Mắt Vuông Gọng Đen Không Độ Hàn Quốc - BLUE LIGHT SHOP",96000,135000,39000,29
TIKI,phu-kien-thoi-trang,177080829,"Tất Vớ Cổ Cao Nam Nữ, Tất Cao Cổ 25cm Chất Liệu Cotton Êm Mềm Đi Thoáng - FIVE-TAY10",39000,55000,16000,29
TIKI,phu-kien-thoi-trang,159049514,"Chun Cột Tóc Felling Màu Đen Gói Nhỏ Siêu Tiện Lợi",7900,7900,0,0
TIKI,ngon,108898157,"Ghim cài áo - lapel pin - Phụ kiện Trâm Cài Áo",99000,99000,0,0
TIKI,phu-kien-thoi-trang,89481415,"Thắt Lưng Nữ Da Thật Bản Nhỏ 2.3cm Aaa Jeans",249000,249000,0,0
TIKI,ngon,80699575,"Kẹp tóc càng cua đính ngọc trai nhân tạo nhiều mẫu phong cách Hàn Quốc - KT06",15000,15000,0,0
TIKI,phu-kien-thoi-trang,180585118,"Kẹp Tóc Nữ Dạng Thạch Trong Suốt Nhiều Màu Phong Cách Hàn Quốc Thanh Lịch Thời Trang",38000,40000,2000,5
TIKI,phu-kien-thoi-trang,100465457,"Đôi Tất Nam Cổ Ngắn, Kháng Khuẩn , Thấm Hút Mồ Hôi, Chất Liệu Cotton Mát",5000,8000,3000,38
TIKI,ngon,171833832,"[ Chỉ giao HN] -Snack sấy khô Da cá 100gr",45000,45000,0,0
TIKI,phu-kien-thoi-trang,96750797,"Nút sắt đóng quần jeans phụ kiện may mặc (gói 10 nút)",13000,13000,0,0
TIKI,phu-kien-thoi-trang,116167598,"Kính viễn thị cao cấp NQ007",200880,279000,78120,28
TIKI,phu-kien-thoi-trang,186110085,"Mũ cói mềm thắt nơ - nón cói vành sóng viền ren hạt ngọc chống nắng, đi biển phong cách",49000,98000,49000,50
TIKI,phu-kien-thoi-trang,134626075,"Nón kết ông địa Mũ lưỡi trai ( Mẫu Bán Chạy Nhất ) cực nét chuẩn lòng sâu ( nón thiết kế )",195000,195000,0,0
TIKI,ngon,160576116,"Quýt ÚC",150000,150000,0,0
TIKI,phu-kien-thoi-trang,145552797,"Khẩu Trang Vải 4D Nemo Collection, Chống Nắng, Lọc Khuẩn, Thoáng Khí Không Gây Mụn - KTXS",35750,55000,19250,35
TIKI,phu-kien-thoi-trang,99462762,"Kẹp búi tóc, kẹp tóc Hàn Quốc quấn tóc đính ngọc trai phong cách Hotgirl cực đẹp SC25",31900,31900,0,0
TIKI,phu-kien-thoi-trang,13407915,"Nón Bucket Unisex Mặt Cười Parisa",34000,34000,0,0
TIKI,ngon,37733507,"Sét 3 kẹp tóc mái Song An Eco KAH119",22000,22000,0,0
TIKI,phu-kien-thoi-trang,72464525,"Tất Thể Thao Redikick R360 Coolmax Cotton Nam Nữ Cổ Cao Vớ có đệm, Chống Trượt, Thoáng Khí, Chống hôi chân phù hợp chơi Bóng Rổ Bóng đá Bóng Chuyền Tennis Chạy Bộ Đá banh -Hàng Chính Hãng",159000,190000,31000,16
TIKI,phu-kien-thoi-trang,51907697,"Combo 6 khẩu trang vải ngăn bụi, ô nhiễm - Màu",36000,36000,0,0
TIKI,ngon,96312715,"Khăn Choàng Cổ Len (Khăn Len Dày) Cao Cấp Giữ Ấm Mùa Đông Trơn Phối Nhiều Màu - PJN.ARC - Mã LN001",145000,145000,0,0
TIKI,ngon,52038677,"Combo 2 Chiếc Tất, Vớ Bảo Vệ Chống Nứt Gót Chân Bằng Silicon",32000,32000,0,0
TIKI,phu-kien-thoi-trang,136354908,"Chụp lưới búi tóc tiện lợi gọn gàng",5000,5000,0,0
TIKI,phu-kien-thoi-trang,186738477,"Kính thời trang chữ V K0165 nhiều màu chống tia UV, chống bụi gọng nhựa vuông unisex nam nữ kính râm phong cách",22000,80000,58000,73
TIKI,ngon,196952111,"Kẹp Tóc Càng Cua Đính Hạt Nhân Tạo Phong Cách Hàn Quốc Họa Tiết Chữ - Mã KT005",25000,25000,0,0
TIKI,phu-kien-thoi-trang,113020356,"Kính Mát ,Mắt Kính Unisex ASARIFA RP3026 Nhiều Màu ",171000,180000,9000,5
TIKI,phu-kien-thoi-trang,207811584,"Kính Giả Cận, Gọng Kính Cận Nam Nữ Mắt Tròn Gọng Đen Không Độ Hàn Quốc - BLUE LIGHT SHOP",165000,165000,0,0
TIKI,ngon,215111451,"Dầu Ô Liu Nguyên Chất Chiết Lạnh Nước Cốt Đầu Dòng Classic - 750ml",400000,400000,0,0
TIKI,ngon,160788638,"Vớ thể thao unisex Sofsole - 20288 (3 đôi đen + 3 đôi trắng)",149000,349000,200000,57
TIKI,ngon,214766201,"Nem chua - Cái 200g",33000,33000,0,0
TIKI,phu-kien-thoi-trang,77638985,"Nón kết trơn không thêu họa tiết, chất liệu vải cotton pha polyester giúp giữ phom nón, freesize - Hạnh Dương",22000,22000,0,0
TIKI,ngon,188854634,"Bờm cài tóc bản to dễ thương",45000,45000,0,0
TIKI,ngon,59013211,"GĂNG TAY NỮ ĐA NĂNG , BAO TAY NỮ GIỮ ẤM DN20080502",59000,59000,0,0
TIKI,ngon,76048642,"Khăn lụa dài thời trang size 145x7cm",70000,70000,0,0
TIKI,ngon,44911430,"Bờm cài tóc - Băng đô cài tóc Noel Giáng Sinh Merry Christmas",39000,39000,0,0
TIKI,ngon,208318875,"Bộ 2 sách vải cho bé chơi mà học Pipo - Sinh vật biển và động vật ăn thịt",90000,90000,0,0
TIKI,ngon,97948039,"Cà Vạt Hội Nghị 7cm FITTOP CAVAT-132",250000,250000,0,0
TIKI,ngon,15463620,"Sét túi 9 dây buộc tóc và kẹp tóc cao cấp xuất Nhật HD21",59000,59000,0,0
TIKI,ngon,141200578,"Kính viễn thị cao cấp PNQ02",128880,179000,50120,28
TIKI,ngon,96311975,"Khăn Lụa Vuông (Khăn Turban) Cao Cấp Họa Tiết Đồng Quê Thanh Lịch - Chất Liệu Chiffon - 70x70cm - Mã KL031",82500,82500,0,0
TIKI,ngon,214766194,"Chả nạc - 1kg chưa rán",230000,230000,0,0
TIKI,ngon,51663438,"( P103 ) Tóc giả nữ ngoặm xoăn lững, tóc giả kẹp",150000,150000,0,0
TIKI,phu-kien-thoi-trang,45915067,"Gọng Kính Cận Nam Mảnh Nhẹ R22- Kính Cho Nam Giới",166250,175000,8750,5
TIKI,phu-kien-thoi-trang,103775055,"Kính Mát Nam CR7 tròng Polazied đen chống chói chống tia UV cực tốt",547200,547200,0,0
TIKI,ngon,196943017,"Sáp Vuốt Tóc Giữ Nếp Tóc Con, Tạo Kiểu Cho Nữ Utena Matomage Hair Styling Stick Nội Địa Nhật Bản",149000,149000,0,0
TIKI,ngon,214766203,"Zăm bông - 1kg",250000,250000,0,0
TIKI,ngon,161394201,"Kính Mát Nam Nữ Mắt Vuông Bản To Kim Loại Chống Nắng UV, Chống Ánh Sáng Xanh Ulzzang Hàn Quốc",160000,180000,20000,11
TIKI,ngon,128124475,"Ngao hoa đen - 1kg",120000,120000,0,0
TIKI,ngon,214090822,"Combo Lẩu Gia Đình Quây Quần CP",119000,119000,0,0
TIKI,ngon,127428745,"[Chỉ giao HN] Khay đậu phụ phomai nhúng lẩu ",28000,28000,0,0
TIKI,phu-kien-thoi-trang,182462065,"Mắt Kính Nữ, Kính Mát Nữ Gọng Vuông, Kính Chống Tia UV Chất Liệu Hợp Kim Cao Cấp AK046 - Aoron",280000,440000,160000,36
TIKI,ngon,117996756,"[ Chỉ giao HN] -Cá chỉ vàng khô -1kg",245000,245000,0,0
TIKI,phu-kien-thoi-trang,171469100,"Mũ cói mềm thắt nơ - nón cói vành rộng cụp viền đen chống nắng, đi biển phong cách",46000,92000,46000,50
TIKI,phu-kien-thoi-trang,73606146,"Dây Nịt Nam SAM Leather SFDN111 - Thắt Lưng Nam Da Bò Cao Cấp/ Mặt Khoá Thắt Lưng Inox Không Gỉ, Men's belts",940000,940000,0,0
TIKI,ngon,222660772,"Sữa Chua Caramel Cà Phê Ba Vì - Thùng 12 Hũ",90000,90000,0,0
TIKI,ngon,36386338,"Dây hoa búi tóc đính hoa đại phong cách Hàn Quốc",25000,25000,0,0
TIKI,ngon,126962614,"[ Chỉ giao HN] -Củ cải khô sợi to 1kg",125000,125000,0,0
TIKI,phu-kien-thoi-trang,72584651,"Mũ thể thao sport nửa đầu - Mũ lưỡi trai nửa đầu phong cách thời trang Aloha style-Nón Kết nửa đầu Nữ  Spor - Trắng",24000,48000,24000,50
TIKI,ngon,194085743,"Hình xăm không trôi chữ kín ngực, đầy lưng, hình xăm cách điệu chữ đối xứng, Xăm giống Inkaholic",60000,60000,0,0
TIKI,ngon,152681979,"GỌNG KÍNH NHỰA TR90 SIÊU NHẸ - 2523",126000,140000,14000,10
TIKI,ngon,149485968,"Mũ len nam nón len nam dona 21121406",128000,135000,7000,5
TIKI,ngon,120667741,"Hình xăm dán cao cấp tattoo hoa văn thánh giá 10x6cm- mua 5 tặng 1 mini xinh",9000,11000,2000,18
TIKI,ngon,91474513,"Khẩu trang thêu tay vải linen JL283X",175000,175000,0,0
TIKI,phu-kien-thoi-trang,153045573,"Kính mát nam MBX mắt Polarized cao cấp, full hộp, khăn, thẻ, bảo hành 12 tháng",599000,599000,0,0
TIKI,ngon,107616142,"GĂNG TAY CHIẾN THUẬT BLACKHAWK FULL NGÓN",127000,127000,0,0
TIKI,ngon,73187421,"Băng đô vải cài tóc, băng đô cài tóc vải, băng đô vải thắt nút",45000,45000,0,0
TIKI,phu-kien-thoi-trang,48751505,"Combo 9  khẩu trang vải 3 lớp bảo vệ phòng dịch bệnh",54000,54000,0,0
TIKI,ngon,118895461,"[Chỉ giao HN] Kem Hộp vị Bánh Quy Socola - Chocolate Cookies ( Biscotino )",119000,119000,0,0
TIKI,ngon,117727039,"[ Chỉ giao HN]-Há cảo Giang Nam-20gr/ cái",12000,12000,0,0
TIKI,ngon,172684035,"ỐNG TAY NỮ MÀU DA Loại mềm mỏng Chất liệu thun Co giãn Thoáng mát Dài 38cm",25000,25000,0,0
TIKI,phu-kien-thoi-trang,31570164,"Kính mát Unisex EXFASH EF 36756 C23",384000,598000,214000,36
TIKI,ngon,176170746,"[ Chỉ giao HN] - Gà chiên Popcorn 300g",79000,79000,0,0
TIKI,ngon,215105306,"Mật Ong Hoa Cỏ Meadow Buzz Honey Hũ 500g Vị Ngọt Nhẹ",458000,458000,0,0
TIKI,ngon,117727233,"[ Chỉ giao HN]-Nem Phượng Hoàng/ cái",12000,12000,0,0
TIKI,ngon,177324034,"Kính râm, Kính mát Nam Nữ Mắt Vuông Chống Nắng UV Gọng Kim Loại Cao Cấp",152000,160000,8000,5
TIKI,ngon,117727211,"[ Chỉ giao HN]-Há cảo hoa-20gr/ cái",12000,12000,0,0
TIKI,phu-kien-thoi-trang,88085902,"Tất nữ cao cổ, vớ nữ loại dày ấm",14500,14500,0,0
TIKI,ngon,215077382,"Mật Ong Hoa Mallee Giống Bạch Đàn Hoa Đỏ Trọng Lượng 320g",270000,270000,0,0
TIKI,ngon,208319358,"Khối Rubik vải phát nhạc Combi 11020",675000,675000,0,0
TIKI,ngon,123395619,"[Chỉ giao HN] Chả ốc 300g",90000,90000,0,0
TIKI,ngon,92808463,"Combo 5 đôi Tất vớ ngắn dưới mắt cá, chất liệu cotton FREEMAN [SOC10",166500,185000,18500,10
TIKI,phu-kien-thoi-trang,52053765,"Gọng Kính Cận Thời Trang Nam  Titan cao cấp gọng khoan nam tính cực sang Nhat ban đeo cực ôm và thời trang có thể thay mắt cận viễn loạn",329000,329000,0,0
TIKI,ngon,121603629,"[ Chỉ giao HN] - Chả Giò Hải Sản 400gr",90000,90000,0,0
TIKI,phu-kien-thoi-trang,167461963,"[ HÀNG CAO CẤP ] Kính thời trang nam nữ unisex Hàn Quốc hot trend 2022 - ANCHI HOUSE",135000,135000,0,0
TIKI,ngon,207236106,"Rong Biển Nướng Dầu Ô Liu Hongki Nhập Khẩu Hàn Quốc Lốc 3 Gói 4g",35000,35000,0,0
TIKI,ngon,189896978,"CP Gà Nugget Vòng Chiên Giòn 300g",45000,45000,0,0
TIKI,ngon,215119236,"Mật Ong Hoa Manuka MGO 1200+/NPA 25+ Hũ 250g",3300000,3300000,0,0
TIKI,ngon,45085481,"NÓN LEN NỮ PHỐI MÀU, MŨ LEN NỮ PHỐI MÀU DN19121708",141550,149000,7450,5
TIKI,phu-kien-thoi-trang,150623036,"Gọng kính 8089 nhựa cao cấp siêu bền thời trang nam nữ OURESS",270000,299000,29000,10
TIKI,ngon,215136427,"Hỏa Tốc Gạo Đài Thơm 8 Túi 10 Kg mới.",245000,245000,0,0
TIKI,ngon,215077839,"Dầu Ô Liu Nguyên Chất Chiết Lạnh Nước Cốt Đầu, Mùi Tỏi - 250ml",250000,250000,0,0
TIKI,ngon,222660782,"Sữa Chua Nếp Cẩm Ba Vì - Thùng 12 Hũ",90000,90000,0,0
TIKI,ngon,191977434,"Đặc Sản Nha Trang -️ Mực Xé Sợi Bơ Tỏi Cay Thơm, Seavy Hộp 200 gram",92000,100000,8000,8
TIKI,ngon,215118830,"Giấm Vị Quả Mâm Xôi Lên Men Từ Vang Nho, (Vinegar – Raspberry Balsamic) - 250ml",250000,250000,0,0
TIKI,ngon,171171252,"️ Đặc Sản Nha Trang - Cá Cơm Sấy Giòn Tỏi Ớt Seavy Hộp 200g",82000,85000,3000,4
TIKI,ngon,222660765,"Sữa Chua Mix Vị Ba Vì - Thùng 12 Hũ",90000,90000,0,0
TIKI,ngon,36106638,"KÍNH VIỄN THỊ CHỐNG ÁNH SÁNG XANH SIÊU DẺO CAO CẤP KV191_DROPXHIP",85500,90000,4500,5
TIKI,ngon,91369539,"Combo 2 kính xem phim 3D dành cho tivi phân cực",101400,101400,0,0
TIKI,ngon,82559449,"[ KÈM LƯỚI VÀ LƯỢC, P84 ] Tóc giả nguyên đầu có rãnh da đầu, tóc giả nữ nguyên đầu, tóc giả nữ - Tóc giả bộ xoăn sóng, tóc giả dài, tóc giả xoăn, tóc giả xù mì, tóc giả cho người trung niên",280000,280000,0,0
TIKI,ngon,215110265,"Mật Ong Hoa Manuka MGO 515+/NPA 15+ Hũ 500g",1650000,1650000,0,0
TIKI,phu-kien-thoi-trang,41173344,"Combo 3 Kẹp Tóc Càng Cua 6 Răng Siêu Bền (màu ngẫu nhiên)",25000,25000,0,0
TIKI,ngon,163554345,"[Chỉ giao HN] - Râu tuộc đỏ đại dương - 1kg",65000,98000,33000,34
TIKI,ngon,119063779,"[Chỉ Giao Hà Nội] Nho xanh Sweet Globes Mỹ - 1 kg",199000,199000,0,0
TIKI,ngon,121603559,"[ Chỉ giao HN] - đậu hũ phô mai 500g",150000,150000,0,0
TIKI,ngon,176170750,"[ Chỉ giao HN] - Giò lụa Cắt Khoanh 250gr",54200,54200,0,0
TIKI,ngon,172276910,"10 ĐÔI TẤT VỚ NỮ MÀU DA Loại xỏ ngón Chất liệu thun Co giãn Thoáng mát Dài 30cm Loại dày êm",150000,150000,0,0
TIKI,ngon,208318951,"Sách vải cho bé chơi mà học Pipo - Chữ cái tiếng Việt",46000,46000,0,0
TIKI,ngon,214766197,"Chả mỡ - 500g rán sẵn",110000,110000,0,0
TIKI,ngon,90679783,"Mũ Lưỡi Trai Đen Trơn Chất Cực Đẹp",51000,51000,0,0
TIKI,ngon,142315257,"[Chỉ giao HN] Cream Cheese (phô mai kem) Anchor New Zealand khối 1kg",274000,274000,0,0
TIKI,ngon,186313825,"Phô mai viên Đôi Đũa Vàng 300g nhân Mozzarella tan chảy béo ngậy",169000,169000,0,0
TIKI,ngon,163554312,"[Chỉ giao HN] - Đuôi bò cắt khúc - 1kg",134000,197000,63000,32
TIKI,ngon,178576939,"Kẹp Tóc Nơ Voan Cao Cấp 3 Cánh Bản To",38500,38500,0,0
TIKI,ngon,119308608,"[Chỉ Giao Hà Nội] Ba chỉ hun khói 300g",90000,90000,0,0
TIKI,ngon,186279132,"Phô mai que rong biển Đôi Đũa Vàng 300g thơm ngon bổ dưỡng",249000,249000,0,0
TIKI,ngon,176170720,"[ Chỉ giao HN] - Dounut gà 500g",72000,72000,0,0
TIKI,ngon,125741612,"Dồi sụn Hà Thành - 1kg 2 túi hút chân không",199000,199000,0,0
TIKI,phu-kien-thoi-trang,39305010,"Sét 10 ghim khuy cài áo cao cấp xuất Nhật GC01",27000,27000,0,0
TIKI,ngon,108276841,"[Chỉ giao HN] - Giỏ trái cây A 802 - Giỏ",800000,800000,0,0
TIKI,ngon,176170684,"[ Chỉ giao HN] - Cánh gà chiên cay 400gr",94500,94500,0,0
TIKI,ngon,196342132,"Dây buộc tóc cho bé gái [Set 8 dây] NASI thắt nơ dễ thương phong cách hàn quốc thun cột tóc nữ co giãn tốt phụ kiện tóc",49000,49000,0,0
TIKI,ngon,208317505,"Mũ len lót nỉ siêu mềm ấm hàng xuất dư cao cấp chất lượng vượt trội cho bé 1-4 tuổi",182000,182000,0,0
TIKI,ngon,170337886,"Đặc Sản Nha Trang - Mực Rim Sa Tế Nha Trang  Cay Dai Đặc Sản, Nguyên Con Seavy Gói 200g",82000,85000,3000,4
TIKI,ngon,176170724,"[ Chỉ giao HN] - Bánh bao sữa nhân khoai môn 390gr",52000,52000,0,0
TIKI,ngon,134713674,"[Chỉ giao Hà Nội] Trà hoa cúc trắng Mộc Sắc - 80g",95000,95000,0,0
TIKI,ngon,179555623,"Nem chua rán Đôi Đũa Vàng đồ ăn vặt giòn rụm đặc sản phố cổ gói 240g",138000,138000,0,0
TIKI,ngon,214766213,"Chả mỡ - 1kg chưa rán",220000,220000,0,0
TIKI,ngon,118896651,"[Chỉ giao HN]  Kem hộp vị Sữa Chua Dâu - Strawberry Yogurt with White Chocolate",119000,119000,0,0
TIKI,ngon,175412816,"Khẩu trang y tế Khánh An Kids Family dành cho trẻ em từ 1 đến 12 tuổi",11200,14000,2800,20
TIKI,ngon,43174372,"Dây thắt lưng nữ bảng nhỏ",70000,70000,0,0
TIKI,ngon,139599300,"[Chỉ Giao Hà Nội] Tim heo - quả",59000,59000,0,0
TIKI,ngon,262797969,"Bò hầm cốt củ quả Truefood hộp 300g - BHCCQ",55000,55000,0,0
TIKI,ngon,119334698,"[Chỉ giao HN] - Bắp Giò Heo Rút Xương Cuộn Chỉ - 1Kg - Chưa Chín",279000,279000,0,0
TIKI,phu-kien-thoi-trang,51654356,"Băng đô caro băng đô turban băng đô rửa mặt",35000,35000,0,0
TIKI,ngon,170435191,"Đặc Sản Nha Trang - Cá Cơm Khô, Khô Cá Cơm Săn, Seavy Gói 500 Gram",92000,95000,3000,3
TIKI,ngon,186906303,"Lườn ức gà nhập khẩu 200g [Chỉ giao HN]",29000,29000,0,0
TIKI,ngon,176170790,"[ Chỉ giao HN] - Đùi tỏi 500gr Khay",72000,72000,0,0
TIKI,ngon,163554353,"[Chỉ giao HN] - Khoanh giò heo -700-800 gram",97000,97000,0,0
TIKI,ngon,116530009,"[Chỉ giao HN] - Tôm Gai Trứng Biển - 1Kg 2 Hộp",299000,299000,0,0
TIKI,ngon,179371944,"Phô mai que kéo sợi Mozzarella thơm ngậy Đôi Đũa Vàng 300gr - Giao tại Hà Nội và Hồ Chí Minh",199000,199000,0,0
TIKI,ngon,215174394,"Hộp quà tết Thịnh Vượng 01",439000,439000,0,0
TIKI,ngon,117075279,"Cá ba sa nguyên con làm sạch cắt khúc 1kg [Chỉ giao hỏa tốc HN]",75000,75000,0,0
TIKI,phu-kien-thoi-trang,101218626,"GỌNG KÍNH TITAN NAM (Titanium Pors Men) CHẤT LIỆU VƯỢT TRỘI SIÊU NHẸ SIÊU BỀN – HÀNG CHÍNH HÃNG P9012",649000,649000,0,0
TIKI,ngon,126962681,"[ Chỉ giao HN] -Lạc nhân trắng 500g",35000,35000,0,0
TIKI,ngon,129021480,"Lườn ức gà Truefood nhập khẩu 500g phù hợp cho người ăn kiêng, ăn chế độ [Chỉ giao hỏa tốc HN]",55000,55000,0,0
TIKI,ngon,132815457,"Thịt dẻ sườn Truefood nhập khẩu 500g ăn nướng [Chỉ giao hỏa tốc HN]",95000,95000,0,0
TIKI,ngon,147465819,"Sticker, Phụ Kiện, Pin cài Balo, áo , Dép hình cô gái dễ thương",2800,2800,0,0
TIKI,ngon,169849586,"Đặc Sản Nha Trang - Bánh Phồng Sữa Thanh Trúc Loại Đại, Seavy Gói 300 Gram",35000,35000,0,0
TIKI,ngon,215105243,"Mật Ong Hoa Manuka MGO 263+/NPA 10+ - 500g",988000,988000,0,0
TIKI,ngon,215077839,"Dầu Ô Liu Nguyên Chất Chiết Lạnh Nước Cốt Đầu, Mùi Tỏi - 250ml",250000,250000,0,0
TIKI,ngon,176170805,"[ Chỉ giao HN] - Đùi gà chiên giòn 500gr",93900,93900,0,0
TIKI,ngon,117139110,"Sốt nướng BBQ TRF - 200ml",12000,12000,0,0
TIKI,ngon,176170784,"[ Chỉ giao HN] - Gà chiên Karage 300g",64500,64500,0,0
TIKI,ngon,117075279,"Cá ba sa nguyên con làm sạch cắt khúc 1kg [Chỉ giao hỏa tốc HN]",75000,75000,0,0
TIKI,ngon,187576168,"Đặc Sản Nha Trang - Bánh Xoài Nha Trang Nguyên Chất Vị Chua Ngọt Tự Nhiên, Seavy Gói 200g",27000,27000,0,0
TIKI,ngon,176170714,"[ Chỉ giao HN] - Xúc xích Đức 450gr",107000,107000,0,0
TIKI,ngon,213488906,"Đặc Sản Nha Trang - Kẹo Dừa Lá Dứa Cuộn Hộp Seavy 200G",50000,50000,0,0
TIKI,ngon,139599281,"Sườn cánh buồm heo nhập khẩu 500g",80000,80000,0,0
TIKI,ngon,167857733,"Đặc Sản Nha Trang -Mực Muối Lạt Phơi Ghe Dẻo Thơm, Ít Muối, Đa Dạng Chế Biến Size Lớn Seavy Gói 500g",175000,185000,10000,5
TIKI,ngon,167653035,"Đặc Sản Nha Trang - Cá Đuối Khô Nguyên Miếng, Seavy Gói 500 Gram",158000,160000,2000,1
TIKI,ngon,169005175,"Thức ăn cho mèo con và mèo trưởng thành Royal Canin Pháp Hộp 1kg - RC Dry Mix Feeding",224800,224800,0,0
TIKI,ngon,186750793,"Đặc Sản Nha Trang - Rong Biển Sấy Giòn Ăn Liền, Loại Ngon, Dùng Được Cho Người Ăn Chay, Seavy  Hộp 100gram - Seavy",50000,50000,0,0
TIKI,ngon,139599289,"[Chỉ Giao Hà Nội] Xương ống heo 500g",15000,15000,0,0
TIKI,ngon,173317931,"[Chỉ giao HN] - Râu Mực Tươi Ngon Đông Lạnh - 500g - Khay Hút Chân Không",179000,179000,0,0
TIKI,ngon,119067553,"Nho sữa giống Hàn Quốc",300000,300000,0,0
TIKI,ngon,129021486,"Đùi tỏi gà Truefood nhập khẩu 500g [Chỉ giao hỏa tốc HN]",50000,50000,0,0
TIKI,ngon,169005666,"Khay, Máy cho Chó, mèo ăn (bán tự động) - Máy cho ăn - Xám",115000,115000,0,0
TIKI,ngon,118103859,"[Chỉ giao HN] - Cá Hồi Fillet Cắt Khúc Nhật Bản - 1Kg - Bao Xanh",529000,529000,0,0
TIKI,phu-kien-thoi-trang,54722890,"Băng đô rửa mặt, trang điểm hình con cua- ngẫu nhiên màu",58900,58900,0,0
TIKI,phu-kien-thoi-trang,195986288,"Dây buộc tóc nữ cao cấp [Set 4 dây] NASI dễ thương phong cách hàn quốc thun cột tóc nữ co giãn tốt phụ kiện tóc",25000,25000,0,0
TIKI,phu-kien-thoi-trang,120665946,"Hình xăm dán",10000,11000,1000,9
TIKI,phu-kien-thoi-trang,95329728,"Tất nam cổ cao công sở - Combo 5 đôi – Màu đen",124000,124000,0,0
TIKI,phu-kien-thoi-trang,136144158,"Thắt lưng nam dây nịt nam chất liệu da bò thật khóa tự động hàng hiệu cao cấp NT323 - Nutushop",285000,285000,0,0
TIKI,phu-kien-thoi-trang,173865917,"Mắt kính RAY-BAN - - RB3682 003/11 -Sunglasses",3264000,4080000,816000,20
TIKI,phu-kien-thoi-trang,20055522,"Trâm cài tóc cổ trang thân gỗ lam điệp trâm cài tóc nữ cổ trang Trung Quốc phong cách cổ đại cosplay nữ tính thời trang",68000,68000,0,0
TIKI,phu-kien-thoi-trang,114737255,"Nón bucket vải bố vành cụp trơn - mũ tai bèo Ulzzang phong cách, cá tính Unisex nam nữ",53000,106000,53000,50
TIKI,phu-kien-thoi-trang,116019073,"Tất Chân Nam Nữ , Vớ Cổ Ngắn chuẩn xuất Nhật [ ] - CB023",88000,88000,0,0
TIKI,phu-kien-thoi-trang,94997802,"Găng tay chống nắng nữ cảm ứng chống trơn trượt lỗ thoáng khí họa tiết chấm bi ren thời trang 2021",55000,55000,0,0
TIKI,phu-kien-thoi-trang,164303490,"THÙNG 300 CÁI KHẨU TRANG NGƯỜI LỚN KF 94. KHẨU TRANG CÁ 4D KHÁNG KHUẨN ÔM SÁT",102000,115000,13000,11
TIKI,phu-kien-thoi-trang,184488871,"Kính Râm, Kính Mát Nam Nữ, Mắt Vuông Gọng Kim Loại Dày Cứng Cáp Đen, Nâu, Chống Tia UV - BLUE LIGHT",185000,185000,0,0
TIKI,phu-kien-thoi-trang,180864557,"Găng tay thun lụa họa tiết trẻ trung - găng tay chống nắng Hatsu XZ01 - Găng tay chạy xe thoáng khí, thời trang",40000,40000,0,0
TIKI,phu-kien-thoi-trang,64657357,"Sét 5 dây buộc tóc tone xanh Scrunchies dễ thương HD64 mầu ngẫu nhiên",59000,59000,0,0
TIKI,phu-kien-thoi-trang,140716979,"Kẹp tóc, Set 10 kẹp tăm phối màu xinh xắn, phong cách học sinh Hàn Quốc",25000,25000,0,0
TIKI,phu-kien-thoi-trang,171439455,"Bao tay Găng tay Nam Chống nắng Hở 5 ngón Chất liệu vải dày Gắn sọc đen đỏ, Chống tia UV, Bảo vệ da tay",36000,36000,0,0
TIKI,phu-kien-thoi-trang,25924664,"Set 5 Đôi Tất Gấu Nữ Cổ Ngắn Chất Đẹp",17500,17500,0,0
TIKI,phu-kien-thoi-trang,146370290,"[VIDEO]- Khăn choàng cổ chất liệu lụa cao cấp, sang trọng 180x90cm dùng để đi du lịch, đi làm...- Quà tặng cho phái đẹp",148000,148000,0,0
TIKI,phu-kien-thoi-trang,139145981,"Set 3 kẹp tóc càng cua Thái lan siêu hot",39000,39000,0,0
TIKI,phu-kien-thoi-trang,103045073,"THẮT LƯNG DA NỊT CHUN 2 BÊN CO GIÃN TIỆN LỢI KHÔNG CẦN MẶT HOTTREND DÂY NỊT KẸP ULZZANG CO GIÃN BẢN 2,8Cm",45000,45000,0,0
TIKI,phu-kien-thoi-trang,74257113,"Nón bucket tai bèo thêu hình chiếc lá We Will Fly, may 2 lớp với 2 màu khác nhau độc đáo, vải cotton mềm mại thoải mái",39000,39000,0,0
TIKI,phu-kien-thoi-trang,115124910,"10 đôi tất nam cổ cao,vớ nam siêu chống thối nhật cổ cao (loại đẹp)",66989,66989,0,0
TIKI,phu-kien-thoi-trang,211300330,"SCRUNCHIES - COMBO 1 - 3 - 5 DÂY CỘT TÓC SCRUNCHIES - NHIỀU MÀU - BẢN TO - DÂY BUỘC TÓC VẢI - CHO BẠN GÁI",10000,10000,0,0
TIKI,phu-kien-thoi-trang,16833861,"Kẹp gấp bông cúc họa mi hoa nhỏ - kẹp càng cua 3 răng",22000,26000,4000,15
TIKI,phu-kien-thoi-trang,141087998,"Kính mát ,Mắt Kính Uniex Thời Trang Chống Tia UV SARIFA 28309",199000,800000,601000,75
TIKI,phu-kien-thoi-trang,105159484,"Thắt Lưng Nữ Factory Dây Nịt Nữ mang đầm váy Dona21060904",94050,99000,4950,5
TIKI,phu-kien-thoi-trang,117491854,"Tất đi giày tây chất liệu cotton cao cấp, vớ nam công sở họa tiết gân chìm lịch lãm - GOM-TAYGANCHIM-1DOI",26000,50000,24000,48
TIKI,phu-kien-thoi-trang,138385880,"Set Kẹp Tóc Hoa Đen 5 Chi Tiết",31000,55000,24000,44
TIKI,phu-kien-thoi-trang,10762232,"Kính mát thể thao Unisex Tifosi Alliant - Gọng Black / Red, Bộ 3 tròng Smoke / AC Red / Clear",1800000,1800000,0,0
TIKI,ngon,142103905,"Dưa lưới nhà kính",100000,100000,0,0
TIKI,phu-kien-thoi-trang,87984650,"Khăn Badana - Khăn Turban Hiphop Cá Tính Nam Nữ",12350,12350,0,0
TIKI,phu-kien-thoi-trang,83616220,"Khẩu trang ninja vải nỉ kính che kín mặt kín tai chống nắng gió lạnh bụi - khau trang kinh che kin",35000,35000,0,0
TIKI,phu-kien-thoi-trang,174377147,"Thắt lưng dây nịt nam da bò phong cách hàn quốc khóa tự động khóa viền sọc tính cách DT104",162000,180000,18000,10
TIKI,ngon,120800169,"[Chỉ giao HN] -Táo Envy - 1kg",210000,210000,0,0
TIKI,phu-kien-thoi-trang,66568182,"Kính Bảo Vệ Mắt Chống Ánh Sáng Xanh Cho Nam KV014 Size Vừa",450000,450000,0,0
TIKI,phu-kien-thoi-trang,22120248,"NÓN NỮ RỘNG VÀNH ĐI BIỂN  - DN19VT0709",134000,159000,25000,16
TIKI,phu-kien-thoi-trang,184247473,"Gọng kính hợp kim cước thời trang nam nữ siêu nhẹ siêu bền Ouress 58007",253000,280000,27000,10
TIKI,ngon,173321016,"[Chỉ giao HN] - Gà Ủ Muối Hoa Tiêu Ăn Liền - Nửa Con",120000,120000,0,0
TIKI,ngon,143322166,"Nho sữa Hàn Quốc (Shine Muscat)",2260000,2260000,0,0
TIKI,phu-kien-thoi-trang,144181163,"Nút bấm áo dài cúc bấm cúc bóp áo dài 555 cúc áo dài nút áo dài princess press stub",13500,13500,0,0
TIKI,phu-kien-thoi-trang,102505117,"Dây Lưng Nam Nữ 3.3cm Da Bò 1 Lớp KEIO NIPPON",179000,179000,0,0
TIKI,ngon,104030227,"[Chỉ Giao HN] Táo xanh nhập khẩu - 1KG",100000,100000,0,0
TIKI,ngon,172025110,"[ Chỉ giao HN] -Táo Koru Mỹ - 1kg",189000,189000,0,0
TIKI,ngon,91247828,"[Chỉ Giao HN] - Quýt 2PH",75000,75000,0,0
TIKI,ngon,128707146,"[Chỉ giao HN] Đùi Cừu New Zeadland - 1KG",680000,680000,0,0
TIKI,ngon,132815445,"Ba chỉ bò cuộn lẩu Truefood nhập khẩu 500g [Chỉ giao hỏa tốc HN]",150000,150000,0,0
TIKI,ngon,193881185,"Gạo nếp nhung - 1kg",35000,35000,0,0
TIKI,ngon,156937392,"[ Chỉ giao HN] -Nấm sò trắng - 1kg",60000,60000,0,0
TIKI,phu-kien-thoi-trang,69162873,"Combo 5 đôi tất da cổ ngắn nữ chống nắng",60000,60000,0,0
TIKI,ngon,171975586,"️ Đặc Sản Nha Trang -Cá Chỉ Vàng Khô Nguyên Con, Rút Xương Mềm Ngon, Seavy Gói 500 gram",158000,160000,2000,1
TIKI,ngon,128645337,"GIỎ QUÀ TẶNG THĂM THÂN",610000,610000,0,0
TIKI,ngon,163554338,"[Chỉ giao HN] - Tôm viên Đức Việt - gói 500g",41000,61000,20000,33
TIKI,ngon,121441848,"[Chỉ Giao HN] Cam Ruột Vàng Úc (0.9kg - 2.6kg)",159000,159000,0,0
TIKI,phu-kien-thoi-trang,59177390,"Mắt kính mát nam DKY8503DD tròng Polarized phân cực, gọng kim loại bọc cao su non.",259000,259000,0,0
TIKI,ngon,120058337,"Nho Đỏ Mỹ 1kg",161000,161000,0,0
TIKI,ngon,121441648,"[Chỉ Giao HN] Lê sữa Hàn Quốc (Quả từ 0.4-0.6kg /quả) ",45000,45000,0,0
TIKI,ngon,170068589,"[ Chỉ giao HN] - Khâu Nhục Sơn Dương",90000,90000,0,0
TIKI,phu-kien-thoi-trang,120379370,"Set túi 60c dây chun buộc tóc cá tính",50000,50000,0,0
TIKI,ngon,169850723,"Đặc Sản Nha Trang - Mực Rim Me Nha Trang - Mực Lá Nước Cốt Me Tươi, Seavy Hộp 280g",92000,95000,3000,3
TIKI,ngon,195279608,"️ Đặc Sản Nha Trang - Mực Khô Câu Nha Trang, Size 22-26 Con/kg, Mực Mềm Ngọt  Seavy ️Gói 500g",585000,600000,15000,3
TIKI,ngon,198541975,"Chai Xịt Thảo Mộc 10s Diệt Ruồi Muỗi Kiến Ba Khoang Gián Mối, 100% Sinh Học, An Toàn Cho Trẻ Em, Hiệu Quả Cao",85000,85000,0,0
TIKI,ngon,163554304,"[Chỉ giao HN] - Bò viên Đức Việt - gói 500g",42000,65000,23000,35
TIKI,ngon,163554365,"[Chỉ giao HN] - Khoai lang kén - gói 250g",15000,30000,15000,50
TIKI,ngon,193111940,"[Chỉ giao HN] - Râu mực size to - Khay",126000,145000,19000,13
TIKI,ngon,167847278,"Đặc Sản Nha Trang - Mực Muối Lạt Phơi Ghe - Dẻo Thơm, Ít Muối, Đa Dạng Chế Biến - Nha Trang 500g Size Nhỏ Seavy Gói 500g",152000,155000,3000,2
TIKI,ngon,166057719,"Súp Thưởng Me-O Creamy Treats Cho Mèo [1 THANH LẺ] - Xanh biển (Gà & Gan)",12000,12000,0,0
TIKI,ngon,176170774,"[ Chỉ giao HN] - Xúc xích Winner 500g (10 cây)",68000,68000,0,0
TIKI,ngon,187659264,"Đặc Sản Nha Trang - Hạt Đác Rim Thơm Hộp Seavy 500G",86000,90000,4000,4
TIKI,ngon,102497380,"Quýt Úc - 1Kg",179000,179000,0,0
TIKI,ngon,197750917,"Đặc Sản Nha Trang-  Bánh Khoai Lang Nha Trang, Dẻo Vàng Thơm, Seavy Gói 300g",37000,37000,0,0
TIKI,ngon,168142511,"Đặc Sản Nha Trang - Thùng 6 Chai Nước Mắm 584 Nha Trang 25 Độ Đạm Truyền Thống Nguyên Chất Đậm Đặc Seavy Thùng 6 Chai 500ml/chai",215000,220000,5000,2
TIKI,ngon,167857126,"Đặc Sản Nha Trang -Mực Muối Lạt Phơi Ghe - Dẻo Thơm, Ít Muối, Đa Dạng Chế Biến - Nha Trang Size Trung Seavy Gói 500g",165000,170000,5000,3
TIKI,ngon,186750823,"Đặc Sản Nha Trang -Ghẹ Sữa Ram Giòn Không Càng, Xốp Giòn, Seavy Hộp 500g",185000,200000,15000,8
TIKI,ngon,203000946,"Đậu hũ phô mai EB Malaysia nhập khẩu gói 500g [Chỉ giao hỏa tốc HN",109000,109000,0,0
TIKI,ngon,176170752,"[ Chỉ giao HN] - Cánh gà chiên giòn 400gr",94500,94500,0,0
TIKI,ngon,179749826,"Nem rán gia đình đặc biệt Đôi Đũa Vàng giòn tan ngập nhân thịt gói 480g",139000,139000,0,0
TIKI,ngon,195256133,"Đặc Sản Nha Trang - Mực Khô Câu Loại 1 Size 45-50 Con/kg Seavy Gói 500G",420000,430000,10000,2
TIKI,ngon,191978480,"Đặc Sản Nha Trang -Seavy Bánh Chuối Dừa Nướng Hương Vị Độc Đáo, Dai Thơm Seavy Gói 200g",40000,40000,0,0
TIKI,ngon,190455544,"Khoai lang kén chiên giòn Đôi Đũa Vàng, bánh khoai cốt dừa thơm ngậy 230g",95000,95000,0,0
TIKI,ngon,116553103,"[Chỉ giao HN] - Lõi Thăn Bò Mỹ - Khay 1Kg Hút Chân Không",349000,349000,0,0
TIKI,ngon,171170748,"️ Đặc Sản Nha Trang -Cá Bò Da Khô Tẩm Gia Vị, Loại Ngon Hình Ovan, Dẻo Mềm, Seavy Gói 500 gram",178000,190000,12000,6
TIKI,ngon,187991872,"Đặc Sản Nha Trang - Bánh Tráng Dừa Nướng Đậm Đặc Nước Cốt Dừa Seavy Gói 850G Gồm 16 Cái",80000,80000,0,0
TIKI,ngon,195274472,"Đặc Sản Nha Trang - Mực Khô Lớn Loại 1 Size 12 Con/kg Seavy Gói 500G",680000,700000,20000,3
TIKI,ngon,191986475,"Đặc Sản Nha Trang - Bánh Tráng Hạt Điều Giòn Rụm Thơm Lừng Seavy Gói 250g",42000,42000,0,0
TIKI,ngon,176170694,"[ Chỉ giao HN] - Thịt Heo Ba rọi (300g)",74500,74500,0,0
TIKI,ngon,190461017,"Giò lụa chay Đôi Đũa Vàng tươi ngon đậm đà 500g",145000,145000,0,0
TIKI,ngon,168137730,"Đặc Sản Nha Trang - Thùng 6 Chai Nước mắm 584 Nha Trang, Loại 30 Độ Đạm Truyền Thống, Nguyên Chất, Đậm Đặc Seavy Thùng 6 chai 500ml/chai",270000,280000,10000,4
TIKI,ngon,172025041,"[ Chỉ giao HN] -Lê Nâu HQ - 1kg",189000,189000,0,0
TIKI,dong-ho-va-trang-suc,48509114,"Dây Chuyền Bạc Nữ Hình Đá Ngọc Thời Trang - Vòng Cổ Bạc Cho Nữ M1558 Bảo Ngọc Jewelry",336000,336000,0,0
TIKI,ngon,117139108,"Sốt thịt kho TRF - 200ml",12000,12000,0,0
TIKI,dong-ho-va-trang-suc,174383050,"Vòng Tay Ngọc Trai 6li Ngọc Trai Tự Nhiên Cao Cấp Mix 1 Hạt Ngọc Lớn",300000,300000,0,0
TIKI,ngon,169004334,"Thức Ăn Cho Mèo Trưởng Thành Reflex PLUS Adult - Vị cá hồi - 1,5Kg",155555,155555,0,0
TIKI,ngon,195645250,"Đặc Sản Nha Trang - Me Ngào Đường Muối Ớt Hộp Seavy 500G",78000,80000,2000,3
TIKI,ngon,190708699,"Chả cốm chay Đôi Đũa Vàng dẻo thơm chuẩn vị 230g",115000,115000,0,0
TIKI,ngon,176170803,"[ Chỉ giao HN] - Gà cuộn phô mai 360g",102500,102500,0,0
TIKI,ngon,193112119,"[Chỉ giao HN] - Lườn Ngỗng hun khói set 2 gói - 450g",65000,88000,23000,26
TIKI,dong-ho-va-trang-suc,102142554,"Nhẫn nữ bạc ta đính đá MS09c",141000,141000,0,0
TIKI,ngon,176170776,"[ Chỉ giao HN] - Nem giòn 180g",46000,46000,0,0
TIKI,dong-ho-va-trang-suc,89879395,"Bông tai nữ bạc ta gắn trai MS62d",109000,109000,0,0
TIKI,ngon,193151136,"[Chỉ giao HN] - Tim Heo - Túi 2 quả - 700g",77000,85000,8000,9
TIKI,ngon,112255373,"Iberico Jowl meat (Diềm má / Thịt nọng iberico) - Khay 300g",236000,278000,42000,15
TIKI,ngon,176170731,"[ Chỉ giao HN] - Bánh bao nhân thịt  trứng cút 500g",61000,61000,0,0
TIKI,dong-ho-va-trang-suc,106394081,"Dây đồng hồ kim loại inox đúc 5 hạt đúc đặc đầu ôm và đầu bằng",199500,199500,0,0
TIKI,ngon,176170698,"[ Chỉ giao HN] - Sườn non heo(300g)",92800,92800,0,0
TIKI,dong-ho-va-trang-suc,162145601,"Đồng Hồ Nữ JA-1112 Julius Hàn Quốc dây da (Đỏ)",599000,599000,0,0
TIKI,ngon,179711555,"[Chỉ giao HN] - Hạnh nhân Olam sống thái lát nhập khẩu Mỹ - 500gr",195000,195000,0,0
TIKI,dong-ho-va-trang-suc,2813429,"Đồng hồ Nam dây da SKMEI 9070 - DHA008",340000,358000,18000,5
TIKI,ngon,193148956,"[Chỉ giao HN] - Băp bò thái lát - Khay 500g",98000,120000,22000,18
TIKI,dong-ho-va-trang-suc,32079760,"Vòng tay phong thủy đá thạch anh trắng mệnh kim , thủy - Ngọc Quý Gemstones",190000,370000,180000,49
TIKI,ngon,163554371,"[Chỉ giao HN] - Khoai tây cọng Bỉ - Gói 1kg",67000,79000,12000,15
TIKI,ngon,163554361,"[Chỉ giao HN] - Sườn heo cánh buồm -1kg",120000,139000,19000,14
TIKI,ngon,115775397,"[CHỈ GIAO HN] - NEM HẢI SẢN SỐT MAYONNAISE VITOT FOOD (1 hộp 10 chiếc)",169000,169000,0,0
TIKI,ngon,113368799,"Iberico Skirt meat Nạc dây (chặng dừng iberico) - Khay 300g",171000,190000,19000,10
TIKI,dong-ho-va-trang-suc,7801790,"Bộ 2 bông tai nam inox khuyên tròn 16mm BT233",35000,35000,0,0
TIKI,dong-ho-va-trang-suc,123231301,"Vòng tay Trầm Hương tự nhiên Minh Nguyệt - Trầm Tốc Việt Nam - Hạnh phúc, thành công, thăng tiến - Thiên Mộc Hương",1701000,1990000,289000,15
TIKI,dong-ho-va-trang-suc,97899787,"Hộp đựng đồng hồ - Hộp đựng 10 đồng hồ bằng gỗ màu nâu",320000,320000,0,0
TIKI,ngon,170179309,"Thức ăn cho mèo con và mèo trưởng thành Royal Canin Pháp Hộp 1kg - RC Fit 32",205000,205000,0,0
TIKI,dong-ho-va-trang-suc,77711425,"Nhẫn bạc nam mắt đá thạch anh mắt hổ ni19 mệnh thổ, kim - Ngọc Quý Gemstones",899000,1280000,381000,30
TIKI,dong-ho-va-trang-suc,137836531,"Dây đeo Samsung Watch 4/ Watch 4 Classic (DGNT)",90000,90000,0,0
TIKI,dong-ho-va-trang-suc,100464212,"DÂY TẾT VÒNG TAY 10met (DÂY ĐAN VÒNG TAY - CHỈ ĐỎ)",30000,30000,0,0
TIKI,ngon,179954126,"Chả giò rế nhân tôm thịt Đôi Đũa Vàng thơm ngậy vàng giòn gói 300g",138000,138000,0,0
TIKI,dong-ho-va-trang-suc,82832880,"Dây Thép Đồng Hồ 2 Trong 1 Thép Đặc Không Gỉ [Tặng Chốt + Dụng cụ tháo lắp",160000,160000,0,0
TIKI,ngon,124258655,"[Chỉ giao HN] - Nạc Nọng Heo - Nạc Giòn",299000,299000,0,0
TIKI,ngon,108938137,"[CHỈ GIAO HN] - TÔM SẮT NÕN TƯƠI VITOT FOOD (500g/ khay)",169000,169000,0,0
TIKI,ngon,169004015,"Thức Ăn Royal Canin Mixed Fit + Kitten + Indoor (Túi 1kg)",224999,224999,0,0
TIKI,dong-ho-va-trang-suc,169191216,"Đồng Hồ Nam Dây Nhựa Casio Standard W-218HC-4A2 Chính Hãng - W-218HC-4A2VDF",636000,848000,212000,25
TIKI,dong-ho-va-trang-suc,89878687,"Dây chuyền nữ bạc ta mặt chiếc lá MS59a",105000,105000,0,0
TIKI,ngon,92379109,"Thịt sườn heo đen Iberico (khay 500g)",226000,251000,25000,10
TIKI,dong-ho-va-trang-suc,87984758,"vòng đôi tình yêu",7670,7670,0,0
TIKI,dong-ho-va-trang-suc,58047528,"Đồng hồ nam chính hãng Lobinni No.16003",4810000,7650000,2840000,37
TIKI,ngon,193888950,"Đặc Sản Nha Trang - ️ Cá Thiều Sợi (Cá Bống Cắt Nướng Que), Tẩm Gia Vị Ăn Liền, Có Vị Cay Nhẹ, Seavy Hộp 200gram",98000,100000,2000,2
TIKI,dong-ho-va-trang-suc,87984720,"nhẫn đô la - Hộp Đựng Nhẫn,11",8450,8450,0,0
TIKI,dong-ho-va-trang-suc,73576256,"Vòng cổ Bạc Cao Cấp DB2473 Bảo Ngọc Jewelry",257000,257000,0,0
TIKI,ngon,116553085,"[Chỉ giao HN] - Cá Mối Hương Fillet 1 Nắng - 1Kg 2 Hộp - Không Xương",209000,209000,0,0
TIKI,dong-ho-va-trang-suc,177496965,"Lắc tay nữ thời trang chất liệu bạc s925 MS09g",160000,160000,0,0
TIKI,ngon,171171627,"Đặc Sản Nha Trang -Cá Cơm Tẩm Bột Sấy Giòn, Hải Sản Khô Seavy Hộp 500 gram",185000,200000,15000,8
TIKI,dong-ho-va-trang-suc,52146570,"Đồng hồ cơ nam tự động SKMEI 9184 dây lưới thép không gỉ",399000,399000,0,0
TIKI,dong-ho-va-trang-suc,161523086,"Dây da đồng hồ 20mm dành cho Samsung galaxy watch 4",200000,200000,0,0
TIKI,dong-ho-va-trang-suc,82412636,"Dây Da Đồng Hồ Da Bò Italy Mềm",130000,130000,0,0
TIKI,dong-ho-va-trang-suc,17898514,"Nhẫn cảm biến nhiệt - Nhẫn thời trang hiển thị nhiệt độ cơ thể",17000,29000,12000,41
TIKI,dong-ho-va-trang-suc,38645201,"Bông Tai Nam Khoen Tròn Loại Kẹp Ko Cần Bấm Lỗ Tai Chất Liệu Thép Titan Ko Rỉ Ko Dị Ứng TT 0851 - 1 Cặp",59000,59000,0,0
TIKI,dong-ho-va-trang-suc,41556614,"Bông Tai Nam Khuyên Tròn Chất Liệu Thép Titan Ko Rỉ TT 0850 - 1 Cặp",34000,34000,0,0
TIKI,dong-ho-va-trang-suc,135077364,"Dây đeo cho Huawei Band 6/ Band 6 Pro/ Honor Band 6 (DB6)",80000,80000,0,0
TIKI,ngon,176170758,"[ Chỉ giao HN] - Thịt heo xay (300g)",58000,58000,0,0
TIKI,dong-ho-va-trang-suc,2792001,"Đồng hồ Nam thể thao SKMEI 1335 - DHA508",155000,155000,0,0
TIKI,ngon,92380617,"Thịt cổ Iberico cuộn (khay 300g)",264000,293000,29000,10
TIKI,dong-ho-va-trang-suc,118787623,"Dây Da Đồng Hồ Daniel Sheffield Tặng kèm Hộp gỗ",200000,200000,0,0
TIKI,dong-ho-va-trang-suc,49472876,"Nhẫn Nữ Kiểu Tổ Ong Titan Ko Đen TT 2461",99000,99000,0,0
TIKI,dong-ho-va-trang-suc,38067750,"Vòng Tay Phong Thủy đá Mắt Hổ Nâu 12 Ly cho Nam mệnh Kim, mệnh Thổ",119000,119000,0,0
TIKI,dong-ho-va-trang-suc,104918357,"Dây đồng hồ Da Đà Điểu Thật,dây đồng hồ da kèm khóa bướm gập cao cấp,BH 6 Tháng tặng chốt, tool tháo, móc khóa",289000,289000,0,0
TIKI,ngon,171152517,"Đặc Sản Nha Trang -️ Cá Bò Da Sợi Mè, Tẩm Gia Vị Ăn Liền Mềm Dai, Seavy Hộp 200gram",78000,80000,2000,3
TIKI,dong-ho-va-trang-suc,51717825,"Dây chuyền nữ mạ bạch kim cao cấp E892",180000,180000,0,0
TIKI,ngon,170501620,"Đặc Sản Nha Trang - Cá Cơm Mờm Rim Giòn Hương Vị Biển Seavy Hộp 200g",78000,80000,2000,3
TIKI,dong-ho-va-trang-suc,51962360,"Đồng hồ Nam HALEI H564 mặt vuông chữ nhật lich ngày sang trọng dây thép không gỉ",333000,351000,18000,5
TIKI,dong-ho-va-trang-suc,43043923,"Dây chuyền hợp kim xâu hạt trai giả thanh lịch và thời trang cho nữ",41000,50000,9000,18
TIKI,ngon,142033266,"Lê nâu Hàn Quốc (Premium Pear)",135000,135000,0,0
TIKI,ngon,172025047,"[ Chỉ giao HN] -Nho đỏ - 1kg",259000,259000,0,0
TIKI,dong-ho-va-trang-suc,68779880,"DÂY ĐỒNG HỒ DA BÒ NÂU ĐẤT - RAM  D1 NÂU ĐẤT - HÀNG CHÍNH HÃNG",189000,189000,0,0
TIKI,dong-ho-va-trang-suc,95294058,"Mặt dây chuyền thạch anh tóc vàng mệnh thủy, kim - Ngọc Quý Gemstones",599000,860000,261000,30
TIKI,dong-ho-va-trang-suc,50254695,"Dây Chuyền Ngọc Trai Nữ - Vòng Cổ Bạc Ngọc Trai Thật M1204 Bảo Ngọc Jewelry (Ngọc trai nước ngọt tự nhiên, Bạc s925 tinh khiết, 3 màu sắc)",921000,921000,0,0
TIKI,ngon,170180750,"Vòng cổ đệm cho chó (Chọn 4 màu) - Xanh Bộ đội - XL",36000,36000,0,0
TIKI,ngon,169064258,"Thức Ăn Cho Chó Con REFLEX PLUS MINI & SMALL BREED JUNIOR vị thịt gà - 1 Kg Chia TB",85000,85000,0,0
TIKI,ngon,169068665,"Thức Ăn Cho Chó Con Smartheart Puppy 400gr - 5 gói",145000,145000,0,0
TIKI,ngon,169005111,"Thức ăn hạt cho mèo catsrang 5kg nhập khẩu từ Hàn Quốc",415555,415555,0,0
TIKI,ngon,166057584,"Rọ mõm mỏ vịt cho chó (mầu ngẫu nhiên) - L",44000,44000,0,0
TIKI,ngon,169004347,"tấm lót vệ sinh chó mèo size S 100 tấm",133333,133333,0,0
TIKI,ngon,169005865,"6 Lon Pate Cho Chó Smartheart Dạng Lon (400g)",255555,255555,0,0
TIKI,ngon,169003950,"Bát ăn cho chó mèo xuống nước tự động (màu ngẫu nhiên, không kèm bình nước) - Size S",28799,28799,0,0
TIKI,ngon,166057920,"DÂY XÍCH DÂY CỔ CHUÔNG 2 LỚP CHO THÚ CƯNG - 1cm",28999,28999,0,0
TIKI,ngon,169064416,"Tả lót vệ sinh cho thú cưng - M",148999,148999,0,0
TIKI,ngon,169003747,"Sữa Tắm Fay 5 Sao (300ml)",76000,76000,0,0
TIKI,ngon,166062629,"RỌ MÕM MỎ VỊT THỜI TRANG ( giao màu ngẫu nhiên) - S",35000,35000,0,0
TIKI,ngon,166062921,"LỒNG SƠN TĨNH ĐIỆN GẬP GỌN NAN DÀY CHO CHÓ MÈO - TRUNG",329999,329999,0,0
TIKI,ngon,166062929,"Thức ăn cho mèo Pate me-o gói 80g - Cá ngừ Mèo con - Hộp 12 gói",144000,144000,0,0
TIKI,ngon,173380072,"Cát vệ sinh cho mèo Kunmiu Hương chanh 5L - 3 gói",155000,155000,0,0
TIKI,ngon,166063072,"Pate Cho Mèo Me-O Delite Gói 70g - Xanh dương",19000,19000,0,0
TIKI,ngon,169005123,"Bình nước gài chuồng cho thú cưng",24000,24000,0,0
TIKI,ngon,166083556,"Tã lót chuồng cho thú cưng ️siêu thấm hút màu xanh size S và M - S",150000,150000,0,0
TIKI,ngon,169064035,"Bát  Ăn Cho Chó Mèo Cao Cấp Chất Liệu Chén Sứ  - Size S (450ml)",62400,62400,0,0
TIKI,ngon,184492218,"Ruốc Tép BAVABI 150g Đặc Sản Vân Đồn Quảng Ninh Thơm Ngon Giàu Dinh Dưỡng",105000,105000,0,0
TIKI,ngon,169067030,"Vòi Uống Nước Gắn Chuồng Cho Chó Mèo Kún Miu - Màu Ngẫu Nhiên",32900,32900,0,0
TIKI,ngon,173379566,"chén nhựa tròn màu Pastel cho chó mèo - hồng,nhỏ",19000,19000,0,0
TIKI,ngon,166083273,"Súp Thưởng Me-O Creamy Treats Cho Mèo [1 THANH LẺ] - Xanh biển (Gà & Gan)",12000,12000,0,0
TIKI,ngon,169057228,"Chuông huấn luyện cho chó mèo",32000,32000,0,0
TIKI,ngon,169004628,"chén nhựa tròn màu Pastel cho chó mèo - biển,trung",19000,19000,0,0
TIKI,ngon,171021190,"[ Chỉ giao HN] - Trà Thái Nguyên phổ thông 500g Tâm Minh",100000,100000,0,0
TIKI,ngon,169077648,"[Combo 30 lọ] Nước yến sào Sanvinest Khánh Hòa dành cho người cao tuổi đóng lọ 70ml",990000,990000,0,0
TIKI,ngon,169005267,"Thức Ăn Cho Mèo Trưởng Thành REFLEX ADULT Vị Thịt Gà - Hộp 1kg",85000,85000,0,0
TIKI,ngon,173379826,"Xương da bò gặm sạch răng cho chó - 25cm",85000,85000,0,0
TIKI,ngon,198482882,"Túi 1 Kg Bột Sữa Béo Cao cấp B One Pha Trà Sữa, Cà Phê - Nhập Khẩu Thái Lan",105000,105000,0,0
TIKI,ngon,170180436,"Combo Thức Ăn Cho Chó Smartheart Adult (400g)  - 5 gói",138000,138000,0,0
TIKI,ngon,169066720,"Dây dắt vòng cổ vải họa tiết ( Giao Ngẫu Nhiên )",35000,35000,0,0
TIKI,ngon,169003982,"Bàn cào móng cho mèo lượn sóng (tặng kèm catnip)",60000,60000,0,0
TIKI,ngon,169068241,"Đồ Ăn Cho Mèo Trưởng Thành Me-O Hương Vị Cá Ngừ (1.2 Kg)",111111,111111,0,0
TIKI,ngon,170180481,"Đồ chơi cho chó hình xương cá Kún Miu",9000,9000,0,0
TIKI,ngon,171105654,"[ Chỉ giao HN] - Chả Cốm 500gr",125000,125000,0,0
TIKI,ngon,169004667,"Đồ Ăn Cho Mèo Trưởng Thành Me-O Hương Vị Cá Ngừ (1.2 Kg)",120000,120000,0,0
TIKI,ngon,170179703,"Combo Thức Ăn Cho Chó Smartheart Adult (400g)  - 10 gói",275000,275000,0,0
TIKI,ngon,173379763,"Sữa Tắm SOS Cho Chó Mèo 530ml",85000,85000,0,0
TIKI,ngon,172120294,"Tương đậu Daesan",38000,38000,0,0
TIKI,ngon,171168588,"Đặc Sản Nha Trang - Cá Bò Da Sống Phi Lê Seavy Hộp 250G",82000,85000,3000,4
TIKI,ngon,179555623,"Nem chua rán Đôi Đũa Vàng đồ ăn vặt giòn rụm đặc sản phố cổ gói 240g",138000,138000,0,0
TIKI,ngon,195862792,"Xoài xanh chua",30000,30000,0,0
TIKI,ngon,120280101,"[Chỉ giao HN] - Thịt Nai Tươi - 1Kg",439000,439000,0,0
TIKI,ngon,197095746,"Đặc Sản Nha Trang-  Bánh Tráng Dừa Non Vị Lá Dứa, Hút Chân Không, Seavy Gói 220gram",32000,32000,0,0
TIKI,ngon,142205126,"[CHỈ GIAO HN] Ổi lê - 1KG",18000,18000,0,0
TIKI,ngon,114197799,"[Chỉ giao HN] - Gà Ủ Muối Hoa Tiêu Ăn Liền - 1 Con 2 Khay",199000,199000,0,0
TIKI,ngon,116553147,"[Chỉ giao HN] - Bao Tử Cá Basa - 1Kg",239000,239000,0,0
TIKI,ngon,108890189,"[CHỈ GIAO HN] - CHẢ CHÌA HẠ LŨNG VITOT FOOD (500g/ khay)",159000,159000,0,0
TIKI,ngon,170513413,"Đặc Sản Nha Trang - Cá Cơm Mờm Rim Giòn Seavy Hộp 500g",185000,200000,15000,8
TIKI,ngon,193777944,"Đặc Sản Nha Trang - Cơm Cháy Chà Bông Hải Hà Giòn Thơm, Béo Ngậy, Seavy Gói Tiết Kiệm 500g",120000,125000,5000,4
TIKI,ngon,128473357,"GIỎ QUÀ TẶNG CẢM ƠN",600000,600000,0,0
TIKI,ngon,168365370,"Đặc Sản Nha Trang -Mủ Trôm Nguồn Dưỡng Chất Tự Nhiên, Giải Độc, Nấu Nước Uống Mát, Seavy Gói 500g",98000,105000,7000,7
TIKI,ngon,117774545,"Đùi tỏi gà Truefood nhập khẩu 1 kg [Chỉ giao hỏa tốc HN]",95000,95000,0,0
TIKI,ngon,91247753,"[Chỉ Giao HN] - Nho Đỏ Crimson Úc",149000,149000,0,0
TIKI,ngon,142173340,"[CHỈ GIAO HÀ NỘI] Cam sành Tiền Giang 1KG",29000,29000,0,0
TIKI,ngon,121441670,"[Chỉ Giao HN] Lê Nâu Hàn Quốc (Quả từ 0.4-0.6kg/quả) ",45000,45000,0,0
TIKI,ngon,194815496,"Đặc Sản Nha Trang - Tôm Khô Nhỏ Loại 1 Đặc Biệt Seavy Gói 500G",485000,490000,5000,1
TIKI,ngon,170434167,"Đặc Sản Nha Trang - Cá Cơm Mờm Sữa Nha Trang Dinh Dưỡng Hảo Hạng, Đẳng Cấp Xuất Khẩu Seavy 500g",129000,135000,6000,4
TIKI,ngon,169331391,"Đặc Sản Nha Trang - Khô Cá Hố Lạt Nguyên Con Lớn Nha Trang, Seavy Gói 500g",149000,150000,1000,1
TIKI,ngon,119931938,"[GIAO NHANH HN - 1H - 0989.780.789] Giỏ Quà Trái Cây - AC236",720000,720000,0,0
TIKI,ngon,126809020,"[ Chỉ giao HN] - Khoai lang Mật 1kg",60000,60000,0,0
TIKI,ngon,120800181,"[Chỉ giao HN] - táo dazzle nhỏ -1Kg",85000,85000,0,0
TIKI,ngon,125803734,"[ Chỉ giao HN] -Ổi Thanh Hà 1kg",20000,20000,0,0
TIKI,ngon,109515125,"[Chỉ Giao HN] Cam Sành Tiền Giang - Combo 3Kg ",100000,100000,0,0
TIKI,ngon,179736579,"Thịt ba chỉ heo nhập khẩu 500g [Chỉ giao hỏa tốc HN]",69000,69000,0,0
TIKI,ngon,184790615,"Chân gà rút xương - 500g",43000,43000,0,0
TIKI,ngon,167951436,"Đặc Sản Nha Trang - Thùng 6 Chai Nước Mắm 584 Nha Trang 35 Độ Đạm, Nước Mắm Cao Cấp Nguyên Chất Đậm Đặc Seavy Thùng 6 Chai 500ml/chai",340000,350000,10000,3
TIKI,ngon,167687118,"Đặc Sản Nha Trang -Rong Biển Khô Hảo Hạng từ Đại Dương, Seavy Gói 100g",60000,69000,9000,13
TIKI,ngon,140621783,"Vú sữa Lò Rèn",49000,49000,0,0
TIKI,ngon,184908664,"Sấu Cạo Vỏ Sẵn Hút Chân Không – 1Kg",95000,95000,0,0
TIKI,ngon,196318911,"Ba chỉ bò dải canada-500g",110000,110000,0,0
TIKI,ngon,163554367,"[Chỉ giao HN] - Nạc vai heo - 1kg",119000,124000,5000,4
TIKI,ngon,190842055,"Bí cô tiên",13000,13000,0,0
TIKI,ngon,190755794,"Set lẩu Thái chua cay Đôi Đũa Vàng tươi ngon bùng vị đậm đà dành cho 2 người",175000,175000,0,0
TIKI,ngon,193778000,"Đặc Sản Nha Trang - Chuối Bala Sấy Dẻo Gói Seavy 250G",40000,40000,0,0
TIKI,ngon,191755652,"Đặc Sản Nha Trang - Khô Cá Đuối Mắm Me Seavy Hộp 220G",98000,105000,7000,7
TIKI,ngon,196318924,"Khoai lang cọng-250g",20000,20000,0,0
TIKI,ngon,197119740,"Đặc Sản Nha Trang- Bánh Tráng Dừa Non Vị Sầu Riêng Hút Chân Không, Seavy Gói 220 gram",32000,32000,0,0
TIKI,ngon,121641680,"Lõi Vai Bò Mỹ Steak Kèm Lá Hương Thảo - 500gr",179500,179500,0,0
TIKI,phu-kien-thoi-trang,48891113,"KÍNH MÁT NAM EXFASH EF58778",342000,640000,298000,47
TIKI,phu-kien-thoi-trang,160307176,"Mũ lưỡi trai ️ Nón kết thêu hình chữ Hello chất kaki cao cấp form unisex nam nữ N26",49000,49000,0,0
TIKI,phu-kien-thoi-trang,119926661,"Cà Vạt Thắt Sẵn Bản 7,5cm",150000,150000,0,0
TIKI,phu-kien-thoi-trang,181692724,"Lens mắt nâu mật ong Nami hiệu Angel Eyes đường kính 12.8 có hỗ trợ cận 0-8",150000,150000,0,0
TIKI,phu-kien-thoi-trang,91751049,"Mặt khóa thắt lưng nam chính hãng D&D Fashion (Mặt rời không dây)",50000,100000,50000,50
TIKI,phu-kien-thoi-trang,147485550,"Sticker, phụ kiện, pin cài Balo, áo bò sữa siêu đáng yêu",2800,2800,0,0
TIKI,phu-kien-thoi-trang,193699514,"Mũ Nón Cói Đi Biển Rộng vành Nửa Đầu - HT",49000,49000,0,0
TIKI,phu-kien-thoi-trang,83615670,"Khẩu trang ninja che kín tai chống nắng, chống bụi thích hợp cả nam và nữ - khau trang che kin tai",30000,30000,0,0
TIKI,phu-kien-thoi-trang,31570157,"Kính mát Unisex EXFASH EF 36758 C20",532000,598000,66000,11
TIKI,phu-kien-thoi-trang,20118479,"Cà vạt thắt sẵn, cà vạt nam bản 5cm CA07",59000,59000,0,0
TIKI,phu-kien-thoi-trang,132023398,"Thắt lưng nam, dây nịt nam da bò Saffiano 3 lớp Bụi Leather L106 - Khóa tự động, nhiều mặt khóa tùy chọn - Bảo hành 12 tháng",225000,412000,187000,45
TIKI,phu-kien-thoi-trang,37038665,"D ây t ết tó c boh em ia n m àu s ắ  c",48000,48000,0,0
TIKI,phu-kien-thoi-trang,133135926,"Thắt lưng nam, dây nịt nam da bò thật nguyên tấm Bụi Leather L112 - Khóa cài  - Bảo hành 12 tháng",259000,260000,1000,0
TIKI,phu-kien-thoi-trang,159275501,"Mắt Kính Ray-Ban  - RX7059D 5196 -Eyeglasses",2128000,2660000,532000,20
TIKI,phu-kien-thoi-trang,35962907,"KÍNH VIỄN THỊ HAI TRÒNG NHÌN XA VÀ GẦN GỌNG HỢP KIM TITAN SIÊU BỀN_KV11_DROPSHIP",186000,186000,0,0
TIKI,phu-kien-thoi-trang,197572060,"Kẹp Tóc Bằng Hợp Kim Cao Cấp Đính Đá Sang Trọng Cho Nữ",65000,65000,0,0
TIKI,phu-kien-thoi-trang,40869482,"Mũ nồi nữ len dạ dày dặn - Hàng loại 1",92000,92000,0,0
TIKI,phu-kien-thoi-trang,194498792,"Kẹp tóc nữ hàn quốc NASI cao cấp hình bướm pha lê lấp lánh chất liệu hợp kim cao cấp bền đẹp kẹp tóc mái mẫu đẹp kẹp mỏ vịt",25000,25000,0,0
TIKI,phu-kien-thoi-trang,59540781,"Gọng Kính Cận, Kính Giả Cận Nam Nữ Clubmaster Đen Bạc Hàn Quốc",52000,52000,0,0
TIKI,phu-kien-thoi-trang,168273878,"Tất Giày Tây Nam Cao Cấp Họa Tiết Chấm Bi, Vớ Nam Cổ Cao Chất Liệu Cotton Hút Ẩm Thoáng Khí - GOM-CHAMBI-1DOI",26000,50000,24000,48
TIKI,phu-kien-thoi-trang,15201330,"Set 2 Kiểu Băng Đô Ngọc Trai Hàn Quốc Thời Trang",19000,34500,15500,45
TIKI,phu-kien-thoi-trang,15463535,"Cài tóc hạt châu gợn sóng - phụ kiện tóc nữ style Hàn Quốc",33000,35000,2000,6
TIKI,phu-kien-thoi-trang,83617592,"Mũ len kèm khăn choàng cổ giữ ấm thời trang mùa đông cho nam nữ",68000,68000,0,0
TIKI,phu-kien-thoi-trang,72518524,"Kính Giả Cận, Gọng Kính Cận Nam Nữ Mắt Vuông To Gọng Nhựa Đen Nhám, Trong Suốt Không Độ Hàn Quốc - BLUE LIGHT SHOP",185000,185000,0,0
TIKI,phu-kien-thoi-trang,74512404,"Tóc giả nữ cột xoăn ngắn C016 FREESHIP buộc tóc giả, tóc giả buộc, cột tóc giả nữ xoăn ngắn 28cm",42000,42000,0,0
TIKI,phu-kien-thoi-trang,128256664,"Mũ lưỡi trai, nón kết big size cỡ lớn cho nam đầu to (chu vi 59-65cm) - PK016",37000,37000,0,0
TIKI,phu-kien-thoi-trang,115610834,"Kẹp xược tạo phồng tóc phồng mái, Kẹp Tóc, Tạo Phồng mái - Phụ Kiện Thời Trang Teen",11500,11500,0,0
TIKI,phu-kien-thoi-trang,91516314,"Kẹp tăm chữ U ( size S,M,L)",48000,48000,0,0
TIKI,phu-kien-thoi-trang,170661553,"Khăn ống trùm đầu đa năng Khẩu trang đa năng Không in hình Chất liệu vải siêu co giãn 2 lớp, Chống nắng, Chống bụi",32000,32000,0,0
TIKI,phu-kien-thoi-trang,85554798,"Nón rộng vành tai bèo nam trơn không thêu logo, nhiều màu sắc lựa chọn, chống nắng tốt - Hạnh Dương",34900,34900,0,0
TIKI,phu-kien-thoi-trang,54809754,"Bộ 2 khẩu trang ninja che cổ dán gáy vải nỉ chống nắng gió bụi hàn xì thích hợp cả nam và nữ - khau trang ninja che co dan gay chong nang",69000,69000,0,0
TIKI,phu-kien-thoi-trang,13374584,"Bờm cài tóc nam nữ bằng sắt siêu bền xoắn lò xo to BV65",22000,22000,0,0
TIKI,phu-kien-thoi-trang,108899928,"Đai đeo quần nam chữ Y 2.5cm - dây yếm quần nam cao cấp bản nhỏ",180000,180000,0,0
TIKI,phu-kien-thoi-trang,173093388,"kính lão viễn thị đọc sách gọng nhựa màu nâu dành cho nữ kiểu dánh đẹp",45000,45000,0,0
TIKI,phu-kien-thoi-trang,187603949,"Kính Râm, Kính Mát Nam Nữ KuBo Mắt Vuông Nhỏ Cao Cấp Cứng Cáp Nhựa TR90 - BLUE LIGHT",230000,230000,0,0
TIKI,phu-kien-thoi-trang,138283210,"Cột tóc vải kết đá thời trang cho nữ",45000,45000,0,0
TIKI,phu-kien-thoi-trang,102261685,"COMBO 3 KHẨU TRANG VẢI - BEST UNIQUE IDEAS",29000,29000,0,0
TIKI,phu-kien-thoi-trang,99671436,"miếng dán tóc mái nhũ hàng đẹp,siêu thích",15000,15000,0,0
TIKI,phu-kien-thoi-trang,19672406,"Băng đô tai mèo đủ bộ lựa chọn",18000,18000,0,0
TIKI,phu-kien-thoi-trang,43759989,"Set 10 Đôi Tất Chân Nữ xuất Nhật - CB024",58000,99000,41000,41
TIKI,ngon,185260727,"Cá Trắm Cỏ Làm Sạch Nguyên Con Size 3.6-4.5kg",128000,128000,0,0
TIKI,ngon,185816140,"Nước Mắm Truyền Thống Phan Thiết 60 Độ Đạm Dung Tích 60Ml Nguyên Chất Hương Vị Truyền Thống",19900,19900,0,0
TIKI,ngon,185258707,"Cá Ba Sa Lột Da Tề Mỡ Sạch Size 1.6-3kg",158000,158000,0,0
TIKI,ngon,171104779,"[ Chỉ giao HN]  - Chim Cút Quay 1 Khay / 3 Con",135000,135000,0,0
TIKI,ngon,171828123,"Cá trắm kho niêu làng Vũ Đại 4kg",1050000,1050000,0,0
TIKI,ngon,273317897,"Đặc Sản Nha Trang-Tổ Yến Dành Cho Người Cao Tuổi Lifesnest Với 20% Yến Sào Thiên Nhiên - Seavy Combo 5 Hủ",195000,195000,0,0
TIKI,ngon,99041617,"[Chỉ Giao HCM] - Bắp bò Úc 500g",129999,129999,0,0
TIKI,ngon,184791364,"Thăn ngoại bò Hukobe - 300g",280000,280000,0,0
TIKI,ngon,127518531,"[Chỉ giao HN] Set Cơm cá hồi sốt teriyaki",114000,114000,0,0
TIKI,ngon,122646253,"Rong Nho Hikario",165000,165000,0,0
TIKI,ngon,170180581,"Dầu Tắm Trị Bọ Chét, Ve, Ghẻ, Rận Chó Mèo Hanvet Hantox  200ml - HỒNG",33000,33000,0,0
TIKI,ngon,127509718,"[Chỉ giao HN] Mực ống thả lẩu 150gr",93500,93500,0,0
TIKI,ngon,169065541,"Sữa Tắm Chó Mèo Trị Nấm Da, Demodex, Ve, Ghẻ, Bọ Chét Chó Meo Bio (150ml)",48888,48888,0,0
TIKI,ngon,160392264,"Viên thả lẩu phô mai trứng muối",76000,76000,0,0
TIKI,ngon,169005590,"Dầu Tắm Trị Bọ Chét, Ve, Ghẻ, Rận Chó Mèo Hanvet Hantox 200ml - Hồng",45000,45000,0,0
TIKI,ngon,169065132,"[Gói 100g] Thức ăn Pháp giúp chăm sóc răng miệng,hỗ trợ tiêu hóa,tiêu búi lông cho mèo con và mèo trưởng thành - RC Kitten 36",23500,23500,0,0
TIKI,ngon,166062768,"Sữa tắm SOS 530ml cho chó mèo - Đen",79999,79999,0,0
TIKI,ngon,134505041,"[Chỉ giao HN] - Kim quất ngọt Đài Loan - 500G",75000,75000,0,0
TIKI,ngon,166083032,"Cỏ Bạc Hà Catnip cho mèo - Cỏ bạc hà mèo 10g",29899,29899,0,0
TIKI,ngon,118896430,"[Chỉ giao HN] Kem hộp vị Socola Bạc Hà - Mint Chocolate",119000,119000,0,0
TIKI,ngon,126234046,"Sụn heo - 1kg",135000,135000,0,0
TIKI,ngon,169062427,"Đồ chơi cho chó cao su dạng bóng Kún Miu",29999,29999,0,0
TIKI,ngon,169066126,"Bóng Cao Su Đồ Chơi Cho Chó Mèo Hình Dấu Chân Chó - XANH LÁ",20000,20000,0,0
TIKI,ngon,170180296,"Dầu tắm SOS cho chó mèo 530ml - Xanh ngọc",79999,79999,0,0
TIKI,ngon,166063013,"Thức ăn cho mèo Pate me-o gói 80g - Vị cá ngừ - Hộp 12 gói",144000,144000,0,0
TIKI,ngon,173379662,"Pate Me-o cho mèo gói 80g",12999,12999,0,0
TIKI,ngon,166062722,"Pate Me-o cho mèo gói 80g",12999,12999,0,0
TIKI,ngon,166062909,"Sữa Tắm Olive Essence 450ml Cho Chó Mèo - 1. Lông nâu đỏ",50000,50000,0,0
TIKI,ngon,170180131,"Banh đồ chơi loại dầy cho chó mèo ( màu ngẫu nhiên )",19000,19000,0,0
TIKI,ngon,169066740,"Sữa Tắm Trị Ve Rận Bọ Chét Chó Mèo Hantox Shampoo 200ml - chai hồng",41000,41000,0,0
TIKI,ngon,125900019,"[Chỉ Giao HN] Cá Chép Giòn đang bơi_4-5kg/con_Minafood_MM00016",675000,675000,0,0
TIKI,ngon,169003642,"Bóng Cao Su Đồ Chơi Cho Chó Mèo Hình Dấu Chân Chó - HỒNG",20000,20000,0,0
TIKI,ngon,116553145,"[Chỉ giao HN] - Cá Sụn Sịnh Tươi Đông Lạnh - 1Kg 2 Khay",239000,239000,0,0
TIKI,ngon,173359170,"Sữa tắm cho chó mèo Olive Esence ( phát loại ngẫu nhiên)",48999,48999,0,0
TIKI,ngon,169004670,"[Gói 100g] Thức ăn Pháp giúp chăm sóc răng miệng,hỗ trợ tiêu hóa,tiêu búi lông cho mèo con và mèo trưởng thành - RC Dry Mix Feeding",25555,25555,0,0
TIKI,ngon,166059290,"Thức ăn hạt cho mèo Me-O - Adult Cá Ngừ 350g",27000,27000,0,0
TIKI,ngon,166062646,"Pate cho mèo Me-o vị cá ngừ  - 1 Gói",13000,13000,0,0
TIKI,ngon,166062560,"Pate cho mèo Me-o vị cá ngừ  - Hộp 12 gói",145000,145000,0,0
TIKI,ngon,116617888,"[Chỉ Giao Hà Nội] Trâu xé muối trứng kiến 120g",180000,180000,0,0
TIKI,ngon,166062917,"Găng Tay Chải Lông Chó Mèo Tiện Lợi",39999,39999,0,0
TIKI,ngon,117404855,"[CHỈ GIAO HN] Set lẩu thập cẩm cho 4 người lớn ăn thoải mái ",499000,499000,0,0
TIKI,ngon,119932968,"[GIAO NHANH HN - 1H - 0989.780.789] Giỏ Quà Trái Cây - AC248",1010000,1010000,0,0
TIKI,ngon,155495735,"[Chỉ giao HN]Thịt Ba Chỉ-300gr",45000,45000,0,0
TIKI,ngon,170438002,"Đặc Sản Nha Trang -️ Khô Cá Cơm Trỏng Rút Xương Tẩm Gia Vị Seavy Gói 500g",199000,210000,11000,5
TIKI,ngon,197099860,"Đặc Sản Nha Trang-  Bánh Tráng Dừa Non Vị Truyền Thống Hút Chân Không, Seavy Gói 220gram",32000,32000,0,0
TIKI,ngon,192092540,"Đặc Sản Nha Trang -️ Kẹo Me Cay Sấy Khô, Chua Chua Cay Cay, Seavy Hộp 200 gram",50000,50000,0,0
TIKI,ngon,176170718,"[ Chỉ giao HN] - Xúc xích Vealz 500 gr( 10 cay)",86000,86000,0,0
TIKI,ngon,186313825,"Phô mai viên Đôi Đũa Vàng 300g nhân Mozzarella tan chảy béo ngậy",169000,169000,0,0
TIKI,ngon,117569418,"[Chỉ giao HN] - Bánh Khúc Việt Trì - Túi 10 Cái Trắng - Đông Lạnh",219000,219000,0,0
TIKI,ngon,193133255,"[Chỉ giao HN] - Tỏi gà - Khay 4-5 chiếc",69000,98000,29000,30
TIKI,ngon,164428804,"[ Chỉ giao HN] - Kiwi xanh - 1kg",82000,82000,0,0
TIKI,ngon,120800164,"[Chỉ giao HN] -Dưa Melon Crown (kg) - 1kg",1250000,1250000,0,0
TIKI,ngon,160370343,"phô mai bào mozzarella",98000,98000,0,0
TIKI,ngon,141947626,"Dâu tây Hana Mộc Châu - 0.5KG",79000,79000,0,0
TIKI,ngon,160621144,"Cam Canh",60000,60000,0,0
TIKI,ngon,174430884,"Bình Gas loại 12kg - Van Ngang ",430000,430000,0,0
TIKI,ngon,180322253,"Nước mắm tôm biển Làng Chài Xưa Hồng Ngọc Đại Dương 125ml/chai",29000,29000,0,0
TIKI,phu-kien-thoi-trang,22194322,"NÓN NỮ RỘNG VÀNH ĐI BIỂN CHỐNG TIA UV - DN19VT0742",151050,159000,7950,5
TIKI,ngon,197749366,"Đặc Sản Nha Trang - Bánh Đậu Phộng Seavy Gói 300G",32000,32000,0,0
TIKI,ngon,117570629,"[Chỉ giao HN] - Bánh Khúc Không Xôi - Túi 5 Cái - Đông Lạnh",149000,149000,0,0
TIKI,phu-kien-thoi-trang,100887633,"Nón kết trơn nam nữ màu xanh đen navy - Mũ Lưỡi trai thời trang",19900,19900,0,0
TIKI,ngon,116553105,"[Chỉ giao HN] - Cá Sặc Trứng 1 Nắng - 1Kg 2 Khay",300000,300000,0,0
TIKI,phu-kien-thoi-trang,57286953,"Kính lão thị kính viễn thị đa tròng nhìn mọi khoảng cách nam nữ sẵn độ",199000,199000,0,0
TIKI,phu-kien-thoi-trang,195030720,"Tất ẩn nam đi giày lười cotton  kháng khuẩn, khử mùi ONOFF - 18AN24A153",35000,45000,10000,22
TIKI,phu-kien-thoi-trang,193720987,"Kính Râm Nam Aoron Kính Mát Nam Chống Tia UV Mắt Kính Thời Trang Phân Cực Kiểu Dáng Phi Công Cực Ngầu - AK062 - Aoron",350000,420000,70000,17
TIKI,ngon,125803742,"[ Chỉ giao HN] -Bưởi Phúc Trạch 1 quả -1.5kg",45000,45000,0,0
TIKI,ngon,189590066,"Đặc Sản Nha Trang - Cá Thiều Miếng Tẩm Gia Vị Ăn Liền Seavy Hộp 200G",98000,105000,7000,7
TIKI,phu-kien-thoi-trang,174605017,"Tất Nam Mang Giày Lười Vải Cotton Mềm Mại Thoáng Mát Có Đệm Cao Su Chống Trượt Gót Chân - TAT-LUOI-02",9900,15000,5100,34
TIKI,ngon,118895494,"[Chỉ giao HN] Kem hộp vị Caramen Mặn - Salted Caramel",119000,119000,0,0
TIKI,ngon,121641726,"Đùi Tỏi Gà - 800gr-1000gr",80000,80000,0,0
TIKI,ngon,167748959,"Đặc Sản Nha Trang - Rong Biển Khô, Rong Sụn Làm Gỏi, Seavy 500 Gram",155000,160000,5000,3
TIKI,phu-kien-thoi-trang,21878209,"NÓN RỘNG VÀNH ĐI BIỂN ĐẸP MŨ RỘNG VÀNH ĐI BIỂN ĐẸP THỜI TRANG HÀN QUỐC MỚI - DN19RV0710",166250,175000,8750,5
TIKI,phu-kien-thoi-trang,114292852,"QUẦN TẤT LÓT LÔNG HÀNG CAO CẤP",109000,109000,0,0
TIKI,phu-kien-thoi-trang,185243258,"Bờm cá mập ngoạm đầu dễ thương - Băng Đô Cài Tóc Hình Cá Vàng & Khủng Long",118800,118800,0,0
TIKI,ngon,195277152,"Đặc Sản Nha Trang - Mắm Tôm Chua Truyền Thống Siêu Nhiều Tôm Seavy ️Hộp 500G",145000,150000,5000,3
TIKI,phu-kien-thoi-trang,29207997,"Kính Giả Cận, Gọng Kính Cận Nam Nữ Mắt Vuông Trong Suốt Không Độ Hàn Quốc - BLUE LIGHT SHOP",189050,199000,9950,5
TIKI,ngon,172919161,"[Chỉ giao Hà Nội] - Gas Petrol Thăng Long 12kg",470000,470000,0,0
TIKI,phu-kien-thoi-trang,139731049,"Gọng Kính Cận Nam Nữ Kính Mắt Có Tròng Chống Tia UV Chống Mỏi Mắt Hàn Quốc Viniel KR02 - Hàng Chính Hãng",200000,200000,0,0
TIKI,phu-kien-thoi-trang,150609489,"Gọng kính 8086 nhựa cao cấp siêu bền thời trang cá tính nam nữ OURESS",270000,299000,29000,10
TIKI,ngon,173380962,"Súp Thưởng Me-O Creamy Treats Cho Mèo [1 THANH LẺ] - Xanh lá(Cá Ngừ Nhật)",12000,12000,0,0
TIKI,ngon,125452845,"Nem bùi Bắc Ninh - sét 3 nắm",109000,109000,0,0
TIKI,phu-kien-thoi-trang,83616522,"Khẩu trang ninja che kín mặt kín cổ thêm kính bảo vệ mắt chống nước bọt băn chống bụi nắng gió",45000,45000,0,0
TIKI,phu-kien-thoi-trang,160217257,"Mũ lưỡi trai - nón Ulzzang thêu chữ Always unisex nam nữ chống nắng phong cách đường phố, thời trang",41000,82000,41000,50
TIKI,phu-kien-thoi-trang,46608345,"Gọng Kính Cận Clubmaster Nam/ Nữ N240 6205 Vuông Vừa",189000,199000,10000,5
TIKI,phu-kien-thoi-trang,271257899,"Dây đeo mắt kính thời trang vải dù Lens Deli",10000,10000,0,0
TIKI,phu-kien-thoi-trang,192962090,"Hình xăm cặp đôi, couple chủ đề con hổ, con thỏ dễ thương, Xăm giống Inkaholic",30000,30000,0,0
TIKI,phu-kien-thoi-trang,28324146,"Cặp Kính Áp Tròng Dùng 1 Ngày Eye Secret KM1N - Fuji Rose",60000,70000,10000,14
TIKI,phu-kien-thoi-trang,87093164,"Thắt Lưng Nam Da Thật Không Đầu Khóa D&D Fashion",50000,100000,50000,50
TIKI,phu-kien-thoi-trang,160404288,"Thắt lưng nữ bản to dây nịt đai váy nịt bụng 6cm dona22012101",79000,79000,0,0
TIKI,phu-kien-thoi-trang,72900729,"Kẹp Tóc - Kẹp Tóc Mỏ Vịt  Chất Liệu Bền Đẹp Sáng Bóng",6300,6300,0,0
TIKI,ngon,176170685,"[ Chỉ giao HN] - Xúc Xích Pháp 450gr",122400,122400,0,0
TIKI,dong-ho-va-trang-suc,106390876,"Dây Đồng Hồ HUBLOT Lót Da Vân Đen Thơm Mùi Vani Case 38 Size Dây 15 - 21 - 18",150000,150000,0,0
TIKI,ngon,195639897,"️Đặc Sản Nha Trang-  Chà Bông Cá Thu Nha Trang  Mặn Ngọt Cay, Đặc Sản Biển, Seavy Hộp 200g",86000,90000,4000,4
TIKI,dong-ho-va-trang-suc,20583900,"Dây chuyền Phật Thiên Thủ Thiên Nhãn_ Phật hộ mệnh cho tuổi Tý_Mặt Phật đá phong thủy_ Phật bản mệnh, Mặt Phật Đá Núi Lửa Obsidian (3,3 x 5 cm)",81000,81000,0,0
TIKI,ngon,171926802,"[ Chỉ giao HN] - Khâu Nhục Sơn Dương 700gr",170000,170000,0,0
TIKI,phu-kien-thoi-trang,169314076,"Khăn phượt đa năng màu xanh than | Khăn đa năng đi phượt vải thun trơn mềm mịn, thoáng khi, may 2 đầu, chống nắng chống tia UV, gió cát, bụi, côn trùng",35000,45000,10000,22
TIKI,dong-ho-va-trang-suc,21433575,"Đồng hồ nam dây nhựa Casio G-Shock chính hãng DW-5600E-1VDF",2343000,3005000,662000,22
TIKI,dong-ho-va-trang-suc,37140290,"Bông Tai Nam Châm Titan Không Đen Không Dị Ứng TT 0767 - 2 chiếc",48000,48000,0,0
TIKI,ngon,186229733,"Khoai môn lệ phố hương cốm Đôi Đũa Vàng 260g",103000,103000,0,0
TIKI,phu-kien-thoi-trang,45157981,"NÓN LEN NỮ BERE, MŨ LEN NỮ BERE DN191227",141550,149000,7450,5
TIKI,phu-kien-thoi-trang,111114957,"Ca Vat, Caravat, Cà Vạt, Cravat Đen Nam Bản Nhỏ 5Cm Dây Kéo Thắt Sẵn",38000,38000,0,0
TIKI,dong-ho-va-trang-suc,197899388," Nhẫn Bạc Nữ Đơn Giản, Nhẫn Bạc Nữ Đính Đá Cầu Vòng Tình Yêu - N1455 - Bảo Ngọc Jewelry",330000,330000,0,0
TIKI,phu-kien-thoi-trang,151612102,"tóc búi cột xoăn",37000,42000,5000,12
TIKI,ngon,126795016,"[Chỉ giao HN] Đuôi Heo khay - 1Kg",115000,115000,0,0
TIKI,dong-ho-va-trang-suc,42788270,"Vòng tay cặp đá mã não liền khối tự nhiên - Ngọc Quý Gemstones",189000,189000,0,0
TIKI,phu-kien-thoi-trang,24185750,"Combo 12 dây buộc tóc nữ dễ thương (có hộp)",22000,22000,0,0
TIKI,dong-ho-va-trang-suc,99093232,"Nhẫn Nam Inox Thời Trang Chữ Phước-NN667",65000,65000,0,0
TIKI,phu-kien-thoi-trang,114070342,"Mũ nón lưỡi trai ngắn vành nam nữ phong cách ulzzang Hàn Quốc – SMN01",69000,69000,0,0
TIKI,phu-kien-thoi-trang,73179336,"Bờm cài tóc bản to phối nhiều mầu dễ tương BN103",42000,42000,0,0
TIKI,dong-ho-va-trang-suc,134313665,"Dây da đồng hồ Size 12 (Nhiều màu)",150000,150000,0,0
TIKI,phu-kien-thoi-trang,160705666,"Khăn lau nano chống bám hơi nước, sương mù, bụi",40000,40000,0,0
TIKI,phu-kien-thoi-trang,188381429,"Bờm cài tóc tết - tóc giả thắt bím SIZE LỚN",15000,15000,0,0
TIKI,dong-ho-va-trang-suc,155701516,"[1 Hạt] 14x11MM Lu Thống Đá Mắt Rồng Tím, Charoite, Tự Nhiên Loại AAA, Phối Vòng Tay Phong Thuỷ, Chuỗi Hạt, Trang Sức, Mặt Dây Chuyền, Hợp Mệnh Thổ, Hỏa - Bead Art",440000,440000,0,0
TIKI,phu-kien-thoi-trang,140879522,"Nón bucket trơn unisex, nam nữ đội đều đẹp luôn nhé",32000,32000,0,0
TIKI,dong-ho-va-trang-suc,82874965,"Dây vải đeo cổ dạng rút - Dây rút điểm vàng - Ngọc Quý Gemstones",20000,40000,20000,50
TIKI,dong-ho-va-trang-suc,80946681,"Vòng tay hạt đậu đỏ - Hồng đậu - tình yêu nồng thắm kèm hộp sang trọng",49000,49000,0,0
TIKI,phu-kien-thoi-trang,107614756,"Bao tay, Găng tay xe máy moto đi phượt Full Ngón - Đen - L",95000,95000,0,0
TIKI,dong-ho-va-trang-suc,45816165,"Khuyên tai hình nốt nhạc đính đá lấp lánh phong cách Hàn Quốc",28500,30000,1500,5
TIKI,dong-ho-va-trang-suc,116380839,"Vòng Tay Phản Quang Phát Sáng Trong Đêm Thời Trang Mẫu Mới 2020 full 4 Màu Hot",19000,19000,0,0
TIKI,ngon,189201802,"Cá hồi Fillet Đôi Đũa Vàng tươi sạch bổ dưỡng 185g",232000,232000,0,0
TIKI,dong-ho-va-trang-suc,176072099,"Dây đồng hồ cao su silicon cao dấp dành cho đồng hồ Huami Amazfit Gtr2 / Gtr2 e",59000,59000,0,0
TIKI,dong-ho-va-trang-suc,11224739,"Đồng hồ trẻ em SKMEI 0998",179000,215000,36000,17
TIKI,phu-kien-thoi-trang,193976758,"Nón lưỡi trai trơn đen Baseball cap phiên bản có tem - quai nút khoá dập logo - vải chất lượng cao",150000,150000,0,0
TIKI,dong-ho-va-trang-suc,14885390,"Đồng Hồ Nữ Chống Nước Mặt Đính Đá Sapphire R-Ontheedge RZY-06T",349000,349000,0,0
TIKI,ngon,114197797,"[Chỉ giao HN] - Vụn Cá Hồi Nauy Túi 1Kg Hút Chân Không",369000,369000,0,0
TIKI,dong-ho-va-trang-suc,59098787,"Bông Tai Nữ Kim Loại Mặt Hình Bướm Phối Khuyên Kẹp Vành Tai Cá Tính",15000,15000,0,0
TIKI,dong-ho-va-trang-suc,104854216,"Mặt dây chuyền ngọc bích mệnh hỏa, mộc - Ngọc Quý Gemstones",999000,1430000,431000,30
TIKI,dong-ho-va-trang-suc,41420250,"Đồng hồ Unisex Casio MQ-24-1ELDF dây nhựa",377400,444000,66600,15
TIKI,ngon,173330372,"[Chỉ giao HN] - Chả Mực Hạ Long - 500g",289000,289000,0,0
TIKI,dong-ho-va-trang-suc,5140123,"Vòng Đeo Tay Chú Mèo May Mắn",52000,52000,0,0
TIKI,ngon,193777793,"Đặc Sản Nha Trang -  Chùm Ruột Rim Đường Chua Ngọt, Seavy Hộp 500g",82000,85000,3000,4
TIKI,dong-ho-va-trang-suc,118775326,"Lắc Tay Bạc Ý S925 Dây Kép Hạt Bi Nhỏ Xinh L1773 - Bảo Ngọc Jewelry",290000,290000,0,0
TIKI,ngon,195659328,"Giò Lụa Gà - 1Kg",140000,140000,0,0
TIKI,phu-kien-thoi-trang,105085065,"GOTI - Cài Áo Nữ Kiểu Dáng Nguyệt Quế Tag Cài Váy Đẹp Thanh Lịch Dành Cho Nữ, Ghim Cài Áo, Váy Đầm Cao Cấp (Nhiều Mẫu) GOTI CA08",18000,30000,12000,40
TIKI,dong-ho-va-trang-suc,137330613,"Vòng cổ dây chuyền dù 3ly bền đẹp đính đá thời trang - phụ kiện dây dù đeo cổ",28000,28000,0,0
TIKI,dong-ho-va-trang-suc,16831194," Mặt dây chuyền Phổ Hiền Bồ Tát_Đá Mã Não Đỏ_Hộ Mệnh cho Tuổi Thìn,Tỵ",168000,168000,0,0
TIKI,ngon,180322266,"[Mua 3 được 6] Mua 3 chai nước tương shiitake tặng 3 chai nước mắm chay shiitake chai nhựa cao cấp 525ml thương hiệu Làng Chài Xưa",720000,720000,0,0
TIKI,ngon,166057912,"Sữa Tắm Olive Essence 450ml Cho Chó Mèo - 6. Ngừa rụng lông",50000,50000,0,0
TIKI,dong-ho-va-trang-suc,171153615,"Mặt dây chuyền đồng điếu đá mã não đỏ mệnh hỏa, thổ - Ngọc Quý Gemstones",250000,490000,240000,49
TIKI,ngon,157856536,"[ Chỉ giao HN] - Set nguyên liệu gói bánh chưng Lang Liêu (500-800g)",360000,360000,0,0
TIKI,phu-kien-thoi-trang,146285790,"Ống tay chống nắng vải thun lạnh thoáng mát tay xỏ ngón cái thích hợp cả nam và nữ",29000,29000,0,0
TIKI,ngon,191502135,"Hôp 50 khẩu trang kháng khuẩn, chống bụi 3 lớp PP ACE Nhật Bản - 50 chiếc",110000,110000,0,0
TIKI,ngon,186629952,"Cá viên rau củ Đôi Đũa Vàng đồ ăn vặt thả lẩu vị rau củ thanh mát gói 420g",145000,145000,0,0
TIKI,dong-ho-va-trang-suc,12960322,"Vòng tay đá ngọc Malaysia mix tỳ hưu đổi màu theo nhiệt độ MS304 - 10 li",125000,125000,0,0
TIKI,ngon,118693698,"[Chỉ giao HN] - Gà Trống Ngon Thịt Sẵn",399000,399000,0,0
TIKI,dong-ho-va-trang-suc,36572891,"Dây chuyền nữ mặt xoàn mạ",238500,238500,0,0
TIKI,dong-ho-va-trang-suc,98335515,"ĐỒNG HỒ KIM TRẺ EM CAO CẤP DÂY SILICON KHÔNG THẤM NƯỚC MR8833 DÀNH CHO BÉ GÁI",145000,145000,0,0
TIKI,ngon,147453935,"[Chỉ giao HN] - Nấm Kim Châm Tươi - 150g",25000,25000,0,0
TIKI,ngon,117570591,"[Chỉ giao HN] - Bánh Khúc Gạo Lứt Việt Trì - Túi 6 Cái - Đông Lạnh",169000,169000,0,0
TIKI,phu-kien-thoi-trang,127323041,"Dây Thun Cột Tóc HANVIET Sắc Màu",7900,7900,0,0
TIKI,ngon,109861051,"NutiMilk Thùng 48 Hộp Sữa chua Có Đường TU.NSCCDLA Nutifood",288000,288000,0,0
TIKI,ngon,193881179,"Bún khô gạo lứt đen Cao Bằng - 0.5kg",35000,35000,0,0
TIKI,ngon,195808260,"Chả mực Hạ Long",470000,470000,0,0
TIKI,ngon,179409548,"Bưởi da xanh 0.8-1kg/quả",50000,50000,0,0
TIKI,dong-ho-va-trang-suc,94852061,"Dây Chuyền Bạc Nữ Đính Đá Lấp Lánh Db2628 - Bảo Ngọc Jewelry",298000,298000,0,0
TIKI,phu-kien-thoi-trang,186157317,"Nón lưỡi trai trơn đen Brand One Hat",145000,145000,0,0
TIKI,dong-ho-va-trang-suc,22820937,"Bộ dụng cụ bấm lỗ tai kèm khuyên đeo cho nữ",155000,155000,0,0
TIKI,ngon,157856379,"[ Chỉ giao HN] - BB_Bánh bao đào hồng – 5 bánh đông lạnh",65000,65000,0,0
TIKI,dong-ho-va-trang-suc,72007237,"Pin CR2016 Maxell Lithium 3V vỉ 5 viên",42000,42000,0,0
TIKI,ngon,92380600,"Thịt đùi sau Cebo de Campo cắt lát (100g) - Muối trên 36 tháng",551000,551000,0,0
TIKI,ngon,191502097,"Hạt nêm Youki 500 Nhật Bản- 500g",225000,225000,0,0
TIKI,dong-ho-va-trang-suc,63271291,"Vòng cổ dây chuyền nam basic titan không đen",145000,145000,0,0
TIKI,ngon,179711703,"[Chỉ giao HN]  - Đậu lăng đỏ nhập khẩu Mỹ - 500gr",80000,80000,0,0
TIKI,ngon,170180514,"Thức Ăn Cho Mèo  Me-O Adult Vị Cá Thu (350g) - 10 Gói",275000,275000,0,0
TIKI,dong-ho-va-trang-suc,157019763,"Bông tai bạc tua nụ đá chất liệu bạc s925 MS04a",73000,73000,0,0
TIKI,dong-ho-va-trang-suc,102154788,"Đồng hồ trẻ em ( bé trai & bé gái )",55000,55000,0,0
TIKI,dong-ho-va-trang-suc,45781832,"Dây chuyền bạc thánh giá đính đá  - Trang sức bạc Panmila (TS-DC-A26)",90000,90000,0,0
TIKI,ngon,165206616,"[HN] 02 Chai Nước Ép Lạnh Rau Củ Quả Hữu Cơ",150000,150000,0,0
TIKI,ngon,179711650,"[Chỉ giao HN] - Sữa óc chó hạt sen ít đường - size S (325ml)",56000,56000,0,0
TIKI,ngon,142315254,"[Chỉ giao HN] Whipped Cream dạng xịt Anchor Bỉ 400g",197000,197000,0,0
TIKI,phu-kien-thoi-trang,103471537,"Thắt lưng nữ dây nịt nữ đai váy Nutushop da thật hàng cao cấp kiểu dáng thời trang cá tính - NT292",195000,195000,0,0
TIKI,ngon,173633234,"Bơ nhạt Gastronomique President 125g",71000,71000,0,0
TIKI,ngon,142315215,"[Chỉ giao HN] Sữa tươi nguyên kem Anchor New Zealand   -Hộp 1L lẻ",62000,62000,0,0
TIKI,ngon,169003856,"Sữa tắm SOS cho chó mèo (100% chính hãng) - Xanh Lá,550ml",75000,75000,0,0
TIKI,ngon,128124517,"Tôm nõn to chưa hấp - 500gr",200000,200000,0,0
TIKI,dong-ho-va-trang-suc,56322894,"Combo Dây chuyền Nam mạ vàng 24k, Kiểu Đốt Trúc, Phong cách Hàn Quốc, Dài 45cm, Cỡ Hạt 6li, Kèm Túi Nhung sang trọng, Phù hợp đeo đi làm, gặp mặt",151000,170000,19000,11
TIKI,ngon,183482060,"[ Mã 8938511152050 Mua 6 tặng 2] Gạo Vinafood1 Séng Cù (3,5 kg) Vua của các loại gạo",162222,162222,0,0
TIKI,ngon,173032810,"[Chỉ giao HN] -  Thịt Xá Xíu Nọng Cằm 500gr",195000,195000,0,0
TIKI,ngon,128124473,"Cua 5 - 1kg",590000,590000,0,0
TIKI,dong-ho-va-trang-suc,73572953,"Bông Tai Bạc Nữ | Bông Tai Bạc ITALY S925 | Bông Tai Bạc Khuyên Tròn Phong Cách- B2545 - Bảo Ngọc Jewelry",121000,121000,0,0
TIKI,ngon,149799466,"Sữa chua uống Dâu Tây",18000,18000,0,0
TIKI,ngon,172299995,"Nước mắm Nam Ngư 10 độ đạm chai 750ml",50000,50000,0,0
TIKI,dong-ho-va-trang-suc,3899543,"Đồng Hồ Nam Điện Tử Thể Thao SKMEI 1155B - DHA473",143000,288000,145000,50
TIKI,ngon,173308593,"[Chỉ giao HN] - Thịt Ghẹ Nõn Bóc Sẵn - 500g",329000,329000,0,0
TIKI,ngon,120800183,"[Chỉ giao HN] - Nho kẹo -1kg",200000,200000,0,0
TIKI,ngon,125900025,"[Chỉ Giao HN] Cá Trắm Đen (trắm ốc) đang bơi - con 6-7 kg - Minafood - MM0004",815000,815000,0,0
TIKI,ngon,171021210,"[ Chỉ giao HN] - Trà Thái Nguyên 3 sao 500g Tâm Minh",150000,150000,0,0
TIKI,dong-ho-va-trang-suc,19823406,"Dây chuyền vòng cổ nam đá phong thuỷ đen mặt hình Quan Công Quan Vân Trường QC111",135000,135000,0,0
TIKI,dong-ho-va-trang-suc,6187133,"2 vỉ pin đồng hồ đeo tay",17000,17000,0,0
TIKI,ngon,191502107,"Tẩy lồng giặt Ultra (mẫu mới)- 550g",85000,85000,0,0
TIKI,ngon,115851344,"[CHỈ GIAO HN] - THỊT GHẸ BÓC NÕN VITOT FOOD (500g/ khay)",249000,249000,0,0
TIKI,ngon,143043574,"[CHỈ GIAO HN] Quýt đường Lai Vung - 1KG",48000,48000,0,0
TIKI,ngon,120161807,"[Chỉ giao HN] Set sashimi tổng hợp 350gr",489000,489000,0,0
TIKI,ngon,180363450,"[GIAO NHANH HN - 1H - 0989.780.789] Giỏ quà trái cây - AC009",1440000,1440000,0,0
TIKI,dong-ho-va-trang-suc,76795655,"Bộ dụng cụ bấm lỗ tai tặng kèm 198 khuyên",179000,179000,0,0
TIKI,phu-kien-thoi-trang,162189778,"Hộp 5 đôi tất vớ đi giày tây nam cổ cao GOMTAT họa tiết chấm bi, chất cotton cao cấp hút ẩm thoáng khí - GOM-CHAMBI-CB5",129000,250000,121000,48
TIKI,ngon,121603602,"[ Chỉ giao HN] - Salami Nga 300gr",216000,216000,0,0
TIKI,phu-kien-thoi-trang,41768898,"Váy Chống Nắng Dạng Quần Vải JEAN Thêu Hoa Cánh Trắng",250000,250000,0,0
TIKI,ngon,177714047,"combo 3 hũ đậu Hà Lan rang muối hũ 220gr",65000,65000,0,0
TIKI,ngon,129436509,"[Chỉ giao HN] Thịt bò Black Angus Oino 200+ - Striploin ( Thăn Lưng Cuối) - 1KG",1300000,1300000,0,0
TIKI,ngon,205255829,"Set 3 Khăn Lau Tay ,Lau Nhà Bếp Tiện Dụng",33000,33000,0,0
TIKI,ngon,205255109,"3-18mm Bộ mũi ta rô lấy ốc gãy 5 chi tiết",33000,33000,0,0
TIKI,ngon,205255911,"Đồng Hồ Dầu Cho Máy Rửa Xe Áp Lực Cao",155000,155000,0,0
TIKI,ngon,205255276,"Vòi Sen Tăng Áp Có Nút Khóa Nước, 3 Chế Độ Phun,Đường Kính 8cm",65000,65000,0,0
TIKI,ngon,205255712,"20M Dây Phun Áp Lực Cho Máy Phun Xịt Rửa Xe Black & Deckerr 1400S,1370TD, 1450,1570,1470,1500,1500S,BW17-B1-1700W,Type A",225000,225000,0,0
TIKI,ngon,205256065,"Vợt muỗi sạc điện đa năng (Đỏ)",109000,109000,0,0
TIKI,ngon,203701848,"Chả rươi Thịnh Phát - đặc sản Hải Phòng - 500g",260000,260000,0,0
TIKI,ngon,205255139,"Kéo Bấm Chỉ Đỏ Sắc,Bền",13000,13000,0,0
TIKI,ngon,204371396,"Đường ăn kiêng",135000,135000,0,0
TIKI,ngon,196175912,"Combo gia vị nấu thịt bò kho gói 500gr",330000,330000,0,0
TIKI,dong-ho-va-trang-suc,99189058,"Đồng hồ đôi Halei dây da chính hãng cao cấp",521550,549000,27450,5
TIKI,dong-ho-va-trang-suc,46108223,"Vòng cẩm thạch xanh lá bản hẹ ni 54 mệnh hỏa, mộc - Ngọc Quý Gemstones",1539000,1920000,381000,20
TIKI,dong-ho-va-trang-suc,164446865,"Dây đeo cho Huawei Watch Fit new/ Fit - kèm dụng cụ tháo (DFIT)",120000,120000,0,0
TIKI,ngon,121603552,"[ Chỉ giao HN] - Cồi sò điệp 500g",282000,282000,0,0
TIKI,ngon,205256049,"Bộ vòi sen điều chỉnh 3 chế độ nước Mishop (Bạc)",77500,77500,0,0
TIKI,ngon,121745066,"Bánh Nướng Nhân Khoai Môn - Vỏ Truyền Thống - Không Trứng Muối",45000,45000,0,0
TIKI,ngon,197562676,"Ba chỉ heo rút sườn - Pork belly boneless single ribbrd rind 500G",95000,95000,0,0
TIKI,dong-ho-va-trang-suc,136367993,"NHIỀU MẪU - Vòng tay lắc tay dây bện cặp đôi đen trắng (2 cái)",45000,45000,0,0
TIKI,ngon,120860430,"Nước ép chanh tươi 350ml",40000,40000,0,0
TIKI,ngon,205255342,"Vòi xịt rửa",85000,85000,0,0
TIKI,dong-ho-va-trang-suc,150887439,"Dây đeo cổ sang chảnh, dễ thương",38000,40000,2000,5
TIKI,dong-ho-va-trang-suc,58298986," Nhẫn đá băng ngọc thủy tảo mệnh hỏa , mộc - Ngọc Quý Gemstones",499000,980000,481000,49
TIKI,ngon,190295043,"Nem Chua Rán Loại Đặc Biệt - Hộp 20 cái/500gr",70000,70000,0,0
TIKI,ngon,196175701,"Gia vị vịt nướng gói 500gr - bí quyết trong cách tẩm ướp vịt nướng ngon mê ly",39000,39000,0,0
TIKI,ngon,120860434,"Nước cam dứa 350ml",55000,55000,0,0
TIKI,dong-ho-va-trang-suc,51663731,"Đồng Hồ Nam HALEI 562 Có Lịch Chống Nước Thép Không Gỉ Cao Cấp  Full Box - Hàng Chính Hãng HALEI Thời Trang Nam Mặt Tròn, Vân Xọc Siêu Đẹp Dành Cho Nam",284000,299000,15000,5
TIKI,dong-ho-va-trang-suc,141009799,"Đồng Hồ Nam Cao Cấp FullBox, Dây Thép Không Gỉ, Mặt Kính Chống Trầy Xước, Chống Nước 3ATM, Phong Cách Thời Trang Hàn Quốc, Tặng Kèm Dụng Cụ Tháo Dây",599000,599000,0,0
TIKI,dong-ho-va-trang-suc,104916352,"Dây Da Đồng Hồ Khóa Bướm Da Cá Sấu Kèm Khóa Bướm Gập Cao Cấp, BH 6 Tháng",245000,245000,0,0
TIKI,dong-ho-va-trang-suc,74408923,"Đồng hồ kim thời trang nữ dây da mặt tròn Rtt1, dây da mềm",38000,38000,0,0
TIKI,dong-ho-va-trang-suc,37806305,"Bông Tai Nam Đính Đá Chất Liệu Thép Titan Không Rỉ Không Dị Ứng TT 0802 - 1 cặp",98000,98000,0,0
TIKI,ngon,196175751,"Bột gừng gói 500gr - Gia vị cho món ăn ngon",128000,128000,0,0
TIKI,dong-ho-va-trang-suc,190459926,"Nhẫn nữ thời trang phong cách hottrend,nhẫn đôi tình yêu, unisex cá tính giành cho mọi lứa tuổi NU-02",25000,25000,0,0
TIKI,ngon,205255288,"Máy hàn túi nylon dập tay 400mm",355000,355000,0,0
TIKI,dong-ho-va-trang-suc,38606393,"Nhẫn cặp anh yêu em trọn đời trọn kiếp BHN36",44000,69000,25000,36
TIKI,dong-ho-va-trang-suc,106392561,"Dây đồng hồ kim loại dạng lưới mắt khúc khóa bướm",304000,304000,0,0
TIKI,dong-ho-va-trang-suc,109837551,"Đồng Hồ Điện Tử Nữ Chính Hãng Casio LA670WA-1DF Dây Kim Loại",897000,1136000,239000,21
TIKI,ngon,196175935,"Bột lá nếp (bột lá dứa) gói 50g",55000,55000,0,0
TIKI,dong-ho-va-trang-suc,114694264,"Dây chuyền nữ ổ khóa tình yêu, vòng cổ trái tim dây xích sành điệu PK11",25000,25000,0,0
TIKI,dong-ho-va-trang-suc,30163069,"Dây chuyền nữ xi mạ",310000,310000,0,0
TIKI,dong-ho-va-trang-suc,24307921,"Dây chuyền nam cao su bọc rồng mạ",220000,231999,11999,5
TIKI,ngon,179711708,"[Chỉ giao HN] - Nước ép dứa cà rốt - size S (325ml)",56000,56000,0,0
TIKI,dong-ho-va-trang-suc,102122063,"[RẺ VÔ ĐỊCH - Bạc Cao Cấp Cam Kết 100% Bạc Ta] Nhẫn bạc lông voi nhân tạo may mắn - Kiểu nhẫn đôi",84000,84000,0,0
TIKI,dong-ho-va-trang-suc,193719269,"Đồng hồ nữ Julius dây đá Ceramic thời trang Ja-1273 Xanh",1199000,1199000,0,0
TIKI,ngon,105985819,"Dưa lưới nhà kính Trái - Combo 3 trái",249000,249000,0,0
TIKI,dong-ho-va-trang-suc,138307756,"Vòng Cổ Choker Nhiều Kiểu Dáng HOTTREND Phong Cách Hàn Quốc - Vòng đeo cổ nữ",25000,25000,0,0
TIKI,dong-ho-va-trang-suc,49723777,"Lắc Tay Nữ Dây Xích Tòn Ten Titan Ko Đen TT 2496",198000,198000,0,0
TIKI,ngon,208318187,"Bình sữa Philips Avent Natural bằng nhựa không có BPA 125ml 690.13",221000,221000,0,0
TIKI,dong-ho-va-trang-suc,58244051,"VÒNG TAY HUYẾT ÁP NHẬT BẢN-HÀNG NHẬP KHẨU",85000,85000,0,0
TIKI,ngon,197562651,"Sườn heo cánh buồm - Sparerib pork 500G",95000,95000,0,0
TIKI,dong-ho-va-trang-suc,2526833,"Dây Đồng Hồ Da Đà Điểu Huy Hoàng HT8403 - Vàng",249000,249000,0,0
TIKI,dong-ho-va-trang-suc,37543510,"Vòng tay Lu Thống Thạch Anh Đỏ - Vòng tay Phật A Di Đà inox vàng VTAOBNLVHB14 - hợp mệnh Hỏa, mệnh Thổ - Vòng đeo tay size lớn",218900,218900,0,0
TIKI,ngon,193911533,"Măng khô ( măng rối) Ninh Sớp 1kg",325000,325000,0,0
TIKI,ngon,196175785,"Combo 2 gói gia vị tẩm ướp vịt nướng dạng bột và muối 500gr - Mang đến hương vị thơm ngon, đậm đà, hấp dẫn cho món vịt",165000,165000,0,0
TIKI,ngon,205255437,"Bình tông, bình bi đông đựng nước, đựng rươu vỏ nhôm dung tích 2 lít + dây đeo",89000,89000,0,0
TIKI,ngon,121603551,"[ Chỉ giao HN] - Lườn ngỗng - 1 Cái",264000,264000,0,0
TIKI,dong-ho-va-trang-suc,108083618,"Cuộn 50m dây cước kim loại bọc nhựa 0.4mm xỏ vòng có khoá - Ngọc Quý Gemstones",55000,100000,45000,45
TIKI,dong-ho-va-trang-suc,178027887,"Dây da đồng hồ nam nữ DA BÒ THẬT 3 LỚP SIÊU DẺO KHÓA CÀI dập vân cá sấu Việt Nam size 18 - 20 - 22",83000,83000,0,0
TIKI,ngon,272657926,"Xoài sấy dẻo có đường túi 500g",185000,185000,0,0
TIKI,ngon,123367485,"[Chỉ giao HN] Giò Đà Điểu 500g",175000,175000,0,0
TIKI,ngon,196175839,"Combo 2 gói gia vị tẩm ướp vịt quay dạng bột và muối 500gr - mang đến hương vị thơm ngon đậm đà đặc trưng",165000,165000,0,0
TIKI,ngon,197988883,"Sữa Nghệ Colos Tumeric Nano VINANITRIFOOD, 900g và 400g",256000,256000,0,0
TIKI,dong-ho-va-trang-suc,176073994,"Dây đồng hồ cao su silicon cao dấp dành cho Samsung Galaxy watch 3 45mm",59000,59000,0,0
TIKI,dong-ho-va-trang-suc,150781647,"Lắc tay nam kiểu lực lớn mạ 24k cao cấp H706",269000,269000,0,0
TIKI,dong-ho-va-trang-suc,107542998,"Dây chuyền mặt hình chữ thập cá tính phong cách Hiphop cho nam và nữ",28000,28000,0,0
TIKI,dong-ho-va-trang-suc,177896439,"Cường lực màn hình 3D Cạnh Cong Full mặt kính cho Amazfit Gtr3/ Gtr3 Pro",35000,35000,0,0
TIKI,dong-ho-va-trang-suc,141473496,"Vòng Tay Tỳ Hưu Phong Thủy Hút Tài Vận, May Mắn Cho Người Đeo KDR-NC229",47500,50000,2500,5
TIKI,dong-ho-va-trang-suc,87985135,"vòng đôi nam châm người yêu",19500,19500,0,0
TIKI,ngon,123351971,"[Chỉ giao tại Hà Nội] DẢI HEO VÁCH NGĂN HEO HÀ LAN 1kg",99000,99000,0,0
TIKI,dong-ho-va-trang-suc,13378372,"Vòng tay gỗ đàn hương đỏ 108 hạt nhiều kích thước  VG9 (Giao mầu tự nhiên)",85000,85000,0,0
TIKI,dong-ho-va-trang-suc,41232225,"Vòng tay đá mã não lông chuột liền khối bản hẹ mỏng ni 56 mệnh kim, thủy - Ngọc Qúy Gemstones",469000,920000,451000,49
TIKI,ngon,198606466,"Táo Envy sz100 - 18 kg (Có hóa đơn VAT)",2000000,2000000,0,0
TIKI,ngon,123398305,"[Chỉ giao HN] Thịt heo giả bò khô 200g",109000,109000,0,0
TIKI,dong-ho-va-trang-suc,191930873,"Bông Tai Bạc Hình Bông Hoa, Khuyên Tai Bạc Tròn Họa Tiết Bông Hoa Tinh Tế, Khuyên Tròn Nữ Nhỏ Bông Hoa Nhiều Màu - B2706 - Bảo Ngọc Jewelry",150000,150000,0,0
TIKI,ngon,195623340,"Nước yến sào cao cấp 12% nguyên chất hộp 6 lọ, 70ml - Yến sào Thiên Triều",320000,320000,0,0
TIKI,dong-ho-va-trang-suc,137564048,"Dây dù đeo cổ - Phụ Kiện - Vòng cổ dây dù - Dây chuyền dây dù",18000,18000,0,0
TIKI,ngon,120860410,"Sinh tố dâu tây 350ml",55000,55000,0,0
TIKI,ngon,196175608,"Gia vị cá gói 500g",145000,145000,0,0
TIKI,dong-ho-va-trang-suc,66524417,"Dây đồng hồ DA BÒ MỊN cao cấp OL-801 kèm khóa bướm ĐÔI thép không gỉ 316L",125000,125000,0,0
TIKI,dong-ho-va-trang-suc,58299829,"Nhẫn nam đá băng ngọc thủy tảo mệnh hỏa , mộc - Ngọc Quý Gemstones",499000,980000,481000,49
TIKI,dong-ho-va-trang-suc,178030256,"Dây đồng hồ da cá sấu cao cấp 2 mặt vân cá sấu kèm khóa bướm thép không gỉ 316L (Chọn màu)",169000,169000,0,0
TIKI,ngon,201390199,"150g Bột Natto Vàng - chứa Nattokinase  (original powder natto)",210000,210000,0,0
TIKI,ngon,197989081,"Thạch Multi Vitamin ăn ngon ngủ Vinanutrifood hộp 10 gói",119000,119000,0,0
TIKI,ngon,171021208,"[ Chỉ giao HN] - Trà Thái Nguyên phổ thông 200g Tâm Minh",40000,40000,0,0
TIKI,ngon,191502077,"Chai xịt vệ sinh bồn cầu 300ml Rocket- Hàng Nhật nội địa- 300ml",45000,45000,0,0
TIKI,ngon,172213352,"Bột chiên xù Miwon 100g ",12000,12000,0,0
TIKI,ngon,191502137,"Nước rửa tay tạo bọt Biore 230ml diệt khuẩn virus- Hàng Nhật nội địa - 230ml",120000,120000,0,0
TIKI,ngon,197988803,"Sữa Bột Colos Formula Baby Vinanutrifood hộp 900g và 400g",217000,217000,0,0
TIKI,ngon,165675855,"Củ cải trắng ",30000,30000,0,0
TIKI,ngon,171330895,"[Chỉ giao HN] Áo ba lỗ mùa hè in hình cute vàng - L",33000,33000,0,0
TIKI,ngon,171021236,"[ Chỉ giao HN] - Trà Thái Nguyên Thọ 100g Tâm Minh",65000,65000,0,0
TIKI,ngon,169004345,"Thức Ăn Cho Mèo lông dài Me-O Gold Persian  - 1,2kg",170000,170000,0,0
TIKI,ngon,171330859,"[Chỉ giao HN] Áo ba lỗ mùa hè in hình cute  màu cam- XL",33000,33000,0,0
TIKI,ngon,160308365,"Chả giò thịt wyn 160g",28500,28500,0,0
TIKI,ngon,197988971,"Bột Cacao Choco Slim Vinanutrifood, Hộp 400g",294000,294000,0,0
TIKI,ngon,160278830,"Bánh Mandu hải sản Bibigo",41040,41040,0,0
TIKI,ngon,170180286,"Tã Lót Vệ Sinh Cho Chó Mèo - Size S: 33*45cm - 1 miếng lẻ",2000,2000,0,0
TIKI,ngon,170180446,"Đồ Chơi Gà La Hét Cho Thú Cưng - 40 CM",28799,28799,0,0
TIKI,ngon,162475408,"[Chỉ giao HN] - Lạp xưởng hun khói Tây Bắc - 500gr",160000,160000,0,0
TIKI,ngon,171330795,"[Chỉ giao HN] Áo ba lỗ mùa hè in hình cute - XL",33000,33000,0,0
TIKI,ngon,197989147,"Kem Mặt Nạ Cream Cần Tây Rau Má VINANUTRIFOOD 100ml",99000,99000,0,0
TIKI,ngon,169005985,"Bình Nước Gắn Chuồng Cho Thú Cưng - Vàng",25000,25000,0,0
TIKI,ngon,170180220,"Vòng cổ đệm cho chó (Chọn 4 màu)  - Xanh Dương - M",32000,32000,0,0
TIKI,ngon,171468333,"[Chỉ giao HN] Balo Phi hành gia loại da",330000,330000,0,0
TIKI,ngon,171833854,"[ Chỉ giao HN] -Raw Food Cá hồi dừa đậu phộng 250gr",70000,70000,0,0
TIKI,ngon,171824962,"Nấm đùi gà - 200g",33000,33000,0,0
TIKI,ngon,171021214,"[ Chỉ giao HN] - Trà Thái Nguyên 2 sao 200g Tâm Minh",50000,50000,0,0
TIKI,ngon,169005750,"Đĩa Bay huấn luyện chó mèo - Đồ chơi cho chó mèo (Màu ngẫu nhiên)",20000,20000,0,0
TIKI,ngon,171330790,"[Chỉ giao HN] Áo ba lỗ mùa hè in hình cute gấu- M",33000,33000,0,0
TIKI,ngon,169076055,"Nước Yến Sào️ CAO CẤP️Khánh Hòa Sanest Lọ 70ml, Hộp 8 Lọ - 002H8",295000,295000,0,0
TIKI,ngon,171330829,"[Chỉ giao HN] Áo ba lỗ mùa hè in hình cute  xanh nước biển - XXL",33000,33000,0,0
TIKI,ngon,170179407,"[Gói 100g] Thức ăn Pháp giúp chăm sóc răng miệng,hỗ trợ tiêu hóa,tiêu búi lông cho mèo con và mèo trưởng thành - BABY CAT",26000,26000,0,0
TIKI,ngon,170179234,"Đồ chơi con gà kêu dành cho chó và mèo - Đồ chơi huấn luyện chó mèo - L",28000,28000,0,0
TIKI,ngon,160290940,"[ Chỉ giao HN] - Hạt Lanh Nâu ARGENTINA 500g",200000,200000,0,0
TIKI,ngon,166083051,"RỌ MÕM MỎ VỊT THỜI TRANG ( giao màu ngẫu nhiên) - L",55000,55000,0,0
TIKI,ngon,166057635,"Bát Ăn Treo Lồng Chicken Dog Bowl",38000,38000,0,0
TIKI,ngon,170180045,"Clicker Huấn Luyện Chó Kún Miu - Giao Màu Ngẫu Nhiên",29999,29999,0,0
TIKI,ngon,166083261,"Bánh Bi men sữa dinh dưỡng Cho Hamster, Nhím, Sóc - Túi ăn thử",3000,3000,0,0
TIKI,ngon,166083213,"Rọ mõm mỏ vịt cho chó (mầu ngẫu nhiên) - M",50000,50000,0,0
TIKI,ngon,166059312,"Phụ kiện kính đeo thời trang cho chó mèo",30000,30000,0,0
TIKI,ngon,169003905,"[Gói 100g] Thức ăn cho mèo con và mèo trưởng thành Royal canin,Reflex,Me-o.Whiskas,Catsrang,Cat Eye - Reflex Plus mèo lớn vị gà",15000,15000,0,0
TIKI,ngon,117570372,"[Chỉ giao HN] - Bánh Khúc Lá Cẩm Việt Trì - Túi 10 Cái - Đông Lạnh",239000,239000,0,0
TIKI,ngon,117708570,"[Chỉ giao HN] - Thịt Ba Chỉ Bò Mỹ - 1Kg 2 Khay",319000,319000,0,0
TIKI,ngon,118528581,"[Chỉ giao HN] - Set Bò Sốt Vang - 1Kg",309000,309000,0,0
TIKI,ngon,117975432,"[Chỉ giao HN] - Bề Bề Hấp Sơ - 1Kg 2 Hộp",499000,499000,0,0
TIKI,ngon,165682299,"Cà bát tím",34000,34000,0,0
TIKI,phu-kien-thoi-trang,197988971,"Bột Cacao Choco Slim Vinanutrifood, Hộp 400g",294000,294000,0,0
TIKI,phu-kien-thoi-trang,201390199,"150g Bột Natto Vàng - chứa Nattokinase  (original powder natto)",210000,210000,0,0
TIKI,ngon,124329729,"Nầm heo ướp sữa dừa",65000,65000,0,0
TIKI,phu-kien-thoi-trang,171824962,"Nấm đùi gà - 200g",33000,33000,0,0
TIKI,phu-kien-thoi-trang,162475408,"[Chỉ giao HN] - Lạp xưởng hun khói Tây Bắc - 500gr",160000,160000,0,0
TIKI,ngon,171307614,"[Chỉ giao HN] Váy cho chó mèo Váy 2 dây Quần áo chó mèo - CutePets - Size M",66000,66000,0,0
TIKI,ngon,125741628,"Cánh gà khúc giữa - khay 1kg đông lạnh",149000,149000,0,0
TIKI,ngon,160580946,"[Chỉ giao HN] - Đặt Gà Cúng - Gà Buộc Cánh Tiên Sạch Đẹp",299000,299000,0,0
TIKI,phu-kien-thoi-trang,197989081,"Thạch Multi Vitamin ăn ngon ngủ Vinanutrifood hộp 10 gói",119000,119000,0,0
TIKI,phu-kien-thoi-trang,191502077,"Chai xịt vệ sinh bồn cầu 300ml Rocket- Hàng Nhật nội địa- 300ml",45000,45000,0,0
TIKI,phu-kien-thoi-trang,197989147,"Kem Mặt Nạ Cream Cần Tây Rau Má VINANUTRIFOOD 100ml",99000,99000,0,0
TIKI,phu-kien-thoi-trang,171468333,"[Chỉ giao HN] Balo Phi hành gia loại da",330000,330000,0,0
TIKI,ngon,125900017,"[Chỉ Giao HN] Cá Trắm Đen (trắm ốc) đang bơi - con 4-5 kg - Minafood - MM0002",445000,445000,0,0
TIKI,phu-kien-thoi-trang,170180446,"Đồ Chơi Gà La Hét Cho Thú Cưng - 40 CM",28799,28799,0,0
TIKI,ngon,108650131,"[CHỈ GIAO HN] - VITOT FOOD CÁ NỤC 1 NẮNG (500g/ khay)",100000,100000,0,0
TIKI,phu-kien-thoi-trang,169004345,"Thức Ăn Cho Mèo lông dài Me-O Gold Persian  - 1,2kg",170000,170000,0,0
TIKI,ngon,171307620,"[Chỉ giao HN] Váy cho chó mèo Váy 2 dây Quần áo chó mèo - CutePets - Size XS",66000,66000,0,0
TIKI,phu-kien-thoi-trang,169005750,"Đĩa Bay huấn luyện chó mèo - Đồ chơi cho chó mèo (Màu ngẫu nhiên)",20000,20000,0,0
TIKI,ngon,170628740,"Cát vệ sinh mèo TOFU CATURE 6L",175000,175000,0,0
TIKI,ngon,171021230,"[ Chỉ giao HN] - Trà Thái Nguyên Phúc 200g Tâm Minh",90000,90000,0,0
TIKI,phu-kien-thoi-trang,171021214,"[ Chỉ giao HN] - Trà Thái Nguyên 2 sao 200g Tâm Minh",50000,50000,0,0
TIKI,phu-kien-thoi-trang,191502137,"Nước rửa tay tạo bọt Biore 230ml diệt khuẩn virus- Hàng Nhật nội địa - 230ml",120000,120000,0,0
TIKI,phu-kien-thoi-trang,169076055,"Nước Yến Sào️ CAO CẤP️Khánh Hòa Sanest Lọ 70ml, Hộp 8 Lọ - 002H8",295000,295000,0,0
TIKI,phu-kien-thoi-trang,171330895,"[Chỉ giao HN] Áo ba lỗ mùa hè in hình cute vàng - L",33000,33000,0,0
TIKI,ngon,108276746,"[Chỉ giao HN] - Cam Úc - 1 kg",155000,155000,0,0
TIKI,phu-kien-thoi-trang,170179234,"Đồ chơi con gà kêu dành cho chó và mèo - Đồ chơi huấn luyện chó mèo - L",28000,28000,0,0
TIKI,ngon,169005388,"Sữa tắm SOS các loại dành cho chó - xanh lá",79999,79999,0,0
TIKI,ngon,125741634,"Chả cua Huế - hộp 500gam đông lanh",199000,199000,0,0
TIKI,phu-kien-thoi-trang,166059312,"Phụ kiện kính đeo thời trang cho chó mèo",30000,30000,0,0
TIKI,phu-kien-thoi-trang,171021208,"[ Chỉ giao HN] - Trà Thái Nguyên phổ thông 200g Tâm Minh",40000,40000,0,0
TIKI,ngon,116553159,"[Chỉ giao HN] - Chả Nem Rế Tôm Cua - 1 Hộp 10 Cái",139000,139000,0,0
TIKI,ngon,125803735,"[ Chỉ giao HN] -Táo xanh Mỹ 1kg",110000,110000,0,0
TIKI,ngon,159110912,"[Giao nội thành Hà Nội] Củ hành ta khô Vườn nhà mẹ - Gia vị tươi, sạch, đạt tiêu chuẩn VietGAP",40000,40000,0,0
TIKI,phu-kien-thoi-trang,160308365,"Chả giò thịt wyn 160g",28500,28500,0,0
TIKI,phu-kien-thoi-trang,171330795,"[Chỉ giao HN] Áo ba lỗ mùa hè in hình cute - XL",33000,33000,0,0
TIKI,phu-kien-thoi-trang,171833854,"[ Chỉ giao HN] -Raw Food Cá hồi dừa đậu phộng 250gr",70000,70000,0,0
TIKI,ngon,173536587,"[Chỉ Giao Hà Nội] Set bánh sừng bò Croissant  Banquet D'or 40gx12 bánh nhập khẩu Pháp (nướng nồi chiên không dầu hoặc lò nướng)",175000,175000,0,0
TIKI,phu-kien-thoi-trang,166083051,"RỌ MÕM MỎ VỊT THỜI TRANG ( giao màu ngẫu nhiên) - L",55000,55000,0,0
TIKI,ngon,116553087,"[Chỉ giao HN] - Cá Mối Hương 1 Nắng - 1Kg 2 Khay - Có Xương",179000,179000,0,0
TIKI,ngon,125578134,"[Chỉ giao HN] Móng gìo heo - 1kg",80000,80000,0,0
TIKI,phu-kien-thoi-trang,160278830,"Bánh Mandu hải sản Bibigo",41040,41040,0,0
TIKI,ngon,189129285,"Ngô ngọt Đôi Đũa Vàng tươi ngon an toàn thực phẩm 400g",82000,82000,0,0
TIKI,phu-kien-thoi-trang,160290940,"[ Chỉ giao HN] - Hạt Lanh Nâu ARGENTINA 500g",200000,200000,0,0
TIKI,phu-kien-thoi-trang,171330790,"[Chỉ giao HN] Áo ba lỗ mùa hè in hình cute gấu- M",33000,33000,0,0
TIKI,ngon,126234091,"Sụn ức gà - 1kg",95000,95000,0,0
TIKI,phu-kien-thoi-trang,170180045,"Clicker Huấn Luyện Chó Kún Miu - Giao Màu Ngẫu Nhiên",29999,29999,0,0
TIKI,phu-kien-thoi-trang,171330829,"[Chỉ giao HN] Áo ba lỗ mùa hè in hình cute  xanh nước biển - XXL",33000,33000,0,0
TIKI,phu-kien-thoi-trang,169003905,"[Gói 100g] Thức ăn cho mèo con và mèo trưởng thành Royal canin,Reflex,Me-o.Whiskas,Catsrang,Cat Eye - Reflex Plus mèo lớn vị gà",15000,15000,0,0
TIKI,phu-kien-thoi-trang,171021236,"[ Chỉ giao HN] - Trà Thái Nguyên Thọ 100g Tâm Minh",65000,65000,0,0
TIKI,phu-kien-thoi-trang,165675855,"Củ cải trắng ",30000,30000,0,0
TIKI,ngon,169064384,"Dây xích chó mèo kết hợp Vòng cổ XCO-15, Dây dắt chó đi dạo, dây buộc mèo - Màu ngẫu nhiên",39999,39999,0,0
TIKI,ngon,176021483,"Chân gà Đông Tảo loại VIP (5-6c/kg)",850000,850000,0,0
TIKI,phu-kien-thoi-trang,171330859,"[Chỉ giao HN] Áo ba lỗ mùa hè in hình cute  màu cam- XL",33000,33000,0,0
TIKI,phu-kien-thoi-trang,166083213,"Rọ mõm mỏ vịt cho chó (mầu ngẫu nhiên) - M",50000,50000,0,0
TIKI,phu-kien-thoi-trang,170179407,"[Gói 100g] Thức ăn Pháp giúp chăm sóc răng miệng,hỗ trợ tiêu hóa,tiêu búi lông cho mèo con và mèo trưởng thành - BABY CAT",26000,26000,0,0
TIKI,ngon,117771052,"Chả bò ước lễ - 500gr",150000,150000,0,0
TIKI,ngon,168927237,"Dầu ô liu siêu nguyên chất dành cho Salad (Salad extra virgin olive oil) nhãn hiệu Gaea 500ml",230000,230000,0,0
TIKI,ngon,160392626,"Viên vị bò Đức Việt Food 500g",37000,37000,0,0
TIKI,ngon,177479420,"[ Chỉ giao HN ] -  Thuốc bổ máu, vitamin, khoáng cho chó mèo 160 viên",120000,120000,0,0
TIKI,ngon,125796893,"[ Chỉ giao HN] -Lá chanh khô 100g",30000,30000,0,0
TIKI,phu-kien-thoi-trang,166083261,"Bánh Bi men sữa dinh dưỡng Cho Hamster, Nhím, Sóc - Túi ăn thử",3000,3000,0,0
TIKI,ngon,173302814,"[Chỉ giao HN] - Xúc Xích Bi - 500g - Túi Hút Chân Không",129000,129000,0,0
TIKI,phu-kien-thoi-trang,166057635,"Bát Ăn Treo Lồng Chicken Dog Bowl",38000,38000,0,0
TIKI,phu-kien-thoi-trang,172213352,"Bột chiên xù Miwon 100g ",12000,12000,0,0
TIKI,phu-kien-thoi-trang,197988803,"Sữa Bột Colos Formula Baby Vinanutrifood hộp 900g và 400g",217000,217000,0,0
TIKI,ngon,117774352,"Chả cốm làng vòng - 500gr",90000,90000,0,0
TIKI,phu-kien-thoi-trang,170180286,"Tã Lót Vệ Sinh Cho Chó Mèo - Size S: 33*45cm - 1 miếng lẻ",2000,2000,0,0
TIKI,ngon,196538739,"Gạo lúa Tôm Vinafood1 túi 5kg",195000,195000,0,0
TIKI,ngon,193233444,"Chân giò hầm Thuốc Bắc 1.2 kg - Ông già IKA",205000,205000,0,0
TIKI,ngon,171833963,"chanh vàng úc",120000,120000,0,0
TIKI,ngon,108989463,"Súp Tomhumca và Bánh Mì Bơ Tỏi",55000,55000,0,0
TIKI,ngon,172919906,"[Chỉ giao Hà Nội] - Gas Vina Petrol - VN 12kg",470000,470000,0,0
TIKI,phu-kien-thoi-trang,170180220,"Vòng cổ đệm cho chó (Chọn 4 màu)  - Xanh Dương - M",32000,32000,0,0
TIKI,phu-kien-thoi-trang,169005985,"Bình Nước Gắn Chuồng Cho Thú Cưng - Vàng",25000,25000,0,0
TIKI,ngon,201390199,"150g Bột Natto Vàng - chứa Nattokinase  (original powder natto)",210000,210000,0,0
TIKI,ngon,171021214,"[ Chỉ giao HN] - Trà Thái Nguyên 2 sao 200g Tâm Minh",50000,50000,0,0
TIKI,ngon,191502056,"Nước giặt đồ lót và tẩy các vết bẩn siêu mạnh KOSE 200ml chiết xuất từ thiên nhiên - Hàng Nhật nội địa -200ml",135000,135000,0,0
TIKI,ngon,197989081,"Thạch Multi Vitamin ăn ngon ngủ Vinanutrifood hộp 10 gói",119000,119000,0,0
TIKI,ngon,197988971,"Bột Cacao Choco Slim Vinanutrifood, Hộp 400g",294000,294000,0,0
TIKI,ngon,171021236,"[ Chỉ giao HN] - Trà Thái Nguyên Thọ 100g Tâm Minh",65000,65000,0,0
TIKI,ngon,171824962,"Nấm đùi gà - 200g",33000,33000,0,0
TIKI,ngon,191502077,"Chai xịt vệ sinh bồn cầu 300ml Rocket- Hàng Nhật nội địa- 300ml",45000,45000,0,0
TIKI,ngon,197988803,"Sữa Bột Colos Formula Baby Vinanutrifood hộp 900g và 400g",217000,217000,0,0
TIKI,ngon,191502137,"Nước rửa tay tạo bọt Biore 230ml diệt khuẩn virus- Hàng Nhật nội địa - 230ml",120000,120000,0,0
TIKI,ngon,165675855,"Củ cải trắng ",30000,30000,0,0
TIKI,ngon,160290940,"[ Chỉ giao HN] - Hạt Lanh Nâu ARGENTINA 500g",200000,200000,0,0
TIKI,ngon,160278830,"Bánh Mandu hải sản Bibigo",41040,41040,0,0
TIKI,ngon,172213352,"Bột chiên xù Miwon 100g ",12000,12000,0,0
TIKI,ngon,162475408,"[Chỉ giao HN] - Lạp xưởng hun khói Tây Bắc - 500gr",160000,160000,0,0
TIKI,ngon,170180446,"Đồ Chơi Gà La Hét Cho Thú Cưng - 40 CM",28799,28799,0,0
TIKI,ngon,171330829,"[Chỉ giao HN] Áo ba lỗ mùa hè in hình cute  xanh nước biển - XXL",33000,33000,0,0
TIKI,ngon,170179234,"Đồ chơi con gà kêu dành cho chó và mèo - Đồ chơi huấn luyện chó mèo - L",28000,28000,0,0
TIKI,ngon,171330895,"[Chỉ giao HN] Áo ba lỗ mùa hè in hình cute vàng - L",33000,33000,0,0
TIKI,ngon,197989147,"Kem Mặt Nạ Cream Cần Tây Rau Má VINANUTRIFOOD 100ml",99000,99000,0,0
TIKI,ngon,171833854,"[ Chỉ giao HN] -Raw Food Cá hồi dừa đậu phộng 250gr",70000,70000,0,0
TIKI,ngon,170180286,"Tã Lót Vệ Sinh Cho Chó Mèo - Size S: 33*45cm - 1 miếng lẻ",2000,2000,0,0
TIKI,ngon,171468333,"[Chỉ giao HN] Balo Phi hành gia loại da",330000,330000,0,0
TIKI,ngon,170180045,"Clicker Huấn Luyện Chó Kún Miu - Giao Màu Ngẫu Nhiên",29999,29999,0,0
TIKI,ngon,171330790,"[Chỉ giao HN] Áo ba lỗ mùa hè in hình cute gấu- M",33000,33000,0,0
TIKI,ngon,171330859,"[Chỉ giao HN] Áo ba lỗ mùa hè in hình cute  màu cam- XL",33000,33000,0,0
TIKI,ngon,170179407,"[Gói 100g] Thức ăn Pháp giúp chăm sóc răng miệng,hỗ trợ tiêu hóa,tiêu búi lông cho mèo con và mèo trưởng thành - BABY CAT",26000,26000,0,0
TIKI,ngon,166083261,"Bánh Bi men sữa dinh dưỡng Cho Hamster, Nhím, Sóc - Túi ăn thử",3000,3000,0,0
TIKI,ngon,169004345,"Thức Ăn Cho Mèo lông dài Me-O Gold Persian  - 1,2kg",170000,170000,0,0
TIKI,ngon,169076055,"Nước Yến Sào️ CAO CẤP️Khánh Hòa Sanest Lọ 70ml, Hộp 8 Lọ - 002H8",295000,295000,0,0
TIKI,ngon,160308365,"Chả giò thịt wyn 160g",28500,28500,0,0
TIKI,ngon,166057635,"Bát Ăn Treo Lồng Chicken Dog Bowl",38000,38000,0,0
TIKI,ngon,171021208,"[ Chỉ giao HN] - Trà Thái Nguyên phổ thông 200g Tâm Minh",40000,40000,0,0
TIKI,ngon,171330795,"[Chỉ giao HN] Áo ba lỗ mùa hè in hình cute - XL",33000,33000,0,0
TIKI,ngon,166083213,"Rọ mõm mỏ vịt cho chó (mầu ngẫu nhiên) - M",50000,50000,0,0
TIKI,ngon,166059312,"Phụ kiện kính đeo thời trang cho chó mèo",30000,30000,0,0
TIKI,ngon,169005985,"Bình Nước Gắn Chuồng Cho Thú Cưng - Vàng",25000,25000,0,0
TIKI,ngon,166083051,"RỌ MÕM MỎ VỊT THỜI TRANG ( giao màu ngẫu nhiên) - L",55000,55000,0,0
TIKI,ngon,170180220,"Vòng cổ đệm cho chó (Chọn 4 màu)  - Xanh Dương - M",32000,32000,0,0
TIKI,ngon,169003905,"[Gói 100g] Thức ăn cho mèo con và mèo trưởng thành Royal canin,Reflex,Me-o.Whiskas,Catsrang,Cat Eye - Reflex Plus mèo lớn vị gà",15000,15000,0,0
TIKI,ngon,169005750,"Đĩa Bay huấn luyện chó mèo - Đồ chơi cho chó mèo (Màu ngẫu nhiên)",20000,20000,0,0
TIKI,ngon,193881163,"Gạo nếp cẩm - 1kg",45000,45000,0,0
TIKI,ngon,108276774,"[Chỉ giao HN] - Giỏ trái cây A 801 - Giỏ",800000,800000,0,0
TIKI,ngon,195623332,"Nước yến sào cao cấp chưng đường phèn 22% bổ dưỡng - Yến sào Thiên Triều",380000,380000,0,0
TIKI,ngon,126962643,"[ Chỉ giao HN] -Táo xanh Mỹ 1kg",115000,115000,0,0
TIKI,ngon,125796841,"[ Chỉ giao HN] -Cùi bưởi 100g",72000,72000,0,0
TIKI,ngon,127509708,"[Chỉ giao HN] Nước lẩu Miso Kimchi",55000,55000,0,0
TIKI,ngon,142315197,"[Chỉ giao HN] Bơ nhạt Anchor New Zealand miếng 200g",122000,122000,0,0
TIKI,ngon,144934458,"[ Chỉ giao HN] - Chân gà đông tảo loại 2  -1kg (9-10 cái/kg)",650000,650000,0,0
TIKI,ngon,114197817,"[Chỉ giao HN] - Thanh Lưng Cá Hồi NaUy Cắt Shushi Túi 1Kg Nạc Không Xương",399000,399000,0,0
TIKI,ngon,185657604,"Tôm sú nguyên con size 35 - 500g",155000,155000,0,0
TIKI,ngon,121603587,"[ Chỉ giao HN] - Chả mực Hạ Long 500g",258000,258000,0,0
TIKI,ngon,119334721,"[Chỉ giao HN] - Chân Giò Heo Ủ Muối Xông Khói Ăn Liền - 1Kg",369000,369000,0,0
TIKI,ngon,116530011,"[Chỉ giao HN] Xúc Xích Bi - 1Kg 2 Túi Hút Chân Không",279000,279000,0,0
TIKI,ngon,120800157,"[Chỉ giao HN] -Quýt Úc Vip - 1kg",160000,160000,0,0
TIKI,ngon,173285397,"[Chỉ giao HN] - Chả Cá Pha Mực - 500g",149000,149000,0,0
TIKI,ngon,145386912,"Rong biển gói tiết kiệm Hàn Quốc lốc 3 gói 4 gram",35000,35000,0,0
TIKI,ngon,120480651,"[Chỉ Giao Hà Nội] Thịt nạc vai xay 1kg",125000,125000,0,0
TIKI,ngon,142315261,"[Chỉ giao HN] Bơ nhạt Anchor New Zealand vỉ 10 viên 7g (Vỉ 70g)",46500,46500,0,0
TIKI,ngon,113215607,"Gà ủ muối hoa tiêu  >=1kg",400000,400000,0,0
TIKI,ngon,129137322,"[Chỉ giao HN] Set Sushi Sanban (phù hợp 2-3 người)",377000,377000,0,0
TIKI,ngon,180322280,"Nước mắm nhỉ Cá Cơm Than Làng Chài Xưa chai nhựa cao cấp 525ml/chai Đặc Biệt Thanh Dịu An toàn Tiết Kiệm",60000,60000,0,0
TIKI,ngon,180322243,"Combo 4 chai nước chấm pha sẵn (Mắm nêm, Nước mắm chua ngọt, Nước mắm gừng, Nước mắm me) Làng Chài Xưa nguyên liệu tươi",240000,240000,0,0
TIKI,ngon,116553111,"[Chỉ giao HN] - Gà Ri Tươi Mạnh Hoạch Đã Mổ Và Làm Sạch Lông",300000,300000,0,0
TIKI,ngon,155495712,"[Chỉ giao HN] Chả Mực Mai- 500gr",230000,230000,0,0
TIKI,ngon,120860444,"Nước ép táo 350ml",50000,50000,0,0
TIKI,ngon,172300363,"Salami cắt lát của Nga",110000,110000,0,0
TIKI,ngon,155278095,"[Chỉ giao HN] - Giò Bê Mông Cuộn - Món Ngon Từ Nghệ An - Quà Biếu Sang Trọng",210000,210000,0,0
TIKI,ngon,121603690,"[ Chỉ giao HN] - Lá Kenhip Hàn Quốc -10 lá",18000,18000,0,0
TIKI,ngon,121442586,"[Chỉ Giao HN] Táo Rocket lốc 3-4 quả",110000,110000,0,0
TIKI,ngon,156937384,"[ Chỉ giao HN] -Nấm yến - 1kg",110000,110000,0,0
TIKI,ngon,154492631,"Táo Ambrosia S80 - 1KG",140000,140000,0,0
TIKI,ngon,181904838,"Gạo ST25 nhãn Fas loại 5kg",175000,175000,0,0
TIKI,ngon,180952006,"[GIAO NHANH HN - 1H - 0989.780.789] Hộp quà tặng AC0014",1150000,1150000,0,0
TIKI,ngon,186554739,"GIÒ ME NGHỆ AN _ GIÒ BÊ NGHỆ AN",250000,250000,0,0
TIKI,ngon,155287895,"[Chỉ giao HN] - Giò Xào Giòn Giòn Cho Cỗ Tết Thêm Ngon - 0.5Kg - Món Ngon Đãi Khách Tết",297000,297000,0,0
TIKI,ngon,147125690,"[Chỉ giao HN] Nước lẩu vị nấm",109000,109000,0,0
TIKI,ngon,154492639,"Quýt Úc 2PH - 1KG",160000,160000,0,0
TIKI,ngon,142315213,"[Chỉ giao HN] Phô mai Cheddar Chesdale New Zealand vị sữa gói 12 lát 250g",92000,92000,0,0
TIKI,ngon,123351969,"[Chỉ giao HN] Giò tai lưỡi xào đặc biệt 500g",150000,150000,0,0
TIKI,ngon,117727237,"[ Chỉ giao HN]-Bánh rán vừng/ cái",12000,12000,0,0
TIKI,phu-kien-thoi-trang,37038685,"Kẹp tóc càng cua nhỏ màu sắc",56000,56000,0,0
TIKI,phu-kien-thoi-trang,192472948,"Mũ cối Tàu loại 1 đặc biệt siêu bền",260000,260000,0,0
TIKI,phu-kien-thoi-trang,114438814,"Tất dài nam chất liệu cotton phong cách hội họa cổ điển",38000,50000,12000,24
TIKI,phu-kien-thoi-trang,186494147,"Kính mắt nữ thời trang cao cấp ELLY – EK143",549450,999000,449550,45
TIKI,phu-kien-thoi-trang,108899687,"Nơ đeo cổ nam đẹp - nơ đeo cổ nam hà nội",25000,25000,0,0
TIKI,phu-kien-thoi-trang,56452656,"Mũ lưỡi trai nữ , Nón nữ nam phong cách Hàn Quốc",34000,34000,0,0
TIKI,phu-kien-thoi-trang,5574039,"Com bo 2 tất vớ đùi nữ viền ren siêu dai bền đẹp",55000,55000,0,0
TIKI,phu-kien-thoi-trang,121329956,"Vải không dệt màu đen dầy khổ 1,6m ~ 1m",23000,23000,0,0
TIKI,phu-kien-thoi-trang,189809229,"Nón Kết Ông Địa Cầm Đàn .",169000,169000,0,0
TIKI,phu-kien-thoi-trang,132956169,"5 ĐÔI TẤT VỚ NỮ MÀU DA Loại xỏ ngón Chất liệu thun Co giãn Thoáng mát Dài 23cm Loại mềm mỏng",60000,60000,0,0
TIKI,phu-kien-thoi-trang,107099565,"BĂNG ĐÔ CÀI TÓC TAI CHUỘT MINNIE",32000,32000,0,0
TIKI,phu-kien-thoi-trang,130730329,"Kính lão thị kính đọc sách đảo chiều xoay 360 độ cài áo tiện lợi nam nữ",165000,165000,0,0
TIKI,phu-kien-thoi-trang,22046394,"NÓN RỘNG VÀNH MŨ RỘNG VÀNH THỜI TRANG HÀN QUỐC - DN19RV07076",175000,175000,0,0
TIKI,phu-kien-thoi-trang,174528923,"Mũ lưỡi trai - nón Ulzzang vải nhung tăm trơn unisex nam nữ chống nắng phong cách thời trang, cá tính",43000,86000,43000,50
TIKI,phu-kien-thoi-trang,25150619,"THẮT LƯNG NỮ DÂY NỊT NỮ MANG ĐẦM VÁY ROSE DN19TL10",64000,64000,0,0
TIKI,phu-kien-thoi-trang,152700990,"Thắt lưng nam da bò Anh Tho Leather SML02 - Khóa con lăn",319000,385000,66000,17
TIKI,phu-kien-thoi-trang,136355203,"Sỉ thun cột tóc 500gr cỡ to/vừa/nhỏ nhiều mẫu hàng mới",79000,79000,0,0
TIKI,phu-kien-thoi-trang,128894457,"Dây nịt thắt lưng nữ đẹp thời trang Hàn Quốc dona21100901",65550,69000,3450,5
TIKI,phu-kien-thoi-trang,165700992,"Tất, vớ màu xanh rêu ( màu xanh công an, màu xanh bộ đội )",25000,25000,0,0
TIKI,phu-kien-thoi-trang,105084572,"GOTI - Tag Cài Áo Hình Cành Hoa Đính Hạt Châu Cao Cấp Kiểu Phụ Kiện Charm Cài Nữ Sang Trọng GOTI CA07",18000,30000,12000,40
TIKI,phu-kien-thoi-trang,136354246,"Kẹp tóc mái Hàn quốc ánh nhũ kim tuyến vải đan thêu handmade",15000,15000,0,0
TIKI,phu-kien-thoi-trang,148000554,"Thắt Lưng Nam Dây Da Thời Trang TL05 Khóa Tự Động Vân Cá Sấu Nổi",60000,120000,60000,50
TIKI,phu-kien-thoi-trang,31083946,"Kính lão lắp sẵn + 1.00- + 4.00 độ",87000,87000,0,0
TIKI,phu-kien-thoi-trang,41320899,"Mũ nón len nữ dệt kim 2 lớp, Nón len thời trang dn19111302",121000,149000,28000,19
TIKI,phu-kien-thoi-trang,72627296,"Set mũ kèm khăn UNISEX - SKMN",62700,66000,3300,5
TIKI,phu-kien-thoi-trang,194084771,"Kẹp tóc nữ KM51 NASI [Set 5 cái] dễ thương phong cách hàn quốc nhiều màu kẹp tóc mái nữ phụ kiện tóc (giao ngẫu nhiên)",12000,12000,0,0
TIKI,phu-kien-thoi-trang,74888120,"Mũ Nồi, Mũ Beret Nữ Kiểu Dáng Thời Trang Phong Cách Hàn Quốc",133000,133000,0,0
TIKI,phu-kien-thoi-trang,177747127,"Nón Bucket Vải Nhung Tăm - Mũ Tai Bèo Ulzzang Unisex Nam Nữ Phong Cách Thời trang, Cá Tính",42800,42800,0,0
TIKI,phu-kien-thoi-trang,117692345,"Kính Giả Cận, Gọng Kính Cận Nam Nữ Mắt Vuông Bầu Thanh Mảnh Đen Bạc Không Độ Hàn Quốc G2725",91000,102000,11000,11
TIKI,phu-kien-thoi-trang,10828346,"Dụng cụ tạo nhiều kiểu tóc tết đẹp V3 siêu bền và tiện lợi",19000,19000,0,0
TIKI,phu-kien-thoi-trang,84469998,"Kính râm nữ mắt mèo",89000,89000,0,0
TIKI,phu-kien-thoi-trang,217273518,"CÀI TÓC CHỮ HAPPY BIRTHDAY",39000,39000,0,0
TIKI,phu-kien-thoi-trang,45612976,"Kính viễn thị, kính lão thị cao cấp mắt cực sáng và trong chống ánh sáng xanh Nhat Ban_UNIQUI_KVN16",142000,142000,0,0
TIKI,phu-kien-thoi-trang,67730445,"10 Đôi Tất Gấu Nữ Cổ Ngắn Nhiều Màu Ngừa Hôi Chân",30897,30897,0,0
TIKI,phu-kien-thoi-trang,127482733,"Dây cột tóc,chun cột tóc hoa nhựa dễ thương",3000,3000,0,0
TIKI,phu-kien-thoi-trang,74257869,"Nón bucket nữ tai bèo thêu hình chiếc lá We Will Fly dễ thương, độc đáo - Hạnh Dương",40000,40000,0,0
TIKI,phu-kien-thoi-trang,51338914,"Kính lão thị hai tròng nhìn xa và gần viễn thị trung niên Nam nữ kv11cp2 cực sáng và trong",186000,186000,0,0
TIKI,phu-kien-thoi-trang,120666586,"Hình xăm dán hoa lan 3d sắc nét 10x6cm- mua 5 tặng 1 mini xinh",9000,11000,2000,18
TIKI,phu-kien-thoi-trang,73182062,"Tóc giả trung niên nữ xoăn lửng L501 ❤️FREESHIP❤️ tóc lửng cả đầu, tóc bộ cả đầu, tặng lưới chụp",150000,150000,0,0
TIKI,phu-kien-thoi-trang,160894071,"Tất vớ cổ ngắn Nam Nữ, tất cotton GOM TẤT êm mềm đi mát, thiết kế thoáng khí - GOM-KLB-TRONNGAN",19900,30000,10100,34
TIKI,dong-ho-va-trang-suc,51356529,"Lắc Tay Bạc 925 Dạng Xích Sang Trọng Cá Tính Cho Nam",99000,99000,0,0
TIKI,dong-ho-va-trang-suc,128330187,"Vòng tay trầm hương tự nhiên 108 hạt Kim Thiềm Đài Cát mix Charm Bạc 925 cao cấp - Giàu sang, thịnh vượng - Trầm Tốc Việt Nam - Thiên Mộc Hương",2371500,2790000,418500,15
TIKI,dong-ho-va-trang-suc,94840277,"Khuyên Tai Bạc Nhí Hóa 5 Cánh B2611 - Bảo Ngọc Jewelry",177000,177000,0,0
TIKI,dong-ho-va-trang-suc,170496556,"Vòng đeo tay chuỗi hạt 108 hạt gỗ đỏ hồng phong thủy niệm Phật",54000,54000,0,0
TIKI,dong-ho-va-trang-suc,17010129,"Dây chuyền nam mạ Vàng 24k 2 màu D5",138000,185000,47000,25
TIKI,dong-ho-va-trang-suc,19293640,"2 CUỘN THUN MÀU TRẮNG HỒNG XỎ VÒNG TAY BẰNG ĐÁ NAM NỮ",58100,58100,0,0
TIKI,dong-ho-va-trang-suc,45438074,"Bông tai nữ đính đá Bạc S925 cao cấp B2416 2 màu Bảo Ngọc Jewelry",352000,352000,0,0
TIKI,dong-ho-va-trang-suc,154224342,"Dây chuyền trái tim titan - Trang sức Bé Heo BHDC264",59000,87000,28000,32
TIKI,dong-ho-va-trang-suc,194316846,"ĐỒNG HỒ NƯỚC HATACO VIỆT NAM, CÔNG TƠ NƯỚC",85000,85000,0,0
TIKI,dong-ho-va-trang-suc,22039671,"Nhẫn Nam Đầu Rồng Mạ Vàng 24K N27",119000,119000,0,0
TIKI,dong-ho-va-trang-suc,136134202,"Đồng hồ nữ Kimio 6328 dây đính đá siêu xịn",164000,164000,0,0
TIKI,dong-ho-va-trang-suc,3905837,"Đồng Hồ Nam Điện Tử Thể Thao SKMEI 1243 - DHA509",142000,175000,33000,19
TIKI,dong-ho-va-trang-suc,31594691,"Nhẫn băng ngọc thủy tảo",135000,135000,0,0
TIKI,dong-ho-va-trang-suc,15420686,"COMBO- CẶP VÒNG TAY ĐÔI Bracelet tình yêu (Đồng trắng mạ Bạch kim) (Đen và Đỏ)",180000,180000,0,0
TIKI,dong-ho-va-trang-suc,45099529,"SET HOA TAI, SET KHUYÊN TAI, SET BÔNG TAI SIÊU HOT BHBT299",18000,18000,0,0
TIKI,dong-ho-va-trang-suc,176071962,"Dây silicon thể thao mềm mại dành cho các loại đồng hồ watch 3 41 mm và watch 3 45 mm",135000,135000,0,0
TIKI,dong-ho-va-trang-suc,5420389,"Vòng đeo tay Thạch Anh Dâu Tây 8 ly 21 hạt - hợp mệnh Hỏa, mệnh Thổ",220000,220000,0,0
TIKI,dong-ho-va-trang-suc,134670126,"Dây Samsung Watch 4/ Watch 4 Classic - Dây thép, khóa nam châm",135000,135000,0,0
TIKI,dong-ho-va-trang-suc,58311532,"Nhẫn nam đá mã não trắng ni 19 mệnh thủy, kim - Ngọc Quý Gemstones",179000,350000,171000,49
TIKI,dong-ho-va-trang-suc,102143096,"Dây chuyền bạc trẻ em mặt hình con giáp MS15",248000,248000,0,0
TIKI,dong-ho-va-trang-suc,161523475,"Dây silicon thể thao mềm mại dành cho các loại đồng hồ size dây 20/22mm",135000,135000,0,0
TIKI,dong-ho-va-trang-suc,41418337,"Đồng hồ kim loại thời trang sinari đẹp DH51",43000,43000,0,0
TIKI,dong-ho-va-trang-suc,68237610," Pin Đồng Hồ DW – Daniel Wellington",20000,20000,0,0
TIKI,dong-ho-va-trang-suc,99055679,"Nhẫn Nam Mặt Trơn Thời Trang Cá Tính-NN620",64000,64000,0,0
TIKI,dong-ho-va-trang-suc,185000898,"Đồng hồ cho bé trai/ gái chạy kim hàng chí.nh hãng chống nước quai silicon",148000,148000,0,0
TIKI,dong-ho-va-trang-suc,36852943,"BÔNG TAI KITTY XINH XẮN CHO BÉ GÁI (HT.A11.B)",149000,149000,0,0
TIKI,dong-ho-va-trang-suc,9014405,"Đồng hồ Nữ Halei - HL552 Dây trắng",284000,299000,15000,5
TIKI,dong-ho-va-trang-suc,58530502,"Dây đồng hồ nibosi thép lưới khoá gài",130000,130000,0,0
TIKI,dong-ho-va-trang-suc,44620714,"Dây Chuyền Nam Kiểu Dây Thừng Titan Không Rỉ TT 2383",105000,105000,0,0
TIKI,dong-ho-va-trang-suc,49757837,"Bông tai khuyên tai những cánh hoa xinh nổi bật nơi bạn đến, trọng lượng hợp lý giúp cho bạn đeo dễ dàng, thuận tiện",49000,49000,0,0
TIKI,dong-ho-va-trang-suc,88053700,"Đồng hồ thời trang nữ Strawberry s1 dây caro cực hot g44cx",29000,29000,0,0
TIKI,dong-ho-va-trang-suc,68561844,"Đồng hồ nam dây vải Casio Standard chính hãng AE-1200WHB-3BVDF (42mm)",962000,1218000,256000,21
TIKI,dong-ho-va-trang-suc,184410025,"Dây thép lưới khóa nam châm cho đồng hồ điện tử thông minh Series 1/2/3/4 - phụ kiện đồng hồ",39000,39000,0,0
TIKI,dong-ho-va-trang-suc,87968046,"[Kèm video] Đồng hồ trẻ em hhchuot cao cấp + Tặng kèm 1 vòng (vòng ngẫu nhiên)",75000,75000,0,0
TIKI,dong-ho-va-trang-suc,16873014,"Lắc tay nam mạ vàng 24k nam tính LT2",90000,90000,0,0
TIKI,dong-ho-va-trang-suc,25922080,"Đồng hồ thể thao nam Synoke 9006",94000,105000,11000,10
TIKI,dong-ho-va-trang-suc,99909550,"Dây chuyền bạc nam móc xích dáng dẹp trọng lượng 17,5 chỉ",2268000,2268000,0,0
TIKI,dong-ho-va-trang-suc,52618723,"Dây đồng hồ da bò sáp handmade",119000,119000,0,0
TIKI,dong-ho-va-trang-suc,159947951,"Đồng hồ đeo tay  - Mặt số Viêt - CO GIÃN",170000,170000,0,0
TIKI,dong-ho-va-trang-suc,111650819,"Dây Chuyền Đuôi Phụng Titan Ko Đen TT 3537",182000,182000,0,0
TIKI,dong-ho-va-trang-suc,114694965,"Đồng hồ nữ chính hãng KASSAW K810-5",3285000,3650000,365000,10
TIKI,dong-ho-va-trang-suc,74011968,"Dây Chuyền Tropicana Phối Charm Swarovski Pha Lê Hạt Đá Lấp Lánh",1360000,1360000,0,0
TIKI,dong-ho-va-trang-suc,182744755,"Pin Đồng Hồ Đeo Tay 1 Viên Maxell Nhật Bản Nhiều Cỡ Lựa Chọn",20000,20000,0,0
TIKI,dong-ho-va-trang-suc,76292816,"Vòng Tay Tropicana Phối Charm Swarovski Chim Cánh Cụt",3870000,3870000,0,0
TIKI,dong-ho-va-trang-suc,30153875,"Vòng hổ phách thiên nhiên 9.4 li, đã kiểm định",900000,900000,0,0
TIKI,dong-ho-va-trang-suc,10383995,"Mặt Phật Bản Mệnh Đại Thế Chí Bồ Tát Obsidian - Dành Cho Người Tuổi Ngọ",98000,98000,0,0
TIKI,dong-ho-va-trang-suc,52319751,"Khóa bướm đồng hồ ĐƠN thép không gỉ dùng cho dây da nhiều SIZE 14 16 18 20 22mm",25000,25000,0,0
TIKI,dong-ho-va-trang-suc,52644407,"(Có túi đựng) Bộ Dụng Cụ Sửa Chữa Đồng Hồ Cá Nhân Chuyên Nghiệp 16 món",96879,96879,0,0
TIKI,dong-ho-va-trang-suc,37772752,"Bông Tai Nam Khuyên Tròn Đính 1 Viên Đá Chất Liệu Thép Titan Không Rỉ Không Dị Ứng TT 0801",98000,98000,0,0
TIKI,dong-ho-va-trang-suc,181993194,"Đồng hồ nhẫn đeo ngón tay nam nữ. Fashion chất",135000,135000,0,0
TIKI,dong-ho-va-trang-suc,100463114,"ĐỒNG ĐÁNH GIÓ BẠC TA CAO CẤP",80000,80000,0,0
TIKI,dong-ho-va-trang-suc,149520845,"Dây đeo Huawei Watch 4/ 4 Pro/ 3/ 3 Pro (DGT)",115000,115000,0,0
TIKI,dong-ho-va-trang-suc,42023113,"Đồng hồ đeo tay nam nữ Minaki unisex thời trang DH47",43999,43999,0,0
TIKI,dong-ho-va-trang-suc,158602551,"Dây Mesh Lưới Cho Đồng Hồ Fossil Casio Samsung Huawei [Tặng Chốt thông minh & Dụng cụ tháo lắp",120000,120000,0,0
TIKI,dong-ho-va-trang-suc,111953051,"ĐỒNG HỒ NỮ ROMATIC 4 VẠCH ITALIA - DÂY TITANIUM SANG TRỌNG + TẶNG HỘP & PIN",200000,200000,0,0
TIKI,dong-ho-va-trang-suc,171538559,"Hộp Đựng Đồng Hồ, Mắt Kính, Trang Sức 3 Tầng SAIKE SAIKE S333",650000,650000,0,0
TIKI,dong-ho-va-trang-suc,54683760,"Nhẫn Cặp | Nhẫn Đôi Nam Nữ Freesize Đan Chéo Đính Đá ND2517 (Có thể tùy chỉnh tùy ý theo cỡ tay)",420000,420000,0,0
TIKI,dong-ho-va-trang-suc,45816241,"Hoa tai dài bằng kim loại mạ vàng đơn giản dễ thương cho nữ",28500,30000,1500,5
TIKI,dong-ho-va-trang-suc,106390188,"Dụng Cụ Vam Mở Nắp Lưng Đồng Hồ Đeo Tay Đơn Giản - Dụng Cụ Sửa Chữa Đồng Hồ",45000,45000,0,0
TIKI,dong-ho-va-trang-suc,58829493,"Vòng tay chuỗi hạt ngọc serpentine hạt 10 li ( hạt 1cm) cho người mệnh Thủy và kim vàng chanh và bạch ngọc  là ngọc thật của Việt Nam Vongtaymenhthuykim",398000,398000,0,0
TIKI,dong-ho-va-trang-suc,176467233,"Đồng Hồ Nam Casio F-91WG-9QDF Dây Nhựa",500000,625000,125000,20
TIKI,dong-ho-va-trang-suc,44866261,"Nhẫn Nam Bản To Màu Đen Titan Không Rỉ TT 2377",87000,87000,0,0
TIKI,dong-ho-va-trang-suc,106393307,"(TẶNG KÈM CHỐT VÀ DỤNG CỤ THAY DÂY) Dây đúc đồng hồ inox không rỉ 7 mắt đủ size 18mm 19mm 20mm 21mm 22mm",220000,220000,0,0
TIKI,dong-ho-va-trang-suc,137788978,"Dây chuyền titan tim đôi không đen - Trang sức Bé Heo BHDC261",61000,77000,16000,21
TIKI,dong-ho-va-trang-suc,70719692,"Nhẫn đo nhiệt độ độc đáo BHN103",25000,40000,15000,38
TIKI,dong-ho-va-trang-suc,141234078,"Vòng tay Chuỗi Tràng Hạt 216 4mm Trầm Tốc Việt - Trầm Hương Tự Nhiên",529000,529000,0,0
TIKI,dong-ho-va-trang-suc,46745436,"Đồng Hồ Tay Đập Hoạt Hình Hình Ngẫu Nhiên",40000,100000,60000,60
TIKI,dong-ho-va-trang-suc,102142756,"Charm Tỳ hưu bằng bạc dùng để mix vòng phong thuỷ",78000,78000,0,0
TIKI,dong-ho-va-trang-suc,26351005,"Vòng chuỗi hạt đeo tay 108 viên đá mắt hổ 6mm mệnh thổ , kim - Ngọc Quý Gemstones",879000,1255000,376000,30
TIKI,dong-ho-va-trang-suc,95986590,"Dây Đồng Hồ Da Bò Sáp Nhiều Màu Kèm Chốt Thông Minh",199000,199000,0,0
TIKI,dong-ho-va-trang-suc,98634983,"Vòng tay in tên theo yêu cầu",39000,39000,0,0
TIKI,dong-ho-va-trang-suc,122470763,"Hộp Đựng Đồng Hồ Bọc Da 2 Ngăn",75000,150000,75000,50
TIKI,dong-ho-va-trang-suc,56611061,"Charm bạc hình tỳ hưu - Ngọc Quý Gemstones",151000,240000,89000,37
TIKI,dong-ho-va-trang-suc,8556811,"Mặt dây chuyền thạch anh tóc vàng móc bạc Ngọc Quý Gemstones",1149000,1312000,163000,12
TIKI,dong-ho-va-trang-suc,154314120,"Đồng Hồ Nữ Dây Nhựa Casio G-Shock GMA-S2100-4A2DR Chính Hãng - GMA-S2100-4A2",2720250,3627000,906750,25
TIKI,dong-ho-va-trang-suc,53993424,"Nhẫn Nam Mạ Vàng ( 01 Chiếc ) Mẫu 0510305 - Che Khuyết Điểm Ngón Tay -  Mang Đi Chơi, Đi Tiệc Đều Được - Tặng Kèm Hộp Đẹp",105000,105000,0,0
TIKI,dong-ho-va-trang-suc,54029628,"Nhẫn Nam Mạ Vàng ( 01 Chiếc ) Mẫu 0550305 - Che Khuyết Điểm Ngón Tay -  Mang Đi Chơi, Đi Tiệc Đều Được - Tặng Kèm Hộp Đẹp",105000,105000,0,0
TIKI,dong-ho-va-trang-suc,105803816,"Vòng Tay Trầm Hương Cao Cấp Hạt Tròn Đơn 14mm Trầm Tốc Việt - Trầm Hương Tự Nhiên",427500,450000,22500,5
TIKI,dong-ho-va-trang-suc,76226179,"Vòng tay chỉ đỏ may mắn bình an kèm túi đỏ làm quà tặng -hạt ngọc phát quang",39000,39000,0,0
TIKI,dong-ho-va-trang-suc,19736242,"Bông tai kẹp vành BHBT147",48000,76000,28000,37
TIKI,dong-ho-va-trang-suc,2762225,"Đồng hồ Nam thể thao SKMEI 1228 - DHA518",165000,165000,0,0
TIKI,dong-ho-va-trang-suc,19842390,"Dây chuyền mặt Phật Độ Mệnh đủ các tuổi nam nữ V38",62000,62000,0,0
TIKI,dong-ho-va-trang-suc,139478724,"Bộ 2 viên Pin cúc áo AG4 LR626 377A 1.55V (Trong vỉ)",8000,14950,6950,46
TIKI,dong-ho-va-trang-suc,90719200,"Lắc tay nam inox kiểu lặc cá tính thép không gỉ 9mm",29000,29000,0,0
TIKI,dong-ho-va-trang-suc,77155440,"Vòng tay mã não đỏ 10 ly, vòng tay phong thủy đá thạch anh",126000,126000,0,0
TIKI,dong-ho-va-trang-suc,122574988,"Vòng tay pha lê đẹp màu sắc thời trang cho nữ VTPL0008",68400,68400,0,0
TIKI,dong-ho-va-trang-suc,132701877,"[5 cái] Con đỉa dây đồng hồ - Phụ kiện dây đồng hồ silicone",65000,65000,0,0
TIKI,dong-ho-va-trang-suc,184614624,"Mặt dây chuyền ngọc bội như ý phong thủy đá ngọc phỉ thúy",290000,290000,0,0
TIKI,dong-ho-va-trang-suc,10933528,"Vòng cổ choker tattoo V45",16000,16000,0,0
TIKI,dong-ho-va-trang-suc,57441676,"Đồng hồ nữ chính hãng Lobinni No.2060-3",4450000,7071429,2621429,37
TIKI,dong-ho-va-trang-suc,102142363,"Bông tai nụ bạc Ý mặt tim MS03d",52000,52000,0,0
TIKI,dong-ho-va-trang-suc,90720669,"Lắc tay nam inox nam cá tính thép không đen, không gỉ - QuynhChi 79",30000,30000,0,0
TIKI,dong-ho-va-trang-suc,155089694,"Dây chuyền Thiên Tâm đế sen hồng may mắn (vàng) WDC099V",318000,318000,0,0
TIKI,dong-ho-va-trang-suc,21197167,"Bông tai ngọc  dài ngôi sao BHBT83",35000,61000,26000,43
TIKI,dong-ho-va-trang-suc,129383697,"Bông tai nữ ngọc trai mạ màu cao cấp P1104",139000,139000,0,0
TIKI,dong-ho-va-trang-suc,11097922,"Mặt dây chuyền thánh giá MDC322 (Màu Đen)",180000,180000,0,0
TIKI,dong-ho-va-trang-suc,99427357,"Combo 5 dây chuyền đeo cổ vải dù ( giao màu ngẫu nhiên) -  T027",82800,82800,0,0
TIKI,dong-ho-va-trang-suc,58917457,"Combo bộ trang sức cưới mạ 24k cao cấp H0202",329000,329000,0,0
TIKI,dong-ho-va-trang-suc,105185109,"Dây đồng hồ da bò cực mềm size 18mm 19mm 20mm 22mm chịu nước và đàn hồi tốt - M02",110000,110000,0,0
TIKI,dong-ho-va-trang-suc,196207484,"Dây đồng hồ cao su Sikai Sports 20mm và 22mm cao cấp chống thấm nước",179000,179000,0,0
TIKI,dong-ho-va-trang-suc,101659993,"Bông tai trẻ em bạc ta MS05c",89000,89000,0,0
TIKI,dong-ho-va-trang-suc,155788680,"Vòng Tay Trầm Hương Cao Cấp Hạt Tròn Đơn - Trầm Tốc Tự Nhiên - Vòng Tay Phong Thủy - Size Nam Nữ",389500,410000,20500,5
TIKI,dong-ho-va-trang-suc,35919858,"(BẠC THẬT 100%) Dây chuyền bạc nữ mặt hồ Ly - Trang sức bạc PANMILA - Dây + Mặt Hồ Ly 1",163000,163000,0,0
TIKI,dong-ho-va-trang-suc,129619655,"Hoa tai bạc nữ, bông tai nữ bạc 925 chữ V đính đá AAA mạ vàng sáng bóng phong cách HQ.",49000,49000,0,0
TIKI,dong-ho-va-trang-suc,35454502,"Nhẫn Nam Khắc Kim Quang Chú Titan Không Đen TT 1426",99000,99000,0,0
TIKI,dong-ho-va-trang-suc,100462774,"BÔNG TAI NỮ BẠC TA - BÔNG TAI HỒ LY",65000,65000,0,0
TIKI,dong-ho-va-trang-suc,106390879,"GIÁ HỦY DIỆT Dây đồng hồ HUBLOT nữ cao su trắng case 34 size dây 13 - 19 - 18",150000,150000,0,0
TIKI,dong-ho-va-trang-suc,229696838,"Dây và Ốp TPU bảo vệ cho đồng hồ Xiaomi Miband 7 Pro",68000,68000,0,0
TIKI,dong-ho-va-trang-suc,23286510,"Vòng Tay - Vòng Đeo Tay Da SAM Leather SAMVDT001",149000,149000,0,0
TIKI,dong-ho-va-trang-suc,58204009,"NHẪN ĐÁ CẨM THẠCH MÀU ĐỎ ĐẸP NI NHẪN 17MM HỢP MỆNH HỎA THỔ",280000,560000,280000,50
TIKI,dong-ho-va-trang-suc,184096918,"Vòng tay nữ charm bạc phong thuỷ chất liệu bạc s925 MS236",400000,400000,0,0
TIKI,dong-ho-va-trang-suc,59471580,"Đồng Hồ Nam Chống Nước MF0018G Dành Cho Doanh Nhân Tặng Kèm Nút Bảo Vệ Đầu Sạc Điện Thoại",549000,549000,0,0
TIKI,dong-ho-va-trang-suc,263805091,"Vòng tay 108 hạt gỗ đàn hương nâu 8 ly ( size XL ), chuỗi tràng 108 hạt niệm Phật, vòng chuỗi đeo tay",200000,200000,0,0
TIKI,dong-ho-va-trang-suc,30034533,"Dây chuyền nữ mạ",125000,125000,0,0
TIKI,dong-ho-va-trang-suc,176072237,"Dây da đồng hồ dành cho Samsung galaxy watch 3 41 / 45mm",200000,200000,0,0
TIKI,dong-ho-va-trang-suc,106390205,"Máy khử từ đồng hồ và vật dụng nhiễm từ",140000,140000,0,0
TIKI,dong-ho-va-trang-suc,56027057,"Charm bạc hồ ly 9 đuôi xỏ ngang - Ngọc Quý Gemstones",67000,110000,43000,39
TIKI,dong-ho-va-trang-suc,14903396,"Mặt dây chuyền phật Văn Thù Bồ Tát màu vàng - Phật bản mệnh",69000,69000,0,0
TIKI,dong-ho-va-trang-suc,56869314,"Charm bạc chuồn chuồn gắn trụ treo  - Ngọc Quý Gemstones",138000,138000,0,0
TIKI,dong-ho-va-trang-suc,176073854,"Dây đồng hồ cao su Sikai 22mm cao cấp chống thấm nước",135000,135000,0,0
TIKI,dong-ho-va-trang-suc,151951218,"VÒNG CỔ INOX TÊN, DÂY CHUYỀN TÊN",28000,45000,17000,38
TIKI,dong-ho-va-trang-suc,194965918,"Nhẫn Nữ Bạc Thái 925 Chữ Om Mani Padme Hum Bạc Hiểu Minh NU491",295000,399000,104000,26
TIKI,dong-ho-va-trang-suc,176074100,"Dây da đồng hồ dành cho Amazfit Gtr2 / gtr47 mm",200000,200000,0,0
TIKI,dong-ho-va-trang-suc,87451745,"Mặt dây chuyền 12 con giáp phong thủy đá mắt hổ",190000,190000,0,0
TIKI,dong-ho-va-trang-suc,56597931,"Combo 2 cái charm bạc hình túi tiền treo - Ngọc Quý Gemstones",88000,160000,72000,45
TIKI,dong-ho-va-trang-suc,11498624,"Đồng hồ cơ nam Kinyued JYD-J026 họa tiết dây da chạy full kim - Fullbox chính hãng",699000,699000,0,0
TIKI,dong-ho-va-trang-suc,77093062,"Vòng tay Cẩm thạch xanh dương 12 ly, vòng tay chuỗi hạt đá thạch anh",138000,138000,0,0
TIKI,dong-ho-va-trang-suc,10573342,"Lắc tay hoa cúc nhỏ bạc s925 xinh xắn chonmua365",89000,89000,0,0
TIKI,dong-ho-va-trang-suc,52198835,"Đồng hồ nữ Ulzang dây silicon mặt heo ủn dễ thương - Hồng",23000,23000,0,0
TIKI,dong-ho-va-trang-suc,141665290,"Dây Chuyền Mặt Chữ Thập  Thời Trang Nam Nữ",11000,11000,0,0
TIKI,dong-ho-va-trang-suc,50248437,"Nhẫn Quân Đội Mỹ Titan Không Đen Mạ Vàng Mặt Đá Đen + TẶNG LÁ BỒ ĐỀ MAY MẮN TÀI LỘC ĐỂ VÍ ĐIỆN THOẠI",150000,150000,0,0
TIKI,dong-ho-va-trang-suc,14702862,"Nhẫn cưới trơn 2 chỉ mạ vàng 24k",48900,48900,0,0
TIKI,dong-ho-va-trang-suc,146939331,"Đồng hồ thời trang nữ dây silicon mặt vuông có lịch AMT555",89000,89000,0,0
TIKI,dong-ho-va-trang-suc,114465510,"Nhẫn Nam Nữ 1 Sọc Xanh Titan Ko Đen TT 3032 - 1 Cái",77000,77000,0,0
TIKI,dong-ho-va-trang-suc,176073667,"Dây đồng hồ cao su Sikai cao cấp 22mm",59000,59000,0,0
TIKI,dong-ho-va-trang-suc,23098417,"Vòng Đeo Cổ Dây Chuyền Đá Phong Thủy Đá Núi Lửa Obsidian Theo Ngũ Hành 16mm",38000,38000,0,0
TIKI,dong-ho-va-trang-suc,104155532,"Cây thay dây đồng hồ - Tool tháo dây kèm 2 thanh chốt dây size 14/16/18/20 22/24",16800,16800,0,0
TIKI,dong-ho-va-trang-suc,35453289,"Đồng hồ nữ Halei dây lắc 5010L - dây vàng mặt",307000,399000,92000,23
TIKI,dong-ho-va-trang-suc,84738455,"Đồng hồ Nữ Daniel Klein Premium Ladies DK.1.12528.4 - Galle Watch",1004500,1530000,525500,34
TIKI,dong-ho-va-trang-suc,170154899,"Vòng tay xuping bền màu mạ bạch .kim cao cấp E7",219000,219000,0,0
TIKI,dong-ho-va-trang-suc,106391733,"(KHUYẾN MẠI GIÁ CỰC SHOCK) Dây da đồng hồ cực mềm, dây chống nước chính hãng Italy đủ size 12 đến 20mm",228000,228000,0,0
TIKI,dong-ho-va-trang-suc,181565677,"[1 Mét] 0.5MM/1MM Dây Sáp Bóng Màu Đỏ, Dùng Thắt Vòng Tay, Dây Đeo, Vòng Cổ, Trang Sức - Bead Art",27000,27000,0,0
TIKI,dong-ho-va-trang-suc,21423173,"Vòng Tay Thạch Anh Hồng",200000,200000,0,0
TIKI,dong-ho-va-trang-suc,178778996,"Đồng hồ nam Fourron 688 dây thép không gỉ cao cấp",109000,109000,0,0
TIKI,dong-ho-va-trang-suc,165706461,"Combo Vòng đeo tay Trầm Hương - Chuỗi tràng 108 Hạt Gỗ và Lá Bồ Đề Dát Vàng Kèm Hộp Gấm Cao Cấp - Phong thủy",90000,95000,5000,5
TIKI,dong-ho-va-trang-suc,152183749,"Vòng Phong Thủy Tam Hợp Tỵ Dậu Sửu Đá Mắt Hổ Vàng - Vòng Tay Phong Thủy Mệnh Kim - Size 8 10 12 ly",299000,299000,0,0
TIKI,dong-ho-va-trang-suc,173613700,"Hộp Đựng Đồng Hồ 12 Ngăn SAIKE SAIKE S120 Vỏ Gỗ Màu Đen Lót Nhung Màu Nâu",680000,680000,0,0
TIKI,dong-ho-va-trang-suc,10231007,"Bông tai ngọc trai tự nhiên cực đẹp B-1506 Bảo Ngọc Jewelry",466666,466666,0,0
TIKI,dong-ho-va-trang-suc,147344064,"Nhẫn nữ đơn giản - Nhẫn nam nữ nhẫn cặp titan đơn giản trái tim",75000,75000,0,0
TIKI,dong-ho-va-trang-suc,16685732,"Mặt dây chuyền Phật Hư Không Tạng Bồ Tát_Đá Mã Não Đỏ_Hộ Mệnh Người Tuổi Sửu, Dần",168000,168000,0,0
TIKI,dong-ho-va-trang-suc,82412853,"Dây Da Đồng Hồ Size 18mm 20mm 22mm Da Bò thật",130000,130000,0,0
TIKI,dong-ho-va-trang-suc,66682091,"Dây da đồng hồ SAM Leather SAM012SNW",690000,690000,0,0
TIKI,dong-ho-va-trang-suc,101660417,"Tỳ hưu bạc si vàng để mix vòng phong thủy",125000,125000,0,0
TIKI,dong-ho-va-trang-suc,197370270,"[3-5-10 Hạt] 6MM Đá Thạch Anh Trắng Vân Rạn Tự Nhiên, White Quartz, Đá Phối Vòng Tay Phong Thuỷ, Chuỗi Hạt, Trang Sức, Mệnh Kim, Thuỷ - Bead Art",61200,61200,0,0
TIKI,dong-ho-va-trang-suc,93275231,"Lắc chân bi chất liệu bạc s925 MS15m",236000,236000,0,0
TIKI,dong-ho-va-trang-suc,47961897,"Nhẫn bạc kim tiền tài lộc cõng tỳ hưu bạc  - bạc thật hm04",240000,240000,0,0
TIKI,dong-ho-va-trang-suc,72837335,"Combo Vòng đeo tay phong thủy, Gỗ Violet Tím Brazil, Mang lại may mắn, tài lộc, Kèm hộp đựng lót Nhung Gấm",146000,164000,18000,11
TIKI,dong-ho-va-trang-suc,185169212,"Vòng tay phong thủ kết dây thủ công 100% mẫu mới",79000,79000,0,0
TIKI,dong-ho-va-trang-suc,57137196,"Combo charm bạc chuông mặt treo - Ngọc Quý Gemstones",157000,260000,103000,40
TIKI,dong-ho-va-trang-suc,185290006,"Vòng tay đá bạch ngọc mix đá Ngọc Hồng Lựu kết dây làm thủ công 100",68000,68000,0,0
TIKI,dong-ho-va-trang-suc,154181151,"Bông tai nữ kiểu dán hình học đính đá phụ kiện trang sức đẹp",43000,43000,0,0
TIKI,dong-ho-va-trang-suc,49737224,"Nhẫn Nam Titan Không Rỉ TT 1324",95000,95000,0,0
TIKI,dong-ho-va-trang-suc,136007899,"Dây đồng hồ Thép, khóa nam châm size 20/ 22mm",78990,78990,0,0
TIKI,dong-ho-va-trang-suc,16931653,"Nhẫn nam quân đội Mỹ mạ Vàng 24k mặt đá đen N9",97000,109000,12000,11
TIKI,dong-ho-va-trang-suc,179545515,"Dây chuyền titan hoa hướng dương không đen Trang sức Bé Heo BHDC277",61000,99000,38000,38
TIKI,dong-ho-va-trang-suc,127219711,"Dây da đồng hồ size 8 (Nhiều màu)",150000,150000,0,0
TIKI,dong-ho-va-trang-suc,172268785,"Dây chuyền Thiên Tâm 2.6cm đính đá cao cấp đeo bình an WDC943",319000,319000,0,0
TIKI,dong-ho-va-trang-suc,141233966,"Hộp gỗ Đỏ đựng vòng, đồ phong thủy sang trọng (11x11x5) Siêu Đẹp - Chắc Chắn - Làm Quà Tặng",150000,150000,0,0
TIKI,dong-ho-va-trang-suc,106390917,"Tặng Kèm Tovit Thay Dây đồng hồ Hublot cao su nữ màu thơm mùi vani 13-19-18",127500,127500,0,0
TIKI,dong-ho-va-trang-suc,98634990,"Vòng tay in hình theo yêu cầu",26000,26000,0,0
TIKI,dong-ho-va-trang-suc,45998193,"Nhẫn Nam Đại Kim Quang Khắc Chú",99500,99500,0,0
TIKI,dong-ho-va-trang-suc,63881858,"Đồng hồ Casio Nữ LTP-VT01L-2BUDF",1182000,1182000,0,0
TIKI,dong-ho-va-trang-suc,150731791,"[1 Hạt/ 3 Hạt] 6MM Đá Thạch Anh Hồng, Rose Quartz Tự Nhiên Loại AB, Đá Phối Vòng Tay Phong Thuỷ, Chuỗi Hạt, Trang Sức, Mệnh Hoả, Mệnh Thổ - Bead Art",17000,17000,0,0
TIKI,dong-ho-va-trang-suc,171476365,"Mặt dây chuyền hoa sen đá mã não trắng 2cm mệnh thủy, kim - Ngọc Quý Gemstones",280000,550000,270000,49
TIKI,dong-ho-va-trang-suc,144252817,"[1 Hạt] 8MM-8.5MM Đá Kyanite Tự Nhiên Xanh Dương Loại AA, Đá Phối Vòng Tay Phong Thuỷ, Trang Sức, Chuỗi Hạt, Mệnh Thuỷ, Mộc - Bead Art",140400,140400,0,0
TIKI,dong-ho-va-trang-suc,160600889,"Mặt dây chuyền Rồng phong thủy đá bạch ngọc",270000,270000,0,0
TIKI,dong-ho-va-trang-suc,52302301,"Vòng tay đá thạch anh hồng phối charm lá phong mệnh hỏa, thổ - Ngọc Quý Gemstones",438000,860000,422000,49
TIKI,dong-ho-va-trang-suc,138460502,"Đồng hồ nam DZG có lịch chống nước",85000,85000,0,0
TIKI,dong-ho-va-trang-suc,106393082,"Khoá đồng hồ Rolex 3 mắt inox không gỉ cho dây rolex 3 mắt size 20",100000,100000,0,0
TIKI,dong-ho-va-trang-suc,106111977,"Bông tai bạc nữ - Khuyên tai nữ giọt nước - Trang sức Bé Heo BHBT447",39000,63000,24000,38
TIKI,dong-ho-va-trang-suc,72724663,"Combo Vòng đeo tay Ngọc Trai Nuôi cấy tự nhiên đính đá Cẩm Thạch, Tặng kèm hộp Lót Nhung Gấm",270750,285000,14250,5
TIKI,ngon,159882092,"Combo 3 hộp nước dừa Xiêm xanh Cocoxim 100% nguyên chất dừa tươi 300ml CB3.XX33007LA COCOXIM",57000,57000,0,0
TIKI,dong-ho-va-trang-suc,104129770,"Dây đồng hồ thép không gỉ chốt thông minh size 20/22/24",210000,210000,0,0
TIKI,dong-ho-va-trang-suc,73501946,"Combo Vòng chuỗi đeo tay đôi Trầm Hương Nam Nữ 108 hạt, kèm hộp đựng lót Nhung, Lụa",233000,249000,16000,6
TIKI,dong-ho-va-trang-suc,68222272,"VÒNG TAY BÁCH PHÚC BẰNG hợp kim đồng thau  CÓ HỘP ĐỰNG ",180000,180000,0,0
TIKI,dong-ho-va-trang-suc,12602815,"Vòng Tay Phong Thủy Đá Thạch Anh Tím 8MM",139000,139000,0,0
TIKI,ngon,204431817,"[Chỉ giao HN] - Tai Heo - Túi 3 chiếc",73000,73000,0,0
TIKI,dong-ho-va-trang-suc,177860110,"đồng hồ siêu nhân nhện có đèn",60000,60000,0,0
TIKI,ngon,177235079,"[ Chỉ giao HN] - Lược chải lông 2 mặt nhỏ SP482",32000,32000,0,0
TIKI,dong-ho-va-trang-suc,176071848,"Dây da hydrid 20mm dành cho Samsung galaxy watch 4",198000,198000,0,0
TIKI,ngon,273381295,"Đặc Sản Nha Trang - Kẹo Mè Xửng Viên Dẻo Dai ,Thơm Vị Mè, mềm dễ ăn  Seavy Hộp 400G",40000,40000,0,0
TIKI,dong-ho-va-trang-suc,20280940,"Vòng tay hổ phách",220000,220000,0,0
TIKI,dong-ho-va-trang-suc,149552558,"5 Hạt/ 10 Hạt] 5MM Hạt Đá Labradorite, Hắc Nguyệt Quang Ánh Cầu Vồng Tự Nhiên Loại AB, Đá Phối Vòng Tay Phong Thuỷ, Chuỗi Hạt, Trang Sức, Mọi Cung Mệnh - Bead Art",52000,52000,0,0
TIKI,ngon,177154065,"[ Chỉ giao HN] - Chụp bảo vệ khi dùng thuốc size 6",64000,64000,0,0
TIKI,ngon,141819363,"[Chỉ Giao HN] Bánh kem tươi bóng xanh 
vương miện 09 Size 16cm cao 8cm",245000,245000,0,0
TIKI,ngon,177631893,"[ Chỉ giao HN] - Pate dành cho các loại mèo vị cá hồi 400g",50000,50000,0,0
TIKI,ngon,249885392,"Kem làm bánh Topping Gold Label",75000,75000,0,0
TIKI,ngon,186166055,"Dầu Olive Extra Virgin Castello 100ml - EUFOOD Việt Nam - Dầu Thực Vật Nhập Khẩu Ý Chính Hãng",81500,81500,0,0
TIKI,ngon,273726509,"Đặc Sản Nha Trang - Mực Xé Lá Chanh Có Vị Chua Chua Của Chanh Kết Hợp Với Vị Thơm Của Lá Chanh, Seavy Hộp 200g",98000,105000,7000,7
TIKI,dong-ho-va-trang-suc,192711042,"Khuyên Tai Tròn Đính Đá Thời Trang Thanh Lịch",9089,14900,5811,39
TIKI,dong-ho-va-trang-suc,116103886,"Dây da dành cho đồng hồ nam da bò thật Handmade",150000,150000,0,0
TIKI,ngon,216398002,"[Chỉ giao HN] - Đậu hũ phomai EB - gói 500g",92000,109000,17000,16
TIKI,dong-ho-va-trang-suc,45024004,"Đồng hồ điện tử thể thao chống nước Sppors nam nữ siêu đẹp DH78",16000,16000,0,0
TIKI,ngon,166083518,"Thức ăn cho Mèo trưởng thành Me-o 1.2kg - Tặng gói thức ăn Mèo Me-O Deli 70g (Vị ngẫu nhiên) - Cá ngừ",135000,135000,0,0
TIKI,ngon,263022215,"Pate Iberico Vị Rượu Nho Ximenez 2x78g Coren",173000,173000,0,0
TIKI,dong-ho-va-trang-suc,84598556,"Dây chuyền da PU có móc nhỏ - Ngọc Quý Gemstones",17000,30000,13000,43
TIKI,dong-ho-va-trang-suc,92817327," Dây chuyền nam nữ inox sáng bóng - Kiểu dáng tinh tế",27000,33000,6000,18
TIKI,ngon,180322184,"Nước mắm me cao cấp Làng Chài Xưa, nguyên liệu tươi, thơm ngon đặc biệt từ me, tỏi, ớt tươi, chai thủy tinh 300g",90000,90000,0,0
TIKI,ngon,177234976,"[ Chỉ giao HN] -Bát inox 15",32000,32000,0,0
TIKI,dong-ho-va-trang-suc,17010133,"Dây chuyền nam mạ Vàng 24k phong cách Hàn Quốc D6",86000,164000,78000,48
TIKI,dong-ho-va-trang-suc,27599925,"Nhẫn Nam Rồng đá nhiều màu",98000,98000,0,0
TIKI,ngon,177154275,"[ Chỉ giao HN] - Đồ chơi Crinkle ball",51000,51000,0,0
TIKI,ngon,147125689,"[Chỉ giao HN] Đùi gà tươi nướng (500gr - 2 đùi)",80000,80000,0,0
TIKI,ngon,177235508,"[ Chỉ giao HN] -  Bình treo chuồng LHK 500ml",62000,62000,0,0
TIKI,ngon,166058083,"Sữa Tắm Olive Essence 450ml Cho Chó Mèo - 2. Lông trắng",50000,50000,0,0
TIKI,ngon,158715309,"Hộp Nước dừa Xiêm xanh 100% dừa tươi nguyên chất Cocoxim 1000ml",45000,45000,0,0
TIKI,ngon,140504012,"SỮA AULAC MILK 1 800g (0-2 Tuổi)",665000,665000,0,0
TIKI,ngon,273961412,"Combo Trái Cây Sấy Dẻo Xoài - Chanh Dây - Mãng cầu",180000,180000,0,0
TIKI,dong-ho-va-trang-suc,173088973,"Mặt dây chuyền Thiên Tâm màu vàng may mắn MMD024",132000,132000,0,0
TIKI,ngon,263354968,"Đặc Sản Nha Trang - Mực Xé Sợi Tắc ,Seavy Hộp 500G",240000,250000,10000,4
TIKI,ngon,262797969,"Bò hầm cốt củ quả Truefood hộp 300g - BHCCQ",55000,55000,0,0
TIKI,dong-ho-va-trang-suc,176071758,"Kính cường lực 2D chống trầy xước bảo vệ cho đồng hồ Samsung Galaxy Watch 4 40mm / 44mm và Watch 4 classic 42mm / 46mm",25000,25000,0,0
TIKI,ngon,129137360,"[Chỉ giao HN] Set Sashimi tổng hợp (2-3 người)",356000,356000,0,0
TIKI,ngon,222660761,"Sữa Chua Chanh Dây Ba Vì - Thùng 12 Hũ",90000,90000,0,0
TIKI,dong-ho-va-trang-suc,189491447,"Khuyên tai mạ bạc 925 hình nơ phối ngọc trai nhân tạo đơn giản phong cách Hàn Quốc ",22000,22000,0,0
TIKI,dong-ho-va-trang-suc,98634097,"Vòng tay HandMade cỏ 4 lá phối chuông 02",22100,22100,0,0
TIKI,ngon,177154228,"[ Chỉ giao HN] -  Bình nước không van size M",60000,60000,0,0
TIKI,ngon,141595630,"[Chỉ giao HN] - Tép Khô Ricofood- 300gr",50000,50000,0,0
TIKI,ngon,177631899,"[ Chỉ giao HN] - Pate dành cho các loại mèo cá hồi và cá ngừ 400gr",50000,50000,0,0
TIKI,ngon,177235184,"[ Chỉ giao HN] -Vòng cổ đệm 2 lớp ABC 1.5cm",33000,33000,0,0
TIKI,ngon,177235468,"[ Chỉ giao HN] - Bình nước du lịch bowl",35000,35000,0,0
TIKI,ngon,177235366,"[ Chỉ giao HN] -  Bình nước không van size M",60000,60000,0,0
TIKI,ngon,208318419,"bộ bát thìa ăn dặm ND Richell",159200,159200,0,0
TIKI,ngon,163525552,"[Chỉ giao HN] - Thịt ba chỉ bò Mỹ - Khay 500gr",110000,110000,0,0
TIKI,ngon,177235008,"[ Chỉ giao HN] - Vòng cổ Ergofluo 1.5/25-33cm (cam)",471000,471000,0,0
TIKI,ngon,205715214,"[Chỉ giao HN] - Cá Basa cắt khúc - Túi 1Kg",59000,84000,25000,30
TIKI,ngon,258329730,"(Yến sào nha trang)hộp quà Combo 6 Tổ Yến Thật Chưng Sẵn –Đường Isomalt(70ml *6 Lọ)tổ yến 3.5g",360000,360000,0,0
TIKI,ngon,260818669,"(Yến sào nha trang)Tổ Yến Thật Chưng Sẵn –Kisd Trái Cây Hồng Sâm (70ml)2.5g",45000,45000,0,0
TIKI,ngon,141595627,"[Chỉ giao HN] - Chả Tôm Ricofood - 300gr",100000,100000,0,0
TIKI,ngon,179711698,"[Chỉ giao HN] - Sữa óc chó mè đen không đường - size S (325ml)",56000,56000,0,0
TIKI,ngon,117720224,"[Chỉ giao HN] - Giò Bò 7 Phút Ngon Bất Bại - 10 Cái",139000,139000,0,0
TIKI,ngon,116553115,"[Chỉ giao HN] - Gà Nấm Bó Xôi Chiên Giòn - 1 Khay 10 Cái - Hút Chân Không",129000,129000,0,0
TIKI,ngon,117986418,"[Chỉ giao HN] - Pho Mai Que - 500g",131000,131000,0,0
TIKI,ngon,181904832,"GẠO TÁM HƯƠNG LÀI NHÃN FAS LOẠI 5KG",90000,90000,0,0
TIKI,ngon,179711694,"[Chỉ giao HN] - Túi mix 04 loại hạt cao cấp ((óc chó, hạnh nhân, macca, hạt điều) - 500gr",290000,290000,0,0
TIKI,ngon,157856385,"[ Chỉ giao HN] - Bánh Chưng Nương Bắc Gấc thịt 800gr",190000,190000,0,0
TIKI,ngon,164428759,"[ Chỉ giao HN] - Dưa lưới Đà Lạt - 1kg",65000,65000,0,0
TIKI,ngon,185916496,"Ba Chỉ Bò Mỹ Thái Lát Lẩu - Nướng Khay 500g - Cắt lát 2mm",123000,123000,0,0
TIKI,ngon,118137937,"Rau cải ngồng - 200g",13000,13000,0,0
TIKI,ngon,126962685,"[ Chỉ giao HN] -Nấm hương mũ 200g",84000,84000,0,0
TIKI,ngon,179711727,"[Chỉ giao HN] - Túi mix 02 loại hạt cao cấp 6 (hạt điều, hạnh nhân) - 1kg",410000,410000,0,0
TIKI,ngon,117211906,"[Chỉ giao HN] - Khâu Nhục Tiên Yên Quảng Ninh - 350g",299000,299000,0,0
TIKI,ngon,127509728,"[Chỉ giao HN] Kim chi cải thảo 300g",44000,44000,0,0
TIKI,ngon,103994226,"[Chỉ Giao HN] Bưởi da xanh 1 Trái 1.5kg",85000,85000,0,0
TIKI,ngon,121603672,"[ Chỉ giao HN] - cá Chẽm tẩm sốt bơ chanh đông lạnh 340gr",240000,240000,0,0
TIKI,ngon,172025039,"[ Chỉ giao HN] -Táo Envy Mỹ -1kg",429000,429000,0,0
TIKI,ngon,193881173,"Bún khô trắng Cao Bằng - 0.5kg",31500,31500,0,0
TIKI,ngon,170347406,"Đệ nhất mì gia trộn Spaghetti Hương vị bò ",10000,10000,0,0
TIKI,ngon,118137940,"Rau mồng tơi - 200g",13000,13000,0,0
TIKI,ngon,121603682,"[ Chỉ giao HN] - Kim chi hộp 500g",57600,57600,0,0
TIKI,ngon,126809008,"[ Chỉ giao HN] - Dưa leo baby 1kg",50000,50000,0,0
TIKI,ngon,164428783,"[ Chỉ giao HN] - Bò ẩm thảo mộc - gói 200g",125000,125000,0,0
TIKI,ngon,117028550,"[ Chỉ giao HN]- Sườn không cục thịt heo 1kg",220000,220000,0,0
TIKI,ngon,118895477,"[Chỉ giao HN] Kem hộp vị Caramen Hạnh Nhân - Caramel Almond",119000,119000,0,0
TIKI,ngon,157856149,"[ Chỉ giao HN] - Bánh Chưng Nương Bắc Xanh thịt 800gr",190000,190000,0,0
TIKI,ngon,118896392,"[Chỉ giao HN] Kem hộp vị Phô Mai RedVelvet - Cream Cheese Red Velvet",119000,119000,0,0
TIKI,ngon,165675011,"Lá bạc hà",18000,18000,0,0
TIKI,ngon,162475475,"[Chỉ giao HN] - Ba chỉ bò Mỹ bào - 500gr",160000,160000,0,0
TIKI,ngon,120480652,"[Chỉ Giao Hà Nội] Đuôi heo Nga - 1kg",148000,148000,0,0
TIKI,ngon,144934460,"[ Chỉ giao HN] - Chân gà mái Đông Tảo loại 3 -1kg (11-12 cái/kg)",590000,590000,0,0
TIKI,ngon,139987692,"Bưởi da xanh Bến Tre",88000,88000,0,0
TIKI,ngon,173294225,"[Chỉ giao HN] - Dồi Sụn Non Nổi Tiếng Hà Thành - 500g - Túi Hút Chân Không",109000,109000,0,0
TIKI,ngon,119398077,"[Chỉ giao HN] - Lưỡi Heo Muối Xông Khói – 1Kg",439000,439000,0,0
TIKI,ngon,179711588,"[Chỉ giao HN]  - Túi mix 03 loại hạt cao cấp 3 (macca, hạnh nhân, hạt điều) - 1kg",600000,600000,0,0
TIKI,ngon,185657602,"Mực nang nút - 1kg",130000,130000,0,0
TIKI,dong-ho-va-trang-suc,169313734,"DÂY DÙ ĐAN LƯỚI, Dây xà tích nhiều kích thước 2mm,3mm,4mm,5mm",55000,55000,0,0
TIKI,dong-ho-va-trang-suc,178029061,"Vỉ 10 Pin cúc áo VINNIC AG8 / LR1120 / L1121/ 391 CHÍNH HÃNG dùng cho đồng hồ đeo tay thiết bị điện tử",31000,31000,0,0
TIKI,ngon,111982177,"[Chỉ giao HN] - Vụn Đuôi Cá Thu Na Uy Xuất Nhật – 1KG – Túi Hút Chân Không",185000,185000,0,0
TIKI,dong-ho-va-trang-suc,14144979,"Gembank Lắc Tay Aquamarine Ngọc Xanh Biển Tự Nhiên 10mm Kèm Giấy Kiểm Định",2800000,2800000,0,0
TIKI,dong-ho-va-trang-suc,106394555,"Khoá bướm đồng hồ dùng cho dây da - Khóa chống hằn bấm mở bóng",85000,85000,0,0
TIKI,dong-ho-va-trang-suc,195951281,"NHẪN NAM INOX 2 SỌC ĐEN 6mm THÉP KHÔNG GỈ",32000,32000,0,0
TIKI,dong-ho-va-trang-suc,13897414,"Đồng hồ nữ dây da Casio LTP-V001GL-9BUDF",627200,784000,156800,20
TIKI,ngon,127509732,"[Chỉ giao HN] Thăn ngoại bò Mỹ cắt lát sốt BBQ 150gr",163900,163900,0,0
TIKI,dong-ho-va-trang-suc,188377256,"Dây da đồng hồ nam nữ 14/16/18/20/22/24mm tặng kèm chốt và dụng cụ tháo lắp giá rẻ",46000,46000,0,0
TIKI,dong-ho-va-trang-suc,32396154,"Nhẫn nữ đính xoàn mạ vàng 18k EKP48AD",98500,98500,0,0
TIKI,dong-ho-va-trang-suc,159970847,"Lắc tay bi chạm mạ bạc .kim cao cấp H294",169000,169000,0,0
TIKI,dong-ho-va-trang-suc,20446700,"Vòng Đá Thạch Anh Xanh Biển",500000,500000,0,0
TIKI,ngon,184599154,"Khoai môn lệ phố hương cốm Đôi Đũa Vàng 260g",103000,103000,0,0
TIKI,dong-ho-va-trang-suc,178111080,"Bông tai nụ ngọc trai nuôi nước ngọt chốt bạc 925 - Kiểu đơn giản sang trọng",250000,250000,0,0
TIKI,dong-ho-va-trang-suc,56742475,"Combo charm bạc hình mặt cười xỏ ngang - Ngọc Quý Gemstones",122000,200000,78000,39
TIKI,ngon,117576472,"[Chỉ giao HN] - Vụn Cá Hồi Có Da - 1Kg 2 Túi Hút Chân Không",409000,409000,0,0
TIKI,dong-ho-va-trang-suc,81971302,"Đồng hồ thời trang nữ DZG dây da mặt chữ nhật GR123",43000,43000,0,0
TIKI,dong-ho-va-trang-suc,168782732,"[5 Hạt/10 Hạt] 5.5MM Đá Thạch Anh Tím Đậm Loại AB, Amethyst Tự Nhiên, Phối Vòng Tay, Phong Thuỷ, Chuỗi Hạt, Trang Sức, Hợp Mệnh Thổ, Hỏa - Bead Art",49200,49200,0,0
TIKI,dong-ho-va-trang-suc,58464565,"Đồng hồ nữ chính hãng LOBINNI L026-6",3195000,3550000,355000,10
TIKI,dong-ho-va-trang-suc,144368445,"MẶT DÂY CHUYỀN NAM THẺ BÀI INOX INOX THÉP KHÔNG GỈ",25000,25000,0,0
TIKI,ngon,120527170,"Dưa lưới đạm cá - 1 quả 1,2 kg - 1,4 kg",110000,110000,0,0
TIKI,dong-ho-va-trang-suc,12307881,"Lắc tay bạc nữ đẹp cúc họa mi LTN0110",89000,89000,0,0
TIKI,dong-ho-va-trang-suc,166003125,"Bộ 2 vòng tay nữ đá thạch anh đỏ 8mm mix bi tròn cao cấp cho Nữ hút Lộc Tài Duyên",169000,169000,0,0
TIKI,dong-ho-va-trang-suc,14753836,"Dây chuyền nữ bi xoàn  mạ vàng 18k MÃ 9079",142000,168000,26000,15
TIKI,dong-ho-va-trang-suc,98155796,"Bông Tai Nam Châm Ko Cần Bấm Lỗ Tai Hình Tròn Ngôi Sao Thép Titan Ko Rỉ TT 3621 - 2 Chiếc",72000,72000,0,0
TIKI,dong-ho-va-trang-suc,8293142,"Bông Tai Nữ Ngọc Trai Xinh Xắn",39900,39900,0,0
TIKI,dong-ho-va-trang-suc,19744203,"Đồng Hồ Casio LW-203-2AVDF Dây Nhựa Màu Xanh - Tuổi Thọ Pin 10 Năm",803200,1004000,200800,20
TIKI,dong-ho-va-trang-suc,116155318,"Vòng Tết Chỉ - Đỏ Tam Hợp Tỵ Dậu Sửu - Vòng Tay Tam Hợp Quý Thần",149999,149999,0,0
TIKI,dong-ho-va-trang-suc,207205927,"N388 vòng cổ choker , dây chuyền choker hạt Ngọc 3 dây tạo nhiều kiểu dáng xinh xắn cho nữ",50000,50000,0,0
TIKI,dong-ho-va-trang-suc,36827861,"Nhẫn Nam Thánh Giá Vàng Bản To Chất Liệu Thép Titan Không Đen Không Dị Ứng TT 1295",186000,186000,0,0
TIKI,dong-ho-va-trang-suc,12274430,"Đồng hồ nữ dây nhựa Casio LRW-200H-4B2VDF",751200,939000,187800,20
TIKI,dong-ho-va-trang-suc,84656848,"Dây chuyền màu titan - Ngọc Quý Gemstones",22000,40000,18000,45
TIKI,dong-ho-va-trang-suc,270992417,"Vòng chuỗi Đá Mắt mèo Xanh biển 108 hạt 6mm, 8mm - Chuỗi tay Phong thủy - Tràng chuỗi hợp mệnh Thủy, Mộc",219000,219000,0,0
TIKI,dong-ho-va-trang-suc,22072582,"Bộ trang sức 3 món trái tim BHB63",84000,135000,51000,38
TIKI,dong-ho-va-trang-suc,56255930,"Combo 2 cái charm bạc hình hồ ly chín đuôi treo - Ngọc Quý Gemstones",150000,240000,90000,38
TIKI,dong-ho-va-trang-suc,40431026,"Đồng hồ dây da thời trang lamina đẹp DH41",68999,68999,0,0
TIKI,dong-ho-va-trang-suc,68353931,"Đồng hồ thể thao điện tử nam nữ dây hoa cúc cá tính DH106",16000,16000,0,0
TIKI,dong-ho-va-trang-suc,31134692,"Vòng cổ tattoo choker Song An Eco (Nhiều mẫu)",16000,16000,0,0
TIKI,dong-ho-va-trang-suc,16861976,"Lắc tay nam mạ vàng 24k đầu rồng LT1",166000,175000,9000,5
TIKI,dong-ho-va-trang-suc,173911215,"Combo dây chuyền lắc tay  đuôi phụng titan bền màu ko đen p38",299000,299000,0,0
TIKI,dong-ho-va-trang-suc,107361498,"Bịch 20 chốt dây đồng hồ xịn không gỉ size 16mm 17mm 18mm 19mm 20mm 21mm",13500,13500,0,0
TIKI,dong-ho-va-trang-suc,176692593,"Hộp Đựng Đồng Hồ Và Mắt Kính 2 Tầng SAIKE SAIKE S609 Vỏ Da Màu Đen",550000,550000,0,0
TIKI,dong-ho-va-trang-suc,20280719,"Vòng tay đá kyanite 12 li",700000,700000,0,0
TIKI,dong-ho-va-trang-suc,100464750,"LẮC CHÂN NỮ BẠC TA, LẮC CHÂN NHỎ XINH KIỂU MỚI SIÊU ĐẸP - LẮC CHÂN BIBI SILVER - ",228000,228000,0,0
TIKI,dong-ho-va-trang-suc,73649660,"Đồng hồ điện tử nam nữ AOSUN Q121 mẫu mới tuyệt đẹp K3511",19000,19000,0,0
TIKI,dong-ho-va-trang-suc,152291573,"[1 Hạt] 6MM/8MM/10MM/12MM Đá Dung Nham Núi Lửa, Black Lava Tự Nhiên Màu Đen, Loại AA, Thuỷ, Mộc, Đá Phối Vòng Tay Phong Thuỷ, Trang Sức, Chuỗi Hạt - Bead Art",12000,12000,0,0
TIKI,dong-ho-va-trang-suc,88998854,"Nhẫn nam nữ bát nhã tâm kinh trì chú khai quang màu bạc",49000,49000,0,0
TIKI,dong-ho-va-trang-suc,105175057,"Lắc tay ngọc trai nuôi nước ngọt - Lắc tay nữ 3 vòng - Tặng hộp và quà Trang sức Bé Heo  BHLT167",74000,120000,46000,38
TIKI,dong-ho-va-trang-suc,186090055,"Dây đồng hồ Size 18mm 20mm 22mm da cá sấu xịn hàng Việt Nam tặng kèm phụ kiện",160000,160000,0,0
TIKI,dong-ho-va-trang-suc,38623269,"Nhẫn cặp thiết kế mở rộng BHN37",55000,120000,65000,54
TIKI,dong-ho-va-trang-suc,74792325,"Vòng Tay Dạng Hạt Đá Ruby Nam Phi - Mx - Hợp Mệnh Thổ, Hoả",220000,220000,0,0
TIKI,dong-ho-va-trang-suc,125940249,"Vòng tay gỗ Xá Xị lên tuyết (Size 12mm - 17 hạt) BH671 - Mùi hương thơm ngát dễ chịu - Bracelet of HAHANCO",71000,71000,0,0
TIKI,dong-ho-va-trang-suc,76404963,"Vòng tay đá cẩm thạch TQ 8 ly, vòng tay chuỗi hạt đá",99999,99999,0,0
TIKI,dong-ho-va-trang-suc,98635430,"Đồng hồ Nam SANDA 6008 MIGER Chuẩn Bền Quân Đội, 2 Máy Chạy Song Song, Chống Nước Rất Tốt",220000,220000,0,0
TIKI,dong-ho-va-trang-suc,8460848,"Đồng Hồ Nam Dây Thép Không Gỉ SKMEI 12TCK60 (40mm)",211000,276000,65000,24
TIKI,dong-ho-va-trang-suc,72006895,"Pin CR2025 Maxell Lithium 3V vỉ 5 viên",35000,35000,0,0
TIKI,dong-ho-va-trang-suc,189441842,"Pin đồng hồ oxit bạc Vinnic 371/ SR920SW / SR69 / 371F (Loại tốt - Giá theo số viên) - 1 Viên",4500,4500,0,0
TIKI,dong-ho-va-trang-suc,70767092,"Vòng tay nam titatium Vòng tay nam titatium không đen 2 màu BHLT126",76000,120000,44000,37
TIKI,dong-ho-va-trang-suc,111034814,"LẮC TAY INOX NAM KIỂU LẶC MẠ VÀNG BẢNG NHỎ 5LY siêu đẹp",35000,35000,0,0
TIKI,dong-ho-va-trang-suc,48100805," BÔNG TAI HOA TUYẾT BHBT323",51000,83000,32000,39
TIKI,dong-ho-va-trang-suc,52468904,"Bông tai nam châm - đính đá",49000,49000,0,0
TIKI,dong-ho-va-trang-suc,196207382,"Kính cường lực cho đồng hồ Amazfit T-rex 2 / T Rex 2 / TREX 2",25000,25000,0,0
TIKI,dong-ho-va-trang-suc,84547070,"Nhẫn Mã Não Đỏ Dày 8mm",130000,130000,0,0
TIKI,dong-ho-va-trang-suc,178028912,"(Dây Xanh lá) DÂY ĐỒNG HỒ DA BÒ THẬT DẬP VÂN CÁ SẤU BỀN ĐẸP SIZE 12 14 16 18 20 22 24",49000,49000,0,0
TIKI,dong-ho-va-trang-suc,112548864,"Đồng hồ nữ Lobinni L026-4 Chính hãng Thụy Sỹ",3150000,3500000,350000,10
TIKI,dong-ho-va-trang-suc,106392394,"Bộ dụng cụ ép đáy đồng hồ cơ bản",185000,185000,0,0
TIKI,dong-ho-va-trang-suc,54859508,"Nhẫn chỉ trơn khắc 9999 mạ 24k cao cấp",79000,79000,0,0
TIKI,dong-ho-va-trang-suc,26287563,"Bộ dụng cụ sửa chữa, tháo lắp đồng hồ đeo tay Milliken NL-3151",220000,220000,0,0
TIKI,dong-ho-va-trang-suc,12408602,"Mặt Dây Chuyền Hư Không Tạng Bồ Tát Tuổi Sửu Dần Đá Cẩm Thạch Nước Ngọc Ngọc Quý Gemstones",399000,782000,383000,49
TIKI,dong-ho-va-trang-suc,19558122,"Dây chuyền nam đốt trúc mặt thẻ rồng mạ Vàng 24k MD16",288000,288000,0,0
TIKI,dong-ho-va-trang-suc,38968260,"Đồng hồ nam nữ thời trang thông minh cực đẹp DH20",64899,64899,0,0
TIKI,dong-ho-va-trang-suc,107480536,"Dụng Cụ Tháo Mắt Dây Đồng Hồ, Cắt Ngắn Dây, Đột Dây Đồng Hồ, Chất Liệu Nhựa ABS, Kim Bằng Thép Và Đồng, Đơn Giản Dễ Dùng",14000,14000,0,0
TIKI,dong-ho-va-trang-suc,8831136,"Vòng tay thạch anh tóc xanh phối hoa sen Ngọc Quý Gemstones",1619000,1850000,231000,12
TIKI,dong-ho-va-trang-suc,52412924,"Đồng hồ dây da thời trang nữ đính cườm sang trọng ZO20",98000,98000,0,0
TIKI,dong-ho-va-trang-suc,39000984,"Dây Chuyền Nam Khối Lập Phương Chất Liệu Thép Titan Ko Rỉ Ko Dị Ứng TT 1537",175000,175000,0,0
TIKI,dong-ho-va-trang-suc,24955584,"Vòng tay trầm hương 108 hạt PVL14",66998,66998,0,0
TIKI,dong-ho-va-trang-suc,102143002,"Lắc tay bạc kim tiền mặt hồ ly MS115",198000,198000,0,0
TIKI,dong-ho-va-trang-suc,202203813,"Pin CR2032 Nhật Bản Hàng Cao Cấp 3V Date 2032",30000,30000,0,0
TIKI,dong-ho-va-trang-suc,106391044,"GIÁ HỦY DIỆT Dây đồng hồ HUBLOT nam lót da vân nâu case 42 size dây 19 - 25 - 22",150000,150000,0,0
TIKI,dong-ho-va-trang-suc,123894417,"Vòng tay phong thủy nam nữ - Vòng đá mã não đen - Vòng phong thủy cho người mệnh mộc thủy",129000,129000,0,0
TIKI,dong-ho-va-trang-suc,12033552,"Vòng tay ngọc trai pha lê Áo LT58106-1",190000,190000,0,0
TIKI,dong-ho-va-trang-suc,72515479,"Đồng Hồ Led Điện Tử Bé Trai Bé Gái Dây Silicon Anime Ngộ Nghĩnh DH109",52599,52599,0,0
TIKI,dong-ho-va-trang-suc,77679214,"VÒNG TAY NAM, NỮ CHUỖI HẠT THỜI TRANG HẠT 14LY",75000,75000,0,0
TIKI,dong-ho-va-trang-suc,176130384,"Nhẫn đeo tay bằng thép không gỉ thời trang cá tính cho cặp đôi DC01",20000,20000,0,0
TIKI,dong-ho-va-trang-suc,177782497,"Nhẫn nữ titan không đen bản nhỏ",59000,59000,0,0
TIKI,dong-ho-va-trang-suc,161033474,"Dây chuyền inox ngọc trai nhân tạo",78000,78000,0,0
TIKI,dong-ho-va-trang-suc,107555741,"NHẪN NAM SƯ TỬ HẢI QUÂN MỸ 1973 ĐÁ XANH, ĐEN, ĐỎ - N010D",79000,79000,0,0
TIKI,dong-ho-va-trang-suc,96399415,"Vòng A SỊN 46mm Kèm Giấy Kiểm định LIULAB 232577  Chất liệu đá cẩm thạch tự nhiên màu Xanh Lý Vân Trắng Nhẹ  Nữ tay nhỏ 30kg - 45kg đeo đẹp ạ",1950000,3900000,1950000,50
TIKI,dong-ho-va-trang-suc,208645772,"Dây Silicon dành cho đồng hồ Huami Amazfit GTR4 / GTS4",88000,88000,0,0
TIKI,dong-ho-va-trang-suc,92151703,"DÂY RADO DA BÒ VEGTAN Ý - RAM LEATHER - TẶNG KHÓA, CHỐT, CÂY THAY DÂY",258700,258700,0,0
TIKI,dong-ho-va-trang-suc,242484740,"Khuyên tai  Hàn Quốc bạc Ý tia sét tình yêu, bông tai bạc S925 trẻ trung KT07",10000,10000,0,0
TIKI,dong-ho-va-trang-suc,141233817,"Túi Để Trang Sức - Túi Nhung Rút - Màu Đỏ - Chữ Phúc - Chuyên Đựng trang sức - Mộc Trầm Hương",50000,50000,0,0
TIKI,dong-ho-va-trang-suc,208645696,"Dây Đeo SILICON 2 màu dành Cho Huawei band 7",79000,79000,0,0
TIKI,dong-ho-va-trang-suc,52105894,"Đồng hồ nữ mặt vát 3d lấp lánh dây thép nhuyễn sang trọng",85000,85000,0,0
TIKI,dong-ho-va-trang-suc,154225373,"Lắc chân titan trái tim  - Trang sức Bé Heo BHLC44",34000,65000,31000,48
TIKI,dong-ho-va-trang-suc,138282893,"Khuyên tai hình hoa cúc xinh xắn HT663 - Culi accessories",85000,85000,0,0
TIKI,dong-ho-va-trang-suc,92819972," Dây chuyền mặt Thánh Giá cho nam và nữ - hợp kim titan màu bạc cực đẹp",35000,35000,0,0
TIKI,dong-ho-va-trang-suc,196965891,"Vòng Cẩm Thạch Huyết Nâu Đẹp Giá Mềm PQ9425 Ni 52-53 ",9100000,9100000,0,0
TIKI,dong-ho-va-trang-suc,13119587,"Bông tai nam Chữ Thập xỏ lỗ",45000,45000,0,0
TIKI,dong-ho-va-trang-suc,176267336,"Đồng hồ nữ thời trang cao cấp ELLY – EH13",1759450,3199000,1439550,45
TIKI,dong-ho-va-trang-suc,28730086,"Vòng tay phong thủy nữ đá thạch anh ưu linh trắng charm tỳ hưu 8mm mệnh thủy , kim - Ngọc Quý Gemstones",1009000,1570000,561000,36
TIKI,dong-ho-va-trang-suc,158602614,"Dây Handmade Da Bò Thật Cho Đồng Hồ Fossil Casio Samsung Huawei [Tặng Chốt thông minh & Hộp gỗ",190000,190000,0,0
TIKI,dong-ho-va-trang-suc,13368755,"Bông tai nam Caro nam châm không cần xỏ lỗ",34900,34900,0,0
TIKI,dong-ho-va-trang-suc,92957153,"Charm bạc chuỗi xích trang trí - Ngọc Quý Gemstones",17000,34000,17000,50
TIKI,dong-ho-va-trang-suc,108919519,"Charm bạc trắng xỏ ngang nhiều cạnh - Ngọc Quý Gemstones",55000,100000,45000,45
TIKI,dong-ho-va-trang-suc,119242259,"nhẫn hình bướm cặp đôi  [Hàng Có sẵn] [Rẻ vô địch] [Giá hủy diệt] [Chính Hãng",9000,9000,0,0
TIKI,dong-ho-va-trang-suc,182482770,"Đồng Hồ Casio Nam G-Shock GM-2100-1ADR",7628000,7628000,0,0
TIKI,dong-ho-va-trang-suc,74751478,"Đồng hồ dây da nữ mặt vuông Rtv1, mặt kính viền kim loại dây da mềm",31000,31000,0,0
TIKI,dong-ho-va-trang-suc,29253359,"Bông tai nam nữ cá tính",83000,83000,0,0
TIKI,dong-ho-va-trang-suc,72033073,"Đồng Hồ Nữ Julius Hàn Quốc JA-496",529000,529000,0,0
TIKI,dong-ho-va-trang-suc,130787596,"Bộ trang sức bạc 5 món chất liệu bạc s925 MS34a",630000,630000,0,0
TIKI,dong-ho-va-trang-suc,117490054,"Vòng giải thoát pháp bảo hộ thân mật tông",15000,15000,0,0
TIKI,dong-ho-va-trang-suc,32785995,"Bông Tai Ngôi Sao Sợi",61750,65000,3250,5
TIKI,dong-ho-va-trang-suc,154180789,"Bông tai nữ dáng dài hoa mai sang trọng thiết kế đeo nhiều kiểu.",67000,67000,0,0
TIKI,dong-ho-va-trang-suc,82923020,"Vòng đeo tay, lắc tay phong thủy đá mắt hổ đỏ",350000,350000,0,0
TIKI,dong-ho-va-trang-suc,103665044,"Dây chuyền bạc 925, Vòng cổ bạc 925 Mặt Đá Pha Lê Xanh Dây Chuyền Hình Bầu Dục [SN0104]",90000,90000,0,0
TIKI,dong-ho-va-trang-suc,74296458,"Dây Chuyền Swarovski Pha Lê Lấp Lánh",1360000,1360000,0,0
TIKI,dong-ho-va-trang-suc,44180454,"Đồng hồ nam dây nhựa Casio G-Shock chính hãng GA-2100-1ADR",2829000,3628000,799000,22
TIKI,dong-ho-va-trang-suc,73955462,"Đồng hồ thời trang nữ Candycat Cdn1 mặt số la mã dây da nhung mẫu mới",24000,24000,0,0
TIKI,dong-ho-va-trang-suc,99495727,"Vòng tay mèo kitty bạc ta cho bé",275000,275000,0,0
TIKI,dong-ho-va-trang-suc,125291053,"Bông tai bạc khuyên tròn cao cấp chất liệu bạc s925 MS55b",107000,107000,0,0
TIKI,dong-ho-va-trang-suc,170707491,"Nhẫn bạc nữ hình rắn chất liệu bạc s925 MS65a1",115000,115000,0,0
TIKI,dong-ho-va-trang-suc,56107956,"Combo 2 cái charm bạc mạ vàng 12 con giáp xỏ ngang - Ngọc Quý Gemstones",200000,320000,120000,38
TIKI,dong-ho-va-trang-suc,15062418,"Dây chuyền bạc nữ - Vòng cổ bạc nữ mặt hồ ly [DC-A13]",159000,159000,0,0
TIKI,dong-ho-va-trang-suc,194462959,"Chuỗi dây mã não 108 hạt Thiên tâm đạo gỗ trắc",410000,410000,0,0
TIKI,dong-ho-va-trang-suc,106393572,"Combo cây thay dây đồng hồ + 4 chốt lò xo",30000,30000,0,0
TIKI,dong-ho-va-trang-suc,75301179,"Lắc chân titan hoa tuyết BHLC36",90000,119000,29000,24
TIKI,ngon,179711540,"[Chỉ giao HN]  - Đậu gà nhập khẩu Mỹ - 500gr",75000,75000,0,0
TIKI,dong-ho-va-trang-suc,148824326,"Đồng Hồ Nam Dây Da Casio Standard MTP-VD02BL-3EUDF Chính Hãng - MTP-VD02BL-3E",962250,1283000,320750,25
TIKI,ngon,179711417,"[Chỉ giao HN] - Sữa hạt điều đậu gà không đường - size M (550ml)",65000,65000,0,0
TIKI,dong-ho-va-trang-suc,92817522," Nhẫn nam nữ titan phối dây xích - kiểu dáng cá tính cực đẹp",12000,20500,8500,41
TIKI,ngon,179711756,"[Chỉ giao HN] - Yến mạch cán dẹt nhập khẩu Úc  - 1kg",120000,120000,0,0
TIKI,ngon,177650115,"[CHỈ GIAO HN] TÔM SÚ (~25 CON/KG)",650000,650000,0,0
TIKI,ngon,186165965,"Mứt Dâu EveryHome 450gr - EUFOOD Việt Nam - Đồ Làm Bánh, Nấu Ăn, Pha Chế - Mứ Nhập Khẩu Malaysia",60000,60000,0,0
TIKI,dong-ho-va-trang-suc,12274959,"Đồng hồ nữ dây nhựa Casio LRW-200H-4E2VDR",751200,939000,187800,20
TIKI,dong-ho-va-trang-suc,114971017,"Vòng kết dây đa sắc hạt đá thiên nhiên - Ngọc Quý Gemstones",74999,130000,55001,42
TIKI,dong-ho-va-trang-suc,14865613,"Vòng Tay Băng Ngọc Thuỷ Tảo Huyết Ni 56 Ngọc Quý Gemstones",1539000,1924000,385000,20
TIKI,dong-ho-va-trang-suc,53977619,"Đồng hồ nam thời trang cao cấp dây da bền bỉ mặt kính tròn to ZO97",43000,43000,0,0
TIKI,dong-ho-va-trang-suc,150145253,"Đồng Hồ Nam Dây Nhựa Casio G-Shock GA-2200BB-1ADR Chính Hãng - GA-2200BB-1A",3363000,4484000,1121000,25
TIKI,dong-ho-va-trang-suc,40261556,"Đồng hồ nam nữ thời trang thông minh tacona DH34",37000,37000,0,0
TIKI,dong-ho-va-trang-suc,221045297,"￼Hộp Đựng Đồng Hồ Cơ Xoay Ngang 4 Chế Độ Xoay Tiêu Chuẩn Quốc Tế",420000,420000,0,0
TIKI,ngon,177154244,"[ Chỉ giao HN] - Bánh xương chó con dentastix56g",37000,37000,0,0
TIKI,ngon,185290175,"Áo cho thú cưng bóng đá đầy đủ đội bóng",39000,39000,0,0
TIKI,dong-ho-va-trang-suc,107959904,"Dây Da Đồng Hồ Cao Cấp - Sang Trọng, Chất Liệu Da Bê EPSOM Nhập Khẩu Từ Pháp, Tiêu chuẩn Châu Âu, Mặt Lót Chống Thấm Mồ Hôi, Tích Hợp Lớp Gia Cố Chống Giãn Đặc Biệt và Chốt Thông Minh Mới Nhất - Hàng Chính Hãng SAIGIO",1880000,1999000,119000,6
TIKI,ngon,179711612,"[Chỉ giao HN] - Sữa hạt sen cốt dừa ít đường - size S (325ml)",56000,56000,0,0
TIKI,dong-ho-va-trang-suc,16413626,"Đồng hồ cơ nam Winner H119M lộ máy dây da - Fullbox chính hãng",395000,395000,0,0
TIKI,ngon,177153855,"[ Chỉ giao HN] - Dây xích có tay cầm 0.3*180cm",240000,240000,0,0
TIKI,dong-ho-va-trang-suc,54856711,"1 vỉ 10 viên pin đồng hồ đeo tay",13000,13000,0,0
TIKI,ngon,179711524,"[Chỉ giao HN] - Đường phèn mật mía tự nhiên Nghệ An - 1kg",140000,140000,0,0
TIKI,dong-ho-va-trang-suc,71516022,"Đồng hồ nam dây nhựa Casio G-Shock chính hãng GA-900-1ADR (49mm)",3335000,4276000,941000,22
TIKI,ngon,186166044,"Mỳ Ý Spaghetty Đỏ EUFOOD 500g - EUFOOD Việt Nam - Mỳ Italia Ngon Nhập Khẩu Chính Hãng",46000,46000,0,0
TIKI,dong-ho-va-trang-suc,51565052," Đồng hồ thời trang nam nữ dây da unisex phong cách thanh lịch công sở ZO38",53999,53999,0,0
TIKI,dong-ho-va-trang-suc,212461988,"Bông tai kiểu dáng đôi dép đính đá phụ kiện trang sức cá tính",56000,56000,0,0
TIKI,ngon,179711590,"[Chỉ giao HN] - Sữa hạt điều cacao ít đường - size L (1000ml)",113000,113000,0,0
TIKI,ngon,185290092,"Cần Câu Mèo ( Chất Lượng ).",26000,26000,0,0
TIKI,ngon,179711444,"[Chỉ giao HN] - Sữa macca hạt sen không đường- size L (1000ml)",131000,131000,0,0
TIKI,dong-ho-va-trang-suc,174182150,"Hoa ( Bông) Tai Ngọc Trai Màu Trắng Kiểu Móc Ngọc Trai CN2",400000,400000,0,0
TIKI,dong-ho-va-trang-suc,161225861,"Vòng đeo tay, lắc tay dạng lu thống phong thủy mix phụ kiện đá ngọc hoàng long",250000,250000,0,0
TIKI,dong-ho-va-trang-suc,68166306,"Mặt Dây Chuyền Tỳ hưu Phong Thủy Đá Aventurine Thiên Nhiên  - Có Móc Bạc và Dây Đeo Cổ",280000,280000,0,0
TIKI,ngon,177153782,"[ Chỉ giao HN] - Dây dắt tự động dây dẹp L 5m",826000,826000,0,0
TIKI,dong-ho-va-trang-suc,66207179,"Đồng hồ Casio Nam G Shock GA-2110SU-3ADR",4103000,4103000,0,0
TIKI,dong-ho-va-trang-suc,116141798,"Vòng đeo tay, lắc tay phong thủy đá ngọc cẩm thạch quấn 3 vòng",300000,300000,0,0
TIKI,dong-ho-va-trang-suc,196207789,"Dây gốm Ceramic 22mm dành cho Garmin Vivoactive 4 / Forerunner 255",400000,400000,0,0
TIKI,dong-ho-va-trang-suc,107393796,"Đồng hồ nam dây nhựa Casio G-Shock chính hãng Anh Khuê GBA-900-1ADR (48mm)",3475000,4456000,981000,22
TIKI,dong-ho-va-trang-suc,219135986,"(Có ký hiệu-Không kiêng nước) Dây Chuyền Mặt Di Lặc Titanium Cao Cấp-Dùng lâu dài tắm rửa thoải mái không đen",223000,223000,0,0
TIKI,ngon,185290371,"Bát Ăn Đôi Inox Cho Chó Mèo (Hình Ếch) Giá Rẻ",70000,70000,0,0
TIKI,ngon,177154332,"[ Chỉ giao HN] - Sữa tắm 4 sao 800ml",175000,175000,0,0
TIKI,ngon,179711474,"[Chỉ giao HN] - Sữa hạt điều đậu gà ít đường - size M (550ml)",65000,65000,0,0
TIKI,dong-ho-va-trang-suc,16875010,"Lắc tay nam mạ vàng 24k rồng vàng LT6",201000,212000,11000,5
TIKI,dong-ho-va-trang-suc,19587473,"Dây chuyền nam mặt chữ nhật khảm Rồng mạ Vàng 24k MD30",254000,300000,46000,15
TIKI,dong-ho-va-trang-suc,104157493,"Dây da bò cao cấp cho Fossil size 20 và 22 chốt thông minh",370000,370000,0,0
TIKI,ngon,176170754,"[ Chỉ giao HN] - Tàu hũ trứng 220g",25000,25000,0,0
TIKI,ngon,177153821,"[ Chỉ giao HN] - Sữa tắm mụn mủ nhờnDemodex 355ml",385000,385000,0,0
TIKI,dong-ho-va-trang-suc,147729250,"Dây đeo Huawei Watch GT4 46mm/ GT3 42/ 46mm/ GT Runner (DSG)",140000,140000,0,0
TIKI,ngon,177154230,"[ Chỉ giao HN] -Cây mèo leo 3 tầng VINTAGE CAT",4930000,4930000,0,0
TIKI,ngon,177663561,"[ Chỉ giao HN] - Thức ăn cho PetBaby Dog Milk400g chia",350000,350000,0,0
TIKI,ngon,179711626,"[Chỉ giao HN] - Sữa hạt sen hạt điều không đường - size L (1000ml)",131000,131000,0,0
TIKI,ngon,179711620,"[Chỉ giao HN] - Sữa hạt sen hạt điều ít đường - size L (1000ml)",131000,131000,0,0
TIKI,ngon,186166123,"Tinh Bột Khoai Tây EUFOOD 400g - EUFOOD Việt Nam - Nguyên Liệu Nấu Súp, Làm Bánh",45000,45000,0,0
TIKI,dong-ho-va-trang-suc,56994124,"Charm bạc tròn hoa văn - Ngọc Quý Gemstones",75000,150000,75000,50
TIKI,dong-ho-va-trang-suc,14031474,"Chuỗi hạt đeo cổ phật Hư Không Tạng Bồ Tát - Bản mệnh người",69000,69000,0,0
TIKI,ngon,186084602,"địu các size cho chó mèo - địu cho chó mèo giá rẻ chất lượng",130000,130000,0,0
TIKI,dong-ho-va-trang-suc,56861139,"Charm bạc hình nén vàng - Ngọc Quý Gemstones",260000,260000,0,0
TIKI,dong-ho-va-trang-suc,141233896,"Vòng Tay Trầm Hương Cao Cấp Mộc Trầm Hương Trụ Trúc Size 10mm (Nam/Nữ) Trầm Tốc Việt Tự Nhiên - Mùi Dịu Nhẹ",259000,259000,0,0
TIKI,dong-ho-va-trang-suc,161030297,"Mặt dây chuyền Thiên Tâm đài sen 5cm MMD019",142000,142000,0,0
TIKI,ngon,177462018,"[ Chỉ giao HN ] -  Puppy Milk Flavour gói 400g ( bao10 kgx25 gói)",25000,25000,0,0
TIKI,ngon,184492213,"Ruốc Hàu BAVABI 100g, Thực Phẩm Đóng Hộp Đặc Sản Quảng Ninh Giàu Dinh Dưỡng",155000,155000,0,0
TIKI,dong-ho-va-trang-suc,9860555,"Mặt Phật Thiên Thủ Thiên Nhãn đá mắt hổ 3.6cm",219000,219000,0,0
TIKI,ngon,177585050,"[Chỉ giao HN ] - Thức ăn cho mèo cá ngừ thịt đỏ và tôm trong thạch 70g",14000,14000,0,0
TIKI,ngon,179711408,"[Chỉ giao HN] - Sữa hạnh nhân matcha không đường - size L (1000ml)",113000,113000,0,0
TIKI,ngon,177154264,"[ Chỉ giao HN] -Áo cách tân khuy hoa mai size S",163000,163000,0,0
TIKI,ngon,177154266,"[ Chỉ giao HN] - treat healthy hip happy joint 100g",19000,19000,0,0
TIKI,dong-ho-va-trang-suc,920500,"Đồng Hồ Nữ Dây Da Julius JA-787B (24 x 19 mm) - Đen",589000,589000,0,0
TIKI,ngon,186166177,"Sốt Mỳ Spaghetti Basil Castello 350g - EUFOOD Việt Nam - Sốt Cà Chua Italia Tiện Lợi Nhập Khẩu",77000,77000,0,0
TIKI,dong-ho-va-trang-suc,148923807,"[5 Hạt/10 Hạt] 3.5MM Đá Peridot Xanh Lá Tự Nhiên (Xử Lý Nhiệt) Giác Cắt, Mộc, Hoả, Đá Phối Vòng Tay Phong Thuỷ, Chuỗi Hạt - Bead Art",55400,55400,0,0
TIKI,dong-ho-va-trang-suc,127058169,"Vòng đeo tay, lắc tay phong thủy chuỗi hạt quấn 3 vòng đá ngọc Jade",290000,290000,0,0
TIKI,ngon,177496508,"[ Chỉ giao HN ] - Genta drop 10ml",10000,10000,0,0
TIKI,ngon,177663555,"[ Chỉ giao HN] - Thức ăn cho Pet British Shorthair Kitten 400g",125000,125000,0,0
TIKI,ngon,177154171,"[ Chỉ giao HN] - Bình nước có van size S",50000,50000,0,0
TIKI,ngon,179711682,"[Chỉ giao HN] - Sữa hạnh nhân matcha ít đường - size M (550ml)",65000,65000,0,0
TIKI,ngon,177154001,"[ Chỉ giao HN] -Bình uống nước tự động phi thuyền 3500ml",188000,188000,0,0
TIKI,dong-ho-va-trang-suc,52003160,"Dây Chuyền Hồ Ly Pha Lê Cầu Tài Lộc - Ngọc Qúy Gemstones",99000,150000,51000,34
TIKI,ngon,179711430,"[Chỉ giao HN] - Sữa óc chó mè đenkhông đường  - size M (550ml)",77000,77000,0,0
TIKI,ngon,177153997,"[ Chỉ giao HN] - Đồ chơi mèo hình mèo CATZILLA",92000,92000,0,0
TIKI,dong-ho-va-trang-suc,94517970,"Charm bạc túi tài lộc treo - Ngọc Quý Gemstones",99000,100000,1000,1
TIKI,dong-ho-va-trang-suc,23290331,"Vòng Tay - Vòng Đeo Tay Da SAM Leather SAMVDTC002",99000,99000,0,0
TIKI,dong-ho-va-trang-suc,53096679,"Vòng tay tự gập , cuốn combo 2 cái",30000,30000,0,0
TIKI,dong-ho-va-trang-suc,59263751,"Lắc tay bạc đá thạch anh dâu phối charm lông vũ mệnh hỏa, thổ - Ngọc Quý Gemstones",399000,590000,191000,32
TIKI,dong-ho-va-trang-suc,21199650,"Bông tai dài đá mã não đỏ BHBT86",39000,87000,48000,55
TIKI,dong-ho-va-trang-suc,5152033,"Vòng cổ Phật Di lặc đá thạch anh đen DDLD23",218900,218900,0,0
TIKI,dong-ho-va-trang-suc,44123568,"[HỎA TRẦM] Vòng Trầm Hương Đeo Tay Tốc Dó Vườn 108 Hạt",145000,145000,0,0
TIKI,dong-ho-va-trang-suc,17987143,"Bông tai nam châm tam giác 9mm BNC17 (Màu đen)",45000,45000,0,0
TIKI,ngon,200677931,"Đùi gà góc tư Truefood nhập khẩu 500g chặt sẵn miếng vừa rang, xào, nấu tiện lợi [Chỉ giao HN]",49000,49000,0,0
TIKI,dong-ho-va-trang-suc,193540751,"Bông tai bạc thời trang chất liệu bạc s925 MS076",130000,130000,0,0
TIKI,dong-ho-va-trang-suc,48018786,"Vòng chỉ đỏ Tây Tạng may mắn tết nhiều sợi (CD48)",19000,19000,0,0
TIKI,dong-ho-va-trang-suc,106394457,"Dụng cụ cắt mắt dây đồng hồ - Dụng cụ tháo mắt dây đồng hồ đầu đột sữa chữa đồng hồ",35000,35000,0,0
TIKI,dong-ho-va-trang-suc,54859974,"Dây chuyền nam chạm mạ 24k cao cấp H24",180000,180000,0,0
TIKI,dong-ho-va-trang-suc,100465865,"BÔNG TAI NỮ BẠC TA - BÔNG NỤ ĐỦ MÀU THEO MỆNH",32000,32000,0,0
TIKI,ngon,170179765,"Combo Thức Ăn Cho Chó Smartheart Adult (400g)  - 50 Gói (1 Bao to 20kg)",1155000,1155000,0,0
TIKI,ngon,164428814,"[ Chỉ giao HN] - Yến mạch nguyên chất ăn liền OATTA- hộp 800g",140000,140000,0,0
TIKI,dong-ho-va-trang-suc,178030964,"Dây da đồng hồ da bò cao cấp kèm khóa bướm Đơn thép không gỉ 316L",78000,78000,0,0
TIKI,ngon,160372855,"Bò viên Giang Minh Food 500g",45000,45000,0,0
TIKI,dong-ho-va-trang-suc,4898457,"Đồng Hồ Nữ Dây Nhựa Casio LRW-200H-3CVDF - Trắng Xanh",751200,939000,187800,20
TIKI,ngon,190745434,"Hộp 12 chai sữa hạt L'ORCHATA vị hạt điều mầm lúa mạch 236ml",660000,660000,0,0
TIKI,ngon,196175650,"Combo gia vị tẩm ướp gà rán 2 gói dạng bột và muối 500gr - Mang đến hương vị thơm ngon, hấp dẫn cho món gà rán",165000,165000,0,0
TIKI,ngon,169004039,"6 Gói Thức Ăn Cho Mèo Lớn Me-O Adult (350g/ Gói)",180000,180000,0,0
TIKI,dong-ho-va-trang-suc,141009836,"Dụng Cụ Tháo Dây Đồng Hồ, Đơn Giản, Dễ Dùng",29000,29000,0,0
TIKI,ngon,197989102,"Sữa Colos Detox Milk đỏ đầy đủ chất dinh dưỡng hỗ trợ người ốm, tăng cường sức đề kháng dành cho mọi lứa tuổi",293000,293000,0,0
TIKI,dong-ho-va-trang-suc,49732153,"Nhẫn Cỏ 4 Lá Đen Trắng Titan Không Rỉ TT 1792",121000,121000,0,0
TIKI,ngon,191502173,"Nước rửa tay Lion hoa hồng 250ml diệt khuẩn hương hoa hồng - 250ml",115000,115000,0,0
TIKI,dong-ho-va-trang-suc,19716288,"VÒNG NAM Mệnh THUỶ MỘC 14ly ĐÁ TN MẮT HỔ ĐEN XANH",379000,379000,0,0
TIKI,dong-ho-va-trang-suc,39331071,"Đồng hồ đeo tay thời trang nam nữ yamino cực đẹp DH33",45699,45699,0,0
TIKI,ngon,169074935,"Yến Sào Đảo Thiên Nhiên Tinh Chế Sử Dụng Đường Ăn Kiêng 5G-012F",345000,345000,0,0
TIKI,dong-ho-va-trang-suc,157500716,"Mặt dây chuyền đá aquamarine giọt nước 18x12x6.5mm mệnh thủy, mộc - Ngọc Quý Gemstones",899000,1280000,381000,30
TIKI,dong-ho-va-trang-suc,106391981,"Bàn Ép Tay Đồng Hồ 11 Cỡ Để Thay Pin Đồng Hồ",185000,185000,0,0
TIKI,dong-ho-va-trang-suc,26046927,"Kiềng cổ nữ mạ",298500,298500,0,0
TIKI,dong-ho-va-trang-suc,24623552,"Dây chuyền nam cao su bọc rồng dát",148000,156000,8000,5
TIKI,ngon,163554328,"[Chỉ giao HN] - Tôm sú size 30 - hộp 1kg",204000,204000,0,0
TIKI,ngon,191502193,"Nho khô Kobe Bussan 400g- Hàng Nhật nội địa- 400g",185000,185000,0,0
TIKI,ngon,196175667,"Combo gia vị tẩm ướp thịt bò khô 2 gói bột và muối 500gr - Chuẩn hương vị cho món thịt bò khô",165000,165000,0,0
TIKI,ngon,173057812,"[ Chỉ giao HN ] - Bánh tôm hồ Tây 10 bánh",150000,150000,0,0
TIKI,ngon,190745467,"Hộp 6 chai sữa hạt L'ORCHATA vị hạt điều mầm lúa mạch 236ml",330000,330000,0,0
TIKI,ngon,177235618,"[ Chỉ giao HN] - Đồ chơi banh chuột Stripe",51000,51000,0,0
TIKI,dong-ho-va-trang-suc,168872083,"Nhẫn bạc nữ mặt vương miện chất liệu bạc s925 MS47d",94000,94000,0,0
TIKI,ngon,170179515,"Vòi Nước Cấp Nước Tự Động Gắn Chuồng Cho Chó Mèo Diil",39999,39999,0,0
TIKI,dong-ho-va-trang-suc,53217776,"Bông tai ngọc đại viền đá BHBT339",48000,87000,39000,45
TIKI,dong-ho-va-trang-suc,106393246,"Dây đồng hồ da vân cá sấu màu xanh đủ size",120000,120000,0,0
TIKI,ngon,190745470,"Hộp 12 chai sữa hạt L'ORCHATA vị hạt điều lá dứa 236ml",660000,660000,0,0
TIKI,dong-ho-va-trang-suc,172548709,"Dây Chuyền Attack on Titan - Phụ Kiện Thời Trang Phong Cách Anime",50000,50000,0,0
TIKI,ngon,191502205,"Hộp thơm phòng cao cấp hương đào - 200g",65000,65000,0,0
TIKI,dong-ho-va-trang-suc,196092829,"Pin đồng hồ Thụy Sỹ RENATA 364 SR621SW dành cho đồng hồ kim 3 kim (Dạng vỉ 10 viên-Giá theo số viên) - 1 Viên",12000,12000,0,0
TIKI,ngon,169077702,"Nước Yến Sào Khánh Hòa Sanest CAO CẤP Lon 190Ml, Thùng 30 Lon - 001T30",262000,262000,0,0
TIKI,ngon,169005360,"Sữa tắm SOS cho chó mèo (100% chính hãng) - Trắng,550ml",79900,79900,0,0
TIKI,ngon,162475448,"[Chỉ giao HN] - Hạt dẻ cười mộc - 500gr",200000,200000,0,0
TIKI,ngon,169067140,"Sữa Tắm Trị Ve Rận Bọ Chét Chó Mèo Hantox Shampoo 200ml - chai xanh",42000,42000,0,0
TIKI,ngon,160278262,"Chả giò nhân thịt nấm tam vị ",74100,74100,0,0
TIKI,dong-ho-va-trang-suc,107708777,"Đồng hồ Nam MVMT dây da 41mm - Revolver D-MR01-RGGR",4000000,4000000,0,0
TIKI,ngon,171906542,"Bột mì Hoa Ngọc Lan",15000,15000,0,0
TIKI,dong-ho-va-trang-suc,7530909,"Vòng Cổ Tua Rua CH180701",16000,16000,0,0
TIKI,ngon,160271765,"Nem chua rán Quang Vinh",51300,51300,0,0
TIKI,dong-ho-va-trang-suc,72791011,"Vòng tay đá thạch anh tóc vàng phối charm ngôi sao size hạt 8mm mệnh thủy, kim - Ngọc Quý Gemstones",1399000,2000000,601000,30
TIKI,ngon,177235358,"[ Chỉ giao HN] - Thùng vệ sinh cho chó mèo",204000,204000,0,0
TIKI,dong-ho-va-trang-suc,101141402,"Vòng Tay Nam Titan Ko Đen TT 3186",187000,187000,0,0
TIKI,ngon,191578363,"KHOAI MÔN LỆ PHỐ MERCI FOODS",36000,36000,0,0
TIKI,dong-ho-va-trang-suc,2528573,"Dây Đồng Hồ Da Đà Điểu Size Nhỏ Huy Hoàng HT8423 - Nâu Đỏ",219000,219000,0,0
TIKI,ngon,169372161,"Trà thảo mộc hữu cơ với gừng, cam thảo và saffron Hy Lạp nhãn hiệu Krokos Kozanis hộp 18g",179000,179000,0,0
TIKI,ngon,164428752,"[ Chỉ giao HN] - Xốt Mỳ Ý Campagna - 350g",81000,81000,0,0
TIKI,ngon,196175685,"Bột điều gói 500g- gia vị tạo màu sắc đẹp, hấp dẫn cho món ăn",85000,85000,0,0
TIKI,dong-ho-va-trang-suc,19844206,"Đồng hồ nữ dây nhựa Casio Baby-G chính hãng BGA-250-7A2DR (41mm)",2559000,3282000,723000,22
TIKI,ngon,177235048,"[ Chỉ giao HN] - Kong Xs",142000,142000,0,0
TIKI,ngon,193911535,"Ruốc lợn đen Lào Cai Ninh Sớp Hộp 350g",299000,299000,0,0
TIKI,dong-ho-va-trang-suc,56255231,"Combo 2 cái charm bạc hình cầu họa tiết hoa văn xỏ ngang - Ngọc Quý Gemstones",180000,300000,120000,40
TIKI,ngon,169372167,"Hộp quà Saffron Organic Nhuỵ Hoa Nghệ Tây Hy Lạp tặng gia đình và người thân",1050000,1050000,0,0
TIKI,dong-ho-va-trang-suc,41225938,"Vòng tay mã não đen đốt trụ 13x10mm mệnh thủy,mộc - Ngọc Quý Gemstones",349000,680000,331000,49
TIKI,dong-ho-va-trang-suc,144192922,"Đồng hồ Nữ dây thép không gỉ SRWATCH SL3009.1102CV",920000,1150000,230000,20
TIKI,dong-ho-va-trang-suc,29285586,"Đồng hồ nam dây kim loại Casio Edifice chính hãng Anh Khuê EFV-C100D-2AVDF (46mm)",2752000,3529000,777000,22
TIKI,dong-ho-va-trang-suc,56689370,"Chuỗi tay Tỳ Hưu inox charm Thạch Anh Đen size 16 ly phối 6 bi - hợp mệnh Mộc, mệnh Thủy - Chuỗi size XXL",286000,286000,0,0
TIKI,dong-ho-va-trang-suc,78046398,"Nhẫn bạc 925 Huệ Ngân - 3 kiểu phong cách Hàn Quốc RR1653",259000,259000,0,0
TIKI,ngon,196175705,"Sốt vang vỉ 30 gói * 5gram",75000,75000,0,0
TIKI,ngon,169061800,"[CHÍNH HÃNG] Thuốc Nhỏ Tai BIO GENTAZOL Trị Viêm Tai cho Chó Mèo 10ml",35000,35000,0,0
TIKI,ngon,191502055,"Bột tẩy đa năng baking soda mã mới- 240g",39000,39000,0,0
TIKI,ngon,173536584,"[Chỉ Giao Hà Nội] Set bánh Socola cuộn Banquet D'or 30gx8 bánh  nhập khẩu Pháp (nướng nồi chiên không dầu hoặc lò nướng)",95000,95000,0,0
TIKI,dong-ho-va-trang-suc,208524940,"(Có đèn nhạc) Đồng hồ hình mèo Kitty cho bé gái điện tử nắp lật có đèn nhạc phát sáng hoạt hình mèo Kitty kỹ thuật số cho trẻ em bé gái",95000,95000,0,0
TIKI,ngon,169067738,"Combo 10 gói thức ăn cho mèo trưởng thành Me-o Adult - Vị cá ngừ - 350g",253333,253333,0,0
TIKI,ngon,177235400,"[ Chỉ giao HN] -Thuốc nhổ lông tai Ear powder",58000,58000,0,0
TIKI,ngon,119528394,"[Chỉ giao HN] - Cá Hố Cắt Khúc Đã Làm Sạch - Đông Lạnh",219000,219000,0,0
TIKI,ngon,172155237,"Cải ngọt ",23000,23000,0,0
TIKI,ngon,123367838,"[Chỉ giao HN] Ruốc tôm sú nguyên chất 100g",159000,159000,0,0
TIKI,ngon,121641703,"Đùi Gà Góc Tư (1/4) - 600g",58500,58500,0,0
TIKI,ngon,176051651,"Ổi nữ hoàng",50000,50000,0,0
TIKI,ngon,179711415,"[Chỉ giao HN] - Sữa đậu gà đậu đỏ không đường - size S (325ml)",34000,34000,0,0
TIKI,ngon,116360844,"[Chỉ giao HN] -Sò Điệp Nhật Nguyên Con ( Aomori ) - 1kg",310000,310000,0,0
TIKI,ngon,173273464,"[Chỉ giao HN] - Vụn Cá Hồi Có Da - 500g - Túi Hút Chân Không",169000,169000,0,0
TIKI,ngon,157330627,"[ Chỉ giao HN] - XO_Xôi ngũ sắc cấp đông - 800gr",125000,125000,0,0
TIKI,ngon,191502155,"Nước tẩy lồng máy giặt siêu sạch - 550gr",58000,58000,0,0
TIKI,ngon,119228662,"[Chỉ Giao Hà Nội] Bắp bò hun khói 200g",121000,121000,0,0
TIKI,ngon,119914647,"[GIAO NHANH HN - 1H - 0989.780.789] Giỏ Quà Tặng Trái Cây -AC246",790000,790000,0,0
TIKI,ngon,180365677,"[GIAO NHANH HN - 1H - 0989.780.789] Giỏ quà trái cây - AC011",1440000,1440000,0,0
TIKI,ngon,121603571,"[ Chỉ giao HN] - Mozzarella Calcar - 1kg",286800,286800,0,0
TIKI,ngon,165682320,"[ Chỉ giao HN] - Hành Tây Tím - 1kg",50000,50000,0,0
TIKI,ngon,180954945,"[GIAO NHANH HN - 1H - 0989.780.789] Hộp quà trái cây AC0015",1180000,1180000,0,0
TIKI,ngon,123391138,"[Chỉ giao HN] Thịt chưng mắm tép 300g",130000,130000,0,0
TIKI,ngon,127429994,"[Chỉ giao HN] Gói váng đậu nhúng lẩu",10000,10000,0,0
TIKI,ngon,155495684,"[Chỉ giao HN]Gà Ủ Muối -1kg2",280000,280000,0,0
TIKI,ngon,155495696,"[Chỉ giao HN]Củ Cải Đỏ-1kg",55000,55000,0,0
TIKI,ngon,116118557,"[Chỉ giao HN] - Lê Nâu Hàn Quốc - 1KG",149000,149000,0,0
TIKI,ngon,172919169,"[Chỉ giao Hà Nội] -  Gas Petro Gia Đình Đỏ 12kg",480000,480000,0,0
TIKI,ngon,154862153,"[Chỉ giao HN] - Set Xôi Ngũ Sắc - 1Kg",199000,199000,0,0
TIKI,ngon,197529406,"Khay trái cây mix - KF02",1000000,1000000,0,0
TIKI,ngon,107016421,"[CHỈ GIAO HN] - CÁ NHỤ 1 NẮNG VITOT FOOD (1 túi/kg)",339000,339000,0,0
TIKI,ngon,119967341,"[Chỉ giao HN] - Đặc Sản Sét Canh Cá Rô Đồng Rim",339000,339000,0,0
TIKI,ngon,107022392,"[GIAO HN & HCM] - CÁ SẶC TRỨNG 1 NẮNG CÀ MAU VITOT FOOD (500g/ khay)",149000,149000,0,0
TIKI,ngon,144162615,"[Chỉ giao HN] Cá hồi Na Uy fillet tươi khay 100g (Để nguyên miếng | Thái gỏi | Thái lẩu)",92000,92000,0,0
TIKI,ngon,114197804,"[Chỉ giao HN] - Cá Saba Fillet Nướng Tẩm Kabayaki Gói 550Gram",159000,159000,0,0
TIKI,ngon,156937361,"[ Chỉ giao HN] -Nấm kim châm trắng - 1kg",125000,125000,0,0
TIKI,ngon,155291686,"[Chỉ giao HN] - Giò Bê Nghệ An Loại 2 - Món Ngon Đãi Khách Tết",179000,179000,0,0
TIKI,ngon,173290608,"[Chỉ giao HN] - Chả Mỡ Nướng Phố Cổ - 500g - Túi Hút Chân Không",119000,119000,0,0
TIKI,ngon,169004176,"Đồ chơi chút chít cho thú cưng - Đồ chơi bông có tiếng kêu chút chít cho chó - Chuối",26666,26666,0,0
TIKI,ngon,177496481,"[ Chỉ giao HN ] -Cát vệ sinh Bentonite hương hoa lavender 5L",85000,85000,0,0
TIKI,ngon,160516376,"Ổi ",40000,40000,0,0
TIKI,ngon,109487929,"[CHỈ GIAO HN và HCM] - VITOT FOOD CÁ LÓC 3 NẮNG MIỀN TÂY (3- 4 con/kg)",239000,239000,0,0
TIKI,ngon,180350909,"[GIAO NHANH HN - 1H - 0989.780.789] Giỏ quà trái cây - AC008",1140000,1140000,0,0
TIKI,ngon,121603654,"[ Chỉ giao HN] - cá Chẽm tẩm sốt Teriyaki đông lạnh 340g",240000,240000,0,0
TIKI,ngon,196318926,"Cánh gà  nguyên-500g",65000,65000,0,0
TIKI,ngon,185903348,"Cá Hồi Nauy Tươi Phile Phần Bụng - Phần Lưng Khay 300g",227000,227000,0,0
TIKI,dong-ho-va-trang-suc,177154250,"[ Chỉ giao HN] -Thức ăn cho mèo thạch cá cơm 70g",16500,16500,0,0
TIKI,dong-ho-va-trang-suc,177783055,"[ Chỉ giao HN] - Sốt cá ngừ và gà bổ sung rau củ cho chó 130 gram",20000,20000,0,0
TIKI,dong-ho-va-trang-suc,177663547,"[ Chỉ giao HN] - Thức ăn cho Pet Kitten 36 10kg",1714000,1714000,0,0
TIKI,dong-ho-va-trang-suc,177154296,"[ Chỉ giao HN] -Địu vải ABC 3",169000,169000,0,0
TIKI,dong-ho-va-trang-suc,177154087,"[ Chỉ giao HN] - Thảm lót để chén ăn uống",105000,105000,0,0
TIKI,dong-ho-va-trang-suc,177153979,"[ Chỉ giao HN] - Dây dắt yên ngựa tròn kèm nơ 0.6x130cm",98000,98000,0,0
TIKI,dong-ho-va-trang-suc,177153867,"[ Chỉ giao HN] -Bát nhựa đơn cao cấp 3036",62000,62000,0,0
TIKI,dong-ho-va-trang-suc,186084424,"Loa Chống Liếm Đủ SIZE Cho Chó Mèo Dùng Khi Bôi Thuốc Tránh Chó Mèo Liếm Vết Thương hoặc Thuốc",20000,20000,0,0
TIKI,dong-ho-va-trang-suc,177153915,"[ Chỉ giao HN] - Rọ mõm mỏ vịt silicon size L",60000,60000,0,0
TIKI,dong-ho-va-trang-suc,177154215,"[ Chỉ giao HN] -Nệm Angry Bird Size 4",435000,435000,0,0
TIKI,dong-ho-va-trang-suc,177235398,"[ Chỉ giao HN]- Váy nơ công chúa kẻ xanh lá size M",150000,150000,0,0
TIKI,dong-ho-va-trang-suc,177154309,"[ Chỉ giao HN] - Đồ chơi con chuột, banh lăn",51000,51000,0,0
TIKI,dong-ho-va-trang-suc,177153802,"[ Chỉ giao HN] -Bình uống tự động hình trụ 3.5L",165000,165000,0,0
TIKI,dong-ho-va-trang-suc,177235011,"[ Chỉ giao HN] -Vòng cổ Police ABC 2.5cm",60000,60000,0,0
TIKI,dong-ho-va-trang-suc,177153764,"[ Chỉ giao HN] -Yếm nylon 2 lớp đệm 2.5cm",116000,116000,0,0
TIKI,dong-ho-va-trang-suc,177154268,"[ Chỉ giao HN] -Bánh xương cho chó trung 98g",39000,39000,0,0
TIKI,dong-ho-va-trang-suc,177154041,"[ Chỉ giao HN] -  Dây dắt tự động dây tròn New Comfort 5m (xám)",584000,584000,0,0
TIKI,dong-ho-va-trang-suc,177153940,"[ Chỉ giao HN] - Yếm Ergofluo 1.5/26-38 cm (cam)",379000,379000,0,0
TIKI,dong-ho-va-trang-suc,177589549,"[Chỉ giao HN ] - Thức ăn Meo kitten 1.1kg",116000,116000,0,0
TIKI,dong-ho-va-trang-suc,177236049,"[ Chỉ giao HN] - Đồ chơi banh xám - bóng đá",51000,51000,0,0
TIKI,dong-ho-va-trang-suc,177589526,"[Chỉ giao HN ] - Thức ăn Meo kitten Ocean fish 400g",38000,38000,0,0
TIKI,dong-ho-va-trang-suc,177154053,"[ Chỉ giao HN] -Thức ăn vặt cho chó vị heo muối que 60g",38000,38000,0,0
TIKI,dong-ho-va-trang-suc,185290063,"Thảm Hứng Cát Trước Chậu vệ Sinh, Nhà Vệ Sinh Của Mèo Tránh Rơi Làm Bẩn Nhà",40000,40000,0,0
TIKI,dong-ho-va-trang-suc,177623526,"[ Chỉ giao HN] - gold persian 400g",78000,78000,0,0
TIKI,dong-ho-va-trang-suc,177235659,"[ Chỉ giao HN] - Đầm xếp ly size S",105000,105000,0,0
TIKI,dong-ho-va-trang-suc,177235272,"[ Chỉ giao HN]- Đầm 8X size 8",65000,65000,0,0
TIKI,dong-ho-va-trang-suc,177154009,"[ Chỉ giao HN] -  Cổ vuông inox 4ly",33000,33000,0,0
TIKI,dong-ho-va-trang-suc,177236098,"[ Chỉ giao HN] - Đồ chơi Crinkle ball",51000,51000,0,0
TIKI,dong-ho-va-trang-suc,177235578,"[ Chỉ giao HN] - Lược ENZO 20x3cm",56000,56000,0,0
TIKI,dong-ho-va-trang-suc,177750932,"WHISKAS Thức ăn cho mèo lớn dạng sốt vị cá ngừ và cá thịt trắng 80g (1 gói)",12000,12000,0,0
TIKI,dong-ho-va-trang-suc,177234655,"[ Chỉ giao HN]- Mũ cho Pet M",130000,130000,0,0
TIKI,dong-ho-va-trang-suc,177153883,"[ Chỉ giao HN] - Dây dắt da Natural 1.5cm/120cm ( đen)",428000,428000,0,0
TIKI,dong-ho-va-trang-suc,177235195,"[ Chỉ giao HN]- Áo hoodie comic XL",115000,115000,0,0
TIKI,dong-ho-va-trang-suc,177154206,"[ Chỉ giao HN] - Địu vải ABC 5",195000,195000,0,0
TIKI,dong-ho-va-trang-suc,177153951,"[ Chỉ giao HN] - Thuc An Cho-Vi thit Bo&amp;rau cu tui 3kg",209000,209000,0,0
TIKI,dong-ho-va-trang-suc,177589541,"[Chỉ giao HN ] - Delite Tuna With Salmon In Gravy 70gx48",21500,21500,0,0
TIKI,dong-ho-va-trang-suc,177663541,"[ Chỉ giao HN] - Thức ăn cho Pet Baby Dog Milk 2kg",1693000,1693000,0,0
TIKI,dong-ho-va-trang-suc,177479479,"[ Chỉ giao HN ] - Cỏ bạc hà thành phẩm",28000,28000,0,0
TIKI,dong-ho-va-trang-suc,177623535,"[ Chỉ giao HN] - gold indoor cat 400g",78000,78000,0,0
TIKI,dong-ho-va-trang-suc,177663577,"[ Chỉ giao HN] - Thức ăn cho Pet Chihuahua junior 500gr",142000,142000,0,0
TIKI,voucher-dich-vu,3666667,"Gói 7 Buổi Vật Lý Trị Liệu Trị Chứng Thoát Vị Đĩa Đệm (Gói Cơ Bản) Tại Phòng Chẩn Y Học Cổ Truyền Tâm Minh Đường",765000,765000,0,0
TIKI,voucher-dich-vu,3654985,"Xoa Bóp Bấm Huyệt, Châm Cứu Cơ Bản Trị Đau Lưng, Đau Dây Thần Kinh Tọa (01 Buổi) Tại Phòng Chẩn Y Học Cổ Truyền Tâm Minh Đường",135000,135000,0,0
TIKI,voucher-dich-vu,138422918,"[E-BOOK] i-Learn Smart Start Special Edition 1 File nghe Audio",10000,10000,0,0
TIKI,voucher-dich-vu,173764355,"TRIỆT LÔNG VÙNG TRÁN (NỮ) tại LOVE + ROSA",140000,140000,0,0
TIKI,voucher-dich-vu,173761747,"TRIỆT LÔNG VÙNG NÁCH (NỮ)  tại LOVE + ROSA ",140000,140000,0,0
TIKI,voucher-dich-vu,54405129,"Học Tiếng Trung Giáo Trình Hán Ngữ Tập 1 - Quyển 2",799000,799000,0,0
TIKI,voucher-dich-vu,95175461,"Sách nói: Sinh Ra Là Một Bản Thể Đừng Chết Như Một Bản Sao",99000,99000,0,0
TIKI,voucher-dich-vu,122644584,"[E-BOOK] i-Learn Smart World 7 Sách giáo viên điện tử",15000,15000,0,0
TIKI,voucher-dich-vu,122669631,"[E-BOOK] i-Learn Smart World 7 Truyện đọc - Carl's Day",5000,5000,0,0
TIKI,voucher-dich-vu,122642412,"[E-BOOK] i-Learn Smart Start Listening & Speaking 1 Sách giáo viên điện tử",15000,15000,0,0
TIKI,voucher-dich-vu,117601199,"Chụp ảnh cưới tại Hồng Linh Studio-Voucher gói chụp ảnh cưới tại các địa điểm trong Khu vực miền Bắc (BLUE RUBY)",26860000,26860000,0,0
TIKI,voucher-dich-vu,117600241,"Chụp ảnh cưới tại Hồng Linh Studio-Voucher gói chụp ảnh cưới tại Đà Lạt (BLUE OPAL)",18680000,18680000,0,0
TIKI,voucher-dich-vu,117583107,"Chụp ảnh cưới tại Hồng Linh Studio-Voucher gói chụp ảnh cưới tại MIỀN TRUNG (PLATINUM)",26860000,26860000,0,0
TIKI,voucher-dich-vu,229782476,"[e-voucher] Sách nói Fonos: Một Huyền Thoại Ra Đời: Salah - Đế Vương The Kop",99000,99000,0,0
TIKI,voucher-dich-vu,52477950,"Khóa học online Chinh phục chứng chỉ MOS WORD 2013 Tin học Cộng",350000,350000,0,0
TIKI,voucher-dich-vu,229773630,"[e-Voucher] Sách nói Fonos: T.E.T - Bồi Dưỡng Giáo Viên Hiệu Quả",99000,99000,0,0
TIKI,voucher-dich-vu,229783916,"[e-voucher] Sách nói Fonos: Chiêm Nghiệm Về Nhân Quả Và Hành Trình Hạnh Phúc",99000,99000,0,0
TIKI,voucher-dich-vu,123148404,"[E-BOOK] i-Learn Smart Start Grade 5 Truyện đọc - Hollywood Here We Come!",5000,5000,0,0
TIKI,voucher-dich-vu,56342211,"KHÓA HỌC TIẾNG NHẬT N4",6600000,6600000,0,0
TIKI,voucher-dich-vu,56382723,"Khóa học tiếng Hàn trung cấp 4",1800000,1800000,0,0
TIKI,voucher-dich-vu,56454920,"TOUR GHÉP KHÁM PHÁ THÀNH PHỐ ĐÀ NẴNG | ĐI VỀ TRONG NGÀY, KHỞI HÀNH HÀNG NGÀY",294000,294000,0,0
TIKI,voucher-dich-vu,241997224,"[E-Voucher] Sách  nói Fonos: Nghĩ Như Hoàng Đế La Mã",99000,99000,0,0
TIKI,voucher-dich-vu,11797810,"Khám Sức Khỏe Work Permit (Giấy Phép Lao Động Nước Ngoài) Gói Tiêu Chuẩn Dành Cho Nam - Phòng Khám Careplus",1700000,1700000,0,0
TIKI,voucher-dich-vu,119991318,"[E-BOOK] Tiếng Anh 2 Extra and Friends Sách mềm sách học sinh",15000,15000,0,0
TIKI,voucher-dich-vu,11797041,"Khám Sức Khỏe Work Permit (Giấy Phép Lao Động Nước Ngoài) Gói Nâng Cao Dành Cho Nữ - Phòng Khám Careplus",3650000,3650000,0,0
TIKI,voucher-dich-vu,11798726,"Gói Khám Tổng Quát Cho Bé Từ 06 - 12 Tháng Tuổi Tại Phòng Khám Careplus",620000,620000,0,0
TIKI,voucher-dich-vu,198740178,"Tour Đà Nẵng 4 ngày 3 đêm Tết Nguyên Đán 2023",9568000,9568000,0,0
TIKI,voucher-dich-vu,48117050,"Khoá Luyện Thi Tiếng Anh Thiếu Nhi Cambridge Starters Cho Bé Lớp 1-3",399000,399000,0,0
TIKI,voucher-dich-vu,137246763,"[E-BOOK] New Amanda & Friends 3 Sách giáo viên điện tử",15000,15000,0,0
TIKI,voucher-dich-vu,270125746,"Hotel De La Coupole 5* Sapa - Nghỉ Dưỡng 2N1Đ Sang Trọng, Buffet Sáng, Hồ Bơi Trong Nhà, Ngay Trung Tâm Và Nhiều Dịch Vụ Hấp Dẫn",2899000,2899000,0,0
TIKI,voucher-dich-vu,253722655,"Sách nói Fonos [E-voucher]: Côn Trùng Ký - Tập 5",99000,99000,0,0
TIKI,voucher-dich-vu,253721385,"Sách nói Fonos [E-voucher]: Những Nhà Tư Tưởng Lớn - Sartre Trong 60 Phút",99000,99000,0,0
TIKI,voucher-dich-vu,58626055,"Gói 10 Lần Triệt Lông Vùng Cánh Tay Bảo Hành 03 Năm Tại L’amie Spa (Áp Dụng Cho 2 Cánh Tay)",2749000,2749000,0,0
TIKI,voucher-dich-vu,269845544,"Radisson Blu Resort 5* Cam Ranh Nha Trang - Buffet Sáng, Hồ Bơi Lớn, Bãi Dài Cực Đẹp Và Nhiều Ưu Đãi Hấp Dẫn",2099000,2099000,0,0
TIKI,voucher-dich-vu,253758562,"Sách nói Fonos [E-voucher]: Những Nhà Tư Tưởng Lớn - Kant Trong 60 Phút",99000,99000,0,0
TIKI,voucher-dich-vu,29022795,"MintWIFI-SIM 4G Du lịch Hàn Quốc tốc độ cao gói 10 ngày sử dụng dung lượng không giới hạn",670000,670000,0,0
TIKI,voucher-dich-vu,58705542,"Combo Chăm Sóc Da Chuyên Sâu Với Liệu Trình Điện Di Vitamin C + Massage Đầu Cổ Vai Tại L’amie Spa",375000,375000,0,0
TIKI,voucher-dich-vu,80901699,"Sách nói: Một Nghệ Thuật Sống",99000,99000,0,0
TIKI,balo-va-vali,8022426,"Túi đựng mỹ phẩm không ngăn",60000,60000,0,0
TIKI,balo-va-vali,2298753,"Túi bọc bảo vệ vali -Áo vỏ bọc vali - Cú HeadPhone",277000,277000,0,0
TIKI,voucher-dich-vu,270477863,"La Sapinette Hotel 4* Đà Lạt - Gồm Buffet Sáng Free, Khách Sạn Hàng Đầu Việt Nam Với Nhiều Ưu Đãi Hấp Dẫn, Gần Ngay Bến Xe Thành Bưởi Đà Lạt",1018000,1018000,0,0
TIKI,balo-va-vali,4210005,"Balo laptop Simplecarry B2B04",590000,590000,0,0
TIKI,balo-va-vali,127348313,"BALO LAPTOP MR.VUI BLLT865 THIẾT KẾ HIỆN ĐẠI, CHỐNG THẤM NƯỚC",380000,475000,95000,20
TIKI,balo-va-vali,25655391,"Balo Sakos MELODY",820000,820000,0,0
TIKI,voucher-dich-vu,80842215,"Khóa học Đào tạo hội nhập - Agilearn",1090000,1090000,0,0
TIKI,balo-va-vali,172574568,"Bao đựng bảo vệ thẻ nhân viên, thẻ cư dân",25000,25000,0,0
TIKI,balo-va-vali,182744827,"Túi đeo vai Tomtoc Meta/Oculus Quest 2 Sling Bag - Hàng chính hãng",1459000,1459000,0,0
TIKI,balo-va-vali,75047598,"Balo thời trang nam nữ Unisex ulzzang học sinh sinh viên Cặp to vừa laptop",91234,124687,33453,27
TIKI,balo-va-vali,180594862,"Ổ khóa số du lịch, mini, khóa hành lý, vali mật mã không cần chìa",62000,62000,0,0
TIKI,balo-va-vali,193045315,"￼Set 4 món balo, túi thời trang đi học, giá rẻ - NEW CUTE",89800,89800,0,0
TIKI,balo-va-vali,183056555,"Balo SAIGON SWAGGER Versatile Backpack Ngăn Chống Sốc Lap 16inch",495000,550000,55000,10
TIKI,balo-va-vali,70825569,"Balo nam nữ thời trang Hàn quốc để được laptop 15,6in du lịch chống thấm nước 111 BEE GEE có nhiều ngăn",247000,498000,251000,50
TIKI,balo-va-vali,90800540," Balo ulzzang cao cấp chống nước The day you went away",149900,149900,0,0
TIKI,balo-va-vali,164554574,"Túi/ Giỏ Đựng Đồ Cá Nhân Du Lịch Nhiều Ngăn Có Quai Xách Tiện Lợi - PaKaSa",59000,118000,59000,50
TIKI,balo-va-vali,192135213,"BALO LAPTOP THỜI TRANG TÍCH HỢP CÁP SẠC HÀNG CHÍNH HÃNG YVan 960",580000,580000,0,0
TIKI,balo-va-vali,113639939,"Balo đi học phong cách Ullzang Hàn Quốc, balo cho học sinh sinh viên - chất liệu vải dù cao cấp chống nước F_BALO_ZAKOMI",209000,209000,0,0
TIKI,balo-va-vali,71536310,"TÚI XÁCH DA, CẶP XÁCH DA CHỐNG SỐC CHO MÁY TÍNH, MACBOOK, LAPTOP - TẶNG KÈM VÍ ĐỰNG PHỤ KIỆN SIÊU CHỐNG NƯỚC",375250,395000,19750,5
TIKI,balo-va-vali,45859743,"Balo Laptop Mr Vui BLLT750 14 inch - ĐEN",491000,491000,0,0
TIKI,balo-va-vali,147702951,"Balo Thời Trang Nam Nữ, Balo Đi Học REGODS. S CLUBSS Phối Túi Trong",76900,76900,0,0
TIKI,balo-va-vali,163021404,"Vali khung nhôm A1S cao cấp 2022",1000000,1000000,0,0
TIKI,balo-va-vali,190517403,"Túi xách chính hãng TOMTOC (USA) Slim Handbag - A21-C01 cho Macbook Pro/Air 13-14 inch/ Ultrabook 13 inch",629100,699000,69900,10
TIKI,balo-va-vali,150935223,"Túi chống sốc Macbook, Laptop thương hiệu TARGUS dòng Multi-Fit",690000,690000,0,0
TIKI,balo-va-vali,89933992,"Balo vải bố đa năng Unisex - BALO DU LỊCH 205937",277800,313000,35200,11
TIKI,balo-va-vali,58567037,"Túi bọc trùm vali 20-24 inch thun 4 chiều siêu bền",99376,143543,44167,31
TIKI,balo-va-vali,191346147,"Balo Dung Tích Lớn Công Nghệ Flexible Defender Chống Va Đập , Chống Nước , Chống Xước",1740000,1740000,0,0
TIKI,balo-va-vali,159023539,"Balo unisex Lfc - A13978",890000,890000,0,0
TIKI,balo-va-vali,19756963,"Túi xách du lịch, túi xách thể thao sang trọng Pink-2019",197998,197998,0,0
TIKI,balo-va-vali,99362598,"Túi chống sốc laptop elastic cao cấp mẫu mới DK28",57109,78049,20940,27
TIKI,balo-va-vali,107616590,"Túi Dây rút Chống Nước Bảo vệ tai nghe,Pin Sạc điện thoại nhỏ,Các vật dụng Cá Nhân nhỏ",15000,15000,0,0
TIKI,balo-va-vali,78887150,"Combo 10 Túi zip đựng đồ du lịch tiện dụng (nhiều size)",49000,49000,0,0
TIKI,balo-va-vali,134939257,"Túi Chống Sốc dành cho Macbook Air, Macbook Pro Loại 11 inch, 13 inch, 15 inch Cao Cấp",139000,139000,0,0
TIKI,balo-va-vali,115896564,"Lọ chiết mỹ phẩm, chiết serum 5ml",6000,6000,0,0
TIKI,balo-va-vali,190863821,"Túi du lịch Pink 2 tầng",109100,109100,0,0
TIKI,balo-va-vali,12208229,"Balo ANELLO cỡ vừa AU-A0133 - Màu",1650000,1650000,0,0
TIKI,balo-va-vali,134937384,"️Túi Nỉ Đựng dành cho iPad Laptop Chống Sốc dành cho Macbook Air 12 inch, 13 inch, 14 inch, 15 inch, 15 6 inch chống nước cao cấp",119000,119000,0,0
TIKI,balo-va-vali,183337159,"Túi Wiwu Pilot Laptop Handbag 15.6 inch Dành Cho Laptop, Macbook Thiết Kế Mỏng Nhẹ, Chống Nước, Chống Xốc - Hàng Chính Hãng",650000,650000,0,0
TIKI,balo-va-vali,113208451,"Balo nam thời trang phong cách Hàn Quốc",88900,88900,0,0
TIKI,balo-va-vali,108912403,"Túi Xách Du Lịch Thời Trang Cao Cấp SAKOS TREK",1045000,1045000,0,0
TIKI,balo-va-vali,25404252,"Balo 3 PUBG",280000,280000,0,0
TIKI,balo-va-vali,66906336,"BALO NAM ĐI HỌC THỜI TRANG HÀN QUỐC ĐỰNG VỪA LAPTOP 15.6 INCH",69900,69900,0,0
TIKI,tui-vi-nu,174469089,"Ví Nữ Mini Cầm Tay Chính TAILIAN Gấp 2 Nhỏ Gọn Nhiều Ngăn Tiện Dụng Da Cao Cấp Cực Đẹp Giá Rẻ TL04",99000,99000,0,0
TIKI,tui-vi-nu,160314787,"Túi xách kẹp nách nữ đeo chéo đeo vai chính hãng MICOCAH dáng công sở thời trang da cao cấp cực đẹp giá rẻ MC08",399000,399000,0,0
TIKI,tui-vi-nu,32977400,"Túi đựng điện thoại - túi đeo chéo mini bag hình chú mèo đáng yêu",42570,58179,15609,27
TIKI,tui-vi-nu,44078807,"Túi đeo chéo nữ đầm tròn quả cầu C40 Shalla",58410,79827,21417,27
TIKI,tui-vi-nu,174445621,"Ví Nữ Ngắn Mini Cầm Tay Chính hãng TAILIAN Thời Trang Đựng Tiền Da Mềm Cao Cấp Cực Đẹp Giá Rẻ TL36",109000,109000,0,0
TIKI,tui-vi-nu,48102759,"Túi tote , túi đeo chéo, túi đeo vai thời trang nữ túi hộp sweet YNTT08",115000,115000,0,0
TIKI,tui-vi-nu,173167109,"Túi vải bố, Túi vải Canvas trơn Màu Be Size 36cm x 31cm",29000,29000,0,0
TIKI,tui-vi-nu,160314390,"Ví Nữ Ngắn Mini Cầm Tay FOREVER YOUNG Gấp 2 Nhỏ Gọn Dáng Cute Dễ Thương Da Cao Cấp Cực Đẹp Giá Rẻ FY17 - Micocah Mall",99000,99000,0,0
TIKI,tui-vi-nu,161386286,"Ví Nữ Cầm Tay Thời Trang JUNO Da Trơn Khóa Trang Trí VI168",544000,544000,0,0
TIKI,tui-vi-nu,192064368,"Ví dài nữ cầm tay thời trang PERFECT FOR YOU đựng tiền điện thoại da xước cao cấp cực đẹp giá rẻ PFY31 - Tukado",169000,169000,0,0
TIKI,tui-vi-nu,187746443,"Túi xách nữ dễ thương NASI T1041 túi cói cầm tay đẹp có dây kéo thời trang cho nữ công sở, học sinh",29000,29000,0,0
TIKI,tui-vi-nu,126882301,"Vỏ bọc thẻ ATM, CCCD, CMND (5 cái)",6998,6998,0,0
TIKI,tui-vi-nu,108253560,"Túi Đeo Chéo Da Mềm Nhiều Ngăn Điểm Sợi Tết",145000,145000,0,0
TIKI,tui-vi-nu,85564320,"Túi đeo vai nữ thời trang cao cấp khóa cài phong cách Âu Mỹ siêu cấp Vip Pro 2021 VTX025",160000,160000,0,0
TIKI,tui-vi-nu,98242410,"Móc Khóa sóc con siêu cute, siêu xinh xắn treo balo, móc khóa cực xịn",34000,34000,0,0
TIKI,tui-vi-nu,181673752,"Túi sách tay có quai sách cối, đi biển, đi làm, đi chơi",95000,95000,0,0
TIKI,tui-vi-nu,115440606,"Ví Nữ Dài Cầm Tay,BÓP VÍ CLUTCH,BÓP VÍ,BÓP VÍ NAM NỮ,BÓP VÍ ĐẸP,BÓP VÍ CẦM TAY,BÓP VÍ NAM ĐẸP,BÓP VÍ HOT,BÓP VÍ RẺ",178000,178000,0,0
TIKI,tui-vi-nu,146948864,"Túi vải canvas nữ đẹp đi chơi giá rẻ phong cách Hàn Quốc STIC TV10",79000,79000,0,0
TIKI,tui-vi-nu,147941376,"Túi Xách Nữ Kẹp Nách Hàng Hiệu MICOCAH Dáng Công Sở Thời Trang Phối Da Lộn Sang Trọng Da Cao Cấp Cực Đẹp MC41 - Tukado",449000,449000,0,0
TIKI,tui-vi-nu,181102322,"Túi xách nữ MONOGRAM CANVAS ELLY – EL200",1499000,1499000,0,0
TIKI,tui-vi-nu,44580696,"Túi xách tay đeo vai nữ Hàn Quốc size lớn size 32x29x12cm",125000,125000,0,0
TIKI,tui-vi-nu,178302279,"Túi phụ kiện RINGKE Pouch đựng đồ cá nhân 5 ngăn kháng nước",250000,250000,0,0
TIKI,tui-vi-nu,36398423," Túi bao tử, đeo bụng da cao cấp cực chất G705",55000,55000,0,0
TIKI,tui-vi-nu,79228194,"Dây Túi đeo chéo da pu, dây đeo vai có thể điều chỉnh  có thể điều chỉnh",100000,100000,0,0
TIKI,tui-vi-nu,93937065,"Ví Đựng Thẻ Da Thật Cao Cấp Saffiano Aaa Jeans",299000,299000,0,0
TIKI,tui-vi-nu,56438178,"Túi Vải Tote Cao Cấp, Dày Dặn Chất Liệu Canvas Hình Mèo, Dễ Phối Đồ",50000,50000,0,0
TIKI,tui-vi-nu,195318278,"Nút tán rivet (đinh tán) 2 mặt Bằng sắt xi Màu bạc, màu vàng, màu đồng Size 5mm, 6mm, 8mm, 9mm Đóng thùng giấy, thủ công",25000,25000,0,0
TIKI,tui-vi-nu,157548783,"Bóp ví nữ cầm tay mini V0204 da cao cấp nhiều ngăn nhỏ gọn phong cách đơn giản, thời trang, dễ thương",35000,70000,35000,50
TIKI,tui-vi-nu,158126738,"Túi xách nữ/Túi đeo chéo đeo vai nữ thời trang cao cấp thiết kế kẻ trung cá tính_ Mã MK198",99000,99000,0,0
TIKI,tui-vi-nu,131139676,"Túi xách nữ thiết kế nhỏ gọn phối dây xích thời trang hàn quốc cao cấp cho nữ SIÊU HOT",99000,99000,0,0
TIKI,tui-vi-nu,21050203,"Túi đeo chéo, túi đeo vai nữ vải canvas TV11",50000,50000,0,0
TIKI,tui-vi-nu,115660965,"Túi Cói Dễ Thương Xách Tay Hai Màu Quai Đen, Trắng",46455,48900,2445,5
TIKI,tui-vi-nu,118029771,"Túi Đi Chùa Thêu Thư Pháp # Túi Nam Nữ # Bị # Túi Đi Chùa",54000,54000,0,0
TIKI,tui-vi-nu,184954202,"[GDSG170][Chắc chắn] Ví cầm tay mini - Ví nữ cầm tay thời trang nhiều màu sắc - Fashion",45000,45000,0,0
TIKI,tui-vi-nu,173649871,"Túi Cói Đi Du Lịch Merci Sang Chảnh,Túi Cói Đi Biển Siêu Hot",59888,59888,0,0
TIKI,tui-vi-nu,242946979,"Ví Cầm Tay Nữ - 8 ngăn, 2 khóa tiện lợi - Cao Cấp Sang Trọng Phong Cách Hàn Quốc",75000,75000,0,0
TIKI,tui-vi-nu,108254582,"Túi Thỏ Đeo Chéo Kiêm Balo Được Yêu Thích Nhất",85000,85000,0,0
TIKI,tui-vi-nu,99293451,"Ví nữ dài cầm tay 2 ngăn kéo sang trọng nhiều ngăn tiện dụng TK0044",76000,100000,24000,24
TIKI,tui-vi-nu,201182542,"Túi cói form to tha hồ đựng đồ, tha hồ sống ảo luôn nè",250000,250000,0,0
TIKI,tui-vi-nu,174468852,"Ví Nữ Mini Cầm Tay    Gấp 3 Nhỏ Gọn Nhiều Ngăn Tiện Dụng Da Cực Đẹp PFY11",129000,129000,0,0
TIKI,tui-vi-nu,146636285,"Túi Tote Canvas in hình Cún LiVing NeSa Shop, túi đeo chéo nữ, chất liệu vải canvas, phong cách trẻ trung",41900,41900,0,0
TIKI,tui-vi-nu,136759598,"Túi tote nữ, túi vải cá tính đừng vừa A4 - DAI MENG",56900,56900,0,0
TIKI,tui-vi-nu,2009411,"Túi Vải Tote Đeo Chéo Đeo Vai Đen XinhStore",50000,50000,0,0
TIKI,tui-vi-nu,116369289,"Quai túi xách gỗ làm túi Macrame",35200,35200,0,0
TIKI,tui-vi-nu,48089749,"Bóp ví cầm tay nữ Da  bò đẹp cao cấp ",229000,429000,200000,47
TIKI,tui-vi-nu,86561667,"Túi vải   Túi Đeo Chéo Canvas Cỡ Lớn Unisex Thời Trang Hàn Quốc Học Sinh Sinh Viên TV19",27900,27900,0,0
TIKI,tui-vi-nu,195329997,"Túi xách du lịch gấp gọn 2 tầng size đại nới đáy chất vải dù chống nước tiện lợi bền đẹp quai đeo chắc chắn đa năng - NGẨU NHIÊN",125000,125000,0,0
TIKI,tui-vi-nu,57495540,"Túi đeo chéo nam nữ thời trang phong cách Hàn Quốc Three Feather",89000,89000,0,0
TIKI,tui-vi-nu,149241417,"Túi Hộp Đeo Chéo Đính Ong TBL15",145000,198000,53000,27
TIKI,tui-vi-nu,251274972,"Túi cói nơ ren trắng đeo vai xinh xỉu",135000,135000,0,0
TIKI,tui-vi-nu,199554068,"Túi Vải Canvas Ông Bầu ",63000,63000,0,0
TIKI,tui-vi-nu,136940008,"Túi thổ cẩm quai gỗ 7001",50000,50000,0,0
TIKI,tui-vi-nu,153415968,"[GDSG31] Túi tote Happyhome [VẢI DÀY - TIỆN LỢI ]Túi tote Vải được thiết kế 2 dây đeo chéo phong cách Hàn Quốc cực HOT",54000,54000,0,0
TIKI,tui-vi-nu,160888146,"Khoen ore xoay Khoen mắt cáo có ren vặn 5, 7, 8.5, 10, 15mm Loại DÀY Bằng Đồng thau H65 Màu nguyên bản Phụ kiện túi xách",10000,10000,0,0
TIKI,tui-vi-nu,103459863,"Ví We Bare Bears",88000,88000,0,0
TIKI,tui-vi-nu,102809986,"Ví nữ cầm tay thời trang YUUMY YV22",179000,330000,151000,46
TIKI,tui-vi-nu,177727143,"Ví nữ gấp nhiều ngăn da bò thật vân hạt",650000,650000,0,0
TIKI,tui-vi-nu,141788350,"Túi Xách Nữ Đeo Chéo Quai Xách Cao Cấp NUTUSHOP - NT39",199000,199000,0,0
TIKI,tui-vi-nu,192881403,"Ví nữ cầm tay dáng đứng YUUMY Ripple YV75 - ngẫu nhiên",89000,190000,101000,53
TIKI,tui-vi-nu,32023338,"Túi Vải Đeo Vai Tote Bag 2 Thời Trang",45000,45000,0,0
TIKI,tui-thoi-trang-nam,126039327,"Bóp Đựng Thẻ ATM Nhỏ Gọn SUPPLE, Da Bò SMALL PEBBLE Mềm Mại - Bền Bỉ, Chống Xước - Chống Nhăn Tốt, Thiết Kế Hiện Đại, Ngăn Súp Lê Rộng, Đựng Được Nhiều Thẻ Ngân Hàng, Card Danh Thiếp, Căn Cước Công Dân, Dáng Đứng - Gập 2 – Hàng Chính Hãng SAIGIO",683000,699000,16000,2
TIKI,tui-vi-nu,97313622," Túi da đeo chéo MSTALLY đón trend 2021",34155,46678,12523,27
TIKI,tui-vi-nu,48506730,"Túi xách tay nữ thời trang đa năng LATA TX08 Nhiều màu",690000,690000,0,0
TIKI,tui-vi-nu,183336599,"Vỏ Bọc Passport, Hộ Chiếu Chống Thấm Nước G381-BOCPP",2999,2999,0,0
TIKI,tui-thoi-trang-nam,188997932,"Túi Đeo Chéo Nhiều Ngăn Chứa Cho Nam Nữ Cao Cấp Đi Chơi Chống Nước, Túi Đựng Điện Thoại Ipad, Túi Đeo Vai Thời Trang Sang Trọng Thời Thượng",135000,135000,0,0
TIKI,tui-thoi-trang-nam,260811551,"Túi da cao cấp Macsim mã MSN75",1540000,1540000,0,0
TIKI,tui-vi-nu,145593359,"Ví da cầm tay nhỏ gọn YUUMY Seasand YV42",79000,150000,71000,47
TIKI,tui-vi-nu,40750699,"Túi xách nữ công sở A4 phong cách Châu Âu",199000,199000,0,0
TIKI,tui-thoi-trang-nam,191820415,"Túi Đeo Chéo Nam Thể Thao US ARMY, Túi Đeo Bao Tử  Đeo Bụng Lính Mỹ Phong Cách Chất Vải Kaki Cao Cấp Chồng Nước Nhẹ - HÀNG CHÍNH HÃNG",98000,259000,161000,62
TIKI,tui-thoi-trang-nam,188997932,"Túi Đeo Chéo Nhiều Ngăn Chứa Cho Nam Nữ Cao Cấp Đi Chơi Chống Nước, Túi Đựng Điện Thoại Ipad, Túi Đeo Vai Thời Trang Sang Trọng Thời Thượng",135000,135000,0,0
TIKI,tui-thoi-trang-nam,76152029,"Ví Nam, Nữ Cầm Tay Cao Cấp VinBuy – Bóp Nam, Nữ Kiểu Dáng Sang Trọng Cao Cấp Dành Cho Doanh Nhân – Hàng Chính Hãng VinBuy",121000,250000,129000,52
TIKI,tui-vi-nu,48136526,"Ví nữ cầm tay dáng dài since 1988 chất da mịn",49000,49000,0,0
TIKI,tui-vi-nu,191297058,"Ví cầm tay nữ gấp 3 da bò thật Jeny",650000,650000,0,0
TIKI,tui-thoi-trang-nam,125290044,"Ví nam, bóp nam da bò Saffiano Bụi Leather V141 - Bảo hành 12 tháng",225000,435000,210000,48
TIKI,tui-vi-nu,133781795,"Túi đeo chéo ngang một bên vai. Túi đeo chéo nữ Forever Young Tua Rua Khuy Vuông, đựng điện thoại, tiền., nhỏ gọn, tiện dụng. Phong cách thời trang Hàn Quốc, sang chảnh, cá tính",149000,149000,0,0
TIKI,tui-vi-nu,68891749,"Ví dài cầm tay thời trang nữ YUUMY YV28 nhiều màu",99000,180000,81000,45
TIKI,tui-thoi-trang-nam,117401394,"Ví Đựng Thẻ ATM Mini, Da Bò Mềm Mại GENTLE, Da Thật 100%, Thiết Kế Hiện Đại, Nhiều Ngăn Tiện Dụng, Đựng Thẻ Ngân Hàng, Danh Thiếp, Căn Cước, Hình Lưu Niệm, Dáng Đứng - Gập 2 - Hàng Chính Hãng SAIGIO",629000,649000,20000,3
TIKI,tui-thoi-trang-nam,142813028,"Túi nam đeo chéo đi học, đi làm 2 màu DN275",169000,220000,51000,23
TIKI,tui-thoi-trang-nam,106699231,"Túi Đeo Chéo Nam Cao Cấp Chất Liệu Vải Dù Chống Thấm Nước,Túi Đeo Vai Phong Cách Thời Trang Hàn Quốc Dành Cho Người Đi Làm, Học Sinh, Sinh Viên,Người Đi Chơi, Đi Du Lịch",295000,295000,0,0
TIKI,tui-thoi-trang-nam,125290044,"Ví nam, bóp nam da bò Saffiano Bụi Leather V141 - Bảo hành 12 tháng",219000,435000,216000,50
TIKI,tui-thoi-trang-nam,174022359,"Ví Bóp Vải Canvas JOHZEON Kiểu Dáng Hàn Quốc Nhiều Ngăn Bền Bỉ Tiện Lợi DV100",68000,80000,12000,15
TIKI,tui-thoi-trang-nam,134040370,"Túi đeo chéo nam nữ thời trang BEE GEE 0127 để điện thoại ipad chống thấm nước đẹp chất lượng tốt",68000,138000,70000,51
TIKI,tui-vi-nu,252090516,"Túi Xách Nữ Đeo Chéo Da PU Siêu Sang, Túi Xách Nữ Thời Trang Form Cứng, Túi Đeo Chéo Nữ Hàn Quốc, Túi Xách Tay Có Kèm Dây Đeo Chéo - OTV229 - Ope Store",335000,335000,0,0
TIKI,tui-thoi-trang-nam,77741254,"Túi Đeo Hông Thời Trang Nam Nữ Cá Tính Túi Bao Tử Vải Dù Cao Cấp Đeo Chéo Nam Nữ Nhỏ Gọn Tiện Dụng TU17",38610,52767,14157,27
TIKI,tui-thoi-trang-nam,71023609,"Ví Da Nam, Bóp Da Nam Đựng Tiền Nhiều Ngăn Tiện Lợi - Mẫu Mới Dòng Cao Cấp Bogesi - Ví Nam Ngang - Kích Thước 10 x 1.5  x 12 cm",79000,79000,0,0
TIKI,tui-thoi-trang-nam,153912766,"Túi Đeo Chéo Nam Nữ U968 US ARMY, Túi Đeo Hông Tiện Dụng Chống Nước Vải Canvas Cao Cấp Phong Cách Lính -HÀNG CHÍNH HÃNG",80000,199000,119000,60
TIKI,tui-vi-nu,219461707,"Túi xách nữ màu đỏ đô da mềm",85000,85000,0,0
TIKI,tui-vi-nu,177557630,"Túi xách nữ da thật cao cấp 8225 TU",122000,910880,788880,87
TIKI,tui-thoi-trang-nam,260811611,"Túi da cao cấp Macsim mã MSTH29",2600000,2600000,0,0
TIKI,tui-vi-nu,5003163,"Túi Xách Nữ Thời Trang Cao Cấp Elly EL21",979300,1399000,419700,30
TIKI,tui-thoi-trang-nam,113760273,"Ví nam da bò cao cấp phong cách mới",387000,430000,43000,10
TIKI,tui-thoi-trang-nam,155330335,"Ví da nam, bóp da nam mini Bụi Leather V115 - Da bò Nappa cao cấp - Bảo hành 12 tháng",180000,278000,98000,35
TIKI,tui-thoi-trang-nam,72769110,"Ví Da Bò Nam KEIO NIPPON Cao Cấp Nhập Khẩu Italia, Khóa Kéo, Kích Thước 12x9,5cm DBNKK12",229000,229000,0,0
TIKI,tui-thoi-trang-nam,116726545,"Túi Đeo Chéo Grepaco Nam Nữ Unisex Vải Bố Canvas Tote Chống Nước Dạng Dây Đeo Vai Xách Đa Năng Đựng Điện Thoại Tiền Đi Học Du Lịch Thể Thao Size Mini Phong Cách Thời Trang Hàn Quốc",92000,99000,7000,7
TIKI,tui-vi-nu,191287987,"Ví nữ cầm tay dáng đứng YUUMY Ripple YV75",89000,190000,101000,53
TIKI,tui-thoi-trang-nam,124966188,"Ví nam, bóp nam da bò sáp Mexico Bụi Leather V102 - Bảo hành 12 tháng",200000,370000,170000,46
TIKI,tui-thoi-trang-nam,48256263,"Ví Nam Da Bò KEIO NIPPON Cao Cấp Kiểu Ngang | Bóp Da Bò Nam Ngang Cánh Lật",249000,249000,0,0
TIKI,tui-thoi-trang-nam,127551391,"Túi đeo chéo Black Rice vải canvas bền bỉ phong cách thòi trang unisex nam nữ Hàn",105000,210000,105000,50
TIKI,tui-thoi-trang-nam,131337754,"Túi đeo chéo phiên bản Hàn Quốc đeo chéo một vai đeo ngực, cưỡi ngựa leo núi ngoài trời",32670,44649,11979,27
TIKI,tui-thoi-trang-nam,169279392,"ví nam AD14, ví sen mini cao cấp, bóp nam da bò thật nguyên tấm , ví da nam nhỏ gọn thiết kế đơn giản tiện dụng, bảo hành da 06 tháng - Adonis Store",159000,269000,110000,41
TIKI,tui-thoi-trang-nam,146618296,"Bóp Da Đựng Thẻ ATM Nhỏ Gọn, Chất Da Pull-Up Mềm Mại, Trẻ Trung - Cá Tính, Thiết Kế Hiện Đại, Nhiều Ngăn Tiện Dụng, Đựng Thẻ Ngân Hàng, Card Danh Thiếp, Căn Cước Công Dân, Hình Lưu Niệm, Dáng Đứng - Gập 2 - Hàng Chính Hãng SAIGIO",779000,799000,20000,3
TIKI,tui-thoi-trang-nam,253171976,"Ví nam 100% da thật thông minh siêu mỏng thời trang cao cấp phong cách cá tính",351000,390000,39000,10
TIKI,tui-thoi-trang-nam,193289594,"Túi Đeo Chéo Nam Nữ Cao Cấp Vải Nylon Nhiều Ngăn Chống Thấm Nước, Túi Đeo Vai Phong Cách Thời Trang Hàn Quốc, Túi Đựng Điện Thoại Đa Năng",130000,130000,0,0
TIKI,tui-thoi-trang-nam,110182282,"Túi Đeo Chéo Nam Phong Cách Lính U448 US ARMY Vải Dệt Cao Cấp -Hàng Chính Hãng",111000,290000,179000,62
TIKI,tui-thoi-trang-nam,124966188,"Ví nam, bóp nam da bò sáp Mexico Bụi Leather V102 - Bảo hành 12 tháng",200000,370000,170000,46
TIKI,tui-thoi-trang-nam,194859087,"ví nam Cef03, bóp nam cefiro logo tộc trưởng da bò cao cấp, ví da nam ví đứng thiết kế nhiều ngăn đựng tiền đựng thẻ, bảo hành da 6 tháng - Adonis",169000,269000,100000,37
TIKI,tui-thoi-trang-nam,141474172,"Túi đeo chéo, đeo vai nhiều ngăn vải Oxford cao cấp chống thấm nước, bền bỉ unisex nam nữ phong cách thời trang, cá tính",85000,180000,95000,53
TIKI,tui-thoi-trang-nam,197879894,"Bóp Đứng Nam Nhỏ Gọn, Chất Liệu Da Bò PULL-UP Mềm Mại, Mỏng Nhẹ, Phong Cách Hiện Đại - Cá Tính, Size Trung, Dáng Đứng - Gập 2, Nhiều Ngăn Để Tiền Và Giấy Tờ Tiện Dụng",982000,999000,17000,2
TIKI,tui-thoi-trang-nam,169277360,"ví nam AD12, bóp nam da bò saffiano cao cấp, ví da nam ví ngang thiết kế nhiều ngăn nhỏ gọn thời trang, bảo hành da 6 tháng - Adonis Store",185000,289000,104000,36
TIKI,tui-thoi-trang-nam,127553838,"Túi đeo chéo Basic chống nước, tích hợp dây sạc USB unisex nam nữ phong cách thời trang",125000,250000,125000,50
TIKI,tui-thoi-trang-nam,82372883,"Túi đeo chéo nam cao cấp phong cách mới",297000,330000,33000,10
TIKI,tui-thoi-trang-nam,115500712,"Ví nam AD01, bóp nam da thật, ví da nam ví đứng nhiều ngăn đựng tiền đựng thẻ tiện dụng chất",145000,145000,0,0
TIKI,tui-thoi-trang-nam,77746659,"Túi đeo chéo nam vải canvas cao cấp phong cách mới",359000,398000,39000,10
TIKI,tui-thoi-trang-nam,710785,"Túi Đeo Chéo Nam HARAS HRTK083 (26 x 16.5 cm) - Đen",100000,100000,0,0
TIKI,tui-thoi-trang-nam,56852299,"Ví Nam Da Bò 4U Dáng Đứng Thời Trang FB241",169000,190000,21000,11
TIKI,tui-thoi-trang-nam,81112510,"Túi đeo hông, đeo bụng nam, nữ chạy bộ thể thao",32670,47190,14520,31
TIKI,tui-thoi-trang-nam,105660567,"Túi đeo chéo nam nữ mini đựng điện thoại phong cách thời trang Hàn Quốc - Túi xách chống nước đi du lịch, đi chơi",69000,69000,0,0
TIKI,tui-thoi-trang-nam,161954337,"Ví nam JOHZEON kiểu dáng hàn quốc nhiều ngăn có ngăn khoá kéo",72500,72500,0,0
TIKI,tui-vi-nu,134666856,"Túi đeo chéo da nữ khóa nhấn Yuumy Seasand YN99",319000,550000,231000,42
TIKI,tui-thoi-trang-nam,68522324,"Cặp công sở đa năng TRITA TCA10 nhiều màu",359000,660000,301000,46
TIKI,tui-thoi-trang-nam,244316262,"Ví nam đựng tiền đựng chìa khóa đựng thẻ đa năng 100% da bò thật cao cấp phong cách mới",333000,370000,37000,10
TIKI,tui-vi-nu,102810102," Ví nữ cầm tay thời trang YUUMY YV12 nhiều màu",59000,80000,21000,26
TIKI,tui-thoi-trang-nam,115663661,"Ví nam AD04, bóp nam da thật, ví da nam ví đứng 18 ngăn đựng tiền đựng thẻ, chất",299000,419000,120000,29
TIKI,tui-vi-nu,178783614,"Túi xách nữ công sở chất da pu đeo vai size lớn đi làm  thời trang hàn quốc cao cấp TX04",129000,129000,0,0
TIKI,tui-thoi-trang-nam,115712587,"Túi Đeo Chéo Nam Cao Cấp Phong Cách Châu Âu Với Thiết Kế Kinh Điển Không Bao Giờ Lỗi Mốt, Chất Liệu Vải Oxford Chống Nhăn, Chống Nước, Chống Bám Bụi Bẩn,Túi Đeo Vai Phong Cách Thể Thao Đường Phố",219000,219000,0,0
TIKI,tui-thoi-trang-nam,72724925,"Ví Nam Vân Cá Sấu KEIO NIPPON Da Bò Nhập Khẩu Italia, Kích thước 12x9.5 cm, Khóa Kéo DBVCS12",249000,249000,0,0
TIKI,tui-thoi-trang-nam,79691242,"Ví Thẻ Tín Dụng, Bóp Đựng Thẻ Tín Dụng, Bóp Hộp Kim Loại Đựng Thẻ Tín Dụng Tự Động, Ví Nam Denim Có Hộp Đựng Thẻ TOPEE VNH26",278000,278000,0,0
TIKI,tui-vi-nu,106948689,"Túi xách  túi đeo vai nữ thời trang cao cấp phong cách mới",315000,350000,35000,10
TIKI,tui-thoi-trang-nam,71178009,"Túi Đeo Chéo Canvas Messenger Ipad Oxford Cao Cấp Màu Đen Có Dây Kéo Và Ngăn Phụ Trong Ngoài Thời Trang Cá Tính",89000,99000,10000,10
TIKI,tui-vi-nu,132078385,"Túi Đeo Chéo T19 Mẫu Mới Khóa Trái Tim- Vàng Nhạt",136000,198000,62000,31
TIKI,tui-thoi-trang-nam,260811608,"Túi xách - Túi da cao cấp Macsim mã MSTH25",1540000,1540000,0,0
TIKI,tui-thoi-trang-nam,130439350,"Ví nam mini AD08, bóp nam nhỏ gọn, ví da nam thủ công làm từ da bò  nguyên tấm, bóp da dáng ngang siêu đẹp nhiều ngăn tiện lợi",179000,279000,100000,36
TIKI,tui-thoi-trang-nam,185991219,"Túi đeo chéo nam đa năng cao cấp phong cách mới",333000,370000,37000,10
TIKI,tui-vi-nu,103660156,"Túi xách nữ thời trang cao cấp phong cách châu âu",351000,390000,39000,10
TIKI,tui-thoi-trang-nam,250111755,"Túi Đeo Chéo Nam 4U Da Tổng Hợp Cao Cấp D267",149000,175000,26000,15
TIKI,tui-vi-nu,147264971,"Ví Đựng Thẻ ATM Cao Cấp Slim CITIZEN, Da Bò Tự Nhiên Cao Cấp, Da Thuộc Thảo Mộc, Nhập Khẩu Từ Châu Âu, Nhỏ Gọn - Hiện Đại - Chuyên Nghiệp, Đựng Tiền, Thẻ Ngân Hàng, Card Danh Thiếp - Hàng Chính Hãng SAIGIO",2079000,2099000,20000,1
TIKI,tui-vi-nu,8173385,"Ví bóp tiền nữ Nút bấm hoa nhiều cánh phong cách cổ kính",155000,155000,0,0
TIKI,tui-vi-nu,109710949,"Túi cói merci loại 1 màu sáng, có đệm đáy giữ form túi, có lót",45000,51930,6930,13
TIKI,tui-vi-nu,25110038,"Vỏ Bọc Hộ Chiếu Du Lịch Có Khe Nhét Thẻ Tiện Dụng",2999,2999,0,0
TIKI,tui-vi-nu,160314498,"Ví Nữ Mini Cầm Tay Hàng Hiệu TAILIAN Đựng Tiền Đựng Thẻ Da Cao Cấp Nhiều Ngăn Tiện Dụng Đẹp Giá Rẻ TL04 - Micocah Mall",99000,99000,0,0
TIKI,tui-vi-nu,161964666,"Túi đeo nữ thời trang cao cấp",225000,225000,0,0
TIKI,tui-vi-nu,180720264,"Túi Xách Thời Trang Nữ Da Thật Cao Cấp Gence TX04",1650000,1650000,0,0
TIKI,tui-vi-nu,148967272,"Túi cói Merci sang chảnh",39499,39499,0,0
TIKI,tui-vi-nu,120538387,"HC6255-56-57-58 - Túi đeo nữ da cá sấu Huy Hoàng màu đen, nâu đỏ, vàng bò, nâu đất",3499000,3499000,0,0
TIKI,tui-vi-nu,144065762,"túi xách nhung hộp mần xui cao cấp- túi cầm tay nhung hộp đính hoa đá đi tiệc cao cấp( ảnh thật )",399000,399000,0,0
TIKI,tui-vi-nu,171648720,"Túi Xách Nữ Đeo Chéo Hình Gấu Dễ Thương, Túi Đeo Vai Nữ Học Sinh Đi Học, Đi Chơi Nhiều Màu - OTV118 - Ope Store",193000,193000,0,0
TIKI,tui-vi-nu,248715249,"Túi đeo chéo mini nữ trẻ trung thời trang phong cách Hàn Quốc",119000,119000,0,0
TIKI,tui-vi-nu,34943636,"Túi vải Bơ đi mà sống",140000,140000,0,0
TIKI,tui-vi-nu,137154005,"Túi Tote Vải Canvas Stay At Home Có Khóa Miệng Túi",35000,35000,0,0
TIKI,tui-vi-nu,149449531,"Túi CEEKAY 2021 - Túi xách nữ cao cấp hàng chính hãng Fullbox",546000,546000,0,0
TIKI,tui-vi-nu,160314394,"Ví Bóp Nữ Mini Cầm Tay FOREVER YOUNG Đựng Tiền Nhiều Ngăn Tiện Dụng Chất Da Xước Cao Cấp Cực Đẹp FY49 - Micocah Mall",149000,149000,0,0
TIKI,tui-vi-nu,182713289,"Ví nữ Monogram Canvas ELLY – EV89",599400,999000,399600,40
TIKI,tui-vi-nu,102576041,"Túi Đeo Chéo Thời Trang Hàn Quốc HARAS HR281",100000,100000,0,0
TIKI,tui-vi-nu,176661865,"Túi xách đính đá thời trang nữ",439000,439000,0,0
TIKI,tui-vi-nu,56421161,"Túi đeo chéo vai nữ nhiều mẫu hình thời trang cao cấp KS51",53460,73062,19602,27
TIKI,tui-vi-nu,249914629,"Ví cầm tay nữ gấp nhiều ngăn da bò Epsom nhập khẩu, vừa GPLX cũ, thẻ BHYT - Pink Ohara",650000,650000,0,0
TIKI,balo-va-vali,151696872,"Balo đựng Laptop thương hiệu TARGUS dòng Newport Ultra Slim",2390000,2390000,0,0
TIKI,tui-vi-nu,200651557,"Túi đeo chéo da nữ khóa nhấn hình thoi Lata HN97",590000,590000,0,0
TIKI,tui-vi-nu,273205303,"Vascara Túi Tote Minimalism Nhấn Quai Bản Dài - TOT 0146",1026000,1026000,0,0
TIKI,tui-vi-nu,160315109,"Ví Bóp Nữ Dài Cầm Tay FOREVER YOUNG Phong Cách Hàn Quốc Siêu Đẹp Nhiều Ngăn Tiện Dụng FY54 - Micocah Mall",149000,149000,0,0
TIKI,tui-vi-nu,132078384,"Túi Đeo Chéo Khóa Gài T22 Caro Trắng",136000,195600,59600,30
TIKI,balo-va-vali,173483855,"Túi đeo chéo chống va đập TOMTOC (USA) EVA - A25-E01 cho Macbook Pro 16 inch",1079100,1199000,119900,10
TIKI,tui-vi-nu,200016856,"Ví vải thổ cẩm/vải thêu dây cầm gắn hạt xinh xắn (ảnh thật)",20000,20000,0,0
TIKI,tui-vi-nu,69470828,"Túi Xách Nữ Đẹp Đeo Chéo Kiểu Dáng Đơn Giản Basic, Túi Vải Canvas Đeo Chéo Kích Thước Lớn Tiện Dụng - OTV064 - Ope Store",144000,144000,0,0
TIKI,balo-va-vali,184332126,"Balo Nữ Thời Trang Solo Austin Hybrid 13.3 Black",1272000,1590000,318000,20
TIKI,tui-vi-nu,176535891,"[SGFS-T55] Túi tote Vải canvas mềm Đẹp Cực Hot đựng vừa a4 [CÓ SẴN][XINH XẮN] Túi vải xinh hình",85000,85000,0,0
TIKI,balo-va-vali,71670941,"Balo laptop Mr Vui BLLT 610 14 inch dành cho nam và nữ",377000,445000,68000,15
TIKI,balo-va-vali,4049363,"Balo laptop Mikkor The Nomad Premier Backpack",590000,590000,0,0
TIKI,tui-vi-nu,32454277,"Túi bao tử đeo chéo hip hop, sành điệu cao cấp cho bạn nam và nữ",120000,120000,0,0
TIKI,balo-va-vali,4613661,"Túi chống sốc Ipad Pro 9.7inch họa tiết hoa văn",179000,179000,0,0
TIKI,balo-va-vali,185003743,"Balo Ipad Laptop 14 Inch - Balo Công Sở Tích Hợp Ổ Cắm USB",162000,180000,18000,10
TIKI,tui-vi-nu,176453886,"Túi xách đính đá thời trang nữ",329000,329000,0,0
TIKI,balo-va-vali,164075681,"Balo thời trang phong cách đơn giản cá tính KBN006 - chống nước, đựng laptop 15.6inch",287280,399000,111720,28
TIKI,balo-va-vali,183570197,"Túi Đựng Quần Áo Choi Golf Da Bò Thật Cao Cấp, Vân Quả Trám Nhãn Hiệu Da Manđini Phiên Bản Mới 2022, Sản xuất Tại Việt Nam , Có Ngăn Để Giày Giá Tốt",2800000,2800000,0,0
TIKI,balo-va-vali,14080572,"Balo Level 3 PUBG HANAMA BL399",59000,59000,0,0
TIKI,balo-va-vali,114696474,"Túi Bạt Dứa Đựng Chăn Màn Tiện Lợi, đồ tiện dụng trong nhà ️️ Sản Phẩm Full Size Cho Nhiều Mục Đích Sử Dụng",26000,26000,0,0
TIKI,tui-vi-nu,149449660,"( MỚI) Túi xách nữ đeo chéo ô Trám khóa xoay - Hàng cao cấp da sịn",464000,464000,0,0
TIKI,tui-vi-nu,172192207,"Túi nữ thời trang phong cách Hàn Quốc Thành Long TLG  208111 3(xám)  Tặng túi đựng bút tiện lợi",30000,30000,0,0
TIKI,balo-va-vali,75759447,"Balo Túi Xách Du Lịch KhoNCC Hàng Chính Hãng - Loại Cỡ Lớn Nhiều Ngăn Bằng Vải Dù Cho Du Lịch – Phượt Thủ – KKT-BL-1833D (Nhiều màu)",249000,328000,79000,24
TIKI,balo-va-vali,85376355,"Túi trống đa năng du lịch cỡ lớn Butan Tặng túi đựng điện thoại chống nước khổ lớn",292050,399135,107085,27
TIKI,balo-va-vali,25662032,"Balo Laptop Reeyee RY1018",1155000,1155000,0,0
TIKI,tui-vi-nu,53782142,"Túi đeo chéo chống shock để ipad nam nữ unisex Hàn quốc thời trang BEE GEE 078 hot trend 2020",45000,90000,45000,50
TIKI,tui-vi-nu,181096767,"Túi xách nữ MONOGRAM CANVAS ELLY – EL204",999500,1999000,999500,50
TIKI,tui-vi-nu,86561311," Túi xách nữ    Túi đeo chéo mini dây xích SANG CHẢNH TD18",78000,78000,0,0
TIKI,balo-va-vali,181786500,"Túi chiến thuật rằn ri đi hành quân, dã ngoại, thao trường cho bộ đội",80000,80000,0,0
TIKI,balo-va-vali,102066729,"Balo Túi Xách Du Lịch Đa Năng",239000,249000,10000,4
TIKI,tui-vi-nu,114697216,"Túi đeo chéo nữ cao cấp, đựng điện thoại tiện dụng, túi đeo chéo nữ mini 2 ngăn nhỏ gọn đẹp, thời trang, cá tính giá rẻ",159000,159000,0,0
TIKI,balo-va-vali,145620844,"MTS0A - 16x14 cm - 25 Túi chống sốc bọc bóng khí",34250,34250,0,0
TIKI,balo-va-vali,45075156,"[Cực hót] Túi du lịch size đại cao cấp đa năng dành cho nam nữ - M.Xanh dương",179000,179000,0,0
TIKI,balo-va-vali,183041621,"Balo laptop đi học học sinh nam nữ chữ supreme (cỡ trung)",79000,79000,0,0
TIKI,tui-vi-nu,13407051,"Túi Bao Tử Đeo Chéo Apehlic Phong Cách Hàn P948 Parisa",77000,77000,0,0
TIKI,balo-va-vali,191777799,"Balo đi học ullzang không thấm nước phong cách Hàn Quốc thời trang học sinh, sinh viên tặng sticker TN282",159000,159000,0,0
TIKI,balo-va-vali,49124279,"Balo Laptop 15.6 Chính Hãng Kim Long KL024",381750,509000,127250,25
TIKI,voucher-dich-vu,162400267,"Reading Gate - ứng dụng đọc sách học tiếng anh đa nền tảng web/ Android/ IOS (Gói 12 tháng)",7200000,7200000,0,0
TIKI,balo-va-vali,22098705,"Balo Chiến Thuật thời trang X7",380000,380000,0,0
TIKI,balo-va-vali,115522094,"TÚI CHỐNG SỐC TOMTOC (USA) STYLE CHO MACBOOK AIR/RETINA 13” - 13.3”  - A18 - HÀNG CHÍNH HÃNG",719000,719000,0,0
TIKI,tui-vi-nu,79844409," Khăn Turban (Khăn Quấn Túi Xách) Cao Cấp Chất Lụa Satin - 5x90cm - Mã TD000",20900,20900,0,0
TIKI,balo-va-vali,172498587,"Balo Mini Nữ Thời Trang Da cao cấp thời trang HÀN QUỐC – BEE GEE BLNN9013",371000,750000,379000,51
TIKI,voucher-dich-vu,187645495,"Sách nói: Khởi Nghiệp Kinh Doanh Online - Bán Hàng Hiệu Quả Trên S.h.o.p.e.e",99000,99000,0,0
TIKI,balo-va-vali,7771325,"Túi Chống Sốc Laptop SimpleCarry LCF16",240000,240000,0,0
TIKI,balo-va-vali,272165583,"Balo nam nữ, balo đựng máy tính, balo du lịch, balo đi học",300000,300000,0,0
TIKI,voucher-dich-vu,122501460,"[E-BOOK] i-Learn Smart Start English for Science 2 Sách mềm sách học sinh",15000,15000,0,0
TIKI,tui-vi-nu,128869210,"TÚI XÁCH NỮ CAO CẤP DA THẬT ELLY – ET122",1624350,2499000,874650,35
TIKI,tui-vi-nu,155013613,"Túi Xách Nữ, Túi Đeo Tréo Nữ Trẻ Trung Duyên Dáng, Nhiều Màu Sắc Cực Kì Dễ Phối Màu MÃ: LFFSH03",99000,99000,0,0
TIKI,balo-va-vali,166416666,"Balo đeo chéo nữ hình búp bê chất vải bông siêu dễ thương mẫu mới nhất",119000,119000,0,0
TIKI,tui-vi-nu,75183422,"Túi Xách Nữ Kẹp Nách Hàn Quốc Vân Cá Sấu Xinh Xắn Đi Chơi Dạo Phố D169",55000,55000,0,0
TIKI,voucher-dich-vu,188586115,"[EVoucher Vietravel ] Sapa - Bản Cát Cát - Fansipan - Ninh Bình - Tràng An - Bái Đính - Tuyệt Tịnh Cốc - Hạ Long - Đảo Titốp - Yên Tử",11990000,11990000,0,0
TIKI,balo-va-vali,171437391,"Túi Đựng Mỹ Phẩm Du Lịch Hàn Quốc dây rút, chống thấm xếp gọn, đồ trang điểm, make up, dầu gội, sữa tắm trong vali",79000,79000,0,0
TIKI,tui-vi-nu,180994096,"Túi xách vải Túi Vải Nữ Túi Đeo Chéo Hàn Quốc Gấu bông dễ thương",158000,320000,162000,51
TIKI,balo-va-vali,160314954,"Balo Nữ Mini Thời Trang MICOCAH Đi Học Đi Chơi Phong Cách Hàn Quốc Sang Chảnh Chất Da Cao Cấp Cực Đẹp Giá Rẻ MC19",389000,389000,0,0
TIKI,tui-vi-nu,203995260,"Túi Xách Nữ, Túi Đeo Chéo Nữ Cao Cấp Da Thêu Một Mảnh Đi Chơi, Đi Tiệc Phong Cách Hàn Quốc",90000,90000,0,0
TIKI,balo-va-vali,7430547,"Balo Mikkor The Edwin Backpack Navy 15,6inch",690000,690000,0,0
TIKI,voucher-dich-vu,80901693,"Sách nói Fonos: Dạy Con Làm Giàu (Tập 2): Sử dụng đồng vốn để được thoải mái về tiền bạc",99000,99000,0,0
TIKI,balo-va-vali,195660462,"Dây Đeo Mắt Kính Acrylic Chống Thất Lạc Đa Năng Họa Tiết Doraemon,Doraemi",35000,35000,0,0
TIKI,tui-vi-nu,197163833,"Túi đeo chéo khóa xoay Yuumy Seasand YN142",345000,650000,305000,47
TIKI,balo-va-vali,136431019,"10 Vỏ bọc bảo quản thẻ cccd atm, thẻ sinh viên... nhựa dẻo trong suốt",14999,14999,0,0
TIKI,tui-vi-nu,107962694,"Ví Da Nữ Mini Handmade Tuyệt Phẩm Quý Cô Sành Điệu",276000,276000,0,0
TIKI,voucher-dich-vu,182821803,"Gói xét nghiệm chẩn đoán viêm gan B",200000,200000,0,0
TIKI,tui-vi-nu,114119921,"Túi Xách Nữ Công Sở thời trang hàn quốc 2021 - TÚI TOTE - TÚI A4 -TÚI BIGSIZE",199500,199500,0,0
TIKI,tui-vi-nu,91421816,"Ví We Bare Bears",127000,127000,0,0
TIKI,voucher-dich-vu,252583823,"[Voucher 12 tháng] Bộ công cụ Học - Thi - Hướng nghiệp lớp 4, VitanEdu",375000,375000,0,0
TIKI,tui-vi-nu,100298409,"Ví mini cầm tay dành cho nam nữ unisex nhiều ngăn nhỏ gọn da pu",40000,40000,0,0
TIKI,voucher-dich-vu,186317680,"Gói nghỉ dưỡng 3N2Đ dành cho 02 khách. Tại Wyndham Garden Hanoi 4*: 2 đêm nghỉ, 1 bữa tối Hàn quốc, 1 bữa tối BBQ Buffet, 30 phút trị liệu spa…",4900000,4900000,0,0
TIKI,voucher-dich-vu,195962505,"[Evoucher - NSG] DU LỊCH ÚC: SYDNEY - MELBOURNE",43090000,43090000,0,0
TIKI,tui-vi-nu,129819243,"Túi đeo chéo, túi đeo vai nữ vải canvas TV11, chất vải canvas siêu bền đẹp, hàng nhập Quảng Châu",50000,50000,0,0
TIKI,voucher-dich-vu,149429816,"2 NGÀY 1 ĐÊM NGHỈ DƯỠNG TIẾT KIỆM KHÁCH SẠN CAO CẤP PARADISE SUITES",1100000,1100000,0,0
TIKI,balo-va-vali,190519964,"Balo Laptop Mr.Vui BLLT884 ngăn laptop 15.6 inch (33 x 45 x 20 cm)",565200,628000,62800,10
TIKI,balo-va-vali,13742821,"Túi Chống Sốc Laptop Shyiaes Cao Cấp - Màu Đỏ",103000,103000,0,0
TIKI,voucher-dich-vu,222680667,"Phiếu Quà Tặng JiangHu Heroes' Hotpot 200K",200000,200000,0,0
TIKI,voucher-dich-vu,207946154,"Phiếu Quà Tặng Dynasty House 200K",200000,200000,0,0
TIKI,balo-va-vali,6906203,"Túi đựng đồ lót khi đi du lịch nhiều ngăn không thấm nước thiết kế thời trang gọn nhẹ phong cách Hàn Quốc - Hàng nhập khẩu",86400,86400,0,0
TIKI,tui-vi-nu,93950153,"Ví Đựng Thẻ Card Holder Da Thật Genuine Leather Kiểu Dáng Thanh Lịch Aaa Jeans",189000,189000,0,0
TIKI,voucher-dich-vu,184318342," [EVoucher Vietravel] Quy Nhơn - Phú Yên - Eo Gió - Kỳ Co - Hòn Khô",5390000,5390000,0,0
TIKI,balo-va-vali,54014120,"Balo Laptop Mikkor The Eli",649000,649000,0,0
TIKI,tui-vi-nu,121332099,"Dây đai dệt trắng, dây quai túi xách 2.5 cm/ cuộn 10 mét",20000,20000,0,0
TIKI,balo-va-vali,144404327,"Balo kiêm Túi đeo Du lịch VLQUE, Đa năng, Chống thấm Nước, Có Ngăn để Giày, Đựng đồ ướt, Dày dặn, Thời trang",250000,250000,0,0
TIKI,voucher-dich-vu,248401533,"[Tài Chính Cá Nhân Dành Cho Người Việt Nam] Voiz FM - Voucher nghe Sách Nói",99000,120000,21000,18
TIKI,voucher-dich-vu,56031281,"Cua Hấp Bia Tại Nhà Hàng Cua Ngon",400000,400000,0,0
TIKI,tui-vi-nu,102109461,"Túi xách nữ - Túi nữ cầm tay có quai đeo MS002",284050,299000,14950,5
TIKI,voucher-dich-vu,56599979,"Combo lấy nhân mụn phương pháp độc quyền không đau tại Dory Beauty Spa",109000,109000,0,0
TIKI,tui-vi-nu,12129349,"Túi đeo chéo nữ",120000,120000,0,0
TIKI,voucher-dich-vu,229973608,"Phiếu Quà Tặng Potico 400K",400000,400000,0,0
TIKI,tui-vi-nu,72069933,"Túi xách nữ thời trang da bò nguyên miếng cao cấp xách tay hoặc đeo vai phong cách châu Âu- Phiên bản giới hạn HGG002",1450000,1450000,0,0
TIKI,tui-vi-nu,196423976,"Túi cói form to đơn giản",159000,159000,0,0
TIKI,tui-vi-nu,157253957,"Móc Khóa Ngựa Horshy SAIGON SWAGGER SGS Horshy Keyring",49000,49000,0,0
TIKI,voucher-dich-vu,87937530,"Vyoga World - Gói Tập 01 Tháng Yoga Bầu",950000,950000,0,0
TIKI,voucher-dich-vu,155923812,"HCM [E-voucher] Giảm 30K Giặt Hấp Vest, Blazer, Váy, Đầm, Áo Quần khác - giao nhận tận nơi tại ứng dụng HERAMO",30000,30000,0,0
TIKI,tui-vi-nu,180720932,"Túi Xách Thời Trang Nữ Da Thật Cao Cấp Gence TX012",1600000,1600000,0,0
TIKI,tui-vi-nu,189648753,"Túi xách nữ da bò công sở Gence TX08 màu đen",1760000,1760000,0,0
TIKI,voucher-dich-vu,244132974,"[E-Voucher] Tour Cần Thơ Cà Mau An Giang 3 ngày 2 đêm",3050000,3050000,0,0
TIKI,tui-vi-nu,32223565,"Túi Vải Canvas Mắt Biếc",63000,70000,7000,10
TIKI,voucher-dich-vu,182832440,"Sách nói: Một Nửa Của 13 Là 8",99000,99000,0,0
TIKI,tui-vi-nu,270141474,"Túi Gấu Bông Gòn Xách Tay Đeo Chéo, Túi Xách Đeo Chéo Gấu Nhồi Bông Hoạt Hình",69000,69000,0,0
TIKI,tui-vi-nu,72863370,"Túi Vải Trơn Tote Canvas Dùng Đi Chợ Gady's Shop",25000,25000,0,0
TIKI,voucher-dich-vu,221818509,"[E-Voucher] Vietourist - Tour Du Lịch Tây Ninh: Núi Bà Đen - Thánh Địa Đạo Cao Đài",790000,790000,0,0
TIKI,tui-vi-nu,93291190,"Marhen.J - Dây đeo túi xách bản rộng Signature F MJ20DSSTFW-IV",990000,990000,0,0
TIKI,tui-vi-nu,147197949,"Túi Hậu Môn Nhân Tạo 2 Mảnh- Hollister (Trong, Sử Dụng Kẹp), 18102 / 18103 / 18104 -VT0435",46000,46000,0,0
TIKI,voucher-dich-vu,34589893,"Khóa Học Hoạch Định Chiến Lược, Tư Vấn Và Triển Khai ERP",19000000,19000000,0,0
TIKI,balo-va-vali,74445487,"( XEM VIDEO ) Balo nam nữ thời trang Hàn quốc BEE GEE 115 chống thấm nước dày dặn và chống shock laptop tốt ( hộp dưới 2 dây kéo )",296000,598000,302000,51
TIKI,voucher-dich-vu,131506242,"Video bài giảng trực tuyến Kỹ năng tổ chức hội nghị, hội họp và đi công tác",50000,50000,0,0
TIKI,voucher-dich-vu,188230535,"Ebook: Làm thế nào để kiếm 100 triệu đầu tiên trên Internet",298000,298000,0,0
TIKI,voucher-dich-vu,198463635,"Tour Du lịch Miền Bắc 4N3D (LT8): Nội Bài - Hà Nội - Vịnh Hạ Long - Sapa - Fansipan, Khởi hành Hằng ngày",3949000,3949000,0,0
TIKI,tui-vi-nu,76108598,"Ví nữ cầm tay HANHSON SP000705 Đen logo vàng",1050000,1050000,0,0
TIKI,voucher-dich-vu,155742754,"Sách nói: Học Khôn Ngoan Mà Không Gian Nan",99000,99000,0,0
TIKI,voucher-dich-vu,19694062,"Khám Phụ Khoa Nữ Có Gia Đình - HPV Cobas - Phòng Khám Careplus",1900000,1900000,0,0
TIKI,voucher-dich-vu,128250890,"Jinro BBQ - Phiếu Quà Tặng 50K",48500,50000,1500,3
TIKI,voucher-dich-vu,174643297,"Điện Di Vitamin C mờ thâm, trắng sáng mịn màng (60 phút)",99000,99000,0,0
TIKI,voucher-dich-vu,185858956,"Tranh 3D Koifish cho hồ cá cảnh, các kích thước, theo yêu cầu",57000,57000,0,0
TIKI,tui-vi-nu,71509879,"Túi xách nữ thời trang cao cấp ELLY- EL154",1399000,1399000,0,0
TIKI,tui-vi-nu,96670026,"   Túi đựng điện thoại đeo chéo handmade - thời trang, trẻ trung  ",175500,175500,0,0
TIKI,tui-vi-nu,106975120,"Bộ đôi túi canvas phối da Đồ Da Thành Long TLG cho nàng và chàng 208089 (Xanh-)",68800,84100,15300,18
TIKI,voucher-dich-vu,132184336,"[E-BOOK] CYLET Practice Tests Pre A1 Starters File nghe Audio",10000,10000,0,0
TIKI,voucher-dich-vu,252135736,"Gói 2N1Đ - Du Thuyền 5 Sao Ambassador  Đẳng Cấp Nhất Vịnh Hạ Long - Nghỉ Dưỡng Trọn Gói Dành Cho 02 Người Lớn & 01 Trẻ Em Dưới 5 Tuổi (Miễn Phí Setup Sinh Nhật, Honey Moon, Kỷ Niệm Cưới)",2590000,2590000,0,0
TIKI,balo-va-vali,118843945,"Túi đựng mỹ phẩm toiletry cao cấp",120000,120000,0,0
TIKI,voucher-dich-vu,253232326,"À La Carte Hạ Long Bay Hotel & Residence 5* - Gồm Bữa Sáng, Nghỉ Dưỡng Đẳng Cấp Bên Bờ Biển, Hồ Bơi Vô Cực View Vịnh, Mới Khai Trương",1499000,1499000,0,0
TIKI,tui-vi-nu,136940212,"TÚI THỔ CẨM THÁI(COMBO 4 MÓN CON CÚ TÍM)",100000,100000,0,0
TIKI,voucher-dich-vu,34589891,"Khóa Học Scrum Master Trong Dự Án - Luyện Thi PSMI",5510000,5510000,0,0
TIKI,tui-vi-nu,86561986," Ví Nữ Mini Cầm Tay FOREVER YOUNG Phong Cách Hàn Quốc Siêu Đẹp, Giá Rẻ V02835",31000,31000,0,0
TIKI,voucher-dich-vu,157943089,"HCM [E-voucher] Gói 2 lần Giặt Sấy Áo Quần - giao nhận tận nơi tại ứng dụng HERAMO",169000,169000,0,0
TIKI,voucher-dich-vu,204413500,"T5. NGẮM HOÀNG HÔN VÀ CÂU MỰC ĐÊM - PHÚ QUỐC",330000,330000,0,0
TIKI,tui-vi-nu,2406109,"Ví Nhỏ Xinh Xắn Hựu Tâm Shop VNXXTI (11 x 9 cm)",80000,80000,0,0
TIKI,voucher-dich-vu,160149123,"Sinh Trắc Vân Tay Gen Talents – Combo Gia đình 2 – 3 Bài Báo Cáo Đầy Đủ 4 Module – Tặng Hợp Đồng Bảo Hiểm Nhân Thọ",11550000,11550000,0,0
TIKI,balo-va-vali,101238801,"Balo thời trang tướng MURAD liên quân, chất liệu vải cao cấp bền đẹp, kiểu dáng thời trang hiện đại",239000,239000,0,0
TIKI,voucher-dich-vu,79733681,"Khóa học Lập kế hoạch và tổ chức sự kiện - Agilearn",1055000,1055000,0,0
TIKI,voucher-dich-vu,11428827,"Khoá Luyện Thi Tiếng Anh Thiếu Nhi Cambridge Flyers Cho Bé (Lớp 6-7) Tại Nhà Cùng 247 Tiếng Anh",399000,399000,0,0
TIKI,voucher-dich-vu,55297903,"Khóa học tiếng Nhật Online luyện thi chứng chỉ N4",450000,450000,0,0
TIKI,voucher-dich-vu,49864028,"Uốn Mi Collagen 6D - Mi Cong - Mi Dày - Mi Dài Hơn",99000,99000,0,0
TIKI,voucher-dich-vu,34325063,"Bọc Răng Sứ Cercon Tại Nha Khoa Moli",4490000,4490000,0,0
TIKI,voucher-dich-vu,34362532,"[HCM] Tour 6N5Đ Hà Nội - Ninh Bình - Hạ Long - Sapa, Gồm Vé Máy Bay Khứ Hồi, Khởi Hành Hàng Tuần",9600000,9600000,0,0
TIKI,voucher-dich-vu,10793692,"Khóa Học Tiếng Anh Online Cambridge Movers B tại nhà cho bé cùng 247 Tiếng Anh ",399000,399000,0,0
TIKI,voucher-dich-vu,28600458,"NĐBĐ : Chương trình tour Quy Nhơn: Hòn Khô - Kỳ Co - Đồi cát Phương Mai - Tháp Đôi",749000,749000,0,0
TIKI,voucher-dich-vu,21787103,"Tick Edu - Dựng Phim Truyền Thông Chuyên Nghiệp Với Adobe Premiere",699000,699000,0,0
TIKI,voucher-dich-vu,262799311,"Evoucher - Phiếu Quà Tặng Trị Liệu Chân (90 phút)",750000,750000,0,0
TIKI,voucher-dich-vu,56880763,"Xuân Hiền Resort Phú Quốc 3* - Gói 2N1D",900000,900000,0,0
TIKI,voucher-dich-vu,204275053,"Sách nói: Năng Lượng Từ Hơi Thở",99000,99000,0,0
TIKI,voucher-dich-vu,24729325,"Tour Làng Nổi Tân Lập - Thiền viện Trúc Lâm Chánh Giác - Công Viên Kỳ Quan Thế Giới 01 Ngày, Khởi Hành Chủ Nhật Hàng Tuần",599000,599000,0,0
TIKI,tui-vi-nu,109631958,"Ví dự tiệc cưới, kiểu ví họa tiết hoa lá, thường thấy ở tiệc cưới, sự kiện, có nút gài kim loại, hàng hiệu, sang trọng, đẳng cấp",330000,550000,220000,40
TIKI,voucher-dich-vu,34476220,"Khóa học Bí quyết xây dựng mối quan hệ trong kinh doanh",400000,400000,0,0
TIKI,voucher-dich-vu,205582354,"Phiếu Quà Tặng Lẩu Đài Loan Băng Chuyền Shang Chi 200K",200000,200000,0,0
TIKI,voucher-dich-vu,170630440,"Khóa Học Video Online Xoa Bóp Giảm Đau Khớp Gối Do Thoái Hóa Khớp, Khô Khớp - Trung Tâm Chăm Sóc Sức Khỏe VMC",900000,900000,0,0
TIKI,voucher-dich-vu,193668833,"Phiếu Quà Tặng BreadTalk 100K",100000,100000,0,0
TIKI,voucher-dich-vu,31850343,"Khóa Học Môi Giới Bất Động Sản Cho Người Mới Bắt Đầu - Trung Tín Edu",510000,510000,0,0
TIKI,voucher-dich-vu,271663649,"Xe bus Đà Nẵng – Hội An (một chiều)/ Shuttle Bus Da Nang to Hoi An (one way)",150000,150000,0,0
TIKI,tui-vi-nu,169851433,"Bộ 8 vỏ bọc thẻ căn cước bằng lái thẻ tín dụng trong suốt",11994,11994,0,0
TIKI,voucher-dich-vu,29284677,"MintWIFI-SIM 4G Du lịch 36 nước Châu Âu tốc độ cao dung lượng 5GB cho 30 ngày sử dụng",779000,779000,0,0
TIKI,voucher-dich-vu,100225063,"Sách nói: Bắt Đầu Với Câu Hỏi Tại Sao",99000,99000,0,0
TIKI,voucher-dich-vu,2065131,"Dịch Vụ Trị Mụn Bằng Mỹ Phẩm Dermaligical Của Mỹ",195000,195000,0,0
TIKI,tui-vi-nu,157479000,"ví bóp nữ cầm tay Forever Young có nhiều ngăn hàng hiệu da cao cấp, đựng vừa điện thoại - PL82561",99000,189000,90000,48
TIKI,voucher-dich-vu,72205456,"KHÓA HỌC NODEJS",6000000,6000000,0,0
TIKI,voucher-dich-vu,11183866,"Combo Cắt Da Tay + Sơn Gel + Vẽ Tự Nhiên Tại Vietgangz Nails",229000,229000,0,0
TIKI,voucher-dich-vu,155742739,"Sách nói: Tâm Lý Học Đám Đông",99000,99000,0,0
TIKI,voucher-dich-vu,11306320,"Combo Nail: Nhặt Da Tay Kết Hợp Sơn Gel TRINITY Tại MOH Beauty",179000,179000,0,0
TIKI,voucher-dich-vu,184507850,"Sách nói: Ánh Sáng Trong Bóng Tối",99000,99000,0,0
TIKI,voucher-dich-vu,41265163,"Tan Mỡ Giảm Cân 4 Vùng Bắp Tay/ Bụng/ Đùi  60 Phút Tại L'Paradis Spa",99000,99000,0,0
TIKI,voucher-dich-vu,193668827,"Phiếu Quà Tặng BreadTalk 500K",500000,500000,0,0
TIKI,voucher-dich-vu,86305194,"TOUR VƯỜN CHÀ LÀ - CÁ LÓC BAY - CHÙA LÁ SEN KHỔNG LỒ 1 NGÀY - HAPPY TOUR ",690000,690000,0,0
TIKI,voucher-dich-vu,7361425,"Vshape Fitness & Yoga Center - Trọn Gói 01 Tháng Tập Gym & Yoga ",400000,400000,0,0
TIKI,voucher-dich-vu,209389851,"Phiếu Quà Tặng Beloved & Beyond 500K",500000,500000,0,0
TIKI,tui-vi-nu,136940240,"Bóp đựng tiền 4 ngăn ( hình chụp 2 mặt trước sau )",15000,15000,0,0
TIKI,tui-vi-nu,185849277,"Túi Xách Nữ Đeo Chéo và Đeo Vai Màu Vàng Bò CRESCENT MOON HOBO BAG GIPSY",690000,690000,0,0
TIKI,tui-vi-nu,117726917,"Ví dài cầm tay nữ WESSON FOREVER YOUNG nhiều ngăn siêu tiện dụng, phong cách Hàn Quốc, trẻ trung, cá tính",149000,149000,0,0
TIKI,voucher-dich-vu,137229860,"[E-BOOK] New Amanda & Friends 2 File nghe Audio",10000,10000,0,0
TIKI,voucher-dich-vu,973188,"Khóa Học Online Luyện TOEIC Nâng Cao 800+",319000,319000,0,0
TIKI,voucher-dich-vu,71188902,"Khóa học CHUYÊN ĐỀ: HÓA HỌC VÔ CƠ - thầy Lê Minh Phấn - 09 tháng",1000000,1000000,0,0
TIKI,voucher-dich-vu,222659074,"[EVoucher Vietravel] Đà Nẵng - Huế - Đầm Lập An - La Vang - Động Phong Nha & Thiên Đường - KDL Bà Nà - Cầu Vàng -Sơn Trà - Hội An - Đà Nẵng",7990000,7990000,0,0
TIKI,voucher-dich-vu,269964216,"[EVoucher Vietravel Hà Nội] Combo 3N2D KS Eden Ocean View Hotel Đà Nẵng 4 Sao: VMB khứ hồi Hà Nội - Đà Nẵng + Phòng Tiêu Chuẩn + Ăn sáng",3990000,3990000,0,0
TIKI,voucher-dich-vu,214766631,"Kịch IDECAF: CƯỚI VỢ CHO AI",270000,270000,0,0
TIKI,voucher-dich-vu,56880763,"Xuân Hiền Resort Phú Quốc 3* - Gói 2N1D",900000,900000,0,0
TIKI,voucher-dich-vu,41265163,"Tan Mỡ Giảm Cân 4 Vùng Bắp Tay/ Bụng/ Đùi  60 Phút Tại L'Paradis Spa",99000,99000,0,0
TIKI,tui-vi-nu,99280866,"Ví nữ dài cầm tay cao cấp dây đeo chéo thời trang đi chơi dạo phố TK0085",59000,118000,59000,50
TIKI,tui-vi-nu,147492246,"Túi đeo chéo nữ vải TOTE dễ thương được tặng kèm quà xinh",105000,105000,0,0
TIKI,tui-thoi-trang-nam,102012630,"Ví nam đựng thẻ ATM mini bằng hợp kim nhôm MB25",238000,238000,0,0
TIKI,voucher-dich-vu,272192414,"[E-Voucher Sannatour] Chùa Linh Ứng - Ngũ Hành Sơn - Hội An 1 Ngày Đón Đà Nẵng",269000,269000,0,0
TIKI,voucher-dich-vu,199957263,"[EVoucher Vietravel] Mùa hoa tam giác mạch: Hà Giang - Lũng Cú - Đồng Văn - Mã Pì Lèng",6990000,6990000,0,0
TIKI,tui-thoi-trang-nam,88999791,"Bóp Ví Nam Da Bò Thật Dáng Ngang MEDYN Chính Hãng - May Tay Chắc Chắn, Ke Viền Nổi Bật - Da Sáp Cực Bền Và Đẹp Theo Thời Gian Không Bị Bong Tróc, Phai Màu",99000,99000,0,0
TIKI,voucher-dich-vu,16117448,"Vé Du Thuyền Sông Hàn, Ngắm Cảnh Đà Nẵng Về Đêm",150000,150000,0,0
TIKI,tui-thoi-trang-nam,72673634,"TÚI ĐEO CHÉO TOMTOC (USA) LIGHTWEIGHT CODURA SLING BAG BLACK (H02-A04D) - HÀNG CHÍNH HÃNG",950000,950000,0,0
TIKI,voucher-dich-vu,91767640,"Sách nói: Đọc Vị Bất Kỳ Ai - Để Không Bị Lừa Dối Và Lợi Dụng",99000,99000,0,0
TIKI,tui-vi-nu,11249058,"Ví đựng thẻ ví ngắn nữ chữ H",83000,83000,0,0
TIKI,tui-thoi-trang-nam,44044629,"Cặp công sở thời trang CAYUUMY07",235000,390000,155000,40
TIKI,tui-thoi-trang-nam,25407742,"Túi Đeo Chéo Da Nam Cao Cấp Túi Nắp Weixier B0834 – Túi Đeo Chéo Da Thời Trang",257000,257000,0,0
TIKI,voucher-dich-vu,129609186,"[E-BOOK] i-Learn Smart Start Special Edition 3 Sách giáo viên điện tử",15000,15000,0,0
TIKI,voucher-dich-vu,202707126,"Toán Và Khoa Học Tiếng Anh Freckle Social Study",2365000,2365000,0,0
TIKI,voucher-dich-vu,105836034,"ELLY - Phiếu Quà Tặng 300.000đ",300000,300000,0,0
TIKI,tui-thoi-trang-nam,56029758,"VÍ SEN 1 - CHÍNH HÃNG KHẮC TÊN",300000,300000,0,0
TIKI,voucher-dich-vu,10085218,"Liệu Trình Hifu Tạo Hình VLine Nâng Cơ, Xóa Nhăn, Trẻ Hóa Da Tại Thanh Thanh Spa (Miễn Tip)",1499000,1499000,0,0
TIKI,tui-vi-nu,191492782,"Túi đeo chéo nữ phong cách dễ thương – DCNU1006",129000,260000,131000,50
TIKI,tui-thoi-trang-nam,192128365,"Túi xách da nam công sở da PU cao cấp hàng hiệu chính hãng YVan F80166-5",650000,650000,0,0
TIKI,voucher-dich-vu,129927325,"[APP] i-Learn Smart Start Level 2 - Ứng dụng phần mềm trò chơi tương tác",25000,25000,0,0
TIKI,tui-thoi-trang-nam,183530414,"Túi bao tử - đeo chéo mini vải Canvas Unisex nam nữ phong cách trẻ trung, đường phố",47000,94000,47000,50
TIKI,voucher-dich-vu,202517585,"myON - Thư Viện Kỹ Thuật Số ",2365000,2365000,0,0
TIKI,voucher-dich-vu,26288964,"MintWIFI-Thuê Bộ Phát Wifi Du lịch Anh Quốc",222000,222000,0,0
TIKI,voucher-dich-vu,204339072,"T3. TOUR CANO 3 ĐẢO LẶN NGẮM SAN HÔ TỰ NHIÊN -PHÚ QUỐC",600000,600000,0,0
TIKI,voucher-dich-vu,91772913,"Sách nói: Tiến Bước",99000,99000,0,0
TIKI,voucher-dich-vu,204267279,"T1. ĐỊA TRUNG HẢI, BÃI SAO VÀ NGẮM HOÀNG HÔN VERSAILLES - PHÚ QUỐC ( Tour riêng )",690000,690000,0,0
TIKI,voucher-dich-vu,204269012,"Sách nói: Giác Ngộ - Osho",99000,99000,0,0
TIKI,tui-thoi-trang-nam,142811219,"Túi da nam đeo chéo thời trang đi học, đi làm D274",149000,190000,41000,22
TIKI,tui-thoi-trang-nam,115659840,"Ví nam mini AD02, bóp nam da thật, ví da nam ví đứng nhiều ngăn kích thước nhỏ gọn đựng tiền đựng thẻ tiện dụng, chất",150000,150000,0,0
TIKI,voucher-dich-vu,74735395,"Ulearning - Khoá Học "Luyện Thi Tiếng Anh THPT"",399000,399000,0,0
TIKI,tui-thoi-trang-nam,157254410,"Túi Bao Tử SAIGON SWAGGER SGS Belt Bumbag-Nhiều Ngăn, Chống Thấm",300000,300000,0,0
TIKI,voucher-dich-vu,165038520,"Sinh Trắc Vân Tay Gen Talents – Module Nâng Cao Năng Lực Học Tập",1870000,1870000,0,0
TIKI,voucher-dich-vu,80063321,"Khóa học Kỹ năng quản lý hiệu quả - Agilearn",1245000,1245000,0,0
TIKI,tui-thoi-trang-nam,57916893,"Túi da bao tử nam Dza, chất Pu cao cấp, thiết kế gọn gàng tinh tế, màu sắc thanh lịch",94333,136259,41926,31
TIKI,tui-thoi-trang-nam,147694482,"Túi Xách Công Sở Nam P117 – Cặp Da Thời Trang Thiết Kế Sang Trọng – Lịch lãm",392000,455000,63000,14
TIKI,tui-thoi-trang-nam,175425259,"Túi Đeo Chéo IBag Thời Trang Cao Cấp SAKOS CENTERA",890000,890000,0,0
TIKI,voucher-dich-vu,205264757,"Sách nói: An Lạc Từ Tâm",99000,99000,0,0
TIKI,voucher-dich-vu,190238877,"Hoa Yêu Thương - Evoucher Bình Hoa Tươi - Nắng Hồng ",550000,550000,0,0
TIKI,tui-thoi-trang-nam,193724249,"Túi Bao Tử Nam Nữ Đeo Chéo Du Lịch Tiện Ích, Vải Cao Cấp Chống Thấm, Nhiều Ngăn Đựng",65000,65000,0,0
TIKI,voucher-dich-vu,184512442,"Sách nói: Luật Của Warren Buffett",99000,99000,0,0
TIKI,tui-thoi-trang-nam,184415074,"Ví Da Nam Cao Cấp VD04 Kiểu Đứng Nhỏ Gọn Thời Trang",38000,50000,12000,24
TIKI,voucher-dich-vu,26324669,"MintWIFI-Thuê Bộ Phát Wifi Du lịch Tây Ban Nha",222000,222000,0,0
TIKI,tui-thoi-trang-nam,153471499,"Cặp da bò dập vân CÁ SẤU - BEEGEE 5509",1089000,2200000,1111000,51
TIKI,voucher-dich-vu,263045058,"[E-Voucher] Vé tham quan VinWonders Phú Quốc vui chơi bất tận",685000,685000,0,0
TIKI,voucher-dich-vu,164817863,"Sinh Trắc Vân Tay Gen Talents – Dịch Vụ Tư Vấn Sinh Trắc Vân Tay Gia Đình – Gói Phân Tích Demo – Tặng Sách Nhà Đầu Tư Thông Minh (Tái Bản)",600000,600000,0,0
TIKI,voucher-dich-vu,91676273,"Sách nói Fonos: Nhân Tố Enzyme: Phương Thức Sống Lành Mạnh",99000,99000,0,0
TIKI,tui-thoi-trang-nam,115642332,"Ví nam dài D066 cầm tay thời trang sang trọng",64000,69000,5000,7
TIKI,tui-thoi-trang-nam,108311444,"Túi xách túi đeo chéo nam 100% da bò thật cao cấp phong cách mới",513000,570000,57000,10
TIKI,voucher-dich-vu,11191793,"Combo Cắt Da Tay, Chăm Sóc Móng, Sơn Gel Tại Vietgangz Nails",199000,199000,0,0
TIKI,tui-thoi-trang-nam,70639323,"Túi Nam Đeo Chéo Bụng 4U Da Bò Thật Cao Cấp Thời Trang DB285",395000,450000,55000,12
TIKI,tui-thoi-trang-nam,57242919,"Túi đeo hông đeo bụng cao cấp thể thao du lịch sport KSD22",52470,71709,19239,27
TIKI,tui-thoi-trang-nam,165699417,"Túi đeo chéo da nam thể du đựng ipad Sport Caro xanh Nền Tối Shalla",49549,67717,18168,27
TIKI,tui-thoi-trang-nam,6887853,"Túi Đeo Chéo Nam DXYZ Chống Trộm",111000,111000,0,0
TIKI,tui-thoi-trang-nam,191606872,"Ví Nam Trơn Da Pu Nhiều Ngăn Có Khóa Nhỏ Gọn Tiện Lợi Cho Phái Nam D&D Fashion",50000,95000,45000,47
TIKI,tui-thoi-trang-nam,58478574,"Túi đeo chéo nam thời trang TRITA RTN3",215000,420000,205000,49
TIKI,tui-thoi-trang-nam,59166368,"Túi đeo chéo cặp da công sở đựng laptop dáng túi ngang T74 33x25x7cm",329000,329000,0,0
TIKI,tui-thoi-trang-nam,77033102,"Túi Đeo Chéo Nam Nữ Chống Nước Thời Trang Kabek TD23 Túi Bao Tử Unisex Dệt Trơn Trượt Nước Đeo Hông Lưng Bụng Màu Đen Phù Hợp Nam Nữ Thời Trang Phong Cách Nhật Bản Thiết Kế Basic Hiện Đại Đơn Giản",64350,87945,23595,27
TIKI,voucher-dich-vu,41173346,"Hấp Trắng Huyết Yến Colagen + Đèn Bioles 60 Phút Tại L'Paradis Spa",119000,119000,0,0
TIKI,tui-thoi-trang-nam,111868735,"Túi đeo chéo, đeo hông Arctic Hunter K00093 chất liệu Oxford chống thấm nước, thiết kế nhiều ngăn tiện dụng",399000,635000,236000,37
TIKI,voucher-dich-vu,204268506,"Sách nói: Ăn Và Chạy - Hành Trình Không Tưởng Của Tôi Tới Bộ Môn Ultramarathon Vĩ Đại",99000,99000,0,0
TIKI,voucher-dich-vu,34434359,"Triệt Lông Công Nghệ Laser Diode Tại Haan Spa",109000,109000,0,0
TIKI,tui-thoi-trang-nam,186270968,"Túi xách da nam công sở TRITA RTN8",315000,550000,235000,43
TIKI,tui-thoi-trang-nam,13436994,"Túi đeo chéo thời trang BEE GEE 037",64000,130000,66000,51
TIKI,tui-thoi-trang-nam,82372883,"Túi đeo chéo nam cao cấp phong cách mới",297000,330000,33000,10
TIKI,voucher-dich-vu,25632406,"Tour 3N2Đ Đà Nẵng - Huế - Động Thiên Đường, Khách Sạn 3 Sao, Khởi Hành Thứ 2, Thứ 6 Hàng Tuần",2499000,2499000,0,0
TIKI,voucher-dich-vu,91556183,"TMV Nevada - Chăm sóc da Perfect Skin 99.000/Buổi",150000,150000,0,0
TIKI,tui-thoi-trang-nam,3054007,"Túi Đeo Chéo 4U Năng Động D246",149000,175000,26000,15
TIKI,tui-thoi-trang-nam,185857699,"Túi Đeo Chéo Tomtoc H02 Urban Codura Sling Bag Travel Work 11" - 14.2",1510000,1779000,269000,15
TIKI,voucher-dich-vu,129983556,"[APP] i-Learn Smart Start Level 5 - Ứng dụng phần mềm trò chơi tương tác",25000,25000,0,0
TIKI,voucher-dich-vu,74743260,"Ulearning - Khoá học "Những Lỗi Thường Gặp Trong Tiếng Anh"",399000,399000,0,0
TIKI,tui-thoi-trang-nam,193310417,"Ví da thời trang ngang nam loại gập cầm tay nhiều ngăn D3088",47500,50000,2500,5
TIKI,voucher-dich-vu,91678176,"Sách nói Fonos: Muốn An Được An của Thầy Thích Nhất Hạnh",99000,99000,0,0
TIKI,voucher-dich-vu,91464728,"[HCM] Gói 7 Ngày Tập Luyện Tại Life Fitness & Yoga",199000,199000,0,0
TIKI,tui-thoi-trang-nam,44324918,"Túi xách da bò công sở cao cấp phong cách châu âu TX7602",900000,999000,99000,10
TIKI,tui-thoi-trang-nam,76659089,"Bóp ví nam da bò thật 4U nhiều ngăn đựng tiền và thẻ tiện dụng F108 (Đen - Nâu)",169000,225000,56000,25
TIKI,tui-thoi-trang-nam,189337217,"Túi đeo chéo nam nữ đa năng vải cao cấp chính hãng YVan 8882",325000,325000,0,0
TIKI,voucher-dich-vu,50824840,"Giảm beó công nghệ Lipo Laser triệt tiêu đến 20cm mỡ thừa sau liệu trình",299000,299000,0,0
TIKI,voucher-dich-vu,270471604,"[Đà Nẵng]-BVĐK Tâm Trí - Gói Phẫu Thuật Cắt Búi Trĩ (Gây Tê)",2203140,2203140,0,0
TIKI,voucher-dich-vu,85257965,"Khóa học Kỹ năng phân tích và tổng hợp thông tin, lập báo cáo - Agilearn",920000,920000,0,0
TIKI,tui-thoi-trang-nam,111868843,"Túi đeo chéo, đeo hông nam Arctic Hunter K00092 chất liệu Oxford chống thấm nước, thiết kế nhiều ngăn tiện dụng",369000,585000,216000,37
TIKI,voucher-dich-vu,129937473,"[APP] i-Learn Smart Start Level 2 - Ứng dụng phần mềm tương tác sách học sinh",25000,25000,0,0
TIKI,tui-thoi-trang-nam,70637098,"Túi Nam Đeo Chéo 4U Da Bò Thật Thời Trang BA295",475000,525000,50000,10
TIKI,voucher-dich-vu,11185314,"Combo Cắt Da Tay + Sơn Gel + Vẽ Sáng Tạo Hoặc Đính Hột Tại Vietgangz Nails",249000,249000,0,0
TIKI,voucher-dich-vu,165041500,"Sinh Trắc Vân Tay Gen Talents – Module Nghề Nghiệp Và Xu Thế Phát Triển Kỹ Năng",1320000,1320000,0,0
TIKI,voucher-dich-vu,26253095,"Thẩm Mỹ Song Kim - 60 Phút Điều Trị Mụn Cám, Mụn Đầu Đen, Se Khít Lỗ Chân Lông",150000,150000,0,0
TIKI,tui-thoi-trang-nam,190860890,"Ví nam da bò cao cấp phong cách mới",270000,299000,29000,10
TIKI,voucher-dich-vu,242076808,"[Biểu Tượng Thất Truyền]  Voiz FM - Voucher nghe Sách Nói",189000,245000,56000,23
TIKI,voucher-dich-vu,273503414,"Voucher Combo Rửa Mặt + Massage",15000,30000,15000,50
TIKI,voucher-dich-vu,152463207,"Sách nói: Trên Hành Trình Tự Học",99000,99000,0,0
TIKI,voucher-dich-vu,96414922,"D1-Concepts - Phiếu Quà Tặng San Fu Lou 1000k",1000000,1000000,0,0
TIKI,voucher-dich-vu,176674685,"Sách nói: Trở Thành Tác Giả",99000,99000,0,0
TIKI,voucher-dich-vu,137316469,"[APP] New Amanda & Friends 1 - Ứng dụng phần mềm tương tác sách học sinh",25000,25000,0,0
TIKI,voucher-dich-vu,99444842,"Villa Vinpearl Nha Trang Bay 2N1Đ | Ăn 3 bữa & Vui chơi Vinwonders không giới hạn",9250000,9250000,0,0
TIKI,voucher-dich-vu,25754482,"Nhà Hàng Rạng Đông  - Buffet Chay Buổi Tối Hơn 40 Món ",187000,187000,0,0
TIKI,voucher-dich-vu,197185810,"[e-space.v] khóa học tiếng Anh giao tiếp online 1 kèm 1",1000,1000,0,0
TIKI,voucher-dich-vu,214766641,"Kịch IDECAF: THUỐC ĐẮNG GIÃ TẬT",220000,220000,0,0
TIKI,voucher-dich-vu,242087719,"Gói 3N2Đ Radisson Blu Resort 5* Phú Quốc - Buffet Sáng, Xe Đón Tiễn Sân Bay, Xe Chợ Đêm, Hồ Bơi, Bãi Biển Riêng, Dành Cho 02 Người Lớn Và 02 Trẻ Em Dưới 12 Tuổi",3190000,3190000,0,0
TIKI,voucher-dich-vu,164055872,"Tour Quy Nhơn 3N3Đ - Bãi Biển Đại Lãnh - Kỳ Co - Eo Gió - Gành Đá Đĩa Phú Yên - KDS Gềnh Ráng - Bãi Xếp - Mũi Điện Cực Đông Tổ Quốc - Vườn Nho Ninh Thuận",2568000,2568000,0,0
TIKI,voucher-dich-vu,25296901,"Tour 4N3Đ Đà Nẵng - Cù Lao Chàm - Bà Nà - Hội An, Khách Sạn 3 Sao, Khởi Hành Hàng Ngày",2588000,2588000,0,0
TIKI,voucher-dich-vu,252400722,"[EVoucher Vietravel] Mệnh giá 6.000.000 VND áp dụng cho tour Singapore - Malaysia - Indonesia giá từ 13.990.000",6000000,6000000,0,0
TIKI,voucher-dich-vu,25493328,"Tour Đà Nẵng - Sơn Trà - Hội An 01 Ngày, Gồm Bữa Tối, Khởi Hành Hàng Ngày",350000,350000,0,0
TIKI,voucher-dich-vu,34589863,"Khóa Học BA & PM Phối Hợp Hoàn Thiện",8900000,8900000,0,0
TIKI,voucher-dich-vu,9809424,"Voucher FLC 2021, 2022 - Nghỉ Dưỡng 3N2Đ Siêu Tiết Kiệm - Áp Dụng Quy Nhơn, Sầm Sơn, Hạ Long, Vĩnh Phúc",2750000,2750000,0,0
TIKI,voucher-dich-vu,2211331,"Gói Dịch Vụ 1 Lần Cạo Vôi Răng Và Đánh Bóng Tại Nha Khoa Thẩm Mỹ Hồng Ân",88000,88000,0,0
TIKI,tui-vi-nu,17003410,"Túi Xách Nữ Thời Trang Cao Cấp EL95 đỏ",719400,1199000,479600,40
TIKI,tui-vi-nu,149449416,"Túi xách đeo chéo mới CeeKay (Fullbox) - Túi xách nữ hàng cao cấp chính hãng",450000,450000,0,0
TIKI,tui-vi-nu,214588850,"Túi da nữ Louis Fontaine Eze màu đen size L",4600000,4600000,0,0
TIKI,voucher-dich-vu,11798392,"Gói Khám Tổng Quát Cho Bé Từ 01 - 06 Tuổi Tại Phòng Khám Careplus",1100000,1100000,0,0
TIKI,tui-vi-nu,157549366,"BỘ 4 TÚI DA THỜI TRANG  Túi xách nữ công sở đẹp cao cấp set 4 món da sang trọng, thời trang",365000,365000,0,0
TIKI,voucher-dich-vu,247302303,"Tour du lịch Đà Nẵng [LAMBABA] Tour Bà Nà 1 ngày Khám phá Sun World Bà Nà Hills Hành trình về Miền Tiên Cảnh",1080000,1080000,0,0
TIKI,tui-vi-nu,5003395,"Túi Xách Nữ Cao Cấp Da Thật Elly ET37",2499000,2499000,0,0
TIKI,voucher-dich-vu,196342212,"Sandals Lily Hotel 4* Đà Lạt - Buffet Sáng - Gần Chợ Đà Lạt",957000,957000,0,0
TIKI,voucher-dich-vu,40195957,"Combo Nàng Ấm Chăm Sóc Da Mặt Tại Ấm Brows & Spa - Combo 2: Chăm Sóc Da Mặt Cơ Bản+Thanh Tẩy Yến Mạch Sữa Non+ Massage Body 60' + Ủ Dưỡng Sữa Non Cô Đặc",255000,255000,0,0
TIKI,tui-vi-nu,186128722,"Túi Đeo Chéo Vải Cavas Siêu Dễ Thương Cho Nữ Đựng Đồ Đi Chơi Dạo Phố, Túi Xách Nữ Thời Trang Nhật Bản",55000,55000,0,0
TIKI,voucher-dich-vu,175966062,"Sách nói: Trên Lưng Khổng Tượng",99000,99000,0,0
TIKI,tui-vi-nu,163719940,"Túi Xách Nữ Đeo Chéo Đeo Vai Kẹp Nách Crescent-Moon Hobo GIPSY",690000,690000,0,0
TIKI,voucher-dich-vu,128251042,"Jinro BBQ - Phiếu Quà Tặng 500K",500000,500000,0,0
TIKI,voucher-dich-vu,108801582,"WeStudy - 15 Thủ pháp thị giac ứng dụng trong Nhiếp Ảnh hiện đại - TẶNG KÈM Khóa học Diễn Xuất",249000,379000,130000,34
TIKI,tui-vi-nu,35573460,"Túi đeo chéo nam nữ - túi bao tử thời trang BEE GEE 028 ( Trơn ) vải dù",40000,80000,40000,50
TIKI,tui-vi-nu,86561430,"Ví bóp nữ    Ví nữ cao cấp cầm tay mini thời trang nhỏ gọn nhiều ngăn đẹp giá rẻ Micloset - V05311",16000,16000,0,0
TIKI,tui-vi-nu,69192511,"Túi Xách Nữ Đeo Vai 2 Dây Đeo Size To Nhiều Ngăn Tiện Dụng Chất Da Đẹp SK912",55000,55000,0,0
TIKI,tui-vi-nu,160315073,"Ví Nữ Dài Cầm Tay FOREVER YOUNG Đựng Tiền Phong Cách Hàn Quốc Siêu Đẹp VD07 - Micocah Mall",119000,119000,0,0
TIKI,tui-vi-nu,252597316,"[Da thật] Ví mini nam nữ da bò thật MN114ALS (Đen/Nâu/Xanh Navy) - 100% da bò thật, BH 3 năm",149000,149000,0,0
TIKI,tui-vi-nu,185077985,"Túi xách nữ Oscar - OCWHBSG 056",690000,2490000,1800000,72
TIKI,tui-vi-nu,160314958,"Ví Nữ Dài Cầm Tay Chính Hãng FOREVER YOUNG Đựng Tiền Đựng Thẻ Da Mềm Khóa Đồng Xu Siêu Đẹp FY01 - Micocah Mall",119000,119000,0,0
TIKI,voucher-dich-vu,6215487,"Liệu Trình Massage Mặt Căng Da Kết Hợp Mặt Nạ Yến Mạch",109000,109000,0,0
TIKI,voucher-dich-vu,175110903,"FPT Play - Tài khoản dùng thử/ 6-12-13 tháng gói iZi-MAX-VIP- Gói dịch vụ phổ biến xem truyền hình, thể thao, phim truyện và giải trí trên FPT Play ✓ Xem trực tiếp trên SmartTV, Smartphone, PC, Laptop &amp; FPT Play Box",55000,55000,0,0
TIKI,voucher-dich-vu,34476189,"Khóa học Phân tích toàn diện doanh nghiệp",800000,800000,0,0
TIKI,tui-vi-nu,191309685,"Marhen.J - Túi đeo vai nữ chữ nhật Milly Nano MJ21AMLYNA-KH",2890000,2890000,0,0
TIKI,tui-vi-nu,191309750,"Marhen.J - Túi xách nữ phom chữ nhật Rhonda Mini MJ21BRNDMN-OG",3590000,3590000,0,0
TIKI,tui-vi-nu,188995393,"Túi Đeo Chéo Tomtoc H02 Lightweight Codura Sling Bag - đựng phụ kiện, đồ dùng cá nhân",883150,1039000,155850,15
TIKI,tui-vi-nu,36827817,"Ví Nữ Mini Ngắn Cầm Tay Cao Cấp Sang Trọng Phong Cách Hàn Quốc, Nhiều Ngăn Tiện Lợi V07",125000,250000,125000,50
TIKI,tui-vi-nu,46166280,"Túi xách nữ thời trang kiểu dáng công sở Châu Âu",189000,189000,0,0
TIKI,voucher-dich-vu,252401603,"[EVoucher Vietravel] Mệnh giá 3.000.000 VND áp dụng cho tour Campuchia giá từ 5.990.000",3000000,3000000,0,0
TIKI,tui-vi-nu,83471905,"Ví cầm tay nữ Yuumy YV32",175000,320000,145000,45
TIKI,tui-vi-nu,42134677,"TÚI ĐEO NỮ NHỎ XINH NHIỀU MÀU - H0011",49000,75000,26000,35
TIKI,voucher-dich-vu,193450833,"[EVoucher Vietravel] Trung Quốc: Thượng Hải - Hàng Châu - Vô Tích - Tô Châu - Bắc Kinh",27990000,27990000,0,0
TIKI,voucher-dich-vu,242720115,"Combo Vé VinWonders Và Vé Vườn Thú Mở Vinpearl Safari Phú Quốc, Vui Chơi Trong Cùng 01 Ngày",990000,990000,0,0
TIKI,voucher-dich-vu,56036698,"Cari Cua Thái Tại Nhà Hàng Cua Ngon",400000,400000,0,0
TIKI,voucher-dich-vu,25411913,"Tour 03 Đảo Nha Trang Bằng Cano, Lặn Ngắm San Hô, Bữa Trưa Trên Bè, Khởi Hành Hàng Ngày",399000,399000,0,0
TIKI,tui-vi-nu,196675540,"Túi Cói, Túi Xách Cỏ Bàng Vẽ Hoa Hướng Dương Cao Cấp Chuẩn Đẹp-Giỏ Xách Cỏ Bàng Mỹ Nghệ TXCBVHHDLTK15",339000,339000,0,0
TIKI,tui-vi-nu,93291134,"Marhen.J - Túi đeo vai chữ nhật Ludy MJ20DLUDYB-PK",3890000,3890000,0,0
TIKI,voucher-dich-vu,34476185,"Khóa học Phân tích báo cái tài chính nâng cao",600000,600000,0,0
TIKI,voucher-dich-vu,225208452,"Coral Bay Resort 3* Phú Quốc - Bãi Biển Đẹp, Bữa Sáng, Gần Chợ Đêm, Ngay Trung Tâm Đông Dương",1340000,1340000,0,0
TIKI,voucher-dich-vu,195850864,"[EVoucher Vietravel] Phú Quốc: Thiền Viện Trúc Lâm Hộ Quốc - Bãi Sao (Khách sạn 3 sao) | Kích cầu du lịch",3590000,3590000,0,0
TIKI,tui-vi-nu,116594664,"Túi Xách Nữ -Túi vải CANVAS đeo chéo nữ dây YXY TOLIVE TV02",40000,40000,0,0
TIKI,tui-vi-nu,131337770,"Túi vải bố, Túi vải Canvas trơn màu kem không khóa kéo",19000,19000,0,0
TIKI,tui-vi-nu,48461717,"Ví nữ dáng dài cầm tay Since kiểu dáng Hàn Quốc",48000,48000,0,0
TIKI,tui-vi-nu,119410137,"Túi đeo chéo nữ trong suốt thời trang dạo phố XX25 Tặng bút cảm ứng ĐT",66973,91530,24557,27
TIKI,voucher-dich-vu,252410148,"[EVoucher Vietravel] Mệnh giá 4.000.000 VND áp dụng cho tour nội địa Đà Nẵng giá từ 7.990.000",4000000,4000000,0,0
TIKI,voucher-dich-vu,221805312,"[E-Voucher] Vietourist - Tour Du Lịch Tây Nguyên: Buôn Ma Thuột - Buôn Đôn - Pleiku - Kontum - Măng Đen",2990000,2990000,0,0
TIKI,tui-vi-nu,136940214,"Túi đựng điện thoại thêu 3 cô gái Việt Nam",25000,25000,0,0
TIKI,voucher-dich-vu,57773207,"TOUR HÀ NỘI - NINH BÌNH - HẠ LONG 3N2D [TPHCM] [KHUYẾN MÃI KÍCH CẦU] [DATVIETRAVEL",310000,310000,0,0
TIKI,tui-vi-nu,248991490,"XI SÁP GOLDCARE - GC5003",55000,55000,0,0
TIKI,tui-vi-nu,95394051," Túi Xách Nữ Thời Trang Đeo Chéo Chất Da Xịn Lên Dáng Chuẩn Form Xinh Lắm Lắm Luôn",68000,68000,0,0
TIKI,tui-vi-nu,173986171,"Phụ kiện túi vải Yuumy cỡ lớn YBVLL",20000,20000,0,0
TIKI,tui-vi-nu,204668560,"Túi xách nữ thời trang đa năng FA DO DA FTX3 nhiều màu",520000,520000,0,0
TIKI,tui-vi-nu,145555826,"Túi xách nữ thời trang LATA TX09",490000,490000,0,0
TIKI,voucher-dich-vu,191657101,"Phiếu Quà Tặng Extrim 50K",47500,50000,2500,5
TIKI,tui-vi-nu,200016854,"Túi Cói Xinh Xắn Nữ Tính Đi Biển Đi Chơi Hình Dáng Vỏ Ốc Cách Điệu Độc Đáo Thủ Công Thân Thiện Môi Trường",320000,320000,0,0
TIKI,tui-vi-nu,82485562,"VÍ NÚT BẤM ĐỰNG THẺ ATM, CARD VISIT (24 NGĂN)",15000,15000,0,0
TIKI,tui-vi-nu,187843426,"Túi xách nữ dễ thương NASI T1044 vải cói pu cầm tay đẹp túi tote đeo vai có dây kéo thời trang cho nữ công sở, học sinh",69000,69000,0,0
TIKI,tui-vi-nu,77649350,"Túi đeo mini unisex cá tính Fimax cho nam nữ, túi đeo chéo nhỏ gọn với kích thước 17x15x5cm làm từ vải chống nước dùng đựng điện thoại và phụ kiện cá nhân khi đi chơi dự tiệc",199000,199000,0,0
TIKI,tui-vi-nu,81736110,"Ví da đựng thẻ ATM 24 ngăn – Bóp da 24 ngăn đựng giấy tờ nữ ( đọc kỹ hdsd) F329SP1",15000,15000,0,0
TIKI,tui-vi-nu,159787715,"Hộp Tre Xinh - Cơi Tre Bông Có Nắp 10 * 12cm",126000,242200,116200,48
TIKI,tui-vi-nu,174468730,"Ví Nữ Dài Cầm Tay PERFECT FOR YOU Chất Da Cao Cấp Cực Đẹp Nhiều Ngăn Tiện Dụng PFY02",129000,129000,0,0
TIKI,voucher-dich-vu,130470300,"[E-BOOK] Practice Tests 1-5 Key For Schools A2 File nghe Audio",10000,10000,0,0
TIKI,voucher-dich-vu,56020946,"Tôm Đất Nướng Muối Ớt Tại Nhà Hàng Cua Ngon ",160000,160000,0,0
TIKI,voucher-dich-vu,204378481,"Sách nói: Vừa Nhắm Mắt Vừa Mở Cửa Sổ",99000,99000,0,0
TIKI,voucher-dich-vu,204387092,"Sách nói: Tam Quốc Diễn Nghĩa 2",99000,99000,0,0
TIKI,voucher-dich-vu,68985679,"Học Tiếng Anh giao tiếp với người Anh (3 tháng)",8100000,8100000,0,0
TIKI,voucher-dich-vu,68985702,"Học Tiếng Anh dự thính trải nghiệm lớp học chuẩn Anh Quốc (3 tháng)",1500000,1500000,0,0
TIKI,voucher-dich-vu,6943757,"Hút chì, thải độc tố, Hồi sinh cho làn da trắng mịn công nghệ Ultrasonic Cure (90 phút)",169000,169000,0,0
TIKI,voucher-dich-vu,69139849,"VietGrow Edu - Khóa Học Biên Soạn Tài Liệu Đào Tạo Và Dẫn Giảng - Giảng Viên Dương Thanh Sơn [E-learning]",799000,799000,0,0
TIKI,voucher-dich-vu,188891936,"Sách nói: Nghệ Thuật Đàm Phán",99000,99000,0,0
TIKI,voucher-dich-vu,2065135,"Gói 10 Lần Triệt Lông Làm Gọn Vùng Bikini",801000,801000,0,0
TIKI,voucher-dich-vu,96362219,"D1-Concepts - Phiếu Quà Tặng 200k",200000,200000,0,0
TIKI,voucher-dich-vu,253665129,"Sách nói Fonos [e-voucher]: Bhagavad Gita - Những Đối Thoại Siêu Hình Thiêng Liêng",99000,99000,0,0
TIKI,voucher-dich-vu,210952870,"Phiếu Quà Tặng Carpaccio 50K",50000,50000,0,0
TIKI,voucher-dich-vu,173984166,"TRIỆT LÔNG NGUYÊN 2 CHÂN (NỮ) tại LOVE + ROSA",740000,740000,0,0
TIKI,voucher-dich-vu,138438318,"[APP] i-Learn Smart Start Special Edition 2 - Ứng dụng phần mềm tương tác sách học sinh",25000,25000,0,0
TIKI,voucher-dich-vu,34325566,"Cạo Vôi Đánh Bóng/ 2 Hàm Cấp Độ 1 Tại Nha Khoa Moli",249000,249000,0,0
TIKI,voucher-dich-vu,8157747,"Combo Cắt + Uốn (Loreal) + Nhuộm (Davines, Revlon, Prosee) + Phục Hồi Collagen Dành Cho Nữ Tại Salon Top Hair Việt Nam",1199000,1199000,0,0
TIKI,voucher-dich-vu,71188344,"Khóa học CHUYÊN ĐỀ: HÓA HỌC HỮU CƠ - thầy Lê Minh Phấn - 09 tháng",1000000,1000000,0,0
TIKI,voucher-dich-vu,155751027,"Sách nói: Từ tơ lụa đến Silicon",99000,99000,0,0
TIKI,voucher-dich-vu,207782523,"Sách nói Lập Kế Hoạch Phát Triển Kinh Doanh",99000,99000,0,0
TIKI,voucher-dich-vu,14996401,"Gói Khám Tiền Mang Thai Cho Nam Tại Phòng Khám Đa Khoa Quốc Tế Golden Healthcare",1980000,1980000,0,0
TIKI,voucher-dich-vu,72033970,"Paris Baguette - Phiếu quà tặng 30k áp dụng tại các chi nhánh",30000,30000,0,0
TIKI,voucher-dich-vu,138452552,"[E-BOOK] i-Learn Smart Start English for Science 2 File nghe Audio",10000,10000,0,0
TIKI,voucher-dich-vu,31322601,"NỐI MI CLASSIC",130000,130000,0,0
TIKI,voucher-dich-vu,15416546,"Gói Khám Toàn Diện Cho Trẻ Em Từ 5 - 9 Tuổi Tại Phòng Khám Đa Khoa Quốc Tế Golden Healthcare",1860000,1860000,0,0
TIKI,voucher-dich-vu,207903826,"Phiếu Quà Tặng Crystal Jade Palace 200K",200000,200000,0,0
TIKI,voucher-dich-vu,210965824,"Phiếu Quà Tặng PhinDeli 500K",500000,500000,0,0
TIKI,voucher-dich-vu,34325020,"Điều Trị Viêm Tủy Tại Nha Khoa Moli",999000,999000,0,0
TIKI,voucher-dich-vu,210965806,"Phiếu Quà Tặng PhinDeli 50K",50000,50000,0,0
TIKI,voucher-dich-vu,72033993,"Paris Baguette - Phiếu quà tặng 100k áp dụng tại các chi nhánh",100000,100000,0,0
TIKI,voucher-dich-vu,14998341,"Gói Khám Tầm Soát Rối Loạn Mỡ Máu Tại Phòng Khám đa Khoa Quốc Tế Golden Healthcare",540000,540000,0,0
TIKI,voucher-dich-vu,252684266,"[Hạ Long] Combo 2N1Đ Từ Hà Nội, Khách Sạn D'Lecia 4* Bãi Cháy, Xe Đưa Đón Khứ Hồi Dành Cho 01 Người",888000,888000,0,0
TIKI,voucher-dich-vu,77681856,"Tài Liệu Marketing - Gói World Class - Bài Thi Young Lions 2019 - 4 Hạng Mục Digital, Marketers, Film & Integrated, PR - Chuẩn quốc tế - Học mọi nơi - VYL_WC_30- Khóa học online [Độc Quyền AIM ACADEMY]",500000,500000,0,0
TIKI,voucher-dich-vu,155740976,"Sách nói: Lãnh Đạo Tỉnh Thức",99000,99000,0,0
TIKI,voucher-dich-vu,174481510,"TRIỆT LÔNG VÙNG NGỰC (NAM) tại LOVE + ROSA",290000,290000,0,0
TIKI,voucher-dich-vu,253689797,"Sách nói Fonos [E-voucher]: Án Mạng Trên Sân Golf",99000,99000,0,0
TIKI,voucher-dich-vu,210967764,"Phiếu Quà Tặng Sushi Tei 200K",200000,200000,0,0
TIKI,voucher-dich-vu,252683739,"Gói 2N1Đ Du Thuyền 5 Sao Aspira Cruises Đẳng Cấp Tại Hạ Long, Gồm 4 Bữa Ăn + Chèo Thuyền Kayak Khám Phá Vịnh Hạ Long - Vịnh Lan Hạ, Câu Mực Đêm",2990000,2990000,0,0
TIKI,voucher-dich-vu,71302377,"Khóa học HÌNH HỌC 7 - CƠ BẢN + NÂNG CAO thầy Lê Hải Trung- 09 tháng",700000,700000,0,0
TIKI,voucher-dich-vu,252385986,"[Đà Nẵng]-BVĐK Tâm Trí - Gói Khám Sức Khỏe Cơ Bản Từ 25-35 Tuổi",1810000,1810000,0,0
TIKI,tui-vi-nu,174531663,"Túi xách nữ Efora Sofia 3831-BR túi da thật cao cấp, xách tay, túi đeo chéo, khoác vai đi chơi đi làm",4380000,4380000,0,0
TIKI,tui-vi-nu,150991651,"Bóp ví nữ cầm tay mini V0435 Carrot bỏ túi nhiều ngăn nhỏ gọn phong cách đơn giản, thời trang, dễ thương",25000,50000,25000,50
TIKI,tui-vi-nu,51235402,"Túi đeo chéo Nữ thời trang",75000,75000,0,0
TIKI,tui-vi-nu,45324029,"Túi xách nữ cao cấp da thật ELLY – ET97",2999000,2999000,0,0
TIKI,tui-vi-nu,195331694,"Túi xách du lịch gấp gọn 2 tầng size đại nới đáy chất vải dù chống nước tiện lợi bền đẹp quai đeo chắc chắn đa năng - NGẨU NHIÊN",125000,125000,0,0
TIKI,tui-vi-nu,20849294,"Túi hộp đeo chéo nữ phong cách Vintage nhiều ngăn",55000,55000,0,0
TIKI,tui-vi-nu,185736127,"Túi xách Túi đeo vai nữ khóa đầu rồng size 18 cm cực xinh_Túi đẹp MQ189",99000,99000,0,0
TIKI,tui-vi-nu,75953993,"Túi đeo chéo nữ thời trang Hàn quốc chống thấm nước dạng trống tròn T1 BEE GEE",74000,150000,76000,51
TIKI,tui-vi-nu,172191753,"Túi đeo chéo phong cách Hàn Quốc Đồ Da Thành Long TLG 208093 2(nâu sậm)",40000,40000,0,0
TIKI,tui-vi-nu,188376754,"Túi Đeo Vai Nữ Ô Vuông Kẻ Ka Rô Sang Trọng Phong Cách Hàn Quốc",99000,99000,0,0
TIKI,tui-vi-nu,190809034,"Túi đeo chéo NASI T1032 phong cách hàn quốc túi xách nữ đeo vai thời trang dạo phố dễ thương vải đẹp",65000,65000,0,0
TIKI,tui-vi-nu,44079056,"Túi đeo chéo nữ đi tiệc đầm tròn quả cầu A09 Shalla",44550,60885,16335,27
TIKI,tui-vi-nu,249296464,"Túi Xách Nữ Thời Trang Đa Năng Thanh Lịch Sang Trọng ZTX02",195000,350000,155000,44
TIKI,tui-vi-nu,170506246,"Ví dài cầm tay nữ The Zipper Wallet chính hãng NATOLI đựng thẻ điện thoại nhiều ngăn cao cấp",489000,698000,209000,30
TIKI,tui-vi-nu,43694647,"Túi nữ thời trang phong cách Hàn Quốc Đồ Da Thành Long TLG 208098",44400,87000,42600,49
TIKI,tui-vi-nu,187103343,"Túi đeo chéo NASI T1030 phong cách hàn quốc túi xách nữ đeo vai thời trang dạo phố dễ thương vải đẹp",45000,45000,0,0
TIKI,tui-vi-nu,184071734,"Túi xách nữ/ 1992 s t u d i o/ FREYA BAG/ túi xách nữ công sở/ túi đi học/ túi đựng laptop/ họa tiết houndstooth",179000,179000,0,0
TIKI,tui-vi-nu,57946797,"Ví nữ cầm tay mini thời trang Phong cách Hàn  nhiều ngăn tiện dụng",99000,99000,0,0
TIKI,tui-vi-nu,77673726,"Túi xách nữ thời trang cao cấp ELLY- EL161",899400,1499000,599600,40
TIKI,tui-vi-nu,90163542,"Túi xách nữ công sở HOTTREND  Túi đeo chéo nữ Hàn Quốc  Deli TN46",219000,219000,0,0
TIKI,tui-vi-nu,129011339,"HJ3141-42-43-44 - Bóp nữ Huy Hoàng cao cấp 1 khóa màu da, đen, nâu, đỏ",839000,839000,0,0
TIKI,tui-vi-nu,89261210,"Túi đeo chéo trước ngực unisex nam nữ Z_TDC_ADIDA màu đen, túi bao tử phong cách thời trang hàn quốc cực xinh đựng điện thoại và phụ kiện cá nhân  khi đeo đi dạo phố dự tiệc ",88900,88900,0,0
TIKI,tui-vi-nu,31197688,"Combo Túi Xách Tay Da Nữ Có Dây Đeo Chéo và Ví Cầm Tay DM-5079 Da Mềm Bền Chắc",365000,365000,0,0
TIKI,tui-vi-nu,119329128,"Túi đeo chéo nữ, túi đựng điện thoại mini dáng dọc thời trang. Phong cách Hàn Quốc trẻ trung, năng động",149000,149000,0,0
TIKI,tui-vi-nu,130856637,"Túi tote vải canvas đeo vai cho nữ,đi học,đi làm túi quả cam quả đào",67000,67000,0,0
TIKI,tui-vi-nu,76109672,"Ví nữ cầm tay HANHSON SP000701 màu Hồng nhạt",980000,980000,0,0
TIKI,tui-vi-nu,197951883,"TÚI CLUTCH NỮ CẦM TAY THỜI TRANG DA PU CAO CẤP MÀU ĐEN TRƠN DẬP VÂN NỔI Y2883",385000,385000,0,0
TIKI,tui-vi-nu,172905215,"TÚI ĐEO CHÉO ĐỰNG ĐIỆN THOẠI CON ONG MIN I NHỎ GỌN MỚI NHẤT 2022 HUONGLANSHOP",55000,55000,0,0
TIKI,tui-vi-nu,163582757,"Túi Đựng Đồ Trang Điểm, Make Up, Mỹ Phẩm Nhiều Ngăn Tiện Lợi, Có Móc Treo [FT1",159000,159000,0,0
TIKI,tui-vi-nu,201014475,"Túi Đeo Chéo Dis.ney cho bé gái là một phụ kiện khá quen thuộc, gần gũi hàng ngày với các tín đồ thời trang",284050,284050,0,0
TIKI,tui-vi-nu,103461410,"Túi tote trong suốt hình gấu",50000,50000,0,0
TIKI,tui-vi-nu,178778056,"Túi đeo chéo nữ kiêm ví đựng điện thoại đẹp thời trang FOREVER BAELLERRY sang chảnh chất liệu da PU siêu mềm mịn VN010",129000,129000,0,0
TIKI,tui-vi-nu,136940056,"TÚI ĐEO CHÉO THỔ CẨM LOẠI ĐEO VUÔNG TRUNG",40000,40000,0,0
TIKI,tui-vi-nu,209414093,"Túi đựng điện thoại mặt cảm ứng trong suốt tiện dụng đeo chéo dáng dọc thời trang Cobala mẫu mới",182000,182000,0,0
TIKI,tui-vi-nu,190155455,"Túi Cói, Túi Tote Vẽ Mỹ Nghệ Xinh Xắn-Giỏ Xách Cỏ Bàng TXCBVBXLTK01 Chuẩn Đẹp",339000,339000,0,0
TIKI,tui-vi-nu,175811879,"Ví Nữ Cầm Tay Thời Trang JUNO Kèm Khoá Trang Trí  VI171",544000,544000,0,0
TIKI,tui-vi-nu,68793036,"Túi đeo chéo cho bé Hình Ong chấm bi LT4 Tặng combo 4 món",54450,74415,19965,27
TIKI,tui-vi-nu,76109831,"Ví nữ cầm tay HANHSON SP000702 màu Xanh Emerald",980000,980000,0,0
TIKI,tui-vi-nu,189953379,"Túi Xách _Túi Đeo Vai Nữ CNK Mini Khóa Gập Da Trần Siêu Xinh Size 18 cm",129000,129000,0,0
TIKI,tui-vi-nu,172191801,"Túi xách nữ, túi đeo chéo đeo vai nữ da thật 208227  (xanh)",400900,766000,365100,48
TIKI,tui-vi-nu,117579068,"Túi xách đeo chéo nữ đẹp-CD08",68000,68000,0,0
TIKI,tui-vi-nu,21160441,"Túi vải bố trơn có khóa kéo",45000,45000,0,0
TIKI,tui-vi-nu,149400848,"TÚI VẢI NHUNG ĐEO VAI HÌNH GẤU XINH XẮN ĐI HỌC ĐI CHƠI TOTE CÓ TÚI CON DV10",75900,75900,0,0
TIKI,tui-vi-nu,5003323,"Túi Xách Nữ Cao Cấp Da Thật Elly ET54",1624350,2499000,874650,35
TIKI,tui-vi-nu,53026947,"Túi đeo chéo bụng bao tử da loại 1 thời trang dạo phố  SKT20 Shalla",94333,136259,41926,31
TIKI,tui-vi-nu,87100259,"Balo thời trang, balo đi học, đựng laptop Túi Tote Mèo Mắt Long Lanh Mèo Cute balo nữ vải",68100,68100,0,0
TIKI,tui-vi-nu,97707630,"Túi xách nữ thời trang công sở cao cấp phong cách mới",441000,490000,49000,10
TIKI,tui-vi-nu,4982335,"Túi Đeo Chéo Nữ Ulzzang Trong Suốt Kèm Ví Nhỏ",57420,82940,25520,31
TIKI,tui-vi-nu,125757916,"Túi xách nữ kẹp nách khoá vuông phối vải kẻ sọc️freeship️",55000,55000,0,0
TIKI,tui-vi-nu,193568721,"Túi Xách Nữ Đeo Chéo Đeo Vai Cao Cấp NUTUSHOP - NT88",299000,299000,0,0
TIKI,tui-vi-nu,97875867,"Ví đựng thẻ, đựng giấy tờ, thẻ ATM loại đẹp TK0087",15000,30000,15000,50
TIKI,tui-vi-nu,172374525,"Ví nữ mini nắp cách điệu YUUMY Seasand YV59",75000,150000,75000,50
TIKI,tui-vi-nu,177187685,"Túi xách nữ thời trang công sở cao cấp phong cách mới",441000,490000,49000,10
TIKI,tui-vi-nu,147943335,"Túi Xách Nữ Kẹp Nách Chính Hãng MICOCAH Dáng Công Sở Đeo Chéo Đeo Vai Phong Cách Ulzzang Siêu Đẹp MC02 - Tukado",389000,389000,0,0
TIKI,tui-vi-nu,44010126,"Túi dự tiệc cưới, túi cầm tay nữ nhỏ, hoa tiết nhỏ nhắn, sang trọng (Nhiều mẫu mã để chọn)",175000,250000,75000,30
TIKI,tui-vi-nu,178007821,"Túi Tote Xách Vải Bố Canvas Grepaco Thời Trang Nữ Đeo Vai Màu Đen Size To (Lớn) In Chữ Có Ngăn Phụ Bên Trong, Dành Cho Công Sở Đi Làm, Sinh Viên Đi Học, Chơi Du Lịch, Picnic, Gym, Shopping - Hàng Chính Hãng",75050,79000,3950,5
TIKI,tui-vi-nu,86560930," Túi đeo chéo nữ    Túi xách nữ mini dây xích SANG CHẢNH TD18",65000,65000,0,0
TIKI,tui-vi-nu,185073370,"Túi xách nữ Oscar - OCWHBSG 055",2490000,2490000,0,0
TIKI,tui-vi-nu,126512059,"Túi đeo chéo nữ LATA HN88",450000,450000,0,0
TIKI,tui-vi-nu,160314545,"Túi Xách Nữ Đeo Chéo Chính Hãng MICOCAH Dáng Công Sở Thời Trang Chất Da Cao Cấp Cực Đẹp MC79 - Micocah Mall",429000,429000,0,0
TIKI,tui-vi-nu,56993030,"Túi đeo chéo nữ Hàn Quốc cao cấp họa tiết kẻ caro",149000,149000,0,0
TIKI,tui-vi-nu,167682901,"Túi đeo chéo nữ mini đựng điện thoại YUUMY YN120",165000,270000,105000,39
TIKI,tui-vi-nu,93291302,"Marhen.J - Túi đeo vai chữ nhật vải bố Rico Mini MJ19BRCOMN-WI",2290000,2290000,0,0
TIKI,tui-vi-nu,186860436,"Ví Đựng Hộ Chiếu Passport Nam Nữ Cao Cấp, Da Bò PULL-UP Mềm Mại, Thiết Kế Hiện Đại - Đa Năng, Đựng Được Nhiều Loại Hộ Chiếu, Nhiều Ngăn Thẻ ATM, Đựng Tiền, Vé Máy Bay, Tiện Dụng Khi Đi Du Lịch, Công Tác - Hàng Chính Hãng SAIGIO",1181000,1199000,18000,2
TIKI,tui-vi-nu,160058433,"Túi tote thời trang May 10",189000,189000,0,0
TIKI,tui-vi-nu,191309776,"Marhen.J - Túi đeo vai nữ chữ nhật Milly Nano MJ21AMLYNA-BK",2890000,2890000,0,0
TIKI,tui-vi-nu,160314806,"Túi Xách Nữ Đeo Chéo Chính Hãng FORERVER YOUNG Dáng Công Sở Thời Trang Da Sần Cao Cấp Nhiều Ngăn Tiện Dụng FY24",489000,489000,0,0
TIKI,tui-vi-nu,185955256,"Túi xách nữ vải canvas thời trang cao cấp phong cách cá tính mới",288000,320000,32000,10
TIKI,tui-vi-nu,154881116,"(Ảnh thật)Túi Cói Merci Loại 1 Màu Sáng, Có Đệm Đáy Giữ Form Túi, Có Lót, Túi Du Lịch",43000,54900,11900,22
TIKI,tui-vi-nu,90529784,"Túi xách nữ thời trang cao cấp",423000,470000,47000,10
TIKI,tui-vi-nu,169600256,"Túi Xách Nam, Nữ, Túi Đeo Chéo Unisex Dành Cho Nam Nữ, Túi Vải Canvas Đeo Chéo Phong Cách Cá Tính - OTV120 - Ope Store",160000,160000,0,0
TIKI,tui-vi-nu,191775236,"Túi Xách Nữ Kẹp Nách Chính Hãng MICOCAH Dáng Công Sở Thời Trang Chất Da Lộn Cao Cấp Phối Màu Vintage Sang Trọng MC141 - Micocah",449000,449000,0,0
TIKI,tui-vi-nu,188940966,"Túi xách túi đeo vai nữ thời trang cao cấp phong cách mới",477000,530000,53000,10
TIKI,tui-vi-nu,7939593,"Túi đựng điện thoại đeo chéo nữ thời trang mini bag",79101,108104,29003,27
TIKI,tui-vi-nu,86560855,"Túi xách nữ    Túi Retro sang chảnh TD10",135000,135000,0,0
TIKI,tui-vi-nu,67451622,"Túi đeo chéo nữ cúc họa mi nhỏ xinh TX38",60000,60000,0,0
TIKI,tui-vi-nu,144637552,"Túi xách , túi đeo vai nữ CG219 thời trang Hàn Quốc trẻ trung",129000,129000,0,0
TIKI,tui-vi-nu,146945565,"Túi xách đeo chéo nữ đẹp đi chơi phong cách thời trang hàn quốc giá rẻ dễ thương cute DC257",60870,60870,0,0
TIKI,tui-vi-nu,82880369,"TÚI VÍ  NỮ DA PHONG CÁCH HÀN QUỐC ĐỂ ĐIỆN THOẠI – SIÊU XINH – NĂNG ĐỘNG VÀ TIỆN ÍCH",53000,53000,0,0
TIKI,tui-vi-nu,48655157,"Túi Đeo Chéo Nữ 2 Ngăn Đựng  Được Điện Thoại  Có Móc Gấu SK11810",75000,75000,0,0
TIKI,voucher-dich-vu,122868490,"[E-BOOK] i-Learn Smart World 8 File nghe Audio",10000,10000,0,0
TIKI,voucher-dich-vu,188846705,"Tour trọn gói 3N2Đ: Ninh Chữ  - Bình Lập [E-Voucher Siêu Sale]",4250000,4250000,0,0
TIKI,voucher-dich-vu,117029040,"Evoucher - VMonkey (Trọn đời, 1 năm) Phần mềm Học tiếng Việt theo Chương trình GDPT Mới cho trẻ Mầm non & Tiểu học",369000,369000,0,0
TIKI,voucher-dich-vu,137250421,"[E-BOOK] New Amanda & Friends 3 Bộ tranh hình",15000,15000,0,0
TIKI,voucher-dich-vu,122642436,"[E-BOOK] CYLET Practice Tests Pre A2 Flyers Sách mềm sách học sinh",15000,15000,0,0
TIKI,voucher-dich-vu,77661763,"Tài Liệu Marketing - Gói Standard - Bài Thi Vietnam Young Lions 2020 - Video Case - Hạng Mục Marketers- Chuẩn quốc tế - Học mọi nơi  - VYLVC11 - Khóa học online [Độc Quyền AIM ACADEMY]",150000,150000,0,0
TIKI,voucher-dich-vu,204340607,"T9. TOUR BẮC ĐẢO KÉO CÁ LẶN NGẮM SAN HÔ 01 NGÀY LÀM NGƯ DÂN - PHÚ QUỐC",950000,950000,0,0
TIKI,voucher-dich-vu,252258349,"[Voucher 12 tháng] Bộ công cụ Học - Thi - Hướng nghiệp lớp 9, VitanEdu",600000,600000,0,0
TIKI,voucher-dich-vu,140170384,"[KHÓA HỌC ONLINE TƯƠNG TÁC] Khóa Học Navisworks Manage-Đại học Xây Dựng (Tương tác trực tiếp với giảng viên qua Zoom)",1000000,1000000,0,0
TIKI,voucher-dich-vu,243043191,"Voucher Tẩy Tế Bào Chết (Mặt) - Chang Nails",10000,16000,6000,38
TIKI,voucher-dich-vu,206677711,"Sách nói: Bản Ngã - Thấu Hiểu Và Tan Biến",99000,99000,0,0
TIKI,voucher-dich-vu,189179492,"Tư vấn, hỗ trợ đăng ký kinh doanh",5500000,5500000,0,0
TIKI,voucher-dich-vu,68856944,"VietGrow Edu - Khóa Học Thực Hành Kỹ Năng Lãnh Đạo - Giảng Viên Võ Thái Lâm [E-learning]",1980000,1980000,0,0
TIKI,voucher-dich-vu,205538845,"Vé Núi Thần Tài - Gói Tích Lộc (Vé Vào Cổng +Vui Chơi + Ăn Trưa)",340000,340000,0,0
TIKI,voucher-dich-vu,91545630,"Chữ ký số  FAST-CA gói 01 năm tặng 1 năm",1435000,1435000,0,0
TIKI,voucher-dich-vu,179952300,"[Giftpop] Phiếu Quà Tặng TOUS les JOURS 200K",200000,200000,0,0
TIKI,voucher-dich-vu,117293137,"Khóa học Toán Tiếng Anh Hệ Cambridge: Stage 6 - Lớp 5 - [TOT.EDU.VN]",1999000,1999000,0,0
TIKI,voucher-dich-vu,101826839,"Iseul Spa - Voucher Triệt Lông",299000,299000,0,0
TIKI,voucher-dich-vu,50068515,"Massage Giảm Mỡ Bụng - Giá Sốc Cho Mẹ Sau Sinh, Vòng 2 Quá Khổ",250000,250000,0,0
TIKI,voucher-dich-vu,120422809,"[E-BOOK] i-Learn Smart Start English for Science 1 Sách mềm sách học sinh",15000,15000,0,0
TIKI,voucher-dich-vu,204432567,"Tictop - Phần Mềm Quản Lý Công Việc phiên bản EFFICIENT / TICTOP-EFFICIENT",225000,225000,0,0
TIKI,voucher-dich-vu,262651801,"Phú Quốc [E-Voucher] Tour 4 đảo Phú Quốc & Cáp treo Hòn Thơm -  CÀNG MUA CÀNG GIẢM",860000,860000,0,0
TIKI,voucher-dich-vu,68719297,"VietGrow Edu - Khóa Học Trực Tuyến Kỹ Năng Hợp Tác - Giảng Viên Phạm Hoàng Thái Dương [E-learning]",499000,499000,0,0
TIKI,voucher-dich-vu,242222882,"[Bến Thành] Vũ - Trang - Thái Đinh - Indie Night - Bước qua mùa cô đơn",1000000,1000000,0,0
TIKI,voucher-dich-vu,112694411,"Quà Tặng Sách Nói: Hành Trình Về Phương Đông - Kèm Dịch Vụ Sinh Trắc Vân Tay – Phân Tích Tính Cách Hành Vi Cơ Bản",40000,40000,0,0
TIKI,voucher-dich-vu,8158657,"Combo 1: Cắt + Uốn / Nhuộm + Phục Hồi Colagen Dành Cho Nam Tại Top Hair Salon",399000,399000,0,0
TIKI,voucher-dich-vu,68721020,"VietGrow Edu - Khóa Học Trực Tuyến Quản Lý Thời Gian - Giảng Viên Trần Bằng Việt [E-learning]",599000,599000,0,0
TIKI,voucher-dich-vu,249931074,"Bánh đồng tiền mix hạt Bảo An",85000,85000,0,0
TIKI,voucher-dich-vu,34324987,"Điều Trị Tủy Răng Sữa Tại Nha Khoa Moli",149000,149000,0,0
TIKI,voucher-dich-vu,213587555,"[E-Voucher] Gói học online theo môn - Lớp 4 (12 tháng) - Phần mềm học tập dành cho trẻ tiểu học",120000,120000,0,0
TIKI,voucher-dich-vu,117569346,"Khóa học Cải thiện NÃO BỘ và NGỦ NGON bằng xoa bóp, bấm huyệt - VMC",600000,600000,0,0
TIKI,voucher-dich-vu,246856239,"[E-Voucher] Sách nói Fonos: Quản Lý Nhân Sự Trong Thời Đại Số",99000,99000,0,0
TIKI,voucher-dich-vu,213587562,"[E-Voucher] Gói học online theo môn - Lớp 5 (12 tháng) - Phần mềm học tập dành cho trẻ tiểu học",120000,120000,0,0
TIKI,voucher-dich-vu,105836073,"ELLY - Phiếu Quà Tặng 500.000đ",500000,500000,0,0
TIKI,voucher-dich-vu,272072269,"[E-Voucher] KHÁM PHÁ HÒA PHÚ THÀNH - ĐÀ NẴNG",799000,799000,0,0
TIKI,voucher-dich-vu,129947401,"[APP] i-Learn Smart Start Level 4 - Ứng dụng phần mềm tương tác sách học sinh",25000,25000,0,0
TIKI,voucher-dich-vu,188621513,"[EVoucher Vietravel] Hà Nội - Sapa- Ninh Bình- Bái Đính- Hạ Long - Đảo Titốp - Yên Tử",11990000,11990000,0,0
TIKI,voucher-dich-vu,262637801,"Evoucher - Phiếu Quà Tặng Matsuri Japanese Restaurant 1000K",1000000,1000000,0,0
TIKI,voucher-dich-vu,188700999,"[EVoucher Vietravel] Combo 4N3Đ KS The Light Hà Nội 4 Sao: VMB khứ hồi Hồ Chí Minh - Hà Nội + Phòng Tiêu Chuẩn + Ăn sáng",3690000,3690000,0,0
TIKI,voucher-dich-vu,72210877,"KHÓA HỌC HCM - KHUNG NĂNG LỰC - NÂNG CAO",9999000,9999000,0,0
TIKI,balo-va-vali,113151412,"Balo denim",180000,180000,0,0
TIKI,balo-va-vali,264018910,"Vascara Balo Du Lịch Phối Vải Dù - BAC 0189",977000,977000,0,0
TIKI,balo-va-vali,106757212,"Túi xách du lịch thể thao nam công suất lớn chất lượng cao cấp",513000,570000,57000,10
TIKI,balo-va-vali,6998659,"Balo Minecraft",239000,239000,0,0
TIKI,balo-va-vali,790958,"Cặp Đựng Laptop Dell 15.6inch G&B 01 CAPLDELL01 - Đen",98000,98000,0,0
TIKI,balo-va-vali,271396032,"Túi du lịch nam da bò sáp cao cấp 1219-1",3090000,3090000,0,0
TIKI,balo-va-vali,98053964,"Túi chống sốc Laptop, Macbook viền da kèm khe cắm bút và khe sạc cao cấp",249000,249000,0,0
TIKI,balo-va-vali,172192390,"Túi đeo ngực thời trang du lịch phong cách Quân đội Mỹ 208128 3(kaki)",90000,90000,0,0
TIKI,balo-va-vali,198223485,"Balo Mini Nhỏ Xinh Chim Cánh Cụt Bl25 Da Trơn Mới",56000,85000,29000,34
TIKI,balo-va-vali,95395106,"Túi Đựng Hành Lý Du Lịch Cỡ Đại Cho Nam Và Nữ Đồ Da Thành Long TLG 208139",100000,153400,53400,35
TIKI,balo-va-vali,26340527,"Balo Sakos HERO",1332000,1332000,0,0
TIKI,voucher-dich-vu,54999656,"NEWSTAR TRAVEL - Tour Trong Ngày Miệt Vườn Mỹ Tho - Bến Tre",850000,850000,0,0
TIKI,voucher-dich-vu,246856334,"[E-Voucher] Sách nói Fonos; Xây Dựng Câu Chuyện Thương Hiệu",99000,99000,0,0
TIKI,voucher-dich-vu,270765390,"TTC Premium Hotel Cần Thơ 4* - Ngay Bến Ninh Kiều, Có Buffet Sáng, Hồ Bơi, Khách Sạn Vị Trí Thuận Tiện Tham Quan và nhiều ưu đãi hấp dẫn",1098000,1098000,0,0
TIKI,balo-va-vali,121329361,"Hàng Hót Balo thời trang balo nam nữ dáng to",159000,159000,0,0
TIKI,balo-va-vali,131144692,"Balo Laptop 13 - 14 inch cỡ nhỏ SimpleCarry M-city, siêu bền, siêu nhẹ",550000,550000,0,0
TIKI,voucher-dich-vu,76693953,"Khóa học Hoàn thành mọi việc với Kanban - Kỹ năng Quản lý Cá nhân - Agilearn | Giải pháp Đào tạo Số hàng đầu cho Doanh nghiệp tại Việt Nam",690000,690000,0,0
TIKI,voucher-dich-vu,77691294," Tài Liệu Marketing - Gói World Class - Bài Thi Young Spikes 2019 - 3 Hạng Mục Digital, Integrated, PR - Chuẩn quốc tế - Học mọi nơi - VYLWC32- Khóa học online - [Độc Quyền AIM ACADEMY]",500000,500000,0,0
TIKI,balo-va-vali,147896554,"Set Balo 4 Món, Balo Combo 4 Món, Balo Nữ, Balo Nam, Balo Thời Trang, Balo Đi Học - Set Balo 4 Món Gâu Cute",121000,121000,0,0
TIKI,balo-va-vali,90209202,"Túi đeo chéo chống va đập Tomtoc Eva for Macbook Pro 13'' Gray (A25-C02G) - Hàng Chính Hãng",1259000,1259000,0,0
TIKI,voucher-dich-vu,20102345,"M Fitnsee Club - Trải Nghiệm 01 Buổi Bơi Chuẩn 5 Sao Không Giới Hạn Thời Gian Bơi",195000,195000,0,0
TIKI,balo-va-vali,119696670,"Túi bạt dứa đựng chăn quần áo mọi kích thước siêu to, siêu rẻ, siêu bền chống thấm nước. Vật dụng cần thiết trong mỗi gia đình",10000,10000,0,0
TIKI,voucher-dich-vu,55028888,"Gói Khám Tổng Quát Sức Khoẻ Răng Miệng ",350000,350000,0,0
TIKI,voucher-dich-vu,19258022,"Combo Chăm Sóc Da Mụn Ở Vùng Mặt Và Trị Mụn Ở Vùng Lưng Tại Mẹ & Em Spa ",499000,499000,0,0
TIKI,balo-va-vali,12020808,"Ba Lô Laptop Campus Cao Cấp PRAZA - BLTK174",149000,149000,0,0
TIKI,balo-va-vali,86159369,"Túi Đựng Mỹ Phẩm Vật Dụng Du Lịch Washbag Cỡ Trung Kích Thước 26x10x15cm Chất Liệu PU TPU Chống Thấm",79000,79000,0,0
TIKI,voucher-dich-vu,21761407,"Tick Edu - Tăng trưởng doanh số bán hàng nhờ chiến lược khuyến mãi",399000,399000,0,0
TIKI,voucher-dich-vu,162512656,"Phiếu Quà Tặng Ngân ĐÌnh Restaurant 100K",100000,100000,0,0
TIKI,voucher-dich-vu,141953827," TUYỆT KỸ GIAO TIẾP TIẾNG ANH CÔNG SỞ - ELEVATOR SPEECH",98000,98000,0,0
TIKI,balo-va-vali,7430633,"Balo Mikkor The Nomad Premier Charcoal 15.6inch",590000,590000,0,0
TIKI,balo-va-vali,254092530,"Balo Nữ Thời Trang Cao Cấp Elly EBH13",1499000,1499000,0,0
TIKI,voucher-dich-vu,77682749,"Tài Liệu Marketing - Gói World Class - Bài Thi Young Lions 2017 + 2018 + 2019 - Hạng Mục Digital, Marketers, Film & Integrated, PR - Chuẩn quốc tế - Học mọi nơi - VYLWC31- Khóa học online - [Độc Quyền AIM ACADEMY]",750000,750000,0,0
TIKI,voucher-dich-vu,76693893,"PMX - Khóa học Quản trị dự án - Kỹ năng Quản lý - Agilearn | Giải pháp Đào tạo Số hàng đầu cho Doanh nghiệp tại Việt Nam",780000,780000,0,0
TIKI,voucher-dich-vu,21775478,"Tick Edu - Kungfu Bán Hàng Triệu Đô",999000,999000,0,0
TIKI,voucher-dich-vu,160901190,"Sinh Trắc Vân Tay Gen Talents – Dịch Vụ Tư Vấn Sinh Trắc Vân Tay Gia Đình – Gói Phân Tích Demo – Tặng Sách Nhà Giả Kim",600000,600000,0,0
TIKI,voucher-dich-vu,249673480,"Tour 5N4Đ Đài Loan - Đài Bắc - Đài Trung - Cao Hùng, Khởi Hành Tháng 5, 6 ,7",12568000,12568000,0,0
TIKI,balo-va-vali,269902465,"TÚI DÂY RÚT HÌNH DORAEMON VẢI MỘC THÔ ĐỰNG VỚ VÀ PHỤ KIỆN",12000,12000,0,0
TIKI,balo-va-vali,11423361,"Túi Trùm Vali Cao Cấp KOS, Vải Thun Co Giãn 4 Chiều, Bọc Vali Chống Trầy, Chống bụi - Áo trùm Vali Size S",250000,250000,0,0
TIKI,voucher-dich-vu,95044323,"Sách nói: OKRs - Hiểu Đúng, Làm Đúng - Cách Để Áp Dụng Thành Công OKRs Ngay Từ Đầu",99000,99000,0,0
TIKI,voucher-dich-vu,21775455,"Tick Edu - Nghệ Thuật Chăm Sóc Khách Hàng Xuất Sắc",799000,799000,0,0
TIKI,balo-va-vali,31811041,"Balo Mèo Vải Bố Cao Cấp AT12",169000,169000,0,0
TIKI,balo-va-vali,15512269,"Túi Chống Sốc Tomtoc A13 (Usa) 360° Protective Surface, Laptop, Macbook Pro 13” Light Blue",800000,800000,0,0
TIKI,voucher-dich-vu,159397242,"VOUCHER SỬA CHỮA HÀNG HIỆU CHUYÊN SÂU GIẢM 499.000VNĐ CHO ĐƠN HÀNG TỪ 2.500.000VNĐ",100000,100000,0,0
TIKI,voucher-dich-vu,187792643,"Dubai | Abu Dhabi (4N4Đ)",28890000,28890000,0,0
TIKI,voucher-dich-vu,122502105,"[APP] i-Learn Smart Start English for Science 2 - Ứng dụng phần mềm tương tác sách học sinh",25000,25000,0,0
TIKI,voucher-dich-vu,76693576,"OKRX - Khóa học Quản trị mục tiêu hiện đại với OKR - Kỹ năng Quản lý - Agilearn | Giải pháp Đào tạo Số hàng đầu cho Doanh nghiệp tại Việt Nam",1270000,1270000,0,0
TIKI,voucher-dich-vu,271726139,"Xe bus Đà Nẵng - Huế (một chiều)/ Shuttle Bus Da Nang to Hue (one way)",230000,230000,0,0
TIKI,balo-va-vali,173856961,"Set balo 4 món sư tử",99000,99000,0,0
TIKI,voucher-dich-vu,229973539,"Phiếu Quà Tặng Potico 1000K",1000000,1000000,0,0
TIKI,balo-va-vali,174665640,"Túi xách chính hãng TOMTOC (USA) Spill-Resistant - A22-E02 cho Macbook Pro 16 inch",949000,949000,0,0
TIKI,voucher-dich-vu,95175053,"Sách nói: Nhà Tiên Tri Vanga Và Vũ Trụ Huyền Bí",99000,99000,0,0
TIKI,voucher-dich-vu,21787118,"Tick Edu - Thai Giáo - Phát Triển Trí Tuệ Và Cảm Xúc Cho Con Từ Trong Bụng Mẹ",699000,699000,0,0
TIKI,balo-va-vali,78487645,"Balo laptop Sakos Carbon I15 (Tặng túi Festival Mini để điện thoại)",1385000,1385000,0,0
TIKI,balo-va-vali,185242745,"Túi xách du lịch thể thao nam đa năng cao cấp phong cách châu âu",1215000,1350000,135000,10
TIKI,voucher-dich-vu,100931478,"Iseul Spa - Voucher Tái Sinh Da Kim Cương Đa Tầng ( Combo 2 lần )",1500000,1500000,0,0
TIKI,balo-va-vali,129147528,"Balo Laptop Chống Nước 16 Inch Cao Cấp Nam Nữ Kim Long Kl032 - Thời Trang Ti Ti",435000,580000,145000,25
TIKI,balo-va-vali,242452549,"Cặp đựng laptop, cặp da công sở Huabups nhiều ngăn tiện dụng rất thanh lịch và sang trọng_0906",755000,755000,0,0
TIKI,balo-va-vali,34273743,"Balo laptop 15.6 inch Mikkor Lewie Backpack Light Grey",750000,750000,0,0
TIKI,balo-va-vali,4902563,"Balo Du Lịch Phượt Cao Cấp 35L - BL23",102960,148720,45760,31
TIKI,voucher-dich-vu,141349351,"[KHÓA HỌC ONLINE TƯƠNG TÁC] Học Revit Architecture (Cơ Bản+Nâng Cao)-(Tương tác trực tiếp với giảng viên qua Zoom)",2450000,2450000,0,0
TIKI,balo-va-vali,164346152,"Túi xách du lịch thể thao nam công suất lớn chất lượng cao cấp",531000,590000,59000,10
TIKI,voucher-dich-vu,174856854,"[E-BOOK] i-Learn Smart Start Special Edition 1 Kế hoạch giảng dạy",15000,15000,0,0
TIKI,balo-va-vali,76551330,"Bao da Cặp da Túi da đựng dành cho Macbook Air / Macbook Pro / Surface Pro / Surface Laptop / Laptop Asus / Laptop HP / Laptop Dell XPS / Laptop Acer / Laptop Lenovo / Laptop 13 inch",369000,369000,0,0
TIKI,balo-va-vali,195960879,"Cặp Da Công Sở Nam Đựng Vừa Laptop 14 inch Jusendaisu",289000,289000,0,0
TIKI,balo-va-vali,32436424,"Cặp xách Laptop 15.6 inch chống sốc nhiều ngăn tiện lợi",349000,349000,0,0
TIKI,voucher-dich-vu,272398026,"VŨNG TÀU HÀNH HƯƠNG 10 CẢNH CHÙA",590000,590000,0,0
TIKI,balo-va-vali,85376332,"Ba lô Mikkor The Ace - Navy",950000,950000,0,0
TIKI,voucher-dich-vu,160946427,"Sinh Trắc Vân Tay Gen Talents – Dịch Vụ Tư Vấn Sinh Trắc Vân Tay Gia Đình – Gói Phân Tích Demo – Tặng Sách Trở Về Từ Cõi Sáng",600000,600000,0,0
TIKI,voucher-dich-vu,271734119,"Xe bus Huế - Đà Nẵng (một chiều)/ Shuttle Bus Hue to Da Nang (one way)",230000,230000,0,0
TIKI,voucher-dich-vu,174860036,"[E-BOOK] i-Learn Smart Start Special Edition 2 Giáo án gợi ý",15000,15000,0,0
TIKI,balo-va-vali,81436803,"Túi Xách Thời Trang Công Sở Nữ Dành Cho Các Dòng Laptop 13.3''-M401 - Hàng Nhập Khẩu",1050000,1050000,0,0
TIKI,voucher-dich-vu,141956188,"CHUỖI HỘI THẢO TIẾNG ANH ONLINE CHO NGƯỜI ĐI LÀM - TOÀN QUỐC",1998000,1998000,0,0
TIKI,voucher-dich-vu,21775422,"Tick Edu - Bí Quyết Xây Dựng Mối Quan Hệ Trong Kinh Doanh",699000,699000,0,0
TIKI,voucher-dich-vu,136942959,"[E-BOOK] Summer Camp starter Pre A1 Starters Sách giáo viên điện tử",15000,15000,0,0
TIKI,voucher-dich-vu,98823444,"Jeonbok - Phiếu Quà Tặng 50K",50000,50000,0,0
TIKI,balo-va-vali,78889340,"Túi du lịch BUNKER NG00 (Đen)",945000,945000,0,0
TIKI,balo-va-vali,179945833,"Vali hợp kim nhôm nguyên khối MS1318 Macsim cao cấp màu đen , Màu bạc, màu Ti-gold cỡ 28inches",10164000,10164000,0,0
TIKI,voucher-dich-vu,270122637,"The Cliff Resort 4* Mũi Né - Buffet Sáng Free, Hồ Bơi, Bãi Biển Riêng, Không Gian Xanh Mát, Nghỉ Dưỡng Đẳng Cấp Phan Thiết Và Nhiều Dịch Vụ Hấp Dẫn",1949000,1949000,0,0
TIKI,voucher-dich-vu,161026807,"Sinh Trắc Vân Tay Gen Talents – Dịch Vụ Tư Vấn Sinh Trắc Vân Tay Gia Đình – Gói Phân Tích Demo – Tặng Sách Điều Kỳ Diệu Của Tiệm Tạp Hóa NAMIYA (Tái Bản)",600000,600000,0,0
TIKI,voucher-dich-vu,271975247,"[E-voucher Sannatour] Cổng trời Đông Giang",145000,145000,0,0
TIKI,tui-vi-nu,193748267,"Túi xách thời trang nữ CK23705",530000,530000,0,0
TIKI,tui-vi-nu,149449322,"TÚI KẸP NÁCH 2 DÂY- TÚI ĐEO CHÉO TAY KHÓA HÌNH CHỮ D 3 MÀU ĐEN TRẮNG BE SIÊU ĐẸP 2021",145000,145000,0,0
TIKI,tui-vi-nu,149449389,"Túi đeo chéo nữ đẹp da cao cấp",101000,101000,0,0
TIKI,tui-vi-nu,176051064,"LỐ 10 TÚI RÚT NHUNG FORM BẦU MÀU XÁM",45000,45000,0,0
TIKI,tui-vi-nu,115439236,"VÍ DA NAM NỮ CẦM TAY",167000,167000,0,0
TIKI,tui-vi-nu,188059099,"Túi Đeo Chéo Dạo Phố Dành Cho Nam Nữ (Tặng Kèm Móc Khóa)",419000,419000,0,0
TIKI,tui-vi-nu,173265310,"Túi nữ thời trang phong cách sang trọng 208093",44400,72500,28100,39
TIKI,tui-vi-nu,180720275,"Túi Xách Thời Trang Nữ Da Thật Cao Cấp Gence TX05 Vàng",1650000,1650000,0,0
TIKI,tui-vi-nu,44140062,"Túi xách da bò công sở cao cấp phong cách châu âu",801000,890000,89000,10
TIKI,tui-vi-nu,180046006,"Túi đeo chéo nữ thời trang cao cấp phong cách mới",171000,190000,19000,10
TIKI,tui-vi-nu,173028224,"Túi ví phong bì da cừu Đồ Da Thành Long TLG 208236 + móc khóa la bàn cao cấp - không thể rẻ hơn",45800,50000,4200,8
TIKI,tui-vi-nu,8281119,"Túi Vải Canvas - But First Coffee",121000,169000,48000,28
TIKI,tui-vi-nu,54364258,"Túi đeo chéo nữ thời trang, Túi mini size dễ thương vô cùng luôn",160000,160000,0,0
TIKI,tui-vi-nu,2020657,"Ví Nữ Da Đà Điểu 1 Khóa Vip Huy Hoàng HT3429 (19 x 10.5 cm) - Đen",1399000,1399000,0,0
TIKI,tui-vi-nu,187697389,"Túi xách nữ dễ thương NASI T1039 túi cói cầm tay đẹp có nút gài thời trang cho nữ công sở, học sinh",29000,29000,0,0
TIKI,tui-vi-nu,90326354,"Túi đeo thời trang nữ bằng da nhiều màu",71000,71000,0,0
TIKI,tui-vi-nu,160346007,"túi xách chấm bi C30019-0148",899000,899000,0,0
TIKI,tui-vi-nu,182148174,"Túi Tote Da Vừa A4 Dây Đeo Có Nấc Tuỳ Chỉnh Hàng Da Dày Dặn",155000,155000,0,0
TIKI,tui-vi-nu,156729826,"Ví nhỏ cầm tay nữ da thật 9x13 VN07",157500,157500,0,0
TIKI,tui-vi-nu,172191291,"Túi nữ thời trang phong cách Hàn Quốc Đồ Da Thành Long TLG 208098 3(đỏ)",40000,40000,0,0
TIKI,tui-vi-nu,25135379,"Túi Vải Canvas PINK Đeo Vai Siêu Hot ",97000,97000,0,0
TIKI,tui-vi-nu,77444506," Ví Cầm Tay Nữ - Bóp Cầm Tay Nữ - Ví Dự Tiệc - Bóp Dự Tiệc - Clutch (VI-NU-059) MUA NHIỀU GIẢM GIÁ ",359000,359000,0,0
TIKI,tui-vi-nu,95394320,"Túi đeo chéo da thật cao cấp 208235",206200,225000,18800,8
TIKI,tui-vi-nu,149245843,"Túi thời trang nữ da bò thật",5000000,5000000,0,0
TIKI,tui-vi-nu,180029939,"Túi phụ kiện đựng đồ cá nhân chính hãng UAG dòng Mouve",350000,350000,0,0
TIKI,tui-vi-nu,153411140,"Túi Đeo Chéo Mini Cho Bé POP IT Phiên Bản Gỉai Tỏa Căng Thẳng Nhiều Màu",39000,65000,26000,40
TIKI,tui-vi-nu,149449354,"(NEW) Túi Vải/ Tote Đeo Chéo - Đeo Vai - Đi Học Cho Sinh Viên Ullzang Chất Vải Dày Dặn Tặng Kèm Gấu NEVA869",243000,243000,0,0
TIKI,tui-vi-nu,114119939,"túi đeo chéo nữ đẹp - Túi đeo chéo da Hàn Quốc",209000,209000,0,0
TIKI,tui-vi-nu,147489111,"Túi kẹp nách, Túi đeo vai, Túi cầm tay bằng da PU trơn kiểu dáng đơn giản hợp thời trang, rộng rãi",99000,99000,0,0
TIKI,tui-vi-nu,174531649,"Túi xách nữ Efora Viola 3609-WHI túi da thật cao cấp, xách tay, túi đeo chéo, khoác vai đi chơi đi làm",4380000,4380000,0,0
TIKI,tui-vi-nu,174511265,"Túi nữ thời trang phong cách Hàn quốc 205954 1 (Đen)",30000,30000,0,0
TIKI,tui-vi-nu,103459752,"Túi đeo chéo Bubble",105000,105000,0,0
TIKI,tui-vi-nu,174531702,"Túi xách nữ Efora Sofia 3831-BL túi da thật cao cấp, xách tay, túi đeo chéo, khoác vai đi chơi đi làm",4380000,4380000,0,0
TIKI,tui-vi-nu,210414149,"Túi Xách Đeo Chéo Nữ Công Sở Đi Tiệc Dạo Phố Cao Cấp Đường May Đẹp LH118",835000,835000,0,0
TIKI,tui-vi-nu,77446157,"TÚI XÁCH NỮ ĐEO CHÉO (TX-081-1)",69000,69000,0,0
TIKI,tui-vi-nu,109286610,"Ví Nữ Ngắn Khóa Trái tim Siêu Xinh VN03",27500,55000,27500,50
TIKI,tui-vi-nu,248355440,"Túi Xách Công Sở, Túi Xách Công Sở Nữ Da PU Thời Trang, Túi Công Sở Nữ Size To Đi Làm, Đi Chơi, Túi Tote Da Cỡ Lớn - OTV230 - Ope Store",350000,350000,0,0
TIKI,tui-vi-nu,45412206,"TÚI XÁCH DÁNG HỘP KHÓA CHỮ NHẬT TX002",1500000,1500000,0,0
TIKI,tui-vi-nu,161560563,"Túi xách nữ thời trang phong cách Thành Long TLG 208094 Tặng túi đựng mỹ phẩm tiện lợi",55600,75000,19400,26
TIKI,tui-vi-nu,173281123,"Túi Nữ Đeo Chéo Thời Trang Hàn Quốc 208063 - vàng",33300,46600,13300,29
TIKI,tui-vi-nu,137154135,"Móc Khóa Cừu Trang Trí Túi Vải, Balo Chất Liệu Bông Trắng Siêu Dễ Thương",32000,32000,0,0
TIKI,tui-vi-nu,43694670,"Túi nữ thời trang phong cách Hàn Quốc Đồ Da Thành Long 208169 ZZ",35600,46400,10800,23
TIKI,tui-vi-nu,124182419,"Túi xách nữ cao cấp da thật ELLY – ET123",2999000,2999000,0,0
TIKI,tui-vi-nu,73092538,"Túi Xách Nữ Thời Trang JUNO Dập Hiệu Ứng Princess Diamond TXT226",780000,780000,0,0
TIKI,tui-vi-nu,247348218,"Túi Xách Đeo Chéo Nữ LEO Thời Trang Sang Trọng Da Cao Cấp Cực Đẹp TX16",129000,129000,0,0
TIKI,tui-vi-nu,173254727,"Ví nữ da thật vân cá sấu 204405",144000,144000,0,0
TIKI,tui-vi-nu,82916516,"Túi Xách Nữ Đeo Chéo Vân Da Sần Khóa Bấm Vuông 2 Dây Đeo Thời Trang Dạo Phố  Không kèm Cục Bông D189",76000,76000,0,0
TIKI,tui-vi-nu,217564195,"Túi đeo chéo Pop-it nhỏ xinh cho các bé. hình xinh xắn ,dây đeo màu sắc",59000,59000,0,0
TIKI,tui-vi-nu,51718050,"Túi Đeo Chéo Thời Trang Nữ Cao Cấp SV002(Tặng Kèm 1 Kẹp Tóc Xinh Xắn Màu Ngẫu Nhiên)",259000,259000,0,0
TIKI,tui-vi-nu,172191730,"Túi Đeo Chéo Nữ Cao Cấp - Có Lỗ Kéo Dây Tai Nghe - Hàng Nhập - Mẫu Hàn Quốc 208152",30000,30000,0,0
TIKI,tui-vi-nu,26428131,"Túi đeo chéo Nữ đính kim tuyến sang trọng + Tặng vòng đeo tay",59000,59000,0,0
TIKI,tui-vi-nu,166068512,"Túi đeo vai cao cấp hình lưỡi",857000,857000,0,0
TIKI,tui-vi-nu,173253219,"Ví nữ thời trang da mềm 204410",38900,69600,30700,44
TIKI,tui-vi-nu,167057537,"VÍ SEN HOA EDITION  - CHÍNH HÃNG KHACTEN.COM",2100000,2100000,0,0
TIKI,tui-vi-nu,147942454,"Túi Xách Nữ Đeo Chéo Chính Hãng FOREVER YOUNG Dáng Công Sở Thời Trang Da Cao Cấp Siêu Đẹp FY24 - Tukado",489000,489000,0,0
TIKI,tui-vi-nu,132079038,"Túi Đeo Chéo Caro Size Lớn T20 Màu Đen",136000,198000,62000,31
TIKI,tui-vi-nu,143300787,"HJ6401-02-03-04 - Túi xách da đà điểu Huy Hoàng màu đen, nâu đỏ, vàng bò, nâu đất",12599000,12599000,0,0
TIKI,tui-vi-nu,155608690,"Ví nữ HANHSON màu nâu vàng",680000,680000,0,0
TIKI,tui-vi-nu,191717415,"TÚI ĐEO CHÉO NỮ THỜI TRANG 3 NGĂN CAO CẤP PHONG CÁCH HÀN QUỐC TRẺ TRUNG",99000,99000,0,0
TIKI,tui-vi-nu,17522341,"Túi đeo chéo nữ",55000,55000,0,0
TIKI,tui-vi-nu,7261987,"Ví nữ cầm tay da mềm cao cấp nhiều ngăn For Young",53999,53999,0,0
TIKI,tui-vi-nu,76246070,"Túi xách nữ đeo chéo kiểu dáng trong suốt hai lớp, có thể tháo rời, phong cách cá tính, thời thượng",115000,115000,0,0
TIKI,tui-vi-nu,209414305,"Ví bóp nữ cầm tay hai dây kéo hai khóa họa tiết quả trám giá rẻ cầm mềm tay VT200",113000,113000,0,0
TIKI,tui-vi-nu,152015296,"Túi Vải Canvas No Mask Not Going Out",150000,150000,0,0
TIKI,tui-vi-nu,154857519,"Túi cói đi biển Sunday - Túi cói Vintage",160000,160000,0,0
TIKI,tui-vi-nu,208615901,"Ví da nữ cầm tay thời trang Lata VN70",430000,430000,0,0
TIKI,tui-vi-nu,41099714,"Ví bóp nữ cầm tay đựng tiền nhỏ mini siêu đẹp manoto VN16",37000,37000,0,0
TIKI,tui-vi-nu,204987540,"Túi Tote size khổng lồ; chất liệu vải không dệt, hàng dầy chịu tải 40kg, in hình  hồng hạc vintage T588",15000,15000,0,0
TIKI,tui-vi-nu,173276635,"Túi xách da thật Đồ Da Thành Long  205774 (Nâu)",543300,604000,60700,10
TIKI,tui-vi-nu,118840891,"Túi cói mềm có khóa kéo form sịn sò",170000,170000,0,0
TIKI,tui-vi-nu,202626740,"Ví nữ gấp mini da bò trơn Pink Ohara",550000,550000,0,0
TIKI,tui-vi-nu,132079653,"Túi Đeo Chéo Caro Size Lớn T20 Màu Hồng Đỏ",149000,198000,49000,25
TIKI,tui-vi-nu,169733293,"Ví Nữ Đựng Thẻ LISA Đẹp Da Saffiano Cầm Tay Mini Nhiều Ngăn Card Holder Cao Cấp Chống Thấm Bò Thật Nam Nút Bấm DOLANTO",238000,238000,0,0
TIKI,tui-vi-nu,74630124,"Túi đeo chéo nữ đựng điện thoại di động Chụp ảnh in hình Kỳ diệu X32 Tặng móc khóa cá heo",68409,93492,25083,27
TIKI,tui-vi-nu,56431998,"Ví dài nữ cầm tay thời trang Hàn Quôc",35000,35000,0,0
TIKI,tui-vi-nu,71355445,"Túi kẹp nách nữ da vân cá sấu, có dây đeo thời trang phối dây xích siêu hót TK0061 - Nâu",50000,100000,50000,50
TIKI,tui-vi-nu,76393715,"Ví đựng thẻ HANHSON SP000652 da bò nâu vàng ",750000,750000,0,0
TIKI,tui-vi-nu,198227962,"Tú xách nữ cao cấp da thật ELLY – ET144",1699000,1699000,0,0
TIKI,tui-vi-nu,68211226,"Túi xách tay nữ cao cấp hàng xuất châu Âu",370000,370000,0,0
TIKI,tui-vi-nu,167644405,"set 3 túi trong suốt",61000,61000,0,0
TIKI,voucher-dich-vu,209389859,"Phiếu Quà Tặng Beloved & Beyond 1000K",1000000,1000000,0,0
TIKI,voucher-dich-vu,206123644,"Sách nói SP0TIFY Và Những Chuyện Chưa Kể",99000,99000,0,0
TIKI,voucher-dich-vu,131498431,"KHÓA HỌC PHÂN TÍCH NGHIỆP VỤ KINH DOANH VÀ THIẾT KẾ SẢN PHẨM",11900000,11900000,0,0
TIKI,voucher-dich-vu,253396602,"SÀI GÒN - LÀNG HOA SA ĐÉC - KDL GÁO GIỒNG - SÀI GÒN",2940000,2940000,0,0
TIKI,voucher-dich-vu,206123727,"Sách nói Xây Dựng Thương Hiệu Tinh Gọn",99000,99000,0,0
TIKI,voucher-dich-vu,253396099,"SÀI GÒN – MỸ THO - BẾN TRE – CHÂU ĐỐC - CẦN THƠ – SÓC TRĂNG – BẠC LIÊU – CÀ MAU – SÀI GÒN",4190000,4190000,0,0
TIKI,voucher-dich-vu,7852323,"Nàng Sen Spa - Voucher Chăm Sóc Da Mặt Chuyên Sâu- Căng Da Liệu Pháp Mặt Nạ Nâng Cơ - Miễn Tip",499000,499000,0,0
TIKI,voucher-dich-vu,167543524,"LIỆU TRÌNH CHĂM SÓC DA MỤN NHẸ NÂNG CAO (75-90 phút)",600000,600000,0,0
TIKI,voucher-dich-vu,167461322,"LIỆU TRÌNH CHĂM SÓC DA MỤN NHẸ TIÊU CHUẨN TẠI LOVE + ROSA BEAUTY SPA (60-75 phút)",600000,600000,0,0
TIKI,voucher-dich-vu,67111292,"Chicken Plus - Gà Không Xương Truyền Thống Lớn",139000,139000,0,0
TIKI,voucher-dich-vu,198573861,"Dịch vụ xe 16 chỗ tiễn sân bay: Hà Nội - Sân bay Nội Bài",499000,499000,0,0
TIKI,voucher-dich-vu,198573128,"Dịch vụ xe 7 chỗ tiễn sân bay: Hà Nội - Sân bay Nội Bài",309000,309000,0,0
TIKI,voucher-dich-vu,119439064,"[E-BOOK] i-Learn Smart Start 2 Truyện đọc - The Clever Horse",5000,5000,0,0
TIKI,voucher-dich-vu,120422765,"[E-BOOK] i-Learn Smart Start English for Math 1 File nghe Audio",10000,10000,0,0
TIKI,voucher-dich-vu,216029420,"Sinh Trắc Vân Tay – Phân Tích Xu Hướng Nghề Nghiệp Theo Tính Cách ",500000,500000,0,0
TIKI,voucher-dich-vu,56092906,"Voucher combo du lịch hạng phòng Deluxe Double 3 ngày 2 đêm tại Mega Light Hotel Nha Trang",1500000,1500000,0,0
TIKI,voucher-dich-vu,44230809,"Liệu trình Massage Sáp nến hương sen - Nàng Sen Spa",299000,299000,0,0
TIKI,voucher-dich-vu,44232592,"Liệu trình Tắm bùn khoáng thiên nhiên siêu mịn da toàn thân 8 in 1 - Nàng Sen Spa",999000,999000,0,0
TIKI,voucher-dich-vu,117291903,"Khóa học Toán Tiếng Anh Hệ Cambridge: Stage 2 - Lớp 1 - [TOT.EDU.VN]",1999000,1999000,0,0
TIKI,voucher-dich-vu,186880774,"Giftpop - Phiếu Quà Tặng Le Monde Steak 200K",200000,200000,0,0
TIKI,voucher-dich-vu,117293101,"Khóa học Toán Tiếng Anh Hệ Cambridge: Stage 5 - Lớp 4 - [TOT.EDU.VN]",1999000,1999000,0,0
TIKI,voucher-dich-vu,119439262,"[E-BOOK] Tiếng Anh 2 i-Learn Smart Start Cẩm nang hướng dẫn Phụ huynh",15000,15000,0,0
TIKI,voucher-dich-vu,119445703,"[E-BOOK] i-Learn Smart Start 1 Truyện đọc - My Great Body",5000,5000,0,0
TIKI,voucher-dich-vu,29207572,"MintWIFI-SIM 4G Du lịch Đài Loan tốc độ cao gói 3 ngày sử dụng, dung lượng không giới hạn",209000,209000,0,0
TIKI,voucher-dich-vu,119438132,"[APP] Tiếng Anh 2 i-Learn Smart Start - Ứng dụng phần mềm trò chơi tương tác",25000,25000,0,0
TIKI,voucher-dich-vu,205279972,"Sách nói: Côn Trùng Ký - Tập 2",99000,99000,0,0
TIKI,voucher-dich-vu,207732801,"Sách nói Đặt Cơ Sở Cho Siêu Hình Học Về Đức Lý",99000,99000,0,0
TIKI,voucher-dich-vu,6090719,"Thanh tẩy Vit C ( Miễn Tip) ",109000,109000,0,0
TIKI,tui-thoi-trang-nam,155330335,"Ví da nam, bóp da nam mini Bụi Leather V115 - Da bò Nappa cao cấp - Bảo hành 12 tháng",180000,278000,98000,35
TIKI,voucher-dich-vu,207733190,"Sách nói Kinh Doanh Nhỏ Thu Lợi Lớn",99000,99000,0,0
TIKI,voucher-dich-vu,207732590,"Sách nói Doanh Nghiệp Tinh Gọn",99000,99000,0,0
TIKI,voucher-dich-vu,119439076,"[E-BOOK] i-Learn Smart Start 2 Truyện đọc - The man, the boy and the donkey",5000,5000,0,0
TIKI,tui-thoi-trang-nam,75417728,"Bóp Ví Dài Nam Nữ KEIO NIPPON Da Bò Mill Cao Cấp Nhập Khẩu, Đựng Điện Thoại, Hộ Chiếu Kích Thước 20x11x2.5 cm VID0003",469000,469000,0,0
TIKI,tui-thoi-trang-nam,153264933,"Túi đeo chéo nam nữ 4 ngăn cao cấp D77 Shalla",38610,52767,14157,27
TIKI,tui-thoi-trang-nam,113760273,"Ví nam da bò cao cấp phong cách mới",387000,430000,43000,10
TIKI,voucher-dich-vu,53871133,"KHÓA HỌC KÈM TIẾNG ANH KIDS & TEENS OFFLINE/ ONLINE 1 THÁNG - RÚT NGẮN 80% THỜI GIAN HỌC MÀ VẪN ĐẠT HIỆU QUẢ CAO!",685000,685000,0,0
TIKI,tui-thoi-trang-nam,253171976,"Ví nam 100% da thật thông minh siêu mỏng thời trang cao cấp phong cách cá tính",351000,390000,39000,10
TIKI,tui-thoi-trang-nam,195153629,"Túi Đeo Chéo Vải Canvas Bền Bỉ Phong Cách Thời Trang Unisex Nam Nữ Hàn  BL002",112500,150000,37500,25
TIKI,voucher-dich-vu,193584101,"Khóa học 6 Kỹ Năng Mềm SkillUp ",2900000,2900000,0,0
TIKI,tui-thoi-trang-nam,105695598,"Ví nam cầm tay cao cấp - Clutch Cầm Tay chất lượng cao phong cách mới",359000,398000,39000,10
TIKI,tui-thoi-trang-nam,155495937,"Ví namecard da bò V131, ví đựng thẻ card holder da thật nhỏ gọn, thương hiệu Bụi leather chuyên đồ da thật",49000,84000,35000,42
TIKI,tui-thoi-trang-nam,189539055,"Túi đeo chéo vải Canvas T0166 unisex nam nữ phong cách trẻ trung Hàn",60000,120000,60000,50
TIKI,tui-thoi-trang-nam,20834169,"Ví Nam Dài Cầm Tay Nam Thời Trang Hàn Quốc",133650,182655,49005,27
TIKI,tui-thoi-trang-nam,126765353,"Túi bao tử - đeo chéo unisex nam nữ vải chống nước phong cách Hàn",76230,104181,27951,27
TIKI,tui-thoi-trang-nam,89786167,"Túi đeo chéo nam nữ vải dù chống nước phong cách Hàn Quốc - Túi bao tử nam TC83",76230,104181,27951,27
TIKI,tui-thoi-trang-nam,198224201,"Túi Đeo Chéo Grepaco Nam Nữ Unisex Vải Bố Canvas Thời Trang Hàn Quốc Đa Năng Đựng Điện Thoại Máy Tính Bảng Mini Chống Thấm Xước Nhiều Ngăn Khóa Kéo YKK, Phù Hợp Nhiều Kiểu Xách Đeo Khác Nhau - Hàng Chính Hãng",94050,99000,4950,5
TIKI,tui-thoi-trang-nam,117401394,"Ví Đựng Thẻ ATM Mini, Da Bò Mềm Mại GENTLE, Da Thật 100%, Thiết Kế Hiện Đại, Nhiều Ngăn Tiện Dụng, Đựng Thẻ Ngân Hàng, Danh Thiếp, Căn Cước, Hình Lưu Niệm, Dáng Đứng - Gập 2 - Hàng Chính Hãng SAIGIO",629000,649000,20000,3
TIKI,tui-thoi-trang-nam,74926237,"Túi Bao Tử Đeo Chéo Cao Cấp Đơn Giản Nhỏ Gọn Nam Nữ Để Điện Thoại Ví Galaxy Store GTBT02 - Hàng Chính Hãng",125000,350000,225000,64
TIKI,tui-thoi-trang-nam,140308913,"Túi đeo bụng, đeo chéo nhiều ngăn đa năng chống thấm nước cho nam, nữ hàng cao cấp size 22cm",72022,98430,26408,27
TIKI,tui-thoi-trang-nam,90507801,"Túi đeo chéo đeo ngực nam có khóa chống trộm chống nước cao cấp",423000,470000,47000,10
TIKI,voucher-dich-vu,207732741,"Sách nói Làm Chủ Bình Minh - Sống Đời Xuất Chúng",99000,99000,0,0
TIKI,tui-thoi-trang-nam,262043409,"Túi da - Balo cao cấp Macsim mã MSN149",1440000,1440000,0,0
TIKI,tui-thoi-trang-nam,184491427,"Túi đeo chéo nam 100% da bò thật cao cấp phong cách mới",477000,530000,53000,10
TIKI,tui-thoi-trang-nam,197879894,"Bóp Đứng Nam Nhỏ Gọn, Chất Liệu Da Bò PULL-UP Mềm Mại, Mỏng Nhẹ, Phong Cách Hiện Đại - Cá Tính, Size Trung, Dáng Đứng - Gập 2, Nhiều Ngăn Để Tiền Và Giấy Tờ Tiện Dụng",982000,999000,17000,2
TIKI,tui-thoi-trang-nam,83677957,"Balo đeo chéo nam thời trang Yuumy RBAC01",189000,390000,201000,52
TIKI,tui-thoi-trang-nam,260811618,"Túi xách - Túi da cao cấp Macsim mã MSALB6",1540000,1540000,0,0
TIKI,tui-thoi-trang-nam,244316262,"Ví nam đựng tiền đựng chìa khóa đựng thẻ đa năng 100% da bò thật cao cấp phong cách mới",333000,370000,37000,10
TIKI,voucher-dich-vu,11238161,"Khoá Học Tiếng Anh Thiếu Nhi Cambridge Starters B Cho Bé (Lớp 1-3) Tại Nhà Cùng 247 Tiếng Anh",399000,399000,0,0
TIKI,tui-thoi-trang-nam,146618296,"Bóp Da Đựng Thẻ ATM Nhỏ Gọn, Chất Da Pull-Up Mềm Mại, Trẻ Trung - Cá Tính, Thiết Kế Hiện Đại, Nhiều Ngăn Tiện Dụng, Đựng Thẻ Ngân Hàng, Card Danh Thiếp, Căn Cước Công Dân, Hình Lưu Niệm, Dáng Đứng - Gập 2 - Hàng Chính Hãng SAIGIO",779000,799000,20000,3
TIKI,voucher-dich-vu,205279610,"Sách nói: Bạn Càng Mạnh Mẽ Thế Giới Càng Công Bằng",99000,99000,0,0
TIKI,tui-thoi-trang-nam,126039327,"Bóp Đựng Thẻ ATM Nhỏ Gọn SUPPLE, Da Bò SMALL PEBBLE Mềm Mại - Bền Bỉ, Chống Xước - Chống Nhăn Tốt, Thiết Kế Hiện Đại, Ngăn Súp Lê Rộng, Đựng Được Nhiều Thẻ Ngân Hàng, Card Danh Thiếp, Căn Cước Công Dân, Dáng Đứng - Gập 2 – Hàng Chính Hãng SAIGIO",683000,699000,16000,2
TIKI,tui-thoi-trang-nam,72869810,"Túi Đeo Chéo Chống Nước FALDO 02",350000,350000,0,0
TIKI,tui-thoi-trang-nam,167468890,"Ví nam, bop nam, ví nam mini, bóp da nam, ví da nam đẹp, vi da nam, ví da nam P015 kiểu dáng thanh lịch, phong cách Hàn Quốc",47000,59000,12000,20
TIKI,tui-thoi-trang-nam,74830942,"Ví da thời trang nam phong cách Hàn Quốc cao cấp VN21 chống nước nhiều ngăn phong cách trẻ sành điệu gu nam tính",119000,119000,0,0
TIKI,tui-thoi-trang-nam,75418303,"Bóp Ví Dài Nam Nữ KEIO NIPPON Da Bò Mill Cao Cấp Nhập Khẩu, Kích Thước 18x9x2cm VID-GAP001",349000,349000,0,0
TIKI,tui-thoi-trang-nam,124966188,"Ví nam, bóp nam da bò sáp Mexico Bụi Leather V102 - Bảo hành 12 tháng",200000,370000,170000,46
TIKI,tui-thoi-trang-nam,72605942,"Túi Đeo Chéo Túi Đeo Ngực Nam Nữ Chống Nước Thể Thao",160000,160000,0,0
TIKI,tui-thoi-trang-nam,106693981,"Túi Đeo Chéo Nam Vải Dù Cao Cấp, Phong Cách Thời Trang Châu Âu, Túi Đeo Vai Chống Thấm Nước Tốt, Vải Mềm Chống Nhăn, Đường Chỉ May Chắc Chắn, Khóa Kéo Bền Đẹp, Túi Dành Cho Học Sinh, Sinh Viên, Người Đi Làm",219000,219000,0,0
TIKI,voucher-dich-vu,207733105,"Sách nói Nghệ Thuật Giao Tiếp Để Thành Công Nơi Công Sở",99000,99000,0,0
TIKI,tui-thoi-trang-nam,185995682,"Túi đeo chéo đeo ngực nam đa năng cao cấp phong cách mới",270000,299000,29000,10
TIKI,voucher-dich-vu,253185188,"TOUR LONG AN - LÀNG NỔI TÂN LẬP  1 NGÀY ",790000,790000,0,0
TIKI,tui-thoi-trang-nam,105695598,"Ví nam cầm tay cao cấp - Clutch Cầm Tay chất lượng cao phong cách mới",359000,398000,39000,10
TIKI,tui-thoi-trang-nam,75728670,"Túi đeo chéo nam tích hợp khóa chống trộm chống nước cao cấp phong cách mới",297000,330000,33000,10
TIKI,tui-thoi-trang-nam,176147572,"Túi Đeo Chéo Nam Thể Thao Chống Nước, Chống Xước, Chống Bám Bụi,chất Liệu Vải Oxford Thiết Kế Thông Minh, Phong Cách Hiện Đại Thời Trang Cao Cấp Besti Y03- Hàng Chính Hãng",250000,250000,0,0
TIKI,voucher-dich-vu,6216695,"Liệu Trình Tắm Trắng Body Bằng Sữa Dê ",209000,209000,0,0
TIKI,tui-thoi-trang-nam,4207965,"Túi đựng ipad Simplecarry LC Ipad",390000,390000,0,0
TIKI,tui-thoi-trang-nam,155776133,"Túi đeo chéo nam nữ unisex phong cách ulzzang sợi polyesster cao cấp chống thấm nước Haoshuai S12",125000,125000,0,0
TIKI,tui-thoi-trang-nam,184491427,"Túi đeo chéo nam 100% da bò thật cao cấp phong cách mới",477000,530000,53000,10
TIKI,tui-vi-nu,165699459,"Túi đeo chéo nam Vải canvas chỉ 2 chấm siêu nhẹ NH78 Shalla tặng bút cảm ứng",29729,40630,10901,27
TIKI,tui-thoi-trang-nam,163281652,"Túi đeo chéo đeo ngực nam cao cấp phong cách châu âu",711000,790000,79000,10
TIKI,tui-thoi-trang-nam,95446218,"Túi xách nam công sở cao cấp siêu bền đẹp",423000,470000,47000,10
TIKI,tui-thoi-trang-nam,79467350,"Túi đeo chéo UAG Hip Pack thời trang, chống nước - Hàng Chính Hãng",1300000,1300000,0,0
TIKI,tui-vi-nu,37939795,"Túi Da Đeo Chéo P074",359000,359000,0,0
TIKI,tui-thoi-trang-nam,191490265,"Túi đeo chéo nam nữ cao cấp vải chống thấm nước BEE GEE DCN9031B",332000,670000,338000,50
TIKI,tui-thoi-trang-nam,174661875,"Túi Đeo Chéo Ngực Cho Nam Chống Nước, Chống Xước, Chống Bám Bẩn, Nhiều Ngăn Phong Cách Thời Trang Cao Cấp Besti Y02- Hàng Chính Hãng",190000,190000,0,0
TIKI,tui-vi-nu,170501923,"Ví cầm tay dài nam  BST The Long Wallet chính hãng NATOLI nhiều ngăn chống nước sang trọng thời trang",469000,666000,197000,30
TIKI,tui-vi-nu,82921698,"Túi xách túi đeo vai nam 100% da bò cao cấp phong cách châu âu",711000,790000,79000,10
TIKI,tui-vi-nu,115520033,"Cặp da công sở tay rút nắp can VINADA ",269000,269000,0,0
TIKI,tui-thoi-trang-nam,155495937,"Ví namecard da bò V131, ví đựng thẻ card holder da thật nhỏ gọn, thương hiệu Bụi leather chuyên đồ da thật",49000,84000,35000,42
TIKI,tui-thoi-trang-nam,138556972,"Cặp da nam công sở TRITA TCA16",269000,460000,191000,42
TIKI,tui-vi-nu,125256490,"Ví nam, bóp nam da bò Saffiano Bụi Leather V126 - Bảo hành 12 tháng",229000,375000,146000,39
TIKI,tui-thoi-trang-nam,183531122,"Túi đeo chéo da nam dáng ngang phối ngăn đôi TRITA RTN6",309000,520000,211000,41
TIKI,tui-vi-nu,83377797,"Ví Sen Cách Điệu Da Bò Thật, Bóp Mini Unisex Thời Trang, Nhỏ Gọn VS19-01",149000,149000,0,0
TIKI,tui-vi-nu,103047087,"Ví Đựng Thẻ Nam Nữ Da Epsom Handmade Lealux Mini Epsom Wallet 1",599000,599000,0,0
TIKI,tui-vi-nu,70154795," Túi Đeo Chéo Trước Ngực 4U Da Tổng Hợp Cá Tính BA417",199000,250000,51000,20
TIKI,tui-vi-nu,111868698,"Túi đeo chéo du lịch nam Arctic Hunter K00096 chất liệu Oxford chống thấm nước, đựng ipad, thiết kế nhiều ngăn tiện dụng",379000,650000,271000,42
TIKI,tui-vi-nu,193202414,"Túi Da Đeo Chéo Nhỏ, Túi Đeo Chéo Da Nam Nữ Phong Cách Thời Trang Hàn Quốc",120000,120000,0,0
TIKI,tui-vi-nu,126765488,"Túi đeo chéo Fashion vải Canvas unisex nam nữ phong cách trẻ trung Hàn",55000,110000,55000,50
TIKI,tui-thoi-trang-nam,75645911,"Túi đeo chéo nam phong cách mới tích hợp khóa chống trộm và chống thấm nước cao cấp",441000,490000,49000,10
TIKI,tui-vi-nu,188566537,"Túi Đeo Chéo Nam Oxford Cao Cấp Nhiều Ngăn Chống Thấm Nước, Túi Đeo Vai Phong Cách Thời Trang Hàn Quốc Dành Cho Người Đi Làm, Học Sinh, Sinh Viên,Người Đi Chơi, Đi Du Lịch",135000,135000,0,0
TIKI,tui-vi-nu,149179571,"Túi đeo chéo nam da bò cao cấp YILIDAISHU T33 27x24x6cm(Nâu - Đen) D.HSTORE",750000,750000,0,0
TIKI,tui-thoi-trang-nam,186483412,"Túi xách nam công sở cao cấp phong cách mới",450000,499000,49000,10
TIKI,tui-thoi-trang-nam,82372883,"Túi đeo chéo nam cao cấp phong cách mới",297000,330000,33000,10
TIKI,tui-vi-nu,59107698,"Túi đeo chéo nam da bò cao cấp T09 27x24x5cm",265000,265000,0,0
TIKI,tui-vi-nu,162100442,"Ví nam DEABOLAR phiên bản cao cấp nhiều ngăn tiện lợi",76000,120500,44500,37
TIKI,tui-vi-nu,111868972,"Balo một dây đeo chéo Arctic Hunter XB00116 chất liệu Oxford chống thấm nước, unisex nam nữ,trang bị cổng sạc USB",515000,849000,334000,39
TIKI,tui-vi-nu,263961192,"Túi xách nam công sở da bò thật cao cấp phong cách mới",794000,882000,88000,10
TIKI,tui-thoi-trang-nam,7763050,"Cặp nam đeo chéo TROY phối nắp",99000,129000,30000,23
TIKI,tui-vi-nu,125136680,"Ví nam, bóp nam da bò sáp Bụi Leather V106 - Bảo hành 12 tháng",209000,370000,161000,44
TIKI,tui-vi-nu,150873006,"Clutch, Ví Cầm Tay Thời Trang Nam Da Bò Khóa Vân Tay Cao Cấp RB06",2500000,2500000,0,0
TIKI,tui-thoi-trang-nam,73502969,"Túi bao tử cao cấp đeo hông đeo ngực tiện lợi MIBAG37",76230,104181,27951,27
TIKI,tui-vi-nu,148850138,"Ví nam cầm tay Arctic Hunter Q00011 dáng dài, dập vân khóa kéo zip YKK sang trọng",230000,415000,185000,45
TIKI,tui-vi-nu,162584139,"Túi đeo ngực, đeo chéo nam đã tích hợp công nghệ 4.0 mã BG-7221",399000,699000,300000,43
TIKI,tui-vi-nu,178313418,"Cặp Nam LATA CA09",650000,650000,0,0
TIKI,tui-vi-nu,183377459,"Túi xách nam công sở, cặp da nam đựng laptop và tài liệu cao cấp GCE12",2750000,2750000,0,0
TIKI,tui-vi-nu,148850126,"Ví nam cầm tay Arctic Hunter Q00010 dáng dài dập vân có nút bấm",215000,350000,135000,39
TIKI,tui-vi-nu,77316752,"Bóp ví nam da bò thật 4U cao cấp dáng ngang, nhiều ngăn đựng tiền và thẻ FA162",230000,260000,30000,12
TIKI,tui-vi-nu,924544,"Túi Đeo Chéo Nam HARAS HRTK147 (26 x 17 cm) - Đen",65000,65000,0,0
TIKI,tui-thoi-trang-nam,20882002,"Ví Nam Dài Cầm Tay - Ví Bóp Cầm Tay Dài Nam Thời Trang",90090,123123,33033,27
TIKI,tui-vi-nu,108850224,"Ví nam thời trang da bò thật LATA LVN84",490000,490000,0,0
TIKI,tui-thoi-trang-nam,21602898,"Ví Nam, Bóp Nam [Dáng Đứng] Da Bò Thật Cao Cấp - Thời Trang",99000,99000,0,0
TIKI,tui-vi-nu,43673298,"Ví cầm tay nam da cao cấp Dạng hộp bản to hình chuột túi trơn SD13 Shalla",147510,201597,54087,27
TIKI,tui-vi-nu,148808284,"Ví dài cầm tay da bò Mill cao cấp Bụi Leather C104 - Bảo hành 12 tháng",450000,665000,215000,32
TIKI,tui-vi-nu,170125120,"MLB - Túi bao tử thời trang Monogram 3AHSM012N",2590000,2590000,0,0
TIKI,tui-thoi-trang-nam,109483831,"Túi đeo chéo nam thời trang cao cấp ",450000,499000,49000,10
TIKI,voucher-dich-vu,207723832,"Sách nói Ngày Xưa Có Một Con Bò",99000,99000,0,0
TIKI,tui-vi-nu,77703745,"Túi Đeo bao tử, nịt bụng đeo chéo đa năng ngang kéo tian l21 Tăng móc khóa nam cao cấp",78210,106887,28677,27
TIKI,tui-vi-nu,27531795,"Túi Đeo Thắt Lưng Du Lịch Phong Cách Quân Đội",64350,87945,23595,27
TIKI,tui-vi-nu,143100393,"Ví nam da bò Anh Tho Leather 065",299000,375000,76000,20
TIKI,tui-vi-nu,12038935,"Túi Đeo Chéo Nam Nữ 17x23x8cm",43999,43999,0,0
TIKI,tui-vi-nu,91447829,"Cặp Túi Da Nam C92",810000,810000,0,0
TIKI,tui-vi-nu,31878057,"Combo Túi Xách Tay Công Sở Nữ Có Dây Đeo Chéo và Ví Cầm Tay LH04 - Đen",319000,319000,0,0
TIKI,tui-vi-nu,38504524,"Túi Phụ Kiện  Đeo Hông ,Đựng Điện Thoại ,  LT01",64350,87945,23595,27
TIKI,tui-vi-nu,11506821,"Ví Da Mini Cầm Tay TM-Purse H86 (KT: 12x10x4 cm) Cá Tính Nữ",159000,159000,0,0
TIKI,tui-vi-nu,174400013,"Túi Xách Nữ Đeo Chéo MICOCAH Dáng Công Sở Thời Trang Vân Quả Trám Sang Trọng Thanh Lịch Da Cao Cấp Cực Đẹp MC61",429000,429000,0,0
TIKI,tui-vi-nu,213568504,"Ví nam mini kiểu đứng bóp nam đựng tiền 3 màu thời trang nhỏ gọn DN9150",125000,250000,125000,50
TIKI,tui-vi-nu,134222430,"Túi đeo chéo nam nữ thời trang BEE GEE 0129 để điện thoại ipad chống thấm nước đẹp chất lượng tốt",68000,138000,70000,51
TIKI,tui-vi-nu,149449518,"Túi xách nữ đeo chéo cao cấp dáng tròn size 18",294000,294000,0,0
TIKI,tui-vi-nu,120068208,"Túi xách nữ đeo chéo đẹp thời trang da bò Kalanos KTNU2020-Trang, Túi xách nữ nhỏ gọn đa năng đựng vừa điện thoại màu tr",599000,599000,0,0
TIKI,tui-vi-nu,93291043,"Marhen.J - Túi đeo vai chữ nhật nắp gập vải bố Roy Mini MJ19AROYMN-IV",3390000,3390000,0,0
TIKI,tui-vi-nu,73930235,"TÚI DA ĐEO CHÉO NỮ DÂY ĐAN TẶNG KÈM VÍ TTS 470",55000,55000,0,0
TIKI,tui-vi-nu,96010866,"Ví Dài Cầm Tay Nam Nữ Thời Trang Baellerry (2 khóa )",129000,129000,0,0
TIKI,tui-vi-nu,147202616,"Túi Hậu Môn Nhân Tạo 2 Mảnh- Hollister (Trong, Lọc Khí, Khóa Cuốn), 18192 / 18193 / 18194 -VT0738",567000,567000,0,0
TIKI,tui-vi-nu,113498879,"Túi Cói Merci",43000,54900,11900,22
TIKI,tui-vi-nu,188713897,"Ví cầm tay nữ PANDAGO Selina 01 nhiều ngăn cao cấp cute dễ thương nhỏ gọn da thật thời trang",400000,400000,0,0
TIKI,tui-vi-nu,196952251,"Túi Xách Kẹp Nách (Túi Tote Nữ) Đẹp Trơn Dung Tích Lớn Thời Trang Mùa Hè Phong Cách Hàn Quốc - Dou collection - Mã XT065",195000,195000,0,0
TIKI,tui-vi-nu,155609841,"Ví nữ HANHSON da đà điểu màu hồng",1050000,1050000,0,0
TIKI,tui-vi-nu,176002011,"Ví da nữ cầm tay nắp gập YUUMY Seasand YV61",159000,330000,171000,52
TIKI,tui-vi-nu,190888530,"Túi đeo chéo NASI T1036 phong cách hàn quốc túi xách nữ đeo vai thời trang dạo phố dễ thương vải đẹp",49000,49000,0,0
TIKI,tui-vi-nu,128861996,"HJ3111-12-13-14-15 - Bóp nữ da thật cao cấp Huy Hoàng 3 gấp màu da, đen, đỏ, hồng, nâu",839000,839000,0,0
TIKI,tui-vi-nu,160314401,"Ví Nữ Dài Cầm Tay TAILIAN Da Vân Cá Sấu Thời Trang Nhiều Ngăn Đựng Tiền Điện Thoại Da Cao Cấp Cực Đẹp Giá Rẻ TL26",129000,129000,0,0
TIKI,tui-vi-nu,169706264,"Túi Xách Nữ Đeo Chéo Hình Hộp Nhiều Màu, Túi Tote Vải Hình Hộp Siêu Xinh - OTV145 - Ope Store",125000,125000,0,0
TIKI,tui-vi-nu,69509321,"Ví nữ cầm tay có khóa kéo sang trọng, nhiều ngăn tiện dụng TK0060",59000,100000,41000,41
TIKI,tui-vi-nu,188033664,"Túi Xách Nữ Cầm Tay, Đeo chéo Da Cao Cấp Hiệu HADATI - Túi Đi Gọn, Nhẹ Đi Tiệc, Đi Du Lịch, Cafe, Đi Làm Vừa Đẹp, Sang, Xinh [Size 28cmx11x21] AllWELLSHOP",599000,599000,0,0
TIKI,tui-vi-nu,160314387,"Ví Nữ Dài Cầm Tay Chính Hãng TAILIAN Dáng Basic Sang Trọng Thanh Lịch Da Cao Cấp Nhiều Ngăn Tiện Dụng TL07",139000,139000,0,0
TIKI,tui-vi-nu,203913270,"Túi Xách Nữ Đeo Chéo Đeo Vai Quảng Châu Cao Cấp Đi Học Đi Chơi Siêu Xinh TUVIDA_VN TX12",183750,183750,0,0
TIKI,tui-vi-nu,184414218,"Túi đeo chéo thời trang chính hãng NATOLI  BST mini Daily Crossbag chất vải canvas kháng nước cao cấp",139000,199000,60000,30
TIKI,tui-vi-nu,173168419,"Túi vải bố, Túi vải Canvas trơn Màu Trắng - Màu Đen Màu Be Size 36cm x 31cm",35000,35000,0,0
TIKI,tui-vi-nu,162113175,"Túi Xách Nữ, Đeo Chéo Đẹp Dáng MÃ: LFFSH06",264000,264000,0,0
TIKI,tui-vi-nu,48509489,"Túi Xách Vải Nữ Hàn Quốc Đeo Vai , Đeo Chéo Birming Ham Tiện Lợi TH022",93000,93000,0,0
TIKI,tui-vi-nu,171626300,"Túi Xách Nữ Thời Trang Ulzzang Đi Học, Đi Chơi, Túi Đeo Chéo Nhiều Màu Đựng Đồ Cỡ Lớn Nhiều Ngăn - OTV117 - Ope Store",179000,179000,0,0
TIKI,tui-vi-nu,31877259,"Túi xách công sở nữ có dây đeo chéo da mềm mịn, chống nươc, chống trầy xước LT02 - Vàng",299000,299000,0,0
TIKI,tui-vi-nu,45305132,"Túi xách nữ đeo chéo nhỏ xinh mini cực đẹp Linoza TX09",45000,45000,0,0
TIKI,tui-vi-nu,173996525,"Phụ Kiện Túi Vải YUUMY Cỡ Nhỏ YBVLN",10000,10000,0,0
TIKI,tui-vi-nu,193549792,"Ví Nữ Thời Trang cao cấp phong cách mới – VNU1005",135000,270000,135000,50
TIKI,tui-vi-nu,176470921,"Túi xách đính đá thời trang nữ",359000,359000,0,0
TIKI,tui-vi-nu,55234019,"Túi Vải Bố Thời Trang",280000,280000,0,0
TIKI,tui-vi-nu,113500282,"Túi Đựng Điện Thoại Phong Cách Hàn Quốc Trẻ Trung Cho Nữ",149000,149000,0,0
TIKI,tui-vi-nu,195971835,"Túi xách nữ cao cấp da thật ELLY – ET146",2599000,2599000,0,0
TIKI,tui-vi-nu,7947415,"Túi Tote Vải Canvas "No Thank You" T026-B",49000,49000,0,0
TIKI,tui-vi-nu,74622871,"Túi đeo chéo cầm tay Dự tiệc ép chữ mẫu mới  XC22 Tặng móc khóa cá heo",83160,120120,36960,31
TIKI,tui-vi-nu,109767833,"Túi Đựng Điện Thoại Đeo Chéo Cao Cấp, Ví Đựng Tiền Tiện Lợi",68000,68000,0,0
TIKI,tui-vi-nu,200679200,"NHÀ MỊ - Túi Xách handmade Len Đan Móc Thủ Công - Floral Handmade Bag",760000,760000,0,0
TIKI,tui-vi-nu,149148535,"Tẩy tế bào chết toàn thân L-Glutathione Body Exfoliating Cream Whitening Hàn Quốc",60000,100000,40000,40
TIKI,tui-vi-nu,41355724,"Ví bóp da nữ mini cầm tay nhỏ gọn Minoxi siêu hot VN17",63000,63000,0,0
TIKI,voucher-dich-vu,76730149,"[Red River Tour] Tour Câu Mực Đêm & Ngắm Hoàng Hôn Phú Quốc Tổ Chức Hằng Ngày",203280,231000,27720,12
TIKI,voucher-dich-vu,187642480,"Sách nói: Nhân Quả Và Phật Pháp Nhiệm Màu - Tập 3",99000,99000,0,0
TIKI,voucher-dich-vu,137191213,"Phiếu Quà Tặng Marc Fashion 200K",200000,200000,0,0
TIKI,voucher-dich-vu,199216358,"TOUR BRUNEI DARUSSALAM 4 NGÀY 3 ĐÊM",15990000,15990000,0,0
TIKI,voucher-dich-vu,129587544,"[E-BOOK] i-Learn Smart Start Special Edition 4 Sách mềm sách bài tập",15000,15000,0,0
TIKI,voucher-dich-vu,187608677,"Giftpop - Phiếu Quà tặng Yakimono 500K",500000,500000,0,0
TIKI,voucher-dich-vu,57804204,"TOUR ĐÀ NẴNG - HỘI AN - HUẾ(MẮT BIẾC) - BÀ NÀ - QUẢNG BÌNH 5N4Đ [TPHCM] [KHUYẾN MÃI KÍCH CẦU] [DATVIETRAVEL",310000,310000,0,0
TIKI,voucher-dich-vu,132196533,"[E-BOOK] CYLET Practice Tests Pre A2 Flyers File nghe Audio",10000,10000,0,0
TIKI,voucher-dich-vu,36487743,"SỞ HỮU NỤ CƯỜI QUYẾN RŨ VỚI PHƯƠNG PHÁP PHẪU THUẬT TẠO KHÓE CƯỜI AN TOÀN, HIỆU QUẢ",6000000,6000000,0,0
TIKI,voucher-dich-vu,158226929,"Phiếu Quà Tặng Bornga/Paik Jong Wons Kitchen 100K",100000,100000,0,0
TIKI,voucher-dich-vu,252384185,"[Voucher 12 tháng] Bộ công cụ Học - Thi - Hướng nghiệp lớp 6, VitanEdu",375000,375000,0,0
TIKI,voucher-dich-vu,73981165,"Thẩm Mỹ Ruby Beauty - Bác Sĩ Lương Ngọc|Lưu Giữ Thanh Xuân Với Dịch Vụ Căng Da Trẻ Hóa Và Tạo Má Lúm Đồng Tiền",4250000,4250000,0,0
TIKI,voucher-dich-vu,121032629,"Tour 3 đảo Deluxe Nha Trang bao gồm cano và ăn trưa, vé tham quan",400000,400000,0,0
TIKI,voucher-dich-vu,75559141,"Goimon.net- Hotpot House- Mì gà tiềm ớt hiểm (Tô thường)",48000,48000,0,0
TIKI,voucher-dich-vu,207208715,"[EVoucher Vietravel] Singapore - Indonesia - Malaysia",12990000,12990000,0,0
TIKI,voucher-dich-vu,213598878,"[E-Voucher] Gói học online theo môn - Lớp 6 (12 tháng) - Ứng dụng hỗ trợ học tập dành cho học sinh THCS",183000,183000,0,0
TIKI,voucher-dich-vu,249178597,"[E-Voucher] Tour Đà Lạt 4 ngày 3 đêm - Đà Lạt mộng mơ",3690000,3690000,0,0
TIKI,voucher-dich-vu,207236112,"Sách nói Mở Rộng Từ Giá Trị Cốt Lõi",99000,99000,0,0
TIKI,voucher-dich-vu,149685380,"InterContinental Phú Quốc Long Beach Resort 5* - Buffet Sáng, Hồ Bơi Cực Đẹp, Miễn Phí Đón Tiễn Sân Bay, Khách Sạn",3100000,3100000,0,0
TIKI,voucher-dich-vu,117434715,"Khóa hoc Cải thiện ĐAU ĐẦU và thư giãn vùng đầu - VMC",900000,900000,0,0
TIKI,voucher-dich-vu,210165675,"Wyndham Garden Grand World Hotel 4* Phú Quốc - Bữa Sáng, Hồ Bơi, Gần Biển, Đối Diện Phố Đi Bộ, Tiện Xem Show Venice Miễn Phí",1150000,1150000,0,0
TIKI,voucher-dich-vu,270257141,"The Imperial Hotel 5* Vũng Tàu - Buffet Sáng, Hồ Bơi, Đối Diện Biển Bãi Sau, Có Xe Đưa Đón Từ Sài Gòn Trong Tuần Và Nhiều Ưu Đãi Hấp Dẫn",2489000,2489000,0,0
TIKI,voucher-dich-vu,56093975,"Voucher combo du lịch hạng phòng Family dành cho 4 người (4 ngày-3 đêm) tại Mega Light Hotel Nha Trang",2800000,2800000,0,0
TIKI,voucher-dich-vu,48109321,"Vé du thuyền sông Hàn Danang Dragon",200000,200000,0,0
TIKI,voucher-dich-vu,176108013,"Sách nói: Triết Lý Kinh Doanh Của Inamori Kazuo",99000,99000,0,0
TIKI,voucher-dich-vu,179759046,"Sách nói: Có Ai Giữ Giùm Những Lãng Quên?",99000,99000,0,0
TIKI,voucher-dich-vu,198750993,"[TOUR VIP] Hạ Long 1N: Du thuyền 5 Sao La Casta Daily siêu VIP thăm vịnh 8 tiếng, Khởi hành Hàng ngày",1699000,1699000,0,0
TIKI,voucher-dich-vu,56090684,"Voucher combo du lịch hạng phòng Suite 3 ngày 2 đêm tại Alpha Bird Hotel Nha Trang",2250000,2250000,0,0
TIKI,voucher-dich-vu,270496175,"Thẻ tập Yoga 01 tháng - Win Fitness & Yoga",460000,460000,0,0
TIKI,voucher-dich-vu,195655699,"TOUR DU LỊCH DUBAI - ABU DHABI - SA MẠC SAFARI",29900000,29900000,0,0
TIKI,voucher-dich-vu,252250752,"[Voucher 12 tháng] Bộ công cụ Học - Thi - Hướng nghiệp lớp 11, VitanEdu",600000,600000,0,0
TIKI,voucher-dich-vu,273155109,"5 Phút Thuộc Bài - Gói VIP 12 năm - dành cho con từ lớp 1 đến lớp 12 Tặng Kèm Sach' Siêu Trí Nhớ 268k",1499000,1499000,0,0
TIKI,voucher-dich-vu,195653621,"HÀ NỘI - ĐÀ NẴNG - BÀ NÀ - HỘI AN - HÀ NỘI BAY VIETJET AIR",5700000,5700000,0,0
TIKI,voucher-dich-vu,164934057,"Sinh Trắc Vân Tay Gen Talents - Bài Báo Cáo Đầy Đủ 4 Module",3850000,3850000,0,0
TIKI,voucher-dich-vu,187643013,"Sách nói: Trí Tuệ Xúc Cảm",99000,99000,0,0
TIKI,voucher-dich-vu,204277501,"Ứng dụng giáo dục sớm tiền tiểu học Dino đi học phát triển tư duy cho trẻ 3-6 tuổi - Gói trọn đời (Tặng trọn bộ 9 quyển sách "Cùng Dino vui học" + Khóa học độc quyền "Cùng con trưởng thành với DINO))",1299000,1299000,0,0
TIKI,voucher-dich-vu,176718536,"Sách nói: Bí Mật Và Thực Tế Về Tự Kỉ Ám Thị",99000,99000,0,0
TIKI,voucher-dich-vu,203049726,"[EVoucher Vietravel] Nha Trang - Làng Chài Xưa Mũi Né - Biển Nhũ Tiên - Vinwonders (Xe - Khách Sạn 4 sao)",3690000,3690000,0,0
TIKI,voucher-dich-vu,196047724,"Sandals Camellia Hotel 3* Đà Lạt - Buffet Sáng - Gần Chợ Đà Lạt",977000,977000,0,0
TIKI,voucher-dich-vu,21775420,"Tick Edu - Dựng Hình Nhân Vật 3D Với Blender",399000,399000,0,0
TIKI,tui-thoi-trang-nam,19729892,"Túi đeo chéo vải bố nam TX0003",327600,455000,127400,28
TIKI,tui-thoi-trang-nam,4699077,"Cặp đa năng văn phòng chỉ xéo",184115,251624,67509,27
TIKI,tui-thoi-trang-nam,141009896,"Túi đeo chéo nam cao cấp, vải Oxford chống nhăn,chống thấm nước,chống bám bụi, túi đeo vai phong cách thời trang Châu Âu",399000,399000,0,0
TIKI,tui-thoi-trang-nam,78950876,"Túi xách nam công sở 100% da bò thật cao cấp phong cách mới",899000,998000,99000,10
TIKI,tui-thoi-trang-nam,56512790,"Ví nam cầm tay cao cấp",129000,129000,0,0
TIKI,tui-thoi-trang-nam,75319988,"Túi đeo chéo unisex thời trang HARAS HR276",80000,80000,0,0
TIKI,tui-thoi-trang-nam,94038063,"Túi đeo hông nam nữ Túi đeo chéo chạy bộ Túi thể thao dã ngoại Sport TTC1 kích thước 31 x11 x 19 cm",34303,49549,15246,31
TIKI,tui-thoi-trang-nam,3282989,"Túi đeo chéo da nam [HÀNG NHẬP] DTN12-2TI",76000,76000,0,0
TIKI,tui-thoi-trang-nam,37938772,"Cặp Xách Da Công Sở P073",375250,395000,19750,5
TIKI,tui-thoi-trang-nam,186210607,"Túi xách nam công sở, cặp da nam đựng laptop và tài liệu cao cấp CGL10",3400000,3400000,0,0
TIKI,tui-thoi-trang-nam,68658966,"Túi đeo chéo vải bố thời trang 2001",170000,170000,0,0
TIKI,tui-thoi-trang-nam,54001669,"Đeo chéo hông bụng nam nữTĐ 5528 dạng lớn hàn quốc HGF01",118057,161345,43288,27
TIKI,tui-thoi-trang-nam,125097857,"Ví nam, bóp nam da bò sáp Bụi Leather V105 - Bảo hành 12 tháng",209000,370000,161000,44
TIKI,tui-thoi-trang-nam,10583890,"Túi Đeo Chéo Nam Chống Trộm",111000,111000,0,0
TIKI,tui-thoi-trang-nam,122502105,"[APP] i-Learn Smart Start English for Science 2 - Ứng dụng phần mềm tương tác sách học sinh",25000,25000,0,0
TIKI,tui-thoi-trang-nam,20102345,"M Fitnsee Club - Trải Nghiệm 01 Buổi Bơi Chuẩn 5 Sao Không Giới Hạn Thời Gian Bơi",195000,195000,0,0
TIKI,tui-thoi-trang-nam,193201445,"Túi Đeo Vai, Túi Đeo Chéo Da PU, Túi Đeo Hông Cao Cấp Nhiều Ngăn Tiện Lợi Thời Trang Nam Phong Cách Hàn Quốc",95000,95000,0,0
TIKI,tui-thoi-trang-nam,130070341," Túi đeo chéo nam nữ phong cách lính",137000,137000,0,0
TIKI,tui-thoi-trang-nam,76693953,"Khóa học Hoàn thành mọi việc với Kanban - Kỹ năng Quản lý Cá nhân - Agilearn | Giải pháp Đào tạo Số hàng đầu cho Doanh nghiệp tại Việt Nam",690000,690000,0,0
TIKI,tui-thoi-trang-nam,19707078,"Túi đeo hông nam du lịch, phượt",157500,157500,0,0
TIKI,tui-thoi-trang-nam,167443834,"Túi đeo chéo nam 100% da bò thật cao cấp phong cách mới",477000,530000,53000,10
TIKI,tui-thoi-trang-nam,97644482,"Túi đeo chéo nam VPC kiểu ngang bóng trơn VF47 Tặng móc khóa hình khiên",82067,112158,30091,27
TIKI,tui-thoi-trang-nam,102012371,"Túi đeo chéo nam nữ chất liệu vải chống thấm nước phong cách Hàn Quốc - Túi bao tử Unisex TC06",76230,104181,27951,27
TIKI,tui-thoi-trang-nam,38050388,"Túi Đeo Chéo Phản Quang Phát Sáng Thời Trang Hàn Quốc FALDO",219000,219000,0,0
TIKI,tui-thoi-trang-nam,51147505,"Túi đeo ngực,đeo chéo nam đã tích hợp công nghệ 4.0",529000,799000,270000,34
TIKI,tui-thoi-trang-nam,160946427,"Sinh Trắc Vân Tay Gen Talents – Dịch Vụ Tư Vấn Sinh Trắc Vân Tay Gia Đình – Gói Phân Tích Demo – Tặng Sách Trở Về Từ Cõi Sáng",600000,600000,0,0
TIKI,tui-thoi-trang-nam,89837896,"Ví nam cầm tay da bò Gianni Conti VP0169DBR",4100000,4100000,0,0
TIKI,tui-thoi-trang-nam,270765390,"TTC Premium Hotel Cần Thơ 4* - Ngay Bến Ninh Kiều, Có Buffet Sáng, Hồ Bơi, Khách Sạn Vị Trí Thuận Tiện Tham Quan và nhiều ưu đãi hấp dẫn",1098000,1098000,0,0
TIKI,tui-thoi-trang-nam,147799009,"Ví Da Nam Bò Sáp Nhiều Ngăn Tiện Dụng Kiểu Dáng Sang Trọng Nam Tính",168000,336000,168000,50
TIKI,tui-thoi-trang-nam,189491562,"Túi đeo chéo nam DA THẬT cao cấp phong cách mới – BEE GEE DCN9071",1238000,2500000,1262000,50
TIKI,tui-thoi-trang-nam,160406240,"Ví da nam da bò thật 100% loại nhỏ có khe để thẻ phía ngoài",149000,149000,0,0
TIKI,tui-thoi-trang-nam,125037676,"Ví nam, bóp nam da bò Nappa Bụi Leather V104 - Bảo hành 12 tháng",209000,370000,161000,44
TIKI,tui-thoi-trang-nam,51662045,"Túi Đeo Chéo Nam Da Cá Sấu CS1",219000,219000,0,0
TIKI,tui-thoi-trang-nam,141956188,"CHUỖI HỘI THẢO TIẾNG ANH ONLINE CHO NGƯỜI ĐI LÀM - TOÀN QUỐC",1998000,1998000,0,0
TIKI,tui-thoi-trang-nam,58563589,"Cặp Công Sở Đa Năng TRITA TCA6",369000,660000,291000,44
TIKI,tui-thoi-trang-nam,190514895,"Túi đeo chéo nam nữ thể thao chạy bộ Haosua cao cấp Shalla",128828,186085,57257,31
TIKI,tui-thoi-trang-nam,161026807,"Sinh Trắc Vân Tay Gen Talents – Dịch Vụ Tư Vấn Sinh Trắc Vân Tay Gia Đình – Gói Phân Tích Demo – Tặng Sách Điều Kỳ Diệu Của Tiệm Tạp Hóa NAMIYA (Tái Bản)",600000,600000,0,0
TIKI,tui-thoi-trang-nam,176130327,"Bóp ví nam có khóa kéo thời trang tiện lợi kiểu dáng hàn quốc ví nam cầm tay cao cấp Mã: MB21",178000,178000,0,0
TIKI,tui-thoi-trang-nam,246856334,"[E-Voucher] Sách nói Fonos; Xây Dựng Câu Chuyện Thương Hiệu",99000,99000,0,0
TIKI,tui-thoi-trang-nam,67299408,"Túi đeo chéo nam da bò cao cấp YILIDAISHU T32 27x25x6cm(Nâu - Đen)",299000,299000,0,0
TIKI,tui-thoi-trang-nam,188997575,"Bao da dành cho Chìa Khóa Smartkey Yamaha NVX, Janus, Nozza Grande, FreeGo, Latte, Exciter 155 VVA handmade da thật",99000,99000,0,0
TIKI,tui-thoi-trang-nam,54999656,"NEWSTAR TRAVEL - Tour Trong Ngày Miệt Vườn Mỹ Tho - Bến Tre",850000,850000,0,0
TIKI,tui-thoi-trang-nam,44336401,"Túi đeo chéo nam nữ unisex du lịch thời trang Hàn quốc BEE GEE cao cấp đẹp giá rẻ - XAM",50000,100000,50000,50
TIKI,tui-thoi-trang-nam,184123552,"Túi xách nam thời trang công sở chống thấm nước cao cấp",450000,499000,49000,10
TIKI,tui-thoi-trang-nam,125280023,"Ví nam, bóp nam da bò Saffiano Bụi Leather V128 - Bảo hành 12 tháng",229000,412000,183000,44
TIKI,tui-thoi-trang-nam,13565884,"Túi bao tử đeo chéo nam",180000,180000,0,0
TIKI,tui-thoi-trang-nam,21787118,"Tick Edu - Thai Giáo - Phát Triển Trí Tuệ Và Cảm Xúc Cho Con Từ Trong Bụng Mẹ",699000,699000,0,0
TIKI,tui-thoi-trang-nam,122911181,"Túi bao tử chính hãng thương hiệu Simplecarry Credo Sling 3",440000,440000,0,0
TIKI,tui-thoi-trang-nam,93151621,"Túi Đeo Chéo Nam Thời Trang Vải Bố Canvas Cao Cấp Dạng Hộp Chống Thấm Nước, Du Lịch, Đi Học, Đi Chơi",60000,69000,9000,13
TIKI,tui-thoi-trang-nam,95044323,"Sách nói: OKRs - Hiểu Đúng, Làm Đúng - Cách Để Áp Dụng Thành Công OKRs Ngay Từ Đầu",99000,99000,0,0
TIKI,tui-thoi-trang-nam,77682749,"Tài Liệu Marketing - Gói World Class - Bài Thi Young Lions 2017 + 2018 + 2019 - Hạng Mục Digital, Marketers, Film & Integrated, PR - Chuẩn quốc tế - Học mọi nơi - VYLWC31- Khóa học online - [Độc Quyền AIM ACADEMY]",750000,750000,0,0
TIKI,tui-thoi-trang-nam,146987945," Ví Da Nam Nhiều Ngăn VD04 Kiểu Đứng Đơn Giản Cá Tính",38000,50000,12000,24
TIKI,tui-thoi-trang-nam,157254213,"Túi Mini SAIGON SWAGGER SGS Mini Bag",200000,200000,0,0
TIKI,tui-thoi-trang-nam,162512656,"Phiếu Quà Tặng Ngân ĐÌnh Restaurant 100K",100000,100000,0,0
TIKI,tui-thoi-trang-nam,55028888,"Gói Khám Tổng Quát Sức Khoẻ Răng Miệng ",350000,350000,0,0
TIKI,tui-thoi-trang-nam,138802053,"Túi bao tử nam đeo chéo nam nữ du lịch tiện ích unisex thời trang Bee Gee 130 siêu đẹp chống thấm nước",69000,140000,71000,51
TIKI,tui-thoi-trang-nam,83830072,"Túi xách nam 100% da bò thật cao cấp phong cách mới 15.6inh",621000,690000,69000,10
TIKI,tui-thoi-trang-nam,67451818,"Túi Nam 4U Da Tổng Hợp Công Sở Sang Trọng DN269 (đen-nâu)",169000,195000,26000,13
TIKI,tui-thoi-trang-nam,193044239,"Túi xách nam công sở da bò thật tích hợp khóa chống trộm cao cấp",882000,980000,98000,10
TIKI,tui-thoi-trang-nam,184517203,"Túi đeo chéo nam cao cấp phong cách mới",288000,320000,32000,10
TIKI,tui-thoi-trang-nam,271726139,"Xe bus Đà Nẵng - Huế (một chiều)/ Shuttle Bus Da Nang to Hue (one way)",230000,230000,0,0
TIKI,tui-thoi-trang-nam,137499373,"Bóp Ví Nam Da Bò Cao Cấp Vân Cá Sấu Gù Nguyên Con Ví Đứng màu đen,màu nâu Viền khâu thủ công sang Trọng Bảo Hành 12 TH",175000,175000,0,0
TIKI,tui-thoi-trang-nam,44044210,"Cặp công sở thời trang CAYUUMY06",235000,390000,155000,40
TIKI,tui-thoi-trang-nam,155339338,"Ví đựng thẻ da bò sáp ngựa điên Crazyhorse V117 cao cấp, card holder da thật, đường chỉ may tinh tế, ví mini nam nhỏ gọn, đựng thẻ tiện lợi, fullbox, thương hiệu Bụi leather chuyên đồ da thật",130000,205000,75000,37
TIKI,tui-thoi-trang-nam,136942959,"[E-BOOK] Summer Camp starter Pre A1 Starters Sách giáo viên điện tử",15000,15000,0,0
TIKI,tui-thoi-trang-nam,169278770,"ví nam AD009, bóp nam da bò nappa cao cấp, ví da nam ví ngang thiết kế nhiều ngăn đựng tiền đựng thẻ, bảo hành da 6 tháng - Adonis Store",169000,269000,100000,37
TIKI,tui-thoi-trang-nam,117401394,"Ví Đựng Thẻ ATM Mini, Da Bò Mềm Mại GENTLE, Da Thật 100%, Thiết Kế Hiện Đại, Nhiều Ngăn Tiện Dụng, Đựng Thẻ Ngân Hàng, Danh Thiếp, Căn Cước, Hình Lưu Niệm, Dáng Đứng - Gập 2 - Hàng Chính Hãng SAIGIO",629000,649000,20000,3
TIKI,tui-thoi-trang-nam,14062664,"Cặp Da Nam Công Sở KG001",299500,599000,299500,50
TIKI,tui-thoi-trang-nam,102012570,"Túi đeo chéo nam mini vải canvas bền bỉ phong cách unisex Hàn Quốc TC02",198000,198000,0,0
TIKI,tui-thoi-trang-nam,130440816,"Ví nam AD09, ví da nam gấp 3 nhỏ gọn, bóp nam da bò thật nhiều ngăn đựng tiền đựng thẻ, bóp da nam cao cấp bảo hàng 12 tháng",185000,289000,104000,36
TIKI,tui-thoi-trang-nam,155330335,"Ví da nam, bóp da nam mini Bụi Leather V115 - Da bò Nappa cao cấp - Bảo hành 12 tháng",180000,278000,98000,35
TIKI,tui-thoi-trang-nam,771415,"Túi Đeo Chéo Nam Haras HRTK083 (26 x 17 cm) - Xanh",65000,65000,0,0
TIKI,tui-thoi-trang-nam,21761407,"Tick Edu - Tăng trưởng doanh số bán hàng nhờ chiến lược khuyến mãi",399000,399000,0,0
TIKI,tui-thoi-trang-nam,109389766,"Túi xách nam công sở da tự nhiên cao cấp phong cách mới",423000,470000,47000,10
TIKI,tui-thoi-trang-nam,249673480,"Tour 5N4Đ Đài Loan - Đài Bắc - Đài Trung - Cao Hùng, Khởi Hành Tháng 5, 6 ,7",12568000,12568000,0,0
TIKI,tui-thoi-trang-nam,125289842,"Ví nam, bóp nam da bò Saffiano Bụi Leather V140 - Bảo hành 12 tháng",215000,412000,197000,48
TIKI,tui-thoi-trang-nam,21775455,"Tick Edu - Nghệ Thuật Chăm Sóc Khách Hàng Xuất Sắc",799000,799000,0,0
TIKI,tui-thoi-trang-nam,174856854,"[E-BOOK] i-Learn Smart Start Special Edition 1 Kế hoạch giảng dạy",15000,15000,0,0
TIKI,tui-thoi-trang-nam,174860036,"[E-BOOK] i-Learn Smart Start Special Edition 2 Giáo án gợi ý",15000,15000,0,0
TIKI,tui-thoi-trang-nam,68887596,"Túi đeo chéo nam vải Oxford chống thấm",699000,699000,0,0
TIKI,tui-thoi-trang-nam,77691294," Tài Liệu Marketing - Gói World Class - Bài Thi Young Spikes 2019 - 3 Hạng Mục Digital, Integrated, PR - Chuẩn quốc tế - Học mọi nơi - VYLWC32- Khóa học online - [Độc Quyền AIM ACADEMY]",500000,500000,0,0
TIKI,tui-thoi-trang-nam,187792643,"Dubai | Abu Dhabi (4N4Đ)",28890000,28890000,0,0
TIKI,tui-thoi-trang-nam,103887358,"Bóp Da Cá Sấu Ví Nam Cá Sấu Phần Bụng Cao Cấp Giá Rẻ Màu Nâu ST04 Tặng Kèm Hộp Tặng Móc Khóa Cá Sấu",750000,750000,0,0
TIKI,tui-thoi-trang-nam,76448408,"Túi xách nam công sở cao cấp phong cách mới",423000,470000,47000,10
TIKI,tui-thoi-trang-nam,100931478,"Iseul Spa - Voucher Tái Sinh Da Kim Cương Đa Tầng ( Combo 2 lần )",1500000,1500000,0,0
TIKI,tui-thoi-trang-nam,229973539,"Phiếu Quà Tặng Potico 1000K",1000000,1000000,0,0
TIKI,tui-thoi-trang-nam,271975247,"[E-voucher Sannatour] Cổng trời Đông Giang",145000,145000,0,0
TIKI,tui-thoi-trang-nam,190514977,"Túi đeo chéo Chống nước PVC cao cấp đường xéo góc HÀNG NHẬP VB67",128066,184984,56918,31
TIKI,tui-thoi-trang-nam,272398026,"VŨNG TÀU HÀNH HƯƠNG 10 CẢNH CHÙA",590000,590000,0,0
TIKI,tui-thoi-trang-nam,147326633,"Cặp đa năng - Loại dày - cho học sinh giáo viên công sở, Cặp Laptop 5.0 VSTYLE (Văn phòng phẩm giá sỉ)",399000,399000,0,0
TIKI,tui-thoi-trang-nam,19258022,"Combo Chăm Sóc Da Mụn Ở Vùng Mặt Và Trị Mụn Ở Vùng Lưng Tại Mẹ & Em Spa ",499000,499000,0,0
TIKI,tui-thoi-trang-nam,170498952,"Bóp đựng tiền nhiều ngăn Simple Vertical Wallet V3 chính hãng NATOLI cầm tay kháng nước cao cấp",179000,256000,77000,30
TIKI,tui-thoi-trang-nam,133619399,"Cặp da công sở thời trang REDPIS 1101",2950000,2950000,0,0
TIKI,tui-thoi-trang-nam,76693893,"PMX - Khóa học Quản trị dự án - Kỹ năng Quản lý - Agilearn | Giải pháp Đào tạo Số hàng đầu cho Doanh nghiệp tại Việt Nam",780000,780000,0,0
TIKI,tui-thoi-trang-nam,76693576,"OKRX - Khóa học Quản trị mục tiêu hiện đại với OKR - Kỹ năng Quản lý - Agilearn | Giải pháp Đào tạo Số hàng đầu cho Doanh nghiệp tại Việt Nam",1270000,1270000,0,0
TIKI,tui-thoi-trang-nam,93878483,"Túi đeo chéo thông minh Divoom Pixoo Slingbag hiển thị màn hình Led, tích hợp app Divoom",1590000,1950000,360000,18
TIKI,tui-thoi-trang-nam,21775478,"Tick Edu - Kungfu Bán Hàng Triệu Đô",999000,999000,0,0
TIKI,tui-thoi-trang-nam,271734119,"Xe bus Huế - Đà Nẵng (một chiều)/ Shuttle Bus Hue to Da Nang (one way)",230000,230000,0,0
TIKI,tui-thoi-trang-nam,70846687,"Túi đeo chéo nam nữ unisex thời trang Hàn quốc BEE GEE 098 để được laptop và áo quần",99000,199000,100000,50
TIKI,tui-thoi-trang-nam,21775422,"Tick Edu - Bí Quyết Xây Dựng Mối Quan Hệ Trong Kinh Doanh",699000,699000,0,0
TIKI,voucher-dich-vu,72099107,"KHÓA HỌC GIẢI QUYẾT CÁC VẤN ĐỀ TRONG HỆ THỐNG CÓ LƯỢNG TRUY CẬP LỚN",6000000,6000000,0,0
TIKI,tui-thoi-trang-nam,75616814,"Túi đeo chéo nam tích hợp khóa chống trộm và chống thấm nước cao cấp phong cách mới",423000,470000,47000,10
TIKI,tui-thoi-trang-nam,107962047,"Ví Nam Da Bò Thật Dáng Đứng Đẳng Cấp Quý Ông",259000,259000,0,0
TIKI,tui-thoi-trang-nam,98823444,"Jeonbok - Phiếu Quà Tặng 50K",50000,50000,0,0
TIKI,tui-thoi-trang-nam,160901190,"Sinh Trắc Vân Tay Gen Talents – Dịch Vụ Tư Vấn Sinh Trắc Vân Tay Gia Đình – Gói Phân Tích Demo – Tặng Sách Nhà Giả Kim",600000,600000,0,0
TIKI,voucher-dich-vu,242078512,"[Chuyện Con Mèo Dạy Hải Âu Bay] Voiz FM - Voucher nghe Sách Nói",29000,38000,9000,24
TIKI,voucher-dich-vu,272732679,"Khóa Học Video Online Thực Hành Xoa Bóp Bấm Huyệt Cải Thiện Triệu Chứng Chóng Mặt, Tiền Đình Tại Nhà - Trung Tâm Chăm Sóc Sức Khỏe VMC - VMC2307.TĐN",600000,600000,0,0
TIKI,tui-thoi-trang-nam,95175053,"Sách nói: Nhà Tiên Tri Vanga Và Vũ Trụ Huyền Bí",99000,99000,0,0
TIKI,tui-thoi-trang-nam,141349351,"[KHÓA HỌC ONLINE TƯƠNG TÁC] Học Revit Architecture (Cơ Bản+Nâng Cao)-(Tương tác trực tiếp với giảng viên qua Zoom)",2450000,2450000,0,0
TIKI,voucher-dich-vu,248502308,"[Phi Lý Một Cách Hợp Lý] Voiz FM - Voucher nghe Sách Nói",49000,59000,10000,17
TIKI,voucher-dich-vu,248505466,"[Sức Mạnh Của Hiện Tại] Voiz FM - Voucher nghe Sách Nói ",69000,88000,19000,22
TIKI,voucher-dich-vu,248476667,"[Trầm Cảm - Sát Thủ Thầm Lặng] Voiz FM - Voucher nghe Sách Nói ",39000,48000,9000,19
TIKI,voucher-dich-vu,248501718,"[Tôi Muốn Trở Thành Người Lãnh Đạo] Voiz FM - Voucher nghe Sách Nói ",79000,99000,20000,20
TIKI,tui-thoi-trang-nam,141953827," TUYỆT KỸ GIAO TIẾP TIẾNG ANH CÔNG SỞ - ELEVATOR SPEECH",98000,98000,0,0
TIKI,voucher-dich-vu,248502335,"[Người Bán Hàng Vĩ Đại Nhất Thế Giới] Voiz FM - Voucher nghe Sách Nói",69000,89000,20000,22
TIKI,voucher-dich-vu,248326468,"[Dấu Chân Trên Cát] Voiz FM - Voucher nghe Sách Nói",99000,122000,23000,19
TIKI,voucher-dich-vu,242077115,"[Bí Mật Tư Duy Triệu Phú] Voiz FM - Voucher nghe Sách Nói",49000,63000,14000,22
TIKI,tui-thoi-trang-nam,157434406,"Túi Đeo Chéo Da Nam 4U Thời Trang Cá Tính D276",199000,220000,21000,10
TIKI,tui-thoi-trang-nam,155339755,"Ví sen 3 PLUS da bò Pullup V123, bóp mini nam nhỏ gọn hai màu đen và nâu, đường chỉ may tinh tế, đựng thẻ kẹp tiền tiện lợi, fullbox, thương hiệu Bụi leather chuyên đồ da thật",160000,278000,118000,42
TIKI,tui-thoi-trang-nam,133900168," Ví nam da bò thật VO 031005",165000,320000,155000,48
TIKI,voucher-dich-vu,117570857,"Khóa Hoc Video Online Chăm Sóc Dạ Dày Và Hệ Tiêu Hóa Chủ Động - Trung Tâm Chăm Sóc Sức Khỏe VMC",600000,600000,0,0
TIKI,tui-thoi-trang-nam,173343742,"Ví Nam Ngang Cao Cấp Sang Trọng, Chất Liệu Bền Đẹp, Ví Da Nam, Ví Nam Cầm Tay Nhiều Ngăn Tiện Lợi - Hàng chính hãng",32000,180000,148000,82
TIKI,voucher-dich-vu,248476277,"[Tôi Tài Giỏi, Bạn Cũng Thế] Voiz FM - Voucher nghe Sách Nói ",69000,80000,11000,14
TIKI,voucher-dich-vu,272617639,"Khóa Học Video Online 24 Động Tác Thai Yoga Masasge Toàn Thân Thư Giãn Và Phục Hồi Sức Khoẻ - Trung Tâm Chăm Sóc Sức Khỏe VMC",800000,800000,0,0
TIKI,voucher-dich-vu,248328169,"[OSHO-Hạnh Phúc Tại Tâm] Voiz FM - Voucher nghe Sách Nói ",49000,63000,14000,22
TIKI,voucher-dich-vu,242077906,"[Chiến Thắng Trò Chơi Chứng Khoán] Voiz FM - Voucher nghe Sách Nói",109000,144000,35000,24
TIKI,voucher-dich-vu,248504613,"[Làm Bạn Với Bầu Trời] Voiz FM - Voucher nghe Sách Nói",119000,154000,35000,23
TIKI,voucher-dich-vu,272618136,"Khóa Học Video Online Giải Pháp Phục Hồi Đau Mỏi Thắt Lưng Hông Cho Người Ngồi Làm Việc Với Máy Tính - Trung Tâm Chăm Sóc Sức Khỏe VMC",600000,600000,0,0
TIKI,voucher-dich-vu,272833921,"Khóa Học Video Online Dinh Dưỡng Cho Người Cường Giáp - Trung Tâm Chăm Sóc Sức Khỏe VMC",600000,600000,0,0
TIKI,voucher-dich-vu,248502298,"[Quẳng Gánh Lo Đi Và Vui Sống] Voiz FM - Voucher nghe Sách Nói",69000,87000,18000,21
TIKI,voucher-dich-vu,272260001,"Khóa Học 7 Đôi Mắt Thần (7 Phương Pháp Nghiên Cứu) – Phần 2 Thinking School Tự Học Online",800000,800000,0,0
TIKI,voucher-dich-vu,272936780,"Khóa Học Video Online Yoga Cho Người Thoái Hóa Khớp - Trung Tâm Chăm Sóc Sức Khỏe VMC",600000,600000,0,0
TIKI,voucher-dich-vu,272938545,"Khóa Học Video Online Yoga Tăng Cường Sức Mạnh Cơ, Xương, Khớp - Trung Tâm Chăm Sóc Sức Khỏe VMC",600000,600000,0,0
TIKI,tui-thoi-trang-nam,270122637,"The Cliff Resort 4* Mũi Né - Buffet Sáng Free, Hồ Bơi, Bãi Biển Riêng, Không Gian Xanh Mát, Nghỉ Dưỡng Đẳng Cấp Phan Thiết Và Nhiều Dịch Vụ Hấp Dẫn",1949000,1949000,0,0
TIKI,tui-thoi-trang-nam,111869000,"Túi đeo chéo Arctic Hunter XB00105 chất liệu Oxford chống thấm nước, unisex nam nữ,trang bị cổng sạc USB tiện dụng",359000,635000,276000,43
TIKI,tui-thoi-trang-nam,77747266,"Túi đeo chéo vải canvas cao cấp phong cách mới",269000,298000,29000,10
TIKI,tui-thoi-trang-nam,164338907,"Túi đeo chéo đeo ngực nam cao cấp phong cách châu âu",603000,670000,67000,10
TIKI,voucher-dich-vu,248325918,"[Đạo Con Đường Không Lối] Voiz FM - Voucher nghe Sách Nói",49000,58000,9000,16
TIKI,tui-thoi-trang-nam,87858835,"Túi đeo chéo nam nữ siêu đẹp siêu sang - Mã 8596",289000,499000,210000,42
TIKI,tui-thoi-trang-nam,159397242,"VOUCHER SỬA CHỮA HÀNG HIỆU CHUYÊN SÂU GIẢM 499.000VNĐ CHO ĐƠN HÀNG TỪ 2.500.000VNĐ",100000,100000,0,0
TIKI,voucher-dich-vu,272938243,"Khóa Học Video Online Yoga Cho Người Bị Đau Dạ Dày - Trung Tâm Chăm Sóc Sức Khỏe VMC",600000,600000,0,0
TIKI,voucher-dich-vu,200747392,"T4: TOUR CANO 4 ĐẢO CÁP TREO HÒN THƠM CÔNG VIÊN NƯỚC AQUATOPIA - PHÚ QUÔC",1400000,1400000,0,0
TIKI,voucher-dich-vu,272936707,"Khóa Học Video Online Các Bài Yoga Giảm Đau Lưng Và Cột Sống Tại Nhà - Trung Tâm Chăm Sóc Sức Khỏe VMC",600000,600000,0,0
TIKI,voucher-dich-vu,34589875,"Khóa Học Pro Salesman - Người Bán Hàng Tuyệt Vời",1700000,1700000,0,0
TIKI,voucher-dich-vu,248401538,"[Vị Tu Sĩ Bán Chiếc Ferrari] Voiz FM - Voucher nghe Sách Nói",69000,81000,12000,15
TIKI,voucher-dich-vu,273900588,"[Giftpop] Phiếu Quà Tặng Khu Vui Chơi Công Viên Văn Hoá Suối Tiên 500K",475000,500000,25000,5
TIKI,voucher-dich-vu,272267621,"Khóa Học Khai Thác Số Liệu Phục Vụ Công Việc Bằng Tư Duy Định Lượng Thinking School Tự Học Online",800000,800000,0,0
TIKI,voucher-dich-vu,272900630,"Khóa Học Video Online Lớp Mỹ Thuật Nâng Cao Cho Trẻ 6-10 Tuổi - Trung Tâm Chăm Sóc Sức Khỏe VMC",600000,600000,0,0
TIKI,voucher-dich-vu,272939256,"Khóa Học Video Online Yoga Tăng Cường Sinh Lý Cho Nữ - Trung Tâm Chăm Sóc Sức Khỏe VMC",600000,600000,0,0
TIKI,tui-thoi-trang-nam,164338780,"Bóp Nam, Ví Nam P016 – Thiết Kế Độc Đáo – Sang trọng – Tiện Dụng",47000,58000,11000,19
TIKI,voucher-dich-vu,273900595,"[Giftpop] Phiếu Quà Tặng Khu Vui Chơi Công Viên Văn Hoá Suối Tiên 200K",190000,200000,10000,5
TIKI,tui-thoi-trang-nam,148966755,"Bóp Da Nam, Ví Da Nam Đựng Tiền Nhiều Ngăn Tiện Lợi - Dòng Cao Cấp 2 Kiểu Dáng Ngang Và Đứng",85000,85000,0,0
TIKI,voucher-dich-vu,272731991,"Khóa Học Video Online Liệu Pháp Giải Cơ Phục Hồi Và Trị Liệu Đau Nhức Cổ Vai Gáy - Trung Tâm Chăm Sóc Sức Khỏe VMC",600000,600000,0,0
TIKI,voucher-dich-vu,272855617,"Khóa Học Video Online Thư Giãn Tinh Thần Thông Qua 5 Mẫu Hoa Cắm Lọ Đơn Giản - Trung Tâm Chăm Sóc Sức Khỏe VMC",600000,600000,0,0
TIKI,voucher-dich-vu,272855736,"Khóa Học Video Online Cắm Hoa Từ Nhựa Tái Chế Trong Gia Đình - Trung Tâm Chăm Sóc Sức Khỏe VMC",600000,600000,0,0
TIKI,tui-thoi-trang-nam,164554647,"Túi Đeo Chéo Nam, Túi Chéo Nam Đi Chơi Chất Đẹp, Túi Xách Nam, Túi Đeo Chéo Nhiều Màu, Thời Trang Siêu Chất - OTV164 - Ope Store",250000,250000,0,0
TIKI,voucher-dich-vu,272834409,"Khóa Học Video Online Kế Hoạch Giáo Dục Cá Nhân Cho Trẻ Rối Loạn Phát Triển Trong Môi Trường Hòa Nhập - Trung Tâm Chăm Sóc Sức Khỏe VMC - VMC-GDĐB.K10",600000,600000,0,0
TIKI,voucher-dich-vu,272908115,"Khóa Học Video Online Học Thanh Nhạc Thông Qua Các Bài Hát Đi Cùng Năm Tháng - Trung Tâm Chăm Sóc Sức Khỏe VMC",600000,600000,0,0
TIKI,voucher-dich-vu,272912592,"Khóa Học Video Online Vovinam Việt Võ Đạo Trình Độ 4 - Trung Tâm Chăm Sóc Sức Khỏe VMC",600000,600000,0,0
TIKI,voucher-dich-vu,273958150,"Voucher tập luyện 30 ngày - Win Fitness & Yoga (Kèm ưu đãi khi đăng ký gói trung hạn)",99000,99000,0,0
TIKI,tui-vi-nu,15467577,"Ví đựng thẻ ATM",9000,9000,0,0
TIKI,tui-vi-nu,86561978,"Túi xách nữ - Túi đeo chéo mini nữ hàng quảng châu siêu đẹp - siêu hot TD17",141700,141700,0,0
TIKI,tui-vi-nu,169423006,"Túi Tote Vải Canvas Nữ Ulzzang Hot Trend Kita Unisex - Mẫu 3 Chú Gà - Ảnh thật ( Có khóa)",39000,70000,31000,44
TIKI,tui-vi-nu,113496493,"Túi Cói Merci Đi Biển Cao Cấp",65990,65990,0,0
TIKI,tui-vi-nu,199999510,"NHÀ MỊ - Túi Xách handmade Len Đan Móc Thủ Công - Retro Granny Crochet Bag",760000,760000,0,0
TIKI,tui-vi-nu,149449217,"Túi xách nữ phối nơ - dây đeo chéo , kẹp nách chất liệu da PU cao cấp dáng vuông cho các cô nàng tiểu thư",118000,118000,0,0
TIKI,tui-vi-nu,173782267,"Túi Lục Bình Đi Biển Cao Cấp, Túi Xách Thời Trang, Túi Dạo Phố Mua Sắm",329000,329000,0,0
TIKI,tui-vi-nu,159004219,"Túi Vải Canvas UAG - Hàng Chính Hãng",200000,200000,0,0
TIKI,tui-vi-nu,186711474,"Túi xách nữ dễ thương NASI T1025 túi cói hình gấu cầm tay đẹp có dây kéo hoặc gài nút thời trang cho nữ công sở, học sinh",29000,29000,0,0
TIKI,tui-vi-nu,189552204,"Túi Xách Nữ Da Bò Cao Cấp Có 2 Kiểu Dây Đeo Phong Cách Công Sở TXD037 - Màu Xanh Dương, Size 28cm",890000,890000,0,0
TIKI,tui-vi-nu,115988863,"Túi đi biển Macrame Handmade",324500,324500,0,0
TIKI,tui-vi-nu,160315146,"Ví nữ ngắn mini cầm tay BATSIOE nhỏ gọn nhiều ngăn đựng tiền dễ thương da cao cấp cực đẹp giá rẻ BS03 - Micocah Mall",129000,129000,0,0
TIKI,tui-vi-nu,21979764,"Ví nữ da bò vân cá sấu nhỏ 2 gấp Huy Hoàng",599000,599000,0,0
TIKI,tui-vi-nu,186261781,"Túi tote cói túi đeo vai phong cách vintage, phụ kiện đi biển không thể thiếu",300000,300000,0,0
TIKI,tui-vi-nu,188043212,"Túi xách thời trang nữ cao cấp  ELLY – EL211",1299000,1299000,0,0
TIKI,tui-vi-nu,160314489,"Ví Nữ Ngắn Mini Cầm Tay Đựng Tiền Chính Hãng TAILIAN Thời Trang Kẻ Caro Xinh Xắn Da Cao Cấp Cực Đẹp TL12 - Micocah Mall",119000,119000,0,0
TIKI,tui-vi-nu,136940149,"Ví tiền thổ cẩm có dây đeo chéo ( cực hot)",15000,15000,0,0
TIKI,tui-vi-nu,196280234,"Ví Nữ Mini Cầm Tay Cao Cấp  Nhiều Ngăn Đựng Thẻ Dễ Thương",27900,27900,0,0
TIKI,tui-vi-nu,79414523,"Ví Da SAVER Đẹp Cầm Tay Da Nappa Cao Cấp Nhập Khẩu Khóa Kéo Tiện Lợi Thông Dụng DOLANTO",188000,188000,0,0
TIKI,tui-vi-nu,151923639,"Túi xách nữ bản to _Túi công sở đựng vừa A4",175000,175000,0,0
TIKI,tui-vi-nu,91127952,"Túi đeo chéo thế hệ mới Mark Ryden – TECNOLOGIA",1105000,1105000,0,0
TIKI,tui-vi-nu,190574784,"Túi xách nữ thời trang cao cấp ELLY – EL218",779400,1299000,519600,40
TIKI,tui-vi-nu,186568770,"Túi đeo chéo PopEye NASI T1017 phong cách hàn quốc túi đeo vai nữ thời trang dạo phố dễ thương vải đẹp",49000,49000,0,0
TIKI,tui-vi-nu,118852192,"túi xách nữ công sở có thế đeo chéo phong cách",99000,99000,0,0
TIKI,tui-vi-nu,72040184,"Túi Xách Nữ Thời Trang Cao Cấp",65000,65000,0,0
TIKI,tui-vi-nu,126705832,"Túi xách nữ da bò thật cao cấp FREYA 24.5",3490000,3490000,0,0
TIKI,tui-vi-nu,196791610,"Túi da đeo chéo nhiều ngăn tiện dụng",150000,150000,0,0
TIKI,tui-vi-nu,192725936,"Túi Xách Nữ Quai Lụa Da Mịn, Túi Mini Nữ đẹp Cá Tính Sang Chảnh PT087045",980000,980000,0,0
TIKI,tui-vi-nu,45200839,"Túi đeo chéo nữ thời trang Châu Âu",359000,359000,0,0
TIKI,tui-vi-nu,153460092,"Ví Zip Mini Cho Nữ Có Dây Đeo Tay GIPSY",350000,350000,0,0
TIKI,tui-vi-nu,73994855,"Túi Đeo Chéo Nữ Cao Cấp Phối Khóa - SMALL CROSSBODY PURSE - HGcork Corkor CK159 - Vật liệu da cork thực vật thuần chay - Sản phẩm Handmade, Sản xuất tại Bồ Đào Nha",1709050,1799000,89950,5
TIKI,tui-vi-nu,186743246,"Túi xách nữ dễ thương NASI T1026 túi cói cầm tay đẹp có dây kéo thời trang cho nữ công sở, học sinh",29000,29000,0,0
TIKI,tui-vi-nu,157213359,"Túi Đựng Phụ Kiện RINGKE Pouch - Hàng Chính Hãng",212500,250000,37500,15
TIKI,tui-vi-nu,191502908,"Túi xách tay nữ Aldo AREAWIEL",1650000,1650000,0,0
TIKI,tui-vi-nu,179776541,"Túi Cói, Túi Xách Cỏ Bàng Vẽ Hồng Hạc Đẹp Lạ",339000,339000,0,0
TIKI,tui-vi-nu,6772451,"Ví Passport Hand made",450000,450000,0,0
TIKI,tui-vi-nu,177185356,"Túi Xách Lục Bình Đính Hoa Cúc Cao Cấp, Chuẩn Đẹp, Túi Cói, Giỏ Xách Dự Tiệc, Dạo Phố, Đi Làm Đẹp",309000,309000,0,0
TIKI,tui-vi-nu,182813484,"Túi xách nữ Monogram Canvas ELLY – EL206",1899000,1899000,0,0
TIKI,tui-vi-nu,36273950,"Túi đeo chéo vải canvas, túi vải nữ TV05, phong cách Hàn Quốc, thời trang trẻ",50000,50000,0,0
TIKI,tui-vi-nu,107962515,"Ví Da Mini Unisex - Ví Nữ Mini Handmade Da Bò Thật",139000,139000,0,0
TIKI,tui-vi-nu,77746334,"VÍ DA NỮ THỜI TRANG CAO CẤP ELLY – EV70",699000,699000,0,0
TIKI,tui-vi-nu,35217332,"Túi nữ đeo chéo mini DYC trẻ trung  năng động thanh lịch phong cách Hàn quốc",90000,90000,0,0
TIKI,tui-vi-nu,91147067,"Túi bao tử nữ đeo chéo trước ngực, đeo hông cá tính KN9068",29000,29000,0,0
TIKI,tui-vi-nu,174468691,"Ví Nữ Ngắn Mini Cầm Tay Perfect For You Nhỏ Gọn Đựng Tiền Vân Ra Rắn Cao Cấp Cực Đẹp Giá Rẻ PFY26",99000,99000,0,0
TIKI,tui-vi-nu,105701133,"Túi tote thời trang đi học sinh viên học sinh - HỘP GÀI",81000,81000,0,0
TIKI,tui-vi-nu,117672638,"Túi cói đi biển hai màu mẫu mới phong cách hàn quốc",42000,44500,2500,6
TIKI,tui-vi-nu,54895172,"Túi xách tay nữ siêu sang dáng vuông charles da chần",75000,75000,0,0
TIKI,tui-vi-nu,102130055," Ví Nữ ◈◈ Ví Nữ Cầm Tay Mini Ngắn Nhỏ Gọn Bỏ Túi Siêu Xinh L01",100000,100000,0,0
TIKI,tui-vi-nu,186530758,"Túi xách nữ da tự nhiên thời trang công sở cao cấp phong cách mới",531000,590000,59000,10
TIKI,tui-vi-nu,157254208,"Túi Tote Chất Liệu Da Cao Cấp SAIGON SWAGGER Eclipse Leather Tote Bag",550000,550000,0,0
TIKI,tui-vi-nu,90912147,"Túi bao tử nữ đeo chéo trước ngực, đeo hông cá tính TX00306",199000,199000,0,0
TIKI,tui-vi-nu,31877168,"Túi đeo chéo xách tay thời trang nữ da PU bóng trơn mềm LH088",427000,427000,0,0
TIKI,tui-vi-nu,28912611,"Túi đeo chéo đựng điện thoại 2 ngăn",100000,100000,0,0
TIKI,tui-vi-nu,191412775," Túi vải tote ENZYCO đeo vai nhiều mẫu vải cotton cao cấp",50000,50000,0,0
TIKI,tui-vi-nu,45353404,"Túi xách đeo chéo hàn quốc nữ đẹp toza TX06",98000,98000,0,0
TIKI,tui-vi-nu,190828821,"Túi đeo chéo NASI T1033 phong cách hàn quốc túi xách nữ đeo vai thời trang dạo phố dễ thương vải đẹp",59000,59000,0,0
TIKI,tui-vi-nu,154179005,"Túi đeo chéo vải canvas hình ngộ nghĩnh",99000,99000,0,0
TIKI,tui-vi-nu,188042221,"Túi xách nữ thời trang cao cấp ELLY – EL208",979300,1399000,419700,30
TIKI,tui-vi-nu,149449626,"Túi xách nữ hai khóa cốp tròn siêu xinh - kiểu dáng độc đáo",259000,259000,0,0
TIKI,tui-vi-nu,88027584,"Túi đeo chéo nữ đựng điện thoại thời trang đi chơi dạo phố TK0079",29000,35000,6000,17
TIKI,tui-vi-nu,164197015,"Ví cầm tay nữ dáng ngang nắp gập LATA VN56",350000,350000,0,0
TIKI,tui-vi-nu,186124018,"Túi Vải Mini Đeo Chéo Cho Nữ Siêu Cute, Túi Đeo Vai Nữ Thời Trang Phong Cách Nhật Bản, Nhiều Màu Sắc Cá Tính",60000,60000,0,0
TIKI,tui-vi-nu,67097402,"Túi đeo chéo thêu thời trang nữ - Nụ tầm xuân",250000,250000,0,0
TIKI,tui-vi-nu,67418853,"Túi đeo chéo nữ thời trang Hàn Quốc dây xích sang trọng phù hợp đi chơi đi tiệc",99000,99000,0,0
TIKI,tui-vi-nu,192559833,"Túi xách nữ thời trang công sở cao cấp phong cách mới",387000,430000,43000,10
TIKI,tui-vi-nu,121234495,"Túi công sở da hai ly dầy đẹp -túi xách CHERRY",129000,129000,0,0
TIKI,tui-vi-nu,207357235,"Túi Canvas Nữ Thời Trang Hàn Quốc, Túi Vải Canvas Đeo Chéo Đơn Giản Siêu Xinh, Túi Tote Đeo Chéo Vải Canvas Đựng Đồ - OTV210 - Ope Store",210000,210000,0,0
TIKI,tui-vi-nu,86560732," Túi Cói    Túi Xách Nữ Mini Phong cách Vintage TV12",25000,25000,0,0
TIKI,tui-vi-nu,71512972,"Túi xách nữ thời trang cao cấp ELLY – EL152",839400,1399000,559600,40
TIKI,tui-vi-nu,109958963,"Túi đeo chéo vải Canvas thời trang, túi xách phong cách Hàn Quốc, phù hợp đi chơi, đi tiệc",125000,125000,0,0
TIKI,tui-vi-nu,131405286,"Túi xách đeo chéo công sở da trần trám đẹp sang chảnh BK17",75000,75000,0,0
TIKI,tui-vi-nu,160315333,"Ví Ngắn Nữ Mini Cầm Tay FOREVER YOUNG Gấp 3 Nhỏ Gọn Nhiều Ngăn Tiện Dụng VD12 - Micocah Mall",25000,25000,0,0
TIKI,tui-vi-nu,209414358,"Túi đeo chéo và cầm đựng điện thoại Manydi TDC200 thời trang xinh xắn đeo ngang",154000,154000,0,0
TIKI,tui-vi-nu,147942365,"Ví Bóp Nữ Mini Cầm Tay FOREVER YOUNG Đựng Tiền Nhiều Ngăn Tiện Dụng Chất Da Xước Cực Đẹp FY49 - Tukado",149000,149000,0,0
TIKI,tui-vi-nu,77680537,"Túi xách nữ thời trang cao cấp ELLY- EL168",839400,1399000,559600,40
TIKI,tui-vi-nu,104361510,"3 Bóp ( Ví ) đựng thẻ ngân hàng",17999,17999,0,0
TIKI,tui-vi-nu,195126785,"Túi da chéo CROS HAVIAS",680000,680000,0,0
TIKI,tui-vi-nu,175656160,"Túi đeo chéo nữ ,Túi xách nữ da trơn nắp khóa cài 1 ngăn thời trang Hàn QuốC LK193",99000,99000,0,0
TIKI,tui-vi-nu,192074280,"Túi đeo chéo Nữ đựng điện thoại 2 ngăn kéo - VN005",90000,90000,0,0
TIKI,tui-vi-nu,194025664,"Túi đeo nữ da cá sấu nguyên tấm màu đen dễ phối đồ!",3090000,5200000,2110000,41
TIKI,tui-vi-nu,184897246,"[SGFS169][Xinh xắn] Ví cầm tay mini - Ví nữ cầm tay thời trang nhiều màu sắc",45000,45000,0,0
TIKI,tui-vi-nu,186136281,"Túi xách nữ thời trang công sở cao cấp phong cách mới",441000,490000,49000,10
TIKI,tui-vi-nu,191291926,"Ví nữ cầm tay dáng đứng YUUMY Ripple YV75",89000,190000,101000,53
TIKI,tui-vi-nu,96013853,"Ví Cầm Tay Nữ ESME Thời Trang ES0345 Chất Liệu Da Mềm Mại",789000,789000,0,0
TIKI,tui-vi-nu,91421847,"Túi tote It's OK",117000,117000,0,0
TIKI,tui-vi-nu,171545510,"Túi Tote Vải Canvas Cỡ Lớn, Túi Xách Đeo Vai Merci Đựng Đồ Cho Nữ - OTV103 - Ope Store",164000,164000,0,0
TIKI,tui-vi-nu,31911289,"Ví cầm tay thời trang Unisex LATA VN34",299000,380000,81000,21
TIKI,tui-vi-nu,193111995,"Ví cầm tay nữ có dây đeo chéo nhiều ngăn đựng tiền,đựng thẻ ATM và điện thoại phong cách Hàn Quốc X001",1165000,1165000,0,0
TIKI,tui-vi-nu,196855134,"Ví đựng thẻ card Mundo da bò vân hạt",370000,370000,0,0
TIKI,tui-vi-nu,115438873,"Ví cốp cầm tay, ví nữ, ví uzzlang ví cầm tay, ví nữ thời trang , ví passport",167000,167000,0,0
TIKI,tui-vi-nu,176218004,"Túi Tote Đeo Chéo Thời Trang ULZZANG BASIC Cho Nam Nữ Đi Học Đi Chơi – Vải Dệt Canvas",99000,99000,0,0
TIKI,tui-vi-nu,55481753,"Túi đeo chéo nam nữ unisex thời trang BEE GEE 088 chống thấm nước để điện thoại ipad mini",59000,119000,60000,50
TIKI,tui-vi-nu,20542076,"Ví Da Bò Thật Đựng Thẻ Atm Name Card",179000,179000,0,0
TIKI,tui-vi-nu,71565914,"Túi xách nữ thời trang cao cấp ELLY- EL145",909350,1399000,489650,35
TIKI,tui-vi-nu,72789860,"Túi xách nữ, túi kẹp nách nữ đeo chéo da vân cá sấu dây xích cực đẹp TX41 với thiết kế hiện đại",39000,39000,0,0
TIKI,tui-vi-nu,160315147,"Túi Xách Nữ Đeo Chéo Chính Hãng FOREVER YOUNG Dáng Công Sở Thời Trang Phong Cách Ulzzang Da Cao Cấp Cực Đẹp FY13",239000,239000,0,0
TIKI,tui-vi-nu,205527662,"Ví nữ đính đá bà sui sang trọng- túi xách đính đá V đi tiệc trung niên thanh lịch,túi diện áo dài đứng sui sang trọng",439000,439000,0,0
TIKI,tui-vi-nu,157084663,"Bóp ví nữ cầm tay mini V092 khóa tròn nhiều ngăn nhỏ gọn phong cách đơn giản, thời trang, dễ thương",25000,50000,25000,50
TIKI,tui-vi-nu,53979967,"Ví nữ cầm tay cao cấp 2 ngăn kéo sang trọng, thiết kế nhiều ngăn tiện dụng TK0047 - ĐỎ ",76000,100000,24000,24
TIKI,tui-vi-nu,104958894,"TÚI XÁCH NỮ TÚI ĐEO VAI TÚI BAO TỬ ĐEO CHÉO SÀNH ĐIỆU",90000,90000,0,0
TIKI,tui-vi-nu,242746185,"Ví đứng bấm cúc bóp đựng tiền nam nữ chất liệu vải canvas",150000,150000,0,0
TIKI,tui-vi-nu,81208972,"Túi Vải Đeo Chéo Nữ Nhiều Họa Tiết 461",59000,59000,0,0
TIKI,tui-vi-nu,89113017,"Túi Xách Nữ Thời Trang Kèm Dây Đeo Chéo Chất Da Rắn Bền Đẹp Thiết Kế Trẻ Trung Size 20 Nhỏ Xinh",76000,76000,0,0
TIKI,tui-vi-nu,173029565,"Túi Nữ túi xách tay Kẻ Sọc Thời Trang Phong Cách Cá Tính 205970",45800,62000,16200,26
TIKI,tui-vi-nu,193051691,"Túi Xách Nữ Đeo Vai Cao Cấp Phong Cách Hiện Đại Âu Mỹ TVNN365",659000,659000,0,0
TIKI,tui-vi-nu,97069588,"Túi xách đựng giấy A4, laptop, thiết kế đơn giản, thông dụng, chuyên nghiệp, kèm dây thừng đeo vai không đau, chất liệu vải bố (Nhiều mẫu để lựa)",84000,140000,56000,40
TIKI,tui-vi-nu,136940097,"Túi thổ cẩm đựng tiền (cb)",15000,15000,0,0
TIKI,tui-vi-nu,176842819,"Túi xách nữ thời trang cao cấp phong cách châu âu",405000,450000,45000,10
TIKI,tui-vi-nu,217519097,"Túi , Ví đeo chéo cho bé , hình xinh yêu ,Làm bằng cao su non ,mềm mại và an toàn",89000,89000,0,0
TIKI,tui-vi-nu,202042624,"Túi đeo chéo nữ vải dù gai 5 ngăn chống nước, phong cách Hàn Quốc Size 20cm TUI-49",189000,189000,0,0
TIKI,tui-vi-nu,150991722,"Bóp ví nữ cầm tay mini V0516 Bò sữa bỏ túi nhiều ngăn nhỏ gọn phong cách đơn giản, thời trang, dễ thương",25000,50000,25000,50
TIKI,tui-vi-nu,73502223,"Túi Đeo Chéo Nữ Dáng Hộp Nắp Gập Style Sang Chảnh Đi Làm, Đi Chơi, Dự Tiệc Đều Đẹp (21x14cm)",169000,169000,0,0
TIKI,tui-vi-nu,71594388,"Ví nữ cầm tay thời trang cao cấp ELLY – EVH68",799000,799000,0,0
TIKI,tui-vi-nu,57860963,"TÚI ĐEO CHÉO NƯ DỄ THƯƠNG AZDT119I",68000,68000,0,0
TIKI,tui-vi-nu,37495739,"Ví  Bóp Ngang Nữ Mini Cầm Tay Vuông Forever Da Pu Cao Cấp Khóa Kéo Chắc Chắn (4 màu:hồng,đen,xám,xanh dương)",25000,30000,5000,17
TIKI,tui-vi-nu,115440149,"Bóp cầm tay, ví cầm tay,bóp tiền, ví nữ, bóp nữ, bóp da, bóp đẹp, ví nữ giá rẻ, bóp cầm tay 2 ngăn, ví cầm tay 2 ngăn",120000,120000,0,0
TIKI,tui-vi-nu,179438184,"Túi đeo chéo Vải Canvas nam nữ học sinh sinh viên đi học đi chơi thời trang Hàn Quốc",139000,139000,0,0
TIKI,tui-vi-nu,71176855,"Túi xách nữ thời trang cao cấp ELLY – EL156",1399000,1399000,0,0
TIKI,tui-vi-nu,185468261,"túi ví đeo chéo nữ thời trang đựng vừa điện thoại 6.5" với khe thẻ bên ngoài - N8612",178000,259000,81000,31
TIKI,tui-vi-nu,183891770,"Túi xách nữ thời trang sang trọng dự tiệc",950000,950000,0,0
TIKI,tui-vi-nu,86561309,"Túi Xách Nữ  50K - TÚI ĐEO CHÉO DÂY PHA XÍCH ULZZANG CÁ TÍNH KT 12CM TD04",55000,55000,0,0
TIKI,tui-vi-nu,171182240,"Túi đeo chéo 2 ngăn đựng điện thoại cao cấp thời trang",199000,199000,0,0
TIKI,tui-vi-nu,167948453,"Set 3 túi trong suốt đựng đồ, mỹ phẩm du lịch thời trang",60700,60700,0,0
TIKI,tui-vi-nu,176127217,"Vỏ Bọc Hộ Chiếu (Passport) Trong Suốt Có Khe Kẹp Vé Thẻ ATM Bền Bỉ Tiện Dụng",2999,2999,0,0
TIKI,tui-vi-nu,271924712,"Túi đeo chéo da nữ dáng hộp LATA HN109",590000,590000,0,0
TIKI,tui-vi-nu,193620925,"Túi Xách Nữ Đeo Chéo, Túi Xách Công Sở Nữ Nhiều Ngăn Tiện Dụng, Nhiều Màu Sắc Lựa Chọn",140000,140000,0,0
TIKI,tui-vi-nu,196373076,"Túi xách nữ da cá sấu BẠCH TẠNG hàng hiếm!",3400000,5500000,2100000,38
TIKI,tui-vi-nu,71624227,"Ví nữ thời trang cao cấp cầm tay dự tiệc sang trọng và thời thượng",490000,490000,0,0
TIKI,tui-vi-nu,12218126,"Túi Bao Tử Đeo Chéo Da PU Quai Sọc 3 Màu Trẻ Trung Parisa",35640,48708,13068,27
TIKI,tui-vi-nu,185468019,"ví mini nữ đựng thẻ hàng hiệu nhỏ xinh mỏng nhẹ chứa thẻ xe, thẻ ngân hàng - NR073",88000,159000,71000,45
TIKI,tui-vi-nu,42735009,"Ví cầm tay nữ kiêm túi đeo chéo nữ da nắp đường tròn có khóa gài lớn, kiểu dáng sang trọng, lịch lãm",146000,146000,0,0
TIKI,tui-vi-nu,149402837,"TÚI TOTE ĐEO CHÉO BƯỚM",87000,87000,0,0
TIKI,tui-vi-nu,164430160,"Ví dài nữ da bò cao cấp MARRANT BHM8303N mẫu mới, nhiều màu",450000,450000,0,0
TIKI,tui-vi-nu,10717329,"Túi cói túi tote đi biển đan tay phong cách tối giản kiểu hàn quốc see thru crotched straw bag",200000,200000,0,0
TIKI,tui-vi-nu,96445933,"Túi xách nữ đeo chéo vân da cá sấu cao cấp TX15 túi xách đeo vai",249000,249000,0,0
TIKI,tui-vi-nu,193720448,"TÚI ĐEO CHÉO UNISEX ĐỰNG ĐIỆN THOẠI CHẤT LIỆU DA CAO CẤP CHỐNG NƯỚC",330000,330000,0,0
TIKI,tui-vi-nu,176897259,"Clutch nữ cầm tay da bò thật mềm mại - Pink Ohara",590000,590000,0,0
TIKI,tui-vi-nu,43348955,"Túi xách tay nữ",120000,120000,0,0
TIKI,tui-vi-nu,88051137,"Túi xách đeo chéo nữ thời trang cao cấp HuongTra99-5566a",1199000,1199000,0,0
TIKI,tui-vi-nu,178313019,"Túi Cói, Túi Xách Cỏ Bàng Vẽ Đẹp Lạ, Giỏ Xách Du Lịch, Túi Đựng Đồ Đa Năng",359000,359000,0,0
TIKI,tui-vi-nu,20447897,"Túi Vải Tote Đeo Chéo Balo Mẫu Ghép Hàng Quảng Châu Cực Tốt",106000,106000,0,0
TIKI,tui-vi-nu,187725651,"Túi xách nữ dễ thương NASI T1040 túi cói cầm tay đẹp có dây kéo hoặc gài nút thời trang cho nữ công sở, học sinh",29000,29000,0,0
TIKI,tui-vi-nu,107962435,"Ví mini nữ đựng thẻ vô cùng nhỏ gọn, nhiều ngăn phù hợp đựng tiền, các loại thẻ",89000,89000,0,0
TIKI,tui-vi-nu,248990754,"Nút chén (nút 4 thành phần)",45000,45000,0,0
TIKI,tui-vi-nu,191775162,"Túi Xách Nữ Kẹp Nách Chính Hãng MICOCAH Dáng Công Sở Thời Trang Đeo Vai Đeo Chéo Tiện Dụng Da Cao Cấp Cực Đẹp MC135",479000,479000,0,0
TIKI,tui-vi-nu,194041302,"Ví Da Nữ DAVANTI Cầm Tay Nhỏ Gọn DFN255",260000,290000,30000,10
TIKI,tui-vi-nu,103458507,"Túi tote Snoppy chất vải mềm mịn thời trang - Tặng dây buộc tóc hoa quả",110000,110000,0,0
TIKI,tui-vi-nu,49956510,"Túi đeo nữ thời trang  dây xích, nhỏ xinh, chất liệu PU bền đẹp TK0040",45000,78000,33000,42
TIKI,tui-vi-nu,148677771,"Túi tote vải canvas đeo vai đi học đi chơi phong cách uzzang giá rẻ",69000,69000,0,0
TIKI,tui-thoi-trang-nam,91447829,"Cặp Túi Da Nam C92",810000,810000,0,0
TIKI,tui-thoi-trang-nam,149179571,"Túi đeo chéo nam da bò cao cấp YILIDAISHU T33 27x24x6cm(Nâu - Đen) D.HSTORE",750000,750000,0,0
TIKI,tui-vi-nu,172993694,"Túi Đeo Quân Đội Thời Trang 208128",90000,90000,0,0
TIKI,tui-thoi-trang-nam,162584139,"Túi đeo ngực, đeo chéo nam đã tích hợp công nghệ 4.0 mã BG-7221",399000,699000,300000,43
TIKI,tui-thoi-trang-nam,115520033,"Cặp da công sở tay rút nắp can VINADA ",269000,269000,0,0
TIKI,tui-vi-nu,51296455,"Túi Vải nữ Tote Đeo Vai Hàn Quốc",75900,75900,0,0
TIKI,tui-thoi-trang-nam,188566537,"Túi Đeo Chéo Nam Oxford Cao Cấp Nhiều Ngăn Chống Thấm Nước, Túi Đeo Vai Phong Cách Thời Trang Hàn Quốc Dành Cho Người Đi Làm, Học Sinh, Sinh Viên,Người Đi Chơi, Đi Du Lịch",135000,135000,0,0
TIKI,tui-thoi-trang-nam,274181930,"[Red River Tour] Đi Bộ Dưới Đáy Biển "Seawalker" Tại Công Viên San Hô Phú Quốc Hằng Ngày",1215000,1350000,135000,10
TIKI,tui-thoi-trang-nam,203477303,"Tẩy trắng răng phương pháp Laser Whitening 5P - Nha khoa BeDental (5 chi nhánh)",899000,899000,0,0
TIKI,tui-thoi-trang-nam,125136680,"Ví nam, bóp nam da bò sáp Bụi Leather V106 - Bảo hành 12 tháng",209000,370000,161000,44
TIKI,tui-thoi-trang-nam,199630798,"Trò chơi vận động 3in1 Game Bull Track Cả Nhà Cùng Vui (Full Option) ",468000,468000,0,0
TIKI,tui-thoi-trang-nam,249262111,"Khóa thông minh nhận diện khuôn mặt Face ID 3D , vân tay, thẻ từ, mật khẩu công nghệ Đức Demax SL918 PB",15032000,15032000,0,0
TIKI,tui-thoi-trang-nam,119947168,"[E-BOOK] Tiếng Anh 6 Right on! Sách giáo viên điện tử Bài học",15000,15000,0,0
TIKI,voucher-dich-vu,152666462,"Sách nói: Digital Transformation - Chuyển Đổi Số",99000,99000,0,0
TIKI,tui-thoi-trang-nam,111868972,"Balo một dây đeo chéo Arctic Hunter XB00116 chất liệu Oxford chống thấm nước, unisex nam nữ,trang bị cổng sạc USB",515000,849000,334000,39
TIKI,tui-thoi-trang-nam,188897976,"Sách nói: Điểm đến của cuộc đời",99000,99000,0,0
TIKI,tui-thoi-trang-nam,221701804,"Phiếu Quà Tặng Cân - Taiwanese Street Hotpot 500K",475000,500000,25000,5
TIKI,tui-thoi-trang-nam,82921698,"Túi xách túi đeo vai nam 100% da bò cao cấp phong cách châu âu",711000,790000,79000,10
TIKI,tui-thoi-trang-nam,260803635,"Evoucher - Phiếu Quà Tặng Nha Khoa Smile Beauty 100K",95000,100000,5000,5
TIKI,tui-thoi-trang-nam,170501923,"Ví cầm tay dài nam  BST The Long Wallet chính hãng NATOLI nhiều ngăn chống nước sang trọng thời trang",469000,666000,197000,30
TIKI,tui-thoi-trang-nam,221701776,"Phiếu Quà Tặng Cân - Taiwanese Street Hotpot 100K",95000,100000,5000,5
TIKI,tui-thoi-trang-nam,186305131,"Sách nói: Pháp Môn Hạnh Phúc: Gia Đình",99000,99000,0,0
TIKI,tui-thoi-trang-nam,273902078,"Toàn quốc [E-Voucher] Phiếu quà tặng trị giá 500k, áp dụng cho mọi sản phẩm tại web/app Potico.vn",400000,400000,0,0
TIKI,tui-thoi-trang-nam,170125120,"MLB - Túi bao tử thời trang Monogram 3AHSM012N",2590000,2590000,0,0
TIKI,tui-thoi-trang-nam,274274717,"Tour trong ngày Rừng Dừa Bảy Mẫu (DAVTC07)",300000,300000,0,0
TIKI,voucher-dich-vu,19751696,"Combo Lấy Cao Răng + Điều Trị Viêm Lợi + Tẩy Trắng Răng Với Công Nghệ Zoom 2 White Speed tại Navii Dental Care",4000000,4000000,0,0
TIKI,tui-thoi-trang-nam,211927114,"Phiếu Quà Tặng Au Lac Do Brazil 1000K",1000000,1000000,0,0
TIKI,tui-vi-nu,210414187,"Túi xách nữ đẹp giá rẻ công sở thời trang đi làm dự tiệc cao cấp LH114",1375000,1375000,0,0
TIKI,voucher-dich-vu,52477756,"Khóa học online Chinh phục chứng chỉ MOS WORD 2016 Tin học Cộng",650000,650000,0,0
TIKI,tui-thoi-trang-nam,207345000,"Sách nói Những Lời Giáo Huấn Của Epictetus",99000,99000,0,0
TIKI,tui-thoi-trang-nam,184505936,"Sách nói: Zadig Hay Số Phận",99000,99000,0,0
TIKI,tui-thoi-trang-nam,155109972,"Sách nói: Những Gã Khổng Lồ Trung Quốc",99000,99000,0,0
TIKI,tui-vi-nu,196203264,"Túi Xách Lục Bình Bán Nguyệt Quai Gỗ Chuẩn Đẹp-Giỏ Lục Bình Sang Trọng TXLBBNQGLTK02",289000,289000,0,0
TIKI,tui-thoi-trang-nam,131137801,"Bài giảng trực tuyến Kỹ năng chuẩn bị lịch và nội dung chương trình",50000,50000,0,0
TIKI,tui-thoi-trang-nam,152663509,"Sách nói: Nho Giáo",99000,99000,0,0
TIKI,tui-vi-nu,76827288,"DKMV Ví ngắn vải canvas in logo con cá - DKMV Wallet Label",170000,170000,0,0
TIKI,tui-vi-nu,248978905,"Túi đi học thêm",90000,90000,0,0
TIKI,voucher-dich-vu,187608673,"Giftpop - Phiếu Quà tặng Yakimono 100K",100000,100000,0,0
TIKI,voucher-dich-vu,206204746,"Tour 4N3Đ Khám Phá Miền Bắc - Ngủ Đêm Trên Du Thuyền 5 Sao Trên Vịnh Hạ Long - Khám Phá Ninh Bình - Hạ Long (Khởi Hành Hàng Ngày Từ Hà Nội, Trọn Gói Ăn Uống + Vé Tham Quan + Phòng Ngủ)",4950000,4950000,0,0
TIKI,tui-thoi-trang-nam,59107698,"Túi đeo chéo nam da bò cao cấp T09 27x24x5cm",265000,265000,0,0
TIKI,tui-thoi-trang-nam,176025212,"Sách nói: Phương Pháp Ăn Uống Cải Thiện Lưu Thông Máu",99000,99000,0,0
TIKI,tui-thoi-trang-nam,177978212,"Sách nói: Phố Đàn Bà",99000,99000,0,0
TIKI,tui-thoi-trang-nam,189201599,"Sách nói: Những Bá Chủ Không Gian",99000,99000,0,0
TIKI,tui-thoi-trang-nam,125256490,"Ví nam, bóp nam da bò Saffiano Bụi Leather V126 - Bảo hành 12 tháng",229000,375000,146000,39
TIKI,tui-thoi-trang-nam,12038935,"Túi Đeo Chéo Nam Nữ 17x23x8cm",43999,43999,0,0
TIKI,tui-thoi-trang-nam,165699459,"Túi đeo chéo nam Vải canvas chỉ 2 chấm siêu nhẹ NH78 Shalla tặng bút cảm ứng",29729,40630,10901,27
TIKI,tui-thoi-trang-nam,108850224,"Ví nam thời trang da bò thật LATA LVN84",490000,490000,0,0
TIKI,voucher-dich-vu,74366608,"[E-Voucher] Phiếu quà tặng Voucher Dịch vụ Vệ sinh 200.000 VNĐ áp dụng Toàn bộ Dịch vụ Vệ Sinh Không Gian Sạch - Tổng đài miễn phí 18006248 để đặt hẹn",170000,170000,0,0
TIKI,voucher-dich-vu,120357442,"[E-BOOK] Tiếng Anh 1 i-Learn Smart Start Cẩm nang hướng dẫn Phụ huynh",15000,15000,0,0
TIKI,tui-thoi-trang-nam,270834157,"Evoucher Phiếu Quà Tặng Jeonbok - BaoYu 50K ",47500,50000,2500,5
TIKI,tui-thoi-trang-nam,274241177,"Tour trong ngày Cù Lao Chàm (DAVTC04)",550000,550000,0,0
TIKI,tui-thoi-trang-nam,103047087,"Ví Đựng Thẻ Nam Nữ Da Epsom Handmade Lealux Mini Epsom Wallet 1",599000,599000,0,0
TIKI,voucher-dich-vu,34476201,"Khóa học Phân tích báo cáo tài chính cốt lõi",600000,600000,0,0
TIKI,voucher-dich-vu,136943117,"[E-BOOK] Summer Camp Movers A1 Sách giáo viên điện tử",15000,15000,0,0
TIKI,tui-thoi-trang-nam,274192065,"Tour Đà Nẵng – Hội An – Huế 3N2D (VTC04)",2350000,2350000,0,0
TIKI,tui-vi-nu,134025588,"Ví cầm tay nam nữ, ví dài sang trọng, Ví da cao cấp, ví nam Quảng Châu, ví nữ thời trang, ví da bò",170500,170500,0,0
TIKI,tui-thoi-trang-nam,193202414,"Túi Da Đeo Chéo Nhỏ, Túi Đeo Chéo Da Nam Nữ Phong Cách Thời Trang Hàn Quốc",120000,120000,0,0
TIKI,tui-thoi-trang-nam,111868698,"Túi đeo chéo du lịch nam Arctic Hunter K00096 chất liệu Oxford chống thấm nước, đựng ipad, thiết kế nhiều ngăn tiện dụng",379000,650000,271000,42
TIKI,tui-vi-nu,251384693,"Túi đeo chéo gấu dâu đáng yêu",65000,65000,0,0
TIKI,voucher-dich-vu,91771726,"Sách nói Fonos: Bão Giông Mới Là Cuộc Đời",99000,99000,0,0
TIKI,tui-thoi-trang-nam,250070936,"Sách - Bùng nổ tiếng Anh – 27 giới từ hữu ích trong tiếng Anh giao tiếp - Thái Hà",169150,199000,29850,15
TIKI,tui-thoi-trang-nam,190119237,"Sách nói: Hành Lý Hư Vô",99000,99000,0,0
TIKI,tui-thoi-trang-nam,178572168,"Sách nói: Cho Đời Bớt Muộn Phiền",99000,99000,0,0
TIKI,tui-thoi-trang-nam,162100442,"Ví nam DEABOLAR phiên bản cao cấp nhiều ngăn tiện lợi",76000,120500,44500,37
TIKI,tui-thoi-trang-nam,134222430,"Túi đeo chéo nam nữ thời trang BEE GEE 0129 để điện thoại ipad chống thấm nước đẹp chất lượng tốt",68000,138000,70000,51
TIKI,tui-thoi-trang-nam,191651830,"Phiếu Quà Tặng Mắt Kính Tâm Đức 500K",475000,500000,25000,5
TIKI,tui-thoi-trang-nam,186243851,"Sách nói: Đừng Để Những Tin Đồn Về Ung Thư Giết Chết Bạn",99000,99000,0,0
TIKI,voucher-dich-vu,174012934,"Sách nói: Nên dân trị Mỹ",99000,99000,0,0
TIKI,voucher-dich-vu,184511311,"Sách nói: Isaac Newton - Nhà Khoa Học Vĩ Đại",99000,99000,0,0
TIKI,voucher-dich-vu,196674875,"Combo THƯ GIÃN TOÀN THÂN & THẢI ĐỘC DA CHUYÊN SÂU | Xông hơi thư giãn làm sạch bụi bẩn và bã nhờn + Lột bỏ tận gốc mụn cám, mụn đầu đen & nhân mụn + Massage ấn huyệt tăng tuần hoàn máu + Đắp mặt nạ dưỡng Collagen (Liệu trình trọn gói full)",1000000,1000000,0,0
TIKI,voucher-dich-vu,188555104,"[EVoucher Vietravel ] Buôn Ma Thuột - Pleiku - Kon Tum - KDL Măng Đen",4990000,4990000,0,0
TIKI,tui-thoi-trang-nam,197107344,"Đèn Led Softlight SL-288A dùng quay phim và chụp ảnh KingMa ",2868000,2868000,0,0
TIKI,tui-thoi-trang-nam,148850138,"Ví nam cầm tay Arctic Hunter Q00011 dáng dài, dập vân khóa kéo zip YKK sang trọng",230000,415000,185000,45
TIKI,tui-thoi-trang-nam,126765488,"Túi đeo chéo Fashion vải Canvas unisex nam nữ phong cách trẻ trung Hàn",55000,110000,55000,50
TIKI,tui-thoi-trang-nam,247936680,"ELSA Speak Pro 1 năm- Phần mềm tiếng Anh Online chất lượng cao",945000,945000,0,0
TIKI,voucher-dich-vu,122938241,"[E-BOOK] i-Learn Smart Start Grade 4 File nghe Audio",10000,10000,0,0
TIKI,tui-thoi-trang-nam,77703745,"Túi Đeo bao tử, nịt bụng đeo chéo đa năng ngang kéo tian l21 Tăng móc khóa nam cao cấp",78210,106887,28677,27
TIKI,tui-thoi-trang-nam,178068944,"Sách nói: Khởi Nghiệp Kinh Doanh Online - Bán Hàng Hiệu Quả Trên F.a.c.e.b.o.o.k",99000,99000,0,0
TIKI,voucher-dich-vu,53824001,"Khoá học: Chứng chỉ hành nghề Bất động sản",3800000,3800000,0,0
TIKI,voucher-dich-vu,190233669,"Phiếu Quà Tặng Hoa Yêu Thương 100K",100000,100000,0,0
TIKI,voucher-dich-vu,186292944,"Sách nói: Khám Phá Sứ Mệnh Với Câu Hỏi Tại Sao",99000,99000,0,0
TIKI,voucher-dich-vu,258670225,"Evoucher Cân - Taiwanese Street Hotpot - Set Vạn Hảo",323000,323000,0,0
TIKI,voucher-dich-vu,179735278,"Sách nói: Tam Quốc Diễn Nghĩa 6",99000,99000,0,0
TIKI,voucher-dich-vu,174243152,"Sách nói: Suy Tưởng",99000,99000,0,0
TIKI,tui-thoi-trang-nam,182834070,"Sách nói: Ngợi Ca Tình Yêu Thương",99000,99000,0,0
TIKI,voucher-dich-vu,190238899,"Hoa Yêu Thương - Evoucher Bó Hoa Tươi - Beautiful You ",1600000,1600000,0,0
TIKI,voucher-dich-vu,194133211,"Khóa Học Tập Luyện Cải Thiện Tư Thế Cho Người Ngồi Nhiều - Trung Tâm Chăm Sóc Sức Khỏe VMC",600000,600000,0,0
TIKI,voucher-dich-vu,155106798,"Sách nói: Tâm Lý Học Thành Công",99000,99000,0,0
TIKI,voucher-dich-vu,121959469,"KHÓA HỌC 10 THÓI QUEN ĐỂ THÀNH CÔNG BỀN VỮNG",999000,999000,0,0
TIKI,tui-thoi-trang-nam,43673298,"Ví cầm tay nam da cao cấp Dạng hộp bản to hình chuột túi trơn SD13 Shalla",147510,201597,54087,27
TIKI,voucher-dich-vu,175150905,"Sách nói: 100 Triệu Năm Thực Phẩm",99000,99000,0,0
TIKI,tui-thoi-trang-nam,83377797,"Ví Sen Cách Điệu Da Bò Thật, Bóp Mini Unisex Thời Trang, Nhỏ Gọn VS19-01",149000,149000,0,0
TIKI,voucher-dich-vu,121261583,"Khóa Học Live-Online Tiếng Anh KET-PET",1152000,1152000,0,0
TIKI,tui-vi-nu,193002777,"Túi Xách Nữ Kẹp Nách Chính Hãng MICOCAH Dáng Công Sở Thời Trang Đeo Vai Đeo Chéo Tiện Dụng Da Cao Cấp Cực Đẹp MC135 - Tukado",489000,489000,0,0
TIKI,tui-thoi-trang-nam,213568504,"Ví nam mini kiểu đứng bóp nam đựng tiền 3 màu thời trang nhỏ gọn DN9150",125000,250000,125000,50
TIKI,voucher-dich-vu,186277439,"Sách nói: Làm Sạch Mạch và Máu",99000,99000,0,0
TIKI,tui-thoi-trang-nam,263961192,"Túi xách nam công sở da bò thật cao cấp phong cách mới",794000,882000,88000,10
TIKI,tui-thoi-trang-nam,179952283,"[Giftpop] Phiếu Quà Tặng TOUS les JOURS 500K",500000,500000,0,0
TIKI,tui-thoi-trang-nam,27531795,"Túi Đeo Thắt Lưng Du Lịch Phong Cách Quân Đội",64350,87945,23595,27
TIKI,tui-vi-nu,248684511,"Túi sách nữ khóa vuông ô thời trang cá tính sang trọng ",130000,130000,0,0
TIKI,voucher-dich-vu,187608675,"Giftpop - Phiếu Quà tặng Yakimono 200K",200000,200000,0,0
TIKI,tui-thoi-trang-nam,150873006,"Clutch, Ví Cầm Tay Thời Trang Nam Da Bò Khóa Vân Tay Cao Cấp RB06",2500000,2500000,0,0
TIKI,tui-vi-nu,163792870,"TÚI ĐEO CHÉO. TÚI XÁCH NỮ DA MỀM NỮ MÀU ĐEN",200000,200000,0,0
TIKI,voucher-dich-vu,178475332,"Sách nói: Tạp Văn Nguyễn Ngọc Tư",99000,99000,0,0
TIKI,tui-thoi-trang-nam,183377459,"Túi xách nam công sở, cặp da nam đựng laptop và tài liệu cao cấp GCE12",2750000,2750000,0,0
TIKI,tui-thoi-trang-nam,38504524,"Túi Phụ Kiện  Đeo Hông ,Đựng Điện Thoại ,  LT01",64350,87945,23595,27
TIKI,tui-thoi-trang-nam,70154795," Túi Đeo Chéo Trước Ngực 4U Da Tổng Hợp Cá Tính BA417",199000,250000,51000,20
TIKI,voucher-dich-vu,67107867,"Chicken Plus - Gà Không Xương Sốt Creamy Onion Lớn",159000,159000,0,0
TIKI,voucher-dich-vu,119263072,"[E-BOOK] Tiếng Anh 6 i-Learn Smart World Vở ghi chú",10000,10000,0,0
TIKI,tui-thoi-trang-nam,177128197,"Sách nói: Sức Khỏe Trong Tay Bạn - Tập 1",99000,99000,0,0
TIKI,tui-thoi-trang-nam,178313418,"Cặp Nam LATA CA09",650000,650000,0,0
TIKI,voucher-dich-vu,211301234,"TOUR DU LỊCH PHÚ QUỐC 3N2Đ",1850000,1850000,0,0
TIKI,voucher-dich-vu,252401868,"[EVoucher Vietravel] Mệnh giá 7.000.000 VND áp dụng cho tour Bali giá từ 12.990.000",7000000,7000000,0,0
TIKI,tui-thoi-trang-nam,143100393,"Ví nam da bò Anh Tho Leather 065",299000,375000,76000,20
TIKI,voucher-dich-vu,185366067,"Sách nói: Dạy Con Làm Giàu - Tập 12",99000,99000,0,0
TIKI,tui-thoi-trang-nam,148808284,"Ví dài cầm tay da bò Mill cao cấp Bụi Leather C104 - Bảo hành 12 tháng",450000,665000,215000,32
TIKI,tui-thoi-trang-nam,187643720,"Sách nói: 50 Bài Học Cơ Bản Để Trở Thành Người Lịch Thiệp",99000,99000,0,0
TIKI,voucher-dich-vu,273502899,"Voucher Nail Design Đính Đá (đá nhỏ, đá hình, đá khối) 1 ngón",20000,40000,20000,50
TIKI,tui-thoi-trang-nam,186312660,"Sách nói: Phụ Nữ Thông Minh Không Ở Góc Văn Phòng",99000,99000,0,0
TIKI,tui-thoi-trang-nam,148850126,"Ví nam cầm tay Arctic Hunter Q00010 dáng dài dập vân có nút bấm",215000,350000,135000,39
TIKI,voucher-dich-vu,119445539,"[E-BOOK] Tiếng Anh 1 i-Learn Smart Start Bộ tranh hình",15000,15000,0,0
TIKI,voucher-dich-vu,190238932,"Hoa Yêu Thương - Evoucher Bó Hoa Tươi - Freshness",730000,730000,0,0
TIKI,tui-thoi-trang-nam,77316752,"Bóp ví nam da bò thật 4U cao cấp dáng ngang, nhiều ngăn đựng tiền và thẻ FA162",230000,260000,30000,12
TIKI,tui-thoi-trang-nam,924544,"Túi Đeo Chéo Nam HARAS HRTK147 (26 x 17 cm) - Đen",65000,65000,0,0
TIKI,tui-thoi-trang-nam,96010866,"Ví Dài Cầm Tay Nam Nữ Thời Trang Baellerry (2 khóa )",129000,129000,0,0
TIKI,voucher-dich-vu,152785778,"Sách nói: Làm Mẹ Rất Vui - Cẩm Nang 365 Ngày Đầu Của Mẹ Bên Con",99000,99000,0,0
TIKI,tui-thoi-trang-nam,37939795,"Túi Da Đeo Chéo P074",359000,359000,0,0
TIKI,tui-thoi-trang-nam,177253548,"Sách nói: Kẻ Khôn Đi Lối Khác",99000,99000,0,0
TIKI,tui-thoi-trang-nam,274182655,"[Red River Tour] Cano 4 Đảo Phú Quốc Hằng Ngày",515200,560000,44800,8
TIKI,voucher-dich-vu,174247439,"Sách nói: Nguồn Gốc Các Loài",99000,99000,0,0
TIKI,tui-thoi-trang-nam,200822866,"Sách nói: Việt Nam Phong Tục",99000,99000,0,0
TIKI,voucher-dich-vu,131137801,"Bài giảng trực tuyến Kỹ năng chuẩn bị lịch và nội dung chương trình",50000,50000,0,0
TIKI,voucher-dich-vu,273902078,"Toàn quốc [E-Voucher] Phiếu quà tặng trị giá 500k, áp dụng cho mọi sản phẩm tại web/app Potico.vn",400000,400000,0,0
TIKI,voucher-dich-vu,211927114,"Phiếu Quà Tặng Au Lac Do Brazil 1000K",1000000,1000000,0,0
TIKI,voucher-dich-vu,179952283,"[Giftpop] Phiếu Quà Tặng TOUS les JOURS 500K",500000,500000,0,0
TIKI,voucher-dich-vu,119947168,"[E-BOOK] Tiếng Anh 6 Right on! Sách giáo viên điện tử Bài học",15000,15000,0,0
TIKI,voucher-dich-vu,207345000,"Sách nói Những Lời Giáo Huấn Của Epictetus",99000,99000,0,0
TIKI,voucher-dich-vu,250070936,"Sách - Bùng nổ tiếng Anh – 27 giới từ hữu ích trong tiếng Anh giao tiếp - Thái Hà",169150,199000,29850,15
TIKI,voucher-dich-vu,188897976,"Sách nói: Điểm đến của cuộc đời",99000,99000,0,0
TIKI,voucher-dich-vu,197107344,"Đèn Led Softlight SL-288A dùng quay phim và chụp ảnh KingMa ",2868000,2868000,0,0
TIKI,voucher-dich-vu,249262111,"Khóa thông minh nhận diện khuôn mặt Face ID 3D , vân tay, thẻ từ, mật khẩu công nghệ Đức Demax SL918 PB",15032000,15032000,0,0
TIKI,voucher-dich-vu,199630798,"Trò chơi vận động 3in1 Game Bull Track Cả Nhà Cùng Vui (Full Option) ",468000,468000,0,0
TIKI,voucher-dich-vu,274181930,"[Red River Tour] Đi Bộ Dưới Đáy Biển "Seawalker" Tại Công Viên San Hô Phú Quốc Hằng Ngày",1215000,1350000,135000,10
TIKI,voucher-dich-vu,191651830,"Phiếu Quà Tặng Mắt Kính Tâm Đức 500K",475000,500000,25000,5
TIKI,voucher-dich-vu,260803635,"Evoucher - Phiếu Quà Tặng Nha Khoa Smile Beauty 100K",95000,100000,5000,5
TIKI,voucher-dich-vu,274192065,"Tour Đà Nẵng – Hội An – Huế 3N2D (VTC04)",2350000,2350000,0,0
TIKI,voucher-dich-vu,184505936,"Sách nói: Zadig Hay Số Phận",99000,99000,0,0
TIKI,voucher-dich-vu,177253548,"Sách nói: Kẻ Khôn Đi Lối Khác",99000,99000,0,0
TIKI,voucher-dich-vu,189201599,"Sách nói: Những Bá Chủ Không Gian",99000,99000,0,0
TIKI,voucher-dich-vu,190119237,"Sách nói: Hành Lý Hư Vô",99000,99000,0,0
TIKI,voucher-dich-vu,177128197,"Sách nói: Sức Khỏe Trong Tay Bạn - Tập 1",99000,99000,0,0
TIKI,voucher-dich-vu,221701804,"Phiếu Quà Tặng Cân - Taiwanese Street Hotpot 500K",475000,500000,25000,5
TIKI,voucher-dich-vu,274182655,"[Red River Tour] Cano 4 Đảo Phú Quốc Hằng Ngày",515200,560000,44800,8
TIKI,voucher-dich-vu,187643720,"Sách nói: 50 Bài Học Cơ Bản Để Trở Thành Người Lịch Thiệp",99000,99000,0,0
TIKI,voucher-dich-vu,221701776,"Phiếu Quà Tặng Cân - Taiwanese Street Hotpot 100K",95000,100000,5000,5
TIKI,voucher-dich-vu,176025212,"Sách nói: Phương Pháp Ăn Uống Cải Thiện Lưu Thông Máu",99000,99000,0,0
TIKI,voucher-dich-vu,200822866,"Sách nói: Việt Nam Phong Tục",99000,99000,0,0
TIKI,voucher-dich-vu,152663509,"Sách nói: Nho Giáo",99000,99000,0,0
TIKI,voucher-dich-vu,203477303,"Tẩy trắng răng phương pháp Laser Whitening 5P - Nha khoa BeDental (5 chi nhánh)",899000,899000,0,0
TIKI,voucher-dich-vu,186305131,"Sách nói: Pháp Môn Hạnh Phúc: Gia Đình",99000,99000,0,0
TIKI,voucher-dich-vu,274274717,"Tour trong ngày Rừng Dừa Bảy Mẫu (DAVTC07)",300000,300000,0,0
TIKI,voucher-dich-vu,186243851,"Sách nói: Đừng Để Những Tin Đồn Về Ung Thư Giết Chết Bạn",99000,99000,0,0
TIKI,voucher-dich-vu,155109972,"Sách nói: Những Gã Khổng Lồ Trung Quốc",99000,99000,0,0
TIKI,voucher-dich-vu,247936680,"ELSA Speak Pro 1 năm- Phần mềm tiếng Anh Online chất lượng cao",945000,945000,0,0
TIKI,voucher-dich-vu,178068944,"Sách nói: Khởi Nghiệp Kinh Doanh Online - Bán Hàng Hiệu Quả Trên F.a.c.e.b.o.o.k",99000,99000,0,0
TIKI,voucher-dich-vu,178572168,"Sách nói: Cho Đời Bớt Muộn Phiền",99000,99000,0,0
TIKI,voucher-dich-vu,270834157,"Evoucher Phiếu Quà Tặng Jeonbok - BaoYu 50K ",47500,50000,2500,5
TIKI,voucher-dich-vu,177978212,"Sách nói: Phố Đàn Bà",99000,99000,0,0
TIKI,voucher-dich-vu,186312660,"Sách nói: Phụ Nữ Thông Minh Không Ở Góc Văn Phòng",99000,99000,0,0
TIKI,voucher-dich-vu,182834070,"Sách nói: Ngợi Ca Tình Yêu Thương",99000,99000,0,0
TIKI,voucher-dich-vu,274241177,"Tour trong ngày Cù Lao Chàm (DAVTC04)",550000,550000,0,0
TIKI,tui-vi-nu,19729892,"Túi đeo chéo vải bố nam TX0003",327600,455000,127400,28
TIKI,tui-vi-nu,4699077,"Cặp đa năng văn phòng chỉ xéo",184115,251624,67509,27
TIKI,tui-vi-nu,141009896,"Túi đeo chéo nam cao cấp, vải Oxford chống nhăn,chống thấm nước,chống bám bụi, túi đeo vai phong cách thời trang Châu Âu",399000,399000,0,0
TIKI,tui-vi-nu,94038063,"Túi đeo hông nam nữ Túi đeo chéo chạy bộ Túi thể thao dã ngoại Sport TTC1 kích thước 31 x11 x 19 cm",34303,49549,15246,31
TIKI,tui-vi-nu,56512790,"Ví nam cầm tay cao cấp",129000,129000,0,0
TIKI,tui-vi-nu,78950876,"Túi xách nam công sở 100% da bò thật cao cấp phong cách mới",899000,998000,99000,10
TIKI,tui-vi-nu,3282989,"Túi đeo chéo da nam [HÀNG NHẬP] DTN12-2TI",76000,76000,0,0
TIKI,tui-vi-nu,68658966,"Túi đeo chéo vải bố thời trang 2001",170000,170000,0,0
TIKI,tui-vi-nu,138802053,"Túi bao tử nam đeo chéo nam nữ du lịch tiện ích unisex thời trang Bee Gee 130 siêu đẹp chống thấm nước",69000,140000,71000,51
TIKI,tui-vi-nu,38050388,"Túi Đeo Chéo Phản Quang Phát Sáng Thời Trang Hàn Quốc FALDO",219000,219000,0,0
TIKI,tui-vi-nu,37938772,"Cặp Xách Da Công Sở P073",375250,395000,19750,5
TIKI,tui-vi-nu,54001669,"Đeo chéo hông bụng nam nữTĐ 5528 dạng lớn hàn quốc HGF01",118057,161345,43288,27
TIKI,tui-vi-nu,89837896,"Ví nam cầm tay da bò Gianni Conti VP0169DBR",4100000,4100000,0,0
TIKI,tui-vi-nu,771415,"Túi Đeo Chéo Nam Haras HRTK083 (26 x 17 cm) - Xanh",65000,65000,0,0
TIKI,tui-vi-nu,125097857,"Ví nam, bóp nam da bò sáp Bụi Leather V105 - Bảo hành 12 tháng",209000,370000,161000,44
TIKI,tui-vi-nu,193201445,"Túi Đeo Vai, Túi Đeo Chéo Da PU, Túi Đeo Hông Cao Cấp Nhiều Ngăn Tiện Lợi Thời Trang Nam Phong Cách Hàn Quốc",95000,95000,0,0
TIKI,tui-vi-nu,13565884,"Túi bao tử đeo chéo nam",180000,180000,0,0
TIKI,tui-vi-nu,186210607,"Túi xách nam công sở, cặp da nam đựng laptop và tài liệu cao cấp CGL10",3400000,3400000,0,0
TIKI,tui-vi-nu,133619399,"Cặp da công sở thời trang REDPIS 1101",2950000,2950000,0,0
TIKI,tui-vi-nu,189491562,"Túi đeo chéo nam DA THẬT cao cấp phong cách mới – BEE GEE DCN9071",1238000,2500000,1262000,50
TIKI,tui-vi-nu,190514977,"Túi đeo chéo Chống nước PVC cao cấp đường xéo góc HÀNG NHẬP VB67",128066,184984,56918,31
TIKI,tui-vi-nu,125280023,"Ví nam, bóp nam da bò Saffiano Bụi Leather V128 - Bảo hành 12 tháng",229000,412000,183000,44
TIKI,tui-vi-nu,51662045,"Túi Đeo Chéo Nam Da Cá Sấu CS1",219000,219000,0,0
TIKI,tui-vi-nu,130440816,"Ví nam AD09, ví da nam gấp 3 nhỏ gọn, bóp nam da bò thật nhiều ngăn đựng tiền đựng thẻ, bóp da nam cao cấp bảo hàng 12 tháng",185000,289000,104000,36
TIKI,tui-vi-nu,107962047,"Ví Nam Da Bò Thật Dáng Đứng Đẳng Cấp Quý Ông",259000,259000,0,0
TIKI,tui-vi-nu,103887358,"Bóp Da Cá Sấu Ví Nam Cá Sấu Phần Bụng Cao Cấp Giá Rẻ Màu Nâu ST04 Tặng Kèm Hộp Tặng Móc Khóa Cá Sấu",750000,750000,0,0
TIKI,tui-vi-nu,70846687,"Túi đeo chéo nam nữ unisex thời trang Hàn quốc BEE GEE 098 để được laptop và áo quần",99000,199000,100000,50
TIKI,tui-vi-nu,75319988,"Túi đeo chéo unisex thời trang HARAS HR276",80000,80000,0,0
TIKI,tui-vi-nu,147799009,"Ví Da Nam Bò Sáp Nhiều Ngăn Tiện Dụng Kiểu Dáng Sang Trọng Nam Tính",168000,336000,168000,50
TIKI,tui-vi-nu,130070341," Túi đeo chéo nam nữ phong cách lính",137000,137000,0,0
TIKI,tui-vi-nu,122911181,"Túi bao tử chính hãng thương hiệu Simplecarry Credo Sling 3",440000,440000,0,0
TIKI,tui-vi-nu,190514895,"Túi đeo chéo nam nữ thể thao chạy bộ Haosua cao cấp Shalla",128828,186085,57257,31
TIKI,tui-vi-nu,176130327,"Bóp ví nam có khóa kéo thời trang tiện lợi kiểu dáng hàn quốc ví nam cầm tay cao cấp Mã: MB21",178000,178000,0,0
TIKI,tui-vi-nu,83830072,"Túi xách nam 100% da bò thật cao cấp phong cách mới 15.6inh",621000,690000,69000,10
TIKI,tui-vi-nu,68887596,"Túi đeo chéo nam vải Oxford chống thấm",699000,699000,0,0
TIKI,tui-vi-nu,160406240,"Ví da nam da bò thật 100% loại nhỏ có khe để thẻ phía ngoài",149000,149000,0,0
TIKI,tui-vi-nu,111869000,"Túi đeo chéo Arctic Hunter XB00105 chất liệu Oxford chống thấm nước, unisex nam nữ,trang bị cổng sạc USB tiện dụng",359000,635000,276000,43
TIKI,tui-vi-nu,157254213,"Túi Mini SAIGON SWAGGER SGS Mini Bag",200000,200000,0,0
TIKI,tui-vi-nu,146987945," Ví Da Nam Nhiều Ngăn VD04 Kiểu Đứng Đơn Giản Cá Tính",38000,50000,12000,24
TIKI,tui-vi-nu,164338780,"Bóp Nam, Ví Nam P016 – Thiết Kế Độc Đáo – Sang trọng – Tiện Dụng",47000,58000,11000,19
TIKI,tui-thoi-trang-nam,116877991,"Ví Cá Sấu Gù To 2 Mặt, Ví Nam Cá Sấu Dáng Ngang, Màu Đen, Nâu Cafe",650000,650000,0,0
TIKI,tui-thoi-trang-nam,153265039,"Túi đeo chéo Vui Nhộn Hoạt Hình Mstaly-MBCR Mẫu mới Shalla",38610,52767,14157,27
TIKI,tui-thoi-trang-nam,149180017,"Túi xách da công sở cao cấp JEEP BULUO T05-2 (KT 39x29x8cm)",666000,666000,0,0
TIKI,tui-thoi-trang-nam,147993769,"Ví Da Nam VD02 Kiểu Ngang Trẻ Trung Phong Cách",168000,336000,168000,50
TIKI,tui-thoi-trang-nam,102498855,"Bóp ví Alan Walker cầm tay đựng đồ nhỏ gọn, nhiều ngăn thời trang cá tính trẻ trung",109000,109000,0,0
TIKI,tui-thoi-trang-nam,97729163," Ví nam PIDENGBAO tiện ích nhỏ gọn",137800,137800,0,0
TIKI,tui-thoi-trang-nam,19707058,"Túi đeo hông, túi đeo bụng nam nữ",65000,65000,0,0
TIKI,tui-thoi-trang-nam,72888449,"Ví bọc hộ chiếu Passport chất liệu da cover hoạt hình "I Love You"",55000,75000,20000,27
TIKI,tui-thoi-trang-nam,84774464,"Túi bao tử - túi đeo chéo - túi đeo bụng nam nữ da bò thật SEAGLE SGB01",434500,434500,0,0
TIKI,tui-thoi-trang-nam,75832656,"Ví dài cầm tay mẫu mới nam nữ Lesin cao cấp N56 Tặng móc khóa hình búa siêu ngầu",139705,201796,62091,31
TIKI,tui-thoi-trang-nam,193607571,"Túi đeo chéo nam đa năng cao cấp phong cách mới",180000,199000,19000,10
TIKI,tui-thoi-trang-nam,193104706,"Ví nam đứng da bò cao cấp TRITA RVN18",199000,390000,191000,49
TIKI,tui-thoi-trang-nam,111537503,"Ví nam da bò cao cấp phong cách mới",351000,390000,39000,10
TIKI,tui-thoi-trang-nam,105618769,"Túi đeo chéo đeo ngực nam cao cấp phong cách mới",603000,670000,67000,10
TIKI,tui-thoi-trang-nam,47992489,"Túi bao tử đeo hông nhiều ngăn TROY MS1",118000,139000,21000,15
TIKI,tui-thoi-trang-nam,121334938,"Ví da namecard LATA Luxdeli LVN102",180000,180000,0,0
TIKI,tui-thoi-trang-nam,75478590,"Túi Đeo Chéo Nam Nữ Chất Da Pu Cao Cấp Phong Cách Cá Tính Năng Động, Cá Tính",119790,163713,43923,27
TIKI,tui-thoi-trang-nam,108850884,"Ví nam da bò thật cao cấp TRITA RVN08 ví ngang đựng tiền và thẻ card",199000,380000,181000,48
TIKI,tui-thoi-trang-nam,711036,"Túi Đeo Chéo Nam HARAS HRTK105 (27 x 17 cm) - Đen",65000,65000,0,0
TIKI,tui-thoi-trang-nam,22145346,"Túi hộp đeo chéo nam vải dù chống thấm nước T1084",169000,169000,0,0
TIKI,tui-thoi-trang-nam,130471908,"Túi Đeo Chéo Nam Vải CanVas Chống Thấm Nước, Nhiều Ngăn Chứa Đồ, Túi Đeo Vai Nam Vải Bố Bền Đẹp_Túi Đi Chơi, Đi Làm Phong Cách Thời Trang Hiện Đại",325000,325000,0,0
TIKI,tui-thoi-trang-nam,146618296,"Bóp Da Đựng Thẻ ATM Nhỏ Gọn, Chất Da Pull-Up Mềm Mại, Trẻ Trung - Cá Tính, Thiết Kế Hiện Đại, Nhiều Ngăn Tiện Dụng, Đựng Thẻ Ngân Hàng, Card Danh Thiếp, Căn Cước Công Dân, Hình Lưu Niệm, Dáng Đứng - Gập 2 - Hàng Chính Hãng SAIGIO",779000,799000,20000,3
TIKI,tui-thoi-trang-nam,177017362,"Túi đeo chéo đeo vai nam vải canvas cao cấp phong cách mới",387000,430000,43000,10
TIKI,tui-thoi-trang-nam,109103074,"Túi đeo chéo bao tử thời trang nam chống thấm nước cao cấp",73260,100122,26862,27
TIKI,tui-thoi-trang-nam,191376194,"Bao da dành cho Chìa Khóa Honda Lead 2022, AirBlade 2023, Winner X 2022, PCX 160, Vario 160, AB 125, AB 160 2023 handmade da thật",99000,99000,0,0
TIKI,tui-thoi-trang-nam,252795368,"[Da thật] Clutch cầm tay nam da bò thật CL126LS (Đen/Nâu sáng/Nâu sẫm) - 100% da bò thật, BH 3 năm",539000,539000,0,0
TIKI,tui-thoi-trang-nam,93712433,"ví nam - ví nam cầm tay cao cấp",269000,298000,29000,10
TIKI,tui-thoi-trang-nam,50491493,"Túi đeo ngực,đeo chéo nam đã tích hợp công nghệ 4.0",621000,690000,69000,10
TIKI,tui-thoi-trang-nam,59234311,"Ví nam vuông cao cấp hình mắt cú thời thời trang",55687,76106,20419,27
TIKI,tui-thoi-trang-nam,158610488,"CITIZEN Business Card Holder, Ví Đựng Thẻ ATM Cao Cấp, Dành Cho Doanh Nhân, Thiết Kế Hiện Đại - Sang Trọng, Chất Liệu Da Bò Vachetta Thuộc Thảo Mộc, Nhập Khẩu Từ Châu Âu, Hoàn Thiện Tỉ Mỉ - Tinh Tế Từng Chi Tiết - Hàng Chính Hãng SAIGIO ",2479000,2499000,20000,1
TIKI,tui-thoi-trang-nam,109479028,"Túi đeo chéo nam cao cấp phong cách mới",359000,398000,39000,10
TIKI,tui-thoi-trang-nam,83691185,"Túi xách cặp da đựng laptop công sở",365000,365000,0,0
TIKI,tui-thoi-trang-nam,107962265,"Ví Nam Mini Da Bò SÁP Dáng Đứng SVN Leather Fullbox",189000,189000,0,0
TIKI,tui-thoi-trang-nam,137997996,"Cặp da thời trang công sở",550000,550000,0,0
TIKI,tui-thoi-trang-nam,151460338,"[Da thật] Túi đeo chéo nam da bò thật TD115LEA (Đen/ Vàng bò) - 100% da thật",430000,430000,0,0
TIKI,tui-thoi-trang-nam,90519788,"Túi đeo chéo đeo ngực nam cao cấp phong cách châu âu",585000,650000,65000,10
TIKI,tui-thoi-trang-nam,9803160,"Túi đeo chéo TROY YM01",127000,150000,23000,15
TIKI,tui-thoi-trang-nam,74854470,"Túi xách nam da thật cao cấp phong cách mới",441000,490000,49000,10
TIKI,tui-thoi-trang-nam,59282088,"Túi đeo chéo đa năng LATA TN16",450000,450000,0,0
TIKI,tui-thoi-trang-nam,149765324,"Túi Xách, Cặp Da Thời Trang Công Sở Nam Cao Cấp Khóa Số CGL07",3200000,3200000,0,0
TIKI,voucher-dich-vu,53135985,"Khóa học ôn thi chứng chỉ IC3 GS4  Cam Kết Đầu Ra - TinhocPST",699000,699000,0,0
TIKI,voucher-dich-vu,122494188,"Toàn quốc - [E-Voucher] Khóa Nắm chắc 100% ngữ pháp Tiếng Anh cho người mất gốc",200000,200000,0,0
TIKI,voucher-dich-vu,54701588,"Khóa Học Bí Quyết Kiểm Soát Dòng Tiền Cho Các Doanh Nghiệp",295000,295000,0,0
TIKI,voucher-dich-vu,120452808,"[E-BOOK] i-Learn Smart World 9 Truyện đọc - May I Speak?",5000,5000,0,0
TIKI,voucher-dich-vu,57043525,"HERBAL SPA - LIỆU TRÌNH CHĂM SÓC DA MẶT CHUYÊN SÂU - MANG ĐẾN VẺ ĐẸP TỰ NHIÊN ",500000,500000,0,0
TIKI,voucher-dich-vu,119993359,"[E-BOOK] Tiếng Anh 2 Extra and Friends File nghe audio Bài tập",10000,10000,0,0
TIKI,voucher-dich-vu,176897636,"Phiếu Quà Tặng Spicy Box 400K",400000,400000,0,0
TIKI,voucher-dich-vu,73893756,"TMV Quốc Tế Dowha - 90 Phút Massage Trị Liệu Cổ Vai Gáy Bao Gồm Xông Hơi Không Giới Hạn",340000,340000,0,0
TIKI,voucher-dich-vu,55346899,"Yes IELTS - Khóa học IELTS Online tương tác với giáo viên IELTS 8.5",199000,199000,0,0
TIKI,voucher-dich-vu,104881301,"Sinh Trắc Vân Tay Gen Talents – Module Nghề Nghiệp Và Xu Thế Phát Triển Kỹ Năng",1320000,1320000,0,0
TIKI,voucher-dich-vu,4730923,"Việt Hàn Spa - Chăm Sóc Da Toàn Diện Trong 30 Ngày 07 Liệu Trình (Không Giới Hạn Số Lần Và Miễn Tip)",1950000,1950000,0,0
TIKI,voucher-dich-vu,172906044,"LIỆU TRÌNH CHĂM SÓC DA NÂNG CAO LOVE + ROSA/ 75 phút",800000,800000,0,0
TIKI,voucher-dich-vu,77662804,"Tài Liệu Marketing - Gói Standard - Bài Thi Vietnam Young Lions 2020 - Contestant Presentation Performance - Hạng Mục Marketers - Chuẩn quốc tế - Học mọi nơi - VYLCP15- Khóa học online [Độc Quyền AIM ACADEMY]",250000,250000,0,0
TIKI,voucher-dich-vu,21787099,"Tick Edu - Học Tiếng Nhật - Luyện Thi JLPT N5 Ngữ Pháp",599000,599000,0,0
TIKI,voucher-dich-vu,14928639,"Liệu Trình Tắm Trắng Vitamim Tại Hương Trà Smile",350000,350000,0,0
TIKI,voucher-dich-vu,56796320,"Combo Cần Thơ 3N2Đ: Mường Thanh Hotel 5*+ Xe Đưa Đón Sân Bay Cần Thơ - Tặng Tour Chợ Nổi",1250000,1250000,0,0
TIKI,voucher-dich-vu,21787107,"Tick Edu - Khoá Học Làm Video Hoạt Hình 2D Kiếm Tiền Youtube",699000,699000,0,0
TIKI,voucher-dich-vu,6296579,"Sim 4G Asia 8 nước nhận tại Việt Nam: Nhận tại Văn Phòng",280000,280000,0,0
TIKI,voucher-dich-vu,15052581,"Gói Khám Tầm Soát Ung Thư Cho Nữ Tại Phòng Khám Đa Khoa Quốc Tế Golden Healthcare",9500000,9500000,0,0
TIKI,voucher-dich-vu,15412112,"Gói khám tiêu chuẩn toàn diện cho nữ tại phòng khám đa khoa quốc tế Golden Healthcare",2520000,2520000,0,0
TIKI,voucher-dich-vu,147883226,"KHOÁ HỌC CHUYỂN ĐỔI SỐ",9900000,9900000,0,0
TIKI,voucher-dich-vu,56658696,"MANMO TUBE HOUSE",550000,550000,0,0
TIKI,voucher-dich-vu,56421552,"Evoucher TRẢI NGHIỆM SƠN GEL từ các nhãn hàng Nổi Tiếng và Uy Tín tại HONEYNAIL",99000,99000,0,0
TIKI,voucher-dich-vu,127757776,"KHÓA HỌC QUẢN TRỊ CUỘC ĐỜI TRỌN VẸN BẰNG CÁCH SỐNG THEO MỤC ĐÍCH ĐÚNG",599000,599000,0,0
TIKI,voucher-dich-vu,206123824,"Sách nói: Ma Trận Thần Thánh",99000,99000,0,0
TIKI,voucher-dich-vu,19246029,"Áp Dụng 1 Trong 3 Dịch Vụ Combo Chăm Sóc Da Điện Di Với Vitamin C / Collagen Kết Hợp Với Massage Body Đá Nóng / Thảo Dược tại Mẹ & Em Spa ",399000,399000,0,0
TIKI,voucher-dich-vu,162512680,"Phiếu Quà Tặng Ngân ĐÌnh Restaurant 300K",300000,300000,0,0
TIKI,voucher-dich-vu,26166682,"MintWIFI-Thuê Bộ Phát Wifi Du lịch Hàn Quốc",145000,145000,0,0
TIKI,voucher-dich-vu,14996483,"Gói Khám Tiền Mang Thai Cho Nữ Tại Phòng Khám Đa Khoa Quốc Tế Golden Healthcare",4100000,4100000,0,0
TIKI,voucher-dich-vu,15051465,"Gói Khám Tiền Hôn Nhân Cho Nữ Tại Phòng Khám Đa Khoa Quốc Tế Golden Healthcare",2500000,2500000,0,0
TIKI,voucher-dich-vu,21761424,"Tick Edu - Luyện phản xạ giao tiếp tiếng Anh chuyên sâu - Phần 1",799000,799000,0,0
TIKI,voucher-dich-vu,130470446,"[E-BOOK] Practice Tests 6-10 Key For Schools A2 Sách giáo viên điện tử",15000,15000,0,0
TIKI,voucher-dich-vu,204361113,"T6. TÀU 2 ĐẢO CÂU CÁ VÀ LẶNG NGẮM SAN HÔ - NAM ĐẢO PHÚ QUỐC",500000,500000,0,0
TIKI,voucher-dich-vu,188696676,"Paris Baguette - Bánh Kem Sữa Tươi Socola (19cm)",490000,490000,0,0
TIKI,voucher-dich-vu,194154955,"Liệu trình Massage Toàn Thân Thư Giãn Đá Nóng + Tinh Dầu Mỹ + Ngâm Chân Thảo Dược Đào Thải Độc Tố 75 Phút tại Happy Beauty & Spa",349000,349000,0,0
TIKI,voucher-dich-vu,198463989,"Tour Du lịch Hà Giang - Quản Bạ - Yên Minh - Đồng Văn - Sapa - Moana - Fansipan 4 Ngày 4 Đêm (XE CABIN VIP), Khởi hành Hằng ngày ",4939000,4939000,0,0
TIKI,voucher-dich-vu,58705032,"Gói 10 Lần Triệt Lông Chân Bảo Hành 03 Năm Tại L’amie Spa (Áp Dụng Cho 02 Chân)",3549000,3549000,0,0
TIKI,voucher-dich-vu,3665239,"Xoa Bóp Bấm Huyệt, Châm Cứu Trị Đau Lưng, Đau Dây Thần Kinh Tọa (Gói Nâng Cao) - 01 Buổi Tại Phòng Chẩn Y Học Cổ Truyền Tâm Minh Đường",207000,207000,0,0
TIKI,voucher-dich-vu,106987425,"E-VOUCHER COMBO KHÁM BỆNH ONLINE - BỆNH VIỆN ĐA KHOA TÂM TRÍ SÀI GÒN",300000,300000,0,0
TIKI,voucher-dich-vu,39710154,"Gói thi thử IELTS online 4 kỹ năng",569000,569000,0,0
TIKI,voucher-dich-vu,179722135,"Sách nói: Lẽ Phải Của Phi Lý Trí",99000,99000,0,0
TIKI,voucher-dich-vu,183551899,"Sách nói: Con người 80/20",99000,99000,0,0
TIKI,voucher-dich-vu,184506999,"Sách nói: Hoàng Tự",99000,99000,0,0
TIKI,voucher-dich-vu,183348319,"Sách nói: 5 Phương Thức Ghi Nhận Sự Nỗ Lực Của Nhân Viên",99000,99000,0,0
TIKI,voucher-dich-vu,176710382,"Sách nói: Thực Hành Theo Luận Đại Thừa Khởi Tín",99000,99000,0,0
TIKI,voucher-dich-vu,188900407,"Sách nói: Dám Thất Bại",99000,99000,0,0
TIKI,voucher-dich-vu,152682352,"Sách nói: Sài Gòn Ngoảnh Lại Trăm Năm",99000,99000,0,0
TIKI,voucher-dich-vu,272857394,"Khóa Học Video Online Piano Đệm Hát Cơ Bản Cho Người Lớn - Trung Tâm Chăm Sóc Sức Khỏe VMC",400000,400000,0,0
TIKI,voucher-dich-vu,272942094,"Khóa Học Video Online Nhảy Breaking Trong Hiphop Cho Người Mới Học - Trung Tâm Chăm Sóc Sức Khỏe VMC",400000,400000,0,0
TIKI,voucher-dich-vu,176716873,"Sách nói: Cái Thật Và Thực Tại",99000,99000,0,0
TIKI,voucher-dich-vu,195655922,"Khóa Học Video Online Piano Phát Triển Khả Năng Sáng Tạo Và Tập Trung Cho Trẻ - Trung Tâm Chăm Sóc Sức Khỏe VMC",400000,400000,0,0
TIKI,voucher-dich-vu,272909763,"Khóa Học Video Online Diễn Tấu Đàn Tranh Qua Các Ca Khúc Nhạc Xuân - Trung Tâm Chăm Sóc Sức Khỏe VMC",400000,400000,0,0
TIKI,voucher-dich-vu,32917217,"Tour Sapa 2N1Đ: Hà Nội - Sapa - Cát Cát (Hoặc KDL Hàm Rồng) - Fansipan - Hà Nội, Khởi Hành Hàng Ngày",2199000,2199000,0,0
TIKI,voucher-dich-vu,274069559,"TOUR HÀN QUỐC 5N5D 2024 ( LỄ 30/4 - Bay Vietjet ) ",16990000,16990000,0,0
TIKI,voucher-dich-vu,273078487,"Khóa Học Video Online 15 Ngày Làm Quen Với Hiphop Dance Cho Người Mới Bắt Đầu - Trung Tâm Chăm Sóc Sức Khỏe VMC",400000,400000,0,0
TIKI,voucher-dich-vu,210967787,"Phiếu Quà Tặng Sushi Tei 1000K",1000000,1000000,0,0
TIKI,voucher-dich-vu,253412038,"[EVoucher Vietravel] Đông Bắc: Hà Nội - Hà Giang - Lũng Cú - Đồng Văn - Mã Pí Lèng - Mèo Vạc - Cao Bằng - Thác Bản Giốc - Hồ Ba Bể 7 Ngày 6 Đêm",9990000,9990000,0,0
TIKI,voucher-dich-vu,189204242,"Sách nói: Trí Tuệ Cộng Tác",99000,99000,0,0
TIKI,voucher-dich-vu,274440507,"[Giftpop] Phiếu Quà Tặng Baoz Group 1000K",1000000,1000000,0,0
TIKI,voucher-dich-vu,189191505,"Sách nói: Quy Tắc Làm Việc Của Google",99000,99000,0,0
TIKI,voucher-dich-vu,272913852,"Khóa Học Video Online Các Thế Vật Tự Vệ Vovinam Cơ Bản - Trung Tâm Chăm Sóc Sức Khỏe VMC",400000,400000,0,0
TIKI,voucher-dich-vu,191696052,"Sách nói: Sống Như Một Chú Mèo",99000,99000,0,0
TIKI,voucher-dich-vu,72203009,"KHÓA HỌC MONGODB",6000000,6000000,0,0
TIKI,voucher-dich-vu,191695671,"Sách nói: Màn Trình Diễn Trí Tuệ Của Warren Buffett - Những Câu Chuyện Tại Hội Nghị Thường Niên Berkshire Hathaway",99000,99000,0,0
TIKI,voucher-dich-vu,34476193,"Khóa học Kungfu bán hàng triệu đô",400000,400000,0,0
TIKI,voucher-dich-vu,274068894,"SINGAPORE - MALAYSIA 5N4D - 2024",10990000,10990000,0,0
TIKI,voucher-dich-vu,34496096,"Khóa học Bí quyết quản trị nhân sự",400000,400000,0,0
TIKI,voucher-dich-vu,72210126,"KHÓA HỌC JAVACRIPT-ANGULAR JS",6000000,6000000,0,0
TIKI,voucher-dich-vu,200931151,"Sách nói Côn Trùng Ký - Tập 1",99000,99000,0,0
TIKI,voucher-dich-vu,34496296,"Phân Tích Nghiệp Vụ Phần Mềm Nâng Cao 3.0",8300000,8300000,0,0
TIKI,voucher-dich-vu,205725740,"Art Project: Vẽ minh họa sách thiếu nhi (storybook)",5600000,5600000,0,0
TIKI,voucher-dich-vu,119992473,"[E-BOOK] Tiếng Anh 2 Extra and Friends Sách giáo viên điện tử",15000,15000,0,0
TIKI,voucher-dich-vu,273538721,"Bảo hiểm TNDS xe ô tô kèm BH tự nguyện cho người ngồi trên xe - Bảo hiểm Quân đội MIC",680700,680700,0,0
TIKI,voucher-dich-vu,72210737,"KHÓA HỌC HCM  - LUYỆN THI CHỨNG CHỈ PHÂN TÍCH AGILE",5999000,5999000,0,0
TIKI,voucher-dich-vu,169923402,"Dây Cáp JTAG FC Nhiều Loại Chân",8820,8820,0,0
TIKI,voucher-dich-vu,249030995,"Sách-Tiếng trung giao tiếp trong Kinh doanh Đặt hàng buôn bán + DVD tài liệu",135000,270000,135000,50
TIKI,voucher-dich-vu,274412082,"TOUR THAI LAN - BANGKOK - PATTAYA 5N4D - THANG 3 - VJ",6780000,6780000,0,0
TIKI,voucher-dich-vu,273329841,"Sách nói Fonos: Chân Dung Những Người Thay Đổi Thế Giới: Thành Cát Tư Hãn Là Ai? [e-voucher]",99000,99000,0,0
TIKI,voucher-dich-vu,51950968,"Voucher Bộ File Thuyết trình 1500+ Powerpoint Template, 800+ Infographic, 3000+ Icon - Tải Trực tuyến, truy cập TRỌN ĐỜI - Từ A đến Z, sử dụng đơn giản",349000,349000,0,0
TIKI,voucher-dich-vu,72216042,"KHÓA HỌC HCM - HUẤN LUYỆN ĐỂ LÀM VIỆC TRONG MÔI TRƯỜNG NGHỀ LUẬT",8900000,8900000,0,0
TIKI,tui-vi-nu,182756912,"Túi Tomtoc LADY FASHION ACCESSORIES - Hàng chính hãng",1049000,1049000,0,0
TIKI,tui-vi-nu,172369648,"Ví da nữ cầm tay nhỏ gọn YUUMY Seasand YV58",75000,150000,75000,50
TIKI,tui-vi-nu,67936753,"KHĂN LỤA BUỘC TÚI- KHĂN QUẤN TÚI NHIỀU HỌA TIẾT",16000,16000,0,0
TIKI,tui-vi-nu,117294127,"Túi xách nữ đeo chéo đan sợi tổng hợp khóa ngọc bản to cực sang 2 màu có sẵn",159000,159000,0,0
TIKI,tui-vi-nu,183343138,"Túi đeo chéo unisex Street Crossbag chính hãng NATOLI chất vải canvas đi học đi chơi nhiều ngăn cá tính đơn giản nhỏ gọn",249000,357000,108000,30
TIKI,tui-vi-nu,15592049,"Túi đeo chéo nữ- túi xách đeo chéo nữ cá tính",55000,55000,0,0
TIKI,tui-vi-nu,182720797,"Cluth nữ Monogram Canvas ELLY – ECH64",779400,1299000,519600,40
TIKI,tui-vi-nu,127635141,"Vỏ Bọc Thẻ Trong Suốt, Túi Đựng Thẻ Căn Cước Công Dân, Thẻ ATM, Thẻ Ngân Hàng, Bằng Lái Xe( set 10c)",14999,14999,0,0
TIKI,tui-vi-nu,154858344,"Túi cói đi biển hình cây vintage - Túi đi dạo phố",195000,195000,0,0
TIKI,tui-vi-nu,92083889,"Bộ 20 Nút Hít Túi Xách Loại 14x3mm Màu Bạc Lực Hít Mạnh",99000,99000,0,0
TIKI,tui-vi-nu,147202890,"Túi Hậu Môn Nhân Tạo 2 Mảnh- Hollister (Trong, Lọc Khí, Khóa Cuốn), 18192 / 18193 / 18194 -VT0738",567000,567000,0,0
TIKI,tui-vi-nu,11468597,"Ví / bóp nữ mini cao cấp (ví gập)",139000,139000,0,0
TIKI,tui-vi-nu,69470436,"Túi Đeo Chéo Nữ Đi Học, Đi Chơi, Túi Vải Canvas Cho Học Sinh, Sinh Viên, Túi Vải Đeo Chéo Thời Trang Hàn Quốc - OTV035 - Ope Store",160000,160000,0,0
TIKI,tui-vi-nu,174626748,"Túi đeo chéo nữ nhỏ gọn BHM7674 Da bò dập nổi họa tiết nhiều màu",550000,550000,0,0
TIKI,tui-vi-nu,147942793,"Ví Nữ Dài Cầm Tay FOREVER YOUNG Da Mềm Khóa Đồng Xu Độc Đáo Nhiều Ngăn Tiện Dụng Chất Cực Đẹp FY01 - Tukado",119000,119000,0,0
TIKI,tui-vi-nu,86561407,"Túi Xách Nữ -  50K - TÚI ĐEO CHÉO DÂY PHA XÍCH ULZZANG CÁ TÍNH KT 18cm TD03",75000,75000,0,0
TIKI,tui-vi-nu,74637171,"Túi đựng điện thoại di động Chụp ảnh in hình Kỳ diệu DF556 Tặng móc khóa cá heo",73260,100122,26862,27
TIKI,tui-vi-nu,176165140,"Túi Đeo Chéo Nữ Tote Công Sở Đi Chơi Đi Làm Hàng Hiệu Cao Cấp - TDC204",97995,97995,0,0
TIKI,tui-vi-nu,69470437,"Túi Xách Nữ Đeo Chéo Hình Snoopy, Túi Đeo Chéo Nữ Đi Học, Đi Chơi, Túi Xách Đeo Chéo Nữ Dễ Thương - OTV006 - Ope Store",275000,275000,0,0
TIKI,tui-vi-nu,81499508,"Ví cầm tay nữ thời trang LATA VN52",269000,350000,81000,23
TIKI,tui-vi-nu,154698727,"Bóp ví nữ cầm tay mini V0525 C0RGI nhiều ngăn nhỏ gọn phong cách đơn giản, thời trang, dễ thương",25000,50000,25000,50
TIKI,tui-vi-nu,146513491,"Túi đeo chéo ba ngăn khóa tiện lợi_Túi thời trang Hàn Quốc",55000,55000,0,0
TIKI,tui-vi-nu,24794459,"Ví , bóp nữ cao cấp có hộp và túi đựng Loai 1",129000,129000,0,0
TIKI,tui-vi-nu,67937211,"Dây lụa buộc túi - dây quấn quai túi họa tiết nhiều mẫu (p2)",16000,16000,0,0
TIKI,tui-vi-nu,131337899,"Túi vải bố, Túi vải Canvas trơn Màu Trắng - Màu Đen Màu Be Size 36cm x 31cm",27000,27000,0,0
TIKI,tui-vi-nu,140879599,"Túi cói dây rút hoa cúc quá trời cưng luôn",135000,135000,0,0
TIKI,tui-vi-nu,209414146,"Túi cói đựng đồ phong cách thời trang Merci",55000,55000,0,0
TIKI,tui-vi-nu,204615439,"Túi xách nữ đeo chéo cầm tay nữ sang chảnh da bò cao cấp hàng hiệu MX",1200000,1200000,0,0
TIKI,tui-vi-nu,77446264," Ví Nữ Nam Unisex Bóp Nữ Nam Unisex Cao Cấp LONG SECTION (VI-NU-017) - Bóp Cầm Tay - Ví Cầm Tay",99000,99000,0,0
TIKI,tui-vi-nu,192693260,"VÍ THẺ CẦM TAY 12 NGĂN HÌNH DOREMON SIÊU YÊU",39000,39000,0,0
TIKI,tui-vi-nu,271534760,"Túi cói PRADAAA đang cực kỳ HOT",255000,255000,0,0
TIKI,tui-vi-nu,203994554,"Túi Xách Nữ Hàng Hiệu Hàn Quốc ZL109 Đẳng Cấp Da Thật Cao Cấp FullBox Size 28cm Làm Quà Tặng, Sinh Nhật",2800000,2800000,0,0
TIKI,tui-vi-nu,71637263,"Ví nữ cầm tay dự tiệc/Clutch nữ cao cấp thiết kế hiện đại, sang trọng, thời thượng",470000,470000,0,0
TIKI,tui-vi-nu,129246978,"túi thời trang nữ, túi đeo vai, túi đeo chéo kèm miếng dán sticker ngộ nghĩnh",83254,118935,35681,30
TIKI,tui-vi-nu,263046025,"Túi Xách Tay Hình Gấu Bông Pompompurin Vàng, Túi Gấu Bông Gòn Dễ Thương",75000,75000,0,0
TIKI,tui-vi-nu,99248043,"Túi đeo chéo nữ kèm phụ kiện gấu bông",99000,99000,0,0
TIKI,tui-vi-nu,44573057,"Túi đeo da đà điểu Huy Hoàng da bụng màu nâu đất HT6424",2499000,2499000,0,0
TIKI,tui-vi-nu,43694334,"Túi đeo chéo da thật cao cấp Đồ Da Thành Long TLG 208241",188900,347000,158100,46
TIKI,tui-vi-nu,117294323,"Túi cói đi chơi đi biển hình hoa hướng dương dáng ly dài nhiều màu cực xinh",135000,135000,0,0
TIKI,tui-vi-nu,263795862,"[Da thật] Túi golf khóa số cầm tay kết hợp đeo chéo da bò thật CL153 (Đen) - 100% da thật",879000,879000,0,0
TIKI,tui-vi-nu,172191774,"Túi đeo chéo trước ngực phong cách vải bố 208031",34300,62000,27700,45
TIKI,tui-vi-nu,45468600,"Túi Xách Nữ - Thời Trang Công Sở",305000,305000,0,0
TIKI,tui-vi-nu,172191324,"Túi đeo chéo phong cách Hàn Quốc Đồ Da Thành Long TLG 208097 1(đen)",30000,30000,0,0
TIKI,tui-vi-nu,131337323,"Có Khóa Kéo Túi vải bố, Túi vải Canvas trơn Màu Trắng - Màu Be",39000,39000,0,0
TIKI,tui-vi-nu,36266064,"Túi đeo chéo vải canvas, túi vải nữ TV08, phong cách Hàn Quốc, thời trang trẻ",50000,50000,0,0
TIKI,tui-vi-nu,11212216,"Túi Tròn Thổ Cẩm Tua Rua NEVENKA N9106",148000,148000,0,0
TIKI,tui-vi-nu,177477874,"MLB - Túi đeo vai chữ nhật Monogram Jacquard Hobo 3ABQS012N",2590000,2590000,0,0
TIKI,tui-vi-nu,167607312,"Bóp ví nữ dài cầm tay V0124 Kẻ vân chỉ nhiều ngăn tiện lợi, phong cách thời trang, cá tính",70000,140000,70000,50
TIKI,tui-vi-nu,115495737,"Túi Xách nữ  Túi Cói Merci Đi Biển, Đi Du lịch, Đi chơi Siêu HOT HIT",77000,77000,0,0
TIKI,tui-vi-nu,56735214,"Ví nữ da bò Marrant BHM4202 Ví gập ba, dập nổi họa tiết 3D, ví đựng thẻ card. Hàng chính hãng",398520,398520,0,0
TIKI,tui-vi-nu,174469112,"Túi Xách Đeo Chéo Nữ Đeo Vai Kẹp Nách MICOCAH Kiểu Dáng Công Sở Thời Trang Da Cao Cấp Cực Đẹp MC46",389000,389000,0,0
TIKI,tui-vi-nu,265177848,"Túi xách nữ đeo chéo xách tay kẹp nách túi chơi đi làm bag đi tiệc Full Hộp DEVIN",300000,300000,0,0
TIKI,tui-vi-nu,106588168,"Bóp Dài Cầm Tay DEVON Da Thật Saffiano Khóa Kéo Sang Trọng Unisex Dành Cho Nam Nữ DOLANTO",350000,350000,0,0
TIKI,tui-vi-nu,151757252,"Túi đeo chéo nữ thời trang cao cấp phong cách Hàn Quốc",99000,99000,0,0
TIKI,tui-vi-nu,45350251,"Túi xách nữ thời trang công sở siêu xinh TSC258",55000,55000,0,0
TIKI,tui-vi-nu,128857481,"TÚI XÁCH NỮ CAO CẤP DA THẬT ELLY – ET118",1379400,2299000,919600,40
TIKI,tui-vi-nu,190589365,"Ví Da Mini Cầm Tay 10 Ngăn Họa Tiết thỏ cà rốt Ngộ Nghĩnh Bóp Nữ Da PU Cute Hot Trend( giao ngẫu nhiên)",50000,50000,0,0
TIKI,tui-vi-nu,53537582,"Túi xách nữ khóa chữ nhật dây đeo chéo (đeo vai)",69000,69000,0,0
TIKI,tui-vi-nu,42129001,"TÚI ĐEO VAI NỮ DỄ THƯƠNG - H0028",45000,75000,30000,40
TIKI,tui-vi-nu,116594673,"Túi xách nữ - Túi dây pha xích phong cách Hàn Quốc cá tính TD12 - Mincloset",83000,83000,0,0
TIKI,tui-vi-nu,170771059,"Túi xách nữ vải dù Oxford thời trang cao cấp đeo chéo đa năng nhiều ngăn chứa đồ chống thấm nước size 29cm",215000,215000,0,0
TIKI,tui-vi-nu,247809152,"Túi tote có khóa, đựng được giấy A4, dành cho laptop, macbook 13 inch, 15 inch",245000,400000,155000,39
TIKI,tui-vi-nu,13670372,"Túi vải bố trơn | túi tote trơn | túi canvas trơn",24900,24900,0,0
TIKI,tui-vi-nu,89217785,"Túi Xách Nữ    Túi Đeo Chéo Khóa Trái Tim Siêu Đẹp Phong Cách Trẻ Trung",65000,65000,0,0
TIKI,tui-vi-nu,149449620,"CEEKAY- Túi đeo chéo cao cấp Fullbox",450000,450000,0,0
TIKI,tui-vi-nu,147941971,"Túi Xách Nữ Kẹp Nách Đeo Chéo Chính Hãng MICOCAH Dáng Công Sở Thời Trang Da Cao Cấp Cực Đẹp Giá Rẻ MC63 - TUKADO",389000,389000,0,0
TIKI,tui-vi-nu,192579893,"Túi xách nữ thời trang công sở cao cấp phong cách mới",387000,430000,43000,10
TIKI,tui-vi-nu,170916262,"Túi Vỏ Bao Đựng Bọc Thẻ Căn Cước Công Dân, Bằng Lái Xe, Thẻ Ngân Hàng, Thẻ Sinh Viên, Thẻ Nhân Viên",1499,1499,0,0
TIKI,tui-vi-nu,209414066,"Túi kiêm ví đeo chéo đựng điện thoại dáng dọc trần trám siêu chất Cobala1688",142000,142000,0,0
TIKI,tui-vi-nu,136940063,"Túi/ ví thổ cẩm combo 3 món",40000,40000,0,0
TIKI,tui-vi-nu,74026612,"Túi Đeo Chéo Nữ Cao Cấp - SADDLE BAG - HGcork Corkor CK246 - Vật liệu da cork thực vật thuần chay - Sản phẩm Handmade, Sản xuất tại Bồ Đào Nha",2659050,2799000,139950,5
TIKI,tui-vi-nu,45066961,"túi xách nữ da cá sấu",2000000,2000000,0,0
TIKI,tui-vi-nu,174445639,"Ví Nữ Ngắn Mini Cầm Tay Chính Hãng TAILIAN Thời Trang Nhiều Ngăn Đựng Tiền Vân Da Rắn Cao Cấp  TL34",119000,119000,0,0
TIKI,tui-vi-nu,104304339,"Túi tote vải đeo chéo, túi canvas bag đi học 2021",112000,112000,0,0
TIKI,tui-vi-nu,197822738,"Túi Tote thời trang Big size phối dây trắng Hibi Sports A012, chất liệu Canvas cao cấp phù hợp đi chơi, đi tập",299000,420000,121000,29
TIKI,tui-vi-nu,87100226,"Balo thời trang, balo đi học, đựng laptop Túi Tote Mèo Cony balo nữ vải",69900,69900,0,0
TIKI,tui-thoi-trang-nam,186243889,"Túi đeo chéo nam vải canvas cao cấp phong cách mới",333000,370000,37000,10
TIKI,tui-thoi-trang-nam,96243197,"Túi xách cặp da công sở vân cá sấu đựng laptop 14inch T80 35x29x6cm(Nâu-Đen)",329000,329000,0,0
TIKI,tui-thoi-trang-nam,93843376,"Túi đeo chéo đeo ngực nam cao cấp phong cách châu âu",783000,870000,87000,10
TIKI,tui-thoi-trang-nam,106053325,"Bóp da nam, ví nam, ví da bò thật 100%, chuẩn đẹp xịn xò A142V",125000,125000,0,0
TIKI,tui-thoi-trang-nam,145978003,"Túi đeo chéo nam, túi xách tay da bò thật Bụi Leather DC104 - Da bò Mill cao cấp, Unisex - Bảo Hành 12 tháng",525000,850000,325000,38
TIKI,tui-vi-nu,136939957,"Túi thổ cẩm đeo vuông",42000,42000,0,0
TIKI,tui-thoi-trang-nam,193004750,"Túi đeo chéo nam, túi bao tử nam Mars Bụi Leather DC109 - Da bò thật cao cấp - Bảo hành 12 tháng",429000,605000,176000,29
TIKI,tui-thoi-trang-nam,11586535,"Túi Đeo Chéo, Túi Đeo Chéo Nam Da Bò Jeep (26 x  23 cm)",152000,152000,0,0
TIKI,tui-thoi-trang-nam,205232933,"Bao da dành cho bọc ốp chìa khoá xe ô tô Toyota Camry 2019 2022 da bò nhiều màu khâu thủ công To28CR",170000,170000,0,0
TIKI,tui-thoi-trang-nam,179207900,"Túi Đeo Chéo Nam TK07 - Túi Đeo Chéo Hàn Quốc - Túi Đeo Trước Ngực - Túi Bao Tử",99000,99000,0,0
TIKI,tui-thoi-trang-nam,73361438,"VÍ NGẮN GẬP DA Bóp COSMOS Da Saffiano Nhập Khẩu Cao Cấp Chống Thấm Nước Unisex Nam Nữ Chuẩn Leonardo DOLANTO",220000,220000,0,0
TIKI,tui-thoi-trang-nam,103534782,"Ví móc khóa cầm tay đa năng 4U nhiều màu FMK06",25000,50000,25000,50
TIKI,tui-thoi-trang-nam,150545045,"Cặp Da Nam , Túi Xách Nam Công Sở Cao Cấp 8012-3, Thiết kế Sang Trọng, Lịch Lãm",695000,695000,0,0
TIKI,tui-thoi-trang-nam,159631049,"Túi đeo chéo DIVOOM Pixoo Slingbag-V hiển thị màn hình LED, có thể đựng Laptop/iPad 11 inch - Hàng chính hãng",2300000,2300000,0,0
TIKI,tui-thoi-trang-nam,185946011,"Túi đeo chéo nam đa chức năng cao cấp phong cách cá tính mới",621000,690000,69000,10
TIKI,tui-vi-nu,58325944,"Túi đeo chéo, túi xách trong suốt",57420,82940,25520,31
TIKI,tui-thoi-trang-nam,47477869,"Túi xách đeo chéo nam nữ phản quang phong cách Hàn Quốc Mituza TX36",32670,44649,11979,27
TIKI,tui-thoi-trang-nam,197879894,"Bóp Đứng Nam Nhỏ Gọn, Chất Liệu Da Bò PULL-UP Mềm Mại, Mỏng Nhẹ, Phong Cách Hiện Đại - Cá Tính, Size Trung, Dáng Đứng - Gập 2, Nhiều Ngăn Để Tiền Và Giấy Tờ Tiện Dụng",982000,999000,17000,2
TIKI,tui-thoi-trang-nam,188997107,"Bao da dành cho chìa khoá toyota Camry, Fortuner, Land Cruiser, Hilux handmade da thật 009",200000,200000,0,0
TIKI,tui-thoi-trang-nam,155776132,"Túi đeo chéo nam nữ unisex phong cách ulzzang sợi polyesster cao cấp chống thấm nước Haoshuai S2",145000,145000,0,0
TIKI,tui-thoi-trang-nam,271887160,"Clutch da bò cao cấp MARRANT - BHM8986 Ví da cầm tay cao cấp. Hàng chính hãng",899000,899000,0,0
TIKI,tui-thoi-trang-nam,41664315,"Cặp công sở thời trang YUUMY CAYUUMY 11",255000,490000,235000,48
TIKI,tui-thoi-trang-nam,711402,"Túi Đeo Chéo Nam HARAS HRTK127 (32 x 18 cm) - Đen",150000,150000,0,0
TIKI,tui-thoi-trang-nam,145413858,"Túi đeo chéo da nam đa năng LATA TN21",369000,390000,21000,5
TIKI,tui-thoi-trang-nam,183046677,"Ví nam 100% da bò thật  cao cấp phong cách mới",171000,190000,19000,10
TIKI,tui-thoi-trang-nam,191044555,"ví nam ví nam clutch cầm tay cao cấp",288000,320000,32000,10
TIKI,tui-thoi-trang-nam,143384978,"Ví Nam Cao Cấp, Da Bò PEBBLE Mềm Mại - Bền Bỉ, Size Lớn, Chống Xước - Chống Nhăn Tốt,  Thiết Kế Cổ Điển, Dáng Ngang - Gập 2, Ngăn Đựng Tiền Có Khóa Kéo, Nhiều Ngăn Để Giấy Tờ Tiện Dụng - Hàng Chính Hãng SAIGIO",1132000,1149000,17000,1
TIKI,tui-thoi-trang-nam,78946196,"Ví nam cầm tay 100% da bò thật cao cấp phong cách mới",513000,570000,57000,10
TIKI,tui-thoi-trang-nam,155340658,"Ví mini nam da bò sáp ngựa điện Crazyhorse V125 cao cấp, bóp đựng thẻ da thật, đường chỉ tinh tế, ví nam nhỏ gọn dáng đứng, fullbox, thương hiệu Bụi leather chuyên đồ da thật",180000,200000,20000,10
TIKI,tui-vi-nu,73486209,"Túi xách túi đeo vai nữ mini quoai ngọc da bóng cực xinh cho mẹ và bé",38000,38000,0,0
TIKI,tui-vi-nu,70937670,"Túi cói thắt nơ",99000,99000,0,0
TIKI,tui-thoi-trang-nam,119132514,"Ví đựng namecard Trita Liberal RVN11",59000,150000,91000,61
TIKI,tui-thoi-trang-nam,183330035,"Túi đeo chéo đeo vai nam 100% da bò  thật cao cấp phong cách châu âu",675000,750000,75000,10
TIKI,tui-thoi-trang-nam,121173964,"Bóp Nam Da Bò VINTAGE Hoài Cổ, Chất Da Mềm Mại - Vân Tự Nhiên, Size Lớn, Thiết Kế Cổ Điển, Đơn Giản - Mỏng Nhẹ, Dáng Ngang - Gập 2, Ngăn Đựng Tiền Có Khóa Kéo, Nhiều Ngăn Để Giấy Tờ Tiện Dụng - Hàng Chính Hãng SAIGIO",879000,899000,20000,2
TIKI,tui-thoi-trang-nam,75727517,"Túi đeo chéo nam tích hợp khóa chống trộm chống nước cao cấp phong cách mới",297000,330000,33000,10
TIKI,tui-thoi-trang-nam,58227879,"Ví nam da thật TRITA RVN002",199000,380000,181000,48
TIKI,tui-thoi-trang-nam,113760273,"Ví nam da bò cao cấp phong cách mới",387000,430000,43000,10
TIKI,tui-thoi-trang-nam,161954755,"Túi Xách Nam Công Sở Gence Da Bò Cao Cấp CTS12 Khóa Số",3200000,3200000,0,0
TIKI,tui-thoi-trang-nam,54420877,"Túi đeo chéo,đeo ngực nam đã tích hợp công nghệ 4.0",621000,690000,69000,10
TIKI,tui-vi-nu,141935291,"Túi xách nữ - túi quảng châu hai quai đeo dùng làm túi kẹp nách bản da rắn nhiều màu",249000,249000,0,0
TIKI,tui-thoi-trang-nam,187621731,"Ví Passport Da Bò PEBBLE Mềm Mại - Bền Bỉ, Chống Xước - Chống Nhăn Tốt, Thiết Kế Hiện Đại - Đa Năng, Đựng Được Nhiều Loại Hộ Chiếu, Nhiều Ngăn Thẻ ATM, Đựng Tiền, Vé Máy Bay, Tiện Dụng Khi Đi Du Lịch, Công Tác - Hàng Chính Hãng SAIGIO",1229000,1249000,20000,2
TIKI,tui-thoi-trang-nam,100320879,"Ví Handmade Nam KEIO NIPPON Da Bò Epsom Cao Cấp / Bóp Nam Da Bò May Thủ Công",249000,249000,0,0
TIKI,tui-vi-nu,107962706,"Ví da mini nữ handmade sành điệu cá tính dành cho cô nàng sang chảnh",199000,199000,0,0
TIKI,tui-vi-nu,108254100,"Túi Đeo Chéo Nữ Dáng Cốp Mini Siêu Cá Tính Mẫu Mới Nhất",89000,89000,0,0
TIKI,tui-vi-nu,72938961,"Ví cầm tay unisex da bò nhập khẩu R01",340000,620000,280000,45
TIKI,tui-vi-nu,106654834,"Ví nữ dài cầm tay, ví nữ đẹp, ví nữ thời trang, ví nữ đựng điện thoại, ví nữ cầm tay thời trang, ví nữ đựng tiền, bóp nữ",89000,89000,0,0
TIKI,tui-vi-nu,109449937,"Ví Nữ Mini Ngắn Cầm Tay Dễ Thương Nữ Tính Phong Cách Hàn Quốc CTVI107",31000,31000,0,0
TIKI,tui-vi-nu,72640552,"Túi cói đi biển túi tote phong các Vintage boho, có tua rua đen",240000,240000,0,0
TIKI,tui-vi-nu,6639487,"Túi Mây Tre Tròn Màu Nâu",230000,230000,0,0
TIKI,tui-vi-nu,153415889,"[GDSG60] Túi tote Vải canvas mềm Đẹp Cực Hot đựng vừa [SIÊU SALE][SIÊU XINH] Túi vải xinh nhiều",75000,75000,0,0
TIKI,tui-vi-nu,76541991,"Túi Vải, Túi Tote Vải Canvas Bag Siêu Xinh",109000,109000,0,0
TIKI,tui-vi-nu,187061154,"HỘP GIẢ GỖ LÓT VẢI VÀNG ĐỰNG VÒNG TAY , CHUỖI PHONG THỦY",45000,45000,0,0
TIKI,tui-vi-nu,6201827,"Ví cầm tay clucth nữ CN026",390000,390000,0,0
TIKI,tui-vi-nu,116862979,"Túi đeo chéo da thật cao cấp 208235",206200,225000,18800,8
TIKI,tui-vi-nu,107962377,"Ví da nữ mini thời trang đựng thẻ, tiền gấp đôi sang chảnh",99000,99000,0,0
TIKI,tui-thoi-trang-nam,193308675,"Túi Đeo Chéo Vải Nylon Nhiều Ngăn Chứa Cho Nam Nữ Cao Cấp Đi Chơi Chống Nước, Túi Đựng Điện Thoại, Túi Đeo Vai Thời Trang Sang Trọng Thời Thượng",125000,125000,0,0
TIKI,tui-thoi-trang-nam,146223397,"Túi đeo chéo nam Da bò thật Bụi Leather DC106 - Nhiều ngăn tiện dụng, Unisex - Bảo hành 12 tháng",469000,530000,61000,12
TIKI,tui-vi-nu,78512627,"Đeo chéo đeo đeo vai cho bé và người lớn Hình Nơ hello ngây ngô đa sắc Dt54 Tặng móc khóa độc quyền",44352,60614,16262,27
TIKI,tui-vi-nu,113256150,"TÚI VẢI MINI PHONG CÁCH HÀN XẺNG",65000,65000,0,0
TIKI,tui-vi-nu,252091008,"Túi Đeo Vai Nữ Dây Xích, Túi Xách Nữ Kẹp Nách Phong Cách Cá Tính, Túi Kẹp Nách Nữ Sang Chảnh Đi Chơi, Đi Tiệc - OTV239 - Ope Store",280000,280000,0,0
TIKI,tui-vi-nu,186749652,"Túi xách nữ dễ thương NASI T1027 túi cói gắn gấu bông cầm tay đẹp có dây kéo thời trang cho nữ công sở, học sinh",39000,39000,0,0
TIKI,tui-vi-nu,58742659,"Túi Đeo Chéo Nữ Cao Cấp Crossbody - HGcork Corkor CK249 – Xách tay, Đeo vai tiện dụng - Hàng Chính Hãng, Sản Xuất Tại Bồ Đào Nha",2849050,2999000,149950,5
TIKI,tui-vi-nu,68154602,"Túi xách nữ thời trang cao cấp ELLY- EL133",1199000,1199000,0,0
TIKI,voucher-dich-vu,274148480,"Hàn Quốc [Evoucher] Thẻ Nexon 넥슨카드 10,000 W.ON",194250,194250,0,0
TIKI,tui-thoi-trang-nam,59086244,"Túi xách cặp da đựng laptop da bò công sở T03 38x28x6cm",329000,329000,0,0
TIKI,tui-vi-nu,4108275,"Túi Đeo Chéo Ulzzang Trong Suốt Kèm Ví Nhỏ Parisa",57420,82940,25520,31
TIKI,voucher-dich-vu,272320914,"Gói PREMIUM 12 Tháng SCTV Online",1188000,1188000,0,0
TIKI,voucher-dich-vu,243035180,"Voucher Dặm Mi - Chang Nails",73000,120000,47000,39
TIKI,tui-vi-nu,39363937,"Túi đeo chéo mini Chaomfirfn phong cách Hàn Quốc",107000,107000,0,0
TIKI,tui-vi-nu,187642886,"Túi Cói Merci - 4 mẫu siêu hot",48000,54900,6900,13
TIKI,tui-vi-nu,194025657,"Túi đeo nữ da cá sấu ",2300000,3500000,1200000,34
TIKI,voucher-dich-vu,273445286,"HOCMAI Combo Khám phá tri thức 2: Khóa học Thuyết trình Tiếng Anh + Phòng luyện TOPCLASS - Toàn quốc [E-Voucher]",433000,910000,477000,52
TIKI,tui-vi-nu,96446040,"Túi xách nữ túi đeo chéo ô trám nắp xoay da PU cao cấp thời trang Hàn Quốc TX21",216000,216000,0,0
TIKI,voucher-dich-vu,273818595,"Bảo hiểm du lịch toàn cầu MIC, chuyến đi từ 23 - 27 ngày, gói Thượng hạng",396200,566000,169800,30
TIKI,tui-vi-nu,188902688,"Túi vải Buzzi tote - May’s Tote Bag",240000,240000,0,0
TIKI,tui-vi-nu,262078803,"Túi xách nữ công sở màu đỏ và đen",220000,220000,0,0
TIKI,tui-vi-nu,75801866,"Túi xách, túi đeo vai nữ cổ điển TĐ44 thời trang cao cấp tặng móc khóa cá heo",134640,194480,59840,31
TIKI,tui-vi-nu,92155250,"Túi Xách Nữ Kẹp Nách Form Lớn Vải Lông Phong Cách Hàn Quốc - Mã TUI10",215000,215000,0,0
TIKI,tui-vi-nu,36524890,"Ví đựng passport cao cấp",50000,50000,0,0
TIKI,voucher-dich-vu,274147667,"Hàn Quốc [Evoucher] Google Play Gift Card (Korea) 구글기프트카드 30,000 W.ON",588300,588300,0,0
TIKI,voucher-dich-vu,242219414,"[FLOWER 1969’s] WORKSHOP SOLID PERFUME - NƯỚC HOA KHÔ",300000,300000,0,0
TIKI,voucher-dich-vu,252771136,"Evoucher - Vé xem phim 2D Lotte Cinema tất cả các ngày trong tuần",120000,120000,0,0
TIKI,voucher-dich-vu,273901815,"HCM [E-Voucher] Mã giảm giá 100k cho đơn hàng có giá trị từ 499k tại web/app Potico.vn",1000,1000,0,0
TIKI,voucher-dich-vu,207236323,"Sách nói Ngài Cóc Đi Gặp Bác Sĩ Tâm Lý",99000,99000,0,0
TIKI,tui-vi-nu,35936786,"Bộ balo túi xách nữ 3 món thời trang",79000,79000,0,0
TIKI,voucher-dich-vu,274585334,"Xét nghiệm ADN Mẹ - Con tại ADNVIETNAM",3000000,3000000,0,0
TIKI,voucher-dich-vu,214830338,"Vở cải lương "Người đối diện Lương Tâm"",300000,300000,0,0
TIKI,voucher-dich-vu,204643488,"[The Open Space Hoa Lan] Workshop làm bánh",490000,490000,0,0
TIKI,tui-vi-nu,207837405,"Túi Tote Vải Đi Học Kẻ Ô Siêu Xinh, Túi Xách Nữ Vải Canvas Thời Trang Đi Chơi, Đựng Đồ - OTV216 - Ope Store",200000,200000,0,0
TIKI,tui-vi-nu,180303958,"Túi Cói, Túi Tote Cỏ Bàng Xinh Xắn, Giỏ Xách Thời Trang",259000,259000,0,0
TIKI,tui-vi-nu,71095889,"TÚI ĐEO CHÉO CHO NỮ MÀU HỒNG",69000,69000,0,0
TIKI,tui-vi-nu,137529159,"Túi ví đeo chéo, cầm tay mini 2 trong 1 vân chỉ có dây phong cách sang, xịn, mịn",69000,138000,69000,50
TIKI,voucher-dich-vu,270477876,"Le Pavillon Hội An Gallery Hotel & Spa 5* - Trung Tâm Phố Cổ, Thuận Tiện Tham Quan, Hồ Bơi, Nhiều Ưu Đãi Hấp Dẫn",789000,789000,0,0
TIKI,voucher-dich-vu,193668829,"Phiếu Quà Tặng BreadTalk 200K",200000,200000,0,0
TIKI,voucher-dich-vu,273284981,"Evoucher Phiếu Quà Tặng Yang Hao 200K",200000,200000,0,0
TIKI,voucher-dich-vu,55190819,"Thẻ học tiếng Anh Panda",420000,420000,0,0
TIKI,tui-vi-nu,154858347,"Túi vải bố thô - không dây rút",30000,30000,0,0
TIKI,voucher-dich-vu,273503292,"Voucher Up Móng dành cho 1 ngón - Chang Nails",7000,15000,8000,53
TIKI,voucher-dich-vu,243044031,"Voucher Đắp Mặt Nạ (Mặt) - Chang Nails",22000,36000,14000,39
TIKI,voucher-dich-vu,206491067,"AIR ON STRINGS - Concerts for supporting Community Development Project",200000,200000,0,0
TIKI,voucher-dich-vu,273818388,"Bảo hiểm du lịch toàn cầu MIC, chuyến đi từ 4 - 6 ngày, gói Thượng hạng",128800,184000,55200,30
TIKI,voucher-dich-vu,273721183,"[Gói An tâm] Bảo hiểm Vững tâm sống khoẻ MIC, trợ cấp nằm viện, nội trú, phẫu thuật, tai nạn",107800,154000,46200,30
TIKI,voucher-dich-vu,243031570,"Voucher Fill Up cho Móng - Chang Nails",49000,72000,23000,32
TIKI,voucher-dich-vu,273737742,"Bảo hiểm Du lịch toàn cầu MIC, chuyến đi 16 - 18 ngày, gói Thượng hạng",315700,451000,135300,30
TIKI,voucher-dich-vu,263967746,"ÊMM Hotel 4* Hội An - Trung Tâm Phố Cổ - Buffet Sáng - Hồ Bơi Giữa Không Gian Xanh Mát",829000,829000,0,0
TIKI,voucher-dich-vu,273718293,"HOCMAI - Phòng luyện đề thi Đánh giá năng lực ĐHQG Hà Nội - HSA - Gói 3, 6, 12 tháng - Evoucher",665000,990000,325000,33
TIKI,voucher-dich-vu,204639526,"[LemLab] Workshop Làm Gốm",450000,450000,0,0
TIKI,tui-vi-nu,157402656,"Classy Bao lì xì Tết 10C/ SET 2024, chất liệu dày dặn, mẫu mã đa dạng Q1476",10000,10000,0,0
TIKI,voucher-dich-vu,272638703,"Bảo hiểm TNDS Xe máy (bắt buộc), số tiền bồi thường 150 triệu, giấy chứng nhận điện tử tiện dụng",66000,66000,0,0
TIKI,tui-vi-nu,54562860,"Túi xách nữ đeo vai dễ thương thời trang  Hàn Quốc VTX016",50000,50000,0,0
TIKI,voucher-dich-vu,243031179,"Voucher Đắp Móng - Chang Nails",122000,200000,78000,39
TIKI,voucher-dich-vu,158012418,"Phiếu Quà Tặng Beard Papa's 20K ",20000,20000,0,0
TIKI,voucher-dich-vu,269843793,"Phiếu Quà Tặng GrabGifts 500K",500000,500000,0,0
TIKI,voucher-dich-vu,272322014,"Gói VIP 1 Tháng SCTV Online",59000,59000,0,0
TIKI,tui-vi-nu,141323336,"Túi đeo chéo nữ da siêu mềm, nhiều ngăn cỡ nhỏ TD1 | Túi Messenger nữ",141900,141900,0,0
TIKI,voucher-dich-vu,270765498,"Ladalat Hotel 5* Đà Lạt - Buffet Sáng, Hồ Bơi, Gần Thung Lũng Tình Yêu, Miễn Phí Tham Quan Vườn Dâu, Vườn Rau, Xe Đưa Đón Chợ Đà Lạt và Nhiều Ưu Đãi Hấp Dẫn",1199000,1199000,0,0
TIKI,voucher-dich-vu,205719298,"[Bến Thành] Liveshow Uyên Linh - Thảo Trang, special guest: Khói",400000,400000,0,0
TIKI,voucher-dich-vu,273445177,"HOCMAI Combo Khám phá tri thức 1: Khóa học lập trình chiến bình Python + Khóa Thuyết trình Tiếng Anh - Phòng luyện TOPCLASS - Toàn quốc [Voucher]",534000,1118000,584000,52
TIKI,voucher-dich-vu,205709193,"[THEATRE 21] I KNOW YOU KNOW I KNOW YOU DON'T KNOW - KỊCH ỨNG TÁC / IMPROV SHOW",175000,175000,0,0
TIKI,tui-vi-nu,191755617,"Túi Cói, Túi Tote Cỏ Bàng Vẽ Hoa Tú Cầu Cao Cấp, Chuẩn Đẹp-Giỏ Xách Cỏ Bàng TXCBVHTCLTK03",329000,329000,0,0
TIKI,voucher-dich-vu,209917714,"[Bến Thành] Liveshow Myra Trần - Mai Tiến Dũng - Thảo Trang",450000,450000,0,0
TIKI,voucher-dich-vu,251520948,"Phiếu Quà Tặng Don Chicken 500K",500000,500000,0,0
TIKI,voucher-dich-vu,204636032,"HỘI AN MEMORIES MUSIC SHOW - Đêm nhạc THIÊN THẦN",500000,500000,0,0
TIKI,voucher-dich-vu,80901695,"Sách nói: Cái Cười Của Thánh Nhân",99000,99000,0,0
TIKI,tui-vi-nu,10278537,"Ví Cầm Tay Nữ Thời Trang Flamingo",131000,131000,0,0
TIKI,tui-vi-nu,107181944,"Túi Xách Hàng Xưởng KiểuTrơn Khóa Gập Dây Kim Loại Mang Đi Tiệc Dạo Phố Đi Chơi Chất Lượng Cao Giá Tốt",128000,128000,0,0
TIKI,tui-vi-nu,181784438,"Túi Cói, Túi Xách Cỏ Bàng Vẽ Hoa Cúc Chuẩn Đẹp",329000,329000,0,0
TIKI,tui-vi-nu,194026122,"Túi nữ đeo chéo da bụng cá sấu bạch tạng hiếm có!",3300000,5500000,2200000,40
TIKI,tui-vi-nu,128291761,"Túi đeo chéo vịt vàng",127000,127000,0,0
TIKI,tui-vi-nu,86561442," Túi đeo chéo   Túi vải Canvas Phong Cách Hàn Quốc TV17",27000,27000,0,0
TIKI,tui-vi-nu,165650794,"Túi đeo chéo nữ mini dây xích to phong cách Hàn Quốc",129000,129000,0,0
TIKI,tui-vi-nu,157402296,"Phụ kiện treo trang trí cây thông giáng sinh nhiều hình xinh xắn bằng vải không dệt Q1772",18000,18000,0,0
TIKI,tui-vi-nu,155608823,"Ví nữ HANHSON da đà điểu màu trắng",1050000,1050000,0,0
TIKI,tui-vi-nu,71677784,"Ví đựng thẻ",290000,290000,0,0
TIKI,tui-vi-nu,147484984,"Túi TOTE vải in hoạt hình dễ thương để đi học dung tích lớn tiện lợi",87000,87000,0,0
TIKI,tui-vi-nu,62997685,"Ví Kéo Dài Mặt Mèo Nhiều Ngăn",30000,30000,0,0
TIKI,tui-vi-nu,46647025,"Túi clutch nữ cao cấp da thật ELLY – EC38 màu đen ",2499000,2499000,0,0
TIKI,tui-vi-nu,194025900,"Túi nữ da cá sấu đeo chéo có khuy cài!",2900000,5000000,2100000,42
TIKI,tui-vi-nu,79449697,"[ Hàng cao cấp]-Túi cói đi biển dạo phố phong cách vintage, túi hình thang",400000,400000,0,0
TIKI,tui-vi-nu,196955805,"Túi Xách Nữ (Túi Tote) Kẻ Sọc Đeo Vai Form Lớn Đi Học & Công Sở Phong Cách Thời Trang Hàn Quốc - Mã XT060",137000,137000,0,0
TIKI,tui-vi-nu,184602751,"Ví card Sophia da bò thật Pink Ohara",370000,370000,0,0
TIKI,tui-vi-nu,77748084,"Túi đeo chéo mini đựng điện thoại đeo chéo thời trang dọc nắp hình ngôi sao MM247 Tặng móc khóa cá heo",32670,44649,11979,27
TIKI,tui-vi-nu,188742578,"Túi Cói, Túi Xách Lục Bình Quai Mây Cao Cấp, Chuẩn Đẹp-Giỏ Lục Bình TXLBQMLTK02",329000,329000,0,0
TIKI,tui-vi-nu,196233239,"Túi đeo chéo nữ phong cách dễ thương – DCNU1013",135000,270000,135000,50
TIKI,tui-vi-nu,46748324,"Túi xách da cao cấp TD8667-001",599000,599000,0,0
TIKI,tui-vi-nu,14704300,"Túi tote túi vải phong cách hàn quốc",120000,120000,0,0
TIKI,tui-vi-nu,21019965,"Túi đeo chéo, túi đeo vai nữ vải Canvas TV07",59000,59000,0,0
TIKI,tui-vi-nu,43694942,"Túi Xách Nữ, Túi Xách Thời Trang 208082",66700,101400,34700,34
TIKI,tui-vi-nu,173552151,"Thẻ Bọc Căn Cước Công Dân-Thẻ ATM-Bao Bì Bọc Thẻ Căn Cước,Thẻ ATM.",1000,1000,0,0
TIKI,tui-vi-nu,185774953,"Túi Xách Thời Trang Nữ",189000,189000,0,0
TIKI,tui-vi-nu,43694796,"Túi Nữ Đeo Chéo Bì Thư Đồ Da Thành Long TLG 208063",33300,46600,13300,29
TIKI,tui-vi-nu,147468642,"Túi đeo chéo Bò Sữa phong cách Hàn Quốc Không bao gồm gấu bông",34000,34000,0,0
TIKI,tui-vi-nu,74603843,"Túi đeo chéo Hoạt Hình Vui Nhộn Mstaly ngẫu nhiên Tặng móc khóa cá heo",38610,52767,14157,27
TIKI,tui-vi-nu,51065034,"Túi Nữ Đeo Chéo Mini, Hình thú vui nhộn, Vải Canvas siêu bền ( Mẫu Vịt)",120000,120000,0,0
TIKI,tui-vi-nu,176150164,"Túi Xách Nữ Gence Da Bò Cao Cấp TX08",1890000,1890000,0,0
TIKI,tui-vi-nu,192029000,"Túi Kẹp Nách Nữ Chính Hãng MICOCAH Túi Đeo Chéo Nữ Đeo Vai Dáng Công Sở Thời Trang Chất Da Cao Cấp Cực Đẹp MC46 - Micocah",389000,389000,0,0
TIKI,tui-vi-nu,135288997,"Túi tote cảro vải canvas dùng hai mặt Túi vải đeo vai",100000,100000,0,0
TIKI,tui-vi-nu,157402119,"[Thiệp xinh] chúc mừng 20-11, Sinh Nhật, Lễ lạt, Cảm Ơn , Tình Yêu in hình sắc nét",2000,2000,0,0
TIKI,tui-vi-nu,2009135,"Ví Nữ Huy Hoàng HT3158 (9.5 x 19 cm) - Xanh Dương",599000,599000,0,0
TIKI,tui-vi-nu,67666778,"Túi đeo chéo đeo bụng hiện đại thời trang siêu đẹp Tặng móc khóa nam cao cấp",124740,170478,45738,27
TIKI,tui-vi-nu,181096611,"Túi xách nữ MONOGRAM CANVAS ELLY – EL205",1044450,1899000,854550,45
TIKI,tui-vi-nu,180225512,"Túi Ví Nữ Cầm Tay Thời Trang Mini Cao Cấp Sang Trọng Lịch Sự Đựng Chìa Khóa, Son Môi - M1",65000,80000,15000,19
TIKI,tui-vi-nu,189897281,"Đeo chéo nữ Thời Trang công sở cao cấp – DCNU1001",198000,400000,202000,51
TIKI,tui-vi-nu,117294770,"Túi cói tròn đeo chéo hình Lá và Dứa (hàng có sẵn)",89000,89000,0,0
TIKI,tui-vi-nu,204914744,"Túi Xách Nữ Có Quai Đeo Da Bò Cao Cấp Màu Đen,Màu Đỏ WT Leather THE QUEEN",5500000,5500000,0,0
TIKI,tui-vi-nu,88050928,"Túi xách nữ thời trang cao cấp HuongTra99-C31018-180",899000,899000,0,0
TIKI,tui-vi-nu,260407494,"Dây kéo YKK Thái 2 chiều (không kèm đầu khóa) răng 5",70000,70000,0,0
TIKI,tui-vi-nu,187828611,"Túi đeo chéo nữ vải dù trần trám 4 ngăn chống nước, phong cách Hàn Quốc Size 22cm",129000,129000,0,0
TIKI,tui-vi-nu,209414568,"Ví nữ dài 2 ngăn 2 khóa tiện dụng cực chất Q",113000,113000,0,0
TIKI,tui-vi-nu,55409165,"Túi xách đeo vai nữ thời trang, sang trọng 0962",165000,165000,0,0
TIKI,tui-vi-nu,108696893,"Ví ngắn cầm tay Prettyzys/Pritti 2021 thiết kế in hoa đơn giản (PTZ95)",210000,210000,0,0
TIKI,tui-vi-nu,11886861,"Túi mây tre đan trơn mấn góc - Nhỏ 18cm",199000,219000,20000,9
TIKI,tui-vi-nu,55057031,"Túi tote vải canvas đi học,đi chơi phon cách Hàn Quốc siêu hot",54900,54900,0,0
TIKI,tui-vi-nu,192031857,"Ví Nữ Mini Cầm Tay Chính Hãng MICOCAH Bóp Nữ Mini Phối Vân Da Rắn Nhỏ Gọn Nhiều Ngăn Tiện Dụng Da Cao Cấp Cực Đẹp Giá Rẻ MC49 - Micocah Mall",169000,169000,0,0
TIKI,tui-vi-nu,149179446,"TÚI ĐEO CHÉO THỜI TRANG NỮ DÂY ĐEO DA PHỤ KIỆN THỜI TRANG",520800,520800,0,0
TIKI,tui-vi-nu,143282150,"HJ6201-02-03-04 - Túi xách nữ Huy Hoàng da cá sấu hộp vuông nhiều màu",10499000,10499000,0,0
TIKI,tui-vi-nu,147197355,"Túi Hậu Môn Nhân Tạo 2 Mảnh- Hollister (Trong, Sử Dụng Kẹp), 18102 / 18103 / 18104 -VT0737",454000,454000,0,0
TIKI,tui-vi-nu,13215443,"Túi nữ cao cấp da thật ELLY- ET92",1949350,2999000,1049650,35
TIKI,tui-vi-nu,175542103,"Túi da bò",999000,999000,0,0
TIKI,tui-vi-nu,160314058,"Túi Xách Nữ Đeo Chéo Đeo Vai MICOCAH Dáng Công Sở Thời Trang Phong Cách Hàn Quốc Da Cao Cấp Cực Đẹp MC107 - Micocah Mall",439000,439000,0,0
TIKI,tui-vi-nu,53769045,"Túi đeo chéo nam nữ thời trang Hàn quốc BEE GEE 085 chống thấm nước",54000,110000,56000,51
TIKI,tui-vi-nu,125100755,"Bộ 2 Ví đựng hộ chiếu giấy tờ và thẻ 12 ngăn (hồng , xanh nhạt)",69000,69000,0,0
TIKI,tui-vi-nu,2020651,"Ví Nữ Da Đà Điểu 1 Khóa Huy Hoàng HT3423 (19 x 10.5 cm) - Đen",1499000,1499000,0,0
TIKI,tui-vi-nu,106657155,"Túi clucth cầm tay, clutch Quảng Châu, ví dài, ví da, ví da cao cấp, ví nữ, clutch dự tiệc, túi công sở",286000,286000,0,0
TIKI,tui-vi-nu,184069057,"HAVAIANAS - Túi đeo chéo mini hình thang hiện đại Bucket 4146864",450000,450000,0,0
TIKI,tui-vi-nu,184859332,"Túi xách nữ thời trang cao cấp thời trang – BEE GEE TN1006",178000,360000,182000,51
TIKI,tui-vi-nu,42240058,"Túi đựng điện thoại đeo chéo thời trang dọc nắp Trơn ép chữ N7 Shalla",83160,120120,36960,31
TIKI,tui-vi-nu,180226070,"Túi Ví Nữ Cầm Tay Thời Trang Mini Cao Cấp Sang Trọng Lịch Sự Đựng Chìa Khóa, Son Môi - M2",75000,85000,10000,12
TIKI,tui-vi-nu,201697057,"Túi xách nữ tuổi trung niên mần sui- túi đi tiệc trung niên đính đá form da mềm sang trọng(túi tặng mẹ,bà)",299000,299000,0,0
TIKI,tui-vi-nu,54053319,"Túi đeo chéo Nữ đựng điện thoại - C02A",150000,150000,0,0
TIKI,tui-vi-nu,108893883,"VÍ ĐỰNG TIỀN MINI CẦM TAY PHỐI HỌA TIẾT DỄ THƯƠNG + TẶNG 1 SET KẸP MÁI NGŨ SẮC",22000,22000,0,0
TIKI,tui-vi-nu,26191856,"Túi đeo chéo mini cho nữ chất liệu vài poly",59667,81545,21878,27
TIKI,tui-vi-nu,187805326,"Túi xách nữ dễ thương NASI T1042 túi vải bố canvas cầm tay đẹp đeo vai thời trang hàn quốc",79000,79000,0,0
TIKI,tui-vi-nu,157199182,"Túi vải bố cao cấp LMCATION",37050,39000,1950,5
TIKI,tui-vi-nu,198129408,"Túi Cói Đi Biển Vintage, Giỏ Xách Cỏ Bàng Vẽ Hoa Cúc Cao Cấp, Chuẩn Đẹp TXCBVHCLTK18",339000,339000,0,0
TIKI,tui-vi-nu,72032325,"Túi xách nữ thời trang cao cấp ELLY- EL139",899400,1499000,599600,40
TIKI,tui-vi-nu,109089147,"Ví nữ mini họa tiết mèo dễ thương, ví vải chống nước cao cấp, tặng kèm dây đeo năng động",200000,200000,0,0
TIKI,voucher-dich-vu,184859332,"Túi xách nữ thời trang cao cấp thời trang – BEE GEE TN1006",178000,360000,182000,51
TIKI,voucher-dich-vu,190589367,"Bóp Ví Cầm Tay Ví Dài Khóa Kéo Nữ Nhiều ngăn Hình Khủng Long Siêu Cute Cho Bạn Gái ( giao ngẫu nhiên)",62000,62000,0,0
TIKI,voucher-dich-vu,11886861,"Túi mây tre đan trơn mấn góc - Nhỏ 18cm",199000,219000,20000,9
TIKI,voucher-dich-vu,181096611,"Túi xách nữ MONOGRAM CANVAS ELLY – EL205",1044450,1899000,854550,45
TIKI,tui-vi-nu,72701832,"móc khóa móc phụ kiện túi xách 1 cặp",29000,29000,0,0
TIKI,voucher-dich-vu,109089147,"Ví nữ mini họa tiết mèo dễ thương, ví vải chống nước cao cấp, tặng kèm dây đeo năng động",200000,200000,0,0
TIKI,tui-vi-nu,58394274,"Túi Xách Nữ Thời Trang Cao Cấp Phong Cách Hàn Quốc N0210",395000,395000,0,0
TIKI,tui-vi-nu,190589367,"Bóp Ví Cầm Tay Ví Dài Khóa Kéo Nữ Nhiều ngăn Hình Khủng Long Siêu Cute Cho Bạn Gái ( giao ngẫu nhiên)",62000,62000,0,0
TIKI,voucher-dich-vu,184069057,"HAVAIANAS - Túi đeo chéo mini hình thang hiện đại Bucket 4146864",450000,450000,0,0
TIKI,tui-vi-nu,36285599,"TÚI ĐEO CHÉO ĐỰNG ĐIỆN THOẠI HÌNH GẤU",110000,122000,12000,10
TIKI,voucher-dich-vu,260407494,"Dây kéo YKK Thái 2 chiều (không kèm đầu khóa) răng 5",70000,70000,0,0
TIKI,voucher-dich-vu,36285599,"TÚI ĐEO CHÉO ĐỰNG ĐIỆN THOẠI HÌNH GẤU",110000,122000,12000,10
TIKI,voucher-dich-vu,125100755,"Bộ 2 Ví đựng hộ chiếu giấy tờ và thẻ 12 ngăn (hồng , xanh nhạt)",69000,69000,0,0
TIKI,voucher-dich-vu,35857223,"Túi Xách Nữ Đeo Chéo Phong Cách Ngọc Trinh BT19",55000,55000,0,0
TIKI,voucher-dich-vu,58394274,"Túi Xách Nữ Thời Trang Cao Cấp Phong Cách Hàn Quốc N0210",395000,395000,0,0
TIKI,voucher-dich-vu,187828611,"Túi đeo chéo nữ vải dù trần trám 4 ngăn chống nước, phong cách Hàn Quốc Size 22cm",129000,129000,0,0
TIKI,tui-vi-nu,188057302,"Túi đeo chéo họa tết vải dù chống thấm nước cao cấp size 20cm TUI-14",99000,99000,0,0
TIKI,voucher-dich-vu,188057302,"Túi đeo chéo họa tết vải dù chống thấm nước cao cấp size 20cm TUI-14",99000,99000,0,0
TIKI,voucher-dich-vu,180225512,"Túi Ví Nữ Cầm Tay Thời Trang Mini Cao Cấp Sang Trọng Lịch Sự Đựng Chìa Khóa, Son Môi - M1",65000,80000,15000,19
TIKI,voucher-dich-vu,147197355,"Túi Hậu Môn Nhân Tạo 2 Mảnh- Hollister (Trong, Sử Dụng Kẹp), 18102 / 18103 / 18104 -VT0737",454000,454000,0,0
TIKI,voucher-dich-vu,53501336,"Túi đeo chéo nữ Hàn Quốc",68000,68000,0,0
TIKI,voucher-dich-vu,67666778,"Túi đeo chéo đeo bụng hiện đại thời trang siêu đẹp Tặng móc khóa nam cao cấp",124740,170478,45738,27
TIKI,voucher-dich-vu,189897281,"Đeo chéo nữ Thời Trang công sở cao cấp – DCNU1001",198000,400000,202000,51
TIKI,voucher-dich-vu,198129408,"Túi Cói Đi Biển Vintage, Giỏ Xách Cỏ Bàng Vẽ Hoa Cúc Cao Cấp, Chuẩn Đẹp TXCBVHCLTK18",339000,339000,0,0
TIKI,voucher-dich-vu,55057031,"Túi tote vải canvas đi học,đi chơi phon cách Hàn Quốc siêu hot",54900,54900,0,0
TIKI,voucher-dich-vu,26191856,"Túi đeo chéo mini cho nữ chất liệu vài poly",59667,81545,21878,27
TIKI,voucher-dich-vu,54053319,"Túi đeo chéo Nữ đựng điện thoại - C02A",150000,150000,0,0
TIKI,voucher-dich-vu,149179446,"TÚI ĐEO CHÉO THỜI TRANG NỮ DÂY ĐEO DA PHỤ KIỆN THỜI TRANG",520800,520800,0,0
TIKI,tui-vi-nu,35857223,"Túi Xách Nữ Đeo Chéo Phong Cách Ngọc Trinh BT19",55000,55000,0,0
TIKI,voucher-dich-vu,72032325,"Túi xách nữ thời trang cao cấp ELLY- EL139",899400,1499000,599600,40
TIKI,voucher-dich-vu,55409165,"Túi xách đeo vai nữ thời trang, sang trọng 0962",165000,165000,0,0
TIKI,voucher-dich-vu,2020651,"Ví Nữ Da Đà Điểu 1 Khóa Huy Hoàng HT3423 (19 x 10.5 cm) - Đen",1499000,1499000,0,0
TIKI,voucher-dich-vu,72701832,"móc khóa móc phụ kiện túi xách 1 cặp",29000,29000,0,0
TIKI,voucher-dich-vu,209414568,"Ví nữ dài 2 ngăn 2 khóa tiện dụng cực chất Q",113000,113000,0,0
TIKI,voucher-dich-vu,201697057,"Túi xách nữ tuổi trung niên mần sui- túi đi tiệc trung niên đính đá form da mềm sang trọng(túi tặng mẹ,bà)",299000,299000,0,0
TIKI,voucher-dich-vu,42240058,"Túi đựng điện thoại đeo chéo thời trang dọc nắp Trơn ép chữ N7 Shalla",83160,120120,36960,31
TIKI,voucher-dich-vu,187805326,"Túi xách nữ dễ thương NASI T1042 túi vải bố canvas cầm tay đẹp đeo vai thời trang hàn quốc",79000,79000,0,0
TIKI,voucher-dich-vu,192031857,"Ví Nữ Mini Cầm Tay Chính Hãng MICOCAH Bóp Nữ Mini Phối Vân Da Rắn Nhỏ Gọn Nhiều Ngăn Tiện Dụng Da Cao Cấp Cực Đẹp Giá Rẻ MC49 - Micocah Mall",169000,169000,0,0
TIKI,voucher-dich-vu,180226070,"Túi Ví Nữ Cầm Tay Thời Trang Mini Cao Cấp Sang Trọng Lịch Sự Đựng Chìa Khóa, Son Môi - M2",75000,85000,10000,12
TIKI,voucher-dich-vu,106657155,"Túi clucth cầm tay, clutch Quảng Châu, ví dài, ví da, ví da cao cấp, ví nữ, clutch dự tiệc, túi công sở",286000,286000,0,0
TIKI,voucher-dich-vu,143282150,"HJ6201-02-03-04 - Túi xách nữ Huy Hoàng da cá sấu hộp vuông nhiều màu",10499000,10499000,0,0
TIKI,voucher-dich-vu,13215443,"Túi nữ cao cấp da thật ELLY- ET92",1949350,2999000,1049650,35
TIKI,voucher-dich-vu,157199182,"Túi vải bố cao cấp LMCATION",37050,39000,1950,5
TIKI,voucher-dich-vu,175542103,"Túi da bò",999000,999000,0,0
TIKI,voucher-dich-vu,108696893,"Ví ngắn cầm tay Prettyzys/Pritti 2021 thiết kế in hoa đơn giản (PTZ95)",210000,210000,0,0
TIKI,tui-vi-nu,53501336,"Túi đeo chéo nữ Hàn Quốc",68000,68000,0,0
TIKI,voucher-dich-vu,53769045,"Túi đeo chéo nam nữ thời trang Hàn quốc BEE GEE 085 chống thấm nước",54000,110000,56000,51
TIKI,voucher-dich-vu,160314695,"Ví Nữ Dài Cầm Tay Chính Hãng TAILIAN Thời Trang Đựng Tiền Da Cao Cấp Cực Đẹp Giá Rẻ TL08 - Micocah Mall",119000,119000,0,0
TIKI,voucher-dich-vu,96312905,"Túi Xách Nữ Đẹp Đeo Vai Form Lớn Đan Len Đi Học & Công Sở Phong Cách Thời Trang Âu Mỹ - Mã XT013",175000,175000,0,0
TIKI,voucher-dich-vu,67211257,"Túi đeo chéo nữ để điện thoại TCHE1 phong cách trẻ trung, năng động tặng kèm 2 nút bảo vệ đầu sạc điện thoại",58410,79827,21417,27
TIKI,voucher-dich-vu,108254287,"Ví Dài Nam Nữ, Ví Cầm Tay Da mềm Cao Cấp",190000,190000,0,0
TIKI,tui-vi-nu,76102979,"Túi Xách Nữ, Túi Đeo Vai Nữ Phong Cách Vintage In Họa Tiết Siêu Dễ Thương",28000,29999,1999,7
TIKI,tui-vi-nu,193715750,"Túi Xách Nữ, Túi Đeo Chéo Nữ Đẹp Trẻ Trung Hàn Quốc",130000,130000,0,0
TIKI,voucher-dich-vu,199520547,"Túi xách nữ silicon lụa phong cách Hàn Quốc",149000,149000,0,0
TIKI,tui-vi-nu,118036773,"Đãi túi cho phật tử và thầy, túi kaki đeo vai",72000,72000,0,0
TIKI,tui-vi-nu,108155133,"Balo thời trang, balo đi học, đựng laptop Túi Tote Mèo Mắt Long Lanh Mèo Cute balo nữ vải",93000,93000,0,0
TIKI,voucher-dich-vu,168794802,"1kg Túi PA hút chân không 10zem/15zem 2 mặt trơn",78000,78000,0,0
TIKI,voucher-dich-vu,184071608,"Túi xách nữ 1992 s t u d i o / LILY BAG /  màu đen kẹp nách",199000,199000,0,0
TIKI,tui-vi-nu,272429248,"Túi xách nữ vải dù siêu bền không thấm nước kiểu dáng Hàn Quốc size 21cm",119000,119000,0,0
TIKI,tui-vi-nu,88813417,"Túi xách Pierre Loues dáng túi trống đeo vai với 2 đầu gút thắt cách điệu thời trang dạo phố - PL514",257000,298000,41000,14
TIKI,tui-vi-nu,53979971,"Ví nữ cầm tay cao cấp 2 ngăn kéo sang trọng, thiết kế nhiều ngăn tiện dụng TK0047 - ĐEN",76000,100000,24000,24
TIKI,voucher-dich-vu,186204178,"Túi Xách Nữ Thời Trang Cao Cấp Elly EL128",979300,1399000,419700,30
TIKI,voucher-dich-vu,73613463,"Túi Vải Đeo Chéo Gấu Bông Hàn Quốc",31680,43296,11616,27
TIKI,voucher-dich-vu,112049090,"Túi đeo chéo thời trang nữ mini đi chơi dự tiệc cao cấp, Túi xách nữ đẹp HT21",55000,55000,0,0
TIKI,voucher-dich-vu,54029584,"Ví cầm tay nữ 2 ngăn kéo sang trọng , thiết kế nhiều ngăn tiện dụng TK0048",76000,100000,24000,24
TIKI,tui-vi-nu,70937309,"Ví nữ cầm tay thời trang cao cấp ELLY – EV69",799000,799000,0,0
TIKI,voucher-dich-vu,160314132,"Ví Nữ Dài Cầm Tay Chính Hãng FOREVER YOUNG Thanh Lịch Sang Trọng Nhiều Ngăn Tiện Dụng FY10 - Micocah Mall",159000,159000,0,0
TIKI,tui-vi-nu,155169078,"Túi giỏ xách nữ đeo chéo cao cấp thời trang Hàn Quốc sang chảnh chất liệu da mềm mịn, kiểu dáng sang trọng,lịch sự TX048",219000,219000,0,0
TIKI,tui-vi-nu,197321592,"Túi Tote Chần Bông SAIGON SWAGGER NOIR PUFFER TOTE BAG",531000,590000,59000,10
TIKI,tui-vi-nu,93831393," Túi đeo chéo trong suốt | Mini Bag Unisex",123500,123500,0,0
TIKI,voucher-dich-vu,71930976,"Túi đeo chéo/Túi bao tử nữ thời trang cao cấp, thiết kế độc, lạ, cá tính hot trend 2020-2021",85000,85000,0,0
TIKI,tui-vi-nu,86561273,"  50K Túi đeo chéo nữ dây pha xích mini",55000,55000,0,0
TIKI,voucher-dich-vu,209414471,"Túi đựng điện thoại kiêm ví đeo chéo hoa cúc TXNHC149",142000,142000,0,0
TIKI,tui-vi-nu,68626519,"Ví da nữ mini nhỏ gọn đựng tiền đựng thẻ YUUMY YV29 nhiều màu",69000,110000,41000,37
TIKI,tui-vi-nu,86561609," Túi Cói    Túi Xách Nữ Phong cách Vintage TV12",38000,41900,3900,9
TIKI,voucher-dich-vu,79411724,"Túi đeo đựng điện thoại thời trang - màu ngẫu nhiên ( tặng móc khoa đa năng )",34155,46678,12523,27
TIKI,tui-vi-nu,105655289,"Túi xách túi đeo chéo nữ kiểu dáng công sở kèm dây nơ xinh xắn",99000,99000,0,0
TIKI,tui-vi-nu,13419271,"Ví Mini Cầm Tay Họa Tiết Kim Loại Hn001",62000,62000,0,0
TIKI,voucher-dich-vu,52658437,"Túi xách đeo vai nữ combo 2 thời trang KDR20",89100,121770,32670,27
TIKI,voucher-dich-vu,77200181,"[VOUCHER 30K] Ví cầm tay nữ thời trang LATA VN51",269000,350000,81000,23
TIKI,tui-vi-nu,114119695,"Túi Đeo Chéo Mickey Dáng Vuông",189000,189000,0,0
TIKI,voucher-dich-vu,32860122,"Túi Đeo Chéo Thời Trang Họa Tiết Sọc",271000,271000,0,0
TIKI,tui-vi-nu,186606688,"Túi Vải Canvas Cao cấp - Độc quyền HeydayCacao",79000,79000,0,0
TIKI,voucher-dich-vu,90432070," TÚI CÓI ĐI BIỂN MERCI SANG CHẢNH PHONG CÁCH HÀN QUỐC",39971,39971,0,0
TIKI,tui-vi-nu,263516111,"(HÀNG SẴN) Túi Xách Tay Da Mềm Thời Trang AT01 - Hàng Quảng Châu Cao Cấp",325000,325000,0,0
TIKI,tui-vi-nu,137952085,"Túi Giỏ Xách Đan Tay Xéo Quai Gỗ Hàng Xuất Khẩu Thủ Công Sang Chảnh Đi Chơi Đi Biển Chụp Hình - Doni House",126000,126000,0,0
TIKI,voucher-dich-vu,209414547,"Ví nữ dài cầm tay hai ngăn phối màu VND100 tam thể hai khóa",112000,112000,0,0
TIKI,voucher-dich-vu,174518731,"Ví đựng hộ chiếu Passport giấy tờ xe, thẻ thời trang chất liệu da bò cao cấp 40596",150000,150000,0,0
TIKI,voucher-dich-vu,52758151,"Túi TOTE Thiết Kế Thời Trang Hàn Quốc",89000,89000,0,0
TIKI,tui-vi-nu,68773394,"Túi Kẹp Nách Nữ Thời Trang Hot Trend Cá Tính TEB409",55000,55000,0,0
TIKI,voucher-dich-vu,31622709,"Túi đeo chéo 2 ngăn đựng điện thoại",150000,150000,0,0
TIKI,voucher-dich-vu,157253905,"Móc Khóa Dọc In Báo SAIGON SWAGGER Journal Card Keychain",150000,150000,0,0
TIKI,tui-vi-nu,191259117,"Ví Da PU Mini Cầm Tay Họa Tiết Cô Gái Summer Xinh Xắn Nhiều Ngăn Có Khóa Kéo Bóp Nữ Cute Hot Trend Dễ Thương",50000,50000,0,0
TIKI,tui-vi-nu,142211339,"Túi Đeo Chéo Chống Thám, Kháng Khuẩn Stargo Retro - Hàng Chính Hãng",187000,219000,32000,15
TIKI,tui-vi-nu,160314514,"Ví Ngắn Nữ Mini Cầm Tay Thời Trang TAILIAN Đựng Tiền Phong Cách Hàn Quốc Sang Trọng Da Cao Cấp Cực Đẹp TL36 - Micocah",109000,109000,0,0
TIKI,voucher-dich-vu,186636029,"Túi Cói, Túi Xách Cỏ Bàng Vẽ Hoa Mỹ Nghệ Cao Cấp, Chuẩn Đẹp-TXCBVHGLTK05",329000,329000,0,0
TIKI,tui-vi-nu,196341307,"Tấm Lót Chống Thấm Cho Bé Sơ Sinh 5 Lớp Chần Bông Thấm Hút Nhanh An Toàn Tiện Lợi - 231",115000,115000,0,0
TIKI,voucher-dich-vu,176681270,"Túi xách nữ bản to _ Túi nữ thời trang công sở đựng vừa A4",125000,125000,0,0
TIKI,voucher-dich-vu,152015159,"Túi Tote Túi Vải Canvas",99000,99000,0,0
TIKI,tui-vi-nu,91430164,"Ví card holder",127000,127000,0,0
TIKI,voucher-dich-vu,180720785,"Túi Xách Thời Trang Nữ Da Thật Cao Cấp Gence TX09",1600000,1600000,0,0
TIKI,tui-vi-nu,108154925,"Túi tote vải Túi Tote Túi Vải Nữ Túi túi xách Túi Tote Sinh Viên Chú Gà Sweet balo nữ vải",63000,63000,0,0
TIKI,voucher-dich-vu,51288506,"Túi xách nữ công sở bản to",245000,245000,0,0
TIKI,tui-vi-nu,206955191,"Túi xách, Husband & Wife, Best Friends for Life, mã G142. Có khóa kéo. Quà tặng cao cấp cho vợ chồng",109000,109000,0,0
TIKI,tui-vi-nu,104091538,"Ví nữ cầm tay dáng dài YUUMY Seasand YUUMY YV47 phong cách hiện đại nhiều ngăn đựng tiền, thẻ card",89000,220000,131000,60
TIKI,voucher-dich-vu,177579514,"Ví nữ dài cầm tay chính hãng TAILIAN thời trang đựng tiền da cao cấp nhiều ngăn tiện dụng TL39",139000,139000,0,0
TIKI,voucher-dich-vu,195511701,"MLB - Túi bucket đeo chéo Basic Big Logo 3ABMS072N",3290000,3290000,0,0
TIKI,voucher-dich-vu,106867104,"Combo Túi Đựng Thẻ Trong Suốt Nhựa Dẻo Đa Năng",13860,18942,5082,27
TIKI,tui-vi-nu,190744476,"Túi Đeo Chéo Nam Nữ Vải Bố Túi Đeo Vai Nam Chất Liệu Kaki Chống Nước Size 24cm TUI-36",109000,109000,0,0
TIKI,tui-vi-nu,124239585,"Bóp nữ hình cây, ví ngắn nữ mini hàng Quảng Châu loại 1",39000,39000,0,0
TIKI,tui-vi-nu,176825223,"Ví đựng thẻ tín dụng ATM nhiều ngăn ví mini kháng nước nhỏ gọn 20 ngăn xinh xắn giá tốt",26000,26000,0,0
TIKI,tui-vi-nu,182712650,"Ví nữ Monogram canvas ELLY – EVH90",599400,999000,399600,40
TIKI,voucher-dich-vu,252721792,"Túi Clutch dự tiệc sang chảnh quý phái tôn dáng nổi bật VDT02",250000,250000,0,0
TIKI,voucher-dich-vu,147942526,"Túi Xách Nữ Đeo Chéo MICOCAH Dáng Công Sở Thời Trang Vân Quả Trám Sang Trọng Thanh Lịch Da Cao Cấp Cực Đẹp MC61 - Tukado",429000,429000,0,0
TIKI,voucher-dich-vu,194414981,"Túi Xách Lục Bình Thêu Hoa Sang Trọng Chuẩn Đẹp, Giỏ Cói Đi Biển, Túi Du Lịch TXLBTHDSLLTK02",419000,419000,0,0
TIKI,tui-vi-nu,149449476,"Túi xách nữ công sở - hàng quảng châu cao cấp (HOTTREND )",258000,258000,0,0
TIKI,tui-vi-nu,176835648,"Túi xách nữ thời trang công sở cao cấp phong cách mới",387000,430000,43000,10
TIKI,voucher-dich-vu,248990332,"Dây kéo 2 chiều răng 5 (không kèm đầu khóa)",62000,62000,0,0
TIKI,tui-vi-nu,5003107,"Túi Xách Nữ Thời Trang Cao Cấp Elly EL85",1049300,1499000,449700,30
TIKI,voucher-dich-vu,31711116,"Túi đeo chéo đựng điện thoại thời trang + tặng vòng đeo tay",90000,90000,0,0
TIKI,tui-vi-nu,118403624,"Túi Cói Đi BiểnTúi Cói Merci SIÊU HÓT HÍT 2021(video tự quay, hàng chất lừ) Đi Biển, Đi Chơi, Đi Du Lịch, đi làm, đi học",80000,80000,0,0
TIKI,voucher-dich-vu,151901545,"Túi Tote Vải Canvas Nữ Có Khóa Ulzzang Hot Trend Kita Unisex - Mẫu MÈO CUTE - Ảnh thật",69000,69000,0,0
TIKI,tui-vi-nu,160314200,"Ví Ngắn Nữ Mini Cầm Tay Thời Trang TAILIAN Nhiều Ngăn Đựng Tiền Phối Vân Da Rắn Cao Cấp Siêu Đẹp Giá Rẻ TL34 - Micocah",119000,119000,0,0
TIKI,tui-vi-nu,173556714,"Túi Cói, Túi Cói Đi Biển Vintage, Túi Lục Bình Đi Biển, Túi Xách Đi Làm, Giỏ Du Lịch Chuẩn Đẹp",299000,299000,0,0
TIKI,tui-vi-nu,185468208,"bóp ví nữ cầm tay hoặc đeo chéo hàng hiệu có nhiều ngăn dáng nằm với 2 ngăn kéo tiện dụng - N0109",158000,249000,91000,37
TIKI,voucher-dich-vu,174468742,"Ví Nữ Ngắn Mini Cầm Tay TAILIAN Dáng Gập Nhỏ Gọn Nhiều Ngăn Tiện Dụng Da Đẹp Giá Rẻ TL01",99000,99000,0,0
TIKI,voucher-dich-vu,165627374,"Túi đeo chéo nữ mini đựng điện thoại phong cách Hàn Quốc",99000,99000,0,0
TIKI,tui-vi-nu,160314695,"Ví Nữ Dài Cầm Tay Chính Hãng TAILIAN Thời Trang Đựng Tiền Da Cao Cấp Cực Đẹp Giá Rẻ TL08 - Micocah Mall",119000,119000,0,0
TIKI,tui-vi-nu,77200181,"[VOUCHER 30K] Ví cầm tay nữ thời trang LATA VN51",269000,350000,81000,23
TIKI,tui-vi-nu,108254287,"Ví Dài Nam Nữ, Ví Cầm Tay Da mềm Cao Cấp",190000,190000,0,0
TIKI,tui-vi-nu,96312905,"Túi Xách Nữ Đẹp Đeo Vai Form Lớn Đan Len Đi Học & Công Sở Phong Cách Thời Trang Âu Mỹ - Mã XT013",175000,175000,0,0
TIKI,tui-vi-nu,71930976,"Túi đeo chéo/Túi bao tử nữ thời trang cao cấp, thiết kế độc, lạ, cá tính hot trend 2020-2021",85000,85000,0,0
TIKI,tui-vi-nu,67211257,"Túi đeo chéo nữ để điện thoại TCHE1 phong cách trẻ trung, năng động tặng kèm 2 nút bảo vệ đầu sạc điện thoại",58410,79827,21417,27
TIKI,tui-vi-nu,184071608,"Túi xách nữ 1992 s t u d i o / LILY BAG /  màu đen kẹp nách",199000,199000,0,0
TIKI,tui-vi-nu,186204178,"Túi Xách Nữ Thời Trang Cao Cấp Elly EL128",979300,1399000,419700,30
TIKI,tui-vi-nu,209414471,"Túi đựng điện thoại kiêm ví đeo chéo hoa cúc TXNHC149",142000,142000,0,0
TIKI,tui-vi-nu,112049090,"Túi đeo chéo thời trang nữ mini đi chơi dự tiệc cao cấp, Túi xách nữ đẹp HT21",55000,55000,0,0
TIKI,tui-vi-nu,73613463,"Túi Vải Đeo Chéo Gấu Bông Hàn Quốc",31680,43296,11616,27
TIKI,tui-vi-nu,52658437,"Túi xách đeo vai nữ combo 2 thời trang KDR20",89100,121770,32670,27
TIKI,tui-vi-nu,160314132,"Ví Nữ Dài Cầm Tay Chính Hãng FOREVER YOUNG Thanh Lịch Sang Trọng Nhiều Ngăn Tiện Dụng FY10 - Micocah Mall",159000,159000,0,0
TIKI,tui-vi-nu,168794802,"1kg Túi PA hút chân không 10zem/15zem 2 mặt trơn",78000,78000,0,0
TIKI,tui-vi-nu,199520547,"Túi xách nữ silicon lụa phong cách Hàn Quốc",149000,149000,0,0
TIKI,tui-vi-nu,51288506,"Túi xách nữ công sở bản to",245000,245000,0,0
TIKI,tui-vi-nu,147942526,"Túi Xách Nữ Đeo Chéo MICOCAH Dáng Công Sở Thời Trang Vân Quả Trám Sang Trọng Thanh Lịch Da Cao Cấp Cực Đẹp MC61 - Tukado",429000,429000,0,0
TIKI,tui-vi-nu,32860122,"Túi Đeo Chéo Thời Trang Họa Tiết Sọc",271000,271000,0,0
TIKI,tui-vi-nu,157253905,"Móc Khóa Dọc In Báo SAIGON SWAGGER Journal Card Keychain",150000,150000,0,0
TIKI,tui-vi-nu,180720785,"Túi Xách Thời Trang Nữ Da Thật Cao Cấp Gence TX09",1600000,1600000,0,0
TIKI,tui-vi-nu,90432070," TÚI CÓI ĐI BIỂN MERCI SANG CHẢNH PHONG CÁCH HÀN QUỐC",39971,39971,0,0
TIKI,tui-vi-nu,195511701,"MLB - Túi bucket đeo chéo Basic Big Logo 3ABMS072N",3290000,3290000,0,0
TIKI,tui-vi-nu,52758151,"Túi TOTE Thiết Kế Thời Trang Hàn Quốc",89000,89000,0,0
TIKI,tui-vi-nu,151901545,"Túi Tote Vải Canvas Nữ Có Khóa Ulzzang Hot Trend Kita Unisex - Mẫu MÈO CUTE - Ảnh thật",69000,69000,0,0
TIKI,tui-vi-nu,152015159,"Túi Tote Túi Vải Canvas",99000,99000,0,0
TIKI,tui-vi-nu,252721792,"Túi Clutch dự tiệc sang chảnh quý phái tôn dáng nổi bật VDT02",250000,250000,0,0
TIKI,tui-vi-nu,194414981,"Túi Xách Lục Bình Thêu Hoa Sang Trọng Chuẩn Đẹp, Giỏ Cói Đi Biển, Túi Du Lịch TXLBTHDSLLTK02",419000,419000,0,0
TIKI,tui-vi-nu,79411724,"Túi đeo đựng điện thoại thời trang - màu ngẫu nhiên ( tặng móc khoa đa năng )",34155,46678,12523,27
TIKI,tui-vi-nu,248990332,"Dây kéo 2 chiều răng 5 (không kèm đầu khóa)",62000,62000,0,0
TIKI,tui-vi-nu,176681270,"Túi xách nữ bản to _ Túi nữ thời trang công sở đựng vừa A4",125000,125000,0,0
TIKI,tui-vi-nu,174468742,"Ví Nữ Ngắn Mini Cầm Tay TAILIAN Dáng Gập Nhỏ Gọn Nhiều Ngăn Tiện Dụng Da Đẹp Giá Rẻ TL01",99000,99000,0,0
TIKI,tui-vi-nu,174518731,"Ví đựng hộ chiếu Passport giấy tờ xe, thẻ thời trang chất liệu da bò cao cấp 40596",150000,150000,0,0
TIKI,tui-vi-nu,54029584,"Ví cầm tay nữ 2 ngăn kéo sang trọng , thiết kế nhiều ngăn tiện dụng TK0048",76000,100000,24000,24
TIKI,tui-vi-nu,186636029,"Túi Cói, Túi Xách Cỏ Bàng Vẽ Hoa Mỹ Nghệ Cao Cấp, Chuẩn Đẹp-TXCBVHGLTK05",329000,329000,0,0
TIKI,tui-vi-nu,209414547,"Ví nữ dài cầm tay hai ngăn phối màu VND100 tam thể hai khóa",112000,112000,0,0
TIKI,tui-vi-nu,31622709,"Túi đeo chéo 2 ngăn đựng điện thoại",150000,150000,0,0
TIKI,tui-vi-nu,177579514,"Ví nữ dài cầm tay chính hãng TAILIAN thời trang đựng tiền da cao cấp nhiều ngăn tiện dụng TL39",139000,139000,0,0
TIKI,tui-vi-nu,106867104,"Combo Túi Đựng Thẻ Trong Suốt Nhựa Dẻo Đa Năng",13860,18942,5082,27
TIKI,tui-vi-nu,165627374,"Túi đeo chéo nữ mini đựng điện thoại phong cách Hàn Quốc",99000,99000,0,0
TIKI,tui-vi-nu,31711116,"Túi đeo chéo đựng điện thoại thời trang + tặng vòng đeo tay",90000,90000,0,0
TIKI,tui-thoi-trang-nam,154207423,"Cặp Xách Nam Công Sở Gence Da Bò Thật CDT04",2000000,2000000,0,0
TIKI,tui-thoi-trang-nam,56404583,"Túi đeo chéo nam đa năng phong cách châu âu",159000,159000,0,0
TIKI,tui-thoi-trang-nam,56959406,"Túi da đeo chéo kẻ caro cực chất cho nam - Hàng cao cấp",106733,145869,39136,27
TIKI,tui-thoi-trang-nam,50260943,"Túi đeo ngực,đeo chéo nam phong cách châu âu hiện đại tích hợp sẵn công nghệ 4.0",531000,590000,59000,10
TIKI,tui-thoi-trang-nam,126765534,"Túi đeo chéo da cao cấp unisex nam nữ chống nước thời trang hot trend",57500,115000,57500,50
TIKI,tui-thoi-trang-nam,155339575,"Ví sen 3 da bò Pullup V122, bóp mini nam nhỏ gọn hai màu đen và nâu, đường chỉ may tinh tế, đựng thẻ kẹp tiền tiện lợi,fullbox, thương hiệu Bụi leather chuyên đồ da thật",140000,227000,87000,38
TIKI,tui-thoi-trang-nam,44014184,"Cặp Da Công Sở LATA CA21",690000,690000,0,0
TIKI,tui-thoi-trang-nam,126973701,"Túi đeo chéo nam BHL144 Da bò thật dập nổi vân da cá sấu",650000,650000,0,0
TIKI,tui-thoi-trang-nam,150877234,"Clutch, Ví Cầm Tay Thời Trang Nam Khóa Số Da Bò Mill Cao Cấp RB07 Đen, Nâu",1300000,1300000,0,0
TIKI,tui-thoi-trang-nam,108635756,"Túi xách nam công sở 100% da bò thật cao cấp phong cách mới",702000,780000,78000,10
TIKI,tui-thoi-trang-nam,50709932,"Cặp Da Công Sở Nam  P077",325000,325000,0,0
TIKI,tui-thoi-trang-nam,57939413,"Cặp da công sở LATA CA31",750000,750000,0,0
TIKI,tui-thoi-trang-nam,146366136,"Ví nam ngang mini BHM816 Mỏng gọn, Da bò thật, chống quét RFID",279720,279720,0,0
TIKI,tui-thoi-trang-nam,138543600,"Cặp da nam công sở TRITA TCA17",269000,440000,171000,39
TIKI,tui-thoi-trang-nam,81224272,"Túi Đeo Chéo Bao Tử Chống Nước FALDO",166000,166000,0,0
TIKI,tui-thoi-trang-nam,197864356,"Ví Đứng Nam Nhỏ Gọn, Da Bò SMALL PEBBLE Mềm Mại - Bền Bỉ, Size Trung, Chống Xước - Chống Nhăn Tốt, Thiết Kế Đơn Giản, Dáng Đứng - Gập 2, 3 Ngăn Lớn Đựng Tiền Và 8 Ngăn Nhỏ Để Thẻ ATM, Giấy Tờ Tùy Thân - Hàng Chính Hãng SAIGIO",983000,999000,16000,2
TIKI,tui-thoi-trang-nam,78954023,"Túi xách nam công sở 100% da bò thật cao cấp phong cách mới",900000,999000,99000,10
TIKI,tui-thoi-trang-nam,50422433,"Túi Đeo Chéo Nam Phong Cách Lịch Lãm P088",245000,245000,0,0
TIKI,tui-thoi-trang-nam,89786100,"Túi đeo chéo túi bao tử Sport Canvas unisex nhỏ gọn tiện dụng - Túi chéo TC70-D",56501,77218,20717,27
TIKI,tui-thoi-trang-nam,58472895,"Túi đeo chéo da nam LATA BALC24",360000,360000,0,0
TIKI,tui-thoi-trang-nam,66912745,"Cặp da công sở đựng Laptop 14 inch họa tiết ông già cao cấp",325000,325000,0,0
TIKI,tui-thoi-trang-nam,90469917,"Túi xách nam công sở da bò thật cao cấp ",900000,999000,99000,10
TIKI,tui-thoi-trang-nam,50490304,"Túi đeo ngực,đeo chéo nam đã tích hợp công nghệ 4.0",711000,790000,79000,10
TIKI,tui-thoi-trang-nam,157254039,"Túi Bao Tử Flexible SAIGON SWAGGER SGS Flexible Bumbag",360000,360000,0,0
TIKI,tui-thoi-trang-nam,32172674,"Túi xách da công sở nam có dây đeo chéo cao cấp chống thấm nước DH1803 - Nâu",329000,329000,0,0
TIKI,tui-thoi-trang-nam,193389984,"Túi Đeo Chéo Nam Nữ Thời Trang Trẻ Trung, Túi Đựng Ipad, Túi Đeo Vai Có Túi Bố Nhiều Ngăn Kéo Đựng Đồ Rất Tiện Lợi, Vải Oxford Chống Thấm Nước",135000,135000,0,0
TIKI,tui-thoi-trang-nam,125181251,"Ví da nam, bóp da nam Bụi Leather V110 - Da bò Pullup cao cấp - Bảo hành 12 tháng",209000,370000,161000,44
TIKI,tui-thoi-trang-nam,153021062,"Túi đeo chéo nam cao cấp phong cách HÀN QUỐC BEE GEE DCN9018A (Tặng quà tặng ngẫu nhiên trong BEEGEE GILF COLLECTION)",238000,480000,242000,50
TIKI,tui-thoi-trang-nam,241816882,"Bóp ví nam đựng thẻ tín dụng, GPLX, CCCD, Card,... có lẫy tự động tích hợp công nghệ chống trộm thông minh RFID",278000,278000,0,0
TIKI,tui-thoi-trang-nam,163574482,"Ví nam cao cấp CaecnKoen- Ví ngắn -Full hộp đựng cao cấp",650000,1300000,650000,50
TIKI,tui-thoi-trang-nam,58842555,"Túi Đeo Chéo, Đeo Ngang Dành Cho Nam Chất Da PU Cao Cấp Thời Trang Phong Cách",66330,95810,29480,31
TIKI,tui-thoi-trang-nam,105628957,"Túi xách nam công sở da thật chất lượng cao cấp phong cách mới",351000,390000,39000,10
TIKI,tui-thoi-trang-nam,125149562,"Ví nam, bóp nam da bò sáp Bụi Leather V108 - Bảo hành 12 tháng",209000,370000,161000,44
TIKI,tui-thoi-trang-nam,93145566,"Ví kẹp tiền cho nam leather carbon",585000,585000,0,0
TIKI,tui-thoi-trang-nam,135053359,"Túi đeo chéo đeo vai thời trang nam vải canvas hiệu Moyyi TDC005",324000,450000,126000,28
TIKI,tui-thoi-trang-nam,149521232,"{DA CÁ SẤU THẬT} Bóp Da Cá Sấu Nam Màu Đen Da Bụng - Ví Nam Da Cá Sấu Có Khoá Kéo Cao Cấp Dáng Ngang Thời Trang",890000,890000,0,0
TIKI,tui-thoi-trang-nam,149179677,"Ví cầm tay, bóp cầm tay, ví đựng thẻ card nam nữ thời trang da bò cao cấp 2 ngăn khóa BA04 KT:21x13x4cm (Nâu - Đen)",143550,207350,63800,31
TIKI,tui-thoi-trang-nam,143789937,"Combo ví Nam Thương hiệu Oscar - Muỗng xỏ giày Pierre",845000,1690000,845000,50
TIKI,tui-thoi-trang-nam,111868791,"Túi đeo chéo, đeo hông Arctic Hunter chất liệu Oxford chống nước - Y00020",335000,635000,300000,47
TIKI,tui-thoi-trang-nam,76748874,"Cặp Sakos Phối Da Legend 04",1924000,2189000,265000,12
TIKI,tui-vi-nu,173265012,"Túi ví phong bì da cừu Đồ Da Thành Long TLG 208236 + móc khóa la bàn cao cấp - không thể rẻ hơn",44400,57900,13500,23
TIKI,tui-vi-nu,188903502,"Túi vải Creamy Bag - May’s Tote Bag",260000,260000,0,0
TIKI,tui-vi-nu,109092368,"Túi xách nữ đeo vai cao cấp đẹp giá rẻ thời trang",69000,69000,0,0
TIKI,tui-vi-nu,252680473,"Túi đeo chéo nam nữ thời trang unisex vải canvas đi học đi chơi",120000,120000,0,0
TIKI,tui-vi-nu,172191595,"XẢ HÀNG GIÁ SỐC - Túi đeo chéo phong cách Hàn Quốc Đồ Da Thành Long TLG 208093-1(nâu nhạt)",40000,40000,0,0
TIKI,tui-vi-nu,270501664,"Ví mini đựng thẻ, ví đựng tiền xu Sora khóa kéo L - Pink Ohara Leather",470000,470000,0,0
TIKI,tui-vi-nu,67621651,"Túi xách nữ thời trang cao cấp",340000,340000,0,0
TIKI,tui-vi-nu,98868697,"10 túi ví mini kiêm móc khoá da đẹp đủ màu",50000,50000,0,0
TIKI,tui-vi-nu,110943984,"Túi cói Merci phong cách Vintage, Túi cói Merci đi du lịch siêu sang hàng loại 1- MIN24",43000,54900,11900,22
TIKI,tui-vi-nu,174468911,"Ví Nữ Ngắn Mini Cầm Tay Chính Hãng TAILIAN Gấp 2 Nhỏ Gọn Phong Cách Hàn Quốc Da Cao Cấp Giá Rẻ TL09",99000,99000,0,0
TIKI,tui-vi-nu,91421012,"Ví ngắn corgi",127000,127000,0,0
TIKI,tui-vi-nu,136940086,"TÚI VẢI THỔ CẨM ( CON CÚ ĐỎ )",40000,40000,0,0
TIKI,tui-vi-nu,109092312,"Túi xách nữ da mềm  Túi đeo chéo mini hàng quảng châu siêu hot QC007",129000,129000,0,0
TIKI,tui-vi-nu,107526256,"Túi vải tặng",99000,99000,0,0
TIKI,tui-vi-nu,143321975,"HJ6463-64-65-66 - Túi xách nữ da đà điểu cỡ nhỏ màu đen, nâu đất, vàng bò, nâu đỏ",4899000,4899000,0,0
TIKI,tui-vi-nu,136355257,"Ví mini mèo xinh vải canvas đẹp bền",35000,35000,0,0
TIKI,tui-vi-nu,21462685,"Túi bucket đan dây handmade ",169000,169000,0,0
TIKI,tui-vi-nu,209414522,"Ví mini nữ nhỏ da mềm cầm tay đựng thẻ tiền tiện dụng xinh xắn",72000,72000,0,0
TIKI,tui-vi-nu,37967345,"Ví Nữ Mini Forever Young Thời Trang VN004",54500,54500,0,0
TIKI,tui-vi-nu,178592711,"Túi Cói, Túi Xách Lá Buông Đan Thủ Công Mỹ Nghệ Cao Cấp, Chuẩn Đẹp",289000,289000,0,0
TIKI,tui-vi-nu,248990307,"Dây kéo YKK Thái 1 chiều răng 3",52000,52000,0,0
TIKI,tui-vi-nu,183041977,"Ví cầm tay da Nam nữ Thời Trang",89000,89000,0,0
TIKI,tui-vi-nu,149449271,"Túi xách nữ - túi đeo chéo cầm tay da PU da mềm , kiểu dáng Hàn Quốc nhỏ gọn giá rẻ",195000,195000,0,0
TIKI,tui-vi-nu,91196032,"TÚI CHÉO ULZZANG GẤU HOT",145000,145000,0,0
TIKI,tui-vi-nu,210414112,"Túi xách nữ đẹp giá rẻ công sở thời trang cao cấp LH47",1750000,1750000,0,0
TIKI,tui-vi-nu,75299455,"Túi da nhỏ chần chéo",559000,559000,0,0
TIKI,tui-vi-nu,84448218,"Túi Tote basic Túi vải bố vải canvas xinh đẹp sử dụng để đồ cá nhân, quảng cáo,in LOGO quà tặng",25000,25000,0,0
TIKI,tui-vi-nu,152015148,"Túi Vải Túi Đeo Chéo Dây Thổ Cẩm",75000,75000,0,0
TIKI,tui-vi-nu,196009391,"Túi Cói, Túi Xách Cỏ Bàng Vẽ Mỹ Nghệ Cao Cấp, Chuẩn Đẹp-Túi Tote TXCBVXDLTK04",329000,329000,0,0
TIKI,tui-vi-nu,40913478,"Ví nữ đựng card da bò cao cấp Gianni Conti VP0154ARA",550000,550000,0,0
TIKI,tui-vi-nu,272362754,"ảnh video thật️ Túi xách nữ mèo mun đáng yêu BC515",499000,499000,0,0
TIKI,tui-vi-nu,72785498,"Túi kẹp nách nữ dây xích, túi đeo chéo nữ da vân cá sấu TX41 trẻ trung hiện đại",55000,55000,0,0
TIKI,tui-vi-nu,108075826,"Túi đeo chéo nam , đựng điện thoại ví...",300000,300000,0,0
TIKI,tui-vi-nu,161533284,"Túi xách đeo chéo mini nữ khoá bấm mạ vàng sang trọng GOMIA TDC168",99000,99000,0,0
TIKI,tui-vi-nu,196409539,"Túi Xách Nữ Kẹp Nách Dây Xích Dây Da Đeo Chéo FLORA BAG Thương Hiệu GIPSY",695000,695000,0,0
TIKI,tui-vi-nu,158851978,"Túi đeo chéo, Đeo vai nữ thời trang Boss cực xinh",69000,69000,0,0
TIKI,tui-vi-nu,149432555,"Túi xách, túi đeo chéo nữ thời trang T20",140000,140000,0,0
TIKI,tui-vi-nu,160907349,"Túi Xách Nữ Thời Trang Công Sở Có Dây Đeo Chéo MQ129",75000,75000,0,0
TIKI,tui-vi-nu,57859819,"TÚI ĐEO CHÉO DA NỮ PHỐI MÀU THỜI TRANG MADT119",90000,90000,0,0
TIKI,tui-vi-nu,125100431,"Bóp nữ da trơn size lớn ( xanh dương)",129000,129000,0,0
TIKI,tui-vi-nu,205081399,"Túi xách nữ công sở đeo chéo kẹp nách đeo vai tote da thời trang cao cấp MX078",789000,789000,0,0
TIKI,tui-vi-nu,100000538,"Túi xách nữ da mểm cao cấp",380000,380000,0,0
TIKI,tui-vi-nu,203913255,"Túi Xách Nữ Đeo Chéo Đeo Vai Quảng Châu Cao Cấp Đi Học Đi Chơi Siêu Xinh TUVIDA_VN TX18 Túi Tote",183750,183750,0,0
TIKI,tui-vi-nu,177859868,"túi đeo chéo nữ,túi đeo vai thời trang phong cách đơn giản dễ phối đồ phù hợp với mọi lứa tuổi (hình ảnh shop tự chụp cam kết 100%)",167000,167000,0,0
TIKI,tui-vi-nu,193720405,"VÍ CẦM TAY NAM HỌA TIẾT DA CÁ SẤU",450000,450000,0,0
TIKI,tui-vi-nu,249457427,"Túi Xách Nữ Đựng Vừa A4 Thanh Lịch Sang Trọng ZTX04",169000,315000,146000,46
TIKI,tui-vi-nu,200671780,"TÚI XÁCH DA NỮ ĐEO VAI KHÓA KÉO LIBERAL YLYN134",200000,200000,0,0
TIKI,tui-vi-nu,173169248,"Túi Cói, Túi Cói Đi Biển, Giỏ Cói, Giỏ Lục Bình Quai Mây Sang Trọng-Thủ Công Mỹ Nghệ Cao Cấp",295000,295000,0,0
TIKI,tui-vi-nu,57173375,"Ví đựng thẻ thời trang cao cấp CL-022",99000,99000,0,0
TIKI,tui-vi-nu,35346241,"Clutch tiệc cầm tay phong cách sao Hàn",230000,230000,0,0
TIKI,tui-vi-nu,22670247," Túi móc treo",369000,369000,0,0
TIKI,tui-vi-nu,118026376,"TÚI ĐI CHÙA # Giỏ Xách Adi # Bị # Túi Vải",30000,30000,0,0
TIKI,tui-vi-nu,16018257,"Ví da bò Vinalea VUN0006E",155000,155000,0,0
TIKI,tui-vi-nu,56402731,"túi chim cánh cụt",110000,110000,0,0
TIKI,voucher-dich-vu,37652811,"Túi vải đay HELLO WEEKEND",269000,269000,0,0
TIKI,voucher-dich-vu,184918441,"Túi xách nữ thời trang công sở cao cấp phong cách mới – TN1008",210000,420000,210000,50
TIKI,tui-vi-nu,206651826,"Ví Đựng Thẻ Card Holder Nam Nữ Songhan Leather WL01.Ví MiNi Da Bò Thật Cao Cấp Nhỏ Gọn Gập Đôi Nhiều Ngăn Thời Trang",259000,259000,0,0
TIKI,voucher-dich-vu,90163531,"Túi Vải Canvas Đeo Chéo Nhật Bản ️ HOTTREND ️ Túi đeo chéo kẻ caro mini nữ thời trang tặng sticker TN76",69000,69000,0,0
TIKI,tui-vi-nu,71486903,"Túi kẹp nách nữ thời trang sọc Caro trẻ trung, hợp xu hướng TK0062",50000,100000,50000,50
TIKI,tui-vi-nu,117294101,"Túi xách,đeo vai bằng vải viền da phong cách Ulzzang 2 trong 1 có 3 màu xinh yêu ( hàng có sẵn)",115000,115000,0,0
TIKI,tui-vi-nu,16052918,"Ví da bò Unisex Vinalea VUN0003E",155000,155000,0,0
TIKI,tui-vi-nu,193720488,"VÍ CẦM TAY THIẾT KẾ SANG TRỌNG",350000,350000,0,0
TIKI,voucher-dich-vu,70906430,"Túi cói xách tay kiểu dáng vintage",189000,189000,0,0
TIKI,tui-vi-nu,193051873,"Ví Nữ Mini Ngắn Cầm Tay Cao Cấp Sang Trọng Phong Cách Hàn Quốc TVNN135",250000,250000,0,0
TIKI,voucher-dich-vu,104944481,"Túi đeo chéo đi học, đi làm, đi chơi thời trang dành cho nữ TUI005",113050,119000,5950,5
TIKI,voucher-dich-vu,177594039,"Ví đựng hộ chiếu Passport giấy tờ xe, thẻ thời trang chất liệu da bò cao cấp 40596",177651,177651,0,0
TIKI,voucher-dich-vu,11186154,"Túi đeo vai ANELLO đeo 2 kiểu vải polyester chịu nhiệt cỡ nhỏ AT-C1839 - Màu",1840000,1840000,0,0
TIKI,voucher-dich-vu,125100701,"Ví Cầm Tay Kim Tuyến Đi Tiệc chodeal24h.com (Vàng gold)",59000,59000,0,0
TIKI,voucher-dich-vu,136940137,"TÚI THỔ CẨM ĐEO CHÉO ĐỰNG ĐIỆN THOẠI",15000,15000,0,0
TIKI,voucher-dich-vu,112210007,"Túi đeo chéo nữ công sở cao cấp họa tiết sang trọng nhiều ngăn tặng kèm móc gấu",159000,159000,0,0
TIKI,tui-vi-nu,185927313,"[ Hàng cao cấp]- Túi cói đeo vai túi tote cói phong cách vintage",280000,280000,0,0
TIKI,voucher-dich-vu,13090538,"Túi đựng điện thoại 2 dây đeo đẹp cho bạn gái",59000,59000,0,0
TIKI,tui-vi-nu,172977126,"Túi vải bố, Túi vải Canvas trơn Màu Trắng - Màu Đen Màu Be Size 36cm x 31cm",25000,25000,0,0
TIKI,voucher-dich-vu,86560782,"Túi đeo chéo    Túi vải mini tai thỏ siêu dễ thương thiết kế Hàn Quốc TV05",52000,52000,0,0
TIKI,voucher-dich-vu,250692203,"Túi Tote Vải Canvas Có Khóa Phong Cách Hàn Quốc",90160,90160,0,0
TIKI,voucher-dich-vu,74463160,"Ví Đựng Thời Trang Tiện Ich HARAS V268",35000,35000,0,0
TIKI,voucher-dich-vu,107962577,"Ví Đựng Thẻ/ Ví Da Mini Handmade Đựng Tiền Sành Điệu Sang Chảnh",99000,99000,0,0
TIKI,tui-vi-nu,73341059,"TÚI NHỎ ĐEO CHÉO Mini Tiện Lợi SQUARE Vải Canvas Cao Cấp Chống Thấm Nước Unisex Nam Nữ Chuẩn Nome DOLANTO",98000,98000,0,0
TIKI,voucher-dich-vu,128291458,"Phụ kiện hoạt hình gắn túi , balo",6000,6000,0,0
TIKI,voucher-dich-vu,209414012,"Túi xách nữ thời trang hottrend siêu xinh đeo chéo ngang nhiều màu tôn dáng giá rẻ",181000,181000,0,0
TIKI,voucher-dich-vu,8114416,"Túi Xách Nữ Cao Cấp Da Thật Elly ET79",1689350,2599000,909650,35
TIKI,tui-vi-nu,160314163,"Ví Nữ Mini Cầm Tay PERFECT FOR YOU Gấp 3 Nhỏ Gọn Nhiều Ngăn Tiện Dụng Chất Da Cao Cấp Cực Đẹp PFY11 - Micocah Mall",129000,129000,0,0
TIKI,voucher-dich-vu,77548527,"Túi Đeo chéo nữ gấu thời trang cho bé hình chuột GG01 Tặng móc khóa thỏ trắng",58410,79827,21417,27
TIKI,tui-vi-nu,199681840,"Money Clip Wallet - Ví kẹp tiền da nam đựng thẻ Carbon RFID tối đa đến 15 thẻ",290000,290000,0,0
TIKI,tui-vi-nu,67096510,"Túi đeo chéo thêu thời trang nữ - Hoa Cúc",250000,250000,0,0
TIKI,voucher-dich-vu,114358110,"Túi xách túi đeo chéo nữ khóa dây da dây xích phối đẹp mắt",75000,75000,0,0
TIKI,voucher-dich-vu,157479189,"ví bóp nữ cầm tay nhiều ngăn dáng dài sang trọng đi tiệc cưới - PL9283",138000,259000,121000,47
TIKI,tui-vi-nu,186232554,"Túi xách nữ Pu Cao Cấp Handle Bag kiểu dáng cổ điển đơn giản thời trang có thể đeo chéo hoặc xách tayTúi đeo vai - Bảo hành 1 năm",456000,456000,0,0
TIKI,voucher-dich-vu,188385295,"Túi xách nữ Da Bò 100% Cao Câp  Vừa Túi đeo chéo, Cầm Tay - Thời trang Nhật Bản và Hàn Quốc kết hợp sản xuất ",756000,756000,0,0
TIKI,voucher-dich-vu,174399995,"Túi Đeo Chéo Nữ Đựng Điện Thọai FOREVER YOUNG Dáng Vuông Nhiều Ngăn Đựng Chất Bền Đẹp FY15",249000,249000,0,0
TIKI,voucher-dich-vu,149764208,"Túi xách nữ đeo chéo họa tiết hoa văn độc đáo thời trang cao cấp phong cách Hàn Quốc",139000,139000,0,0
TIKI,voucher-dich-vu,247745940,"Túi Xách Nữ ️️ Túi Nữ Da Mềm Luxury thời trang, phong cách trẻ trung mã số LXRBB0012",79000,79000,0,0
TIKI,tui-vi-nu,149449628,"Túi đeo chéo - Túi xách nữ kiểu dáng yên ngựa chất mềm hai dây đeo bản to thời trang",243000,243000,0,0
TIKI,tui-vi-nu,125100629,"Ví cầm tay ngắn Sang trọng CDVN01 (đen)",189000,189000,0,0
TIKI,tui-vi-nu,101861404,"Túi Cói Đi Biển, Túi Xách Cấm Tay Đi Chơi, Đi Picnic Xinh Xắn - Mã TUI27",49000,49000,0,0
TIKI,voucher-dich-vu,158720856,"Túi đeo chéo da nữ thời trang Hàn Quốc DT135TI",99000,99000,0,0
TIKI,tui-vi-nu,157253910,"Ví Nắp Da In SAIGON SWAGGER Eclipse Short Flap Wallet",480000,480000,0,0
TIKI,voucher-dich-vu,52890054,"Ví Nữ Ngắn Thời Trang Cao Cấp HNN20-Tặng Kèm 01 Sản Phẩm Ngẫu Nhiên",99000,99000,0,0
TIKI,tui-vi-nu,116776144,"Túi xách vali thời trang nhỏ gọn đựng được nhiều đồ",170000,170000,0,0
TIKI,tui-vi-nu,271474405,"TÚI CANVAS GẤU TRÚC HOA HOA - HUAHUA PANDA",59000,59000,0,0
TIKI,voucher-dich-vu,152951458,"Túi Cói, Túi Trụ Hoa và Túi Trụ Lủng Lẳng",265000,265000,0,0
TIKI,tui-vi-nu,88085617,"Túi xách nữ ,Túi đeo vai nữ da vân cao cấp khóa cúc nổi bật sang trọng và thời thượng",75000,75000,0,0
TIKI,voucher-dich-vu,182805698,"Túi xách nữ Monogram Canvas ELLY – EL198",1799000,1799000,0,0
TIKI,voucher-dich-vu,209414357,"Ví bóp nữ cầm tay da trơn mềm xinh xắn dễ phối đồ cobala ví túi xinh",141000,141000,0,0
TIKI,voucher-dich-vu,42125853,"Túi đeo nữ mini H0001",39000,70000,31000,44
TIKI,tui-vi-nu,187852573,"Túi xách nữ dễ thương NASI T1045 vải cói pu cầm tay đẹp túi tote đeo vai có nút bấm thời trang cho nữ công sở, học sinh",38000,44900,6900,15
TIKI,voucher-dich-vu,157254351,"Ví Đựng Thẻ Card Holder SAIGON SWAGGER Journal Zip Card Case",230000,230000,0,0
TIKI,voucher-dich-vu,194456982,"Túi đựng tiền, túi đựng đồ mini phong cách Châu Âu mã 1042 - ĐEN	Túi đựng tiền, túi đựng đồ mini phong cách Châu Âu mã 1042",179000,329000,150000,46
TIKI,tui-vi-nu,89220547,"Ví nữ nhỏ nhiều ngăn cầm tay mini gấp 3 thời trang cute dễ thương giá rẻ LUKAMO VD70",31000,31000,0,0
TIKI,voucher-dich-vu,57100783,"Túi xách nữ kiểu dáng trẻ trung SW48",149000,149000,0,0
TIKI,tui-vi-nu,164961179,"Túi đeo chéo, đeo vai nữ mini da cao cấp T0229 Khóa gài chống thấm nước, bền bỉ phong cách thời trang Hàn",130000,260000,130000,50
TIKI,tui-vi-nu,150992317,"Bóp ví nữ cầm tay mini V0514 Hi Cow bỏ túi nhiều ngăn nhỏ gọn phong cách đơn giản, thời trang, dễ thương",25000,50000,25000,50
TIKI,tui-vi-nu,58796191,"Ví đựng tiền xu mini cho bé hình thú - Giao hình ngẫu nhiên",90000,90000,0,0
TIKI,tui-vi-nu,183736392,"1.	Túi xách nữ đẹp FA FTX1",550000,550000,0,0
TIKI,voucher-dich-vu,248990778,"Dây kéo 1 chiều răng 5 (không kèm đầu khóa)",40000,40000,0,0
TIKI,voucher-dich-vu,191995263,"Vỏ bao hộ chiếu (passport) dẻo trong có khe đựng vé máy bay và các thoại thẻ hiệu bamarau B132",2999,2999,0,0
TIKI,voucher-dich-vu,169354370,"Clutch nhung đính đá tua rua cao cấp-túi nhung đá đi tiệc siêu sang",320000,320000,0,0
TIKI,voucher-dich-vu,183243463,"Túi Tote canvas - Hoa ghi - thêu tay thủ công, nữ tính, gọn nhẹ",325000,325000,0,0
TIKI,voucher-dich-vu,44148141,"Túi Vải Tote Canvas Cao Cấp, Dày Dặn Hình Hoa Cúc Họa Mi, Phong Cách Basic",88900,88900,0,0
TIKI,voucher-dich-vu,113039984,"Túi đeo chéo nữ công sở dạo phố thời trang cao cấp",99000,99000,0,0
TIKI,tui-vi-nu,86560782,"Túi đeo chéo    Túi vải mini tai thỏ siêu dễ thương thiết kế Hàn Quốc TV05",52000,52000,0,0
TIKI,tui-vi-nu,250692203,"Túi Tote Vải Canvas Có Khóa Phong Cách Hàn Quốc",90160,90160,0,0
TIKI,tui-vi-nu,157254351,"Ví Đựng Thẻ Card Holder SAIGON SWAGGER Journal Zip Card Case",230000,230000,0,0
TIKI,tui-vi-nu,37652811,"Túi vải đay HELLO WEEKEND",269000,269000,0,0
TIKI,tui-vi-nu,184918441,"Túi xách nữ thời trang công sở cao cấp phong cách mới – TN1008",210000,420000,210000,50
TIKI,tui-vi-nu,57100783,"Túi xách nữ kiểu dáng trẻ trung SW48",149000,149000,0,0
TIKI,tui-vi-nu,74463160,"Ví Đựng Thời Trang Tiện Ich HARAS V268",35000,35000,0,0
TIKI,tui-vi-nu,182805698,"Túi xách nữ Monogram Canvas ELLY – EL198",1799000,1799000,0,0
TIKI,tui-vi-nu,104944481,"Túi đeo chéo đi học, đi làm, đi chơi thời trang dành cho nữ TUI005",113050,119000,5950,5
TIKI,tui-vi-nu,136940137,"TÚI THỔ CẨM ĐEO CHÉO ĐỰNG ĐIỆN THOẠI",15000,15000,0,0
TIKI,tui-vi-nu,128291458,"Phụ kiện hoạt hình gắn túi , balo",6000,6000,0,0
TIKI,tui-vi-nu,42125853,"Túi đeo nữ mini H0001",39000,70000,31000,44
TIKI,tui-vi-nu,77548527,"Túi Đeo chéo nữ gấu thời trang cho bé hình chuột GG01 Tặng móc khóa thỏ trắng",58410,79827,21417,27
TIKI,tui-vi-nu,157479189,"ví bóp nữ cầm tay nhiều ngăn dáng dài sang trọng đi tiệc cưới - PL9283",138000,259000,121000,47
TIKI,tui-vi-nu,191995263,"Vỏ bao hộ chiếu (passport) dẻo trong có khe đựng vé máy bay và các thoại thẻ hiệu bamarau B132",2999,2999,0,0
TIKI,tui-vi-nu,194456982,"Túi đựng tiền, túi đựng đồ mini phong cách Châu Âu mã 1042 - ĐEN	Túi đựng tiền, túi đựng đồ mini phong cách Châu Âu mã 1042",179000,329000,150000,46
TIKI,tui-vi-nu,247745940,"Túi Xách Nữ ️️ Túi Nữ Da Mềm Luxury thời trang, phong cách trẻ trung mã số LXRBB0012",79000,79000,0,0
TIKI,tui-vi-nu,90163531,"Túi Vải Canvas Đeo Chéo Nhật Bản ️ HOTTREND ️ Túi đeo chéo kẻ caro mini nữ thời trang tặng sticker TN76",69000,69000,0,0
TIKI,tui-vi-nu,107962577,"Ví Đựng Thẻ/ Ví Da Mini Handmade Đựng Tiền Sành Điệu Sang Chảnh",99000,99000,0,0
TIKI,tui-vi-nu,169354370,"Clutch nhung đính đá tua rua cao cấp-túi nhung đá đi tiệc siêu sang",320000,320000,0,0
TIKI,tui-vi-nu,13090538,"Túi đựng điện thoại 2 dây đeo đẹp cho bạn gái",59000,59000,0,0
TIKI,tui-vi-nu,209414012,"Túi xách nữ thời trang hottrend siêu xinh đeo chéo ngang nhiều màu tôn dáng giá rẻ",181000,181000,0,0
TIKI,tui-vi-nu,177594039,"Ví đựng hộ chiếu Passport giấy tờ xe, thẻ thời trang chất liệu da bò cao cấp 40596",177651,177651,0,0
TIKI,tui-vi-nu,8114416,"Túi Xách Nữ Cao Cấp Da Thật Elly ET79",1689350,2599000,909650,35
TIKI,tui-vi-nu,70906430,"Túi cói xách tay kiểu dáng vintage",189000,189000,0,0
TIKI,tui-vi-nu,152951458,"Túi Cói, Túi Trụ Hoa và Túi Trụ Lủng Lẳng",265000,265000,0,0
TIKI,tui-vi-nu,149764208,"Túi xách nữ đeo chéo họa tiết hoa văn độc đáo thời trang cao cấp phong cách Hàn Quốc",139000,139000,0,0
TIKI,tui-vi-nu,174399995,"Túi Đeo Chéo Nữ Đựng Điện Thọai FOREVER YOUNG Dáng Vuông Nhiều Ngăn Đựng Chất Bền Đẹp FY15",249000,249000,0,0
TIKI,tui-vi-nu,183243463,"Túi Tote canvas - Hoa ghi - thêu tay thủ công, nữ tính, gọn nhẹ",325000,325000,0,0
TIKI,tui-vi-nu,209414357,"Ví bóp nữ cầm tay da trơn mềm xinh xắn dễ phối đồ cobala ví túi xinh",141000,141000,0,0
TIKI,tui-vi-nu,158720856,"Túi đeo chéo da nữ thời trang Hàn Quốc DT135TI",99000,99000,0,0
TIKI,tui-vi-nu,44148141,"Túi Vải Tote Canvas Cao Cấp, Dày Dặn Hình Hoa Cúc Họa Mi, Phong Cách Basic",88900,88900,0,0
TIKI,tui-vi-nu,113039984,"Túi đeo chéo nữ công sở dạo phố thời trang cao cấp",99000,99000,0,0
TIKI,tui-vi-nu,248990778,"Dây kéo 1 chiều răng 5 (không kèm đầu khóa)",40000,40000,0,0
TIKI,tui-vi-nu,114358110,"Túi xách túi đeo chéo nữ khóa dây da dây xích phối đẹp mắt",75000,75000,0,0
TIKI,tui-vi-nu,112210007,"Túi đeo chéo nữ công sở cao cấp họa tiết sang trọng nhiều ngăn tặng kèm móc gấu",159000,159000,0,0
TIKI,tui-vi-nu,125100701,"Ví Cầm Tay Kim Tuyến Đi Tiệc chodeal24h.com (Vàng gold)",59000,59000,0,0
TIKI,tui-vi-nu,188385295,"Túi xách nữ Da Bò 100% Cao Câp  Vừa Túi đeo chéo, Cầm Tay - Thời trang Nhật Bản và Hàn Quốc kết hợp sản xuất ",756000,756000,0,0
TIKI,tui-vi-nu,11186154,"Túi đeo vai ANELLO đeo 2 kiểu vải polyester chịu nhiệt cỡ nhỏ AT-C1839 - Màu",1840000,1840000,0,0
TIKI,tui-vi-nu,52890054,"Ví Nữ Ngắn Thời Trang Cao Cấp HNN20-Tặng Kèm 01 Sản Phẩm Ngẫu Nhiên",99000,99000,0,0
TIKI,tui-vi-nu,110723636," VÍ DA CẦM TAY NỮ VÍ DA CẦM TAY NAM",118000,169000,51000,30
TIKI,tui-vi-nu,159725474,"Túi xách đa năng May 10 (giao màu ngẫu nhiên)",35000,35000,0,0
TIKI,tui-vi-nu,135545812,"Túi đeo chéo mini Fimax vài cao cấp chống thấm nước - túi đeo nữ thời trang vải cao cấp phong cách Hàn Quốc",119000,119000,0,0
TIKI,tui-vi-nu,173167924,"Túi vải bố, Túi vải Canvas trơn Màu Trắng - Màu Đen không khóa kéo",19000,19000,0,0
TIKI,tui-vi-nu,162373758,"Túi Vải Bố Canvas Tote Trơn Grepaco Không In Màu Trắng Dạng Quai Xách Đeo Vai Có Ngăn Phụ Bên Trong Dùng Đi Học Dạy Vẻ Cho Sinh Viên Học Sinh",46000,49000,3000,6
TIKI,tui-vi-nu,152446331,"Túi xách nữ đeo chéo da mềm thời trang phong cách Hàn Quốc",99000,99000,0,0
TIKI,tui-vi-nu,160314876,"Túi Xách Đeo Chéo Nữ Kẹp Nách Chính Hãng MICOCAH Dáng Công Sở Thời Trang Da Cao Cấp Cực Đẹp MC63",369000,369000,0,0
TIKI,tui-vi-nu,137154030,"Túi Tote Canvas Đeo Chéo Nữ Đi Học Mèo My World Phong Cách Ulzzang",59000,59000,0,0
TIKI,tui-vi-nu,187642699,"Túi Cói Merci Siêu Hot Hit ! đi biển,đi chợ,đi chơi",38000,38000,0,0
TIKI,tui-vi-nu,16882460,"Vỏ Bọc Hộ Chiếu Có Khe Nhét Thẻ Tiện Dụng",2999,2999,0,0
TIKI,tui-vi-nu,55022823,"Túi xách nữ đeo chéo hàn quốc đẹp cao cấp Vimona TX20 in vân chìm sang chảnh",128000,128000,0,0
TIKI,tui-vi-nu,42729783,"Túi clutch nữ thời trang cao cấp ELLY – ECH31",999000,999000,0,0
TIKI,tui-vi-nu,188503686,"Túi đeo chéo nữ vải dù trần trám, nhiều ngăn chống nước, phong cách Hàn Quốc Size 22cm TUI-58",139000,139000,0,0
TIKI,tui-vi-nu,192033898,"Túi peekoo xanh tiện lợi",49000,49000,0,0
TIKI,tui-vi-nu,172977144,"Túi vải bố, Túi vải Canvas trơn Màu Be - Màu Đen không khóa kéo",19000,19000,0,0
TIKI,tui-vi-nu,54430952,"Túi xách nữ cao cấp phong cách châu âu hiện đại mới",275000,275000,0,0
TIKI,tui-vi-nu,90113077,"Túi Cói Merci Siêu Tiện Dụng Siêu HÓT HÍT Túi đi biển",54999,54999,0,0
TIKI,tui-vi-nu,84229853,"Túi xách nữ thêu hoa túi xách công sở thanh lịch sang trọng phong cách Hàn Quốc",219000,219000,0,0
TIKI,tui-vi-nu,68527197,"Túi xách tote vải Túi Tote Túi Vải Nữ Túi Đeo Chéo Hàn Quốc ",51300,51300,0,0
TIKI,tui-vi-nu,158815530,"Ví cầm tay nữ nắp gập cách điệu YUUMY Seasand YV55",165000,330000,165000,50
TIKI,tui-vi-nu,150147404,"Dầu Bôi Ấm Ngực Vicks Baby Balsam Chống Cảm Cho Bé",175000,250000,75000,30
TIKI,tui-vi-nu,96311978,"Túi Cói Xách Tay Thời Trang Đi Biển 2 Lớp Quai Vải Phong Cách Vintage - Mã XT026",43000,47900,4900,10
TIKI,tui-vi-nu,45268061,"Dây Túi đeo chéo da pu kết hợp với dây vải xì teen, dây đeo vai có thể điều chỉnh  có thể điều chỉnh",120000,120000,0,0
TIKI,tui-vi-nu,56531143,"Ví nữ cầm tay gấp đôi nhỏ gọn, phối màu dễ thương TK0052",35000,70000,35000,50
TIKI,tui-vi-nu,86560842,"Ví bóp nữ   Ví nữ cầm tay ngắn mini cao cấp nhiều ngăn giá rẻ V042301",32000,32000,0,0
TIKI,tui-vi-nu,58230324,"Túi bao tử nữ đeo chéo trước ngực, đeo hông",53460,73062,19602,27
TIKI,tui-vi-nu,114568388,"Túi cói Merci thời trang đi biển - dạo phố - đi làm",41890,41890,0,0
TIKI,tui-vi-nu,176267743,"Túi đeo chéo nữ nắp phong thư Yuumy seasand YN97",299000,570000,271000,48
TIKI,tui-vi-nu,72210939,"Móc khóa thời trang YUUMY YMK5 - Màu sắc trẻ trung - Thiết kế hiện đại - Đa chức năng sử dụng - Đựng thẻ ngân hàng, thẻ xe, chìa khóa xe - Tiên dụng mang theo bên người (Dài 7cm x Cao 10.5cm)",29000,50000,21000,42
TIKI,tui-vi-nu,102399926,"Túi xách đeo chéo nữ nhỏ dạo phố xinh xắn MN105",99000,99000,0,0
TIKI,tui-vi-nu,162024663,"Túi xách nữ thời trang công sở cao cấp phong cách mới",404000,448200,44200,10
TIKI,tui-vi-nu,76181891,"Ví nữ cầm tay 2 ngăn kéo cao cấp, thiết kế độc đáo đẹp mắt, nhiều ngăn tiện dụng TK0073",69000,100000,31000,31
TIKI,tui-vi-nu,134947145,"Túi Xách Cói Dây Da Đi Biển YUUMY YTX16",155000,290000,135000,47
TIKI,tui-vi-nu,114411570,"Móc khóa thời trang LATA MK6",95000,150000,55000,37
TIKI,tui-vi-nu,117084931,"Túi xách đeo chéo nữ tặng dây chuyền ngọc trai dạo phố",159000,159000,0,0
TIKI,tui-vi-nu,66654552,"dây xích kim loại, quai túi xách, dây túi 2 loại ngắn40cm và dài 120cm",33000,33000,0,0
TIKI,tui-vi-nu,107614755,"Túi vải bố, Túi vải Canvas trơn Màu Trắng - Màu Đen không khóa kéo",19000,19000,0,0
TIKI,tui-vi-nu,109631859,"Ví dự tiệc cưới, sự kiện, kiểu dáng trong suốt, có nút gài kim loại, ví dự tiệc sang trọng, đẳng cấp",270000,450000,180000,40
TIKI,tui-vi-nu,189832277,"Túi xách túi đeo vai nữ mini , có quai cầm ngọc  trai ,da bóng đẹp  xinh xắn đáng yêu cho phái nữ dạo phố",39000,39000,0,0
TIKI,tui-vi-nu,132053956,"Túi xách nữ sang chảnh 4 màu hộp vuông túi nữ có dây đeo chéo dáng hàn quốc size 20",125000,125000,0,0
TIKI,tui-vi-nu,107037353,"Túi Đi Chùa # Đãi Nhỏ Lớn Đủ Size, Đủ Màu",84000,84000,0,0
TIKI,tui-vi-nu,109343837,"Ví thời trang Teen ZAKOMI hình mèo vải cao cấp chống nước ZVIMEO - Bảo hành 12 tháng",200000,200000,0,0
TIKI,tui-vi-nu,176245722,"Túi đeo chéo nữ, túi đeo chéo thời trang cho nàng, chất liệu da PU cao cấp cực bền dáng",239000,239000,0,0
TIKI,tui-vi-nu,187143312,"Túi đeo chéo NASI T1031 phong cách hàn quốc túi xách nữ đeo vai thời trang dạo phố dễ thương vải đẹp",49000,49000,0,0
TIKI,tui-vi-nu,120524879,"Ví nữ da đà điểu Huy Hoàng 1 khóa thụt màu đen HC3462",2199000,2199000,0,0
TIKI,tui-vi-nu,157146729,"(Chất Đẹp) Ví Da Đựng Giấy Tờ Theo Hãng Xe",30000,30000,0,0
TIKI,tui-vi-nu,168356847,"Ví cầm tay nữ nam nhỏ gọn bỏ túi nhiều ngăn da thật cao cấp thời trang PANDAGO Pandora 02 đáng đứng",430000,430000,0,0
TIKI,tui-vi-nu,149179245,"Túi xách công sở POLO da bò cao cấp, đựng vừa laptop 14 inch",950000,950000,0,0
TIKI,tui-vi-nu,180991605,"Túi Cói, Túi Xách Cỏ Bàng Vẽ Hoa Tú Cầu Cao Cấp, Chuẩn Đẹp",329000,329000,0,0
TIKI,tui-vi-nu,196544947,"Túi tote, túi đeo chéo bằng vải canvas cao cấp",89000,89000,0,0
TIKI,tui-vi-nu,86561948," Túi vải    Túi Đeo Chéo Vải Bố Phong Cách Hàn Quốc Xinh Xắn Dành Cho Nữ TV09",69500,69500,0,0
TIKI,tui-vi-nu,188902643,"Túi đeo vai Petit (Túi đeo vai vải linen vintage) - May's Tote Bag",190000,190000,0,0
TIKI,tui-vi-nu,72098593,"Ví nữ cầm tay thời trang cao cấp ELLY – EV72",699000,699000,0,0
TIKI,tui-vi-nu,157479174,"[FREESHIP]bóp ví nữ Pierre Loues đựng vừa điện thoại 6.2", để thẳng tiền, thắt nơ cách điệu - PL6818",229000,229000,0,0
TIKI,tui-vi-nu,136940022,"Túi thổ cẩm quai gỗ 7002",50000,50000,0,0
TIKI,tui-vi-nu,120524458,"HC3759 - Ví nữ da cá sấu Huy Hoàng ngăn thụt cầm tay màu đen",2999000,2999000,0,0
TIKI,tui-vi-nu,143112660,"Ví Vải Modern Fabric Vertical Wallet HAVIAS",350000,350000,0,0
TIKI,tui-vi-nu,190732039,"Túi tote túi vải canvas quai da bò.",150000,150000,0,0
TIKI,tui-vi-nu,270272499,"Ví đựng thẻ card Chico có khóa kéo da bò thật - Pink Ohara Leather",270000,270000,0,0
TIKI,tui-vi-nu,203913225,"Túi Xách Nữ Đeo Chéo Đeo Vai Quảng Châu Cao Cấp Đi Học Đi Chơi Siêu Xinh TUVIDA_VN TX08",180000,180000,0,0
TIKI,tui-vi-nu,74775955,"Ví cầm tay thêu thời trang nữ - V Clutch 08",270000,270000,0,0
TIKI,tui-vi-nu,128490251,"Túi tote vải đeo vai nhung tăm hình gấu thêu 3 nút bấm form túi cứng cáp sang xịn mịn mã TP1 | tiemtuitotebypat",77900,77900,0,0
TIKI,tui-vi-nu,84377275,"Túi xách đựng Ipad",442000,442000,0,0
TIKI,tui-vi-nu,198577449,"Túi Xách Nữ Kẹp Nách Chần Trám Dây Xích To Alva Bag Thương Hiệu GIPSY",780000,780000,0,0
TIKI,tui-vi-nu,136940234,"TÚI THỔ CẨM ĐEO CHÉO LOẠI BÓP ĐẦM",35000,35000,0,0
TIKI,tui-vi-nu,148697671,"Ví đựng passport đựng thẻ và vật dụng du lịch P-Travel Design - D375",246000,246000,0,0
TIKI,tui-vi-nu,128857429,"HJ3101-02-03-04 - Bóp nữ da thật vân cá sấu Huy Hoàng 2 gấp vân nhỏ màu da, đen, nâu, vàng bò",839000,839000,0,0
TIKI,tui-vi-nu,194026682,"Túi  Đeo Chéo Nữ Mini  Đựng Điện Thoại, Đồ Trang Điểm Đi Làm, Đi Chơi, Đi Học  Phong Cách Hàn Quốc ",100000,100000,0,0
TIKI,tui-vi-nu,67107403,"Túi đeo chéo thêu thời trang nữ - Hai bông hoa",250000,250000,0,0
TIKI,tui-vi-nu,248990159,"Móc càng cua màu đen",24000,24000,0,0
TIKI,tui-vi-nu,262043943,"Ví Vans Slipped Camo Wallet VN000C3297I",450000,450000,0,0
TIKI,tui-vi-nu,55456820,"VÍ NỮ MINI GẬP GỌN SIÊU XINH V07",125000,250000,125000,50
TIKI,tui-vi-nu,155609024,"Ví nữ HANHSON da đà điểu màu xanh",1050000,1050000,0,0
TIKI,tui-vi-nu,72035248,"Ví nữ cầm tay thời trang cao cấp ELLY – EV74",699000,699000,0,0
TIKI,tui-vi-nu,58416552,"Túi Xách Tay Và Đeo Chéo Kẻ Ô Kèm Phụ Kiện Hoa Hồng",100000,100000,0,0
TIKI,tui-vi-nu,22363108,"Túi cói đan móc vintage",99000,99000,0,0
TIKI,tui-vi-nu,127645703,"Túi cói merci loại 1 màu sáng, có đệm đáy",40988,40988,0,0
TIKI,voucher-dich-vu,56600709,"Combo phun noãn thực vật giúp làn da đều màu, se khít lỗ chân lông tại Dory Beauty Spa",240000,240000,0,0
TIKI,tui-vi-nu,197890368,"Túi đeo chéo đựng điện thoại hoạ tiết gấu dễ thương ngăn sau trong suốt cảm ứng tiện lợi TK003",49000,98000,49000,50
TIKI,tui-thoi-trang-nam,193546215,"Bóp Nam Da Bò SÁP Họa Tiết Caro, Size Lớn, Thiết Kế Cổ Điển, Đơn Giản - Mỏng Nhẹ, Dáng Ngang - Gập 2, Ngăn Đựng Tiền Có Khóa Kéo, Nhiều Ngăn Để Giấy Tờ Tiện Dụng",880000,899000,19000,2
TIKI,voucher-dich-vu,207230673,"Sách nói Fonos: Đi Khi Ta Còn Trẻ",99000,99000,0,0
TIKI,voucher-dich-vu,9960357,"Chụp Ảnh Cưới tại Studio (tặng 01 ảnh gỗ 60 x 90 cm, 10 ảnh 13 x 18 cm)",1200000,1200000,0,0
TIKI,tui-thoi-trang-nam,74862821,"Ví nam da bò dáng ngang thời trang LATA LVN69 , 9 ngăn, đựng vừa tiền, CMND và 5 thẻ namecard, phù hợp đi chơi, đi làm, sử dụng hằng ngày, da bò thật 100%, không bong tróc, độ bền cao (Dài 13cm x Cao 10cm)",380000,380000,0,0
TIKI,tui-thoi-trang-nam,183503748,"Túi Đeo Dọc WIWU PIONEER 12.9 Inch Dành Cho Ipad Làm Bằng Polyester Chống Thấm Nước, Bền, Dễ Làm Sạch - Hàng Chính Hãng",499000,499000,0,0
TIKI,tui-thoi-trang-nam,70627845,"Túi bao tử_túi đeo chéo da nam_nữ SEAGLE ST02",345000,345000,0,0
TIKI,tui-thoi-trang-nam,121965394,"Ví Nam Da Bò Sáp Dáng Đứng Nhiều Ngăn Siêu Bền Đẹp",168000,336000,168000,50
TIKI,voucher-dich-vu,206104823,"Sách nói: Ảnh Hưởng Của Sức Mạnh Trên Biển Đối Với Lịch Sử, 1660 - 1783",99000,99000,0,0
TIKI,tui-thoi-trang-nam,73730912,"Túi đeo chéo da nam nữ cao cấp da bền MIBAG70",185000,185000,0,0
TIKI,voucher-dich-vu,127015908,"FPT Play - Gói VIP 6 tháng",720000,720000,0,0
TIKI,voucher-dich-vu,73245621,"TOUR LÀNG HOA SA ĐÉC - VƯỜN QUÍT HỒNG LAI VUNG - CHÙA PHẬT NGỌC XÁ LỢI - 1 NGÀY - HAPPY TOUR ",699000,699000,0,0
TIKI,voucher-dich-vu,129916617,"[APP] i-Learn Smart Start Level 1 - Ứng dụng phần mềm tương tác sách học sinh",25000,25000,0,0
TIKI,tui-thoi-trang-nam,89113490,"Ví Dài Nam Hai Ngăn Có Ngăn Kéo Khóa Hàng Full Box Chất Da Trơn Chuẩn Đẹp",246000,246000,0,0
TIKI,voucher-dich-vu,21787095,"Tick Edu - 7 Ý Tưởng Viral Content Trên Social Media Cho Ngành Mỹ Phẩm",799000,799000,0,0
TIKI,tui-thoi-trang-nam,710997,"Túi Đeo Chéo Nam HARAS HRTK118 (27 x 17 cm) - Xám",90000,90000,0,0
TIKI,voucher-dich-vu,75343770,"Goimon.net - Hotpot House- Lẩu xương sườn sụn dành cho 2-3 người ăn",298000,298000,0,0
TIKI,tui-thoi-trang-nam,114170445," Ví bóp ngang nam da bò cao cấp nhỏ gọn thời trang nam nữ VS21",99000,149000,50000,34
TIKI,voucher-dich-vu,80901705,"Sách nói: Thuật Xử Thế Của Người Xưa",99000,99000,0,0
TIKI,voucher-dich-vu,127201658,"KHÓA HỌC THAY ĐỔI THÓI QUEN – THAY ĐỔI CUỘC ĐỜI",599000,599000,0,0
TIKI,tui-thoi-trang-nam,149179544,"Túi đeo chéo nam da bò 100% cao cấp T14 túi đựng ipad (KT :30.5x26x6cm)",1260000,1260000,0,0
TIKI,tui-thoi-trang-nam,194400860,"Túi Đeo Chéo Vải Canvas DAVANTI Nhỏ Gọn DV296",149000,190000,41000,22
TIKI,voucher-dich-vu,206132647,"Voucher Du Thuyền Hạ Long 6 Sao Ambassador  Đẳng Cấp Nhất Vịnh - Nghỉ Dưỡng Trọn Gói 2N1Đ Trên Vịnh Hạ Long (Miễn Phí Setup Sinh Nhật, Honey Moon, Kỷ Niệm Cưới)",3450000,3450000,0,0
TIKI,voucher-dich-vu,43810124,"Khóa học Giải Mã Siêu Trí Tuệ Việt Nam",268000,268000,0,0
TIKI,tui-thoi-trang-nam,108197950,"Túi xách nam 100% da bò thật công sở cao cấp phong cách mới",702000,780000,78000,10
TIKI,tui-thoi-trang-nam,25182819,"Túi đeo hông nam, túi đeo bụng da nam 6 ngăn",94333,136259,41926,31
TIKI,voucher-dich-vu,96418735,"D1-Concepts - Phiếu Quà Tặng Dì Mai 200k",200000,200000,0,0
TIKI,voucher-dich-vu,36182013,"NHẬN 40% GIÁ TRỊ KHI MUA VOUCHER TRỊ GIÁ 500K - THẢ GA TRẢI NGHIỆM DỊCH VỤ ",299000,299000,0,0
TIKI,voucher-dich-vu,254141848,"[Trọn đời] E-voucher khóa học tiếng Anh trực tuyến dành cho độ tuổi 16 trở lên ENGLISH4U Hỗ trợ kích hoạt online",3600000,3600000,0,0
TIKI,tui-thoi-trang-nam,137796500,"Ví nam da bò thật VO 051005",165000,320000,155000,48
TIKI,voucher-dich-vu,206680502,"Voucher tập luyện 2 tháng (Tất cả dịch vụ) - Win Fitness & Yoga",855000,855000,0,0
TIKI,tui-vi-nu,196966150,"Túi Cói, Túi Xách Cỏ Bàng Vẽ Hoa Sen Đẹp Tinh Tế, Sang Trọng-TXCBVHSHLTK06",339000,339000,0,0
TIKI,voucher-dich-vu,105836820,"ELLY - Phiếu Quà Tặng 1.000.000đ",1000000,1000000,0,0
TIKI,tui-thoi-trang-nam,38655549,"Túi Đeo Chéo - Đeo Hông Da 2 Ngăn Thời Trang",51727,70694,18967,27
TIKI,tui-thoi-trang-nam,132833949,"Cặp da nam đẹp FSD 0026",864000,864000,0,0
TIKI,voucher-dich-vu,39697333,"1 Trong Các DỊch Vụ Chăm Sóc Da Mặt Thư Giãn Tuyệt Đối Tại Ấm Brows & Spa",127000,127000,0,0
TIKI,voucher-dich-vu,11389872,"60 Phút Cấy Tảo Xoắn Tươi Nhật Tại Thẩm Mỹ Viện Văn Phượng",99000,99000,0,0
TIKI,tui-thoi-trang-nam,67017467,"Ví Nam Da Bò SAM Leather – Bóp/Ví Nam Da Bò Cao Cấp",599000,599000,0,0
TIKI,voucher-dich-vu,51043312,"Gói phi kim mụn_Q Beauty Spa",488000,488000,0,0
TIKI,voucher-dich-vu,205274169,"Sách nói: The Hero Factor - Các Nhà Lãnh Đạo Vĩ Đại Thay Đổi Tổ Chức Và Tạo Nên Văn Hóa",99000,99000,0,0
TIKI,tui-thoi-trang-nam,100846209,"Túi đeo chéo nam thời trang chống nước MOYYI TDC004",180000,250000,70000,28
TIKI,tui-thoi-trang-nam,188018042,"Clutch, Ví Cầm Tay Thời Trang Nam Da Bò Alran Cao Cấp HT15 Đen",1600000,1600000,0,0
TIKI,voucher-dich-vu,155751029,"Sách nói: Dốc Hết Trái Tim - Cách Starbucks Xây Dựng Công Ty Bằng Từng Tách Cà Phê",99000,99000,0,0
TIKI,voucher-dich-vu,262782594,"DLG Hotel 5* Đà Nẵng - Đối Diện Biển, Buffet Sáng, 02 Hồ Bơi Vô Cực, Vị Trí Thuận Tiện",1830000,1830000,0,0
TIKI,tui-thoi-trang-nam,146955416,"Ví Da Nam VD05 Dáng Ngang Cá Tính Thời Thượng",38000,50000,12000,24
TIKI,tui-thoi-trang-nam,74863205,"Ví nam da bò dáng ngang thời trang LATA LVN70 , 11 ngăn, đựng vừa tiền, CMND và 7 thẻ namecard, phù hợp đi chơi, đi làm, sử dụng hằng ngày, da bò thật 100%, không bong tróc, độ bền cao (Dài 12.5cm x Cao 10cm)",380000,380000,0,0
TIKI,tui-thoi-trang-nam,179013218,"Ví nam vuông cầm tay mắt cú siêu ngầu thời trang Shalla",41506,59953,18447,31
TIKI,tui-vi-nu,77233305,"Túi Xách Tole Nữ dạo phố kèm Gấu giấu trong đáng yêu FR11 Tặng móc khóa cá heo",70290,96063,25773,27
TIKI,tui-thoi-trang-nam,19730058,"Túi đeo chéo vải bố nam TX0010",360000,360000,0,0
TIKI,voucher-dich-vu,7307551,"Mỹ Chi Spa - Trọn Gói 13 Lần Tan Mỡ, Giảm Béo Siêu Tốc - Hiệu Quả Ngay Lần Đầu Tiên",990000,990000,0,0
TIKI,voucher-dich-vu,67114195,"Chicken Plus - Gà Chiên Truyền Thống Nửa Con",139000,139000,0,0
TIKI,voucher-dich-vu,121260498,"Khóa học Live-Online Tiếng Anh Giao Tiếp",1152000,1152000,0,0
TIKI,voucher-dich-vu,120422717,"[APP] i-Learn Smart Start English for Math 1 - Ứng dụng phần mềm tương tác sách học sinh",25000,25000,0,0
TIKI,tui-thoi-trang-nam,188993783,"Ví Sen To handmade da thật",550000,550000,0,0
TIKI,tui-thoi-trang-nam,98074341,"Ví nam bảng dài cầm tay  bấm góc bản châu âu B11 Tặng móc khóa nam cao cấp",111448,152313,40865,27
TIKI,tui-thoi-trang-nam,54095567,"Túi đeo chéo_ Tặng ví da cao cấp",179000,179000,0,0
TIKI,tui-thoi-trang-nam,136095594,"Túi Xách Đựng Laptop Cặp Da Nam GENCE CDT04 Chất Liệu Da Bò Cao Cấp Màu Đen",1800000,1800000,0,0
TIKI,tui-thoi-trang-nam,43813150,"Túi đeo bụng, túi đeo vai, túi đeo chéo  tiện dụng MG8009",36630,50061,13431,27
TIKI,voucher-dich-vu,122642414,"[E-BOOK] i-Learn Smart Start Listening & Speaking 2 Sách giáo viên điện tử",15000,15000,0,0
TIKI,tui-thoi-trang-nam,37474374,"Túi đeo chéo P080",236550,249000,12450,5
TIKI,voucher-dich-vu,164056566,"Tour Vĩnh Hy - Nét Đẹp Hoang Sơ 2N2Đ - Vịnh Vĩnh Hy - Ninh Hải - Mũi Cá Ông - Hang Yến - Hòn Rùa - Hang Rái - Ninh Chữ - Tháp P0klong Grai - Làng Gốm Bàu Trúc",1923000,1923000,0,0
TIKI,tui-thoi-trang-nam,77857670,"Túi Đeo Chéo Bao Tử Nhỏ Gọn Tiện Lợi ZUMBA Vải Canvas Cao Cấp Chống Thấm Nước Unisex Nam Nữ",78000,78000,0,0
TIKI,voucher-dich-vu,203392925,"TOUR HÀNH HƯƠNG NHÀ THỜ BÃI SẬY- VIẾNG CHA DIỆP -  QUAN ÂM NAM HẢI - NHÀ CÔNG TỬ BẠC LIÊU- CÔNG VIÊN ĐỜN KÌM - XE GIƯỜNG NẰM -  1 NGÀY 1 ĐÊM KHỞI HÀNH TỐI THỨ 7- HAPPY TOUR",699000,699000,0,0
TIKI,voucher-dich-vu,137208066,"[APP] New Amanda & Friends 1 - Ứng dụng phần mềm Trò chơi tương tác",25000,25000,0,0
TIKI,tui-thoi-trang-nam,104272509,"Túi đeo chéo da bò thật thời trang cao cấp DAVANTI DD04",495000,550000,55000,10
TIKI,tui-thoi-trang-nam,89588637,"[Da thật} Ví nam da thật, Ví đứng da sáp WS101B (Nâu sẫm) - 100% da bò thật, BH 3 năm",71500,71500,0,0
TIKI,tui-thoi-trang-nam,97551097,"Túi xách nam da bò thật cao cấp phong cách mới 15,6",900000,999000,99000,10
TIKI,voucher-dich-vu,11797456,"Gói Khám Sức Khỏe Tiền Hôn Nhân Cho Nam - Phòng Khám Careplus",2400000,2400000,0,0
TIKI,tui-thoi-trang-nam,68554912,"Cặp Xách Công Sở Nam Da Bò Cao Cấp CTS08",3000000,3000000,0,0
TIKI,voucher-dich-vu,117764804,"Giải bài tận gốc cùng gia sư Snapask - Gói Thử Sức (10 lượt hỏi)",220000,220000,0,0
TIKI,voucher-dich-vu,21775444,"Tick Edu - Kỹ Năng Tổ Chức Trò Chơi",599000,599000,0,0
TIKI,tui-thoi-trang-nam,115643255,"Ví Nam Mini Nhỏ Gọn Cao Cấp, Da Bò NAPA Láng Mịn, Thiết Kế Cổ Điển, Tinh Tế - Sang Trọng, Dáng Ngang - Gập 2, Đựng Tiền và Thẻ ATM Tiện Dụng - Hàng Chính Hãng SAIGIO",959000,999000,40000,4
TIKI,voucher-dich-vu,155751058,"Sách nói: Tam Quốc Diễn Nghĩa 3",99000,99000,0,0
TIKI,tui-thoi-trang-nam,4353345,"Túi đựng ipad Simplecarry LC Ipad2",390000,390000,0,0
TIKI,voucher-dich-vu,11237729,"Khoá Học Tiếng Anh Thiếu Nhi Cambridge Starters A Cho Bé (Lớp 1-3) Tại Nhà Cùng 247 Tiếng Anh",399000,399000,0,0
TIKI,tui-thoi-trang-nam,170497250,"Ví ngang nam Simple Horizontal Wallet chính hãng NATOLI đựng tiền, thẻ nhiều ngăn nhỏ gọn cao cấp",179000,256000,77000,30
TIKI,voucher-dich-vu,4730929,"Việt Hàn Spa - Tắm Trắng Alissi Bronte, Serum Gold Nutriv 24K + Tế Bào Tươi",500000,500000,0,0
TIKI,voucher-dich-vu,91770456,"Sách nói Fonos: Upanishad - Osho",99000,99000,0,0
TIKI,voucher-dich-vu,122642432,"[E-BOOK] CYLET Practice Tests Pre A1 Starters Sách mềm sách học sinh",15000,15000,0,0
TIKI,tui-thoi-trang-nam,127210944,"Túi đeo chéo nam da bò thật BIGBEN cao cấp TXBB02",499000,499000,0,0
TIKI,tui-thoi-trang-nam,91447707,"Cặp Túi Da Nam C48",1188000,1188000,0,0
TIKI,tui-thoi-trang-nam,169127759,"Ví Da Nam Da Bò Thật Nhỏ Gọn",290000,290000,0,0
TIKI,tui-thoi-trang-nam,187586720,"Ví nam cầm tay cao cấp - Clutch Cầm Tay chất lượng cao phong cách mới",243000,270000,27000,10
TIKI,tui-thoi-trang-nam,154190285,"Clutch Cầm Tay Nam Gence Da Bò Saffiano CK11",1400000,1400000,0,0
TIKI,tui-thoi-trang-nam,176130369,"Túi đeo chéo nam vải canvas, thiết kế 3 ngăn để đồ, phong cách thời trang Hàn Quốc TC03",110000,110000,0,0
TIKI,tui-thoi-trang-nam,37941722,"Cặp Da Công Sở P075",379050,399000,19950,5
TIKI,tui-thoi-trang-nam,190722535,"Cặp da công sở cao cấp SHINKOZI CS05",1990000,1990000,0,0
TIKI,tui-thoi-trang-nam,188997786,"Túi Đeo Chéo Nam Nữ Cao Cấp Nhiều Ngăn Chống Thấm Nước, Túi Đeo Vai Phong Cách Thời Trang Hàn Quốc, Túi Đựng Ipad Điện Thoại Đa Năng",130000,130000,0,0
TIKI,tui-thoi-trang-nam,176130340,"Hộp đựng ví nam sang trọng đựng kèm quà tặng ví mua kèm ví nam được giảm giá - MB32",16000,16000,0,0
TIKI,tui-thoi-trang-nam,181785469,"Túi chiến thuật rằn ri đi hành quân, dã ngoại, thao trường cho bộ đội mẫu mới 2020",80000,80000,0,0
TIKI,tui-thoi-trang-nam,193638928,"Túi đeo chéo nam nữ thời trang đa năng cao cấp phong cách mới",261000,290000,29000,10
TIKI,tui-thoi-trang-nam,191925864,"Túi đeo chéo nam hàng hiệu Shinkozi MN01 Da Bò Thật 100%",1190000,1190000,0,0
TIKI,tui-thoi-trang-nam,149133390,"Túi đeo chéo nam, túi đeo vai nam đa chức năng chất liệu vải oxford chống thấm nước, phong cách thời trang năng động",234800,234800,0,0
TIKI,tui-thoi-trang-nam,92564158," Túi đeo chéo nam Kangaroo da cao cấp",289000,289000,0,0
TIKI,tui-thoi-trang-nam,49233464,"Ba Lô Đeo Chéo Nam LATA - Thời Trang Đa Năng - Da Tổng hợp, chất da bền bỉ, không bong tróc, không thấm nước - LATA BALC22 Nhiều Màu ( dài 17 x rộng 6 x cao 26 cm ) - Hàng Chính Hãng",360000,360000,0,0
TIKI,tui-thoi-trang-nam,27927285,"Túi đeo chéo da Bò thời trang cao cấp cho Laptop, Macbook, Ipad - Hàng nhập khẩu",1566000,1566000,0,0
TIKI,tui-thoi-trang-nam,94586618,"TÚI ĐEO CHÉO THỜI TRANG MARK RYDEN – BANDOLERA thế hệ mới chống nước hiệu quả",1014000,1014000,0,0
TIKI,tui-thoi-trang-nam,54159716,"Túi đeo chéo Unisex chống nước Cleacco cho nam nữ",149000,149000,0,0
TIKI,tui-thoi-trang-nam,169472978,"Túi đeo chéo TOMTOC (USA) Lightweight Codura Sling Bag",1039000,1039000,0,0
TIKI,tui-thoi-trang-nam,58810783,"Ví Sen Đà Điểu - CHÍNH HÃNG KHACTEN.COM",1500000,1500000,0,0
TIKI,tui-thoi-trang-nam,112634930,"Bóp Ví Nam Da Bò Thật Cao Cấp Dáng Đứng Thời Trang DM01",139000,178000,39000,22
TIKI,tui-thoi-trang-nam,44325811,"Túi xách da bò công sở cao cấp phong cách châu âu TX DA BÒ 044",504000,560000,56000,10
TIKI,tui-thoi-trang-nam,68303251,"Cặp công sở laptop nam nữ 4 kiểu phong cách mới CV4 Tặng móc khóa nam cao cấp",127710,174537,46827,27
TIKI,tui-thoi-trang-nam,175413411,"TÚI ĐEO CHÉO ĐA NĂNG TOMTOC CROXBODY EDC SLING BAG 11 INCH (A54 - A1D1 )-Hàng Chính Hãng",1100000,1100000,0,0
TIKI,tui-thoi-trang-nam,771480,"Túi Đeo Chéo Praza DCTK090 (25 x 15 cm) - Đen",59000,59000,0,0
TIKI,tui-thoi-trang-nam,196758904,"Túi Cầm Tay Đeo Chéo Nam Gence Da Bò Togo TC01",1800000,1800000,0,0
TIKI,tui-thoi-trang-nam,125354950,"Ví Cầm Tay Nam Da Bò Dập Vân Cá Sấu 1 Ngăn Nam Tính",92000,180000,88000,49
TIKI,tui-thoi-trang-nam,150148744,"Cặp da bò sáp xách tay vừa laptop 13inch BHL2808 Túi công sở nam",1450000,1450000,0,0
TIKI,tui-thoi-trang-nam,1940599,"Cặp Công Sở Yuumy Cayuumy 03 Bò",235000,315000,80000,25
TIKI,tui-thoi-trang-nam,119385004,"Túi đeo hông nam, túi bao tử da bò thật Crazy horse TD106LEA- 100% da bò thật",435000,435000,0,0
TIKI,tui-thoi-trang-nam,96027817,"Ví đứng nam Đông Hải - AV007",490000,490000,0,0
TIKI,tui-thoi-trang-nam,191925614,"Cặp Da Nam Công Sở- Cặp Da Thật - Cặp Đựng Laptop Shinkozi CS011",2590000,2590000,0,0
TIKI,tui-thoi-trang-nam,185644007,"Túi đeo chéo nam đa năng cao cấp phong cách cá tính mới",531000,590000,59000,10
TIKI,tui-thoi-trang-nam,171776243,"cặp da công sở nam",827000,827000,0,0
TIKI,tui-thoi-trang-nam,146952369,"Ví Da Nam Nhiều Ngăn VD04 Kiểu Đứng Nhỏ Gọn Chất Lượng",38000,50000,12000,24
TIKI,tui-thoi-trang-nam,193601758,"Túi đeo chéo nam chống nước, khóa số chống trộm cao cấp BG-7082",600000,600000,0,0
TIKI,tui-thoi-trang-nam,149179182,"Túi đeo chéo nam da bò ZHIZUNCANGAROO T46 28x23x7cm (Đen - Nâu) - DH STORE",648000,648000,0,0
TIKI,tui-thoi-trang-nam,1940551,"Cặp công sở Yuumy Cayyumy01 - Màu Bò",255000,315000,60000,19
TIKI,tui-thoi-trang-nam,193723918,"Túi Đeo Chéo Nam Nữ  Vải Chống Thấm Nước Phong Cách Hàn Quốc, Túi Bao Tử Thể Thao",59000,59000,0,0
TIKI,tui-thoi-trang-nam,140097078,"Cặp Da Nam Cao Cấp Khóa Số Gence CTS10",3200000,3200000,0,0
TIKI,tui-thoi-trang-nam,80900199,"Bóp Ví Nam Da Bò Thật 4U Cao Cấp Dáng Ngang FA202",175000,195000,20000,10
TIKI,tui-thoi-trang-nam,188491306,"Túi nam | 1992 s t u d i o | ZANE BAG RẰN RI | Túi bao tử | chất liệu oxford",399000,399000,0,0
TIKI,tui-thoi-trang-nam,145394214,"Túi đeo chéo nam ngăn đôi dáng ngang lịch lãm LATA TN20",339000,400000,61000,15
TIKI,tui-thoi-trang-nam,149179578,"Túi đeo chéo nam, túi đựng ipad hồ sơ tài liệu da bò thật cao cấp  (KT27x24x5) ĐEN - NÂU - BẢO HÀNH DA 12 THÁNG",650000,650000,0,0
TIKI,tui-thoi-trang-nam,126682296,"Cặp công sở nam cao cấp BHL1038 Vừa laptop 15inch. Da bò thô nguyên tấm",1755000,1755000,0,0
TIKI,tui-thoi-trang-nam,151491295,"Túi đeo chéo nam nữ sành điệu nhỏ gọn tiện lợi giá rẻ bền đẹp đi chơi picnic chất vải Canvas GOMIA DC1903",47775,47775,0,0
TIKI,tui-thoi-trang-nam,116971464,"Ví nam da bò cao cấp Gianni Conti Italy 587620BLA - màu đen ",1400000,1400000,0,0
TIKI,tui-thoi-trang-nam,7233617,"Túi đẻo bụng thể thao tặng khóa",78210,106887,28677,27
TIKI,tui-thoi-trang-nam,179758621,"CẶP DA KHÓA SỐ DOANH NHÂN",1250000,1250000,0,0
TIKI,tui-thoi-trang-nam,107962004,"(ẢNH THẬT -CAO CẤP) Ví Nam Handmade Phong Cách Màu Cafe,Ví Da Nam Thời Thượng - Ví Tiền VIP02",339000,339000,0,0
TIKI,tui-thoi-trang-nam,193104461,"Ví nam da bò dáng ngang họa tiết sọc chéo TRITA RVN17",390000,390000,0,0
TIKI,tui-thoi-trang-nam,68845268,"Ví nam chống RFID BHM7777 Da bò thật, siêu mỏng gọn",387720,387720,0,0
TIKI,tui-thoi-trang-nam,108855728,"Ví nam thời trang da bò thật TRITA RVN07 phong cách cá tính, đựng tiền và thẻ card 14:46 17:45 25/06/2021",205000,410000,205000,50
TIKI,tui-thoi-trang-nam,99336014,"[Da thật] Túi đeo ngực kết hợp đeo hông nam da bò thật TD107 (Vàng bò) - 100% da bò thật",450000,450000,0,0
TIKI,tui-thoi-trang-nam,53347936,"Túi Bao Tử Đeo Chéo Cao Cấp Nam Nữ Thời Trang Đa Năng Galaxy Store GTBT01 (28x17.5cm) - Hàng Chính Hãng",242000,450000,208000,46
TIKI,tui-thoi-trang-nam,179013334,"Ví kẹp bảng dài nam nữ hình mắt cú thời trang siêu đẹp Shalla",60221,86986,26765,31
TIKI,tui-thoi-trang-nam,173542370,"Ví Cầm Tay Nam Da Bò Hàng Hiệu POLO MEISDO Sang Trọng Lịch Lãm PL 06",1800000,1800000,0,0
TIKI,tui-thoi-trang-nam,103886512,"Túi Đeo Chéo Da Bò Thật Bảo Hành Ba Năm CB03",750000,750000,0,0
TIKI,tui-thoi-trang-nam,67235358,"TÚI ĐEO CHÉO TOMTOC (USA) URBAN CODURA SHOULDER BAGS FOR ULTRABOOK 13″ BLACK – H14-C01D",1789000,1789000,0,0
TIKI,tui-thoi-trang-nam,41427549,"Cặp công sở laptop đeo chéo mẫu mới ngang đỏ trên P2 Shalla",122378,167250,44872,27
TIKI,tui-thoi-trang-nam,126039327,"Bóp Đựng Thẻ ATM Nhỏ Gọn SUPPLE, Da Bò SMALL PEBBLE Mềm Mại - Bền Bỉ, Chống Xước - Chống Nhăn Tốt, Thiết Kế Hiện Đại, Ngăn Súp Lê Rộng, Đựng Được Nhiều Thẻ Ngân Hàng, Card Danh Thiếp, Căn Cước Công Dân, Dáng Đứng - Gập 2 – Hàng Chính Hãng SAIGIO",683000,699000,16000,2
TIKI,tui-thoi-trang-nam,88929109,"Túi xách nam công sở cao cấp",405000,450000,45000,10
TIKI,tui-thoi-trang-nam,157254216,"Túi Đeo Chéo Nam, Nữ Họa Tiết Sọc SAIGON SWAGGER SGS Icon Tartan Bag",450000,450000,0,0
TIKI,tui-thoi-trang-nam,45842879,"Ví da cầm tay nam nữ cao cấp  - Nâu",113850,155595,41745,27
TIKI,tui-thoi-trang-nam,87137041,"Túi Da Công Sở P076 - Màu Đen – Form Chuẩn – Sang Trọng – Đẳng Cấp.",432250,455000,22750,5
TIKI,tui-thoi-trang-nam,153264863,"Túi đeo chéo vải bố kẻo chỉ đỏ cao cấp B77 Shalla",31680,43296,11616,27
TIKI,tui-thoi-trang-nam,179718829,"Ví tròn đựng tiền, trang sức, chìa khóa, tai phone ( mẫu ngẫu nhiên)",17000,17000,0,0
TIKI,tui-thoi-trang-nam,49208826,"Túi Đeo Chéo Nam Da Bò Sunpolo STU102",990000,990000,0,0
TIKI,tui-thoi-trang-nam,195559178,"Ví nam họa tiết rằn ri",99000,99000,0,0
TIKI,tui-thoi-trang-nam,254081948,"[Da thật] Ví dài nam nữ da bò thật vân cá sấu WL123LS (Đen/Nâu) [Full box] - 100% da bò thật, BH 3 năm",395000,395000,0,0
TIKI,tui-thoi-trang-nam,185888240,"Túi xách laptop , Cặp đựng laptop 15,6 inch quai sách công sở, văn phòng, giáo viên đi làm đựng tài liệu",199000,199000,0,0
TIKI,tui-thoi-trang-nam,149179363,"Túi đeo chéo nam da bò POLO cao cấp T66 KT 19x22x4cm (Nâu Đậm - Nâu Nhạt) - DH STORE",478800,478800,0,0
TIKI,tui-thoi-trang-nam,70090549,"Túi bao tử đeo chéo đeo bụng đa năng",190000,190000,0,0
TIKI,tui-thoi-trang-nam,113168460,"Ví nam cầm tay Gianni Conti Italy VP0176BLA - màu đen",3300000,3300000,0,0
TIKI,tui-thoi-trang-nam,155495502,"Ví namecard da bò V130, ví đựng thẻ da thật, khâu tay thủ công, ví mini nam đường chỉ tinh tế, thương hiệu Bụi leather chuyên đồ da thật",135000,170000,35000,21
TIKI,tui-thoi-trang-nam,19742944,"Túi xách da nam công sở",315000,315000,0,0
TIKI,tui-thoi-trang-nam,177012500,"Túi xách nam công sở da tự nhiên cao cấp phong cách mới",441000,490000,49000,10
TIKI,tui-thoi-trang-nam,157254280,"Túi Đeo Chéo Nam, Nữ SAIGON SWAGGER SGS Cross Body Bag",400000,400000,0,0
TIKI,tui-thoi-trang-nam,172191930,"Túi đeo chéo nam phong cách Hàn Quốc chống nước, có cổng USB xạc tiện dụng – bảo hành 3 tháng.208204",59600,67600,8000,12
TIKI,tui-thoi-trang-nam,188750941,"Túi Xách Nam Da Bò Cao Cấp Có Quai Đeo Màu Đen, Màu Nâu Đỏ WT Leather WINE",6500000,6500000,0,0
TIKI,tui-thoi-trang-nam,55461600,"Ví/ Bóp Nam Dáng Đứng Màu Nâu Dành cho Nam Da Bò Cao Cấp, Thiết Kế Tinh Tế, Thời Trang 2020 - ORCO (Kích thước 12 cm x 9 cm)",99000,99000,0,0
TIKI,tui-thoi-trang-nam,117393261,"Túi đeo chéo nam nữ da Pu cao cấp TC08",106733,145869,39136,27
TIKI,tui-vi-nu,185882538,"Túi Xách Nữ Túi Xách Hàn Quốc ZL105 Da Thật Cao Cấp FullBox Size 28.5cm (BH 12 tháng) Thích Hợp Làm Quà Tặng, Sinh Nhật",2900000,2900000,0,0
TIKI,tui-vi-nu,252640931,"Túi Xách Nữ Công Sở Pha Da Cao Cấp Dáng Công Sở, Túi Đeo Vai Nữ Vải Canvas Thời Trang Sang Trọng Đi Làm, Đi Chơi - OTV236 - Ope Store",340000,340000,0,0
TIKI,tui-vi-nu,51281307,"[Kèm ảnh thật]Túi đeo chéo khoá chữ B da vân rắn thời trang-túi đeo chéo nữ, túi xách nữ, túi đeo chéo thời trang-da pu vân rắn cực đẹp,móc khoá chữ B cách điệu, có quai xách  - đỏ",99000,99000,0,0
TIKI,tui-vi-nu,12135715,"Túi đeo chéo ANELLO unisex vải polyester cỡ nhỏ AT-N0661 - Màu",1180000,1180000,0,0
TIKI,tui-vi-nu,128292640,"Ví cầm tay hình con vật",102000,102000,0,0
TIKI,tui-vi-nu,43179400,"Túi xách nữ đeo vai thời trang",89000,89000,0,0
TIKI,tui-vi-nu,147871381,"Ví tiền vải fairy style sang trọng có quai đeo",649000,649000,0,0
TIKI,tui-vi-nu,10251402,"Túi đeo vai Sailor Moon GU Nhật Bản",350000,350000,0,0
TIKI,tui-vi-nu,164430267,"Túi nữ pha dạ kẻ, túi đeo chéo 2 màu xinh xắn",55000,55000,0,0
TIKI,tui-vi-nu,75447858,"TÚI TOTE THỜI TRANG ĐEO VAI VÀ ĐEO CHÉO ĐI HỌC - VỊT DONAL XINH XẮN",107000,107000,0,0
TIKI,tui-vi-nu,120035580,"Túi hộp đeo chéo nữ Huy Hoàng da đà điểu màu nâu đất HP6458",4499000,4499000,0,0
TIKI,tui-vi-nu,57156779,"TÚI XÁCH GẤU TRÚC PANDA",85500,85500,0,0
TIKI,tui-vi-nu,130328059,"HJ6246-47-48-49 - Túi xách nữ da cá sấu Huy Hoàng đeo chéo 2 gai màu đen, nâu đỏ, vàng bò, nâu đất",4899000,4899000,0,0
TIKI,tui-vi-nu,77446539," Ví Nữ Nam Unisex Bóp Nữ Nam Unisex Cao Cấp (VI-NU-034) - Bóp Cầm Tay - Ví Cầm Tay",99000,99000,0,0
TIKI,tui-vi-nu,103459101,"Túi đeo chéo cún vàng tặng kèm 1 móc khóa Gấu",110000,110000,0,0
TIKI,tui-vi-nu,184997925,"Túi xách nữ thời trang cao cấp ELLY – EL141",1499000,1499000,0,0
TIKI,tui-vi-nu,196478866,"Ví Nữ Ngắn Gập Cầm Tay Da Bò Thật Thương Hiệu GIPSY",550000,550000,0,0
TIKI,tui-vi-nu,120525319,"Bóp da đà điểu Huy Hoàng nhiều ngăn màu xanh lá HC3427",2749000,2749000,0,0
TIKI,tui-vi-nu,116852451,"Túi đeo chéo da thật cao cấp 208241",166700,494000,327300,66
TIKI,tui-vi-nu,173028766,"Túi Nữ Kẻ Sọc Thời Trang Phong Cách Cá Tính 205970",45800,70000,24200,35
TIKI,tui-vi-nu,176150006,"Túi Xách Nữ Gence Da Bò Cao Cấp TX05",1980000,1980000,0,0
TIKI,tui-vi-nu,89949853,"Túi đeo chéo nam thời trang phong cách Hàn Quốc Z 208188   Khuyến mại túi xách",50000,61100,11100,18
TIKI,tui-vi-nu,89937487,"Túi Đeo Chéo Phong Cách Hàn Quốc Z 208152   KHUYẾN MẠI TÚI XÁCH",38900,60000,21100,35
TIKI,tui-vi-nu,40192403,"Túi xách công sở form lớn",299000,299000,0,0
TIKI,tui-thoi-trang-nam,74550219,"Túi đeo chéo nam chất da Pu cao cấp cực đẹp KN1006",185000,185000,0,0
TIKI,tui-vi-nu,81645600,"TÚI TOTE VẢI TÚI TOTE TRẮNG NGÀ VINTAGE CHỮ ĐỎ DEMAIN",75000,75000,0,0
TIKI,tui-vi-nu,151233487,"Túi xách da",160000,160000,0,0
TIKI,tui-vi-nu,102115869,"Túi đeo chéo nữ công sở phong cách Hàn Quốc sang trọng và thanh lịch TN173",129000,129000,0,0
TIKI,tui-vi-nu,198075906,"Túi xách nữ thời trang cao cấp ELLY – EL217",844350,1299000,454650,35
TIKI,tui-thoi-trang-nam,106655788,"Ví nam, ví da, ví cầm tay, ví đa năng, ví dài, ví đựng tiền, ví mắt, ví đôi mắt, ví mắt nam, ví nữ, ví nam thời trang",165000,165000,0,0
TIKI,tui-vi-nu,117294382,"Túi đeo chéo hình xe hơi, ô tô cho cả mẹ và bé siêu xinh",89000,89000,0,0
TIKI,tui-vi-nu,180388254,"100g keo liền da cây 35k.",35000,35000,0,0
TIKI,tui-vi-nu,198365331," Ví nữ da bò màu đen HJ93106-12-16-20-26",499000,499000,0,0
TIKI,tui-vi-nu,21243111,"Túi thời trang cực xinh phong cách Hàn Quốc HQC332",249000,249000,0,0
TIKI,tui-thoi-trang-nam,170181753,"Ví nam, bóp nam dài cầm tay da thật, mềm, mỏng, cao cấp kiểu dáng đẹp, phong cách thời trang đang được ưa chuộng",189000,189000,0,0
TIKI,tui-vi-nu,206980692,"Túi xách tặng bố, My Friend, My Hero, My Dad, mã G175. Có khóa kéo. Quà tặng cao cấp cho cha",109000,109000,0,0
TIKI,tui-thoi-trang-nam,248546613,"Ví nam khắc tên da bò thật Taiga cao cấp LIDAN, bóp dáng ngang có hộp vintage kèm thiệp đẹp làm quà tặng LD17",469000,469000,0,0
TIKI,tui-thoi-trang-nam,67536791,"Túi Bao Tử Đeo Chéo Thể Thao",38610,52767,14157,27
TIKI,tui-thoi-trang-nam,149179303,"Túi đeo chéo nam da bò cao cấp, túi đựng ipad, hồ sơ tài liệu BAODIDAISHU MS01 (ĐEN-NÂU) KT 26x23x7 - 32x25x8cm",900000,900000,0,0
TIKI,tui-thoi-trang-nam,76657266,"Túi messenger ipad cao cấp Fimax, túi đéo chéo nam đựng ipad chất liệu vải oxford chống thấm với có nhiều ngăn đựng đồ tiện lợi dùng để đeo đi làm đi học đi chơi",349000,349000,0,0
TIKI,tui-vi-nu,147486282,"Túi TOTE tai thỏ phong cách Hàn Quốc dung tích lớn tiện dụng",84500,84500,0,0
TIKI,tui-thoi-trang-nam,111868963,"Túi đeo chéo nam trước ngực Arctic Hunter chất liệu Oxford chống nước - Y00013",499000,810000,311000,38
TIKI,tui-thoi-trang-nam,113168817,"Ví cầm tay nam Gianni Conti Italy VP0176DBR - màu nâu",3300000,3300000,0,0
TIKI,tui-thoi-trang-nam,9821513,"Ví bóp Nam phong cách",143550,207350,63800,31
TIKI,tui-thoi-trang-nam,96067481,"Túi đeo hông đeo bụng chống thấm nước tiện dụng cho nam nữ",38610,52767,14157,27
TIKI,tui-thoi-trang-nam,32859275,"Cặp da công sở cao cấp chính hãng Mandino M383 màu đen",3600000,3600000,0,0
TIKI,tui-thoi-trang-nam,157254411,"Túi Đeo Chéo Nam Nữ Ngang In Họa Tiết Báo SAIGON SWAGGER SGS Journal Cross Body Bag",420000,420000,0,0
TIKI,tui-vi-nu,121106509,"Ví tiền TFBOYS/ bóp tiền TFBOYS",55000,55000,0,0
TIKI,tui-vi-nu,143112703,"Túi Grand Mini Oxford HAVIAS_Túi vải đeo chéo Đen",350000,350000,0,0
TIKI,tui-thoi-trang-nam,153011026,"Túi đeo chéo nam cao cấp phong cách HÀN QUỐC BEE GEE DCN9019",208000,420000,212000,50
TIKI,tui-thoi-trang-nam,114125242,"Ví nam da thật Lata LVN98",480000,480000,0,0
TIKI,tui-vi-nu,260804853,"Dây kéo 1 chiều răng 3(không kèm đầu khóa)",37000,37000,0,0
TIKI,tui-thoi-trang-nam,90431424,"VÍ NAM CẦM TAY NHIỀU NGĂN TIỆN LỢI",44975,61466,16491,27
TIKI,tui-thoi-trang-nam,197540212,"Túi xách nam Oscar - OCMHBLG042",3950000,7900000,3950000,50
TIKI,tui-thoi-trang-nam,52195323,"Túi xách nam da bò công sở cao cấp",659000,950000,291000,31
TIKI,tui-thoi-trang-nam,158385592,"Cặp Xách Nam Gence Da Bò Cao Cấp CTS11 Khóa Số",3520000,3520000,0,0
TIKI,tui-thoi-trang-nam,148850139,"Ví nam đựng thẻ Arctic Hunter Q00013 thiết kế nhiều ngăn, chống nước, chống xước",99000,185000,86000,46
TIKI,tui-thoi-trang-nam,186350260,"Túi xách nam công sở da tự nhiên cao cấp phong cách mới",711000,790000,79000,10
TIKI,tui-vi-nu,71178537,"Túi đeo chéo nữ để diện thoại thời trang họa tiết dễ thương BEE GEE 096",74000,150000,76000,51
TIKI,tui-vi-nu,1995287,"Túi Đeo Chéo 2 Gai Nữ Da Cá Sấu Huy Hoàng HT6246 (14.5 x 24.5 cm) - Đen",3499000,3499000,0,0
TIKI,tui-thoi-trang-nam,35326773,"Túi xách nam da thật ELLY HOMME – ETM4",3199000,3199000,0,0
TIKI,tui-thoi-trang-nam,41413478,"Cặp công sở aptop đeo chéo mẫu mới ngang đỏ trên MK2 Shalla",120780,165066,44286,27
TIKI,tui-vi-nu,188903518,"Túi vải Grocery - May’s Tote Bag",200000,200000,0,0
TIKI,tui-thoi-trang-nam,137238525,"Túi đeo chéo chống thấm nước 5 ngăn cao cấp size 24cm",99000,99000,0,0
TIKI,tui-thoi-trang-nam,125353248,"Ví Da Nam Cầm Tay Da Bò Sáp Nguyên Tấm",235000,460000,225000,49
TIKI,tui-thoi-trang-nam,162575288,"Clutch Nam Cầm Tay Gence Cao Cấp, Ví Cầm Tay Nam Da Bò RB06 Khóa Vân Tay",2500000,2500000,0,0
TIKI,tui-thoi-trang-nam,481730,"Túi Đeo Chéo Ipad Mikkor Betty Tablet BT005 - Camo ",203000,203000,0,0
TIKI,tui-thoi-trang-nam,10014247,"Túi đeo chéo TROY YM in logo Chelsea",187000,199000,12000,6
TIKI,tui-thoi-trang-nam,213676659,"Ví nam mini kiểu đứng nhiều ngăn bỏ túi nhỏ gọn K9101",105000,210000,105000,50
TIKI,tui-thoi-trang-nam,185994646,"Túi xách túi đeo chéo nam công sở da bò thật cao cấp phong cách cá tính mới",765000,850000,85000,10
TIKI,tui-thoi-trang-nam,241819867,"Ví nam đựng thẻ tin dụng, bóp nam cầm tay đựng thẻ ngân hàng atm, card,... có lẫy tự động cao cấp",278000,278000,0,0
TIKI,tui-thoi-trang-nam,53282253,"BAO DA HỘ CHIẾU (Passport) - CHÍNH HÃNG KHẮC TÊN",500000,500000,0,0
TIKI,tui-thoi-trang-nam,76156635," capdakhoaso1 - D1: 39 x 29 x 10 Cm",827000,827000,0,0
TIKI,tui-thoi-trang-nam,271086705,"[VOUCHER 30K] Cặp da nam công sở phối ngăn LATA CA38",890000,890000,0,0
TIKI,tui-thoi-trang-nam,107962057,"Ví nam da thật thời trang cao cấp cho giới trẻ S39-2",15000,15000,0,0
TIKI,tui-thoi-trang-nam,192563908,"Túi Da Bò Đeo Chéo - Túi Da Đeo Chéo  Shinkozi TDC10 Da Bò Thật 100%",1390000,1390000,0,0
TIKI,tui-thoi-trang-nam,173542396,"Ví Da Bò Nam Cao Cấp Hàng Hiệu POLO MEISDO Sang Trọng ( Da Bò Thật 100%)",1200000,1200000,0,0
TIKI,tui-thoi-trang-nam,192034009,"Túi Nam đeo chéo đeo vai vải chống thấm - T0302",320000,320000,0,0
TIKI,tui-thoi-trang-nam,59288059,"Balo đeo chéo LATA BALC26",360000,360000,0,0
TIKI,tui-thoi-trang-nam,4353437,"Túi đựng ipad Simplecarry LC Ipad3",390000,390000,0,0
TIKI,tui-vi-nu,97018360,"Hình Thật-FREESHIP Túi Đeo Chéo Nữ Vải Chống Nước Hàng Xịn Quảng Châu Kẹp Nách Xách Vai Tote Unisex Mini Thời Trang",189000,189000,0,0
TIKI,tui-vi-nu,45875814,"Túi Xách Nữ Có Quai Đeo Chéo Sang Trọng - Nâu",1899000,1899000,0,0
TIKI,tui-vi-nu,172191747,"Túi nữ thời trang Đồ Da Thành Long TLG 208153 3(xanh) tặng túi đựng bút tiện lợi",44690,44690,0,0
TIKI,tui-vi-nu,193765298,"Túi Cói, Túi Tote Vẽ Mỹ Nghệ Sang Trọng, Chuẩn Đẹp-Túi Xách Cỏ Bàng TXCBQHVCLLTK05",309000,309000,0,0
TIKI,tui-vi-nu,194025709,"Túi xách nữ Gù gai cá sấu cao cấp ",3500000,5500000,2000000,36
TIKI,tui-vi-nu,144044711,"Túi đeo chéo bông chó Corgi size 35cm",160000,160000,0,0
TIKI,tui-vi-nu,253306325,"Túi Tote Vải Đeo Chéo Phong Cách Hàn Quốc",199000,199000,0,0
TIKI,tui-vi-nu,96670376,"Túi điện thoại đeo chéo thời trang nữ - túi handmade",175500,175500,0,0
TIKI,tui-vi-nu,108253653,"Túi Đeo Chéo Da Mềm Nhỏ Xinh Khóa Tròn Mẫu Mới",107000,107000,0,0
TIKI,tui-vi-nu,852565,"Ví Cầm Tay Đa Năng Da Bò Hity ACC001 (21 x 13 cm)",799000,799000,0,0
TIKI,tui-vi-nu,103458980,"Túi đeo chéo Kakao",110000,110000,0,0
TIKI,tui-vi-nu,132079535,"Túi Đeo Vai V - Màu Đồng [T07]",112000,194400,82400,42
TIKI,tui-vi-nu,184071628,"Túi xách nữ màu đen phom hộp vân trám/ BRIONA BAG",299000,299000,0,0
TIKI,tui-vi-nu,71178658,"Túi đeo chéo nam nữ unisex thời trang Hàn quốc để điện thoại chống thấm nước BEE GEE 099",49000,98000,49000,50
TIKI,tui-vi-nu,176217546,"Túi Vải Họa Tiết Ca Rô Siêu Hot - Túi Vải Túi Tote Dành Cho Nữ Siêu Đẹp - Túi Vải Đi Chơi Cho Nữ",70000,70000,0,0
TIKI,tui-vi-nu,89945197,"Túi nữ họa tiết thời trang   208164 2 (đen )",68600,160000,91400,57
TIKI,tui-vi-nu,82865716,"TÚI NỮ DA PHONG CÁCH HÀN QUỐC ĐỂ ĐIỆN THOẠI – SIÊU XINH – NĂNG ĐỘNG VÀ TIỆN ÍCH",110000,110000,0,0
TIKI,tui-vi-nu,35524804,"Ví Forever Young Phong Cách Hàn Quốc VD23",75000,75000,0,0
TIKI,tui-vi-nu,2009003,"Ví Nữ Huy Hoàng HT3114 (9.5 x 19 cm) - Hồng",599000,599000,0,0
TIKI,tui-vi-nu,10094193,"Ví Cầm Tay Hình Mèo - Nội Địa Nhật Bản",39000,39000,0,0
TIKI,tui-vi-nu,160888065,"Nút tán rivet (đinh tán) 2 mặt Bằng sắt xi Màu bạc, màu vàng, màu đồng Size 5mm, 6mm, 8mm, 9mm Đóng thùng giấy, thủ công",20000,20000,0,0
TIKI,tui-vi-nu,2009231,"Ví Nữ Huy Hoàng HT3259 (10.5 x 19 cm) - Xanh Lá",1999000,1999000,0,0
TIKI,tui-vi-nu,177123789,"Túi đeo chéo dạo phố BUCGET MINI Thời trang sành điệu nữ giới kích thước 19cm x 16cm x 9cm",185000,185000,0,0
TIKI,tui-vi-nu,173234122,"Bộ 3 túi xách nữ thời trang phong cách Đồ Da Thành Long TLG 208012 - hồng sen",111100,194100,83000,43
TIKI,tui-vi-nu,77747015,"Túi đựng điện thoại đeo chéo nữ thời trang dọc nắp hình ngựa LLM012 Tặng móc khóa thỏ trắng",78423,107178,28755,27
TIKI,tui-vi-nu,120524902,"HT3738-39-40-41 - Bóp nữ da cá sấu Huy Hoàng nhiều ngăn gai cầm tay màu đen, nâu đỏ, vàng bò, nâu đất",2499000,2499000,0,0
TIKI,tui-vi-nu,114697092,"Túi đeo chéo nữ mini sang chảnh, cá tính, 2 ngăn nhỏ gọn, tiện dụng, đựng điện thoại, tiền. Túi nhỏ đi chơi siêu đẹp",159000,159000,0,0
TIKI,tui-vi-nu,109814991,"Túi đeo chéo nữ phong cách cá tính Đồ Da Thành Long TLG 208088 4(xám)",45800,56000,10200,18
TIKI,tui-vi-nu,136939996,"Túi ví đựng tiền thêu hoa",25000,25000,0,0
TIKI,tui-vi-nu,192725934,"Túi xách nữ phong cách phương tây 2022",1295000,1295000,0,0
TIKI,tui-vi-nu,173856821,"Túi đeo chéo thời trang dây xích kèm túi con đi làm vải canvas",89000,89000,0,0
TIKI,tui-vi-nu,136940191,"Túi đeo chéo bầu",60000,60000,0,0
TIKI,tui-vi-nu,161456500,"Ví Dài The Heyday2 Long Wallet",700000,700000,0,0
TIKI,tui-vi-nu,179966591,"Phụ kiện Đan móc Hải Phòng số 415",185000,185000,0,0
TIKI,tui-vi-nu,136940013,"TÚI VÍ THỔ CẨM ĐỰNG TIỀN",15000,15000,0,0
TIKI,tui-vi-nu,2008981,"Ví Nữ Huy Hoàng HT3103 (9 x 18.5 cm) - Nâu",599000,599000,0,0
TIKI,tui-vi-nu,176245762,"Túi đeo chéo nữ, giỏ đeo chéo cá tính, chất liệu da PU cao cấp cực bền đẹp",275000,275000,0,0
TIKI,tui-vi-nu,95154541,"túi công sở vân rắn",364000,364000,0,0
TIKI,tui-vi-nu,148715003,"New - Ví kẹp tiền thẻ atm cao cấp phong cách doanh nhân thành đạt 2019 ",285600,285600,0,0
TIKI,tui-vi-nu,174468582,"Ví Nữ Dài Cầm Tay Chính Hãng TAILIAN Đựng Tiền Điện Thoại Da Cao Cấp Nhiều Ngăn Giá Cực Rẻ TL07",139000,139000,0,0
TIKI,tui-vi-nu,225194846,"Túi xách cho nữ xinh xắn",10000,10000,0,0
TIKI,tui-vi-nu,106654179,"Ví cầm tay nữ dáng dài sang trọng, Ví nữ đựng tiền, ví bóp nữ giá rẻ, ví nữ dài cầm tay nhiều ngăn, Ví nữ cao cấp",132000,132000,0,0
TIKI,tui-vi-nu,197654021,"Túi đeo chéo ngực nam nữ trong suốt thời trang unisex túi việt kiều bumbag đeo vai VK011",145000,145000,0,0
TIKI,tui-vi-nu,196596639,"Túi giỏ xách đeo chéo, đeo vai, xách tay hình tròn thời trang nữ chất liệu da PU siêu đẹp phù hợp đi làm, đi tiệc TX057",229000,229000,0,0
TIKI,tui-vi-nu,71730288,"Túi clutch nữ thời trang cao cấp ELLY – ECH49",1199000,1199000,0,0
TIKI,tui-vi-nu,74892467,"[VOUCHER 30K] Ví Cầm Tay Unisex Thời Trang LATA VN48 nhiều màu (Dài 25cm x Rộng 10cm x Cao 5cm)",229000,290000,61000,21
TIKI,tui-vi-nu,71514893,"Túi xách nữ thời trang cao cấp ELLY- EL147",1119200,1399000,279800,20
TIKI,tui-vi-nu,67086904,"Túi xách hình vỏ sò sang trọng - giao màu ngẫu nhiên",160000,160000,0,0
TIKI,tui-vi-nu,149970234,"Túi đựng điện thoại DT1121",86000,86000,0,0
TIKI,tui-vi-nu,203913244,"Túi Xách Nữ Đeo Chéo Đeo Vai Quảng Châu Cao Cấp Đi Học Đi Chơi Siêu Xinh TUVIDA_VN TX03",180000,180000,0,0
TIKI,tui-vi-nu,137155169,"Túi Tote Canvas Quai Tròn Vải Mềm Roro",59000,59000,0,0
TIKI,tui-vi-nu,73100759,"dây xích kim loại đeo vai túi xách quai túi loại xích tròn",90000,90000,0,0
TIKI,tui-vi-nu,54840715,"Túi đeo chéo nam nữ để điện thoại thời trang Hàn quốc chống thấm nước BEE GEE 084 chống thấm nước",40000,80000,40000,50
TIKI,tui-vi-nu,99514361,"Ví bóp nữ mini cầm tay hình bò sữa , chất liệu da cao cấp",55000,55000,0,0
TIKI,tui-vi-nu,153382569,"Túi đeo chéo bò sửa trong suốt không kèm phụ kiện HS1P",58000,58000,0,0
TIKI,tui-vi-nu,186632836,"Túi đeo chéo Hello Girl NASI T1020 phong cách hàn quốc túi đeo vai nữ thời trang dạo phố dễ thương vải đẹp",49000,49000,0,0
TIKI,tui-vi-nu,68553531,"Ví Cầm Tay Thời Trang FALDO Chống Thấm Nước",51000,51000,0,0
TIKI,tui-vi-nu,167658366,"Túi nữ mini da mềm YUUMY YN119",175000,290000,115000,40
TIKI,tui-vi-nu,152923488,"Bóp ví nữ cầm tay mini V0490 Meow meow bỏ túi nhiều ngăn nhỏ gọn phong cách đơn giản, thời trang, dễ thương",25000,50000,25000,50
TIKI,tui-vi-nu,149449471,"Túi đeo chéo cao cấp - CEEKAY túi xách tay",499000,499000,0,0
TIKI,tui-vi-nu,44433176,"Túi Xách Nữ Có Dây Đeo Phối Charm Sang Trọng",275000,275000,0,0
TIKI,tui-vi-nu,125100800,"Túi Đeo Chéo Đựng Điện Thoại Thời Trang CDTX34",49000,49000,0,0
TIKI,tui-vi-nu,73362075,"VÍ NGẮN GẬP DA Bóp BASIC Da Saffiano Nhập Khẩu Cao Cấp Chống Thấm Nước Unisex Nam Nữ Chuẩn Nome DOLANTO",220000,220000,0,0
TIKI,tui-vi-nu,183349761,"Set 4 hộp đựng khẩu trang + stickers",280000,280000,0,0
TIKI,tui-vi-nu,71176787,"Túi xách nữ thời trang cao cấp ELLY – EL157",1399000,1399000,0,0
TIKI,tui-vi-nu,193447892,"Túi Xách Nữ Da Thật, Túi Công Sở Cầm Tay Sang Trọng, Cao Cấp  -Túi xách nữ đeo chéo, túi xách da Thời Trang",869000,869000,0,0
TIKI,tui-vi-nu,157254128,"Móc Khóa Horshy Keychain SAIGON SWAGGER SGS Horshy Keychain",69000,69000,0,0
TIKI,tui-vi-nu,22631064,"Túi đeo vai nữ cổ điển TĐ44 Shalla",134640,194480,59840,31
TIKI,tui-vi-nu,190547235,"Túi hạt chuỗi",315000,315000,0,0
TIKI,tui-vi-nu,172998464,"Túi Nữ Kẻ Sọc Thời Trang Phong Cách Cá Tính 205970",45800,70000,24200,35
TIKI,tui-vi-nu,73339899,"TÚI ĐEO CHÉO Mini Tiện Lợi DISCOVERY Vải Canvas Cao Cấp Chống Thấm Nước Unisex Nam Nữ Chuẩn Nome DOLANTO",180000,180000,0,0
TIKI,tui-thoi-trang-nam,155530131,"Cặp da công sở da bò Mill cao cấp B102 Bụi Leather - Bảo hành 12 tháng",1200000,1798000,598000,33
TIKI,tui-vi-nu,63172383,"Túi Đeo Chéo Gắn Họa Tiết Con Ong Đẹp TX20",146000,146000,0,0
TIKI,tui-thoi-trang-nam,196156253,"Ví Da Nam VD06 Kiểu Đứng Nhỏ Gọn Cao Cấp",38000,50000,12000,24
TIKI,tui-vi-nu,87939602,"Túi Đeo Chéo Nữ, Túi Chất Liệu Da Mềm Cao Cấp, Dây Đeo Chéo TC021",139000,139000,0,0
TIKI,tui-thoi-trang-nam,49100365,"Ví ngang nam da bò KTP Cao cấp",479800,479800,0,0
TIKI,tui-vi-nu,147942898,"Túi Đeo Chéo Nữ Chính Hãng FOREVER YOUNG Dáng Vuông Nhiều Ngăn Đựng Điện Thoại Đựng Tiền Siêu Tiện Dụng FY15 - Tukado",269000,269000,0,0
TIKI,tui-vi-nu,78623517,"Túi Tote NICE - VN208 ( có khóa kéo, dây đeo )",99000,99000,0,0
TIKI,tui-thoi-trang-nam,206249762,"Ví da nam . ví nam cao cấp Full hộp WilliamPOLO -  V26",545000,545000,0,0
TIKI,tui-thoi-trang-nam,107962615,"Bóp ví nam da thời trang đa năng nhiều ngăn tiện dụng đầy nam tính kiểu ngang đen",39000,39000,0,0
TIKI,tui-thoi-trang-nam,14279871,"Túi Đeo Chéo Nam Thời Trang",275000,275000,0,0
TIKI,tui-thoi-trang-nam,176686195,"Túi đeo chéo nam vải dù Oxford chống nước cao cấp size 27cm",99000,99000,0,0
TIKI,tui-thoi-trang-nam,174589603,"Ví nam cầm tay da thật HOMME – EVM18",1099000,1099000,0,0
TIKI,tui-thoi-trang-nam,135815742,"Túi đeo chéo nam nam nữ unisex thời trang BEEGEE 068 - tui deo cheo nam - tui deo cheo nu",74000,150000,76000,51
TIKI,tui-thoi-trang-nam,177561265,"Túi đeo chéo nam cao cấp tích hợp cổng sạc USB ngoài 208211",69300,78785,9485,12
TIKI,tui-vi-nu,185902139,"Túi xách nữ cao cấp da thật ELLY – ET132",1689350,2599000,909650,35
TIKI,tui-vi-nu,210414307,"Túi Xách Đeo Chéo Nữ Thời Trang Cao Cấp Đường May Đẹp LH115",799000,799000,0,0
TIKI,tui-thoi-trang-nam,21980324,"Ví nam da bò sang trọng Huy Hoàng",559000,559000,0,0
TIKI,tui-vi-nu,147479420,"Túi TOTE vải bố dung tích lớn vô cùng lắm chức năng, tiện dụng",79000,79000,0,0
TIKI,tui-thoi-trang-nam,89179125,"Túi đeo chéo messenger FTDCIPAD- túi đeo công sở cao cấp cho nam nữ có nhiều ngăn đựng ipad mini sổ sách a4 điện thoại, làm từ vải oxford chống nước- BH 12 THÁNG",365000,365000,0,0
TIKI,tui-thoi-trang-nam,51832104,"Túi xách da bò nam công sở cao cấp",333000,369000,36000,10
TIKI,tui-thoi-trang-nam,126901993,"Túi Đeo Chéo Nam Da Thật Cao Cấp SUNPOLO STU102 (Đen, Nâu, Nâu Bò)",990000,990000,0,0
TIKI,tui-vi-nu,67490763," Túi đeo chéo nữ mini hoa cúc cực đẹp siêu tiện dụng TX38",59000,59000,0,0
TIKI,tui-thoi-trang-nam,85092653,"Ví cầm tay nam da thời trang dạo phố dạng hộp bảng lớn caro Màu Trơn NKN Tặng móc khóa nam A2",131670,179949,48279,27
TIKI,tui-thoi-trang-nam,51299189,"Túi xách da bò nam công sở cao cấp phong cách châu âu",801000,890000,89000,10
TIKI,tui-vi-nu,164960415,"Túi đeo chéo, đeo vai da cao cấp T0128 Ulzzang chống thấm nước, bền bỉ unisex nam nữ phong cách thời trang, cá tính Hàn",170000,340000,170000,50
TIKI,tui-vi-nu,252009363,"Túi xách nữ đeo chéo màu nâu họa tiết",195000,195000,0,0
TIKI,tui-thoi-trang-nam,14038774,"Cặp Công Sở Thời Trang Yuumy Cayuumy 02",235000,315000,80000,25
TIKI,tui-thoi-trang-nam,94347674," Túi đeo chéo nam da cao cấp Kangaroo - RiBi shop",255000,255000,0,0
TIKI,tui-thoi-trang-nam,253189209,"Túi xách da bò nam công sở cao cấp phong cách châu âu",783000,870000,87000,10
TIKI,tui-thoi-trang-nam,122230271,"Ví Da Nam Cao Cấp Chuẩn Da Bò Sáp Thể Hiện Đẳng Cấp",168000,336000,168000,50
TIKI,tui-thoi-trang-nam,196320293,"Ví Da Nam VD07 Ví Cầm Tay Nam Cao Cấp Sang Trọng Lịch Lãm",48000,80000,32000,40
TIKI,tui-thoi-trang-nam,149179058,"Túi đeo chéo nam da bò cao cấp YILIDAISHU T32 27x25x6cm(Nâu - Đen)",792000,792000,0,0
TIKI,tui-thoi-trang-nam,75998917,"Túi bao tử nam nữ có lỗ tai nghe chống nước chống bụi MIBAG38",74279,101515,27236,27
TIKI,tui-thoi-trang-nam,53598383,"Cặp Xách , Túi Xách Công Sở Thời Trang Nam P099",352000,375000,23000,6
TIKI,tui-thoi-trang-nam,58173294,"Ví Nam Da Cá Sấu. Ví 2 Mặt Đan Viền Thủ Công - Dáng Ngang Dễ Sử Dụng",868000,1291000,423000,33
TIKI,tui-vi-nu,136940052,"COMBO 2 BÓP VÍ THỔ CẨM (CÚ ĐÔI XANH ĐEN)",30000,30000,0,0
TIKI,tui-thoi-trang-nam,192641866,"Túi đeo chéo đeo ngực nam cao cấp phong cách mới",675000,750000,75000,10
TIKI,tui-thoi-trang-nam,149180039,"Túi đeo chéo nam công sở BAODIDAISHU kiểu túi ngang thời trang đựng vừa A4, Ipad da bò cao cấp T74 KT 33x25x7cm",900000,900000,0,0
TIKI,tui-thoi-trang-nam,21560454,"Túi Xách Công Sở NamMikkor The Ralph Briefcase",690000,690000,0,0
TIKI,tui-thoi-trang-nam,180000878,"Túi Đeo Chéo Nam Mini BT06 Da Bò Tiện Dụng Phù Hợp Đi Chơi Đi Làm Đầy Cá Tính",235000,450000,215000,48
TIKI,tui-vi-nu,149179313,"Túi xách tay, đeo chéo nữ thời trang kiểu dáng from túi đứng DA BÒ cao cấp KT: 32x28x12cm (Đỏ-Đen-Da bò)",432000,432000,0,0
TIKI,tui-vi-nu,171889639,"Túi hộp cặp lồng mini trần trám da mềm cao cấp Mimo baby TC04",429000,429000,0,0
TIKI,tui-thoi-trang-nam,197459903,"ví nam ví nam clutch cầm tay cao cấp",270000,299000,29000,10
TIKI,tui-thoi-trang-nam,176753345,"Ví Da Nam Bóp Da Nam Cao Cấp EINHORN EI03",135000,200000,65000,33
TIKI,tui-thoi-trang-nam,106659595,"TÚI ĐEO CHÉO NAM DA (ĐEN) NU3 KDR-TDC288",123750,169125,45375,27
TIKI,tui-thoi-trang-nam,143038636,"Ví dài da bò Anh Tho Leather - BD19",459000,475000,16000,3
TIKI,tui-vi-nu,251535029,"Túi Da Đeo Chéo Dáng Hộp Cao Cấp ZKH01",370000,370000,0,0
TIKI,tui-thoi-trang-nam,177145864,"Ví Da Nam Bóp Da Nam Cao Cấp EINHORN EI04B",226000,330000,104000,32
TIKI,tui-vi-nu,251735924,"Túi đeo chéo viền lông sang chảnh",149000,149000,0,0
TIKI,tui-vi-nu,115564410,"Túi vải TOTE SUNNY thiết kế - ĐỘC QUYỀN",55000,55000,0,0
TIKI,tui-vi-nu,197568139,"Ví dài nữ thời trang",179000,179000,0,0
TIKI,tui-vi-nu,191133623,"Túi Cói, Túi Xách Cỏ Bàng Vẽ Hoa Hồng Baby Xinh Xắn-Giỏ Cỏ Bàng TXCBVHHBBLTK06",329000,329000,0,0
TIKI,tui-thoi-trang-nam,74886398,"Ví da thật phom ngang đựng name card LATA LVN76 nhiều màu (DàI 8cm x Rộng 0.5cm x Cao 11.5cm)",210000,210000,0,0
TIKI,tui-thoi-trang-nam,177145223,"Ví Da Nam Bóp Da Cao Cấp Sang Trọng EINHORN EI05B",226000,330000,104000,32
TIKI,tui-vi-nu,173168563,"Túi vải bố, Túi vải Canvas trơn màu trắng không khóa kéo",21000,21000,0,0
TIKI,tui-vi-nu,97018406,"Túi vải Túi đeo chéo Canvas nam nữ học sinh sinh viên đi học đi chơi thời trang Hàn Quốc",159000,159000,0,0
TIKI,tui-vi-nu,143302874,"HJ6430-31-32-33 - Túi xách nữ da đà điểu Huy Hoàng đeo chéo màu đen, nâu đất, vàng, nâu đỏ",4199000,4199000,0,0
TIKI,tui-vi-nu,7695713,"Ví Nữ Thời Trang Họa Tiết Chiếc Lá",61999,61999,0,0
TIKI,tui-vi-nu,147962291,"Túi cam trong suốt",427200,712000,284800,40
TIKI,tui-vi-nu,137154424,"Túi Tote Đeo Chéo Vải Hình Chữ Nhật BK01",64000,64000,0,0
TIKI,tui-vi-nu,149449478,"Túi đeo chéo nữ, túi đeo bụng - đeo ngực, deo vai chất da xịn xò hottrend",162000,162000,0,0
TIKI,tui-vi-nu,22195106," VÍ ĐỰNG CARD - 9507591ROS",490000,490000,0,0
TIKI,tui-vi-nu,91634901," Clutch dự tiệc sequin đính đá sang cực",390000,390000,0,0
TIKI,tui-vi-nu,109853121,"Túi Tote, Túi Đeo Vai - Kiểu Dáng Độc Đáo - Cá Tính - Bền Đẹp - MS31",38000,38000,0,0
TIKI,tui-vi-nu,46259854,"Ví nữ cầm tay chính hãng HANHSON SP000628 Xanh Dương vân EPI",1095000,1095000,0,0
TIKI,tui-thoi-trang-nam,149179264,"Túi xách cặp da bò đựng laptop 14 inch công sở T13 40x30x9cm (Nâu)",900000,900000,0,0
TIKI,tui-vi-nu,107709968,"Túi đeo điện thoại chính hãng Noble, chất liệu vải dù chống nước siêu bền, bảo hành 2 năm. Mã N100BON",175000,175000,0,0
TIKI,tui-vi-nu,1995345,"Túi Xách Da Đà Điểu Huy Hoàng HT6404 (32 x 25 cm) - Nâu Đất",8999000,8999000,0,0
TIKI,tui-vi-nu,182812708,"Túi xách nữ Monogram Canvas ELLY – EL199",1699000,1699000,0,0
TIKI,tui-vi-nu,169050429,"Đá muối himalaya loại cong- món quà đầy ý nghĩa",465000,465000,0,0
TIKI,tui-thoi-trang-nam,68303291,"Cặp văn phòng laptop đeo chéo đeo vai 4 kiểu phong cách mới MN4 Tặng móc khóa nam cao cấp",127710,174537,46827,27
TIKI,tui-vi-nu,176150375,"Túi Xách Nữ Gence Da Bò Cao Cấp TX12",1890000,1890000,0,0
TIKI,tui-vi-nu,188229480,"Túi Xách Nữ Cầm Tay Da Cao Cấp 2 Kiểu Dây Đa Phong Cách tiện đi Làm, Sự Kiện, Cafe - Màu xanh dương, Size 28cm [Bao đổi trả].",909000,909000,0,0
TIKI,tui-vi-nu,166530401,"Túi xách nữ da bò thật dập vân cá sấu đeo chéo có 2 màu nâu/đen thủ công bằng tay hình thật shop tự chụp",4299000,4299000,0,0
TIKI,tui-thoi-trang-nam,481722,"Túi Đeo Chéo Ipad Mikkor Betty Tablet BT004 - Xám Nhạt",249000,249000,0,0
TIKI,tui-thoi-trang-nam,109126639,"Ví nam da bò chân kim da bò thật, Bóp ngang nam da bò chân kim",199000,199000,0,0
TIKI,tui-vi-nu,120504845,"HC3201-02-03-07 - Bóp nữ da Huy Hoàng 3 gấp gai màu vàng bò, đen, nâu đỏ, nâu đất",2299000,2299000,0,0
TIKI,tui-vi-nu,185882439,"Túi Xách Nữ Túi Xách Hàn Quốc ZL124 Da Thật Cao Cấp FullBox Size 33cm (BH 12 tháng) Thích Hợp Làm Quà Tặng, Sinh Nhật",3200000,3200000,0,0
TIKI,tui-vi-nu,206988838,"Túi xách đẹp, Phải tịnh tâm mới có người yêu, mã LV4. Quà tặng cao cấp cho gia đình, nam nữ cặp đôi, hội nhóm, doanh nghiệp",109000,109000,0,0
TIKI,tui-vi-nu,140208804,"Khóa bảo mật TigerNu dành cho balo, túi xách an toàn chắc chắn PK01",129600,180000,50400,28
TIKI,tui-vi-nu,206987767,"Túi xách WHALE, mã G274. Quà tặng cao cấp cho gia đình, nam nữ cặp đôi, hội nhóm, doanh nghiệp",109000,109000,0,0
TIKI,tui-vi-nu,122480440,"Túi Xách Nữ Kiểu Dáng Công Sở Dễ Thương Phối Móc Khóa Nơ  MS011",265050,279000,13950,5
TIKI,tui-vi-nu,120525207,"Bóp nữ da cá sấu Huy Hoàng nhiều ngăn màu vàng bò, đen, nâu đỏ, nâu đất HC3212-13-14-70",2999000,2999000,0,0
TIKI,tui-vi-nu,128292212,"Ví We Bare Bears",75000,75000,0,0
TIKI,tui-vi-nu,177279678,"Túi xách nữ thời trang cao cấp thời trang HỒNG KÔNG – BEE GEE TN1004",300000,600000,300000,50
TIKI,tui-vi-nu,192880502,"Ví nữ cầm tay dáng đứng YUUMY Ripple YV75 - ngẫu nhiên",89000,190000,101000,53
TIKI,tui-vi-nu,270807598,"Ví nữ nhỏ thiết kế đơn giản - tiện lợi BSB1083",2000000,2000000,0,0
TIKI,tui-vi-nu,84712490,"SẴN HÀNG: Túi đeo vai (Túi hộp tròn) GU Nhật Bản + Tặng kèm khẩu trang UV",320000,320000,0,0
TIKI,tui-vi-nu,498066,"Túi Xách Nữ Mikkor The Betty Pretty TBP005 - Tím Hoa Cà",249000,249000,0,0
TIKI,tui-vi-nu,119329300,"Túi Đeo Chéo Nữ Dáng Vuông FOREVER YOUNG Nhiều Ngăn Đựng Điện Thoại, Đựng Tiền Siêu Tiện Dụng",239000,239000,0,0
TIKI,tui-vi-nu,187156659,"Túi đeo chéo NASI T1037 phong cách hàn quốc túi xách nữ đeo vai thời trang dạo phố dễ thương vải đẹp",59000,59000,0,0
TIKI,tui-vi-nu,71096052,"TÚI  ĐEO CHÉO NỮ MÀU XANH",69000,69000,0,0
TIKI,tui-vi-nu,147832125,"Túi xách nữ công sở đeo vai kiểu dáng đơn giản, thanh lịch phong cách Hàn Quốc",199000,199000,0,0
TIKI,tui-vi-nu,160315096,"Ví Nữ Ngắn Mini Cầm Tay Chính Hãng TAILIAN Gấp 2 Nhỏ Gọn Da Cao Cấp Cực Đẹp Giá Rẻ TL09 - Micocah Mall",99000,99000,0,0
TIKI,tui-vi-nu,136940089,"Bóp thổ cẩm đựng tiền (cb)",12000,12000,0,0
TIKI,tui-vi-nu,184914089,"Túi xách nữ thời trang công sở cao cấp phong cách mới – TN1007",277000,560000,283000,51
TIKI,tui-vi-nu,53026962,"Túi đeo chéo bao tử da cao cấp loại 1 dạo phố  SK 25 Shalla",94333,136259,41926,31
TIKI,tui-vi-nu,55456785,"VÍ NỮ MINI GẬP GỌN SIÊU XINH V07",125000,250000,125000,50
TIKI,tui-vi-nu,113499862,"Túi Cói Merci Đi Biển Cao Cấp Có Lớp Lót Và Đế",65980,65980,0,0
TIKI,tui-vi-nu,195279709,"Túi Giỏ Xách Đan Tay Xéo Lớn Quai Gỗ Vintage Hàng Xuất Khẩu Đi Chơi Đi Biển Chụp Hình Quà Tặng",179000,179000,0,0
TIKI,tui-vi-nu,81363674,"Túi đeo chéo nữ thời trang cao cấp Hàn Quốc TN120",99000,99000,0,0
TIKI,tui-vi-nu,173989729,"Phụ kiện túi vải Yuumy cỡ lớn YBVLL",20000,20000,0,0
TIKI,tui-vi-nu,173682708,"Vỏ Bọc Hộ Chiếu (Passport) Trong Suốt Có Khe Kẹp Vé Thẻ ATM Bền Bỉ Tiện Dụng",2999,2999,0,0
TIKI,tui-vi-nu,177736657,"Ví dài nữ cầm tay chính hãng TOMICMIC đựng tiền nhiều ngăn phong cách Hàn Quốc da cao cấp TL39",139000,139000,0,0
TIKI,tui-vi-nu,47215591,"Túi xách nữ cao cấp da thật ELLY – ET87",2999000,2999000,0,0
TIKI,tui-vi-nu,73286081,"Túi vải Tote đeo vai nữ - phong cách Hàn Quốc dễ thương",40000,40000,0,0
TIKI,tui-vi-nu,193978950,"Túi Xách Nhựa Trong Suốt In Hình Chuột Dễ Thương Dành Cho Nữ - JL",79000,79000,0,0
TIKI,tui-vi-nu,75315857,"Ví thời trang tiện ích HARAS HR274",65000,65000,0,0
TIKI,tui-vi-nu,58988607,"Ví Da Thật 100% Đựng Thẻ, Name Card Tiện Dụng - Hàng Chính Hãng",54000,54000,0,0
TIKI,tui-vi-nu,151898395,"Túi Tote Vải Canvas Nữ Ulzzang Hot Trend Kita Unisex - Mẫu Smilei - Ảnh thật",38900,38900,0,0
TIKI,tui-vi-nu,196552250,"Túi vải dây rút thời trang iBasic TUIVAI002",69000,69000,0,0
TIKI,tui-vi-nu,195279744,"Túi Giỏ Xách Đan Tay Quai Gỗ Vintage Hàng Xuất Khẩu Thủ Công Đi Chơi Đi Biển Chụp Hình Làm Quà Tặng GX02",145000,145000,0,0
TIKI,tui-vi-nu,149184236,"TÚI CÓI SIZE TO IN HÌNH NỮ HOÀNG TNX 502",56050,59000,2950,5
TIKI,tui-vi-nu,152015309,"Túi Tote Túi Vải Trơn Chất Canvas Dày Dặn",155000,155000,0,0
TIKI,tui-vi-nu,170463614,"Túi Xách Nữ Đẹp Đeo Chéo Thời Trang BEE GEE TN1002",230000,460000,230000,50
TIKI,tui-vi-nu,24988605,"Ví cầm tay nữ cao cấp",262000,262000,0,0
TIKI,tui-vi-nu,157479001,"Túi Ví Nữ Đeo Chéo Nhiều Ngăn Với Ngăn Đựng Điện Thoại Trong Suốt Túi Để Chơi Tết - N8621",197000,249000,52000,21
TIKI,tui-vi-nu,157551295,"Bóp ví nữ cầm tay mini V038 trơn nhiều ngăn nhỏ gọn phong cách đơn giản, thời trang, dễ thương",45000,90000,45000,50
TIKI,tui-vi-nu,48583096,"Túi Tote Vải Đeo Chéo, Túi Đeo Vai Hàn Quốc Hình PIGGY Siêu Đáng Yêu, Túi Xách Nữ Đeo Nhiều Kiểu Đi Học, Đi Chơi Tiện Dụng - OTV135 - Ope Store",108000,108000,0,0
TIKI,tui-vi-nu,12482159,"Túi xách nữ thời trang cao cấp ELLY EL129",1499000,1499000,0,0
TIKI,tui-vi-nu,134754462,"Túi tote đeo vai vải bố canvas trơn T014 nữ logo hình lá đựng đồ đi học, đi chơi mềm đẹp",48000,96000,48000,50
TIKI,tui-vi-nu,164961811,"Túi đeo chéo, đeo vai nữ mini da cao cấp T0131 Basic chống thấm nước, bền bỉ phong cách thời trang Hàn",180000,360000,180000,50
TIKI,tui-vi-nu,88826253,"TÚI ĐEO CHÉO NỮ MINI ĐÁNG YÊU FALDO PHONG CÁCH HÀN QUỐC",69000,69000,0,0
TIKI,tui-vi-nu,68109855,"Ví nữ cầm tay nhiều ngăn tiện dụng, họa tiết hình chiếc lá sang trọng TK0058",59000,100000,41000,41
TIKI,tui-vi-nu,137154462,"Túi Vải Đeo Chéo Canvas In Hình Just Be YourSelf Phong Cách Ulzzang",59000,59000,0,0
TIKI,tui-vi-nu,74887030,"Ví Cầm Tay Unisex Thời Trang LATA VN44 Nhiều Màu (Dài 22cmxRộng 3cmxCao 12cm)",420000,420000,0,0
TIKI,tui-vi-nu,43694794,"Túi xách nữ thời trang cao cấp Đồ Da Thành Long TLG 208218",213000,213000,0,0
TIKI,tui-vi-nu,100479434,"Túi Xách Nữ Đeo Chéo 2 dây đeo vai tiện lợi Dáng Túi Công Sở Da Mềm 2 Qoai Thay Đổi - SIÊU HOT 2021",99000,99000,0,0
TIKI,tui-vi-nu,186120429,"Túi Đeo Chéo Mini Cho Nữ Dễ Thương Phong Cách Nhật Bản, Túi Xách Nữ Cute Nhiều Màu Sắc",55000,55000,0,0
TIKI,tui-vi-nu,196687257,"Túi Tote Nữ Kẹp Nách Kích Thước Lớn 37x30x10.5 cm Đựng Vừa Mọi Laptop Cỡ Lớn Da Mềm Phong Cách Hàn Quốc Jess85",215000,215000,0,0
TIKI,tui-vi-nu,43112097,"Túi Da Thật Kat – Jane",2060000,2060000,0,0
TIKI,tui-vi-nu,10773176,"Túi Xách Nữ Đeo Vai Dây Xích Da",155000,155000,0,0
TIKI,tui-vi-nu,95993549,"Túi xách nữ công sở Gianni conti Italy 493204",5900000,5900000,0,0
TIKI,tui-vi-nu,4216983,"Bóp ví nữ cầm tay Timall TM-Vinu03 phong cách châu Âu",98000,98000,0,0
TIKI,tui-vi-nu,188321409,"Túi xách đeo chéo nữ vải dù chống nước cao cấp size 24cm TUI-49",139000,139000,0,0
TIKI,tui-vi-nu,187843405,"Túi Xách Nữ Đa Phong Cách Vừa Cầm Tay, Đeo chéo Da Cao Cấp - Túi Đi Gọn, Nhẹ Đi Tiệc, Đi Du Lịch, Cafe, Đi Làm Vừa Đẹp, Sang, Xinh [Size 28cmx11x21]",798000,798000,0,0
TIKI,tui-vi-nu,175107410,"Túi Vải Nữ Đeo Chéo Mini Đẹp, Túi Xách Mini, Túi Xách Nữ Nhỏ Gọn Nhiều Màu Xinh - OTV134 - Ope Store",90000,90000,0,0
TIKI,tui-vi-nu,174145938,"Túi Cói, Túi Lục Bình Đính Hoa Cúc Chuẩn Đẹp, Túi Xách Dự Tiệc, Giỏ Đi Làm",289000,289000,0,0
TIKI,tui-vi-nu,193395522,"Túi Xách Nữ Đeo Vai, Cầm Tay Da Bò Thật, Túi mới hợp thời trang, Phong Cách túi thời trang phù hợp với tất Phong Cách SangTrọng Tiện dụng đựng nhiều đồ  Túi đeo chéo Size 27cmX12.5cmX20cm",879000,879000,0,0
TIKI,tui-vi-nu,248639526,"Túi Xách Nữ Đeo Chéo Telfar Có Hộp Hàng Đẹp Chuẩn Cao Cấp Nhiều Màu",530375,530375,0,0
TIKI,tui-vi-nu,143321669,"HJ6457-58-59-60 - Túi hộp đeo chéo nữ da đà điểu màu đen, nâu đất, vàng bò, nâu đỏ",6299000,6299000,0,0
TIKI,tui-vi-nu,149449578,"Túi Xách Nữ Trần Trám Dây Chuông Chất Đẹp - Túi Đeo Chéo Cầm Tay , Có Quai Xách Khóa Xoay - Hàng Quảng Châu Siêu Hót",509000,509000,0,0
TIKI,tui-vi-nu,247745649,"Túi Xách Nữ ️️ Túi Nữ Da Mềm LUXURY thời trang, trẻ trung năng động mã số LUXURYBAG9650196",65280,65280,0,0
TIKI,tui-vi-nu,152548102," Túi Tote Attitude SIÊU HOT HIT phong cách Hàn Quốc",65000,65000,0,0
TIKI,tui-vi-nu,57811376,"Túi xách nữ đẹp sang trọng, chất da vân cao cấp ",99000,99000,0,0
TIKI,tui-vi-nu,72623990,"Túi cói đi biển, túi đeo chéo nữ, túi cói có tay vuông nhỏ xinh 03",220000,220000,0,0
TIKI,tui-vi-nu,184071708,"Túi xách nữ /1992 s t u d i o/ DIAGAN BAG/ màu đen kẹp nách dây da bản lớn cá tính",590000,590000,0,0
TIKI,tui-vi-nu,8280638,"Túi Vải Canvas - Save Water Drink Wine",121000,169000,48000,28
TIKI,tui-vi-nu,87833902,"TÚI ĐEO CHÉO NỮ TRẦN TRÁM NẮP GẬP SIÊU HOT TTS 484",75000,75000,0,0
TIKI,tui-vi-nu,75418475,"Ví ngắn cầm tay thêu viền - giao màu ngẫu nhiên",85000,85000,0,0
TIKI,tui-vi-nu,69322260,"Túi Nữ Đeo Chéo Hình Vịt Con Dễ Thương",45000,45000,0,0
TIKI,tui-vi-nu,84086144,"Túi đeo chéo nữ vải tone phối vải độc đáo, thời trang phong cách trẻ",50000,50000,0,0
TIKI,tui-vi-nu,54986343,"Túi nữ cao cấp da thật ELLY- ET111 đen",2399000,2399000,0,0
TIKI,tui-vi-nu,188033574,"Móc khóa gấu bông treo balo túi xách siêu xinh giá cực rẻ",15000,15000,0,0
TIKI,tui-vi-nu,21943619,"Túi Tote Túi Vải Nữ Túi Đeo Chéo Nữ Hàn Quốc Bằng Vải Dù Nhiều Màu",58000,58000,0,0
TIKI,tui-vi-nu,185468121,"bóp ví nữ mini cầm tay hàng hiệu Baellerry gập hai họa tiết caro đựng giấy tờ, thẻ - NR085",128000,219000,91000,42
TIKI,tui-vi-nu,32862548,"Túi Xô, Túi Đeo Chéo Nữ Thời Trang Màu Trơn HN022",285000,285000,0,0
TIKI,tui-vi-nu,104799906,"Túi Xách Âm Nhạc",99000,99000,0,0
TIKI,tui-vi-nu,134254908,"Túi xách vải dù chống nước Oxford nhiều ngăn đi chợ du lịch đa năng",200000,200000,0,0
TIKI,tui-vi-nu,134749328,"Túi tote đeo vai vải bố canvas trơn T036 nữ đựng đồ đi học, đi chơi mềm đẹp",49000,98000,49000,50
TIKI,tui-vi-nu,206988066,"Túi xách cho người yêu mèo, Less People More Cats, mã G266. Quà tặng cao cấp cho gia đình, nam nữ cặp đôi, hội nhóm, doanh nghiệp",109000,109000,0,0
TIKI,tui-vi-nu,53983416,"TÚI XÁCH NỮ HAI QUAI XÁCH DA MỀM màu kem",299000,299000,0,0
TIKI,tui-vi-nu,172192210,"Túi Xách Nữ Thời Trang Cao Cấp  208079-5(Đỏ) tặng túi đựng mỹ phẩm tiện lợi",40000,40000,0,0
TIKI,tui-vi-nu,202997335,"Túi xách đeo chéo nữ nhiều ngăn tiện dụng, chống thấm nước siêu bền đẹp size 24cm TUI-107",139000,139000,0,0
TIKI,tui-vi-nu,147477859,"Túi TOTE chuột đáng yêu dung tích lớn đa chức năng dùng để đi học, đi chơi",85000,85000,0,0
TIKI,tui-vi-nu,24838211,"Túi đeo vai nữ cổ điển  TĐ404 Shalla",134640,194480,59840,31
TIKI,tui-vi-nu,70906842,"Túi cói bán nguyệt thắt nơ ren sang trọng",180000,180000,0,0
TIKI,tui-vi-nu,86561105," Túi đeo chéo nữ  ?  Túi xách Nữ Vân Da Nổi SANG - XỊN TD07",100000,100000,0,0
TIKI,tui-vi-nu,107962225,"Ví Nữ, Ví Nữ Cầm Tay, Ví Mini, Ví Dự Tiệc, Ví Tiện Dụng Nữ Thời Trang",190800,190800,0,0
TIKI,tui-vi-nu,164266267,"Túi vải không dệt 100 túi",28000,28000,0,0
TIKI,tui-vi-nu,8280243,"Túi Vải Canvas - Một Ngày Không Sun Sea",121000,169000,48000,28
TIKI,tui-vi-nu,91421157,"Ví con vật",127000,127000,0,0
TIKI,tui-vi-nu,14867339,"Ví Cầm Tay Nữ Cao Cấp VCT305",159000,159000,0,0
TIKI,tui-vi-nu,145172206,"Ví cầm  tay nữ",50000,50000,0,0
TIKI,tui-vi-nu,115495554,"Túi đeo chéo nữ  Túi xách nữ Da Trơn Quảng Châu sang chảnh Siêu HOT T22",62000,62000,0,0
TIKI,tui-vi-nu,140917582,"Túi đeo chéo cói",150000,150000,0,0
TIKI,tui-vi-nu,159438389,"Ví nữ, Ví cầm tay, ví đa năng, ví da cao cấp, ví nam, ví da nam cao cấp, ví nam cầm tay, ví unisex, ví đựng tiền",167000,167000,0,0
TIKI,tui-vi-nu,164287436,"Túi chiến thuật mẫu mới 2020",80000,80000,0,0
TIKI,tui-vi-nu,206715482,"Túi xách tote, HAWAII, mã G65. Quà tặng cao cấp cho gia đình, nam nữ cặp đôi, hội nhóm, doanh nghiệp",109000,109000,0,0
TIKI,tui-vi-nu,184933525,"Dây xích túi xách phụ kiện dây đeo chéo túi xách cho bạn nữa",28000,28000,0,0
TIKI,tui-vi-nu,181097679,"Túi cách nữ MONOGRAM CANVAS ELLY – EL202",799500,1599000,799500,50
TIKI,tui-vi-nu,108239781,"Ví Da Nam Nữ Đựng Thẻ Handmade Lealux Holder Handmade 1",539000,539000,0,0
TIKI,tui-vi-nu,204615396,"Túi Xách Da Bò Thời Trang Công Sở Cho Nữ Đeo Chéo Đeo Vai Hàng Hiệu MX046",1100000,1100000,0,0
TIKI,tui-vi-nu,157479120,"[FREESHIP]bóp ví đeo chéo nữ ngăn đựng điện thoại trong suốt cắm sạc được, không cần lấy ra - N5015",157000,229000,72000,31
TIKI,tui-vi-nu,136940166,"Ví vải hoa chống nước 3 khoá 7 màu( được chọn màu )",50000,50000,0,0
TIKI,tui-vi-nu,73261918,"Ví Cầm tay dạo phố bảng to mini sang trọng siêu năng kẹp nút Bi Tròn VGG 1 Tặng móc khóa cá heo",117810,161007,43197,27
TIKI,tui-vi-nu,91138583,"JUNO Túi Xách Nhỏ TXN472",682000,682000,0,0
TIKI,tui-vi-nu,134640750,"Túi đeo chéo , balo nữ đẹp đi chơi thời trang giá rẻ - TDC02",83490,83490,0,0
TIKI,tui-vi-nu,1995337,"Túi Xách Da Trăn Huy Hoàng HT6301 (20 x 37 cm)",4999000,4999000,0,0
TIKI,tui-vi-nu,172191582,"Túi Nữ Kẻ Sọc Thời Trang Phong Cách Cá Tính + Tặng Kèm Móc Thành Long TLG 205970",57200,79000,21800,28
TIKI,tui-vi-nu,184071756,"Túi xách nữ/ 1992 s t u d i o/ LELAH BAG/ màu đen đơn giản",550000,550000,0,0
TIKI,tui-vi-nu,52691343,"Túi da đeo chéo nữ nắp phong thư",55000,55000,0,0
TIKI,tui-vi-nu,209414065,"Ví bóp nữ cầm tay hai dây kéo hai khóa họa tiết kim tuyến giá rẻ cầm mềm tay VKT200",108000,108000,0,0
TIKI,tui-vi-nu,142989417,"HJ3738-39-40-41 - Ví nữ da cá sấu Huy Hoàng nhiều ngăn gai cầm tay màu đen, nâu đỏ, vàng, nâu đất",4199000,4199000,0,0
TIKI,tui-vi-nu,2365767,"Ví Nữ Da Đà Điểu 1 Khóa Vip Huy Hoàng HT3438 (19 x 10,5 cm) - Xanh Lá",1399000,1399000,0,0
TIKI,tui-vi-nu,149179210,"Túi xách tay nữ da bò Hàn Quốc size lớn ( 32x29x12cm) - ĐỰNG GIÁO ÁN, HỒ SƠ, TÀI LIỆU",432000,432000,0,0
TIKI,tui-vi-nu,138870789,"Túi xách nữ thời trang Đầu rồng Vân rắn Đeo chéo đeo vai Dáng công sở sang chảnh màu đen Ba ngăn Khóa đồng",196000,196000,0,0
TIKI,tui-vi-nu,147941796,"Túi Xách Đeo Chéo Nữ Kẹp Nách Chính Hãng MICOCAH Dáng Công Sở Thời Trang Đi Làm Đi Chơi Da Cao Cấp Cực Đẹp MC21 - Tukado",389000,389000,0,0
TIKI,tui-vi-nu,53393516,"Túi đeo chéo Thỏ dễ thương",140000,140000,0,0
TIKI,tui-vi-nu,210414181,"Túi xách nữ đẹp giá rẻ công sở thời trang đi làm dự tiệc cao cấp LH18",899000,899000,0,0
TIKI,tui-vi-nu,74623182,"VÍ cầm tay dài Dự tiệc đa năng ép chữ mẫu mới GH55 Tặng móc khóa cá heo",83160,120120,36960,31
TIKI,tui-vi-nu,196425447,"Túi cói xách tay form to mẫu mới",120000,120000,0,0
TIKI,tui-vi-nu,179438382,"Túi Đeo Chéo Vải Canvas Cỡ Lớn Thời Trang Nam Nữ Đi Học Đi Chơi – Túi Tote Phong Cách ULZZANG Đựng Đồ Du Lịch",139000,139000,0,0
TIKI,tui-vi-nu,171668670,"Túi Vải Canvas Trung Nguyên Legend",65000,65000,0,0
TIKI,tui-vi-nu,186710618,"Túi đeo chéo Peach Juice NASI T1024 phong cách hàn quốc túi đeo vai nữ thời trang dạo phố dễ thương vải đẹp",39000,39000,0,0
TIKI,tui-vi-nu,206990610,"Túi xách đẹp, Đâu cũng được miễn là đi cùng nhau, mã LV5. Quà tặng cao cấp cho gia đình, nam nữ cặp đôi, hội nhóm, doanh nghiệp",109000,109000,0,0
TIKI,tui-vi-nu,146944704,"Túi tote vải canvas nữ đẹp đeo chéo đi học nhỏ gọn cute dễ thương giá rẻ TV08",74700,74700,0,0
TIKI,tui-vi-nu,194025676,"Túi xách da cá sấu có quai đeo rất tiện lợi!",3300000,5500000,2200000,40
TIKI,tui-vi-nu,187927431,"Túi Xách ,Túi Đeo Vai Nữ Thời Trang Trẻ _ KN236",65000,65000,0,0
TIKI,tui-thoi-trang-nam,186254687,"Túi đeo chéo Thời Trang cao cấp – 1400",139000,280000,141000,50
TIKI,tui-thoi-trang-nam,186208860,"Túi xách nam công sở, cặp da nam đựng laptop và tài liệu cao cấp GCE23",2800000,2800000,0,0
TIKI,tui-thoi-trang-nam,152868978,"Clutch Nam Ví Da Cầm Tay Thời Thượng GENCE HT02 Da Bò Cao Cấp Màu Đen",1600000,1600000,0,0
TIKI,tui-thoi-trang-nam,136313446,"Cặp Da Công Sở Túi Xách Nam GENCE GCE14 Chất Liệu Da Bò Cao Cấp Màu Đen Có Dây Đeo Vai",2400000,2400000,0,0
TIKI,tui-thoi-trang-nam,847441,"Túi Đeo Chéo Nam Chống Trộm HARAS HRTK196 (31 x 18 cm) - Đen",170000,170000,0,0
TIKI,tui-thoi-trang-nam,12302486,"Cặp đeo chéo in logo MU",235000,250000,15000,6
TIKI,tui-thoi-trang-nam,95394027,"Túi đeo chéo Army cao cấp (kèm hình thật kế bên) 208128",95600,113000,17400,15
TIKI,tui-thoi-trang-nam,76157012," capdakhoaso1 - Nhận hàng sau 9 ngày",970000,970000,0,0
TIKI,tui-thoi-trang-nam,173542322,"Ví Da Bò Nam Cao Cấp Hàng Hiệu POLO MEISDO (Da Thật 100%) Full Hộp Phù Hợp Làm Quà Biếu Tặng Sinh Nhật Bảo Hành 24 Tháng",1200000,1200000,0,0
TIKI,tui-thoi-trang-nam,181794255,"Cặp da nam công sở cao cấp _ Cặp đựng laptop T19 38x27x6cm",315000,315000,0,0
TIKI,tui-thoi-trang-nam,184300240,"Túi Nam Đeo Chéo Đeo Hông Da Bò BT04 Cực Hot",259000,518000,259000,50
TIKI,tui-thoi-trang-nam,91447658,"Cặp Túi Da Nam C70",1404000,1404000,0,0
TIKI,tui-thoi-trang-nam,184787634,"Túi da bò đựng laptop cao cấp",2490000,2490000,0,0
TIKI,tui-thoi-trang-nam,74775350," Bóp Ngang Gai Lưng Cá Sấu 2 Mặt Đan Viền Rất Đẹp VS2V01",818000,1291000,473000,37
TIKI,tui-thoi-trang-nam,89786103,"Túi Đeo Chéo Nam Khóa Phản Quang Phong Cách Streetwear, Túi Bao Tử Nam Kháng Nước TC98",74250,101475,27225,27
TIKI,tui-vi-nu,144613795,"Túi đeo chéo nữ -túi đeo chéo đựng điện thoại khoá sập 20",120000,120000,0,0
TIKI,tui-thoi-trang-nam,77703757,"Túi Đeo bao tử, nịt bụng đeo chéo đa năng cao cấp ngang kéo Tian GG032 Tăng móc khóa nam cao cấp",78210,106887,28677,27
TIKI,tui-thoi-trang-nam,201359129,"Cặp da đứng Công sở khóa số Boshi 68008 Đen",2600000,2600000,0,0
TIKI,tui-thoi-trang-nam,249743040,"Ví Cầm Tay Nam Da Bò Thật CT01 Cao Cấp Sang Trọng Nhiều Ngăn Đựng Điện Thoại Bóp Dài Nam Kiểu Dáng Hàn Quốc",260000,260000,0,0
TIKI,tui-thoi-trang-nam,188996094,"Bao da dành cho Chìa Khóa Honda SH 2021 (2 nút bấm), SH 2022, SH 350i, SH Mode, Lead, Cub, Winner X, AB 2022, PCX 160, Vario 160",130000,130000,0,0
TIKI,tui-thoi-trang-nam,147921525,"Túi Đeo Chéo Nam BT05 Kiểu Dáng Bao Tử Trẻ Trung Hiện Đại",259000,480000,221000,46
TIKI,tui-vi-nu,13419358,"Ví Nữ Thời Trang Khóa Kim Loại Hình Chữ V-HN002",62000,62000,0,0
TIKI,tui-thoi-trang-nam,56657787,"Túi đeo chéo JUNIOR COMPANY",319000,319000,0,0
TIKI,tui-thoi-trang-nam,13564408,"Cặp công sở nam da bò BHM9005",1450000,1450000,0,0
TIKI,tui-thoi-trang-nam,205232972,"Bao da dành cho bọc ốp chìa khoá xe ô tô KIA Cerato 2019 2021 da bò nhiều màu khâu thủ công KIA12",170000,170000,0,0
TIKI,tui-thoi-trang-nam,173542432,"Ví Da Bò Nam Cao Cấp Hàng Hiệu POLO MEISDO Sang Trọng ( Da Bò Thật 100%) Làm Quà Biếu Tặng Sinh Nhật BH 2 Năm",1000000,1000000,0,0
TIKI,tui-vi-nu,131338439,"Túi vải bố, Túi vải Canvas trơn màu Đen không khóa kéo",22000,22000,0,0
TIKI,tui-vi-nu,157254226,"Túi Hộp Bút Vuông SAIGON SWAGGER SGS Square Pencil Case-Vừa Máy Tính Casio",99000,99000,0,0
TIKI,tui-vi-nu,152015208,"Túi Đeo Chéo Canvas 2 Lớp Lót Vải Dù Bên Trong",85000,85000,0,0
TIKI,tui-vi-nu,79228358,"Giỏ xách thời trang, túi xách nữ phong cách vintage",250000,250000,0,0
TIKI,tui-thoi-trang-nam,52333333,"Túi Đeo Chéo Thời Trang Hàn Quốc HARAS HR264",150000,150000,0,0
TIKI,tui-vi-nu,43662703,"Ví Da Mini Card Holder Nhỏ Gọn WMV2",226000,226000,0,0
TIKI,tui-vi-nu,20541997,"Ví đựng thẻ,giấy tờ, CMT, ATM, name card SPK211",99000,99000,0,0
TIKI,tui-thoi-trang-nam,84892610,"Túi đeo chéo Clownz",249000,249000,0,0
TIKI,tui-thoi-trang-nam,180730225,"Ví Da Cầm Tay Nam 1 Ngăn Siêu Đẹp Siêu Nam Tính",82000,160000,78000,49
TIKI,tui-thoi-trang-nam,135626167," Ví nam da bò thật VO 041005 ví đứng",198000,198000,0,0
TIKI,tui-vi-nu,95395129,"Túi nữ thời trang phong cách Hàn quốc 205954",34300,38000,3700,10
TIKI,tui-thoi-trang-nam,149756687,"Cặp đựng tài liệu da thật CT002-N",1860000,1860000,0,0
TIKI,tui-vi-nu,249671073,"Túi Xách Nữ Cao Cấp Dáng Vuông Họa Tiết Da Cá Sấu Thời Trang Hàn Quốc Dự Tiệc, Đi Làm Sang Chảnh",90000,90000,0,0
TIKI,tui-vi-nu,87100289,"Balo thời trang, balo đi học, đựng laptop Túi Tote Sinh Viên Chú Gà Sweet balo nữ vải",78000,78000,0,0
TIKI,tui-vi-nu,185674814,"Túi xách vuông đựng đồ trang điểm, lòng túi rộng sức chứa lớn đựng được cả nước hoa, skincare",360000,360000,0,0
TIKI,tui-vi-nu,193056817,"TÚI XÁCH TAY PEEKOO SIÊU TO MÀU XANH HOT TREND CỰC ĐẸP",39000,39000,0,0
TIKI,tui-vi-nu,191775113,"Túi Đeo Chéo Nữ Mini Thời Trang MICOCAH Nhỏ Gọn Dễ Thương Da Cao Cấp Cực Đẹp Đi Chơi Dự Tiệc Sang Trọng MC128 - Micocah",389000,389000,0,0
TIKI,tui-vi-nu,136940047,"Ví lụa thêu cô gái Việt Nam",30000,30000,0,0
TIKI,tui-vi-nu,182098002,"Ví dài nữ khoá kéo L - da bò nhập Ý mềm mại",680000,680000,0,0
TIKI,tui-thoi-trang-nam,194026277,"Clutch nam cầm tay ",2850000,5000000,2150000,43
TIKI,tui-thoi-trang-nam,16278504,"Bóp Ví Nam Da Bò Thật",159000,159000,0,0
TIKI,tui-vi-nu,171653891,"Hộp Đựng Thuốc Siêu Tiện Lợi Mang Đi Du Lịch Hoặc Công Tác",20000,30000,10000,33
TIKI,tui-vi-nu,53300717,"Túi bao tử đeo bụng chất vải siêu hot LA812",99750,99750,0,0
TIKI,tui-vi-nu,77445818," Ví Cầm Tay Nữ - Bóp Cầm Tay Nữ - Ví Dự Tiệc - Bóp Dự Tiệc - Clutch (VI-NU-016-1) MUA NHIỀU GIẢM GIÁ",329000,329000,0,0
TIKI,tui-thoi-trang-nam,157147498,"Bộ khăn Ascot Cổ Điển kèm khăn cài túi - Khăn Quàng Trong Áo Sơ Mi",320000,320000,0,0
TIKI,tui-vi-nu,169354383,"Clutch đi tiệc nhung đính đá cao cấp, sang trọng( kéo xem ảnh thật)",360000,360000,0,0
TIKI,tui-vi-nu,35845564,"Túi Vải Tote XinhStore Hình Mèo",102000,102000,0,0
TIKI,tui-vi-nu,108697252,"Túi xách cầm tay nữ Micocah 2020 size trung, có dây đeo chéo tiện dụng (FSE440) (M364)",420000,420000,0,0
TIKI,tui-thoi-trang-nam,120033038,"Bóp da cá sấu Huy Hoàng nhiều ngăn nguyên con nhiều màu HP3212-13-14-70",2999000,2999000,0,0
TIKI,tui-thoi-trang-nam,164341070,"cặp da văn phòng Cặp da fsd.wg 9032",839000,839000,0,0
TIKI,tui-vi-nu,136940007,"TÚI ĐEO CHÉO THỔ CẨM ĐỰNG ĐIỆN THOẠI",15000,15000,0,0
TIKI,tui-vi-nu,149179149,"Ví cầm tay nữ thời trang Y10 họa tiết 2 màu quai đỏ, đen",55000,55000,0,0
TIKI,tui-vi-nu,147942962,"Ví Nữ Mini Cầm Tay FOREVER YOUNG Dáng Vuông Xinh Xắn Cực Sang Chảnh Da Cao Cấp Cực Đẹp Giá Rẻ FY29 - Tukado",99000,99000,0,0
TIKI,tui-thoi-trang-nam,71902643,"Bộ Đôi Ví Couple Gerbera & Venuta Black Da Thật_HAVIAS",945000,945000,0,0
TIKI,tui-thoi-trang-nam,183088964,"Túi xách tay da bò sáp crazy horse- Cặp đựng Laptop, túi xách công sở",850000,850000,0,0
TIKI,tui-vi-nu,149449401,"TÚI ĐEO CHÉO NỮ HM - Hàng Quảng Châu cao cấp Hot Trend 2021",296000,296000,0,0
TIKI,tui-vi-nu,26329162,"Túi Vải Tote Đeo Chéo Balo Hình Chó Con Hàng Quảng Châu Cực Tốt",79000,79000,0,0
TIKI,tui-vi-nu,136940208,"TÚI ĐEO CHÉO THỔ CẨM LOẠI CÓ CHUÔNG SV",70000,70000,0,0
TIKI,tui-vi-nu,136940016,"Túi thổ cẩm đeo chéo tua rua",60000,60000,0,0
TIKI,tui-vi-nu,101794971,"(New style) Túi cói summer thắt nơ bi",79000,79000,0,0
TIKI,tui-thoi-trang-nam,141304874,"1 TÚI ĐEO NGANG HÔNG CÓ NHIỀU NGĂN ĐỰNG PHỤ KIỆN TIỆN DỤNG HÀNG CAO CẤP LOẠI TỐT",168000,168000,0,0
TIKI,tui-thoi-trang-nam,179941566,"Túi Đeo Chéo Bao Tử Nam Da Bò Thời Trang Hiện Đại Cực Đẹp",180000,360000,180000,50
TIKI,tui-vi-nu,131405315,"Túi xách nữ công sở da mềm phong cách Hàn Quốc da mềm",199000,199000,0,0
TIKI,tui-vi-nu,118036758,"Túi xách đi chùa _ phụ kiện có video",54000,54000,0,0
TIKI,tui-vi-nu,195096554,"Móc khóa hình gấu đính đá xinh xắn - JL",19000,20000,1000,5
TIKI,tui-vi-nu,133933630,"Túi đeo chéo mini dễ thương ️ Hot trend ️ Túi đeo chéo nữ mini thời trang TN78",99000,99000,0,0
TIKI,tui-vi-nu,54480694,"Túi Grand Mini Oxford HAVIAS",350000,350000,0,0
TIKI,tui-vi-nu,106045483,"Túi đeo chéo nữ thời trang đựng điện thoại nhiều ngăn tiện dụng TK0094",69000,100000,31000,31
TIKI,tui-thoi-trang-nam,13645245,"Túi đeo chéo nam nữ unisex thời trang Bee Gee 02 - ĐEN",64000,130000,66000,51
TIKI,tui-vi-nu,157253972,"Ví Nắp Ngắn In Báo SAIGON SWAGGER Journal Short Flap Wallet",390000,390000,0,0
TIKI,tui-vi-nu,53028909,"Túi đeo chéo cao cấp N9 bóng chống nước đa năng KS03 Shalla",88110,120417,32307,27
TIKI,tui-vi-nu,221240424,"TÚI LƯỚI ĐỰNG ĐIỆN THOẠI KHÔNG KÈM PHỤ KIỆN MÓC KHÓA ĐEO CHÉO ĐI BIỂN ĐI CHƠI DẠO PHỐ NỮ NAM UNISEX / NO.4 PHONE BAG",160000,160000,0,0
TIKI,tui-thoi-trang-nam,173542535,"Ví Cầm Tay Da Bò Cao Cấp Hàng Hiệu POLO MEISDO Da Bò Thật 100%",1800000,1800000,0,0
TIKI,tui-vi-nu,95394365," Túi xách nữ thời trang phong cách hàn quốc đẹp nhất 208169",32200,40000,7800,20
TIKI,tui-vi-nu,185882440,"Túi Xách Nữ Túi Xách Hàn Quốc ZL104 Da Thật Cao Cấp FullBox Size 23cm (BH 12 tháng) Thích Hợp Làm Quà Tặng, Sinh Nhật",2800000,2800000,0,0
TIKI,tui-vi-nu,2008985,"Ví Nữ Huy Hoàng HT3105 (9.5 x 19 cm) - Da Bò",699000,699000,0,0
TIKI,tui-vi-nu,174101863,"Túi cỏ bàng chuồn chuồn",550000,550000,0,0
TIKI,tui-vi-nu,118026712,"TÚI ĐI CHÙA # Túi Thêu Thư Pháp Cở Lớn",48000,48000,0,0
TIKI,tui-vi-nu,217092938,"Túi xách len handmade trái dâu đã hoàn thiện",350000,350000,0,0
TIKI,tui-vi-nu,176663901,"Túi Cói Đi Du Lịch Merci Sang Chảnh,Túi Cói Đi Biển",94000,94000,0,0
TIKI,tui-vi-nu,141323463,"Túi đeo vai thời trang nữ đơn giản cỡ lớn siêu đẹp- G6019",127710,127710,0,0
TIKI,tui-vi-nu,160314148,"Hộp carton đựng ví dài TAILIAN hộp quà tặng sang trọng chất liệu cao cấp giá rẻ TL19 - Micocah Mall",12000,12000,0,0
TIKI,tui-vi-nu,86560957,"  + TẶNG GHIM HOA CÚC  Túi đeo chéo - Túi vải Họa Tiết Bò Sữa Phong Cách Hàn Quốc TV16",41000,41000,0,0
TIKI,tui-vi-nu,143695119,"Clutch thời trang đi tiệc- túi xách bán nguyệt ngọc sang chảnh cao cấp( trend mới nhất )",399000,399000,0,0
TIKI,tui-vi-nu,271143860,"Ví dài nữ khóa kéo L vừa điện thoại da bò thật - Pink Ohara",720000,720000,0,0
TIKI,tui-vi-nu,125920447,"Túi Xách Đeo Chéo Nữ Quảng Châu Đẹp Chất Liệu Vải Tote , Du Lịch , Thời Trang",119000,119000,0,0
TIKI,tui-vi-nu,189176737,"Túi cói đeo chéo đính nơ voan bản to siêu xinh cho mẹ và bé TC07 Mimo Baby",250000,250000,0,0
TIKI,tui-vi-nu,144612951,"túi đeo chéo nữ khoá TT 170",140000,140000,0,0
TIKI,tui-vi-nu,184071783,"Túi xách nữ/ 1992 s t u d i o/ MONO BAG/ túi xách công sở/ túi đi học/ túi size lớn/ Canvas phối da",199000,199000,0,0
TIKI,tui-vi-nu,14421908,"Ví Cầm Tay Love Of Nature Cao cấp",44999,44999,0,0
TIKI,tui-vi-nu,177560651,"Túi Nữ túi xách tay Kẻ Sọc Thời Trang Phong Cách Cá Tính 205970",48711,51275,2564,5
TIKI,tui-vi-nu,72137256,"Túi xách nữ đeo chéo nhỏ xinh mini Hàn Quốc",167000,167000,0,0
TIKI,tui-vi-nu,241790438,"TÚI DA THỜI TRANG KHÓA V BẠC CAO CẤP - Y3074",540000,540000,0,0
TIKI,tui-vi-nu,248990013,"PHÔI DÂY ĐỒNG HỒ DA PHÁP",65000,65000,0,0
TIKI,tui-vi-nu,197565028,"Ví cầm tay nữ",179000,179000,0,0
TIKI,tui-vi-nu,76138793,"Ví nữ cầm tay nắp gập mini hoạ tiết caro IDIGO FW2-1225-00",195000,300000,105000,35
TIKI,tui-vi-nu,152548151,"Túi Tote Túi Vải Nữ Canvas đeo chéo Thỏ mini Trắng phong cách Hàn Quốc có dây kéo và ngăn phụ mang được 2 kiểu tiện lợi",65000,65000,0,0
TIKI,tui-vi-nu,71092019,"Túi cói xách tay merci form to",43000,54900,11900,22
TIKI,tui-vi-nu,172192494,"Túi nữ thời trang phong cách Hàn Quốc Đồ Da Thành Long TLG 208098 1(nâu)",40000,40000,0,0
TIKI,tui-vi-nu,13779106,"Túi Xách Thời Trang Quai Chéo - Đen",1092500,1150000,57500,5
TIKI,tui-vi-nu,196225341,"Ví nữ ngắn dạng gập màu trơn, nhiều ngăn đựng thẻ, có nút bấm T1308",15000,15000,0,0
TIKI,tui-vi-nu,147489516,"Túi TOTE tai thỏ dễ thương đa chức năng tiện lợi dễ sử dụng",81000,81000,0,0
TIKI,tui-vi-nu,56363716,"TÚI ĐEO CHÉO DA NỮ THỜI TRANG MADT116",55000,55000,0,0
TIKI,tui-vi-nu,185449802,"Túi tote túi vải canvas quai da bò.",150000,150000,0,0
TIKI,tui-vi-nu,24833055,"Ví , bóp nữ cao cấp có hộp và túi đựng Loai 1",139000,139000,0,0
TIKI,tui-vi-nu,174308540,"TÚI ĐEO CHÉO WINGHOUSE HÀN QUỐC",260000,260000,0,0
TIKI,tui-vi-nu,248057886,"Túi xách nữ/ túi hobo/ chabel hobo 2020",450000,450000,0,0
TIKI,tui-vi-nu,67546228,"Túi vải paint chú hề TX39",86000,86000,0,0
TIKI,tui-vi-nu,173001759,"Ví Nữ Cầm Tay Da Cao Cấp - Ví Cầm Tay - Ví Đựng Tiền 204446",30000,30000,0,0
TIKI,tui-vi-nu,14660367,"VÍ DÀI NỮ KHUY TRÁI TIM XINH TƯƠI P1132 Parisa",25300,92000,66700,73
TIKI,tui-vi-nu,74946003,"Túi tote Túi Vải Bố hình thú 2 răng siêu cưng  Nữ Đi học Balo Ulzzang",64500,64500,0,0
TIKI,tui-vi-nu,174511321,"Túi Xách Nữ Thời Trang Cao Cấp Đồ Da Thành Long TLG 208079 5(Đỏ) tặng túi đựng mỹ phẩm tiện lợi",50000,50000,0,0
TIKI,tui-vi-nu,262392668,"Nam châm bộ - màu đẹp và chắc chắn",30000,30000,0,0
TIKI,tui-vi-nu,147942698,"Túi Xách Nữ Đeo Chéo Đeo Vai Kẹp Nách Chính Hãng MICOCAH Dáng Công Sở Thời Trang Da Cao Cấp Cực Đẹp Giá Rẻ MC08 - Tukado",399000,399000,0,0
TIKI,tui-thoi-trang-nam,149179734,"Túi xách cặp da đựng laptop da bò cao cấp T36 38x27.5x7cm (Nâu đậm - Nâu sáng - Đen) D.HSTORE",1020000,1020000,0,0
TIKI,tui-thoi-trang-nam,5918881,"Combo 2 Túi May Đeo Chéo Thể Thao",109000,109000,0,0
TIKI,tui-thoi-trang-nam,248546677,"Ví nam da bò thật Nappa cao cấp LIDAN, bóp dáng ngang có hộp vintage kèm thiệp đẹp làm quà tặng LD20",459000,459000,0,0
TIKI,tui-thoi-trang-nam,95394269," Túi đeo chéo nam nữ phong cách quân đội Army 208128",111800,111800,0,0
TIKI,tui-thoi-trang-nam,186209258,"Túi xách nam công sở, cặp da nam đựng laptop và tài liệu cao cấp GCE24",2800000,2800000,0,0
TIKI,tui-thoi-trang-nam,84331166,"Ví Nam Đứng Da Cá Sấu Thật CW01-02L",1100000,1100000,0,0
TIKI,tui-thoi-trang-nam,1940615,"Cặp Công Sở Yuumy Cayuumy 03 Đen",235000,315000,80000,25
TIKI,tui-thoi-trang-nam,82874016,"Túi xách nam công sở cao cấp phong cách mới",423000,470000,47000,10
TIKI,tui-thoi-trang-nam,243006575,"Ví Nam Da Bò Kiểu Dáng Đứng Và Dáng Ngang, Ví Nam Độc Lạ Chất Da Thật - Max Độc - Mã V96",299000,299000,0,0
TIKI,tui-thoi-trang-nam,155040273,"Combo Cặp công sở DA CÁ SẤU và ví nam BÀN TAY CÁ SẤU VN1602",1238000,2500000,1262000,50
TIKI,tui-thoi-trang-nam,80946593,"[Da thật] Túi đeo hông, túi bao tử da bò thật Crazy horse TD106 - 100% da bò thật, BH 3 năm",390000,390000,0,0
TIKI,tui-thoi-trang-nam,157254041,"Túi Đeo Chéo Nam,Nữ SAIGON SWAGGER Dynamic Bag-Phối Lưới Đen",350000,350000,0,0
TIKI,tui-thoi-trang-nam,44000845,"Cặp Da Công Sở LATA CA25",720000,720000,0,0
TIKI,tui-thoi-trang-nam,59116682,"Túi Đeo Chéo Chống Nước Mềm Mại Thể Thao SPO1 - Màu Xanh",59423,81211,21788,27
TIKI,tui-thoi-trang-nam,73535303,"Túi đeo chéo Fashion thời trang nam nữ, túi đeo ngực vải Canvas nhiều ngăn tiện ích",42619,58246,15627,27
TIKI,tui-thoi-trang-nam,188994200,"Bao da dành cho Chìa Khoá Ép Phom Lexus handmade da thật (Lexus RX, GX, LX, ES...) 001e",350000,350000,0,0
TIKI,tui-thoi-trang-nam,111868737,"Túi đeo chéo du lịch Arctic Hunter chất liệu Oxford chống nước - XB00121",399000,700000,301000,43
TIKI,tui-thoi-trang-nam,69862059,"Túi để điện thoại đeo thắt lưng phong cách phái mạnh",99000,99000,0,0
TIKI,tui-thoi-trang-nam,202963412,"Ví da nam . ví nam cao cấp Full hộp WilliamPOLO -  V27",545000,545000,0,0
TIKI,tui-thoi-trang-nam,112096703,"cặp da công sở P075 - Nâu 2 ngăn",400000,425000,25000,6
TIKI,tui-thoi-trang-nam,140511608,"Ví Da Nam TRAZ Cực Chất, Bóp Nam Cầm Tay Thời Trang Hàn Quốc",99000,99000,0,0
TIKI,tui-thoi-trang-nam,192122688,"VÍ NAM CẦM TAY VALENTINO CREATIONS-LPF-210216SL-DBN - 1",10990000,10990000,0,0
TIKI,tui-thoi-trang-nam,99667516,"Xả hàng COMBO VÍ + THẮT LƯNG có TÚI HỘP ĐỰNG Y HÌNH",99000,99000,0,0
TIKI,tui-thoi-trang-nam,132829069,"Cặp da nam da thật 0551",3180000,3180000,0,0
TIKI,tui-thoi-trang-nam,193720588,"TÚI ĐEO CHÉO BAO TỬ CARO THỜI TRANG",350000,350000,0,0
TIKI,tui-thoi-trang-nam,271412459," Ví nam dáng đứng da bò Nappa hạt cao cấp PQ Leather PV15, da thật full hộp làm quà tặng bảo hành 12 tháng",365000,365000,0,0
TIKI,tui-thoi-trang-nam,197046803,"Ví da nam cao cấp hiệu Việt Tiến - Bóp nam dáng ngang khóa kéo da thật Viettien",750000,750000,0,0
TIKI,tui-thoi-trang-nam,21337606,"Túi đeo bao tử - Túi đeo chéo nam nữ - Túi đeo bụng - Túi đeo ngang hông",65000,65000,0,0
TIKI,tui-thoi-trang-nam,72566191,"Túi Đeo Vai - Túi Đeo Chéo Da Cá Sấu Thanh Lịch SPC1",220000,220000,0,0
TIKI,tui-thoi-trang-nam,74901478,"Túi xách da bò nam cao cấp phong cách mới 15.6"",882000,980000,98000,10
TIKI,tui-thoi-trang-nam,54645206,"Cặp công sở nam MARRANT BHM2099 Da bò thật, vừa laptop 14inch, có khe cài vali, chính hãng.",799000,799000,0,0
TIKI,tui-thoi-trang-nam,58210087,"Cặp nam công sở cao cấp BHM7355 Da bò nguyên tấm. Túi xách công sở nam. Vừa laptop 14inch,phom cứng. Sang trọng, lịch lãm",1999999,1999999,0,0
TIKI,tui-thoi-trang-nam,194405258,"Túi Đeo Chéo Vải Canvas DAVANTI Thời Trang DV298",199000,240000,41000,17
TIKI,tui-thoi-trang-nam,96032741,"Túi đeo chéo nam nữ phong cách quân đội Army",150000,150000,0,0
TIKI,tui-thoi-trang-nam,54000399,"Túi đeo vai chéo đeo bụng TĐ 5520 dạng lớn thời trang K06",118057,161345,43288,27
TIKI,tui-thoi-trang-nam,188017981,"Clutch, Ví Cầm Tay Thời Trang Nam Da Bò Alran Cao Cấp HT17 Xanh",1600000,1600000,0,0
TIKI,tui-thoi-trang-nam,189267895,"Túi xách nam da PU cao cấp thời trang công sở YVan 2050-5",650000,650000,0,0
TIKI,tui-thoi-trang-nam,111868769,"Balo đeo chéo một dây Arctic Hunter XB00105 chất liệu Oxford chống thấm nước, unisex nam nữ,trang bị cổng sạc USB",359000,635000,276000,43
TIKI,tui-thoi-trang-nam,90502326,"Túi đeo chéo nam vải Oxford chống thấm nước",672100,672100,0,0
TIKI,tui-thoi-trang-nam,92922351,"Kẹp tiền từ tính đựng thẻ đa năng BlackMan Money Clip RFID",290000,290000,0,0
TIKI,tui-thoi-trang-nam,7483959,"Túi đeo chéo nam da bò BHM1121",735000,735000,0,0
TIKI,tui-thoi-trang-nam,197150834,"Ví nam da bò Nappa hạt phối da Saffiano V111 - Bụi leather - Bảo hành 12 tháng",253000,410000,157000,38
TIKI,tui-thoi-trang-nam,137944866,"Ví card da bò thật SEAGLE nhỏ gọn SMV119",169000,169000,0,0
TIKI,tui-thoi-trang-nam,23433592,"Túi Đeo Chéo Thời Trang HARAS HR253",79000,79000,0,0
TIKI,tui-thoi-trang-nam,149179099,"HOT DEAL - Túi xách cặp da giáo viên đựng laptop 14 inch da bò công sở T23 khóa số (Nâu-Đen) (KT 39x30x10cm.)",1050000,1050000,0,0
TIKI,tui-thoi-trang-nam,122314866,"Túi Đeo Chéo Nam Mini BT06 Da Đơn Giản Tiện Dụng Đi Học Đi Chơi 2 Màu Nâu Đen",234000,450000,216000,48
TIKI,tui-thoi-trang-nam,136940004,"Túi đeo chéo thổ cẩm 5 ngăn nam nữ",100000,100000,0,0
TIKI,tui-thoi-trang-nam,103886721,"Ví Nam Da Cá Sấu Ví Đứng VS02",437000,460000,23000,5
TIKI,tui-thoi-trang-nam,161954571,"Túi Xách Công Sở Nam Gence Da Bò Saffiano CDX11",3080000,3080000,0,0
TIKI,tui-thoi-trang-nam,56683624,"Túi đeo chéo nữ nam unisex chống thấm nước dạng rút Hàn quốc BEE GEE 091 du lịch thời trang",54000,110000,56000,51
TIKI,tui-thoi-trang-nam,103079576,"Ví Da Epsom Dáng Đứng Handmade Lealux Epsom Wallet 3",689000,689000,0,0
TIKI,tui-thoi-trang-nam,58439803,"Túi Đeo Chéo Da Nam LATA BALC23",360000,360000,0,0
TIKI,tui-thoi-trang-nam,110818090,"️ Ví đựng chìa khóa, ví đựng thẻ 40508",231000,231000,0,0
TIKI,tui-thoi-trang-nam,176130462,"Ví nam đựng thẻ ATM mini bằng hợp kim nhôm MB25",178000,178000,0,0
TIKI,tui-thoi-trang-nam,108254144,"Túi Da Nam Đeo Chéo Mẫu Mới Siêu Bền Đẹp Chống Thấm Nước Phon Dáng Chuẩn Đẳng Cấp Phái Mạnh",179000,179000,0,0
TIKI,tui-thoi-trang-nam,68397713,"Túi đeo chéo đeo bụng nam thời trang",199500,199500,0,0
TIKI,tui-thoi-trang-nam,182850614,"TÚI ĐEO CHÉO NAM CÔNG SỞ THƯƠNG HIỆU K2 BRAND VẢI CANVAS THỦ CÔNG CAO CẤP NHIỀU NGĂN ĐA NĂNG",479000,479000,0,0
TIKI,tui-thoi-trang-nam,87822175,"Ví Da Bò Pullup wax WS107 Xanh Navy - Kích thước (cm): 12x10x2 cm",250000,250000,0,0
TIKI,tui-thoi-trang-nam,183350904,"Túi xách nam công sở, cặp da nam đựng laptop và tài liệu cao cấp GCE20",2600000,2600000,0,0
TIKI,tui-thoi-trang-nam,50415159,"Túi Đeo Chéo Đứng Vừa Ipad-Màu Ngẫu Nhiên",79000,79000,0,0
TIKI,tui-thoi-trang-nam,158818774,"TÚI XÁCH NAM RETRO MÀU NÂU DA BÒ",299000,299000,0,0
TIKI,tui-thoi-trang-nam,165605112,"Cặp Xách Nam Công Sở Gence Da Bò Mill Mềm, Túi Xách Nam Da Bò Khóa Số Cao Cấp CTS13 Màu Nâu | Hàng Chính Hãng",2800000,2800000,0,0
TIKI,tui-thoi-trang-nam,72907861,"Túi Đeo Hông thể thao mini soldier HL10 Tặng móc khóa cá heo",64350,92950,28600,31
TIKI,tui-thoi-trang-nam,168955216,"Ví nam đứng da bò cao cấp LuxWear bảo hành 15 tháng VD01",89000,89000,0,0
TIKI,tui-thoi-trang-nam,270694206,"Cặp da nam công sở basic LATA CA41",830000,830000,0,0
TIKI,tui-thoi-trang-nam,79583286,"Cặp nam văn phòng da bò thật Marrant BHM17631 Màu Đen Túi xách công sở nam. Vừa laptop 14inch. Hàng chính hãng",1400000,1400000,0,0
TIKI,tui-thoi-trang-nam,7936340,"Túi đeo Tomtoc 360* Shoulder Bags Macbook 13 - A42",920000,920000,0,0
TIKI,tui-thoi-trang-nam,149567703,"Túi Đeo Chéo Nam Gioi Thương Hiệu Mark Ryden_Anh Quốc, Túi Đeo Chéo 3 Chiều",499000,499000,0,0
TIKI,tui-thoi-trang-nam,66825039,"Tuid phụ kiện móc balo hoặc cài thắt lưng",60221,82302,22081,27
TIKI,tui-thoi-trang-nam,51566434,"Cặp công sở đa năng LATA CA30 nhiều màu",599000,750000,151000,20
TIKI,tui-thoi-trang-nam,177925191,"Túi đeo chéo nam cao cấp phong cách mới BEE GEE – DCN9058",267000,540000,273000,51
TIKI,tui-thoi-trang-nam,188997373,"Bao da dành cho Chìa Khoá New KIA K3 2021 Luxury, Premium, K5, New Sportage 2022, Sorento, cerato logo mới handmade Da Thật 010",200000,200000,0,0
TIKI,tui-thoi-trang-nam,113171536,"Bóp Ví Nam Da Bò Thật Cao Cấp Dáng Đứng Handmade Nổi Bật DX02",139000,165000,26000,16
TIKI,tui-thoi-trang-nam,161002033,"Balo đeo chéo XIAOMI mi city sling bag - Hàng chĩnh hãng do Digiworld nhập khẩu",350000,350000,0,0
TIKI,tui-thoi-trang-nam,107962695,"Ví Da Nam Cầm Tay Đẳng Cấp Doanh Nhân",339000,339000,0,0
TIKI,tui-thoi-trang-nam,146494344,"Bóp ví nam da bò thật SEAGLE dáng ngang cổ điển, sang trọng S1V01",195000,195000,0,0
TIKI,tui-thoi-trang-nam,143063283,"Ví nam da bò Anh Tho Leather MIN-03 Cánh lật",429000,460000,31000,7
TIKI,tui-thoi-trang-nam,136462840,"Ví dài cầm tay cao cấp",99900,99900,0,0
TIKI,tui-thoi-trang-nam,186209971,"Túi xách nam công sở, cặp da nam đựng laptop và tài liệu cao cấp GCE26",2800000,2800000,0,0
TIKI,tui-thoi-trang-nam,194025954,"Túi đeo ngực da cá sấu",3550000,6000000,2450000,41
TIKI,tui-vi-nu,161524403,"Bóp ví nữ dài cầm tay V0510 LIVE nhiều ngăn tiện lợi, phong cách thời trang, cá tính",36000,72000,36000,50
TIKI,tui-vi-nu,77445739,"Túi Xách Nữ - Túi Cầm Tay Nữ - Clutch Dự Tiệc (TX-063-1)",359000,359000,0,0
TIKI,tui-vi-nu,117208903,"Ví dài cầm tay nữ phong cách hàn Quốc, mãi mãi trẻ trung, cá tính, ví dài cầm tay nhiều ngăn siêu tiện dụng, phù hợp cho mọi lứa tuổi. Màu Đỏ đô",159000,159000,0,0
TIKI,tui-vi-nu,136940145,"Ví tiền vải canvas mini xinh xắn cho nữ",15000,15000,0,0
TIKI,tui-vi-nu,15237390,"Túi đeo điện thoại M001",119000,119000,0,0
TIKI,tui-vi-nu,196573813,"Ví nữ cầm tay  Hàn Quốc nhiều ngăn nhỏ gọn , đáng yêu( shop giao ngẫu nhiên)",19800,22000,2200,10
TIKI,tui-vi-nu,157254165,"Ví Nam, Nữ Ngắn Logo SAIGON SWAGGER Nhiều Ngăn, Chống Thấm",280000,280000,0,0
TIKI,tui-vi-nu,196147569,"Ví Da Nam Nữ Cầm Tay Khóa kéo Davanti Sang Trọng DFN257",460000,490000,30000,6
TIKI,tui-vi-nu,133775928,"Túi đeo chéo nữ, túi đựng điện thoại mini dáng dọc thời trang. Phong cách thiếu nữ Hàn Quốc trẻ trung, năng động. Sang chảnh, cá tính- Màu Hồng nhạt",129000,129000,0,0
TIKI,tui-vi-nu,192064404,"Túi Xách Nữ Kẹp Nách Chính Hãng MICOCAH Dáng Công Sở Thời Trang Sang Trọng Đeo Vai Đeo Chéo Da Cao Cấp Cực Đẹp MC131 - Tukado",469000,469000,0,0
TIKI,tui-vi-nu,209414504,"Ví nữ cầm tay , dự tiệc phong cách hàn quốc hót nhất 2022",282000,282000,0,0
TIKI,tui-vi-nu,160315171,"Ví Nữ Mini Cầm Tay PERFECT FOR YOU Đựng Tiền Dáng Vuông Xinh Xắn Da Cao Cấp Cực Đẹp PFY01 - Micocah Mall",99000,99000,0,0
TIKI,tui-vi-nu,185849411,"Túi Xách Nữ Thời Trang Dây Đeo Chéo Đeo Vai Kẹp Nách CRESCENT MOON HOBO BAG GIPSY",690000,690000,0,0
TIKI,tui-vi-nu,25293202,"Túi đeo chéo hình chú chuột Hamster siêu đáng yêu",62370,85239,22869,27
TIKI,tui-vi-nu,186229908,"Túi xách nữ Pu Cao Cấp Handle Bag chính VÀ kiểu dáng cổ điển đơn giản thời trang có thể đeo chéo hoặc xách tayTúi đeo vai - Bảo hành 1 năm",592800,592800,0,0
TIKI,tui-vi-nu,8237398,"Ví cầm tay thời trang cho nữ TM-VinuCK63 kiểu dáng sang trọng",209000,209000,0,0
TIKI,tui-vi-nu,206661343,"Túi xách TOKYO JAPAN, mã G34. Quà tặng cao cấp cho gia đình, nam nữ cặp đôi, hội nhóm, doanh nghiệp",109000,109000,0,0
TIKI,tui-vi-nu,248990474,"KHÓA SẬP MỎ VỊT 2-3CM",42000,42000,0,0
TIKI,tui-vi-nu,205819383,"Túi xách nữ cao cấp thời trang da mềm phong cách Hàn Quốc thanh lịch và sang trọng",219000,219000,0,0
TIKI,tui-vi-nu,173856972,"Túi đeo vai đi làm, đi học đẹp giá rẻ, form to, 2 lớp, vải canvas - CON CÁ Heo",69000,69000,0,0
TIKI,tui-vi-nu,171214627,"Túi ví mèo thần tài (màu xanh lá số 11)",45000,45000,0,0
TIKI,tui-vi-nu,172192141,"Túi Nữ Thời Trang Phong Cách Hàn Quốc Đồ Da Thành Long TLG 208169",30000,30000,0,0
TIKI,tui-vi-nu,74603963,"Túi đeo chéo in hình vui nhộn Mstaly Tặng móc khóa cá heo",38610,52767,14157,27
TIKI,tui-vi-nu,71725974,"Túi clutch nữ thời trang cao cấp ELLY – ECH46",559300,799000,239700,30
TIKI,tui-vi-nu,129382325,"Túi Đeo Chéo Pop It Nhiều Màu (Giao màu ngẫu nhiên)",44600,44600,0,0
TIKI,tui-vi-nu,107982318,"Túi kẹp nách nữ phối dây xích thời trang nhỏ gọn tiện dụng da mềm đẹp TK0095",49000,90000,41000,46
TIKI,tui-vi-nu,206662997,"Túi xách tote RUN, mã G26. Quà tặng cao cấp cho gia đình, nam nữ cặp đôi, hội nhóm, doanh nghiệp",109000,109000,0,0
TIKI,tui-vi-nu,43694766,"Túi nữ thời trang phong cách Hàn Quốc Đồ Da Thành Long TLG 208098",44400,87000,42600,49
TIKI,tui-vi-nu,185468231,"túi ví đeo chéo nữ với 2 dây đeo họa tiết thổ cẩm dáng đứng đựng vừa điện thoại - N8605",198000,269000,71000,26
TIKI,tui-vi-nu,96987940,"Đeo chéo da Bóp đầm da dạ hội trơn Aly CS35 Tặng móc khóa cá heo",84181,115048,30867,27
TIKI,tui-vi-nu,198321186,"Túi nữ dạng cặp lồng đeo chéo hoặc cầm tay họa tiết sọc caro phong cách cổ điển",177100,177100,0,0
TIKI,tui-vi-nu,75414164,"Ví nữ cầm tay 2 ngăn kéo họa tiết hoa văn sang trọng, thiết kế nhiều ngăn tiện dụng TK0070",76000,150000,74000,49
TIKI,tui-vi-nu,125100953,"Túi cầm tay Kim Sa",59000,59000,0,0
TIKI,tui-vi-nu,13633710,"Túi Vải Tote Cực Xinh G015",69000,69000,0,0
TIKI,tui-vi-nu,172977342,"Túi vải bố, Túi vải Canvas trơn Màu Trắng",25000,25000,0,0
TIKI,tui-vi-nu,84103250,"túi ngọc trai mini thời trang dành cho nữ",169000,169000,0,0
TIKI,tui-vi-nu,209414557,"Ví túi dự tiệc cầm tay dạ hội sinh nhật khai trương lễ cưới sang trọng VDT10",341000,341000,0,0
TIKI,tui-vi-nu,132079713,"Túi Chuồn Chuồn Màu Đen",99000,240000,141000,59
TIKI,tui-vi-nu,157210295,"Túi tote - Combo Daisy ",364000,364000,0,0
TIKI,tui-vi-nu,59264752,"Ví tiền mini hình chữ vuông nhiều màu siêu dễ thương - Đựng tiền xu, tai nghe tiện lợi - Mẫu ngẫu nhiên",13500,13500,0,0
TIKI,tui-vi-nu,177158869,"Túi xách nữ 2 trong 1 thời trang cao cấp",387000,430000,43000,10
TIKI,tui-vi-nu,189337493,"Túi đeo chéo nữ nam thời trang cao cấp chính hãng YVan C69",599000,599000,0,0
TIKI,tui-vi-nu,42240080,"Túi đeo chéo đeo vai nữ đựng điện thoại dọc nắp Trơn ép chữ K9 Shalla",83160,120120,36960,31
TIKI,tui-vi-nu,89119829,"Túi đeo chéo đeo vai nữ cao cấp phong cách mới",269000,298000,29000,10
TIKI,tui-vi-nu,196522741,"MLB - Túi đeo chéo Checkerboard Hipsack 3AHSM082N",3590000,3590000,0,0
TIKI,tui-vi-nu,47215277,"Túi xách nữ cao cấp da thật ELLY – ET82",1019400,1699000,679600,40
TIKI,tui-vi-nu,190489681,"Túi Xách Nữ Da Thật, Túi Công Sở Cầm Tay Sang Trọng, Cao Cấp HADATI - Màu Xanh Dương, Size 25cm  -Túi xách nữ đeo chéo, túi xách da, khí chất thời trang mới, túi xách nữ, túi đeo vai nữ da phối màu hợp thời trang",869000,869000,0,0
TIKI,tui-vi-nu,4941579,"Túi xách tay nữ size lớn 32x29x12cm",219000,219000,0,0
TIKI,tui-vi-nu,86562068,"Túi đeo chéo nữ    Túi xách nữ mini dây da pha xích Ulzzang siêu dễ thương TD14",59000,59000,0,0
TIKI,tui-vi-nu,263696207,"Túi da nữ đeo vai basic Lata HN108",590000,590000,0,0
TIKI,tui-vi-nu,186639332,"Túi Xách Nữ Công Sở Chất Da Pu Đeo Vai Sze Lớn Đi Làm Thời Trang Hàn Quốc Cao Cấp KN09",89000,89000,0,0
TIKI,tui-vi-nu,81608563,"Túi xách nữ đeo chéo pha màu kiểu dáng Hàn Quốc sang trọng, thanh lịch TN160",119000,119000,0,0
TIKI,tui-vi-nu,51637673,"Túi Xách Đeo Chéo Nữ Mini Đẹp Năng Động CF11",43000,56700,13700,24
TIKI,tui-vi-nu,5003133,"Túi Xách Nữ Thời Trang Cao Cấp Elly EL65",899400,1499000,599600,40
TIKI,tui-vi-nu,138334203,"Túi Xách Nữ Thời Trang JUNO Cỡ Nhỏ Dáng Bì Thư TXN521",682000,682000,0,0
TIKI,tui-vi-nu,87050052,"Túi xách nữ pha màu, túi xách công sở thời trang phong cách Hàn Quốc",259000,259000,0,0
TIKI,tui-vi-nu,195971660,"Túi cách nữ cao cấp da thật ELLY – ET141",2799000,2799000,0,0
TIKI,tui-vi-nu,66483145,"Túi  xách tay nữ công sở bản to có dây đeo",65000,65000,0,0
TIKI,tui-vi-nu,147942468,"Ví Nữ Mini Cầm Tay Chính Hãng MICOCAH Vân Da Rắn Cao Cấp Nhỏ Gọn Nhiều Ngăn Tiện Dụng Siêu Đẹp Giá Rẻ MC49 - Tukado",159000,159000,0,0
TIKI,tui-vi-nu,134754496,"Túi tote đeo vai vải bố canvas T052 nữ in chữ by merciparis có khóa kéo, mềm, đẹp phong cách Hàn",76000,152000,76000,50
TIKI,tui-vi-nu,177092421,"Túi xách nữ 2 trong 1 thời trang cao cấp phong cách mới",387000,430000,43000,10
TIKI,tui-vi-nu,37705615,"Túi xách nữ quai xích thời trang",145000,145000,0,0
TIKI,tui-thoi-trang-nam,160818635," Cặp Da đựng tài liệu Cặp giáo viên Có ngăn Đựng laptop, tài liệu công tác nhiều ngăn phụ",699000,699000,0,0
TIKI,tui-vi-nu,86561206," Túi xách nữ    Túi đeo chéo mini hàng quảng châu siêu hot TD17",63000,63000,0,0
TIKI,tui-vi-nu,83921150,"Túi Đeo Chéo Nữ ️️ Túi Xách Nữ Bản To Đựng Laptop Chống Nước Phong Cách Hàn Quốc SPB136",125000,125000,0,0
TIKI,tui-vi-nu,101831134,"Túi Kẹp Nách, Túi Xách Nữ, Túi Đeo Chéo Hàn Quốc TDC045",75000,75000,0,0
TIKI,tui-thoi-trang-nam,149521455,"{DA CÁ SẤU THẬT} Bóp Da Cá Sấu Nam Màu Nâu Da Bụng - Ví Nam Da Cá Sấu Có Khoá Kéo Cao Cấp Dáng Ngang Thời Trang",890000,890000,0,0
TIKI,tui-thoi-trang-nam,120469883,"Ví Nam Đứng, Da Bò Mềm Mại GENTLE, Size Lớn, Thiết Kế Cổ Điển Đơn Giản - Đẹp Mắt, Dáng Đứng - Gập 2, Ngăn Đựng Tiền Có Khóa Kéo, Nhiều Ngăn Để Giấy Tờ Tiện Dụng - Hàng Chính Hãng SAIGIO",781000,799000,18000,2
TIKI,tui-vi-nu,118553670,"2 Túi Nhựa Bảo Vệ Thẻ, Căn Cước Công Dân, Thẻ ATM, Bằng Lái, Thẻ Sinh Viên, Card Visit",2999,2999,0,0
TIKI,tui-thoi-trang-nam,95004244,"Túi đeo chéo nam vải canvas cao cấp phong cách mới",269000,298000,29000,10
TIKI,tui-thoi-trang-nam,76687028,"Ví nam da bò cao cấp phong cách mới",359000,398000,39000,10
TIKI,tui-thoi-trang-nam,73340768,"TÚI ĐEO CHÉO Mini Tiện Lợi BUMBAG Vải Canvas Cao Cấp Chống Thấm Nước Unisex Nam Nữ Chuẩn Dim DOLANTO",180000,180000,0,0
TIKI,tui-vi-nu,46224953,"Túi xách nữ XN005",299000,299000,0,0
TIKI,tui-thoi-trang-nam,193005196,"Túi đeo chéo nam da bò Staurn Bụi Leather DC111 - Da bò thật cao cấp - Bảo hành 12 tháng",479000,679000,200000,29
TIKI,tui-thoi-trang-nam,59103121,"Túi đeo chéo nam da bò cao cấp T08 26x23x7cm",275000,275000,0,0
TIKI,tui-vi-nu,98978186,"Túi Xách Da PU Mềm 2 Màu Đen, Trắng Phong Cách Sang Chảnh",99000,99000,0,0
TIKI,tui-vi-nu,58702162,"Túi xách nữ",95000,95000,0,0
TIKI,tui-vi-nu,160315233,"Túi Xách Nữ Kẹp Nách Chính Hãng MICOCAH Dáng Công Sở Thời Trang Nhiều Ngăn Tiện Dụng Chất Cực Đẹp MC21 - Micocah Mall",389000,389000,0,0
TIKI,tui-thoi-trang-nam,147423638,"Bao Bọc Hộ Chiếu - Passport Dẻo Trong Suốt",2999,2999,0,0
TIKI,tui-thoi-trang-nam,75600848,"Túi đeo chéo ,đeo ngực nam phong cách mới",405000,450000,45000,10
TIKI,tui-vi-nu,81312126,"Túi xách nữ công sở HOTTREND  Túi xách nữ kẻ caro Hàn Quốc  Deli TN47",199000,199000,0,0
TIKI,tui-vi-nu,144570962,"Túi xách nữ/ Túi đeo chéo, túi đeo vai nữ da bò nguyên miếng siêu cao cấp, đơn giản và thời thượng",850000,850000,0,0
TIKI,tui-thoi-trang-nam,58215166,"Cặp công sở TRITA TCA1",359000,600000,241000,40
TIKI,tui-thoi-trang-nam,188897177,"Túi Đeo Chéo Nam Nữ Thời Trang Trẻ Trung, Túi Đựng Ipad, Túi Đeo Vai Nhiều Ngăn Kéo Đựng Đồ Rất Tiện Lợi, Vải Oxford Chống Thấm Nước",140000,140000,0,0
TIKI,tui-thoi-trang-nam,75448071,"TÚI ĐEO ĐA NĂNG TOMTOC (USA) CROSSBODY FOR TECH ACCESSORIES AND IPAD 10.5/PRO 11INCH/TABLET/NOTEBOOK 11INCH GRAY H02-A01G - Hàng Chính Hãng",1359000,1359000,0,0
TIKI,tui-vi-nu,73748499,"Túi xách nữ thời trang cao cấp ELLY – EL157 Đen Nude",1399000,1399000,0,0
TIKI,tui-thoi-trang-nam,181523715,"Ví Nam Cao Cấp, Da Bò NAPA Láng Mịn, Mỏng Nhẹ, Size Trung, Kiểu Cổ Điển Tinh Tế - Sang Trọng, Dáng Ngang - Gập 2, Nhiều Ngăn Để Tiền Và Giấy Tờ Tiện Dụng - Hàng Chính Hãng SAIGIO",1181000,1199000,18000,2
TIKI,tui-thoi-trang-nam,193004984,"Túi đeo chéo nam Jupiter Bụi Leather DC110 - Da bò thật cao cấp - Bảo hành 12 tháng",499000,705000,206000,29
TIKI,tui-thoi-trang-nam,83940625,"VÍ DA NAM MINI - ĐỒ DA THỦ CÔNG- DA BÒ NHẬP KHẨU",399000,399000,0,0
TIKI,tui-thoi-trang-nam,148850131,"Túi đeo chéo, đeo ngực nam Arctic Hunter YB00047 chất liệu Oxford chống thấm nước, thiết kế nhiều ngăn tiện dụng",299000,550000,251000,46
TIKI,tui-thoi-trang-nam,180987710,"Ví thời trang da nam cầm tay ngang D06 trẻ trung sang trọng",59000,59000,0,0
TIKI,tui-thoi-trang-nam,73218453,"TÚI ĐEO CHÉO Mini Tiện Lợi RUSH BAG Nhỏ Gọn Vải Canvas Cao Cấp Chống Thấm Nước Unisex Nam Nữ Chuẩn Leonardo DOLANTO",209000,209000,0,0
TIKI,tui-thoi-trang-nam,162051575,"ví nam ví nam clutch cầm tay cao cấp",441000,490000,49000,10
TIKI,tui-thoi-trang-nam,195160576,"Túi Đeo Chéo Nam Nữ Size Lớn Chất Vải Polysster Cao Cấp Chống Thấm Nước 2087 End&Start  BL003",272000,320000,48000,15
TIKI,tui-thoi-trang-nam,89786838,"Túi đeo chéo nam, túi bao tử vải dù cao cấp chống nước",147510,213070,65560,31
TIKI,tui-thoi-trang-nam,103886545,"Ví Nam Bóp Da Cá Sấu Thật Màu Nâu Đất ST06 BH 24 Tháng Tặng Kèm Lót Nhung Cao Cấp",850000,850000,0,0
TIKI,tui-thoi-trang-nam,57983619,"Cặp da công sở LATA CA16",499000,650000,151000,23
TIKI,tui-thoi-trang-nam,189281858,"Túi đeo chéo nam nữ nhiều ngăn tiện lợi vải cao cấp chính hãng YVan 1202-1",325000,325000,0,0
TIKI,tui-thoi-trang-nam,195757042,"Bộ combo ví MoonFest  - CHÍNH HÃNG KHACTEN.COM",2100000,2100000,0,0
TIKI,tui-thoi-trang-nam,95856860,"Cặp Da Nam Công Sở P112 – Phong Cách Hàn Quốc – Trẻ Trung – Thanh Lịch",312550,329000,16450,5
TIKI,tui-vi-nu,164961283,"Túi đeo chéo, đeo vai da cao cấp T0031 Basic chống thấm nước, bền bỉ unisex nam nữ phong cách thời trang Hàn",190000,380000,190000,50
TIKI,tui-thoi-trang-nam,168069730,"Túi Đeo Chéo Nam Chống Nước FALDO 2.1",350000,350000,0,0
TIKI,tui-thoi-trang-nam,88925675,"Túi xách nam công sở cao cấp",423000,470000,47000,10
TIKI,tui-thoi-trang-nam,96580691,"Túi đeo chéo nam da bò JEEP BULUO 26x21x6cm-EVA.STORES",179000,179000,0,0
TIKI,tui-thoi-trang-nam,148811049,"Ví dài cầm tay da bò Mill cao cấp Bụi Leather C107 - Bảo hành 12 tháng",490000,778000,288000,37
TIKI,tui-thoi-trang-nam,103813801,"Túi Da Công Sở P116 – Thiết Kế Tiện Lợi – Sang Trọng – Đẳng Cấp",455050,479000,23950,5
TIKI,tui-thoi-trang-nam,116724768,"Ví Nam Mini Nhỏ Gọn, Da Bò Mềm Mại GENTLE, Thiết Kế Hiện Đại, Nhiều Ngăn Đựng Tiền và Thẻ Tiện Dụng, Dáng Ngang - Gập 2 - Hàng Chính Hãng SAIGIO",783000,799000,16000,2
TIKI,tui-thoi-trang-nam,143112607,"Túi Crossbody Oxford HAVIAS_Túi Bao Tử Đen (Black)",350000,350000,0,0
TIKI,tui-thoi-trang-nam,148801985,"Ví dài cầm tay da bò sáp ngựa điên Crazyhorse cao cấp C102 Bụi Leather - Bảo hành 12 tháng",259000,514000,255000,50
TIKI,tui-thoi-trang-nam,149970506,"Ví Da Cá Sấu Nam Màu Nâu {DA CÁ SẤU THẬT} - Ví Nam Da Cá Sấu Có Khoá Kéo Cao Cấp Dáng Ngang Thời Trang",890000,890000,0,0
TIKI,tui-thoi-trang-nam,67175802,"Cặp da công sở đựng Laptop 14 inch da vân kèm 2 ngăn kép",275000,275000,0,0
TIKI,tui-thoi-trang-nam,192566295,"Bóp ví da nam cầm tay Classic vải Canvas trơn đựng thẻ nhỏ gọn phong cách đơn giản, thời trang",48000,96000,48000,50
TIKI,tui-thoi-trang-nam,145748036,"Ví Nam Da Bò Mềm Mại ONE LINE, Size Lớn, Thiết Kế Nhiều Ngăn Để Giấy Tờ, Có Khóa Kéo, Đựng Tiền và Thẻ Tiện Dụng, Dáng Ngang - Gập 2 - Hàng Chính Hãng SAIGIO",782000,799000,17000,2
TIKI,tui-thoi-trang-nam,185468175,"bóp ví nam ngắn cầm tay nhiều ngăn chất da cao cấp thời trang châu Âu sành điệu - D3216",148000,219000,71000,32
TIKI,tui-thoi-trang-nam,146449276,"Ví da nam cầm tay họa tiết đan , clutch nam cầm tay , bóp nam cầm tay",350000,350000,0,0
TIKI,tui-vi-nu,189457910,"Túi xách thời trang nữ cao cấp Allwellshop - Túi cầm tay  da bò 2 lớp font đẹp, sang trọng sử dụng đa phong cách",745000,745000,0,0
TIKI,tui-thoi-trang-nam,185990735,"Túi đeo chéo nam đa chức năng thời trang cao cấp phong cách mới",261000,290000,29000,10
TIKI,tui-thoi-trang-nam,89786109,"Túi Đeo Chéo Nam Khóa Phản Quang Phong Cách Streetwear, Túi Bao Tử Nam Kháng Nước TC98 - Đen",74250,101475,27225,27
TIKI,tui-thoi-trang-nam,117036103,"Ví Nam Cao Cấp, Da Bò NAPA Láng Mịn, Mỏng Nhẹ, Size Lớn, Kiểu Cổ Điển Tinh Tế - Sang Trọng, Dáng Ngang - Gập 2, Ngăn Đựng Tiền Có Khóa Kéo, Nhiều Ngăn Để Giấy Tờ Tiện Dụng - Hàng Chính Hãng SAIGIO",1179000,1199000,20000,2
TIKI,tui-thoi-trang-nam,81116907," Túi xách da đựng laptop, cặp sách công sở",927000,927000,0,0
TIKI,tui-vi-nu,169594412,"Combo Túi Xách Nữ Kèm Túi Nhỏ, Túi Vải Canvas Cỡ Lớn Đựng Nhiều Đồ, Túi Tote Đeo Vai Phong Cách Hàn Quốc Cỡ Lớn (Kèm Thêm Túi Nhỏ) - OTV115 - Ope Store",172000,172000,0,0
TIKI,tui-thoi-trang-nam,4353501,"Túi đựng ipad Simplecarry LC Ipad4",390000,390000,0,0
TIKI,tui-thoi-trang-nam,73775533,"Ví nam 100% da bò thật cao cấp phong cách mới",405000,450000,45000,10
TIKI,tui-thoi-trang-nam,53030801,"túi xách nam phong cách lịch lãm D0443 - cặp xách da nam công sở cao cấp",325000,325000,0,0
TIKI,tui-thoi-trang-nam,109949772,"Ví Unisex THE MAIL WALLET Da Thật Vân Saffiano Thương Hiệu DOLANTO",208000,208000,0,0
TIKI,tui-thoi-trang-nam,87354662,"Túi xách laptop, công sở vải canvas MOYYI TXMY004",349200,485000,135800,28
TIKI,tui-thoi-trang-nam,193723764,"Túi Đeo Chéo Nam, Túi Bao Tử Đeo Hông Đeo Ngực Sang Trọng Chống Nước, Chống Xước Nhiều Ngăn Xịn Xò",55000,55000,0,0
TIKI,tui-thoi-trang-nam,70680920,"Túi Đeo Chéo Nam Unisex Thời Trang Chống Nước Yourwish TD23 Túi Bao Tử Dệt Trơn Trượt Nước Đeo Hông Lưng Bụng Màu",64350,87945,23595,27
TIKI,tui-vi-nu,174293719,"Túi xách nam  nữ vải dù Oxford thời trang cao cấp giá rẻ đeo chéo đa năng nhiều ngăn chống thấm nước",167000,167000,0,0
TIKI,tui-thoi-trang-nam,32843502,"Túi xách công sở nam chất liệu da PU cao cấp DH1801",299000,299000,0,0
TIKI,tui-thoi-trang-nam,53280099,"Túi xách da nam công sở cao cấp phong cách hiện đại trẻ trung",423000,470000,47000,10
TIKI,tui-thoi-trang-nam,2132789,"Túi Đeo Ipad Thời Trang Praza DC108 (29 x 18 cm) - Xanh",103000,103000,0,0
TIKI,tui-thoi-trang-nam,136816225,"Túi chéo nam da thật cao cấp BEE GEE BLCC ĐỎ",446000,900000,454000,50
TIKI,tui-thoi-trang-nam,70135041,"Túi Đeo Chéo Trước Ngực 4U Da Tổng Hợp Thời Trang BA416",199000,250000,51000,20
TIKI,tui-thoi-trang-nam,193723534,"Túi Đeo Chéo, Túi Bao Tử Đa Năng, Mẫu Thể Thao Năng Động Chống Thấm Nước, Có 4 Ngăn Đựng Đồ Tiện Dụng",60000,60000,0,0
TIKI,tui-thoi-trang-nam,157260595,"Túi Nam Da Đeo Chéo Trước Ngực 4U Nhỏ Gọn BA418",189000,210000,21000,10
TIKI,tui-thoi-trang-nam,44011247,"Cặp Da Công Sở LATA CA22",720000,720000,0,0
TIKI,tui-thoi-trang-nam,72207505,"Túi Đeo bao tử, nịt bụng đeo chéo đa năng ngang kéo tian TL14 Tặng móc khóa nam",78210,106887,28677,27
TIKI,tui-thoi-trang-nam,163833463,"Túi Nam Đeo Chéo Da Thật SUNPOLO STU109 (Nâu)",750000,750000,0,0
TIKI,tui-thoi-trang-nam,171772156,"túi da nam , cặp đựng laptop thời trang B2",827000,827000,0,0
TIKI,tui-vi-nu,137951969,"Túi Giỏ Xách Đan Tay Quai Gỗ Hàng Xuất Khẩu Thủ Công Sang Chảnh Đi Chơi Đi Biển Chụp Hình - Doni House",100000,100000,0,0
TIKI,tui-thoi-trang-nam,19548082,"Túi đeo chéo vải bố nam TX0009",320000,320000,0,0
TIKI,tui-thoi-trang-nam,157254118,"Ví Nam, Nữ Gập Da SAIGON SWAGGER SGS Anthem Leather Fold-Nhiều Ngăn, Đựng Thẻ",490000,490000,0,0
TIKI,tui-thoi-trang-nam,102905124,"ví da name card",329000,329000,0,0
TIKI,tui-thoi-trang-nam,193395346,"Clutch, Ví Cầm Tay Thời Trang Nam Da Bò Epsom Cao Cấp HT18 Đen",1490000,1490000,0,0
TIKI,tui-vi-nu,173856862,"Túi tote đeo chéo đeo đi học đi làm đi chơi",46900,46900,0,0
TIKI,tui-thoi-trang-nam,51299063,"Túi xách da bò nam công sở cao cấp phong cách châu âu",855000,950000,95000,10
TIKI,tui-thoi-trang-nam,7804629,"Túi Đeo Chéo Ipad Unisex Fortune Mouse C860 (20 x 24 cm)",39000,39000,0,0
TIKI,tui-thoi-trang-nam,89176321,"Túi xách túi đeo chéo nam vải canvas cao cấp phong cách mới",351000,390000,39000,10
TIKI,tui-thoi-trang-nam,193004204,"Túi đeo chéo da bò thật Venus Bụi Leather DC108 - Da bò Nappa cao cấp - Bảo hành 12 tháng",349000,495000,146000,29
TIKI,tui-thoi-trang-nam,125182848,"Túi Đeo Chéo Bao Tử Nam Da Bò Trẻ Trung Sành Điệu ",180000,360000,180000,50
TIKI,tui-thoi-trang-nam,50028638,"Túi đeo chéo đeo ngực nam thông minh đa chức năng thời trang cao cấp phong cách cá tính",621000,690000,69000,10
TIKI,tui-thoi-trang-nam,149179843,"Túi đeo chéo nam da cá sấu cao cấp T48 (KT:26.5x17x7cm) Bảo hành da 12 tháng (Nâu đậm-Nâu sáng)",1260000,1260000,0,0
TIKI,tui-thoi-trang-nam,125078612,"Túi đeo hông Marshall Underground Belt Bag - Hàng Chính Hãng",890000,890000,0,0
TIKI,tui-thoi-trang-nam,193241728,"Túi Đeo Chéo Nam Vải Nylon Cao Cấp Nhiều Ngăn Chống Thấm Nước, Túi Đeo Vai Phong Cách Thời Trang Hàn Quốc Dành Cho Người Đi Làm, Học Sinh, Sinh Viên,Người Đi Chơi, Đi Du Lịch",115000,115000,0,0
TIKI,tui-vi-nu,176652201,"Túi đeo chéo nữ thời trang YUUMY YN91 nhiều màu",325000,490000,165000,34
TIKI,tui-thoi-trang-nam,45018395,"Túi đeo chéo nam nữ unisex thời trang BEE GEE 063",68000,138000,70000,51
TIKI,tui-thoi-trang-nam,195986500,"Túi đeo chéo Messenger vải Oxford cao cấp chống thấm nước, bền bỉ unisex nam nữ phong cách thời trang, cá tính",70000,140000,70000,50
TIKI,tui-thoi-trang-nam,157254318,"Túi Đeo Chéo Nam, Nữ Họa tiết Checkerboard SAIGON SWAGGER SGSxClownZ Joke Bag",449000,449000,0,0
TIKI,tui-thoi-trang-nam,192834131,"Túi Đeo Chéo Local Brand Streetwear Unisex Thời Trang Cho Nam và Nữ",179000,179000,0,0
TIKI,voucher-dich-vu,272384270,"Combo Nghỉ Dưỡng 3N2Đ Mường Thanh Đà Nẵng - Hội An + Ăn Sáng + Ăn Trưa/Tối + Đón Tiễn",3299000,3299000,0,0
TIKI,voucher-dich-vu,272471568,"Villa Nguyên Căn Hội An 03-05 Phòng Ngủ, Giao Chìa Tự Quản, Cách Phố Cổ 2,5km",2990000,2990000,0,0
TIKI,voucher-dich-vu,119439023,"[E-BOOK] i-Learn Smart Start 2 Truyện đọc - The Rabbit and the Tortoise",5000,5000,0,0
TIKI,voucher-dich-vu,96418729,"D1-Concepts - Phiếu Quà Tặng Dì Mai 500K",500000,500000,0,0
TIKI,voucher-dich-vu,206845612,"Voucher 2N1Đ Ngủ Đêm Trên Du Thuyền 5 sao Le Theatre Cruises Sang Trọng Tại Vịnh Hạ Long (Khởi Hành Hàng Ngày + Ăn 04 bữa + Vé Tham Quan Lịch Trình 2N1Đ + Phòng Ngủ Trên Du Thuyền) ",3590000,3590000,0,0
TIKI,voucher-dich-vu,206831843,"Khám Phá Vịnh Hạ Long 8 Tiếng Trên Siêu Du Thuyền 5 Sao Jade Sails Đẳng Cấp (Khởi Hành Hàng Ngày từ Hà Nội + Ăn Trưa Buffet + Vé Tham Quan + Miễn Phí Chèo Thuyền Kayaking)",1890000,1890000,0,0
TIKI,voucher-dich-vu,273175285,"KHÁM PHÁ CHÂU HỒNG HÀ – TRUNG QUỐC:  Hà Nội – Hà Khẩu - Bình Biên – Di Lặc – Kiến Thủy – Mông Tự - Hà Khẩu – Hà Nội ( bao gồm xe + vé thắng cảnh+ăn uống +khách sạn+HDV suốt tuyến)",4690000,4690000,0,0
TIKI,voucher-dich-vu,273171856,"KHOÁ HỌC ONLINE CAO THỦ PHA CHẾ TỔNG HỢP",398000,398000,0,0
TIKI,voucher-dich-vu,260803644,"Evoucher Smile Beauty - Răng Sứ Toàn Sứ Zirconia Chính Hãng",5000000,5000000,0,0
TIKI,voucher-dich-vu,273221353,"Tour du thuyền Ambassador 5 sao thăm vịnh Hạ Long 8 tiếng",1460000,1460000,0,0
TIKI,voucher-dich-vu,273199877,"Evoucher Phiếu Quà Tặng Ori Express 50K",50000,50000,0,0
TIKI,voucher-dich-vu,273199881,"Evoucher Phiếu Quà Tặng Ori Express 100K",100000,100000,0,0
TIKI,voucher-dich-vu,209177103,"Voucher Bọc răng sứ Roland - Nha khoa BeDental",4500000,4500000,0,0
TIKI,voucher-dich-vu,119438194,"[E-BOOK] Tiếng Anh 2 i-Learn Smart Start Bộ tranh hình",15000,15000,0,0
TIKI,voucher-dich-vu,197858007,"Khóa học Sơ Cấp cứu  - SSVN",899000,899000,0,0
TIKI,voucher-dich-vu,86418283,"EVERYDAY ENGLISH A1-C1",1175000,1175000,0,0
TIKI,voucher-dich-vu,7816569,"Voucher 7 Bước Triệt Lông Vĩnh Viễn Tại Ellis Spa",99000,99000,0,0
TIKI,voucher-dich-vu,262637834,"Evoucher - Phiếu Quà Tặng Matsuri Japanese Restaurant 300K",300000,300000,0,0
TIKI,voucher-dich-vu,68517492,"Khóa học TOÁN HỌC LỚP 3 - Cô Ngọc Lan - 09 tháng",700000,700000,0,0
TIKI,voucher-dich-vu,186392567,"PEEL ACNE Trị Mụn, Giảm Thâm Mụn",980000,980000,0,0
TIKI,voucher-dich-vu,273383817,"Evoucher Phiếu Quà Tặng Chuk Tea & Coffee - Chuk Express 30K",30000,30000,0,0
TIKI,voucher-dich-vu,262799633,"Evoucher - Phiếu Quà Tặng Trị Liệu Trẻ Em (60 phút)",500000,500000,0,0
TIKI,voucher-dich-vu,248247152,"[E-Voucher] Tour Cần Thơ Đà Lạt 3 ngày 2 đêm – Check-in Đà Lạt mộng mơ",2690000,2690000,0,0
TIKI,voucher-dich-vu,186392820,"Dịch Vụ Triệt Lông Nách Công Nghệ IPL",125000,125000,0,0
TIKI,voucher-dich-vu,247858980,"Tour Đà Nẵng [LAMBABA]Tour Cù Lao Chàm và lặn ngắm san hô 1 ngày",639000,639000,0,0
TIKI,voucher-dich-vu,273383812,"Evoucher Phiếu Quà Tặng Chuk Tea & Coffee - Chuk Express 50K",50000,50000,0,0
TIKI,voucher-dich-vu,273309985,"Sách nói Fonos: Việt Nam Danh Tác: Hà Nội Băm Sáu Phố Phường [e-voucher]",99000,99000,0,0
TIKI,voucher-dich-vu,273309448,"Sách nói Fonos: Pippi Tất Dài [e-voucher]",99000,99000,0,0
TIKI,voucher-dich-vu,119229172,"[E-BOOK] Tiếng Anh 6 i-Learn Smart World Sách mềm sách học sinh",15000,15000,0,0
TIKI,voucher-dich-vu,263060309,"Fonos Sách nói Ông Già Và Biển Cả [e-voucher]",99000,99000,0,0
TIKI,voucher-dich-vu,205767974," [EVoucher Vietravel] Hà Nội: 4N3Đ Hà Giang - Lũng Cú - Đồng Văn - Nơi đá nở hoa",4350000,4350000,0,0
TIKI,voucher-dich-vu,36462504,"Bọc 1 răng mặt dán sứ Emax/Cercon HT tại Nha Khoa Gia Hân",9000000,9000000,0,0
TIKI,voucher-dich-vu,35412127,"Chăm Sóc Da Mặt Cơ Bản Tại TG Herbal House",237500,237500,0,0
TIKI,voucher-dich-vu,273310021,"Sách nói Fonos: Khi Nào Cướp Nhà Băng [e-voucher]",99000,99000,0,0
TIKI,voucher-dich-vu,213584621,"[E-Voucher] Gói học trực tuyến theo môn - Lớp 2 (1 năm), Ứng dụng hỗ trợ học tập cho học sinh tiểu học",193000,193000,0,0
TIKI,voucher-dich-vu,263058977,"Fonos Sách nói Thám Tử Sherlock Holmes [e-voucher]",99000,99000,0,0
TIKI,voucher-dich-vu,122494070,"Toàn quốc - [E-voucher] 1 năm học khóa Thành thạo 60 chủ đề từ vựng Tiếng Anh thi Đại học - Onluyen.vn",200000,200000,0,0
TIKI,voucher-dich-vu,263058891,"Fonos Sách nói Robinson Crusoe Lạc Trên Hoang Đảo [e-voucher]",99000,99000,0,0
TIKI,voucher-dich-vu,273329891,"Sách nói Fonos: Ông Trăm Tuổi Trèo Qua Cửa Sổ Và Biến Mất [e-voucher]",99000,99000,0,0
TIKI,voucher-dich-vu,144333971,"Toàn Quốc [Voucher Giấy] Học online môn Toán từ lớp 1 - 12 tại nhà - TOPPY",299000,299000,0,0
TIKI,tui-vi-nu,131338262,"Túi vải bố, Túi vải Canvas trơn Màu Trắng",29000,29000,0,0
TIKI,tui-vi-nu,248991514,"XI MÚT ĐÁNH BÓNG GOLDCARE",70000,70000,0,0
TIKI,tui-vi-nu,113404169,"Túi Ngang Đeo Hông, Đeo Chéo Spost",48400,48400,0,0
TIKI,tui-vi-nu,194461788,"Ví nhỏ cầm tay nữ da thật 9x17 VN111",247000,247000,0,0
TIKI,tui-vi-nu,193007974,"Túi đựng tiền, túi thời trang phong cách Châu Âu mã 6077",219000,399000,180000,45
TIKI,tui-vi-nu,117294385,"Túi cói size lớn đi Tết đi chơi phối dây thổ cẩm 3 màu cực sang (hàng có sẵn)",93000,93000,0,0
TIKI,tui-vi-nu,184223381,"Túi xách túi đeo vai nữ vải canvas thời trang cao cấp phong cách mới",333000,370000,37000,10
TIKI,tui-vi-nu,67087965,"Túi xách nữ GGTT -67",129000,129000,0,0
TIKI,tui-vi-nu,193186934,"Ví Nữ Thời Trang cao cấp phong cách mới – VNU1001",200000,400000,200000,50
TIKI,tui-vi-nu,176535717,"[SGFS56] Túi tote Vải canvas mềm Đẹp Cực Hot đựng vừa a4 [CÓ SẴN][XINH XẮN]Túi vải thời trang",75000,75000,0,0
TIKI,tui-vi-nu,191259116,"Ví Da Mini Cầm Tay 10 Ngăn Họa Tiết Chú Gấu 9 Mẫu Trà Sữa Ngộ Nghĩnh Bóp Nữ Da PU Cute Hot Trend( giao ngẫu nhiên)",50000,50000,0,0
TIKI,tui-vi-nu,98151817,"Túi đeo chéo, túi xách nữ công sở nữ họa tiết phong cách Hàn Quốc TN200",132000,132000,0,0
TIKI,tui-vi-nu,102143682,"Túi đeo chéo/ Túi xách nữ thời trang phong cách Hàn Quốc",119000,219000,100000,46
TIKI,tui-vi-nu,96312652,"Túi Xách Niche Rento (Túi Kẹp Nách) Mini Da Mềm Xếp Li Đeo Vai Hot Trend Phong Cách Châu Âu - Mã XT036",104500,104500,0,0
TIKI,voucher-dich-vu,192398394,"[EVoucher Vietravel] Malaysia: Malaysia - Cao nguyên Berjaya - Singapore",9490000,9490000,0,0
TIKI,tui-vi-nu,165760938,"Túi Xách Nữ Đeo Chéo Quai Lụa Cao Cấp NUTUSHOP - NT45",289000,289000,0,0
TIKI,tui-vi-nu,139468542,"Túi xách đeo vai túi xách tay công sở size lớn chất đẹp NK14",96000,96000,0,0
TIKI,tui-vi-nu,249669622,"Túi Đeo Chéo Nữ, Túi Xách Nữ Vuông Họa Tiết Da Cá Sấu Cao Cấp Phong Cách Hàn Quốc",85000,85000,0,0
TIKI,voucher-dich-vu,189135471,"[EVoucher Vietravel] Đà Nẵng - Phố cổ Hội An - Bà Nà - Cầu Vàng - Vườn Tượng Apec - Cầu Tình yêu (KS 4sao)",3590000,3590000,0,0
TIKI,tui-vi-nu,52539642,"Túi xách nữ đeo chéo vân cá sấu",99000,99000,0,0
TIKI,tui-vi-nu,47965302,"Túi xách đựng A4, chất liệu vải bố, thấm nước, kết hợp dây đeo là dây thừng, không đau vai (Nhiều phiên bản để chọn)",79000,130000,51000,39
TIKI,voucher-dich-vu,138612749,"VOUCHER - [ST001] - DỊCH VỤ SOẢN THẢO THỎA THUẬN TRƯỚC HÔN NHÂN - Công ty Luật Apra",1000000,1000000,0,0
TIKI,tui-vi-nu,72863522,"Túi vải tote nữ Canvas trơn trắng Gady",34000,34000,0,0
TIKI,tui-vi-nu,108253891,"Túi Đeo Chéo Nữ Hình Sao Biển Dễ Thương Lông Mềm Mịn",55000,55000,0,0
TIKI,voucher-dich-vu,68564421,"[E-Voucher] Tour du lịch miền Tây 2N1Đ | Sài Gòn – Tiền Giang – Bến Tre – Cần Thơ",1500000,1500000,0,0
TIKI,tui-vi-nu,177254516,"Túi xách nữ thời trang công sở cao cấp phong cách mới",351000,390000,39000,10
TIKI,voucher-dich-vu,195852214,"[EVoucher Vietravel] Hà Nội - Xuân Sơn - Bắc Yên - Sống lưng khủng long Tà Xùa - Mộc Châu",6990000,6990000,0,0
TIKI,tui-vi-nu,44580877,"Ví cầm tay nữ cao cấp 2 ngăn khóa BA04",143550,207350,63800,31
TIKI,tui-vi-nu,262800445,"Túi Xách Nữ Thời Trang Cao Cấp Elly EL124",1399000,1399000,0,0
TIKI,tui-vi-nu,172801348,"Ví da nữ cầm tay nắp gập YUUMY Seasand YV61",159000,330000,171000,52
TIKI,voucher-dich-vu,225909092,"[EVoucher Vietravel] Thái Lan: Bangkok - Pattaya (Khách sạn 4* - Tham quan Safari World & Thưởng thức buffet tối trên Du thuyền 5 sao)",9990000,9990000,0,0
TIKI,tui-vi-nu,185964455,"Túi xách nữ vải canvas thời trang cao cấp phong cách cá tính mới",315000,350000,35000,10
TIKI,voucher-dich-vu,270058423," [EVoucher Vietravel Hà Nội] Combo 3N2D KS Liberty Central Hotel Nha Trang: VMB khứ hồi Hà Nội - Nha Trang + Phòng Tiêu Chuẩn + Ăn sáng",3990000,3990000,0,0
TIKI,voucher-dich-vu,254141219,"[Gói 2 năm] Ứng dụng học Toán cho Lớp 6 đến Lớp 9 ALOWINGS TOÁN Voucher online áp dụng trên toàn quốc",1400000,1400000,0,0
TIKI,voucher-dich-vu,140300484,"VOUCHER - [LSR003] - LUẬT SƯ RIÊNG 06 THÁNG - Công ty Luật Apra",9000000,9000000,0,0
TIKI,voucher-dich-vu,269959970,"[EVoucher Vietravel Hà Nội] Combo 3N2D KS The Code Đà Nẵng 4 Sao: VMB khứ hồi Hà Nội - Đà Nẵng + Phòng Tiêu Chuẩn + Ăn sáng",3990000,3990000,0,0
TIKI,tui-vi-nu,95063187," Túi đeo chéo nữ vải canvas nút bấm hình com bướm đựng vừa a4 - 2 màu",89900,89900,0,0
TIKI,tui-vi-nu,86134461,"Túi xách nữ da dù chống nước túi xách công sở túi đeo vai thời trang phong cách Hàn Quốc TN67",139000,139000,0,0
TIKI,tui-vi-nu,185079603,"Túi xách nữ Oscar - OCWHBSG 058",690000,1890000,1200000,63
TIKI,voucher-dich-vu,190335864,"VOUCHER - [TT006] - THAY ĐỔI NỘI DUNG GIẤY CHỨNG NHẬN ĐĂNG KÝ DOANH NGHIỆP - Công ty Luật Apra",2000000,2000000,0,0
TIKI,tui-vi-nu,73260559,"Ví tay Nữ mini sang trọng siêu năng kẹp nút Bi Tròn LL4 Tặng móc khóa cá heo",117810,161007,43197,27
TIKI,tui-vi-nu,56093264,"Túi Xách Nữ Đeo Chéo Mẫu Mới Nhất (Size 23)",75000,75000,0,0
TIKI,voucher-dich-vu,230082708,"[E-Voucher] Sách nói Fonos: Chế Độ Ăn Trường Thọ",99000,99000,0,0
TIKI,tui-vi-nu,161864224,"Túi xách nữ công sở đeo chéo hoạ tiết kẻ sọc sang trọng",75000,75000,0,0
TIKI,voucher-dich-vu,243300498,"[E-Voucher] Tour chợ nổi Cái Răng ghép đoàn",100000,100000,0,0
TIKI,voucher-dich-vu,254139816,"[Gói 5 năm] ALOSTAR - Mã kích hoạt app học tiếng Anh cho trẻ 2-7 tuổi Áp dụng trên toàn quốc",5000000,5000000,0,0
TIKI,tui-vi-nu,108830940,"VÍ MINI ĐỰNG THẺ NỮ Bóp Nhỏ Gọn Cardholder LUCY Da Saffiano Nhập Khẩu Cao Cấp Chống Thấm Nước",180000,180000,0,0
TIKI,voucher-dich-vu,66761996,"[E-Voucher] Tour du lịch miền Tây 1 ngày giá rẻ | Sài Gòn – Mỹ Tho – Bến Tre",550000,550000,0,0
TIKI,voucher-dich-vu,195852104,"[EVoucher Vietravel] Đông Bắc: Hà Giang - Lũng Cú - Đồng Văn - Mã Pí Lèng - Cột Cờ Lũng Cú",7990000,7990000,0,0
TIKI,voucher-dich-vu,254139935,"Voucher App học tiếng Anh dành cho học sinh Cấp 2 ALOWINGS Mã kích hoạt online áp dụng trên toàn quốc",1500000,1500000,0,0
TIKI,voucher-dich-vu,202631329,"[Vietravel HN] Gói 2N1Đ - Du Thuyền 5* Stella, Vịnh Hạ Long, Lan Hạ ",3690000,3690000,0,0
TIKI,tui-vi-nu,31885528,"Túi Xách Nữ 3 Ngăn 30x25x13cm DM267",299000,299000,0,0
TIKI,voucher-dich-vu,162400246,"Reading Gate - ứng dụng đọc sách học tiếng anh đa nền tảng web/ Android/ IOS (Gói 1 tháng)",600000,600000,0,0
TIKI,voucher-dich-vu,254145866,"[Gói 3 năm] Combo ALOSTAR và ALOKIDDY Tiếng Anh - Ứng dụng học tiếng Anh cho bé mầm và tiểu học",2500000,2500000,0,0
TIKI,voucher-dich-vu,254142203,"[Trọn đời] Combo ALOWINGS Tiếng Anh và Toán - Ứng dụng học tập chuẩn Sách Giáo Khoa từ Lớp 6 đến Lớp 9",8000000,8000000,0,0
TIKI,voucher-dich-vu,193450374,"[EVoucher Vietravel] Trung Quốc: Thượng Hải - Chu Gia Giác - Bắc Kinh - Chinh phục Vạn Lý Trường Thành",25990000,25990000,0,0
TIKI,voucher-dich-vu,195851943,"[EVoucher Vietravel] Hà Nội - Sapa - Bản Cát Cát - Fansipan - Cổng Trời Ô Quy Hồ",7190000,7190000,0,0
TIKI,voucher-dich-vu,254141710,"[Gói 1 năm] ENGLISH4U - Khóa học tiếng Anh trực tuyến dành cho học sinh, sinh viên, người đi làm",1000000,1000000,0,0
TIKI,voucher-dich-vu,91373451,"[E-Voucher] Tour Hòn Sơn từ Sài Gòn 2 ngày 1 đêm – Khám phá “Hòn đảo thiên đường”",1690000,1690000,0,0
TIKI,voucher-dich-vu,253227605,"[Gói 1 năm] App học Toán Tiếng Việt Tiếng Anh dành cho trẻ 6-10 tuổi ALOKIDDY TIỂU HỌC Mã kích hoạt áp dụng toàn quốc",2200000,2200000,0,0
TIKI,tui-vi-nu,190170113,"Túi đeo chéo nữ thời trang công sở phong cách mới – DCNU1004",317000,640000,323000,50
TIKI,voucher-dich-vu,254142155,"[Gói 4 năm] Combo ALOWINGS Tiếng Anh và Toán - Ứng dụng học tập chuẩn chương trình Cấp 2 chính quy",4400000,4400000,0,0
TIKI,tui-vi-nu,86561593,"Túi đeo chéo nữ    Túi xách nữ mini phối màu Fashion & Bag TD13",48000,48000,0,0
TIKI,tui-vi-nu,89261198,"Túi đeo chéo mini nữ Fimax FTDCMINI vải Oxford chống nước, túi nhỏ đeo chéo giá rẻ đựng điện phụ kiện đi dạo phố siêu cute  – BH 12 tháng",155000,155000,0,0
TIKI,tui-vi-nu,72025526,"Túi Xách Nữ V20",129000,129000,0,0
TIKI,tui-vi-nu,86560832,"Ví nữ    Ví cầm tay nữ mini cao cấp ngắn cute nhỏ gọn bỏ túi thời trang giá rẻ V091111",16900,16900,0,0
TIKI,voucher-dich-vu,34589868,"Khóa Học Chuyên Gia BSC - KPI Nội Bộ",10800000,10800000,0,0
TIKI,voucher-dich-vu,192409684,"[EVoucher Vietravel] Hà Nội - Hạ Long - Yên Tử - Ninh Bình - Bái Đính - Tràng An (Khách sạn 4 sao)",6590000,6590000,0,0
TIKI,voucher-dich-vu,199958162,"[EVoucher Vietravel] Đà Nẵng – Huế - Bà Nà – Cầu Vàng – Hội An (Khách sạn 4*) – Tặng Combo Thuyền dạo sông Hoài & Show Kí ức Hội An",6990000,6990000,0,0
TIKI,voucher-dich-vu,34361850,"[HCM] Tour 3N2Đ Hà Nội - Ninh Bình - Hạ Long, Gồm Vé Máy Bay Khứ Hồi, Khởi Hành Hàng Tuần",7390000,7390000,0,0
TIKI,voucher-dich-vu,254145783,"[Gói 1 năm] Combo ALOSTAR và ALOKIDDY Tiếng Anh - App học tiếng Anh cho trẻ mầm non và tiểu học",2000000,2000000,0,0
TIKI,voucher-dich-vu,253264776,"[HCM] Gói 14 Ngày Tập Luyện Tại Life Fitness & Yoga",299000,299000,0,0
TIKI,voucher-dich-vu,141372541,"[KHÓA HỌC ONLINE TƯƠNG TÁC]Học Etabs-Safe Cơ bản và Nâng cao (Tương tác trực tiếp với giảng viên qua Zoom)",2000000,2000000,0,0
TIKI,voucher-dich-vu,21775693,"Tick Edu - Quản Trị Mạng Marketting",799000,799000,0,0
TIKI,voucher-dich-vu,273532977,"Sạch da láng mịn kèm đắp mặt nạ (Gói Vi điện + Led + Mặt nạ) - 1 buổi",1860000,1860000,0,0
TIKI,voucher-dich-vu,36462502,"Tẩy Trắng Răng Công Nghệ Plasma Laser - Nha khoa Gia Hân",1250000,1250000,0,0
TIKI,voucher-dich-vu,207345059,"Sách nói Content Marketing Trong Kỷ Nguyên 4.0",99000,99000,0,0
TIKI,voucher-dich-vu,207230607,"Sách nói: Nghệ Thuật Quản Lý Thời Gian",99000,99000,0,0
TIKI,voucher-dich-vu,144349630,"Toàn Quốc [Voucher Giấy] Học online Tiếng Anh từ lớp 1 - 12 cùng TOPPY",299000,299000,0,0
TIKI,voucher-dich-vu,68540784,"Khóa học NGỮ VĂN LỚP 10 cô Diệu Thu - 09 tháng",700000,700000,0,0
TIKI,voucher-dich-vu,6462623,"Cạo Vôi + Đánh Bóng Răng Với Công Nghệ Hiện Đại",150000,150000,0,0
TIKI,voucher-dich-vu,273533931,"Trắng da căng bóng  RF-LED (Gói RF-Lifting + LED + Mặt nạ) - 1 buổi",3470000,3470000,0,0
TIKI,voucher-dich-vu,270275974,"Khóa học 3 tháng tập chạy 21km Techcombank Hồ Chí Minh Marathon",2800000,2800000,0,0
TIKI,voucher-dich-vu,254140046,"[Gói 2 năm] Mã kích hoạt online khóa học tiếng Anh dành cho Lớp 6 đến Lớp 9 ALOWINGS Áp dụng trên toàn quốc",1500000,1500000,0,0
TIKI,voucher-dich-vu,9975853,"Thanh Thanh Spa - Tắm Trắng Body & Facial Bằng Pha Lê Tuyết Kết Hợp Máy Phi Thuyền (Miễn Tip)",450000,450000,0,0
TIKI,voucher-dich-vu,254141990,"[Gói 1 năm] Combo ALOWINGS Tiếng Anh và Toán - App học tập dành cho Lớp 6 đến Lớp 9 Mã học online áp dụng toàn quốc",2500000,2500000,0,0
TIKI,voucher-dich-vu,270275948,"Khóa học 3 tháng tập chạy 42km giải Tiền Phong Marathon TPM",3000000,3000000,0,0
TIKI,voucher-dich-vu,190125499,"Sách nói: Hệ Miễn Dịch: Khám Phá Cơ Chế Tự Phòng Chữa Bệnh Của Cơ Thể Người",99000,99000,0,0
TIKI,voucher-dich-vu,21787104,"Tick Edu - Photoshop Chỉnh Hình Ảnh Chuyên Nghiệp Cho Nhà Nhiếp Ảnh",699000,699000,0,0
TIKI,voucher-dich-vu,101235553,"Chụp ảnh cưới tại Hồng Linh Studio-Voucher gói chụp ảnh cưới tại Hà Nội (SILVER)",8680000,8680000,0,0
TIKI,voucher-dich-vu,21761428,"Tick Edu - Thoát Khỏi Ác Mộng Ép Doanh Số Với Công Thức Bán Hàng 3S Đỉnh Cao",799000,799000,0,0
TIKI,voucher-dich-vu,190238869,"Hoa Yêu Thương -  Evoucher Giỏ Hoa Tươi - Tình Yêu Đầu",650000,650000,0,0
TIKI,voucher-dich-vu,207236836,"Sách nói Những Lối Về Ấu Thơ",99000,99000,0,0
TIKI,voucher-dich-vu,249685106,"Tour 6N5Đ Nhật Bản - Tokyo – Yamanashi – Nagoya – Kyoto – Osaka",30630000,30630000,0,0
TIKI,voucher-dich-vu,79855795,"Khóa học Quy trình bán hàng - Agilearn",480000,480000,0,0
TIKI,voucher-dich-vu,222692542,"[EVoucher Vietravel] Thái Lan: Chiangmai – Chiangrai: Khám phá Chùa Trắng & Tam Giác Vàng - Tặng vé tham quan Chiang Mai Night Safari",10490000,10490000,0,0
TIKI,tui-vi-nu,86561568,"Túi Xách Nữ /  50K - TÚI ĐEO CHÉO NỮ MINI HOA CÚC SIÊU XINH HOT TREND TV03",51000,51000,0,0
TIKI,voucher-dich-vu,13591435,"Voucher trắng sáng căng bóng da tại QUỲNH CHI SPA",600000,600000,0,0
TIKI,voucher-dich-vu,68534865,"Khóa học ĐẠI SỐ 7 - CƠ BẢN + NÂNG CAO thầy Quốc Sơn - 09 tháng",700000,700000,0,0
TIKI,voucher-dich-vu,91305213,"Sách nói: Tìm Bình Yên Trong Gia Đình ",99000,99000,0,0
TIKI,voucher-dich-vu,132346331,"[E-BOOK] i-Learn Smart Start Level 4 Sách mềm sách bài tập",15000,15000,0,0
TIKI,voucher-dich-vu,57510920,"Phần mềm hóa đơn điện tử Viettel Sinvoice- Gói 50000 hóa đơn điện tử Viettel - HÀNG CHÍNH HÃNG 100%",16950000,16950000,0,0
TIKI,voucher-dich-vu,190233713,"Phiếu Quà Tặng Hoa Yêu Thương 1000K",1000000,1000000,0,0
TIKI,voucher-dich-vu,273533783,"Da căng bóng mịn màng (Gói Scrubber + Jet Peel) -1 buổi",1860000,1860000,0,0
TIKI,voucher-dich-vu,161255655,"Sinh Trắc Vân Tay Gen Talents – Dịch Vụ Tư Vấn Sinh Trắc Vân Tay Gia Đình – Gói Phân Tích Demo – Tặng Sách Người Đua Diều (Tái Bản)",600000,600000,0,0
TIKI,voucher-dich-vu,34476173,"Khóa học Quyết định đầu tư",600000,600000,0,0
TIKI,voucher-dich-vu,195881036,"[Evoucher - NSG] DU LỊCH SINGAPORE - MALAYSIA",7990000,7990000,0,0
TIKI,voucher-dich-vu,212565330,"Gói DRAERP Phân phối (DISTRIBUTION DRAERP) - LOẠI HÌNH DOANH NGHIỆP",2250000,2250000,0,0
TIKI,voucher-dich-vu,271779709,"TOUR HỒ TRÀM - TROPICANA PARK 1 NGÀY - XE LIMOUSINE",990000,990000,0,0
TIKI,voucher-dich-vu,68503817,"Khóa học TIẾNG VIỆT LỚP 2 cô Thanh Thủy - 09 tháng",700000,700000,0,0
TIKI,voucher-dich-vu,21727072,"DỊCH VỤ PHUN MÔI COLLAGEN",1800000,1800000,0,0
TIKI,voucher-dich-vu,189182285,"Sách nói: Khói Trời Lộng Lẫy",99000,99000,0,0
TIKI,voucher-dich-vu,4730931,"Việt Hàn Spa - Điều Trị Rạn Da Sau Sinh Bằng Spectra Laser, Hiệu Quả Ngay Lần Đầu Tiên",455000,455000,0,0
TIKI,voucher-dich-vu,21775477,"Tick Edu - Massage Uyên Ương",599000,599000,0,0
TIKI,voucher-dich-vu,207236603,"Sách nói Bí Quyết Kinh Doanh Của Người Do Thái",99000,99000,0,0
TIKI,voucher-dich-vu,21787115,"Tick Edu - Trầm Cảm Sau Sinh",699000,699000,0,0
TIKI,voucher-dich-vu,139718208,"[KHÓA HỌC ONLINE TƯƠNG TÁC] Học Revit Structure (CB+NC) chuẩn Nhật Bản - Đại học Xây Dựng",2450000,2450000,0,0
TIKI,voucher-dich-vu,21775419,"Tick Edu - Phòng Và Trị Bệnh Cơ Xương Khớp, Cột Sống Bằng Tư Thế Đúng",599000,599000,0,0
TIKI,voucher-dich-vu,21761417,"Tick Edu - Tiền hôn nhân và tuyệt chiêu tìm bạn đời phù hợp",399000,399000,0,0
TIKI,voucher-dich-vu,21761421,"Tick Edu - Kiến thức về kinh nguyệt không phải ai cũng biết",799000,799000,0,0
TIKI,tui-thoi-trang-nam,90113768,"Túi xách da nam cao cấp phong cách hiện đại mới - 9910",349000,599000,250000,42
TIKI,tui-thoi-trang-nam,161560873,"Túi Đeo Chéo Nam Đẹp, Tiện Nghi, Thời Trang Màu Đen 208031",34300,38000,3700,10
TIKI,tui-thoi-trang-nam,203199337,"Túi đeo chéo nam phong cách châu âu",675000,750000,75000,10
TIKI,tui-thoi-trang-nam,192130009,"Túi đeo chéo nam da PU thời trang cao cấp hàng chính hãng YVan",385000,385000,0,0
TIKI,tui-thoi-trang-nam,191925622,"Túi công sở cao cấp da thật Shinkozi CS08 Da Bò Thật 100%",1900000,1900000,0,0
TIKI,tui-thoi-trang-nam,4225723,"Túi Nam Đeo Chéo Da Bò BHM8006D - Đỏ Mận (22 x 5.5 x 26 cm)",650000,650000,0,0
TIKI,tui-thoi-trang-nam,187512515,"Túi Xách, Cặp Công Sở Thời Trang Nam Da Bò Swift Cao Cấp 2 Khoá GCE23 Nâu",2600000,2600000,0,0
TIKI,tui-thoi-trang-nam,136787286,"Ví Cầm Tay Nam Gence Da Bò Cao Cấp Khóa Số  RB07",1300000,1300000,0,0
TIKI,tui-thoi-trang-nam,14289211,"Túi Bao Tử Túi Đeo Chéo Nam Da Pu Thời Trang Phái Mạnh 2019 - LKS445",199000,199000,0,0
TIKI,tui-thoi-trang-nam,157254083,"Ví Nam, Nữ Nút Ngắn Da Cao Cấp SAIGON SWAGGER SGS Anthem Leather Short Flap Wallet",450000,450000,0,0
TIKI,tui-thoi-trang-nam,167432346,"Túi Xách, Cặp Thời Trang Công Sở Nam Khóa Số Da Bò Cao Cấp CTS13 Nâu",2800000,2800000,0,0
TIKI,tui-thoi-trang-nam,73341295,"BÓP NGẮN GẬP DA SÁP Ví VINTAGE Da Sáp Nhập Khẩu Cao Cấp Chống Thấm Nước Unisex Nam Nữ Chuẩn Leonardo DOLANTO",178000,178000,0,0
TIKI,tui-thoi-trang-nam,111868827,"Túi đeo chéo nam Arctic Hunter K00096 chất liệu Oxford chống thấm nước, đựng ipad, thiết kế nhiều ngăn tiện dụng",379000,650000,271000,42
TIKI,tui-thoi-trang-nam,243146016,"Túi phụ kiện da bò thật, túi đeo ngực nam, túi đeo bụng, túi bao tử, túi đeo vai màu đen BEE GEE DCN9022",658000,1330000,672000,51
TIKI,tui-thoi-trang-nam,169653703,"Cặp học sinh văn phòng thời trang Dù Xốp Thái viền ngang kéo đen siêu bền",142560,205920,63360,31
TIKI,tui-thoi-trang-nam,48219622,"Túi đeo chéo da bò phong cách châu âu",275000,275000,0,0
TIKI,tui-thoi-trang-nam,73599730,"Túi bao tử nam BHLX007 Túi đeo bụng, đeo ngực da bò thật, không bong nổ",650000,650000,0,0
TIKI,tui-thoi-trang-nam,70524026,"Túi bao tử_túi đeo chéo da nam_nữ SEAGLE ST01",330000,330000,0,0
TIKI,tui-thoi-trang-nam,193233694,"Túi Đeo Vai, Túi Đeo Chéo Vải Nylon Cao Cấp Chống Thấm, Túi Đeo Hông Cao Cấp Nhiều Ngăn Tiện Lợi Thời Trang Nam Phong Cách Hàn Quốc",110000,110000,0,0
TIKI,tui-thoi-trang-nam,167473583,"Ví Nam, Bóp Nam Thời Trang Da Bò EPSOM Cao Cấp Gence HM07",1100000,1100000,0,0
TIKI,tui-thoi-trang-nam,143063148,"Ví nam da bò Anh Tho Leather MIN-02",429000,460000,31000,7
TIKI,tui-thoi-trang-nam,138157630,"VÍ ĐỰNG THẺ THÔNG MINH VBA",350000,350000,0,0
TIKI,tui-thoi-trang-nam,147896872,"Ví Da Nam Cầm Tay 1 Ngăn Cao Cấp",82000,160000,78000,49
TIKI,tui-thoi-trang-nam,75801365,"Túi đeo bụng, đeo hông buôn bán mẫu mới 8616 Tặng móc khóa A7",112438,153666,41228,27
TIKI,tui-thoi-trang-nam,183718980,"Túi Nam Đeo Chéo DC01 Chất Liệu Da Cao Cấp Đi Làm Đi Chơi Tiện Lợi Và Gọn Nhẹ",199000,380000,181000,48
TIKI,tui-thoi-trang-nam,198145047,"Túi đeo chéo Nam da bò thật cao cấp - B016A",650000,650000,0,0
TIKI,tui-thoi-trang-nam,53289766,"Túi đeo chéo nam nữ ngang ngực - đeo hong V9 thời trang PK010",145000,145000,0,0
TIKI,tui-thoi-trang-nam,168227938,"Túi Đeo Chéo Bụng Da Bò Thật Cao Cấp Cá Tính, Túi Bao Tử Da Nam",315000,315000,0,0
TIKI,tui-thoi-trang-nam,106244852,"Túi Đeo Chéo Bao Tử Nam Da Bò Cực Đẹp , Siêu Xịn",180000,360000,180000,50
TIKI,tui-thoi-trang-nam,70051251,"túi xách nam da bò thật - túi xách nam da bò thật cao cấp",899000,998000,99000,10
TIKI,tui-thoi-trang-nam,274443629,"Cặp nam văn phòng Marrant BHM17610 Da bò thật Túi xách công sở nam. Vừa laptop 14inch. Phom cứng.Hàng chính hãng",1400000,1400000,0,0
TIKI,tui-thoi-trang-nam,34680863,"Túi clutch nam da thật ELLY HOMME – ECM6",2599000,2599000,0,0
TIKI,tui-thoi-trang-nam,150374684,"Túi Xách, Cặp Thời Trang Nam Công Sở Da Bò Khóa Số Cao Cấp CTS09",4200000,4200000,0,0
TIKI,tui-thoi-trang-nam,171056563,"Túi đeo chéo nam nữ, túi bao tử, túi đeo ngực, túi đeo bụng da bò thật thương hiệu SEAGLE SB02",450000,450000,0,0
TIKI,tui-thoi-trang-nam,106244993,"Ví Da Bò Sáp Nam Siêu Chất Full Da Bò Xịn",168000,336000,168000,50
TIKI,tui-thoi-trang-nam,179013823,"Túi đeo bụng đeo chéoTĐ 520 đa năng cao cấp KT30",95134,137416,42282,31
TIKI,tui-thoi-trang-nam,53999685,"Túi đeo bụng đeo chéoTĐ 520 đa năng cao cấp KSX80",118057,161345,43288,27
TIKI,tui-thoi-trang-nam,111868714,"Túi đeo chéo,đeo ngực Arctic Hunter XB00105 chất liệu Oxford chống thấm nước thiết kế đơn giản, hiện đại, phù hợp nam nữ",359000,635000,276000,43
TIKI,tui-thoi-trang-nam,81116791,"Túi xách công sở nam",857000,857000,0,0
TIKI,tui-thoi-trang-nam,111869039,"Túi đeo chéo chống trộm Arctic Hunter XB00081 chất liệu Oxford chống thấm nước ,đựng ipad có cổng sạc USB, nhiều ngăn",369000,635000,266000,42
TIKI,tui-thoi-trang-nam,190858886,"Túi Đeo Chéo Thời Trang Năng Động STARGO RETRO",219000,219000,0,0
TIKI,tui-thoi-trang-nam,52602200,"Túi xách nam công sở cao cấp phong cách châu âu",405000,449000,44000,10
TIKI,tui-thoi-trang-nam,107961978,"Ví Nam Mini Da Bò Sáp Nhập Khẩu - Full Box",179000,179000,0,0
TIKI,tui-thoi-trang-nam,252860101,"[Da thật] Clutch nam da bò thật; Túi cầm tay nam da sáp CL145LS (nâu) - 100% da bò thật",639000,639000,0,0
TIKI,tui-thoi-trang-nam,133565700,"Ví Da Bò Thật Nam Cao Cấp Ví Dài V21",540000,540000,0,0
TIKI,tui-thoi-trang-nam,119616519,"Đeo chéo vải bố cao cấp kéo đứng Tặng bút cảm ứng ĐT",39600,54120,14520,27
TIKI,tui-thoi-trang-nam,148545259,"Ví da nam dọc D730 cầm tay thời trang cao cấp",65550,69000,3450,5
TIKI,tui-thoi-trang-nam,481737,"Túi Đeo Chéo Ipad Mikkor Betty Tablet BT006 - Nâu ",203000,203000,0,0
TIKI,tui-thoi-trang-nam,193970402,"Ví Nam Thời Trang cao cấp – VN1011",495000,1000000,505000,51
TIKI,tui-thoi-trang-nam,11718960,"Túi đeo hông, Túi đeo bụng nam nữ đa năng du lịch phượt wanfuniao",50000,50000,0,0
TIKI,tui-thoi-trang-nam,51299303,"Túi xách da bò nam công sở cao cấp phong cách châu âu",882000,980000,98000,10
TIKI,tui-thoi-trang-nam,103886747,"Bóp Cá Sấu Tuấn Minh Ví Nam Da Cá Sấu Gai Lưng Cao Cấp Màu Nâu Cà Phê ST01 Tặng kèm Hộp",750000,750000,0,0
TIKI,tui-thoi-trang-nam,86310816," Túi đeo chéo nam nữ vải bố thời trang nhỏ gọn tiện lợi",120000,120000,0,0
TIKI,tui-thoi-trang-nam,117393212,"Túi đeo chéo nam nữ da Pu cao cấp  TC09",97762,133608,35846,27
TIKI,tui-thoi-trang-nam,79675197,"Túi đeo chéo nam đựng ipad 9.7 vải Oxford chống thấm nước ",463500,463500,0,0
TIKI,tui-thoi-trang-nam,190184659,"Túi bao tử - đeo chéo unisex nam nữ vải chống nước phong cách Hàn",166250,175000,8750,5
TIKI,tui-thoi-trang-nam,185781988,"Ví Da Bò Nam Cao Cấp Bóp Da Nam POLO MEISDO Full Hộp Phù Hợp Làm Quà Biếu Tặng Sinh Nhật PL31",1500000,1500000,0,0
TIKI,tui-thoi-trang-nam,72467878,"Balo Đeo Chéo Da Cao Cấp Nấp Gập Thời Trang Kiểu Dáng Đơn Giản BL-D01",98010,141570,43560,31
TIKI,tui-thoi-trang-nam,192376103,"CẶP HEYYOU BASIC BACKPACK",450000,450000,0,0
TIKI,tui-thoi-trang-nam,174382609,"Túi xách nam công sở da bò cao cấp BEEGEE CCS5511",520000,1050000,530000,50
TIKI,tui-thoi-trang-nam,4331091,"Balo một quai Simplecarry Sling Big",540000,540000,0,0
TIKI,tui-thoi-trang-nam,149179742,"Túi đeo chéo nam da bò YUEKANGAROOS T53 (KT:27x23x7cm) Bảo hành da 12 tháng (Nâu-Đen)",660000,660000,0,0
TIKI,tui-thoi-trang-nam,173654411,"Ví Nam Da Cá Sấu Thật BIGGBEN Cao Cấp BG10",1000000,1000000,0,0
TIKI,tui-thoi-trang-nam,74180929,"Túi xách laptop, túi xách công sở nam vải canvas TX001",403200,560000,156800,28
TIKI,tui-thoi-trang-nam,186254950,"Túi đeo chéo nam cao cấp phong cách HÀN QUỐC BEE GEE– 01390",128000,258000,130000,50
TIKI,tui-thoi-trang-nam,200853184,"Ví Nam Da Cá Sấu 2 Mặt, Ví  Dáng Đứng Da Cá Sấu Thật Songhan Leather WM01 Làm Từ Da Bụng, Bảo Hành 12 Tháng",1000000,1000000,0,0
TIKI,tui-thoi-trang-nam,133810118,"Túi đeo chéo nam cao cấp BHM8710 Da bò nguyên tấm. Hàng chính hãng.",1199000,1199000,0,0
TIKI,tui-thoi-trang-nam,35327082,"Túi xách nam da thật ELLY HOMME – ETM5",2999000,2999000,0,0
TIKI,tui-thoi-trang-nam,40722292,"Cặp da công sở LATA CA29",720000,720000,0,0
TIKI,tui-thoi-trang-nam,169653644,"Cặp học sinh đa năng cao cấp Dù Xốp Thái viền chỉ xéo đôi siêu bền thời trang GSR1 Shalla",142560,205920,63360,31
TIKI,tui-thoi-trang-nam,159891200,"Túi xách da nam cao cấp phong cách hiện đại mới Mã TDC.9910",599000,599000,0,0
TIKI,tui-thoi-trang-nam,50491352,"Túi đeo ngực,đeo chéo nam đã tích hợp công nghệ 4.0",529000,799000,270000,34
TIKI,tui-thoi-trang-nam,38086342,"Túi đeo chéo nam vải canvas - TN001",38610,52767,14157,27
TIKI,tui-thoi-trang-nam,45019445,"Túi đeo chéo nam nữ unisex BEE GEE 070",68000,138000,70000,51
TIKI,tui-thoi-trang-nam,98651440,"Túi Đeo Chéo Chống Nước FALDO 02",270000,270000,0,0
TIKI,tui-thoi-trang-nam,197538668,"Túi xách nam Oscar - OCMHBLG040",3950000,7900000,3950000,50
TIKI,tui-thoi-trang-nam,187512564,"Túi Xách, Cặp Công Sở Thời Trang Nam Da Bò Swift Cao Cấp GCE24 Đen",2600000,2600000,0,0
TIKI,tui-thoi-trang-nam,73361687,"VÍ NGẮN GẬP DA Bóp CLASSY Da CrossGrain Nhập Khẩu Cao Cấp Chống Thấm Nước Unisex Nam Nữ Chuẩn Leonardo DOLANTO",208000,208000,0,0
TIKI,tui-thoi-trang-nam,3275963,"Ví Dài Nam Bụi Bặm",75000,75000,0,0
TIKI,tui-thoi-trang-nam,180235658,"Ví Da Nam VD05 Kiểu Ngang Hiện Đại Trẻ Trung Cá Tính",38000,50000,12000,24
TIKI,tui-thoi-trang-nam,137520251,"Ví Cầm Tay Clutch Nam GENCE CK11 Da Bò Khóa Số Cao Cấp Màu Nâu Phụ Kiện Vàng Hoặc Bạc",1400000,1400000,0,0
TIKI,tui-thoi-trang-nam,192377588,"Túi Xách Nam Công Sở Gence Da Bò Taiga CDX13",3500000,3500000,0,0
TIKI,tui-thoi-trang-nam,148748877,"túi xách nam công sở cao cấp phong cách châu âu",599000,599000,0,0
TIKI,tui-thoi-trang-nam,121974619,"Túi Đeo Chéo Bao Tử Nam Da Bò Phong Cách Thể Thao Hiện Đại",180000,360000,180000,50
TIKI,tui-thoi-trang-nam,188906958,"Bao da dành cho dành cho Chìa Khóa Honda Lead 2022, AirBlade 2023, Winner X 2022, PCX 160, Vario 160, AB 125, AB 160 2023 handmade da thật",99000,99000,0,0
TIKI,tui-thoi-trang-nam,35608327,"Túi đeo chéo - túi bao tử nam nữ du lịch thời trang BEE GEE 044",69000,140000,71000,51
TIKI,tui-thoi-trang-nam,165586359,"Cặp Công Sở Nam Lata CA14",499000,595000,96000,16
TIKI,tui-thoi-trang-nam,72970813,"Túi nam ngang da bò thật BHM1050 Thô nguyên tấm, vừa A4, vừa laptop 13inch",1370000,1370000,0,0
TIKI,tui-thoi-trang-nam,134842357,"Cặp da nam kiểu hàn quốc",1020000,1020000,0,0
TIKI,tui-thoi-trang-nam,13645401,"Túi đeo chéo nam nữ unisex thời trang Bee Gee 03",64000,130000,66000,51
TIKI,tui-thoi-trang-nam,96042251,"Túi đeo chéo nam nữ phong cách quân đội",145000,145000,0,0
TIKI,tui-thoi-trang-nam,107962441,"Ví Da Nam Handmade Phong Cách Thời Trang Hàng Hiệu Cho Quý Ông SVN Luxury",276000,276000,0,0
TIKI,tui-thoi-trang-nam,149179118,"Túi đeo chéo nam da bò thật T44 27x22x7.5cm đựng ipad (Nâu đậm-Nâu-Nâu sáng) - DH STORE",1250000,1250000,0,0
TIKI,tui-thoi-trang-nam,136939961,"Túi đeo chéo 5 ngăn chống thấm",52500,52500,0,0
TIKI,tui-thoi-trang-nam,52352846,"Túi Đeo Chéo Phản Quang Mini Bag Colkids Club Unisex SS3 - Đen",69900,69900,0,0
TIKI,tui-thoi-trang-nam,4225577,"Túi Nam Da Đeo Bụng BHM8355 - Nâu (32 x 9.5 x 9 cm)",670000,670000,0,0
TIKI,tui-thoi-trang-nam,149797920,"Túi Xách, Cặp Da Công Sở Thời Trang Nam Da Alran Cao Cấp GCE04",2500000,2500000,0,0
TIKI,tui-thoi-trang-nam,57694363,"Cặp nam công sở da bò thật Marrant BHM2019 Vừa laptop đến 15inch. Túi xách nam. Cặp văn phòng",750000,750000,0,0
TIKI,tui-thoi-trang-nam,107611618,"Ví Da Nam Cầm Tay Cao Cấp Dạng Dài, Bóp Da Nam Dáng Dài Cầm Tay Sang Trọng, Phong Cách Qúy Ông Hiện Đại",195000,195000,0,0
TIKI,tui-thoi-trang-nam,116727679,"Túi Nam Đeo Chéo Đeo Hông Da Bò BT04 Thông Dụng",259000,518000,259000,50
TIKI,tui-thoi-trang-nam,189671749,"EuroQuality Túi đeo chéo nam đựng ipad 9.7 vải Oxford chống thấm nước",549000,549000,0,0
TIKI,tui-thoi-trang-nam,149179358,"Túi xách tay đeo chéo nam da bò cao cấp ZHIZUNCANGUROOS T52 KT: 33x25x8cm (Nâu-Đen)",1140000,1140000,0,0
TIKI,tui-thoi-trang-nam,25407676,"Túi Đeo Chéo Da Cao Cấp Weixier B0833",185000,185000,0,0
TIKI,tui-thoi-trang-nam,189684205,"Túi Đeo Chéo Nam chống va đập XProtect Men",1140000,1140000,0,0
TIKI,tui-thoi-trang-nam,172538374,"Cặp tài liệu có khoá",91000,91000,0,0
TIKI,tui-thoi-trang-nam,91126883,"Túi Canvas Da PU chống thấm - SUPER STORE",806000,806000,0,0
TIKI,tui-thoi-trang-nam,41258265,"Cặp công sở văn phòng kép đỏ kẹp vào vali HD12 Shalla",130536,178400,47864,27
TIKI,tui-thoi-trang-nam,142458366,"Bóp ví da nam cầm tay dáng ngang nhiều ngăn đựng thẻ phong cách đơn giản,  thời trang",40000,80000,40000,50
TIKI,tui-thoi-trang-nam,193891511,"Ví Nam Thời Trang cao cấp – VN1010",426000,860000,434000,50
TIKI,tui-thoi-trang-nam,173652490,"Ví Nam Da Cá Sấu Thật BIGGBEN Cao Cấp BG8",1000000,1000000,0,0
TIKI,tui-thoi-trang-nam,187070734,"Túi Xách Nam Gence Da Bò Swift GCE24",3150000,3150000,0,0
TIKI,tui-thoi-trang-nam,139451370,"Túi đeo chéo chống nước cao cấp - Túi đeo vải thời trang, năng động",195000,195000,0,0
TIKI,tui-thoi-trang-nam,148801978,"Ví Nam Đứng Cao Cấp,Ví Da Nam Dáng Dứng Đựng Tiền Và Thẻ Mini Nhỏ Gọn Da Lộn",118000,118000,0,0
TIKI,tui-thoi-trang-nam,55601522,"Túi đeo chéo nam nữ du lịch thời trang Hàn quốc có kết nối cổng sạc USB và tai nghe ngoài đa năng DQTC002",199000,199000,0,0
TIKI,tui-thoi-trang-nam,122314685,"Túi Nam Đeo Chéo Đeo Hông Da Bò BT04 Thời Trang Tiện Ích",259000,518000,259000,50
TIKI,tui-thoi-trang-nam,67896332,"Túi đeo chéo nam nữ unisex chống thấm nước đi học đi chơi",220000,220000,0,0
TIKI,tui-thoi-trang-nam,44146712,"Túi xách da bò công sở cao cấp phong cách châu âu TX DA BÒ 7618",882000,980000,98000,10
TIKI,tui-thoi-trang-nam,133775941,"Ví Nam Đứng Gấp 3 Da Bò Cao Cấp SUNPOLO WSTF51 (Đen, Nâu Đỏ, Xanh)",490000,490000,0,0
TIKI,tui-thoi-trang-nam,151798855,"Túi Xách Nam Công Sở Da Bò Cao Cấp P. KUONE 1128",1668000,1668000,0,0
TIKI,tui-thoi-trang-nam,171774843,"Túi xách da đựng laptop công sở",857000,857000,0,0
