ecommerce,category,original_id,name,price,original_price,discount,discount_rate
TIKI,nha-sach-tiki,897016,"Combo Sân Chơi Trí Tuệ Của Chim Đa Đa (Bộ 6 Cuốn)",125000,180000,55000,31
TIKI,nha-sach-tiki,273536931,"Kinh Doanh Thời Trang - 8 Bước Xây Dựng, Vận Hành Và Phát Triển Shop Quần Áo Của Bạn",155000,199000,44000,22
TIKI,nha-sach-tiki,192844861,"Combo 2 Cuốn Tôn Giáo - Tâm Linh: An Nhiên Như Nắng + Đi Gặp Mùa Xuân - Hành Trạng Thiền Sư Thích Nhất Hạnh",375000,375000,0,0
TIKI,nha-sach-tiki,184075874,"(Gift) Bút ký khắc tên cao cấp LC 010, đẹp, mực mịn đều ở mọi góc nghiêng",159000,159000,0,0
TIKI,nha-sach-tiki,74021317,"Cây Cam Ngọt Của Tôi",77300,108000,30700,28
TIKI,nha-sach-tiki,272412121,"THUẬT LÃNH ĐẠO nơi công sở - How to Manage Problem Employees",249000,249000,0,0
TIKI,nha-sach-tiki,188940817,"Vị Thần Của Những Quyết Định",56100,79000,22900,29
TIKI,nha-sach-tiki,189643105,"Không Phải Sói Nhưng Cũng Đừng Là Cừu -Tặng kèm bookmark 2 mặt",96800,128000,31200,24
TIKI,nha-sach-tiki,26114399,"Nóng Giận Là Bản Năng , Tĩnh Lặng Là Bản Lĩnh",56500,89000,32500,37
TIKI,nha-sach-tiki,109017985,"Thiên Tài Bên Trái, Kẻ Điên Bên Phải (Tái Bản)",118000,179000,61000,34
TIKI,nha-sach-tiki,272530379,"Bộ sách trở thành “ÁT CHỦ BÀI” công sở (Gồm 2 cuốn)",498000,498000,0,0
TIKI,nha-sach-tiki,273046888,"Lãnh đạo là ngôn ngữ - Leadership is language",349000,349000,0,0
TIKI,nha-sach-tiki,108259024,"Combo Sách Osho - Đàn Ông + Đàn Bà + Ươm Mầm",299500,299500,0,0
TIKI,nha-sach-tiki,271960042,"Xoay chuyển con tàu - Turn the Ship Around",299000,299000,0,0
TIKI,nha-sach-tiki,216102104,"Bóng nhựa Arylic trong suốt đường kính 35 cm",1500000,1500000,0,0
TIKI,nha-sach-tiki,174301838,"BỘ BOOKMARK 1% TINH HOA",49000,49000,0,0
TIKI,nha-sach-tiki,52789367,"Nhà Giả Kim (Tái Bản 2020)",54000,79000,25000,32
TIKI,nha-sach-tiki,69764541,"Tâm Lý Học Hành Vi (Tặng Kèm 1 Bookmark )",70100,98000,27900,28
TIKI,nha-sach-tiki,174444163,"Dear, Darling",62900,88000,25100,29
TIKI,nha-sach-tiki,73207240,"Xa Ngoài Kia Nơi Loài Tôm Hát - Where The Crawdads Sing",105000,165000,60000,36
TIKI,nha-sach-tiki,22777661,"Combo Truyện Cổ Grim + Thần Thoại Hy Lạp + Truyện Cổ Andecxen",455002,455002,0,0
TIKI,nha-sach-tiki,184785575,"Bút Rồng Hoàng Gia cao cấp dành cho Doanh nhân LC056",399000,399000,0,0
TIKI,nha-sach-tiki,271061349,"Cách đưa bạn trở thành siêu sao nơi công sở - How to Be the Employee Your Company Can't Live Without",249000,249000,0,0
TIKI,nha-sach-tiki,147920903,"Một Thoáng Ta Rực Rỡ Ở Nhân Gian",100000,135000,35000,26
TIKI,nha-sach-tiki,121635154,"Điều Đẹp Nhất Có Khi Là Buông Tay (Tặng Kèm Bookmark)",51000,72000,21000,29
TIKI,nha-sach-tiki,3608621,"Góc Nhìn Alan - Bộ Di Sản Alan Phan",516000,516000,0,0
TIKI,nha-sach-tiki,3954355,"Yêu Những Điều Không Hoàn Hảo",99500,139000,39500,28
TIKI,nha-sach-tiki,117254517,"Đại Dương Đen - Những Câu Chuyện Từ Thế Giới Của Trầm Cảm",186000,240000,54000,23
TIKI,nha-sach-tiki,72882553,"Kỷ Luật Tự Giác (Tặng Kèm Bookmark )",58500,84000,25500,30
TIKI,nha-sach-tiki,195801653,"Chú Thuật Hồi Chiến - Tập 6 - Bản Tặng Kèm Obi Và Thẻ Bo Góc Nhựa",30000,30000,0,0
TIKI,nha-sach-tiki,115701940,"Giá MiCa Để Sách, iPad, Máy Tính",75000,75000,0,0
TIKI,nha-sach-tiki,121635152,"Không Ai Có Thể Làm Bạn Tổn Thương Trừ Khi Bạn Cho Phép (Tặng Kèm 1 Bộ Bookmark Gồm 4 Cái)",84000,119000,35000,29
TIKI,nha-sach-tiki,42230121,"Sách Hiểu Về Trái Tim (Tái Bản 2019) - Minh Niệm",128000,158000,30000,19
TIKI,nha-sach-tiki,46240929,"Rèn Luyện Tư Duy Phản Biện",68000,99000,31000,31
TIKI,nha-sach-tiki,106863963,"Tâm Lý Học - Phác Họa Chân Dung Kẻ Phạm Tội",105000,145000,40000,28
TIKI,nha-sach-tiki,195969664,"Tokyo Revengers - Tập 4",37000,115000,78000,68
TIKI,nha-sach-tiki,73787185,"Những Tù Nhân Của Địa Lý",139000,210000,71000,34
TIKI,nha-sach-tiki,196515658,"Blue Period - Tập 04",43100,48000,4900,10
TIKI,nha-sach-tiki,97594364,"Luật Tâm Thức - Giải Mã Ma Trận Vũ Trụ",226000,292000,66000,23
TIKI,nha-sach-tiki,193151000,"Trend Following – Cách thức để kiếm được VẬN MAY LỚN và GIÀU CÓ trong các thị trường BÒ, GẤU và các sự kiện THIÊN NGA ĐEN",599000,599000,0,0
TIKI,nha-sach-tiki,143217512,"Điềm Tĩnh Và Nóng Giận",69600,96000,26400,28
TIKI,nha-sach-tiki,157432544,"Giải Thích Ngữ Pháp Tiếng Anh (Với Bài Tập Và Đáp Án) (Tái Bản)",142000,220000,78000,35
TIKI,nha-sach-tiki,85763211,"Hãy Khiến Tương Lai Biết Ơn Vì Hiện Tại Bạn Đã Cố Gắng Hết Mình (Tặng Kèm: 01 Bookmark)",68800,99000,30200,31
TIKI,nha-sach-tiki,8885999,"Totto - Chan Bên Cửa Sổ (Tái Bản)",67000,98000,31000,32
TIKI,nha-sach-tiki,72459686,"How Psychology Works - Hiểu Hết Về Tâm Lý Học",225000,300000,75000,25
TIKI,nha-sach-tiki,145288029,"Xứ Cát",186000,249000,63000,25
TIKI,nha-sach-tiki,190861557,"Yêu Những Ngày Nắng Chẳng Ghét Những Ngày Mưa",106000,132000,26000,20
TIKI,nha-sach-tiki,111285062,"Đắc Nhân Tâm (Bìa Mềm)(Tái Bản)",62300,86000,23700,28
TIKI,nha-sach-tiki,197719874,"Suy Nghĩ Thống Kê Trong Đời Thường",105000,160000,55000,34
TIKI,nha-sach-tiki,194959173,"Semantic Error – Lỗi Logic (Tập 2)",194000,259000,65000,25
TIKI,nha-sach-tiki,117238177,"Thư Viện Nửa Đêm",115000,150000,35000,23
TIKI,nha-sach-tiki,194960721,"Blue Period - Tập 03",34100,48000,13900,29
TIKI,nha-sach-tiki,10095276,"Ikigai - Bí Mật Sống Trường Thọ Và Hạnh Phúc Của Người Nhật",69700,90000,20300,23
TIKI,nha-sach-tiki,68585576,"Càng Kỷ Luật, Càng Tự Do",79100,109000,29900,27
TIKI,nha-sach-tiki,3304875,"Điều Kỳ Diệu Của Tiệm Tạp Hóa NAMIYA (Tái Bản)",80900,105000,24100,23
TIKI,nha-sach-tiki,106864418,"Combo 10 Cuốn: Chuyện Xóm Gà",409000,580000,171000,29
TIKI,nha-sach-tiki,273536931,"Kinh Doanh Thời Trang - 8 Bước Xây Dựng, Vận Hành Và Phát Triển Shop Quần Áo Của Bạn",155000,199000,44000,22
TIKI,nha-sach-tiki,271442564,"Sổ planner 52 tuần 2024 SDstationery “Treasure the Journey” gáy lò xo, họa tiết màu pastel trang nhã 14x20.3cm",112000,132000,20000,15
TIKI,nha-sach-tiki,273046888,"Lãnh đạo là ngôn ngữ - Leadership is language",349000,349000,0,0
TIKI,nha-sach-tiki,168283405,"Chiến Tranh Tiền Tệ - Phần 1 - Ai Thực Sự Là Người Giàu Nhất Thế Giới ( Tái Bản 2022)",106000,165000,59000,36
TIKI,nha-sach-tiki,12410166,"Bút ký Lộc phát 168 - Màu đen - 1 bộ Full box ruột đen",210000,210000,0,0
TIKI,nha-sach-tiki,73518666,"Combo 3 cuốn osho:  Osho Đàn Ông + Osho Phụ Nữ + Osho Ươm Mầm",317500,317500,0,0
TIKI,nha-sach-tiki,3639597,"Bước Chậm Lại Giữa Thế Gian Vội Vã (Tái Bản)",65000,85000,20000,24
TIKI,nha-sach-tiki,71345381,"Sách Thay Đổi Cuộc Sống Với Nhân Số Học - Lê Đỗ Quỳnh Hương",181000,248000,67000,27
TIKI,nha-sach-tiki,197344455,"Ikigami - The Ultimate Limit - Tuyển Tập Những Câu Chuyện Lay Động Lòng Người - Tập 9",45000,45000,0,0
TIKI,nha-sach-tiki,78598381,"Tâm Lý Học Tính Cách (Tặng Kèm: 1 Bookmark)",76900,109000,32100,29
TIKI,nha-sach-tiki,184466860,"Hành Tinh Của Một Kẻ Nghĩ Nhiều",64000,86000,22000,26
TIKI,nha-sach-tiki,3608617,"Góc Nhìn Alan - Dành Tặng Doanh Nhân Việt Trong Thế Trận Toàn Cầu",199000,199000,0,0
TIKI,nha-sach-tiki,54614797,"Có Một Ngày, Bố Mẹ Sẽ Già Đi",66700,96000,29300,31
TIKI,nha-sach-tiki,52788072,"Chiến Binh Cầu Vồng (Tái Bản 2020)",84500,109000,24500,22
TIKI,nha-sach-tiki,3608639,"Combo Sách Góc Nhìn Alan (Gồm 2 Cuốn)",368000,368000,0,0
TIKI,nha-sach-tiki,104612965,"FLASHCARD SachID Moon",10000,10000,0,0
TIKI,nha-sach-tiki,161310103,"Từ Vựng IELTS 8.0 - Từ Vựng Đắt Để Đạt Điểm Cao 4 Kỹ Năng",89000,135000,46000,34
TIKI,nha-sach-tiki,180593003,"Combo 2Q: Nước Ép Xanh Chữa Lành Cơ Thể + Mong Mẹ Hãy Yêu Lấy Chính Mình",232500,232500,0,0
TIKI,nha-sach-tiki,76388962,"Chúng Ta Rồi Sẽ Hạnh Phúc, Theo Những Cách Khác Nhau [Tặng Kèm: 01 Bookmark]",61400,86000,24600,29
TIKI,nha-sach-tiki,109505434,"Bạn Không Thông Minh Lắm Đâu (Tái Bản)(Tặng kèm Bookmark)",96800,139000,42200,30
TIKI,nha-sach-tiki,10005245,"Đàn Ông Sao Hỏa Đàn Bà Sao Kim",134000,188000,54000,29
TIKI,nha-sach-tiki,8885995,"Sự Im Lặng Của Bầy Cừu (Tái Bản)",85800,115000,29200,25
TIKI,nha-sach-tiki,176254576,"(Gift) Bút ký khắc tên cao cấp làm quà tặng LC 010 màu xanh đọt chuối, sang trọng đẳng cấp",299000,299000,0,0
TIKI,nha-sach-tiki,92859698,"Tâm Lý Học Biểu Cảm",65500,98000,32500,33
TIKI,nha-sach-tiki,113779037,"(Gift) Bút ký khắc tên cao cấp Doanh nhân LC014, mực bi, đều ở mọi góc nghiêng",299000,299000,0,0
TIKI,nha-sach-tiki,113530805,"Tuổi Trẻ Đáng Giá Bao Nhiêu (Tái Bản)",61100,90000,28900,32
TIKI,nha-sach-tiki,106318762,"Sách ID Tiếng Anh cho người mới bắt đầu - người mới mất gốc Cô Trang Anh",159000,200000,41000,21
TIKI,nha-sach-tiki,161008715,"Power Vs Force - Trường Năng Lượng Và Những Nhân Tố Quyết Định Hành Vi Của Con Người (Tái Bản)",128000,179000,51000,28
TIKI,nha-sach-tiki,106185389,"Tổng ôn ngữ pháp Tiếng Anh cô Trang Anh- Sách luyện thi THPT Quốc gia môn tiếng anh",189000,250000,61000,24
TIKI,nha-sach-tiki,171556602,"2030: Những Xu Hướng Lớn Sẽ Định Hình Thế Giới Tương Lai (Tái Bản Lần 1)",155000,209000,54000,26
TIKI,nha-sach-tiki,57325187,"Sách Người Giàu Có Nhất Thành Babylon (Tái Bản 2020)",64500,98000,33500,34
TIKI,nha-sach-tiki,15267827,"Hoàng Tử Bé (Tái Bản 2019)",53500,75000,21500,29
TIKI,nha-sach-tiki,19792256,"Chuyện Con Mèo Dạy Hải Âu Bay (Tái Bản 2019)",37200,49000,11800,24
TIKI,nha-sach-tiki,187338036,"Chiến Tranh Tiền Tệ - Tập 4",116700,185000,68300,37
TIKI,nha-sach-tiki,113289973,"(Gift) Bút ký khắc tên cao cấp doanh nhân 035, thép nguyên khối sơn tĩnh điện công nghệ cao",299000,299000,0,0
TIKI,nha-sach-tiki,20917699,"Làm Sao Học Ít Hiểu Nhiều",82700,128000,45300,35
TIKI,nha-sach-tiki,75307228,"Sách OSHO Yêu - Being In Love - Yêu Trong Tỉnh Thức",117000,168000,51000,30
TIKI,nha-sach-tiki,53720978,"Trong Cái Không Có Gì Không ? (Thiền Sư Thích Nhất Hạnh Trả Lời Cho Trẻ Em Những Thắc Mắc Về Ý Nghĩa Cuộc Sống, Về Cái Chết, Về Gia Đình, Bạn Bè Và Nhiều Câu Hỏi Khác)",113000,160000,47000,29
TIKI,nha-sach-tiki,180584741,"Combo 2Q: Tớ Học Lập Trình - Làm Quen Với Python + Clean code – Mã sạch và con đường trở thành lập trình viên giỏi",452500,452500,0,0
TIKI,nha-sach-tiki,197558905,"Komi - Nữ Thần Sợ Giao Tiếp - Tập 13",24700,25000,300,1
TIKI,nha-sach-tiki,7833728,"Dạy Con Làm Giàu (Tập 1) - Để Không Có Tiền Vẫn Tạo Ra Tiền - Cha Giàu Cha Nghèo (Tái Bản)",49100,80000,30900,39
TIKI,nha-sach-tiki,49747007,"Hai Mặt Của Gia Đình",68500,98000,29500,30
TIKI,nha-sach-tiki,77774625,"Nghệ Thuật Tập Trung - Nâng Cao Năng Suất, Tối Ưu Thời Gian, Hiệu Quả Bất Ngờ",68800,99000,30200,31
TIKI,nha-sach-tiki,90622579,"Tâm Lý Học - Nghệ Thuật Giải Mã Hành Vi",96100,150000,53900,36
TIKI,nha-sach-tiki,54266567,"Sách Nghĩ Giàu Và Làm Giàu (Bìa Mềm)",78000,110000,32000,29
TIKI,nha-sach-tiki,114197876,"(Gift)Bút ký khắc tên cao cấp Doanh nhân LC008, mực mịn, đều ở mọi góc nghiêng",750000,750000,0,0
TIKI,nha-sach-tiki,4780917,"Người Đua Diều (Tái Bản 2018)",100000,129000,29000,22
TIKI,nha-sach-tiki,168373800,"Sách - Thao túng tâm lý - 1980BOOKS",118000,169000,51000,30
TIKI,nha-sach-tiki,114937969,"Rừng Nauy (Tái Bản)",116000,150000,34000,23
TIKI,nha-sach-tiki,113406962,"(Gift) Bút ký khắc tên cao cấp Doanh nhân LC 021, mực bi đều ở mọi góc nghiêng",299000,299000,0,0
TIKI,nha-sach-tiki,161008717,"Kiếp Nào Ta Cũng Tìm Thấy Nhau: Câu Chuyện Về Những Linh Hồn Tri Kỷ Vĩnh Viễn Không Chia Lìa (Tái Bản)",66800,99000,32200,33
TIKI,nha-sach-tiki,69978860,"Sói đội lốt Cừu - Kẻ hiếu chiến ngầm và các thủ thuật thao túng tâm lí",75000,110000,35000,32
TIKI,nha-sach-tiki,193614514,"[Gift] Tặng 01 bookmark cho mỗi đơn hàng",19500,30000,10500,35
TIKI,nha-sach-tiki,112110014,"TÂM LÝ HỌC ỨNG DỤNG",89800,129000,39200,30
TIKI,nha-sach-tiki,173748415,"Tâm Lý Học Mối Quan Hệ",69200,98000,28800,29
TIKI,nha-sach-tiki,80628929,"Từ IQ Đến EQ - Nắm Bắt Thành Công Qua Trí Tuệ Cảm Xúc",63500,91000,27500,30
TIKI,nha-sach-tiki,147999778,"Không Bao Giờ Là Thất Bại - Tất Cả Là Thử Thách (Ấn Bản Cập Nhật Đầy Đủ Nhất)(Bìa Cứng)",141000,268000,127000,47
TIKI,nha-sach-tiki,103640412,"Đừng Lựa Chọn An Nhàn Khi Còn Trẻ (Tái Bản)",69000,99000,30000,30
TIKI,nha-sach-tiki,168293266,"Chiến Tranh Tiền Tệ - Phần 2 - Sự Thống Trị Của Quyền Lực Tài Chính ( Tái Bản 2022)",111000,170000,59000,35
TIKI,nha-sach-tiki,91947689,"7 Thói Quen Hiệu Quả (The 7 Habits Of Highly Effective People) (Tái Bản)",191000,250000,59000,24
TIKI,nha-sach-tiki,72308265,"Hoa Vẫn Nở Mỗi Ngày",140400,234000,93600,40
TIKI,nha-sach-tiki,138107485,"Mặt Dày Tâm Đen (Tái Bản)",109000,169000,60000,36
TIKI,nha-sach-tiki,56454897,"Hiệu Sách Nhỏ Ở Paris",110000,149000,39000,26
TIKI,nha-sach-tiki,103379147,"Bạch Dạ Hành (Tái Bản)",156000,209000,53000,25
TIKI,nha-sach-tiki,27582931,"How Money Works - Hiểu Hết Về Tiền",220000,300000,80000,27
TIKI,nha-sach-tiki,74341297,"Không Sợ Chậm Chỉ Sợ Dừng",92400,129000,36600,28
TIKI,nha-sach-tiki,70016692,"Bắt Trẻ Đồng Xanh (Tái Bản 2020)",60200,88000,27800,32
TIKI,nha-sach-tiki,70224520,"Băng keo dán nano 2 mặt siêu dính trong suốt dày 1mm dài 2m rộng 3cm và 5cm",17999,17999,0,0
TIKI,nha-sach-tiki,5067169,"Luật Hấp Dẫn (Tái Bản)",65800,89000,23200,0
TIKI,nha-sach-tiki,195969669,"Chào Mừng Đến Lớp Học Đề Cao Thực Lực - 3",63000,120000,57000,48
TIKI,nha-sach-tiki,139303869,"Nghệ Thuật Tinh Tế Của Việc Đếch Quan Tâm (Tái Bản)",83000,128000,45000,35
TIKI,nha-sach-tiki,82912488,"Từ Tốt Đến Vĩ Đại (Tái bản 2021)",75000,130000,55000,42
TIKI,nha-sach-tiki,197344441,"Như Cơn Gió Thoảng - Nghĩ Về Những Qui Luật Cuộc Sống",80500,80500,0,0
TIKI,nha-sach-tiki,197344439,"Kingdom - Tập 34",43600,45000,1400,3
TIKI,nha-sach-tiki,196923457,"Blue Flag - Tập 2",44100,45000,900,2
TIKI,nha-sach-tiki,3608625,"Payback Time - Ngày Đòi Nợ",299000,299000,0,0
TIKI,nha-sach-tiki,74362508,"Thần Số Học Ứng Dụng",78000,129000,51000,40
TIKI,nha-sach-tiki,8835159,"Đời Ngắn Đừng Ngủ Dài (Tái Bản)",62200,85000,22800,27
TIKI,nha-sach-tiki,157255752,"Sức Mạnh Của Hiện Tại (Tái Bản)",117000,168000,51000,30
TIKI,nha-sach-tiki,174215347,"Ajin - Boxset Số 3 (Tập 13 - 17) - Tặng Kèm Bookmark 3D",192000,270000,78000,29
TIKI,nha-sach-tiki,7718737,"Nghệ Thuật Tư Duy Rành Mạch (Tái Bản)",85600,118000,32400,27
TIKI,nha-sach-tiki,184070223,"OSHO - Cảm Xúc",131000,188000,57000,30
TIKI,nha-sach-tiki,23416722,"How The Body Works - Hiểu Hết Về Cơ Thể",205000,300000,95000,32
TIKI,nha-sach-tiki,76013378,"Storytelling With Data - Kể Chuyện Thông Qua Dữ Liệu (Cuốn Cẩm Nang Hướng Dẫn Trực Quan Hóa Dữ Liệu)",222100,319000,96900,30
TIKI,nha-sach-tiki,59262880,"Sách Người Bán Hàng Vĩ Đại Nhất Thế Giới (Tái Bản 2020)",103000,148000,45000,30
TIKI,nha-sach-tiki,72001057,"Chiến Tranh Tiền Tệ - Phần III",112000,175000,63000,36
TIKI,nha-sach-tiki,195801662,"Ngôi Sao Vườn Nữ Sinh - Tập 1",49100,50000,900,2
TIKI,nha-sach-tiki,192115858,"Chú Thuật Hồi Chiến -  Tập 5 - Giao Lưu Trường Kết Nghĩa Kyoto [Tặng Kèm Obi Và Thẻ Bo Góc Nhựa]",30000,30000,0,0
TIKI,nha-sach-tiki,140416370,"Dòng Chảy",167000,228000,61000,27
TIKI,nha-sach-tiki,181699664,"Những Ngã Tư Và Những Cột Đèn",149000,200000,51000,26
TIKI,nha-sach-tiki,196016785,"Ikigami - Tập 08",40400,45000,4600,10
TIKI,nha-sach-tiki,194205608,"Cherry Magic - Tập 2",86500,109000,22500,21
TIKI,nha-sach-tiki,127844385,"Kiêu Hãnh Và Định Kiến (Tái Bản)",86500,116000,29500,25
TIKI,nha-sach-tiki,148760924,"How Management Works - Hiểu Hết Về Quản Lý",242000,330000,88000,27
TIKI,nha-sach-tiki,196851308,"Dragon Ball Full Color - Phần Năm: Truy Lùng Cell Bọ Hung - Tập 4",76500,77000,500,1
TIKI,nha-sach-tiki,167972598,"Tôi Thích Bản Thân Nỗ Lực Hơn (Ấn Bản Kỷ Niệm)",84500,120000,35500,30
TIKI,nha-sach-tiki,107802183,"Sách Sức Mạnh Tiềm Thức (Tái Bản) (Bìa Mềm)",91700,128000,36300,28
TIKI,nha-sach-tiki,173882437,"8 Vụ Án Hoàn Hảo - Vạch Trần Tâm Lý Kẻ Phạm Tội",101000,145000,44000,30
TIKI,nha-sach-tiki,120219394,"Tôi Nói Gì Khi Nói Về Chạy Bộ",53000,76000,23000,30
TIKI,nha-sach-tiki,94173458,"Khuyến Học (Tái Bản)",47100,65000,17900,28
TIKI,nha-sach-tiki,192124399,"Blue Period Tập 2",34000,48000,14000,29
TIKI,nha-sach-tiki,196409700,"Công Chúa Ma Cà Rồng Quyền Năng Chỉ Muốn Có Một Người Em Gái Mà Thôi",146000,175000,29000,17
TIKI,nha-sach-tiki,173763072,"Tâm Lý Học Hẹn Hò - Nghệ Thuật Giao Tiếp Trong Tình Yêu",78000,109000,31000,28
TIKI,nha-sach-tiki,185067342,"Tô Bình Yên Vẽ Hạnh Phúc (Tái Bản)",62000,88000,26000,30
TIKI,nha-sach-tiki,52329763,"Kafka bên bờ biển (Tái Bản 2020)",114000,158000,44000,28
TIKI,nha-sach-tiki,179546672,"Làm Sao Học Hết Được Nhân Sinh",130000,169000,39000,23
TIKI,nha-sach-tiki,194205620,"Người Hướng Nội Trong Thế Giới Hướng Ngoại",79000,105000,26000,25
TIKI,nha-sach-tiki,85396163,"Combo 2 Cuốn: Yêu Những Điều Không Hoàn Hảo + Bước Chậm Lại Giữa Thế Gian Vội Vã (Tái Bản)",165000,224000,59000,26
TIKI,nha-sach-tiki,55605170,"Cơ Thể Tự Chữa Lành: Thực Phẩm Thay Đổi Cuộc Sống",119000,185000,66000,36
TIKI,nha-sach-tiki,124767703,"Cân Bằng Cảm Xúc Cả Lúc Bão Giông (Tặng Kèm Bookmark)(Tái Bản)",67100,105000,37900,36
TIKI,nha-sach-tiki,191920180,"Cherry Magic - Tập 1",86000,109000,23000,21
TIKI,nha-sach-tiki,76776245,"Nghệ Thuật Tư Duy Phản Biện",85900,129000,43100,33
TIKI,nha-sach-tiki,195187480,"Thiên Quan Tứ Phúc - Tập 6 (Tiểu thuyết, đam mỹ)",110700,159000,48300,30
TIKI,nha-sach-tiki,273624916,"[ Trạm Đọc Official ]  Trí Tuệ Do Thái (Tái Bản)",142000,189000,47000,25
TIKI,nha-sach-tiki,158019962,"Combo 3 Cuốn Bộ Sách: Nuôi Con Không Phải Là Cuộc Chiến 2 (Tái Bản)",262000,377000,115000,31
TIKI,nha-sach-tiki,105663942,"Hành Trình Về Phương Đông (Tái Bản 2021)",83000,118000,35000,30
TIKI,nha-sach-tiki,108684605,"Trí Thông Minh Của Sự Tinh Tế",63600,89000,25400,29
TIKI,nha-sach-tiki,3644267,"Đặc Quyền Của Gái Hư",61400,86000,24600,29
TIKI,nha-sach-tiki,105483727,"Ổn Định Hay Tự Do",92400,129000,36600,28
TIKI,nha-sach-tiki,13333355,"Đọc Nhiều Nhớ Được Bao Nhiêu?",76200,118000,41800,35
TIKI,nha-sach-tiki,179735872,"Sách Tâm Lý Dành Cho Người Nhạy Cảm",62700,89000,26300,30
TIKI,nha-sach-tiki,540039,"Giáo Trình Chuẩn HSK 1 - Bài Học (Kèm file MP3)",149000,198000,49000,25
TIKI,nha-sach-tiki,100931416,"Bắt Đầu Với Câu Hỏi Tại Sao - Nghệ Thuật Truyền Cảm Hứng Trong Kinh Doanh (Tái Bản)",78000,109000,31000,28
TIKI,nha-sach-tiki,197353399,"Học Viện Siêu Anh Hùng Vigilantes - My Hero Academia Illegals - Tập 1: Đã Có Ta Ở Đây",29000,30000,1000,3
TIKI,nha-sach-tiki,171549981,"Cuộc Diễu Hành Thầm Lặng",148000,198000,50000,25
TIKI,nha-sach-tiki,8886007,"Ngàn Mặt Trời Rực Rỡ (Tái Bản)",100000,130000,30000,23
TIKI,nha-sach-tiki,154245455,"Combo 2 Cuốn Nghiền Từ Vựng Tiếng Anh: Học Qua Gốc Từ Bằng Hình Ảnh - Gốc Từ Là Bí Quyết Để Ghi Nhớ Hàng Nghìn Từ Vựng",177000,270000,93000,34
TIKI,nha-sach-tiki,163703151,"Chuyện Kể Rằng Có Nàng Và Tôi",51700,72000,20300,28
TIKI,nha-sach-tiki,168234714,"Cư Xử Như Đàn Bà Suy Nghĩ Như Đàn Ông",78100,109000,30900,28
TIKI,nha-sach-tiki,71907876,"Từ Điển Tiếng “Em”",48200,69000,20800,30
TIKI,nha-sach-tiki,139567621,"Thức Tỉnh Mục Đích Sống (Tái Bản)",98000,148000,50000,34
TIKI,nha-sach-tiki,196422809,"Bá Tước Tiểu Thư - Tập 3",30000,30000,0,0
TIKI,nha-sach-tiki,149089470,"Những Vị Thần Nước Mỹ",187000,250000,63000,25
TIKI,nha-sach-tiki,195885688,"Dragon Quest - Dấu Ấn Roto (Dragon Quest Saga Emblem Of Roto) Perfect Edition - Tập 9",74100,75000,900,1
TIKI,nha-sach-tiki,126743459,"Fear - Sợ Hãi (Hóa Giải Sợ Hãi Bằng Tình Thương)",76100,109000,32900,30
TIKI,nha-sach-tiki,185071145,"Sói Đầu Đàn Và Cún Nhỏ - Tập 2",105000,135000,30000,22
TIKI,nha-sach-tiki,35191892,"21 Bài Học Cho Thế Kỷ 21",162000,209000,47000,22
TIKI,nha-sach-tiki,197781975,"Dr.Slump Ultimate Edition Tập 12",59500,60000,500,1
TIKI,nha-sach-tiki,104741661,"Combo 2 Tập : 999 Lá Thư Gửi Cho Chính Mình (Tái Bản)",193000,258000,65000,25
TIKI,nha-sach-tiki,14508205,"Sổ tay thực hành 66 ngày thử thách",89000,89000,0,0
TIKI,nha-sach-tiki,77105730,"Tàn Ngày Để Lại (Bìa Cứng)",126000,169000,43000,25
TIKI,nha-sach-tiki,195190105,"Color Rush - Bản Thông Thường",223000,265000,42000,16
TIKI,nha-sach-tiki,54748899,"Sách Muôn Kiếp Nhân Sinh (Bìa Mềm) - Nguyên Phong",118000,168000,50000,30
TIKI,nha-sach-tiki,152740748,"Lối Sống Tối Giản Của Người Nhật (Tái Bản)",85200,119000,33800,28
TIKI,nha-sach-tiki,54422942,"Tôi Quyết Định Sống Cho Chính Tôi (Tái Bản 2020)",59400,88000,28600,33
TIKI,nha-sach-tiki,167210779,"Quyền Lực",111000,155000,44000,28
TIKI,nha-sach-tiki,196016781,"Kingdom - Tập 33",42000,45000,3000,7
TIKI,nha-sach-tiki,45902241,"Tìm Mình Trong Thế Giới Hậu Tuổi Thơ",106000,142000,36000,25
TIKI,nha-sach-tiki,3608623,"Bí Mật Của Phan Thiên Ân",69000,69000,0,0
TIKI,nha-sach-tiki,87226756,"Những Đêm Không Ngủ, Những Ngày Chậm Trôi",56000,86000,30000,35
TIKI,nha-sach-tiki,194960238,"Slam Dunk - Deluxe Edition - Tập 10",55000,60000,5000,8
TIKI,nha-sach-tiki,73878873,"Tư Duy Sâu",64100,91000,26900,30
TIKI,nha-sach-tiki,185242031,"The Shining - Thị Kiến",200000,269000,69000,26
TIKI,nha-sach-tiki,57110087,"Siêu Cò – How To Be A Power Connector",249000,249000,0,0
TIKI,nha-sach-tiki,196515661,"Văn Phòng Thám Tử Quái Vật - Tập 12",23500,30000,6500,22
TIKI,nha-sach-tiki,191571494,"Black Jack - Tập 12",30000,30000,0,0
TIKI,nha-sach-tiki,57762732,"Nhà Đầu Tư Thông Minh (Tái Bản 2020)",154000,199000,45000,23
TIKI,nha-sach-tiki,183058543,"OSHO - Trưởng Thành",89100,128000,38900,30
TIKI,nha-sach-tiki,17336360,"Lolita (Tái Bản 2019)",92900,128000,35100,27
TIKI,nha-sach-tiki,750578,"Khi Hơi Thở Hóa Thinh Không",74000,109000,35000,32
TIKI,nha-sach-tiki,110448022,"Ba Phút Sơ Cứu",104000,140000,36000,26
TIKI,nha-sach-tiki,187827003,"Không Diệt Không Sinh Đừng Sợ Hãi (TB5)",75000,110000,35000,32
TIKI,nha-sach-tiki,196851310,"Migi & Dali - Tập 2",39000,40000,1000,3
TIKI,nha-sach-tiki,53532186,"Tuyệt kỹ Giao dịch bằng đồ thị nến Nhật – Japanese Candlestick Charting Techniques",499000,499000,0,0
TIKI,nha-sach-tiki,158019964,"Combo 4 Cuốn Bộ Sách: Nuôi Con Không Phải Là Cuộc Chiến (Tái Bản)",350300,506000,155700,31
TIKI,nha-sach-tiki,162844699,"Tạm Biệt Tôi Của Nhiều Năm Về Trước",67800,95000,27200,29
TIKI,nha-sach-tiki,90887853,"Mình Chỉ Là Người Bình Thường (Sách Tô Màu)",97500,138000,40500,29
TIKI,nha-sach-tiki,196515664,"Anh Em Phi Hành Gia - Tập 33",44500,45000,500,1
TIKI,nha-sach-tiki,12377498,"Bố Con Cá Gai (Tái Bản 2019)",74400,96000,21600,23
TIKI,nha-sach-tiki,196923451,"Vua Sáng Chế - Tập 17",20000,20000,0,0
TIKI,nha-sach-tiki,115266692,"Sách - Ám Ảnh Sợ Xã Hội - Chạy Trốn Hay Đối Mặt",82900,125000,42100,34
TIKI,nha-sach-tiki,170708233,"Thay Đổi Tí Hon - Hiệu Quả Bất Ngờ (Tái Bản)",140000,189000,49000,26
TIKI,nha-sach-tiki,378448,"Nhà Giả Kim",66950,66950,0,0
TIKI,nha-sach-tiki,50414368,"Án Mạng Mười Một Chữ",75400,110000,34600,31
TIKI,nha-sach-tiki,84970841,"Men Chase Women Choose - Chuyện Tình Yêu Bạn Biết Được Bao Nhiêu?",73600,109000,35400,32
TIKI,nha-sach-tiki,145289356,"Sách Atomic Habits - Thay Đổi Tí Hon, Hiệu Quả Bất Ngờ ( Những Thay Đổi Nhỏ Tạo Nên Thành Công Lớn/ Tặng kèm Bookmark)",160000,189000,29000,15
TIKI,nha-sach-tiki,173865570,"Một Cuốn Sách Về Chủ Nghĩa Tối Giản (Tái bản 2022)",129000,129000,0,0
TIKI,nha-sach-tiki,128649312,"21 Nguyên Tắc Tự Do Tài Chính (Tái Bản)",38000,55000,17000,31
TIKI,nha-sach-tiki,100321478,"Muốn An Được An (Tái bản 2021)",43000,65000,22000,34
TIKI,nha-sach-tiki,9948009,"Dám Hạnh Phúc",78100,110000,31900,29
TIKI,nha-sach-tiki,179546078,"Luật Hấp Dẫn - Quy Luật Về Sức Mạnh Tâm Trí Và Phát Huy Năng Lượng Tích Cực Để Làm Chủ Định Mệnh",81500,139000,57500,41
TIKI,nha-sach-tiki,145288026,"Chia Rẽ - Tại Sao Chúng Ta Đang Sống Trong Thời Đại Của Những Bức Tường",149000,200000,51000,26
TIKI,nha-sach-tiki,197990865,"Dragon Quest - Dấu Ấn Roto (Dragon Quest Saga Emblem Of Roto) Perfect Edition - Tập 10",73300,75000,1700,2
TIKI,nha-sach-tiki,86517373,"Khoa Học Về Nấu Ăn - The Science Of Cooking",267000,350000,83000,24
TIKI,nha-sach-tiki,11122712,"Bộ sách Làm Giàu Từ Chứng Khoán (How To Make Money In Stock) phiên bản mới + Hướng Dẫn Thực Hành CANSLIM Cho Người Mới Bắt Đầu",700000,700000,0,0
TIKI,nha-sach-tiki,7982628,"Suối Nguồn (Tái Bản)",229000,380000,151000,40
TIKI,nha-sach-tiki,106864418,"Combo 10 Cuốn: Chuyện Xóm Gà",409000,580000,171000,29
TIKI,nha-sach-tiki,186237324,"Thiên quan tứ phúc - Tập 5 (Tiểu thuyết đam mỹ) - Tặng kèm 1 bookmark 2 mặt",110700,159000,48300,30
TIKI,nha-sach-tiki,168559521,"Sự Trung Thực Của Xác Chết – Ghi Chép Của Một Nhà Pháp Y",68800,99000,30200,31
TIKI,nha-sach-tiki,104074997,"Kỹ Năng Bán Hàng Tuyệt Đỉnh (Tái Bản)",77500,120000,42500,35
TIKI,nha-sach-tiki,73515859,"Sách OSHO - Can Đảm Là Chính Mình Trong Thế Giới Hiểm Nguy",61100,88000,26900,31
TIKI,nha-sach-tiki,2496281,"Đồi Gió Hú (Tái Bản)",80000,108000,28000,0
TIKI,nha-sach-tiki,21130350,"Vụ Án LEROUGE (Trinh Thám)",79000,168000,89000,53
TIKI,nha-sach-tiki,196515668,"Quán Rượu Dị Giới "Nobu" - Tập 11",35000,40000,5000,13
TIKI,nha-sach-tiki,11368965,"Combo Giáo Trình Chuẩn HSK 1 - Bài Học (Kèm 1 MP3) và Giáo Trình Chuẩn HSK 1 - Bài Tập (Kèm 1 MP3) ( Tặng Kèm Viết )",284800,356000,71200,20
TIKI,nha-sach-tiki,179546070,"Luật Hấp Dẫn - Quy Luật Về Sức Mạnh Của Linh Hồn Và Năng Lượng Chữa Lành Cơ Thể Từ Bên Trong",85900,129000,43100,33
TIKI,nha-sach-tiki,641906,"Bí Mật Của Naoko",79400,108000,28600,26
TIKI,nha-sach-tiki,130233544,"Mèo Và Triết Lý Nhân Sinh - Mèo Đã Dạy Chúng Ta Điều Gì Về Cuộc Sống",145500,209000,63500,30
TIKI,nha-sach-tiki,194960244,"Fullmetal Alchemist - Cang Giả Kim Thuật Sư - Fullmetal Edition - Tập 16",63000,69000,6000,9
TIKI,nha-sach-tiki,191782162,"Trên Đường Băng (Tony Buổi Sáng)",71500,105000,33500,32
TIKI,nha-sach-tiki,35283863,"Lược Sử Thế Giới",219000,320000,101000,32
TIKI,nha-sach-tiki,828621,"Dolocher (Trinh Thám)",44000,159000,115000,72
TIKI,nha-sach-tiki,194104216,"Văn Phòng Thám Tử Quái Vật - Tập 11",29100,30000,900,3
TIKI,nha-sach-tiki,73316977,"Hành Trình Của Linh Hồn (Tái Bản 2020)",89800,129000,39200,30
TIKI,nha-sach-tiki,56692532,"Tôi Từng Nghĩ Mọi Thứ Sẽ Ổn Khi Trở Thành Người Lớn (Tặng Kèm 1 Bookmark)",66500,96000,29500,31
TIKI,nha-sach-tiki,102629318,"999 Lá Thư Gửi Cho Chính Mình (*) - Tập 1 - Mong Bạn Trở Thành Phiên Bản Hoàn Hảo Nhất (Tái bản)",92400,129000,36600,28
TIKI,nha-sach-tiki,174842858,"Sách Sức Mạnh Của Ngôn Từ (Tái Bản 2022)",75100,108000,32900,30
TIKI,nha-sach-tiki,155550591,"Dinh Dưỡng Học Bị Thất Truyền - Dinh Dưỡng Đẩy Lùi Bệnh Tật",115000,178000,63000,35
TIKI,nha-sach-tiki,179063952,"Khi Mọi Điểm Tựa Đều Mất",65200,98000,32800,33
TIKI,nha-sach-tiki,66090079,"Cơ Thể Tự Chữa Lành: Giải Cứu Gan",161000,250000,89000,36
TIKI,nha-sach-tiki,540040,"Giáo Trình Chuẩn HSK 1 - Bài Tập (Kèm file MP3)",119000,158000,39000,25
TIKI,nha-sach-tiki,52584834,"Tư Duy Hệ Thống Trong Công Việc",61500,89000,27500,31
TIKI,nha-sach-tiki,193434490,"Ikigami - Tập 07",32000,45000,13000,29
TIKI,nha-sach-tiki,126743464,"Kế Hoạch Của Linh Hồn - Khám Phá Ý Nghĩa Cuộc Sống Mà Bạn Đã Lên Kế Hoạch Trước Khi Sinh Ra",117000,169000,52000,31
TIKI,nha-sach-tiki,176909221,"Ngôi Nhà Bên Bờ Biển Xanh Thẳm",124000,174000,50000,29
TIKI,nha-sach-tiki,2429811,"Tư Duy Phản Biện",56100,85000,28900,34
TIKI,nha-sach-tiki,130996082,"Bồ Câu Bay Đi Tìm Bà",56100,77000,20900,27
TIKI,nha-sach-tiki,52785564,"Dịch Hạch (Nobel Văn Chương 1957)",93700,129000,35300,27
TIKI,nha-sach-tiki,111580006,"Sách Muôn Kiếp Nhân Sinh 2 (Khổ Nhỏ) - Nguyên Phong",86000,148000,62000,42
TIKI,nha-sach-tiki,11371249,"Chuyện Con Mèo Và Con Chuột Bạn Thân Của Nó - Tái Bản",30100,39000,8900,23
TIKI,nha-sach-tiki,22881852,"English Grammar in Use Book w Ans",160200,198000,37800,19
TIKI,nha-sach-tiki,159004131,"Semantic Error – Lỗi Logic (Tập 1) - Bản thường (Tặng Kèm 01 Bookmark + 01 Postcard)",183000,259000,76000,29
TIKI,nha-sach-tiki,195357772,"Máy Tính CASIO FX-880BTG - Màu Đen",696000,800000,104000,13
TIKI,nha-sach-tiki,25557704,"Bãi săn người - Trinh Thám Kinh Dị",62000,162000,100000,62
TIKI,nha-sach-tiki,147988185,"Combo 2 Cuốn "Hiểu Hết" : How Business Works - Hiểu Hết Về Kinh Doanh + How Money Works - Hiểu Hết Về Tiền",469000,680000,211000,31
TIKI,nha-sach-tiki,95218451,"Lần Đầu Làm Mẹ - Tổng Hợp Những Kiến Thức Mới Nhất Về Mang Thai Và Sinh Nở (Tái Bản)",176000,260000,84000,32
TIKI,nha-sach-tiki,52805060,"Chúa Ruồi - Tiểu Thuyết (Nobel Văn Chương 1983)(Tái Bản 2020)",63700,88000,24300,28
TIKI,nha-sach-tiki,195649312,"Trí Tuệ Do Thái  (Tái Bản 2022)",137000,189000,52000,28
TIKI,nha-sach-tiki,66619715,"Sách Vị Tu Sĩ Bán Chiếc Ferrari (Tái Bản)",68100,98000,29900,31
TIKI,nha-sach-tiki,160997378,"Giải Thích Ngữ Pháp Tiếng Anh Với Bài Tập Và Đáp Án (TB 2022) - Tác giả Mai Lan Hương, Hà Thanh Uyên",165000,220000,55000,25
TIKI,nha-sach-tiki,196923452,"Birdmen - Tập 7",30000,30000,0,0
TIKI,nha-sach-tiki,190238356,"Kỷ Luật Bản Thân",125000,189000,64000,34
TIKI,nha-sach-tiki,50751279,"Vui Vẻ Không Quạu Nha - Tản Văn",49200,69000,19800,29
TIKI,nha-sach-tiki,157240665,"Ra Bờ Suối Ngắm Hoa Kèn Hồng (Truyện Dài-Nguyễn Nhật Ánh) - Bìa Mềm (Màu Hồng) (Tặng Kèm Bookmark Bồi Hai Mặt, Thiệp Trái Tim In Bài Thơ Của Tác Giả)",97400,145000,47600,33
TIKI,nha-sach-tiki,193411736,"Anh Em Nhà Motohashi - Tập 2",52000,68000,16000,24
TIKI,nha-sach-tiki,164336673,"How The Brain Works - Hiểu Hết Về Bộ Não",264000,330000,66000,20
TIKI,nha-sach-tiki,162205263,"Những Đồ Vật Có Linh Hồn - Bản Thường (Tặng Kèm 1 Bookmark)",106000,149000,43000,29
TIKI,nha-sach-tiki,143186001,"Chiến Thắng Con Quỷ Trong Bạn - Bí Quyết Tự Do Và Thành Công (Tái Bản)",82300,115000,32700,28
TIKI,nha-sach-tiki,14053724,"Sự Cứu Rỗi Của Thánh Nữ",93700,128000,34300,27
TIKI,nha-sach-tiki,141333746,"Chúng Ta Học Thế Nào - How We Learn (Sự Thật Khó Tin Về Việc Học Nó Diễn Ra Khi Nào, Ở Đâu , Và Tại Sao)",112000,150000,38000,25
TIKI,nha-sach-tiki,57761618,"Vụ Án Mạng Ở Lữ Quán Kairotei",84100,123000,38900,32
TIKI,nha-sach-tiki,85029033,"Truyện Cổ Grimm (Ấn Bản Đầy Đủ Nhất Kèm 184 Minh Hoạ Của Philipp Grot Johann Và Robert Leinweber)",446000,680000,234000,34
TIKI,nha-sach-tiki,66067655,"Trải Nghiệm Khách Hàng Xuất Sắc",181000,250000,69000,28
TIKI,nha-sach-tiki,70016690,"Thế Giới Rộng Lớn Lòng Người Chật Hẹp (Tặng Kèm 1 Bookmark )",62100,92000,29900,33
TIKI,nha-sach-tiki,137741275,"Ngỡ Như Lương Thiện, Hóa Ra Mềm Yếu",93000,125000,32000,26
TIKI,nha-sach-tiki,79672197,"Bí Mật Của May Mắn (Khổ Nhỏ)(Tái Bản)",32100,45000,12900,29
TIKI,nha-sach-tiki,1926761,"Khởi Nghiệp Bán Lẻ - Bí Quyết Thành Công Và Giàu Có Bằng Những Cửa Hàng Đông Khách - Công Thức Kinh Doanh Và Quản Lý Cửa Hàng Hiệu Quả",125000,199000,74000,37
TIKI,nha-sach-tiki,195885685,"Vua Sáng Chế -  Tập 16",20000,20000,0,0
TIKI,nha-sach-tiki,187190676,"Black Jack - Tập 11",30000,30000,0,0
TIKI,nha-sach-tiki,108501279,"Viết Đi Đừng Sợ! Từ Tay Không Thành Tay Viết",188000,245000,57000,23
TIKI,nha-sach-tiki,193433626,"Kỹ năng tự học cho trẻ tiểu học",142000,199000,57000,29
TIKI,nha-sach-tiki,160081250,"Tăng Cường Sức Mạnh Não Bộ",95000,120000,25000,21
TIKI,nha-sach-tiki,3976835,"Velma - Trinh Thám Cổ Điển Phương Tây",49500,99000,49500,50
TIKI,nha-sach-tiki,67271338,"Sách OSHO - Trò Chuyện Với Vĩ Nhân",135000,198000,63000,32
TIKI,nha-sach-tiki,186286187,"Nhà Lãnh Đạo Không Chức Danh",68000,105000,37000,35
TIKI,nha-sach-tiki,69644752,"Toàn Thư Chiêm Tinh Học Nhập Môn",226000,350000,124000,35
TIKI,nha-sach-tiki,184070221,"Sách OSHO Hiểu - Đường Đến Tự Do",117000,168000,51000,30
TIKI,nha-sach-tiki,100931414,"Cách Khen Cách Mắng Cách Phạt Con (Tái Bản)",47800,69000,21200,31
TIKI,nha-sach-tiki,104314401,"Sách Bí Mật Của May Mắn (Khổ Lớn) (Tái Bản)",46100,68000,21900,32
TIKI,nha-sach-tiki,193988323,"Sa Vào Ánh Hào Quang Của Người – Tập 2",113000,138000,25000,18
TIKI,nha-sach-tiki,1938915,"Sự Tiếp Xúc Của Văn Hóa Việt Nam Với Pháp",81650,109000,27350,25
TIKI,nha-sach-tiki,7916685,"All The Rule - Bình Tĩnh Khi Ế, Mạnh Mẽ Khi Yêu",60600,86000,25400,30
TIKI,nha-sach-tiki,195801644,"Black Jack - Tập 13 (Bìa Cứng)",128000,135000,7000,5
TIKI,nha-sach-tiki,145287904,"Sách - Giận (Tái Bản 2021)(Cuốn sách hay của Thiền sư Thích Nhất Hạnh/ Tặng kèm Bookmark)",128650,128650,0,0
TIKI,nha-sach-tiki,136143567,"Thần Số Học",146000,219000,73000,33
TIKI,nha-sach-tiki,50723822,"Con Đường Đi Đến Thành Công Bằng Sự Tử Tế (Tái Bản 2020)",48000,70000,22000,31
TIKI,nha-sach-tiki,17719702,"Một Thế Giới Không Có Đàn Bà (Trinh Thám Việt Nam)",98000,142000,44000,31
TIKI,nha-sach-tiki,13419678,"Sách Đi Tìm Lẽ Sống (Tái Bản )",61100,88000,26900,31
TIKI,nha-sach-tiki,113540576,"Hảo Nữ Trung Hoa",101000,128000,27000,21
TIKI,nha-sach-tiki,45321594,"Nghệ Thuật Bán Hàng Của Người Hướng Nội",88800,119000,30200,25
TIKI,nha-sach-tiki,100958457,"Gieo Trồng Hạnh Phúc (Tái Bản)",61800,89000,27200,31
TIKI,nha-sach-tiki,13624088,"Nghĩ Thiện Để Cuộc Đời Và Công Việc Viên Mãn",51000,85000,34000,40
TIKI,nha-sach-tiki,160759005,"Cơ Thể Tự Chữa Lành - Thanh Lọc Để Phục Hồi",190000,295000,105000,36
TIKI,nha-sach-tiki,145288031,"Tarot Toàn Thư - Đọc Vận Mệnh Qua Những Lá Bài",244000,380000,136000,36
TIKI,nha-sach-tiki,170297937,"Tâm Lý Học Về Sự Lo Âu",95100,129000,33900,26
TIKI,nha-sach-tiki,184774173,"Những Người Nhật Tử Tế",96000,148000,52000,35
TIKI,nha-sach-tiki,168576295,"Mình Phải Sống Như Biển Rộng Sông Dài",77300,109000,31700,29
TIKI,nha-sach-tiki,119694726,"Combo 6 cuốn Ehon Kích thích thị giác - Âm thanh cho Trẻ sơ sinh",121680,234000,112320,48
TIKI,nha-sach-tiki,52597663,"Đừng Chạy Theo Số Đông - Cuốn Sách Bạn Cần Đọc Trước Khi Quá Muộn",129000,200000,71000,36
TIKI,nha-sach-tiki,153045603,"Sách Người Giỏi Không Phải Là Người Làm Tất Cả (Tái Bản 2021)",40100,58000,17900,31
TIKI,nha-sach-tiki,90469338,"Combo 5 cuốn: Cơ Thể Tự Chữa Lành",594000,923000,329000,36
TIKI,nha-sach-tiki,148802202,"How Philosophy Works - Hiểu Hết Về Triết Học",246000,330000,84000,25
TIKI,nha-sach-tiki,155683832,"túi đựng card visit - JL",5000,5000,0,0
TIKI,nha-sach-tiki,143172597,"2000 English Collocation and Idioms",119000,200000,81000,41
TIKI,nha-sach-tiki,179063564,"Tôi Tự Học",79000,120000,41000,34
TIKI,nha-sach-tiki,54051752,"Bộ Ba Quái Hiệp (Trinh Thám)",69000,138000,69000,50
TIKI,nha-sach-tiki,48481763,"Thiên Nga Đen (Tái Bản 2020)",190400,299000,108600,36
TIKI,nha-sach-tiki,100931418,"Giao Tiếp Bất Kỳ Ai - 101 Cách Nâng Cao Khả Năng Giao Tiếp (Tái Bản)",37800,55000,17200,31
TIKI,nha-sach-tiki,160081252,"Người Tan Làm Sau Cùng Là Người Nghỉ Việc Đầu Tiên (Tặng kèm bookmark)",84000,119000,35000,29
TIKI,nha-sach-tiki,49910019,"Bác Sĩ Riêng Của Bé Yêu - Chào Con! Ba Mẹ Đã Sẵn Sàng (Tái Bản)",66000,95000,29000,31
TIKI,nha-sach-tiki,32155084,"Combo 25 Chuyên đề ngữ pháp tiếng anh trọng tâm ( trọn bộ tập 1+2 )",148000,230000,82000,36
TIKI,nha-sach-tiki,198016656,"Blue Flag - Tập 3",44100,45000,900,2
TIKI,nha-sach-tiki,129381090,"Minh Triết Trong Đời Sống (Tái Bản)",71100,108000,36900,34
TIKI,nha-sach-tiki,44433397,"Yêu Mình Trước Đã, Yêu Đời Để Sau",75800,109000,33200,30
TIKI,nha-sach-tiki,197634252,"Văn phòng thám tử quái vật - Tập 13",25900,30000,4100,14
TIKI,nha-sach-tiki,195357776,"Máy Tính CASIO FX-880BTG - Màu Hồng",742000,800000,58000,7
TIKI,nha-sach-tiki,96357336,"Cáo Pax",85100,116000,30900,27
TIKI,nha-sach-tiki,197781977,"Yu-Gi-Oh! Gx Tập 1: “Người Hùng Mới” Lộ Diện",29000,30000,1000,3
TIKI,nha-sach-tiki,182548592,"Thiên Sứ Nhà Bên – Tập 3",70000,95000,25000,26
TIKI,nha-sach-tiki,1080002,"Boxset Harry Potter - Tiếng Việt (Trọn Bộ 7 Tập)",1199000,1750000,551000,31
TIKI,nha-sach-tiki,48323805,"Sách Người trong muôn nghề",169000,189000,20000,11
TIKI,nha-sach-tiki,100947274,"Tìm Bình Yên Trong Gia Đình (Tái Bản)",68800,99000,30200,31
TIKI,nha-sach-tiki,197353391,"Ninja Rantaro - Tập 61",39000,40000,1000,3
TIKI,nha-sach-tiki,179952621,"Hành Trình Tarot (Tái Bản 2022)",107000,149000,42000,28
TIKI,nha-sach-tiki,196944533,"Tài chính doanh nghiệp for Dummies",166000,239000,73000,31
TIKI,nha-sach-tiki,243358535,"Squid Game Móc khoá - Móc khoá Silicon 5cm-SQ1",10000,20000,10000,50
TIKI,nha-sach-tiki,626886,"Những Tấm Lòng Cao Cả",53100,80000,26900,34
TIKI,nha-sach-tiki,194104631,"Mong Bạn Đừng Khóc Một Mình",65500,88000,22500,26
TIKI,nha-sach-tiki,176550321,"Bàn Về Ham Muốn: Tại Sao Chúng Ta Muốn Thứ Mà Ta Muốn",121000,169000,48000,28
TIKI,nha-sach-tiki,81323246,"90-20-30 90 Bài Học Vỡ Lòng Về Ý Tưởng Và Câu Chữ (Bản Đen Trắng)",149000,195000,46000,24
TIKI,nha-sach-tiki,161245852,"Giải Thích Ngữ Pháp Tiếng Anh (Tái Bản 2022)",176000,220000,44000,20
TIKI,nha-sach-tiki,187622420,"The Art and Science of Technical Analysis – Phân tích kỹ thuật: Sự kết hợp giữa KHOA HỌC và NGHỆ THUẬT trong đầu tư chứng khoán",569000,569000,0,0
TIKI,nha-sach-tiki,186091870,"Fullmetal Alchemist - Cang Giả Kim Thuật Sư - Fullmetal Edition Tập 15 [Tặng Kèm Bookmark PVC]",62100,69000,6900,10
TIKI,nha-sach-tiki,113655533,"Giáo Trình Chủ Nghĩa Xã Hội Khoa Học (Dành Cho Bậc Đại Học Hệ Không Chuyên Lý Luận Chính Trị) - Bộ mới năm 2021",58000,58000,0,0
TIKI,nha-sach-tiki,193434488,"Kingdom -  Tập 32",32600,45000,12400,28
TIKI,nha-sach-tiki,171057415,"Cẩm nang hướng dẫn tự học tiếng Thái – trình độ sơ cấp – trung cấp",98000,98000,0,0
TIKI,nha-sach-tiki,3737963,"Bức Xúc Không Làm Ta Vô Can (Tái Bản)",63300,85000,21700,26
TIKI,nha-sach-tiki,57870426,"Sức Mạnh Của Ngôn Từ (Tặng Kèm 1 Photocard Mintbooks Limited)",64500,96000,31500,33
TIKI,nha-sach-tiki,274404957,"Montessori – Phương Pháp Giáo Dục Toàn Diện Cho Trẻ 0-6 Tuổi",81100,81100,0,0
TIKI,nha-sach-tiki,195649281,"Đọc Vị Tâm Lý Hành Vi Của Giới Giàu Và Siêu Giàu",222000,299000,77000,26
TIKI,nha-sach-tiki,80657321,"Cơ Thể Tự Chữa Lành: Phục Hồi Tuyến Giáp",116000,180000,64000,36
TIKI,nha-sach-tiki,115478654,"Keo Siêu Dính Đa Năng Mạnh Gấp 80 Keo 502 Dán Sắt, Dán Đá, Dán Nhựa, Dán Gỗ",39000,39000,0,0
TIKI,nha-sach-tiki,90056907,"Khởi Nghiệp Tinh Gọn (The Lean Startup) (Tái Bản)",129000,165000,36000,22
TIKI,nha-sach-tiki,178483637,"Nước Ép Trị Liệu Và Chế Độ Ăn Theo Phương Pháp Cơ Thể Tự Chữa Lành",142000,199000,57000,29
TIKI,nha-sach-tiki,87959748,"451 Độ F",73800,99000,25200,25
TIKI,nha-sach-tiki,50475521,"Sách Đánh Thức Con Người Phi Thường Trong Bạn",97000,168000,71000,42
TIKI,nha-sach-tiki,110448020,"Nhà Ảo Thuật Đen Và Vụ Án Mạng Tại Thị Trấn Không Tên",154000,199000,45000,23
TIKI,nha-sach-tiki,125528587,"Thần Với Chả Thoại (Những Câu Chuyện "Mệt Mỏi" Về Các Vị Thần)",85000,139000,54000,39
TIKI,nha-sach-tiki,193433863,"101 Lời Khuyên Tài Chính Cá Nhân Từ Thái Phạm",299000,299000,0,0
TIKI,nha-sach-tiki,162181800,"Cảm Ơn Anh Đã Đánh Mất Em - Bản Thường (Tặng Kèm 2 postcard)",70000,99000,29000,29
TIKI,nha-sach-tiki,191148794,"Tôi Ước Mình Chưa Từng Được Sinh Ra -Tặng kèm 1 bookmark",63000,90000,27000,30
TIKI,nha-sach-tiki,194104232,"Anh Em Phi Hành Gia - Tập 32",42300,45000,2700,6
TIKI,nha-sach-tiki,58695343,"Kỹ Năng Giao Tiếp Đỉnh Cao",66500,96000,29500,31
TIKI,nha-sach-tiki,147058065,"Phi Lý Trí - Khám Phá Những Động Lực Vô Hình Ẩn Sau Những Quyết Định Của Con Người ( Tái Bản)",110000,169000,59000,35
TIKI,nha-sach-tiki,168662171,"Vừa Nhắm Mắt Vừa Mở Cửa Số",52000,75000,23000,31
TIKI,nha-sach-tiki,40933969,"Một Đời Quản Trị (Tái Bản)",121000,200000,79000,40
TIKI,nha-sach-tiki,69644748,"Thiền Sư Và Em Bé 5 Tuổi",67100,120000,52900,44
TIKI,nha-sach-tiki,71090268,"Ám Ảnh Từ Kiếp Trước - Bí Mật Của Sự Sống Và Cái Chết (Tái Bản 2020)",58100,89000,30900,35
TIKI,nha-sach-tiki,195885690,"Birdmen - Tập 6",29000,30000,1000,3
TIKI,nha-sach-tiki,140416373,"Hành Trình Về Phương Đông (Khổ Nhỏ)(Tái Bản)",54100,78000,23900,31
TIKI,nha-sach-tiki,67491398,"Sách OSHO Từ Bi - Compassion",89100,128000,38900,30
TIKI,nha-sach-tiki,73222800,"Nghĩ Giàu Và Làm Giàu (Khổ Nhỏ)",74000,108000,34000,31
TIKI,nha-sach-tiki,69764534,"Thợ Xăm Ở Auschwitz",110000,148000,38000,26
TIKI,nha-sach-tiki,66712456,"Trở Về Không - Trải Nghiệm Ho'oponopono - Thực Hiện Hóa Những Phép Màu Trong Cuộc Sống",118000,159000,41000,26
TIKI,nha-sach-tiki,94173462,"Muôn Kiếp Nhân Sinh 2",192000,268000,76000,28
TIKI,nha-sach-tiki,106863962,"Sách Bên Rặng Tuyết Sơn - Nguyên Phong (Tái Bản)",82100,118000,35900,30
TIKI,nha-sach-tiki,194960730,"Nỗi buồn chiến tranh",86000,130000,44000,34
TIKI,nha-sach-tiki,63473605,"Ho’Oponopono: Sống Như Người Hawaii – Chấp Nhận, Biết Ơn Và Tha Thứ",80200,109000,28800,26
TIKI,nha-sach-tiki,173745189,"Clean Code – Mã Sạch Và Con Đường Trở Thành Lập Trình Viên Giỏi",244000,386000,142000,37
TIKI,nha-sach-tiki,56697257,"Bí Mật Và Thực Tế Về Tự Kỉ Ám Thị (Self Mastery Through Conscious Autosuggestion) - Cuốn Sách Về Tự Kỉ Ám Thị Được Freud Và Các Bậc Thầy Phân Tâm Trích Dẫn Và Nghiên Cứu - Liệu Pháp Tự Chữa Lành Được Napoleon Hill Và Tony Robbin Sử Dụng Đều Xuất Phát Từ Đ",52700,83000,30300,37
TIKI,nha-sach-tiki,151994935,"Sói Đầu Đàn Và Cún Nhỏ - Tập 1",99300,128000,28700,22
TIKI,nha-sach-tiki,45663008,"Ngày Xưa Có Một Con Bò…(Tái Bản)",48000,70000,22000,31
TIKI,nha-sach-tiki,193446628,"Dragon Ball Full Color - Phần Năm: Truy Lùng Cell Bọ Hung Tập 3 [Tặng kèm Standee hoặc Postcard]",69100,77000,7900,10
TIKI,nha-sach-tiki,49317816,"Cơ Thể Tự Chữa Lành",103000,160000,57000,36
TIKI,nha-sach-tiki,74686986,"Spy X Family Tập 2",25000,25000,0,0
TIKI,nha-sach-tiki,2126103,"Tazaki Tsukuru Không Màu Và Những Năm Tháng Hành Hương (Tái Bản 2018)",79000,106000,27000,25
TIKI,nha-sach-tiki,153521878,"Nhân Loại - Một Lịch Sử Tràn Đầy Hi Vọng",153000,245000,92000,38
TIKI,nha-sach-tiki,109862191,"Combo 8 cuốn: Bộ sách IQ vượt trội - IQ booster",49920,96000,46080,48
TIKI,nha-sach-tiki,195357782,"Máy Tính CASIO FX-880BTG - Màu Xám",740000,800000,60000,8
TIKI,nha-sach-tiki,108715084,"Rio Book No.1 - Xấu Thế Nào, Đẹp Ra Sao - Bí Kíp Thẩm Định Thiết Kế Trong Marketing (Tái Bản Lần 6)",134000,175000,41000,23
TIKI,nha-sach-tiki,99513994,"Những Người Đàn Ông Không Có Đàn Bà (Tái Bản)",73000,100000,27000,27
TIKI,nha-sach-tiki,31509726,"Làm Bạn Với Bầu Trời (Bìa Mềm) (Tặng Kèm Khung Ảnh Số Lượng Có Hạn)",62000,110000,48000,44
TIKI,nha-sach-tiki,95218447,"Con Đường Chuyển Hóa - Kinh Bốn Lĩnh Vực Quán Niệm (Tái Bản)",61800,89000,27200,31
TIKI,nha-sach-tiki,155550600,"Sống Bán Nông Bán X - Tâm Lý Mới Về Cuộc Sống Điền Viên",96000,148000,52000,35
TIKI,nha-sach-tiki,95220861,"Tuần Làm Việc 4 Giờ (Tái Bản)",80000,115000,35000,30
TIKI,nha-sach-tiki,103550551,"Hung Khí Hoàn Mỹ",116000,150000,34000,23
TIKI,nha-sach-tiki,377644,"Chờ Đến Mẫu Giáo Thì Đã Muộn",49000,69000,20000,29
TIKI,nha-sach-tiki,36363381,"Sao Chúng Ta Lại Ngủ",186800,249000,62200,25
TIKI,nha-sach-tiki,188548575,"Đời Muối: Lịch Sử Thế Giới",152000,235000,83000,35
TIKI,nha-sach-tiki,162865518,"Tôn Tử Binh Pháp (Tái Bản)",117000,160000,43000,27
TIKI,nha-sach-tiki,112106439,"GIẢI MÃ HÀNH VI ĐỌC VỊ CẢM XÚC",89800,129000,39200,30
TIKI,nha-sach-tiki,107331062,"Khởi Nghiệp Kinh Doanh Online - Bán Hàng Hiệu Quả Trên Face.book",159000,199000,40000,20
TIKI,nha-sach-tiki,76012203,"Cuộc Đời Là Một Tiểu Thuyết",104000,140000,36000,26
TIKI,nha-sach-tiki,117595535,"Kẻ Ngoại Cuộc",90000,123000,33000,27
TIKI,nha-cua-doi-song,252135037,"Giường xếp gấp gọn 6 chân đa năng SUMIKA 298, có nệm, 5 cấp độ điều chỉnh",769000,1200000,431000,36
TIKI,nha-cua-doi-song,262731552,"Giường xếp gấp gọn di động SUMIKA 386, khung thép, có bánh xe",1529000,2250000,721000,32
TIKI,nha-cua-doi-song,252134180,"Giường xếp gấp gọn 4 chân đa năng SUMIKA 181, có nệm, 5 cấp độ điều chỉnh",869000,1580000,711000,45
TIKI,nha-cua-doi-song,83412126,"Bình Giữ Nhiệt Lock&Lock Energetic One-Touch Tumbler LHC3249 - 550ML",264000,528000,264000,50
TIKI,nha-cua-doi-song,270466751,"Ghế ăn Tami, ghế nhựa đúc ngoài trời",1290000,1290000,0,0
TIKI,nha-cua-doi-song,53789448,"Bộ cây lau nhà tự vắt thông minh, chổi lau nhà 360 độ, lau sạch khô nhanh - Parroti Pro PR01",419000,799000,380000,48
TIKI,nha-cua-doi-song,270247452,"Ghế ăn đúc nguyên khối cổ điển dành cho quán cà phế, văn phòng",599000,599000,0,0
TIKI,nha-cua-doi-song,99868980,"Bình Giữ Nhiệt Locknlock Bucket Tumbler 540ml LHC4269WHT",284000,473000,189000,40
TIKI,nha-cua-doi-song,249206732,"Bàn cafe Tulip mặt tròn",1790000,1790000,0,0
TIKI,nha-cua-doi-song,73124602,"Bình Giữ Nhiệt Bằng Thép Không Gỉ Lock&amp;Lock Vacuum Bottle LHC6180FU (800ML)",352000,677000,325000,48
TIKI,nha-cua-doi-song,253402833,"Móc gỗ treo tường Anzzar, móc treo quần áo, phụ kiện, giá gỗ treo quần áo-MT04",209000,220000,11000,5
TIKI,nha-cua-doi-song,270139577,"Chất Tăng Cứng Sàn Liquid Hardener HTS HARD+ thùng 6Kg - Tăng cứng, Chống bụi, Dùng được cho sàn Mác yếu",427500,450000,22500,5
TIKI,nha-cua-doi-song,1657931,"Vợt Muỗi Sunhouse SHE-E200 - Vàng",72000,119000,47000,39
TIKI,nha-cua-doi-song,129370124,"Hoá Chất Tăng Cứng Sàn Liquid Hardener HTS HARD+ thùng nhỏ 6Kg - Thi công 40m2 sàn",421800,444000,22200,5
TIKI,nha-cua-doi-song,84566545,"Ổ cắm điện đa năng kết hợp ổ cắm USB Nakagami chất lượng cao công nghệ Nhật Bản - Màu ngẫu nhiên",159000,159000,0,0
TIKI,nha-cua-doi-song,33067171,"Áo mưa dây kéo vải dù tổ ong chống thấm ( nhiều màu)",95000,95000,0,0
TIKI,nha-cua-doi-song,58828647,"Xe đẩy hàng 4 bánh SUMIKA T150 - Khung thép, tay cầm gấp mở tiện lợi, tải trọng 150kg",880000,1350000,470000,35
TIKI,nha-cua-doi-song,58804363,"Dụng Cụ Băm Rau Củ Quả Lock&amp;Lock Quick Chopper CKS310BLU",112000,216000,104000,48
TIKI,nha-cua-doi-song,185380333,"Keo Sơn Chống Thấm Dột 1 Thành Phần TAIKOMI CT4 - Chuyên Xử Lý Chống Thấm Ngược, Môi Trường Ẩm, Bể Âm, Hố Thang Máy, Nhà Vệ Sinh - Thùng 1 Lít",254800,320000,65200,20
TIKI,nha-cua-doi-song,71890908,"Bộ lau nhà xoay 360 độ Sunhouse KS-CL330S",231000,406000,175000,43
TIKI,nha-cua-doi-song,214131948,"Vải Polyester Phủ Chống Thấm Mái Nhà Tường Nhà Khe Nứt Tiện Dụng Đa Năng Khổ 1m",331500,390000,58500,15
TIKI,nha-cua-doi-song,185380360,"[Hàng Chính Hãng - BH 2 Năm]Keo Sơn Chống Thấm Sàn Mái TAIKO NITTON - Thùng 10 Lít",1485000,1500000,15000,1
TIKI,nha-cua-doi-song,92453371,"Áo Mưa Cánh Dơi Có Kiếng Đèn, Áo Mưa Kiếng Đèn Vải Dù Loại Siêu Dày, Hàng Việt Nam, Khổ To Rộng, Chống Thấm Hiệu Quả, Phù Hợp Nam Và Nữ, Có Túi Đựng, Có Lựa Chọn Màu Sắc",130000,130000,0,0
TIKI,nha-cua-doi-song,56941523,"Ly nhựa 2 lớp LocknLock kèm ống hút HAP507 750ml",113000,217000,104000,48
TIKI,nha-cua-doi-song,17423771,"5 Viên Pin CR2032 3V Panasonic Lithium thay pin Smartkey , Cmos , Pin thay Airtag - Hàng chính hãng",77000,100000,23000,23
TIKI,nha-cua-doi-song,249022286,"Sơn Chống Thấm Gốc Bitum TAIKO BITSUN No.1 - Chống Thấm Bể Cá Koi, Mái Nhà, Sân Thượng, Nhà Vệ Sinh, Logia",150000,250000,100000,40
TIKI,nha-cua-doi-song,169848307,"Kệ Wifi Treo Tường 2 Tầng Không Cần Khoan Để Đầu Thu Kỹ Thuật Số, Remote, Điện Thoại - IG407",56000,60000,4000,7
TIKI,nha-cua-doi-song,54484578,"Đèn Bàn Học LED USB Di Động Cao Cấp Có Thể Gập Hai Chỗ – 03 Chế Độ Ánh Sáng Vàng Bảo Vệ Mắt Chống Cận eLights - Đèn Cắm Dây",185000,199000,14000,7
TIKI,nha-cua-doi-song,94778000,"Ô Dù che nắng, che mưa, có nút bấm 2 chiều, hàng chất lượng, dễ thương, thiết kế sang trọng và bền bỉ, ô dù có lựa chọn màu sắc",196000,196000,0,0
TIKI,nha-cua-doi-song,99994000,"Bình giữ nhiệt có ống hút Lock&Lock Bucket Tumbler with Straw LHC4268 540ml - Màu",284000,473000,189000,40
TIKI,nha-cua-doi-song,73125530,"Hộp cơm thủy tinh kèm muỗng đũa LocknLock LLG991CLNVY 930ml - Màu Navy",188000,362000,174000,48
TIKI,nha-cua-doi-song,223727594,"[Chính Hãng]Keo Chống Thấm TAIKO Trong Suốt Silicon 500 ml -Chống Thấm Gạch Lát Nền,Trần, Tường, Cửa Sổ, Vết Nứt Mái Nhà Triệt Để - Keo sau 72h mới khô hoàn toàn",110000,137500,27500,20
TIKI,nha-cua-doi-song,11488920,"Bình Giữ Nhiệt Lock&Lock RigaTumbler (Shanghai) LHC4160RED  897ml - màu Red",372000,715000,343000,48
TIKI,nha-cua-doi-song,2119173,"Cây Lau Nhà Dạng Xịt Nước Lock&Lock ETM472",280000,539000,259000,48
TIKI,nha-cua-doi-song,104270135,"Bình Giữ Nhiệt LocknLock Featherlight One-touch Tumbler 500ml LHC3257WHT - Màu trắng",269000,517000,248000,48
TIKI,nha-cua-doi-song,92521124,"Ủng Bọc Giày Đi Mưa Chống Nước Có Đế Chống Trơn Trượt Cao Cấp",39900,39900,0,0
TIKI,nha-cua-doi-song,48045630,"5 Viên Pin Smartkey - Cmos Panasonic CR2032 - Hàng Chính Hãng",80000,100000,20000,20
TIKI,nha-cua-doi-song,186558014,"Combo 10 Móc Dán Tường Treo Đồ Đa Năng Siêu Chịu Lực",25000,25000,0,0
TIKI,nha-cua-doi-song,71178441,"Áo Mưa Bít Dù Trơn, Áo Mưa Kín Người Vải Dù Siêu Dày, Chống Thấm Hiệu Quả, Phù Hợp Nam Và Nữ, Có Túi Đựng, Có Lựa Chọn Màu Sắc",115000,115000,0,0
TIKI,nha-cua-doi-song,99621372,"Bình giữ nhiệt Lock&amp;Lock Belt Bottle LHC4267IVY490ml - Màu",284000,473000,189000,40
TIKI,nha-cua-doi-song,122692850,"Cây chà sàn thông minh cao cấp, chổi chà sàn đa năng 2 trong 1, cọ sàn và gạt nước – Parroti Easy ES02",129000,199000,70000,35
TIKI,nha-cua-doi-song,173211404,"Ghế Xoay Văn Phòng Ngồi Làm Việc Công Thái Học Deli - Tay Gập Thông Minh, Có Ngả Lưng, Lưới Thoáng Khí, Chân Xoay Tiện Ích, Đệm Ghế Êm Aí - Phù Hợp Học Sinh, Văn Phòng, Game Thủ, Gaming - Hàng Chính Hãng - E4928 / E4929 / E4925 / E4926G",886000,1618200,732200,45
TIKI,nha-cua-doi-song,273624233,"Bình giữ nhiệt LocknLock Metro Two Way LHC4272/LHC4274 - Hàng chính hãng",315000,605000,290000,48
TIKI,nha-cua-doi-song,187636657,"Keo Dán Giày Đa Năng Dán Mọi Loại Giày, Chống Thấm",45000,45000,0,0
TIKI,nha-cua-doi-song,184126392,"Bình giữ nhiệt 450ml kèm cốc đẹp lõi INOX 304 cao cấp giữ nhiệt tới 8 tiếng chống tràn có cốc uống, có thể dùng làm quà tặng độc đáo",72995,72995,0,0
TIKI,nha-cua-doi-song,2119169,"Bộ Cây Lau Nhà Lock&Lock Squeeze Flat Mop ETM471",509000,979000,470000,48
TIKI,nha-cua-doi-song,75614459,"Thùng rác treo tủ bếp có nắp đậy thông minh, thùng rác treo tường dán tường, có thanh trượt cửa bếp – Parroti Bin BN01/BIN01",299000,299000,0,0
TIKI,nha-cua-doi-song,116819040,"Thước Dây 1,5m - YOGA QG, Thước Dây May Má, Đo Chiều Cao Cho Bé, Đo Kích Thước Ba Vòng",9999,9999,0,0
TIKI,nha-cua-doi-song,107961500,"Ly Nhựa 2 Lớp LocknLock Double Wall Cold Cup Cherry Blossom 750ml HAP509WHT - Màu",130000,217000,87000,40
TIKI,nha-cua-doi-song,52574827,"Ô (dù) tự động 2 chiều cao cấp DandiHome chống UV",104500,110000,5500,5
TIKI,nha-cua-doi-song,46202190,"Combo nhiều túi lưới giặt đồ cho máy giặt bảo vệ quần áo chống biến dạng chất lượng tốt dây kéo lưới mịn Polyester",42000,42000,0,0
TIKI,nha-cua-doi-song,892121,"Pin Max 8 + 4 Viên Energizer E91 BP8+4 AA",152000,180000,28000,16
TIKI,nha-cua-doi-song,120552065,"Bình giữ nhiệt inox 304 Elmich EL-8013OL dung tích 480ml",139000,389000,250000,64
TIKI,nha-cua-doi-song,90531871,"Đèn Pixar, Đèn Bàn Học Chống Cận Thị, Đèn Đọc Sách, Đèn Làm Việc Bảo Vệ Mắt - Hàng Chính Hãng Moontronics",139000,139000,0,0
TIKI,nha-cua-doi-song,3480627,"Bộ Cây Lau Nhà Xoay Tay Compact Spin Mop Lock&Lock ETM466: Thùng Giặt + Cây + Bông Lau",480000,924000,444000,48
TIKI,nha-sach-tiki,274566783,"Siêu Nhí Hỏi Nhà Khoa Học Trả Lời - 100 Bí Ẩn Mọi Đứa Trẻ Đều Muốn Hỏi Một Nhà Khoa Học",173000,173000,0,0
TIKI,nha-sach-tiki,130996088,"Câu Chuyện Ngôn Ngữ",116000,160000,44000,28
TIKI,nha-sach-tiki,129381098,"Tiếp Thị 5.0: Công Nghệ Vị Nhân Sinh",82500,120000,37500,31
TIKI,nha-sach-tiki,394434,"Giấy Excel A4 DL70",62000,62000,0,0
TIKI,nha-sach-tiki,197558899,"Anime Comics: One Piece Film Z - Tập 1",68300,77000,8700,11
TIKI,nha-sach-tiki,197558902,"Anime Comics: One Piece Film Z - Tập 2",68300,77000,8700,11
TIKI,nha-sach-tiki,77900454,"Bí Mật Của Nước (Tái Bản)",63600,89000,25400,29
TIKI,nha-sach-tiki,154160965,"Thần Thoại Hy Lạp (Tái Bản)",169000,255000,86000,34
TIKI,nha-sach-tiki,133599625,"Spy X Family Tập 6",25000,25000,0,0
TIKI,nha-sach-tiki,93734071,"Trí Thông Minh Trên Giường",130000,219000,89000,41
TIKI,nha-sach-tiki,17881046,"Trầm lặng - Sức mạnh tiềm ẩn của người hướng nội",88100,130000,41900,32
TIKI,nha-sach-tiki,96616370,"Con Đường Trở Thành Freelance Writer - Tôi Đã Kiếm 800.000.000 Một Năm Từ Viết Lách Như Thế Nào? (Tái Bản)",164000,220000,56000,25
TIKI,nha-sach-tiki,113540577,"Anne Tóc Đỏ Dưới Chái Nhà Xanh",92300,119000,26700,22
TIKI,nha-sach-tiki,194960245,"Migi & Dali -Tập 1",37100,40000,2900,7
TIKI,nha-sach-tiki,53722909,"Combo Trinh Thám Trung Quốc: Phục Thù (2 tập)",95000,225000,130000,58
TIKI,nha-sach-tiki,184466862,"Trưởng Thành Là Khi Nỗi Buồn Cũng Có Deadline",65000,88000,23000,26
TIKI,nha-sach-tiki,39228816,"Kỹ Thuật Giao Dịch Để Kiếm Tiền Hàng Ngày Trên Thị Trường Chứng Khoán – Day Trade For A Living",298000,298000,0,0
TIKI,nha-sach-tiki,77621607,"Spy X Family Tập 3",24300,25000,700,3
TIKI,nha-sach-tiki,191045565,"Cô Gái Mặc Váy Tím",73600,95000,21400,23
TIKI,nha-sach-tiki,97561438,"Thế Giới Quả Là Rộng Lớn Và Có Rất Nhiều Việc Phải Làm (Tái Bản)",92620,139000,46380,33
TIKI,nha-sach-tiki,178294073,"Trading in The Zone - Thực Hành Kiểm Soát Cảm Xúc bằng Tâm Lý Học Hành Vi trong Đầu Tư và Giao Dịch",295000,295000,0,0
TIKI,nha-sach-tiki,87959745,"Hạnh Phúc Là Con Đường",115000,155000,40000,26
TIKI,nha-sach-tiki,100947276,"Ung Thư - Sự Thật, Hư Cấu, Gian Lận Và Những Phương Pháp Chữa Bệnh Không Độc Hại (Tái Bản)",114000,169000,55000,33
TIKI,nha-sach-tiki,21130354,"Vòng Tròn Máu - Trinh Thám Cổ Điển Anh",72000,102000,30000,29
TIKI,nha-sach-tiki,72744612,"Nghề Thầy",52000,70000,18000,26
TIKI,nha-sach-tiki,90985718,"Càng Mạnh Mẽ, Càng Dịu Dàng (Tái Bản)",67800,99000,31200,32
TIKI,nha-sach-tiki,186578227,"Những kẻ cuồng nhạc Musicophilia – Tales of music and the brain",177000,230000,53000,23
TIKI,nha-sach-tiki,193605362,"Ali Và NiNo",97000,125000,28000,22
TIKI,nha-sach-tiki,197119849,"Chuông Gió (Tập 3)",135000,174000,39000,22
TIKI,nha-sach-tiki,192048665,"Vỡ lòng về tiền tệ - Money for Beginners",112000,150000,38000,25
TIKI,nha-sach-tiki,274607551,"Lời Nói Thần Kỳ Nuôi Dưỡng Những Đứa Trẻ Hạnh Phúc: 0 - 6 Tuổi",61100,61800,700,1
TIKI,nha-sach-tiki,192909291,"Văn Phòng Thám Tử Quái Vật - Tập 10",21000,30000,9000,30
TIKI,nha-sach-tiki,194104223,"Quán Rượu Dị Giới "Nobu" - Tập 10",28100,40000,11900,30
TIKI,nha-sach-tiki,72680632,"Năng Lực Tìm Kiếm",60400,91000,30600,34
TIKI,nha-sach-tiki,55506686,"Tiktok Marketing",92600,139000,46400,33
TIKI,nha-sach-tiki,125776045,"Giấy in photo A4 IK Copy IK-01 - Định lượng 70 gsm - 500 tờ/ream - giấy chất lượng cao nhập khẩu Indonesia",70000,110000,40000,36
TIKI,nha-sach-tiki,193590152,"Méthode Rose - Phương pháp hồng 1 - Năm thứ nhất với đàn piano - Giáo trình dạy piano nổi tiếng của Pháp",97000,150000,53000,35
TIKI,nha-sach-tiki,168662558,"CCMR. Phải Trái Đúng Sai",92000,155000,63000,41
TIKI,nha-sach-tiki,189657049,"One Piece - Tập 99",25000,25000,0,0
TIKI,nha-sach-tiki,193896563,"Cô Bạn Tôi Thầm Thích Lại Quên Mang Kính Rồi - Tập 2 [Tặng Kèm Standee Ivory]",37100,38000,900,2
TIKI,nha-cua-doi-song,206165460,"Cây lau nhà VILEDA Turbo Easy Wring&Clean đầu lau tam giác, gồm xô giặt và cây lau nhà - TSU162214",579000,579000,0,0
TIKI,nha-cua-doi-song,28619438,"Thang nhôm rút gọn SUMIKA SK320 - Chiều cao tối đa 3.2m, chiều dài rút gọn 0.8m, hợp kim nhôm cao cấp, khóa chốt chắc chắn, đế cao su chống trượt, nhỏ gọn, di chuyển tiện lợi",1139000,1500000,361000,24
TIKI,nha-cua-doi-song,73785488,"Bộ 3 nồi inox 4 đáy Nagakawa NAG1306 (16cm, 20cm, 24cm) - Quai mạ vàng - Dùng trên mọi loại bếp - Hàng Chính Hãng",528000,1000000,472000,47
TIKI,nha-cua-doi-song,51699604,"Ghế lười Dream Micro  HomeDream - HOMEDREAM-MRH",1000000,1000000,0,0
TIKI,nha-cua-doi-song,122700651,"Cây lau kính, gạt chùi kính đa năng 2 đầu trong 1 - Parroti Shiny SN01",129000,199000,70000,35
TIKI,nha-cua-doi-song,21441057,"Chảo Chống Dính Đá Sunhouse SBD18 - 18cm",187000,260000,73000,28
TIKI,nha-cua-doi-song,271063530,"Mua 3 Tặng 2 Bộ 3 Đôi Găng Tay Cao Su Ngọc Trai Tay Lửng Size L",99000,159000,60000,38
TIKI,nha-cua-doi-song,94724913,"Ron Dán Che Khe Cửa ,Chân Cửa,Khung Cửa CTFAST Chống Bụi, Ngăn Côn Trùng, Chống Ồn, Chống Thoát Nhiệt Điều Hòa, Chống Va Đập Cửa - Mẫu Cải Tiến 2021 ( Hàng Chính Hãng )",49000,68000,19000,28
TIKI,nha-cua-doi-song,146262084,"Gối Ngủ Memory Foam NOOZ Ruột Gối Cao Su Non Giúp Nâng Đỡ Đốt Sống Cổ Chống Đau Vai Gáy Ngủ Sâu Hỗ Trợ Chống Trào Ngược Phù Hợp Với Mọi Tư Thế Nằm Vỏ Gối Tencel",339000,560000,221000,39
TIKI,nha-cua-doi-song,273554952,"Phin nhôm hoa văn Trung Nguyên - Màu vàng",79000,79000,0,0
TIKI,nha-cua-doi-song,241804451," Móc INOX 304 Treo Đồ nặng, treo thớt, nồi niêu INOX 304 [CHỐNG NƯỚC, CHỐNG RỈ] Dán Mọi Bề Mặt",15000,15000,0,0
TIKI,nha-cua-doi-song,272363198,"Chảo chống dính Elmich EL7105Max size",344000,404250,60250,15
TIKI,nha-cua-doi-song,78025846,"Khăn tắm Bamboo Life BL058 hàng chính hãng được làm từ sợi tre thiên nhiên mềm mại kháng khuẩn siêu thấm hút an toàn cho da",59000,59000,0,0
TIKI,nha-cua-doi-song,193108477,"Bộ Ghế Lười K-Bean Canvas Xám Xanh ",1400000,1400000,0,0
TIKI,nha-cua-doi-song,1024190,"Bộ 3 Hộp Cơm Giữ Nhiệt Lock&amp;Lock Mushroom LHC8025SLV - Bạc",524000,1007000,483000,48
TIKI,nha-cua-doi-song,177610565,"Đèn Pin Siêu Sáng US ARMY Mã XML-T6 Cao Cấp Vỏ Hợp Kim Chống Nước Sử Dụng Pin Có Thể Sạc Lại Tặng Hộp Full Box- HÀNG CHÍNH HÃNG",108000,258000,150000,58
TIKI,nha-cua-doi-song,57867024,"Bộ Lau Nhà Xoay 360 Độ Sunhouse Ks-Cl350PO",337000,513000,176000,34
TIKI,nha-cua-doi-song,120759154,"Bó 100 Dây Thít, Dây Rút, Lạt Nhựa Đủ Mọi Kích Cỡ Tiện Lợi",24000,30000,6000,20
TIKI,nha-cua-doi-song,217695866,"Bóng đèn LED Bulb MPE LBD E27 - Tiết kiệm điện, Tiêu chuẩn Châu Âu, Thương hiệu Việt Nam - Hàng Chính Hãng",41000,67000,26000,39
TIKI,nha-cua-doi-song,15737169,"Đế Đèn LED 3D Có Điều Khiển Remote 16 Màu Đèn",75000,75000,0,0
TIKI,nha-cua-doi-song,248184506,"Combo 2 nắp bồn cầu thông minh dùng cơ Bumia bidet, tự rửa vệ sinh hậu môn và vệ sinh cho phụ nữ , vòi xịt vệ sinh thông minh, mã BM-01V",2879000,2879000,0,0
TIKI,nha-cua-doi-song,119195755,"Bộ lau nhà tự vắt thông minh, chổi lau nhà 360 độ, lau sạch khô nhanh - Parroti ProMax PX01",519000,849000,330000,39
TIKI,nha-cua-doi-song,32328782,"Phin Nhôm Cà Phê Tráng Men Đen Trung Nguyên  ",79000,79000,0,0
TIKI,nha-cua-doi-song,119030223,"Keo Dán Giày, Gỗ, Nhựa, Sứ Siêu Dính Chống Thấm Đa Năng Deli - 7Ml / 20Ml - 7140 / 7149",8000,16200,8200,51
TIKI,nha-cua-doi-song,98562149," 328 Cái Ống Co Nhiệt Cách Nhiệt Ống Co Phân Loại Điện Tử",28989,28989,0,0
TIKI,nha-cua-doi-song,182971940,"Bình giữ nhiệt LocknLock có 2 nắp thay thế New Clip Tumbler 540ml LHC4279",270000,520000,250000,48
TIKI,nha-cua-doi-song,273663747,"Kèn Melodion/ Pianica/ Melodica Suzuki MX-37C - Hàng Chính Hãng",1039000,1039000,0,0
TIKI,nha-cua-doi-song,163550425,"Nệm Bông Gòn Xuất Nhật, Nệm Trải Sàn Tiện Lợi, Đệm Văn Phòng Size 1m x 2m; 1.4m x 2m; 1.6m x 2m",387000,500000,113000,23
TIKI,nha-cua-doi-song,52504270,"Chiếu Mây Điều Hòa Cao Cấp Loại dày",169000,230000,61000,27
TIKI,nha-cua-doi-song,112321595,"Đèn Học Chống Cận Thị, Đèn Đọc Sách, Đèn Làm Việc Để Bàn Chống Chói Mắt Lóa Mắt Bảo Vệ Mắt Chống Cận Thị, Cảm Ứng Siêu Sáng - VinBuy",164000,300000,136000,45
TIKI,nha-cua-doi-song,273360410,"Kèn Melodion/ Pianica/ Melodica Valote VM-32K, VM-37K Túi Vải Nhiều Màu Sắc - Hàng Chính Hãng",259000,259000,0,0
TIKI,nha-cua-doi-song,181971817,"Nệm cao su thiên nhiên Rosi massage Thắng Lợi, Đệm cao su thiên nhiên hàng chính hãng",3350000,3350000,0,0
TIKI,nha-cua-doi-song,186627908,"Ghế Gác Chân Công Thái Học Ergonomic Footrest, Ghế Kê Chân Ghế Gác Chân Văn Phòng",189000,280000,91000,33
TIKI,nha-cua-doi-song,115092053,"Bộ ga giường poly cotton LIDACO drap giường đủ size nệm 1m2, 1m4, 1m6, 1m8",119000,120000,1000,1
TIKI,nha-cua-doi-song,147265074,"Vỉ 2 VPin AA , Pin AAA DURACELL 1,5V Siêu Bền - Hàng chính hãng",30000,30000,0,0
TIKI,nha-cua-doi-song,84886093,"Vợt muỗi thông minh 3in1 SUNHOUSE SHE-PRO11.W",208000,344000,136000,40
TIKI,nha-cua-doi-song,273348701,"Bộ lọc nước sinh hoạt 3 cấp 10" lọc zen 21 - Hàng chính hãng",256500,270000,13500,5
TIKI,nha-cua-doi-song,183907622,"Cây Lăn Bụi Quần Áo, Ghế Sofa - Tặng Kèm 2 lõi lăn",31000,55000,24000,44
TIKI,nha-cua-doi-song,57806524,"Áo Mưa Bộ Vải Dù Cao Cấp Cho Bé Từ 3 -10 Tuổi, Chống Thấm, Che Kín Người An Toàn Cho Bé, Lựa Chọn Màu Sắc Phù Hợp Giới Tính (Giao Màu - Mẫu Ngẫu Nhiên)",110000,110000,0,0
TIKI,nha-cua-doi-song,52756206,"1kg Túi Đựng Rác Tự Phân Hủy Sinh Học Gimex II (full size)",28000,28000,0,0
TIKI,nha-cua-doi-song,185910176,"Giấy Nến Vàng Lót Nồi Chiên Không Dầu Sạch Sẽ Tiện Dụng An Toàn Cho Sức Khỏe - 1 set 50 Tờ",85000,85000,0,0
TIKI,nha-cua-doi-song,92385690,"Áo Mưa Cánh Dơi 2 Đầu Vải Dù Loại Siêu Dày, Hàng Việt Nam Chất Lượng Cao, Khổ To Rộng Phù Hợp Cho 2 Người, An Toàn Cho Người Sử Dụng, Có Túi Đựng Dễ Bảo Quản.",140000,140000,0,0
TIKI,nha-cua-doi-song,119007194,"Thanh 4 Móc Treo Dán Tường, Móc Treo Đồ Đa Năng Parroti Handy HD41",21900,36000,14100,39
TIKI,nha-cua-doi-song,54145105,"Cọ Bồn Cầu Toilet, Cọ Vệ Sinh Cao Cấp - Parroti Silicon SL01 – Có Bình Đựng Nước Tẩy, Cây Gắp Tóc Tiện Dụng",88000,89000,1000,1
TIKI,nha-cua-doi-song,1399571,"Gối Memory Foam 50D Hình Cong Lock&Lock HLW111 (50 x 30 cm) - Trắng",290000,483000,193000,40
TIKI,nha-cua-doi-song,138952791,"Móc Treo Cây Lau Nhà Dán Tường Đa Năng Chịu Lực Tốt, 2 Trong 1 - Parroti Keeper KP03",22900,42000,19100,45
TIKI,nha-cua-doi-song,106457363,"Túi Giữ Nhiệt Đựng Hộp Cơm 2 Ngăn – Chọn Màu Túi Giữ Nhiệt Đựng Cặp Lồng Cơm – Nhiều Màu – Chống Thấm Nước Chính Hãng",45000,70000,25000,36
TIKI,nha-cua-doi-song,165013585,"Ổ Cắm Điện Dài VINAVU Kèm Cổng USB Công Tắc Riêng Chịu Tải 2500W, Chống Giật, Chống Cháy",199000,199000,0,0
TIKI,nha-cua-doi-song,119203295,"Combo 5 Khăn Lau Bếp, Lau Kính Siêu Thấm Hút Parroti - Fiber FB02",47000,89000,42000,47
TIKI,nha-cua-doi-song,892141,"Pin Max 8 + 4 Viên Energizer E92 BP8+4 AAA",152000,180000,28000,16
TIKI,nha-cua-doi-song,71924330,"Bộ Chổi Quét Nhà Lock&Lock Gồm Cây Chổi và Dụng Cụ Hốt ETM465",257000,428000,171000,40
TIKI,nha-cua-doi-song,73147684,"Thanh xốp gắn chân cửa chống kẹt chân cho bé, bịt khe hở, chắn gió, chặn côn trùng",8000,13999,5999,43
TIKI,nha-cua-doi-song,143841853,"Bình Giữ Nhiệt Coffee Bugu Mini Inox 304 LI-02 – Hàng Chính Hãng",108000,150000,42000,28
TIKI,nha-cua-doi-song,181410158,"Bàn Làm Việc Đa Năng Decor Phong Cách Gaming Thương Hiệu IGA - GM62",293000,320000,27000,8
TIKI,nha-cua-doi-song,185756654,"Cây chà sàn nhà tắm Kitimop-Z4 chổi cọ sàn và gạt nước đa năng 2 trong 1, cọ sạch khe hẹp và góc tường",49000,75000,26000,35
TIKI,nha-cua-doi-song,1651191,"Kệ Đỡ Màn Hình Máy Tính Monitor Stand Walnut Plyconcept MSM01003 (490 x 200 mm) - Nâu Đậm",290000,380000,90000,24
TIKI,nha-cua-doi-song,104680895,"Cây Lau Nhà Đơn MyJae Sợi Microfiber Xoay 360 Độ Phù Hợp Cho Nhiều Loại Thùng Lau 134cm",199000,330000,131000,40
TIKI,nha-cua-doi-song,153066085,"Pin CR2032 Lithium 3V Maxell cao cấp Made In Japan - Hàng chính hãng",26000,30000,4000,13
TIKI,nha-cua-doi-song,58357614,"Đèn bắt muỗi, ruồi và các loại côn trùng Con Dơi",390000,390000,0,0
TIKI,nha-cua-doi-song,184245786,"Túi đựng hộp cơm giữ nhiệt, túi đựng đồ ăn trưa văn phòng có lớp lót nhôm giữ nhiệt dày dặn, kích thước lớn tiện lợi",59000,59000,0,0
TIKI,nha-cua-doi-song,273244363,"Kệ Sách Gỗ 5 Tầng, Giá Sách Đứng Cạnh Bàn Làm Việc - GP189",318000,346000,28000,8
TIKI,nha-cua-doi-song,122911188,"Găng tay cao su siêu dai rửa bát, bao tay cao su rửa chén, vệ sinh nhà cửa, an toàn, không mùi hôi Parroti Active AT01",47000,89000,42000,47
TIKI,nha-cua-doi-song,64988886,"Bình giữ nhiệt Lock&amp;Lock Flat nắp gỗ 400ml - LHC4227WHT - Màu",278000,534000,256000,48
TIKI,nha-cua-doi-song,14681534,"Bộ tua vít sửa chữa đồng hồ điện thoại",31160,32800,1640,5
TIKI,nha-cua-doi-song,173732608,"Combo Khăn Lau Đa Năng 2 Mặt Siêu Thấm , Khăn Lau Bếp , Khăn Lau Kính , Khăn Lau Chén Bát , Khăn Lau Tay , Khăn Lau Ô Tô PaKaSa",38000,38000,0,0
TIKI,nha-cua-doi-song,200960836,"Dây Đèn Led Fairy Light Trang Trí Giáng Sinh Biểu Tượng Cây Thông, Người Tuyết, Ông Già Noel - Chính Hãng NAVIVU",79000,79000,0,0
TIKI,nha-cua-doi-song,52484490,"Keo Dán Chống Thấm Siêu Dính Nhật Bản Bosui Dài 5m ",13000,14999,1999,13
TIKI,nha-cua-doi-song,148713415,"Tua Vít Cầm Tay Nhỏ Gọn, Tiện Dụng Lắp Ráp Và Sửa Chữa Vật Dụng Gia Đình (5mmx155mm)",27000,27000,0,0
TIKI,nha-cua-doi-song,131407951,"Bàn làm việc bàn hoc chữ k",372240,396000,23760,6
TIKI,nha-cua-doi-song,117353723,"Chiếu ngủ văn phòng cao cấp",45000,45000,0,0
TIKI,nha-cua-doi-song,165256438,"Khăn mặt sợi tre Bamboo&Love 30x50 mềm mại kháng khuẩn siêu thấm hút an toàn cho da ngay cả với trẻ sơ sinh",23700,23900,200,1
TIKI,nha-cua-doi-song,46163430,"Sáo Recorder Soprano Yamaha YRS-24B Tone C (Đô) - Kèm Móng Gảy DreamMaker",129000,129000,0,0
TIKI,nha-cua-doi-song,2153015,"Bộ Vít 24 Món Xiaomi Wiha Precision Screwdriver",399000,490000,91000,19
TIKI,nha-cua-doi-song,110001215,"Nẹp Dây Điện Dán Tường Siêu Dính ,Kẹp Dây Điện Cố Định Và Giữ Dây Điện Siêu Sốc an toàn tiện lợi dễ lắp đặt",11699,11699,0,0
TIKI,nha-cua-doi-song,162548473,"Hộp Đựng Giày Nhựa Cứng Cao Cấp Size Lớn Cửa Nam Châm Lắp Ráp Tiện Lợi Song Anh- Hàng Chính Hãng",95000,95000,0,0
TIKI,nha-cua-doi-song,118858137,"Nạo Gọt Rau Củ Quả  Inox 304 Hàng Cao Cấp - Mua 1 Lần Dùng Mãi Mãi",70000,70000,0,0
TIKI,nha-cua-doi-song,149617968,"Thùng đựng gạo thông minh M&L Royalcare 6068 - bao gồm khay đựng ngũ cốc - chống ẩm mốc côn trùng - đồ gia dụng tiện ích",469000,469000,0,0
TIKI,nha-cua-doi-song,36560504,"Bình Nước Lock&Lock One Touch ABF687LPIK 500ml",151000,290000,139000,48
TIKI,nha-cua-doi-song,104110135,"Bàn chải nhà tắm, cọ bồn rửa Parroti Clever CR01",55000,99000,44000,44
TIKI,nha-cua-doi-song,138507381,"Chai xịt chuột thái land rat off",83000,83000,0,0
TIKI,nha-cua-doi-song,127031393,"Ca nước giữ nhiệt LocknLock Metro Mug LHC4219MIT 475ml - Màu",304000,506000,202000,40
TIKI,nha-cua-doi-song,71206737,"Đèn Pin Laser 303 - Hàng Chính Hãng",133400,145000,11600,8
TIKI,nha-cua-doi-song,149573787,"Thùng rác thông minh cảm ứng tự động M&L-FH-2 phong cách Hàn Quốc",479000,479000,0,0
TIKI,nha-cua-doi-song,10227148,"Dụng Cụ Mài Dao 3 Lớp Lock&Lock CKK112 (245 x 53 x 72 mm)",165000,275000,110000,40
TIKI,nha-cua-doi-song,75664370,"GỐI MỀN BIỆT ĐỘI RU NGỦ 3 IN 1 - BỘ CHĂN GỐI VĂN PHÒNG SIÊU MỊN -MẪU 2021",199000,199000,0,0
TIKI,nha-cua-doi-song,174236741,"Găng tay cao su tự nhiên Lock&amp;Lock ETM830 (có móc treo)",31000,56000,25000,45
TIKI,nha-cua-doi-song,119112667,"Combo 2 Miếng Lau Nhà Parroti ProMAX - Kích Thước 38 x12 CM",85000,145000,60000,41
TIKI,nha-cua-doi-song,128969410,"Kệ Sách Để Bàn, Giá Sách Thiết Kế Hiện Đại Thương Hiệu IGA - GP157",187000,205000,18000,9
TIKI,nha-cua-doi-song,63051860," Đèn Học Làm Việc Đọc Sách Để Bàn Pixar Chống Cận Thị Bảo Vệ Mắt - Hàng Chính Hãng eLights",159000,219000,60000,27
TIKI,nha-cua-doi-song,44620765,"Đèn Pin Led Siêu Sáng Mini Có Sạc USB Có Hỗ Trợ Sạc Dự Phòng Lại Cho Điện Thoại Khẩn Cấp - Hàng Chính Hãng",85000,129000,44000,34
TIKI,nha-cua-doi-song,2151853,"Ly Giữ Nhiệt Lock&Lock Swing Tumbler LHC4138SLV",374000,623000,249000,40
TIKI,nha-cua-doi-song,177969021,"Bộ Hộp Cơm Giữ Nhiệt 2GOOD Lunch Box HC02 (2000ml) - Kèm Muỗng và Đũa Inox 304",590000,590000,0,0
TIKI,nha-cua-doi-song,52187161,"Giá Treo Ổ Điện Dán Tường Tiết Kiệm Không Gian",6000,9000,3000,33
TIKI,nha-cua-doi-song,75615959,"Combo 5 khăn lau đa năng siêu thấm hút, khăn size lớn (30x40 cm) khăn lau kính, ô tô, mặt bàn, bếp Parroti Fiber FB01",48000,89000,41000,46
TIKI,nha-cua-doi-song,57999394,"Bộ Ga Gối Cotton Đũi Tici LIDACO Cao Cấp - Xanh Mint",149000,220000,71000,32
TIKI,nha-sach-tiki,637390,"Tuần Của Bé - Bé Thông Minh",21850,23000,1150,5
TIKI,nha-sach-tiki,93249197,"22 Quy Luật Bất Biến Trong Marketing",53100,78000,24900,32
TIKI,nha-sach-tiki,20444622,"Cẩm Nang Cấu Trúc Tiếng Anh",63000,98000,35000,36
TIKI,nha-sach-tiki,197634260,"Black Jack - Tập 14",30000,30000,0,0
TIKI,nha-sach-tiki,80960198,"Thiên Tài Bên Trái, Kẻ Điên Bên Phải (Tái Bản 2021)",121000,179000,58000,32
TIKI,nha-sach-tiki,197990871,"Doraemon Movie Story: Nobita Và Hòn Đảo Diệu Kì - Cuộc Phiêu Lưu Của Loài Thú",30000,30000,0,0
TIKI,nha-sach-tiki,56218385,"Thông Điệp Của Nước (Tái Bản 2020)",59100,89000,29900,34
TIKI,nha-sach-tiki,381234,"Cuốn Sách Hoàn Hảo Về Ngôn Ngữ Cơ Thể - Body Language (Tái Bản)",149000,198000,49000,25
TIKI,nha-sach-tiki,197990867,"Doraemon Movie Story: Nobita Và Viện Bảo Tàng Bảo Bối",30000,30000,0,0
TIKI,nha-sach-tiki,59293803,"A Holistic Approach To IELTS Writing",131000,189000,58000,31
TIKI,nha-sach-tiki,54624820,"Sức Mạnh Của Tĩnh Lặng (Tái Bản 2020)",46500,68000,21500,32
TIKI,nha-sach-tiki,174444205,"Dịch Vụ Đặc Biệt: Dọn Dẹp Nhà Cho Người Chết",71800,99000,27200,27
TIKI,nha-sach-tiki,89179374,"Spy X Family Tập 4",24300,25000,700,3
TIKI,nha-sach-tiki,106605689,"Spy X Family Tập 5 - Bản Thường",25000,25000,0,0
TIKI,nha-sach-tiki,87391039,"Thuật Yêu Đương (Tái Bản)",81000,120000,39000,33
TIKI,nha-sach-tiki,77230663,"Combo 2 Cuốn: Tâm Lý Học Tội Phạm",200000,288000,88000,31
TIKI,nha-sach-tiki,54051756,"19 Năm Mưu Sát - Tập 2 (Trinh Thám Trung Quốc)",74000,115000,41000,36
TIKI,nha-sach-tiki,195885680,"Tiệm Trừ Yêu Kì Ảo -  Tập 18",34100,35000,900,3
TIKI,nha-sach-tiki,100958444,"Hạnh Phúc Cầm Tay (Tái Bản)",52000,75000,23000,31
TIKI,nha-sach-tiki,595724,"Giáo Trình Chuẩn HSK 4 Bài Học (Tập 1)",171000,228000,57000,25
TIKI,nha-sach-tiki,77109209,"Nghệ Thuật Đánh Cắp Ý Tưởng (10 Bí Mật Không Ai Nói Với Bạn Về Sáng Tạo)",65400,99000,33600,34
TIKI,nha-sach-tiki,124639646,"Bé chinh phục 2000 từ vựng tiếng Anh - My First 2000 English words",62400,120000,57600,48
TIKI,nha-sach-tiki,14645351,"Cuộc Đời Của Pi ( Tái Bản 2019)",82000,110000,28000,25
TIKI,nha-sach-tiki,192909304,"Lên Tàu Cùng Socrates - Đi Tìm Ý Nghĩa Cuộc Sống Từ Các Triết Gia",103900,195000,91100,47
TIKI,nha-sach-tiki,116406678,"Quản Lý Nghiệp (Tái Bản)",40800,59000,18200,31
TIKI,nha-sach-tiki,76175424,"Vụ Án Mạng Ở Nhà Khách Núi Hakuba",101000,138000,37000,27
TIKI,nha-sach-tiki,111582631,"Cái Dũng Của Thánh Nhân (Thu Giang Nguyễn Duy Cần) (Tái Bản)",62000,90000,28000,31
TIKI,nha-sach-tiki,149180057,"Đừng Cố Làm Người Tốt Trong Mắt Tất Cả Mọi Người",86000,108000,22000,20
TIKI,nha-sach-tiki,81224320,"Nước Ép Xanh Chữa Lành Cơ Thể",124600,179000,54400,30
TIKI,nha-sach-tiki,52329861,"Con Đường Hồi Giáo (Tái Bản 2020)",72500,100000,27500,28
TIKI,nha-sach-tiki,54051754,"19 Năm Mưu Sát - Tập 1 (Trinh Thám Trung Quốc)",74000,115000,41000,36
TIKI,nha-sach-tiki,189641379,"Anh Em Nhà Motohashi - Tập 1",53400,68000,14600,21
TIKI,nha-sach-tiki,187843301,"How Technology Works – Hiểu hết về công nghệ",242000,330000,88000,27
TIKI,nha-sach-tiki,194104226,"Mô Hình Can Thiệp Sớm Denver Cho Trẻ Tự Kỷ - Thúc Đẩy Kỹ Năng Ngôn Ngữ, Học Tập Và Tương Tác",110200,210000,99800,48
TIKI,nha-sach-tiki,46789754,"Hiểu Hết Về Kinh Doanh",283000,380000,97000,26
TIKI,nha-sach-tiki,10405966,"Tarot Nhập Môn (Tái Bản 2019)",87100,120000,32900,27
TIKI,nha-sach-tiki,190240560,"Bộ Sách Tô Màu - Bé Làm Họa Sĩ",19000,25000,6000,24
TIKI,nha-sach-tiki,140635217,"Mất Kết Nối (Khám Phá Các Nguyên Nhân Thực Của Trầm Cảm Và Các Giải Pháp Bất Ngờ)",166000,250000,84000,34
TIKI,nha-sach-tiki,10397239,"Chiến Lược Dữ Liệu",114000,158000,44000,28
TIKI,nha-sach-tiki,162201947,"One Piece - Tập 98: “Phút Huy Hoàng Của Những Trung Thần",25000,25000,0,0
TIKI,nha-sach-tiki,140360874,"Những Đòn Tâm Lý Trong Bán Hàng (Tái Bản)",80620,139000,58380,42
TIKI,nha-sach-tiki,10383904,"Tôi Là Bêtô",65000,95000,30000,32
TIKI,nha-sach-tiki,176654072,"Bộ 5 bút chì gỗ 2B HB Deli - Có bán lẻ 1 chiếc - Nhiều loại mẫu mã màu sắc - Phù hợp cho học sinh sinh viên tập viết vẽ tranh",1700,3420,1720,50
TIKI,nha-sach-tiki,190708154,"Dragon Quest - Dấu Ấn Roto (Dragon Quest Saga Emblem Of Roto) Perfect Edition Tập 8 [Tặng Kèm Bookmark PVC]",70000,75000,5000,7
TIKI,nha-sach-tiki,105614684,"Bút gel 0.5mm Deli nhiều màu lựa chọn - Bút bi nước -  1 chiếc - Mực đỏ / Xanh / Đen - A116",7200,7200,0,0
TIKI,nha-sach-tiki,58342212,"Set 3 cuốn Moi Moi và những người bạn - Dành cho trẻ từ 0-2 tuổi",75600,117000,41400,35
TIKI,nha-sach-tiki,73125816,"Digital Marketing - Từ Chiến Lược Đến Thực Thi (Tái Bản 2020)",167000,220000,53000,24
TIKI,nha-sach-tiki,137161811,"Bút gel bấm ngòi 0.5mm nhiều màu Deli - Độ dài mực lên tới 1000m - 12 màu mực - 1 chiếc - EG118",5000,10800,5800,54
TIKI,nha-sach-tiki,100347903,"Nói Một Cách Đơn Giản",90000,129000,39000,30
TIKI,nha-sach-tiki,180851000,"Bảy Thanh Hung Giản 3 Mưa Phùn Chôn Nho - Truy Lùng Báo Săn Giá",182000,235000,53000,23
TIKI,nha-sach-tiki,148761077,"Khách Sạn Mặt Nạ 1",136000,175000,39000,22
TIKI,nha-sach-tiki,72542509,"Raw Vegan – Sức Mạnh Chữa Lành Của Thực Vật (Tặng kèm bookmark)",63900,92000,28100,31
TIKI,nha-sach-tiki,509829,"Giấy Double A A4 DL70",85500,90000,4500,5
TIKI,nha-sach-tiki,144203242,"9 Lần Khởi Nghiệp - Chuyện Kể Về Những Thất Bại Và Thành Công Của Một Triệu Phú",149000,199000,50000,25
TIKI,nha-sach-tiki,50685547,"Bản Đồ (Bản Thông Thường)",237000,345000,108000,31
TIKI,nha-sach-tiki,62648441,"The Customer Rules - 39 Nguyên Tắc Cốt Lõi Để Mang Tới Dịch Vụ Đỉnh Cao",174000,220000,46000,21
TIKI,nha-sach-tiki,10325548,"How Food Works - Hiểu Hết Về Thức Ăn",223000,300000,77000,26
TIKI,nha-sach-tiki,138226289,"Storytelling With Data: Let’S Practice! - Thực Hành Kể Chuyện Thông Qua Dữ Liệu!",277800,399000,121200,30
TIKI,nha-sach-tiki,193434494,"Shaman King - Tập 15",33800,35000,1200,3
TIKI,nha-sach-tiki,168946125,"Digital Marketing - Chiến Lược Là Lược Đi Để Chiến",111200,139000,27800,20
TIKI,nha-sach-tiki,193736891,"Tâm Lý Học Xã Hội - Đi Tìm Chất Gây Nghiện Trong Mỗi Con Người",99600,139000,39400,28
TIKI,nha-sach-tiki,193978836,"Trí Óc Minh Mẫn: Để Não Bộ Sắc Bén Ở Mọi Lứa Tuổi",164400,249000,84600,34
TIKI,nha-sach-tiki,196001724,"Dưới Cánh Đại Bàng (Bìa Mềm)",95100,138000,42900,31
TIKI,nha-sach-tiki,95090804,"Bút dạ viết bảng Deli - xóa được - Mực xanh/đen/đỏ - 1 chiếc – EU00120/ EU00130 / EU00140",14400,14400,0,0
TIKI,nha-sach-tiki,49181801,"Oxford Advanced Learner's Dictionary : Paperback - 10th Edition (With 1 Year's Access To Both Premium Online And App)",522660,562000,39340,7
TIKI,nha-sach-tiki,176906726,"Chân Dung Thật - Thấu Hiểu Khách Hàng Chỉ Bằng Những Cuộc Trò Chuyện",211000,245000,34000,14
TIKI,nha-sach-tiki,77105810,"Nỗi Đau Của Chàng Werther (Bìa Cứng)",63300,85000,21700,26
TIKI,nha-sach-tiki,15397971,"Hà Nội Băm Sáu Phố Phường (Tái bản 2019)",37100,50000,12900,26
TIKI,nha-sach-tiki,130997085,"Chuyện Con Chó Tên Là Trung Thành",34000,45000,11000,24
TIKI,nha-sach-tiki,197587849,"Yuri Espoir (Tập 3)",62700,79000,16300,21
TIKI,nha-sach-tiki,174427255,"Lốc Vở Kẻ Ngang Primer (120 trang - 200 trang | Giao mẫu ngẫu nhiên)",80070,157000,76930,49
TIKI,nha-sach-tiki,84950232,"Hoa Sen Trên Tuyết (Tái Bản)",68100,98000,29900,31
TIKI,nha-sach-tiki,115873770,"Sách: Thay Đổi Một Suy Nghĩ Thay Đổi cả Cuộc Đời",120000,160000,40000,25
TIKI,nha-sach-tiki,195801646,"Ninja Rantaro - Tập 60",37100,40000,2900,7
TIKI,nha-sach-tiki,78975610,"Siêu Tập Trung (Tái Bản)",90000,140000,50000,36
TIKI,nha-sach-tiki,45663835,"Lạc Quan Tếu – Irrational Exuberance",299000,299000,0,0
TIKI,nha-sach-tiki,197781968,"Migi & Dali Tập 3",37900,40000,2100,5
TIKI,nha-sach-tiki,196001693,"Trí Tuệ Của Trái Tim",69500,88000,18500,21
TIKI,nha-sach-tiki,72818335,"Bộ Thẻ học Thông minh - 416 Thẻ Flashcards Tiếng Anh - 16 Chủ đề mới nhất",65790,129000,63210,49
TIKI,nha-sach-tiki,148760915,"Khách Sạn Mặt Nạ 2 - Đêm Trước Lễ Hội Hóa Trang",97000,125000,28000,22
TIKI,nha-cua-doi-song,118966833,"Móc Treo Cây Lau Nhà Dán Tường Đa Năng  Chịu Lực Tốt - Parroti Keeper KP02",22900,42000,19100,45
TIKI,nha-cua-doi-song,74396976,"Máy xay tỏi ớt bằng tay Lock&Lock (Nhiều kích cỡ) - Hàng chính hãng, lực nghiền mạnh với 3 lưỡi dao thép không gỉ",129000,216000,87000,40
TIKI,nha-cua-doi-song,165404269,"Khăn tắm sợi tre Bamboo&Love 60x120cm mềm mại kháng khuẩn siêu thấm hút an toàn cho da ngay cả với trẻ sơ sinh",70000,70000,0,0
TIKI,nha-cua-doi-song,180378151,"Bình giữ nhiệt LocknLock Metro Drive LHC4277S 650ml - Kèm ống hút và cọ rửa",301000,579000,278000,48
TIKI,nha-cua-doi-song,189491905,"Nhang Sen Thuần Khiết Liên Tâm 20.5cm 160 cây - Ít khói, dịu nhẹ, 100% Đài sen thiên nhiên",75000,75000,0,0
TIKI,nha-cua-doi-song,3490669,"Cây lau nhà tự vắt thông minh Panda ",39899,41999,2100,5
TIKI,nha-cua-doi-song,121396300,"Dây rút nhựa 10cm ,15cm, 20cm, 25cm, 30cm ( Khoảng 80 sợi/bịch )",3900,3900,0,0
TIKI,nha-cua-doi-song,17593518,"Bộ Hộp Cơm Giữ Nhiệt Thép Không Gỉ Lock & Lock LHC8031SLV - Bạc",668000,1285000,617000,48
TIKI,nha-cua-doi-song,10032000,"Ổ cắm đa năng du lịch Adapter",30500,30500,0,0
TIKI,nha-cua-doi-song,71005991,"Bình xịt dầu Lock&Lock 100ml kèm phểu và cọ rửa - CKO109",104000,174000,70000,40
TIKI,nha-cua-doi-song,147806385,"Đũa gắp thức ăn vặt DandiHome siêu nhẹ cho chơi game, làm việc văn phòng",13250,15000,1750,12
TIKI,nha-cua-doi-song,259514693,"Cây chà sàn nhà tắm Kitimop-Z1 chổi cọ sàn và gạt nước đa năng 2 trong 1, cán hợp kim nhôm tăng giảm chiều dài 65-125cm",145000,215000,70000,33
TIKI,nha-cua-doi-song,134853381,"Bình giữ nhiệt LocknLock Feather Light Ring LHC4244PIK 460ml - Màu",313000,601000,288000,48
TIKI,nha-cua-doi-song,162526068,"Đất trồng cây SOILMIX cho hoa hồng, cây cảnh, sen đá, rau sạch hữu cơ, bổ sung phân bón vi sinh, trichoderma, đá perlite",50000,50000,0,0
TIKI,nha-cua-doi-song,77775165,"Hộp Bảo Quản Thủy Tinh Lock&Lock LBG - Top Class (Nhiều Dung Tích)",102000,196000,94000,48
TIKI,nha-cua-doi-song,57945711,"Hộp đựng bàn chải kem đánh răng nhà tắm tặng kèm 4 cốc-Kệ để đồ vệ sinh răng miệng dán tường (màu ngẫu nhiên)",168850,168850,0,0
TIKI,nha-cua-doi-song,949687,"Kệ Đỡ Màn Hình Máy Tính Monitor Stand Plyconcept MSM01001 (490 x 200 mm) - Gỗ",250000,300000,50000,17
TIKI,nha-cua-doi-song,178783625,"Combo 2 Giá đỡ bàn chải máy dán tường NAVIVU",50000,50000,0,0
TIKI,nha-cua-doi-song,102488853,"Thùng Đựng Gạo Cao Cấp 5kg & 10kg - Thùng Đựng Gạo Nắp Đậy Thông Minh, Thiết Kế Hiện Đại & Đẹp Mắt, Chất Liệu ABS &PP An Toàn Chống Nước, Chống Ẩm Mốc, Mối Mọt - Hàng Nhập Khẩu",206000,343500,137500,40
TIKI,nha-cua-doi-song,206485076,"Hương nhang sạch Dương Minh nhang 20cm và 30cm 100% thành phần tự nhiên các loại nhang Cam Sả nhang Bồ Kết nhang Bắc nhang Thảo Mộc nhang Quế nhang Khuynh Diệp và Trầm Hương cao cấp",45000,55000,10000,18
TIKI,nha-cua-doi-song,52578184,"Tuýp Keo Dán Đồ Gia Dụng Siêu Dính, Keo Dán Kim Loại Cao Cấp",15000,15000,0,0
TIKI,nha-cua-doi-song,110894852,"Giấy Bạc Màng Nhôm MyJae Đài Loan Để Bảo Quản, Nướng Thức Ăn, Bọc Thực Phẩm 30cm x 14m",85000,119000,34000,29
TIKI,nha-cua-doi-song,57867023,"Cây Lau Nhà Xoay 360 Độ Sunhouse Ks-Mo350I",130000,200000,70000,35
TIKI,nha-cua-doi-song,12030860,"Áo Mưa kín người Không Xẻ Tà Vải Dù Hàng Cao Cấp Chống Thấm Cực Tốt, Áo Mưa Đi Xe Máy",85940,85940,0,0
TIKI,nha-cua-doi-song,185756969,"Cây lau kính đa năng Kitimop-3in1 có thiết kế thông minh gạt chùi kính 3 đầu trong 1, nhỏ gọn tiện lợi hiệu quả",39000,75000,36000,48
TIKI,nha-cua-doi-song,53518638,"2 Móc Dán Tường Giữ Dây Cắm Điện Phích Cắm Loại Trong Suốt",8950,8950,0,0
TIKI,nha-cua-doi-song,467912,"Máy Khoan Động Lực Bosch GSB 550 550W Set Và Bộ Dụng Cụ 100 Chi Tiết",1710000,2177000,467000,21
TIKI,nha-cua-doi-song,55900887,"Đèn Bàn Học Đọc Sách, Làm Việc (Học Sinh, Sinh Viên, Văn Phòng) LED Chống Cận, Cảm Ứng Nhôm Cao Cấp eLights",389000,449000,60000,13
TIKI,nha-cua-doi-song,82875291,"Bộ 2 thùng vải, hộp vải đựng đồ đa năng -Màu Nâu Kem + Tặng kèm dây cột tóc- Hộp vải đựng quần áo 2 size đựng quần áo, đồ lót, giày, văn phòng phẩm, đồ dùng cá nhân rất tiện lợi-Bộ 2 hộp vải đựng đồ vải canvas siêu xinh có nắp đậy, tủ vải đựng đồ hộp cái ",109000,141700,32700,23
TIKI,nha-cua-doi-song,19298165,"Áo Mưa Bộ Cho Bé Trai, Bé Gái ( số 1-5)",46000,46000,0,0
TIKI,nha-cua-doi-song,199728521,"Bộ lau nhà đa năng Space Saving Sunhouse KS-CL3211PW",310000,450000,140000,31
TIKI,nha-cua-doi-song,179370829,"GÓI 20 VIÊN KHĂN GIẤY NÉN HÀN QUỐC HÌNH VIÊN KẸO ĐA NĂNG",16999,16999,0,0
TIKI,nha-cua-doi-song,121602582,"Bình xịt chống thấm tường, Keo chống dột xịt chống thấm nhà, mái tôn, bể nước 720ml Waterproof",58000,63000,5000,8
TIKI,nha-cua-doi-song,114204740,"Bình giữ nhiệt inox 304 Sunhouse 900ml KS-TU900I",149000,225000,76000,34
TIKI,nha-cua-doi-song,14640240,"Cân Điện Tử Nhà Bếp 5kg - Cân Chia Thực Phẩm Nhà Bếp - Cân Tiểu Ly 5kg",90000,135000,45000,33
TIKI,nha-cua-doi-song,3927949,"Bộ sạc Energizer Charger kèm 4 pin Ener AA 2000mAh, tự ngắt sạc (CHVCM4)",447000,460000,13000,3
TIKI,nha-cua-doi-song,21101765,"Bàn Học Bàn Làm Việc Kết Hợp Kệ Sách Thương Hiệu IGEA",670000,729000,59000,8
TIKI,nha-cua-doi-song,55669191,"Đèn Pixar, Đèn Học Chống Cận Thị, Đèn Đọc Sách, Đèn Làm Việc Để Bàn Chống Chói Mắt Lóa Mắt Bảo Vệ Mắt - Hàng Chính Hãng",250000,250000,0,0
TIKI,nha-cua-doi-song,68716605,"Dao Làm Bếp Đa Năng Sunhouse KS-KN165KS",74000,117000,43000,37
TIKI,nha-cua-doi-song,13309367,"Ổ điện thông minh có 6 phích cắm 3 cổng USB (Giao Màu Ngẫu Nhiên)",44000,44000,0,0
TIKI,nha-cua-doi-song,144752155,"Khăn lau đa năng H600 Khăn lau tay bát đĩa nhà bếp vải mềm mịn thấm nước siêu nhanh tiện lợi an toàn",1700,1700,0,0
TIKI,nha-cua-doi-song,58002786,"Vòi bơm dây dẫn nước rửa chén gắn chậu rửa Hobby home decor NRC2 đầu bơm inox 304 có van 1 chiều gắn chai nước rửa chén",205000,279000,74000,27
TIKI,nha-cua-doi-song,35905855,"Cây Lau Nhà Pva Lock&Lock ETM481 - PP, 33 x 6 x 132 cm - Màu Trắng",280000,539000,259000,48
TIKI,nha-cua-doi-song,137671794," Cân Tiểu Ly Nhà Bếp Chống Nước Cao Cấp Khoảng Chính Xác 1g - 5kg ",165000,295000,130000,44
TIKI,nha-cua-doi-song,48510374,"Combo 300 Túi Lọc Rác Siêu Tiện dụng cho Bồn rửa Chén bát",129000,200000,71000,36
TIKI,nha-cua-doi-song,195852183,"Bình giữ nhiệt bằng thép không gỉ LocknLock Jumbo Tumbler LHC4300NVY 900ML",438000,730000,292000,40
TIKI,nha-cua-doi-song,71999229,"Nồi Inox 3 Lớp Đáy Liền Elmich Trimax Classic 2408OL",700000,990000,290000,29
TIKI,nha-cua-doi-song,210760574,"Cây lau nhà tự vắt thông minh sợi microfiber",209000,209000,0,0
TIKI,nha-cua-doi-song,696495,"Ổ Cắm Điện 4 Lỗ 3 Chấu 3m Philips SPN1348WB/74 (2500W)",328000,369000,41000,11
TIKI,nha-cua-doi-song,56880195,"Bình nước Lock&Lock Eco Bottle ABF664BLU 750ml - Màu",145000,242000,97000,40
TIKI,nha-cua-doi-song,52885368,"1 Kg túi zip chỉ đỏ thương hiệu Gimex II",69000,69000,0,0
TIKI,nha-cua-doi-song,69929041,"Móc Treo Quần Áo, Móc Phơi Đồ Trẻ Em Inox Kẹp Chống Rơi, Móc Treo Tất, Vớ, Đồ Lót Nhiều Kiểu Dáng",35000,35000,0,0
TIKI,nha-cua-doi-song,578967,"Chảo Đá Chống Dính Siêu Bền Sunhouse SBD28 28cm",273000,430000,157000,37
TIKI,nha-cua-doi-song,54130086,"Cây lau nhà tự vắt thông minh đa năng cao cấp Parroti Magic MG01 - Tặng 1 Miếng Lau",229000,349000,120000,34
TIKI,nha-cua-doi-song,55365176,"0.5kg túi zipper chỉ đỏ đựng thực phẩm",39000,39000,0,0
TIKI,nha-cua-doi-song,54686184,"Bạt Áo Trùm Máy Giặt Cửa Trên, Cửa Ngang Vải Dù Siêu Dày, Chống Thấm Nước, Không Phai Màu - (Giao Màu - Họa Tiết Ngẫu Nhiên)",99999,99999,0,0
TIKI,nha-cua-doi-song,3677799,"Hộp 6 Lõi  Lọc Nước BRITA Maxtra Plus Filter Cartridge",1849000,1849000,0,0
TIKI,nha-cua-doi-song,51476716,"Bộ 10 đôi đũa inox 304 - 316 DandiHome 2020 chống trơn trượt, sang trọng, tinh tế",300000,300000,0,0
TIKI,nha-cua-doi-song,71111080,"Kệ Để Giày Dép Inox 5 Tầng Chính Hãng Amalife, Giá Để Giày Inox 5 Tầng - Chọn Màu",99000,99000,0,0
TIKI,nha-cua-doi-song,35058677,"Vỉ 5 Viên Pin CR1632 ( CR 1632/5BE x 1 Vỉ ) Panasonic Lithium 3 V - Hàng Chính Hãng",87000,100000,13000,13
TIKI,nha-cua-doi-song,45300792,"Đồng hồ báo thức điện tử để bàn màn hình đa chức năng thời gian, lịch, báo thức, nhiệt độ DH89",50900,50900,0,0
TIKI,nha-cua-doi-song,85029598,"Ổ cắm Điện Quang ĐQ 002A-02 (3 lỗ)",95000,95000,0,0
TIKI,nha-cua-doi-song,87873126,"Áo Mưa Bộ Vải Dù, Bộ Quần Áo Mưa Có Phản Quang Đủ Size, Chống Thấm Hiệu Quả, Phù Hợp Nam Và Nữ, Có Túi Đựng, Có Lựa Chọn Màu Sắc",150000,150000,0,0
TIKI,nha-cua-doi-song,7114709,"Đèn Pin Đội Đầu Sunhouse Cỡ Nhỏ She 5012",62000,99000,37000,37
TIKI,nha-cua-doi-song,51554889,"Ron Dán Che Khe Cửa ,Chân Cửa Chống Gió Lùa, Chống Bụi Và Chống Côn Trùng - Hàng Chính Hãng Cuộn 2m",40000,52000,12000,23
TIKI,nha-cua-doi-song,51662145,"Keo dán siêu dính X2000 (50g) dán gỗ, sắt, sứ, kim loại đa năng",18000,46900,28900,62
TIKI,nha-cua-doi-song,155794592,"Kệ lò vi sóng đa năng Thép Carbon cao cấp Vando, kệ để đồ nhà bếp siêu chịu lực 300kg sơn tĩnh điện chống bong tróc, kệ nhà bếp",899000,1427000,528000,37
TIKI,nha-cua-doi-song,19719366,"Võng dù 2 lớp BAN MAI, gọn nhẹ 230x145 cm, nặng 600gr (Giao màu ngẫu nhiên)",129000,150000,21000,14
TIKI,nha-cua-doi-song,58828647,"Xe đẩy hàng 4 bánh SUMIKA T150 - Khung thép, tay cầm gấp mở tiện lợi, tải trọng 150kg",880000,1350000,470000,35
TIKI,nha-cua-doi-song,161225352,"Miếng dán đỡ kệ gỗ, chia ngăn tủ, không cần đóng đinh",22000,22000,0,0
TIKI,nha-cua-doi-song,109654810,"Bình xịt tưới cây MONROVIA 2 lít, phun sương tưới cây cảnh, vòi dài, tặng vòi ngắn, màu xanh, tiêu chuẩn Châu Âu",169000,169000,0,0
TIKI,nha-cua-doi-song,114789036,"Vòi Dẫn Nước Rửa Chén Bộ Đầu Vòi Dẫn Bơm Hút Xịt Nước Rửa Chén Dầu Rửa Bát Gắn Bồn Rửa Bát",59596,59596,0,0
TIKI,nha-cua-doi-song,193433927,"Đèn Bàn Học Led Đọc Sách Làm Việc Học Tập Bảo Vệ Mắt Chống Cận - 2 Trục Đèn Chiếu Sáng - Gấp Gọn Tiện Lợi",569000,699000,130000,19
TIKI,nha-cua-doi-song,217714140,"Móc Dán Tường INOX 304 Treo Đồ nặng, Treo Thớt, Nồi Niêu Treo Đồ Đa Năng [CHỐNG NƯỚC, CHỐNG RỈ] Dán Mọi Bề Mặt",15000,15000,0,0
TIKI,nha-cua-doi-song,41430891,"Ổ Khóa 4 Số Có Đổi Mã Chữ U ZR-01",68000,96000,28000,29
TIKI,nha-cua-doi-song,208413993,"Bàn Làm Việc Phong Cách Bắc Âu Thương Hiệu IGEA (Không Bao Gồm Ghế)",275500,290000,14500,5
TIKI,nha-cua-doi-song,48055150,"Thảm Lau Chân Chống Trượt Siêu Thấm 40x60cm",93000,186000,93000,50
TIKI,nha-cua-doi-song,141246639,"Hộp giữ nhiệt đựng đồ ăn có tay cầm Handle Food Jar LocknLock 700ml LHC8042NVY - Màu",416000,800000,384000,48
TIKI,nha-cua-doi-song,134582052,"ĐỆM TRẢI SÀN, NỆM, TOPPER HÀNG XUẤT NHẬT",242000,269900,27900,10
TIKI,nha-cua-doi-song,178068438,"Khăn giấy cuộn đa năng, lau bếp, lau kính, chén bát, lau tay (50 khăn/cuộn, 25cm x25cm) - Parroti Bingo NG01",38900,78000,39100,50
TIKI,nha-sach-tiki,1471887,"Tớ Muốn Ăn Tụy Của Cậu",72000,96000,24000,25
TIKI,nha-sach-tiki,179546074,"Luật Hấp Dẫn - Quy Luật Về Sự Thịnh Vượng Và Thành Công",85900,129000,43100,33
TIKI,nha-sach-tiki,40774181,"Combo Sách Tiếng hàn tổng hợp dành cho người Việt Nam - Sơ cấp 1 (Phiên bản 1 màu)",163800,234000,70200,30
TIKI,nha-sach-tiki,197781971,"Chòm Sao Linh Thú Tập 9",39100,40000,900,2
TIKI,nha-sach-tiki,50322710,"48 Nguyên Tắc Chủ Chốt Của Quyền Lực (Tái Bản 2020)",119000,200000,81000,41
TIKI,nha-sach-tiki,44627532,"Cẩm Nang Hướng Dẫn Thải Độc & Chế Độ Ăn Uống Lành Mạnh",98500,145000,46500,32
TIKI,nha-sach-tiki,75615273,"Combo 3 Cuốn Sách Ehon: Buồn Ngủ Ơi Là Buồn Ngủ (Dành Cho Trẻ Từ 0 - 4 Tuổi)",75700,117000,41300,35
TIKI,nha-sach-tiki,273633981,"[ Trạm Đọc Official ] Sách: Tâm Lý Học Thành Công (Tái Bản)",149000,199000,50000,25
TIKI,nha-sach-tiki,191320058,"Set 6 Chiếc Bút Highlight Hai Đầu Bút Nhớ Dòng Đánh Dấu Dạ Quang Take Note Ghi Chú Deli - Bảng Màu Pastel Macaron - 33002 S605 S735 S134",29000,57600,28600,50
TIKI,nha-sach-tiki,193211309,"Chuông Gió (Tập 2)",125000,174000,49000,28
TIKI,nha-sach-tiki,176550203,"Cuộc Đời Ngắn Lắm Đừng Ôm Muộn Phiền",62900,88000,25100,29
TIKI,nha-sach-tiki,109633951,"Combo 8 cuốn: Tô màu Nối số Thông minh",49920,96000,46080,48
TIKI,nha-sach-tiki,147920907,"Combo Bộ 6 Cuốn: Thư Viện Song Ngữ Đầu Tiên Cho Bé (0-3 Tuổi)",80500,108000,27500,25
TIKI,nha-sach-tiki,545278,"Combo Sherlock Holmes Toàn Tập (Trọn Bộ 3 Tập)",156000,300000,144000,48
TIKI,nha-sach-tiki,10767515,"Phân Tâm Học Nhập Môn",118000,159000,41000,26
TIKI,nha-sach-tiki,76105910,"5 Ngôn Ngữ Yêu Thương - The Five Love Languages (Tái Bản)",89100,128000,38900,30
TIKI,nha-sach-tiki,195980676,"Phượng Hoàng Tái Sinh - 12 Phẩm Chất Quan Trọng Để Bứt Phá Sự Nghiệp Và Cuộc Sống",109440,152000,42560,28
TIKI,nha-sach-tiki,4255933,"Plato Và Con Thú Mỏ Vịt Bước Vào Quán Bar (Tái Bản 2018 )",74500,100000,25500,26
TIKI,nha-sach-tiki,38223395,"Tâm Lý Học Hài Hước (Tái Bản)",63600,89000,25400,29
TIKI,nha-sach-tiki,10397241,"Sách Chữa Lành Nỗi Đau",68100,98000,29900,31
TIKI,nha-sach-tiki,36854641,"Sự Thật Về Thế Giới : Mười Lý Do Khiến Ta Hiểu Sai Về Thế Giới - Và Vì Sao Thế Gian Này Tốt Hơn Ta Tưởng",88200,160000,71800,45
TIKI,nha-sach-tiki,552393,"Hiểu Về Trái Tim",142000,158000,16000,10
TIKI,nha-sach-tiki,106693398,"Combo 4 cuốn: Luyện viết (Theo chương trình mới - Bé vào lớp 1)",37440,72000,34560,48
TIKI,nha-sach-tiki,189350061,"Giá Mà Nỗi Buồn Có Thể Cầm Nắm Trên Tay - Tặng kèm 03 postcard",78000,109000,31000,28
TIKI,nha-sach-tiki,184475053,"Sa Vào Ánh Hào Quang Của Người – Tập 1",108000,132000,24000,18
TIKI,nha-sach-tiki,196849396,"Gửi Em, Người Bất Tử - Tập 3 (Tái Bản 2022)",29500,30000,500,2
TIKI,nha-sach-tiki,196849393,"Gửi Em, Người Bất Tử - Tập 4 (Tái Bản 2022)",21000,30000,9000,30
TIKI,nha-sach-tiki,196849400,"Gửi Em, Người Bất Tử - Tập 5 (Tái Bản 2022)",21400,30000,8600,29
TIKI,nha-sach-tiki,74460137,"Sách Bí Quyết Áp Dụng 7 Thói Quen Của Bạn Trẻ Thành Đạt (Khổ Nhỏ) (Tái Bản 2020)",75100,108000,32900,30
TIKI,nha-sach-tiki,5067167,"Tôi Là Ai - Và Nếu Vậy Thì Bao Nhiêu? (Tái Bản 2018)",92700,126000,33300,26
TIKI,nha-sach-tiki,76013370,"Được Học - Educated (Tái Bản)",136000,182000,46000,25
TIKI,nha-sach-tiki,192124393,"Ikigami - Tập 06",43100,45000,1900,4
TIKI,nha-sach-tiki,10920495,"Dế Mèn Phiêu Lưu Ký",104000,150000,46000,31
TIKI,nha-sach-tiki,176906754,"Inspired - Kiến Tạo Sản Phẩm Công Nghệ Chiếm Trọn Trái Tim Người Dùng",228000,295000,67000,23
TIKI,nha-sach-tiki,187622581,"Sách Sức Mạnh Của Sự Trầm Lắng",99840,128000,28160,22
TIKI,nha-sach-tiki,104651900,"Sách Seneca: Những Bức Thư Đạo Đức – Chủ nghĩa Khắc kỷ trong đời sống - Tập 1",149000,159000,10000,6
TIKI,nha-sach-tiki,95218547,"Đọc Vị Mọi Vấn Đề Của Trẻ - Giải Mã Mọi Vấn Đề Về Nuôi Con Nhỏ: Ăn - Ngủ - Kỷ Luật Hành Vi (Tái Bản)",133000,199000,66000,33
TIKI,nha-sach-tiki,103471709,"Full bộ (10 quyển) Truyện cổ tích Việt Nam (Song ngữ Việt - Anh) (giao ngẫu nhiên)",62400,120000,57600,48
TIKI,nha-sach-tiki,75338644,"Bảng viết, bảng vẽ cảm ứng điện tử thông minh tự động xóa cho bé - Hàng Chính Hãng VinBuy",65000,120000,55000,46
TIKI,nha-sach-tiki,140360872,"Để Xây Dựng Doanh Nghiệp Hiệu Quả (Tái Bản)",92620,139000,46380,33
TIKI,nha-sach-tiki,152875147,"Miền Đất Hứa (A Promised Land) - Barack Obama (Bìa Cứng)",179000,768000,589000,77
TIKI,nha-sach-tiki,95997783,"Sách Luyện thi B1 Vstep 4 kỹ năng - Ôn thi chứng chỉ tiếng Anh B1 bậc 3 (bằng B1 tiếng Anh) theo Khung NLNN Việt Nam",300000,300000,0,0
TIKI,nha-sach-tiki,171825201,"Người Bà Tài Giỏi Vùng Saga – Tập 7",41600,52000,10400,20
TIKI,nha-sach-tiki,13446508,"Cánh Đồng Bất Tận (Tái Bản 2019)",65000,85000,20000,24
TIKI,nha-sach-tiki,185888686,"Trường An Ly Ca 3 – Cao Sơn Lưu Thuỷ",134000,170000,36000,21
TIKI,nha-sach-tiki,55119955,"Cách Sống (Tái Bản 2020)",58500,85000,26500,31
TIKI,nha-sach-tiki,54383647,"Fullmetal Alchemist - Cang Giả Kim Thuật Sư - Fullmetal Edition Tập 4",64100,69000,4900,7
TIKI,nha-sach-tiki,165150439,"TalMud - Tinh Hoa Trí Tuệ Do Thái (Tái Bản)",73000,110000,37000,34
TIKI,nha-sach-tiki,189326210,"Nghệ thuật tư duy dựa trên dữ liệu - Để ra quyết điịnh thông minh hơn trong một thê giới không chắc chắn",85000,150000,65000,43
TIKI,nha-sach-tiki,160375101,"Ngữ pháp luyện thi IELTS - Grammar for ielts",88000,88000,0,0
TIKI,nha-sach-tiki,87226754,"Một Cuốn Sách Buồn… Cười - Vui Vẻ Không Quạu Nha 2",52000,79000,27000,34
TIKI,nha-sach-tiki,76014598,"Blue Ocean Strategy - Chiến Lược Đại Dương Xanh (Bìa Cứng) (Tái Bản)",150600,239000,88400,37
TIKI,nha-sach-tiki,75630595,"The Design Thinking Playbook- Thực Hành Tư Duy Thiết Kế",185400,299000,113600,38
TIKI,nha-sach-tiki,195190272,"Nhất Quỷ Nhì Ma, Thứ Ba Takagi  - Tập 15",29000,30000,1000,3
TIKI,nha-sach-tiki,52329765,"Biên Niên Ký Chim Vặn Dây Cót (Tái Bản 2020)",137000,199000,62000,31
TIKI,nha-sach-tiki,53452969,"Khởi Nghiệp Du Kích - Kinh Doanh Ít Vốn - Vận Dụng Nguồn Lực Nhỏ Chiến Thắng Cuộc Chơi Lớn (Tái Bản)",155000,199000,44000,22
TIKI,nha-sach-tiki,9695881,"Nghệ Thuật đầu tư Dhandho - The Dhandho Investor",238000,238000,0,0
TIKI,nha-sach-tiki,101782486,"Làm Ra Làm, Chơi Ra Chơi (Tái Bản)",104200,159000,54800,34
TIKI,nha-sach-tiki,148750882,"Khi Mọi Thứ Sụp Đổ - Lời Khuyên Chân Thành Trong Những Thời Điểm Khó Khăn",82800,119000,36200,30
TIKI,nha-sach-tiki,73102465,"Bé Tô màu - Combo 11 cuốn",64900,127255,62355,49
TIKI,nha-sach-tiki,20520720,"Đối Thoại Với Thượng Đế ( Tái Bản )",73000,98000,25000,26
TIKI,nha-sach-tiki,121185870,"Và Rồi Núi Vọng",109000,148000,39000,26
TIKI,nha-sach-tiki,4080373,"90% Trẻ Thông Minh Nhờ Cách Trò Chuyện Đúng Đắn Của Cha Mẹ",31000,39000,8000,21
TIKI,nha-sach-tiki,10678954,"Full bộ Ehon Nhật Bản cho bé 0-6 tuổi thông minh, sáng tạo",271000,390000,119000,31
TIKI,nha-sach-tiki,196849409,"Gửi Em, Người Bất Tử - Tập 11 (Tái Bản 2022)",28900,30000,1100,4
TIKI,nha-sach-tiki,196849406,"Gửi Em, Người Bất Tử - Tập 9 (Tái Bản 2022)",21300,30000,8700,29
TIKI,nha-sach-tiki,177637709,"Làm Chủ Bình Minh - Sống Đời Xuất Chúng - CLB 5 Giờ Sáng (Robin Sharma)",109000,185000,76000,41
TIKI,nha-sach-tiki,186271356,"Từ điển xây kênh từ cơ bản đến thành công",268000,268000,0,0
TIKI,nha-sach-tiki,196849403,"Gửi Em, Người Bất Tử - Tập 8 (Tái Bản 2022)",21400,30000,8600,29
TIKI,nha-sach-tiki,167301575,"Khí Chất Bao Nhiêu Hạnh Phúc Bấy Nhiêu (Tái Bản 2022)",103000,139000,36000,26
TIKI,nha-sach-tiki,74285820,"Cơ Thể Tự Chữa Lành: Nước Ép Cần Tây",96000,148000,52000,35
TIKI,nha-sach-tiki,195357774,"Máy Tính CASIO FX-880BTG - Màu Xanh Biển",708000,800000,92000,12
TIKI,nha-sach-tiki,196849389,"Gửi Em, Người Bất Tử - Tập 10 (Tái Bản 2022)",28900,30000,1100,4
TIKI,nha-sach-tiki,124767712,"Không Tự Khinh Bỉ - Không Tự Phí Hoài (Tái Bản)",85200,119000,33800,28
TIKI,nha-sach-tiki,37411897,"Sách Đen - Bộ Công Cụ Của Phụ Nữ Thành Đạt",55600,79000,23400,30
TIKI,nha-sach-tiki,113656455,"Giáo Trình Tư Tưởng Hồ Chí Minh (Dành Cho Bậc Đại Học Hệ Không Chuyên Lý Luận Chính Trị) - Bộ mới năm 2021",55000,55000,0,0
TIKI,nha-sach-tiki,73316970,"Osho - Ươm Mầm",75800,109000,33200,30
TIKI,nha-sach-tiki,63187280,"Combo 2 Cuốn: Cơ Thể Tự Chữa Lành",222000,345000,123000,36
TIKI,nha-sach-tiki,32415084,"Combo 2 cuốn Giáo Trình Hán Ngữ (Sách học Tiếng Trung dành cho người Việt): Giáo Trình Hán Ngữ Tập 1 + Giáo Trình Hán Ngữ Tập 2 (Học bằng App McBooks) - Tặng kèm bookmark GreenLife",170800,244000,73200,30
TIKI,nha-sach-tiki,73207098,"Làm Chủ - Mastery",128000,200000,72000,36
TIKI,nha-sach-tiki,100384412,"Vô Cùng Tàn Nhẫn Vô Cùng Yêu Thương (Tái Bản)",109620,189000,79380,42
TIKI,nha-sach-tiki,59078520,"Các phương pháp giao dịch ngắn hạn hiệu quả trên thị trường Forex – Day Trading and Swing Trading the Currency Market",299000,299000,0,0
TIKI,nha-sach-tiki,196150482,"Người nuôi ong thành Aleppo - The beekeeper of Aleppo (Aspen Words Literary Prize Winner)",108000,168000,60000,36
TIKI,nha-sach-tiki,193917227,"Mỹ Vị Hầm Ngục - 3 - Bản Đặc Biệt - Tặng Kèm Bìa 2 Mặt, Bộ Đôi Card Chiến Binh & Ẩm Thực",45000,70000,25000,36
TIKI,nha-sach-tiki,188534368,"Khúc Ngẫu Hứng Trước Ga Mahoro",135000,180000,45000,25
TIKI,nha-sach-tiki,109322300,"Combo 8 cuốn Ehon Kỹ năng sống: Bon và Gia đình, Bạn bè",120640,232000,111360,48
TIKI,nha-sach-tiki,116397449,"Người Tình Sputnik",64000,86000,22000,26
TIKI,nha-sach-tiki,22878271,"Essential Grammar in Use Book with Answers Edition: A Self-Study Reference and Practice Book for Elementary Learners of English",165540,178000,12460,7
TIKI,nha-sach-tiki,88791130,"Gôm Tẩy 2B Deli, 40×22×12Mm, Đen - 1 Viên - E3043",7200,7200,0,0
TIKI,nha-sach-tiki,139979524,"Thiền - Osho (Tái Bản)",102000,149000,47000,32
TIKI,nha-sach-tiki,95289208,"Người Bà Tài Giỏi Vùng Saga",83000,128000,45000,35
TIKI,nha-sach-tiki,54422996,"Nóng Giận Là Bản Năng, Tĩnh Lặng Là Bản Lĩnh (Tái Bản 2020)",66800,89000,22200,25
TIKI,nha-sach-tiki,95090643,"Bút màu marker chuyên nghiệp Deli -kèm túi vải - 30/40/60/80 Màu - 70806",232200,232200,0,0
TIKI,nha-sach-tiki,3640421,"Đắc Nhân Tâm - Bản Dịch Gốc Từ Nguyễn Hiến Lê (Tặng Kèm Audio Book)",56100,90000,33900,38
TIKI,nha-sach-tiki,2716247,"Quẳng Gánh Lo Đi Và Vui Sống (Bìa Cứng)",77300,108000,30700,28
TIKI,nha-sach-tiki,186290802,"Bàn Có Năm Chỗ Ngồi (Tái Bản 2022)",25600,38000,12400,33
TIKI,nha-sach-tiki,185188826,"Fryderyk Chopin: Cuộc Đời Và Thời Đại ",374000,499000,125000,25
TIKI,nha-sach-tiki,145300494,"The Mastery Of Self - Hành Trình Thấu Hiểu Bản Thân Và Tìm Thấy Tự Do",119000,180000,61000,34
TIKI,nha-sach-tiki,197634255,"Anh em phi hành gia - Tập 34",32000,45000,13000,29
TIKI,nha-sach-tiki,1565657,"Dốc Hết Trái Tim - Cách Starbucks Xây Dựng Công Ty Bằng Từng Tách Cà Phê (Tái Bản 2018)",99000,150000,51000,34
TIKI,nha-sach-tiki,184801142,"Cutie Pie – Em Ngoan, Lại Cho Là Em Ngốc - Bản thường (tặng kèm 1 bookmark in bồi 2 mặt)",145000,189000,44000,23
TIKI,nha-sach-tiki,77900446,"Thần Số Học: Thấu Hiểu Nhân Tâm",75800,109000,33200,30
TIKI,nha-sach-tiki,12107394,"Barron's Essential Words For The Toeic (Tái Bản)",166000,238000,72000,30
TIKI,nha-sach-tiki,196849394,"Gửi Em, Người Bất Tử - Tập 6 (Tái Bản 2022)",21000,30000,9000,30
TIKI,nha-sach-tiki,91444567,"Sống Cuộc Đời Bạn Muốn",180000,220000,40000,18
TIKI,nha-sach-tiki,198016673,"Vua Sáng Chế - Tập 18",20000,20000,0,0
TIKI,nha-sach-tiki,2812299,"Tiếng Nhật Cho Mọi Người - Sơ Cấp 1 - Bản Dịch Và Giải Thích Ngữ Pháp - Tiếng Việt (Bản Mới)",65000,100000,35000,35
TIKI,nha-sach-tiki,136340700,"Trên Lưng Khổng Tượng - Kinh Doanh Online Trên Sàn Thương Mại Điện Tử - Khởi Nghiệp Với Bán Hàng Qua Mạng và Nhãn Hàng Riêng",155000,199000,44000,22
TIKI,nha-sach-tiki,196849405,"Gửi Em, Người Bất Tử - Tập 7 (Tái Bản 2022)",21000,30000,9000,30
TIKI,nha-sach-tiki,57350380,"Very Easy Toeic 1 - Introduction",159000,228000,69000,30
TIKI,nha-sach-tiki,19349145,"Bí Mật Tư Duy Triệu Phú (Tái Bản 2019)",86000,108000,22000,20
TIKI,nha-sach-tiki,129672282,"Từ vựng luyện thi IELTS - Vocabulary for Ielts with answers",56000,90000,34000,38
TIKI,nha-sach-tiki,131401030,"Ayurveda",240000,240000,0,0
TIKI,nha-sach-tiki,190701644,"Dám Mơ Lớn, Đừng Hoài Phí Tuổi Trẻ (Tái Bản) -Tặng kèm 1 bookmark 2 mặt",82100,119000,36900,31
TIKI,nha-sach-tiki,192475873,"Để Con Được Ốm",90100,120000,29900,25
TIKI,nha-sach-tiki,184236581,"Năng Lực Của Sự Ngu Ngốc",168000,225000,57000,25
TIKI,nha-sach-tiki,274175495,"Tĩnh Lặng",49200,69000,19800,29
TIKI,nha-sach-tiki,186088879,"Beyond Order - Vượt Lên Trật Tự",257000,350000,93000,27
TIKI,nha-sach-tiki,73105037,"Combo 9 cuốn Tập tô - Tập viết chữ - Làm quen chữ cái/chữ số (Chuẩn bị vào lớp 1)",56160,108000,51840,48
TIKI,nha-sach-tiki,57815506,"Sách Tư Duy Ngược Dịch Chuyển Thế Giới",124000,178000,54000,30
TIKI,nha-sach-tiki,73139676,"Full bộ (20 quyển) Truyện kể Mầm non - Cổ tích - Ngụ ngôn Aesop (giao ngẫu nhiên)",107781,207271,99490,48
TIKI,nha-sach-tiki,167210783,"Trường An Ly Ca 1 – Máu Đỏ Hoa Đào",135000,175000,40000,23
TIKI,nha-sach-tiki,100958526,"Nhân Tố Enzyme - Thực Hành (Tái Bản 2021)",73000,109000,36000,33
TIKI,nha-sach-tiki,155115301,"Bộ "Chuyện xóm gà" 2",276000,348000,72000,21
TIKI,nha-sach-tiki,76541999,"Tăng tốc luyện đề thi Đánh giá năng lực (theo cấu trúc đề thi của Đại học Quốc gia TP. Hồ Chí Minh)",157000,225000,68000,30
TIKI,nha-sach-tiki,69219921,"OKRs - Hiểu Đúng, Làm Đúng - Cách Để Áp Dụng Thành Công OKRs Ngay Từ Đầu",150600,239000,88400,37
TIKI,nha-sach-tiki,192339426,"Không Ai Sống Giống Ai Trong Cuộc Đời Này",112000,145000,33000,23
TIKI,nha-sach-tiki,190464440,"Ikigami - Tập 05",32000,45000,13000,29
TIKI,nha-sach-tiki,111285050,"Ai Lấy Miếng Pho Mát Của Tôi ? (Tái Bản)",47100,68000,20900,31
TIKI,nha-sach-tiki,181379116,"Hackers Toeic Vocabulary (Tái Bản)",173800,279000,105200,38
TIKI,nha-sach-tiki,3048355,"Nhà (Tái Bản)",70400,109000,38600,35
TIKI,nha-sach-tiki,92492870,"Combo 6 Cuốn Ehon Nhật Bản : Ai Ở Sau Lưng Bạn Thế (Tái Bản)",161000,234000,73000,31
TIKI,nha-sach-tiki,191801175,"Nhịn Khô",98500,139000,40500,29
TIKI,nha-sach-tiki,196517619,"Thiếu Nữ (Shoujo)",97500,150000,52500,35
TIKI,nha-sach-tiki,53301006,"Sách Ping - Vượt Ao Tù Ra Biển Lớn (Tái Bản 2020)",64100,98000,33900,35
TIKI,nha-sach-tiki,11357193,"Những Cuộc Phiêu Lưu Của Huckleberry Finn",63000,98000,35000,36
TIKI,nha-sach-tiki,22634335,"Kỹ Năng Quản Lý Nhân Sự Chuyên Nghiệp",82800,119000,36200,30
TIKI,nha-sach-tiki,186211127,"Khởi Nghiệp Kinh Doanh Online - Bán Hàng Hiệu Quả Trên Shopee",151000,199000,48000,24
TIKI,nha-sach-tiki,9687409,"Thôi Miên Bằng Ngôn Từ",121580,169000,47420,28
TIKI,nha-sach-tiki,8835165,"Ông Trăm Tuổi Trèo Qua Cửa Sổ Và Biến Mất (Tái Bản)",125000,190000,65000,34
TIKI,nha-sach-tiki,190242074,"Chuông Gió (Tập 1) - Tặng kèm 1 bookmark",123000,174000,51000,29
TIKI,nha-sach-tiki,197602047,"Fullmetal Alchemist - Cang Giả Kim Thuật Sư - Fullmetal Edition Tập 9",61400,69000,7600,11
TIKI,nha-sach-tiki,135754581,"Những Câu Chuyện Truyền Cảm Hứng - I Will Be Better: Nguồn Năng Lượng Tích Cực",43000,58000,15000,26
TIKI,nha-sach-tiki,113583126,"Ngữ Pháp Tiếng Anh (Tái Bản)",57400,89000,31600,36
TIKI,nha-sach-tiki,186434701,"Khi Bạn Đang Say Giấc, Ai Đó Đã Đạt Được Ước Mơ-Tặng kèm 01 bookmark",76100,108000,31900,30
TIKI,nha-sach-tiki,107342987,"Bút bi nước khô nhanh Deli - 0.5mm - Bút viết thư pháp - Ống bút liền mực - Mực Xanh - 1 chiếc - S856",12600,12600,0,0
TIKI,nha-sach-tiki,193605374,"Làm Sao Để Che Giấu Một Đế Quốc - How To Hide An Empire",222000,299000,77000,26
TIKI,nha-sach-tiki,76401055,"Sét Bong Bóng Trang Trí Sinh Nhật FUNU Nhiều Mẫu Kèm Bơm Tay- Hàng Chính Hãng",116850,123000,6150,5
TIKI,nha-sach-tiki,188940825,"Những Chàng Trai Ở Lộc Phong Quán – Tập 10 - Tặng 1 bookmark 2 mặt ",38100,48000,9900,21
TIKI,nha-sach-tiki,58390336,"Python cơ bản",125000,125000,0,0
TIKI,nha-sach-tiki,68392386,"Stephen Hawking - Trả Lời Ngắn Gọn Những Câu Hỏi Lớn",55800,90000,34200,38
TIKI,nha-sach-tiki,45349383,"Hashtag No.2 Fashion - Kinh Doanh Thời Trang Tại Thị Trường Việt Nam",153000,200000,47000,24
TIKI,nha-sach-tiki,8886005,"Bay Trên Tổ Chim Cúc Cu (Tái Bản)",91500,118000,26500,22
TIKI,nha-sach-tiki,193981038,"Vua sáng chế - Tập 15",20000,20000,0,0
TIKI,nha-sach-tiki,90227346,"Sapiens: Lược Sử Loài Người Bằng Tranh - Tập 1: Khởi Đầu Của Loài Người",212100,345000,132900,39
TIKI,nha-sach-tiki,171170802,"Kỹ thuật giao dịch nâng cao để kiếm tiền hàng ngày trên thị trường chứng khoán – Advanced Techniques in Day Trading",359000,359000,0,0
TIKI,nha-sach-tiki,189657596,"Komi - Nữ Thần Sợ Giao Tiếp Tập 11",25000,25000,0,0
TIKI,nha-sach-tiki,2380007,"Khi Bạn Đang Mơ Thì Người Khác Đang Nỗ Lực",108800,136000,27200,20
TIKI,nha-sach-tiki,186434891,"Cá Cược Với Tình Yêu",95000,95000,0,0
TIKI,nha-sach-tiki,188487640,"Dragon Ball Full Color - Phần Năm: Truy Lùng Cell Bọ Hung  - Tập 2 [Tặng Ngẫu Nhiên 1 Trong 2 Mẫu Postcard Nhân Vật]",68100,77000,8900,12
TIKI,nha-cua-doi-song,11203853,"Bộ 10 đinh treo tranh, mắc màn loại 4 chân",13992,13992,0,0
TIKI,nha-cua-doi-song,110756858,"Set 200 Găng Tay Nilon Trong Suốt Sử Dụng Một Lần Tiện Lợi ",18394,18394,0,0
TIKI,nha-cua-doi-song,41886085,"Túi Đựng Ly Giữ Nhiệt Lớn 900ml - Nhiều Hoa Văn",40000,40000,0,0
TIKI,nha-cua-doi-song,54122078,"Pin AAAA Energizer E96 BP2",67000,80000,13000,16
TIKI,nha-cua-doi-song,63133571,"Mền lông cừu xanh dương đậm cao cấp A - 1m8x2m",165000,180000,15000,8
TIKI,nha-cua-doi-song,22081865,"TÚI ÁO BÌNH GIỮ NHIỆT TIỆN LỢI",40000,40000,0,0
TIKI,nha-cua-doi-song,16166750,"ÁO MƯA BIT CƠ BẢN",85000,85000,0,0
TIKI,nha-cua-doi-song,1453915,"Ly Giữ Nhiệt Bằng Thép Không Gỉ Lock&Lock Clip Tumbler LHC4151BLK (540ml) - Đen",304000,506000,202000,40
TIKI,nha-cua-doi-song,153291977,"Băng Keo Chống Thấm, Chống Dột Dán Siêu Dính Trên Mọi Bề Mặt, Dán Mái Tôn, Dán Tường, Dán Ống Nước - PucaMart",13000,18999,5999,32
TIKI,nha-cua-doi-song,54485029,"Đèn Bàn Học Đọc Sách LED Chống Cận 03 Chế Độ Ánh Sáng Bảo Vệ Mắt Có Hộp Bút Và Giá Để Điện Thoại eLights",179000,220000,41000,19
TIKI,nha-cua-doi-song,51105287,"Bộ 4 ống hút Inox 304 kèm cọ rửa DandiHome",33000,39000,6000,15
TIKI,nha-cua-doi-song,3677797,"Hộp 3 Lõi Lọc Nước BRITA Maxtra Plus Filter Cartridge",599000,949000,350000,37
TIKI,nha-cua-doi-song,76046302,"Móc treo quần áo gắn sau cánh cửa tử HOBBY MTGC Nice Day 6 chấu - 2 màu tùy chọn",28000,79000,51000,65
TIKI,nha-cua-doi-song,146887829,"Đèn Pixar, Đèn Bàn Học Chống Cận Thị, Đèn Đọc Sách LED, Đèn Làm Việc Bảo Vệ Mắt, đèn học để bàn, đèn học cho học sinh sinh viên, đèn trang trí decor - Hàng Chính Hãng dododios",148000,148000,0,0
TIKI,nha-cua-doi-song,86376338,"Đèn ngủ Oval cắm điện 10 cấp độ sáng có remote - đèn ngủ thông minh - hẹn giờ - 2 cổng USB sạc nhanh mới 2021",99000,99000,0,0
TIKI,nha-cua-doi-song,55875210,"Tủ Vải Đựng Đồ Khung Thép Chịu Lực, Túi Đựng Chăn Màn Quần Áo miDoctor Tiện Lợi - Giao Màu Ngẫu Nhiên",88000,89000,1000,1
TIKI,nha-cua-doi-song,165346784,"Khăn gội sợi tre Bamboo&Love 35x75cm mềm mại kháng khuẩn siêu thấm hút an toàn cho da ngay cả với trẻ sơ sinh",34900,58000,23100,40
TIKI,nha-cua-doi-song,272453821,"[Tặng Bông Lau] Bộ Lau Nhà MyJae Đài Loan Sợi Microfiber Xoay Siêu Tốc 360 Độ Thông Minh 129.5cm",699000,990000,291000,29
TIKI,nha-cua-doi-song,53307149,"Bộ tua vít đa năng sửa chữa điện thoại 25 in 1 vít từ tính chất liệu cao cấp S2",38880,38880,0,0
TIKI,nha-cua-doi-song,90523892,"Ly Giữ Nhiệt Lock&Lock Energetic One Touch Tumbler LHC3249 (550ml) - Hàng Chính Hãng, Bằng Thép Không Gỉ Inox 316L, Nắp Mở Một Chạm, Tặng Ống Hút Và Cọ Rửa",289000,488000,199000,41
TIKI,nha-cua-doi-song,27609461,"Dụng cụ thông tắc bồn cầu, cống bằng khi nén áp lực siêu mạnh",185000,185000,0,0
TIKI,nha-cua-doi-song,81936300,"BIG SIZE -Túi Đựng Quần Áo Khung Thép 88L: 60x40x35 (cm) Morning House- Gấp gọn tiện lợi, bảo quản quần áo bền đẹp",88000,88000,0,0
TIKI,nha-cua-doi-song,77448059,"Cốc giữ nhiệt LocknLock LHC4247PIK Table Mug 473ml",252000,484000,232000,48
TIKI,nha-cua-doi-song,146384829,"Ghế xoay văn phòng công thái học ergonomic có ngả lưng Premium 02, ghế xoay Gaming cao cấp nhập khẩu",1064000,2490000,1426000,57
TIKI,nha-cua-doi-song,32178097,"Chảo Sâu Lòng NAG2653 Đáy Từ 5 Lớp Chống Dính Vung Kính Siêu Bền Nagakawa (26cm) - Dùng Trên Mọi Loại Bếp - Hàng Chính Hãng",333000,585000,252000,43
TIKI,nha-cua-doi-song,655378,"Đèn Tích Điện Đa Năng 360 Cỡ Trung Sunhouse SHE-6848LA - Trắng",201000,331000,130000,39
TIKI,nha-cua-doi-song,130767592,"Ổ cắm Điện Quang ĐQ ESK 5W. SM740SL (4 lỗ 3 chấu dây 5 mét màu Trắng Đỏ)",158480,198100,39620,20
TIKI,nha-cua-doi-song,7635008,"Bộ 2 cuộn túi hút chân không một mặt nhám rộng",60000,60000,0,0
TIKI,nha-cua-doi-song,54483857,"Đèn Bàn Học Đọc Sách, Làm Việc (Học Sinh, Sinh Viên, Văn Phòng) LED Chống Cận, Cảm Ứng Tích Điện Pin 2500mAh Elights BT-618",49000,49000,0,0
TIKI,nha-cua-doi-song,73529777,"Kệ chén bát đa năng bằng thép carbon không gỉ, chống xước, sơn đen tĩnh điện, giá bát trên bồn rửa ráo nước cho nhà bếp sạch sẽ VANDO",319000,349000,30000,9
TIKI,nha-cua-doi-song,48175867,"KỆ TRANG TRÍ VUÔNG 2 TẦNG - CAO 50CM x DÀI 35CM x RỘNG 35CM ",150000,150000,0,0
TIKI,nha-cua-doi-song,74598515,"Đệm ngồi 3D Silicon cao cấp thoáng khí chống đau mỏi - Hàng nhập khẩu",149000,149000,0,0
TIKI,nha-cua-doi-song,193709920,"Bình Đựng Nước 1L Bao Bì Dễ Thương Có Vạch Báo Giờ Uống Nước Chia Lượng Nước Deli - Nhựa Cao Cấp An Toàn Đầy Đủ Kiểm Định Chất Lượng Phủ Hợp Bình Nước Thể Thao Cho Bé Tới Trường - VS822 VS823",99000,178200,79200,44
TIKI,nha-cua-doi-song,466737,"Hộp Cơm Cắm Điện - Hộp Hâm Nóng Văn Phòng 2 Tầng Life360 EL-ALS263 (Tím) - Hàng Chính Hãng",456000,749000,293000,39
TIKI,nha-cua-doi-song,139562345,"Khăn mặt khô  Animerry dùng 1 lần lau khô, lau ướt - Giấy lau mặt dùng một lần",12900,18500,5600,30
TIKI,nha-cua-doi-song,72904497,"Kệ Nhà Tắm Kèm Nhả Kem Đánh Răng Tự Động 2 Cốc OENON Lắp Đặt Dán Tường - OEKEM",159000,300000,141000,47
TIKI,nha-cua-doi-song,191820658,"Gối Cao Su Thiên Nhiên Gummi Cookie Thiết Kế Vòm Cong Tối Ưu Giúp Giảm Đau Cổ Vai Gáy Vượt Trội",489000,720000,231000,32
TIKI,nha-cua-doi-song,162112460,"Thùng Rác Tròn Chân Đạp 6l Phù Hợp Văn Phòng, Gia Đình, Phòng Bếp Tiện Nghi Sang Trọng",129000,129000,0,0
TIKI,nha-cua-doi-song,52006431,"Hộp đựng thìa đũa cá nhân DandiHome (màu ngẫn nhiên)",26500,30000,3500,12
TIKI,nha-cua-doi-song,197412247,"[ TikiNow giao hàng ] Ghế chỉnh dáng ngồi đúng Roichen - Hàn Quốc. Sản phẩm dành cho Nam. Nhập khẩu Hàn Quốc (Made in Korea). Hàng chính hãng Roichen",785000,898000,113000,13
TIKI,nha-cua-doi-song,72049662,"Combo 6 Túi Giặt Lưới Bảo Vệ Quần Áo, túi lưới mịn polyester bảo quản quần áo",99000,99000,0,0
TIKI,nha-cua-doi-song,146432055,"Túi Chân Không Tự Hút Đựng Chăn Mền Quần Áo Không Cần Dụng Cụ Hút",42000,42000,0,0
TIKI,nha-cua-doi-song,52238726,"Mùng Chụp Tự Bung Cao Cấp Siêu Dày - Màu Xanh Da Trời  + Tặng kèm túi thơm thảo dược",155000,215000,60000,28
TIKI,nha-cua-doi-song,19929974,"Bộ 4 Ống Hút Thủy Tinh Chịu Nhiệt (2 Cong + 2 Thẳng) + 2 Cọ Rửa + 1 Túi Vải",69000,69000,0,0
TIKI,nha-cua-doi-song,89992214,"Kệ Góc Nhà Tắm INOX 304 dán tường gạch men siêu chắc",69000,125000,56000,45
TIKI,nha-cua-doi-song,116048764,"Kệ sách tổ ong vân gỗ dễ dàng kết hợp với bàn làm việc chính hãng IGA - GP100",121000,130000,9000,7
TIKI,nha-cua-doi-song,53599746,"Combo Giá Treo Ổ Cắm Điện, Modem Dán Tường Tiện Dụng",19900,19900,0,0
TIKI,nha-cua-doi-song,134515126,"Bình giữ nhiệt cho trẻ em LocknLock Cozy Kids Straw Tumbler LHC4236BLU 330ml - Màu",355000,592000,237000,40
TIKI,nha-cua-doi-song,71999227,"Bộ Nồi Inox 3 Lớp Đáy Liền Elmich Trimax Classic 2106OL Size 18,20,24cm",1591000,2870000,1279000,45
TIKI,nha-cua-doi-song,165109465,"Kệ Lò Vi Sóng 2 Tầng, Kệ Nhà Bếp Thương Hiệu IGA - GM52",155000,169000,14000,8
TIKI,nha-cua-doi-song,71174837,"Đèn Pin Mini Siêu Sáng XML-T6 miDoctor - Chính Hãng",86000,86000,0,0
TIKI,nha-cua-doi-song,70083074,"Ghế xếp thư giãn SUMIKA 199 - có lăn tay massage, khung vuông cao cấp, tải trọng 300kg",1165000,1580000,415000,26
TIKI,nha-cua-doi-song,14448546,"Bình Gas Bơm Bật Lửa BlueSky",55000,55000,0,0
TIKI,nha-cua-doi-song,88925284,"Ổ Cắm Điện LIOA 10 ổ dây 3m(4D6S32) & 5m (4D6S52)",140000,140000,0,0
TIKI,nha-cua-doi-song,111511362,"Cuộn giấy lau nhà bếp đa năng 220 tờ màu trắng siêu dai có thể giặt được",9000,10500,1500,14
TIKI,nha-cua-doi-song,75340681,"Hộp Đựng Đồ Đa Năng TD1 – Túi Vải Đựng Quần Áo Chăn Màn Phong Cách Thụy Điển Sang Trọng, Lịch Sự – Hàng Chính Hãng",76000,130000,54000,42
TIKI,nha-cua-doi-song,163827070,"Combo 2 hộp chia ngăn sắp xếp quần áo phong cách Nhật Bản VINAVU",190000,190000,0,0
TIKI,nha-cua-doi-song,54412879,"Lô 4 túi rác tiện dụng Soji - size 10L - 25L và 50L",33250,35000,1750,5
TIKI,nha-cua-doi-song,84746981,"Lọ đựng gia vị, dầu ăn, nước chấm bằng thủy tinh trong suốt kèm muỗng tiện lợi",11900,11900,0,0
TIKI,nha-cua-doi-song,45404047,"[ĐẶC BIỆT] Nhang Xanh Trầm Hương Cao Cấp 15 năm -100g - mùi thơm tự nhiên, dịu ngọt của trầm - Nhang Thiền",123500,125000,1500,1
TIKI,nha-cua-doi-song,115532506,"Hộp Nhựa Đựng Thực Phẩm, Hộp Bảo Quản Thực Phẩm Tủ Lạnh Homepower Trong Suốt Có Khay Lót Đáy Giúp Ráo Nước, Vòng Ghi Chú Thời Gian Bảo Quản Tiện Lợi",129000,129000,0,0
TIKI,nha-cua-doi-song,192258425,"Thảm Chùi Chân 4 Lớp Siêu Thấm Hút Nhiều Hoa Văn Độc Đáo",79000,79000,0,0
TIKI,nha-cua-doi-song,803123,"Thùng rác nhựa Fitis Compact X PPL1-906",280000,350000,70000,20
TIKI,nha-cua-doi-song,59259444,"Mùng chụp tự bung cao cấp FUNU - Màn chống muỗi thông minh - Hàng chính hãng (Sản xuất tại Việt Nam)",145700,155000,9300,6
TIKI,nha-cua-doi-song,191822621,"Gối Foam Contour Doona Sofy Cấu Trúc Lượn Sóng Nâng Đỡ Định Hình Xương Cổ Và Đầu Hoàn Hảo",339000,600000,261000,44
TIKI,nha-cua-doi-song,17488465,"Vỉ 5 viên Pin GP 12V 23A",49000,49000,0,0
TIKI,nha-cua-doi-song,169650796,"Màn chụp, mùng chụp đỉnh vuông Không chân viền cao cấp Một Cửa - Hàng chính hãng (Giao ngẫu nhiên)",313500,330000,16500,5
TIKI,nha-cua-doi-song,114976767,"Nệm foam Goodnight Massage bán chạy số 1 Việt Nam 9cm tại Vua Nệm - Cấu trúc lượn sóng duy trì tư thế tự nhiên của cột sống",4290000,4290000,0,0
TIKI,nha-cua-doi-song,169978766,"Túi Hút Chân Không Đựng Quần Áo, Chăn Ga Gối, Thú Bông Deli - Loại Dày Cao Cấp, Nhiều Hoạ Tiết, Bảo Vệ Quần Áo, Chăn Ga Khỏi Ẩm, Nấm Mốc, Chống Nước Tuyệt Đối",16000,35820,19820,55
TIKI,nha-cua-doi-song,157055245,"Combo 100 viên khăn giấy nén hình viên kẹo bỏ túi khi đi du lịch, 50 viên khăn lau mặt dạng nén dùng một lần siêu tiện lợi",35000,35000,0,0
TIKI,nha-cua-doi-song,103780888,"Ổ cắm có dây - Ổ điện an toàn - Ổ cắm điện đa năng - Ổ cắm điện Lioa ( 4 - 6 - 10 ổ cắm ) dây 5m và 3m Lioa - hàng chính hãng cao cấp",62000,62000,0,0
TIKI,nha-cua-doi-song,146062295,"Bộ 2 Ốc Vít - Chốt Cao Su Cố Định Nắp Bồn Cầu",68000,68000,0,0
TIKI,nha-cua-doi-song,59598451,"Miếng xốp bọc chân cửa chắn gió chống bụi, ngăn tiếng ồn, ngăn côn trùng 93 x 9.6cm",20000,20000,0,0
TIKI,nha-cua-doi-song,163574367,"Nến Thơm Cenote 4 Mùi Cao Cấp, Có Nắp Tắt Lửa Không Khói, Dùng cho Phòng Khách, Spa, Khách sạn và Phòng Hát Karaoke",139000,139000,0,0
TIKI,nha-cua-doi-song,89980825,"Bộ 2 nhả kem đánh răng tự động OENON, Kệ nhà tắm thông minh kèm cốc láp đặt dán tường - 2NHAKEM",229000,400000,171000,43
TIKI,nha-cua-doi-song,68716607,"Dao Thái Sunhouse KS-KN165SS",73000,117000,44000,38
TIKI,nha-cua-doi-song,199593599,"Kệ Sách Hình Cây Để Sàn",224000,245000,21000,9
TIKI,nha-cua-doi-song,31576989,"Quai xách Dây Dù bình giữ nhiệt 2GOOD Para Handle",65000,65000,0,0
TIKI,nha-cua-doi-song,38059858,"Bộ 10 khăn lau 2 mặt siêu thấm- Khăn lau không phai màu không rụng sợi- nhanh khô- Khăn lau bếp, khăn lau kính, lau bát lau tay",9999,9999,0,0
TIKI,nha-cua-doi-song,270862516,"Gối cao su chống đau cột sống - Gối cao su dành cho người hay ngủ ngáy mỏi cổ vai gáy – Hàng chính hãng",127000,200000,73000,37
TIKI,nha-cua-doi-song,84699481,"Đèn Bàn Học Đọc Sách Làm Việc LED Chống Cận Bảo Vệ Mắt – Cảm Ứng Tích Hợp Sạc Không Dây - Vùng Sáng 3000-6500K – 5 Cấp Độ Điều Chỉnh – Phiên Bản Nâng Cấp Cổng Type-C",649000,799000,150000,19
TIKI,nha-cua-doi-song,73116895,"Găng tay nướng bánh cách nhiệt Baking Gloves ",50000,50000,0,0
TIKI,nha-cua-doi-song,113458874,"Tủ Để Đồ Thông Minh S Smart Tận Dụng Không Gian Cạnh Cửa Sổ - GP131",406000,444000,38000,9
TIKI,nha-cua-doi-song,579928,"Chảo Sâu Chống Dính Sunhouse SHS20 20cm",130000,180000,50000,28
TIKI,nha-cua-doi-song,100522012,"Cây Lau Nhà Thông Minh, Chổi Lau Nhà 360 Độ Đa Năng (Không Bao Gồm Thùng Vắt) - Parroti MOP-PR01",209000,269000,60000,22
TIKI,nha-cua-doi-song,25412653,"Cây lăn bụi quần áo đa năng kèm 2 cục dự phòng",13000,15000,2000,13
TIKI,nha-cua-doi-song,14981747,"01 hộp đũa Inox 304 cao cấp DandiHome (10 đôi) - Cá chép vượt cổng Vũ Môn",300000,300000,0,0
TIKI,nha-cua-doi-song,72332230,"GỐI CHỮ U CAO SU NON - GỐI TỰA CỔ CHO DÂN VĂN PHÒNG, LÁI XE, DU LỊCH",99000,99000,0,0
TIKI,nha-cua-doi-song,199581980,"Kệ Sách Gỗ Để Bàn Thương Hiệu IGA - GP62",100000,109000,9000,8
TIKI,nha-cua-doi-song,477936,"Lõi Lọc Kova-Barrier Tiêu Chuẩn - FC-STD",183000,235000,52000,22
TIKI,nha-cua-doi-song,134621577,"[Nhập CECAMP70KD1 giảm 70k đơn 999k] Bộ Dao 7 Món Lock&amp;Lock CKK301",1594000,2657000,1063000,40
TIKI,nha-cua-doi-song,88241130,"Khăn trải bàn nhựa PVC không thấm nước, khăn trai bàn có hoạ tiết đẹp phù hợp với mọi nhà",55000,55000,0,0
TIKI,nha-cua-doi-song,579854,"Nồi Nấu Bột Chống Dính Nắp Kính Sunhouse SHG-MP14 14cm",122000,180000,58000,32
TIKI,nha-cua-doi-song,174378686,"Miếng gảy đàn, Pick - Alice AP-ALT - Dành cho Guitar, Ukulele, Bass - Dày 0.46mm, Colorful Celluloid - Màu ngẫu nhiên - Hàng chính hãng",14000,14000,0,0
TIKI,nha-cua-doi-song,274121764,"Ruột Gối Ôm Gòn Cozy Thuần Việt - Sợi Gòn Cao Cấp, Êm Ái - Kích Thước 20x100",220000,350000,130000,37
TIKI,nha-cua-doi-song,56612464,"Hộp Cơm Giữ Nhiệt INOX304 Hiện Đại Kèm Hộp Đựng Canh Soup",177650,187000,9350,5
TIKI,nha-cua-doi-song,120470943,"Bình Nước Thuỷ Tinh Luminarc Bucolique 1.3L - LUBIN1806 ",136000,136000,0,0
TIKI,nha-cua-doi-song,172447892,"Bộ 6 túi giặt siêu dày 3 lớp cao cấp - Combo 6 túi lưới bảo vệ quần áo dùng cho máy giặt siêu bền tiện dụng chính hãng",165000,250000,85000,34
TIKI,nha-cua-doi-song,112760341,"Thùng rác treo tủ bếp có nắp đậy thông minh, thùng rác treo tường dán tường, có thanh trượt cửa bếp – Parroti Bin BN02",169000,299000,130000,43
TIKI,nha-cua-doi-song,70820849,"Pin CR2032 Energizer 3V vỉ 5 viên",59000,100000,41000,41
TIKI,nha-cua-doi-song,54476660,"Đèn Bàn Học Đọc Sách, Làm Việc (Học Sinh, Sinh Viên, Văn Phòng) Cao Cấp Kẹp Bàn – 03 Mức Độ Ánh Sáng Vàng Bảo Vệ Mắt Chống Cận Pin 2500 mAh",149000,149000,0,0
TIKI,nha-cua-doi-song,51530502,"GƯƠNG KỆ ĐỨNG KHUNG GỖ HÀN QUỐC - MIRROR SHELF - D41 X R35 X C160 - 2 MÀU LỰA CHỌN",415000,420000,5000,1
TIKI,nha-cua-doi-song,70898819,"Giấy ăn giấy gấu trúc Ycool -khăn giấy rút 300 tờ 1bịch 10 gói mẫu trắng",45000,45000,0,0
TIKI,nha-cua-doi-song,197799361,"Combo 2 Bộ Chuyển Đổi Ổ Cắm 2 Chấu Thành 3 Chấu",27094,28520,1426,5
TIKI,nha-cua-doi-song,146509745,"Bộ Hộp Cơm Giữ Nhiệt Văn Phòng Cao Cấp Cắm Điện inox 3 tầng - Chính hãng dododios",189000,189000,0,0
TIKI,nha-cua-doi-song,143217219,"Kệ Đa Năng Lưu Trữ Đồ Dùng, Giá Sách Có Bánh Xe Thương Hiệu IGA - GP173",293000,318000,25000,8
TIKI,nha-cua-doi-song,241805597,"Móc Dán Tường, Móc Dính Tường Treo Đồ Nặng Siêu Dính Inox 304 - Treo Thớt, Nồi Niêu Xong Chảo, Treo Đồ Đa Năng",12000,12000,0,0
TIKI,nha-cua-doi-song,134242996,"Ly Nhựa Có Ống Hút Lock&amp;Lock HAP507YEL",113000,217000,104000,48
TIKI,nha-cua-doi-song,31206755,"Hộp 40 viên pin Maxell AAA",122000,130000,8000,6
TIKI,nha-cua-doi-song,80901951,"Kéo Nhật Nội Địa SK5 Siêu Sắc, Kéo Nhà Bếp, Kéo Cắt Gà, Cắt Vịt, Cắt Thịt Các Loại",79000,79000,0,0
TIKI,nha-cua-doi-song,195968874,"Đèn LED Mini Móc Khóa Siêu Sáng Tiện Dụng US ARMY,  Đèn Pin COB Dã Ngoại Thường Ngày, Sạc TYPE-C Tiện Dụng Dung Lượng PIN 500mAh  Full Hộp Sạc- HÀNG CHÍNH HÃNG",63000,178000,115000,65
TIKI,nha-cua-doi-song,51541280,"Hộp Cơm Cắm Điện - Hộp Hâm Nóng Văn Phòng 2 Tầng ArirangLife EL-ALS263 (Hồng) - Hàng chính hãng",455000,749000,294000,39
TIKI,nha-cua-doi-song,105717965,"Bình Giữ Nhiệt 2GOOD FLASK WM-02 Sport Lid (946ml) - Hàng Chính Hãng",399000,399000,0,0
TIKI,nha-cua-doi-song,10017811,"Súng bắn keo nến 20w +Tặng 10 cây keo nến ",44300,44300,0,0
TIKI,nha-cua-doi-song,128584341,"Ổ cắm đa năng USB Rạng Đông dài 3m Model: OC02.USB 3C/3M/10A",277200,308000,30800,10
TIKI,nha-cua-doi-song,17000892,"Ô gấp gọn chống tia UV ",35000,35000,0,0
TIKI,nha-cua-doi-song,579962,"Bộ Nồi 5 Đáy Cao Cấp Núm Vàng Sunhouse SH781 Quay Mạ Vàng Cao Cấp (16cm, 20cm, 24cm) - Dùng Cho Mọi Loại Bếp - Hàng Chính Hãng",487000,960000,473000,49
TIKI,nha-cua-doi-song,63821690,"Vòi Lavabo lạnh - 01 đường nước - tay gật gù Yamato cao cấp",169000,200000,31000,16
TIKI,nha-cua-doi-song,59047203,"Bộ 10 đầu tưới nắp chai nhỏ giọt tự động thông minh có điều chỉnh ( tưới hoa, cây cảnh )",29000,29000,0,0
TIKI,nha-cua-doi-song,176592358,"Cây lau nhà tự vắt đa năng Sunhouse KS-MO3211PW",181000,263000,82000,31
TIKI,nha-sach-tiki,106788395,"Toán Tư duy - Beginning Creative Math (Dành cho bé 4-6 tuổi/Song ngữ Việt - Anh)",57200,110000,52800,48
TIKI,nha-sach-tiki,140416366,"Hôm Nay Phải Mở Mang (Một Tựa Sách Của Ngày Ngày Viết Chữ Dành Cho Người Học Viết Và Làm Nghề Viết)",93000,119000,26000,22
TIKI,nha-sach-tiki,178483666,"Những Lời Giáo Huấn Của Epictetus",171000,239000,68000,28
TIKI,nha-sach-tiki,544731,"Giáo Trình Chuẩn HSK 2 - Bài Học (Kèm file MP3)",149000,198000,49000,25
TIKI,nha-sach-tiki,4466841,"Trưởng Thành Sau Ngàn Lần Tranh Đấu (Tái Bản)",69100,95000,25900,27
TIKI,nha-sach-tiki,971704,"Tạo Lập Mô Hình Kinh Doanh (Tái bản)",185400,299000,113600,38
TIKI,nha-sach-tiki,142791749,"Sự Trỗi Dạy Và Suy Tàn Của Đế Chế Thứ 3 (Tái Bản)",275000,445000,170000,38
TIKI,nha-sach-tiki,96327064,"Bye Béo - Cách giảm 7kg trong 30 ngày",199000,199000,0,0
TIKI,nha-sach-tiki,149573910,"Thiên Quan Tứ Phúc - Tập 4",110700,159000,48300,30
TIKI,nha-sach-tiki,192125806,"Dạy con làm giàu - Tập 11 - Trường dạy kinh doanh cho những người thích giúp đỡ người khác (Tái Bản 2022)",53000,80000,27000,34
TIKI,nha-sach-tiki,23433003,"30 Chủ Đề Từ Vựng Tiếng Anh (Tập 1)",123000,190000,67000,35
TIKI,nha-sach-tiki,1445365,"Dưới Một Mái Nhà Ở Paris",87600,119000,31400,26
TIKI,nha-sach-tiki,116835635,"Tớ Học Lập Trình - Làm Quen Với Python",78300,105000,26700,25
TIKI,nha-sach-tiki,197629362,"Bức Họa Múa Rối Xương (Combo tập 1+2)",217000,279000,62000,22
TIKI,nha-sach-tiki,193446626,"Chòm Sao Linh Thú Tập 8 [Tặng kèm Bookmark]",39000,40000,1000,3
TIKI,nha-sach-tiki,197602052,"Fullmetal Alchemist - Cang Giả Kim Thuật Sư - Fullmetal Edition Tập 7",61900,69000,7100,10
TIKI,nha-sach-tiki,136232535,"Ux Content 4.0 (Chọn Đúng Chữ, Giữ Người Dùng)",117000,139000,22000,16
TIKI,nha-sach-tiki,192124401,"Kingdom -Tập 31",43600,45000,1400,3
TIKI,nha-sach-tiki,113655308,"Giáo Trình Kinh Tế Chính Trị Mác – Lênin (Dành Cho Bậc Đại Học Hệ Không Chuyên Lý Luận Chính Trị) - Bộ mới năm 2021",59000,59000,0,0
TIKI,nha-sach-tiki,188039858,"Combo 4 Cuốn Sổ Tay Ghi Chép A5 Gáy Xoắn 120 Trang Kẻ Ngang Deli - Phù Hợp Làm Sổ Kế Hoạch Planner, Nhật Kí, Tập Vở Ghi Chép Bullet Journal - LA560-06",18000,37800,19800,52
TIKI,nha-sach-tiki,190701636,"Yuri Espoir (Tập 2) - Bản thường: tặng kèm postcard",59100,79000,19900,25
TIKI,nha-sach-tiki,185226873,"Achievers Grade 7 Student's Book with CLIL Book",251000,251000,0,0
TIKI,nha-sach-tiki,192692368,"Phương Pháp Thực Chiến Hiệu Suất Cao Đến Từ Nhà Quán Quân Giao Dịch Tài Chính",364000,364000,0,0
TIKI,nha-sach-tiki,95311757,"Lưu Thông Máu Tốt Hóa Giải Bách Bệnh",68800,99000,30200,31
TIKI,nha-sach-tiki,142675354,""Từ Điển" Sử Dụng Loài Người",75500,105000,29500,28
TIKI,nha-sach-tiki,171549988,"Trường An Ly Ca 2 - Vén Mây Thấy Trời",127000,165000,38000,23
TIKI,nha-sach-tiki,175845415,"Bí Quyết Tìm Kiếm Mặt Bằng Kinh Doanh - Đến Sahara Mở Quán Trà Đá - Bộ Sách Khởi Nghiệp Bán Lẻ",169000,199000,30000,15
TIKI,nha-sach-tiki,98733259,"Những Tù Nhân Của Địa Lí - Khám Phá Sự Vận Hành Của Thế Giới Qua Những Tấm Bản Đồ - Phiên Bản Minh Hoạ Màu Dành Cho Độc Giả Trẻ",162000,230000,68000,30
TIKI,nha-sach-tiki,181699672,"Shuggie Bain: Chiếc Linh Hồn Nhỏ",156000,235000,79000,34
TIKI,nha-sach-tiki,53434797,"Sách Tài Chính Cá Nhân Cho Người Việt Nam - Tặng Khóa học Online về Tài chính",200000,200000,0,0
TIKI,nha-sach-tiki,55605172,"Tắt Đèn (Tái Bản 2020)",33000,50000,17000,34
TIKI,nha-sach-tiki,106997685,"Keo dán siêu chắc Sealant Fix - Giải pháp thay thế đinh vít",21000,21000,0,0
TIKI,nha-sach-tiki,174605333,"Châu Phi Nghìn Trùng (Tái Bản)",123000,165000,42000,25
TIKI,nha-sach-tiki,106149744,"Tôi Đã Kiếm 2.000.000 Đô La Từ Thị Trường Chứng Khoán Như Thế Nào (Tái Bản)",63220,109000,45780,42
TIKI,nha-sach-tiki,50773990,"Triết Lý Kinh Doanh Của Kyocera",124000,175000,51000,29
TIKI,nha-sach-tiki,137561095,"Combo 2 Cuốn Sách Tâm Lý Học Nhập Môn: Toàn Thư Tâm Lý Học + Từ Điển Tâm Lý",183000,254000,71000,28
TIKI,nha-sach-tiki,126474205,"Làm giàu từ chứng khoán bằng phương pháp VSA chính gốc: Nghiên cứu chuyên sâu về cách giao dịch của Wyckoff",499000,499000,0,0
TIKI,nha-sach-tiki,273896677,"Trí Tuệ Do Thái",141000,189000,48000,25
TIKI,nha-sach-tiki,110944248,"Tôi Không Thích Ồn Ào (Tặng Kèm Bookmark)(Tái Bản)",55000,75000,20000,27
TIKI,nha-sach-tiki,111290700,"Bố Già (Bìa Cứng) (Tái Bản)",149175,250000,100825,40
TIKI,nha-cua-doi-song,53647975,"1 Gối Ôm thương hiệu A có khóa kéo - an toàn sức khỏe, không chứa chất độc hại - êm ái, mềm mịn - KT",125000,150000,25000,17
TIKI,nha-cua-doi-song,20025334,"Bình Chữa Cháy Dạng Bột Khô ABC MFLZ-4Kg (Chữa cháy chất Rắn, Lỏng và Khí)",220000,380000,160000,42
TIKI,nha-cua-doi-song,162597633,"Combo 4 miếng dán đỡ kệ gỗ VINAVU, giúp chia ngăn tủ, không cần đóng đinh",24000,24000,0,0
TIKI,nha-cua-doi-song,153467342,"Xốp Chèn Cửa 95cm Chặn Đáy Khe Cửa, Cách Nhiệt, Cách Âm, Ngăn Côn Trùng, Thanh Chắn Khe Cửa",4000,26000,22000,85
TIKI,nha-cua-doi-song,135321378,"Thanh Chặn Khe Cửa 95cm Đa Năng,Chặn Đáy Khe Cửa, Ngăn Côn Trùng, Chắn Gió Mùa, Ngừa Bụi Bẩn, Giảm Ồn",8000,13999,5999,43
TIKI,nha-cua-doi-song,91475535,"Áo Mưa Cánh Dơi Rằn Ri, Áo Mưa Xẻ Tà Màu Lính Vải Dù Siêu Dày 1M4, Chống Thấm Hiệu Quả, Phù Hợp Nam Và Nữ, Có Túi Đựng",130000,130000,0,0
TIKI,nha-cua-doi-song,54582729,"KỆ ĐẦU GIƯỜNG 1 TẦNG - TỦ ĐẦU GIƯỜNG - GỖ THÔNG NEWZEALAND - MÀU GỖ VÀNG NHẠT TỰ NHIÊN CÓ VÂN GỖ",109000,200000,91000,46
TIKI,nha-cua-doi-song,185380294,"Lưới Polyester Phủ Chống Thấm, Vải Polyester Gia Cố Chống Thấm Mái Nhà Sàn Nhà Khe Nứt Khổ 10 cm",77350,91000,13650,15
TIKI,nha-cua-doi-song,190989483,"Bình giữ nhiệt Baby Inox 316 Elmich EL8017 dung tích 300ml",231000,319000,88000,28
TIKI,nha-cua-doi-song,202805092,"Bình Giữ Nhiệt 800ml Lock&Lock Vacuum Bottle LHC6180 - Hàng Chính Hãng, Bằng Thép Không Gỉ, Có Lưới Lọc Trà Bằng Inox, Mức Giữ Nhiệt Vượt Trội Tặng Kèm Ống Hút Inox",373000,697000,324000,46
TIKI,nha-cua-doi-song,125913928,"Móc dán tường trong suốt Móc treo đồ Móc dán tường 3D",700,1000,300,30
TIKI,nha-cua-doi-song,21466758,"Đầu chuyển ổ cắm 3 chấu qua 2 chấu - Hàng nhập khẩu",11353,11950,597,5
TIKI,nha-cua-doi-song,137572447,"Bóng đèn LED Bulb PHILIPS Essential E27 - Tiết kiệm điện, Ánh sáng chất lượng cao - Hàng Chính Hãng",42000,66000,24000,36
TIKI,nha-cua-doi-song,3526073,"Bộ Túi Hộp Cơm Thủy Tinh Lock&Lock 3EA LLG428M2 - Xanh Mint",343000,660000,317000,48
TIKI,nha-cua-doi-song,57272706,"Combo 200 túi lọc rác bồn rửa bát - Túi lưới lọc rác giúp ngăn chặn tắc đường ống",33030,33030,0,0
TIKI,nha-cua-doi-song,193708669,"Bình Đựng Nước 2L Kèm Ống Hút Bao Bì Dễ Thương Có Vạch Báo Giờ Uống Nước Chia Lượng Nước Deli - Bình Nước 2 Lít Nhựa Cao Cấp An Toàn Đầy Đủ Kiểm Định Chất Lượng Phủ Hợp Bình Nước Thể Thao Cho Bé Tới Trường - VS818 VS819",85000,160200,75200,47
TIKI,nha-cua-doi-song,59092666,"MÁY KHUẾCH TÁN TINH DẦU CHUYÊN DỤNG | Vân Gỗ Cao Cấp | Có Điều Khiển Từ Xa | Máy Phun Sương Tỏa Hương Tinh Dầu 500ML Cho Phòng Lớn",229000,476000,247000,52
TIKI,nha-cua-doi-song,72044284,"BÀN LÀM VIỆC CHÂN GẤP GỌN 100CM - Nhiều màu sắc",392000,400000,8000,2
TIKI,nha-cua-doi-song,55202824,"Bình Nước Nhựa Nắp Vặn Dây Treo Họa Tiết Hươu Và Trăng Tiện Dụng Phù Hợp Với Mọi Lứa Tuổi 560ml",129000,258000,129000,50
TIKI,nha-cua-doi-song,97817455,"Bộ túi hộp cơm thủy tinh COBA'COOK. Gồm 3 hộp 400ml và 1 túi giữ nhiệt với 2 khóa kéo tiện dụng- CCR43BL",203000,316000,113000,36
TIKI,nha-cua-doi-song,114621700,"Kệ để hồ sơ văn phòng tiện lợi, kệ sách để bàn nhỏ gọn gỗ MDF chống ẩm chất lượng cao",126000,171000,45000,26
TIKI,nha-cua-doi-song,95335291,"Combo 10 cặp kẹp dán tường thông minh - Không cần khoan lỗ, đục tường- Chịu lực lên đến 3Kg",35939,37830,1891,5
TIKI,nha-cua-doi-song,135321411,"Giấy Bạc Tráng Nhôm, dán bếp tăng thẩm mỹ và rất sạch sẽ(2M)",16000,35000,19000,54
TIKI,nha-cua-doi-song,104681179,"Bông Lau Thay Thế MyJae Dạng Tròn Dành Cho Cây Lau Nhà Xoay 360 Độ",109000,200000,91000,46
TIKI,nha-cua-doi-song,272966734,"Ổ cắm điện 5 lỗ 2m Điện Quang SM750SL - Hàng Chính Hãng",175000,175000,0,0
TIKI,nha-cua-doi-song,79267304,"Túi rác tự hủy inochi tiện dụng SOJI có quai xuất nhật Dùng đựng rác gia đình ,Bao đựng rác văn phòng đủ size -màu đen mềm nhẹ dai túi rác tự hủy giúp bảo vệ môi trường",38000,45000,7000,16
TIKI,nha-cua-doi-song,54132706,"Bộ sạc Energizer Charger kèm 4 pin Ener AA 2000mAh, tự ngắt sạc (CHVCM4) ( Mẫu mới)",429800,449000,19200,4
TIKI,nha-cua-doi-song,92441037,"[LOẠI XỊN - CÓ TẶNG BƠM TAY] Bộ 8 Túi Hút Chân Không Đựng Quần Áo, Chăn Màn CỠ ĐẠI Cao Cấp - Hàng chính hãng",198000,198000,0,0
TIKI,nha-cua-doi-song,66877902,"Đèn Ngủ Quả Cầu Mây Để Bàn SPEVI - Điều Chỉnh Độ Sáng, Làm Đèn Ngủ Trang Trí, Quà Sinh Nhật Cực Đáng Yêu, Đầu USB, Adapter USB Tiện Lợi, Đế Gỗ Xếp Sang Trọng, Bóng Đèn Led Vô Cùng Tiết Kiệm Điện - Hàng Chính Hãng",129000,246000,117000,48
TIKI,nha-cua-doi-song,64618364,"Day Đèn LED Siêu Sáng 5050 RGB Chống Nước Quấn Cây Trang Trí Ngoài Trời",112000,112000,0,0
TIKI,nha-cua-doi-song,21301419,"Bàn để là quần áo dạng đứng",140000,140000,0,0
TIKI,nha-cua-doi-song,21782438,"Kìm  kẹp quả óc chó ,càng cua, ghẹ inox - 17x4.5cm 247g",26000,26000,0,0
TIKI,nha-cua-doi-song,15343778,"Kệ góc nhà tắm dán tường inox 304 bóng Hobby Home Decor KG1 kèm keo dán và đinh ốc",249000,249000,0,0
TIKI,nha-cua-doi-song,75616917,"Khăn lau vuông đa năng tiện lợi có dây treo siêu thấm hút lau tay lau bếp vệ sinh nhà cửa 25x25cm",8000,8000,0,0
TIKI,nha-cua-doi-song,34230976,"Bàn làm việc 2 tầng 80cm",210602,214900,4298,2
TIKI,nha-cua-doi-song,70316883,"KỆ ĐỂ GIÀY DÉP GỖ THÔNG- Dài 50cm - 2T500",119000,119000,0,0
TIKI,nha-cua-doi-song,117195930,"Pin Maxell Super Đỏ - Hộp 40 Viên Pin Tiểu AA (2A) 1.5V",105000,105000,0,0
TIKI,nha-cua-doi-song,162360312,"[HÀNG XỊN - CHỌN SIZE] Chiếu điều hòa sợi mây tổng hợp lót vải không dệt cao cấp hàng xuất khẩu 2 mặt giá rẻ 1m2 1m6 1m8 chính hãng",182000,300000,118000,39
TIKI,nha-cua-doi-song,263488472,"Tủ kệ sách để bàn H6689 nhiều màu tiện ích ( Ngẫu nhiên )",48000,58000,10000,17
TIKI,nha-cua-doi-song,53830678,"1 cặp ruột gối hơi cao cấp - Gòn bông nhân tạo an toàn sức khỏe, không chứa chất độc hại - Có khóa kéo dễ dàng thêm bớt gòn bên trong - Êm ái, mềm mịn",60000,65000,5000,8
TIKI,nha-sach-tiki,193099631,"Đại Gia Gatsby",59000,86000,27000,31
TIKI,nha-sach-tiki,187827390,"Gửi Tới Người Mùa Đông Này Sẽ Không Còn Nữa",95400,123000,27600,22
TIKI,nha-sach-tiki,162832796,"Rilla Dưới Mái Nhà Bên Ánh Lửa",154000,200000,46000,23
TIKI,nha-sach-tiki,3876677,"Hỏa Ngục",149000,239000,90000,38
TIKI,nha-sach-tiki,197602124,"Fullmetal Alchemist - Cang Giả Kim Thuật Sư - Fullmetal Edition - Tập 6",61100,69000,7900,11
TIKI,nha-sach-tiki,57590002,"Fullmetal Alchemist - Cang Giả Kim Thuật Sư - Fullmetal Edition Tập 5",61000,69000,8000,12
TIKI,nha-sach-tiki,106206473,"Thân Gửi Sở Thú",61100,79000,17900,23
TIKI,nha-sach-tiki,105778970,"Nhật Ký Tarot",158000,199000,41000,21
TIKI,nha-sach-tiki,23437685,"English Vocabulary in Use: Pre-Intermediate and Intermediate Book with Answers: Vocabulary Reference and Practice (Kèm CD)",177600,193000,15400,8
TIKI,nha-sach-tiki,147802908,"Trong Cái Không Có Gì Không ? - Thiền Sư Thích Nhất Hạnh (NXB KĐ - bìa cứng)",144000,160000,16000,10
TIKI,nha-sach-tiki,191571530,"Văn Phòng Thám Tử Quái Vật - Tập 09",29100,30000,900,3
TIKI,nha-sach-tiki,11336581,"Rich Habits - Thói Quen Thành Công Của Những Triệu Phú Tự Thân",110000,158000,48000,30
TIKI,nha-sach-tiki,56377199,"Giải Mã Siêu Trí Tuệ",126000,169000,43000,25
TIKI,nha-sach-tiki,83664156,"Rio Book No.2 - Nhận Diện Thương Hiệu, Những Điểm Chạm Thị Giác (Tái Bản)",127000,170000,43000,25
TIKI,nha-sach-tiki,139979522,"Ăn Dặm Kiểu Nhật (Tái Bản)",127000,189000,62000,33
TIKI,nha-sach-tiki,192474352,"Vẻ Đẹp Của Sự Vừa Đủ",114000,136000,22000,16
TIKI,nha-sach-tiki,67991600,"Nghệ Thuật Từ Chối – Cách Nói Không Mà Vẫn Có Được Đồng Thuận",56000,82000,26000,32
TIKI,nha-sach-tiki,188663311,"Khi Bạn Đang Mơ Thì Người Khác Đang Nỗ Lực (2022)",91200,136000,44800,33
TIKI,nha-sach-tiki,43859629,"Người giàu nhất thành Babylon - phiên bản đầy đủ thêm 2 chương mới",54000,80000,26000,33
TIKI,nha-sach-tiki,3640427,"Quẳng Gánh Lo Đi Và Vui Sống (Nguyễn Hiến Lê - Bộ Sách Sống Sao Cho Đúng)",56100,90000,33900,38
TIKI,nha-sach-tiki,140635218,"Nuôi Dạy Đứa Trẻ Tự Chủ",130000,179000,49000,27
TIKI,nha-sach-tiki,131879454,"Combo Philip Kotler: Tiếp Thị 5.0 - Công Nghệ Vị Nhân Sinh Và Tiếp Thị 4.0 - Dịch Chuyển Từ Truyền Thống Sang Công Nghệ Số",223250,235000,11750,5
TIKI,nha-sach-tiki,11806671,"Combo Doraemon Truyện Tranh Màu Kỹ Thuật Số (6 Tập)",161000,180000,19000,11
TIKI,nha-sach-tiki,187933551,"Reiki - Nghệ Thuật Chữa Lành Bằng Năng Lượng",131600,189000,57400,30
TIKI,nha-sach-tiki,54433518,"Combo Sách Học Tiếng Anh Little Stories 1 (5 Cuốn)",226000,325000,99000,30
TIKI,nha-sach-tiki,897016,"Combo Sân Chơi Trí Tuệ Của Chim Đa Đa (Bộ 6 Cuốn)",125000,180000,55000,31
TIKI,nha-sach-tiki,178514165,"Dọc Đường",124000,160000,36000,23
TIKI,nha-sach-tiki,192677821,"Sổ tay công thức giải nhanh Toán 12",59000,98000,39000,40
TIKI,nha-sach-tiki,168367080,"Thông Não Ielts Reading Cùng Linear",432000,499000,67000,13
TIKI,nha-sach-tiki,193917225,"Vẽ Vời Vẩn Vơ - 3",19000,58000,39000,67
TIKI,nha-sach-tiki,174449882,"“Lần Đầu Làm Sếp” – (Your First Leadership Job)",137000,195000,58000,30
TIKI,nha-sach-tiki,76278485,"Ảo Dạ (Tái Bản)",133000,179000,46000,26
TIKI,nha-sach-tiki,149257065,"Keanu Reeves - Ma Trận Cuộc Đời (Bí Ẩn Đằng Sau Người Đàn Ông Tử Tế Nhất Hành Tinh)",80000,168000,88000,52
TIKI,nha-sach-tiki,189641377,"Kombucha - Tuyệt Đỉnh Thức Uống Lên Men",249000,320000,71000,22
TIKI,nha-sach-tiki,110965784,"Keo Dán Giày Siêu Chắc Chống Nước Tốt Seaglue 100g",69000,79000,10000,13
TIKI,nha-sach-tiki,116158321,"7 Chiến Lược Thịnh Vượng Và Hạnh Phúc (Tái Bản 2021)",68000,85000,17000,20
TIKI,nha-sach-tiki,143185998,"Ăn Dặm Không Phải Là Cuộc Chiến (Tái Bản)",197000,289000,92000,32
TIKI,nha-sach-tiki,104315085,"Tư Duy Logic (Tái Bản)",71800,110000,38200,35
TIKI,nha-sach-tiki,150956757,"Combo 8 cuốn Túi tô màu Tập làm họa sĩ nhí",43680,84000,40320,48
TIKI,nha-sach-tiki,65786287,"Triệu phú thức tỉnh - bí kíp để khơi dòng suối nguồn thịnh vượng trong tâm thức",214400,268000,53600,20
TIKI,nha-cua-doi-song,48967324,"Khóa Vali Khóa Balo Mã Số Chữ Thập",29000,29000,0,0
TIKI,nha-cua-doi-song,164479566,"Ghế chỉnh dáng ngồi đúng - Roichen Hàn Quốc (Made in Korea). Dùng cho Nam, Nữ, Trẻ em. Hàng chính hãng",710000,750000,40000,5
TIKI,nha-cua-doi-song,67299755,"Giấy nến đục lỗ lót nồi chiên không dầu loại 4 lít, 4.5 lít, 5 lít, 6.5 lít - Size 21cm - 100 tờ - siêu tiện dung",29000,29000,0,0
TIKI,nha-cua-doi-song,71925401,"Đèn Bàn Học Đọc Sách, Đèn Bàn Làm Việc Sang Trọng, Đèn Ngủ Cao Cấp (Học Sinh, Sinh Viên, Văn Phòng) LED Chống Cận 03 Mức Độ Sáng, Cảm Ứng Tích Điện Pin 2500mAh - Hàng Chính Hãng - VinBuy",123000,260000,137000,53
TIKI,nha-cua-doi-song,52238368,"Chiếu điều hòa cao cấp Ánh Sao - Sợi mây tổng hợp + Tặng kèm túi thơm thảo dược - giao mẫu ngẫu nhiên",130000,140000,10000,7
TIKI,nha-cua-doi-song,169919224,"Kệ Để Kem Đánh Răng & Bàn Chải, Tặng Kèm Cốc - Kệ Nhà Tắm Dán Tường Thông Minh - Giá Treo Bàn Chải Đánh Răng Kiêm Để Đồ & Úp Cốc - Giao Màu Ngẫu Nhiên [HÀNG CHÍNH HÃNG",99000,120000,21000,18
TIKI,nha-cua-doi-song,19867726,"Võng lưới mềm dày 99, gỗ 50 (Giao màu ngẫu nhiên)",208000,350000,142000,41
TIKI,nha-cua-doi-song,75659112,"Kệ Sách Tổ Ong IGEA Đa Tầng Convent 234F - GP100",181000,198000,17000,9
TIKI,nha-cua-doi-song,53497035,"40 VIÊN PIN MAXELL AAA TEM BẠC - HÀNG CHÍNH HÃNG",51400,51400,0,0
TIKI,nha-cua-doi-song,54460849,"Bộ chăn ga gối cotton LIDACO PL1 - Caro Nâu (SP000661)",195000,276000,81000,29
TIKI,nha-cua-doi-song,67650750,"Đệm ngồi lót ghế làm từ hợp chất TPE, thoáng khí, hỗ trợ tuần hoàn máu, chống ê mông, mỏi lưng - Thương hiệu Nhà của Mẹ- giao màu ngẫu nhiên",153000,160000,7000,4
TIKI,nha-cua-doi-song,135442410,"Máy Đo Khoảng Cách Laser Deli Chính Hãng Loại 40m / 50m / 60m Đa Năng - Dễ Dàng Sử Dụng Từ Xa - DL331050P / EDL4168",488000,896000,408000,46
TIKI,nha-cua-doi-song,58546654,"Đèn Pixar, Đèn Học Chống Cận Thị, Đèn Đọc Sách, Đèn Làm Việc Để Bàn Chống Chói Mắt Lóa Mắt Bảo Vệ Mắt + Bóng Đèn + Chân Kẹp + Chân Đế - Hàng Chính Hãng Amalife",165000,165000,0,0
TIKI,nha-cua-doi-song,152784110,"Khay Đá Silicon Có Nắp Đậy 14 Viên, Khay Đựng Đá Tủ Lạnh, Làm Đá Thạch Kem Bảo Quản Chống Mùi Tuyệt Đối- Hàng Loại 1",49000,49000,0,0
TIKI,nha-cua-doi-song,51373821,"Đèn bàn học led cảm ứng chính hãng Rạng Đông Model: RD RL 36 LED",203000,203000,0,0
TIKI,nha-cua-doi-song,55124901,"Thùng Rác Mini Phòng Ngủ, Toilet, Xe Hơi Khả Năng Giữ Mùi 90",100000,100000,0,0
TIKI,nha-cua-doi-song,57335326,"Ghế xếp thư giãn SUMIKA 179A - Khóa kim loại, khung thép tròn, tải trọng 200kg",765000,1000000,235000,24
TIKI,nha-cua-doi-song,686906,"Hộp Thủy Tinh Cao Tròn Glasslock MCCD072 (720ml)",144000,194000,50000,26
TIKI,nha-cua-doi-song,141201958,"Ly Giữ Nhiệt Cà Phê Có Tay Cầm Nắp Trượt Chống Tràn Rinfere (415ml)",295000,449000,154000,34
TIKI,nha-cua-doi-song,163304843,"Máy phun rửa áp lực cao Karcher K2 Classic ",2222700,2390000,167300,7
TIKI,nha-cua-doi-song,52789105,"Đế Bình Giữ Nhiệt Silicone Boot 2GOOD Flask 900ml",50000,50000,0,0
TIKI,nha-cua-doi-song,241806648,"Móc Dán Tường Treo Chậu Rổ, Treo Đồ Đa Năng Inox 304 Jodily Sử Dụng Miếng Dán Thế Hệ Mới",20000,20000,0,0
TIKI,nha-cua-doi-song,68413077,"Đèn đọc sách mini, pin sạc tiện dụng Baseus Comfort Reading Mini Clip Lamp ( Dịu mắt, chân kẹp, 3 mức sáng, 350mAh, 24h sử dụng)hàng nhập khẩu",215000,249000,34000,14
TIKI,nha-cua-doi-song,263990262,"Lọ xay tiêu Inox 304 DandiHome cao cấp",56000,65000,9000,14
TIKI,nha-cua-doi-song,188375839,"Khăn tắm Khăn lau mặt Cotton 100% Mềm Êm Dày dặn Màu trơn Nhấn viền họa tiết 74x33cm",49000,49000,0,0
TIKI,nha-cua-doi-song,111410597,"Kính bảo hộ Honeywell A700 Mắt kính chống bụi, chống tia UV, chống trầy xước, đọng sương",77900,82000,4100,5
TIKI,nha-cua-doi-song,20103667,"Combo Cọ Rửa Dành Cho Ống Hút Inox và Ống Hút Thủy Tinh",28000,28000,0,0
TIKI,nha-cua-doi-song,143002904,"Ổ  điện đa năng shoptida hình tháp nhiều tầng T8/ T12 chịu tải 3600W, an toàn chống cháy chống giật, dây dài 3m và 4m",549000,579000,30000,5
TIKI,nha-cua-doi-song,178101136,"Bơm điện 2 chiều bơm và hút chân không cao cấp miDoctor",97000,180000,83000,46
TIKI,nha-cua-doi-song,250512089,"Kéo cắt cành cộng lực chuyên dụng Germany -dụng cụ làm vườn đa năng",162000,280000,118000,42
TIKI,nha-cua-doi-song,47163069,"Túi Đựng Chăn Mền Quần Áo Kháng Mốc Cỡ Lớn Nhiều Màu",58000,58000,0,0
TIKI,nha-cua-doi-song,78633940,"Máy Sấy Và Khử Trùng Giày Xiaomi Youpin SOTHING DSHJ-S-1904 có hẹn giờ",259000,269000,10000,4
TIKI,nha-cua-doi-song,189339895,"Đèn LED Mini Móc Khóa - Đèn Pin COB - Đèn Pin Dã Ngoại - Sạc Type C Tiện Dụng",30400,32000,1600,5
TIKI,nha-cua-doi-song,44803282,"Bàn Làm Việc Có Kệ Sách Mẫu Mới",262500,350000,87500,25
TIKI,nha-sach-tiki,173093792,"Thao Túng Tâm Lý - Nhận Diện, Thức Tỉnh Và Chữa Lành Những Tổn Thương Tiềm Ẩn",126800,169000,42200,25
TIKI,nha-sach-tiki,13673970,"Combo Trinh Thám Giây Thứ 12 (2 Tập)",95000,276000,181000,66
TIKI,nha-cua-doi-song,117645437,"Ổ cắm điện LiOA đa năng kết hợp - 2D2S, 3D3S, 4D6S dây dài 3m/5m - Ổ cắm điện Lioa Chính Hãng",85000,85000,0,0
TIKI,nha-sach-tiki,170463582,"Siêu Nhí Biết Tuốt - 101 Bí Ẩn Kích Thích Tò Mò Của Các Bạn Nhỏ",124800,240000,115200,48
TIKI,nha-sach-tiki,26593338,"Misty Morning Walk With Mother - Cùng Mẹ Đi Trong Sương Sớm",41000,85000,44000,52
TIKI,nha-sach-tiki,335337,"Tôi Tài Giỏi - Bạn Cũng Thế",128050,135000,6950,5
TIKI,nha-cua-doi-song,152789537,"Combo 5 Đôi Đũa Thủy Tinh Đầu Đũa Vạt Xéo Trang Trí Họa Tiết Nhật Bản Phủ Bóng",70000,70000,0,0
TIKI,nha-sach-tiki,117035933,"Sách: Hài Hước Một Chút Thế Giới Sẽ Khác Đi (Tái Bản)",64000,80000,16000,20
TIKI,nha-cua-doi-song,171797241,"{XẢ KHO} Cây Lau Nhà Thông Minh, Tự Động Tách Nước Bẩn, Tự Động Vắt Khô, Xoay 360 độ Hatachi  HTC - V6 - HÀNG CHÍNH HÃNG",512050,539000,26950,5
TIKI,nha-sach-tiki,77324132,"Phụ Nữ Hiểu Biết Sẽ Có Cuộc Sống Đẳng Cấp Hơn (Tặng Kèm Bookmark)",85900,119000,33100,28
TIKI,nha-sach-tiki,109018530,"Vườn Hoa Mạt Dược Ký Sự - Những Kỳ Án Nổi Tiếng Chưa Có Lời Giải (Tặng Kèm 1 Bookmark Chữ Nhật)",90100,139000,48900,35
TIKI,nha-cua-doi-song,16196661,"Bộ Tua Vít Đa Năng Tua Vít 25 Đầu Trong 1 Screwdriver",28044,28044,0,0
TIKI,nha-cua-doi-song,41318920,"Bộ chặn cửa chống va đập nam châm hít cửa dán sàn Hobby Home Decor CC1 inox 304 kèm keo dán sàn",82000,139000,57000,41
TIKI,nha-sach-tiki,187619074,"Quý Cô Tài Chính",103000,139000,36000,26
TIKI,nha-sach-tiki,185595374,"Picasso Và Bức Tranh Khiến Thế Giới Sửng Sốt",299000,399000,100000,25
TIKI,nha-sach-tiki,117681065,"Sống Thực Tế Giữa Đời Thực Dụng (Tái Bản)",92400,129000,36600,28
TIKI,nha-sach-tiki,95090377," Bút màu sáp dầu học sinh hộp nhựa Deli - 12/18/24 màu - 72090/72091/72092",52200,52200,0,0
TIKI,nha-sach-tiki,87389629,"OSHO - Sáng Tạo Bừng Cháy Sức Mạnh Bên Trong (Tái Bản)",72500,108000,35500,33
TIKI,nha-sach-tiki,189371286,"[ Gift] [Hàng Tặng Không Bán] Sổ Tay Sức Khỏe DHC",50000,50000,0,0
TIKI,nha-sach-tiki,195801645,"Thực Học Của Inamori Kazuo: Quản Trị Và Kế Toán",64000,95000,31000,33
TIKI,nha-sach-tiki,126853168,"Thấu hiểu Hành vi giá Thị trường Tài chính (Understanding Price Action)",367000,367000,0,0
TIKI,nha-sach-tiki,75403873,"Bộ Màu Nước Solid Water Color Cao Cấp - Tặng Kèm 2 Bút Nước, 2 Mút, 1 Palette - Chuyên Dùng Cho Học Sinh, Sinh Viên, Vẽ Chuyên Nghiệp - Hàng Chính Hãng - VinBuy",65000,120000,55000,46
TIKI,nha-sach-tiki,137241842,"Trồng Một Nụ Cười - Cùng Trẻ Thực Hành Chánh Niệm",138000,199000,61000,31
TIKI,nha-sach-tiki,58441509,"Ăn Uống Đúng Cách: Bộ Quy Tắc Ẩm Thực Lành Mạnh",86500,116000,29500,25
TIKI,nha-sach-tiki,32192510,"Madame Chic - Rất Thần Thái, Rất Paris",64000,99000,35000,35
TIKI,nha-sach-tiki,130314065,"Tâm lý thị trường chứng khoán - Hành vi đám đông và sự thật đằng sau những con sóng",37100,50000,12900,26
TIKI,nha-cua-doi-song,72459016,"Bộ Nhả Kem Đánh Tự Động OENON, Kệ Treo Bàn Chải Nhà Tắmg Dán Tường Kèm Cốc Hút Từ Tính - OEKEM",99000,190000,91000,48
TIKI,nha-sach-tiki,107802188,"Bí Mật Tư Duy Triệu Phú (Tái Bản)",75100,108000,32900,30
TIKI,nha-sach-tiki,75813201,"Không Đến Một (Tái Bản - Bìa Cam)",79200,110000,30800,28
TIKI,nha-sach-tiki,195306000,"Tư trị thông giám - Tập 9",211000,285000,74000,26
TIKI,nha-sach-tiki,56878836,"Sách Muôn Kiếp Nhân Sinh (Bìa Cứng) - Nguyên Phong",169000,228000,59000,26
TIKI,nha-sach-tiki,49249526,"Thiết Kế Cuộc Đời Thịnh Vượng - Design a Prosperous Life",299000,299000,0,0
TIKI,nha-sach-tiki,95090744," Bút chì lục giác Deli - loại 2B/HB - 30 chiếc/hộp - 58166 / 58167",45000,99000,54000,55
TIKI,nha-sach-tiki,142002263,"Muôn Kiếp Nhân Sinh 2 (Bìa Cứng)",338000,338000,0,0
TIKI,nha-sach-tiki,174038838,"Here U Are – Tập 2 - Bản Thường: Tặng Kèm 1 Bookmark Bế Hình",88100,110000,21900,20
TIKI,nha-sach-tiki,193684717,"Từ Vũ Trụ Đến Trái Tim – Những Thông Điệp Yêu Thương",88500,89000,500,1
TIKI,nha-sach-tiki,170094968,"Atlas Giải Phẫu Cơ Thể Người - Tái Bản",502000,680000,178000,26
TIKI,nha-sach-tiki,67477613,"Xin Bạn Hãy Ôm Lấy Trái Tim Mình Trước Đã (Tặng Kèm 1 Bookmark)",64800,96000,31200,33
TIKI,nha-sach-tiki,174377494,"Combo 10 cuốn Ehon Ươm mầm Tính cách",202800,390000,187200,48
TIKI,nha-sach-tiki,190214568,"Kỷ luật bản thân",132300,189000,56700,30
TIKI,nha-sach-tiki,107363748,"Bút chì màu dạng cốc Deli - bút chì gỗ khô tự nhiên an toàn -  12/24/36/48 màu - 7070",52200,52200,0,0
TIKI,nha-sach-tiki,41131985,"Thực Hành 7 Thói Quen Của Bạn Trẻ Thành Đạt",54100,78000,23900,31
TIKI,nha-sach-tiki,191506179,"Sách Bạn Thật Sự Là Ai?",60600,88000,27400,31
TIKI,nha-sach-tiki,193981046,"Tiệm trừ yêu kì ảo - Tập 17",33000,35000,2000,6
TIKI,nha-sach-tiki,176473191,"Bút màu marker lẻ chiếc 2 đầu to nhỏ nhiều màu thân bút vuông màu đen Deli - Tô màu vẽ tranh trang trí sổ tay - 70701",4000,9000,5000,56
TIKI,nha-sach-tiki,185024355,"Spy X Family 7",25000,25000,0,0
TIKI,nha-sach-tiki,185889844,"Tại Sao Chúng Tôi Muốn Bạn Giàu",89000,135000,46000,34
TIKI,nha-sach-tiki,177736624,"Mặc Kệ Thiên Hạ - Sống Như Người Nhật (Tái Bản)",71000,94000,23000,24
TIKI,nha-sach-tiki,195291930,"Bốn Thỏa Ước",84000,130000,46000,35
TIKI,nha-sach-tiki,121372698,"NGÀI CÓC ĐI GẶP BÁC SĨ TÂM LÝ ( BÌA CỨNG)",152500,219000,66500,30
TIKI,nha-sach-tiki,178032047,"Fullmetal Alchemist - Cang Giả Kim Thuật Sư - Fullmetal Edition Tập 14 [Tặng Kèm Bookmark Pvc]",61100,69000,7900,11
TIKI,nha-sach-tiki,58971674,"Sách Nghệ Thuật Bán Hàng Của Người Do Thái (Tái Bản 2020)",61100,88000,26900,31
TIKI,nha-sach-tiki,193605360,"Chuyện Xưa Tôi Nhớ Người Cũ Đã Quên (Lam – Lê)",64500,89000,24500,28
TIKI,nha-sach-tiki,65008052,"Từ Điển Anh - Anh - Việt",208600,298000,89400,30
TIKI,nha-sach-tiki,52798281,"Phương Pháp Giáo Dục Sớm Montessori Cho Trẻ Từ
0 – 3 Tuổi",63000,99000,36000,36
TIKI,nha-sach-tiki,184782104,"Cha Mẹ Độc Hại (Tái Bản)",110000,148000,38000,26
TIKI,nha-sach-tiki,148802204,"Chuyện Trà - Lịch Sử Một Thức Uống Lâu Đời Của Người Việt (Bìa Mềm)",216000,290000,74000,26
TIKI,nha-sach-tiki,165030714,"Black Jack 07 (Bìa Mềm)",28000,30000,2000,7
TIKI,nha-sach-tiki,192909296,"Anh Em Phi Hành Gia - Tập 31",32500,45000,12500,28
TIKI,nha-sach-tiki,1734377,"Những Chú Chó Bán Hàng",89000,140000,51000,36
TIKI,nha-sach-tiki,85923342,"Minh Triết Trong Ăn Uống Của Phương Đông (Tái Bản)",122000,168000,46000,27
TIKI,nha-sach-tiki,121185868,"Vang Bóng Một Thời (Việt Nam Danh Tác)",58000,76000,18000,24
TIKI,nha-sach-tiki,163165281,"Mong Mẹ Hãy Yêu Lấy Chính Mình",72100,99000,26900,27
TIKI,nha-sach-tiki,84950236,"Người Nhạy Cảm Trong Thế Giới Vô Cảm",56100,85000,28900,34
TIKI,nha-sach-tiki,191571328,"Black Jack (Bản Đặc Biệt) - Tập 12",134000,135000,1000,1
TIKI,nha-sach-tiki,104273017,"Combo 2 Tập: Tăng Thông Khí - Bản Thường - (Tặng Kèm 2 Bookmark In 2 Mặt)(Bìa Mềm)",181000,258000,77000,30
TIKI,nha-sach-tiki,467896,"Trà Hoa Nữ (Tái Bản)",33000,50000,17000,34
TIKI,nha-sach-tiki,186202768,"Và Rồi Tháng 9 Không Có Cậu Đã Tới (Tái Bản)",75800,106000,30200,28
TIKI,nha-sach-tiki,184779709,"Xã Hội Học - Khái Lược Những Tư Tưởng Lớn",284000,390000,106000,27
TIKI,nha-sach-tiki,74981856,"Gửi Bạn, Người Đã Kiệt Sức Vì Những Chịu Đựng Âm Thầm [Tặng Kèm: 1 Bookmark Daisy]",66700,96000,29300,31
TIKI,nha-sach-tiki,9490657,"Hệ thống giao dịch Ichimoku Charts - Ichimoku Kinko Clouds (Phiên bản sách năm 2018)",330000,330000,0,0
TIKI,nha-sach-tiki,127077157,"Bà Tổng Thống Trước Họng Súng - Hai Số Phận - Phần III",114000,169000,55000,33
TIKI,nha-sach-tiki,7644510,"Lòng Tốt Của Bạn Cần Thêm Đôi Phần Sắc Sảo",80500,108000,27500,25
TIKI,nha-sach-tiki,28292286,"Combo 30 Chủ Đề Từ Vựng Tiếng Anh (2 Tập)",245000,380000,135000,36
TIKI,nha-sach-tiki,185435293,"Nhân Sinh Nơi Nơi Đều Là Tu Hành ( Tặng 1 Bookmark 02 mặt + 1 Sổ phụ chương khổ 12x16cm)",144000,145000,1000,1
TIKI,nha-sach-tiki,174215331,"Ajin - Boxset Số 2 (Tập 7 - 12) - Tặng Kèm Bookmark 3D",214000,300000,86000,29
TIKI,nha-sach-tiki,184629090,"Lấy Nước Đường Xa",68800,99000,30200,31
TIKI,nha-sach-tiki,186265452,"My Hero Academia - Học Viện Siêu Anh Hùng Tập 29: Bakugo Katsuki: Trỗi Dậy",25000,25000,0,0
TIKI,nha-sach-tiki,167686691,"Sách Tổng Ôn Cấp Tốc Toán Học 12, Sách Ôn Thi THPT Quốc Gia Moon",149000,200000,51000,26
TIKI,nha-sach-tiki,114765005,"Vụng Trộm Yêu Anh - Tập 1+2 (Tặng Kèm: 02 Bookmark 2 Mặt Theo Bìa)",178000,249000,71000,29
TIKI,nha-sach-tiki,69624539,"Khoa Học Về Yoga",223000,300000,77000,26
TIKI,nha-sach-tiki,75636226,"Phương pháp VPA - Kỹ thuật nhận diện Dòng Tiền Thông Minh bằng Hành Động Giá kết hợp Khối Lượng Giao Dịch",357000,357000,0,0
TIKI,nha-sach-tiki,187001113,"Giấy bọc sách vở / Giấy gói quà / giấy bao tập / giấy bao vở học sinh, sinh viên size A4, B5, A5 cao cấp – 24 cuốn",49000,88000,39000,44
TIKI,nha-sach-tiki,110447680,"Kế Hoạch Marketing Trên Một Trang Giấy (Những Chỉ Dẫn Dễ Hiểu Nhất Cho Một Kế Hoạch Marketing Thông Minh)",104200,159000,54800,34
TIKI,nha-sach-tiki,146223395,"Cách thức kinh doanh và đầu cơ cổ phiếu! – How to Trade in Stocks",349000,349000,0,0
TIKI,nha-sach-tiki,13061338,"Series Địch Công Kỳ Án Tập 15 - Hoa Văn Cây Liễu",49500,99000,49500,50
TIKI,dien-thoai-may-tinh-bang,271046571,"Điện thoại Xiaomi Redmi Note 12 (8GB/128GB) - Hàng chính hãng",3790000,4530000,740000,16
TIKI,dien-thoai-may-tinh-bang,173387789,"Máy đọc sách All New Kindle Oasis 3 - Hàng nhập khẩu",5790000,5790000,0,0
TIKI,dien-thoai-may-tinh-bang,184059211,"Apple iPhone 13",13990000,24990000,11000000,44
TIKI,dien-thoai-may-tinh-bang,184036446,"Apple iPhone 11",11490000,15999000,4509000,28
TIKI,dien-thoai-may-tinh-bang,273947792,"Điện thoại AI Samsung Galaxy S24 Ultra 12GB/256GB, Camera 200MP Zoom 100x, S Pen- Vàng- Hàng Chính Hãng",33830000,34490000,660000,2
TIKI,dien-thoai-may-tinh-bang,252586291,"Máy đọc sách All New Kindle Paperwhite 5 (11th Gen) - Hàng chính hãng",3790600,3990000,199400,5
TIKI,dien-thoai-may-tinh-bang,163914808,"Điện thoại bàn Panasonic  KX-TS500MX-hàng chính hãng",300000,300000,0,0
TIKI,dien-thoai-may-tinh-bang,183330021,"Apple iPad 10.2-inch (9th Gen) Wi-Fi 2021",6990000,10990000,4000000,36
TIKI,dien-thoai-may-tinh-bang,120295859,"Điện Thoại Nokia C30 (2GB/32GB) - Hàng Chính Hãng",1490000,1990000,500000,25
TIKI,dien-thoai-may-tinh-bang,57809866,"Điện thoại Xiaomi Redmi 9A (2GB/32GB)",1690000,2490000,800000,32
TIKI,dien-thoai-may-tinh-bang,272113804,"[MỚI] Điện thoại vivo Y17s - Hàng chính hãng - Camera 50MP - Pin 5000 mAh - Sạc nhanh- RAM mở rộng đến 8GB",3990000,3990000,0,0
TIKI,dien-thoai-may-tinh-bang,125182567,"Máy đọc sách All New Kindle Paperwhite 5 (11th Gen) - Hàng nhập khẩu",3950000,3950000,0,0
TIKI,dien-thoai-may-tinh-bang,125182567,"Máy đọc sách All New Kindle Paperwhite 5 (11th Gen) - Hàng nhập khẩu",4600000,4600000,0,0
TIKI,dien-thoai-may-tinh-bang,139632023,"Máy đọc sách Kobo Libra 2 - hàng nhập khẩu",5199000,5800000,601000,10
TIKI,dien-thoai-may-tinh-bang,242434782,"Máy đọc sách New Kindle 11th 2022 (16GB) - Hàng nhập khẩu",2920000,2920000,0,0
TIKI,dien-thoai-may-tinh-bang,184248127,"Apple iPad mini (6th Gen) Wi-Fi 2021",11490000,14990000,3500000,23
TIKI,dien-thoai-may-tinh-bang,217640502,"Máy đọc sách Kindle Scribe - Hàng chính hãng",12590000,12590000,0,0
TIKI,dien-thoai-may-tinh-bang,214756058,"Máy đọc sách New Kindle 11th 2022 (16GB) - Hàng chính hãng",2920000,2920000,0,0
TIKI,dien-thoai-may-tinh-bang,73842403,"Điện thoại bàn có dây nhỏ gọn màu trắng",250000,250000,0,0
TIKI,dien-thoai-may-tinh-bang,201067649,"Combo máy đọc sách Kindle Paperwhite 5 (11th gen) tặng kèm bao da ( Cover ) - Hàng nhập khẩu",3760000,3990000,230000,6
TIKI,dien-thoai-may-tinh-bang,43924153,"Máy đọc sách Kindle Oasis 3 (2019) - Amazon - Hàng nhập khẩu",5790000,5790000,0,0
TIKI,dien-thoai-may-tinh-bang,31261844,"Điện Thoại Bàn Cố Định Không Dây Lắp Sim",650000,650000,0,0
TIKI,dien-thoai-may-tinh-bang,197960169,"Điện thoại Masstel Lux 10 4G - Sang trọng - Gọi HD Call - Hàng chính hãng",538000,700000,162000,23
TIKI,dien-thoai-may-tinh-bang,42333095,"Điện thoại cố định không dây cho người già, màn hình hiển thị đầu số - Hàng chính hãng",490000,490000,0,0
TIKI,dien-thoai-may-tinh-bang,273947785,"Điện thoại AI Samsung Galaxy S24+ 12GB/256GB, Camera 50MP, Màn hình 6.7"- Đen- Hàng Chính Hãng",25490000,27490000,2000000,7
TIKI,dien-thoai-may-tinh-bang,201067649,"Combo máy đọc sách Kindle Paperwhite 5 (11th gen) tặng kèm bao da ( Cover ) - Hàng nhập khẩu",3849000,4100000,251000,6
TIKI,dien-thoai-may-tinh-bang,170165701,"Điện thoại bàn Ktel 645 hàng chính hãng",398000,398000,0,0
TIKI,dien-thoai-may-tinh-bang,252586291,"Máy đọc sách All New Kindle Paperwhite 5 (11th Gen) - Hàng chính hãng",3790600,3990000,199400,5
TIKI,dien-thoai-may-tinh-bang,204237269,"Điện Thoại Bàn Panasonic KX-TSC11 - Hàng Chính Hãng - Trắng",600000,600000,0,0
TIKI,dien-thoai-may-tinh-bang,197652030,"Điện thoại Masstel Lux 20 4G - Sang trọng - Gọi HD Call - Hàng chính hãng",567000,800000,233000,29
TIKI,dien-thoai-may-tinh-bang,121744434,"Điện Thoại Xiaomi Redmi 10 4GB/128GB - Hàng Chính Hãng",2949000,4290000,1341000,31
TIKI,dien-thoai-may-tinh-bang,126050455,"Điện thoại Nokia C20 (2GB/16GB) - Hàng Chính Hãng",1290000,2290000,1000000,44
TIKI,dien-thoai-may-tinh-bang,181452535,"Điện thoại Itel it9200 4G - WIFI - Xem YTB , FB - Hàng chính hãng",547000,790000,243000,31
TIKI,dien-thoai-may-tinh-bang,209872337,"Máy đọc sách Kindle 2022 (11th) - All new kindle 2022 11th màn hình 6inch 300PPI gấp 2 lần độ sắc nét, 16GB bộ nhớ trong với cổng kết nối USB-C - Hàng nhập khẩu",2920000,2920000,0,0
TIKI,dien-thoai-may-tinh-bang,217645692,"Combo Máy đọc sách All New Kindle Paperwhite 5 (11th Gen) - 16Gb và Bao da - Hàng nhập khẩu",3980000,3980000,0,0
TIKI,dien-thoai-may-tinh-bang,168526284,"Điện thoại Nokia 105 4G - Hàng chính hãng",675000,769000,94000,12
TIKI,dien-thoai-may-tinh-bang,189466001,"Điện thoại Xiaomi Redmi 10A (2GB/32GB) - Hàng chính hãng",1949000,2890000,941000,33
TIKI,dien-thoai-may-tinh-bang,167466044,"Điện thoại Masstel FAMI 60 4G Pin 2000 mah - Hàng chính hãng",636000,750000,114000,15
TIKI,dien-thoai-may-tinh-bang,181266509,"Điện thoại Ulefone Armor 14 pro (chống nước,chống va đập,pin khủng,pin 10.000mAh,Ram 8Gb,Rom 128Gb)- hàng chính hãng",5990000,5990000,0,0
TIKI,dien-thoai-may-tinh-bang,173387789,"Máy đọc sách All New Kindle Oasis 3 - Hàng nhập khẩu",5790000,5790000,0,0
TIKI,dien-thoai-may-tinh-bang,123345348,"Apple iPhone 12",11490000,16990000,5500000,32
TIKI,dien-thoai-may-tinh-bang,181977398,"Điện thoại bàn Panasonic KX-TS880 hàng chính hãng",1050000,1050000,0,0
TIKI,dien-thoai-may-tinh-bang,172329599,"Điện thoại Xiaomi Redmi 9A (2GB/32GB) - Hàng chính hãng",1754000,2199000,445000,20
TIKI,dien-thoai-may-tinh-bang,43924153,"Máy đọc sách Kindle Oasis 3 (2019) - Amazon - Hàng nhập khẩu",5790000,5790000,0,0
TIKI,dien-thoai-may-tinh-bang,29931445,"Ulefone Armor X 5 ( chống nước,chống va đập,pin 5.000mAh ) hàng chính hãng",3990000,3990000,0,0
TIKI,dien-thoai-may-tinh-bang,197654695,"Điện thoại Masstel izi 26 4G - Gọi HD Call - Hàng chính hãng",489000,650000,161000,25
TIKI,dien-thoai-may-tinh-bang,140940220,"Máy đọc sách Kobo Sage - hàng nhập khẩu",8679000,8679000,0,0
TIKI,dien-thoai-may-tinh-bang,11415485,"ĐIỆN THOẠI CỐ ĐỊNH PANASONIC KX-TS580MX",940000,940000,0,0
TIKI,dien-thoai-may-tinh-bang,173557858,"Máy tính bảng Kindle File HD 8 (10th generation - 2020) Hàng nhập khẩu",2250000,2250000,0,0
TIKI,dien-thoai-may-tinh-bang,217706932,"Combo Máy đọc sách All New Kindle Paperwhite 5 (11th Gen) và Bao da - Hàng nhập khẩu",3980000,3980000,0,0
TIKI,dien-thoai-may-tinh-bang,184578632,"Điện thoại Itel it9010 4G - Hàng chính hãng",399000,399000,0,0
TIKI,dien-thoai-may-tinh-bang,125590981,"Điện thoại Nokia C30 2GB/32GB - Hàng chính hãng",1550000,1550000,0,0
TIKI,dien-thoai-may-tinh-bang,195317118," Máy tính bảng Oppo Pad Air (4GB/64GB) - Hàng Chính Hãng",4990000,6999000,2009000,29
TIKI,dien-thoai-may-tinh-bang,270794184,"Máy đọc sách Kobo Clara - Hàng Chính Hãng",2899000,2925000,26000,1
TIKI,dien-thoai-may-tinh-bang,150724369,"Máy tính bảng Fire HD10 2021 - 11th - (All New Fire HD10 - 2021) - Ram 3/4GB, bộ nhớ 32GB, màn hình 1080 FullHD",3115000,3500000,385000,11
TIKI,dien-thoai-may-tinh-bang,271046571,"Điện thoại Xiaomi Redmi Note 12 (8GB/128GB) - Hàng chính hãng",3790000,4530000,740000,16
TIKI,dien-thoai-may-tinh-bang,209872337,"Máy đọc sách Kindle 2022 (11th) - All new kindle 2022 11th màn hình 6inch 300PPI gấp 2 lần độ sắc nét, 16GB bộ nhớ trong với cổng kết nối USB-C - Hàng nhập khẩu",2920000,2920000,0,0
TIKI,dien-thoai-may-tinh-bang,273947792,"Điện thoại AI Samsung Galaxy S24 Ultra 12GB/256GB, Camera 200MP Zoom 100x, S Pen- Vàng- Hàng Chính Hãng",33830000,34490000,660000,2
TIKI,dien-thoai-may-tinh-bang,125182567,"Máy đọc sách All New Kindle Paperwhite 5 (11th Gen) - Hàng nhập khẩu",3690000,3690000,0,0
TIKI,dien-thoai-may-tinh-bang,273947785,"Điện thoại AI Samsung Galaxy S24+ 12GB/256GB, Camera 50MP, Màn hình 6.7"- Đen- Hàng Chính Hãng",25490000,27490000,2000000,7
TIKI,dien-thoai-may-tinh-bang,167465704,"Điện thoại Masstel IZI 20 4G , Pin 1700 mAh - Hàng chính hãng",399000,499000,100000,20
TIKI,dien-thoai-may-tinh-bang,173387789,"Máy đọc sách All New Kindle Oasis 3 - Hàng nhập khẩu",5880000,5880000,0,0
TIKI,dien-thoai-may-tinh-bang,117929342,"Điện thoại Panasonic KX-TSC11MX -Hàng chính hãng",599000,599000,0,0
TIKI,dien-thoai-may-tinh-bang,170448099,"Điện Thoại Người Già Masstel Fami 60 4G - Loa To, FM Không Dây, Đọc Số Bằng Giọng Nói, SOS, Đèn Pin Kép,... Hàng Chính Hãng",679000,882000,203000,23
TIKI,dien-thoai-may-tinh-bang,217640502,"Máy đọc sách Kindle Scribe - Hàng chính hãng",12590000,12590000,0,0
TIKI,dien-thoai-may-tinh-bang,23142193,"Điện thoại bàn không dây Panasonic KX-TGC313 - Hàng Chính Hãng",2100000,2100000,0,0
TIKI,dien-thoai-may-tinh-bang,197666071,"Điện thoại Masstel Fami 65 4G - Tặng dock sạc - Gọi HD Call - Hàng chính hãng",656000,900000,244000,27
TIKI,dien-thoai-may-tinh-bang,272113804,"[MỚI] Điện thoại vivo Y17s - Hàng chính hãng - Camera 50MP - Pin 5000 mAh - Sạc nhanh- RAM mở rộng đến 8GB",3990000,3990000,0,0
TIKI,dien-thoai-may-tinh-bang,217645692,"Combo Máy đọc sách All New Kindle Paperwhite 5 (11th Gen) - 16Gb và Bao da - Hàng nhập khẩu",3980000,3980000,0,0
TIKI,dien-thoai-may-tinh-bang,194498804,"Máy Tính Bảng OPPO Pad Air (4GB/64GB) | Màn Hình 2K 1 tỷ Màu | Chip Snapdragon 680 | Hàng Chính Hãng",4990000,6990000,2000000,29
TIKI,dien-thoai-may-tinh-bang,155833852,"Điện Thoại Masstel Hapi 30 3GB/32GB - Hàng Chính Hãng",1879000,2390000,511000,21
TIKI,dien-thoai-may-tinh-bang,242434782,"Máy đọc sách New Kindle 11th 2022 (16GB) - Hàng nhập khẩu",2920000,2920000,0,0
TIKI,dien-thoai-may-tinh-bang,148701811,"Máy đọc sách Kobo Nia - Hàng nhập khẩu",2680000,2680000,0,0
TIKI,dien-thoai-may-tinh-bang,4048581,"Điện Thoại Bàn Panasonic KX-TSC11",689000,689000,0,0
TIKI,dien-thoai-may-tinh-bang,151463645,"Điện thoại Bphone A60 (Ram 6Gb,Rom 128 Gb,màn hình đục lổ FHD 6.7inch , pin 5.000mAh ) - Hàng chính hãng",6490000,6490000,0,0
TIKI,dien-thoai-may-tinh-bang,74776150,"Máy đọc sách Kobo Libra H20 8GB Trắng/Đen có đèn nền vàng, chống nước - Hàng nhập khẩu",4499000,4499000,0,0
TIKI,dien-thoai-may-tinh-bang,185755283,"Máy đọc sách Onyx Boox Nova Air - Hàng chính hãng",9860000,9860000,0,0
TIKI,dien-thoai-may-tinh-bang,217706932,"Combo Máy đọc sách All New Kindle Paperwhite 5 (11th Gen) và Bao da - Hàng nhập khẩu",3980000,3980000,0,0
TIKI,nha-cua-doi-song,5146283,"Ấm đun nước Inox 304 Elmich 3L EL3373 dùng bếp từ",643000,890000,247000,28
TIKI,dien-thoai-may-tinh-bang,176909016,"Máy tính bảng HANET Smart Edu Tablet Model T432 - Hàng Chính Hãng",3300000,3300000,0,0
TIKI,dien-thoai-may-tinh-bang,125753291,"Điện thoại Nokia 105 4G - Hàng chính hãng",629000,629000,0,0
TIKI,dien-thoai-may-tinh-bang,72290345,"Máy đọc sách Kobo Clara HD 8GB đen, 6 inch, có đèn cam - Hàng nhập khẩu",3099000,3099000,0,0
TIKI,dien-thoai-may-tinh-bang,140184098,"Điện Thoại Vsmart Bee Lite 2GB/16GB - Hàng Chính Hãng",999000,1990000,991000,50
TIKI,dien-thoai-may-tinh-bang,197907038,"Điện thoại di động Vtel E10 4G – Hàng Chính Hãng",375000,399000,24000,6
TIKI,nha-cua-doi-song,157169614,"Thớt Nhựa Kháng Khuẩn 5D Cao Cấp - Chính Hãng ( Giao màu ngẫu nhiên)",29000,58000,29000,50
TIKI,dien-thoai-may-tinh-bang,84757299,"Điện thoại Itel it9200 4G - Hàng chính hãng",590000,590000,0,0
TIKI,dien-thoai-may-tinh-bang,158895857,"Điện thoại Vivo Y33s (8GB/128GB) - Hàng chính hãng",6069000,6069000,0,0
TIKI,nha-cua-doi-song,195469953,"Súng Bắn Keo (Cỡ Lớn/Nhỏ) Kèm 10 Keo Nến Silicon",109000,109000,0,0
TIKI,dien-thoai-may-tinh-bang,143359355,"Điện Thoại Tecno Spark 6 Go 4GB/64GB - Hàng Chính Hãng",2079000,2990000,911000,30
TIKI,dien-thoai-may-tinh-bang,128895957,"Paperwhite 5 (11th-generation) - 2021 - Hàng Nhập Khẩu",3690000,3800000,110000,3
TIKI,nha-cua-doi-song,116185291,"Nhiệt ẩm kế cơ học TANAKA TH101E Chính hãng nhật,nhiệt ẩm kế cơ theo công nghệ nhật bản,đồng hồ đo ẩm kế chính xác,nhiệt ẩm kế phòng,nhiệt ẩm kế sử dụng cho trẻ sơ sinh,nhiệt ẩm kế treo tường ",118500,140000,21500,15
TIKI,nha-cua-doi-song,20528052,"Bộ 2 Pin Sạc AA 1.2V - 1.450mAh Tích Hợp Cổng Sạc USB Tiện Dụng (Màu ngẫu nhiên)",140000,140000,0,0
TIKI,nha-cua-doi-song,195980111,"Bình giữ nhiệt LocknLock LHC3275 - 490ML - Hàng chính hãng",294000,490000,196000,40
TIKI,dien-thoai-may-tinh-bang,272909668,"[Mới] Điện thoại vivo V29e 5G (8GB/256GB) - Hàng Chính Hãng - Camera Selfie 50 MP - Vòng Sáng Aura 2.0 - Màn hình AMOLED 6.67",8990000,8990000,0,0
TIKI,dien-thoai-may-tinh-bang,160450655,"Điện Thoại Masstel Tab 10A 3GB/32GB - Hàng Chính Hãng",2939000,3790000,851000,22
TIKI,dien-thoai-may-tinh-bang,198111545,"Điện Thoại Vivo V25e 2022 (8GB/128GB) - Hàng Chính Hãng",8490000,8490000,0,0
TIKI,dien-thoai-may-tinh-bang,16521748,"Điện thoại để bàn Panasonic KX-TS880 hàng chính hãng",1150000,1150000,0,0
TIKI,dien-thoai-may-tinh-bang,11251711,"Điện thoại bàn không dây Panasonic KX-TGD312 - Hàng Chính Hãng",2090000,2090000,0,0
TIKI,dien-thoai-may-tinh-bang,72310352,"Máy tính bảng Vankyo MatrixPad Z10 - Hàng Chính Hãng",2990000,2990000,0,0
TIKI,nha-cua-doi-song,68513020,"Combo 3 hộp đựng đồ cao cấp Việt Nam phong cách Nhật (38x25xH25cm) Storage Box",166000,166000,0,0
TIKI,nha-cua-doi-song,54133235,"Pin Sạc AA 2000mAh NH15 Power Plus RP2 Energizer NH15 RP2 (Mẫu mới)",157000,160000,3000,2
TIKI,dien-thoai-may-tinh-bang,118486668,"Máy đọc sách Kobo Elipsa - Hàng nhập khẩu",12000000,12000000,0,0
TIKI,nha-cua-doi-song,57971649,"Bộ 2 chảo Lock&Lock Easy Frypan 2P Set, Chảo 1 tay cầm 24cm + Chảo lòng sâu 26cm (LEY1243 x 1, LEY1265 x 1) LEY1243S2",308000,593000,285000,48
TIKI,nha-cua-doi-song,181909422,"Chảo Sâu Lòng Suit LocknLock CSU1225PIK – 22cm - Màu Pink",331730,677000,345270,51
TIKI,dien-thoai-may-tinh-bang,72310420,"Máy tính bảng VANKYO MatrixPad S30 - Hàng Chính Hãng",3090000,3090000,0,0
TIKI,nha-cua-doi-song,56383693,"Combo 300 túi lọc rác bồn rửa bát",37999,37999,0,0
TIKI,nha-cua-doi-song,28937063,"Đồng hồ để bàn báo thức điện tử",81000,120000,39000,33
TIKI,dien-thoai-may-tinh-bang,197966909,"Điện Thoại Samsung A04s 4GB/64GB - Hàng Chính Hãng",2669000,3990000,1321000,33
TIKI,nha-cua-doi-song,182432982,"KỆ ĐỂ GIÀY DÉP SAGOKER, mã KED201",141000,159999,18999,12
TIKI,dien-thoai-may-tinh-bang,162866839,"Máy tính bảng VNPT Technology VNT Tab8 Plus 8 Inch Android 11 RAM 4GB - Hàng chính hãng",3146000,3146000,0,0
TIKI,nha-cua-doi-song,58469713,"Dây đèn nháy led đom đóm trang trí dùng pin nhiều màu, bóng đèn nháy fairy light cao cấp décor phòng, nhà cửa, tết (Tùy chọn chiều dài dây)",89000,115000,26000,23
TIKI,nha-cua-doi-song,184519325,"Bộ quần áo mưa vân tổ ong cao cấp siêu bền",138000,138000,0,0
TIKI,nha-cua-doi-song,66546628,"Giá Treo Rổ Rá, Thau Chậu và Dụng Cụ Bếp Dán Tường Không Khoan Đục Kèm 4 Móc Treo Đồ Tiện Lợi MTC1",58000,99000,41000,41
TIKI,dien-thoai-may-tinh-bang,62242668,"Điện Thoại Bàn Homephone lắp sim - Lắp Tất Cả Các Sim Đi Động - Di Chuyển Mang Đi Khắp Nơi - Hàng Chính Hãng",699000,699000,0,0
TIKI,nha-cua-doi-song,272452316,"Bộ Lau Nhà MyJae Đài Loan Sợi Fiber Xoay 360 Độ Thông Minh 125cm",429000,1200000,771000,64
TIKI,nha-cua-doi-song,96608971,"Móc treo quần áo gấp gọn tiện dụng/Móc du lịch đa năng",7680,9600,1920,20
TIKI,nha-cua-doi-song,94847014,"Nến thơm trang trí phong cách hoa khô thảo mộc",180000,180000,0,0
TIKI,nha-cua-doi-song,13287995,"Cây gãi lưng chỉnh độ dài có đầu gãi bằng PVC ",18000,18000,0,0
TIKI,nha-cua-doi-song,180997554,"Bộ 12 ly  thủy tinh cao cấp",64991,64991,0,0
TIKI,nha-cua-doi-song,14764119,"Ly Giữ Nhiệt Nắp Trượt Chống Tràn Rinfere - Tặng Kèm Ống Hút Không Gỉ, Dụng Cụ Vệ Sinh Ông Hút (590ml)",265000,299000,34000,11
TIKI,nha-cua-doi-song,15444566,"Kệ đựng xà bông dán tường phòng tắm Hobby Home Decor SBL2 có miếng dán gạch men",70000,89000,19000,21
TIKI,nha-cua-doi-song,106996271,"Bộ vòi dẫn nước nước rửa chén inox 304 gắn bồn rửa bát dây dài 1.2met",56154,56154,0,0
TIKI,nha-cua-doi-song,37495650,"Kệ Sách Để Sàn Cao Cấp 11 Tầng Bằng Gỗ MDF Phủ Melamin Chống Nước, Chống Xước - Hàng Chính Hãng",400000,439000,39000,9
TIKI,dien-thoai-may-tinh-bang,47292697,"Điện thoại bàn cổ điển DT40",2000000,2000000,0,0
TIKI,nha-cua-doi-song,125771437,"Khay nướng Bít-tết Phụ kiện nồi chiên không dầu 2GOOD ",380000,380000,0,0
TIKI,nha-cua-doi-song,134676914,"Lọ Hũ Thủy Tinh Nắp Cài Kín Hơi Đáy Vuông Nhiều Dung Tích",55000,55000,0,0
TIKI,dien-thoai-may-tinh-bang,163875403,"ĐIỆN THOẠI MASSTEL IZI 55 4G-HÀNG CHÍNH HÃNG",650000,650000,0,0
TIKI,dien-thoai-may-tinh-bang,140144656,"Điện thoại Realme C25Y (4GB/128GB) - Hàng chính hãng",3599000,4990000,1391000,28
TIKI,dien-thoai-may-tinh-bang,147969070,"Điện thoại thông minh itel A26 - giá rẻ | 2 Sim 2 Sóng 4G LTE | Màn hình IPS 5.7" HD+ | RAM 2GB + ROM 32 GB (Hỗ trợ thẻ nhớ 32 GB) | Mở khoá bằng Gương Mặt | Chính Hãng bảo hành 12 tháng| 1 đổi 1 trong 30 ngày",2390000,2390000,0,0
TIKI,nha-cua-doi-song,133885539,"Tô Giấy Dùng 1 lần KETILO Cao Cấp 250ml, Trắng Trơn, Cứng Cáp, An Toàn và Thân Thiện Môi Trường - HÀNG CHÍNH HÃNG TG100",69900,89000,19100,21
TIKI,nha-cua-doi-song,75730188,"Băng keo dán chống thấm nước bồn rửa chén, bếp, nhà vệ sinh [Tặng dây cột tóc hoa mặt trời ngẫu nhiên",40997,40997,0,0
TIKI,dien-thoai-may-tinh-bang,125753416,"Điện thoại Nokia 110 4G - Hàng chính hãng",740000,740000,0,0
TIKI,nha-cua-doi-song,195949375,"Đèn bàn học làm việc đọc sách chống cận, pin sạc tích điện led có thể gấp gọn – 03 chế độ ánh sáng bảo vệ mắt - Chính hãng VinBuy",179000,300000,121000,40
TIKI,nha-cua-doi-song,50294624,"Lưới Đèn LED Chống Nước Trang Trí Ngoài Trời Cho Giánh Sinh, Tiệc, Lễ Tết - Nhiều kích cỡ",119000,119000,0,0
TIKI,nha-cua-doi-song,12622141,"Cân điện tử mini nhà bếp 5kg",36000,36000,0,0
TIKI,nha-cua-doi-song,115972789,"HỘP ĐỰNG TÚI ĐỰNG QUẦN ÁO KHUNG THÉP 66L- LIVING BOX 66L- Dài 50x Rộng 40x Cao 33.5 cm",85000,85000,0,0
TIKI,nha-cua-doi-song,75478111,"Bộ tượng 04 chú tiểu trang trí xe hơi, bàn làm việc, mang lại bình an, hạnh phúc",41400,45000,3600,8
TIKI,nha-cua-doi-song,32021492,"Ổ Khóa Số Du Lịch Stanley S742-054",161000,167000,6000,4
TIKI,dien-thoai-may-tinh-bang,214756058,"Máy đọc sách New Kindle 11th 2022 (16GB) - Hàng chính hãng",2920000,2920000,0,0
TIKI,dien-thoai-may-tinh-bang,193366048,"Điện thoại OnePlus 10T 5G - Hàng Chính Hãng",15990000,15990000,0,0
TIKI,nha-cua-doi-song,107961495,"Ly Nhựa 2 Lớp LocknLock 900ml HAP502BEG - Màu",158000,263000,105000,40
TIKI,dien-thoai-may-tinh-bang,197651936,"Điện thoại Masstel Izi 25 4G Pin siêu khỏe, Gọi HD call- Hàng chính hãng",489000,599000,110000,18
TIKI,nha-cua-doi-song,183335921,"Bộ ống hút inox thẳng kèm cọ rửa đảm bảo sức khỏe cho người tiêu dùng",20000,20000,0,0
TIKI,dien-thoai-may-tinh-bang,192694043,"Điện thoại để bàn Panasonic KX-TS880 hàng chính hãng",1060000,1060000,0,0
TIKI,dien-thoai-may-tinh-bang,192859201,"Điện thoại Oukitel WP19(chống sốc ,chống nước ,Pin 21000mAh ,Ram 8G ,Rom 256G ,Tầm nhìn ban đêm 64MP ,  Máy ảnh 90Hz ,Điện thoại Helio G95 )-hàng chính hãng",9790000,9790000,0,0
TIKI,dien-thoai-may-tinh-bang,136876846,"Máy Tính Bảng Samsung Galaxy Tab A7 3GB/64GB - Hàng Chính Hãng",4989000,7990000,3001000,38
TIKI,dien-thoai-may-tinh-bang,43924153,"Máy đọc sách Kindle Oasis 3 (2019) - Amazon - Hàng nhập khẩu",5790000,5790000,0,0
TIKI,nha-cua-doi-song,19590366,"Kệ Đa Năng Inochi B4 (45,5 x 26,0 x 44,7 cm)",76000,80000,4000,5
TIKI,nha-cua-doi-song,77577550,"Bộ Chăn Gối Văn Phòng 3 Trong 1 Kiểu Gấu Nâu Độc Đáo Dùng Để Ngủ Trưa Tại Văn Phòng, Tựa Lưng Và Gấu Bông Dùng Để Trang Trí",249000,279000,30000,11
TIKI,nha-cua-doi-song,112946538,"Tấm trải tiện ích Everon Lite (Giao màu ngẫu nhiên)",296000,395000,99000,25
TIKI,nha-sach-tiki,157255019,"Bộ Màu Nước Nén Water Color Cao Cấp 24 36 48 Màu Tặng Bút Lông Nước, Mút, Cọ, Tẩy, Bút Chì, Gọt, Màu Trắng Deli - Chuyên Dùng Cho Học Sinh, Sinh Viên, Vẽ Mĩ Thuật Chuyên Nghiệp - Ô tổ ong - 73936",135000,268200,133200,50
TIKI,nha-sach-tiki,110583137,"Bút highlight nhấn dòng dạ quang Deli - Cam/ Vàng/ Xanh Lá/ Hồng/ Xanh Dương - S625",8333,17400,9067,52
TIKI,nha-sach-tiki,185242029,"Vũ Điệu Quỷ Satan",123000,158000,35000,22
TIKI,nha-sach-tiki,49722650,"12 Quy Luật Cuộc Đời: Thần Dược Cho Cuộc Sống Hiện Đại",194000,300000,106000,35
TIKI,nha-sach-tiki,447164,"Tôi Vẽ - Phương Pháp Tự Học Vẽ Truyện Tranh",73000,100000,27000,27
TIKI,nha-sach-tiki,169621653,"Đến Ngày Gặp Anh",103800,115000,11200,10
TIKI,nha-sach-tiki,196204932,"[A3/A4/A5/A6] Giấy Vẽ Màu Nước Tệp 16 Tờ 300Gsm A3 / A4 / A5 / A6 Chuyên Dụng Hạng Hoạ Sĩ Watercolor Paper Cao Cấp Finenolo Deli - Dùng Cho Màu Nước Gouache Acrylic Nhiều Cọ - EC270",29000,63000,34000,54
TIKI,nha-sach-tiki,194205624,"Pippi Tất Dài",92000,125000,33000,26
TIKI,nha-sach-tiki,74608742,"Vừa Đủ - Đẳng Cấp Sống Của Người Thụy Điển (Tái Bản)",64000,98000,34000,35
TIKI,nha-sach-tiki,155049277,"IELTS Key Writing - Công Thức Học Nhanh IELTS Writing Task 1",78000,119000,41000,34
TIKI,nha-sach-tiki,80141519,"Hackers IELTS Basic- Writing",115420,199000,83580,42
TIKI,nha-sach-tiki,160488838,"Axit Và Kiềm Trong Thực Dưỡng (Tái Bản)",53500,75000,21500,29
TIKI,nha-sach-tiki,192788797,"Fly Me To The Moon - Tóm Lại Là Em Dễ Thương, Được Chưa - Tập 2",45000,55000,10000,18
TIKI,nha-sach-tiki,62648437,"Kinh Doanh Dịch Vụ Tại Việt Nam - Tự Tay Vận Hành Hoạt Động Marketing Của Bạn",144000,190000,46000,24
TIKI,nha-sach-tiki,158641027,"Kẻ Nhắc Tuồng (Tái Bản)",116000,155000,39000,25
TIKI,nha-sach-tiki,104074993,"Nhảy Nhảy Nhảy (Tái Bản)",116000,169000,53000,31
TIKI,nha-sach-tiki,169262882,"Combo 2 cuốn Giáo Trình Hán Ngữ (Sách học Tiếng Trung dành cho người Việt) Giáo Trình Hán Ngữ Tập 1 + Giáo Trình Hán Ngữ Tập 2 (Phiên bản mới - Học bằng App McBooks)",170800,244000,73200,30
TIKI,nha-sach-tiki,115897817,"Kỷ Luật Mềm Trong Gia Đình: Giáo Dục Trẻ 3 - 10 Tuổi Dành Cho Gia Đình Việt",118000,165000,47000,28
TIKI,nha-sach-tiki,184466858,"Tâm Lý Học - Những Thí Nghiệm Não Bộ Chưa Được Tiết Lộ",93100,125000,31900,26
TIKI,nha-sach-tiki,181656866,"Lịch Sử Israel - Câu Chuyện Về Sự Hồi Sinh Của Một Dân Tộc (Daniel Gordis)",291000,389000,98000,25
TIKI,nha-sach-tiki,101801426,"Sách IRED Books - ĐÚNG VIỆC - Một góc nhìn về câu chuyện KHAI MINH (Tái Bản) - Giản Tư Trung",125000,125000,0,0
TIKI,nha-sach-tiki,273645890,"Trạm Đọc | Thuật Tẩy Não",141000,189000,48000,25
TIKI,nha-sach-tiki,81437585,"Tiếng Triều Dâng",105000,140000,35000,25
TIKI,nha-sach-tiki,13101929,"Series Địch Công Kỳ Án Tập 13 - Địch Gia Bát Án",66000,137000,71000,52
TIKI,nha-sach-tiki,173650547,"30 Chuyên Đề Ngữ Pháp Tiếng Anh Cô Trang Anh: Sách ID Tổng ôn Ngữ pháp Tiếng Anh Moonbook",189000,250000,61000,24
TIKI,nha-sach-tiki,130233550,"Vượt Qua Âu Lo, Chữa Lành Tâm Trí - Kiểm Soát Trầm Cảm Trong 7 Tuần Bằng Liệu Pháp Nhận Thức Hành Vi",137000,189000,52000,28
TIKI,nha-sach-tiki,132355750,"Võ Nguyên Giáp - Hào Khí Trăm Năm (Tái Bản)",116000,200000,84000,42
TIKI,nha-sach-tiki,75953557,"Tâm Lý Học Về Tiền",132300,189000,56700,30
TIKI,nha-sach-tiki,77982978,"The Master COACH - Con Đường Trở Thành Nhà Khai Vấn Tài Ba",96500,150000,53500,36
TIKI,nha-sach-tiki,150783204,"Combo 10 miếng dán keo 2 mặt xốp siêu dính",20000,20000,0,0
TIKI,nha-sach-tiki,26272210,"Mọi người đều nói dối - Dữ liệu lớn, Dữ liệu mới và những điều Internet tiết lộ về chính chúng ta",127000,150000,23000,15
TIKI,nha-sach-tiki,143226162,"Tỷ Phú Bán Giày (Tái Bản)",104200,159000,54800,34
TIKI,nha-sach-tiki,160081248,"Gấu Pooh Xinh Xắn",69700,90000,20300,23
TIKI,nha-sach-tiki,6915413,"Nghệ Thuật Tối Giản: Có Ít Đi, Sống Nhiều Hơn (Tái bản)",69700,108000,38300,35
TIKI,nha-sach-tiki,155463014,"Quốc Gia Khởi Nghiệp - Câu Chuyện Về Nền Kinh Tế Thần Kỳ Của Israel (Tái Bản)",121220,209000,87780,42
TIKI,nha-sach-tiki,153521902,"Những Người Phụ Nữ Bé Nhỏ",89800,129000,39200,30
TIKI,nha-sach-tiki,87960389,"Keo Siêu Dính Đa Năng Deli - 7Ml/ 20Ml - 7140/7149",16200,16200,0,0
TIKI,nha-sach-tiki,57386279,"Quạt xếp, quạt vải cầm tay họa tiết hoa anh đào 21*38 cm+ Tặng kèm hình dán-Quạt xếp cầm tay nhỏ gọn phong cách",59000,73750,14750,20
TIKI,nha-sach-tiki,97825967,"Tuyển Tập Những Câu Chuyện Hay Nhất Của AESOP (Song Ngữ Anh - Việt)",72600,108000,35400,33
TIKI,nha-sach-tiki,184774171,"Đũa - Chuyện Linh Dị",214000,289000,75000,26
TIKI,dien-thoai-may-tinh-bang,15428119,"Điện thoại Ip phone Cisco CP-7945G chính hãng",4500000,4500000,0,0
TIKI,dien-thoai-may-tinh-bang,52481412,"Điện thoại bàn cổ điển, điện thoại bàn tân cổ điển, DT122",2200000,2200000,0,0
TIKI,dien-thoai-may-tinh-bang,23865953,"Điện Thoại Để Bàn Panasonic KX-TS500MX - Hàng Chính Hãng",299000,299000,0,0
TIKI,dien-thoai-may-tinh-bang,172537996,"(Hàng chính hãng) Điện thoại bàn hữu tuyến H2P, hiệu Alcatel - Lucent",2220000,2220000,0,0
TIKI,dien-thoai-may-tinh-bang,29446449,"Điện thoại không dây IP 622CW ",1850000,1850000,0,0
TIKI,dien-thoai-may-tinh-bang,252884859,"Tay con điện thoại bàn Panasonic TGDA30-hàng chính hãng",990000,990000,0,0
TIKI,dien-thoai-may-tinh-bang,271152577,"Điện Thoại Samsung Galaxy Z Flip5 5G - Hàng Chính Hãng - Đã kích hoạt bảo hành điện tử",29490000,29490000,0,0
TIKI,dien-thoai-may-tinh-bang,273897590,"Điện thoại Tecno SPARK 20c (8+8)GB/128GB - MTK G36 | 5000 mAh | Sạc nhanh 18W | Hàng Chính Hãng",2490000,2690000,200000,7
TIKI,dien-thoai-may-tinh-bang,274568845,"Điện thoại Xiaomi 14 5G (12GB/256GB) - Hàng chính hãng",22990000,22990000,0,0
TIKI,dien-thoai-may-tinh-bang,273685412,"Điện thoại Samsung Galaxy A25 5G (6GB/128GB) - Hàng chính hãng",6590000,6590000,0,0
TIKI,dien-thoai-may-tinh-bang,160434731,"Máy Tính Bảng Samsung Galaxy Tab A8 4GB/64GB - Hàng Chính Hãng",5856000,5856000,0,0
TIKI,dien-thoai-may-tinh-bang,253443894,"Điện Thoại Samsung Galaxy M14 5G (4GB/128GB) - Hàng Chính Hãng",4212000,4212000,0,0
TIKI,dien-thoai-may-tinh-bang,273955111,"Điện Thoại Oppo Reno 10 5G (8GB/128GB) - Hàng Chính Hãng",7650000,8990000,1340000,15
TIKI,dien-thoai-may-tinh-bang,274440344,"Điện thoại Xiaomi Redmi Note 13 pro (8GB - 128GB) hàng chính hãng - Bảo hành 18 tháng",6490000,6790000,300000,4
TIKI,dien-thoai-may-tinh-bang,192348147,"Điện thoại Oppo A57 (4GB/64GB) - Hàng chính hãng",4284000,4284000,0,0
TIKI,dien-thoai-may-tinh-bang,249168949,"Điện thoại Samsung Galaxy A34 5G 8GB/128GB Bạc - Hàng chính hãng",7164000,7164000,0,0
TIKI,dien-thoai-may-tinh-bang,247730209,"Điện thoại Samsung Galaxy A34 5G (8GB/128GB) - Hàng chính hãng",7164000,7164000,0,0
TIKI,dien-thoai-may-tinh-bang,271822675,"Máy Tính Bảng Samsung Galaxy Tab A8 - Hàng Chính Hãng",5856000,5856000,0,0
TIKI,dien-thoai-may-tinh-bang,249178196,"Điện thoại Samsung Galaxy A34 5G 8GB/128GB Xanh - Hàng chính hãng",7600000,8490000,890000,10
TIKI,dien-thoai-may-tinh-bang,251772653,"Điện thoại Masstel izi 56 4G (pin trâu-loa chữ to rõ) - Hàng Chính Hãng",687000,687000,0,0
TIKI,dien-thoai-may-tinh-bang,249955152,"Điện thoại Xiaomi Redmi Note 12 Pro 5G (8GB/256GB) - Hàng chính hãng",9490000,9490000,0,0
TIKI,dien-thoai-may-tinh-bang,245770363,"Điện thoại Samsung Galaxy A04e (3GB/32GB) - Hàng chính hãng",2325000,2325000,0,0
TIKI,dien-thoai-may-tinh-bang,273373420,"Điện thoại Xiaomi Redmi 13C (4GB/128GB) - Hàng chính hãng - Bảo hành 18 tháng",2832000,3090000,258000,8
TIKI,dien-thoai-may-tinh-bang,273388474,"Điện thoại chắc chắn Ulefone Power Armor 18T Ultra (chụp ảnh nhiệt Camera FLIR5G 512GB ROM +24GB RAM)- hàng chính hãng",15990000,15990000,0,0
TIKI,dien-thoai-may-tinh-bang,274498287,"Điện Thoại Samsung Galaxy A55 5G (8GB/128GB)- Hàng Chính Hãng",9390000,9990000,600000,6
TIKI,dien-thoai-may-tinh-bang,249730344,"Điện thoại Masstel IZI 12 4G LTE - 2 Sim 2 Sóng - Pin 1000 mAh - Loa to - Hàng Chính Hãng - Bảo Hành 12 Tháng",456000,456000,0,0
TIKI,dien-thoai-may-tinh-bang,53380152,"Điện Thoại IP Phone Fanvil X1S - Hàng Chính Hãng",950000,950000,0,0
TIKI,dien-thoai-may-tinh-bang,273244815,"Điện thoại Samsung Galaxy A23 5G 4GB/128GB Đen - Hàng chính hãng",5200000,5990000,790000,13
TIKI,dien-thoai-may-tinh-bang,273411988,"Điện thoại Xiaomi Redmi 13C (6+128GB) | 6.74" 90Hz| Media Tek Helio G85| 5000mAh - Hàng chính hãng",3028000,3490000,462000,13
TIKI,dien-thoai-may-tinh-bang,262589811,"Điện thoại Samsung Galaxy A24 (6GB/128GB) - Hàng chính hãng - ĐÃ KÍCH HOẠT BẢO HÀNH ĐIỆN TỬ",6084000,6084000,0,0
TIKI,dien-thoai-may-tinh-bang,274191773,"Điện thoại ZTE Libero 5G IV - 4GB/128GB Dimensity 700 , Kháng nước IP67 , Sạc nhanh 22,5W - Mới nguyên seal - Hàng nhập khẩu",2350000,2990000,640000,21
TIKI,dien-thoai-may-tinh-bang,255866251,"Điện Thoại Samsung A14 4GB/128GB - Hàng Chính Hãng",3429000,4490000,1061000,24
TIKI,dien-thoai-may-tinh-bang,215097578,"Điện Thoại Di Động Forme D666 4G - Hàng Chính Hãng",650000,650000,0,0
TIKI,dien-thoai-may-tinh-bang,273640492,"Điện Thoại Samsung Galaxy A05 (6GB/128GB) - Hàng Chính Hãng",3237000,3237000,0,0
TIKI,dien-thoai-may-tinh-bang,244355503,"Điện thoại Samsung Galaxy A04s (4GB/64BG) - Hàng chính hãng",3990000,3990000,0,0
TIKI,dien-thoai-may-tinh-bang,204872160,"Điện thoại Oppo A17k (3GB/64GB) - Hàng chính hãng",3290000,3290000,0,0
TIKI,dien-thoai-may-tinh-bang,273360836,"Điện thoại Ulefone armor 22(chống nước,chống va đập, Màn hình giọt nước 6,58 inch, RAM:8GB,Rom 128GB/256GB,Thẻ nhớ microSD Lên đến 512GB, Camera kép 64MP + 64MP)- hàng chính hãng",5990000,5990000,0,0
TIKI,dien-thoai-may-tinh-bang,197902452,"Điện thoại Masstel Lux 20 4G dành cho người lớn tuổi - Hàng chính hãng, Nguyên Seal",790000,790000,0,0
TIKI,dien-thoai-may-tinh-bang,271290719,"Điện Thoại Cho Người Già Masstel Fami 65 - SOS, Loa To, FM Không Dây, Đọc Số Bằng Giọng Nói, Xem Lịch Âm - HÀNG CHÍNH HÃNG",699000,999000,300000,30
TIKI,dien-thoai-may-tinh-bang,261965186,"Điện Thoại Xiaomi Redmi Note 12S (8GB/256GB) - Hàng Chính Hãng",6132000,6132000,0,0
TIKI,nha-cua-doi-song,21459762,"PHÂN TRÙN QUẾ HỮU CƠ DÙNG CHO RAU SẠCH VÀ HOA KIỂNG - 2 KG",15900,15900,0,0
TIKI,nha-cua-doi-song,32014487,"Chăn Nỉ Văn Phòng Cao Cấp (160cm * 120cm)",129000,179000,50000,28
TIKI,nha-cua-doi-song,176309828,"Túi thực phẩm Inochi - shinsen 25 x 35cm",35000,35000,0,0
TIKI,nha-cua-doi-song,7202377,"Bộ 3 Lõi Lọc Nước Máy Tiêu Chuẩn Barrier",504000,660000,156000,24
TIKI,nha-cua-doi-song,87966539,"Sọt rác lưới tròn 26x23x18.5cm - Màu Ngẫu Nhiên",76000,120000,44000,37
TIKI,nha-cua-doi-song,118451214,"Ổ cắm điện LiOA đa năng - Ổ on/off 4 lỗ, 6 lỗ mỗi ổ 1 công tắc dây dài 3m",139000,139000,0,0
TIKI,nha-cua-doi-song,167041804,"Ly rock thủy tinh pha lê đế xoay 360 độ, cốc uống whisky rượu tây 160ml wine glass",35000,35000,0,0
TIKI,nha-cua-doi-song,87982701,"Pin Nút Áo CR2032 BR2032 DL2032 ECR2032 Lithium 3V CR 2032 220mAh (5 Viên) Pin Cho Đồng Hồ Điện Tử/ Đồ Chơi Điều Khiển Từ Xa/ Đèn Xe Đạp",26000,39000,13000,33
TIKI,nha-cua-doi-song,27986931,"Kệ Sách Để Bàn Tiện Ích - Vân gỗ",68000,99000,31000,31
TIKI,nha-cua-doi-song,72829989,"Lá diệp phật - Ngọc Quý Gemstones",39000,39000,0,0
TIKI,nha-cua-doi-song,73464817,"Kệ gia vị dán tường dài 30/40/50cm sơn đen tĩnh điện Vando chính hãng - kèm keo chuyên dụng kệ treo tường bằng thép carbon không gỉ, siêu chịu lực 30kg",119000,141000,22000,16
TIKI,nha-cua-doi-song,201687096,"[TikiNow giao hàng] Ghế chỉnh dáng ngồi đúng Roichen - Hàn Quốc. Sản phẩm dành cho Nữ , Sản phẩm nhập khẩu Hàn Quốc (Made in Korea). Hàng chính hãng Roichen",785000,898000,113000,13
TIKI,nha-cua-doi-song,73230427,"Chill Party-Đèn Chiếu Ngàn Sao 6 phong cách kiêm đèn ngủ xoay tự động, tích hợp phát nhạc bằng Bluetooth nhiều màu sắc tuyệt đẹp, sạc lại bằng USB",380000,380000,0,0
TIKI,nha-cua-doi-song,68391419,"ĐẦU VÒI RỬA CHÉN LỌC NƯỚC TĂNG ÁP 360 ĐỘ - giao màu ngẫu nhiên",7850,7850,0,0
TIKI,nha-cua-doi-song,59425995,"Bộ Ga Gối Cotton Tici Kẻ LIDACO Cao Cấp - Kẻ Cam Ghi",159000,229000,70000,31
TIKI,nha-cua-doi-song,181223364,"Bộ vòi xịt vệ sinh toilet kèm giá treo và dây lò xo co giãn HOBBY Home Decor VSR2 inox 304 ren chờ 21mm",144000,229000,85000,37
TIKI,nha-cua-doi-song,81936258,"Hộp đựng quần áo gấp gọn có nắp Màu kem Morning House  - SIZE S",45000,50000,5000,10
TIKI,nha-cua-doi-song,90530495,"Đèn Pixar, Đèn Bàn Học Chống Cận Thị, Đèn Đọc Sách, Đèn Làm Việc Bảo Vệ Mắt - Hàng Chính Hãng Moontronics MT01",255000,310000,55000,18
TIKI,nha-cua-doi-song,29339320,"Công tắc điều khiển từ xa Honest HT-6220KGD công suất lớn 220v 40A 1000m dùng cho máy bơm ,moto điện..",159000,159000,0,0
TIKI,nha-cua-doi-song,46327991,"Hộp Nhựa Đựng Thực Phẩm Trong Suốt GAGI Mã GH01 Nhựa PP Bền Bỉ, Sử Dụng Cho Cả Lò Vi Sóng Không Bám Mùi Dễ Dàng Vệ Sinh - Hàng Chính Hãng",44000,69000,25000,36
TIKI,nha-cua-doi-song,186094219,"Khăn Tắm Nén Bằng Cotton Tiện Lợi Dùng Một Lần 70*140 cm - Khăn Nén Du Lịch - Khăn Nén Spa",13000,14111,1111,8
TIKI,nha-cua-doi-song,205819517," Bóng đèn Led thông minh Xiaomi Yeelight Bulb W3 đui xoắn E27 (RGB 16 triệu màu) - tích hợp Razer Chroma",261000,350000,89000,25
TIKI,nha-cua-doi-song,171022457,"Dầu bôi trơn thiết bị gia dụng đa năng dùng trong gia đình - Dầu bôi trơn động cơ, chống rỉ bánh răng cơ khí",24000,24000,0,0
TIKI,nha-cua-doi-song,134360720,"Bộ 8 Pin AAA ( R03NT/2S ) Panasonic 1,5V Không Chì - Hàng Chính Hãng",40000,45000,5000,11
TIKI,nha-cua-doi-song,191918107,"Bình lắc LocknLock Balance Shake It Bottle HAP949BLK 800ml - Màu",139000,267000,128000,48
TIKI,nha-cua-doi-song,42759652,"Chốt cửa dây xích an toàn inox 304 gắn cửa HOBBY Home Decor KLC1 bảo vệ phòng cho chung cư phòng ngủ không rỉ sét",82000,129000,47000,36
TIKI,nha-cua-doi-song,164848242,"Chậu gội đầu tại giường cho người già, trẻ nhỏ, người bệnh... màu sắc giao ngẫu nhiên- Hàng chính hãng",124000,130000,6000,5
TIKI,nha-cua-doi-song,138380998,"Gói 20 Chiếc Khăn Cotton Nén Sử Dụng Một Lần Tiện Dụng Cho Du Lịch Khổ 20x24cm Khăn Uớt Viên Kẹo",17000,35000,18000,51
TIKI,nha-cua-doi-song,137176118,"100gram Túi Zip trong suốt đáy đứng- túi đựng thực phẩm khô, nước - size",38000,40000,2000,5
TIKI,nha-cua-doi-song,88914388,"Bộ 04 chân đế cao su chống rung máy giặt - HT SYS - Đế chống rung máy giặt - Đế chống ồn máy giặt, máy sấy,tủ lạnh, bàn ghế + Sét 3 móc dính dán tường vàng tài lộc HT SYS",139000,139000,0,0
TIKI,nha-cua-doi-song,73314056,"Lọ xay tiêu cầm tay nắp viền inox 304 lọ thủy tinh Hobby Home Decor XT mẫu thon cao và mẫu thấp tùy chọn",54000,99000,45000,45
TIKI,nha-cua-doi-song,20104505,"Hộp 3 ống hút inox và cọ rửa",43000,43000,0,0
TIKI,nha-cua-doi-song,657076,"Màng Bọc Thực Phẩm PE Ringo 150 (30cm x 150m)",103000,103000,0,0
TIKI,nha-cua-doi-song,55465365,"Pin Max 8 + 4 Viên Energizer E92 BP8+4 AAA - Hàng Chính Hãng Model 2020",138000,145000,7000,5
TIKI,nha-cua-doi-song,21389285,"Vỉ 20 viên pin cmoss CR2032",38200,38200,0,0
TIKI,nha-cua-doi-song,169696716,"Bình Đựng Nước 2L Dễ Thương Kèm Ống Hút , Có Vạch Báo Giờ Uống Nước - Hàng Loại 1 Chính Hãng",124000,218000,94000,43
TIKI,nha-cua-doi-song,21418511,"Hộp đựng bông tẩy trang và tăm bông 2 ngăn mica cao cấp 14.5 x 10.5 x 13 cm",85000,85000,0,0
TIKI,nha-cua-doi-song,174262175,"Bát Sen Tắm Của Vòi Tắm Hoa Sen Nóng Lạnh Pimisi Với Tay Sen Bằng Nhựa Cao Cấp Mạ Xi Cr/Ni Màu Inox Sáng Bóng Kiểu Vuông Bo Tròn Góc - Ổn Định Nhiệt Độ Nước Nóng Lạnh Theo Công Nghệ Đầu Phun Tăng Áp Dạng Phun Mưa Tiết Kiệm Nước | Hàng Chính Hãng",124000,200000,76000,38
TIKI,nha-cua-doi-song,78904788,"Gối Lót Ngồi Y Tế Hình Chữ O Bằng Cao Su Non Phòng Bệnh Trĩ Giảm Đau Xương Cụt",205000,205000,0,0
TIKI,nha-cua-doi-song,55427978,"Combo 200 Túi Lọc Rác cho bồn rửa chén bát ",99000,99000,0,0
TIKI,nha-cua-doi-song,58206715,"Bản lề tự đóng cửa tự động cho cửa hàng, văn phòng, nhà ở",38900,38900,0,0
TIKI,nha-cua-doi-song,31895999,"Đầu Vòi Lọc Sạch Nước Than Hoạt Tính",19400,19400,0,0
TIKI,nha-cua-doi-song,185654331,"Hộp, Lọ, Hũ Thủy Tinh Nắp Gỗ JIMMEAL 200ml 350ml 500ml 750ml 1000ml 1200ml 1600ml",32000,32000,0,0
TIKI,nha-cua-doi-song,67416013,"CỐC GIỮ NHIỆT ELMICH INOX 304 470ML EL3668",254000,399000,145000,36
TIKI,nha-cua-doi-song,800795,"Bình đựng thức ăn giữ nhiệt 1800ml EL3128",699000,1390000,691000,50
TIKI,nha-cua-doi-song,121367420,"Gối ngồi lót mông y tế chống trĩ, đau xương cụt, ê mỏi mông cho dân văn phòng, lái xe, thu ngân, sinh viên...Chính hãng Ema - Hàng nhập khẩu",550000,550000,0,0
TIKI,nha-cua-doi-song,11341623,"Hộp 40 viên pin 2A Maxell",122000,130000,8000,6
TIKI,nha-cua-doi-song,3677753,"Bình Lọc Nước BRITA Flow Basic Blue - 8.2L (Kèm Maxtra Plus) - Hàng Chính Hãng",2499000,2499000,0,0
TIKI,nha-cua-doi-song,142261128,"Đệm Lót Ghế Ngồi NOOZ Home Goods Gối Lót Ghế Ngồi Bệt Memory Foam Giúp Chống Đau Lưng, Đau Xương Cụt, Đau Thần Kinh Tọa Ruột Đệm Cao Su Non Danh Cho Dân Văn Phòng",339000,450000,111000,25
TIKI,nha-cua-doi-song,173717336,"Túi Hộp Vải Lưới Đựng Đồ Lót, Tất Vớ Nhiều Ngăn - Khay Xếp Chia Ô Đựng Đồ Để Tủ Quần Áo Tiện Ích",24000,24000,0,0
TIKI,nha-cua-doi-song,127693039,"[Thùng 1, 5, 10, 18 Lít] Keo Sơn Chống Thấm Sàn Mái Lộ Thiên TAIKO NITTON (Gốc Acrylic) - Tặng Kèm Vải Kết Cấu Và Chổi Lăn Sơn - Chống Thấm Sàn Mái, Máng Xối, Ban Công Lô Gia, Bể Nước, Bể Cá, Bề Mặt Cát Xi Măng (Hiệu quả hơn khi pha với Xi Măng",249600,320000,70400,22
TIKI,nha-cua-doi-song,141971329,"Túi Đựng Hộp Cơm Grepaco Giữ Nhiệt Nóng Lạnh Dạng Đứng Có Ngăn Phụ Đựng Đồ Thức Ăn Văn Phòng, Du Lịch – Vải Bố Canvas, Kích Thước Size Vừa, Kiểu Giỏ Xách Thời Trang Nam Nữ - Tặng Túi Đựng Muỗng Nĩa - Hàng Chính Hãng",69000,69000,0,0
TIKI,nha-cua-doi-song,106281034,"Bình nước thủy tinh Luminarc Quadro 1.7L -LUQUG2668",154000,205000,51000,25
TIKI,nha-cua-doi-song,187622257,"Bộ 3 Kệ Trang Trí Treo Góc Tường SIB DECOR Hình Cung Tròn",149000,149000,0,0
TIKI,nha-cua-doi-song,7699062,"Chảo Nhôm Chống Dính Lock&Lock Baum Marble 1 Tay Cầm LBU1283C (28cm)",295000,567000,272000,48
TIKI,nha-cua-doi-song,74615464,"Phin pha cà phê nhôm Trung Nguyên( Không Hoa Văn)",30000,30000,0,0
TIKI,nha-cua-doi-song,52297710,"Bộ 25 Móc dán tường, dính tường trong suốt Siêu chắc, siêu chịu lực loại 10kg",11968,11968,0,0
TIKI,nha-cua-doi-song,160909295,"0,5KG - 1KG TÚI ZIP LỤA MỜ và TRONG Túi Zip lock LỤA MỜ có khoá kéo, túi zip đựng quần áo, khoá chắc chắn",65000,65000,0,0
TIKI,nha-cua-doi-song,84953200,"Kệ đựng dụng cụ rửa chén dán tường Hobby Home Decor KRC6 inox 304 có miếng dán",173000,279000,106000,38
TIKI,nha-cua-doi-song,53185365,"Túi Ly Giữ Nhiệt Rinfere - Sản Phẩm Handmade Phù Hợp Với Ly Giữ Nhiệt Rinfere, Lock and Lock, Yeti - Free Size",104000,104000,0,0
TIKI,nha-cua-doi-song,155546820,"Hộp nhựa đựng thực phẩm tủ lạnh 2 lớp Homepower ghi chú thời gian bảo quản thông minh kèm rổ thoát nước tiện lợi - Cao cấp",89000,89000,0,0
TIKI,nha-cua-doi-song,181909425,"Nồi 1 Tay Cầm Suit LocknLock CSU1181PIK (18cm) - Màu Pink",491000,945000,454000,48
TIKI,nha-cua-doi-song,167030045,"Áo Nệm, Ga bọc Nệm Toppper 2 Mặt Có Khóa Kéo, Kich Thước 1mx2m,1m2x2m, 1m4x2m, 1m6x2m, 1m8x2m",145000,145000,0,0
TIKI,nha-cua-doi-song,149959628,"Cmbo 6 Cuộn Túi Đựng Rác Gia Đình, Bao Đựng Rác Văn Phòng, Trường Học Tiện Lợi Màu Đen Đầy Đủ 3 Size Tiểu Trung Đại - Chính Hãng MINIIN",45000,45000,0,0
TIKI,nha-cua-doi-song,274121804,"Ruột Gối Ôm Lông Vũ Thuần Việt - Sợi Lông Vũ Nhân Tạo Microfiber Êm Ái Mềm Mịn - KT 20x100cm",340000,550000,210000,38
TIKI,nha-cua-doi-song,116244976,"Túi Đựng Hộp Cơm Grepaco Giữ Nhiệt Nóng Lạnh Đựng Đồ Thức Ăn Văn Phòng, Du Lịch – Vải Bố Canvas, Kích Thước To (Cỡ Lớn), Kiểu Dáng Giỏ Xách Thời Trang Nam Nữ - Tặng Túi Đựng Muỗng Nĩa",149000,149000,0,0
TIKI,nha-cua-doi-song,105026602,"Chuông báo động, còi báo động dành cho người lớn tuổi, người bệnh ",234060,249000,14940,6
TIKI,nha-cua-doi-song,38666598,"Túi Đựng Ly Giữ Nhiệt Lớn 900ml Nhiều Mẫu",40000,40000,0,0
TIKI,nha-cua-doi-song,13619778,"Đồng Hồ Treo Tường P1 (25cm) - Màu ngẫu nhiên",99000,99000,0,0
TIKI,nha-cua-doi-song,11710987,"Combo 10 cuộn keo lụa vặn ren vòi nước, ren ống cao cấp (Cao su non, băng tan) ",33000,38000,5000,13
TIKI,nha-cua-doi-song,198214329,"Combo 2 bộ chuyển đổi 3 chấu thành 2 chấu phích tròn Barwell - Chính hãng, giao màu ngẫu nhiên",32200,35000,2800,8
TIKI,nha-cua-doi-song,79971957,"Bộ Chăn Gối Văn Phòng 3 IN 1 Hình Thú Mặc Áo Hà Mã, Bò Vàng Siêu Tiện Lợi- Bò áo xám",219000,219000,0,0
TIKI,nha-cua-doi-song,162406191,"Giấy lau mặt dùng 1 lần khăn mặt cotton khô cuộn giấy tẩy trang lau khô/lau ướt",14900,28500,13600,48
TIKI,nha-cua-doi-song,113899477,"Đèn học để bàn, đèn đọc sách LED tích điện di động Homepower gập 2 chỗ - 3 chế độ ánh sáng vàng bảo vệ mắt, chống cận Pin 2500mAh",179000,179000,0,0
TIKI,nha-cua-doi-song,198508670,"Đèn LED Mini Móc Khóa - Đèn Pin COB - Đèn Pin Dã Ngoại - Sạc USB Tiện Dụng- Kiêm hộp quẹt",48510,49000,490,1
TIKI,nha-cua-doi-song,149242704,"Combo 20 Móc treo ảnh gắn tường, móc treo ảnh cưới ôm sát tường decor rất đẹp, không cần khoan đục - Hàng chính hãng",33250,35000,1750,5
TIKI,nha-cua-doi-song,403497,"Đèn Diệt Côn Trùng Well DS-D6",625000,786000,161000,20
TIKI,nha-cua-doi-song,91546481,"️ Kệ nhà bếp gấp gọn đa năng TI-KE001 - Tháo ra dùng ngay được",401000,433900,32900,8
TIKI,nha-cua-doi-song,51406882,"Bộ 10 miếng xốp dán tường giả gạch 3D 70x77cm",104000,104000,0,0
TIKI,nha-cua-doi-song,140746932,"Bàn Gấp Treo Tường Đầy Đủ Phụ Kiện và Hướng Dẫn Đi Kèm",165000,165000,0,0
TIKI,nha-cua-doi-song,139815721,"Sào Phơi Giá Rẻ - ko khoen,ko bánh xe,1m",125000,125000,0,0
TIKI,nha-cua-doi-song,159971094,"Bộ 2 hộp vải đựng đồ 7 ngăn mã HQ2 - Combo 2 hộp vải đựng quần áo chia ngăn gọn gàng tiện lợi chất vải Oxford cao cấp miDoctor",150000,250000,100000,40
TIKI,nha-cua-doi-song,117318253,"Nệm xếp đa năng Goodnight 70x180cm, Nệm gấp văn phòng, Nệm xếp 3 thiết kế gọn nhẹ, kèm túi đựng (Giao màu ngẫu nhiên)",466000,570000,104000,18
TIKI,nha-cua-doi-song,185647202,"Tranh Cát Chảy Chuyển Động 3D KUNBE Nhiều Mẫu Trang Trí Nhà Cửa Bàn Làm Việc, Giảm Stress",168000,168000,0,0
TIKI,nha-cua-doi-song,15839139,"Đèn pin Laser Laze MV – 303 (Đen) tặng pin sạc và sạc",108000,108000,0,0
TIKI,nha-cua-doi-song,12736380,"Đồng hồ để bàn led báo thức thông minh",178000,178000,0,0
TIKI,nha-cua-doi-song,75411116,"Lót chân ghế, miếng dán chống trầy, chống rung lắc bàn ghế - Hàng chính hãng",23000,25000,2000,8
TIKI,nha-cua-doi-song,42491736,"Bút thử nước TDS, dụng cụ đo TDS, máy đo độ cứng của nước - Hàng chính hãng",124000,180000,56000,31
TIKI,nha-cua-doi-song,181909427,"Nồi 2 Tay Cầm Suit LocknLock CSU1202PIK - Màu Pink",578000,1112000,534000,48
TIKI,nha-cua-doi-song,194465292,"Bình giữ nhiệt LocknLock DIY Strap Tumbler LHC3283 350ml",254000,489000,235000,48
TIKI,nha-cua-doi-song,83927709,"Bịt Mắt Ngủ Che Mắt Ngủ Có Túi Gel Massage - Giảm Thâm Quầng Mắt - Mẫu Hoạt Hình Mới - Xanh Đen",35000,35000,0,0
TIKI,nha-cua-doi-song,54682452,"Pin vuông 9V Energizer 522 ALKALINE chính hãng ( Mẫu mới )",57000,60000,3000,5
TIKI,nha-cua-doi-song,98153708,"Chậu Gội Đầu Tại Giường KUNBE, Chậu Gội Đầu Tại Nhà Thông Minh Cho Mọi Người - Tặng Lược Massage Và Cốc Gội Đầu",209000,209000,0,0
TIKI,nha-cua-doi-song,185889866,"[ Mới nhất ] Hashtag Cầm Tay check in đám cưới",28000,28000,0,0
TIKI,nha-cua-doi-song,177129235,"Bình giữ nhiệt Thermos nút bấm JNL-752 MTB 750ml màu xanh dương",854000,1090000,236000,22
TIKI,nha-cua-doi-song,75044183,"Đèn Đọc Sách Cao Cấp - Đèn Bàn Làm Việc Sang Trọng - Đèn Ngủ - Đèn Trang Trí - Có Thể Gập Hai Chỗ – 03 Chế Độ Ánh Sáng Vàng Bảo Vệ Mắt Chống Cận Pin Sạc - Hàng Chính Hãng - VinBuy",175000,300000,125000,42
TIKI,nha-cua-doi-song,38114299,"Thanh treo rèm cửa inox đa năng, không cần khoan tường hay bắt vít, thay đổi vị trí linh hoạt HT03",60000,60000,0,0
TIKI,nha-cua-doi-song,189157824,"Bộ 8 túi hút chân không tặng kèm bơm hút chân không đựng quần áo, chăn màn, ga gối gọn gàng D Danido",189000,199000,10000,5
TIKI,nha-cua-doi-song,252390050,"Gương dán tường 30x30cm LOẠI MỚI",33000,39000,6000,15
TIKI,nha-cua-doi-song,59238383,"Vòi nước đa năng 2 đầu đồng mạ chorme cao cấp mẫu mới 2024 (Hàng chính hãng)",171000,295000,124000,42
TIKI,nha-cua-doi-song,105374376,"Bộ Lõi Lọc Khử Mùi Hôi Lỗ Thoát Sàn Cao Cấp MIFAN - Ngăn chặn mùi hôi cống, chống côn trùng lỗ thoát nước nhà tắm, vệ sinh, bồn rửa - Mẫu mới 2021",50000,50000,0,0
TIKI,nha-cua-doi-song,21582013,"Bộ Bịt Mắt Ngủ 3D Tặng Kèm Bịt Tai Chống Ồn Màu Ngẫu Nhiên",45000,45000,0,0
TIKI,nha-cua-doi-song,106338289,"Dép Lỗ Đi Trong Nhà Tắm Chống Trơn Trượt Nhanh Khô, Thoáng Mát, Mẫu Mới Nhất. Dép Cho Cả Gia Đình",95000,155000,60000,39
TIKI,nha-cua-doi-song,73640967,"Miếng lau nhà thay thế Bộ lau nhà KITIMOP-C6 PLUS ( 33 x 12cm)",15000,19000,4000,21
TIKI,nha-cua-doi-song,125658476,"Bình Giữ Nhiệt Kim Cương 1500Ml Inox 304- YOGA QG- Chống Rỉ Set, Nắp Đậy Chặt, Giữ Nhiệt Nóng Lạnh Tốt 6- 8h, Quai Đeo Chắc Chắn, Thiết Kế Sang Trọng, Màu Sắc Thanh Lịch, Tiện Lợi, Pha Lọc Trà, Hàng Chính Hãng",141000,172000,31000,18
TIKI,nha-cua-doi-song,185004372,"Ly Thủy Tinh Phong Cách Bắc Âu Đế Xoay 170ml - Navivu Rock Glass",45000,45000,0,0
TIKI,nha-cua-doi-song,102508672,"Thùng Đựng Rác Thông Minh E1906, Nắp Đóng Mở Một Chạm Tiện Ích, Chất Liệu Nhựa Cao Cấp Chống Nước, Chịu Nhiệt Tốt, Dung Tích 10 Lít - Hàng Nhập Khẩu",229000,360000,131000,36
TIKI,nha-cua-doi-song,131407862,"ghế văn phòng ghế xoay văn phòng",399000,591000,192000,32
TIKI,nha-cua-doi-song,45170002,"Tấm Chắn Dầu Mỡ Tiện Dụng Cho Bếp Ga - TC29",14000,15478,1478,10
TIKI,nha-cua-doi-song,80757840,"Combo 3 hộp vải đựng đồ đa năng TD2 – Bộ 3 túi vải Thụy Điển không nắp tiết kiệm sang trọng dung tích 24L mỗi hộp - chính hãng",159000,210000,51000,24
TIKI,nha-cua-doi-song,12213522,"Ô dù đi mưa gấp gọn hình gấu Brown",45000,45000,0,0
TIKI,nha-cua-doi-song,149657438,"Tấm Nệm Trải Sàn Gấp Gọn Hàng xuất Nhật",273000,350000,77000,22
TIKI,nha-cua-doi-song,781987,"Gối Memory Foam 50D Lock & Lock HLW114 (61 x 34 x 10 cm)",475000,791000,316000,40
TIKI,nha-cua-doi-song,75354717,"Tủ Quần Áo 2 Buồng 6 Ngăn Tiện Lợi, Tủ Vải 170cm Chất Lượng Cao Chắc Chắn, Vững Chãi - Hàng Chính Hãng miDoctor",240000,295000,55000,19
TIKI,nha-cua-doi-song,7699064,"Chảo Nhôm Sâu Lòng Chống Dính Lock&Lock Baum Marble 1 Tay Cầm, Nắp Thủy Tinh LBU1285 (28cm)",404000,776000,372000,48
TIKI,nha-cua-doi-song,38462026,"Đèn Led Trang Trí Bóng Tròn Dài 3M - 20 Bóng Trang Trí Noel Lễ Tết",43900,43900,0,0
TIKI,nha-cua-doi-song,77962744,"Kệ nhà tắm, kệ dán tường đựng đồ nhà tắm, đồ bếp, nhà vệ sinh, siêu chịu lực, (không dán lên tường sơn nước, sơn vôi) - Giao màu ngẫu nhiên",42750,45000,2250,5
TIKI,nha-cua-doi-song,104681142,"(Chọn Loại) Túi Zip PE Trong Suốt 2 Đường Kéo MyJae, Túi Bọc Đồ Ăn, Rau Củ Bảo Quản Trong Tủ Lạnh",66000,99000,33000,33
TIKI,nha-cua-doi-song,164593190,"Tăm chỉ nha khoa tiệt trùng hộp 50 cây, vệ sinh kẽ răng chân nướu chuyên dụng",4999,4999,0,0
TIKI,nha-cua-doi-song,74859074,"Chuông Cửa Không Dây Thông Minh CTFAST CT - 01 (1 Nút Bấm, 1 Chuông ), Chống Nước, Khoảng Cách Sử Dụng Hiệu Quả 300 mét - Hàng Chính Hãng",135000,169000,34000,20
TIKI,dien-thoai-may-tinh-bang,31820638,"Điện Thoại Bàn Panasonic KX-TS500MX - Panasonic KX-TS500MX Integrated Telephone System - Hàng chính hãng",299000,299000,0,0
TIKI,dien-thoai-may-tinh-bang,196760330,"Điện Thoại Vivo T1x 4GB/64GB - Hàng Chính Hãng",3379000,4490000,1111000,25
TIKI,dien-thoai-may-tinh-bang,37289936,"Điện thoại Oukitel WP2 chống nước,chống va đập, pin 10.000 mAh - Hàng chính hãng",5490000,5490000,0,0
TIKI,dien-thoai-may-tinh-bang,4048043,"Điện Thoại Bàn Panasonic KX-TS500",339000,369000,30000,8
TIKI,dien-thoai-may-tinh-bang,221518066,"Máy đọc sách Kindle Oasis 3 10th - Hàng nhập khẩu",6042210,6789000,746790,11
TIKI,dien-thoai-may-tinh-bang,194462682,"Điện thoại ZTE Blade A52 4GB l 64GB, Pin 5000mAh, Màn hình 6.52", Camera AI Triple - Hàng chính hãng",3490000,3490000,0,0
TIKI,dien-thoai-may-tinh-bang,273227290,"Combo Máy đọc sách Kindle Scribe kèm bút – thế hệ đầu tiên có thể đọc và viết, màn hình 10,2” 300PPI, đèn vàng warmlight, bộ nhớ 16-64GB, đồng bộ dữ liệu qua Microsoft Word - hàng nhập khẩu",11276100,11390000,113900,1
TIKI,dien-thoai-may-tinh-bang,171852890,"Điện thoại Masstel FAMI 60 4G ,Pin 2000 mah ,cỡ chữ to rõ ràng,âm thanh lớn,màn hình to- Hàng chính hãng",689000,689000,0,0
TIKI,dien-thoai-may-tinh-bang,80132874,"ĐIỆN THOẠI TÂN CỔ ĐIỂN DT16 bàn phím quay chuông thanh, dùng được nghe gọi âm thanh rõ ràng. Điện thoại để bàn tân cổ điển- Điện thoại bàn chất liệu gỗ để trang trí",2320000,2900000,580000,20
TIKI,dien-thoai-may-tinh-bang,196176544,"Điện Thoại Cho Người Già Masstel Fami 12 4G-hỗ trợ 4g-chữ to dành cho người già(Hàng Chính Hãng)",630000,630000,0,0
TIKI,dien-thoai-may-tinh-bang,198203859,"Điện Thoại Vivo V25 5G 2022 (8GB/128GB) - Hàng Chính Hãng",7490000,10490000,3000000,29
TIKI,dien-thoai-may-tinh-bang,181216830,"Điện thoại ZTE Blade V40 Vita (ZTE 8045) - MH giọt nước HD+ 6.75" - Pin 6000 mAh sạc nhanh 22.5W -  Bộ nhớ mở rộng (4+2)GB - Hàng chính hãng",4290000,4290000,0,0
TIKI,dien-thoai-may-tinh-bang,198111545,"Điện Thoại Vivo V25e 2022 (8GB/128GB) - Hàng Chính Hãng",8490000,8490000,0,0
TIKI,dien-thoai-may-tinh-bang,29440849,"điện thoại  IP622C - hàng chính hãng",1650000,1650000,0,0
TIKI,dien-thoai-may-tinh-bang,21317020,"Điện thoại bàn không dây Panasonic KX-TGF310 - Hàng Chính Hãng",2450000,2450000,0,0
TIKI,dien-thoai-may-tinh-bang,174085242,"Điện Thoại Cho Người Già Masstel Fami 12 4G - Viền Kim Loại, Ăng Ten FM Không Dây - Hàng Chính Hãng",612000,699000,87000,12
TIKI,dien-thoai-may-tinh-bang,188030974,"Máy tính bảng Oukitel RT1 - hàng chính hãng  (chống nước,chống va đập , pin khủng,pin 10.000mAh,màn hình 10,1 inch,Ram 4Gb,Rom 64Gb,tám nhân,học online)",6990000,6990000,0,0
TIKI,dien-thoai-may-tinh-bang,4059671,"Điện Thoại Bàn Panasonic KXTS 520 - Hàng Chính Hãng",469000,489000,20000,4
TIKI,dien-thoai-may-tinh-bang,157835051,"Điện Thoại Để Bàn Panasonic KX-TS500MX - Hàng Chính Hãng",380000,380000,0,0
TIKI,dien-thoai-may-tinh-bang,121154009,"Điện thoại bàn cố định không dây lắp các loại Sim Di động, Cố định (Viettel, Vinaphone, Mobifone...)",650000,650000,0,0
TIKI,dien-thoai-may-tinh-bang,14508445,"Điện thoại Ip phone Cisco CP-7841-K9 chính hãng",4200000,4200000,0,0
TIKI,dien-thoai-may-tinh-bang,16518032,"Điện thoại để bàn Panasonic KX-TS560 hàng chính hãng",730000,730000,0,0
TIKI,dien-thoai-may-tinh-bang,54882670,"Điện thoại để bàn tân cổ điển chuông thanh bàn phím quay mã DT10 dùng sim di động hoặc dùng cáp nghe gọi âm thanh rõ ràng và để trang trí (điện thoại bàn tân cổ điển)",2320000,2900000,580000,20
TIKI,dien-thoai-may-tinh-bang,215125094,"Điện Thoại Di Động Forme D999 4G - Hàng Chính Hãng",760000,760000,0,0
TIKI,dien-thoai-may-tinh-bang,113475741,"Điện thoại Panasonic KX-TS520MX - Trắng - Hàng chính hãng",450000,450000,0,0
TIKI,dien-thoai-may-tinh-bang,94453667,"Điện thoại VoIP Yealink SIP-T30",1050000,1050000,0,0
TIKI,dien-thoai-may-tinh-bang,52326343,"Cisco Unified IP Phone CP-7821-K9 - Hàng chính hãng",2580000,2580000,0,0
TIKI,dien-thoai-may-tinh-bang,55197731,"Điện thoại bàn màu đỏ KXT438",215000,215000,0,0
TIKI,dien-thoai-may-tinh-bang,140747649,"Điện thoại Realme C11 2021 (4GB/64GB) - Hàng chính hãng",3790000,3790000,0,0
TIKI,dien-thoai-may-tinh-bang,54989813,"Điện thoại tân cổ điển để bàn mã DT4 màu trắng kết hợp vàng, chuông thanh bàn phím quay, dùng sim di động nghe gọi âm thanh tốt và để trang trí (Điện thoại bàn tân cổ điển)",2900000,2900000,0,0
TIKI,dien-thoai-may-tinh-bang,257866809,"Điện thoại để bàn tân cổ điển phím quay DT15",3900000,3900000,0,0
TIKI,dien-thoai-may-tinh-bang,117347869,"ĐIỆN THOẠI HỘI NGHỊ YEALINK CP960 -HÀNG CHÍNH HÃNG",15230000,15230000,0,0
TIKI,dien-thoai-may-tinh-bang,197905982,"Điện thoại di động Vtel E10 4G – Hàng Chính Hãng",379050,399000,19950,5
TIKI,dien-thoai-may-tinh-bang,168320000,"Điện Thoại Xiaomi Redmi 9A (2GB/32GB)- Đã kích hoạt bảo hành điện tử- Hàng Chính Hãng - Granite Gray",2088000,2088000,0,0
TIKI,dien-thoai-may-tinh-bang,253443951,"Điện Thoại Samsung Galaxy M14 5G (6GB/128GB) - Hàng Chính Hãng",5292000,5292000,0,0
TIKI,dien-thoai-may-tinh-bang,247016383,"Điện Thoại Xiaomi Redmi 12C 4GB/64GB - Hàng Chính Hãng",3168000,3168000,0,0
TIKI,dien-thoai-may-tinh-bang,190701486,"Điện Thoại OPPO A57 (4GB/64GB) - Hàng Chính Hãng",4284000,4284000,0,0
TIKI,dien-thoai-may-tinh-bang,11110653,"Điện thoại bàn không dây Panasonic KX-TGF320 - Hàng Chính Hãng",2500000,2500000,0,0
TIKI,dien-thoai-may-tinh-bang,91281318,"Máy Đọc Sách Likebook P10 - Hàng chính hãng",9090000,9090000,0,0
TIKI,dien-thoai-may-tinh-bang,54683561,"ĐIỆN THOẠI TÂN CỔ ĐIỂN DT14 bàn phím quay chuông quả, dùng cáp điện thoại cố định nghe gọi âm thanh rõ ràng (điện thoại bàn tân cổ điển)",3520000,4400000,880000,20
TIKI,dien-thoai-may-tinh-bang,11376644,"Điện thoại bàn có dây Panasonic KX-TS560MX",730000,730000,0,0
TIKI,dien-thoai-may-tinh-bang,91836155,"Điện Thoại  Dành Cho Người Già Masstel Fami 12 Phiên bản mới hỗ trợ đèn Pin siêu sáng- Hàng Chính Hãng - Màu đen",630000,630000,0,0
TIKI,dien-thoai-may-tinh-bang,271234577,"Điện Thoại Nokia 105 4G Pro - Hàng Chính Hãng",669000,680000,11000,2
TIKI,dien-thoai-may-tinh-bang,170727305,"Điện thoại bàn Panasonic KX-TS580 hàng chính hãng",999000,999000,0,0
TIKI,dien-thoai-may-tinh-bang,156222386,"Điện thoại Panasonic KX-TS520MX -Hàng chính hãng",449000,459000,10000,2
TIKI,dien-thoai-may-tinh-bang,220670303,"Yealink W73P - Điện thoại IP cầm tay không dây DECT - Hàng Chính Hãng - Điện thoại IP mẹ bồng con",2800000,2800000,0,0
TIKI,dien-thoai-may-tinh-bang,260406257,"Điện thoại oukitel wp23 ( chống nước,chống va đập,pin 10600mAh,Ram 4Gb.Rom 64Gb,màn hình 6.52 inch,mạng 2,3,4G,Android 13 )-hàng chính hãng",3990000,3990000,0,0
TIKI,dien-thoai-may-tinh-bang,164697930,"Máy tính bảng Samsung Galaxy Tab A8  (2022) - Hàng chính hãng - ĐÃ KÍCH HOẠT BẢO HÀNH ĐIỆN TỬ",5856000,5856000,0,0
TIKI,dien-thoai-may-tinh-bang,273232944,"Máy tính bảng Masstel Tab 10.4 - Hàng chính hãng",4990000,4990000,0,0
TIKI,dien-thoai-may-tinh-bang,125171841,"Điện Thoại Bàn Panasonic KX-TSC11 - Hàng Chính Hãng",620000,620000,0,0
TIKI,dien-thoai-may-tinh-bang,251275686,"Điện thoại OPPO A57 4GB/128GB Vàng - Hàng chính hãng",4632000,4632000,0,0
TIKI,dien-thoai-may-tinh-bang,274639670,"Điện thoại Realme V30T 4GB/128GB Dimensity 700 - Rom tiếng việt - Hàng nhập khẩu",2650000,3590000,940000,26
TIKI,dien-thoai-may-tinh-bang,248235765,"Điện Thoại Masstel iZi 26 4G - Hàng Chính Hãng",589000,640000,51000,8
TIKI,dien-thoai-may-tinh-bang,249730339,"Điện Thoại Masstel IZI 55 4G LTE - 2 Sim 2 Sóng - Pin 1800 mAh - Hàng Chính Hãng - Bảo Hành 12 Tháng",659000,659000,0,0
TIKI,dien-thoai-may-tinh-bang,270736028,"Điện thoại Samsung Galaxy Z Fold 5 - Hàng chính hãng",29990000,44990000,15000000,33
TIKI,dien-thoai-may-tinh-bang,244303202,"Điện Thoại Samsung A14 4GB/128GB - Hàng Chính Hãng",3349000,4490000,1141000,25
TIKI,dien-thoai-may-tinh-bang,249156531,"Điện thoại Realme C55 6GB/128GB Vàng nắng mai - Hàng chính hãng",4680000,4990000,310000,6
TIKI,dien-thoai-may-tinh-bang,198858451,"Điện thoại Samsung Galaxy A04s (4GB/64GB) - Hàng chính hãng",3990000,3990000,0,0
TIKI,dien-thoai-may-tinh-bang,273636845,"Điện Thoại Samsung Galaxy A05 (4GB/64GB) - Hàng Chính Hãng",3025000,3025000,0,0
TIKI,dien-thoai-may-tinh-bang,258667842,"Điện thoại Xiaomi Redmi Note 12 Pro 4G (8GB/256GB) - Hàng chính hãng",7990000,7990000,0,0
TIKI,dien-thoai-may-tinh-bang,274361820,"Máy Tính Bảng Học Tập Smart Study 1, Hàng Chính Hãng, Cho Trẻ Từ 5-12 Tuổi, 64GB, Tích Hợp Chương Trình Học Tập Toàn Diện",7900000,7900000,0,0
TIKI,dien-thoai-may-tinh-bang,217158870,"Máy tính bảng Samsung Galaxy Tab A8 (4GB/64GB) - Hàng Chính Hãng",5856000,5856000,0,0
TIKI,dien-thoai-may-tinh-bang,258787119,"Máy tính bảng OUKITEL RT2 chắc chắn (chống nước,chống va đập ,pin xài lâu,Pin  20.000Mah, Màn hình  10,1 inch,Ram 8GB,Rom  128 GB, lõi tám nhân,Máy ảnh 16MP,Android 12,sạc nhanh 33W)- hàng chính hãng",8990000,8990000,0,0
TIKI,dien-thoai-may-tinh-bang,220678495,"Điện thoại bàn DECT không dây Yealink W73H có chân đế - Hàng chính hãng",2200000,2200000,0,0
TIKI,dien-thoai-may-tinh-bang,188948039,"Máy tính bảng Samsung Galaxy Tab A8 64GB Xám (2022) - Hàng Chính Hãng",5856000,5856000,0,0
TIKI,dien-thoai-may-tinh-bang,274507025,"Điện thoại Realme V50 5G 6GB/128GB ,CPU Dimensity 6100+ , Màn 120HZ , Rom Quốc tế có tiếng việt - Hàng nhập khẩu",3199000,3990000,791000,20
TIKI,dien-thoai-may-tinh-bang,212040697,"Điện Thoại Samsung Galaxy A04 (3GB/32GB) - Hàng Chính Hãng - Đã kích hoạt bảo hành điện tử",2130000,2990000,860000,29
TIKI,dien-thoai-may-tinh-bang,263438199,"Máy tính bảng Edutab 10.1 Pro & Case da tặng Hệ thống quản lý học tập & kiểm soát dành cho Phụ huynh trọn đời",4989000,4989000,0,0
TIKI,dien-thoai-may-tinh-bang,271134741,"Điện thoại Samsung Galaxy Z Flip5 (8GB/512GB) - Hàng chính hãng",17639000,29990000,12351000,41
TIKI,dien-thoai-may-tinh-bang,272270730,"Điện thoại Samsung Galaxy A05 (4GB/128GB) - Hàng chính hãng",2650000,3099000,449000,14
TIKI,dien-thoai-may-tinh-bang,274516951,"Điện thoại Masstel izi 16 4G(LTE) , Bàn phím nổi, FM không dây - Hàng chính hãng",420000,499000,79000,16
TIKI,dien-thoai-may-tinh-bang,198868735,"Điện thoại IP Grandstream GRP 2601 hàng chính hãng",880000,880000,0,0
TIKI,dien-thoai-may-tinh-bang,230157205,"Điện thoại Xiaomi Redmi Note 10T 5G 4GB/64GB - Màn 90HZ - Chống Nước IP68 - Hàng Nhập Khẩu - Bản quốc tế",2420000,4190000,1770000,42
TIKI,dien-thoai-may-tinh-bang,274410237,"Điện thoại người già IPRO F183 4G , Gọi HD Call , Có SOS , 2 sim 2 sóng - Hàng chính hãng",338000,450000,112000,25
TIKI,dien-thoai-may-tinh-bang,262516014,"Điện Thoại Samsung Galaxy A34 5G - Hàng Chính Hãng",7164000,7164000,0,0
TIKI,dien-thoai-may-tinh-bang,190544267,"Điện Thoại Oppo A57 4GB/64GB - Hàng Chính Hãng",4284000,4284000,0,0
TIKI,dien-thoai-may-tinh-bang,186149961,"Máy tính bảng Samsung Galaxy Tab A7 Lite 32GB Xám - Hàng Chính Hãng",3587000,3587000,0,0
TIKI,dien-thoai-may-tinh-bang,248185228,"Điện Thoại Masstel Lux 10 4G - Hàng Chính Hãng",675000,675000,0,0
TIKI,dien-thoai-may-tinh-bang,272555368,"XIAOMI 13T 5G (12GB-256GB) - Hàng chính hãng",11385000,11990000,605000,5
TIKI,dien-thoai-may-tinh-bang,273438724,"Điện Thoại Samsung A05s 4GB/128GB , Snapdragon 680 , Sạc nhanh 25W - Hàng Chính Hãng",3204000,3990000,786000,20
TIKI,dien-thoai-may-tinh-bang,271798615,"Điện thoại thông minh siêu bền Oukitel WP28 (màn hình 6.52‘' ,HD+ ,pin 10600mAh ,Ram 15Gb(8GB+7Gb),Rom 256GB ,Android13, camera 48MP)-hàng chính hãng",4990000,4990000,0,0
TIKI,dien-thoai-may-tinh-bang,217706932,"Combo Máy đọc sách All New Kindle Paperwhite 5 (11th Gen) và Bao da - Hàng nhập khẩu",3980000,3980000,0,0
TIKI,dien-thoai-may-tinh-bang,153581568,"Điện thoại Masstel IZI 55 4G - Hàng chính hãng",659000,659000,0,0
TIKI,dien-thoai-may-tinh-bang,274019932,"Điện thoại Masstel Izi 56 4G (LTE) Gọi HD Call ,Pin khủng ,loa lớn - Hàng Chính Hãng",548000,650000,102000,16
TIKI,dien-thoai-may-tinh-bang,274639765,"Điện thoại OPPO A2M 5G 6GB/128GB , Dimensity 6020 , Màn 90Hz , Rom tiếng việt - Hàng chính hãng",2990000,3690000,700000,19
TIKI,dien-thoai-may-tinh-bang,270074304,"Điện Thoại Xiaomi Redmi Note 12S 8GB/256GB - Hàng Chính Hãng",4739000,6690000,1951000,29
TIKI,dien-thoai-may-tinh-bang,252073075,"Điện thoại Masstel IZI11 4G - Hàng Chính Hãng",468000,468000,0,0
TIKI,dien-thoai-may-tinh-bang,252428990,"Điện thoại Tecno SPARK 10 Pro 8GB/256GB - Helio G88 | 5000 mAh | Sạc nhanh 18W | Cảm ứng vân tay - Hàng chính hãng",4149000,4490000,341000,8
TIKI,dien-thoai-may-tinh-bang,270707514,"Máy Đọc Sách BOOX Tab Mini C - Hàng Chính Hãng",11850000,12990000,1140000,9
TIKI,dien-thoai-may-tinh-bang,273258830,"Điện thoại Samsung Galaxy A05 (4GB/128GB) - Đã kích hoạt bảo hành điện tử -Hàng chính hãng",2590000,3050000,460000,15
TIKI,dien-thoai-may-tinh-bang,274116886,"Điện Thoại Xiaomi Redmi A2+ 3GB/64GB - Hàng Chính Hãng",1989000,2790000,801000,29
TIKI,dien-thoai-may-tinh-bang,224873580,"Điện thoại Masstel izi 26 - Hàng chính hãng ",600000,600000,0,0
TIKI,dien-thoai-may-tinh-bang,273016223,"Điện Thoại Xiaomi Redmi A2 2GB/32GB - Hàng Chính Hãng",1729000,2190000,461000,21
TIKI,dien-thoai-may-tinh-bang,247823537,"Điện thoại Realme C55 (6GB/128GB) - Hàng chính hãng",3790000,4990000,1200000,24
TIKI,dien-thoai-may-tinh-bang,270510406,"Điện thoại Vivo Y36 (8GB/128GB) - Hàng Chính Hãng - Camera 50MP - Sạc Nhanh 44W",5190000,5190000,0,0
TIKI,dien-thoai-may-tinh-bang,263073487,"Điện thoại Tecno CAMON 20 Pro 8GB/256GB - Camera 64MP + 32MP | Helio G99 | 5000 mAh/ 33W | 6.7'' FHD AMOLED - Hàng Chính Hãng - BH 13 Tháng",5490000,5490000,0,0
TIKI,dien-thoai-may-tinh-bang,270978486,"Điện thoại Samsung Galaxy M14 5G (6GB/128GB) - Đã kích hoạt bảo hành điện tử - Hàng chính hãng",3910000,5690000,1780000,31
TIKI,dien-thoai-may-tinh-bang,204671569,"Điện Thoại Oppo A17k 3GB/64GB - Hàng Chính Hãng",2529000,3290000,761000,23
TIKI,dien-thoai-may-tinh-bang,262514707,"Điện thoại Xiaomi Redmi Note 12 Pro (8GB/256GB) - Hàng chính hãng",7990000,7990000,0,0
TIKI,dien-thoai-may-tinh-bang,257861524,"Điện thoại để bàn tân cổ điển phím quay DT11",3500000,3500000,0,0
TIKI,dien-thoai-may-tinh-bang,271218081,"Máy đọc sách Kindle Oasis Edition 3 (8GB) - Hàng chính hãng",6500000,7690000,1190000,15
TIKI,dien-thoai-may-tinh-bang,262908601,"Máy tính bảng chắc chắn oukitel RT3 (chống nước,chống va đập,Ram 4Gb,Rom 64 Gb,màn hình 8 inch,pin 5150 mAh)- hÀng chính hãng",4990000,4990000,0,0
TIKI,dien-thoai-may-tinh-bang,273942001,"Điện thoại Xiaomi Redmi Note 13 (6GB/128GB) - Hàng chính hãng",4090000,4490000,400000,9
TIKI,dien-thoai-may-tinh-bang,273664463,"Điện Thoại Oppo A18 4GB/128GB - Hàng Chính Hãng",3499000,3990000,491000,12
TIKI,dien-thoai-may-tinh-bang,121059239,"Máy Tính Bảng Samsung Galaxy Tab A7 Lite T225 3GB/32GB - Hàng Chính Hãng",3587000,3587000,0,0
TIKI,dien-thoai-may-tinh-bang,270636882,"Điện Thoại Samsung M14 5G 4GB/64GB - Hàng Chính Hãng",2989000,4990000,2001000,40
TIKI,dien-thoai-may-tinh-bang,273127929,"Điện thoại Xiaomi 13T 12GB-256GB - Hàng Chính Hãng",12990000,12990000,0,0
TIKI,dien-thoai-may-tinh-bang,197214029,"Apple iPhone 14",16490000,24990000,8500000,34
TIKI,dien-thoai-may-tinh-bang,273366296,"ulefone Armor 24 (TIÊU CHUẨN MIL-STD-810H ,IP69K, chống nước ,chống sốc,pin 22000mah , màn hình6,78 inch, NFC, Ram24GB(12Gb+12Gb),rom 256GB)-hàng chính hãng ",7990000,7990000,0,0
TIKI,dien-thoai-may-tinh-bang,271730109,"Điện thoại chắc chắn Ulefone Armor X13, (Ram 12GB(6Gb+6Gb),Rom 64GB,chống nước,chống va đập IP68/IP69K, Android 13,CPU MediaTek Helio G36 Octa Core,Màn hình 6,52 inch, Mạng: 4G, NFC,OTG)-hàng chính hãng",3990000,3990000,0,0
TIKI,dien-thoai-may-tinh-bang,274101262,"Máy Tính Bảng Samsung Galaxy Tab A9 Plus Wifi 4GB/64GB - Hàng Chính Hãng",3990000,5990000,2000000,33
TIKI,dien-thoai-may-tinh-bang,274536294,"Máy đọc sách Kindle Paperwhite 5 (16GB) - Hàng chính hãng",4050000,4990000,940000,19
TIKI,dien-thoai-may-tinh-bang,249890023,"Điện Thoại Xiaomi Redmi Note 12 Pro 5G 8GB/256GB - Hàng Chính Hãng",7249000,9490000,2241000,24
TIKI,dien-thoai-may-tinh-bang,274544634,"Điện thoại Redmi Note 12R 5G 6/128GB Snapdragon 4 Gen 2, Rom Quốc tế có sẳn Tiếng việt - Hàng nhập khẩu",3050000,3590000,540000,15
TIKI,dien-thoai-may-tinh-bang,258330471,"Điện thoại để bàn tân cổ điển phím bấm DT08, Điện thoại nghe gọi được",3500000,3500000,0,0
TIKI,dien-thoai-may-tinh-bang,242434782,"Máy đọc sách New Kindle 11th 2022 (16GB) - Hàng nhập khẩu",2920000,2920000,0,0
TIKI,dien-thoai-may-tinh-bang,153581522,"Máy đọc sách All new Paperwhite Gen 5 (11th) màn hình 6.8 inch có đèn vàng warmlight",3690000,3800000,110000,3
TIKI,dien-thoai-may-tinh-bang,274392442,"Điện thoại Oppo A38 - Hàng chính hãng",4490000,4490000,0,0
TIKI,dien-thoai-may-tinh-bang,270832077,"Điện thoại Xiaomi Redmi 12 (4GB-128GB) - Hàng Chính Hãng",3890000,3890000,0,0
TIKI,dien-thoai-may-tinh-bang,191689878,"Điện thoại OPPO CPH2387 - A57 Xanh - Hàng Chính Hãng",4632000,4632000,0,0
TIKI,nha-cua-doi-song,140791193,"Bóng đèn LED Bright PHILIPS E27 - Thay thế hoàn hảo cho bóng đèn Compact - Hàng Chính Hãng",56000,90000,34000,38
TIKI,nha-cua-doi-song,72615961,"Dây đèn led đom đóm trang trí decor phòng, du lịch cắm trại, fairy light cao cấp (tùy chọn loại nguồn cấp, chiều dài dây và màu sắc)",14000,23000,9000,39
TIKI,nha-cua-doi-song,192975755,"Kệ Gỗ Trang Trí Treo Tường Không Cần Khoan - Tặng Kèm Móc Treo Inox Và Phụ Kiện",95000,110000,15000,14
TIKI,nha-cua-doi-song,72041730,"Bộ Dao 6 Món Lock&Lock (4 Dao, 1 Kéo, 1 Hộp Đựng Dao) CKK802",598000,996000,398000,40
TIKI,nha-cua-doi-song,146495143,"Hộp vải đựng đồ BA03 đa năng, thùng đựng quần áo có nắp rời đậy chắc chắn an toàn dododios",129000,129000,0,0
TIKI,nha-cua-doi-song,47108061,"Bộ 100 túi bóng hút chân không 1 mặt nhám - có nhiều size túi kích thước khác nhau",65000,65000,0,0
TIKI,nha-cua-doi-song,32072094,"Dầu neem hữu cơ DOCNEEM phòng trị sâu bệnh hoa hồng, phong lan, cây cảnh, dầu neem oil nguyên chất ép lạnh 100ml",150000,150000,0,0
TIKI,nha-cua-doi-song,7583254,"Vòi xịt vệ sinh inox - Vòi xịt bồn cầu inox SUS 304 cao cấp",59800,59800,0,0
TIKI,nha-cua-doi-song,272298582,"Bóng đèn bắt muỗi ( dùng để thay thế bóng khi bóng chính bị hỏng)",68000,68000,0,0
TIKI,nha-cua-doi-song,145767958,"Set 3 hộp tròn đựng thực phẩm tủ lạnh, bảo quản thực phẩm có lót đáy ráo nước, van thoát khí PET Xuất Khẩu EU",299000,299000,0,0
TIKI,nha-cua-doi-song,58014281,"Giá treo móc phơi, kẹp quần áo cho gọn loại lớn Inox 304 dán tường gạch men - kèm keo dán sealant fix - HOBBY GPM3",123000,199000,76000,38
TIKI,nha-cua-doi-song,16869707,"Kính Bịt Mắt Ngủ 3D (Đen)",29900,39000,9100,23
TIKI,nha-cua-doi-song,49100347,"Cây massage đa chức năng: gãi lưng , đấm lưng , massage đầu, tay, chân, vai tặng kèm móc treo siêu dính (màu ngẫu nhiên)",21900,21900,0,0
TIKI,nha-cua-doi-song,73887002,"Đèn Ngủ Cảm Ứng Cảm Biến Dán Tường Sạc Pin USB Đời Mới",79000,79000,0,0
TIKI,nha-cua-doi-song,184122885,"Khăn tắm lau mặt nén bằng cotton dùng 1 lần hoặc tái sử dụng được cho du lịch khách sạn",38000,40000,2000,5
TIKI,nha-cua-doi-song,167954128,"BỘ LAU NHÀ TRÒN XOAY 360 ĐỘ MẪU MỚI",183000,350000,167000,48
TIKI,nha-cua-doi-song,718885,"Thùng rác nhựa Fitis Compact PPS1-904 - xanh xám - 10L",232000,290000,58000,20
TIKI,nha-cua-doi-song,197826403,"Bình Đựng Nước 2L Có Vạch Báo Giờ Uống Nước",65000,65000,0,0
TIKI,nha-cua-doi-song,16382292,"Bộ Quần Áo Đi Mưa - 3XL",115000,115000,0,0
TIKI,nha-cua-doi-song,53063443,"Ga giường chống thẩm trơn kích thước 1.6mx2m - Màu giao ngẫu nhiên",49450,49450,0,0
TIKI,nha-cua-doi-song,58679667,"Chuỗi dây đèn led gương trang điểm 10 bóng 5 màu điều chỉnh",199900,199900,0,0
TIKI,nha-cua-doi-song,149376396,"Túi peva SmileBox size lớn bọc nhiều bộ quần áo treo tủ chống thấm, chống bụi, có khóa kéo đôi tiện lợi nhiều size ngắn dài 90cm 110cm- Hàng chính hãng",105000,105000,0,0
TIKI,nha-cua-doi-song,55727445,"Nắp đậy ly cốc bằng silicon nhiều mẫu xinh xắn",10000,10000,0,0
TIKI,nha-cua-doi-song,99099494,"Bóng Đèn LED 38W COMET Bulb Fighter CB02F0386 Ánh Sáng Trắng - Hàng Chính Hãng",164000,164000,0,0
TIKI,nha-cua-doi-song,26060194,"GĂNG TAY RỬA BÁT SILICON SIÊU DAI CỰC BỀN",9989,9989,0,0
TIKI,nha-cua-doi-song,25088140,"2 cuộn 1 lốc Bao rác cực đại",25000,25000,0,0
TIKI,nha-cua-doi-song,66903798,"Remote Điều Khiển Từ Xa Cho Quạt SenkoTR1428, TR1628, DR1608 – Hàng Chính Hãng",75000,75000,0,0
TIKI,nha-cua-doi-song,10788516,"Khuôn làm kem 6 que  (Màu ngẫu nhiên)",32999,32999,0,0
TIKI,nha-cua-doi-song,173701257,"Khăn lau đa năng bếp, bát đĩa, cốc chén thấm nước chống dính dầu mỡ hai mặt",8000,8000,0,0
TIKI,nha-cua-doi-song,26334551,"Mền dù cao cấp  - mỏng nhẹ - thoáng mát - Cho giấc ngủ dễ chịu [chăn ga gối đệm",160000,180000,20000,11
TIKI,nha-cua-doi-song,71518280,"Đèn Led Thanh 8 Bóng Để Bàn Đầu Gắn Ngõ USB Dự Phòng 4W (0.5W/led) Siêu Sáng",7000,14000,7000,50
TIKI,nha-cua-doi-song,75836319,"Phân bón hữu cơ Kích Hoa cho Hoa hồng, Hoa lan, cây cảnh, cây kiểng trong nhà và ngoài trời, giàu lân giúp phân nhánh nụ, hoa, giảm chồi điếc, dung tích 1 lít, chính hãng DOCNEEM",119000,119000,0,0
TIKI,nha-cua-doi-song,135442243,"Bộ Lục Giác Deli Đầu Bằng Chữ L Cao Cấp - Kiểu Dáng Nhỏ Gọn Giúp Người Dùng Cầm Nắm, Thao Tác Dễ Dàng DL230008 DL230009",24000,46800,22800,49
TIKI,nha-cua-doi-song,162424714,"Khay Giấy Bạc, Khay Bạc Đựng Thực Phẩm Lót Nồi Chiên Không Dầu Chịu Nhiệt Cao - Hàng Loại 1 - Chính Hãng MINIIN",32000,65000,33000,51
TIKI,nha-cua-doi-song,4355547,"Bộ lọc nước thô đầu nguồn 3 cấp lọc 10inch Yamato YMTH10-3TX",334000,385000,51000,13
TIKI,nha-cua-doi-song,143001862,"Ổ cắm điện đa năng shoptida có sạc nhanh PD 20W cổng USB+TYPEC, có 4-6 lỗ cắm tải 2500W, 1 đổi 1 15 tháng",174000,250000,76000,30
TIKI,nha-cua-doi-song,144590196," Kéo Nhật Nhà Bếp Cắt Gà Cắt Đồ Đa Năng Jodily - Hàng Chính Hãng ",105000,105000,0,0
TIKI,nha-cua-doi-song,72016703,"Bếp Nướng Than Hoa Phiên Bản Cải Tiến Loại Dài 2023 Chống Cháy Thực Phẩm, An Toàn Sức Khỏe, Không Cần Quạt, Bếp Nướng Không Khói, Bếp Nướng Ngoài Trời, Bếp Nướng Than Hoa Vuông",209000,209000,0,0
TIKI,nha-cua-doi-song,50241058,"Kệ sách gỗ để bàn - Tủ,kệ sách mini - Giao màu sắc ngẫu nhiên ",47500,50000,2500,5
TIKI,nha-cua-doi-song,93760107,"Dây đèn trang trí ngoài trời chống nước dùng cho quán cà phê, trà chanh, trà sữa đuôi đèn chống nước -thương hiệu Kiotool",103000,103000,0,0
TIKI,nha-sach-tiki,68456842,"Bài Tập Tiếng Anh 8 - Không Đáp Án",27100,40000,12900,32
TIKI,nha-sach-tiki,195190269,"Combo Anime Comics: One Piece Film Strong World (2 Cuốn)",153000,154000,1000,1
TIKI,nha-sach-tiki,138934620,"Red Nile - Tiểu Sử Của Dòng Sông Vĩ Đại Nhất Thế Giới",243400,399000,155600,39
TIKI,nha-sach-tiki,66698344,"Sách Bài Học Diệu Kỳ Từ Chiếc Xe Rác (Khổ Nhỏ) (Tái Bản 2020)",61100,88000,26900,31
TIKI,nha-sach-tiki,67060012,"Phát Triển Trí Tuệ Cảm Xúc- Cảm Xúc Của Con Màu Gì?",37100,50000,12900,26
TIKI,nha-sach-tiki,159259322,"Nhớ Hà Nội, Thương Sài Gòn",102000,129000,27000,21
TIKI,nha-sach-tiki,138504809,"EQ - Đừng Để Cảm Xúc Hạ Gục Bản Thân",115000,159000,44000,28
TIKI,nha-sach-tiki,22725674,"Kinh Nghiệm Từ Nước Nhật - Giúp Con Tự Lập Từ 0-6 Tuổi",45100,62000,16900,27
TIKI,nha-sach-tiki,172206434,"Huyền Thuật Và Các Đạo Sĩ Tây Tạng (Tái Bản)",75100,108000,32900,30
TIKI,nha-sach-tiki,143513113,"Con Yêu Bố Chừng Nào",59000,79000,20000,25
TIKI,nha-sach-tiki,74856421,"Hạnh Phúc Trong Công Việc",109220,159000,49780,31
TIKI,nha-sach-tiki,1534613,"Giáo Trình Chuẩn HSK 5 Bài Học (Tập 1)",209000,278000,69000,25
TIKI,nha-sach-tiki,190708149,"Chitose Trong Chai Ramune – Tập 1 - Bản Phổ Thông - [Tặng Bookmark Bế Hình Có Chân Đế]",105000,105000,0,0
TIKI,nha-sach-tiki,8886001,"Giết Con Chim Nhại (Tái Bản)",93100,120000,26900,22
TIKI,nha-sach-tiki,58732189,"Liệu Pháp Tâm Lý: Ứng Dụng Màu Sắc Thay Đổi Cuộc Sống",113000,159000,46000,29
TIKI,nha-sach-tiki,193895769,"Cao Thủ "Đổi Đen Thay Trắng" - Tập 6 (Tiểu thuyết)",121500,159000,37500,24
TIKI,nha-sach-tiki,176824199,"Thần Số Học - Làm Chủ Cuộc Đời",98500,138000,39500,29
TIKI,nha-sach-tiki,50668886,"Thiện, Ác Và Smart Phone (Tái Bản)",76000,105000,29000,28
TIKI,nha-sach-tiki,171055469,"TikTok Tất Tần Tật",113000,158000,45000,28
TIKI,nha-sach-tiki,51845986,"Chinh Phục Luyện Thi Vào 10 Môn Ngữ Văn Theo Chủ Đề",105000,159000,54000,34
TIKI,nha-sach-tiki,59478514,"Combo 2 Cuốn: Osho Đàn Ông + Osho Phụ Nữ",165000,228000,63000,28
TIKI,nha-sach-tiki,11368983,"Combo Giáo Trình Chuẩn HSK 2 - Bài Học (Kèm 1 MP3) và Giáo Trình HSK 2 - Sách Bài Tập (Kèm MP3) ( Tặng Kèm Viết )",308800,386000,77200,20
TIKI,nha-sach-tiki,71957923,"Sách Ehon - Combo 4 cuốn Bạn là ai vậy - Dành cho trẻ từ 0 - 3 tuổi",100000,156000,56000,36
TIKI,nha-sach-tiki,181379287,"Tốc Độ Của Niềm Tin (The Speed Of Trust)(Tái Bản 2022)",139000,175000,36000,21
TIKI,nha-sach-tiki,165030729,"Những Kẻ Âu Lo",97600,180000,82400,46
TIKI,nha-sach-tiki,197751561,"MONSTER #8 - Tập 5",52200,58000,5800,10
TIKI,nha-sach-tiki,143676192,"Màu Acrylic tuýp mini chuyên nghiệp Deli - 5ml/tuýp - Vẽ vải / Vẽ quần áo / Vẽ giày - 12/18/24 màu",75600,75600,0,0
TIKI,nha-sach-tiki,192125793,"Harry Potter và tên tù nhân ngục Azkaban (Tái Bản 2022)",132000,205000,73000,36
TIKI,nha-sach-tiki,187827433,"Sau Tang Lễ",82900,145000,62100,43
TIKI,nha-sach-tiki,7369223,"Cho Tôi Xin Một Vé Đi Tuổi Thơ",61000,90000,29000,32
TIKI,nha-sach-tiki,194959693,"Hàn Quốc Quốc Gia Gây Sững Sờ",197000,225000,28000,12
TIKI,nha-sach-tiki,46849710,"Robinson Crusoe ",125000,190000,65000,34
TIKI,nha-sach-tiki,102629342,"999 Lá Thư Gửi Cho Chính Mình (**) - Tập 2 - Mong Bạn Trở Thành Phiên Bản Hạnh Phúc Nhất (Tái bản)",92800,129000,36200,28
TIKI,nha-sach-tiki,58547334,"Bài Tập Tiếng Anh 9 - Không Đáp Án (Tái Bản 2020)",40000,52000,12000,23
TIKI,nha-sach-tiki,197656790,"Kaguya-Sama: Cuộc Chiến Tỏ Tình - Tập 1 - Tặng Kèm Lót Ly",38800,40000,1200,3
TIKI,nha-sach-tiki,110112108,"Phương Pháp Đầu Tư Warren Buffett",110000,169000,59000,35
TIKI,nha-sach-tiki,191636255,"Chòm Sao Linh Thú Tập 7 [Tặng Kèm Bookmark]",37000,40000,3000,8
TIKI,nha-sach-tiki,38265901,"Điều Quan Trọng Nhất – The Most Important Thing",299000,299000,0,0
TIKI,nha-sach-tiki,2583023,"Bé Nhanh Nhẹn",11500,23000,11500,50
TIKI,nha-sach-tiki,181699688,"Husky Và Sư Tôn Mèo Trắng Của Hắn - Tập 3",127000,169000,42000,25
TIKI,nha-sach-tiki,189940724,"Triệu Phú Khu Ổ Chuột",94000,126000,32000,25
TIKI,nha-sach-tiki,141483251,"Sách: Thai Giáo Theo Chuyên Gia - 280 Ngày Mỗi Ngày Đọc 1 Trang (Tái Bản)",88000,110000,22000,20
TIKI,nha-sach-tiki,5154511,"Bà Nội Găngxtơ (Tái Bản)",58000,75000,17000,23
TIKI,nha-sach-tiki,69337681,"Nhà Tư Tưởng Lớn - Nietzsche Trong 60 Phút",63000,96000,33000,34
TIKI,nha-sach-tiki,83432000,"Sách Người trong muôn nghề: Ngành Kinh tế có gì?",173000,189000,16000,8
TIKI,nha-sach-tiki,114689806,"Full combo (Bộ 10 cuốn) Ehon song ngữ Kỹ năng - Màu sắc - Hình khối - Nhận biết",182000,350000,168000,48
TIKI,nha-sach-tiki,271536000,"Chú Thuật Hồi Chiến Tập 3: Cá Con Và Trừng Phạt Ngược",29800,30000,200,1
TIKI,nha-sach-tiki,185410021,"Set Decal Bọc Sách Vở Dán Bìa Trong Suốt Chống Nước Nhiều Kích Cỡ Deli - Bọc SGK Vở Sổ Tay Ghi Chép Truyện Tiều Thuyết - Lưu Trữ Bền Đẹp - 70603 / 70602 / 70601",27000,48600,21600,44
TIKI,nha-sach-tiki,176550199,"Hội Chứng Trầm Cảm Cười: Đằng Sau Nụ Cười Hạnh Phúc Là Những Nỗi Đau",81100,109000,27900,26
TIKI,nha-sach-tiki,127654481,"Tiệm Café Bên Rìa Thế Giới",70000,108000,38000,35
TIKI,nha-sach-tiki,36727163,"Người Nam Châm (Tái Bản 2019)",55000,79000,24000,30
TIKI,nha-sach-tiki,124767704,"Bạn Đắt Giá Bao Nhiêu? (Tái Bản)",86400,119000,32600,27
TIKI,nha-sach-tiki,194110075,"Bẩm thầy Tường có thầy Vũ đến tìm - tập 2",115000,115000,0,0
TIKI,nha-sach-tiki,71880692,"600 Câu Hỏi Dùng Cho Sát Hạch, Cấp Giấy Phép Lái Xe Cơ Giới Đường Bộ",45000,45000,0,0
TIKI,nha-sach-tiki,108261352,"Tự Học Ngữ pháp Tiếng Anh Bằng Mindmap Tập 2",108000,145000,37000,26
TIKI,nha-sach-tiki,157432540,"Thư Tình Gửi Một Người (Trịnh Công Sơn) (Tái Bản)",112000,195000,83000,43
TIKI,nha-sach-tiki,73795265,"Sách Hợp Nhất Với Vũ Trụ (Bìa Mềm) (Tái Bản 2020)",68100,88000,19900,23
TIKI,nha-sach-tiki,187009994,"Lôi Thần Và Nhân Viên Văn Phòng (Tập 5)",51200,66000,14800,22
TIKI,nha-sach-tiki,138269668,"Từ Điển Tiếng Việt (Hoàng Phê)(Tái Bản)",442000,495000,53000,11
TIKI,nha-sach-tiki,47323853,"Chinh Phục Luyện Thi Vào Lớp 10 Môn Tiếng Anh Theo Chủ Đề",105000,159000,54000,34
TIKI,nha-sach-tiki,188694727,"Tập viết tiếng Thái",34000,50000,16000,32
TIKI,nha-sach-tiki,184226848,"Sợi tóc - Thạch Lam (Bìa mềm)",26700,35000,8300,24
TIKI,nha-sach-tiki,188536931,"Gửi Người Bí Ẩn Thân Thương (Truyện Tranh)",91100,109000,17900,16
TIKI,nha-sach-tiki,137751490,"[Tặng Bút Lông + Lau Bảng] Bảng từ trắng treo tường viết bút lông Deli Nhiều kích cỡ - Dùng Cho Văn Phòng, Trường Học, Tập Vẽ, Ghi Chú Công Thức Nấu Ăn, Trang Trí Nhà Cửa",405000,405000,0,0
TIKI,nha-sach-tiki,46009013,"Fullmetal Alchemist - Cang Giả Kim Thuật Sư - Fullmetal Edition Tập 2",61100,69000,7900,11
TIKI,nha-sach-tiki,181379111,"Vô Cùng Tàn Nhẫn Vô Cùng Yêu Thương Tập 4",86420,149000,62580,42
TIKI,nha-sach-tiki,67040880,"Thân Mật Cội Nguồn Của Hạnh Phúc (Tái Bản 2020)",68100,98000,29900,31
TIKI,nha-sach-tiki,73810559,"Combo 3 Cuốn: Hiệu Ứng Chim Mồi Tập 1 + 2 + 3",182000,265000,83000,31
TIKI,nha-sach-tiki,107409375,"Tiếng Anh 6 I-Learn Smart World - Workbook (Sách Bài Tập)",68000,68000,0,0
TIKI,nha-sach-tiki,149942445,"Sức Mạnh Thương Mại Điện Tử - 12 Tháng Kiếm 1 Triệu Đô Bằng Kinh Doanh Online - Bộ Sách Trên Lưng Khổng Tượng",142000,199000,57000,29
TIKI,nha-sach-tiki,13065341,"Series Địch Công Kỳ Án Tập 16 - Quảng Châu Án",101000,158000,57000,36
TIKI,nha-sach-tiki,14100920,"Bánh Mì Kẹp Chuột (Tái Bản 2019)",58800,79000,20200,26
TIKI,nha-sach-tiki,45438055,"BỘ SÁCH HỌC TIẾNG ANH lITTLE STORIES",421000,650000,229000,35
TIKI,nha-sach-tiki,11347711,"All The Rule - Sống Bản Lĩnh Theo Cách Một Quý Cô",62100,96000,33900,35
TIKI,nha-sach-tiki,5112975,"Marketing giỏi phải kiếm được tiền - The end of marketing as we know it",299000,299000,0,0
TIKI,nha-sach-tiki,182149648,"Nước Ép Trị Liệu Và Chế Độ Ăn Theo Phương Pháp Cơ Thể Tự Chữa Lành",149300,199000,49700,25
TIKI,nha-sach-tiki,196395463,"Dưới cánh đại bàng (bìa mềm)",117300,138000,20700,15
TIKI,nha-sach-tiki,48592472,"Combo Truyện Tranh Song Ngữ Việt - Anh Cho Bé (12 Tập)",135000,180000,45000,25
TIKI,nha-sach-tiki,146988856,"Lựa Chọn Đúng Quan Trọng Hơn Nỗ Lực - 6 Bước Để Ra Quyết Định Hoàn Hảo",110000,170000,60000,35
TIKI,nha-sach-tiki,99992416,"Fullmetal Alchemist - Cang giả kim thuật sư - Fullmetal Edition - Tập 10",65600,69000,3400,5
TIKI,nha-sach-tiki,191655862,"[Combo Manga] Diệt Slime Suốt 300 Năm, Tôi Levelmax Lúc Nào Chẳng Hay (Tập 8 + 9)",148000,184000,36000,20
TIKI,nha-sach-tiki,123236564,"Combo 6 cuốn: Miếng dán Thông minh cho bé (Phát triển EQ - IQ) - My First Sticker Book",131040,252000,120960,48
TIKI,nha-sach-tiki,92996206,"Kinh Yoga Của Patanjali",60700,85000,24300,29
TIKI,nha-sach-tiki,186229224,"Bộ Sách Khởi Nghiệp Kinh Doanh Online - Marketing và Bán Hàng Hiệu Quả Với Thương Mại Điện Tử Tại Việt Nam",277000,378000,101000,27
TIKI,nha-sach-tiki,101325467,"Bộ Truyện Tranh Gieo Hạt Cùng Vĩ Nhân (Tập 1-10)",270000,270000,0,0
TIKI,nha-sach-tiki,57211757,"Utopia - Địa đàng trần gian (Tái Bản 2020)",43300,60000,16700,28
TIKI,nha-sach-tiki,145977548,"Kiếp Người - Vĩnh Cửu Và Vô Thường ",56100,79000,22900,29
TIKI,nha-sach-tiki,2903309,"Khéo Ăn Nói Sẽ Có Được Thiên Hạ ( Tái Bản )",104000,130000,26000,20
TIKI,nha-sach-tiki,149534865,"Bảy Thanh Hung Giản 2 - Hổ Phách Đỏ Son - Gió Cuốn Cát Bụi",171000,230000,59000,26
TIKI,nha-sach-tiki,194959695,"Thế Giới Mênh Mông Buồn Vui Cất Vào Lòng",64700,90000,25300,28
TIKI,nha-sach-tiki,152743069,"FPT Bí Lục - Khám Phá Văn Hoá Doanh Nghiệp Tại FPT",138000,199000,61000,31
TIKI,nha-sach-tiki,195801705,"Một Nửa Chiếc Va Li",116000,130000,14000,11
TIKI,nha-sach-tiki,464132,"Truyện Kiều",24000,35000,11000,31
TIKI,nha-sach-tiki,185232575,"Tiếng Anh 3 Extra and Friends Activity book (Sách bài tập)",65000,65000,0,0
TIKI,nha-sach-tiki,71898415,"Cơ Thể Ta Đã Hai Triệu Năm - Giải Mã Các Căn Bệnh Thời Hiện Đại",54800,79000,24200,31
TIKI,nha-sach-tiki,48362502,"Sang Chấn Tâm Lý - Hiểu Để Chữa Lành",226000,350000,124000,35
TIKI,nha-sach-tiki,151597556,"American Jetstream Pre-Intermediate A Student's book & Workbook ( không kèm CD)",207000,207000,0,0
TIKI,nha-sach-tiki,7958959,"5 Điểm Chết Trong Teamwork",79300,128000,48700,38
TIKI,nha-sach-tiki,21146016,"Tinh Mắt Bắt Hình – Nông Trại",41500,60000,18500,31
TIKI,nha-sach-tiki,185500892,"i-Learn Smart Start 5 Workbook Special Edition",81000,81000,0,0
TIKI,nha-sach-tiki,191919683,"Tro tàn của Angela",171000,220000,49000,22
TIKI,nha-sach-tiki,182736915,"Combo 3 Cuốn Sách: Cuộc Hành Hương Nội Tại - Chính Trực - Giác Ngộ",325100,467000,141900,30
TIKI,nha-sach-tiki,75601401,"Nghệ Thuật Bán Hàng Bằng Câu Chuyện",135360,188000,52640,28
TIKI,nha-sach-tiki,55119185,"Sách Nghĩ Giàu và Làm Giàu (Bìa Cứng) (Tái Bản 2020)",117000,168000,51000,30
TIKI,nha-sach-tiki,160585830,"Tôi Thích Tin Tức Tố Của Cậu - Tập 2 (Tặng Kèm Bookmark)",146000,169000,23000,14
TIKI,nha-sach-tiki,49002497,"Tâm Bệnh Học",82900,145000,62100,43
TIKI,nha-sach-tiki,188128048,"Ikigami - Tập 04",32100,45000,12900,29
TIKI,nha-sach-tiki,15256884,"Đầu Tư Tài Chính (Investments)",610000,659000,49000,7
TIKI,nha-sach-tiki,198016658,"Birdmen - Tập 8",29000,30000,1000,3
TIKI,nha-sach-tiki,184419723,"Sapiens Lược Sử Loài Người (Tái Bản 2022)",185400,299000,113600,38
TIKI,nha-sach-tiki,56757447,"Tiền Đẻ Ra Tiền: Đầu Tư Tài Chính Thông Minh",95100,139000,43900,32
TIKI,nha-sach-tiki,152743081,"Bàn Tay Ánh Sáng",193000,269000,76000,28
TIKI,nha-sach-tiki,167149888,"Khám Phá Đứa Trẻ Bên Trong Bạn",98000,139000,41000,29
TIKI,nha-sach-tiki,197634256,"Black Jack - Tập 14 (Bìa Cứng)",134000,135000,1000,1
TIKI,nha-sach-tiki,48629547,"Tiền Không Mua Được Gì (What money can't buy?) - Michael Sandel Tác giả Phải Trái Đúng Sai",78000,125000,47000,38
TIKI,nha-sach-tiki,14655498,"Bút bi TriTouch ngòi 0.7mm (hộp 12 cái)",54000,54000,0,0
TIKI,nha-sach-tiki,100947280,"Những Phương Thức Phục Hồi Sức Khỏe Theo Tự Nhiên (Tái Bản)",70800,99000,28200,28
TIKI,nha-sach-tiki,113656189,"Giáo Trình Lịch Sử Đảng Cộng Sản Việt Nam (Dành Cho Bậc Đại Học Hệ Không Chuyên Lý Luận Chính Trị) - Bộ mới năm 2021",84000,84000,0,0
TIKI,nha-sach-tiki,44976191,"Economix - Các Nền Kinh Tế Vận Hành (Và Không Vận Hành) Thế Nào Và Tại Sao?",114000,152000,38000,25
TIKI,nha-sach-tiki,181122317,"Chân Trần Chí Thép (Tái Bản 2022)",114000,168000,54000,32
TIKI,nha-sach-tiki,120357410,"Thực Hành Khởi Nghiệp - Từng Bước Nhỏ Làm Chủ Doanh Nghiệp Lớn",125000,169000,44000,26
TIKI,nha-sach-tiki,147920905,"Đường Mây Qua Xứ Tuyết (Tái Bản)",82100,118000,35900,30
TIKI,nha-sach-tiki,11508322,"Nội Tình Của Ngoại Tình",142000,220000,78000,35
TIKI,nha-sach-tiki,192339427,"Bà Bác Khủng Khiếp",116000,150000,34000,23
TIKI,nha-sach-tiki,190705661,"Lại Thằng Nhóc Emil",84500,109000,24500,22
TIKI,nha-sach-tiki,181699658,"Chiến Lược Giao Dịch Của Jesse Livermore",110700,159000,48300,30
TIKI,nha-sach-tiki,185500894,"i-Learn Smart Start 5 Student's Book Special Edition",113000,113000,0,0
TIKI,nha-sach-tiki,1029894,"Tuần Của Bé - Bé Tinh Tế (Dành Cho Trẻ 3 - 6 Tuổi)",21850,23000,1150,5
TIKI,nha-sach-tiki,25203389,"Advanced Grammar in Use Book with Answers  Edition: A Self-Study Reference and Practice Book for Advanced Learners of English",163800,178000,14200,8
TIKI,nha-sach-tiki,46723656,"Sách Tử Tế Đáng Giá Bao Nhiêu",68100,98000,29900,31
TIKI,nha-sach-tiki,3526069,"Quản Trị Nguồn Nhân Lực",116000,116000,0,0
TIKI,nha-sach-tiki,344788,"Bất Cứ Điều Gì Em Muốn",41400,69000,27600,40
TIKI,nha-sach-tiki,102832719,"Thay Tư Duy Xoay Cục Diện - Ngưng Sống Cầm Chừng",96300,129000,32700,25
TIKI,nha-sach-tiki,34751481,"Ngụ Ngôn Song Ngữ Anh - Việt: Kiến Và Chim Bồ Câu (Tái Bản 2019)",16800,28000,11200,40
TIKI,nha-sach-tiki,58627102,"Sổ Tay Nhà Thôi Miên",98500,145000,46500,32
TIKI,nha-sach-tiki,274145052,"Trạm Đọc| Hackers IELTS Basic: Reading + Writing + Speaking + Listening ( Dành cho người mới bắt đầu )",624000,836000,212000,25
TIKI,nha-sach-tiki,155463025,"Nghệ Thuật Bán Hàng Bậc Cao - Bí Quyết Chốt Deal Mọi Thời Đại (Khổ Lớn)(Tái Bản)",128000,198000,70000,35
TIKI,nha-sach-tiki,193450572,"Quái Mèo Độc Tấu",99200,119000,19800,17
TIKI,nha-sach-tiki,45321630,"Bạn Chỉ Tưởng Là Mình Đang Rất Cố Gắng",93000,123000,30000,24
TIKI,nha-sach-tiki,67712912,"Phát Triển Trí Tuệ Cảm Xúc- Chúng Mình Tôn Trọng Cơ Thể Và Cảm Xúc Của Nhau",37100,50000,12900,26
TIKI,nha-sach-tiki,193895767,"THE DAILY STOIC – 366 CHIÊM NGHIỆM VỀ TRÍ TUỆ VÀ LÒNG CAN TRƯỜNG CÙNG NGHỆ THUẬT SỐNG",166400,239000,72600,30
TIKI,nha-sach-tiki,171212880,"Ikigai – Đi Tìm Lý Do Thức Dậy Mỗi Sáng",61800,89000,27200,31
TIKI,nha-sach-tiki,193099629,"Chuyên Gia Kinh Tế Bước Vào Nhà Thổ Và Những Nơi Không Ngờ Khác Để Hiểu Về Rủi Ro",135000,175000,40000,23
TIKI,nha-sach-tiki,168559524,"Gia Đình Tỉnh Thức",149000,209000,60000,29
TIKI,nha-sach-tiki,115972858,"Sổ tay ghi chép lò xo màu pastel Deli - Giấy kẻ ngang 80 trang khổ A5 / B5 - Phù hợp làm sổ kế hoạch, sổ nhật kí, tập vở ghi chép - 24202 / 24203",33000,70200,37200,53
TIKI,nha-sach-tiki,40933973,"Dịch Kinh Tường Giải (Di Cảo): Quyển Thượng (Tái Bản)",222000,340000,118000,35
TIKI,nha-sach-tiki,568762,"Tam Quốc Diễn Nghĩa (Trọn Bộ 04 Tập)",182000,350000,168000,48
TIKI,nha-sach-tiki,176824204,"Tinh Hoa Kinh Tế Học (Tái Bản)",431000,555000,124000,22
TIKI,nha-sach-tiki,188960732,"COMBO TỰ HỌC TAROT: Sách Nhật ký Tarot + Bộ Bài & Sách Hướng Dẫn (Tái bản 2022)",296000,398000,102000,26
TIKI,nha-sach-tiki,55589742,"Sách Bài Học Diệu Kỳ Từ Chiếc Xe Rác (Khổ Lớn) (Tái Bản)",71100,108000,36900,34
TIKI,nha-sach-tiki,114228620,"Combo Tiếng Hàn Tổng Hợp Sơ Cấp 1 Dành Cho Người Việt Nam Bản In Màu - Học Kèm App",249900,357000,107100,30
TIKI,nha-sach-tiki,100202726,"Phương Pháp Wyckoff Hiện Đại - Kỹ thuật Nhận diện Xu hướng Thị trường Tiềm năng",356000,356000,0,0
TIKI,nha-sach-tiki,89001327,"Giao Dịch Theo Xu Hướng Để Kiếm Sống",366000,366000,0,0
TIKI,nha-sach-tiki,72202103,"Con Chim Xanh Biếc Bay Về (Nguyễn Nhật Ánh) (Bìa Mềm)",99000,150000,51000,34
TIKI,nha-sach-tiki,89204253,"4000 Từ Vựng Và Mẫu Câu Tiếng Anh Thiết Yếu Cho Trẻ Em",177000,250000,73000,29
TIKI,nha-sach-tiki,195959545,"Chú Thuật Hồi Chiến - Tập 6 - Bản Thường - Tặng Kèm Obi Và Thẻ Bo Góc Nhựa",29100,30000,900,3
TIKI,nha-sach-tiki,185658131,"Dragon Quest - Dấu Ấn Roto (Dragon Quest Saga Emblem Of Roto) Perfect Edition Tập 7 [Tặng Kèm Bookmark PVC] ",67100,75000,7900,11
TIKI,nha-sach-tiki,5743603,"Vật Lý Thiên Văn Cho Người Vội Vã",58700,80000,21300,27
TIKI,nha-sach-tiki,71094783,"Linh Hồn Của Tiền - The Soul Of Money",249000,249000,0,0
TIKI,nha-sach-tiki,95089986," Bút chì màu gốc dầu cao cấp Deli - 6565 / 6566 / 6567",250200,250200,0,0
TIKI,nha-cua-doi-song,152446518,"Cây cúc tần ấn độ - cây cảnh vườn + tặng phân bón cho cây",25000,30000,5000,17
TIKI,nha-cua-doi-song,4361879,"Bộ lọc nước thô đầu nguồn 3 cấp lọc 10inch Yamato YMTH10-3T",334000,450000,116000,26
TIKI,nha-cua-doi-song,155253236,"HỘP PIN MAXELL 40 VIÊN  AAA TEM BẠC - HÀNG CHÍNH HÃNG",51450,51450,0,0
TIKI,nha-cua-doi-song,174897090,"Combo 4 Miếng dán tường treo kệ bếp, kệ nhà tắm",24000,24000,0,0
TIKI,nha-cua-doi-song,212986033,"Đồng hồ bấm giờ đếm ngược điện tử mini, đồng hồ điện tử đa năng - Funu Home",65000,65000,0,0
TIKI,nha-cua-doi-song,150561019,"Ủng Bọc Giày Đi Mưa Cổ Cao Có Đế Chống Trượt",38900,38900,0,0
TIKI,nha-cua-doi-song,48354676,"Bộ 2 Hộp Thủy Tinh Chịu Nhiệt KLOCK KV400 (2 x 400ml) Tặng Túi Giữ Nhiệt",119000,199000,80000,40
TIKI,nha-cua-doi-song,67980198,"Phân bón hữu cơ sinh học KingCrop, dùng trồng rau, cây ăn trái sạch, an toàn",70000,70000,0,0
TIKI,nha-cua-doi-song,217766070,"Thùng Rác Văn Phòng Dạng Lưới Kim Loại Size 27cm",88000,88000,0,0
TIKI,nha-cua-doi-song,197649725,"Bình Nước Giữ Nhiệt 500ml Bằng Thép Không Gỉ 304 Hai Lớp Có Màn Hình Kỹ Thuật Số Hiển Thị Nhiệt Độ Cảm Biến 1 Chạm",125000,125000,0,0
TIKI,nha-cua-doi-song,35169106,"Bộ 3 đầu cọ bàn chải gắn máy Khoan cầm tay - Dụng cụ vệ sinh nhà cửa lốp xe thông minh",60000,149440,89440,60
TIKI,nha-cua-doi-song,196552579,"Ô Dù gấp gọn , dù che mưa , chống tia UV 8 nan ( nhiều mẫu )",51000,51000,0,0
TIKI,nha-cua-doi-song,274541068,"Combo 10 cặp nút tai chống ồn cao cấp Honeywell Max 1 - Nút bịt tai chống ồn khi đi ngủ, ôn thi, đi máy bay, công trình, xưởng in",3000,3000,0,0
TIKI,nha-cua-doi-song,35068214,"Pin 12V- Pin A23 Panasonic LRV08 - Hàng Chính Hãng",35000,35000,0,0
TIKI,nha-cua-doi-song,55718749,"Tấm lót silicon đa năng trơn dùng làm bánh lót bàn ăn",69000,69000,0,0
TIKI,nha-cua-doi-song,136014171,"Bình Nước Nhựa We Bare Bears 1l Dễ Thương Có Kèm Túi Rút Túi Giữ Nhiệt Và Ống Hút Siêu Tiện Lợi",418000,418000,0,0
TIKI,nha-cua-doi-song,26299212,"Miếng Che Mắt Ngủ Có Túi Gel Làm Mát - Màu Ngẫu Nhiên",32000,32000,0,0
TIKI,nha-cua-doi-song,100431737,"Bộ hộp bảo quản thực phẩm đa năng Nora Ez – FS11-E1++++",198000,198000,0,0
TIKI,nha-cua-doi-song,98955056,"Móc Treo Quần Áo Inox SUS304 7 Chấu Dán Tường Không Cần Khoan Đục - Tặng Kèm keo và Đinh Vít",150000,195000,45000,23
TIKI,nha-cua-doi-song,13509515,"Đèn LED siêu sáng USB 28 bóng AZONE",34000,89000,55000,62
TIKI,nha-cua-doi-song,46185330,"COMBO 10 MÓC INOX HÌNH CHỮ S NHỎ",60000,60000,0,0
TIKI,nha-cua-doi-song,128202074,"Găng Tay Siêu Dai Hình Con Hươu Lót Nỉ",21000,21000,0,0
TIKI,nha-cua-doi-song,59412424,"Bộ Dụng Cụ Bếp (Đũa, Sạn, Vá) Bằng Gỗ Nhãn Tự Nhiên - VAGOO - Làm Thủ Công Chống Thấm, Chống Ẩm Mốc, An Toàn Sức Khoẻ",169000,169000,0,0
TIKI,nha-cua-doi-song,25620364,"Set 300 ống hút nhựa PP an toàn",64500,64500,0,0
TIKI,nha-cua-doi-song,192443483,"Hộp cơm văn phòng KIPOR KP-HC01 - Thuỷ tinh cao cấp dùng được trong lò vi sóng - Chống tràn, tiện lợi - Hàng chính hãng",42000,72000,30000,42
TIKI,nha-cua-doi-song,42566535,"Dụng Cụ Mài Dao 3 Rảnh - Dụng Cụ Mài Nhiều Loại Dao, Nhiều Chế Độ",15000,15000,0,0
TIKI,nha-cua-doi-song,984752,"Nồi Inox 3 Đáy Fivestar N20-3DG (20cm) - Hàng Chính Hãng",279000,279000,0,0
TIKI,nha-cua-doi-song,59236591,"Cốc Thủy Tinh Chia Vạch Tiên Lợi-màu giao ngẫu nhiên- CCV",24000,26499,2499,9
TIKI,nha-cua-doi-song,145420630,"kệ treo quần áo chống gỉ / Giá treo áo khoác kim loại đơn giản và thời trang Bền Chắc Đa Năng Nội Thất Cho Phòng Ngủ- Bảo hành 10 năm",399000,399000,0,0
TIKI,nha-cua-doi-song,253106781,"Nút Nắp Đậy Chai Bằng Silicon Hình Con Chim Giao Màu Ngẫu Nhiên",61600,61600,0,0
TIKI,nha-cua-doi-song,11249688,"Dụng Cụ Bịt Mắt Ngủ- Màu Trắng Hình Ngẫu Nhiên",10800,10800,0,0
TIKI,nha-cua-doi-song,47271244,"Shaker Inox 2 mảnh - Cocktail Boston",175000,175000,0,0
TIKI,nha-cua-doi-song,101937904,"Kệ nhà tắm, Kệ để đồ toilet thông minh Kệ để đồ phòng tắm phòng vệ sinh dán tường không cần khoan đục",38999,38999,0,0
TIKI,nha-cua-doi-song,71692258,"Mũ làm khô tóc siêu thấm nước dùng sau khi gội đầu/tắm đa năng",42000,42000,0,0
TIKI,nha-cua-doi-song,116749239,"Ruột Gối Doona Basic độ bền cao, mềm mịn, an toàn cho sức khoẻ",195000,210000,15000,7
TIKI,nha-cua-doi-song,27826567,"Dụng cụ ép tỏi, nghiền tỏi có tay cầm tiện dụng",22000,22000,0,0
TIKI,nha-cua-doi-song,58498874,"Bộ Đũa Thìa Dĩa Inox, Hộp Đựng Lúa Mạch, Nhiều Màu Lựa Chọn, Tặng Kèm Ống Hút Tre",48999,48999,0,0
TIKI,nha-cua-doi-song,31264857,"Combo 5 Chiếc Khăn Tắm Xuất Nhật bản to 70x140cm",62999,62999,0,0
TIKI,nha-cua-doi-song,82979825,"Bàn Chải Đa Năng Cầm Tay Dùng Cho Phòng Tắm Hình Cá Voi Có Đế Đựng Tiện Lợi",45000,45000,0,0
TIKI,nha-cua-doi-song,26602007,"Kẹp Bẫy Bắt Chuột Thông Minh",7000,18000,11000,61
TIKI,nha-sach-tiki,181802012,"Set 50/100 tem dán cảm ơn khách và lưu ý quay video mở hàng (8x10cm) (1.025) - tem dán đơn hàng, kiện hàng dành cho shop",40000,40000,0,0
TIKI,nha-sach-tiki,14136016,"Phía Nam Biên Giới, Phía Tây Mặt Trời (Tái Bản 2018)",63300,85000,21700,26
TIKI,nha-sach-tiki,102893964,"Combo 5-10-20 Bút Bi Thiên Long TL-027 - Mực Xanh/Đen/Đỏ/Tím",23000,23000,0,0
TIKI,nha-sach-tiki,186265453,"Komi - Nữ Thần Sợ Giao Tiếp Tập 10 [Tặng Kèm PVC Card]",25000,25000,0,0
TIKI,nha-sach-tiki,32219488,"Doanh Nghiệp Của Thế Kỷ 21 (Tái Bản 2019)",62200,100000,37800,38
TIKI,nha-sach-tiki,189765038,"Python lập trình thuật toán",95000,95000,0,0
TIKI,nha-sach-tiki,186578226,"Hy vọng mong manh",118000,158000,40000,25
TIKI,nha-sach-tiki,160370181,"Khói Trời Lộng Lẫy (Tập Truyện Ngắn Nguyễn Ngọc Tư)(Tái Bản)",60800,90000,29200,32
TIKI,nha-sach-tiki,73685374,"Combo Trinh Thám Đen: Cô Dâu Đen + Ám Ảnh Đen + Điểm Hẹn Đen + Kết Hôn Với Người Chết",199500,399000,199500,50
TIKI,nha-sach-tiki,4978895,"Biết Chính Mình",60700,85000,24300,29
TIKI,nha-sach-tiki,58067801,"Luyện Kỹ Năng Phát Âm Tiếng Anh (Trình Độ Sơ Cấp) - English Pronunciation In Use (Elementary)",80000,80000,0,0
TIKI,nha-sach-tiki,52788074,"Khu Vườn Mùa Hạ (Tái Bản 2020)",50500,68000,17500,26
TIKI,nha-sach-tiki,192733741,"Mùi hương - Tái Bản",85800,115000,29200,25
TIKI,nha-sach-tiki,1362559,"Cổ Phiếu Thường, Lợi Nhuận Phi Thường (Tái Bản)",127400,199000,71600,36
TIKI,nha-sach-tiki,197652268,"Như Cơn Gió Thoảng - Nghĩ Về Những Qui Luật Cuộc Sống",103500,115000,11500,10
TIKI,nha-sach-tiki,27971953,"Lược Sử Tôn Giáo",96300,129000,32700,25
TIKI,nha-sach-tiki,48329799,"Tự Học Toàn Diện Hóa Học - Từ Cơ Bản Đến Nâng Cao Lớp 9",65000,99000,34000,34
TIKI,nha-sach-tiki,13312178,"Combo Tôi Tự Học và Óc Sáng Suốt ( Tặng Kèm Sổ Tay )",181350,181350,0,0
TIKI,nha-sach-tiki,185409035,"Bút Bi Nước Mực Gel Bấm Ngòi 0.5mm Deli - Có Ngòi Thay Thế Viết Trơn Đều Phù Hợp Ghi Chép Văn Phòng Học Sinh Sổ Tay - A575",2000,5400,3400,63
TIKI,nha-sach-tiki,141472522,"Sách: Cẩm Nang Tuổi Dậy Thì Dành Cho Bạn Gái (Tái Bản)",80000,100000,20000,20
TIKI,nha-sach-tiki,192909289,"Quán Rượu Dị Giới "Nobu" - Tập 09",31500,40000,8500,21
TIKI,nha-sach-tiki,90679276,"Mở Cửa Tương Lai",128000,200000,72000,36
TIKI,nha-sach-tiki,10379317,"Nghệ Thuật Giao Tiếp Để Thành Công (Tái Bản 2019)",98020,169000,70980,42
TIKI,nha-sach-tiki,83396665,"Hướng dẫn khởi động & 200 tư thế Yoga từ cơ bản đến nâng cao",128000,185000,57000,31
TIKI,nha-sach-tiki,68049234,"Đừng Để Mất Bò - 7 Bước Quản Lý Cửa Hàng Hiệu Quả Và Chống Thất Thoát",149000,169000,20000,12
TIKI,nha-sach-tiki,32720778,"Sách tiếng Anh - Principles: Life and Work",483600,520000,36400,7
TIKI,nha-sach-tiki,177569697,"Perfect Ielts Vocabulary (Tái Bản)",162200,259000,96800,37
TIKI,nha-sach-tiki,176831144,"Combo 23 Tập Thanh Gươm Diệt Quỷ (Tập 1-23)",499000,575000,76000,13
TIKI,nha-sach-tiki,146271773,"Nghiệp Tình Yêu - Karma Of Love (Tái Bản 2021)",175200,199000,23800,12
TIKI,nha-sach-tiki,102832718,"Thay Tư Duy Xoay Cục Diện - Vĩnh Biệt Lối Mòn",84100,119000,34900,29
TIKI,nha-sach-tiki,122869197,"túi giấy đựng quà các cỡ loại đẹp có nắp",9000,14400,5400,38
TIKI,nha-sach-tiki,111582624,"Trải Nghiệm Apple - Xây Dựng Lòng Trung Thành Không Chỉ Từ Sản Phẩm",197000,239000,42000,18
TIKI,nha-sach-tiki,117254518,"Thiên Nga Hoang Dã",271000,350000,79000,23
TIKI,nha-sach-tiki,1007137,"Tự Học 2000 Từ Vựng Tiếng Anh Theo Chủ Đề",45500,65000,19500,30
TIKI,nha-sach-tiki,105614665,"Bút bi bấm ngòi 0.7mm mực xanh Deli - Màu sắc theo lựa chọn -  1 chiếc - EQ199-BL",7200,7200,0,0
TIKI,nha-sach-tiki,187827438,"Vọng Lâu Tử Thần",72400,120000,47600,40
TIKI,nha-sach-tiki,113540588,"Thiên Táng",73900,96000,22100,23
TIKI,nha-sach-tiki,88592202,"Tiny Habits : Thói quen tí hon - Tiềm năng khổng lồ",299000,299000,0,0
TIKI,nha-sach-tiki,176550198,"Nam Hải Dị Nhân Liệt Truyện",353000,500000,147000,29
TIKI,nha-sach-tiki,195521211,"Diệt Slime Suốt 300 Năm, Tôi Levelmax Lúc Nào Chẳng Hay (Tập 11)",119000,159000,40000,25
TIKI,nha-cua-doi-song,188769126,"Chuông cửa không dây thông minh CACAZI A10, chống nước khoảng cách sử dụng trong 300M, 60 loại nhạc chuông, 110 DB",185000,185000,0,0
TIKI,nha-cua-doi-song,185004559,"Ly Thủy Tinh Hoa Văn Navivu Vintage Glass 300 - 350ml",47000,47000,0,0
TIKI,nha-cua-doi-song,28619438,"Thang nhôm rút gọn SUMIKA SK320 - Chiều cao tối đa 3.2m, chiều dài rút gọn 0.8m, hợp kim nhôm cao cấp, khóa chốt chắc chắn, đế cao su chống trượt, nhỏ gọn, di chuyển tiện lợi",1139000,1500000,361000,24
TIKI,nha-cua-doi-song,30008695,"Vĩ 5 viên pin Maxell dòng cao cấp CR2032",20050,20050,0,0
TIKI,nha-cua-doi-song,157175018,"Kệ Thanh Ngang Treo Tường Kết Cấu Giấu Chân SIB Decor, Gỗ Lõi Xanh Chống Ẩm, Kèm Phụ Kiện Và Thước Thuỷ Lấy Cân Bằng",89000,89000,0,0
TIKI,nha-cua-doi-song,173768367,"Hộp đựng đồ chia ngăn 7 - 9 và 12 ngăn sắp xếp quần áo Danido - Khay đựng đồ chia ngăn tiện ích, chất liệu cao cấp",75050,79000,3950,5
TIKI,nha-cua-doi-song,42718737," Đèn Led Trang Trí Bóng Tròn Dài 6M - 40  Bóng Trang Trí Noel Lễ Tết",80000,80000,0,0
TIKI,nha-cua-doi-song,49123718,"Bàn Học, Bàn Làm Việc Thông Ming Thương Hiệu IGEA",758000,825000,67000,8
TIKI,nha-cua-doi-song,696521,"Ổ Cắm Điện 4 Lỗ 3 Chấu 2 cổng USB Philips SPN6248WB/74 (2500W)",416000,469000,53000,11
TIKI,nha-cua-doi-song,148810239,"Hộp Cơm Cắm Điện Đời Mới Chính Hãng MINIIN, Hâm Nóng, Giữ Nhiệt, Nấu Chín Cơm Và Thức Ăn, 2 Tầng Nhỏ Gọn, 4 Bát Innox Không Gỉ, Tặng Kèm Bộ Đũa Và Thìa, Đa Chức Năng, Dễ Dàng Vệ Sinh",220150,259000,38850,15
TIKI,nha-cua-doi-song,153263106,"Kéo Cắt Gà  Nhật Bản Làm Bếp Đa Năng Cắt Vải Cắt Giấy SK5 Siêu Sắc - Hàng Loại 1- Chính Hãng",58000,65000,7000,11
TIKI,nha-cua-doi-song,155718559,"Bình xịt dầu ăn, xịt gia vị dạng phun sương chai thủy tinh 100ml - hàng chính hãng THAFA",35000,39000,4000,10
TIKI,nha-cua-doi-song,7078973,"Kìm Cắt Chân Linh Kiện PLT 170 125mm",17000,17000,0,0
TIKI,nha-cua-doi-song,76058957,"Kệ gia vị chữ E cao cấp VANDO bằng thép carbon chống gỉ, chống xước, kệ đựng chai lọ gia vị đa năng, kệ để đồ nhà bếp gọn gàng, sang trọng",399000,656000,257000,39
TIKI,nha-cua-doi-song,117791447,"Bình nước cho bé đi học, Bình uống nước cho bé có ống hút 700ml bằng nhựa PP chịu nhiệt tốt tặng kèm túi và dây đeo tiện lợi BBShine – BN011",94000,150000,56000,37
TIKI,nha-cua-doi-song,120470924,"Bình Thuỷ Tinh Luminarc Dona Embossment Ray 1L - LUDOQ0436 ",104000,104000,0,0
TIKI,nha-cua-doi-song,42264813,"Kẹp phơi đồ Inox -Kẹp phơi quần áo đồ chống gió",61800,61800,0,0
TIKI,nha-cua-doi-song,36935892,"Combo 10 khăn lau bếp đa năng - KL29 (Giao ngẫu nhiên mẫu)",10000,10998,998,9
TIKI,nha-cua-doi-song,34527170,"Giấy bạc dán tường nhà bếp chống thấm dầu, thấm nước tiện dụng 3mx60cm",20999,20999,0,0
TIKI,nha-cua-doi-song,138534630,"Tủ nhựa KATA 5 tầng giá rẻ, chất lượng, chính hãng, nhiều màu sắc",1049000,1250000,201000,16
TIKI,nha-cua-doi-song,263488389,"Kệ sách để bàn HT003  - Vàng vân gỗ - Ván dày 12mm",47000,58000,11000,19
TIKI,nha-cua-doi-song,73758944,"Kệ Đa Năng Để Lò Vi Sóng INOX Trắng Cao Cấp Chống Han Gỉ Kệ Để Đồ Nặng Siêu Gọn Cho Nhà Bếp VANDO",599000,856000,257000,30
TIKI,nha-cua-doi-song,165219472,"Sét 10 khay giấy bạc,khay bạc đựng thực phẩm lót nồi chiên không dầu chịu nhiệt độ cao",10000,13000,3000,23
TIKI,nha-cua-doi-song,85908084,"Nhang Sạch Phòng Máy Lạnh - Ít khói - Hương trầm dịu nhẹ - Chân tăm mộc - Nhang Xanh - 300g - 20cm",120000,120000,0,0
TIKI,nha-cua-doi-song,190989561,"Bình đựng thức ăn giữ nhiệt Inox 316 Elmich EL-8019 dung tích 600ml",301000,419000,118000,28
TIKI,nha-cua-doi-song,161455577,"Đui đèn cảm biến chuyển động",42000,42000,0,0
TIKI,nha-cua-doi-song,90072128,"Kệ Giày Dép 7 Tầng Rộng 80cm Gỗ Tự Nhiên 100%- TN",745000,980000,235000,24
TIKI,nha-cua-doi-song,26053920,"Vòi Nước Inox 304 Loại Tốt",34293,34293,0,0
TIKI,nha-cua-doi-song,174489182,"Túi đựng rác phân hủy sinh học Sunhouse KS-GA6578BS",46000,70000,24000,34
TIKI,nha-cua-doi-song,1084776,"Chảo Chống Dính Vân Đá Đáy Từ HappyCook MFP-26IH GRAY (26cm)",235000,373000,138000,37
TIKI,nha-cua-doi-song,98678067,"10 Thùng hộp carton - Mã MHL8 - Kích thước 50x40x30 (cm)",162000,162000,0,0
TIKI,nha-cua-doi-song,146373034,"Hộp Đựng Đồ Dùng Gấp Gọn Cao Cấp BA01 Kích Thước 38x25x25cm Tiện Lợi, Hộp Vải Chia Ngăn Đựng Quần áo, Hộp vải chia 7 ngăn, chia 9 ngăn, chia 11 ngăn, chia 12 ngăn - Chính Hãng dododios",65000,65000,0,0
TIKI,nha-cua-doi-song,108712114,"Kèn Melodion Swan 32 Phím Model SW-37 Tặng kèm túi đựng TIKCO và khăn lau hàng chính hãng",195000,195000,0,0
TIKI,nha-cua-doi-song,69927147,"Túi Đựng Hộp Cơm Giữ Nhiệt Đa Lớp Nhiều Hoa Văn - Xanh Denim",23896,23896,0,0
TIKI,nha-cua-doi-song,180750013,"VẢI GA BỌC GHẾ SOFA GIƯỜNG - SOFA BED",66000,66000,0,0
TIKI,nha-cua-doi-song,58536862,"Cặp Vỏ Gối Lụa Cao cấp A - 50x70cm hoặc 60x80cm - mềm mịn mát lạnh",165000,200000,35000,18
TIKI,nha-cua-doi-song,54758744,"combo 5 keo bẫy  chuột siêu dính cao cấp , dùng được nhiều lần ",34900,34900,0,0
TIKI,nha-cua-doi-song,71342375,"Áo Mưa Bít Trẻ Em Vải Dù Siêu Dày Hàng Việt Nam, Chống Thấm Nước, Phơi Mau Khô Ráo, Che Kín Người An Toàn Cho Bé, Có Lựa Chon Size, Giới Tính Cho Bé ( Giao Màu - Mẫu Ngẫu Nhiên Vì Nhiều Hoạt Tiết)",90000,90000,0,0
TIKI,nha-cua-doi-song,75483321,"Dụng Cụ Cọ Rủa Bình,Ly Có Đầu Mút-Giao Màu Ngẫu Nhiên",12000,12000,0,0
TIKI,nha-cua-doi-song,133245917,"Hộp Đựng Bàn Chải Và Nhả Kem Đánh Răng Tự Động Tặng Kèm  Cốc Hút Từ -Kệ Để Đồ Nhà Tắm Dán Tường Tiện Lợi- Hàng Chính Hãng MINIIN",145350,153000,7650,5
TIKI,nha-cua-doi-song,144203362,"Bộ túi hộp cơm thủy tinh Lock&amp;Lock 3EA LLG429DS2GRY (LLG429Dx1, LLG428x1, HWB820GRYx1) - Màu",355000,682000,327000,48
TIKI,nha-cua-doi-song,38306937,"Vỉ 5 Viên Pin CR1616 Lithium 3V Panasonic - Hàng Chính Hãng",86400,89000,2600,3
TIKI,nha-cua-doi-song,177081696,"Cây Sứ Thái Kép Hoa Tím - cây cảnh để trong nhà + tặng phân bón cho cây",65000,110000,45000,41
TIKI,nha-cua-doi-song,118898224,"Phin nhôm cao cấp hoa văn màu đen có hộp giấy",75000,75000,0,0
TIKI,nha-cua-doi-song,70840199,"Vá Canh Bằng Gỗ Nhãn Tự Nhiên - VAGOO - Làm Thủ Công Chống Thấm, Chống Ẩm Mốc, An Toàn Cho Sức Khoẻ",99000,99000,0,0
TIKI,nha-cua-doi-song,180001622,"Bộ 2 Ly Thuỷ Tinh Cao Luminarc Salto Frost Lime 350ml - LUSAQ3177",139000,180000,41000,23
TIKI,nha-cua-doi-song,139161475," Muỗng, Muôi Múc Canh, Vá múc canh Inox 304 Cao Cấp, Sang Trọng Cho Bữa Cơm",45000,45000,0,0
TIKI,nha-cua-doi-song,52609001,"Đèn Pin Mini Cầm Tay Siêu Sáng Loại Đèn Nhỏ 3W Police Dùng Pin AA",31000,55000,24000,44
TIKI,nha-cua-doi-song,8085585,"Giấy lọc cà phê Hario 40 cái (V60-VCF-02-40W)",47000,58000,11000,19
TIKI,nha-cua-doi-song,54644755,"Áo bọc bàn để ủi quần áo, nhiều họa tiết - Áo trùm bàn ủi đồ, chọ size theo ý, giao mẫu ngẫu nhiên+ Tặng kèm hình dán",59000,59000,0,0
TIKI,nha-cua-doi-song,167937668,"Aó mưa măng tô,Áo mưa có dây kéo ,vải dù cao cấp chống thấm nước cực tốt ,bảo vệ cơ thể ấm áp,cho nam và nữ",151050,159000,7950,5
TIKI,nha-cua-doi-song,46178511,"Túi Lọc Sữa Đậu Nành, Túi Lọc Sữa Hạt Cao Cấp, Túi Lọc Trà, Túi Lọc Gia Vị - Hàng Chính Hãng",28000,60000,32000,53
TIKI,nha-cua-doi-song,184915910,"Chậu Gội Đầu Tại Nhà, Tại Giường Cho Người Già, Người Bệnh, Trẻ Em",89000,125000,36000,29
TIKI,nha-cua-doi-song,77315431,"[Chọn màu] Bộ 20 miếng bọc chân ghế tròn, chân bàn bằng silicon dày, bọc chân bàn chống trượt, chống xước cho sàn gỗ GD365-BCGheTron-20",19998,19998,0,0
TIKI,nha-cua-doi-song,16284231,"Bộ 50 móc dán tường siêu dính ",22999,22999,0,0
TIKI,nha-cua-doi-song,25036470,"Bình Lọc Nước Barrier Nika (2.5l) - Xanh Lá",206000,450000,244000,54
TIKI,nha-cua-doi-song,25731116,"Thùng vuông 55 lít - có bánh xe Duy Tân No.748 (61 x 43 x 32 cm)",195000,195000,0,0
TIKI,nha-cua-doi-song,67937873,"Tấm bảo vệ nệm Everon White",370000,370000,0,0
TIKI,nha-cua-doi-song,243047801,"Gối tựa lưng văn phòng cao su non A kích thước 34 x 34 cm x 6/10cm",180000,180000,0,0
TIKI,nha-cua-doi-song,17998301,"Túi đựng đồ lót nhiều ngăn có móc treo",32600,32600,0,0
TIKI,nha-cua-doi-song,57521842,"Bàn Học Bàn Làm Việc Kết Hợp Kệ Sách Thương Hiệu IGEA",569000,620000,51000,8
TIKI,nha-cua-doi-song,143322314,"Ron chặn khe hở 90cm đa năng, Nẹp dán chân cửa chống côn trùng, phù hợp mọi loại cửa tiện dụng-GD534-Ron90",29000,29000,0,0
TIKI,nha-cua-doi-song,27068546,"Bộ 2 Túi Đựng Chăn Màn - Túi Quần Áo Khung Sắt Gấp Gọn 2 Chiếc Cao Cấp (Giao màu ngẫu nhiên)",169000,250000,81000,32
TIKI,nha-cua-doi-song,42354346,"Gối Chữ U Kèm Bịt Mắt, Bịt Tai – Gối Ngủ Du Lịch, Tựa Đầu Chống Mỏi Chất Liệu Memory Foam Chính Hãng miDoctor – mi1711",149000,149000,0,0
TIKI,nha-cua-doi-song,58678597,"Hộp Cơm Điện Lock&Lock EJR226IVY (2 Lít)",1010000,1942000,932000,48
TIKI,nha-cua-doi-song,3677777,"Bình Lọc Nước BRITA Active Pink - 600ml (Kèm Microdisc)",549000,849000,300000,35
TIKI,nha-cua-doi-song,12461025,"Nước cắm hoa công nghệ nano đồng Fresh Flowers AHT 430ml - giúp hoa lâu tàn, không thối nước",44000,55000,11000,20
TIKI,nha-cua-doi-song,198562465,"Bàn Làm Việc, Bàn Học Có Ngăn Để Đồ Tiện Dụng Phong Cách Bắc Âu Thương Hiệu IGA - GP185",613000,666000,53000,8
TIKI,nha-cua-doi-song,4216861,"Kính bảo hộ 3M SF401AF chống đọng sương",75000,75000,0,0
TIKI,nha-cua-doi-song,93062863,"Ô dù tự động thông minh cao cấp toàn Fully Automatic Safe Umbrella, cơ chế giữ nước như dù ngược, khung nan chắc chắn chống gió bão cấp 6, vải siêu chống nước phủ Nano chống tia UV",259000,259000,0,0
TIKI,nha-cua-doi-song,152446716,"Cây Lài Trà - cây cảnh vườn + Tặng phân bón cho cây mau lớn",25000,30000,5000,17
TIKI,nha-cua-doi-song,32153958,"Khóa Số ABUS 145/20 (20mm) - Nhiều Màu",129000,139000,10000,7
TIKI,nha-cua-doi-song,155114109,"Ngăn Kéo Nhựa Nhỏ Mini, Khay Đựng Bút Gắn, Hộp ngăn kéo Treo Dưới Bàn Làm Việc Giúp Cất Giữ Gọn Gàng Bàn Làm Việc (Giao Màu Ngẫu Nhiên)",119000,119000,0,0
TIKI,nha-cua-doi-song,146288304,"Giá để/ Chân để/ Giá đỡ/ Chân đỡ đàn Guitar cao cấp - Kzm Kurtzman J2 - Đa năng, dành cho tất cả loại đàn Guitar - Màu đen - Hàng chính hãng",168000,168000,0,0
TIKI,nha-cua-doi-song,207557574,"Bàn học gấp gọn ngồi bệt, bàn chân nhựa cứng 40x60cm mặt gỗ MDF loại đẹp ( giao màu ngẫu nhiên )",60000,77000,17000,22
TIKI,nha-cua-doi-song,53521887,"Giấy lọc cà phê Hario 40 cái (V60-VCF-02-40M)",49000,62000,13000,21
TIKI,nha-cua-doi-song,52354974,"Combo 9 Ván Sàn Gỗ Tự Nhiên Màu Nâu Vàng, Vỉ Gỗ Lót Sàn Ban Công, Sân Vườn, Hồ Bơi, Phòng Spa, Siêu Bền, Chịu Nước Tốt, Chống Trơn Trượt, Tiêu Chuẩn Xuất Khẩu",249000,279000,30000,11
TIKI,nha-cua-doi-song,68716601,"Dao Gọt Hoa Quả Sunhouse KS-KN100PS",33000,49000,16000,33
TIKI,nha-cua-doi-song,126244017,"Ghế Học Sinh Tiểu Học Chống Gù Thông Minh Có Gác Chân BHS288 Ghế Ngồi Bàn Học Cho Bé Tuỳ Chỉnh Độ Cao - Hàng Chính Hãng",1035000,1265000,230000,18
TIKI,nha-cua-doi-song,82877146,"Đèn Bàn Học LED Chống Cận GHINER GN-1902 (Pin 4500mAh)",250000,320000,70000,22
TIKI,dien-thoai-may-tinh-bang,274179544,"Điện thoại Realme C51 (6GB/256GB) - Hàng Chính Hãng",3390000,4190000,800000,19
TIKI,dien-thoai-may-tinh-bang,273359059,"Điện Thoại Chắc Chắn OUKITEL WP23 PRO ( Ram 16Gb(8GB+8Gb),Rom 128GB ,Android13, Pin 10600mAh,Màn hình 6.52 "HD + ,13MP camera Sau,chống nước,chống va đập)-hàng chính hãng",4990000,4990000,0,0
TIKI,dien-thoai-may-tinh-bang,270471106,"Điện Thoại Nokia 105 4G Pro TA-1538 - Hàng Chính Hãng",630000,680000,50000,7
TIKI,dien-thoai-may-tinh-bang,248704404,"Điện Thoại Samsung Galaxy A14 (4GB/128GB) - Hàng Chính Hãng",3672000,3672000,0,0
TIKI,dien-thoai-may-tinh-bang,65091422,"Điện thoại Oukitel WP6 (Chống va đập,chống nước,Ram 6Gb,Rom 128Gb,pin 8.000mAh) hàng chính hãng",6990000,6990000,0,0
TIKI,dien-thoai-may-tinh-bang,212261734,"Điện thoại Masstel Play 10 4G Thiết kế hầm hố,Khung viền kim loại - Hàng chính hãng",558000,799000,241000,30
TIKI,dien-thoai-may-tinh-bang,271966786,"iPhone 15",19490000,21490000,2000000,9
TIKI,dien-thoai-may-tinh-bang,272909668,"[Mới] Điện thoại vivo V29e 5G (8GB/256GB) - Hàng Chính Hãng - Camera Selfie 50 MP - Vòng Sáng Aura 2.0 - Màn hình AMOLED 6.67",8690000,8990000,300000,3
TIKI,dien-thoai-may-tinh-bang,274166857,"Điện thoại Samsung Galaxy S23 FE (8GB/128GB) - Hàng chính hãng",14890000,14890000,0,0
TIKI,dien-thoai-may-tinh-bang,274316885,"Điện Thoại Xiaomi POCO X6 5G 8GB-256GB - Hàng chính hãng",7510000,9990000,2480000,25
TIKI,dien-thoai-may-tinh-bang,271494404,"Điện thoại Tecno POVA 5 (8GB+8GB/128GB) RAM mở rộng 16GB | Pin 6000 mAh | Màn 120Hz - Sạc nhanh 45W - Hàng Chính Hãng",3799000,4490000,691000,15
TIKI,dien-thoai-may-tinh-bang,273373436,"Điện thoại Xiaomi Redmi 13C (6GB/128GB) - Hàng chính hãng - Bảo hành 18 tháng",3028000,3490000,462000,13
TIKI,dien-thoai-may-tinh-bang,273774937,"Điện thoại Samsung Galaxy A15 (8GB/128GB) - Hàng chính hãng - Đã kích hoạt bảo hành điện tử",4455000,4990000,535000,11
TIKI,dien-thoai-may-tinh-bang,271118390,"Điện thoại OPPO Reno10 5G (8GB/256GB) - Hàng Chính Hãng",9190000,10990000,1800000,16
TIKI,dien-thoai-may-tinh-bang,261946899,"Điện Thoại Samsung Galaxy A14 (6GB/128GB) - Hàng Chính Hãng",3999000,4990000,991000,20
TIKI,dien-thoai-may-tinh-bang,274498288,"Điện Thoại Samsung Galaxy A35 5G (8GB/128GB)- Hàng Chính Hãng",7890000,8290000,400000,5
TIKI,dien-thoai-may-tinh-bang,271982547,"Điện thoại Oukitel  WP12 Pro (chống nước,chống va đập,RAM 8GB(Ram 4GB+ 4Gb),Rom 64 Gb,8 nhân)- hÀng chính hãng",3990000,3990000,0,0
TIKI,dien-thoai-may-tinh-bang,263073555,"Điện thoại Tecno CAMON 20 8GB/256GB - Camera 64MP + 32MP | 5000 mAh | Sạc nhanh 33W | 6.7'' FHD AMOLED - BH 13 Tháng - Hàng Chính Hãng",4990000,4990000,0,0
TIKI,dien-thoai-may-tinh-bang,274059475,"Điện Thoại Samsung Galaxy S24 Ultra (12GB/256GB) - Hàng Chính Hãng",33990000,33990000,0,0
TIKI,dien-thoai-may-tinh-bang,273430216,"Điện thoại Ulefone Armor 13 (pin khủng,pin 13.200mAh, Ram 8Gb,Rom 256Gb,chống sốc,chống va đập,nội soi,tia hồng ngoại,tia lade,loa to,học online)- hàng chính hãng",7990000,7990000,0,0
TIKI,dien-thoai-may-tinh-bang,272348047,"Điện Thoại Samsung A05s 4GB/128GB - Hàng Chính Hãng",3239000,3990000,751000,19
TIKI,dien-thoai-may-tinh-bang,274542883,"Điện Thoại Samsung A35 5G 8GB/128GB - Hàng Chính Hãng",7369000,8290000,921000,11
TIKI,dien-thoai-may-tinh-bang,273718967,"Điện Thoại Samsung A15 8GB/128GB - Hàng Chính Hãng",4349000,4990000,641000,13
TIKI,dien-thoai-may-tinh-bang,209927605,"Combo máy đọc sách Kindle 2022 (11th) tặng kèm bao da ( Cover ) - Hàng nhập khẩu",3069000,3100000,31000,1
TIKI,dien-thoai-may-tinh-bang,271128271,"Điện Thoại Oppo A58 6GB/128GB - Hàng Chính Hãng",4349000,4990000,641000,13
TIKI,dien-thoai-may-tinh-bang,273252926,"Điện Thoại Oppo A18 (4GB/128GB) - Hàng Chính Hãng",3390000,3990000,600000,15
TIKI,dien-thoai-may-tinh-bang,257682739,"Điện thoại Samsung Galaxy A04 (3GB/32GB) - Đã kích hoạt bảo hành điện tử -  Hàng chính hãng",1999000,2990000,991000,33
TIKI,dien-thoai-may-tinh-bang,273958512,"Điện thoại Xiaomi Redmi Note 13 (6GB/128GB) - Hàng chính hãng",4890000,4890000,0,0
TIKI,dien-thoai-may-tinh-bang,263274580,"Điện thoại Samsung Galaxy M14 5G (4GB/64GB) - Hàng chính hãng - Đã kích hoạt bảo hành điện tử",2743000,3990000,1247000,31
TIKI,dien-thoai-may-tinh-bang,272222033,"Máy đọc sách Boox Palma - Hàng Chính Hãng",7200000,8590000,1390000,16
TIKI,dien-thoai-may-tinh-bang,25949745,"Máy Đọc Sách Kindle Oasis (10th Gen) 2019- 8GB - Hàng Chính Hãng",6043100,6790000,746900,11
TIKI,dien-thoai-may-tinh-bang,273897523,"Điện thoại Tecno SPARK 20 (8+8)GB/128GB - Helio G85 | 5000 mAh | Sạc nhanh 18W | Hàng Chính Hãng",3390000,3490000,100000,3
TIKI,dien-thoai-may-tinh-bang,52002453,"Cisco Unified IP Phone 7962G - Hàng chính hãng",4900000,4900000,0,0
TIKI,dien-thoai-may-tinh-bang,217640502,"Máy đọc sách Kindle Scribe - Hàng chính hãng",12590000,12590000,0,0
TIKI,dien-thoai-may-tinh-bang,274375122,"Điện thoại Xiaomi Redmi Note 13 Pro 4G (8GB/128GB) - Hàng chính hãng",6489000,7290000,801000,11
TIKI,dien-thoai-may-tinh-bang,273553649,"Điện thoại Oppo A18 - Hàng chính hãng",3499000,3690000,191000,5
TIKI,dien-thoai-may-tinh-bang,52480318,"Điện thoại bàn cổ điển DT115",2500000,2500000,0,0
TIKI,dien-thoai-may-tinh-bang,248799307,"Điện thoại Xiaomi 13 Lite (8GB/256GB) - Hàng chính hãng",11490000,11490000,0,0
TIKI,dien-thoai-may-tinh-bang,273378164,"Điện thoại Xiaomi Redmi 13C (6GB/128GB) - Hàng chính hãng - Đã kích hoạt bảo hành điện tử",2960100,3490000,529900,15
TIKI,dien-thoai-may-tinh-bang,274164078,"Máy tính bảng Samsung Galaxy Tab A9 WIFI 4GB-64GB- Hàng chính hãng",3210000,3990000,780000,20
TIKI,nha-sach-tiki,170490710,"Bàn Về Cách Sống – Đối Thoại Giữa Triết Gia, Bác Sĩ Và Nhà Sư",99600,139000,39400,28
TIKI,nha-sach-tiki,153518828,"Hong Tay Khói Lạnh (Tản Văn Nguyễn Ngọc Tư)",62000,90000,28000,31
TIKI,nha-sach-tiki,174605338,"Bách Khoa Thư Về Nghệ Thuật",301400,499000,197600,40
TIKI,nha-sach-tiki,109298270,"Sách Cẩm Nang Con Gái (Tái Bản)",47500,68000,20500,30
TIKI,nha-sach-tiki,171549954,"Tâm Hồn Cao Thượng",150000,220000,70000,32
TIKI,nha-sach-tiki,145092110,"Cách Biến Đổi Câu Trong Tiếng Anh",57900,80000,22100,28
TIKI,nha-sach-tiki,130230750,"Combo 10 Tập - Truyện tranh song ngữ Việt-Anh dành cho trẻ em - Cùng học cư xử tốt",278000,280000,2000,1
TIKI,nha-sach-tiki,189643106,"Tự Tôn",117700,169000,51300,30
TIKI,nha-sach-tiki,77900450,"Đạo Phật Vỡ Lòng (Tái Bản)",49600,69000,19400,28
TIKI,nha-sach-tiki,194197858,"Achievers grade 7 Workbook",112000,112000,0,0
TIKI,nha-sach-tiki,165700192,"Lịch Sử Vú",173000,248000,75000,30
TIKI,nha-sach-tiki,72542474,"Biên Niên Cô Đơn (Bản Thông Thường)",72000,99000,27000,27
TIKI,nha-sach-tiki,46259908,"Fibonacci Trading",299000,299000,0,0
TIKI,nha-sach-tiki,5852521,"Combo Cà Phê Cùng Tony và Trên Đường Băng",186950,186950,0,0
TIKI,nha-sach-tiki,136539753,"Tự Chữa Lành Thông Qua Hiểu Biết Về Khoa Học Tâm Thức",85200,119000,33800,28
TIKI,nha-sach-tiki,189557422,"THINK OUT OF THE BOOK - Nghĩ Ngoài Sách Vở",190000,220000,30000,14
TIKI,nha-sach-tiki,75697497,"Lịch Sử Triết Học (Trọn Bộ 2 Tập) (Tập 1: Triết Học Cổ Đại Và Trung Đại + Tập 2: Triết Học Cận Đại Và Hiện Đại)",853000,900000,47000,5
TIKI,nha-sach-tiki,190705658,"Bật Khóc Ở H Mart",104000,140000,36000,26
TIKI,nha-sach-tiki,12533371,"Đạo Đức Kinh",66400,99000,32600,33
TIKI,nha-sach-tiki,196001728,"Vạn Sắc Hư Vô",99000,150000,51000,34
TIKI,nha-sach-tiki,58067806,"Từ Vựng Tiếng Anh Thực Hành (Trình Độ Trung Cấp) - English Collocation In Use (Intermediate)",47000,80000,33000,41
TIKI,nha-sach-tiki,87149160,"Bộ Cọ Vẽ Chuyên Nghiệp Deli - Dùng Cho Màu Nước/Bột/Sơn Acrylic -Set 4/6 Cây- 73885/73866/73867",40000,88200,48200,55
TIKI,nha-sach-tiki,190242072,"Qủy Ấn - Bộ 2 tập ( Tập 1 và 2) - tặng kèm 1 bookmark",211000,291000,80000,27
TIKI,nha-sach-tiki,69621516,"Combo sách: Bài thơ - bài hát - câu đố dành cho bé (tái bản 2020)",95000,135000,40000,30
TIKI,nha-sach-tiki,13797246,"Combo 6 Cuốn Ehon nhật bản - Giờ Chơi Của Bé ( Tái Bản )",125000,174000,49000,28
TIKI,nha-sach-tiki,170345811,"Phân Tích Khách Hàng For Dummies",159000,229000,70000,31
TIKI,nha-sach-tiki,137241901,"Thần Số Học: Sức Mạnh Của Những Con Số",98500,139000,40500,29
TIKI,nha-sach-tiki,10244763,"Bút quay nghệ thuật - Era PS Mod",99000,99000,0,0
TIKI,nha-sach-tiki,157468180,"Trọn Bộ 4 Quyển Sách Trên Lưng Khổng Tượng - Kinh Doanh Online Trên Sàn Thương Mại Điện Tử - Khởi Nghiệp Với Bán Hàng Qua Mạng và Nhãn Hàng Riêng",481000,796000,315000,40
TIKI,nha-sach-tiki,185055209,"Osho - Combo Sống Hài Hòa (Yêu, Cảm Xúc, Hiểu)",375000,524000,149000,28
TIKI,nha-sach-tiki,273714632,"Trí Tuệ Do Thái (Tái Bản)",140900,189000,48100,25
TIKI,nha-sach-tiki,192048663,"Sáng trăng",57500,75000,17500,23
TIKI,nha-sach-tiki,160585764,"Veil - Thân Nhiệt Của Sắc Cam - Tập 1 (Tặng Kèm Postcard)",92200,109000,16800,15
TIKI,nha-sach-tiki,127377217,"Sách Người Trong Muôn Nghề: Ngành Sáng tạo và Nghệ thuật có gì?",201000,219000,18000,8
TIKI,nha-sach-tiki,6482397,"Hàn Quốc Dưới Chế Độ Độc Tài Phát Triển Park Chung Hee (1961 – 1979)(Tái Bản 2020)",76000,98000,22000,22
TIKI,nha-sach-tiki,193981040,"Birdmen - Tập 5",29000,30000,1000,3
TIKI,nha-sach-tiki,54614791,"Từ Điển Tâm Lý - Tính Cách Và Cảm Xúc Đến Từ Đâu ?",94000,128000,34000,27
TIKI,nha-sach-tiki,193177952,"Bản đặc biệt Tổng ôn 30 chuyên đề ngữ pháp tiếng anh cô Trang anh 2023",199000,300000,101000,34
TIKI,nha-sach-tiki,38436464,"Khác Biệt Để Bứt Phá (Tái Bản 2019)",89100,128000,38900,30
TIKI,nha-sach-tiki,193896561,"Ninja Rantaro - Tập 59",37100,40000,2900,7
TIKI,dien-thoai-may-tinh-bang,273659145,"Máy tính bảng Masstel Kidzone dành cho bé - quản lý thời gian cho bé - bé học tốt, hiệu quả cao - 1 đổi 1 trong 100 ngày - Hàng chính hãng",2990000,3990000,1000000,25
TIKI,dien-thoai-may-tinh-bang,272273169,"Điện thoại Samsung Galaxy M34 5G (8GB/128GB) - Hàng chính hãng",7590000,7990000,400000,5
TIKI,dien-thoai-may-tinh-bang,249851724,"Điện Thoại 4G Masstel Lux 10 - 2 Sim 2 Sóng - Sóng 4G HD Call - Loa To Rõ - Pin Bền - Hàng Chính Hãng - Bảo Hành 12 Tháng",675000,675000,0,0
TIKI,dien-thoai-may-tinh-bang,223859345,"Điện thoại Masstel Fami 60 - Hàng chính hãng ",730000,730000,0,0
TIKI,dien-thoai-may-tinh-bang,200819471,"Điện thoại Mobell Rock 4 4G , Pin 3250mah , Loa Siêu lớn - Hàng chính hãng",685000,799000,114000,14
TIKI,dien-thoai-may-tinh-bang,200829966,"Điện thoại Mobell M239 4G - 2 SIM - Hàng chính hãng",415000,500000,85000,17
TIKI,dien-thoai-may-tinh-bang,274611998,"Điện thoại Xiaomi Redmi 12 (4GB/128GB) - Hàng chính hãng",3790000,3790000,0,0
TIKI,dien-thoai-may-tinh-bang,274545326,"Điện thoại OPPO A36 6GB/128GB, Chip Snapdragon 680 , Màn 90Hz , Rom Tiếng việt - Hàng nhập khẩu",3050000,3590000,540000,15
TIKI,dien-thoai-may-tinh-bang,179547641,"Máy đọc sách Kindle Paperwhite 5 (8GB) - Hàng chính hãng",3750000,3750000,0,0
TIKI,dien-thoai-may-tinh-bang,270473116,"Điện thoại Xiaomi Redmi Note 12 (8GB/128GB) - Hàng chính hãng",4489000,5790000,1301000,22
TIKI,dien-thoai-may-tinh-bang,205815576,"Apple iPad 10.9-inch (10th Gen) Wi-Fi, 2022",9990000,12990000,3000000,23
TIKI,dien-thoai-may-tinh-bang,250109584,"Điện thoại Xiaomi Redmi Note 12 (4GB/128GB) - Hàng chính hãng",3600000,4990000,1390000,28
TIKI,dien-thoai-may-tinh-bang,273438769,"Điện thoại Xiaomi Redmi A2 2GB/32GB MediaTek Helio G36 , Pin 5000 mAh - Hàng chính hãng",1669000,2190000,521000,24
TIKI,dien-thoai-may-tinh-bang,271364652,"Máy tính bảng Xiaomi Pad 6 (8GB/128GB) -  Hàng chính hãng - Đã kích hoạt bảo hành điện tử",8790000,9490000,700000,7
TIKI,dien-thoai-may-tinh-bang,263309601,"Điện thoại siêu bền Oukitel K16(mini,Vỏ lưng bằng da,Ram 8Gb,Rom 128Gb,camera 48MP,pin 3.050mAh)- hàng chính hãng",4990000,4990000,0,0
TIKI,dien-thoai-may-tinh-bang,242771940,"Điện Thoại Samsung A04e 3GB/32GB - Hàng Chính Hãng",2109000,2990000,881000,29
TIKI,dien-thoai-may-tinh-bang,270164674,"Điện thoại OPPO A78 (8GB/256GB) - Hàng Chính Hãng",6990000,6990000,0,0
TIKI,dien-thoai-may-tinh-bang,271046571,"Điện thoại Xiaomi Redmi Note 12 (8GB/128GB) - Hàng chính hãng",3790000,4790000,1000000,21
TIKI,dien-thoai-may-tinh-bang,248590019,"Điện thoại Xiaomi Redmi 12C (3GB/32GB) - Hàng chính hãng",2808000,2808000,0,0
TIKI,dien-thoai-may-tinh-bang,168094334,"Điện thoại Samsung Galaxy S20 FE (8GB/256GB) - Hàng chính hãng",8625000,8625000,0,0
TIKI,dien-thoai-may-tinh-bang,274542808,"Điện Thoại Samsung A55 5G 8GB/128GB - Hàng Chính Hãng",9499000,9990000,491000,5
TIKI,dien-thoai-may-tinh-bang,271973414,"iPhone 15 Pro Max 256GB Titan Tự Nhiên",30990000,33990000,3000000,9
TIKI,dien-thoai-may-tinh-bang,197214015,"Apple iPhone 14 Plus",19490000,27990000,8500000,30
TIKI,dien-thoai-may-tinh-bang,251407092,"Điện Thoại Samsung Galaxy A34 5G (8GB/128GB) ĐKH -  Hàng Chính Hãng",7164000,7164000,0,0
TIKI,dien-thoai-may-tinh-bang,219400421,"Điện thoại OPPO CPH2471 - A17k Xanh - Hàng Chính Hãng (chỉ giao HN và một số khu vực)",3276000,3276000,0,0
TIKI,dien-thoai-may-tinh-bang,249169833,"Điện thoại Samsung Galaxy A34 5G 8GB/128GB Đen - Hàng chính hãng",7164000,7164000,0,0
TIKI,dien-thoai-may-tinh-bang,176438864,"Điện thoại Xiaomi REDMI 9A (2+32) Xanh dương - Hàng chính hãng (chỉ giao HN và một số khu vực)",2088000,2088000,0,0
TIKI,dien-thoai-may-tinh-bang,249890677,"Điện Thoại Xiaomi Redmi Note 12 4GB/128GB - Hàng Chính Hãng",3599000,4990000,1391000,28
TIKI,dien-thoai-may-tinh-bang,253395356,"Điện Thoại Samsung M14 5G 6GB/128GB - Hàng Chính Hãng",5292000,5292000,0,0
TIKI,dien-thoai-may-tinh-bang,246163082,"Điện Thoại Nokia C30 2GB/32GB - Hàng Chính Hãng",1599000,2290000,691000,30
TIKI,dien-thoai-may-tinh-bang,273595363,"Oukitel wp30 Pro 5g SIÊU BỀN (sạc nhanh 120W ,pin 11000 mAh,màn hình 6.78 inch,Ram 24 GB(12gb + 12GB),Rom 512GB ,120Hz ,Android 13,camera 108mp)- hàng chính hãng",11990000,11990000,0,0
TIKI,dien-thoai-may-tinh-bang,262055875,"Điện thoại POCO M5 4GB+64GB - Pin 5000mAh - MediaTek Helio G99 -  Sạc nhanh 18W - Hàng chính hãng",2599000,3990000,1391000,35
TIKI,dien-thoai-may-tinh-bang,216092766,"Điện Thoại Oppo Reno 8T 4G (8GB/256GB)",8136000,8136000,0,0
TIKI,dien-thoai-may-tinh-bang,270975124,"Điện Thoại Oppo A58 6GB/128GB - Hàng Chính Hãng",4190000,4990000,800000,16
TIKI,dien-thoai-may-tinh-bang,258668285,"Điện thoại cố định Panasonic KX-TS520MX ( màu đen)-Hàng chính hãng",449000,469000,20000,4
TIKI,dien-thoai-may-tinh-bang,273389282,"Điện Thoại ulefone armor 21(Loa to 122dB Speaker ,pin 9600mAh,sạc nhanh 33W,Màn hình 6.58 in,camera chính 64MP,ban đêm 24MP,Ram 16Gb(8+8),rom 256Gb, điều khiển từ xa đa năng)- hàng chính hãng",6990000,6990000,0,0
TIKI,dien-thoai-may-tinh-bang,202035122,"[HCM]Ốp Lưng IPHONE Cường Lực Trong Suốt Cao Cấp Cho Dòng Iphone 14/14Pro/14Plus/14 Pro Max, Iphone 13Mini/13Pro/13ProMax, Iphone 12/12Pro/12Promax, Iphone 11/11Pro/11ProMax- Hàng nhập khẩu",110000,110000,0,0
TIKI,dien-thoai-may-tinh-bang,274393574,"Điện thoại Xiaomi Poco C65 - Hàng chính hãng",3090000,3090000,0,0
TIKI,dien-thoai-may-tinh-bang,274316036,"Điện Thoại Samsung Galaxy M34 5G 8GB-128GB - Hàng chính hãng",6250000,7990000,1740000,22
TIKI,dien-thoai-may-tinh-bang,274564360,"Điện Thoại Xiaomi Redmi 12 4G (4GB/128GB) - Hàng chính hãng",3290000,4990000,1700000,34
TIKI,dien-thoai-may-tinh-bang,274524033,"Điện thoại người già Masstel Fami 12S 4G(LTE) , Bàn phím chữ số to, Loa lớn , Máy viền thép chắc chắn - Hàng chính hãng",569000,650000,81000,12
TIKI,dien-thoai-may-tinh-bang,244167098,"Điện thoại Xiaomi Redmi 12C (4GB/64GB) - Hàng chính hãng",3168000,3168000,0,0
TIKI,dien-thoai-may-tinh-bang,274383701,"Điện thoại Samsung Galaxy A05s 6GB-128GB - Hàng chính hãng",3890000,3890000,0,0
TIKI,dien-thoai-may-tinh-bang,274560616,"Máy tính bảng học tập giá rẻ Nexta Edutab Kid cho bé từ 5-8 tuổi, màn hình full HD 64GB, bao da, kính dán cường lực, hàng chính hãng",4990000,4990000,0,0
TIKI,dien-thoai-may-tinh-bang,273231495,"Máy tính bảng Masstel tab 10.1 pro - Hàng chính hãng",4290000,4290000,0,0
TIKI,dien-thoai-may-tinh-bang,225960096,"Điện Thoại Samsung Galaxy S23+ 5G - Hàng Chính Hãng",18000000,18000000,0,0
TIKI,dien-thoai-may-tinh-bang,205846229,"Điện Thoại Oppo A57 4GB/128GB - Hàng Chính Hãng",4632000,4632000,0,0
TIKI,dien-thoai-may-tinh-bang,249168300,"Điện thoại OPPO A57 4GB/128GB Đen - Hàng chính hãng",4890000,4990000,100000,2
TIKI,dien-thoai-may-tinh-bang,273185467,"Điện thoại Samsung A05 4GB - hàng chính hãng",3112000,3112000,0,0
TIKI,dien-thoai-may-tinh-bang,274162900,"Điện thoại OPPO A18 4GB-128GB - Hàng chính hãng",3690000,3990000,300000,8
TIKI,dien-thoai-may-tinh-bang,215119245,"Điện Thoại Di Động Forme D888 4G - Hàng Chính Hãng",680000,680000,0,0
TIKI,dien-thoai-may-tinh-bang,274364026,"Máy tính bảng học tập thông minh Nexta Edutab Pro tối ưu cho trẻ 9-12 tuổi, 64GB, tích hợp ứng dụng học tập - Hàng nhập khẩu",6490000,6490000,0,0
TIKI,dien-thoai-may-tinh-bang,230055130,"Điện thoại Oppo Reno8 T (8GB/256GB) - Hàng chính hãng",10392000,10392000,0,0
TIKI,dien-thoai-may-tinh-bang,243165179,"Điện thoại OPPO Reno8 T 4G (8GB/256GB) - Hàng Chính Hãng",8136000,8136000,0,0
TIKI,dien-thoai-may-tinh-bang,252073013,"Điện thoại hiệu Masstel Fami 60 - Hàng chính hãng - Giá rẻ - hỗ trợ 4G - dành cho người lớn tuổi",730000,730000,0,0
TIKI,dien-thoai-may-tinh-bang,258766897,"Điện Thoại Masstel iZi 11 4G - Hàng Chính Hãng",468000,468000,0,0
TIKI,dien-thoai-may-tinh-bang,273559020,"Máy tính bảng Kindle Fire HD10 2023 13th - 32Gb - Hàng chính hãng",3390000,3390000,0,0
TIKI,dien-thoai-may-tinh-bang,249782771,"Máy tính bảng Xelex Gama Tab X8 EDU (Hàng chính hãng)",2890000,2890000,0,0
TIKI,dien-thoai-may-tinh-bang,248185860,"Điện Thoại Masstel Fami 12 4G - Hàng Chính Hãng",630000,630000,0,0
TIKI,dien-thoai-may-tinh-bang,216934468,"Điện thoại Samsung Galaxy A14 5G (4GB/128GB) - Hàng chính hãng",5000000,5000000,0,0
TIKI,dien-thoai-may-tinh-bang,244308977,"Điện Thoại Xiaomi Redmi 12C 4GB/64GB - Hàng Chính Hãng",3168000,3168000,0,0
TIKI,dien-thoai-may-tinh-bang,272273680,"Điện thoại Samsung Galaxy A05s (4GB/128GB) - Hàng chính hãng",3174000,4290000,1116000,26
TIKI,dien-thoai-may-tinh-bang,248754839,"Điện Thoại OPPO A17K (3GB/64GB) - Hàng Chính Hãng",3276000,3276000,0,0
TIKI,dien-thoai-may-tinh-bang,200848570,"Điện thoại Mobell M539 4G - Màn hình lớn 2.8 inch - Hàng chính hãng",626000,730000,104000,14
TIKI,dien-thoai-may-tinh-bang,191089547,"Điện Thoại Nokia 110 4G - Hàng Chính Hãng",675000,899000,224000,25
TIKI,dien-thoai-may-tinh-bang,175967811,"Điện Thoại Samsung Galaxy S20 FE 256GB | 8GB - Hàng Chính Hãng",8625000,8625000,0,0
TIKI,dien-thoai-may-tinh-bang,274638556,"BÚT MÁY ĐỌC SÁCH KINDLE SCRIBE - HÀNG CHÍNH HÃNG",2500000,2500000,0,0
TIKI,dien-thoai-may-tinh-bang,274257669,"Điện thoại Masstel Izi S1 4G (LTE) Gọi HD Call - Hàng chính hãng",420000,499000,79000,16
TIKI,dien-thoai-may-tinh-bang,273407277,"Máy tính bảng chắc chắn Oukitel RT7(Chống va đập,Màn hình 10.1" FHD+,Pin 32000mAh ,Ram 24GB,Rom 256GB, Android 13,Camera sau 48MP, tầm nhìn ban đêm 20MP,camera trước 32MP,5G) – hàng chính hãng",13990000,13990000,0,0
TIKI,dien-thoai-may-tinh-bang,262688183,"ĐIỆN THOẠI MASSTEL IZI 30 4G-LTE-HÀNG CHÍNH HÃNG",560000,560000,0,0
TIKI,dien-thoai-may-tinh-bang,230155305,"Điện thoại Xiaomi Redmi Note 10 JE 5G 4GB/64GB - Màn 90HZ - Chống Nước IP68 - Hàng Nhập Khẩu - Bản quốc tế",2276000,3990000,1714000,43
TIKI,dien-thoai-may-tinh-bang,198968094,"Điện Thoại Xiaomi Redmi A1 2GB/32GB - Hàng Chính Hãng",1749000,2190000,441000,20
TIKI,dien-thoai-may-tinh-bang,68693081,"Điện Thoại Samsung Galaxy S20 FE (8GB/256GB) - Hàng Chính Hãng",8625000,8625000,0,0
TIKI,dien-thoai-may-tinh-bang,175851126,"Máy Tính Bảng Galaxy Tab A8 4GB | 64GB - Hàng Chính Hãng",5856000,5856000,0,0
TIKI,dien-thoai-may-tinh-bang,136364272,"Máy tính bảng Masstel Tab 10.4" (4GB/64GB) - Hàng chính hãng - ĐÃ KÍCH HOẠT BẢO HÀNH ĐIỆN TỬ",4800000,4800000,0,0
TIKI,dien-thoai-may-tinh-bang,103168071,"Máy tính bảng Samsung Galaxy Tab A7 Lite LTE SM-T225 - Hàng Chính Hãng",3587000,3587000,0,0
TIKI,dien-thoai-may-tinh-bang,271801317,"Máy tính bảng siêu bền Oukitel RT6 (chống nước,chống va đập,pin 20000mAh,Ram 16Gb(8GB+8Gb),Rom 256GB,Màn hình 10.1" ,FHD,Android 13,CPU MTK8788 ,Camera 16MP,sạc nhanh 33W)-hàng chính hãng",9990000,9990000,0,0
TIKI,dien-thoai-may-tinh-bang,245770248,"Điện thoại Xiaomi Redmi 12C (4GB/64GB) - Hàng chính hãng",3168000,3168000,0,0
TIKI,dien-thoai-may-tinh-bang,274065746,"Điện thoại siêu bền Oukitel WP33 Pro 5G (Loa to 136 dB (5W) ,Pin 22000mAh,màn hình 6,6 inch FHD+,Ram 24GB(8+16),Rom 256GB, Camera 64MP,sạc nhanh 33W)- hàng chính hãng",8990000,8990000,0,0
TIKI,dien-thoai-may-tinh-bang,198671718,"Điện Thoại Samsung Galaxy A04s (4GB/64GB) - Hàng Chính Hãng - Đã kích hoạt bảo hành điện tử",2670000,3990000,1320000,33
TIKI,dien-thoai-may-tinh-bang,181699208,"Máy tỉnh bảng Samsung Galaxy Tab A8 -Hàng chính hãng",5856000,5856000,0,0
TIKI,dien-thoai-may-tinh-bang,273186334,"Điện thoại Samsung Galaxy A05s 4GB/128GB- Hàng Chính hãng",3980000,3980000,0,0
TIKI,dien-thoai-may-tinh-bang,250113073,"Điện thoại Xiaomi Redmi Note 12 Pro 5G (8GB/256GB) - Hàng chính hãng",9000000,9000000,0,0
TIKI,dien-thoai-may-tinh-bang,196348143,"Điện Thoại OPPO A57 (4GB/64GB) - Hàng Chính Hãng",4284000,4284000,0,0
TIKI,dien-thoai-may-tinh-bang,253443652,"Điện Thoại Samsung Galaxy M14 5G - Hàng Chính Hãng",4212000,4212000,0,0
TIKI,dien-thoai-may-tinh-bang,168317790,"Điện Thoại Xiaomi Redmi 9A (2GB/32GB)- Đã kích hoạt bảo hành điện tử- Hàng Chính Hãng - Peacock Green",2088000,2088000,0,0
TIKI,dien-thoai-may-tinh-bang,244182370,"Điện thoại Samsung Galaxy S23 Ultra 1TB - Hàng chính hãng",44990000,44990000,0,0
TIKI,dien-thoai-may-tinh-bang,272200109,"Điện Thoại Samsung Galaxy A04e - Hàng Chính Hãng",2340000,2340000,0,0
TIKI,dien-thoai-may-tinh-bang,242657652,"Điện thoại Samsung Galaxy S23 Plus 256GB - Hàng chính hãng",26990000,26990000,0,0
TIKI,dien-thoai-may-tinh-bang,273438458,"Điện thoại Samsung Galaxy A05 (4GB/128GB)- Helio G85 - Sạc nhanh 25W - Hàng chính hãng",2636000,3090000,454000,15
TIKI,dien-thoai-may-tinh-bang,273947785,"Điện thoại AI Samsung Galaxy S24+ 12GB/256GB, Camera 50MP, Màn hình 6.7"- Đen- Hàng Chính Hãng",25490000,27490000,2000000,7
TIKI,dien-thoai-may-tinh-bang,262660017,"Điện Thoại Samsung Galaxy A24 (6GB/128GB) - Hàng Chính Hãng",5800000,5800000,0,0
TIKI,dien-thoai-may-tinh-bang,252423003,"Điện thoại Tecno SPARK 10 4GB/128GB - Camera 50MP | 5000 mAh | Sạc nhanh 18W | Cảm ứng vân tay - Hàng chính hãng",3190000,3190000,0,0
TIKI,dien-thoai-may-tinh-bang,273366493,"Máy tính bảng chắc chắn Ulefone Armor Pad 2(màn hình 11" ,2K, pin 18600 mAh, IP68/IP69K, Android 13, NFC ,GPS, 4G, Ram 16GB(8gb+8gb),rom 256GB)- hàng chính hãng",7990000,7990000,0,0
TIKI,dien-thoai-may-tinh-bang,258373871,"Điện Thoại Itel S23 128GB/16GB (8GB+8GB) | Pin 5000mAh | 6.6 Inch | Camera 50MP | 90Hz | Face ID - Hàng chính Hãng",2342000,3490000,1148000,33
TIKI,dien-thoai-may-tinh-bang,102620086,"Điện thoại VoIP Yealink SIP-T30 - Hàng Chính Hãng",1200000,1200000,0,0
TIKI,dien-thoai-may-tinh-bang,271341795,"Điện thoại smartphone Masstel Hapi 15 (2GB/16GB) - 2 Sim, Tặng kèm ốp lưng - Hàng chính hãng - Bảo hành chính hãng",1499000,1499000,0,0
TIKI,dien-thoai-may-tinh-bang,160051501,"Điện thoại Masstel IZI 20 4G - Hàng chính hãng, Nguyên Seal",512000,512000,0,0
TIKI,dien-thoai-may-tinh-bang,215543460,"Điện Thoại Samsung Galaxy A14 5G (4GB/128GB) - Hàng Chính hãng",5190000,5190000,0,0
TIKI,dien-thoai-may-tinh-bang,248766283,"Máy đọc sách New Kindle 11th 2022 (Kids) kèm bao da - Hàng Chính Hãng",3010000,3299000,289000,9
TIKI,dien-thoai-may-tinh-bang,212329857,"Điện thoại Xiaomi Redmi 9A 2GB/32GB Xám - Hàng chính hãng",2088000,2088000,0,0
TIKI,dien-thoai-may-tinh-bang,215135773,"Điện Thoại Di Động Forme D111 4G - Hàng Chính Hãng",520000,520000,0,0
TIKI,dien-thoai-may-tinh-bang,273511450,"Điện thoại Xiaomi Redmi 12 8GB/128GB - Hàng Chính Hãng",4390000,4390000,0,0
TIKI,dien-thoai-may-tinh-bang,226552005,"Điện thoại bàn Panasonic KX-TSC11 hàng chính hãng",600000,600000,0,0
TIKI,dien-thoai-may-tinh-bang,272113804,"[MỚI] Điện thoại vivo Y17s - Hàng chính hãng - Camera 50MP - Pin 5000 mAh - Sạc nhanh- RAM mở rộng đến 8GB",3790000,3990000,200000,5
TIKI,dien-thoai-may-tinh-bang,273440662,"Điện thoại Xiaomi Redmi 12 (4GB/128GB) , Helio G88 , Màn 90HZ - Hàng chính hãng",3299000,4290000,991000,23
TIKI,dien-thoai-may-tinh-bang,201001781,"Điện thoại Masstel Lux 10 4G - Nhiều chức năng - Hàng chính hãng",675000,675000,0,0
TIKI,dien-thoai-may-tinh-bang,200816374,"Điện Thoại Forme D888 - Hàng Chính Hãng",589000,699000,110000,16
TIKI,dien-thoai-may-tinh-bang,249734070,"Điện Thoại Masstel Fami 12 4G LTE - 2 Sim- Pin 1400 mAh - Đọc số bằng giọng nói - Hàng Chính Hãng - Bảo Hành 12 Tháng",630000,630000,0,0
TIKI,dien-thoai-may-tinh-bang,274638430,"Điện thoại Redmi Note 13R 5G 4GB/128GB Dimensity 6100+ , Màn 90Hz , Rom quốc tế có sẳn Tiếng việt - Hàng nhập khẩu",2899000,3590000,691000,19
TIKI,dien-thoai-may-tinh-bang,208171115,"Điện thoại OUKITEL WP18 (Chống nước ,chống va đập, pin khủng 12500mAh, Ram 4GB ,Rom 32GB ,màn hình 5.93 inch,Điện thoại chắc chắn) – HÀNG CHÍNH HÃNG",3990000,3990000,0,0
TIKI,dien-thoai-may-tinh-bang,251514670,"Điện thoại Xiaomi Redmi Note 12 (4GB/128GB) Màn AMOLED 120HZ, Snapdragon 685 , Sạc 33W - Hàng chính hãng",3599000,4990000,1391000,28
TIKI,dien-thoai-may-tinh-bang,271234313,"Điện Thoại Nokia 110 4G Pro - Hàng Chính Hãng",699000,710000,11000,2
TIKI,dien-thoai-may-tinh-bang,274456687,"Điện thoại Samsung Galaxy A55 5G (8GB/128GB) - Hàng chính hãng",9990000,9990000,0,0
TIKI,dien-thoai-may-tinh-bang,274019962,"Điện thoại Masstel Fami 8 4G(LTE) Gọi HD call , Bàn phím chữ số lớn,Loa to - Hàng chính hãng",489000,550000,61000,11
TIKI,dien-thoai-may-tinh-bang,274030201,"Điện thoại TECNO SPARK 10 8GB/128GB - Hàng Chính Hãng",2832000,3590000,758000,21
TIKI,dien-thoai-may-tinh-bang,207883258,"Điện thoại oukitel  wp21 (Ram 12Gb,Rom 256Gb ,chống sốc,chống nước,pin khủng, pin 9.800mAh) - hàng chính hãng",9970000,9970000,0,0
TIKI,dien-thoai-may-tinh-bang,209872337,"Máy đọc sách Kindle 2022 (11th) - All new kindle 2022 11th màn hình 6inch 300PPI gấp 2 lần độ sắc nét, 16GB bộ nhớ trong với cổng kết nối USB-C - Hàng nhập khẩu",2300000,2300000,0,0
TIKI,dien-thoai-may-tinh-bang,273454566,"Điện thoại Xiaomi POCO C65 (6GB/128GB) - Helio G85 - Màn 90HZ - Hàng chính hãng",2669000,2990000,321000,11
TIKI,dien-thoai-may-tinh-bang,131028406,"Máy tính bảng Fire HD 10 Plus 2021 thế hệ 11th",3551100,3990000,438900,11
TIKI,nha-cua-doi-song,199263383,"Bàn Ăn Phong Cách Bắc Âu Đơn Giản Thương Hiệu IGA - GP181",485000,528000,43000,8
TIKI,nha-cua-doi-song,162407831,"Kệ Để Máy Tính Kết Hợp Kệ Sách Đa Năng Hiện Đại Thương Hiệu IGA - GP184",176000,186000,10000,5
TIKI,nha-cua-doi-song,51473042,"Kệ đa năng Tokyo 4 tầng hàng cao cấp",154000,154000,0,0
TIKI,nha-cua-doi-song,89198232,"Kệ Gia Vị Để Bàn Nora Cho Phòng Bếp Gọn Gàng - GM04",133000,146000,13000,9
TIKI,nha-cua-doi-song,165594187,"Kệ Sách Để Bàn Có Hộc Đựng Tiện Lợi Thương Hiệu IGA - GP187",134000,134000,0,0
TIKI,nha-cua-doi-song,131498054,"Bóng đèn LED trụ Hi-lumen G3 PHILIPS E27 - Độ sáng cao, tiết kiệm điện, chất lượng ánh sáng vượt trội - Hàng Chính Hãng",134000,264000,130000,49
TIKI,nha-cua-doi-song,208358660,"Ổ cắm điện LiOA đa năng - 3 lỗ, 4 lỗ, 6 lỗ, 8 lỗ dây dài 3m/5m - Chính Hãng - MITA",95000,95000,0,0
TIKI,nha-cua-doi-song,135507759,"Dây vòi hoa sen tắm nóng lạnh Pimisi bằng inox 304 với đầu dây đồng thau không gỉ phù hợp với mọi sen tắm trong nhà vệ sinh dài 150cm chống xoắn - mạ xi sáng bóng - ống mềm cấp nước và dùng được cho cả vòi xịt nhà vệ sinh phòng tắm | Hàng chính hãng",87000,120000,33000,28
TIKI,nha-cua-doi-song,158804921,"Gối ngủ cao su non vỏ sợi tre kháng khuẩn cao cấp cho người lớn EMA - Phong cách Nhật Bản - Chống đau mỏi cổ vai gáy, ngủ ngáy - KT 50x30x10cm",149000,298000,149000,50
TIKI,nha-cua-doi-song,131145091,"Giá Sách Mini Tủ Đầu Giường Phong Cách Nordic Thương Hiệu IGA - GP156",221000,240000,19000,8
TIKI,nha-cua-doi-song,175147417,"Set 10 hộp nhựa chữ nhật mỏng đựng thực phẩm Đại Đồng Tiến 100% nhựa PP an toàn cho sức khỏe dùng được cho lò vi sóng",49020,51600,2580,5
TIKI,nha-cua-doi-song,96703757,"bàn làm việc - Nâu - 80x40x75cm",179999,179999,0,0
TIKI,nha-cua-doi-song,182602992,"Khăn Tắm Gội Đầu Lau Mặt ROYAL TOWEL Dùng Cho Gia Đình Spa Khách Sạn 100% Cotton Thấm Hút Không Ra Màu",29000,29000,0,0
TIKI,nha-cua-doi-song,50775246,"Gối hơi du lịch, gối kê cổ du lịch, văn phòng tự bơm, gối hơi kê cổ đa năng, nhiều màu, giao ngẫu nhiên+ Tặng kèm hình dán",95000,95000,0,0
TIKI,nha-cua-doi-song,117138509,"Ổ cắm điện LiOA đa năng - 3 lỗ, 4 lỗ, 6 lỗ, 8 lỗ dây dài 3m/5m - Chính Hãng - MITA",92000,92000,0,0
TIKI,nha-cua-doi-song,135442402,"Mỏ Hàn Điện Deli Chính Hãng 30W / 60W Chất Lượng Cao - Sử Dụng Đa Năng, Tiện Ích - DL8830 / DL8860",83000,142200,59200,42
TIKI,nha-cua-doi-song,6710595,"Bộ 10 móc treo dán tường chịu lực 10kg",4000,30000,26000,87
TIKI,nha-cua-doi-song,27948515,"Bộ 2 móc treo chổi, cây lau nhà dụng cụ tẩy rửa nhà tắm dán tường chống khuẩn tiết kiệm không gian chịu lực tối đa 5Kg",10899,10899,0,0
TIKI,nha-cua-doi-song,58802544,"Hộp Cơm Giữ Nhiệt INOX304 Hiện Đại Tặng Kèm Túi Giữ Nhiệt",162630,208500,45870,22
TIKI,nha-cua-doi-song,35273810,"Keo vá tường,Keo trám vết nứt tường thông minh - Tặng kèm bộ dụng cụ",16051,16051,0,0
TIKI,nha-cua-doi-song,52021508,"Bảng điện nổi V2 Điện Quang ĐQ FEP 32W 02S (màu trắng, 3 lỗ 2 chấu, 2 công tắc)",60000,81200,21200,26
TIKI,nha-cua-doi-song,191918103,"Dụng cụ rửa chai và ly LocknLock ETM143DGRY - Màu xám đen",41000,79000,38000,48
TIKI,nha-cua-doi-song,7221847,"Bộ Nồi Inox Sunhouse Mama cao cấp 5 đáy SH784 (16cm, 20cm, 24cm) - Dùng cho mọi loại bếp - Hàng chính hãng",858000,1340000,482000,36
TIKI,nha-cua-doi-song,165758264,"Bộ dao 2 chiếc Eco Family Sunhouse KS-KN2E1",102000,163000,61000,37
TIKI,nha-cua-doi-song,55630076,"Miếng lót ly bằng đất xốp Diatomite siêu hút nước, thông điệp ý nghĩa",55000,55000,0,0
TIKI,nha-cua-doi-song,12197016,"Bộ 280 Ống gen co nhiệt cách điện nhiều màu đủ size",28896,28896,0,0
TIKI,nha-cua-doi-song,44350764,"Combo 2 Thanh treo đồ dán tường,tủ quần áo, nhà bếp, có 6 móc chịu lực (giao màu ngẫu nhiên) GD263-MTSC-Thanh2",34899,34899,0,0
TIKI,nha-cua-doi-song,149387829,"Hộp Đựng Giấy Vệ Sinh Đa Năng 2 Tầng Treo Tường Cao Cấp - Có Ngăn Kéo Và Khe Cắm Điện Thoại, Ipad - Hàng Chính Hãng Nhập Khẩu",125000,159000,34000,21
TIKI,nha-cua-doi-song,139600248,"Miếng Tấm Pát Pad Thép Vuông Sửa Bản Lề Tủ Cửa Gỗ Lỗ Vít Door Hinge Repair Kit",10000,10000,0,0
TIKI,nha-cua-doi-song,106385679,"Túi Giữ Nhiệt Đựng Hộp Cơm Văn Phòng Siêu Dày – Chọn Size – Giữ Nhiệt – 3 Lớp - Chống Thấm Cao Cấp Chính Hãng miDoctor",67000,67000,0,0
TIKI,nha-cua-doi-song,59318679,"Bộ Ga Gối Cotton Tici Kẻ LIDACO Cao Cấp - Caro Nâu Nhạt",159000,229000,70000,31
TIKI,nha-cua-doi-song,113773790,"Bình Thủy Tinh 2 Lớp Pha Trà Doron MS79 - Cách Nhiệt Tốt - Có Lõi Lọc Inox 304 - Dung Tích 400ml - Hàng Loại 1",129000,129000,0,0
TIKI,nha-cua-doi-song,55481938,"Đồng hồ gỗ LED để bàn cao cấp - Gỗ đen led trắng - Hiển thị nhiệt độ",195000,195000,0,0
TIKI,nha-cua-doi-song,116571600,"Ga Chống Thấm Cotton LIDACO Cao Cấp - Hươu vàng - 1m4x2mxdưới12cm",149000,160000,11000,7
TIKI,nha-cua-doi-song,186440945,"Giá Sách Treo Tường Trang Trí FIVO Mã FB40 Không Cần Khoan Tặng Kèm Đinh 4 Chân Chịu Lực Lên Đến 10KG Với Móc Inox Dễ Dàng Gắn Lên Tường",42000,82000,40000,49
TIKI,nha-cua-doi-song,50339509,"Kệ sách gỗ để đồ đa năng 2 tầng kích thước 80*26*50 cm",159000,179000,20000,11
TIKI,nha-cua-doi-song,177744785,"Bộ lau nhà tách nước bẩn Kitimop K22 Plus có thùng lau nhà tự vắt 2 ngăn riêng biệt, chổi lau nhà xoay 360 độ lau sạch khô nhanh, 2 bông lau",459000,685000,226000,33
TIKI,nha-cua-doi-song,144582478," Dán Tường Để Đồ Đa Năng, Dán Tường Để Điện Thoại, Để Điều Khiển... - Giao màu ngẫu nhiên ",15000,15000,0,0
TIKI,nha-cua-doi-song,23476097,"Ô Dù Che mưa Che Nắng Chống Tia UV (màu ngẫu nhiên)",28000,150000,122000,81
TIKI,nha-cua-doi-song,161455657,"Bóng đèn led 30W TAT",19000,19000,0,0
TIKI,nha-cua-doi-song,26387653,"KỆ ĐỂ GIÀY DÉP 3 TẦNG 80 CM",209000,300000,91000,30
TIKI,nha-cua-doi-song,183254388,"Ô (Dù) Tự Động 2 Chiều Cao Cấp Teement, Che Mưa, Che Nắng, Chống UV - Hàng Chính Hãng",170000,170000,0,0
TIKI,nha-cua-doi-song,6643347,"Phích Cắm Chuyển Đổi 3 Chấu Sang 2 Chấu",12000,12000,0,0
TIKI,nha-cua-doi-song,172950048,"Kệ Nhà Bếp Đa Năng, Kệ Để Lò Vi Sóng Chính Hãng IGA - GM05",213000,232000,19000,8
TIKI,nha-cua-doi-song,193081467,"Ghế Xoay Văn Phòng Lưới Làm Việc Công Thái Học Deli - Tay Gập Thông Minh, Có Chỉnh Lưng, Lưới Thoáng Khí, Chân Xoay Tiện Ích, Đệm Ghế Êm Aí, Nhiều Màu - Phù Hợp Học Sinh, Văn Phòng, Game Thủ, Gaming - Hàng chính hãng",886000,1978200,1092200,55
TIKI,nha-cua-doi-song,67932480,"Topper Everon White",899000,899000,0,0
TIKI,nha-cua-doi-song,186693022,"Cây lau nhà tự vắt Kitimop-Red bàn lau lớn 38cm, con lăn trợ lực, thanh thép không gỉ, khớp xoay 360 độ, 2 bông lau",139000,225000,86000,38
TIKI,nha-cua-doi-song,73113608,"Bình PET Đựng Nước Tròn Có Vòi 10 Lít Duy Tân thân bình trong suốt giao quai màu ngẫu nhiên (Ø 20 x 40.2 cm) No.625 ",65000,65000,0,0
TIKI,nha-cua-doi-song,163580111,"Bọ xiphong ống thoát chậu rửa chén siêu to",450000,450000,0,0
TIKI,nha-cua-doi-song,74605907,"Khăn Tắm/Khăn Mặt Cotton Mềm Mại Thấm Hút Nước 34x75cm Nhanh Khô",33000,33000,0,0
TIKI,nha-cua-doi-song,144203367,"Bộ túi hộp cơm thủy tinh Lock&Lock 3EA LLG428S2IVY (LLG429Dx1, LLG428x1, HWB821GRYx1) - Màu",378000,726000,348000,48
TIKI,nha-cua-doi-song,121330266,"sét 10 bóng Đèn Led 3w Ánh Sáng Trắng",4000,4000,0,0
TIKI,nha-cua-doi-song,59401658,"Cuộn Đèn LED Trang Trí Quấn Cây RGB Chống Nước, Dài 5M Kèm Remote 44 Phím",115000,115000,0,0
TIKI,nha-cua-doi-song,76545899,"Bộ Máy Khoan Mài khuôn Khắc mini Đa Năng 100 chi tiết 6 tốc độ Kiotool",545000,545000,0,0
TIKI,nha-cua-doi-song,182148476,"Combo Móc Dán Tường In Hình Họa Tiết Dễ Thương Loại Lớn PaKaSa - Hàng Chính Hãng ( Giao họa tiết ngẫu nhiên )",39000,58000,19000,33
TIKI,nha-cua-doi-song,230013933,"Kệ Sách Để Bàn Phong Cách Nordic Thương Hiệu IGA - GP176",281000,305000,24000,8
TIKI,nha-cua-doi-song,270862442,"Ổ Cắm Điện Đa Năng Chống Giật Có 3 Cổng USB, Sạc Trực Tiếp, Tiết Kiệm Điện – Bộ Ổ Cắm Điện Xanh Lá Cao Cấp Chính Hãng - (Model ngẫu nhiên)",69000,100000,31000,31
TIKI,nha-cua-doi-song,112068381,"Kệ Đa Năng, Kệ Để Đồ Black Kodo Phong Cách Hiện Đại - GM06",202000,220000,18000,8
TIKI,nha-cua-doi-song,78010514,"Timer hẹn giờ bật tắt điện tự động KG316T-II/25A/220V",67500,67500,0,0
TIKI,nha-cua-doi-song,56247996,"Kệ sách mini bằng gỗ, để trên bàn làm việc hoặc bàn học. Hàng tự lắp ghép đa năng, thông minh. Gồm 3 màu đẹp hiện đại",50249,50249,0,0
TIKI,nha-cua-doi-song,160310283,"Găng Tay Tắm Funu Giúp Tẩy Tế Bào Chết, Làm Sạch Da - Giao Màu Ngẫu Nhiên",33000,33000,0,0
TIKI,nha-cua-doi-song,125084260,"Vỏ gối ôm cotton tici Lidaco kích thước 35x100cm",35000,39000,4000,10
TIKI,nha-cua-doi-song,980512,"Cân Nhơn Hòa NHS-5 (5kg) - Hàng Chính Hãng",320000,320000,0,0
TIKI,nha-cua-doi-song,208761326,"Chai xịt chuột thái land rat off",84000,84000,0,0
TIKI,nha-cua-doi-song,122311338,"Nhang Nụ Trầm Hương tự nhiên khói chảy ngược - Hộp 40 nụ - Mùi thơm dịu nhẹ, không cay mắt, không kích mũi - Thiên Mộc Hương",261000,350000,89000,25
TIKI,nha-cua-doi-song,77947848,"Kệ Chén Đĩa Thép Cao Cấp Sơn Đen Tĩnh Điện Kèm Khay Ráo Nước VANDO, Giá Kệ Úp Bát Đa Năng",429000,656000,227000,35
TIKI,nha-cua-doi-song,191057553,"Ổ Cắm Điện Thông Minh USB Cao Cấp Jodily StarHome",185000,185000,0,0
TIKI,nha-cua-doi-song,169208802,"Vỏ gối chất liệu Cotton 40x60, 50x70 mềm mại siêu rẻ cho khách sạn, phòng ngủ, phòng trọ",30000,30000,0,0
TIKI,nha-cua-doi-song,194125082,"Khăn mặt sợi tre MORI xuất Nhật cao cấp 30x50cm",20900,38000,17100,45
TIKI,nha-cua-doi-song,72652196,"Bộ túi hộp cơm thủy tinh Lock&Lock 3EA (LLG429Dx1,LLG428x1,BAG-HPL815SGRYx1) LLG428S2GRY - Màu",337000,649000,312000,48
TIKI,nha-cua-doi-song,95043563,"Khăn tắm sợi tre Bamboo Life hàng chính hãng Khăn lau người mềm mại kháng khuẩn siêu thấm hút an toàn cho da ngay cả với trẻ sơ sinh BL046",65000,65000,0,0
TIKI,nha-cua-doi-song,165705675,"Cọ vệ sinh Bình Giữ Nhiệt chuyên dụng, Cứng cáp, Đế gỗ",150000,150000,0,0
TIKI,nha-cua-doi-song,174128094,"SALE SỐC NỆM VĂN PHÒNG- ĐỆM NGỦ VĂN PHÒNG CHỐNG THẮM NƯỚC 75 X 180 X 3CM ( GIAO MÀU NGẪU NHIÊN )",259000,350000,91000,26
TIKI,nha-cua-doi-song,116191376,"Nhang trầm hương tự nhiên Thiên Mộc Hương 30cm, Ít Khói, Thơm Nhẹ, Dễ Chịu, Không kích mũi",89000,150000,61000,41
TIKI,nha-cua-doi-song,152521474,"Combo 200 Túi Lọc Rác Bồn Rửa Bát - Túi Lưới Lọc Rác Giúp Ngăn Chặn Tắc Đường Ống- Hàng Loại 1 - Chính Hãng MINIIN",56050,59000,2950,5
TIKI,nha-cua-doi-song,125555122,"Bàn Học, Bàn Làm Việc Gấp Gọn Hiện Đại Thương Hiệu IGA - GP154",155000,169000,14000,8
TIKI,nha-cua-doi-song,76658958,"Khăn Tắm Khách Sạn 5 sao – Cotton 100% - Sợi se đôi cao cấp – Thấm hút cực tốt - Kích thước lớn 70 x 140 cm có thể quấn quanh người",53888,53888,0,0
TIKI,nha-cua-doi-song,116681853,"Bình Giữ Nhiệt Lock&Lock Featherlight One-touch Tumbler 500ml LHC3257 - Hàng Chính Hãng - Tặng Kèm Ống Hút Inox",309000,537000,228000,42
TIKI,nha-cua-doi-song,108605078,"Pin kiềm Akaline AA Deli - Vỉ 2 viên/ 4 viên - 18500 / 18501",30600,30600,0,0
TIKI,nha-cua-doi-song,98804083,"Bóng Đèn Thông Minh TP-Link Tapo L530E Đa Sắc - Hàng Chính Hãng",199000,398000,199000,50
TIKI,nha-sach-tiki,184334565,"Bút vẽ kỹ thuật / Bút vẽ nét/ bút lông kim Fine Pen cơ bản – chuyên nghiệp mực đen",22000,30000,8000,27
TIKI,nha-sach-tiki,191926693,"Trái cây đại chiến Zombie - Thế giới khủng long: Tập 9 - Trên đảo khủng long",58000,89000,31000,35
TIKI,nha-sach-tiki,196394972,"Thương Tiến Tửu - Tập 2",134000,169000,35000,21
TIKI,nha-sach-tiki,160585832,"Veil – Sắc Trắng Yêu Kiều - Tập 3 (Tặng Kèm Postcard)",90000,109000,19000,17
TIKI,nha-sach-tiki,176909238,"Hà Nội Còn Một Chút Này",84000,109000,25000,23
TIKI,nha-sach-tiki,142833447,"Sanctify - Tập 3",89700,109000,19300,18
TIKI,nha-sach-tiki,187843292,"Hoa trên mộ Algernon",112000,150000,38000,25
TIKI,nha-sach-tiki,273401813,"Tết Ở Làng Địa Ngục",116000,169000,53000,31
TIKI,nha-sach-tiki,189326211,"Văn phòng thám tử quái vật - Tập 08",21100,30000,8900,30
TIKI,nha-sach-tiki,148008757,"Combo 2 Cuốn "Tim Marshall": "Những Tù Nhân Của Địa Lý" + "Chia Rẽ - Tại Sao Chúng Ta Đang Sống Trong Thời Đại Của Những Bức Tường"",281000,410000,129000,31
TIKI,nha-sach-tiki,173481387,"Eo Thon Nhỏ",163000,239000,76000,32
TIKI,nha-sach-tiki,76826978,"Sức Mạnh Chữa Lành Của Tinh Dầu",121000,169000,48000,28
TIKI,nha-sach-tiki,980770,"Chí Phèo",31700,48000,16300,34
TIKI,nha-sach-tiki,195827102,"(Bìa cứng in màu trên giấy cóuche - tặng kèm postcard) SƠN HẢI KINH – Lương Siêu biên soạn – Sam Trạch minh họa – An Lạc Group dịch – Wingbooks - NXB Kim Đồng",325000,325000,0,0
TIKI,nha-sach-tiki,71149569,"Cách kiếm lợi nhuận 18.000% từ thị trường chứng khoán - Trade Like An O'Neil Disciple",499000,499000,0,0
TIKI,nha-sach-tiki,196305158,"Vì Cuộc Đời Không Hẹn Lần Sau",106000,139000,33000,24
TIKI,nha-sach-tiki,76531748,"Sách DevUP",149000,149000,0,0
TIKI,nha-sach-tiki,69219919,"Muôn Kiếp Nhân Sinh (Khổ Nhỏ)",73500,98000,24500,25
TIKI,nha-sach-tiki,111537689,"Án Mạng Trên Sông Nile (Agatha Christie)(Tái Bản)",78700,135000,56300,42
TIKI,nha-sach-tiki,185408437,"Bút Bi Nước Mực Gel Bấm Ngòi 0.5mm Deli - Mực Đen Nhanh Khô, Viết Đều, Trơn Tru, Phù Hợp Văn Phòng Học Sinh - S08-B",6000,11700,5700,49
TIKI,nha-sach-tiki,53563837,"Combo Sách Nuôi Dạy Trẻ: Phương Pháp Giáo Dục Con Của Người Do Thái + Chờ Đến Mẫu Giáo Thì Đã Muộn +90% Trẻ Thông Minh Nhờ Cách Trò Chuyện Đúng Đắn Của Cha Mẹ + Cách Khen, Cách Mắng, Cách Phạt Con + Poster An Toàn(Tủ Sách Người Mẹ Tốt)",251350,251350,0,0
TIKI,nha-sach-tiki,106365090,"Kinh Dịch Đạo Của Người Quân Tử - Nguyễn Hiến Lê (Tái Bản)",173000,268000,95000,35
TIKI,nha-sach-tiki,146225297,"Flow - Dòng Chảy",175600,228000,52400,23
TIKI,nha-sach-tiki,170706996,"Điểm Bùng Phát ( Tái Bản)",115800,179000,63200,35
TIKI,nha-sach-tiki,193450565,"Nam Đình Cốc Vi– Tập 7 -  Tặng 1 Postcard Nam Đình Cốc Vi",99200,119000,19800,17
TIKI,nha-sach-tiki,94132196,"Bộ Luật Lao Động Hiện Hành (Mới Nhất) Thông Qua Tại Kỳ Họp Thứ 8 Quốc Hội Khóa XIV",51000,119000,68000,57
TIKI,nha-sach-tiki,188381614,"Thẻ học Thông minh (Size Lớn - 18 Chủ đề - 288 thẻ) - Song ngữ Anh - Việt - Thế giới Xung quanh",104000,200000,96000,48
TIKI,nha-sach-tiki,4077687,"Bài Tập Trắc Nghiệm Tiếng Anh 9 (Có Đáp Án)",37100,56000,18900,34
TIKI,nha-sach-tiki,112332742,"English Grammar In Use - 130 Bài Ngữ Pháp Tiếng Anh (Tái Bản)",115000,165000,50000,30
TIKI,nha-sach-tiki,147220978,"Sự Tiến Hóa Của Tiền Tệ",111000,139000,28000,20
TIKI,nha-sach-tiki,187827445,"Lược Sử Thời Gian",79000,115000,36000,31
TIKI,nha-sach-tiki,167940010,"Thao Túng Tâm Lý",118300,169000,50700,30
TIKI,nha-sach-tiki,185854305,"Full bộ 4 cuốn Truyện - Thơ - Đồng dao - Câu đố cho Trẻ mầm non (Giúp bé sáng dạ, thông minh, tập nói và đọc nhanh)",141999,278429,136430,49
TIKI,nha-sach-tiki,158235745,"Phương Pháp Kaizen
 (The Kaizen Way)(Tái Bản)",75500,95000,19500,21
TIKI,nha-sach-tiki,3152291,"Hướng Dẫn Giao Dịch Theo Sóng Elliott",369000,369000,0,0
TIKI,nha-sach-tiki,126742911,"Món Quà Của Linh Hồn - Sức Mạnh Chữa Lành Của Những Thữ Thách Trong Cuộc Sống",206000,289000,83000,29
TIKI,nha-sach-tiki,598974,"Dạy Con Làm Giàu 05 - Để Có Sức Mạnh Về Tài Chính",98200,160000,61800,39
TIKI,nha-sach-tiki,17719704,"Hạn Chót Lúc Bình Minh",80000,122000,42000,34
TIKI,nha-sach-tiki,161383826,"Đảo Mộng Mơ (Tái Bản)",55800,75000,19200,26
TIKI,nha-sach-tiki,446881,"Các Thế Giới Song Song (Tái Bản 2018)",95500,128000,32500,25
TIKI,dien-thoai-may-tinh-bang,270814388,"Điện thoại Tecno POVA 5 (8+8)/128GB - MediaTek Helio G99 - Sạc nhanh 45W - 6.8'' FHD+120HZ - Hàng Chính Hãng - BH 13 Tháng",3690000,4490000,800000,18
TIKI,dien-thoai-may-tinh-bang,217276360,"Điện thoại Mobell F209 4G ,Loa to, Phím lớn - Hàng chính hãng",567000,670000,103000,15
TIKI,dien-thoai-may-tinh-bang,272151221,"Điện thoại Xiaomi Redmi 10 2022 (4GB/128GB) - Hàng chính hãng",2690000,3990000,1300000,33
TIKI,dien-thoai-may-tinh-bang,248762051,"Điện Thoại Samsung A34 5G 8GB/128GB - Hàng Chính Hãng",5939000,8490000,2551000,30
TIKI,dien-thoai-may-tinh-bang,273951550,"Điện Thoại Samsung Galaxy A15 LTE (8GB/128GB)- Đã Kích Hoạt Bảo Hành Điện tử - Hàng Chính Hãng",4290000,4990000,700000,14
TIKI,dien-thoai-may-tinh-bang,273668660,"Điện Thoại Oppo A18 4GB/64GB - Hàng Chính Hãng",3329000,3690000,361000,10
TIKI,dien-thoai-may-tinh-bang,273367316,"Điện Thoại Xiaomi Redmi 13C 6GB/128GB - Hàng Chính Hãng",2979000,3490000,511000,15
TIKI,dien-thoai-may-tinh-bang,273683300,"Điện thoại Samsung Galaxy A15 LTE (8GB/128GB) - Hàng chính hãng",4990000,4990000,0,0
TIKI,dien-thoai-may-tinh-bang,274365104,"Điện thoại Xiaomi Redmi Note 13 Pro (8GB/128GB) - Hàng Chính Hãng",5990000,7290000,1300000,18
TIKI,dien-thoai-may-tinh-bang,274456447,"Điện thoại Samsung Galaxy A35 5G (8GB/128GB) - Hàng chính hãng",7949000,8290000,341000,4
TIKI,dien-thoai-may-tinh-bang,173789184,"Điện thoại bàn treo tường TC990",250000,250000,0,0
TIKI,dien-thoai-may-tinh-bang,273165324,"Điện thoại Xiaomi Redmi A2 (2GB/32GB) - Hàng chính hãng",2190000,2190000,0,0
TIKI,dien-thoai-may-tinh-bang,203853390,"Điện Thoại Oppo A17k (3GB/64GB)",2390000,3290000,900000,27
TIKI,dien-thoai-may-tinh-bang,203278278,"Điện Thoại Samsung A04 3GB/32GB - Hàng Chính Hãng",2159000,2990000,831000,28
TIKI,dien-thoai-may-tinh-bang,103168844,"Máy tính bảng Samsung Galaxy Tab A7 Lite LTE SM-T225) - ĐÃ KÍCH HOẠT ĐIỆN TỬ - Hàng Chính Hãng",3587000,3587000,0,0
TIKI,dien-thoai-may-tinh-bang,273348837,"Điện thoại Xiaomi Redmi 13C (6GB/128GB) - Hàng chính hãng",2890000,3290000,400000,12
TIKI,dien-thoai-may-tinh-bang,191636459,"Điện thoại Masstel IZI 11 4G - Hàng chính hãng",468000,468000,0,0
TIKI,dien-thoai-may-tinh-bang,271967379,"iPhone 15 Plus",22490000,25990000,3500000,13
TIKI,do-choi-me-be,273532024,"[Combo 3 lon còn 1tr440] Sữa Bột Nutifood GrowPLUS+ Suy Dinh Dưỡng 1.5kg - Tăng Cân, Tăng Chiều Cao (Lon 1.5kg)",568000,884000,316000,36
TIKI,dien-thoai-may-tinh-bang,273897681,"Điện thoại Tecno SPARK GO 2024 (4+4)GB/64GB - Unisoc T606 | 5000 mAh | 6,6" HD+ | Hàng Chính Hãng",2009000,2190000,181000,8
TIKI,do-choi-me-be,116407424,"Combo 2 túi nước giặt OMO Matic cho máy giặt cửa trên giúp quần áo sạch bẩn khử mùi toàn diện, túi 3.9kg",350000,454000,104000,23
TIKI,dien-thoai-may-tinh-bang,271799133,"Máy tính bảng chắc chắn oukitel RT5 (chống nước,chống va đập,pin 11.000mAh,Màn hình 10.1 inch FHD, Ram 14Gb,Rom 256Gb, CPU : Mediatek 8788,lõi 8, lên đến 2.0 GHz, Camera Trước,sau 16 MP, Android 13)- hàng chính hãng",7490000,7490000,0,0
TIKI,dien-thoai-may-tinh-bang,270544863,"Điện Thoại Samsung Galaxy A24 (8GB/128GB) - Hàng Chính Hãng",6084000,6084000,0,0
TIKI,do-choi-me-be,181426565,"Nước xả làm mềm vải Comfort chăm sóc chuyên sâu phơi trong nhà Hương nắng mới",215000,271000,56000,21
TIKI,do-choi-me-be,184101589,"Combo 2 TúI Nước Giặt Omo Matic Cho Quần Áo Bé Yêu Chiết Xuất Tràm Trà Và Nha Đam Dịu Nhẹ, Sạsh Khuẩn , túi 3.6Kg",350000,454000,104000,23
TIKI,do-choi-me-be,68612510,"Combo 2 Túi nước giặt xả Maxkleen Hương Huyền Diệu 3.8kg/túi ",369000,420000,51000,12
TIKI,do-choi-me-be,95269395,"Tã Quần Siêu Cao Cấp Huggies Platinum Nature Made L44 (44 Miếng)",329000,460000,131000,28
TIKI,do-choi-me-be,181452377,"Combo 2 túi Nước xả làm mềm vải Comfort chăm sóc chuyên sâu phơi trong nhà Hương nắng mới",422000,542000,120000,22
TIKI,do-choi-me-be,145976954,"[CỘNG 6 MIẾNG] Tã quần Moony cao cấp XL38+6 (Girl) - Nhập khẩu từ Nhật Bản",339000,475000,136000,29
TIKI,do-choi-me-be,124708784,"Nước Giặt Ariel Hương Downy Túi 3.2Kg",236500,236500,0,0
TIKI,dien-thoai-may-tinh-bang,272056889,"Điện Thoại Samsung A24 6GB/128GB - Hàng Chính Hãng",4789000,6490000,1701000,26
TIKI,do-choi-me-be,145976954,"[CỘNG 6 MIẾNG] Tã quần Moony cao cấp XL38+6 (Girl) - Nhập khẩu từ Nhật Bản",339000,475000,136000,29
TIKI,dien-thoai-may-tinh-bang,225936344,"Máy tính bảng Samsung Galaxy Tab A8 (4GB/64GB) - Hàng Chính Hãng",5856000,5856000,0,0
TIKI,do-choi-me-be,126022163,"Bột thông tắc cống, bồn cầu, bồn rửa bát, đường ống cực mạnh HGO Super 250g",49000,75000,26000,35
TIKI,do-choi-me-be,573673,"Thùng 48 Hộp Sữa Nước Abbott Grow Gold 180ml cho trẻ 1 tuổi trở lên",813000,904224,91224,10
TIKI,do-choi-me-be,199903945,"Combo 2 Tấm lót SunMate cải tiến mới (45 x 70cm)",99000,130680,31680,24
TIKI,do-choi-me-be,115483206," Sữa bột Enfagrow A+ NeuroPro 3 với 2’-FL HMO cho trẻ từ 1 – 3 Tuổi - Vị Nhạt Dễ Uống (2.2kg)",997000,997000,0,0
TIKI,do-choi-me-be,6840059,"Combo 2 Tã Dán Người Lớn SunMate G2 Size M10 (10 Miếng)",146000,182620,36620,20
TIKI,dien-thoai-may-tinh-bang,267178005,"Điện thoại Samsung Galaxy A24 - Hàng chính hãng",5808000,5808000,0,0
TIKI,do-choi-me-be,6840059,"Combo 2 Tã Dán Người Lớn SunMate G2 Size M10 (10 Miếng)",146000,182620,36620,20
TIKI,dien-thoai-may-tinh-bang,215746882,"Điện thoại OPPO Reno8T 4G - Hàng chính hãng",8136000,8136000,0,0
TIKI,do-choi-me-be,24026125,"Thùng 30 Chai Sữa Nước Abbott Glucerna Vani 220ml",1440000,1567500,127500,8
TIKI,dien-thoai-may-tinh-bang,196197701,"Điện thoại Samsung Galaxy Z Fold4 5G (12GB/256GB) - Hàng chính hãng",40990000,40990000,0,0
TIKI,dien-thoai-may-tinh-bang,219397711,"Điện thoại Samsung Galaxy A14 5G A146P (4+128G) Đen - Hàng Chính Hãng (chỉ giao HN và một số khu vực)",5080000,5080000,0,0
TIKI,dien-thoai-may-tinh-bang,273610105,"Điện Thoại Samsung Galaxy A05 - Hàng Chính Hãng",3025000,3025000,0,0
TIKI,do-choi-me-be,273662539,"Tã quần Người Lớn Confidence Slim & Fit size L16 (16 miếng)",169000,205000,36000,18
TIKI,do-choi-me-be,159387940,"Đai đi xe máy cho bé phản quang, thoáng khí sử dụng khóa 2 cấp bền chắc, chống bui bẩn",129000,179000,50000,28
TIKI,do-choi-me-be,10054452,"Thùng 48 Hộp Sữa Bột Pha Sẵn Friso Gold Rtd Vani (48 Hộp X 110ml)",438000,505000,67000,13
TIKI,do-choi-me-be,59143355,"Combo Tiết Kiệm: 6 Gói Khăn Ướt Bobby Care Bổ Sung 80 Miếng/Gói",159000,231000,72000,31
TIKI,dien-thoai-may-tinh-bang,272241346,"Điện thoại Samsung Galaxy A05s (4GB/128GB) - Hàng chính hãng",3990000,3990000,0,0
TIKI,do-choi-me-be,130997754,"Combo 2 túi nước giặt dưỡng vải Comfort 3.8kg",390000,390000,0,0
TIKI,do-choi-me-be,57044926,"Thùng 48 Hộp Sữa Nước Abbott Pediasure Vani 110ml cho trẻ từ 1 - 10 tuổi",1009000,1111824,102824,9
TIKI,dien-thoai-may-tinh-bang,217559440,"Điện thoại Samsung Galaxy A03s (3GB/32GB) - Hàng chính hãng",2990000,2990000,0,0
TIKI,do-choi-me-be,184101589,"Combo 2 TúI Nước Giặt Omo Matic Cho Quần Áo Bé Yêu Chiết Xuất Tràm Trà Và Nha Đam Dịu Nhẹ, Sạsh Khuẩn , túi 3.6Kg",350000,454000,104000,23
TIKI,dien-thoai-may-tinh-bang,251448280,"Samsung Galaxy A34 5G A346E (8+128G) Silver Bạc - Hàng Chính Hãng (chỉ giao HN và một số khu vực)",7164000,7164000,0,0
TIKI,dien-thoai-may-tinh-bang,253443788,"Điện Thoại Samsung Galaxy M14 5G (4GB/64GB) - Hàng Chính Hãng",6000000,6000000,0,0
TIKI,do-choi-me-be,72924801,"Combo 3 Hộp 4 Viên Nén Vệ Sinh Lồng Giặt OMO Matic 80gr",227000,276000,49000,18
TIKI,do-choi-me-be,23957447,"Combo 2 Tã Quần Người Lớn Sunmate Mềm Mại M9 (9 Miếng)",166000,203702,37702,19
TIKI,do-choi-me-be,25099352,"Combo 02 Hộp Bột Tẩy Vệ Sinh Lồng Máy Giặt Ag+ Mao Bao 306g - Tặng 01 hộp Bột Tẩy Quần Áo Thiên Nhiên 12g x 2 gói",84000,110000,26000,24
TIKI,do-choi-me-be,498670,"Combo 2 Tã Dán Người Lớn SunMate G2 Size XL10 (10 Miếng)",202000,261163,59163,23
TIKI,dien-thoai-may-tinh-bang,204802771,"Điện thoại Oppo A57 (4GB/128GB) - Hàng chính hãng",4632000,4632000,0,0
TIKI,do-choi-me-be,213586945,"Combo 4 Tấm lót SunMate cải tiến mới 14 miếng/gói size L (60 x 70cm)",292000,373092,81092,22
TIKI,dien-thoai-may-tinh-bang,273653444,"Máy tính bảng Kindle Fire Hd 10 2023 13th - Hàng nhập khẩu",3790000,3790000,0,0
TIKI,do-choi-me-be,181452377,"Combo 2 túi Nước xả làm mềm vải Comfort chăm sóc chuyên sâu phơi trong nhà Hương nắng mới",422000,542000,120000,22
TIKI,do-choi-me-be,118123582,"Giấy vệ sinh PREMIER VinaRoll không lõi - Combo 3 lốc",225000,225000,0,0
TIKI,do-choi-me-be,175953067,"Combo 4 Tã Quần Người Lớn SunMate Mềm Mại",293000,399997,106997,27
TIKI,do-choi-me-be,175953065,"Combo 4 Tã Dán Người Lớn SunMate G2 size M10, M/L10, XL10, M/L18",267000,365234,98234,27
TIKI,dien-thoai-may-tinh-bang,242712931,"Điện thoại Samsung Galaxy S23 Ultra 512GB - Hàng chính hãng",36990000,36990000,0,0
TIKI,do-choi-me-be,117836946,"[Mới] Hộp giấy 2 Kg Frisolac Gold 3",939000,939000,0,0
TIKI,do-choi-me-be,175953067,"Combo 4 Tã Quần Người Lớn SunMate Mềm Mại",293000,399997,106997,27
TIKI,do-choi-me-be,435762,"Sữa Bột Abbott Grow Gold 3+ cho trẻ từ 3 - 6 tuổi (1.7Kg)",674000,781380,107380,14
TIKI,do-choi-me-be,57044932,"Thùng 48 Hộp Sữa Nước Abbott Pediasure Vani 180ml cho trẻ từ 1 - 10 tuổi",1470000,1633728,163728,10
TIKI,dien-thoai-may-tinh-bang,263060294,"Điện thoại di động Samsung A24 (6G/128G) - Hàng chính hãng - Đã kích hoạt bảo hành điện tử",5808000,5808000,0,0
TIKI,do-choi-me-be,23957447,"Combo 2 Tã Quần Người Lớn Sunmate Mềm Mại M9 (9 Miếng)",166000,203702,37702,19
TIKI,dien-thoai-may-tinh-bang,248655651,"Điện Thoại Samsung Galaxy A14 5G (4GB/128GB) - Hàng chính hãng - ĐÃ KÍCH HOẠT BẢO HÀNH ĐIỆN TỬ",5000000,5000000,0,0
TIKI,do-choi-me-be,130461479,"Sữa Bột Similac Einstein 4 cho trẻ từ 2 - 6 tuổi",499000,547560,48560,9
TIKI,do-choi-me-be,24030105,"Sữa bột Abbott Pediasure 850g cho trẻ từ 1 - 10 tuổi",665000,755948,90948,12
TIKI,do-choi-me-be,88949152,"Sữa Bột Frisolac Gold 3 1400g (Dành Cho Trẻ Từ 1 - 2 Tuổi)",735000,735000,0,0
TIKI,do-choi-me-be,413088,"Miếng Lót Sơ Sinh Bobby Fresh Newborn 2 - 40 (40 Miếng)",79000,98000,19000,19
TIKI,do-choi-me-be,88924594,"Sữa Bột Frisolac Gold 1 850g Dành Cho Trẻ Từ 0 - 6 Tháng Tuổi",531000,531000,0,0
TIKI,dien-thoai-may-tinh-bang,213858174,"Máy tính bảng Samsung Galaxy Tab A7 Lite (3GB/32GB) - Hàng chính hãng - Màn hình 8.7inch TFT LCD, Camera sau 8MP - Bảo Hành 12 Tháng",3587000,3587000,0,0
TIKI,do-choi-me-be,84304880,"Tẩy cặn canxi vách kính, vòi sen inox, bồn sứ, gạch men HGO Plus 500ml",95000,95000,0,0
TIKI,do-choi-me-be,32030382,"Combo 12 Gói Khăn Ướt Huggies Cacao và Bơ Hạt Mỡ (72 Miếng/ Gói)",369000,408000,39000,10
TIKI,do-choi-me-be,116407424,"Combo 2 túi nước giặt OMO Matic cho máy giặt cửa trên giúp quần áo sạch bẩn khử mùi toàn diện, túi 3.9kg",350000,454000,104000,23
TIKI,do-choi-me-be,25026925,"Combo 2 Gói Tã Quần Người Lớn Sunmate Khô Thoáng M8 (8 Miếng/ Gói)",161000,199999,38999,19
TIKI,dien-thoai-may-tinh-bang,273029857,"Điện Thoại Samsung Galaxy A05s (4GB/128GB) - Hàng Chính Hãng",3980000,3980000,0,0
TIKI,do-choi-me-be,35043572,"Thùng 48 Hộp Sữa Nước Abbott Similac 110ml cho trẻ từ 1 tuổi",605000,699600,94600,14
TIKI,do-choi-me-be,181426565,"Nước xả làm mềm vải Comfort chăm sóc chuyên sâu phơi trong nhà Hương nắng mới",215000,271000,56000,21
TIKI,dien-thoai-may-tinh-bang,219392186,"Điện thoại OPPO CPH2471 - A17k Vàng - Hàng Chính Hãng (chỉ giao HN và một số khu vực)",3276000,3276000,0,0
TIKI,do-choi-me-be,7178671,"Bột Tẩy Quần Áo Thiên Nhiên Baking Soda Mao Bao (12 g x 5 gói)",43000,55000,12000,22
TIKI,do-choi-me-be,160299782,"Nước Lau Sàn Sunlight Tinh Dầu Thảo Mộc Hương Hoa Hạ & Bạc Hà 3,6 Kg - Sạch Thơm Thư Thái - Nhà Thêm Trong Lành",92900,93000,100,0
TIKI,do-choi-me-be,145974290,"[CỘNG 4 MIẾNG] Tã dán Moony cao cấp L54+4 - Nhập khẩu từ Nhật Bản",339000,475000,136000,29
TIKI,do-choi-me-be,498670,"Combo 2 Tã Dán Người Lớn SunMate G2 Size XL10 (10 Miếng)",202000,261163,59163,23
TIKI,do-choi-me-be,24028484,"Sữa bột Abbott Pediasure cho trẻ từ 1 - 10 tuổi (400g)",321000,346500,25500,7
TIKI,do-choi-me-be,98276143,"Thùng 3 Gói Tã/ Bỉm Quần PAMPERS Nhật Thượng Hạng, Size M (144 miếng, 6-12kg), Siêu Mềm Mịn & Thoáng Khí",964000,1410000,446000,32
TIKI,dien-thoai-may-tinh-bang,249153684,"Điện thoại Realme C55 6GB/128GB Đen trời đêm - Hàng chính hãng",4680000,4990000,310000,6
TIKI,dien-thoai-may-tinh-bang,191764688,"Điện thoại Xiaomi Redmi 10A (2GB/32GB) - Hàng chính hãng",2556000,2556000,0,0
TIKI,dien-thoai-may-tinh-bang,273359931,"Điện Thoại Thông Minh siêu bền Oukitel WP27 (Ram 12GB,Rom 256GB,Màn hình 6.78 “FHD + ,pin 8300MAH,NFC, Android 13 ,CPU MTK G99,chống nước,chống sốc) –hàng chính hãng",6990000,6990000,0,0
TIKI,dien-thoai-may-tinh-bang,273958619,"Điện Thoại Xiaomi Redmi Note 13 6GB-128GB - Hàng chính hãng",4145000,4890000,745000,15
TIKI,dien-thoai-may-tinh-bang,249730338,"Điện Thoại 4G Masstel Lux 20 - 2 Sim 2 Sóng - Sóng 4G Hd Call - Loa To Rõ - Hàng Chính Hãng - Bảo Hành 12 Tháng",790000,790000,0,0
TIKI,dien-thoai-may-tinh-bang,205750556,"Điện Thoại Oppo A57 4GB/128GB - Hàng Chính Hãng",4632000,4632000,0,0
TIKI,dien-thoai-may-tinh-bang,197045354,"ĐIỆN THOẠI MASSTEL LUX 20-4G  HÀNG CHÍNH HÃNG",750000,750000,0,0
TIKI,dien-thoai-may-tinh-bang,263675862,"Điện thoại OPPO A77 4GB+4GB/128GB - Sạc siêu nhanh 33W - Hàng nhập khẩu nhật - Bản quốc tế",3369000,4990000,1621000,32
TIKI,dien-thoai-may-tinh-bang,274380639,"Điện thoại Oppo Reno11 F 5G (8GB/256GB) - Hàng Chính Hãng",7990000,8990000,1000000,11
TIKI,dien-thoai-may-tinh-bang,105830021,"Máy Tính Bảng Samsung Galaxy Tab A7 Lite LTE T225 (3GB/32GB) ĐÃ KÍCH HOẠT BẢO HÀNH ĐIỆN TỬ - Hàng Chính Hãng",3587000,3587000,0,0
TIKI,dien-thoai-may-tinh-bang,160051494,"Điện thoại Masstel FAMI 60 4G - Hàng chính hãng, Nguyên Seal",689000,689000,0,0
TIKI,dien-thoai-may-tinh-bang,167465856,"Điện thoại Masstel IZI 50 4G , Pin 1700 mah - Hàng chính hãng",419000,549000,130000,24
TIKI,dien-thoai-may-tinh-bang,271530789,"Combo Máy đọc sách All New Kindle Paperwhite 5 (11th) KIDS EDITTION (KHÔNG QUẢNG CÁO) và Bao da - Hàng chính hãng",4064300,4190000,125700,3
TIKI,dien-thoai-may-tinh-bang,271972435,"iPhone 15 Pro 128GB Titan Đen",25490000,27990000,2500000,9
TIKI,dien-thoai-may-tinh-bang,263438008,"Điện thoại Masstel Hapi 30 4G Hàng Chính Hãng",2290000,2290000,0,0
TIKI,dien-thoai-may-tinh-bang,16518729,"Điện thoại để bàn Panasonic KX-TS580 hàng chính hãng",850000,850000,0,0
TIKI,dien-thoai-may-tinh-bang,274516245,"Điện thoại Masstel Fami 60S 4G(LTE) ,Bàn phím lớn, Khung viền kim loại - Hàng chính hãng",656000,750000,94000,13
TIKI,dien-thoai-may-tinh-bang,201003623,"Điện thoại Masstel Fami 12 4G Dành cho người già - Hàng chính hãng",630000,630000,0,0
TIKI,dien-thoai-may-tinh-bang,160556149,"Máy tính bảng Samsung Galaxy Tab A8 - Hàng chính hãng",5856000,5856000,0,0
TIKI,dien-thoai-may-tinh-bang,263041214,"Điện thoại Gaming Tecno POVA 4 8GB/128GB - Hàng Chính Hãng - MediaTek G99 | 6000mAh - 6.82 inch - Bảo hành 13 Tháng",3649000,4690000,1041000,22
TIKI,dien-thoai-may-tinh-bang,273684137,"Máy tính bảng quản lý thời gian sử dụng dành cho trẻ em Masstel Kidzone-1 đổi 1 trong vòng 100 ngày",1990000,1990000,0,0
TIKI,dien-thoai-may-tinh-bang,272392928,"Điện thoại Samsung Galaxy A05 (4GB/128GB) - Hàng chính hãng - ĐÃ KÍCH HOẠT BẢO HÀNH ĐIỆN TỬ",3090000,3090000,0,0
TIKI,dien-thoai-may-tinh-bang,252427658,"Điện thoại Tecno SPARK 10 Pro 8GB/128GB - Helio G88 | 5000 mAh | Sạc nhanh 18W | Cảm ứng vân tay - Hàng chính hãng",3679000,3990000,311000,8
TIKI,dien-thoai-may-tinh-bang,273498357,"Điện Thoại Itel S23 16GB(8GB+8GB)/256GB | Pin 5000mAh | 6.6 Inch | Camera 50MP | HÀNG CHÍNH HÃNG",2490000,3490000,1000000,29
TIKI,dien-thoai-may-tinh-bang,249730336,"Điện Thoại Masstel Fami 60 4G LTE - Pin 2000 mAh - Chức Năng SOS - Hàng Chính Hãng - Bảo Hành 12 tháng",730000,730000,0,0
TIKI,dien-thoai-may-tinh-bang,197670818,"Điện thoại Samsung Galaxy A04s (4GB/64GB) - Hàng chính hãng",2590000,3990000,1400000,35
TIKI,dien-thoai-may-tinh-bang,250111470,"Điện thoại Xiaomi Redmi Note 12 (8GB/128GB) - Hàng chính hãng",4190000,5790000,1600000,28
TIKI,dien-thoai-may-tinh-bang,273411607,"Điện thoại Samsung Galaxy M14 5G (4GB/64GB) - Hàng chính hãng",2750000,3690000,940000,25
TIKI,dien-thoai-may-tinh-bang,270471101,"Điện Thoại Nokia 110 4G Pro TA-1559 - Hàng Chính Hãng",650000,710000,60000,8
TIKI,dien-thoai-may-tinh-bang,273411606,"Điện thoại Samsung Galaxy M14 5G (4GB/128GB) - Hàng chính hãng",3590000,3990000,400000,10
TIKI,dien-thoai-may-tinh-bang,274524742,"Điện thoại Fonrox F2163 4G , Gọi HD Call , Lướt WEB , 2 sim 2 sóng - Hàng chính hãng",339000,399000,60000,15
TIKI,dien-thoai-may-tinh-bang,274186881,"Máy tính bảng Samsung Galaxy Tab A9+ Wifi (4GB/64GB) - Hàng chính hãng",5990000,5990000,0,0
TIKI,dien-thoai-may-tinh-bang,158742790,"Máy tính bảng Samsung Galaxy Tab A8 (4GB/64GB) - Hàng Chính Hãng",5856000,5856000,0,0
TIKI,dien-thoai-may-tinh-bang,270814412,"Điện thoại Tecno CAMON 20 Premier 5G - 8GB/512GB | Dimensity 8050| Cụm Camera 108+50+ 2MP | AMOLED - Tần số quét 120Hz - Hàng chính hãng",11990000,11990000,0,0
TIKI,dien-thoai-may-tinh-bang,274405521,"Điện Thoại Samsung A05 4GB/64GB - Hàng Chính Hãng",2409000,2990000,581000,19
TIKI,dien-thoai-may-tinh-bang,274101255,"Máy Tính Bảng Samsung Galaxy Tab A9 Wifi 4GB/64GB - Hàng Chính Hãng",2650000,3990000,1340000,34
TIKI,dien-thoai-may-tinh-bang,273872197,"Máy Tính Bảng Samsung Galaxy Tab A9 Wifi 4GB/64GB - Hàng Chính Hãng",2739000,3990000,1251000,31
TIKI,dien-thoai-may-tinh-bang,272328188,"Điện Thoại Samsung A05 4GB/128GB - Hàng Chính Hãng",2649000,3090000,441000,14
TIKI,dien-thoai-may-tinh-bang,274542983,"Điện Thoại Samsung A05 6GB/128GB - Hàng Chính Hãng",3049000,3490000,441000,13
TIKI,dien-thoai-may-tinh-bang,272056193,"Điện Thoại Xiaomi Redmi Note 12 8GB/128GB - Hàng Chính Hãng",4029000,5790000,1761000,30
TIKI,nha-cua-doi-song,194005519,"Ghế Kê Chân Văn Phòng, Chịu lực 200 kg Plyconcept Seiza Chair - Gỗ Uốn Cong",160000,280000,120000,43
TIKI,nha-cua-doi-song,1611899,"Vợt Muỗi Điện Quang ĐQ EMR02 WR - Trắng Phối Đỏ",115855,136300,20445,15
TIKI,nha-cua-doi-song,108936951,"Bảng Gỗ Quy Tắc Gia Đình, Tranh Treo Tường Gia đình, Những Quy Tắc Để Con Có Cuộc Sống Hạnh Phúc",160000,160000,0,0
TIKI,nha-cua-doi-song,161030427,"Cây lau trần nhà, chổi quét trần nhà đa năng hình tam giác - Kitimop A3",149000,199000,50000,25
TIKI,nha-cua-doi-song,48522643,"Nhiệt ẩm kế cao cấp TT-513 Nhật Bản, đo nhiệt độ phòng, độ ẩm không khí- sản phẩm cần thiết trong mỗi gia đình",197000,296000,99000,33
TIKI,nha-cua-doi-song,57712474,"Keo dán đa năng trên mọi bề mặt 50ml+ Tặng kèm miếng dán nam châm",41000,41000,0,0
TIKI,nha-cua-doi-song,117059826,"Giấy lọc cà phê Hario 100 cái (V60-VCF-02-100W)",99000,99000,0,0
TIKI,nha-cua-doi-song,79691104,"Bộ Hộp Cơm Giữ Nhiệt Văn Phòng Cao Cấp Cắm Điện inox 3 tầng - Chính Hãng",209000,300000,91000,30
TIKI,nha-cua-doi-song,183029245,"Mền lông cừu Caro cao cấp A kích thước 1m8 x 2m",195000,195000,0,0
TIKI,nha-cua-doi-song,141143706,"Ly Giữ Nhiệt Cà Phê Nắp Trượt Chống Tràn Rinfere (295ml)",249000,349000,100000,29
TIKI,nha-cua-doi-song,178936441," Đũa Gỗ Mộc Hương Cao Cấp - Gỗ Tự Nhiên - Đánh Bóng Thủ Công - Không Ẩm Mốc - Vỉ 10 đôi ",135000,135000,0,0
TIKI,nha-cua-doi-song,73467694,"Kệ để lò vi sóng đa năng Inox 304 cao cấp Vando chính hãng kệ để đồ lò nướng chắc chắn, sơn tĩnh điện chống bong tróc, kệ nhà bếp siêu chịu lực 300kg",1099000,1099000,0,0
TIKI,nha-cua-doi-song,198193045,"Khăn lau kính lau xe ma thuật không để lại vết mờ - Hàng cao cấp - Hàng hót 2022",16900,16900,0,0
TIKI,nha-cua-doi-song,162577287,"Cuộn Dây 5m/10m Đèn LED Trang Trí RGB 5050 Strip Light miDoctor, Quấn Cây Chống Nước, Trang Trí Phòng, Dán Tường, Bàn Máy Tính, Tạo Không Gian Quay Video Tiktok, Chụp Ảnh, Kèm Remote 44 Phím",115000,115000,0,0
TIKI,nha-cua-doi-song,25055074,"Tủ vải quần áo 3 buồng 8 ngăn, khách được chọn màu,  khung sắt sơn tĩnh điện, vải không dệt",210000,210000,0,0
TIKI,nha-cua-doi-song,143861521,"Dây Led Neon Flex 12V Kèm Nguồn Dài 1M/2M/3M/5M Trang Trí Cổ Điển",100000,100000,0,0
TIKI,nha-cua-doi-song,127152344,"Chổi Cọ Nhà Vệ Sinh Bồn Cầu Toilet Không Dây Đa Năng SENNAI Pin 4000mAh - Hàng Chính Hãng",129000,195000,66000,34
TIKI,nha-cua-doi-song,111472777,"Miếng Dán Tường Đa Năng SenNai - Móc Dán Cây Lau Nhà Loại Tốt - Chịu Tải Lên Đến 5kg",17820,18000,180,1
TIKI,nha-cua-doi-song,104027916,"Bộ gối tựa lưng và đệm lót ghế chống đau xương cụt Ema loại có gel cao cấp cho dân văn phòng, lái xe, sinh viên",330000,660000,330000,50
TIKI,nha-cua-doi-song,83927711,"Bịt Mắt Ngủ Che Mắt Ngủ Có Túi Gel Massage - Giảm Thâm Quầng Mắt - Mẫu Hoạt Hình Mới - Xanh Nhạt",35000,35000,0,0
TIKI,nha-cua-doi-song,186348775,"Đệm ngồi ghế văn phòng chống đau xương cụt, ê mông, thâm mông, xệ mông cho dân văn phòng, lái xe, học sinh - Thương hiệu EMA - Loại cao cấp có gel tản nhiệt",285000,570000,285000,50
TIKI,nha-cua-doi-song,48488492,"Đèn Ngủ Hình Mèo Con Siêu Dễ Thương - Chất liệu Silicon Dẻo Cao Cấp An Toàn ",90000,157725,67725,43
TIKI,nha-cua-doi-song,108918404,"GA GIƯỜNG THUN LẠNH MÀU TRƠN - Xám chì - Ga lẻ 1x2m nệm 5->15cm",100000,100000,0,0
TIKI,nha-cua-doi-song,147694768,"găng tay làm bếp nấu ăn siêu dai Victoria Bay chất liệu TPE không mùi chống nhăn hộp 100 cái size M",11000,16998,5998,35
TIKI,nha-cua-doi-song,193541405,"Áo Mưa Bít Trẻ Em Cho Bé Cute Dễ Thương Siêu Dày Chống Thấm Nước Có Phản Quang Phơi Mau Khô Ráo Che Kín Người Kèm Túi Đựng Deli - Chất Liệu An Toàn Có Lựa Chọn Nhiều Size Màu Sắc",196000,340200,144200,42
TIKI,nha-cua-doi-song,121268576,"Ổ cắm điện 5 lỗ 2m Điện Quang SM750SL - Hàng Chính Hãng",166000,166000,0,0
TIKI,nha-cua-doi-song,94891198,"Hộp Cơm Giữ Nhiệt INOX304 Hiện Đại Kèm Hộp Đựng Canh Soup và Bộ Đũa Thìa INOX – Chất Liệu Cao Cấp An Toàn Cho Sức Khỏe – Hàng Chính Hãng Vinbuy",281000,500000,219000,44
TIKI,nha-cua-doi-song,53098903,"Giá treo khăn - Vắt Khăn tắm, Giá treo khăn tắm inox 304 Đa năng 2 tầng, có móc treo quần áo Cao Cấp",380000,510000,130000,25
TIKI,nha-cua-doi-song,76451291,"Đèn Led Đom Đóm Dây Kẽm Dễ Uốn Kèm Pin CR2032",9999,9999,0,0
TIKI,nha-cua-doi-song,59500188,"Gối cổ chữ U cao su non Nice Food",115000,115000,0,0
TIKI,nha-cua-doi-song,134360863,"Vỉ 6 Viên Pin AA , Pin AAA Energizer Max 1,5V Alkaline - Hàng chính hãng",79000,90000,11000,12
TIKI,nha-cua-doi-song,56228508,"Phân bón hữu cơ dịch chuối DOCNEEM, phân bón cho phong lan, hoa hồng, cây cảnh kích rễ, kích kei, chồi, mầm, chai 1 lít",119000,119000,0,0
TIKI,nha-cua-doi-song,69843631,"CÂY TREO QUẦN ÁO HÀN QUỐC GỖ LẮP RÁP- STANDING HANGER- BLUE HOME- MÀU GỖ TỰ NHIÊN",259000,279000,20000,7
TIKI,nha-cua-doi-song,130769103,"Bộ 12 Hũ Thủy Tinh Sọc Làm Sữa Chua 100ml, Hũ Lọ Yaourt, Lọ Pudding, Hủ Làm Sữa Chua, Caramen- Có Nắp Đậy- Hàng Chính Hãng MINIIN",56000,65000,9000,14
TIKI,nha-cua-doi-song,191918105,"Bộ Bàn Chải Vệ Sinh Các Khe LocknLock ETM415 - 2 cái/bộ",20000,39000,19000,49
TIKI,nha-cua-doi-song,184282768,"Combo 6 túi giặt 3 lớp bảo vệ quần áo, đồ lót dùng cho máy giặt chính hãng Dododios",149000,149000,0,0
TIKI,nha-cua-doi-song,192635575,"Combo Chén/ Bát gáo dừa + Muỗng gỗ dừa DK Harvest - Loại size lớn 12 - 14cm (Loại Xuất khẩu)",38000,38000,0,0
TIKI,nha-cua-doi-song,143363686,"Băng keo chống thấm x2000 Nhật Bản chống thấm dột, dán tường, dán mái tôn, dán ống nước",24000,40000,16000,40
TIKI,nha-cua-doi-song,135156091,"Tua vít bake thép 3*100mm",10000,10000,0,0
TIKI,nha-cua-doi-song,200762341,"Cốc Giữ Nhiệt Ly Giữ Nhiệt Inox 304 Có Ống Hút Ly Uống Coffee 600ml",88312,88312,0,0
TIKI,nha-cua-doi-song,116571619,"Ga Chống Thấm Cotton LIDACO Cao Cấp - Kẻ sao - 1m2x2mxdưới12cm",149000,200000,51000,26
TIKI,nha-cua-doi-song,116571657,"Ga Chống Thấm Cotton LIDACO Cao Cấp - Kitty hồng - 2m2x2mxdưới12cm",199000,217000,18000,8
TIKI,nha-cua-doi-song,116571660,"Ga Chống Thấm Cotton LIDACO Cao Cấp - Kẻ sao - 1m6x2mxdưới12cm",149000,179000,30000,17
TIKI,nha-cua-doi-song,116571729,"Ga Chống Thấm Cotton LIDACO Cao Cấp - Cá đĩa - 1m8x2mxdưới12cm",155000,300000,145000,48
TIKI,nha-cua-doi-song,116571707,"Ga Chống Thấm Cotton LIDACO Cao Cấp - Baby shark - 2m2x2mxdưới12cm",199000,213000,14000,7
TIKI,nha-cua-doi-song,116571625,"Ga Chống Thấm Cotton LIDACO Cao Cấp - Dâu nhật - 1m4x2mxdưới12cm",149000,154000,5000,3
TIKI,nha-cua-doi-song,116571731,"Ga Chống Thấm Cotton LIDACO Cao Cấp - Thỏ bé - 1m4x2mxdưới12cm",149000,160000,11000,7
TIKI,nha-cua-doi-song,116571685,"Ga Chống Thấm Cotton LIDACO Cao Cấp - Cá đĩa - 1m2x2mxdưới12cm",149000,189000,40000,21
TIKI,nha-cua-doi-song,116571649,"Ga Chống Thấm Cotton LIDACO Cao Cấp - Kitty hồng - 1m2x2mxdưới12cm",149000,217000,68000,31
TIKI,nha-cua-doi-song,116571716,"Ga Chống Thấm Cotton LIDACO Cao Cấp - Thỏ bé - 1m8x2mxdưới12cm",155000,242000,87000,36
TIKI,nha-cua-doi-song,116571742,"Ga Chống Thấm Cotton LIDACO Cao Cấp - Cá đĩa - 2m2x2mxdưới12cm",199000,226000,27000,12
TIKI,nha-cua-doi-song,116571671,"Ga Chống Thấm Cotton LIDACO Cao Cấp - Kẻ sao - 2m2x2mxdưới12cm",199000,226000,27000,12
TIKI,nha-cua-doi-song,116571603,"Ga Chống Thấm Cotton LIDACO Cao Cấp - Dâu nhật - 1m8x2mxdưới12cm",155000,291000,136000,47
TIKI,nha-cua-doi-song,116571710,"Ga Chống Thấm Cotton LIDACO Cao Cấp - Baby shark - 1m6x2mxdưới12cm",149000,159000,10000,6
TIKI,nha-cua-doi-song,116571597,"Ga Chống Thấm Cotton LIDACO Cao Cấp - Hươu vàng - 1m2x2mxdưới12cm",149000,160000,11000,7
TIKI,nha-cua-doi-song,116571663,"Ga Chống Thấm Cotton LIDACO Cao Cấp - Kẻ sao - 1m8x2mxdưới12cm",155000,200000,45000,23
TIKI,nha-cua-doi-song,129144356,"Ga Chống Thấm Cotton LIDACO Cao Cấp - Lông vũ - 1m2x2mxdưới12cm",149000,189000,40000,21
TIKI,nha-cua-doi-song,116571655,"Ga Chống Thấm Cotton LIDACO Cao Cấp - Kẻ sao - 1m4x2mxdưới12cm",149000,189000,40000,21
TIKI,nha-cua-doi-song,69741184,"Thanh treo inox cao cấp không cần khoan tường, siêu chắc chắn, khả năng chịu tải cao HT07",150000,150000,0,0
TIKI,nha-cua-doi-song,116571693,"Ga Chống Thấm Cotton LIDACO Cao Cấp - Baby shark - 1m4x2mxdưới12cm",149000,184000,35000,19
TIKI,nha-cua-doi-song,116571607,"Ga Chống Thấm Cotton LIDACO Cao Cấp - Phong lan - 1m4x2mxdưới12cm",149000,189000,40000,21
TIKI,nha-cua-doi-song,116571687,"Ga Chống Thấm Cotton LIDACO Cao Cấp - Thỏ bé - 2m2x2mxdưới12cm",199000,250000,51000,20
TIKI,nha-cua-doi-song,116571627,"Ga Chống Thấm Cotton LIDACO Cao Cấp - Dâu nhật - 1m6x2mxdưới12cm",149000,179000,30000,17
TIKI,nha-cua-doi-song,116571623,"Ga Chống Thấm Cotton LIDACO Cao Cấp - Kitty hồng - 1m4x2mxdưới12cm",149000,189000,40000,21
TIKI,nha-cua-doi-song,116571735,"Ga Chống Thấm Cotton LIDACO Cao Cấp - Thỏ bé - 1m6x2mxdưới12cm",149000,179000,30000,17
TIKI,nha-cua-doi-song,116571602,"Ga Chống Thấm Cotton LIDACO Cao Cấp - Hươu vàng - 1m6x2mxdưới12cm",149000,169000,20000,12
TIKI,nha-cua-doi-song,116571667,"Ga Chống Thấm Cotton LIDACO Cao Cấp - Baby shark - 1m2x2mxdưới12cm",149000,154000,5000,3
TIKI,nha-cua-doi-song,116571721,"Ga Chống Thấm Cotton LIDACO Cao Cấp - Cá đĩa - 1m4x2mxdưới12cm",149000,189000,40000,21
TIKI,nha-cua-doi-song,101841654,"Đàn Kalimba Cega 17 phím gỗ nguyên tấm Mahogany",290000,290000,0,0
TIKI,nha-cua-doi-song,116571727,"Ga Chống Thấm Cotton LIDACO Cao Cấp - Cá đĩa - 1m6x2mxdưới12cm",149000,179000,30000,17
TIKI,nha-cua-doi-song,189492088,"Nhang Sen Thuần Khiết Liên Tâm 29cm 200 cây - Ít khói, dịu nhẹ, 100% Đài sen thiên nhiên",99750,99750,0,0
TIKI,nha-cua-doi-song,116571699,"Ga Chống Thấm Cotton LIDACO Cao Cấp - Baby shark - 1m8x2mxdưới12cm",155000,200000,45000,23
TIKI,nha-cua-doi-song,116571741,"Ga Chống Thấm Cotton LIDACO Cao Cấp - Thỏ bé - 1m2x2mxdưới12cm",149000,250000,101000,40
TIKI,nha-cua-doi-song,19423384,"Bộ võng xếp BAN MAI: sơn tĩnh điện và lưới thép số 9 (Giao màu ngẫu nhiên)",619000,920000,301000,33
TIKI,nha-cua-doi-song,186645870,"Máy Bắn Keo Nến Deli - Phù hợp DIY Làm Đồ Handmade Thủ Công - An Toàn, Nhỏ Gọn, Dễ Sử Dụng - DL390120",79000,171000,92000,54
TIKI,nha-cua-doi-song,36300228,"Bộ Móc treo chữ S, có 3 size chọn lựa",21400,21400,0,0
TIKI,nha-cua-doi-song,118680989,"Set nến thơm hộp quà thắt nơ – xinh xắn phù hợp làm quà tặng bạn gái",100000,100000,0,0
TIKI,nha-cua-doi-song,164158123,"Vỉ 2 Viên Pin Duracell CR2032 / CR2025 / CR2016 Lithium 3V - Hàng chính hãng",60000,60000,0,0
TIKI,nha-cua-doi-song,217736127,"Ga Chống Thấm Cotton LIDACO Cao Cấp - San hô",149000,250000,101000,40
TIKI,nha-cua-doi-song,96209890,"Dụng cụ thông ống thoát nước chuyên nghiệp có tay cầm - Độ dài dây lò xo: 5m",153400,153400,0,0
TIKI,nha-sach-tiki,49204092,"Tái Tạo Tổ Chức: Phá Vỡ Rào Cản, Thổi Bùng Sinh Khí (Tái Bản)",123000,190000,67000,35
TIKI,nha-sach-tiki,186578993,"Đu Đưa Trên Ngọn Cây Bàng",91500,118000,26500,22
TIKI,nha-sach-tiki,59618902,"Ehon - Hướng Dẫn Sử Dụng Mẹ (Tái Bản 2020)",40800,59000,18200,31
TIKI,nha-sach-tiki,195662905,"Circe",137000,200000,63000,32
TIKI,nha-sach-tiki,130863107,"Sách Người Tìm Xác tập 1+2 - Truyện trinh thám, linh dị",298000,378000,80000,21
TIKI,nha-sach-tiki,175724125,"Chú Thuật Hồi Chiến Tập 2: Chú Thai Đới Thiên [Tặng Kèm Obi Và Thẻ Bo Góc Nhựa]",29000,30000,1000,3
TIKI,nha-sach-tiki,176906739,"UX Writing - Quyền Năng Tối Thượng Của Nội Dung Tương Tác",61000,99000,38000,38
TIKI,nha-sach-tiki,66398387,"Trời Sinh Vụng Về, Hãy Bù Đắp Bằng Sự Kiên Trì",92400,129000,36600,28
TIKI,nha-sach-tiki,32490132,"Một Đời Như Kẻ Tìm Đường",113000,175000,62000,35
TIKI,nha-sach-tiki,77539095,"Nghệ Thuật Dạy Con Từ Kinh Talmud (20 Câu Chuyện Sâu Sắc Từ Bộ Kinh Cổ Của Người Do Thái)",104000,135000,31000,23
TIKI,nha-sach-tiki,129766803,"Sách Khác Biệt Hay Là Chết (Tái Bản)",89100,128000,38900,30
TIKI,nha-sach-tiki,147988202,"Combo 2 Cuốn Tớ Học Lập Trình: Tớ Học Lập Trình - Làm Quen Với Python + Tớ Học Lập Trình - Làm Quen Với Lập Trình Scratch",167000,210000,43000,20
TIKI,nha-sach-tiki,74277389,"Combo 4 Cuốn: Bộ Tuyển Tập Truyện Hay Dành Cho Thiếu Nhi (Tái Bản)",133000,192000,59000,31
TIKI,nha-sach-tiki,76737958,"Mind Map English Vocabulary - Từ Vựng Tiếng Anh Qua Sơ Đồ Tư Duy",128700,198000,69300,35
TIKI,nha-sach-tiki,190859600,"Lôi Thần Và Nhân Viên Văn Phòng (Tập 4)",58400,66000,7600,12
TIKI,nha-sach-tiki,157540009,"Diệt Slime Suốt 300 Năm, Tôi Levelmax Lúc Nào Chẳng Hay (Tập 7)",42000,48000,6000,13
TIKI,nha-sach-tiki,112333133,"Quý Cô Thịnh Vượng - Khi Phụ Nữ Tư Duy Đúng Về Tiền",68900,89000,20100,23
TIKI,nha-sach-tiki,125362334,"Dinh Dưỡng Thai Kỳ (Mẹ Bầu Ăn Gì Giúp Con Phát Triển Toàn Diện Và Thông Minh",122000,189000,67000,35
TIKI,nha-sach-tiki,194205609,"Ai Đó Chạy Cùng Ta",175000,225000,50000,22
TIKI,nha-sach-tiki,7804743,"Bí mật - The secret",238000,298000,60000,20
TIKI,nha-sach-tiki,72027523,"Ehon - Đi Đã Ngoại Ngày Mưa (Tái Bản 2020)",39100,55000,15900,29
TIKI,nha-sach-tiki,58828012,"Ai Lấy Miếng Pho Mát Của Tôi ? - Phiên Bản Dành Cho Độc Giả Nhí",47100,68000,20900,31
TIKI,nha-sach-tiki,176132374,"Truyện Thiếu Nhi Hạt Giống Tâm Hồn - Điều Ước Gửi Các Vì Sao",46000,56000,10000,18
TIKI,nha-sach-tiki,867314,"Tuần Của Bé - Bé Sạch Sẽ",11500,23000,11500,50
TIKI,nha-sach-tiki,151597210,"Practice Test Grade 6",118000,118000,0,0
TIKI,nha-sach-tiki,273656715,"Trạm Đọc Official |  Tư Duy Nhanh Và Chậm",201000,269000,68000,25
TIKI,nha-sach-tiki,164336681,"Việt Nam Danh Tác - Bỉ Vỏ",69700,90000,20300,23
TIKI,nha-sach-tiki,188767663,"Quỷ Giá - Bản Thường ( Tặng kèm 1 Bookmark 2 mặt)",124000,159000,35000,22
TIKI,nha-sach-tiki,4040663,"25 Chuyên Đề Ngữ Pháp Tiếng Anh Trọng Tâm – (Tập 1)",71000,110000,39000,35
TIKI,nha-sach-tiki,55071991,"Combo Trọn Bộ 6 Cuốn Giáo Trình Hán Ngữ",512400,732000,219600,30
TIKI,nha-sach-tiki,197464901,"Bẩm Thầy Tường Có Thầy Vũ Tới Tìm - Tập 2",97800,115000,17200,15
TIKI,nha-sach-tiki,14684952,"Khu Vườn Bí Mật ( Tái Bản 2019 )",71500,96000,24500,26
TIKI,nha-sach-tiki,192913462,"Lớp 7(bộ Kết nối, Cánh diều, Chân trời) - Sách Siêu trọng tâm môn Toán, Anh, KHTN - Nhà sách Ôn luyện",80000,160000,80000,50
TIKI,nha-sach-tiki,13673964,"Giây Thứ 12 - Tập 1 (Trinh Thám)",42000,87000,45000,52
TIKI,nha-sach-tiki,186290792,"Bồ Câu Không Đưa Thư (Tái Bản 2022)",27800,38000,10200,27
TIKI,nha-sach-tiki,188535073,"Tối Giản Thông Thái",75700,96000,20300,21
TIKI,nha-sach-tiki,190702862,"Siddhartha",79000,120000,41000,34
TIKI,nha-sach-tiki,8288935,"Của Chuột Và Người",68400,76000,7600,10
TIKI,nha-sach-tiki,68437861,"Đừng Chết Bởi Canxi",110000,159000,49000,31
TIKI,nha-sach-tiki,58220389,"Mô Hình Biểu Đồ - Phương pháp Hiệu quả để Tìm kiếm Lợi nhuận",368000,368000,0,0
TIKI,do-choi-me-be,173164598,"Sữa Bột Anlene Gold 5X Hương Vanilla (Hộp Thiếc 800g)",469000,508000,39000,8
TIKI,do-choi-me-be,147246867,"Sữa Bột Anlene Gold 5X Hương Vanilla (Hộp Thiếc 400g)",249000,268000,19000,7
TIKI,do-choi-me-be,435855,"Sữa Bột Abbott Grow Gold 6+cho trẻ từ 6 tuổi trở lên (900g)",464000,472500,8500,2
TIKI,do-choi-me-be,175953065,"Combo 4 Tã Dán Người Lớn SunMate G2 size M10, M/L10, XL10, M/L18",267000,365234,98234,27
TIKI,do-choi-me-be,967305,"Sữa Bột Abbott Similac Mom Vani 900g",465000,493020,28020,6
TIKI,do-choi-me-be,115483434,"Sữa bột Enfamil A+ NeuroPro 2 với 2’-FL HMO cho trẻ từ 6 –12  tháng tuổi– 1.7kg",979000,979000,0,0
TIKI,do-choi-me-be,88949150,"Sữa Bột Frisolac Gold 3 850g (Dành Cho Trẻ Từ 1 - 2 Tuổi)",484000,484000,0,0
TIKI,do-choi-me-be,105901380,"Vitamin k2 d3 hỗ trợ tăng chiều cao, hết còi xương cho trẻ sơ sinh - LINEABON K2D3 - Sản phẩm từ Châu Âu - Công nghệ mới giúp hấp thu tối đa canxi tự nhiên",271000,369000,98000,27
TIKI,do-choi-me-be,146555381,"Đồ Chơi Rút Gỗ Trẻ Em - 2 Cỡ (Lớn và Nhỏ) - 54 Thanh Rút Gỗ Kèm 4 Con Súc Sắc Cho Bé – Bộ Đồ Chơi Rút Gỗ Cao Cấp Chính Hãng dododios",49000,49000,0,0
TIKI,do-choi-me-be,52774130,"Bộ 2 chai chất thông tắc Cầu, Cống Sifa chống hôi Siêu nhanh Siêu mạnh 5 phút",110000,110000,0,0
TIKI,do-choi-me-be,75357776,"Hộp quà cặp tóc dây buộc tóc công chúa bé gái nhiêu màu cực xinh",69000,69000,0,0
TIKI,do-choi-me-be,54619802,"Chai Thả Bồn Cầu Nhật bản, Vệ Sinh Bồn Cầu, Giúp Hỗ Trợ Giảm Thông Tắc Bồn Cầu Và Khử Mùi, Diệt Sạch 99% Vi Khuẩn (Combo 02 Lọ) - Hàng Chính Hãng",53000,58000,5000,9
TIKI,do-choi-me-be,84705786,"Gạc Rơ Lưỡi, Vệ Sinh Răng Miệng Cho Bé Dr Papie (1 hộp 30 gói)",102000,102000,0,0
TIKI,do-choi-me-be,61290431,"Combo 4 Gói Khăn Ướt Yuniku 90 Tờ Hương Phấn ( 90 tờ x 4 )",99000,167200,68200,41
TIKI,do-choi-me-be,177436965,"Đồ bơi trẻ em, đồ bơi bé trai chất vải chống nắng size lớn 45kg cho bé trai đến 10 tuổi",199000,224130,25130,11
TIKI,do-choi-me-be,68925517,"Cháo Tươi Tôm Rau Ngót Cây Thị",21600,25000,3400,14
TIKI,do-choi-me-be,75521920,"Combo 10 cuộn giấy vệ sinh lớn An Khang AKC500 hai lớp loại 500gr",320000,480000,160000,33
TIKI,do-choi-me-be,76372614,"Đồ chơi trí tuệ Smart Games Thử thách IQ hạt tròn",279000,279000,0,0
TIKI,do-choi-me-be,85239904,"Cuộn Xốp Bọc Cạnh Bàn 2M - Dây Cao Su Che Bịt Cạnh Bàn, Ghế An Toàn Cho Bé",25000,25000,0,0
TIKI,do-choi-me-be,114958267,"Bộ Bài Tình Yêu Game Card Lovetouch - Love card game, board games, bài cho cặp đôi, bài thấu hiểu [Kim Ngọc Thuỷ]",155000,300000,145000,48
TIKI,do-choi-me-be,2173355,"Combo 5 Bịch Khăn Vải Khô Likado (300g)",169000,169000,0,0
TIKI,do-choi-me-be,49884598,"Sữa Morinaga Số 2 - Chilmil (850g) dành cho bé từ 6 đến 36 tháng tuổi",495000,578000,83000,14
TIKI,do-choi-me-be,158887692,"Đồ chơi lắp ráp, xếp hình Qman 1801 - Trực thăng chiến đấu - 381 mảnh ghép",199000,269000,70000,26
TIKI,do-choi-me-be,7459815," Thuốc diệt gián hộp 12 viên - Nội địa Nhật",55000,55000,0,0
TIKI,do-choi-me-be,6632811,"Cháo Tươi Thịt Heo Bí Đỏ Cây Thị",18000,21000,3000,14
TIKI,do-choi-me-be,86155733,"Bộ đồ chơi nhập vai BOWA – Bộ Trang điểm ( BOWA 8252 / BOWA 8255P )",259000,259000,0,0
TIKI,do-choi-me-be,12425736,"Lốc 4 Gói Khăn Giấy Cao Cấp Tempo Softpack Mùi Bạc Hà, 4 Lớp, Không Gây Kích Ứng Da (90 Tờ/ Gói) - Thương Hiệu Đức",105000,105000,0,0
TIKI,do-choi-me-be,50131768,"Set 12 miếng silicon bọc cạnh, góc bàn bảo vệ bé không bị thương khi va đập",19000,19000,0,0
TIKI,do-choi-me-be,79672168,"Sữa Bột Enfagrow Premium Toddler Hương Sữa Tự Nhiên cho trẻ 1-3 tuổi (907g)",691000,691000,0,0
TIKI,do-choi-me-be,19944439,"Tã Dán Moony Natural Bông Organic M46 (46 Miếng)",379000,569400,190400,33
TIKI,do-choi-me-be,57302858,"Bột Thông Cống, Thông Tắc Bồn Cầu Hàn Quốc Cao Cấp combo ( Hộp 5 Gói )",35192,35192,0,0
TIKI,do-choi-me-be,435891,"Sữa Bột Abbott Glucerna Vani 850g",890000,890000,0,0
TIKI,do-choi-me-be,270229665,"Sách nói điện tử song ngữ trẻ em (Bản nâng cấp 1+) - Sách quý điện tử song ngữ Anh – Việt cho bé - Có lựa chọn lấy thêm pin",122000,140000,18000,13
TIKI,do-choi-me-be,116410119,"Túi Nước giặt Omo Nước giặt cửa trước hương Lavender Khử mùi thư thái 3.6KG",180000,227000,47000,21
TIKI,do-choi-me-be,20088701,"Dầu gội Johnson's Baby dịu nhẹ (800ml)",159000,192000,33000,17
TIKI,do-choi-me-be,97551646,"Bộ 2 Lon Sữa Bột Friso Gold 4 1400g Dành Cho Trẻ Từ 2 - 6 Tuổi + Tặng Lon Sữa Friso Gold 4 380g",1260000,1770000,510000,29
TIKI,do-choi-me-be,273532024,"[Combo 3 lon còn 1tr440] Sữa Bột Nutifood GrowPLUS+ Suy Dinh Dưỡng 1.5kg - Tăng Cân, Tăng Chiều Cao (Lon 1.5kg)",568000,884000,316000,36
TIKI,do-choi-me-be,185262304,"Kem đánh răng Colgate Batman 40g dành cho bé",23000,23000,0,0
TIKI,do-choi-me-be,88928340,"Combo 10 khăn ướt Mamamy ( 80 tờ )",285000,300000,15000,5
TIKI,do-choi-me-be,116407426,"Combo 2 Túi Nước Giặt Omo Matic Máy Giặt Cửa Trên Hương Comfort Tinh Dầu Thơm Xoáy Bay Vết Bẩn Thơm Bền Lâu 3.6Kg",350000,454000,104000,23
TIKI,do-choi-me-be,111304924,"Túi Nước Giặt Omo Matic Cho Quần Áo Bé Yêu Chiết Xuất Tràm Trà Và Nha Đam Dịu Nhẹ, Sạch Khuẩn 3.6Kg",180000,227000,47000,21
TIKI,do-choi-me-be,61285745,"Combo 4 Gói Khăn Ướt Yuniku 90 Tờ Không Hương ( 90 tờ x 4 )",99000,167200,68200,41
TIKI,do-choi-me-be,1000534,"Sữa Bột Anlene Gold Movepro Hương Vanilla (Hộp Giấy 440g)",189000,204000,15000,7
TIKI,do-choi-me-be,6464021,"Cháo Tươi Cá Lóc Đậu Xanh Cây Thị",21600,25000,3400,14
TIKI,do-choi-me-be,116410110,"TúI Nước Giặt Omo Matic Cho Máy Giặt Cửa Trên Xoáy Bay Vết Bẩn Sạch Bẩn Khử Mùi Toàn Diện 3.9Kg",180000,227000,47000,21
TIKI,do-choi-me-be,76404389,"Tã/ Bỉm Quần PAMPERS Giữ Dáng Gói Cực Đại Size M (74 miếng, 7-12kg), Chống Xệ",332000,528000,196000,37
TIKI,do-choi-me-be,100989176,"Nước Xả Làm Mềm Vải Comfort Chăm Sóc Dịu Nhẹ Cho Da Nhạy Cảm 3.8L",285000,285000,0,0
TIKI,do-choi-me-be,68370674,"Nước Xả Làm Mềm Vải COMFORT Nước Xả Vải Hương Ban Mai Đậm Đặc 1 Lần Xả Giúp Giữ Màu & Bền Vải 3.8L",215000,271000,56000,21
TIKI,do-choi-me-be,134516823,"Combo 2 túi nước xả vải em bé Comfort cho da nhạy cảm với công thức riêng dịu nhẹ 100% nguồn gốc thực vật, Túi 3.8L",452000,570000,118000,21
TIKI,do-choi-me-be,41356464,"Nước Rửa Chén Bát Sunlight Thiên Nhiên Muối Khoáng & Lô Hội 3.6kg",118000,126500,8500,7
TIKI,do-choi-me-be,20088686,"Sữa tắm gội toàn thân Johnson's Baby (500ml)",155000,155000,0,0
TIKI,do-choi-me-be,59143353,"Combo Tiết Kiệm: 6 Gói Khăn Ướt Bobby Care Không Hương 100 Miếng/Gói",199000,279000,80000,29
TIKI,do-choi-me-be,41356464,"Nước Rửa Chén Bát Sunlight Thiên Nhiên Muối Khoáng & Lô Hội 3.6kg",118000,126500,8500,7
TIKI,do-choi-me-be,23957552,"Combo 2 Tã Quần Người Lớn Sunmate Mềm Mại L8 (8 Miếng)",160000,199999,39999,20
TIKI,do-choi-me-be,25027164,"Combo 2 Gói Tã Quần Người Lớn Sunmate Khô Thoáng L7 (7 Miếng/ Gói)",151000,199999,48999,24
TIKI,do-choi-me-be,116407426,"Combo 2 Túi Nước Giặt Omo Matic Máy Giặt Cửa Trên Hương Comfort Tinh Dầu Thơm Xoáy Bay Vết Bẩn Thơm Bền Lâu 3.6Kg",350000,454000,104000,23
TIKI,do-choi-me-be,89261232,"Combo 20 gói khăn giấy lau tay An Khang AK20-2 loại hai lớp dài 20cm - 102 tờ/gói",308000,440000,132000,30
TIKI,do-choi-me-be,59143353,"Combo Tiết Kiệm: 6 Gói Khăn Ướt Bobby Care Không Hương 100 Miếng/Gói",199000,279000,80000,29
TIKI,do-choi-me-be,272847939,"Hạt nêm rau củ Massel Úc 100% từ rau củ thảo mộc bảo vệ sức khỏe, dành cho ăn chay, ăn mặn, ăn kiêng và cho bé ăn dặm - QuaTangMe Extaste",88400,180000,91600,51
TIKI,do-choi-me-be,134516825,"Combo 2 túi Nước Xả Vải Comfort Giữ Màu & Bền Vải Một Lần Xả Hương Ban Mai, túi 3.8L",427000,542000,115000,21
TIKI,do-choi-me-be,1000540,"Sữa Bột Anlene Gold Movepro 3X Hương Vanilla (Hộp Thiếc 800g)",385000,410000,25000,6
TIKI,do-choi-me-be,137337237,"Combo Mua 1 Tặng 1 - Giấy vệ sinh PREMIER Deluxe đóng cặp ",165000,200000,35000,18
TIKI,do-choi-me-be,34537694,"Tã Dán Siêu Thấm Caryn Gói Siêu Tiết Kiệm M40 (40 Miếng)",334000,352300,18300,5
TIKI,do-choi-me-be,125240682,"Nước Xả Vải Downy Dạng Túi",275000,275000,0,0
TIKI,do-choi-me-be,1745009,"Tấm Đệm Lót Siêu Thấm Caryn (20 Miếng)",105000,128700,23700,18
TIKI,do-choi-me-be,134516825,"Combo 2 túi Nước Xả Vải Comfort Giữ Màu & Bền Vải Một Lần Xả Hương Ban Mai, túi 3.8L",427000,542000,115000,21
TIKI,do-choi-me-be,116447512,"Sữa tắm Johnson's Baby chứa sữa và gạo (1000ml)",235000,235000,0,0
TIKI,do-choi-me-be,116407260,"Combo 2 túi nước giặt OMO Matic chuyên dụng Cửa Trước Lavender Khử Mùi Thư Thái 3.6kg",350000,454000,104000,23
TIKI,do-choi-me-be,498703,"Combo 6 Khăn Ướt Unifresh Aloevera 80M (80 Miếng)",140970,140970,0,0
TIKI,do-choi-me-be,68347468,"Nước xả làm mềm vải COMFORT Nước xả vải hương Bella Giữ màu, Bền Vải & Hương nước hoa thiên nhiên 3.8L",215000,271000,56000,21
TIKI,do-choi-me-be,68347466,"Nước Xả Làm Mềm Vải Comfort Giữ Màu & Bền Vải Sophia Hương Nước Hoa Thiên Nhiên 3.8L",215000,271000,56000,21
TIKI,do-choi-me-be,68370674,"Nước Xả Làm Mềm Vải COMFORT Nước Xả Vải Hương Ban Mai Đậm Đặc 1 Lần Xả Giúp Giữ Màu & Bền Vải 3.8L",215000,271000,56000,21
TIKI,do-choi-me-be,175953065,"Combo 4 Tã Dán Người Lớn SunMate G2 size M10, M/L10, XL10, M/L18",380000,522327,142327,27
TIKI,do-choi-me-be,114771868,"Nước giặt dưỡng vải Comfort Nước giặt xả đa chức năng hương Thời Thượng giúp quần áo sạch thơm & tươi màu Túi 3.8kg",167000,195000,28000,14
TIKI,do-choi-me-be,116410107,"TúI Nước Giặt Omo Matic Comfort Cho Máy Giặt Cửa Trên Hương Tinh Dầu Thơm Xoáy Bay Vết Bẩn, Hương Thơm Bền Lâu 3.6Kg",180000,227000,47000,21
TIKI,do-choi-me-be,152469540,"Ghép Hình Lực Lượng Cảnh Sát - Xe Tuần Tra 158 Chi Tiết DK81063",81000,108000,27000,25
TIKI,do-choi-me-be,134516823,"Combo 2 túi nước xả vải em bé Comfort cho da nhạy cảm với công thức riêng dịu nhẹ 100% nguồn gốc thực vật, Túi 3.8L",452000,570000,118000,21
TIKI,do-choi-me-be,38438031,"Combo Viên tẩy bồn cầu 55G x 3 VIM Power 5 hương Oải hương Sạch Khuẩn Thơm Mát suốt 30 ngày",75000,84000,9000,11
TIKI,do-choi-me-be,68347468,"Nước xả làm mềm vải COMFORT Nước xả vải hương Bella Giữ màu, Bền Vải & Hương nước hoa thiên nhiên 3.8L",215000,271000,56000,21
TIKI,do-choi-me-be,24028050,"Sữa bột Abbott Pediasure 1.6kg cho trẻ từ 1-10 tuổi",1039000,1240250,201250,16
TIKI,do-choi-me-be,160299786,"Nước Rửa Chén Bát Sunlight Chanh 100 Sạch Nhanh Xả Bọt Nhanh Rửa Sạch Dầu Mỡ 3.6kg",100000,104900,4900,5
TIKI,do-choi-me-be,88784189,"Bột thông cống và khủ mùi hôi bồn cầu, lavabo, chậu rửa bát, đường ống cực  mạnh nắp xanh",10000,16139,6139,38
TIKI,do-choi-me-be,160299786,"Nước Rửa Chén Bát Sunlight Chanh 100 Sạch Nhanh Xả Bọt Nhanh Rửa Sạch Dầu Mỡ 3.6kg",100000,104900,4900,5
TIKI,do-choi-me-be,115667006,"Khăn giấy lụa Premier VinaTissue 280 tờ - Combo lốc 6",120000,155000,35000,23
TIKI,do-choi-me-be,116407260,"Combo 2 túi nước giặt OMO Matic chuyên dụng Cửa Trước Lavender Khử Mùi Thư Thái 3.6kg",350000,454000,104000,23
TIKI,do-choi-me-be,88924596,"Sữa Bột Frisolac Gold 2 850g Dành Cho Trẻ Từ 6 - 12 Tháng Tuổi",539000,539000,0,0
TIKI,do-choi-me-be,114771870,"Nước giặt dưỡng vải Comfort Nước giặt xả đa chức năng hương Thanh Lịch giúp quần áo sạch thơm & tươi màu Túi 3.8kg",163000,195000,32000,16
TIKI,do-choi-me-be,25746246,"Combo 2 Chai Nước Tẩy Bồn Cầu Vim Trắng Sáng Hương Oải Hương 870 ML",78000,78000,0,0
TIKI,do-choi-me-be,100989176,"Nước Xả Làm Mềm Vải Comfort Chăm Sóc Dịu Nhẹ Cho Da Nhạy Cảm 3.8L",285000,285000,0,0
TIKI,do-choi-me-be,116410159,"Túi Nước Giặt Omo Matic Cho Máy Giặt Cửa Trước Bền Đẹp Bền Màu Sau 100 Lần Giặt 3.6Kg",180000,227000,47000,21
TIKI,do-choi-me-be,88949154,"Sữa Bột Friso Gold 4 1400g (Dành Cho Trẻ Từ 2 - 6 Tuổi)",730000,885000,155000,18
TIKI,do-choi-me-be,175953067,"Combo 4 Tã Quần Người Lớn SunMate Mềm Mại",293000,399997,106997,27
TIKI,do-choi-me-be,174865692,"Combo 5 Bộ Viên tẩy bồn cầu Vim Power 5 Hương Lavender 275G (5x55G)",112000,120000,8000,7
TIKI,do-choi-me-be,23957552,"Combo 2 Tã Quần Người Lớn Sunmate Mềm Mại L8 (8 Miếng)",160000,199999,39999,20
TIKI,do-choi-me-be,19944385,"Tấm Đệm Lót Caryn Mỏng Nhẹ (14 Miếng)",90000,102900,12900,13
TIKI,nha-cua-doi-song,272035598,"HỘP 10 ĐÔI ĐŨA INOX 304 - CAO CẤP - SANG TRỌNG - NGUYÊN KHỐI INOX 304",235000,235000,0,0
TIKI,nha-cua-doi-song,85029640,"Ổ cắm Điện Quang ĐQ ESK 2WR 23-3U (2 lỗ 3 chấu, 3 USB, dây dài 2m, màu trắng đỏ)",214160,267700,53540,20
TIKI,nha-cua-doi-song,124691053,"Đệm thắt lưng tam giác Ema thế hệ 2 - Rộng hơn - Thoải mái xoay trở - Dành cho người thoát vị thắt lưng, bà bầu, người cao tuổi",200000,400000,200000,50
TIKI,nha-cua-doi-song,44321391,"Tủ nhựa lắp ghép 6 Ô quần áo (70cm x 110cmx47cm)",279000,279000,0,0
TIKI,nha-cua-doi-song,168837331,"Giấy Nến Lót Nồi Chiên Không Dầu Hình Khuôn Bánh Siêu Tiện Lợi - Thấm Giảm Thiểu Tối Đa Dầu Mỡ Bám - Hàng Chính Hãng MINIIN",99000,99000,0,0
TIKI,nha-cua-doi-song,78890431,"Bộ nắp bàn cầu nhà vệ sinh bằng nhựa cao cấp, thích hợp sử dụng với nhiều loại bồn cầu",65000,65000,0,0
TIKI,nha-cua-doi-song,190542051,"[70*140cm] Khăn Tắm Viên Nén HQ",8900,15000,6100,41
TIKI,nha-cua-doi-song,39292323,"Bình Nước Thủy Tinh WATER Phong Cách Hàn Quốc 460ml",115000,115000,0,0
TIKI,nha-cua-doi-song,96183241,"Chân đàn Organ, Piano đa năng - Kzm Kurtzman STX2 - Dáng chữ X đôi - Hàng chính hãng",210000,210000,0,0
TIKI,nha-cua-doi-song,2039747,"Bộ Nồi Inox 3 Đáy Sunhouse SH334",440000,690000,250000,36
TIKI,nha-cua-doi-song,145243898,"Bộ vòi bơm hút nước rửa chén gắn chậu rửa HOBBY Home Decor NRC4 màu đen đầu bơm Inox 304 kèm dây dẫn 120cm",209000,280000,71000,25
TIKI,nha-cua-doi-song,56451459,"Pin C carbon Panasonic R14UT/2S chính hãng",27550,29000,1450,5
TIKI,nha-cua-doi-song,53116171,"PHÂN TRÙN QUẾ DẠNG VIÊN NÉN SFARM CHUYÊN DÙNG CHO LAN VÀ HOA KIỂNG TRỒNG CHẬU - BỔ SUNG HỆ VI SINH CÓ LỢI CHO ĐẤT",45000,45000,0,0
TIKI,nha-cua-doi-song,47462861,"Bộ 6 vỉ (12 viên pin) pin Kiềm Alkaline Panasonic AAA LR03T/2B-Hàng chính hãng",167000,180000,13000,7
TIKI,nha-cua-doi-song,162875961,"Hộp 10 Đôi Đũa  Sừng Chất Liệu Hợp Kim Mạ Vàng Cao Cấp Đầu Đũa Có Chống Trơn - Hàng Loại 1 - Chính Hãng MINIIN",32000,32000,0,0
TIKI,nha-cua-doi-song,15262922,"Đầu Gắn Vòi Nước Rửa Chén Xoay 360 Độ Tiết Kiệm Nước XR581",18800,18800,0,0
TIKI,nha-cua-doi-song,55134471,"1kg - Túi đựng rác gia đình , Bao đựng rác văn phòng 3 màu size trung 55x65",34000,34000,0,0
TIKI,nha-cua-doi-song,195544340,"Bình Inox Đựng Rượu CCCP Truyền Thống Dung Tích 2.0L Dày 0,6 ly - 64OZ ( Loại 1 ), Kèm Bao Da Phong Cách",185000,398000,213000,54
TIKI,nha-cua-doi-song,140204791,"Bộ 24 Quả Châu Bóng Nhũ Kim Tuyến Lấp Lánh Trang Trí Cây Thông Noel Giáng Sinh Giá Rẻ",78000,78000,0,0
TIKI,nha-cua-doi-song,135610861,"Ga thun lạnh đủ kích thước",55000,55000,0,0
TIKI,nha-cua-doi-song,52577269," Đầu vòi rửa chén tăng áp nhựa mạ điện-Ba phương pháp thoát nước",38000,85000,47000,55
TIKI,nha-cua-doi-song,35449842,"hộp 200 ống hút giấy cao cấp _ Clean Paper Straw màu trắng kích thước 6mm x 197mm dùng cho cà phê, nước ép....",53000,53000,0,0
TIKI,nha-cua-doi-song,139723967,"Combo Khăn Lau Đa Năng Mặt Siêu Thấm, Khăn Lau Bếp, Khăn Lau Kính, Khăn Lau Bát, Khăn Lau Tay, Khăn Lâu Ô Tô miDoctor",16000,16000,0,0
TIKI,nha-cua-doi-song,2391311,"Cân Treo Mini Bỏ Túi 1 Mặt Số 5kg Nhơn Hòa NHMGS-5 - Hàng Chính Hãng",69000,69000,0,0
TIKI,nha-cua-doi-song,87578488,"Găng tay y tế latex S Gloves - Bao tay y tế có bột màu trắng hộp 100 chiếc",54000,70000,16000,23
TIKI,nha-cua-doi-song,26670490,"Kệ Góc Nhà Tắm Chống Nước",204000,222000,18000,8
TIKI,nha-cua-doi-song,96271704,"Ổ Cắm Điện Thông Minh XSmart Đa Tính Năng Chống Giật Hàng Siêu Cao Cấp,  Chống Cháy Nổ Chịu Được Công Suất Cao, Chính Hãng",139000,139000,0,0
TIKI,nha-cua-doi-song,10404394,"Bình Đựng Thức Ăn Giữ Nhiệt ELmich Inox 304 EL0631 (500ml)",243000,469000,226000,48
TIKI,nha-cua-doi-song,273377437,"Ổ cắm điện kéo dài Rạng Đông 2m/5m Model OC04, OC05 chống giật, rơ le tự ngắt chống quá tải",126000,140000,14000,10
TIKI,nha-cua-doi-song,170927755,"Hộp nhựa đựng thực phẩm Homepower trong suốt có khay lót đáy giúp ráo nước, chất liệu cao cấp, an toàn cho sức khỏe",149000,149000,0,0
TIKI,nha-cua-doi-song,75783351,"Máy Xay Tỏi Ớt Cầm Tay Mini Sạc Điện 100ml 250ml Tiện Lợi",160000,160000,0,0
TIKI,nha-cua-doi-song,20634384,"Ổ Khóa inox Mật Mã 4 Số",28000,28000,0,0
TIKI,nha-cua-doi-song,85351583," 100 Túi bao Ổi, Cam, Na, Vú Sữa,.. túi bọc trái cây phòng ngừa sâu bệnh phá hoại - Dạng Rút Túi Chuyên Dụng",32000,32000,0,0
TIKI,nha-cua-doi-song,68736740,"Ruột gối nằm lông vũ khách sạn cao cấp sợi microfiber nhân tạo Hanvico by Homemark có kích thước trẻ em và 50x70 cm",133000,250000,117000,47
TIKI,nha-cua-doi-song,73608154,"ĐỒNG HỒ TREO TƯỜNG TRÒN KIM TRÔI SIZE LỚN ĐƯỜNG KÍNH 30CM",149000,149000,0,0
TIKI,nha-cua-doi-song,114204741,"Bình giữ nhiệt inox 304 Sunhouse 450ml KS-TU450I",98000,150000,52000,35
TIKI,nha-cua-doi-song,116198000,"Đệm Ngồi Thông Minh Lưu Thông Máu Thoáng Khí PEAFLO",145000,165000,20000,12
TIKI,nha-cua-doi-song,90850071,"DECAL DÁN KÍNH CHỐNG NẮNG CÁCH NHIỆT XANH DƯƠNG(CUÔN 3M)",169000,169000,0,0
TIKI,nha-cua-doi-song,14639229,"Nắp Kính Cường Lực Nồi Và Chảo Fivestar",55000,55000,0,0
TIKI,nha-cua-doi-song,67811819,"Đèn LED Cảm Biến Chuyển Động Nhiều Kích Cỡ, Cảm Ứng Hồng Ngoại 3 Chế Độ",197000,197000,0,0
TIKI,dien-thoai-may-tinh-bang,274095168,"Điện thoại Xiaomi Redmi A2+ (3GB/64GB) - Hàng Chính Hãng",1890000,2790000,900000,32
TIKI,dien-thoai-may-tinh-bang,197143907,"Điện thoại POCO M5 4GB+64GB/6GB+128GB | Pin 5000mAh | MediaTek Helio G99 | Sạc nhanh 18W - Hàng chính hãng",2599000,3990000,1391000,35
TIKI,dien-thoai-may-tinh-bang,214756058,"Máy đọc sách New Kindle 11th 2022 (16GB) - Hàng chính hãng",2920000,2920000,0,0
TIKI,dien-thoai-may-tinh-bang,272238679,"Điện thoại Samsung Galaxy A05 (4GB/128GB) - Hàng chính hãng",3090000,3090000,0,0
TIKI,dien-thoai-may-tinh-bang,273947792,"Điện thoại AI Samsung Galaxy S24 Ultra 12GB/256GB, Camera 200MP Zoom 100x, S Pen- Đen- Hàng Chính Hãng",31990000,34490000,2500000,7
TIKI,dien-thoai-may-tinh-bang,263798932,"Máy đọc sách Boox Page - Hàng Chính Hãng",6700000,7990000,1290000,16
TIKI,dien-thoai-may-tinh-bang,273175604,"Máy đọc sách Boox Note Air 3 C - Hàng Chính Hãng",13980000,15990000,2010000,13
TIKI,dien-thoai-may-tinh-bang,270447782,"Điện thoại Nokia C32 (4GB/128GB) - Hàng chính hãng",2090000,3290000,1200000,36
TIKI,dien-thoai-may-tinh-bang,247829297,"Điện thoại Realme C55 (8GB/256GB) - Hàng chính hãng",4470000,5690000,1220000,21
TIKI,dien-thoai-may-tinh-bang,58146831,"Điện Thoại Cổ Điển DT150 - Bản Dây Line",2500000,2500000,0,0
TIKI,dien-thoai-may-tinh-bang,205897182,"Máy tính bảng Xiaomi Redmi Pad (3GB/64GB) - Hàng chính hãng",6290000,6290000,0,0
TIKI,dien-thoai-may-tinh-bang,262706645,"Máy đọc sách kindle 2022 11th - hàng chính hãng",2790000,2790000,0,0
TIKI,dien-thoai-may-tinh-bang,176438844,"Điện thoại Xiaomi REDMI 9A (2+32) Xanh lá - Hàng chính hãng (chỉ giao HN và một số khu vực)",2088000,2088000,0,0
TIKI,dien-thoai-may-tinh-bang,217158529,"Máy tính bảng Samsung Galaxy Tab A7 Lite - Hàng chính hãng",3587000,3587000,0,0
TIKI,dien-thoai-may-tinh-bang,271822725,"Máy Tính Bảng Samsung Galaxy Tab A8 2022 (3GB/32GB) - Hàng Chính Hãng",5856000,5856000,0,0
TIKI,dien-thoai-may-tinh-bang,191689727,"Điện thoại OPPO CPH2387 - A57 Đen - Hàng Chính Hãng",4284000,4284000,0,0
TIKI,dien-thoai-may-tinh-bang,189658085,"Điện Thoại Oppo A57 (4GB/64GB)",4284000,4284000,0,0
TIKI,dien-thoai-may-tinh-bang,195177036,"Máy tính bảng Samsung Galaxy Tab A7 Lite LTE SM-T225 - Hàng Chính Hãng",3587000,3587000,0,0
TIKI,dien-thoai-may-tinh-bang,165747145,"Điện thoại Xiaomi Redmi 9A 2GB/32GB - Chip MediaTek Helio G25 8 nhân (12 nm), Màn hình 6.53" HD+, Camera 13MP, Pin 5000 - Hàng Chính Hãng",2148000,2148000,0,0
TIKI,dien-thoai-may-tinh-bang,115830124,"Điện Thoại Xiaomi Redmi 9A (2GB/32GB)- Đã kích hoạt bảo hành điện tử- Hàng Chính Hãng - Sky Blue",2088000,2088000,0,0
TIKI,dien-thoai-may-tinh-bang,261962220,"Điện Thoại Samsung Galaxy A24 (6GB/128GB) - Hàng Chính Hãng",5808000,5808000,0,0
TIKI,dien-thoai-may-tinh-bang,181699053,"Điện thoại Xiaomi Redmi 9A - Hàng chính hãng",2088000,2088000,0,0
TIKI,dien-thoai-may-tinh-bang,192036708,"Điện Thoại OPPO A57 (4GB/128GB) - Hàng Chính Hãng",4632000,4632000,0,0
TIKI,dien-thoai-may-tinh-bang,242712374,"Điện thoại Samsung Galaxy S23 Ultra 256GB - Hàng chính hãng",31990000,31990000,0,0
TIKI,dien-thoai-may-tinh-bang,274160702,"Điện thoại Samsung Galaxy S24 Ultra - Hàng chính hãng",28390000,33990000,5600000,16
TIKI,dien-thoai-may-tinh-bang,249143473,"Điện thoại Samsung Galaxy A34 5G (8GB/128GB) - Hàng chính hãng - ĐÃ KÍCH HOẠT BẢO HÀNH ĐIỆN TỬ",7164000,7164000,0,0
TIKI,dien-thoai-may-tinh-bang,248929458,"Điện thoại Samsung Galaxy A34 5G (8GB/128GB) - Hàng chính hãng",7164000,7164000,0,0
TIKI,dien-thoai-may-tinh-bang,217548686,"Máy đọc sách Kindle Scribe – thế hệ đầu tiên có thể đọc và viết, màn hình 10,2” 300PPI, đèn vàng warmlight, bộ nhớ 16-64GB, đồng bộ dữ liệu qua Microsoft Word - hàng nhập khẩu",11390000,11390000,0,0
TIKI,dien-thoai-may-tinh-bang,272397263,"Điện thoại Xiaomi 13T Pro (12GB/512GB) - Hàng chính hãng",16990000,16990000,0,0
TIKI,dien-thoai-may-tinh-bang,215617756,"Điện Thoại Samsung A14 5G 4GB/128GB - Hàng Chính Hãng",3439000,5190000,1751000,34
TIKI,dien-thoai-may-tinh-bang,273398391,"Điện thoại Ulefone Armor 18T (Ram 12Gb,Rom 256Gb,Camera 108MP,camera nhiệt FLIR,Pin 9600 mAh,5G,chống nước,chống va đập)-hàng chính hãng",14990000,14990000,0,0
TIKI,dien-thoai-may-tinh-bang,198868573,"Điện thoại IP Grandstream GRP 2601P hàng chính hãng",1050000,1050000,0,0
TIKI,dien-thoai-may-tinh-bang,254125720,"Điện thoại oukitel WP22 (Loa to,Chống nước ,chống sốc IP68/IP69K,Ram 13Gb(8GB+5Gb mở rộng),Rom 256Gb,Màn hình 6.58 FHD,tầm nhìn ban đêm,Pin 10.000mAh)- Hàng chính hãng",5990000,5990000,0,0
TIKI,dien-thoai-may-tinh-bang,274424330,"Điện thoại Người Già Good A60 Pro 4G (LTE) Gọi HD Call , Có SOS , Màn lớn - Phím to - Pin trâu - Sạc Type C - Hàng nhập khẩu",469000,490000,21000,4
TIKI,dien-thoai-may-tinh-bang,230203067,"Điện thoại OPPO A55s 5G 4GB/64GB - Màn 90hz - Chống nước IP68 - Hàng nhập khẩu - Bản quốc tế",2841000,3699000,858000,23
TIKI,dien-thoai-may-tinh-bang,270260682,"Điện thoại Gaming Tecno POVA 4 8GB/128GB - Hàng Chính Hãng - MediaTek G99 | 6000mAh - 6.82 inch - Bảo hành 13 Tháng",3499000,4690000,1191000,25
TIKI,dien-thoai-may-tinh-bang,207914534,"Điện Thoại Nokia 5710 XpressAudio - Hàng Chính Hãng",1599000,1790000,191000,11
TIKI,dien-thoai-may-tinh-bang,262304313,"Điện thoại Xiaomi Redmi Note 12S (8GB/256GB) - Hàng chính hãng",5019000,6690000,1671000,25
TIKI,dien-thoai-may-tinh-bang,195894801,"Masstel izi 26 4G - Chữ to - Loa to - Hàng Chính Hãng",489000,650000,161000,25
TIKI,dien-thoai-may-tinh-bang,274164375,"Máy Tính Bảng Samsung Galaxy Tab A9 Plus WIFI 4GB-64GB - Hàng chính hãng",4350000,5990000,1640000,27
TIKI,do-choi-me-be,25769067,"Cờ Vua Nam Châm Cỡ Lớn miDoctor 4812A",175000,175000,0,0
TIKI,do-choi-me-be,66615105,"Bộ bài Uno Giấy cứng giải trí",18800,18800,0,0
TIKI,do-choi-me-be,6464017,"Cháo Tươi Cá Hồi Rong Biển Cây Thị",22500,26000,3500,13
TIKI,do-choi-me-be,17114404,"Sữa tắm gội toàn thân Johnson's Baby mềm mịn (500ml)",145000,178000,33000,19
TIKI,do-choi-me-be,104131972,"Núm vú cổ rộng silicone siêu mềm Plus Pigeon 2 Cái/Vỉ",120000,199000,79000,40
TIKI,do-choi-me-be,88928273,"Combo 10 Gói Khăn Ướt Trẻ Em MAMAMY 100 Tờ",296000,323000,27000,8
TIKI,do-choi-me-be,270845223,"Sữa cho bé 1 đến 3 tuổi Meiji nội địa Nhật giúp bé phát triển cân đối chiều cao, cân nặng, trí não - QuaTangMe Extaste",415000,415000,0,0
TIKI,do-choi-me-be,145512639,"Nút Che Bịt Ổ Điện Chắc Chắn An Toàn Cho Bé",1881,1900,19,1
TIKI,do-choi-me-be,68179518,"Nước Tẩy Nhà Tắm Mao Bao 600ml",42500,50000,7500,15
TIKI,do-choi-me-be,71080136,"Sure Prevent Gold HT 900g",615000,615000,0,0
TIKI,do-choi-me-be,130461472,"Sữa Bột Similac Einstein 3 cho trẻ 1 – 2 tuổi",510000,510000,0,0
TIKI,do-choi-me-be,76072139,"Xe công trình xây dựng bằng kim loại  KAVY gồm 6 xe chi tiết sắc sảo, an toàn cho bé, dùng làm đồ chơi trẻ em hoặc trang trí",129000,129000,0,0
TIKI,do-choi-me-be,34537693,"Tã Dán Siêu Thấm Caryn Gói Siêu Tiết Kiệm L40 (40 Miếng)",369000,403300,34300,9
TIKI,do-choi-me-be,249030271,"Ensure Úc sữa cho người lớn Giúp hồi phục sức khỏe cho người gầy yếu, người suy dinh dưỡng - QuaTangMe Extaste",903000,2078000,1175000,57
TIKI,do-choi-me-be,170331247,"Gạc Rơ Lưỡi Oribebe Vệ Sinh Răng Miệng Cho Bé Hộp 30 Gói",115000,165000,50000,30
TIKI,do-choi-me-be,116452634,"Khăn giấy bếp PREMIER VinaRoll 2 cuộn/gói - Combo 3 gói",68000,99000,31000,31
TIKI,do-choi-me-be,10054502,"Thùng 48 Hộp Sữa Bột Pha Sẵn Friso Gold Rtd Vani (48 x 180Ml)",685000,807000,122000,15
TIKI,do-choi-me-be,68612841,"Combo 2 túi nước giặt xả Maxkleen hương Vườn Sớm Mai 3.8kg/túi ",291000,420000,129000,31
TIKI,do-choi-me-be,1744987,"Tã Quần Mỏng Nhẹ Caryn Gói Siêu Lớn M16 (16 Miếng)",180000,181600,1600,1
TIKI,do-choi-me-be,97008405,"Combo 02 Hộp Vệ Sinh Lồng Máy Giặt Ag+ Mao Bao 306g - Tặng Chất Làm Sạch Bình Đun Nước 25g x 1 gói",84000,100000,16000,16
TIKI,do-choi-me-be,129577440,"Bột Tẩy Rong Rêu Trên Nền Xi Măng ROC",38997,38997,0,0
TIKI,do-choi-me-be,73638976,"Tẩy dầu mỡ máy hút mùi, mặt bếp, tường gạch ốp, bồn rửa bát HGO 500ml",105000,105000,0,0
TIKI,do-choi-me-be,10021552,"Sữa Bột Meiji 0-1 Infant Formula (800g)",519000,519000,0,0
TIKI,do-choi-me-be,29540357,"Đồ chơi lắp ghép xếp hình  Trực thăng chiến đấu 8 trong 1 Qman 1801",229000,229000,0,0
TIKI,do-choi-me-be,6464033,"Cháo Tươi Rau Củ Thập Cẩm Cây Thị",18900,22000,3100,14
TIKI,do-choi-me-be,104140783,"Tắm gội dịu nhẹ Pigeon Hương Jojoba 200ml/700ml",60000,79000,19000,24
TIKI,do-choi-me-be,57967652,"Viên Thả Bồn Cầu Nhật Bản Dạng Nén Cao Cấp HOMI Mã HC01 Thế Hệ 2 Giúp Diệt Sạch Vi Khuẩn Khử Mùi Hiệu Quả Tuyệt Đối An Toàn Khi Sử Dụng (Hộp 10 viên) - Hàng Chính Hãng",26000,89000,63000,71
TIKI,do-choi-me-be,412772,"Tã Quần Cao Cấp Moony Nhật Bản Bé Gái XL38 (38 Miếng)",339000,466400,127400,27
TIKI,do-choi-me-be,104125144,"Ty ngậm đôi Pigeon size L (HSD: 11/2025)",95000,158000,63000,40
TIKI,do-choi-me-be,109882431,"BẤM MÓNG TAY AN TOÀN CHO TRẺ SƠ SINH NUK DÙNG CHO BÉ TỪ 0 THÁNG TUỔI",65000,69000,4000,6
TIKI,do-choi-me-be,95035819,"Bột ăn dặm dinh dưỡng Sữa - Ăn dặm khởi đầu HiPP Organic 250g",145000,145000,0,0
TIKI,do-choi-me-be,53039237,"Combo 2 Túi Nước rửa bình sữa Arau Baby (450ml x 2 túi)",229000,229000,0,0
TIKI,do-choi-me-be,43191091,"Thùng 48 Hộp Sữa Anlene Đậm Đặc 4X Ít Béo Hương Vani (12 x 4 x 125 ml)",509000,552000,43000,8
TIKI,do-choi-me-be,189657651,"Nước giặt Lix Đậm Đặc Hương Hoa Túi 3.5Kg - Tẩy Sạch Cực Mạnh Vết Bẩn - NG350",115000,115000,0,0
TIKI,do-choi-me-be,184217978,"Nước Giặt ARIEL Cửa Trên Sạch Sâu",214000,236500,22500,10
TIKI,do-choi-me-be,102738895,"Muối Rửa Bát Finish 1,2kg - Hàng Nhập Khẩu Đức",106975,106975,0,0
TIKI,do-choi-me-be,543129,"Dung Dịch Giặt Quần Áo Cho Bé D-Nee - Chai 3000ml (Xanh)",196000,245000,49000,20
TIKI,do-choi-me-be,97846795,"Set 5 Khăn Rửa Mặt 4 Lớp Sợi Tre Lụa Mềm, Thấm Hút Tốt, Kháng Khuẩn 100% Thương Hiệu Bonny (KT: 30x30 Cm)",98000,98000,0,0
TIKI,do-choi-me-be,52344942,"Combo 4 gói Khăn Giấy Rút See-U 2 Lớp 200 Tờ/gói",66000,66000,0,0
TIKI,do-choi-me-be,76507811,"Đồ Chơi Rút Gỗ Trẻ Em - 2 Cỡ (Lớn và Nhỏ) - 54 Thanh Rút Gỗ Kèm 4 Con Súc Sắc Cho Bé – Bộ Đồ Chơi Rút Gỗ Cao Cấp Chính Hãng Amalife",39000,39000,0,0
TIKI,nha-sach-tiki,72290296,"Bí Quyết Đầu Tư & Kinh Doanh Chứng Khoán Của Tỷ Phú Warren Buffett Và George Soros (Tái Bản 2020)",110000,158000,48000,30
TIKI,nha-sach-tiki,80920029,"Nguyên lý kế toán TBL9",63000,63000,0,0
TIKI,nha-sach-tiki,347334,"Có Hai Con Mèo Ngồi Bên Cửa Sổ",70500,100000,29500,30
TIKI,nha-sach-tiki,71553549,"Đọc Nhanh, Hiểu Sâu, Nhớ Lâu Trọn Đời (Tái Bản 2020)",42000,59000,17000,29
TIKI,nha-sach-tiki,160585762,"Veil – Sắc Đen Trầm Lặng - Tập 2 - (Tặng Kèm Postcard)",92200,109000,16800,15
TIKI,nha-sach-tiki,8149335,"Cổ Học Tinh Hoa (Bìa Mềm)",94300,115000,20700,18
TIKI,nha-sach-tiki,71990280,"Nói Chuyện Là Bản Năng, Giữ Miệng Là Tu Dưỡng, Im Lặng Là Trí Tuệ",132300,189000,56700,30
TIKI,nha-sach-tiki,100958464,"Hỏi Đáp Từ Trái Tim (Tái Bản)",102000,149000,47000,32
TIKI,nha-sach-tiki,174444166,"Cẩm Nang Diện Chẩn – Phương Pháp Đơn Giản Áp Dụng Tại Gia",124000,179000,55000,31
TIKI,nha-sach-tiki,40750124,"Không Gia Đình (Phiên Bản Mới) - Tặng kèm bộ Postcard",119250,159000,39750,25
TIKI,nha-sach-tiki,175956866,"Giới Hạn Của Bạn Chỉ Là Xuất Phát Điểm Của Tôi (Tái Bản)",62700,89000,26300,30
TIKI,nha-sach-tiki,16284286,"Tuổi Thơ Dữ Dội - Tập 1 (Tái Bản)",57900,80000,22100,28
TIKI,nha-sach-tiki,187889757,"Gọt bút chì mini Deli - Màu ngẫu nhiên - E0594",2500,5400,2900,54
TIKI,nha-sach-tiki,181928999,"Yuri Espoir (Tập 1) - Bản Thường Tặng Kèm Postcard",57300,79000,21700,27
TIKI,nha-sach-tiki,74616448,"Lập Kế Hoạch Kinh Doanh Cho Người Mới Bắt Đầu",69020,119000,49980,42
TIKI,nha-sach-tiki,13673968,"Giây Thứ 12 - Tập 2 (Trinh Thám)",68000,145000,77000,53
TIKI,nha-sach-tiki,165038798,"OKRs - Tối Ưu Hóa Hiệu Suất Của Bất Kỳ Đội Nhóm Nào",110000,169000,59000,35
TIKI,nha-sach-tiki,195479322,"Tàn Tro",79400,108000,28600,26
TIKI,nha-sach-tiki,21031780,"Pháo Đài Số ( Tái Bản )",128500,199000,70500,35
TIKI,nha-sach-tiki,1029908,"Tuần Của Bé - Bé Công Bằng (Dành Cho Trẻ 3 - 6 Tuổi)",17000,23000,6000,26
TIKI,nha-sach-tiki,40433264,"Combo Bí Ẩn Mãi Mãi Là Bí Ẩn( Trọn bộ 6 cuốn)( tặng kèm sổ Tay Xương Rồng)",261000,290000,29000,10
TIKI,nha-sach-tiki,109654814,"Bút bi gel 0.5mm nhiều màu Deli - Có nắp gài - 1 chiếc - Đỏ/ Xanh Dương/ Xanh Lá/ Tím/ Cam - A119",5000,10800,5800,54
TIKI,nha-sach-tiki,170708219,"Đừng Bao Giờ Chia Đôi Lợi Ích Trong Mọi Cuộc Đàm Phán",103820,179000,75180,42
TIKI,nha-sach-tiki,17530147,"Series Địch Công Kỳ Án Tập 14 - Hầu Tử Và Lão Hổ ( Tái Bản )",44000,88000,44000,50
TIKI,nha-sach-tiki,155351487,"IELTS 16 ACADEMIC",195000,195000,0,0
TIKI,nha-sach-tiki,195969658,"Tiệm Sách Cũ Biblia - Ngoại Truyện 2 - Tobirako Và Thời Gian Bỏ Ngỏ",51000,95000,44000,46
TIKI,nha-sach-tiki,107492789,"Keo dán x2000 siêu dính, keo dán đa năng dán tất cả vật liệu bằng gỗ, thủy tinh, dán nhựa an toàn với da tay (Dạng nước)",21996,21996,0,0
TIKI,nha-sach-tiki,8011021,"Tâm Lý Học Thành Công (Tái Bản)",149000,199000,50000,25
TIKI,nha-sach-tiki,111537682,"Bách Khoa Cho Trẻ Em - Bách Khoa Động Vật (Tái Bản)",131000,180000,49000,27
TIKI,nha-sach-tiki,46240920,"Kỹ Năng Quản Lý Tài Chính Cá Nhân Trong 30 Ngày",82800,119000,36200,30
TIKI,nha-sach-tiki,77403145,"The Story Of Food - Câu Chuyện Thực Phẩm",483000,486000,3000,1
TIKI,nha-sach-tiki,58462050,"Sách Người Trong Muôn Nghề: Ngành IT có gì?",155000,169000,14000,8
TIKI,nha-sach-tiki,73684906,"Marketing Phải Bán Được Hàng",110000,159000,49000,31
TIKI,nha-sach-tiki,109982979,"Isaac Newton - Nhà Khoa Học Vĩ Đại",28000,40000,12000,30
TIKI,nha-sach-tiki,34708988,"Bộ 10 Bút Gel Điểm 10 xóa được TP-GELE01",95000,120000,25000,21
TIKI,nha-sach-tiki,150711999,"Michelle Obama - Chất Michelle (Bìa Cứng) (Tái Bản)",372000,520000,148000,28
TIKI,nha-sach-tiki,83162438,"Combo Kinh Tế Vi Mô và Câu Hỏi - Bài Tập - Trắc Nghiệm Kinh Tế Vi Mô",171000,180000,9000,5
TIKI,nha-sach-tiki,168181452,"Thiên Sứ Nhà Bên - Tập 2",83600,95000,11400,12
TIKI,nha-sach-tiki,175833959,"Combo 5-10-20 Bút Bi Bấm Deli EQ24 Ngòi 0.7mm - Mực Xanh/Đen/Đỏ - Bút bi dầu phù hợp học sinh văn phòng",8500,17100,8600,50
TIKI,nha-sach-tiki,170434495,"Hộp Quà Bí Mật Dành Tặng Bé Yêu",19000,19000,0,0
TIKI,nha-sach-tiki,193684715,"Ngoan Cường Vượt Định Kiến",56100,79000,22900,29
TIKI,nha-sach-tiki,332626,"Oxford Learner's Pocket Dictionary : A Pocket-sized Reference to English Vocabulary (Fourth Edition)",76260,85000,8740,10
TIKI,nha-sach-tiki,197629358,"Chúng Ta Có Hẹn Với Bình Yên",71000,89000,18000,20
TIKI,nha-sach-tiki,101297001,"Tâm Lý Hành Vi Trong Đầu Tư Chứng Khoán",110700,159000,48300,30
TIKI,nha-sach-tiki,148761075,"Combo 6 Cuốn: "Hít Hà Mùi Đất Nước"",207000,240000,33000,14
TIKI,nha-sach-tiki,135552451,"Các Triều Đại Việt Nam",78000,120000,42000,35
TIKI,nha-sach-tiki,189598539,"Bài tập bổ trợ Tiếng Anh 10",118000,118000,0,0
TIKI,nha-sach-tiki,259537049,"Hộp 10 Bút Lông Bảng Thiên Long WB-03",73000,93000,20000,22
TIKI,nha-sach-tiki,191148968,"Bút Hết Nặng Viết Hết Đau",185000,239000,54000,23
TIKI,nha-sach-tiki,76305752,"Combo Bộ 2 Cuốn: Giết Chỉ Huy Đội Kỵ Sĩ (Tập 1: Ý Tưởng Xuất Hiện + Tập 2: Ẩn Dụ Dịch Chuyển)",326000,410000,84000,20
TIKI,nha-sach-tiki,169603497,"Macmillan Dictionary Vietnam ED with App – Soft cover",399000,399000,0,0
TIKI,nha-sach-tiki,46107068,"Thế Giới Ảo, Thương Hiệu Thật",86420,149000,62580,42
TIKI,nha-sach-tiki,193988316,"Siêu Tâm Trí – Học Cách Suy Nghĩ Như Sherlock Holmes",98100,145000,46900,32
TIKI,nha-sach-tiki,150682463,"Linh Ứng - Hành Trình Của Kẻ Siêu Vô Thần Đến Thế Giới Tâm Linh",187000,268000,81000,30
TIKI,nha-cua-doi-song,136855573,"Xe Kéo Hàng, Xe Đẩy Hàng Gấp Gọn Nhập Khẩu Chất Lượng Cao XKT04 Mới",559000,559000,0,0
TIKI,nha-sach-tiki,74983567,"Tứ Trấn Huyền Linh",158000,259000,101000,39
TIKI,nha-sach-tiki,176909246,"Bí Quyết Bấm Huyệt Chữa Bệnh",124000,178000,54000,30
TIKI,nha-sach-tiki,68456844,"Bài Tập Tiếng Anh 8 - Tập 1 - Có Đáp Án (Theo Chương Trình Mới Của Bộ GD&ĐT)",37900,48000,10100,21
TIKI,nha-sach-tiki,146936894,"Combo 4 cuốn Sách tự xóa: Chữ cái - Toán - Chữ số - Hình khối & Màu sắc (tặng kèm bút)",79528,152939,73411,48
TIKI,nha-cua-doi-song,72527573,"Hộp Đựng Giấy Vệ Sinh Cao Cấp OENON Dán Tường, Hộp Đựng Giấy Đa Năng Có Thêm Ngăn Để Đồ Tiện Lợi - OENON",149000,280000,131000,47
TIKI,nha-sach-tiki,173092689,"Phát triển trí tuệ (140 câu đố) - Bộ sách Rèn luyện Trí thông minh - Dành cho trẻ 5-6 tuổi",23538,46152,22614,49
TIKI,nha-cua-doi-song,193777239,"Cưa cành cây cưa gỗ gấp gọn bằng thép không gỉ sản xuất tại NHẬT BẢN",25000,50000,25000,50
TIKI,nha-sach-tiki,5974545,"Series Địch Công Kỳ Án Tập 11: Bóng Ma Trong Chùa",53000,110000,57000,52
TIKI,nha-cua-doi-song,25140473,"KỆ LÒ VI SÓNG 3 TẦNG Dài 60cm x Cao 80cm",229000,350000,121000,35
TIKI,nha-sach-tiki,188128043,"Kingdom - Tập 29",44500,45000,500,1
TIKI,nha-cua-doi-song,204207230,"Nhang nụ trầm hương đốt xông nhà tẩy uế HÀ XÁ đồ thờ cúng phong thủy, xua đuổi vận xui, thu hút nguồn năng lượng tích cực, thanh lọc không khí, an toàn cho sức khỏe",99000,198000,99000,50
TIKI,nha-sach-tiki,10581200,"Dế Mèn Phiêu Lưu Ký (Tái Bản)",38000,50000,12000,24
TIKI,nha-sach-tiki,147988196,"Combo 3 Cuốn "Hiểu Hết": How Food Works - Hiểu Hết Về Thức Ăn + How The Body Works - Hiểu Hết Về Cơ Thể + How Psychology Works - Hiểu Hết Về Tâm Lý Học",759000,900000,141000,16
TIKI,nha-sach-tiki,101897983,"Không Tức Giận Bạn Đã Thắng",107000,149000,42000,28
TIKI,nha-sach-tiki,69162885,"Influencer - Phương Pháp 5 Bước Để Trở Thành Người Có Tầm Ảnh Hưởng Nhất Trong Lĩnh Vực Của Bạn",88100,129000,40900,32
TIKI,nha-cua-doi-song,135720334,"Bình pha trà cafe French Press Lock&Lock, 800ml - LLG018",169000,255000,86000,34
TIKI,nha-cua-doi-song,79323009,"Tủ Sách Đa Năng Conven Phong Cách Nordic Thương Hiệu IGA",632000,689000,57000,8
TIKI,nha-cua-doi-song,55580718,"Bộ 3 Nồi Inox 304 Đáy Từ 5 Đáy Nagakawa NAG1352 (16cm, 20cm, 24cm) - Hàng Chính Hãng",1000000,1890000,890000,47
TIKI,nha-cua-doi-song,142441475,"Hộp Sấy Và Khử Khuẩn Đũa Thìa Muỗng Thông Minh,  Có Nắp Đậy Cao Cấp Chống Côn Trùng, Kiến, Dán Tường Chắc Chắn- Hàng Loại 1 Chính Hãng MINIIN",229000,229000,0,0
TIKI,nha-sach-tiki,152517438,"Dữ Liệu Bạch Kim (Văn Học Trinh Thám)",127200,159000,31800,20
TIKI,nha-sach-tiki,191926650,"Trái cây đại chiến Zombie - Thế giới khủng long: Tập 11 - Thợ săn đáy biển",58000,89000,31000,35
TIKI,nha-sach-tiki,166033485,"Sách 14 Nguyên Tắc Tăng Trưởng Thần Tốc Như Amazon",125000,188000,63000,34
TIKI,nha-sach-tiki,164323204,"Semantic Error - Lỗi Logic - Tập 1 - Tặng Kèm Bookmark + 01 Postcard",233100,259000,25900,10
TIKI,nha-sach-tiki,714012,"Truyện Ngụ Ngôn La Fontaine",58800,98000,39200,40
TIKI,nha-cua-doi-song,89144285,"Cốc Dán Tường Nhà Tắm Hình Gấu Nâu Dễ Thương - Cốc Đựng Bàn Chải Đánh Răng - Cốc Hình Gấu",6897,6897,0,0
TIKI,nha-cua-doi-song,103755910,"Ghế tatami, ghế lười bệt tựa lưng nệm - Có 5 cấp độ ngã lưng - Chính hãng TIDO",390000,390000,0,0
TIKI,nha-sach-tiki,87941401,"Lối Tắt Khởi Nghiệp - Con Đường Ngắn Từ Tay Trắng Đến Thành Công Bền Vững",125000,169000,44000,26
TIKI,nha-sach-tiki,193100617,"Anh Hùng Diệt Thần & Bảy Thệ Ước (Tập 2)",134000,149000,15000,10
TIKI,nha-cua-doi-song,57146868,"máy đồng hồ treo tường kim trôi ja-pan",59000,59000,0,0
TIKI,nha-sach-tiki,51660434,"Những Bí Quyết Vàng Đầu Tư Bất Động Sản",89000,89000,0,0
TIKI,nha-cua-doi-song,57911829,"GỐI MỀN 3 trong 1 Trái Cây hình thú cute, thun 4 chiều siêu mịn, bộ chăn gối văn phòng, gấu bông kèm mền GM74-Chuotfruit",158745,158745,0,0
TIKI,nha-sach-tiki,95090180," Bút dấu dòng dạ quang Deli – 6 chiếc/ hộp - S624",52200,52200,0,0
TIKI,nha-cua-doi-song,202840456,"Kệ Lò Vi Sóng Effect Đa Năng - GM02",128000,139000,11000,8
TIKI,nha-cua-doi-song,57755151,"Đèn đường năng lượng mặt trời 300W",760000,760000,0,0
TIKI,nha-cua-doi-song,7159593,"Khóa số chống trộm an toàn Royal",32000,32000,0,0
TIKI,nha-cua-doi-song,165844799,"Giá Kệ Sách Để Sàn 5 Tầng Gỗ Cao Cấp Màu Trắng FIVO Mã FB70 Gỗ MDF Phủ Melamine Chống Thấm Bề Mặt Phù Hợp Với Nhiều Không Gian",749000,1168000,419000,36
TIKI,nha-cua-doi-song,52004331,"Kệ lò nướng - Kệ lò vi sóng - kệ nhà bếp đa năng bằng gỗ thông tự nhiên 4 tầng kích thước 60 x 40 x 110 cm",319000,450000,131000,29
TIKI,nha-cua-doi-song,21268314,"Ổ cắm điện chuyển đổi đa chức năng dùng khi xuất ngoại, đi du lịch,...",35000,35000,0,0
TIKI,nha-cua-doi-song,125604026,"Dây Treo Trang Trí Noel Dài 3m",25000,25000,0,0
TIKI,nha-cua-doi-song,168234677,"[Hàng chính hãng] Ghế chỉnh dáng ngồi đúng - Curble Wider_Premium Model Hàn Quốc (Made in Korea). Phù hợp mọi đối tượng (Free Size)",699840,729000,29160,4
TIKI,nha-cua-doi-song,57046106,"Bình Đựng Nước Lock&Lock Easy Grip Dung Tích 1.5L HAP814",48000,77000,29000,38
TIKI,nha-cua-doi-song,125739804,"BỘ CÂY LAU NHÀ THÔNG MINH SAGOKER, mã BLNEC",146000,159999,13999,9
TIKI,nha-cua-doi-song,69226574,"Combo 10 viên pin CR2032 Maxell Nhật Bản",31700,31700,0,0
TIKI,nha-cua-doi-song,54156958,"Pin Sạc Energizer AAA 700mAh Power Plus",157000,160000,3000,2
TIKI,nha-cua-doi-song,48287902,"KỆ GIÀY DÉP 2 TẦNG GỖ THÔNG- Dài 50cm x Cao 50cm",109000,169000,60000,36
TIKI,nha-sach-tiki,136753126,"Tôi Đã Kiếm 1 Triệu Đô Đầu Tiên Trên Internet Như Thế Nào Và Bạn Cũng Có Thể Làm Như Thế (Tái Bản)",115420,199000,83580,42
TIKI,nha-cua-doi-song,146260986,"Nồi inox kho cá thịt chống dính bếp từ Fivestar ( 18cm / 20cm / 22cm ) nắp kính , 3 đáy , inox 430 , tặng 1 vá canh",199000,199000,0,0
TIKI,nha-sach-tiki,42180465,"Đừng Chỉ Đẹp Mà Không Hiểu Chuyện",61800,89000,27200,31
TIKI,nha-cua-doi-song,117125057,"Ổ Cắm Điện LiOA Phổ Thông - Ổ Cắm Điện 3 lỗ - 4 lỗ - 5 lỗ - 6 lỗ - dài 3m - MITA",65000,65000,0,0
TIKI,nha-cua-doi-song,158462914,"Cây Lau Kính, Gạt Chùi Kính Đa Năng 2 Đầu Trong 1 MyJae Cán Dài Uốn Xoay Thông Minh Chống Trơn Trượt",239000,390000,151000,39
TIKI,nha-cua-doi-song,1918931,"Keo Dán Đa Năng Selleys Epoxy Fix (10ml / Tuýp)",37050,39000,1950,5
TIKI,nha-cua-doi-song,87831027,"ĐÈN NĂNG LƯỢNG MẶT TRỜI 100W - 180W - 80W - 60W - 45W  SOLAR LIGHT - ĐIỀU KHIỂN TỪ XA - PIN SẠC TRỌN DỜI - D1147",290000,290000,0,0
TIKI,nha-cua-doi-song,578902,"Chảo Đáy Từ Chống Dính Sunhouse SHM26 26cm",207000,300000,93000,31
TIKI,nha-cua-doi-song,48622915,"Bộ Đầu Vòi Xịt Vệ Sinh (Toilet), Vệ Sinh Bồn Cầu + Giá Đỡ - Thiết kế Thông Minh Nhỏ Gọn Tiện Ích",55000,69000,14000,20
TIKI,nha-sach-tiki,187190670,"Black Jack - Tập 11 (Bìa Cứng)",126000,135000,9000,7
TIKI,nha-cua-doi-song,117560257,"CHẢO CHỐNG DÍNH SÂU LÒNG SIÊU TIỆN LỢI",33999,33999,0,0
TIKI,nha-sach-tiki,184781428,"Nuôi Con Bằng Yêu Thương Dạy Con Bằng Lý Trí (Tái bản) - Tặng Kèm Bookmark",85000,114000,29000,25
TIKI,nha-sach-tiki,99681443,"Khoa Học - Khái Lược Những Tư Tưởng Lớn ",327000,450000,123000,27
TIKI,nha-cua-doi-song,172143534,"Kệ Gỗ Để Đồ Đa Năng Có Bánh Xe Di Chuyển Dễ Dàng - GP190",216000,235000,19000,8
TIKI,nha-cua-doi-song,21482254,"Bàn gấp chân sắt 1m2 BVP23Đ",396900,490000,93100,19
TIKI,nha-sach-tiki,194130753,"Bong bóng số 0-9 nhiều màu 35cm trang trí tiệc xinh",18000,18000,0,0
TIKI,nha-cua-doi-song,196051243,"Búa Lùn Nguyên Khối Deli Chính Hãng - Đóng Đinh, Nhổ Đinh Dễ Dàng, Tiện Dụng - Nhỏ Gọn, Tay Cầm Bọc Cao Su - DL441008",62000,106000,44000,42
TIKI,nha-cua-doi-song,156222332,"SEN TẮM CÂY NÓNG LẠNH NHẬP KHẨU NGA FULLBOX F2428 - HÀNG CHÍNH HÃNG - SIÊU BỀN BỈ",2491000,4700000,2209000,47
TIKI,nha-cua-doi-song,75330721,"Then Chốt Cài Cửa, Chốt Khóa Bằng Thép Không Gỉ KUNBE An Toàn Tiện Lợi Nhiều Kích Thước",22900,22900,0,0
TIKI,nha-cua-doi-song,24482769,"Dây xịt vệ sinh inox 304 dài 120cm",54000,60000,6000,10
TIKI,do-choi-me-be,25096869,"Bột Tẩy Quần Áo Thiên Nhiên Mao Bao chứa Baking Soda (12g x 2 gói)",22000,32000,10000,31
TIKI,do-choi-me-be,453774,"Kem Dưỡng Da Chứa Sữa Và Gạo Johnson’s Baby 20309343 (50g)",66000,66000,0,0
TIKI,do-choi-me-be,92496752,"Combo tẩy cặn canxi nhà tắm HGO Plus + tẩy dầu mỡ nhà bếp HGO bình xịt 500ml, sử dụng tiện lợi hiệu quả tiết kiệm",179000,265000,86000,32
TIKI,do-choi-me-be,249054309,"Sữa Ensure Vanila Úc cho người già, người suy dinh dưỡng, cấp đầy đủ dinh dưỡng giúp hồi phục sức khỏe - Massel Official (850g/lon)",1039000,2078000,1039000,50
TIKI,do-choi-me-be,75435459,"Tã Quần Caryn Loại Mỏng Nhẹ M32",315000,350400,35400,10
TIKI,do-choi-me-be,47961612,"Combo 2 Que Thử Thai QuickStick",40000,40000,0,0
TIKI,do-choi-me-be,576239,"Nước Tẩy Đa Năng Kháng Khuẩn Mao Bao 600ml",43000,50000,7000,14
TIKI,do-choi-me-be,124722427,"Xịt đuổi chuột  200ml Thái Lan",48500,48500,0,0
TIKI,do-choi-me-be,1744989,"Tã Quần Mỏng Nhẹ Caryn Gói Siêu Lớn L14 (14 Miếng)",180000,181600,1600,1
TIKI,do-choi-me-be,68088749,"Combo 2 Túi Nước Giặt Xả Maxkleen Hương Hoa Nắng (3.8kg/túi)",369000,420000,51000,12
TIKI,do-choi-me-be,543122,"Nước Giặt Quần Áo Em Bé D-nee Hương Lavender 3L - [8851989061535]",203000,245000,42000,17
TIKI,do-choi-me-be,34402891,"Viên Thả Làm Sạch Bồn Cầu (1 Gói 10 Viên)",8000,10869,2869,26
TIKI,do-choi-me-be,135325550,"Combo 2 Nước Tẩy Bồn Cầu Vim 880ml Diệt 99,9% Vi Khuẩn",67100,76000,8900,12
TIKI,do-choi-me-be,68268748,"Viên sắt, acid folic, DHA, vitamin & khoáng chất Fe-NANA - Hộp 20 viên",84000,110000,26000,24
TIKI,do-choi-me-be,133040504,"Combo 3 viên giặt xả MaxKleen hương ngày thư thái (34 viên/túi)",374000,420000,46000,11
TIKI,do-choi-me-be,52293405,"Khăn Giấy Rút See-U, 2 Lớp 250 Tờ/gói",27000,27000,0,0
TIKI,do-choi-me-be,75435457,"Tã Quần Caryn Loại Mỏng Nhẹ L28",315000,391200,76200,19
TIKI,do-choi-me-be,182709739,"Combo 2 Sữa tắm gội dịu lành cho bé Cetaphil Baby Gentle Wash & Shampoo 400ml/chai",490000,490000,0,0
TIKI,do-choi-me-be,1744997,"Tã Dán Siêu Thấm Caryn Gói Siêu Lớn M20 (20 Miếng)",180000,201800,21800,11
TIKI,do-choi-me-be,17888580,"Cờ Vua Cao Cấp miDoctor (Chính Hãng) - NHỎ 3810A:  25 x 25 x 2 cm - Hàng chính hãng",92000,92000,0,0
TIKI,do-choi-me-be,77858363,"Nước Súc Miệng Listerine Kids dành riêng cho trẻ trên 6 tuổi 250ml - ",49000,55000,6000,11
TIKI,do-choi-me-be,135328955,"Sữa Bột Nestlé NAN SupremePro 1 lon 400g với 5HMO & đạm Gentle Optipro nhập khẩu nguyên lon từ Đức",299000,299000,0,0
TIKI,do-choi-me-be,106307519,"1 VIÊN TẨY BỒN CẦU",2299,2299,0,0
TIKI,do-choi-me-be,95269446,"Tã Dán Siêu Cao Cấp Huggies Platinum Naturemade L54 (54 Miếng)",329000,460000,131000,28
TIKI,do-choi-me-be,168662602,"Sữa bột NAN INFINIPRO A2 Thụy Sĩ 3 800g với đạm quý A2 tiêu hóa tốt sau 7 ngày và 5HMO tăng cường đề kháng (2 - 6 tuổi)",559000,600000,41000,7
TIKI,do-choi-me-be,61292593,"Combo 4 Gói Khăn Ướt Yuniku 90 Tờ Hương Lài ( 90 tờ x 4 )",99000,167200,68200,41
TIKI,do-choi-me-be,53135547,"Lọ Tẩy Vệ Sinh Bồn Cầu Nhật Bản SPEVI - Khử Mùi Nhà Vệ Sinh, Diệt Sạch 99,9% Vi Khuẩn Thiết Kế Thông Minh Giúp Dễ Dàng Sử Dụng, Lọ Thả Bồn Cầu Hiệu Quả Rất Nhiều So Với Viên Thả Bồn Câ·",19000,19000,0,0
TIKI,do-choi-me-be,142115663,"Tranh Cát Cho Bé Tập Làm Họa Sỹ",5000,5000,0,0
TIKI,do-choi-me-be,88949156,"Sữa Bột Friso Gold 4 850g (Dành Cho Trẻ Từ 2 - 6 Tuổi)",495000,600000,105000,18
TIKI,do-choi-me-be,730944,"Sữa Tắm Gội Trẻ Em Lactacyd Milky BẢO VỆ, NUÔI DƯỠNG DA và TÓC BÉ VƯỢT TRỘI 500ml",183000,183000,0,0
TIKI,do-choi-me-be,274034133,"Bộ Bài Drink Game Say sưa 84 lá đầy đủ thử thách vui nhộn",90000,165000,75000,45
TIKI,do-choi-me-be,25027164,"Combo 2 Gói Tã Quần Người Lớn Sunmate Khô Thoáng L7 (7 Miếng/ Gói)",151000,199999,48999,24
TIKI,do-choi-me-be,7827140,"Chất thông tắc bồn cầu toilet chống hôi Siêu tốc 5 phút Sifa (1400g)",53000,53000,0,0
TIKI,do-choi-me-be,35043549,"Thùng 48 Hộp Sữa Nước Abbott Similac 180ml cho trẻ từ 1 tuổi",875000,1003200,128200,13
TIKI,do-choi-me-be,82525136,"Combo 3 lon Sữa Morinaga số 2 Chilmil 850g và 1 lon sữa Morinaga số 2 320gr dành cho bé từ 6-36 tháng tuổi",1450000,1734000,284000,16
TIKI,do-choi-me-be,76099465,"Chế phẩm diệt kiến gián sinh học Anbio - lọ 10ml",16800,16800,0,0
TIKI,do-choi-me-be,48964146,"Set 2 Khăn Tắm Em Bé Sợi Tre Bonny Siêu Mềm Và Thấm Hút (KT: 1m2x1m2) - Giao họa tiết ngẫu nhiên",190000,190000,0,0
TIKI,do-choi-me-be,145677986,"Bộ cờ vua tiêu chuẩn thi đấu, quân cờ nhựa đặc ruột cao cấp (tặng thêm 2 Hậu thuận tiện phong cấp)",250000,250000,0,0
TIKI,do-choi-me-be,175953079,"Combo 4 Gói Tã Quần Người Lớn SunMate Khô Thoáng",299000,399997,100997,25
TIKI,do-choi-me-be,146556777,"Cờ Vua Gỗ - Cờ Vua Cao Cấp - Đồ Chơi Bằng Gỗ Tự Nhiên - Chính hãng dododios",138000,138000,0,0
TIKI,nha-sach-tiki,49716241,"Tử Vi Hàm Số (Bìa Cứng)",121000,180000,59000,33
TIKI,nha-sach-tiki,178240555,"Tần Số Của Chúng Ta",178000,179000,1000,1
TIKI,nha-sach-tiki,1667307,"Quân Vương – Thuật Cai Trị (Tái Bản)",69000,109000,40000,37
TIKI,nha-sach-tiki,195305999,"Giải mã truyện Tây Du",80000,119000,39000,33
TIKI,nha-sach-tiki,171137376,"SUY TƯỞNG – MARCUS AURELIUS ANTONINUS – TỦ SÁCH TINH HOA -",155000,155000,0,0
TIKI,nha-sach-tiki,196373994,"Sổ Tay Ghi Chép Bìa Da A5 300 Trang Kẻ Ngang Deli - Phù Hợp Làm Sổ Kế Hoạch Planner, Nhật Kí, Tập Vở Ghi Chép Bullet Journal - EN012 / EN013",106200,106200,0,0
TIKI,nha-sach-tiki,42975887,"Nuốt Cá Lớn - Eating The Big Fish",299000,299000,0,0
TIKI,nha-sach-tiki,145092202,"Túi giấy kraft Nhật trơn có quai đựng thực phẩm nhiều kích thước, túi giấy xi măng đựng quà",1675,1675,0,0
TIKI,nha-sach-tiki,26135056,"Bộ 2 cuốn sách về kinh tế hay nhất : Dạy Con Làm Giàu (Tập 1) - Để Không Có Tiền Vẫn Tạo Ra Tiền + Dạy Con Làm Giàu (Tập 2) - Sử Dụng Đồng Vốn (Tặng kèm Bookmark thiết kế AHA)",191500,191500,0,0
TIKI,nha-sach-tiki,197587848,"Mỗi Ngày Gửi Cậu Một Cái Ôm",103000,129000,26000,20
TIKI,nha-sach-tiki,59362973,"Osho Phụ Nữ - The Book Of Women",78000,109000,31000,28
TIKI,nha-sach-tiki,105614549,"Khay pha màu 10/14 ngăn Deli - 1 chiếc - 9402 / 9403",10000,10000,0,0
TIKI,nha-sach-tiki,273636756,"Trạm Đọc Official | Hackers Toeic Vocabulary",209250,279000,69750,25
TIKI,nha-sach-tiki,176824198,"How To Draw – Vẽ Nguệch Ngoạc Cả Thế Giới",103000,139000,36000,26
TIKI,nha-sach-tiki,58864689,"Giải Mã Siêu Trí Nhớ",139000,139000,0,0
TIKI,nha-sach-tiki,598975,"Dạy Con Làm Giàu 10 - Trước Khi Bạn Thôi Việc",78300,90000,11700,13
TIKI,nha-sach-tiki,129765498,"Văn Học Kinh Điển - Những Người Phụ Nữ Bé Nhỏ (tặng 2 postcard Tranh Màu + 1 bookmark)",190000,380000,190000,50
TIKI,nha-sach-tiki,31515106,"Đàn Kiến Chăm Chỉ - Ngụ Ngôn Song Ngữ (Tái Bản 2019)",19200,32000,12800,40
TIKI,nha-sach-tiki,152522279,"Phúc Cho Ai Không Thấy Mà Tin - Những Câu Chuyện Nhiệm Mầu Về Hồng Ân Thiên Chúa",61100,88000,26900,31
TIKI,nha-sach-tiki,42877486,"Văn Học Kinh Điển Thế Giới - Peter Pan (Tái Bản)",57000,88000,31000,35
TIKI,nha-sach-tiki,187933180,"OKR - Phương Pháp Thiết Lập Mục Tiêu Và Quản Lý Công Việc Vượt Trội (Tái Bản 2022)",89800,129000,39200,30
TIKI,nha-sach-tiki,134846272,"Education - Kinh Doanh Giáo Dục Tại Thị Trường Việt Nam",163000,220000,57000,0
TIKI,nha-sach-tiki,184075082,"Học Đàn Piano",90000,125000,35000,28
TIKI,nha-sach-tiki,173135243,"Vòng Đời (Life Cycles)",233000,350000,117000,33
TIKI,nha-sach-tiki,10971007,"EQ - Trí Thông Minh Xúc Cảm Trong Công Việc",111300,159000,47700,30
TIKI,nha-sach-tiki,192048655,"Tớ đã từng sợ hãi",58000,75000,17000,23
TIKI,nha-sach-tiki,196157730,"[QUÀ TẶNG ĐỘC QUYỀN] Combo 10 bông tẩm cồn sát trùng Alcohol Pads - Nhỏ gọn, rất tiện khi sử dụng.",25000,25000,0,0
TIKI,nha-sach-tiki,163553056,"Thần Chết Làm Thêm 300 Yên/Giờ (Tái Bản)",77200,105000,27800,26
TIKI,nha-sach-tiki,182548599,"Dragon Quest - Dấu Ấn Roto (Dragon Quest Saga Emblem Of Roto) Perfect Edition Tập 6 - Tặng Kèm Bookmark PVC",68000,75000,7000,9
TIKI,nha-sach-tiki,72744539,"IELTS 15 ACADEMIC",142000,142000,0,0
TIKI,nha-sach-tiki,51215567,"Đồng Tiền Hạnh Phúc",62000,95000,33000,35
TIKI,nha-sach-tiki,181131167,"Boxset Nhà Trọ Của Những Điều Đã Mất (3 Cuốn)",89000,90000,1000,1
TIKI,nha-sach-tiki,7440075,"Lâu Đài Trên Mây",71500,96000,24500,26
TIKI,nha-sach-tiki,171549996,"Never Get Bored - Tí Ta Tí Toáy",120000,155000,35000,23
TIKI,nha-sach-tiki,106770825,"Bộ 10 bìa bao tập Thiên Long Điểm 10 TP-NBC01",15000,15000,0,0
TIKI,nha-sach-tiki,160371977,"Ăn Tối Cùng Chef Và Nói Chuyện Bếp",98000,170000,72000,42
TIKI,nha-sach-tiki,178514167,"Tìm Lại Màu Xanh (Phần Tiếp Theo Của Người Truyền Ký Ức)",84000,108000,24000,22
TIKI,nha-sach-tiki,197353392,"Holmes Ở Kyoto - Tập 6",52000,85000,33000,39
TIKI,nha-sach-tiki,190705657,"Nuôi Dạy Con Theo Phương Pháp Montessori: Em Bé Sơ Sinh Từ 0-1 Tuổi",153000,220000,67000,30
TIKI,nha-sach-tiki,134605012,"15 Nguyên Tắc Vàng Về Phát Triển Bản Thân (Tái Bản)",103820,179000,75180,42
TIKI,nha-cua-doi-song,103118895,"Đèn pha led năng lượng mặt trời 300w 200w 100w 60w báo dung lượng pin pha nhôm chống nước IP67 có giấy bảo hành 2 năm",434000,434000,0,0
TIKI,nha-cua-doi-song,164771128,"Roi mây dẻo dai siêu thần thánh",22500,30000,7500,25
TIKI,nha-cua-doi-song,85763912,"Ghế đôn hộp, ghế ngồi kiêm hộp đựng đồ 2 IN 1. Ghế ngồi đa năng mẫu mới",149000,149000,0,0
TIKI,nha-cua-doi-song,72707434,"BỘ KÍCH THÉP DI CHUYỂN ĐỒ NẶNG 500KG 12 BÁNH PU XOAY 360° GOODTOOL35",275000,275000,0,0
TIKI,nha-cua-doi-song,132276408,"Ron pvc chặn khe hở - Thanh cao su dán chân cửa chắn khe hở, chống côn trùng, cách âm, phù hợp mọi loại cửa RPVC",35000,35000,0,0
TIKI,nha-cua-doi-song,53830664,"Mùng ngủ không cửa giăng dây 4 góc truyền thống - Vải tuyn dày lỗ nhỏ chống muỗi tuyệt đối",155000,155000,0,0
TIKI,nha-cua-doi-song,112072065,"Túi Đựng Hộp Cơm Giữ Nhiệt - Túi Trữ Lạnh Cao Cấp Chống Thấm Nước – Túi Giữ Nhiệt Hàng Chính Hãng",36000,70000,34000,49
TIKI,nha-cua-doi-song,14257715,"Dụng Cụ Lấy Dấu, Định Vị Điểm Khoan - Chống Trượt",27999,27999,0,0
TIKI,nha-cua-doi-song,119446046,"Bát Tô Canh Sứ Trắng Đủ Size - Tô khum Sứ Long Phương - 6 inch",38400,38400,0,0
TIKI,nha-cua-doi-song,95333782,"Đế lót chậu cây có bánh xe MONROVIA, đế để chậu cây, kệ chậu cây do động, có bánh xe, mặt tròn hoặc vuông bằng gỗ tràm cao cấp loại 1, trên 10 năm tuổi, màu vàng đường kinh 30 cm, chính hãng thương hiệu MONROVIA",85000,85000,0,0
TIKI,nha-cua-doi-song,74329992,"Hộp Đựng Trang Sức Nữ Trang Cỡ Lớn Da Cao Cấp",150000,150000,0,0
TIKI,nha-cua-doi-song,76514380,"Ổ Cắm Điện Đa Năng Chống Giật Có 3 Cổng USB – Sạc Trực Tiếp – Tiết Kiệm Điện – Bộ Ổ Cắm Điện Xanh Lá Cao Cấp Chính Hãng Amalife - DE30",55000,55000,0,0
TIKI,nha-cua-doi-song,54075243,"Gối cao su non chống ngáy người lớn chất lượng êm ái cho giấc ngủ sâu hơn, gối cao su non, gối chống mỏi cổ, gối chống mỏi gáy (màu ngẫu nhiên)",49000,58997,9997,17
TIKI,nha-cua-doi-song,171174862,"Vỏ Thay Thế Cho Gối Nooz Mềm Mịn Kháng Khuẩn Và Không Gây Kích Ứng Da",150000,150000,0,0
TIKI,nha-cua-doi-song,185380278,"Bình Xịt Nhật Bản - TAIKOMI Japan Chống Thấm Vết Nứt Mái Nhà, Sàn Nhà Vệ Sinh, Máng Xối, Mái Tôn, Sàn Nhà",99185,135000,35815,27
TIKI,nha-cua-doi-song,117212183,"Ổ Cắm Nối Chia 3 Lioa, Phích Cắm 1 ra 3 Lioa - MITA",22000,22000,0,0
TIKI,nha-cua-doi-song,53116344,"Súng bắn keo nến silicon + Tặng 10 cây keo silicon nến",38000,79000,41000,52
TIKI,nha-cua-doi-song,70002562,"BÁO ĐỘNG CHỐNG TRỘM HỒNG NGOẠI HT1A-S 3 NÚT, 180-220V AC - 50Hz.",190000,190000,0,0
TIKI,nha-cua-doi-song,50098102,"Tủ Vải Quần Áo 3 Buồng 8 Ngăn To, Bền - Hàng Chính Hãng",385000,550000,165000,30
TIKI,nha-cua-doi-song,142989680,"Màn chụp tự bung đỉnh vuông Bảo An - Mẫu mùng chụp tự bung có viền chân chống muỗi tuyệt đối",203697,203697,0,0
TIKI,nha-cua-doi-song,143779168,"Thảm ngủ cá nhân văn phòng",25000,25000,0,0
TIKI,nha-cua-doi-song,152446542,"Cây Cau Tiểu Trâm - cây cảnh để bàn",33000,46000,13000,28
TIKI,nha-cua-doi-song,135442231,"Máy Khoan Deli Chính Hãng Pin 12V Bắt Vít - Nhỏ Gọn, Tiện Dụng - Dùng Cho Sửa Chữa Vật Dụng - DL600012",551000,1006200,455200,45
TIKI,nha-cua-doi-song,189373783,"Máy Rửa Xe Mini Deli Công Suất Lớn - Tiết Kiệm Điện Năng, Phun Rửa Đa Năng - DL882201",1349000,2399000,1050000,44
TIKI,nha-cua-doi-song,59273521,"Combo 02 Khăn tắm, khăn mặt FUNU, mềm mịn, siêu thấm, kháng khuẩn - Hàng chính hãng, hàng nhiều mẫu design, giao mẫu ngẫu nhiên",92000,100000,8000,8
TIKI,nha-cua-doi-song,138814386,"Set 10 móc phơi quần áo inox dày bọc nhựa cao cấp",25000,25000,0,0
TIKI,nha-cua-doi-song,120470467,"Bộ 6 Ly Cao Thuỷ Tinh Luminarc Louvre 350ml - LULON1807 ",289000,289000,0,0
TIKI,nha-cua-doi-song,161024967,"Combo 2 hộp chia ngăn sắp xếp quần áo phong cách Nhật Bản Mai Anh House",210000,210000,0,0
TIKI,nha-cua-doi-song,57894229,"Kệ đựng để đồ đa năng có bánh xe 3 tầng (giao màu ngẫu nhiên)",80000,80000,0,0
TIKI,nha-cua-doi-song,62292300,"Bộ vòi sen tắm lạnh – tay sen tăng áp  (Hàng chính hãng)",209000,350000,141000,40
TIKI,nha-cua-doi-song,96180139,"Chân đàn Organ/ Piano đa năng - Kzm Kurtzman STX1 - Dáng chữ X đơn - Màu đen - Hàng chính hãng",140000,140000,0,0
TIKI,nha-cua-doi-song,4777363,"Bàn làm việc gấp gọn có khe cắm ipad - giao màu ngẫu nhiên",71000,71000,0,0
TIKI,nha-cua-doi-song,51044868,"Vòi sen tăng áp, bát sen tắm inox 304 KAMA PK03, vòi nước tăng áp, bát sen tăng áp inox 304, bề mặt inox 304 nguyên bản, không rỉ sét, vòi sen tắm tăng áp lực nước",180000,180000,0,0
TIKI,nha-cua-doi-song,125667836,"Bộ Cờ Lê 14 Chi Tiết",235000,235000,0,0
TIKI,nha-cua-doi-song,67910007,"Vỉ 20 nẹp cố định dây điện dán tường, bàn ghế",12999,12999,0,0
TIKI,nha-cua-doi-song,696349,"Ổ Cắm Điện 4 Lỗ 3 Chấu 3m Philips SPN1248WB/74 (2500W)",280000,299000,19000,6
TIKI,nha-cua-doi-song,19560656,"Bộ 4 Chiếc Kẹp Ga Giường",49000,49000,0,0
TIKI,nha-cua-doi-song,165029589,"VỢT BẮT MUỖI CAO CẤP 2 IN 1 DP - 834",99000,99000,0,0
TIKI,nha-cua-doi-song,51368456,"Bộ 6 thìa Inox 304 pha nước (số 12)",174000,210000,36000,17
TIKI,nha-cua-doi-song,54348370,"Kệ di động Inochi hàng cao cấp",140000,150000,10000,7
TIKI,dien-thoai-may-tinh-bang,214603586,"Điện Thoại Samsung Galaxy A04e (3GB/32GB)- Hàng Chính Hãng",1998000,2690000,692000,26
TIKI,dien-thoai-may-tinh-bang,272850971,"Điện thoại Libero 5G III - 4/64GB Dimensity 700 ,Màn OLED ,Kháng nước IP57 - Hàng nhập khẩu nhật",2244000,2990000,746000,25
TIKI,dien-thoai-may-tinh-bang,171685825,"Điện thoại Nokia 105 4G -  chính hãng - Đen",690000,690000,0,0
TIKI,dien-thoai-may-tinh-bang,273650151,"Điện thoại siêu bền Ulefone Power Armor X11(chống nước,chống va đập , Ram8 GB(4gb+4gb),Rom 32 GB, NFC, Helio G25, WiFi 2.4G/5G, Pin 8150 Mah,)-hàng chính hãng",3290000,3290000,0,0
TIKI,dien-thoai-may-tinh-bang,212926651,"Điện Thoại Samsung Galaxy S20 FE 8GB/256GB - Hàng Chính Hãng - Đã Kích Hoạt Bảo Hành Điện Tử",8625000,8625000,0,0
TIKI,dien-thoai-may-tinh-bang,271329051,"Máy tính bảng Kindle Fire MAX 11, màn hình 11 inch, RAM 4GB, CPU Octa-core 2.2Ghz, bộ nhớ 64/128GB - Hàng chính hãng",5300000,5500000,200000,4
TIKI,dien-thoai-may-tinh-bang,270714226,"Điện Thoại Itel S23 4GB/128GB | Pin 5000mAh | 6.6 Inch | Camera 50MP | HÀNG CHÍNH HÃNG",2290000,2590000,300000,12
TIKI,dien-thoai-may-tinh-bang,225912504,"Điện Thoại Forme D111 - Hàng Chính Hãng",499000,519000,20000,4
TIKI,dien-thoai-may-tinh-bang,217505504,"Máy tính bảng Kindle Fire HD8 PLUS 2022 (Fire HD 8 12th) - Màn hình 8inch HD, RAM 3GB, CPU Hexa-core 2.0 GHz, CÀI ĐƯỢC CH PLAY- Hàng nhập khẩu",2483100,2790000,306900,11
TIKI,dien-thoai-may-tinh-bang,249730342,"Điện Thoại Masstel Fami 12 4G LTE - 2 Sim- Pin 1400 mAh - Đọc số bằng giọng nói - Hàng Chính Hãng - Bảo Hành 12 Tháng",630000,630000,0,0
TIKI,dien-thoai-may-tinh-bang,217505430,"Máy tính bảng Kindle Fire HD8 2022 (Fire HD 8 12th) - Màn hình 8inch HD, RAM 2GB, CPU Hexa-core 2.0 GHz, CÀI ĐƯỢC CH PLAY- Hàng nhập khẩu",2050000,2050000,0,0
TIKI,dien-thoai-may-tinh-bang,247925719,"Điện thoại Samsung Galaxy A14  (4GB/128GB) - Hàng Chính Hãng - Đã kích hoạt bảo hành điện tử",3672000,3672000,0,0
TIKI,dien-thoai-may-tinh-bang,271954384,"Điện thoại OPPO A58 6GB/128GB , Sạc nhanh 33W - Hàng Chính Hãng",4311000,4990000,679000,14
TIKI,dien-thoai-may-tinh-bang,274524050,"Điện thoại Masstel izi T2 4G(LTE), Màn hình 2.4 inch, Đèn pin siêu sáng, Loa to - Hàng chính hãng",489000,550000,61000,11
TIKI,dien-thoai-may-tinh-bang,249730334,"Điện Thoại Masstel Izi 20 4G LTE - 2 sim -Pin 1700 mAh - Loa To - Camera 0.08 MP - Hàng Chính Hãng - Bảo Hành 12 Tháng",512000,512000,0,0
TIKI,dien-thoai-may-tinh-bang,271284934,"Máy tính bảng Edutab 10.4 & Case da tặng Quà hot Hệ thống quản lý học tập & kiểm soát dành cho Phụ huynh trọn đời - Hàng Chính Hãng",5769000,5769000,0,0
TIKI,dien-thoai-may-tinh-bang,274415640,"Điện Thoại Xiaomi Redmi Note 13 Pro 8GB/128GB - Hàng Chính Hãng",6329000,7290000,961000,13
TIKI,dien-thoai-may-tinh-bang,170449059,"Điện Thoại Masstel Izi 20 4G - Loa To, Pin Trâu, 2 Sim 2 Sóng, Hỗ Trợ 4G VoLTE, Đèn Pin Sáng, Giá Rẻ - Hàng Chính Hãng",482000,489000,7000,1
TIKI,dien-thoai-may-tinh-bang,272323566,"Điện Thoại Samsung M34 5G 8GB/128GB - Hàng Chính Hãng",6179000,7990000,1811000,23
TIKI,dien-thoai-may-tinh-bang,248005118,"Điện Thoại Samsung Galaxy A34 5G (8GB/128GB) - Hàng Chính Hãng",7164000,7164000,0,0
TIKI,dien-thoai-may-tinh-bang,261964853,"Điện thoại ulefone note 16 pro (Ram 16Gb(8+8),rom 128Gb,android 13 , camera 50MP,pin 4.400mAhm, Mở khóa vân tay, Mở khóa bằng khuôn mặt )-hàng chính hãng",5990000,5990000,0,0
TIKI,dien-thoai-may-tinh-bang,274638822,"Điện thoại Xiaomi Redmi Note 12 Turbo , Snapdragon 7 Gen 2 , Màn OLED 120Hz , Sạc nhanh 67W , Rom tiếng việt  - Hàng nhập khẩu",5999000,7990000,1991000,25
TIKI,dien-thoai-may-tinh-bang,273990229,"Điện Thoại Xiaomi Redmi Note 13 6GB/128GB - Hàng Chính Hãng",4289000,4890000,601000,12
TIKI,dien-thoai-may-tinh-bang,172920927,"Điện thoại Masstel izi 12 4G - Hàng chính hãng",10000000,10000000,0,0
TIKI,dien-thoai-may-tinh-bang,274186112,"Máy tính bảng Samsung Galaxy Tab A9 Wifi (4GB/64GB) - Hàng chính hãng",3990000,3990000,0,0
TIKI,dien-thoai-may-tinh-bang,273357326,"Điện thoại Xiaomi Redmi 13C (6GB/128GB) - Hàng chính hãng",3490000,3490000,0,0
TIKI,dien-thoai-may-tinh-bang,217645692,"Combo Máy đọc sách All New Kindle Paperwhite 5 (11th Gen) - 16Gb và Bao da - Hàng nhập khẩu",3980000,3980000,0,0
TIKI,dien-thoai-may-tinh-bang,249956458,"Điện thoại Xiaomi Redmi Note 12 (4GB/128GB) - Hàng chính hãng",4990000,4990000,0,0
TIKI,dien-thoai-may-tinh-bang,274638659,"Điện Thoại Xiaomi Redmi Note 13 Pro 5G 8GB/128GB Snapdragon 7s Gen 2 , Màn OLED 120Hz, Rom Tiếng việt - Hàng nhập khẩu",5290000,6990000,1700000,24
TIKI,dien-thoai-may-tinh-bang,273412211,"Điện thoại Xiaomi Redmi 13C (4+128GB) | 6.74" 90Hz| Media Tek Helio G85| 5000mAh - Hàng chính hãng",2832000,3290000,458000,14
TIKI,dien-thoai-may-tinh-bang,273258825,"Điện thoại Samsung Galaxy A05s (4GB/128GB) - Đã kích hoạt bảo hành điện tử - Hàng chính hãng",3190000,3950000,760000,19
TIKI,dien-thoai-may-tinh-bang,245770806,"Điện thoại Samsung Galaxy A14 LTE (4GB/128GB) - Hàng chính hãng",3672000,3672000,0,0
TIKI,dien-thoai-may-tinh-bang,252884932,"Tay con điện thoại bàn Panasonic TGCA30- Hàng chính hãng-Chỉ xài được khi đã có máy mẹ",750000,750000,0,0
TIKI,dien-thoai-may-tinh-bang,198648645,"Điện thoại Xiaomi Redmi A1 (2GB/32GB)",1715000,2190000,475000,22
TIKI,dien-thoai-may-tinh-bang,272394241,"Điện thoại Samsung Galaxy A05s (4Gb/128Gb) - Hàng chính hãng - Đã kích hoạt bảo hành điện tử",3260000,3990000,730000,18
TIKI,dien-thoai-may-tinh-bang,270625677,"Điện Thoại Oppo A78 8GB/256GB - Hàng Chính Hãng",5969000,6990000,1021000,15
TIKI,dien-thoai-may-tinh-bang,270814316,"Điện thoại Tecno POVA 5 (8+8)/256GB - MediaTek Helio G99 - Sạc nhanh 45W - 6.8'' FHD+120HZ - Hàng Chính Hãng -  BH 13 Tháng",4529000,5290000,761000,14
TIKI,dien-thoai-may-tinh-bang,271451188,"Điện thoại Xiaomi Redmi A2| IPS LCD 6.52" HD+| MediaTek Helio G36| 5000 mAh - Hàng chính hãng",1669000,2190000,521000,24
TIKI,dien-thoai-may-tinh-bang,274172292,"Điện thoại Samsung Galaxy A05 (4GB/64GB) - Hàng chính hãng",2990000,2990000,0,0
TIKI,dien-thoai-may-tinh-bang,175845367,"Điện Thoại Samsung Galaxy S20 FE (8GB/256GB) Xanh Thanh Mát - Đã kích hoạt bảo hành điện tử - Hàng Chính Hãng",8625000,8625000,0,0
TIKI,do-choi-me-be,118946346,"Nước rửa chén bát hữu cơ Golden Life 1L - Hương",42000,42000,0,0
TIKI,do-choi-me-be,95269416,"Tã Dán Siêu Cao Cấp Huggies Platinum Naturemade M64 (64 Miếng)",329000,460000,131000,28
TIKI,do-choi-me-be,82482707,"GẤU BÔNG KHỦNG LONG LỬA NGỦ SAY (30 CM) GB73",99000,99000,0,0
TIKI,do-choi-me-be,146499353,"Bộ Bài Tây Poker Nền Đen Cao Cấp Chọn Màu – Bài Tây Đen Bằng Nhựa PVC Chống Thấm Nước Chống Gập Chính Hãng Dododios",29000,29000,0,0
TIKI,do-choi-me-be,19944519,"Tã dán người lớn Caryn XL10 (10 Miếng)",130000,144400,14400,10
TIKI,do-choi-me-be,25026925,"Combo 2 Gói Tã Quần Người Lớn Sunmate Khô Thoáng M8 (8 Miếng/ Gói)",161000,199999,38999,19
TIKI,do-choi-me-be,74973224,"Đồ chơi xe địa hình điều khiển từ xa KAVY tỷ lệ 1:16 bằng hợp kim tốc độ cao, bền bỉ chắc chắn, dẫn động 2 bánh",360000,360000,0,0
TIKI,do-choi-me-be,214238333,"Sữa tăng chiều cao và tăng cân cho trẻ Milo Úc và A2 Full Cream High In Calcium Úc - Chống loãng xương ở người lớn, tăng sức khỏe tổng thể - Massel Official",461000,922000,461000,50
TIKI,do-choi-me-be,62315154,"Hộp 12 viên diệt gián tận gốc Nhật Bản",35999,35999,0,0
TIKI,do-choi-me-be,104144223,"Tắm gội dịu nhẹ Pigeon Hoa hướng dương 200ml/700ml",60000,79000,19000,24
TIKI,do-choi-me-be,194017033,"Balo Tiểu Học Dành Bé Trai Mr Vui 838",337000,398000,61000,15
TIKI,do-choi-me-be,143503334,"BA LÔ CHỐNG GÙ HÌNH GẤU CHO BÉ",109000,109000,0,0
TIKI,do-choi-me-be,67729762,"Sữa tắm gội toàn thân Cetaphil Baby Gentle Wash & Shampoo 2 in 1 400ml",221000,226000,5000,2
TIKI,do-choi-me-be,188126560,"Combo 3 Viên Tẩy Bồn Cầu VIM Power 5 Hương Trà Xanh Chanh Vàng 55G",83000,84000,1000,1
TIKI,do-choi-me-be,103881069,"Miếng Bịt Góc Bàn Ghế Hình Chân Mèo",56250,56250,0,0
TIKI,do-choi-me-be,196757806,"Set 2 Miếng Silicon Bọc Góc Bàn, Góc Tủ, Cạnh Giường Giữ An Toàn Cho Bé",39000,39000,0,0
TIKI,do-choi-me-be,179764120,"Đồ bộ bé gái, quần áo Mimykid in 3D hoạt hình dễ thương, đáng yêu chất liệu thun dày mịn mát, được các bé gái yêu thích, thời trang, set, đồ cho trẻ em, bé gái từ 8kg-28kg",66000,66000,0,0
TIKI,do-choi-me-be,101148136,"Bột Thông Cống YUHAO 280gr - Thông Tắc Cực Mạnh, Đường Ống, Bồn Cầu, Bồn Rửa Mặt - Hàng Chính Hãng",31000,39000,8000,21
TIKI,do-choi-me-be,117720148,"Combo 4 miếng bịt góc bàn silicon an toàn cho trẻ - TIDO",20000,20000,0,0
TIKI,do-choi-me-be,115483446,"Sữa bột Enfagrow A+ NeuroPro 3 với 2’-FL HMO cho trẻ từ 1 – 3 tuổi– 400g",239000,239000,0,0
TIKI,do-choi-me-be,116448455,"Nước hoa Johnson's Baby Cho Bé - Dung Tích 125ml",81000,81000,0,0
TIKI,do-choi-me-be,576191,"Nước Giặt Kháng Khuẩn Mao Bao 3200g",124500,159000,34500,22
TIKI,do-choi-me-be,164075691,"Tả quần Kitin Natural size L40 (9-14kg)",153000,225000,72000,32
TIKI,do-choi-me-be,184101603,"Combo 2 túi nước xả vải làm mềm vải Comfort Chăm sóc Chuyên sâu Hương nước hoa thiên nhiên Sophia túi 3.8L",420000,542000,122000,23
TIKI,do-choi-me-be,273235757,"Sữa dành cho người tiểu đường Glucerna Úc Bổ sung dinh dưỡng, cân bằng đường huyết, tạo sức khỏe tim, tăng sức khỏe chung - QuaTangMe Extaste",1045000,2090000,1045000,50
TIKI,do-choi-me-be,20088699,"Dầu dưỡng ẩm mát xa Johnson's Baby (200ml)",105000,105000,0,0
TIKI,do-choi-me-be,72875812,"Combo 20 gói khăn giấy lau tay Roto eco20-2 hai lớp 100% bột giấy nguyên sinh, dài 20cm, họa tiết chấm bi xốp, thấm hút 2 chiều, gồm 102 tờ/gói",232000,360000,128000,36
TIKI,do-choi-me-be,17459641,"Hộp xếp hình lắp ráp sáng tạo 460 chi tiết Qman 2901",179000,214000,35000,16
TIKI,do-choi-me-be,89144736,"Xe Tập Đi Bằng Gỗ 3 Con Gà Cao Cấp Cho Bé Yêu",88000,88000,0,0
TIKI,do-choi-me-be,125628724,"Cờ Tỉ Phú Monopoly – Cờ Tỷ Phú Vui Nhộn Cao Cấp, An Toàn Cỡ Cực Đại 42x42 – Hàng Chính Hãng",96000,180000,84000,47
TIKI,do-choi-me-be,54477959,"Đồ chơi trẻ em bằng nhựa ABS Vô Lăng Tập Lái Cho Bé Có 2 màu cho bé trai và gái",300000,300000,0,0
TIKI,do-choi-me-be,48040396,"Muối rửa chén Finish Dishwasher Salt 4kg PTT017389",228000,228000,0,0
TIKI,do-choi-me-be,122234661,"Đồ chơi lắp ráp tháp trượt lăn bi, trò chơi thách thức trí tuệ và vui nhộn cho bé từ 3 tuổi",180000,180000,0,0
TIKI,do-choi-me-be,67546214,"Sữa Tắm Gội Toàn Thân Cetaphil Baby Gentle Wash Shampoo 2 in 1 (400ml)",221000,226000,5000,2
TIKI,do-choi-me-be,184101593,"Combo 2 túi nước xả vải làm mềm vải Comfort Chăm sóc Chuyên sâu Hương nước hoa thiên nhiên Bella túi 3.8L",420000,542000,122000,23
TIKI,do-choi-me-be,130015080,"[MUA LÀ CÓ QUÀ] Tấm Lót Thấm Sữa Nha Đam Pigeon 12 miếng/30 miếng/50 miếng",42000,52000,10000,19
TIKI,do-choi-me-be,87378190,"Nước giặt LIX Đậm đặc Hương Nước hoa (Cam) tẩy sạch vết bẩn cực mạnh túi 3.5KGX2",189000,189000,0,0
TIKI,do-choi-me-be,115483438,"Sữa bột Enfamil A+ NeuroPro 1 với 2’-FL HMO cho trẻ từ 0 – 6 tháng tuổi– 830g",567000,567000,0,0
TIKI,do-choi-me-be,55512044,"Sữa Bột Anlene Gold Movepro 3X Hương Vanilla (Hộp Giấy 1,2kg)",455000,455000,0,0
TIKI,do-choi-me-be,3708857,"Combo 5 gói giấy ướt không mùi Mamamy mẫu mới nhất (Gói 100 tờ)",162500,162500,0,0
TIKI,nha-sach-tiki,191353862,"Green Witchcraft - Năng lượng từ thảo mộc",104300,149000,44700,30
TIKI,nha-sach-tiki,112588572,"Yêu Trong Tỉnh Thức - Từ Bạn Đời Đến Bạn Đạo Tập 1",185000,185000,0,0
TIKI,nha-sach-tiki,73222804,"Sách Putin Logic Của Quyền Lực (Tái Bản 2020)",117000,168000,51000,30
TIKI,nha-sach-tiki,172800656,"Komi - Nữ Thần Sợ Giao Tiếp Tập 8 [Tặng kèm Card bo góc Nữ thần]",25000,25000,0,0
TIKI,nha-sach-tiki,870619,"Túp Lều Bác Tom",71000,110000,39000,35
TIKI,nha-cua-doi-song,166659124,"Dao Nhật Bản Siêu Sắc Bén Hàng Chính Hãng Cao Cấp ",365000,365000,0,0
TIKI,nha-sach-tiki,190592917,"Combo 2 Quyển: Thiên Tài Bên Trái, Kẻ Điên Bên Phải + Tâm Lý Học Tội Phạm: Phác Họa Chân Dung Kẻ Phạm Tội",223000,324000,101000,31
TIKI,nha-cua-doi-song,121243851,"Vòi rửa bát inox 304 Pimisi gắn chậu rửa bát 1 đường nước lạnh đơn cho mọi loại chậu rửa chén phổ biến trong nhà bếp | Hàng chính hãng",463000,700000,237000,34
TIKI,nha-sach-tiki,520337,"Luật Im Lặng (Mario Puzo)",63000,95000,32000,34
TIKI,nha-cua-doi-song,32004018,"PHÂN GÀ HỮU CƠ (NHẬT BẢN) - BAO 5KG - SẢN PHẨM CAO CẤP CHO MỌI LOẠI CÂY TRỒNG ( MS 025)",90000,90000,0,0
TIKI,nha-sach-tiki,91120169,"Homecoming - Hồi Sinh Đứa Trẻ Bên Trong Bạn",117000,169000,52000,31
TIKI,nha-cua-doi-song,130978265,"Ổ cắm Xoay 90° Điện Quang ĐQ ESK RT 6GW (6 lỗ, màu xanh lá trắng)",77440,103300,25860,25
TIKI,nha-sach-tiki,195801643,"Cà Phê Cùng Tony (Tái Bản 2022)",72000,105000,33000,31
TIKI,nha-sach-tiki,194959697,"Thánh Hiệp Sĩ Nơi Tận Cùng Thế Giới – Tập 1",116000,145000,29000,20
TIKI,nha-sach-tiki,191148787,"Green Witchcraft - Năng lượng từ thảo mộc",103700,149000,45300,30
TIKI,nha-cua-doi-song,134361201,"Giấy Dán Tường Nhà Bếp Chống Thấm Dầu Mở, Chống Thấm Nước, Cách Nhiệt Tiện Dụng [Tặng Móc Dán Tường Treo Đồ",43000,43000,0,0
TIKI,nha-cua-doi-song,186142362,"Ô Dù Chống Nắng Che Mưa Cản UV Tự Động Đóng Mở Khung 12 Xương",230000,230000,0,0
TIKI,nha-sach-tiki,5087505,"Ám Dạ Hành (Trinh Thám Hiện Đại Trung Quốc)",63000,151000,88000,58
TIKI,nha-sach-tiki,109982972,"Marie Curie - Nhà Nữ Khoa Học Kiệt Xuất",58500,75000,16500,22
TIKI,nha-cua-doi-song,50254577,"Thước Đo Khoảng Cách Bằng Tia Laser SNDWAY Phạm Vi 50m SW-M50 Cao Cấp AZONE",350000,350000,0,0
TIKI,nha-cua-doi-song,186883908,"Khăn tắm nén du lịch (70x140cm) bằng cotton thấm hút tốt, dùng một lần tiện lợi - Chính hãng MINIIN",21000,29000,8000,28
TIKI,nha-sach-tiki,73553840,"Truyện Thiếu Nhi Hạt Giống Tâm Hồn - Thế Giới Trong Ngăn Tủ (Tái Bản 2020)",35000,40000,5000,13
TIKI,nha-sach-tiki,46107066,"Học Cách Học",119000,159000,40000,25
TIKI,nha-cua-doi-song,51915247,"Combo 200 túi lọc rác bồn rửa bát",22999,22999,0,0
TIKI,nha-sach-tiki,109982956,"Leonardo Da Vinci - Thiên Tài Toàn Năng",40000,60000,20000,33
TIKI,nha-cua-doi-song,135059226,"Móc Dán Tường Inox 304 Dùng Keo 3M Siêu Chắc, Chịu lực lên đến hơn 20kg, Nhiều Kiểu Dáng Đẹp",41000,41000,0,0
TIKI,nha-sach-tiki,11119019,"Oxford Advanced Learner's Dictionary 8th Edition (With Vietnamese Translation) and CD - ROM (Paperback)",581300,625000,43700,7
TIKI,nha-sach-tiki,130997089,"[Manga] Diệt Slime Suốt 300 Năm, Tôi Levelmax Lúc Nào Chẳng Hay (Tập 6)",47100,48000,900,2
TIKI,nha-cua-doi-song,81647926,"Đầu nối chia điện đa năng 3 cửa SOPOKA P11 P12 chịu tải 2200W",32000,32000,0,0
TIKI,nha-cua-doi-song,33404972,"Tủ kệ sách để bàn HT003",45600,48000,2400,5
TIKI,nha-sach-tiki,77481097,"Nghề Nhân Sự Việt - Nghìn Lẻ Chuyện Giờ Mới Kể",127400,199000,71600,36
TIKI,nha-cua-doi-song,81936306,"Kệ Decor Phòng Gương 2 Tầng Morning House",159000,169000,10000,6
TIKI,nha-cua-doi-song,76827765,"Pin Energizer ECR2025 Lithium 3V Chính Hãng | Bộ Vỉ 5 Viên",55300,59000,3700,6
TIKI,nha-cua-doi-song,14526627,"Quánh Inox 430 Bếp Từ 3 Đáy Fivestar Nắp Kính",199000,199000,0,0
TIKI,nha-sach-tiki,392568,"Marvellous Techniques For IELTS Writing",201000,268000,67000,25
TIKI,nha-sach-tiki,76117849,"Luyện Kỹ Năng Nghe Tiếng Anh (Trình Độ Cơ Bản) -Tactics For Listening Basic",64000,90000,26000,29
TIKI,nha-cua-doi-song,135099603,"Cây lau nhà thay thế bộ lau nhà PX01 (Không bao gồm thùng vắt) - Parroti MOP-PX01",229000,280000,51000,18
TIKI,nha-cua-doi-song,117058329,"Giấy lọc cà phê Hario 100 cái (V60-VCF-01-100W)",89000,99000,10000,10
TIKI,nha-cua-doi-song,80657249,"Hộp vải đựng đồ đa năng có nắp TD3a và TD3b – Túi vải Thụy Điển có nắp rời 34L sang trọng vải Oxford chính hãng miDoctor",129000,200000,71000,36
TIKI,nha-sach-tiki,72688722,"Giáo Dục - Tương Lai & Đổi Mới",148000,180000,32000,18
TIKI,nha-sach-tiki,160814425,"Thai Giáo Theo Chuyên Gia - 280 Ngày - Mỗi Ngày Đọc Một Trang (Tái Bản 2021)",82800,115000,32200,28
TIKI,nha-sach-tiki,191373346,"[QUÀ TẶNG ĐỘC QUYỀN]  Ví da y tế cao cấp đa năng, đựng thuốc, đựng máy đo đường huyết, nhiệt kế, điện thoại, ví tiền, bền đẹp và tiện lợi, hạn chế va đập, tiện lợi cả ở nhà và đi du lịch",199000,199000,0,0
TIKI,nha-cua-doi-song,50206492,"Thuốc trừ rầy, nhện, kiến, gián mối, bọ chét, ve chó Regent 800WG",40000,40000,0,0
TIKI,nha-cua-doi-song,39748239,"Kệ để đồ dán tường cho phòng tắm và nhà bếp (Giao ngẫu nhiên mẫu)",10000,20900,10900,52
TIKI,nha-cua-doi-song,159144262,"Cây lau nhà VILEDA Turbo Easy Wring&Clean đầu lau tam giác, xô giặt quay bằng chân, thêm 2 bông lau",659000,659000,0,0
TIKI,nha-sach-tiki,11413619,"Combo Mẹ Hỏi Bé Trả Lời (4 Cuốn)",95000,120000,25000,21
TIKI,nha-sach-tiki,91774356,"Fullmetal Alchemist - Cang Giả Kim Thuật Sư - Fullmetal Edition Tập 8",65500,69000,3500,5
TIKI,nha-sach-tiki,52691750,"Tự Do Đầu Tiên & Cuối Cùng",124000,178000,54000,30
TIKI,nha-sach-tiki,6807847,"Cảm Ơn Người Lớn (Bìa Mềm) - Bản Tặng Kèm Thiệp + Phong Bì Thiệp + Bookmark (Số Lượng Có Hạn)",64200,110000,45800,42
TIKI,nha-cua-doi-song,177679445,"Chuông Cửa Không Dây Thông Minh Besti YBT01 (1 Nút Bấm, 1 Chuông ), Chống Nước, Khoảng Cách Sử Dụng Hiệu Quả 300M, 60 Loại Nhạc Chuông, 4 Mức Điều Chỉnh Âm Lượng - Hàng Chính Hãng",180000,180000,0,0
TIKI,nha-cua-doi-song,67096743,"Combo Full Bộ Ống Hút Inox 304 Thép Không Gỉ, Tái Chế Sử Dụng, Thân Thiện Môi Trường - Hàng Chính Hãng",29000,29000,0,0
TIKI,nha-cua-doi-song,196571419,"CHẢO CẠN INOX 5 ĐÁY SUNHOUSE 16-20-24-26-28CM (DÙNG TRÊN MỌI LOẠI BẾP)",175000,175000,0,0
TIKI,nha-sach-tiki,172422019,"Vì Con Gái Tôi Có Thể Đánh Bại Cả Ma Vương - Tập 5 - Tặng Kèm Poster + Bookmark",119000,140000,21000,15
TIKI,nha-cua-doi-song,50825030,"Dụng cụ kẹp gắp bát, đĩa, đồ nóng",14500,14500,0,0
TIKI,nha-cua-doi-song,56562967,"Combo 5 Miếng Xốp Dán Tường Giả Gạch Dày 4mm -  Trắng",51299,53999,2700,5
TIKI,nha-cua-doi-song,263076438,"Gối chống trào ngược dạ dày thực quản người lớn Ema giúp giảm trào ngược dạ dày, viêm họng mãn tính, nuốt vướng, nghẹn cổ, khó thở khi ngủ, ngáy ngủ",585000,1170000,585000,50
TIKI,nha-sach-tiki,36311444,"Đàn Ông Sao Hỏa Đàn Bà Sao Kim (Tặng Bookmark PL)",135360,188000,52640,28
TIKI,nha-sach-tiki,3840809,"New Economy Toeic Lc 1000 (Kèm file MP3)",149000,198000,49000,25
TIKI,nha-cua-doi-song,59386141,"Bọc Giày Đi Mưa Silicon Siêu Bền Nhiều Màu",59900,59900,0,0
TIKI,nha-cua-doi-song,167046966,"Áo bọc bàn để ủi cầu là quần áo có mút Kokomega BU04 KT: 35*100cm( Và Sử Dụng Cho BU-120)",75050,79000,3950,5
TIKI,nha-sach-tiki,100382935,"Sách - Hành Trình Về Phương Đông (Bìa Mềm - Tái bản 2021) - First News",106650,106650,0,0
TIKI,nha-sach-tiki,158972052,"Cẩm Nang Con Trai",47100,68000,20900,31
TIKI,nha-cua-doi-song,46207255,"Combo 2 túi lưới giặt đồ 2 lớp Polyester dạng lưới mịn giặt đồ chống biến dạng quần áo cho máy giặt dạng hộp khóa kéo phù hợp giặt đồ nhỏ đồ lót",45000,45000,0,0
TIKI,nha-cua-doi-song,147593105,"Miếng chặn khe cửa chống bụi  Nẹp chặn cửa chắn khe hở chống bụi, chống côn trùng, chống thoát hơi gió điều hòa",20000,20000,0,0
TIKI,nha-cua-doi-song,142857607,"Thông tắc vệ sinh, dây thông cống lò xo, tiện dụng và được việc",45000,67500,22500,33
TIKI,nha-cua-doi-song,17008839,"Thiết Bị Bấm Lỗ Dây Nịt Da Cầm Tay (6-9")",53091,53091,0,0
TIKI,nha-sach-tiki,171821043,"Bộ "Anne Tóc Đỏ" 8 Cuốn",717000,972000,255000,26
TIKI,nha-sach-tiki,175967753,"Komi - Nữ Thần Sợ Giao Tiếp Tập 9",25000,25000,0,0
TIKI,nha-sach-tiki,72688720,"Năm Phút Nữa Thôi",43800,59000,15200,26
TIKI,nha-sach-tiki,1544255,"Băng Keo Trong 5F (2 Cuộn / Lốc)",17000,49000,32000,65
TIKI,nha-cua-doi-song,83397956,"MXK4 - 25x15x10 cm - 20 Thùng hộp carton",52600,52600,0,0
TIKI,nha-sach-tiki,11413616,"Mẹ Hỏi Bé Trả Lời 4-5 Tuổi (Tái Bản)",27000,30000,3000,10
TIKI,nha-cua-doi-song,184903735,"Khay xếp quần áo chia ngăn 6 7 20, Hộp đựng đồ lót tất vớ chất liệu vải không dệt cao cấp",32000,32000,0,0
TIKI,nha-sach-tiki,173420792,"Người Hạt Dẻ",159200,199000,39800,20
TIKI,nha-sach-tiki,100376369,"Đứa Con Gái Hoang Đàng - Hai Số Phận - Phần II",129000,209000,80000,38
TIKI,nha-cua-doi-song,63479866,"[CHÍNH HÃNG] Khoá treo đồng bấm Việt - Tiệp Cao cấp - Chống trộm | Mã SP: 01524",125970,132600,6630,5
TIKI,nha-cua-doi-song,57863885,"Đồng hồ LED để bàn hình hộp gỗ - Nhiệt kế - Báo thức - Cảm ứng âm thanh",109000,159000,50000,31
TIKI,nha-cua-doi-song,16093882,"Phích Cắm Chuyển Đổi 3 Chấu Sang 2 Chấu Milliken NL-3106",15000,15000,0,0
TIKI,nha-cua-doi-song,52188851,"Muỗng Thìa Cà Phê Cán Dài INOX304 24cm",30000,30000,0,0
TIKI,nha-cua-doi-song,90597884,"Bàn Học Bàn Làm Việc Ngồi Bệt Model 1 Thông Minh - GP116",382000,415000,33000,8
TIKI,nha-sach-tiki,4319337,"Tạo Dựng Thương Hiệu Cá Nhân",76300,109000,32700,30
TIKI,nha-sach-tiki,148802195,"How We’Re F***Ing Up Our Planet - Ta Đang Hủy Diệt Trái Đất Như Thế Nào",255000,330000,75000,23
TIKI,nha-sach-tiki,186578233,"Trúc thư dao 2 (Nước Tấn - Gió nổi cung đình)",173000,219000,46000,21
TIKI,nha-sach-tiki,8128223,"Lột xác để trở thành nhà đầu tư giá trị - The education of a value investor",268000,268000,0,0
TIKI,nha-sach-tiki,163297416,"My Hero Academia - Học Viện Siêu Anh Hùng Tập 3: All Might (Tái Bản)",25000,25000,0,0
TIKI,nha-sach-tiki,154245459,"Nghiền Từ Vựng Tiếng Anh - Học Qua Gốc Từ Bằng Hình Ảnh - Gốc Từ Là Bí Quyết Để Ghi Nhớ Hàng Nghìn Từ Vựng - Quyển 1",89000,135000,46000,34
TIKI,nha-sach-tiki,110649726,"Hành Trình Thức Tỉnh ",229000,229000,0,0
TIKI,nha-sach-tiki,14684312,"Dấn Thân (Tái Bản)",75000,112000,37000,33
TIKI,nha-sach-tiki,427631,"Tầm Nhìn Thay Đổi Quốc Gia",187000,268000,81000,30
TIKI,nha-sach-tiki,172160196,"Thấu Hiểu Marketing Bệnh Viện",249000,249000,0,0
TIKI,nha-sach-tiki,105837988,"Hộp 22 gôm tẩy học sinh Deli - Hình dáng ngộ nghĩnh đáng yêu - 71055 / 71054",59400,59400,0,0
TIKI,nha-sach-tiki,82072617,"Các Lỗi Thường Gặp Trong Tiếng Anh",51500,80000,28500,36
TIKI,nha-sach-tiki,145977554,"Combo 2 Cuốn: Thần Số Học + Thần Số Học Ứng Dụng",242300,348000,105700,30
TIKI,nha-sach-tiki,63924629,"Tạp Văn Nguyễn Ngọc Tư (Tái Bản Lần Thứ 20-2020)",62000,90000,28000,31
TIKI,nha-sach-tiki,273718791,"Sapiens: Lược Sử Loài Người",224000,299000,75000,25
TIKI,nha-sach-tiki,273714602,"Trạm Đọc | Thuật Tẩy Não - Nghệ Thuật Thao Túng Và Kiểm Soát Tâm Lý Đối Phương",141000,189000,48000,25
TIKI,nha-sach-tiki,196394987,"Hai Ta Trên Đường Kẻ Cuộc Đời",98400,109000,10600,10
TIKI,nha-sach-tiki,19948893,"Chạm Tay Hóa Vàng (Tái Bản)",77000,125000,48000,38
TIKI,nha-sach-tiki,49252204,"Dạy Con Làm Giàu - Tập 12: Lời Tiên Tri Của Người Cha Giàu (Tái Bản)",98200,160000,61800,39
TIKI,nha-sach-tiki,191926658,"Trái cây đại chiến Zombie - Thế giới khủng long: Tập 10 - Vương quốc ngủ say",58000,89000,31000,35
TIKI,nha-sach-tiki,192833921,"Combo 2 Sách: Tiếng Anh Cho Người Mới Bắt Đầu và Tổng Ôn Ngữ Pháp Tiếng Anh Cô Trang Anh",328000,400000,72000,18
TIKI,nha-sach-tiki,75454261,"Stay Positive - Sống Tích Cực, Đời Hết Bực - Bí Quyết Sống Vui Mỗi Ngày",99000,120000,21000,18
TIKI,nha-sach-tiki,194103341,"Bột Nước Muối Men: Nền tảng của bánh mỳ và pizza thủ công",232000,360000,128000,36
TIKI,nha-sach-tiki,273568395,"Husky Và Sư Tôn Mèo Trắng Của Hắn (Tập 2)",111000,169000,58000,34
TIKI,nha-sach-tiki,193896500,"How Yoga Works: Bí mật Yoga",171900,239000,67100,28
TIKI,nha-sach-tiki,107576379,"Sổ tay học sinh Destination B1,B2,C1&2",118500,118500,0,0
TIKI,nha-sach-tiki,186265472,"Thế Giới Của Truyện Nôm",112000,170000,58000,34
TIKI,nha-sach-tiki,47323978,"Quick Quick Học Nhanh Toàn Diện Từ Vựng Tiếng Anh Theo Chủ Đề Lớp 1",66000,89000,23000,26
TIKI,nha-sach-tiki,7982626,"Thế Giới Phẳng (Tái Bản)",162000,310000,148000,48
TIKI,nha-sach-tiki,147964307,"COMBO SÁCH PHÙ HỢP MỌI THỂ LOẠI ĐẦU TƯ – KỸ THUẬT KHÓ CHẲNG LO",428000,428000,0,0
TIKI,nha-sach-tiki,189557421,"Blog Writing - Sống với nghề viết blog",216000,250000,34000,14
TIKI,nha-sach-tiki,82996527,"Tinh Thần Chiến Đấu Rực Lửa",66500,95000,28500,30
TIKI,nha-sach-tiki,190238358,"Nhặt Sao - Bản Thường - (Tặng kèm 1 bookmark in 2 mặt)",161000,179000,18000,10
TIKI,nha-sach-tiki,730723,"Tuần Của Bé Tháng 7- Bé Tự Tin",11500,23000,11500,50
TIKI,nha-sach-tiki,58165559,"Ngữ Pháp Tiếng Hàn Thông Dụng - Sơ Cấp",160000,250000,90000,36
TIKI,nha-sach-tiki,714023,"Ngụ Ngôn E Dốp - Văn Học Cổ Điển Hi Lạp",58800,98000,39200,40
TIKI,nha-sach-tiki,191782142,"Điều Vĩ Đại Đời Thường",63000,92000,29000,32
TIKI,nha-sach-tiki,111537683,"Và Rồi Chẳng Còn Ai (Agatha Christie)",64200,110000,45800,42
TIKI,nha-sach-tiki,188930498,"Người Bà Tài Giỏi Vùng Saga – Tập 6",40500,52000,11500,22
TIKI,nha-cua-doi-song,91063233,"Hạt Giống Hoa Mãn Đình Hồng Kép Nhiều Màu 20 hạt",13000,15260,2260,15
TIKI,nha-cua-doi-song,88230880,"Bóng đèn cảm ứng cảm biến chuyển động rada vi sóng 5.8 Hz tự động bật tắt đèn khi có người đi qua",41000,41000,0,0
TIKI,nha-cua-doi-song,146926667,"Giây Ăn SAKARA Mã 6089 Siêu Mịn, Siêu Dai, Bốn Lớp, Không Mủn Giấy Ăn Cao Cấp Nhập Khẩu Thùng 30 gói",141897,141897,0,0
TIKI,nha-cua-doi-song,189568098,"Bình giữ nhiệt inox 304 Elmich",220000,499000,279000,56
TIKI,nha-sach-tiki,644081,"Đường Về",52000,70000,18000,26
TIKI,nha-cua-doi-song,28604722,"Ghế bệt gỗ kiểu nhật D227 ( Hàng nhập khẩu )",320000,320000,0,0
TIKI,nha-cua-doi-song,17164211,"Bộ 13 mũi khoan đa năng lục giác",44999,44999,0,0
TIKI,nha-cua-doi-song,73759724,"Kệ Sách Đứng Để Sàn Cao Cấp FIVO Mẫu FB70 Lắp Ráp Đơn Giản, Phù Hợp Với Mọi Không Gian",749000,1168000,419000,36
TIKI,nha-cua-doi-song,42270992,"Bình Giữ Nhiệt Rinfere, Với Miệng Rộng, Nắp Quai Cầm - Nhiều Kích Cỡ Và Màu Sắc",305000,499000,194000,39
TIKI,nha-cua-doi-song,104472138,"Tấm/Miếng Lót Nồi Bằng Gỗ Đường Kính 21cm",25000,25000,0,0
TIKI,nha-cua-doi-song,134407128,"Tủ Kệ Sách Trang Trí, Làm Từ Gỗ Công Nghiệp rẻ vô địch, Chất Lượng Cao, Dễ Dàng Lắp Ghép Nhiều Ngăn Để Đồ tiện lợi",252000,252000,0,0
TIKI,nha-cua-doi-song,20575031,"VÒI LAVABO LẠNH INOX SUS304",165000,165000,0,0
TIKI,nha-cua-doi-song,117282929,"Phích ổ cắm đa năng LiOA chuyển 3 chân thành 2 chân 15A/220V Chân Tròn/Dẹt - Ổ điện chuyển đổi từ 3 chấu sang 2 chấu",18000,18000,0,0
TIKI,nha-cua-doi-song,98556230,"Kệ Gỗ Trang Trí Treo Tường Không Cần Khoan Với Móc Treo Inox Và Đầy Đủ Phụ Kiện Tặng Kèm, Dễ Dàng Gắn Lên Tường",119000,125000,6000,5
TIKI,nha-cua-doi-song,66877577,"Hộp đựng cơm thủy tinh cao cấp 3 ngăn ( Giao mầu ngẫu nhiên)",89000,89000,0,0
TIKI,nha-cua-doi-song,7699055,"Chảo Nhôm Chống Dính Lock&Lock Baum Marble 1 Tay Cầm LBU1243C (24cm)",235000,451000,216000,48
TIKI,nha-cua-doi-song,187829576,"VỎ GỐI NẰM,GỐI ÔM COTTON MỀM MỊN. THOÁNG MÁT GIÁ SIÊU RẺ,KÍCH THƯỚC 40X60.50X70.35X105",30400,40000,9600,24
TIKI,nha-cua-doi-song,120166109,"Bóng Philips LED bulb Essential E27 (5W,7W,9W,11W,13W) - E27 (3000K/6500K)",50600,52200,1600,3
TIKI,nha-cua-doi-song,74986118,"Màng Bọc Thực Phẩm PE Shinsen 30 x 40000",163000,163000,0,0
TIKI,nha-cua-doi-song,128935485,"Thìa Ăn Phở Ăn Soup - Inox 304 Jodily Cao Cấp Sáng Bóng Bền Mãi Với Thời Gian",15000,15000,0,0
TIKI,nha-cua-doi-song,106677814,"Hộp thuỷ tinh chữ nhật Nikko 370 ml",43000,43000,0,0
TIKI,nha-cua-doi-song,84153167,"Kệ Sách Đa Năng Athena 5F Thương Hiệu IGEA",409000,445000,36000,8
TIKI,nha-cua-doi-song,106281062,"Bộ 6 Ly Bia Thuỷ Tinh Luminarc Benidorm 450ml - LUBEG2616",309000,386000,77000,20
TIKI,nha-cua-doi-song,80874505,"Cốc gấu đựng bàn chải kem đánh răng, Cốc gấu dán tường siêu dính",14999,14999,0,0
TIKI,nha-cua-doi-song,184591044,"Đèn Pixar, Đèn Bàn Chống Cận Thị, Đèn Đọc Sách LED, Đèn Làm Việc Bảo Vệ Mắt - Hàng Chính Hãng",258000,320000,62000,19
TIKI,nha-cua-doi-song,26149459,"Bộ Muỗng Đũa Cơm Trưa INOX 304 Thiết Kế Sang Trọng Mạ PVD Cao Cấp - Xanh Da Trời",120000,120000,0,0
TIKI,nha-cua-doi-song,176530481,"Chiếu điều hòa tencel Lidaco (Nhiều mẫu lựa chọn)",389000,560000,171000,31
TIKI,nha-cua-doi-song,125149573,"Sáo Tiêu Recorder Soprano Yamaha YRS-402, YRS-20,YRS-24B Chính Hãng, Độ Bền Cao, Chất Liệu ABS An Toàn",135000,135000,0,0
TIKI,nha-cua-doi-song,146393649,"Ngăn Mùi Hôi Cống  Ngăn Mùi Thoát Sàn Silicon-Nút Bịt Ống Cống Chống Hôi Hiệu Quả 100%",9499,9999,500,5
TIKI,nha-cua-doi-song,72751318,"Báo Động Chống Trộm, Chuông Báo Khách Mở Cửa Đa Chức Năng Có Điều Khiển Từ Xa MC - 02, Báo Động Nhiều Chế Độ : Chống Trộm Xâm Nhập , Báo Chuông Cửa..",205000,249000,44000,18
TIKI,nha-cua-doi-song,51343718,"Thau Gập Gọn - Chậu Nhựa Gấp Gọn Đa Năng1 2x35cm, nhiều màu, giao màu ngẫu nhiên+ Tặng kèm móc treo",68135,126000,57865,46
TIKI,nha-cua-doi-song,134360858,"Bộ 8 Pin AA Panasonic 1,5V Không chì , Pin không chảy nước R6DT/4S - Hàng chính hãng",38000,60000,22000,37
TIKI,nha-cua-doi-song,53472238,"Kệ gỗ thông để giày đa năng",129800,129800,0,0
TIKI,nha-cua-doi-song,93780998,"Đồng hồ hẹn giờ đếm ngược dùng trong nấu ăn, pha chế",185000,200000,15000,8
TIKI,nha-cua-doi-song,37730520,"Thanh treo quần áo 4 chấu dán tường Hobby 4TV160 chuẩn Inox 304 - kèm keo dán siêu dính",147000,219000,72000,33
TIKI,nha-cua-doi-song,137796584,"Thảm Lau Chân Nhà Tắm Đa Năng Chất Liệu Chống Trơn Trượt Cao Cấp 4 Lớp Thấm Hút Tốt 40x60cm Loại 1 - Hàng Chính Hãng -( Màu Và Chữ Ngẫu Nhiên)",94050,99000,4950,5
TIKI,nha-cua-doi-song,121162213,"Set 10 Móc Treo Quần Áo Người Lớn Jodily inox 304 Sáng Bóng Bền Mãi Với Thời Gian",150000,150000,0,0
TIKI,nha-cua-doi-song,165758266,"Bộ dao 3 chiếc Eco Family Sunhouse KS-KN3E1",283000,438000,155000,35
TIKI,nha-cua-doi-song,77746708,"Dây đèn led đom đóm trang trí pin không nháy tiểu dây bóng đèn fairy light cao cấp, tinh tế sang trọng decor phòng, du lịch, lều trại, luôn sáng - Chính hãng DEHA",35000,65000,30000,46
TIKI,nha-cua-doi-song,34816875,"Dụng Cụ Thông Tắc Cống, Kẹp Gắp Rác Đa Năng Loại Tốt",21000,21000,0,0
TIKI,nha-cua-doi-song,8141095,"Bình nước Lock&Lock Aqua HAP739B/HAP739W 2,6L",68800,109000,40200,37
TIKI,do-choi-me-be,1000538,"Sữa Bột Anlene Gold Movepro 3X Hương Vanilla (Hộp Thiếc 400g)",217000,224000,7000,3
TIKI,do-choi-me-be,56957583,"Bio Island DHA cho bà bầu chính hãng Úcs",535000,668750,133750,20
TIKI,do-choi-me-be,130470106,"Similac Einstein 1 cho trẻ từ 0 - 6 tháng tuổi",287000,287000,0,0
TIKI,do-choi-me-be,89249057,"Combo 10 hộp khăn giấy lụa Japani Silk180 hai lớp kích thước 19x20cm hộp xanh - 180 tờ/hộp",196000,280000,84000,30
TIKI,do-choi-me-be,196177335,"Lốc 10 Cuộn Giấy Vệ Sinh Bless You À La Vie Cao Cấp Mềm Mịn",92000,160000,68000,43
TIKI,do-choi-me-be,66065160,"Sữa Bột Abbott Glucerna Lúa Mạch 850g",929000,929000,0,0
TIKI,do-choi-me-be,32835143,"Combo Bộ Bài Bói The Rider Waite Tarot và Túi Nhung Cao Cấp",119000,119000,0,0
TIKI,do-choi-me-be,260817020,"Sữa bột công thức HiPP 2 Organic Combiotic 800g",720000,720000,0,0
TIKI,do-choi-me-be,59196226,"Dầu húng chanh Minion 30ml",259000,259000,0,0
TIKI,do-choi-me-be,54509649,"Viên Khử Trùng và Vệ Sinh Bồn Cầu, Hỗ Trợ Diệt Khuẩn Giảm Thông Tắc Bồn Cầu Xuất Xứ Nhật Bản - Diệt Khuẩn, Khử Mùi, Vệ Sinh Bồn Cầu Cực Kì Hiệu Quả",31000,32000,1000,3
TIKI,do-choi-me-be,1745007,"Tấm Đệm Lót Siêu Thấm Caryn (10 Miếng)",55000,60400,5400,9
TIKI,do-choi-me-be,41465659,"Đồ bơi cho bé trai quần short size lớn đến 55kg",299000,343350,44350,13
TIKI,do-choi-me-be,97983190,"Kính bơi trẻ em Sinca có lớp tráng gương, chống sương mù, dây silicon dễ dàng điều chỉnh cho bé từ 5 tuổi - 15 tuổi",149000,163330,14330,9
TIKI,do-choi-me-be,66767666,"Ống Bón Sữa, Bón Thuốc Tiện Lợi Dễ Sử Dụng Cho Bé Yêu Loại 3ml",10000,10000,0,0
TIKI,do-choi-me-be,102459754,"Đồ Chơi Xếp Hình Thông Minh Bằng Gỗ 180 Miếng Ghép Tangram Có Hộp Đựng Cho Bé Tư Duy Sáng Tạo Và Học Hình Khối Màu Sắc",130000,163000,33000,20
TIKI,do-choi-me-be,160880625,"Kẹp tóc cho bé gái, Set 14 kẹp tóc mái cho bé nhiều màu sắc họa tiết dễ thương (14psc) – SP154",28000,28000,0,0
TIKI,do-choi-me-be,173164596,"Combo 03 Sữa Bột Anlene Gold 3X Hương Vanilla (Hộp thiếc 800g) - Tặng nồi inox",1190000,1230000,40000,3
TIKI,do-choi-me-be,73661266,"Bộ 2 chai Sữa Tắm Gội Trẻ Em Lactacyd Milky BẢO VỆ, NUÔI DƯỠNG DA và TÓC BÉ VƯỢT TRỘI 500ml/chai",366000,366000,0,0
TIKI,do-choi-me-be,48494290,"Bộ 2 tấm xếp hình A3 :1 Tranh đội bay siêu đẳng và 1 tranh Doremon (48 mảnh ghép). Đồ chơi trí tuệ cho bé từ 3 tuổi. Tia Sáng Việt Nam. Chứng nhận hợp quy Tia sáng tên chủng loại: Xếp hình số mảnh ghép lên đến 250 mảnh. Ký hiệu kiểu loại: Xếp hình.",78000,78000,0,0
TIKI,do-choi-me-be,66193472,"Bộ 2 tấm tranh xếp hình đội chó cứu hộ và Heo Peppa, 48 mảnh ghép, kích thước A3. Tia Sáng Việt Nam.",78000,78000,0,0
TIKI,do-choi-me-be,84999798,"Thùng 18 Hộp Sữa đêm ngũ cốc Fruto Nyanya 200ml",497664,622080,124416,20
TIKI,do-choi-me-be,44140382,"Túi Ngũ Cốc NAVAN (800G) -  Dinh Dưỡng Thiết Yếu Cho Mẹ",199000,199000,0,0
TIKI,do-choi-me-be,24510746,"Chất thông tắc Cầu, Cống Sifa chống hôi Siêu nhanh Siêu mạnh 5 phút",62000,62000,0,0
TIKI,do-choi-me-be,191387813,"Nước xả làm mềm vải Comfort Hương Nước Hoa Thiên Nhiên Jennie túi 3.8L",215000,243900,28900,12
TIKI,do-choi-me-be,168662079,"Sữa bột NAN INFINIPRO A2 Thụy Sĩ 2 800g với sự kết hợp độc đáo giữa đạm quý A2 và 5HMO (12 - 24 tháng)",629000,629000,0,0
TIKI,do-choi-me-be,187636884,"Chăn Mền Cotton Đũi cho bé Thu Hè, chăn mền điều hòa trẻ em mỏng thoáng mát - Tặng 10 chiếc chun",75000,75000,0,0
TIKI,do-choi-me-be,412763,"Tã Quần Cao Cấp Moony Nhật Bản Bé Trai L44 (44 Miếng)",339000,466400,127400,27
TIKI,do-choi-me-be,53281844,"100 Quân Domino Cờ Các Quốc Gia, Xếp Hình Tập Nhận Biết Quốc Kì, Đồ Chơi Bằng Gỗ Tự Nhiên - Hàng Chính Hãng miDoctor",99000,99000,0,0
TIKI,do-choi-me-be,113864742,"Bỉm Aikuu Bear CHÍNH HÃNG Dán/Quần đủ size S112,M100/M100,L96,XL92,XXL88,XXXL84",278000,300000,22000,7
TIKI,do-choi-me-be,262974809,"Sữa Bột Nestle Milo Value Pack  Úc, Bổ Sung vitamin và khoáng chất giúp bé phát triển chiều cao và cân năng, thông minh và sáng tạo năng động vượt trội - Massel Official",364000,728000,364000,50
TIKI,do-choi-me-be,115483435,"Sữa bột Enfamil A+ NeuroPro 2 với 2’-FL HMO cho trẻ từ 6 –12  tháng tuổi– 830g",541000,541000,0,0
TIKI,do-choi-me-be,142422033,"Combo 3 Túi Nước Rửa Bình Sữa Dnee 600ml/túi",149000,149000,0,0
TIKI,do-choi-me-be,53626561,"Chất tẩy mốc xi măng trên nhiều chất liệu, tẩy rong rêu, tẩy gạch cũ bẩn, tẩy ron gạch siêu mạnh  HT01-TVS -1,8L (sản phẩm mới hoạt chất bảo vệ bề mặt 100%, chất lượng cao)",149000,180000,31000,17
TIKI,do-choi-me-be,213517312,"Sữa Ensure cho người già Úc - Cung cấp dinh dưỡng giúp hồi phục sức khỏe cho người suy dinh dưỡng, ốm yếu, người già - QuaTangMe Extaste",1039000,2078000,1039000,50
TIKI,do-choi-me-be,95035879,"Dinh dưỡng 100% Trái cây nghiền Organic HiPPiS Dâu rừng, Táo, Đào",60000,60000,0,0
TIKI,do-choi-me-be,187216804,"Sữa dê HiPP Organic 400g - Nhập khẩu Đức, giúp bé phát triển chiều cao, trí não, tăng cường hấp thu",544000,544000,0,0
TIKI,do-choi-me-be,182709864,"Combo 2 Sữa tắm gội dịu lành cho bé Cetaphil Baby Wash & Shampoo with Organic Calendula 400ml/chai",590000,590000,0,0
TIKI,do-choi-me-be,44246534,"Bộ Cờ Tướng Gỗ Sồi + Bàn Cờ Tướng 40*35cm, Cờ Tướng Gỗ Có Bàn Là Hộp Đựng Chính Hãng",259000,450000,191000,42
TIKI,do-choi-me-be,129540643,"Kem chống hăm tã em bé Sudocrem hộp 60g",109000,109000,0,0
TIKI,do-choi-me-be,118288089,"Sữa Dành Cho Người Tiểu Đường Abbott Glucerna Úc Bổ Sung Đầy Đủ Dinh Dưỡng Và Cân Bằng Đường Huyết - Lon 850g - Massel Official",875000,2090000,1215000,58
TIKI,nha-sach-tiki,1686729,"Học Tiếng Anh Giao Tiếp Chỉ Trong 30 Ngày",224000,298000,74000,25
TIKI,nha-sach-tiki,12107379,"Barron's Essential Words For The Ielts (Tái Bản)",145000,208000,63000,30
TIKI,nha-sach-tiki,192714730,"Tuyển Tập Đề Kiểm Tra Định Kì Khoa Học Tự Nhiên Lớp 7 ( Theo Chương Trình GDPT Mới )",69000,92000,23000,25
TIKI,nha-sach-tiki,194104629,"Một Quyển Phong Hoa Đại Đường",96500,139000,42500,31
TIKI,nha-sach-tiki,111155169," [Manga] Diệt Slime Suốt 300 Năm, Tôi Levelmax Lúc Nào Chẳng Hay (Tập 5) ",38100,48000,9900,21
TIKI,nha-sach-tiki,190707619,"Của Chuột Và Người",60300,76000,15700,21
TIKI,nha-sach-tiki,11470936,"Combo Giáo Trình HSK 3 - Sách Bài Học (Kèm MP3) và Giáo Trình HSK 3 - Sách Bài Tập (Kèm MP3) ( Tặng Kèm Sổ Tay)",380800,476000,95200,20
TIKI,nha-sach-tiki,55957270,"Sách Hoa Trôi Trên Sóng Nước (Tái Bản 2020) - Nguyên Phong",64000,98000,34000,35
TIKI,nha-sach-tiki,7556499,"GAM7 No.11 Promotion - Khuyến Mại",136000,165000,29000,18
TIKI,nha-sach-tiki,41299102,"Những Nguyên Lý Quản Trị Bất Biến Mọi Thời Đại (Tái Bản 2019)",96100,138000,41900,30
TIKI,nha-sach-tiki,46253703,"Danh Gia Cổ Vật - Bí Ẩn Thanh Minh Thượng Hà Đồ",119000,150000,31000,21
TIKI,nha-sach-tiki,14643411,"Điều Kỳ Diệu (Tái Bản)",84200,148000,63800,43
TIKI,nha-sach-tiki,95311763,"Phương Pháp Ăn Uống Cải Thiện Lưu Thông Máu",61800,89000,27200,31
TIKI,nha-sach-tiki,157244522,"Văn Minh Đông Phương Và Tây Phương (Ts Thu Giang Nguyễn Duy Cần)(Tái Bản)",41200,60000,18800,31
TIKI,nha-sach-tiki,136540035,"Tư Duy Hộp Đen (Tìm Ra Lời Giải Cho Những Câu Hỏi Trong Cuộc Sống Và Kinh Doanh Bằng Tư Duy Thực Tế)",152500,219000,66500,30
TIKI,nha-sach-tiki,73553827,"Dữ Liệu Lớn Cho Doanh Nghiệp Nhỏ For Dummies",118000,159000,41000,26
TIKI,nha-sach-tiki,15634588,"Who? Chuyện Kể Về Danh Nhân Thế Giới: Ludwig Van Beethoven (Tái Bản 2019)",41000,55000,14000,25
TIKI,nha-sach-tiki,386182,"Thế Giới Tuổi Thần Tiên - Những Câu Chuyện Trong Rừng Xanh",20000,38000,18000,47
TIKI,nha-sach-tiki,41299108,"Trở Về Từ Cõi Sáng (Tái Bản)",68100,98000,29900,31
TIKI,nha-sach-tiki,112331977,"Quiz! Khoa Học Kì Thú: Khám Phá Trái Đất",49100,68000,18900,28
TIKI,nha-sach-tiki,67120551,"Đây Là Monet",109000,150000,41000,27
TIKI,nha-sach-tiki,595726,"Giáo Trình Chuẩn HSK 4 Bài Học (Tập 2)",179000,238000,59000,25
TIKI,nha-sach-tiki,273634677,"Trạm Đọc Official | Hackers Ielts 4 cuốn  ( Listening + Reading + Speaking + Writing )",743000,996000,253000,25
TIKI,nha-sach-tiki,187859733,"Thám Tử Đã Chết Tập 4 - Bản Phổ Thông - Quà Tặng Kèm Bookmark, Bộ Card Trong Bù Của Tập 3 (Trong Lần In Đầu)",83900,109000,25100,23
TIKI,nha-sach-tiki,189076559,"Gatsby vĩ đại",184000,280000,96000,34
TIKI,nha-sach-tiki,187859732,"Spy Room – Lớp Học Điệp Viên 4",83900,109000,25100,23
TIKI,nha-sach-tiki,187279375,"Sách Luyện thi B2 Vstep 4 kỹ năng - Ôn thi chứng chỉ tiếng Anh bậc 4 (bằng B2 tiếng Anh) khung năng lực Ngoại ngữ 6 bậc Việt Nam",304500,350000,45500,13
TIKI,nha-sach-tiki,1732997,"Hồ Sơ Mật Lầu 5 Góc Và Hồi Ức Về Chiến Tranh Việt Nam (Sách Tham Khảo)",290000,290000,0,0
TIKI,nha-sach-tiki,29190890,"Tôi Đi Tìm Tôi",102000,160000,58000,36
TIKI,nha-sach-tiki,68350215,"Combo Chinh Phục Luyện Thi Vào 10 Toán Văn Anh Theo Chủ Đề",313000,477000,164000,34
TIKI,nha-sach-tiki,81499980,"Danh Gia Cổ Vật - Minh Nhãn Mai Hoa",178000,230000,52000,23
TIKI,nha-sach-tiki,49904794,"Fullset Ehon Nhật Bản cho bé thông minh sáng tạo: Ehon Điều Kỳ Diệu Của Hình Khối + Điều Kỳ Diệu Của Âm Thanh + Điều Kỳ Diệu Của Màu Sắc (Bộ 10 cuốn cho bé 0-6 tuổi / Bộ Sách Phát Triển Trí Tuệ & Kích Thích Thị Giác Cho Bé)",269000,390000,121000,31
TIKI,nha-sach-tiki,9687403,"The Book Of Leadership - Dẫn Dắt Bản Thân, Đội Nhóm Và Tổ Chức Vươn Xa",150000,218000,68000,31
TIKI,nha-sach-tiki,191045567,"Làm Người Là Như Thế Nào? How To Be Human – The Manual",133000,179000,46000,26
TIKI,nha-sach-tiki,178240500,"Đường Gia Tiểu Miêu",133000,179000,46000,26
TIKI,nha-sach-tiki,190701640,"Diệt Slime Suốt 300 Năm, Tôi Levelmax Lúc Nào Chẳng Hay (Tập 4) - (Tái Bản)",48000,52000,4000,8
TIKI,nha-sach-tiki,195288800,"Combo 2 Cuốn Khám Phá Sứ Mệnh Với Câu Hỏi Tại Sao – Bắt Đầu Với Câu Hỏi Tại Sao",149000,208000,59000,28
TIKI,nha-sach-tiki,172175794,"Lý Thuyết Dow - Khoa Học Đầu Cơ Chứng Khoán: Bí Quyết Phân Tích Hành Vi Thị Trường Của Cha Đẻ Chỉ Số Dow Jones - Tác Phẩm Nền Tảng Của Phân Tích Kĩ Thuật Hiện Đại",37100,55000,17900,33
TIKI,nha-sach-tiki,77281352,"Lời giải bài tập Python cơ bản",75000,75000,0,0
TIKI,nha-sach-tiki,595738,"Giáo Trình Chuẩn HSK 4 Bài Tập (Tập 1)",111000,148000,37000,25
TIKI,nha-sach-tiki,541248,"Võ Nguyên Giáp - Những Năm Tháng Cuộc Đời (Tái Bản)",49400,82000,32600,40
TIKI,nha-sach-tiki,77917794,"Từ Nước Mắt Đến Nụ Cười - Tận Cùng Khổ Đau Đến Ngời Sáng Tâm Hồn",104000,148000,44000,30
TIKI,nha-sach-tiki,32855400,"Tâm Lý Học Đám Đông (Tái Bản) ( tặng kèm bookmark Sáng Tạo )",111650,149000,37350,25
TIKI,nha-sach-tiki,195306005,"Nhà thờ Đức Bà Paris (Bìa Cứng)",426000,650000,224000,34
TIKI,nha-sach-tiki,192161603,"Chú Thuật Hồi Chiến - Tập 5 - Bản Thường - Tặng Kèm Obi Và Thẻ Bo Góc Nhựa",29100,30000,900,3
TIKI,nha-sach-tiki,179547036,"Bộ Sách Khởi Nghiệp Du Kích - Kinh Doanh Ít Vốn: Làm Thế Nào Để Khởi Động và Vận Hành Doanh Nghiệp Bằng Nguồn Vốn Hạn Hẹp",325000,567000,242000,43
TIKI,nha-sach-tiki,169376042,"Từ Điển Tiếng Việt Hoàng Phê (Tái Bản)",495000,495000,0,0
TIKI,nha-sach-tiki,581983,"Việt Nam Sử Lược (Bản Đặc Biệt - Ấn Bản Kỉ Niệm 60 Năm NXB Kim Đồng)",177000,250000,73000,29
TIKI,nha-sach-tiki,67120562,"Đây Là Leonardo Da Vinci",109000,150000,41000,27
TIKI,nha-sach-tiki,92096347,"Trở Về Từ Xứ Tuyết (Tái Bản)",63900,92000,28100,31
TIKI,nha-sach-tiki,170490622,"Người Điều Khiển Mê Cung",106700,128000,21300,17
TIKI,nha-sach-tiki,15634596,"Búp Sen Xanh (Tái Bản)",72000,72000,0,0
TIKI,nha-sach-tiki,572247,"Chiến Thắng Kì Thi 9 Vào 10 Chuyên Vật Lý (Tập 1)",109000,189000,80000,42
TIKI,nha-sach-tiki,195291853,"Kỳ Nghỉ Dưỡng Của Chàng Quý Tộc Ôn Hòa (Tập 3)",149000,196000,47000,24
TIKI,nha-sach-tiki,104074530,"Tôi, Tương Lai Và Thế Giới (Tái Bản)",103000,160000,57000,36
TIKI,nha-sach-tiki,77988131,"Văn Học Kinh Điển - Thể Xác Và Tâm Hồn (Ấn Bản Phổ Thông - Bìa Cứng) [Tặng Kèm: Postcard + Bookmark]",179000,388000,209000,54
TIKI,nha-sach-tiki,176487508,"Trường Pháp Ở Việt Nam 1945 -1975",164400,249000,84600,34
TIKI,nha-sach-tiki,47504724,"Những Tấm Lòng Cao Cả (Tái Bản 2020)",59000,90000,31000,34
TIKI,nha-sach-tiki,195801321,"The One Thing - Điều Ý Nghĩa Nhất (Tái Bản 2022)",78000,119000,41000,34
TIKI,nha-sach-tiki,195928317,"Hộp Bút Túi Đựng Bút Đồ Dùng Học Tập Đồ Dùng Cá Nhân Học Sinh Họa Tiết Vui Nhộn Deli -  Bóp Viết Phù Hợp Cho Học Sinh, Đựng Mĩ Phẩm - Màu Sắc Tươi Sáng",39000,81000,42000,52
TIKI,nha-sach-tiki,52004412,"D. Trump - Nghệ Thuật Đàm Phán (Tái bản 2020)",74000,109000,35000,32
TIKI,nha-sach-tiki,115702579,"Quảng Cáo Không Nói Láo - Sự Thật Về Quảng Cáo Dưới Góc Nhìn Khoa Học, Toàn Diện Và Thực Tiễn",168000,195000,27000,14
TIKI,nha-sach-tiki,71658956,"Full Combo (Bộ 10 cuốn) Ehon Kỹ năng - Âm thanh - Nhận biết",167440,322000,154560,48
TIKI,nha-sach-tiki,69908762,"Luyện viết chữ Hán Sơ cấp 1 (Theo Giáo trình Hán ngữ BOYA)",129000,250000,121000,48
TIKI,nha-sach-tiki,10694902,"Tôi Tài Giỏi - Bạn Cũng Thế (Tái bản) + tặng kèm 1 bookmark",133500,133500,0,0
TIKI,nha-sach-tiki,10271803,"Combo Ngữ Pháp Và Giải Thích Ngữ Pháp Tiếng Anh Cơ Bản Và Nâng Cao",280000,400000,120000,30
TIKI,nha-sach-tiki,76443018,"Lược Sử Triết Học",106000,142000,36000,25
TIKI,nha-sach-tiki,59362963,"Osho Đàn Ông - The Book Of Men",85200,119000,33800,28
TIKI,nha-sach-tiki,67060014,"Phát Triển Trí Tuệ Cảm Xúc - Con Được Là Chính Mình!",37100,50000,12900,26
TIKI,nha-sach-tiki,173406524,"Kẻ Lãng Quên - Pháp Y Tần Minh",163500,163500,0,0
TIKI,nha-sach-tiki,94347312,"Cái Cười Của Thánh Nhân (Ts Thu Giang)(Tái Bản)",73000,105000,32000,30
TIKI,nha-sach-tiki,56819709,"Thiền Chữa Lành Thân Và Tâm (Tái Bản 2020)",67900,95000,27100,29
TIKI,nha-sach-tiki,59321997,"Luận Về Đại Chiến Lược",150220,259000,108780,42
TIKI,nha-sach-tiki,13828940,"Văn Học Kinh Điển Thế Giới - Phù Thủy Xứ OZ",57000,88000,31000,35
TIKI,nha-sach-tiki,59291594,"100 Phương Pháp Thực Tiễn Để Cải Thiện Trải Nghiệm Khách Hàng",99000,150000,51000,34
TIKI,nha-sach-tiki,185055210,"Có Lẽ Bạn Nên Gặp Bác Sỹ Tâm Lý",185000,249000,64000,26
TIKI,nha-sach-tiki,147265098,"Volume Profile - Góc nhìn từ người trong cuộc",209000,209000,0,0
TIKI,nha-sach-tiki,49549966,"Ba Người Lính Ngự Lâm (Đông A) (Tái Bản)",164000,250000,86000,34
TIKI,nha-sach-tiki,50322534,"Song Ngữ Việt - Anh - Diary Of A Wimpy Kid - Nhật Ký Chú Bé Nhút Nhát",76800,96000,19200,20
TIKI,nha-sach-tiki,197531553,"Blue Period - Tập 4 - Tặng Kèm Bookmark Giấy",45600,48000,2400,5
TIKI,do-choi-me-be,119706884,"Sữa tắm gội dịu lành cho bé Cetaphil Baby Wash & Shampoo with Organic Calendula 400ml",295000,295000,0,0
TIKI,do-choi-me-be,10021580,"Sữa Bột Meiji 1-3 Growing Up Formula (800g)",455000,455000,0,0
TIKI,do-choi-me-be,7250239,"Chất Thông Cống Siêu Mạnh SiFa (1.6kg)",65000,65000,0,0
TIKI,do-choi-me-be,138581421,"Combo 10 Gói Khăn Ướt Yuniku 20 Tờ Hương Hoa Lài ( 20 Tờ x 10 )",95000,137000,42000,31
TIKI,do-choi-me-be,107935064,"Bình sữa mô phỏng tự nhiên hiệu Philips Avent (260 ml - đơn) cho trẻ từ 1 tháng tuổi 693.13",295000,295000,0,0
TIKI,do-choi-me-be,104883479,"Nước Rửa Chén Gốc Thực Vật Peace Mass Công Nghệ Enzyme Rửa Sạch & Không Lưu Mùi (Thuộc nhóm Sản phẩm Lành tính / Hữu cơ) Can 3.6 Lít",162450,171000,8550,5
TIKI,do-choi-me-be,104341333,"Xe đẩy cho bé, Xe Đẩy Gấp Gọn 2 Chiều Thông Minh Cho Bé, Xe Đẩy Dạo Chơi Cho Bé Du Lịch",310000,310000,0,0
TIKI,do-choi-me-be,108598576,"[LOẠI XỊN - CÓ CHỌN SIZE] Cờ Vây Nam Châm Cao Cấp, Cờ Caro Tiện Dụng Chính Hãng - Chọn Nhiều Cỡ",155000,155000,0,0
TIKI,do-choi-me-be,109372981,"Hộp 6 bộ đồ chơi lắp ráp Robot biến hình - Khủng long (553 chi tiết) Qman 1414",339000,349000,10000,3
TIKI,do-choi-me-be,55294509,"Đồ Chơi Lắp Ghép Bộ Chữ Số Biến Hình Từ 1 2 3 4 5 6 7 8 9 Thành Robot",299000,400000,101000,25
TIKI,do-choi-me-be,173910843,"Xe ô tô điều khiển từ xa KAVY 058 bằng cử chỉ có nhạc, đèn phun được khói xoay 360 độ cao",525000,525000,0,0
TIKI,do-choi-me-be,150565149,"Bộ Dụng Cụ Lấy Ráy Tai Có Đèn Led Cao Cấp Kèm Hộp Đựng Sịn Sò Sử Dụng Cổng Sạc USB",179000,179000,0,0
TIKI,do-choi-me-be,108753317,"Núm ty Silicon mô phỏng tự nhiên hiệu Philips Avent cho trẻ sơ sinh",225000,225000,0,0
TIKI,do-choi-me-be,435753,"Sữa Bột Abbott Grow 3 cho trẻ từ 1- 2 tuổi (900g)",295000,295000,0,0
TIKI,do-choi-me-be,30911702,"Bộ Bài Tarot Bói Smith Waite Tarot  Cao Cấp",89000,89000,0,0
TIKI,do-choi-me-be,196675403,"Cốc tập uống bằng nhựa HiPP - Nhập khẩu Đức (Màu ngẫu nhiên)",75000,75000,0,0
TIKI,do-choi-me-be,74871422,"Đồ chơi xe ô tô địa hình chạy đà KAVY quán tính bằng nhựa nguyên sinh an toàn, chạy rất xa và khỏe",24000,24000,0,0
TIKI,do-choi-me-be,26303479,"Cốc Hút Sữa Silicon NatureBond Chính Hãng Hoa Kỳ, số 1 tại Anh, Canada + Nút chặn chống đổ sữa, túi nhung cao cấp",499000,499000,0,0
TIKI,do-choi-me-be,54412956,"Bộ Cờ Cá Ngựa – Cờ Cá Ngựa Nam Châm – Chính Hãng An Toàn Vui Nhộn Cho Bé (Vỏ Hộp Màu Ngẫu Nhiên)",95000,130000,35000,27
TIKI,do-choi-me-be,81227999,"Xe Cứu Hoả Duka DK81039",135000,180000,45000,25
TIKI,do-choi-me-be,171666372,"[Tặng 12 màu + 2 cọ] Combo 20 tượng thạch cao size 5cm - Tô tượng cho bé",55000,55000,0,0
TIKI,do-choi-me-be,57930183,"Hộp 8 bộ đồ chơi lắp ráp Trực thăng tấn công 8in1 Qman 1801 (381 chi tiết)",199000,269000,70000,26
TIKI,do-choi-me-be,198614354,"Bình Trữ Sữa Cổ Rộng Mama's Choice 180ml–240ml, Tương Thích Máy Hút Sữa Spectra, Avent, Fatz, Rozabi, Cimilre",92000,95000,3000,3
TIKI,do-choi-me-be,116727455,"(Date mới) Sữa Hữu Cơ Miwako A+ Hộp 700g Vị Vani Nhập Khẩu Malaysia, Sữa Hạt Organic Dinh Dưỡng Phát Triển Trí Não & Chiều Cao Cho Bé Từ 1-6 Tuổi Vị Ngọt Thanh Dễ Uống",649000,675000,26000,4
TIKI,do-choi-me-be,263388843,"Viên giặt xả Bold Gel Ball 3D hương hoa túi 44 viên của Nhật Bản",179000,179000,0,0
TIKI,do-choi-me-be,77014311,"Nước Rửa Chén Sinh Học ENZYCO Lên Men Tự Nhiên Từ Dứa Và Bồ Hòn An Toàn Cho Da Tay Và Diệt Khuẩn - Hương Cam 480ml",100000,100000,0,0
TIKI,do-choi-me-be,2682725,"Thuốc viên diệt gián nội địa Nhật Bản",66000,77000,11000,14
TIKI,do-choi-me-be,51661295,"Vitamin k2 d3 Lineabon từ Châu Âu chứa MK7 giúp hấp thụ calci – Hỗ trợ hấp thu canxi tự nhiên cho trẻ, giúp tăng chiều cao, hết còi xương - Hết ngay khóc đêm, trằn trọc, mồ hôi trộn",275000,369000,94000,25
TIKI,do-choi-me-be,879798,"3 Gói Khăn Ướt Yuniku Max Cool YK20-02 (20 Tờ x 3) - 3 Màu",29000,41100,12100,29
TIKI,do-choi-me-be,115483210,"Sữa bột Enfagrow A+ NeuroPro 3 với 2’-FL HMO cho trẻ từ 1 – 3 tuổi – 830g",492000,492000,0,0
TIKI,do-choi-me-be,197529904,"Học liệu bóc dán thông minh cho bé, học liệu busy book 17 chủ đề đa dạng dùng nhiều lần",89500,89500,0,0
TIKI,do-choi-me-be,184101595,"Combo 2 túi Nước giặt OMO Matic Comfort Hương Hoa Hồng Ecuador cho máy giặt cửa trên, túi 3.6kg",350000,454000,104000,23
TIKI,do-choi-me-be,64978053,"Combo 4 Gói Khăn Ướt Max Cool 80 Tờ Có Hương Tặng 2 Gói Cùng Loại",124000,124000,0,0
TIKI,do-choi-me-be,104850929,"Váy đầm bé gái Hồng Chấm Bi Cổ Vàng KIKA - Size 11-45kg - K139",199000,199000,0,0
TIKI,do-choi-me-be,89802357,"Nước Rửa Bát Hữu Cơ ENZYCO Lên Men Từ Bồ Hòn Và Dứa Không Chất Tẩy Công Nghiệp Không Gây Dị Ứng Cho Tay An Toàn Cho Trẻ Nhỏ Mùi Hương - Chai",180000,180000,0,0
TIKI,do-choi-me-be,50615508,"Xe gà cho bé tập đi bằng gỗ siêu bền",95997,95997,0,0
TIKI,do-choi-me-be,144121555,"Túi Trữ Sữa Và Bảo Quản Sữa Mẹ Mama’s Choice, Bịch Đựng Sữa Mẹ, Có Khóa Zip Tiện Lợi An Toàn, Lẻ 10 Túi",65000,87000,22000,25
TIKI,do-choi-me-be,95035813,"Bột ăn dặm dinh dưỡng Sữa, Chuối, Đào HiPP Organic 250g",145000,145000,0,0
TIKI,do-choi-me-be,109123361,"Combo 60 túi trữ sữa mẹ Sunmum mini hồng 100ml (2 hộp) tặng 2 zipper bảo quản",125000,138000,13000,9
TIKI,do-choi-me-be,115694868,"Đồ chơi lắp ráp xếp hình robot người máy Qman 1414 - Siêu Robot khủng long (456 mảnh ghép) dành cho bé trên 6 tuổi",259000,359000,100000,28
TIKI,thiet-bi-kts-phu-kien-so,113568856,"Tai nghe chụp tai không dây Remax RB-660HB - Hàng chính hãng",563500,700000,136500,20
TIKI,thiet-bi-kts-phu-kien-so,273908828,"Bộ sạc nhanh IP, Android chuẩn PD 20W iCybernet IC-3002 cáp C to C 1,2m (Cáp hỗ trợ sạc tối đa 100W cho mọi thiết bị typeC) - Hàng chính hãng",192000,300000,108000,36
TIKI,thiet-bi-kts-phu-kien-so,273908702,"Bộ sạc nhanh IP công suất 20W chuẩn PD iCybernet IC-3001 (C to L cho IP14 trở xuống) - Hàng chính hãng",192000,300000,108000,36
TIKI,thiet-bi-kts-phu-kien-so,273906522,"Cáp sạc USB to IP iCybernet IC-1001 sạc 2.4A và truyền dữ liệu đồng thời, chiều dài 1,2m - Hàng chính hãng",58000,100000,42000,42
TIKI,thiet-bi-kts-phu-kien-so,273906695,"Cáp sạc và truyền dữ liệu 2.4A iCybernet IC-1002 USB to TypeC - Hàng chính hãng",58000,100000,42000,42
TIKI,thiet-bi-kts-phu-kien-so,161007768,"Ốp lưng dẻo mỏng dành cho iPhone 11 / 12 / 13 / 11 Pro / 12 Pro / 13 Pro / 11 Pro Max / 12 Pro Max / 13 Pro Max / 12 Mini / 13 Mini - Hàng chính hãng",49000,69000,20000,29
TIKI,thiet-bi-kts-phu-kien-so,181772131,"Tai Nghe Bluetooth Chụp Tai Sony WH-1000XM5 Hi-Res Noise Canceling - Hàng Chính Hãng",6890000,7990000,1100000,14
TIKI,thiet-bi-kts-phu-kien-so,125781,"Tai Nghe Nhét Tai Sony Fontopia MDR-E9LP",143000,159000,16000,10
TIKI,thiet-bi-kts-phu-kien-so,170273830,"Thẻ nhớ Micro SD Hikvision 32GB 64GB 128GB Class 10 tốc độ 92MB/s - Hàng chính hãng",120000,160000,40000,25
TIKI,thiet-bi-kts-phu-kien-so,855600,"Tai Nghe Nhét Tai Sony MDR-EX155AP",350000,390000,40000,10
TIKI,thiet-bi-kts-phu-kien-so,273908414,"Cáp sạc nhanh IP chuẩn PD 20W iCybernet IC-1003 TypeC to IP chiều dài 1,2m - Hàng chính hãng",98000,150000,52000,35
TIKI,thiet-bi-kts-phu-kien-so,273891515,"Cáp sạc siêu nhanh PD 100W iCybernet IC-1004 C to C chiều dài 1m - Hàng chính hãng",98000,150000,52000,35
TIKI,thiet-bi-kts-phu-kien-so,216238849,"Bộ sạc nhanh cho IP công suất 18W Remax RP-U37 - Hàng chính hãng",249000,300000,51000,17
TIKI,thiet-bi-kts-phu-kien-so,102391960,"Giá Đỡ Máy Tính, Laptop, iPad, Macbook Hợp Kim Nhôm Cao Cấp. Hỗ Trợ Tản Nhiệt Chống Mỏi Cổ, Vai, Gáy. Hàng Chính Hãng Tamayoko",450000,500000,50000,10
TIKI,thiet-bi-kts-phu-kien-so,272913331,"Thiết bị theo dõi thông minh Samsung Galaxy SmartTag2-Hàng Chính hãng",355000,355000,0,0
TIKI,thiet-bi-kts-phu-kien-so,13119283,"Bút Cảm Ứng Dành  Cho SMARTPHONE VÀ IPAD -Giao  Màu  Ngẩu Nhiên",6430,8788,2358,27
TIKI,thiet-bi-kts-phu-kien-so,15251528,"Đầu Chuyển HDMI ra VGA",25300,25300,0,0
TIKI,thiet-bi-kts-phu-kien-so,176752662,"Kính Cường Lực Kingkong iPhone, Màn Nhám Chống Vân Tay Dành Cho Game Thủ - Full Hộp - Hàng Chính Hãng",88000,135000,47000,35
TIKI,thiet-bi-kts-phu-kien-so,179541784,"Cáp sạc nhanh siêu bền C to IP Baseus Dynamic Series FAST CHARGING DATA CABLE 20W dùng cho IP 13,12,... - Hàng chính hãng",101000,159000,58000,36
TIKI,thiet-bi-kts-phu-kien-so,72796676,"Giá Đỡ Laptop Hợp Kim Nhôm Cao Cấp Có Thể Gấp Gọn, Giúp Tản Nhiệt Laptop, Macbook, Máy Tính Xách Tay. 07 Vị Trí Điều Chỉnh Góc Độ. Hàng Chính Hãng Tamayoko FS060",199000,229000,30000,13
TIKI,thiet-bi-kts-phu-kien-so,80857582,"Kính Cường Lực Chống Nhìn Trộm KingKong Dành Cho iPhone - Full Hộp - Dán Full Màn - Hàng Chính Hãng ",34000,34000,0,0
TIKI,thiet-bi-kts-phu-kien-so,73324095,"Bộ điều khiển thông minh Google Chromecast with Google TV - Hàng Nhập Khẩu",1300000,1610000,310000,19
TIKI,thiet-bi-kts-phu-kien-so,76067387,"Đầu đọc thẻ nhớ 2.0 Hoco HB20 Mindful - hỗ trợ khe microSD/SD (Hàng chính hãng)",79000,79000,0,0
TIKI,thiet-bi-kts-phu-kien-so,63912442,"Giá Đỡ Điện Thoại Gấp Gọn, Tùy Chỉnh Độ Cao - DT056",16676,16676,0,0
TIKI,thiet-bi-kts-phu-kien-so,251518071,"Cáp sạc nhanh chuẩn PD 20W cho IP Remax RC-183i chiều dài 2m - Hàng chính hãng",144550,200000,55450,28
TIKI,thiet-bi-kts-phu-kien-so,56049649,"CỐC SẠC NHANH 15W 2 CỔNG CHỐNG CHÁY NỔ HOCO C73 - CỦ SẠC ĐA NĂNG 2.4A CHO CÁC DÒNG ĐIỆN THOẠI CHÍNH HÃNG",69000,119000,50000,42
TIKI,thiet-bi-kts-phu-kien-so,167528098,"HUB TYPE C Và HUB USB 3.0 Tốc Độ Cao Chia 4 Cổng VinBuy, HUB Chuyển Đổi Dành Cho Macbook Pro Laptop PC Hỗ Trợ Sạc Pin Kết Nối Đa Năng Ổ Cứng Bàn Phím Chuột Máy In, Thiết Bị Ổ Chia USB - Hàng Chính Hãng",88000,300000,212000,71
TIKI,thiet-bi-kts-phu-kien-so,189474023,"Sạc dự phòng không dây từ tính Remax RPP-65 10000mAh - Hàng chính hãng",753500,990000,236500,24
TIKI,thiet-bi-kts-phu-kien-so,67907870,"Chuột Bluetooth Silent Logitech Pebble M350 - Hàng chính hãng",418000,599000,181000,30
TIKI,thiet-bi-kts-phu-kien-so,56608719,"Chuột không dây Bluetooth  HXSJ M90 - Hàng chính hãng",139000,168000,29000,17
TIKI,thiet-bi-kts-phu-kien-so,191502436,"Dây Đeo Thay Thế Viền Dành Cho Vòng Đeo Tay Thông Minh Xiaomi Mi Band 5/ Miband 6 - Hàng chính hãng",42000,45000,3000,7
TIKI,thiet-bi-kts-phu-kien-so,154835064,"Đồng hồ Thông minh Trẻ em AMA Watch Q15 lắp SIM nghe gọi 2 chiều 3 màu Xanh Hồng Đen Hàng chinh hãng",400000,400000,0,0
TIKI,thiet-bi-kts-phu-kien-so,35420153,"Cáp sạc nhanh, truyền dữ liệu tốc độ cao Baseus Cafule Type C cho Samsung S8/S9/ Note8/ Note9/ Xiaomi/ Huawei/ Oppo/Nokia ( 3A, Sạc nhanh Quick charge 3.0, Siêu bền)- Hàng nhập khẩu",87000,159000,72000,45
TIKI,thiet-bi-kts-phu-kien-so,201437484,"Giá Đỡ Máy Tính, Laptop, iPad, Macbook Hợp Kim Nhôm Cao Cấp. Hỗ Trợ Tản Nhiệt Chống Mỏi Cổ, Vai, Gáy. Hàng Chính Hãng Tamayoko",489000,489000,0,0
TIKI,thiet-bi-kts-phu-kien-so,113568856,"Tai nghe chụp tai không dây Remax RB-660HB - Hàng chính hãng",563500,700000,136500,20
TIKI,thiet-bi-kts-phu-kien-so,56885648,"Đầu Chuyển Đổi USB Type C Sang USB 3.0 Hàng Chính Hãng Helios",59000,59000,0,0
TIKI,thiet-bi-kts-phu-kien-so,67517393,"Thẻ Nhớ Camera Hikvision 64Gb Class 10 ( Chuyên dùng cho Camera IP ) - Hàng Chính hãng",84000,84000,0,0
TIKI,thiet-bi-kts-phu-kien-so,132144149,"Cường Lực Chống Nhìn Trộm KingKong Dành Cho iPhone X-XS, XS Max, iPhone 11, 11Pro, 11ProMax, iPhone 12, 12Mini, 12Pro, 12Pro Max, iPhone 13, 13Mini, 13Pro, 13Pro Max - Dán Full Màn - Hàng Chính Hãng",35000,35000,0,0
TIKI,thiet-bi-kts-phu-kien-so,107067035,"Thẻ Nhớ SanDisk Ultra MicroSDXC UHS-1 100 MB/s Class 10 32GB/64GB/128GB - Hàng Chính Hãng",110000,141000,31000,22
TIKI,thiet-bi-kts-phu-kien-so,123843835,"Cây chọt sim điện thoại, que chọc sim để sau ốp lưng dành cho iphone 5/5s/6/6plus/6s/6s plus/6/7/7plus/8/8plus/x/xs/xs max",3900,3900,0,0
TIKI,thiet-bi-kts-phu-kien-so,97547734,"Giá Đỡ Để Bàn Điện Thoại Di Động, Máy Tính Bảng, Ipad Hợp Kim Nhôm Cao Cấp Hai Trục Xoay 180 Độ Chống Đổ Hàng Chính Hãng Tamayoko",390000,450000,60000,13
TIKI,thiet-bi-kts-phu-kien-so,359484,"Bàn phím có dây Logitech K120 - Hàng chính hãng",146000,179000,33000,18
TIKI,thiet-bi-kts-phu-kien-so,112287571,"Đồng Hồ Thông Minh cho Trẻ em 6 tuổi, 7 tuổi, 8 tuổi, 9 tuổi, 10 tuổi, 11 tuổi Lắp Sim Độc lập nghe gọi 2 chiều AMA Watch Y92 Chống nước Định vị Wifi độ chính xác cao Hàng nhập khẩu",577000,577000,0,0
TIKI,thiet-bi-kts-phu-kien-so,145495427,"Thẻ Nhớ Lexar MICRO 633X Tốc Độ 100mb/s - Hàng Chính Hãng",88000,88000,0,0
TIKI,thiet-bi-kts-phu-kien-so,107071890,"Miếng Kê tay, Thanh Kê Tay Bàn Phím Cực Dễ Thương Nhiểu Mẫu Mới_ Hàng Chính Hãng",136843,144045,7202,5
TIKI,thiet-bi-kts-phu-kien-so,111978854,"Hub Chuyển Đổi USB Type C to HDMI CHOETECH HUB-H10 Độ Phân Giải 4K 60Hz, 1080P Cho Tivi/Laptop/Playstation/PC - Hàng Chính Hãng",299000,590000,291000,49
TIKI,thiet-bi-kts-phu-kien-so,88796437,"Dây Cáp Nối Dài Âm Thanh 2 Đầu Đực 3.5mm Dài 1.2M CHOETECH AUX002 - Hàng Chính Hãng",99000,150000,51000,34
TIKI,thiet-bi-kts-phu-kien-so,111484548,"Dây cáp VGA 1.5M Đen chống nhiễu loại cực tốt",19470,19470,0,0
TIKI,thiet-bi-kts-phu-kien-so,195300861,"Cáp ANKER Powerline III Flow USB-C To USB-C - A8552 / A8553 - Siêu Mềm Mại và Bền Bỉ - Hàng Chính Hãng",180000,300000,120000,40
TIKI,thiet-bi-kts-phu-kien-so,192977208,"Đồng hồ Thông minh Chống nước IP67 Dành cho Trẻ em nhuẩn AMA Watch Q16S Hàng chính hãng",395000,395000,0,0
TIKI,thiet-bi-kts-phu-kien-so,74343712,"Dây Nguồn Laptop 1.5m",18945,37890,18945,50
TIKI,thiet-bi-kts-phu-kien-so,53977774,"Phụ kiện giữ dây cáp sạc Giá Silicon mini cố định dây cáp sạc cho các thiết bị điện tử trên bàn làm việc - Hàng Chính Hãng",20000,69000,49000,71
TIKI,thiet-bi-kts-phu-kien-so,112087792,"Thẻ nhớ chuyên camera Mirco SD HIKVISION  64G - 32GB - 92MB/s, chuyên ghi hình cho camera, máy ảnh, ... Hàng nhập khẩu",71900,71900,0,0
TIKI,thiet-bi-kts-phu-kien-so,49658272,"Đen - Dây cáp sạc nhanh Type-C dài 2M hiệu Baseus Cafule Type C to Type C PD truyền data tốc độ cao  cho Smartphone / Tablet / Macbook / Laptop Type C Samsung Huawei Oppo Xiaomi (3A, 60W, Sạc nhanh PD, Sạc nhanh QC 4.0 Quick Charge)-Hàng nhập khẩu",93000,109000,16000,15
TIKI,thiet-bi-kts-phu-kien-so,133637826,"CÂY CHỌC SIM ĐIỆN INOX - QUE CHỌC SIM INOX HÌNH GIỌT NƯỚC",1000,3000,2000,67
TIKI,do-choi-me-be,78283430,"Đồ chơi mô hình xe bus 2 tầng mui trần  KAVY có nhạc và đèn chạy cót bằng kim loại bền bỉ, xe thăm quan du lịch thành phố",185000,185000,0,0
TIKI,do-choi-me-be,131192983,"[HÀNG CHÍNH HÃNG] Nước lau sàn chuyên dụng dành riêng cho Robot hút bụi lau nhà ECOVACS DEEBOT / ILIFE / XIAOMI / LIECTROUX / IROBOT",96900,96900,0,0
TIKI,do-choi-me-be,51064515,"Tấm lót chống thấm cho bé Organic Good Cotton Babyup. Miếng lót chống thấm 4 lớp. Tấm lót thay tả mềm mại, thoáng khí, siêu thấm hút, có thể giặt, an toàn cho bé",139000,199000,60000,30
TIKI,do-choi-me-be,107995394,"Bộ 2 Bình sữa mô phỏng tự nhiên hiệu Philips Avent (125 ml) cho trẻ từ 0 tháng tuổi 690.23",485000,485000,0,0
TIKI,do-choi-me-be,146618294,"Hộp 6 bộ đồ chơi lắp ráp Robot biến hình - Phương tiện cảnh sát ( 453 chi tiết) Qman 41104",329000,349000,20000,6
TIKI,do-choi-me-be,55500745,"Bộ đồ chơi nhà bếp cao 40cm",209000,209000,0,0
TIKI,do-choi-me-be,49884596,"Sữa Morinaga Số 3 Hương Vani - Kodomil (850g) dành cho bé trên 36 tháng tuổi",432000,551000,119000,22
TIKI,do-choi-me-be,173339381,"Mũ Bảo Hiểm Tập Đi An Toàn Cho Bé 7 Tháng đến 4 Tuổi nhẹ gọn, thoáng mát đầu bé",89800,89800,0,0
TIKI,do-choi-me-be,212607471,"Ensure Đức cho người lớn tuổi Ensure Vanille-Geschmask giúp hồi phục sức khỏe cho người gầy, suy dinh dưỡng - QuaTangMe Extaste",496000,992000,496000,50
TIKI,do-choi-me-be,59493903,"Phụ kiện tóc cho bé phong cách Hàn Quốc 17 món kèm hộp, giao màu ngẫu nhiên+ Tặng kèm hình dán nam châm hình que kem cho bé",69000,89700,20700,23
TIKI,do-choi-me-be,88820588,"Hộp 30 túi trữ sữa sunmum mini 100ml Thái Lan (có tem niêm phong) tặng 2 zipper 15x20cm",69000,69000,0,0
TIKI,do-choi-me-be,95269411,"Tã Dán Siêu Cao Cấp Huggies Platinum Naturemade XL44 (44 Miếng)",329000,460000,131000,28
TIKI,do-choi-me-be,104137482,"Núm vú cổ hẹp silicone mềm Pigeon (2 cái/vỉ)",9000,26000,17000,65
TIKI,do-choi-me-be,89221426,"Hai lốc giấy vệ sinh An Khang Classic10 hai lớp - 10 cuộn / lốc",72000,104000,32000,31
TIKI,do-choi-me-be,14766073,"Bộ bài UNO  giấy cứng",19600,19600,0,0
TIKI,do-choi-me-be,168293316,"Canxi & vitamin D Ostelin Úc cho bà bầu (130 viên)",330000,330000,0,0
TIKI,do-choi-me-be,143778813,"Cờ tỷ phú Monopoly - Việt Nam Phiên Bản cao cấp",351000,351000,0,0
TIKI,do-choi-me-be,50415176,"Sữa Tắm Gội Trẻ Em Lactacyd Bb GIẢM RÔM SẢY và HĂM KẼ VƯỢT TRỘI 250ml",97000,101000,4000,4
TIKI,do-choi-me-be,104850831,"Váy đầm thun cho bé gái mùa hè mầu vàng cổ sen dây nơ - Size 11-45kg - K140",199000,199000,0,0
TIKI,do-choi-me-be,7187943,"Sữa Bột Vinamilk Sure Diecerna - Hộp Thiếc 900g",585000,585000,0,0
TIKI,do-choi-me-be,43282996,"Cờ Vua Nam Châm Cao Cấp 25cm, 32cm, 36cm – Hàng Chính Hãng",89000,89000,0,0
TIKI,do-choi-me-be,42794160,"COMBO 3 Bộ Quần áo Tole lanh Bé Gái | Mẫu đùi Cánh Tiên cài nút sau - Size 1-16 cho bé 5-43kg -  Hàng Việt Nam chất lượng",117000,117000,0,0
TIKI,do-choi-me-be,131246833,"Lều Xông Hơi Tự Bung Lều Xông Hơi Sau Sinh Trị Cúm Tại Nhà Kèm Nồi Hơi Cao Cấp Dung Tích 2L",539000,539000,0,0
TIKI,do-choi-me-be,164075724,"Tả quần Kitin Natural size XL38 (12-15kg)",140000,225000,85000,38
TIKI,do-choi-me-be,49209058,"Combo 3 Khăn Tắm Bonny Sợi Tre Siêu Mềm Và Thấm Hút Cho Bé",285000,285000,0,0
TIKI,do-choi-me-be,192650438,"Sữa Tắm Gội Trẻ Em Lactacyd Baby Gentle Care Bảo Vệ Dịu Nhẹ Cho Làn Da Nhạy Cảm 500ml",183000,183000,0,0
TIKI,do-choi-me-be,116572132,"Combo 2 lon sữa bột dinh dưỡng công thức HiPP 2 Organic Combiotic chất lượng hữu cơ tự nhiên an toàn, bổ sung Omega 3 (DHA & ALA) dành cho trẻ từ 6 đến 12 tháng tuổi (2 lon x 800g)",1440000,1440000,0,0
TIKI,do-choi-me-be,180396538,"Đai địu vải 4 tư thế có đỡ cổ cho bé sơ sinh, trẻ em 36 tháng tuổi ngồi xe máy an toàn - MySun",144000,255000,111000,44
TIKI,do-choi-me-be,19944395,"Tã Quần Moony Natural Bông Organic L36 (36 Miếng)",280000,280000,0,0
TIKI,do-choi-me-be,34024059,"Bô vệ sinh cho bé Kiu Kiu babyhop NM-105",188000,320000,132000,41
TIKI,do-choi-me-be,49184432,"Đồ bơi cho bé gái quần short dài tay size từ 28kg đến 45kg",249000,283090,34090,12
TIKI,do-choi-me-be,112969206,"Bộ Thẻ Bài Pokemon 25 Thẻ Sword Shield BATTLESTYLES ( Mẫu Ngẫu Nhiên) Loại Cao cấp",25000,25000,0,0
TIKI,do-choi-me-be,37130044,"Vệ sinh máy rửa bát Finish",99000,99000,0,0
TIKI,do-choi-me-be,164075817,"Tả quần Kitin Natural size XXXL34(>18kg)",140000,225000,85000,38
TIKI,do-choi-me-be,87894726,"Xe Trượt Scooter 3 Bánh Phát Sáng Cho Bé Bằng Nhựa - Kiểu mới",161000,280000,119000,43
TIKI,do-choi-me-be,107020740,"Đồ chơi Câu Cá Đại Dương Duka",104250,139000,34750,25
TIKI,do-choi-me-be,58978895,"Vi Sinh Xử Lý Hầm Cầu, Bể Phốt Bị Đầy - EcoClean Septic - Nhập Khẩu Mỹ - Túi 100gram",82000,82000,0,0
TIKI,do-choi-me-be,91256196,"Nước rửa chén diệt khuẩn KAO Kyukyutto Clear 1380mL nội địa Nhật - Hương bưởi",159740,163000,3260,2
TIKI,do-choi-me-be,79126494,"Combo 10 Nút bịt ổ điện an toàn cho bé chất liệu nhựa ABS cao cấp",6605,9026,2421,27
TIKI,do-choi-me-be,27731018,"Đồ Chơi Bác Sĩ 31 Chi Tiết Có Đèn Và Áo Mũ Blouse - Màu Hồng",119000,119000,0,0
TIKI,do-choi-me-be,84785219,"Bàn chải đánh răng trẻ em Curly Sue nhập khẩu Hàn Quốc (Dành cho bé từ 3 đến 8 tuổi)",7000,36000,29000,81
TIKI,do-choi-me-be,12425734,"Lốc 4 Gói Khăn Giấy Cao Cấp Tempo Softpack Không Mùi, 4 Lớp, Không Gây Kích Ứng Da (90 Tờ/ Gói) - Thương Hiệu Đức",105000,105000,0,0
TIKI,do-choi-me-be,73854854,"Bộ Cờ Cá Ngựa Hộp Nhựa Chắc Chắn 30Cmx30Cm",38000,38000,0,0
TIKI,do-choi-me-be,55961916,"Bột Giặt LIX Extra Hương Hoa 2.4Kg EB024 - Tẩy Sạch Vết Bẩn Cực Mạnh",72000,72000,0,0
TIKI,do-choi-me-be,105778887,"Đồ chơi mô hình 6 xe cảnh sát hình sự KAVY No.8807 nhiều màu sắc bằng kim loại",132000,132000,0,0
TIKI,do-choi-me-be,116572117,"Thùng 6 lon sữa bột dinh dưỡng công thức HiPP 2 Organic Combiotic chất lượng hữu cơ tự nhiên an toàn, bổ sung Omega 3 (DHA & ALA) dành cho trẻ từ 6 đến 12 tháng tuổi (6 lon x 800g)",4320000,4320000,0,0
TIKI,do-choi-me-be,94728359,"Gối cao su non cho bé 100% Cotton hữu cơ có lỗ chống ngạt cho bé Comfybaby 6201 - Đồ dùng cho bé từ sơ sinh tới 8 tuổi - CF062018N03 & CFN01",299000,380000,81000,21
TIKI,do-choi-me-be,97856241,"Bộ Quây Cũi Nhựa Gấp Gọn Cho Bé Yêu- Tặng Thảm Xốp, Bóng Và Sọt Đựng Bóng",1390000,1390000,0,0
TIKI,do-choi-me-be,273180228,"Sure Prevent Gold HT",605000,630904,25904,4
TIKI,do-choi-me-be,3005389,"Dung Dịch Giặt Quần Áo Cho Bé D-Nee - Chai 3000ml (Xanh lá)",196000,245000,49000,20
TIKI,do-choi-me-be,116572134,"Thùng 4 lon sữa bột dinh dưỡng công thức HiPP 2 Organic Combiotic chất lượng hữu cơ tự nhiên an toàn, bổ sung Omega 3 (DHA & ALA) dành cho trẻ từ 6 đến 12 tháng tuổi (4 lon x 800g)",2880000,2880000,0,0
TIKI,do-choi-me-be,108550701,"Lều công chúa cho Bé Ngủ chơi Lều công chúa, lều hoàng tử s5 vải mềm siêu đẹp cho bé hàng loại 1",265000,265000,0,0
TIKI,do-choi-me-be,115483447,"Sữa bột Enfamil A+ NeuroPro 2 với 2’-FL HMO cho trẻ từ 6 –12  tháng tuổi– 400g",266000,266000,0,0
TIKI,do-choi-me-be,96608806,"Nước giặt đồ lót Lingerie Soap 120ml",94500,94500,0,0
TIKI,do-choi-me-be,74512193,"Gấu Bông Gối Ôm Khủng Long Đuôi Tim Bông Gòn Cao Cấp",50000,50000,0,0
TIKI,do-choi-me-be,10710902,"Sữa bột Vinamilk Dielac Alpha 4 - Hộp thiếc 1500g (dành cho trẻ 2-6 tuổi)",343000,389000,46000,12
TIKI,do-choi-me-be,1380475,"Combo 3 Gói Khăn Giấy Ướt 100 Tờ Không Mùi Kháng Khuẩn An Toàn Cho Bé Mamamy ( 100 Tờ Nắp x 3)",101000,101000,0,0
TIKI,do-choi-me-be,629921,"Bộ 2 Gói Nước Rửa Bình Sữa Wesser (500ml x 2)",160000,160000,0,0
TIKI,do-choi-me-be,49232078,"Gạc Rơ Lưỡi Dr Papie Vệ Sinh Răng Miệng Cho Bé , Gạc Răng Miệng Dr Papie Làm Sạch Răng Miệng Cho Bé Hộp 30 Miếng",110000,110000,0,0
TIKI,do-choi-me-be,127197584,"Xe đồ chơi mô hình đầu kéo container vận chuyển KAVY No.8807 đầu hợp kim tháo rời kích thước lớn tỷ lệ 1:48 - nhiều màu",125000,125000,0,0
TIKI,do-choi-me-be,50256293,"Nước Tẩy Trắng Quần Áo Lix Javel 1kg",20000,20000,0,0
TIKI,do-choi-me-be,49957356,"Bánh Ăn Dặm Gạo Lứt Phô Mai Bebedang Cho Bé Nhập Khẩu Hàn Quốc",43500,55000,11500,21
TIKI,do-choi-me-be,20024063,"Thùng 48 Hộp x 110ml Sữa Bột Pha Sẵn GrowPLUS+ Đỏ 110ml Suy Dinh Dưỡng - Hàng Chính Hãng",385000,385000,0,0
TIKI,do-choi-me-be,53627304,"Chất tẩy xi măng trên nhiều chất liệu, tẩy ron gạch siêu mạnh HT01-TVS -5 Lit (sản phẩm mới hoạt chất bảo vệ bề mặt 100%, chất lượng cao)",350000,399000,49000,12
TIKI,do-choi-me-be,171833960,"Viên Xông Giúp Thông Mũi Họng Giảm Nghẹt Mũi Sổ Mũi Tinh Dầu Hương Tràm ( Hộp 20 viên )",59400,59400,0,0
TIKI,do-choi-me-be,196177336,"Khăn Giấy Lụa Rút 2 lớp Bless You À La Vie cao cấp x 250 tờ",26000,40000,14000,35
TIKI,do-choi-me-be,13566900,"Combo 3 hộp khăn khô đa năng Mamamy",165000,165000,0,0
TIKI,do-choi-me-be,58457905,"Tấm lót chống thấm cho bé cao cấp - Kích thước 70x120cm. Miếng lót chống thấm thoáng khí, siêu thấm và an toàn cho trẻ sơ sinh và trẻ nhỏ - TLCTCB00001",245000,245000,0,0
TIKI,do-choi-me-be,129976841,"Gối Ôm Bà Bầu Chữ U vải nhung mềm mại hỗ trợ giảm đau lưng, gối bà bầu đa năng cực tiện hàng cao cấp - Màu xám ghi",275000,275000,0,0
TIKI,do-choi-me-be,129458810,"Trà cốm hoa quả Burine dinh dưỡng dành cho bé - Vị Cam Nam Mỹ giúp hỗ trợ giảm viêm nhiễm, tăng cường đề kháng (Không dành cho trẻ dưới 8 tháng tuổi)",155000,155000,0,0
TIKI,do-choi-me-be,68554792,"Tấm lót chống thấm cho bé dùng được 2 mặt. Miếng lót chống thấm xuống nệm, thoáng khí, hàng chính hãng - 50x70",139000,199000,60000,30
TIKI,do-choi-me-be,192202449,"100 sleeve bọc bài UNO 5.9x9cm , Mèo nổ 6.5x9cm",20000,20000,0,0
TIKI,do-choi-me-be,151745410,"Ghế ăn dặm cho bé gấp gọn nâng hạ độ cao Mastela 07110 / 07112  - Ghế tập ăn dặm cho bé chuẩn ASTM Mỹ BPA Free",579000,579000,0,0
TIKI,do-choi-me-be,191620753,"Máy in con lăn tạo phép tính cộng trừ,máy tạo phép tính đơn giản ra bài tập cho bé học toán",25998,25998,0,0
TIKI,do-choi-me-be,95035849,"Bột ăn dặm dinh dưỡng Sữa, Ngũ cốc & rau củ - Cà rốt HiPP Organic 250g",145000,145000,0,0
TIKI,do-choi-me-be,80358747,"Đồ Chơi Nhập Vai Bác Sĩ Cho Bé Từ 3 Tuổi Bowa",239000,239000,0,0
TIKI,do-choi-me-be,49495083,"Tã/Bỉm quần cao cấp MIJUKU gói 50 miếng - M",165000,165000,0,0
TIKI,do-choi-me-be,113767814,"Sữa Bột Meiji 1-3 Growing Up Formula (800g)",479000,479000,0,0
TIKI,do-choi-me-be,99043326,"Mèo Nổ Mini Exoloding Kittens cơ bản Tặng Kèm Móc Khóa TTH",70000,139000,69000,50
TIKI,do-choi-me-be,96912147,"Bịch 10 Khăn sữa Cotton viền màu 4 lớp an toàn cho trẻ sơ sinh - Aiko (Hàng Việt Nam xuất Nhật) (Khăn kích thước 27cm x 25cm)",45000,45000,0,0
TIKI,nha-cua-doi-song,187843307,"Đèn Năng Lượng Mặt Trời Chống Lóa 100W 200W 300W, 4LED 200W 300W 500W",720000,900000,180000,20
TIKI,nha-cua-doi-song,43389470,"Bàn Ăn Thông Minh Tiết Kiệm Diện Tích Màu Sắc Hiện Đại",1127000,1220000,93000,8
TIKI,nha-cua-doi-song,132855126,"Rèm Cửa Sổ, Rèm Cửa Ra Vào Vintage Phong Cách Scandinavian Bắc Âu",358000,358000,0,0
TIKI,nha-cua-doi-song,71105497,"Bộ ấm trà xách tay đơn giản, sang trong, tiện lợi khi đi du lịch",299000,299000,0,0
TIKI,nha-cua-doi-song,106808360,"Bình Giữ Nhiệt Lock&Lock Riga Tumbler LHC4160 (897ml) - Hàng Chính Hãng, Bằng Thép Không Gỉ, Có Lưới Lọc Inox - Tặng Kèm Ống Hút Và Cọ Rửa Ống Hút",399000,735000,336000,46
TIKI,nha-cua-doi-song,169518924,"Bình Giữ Nhiệt Inox 304 - YOGA QG, Dung Tích 1000ml - 15000ml, Giữ Nhiệt Tốt Đến 12h, Thiết Kế Sang Trọng, Màu Sắc Bắt Mắt - Hàng chính hãng",114000,125000,11000,9
TIKI,nha-cua-doi-song,272452606,"Bộ cây lau nhà tự vắt thông minh 3 thanh vắt sợi microfiber",550000,1190000,640000,54
TIKI,nha-cua-doi-song,72646362,"Bộ dụng cụ di chuyển đồ nặng chuyên dụng tải trọng tối đa 1000kg xoay 360 độ",275000,275000,0,0
TIKI,nha-cua-doi-song,241980823,"Combo 20 Kẹp Inox 304 Phơi Quần Áo, Chăn Mền",25000,25000,0,0
TIKI,nha-cua-doi-song,162427187,"Dụng Cụ Bơm Hút Rượu Xăng Dầu Chất Lỏng Bóp Tay Tiện Lợi Đa Năng - Hàng Loại 1-  Chính Hãng MINIIN",47000,76000,29000,38
TIKI,nha-cua-doi-song,144527016,"Bộ Mũi khoan đa năng khoan gốm sứ tường, 1 Bộ 5 món 6/6/8/10/12mm",95195,95195,0,0
TIKI,nha-cua-doi-song,536498,"Bộ Vặn Vít Đa Năng 38 Chi Tiết Bosch 2607019506",439000,494000,55000,11
TIKI,nha-cua-doi-song,124483451,"TREO CHỔI TREO CÂY LAU NHÀ TREO Ô DÙ VÒI HOA SEN VÒI NƯỚC JODILY DÁN TƯỜNG INOX 304",45000,45000,0,0
TIKI,nha-cua-doi-song,107016572,"Thùng rác văn phòng lưới Deli - Sọt đựng rác - Màu đen - 28cm - 9188/E9190",214200,214200,0,0
TIKI,nha-cua-doi-song,108243510,"Chảo Inox cao cấp 5 Đáy chống dính siêu bền Sunhouse IN20M2 - 20 cm - Dùng trên mọi loại bếp - Hàng chính hãng",293000,450000,157000,35
TIKI,nha-cua-doi-song,49300423,"Kệ Gương Gỗ",415000,430000,15000,3
TIKI,nha-cua-doi-song,75339729,"Chổi Quét Trần Nhà, Chổi Phất Trần Có Cán Điều Chỉnh Độ Dài KUNBE Quét Mạng Nhện, Lau Chùi Bụi Bẩn Trên Cao Tiện Dụng",149000,149000,0,0
TIKI,nha-cua-doi-song,79665351," Đèn Led gắn tường, tủ đọc sách  tích điện đa năng 4 cấp độ",135000,135000,0,0
TIKI,nha-cua-doi-song,73988526,"Đuôi thoát sàn ngăn mùi hôi, chống côn trùng trọng lực nhựa ABS Hiwin FD-50LID",54000,54000,0,0
TIKI,nha-cua-doi-song,213710307,"Lưỡi cưa xích RAKUTEN LOẠI 1 gắn máy mài cầm tay, bộ dụng cụ chuyển đổi máy mài thành máy cưa gỗ mini",132050,139000,6950,5
TIKI,nha-cua-doi-song,36452514,"Đèn pin siêu sáng mini 2in1",46505,86000,39495,46
TIKI,nha-cua-doi-song,59267058,"Bình Pha Cà Phê Cold Brew Thủy Tinh 1200ml",279000,279000,0,0
TIKI,nha-cua-doi-song,73553244,"Hộp Đựng Trang Sức MOHI MH10 Kích Thước 10x10x5.5cm - Hàng Chính Hãng",64400,70000,5600,8
TIKI,nha-cua-doi-song,116194000,"Hộp đựng trứng, khay trứng, hộp bảo quản thực phẩm tủ lạnh Homepower cao cấp, trên nắp đậy có phần ghi chú thời gian bảo quản tiện lợi",169000,169000,0,0
TIKI,nha-cua-doi-song,95875948,"Ổ khóa cửa treo Việt Tiệp đồng vàng",58045,61100,3055,5
TIKI,nha-cua-doi-song,176076047,"Khăn Lau  Nhà Bếp Siêu Thấm Nước Mềm Mại Size Lớn",9000,9000,0,0
TIKI,nha-cua-doi-song,151555811,"Bàn làm việc có kệ - Màu vàng nhạt - 80cmx40cmx75cm",359000,359000,0,0
TIKI,nha-cua-doi-song,89227279,"Giấy bạc dán tường nhà bếp chống thấm dầu, thấm nước tiện dụng, cách nhiệt",69000,69000,0,0
TIKI,nha-cua-doi-song,170270819,"Ổ cắm chuyển đổi 3 chấu sang 2 chấu tiện lợi - Hàng nhập khẩu",12000,25000,13000,52
TIKI,nha-cua-doi-song,67707813,"Phụ kiện Ngăn mùi nhà tắm - INOX 304 lắp thoát sàn chống mùi hôi ngăn vi khuẩn trào ngược lên – DH2011",98000,98000,0,0
TIKI,nha-cua-doi-song,73829087,"Kệ để đồ rửa chén bát gác trên bồn rửa inox 304 Hobby Home Decor KRC5 có khay hứng nước",99000,159000,60000,38
TIKI,nha-cua-doi-song,191326374,"Bộ Sạc Pin AA, AAA Beston Tự ngắt khi đầy Sạc Tốc Độ Cao Có Led báo trạng thái sạc BST-C9009, Pin sạc chính hãng",60000,60000,0,0
TIKI,nha-cua-doi-song,19448864,"Bộ võng xếp BAN MAI: khung sơn tĩnh điện VIP và lưới mềm dày 99 ( Giao màu ngẫu nhiên )",749000,1050000,301000,29
TIKI,nha-cua-doi-song,118090738,"Kệ Treo Tường - Thanh Ngang Trang Trí Màu Vân Gỗ Sồi Đơn Giản SIB Decor, Gỗ Chống Ẩm 25mm, Kết Cấu Không Giá Đỡ Chắc Chắn Thẩm Mỹ",159000,159000,0,0
TIKI,nha-cua-doi-song,35876754,"Ổ Điện Đa Năng Chống Giật 3 Cổng USB và 9 ổ cắm iCART",37899,37899,0,0
TIKI,nha-cua-doi-song,176805088,"COMBO 3 Túi Phân Bón Lan ORCHID 1-2-3 - Dưỡng rễ, Cây, Kích Ra Hoa cho Phong Lan, cây kiểng - tan chậm Túi Lưới",79000,79000,0,0
TIKI,nha-cua-doi-song,112976323,"Đèn LED cảm biến chuyển động SEASY SS02, cảm biến thông minh, ánh sáng bảo vệ mắt, sạc pin USB đời mới, dán tường, tủ quần áo, cầu thang, phòng ngủ - Hàng chính hãng",42000,89000,47000,53
TIKI,nha-cua-doi-song,72901343,"Combo 4 Móc Dán Tường Inox 304 Hình Trụ Vuông MD02 Cao Cấp Chống Gỉ Sét Siêu Bền Siêu Chịu Lực - Móc Treo Đồ Gia Đình Tiện Dụng",135000,230000,95000,41
TIKI,nha-cua-doi-song,137136435," Keo silicon Apollo A500 chống thấm tốt, bền bỉ (keo trong - keo trắng đục) 300ml",61750,65000,3250,5
TIKI,nha-cua-doi-song,70372700,"Đèn Cây Dạng Đứng Đọc Sách Pixar, Đèn Sàn, Đèn Trang Trí Phòng Khách, Đèn Ngủ. Chống Cận Thị Bảo Vệ Mắt. Chiều Cao 1,85m. Hàng Chính Hãng Moontronics",399000,399000,0,0
TIKI,nha-cua-doi-song,187512713,"Ly Thủy Tinh Navivu Oval 380ml - Cốc Thủy Tinh Uống Trà",45000,45000,0,0
TIKI,nha-cua-doi-song,116670105,"Dụng cụ di chuyển vật nặng",275000,275000,0,0
TIKI,nha-cua-doi-song,115436781,"Đèn Fairy Light Năng Lượng Mặt Trời Điều Khiển Remote",270000,270000,0,0
TIKI,nha-cua-doi-song,173673833,"Ghế Quầy Bar Cao Cấp Phong Cách Hiện Đại Decor Tại Nhà Hoặc Văn Phòng Thư Giãn - Hàng Chính Hãng",699000,935000,236000,25
TIKI,nha-cua-doi-song,44297321,"Đèn Diệt Côn Trùng Đại Sinh DS-D6",585000,585000,0,0
TIKI,nha-cua-doi-song,192909616,"Khăn mặt khô KIPOR dùng 1 lần lau khô, lau ướt - 60 khăn/cuộn, kích thước 20x20cm - Hàng chính hãng",33000,65000,32000,49
TIKI,nha-cua-doi-song,58415187,"Đèn cảm ứng gắn cầu thang, tủ đồ, toilet, tự động bật/tắt ánh sáng, sạc bằng USB tiện dụng",84000,84000,0,0
TIKI,nha-cua-doi-song,75356087,"Túi Đựng Hộp Cơm Giữ Nhiệt Đa Lớp Cỡ Lớn 34cm*25cm*15cm",60000,60000,0,0
TIKI,nha-cua-doi-song,191604178,"Đèn đốt nến thơm, an toàn, sang trọng, phù hợp mọi không gian",299000,299000,0,0
TIKI,nha-cua-doi-song,9805349,"Ổ cắm Điện Quang ECO ĐQ ESK 5WR 8ECO (8 Lỗ, dây dài 5m, màu trắng đỏ)",165000,223800,58800,26
TIKI,nha-cua-doi-song,58228617,"Cuộn dây cáp làm giàn, có sợi gia cường, nhựa bọc kim loại cực kỳ bền chắc - 1kg",79000,79000,0,0
TIKI,nha-cua-doi-song,14338957,"Bộ 3 khăn tắm Nhật siêu mềm siêu thấm - khăn tắm khổ rộng 70x140",28998,28998,0,0
TIKI,nha-cua-doi-song,107713002,"Nam châm siêu trường, siêu mạnh, siêu hút dính dùng để trục vớt đồ vật, nâng vật nặng, treo đồ Dan House - DST15, Hàng chính hãng-D20",92000,92000,0,0
TIKI,nha-cua-doi-song,94888985,"Sọt Đựng Quần Áo Bẩn Túi Đựng Đồ Đa Năng",65000,65000,0,0
TIKI,nha-cua-doi-song,230062294,"Bộ dụng cụ tháo vặn ốc vít",148000,148000,0,0
TIKI,nha-cua-doi-song,51062179,"Keo dán đa năng siêu dính V - 370 gắn tất cả các loại vật liệu ( 50ml)",89000,89000,0,0
TIKI,nha-cua-doi-song,58448882,"Thanh xốp chắn khe cửa đa năng thông minh",20000,20000,0,0
TIKI,nha-cua-doi-song,39318884,"Hộp 60 Viên Pin AA Panasonic ( Pin Tiểu ) Hi Top - Hàng Chính Hãng",174000,179000,5000,3
TIKI,nha-cua-doi-song,76468352,"Combo 200 CÁI TÚI LỌC RÁC BỒN RỬA CHÉN - KT: 10x10cm -Hàng chất lượng tốt",27999,27999,0,0
TIKI,nha-cua-doi-song,81988120,"Dây nguồn phích âm SOPOKA N8-N10 dây 2,3m-6,5m",43000,43000,0,0
TIKI,nha-cua-doi-song,117196166,"Pin Maxell R6P super AA hộp 40 viên tiểu",49900,49900,0,0
TIKI,nha-cua-doi-song,19557637,"Combo 2 Gối Mây Đan Tổng Hợp Thoáng Mát",67000,67000,0,0
TIKI,nha-cua-doi-song,162405563,"Cọ Bồn Cầu Toilet Nhà Vệ Sinh Cao Cấp Kèm Giá Cắm Chổi  Silicon - Hàng Loại 1 - Chính Hãng MINIIN",83000,109000,26000,24
TIKI,nha-cua-doi-song,116452179,"SÉT 100 TÚI BỌC THỰC PHẨM GẤU HÀNG ĐẸP, DÀY DẶN LOẠI 1.",12798,12798,0,0
TIKI,nha-cua-doi-song,73755163,"Hộp Đựng Mỹ Phẩm,Đồ Trang Điểm MOHI MT9 ,2 Ngăn Có Kệ Trên Và Nắp Đậy-Hàng Chính Hãng",414000,450000,36000,8
TIKI,nha-cua-doi-song,108025488,"BÀN CHẢI ĐÁNH RĂNG PIH HÀNG VIỆT NAM CAO CẤP SIÊU MỀM",4000,4000,0,0
TIKI,nha-cua-doi-song,191136118,"Bóng Đèn Led Bulb, Led Edison Đui E27 Các Loại - Hàng Chính Hãng NAVIVU",15000,15000,0,0
TIKI,nha-cua-doi-song,58451521,"Combo 2 Miếng Lau Nhà Parroti Magic MG01 – Kích Thước 32x10 CM - Chất Liệu Microfiber Cao Cấp",55000,109000,54000,50
TIKI,nha-cua-doi-song,181936450,"Túi Lọc Trà Túi Lọc Cà Phê Cold Brew Vải Không Dệt Có Dây Rút 8X10Cm, Định Lượng 60G/Túi, Combo 10 Túi",14000,15000,1000,7
TIKI,nha-cua-doi-song,160570940,"Set 10  Khay giấy bạc lót nồi chiên không dầu tái sử dụng được ",11000,11999,999,8
TIKI,nha-cua-doi-song,173710560,"Cuộn Khăn Giấy Lau Đa Năng - Chất Liệu Rayon An Toàn - Lau Chén Đĩa , Lau Nhà Bếp..vv - Hàng Chính Hãng",49000,58000,9000,16
TIKI,nha-cua-doi-song,70536777,"Đèn bắt muỗi, ruồi và các loại côn trùng Đại Sinh DS-D6",585000,585000,0,0
TIKI,nha-cua-doi-song,31473727,"Combo 100 Túi Lọc Trà Có Dây Rút",24000,24000,0,0
TIKI,nha-cua-doi-song,162189829,"Nhang Xanh Phổ Thông 30cm 500g (Đỏ)",163000,165000,2000,1
TIKI,nha-cua-doi-song,69543163,"Cây thông tắc bồn cầu, nhà vệ sinh đa năng cao cấp- Dụng cụ thông tắc bồn cầu, cống bằng khi nén áp lực siêu mạnh kèm bơm rời Morado - Hàng Chính Hãng",310000,310000,0,0
TIKI,nha-cua-doi-song,19853979,"Võng lưới số 9.2, căng kim dày BAN MAI, khổ rộng, cán thép 50 (Giao màu ngẫu nhiên)",215000,300000,85000,28
TIKI,nha-cua-doi-song,109213631,"Chân đặt khung ảnh chân đặt khung hình thờ chữ L xếp lại gọn gàng chắc vững - Nhiều cỡ",52000,52000,0,0
TIKI,nha-cua-doi-song,73566076,"Cây lau nhà tự vắt thông minh chổi lau nhà 360 độ, kèm 2 miếng lau Kitimop-RED, vắt kiệt nước dễ dàng, cầm nhẹ tay, chổi lau nhà thông minh",145000,145000,0,0
TIKI,nha-cua-doi-song,15428054,"Đệm (Bồ đoàn) ngồi thiền Sunny",175000,175000,0,0
TIKI,nha-cua-doi-song,196376951,"Cốc Giữ Nhiệt Nóng Lạnh Vusign Inox 304 Cao Cấp Viền Cao Su Cách Nhiệt Deli Dung Tích 510ml -Phù Hợp Cà Phê Trà Nước Ép Sinh Tố Đá Du Lịch Đi Học Tập Gym",119000,250200,131200,52
TIKI,nha-cua-doi-song,108243508,"Chảo sâu đáy từ miệng rót Sunhouse SHS20MRD - Dùng trên mọi loại bếp - Hàng chính hãng",272000,400000,128000,32
TIKI,nha-cua-doi-song,162210732,"Bộ Tua Vít Deli Cao Cấp 30 Chi Tiết Đa Năng Vặn Ốc Vít, Bu Lông - Phù Hợp Sửa Chữa Vật Dụng, Xe Máy - DL1130",164000,268000,104000,39
TIKI,nha-cua-doi-song,13561925,"Nồi Hấp 2 Tầng Bằng Inox Lock&Lock LLH1282 (28cm)",791000,1319000,528000,40
TIKI,nha-cua-doi-song,49098494,"Kệ Góc Nhà Tắm, Kệ Góc Tường, Kệ Nhà Tắm Inox 304 2 tầng Cao Cấp L1",380000,550000,170000,31
TIKI,nha-cua-doi-song,55502241,"Bộ chăn ga gối cotton LIDACO PL1 - Dưa Hấu Hồng (SP001111)",198200,299000,100800,34
TIKI,nha-cua-doi-song,49724259,"Nệm Foam Cao Cấp Nest Ru9 15cm - Màu Xám | 2 Lớp Foam Nâng Đỡ | Bao Gồm 6 Kích Thước | 100 Đêm Ngủ Thử",5790000,5790000,0,0
TIKI,nha-cua-doi-song,62734430,"Gói 5 Kg Phân bón đầu trâu hữu cơ vi sinh cao cấp Trichoderma + TE giúp kháng bệnh và tăng trưởng khỏe cho cây trồng",125000,125000,0,0
TIKI,nha-cua-doi-song,131407865,"bàn làm việc chân gấp gọn",405000,450000,45000,10
TIKI,nha-cua-doi-song,146289201,"Túi đựng hộp cơm giữ nhiệt, túi đựng đồ ăn trưa văn phòng đa chức năng phù hợp cho cả nam và nữ có tay cầm tiện lợi, chống thấm nước",59000,59000,0,0
TIKI,nha-cua-doi-song,112218352,"Ron Gioăng Chữ T Dán Chặn Che Khe Hở Khung Chân Cửa Chống Gió Bụi Côn Trùng Thoát Hơi Máy Lạnh",13000,13000,0,0
TIKI,nha-cua-doi-song,200936447,"Bàn Trà Cafe, Bàn Trà Sofa Phong Cách Bắc Âu Thương Hiệu IGEA",176000,176000,0,0
TIKI,nha-cua-doi-song,794973,"Gối Cao Su Liên Á Oval LAGOV4565 (45 x 65 cm) - Trắng",790000,790000,0,0
TIKI,nha-cua-doi-song,984246,"Kèn Melodion - Melodica Suzuki MX-37 37 Phím",750000,750000,0,0
TIKI,nha-cua-doi-song,168878527,"SET 10 KHĂN LAU NHÀ BẾP ĐA NĂNG THIẾT KẾ 2 MẶT CHỐNG THẤM DẦU CAO CẤP",28000,28000,0,0
TIKI,nha-cua-doi-song,101627081,"Ô dù cầm tay siêu nhẹ 105g cho phái đẹp, chống tia UV - Nason Feather Umbrella for Lady - Dù gấp gọn bỏ túi Nason",195000,195000,0,0
TIKI,nha-cua-doi-song,72049797,"Set 02 Cuộn Giấy Nến, Giấy Sáp, Giấy Lót Nướng Bánh, Lẩu Nướng, Hấp Bánh, Nướng Thực Ăn Chịu Nhiệt, Chống Dính, Không Thấm Dầu Tiện Dụng 30cm x 5m + Tặng Chổi Phếu Dầu Ăn",45000,45000,0,0
TIKI,nha-cua-doi-song,162767378,"Bình giữ nhiệt có ống hút, quai đeo cho bé dung tích 1L",93099,97999,4900,5
TIKI,nha-cua-doi-song,48175833,"KỆ VUÔNG 3 TẦNG GỖ THÔNG- DÀI 35cm x CAO 65cm",159000,250000,91000,36
TIKI,nha-cua-doi-song,148026925,"Bình Đựng Nước 2L Dễ Thương Có Vạch Báo Giờ Uống Nước - Hàng Loại 1 - Chính Hãng MINIIN",94000,120000,26000,22
TIKI,nha-cua-doi-song,115986066,"Miếng Dán Chân Bàn Ghế Chống Trượt Hamart Bọc Lót Chân Bàn Ghế Chống Ồn Chống Xước Nền Nhà",18000,29000,11000,38
TIKI,nha-cua-doi-song,158816154,"Bộ 5 Tấm Xốp Dán Tường Hoạt Hình Mèo Ú Siêu Dễ Thương Sẵn Keo 70x77",85000,85000,0,0
TIKI,nha-cua-doi-song,175432384,"Bàn để ủi quần áo cao cấp Nakagami tư thế đứng có giá đỡ chất lượng Công nghệ Nhật Bản - Màu ngẫu nhiên - Hàng chính hãng",399000,399000,0,0
TIKI,nha-cua-doi-song,54752502,"Bộ 10 khăn lau 2 mặt xuất Nhật Toki - Khăn lau không phai màu không rụng sợi- nhanh khô- Khăn lau bếp, khăn lau kính, lau bát lau tay - HN09421L",10000,15000,5000,33
TIKI,nha-cua-doi-song,207227522,"Giấy nến nấu ăn thương hiệu MyJae",55000,130000,75000,58
TIKI,nha-cua-doi-song,154157961,"Màn Dây Không Cửa FUNU Chống Muỗi Cao Cấp, Vải Màn Mềm, Mịn, Mắt Dày Dặn Chống Muỗi Tuyệt Đối - Hàng Chính Hãng",133000,140000,7000,5
TIKI,nha-cua-doi-song,35475781,"Bộ củ sen tắm nóng lạnh bồn tắm inox 304 gồm ( củ sen tắm, vòi sen inox, giá đỡ vòi sen inox, dây sen inox)",276000,550000,274000,50
TIKI,nha-cua-doi-song,136227595,"Khay đựng remote  - điện thoại dán tường có khe luồn sạc nhỏ gọn tiện lợi  ( Giao màu ngẫu nhiên ) - Hàng chính hãng ",16000,30000,14000,47
TIKI,nha-cua-doi-song,58814335,"Xe đẩy hàng 4 bánh SUMIKA T300 - Khung thép, tay cầm gấp mở tiện lợi, tải trọng 300kg",1265000,1950000,685000,35
TIKI,nha-cua-doi-song,117291914,"Bàn Trang Điểm Ngồi Bệt IGA Sắp Xếp Mỹ Phẩm, Son Gọn Gàng - GP143",385000,419000,34000,8
TIKI,nha-cua-doi-song,66090300,"Bộ 20 dụng cụ kẹp giữ dây điện gọn gàng",12999,12999,0,0
TIKI,nha-cua-doi-song,148877182,"Ruột gối nằm K-Bedding chất liệu Microfiber màu ngẫu nhiên (45x65cm)",320000,400000,80000,20
TIKI,nha-cua-doi-song,108418530,"Kệ bồn cầu 3 tầng để sau bồn cầu, kệ nhà vệ sinh trên toilet, Kệ nhà tắm đa năng tiện lợi",212900,212900,0,0
TIKI,nha-cua-doi-song,111705115,"Túi đựng dụng cụ 13 inch INGCO HTBG281328",108000,108000,0,0
TIKI,nha-cua-doi-song,20680352,"Combo 5 bẫy diệt chuột thông minh",75000,75000,0,0
TIKI,nha-cua-doi-song,125968227,"Cây lau nhà phun sương thông minh 2 trong 1, đầu xoay 360 độ tiện lợi - Broom Green Pro 02",64986,64986,0,0
TIKI,nha-cua-doi-song,10115744,"Ổ cắm Điện Quang ECO ĐQ ESK 2BR 6ECO (6 Lỗ, dây dài 2m, màu đen đỏ)",88000,88000,0,0
TIKI,nha-cua-doi-song,56596052,"KỆ ĐỂ BÀN CHẢI ĐÁNH RĂNG VÀ NHẢ KEM ĐÁNH RĂNG TỰ ĐỘNG KÈM 2 CỐC HÚT TỪ TÍNH",106799,119999,13200,11
TIKI,nha-cua-doi-song,113833830,"Tấm Lót Bảo Vệ Nệm Cao Cấp PHÚC HẠNH - Lót Chống Thấm",171000,190000,19000,10
TIKI,nha-cua-doi-song,195891839,"Đèn LED Mini Móc Khóa - Đèn Pin COB - Đèn Pin Dã Ngoại - Sạc USB Tiện Dụng - Hàng Loại 1 - Chính Hãng MINIIN",51000,59000,8000,14
TIKI,nha-cua-doi-song,189208326,"Thảm nhà tắm, nhà bếp siêu thấm nước, chống trơn trượt tối giản, hiện đại NAVIVU",99000,99000,0,0
TIKI,nha-cua-doi-song,152446406,"Cây Chúc ( chanh thái ) - Cây chanh ăn lá ( chanh hấp gà ) + Tặng phân bón cho cây",39000,58000,19000,33
TIKI,nha-cua-doi-song,51966031,"Phân Hữu Cơ Gà Dynamic Nhật Bản Tốt Cây Xanh lá  Cung Cấp Đầy Đủ Dưỡng Chất , Dúng Bón Hoa Hồng ,Cây Kiểng , Cây Ăn Trái( Túi 1 KG)",35000,35000,0,0
TIKI,nha-cua-doi-song,52021362,"Bảng điện nổi V3 Điện Quang ĐQ FEP 32W 03S (màu trắng, 3 lỗ 2 chấu, 3 công tắc)",71000,91900,20900,23
TIKI,nha-cua-doi-song,46601114,"KỆ GƯƠNG 2 TẦNG ĐẦU GIƯỜNG GỖ THÔNG- GLASS SHELF- CAO 50CM x DÀI 30CM x RỘNG 30CM",180000,180000,0,0
TIKI,nha-cua-doi-song,61278429,"Bình Nước Giữ Nhiệt Có Móc Treo (300ml)",68000,68000,0,0
TIKI,nha-cua-doi-song,142383214,"Hộp Đựng Giấy Ăn Để Bàn Có Ngăn Để Đồ Đa Năng, Hộp Khăn Giấy Nắp Gỗ",25624,25624,0,0
TIKI,nha-cua-doi-song,12756233,"Ổ điện thông minh có 6 phích cắm 3 cổng USB (giao màu ngẫu nhiên)",41000,41000,0,0
TIKI,nha-cua-doi-song,141469357,"COMBO 50 Khay (Chén, Bát) Giấy FEST CHOICE FOOD TRAY 3x3 Inches THÁI LAN Hàng Nhập Khẩu Cao Cấp, Dùng 1 Lần Tiện Lợi, An Toàn - CHÍNH HÃNG F010 (Tặng Móc Khóa KETILO)",99000,99000,0,0
TIKI,nha-cua-doi-song,132209590,"Thảm chùi chân siêu thấm hút nước 3 giây  cho phòng tắm, phòng bếp, dễ dàng vệ sinh, nhanh khô vệ sinh nhà cửa an toàn với da.",28997,28997,0,0
TIKI,nha-cua-doi-song,96419574,"Màng PE trắng khổ 50cm 2,5kg - Màng PE quấn hàng.",135000,135000,0,0
TIKI,nha-cua-doi-song,26159911,"Decal dán tường thước đo chiều cao Hươu cao cổ 5 AmyShop (145 x 84 cm)",66900,75000,8100,11
TIKI,nha-cua-doi-song,36568964,"thước kep điện tử sợi carbon 0-150mm",49900,49900,0,0
TIKI,nha-cua-doi-song,204230323,"Bộ nhang không tăm đầy đủ hộp đựng và máng đốt bằng gỗ nhà HÀ XÁ cao cấp",99000,198000,99000,50
TIKI,nha-cua-doi-song,43110675,"Móc Khóa Tua Vít mini đa năng sửa chữa kính, đồng hồ, điện thoại (6cm x 0,5cm)",9700,9700,0,0
TIKI,nha-cua-doi-song,35422376,"Ô Dù 4 Lớp Che Nắng, Đi Mưa Chống Tia UV",37996,37996,0,0
TIKI,nha-cua-doi-song,193095643,"Combo 2 Móc Dán Tường Trong Suốt Treo Đồ Dùng Thông Minh",6900,6900,0,0
TIKI,nha-cua-doi-song,4995493,"Thang Nhôm Rút Chữ A Sumika SK380D NEW - Chữ A cao 1.9m, chữ I cao 3.8m, tải trọng 300kg",1769000,2300000,531000,23
TIKI,nha-cua-doi-song,84958837,"Kệ sách tổ ong đa năng.GP100",65000,69999,4999,7
TIKI,nha-cua-doi-song,50324146,"Combo 5 Chai Thủy Tinh đựng nước 500ML - Nắp Thiếc vặn có dây treo (Bình thủy tinh đựng nước, đựng sữa - Chai thủy tinh đựng nước ép)",53000,53000,0,0
TIKI,nha-cua-doi-song,141001207,"Ghế Gấp Inox Phòng Chờ, Ghế Xếp Văn Phòng, Ghế Phòng Họp Gấp Gọn - Hàng Chính Hãng",479000,800000,321000,40
TIKI,thiet-bi-kts-phu-kien-so,201308561,"Chuột game có dây Logitech G102 Lightsync - Tùy chỉnh RGB, 6 nút lập trình, nhẹ, 8000 DPI, PC/Mac - Hàng Ch��nh Hãng",398000,590000,192000,33
TIKI,nha-cua-doi-song,93154028,"Thảm lông trải sàn lông mịn kích thước 1.2 x 1.6m- dài Thảm lông trải sàn cao cấp phòng khách trang trí nhà cửa.",175000,175000,0,0
TIKI,thiet-bi-kts-phu-kien-so,192432383,"Case Silicon dành cho Airpods Pro 2/ Airpods 1,2/ Airpods Pro/ Airpods 3 Hình Gấu Brown_ Hàng Chính Hãng",85000,85000,0,0
TIKI,nha-cua-doi-song,202185819,"Bình Giữ Nhiệt Cao Cấp 304  Có Nắp Xoáy Tiện Lợi Giữ Nhiệt Nóng Lạnh",200000,200000,0,0
TIKI,nha-cua-doi-song,107486345,"Bộ chăn ga giường Lidaco cotton Tici cao cấp (Nhiều mẫu lựa chọn)",239000,339000,100000,29
TIKI,nha-cua-doi-song,159144266,"Cây lau nhà VILEDA Turbo Easy Wring&Clean đầu lau tam giác, xô giặt quay bằng chân",579000,579000,0,0
TIKI,thiet-bi-kts-phu-kien-so,73315307,"Thẻ Nhớ microSD SanDisk Ultra 64GB UHS-I - 100MB/s (New 2020) - Hàng Nhập Khẩu",129000,129000,0,0
TIKI,nha-cua-doi-song,89059076,"Chảo sâu lòng chống dính đáy từ Tefal Ultimate 28cm, dùng cho mọi loại bếp - Sản xuất tại Pháp - Hàng chính hãng",1699000,1699000,0,0
TIKI,thiet-bi-kts-phu-kien-so,248539405,"Tai Nghe Bluetooth Baseus WM01 TWS Không Dây - Công Nghệ Chống Tiếng Ồn Mới Nhất - Thiết Kế Nhỏ Gọn Xinh Xắn - Tương Thích Nhiều Thiết Bị - Điều Khiển Cảm Ứng - Hàng Chính Hãng",450000,450000,0,0
TIKI,nha-cua-doi-song,101870479,"Thanh treo rèm cửa đa năng, không cần khoan tường hay bắt vít, thay đổi vị trí linh hoạt",75000,120000,45000,38
TIKI,nha-cua-doi-song,72797082,"Chảo Sâu Lòng DECOR Lock&Lock LDE1225IH 22cm (màu vàng) - Hàng chính hãng",397000,662000,265000,40
TIKI,thiet-bi-kts-phu-kien-so,73179180,"Thẻ Nhớ microSD SanDisk Ultra 128GB UHS-I - 100MB/s (New 2020) - Hàng Nhập Khẩu",229000,229000,0,0
TIKI,nha-cua-doi-song,54082178,"Túi đựng rác lốc 3 cuộn 1kg - Bịch đựng rác 3 cuộn cỡ đại, trung, tiểu",24000,24000,0,0
TIKI,nha-cua-doi-song,778124,"Bộ Hộp Cơm Giữ Nhiệt Lock&Lock LHC8015 (910ml) - Xám Bạc ",619000,1142000,523000,46
TIKI,thiet-bi-kts-phu-kien-so,72796676,"Giá Đỡ Laptop Hợp Kim Nhôm Cao Cấp Có Thể Gấp Gọn, Giúp Tản Nhiệt Laptop, Macbook, Máy Tính Xách Tay. 07 Vị Trí Điều Chỉnh Góc Độ. Hàng Chính Hãng Tamayoko FS060",179000,179000,0,0
TIKI,nha-cua-doi-song,174307623,"Đệm Ngồi Bệt Tròn Cho Bàn Trang Điểm Vải Cao Cấp Kiểu Hàn Chính Hãng IGA - GC13",91000,99000,8000,8
TIKI,thiet-bi-kts-phu-kien-so,188189139,"Case Ốp Vỏ Vệ Vịt Boss dành cho Airpods Pro/ Airpods 3 kèm móc treo- Hàng chính hãng",99000,99000,0,0
TIKI,thiet-bi-kts-phu-kien-so,109393113,"Tai nghe bluetooth nhét tai chống ồn cao cấp V5.0 chính hãng dùng cho iPhone Samsung OPPO VIVO HUAWEI XIAOMI tai nghe không dây Hàng Chính Hãng PKCB",280000,500000,220000,44
TIKI,thiet-bi-kts-phu-kien-so,146266186,"Miếng Lót Chuột Kai Hình Chữ Nhật Siêu Dễ thương Nhiều Mẫu Mới",23000,28000,5000,18
TIKI,thiet-bi-kts-phu-kien-so,1935009,"Tai Nghe Apple EarPods Cổng Lightning - MMTN2",480000,790000,310000,39
TIKI,thiet-bi-kts-phu-kien-so,102782859,"Tai nghe In Ear Remax RM330 - Hàng chính hãng",212000,250000,38000,15
TIKI,thiet-bi-kts-phu-kien-so,1060082,"Dây Cáp Sạc Li.ght.ning Cho i.Phone Anker PowerLine II 1.8m - A8433H22",320000,380000,60000,16
TIKI,thiet-bi-kts-phu-kien-so,221256638,"Kính cường lực full màn hình G5 cho iPhone 14/ 14 pro/ 14 pro max - Hàng nhập khẩu",65000,65000,0,0
TIKI,thiet-bi-kts-phu-kien-so,123836523," Adapter Sạc 1 Cổng USB Type-C 20W Apple MHJE3ZA/A",450000,790000,340000,43
TIKI,nha-cua-doi-song,117370665,"Chiếu ngủ trưa văn phòng cá nhân dày 3.5ly / Chiếu Cách Nhiệt Văn Phòng 100 X 190 cm",46000,46000,0,0
TIKI,nha-cua-doi-song,98335248,"Đèn laser ánh sáng laze cảm biến âm thanh - Kết hợp Đèn LED xoay 7 màu dùng trang trí vũ trường, phòng karaoke",349000,349000,0,0
TIKI,thiet-bi-kts-phu-kien-so,143957287,"HUB Type C và HUB USB 3.0 tốc độ cao 4 in 1 Sidotech bộ chia cổng usb mở rộng kết nối chuyển đổi cho Macbook Pro Laptop PC máy tính hỗ trợ sạc pin kết nối đa năng ổ cứng bàn phím chuột máy in, thiết bị ổ chia usb - Hàng chính hãng",399000,399000,0,0
TIKI,nha-cua-doi-song,10814223,"Dụng Cụ Gắp Rác Thông Tắc Đường Ống, Lavabo Tiện Ích (160cm)",32900,32900,0,0
TIKI,nha-cua-doi-song,89792661,"[tặng kèm khay trúc 02 tầng] Bộ Ấm Chén Pha Trà Du Lịch 2 - Kiểu dáng trang nhã, Gọn gàng, Thích hợp mang đi du lịch, công tác",134964,134964,0,0
TIKI,nha-cua-doi-song,57650806,"Máy bơm tăng áp mini tự động",480000,480000,0,0
TIKI,thiet-bi-kts-phu-kien-so,123847933,"Apple Pencil 2 - MU8F2",2690000,4890000,2200000,45
TIKI,thiet-bi-kts-phu-kien-so,189474023,"Sạc dự phòng không dây từ tính Remax RPP-65 10000mAh - Hàng chính hãng",753500,990000,236500,24
TIKI,nha-cua-doi-song,143299139,"Bình Đựng Nước Cho Bé, Bình Nước Goki Rudy 450ml, Bình Nước Cao Cấp Chính Hãng Inochi Đạt Tiêu Chuẩn Xuất Nhật",82600,118000,35400,30
TIKI,thiet-bi-kts-phu-kien-so,389145,"Chuột không dây Logitech B175 - đầu thu USB 2.4Ghz, pin 1 năm, nhỏ gọn, thiết kế thuận cả 2 tay, phù hợp PC/ Laptop - Hàng chính hãng",199000,199000,0,0
TIKI,thiet-bi-kts-phu-kien-so,272913331,"Thiết bị theo dõi thông minh Samsung Galaxy SmartTag2-Hàng Chính hãng",355000,355000,0,0
TIKI,nha-cua-doi-song,14886261," Máy sấy khử mùi giày",156988,156988,0,0
TIKI,thiet-bi-kts-phu-kien-so,171657209,"Thẻ Nhớ Micro SDXC Samsung Evo Plus U3 130MB/s 128GB New  - Hàng Nhập Khẩu",295000,295000,0,0
TIKI,thiet-bi-kts-phu-kien-so,135284107,"Headphone Tai Nghe Chụp Tai bluetooth Rockspace O2 kết nối không dây có mic nghe nhạc liên tục 15h - Hàng chính hãng",465000,595000,130000,22
TIKI,thiet-bi-kts-phu-kien-so,113835505,"Giá Đỡ Máy Tính Bảng, Ipad, Điện Thoại - Chất Liệu Hợp Kim Nhôm Cao Cấp - Hàng Chính Hãng Tamayoko",450000,450000,0,0
TIKI,thiet-bi-kts-phu-kien-so,19419738,"Bộ Thu Phát Bluetooth TP-Link UB400 USB Nano Bluetooth 4.0 - Hàng Chính Hãng",102000,102000,0,0
TIKI,thiet-bi-kts-phu-kien-so,299431,"Chuột Không Dây Logitech M221",280000,280000,0,0
TIKI,thiet-bi-kts-phu-kien-so,142439870,"Cáp sạc Baseus Cafule sạc nhanh dùng cho iPhone - Hàng chính hãng",89000,159000,70000,44
TIKI,nha-cua-doi-song,226043852,"Chăn Gối Ngủ Văn Phòng Hình Mèo Kèm Chăn",148000,148000,0,0
TIKI,thiet-bi-kts-phu-kien-so,76480235,"Bao Tay Chơi Game Cảm Ứng Chống Mồ Hôi SIDOTECH Siêu Mỏng Vải Sợi Carbon Siêu Bền Chống Giãn Xù, Cảm Ứng Nhạy Thuộc Dòng Găng Tay Chơi Game Bao Ngón Tay Cho PUBG Tốc Chiến Freefire Liên Quân mobile - Hàng Chính Hãng",26000,26000,0,0
TIKI,nha-cua-doi-song,72659852,"Kệ Nhà Tắm Dán Tường OENON chất liệu nhựa ABS có thêm thanh nhôm treo khăn - OE08",169000,300000,131000,44
TIKI,thiet-bi-kts-phu-kien-so,270747030,"Cáp sạc USB to IP Remax RC-152i chiều dài 1m sạc 2.4A và truyền dữ liệu đồng thời 480MB/s có đèn tiện lợi - Hàng chính hãng",115000,150000,35000,23
TIKI,thiet-bi-kts-phu-kien-so,36007224,"Bàn phím có dây Dell KB216 USB - Hàng Chính Hãng",160000,160000,0,0
TIKI,thiet-bi-kts-phu-kien-so,262034792,"Hub USB 3.0 FIRO Và Hub Type C FIRO - Bộ Chia Cổng USB FIRO - HUB Chuyển Đổi Dành Cho Laptop, PC - Hỗ Trợ Sạc Pin, Kết Nối Đa Năng Ổ Cứng , Bàn Phím, Chuột, Máy In, Thiết Bị Ổ Chia USB - FIRO Type C Adapter 4in1 - Hàng Chính Hãng",133000,319000,186000,58
TIKI,thiet-bi-kts-phu-kien-so,209386109,"Tai Nghe Bluetooth FIRO FI5 Pro2 - Tai Nghe Không Dây FIRO Công Nghệ Bluetooth V5.3 - Kháng Nước IPX5 - Điều Khiển Cảm Ứng Thông Minh - Âm Bass Cực Hay - Tai Nghe FIRO FI5 Pro2 Tương Thích Với Tất Cả Dòng Máy - Hàng Chính Hãng",385000,739000,354000,48
TIKI,thiet-bi-kts-phu-kien-so,56889347,"Chuột Không Dây HXSJ X50 Plus - Hàng Chính Hãng",129000,245000,116000,47
TIKI,thiet-bi-kts-phu-kien-so,3671793,"Sim 4G Mobifone 12FD50 Tặng 150GB/Tháng(5GB/Ngày) Trọn Gói 1 Năm- Hàng Chính Hãng - Mẫu ngẫu nhiên",750000,750000,0,0
TIKI,thiet-bi-kts-phu-kien-so,158868703,"[Miễn Phí 12 Tháng] SIM MAX DATA 4G VIETNAMOBILE 6GB/Ngày. Trọn Gói 1 Năm - Hàng Chính Hãng",368000,650000,282000,43
TIKI,thiet-bi-kts-phu-kien-so,102782859,"Tai nghe In Ear Remax RM330 - Hàng chính hãng",212000,250000,38000,15
TIKI,thiet-bi-kts-phu-kien-so,174490279,"Chuột không dây bluetooth Logitech Signature M650 - Dành cho tay có kích cỡ từ nhỏ tới trung bình, Cuộn SmartWheel, giảm ồn, các nút bên có thể tùy chỉnh - Hàng chính hãng",576000,869000,293000,34
TIKI,nha-cua-doi-song,271696352,"Gối Niu Cao Cấp Ru9 - Công Nghệ Đột Phá Graphene Foam | Chất Liệu Foam Mềm Mại | Nâng Đỡ Đốt Sống Cổ | Chống Đau Vai Gáy",912000,950000,38000,4
TIKI,thiet-bi-kts-phu-kien-so,150921519,"Ốp Case Chống Shock Kai Rugged Armor cho Apple Watch Series 6/ SE/ Series 5/4 Size 40/44mm- Hàng Chính Hãng",94050,99000,4950,5
TIKI,thiet-bi-kts-phu-kien-so,123838761,"Apple AirPods 2 - MV7N2 - Hộp Sạc Thường",2690000,5390000,2700000,50
TIKI,thiet-bi-kts-phu-kien-so,174593826,"Lót chuột máy tính PixLink kích thước 22x18cm hàng chính hãng",14000,39000,25000,64
TIKI,thiet-bi-kts-phu-kien-so,162772687,"Chuột không dây Logitech SIGNATURE M650 Wireless/Bluetooth - Hàng Chính Hãng",650000,650000,0,0
TIKI,thiet-bi-kts-phu-kien-so,110850007,"Tai nghe nhét tai có dây jack 3.5mm Remax RM-512 (New Package) - Hàng chính hãng",106550,150000,43450,29
TIKI,thiet-bi-kts-phu-kien-so,134364129,"Bộ Thu Phát Bluetooth TP-Link UB500 USB Nano Bluetooth 5.0 - Hàng Chính Hãng",118000,118000,0,0
TIKI,thiet-bi-kts-phu-kien-so,1059892,"Dây Cáp Sạc Lightning Cho iPhone Anker PowerLine II 0.9m - A8432H21",260000,330000,70000,21
TIKI,thiet-bi-kts-phu-kien-so,71672203,"Thẻ Nhớ microSDHC SanDisk Ultra 32GB UHS-I - 100MB/s (New 2020) - Hàng Nhập Khẩu",108000,108000,0,0
TIKI,thiet-bi-kts-phu-kien-so,71091864,"Đồng Hồ Pomodoro Hẹn Giờ 60 Phút Kim Loại Nhiều Kiểu Dáng",75000,75000,0,0
TIKI,thiet-bi-kts-phu-kien-so,137864606,"Tấm Lót Chuột, Thảm Da Trải Bàn Làm Việc VinBuy, Miếng Di Chuột Cỡ Lớn 40cmx80cm - Hàng Chính Hãng",90000,180000,90000,50
TIKI,thiet-bi-kts-phu-kien-so,56859344,"Chuột không dây sạc điện HXSJ M103 - Hàng chính hãng",119000,199000,80000,40
TIKI,thiet-bi-kts-phu-kien-so,272349163,"Micro thu âm không dây Remax K02 / K03 Dành cho điện thoại, hỗ trợ quay video, Livestream - Hàng Chính Hãng",595000,595000,0,0
TIKI,thiet-bi-kts-phu-kien-so,172146754,"Ốp lưng chống sốc lưng trong phong cách mới dành cho iPhone 11 / 12 / 13 / 11 Pro / 12 Pro / 13 Pro / 11 Pro Max / 12 Pro Max / 13 Pro Max / 12 Mini / 13 Mini - Hàng chính hãng",179000,250000,71000,28
TIKI,thiet-bi-kts-phu-kien-so,299461,"Chuột Không Dây Logitech M331 Silent",389000,389000,0,0
TIKI,thiet-bi-kts-phu-kien-so,201437484,"Giá Đỡ Máy Tính, Laptop, iPad, Macbook Hợp Kim Nhôm Cao Cấp. Hỗ Trợ Tản Nhiệt Chống Mỏi Cổ, Vai, Gáy. Hàng Chính Hãng Tamayoko",479000,489900,10900,2
TIKI,thiet-bi-kts-phu-kien-so,123518348,"Tai nghe Remax RM-201 - Hàng chính hãng",112250,150000,37750,25
TIKI,thiet-bi-kts-phu-kien-so,174593860,"Chuột Không Dây Bluetooth PIX-LINK P100B Chống Ồn, DPI 1600, Chế Độ Kép Wireless Usb 2.4Ghz, Bluetooth Dùng Cho Macbook, Laptop, PC - Hàng chính Hãng",133000,299000,166000,56
TIKI,thiet-bi-kts-phu-kien-so,174593840,"Chuột Không Dây PIX-LINK P100 Wireless 2.4Ghz Sạc Pin, Chống Ồn, DPI1600 Dùng Cho Máy Tính, Laptop, Tivi-Hàng Chính Hãng",115000,230000,115000,50
TIKI,thiet-bi-kts-phu-kien-so,88798139,"Dây Cáp Dù Lõi HDMI 2.1 8K 48Gbps, 4K 165Hz Dài 2M CHOETECH XHH01 Dùng Cho Tivi/ Máy Tính/ Playstation - Hàng Chính Hãng",219000,390000,171000,44
TIKI,thiet-bi-kts-phu-kien-so,126697,"Tai Nghe Nhét Tai Sony MDR-EX15AP",190000,199000,9000,5
TIKI,thiet-bi-kts-phu-kien-so,194458001,"Tai nghe bluetooth nhét tai chống ồn cao cấp V5.3 chính hãng dùng cho iPhone Samsung OPPO VIVO HUAWEI XIAOMI tai nghe không dây - Hàng Chính Hãng PKCB",313000,500000,187000,37
TIKI,thiet-bi-kts-phu-kien-so,127695415,"Loa Bluetooth HXSJ V6 Bản Mở Rộng Hỗ Trợ Kết Nối Bluetooth 5.0, Thẻ Nhớ, USB, Công suất 2 loa 10W Nhiều Màu Sắc - Hàng chính hãng",349000,689000,340000,49
TIKI,thiet-bi-kts-phu-kien-so,169196334,"Bàn Di Chuột Cỡ Lớn 30-80cm,Pad Chuột,Lót Chuột Phím Tắt Văn Phòng Cao Cấp - Bàn Di Công Thức",39000,39000,0,0
TIKI,thiet-bi-kts-phu-kien-so,78010530,"Adapter Củ Sạc CHOETECH PD5005 PD 20W Chuyên Sạc Nhanh iPhone, iPad - Hàng Chính Hãng",199000,390000,191000,49
TIKI,thiet-bi-kts-phu-kien-so,24865067,"Bút laser trình chiếu Slide VSON N35 - Hàng nhập khẩu",172000,172000,0,0
TIKI,thiet-bi-kts-phu-kien-so,195305655,"Adapter Sạc ANKER 511 Nano Pro 20W Type-C Sạc Nhanh Tích Hợp PIQ 3.0 A2637 Tương Thích iPhone 13 series và iPhone 12 series, Galaxy, Pixel 4/3, iPad / iPad mini - Hàng Chính Hãng",250000,450000,200000,44
TIKI,thiet-bi-kts-phu-kien-so,26029929,"Bàn di,tấm lót chuột chơi game Mouse pad",11900,11900,0,0
TIKI,thiet-bi-kts-phu-kien-so,201437397,"Giá Đỡ Laptop Hợp Kim Nhôm Cao Cấp Dễ Dàng Gấp Gọn, Giúp Tản Nhiệt Laptop, Máy Tính Xách Tay - 07 Nấc Điều Chỉnh Góc Độ. Hàng Chính Hãng Tamayoko",160000,160000,0,0
TIKI,thiet-bi-kts-phu-kien-so,52945747,"Giá đỡ laptop nhôm có thể gấp gọn dành cho Macbook Ipad Surface và máy tính xách tay",109000,109000,0,0
TIKI,thiet-bi-kts-phu-kien-so,87675294,"Đồng Hồ Thông Minh Trẻ Em Chống Nước Chuẩn IP67 AMA Watch Q12 Hàng nhập khẩu",280000,280000,0,0
TIKI,thiet-bi-kts-phu-kien-so,191684818,"Tai Nghe Bluetooth True Wireless AMOI F9 Cảm Ứng Vân Tay, Nâng Cấp Dock Sạc có Led Báo Pin Kép - Hàng Nhập Khẩu",89000,94000,5000,5
TIKI,thiet-bi-kts-phu-kien-so,128678712,"Apple Watch Series 7 GPS Sport Band (Viền Nhôm, Dây Cao Su)",7890000,12990000,5100000,39
TIKI,thiet-bi-kts-phu-kien-so,193209851,"Pin Sạc Dự Phòng 20000mAh Sạc Nhanh PD 20W QC 18W RAVPower RP-PB1205 - Hàng Chính Hãng",699000,1190000,491000,41
TIKI,thiet-bi-kts-phu-kien-so,637038,"Chuột Có Dây Dell MS116 (Đen) - Hàng Chính Hãng",82000,82000,0,0
TIKI,thiet-bi-kts-phu-kien-so,88796298,"Dây Cáp Nối Dài Âm Thanh 3.5mm Dài 2M CHOETECH AUX001-BK - Hàng Chính Hãng",99000,150000,51000,34
TIKI,thiet-bi-kts-phu-kien-so,68985833,"Dây sạc Cáp sạc Nam châm Đồng hồ Thông minh Q12, Q16, Q19, Q100, TD26, A28, DS60, DS66, Y95, D06, DF39 Hàng nhập khẩu",57000,57000,0,0
TIKI,thiet-bi-kts-phu-kien-so,126032985,"Ốp Lưng Trong Suốt MIPOW TEMPERED GLASS Dành Cho iPhone 13 Mini, Iphone 13/ 13 Pro, 13 Pro Max - Hàng Chính Hãng",68000,290000,222000,77
TIKI,thiet-bi-kts-phu-kien-so,189474023,"Sạc dự phòng không dây từ tính Remax RPP-65 10000mAh - Hàng chính hãng",753500,990000,236500,24
TIKI,thiet-bi-kts-phu-kien-so,125652874,"Combo củ cáp sạc nhanh chuẩn PD 20W cho IP12,IP13 Remax RPU88i-RC188i- Hàng chính hãng",450000,500000,50000,10
TIKI,thiet-bi-kts-phu-kien-so,107338360,"Bàn Di Chuột - Miếng Lót Chuột Cỡ Lớn Doron-HDC01 Size 40x80, 45x90 cm - Kiêm Deskpad Thảm Da, Trải Bàn Làm Việc Chống Nước Dùng Được Hai Mặt - Hàng Nhập Khẩu",99000,99000,0,0
TIKI,thiet-bi-kts-phu-kien-so,135410778,"Ốp Lưng Trong Suốt Hoco Dành Cho iPhone - Hàng Chính Hãng ",86000,86000,0,0
TIKI,thiet-bi-kts-phu-kien-so,91013563,"Remote Quạt Senko Điều Khiển (Tất Cả Các Loại như TR1683, DR1608, TR1628, DH1600) Hàng Chính Hãng",70000,70000,0,0
TIKI,thiet-bi-kts-phu-kien-so,72540740,"Ốp lưng dẻo thoát nhiệt dành cho iPhone 11 PRO MAX - Đen - Hàng chính hãng",49000,69000,20000,29
TIKI,thiet-bi-kts-phu-kien-so,116783441,"5in1 - Bộ vệ sinh Laptop, Macbook, Máy ảnh Cao Cấp - Hàng Nhập Khẩu - Chính Hãng JRC",228800,228800,0,0
TIKI,thiet-bi-kts-phu-kien-so,102391960,"Giá Đỡ Máy Tính, Laptop, iPad, Macbook Hợp Kim Nhôm Cao Cấp. Hỗ Trợ Tản Nhiệt Chống Mỏi Cổ, Vai, Gáy. Hàng Chính Hãng Tamayoko",450000,500000,50000,10
TIKI,thiet-bi-kts-phu-kien-so,195277333,"Ốp lưng dẻo cho iPhone 8 / SE 2020 / 8 Plus / X / XS / XR / XS Max / 11 / 11 Pro / 11 Pro Max / 12 / 12 Pro / 12 Pro Max / 12 Mini / 13 / 13 Pro / 13 Pro Max / 13 Mini / 14 / 14 Pro / 14 Pro Max / 14 Max -Hàng chính hãng-Photodesign VN",149000,250000,101000,40
TIKI,thiet-bi-kts-phu-kien-so,117987260,"Loa Máy Tính Doron V-196 - Âm Thanh Siêu Trầm 4D, Bass Êm - Hàng Chính Hãng",190000,190000,0,0
TIKI,thiet-bi-kts-phu-kien-so,1517005,"Thẻ Nhớ Micro SDHC SanDisk UHS-1 32GB Class 10 - Hàng Chính Hãng",108000,108000,0,0
TIKI,thiet-bi-kts-phu-kien-so,87106876,"Dây Cáp Sạc Nhanh USB Type C to Type C 100W Dài 1.8M Chuyên Sạc iPhone 15, Macbook, Laptop, Smartphone CHOETECH XCC-1002-GY - Hàng Chính Hãng",189000,280000,91000,33
TIKI,thiet-bi-kts-phu-kien-so,110169574,"Thảm Lót Chuột Cỡ Lớn, Dùng Được Hai Mặt - Da PU Chống Nước - Doron HD01 - Kiêm Deskpad Thảm Da, Trải Bàn Làm Việc - Hàng Nhập Khẩu",79000,79000,0,0
TIKI,thiet-bi-kts-phu-kien-so,188998014,"Ốp Bảo Vệ Chống Sốc Armor TPU PC Cho Airpods 1,2 / Airpods 3/ Airpods Pro/ Airpods Pro 2 Kèm Móc Treo- Hàng Chính Hãng",99000,99000,0,0
TIKI,thiet-bi-kts-phu-kien-so,895314,"Tai Nghe Nhét Tai Langsdom Super Bass JM26",45000,50000,5000,10
TIKI,thiet-bi-kts-phu-kien-so,111983048,"Dây Cáp HDMI 2.1 CHOETECH XHH03-BK Dài 2M Phân Giải Tối Đa 8K 48Gbps, 4K 120Hz Dùng Cho Tivi/Laptop/Playstation/PC - Hàng Chính Hãng",179000,260000,81000,31
TIKI,thiet-bi-kts-phu-kien-so,192364741,"Miếng Lót Chuột ,Bàn Di Chuột Huqu -Chất Liệu Sợi Fiber -Hàng Chính Hãng ",28500,30000,1500,5
TIKI,thiet-bi-kts-phu-kien-so,95085073,"Dây Cáp Chuyển Đổi USB Type C To HDMI 4K 60Hz Dài 1.8M CHOETECH CH0019 - Hàng Chính Hãng",369000,590000,221000,37
TIKI,thiet-bi-kts-phu-kien-so,104268199,"Chuột không dây kiểu đứng sạc pin HXSJ T22 wireless USB 2.4GHz chống mỏi tay chuyên dùng cho pc laptop macbook ipad tivi - Hàng chính hãng",349000,599000,250000,42
TIKI,thiet-bi-kts-phu-kien-so,122158068,"Tẩu sạc nhanh 20W trên xe hơi ô tô HOCO Z42 PD QC 3.0 Dành cho điện thoại iPhone iP Samsung Oppo cốc củ cóc sạc oto  - Hàng chính hãng",159000,159000,0,0
TIKI,thiet-bi-kts-phu-kien-so,199165708,"Giá đỡ laptop tuỳ chỉnh góc nghiêng để phù hợp góc nhìn của bạn chất liệu hợp kim nhôm, hỗ trợ tản nhiệt tốt cho máy tính laptop, macbook và máy tính bảng",109000,109000,0,0
TIKI,thiet-bi-kts-phu-kien-so,53547831,"Lót chuột  siêu bền 26x21 cm - Hàng chính hãng",19000,19000,0,0
TIKI,thiet-bi-kts-phu-kien-so,360660,"Bộ Bàn Phím Và Chuột Logitech MK220 Không Dây - Hàng chính hãng",419000,419000,0,0
TIKI,do-choi-me-be,273720404,"Sữa Ensure Úc hồi phục sức khỏe cho người già, người ốm yếu, suy dinh dưỡng, người sau phẫu thuật - QuaTangMe Extaste",1039000,2078000,1039000,50
TIKI,do-choi-me-be,94726851,"Thú nhún trẻ em cao cấp Toyshouse PA1012 - Tiêu chuẩn Xuất khẩu Mỹ (ASTM) và Châu Âu (EN71)- Đồ chơi vận động cho bé từ 8 tháng",309000,410000,101000,25
TIKI,do-choi-me-be,84598543,"LOẠI XỊN - Cây Xương Rồng Nhồi Bông Có Nhạc, Biết Nhảy Biết Múa và Nhại Tiếng - PHÁT SÁNG",64999,64999,0,0
TIKI,do-choi-me-be,168778815,"Gạc Rơ Lưỡi Dr.Papie Vệ Sinh Răng Miệng Cho Bé",160000,160000,0,0
TIKI,do-choi-me-be,53210144,"Bộ 2 Gói Nước Rửa Bình Sữa D-nee (550ml x 2)",105000,105000,0,0
TIKI,do-choi-me-be,74769722,"Kutieskin 30gr Kem mẩn ngứa – hăm Kutieskin",96000,96000,0,0
TIKI,do-choi-me-be,154702528,"Nôi ru ngủ thư giãn kết hợp ghế ngồi đọc sách cho bé nhạc trắng Mastela 8104/8106 - điều khiển từ xa - kết hợp Bluetooth",2190000,2190000,0,0
TIKI,do-choi-me-be,170154837,"Đồ Bơi Liền Thân Tay Dài - Black Bodysuit",442000,520000,78000,15
TIKI,do-choi-me-be,119706876,"Sữa tắm gội dịu lành cho bé Cetaphil Baby Gentle Wash & Shampoo 400ml",245000,245000,0,0
TIKI,do-choi-me-be,121678667,"Đồ Chơi Đèn Pin Kể Chuyện Mideer Phiên Bản 12 Truyện - Mideer StoryBook Torch (có bản dịch tiếng Việt)",319000,450000,131000,29
TIKI,do-choi-me-be,72014622,"Khoá Chặn Cửa Tủ , Tủ Lạnh Bảo Vệ An Toàn Cho Bé",7499,7499,0,0
TIKI,do-choi-me-be,95035914,"Dinh dưỡng 100% Trái cây nghiền Organic HiPPiS Chuối, Lê, Xoài",60000,60000,0,0
TIKI,do-choi-me-be,95082972,"Sữa bột Enfamil A2 Neuropro 2 cho trẻ từ 6 - 12 tháng tuổi – 350g",303000,303000,0,0
TIKI,do-choi-me-be,27657637,"Khăn vải khô đa năng Mama 240 tờ",53000,53000,0,0
TIKI,do-choi-me-be,190547367,"Đai, địu lưới thoáng khí thoải mái cho bé",83989,83989,0,0
TIKI,do-choi-me-be,85366318,"Xương Rồng Nhại Giọng Nói Phiên Bản Cao Cấp Nhảy Theo Điệu Nhạc",99000,99000,0,0
TIKI,do-choi-me-be,95035935,"Dinh dưỡng 100% Trái cây nghiền Organic HiPPiS Kiwi, Lê, Chuối",60000,60000,0,0
TIKI,do-choi-me-be,272412284,"1 con dao Đồ chơi dao cà rốt động lực in 3d phản quang đồ chơi giải trí giảm street",25000,25000,0,0
TIKI,do-choi-me-be,177274317,"Mũ bảo vệ đầu chống va đập an toàn cho bé yêu từ 7 tháng đến 48 tháng_RUBIK",78750,105000,26250,25
TIKI,do-choi-me-be,1008834,"Máy đưa võng em bé VINANOI - Vn365",550000,550000,0,0
TIKI,do-choi-me-be,94762046,"Túi Trữ Sữa Mama's Choice, Túi Đựng Sữa Mẹ Loại 250ml và 120ml, Kiểm Định An Toàn Bởi Bureau Veritas, Hộp 30 Túi",115000,125000,10000,8
TIKI,do-choi-me-be,48331524,"FITOBIMBI IMMUNO – SIRO THẢO DƯỢC CHUẨN HÓA CHÂU ÂU TĂNG CƯỜNG MIỄN DỊCH TOÀN CHO TRẺ (200ML)",365000,365000,0,0
TIKI,do-choi-me-be,129727791,"Ghế Bô Cho Bé Đi Vệ Sinh Có Tựa Lưng,Chân Đế Chống Trượt,Có Ngăn Chứa Dễ Tháo Lắp Cọ Rửa",95000,95000,0,0
TIKI,do-choi-me-be,116572142,"Thùng 6 lon sữa bột dinh dưỡng công thức HiPP 3 Organic Combiotic chất lượng hữu cơ tăng cường sức khoẻ hệ miễn dịch, bổ sung Canxi và vitamin D dành cho trẻ trên 12 tháng tuổi (6 lon x 800g)",4320000,4320000,0,0
TIKI,do-choi-me-be,184437908,"Túi Viên Giặt Xả Đa Năng 4 Trong 1 KA Universal (1 Viên/ Túi)",25000,25000,0,0
TIKI,do-choi-me-be,273155095,"Philips Avent Bình sữa mô phỏng tự nhiên mới - dung tích 330ml cho bé từ 3 tháng SCY906.01 SCY906.02",315000,315000,0,0
TIKI,do-choi-me-be,110138019,"MÁY ĐA NĂNG ĐIỆN TỬ (ALL-IN-ONE) FATZBABY - MULTIMAX 1 - FB9002SJ CHÍNH HÃNG BẢO HÀNH 12 THÁNG",999000,999000,0,0
TIKI,do-choi-me-be,23643074,"Đồ chơi gỗ - Giáo cụ Montessori Ghép hình tư duy Four color Game",102000,102000,0,0
TIKI,do-choi-me-be,85030214,"Áo dài tay MIOMIO (0m-24m) phom rộng",64000,64000,0,0
TIKI,do-choi-me-be,171666472,"Cánh bướm thiên thần CÓ ĐÈN kèm Gậy và vương miện cho bé gái",33000,33000,0,0
TIKI,do-choi-me-be,89643366,"Boardgame Cờ Tỷ Phú Việt Nam Sato Cỡ Lớn 42x42 Tặng Kèm Xúc Xắc Gỗ-Trò Chơi Rèn Luyện Tư Duy Làm Giàu",87000,87000,0,0
TIKI,do-choi-me-be,26612371,"Tã quần cao cấp Bobby Extra Soft Dry thun chân ngăn hằn",377300,377300,0,0
TIKI,do-choi-me-be,116149803,"Áo Polo Trẻ Em Mắt Chim Phối Bo Thoải Mái Và Thoáng Mát APK5177",219000,219000,0,0
TIKI,do-choi-me-be,435761,"Sữa Bột Abbott Grow Gold 3+ cho trẻ từ 3 - 6 tuổi (900g)",469000,469000,0,0
TIKI,do-choi-me-be,90654128,"Set đồ sơ sinh cotton 18 chi tiết mùa xuân hè thu cho bé trai và bé gái (3 bộ bồ, 1 yếm choàng lớn, 1 gối, 1 yếm tròn nhỏ, 1 yếm tam giác, 4 khăn sữa, 1 mũ, 1 đôi tất tay, 1 đôi tất chân)",349000,349000,0,0
TIKI,do-choi-me-be,173768941,"Boardgame Lớp Học Mật Ngữ - Khu Rừng Kim Cương",485200,599000,113800,19
TIKI,do-choi-me-be,173751815,"Quần áo bé trai, đồ bộ in 3D thấm hút mồ hôi tốt, co giãn 4 chiều mềm mại, in hoạt hình cực hót, set, thời trang, bộ đồ, đồ cho trẻ em, bé trai từ 8-28kg",66000,66000,0,0
TIKI,do-choi-me-be,68328015,"Bệ Thu Nhỏ Bồn Cầu Cho Bé Cleverbees - Nhựa PVC Cao Cấp",209000,249000,40000,16
TIKI,do-choi-me-be,189673426,"Nước giặt Lix Hương Nước Hoa Túi 3.5Kg - Tẩy Sạch Cực Mạnh Vết Bẩn - NGH07",115000,115000,0,0
TIKI,do-choi-me-be,249578221,"Đồ bộ 3 lỗ bé trai chất cotton bộ mùa hè cho bé hàng Quảng Châu chất lượng cao",59000,59000,0,0
TIKI,do-choi-me-be,171153525,"Hộp 6 bộ đồ chơi lắp ráp Robot biến hình - Thiết bị quân sự Qman 1412",329000,359000,30000,8
TIKI,do-choi-me-be,270796181,"Vitamin tổng hợp cho trẻ L'il Critters Gummy Vites Daily Mỹ chứa vitamin và khoáng chất hỗ trợ miễn dịch, mắt, chống oxy hóa và tăng sức khỏe tổng thể - QuaTangMe Extaste",593000,1186000,593000,50
TIKI,do-choi-me-be,129710218,"HOT: Chó Shiba XẢ STRESS - Chó Shiba silicon co dãn, dẻo, đàn hồi ngộ nghĩnh, giải tỏa căng thẳng, xả STRESS",20000,20000,0,0
TIKI,do-choi-me-be,2173351,"Combo 3 Bịch Khăn Vải Khô Likado (300g)",109000,120000,11000,9
TIKI,do-choi-me-be,129665688,"(HCM) Tấm đệm lót người già Caryn khổ lớn 60x70cm gói 14 miếng",98000,98000,0,0
TIKI,do-choi-me-be,168160974,"Khăn Lau Hạ Sốt 0+ Dr.Papie Cho Bé Hạ Nhiệt Giảm Sốt Ngăn Ngừa Co Giật",185000,185000,0,0
TIKI,do-choi-me-be,17702472,"4 Bịch Khăn vải khô đa năng LIKADO 400g (20 x 22cm)",220000,240000,20000,8
TIKI,do-choi-me-be,133545034,"Combo 6 Gói Khăn Ướt Yuniku 90 Tờ Hương Lài ( 90 Tờ x 6 )",145000,250800,105800,42
TIKI,do-choi-me-be,118494409,"Siro Uống Nature's Way Kids Smart Drops DHA Dạng Giọt Giúp Tăng IQ, Phát Triển Não Bộ Cho Bé 20ml",350000,350000,0,0
TIKI,do-choi-me-be,70839639,"Bàn Tỷ Phú Lớn",115000,115000,0,0
TIKI,do-choi-me-be,55461311,"Tinh dầu tràm Huế Kim Vui 125ml - Tinh dầu dùng cho trẻ sơ sinh",190000,190000,0,0
TIKI,do-choi-me-be,126243917,"Chậu Xông Vùng Kín Sau Sinh, Chậu xông hơi vùng kín Gấp Gọn, gắn bồn cầu, bô xông vùng kín Tiện Lợi kèm Vòi xịt phụ khoa",83900,83900,0,0
TIKI,do-choi-me-be,75996180,"Đồ chơi lò xo cầu vồng ma thuật bằng nhựa (đường kính 7 cm)",15600,15600,0,0
TIKI,do-choi-me-be,134440669,"Ghế ăn dặm gấp gọn cao cấp Umoo mới nhất 2021, có bánh xe và điều chỉnh được độ cao",647000,699999,52999,8
TIKI,do-choi-me-be,56815790,"Bộ tranh xếp hình 150 mảnh – Totoro",45000,65000,20000,31
TIKI,do-choi-me-be,105219052,"Mút Cao Su Dán, Bọc Cạnh, Góc Bàn An Toàn Cho Bé - KUB",74000,74000,0,0
TIKI,do-choi-me-be,90584712,"Bệ Thu Nhỏ Bồn Cầu Cho Bé - Nhựa PVC Cao Cấp",179000,179000,0,0
TIKI,do-choi-me-be,59049510,"Chất thông tắc Cống và Cầu Sifa chống hôi Siêu nhanh siêu mạnh 5 phút 425ml cao cấp",50000,50000,0,0
TIKI,do-choi-me-be,49498423,"Combo 2 bịch bỉm/tã quần cao cấp MIJUKU - M",335000,335000,0,0
TIKI,do-choi-me-be,107972572,"Bình sữa mô phỏng tự nhiên hiệu Philips Avent (125 ml - đơn) cho trẻ từ 0 tháng tuổi 690.13",285000,285000,0,0
TIKI,do-choi-me-be,58141815,"Bột Thông Tắc Cống, Đường Ống - EcoSock Hộp 0.5Kg - Hàng Chính Hãng Từ Mỹ",362000,362000,0,0
TIKI,do-choi-me-be,197329427,"Cuộn 2m Mút Xốp Bọc Cạnh Bàn Ghế Giường Tủ Bảo Vệ An Toàn Cho Bé",65000,65000,0,0
TIKI,do-choi-me-be,174624883,"Giấy vệ sinh 3 lớp cao cấp có lõi JAPANI SILK | Thế Giới Giấy | 100% bột giấy nguyên sinh | 10 cuộn",64000,86000,22000,26
TIKI,do-choi-me-be,48184895,"Dung dịch tẩy rửa máy rửa chén Finish Dishwasher Cleaner Lemon 2x250ml QT04441 - hương chanh",179000,179000,0,0
TIKI,do-choi-me-be,177751108,"MÁY HÚT SỮA ĐIỆN ĐÔI FATZ BABY - CHORUS 2 - FB1182MX",666000,666000,0,0
TIKI,do-choi-me-be,74850451,"Đồ chơi mô hình xe ô tô cảnh sát chạy pin, nhựa nguyên sinh an toàn, chạy rất nhanh và xa",36000,36000,0,0
TIKI,do-choi-me-be,74769754,"Đồ chơi mô hình xe trộn bê tông KAVY NO.8809 chất liệu hợp kim và nhựa nguyên sinh an toàn, chi tiết sắc sảo",68000,68000,0,0
TIKI,do-choi-me-be,127993576,"Đồ Chơi Gỗ Cao Cấp Hộp thả hình, đồ chơi gỗ thông minh - hàng chính hãng",134640,136000,1360,1
TIKI,do-choi-me-be,72577100,"03 bộ tranh xếp hình 70 mảnh ghép khổ A3 – đồ chơi trí tuệ cho bé từ 3 tuổi – Combo 1 (Giao mẫu ngẫu nhiên)",85000,110000,25000,23
TIKI,do-choi-me-be,730491,"Nước Rửa Bình Thảo Mộc Arau Baby Dạng Túi (450ml)",109650,129000,19350,15
TIKI,do-choi-me-be,95035851,"Trà cốm lợi sữa HiPP dành cho phụ nữ cho con bú 200g",175000,175000,0,0
TIKI,do-choi-me-be,102262521,"Phao bơi chống lật Swim Bobo cho bé từ 1 tuổi đến 5 tuổi",319000,346020,27020,8
TIKI,do-choi-me-be,94728752,"Đồ chơi giáo dục sớm thả hình khối có quai xách cho bé Toyshouse 0702-TH-HE0218",139000,160000,21000,13
TIKI,do-choi-me-be,191678954,"Đèn lồng trung thu hình thú phát sáng, Đèn led phát sáng vui nhộn",33377,33377,0,0
TIKI,do-choi-me-be,116572109,"Combo 3 Trà cốm lợi sữa hoà tan HiPP Mama Herbal Nursing Tea 100% thảo mộc, dành cho mẹ sau sinh và đang cho con bú giúp bồi bổ cơ thể, hỗ trợ và tăng cường lượng sữa (2 hộp x 200g)",525000,525000,0,0
TIKI,do-choi-me-be,95035825,"Bột ăn dặm dinh dưỡng Ngũ cốc bắp non HiPP Organic 200g",135000,135000,0,0
TIKI,do-choi-me-be,165846177,"XE ĐẨY GẤP GỌN CHO BÉ HAKAWA HK-B07 - HÀNG CHÍNH HÃNG",1200000,1200000,0,0
TIKI,do-choi-me-be,42411606,"Cuộn bọc cạnh bàn ghế, cạnh tủ cao su non bảo vệ an toàn cho bé vui chơi trong nhà (2 mét) tặng kèm băng dính -giao màu ngẫu nhiên",31998,31998,0,0
TIKI,do-choi-me-be,147588060,"Bộ Bài Tây Poker Mạ Si Vàng 24K Cao Cấp Phủ Nhũ Vàng Chính Hãng Dododios – Bộ 54 Lá Bài Tây Pocker Nhựa Dẻo Chống Thấm Nước Chống Gãy",29000,29000,0,0
TIKI,do-choi-me-be,3525963,"Đồ Chơi Bé Trai, Đồ Chơi Dụng Cụ Sửa Chữa Cơ Khí Toyshouse",170000,170000,0,0
TIKI,thiet-bi-kts-phu-kien-so,173058453,"Chuột không dây bluetooth Logitech POP MOUSE - giảm ồn, nút emoji tùy chỉnh - Hàng chính hãng",529000,899000,370000,41
TIKI,thiet-bi-kts-phu-kien-so,191817608,"Bộ Bàn Phím Chuột không dây W201 nhỏ gọn",218500,230000,11500,5
TIKI,thiet-bi-kts-phu-kien-so,116125939,"Dán màn hình dành cho iPad Paper-like Kai Cao Cấp chống vân tay cho cảm giác vẽ như trên giấy",145000,145000,0,0
TIKI,thiet-bi-kts-phu-kien-so,270767050,"[Mới 100%] Sim VIETNAMOBILE Chuyên Dùng Để Nghe Gọi & Tạo Tài Khoản TMĐT, Laz, Sope, Sen, Face, ZaL0, Momo, Tw, Tele, Game... TK 0đ Giá Rẻ - Cam Kết Chưa Từng Đăng Ký Dịch Vụ Gì. Hàng Chính Hãng",55900,110000,54100,49
TIKI,do-choi-me-be,133790543,"Gối Mẹ Bầu Đậu Khuyết Đa Năng Linen Bông Gòn Lông Vũ Cao Cấp | 159",599000,599000,0,0
TIKI,do-choi-me-be,120170572,"Xe chòi chân B.Duck yên da cho bé từ 1 đến 2 tuổi - Xe thăng bằng khung thép, bánh cao su an toàn cho trẻ DC019",249000,249000,0,0
TIKI,thiet-bi-kts-phu-kien-so,52602232,"Combo Sạc cáp nhanh 25w Type C dùng cho SS Note10 / S10plus 5G / A80, OPPO, VIVO, HUAWEI",110000,110000,0,0
TIKI,thiet-bi-kts-phu-kien-so,111748361,"Lót chuột phím tắt văn phòng đã Việt hóa khổ lớn cực tiện dụng - Hàng chính hãng",55000,55000,0,0
TIKI,do-choi-me-be,70844277,"Bộ Thẻ Bài Pokemon 324 Thẻ Cao Cấp Nhiều Loại",198000,198000,0,0
TIKI,thiet-bi-kts-phu-kien-so,122949142,"Tai nghe Bluetooth True Wireless Samsung Galaxy Buds 2 - Hàng Chính Hãng",1590000,2990000,1400000,47
TIKI,thiet-bi-kts-phu-kien-so,126998612,"Loa Bluetooth JBL Charge 5 - Hàng Chính Hãng",3790000,3990000,200000,5
TIKI,thiet-bi-kts-phu-kien-so,51059393,"Tai Nghe Dây Cho Các Dòng Sản Phẩm Phân Khúc Galaxy J Của Samsung",27900,27900,0,0
TIKI,do-choi-me-be,16374640,"Tấm Lót Chống Thấm Tiện Lợi An Toàn Cho Bé (80 x 120 cm)",88000,117000,29000,25
TIKI,do-choi-me-be,55576959,"Tinh dầu tràm Con Dơi ( Nguyên chất 100%)",137000,137000,0,0
TIKI,do-choi-me-be,90526567," Váy đầm thun bé gái dễ thương - Size 11-45kg - K134",150000,150000,0,0
TIKI,do-choi-me-be,89233900,"Lưới bọc quạt loại to có dây kéo an toàn cho trẻ nhỏ . Đường kính tối đa 50cm",20500,20500,0,0
TIKI,do-choi-me-be,205290276,"Nước làm bóng Finish 750ml",118000,118000,0,0
TIKI,thiet-bi-kts-phu-kien-so,68467585,"Đồng Hồ Thông Minh Trẻ Em ngôn ngữ Tiếng Việt, Pin sử dụng được 2 ngày, dây đeo có Hoa văn hình Trái tim Dễ thương Model Y85 Pro - Hàng nhập khẩu",490000,490000,0,0
TIKI,thiet-bi-kts-phu-kien-so,115105801,"Thiết Bị Đọc Thẻ Nhớ ROBOT CR202 - 2 Đầu Type-C Và USB 3.0, Khe Cắm Thẻ Nhớ SD/Micro SD - Hàng Chính Hãng",220000,220000,0,0
TIKI,thiet-bi-kts-phu-kien-so,158868825,"[FREE 6 Tháng - Đầu Số 092] SIM MAX DATA 4G VIETNAMOBILE - 6GB/Ngày. Trọn Gói 6 Tháng Không Cần Nạp Tiền - Hàng Chính Hãng",268000,350000,82000,23
TIKI,thiet-bi-kts-phu-kien-so,13781962,"Bút trình chiếu Lazer- Bút thuyết trình- Bút trình chiếu silde- Bút điều khiển trình chiếu- Bút trình chiếu powerpoint",94500,94500,0,0
TIKI,thiet-bi-kts-phu-kien-so,54616399,"Giá đỡ điện thoại để bàn gấp Điện thoại di động Giá đỡ bàn cho iPhone ipad pro mini Samsung Xiaomi Tablet Đứng tăng và giảm Giá đỡ có thể điều chỉnh",13000,13798,798,6
TIKI,do-choi-me-be,755394,"Cờ Domino Ngà Lớn Liên Hiệp Thành KDNL",78000,78000,0,0
TIKI,do-choi-me-be,95035841,"(date T6.24) Dinh dưỡng đóng lọ ăn dặm Trái cây nhiệt đới HiPP Organic 125g",45000,45000,0,0
TIKI,thiet-bi-kts-phu-kien-so,150205187,"Que Chọc Sim",1490,1490,0,0
TIKI,do-choi-me-be,24448316,"Nước rửa bình sữa D-nee Mild & Care chai 500ml",79000,91000,12000,13
TIKI,do-choi-me-be,68462933,"Bỉm - Tã Quần Moony Natural Size XL- 32 miếng ( bé 12- 22Kg)",286900,286900,0,0
TIKI,thiet-bi-kts-phu-kien-so,55210024,"Giá Đỡ Dành Cho Laptop Macbook Để Bàn Chất Liệu Hợp Kim Nhôm Cao Cấp Hàng Nhập Khẩu Helios",219000,400000,181000,45
TIKI,thiet-bi-kts-phu-kien-so,115847303,"Giá Đỡ Để Bàn Điện Thoại Di Động, Máy Tính Bảng. Chất Liệu Hợp Kim Nhôm Cao Cấp. Xoay 270 Độ Tự Do Điều Chỉnh Góc Nhìn Model Z4. Hàng Chính Hãng Tamayoko",119000,149000,30000,20
TIKI,do-choi-me-be,89752727,"Bộ bơi bé gái lớn, dáng 2 mảnh cộc tay quần sooc đùi thể thao, màu sắc trẻ trung, áo tắm trẻ em nữ size đại từ 25 đến 60kg | BT37",299000,314420,15420,5
TIKI,thiet-bi-kts-phu-kien-so,173034520,"Combo chuột phím không dây Logitech MK345 - 1 đầu thu USB, pin lâu, chống tràn, fullsize - Hàng chính hãng",565000,749000,184000,25
TIKI,do-choi-me-be,52579303,"[COMBO 4 GÓI] KHĂN VẢI KHÔ ĐA NĂNG AIKO X 270 TỜ/ GÓI",140000,140000,0,0
TIKI,do-choi-me-be,64029864,"Bộ Thẻ Nhân Quả (Cấp Độ Trung Bình) | Game Tư Duy Nhân Quả Số 1 Tại Việt Nam",200000,200000,0,0
TIKI,do-choi-me-be,274536010,"[Combo Tiện Lợi] Gói Men Bể Phốt EcoClean Septic - Men Vi Sinh Xử Lý Hầm Cầu, Bể Phốt Đầy, Tràn - Túi Gói 100gram",246000,246000,0,0
TIKI,thiet-bi-kts-phu-kien-so,135412837,"Đế Sạc Nhanh Không Dây Đa Năng 3in1 Remax RP-W53 - Hỗ Trợ Sạc Nhanh Lên Đến 15W - Hàng Chính Hãng",550000,550000,0,0
TIKI,do-choi-me-be,104559720,"Kính bơi cho trẻ em độ tuổi từ 4 tuổi đến 10 tuổi",89000,94240,5240,6
TIKI,thiet-bi-kts-phu-kien-so,86018342,"Kính Cường Lực KingKong 9D Trong Suốt Dành Cho iPhone - Full Hộp Sắt Cao Cấp - Dán Full Màn - Hàng Chính Hãng",105991,211982,105991,50
TIKI,do-choi-me-be,130362474,"SET 10 QUẦN ĐÙI THUN COTTON NHIỀU HOẠ TIẾT CHO BÉ GÁI",197000,197000,0,0
TIKI,thiet-bi-kts-phu-kien-so,135716055,"Ốp da cao cấp dành cho iPhone 13 / 13 Pro / 13 Pro Max / 13 Mini - Hàng chính hãng",149000,250000,101000,40
TIKI,do-choi-me-be,70904714,"Tã Dán Siêu Thấm Caryn Gói Siêu Tiết Kiệm M40 (40 Miếng) - MẪU MỚI",349000,349000,0,0
TIKI,thiet-bi-kts-phu-kien-so,195998782,"Cáp sạc và truyền dữ liệu 2.4A Remax RC-138a USB to TypeC  - Hàng chính hãng",59000,99000,40000,40
TIKI,do-choi-me-be,117031983,"Áo Hút Sữa Rảnh Tay Mama’s Choice, Mặc Hút Sữa Cho Mẹ, Có Dây Giữ Bình Hút Sữa Chắc Chắn, Chất Liệu Thoáng Khí, Freesize - MÀU ĐEN",350000,390000,40000,10
TIKI,thiet-bi-kts-phu-kien-so,4539349,"Bộ Vệ Sinh Laptop ",19000,19000,0,0
TIKI,do-choi-me-be,90475777,"Thuốc diệt chuột thái lan tiêu diệt cả đàn sau 3 ngày tặng kèm bịt thuốc diệt dán và kiến",31900,31900,0,0
TIKI,do-choi-me-be,74944614,"Đồ chơi hình cú mèo chạy cót KAVY nhấn là chạy đáng yêu dễ thương nhựa nguyên sinh an toàn",22000,22000,0,0
TIKI,thiet-bi-kts-phu-kien-so,7734288,"SIM 4G Mobifone MDT250A Trọn Gói 1 Năm Không Cần Nạp Tiền - Hàng chính hãng - Mẫu ngẫu nhiên",299000,299000,0,0
TIKI,thiet-bi-kts-phu-kien-so,148813604,"Chuột không dây Logitech M331 SILENT-Hàng chính hãng",397000,397000,0,0
TIKI,do-choi-me-be,104156562,"Sữa tắm dịu nhẹ Jojoba Pigeon 200ml/700ml",47000,67000,20000,30
TIKI,thiet-bi-kts-phu-kien-so,148824604,"Bộ thu phát Bluetooth, thiết bị hỗ trợ thu phát nhạc không dây Nano USB 5.0 Bluetooth dành cho Laptop, Máy tính để bàn, Tivi",30000,39000,9000,23
TIKI,thiet-bi-kts-phu-kien-so,3416201,"Bảng Vẽ Wacom Intuos S CTL-4100 - Hàng Chính Hãng",2147000,2147000,0,0
TIKI,thiet-bi-kts-phu-kien-so,1457747,"Thẻ Nhớ Micro SDXC SanDisk UHS-1 64GB Class 10 - Hàng Chính Hãng",173000,173000,0,0
TIKI,do-choi-me-be,205719867,"Combo muối rửa bát Finish 1,5kg+viên rửa bát Finish 120 viên+Nước làm bóng bát chén finish 800ml",519000,519000,0,0
TIKI,thiet-bi-kts-phu-kien-so,356188,"Chuột Có Dây Logitech B100 - Hàng Chính Hãng",89000,89000,0,0
TIKI,thiet-bi-kts-phu-kien-so,71291990,"Giá Đỡ Laptop Nhôm Gấp Gọn, Laptop Stand Dùng Cho Máy Từ 11~17 inch, Có Thể Điều Chỉnh Nhiều Mức Độ Cao, Chất Liệu Hợp Kim Nhôm Cao Cấp",65800,65800,0,0
TIKI,do-choi-me-be,107693416,"Nước rửa bát hữu cơ Fuwa3e organic Enzyme sinh học 500ml an toàn cho bé bảo vệ da tay",58000,58000,0,0
TIKI,do-choi-me-be,247474808," Bàn Chải Đánh Răng Trẻ Em Jodily 1-4 Tuổi Siêu Mền Mại (Dành Cho Bé Tập Đánh Răng)",55000,55000,0,0
TIKI,do-choi-me-be,153820898,"Bộ bóc dán thông minh cho bé 17 chủ đề (loại cao cấp), dùng nhiều lần, giúp bé vừa chơi, vừa học tiếng Anh",99000,198000,99000,50
TIKI,thiet-bi-kts-phu-kien-so,95681232,"Adapter Sạc Anker 1 cổng 65W Hỗ Trợ Sạc Nhanh PIQ 3.0 PowerPort III Pod Lite - A2718 - Hàng chính hãng",594000,750000,156000,21
TIKI,do-choi-me-be,146399059,"Sữa bột Nutricare Care 100 Plus phục hổi dinh dưỡng cho trẻ biếng ăn (900g)",335000,335000,0,0
TIKI,thiet-bi-kts-phu-kien-so,175104946,"Thẻ Nhớ Micro SDXC Samsung Evo Plus U3 130MB/s 256GB New - Hàng Nhập Khẩu",480000,480000,0,0
TIKI,thiet-bi-kts-phu-kien-so,97034068,"Tai Nghe Nhét Tai XSmart HiFi S2000 Pro Super Bass Chống Ồn Cực Tốt, Âm Thanh Khủng, Chơi Game Ngon - Hàng Chính Hãng",69000,69000,0,0
TIKI,do-choi-me-be,181184380,"Ghế ăn dặm cho bé gập gọn và nâng hạ độ cao Mastela 7331 - Ghế tập ăn dặm cho bé đạt chuẩn ASTM Mỹ BPA Free",660000,660000,0,0
TIKI,thiet-bi-kts-phu-kien-so,72725402,"Combo chuột phím không dây Logitech MK295 Silent - Chống ồn 90%, có phím số, mắt đọc cải tiến, bền bỉ, không lag - Hàng chính hãng",694000,694000,0,0
TIKI,do-choi-me-be,57933293,"Hộp 8 bộ đồ chơi lắp ráp Biệt đội cứu hỏa vòi rồng 8in1 Qman 1805 (313 chi tiết)",177000,256000,79000,31
TIKI,do-choi-me-be,94728826,"Áo yếm máng dài tay Cotton chống thấm nước cho bé tập ăn dặm, tập vẽ Mastela Dành cho bé từ 0-4 tuổi - Có chọn màu và size",69000,95000,26000,27
TIKI,do-choi-me-be,68142209,"Nutifood GrowPLUS+ Đỏ 1500 Gr : sữa dành cho trẻ từ 1- 10 tuổi bị suy dinh dưỡng thấp còi (mẫu mới)",555000,555000,0,0
TIKI,do-choi-me-be,44885577,"Đồ Chơi Gỗ Bộ Domino 100 Quốc Gia Trên Thế Giới",95000,150000,55000,37
TIKI,do-choi-me-be,135478535,"Nước giặt Dnee cho bé chai 3000ml-hàng chính hãng có hoá đơn",194000,194000,0,0
TIKI,do-choi-me-be,73272562,"Combo 4 Gói Khăn Ướt Max Cool 80 Tờ Tặng 2 Gói Cùng Loại",99000,124000,25000,20
TIKI,thiet-bi-kts-phu-kien-so,195977274,"Bàn phím cơ gaming 5TECH Led RGB 10 chế độ nháy cực đẹp, chơi game gõ siêu đã, thiết kế nhỏ gọn dùng cho máy tính, laptop hàng chính hãng",449000,449000,0,0
TIKI,do-choi-me-be,184522257,"Đồ chơi lắp ráp, xếp hình tàu chiến Qman 1411 cho bé trai - Tàu tuần dương biển (700 mảnh ghép)",359000,459000,100000,22
TIKI,thiet-bi-kts-phu-kien-so,158848954,"Chuột không dây Wireless Bluetooth sạc pin SIDOTECH PM1 không cần thay pin, sạc 1 lần dùng 30 ngày thiết kế công thái học không mỏi tay, silent chống ồn ban đêm tương thích Laptop Macbook Máy tính bảng PC- Hàng Chính Hãng",182000,182000,0,0
TIKI,do-choi-me-be,144278087,"Lều Xông Hơi Tự Bung 3 Lớp Và Nồi Xông Hơi Cao Cấp Dùng Tại Nhà Spa",698000,698000,0,0
TIKI,do-choi-me-be,146366199,"MÁY ĐA NĂNG ĐIỆN TỬ (ALL-IN-ONE) FATZBABY - MULTIMAX 2 - FB9013SLTHẾ HỆ MỚI",1099000,1099000,0,0
TIKI,thiet-bi-kts-phu-kien-so,73261935,"Giá Đỡ Để Bàn Điện Thoại Di Động, Máy Tính Bảng, Ipad Mini. Chất Liệu Hợp Kim Nhôm Cao Cấp. Hàng Chính Hãng Tamayoko",119200,149000,29800,20
TIKI,thiet-bi-kts-phu-kien-so,183119284,"Case Silicon dành cho Airpods 1,2/ Airpods Pro/ Airpods 3 Hình Chó Cori_ Hàng Chính Hãng",85000,85000,0,0
TIKI,thiet-bi-kts-phu-kien-so,96595575,"Cáp USB nối dài 1.5M 3M 5M CHỐNG NHIỄU",12000,12000,0,0
TIKI,thiet-bi-kts-phu-kien-so,22633043,"Dây 2 Đầu HDMi 5M UNITEK - Cáp HDMI 5M UNITEK Full HD 4K - Hàng Nhập Khẩu",155000,155000,0,0
TIKI,do-choi-me-be,115694932,"Đồ chơi lắp ráp xếp hình tên lửa chiến đấu Qman 1728 - Tên lửa đánh chặn (409 mảnh ghép) dành cho bé trai trên 6 tuổi",279000,359000,80000,22
TIKI,do-choi-me-be,48477021,"Combo Bộ Bài Tarot Bói Smith Waite Tarot Cao Cấp và Túi Nhung Đựng Tarot và Khăn Trải Bàn Tarot",119000,119000,0,0
TIKI,the-thao-da-ngoai,138209947,"Giày Bóng Chuyền, Cầu Lông Nam Nữ Mira 19.1 Thương Hiệu Mira Chất Liệu Da Bóng, Đế Kep Cao Su Tự Nhiên Chống Bào Mòn",469000,469000,0,0
TIKI,the-thao-da-ngoai,193645267,"Áo bra tập Yoga Gym Hibi Sports BA509 kiểu cổ yếm có khuy cài, kèm mút ngực",199000,340000,141000,41
TIKI,the-thao-da-ngoai,111350129," Cơ bida líp Lửa Đỏ ngọn sơn Đen DD6",1300000,1300000,0,0
TIKI,the-thao-da-ngoai,128256904,"Tạ Tay Nữ 1 >> 6KG Bọc Cao Su Trơn Lõi Gang Cao Cấp",69000,69000,0,0
TIKI,o-to-xe-may-xe-dap,9883125,"Túi yên xe đạp Lezyne Energy Caddy",450000,450000,0,0
TIKI,the-thao-da-ngoai,68122347,"Banh Bóng Đá Đúc Loại 1 - SỐ 5 - Tặng Bơm, kim bơm và túi lưới",239000,425000,186000,44
TIKI,o-to-xe-may-xe-dap,7398805,"Camera Lùi Cho Xe Hơi 8 Led",139000,139000,0,0
TIKI,o-to-xe-may-xe-dap,171470448,"Nhớt Xe Máy Fuchs Silkolene Pro 4 10W30 Nhập Anh Chính Hãng Có Chiết Lẻ",270000,270000,0,0
TIKI,o-to-xe-may-xe-dap,131337458,"Găng tay phượt Sports cao cấp, găng đi xe máy có gù bảo vệ",45000,45000,0,0
TIKI,the-thao-da-ngoai,191219591,"Băng đeo trán chắn mồ hôi Cleacco BORO SPORT",20000,69000,49000,71
TIKI,o-to-xe-may-xe-dap,72575483,"[Mẫu Mới] Nhớt cao cấp cho xe tay ga đời mới Motul Scooter Power LE 5W40 800ml tặng nhớt hộp số Motul Gear 80W90 120ml",209000,209000,0,0
TIKI,the-thao-da-ngoai,161459742,"Bộ 2 tạ tay nhựa bát giác 2kg REEFIT (2 tạ 2kg, tổng 4kg)",28000,28000,0,0
TIKI,o-to-xe-may-xe-dap,41379540,"Cảm Biến Áp Suất Lốp Ô Tô steelmate  E3 Van Trong - Van Ngoài",1085000,1085000,0,0
TIKI,o-to-xe-may-xe-dap,49451282,"Máy lọc không khí ô tô Airshot Road | Sản phẩm chính hãng Hàn Quốc | Sử dụng công nghệ đèn LED UV khử trùng mạnh mẽ",1700000,1700000,0,0
TIKI,o-to-xe-may-xe-dap,42504433,"Dầu hộp số tự động Trợ lực tay lái Kixx ATF DX VI 1L",145000,145000,0,0
TIKI,o-to-xe-may-xe-dap,72957962,"Thùng đựng đồ đa năng cốp sau ô tô bọc da cao cấp , có nắp gấp, gọn gàng , ngăn nắp chứa được nhiều đồ size lớn nhất 70x32x30",491000,529000,38000,7
TIKI,o-to-xe-may-xe-dap,155288114,"Nhớt Xe Máy Motul GP Power 10W40 API SL JASO MA2 Chai 800ml Chính Hãng ",115000,115000,0,0
TIKI,bach-hoa-online,31975427,"Nước dừa Dứa Vico Fresh hộp 1L",40000,40000,0,0
TIKI,the-thao-da-ngoai,176252287,"Giày Thể Thao Nam Biti's Hunter X Cut-Out DSMH08900DEN",855000,1069000,214000,20
TIKI,bach-hoa-online,94700752,"Đặc Sản Phú Quốc - Nước Mắm Phú Quốc Khải Hoàn 43 Độ Đạm Chai Nhựa 1L - Ocop 5 Sao",206000,206000,0,0
TIKI,o-to-xe-may-xe-dap,173463497,"Móc treo xe đạp lên tường MTR02, giá treo xe đạp 2 móc đỏ siêu chắc chắn  (kèm ốc vít) Mai Lee ",119000,159000,40000,25
TIKI,the-thao-da-ngoai,248818632,"100% Creatine 5000 Vitaxtrong (300g - 60 Lần Dùng) Hỗ Trợ Tăng Sức Mạnh Vượt Ngưỡng Trong Tập Luyện",330000,330000,0,0
TIKI,bach-hoa-online,72301784,"Bột gạo lứt - mè đen - hạt sen 500g - ( MS)",95000,120000,25000,21
TIKI,o-to-xe-may-xe-dap,65465000,"DUNG DỊCH PHỤC HỒI LỐP XE ĐEN BÓNG [Bình xịt 511ml]",119000,129000,10000,8
TIKI,o-to-xe-may-xe-dap,47353118,"Đèn Led Gắn Van Xe Đạp,Xe Máy,Ô Tô Kiểu 5 BÓNG LED",39900,39900,0,0
TIKI,bach-hoa-online,140165911,"Xẻng xúc cát cho mèo - cán hình mèo (Giao màu ngẫu nhiên)",7888,7888,0,0
TIKI,bach-hoa-online,189183882,"Bột Ngọt VEDAN 1kg",55000,58000,3000,5
TIKI,bach-hoa-online,3243007,"Thùng 30 Mì Chay Lẩu Thái VIFON (65g / Gói)",117000,117000,0,0
TIKI,o-to-xe-may-xe-dap,11238036,"Bộ đèn pin gắn xe đạp và đèn chiếu hậu 5 LED WJ-101",34176,34176,0,0
TIKI,the-thao-da-ngoai,147995504,"[Còn hàng] Máy chạy bộ đa năng tại nhà Toshiko MC33 PRO, chức năng nâng dốc tự động theo nhu cầu, kèm theo đai massage và thanh gập bụng, đồng hồ hiển thị thông số nhịp tim, calo tiêu thụ",9490000,14500000,5010000,35
TIKI,bach-hoa-online,70528681,"Yến sào win'sNest tổ yến 25% chưng sẵn nguyên chất ít đường (4 lọ*70ml/ Hộp) thích hợp cho mọi đối tượng và trẻ từ 3 tuổi trở lên",279000,279000,0,0
TIKI,o-to-xe-may-xe-dap,50693882,"Combo Mũ Bảo Hiểm 3/4 Đầu Napoli SH1 Kèm Kính UV400 - Nón Bảo Hiểm Phượt Napoli Mẫu Mới 2020",399000,399000,0,0
TIKI,o-to-xe-may-xe-dap,12207786,"Mũ bảo hiểm 3/4 Asia M115 kính gương",296000,296000,0,0
TIKI,the-thao-da-ngoai,46476816,"Xe đạp tập thể dục trong nhà BG 8701 màu Xám (hàng nhập khẩu)",1699000,2959000,1260000,43
TIKI,o-to-xe-may-xe-dap,57060019,"Cuộn Nẹp Cacbon Chống Xước Bậc Cửa Xe Cho Xe Ô Tô, Xe Hơi",30000,30000,0,0
TIKI,the-thao-da-ngoai,145597163,"bộ cần câu 2m7 + máy 7000  cần 2 khúc đặc cần tải 10kg siêu khoẻ y hình giá rẻ",229994,229994,0,0
TIKI,o-to-xe-may-xe-dap,56270270,"Miếng Dán Chống Trượt Điện Thoại Trên Ô Tô, Xe Hơi ",12900,12900,0,0
TIKI,the-thao-da-ngoai,12286660,"Giày thể thao nam chạy bộ Goinglink Dream-1 Running GL1810",417000,459000,42000,9
TIKI,o-to-xe-may-xe-dap,150929607,"Xe đạp Thống Nhất mini New 26-Hàng chính hãng",2348000,2348000,0,0
TIKI,bach-hoa-online,74790102,"Dầu Cooking Nakydaco 5L",230000,230000,0,0
TIKI,o-to-xe-may-xe-dap,118102135,"Bộ chắn bùn xe đạp thể thao trước và sau CBXT01",68000,68000,0,0
TIKI,o-to-xe-may-xe-dap,178058023,"Bơm xe đạp bơm xe máy XT02 - ống bơm đa năng gia dụng dài đến 58cm áp suất 150PSI - Hỗ trợ van Mỹ và van Pháp",118000,118000,0,0
TIKI,o-to-xe-may-xe-dap,191930932,"Bóng đèn pha xe môtô Philips 200 M5 11163 UEM X1",220000,220000,0,0
TIKI,o-to-xe-may-xe-dap,119719099,"Ắc quy GS khô GTZ6V PCX Vision Lead125, Sh Việt Airblade 125 Winner Grande STD acquy shvn vn Air Blade ab 125 MF 5A 5ah",380000,380000,0,0
TIKI,the-thao-da-ngoai,154941225,"Phao Câu Cá Phao Câu Đài Nano Phao Câu Đơn AK Siêu Đẹp Sang Trọng PC11",21000,21000,0,0
TIKI,the-thao-da-ngoai,33465886,"Găng Tay Tập GYM 4 Ngón Nửa Bàn Aolikes (1 Đôi) - L",125000,125000,0,0
TIKI,the-thao-da-ngoai,48688857,"Bộ dụng cụ 5 món tập cơ tay, bụng, hít đất, con lăn - Tập thể dục thể thao toàn diện tại nhà",299000,299000,0,0
TIKI,bach-hoa-online,50411237,"Trà Xanh Thượng Hạng Tân Cương Thái Nguyên Khánh Nga 100g",47000,47000,0,0
TIKI,o-to-xe-may-xe-dap,172948758,"BAO DA MÓC CHÌA KHÓA",107018,107018,0,0
TIKI,bach-hoa-online,104192734,"KHÔ GÀ LÁ CHANH TÂN LỘC PHÁT - BỊCH 40G",6000,20000,14000,70
TIKI,bach-hoa-online,193717283,"Bột Cacao Sữa Dừa Heyday - Gói Tiện Lợi 20g - Bột cacao sữa dừa tự nhiên, thuần chay - Heyday Cacao",10000,10000,0,0
TIKI,the-thao-da-ngoai,193334497,"Giày Bóng Đá Nam Biti's Hunter Football DSMH09600DOO (Đỏ)",537000,716000,179000,25
TIKI,bach-hoa-online,67207109,"Thức Ăn Hạt Catsrang Cho Mèo Mọi Lứa Tuổi - 2Kg",243000,243000,0,0
TIKI,o-to-xe-may-xe-dap,35507865,"Bơm lốp ô tô, xe hơi điện tử thông minh AIKESI, cài đặt số cân & tự ngắt",304995,304995,0,0
TIKI,o-to-xe-may-xe-dap,31897046,"KEM XÓA XƯỚC CHO BỀ MẶT SƠN, NHỰA, KÍNH AUTOSOL SCRATCH REMOVER #1300 75ML",179000,179000,0,0
TIKI,bach-hoa-online,188551103,"Gạo Đặc Sản ST25 Trạng Nguyên – Dẻo nhiều, dai cơm, thơm dứa - Chuẩn HACCP, VietGAP",63000,79000,16000,20
TIKI,the-thao-da-ngoai,11487869,"Găng tay tập gym có quấn cổ tay",65000,65000,0,0
TIKI,bach-hoa-online,145093462,"Cà Phê Trắng Truyền Thống 3 Trong 1 Aik Cheong Malaysia - White Coffee (15 Gói x 40g)",120000,145000,25000,17
TIKI,bach-hoa-online,83781963,"Combo 2 Hộp Bánh Dinh Dưỡng AFC Lúa Mì 2x172g",61000,71000,10000,14
TIKI,o-to-xe-may-xe-dap,38151399,"KHÓA DÂY XE ĐẠP MASTERLOCK 8126EURD",140000,150000,10000,7
TIKI,the-thao-da-ngoai,149590264,"Hộp 4 lưỡi câu cá, lưỡi lăng xê (lancer) xanh chất lượng đủ kích thước LC-3",27600,27600,0,0
TIKI,the-thao-da-ngoai,95200430,"Kìm bóp tập cơ tay, kìm bóp tay GoodFit tùy chỉnh 5-60kg tập gym, tập lực tại nhà GF01E",71000,71000,0,0
TIKI,the-thao-da-ngoai,6425767,"Giày đá banh Prowin S50",169500,169500,0,0
TIKI,the-thao-da-ngoai,196978763,"Giày Đi Bộ Nữ Biti's Hunter Jogging DSWH10100DEN (Đen)",574000,638000,64000,10
TIKI,the-thao-da-ngoai,21025732,"Găng Tay Boxing Người Lớn miDoctor – Găng Tay Đấm Bốc Người Lớn Chính Hãng",163000,163000,0,0
TIKI,o-to-xe-may-xe-dap,1176187,"Vệ Sinh Thắng Đĩa, Máy, Sên Không Phốt Liqui Moly 3318 (500ml)",109250,115000,5750,5
TIKI,the-thao-da-ngoai,105625622,"Nutrex Vitadapt, Vitamin Tổng Hợp Thể Thao, Khoáng Chất Phức Hợp, Sâm Ấn Độ (KSM-66 Ashwagandha), Chiết Xuất Cây Ngũ Vị Tử & Cây Rễ Vàng, 90 Viên",579000,579000,0,0
TIKI,bach-hoa-online,154698881,"Hà thủ ô sấy khô L'angfarm, 450g, bịch",181000,181000,0,0
TIKI,o-to-xe-may-xe-dap,192890966,"CỤM GIÁ ĐỂ HÀNG JUPITER FINN",199000,199000,0,0
TIKI,the-thao-da-ngoai,74595241,"Giày patin dành cho bé (3 màu)",299000,299000,0,0
TIKI,the-thao-da-ngoai,116628441,"Gạch Tập Yoga In Hoa Mandala -YOGA QG, Chất Liệu EVA Cao Cấp, Giúp Bạn Tập Yoga Tại Nhà Và Phòng Tập",54000,68000,14000,21
TIKI,o-to-xe-may-xe-dap,892513,"Chai Xịt Bảo Dưỡng Lốp Xe Ô Tô 3M 39042 LT 3M Tire Dressing (400ml)",182000,182000,0,0
TIKI,o-to-xe-may-xe-dap,5034929,"Đèn LED Gắn Trần Nội Thất Xe Ô Tô (2 Cái)",72000,72000,0,0
TIKI,o-to-xe-may-xe-dap,196028399,"Bình phun tạo bọt tuyết rửa xe ô tô , xe máy cầm tay 2000ML tiện dụng",159000,159000,0,0
TIKI,o-to-xe-may-xe-dap,56021137,"Bộ 5 Tấm Chắn Nắng Cách Nhiệt Cho Ô Tô Đế Hút Chân Không ",79000,79000,0,0
TIKI,bach-hoa-online,58407832,"Cà phê Sáng tạo 1 (340gr)",69000,74043,5043,7
TIKI,bach-hoa-online,73859726,"BÁNH PHỒNG TÔM CÀ MAU TETE 500GRAM",59000,59000,0,0
TIKI,bach-hoa-online,140465999,"Thức ăn cho mèo trưởng thành Me-O Cat Food Hộp 1kg",74444,74444,0,0
TIKI,bach-hoa-online,110818552,"Nhà vệ sinh siêu to có cửa cho mèo - tặng kèm xẻng",293000,293000,0,0
TIKI,the-thao-da-ngoai,159496935,"Phao bơi trẻ em Zoggs - 301211 (3-6 tuổi)",195000,255000,60000,24
TIKI,the-thao-da-ngoai,36385928,"Quần Thể Thao Nữ Tập Gym Yoga Lưng Cao Cao Cấp Amalife",102000,199000,97000,49
TIKI,the-thao-da-ngoai,110253024,"Bộ quần áo bóng đá câu lạc bộ Chelsea - Áo bóng đá CLB ngoại hạng Anh - Bộ đồ bóng đá đẹp",95000,150000,55000,37
TIKI,bach-hoa-online,6677811,"Gạo lứt đen hữu cơ cao cấp/ECOBA Huyền Mễ 1kg - Thơm ngon dẻo ngọt - Thanh lọc cơ thể",109000,115000,6000,5
TIKI,o-to-xe-may-xe-dap,58705244,"Bạt trùm xe máy, áo trùm xe vải dù cao cấp 220cm x 115cm che vừa vặn tất cả các loại xe máy - giao màu ngẫu nhiên",99000,99000,0,0
TIKI,bach-hoa-online,75833417,"Túi đựng chó mèo họa tiết ngẫu nhiên",145000,182000,37000,20
TIKI,the-thao-da-ngoai,1416813,"Giày Thượng Đình KK14-1 White",105000,105000,0,0
TIKI,bach-hoa-online,137754572,"CÁT VỆ SINH HỮU CƠ CHO MÈO VÓN CỤC KHỬ MÙI VÀ VI TRÙNG CAT’S BEST ORIGINAL",159000,200000,41000,21
TIKI,bach-hoa-online,5183193,"Nước tương ăn dặm giảm muối Nhật Bản 150ml ChiBi (Yamagen) cho bé từ 9 tháng tuổi",99000,99000,0,0
TIKI,bach-hoa-online,50740437,"Nước mắm Tỏi ớt Thanh Hà 500ml",66100,66100,0,0
TIKI,o-to-xe-may-xe-dap,53247443,"Máy bơm lốp ô tô, xe hơi tự ngắt Michelin 4398ML (12266) động cơ mạnh mẽ 180W cho áp suất tối đa 150PSI, tốc độ bơm nhanh 35l/phút",1025000,1025000,0,0
TIKI,bach-hoa-online,483310,"Dầu Hạt Cải Simply (1L / Chai)",62900,77188,14288,19
TIKI,bach-hoa-online,10371298,"Sữa bột Wincofood Bonecare Calcimax+ 850g dành cho người từ 18 tuổi trở lên bổ sung canxi - Collagen và đường Isomalt phòng ngừa loãng xương, giúp chống lão hóa đẹp da và ngừa tiểu đường.",213950,389000,175050,45
TIKI,o-to-xe-may-xe-dap,96989743,"Ô che nắng, chắn tia UV kính lái ô tô đa năng - Chất liệu: (vải dù) keo bạc titan - Kích thước: 80x145cm",73000,73000,0,0
TIKI,the-thao-da-ngoai,148749357,"Quần ngắn thể thao nam New Balance Impact Run 5 Inch - AMS01241 (form châu Á)",597000,995000,398000,40
TIKI,the-thao-da-ngoai,141607124,"Ô Dù câu cá 2 tầng cao cấp - Ô",187100,187100,0,0
TIKI,bach-hoa-online,58393302,"Trung Nguyên Legend Cappuccino Mocha Hộp 12 sticks x 18gr",64000,71562,7562,11
TIKI,o-to-xe-may-xe-dap,73795218,"Tay Càng Chống Mỏi, Tay Nghỉ Gắn Ghi Đông Xe Đạp Thể Thao Đua Hợp Kim Nhôm Trọng Lượng Nhẹ (Dài 34cm) Mai Lee",225000,269000,44000,16
TIKI,bach-hoa-online,112585188,"Combo Whiskas mèo con 80g mix 2 vị (cá ngừ + cá thu) - 12 túi",150000,150000,0,0
TIKI,the-thao-da-ngoai,193334808,"Giày Bóng Đá Nam Biti's Hunter Football DSMH09600XDG (Xanh Dương)",537000,716000,179000,25
TIKI,bach-hoa-online,56834655,"1kg Bột Baking Soda Đa Công Dụng Arm & Hammer TETE",49000,49000,0,0
TIKI,bach-hoa-online,128254153,"Cát Vệ Sinh Cho Mèo Jolly Cat 5L Nhiều Mùi Hương",75000,75000,0,0
TIKI,o-to-xe-may-xe-dap,29322703,"Gel Silicone Làm Sạch Bụi Bẩn Ô Tô Bàn Phím Máy Tính",5900,5900,0,0
TIKI,the-thao-da-ngoai,178937375,"Cơ bida líp Trung cấp Đỏ Trắng mũi tên A1",1300000,1300000,0,0
TIKI,bach-hoa-online,72040743,"3 Hộp Bột Cần Tây Mật Ong Motree Mẫu Mới Giúp Giảm Cân, Hết Mụn, Sáng Da, Đẹp Dáng, Đào Thải Mỡ Thừa, Thanh Lọc Cơ Thể Tặng Kèm 01 Túi Muối NGâm Chân GIúp Ngủ Ngon Và 01Bình Thủy Tinh Cao Cấp",299000,299000,0,0
TIKI,bach-hoa-online,90059778,"Combo Detox thải độc - Bột rau củ hữu cơ sấy lạnh Dalahouse - Hộp 21 gói 7 loại rau củ, mỗi gói 3gr [Mẫu mới] - Hỗ trợ giảm cân, Thải độc, thanh lọc cơ thể",166500,166500,0,0
TIKI,bach-hoa-online,22829330,"Khô Gà Bơ Tỏi Thơm Mùi Tỏi TETE 500gram",75000,75000,0,0
TIKI,bach-hoa-online,134971271,"1kg chà bông gà loại thượng hạng cho bữa ăn ngon hiệu SK FOOD",175000,195000,20000,10
TIKI,bach-hoa-online,116741477,"Lốc 6 Hũ Mắm Kho Quẹt 120g/hũ",142200,142200,0,0
TIKI,the-thao-da-ngoai,70308674,"QUẦN THỂ THAO QUẦN DÀI NAM NỮ MẶC",74000,74000,0,0
TIKI,bach-hoa-online,187645098,"Cát Vệ Sinh Mèo Đậu Nành Cao Cấp Không Bụi Vón Nhanh - JollyCat Tofu 6L",225000,225000,0,0
TIKI,the-thao-da-ngoai,148472871,"Nón bơi unisex Speedo Bubble - 8-709290001",295000,295000,0,0
TIKI,o-to-xe-may-xe-dap,54749509,"Bọc vô lăng ô tô Tặng Bảng Số Điện Thoại - Bọc vô lăng Xe Hơi",78000,78000,0,0
TIKI,the-thao-da-ngoai,95280496,"CUỐN CỐT VỢT TENNIS VÀ CẦU LÔNG BABOLAT (giao màu ngẫu nhiên)",124000,124000,0,0
TIKI,o-to-xe-may-xe-dap,179561742,"Bọc chìa khóa Smartkey Honda mẫu mới 2 nút nhựa TPU kèm móc khóa thời trang, sang trọng",125000,125000,0,0
TIKI,the-thao-da-ngoai,141265392,"Dụng Cụ Bơm Bóng Đá, Bóng Rổ, Bóng Chuyền Bằng Tay - Có Ống Kim",38000,38000,0,0
TIKI,the-thao-da-ngoai,6537327,"Sữa Whey Protein Hammer Nutrition 24 serving - Whey Isolate duy trì và phục hồi cơ nhanh chóng",945000,1050000,105000,10
TIKI,bach-hoa-online,174502556,"[COMBO 3 HỘP] Kẹo ngậm Viacol thảo mộc Vietnat không đường giảm ho đau họng - 20 viên/ hộp",109000,109000,0,0
TIKI,bach-hoa-online,131493503,"ANF-6FREE THỨC ĂN HẠT HỮU CƠ CHO MÈO LỚN",59000,59000,0,0
TIKI,the-thao-da-ngoai,69179923,"Phao ngực vòng ôm tay cho bé tập bơi",156960,156960,0,0
TIKI,bach-hoa-online,10409776,"Cà Phê Rang Xay Truyền Thống Highlands Coffee (200g)",75000,75000,0,0
TIKI,o-to-xe-may-xe-dap,122830493,"Bộ 4 miếng cao su dán cánh cửa xe Chống va đập Logo SPORT",79000,79000,0,0
TIKI,o-to-xe-may-xe-dap,109191096,"Ốp, bọc bảo vệ chìa khóa cho xe Mercedes-Benz GLC-Class 2020-2021, E-Class 2020-2021, C-Class 2020-2021",188000,188000,0,0
TIKI,o-to-xe-may-xe-dap,151681304,"Bạt trùm che phủ xe ô tô Toyota Corolla Cross Cao Cấp 3 Lớp Chống Nắng Nóng Chống Nước Chống xước",255000,255000,0,0
TIKI,o-to-xe-may-xe-dap,51574367,"Keo vá lốp (Super Valkarn) thương hiệu Maruni - Nhật Bản (lọ 200cc)",200000,200000,0,0
TIKI,o-to-xe-may-xe-dap,10007167,"Chai dưỡng sên, xịt sên Liqui Moly 1508 250ml",212000,212000,0,0
TIKI,o-to-xe-may-xe-dap,38993920,"Thảm lót sàn ô tô T25.3 50x150 cm, Thảm Lót Cốp Ô Tô",134000,134000,0,0
TIKI,o-to-xe-may-xe-dap,32282805,"Dụng Cụ Làm Mềm Làm Mới Lưỡi Gạt Nước Xe Ô Tô Cao Cấp AZONE",30000,30000,0,0
TIKI,o-to-xe-may-xe-dap,128543422,"Giá Đỡ Bình Nước Xe Đạp Siêu Bền",19000,19000,0,0
TIKI,o-to-xe-may-xe-dap,172068762,"Thảm taplo ô tô để đồ đa năng chống trượt kiêm giá đỡ và bảng ghi số điện thoại mẫu mới loại tốt siêu đẹp",58000,58000,0,0
TIKI,o-to-xe-may-xe-dap,22536664,"Bơm hút tự động nước, rượu, xăng dầu, chất lỏng, hóa chất đủ loại - loại mini chạy pin tự động chỉ 1 nút bấm",68799,68799,0,0
TIKI,o-to-xe-may-xe-dap,124385409,"Vè Che Mưa Ô Tô SUZUKI XL7 Ertiga Chỉ Inox ",367000,367000,0,0
TIKI,o-to-xe-may-xe-dap,116057963,"Thảm Taplo Da Carbon xe Mitsu Xpander 2018 2019 2020 cao cấp",268000,268000,0,0
TIKI,o-to-xe-may-xe-dap,83366581,"pô cup DD Cao cấp dành cho xe cup DD 50 70 81 82 84 86 90",849500,849500,0,0
TIKI,o-to-xe-may-xe-dap,157146235,"Bao Da Chìa Khóa Cho Xe Ford Ecosport, Everest, Ranger, Explorer (Da Thật)",138000,138000,0,0
TIKI,o-to-xe-may-xe-dap,90574279,"Bảng Số Điện Thoại Kiêm Giá Điện Thoại Đa Năng Để Taplo Ô Tô Kim Loại Cao Cấp",65000,65000,0,0
TIKI,o-to-xe-may-xe-dap,177299335,"Ty hãm cốp thuỷ lực cho xe bán tải Ford Ranger",350000,350000,0,0
TIKI,o-to-xe-may-xe-dap,192812313,"Combo 2 Miếng Dán Chống Trượt Thảm Ô Tô Miếng Lót Chân Miếng Kẹp Thảm Sàn Phụ Kiện Miếng Dán Cố Định Nội Thất Ô Tô",35000,35000,0,0
TIKI,o-to-xe-may-xe-dap,139445907,"Sạc điện thoại xe máy kèm đồng hồ báo vôn ắc quy 2in1 mẫu mới lắp các loai xe siêu tiện loại tốt",169000,169000,0,0
TIKI,o-to-xe-may-xe-dap,27883304,"Quạt Đôi Mini 12V Xoay 360 Dành Cho Xe Ô Tô",118000,118000,0,0
TIKI,o-to-xe-may-xe-dap,23291784,"Súng bơm lốp xe ô tô dùng khí Total TAT11601",186000,186000,0,0
TIKI,o-to-xe-may-xe-dap,75709451,"Dưỡng bóng dàn áo ,kim loại MEGACOOLS SiO2 Slick WAX 250ml, dễ sử dụng, an toàn, hiệu quả cao",104000,104000,0,0
TIKI,o-to-xe-may-xe-dap,170280815,"Đèn ưu tiên 12 bóng led xanh đỏ gắn kính lái ô tô",250000,250000,0,0
TIKI,o-to-xe-may-xe-dap,21311957,"Kem xoá vết xước ô tô, xe máy F1-CC",19000,19000,0,0
TIKI,o-to-xe-may-xe-dap,19662320,"Hộp tỳ tay ô tô dành cho xe Mitsubishi Attrage và Mirage tích hợp 7 cổng USB (DUSB-ATG)",384995,384995,0,0
TIKI,o-to-xe-may-xe-dap,188927209,"Dung Dịch Chống Thấm Nước Trên Kính Senfineco 9945 Water Repellant",225000,225000,0,0
TIKI,o-to-xe-may-xe-dap,54141077,"Bộ 2 Gương Chiếu Hậu Cho Xe Đạp Thể Thao Địa Hình Xoay 360 Độ Giúp Lái Xe An Toàn",68200,68200,0,0
TIKI,o-to-xe-may-xe-dap,189941368,"Tấm che nắng kính lái ô tô 5 lớp tráng bạc phản quang chống nóng tia UV",79000,79000,0,0
TIKI,o-to-xe-may-xe-dap,72026298,"Hộp đựng khăn giấy kiêm bảng số điện thoại và đồng hồ cao cấp đặt taplo ô tô, xe hơi TB-6137",196997,196997,0,0
TIKI,o-to-xe-may-xe-dap,113352117,"Nước Hoa Ô Tô Cao Cấp Etonner E1801D 60ml thiết kế để taplo xe sang trọng, phù hợp với nhiều dòng xe.",980000,980000,0,0
TIKI,o-to-xe-may-xe-dap,130470626,"Gạt mưa Silicone xương cứng Mazda 3 -2018",231000,231000,0,0
TIKI,o-to-xe-may-xe-dap,19899873,"Bộ Rèm Chắn Nắng Nam Châm dành cho xe KIA Morning 2012-2019",259700,259700,0,0
TIKI,o-to-xe-may-xe-dap,74214137,"Gối tựa đầu ô tô và gối tựa lưng ô tô cao su non đúc nguyên khối,đàn hồi cực tốt,bọc da cao cấp-SIÊU ÊM-SIÊU BỀN-KHÔNG NỔ DA",323997,323997,0,0
TIKI,o-to-xe-may-xe-dap,36689130,"ĐÈN XI NHAN  WINNER X , BỘ ĐÈN XI NHAN TAM GIÁC CHO XE WINNER X ĐẸP QUÊN LỐI VỀ - MÀU VÀNG-XNTG",52000,52000,0,0
TIKI,o-to-xe-may-xe-dap,15832262,"Dây An Toàn Dùng Cho Ô Tô Tiện Lợi ( rộng 5 cm ) - Ghi",85000,85000,0,0
TIKI,o-to-xe-may-xe-dap,53900678,"Sạc Pin Dành Cho Xe Ô Tô & Xe Máy Điện Trẻ Em 12V Có Đèn Báo Pin",91000,91000,0,0
TIKI,o-to-xe-may-xe-dap,102511519,"Giá đỡ điện thoại hút chân không gắn kính hoặc táp lô ô tô Baseus SUYL-TK01 Tank gravity car mount holder with suction base - Hàng chính hãng",342000,360000,18000,5
TIKI,o-to-xe-may-xe-dap,177301126,"Nẹp bước chân trong TITAN ô tô Vinfast Lux A 2.0 2020-2021-2022 chống trầy bảo vệ trang trí xe",288000,288000,0,0
TIKI,o-to-xe-may-xe-dap,13306810,"Combo Đệm Tựa Lưng Massage Và Gối Tựa Đầu",268000,268000,0,0
TIKI,o-to-xe-may-xe-dap,48110441,"ghi đông cho xe 68 72 tặng bao tay xe máy",169000,169000,0,0
TIKI,o-to-xe-may-xe-dap,117927078,"BIOION AIR SANITIZER AEROSOL REFILL - Bình Xịt Khử Khuẩn, Khử Mùi (Dùng cho máy xịt tự động RX900) 250ML",125000,125000,0,0
TIKI,lam-dep-suc-khoe,171124536,"CAO SAO VÀNG (Hộp 20 g) -Dùng khi nhức đầu, sổ mũi, đau bụng, say tàu xe, côn trùng đốt - Hàng chính hãng OPC",44600,44600,0,0
TIKI,lam-dep-suc-khoe,116480061,"Viên Giấp Cá Dân Khang Giảm Táo Bón Và Trĩ Nội Trĩ Ngoại Hộp 3 vỉ x 10 viên",84500,105000,20500,20
TIKI,lam-dep-suc-khoe,68617503,"Papulex Sữa Rửa Mặt Papulex Ngăn Ngừa & Giảm Mụn Trứng Cá Moussant Soap Free Cleansing Gel 150ml",380000,380000,0,0
TIKI,lam-dep-suc-khoe,210145114,"Tinh Bột Cám Gạo Nguyên Chất UMIHOME 40G Tẩy da chết, dưỡng trắng hồng da hiệu quả",39000,85000,46000,54
TIKI,lam-dep-suc-khoe,92560200,"Xịt khử mùi dưỡng trắng hương nước hoa Refre Whitening Perfume In Love - Hương Tình Yêu 30ml",56100,62000,5900,10
TIKI,lam-dep-suc-khoe,204340766,"Combo 3 Tinh Dầu LORGANIC / Nhiều Mùi Hương / Xông Phòng Thư Giãn, Đuổi Muỗi 10m / Sả Chanh, Oải Hương Lavender, Ngọc Lan Tây, Hương Thảo, Stress Relief, Quyến Rũ Sensualy (10ml)",115000,195000,80000,41
TIKI,lam-dep-suc-khoe,159264926,"Kem mờ sẹo, liền sẹo chuyên sâu Scarz Intensive Gel 9g ( dạng gel)",150000,150000,0,0
TIKI,lam-dep-suc-khoe,190641512,"Sữa Rửa Mặt Dịu Nhẹ Cho Da Dầu CeraVe Foaming Cleanser 88ml",139000,155000,16000,10
TIKI,lam-dep-suc-khoe,195821392,"Máy massage cầm tay CameWell, máy massage toàn thân trị liệu cổ vai gáy 4 đầu 5 chế độ, pin 2600 mAh dùng liên tục 4h",1490000,1990000,500000,25
TIKI,lam-dep-suc-khoe,105629974,"Bộ 2 gel bôi trơn Durex K-Y Jelly 50g",170000,180000,10000,6
TIKI,lam-dep-suc-khoe,114276905,"Máy hút ráy tai Nhật Bản - dụng cụ lấy ráy tai an toàn.",56050,59000,2950,5
TIKI,lam-dep-suc-khoe,52779805,"Mặt Nạ Ngủ Cho Môi Laneige Lip Sleeping Mask Apple Lime EX 20g",440000,500000,60000,12
TIKI,lam-dep-suc-khoe,198769926,"[HỘP - FAMAPRO 5D DÂY VẢI] - Khẩu trang y tế kháng khuẩn 3 lớp Famapro 5D Mask dây vải (10 cái/ hộp)",10900,10900,0,0
TIKI,lam-dep-suc-khoe,271444292,"Sụn vi cá mập Úc Healthy Care Shark Cartilage 750mg tăng sức khỏe xương khớp, cơ bấp, tăng chức năng vận động - Massel Official",414000,828000,414000,50
TIKI,lam-dep-suc-khoe,48190464,"VIÊN TINH NGHỆ MẬT ONG SỮA CHÚA HONEYLAND 250G/HŨ",251000,389000,138000,35
TIKI,lam-dep-suc-khoe,101947387,"Cho máy Oral B Braun, bộ 4 Đầu Bàn Chải đánh răng điện thay thế MIHOCO EB18-P New   ,  phá tan mảng bám, cho răng trắng sáng",125000,125000,0,0
TIKI,lam-dep-suc-khoe,171153592,"Sáp Khử Mùi Old Spice Ngăn Tiết Mồ Hôi Nhiều Mùi Hương Bearglove I Wolfthorn I Timber I Fiji 73g Chuẩn Chất Đàn Ông",139000,139000,0,0
TIKI,lam-dep-suc-khoe,74547395,"Kem Chống Nắng Không Màu Kiểm Soát Dầu La Roche-Posay Anthelios XL Dry Touch Gel-Cream SPF 50+ UVB & UVA (50ml) - TẶNG MÓC KHÓA",450000,450000,0,0
TIKI,lam-dep-suc-khoe,57715384,"Nước Hoa MIni VERSACE EROS FOR MEN Phong Độ Nam Giới 5ml Ý",299000,299000,0,0
TIKI,lam-dep-suc-khoe,171574158,"Xịt chống muỗi hương cam Soffell (80ml)",36000,36000,0,0
TIKI,lam-dep-suc-khoe,41967584,"Viên uống Sắc Ngọc Khang Vi tảo lục (60 viên) giúp trẻ hóa làn da xua tan vết nám, hỗ trợ cân bằng nội tiết tố, bổ huyết, điều kinh, hỗ trợ giảm các triệu chứng tiền mãn kinh",219000,290000,71000,24
TIKI,lam-dep-suc-khoe,87446824,"Mặt Nạ Nghệ Hưng Yên Cocoon 30ml",145000,145000,0,0
TIKI,lam-dep-suc-khoe,12063335,"Xịt Khử Mùi Hàng Ngày Etiaxil Déodorant Anti-Transpirant 48h Anti-Traces Blanches & Jaunes 100ml",249000,289000,40000,14
TIKI,lam-dep-suc-khoe,153612336,"Nước hoa nữ Versace Eros Pour Femme Eau De Parfum",239000,409000,170000,42
TIKI,lam-dep-suc-khoe,203790754,"Combo 3 Tinh Dầu LORGANIC / Nhiều Mùi Hương / Xông Phòng Thư Giãn, Đuổi Muỗi 10m / Sả Chanh, Quế, Bạc Hà, Oải Hương Lavender, Tràm, Ngọc Lan Tây, Hương Thảo, Stress Relief, Sensual, Cam, Vỏ Bưởi, Bạch Đàn Chanh, Bưởi Chùm, Gỗ Thông (10ml)",99000,198000,99000,50
TIKI,lam-dep-suc-khoe,12242241," Trà ổi giảm cân Orihiro Nhật Bản (60 gói) tặng gói trà sữa hoặc cafe ngẫu nhiên",118000,146160,28160,19
TIKI,lam-dep-suc-khoe,159887702,"Collagen ngăn ngừa lão hóa,trắng da,đẹp tóc Lá House Gluta Q10 (6.5g*30gói)",2450000,2450000,0,0
TIKI,lam-dep-suc-khoe,176059943,"Bọt vệ sinh nam ALFASEPT Intimate Wash For Men ICE COOL- Dung dịch tạo bọt chai 100ml",115000,115000,0,0
TIKI,lam-dep-suc-khoe,41090601,"Lăn khử mùi nam Old Spice High Endurance Deodorant Long Lasting Stick Pure Sport 85g  - USA",165000,165000,0,0
TIKI,lam-dep-suc-khoe,7939532,"Sữa Rửa Nam Ngăn Ngừa Mụn Trắng Da Dabo Black Force (120ml)",105000,105000,0,0
TIKI,lam-dep-suc-khoe,176812033,"Kem Dưỡng Ẩm Hằng Ngày Bepanthen Sensidaily 150ML",709000,709000,0,0
TIKI,lam-dep-suc-khoe,190881603,"Khẩu trang y tế 4 lớp, lẻ 10 cái, 1 hộp 50 cái, kháng khuẩn, kháng virus Corona chuyên dụng cho bệnh viện, nhiều màu",6000,6000,0,0
TIKI,lam-dep-suc-khoe,205073657,"Gel bôi trơn hậu môn nóng ấm - Shell Supermen Warming - Chai 90ml",342000,380000,38000,10
TIKI,lam-dep-suc-khoe,32495160,"Túi Chườm Gel Nóng Lạnh Giảm Đau,Hạ Sốt R&R Rexi Care Loại Lớn (31 x 17 cm)",179000,179000,0,0
TIKI,lam-dep-suc-khoe,118896584,"Nến thơm tinh dầu cao cấp không khói an toàn Candle Cup - WHITE TEA - S - 100G (KG NẮP)",120000,120000,0,0
TIKI,lam-dep-suc-khoe,58519309,"Kem bôi da Thuần Mộc Thanh Mộc Hương mẫu mới - Tặng Kèm Cột Tóc Tai Thỏ Màu Ngẫu Nhiên",106000,106000,0,0
TIKI,lam-dep-suc-khoe,23079049,"Combo 3 Hộp Tăm Bông Diva - 200 Que/Hộp",59000,59000,0,0
TIKI,lam-dep-suc-khoe,118896560,"Nến thơm tinh dầu cao cấp không khói an toàn Candle Cup - JASMINT/HOA NHÀI - S - 100G (KG NẮP)",120000,120000,0,0
TIKI,lam-dep-suc-khoe,28117010,"Dụng cụ dũa móng tay 6 mặt",7890,7890,0,0
TIKI,lam-dep-suc-khoe,192418945,"Mặt nạ tay dưỡng da tay Mèo, làm trắng da bổ sung collagen cải thiện nếp nhăn, tẩy tế bào chết",12500,25000,12500,50
TIKI,thoi-trang-nu,112250895,"Sét Đồ Bộ Thể Thao Nam Nữ Mặc Nhà Phong Cách Ulzzang Unisex, Freesize Chất Cotton Không Phai, Đồ bộ mặc nhà dạo phố chất thun cotton I LIKE tay phối raplang trẻ trung năng động, Set đồ bộ nữ chất thun cotton co giản thoáng mát",99000,99000,0,0
TIKI,thoi-trang-nu,97586335,"Đồ Ngủ Hai Dây Lụa Satin Sexy Quyến Rũ Thương Hiệu Baw, Chất Liệu Lụa Mát Mịn Nhẹ Nhàng Cực Kỳ Lôi Cuốn NT701 (hình thật shop tự chụp)",169000,169000,0,0
TIKI,thoi-trang-nu,87582606,"Áo Lót Mút Mỏng Vừa Màu Trơn Habpy Lady By Sabina HBXLP0004",229000,383000,154000,40
TIKI,thoi-trang-nu,74360894,"Quần Lót Nữ Modal Trơn Comfort Miley Lingerie BCS-04",32000,79000,47000,59
TIKI,thoi-trang-nu,161556077,"Choàng Chống Nắng Nữ 2 Lớp Laroma| UPF50+ | Vải Thơm | Làm Mát | Thời Trang | Đa Dụng",629000,899000,270000,30
TIKI,thoi-trang-nu,59205406,"COMBO 5 ÁO LÁ NGẮN THUN LỤA MẶT TRƯỚC 2 LỚP DÀNH CHO HỌC SINH",93000,98000,5000,5
TIKI,thoi-trang-nu,84437281,"áo sweater nữ in quả địa cầu , áo hoodie nữ, áo thun tay dài form rộng ,áo sweater nam nữ đều mặc được, áo chui đầu, áo khoác nữ chống nắng chống lạnh tốt",92000,92000,0,0
TIKI,thoi-trang-nu,114317990,"Áo khoác bomber dù unisex form rộng 2 lớp 23 nam nữ",88000,88000,0,0
TIKI,thoi-trang-nu,7595959,"Áo Thun Nữ Phối Ren Thời Trang MS0084A",170000,170000,0,0
TIKI,thoi-trang-nu,150213944,"Áo bảo hộ lao động nam nữ màu than phối xanh khóa kéo SHUNI -005A vải kaki liên doanh loại dày, đồng phục kỹ sư,xây dựng",149000,149000,0,0
TIKI,thoi-trang-nu,82914112,"Bộ 5 Quần Lót Su Viền Lượn Sóng Không Viền Mẫu mới 2021 thương hiệu BAW NT10",199000,199000,0,0
TIKI,thoi-trang-nu,109137583,"ÁO HOODIE NỮ IHAN FORM RỘNG CHẤT NỈ NGOẠI DÀY DẶN THOÁNG MÁT, ÁO KHOÁC HOODIE ULZZANG PHONG CÁCH CÁ TÍNH, Aó hoodie nam , áo hoodie nữ , áo khoác áo hoodie cặp đôi nam nữ mặc",100000,100000,0,0
TIKI,thoi-trang-nu,191052909,"Chân váy nữ ngắn xếp ly lưng cao chữ a, chân váy tennis xếp li bản nhỏ màu đen trắng be vải kaki mịn mặc đi học đi chơi dạo phố vào mùa hè",149000,250000,101000,40
TIKI,thoi-trang-nu,109190787,"Đầm xòe đỏ kết hoa trắng-MS0605D",190000,190000,0,0
TIKI,thoi-trang-nu,182100187,"[MUA ÁO TẶNG QUẦN] Áo ngực có gọng mút vừa T-Shirt smothie iBasic BRAW130",279000,299000,20000,7
TIKI,thoi-trang-nu,193099535,"Áo khoác vest nữ cổ lụa ngắn tay lỡ, blazer nữ công sở form suông thiết kế trẻ trung chất tuyết mưa màu đen trắng xanh dễ phối đồ đi chơi dạo phố sự kiện tiệc cưới lễ hội",400000,400000,0,0
TIKI,thoi-trang-nu,145289760,"Chân Váy Công Sở New Design Thiết Kế Dáng Váy chữ A, Dài Qua Gối ,Phối Nút, Phom Chuẩn Tôn Dáng Sang Trọng Vải Tốt co Giãn, Màu Đen CV0066",179000,299000,120000,40
TIKI,thoi-trang-nu,132126269,"Đồ đi biển gia đình 3 4 5 người đồng phục du lịch nam nữ đủ size áo và quần nổi bật DDB08 | SG",99000,99000,0,0
TIKI,thoi-trang-nu,116206931,"Quần ống rộng nữ,quần ống suông nữ lưng cao dáng dài 1 khuy chất tuyết mưa dày dặn",85000,85000,0,0
TIKI,thoi-trang-nu,162526714,"Quần short nữ ống rộng cạp cao vắt chéo xếp ly quần đùi bigsize đến 80kg mặc ở nhà, đi chơi,dạo phố vào mùa xuân hè thu",125000,250000,125000,50
TIKI,thoi-trang-nu,124489997,"Đồ ngủ sexy nữ Đồ ngủ hai dây có mút ngực, cột nơ chất phi hai dây chất mịn quyến rũ",56000,56000,0,0
TIKI,thoi-trang-nu,67241193,"Đầm suông linen cổ V túi hộp thắt eo ArcticHunter, thời trang thương hiệu chính hãng",280000,280000,0,0
TIKI,thoi-trang-nu,254097845,"Túi Đi Chùa # Túi Đi Chùa # Nam Nữ # Bị",25000,25000,0,0
TIKI,thoi-trang-nu,116965781,"Cặp Miếng Dán Ngực Giấy Mỏng Tiện Lợi Loirechic MD08",5000,5000,0,0
TIKI,thoi-trang-nu,99219054,"Quần âu nữ công sở Hiền Trần BOUTIQUE vải trượt Thái mềm mại, co giãn, tôn dáng chuẩn VNXK",151000,350000,199000,57
TIKI,thoi-trang-nu,96994606,"Váy ngủ ren hoa xuyên thấu thoáng mát+ Quần lót sexy",69000,69000,0,0
TIKI,thoi-trang-nu,107352272,"Quần ống rộng nữ, quần ống suông đũi Gu chun lưng chất mát",69000,69000,0,0
TIKI,thoi-trang-nu,162089271,"Áo Chống Nắng Nữ 2 Lớp Laroma| UPF50+ | Vải Thơm | Làm Mát | Thời Trang | Đa Dụng",429000,569000,140000,25
TIKI,thoi-trang-nu,140213462,"Áo hai dây nữ lụa cao cấp, mát, mịn, không nhăn - AD01 - wfstudios",180000,180000,0,0
TIKI,thoi-trang-nu,44580442,"Áo len nữ thêu hình kiểu dáng Hàn Quốc",179000,179000,0,0
TIKI,thoi-trang-nu,73278835,"Combo 10 Quần Lót Nữ Modal Trơn Comfort BCS-04 - Giao màu ngẫu nhiên",419000,790000,371000,47
TIKI,thoi-trang-nu,190229023,"( Miễn phí áo liner + thanh nới ) Đai nịt bụng latex VORONIN SIÊU SIẾT EO che mỡ lưng-Sự lựa chọn để có 1 body hoàn hảo",330000,330000,0,0
TIKI,thoi-trang-nu,116117817,"Quần Lót Giấy cho các mẹ sau khi sinh, 1 gói 5 chiếc (MSP: Đáy Liền)",30000,30000,0,0
TIKI,thoi-trang-nu,179417985,"Áo trung niên nữ cổ tròn chất đũi dáng rộng, họa tiết thêu độc đáo. R4",185000,185000,0,0
TIKI,thoi-trang-nu,76563546,"Váy ngủ lụa phối ren xẻ tà cao cấp ĐỦ MÀU ĐỦ SIZE",175000,175000,0,0
TIKI,thoi-trang-nu,179412723,"Áo khoác vest blazer nữ phong cách hàn quốc 2 túi chất đũi xước cao cấp ( mã SP11)",190000,190000,0,0
TIKI,thoi-trang-nu,153409167,"Áo polo unisex tay lỡ form rộng Yinxx, áo thun có cổ nam nữ màu xanh ATP01",75050,79000,3950,5
TIKI,thoi-trang-nu,182993124,"Đồ Bơi Nữ Tay Dài Quần Dài Ôm Thân Khoe Dáng AT227 MayHomes Long Sleeves And Long Pants Women Swimwear With UPF 50 Sun Protection",343000,350000,7000,2
TIKI,thoi-trang-nu,49293177,"Áo Tắm Hai Mảnh Cá Tính AT146 MayHomes Thun Co Giãn, Không Phai Màu",243460,259000,15540,6
TIKI,thoi-trang-nu,110896759,"Quần ống rộng nữ vải đũi cạp cao 2 cúc suông dài tôn dán chun sau co dãn thoải mái Thời trang BANAMO sớ đũi 2khuy 922",89000,89000,0,0
TIKI,dien-gia-dung,179175096,"Nồi chiên không dầu 7 Lít",453761,453761,0,0
TIKI,dien-gia-dung,265546751,"Quạt Đứng, Quạt Tích Điện Mi-Lux F188 Đối Lưu Không Khí Thế Hệ Mới Pin 8000mAh Tích Điện 20- 60 Giờ Gồm 4 Cấp Độ Gió, Tích Hợp Đèn Ngủ - Hàng Chính Hãng",1599000,3189000,1590000,50
TIKI,dien-gia-dung,114535577,"Nồi Cơm Điện Tử Lòng Niêu BlueStone RCB-5949 1.5 Lít- Hàng chính hãng",2144000,2999000,855000,29
TIKI,dien-gia-dung,181358611,"Máy xay thịt đa năng LEBENLANG công suất 400W, dung tích cối xay 500ml, bảo hành điện tử 2 năm, model LBMF8906 - hàng chính hãng",1129000,1129000,0,0
TIKI,dien-gia-dung,16344906,"Quạt Sạc Tích Điện Kẹp Bàn Mini Baseus Xoay 360 Độ Công Suất Lớn - Hàng Chính Hãng",399000,399000,0,0
TIKI,dien-gia-dung,149963858,"Máy hút bụi cầm tay dùng pin 20V INGCO CVLI2001 - Không kèm pin",802792,872600,69808,8
TIKI,dien-gia-dung,121225771,"Quạt ỐP Trần Hàn Quốc Trang Trí Phòng Khách Phòng Ngủ 3 Chế Độ Màu Điều Khiển Từ Xa Hẹn Giờ Thông Minh",1350000,1350000,0,0
TIKI,dien-gia-dung,205494552,"Tủ Sấy Quần Áo 2-3 Tầng Thông Minh Sấy Khô Thế Hệ Mới Có Điều Khiển Từ Xa - Có Thể Gấp Gọn - Có Video",979000,1499000,520000,35
TIKI,dien-gia-dung,146288116,"Máy ép hoa quả Mitomo-EC55 hàng chính hãng bảo hành 3 năm",929000,1320000,391000,30
TIKI,dien-gia-dung,101454992,"Vòi cổ ngỗng máy lọc nước",95000,115000,20000,17
TIKI,dien-gia-dung,13788140,"Bơm tăng áp dùng cho máy lọc nước Ro 10L",333000,333000,0,0
TIKI,dien-gia-dung,105602628,"Quạt Điện Đứng Senko L1338 - thay mã mới L1638 Giao Màu Ngẫu Nhiên - Hàng Chính Hãng",360000,360000,0,0
TIKI,dien-gia-dung,114514791,"Quạt thông gió 220V",95000,95000,0,0
TIKI,dien-gia-dung,1953341,"Máy Sấy Tóc Sunhouse SHD2306 - Đen",203000,340000,137000,40
TIKI,dien-gia-dung,31252972,"Bếp Nướng Điện 2 Mặt Nagakawa NAG3102 (2000W) - Hàng Chính Hãng",1299000,2120000,821000,39
TIKI,dien-gia-dung,170964334,"Máy Ép Chậm OLIVO SJ200 [ HÀNG CHÍNH HÃNG] Máy Ép Trái Cây Rau Củ Quả Thương Hiệu Mỹ",3190000,3190000,0,0
TIKI,dien-gia-dung,10098952,"Combo lõi lọc nước Karofi 1, 2, 3 dành cho nước Cứng - Hàng Chính Hãng",179000,179000,0,0
TIKI,dien-gia-dung,171651777,"Quạt sưởi đứng không cánh 2 chiều cao cấp lọc không khí và diệt khuẩn có kèm Ảnh Thật",2699000,2699000,0,0
TIKI,dien-gia-dung,20856733,"Máy Xay Sinh Tố Cầm Tay Mini Đa Năng",191200,239000,47800,20
TIKI,dien-gia-dung,94582524,"Ấm đun nước siêu tốc xếp gọn đi du lịch có màn hình hiển thị - HanruiOffical",1255800,1255800,0,0
TIKI,dien-gia-dung,76102965,"Nồi Cơm Điện Cuckoo CRP-PK0600F/BKRDVN 1.08L - Hàng chính hãng",3360000,4190000,830000,20
TIKI,dien-gia-dung,54614613,"Bàn ủi hơi nước bình treo công nghiệp ES-94A Silver Star + Mặt nạ chống bóng vải - Hàng Chính Hãng",1258950,1258950,0,0
TIKI,dien-gia-dung,31522970,"Lò nướng thủy tinh 16L Khaluck.Home KL-658H - Hàng Chính Hãng",689000,689000,0,0
TIKI,dien-gia-dung,64313758,"Nồi Cơm Điện 1L Fujika FJ-NC1005 Công Suất 400W Lồng Men Chống Dính Cho 2,3 Người Ăn (Mẫu Ngẫu Nhiên)-Hàng Chính Hãng",299000,299000,0,0
TIKI,dien-gia-dung,82880367,"Robot quét nhà thông minh LIECTROUX Hàng chính hãng Robot hút bụi Đức XR500 chức năng 2 trong 1 vừa quét vừa lau Lực hút siêu khỏe CHIP xử lí thông minh Tính năng vượt vật cản",4417500,4650000,232500,5
TIKI,dien-gia-dung,111976756,"Quạt Hộp USS-H3VU-Hàng chính hãng",285000,285000,0,0
TIKI,dien-gia-dung,184496809,"Máy Hút Bụi Cầm Tay Mini 2 in 1 Bản Nâng Cấp 2021 ️ Lực Hút 9000PA,120W,Đầu Sạc USB Tiện Lợi, Hút bụi không dây",112000,112000,0,0
TIKI,dien-gia-dung,38628206,"Bếp Ga Đơn Rinnai RV-150 (G) + Tặng kèm 1 bộ dây và van gas- Hãng chính hãng",498551,498551,0,0
TIKI,dien-gia-dung,21060537,"Quạt điều hòa - Quạt hơi nước mini 2231",199000,199000,0,0
TIKI,dien-gia-dung,136981294,"Máy hút bụi không dây cầm tay LT-106EG - Máy hút bụi đa năng - Lực hút 12000Pa - Sạc USB - Công suất120W (CT1738)",509000,509000,0,0
TIKI,dien-gia-dung,147356517,"Máy Xay Sinh Tố PHILIPS HR2041/10 450W - Hàng Chính Hãng",745000,858000,113000,13
TIKI,dien-gia-dung,70527519,"Quạt Sàn Công Nghiệp Chân Quỳ 18'' Hatari IT18M2 - Hàng Chính Hãng - Màu Ngẫu Nhiên",1449000,1449000,0,0
TIKI,dien-gia-dung,26669664,"Máy xay cà phê cầm tay - Coffee Grinder - nhanh chóng, tiện lợi, sang trọng - Coffee New",228000,270000,42000,16
TIKI,dien-gia-dung,134333384,"Máy đánh trứng Lock&Lock Hand Mixer EJM501DGRY 250-300W - Hàng chính hãng",536000,973000,437000,45
TIKI,dien-gia-dung,131498522,"Quạt Solar sử dụng năng lượng mặt trời",698000,698000,0,0
TIKI,dien-gia-dung,165343269,"ĐẦU QUẠT TREO TƯỜNG 3HT - HÀNG CHÍNH HÃNG",160000,160000,0,0
TIKI,dien-gia-dung,31251787,"Máy hút mùi âm tủ Hafele HH-TI90D 539.81.085 - Hàng Chính Hãng",6468000,7840000,1372000,18
TIKI,dien-gia-dung,37495656,"Ấm Đun Nước Siêu Tốc CAO CẤP",250000,250000,0,0
TIKI,dien-gia-dung,163552503,"Máy Hàn Miệng Túi FS-200 – Giúp Bảo Quản Thực Vật Tươi Lâu Hơn, Áp Dụng Phổ Biến Trong Đời Sống – Hàng Chính Hãng MINIIN",255000,285000,30000,11
TIKI,dien-gia-dung,205915127,"Quạt Đứng KDK M40K - Xám - Hàng chính hãng",3279000,3279000,0,0
TIKI,thoi-trang-nam,58587472,"quần âu nam công sở dạo phố cao cấp co giãn nhẹ, quần tây nam dáng ôm",119000,119000,0,0
TIKI,thoi-trang-nam,196313090,"Áo khoác dù chống nắng nam, có 3 ngăn túi khóa kéo nón có thể tách rời tiện lợi - FORMENSHOP - FMTHT050",159000,300000,141000,47
TIKI,thoi-trang-nam,196389374,"Combo 2 Quần lót nam boxer CITYMEN lưng Sọc vải thun lạnh 4 chiều - Giao màu ngẫu nhiên",80000,80000,0,0
TIKI,thoi-trang-nam,138750990,"Áo Phông Nam cổ tim Chất cotton mềm Mịn Dáng Ôm Nhẹ Thời Trang",74260,79000,4740,6
TIKI,thoi-trang-nam,55163582,"Quần Bơi Nam Họa Tiết Cá Tính AT171 MayHomes Thun Lạnh Co Giãn Tốt, Mạnh Mẽ Cá Tính",114810,129000,14190,11
TIKI,thoi-trang-nam,164011222,"Áo Sơ Mi Nam Công Sở Trung Niên Dài Tay Thương Hiệu Anton màu Nâu Đậm Vải Cotton - YAC128",215000,215000,0,0
TIKI,thoi-trang-nam,115955390,"Áo thun dài tay cổ tim nam",78000,78000,0,0
TIKI,thoi-trang-nam,169569534,"Áo bơi tay dài nam hàng cao cấp thun xịn đường kim mũi chỉ chắc chắn",230500,230500,0,0
TIKI,thoi-trang-nam,113166943,"Áo sơ mi nam cổ tàu dài tay màu đen",142800,142800,0,0
TIKI,thoi-trang-nam,178785868,"Áo phông nam phong cách Hàn Quốc mã TX20",229500,459000,229500,50
TIKI,thoi-trang-nam,179163530,"(big size<130kg) Áo sơ mi nam tay dài big size màu đen",185000,185000,0,0
TIKI,thoi-trang-nam,73365866,"Bộ 10 Quần Lót Nam vải cotton 2 chiều co giãn nhiều lưng hiệu CITYMEN, màu ngẫu nhiên, đồ lót - LMTK-MULTI2C",180000,180000,0,0
TIKI,thoi-trang-nam,109956995,"QUẦN KAKI NAM MÀU ĐEN TÚI MỸ VIỀN",150000,150000,0,0
TIKI,thoi-trang-nam,77745744,"Quần Lót Nam nhiều lưng co giãn 2 chiều vải cotton hiệu CITYMEN, màu ngẫu nhiên, đồ lót - LMTK-MULTI2C",15000,15000,0,0
TIKI,thoi-trang-nam,125996824,"Quần Ống Rộng Quần Jeans Baggy Quần Jean Nam Quần Bò Ống Đứng Style 2021",59000,59000,0,0
TIKI,thoi-trang-nam,171451574,"Quần Sọt Nam, Quần Short Tây Âu Nam Co Giãn Nhẹ Dáng Ôm, Quần Ngố Nam Lịch Sự Phù Hợp Dạo Phố Du Lịch Thương Hiệu Chandi Mã TA19",132050,139000,6950,5
TIKI,thoi-trang-nam,188916571,"Tất nam cổ trung Fasvin mềm mịn co giãn tốt TN21902.HN",19000,36000,17000,47
TIKI,thoi-trang-nam,139002166,"Quần jean Baggy ống suông, rộng nam, nữ TR01 hottrend hàn quốc 2021",115000,115000,0,0
TIKI,thoi-trang-nam,159382275,"Áo polo nam trơn cổ bẻ - Áo thun nam vải cá xấu cotton tay ngắn thoáng mát<Hàng Cao Cấp",79000,79000,0,0
TIKI,thoi-trang-nam,24864749,"Quần Tây Âu Màu Trơn Cho Nam",89000,89000,0,0
TIKI,thoi-trang-nam,7189521,"Bộ 2 Quần Boxer Đúc Nam Nhật Bản - 5Star",85000,85000,0,0
TIKI,thoi-trang-nam,174301048,"Quần Kaki Nam Ống Suông Cao Cấp Chất Liệu Co Dãn Dáng Âu Phong Cách Công Sở Thương Hiệu CHANDI JK1",194000,229000,35000,15
TIKI,thoi-trang-nam,89631305,"ÁO SƠ MI CARO ĐỦ MÀU NAM NỮ",92000,92000,0,0
TIKI,thoi-trang-nam,190355591,"Combo 3 quần lót boxer nam CITYMEN lưng Hàn Quốc cao cấp vải lạnh co dãn 4 chiều mềm mại thoáng khí thấm hút tốt, quần xịp sịp đùi nam - Giao màu ngẫu nhiên",140000,140000,0,0
TIKI,thoi-trang-nam,41654783,"Áo Len Cổ Lọ Nam Phong Cách Hàn Quốc Siêu Ấm SAL222",118000,118000,0,0
TIKI,thoi-trang-nam,178577763,"Áo khoác bóng chày form rộng vải dù cao cấp ️Áo Khoác Dù 2 Lớp PENTA.Q Ulzzang Nam Nữ Unisex Form Rộng Bomber Jacket",100000,100000,0,0
TIKI,thoi-trang-nam,179161990,"(big size < 130kg) sơ mi nam tay dài màu xanh đen big size",185000,185000,0,0
TIKI,thoi-trang-nam,68630251,"Quần bơi nam Lan Hạnh 50123-DE0103",238000,238000,0,0
TIKI,thoi-trang-nam,197629108,"COUPLE TX - Áo Khoác Nam Dù Trượt Nước Ombre Loang Màu MOP 1023",799000,799000,0,0
TIKI,thoi-trang-nam,110948866,"Quần đùi nam chất kate cotton thương hiệu Fezzio chính hãng",64500,129000,64500,50
TIKI,thoi-trang-nam,196184514,"Áo Blue, Blouse trắng Dáng Ngắn Ngang Đùi Nam Nữ Dài Tay, Cộc Tay Hàng Đẹp Loại 1 Dành Cho Y Tá, Dược Sĩ, Điều Dưỡng",138000,138000,0,0
TIKI,thoi-trang-nam,15992824,"Áo Khoác Nam Áo Khoác Dù Nam Cao Cấp-AD27",159000,270000,111000,41
TIKI,thoi-trang-nam,125784347,"Quần bơi lững nam 881(30-100kg)",60000,60000,0,0
TIKI,thoi-trang-nam,163552063,"Áo Thun Nam PoLo Ngắn Tay Có Cổ Kiểu Dáng Thời Trang Cao Cấp AVIANO",129000,258000,129000,50
TIKI,thoi-trang-nam,183682463,"ÁO LÓT NGẮN TAY CATRIO là áo phông trắng, áo thun ngắn tay cho bố, ông, người trung tuổi, vải 100̀% cotton mặc lót bên trong áo sơ mi, mặc ở nhà, đi ngủ",65000,65000,0,0
TIKI,thoi-trang-nam,146289287,"Áo thun nam có cổ ngắn tay phối tay hoạ tiết sang trọng, phù hợp với mọi lứa tuổi - FORMEN SHOP - FMPS160",159000,250000,91000,36
TIKI,thoi-trang-nam,188382233,"Áo Gile nam, Áo Gile T&T phối sơ mi độc đáo, đứng dang, không phai màu, không nhăn mã N43",260000,260000,0,0
TIKI,thoi-trang-nam,57758774,"Quần short nam có Big Size 115kg lưng thun co giãn 4 chiều ,quần đùi nam thể thao cao cấp ShopN6 - QSB1 (sọc ngẫu nhiên)",59000,105000,46000,44
TIKI,thoi-trang-nam,106714415,"Combo 3 quần đùi nam May 10 loại có túi 2 bên",195000,195000,0,0
TIKI,thoi-trang-nam,3714997,"Combo 5 Quần Lót Boxer Nam Freeman 6516-CB5-L (Size",340000,425000,85000,20
TIKI,cross-border-hang-quoc-te,54762609,"Quần kaki nam 1 ply Khatoco Q2M528R1-INMA003-2106-1",422400,528000,105600,20
TIKI,dien-gia-dung,2166847,"Bộ Túi Lọc Bụi Karcher VC 2 (5 Cái) - Hàng chính hãng",190000,190000,0,0
TIKI,cross-border-hang-quoc-te,189467654,"Quần Jeans nam dáng regular fit 6Q7092 - thương hiệu Viettien",645000,645000,0,0
TIKI,o-to-xe-may-xe-dap,137555914,"Sạc bình acquy 12V tự động ngắt khi đầy-đen",60800,64000,3200,5
TIKI,dien-gia-dung,13239533,"Bộ kiềng bếp gas 5 chân, sử dụng thay thế cho các dòng bếp kính phổ thông - Hàng chính hãng",69000,69000,0,0
TIKI,o-to-xe-may-xe-dap,48303234,"Mũ Bảo Hiểm 3/4 Napoli SH1 Free Size 5-58 cm - Nâu Lót Nâu - Bảo hành 12 tháng",359000,359000,0,0
TIKI,o-to-xe-may-xe-dap,111589429,"Nón bảo hiểm trẻ em 1/2 đầu Protec Kitty, họa tiết siêu anh hùng Captain American",305000,358000,53000,15
TIKI,o-to-xe-may-xe-dap,68877509,"Dụng Cụ Kìm (Kềm) Cắt Mở Đóng Dây Sên Xích Xe Đạp Thể Thao Mini Tiện Lợi Nhanh Chóng Mai Lee",46550,49000,2450,5
TIKI,cross-border-hang-quoc-te,37650433,"ÁO KHOÁC KAKI NAM UNISEX -LLQAK01",120000,120000,0,0
TIKI,bach-hoa-online,50380227,"Cát vệ sinh đậu phụ cho mèo PURA",82500,146000,63500,43
TIKI,o-to-xe-may-xe-dap,68442580,"Nệm hơi xe ô tô Nhà của Mẹ cao cấp chất liệu vải nhung kích thước 140 x 90 x 50 cm tặng kèm bơm điện - Màu sắc giao ngẫu nhiên",395000,420000,25000,6
TIKI,dien-gia-dung,2745859,"Bếp Từ Đôi Hồng Ngoại Cảm Ứng KAFF KF-073IC - Hàng Chính Hãng",5450000,5450000,0,0
TIKI,o-to-xe-may-xe-dap,85117078,"Nón Bảo Hiểm Xe Đạp Cao Cấp Protec Win 066, Siêu Phẩm Phượng Hoàng Lửa, Mạnh Mẽ, Cá Tính - Hàng Chính Hãng",469000,569000,100000,18
TIKI,bach-hoa-online,89762344,"Sữa non Anpha Lipid USA 900g Halanmilk - Giúp tăng sức đề kháng, phục hồi nhanh sức khỏe",485000,485000,0,0
TIKI,dien-gia-dung,57902421,"Bình Đun Siêu Tốc Toshiba KT-15DS1NV (1.5L) - Hàng Chính Hãng",902500,902500,0,0
TIKI,cross-border-hang-quoc-te,197600242,"Hộp 4 quần lót nam boxer CITYMEN lưng Thái cao cấp vải thun lạnh co giãn 4 chiều - Giao màu ngẫu nhiên",180000,180000,0,0
TIKI,thoi-trang-nu,179417238,"Quần short nữ ống rộng cá tính, quần đùi nữ ống rộng chất đũi mát siêu đẹp Y1",175000,175000,0,0
TIKI,thoi-trang-nu,37126497,"( 10 cái ) quần lót nữ Su đúc không đường may, hàng đẹp loại xịn W19_503",135000,135000,0,0
TIKI,bach-hoa-online,202797473,"Bánh Gấu Nhân Kem DTfood 1kg",65550,69000,3450,5
TIKI,o-to-xe-may-xe-dap,74083498,"Cảo Xích Xe Đạp Giúp Tháo Mở Cảo Cắt Mắt Dây Sên Xe Đạp Nhỏ Gọn, Tiện Lợi Mai Lee",88000,99000,11000,11
TIKI,thoi-trang-nu,58668155,"Aó lót ren Triumph D 337 WHU - Màu hồng da - có gọng , mút dầy , mút có thể tháo rời",550000,799000,249000,31
TIKI,dien-gia-dung,109452393,"QUẠT SÀN CÔNG NGHIỆP HALI SN186C- 80W- CÁNH 450mm - BẢO HÀNH 1 NĂM - Hàng chính hãng",630000,630000,0,0
TIKI,thoi-trang-nu,8068749,"Áo Khoác Nữ Xỏ Ngón Comfort Phúc An 4034 Màu",180000,180000,0,0
TIKI,lam-dep-suc-khoe,105821846,"Tinh Dầu Treo Xe Homer 7ML - Khử Mùi Xe Hơi, Treo Thơm Phòng, Treo Tủ - Tinh dầu treo Sả chanh/ Bạc Hà/ Quế",8000,8000,0,0
TIKI,bach-hoa-online,137755749,"Thức ăn cho mèo con và mèo trưởng thành Royal Canin Pháp Hộp 1kg",199999,199999,0,0
TIKI,thoi-trang-nu,103079663,"[ĐẸP ĐỘC] Chân váy jean ngang gối 08 phối dây xích lưng cá tính C101 Cỏ Boutique",295000,295000,0,0
TIKI,lam-dep-suc-khoe,117257499,"Bộ 2 dầu gội Palmolive 600ml Sữa dừa và Keratin kết hợp quả ô liu 600ml",236000,236000,0,0
TIKI,dien-gia-dung,176150706,"Combo Nồi Nấu Chậm 0,8L SUBE001 + Máy Xay Ăn Dặm 0,3L B03V2 cháo, chưng yến dinh dưỡng, tiện dụng - Hàng Chính Hãng",813000,1012999,199999,20
TIKI,bach-hoa-online,176292294,"Canh cải xoong nấu thịt ăn liền I-Soup 42g (túi 06 viên cho 06 khẩu phần ăn)-Công nghệ Nhật Bản",68000,68000,0,0
TIKI,cross-border-hang-quoc-te,191268792,"Viên uống Kirkland Signature CoQ10 300 mg, 100 viên",633000,633000,0,0
TIKI,cross-border-hang-quoc-te,170726435,"Sách - Six of Crows : Book 1 by Leigh Bardugo (UK edition, paperback)",443000,443000,0,0
TIKI,dien-gia-dung,429546,"Bếp Hồng Ngoại Iruka I-77 (2200W) - Hàng Chính Hãng",1689000,2490000,801000,32
TIKI,lam-dep-suc-khoe,146584853,"Bàn chải đánh răng điện FAIRYWILL D7 Công nghệ sóng siêu âm 5 Chế độ làm sạch 3 Đầu thay thế đặc biệt Hàng Chính Hãng",284050,299000,14950,5
TIKI,lam-dep-suc-khoe,86529842,"Hộp 10 miếng mặt nạ giảm mụn mờ thâm Caryophy Portulaca Mask Sheet 3IN1 22g x 10",500000,500000,0,0
TIKI,lam-dep-suc-khoe,174045175,"Kem chống nắng nâng tông Skin Aqua Tone up Latte Beige cho mọi tông da, dạng tinh chất Sunplay Skin Aqua Tone Up UV Essence Latte Beige SPF 50+ PA++++ 50g",161000,199000,38000,19
TIKI,cross-border-hang-quoc-te,187861992,"Quần bơi dài, lửng",95000,95000,0,0
TIKI,cross-border-hang-quoc-te,178060756,"Sách - Layla by Colleen Hoover (US edition, paperback)",488000,488000,0,0
TIKI,cross-border-hang-quoc-te,7917818,"Multipliers",440000,440000,0,0
TIKI,o-to-xe-may-xe-dap,50512779,"Nón bảo hiểm 3/4 kính âm Royal M139 Xanh Mực Nhám cao cấp Lót tháo rời, che hết mặt",499000,499000,0,0
TIKI,thoi-trang-nu,179418058,"Áo sơ mi cổ trụ tay lỡ dáng xuông thời trang Hàn Quốc ( mã A25)",186000,186000,0,0
TIKI,thoi-trang-nu,67225104,"Quần tây baggy công sở bigsize lưng thun nữ",149000,149000,0,0
TIKI,dien-gia-dung,42958544,"Biến áp (Adaptor) - chuyển nguồn",139000,150000,11000,7
TIKI,dien-gia-dung,14548451,"Combo 2 Quạt Cầm Tay Mini Cắm Cổng USB Laptop, Sạc Dự Phòng No.1",15500,15500,0,0
TIKI,dien-gia-dung,105602617,"Quạt đứng SENKO sải cảnh lớn , hẹn giờ bật tắt cao cấp hàng chính hãng- GIAO MÀU NGẪU NHIÊN  ",460000,460000,0,0
TIKI,dien-gia-dung,165345772,"ĐẦU QUẠT TREO SẮT ĐỘNG CƠ 100% ĐỒNG - HÀNG CHÍNH HÃNG 3HT",220000,220000,0,0
TIKI,thoi-trang-nu,91663893,"Đồ bộ bigsize - Đồ bộ trung niên - Bộ đồ trung niên mặc nhà bigsize Vicci DGN.03 thiết kế áo cộc quần dài chất liệu đũi cao cấp (dành cho người béo)",168000,329000,161000,49
TIKI,cross-border-hang-quoc-te,161539220,"quần lót nam relax cotton cao cấp chính hãng, quần sịp nam relax underwear rltk23",89000,89000,0,0
TIKI,dien-gia-dung,20524490,"MÁY HÚT BỤI 2 CHIỀU VỪA HÚT VỪA THỔI",394270,443000,48730,11
TIKI,thoi-trang-nu,137524599,"Áo khoác,bomber gió chữ R trắng in hình họa tiết cực nổi nam nữ mặc cực chất, Áo Khoác Bomber Nam Thời trang, Áo Bomber Nam Nữ Phối Tay Chữ R Gió Thu Đông Unisex, Áo gió BOMBER",110000,110000,0,0
TIKI,cross-border-hang-quoc-te,170625575,"Sách - Meditations : A New Translation by Marcus Aurelius (US edition, paperback)",361000,361000,0,0
TIKI,cross-border-hang-quoc-te,174369429,"Áo đũi nam cổ tầu phối túi ngực xếp ly trẻ trung, thời trang xuân hè 2022",179000,179000,0,0
TIKI,dien-gia-dung,53183173,"Hộp cơm điện mini đa năng AS2020 chất liệu inox siêu bền, giữ nhiệt tốt.Hộp cơm hâm nóng, nấu chín thức ăn, cơm.",360000,360000,0,0
TIKI,cross-border-hang-quoc-te,113486419,"PBT Keycaps, Thermal Dye Sublimation PBT Keycaps Set OEM Profile 108 Keycap Set for MX for Switches Mechanical Gaming Keyboard",246000,246000,0,0
TIKI,thoi-trang-nu,108926792,"Áo nịt vải lưới dây kéo giữa - Không gen Tom Trans",117999,117999,0,0
TIKI,thoi-trang-nu,58120696,"Quần lót BARE S1030266-ZY",99000,359000,260000,72
TIKI,cross-border-hang-quoc-te,2630799,"Áo thun nam trơn cổ tròn - ( trắng)",39000,39000,0,0
TIKI,dien-gia-dung,98675019,"Máy khử mùi đa năng dành cho nhà bếp, phòng ngủ, nhà vệ sinh",329000,360000,31000,9
TIKI,dien-gia-dung,658108,"Quạt Bàn Đảo 3 Tấc Senko BD8860 - Màu Ngẫu Nhiên - Hàng chính hãng",365000,365000,0,0
TIKI,dien-gia-dung,111704764,"Thiết bị phun khử trùng nano cầm tay CTFAST - 05 : Máy phun khử trùng gia đình tích điện không dây kết hợp ánh sáng xanh an toàn, khử trùng, diệt khuẩn, đuổi muỗi",199000,349000,150000,43
TIKI,o-to-xe-may-xe-dap,10085871,"Tem dán sườn xe ô tô phong cách thể thao TS02",239000,239000,0,0
TIKI,dien-gia-dung,203467727,"ẤM SIÊU TỐC THỦY TINH SUNHOUSE SHD1215B - Hàng Chính Hãng",335000,335000,0,0
TIKI,cross-border-hang-quoc-te,175886322,"Sách - I Used to Have a Plan : But Life Had Other Ideas by Alessandra Olanow (US edition, hardcover)",576000,576000,0,0
TIKI,dien-gia-dung,5818893,"Siêu sắc thuốc Gali GL-1801 (3.3L)- Hãng chính hãng",649000,649000,0,0
TIKI,cross-border-hang-quoc-te,67733705,"Áo thun dài tay nam nữ",86000,86000,0,0
TIKI,dien-gia-dung,176762199,"Máy Xay Sinh Tố Công Nghiệp Uniblend UB - 712 ( Hàng Nhập Khẩu)",2595000,2595000,0,0
TIKI,bach-hoa-online,161459769,"Bún Tươi Khô Asiadeli gói 300g Hàng Xuất Khẩu",28080,28080,0,0
TIKI,bach-hoa-online,138956271,"[Thùng 30 lon] Nước Yến sào Sanest Khánh Hòa đóng lon 190ml - Có đường 001",264000,264000,0,0
TIKI,thoi-trang-nu,181263918,"Quần lót nữ cạp cao gen bụng thun lạnh cao cấp viền ren mềm đũng 2 lớp kháng khuẩn,co giãn 4 chiều cạp cao",180000,180000,0,0
TIKI,the-thao-da-ngoai,82485968,"Gấu Bông Cá Nemo (50 Cm) Gb109 (Màu Cam)",189000,189000,0,0
TIKI,thoi-trang-nu,136940014,"Quần lanh thổ cẩm từ 40kg-80kg",80000,80000,0,0
TIKI,cross-border-hang-quoc-te,170661823,"Sách - The 7 Habits of Highly Effective People : 30th Anniversary Card Deck by Stephen R. Covey (US edition, paperback)",606000,606000,0,0
TIKI,thoi-trang-nu,107764628,"Áo thun nữ form rộng tay lỡ mặt cười ( trắng, đen, hồng) áo thun nữ tay lỡ áo thun nữ(cam kết như hình )",58000,58000,0,0
TIKI,thoi-trang-nu,169459230,"Đầm ngủ váy ba lỗ sườn xám cách tân sang chảnh",144000,144000,0,0
TIKI,o-to-xe-may-xe-dap,52179904,"máy sạc bình ắc quy 12v 2a từ 4-20ah sạc bình ắc quy xe máy sạc bình ắc quy 12V(Đen)",47000,47000,0,0
TIKI,cross-border-hang-quoc-te,17968980,"The Elements Of Style Illustrated",552000,552000,0,0
TIKI,bach-hoa-online,55065594,"1Kg Cơm Cháy Lắc Khô Gà Giòn Ngon Chất Lượng",97000,119000,22000,18
TIKI,thoi-trang-nu,68960906,"Đồ lót nữ trong suốt gợi cảm - Trắng",19000,19000,0,0
TIKI,thoi-trang-nu,125021753,"(HÀNG SẴN) Áo Sơ Mi Ren Ngắn Tay Cổ Trụ Phong Cách hàn Quốc SM52 - Hàng Quảng Châu Cao Cấp",275000,275000,0,0
TIKI,dien-gia-dung,97045675,"Quạt treo tường Hali công nghiệp TC197 (2 Dây) Hàng Chính Hãng (màu đen) ",555000,555000,0,0
TIKI,dien-gia-dung,112076659,"Combo 3 Lõi Lọc Nước 1,2,3 Kanzo RO L123 (Lõi PP5 + OCB + PP1) - Hàng chính hãng",200000,200000,0,0
TIKI,lam-dep-suc-khoe,84875620,"Tinh Dầu Hoa Nhài 30ML Nguyên Chất, Nhập Khẩu - Tinh Dầu Hoa Lài TIDAMO (Jasmine) Có Kiểm Nghiệm, Hương Thơm Dịu Nhẹ Quý Phái - Xông Thơm Phòng, Thư Giãn và Tốt Cho Sức Khỏe",74800,176000,101200,58
TIKI,o-to-xe-may-xe-dap,105525660,"Nón bảo hiểm xe đạp có kính Protec Win 018, nón bảo hiểm chơi thể thao ngoài trời tiêu chuẩn châu âu, kính mát, chống tia UV",505000,568000,63000,11
TIKI,o-to-xe-may-xe-dap,71075907,"Bộ Dụng Cụ Chùi Chải Vệ Sinh Sên Xích Nhông Đĩa Cho Xe Đạp Thể Thao, Địa Hình (Kèm nước rửa tẩy rửa vệ sinh sên xích) Vệ Sinh Xích Líp Mai Lee",142000,159000,17000,11
TIKI,dien-gia-dung,110035573,"Chân kệ để máy lọc nước R.O (free size) - Hàng chính hãng",76000,82000,6000,7
TIKI,cross-border-hang-quoc-te,216901915,"Áo đồng phục công nhân, kỹ sư vải kaki Nam Định phối phản quang",110000,110000,0,0
TIKI,dien-gia-dung,243245301,"Combo 3 lõi lọc nước Karofi 1,2,3 chính hãng",54500,54500,0,0
TIKI,o-to-xe-may-xe-dap,172948856,"BỘ CHẮN BÙN SAU XE NVX 155",199000,199000,0,0
TIKI,lam-dep-suc-khoe,76133761,"[HỘP - FAMAPRO 5D BABY] - khẩu trang y tế trẻ em kháng khuẩn 3 lớp Famapro 5D Baby (10 cái/ hộp) - 1 HỘP",9900,9900,0,0
TIKI,thoi-trang-nu,83159018,"Áo Sơ Mi Nữ Ngắn Tay Hai Màu Xanh Trắng",157000,157000,0,0
TIKI,bach-hoa-online,68607796,"Đậu đen xanh lòng rang sẵn - 1kg - (MS ) - Đậu đen xanh lòng hữu cơ - hạt nhỏ thuần chủng",125000,135000,10000,7
TIKI,cross-border-hang-quoc-te,115286437,"Cốc có quay bằng đồng đựng cocktail, nước trái cây, trà đá, bia và các loại đồ uống khác cho gia đình quán bar, nhà hàng",319000,319000,0,0
TIKI,lam-dep-suc-khoe,186305097,"Gối Kê Gáy, Cổ Thảo Dược Hapaku - Làm Nóng Bằng Lò Vi Sóng",198000,298000,100000,34
TIKI,cross-border-hang-quoc-te,124749863,"QUẦN TÂY MÀU XANH ĐEN VIỆT TIẾN",580000,580000,0,0
TIKI,dien-gia-dung,403444,"Máy Pha Cà Phê Espresso Tiross TS620 - Hàng Chính Hãng",1050000,1990000,940000,47
TIKI,bach-hoa-online,195711140,"Kỷ Tử Khô (Câu Kỷ Tử) Smilenuts túi 145g/225g _ Kỷ tử khô CAO CẤP quà tết 2023 _ Quý Mão thượng hạng , ngon ngọt quả lớn, đặc biệt có thể ăn trực tiếp, chứa nhiều chất chống oxy hóa, đẹp da, giàu Sắt và Vitamin C",167000,167000,0,0
TIKI,cross-border-hang-quoc-te,95367701,"Thẻ nhớ USB 3.0 dung lượng 2TB",325000,325000,0,0
TIKI,o-to-xe-may-xe-dap,68110347,"Bộ body chần bông cài giữa cho bé Haki BB015",214000,240000,26000,11
TIKI,the-thao-da-ngoai,48264349,"Sonno - SIRO THẢO DƯỢC CHÂU ÂU GIÚP BÉ NGỦ SÂU GIẤC TỰ NHIÊN",345000,345000,0,0
TIKI,dien-gia-dung,36995730,"tủ sấy quần áo hàn quốc",1049995,1049995,0,0
TIKI,cross-border-hang-quoc-te,51200738,"Dây Cáp Sạc USB 5Pin Cho Máy Ảnh Kỹ Thuật Số Canon",123000,123000,0,0
TIKI,the-thao-da-ngoai,104154864,"Tổ yến mô hình dùng để trưng bày",15000,15000,0,0
TIKI,lam-dep-suc-khoe,89204299,"Cao dán hồng sâm Hàn Quốc",49000,80000,31000,39
TIKI,dien-gia-dung,10951384,"Quạt Treo 2 Dây Senko TC1626 (47W) - Hàng chính hãng",328000,328000,0,0
TIKI,thoi-trang-nu,116402810,"Bộ Scrubs bác sĩ phẫu thuật, hộ lý, điều dưỡng phòng mổ cao cấp màu Xanh Lá - NAM",290000,290000,0,0
TIKI,dien-gia-dung,119967922,"Máy hút bụi không dây siêu nhẹ Panasonic MC-SBV01W246 – Hút sạch mọi lúc mọi nơi – Dễ dàng tháo lắp - Tích hợp đèn LED phát hiện bụi - Hàng chính hãng",4489000,4489000,0,0
TIKI,bach-hoa-online,12114032,"Kẹo ngậm thảo dược EUGICA CANDY (Túi zip 15 viên)",12000,13000,1000,8
TIKI,dien-gia-dung,449515,"Bếp Hồng Ngoại Cảm Ứng Sunhouse SHD6017 - Hàng chính hãng",1100000,1480000,380000,26
TIKI,bach-hoa-online,2906923,"Gạo lứt nâu hữu cơ cao cấp/ECOBA Kim Mễ 1kg - Gạo lứt giảm cân - Cơm ngon mềm dẻo",105000,109000,4000,4
TIKI,dien-gia-dung,444402,"Nồi Áp Suất Điện Philips HD2103 (5 Lít) - Hàng Chính Hãng",1880000,2200000,320000,15
TIKI,lam-dep-suc-khoe,149467412,"Tinh Dầu Ngọc Lan Tây Homer 100ML - Tinh Dầu Thiên Nhiên Nhập Khẩu Nguyên Chất Giúp Giảm Stress, Khử Khuẩn và Xua Đuổi Côn Trùng, Sử Dụng Hiệu Quả với Máy Xông Tinh Dầu",85000,85000,0,0
TIKI,o-to-xe-may-xe-dap,94725525,"Màn hình Ôtô xe hơi đặt táp lô, hút kính 5 inch độ phân giải cao 800*480p LCD dùng cho camera lùi, camera căn lề",399000,399000,0,0
TIKI,dien-gia-dung,153495047,"Bếp điện từ Elmich ICE-3874 - Hàng chính hãng",1070000,1070000,0,0
TIKI,dien-gia-dung,76184310,"Máy Làm Sạch Thảm Karcher SE 4002",10842000,11990000,1148000,10
TIKI,cross-border-hang-quoc-te,21190890,"Áo Sơ Mi Nam Ngắn Tay Hình Logo NTLG6895",165000,165000,0,0
TIKI,dien-gia-dung,34694884,"Tông Đơ Hớt Tóc Gia Đình Cho Bé JICHEN 0817 TẶNG Bộ Kéo Cắt Tỉa + Lấy Ráy Tai Có Đèn",147996,147996,0,0
TIKI,lam-dep-suc-khoe,1529993,"Xịt khử mùi dưỡng trắng hương nước hoa Refre Whitening PerfumeSophis Hương Tinh Tế 30ml",56100,62000,5900,10
TIKI,lam-dep-suc-khoe,7677552,"Thực phẩm bảo vệ sức khỏe Viên dầu cá Kirkland Signature Fish Oil 1000mg từ Mỹ, bổ sung Omega-3, DHA và EPA - 400 Viên",776000,1552000,776000,50
TIKI,thoi-trang-nu,178229107,"Váy ngủ ren tà dài đan chéo ngực sexy cao cấp Q505 - Đầm ngủ nữ 2 dây quyến rũ - Đồ ngủ nữ gợi cảm sexy",129000,199000,70000,35
TIKI,o-to-xe-may-xe-dap,160879556,"Áo thun bé trai và áo thun bé gái QATE662 - áo thun cho bé trai và áo thun cho bé gái từ sơ sinh đến 18kg",40000,40000,0,0
TIKI,dien-gia-dung,101845731,"Đèn khò gas ECO 20 công suất cao TS2022RN - HÀNG CHÍNH HÃNG NAMILUX (MP)",169000,169000,0,0
TIKI,lam-dep-suc-khoe,72924805,"Máy Xông Tinh Dầu Hiệu Ứng Ánh Sáng 3D Cực đẹp, Máy Khuếch Tán Tinh Dầu Chuyên Dụng Xông Tinh Dầu Và Đèn LED 3D Trang Trí Phòng",388000,776000,388000,50
TIKI,lam-dep-suc-khoe,20649902,"Kem Chống Nắng Cho Mọi Loại Da Cell Fusion C Laser Sunscreen 100 SPF 50+/PA+++ (50ml)",345000,450000,105000,23
TIKI,lam-dep-suc-khoe,108535212,"Bao cao su Sagami Miracle - Thiết kế 3D - Ôm khít - Size 49 mm - Hộp 10 chiếc",95000,120000,25000,21
TIKI,cross-border-hang-quoc-te,175886807,"Sách - Why Has Nobody Told Me This Before? by Dr Julie Smith (US edition, hardcover)",819000,819000,0,0
TIKI,cross-border-hang-quoc-te,192367917,"Quần short đùi nam cao cấp TC với thiết kế họa tiết logo thêu, kết hợp phần sọc bên hông quần tạo điểm nhấn, chất cotton mát, co dãn, phong cách trẻ trung, năng động, thể thao-364",450000,450000,0,0
TIKI,dien-gia-dung,20699969,"Nồi Lẩu Điện Mini Đa Năng 2 In 1 ( 18 Cm )",79000,79000,0,0
TIKI,o-to-xe-may-xe-dap,130861049,"[BỘ 8 MIẾNG 4 CỬA] Miếng dán chống trầy xước bậc cửa xe hơi ô tô sợi carbon bền đẹp có in logo hãng",169000,169000,0,0
TIKI,bach-hoa-online,108329176,"DẦU DỪA  (100% NGUYÊN CHẤT) - CHAI 1 LÍT",63000,63000,0,0
TIKI,dien-gia-dung,1734985,"Máy Nước Nóng Lạnh Toshiba RWF-W1669BV(K1) 650W - Hàng chính hãng",3780000,5390000,1610000,30
TIKI,dien-gia-dung,175154487,"Nồi Cơm Điện cao tần Sharp KS-IH191V-GL(1.8L) Đa Chức Năng Hàng Chính Hãng",2483000,4190000,1707000,41
TIKI,lam-dep-suc-khoe,172303081,"Gel lột mụn hút sạch mụn cám, mụn đầu đen YOSHI 200gr",65000,65000,0,0
TIKI,lam-dep-suc-khoe,67555393,"Dung dịch vệ sinh nam dịu nhẹ lành tính thành phần tự nhiên mùi hương nam tính chai vòi nhấn 150ml - LOLI & THE WOLF",149000,149000,0,0
TIKI,the-thao-da-ngoai,181462670,"Bàn chải đánh răng trẻ em TLI Richell Nhật Bản | Baby",126655,126655,0,0
TIKI,o-to-xe-may-xe-dap,113919089,"Bình sữa cổ thường Pur Advanced 250ml (1802)",96000,96000,0,0
TIKI,dien-gia-dung,138161234,"Ấm đun nước siêu tốc tự động bơm tự động duy trì nhiệt độ sử dụng cho bàn trà điện thông minh",699000,699000,0,0
TIKI,the-thao-da-ngoai,53756902,"Sữa bột Nutricare ColosCare 0+ - sữa non tăng cường miễn dịch (800g)",429000,429000,0,0
TIKI,thoi-trang-nu,129823279,"Áo kiểu nữ form rộng kẻ ô trẻ trung, thời trang trẻ phong cách Hàn",159000,159000,0,0
TIKI,the-thao-da-ngoai,51299417,"Áo thun Đội bay siêu đăng bé trai",110000,110000,0,0
TIKI,o-to-xe-may-xe-dap,82862705,"Gấu bông gối ôm chó corgi tròn siêu đẹp dễ thương,Gấu bông sang trọng, Đồ chơi thú bông",265000,530000,265000,50
TIKI,bach-hoa-online,2596253,"Sốt Ướp Thịt BBQ 200gr Dh Foods",26000,26000,0,0
TIKI,o-to-xe-may-xe-dap,48264349,"Sonno - SIRO THẢO DƯỢC CHÂU ÂU GIÚP BÉ NGỦ SÂU GIẤC TỰ NHIÊN",345000,345000,0,0
TIKI,o-to-xe-may-xe-dap,75977831,"Đồ chơi lật đật phát âm thanh hình gà con xinh xắn biết chớp mắt và có nhạc nhẹ nhàng cho bé yêu, chọn màu theo ý-Đồ chơi giải trí - Đồ chơi ngộ nghĩnh cho bé từ 3 tháng tuổi trở lên",89000,115700,26700,23
TIKI,dien-gia-dung,173771927,"Máy Nướng Bánh Mì YG-3088 650W",610000,610000,0,0
TIKI,cross-border-hang-quoc-te,124554704,"Quần tây vải quần tây nam ống côn vải dãn dành cho học sinh, sinh viên có big size từ 26 đến 37",139000,139000,0,0
TIKI,thoi-trang-nu,174219974,"Quần nữ dáng suông, lưng bo chun thoải mái, chất đũi mặc mát Đũi Việt DV38",149000,169000,20000,12
TIKI,cross-border-hang-quoc-te,7823134,"Bộ 3 Quần Boxer Đúc Nam Nhật Bản (Nhiều màu) - 5Star",120000,120000,0,0
TIKI,dien-gia-dung,117571940,"Nồi điện đa năng ăn lẩu, nướng, làm bánh,... DKL-D12A1 tặng ổ cắm 3 chấu",720000,720000,0,0
TIKI,o-to-xe-may-xe-dap,145394244,"Khay ăn dặm 5 ngăn Edison Hàn Quốc có đế chống trơn cho bé mã 6872",158000,158000,0,0
TIKI,thoi-trang-nu,185867089,"Bộ quần áo lửng cho mẹ họa tiết Xanh rêu lụa - AICDMEQB5DGH - AIN Closet",310000,430000,120000,28
TIKI,lam-dep-suc-khoe,77749059,"Tinh Dầu Sả Chanh 50ML + Tinh Dầu Treo xe Treo Phòng Sả Chanh (Lemongrass) - Tinh Dầu Xông Phòng Sả Chanh Nguyên Chất TIDAMO Giúp Bảo Vệ Sức Khỏe, Kháng Khuẩn, Đuổi Muỗi Và Thư Giãn Tinh Thần",128000,256000,128000,50
TIKI,thoi-trang-nu,167561204,"Quần đùi pyjama nữ ngắn lụa Satin hoạ tiết icon iBasic HOMW028B",139000,199000,60000,30
TIKI,o-to-xe-may-xe-dap,59441423,"Kính rời dành cho Mũ bảo hiểm 3/4 - CHITA",150000,150000,0,0
TIKI,bach-hoa-online,107018178,"Bánh bông lan Quasure light cốm 126 gram Bibica - thực phẩm dành cho người ăn kiêng, tiểu đường",32900,32900,0,0
TIKI,o-to-xe-may-xe-dap,74190242,"Xe Trượt Scooter Trẻ Em Có Ghế Gấp Gọn 3 Bánh Phát Sáng, Có Nhạc Và Đèn Báo, Dành Cho Bé Từ 2-12 Tuổi",215000,263900,48900,19
TIKI,bach-hoa-online,56417254,"Muối Hồng Himalaya DK Harvest",85000,119000,34000,29
TIKI,thoi-trang-nu,181428892,"Áo kiểu nữ cổ voan bèo nhẹ nhàng, thích hợp đi chơi du lịch, thời trang xuân hè 2022 - Vàng",82600,82600,0,0
TIKI,o-to-xe-may-xe-dap,174121364,"Chai xịt khử mùi - diệt khuẩn 3M Air Freshener Spray 38660 200ml",218500,230000,11500,5
TIKI,thoi-trang-nu,191500992,"Áo Lót Nữ Áo Ngực Nữ Su Đúc Không Gọng Nâng Ngực Thông Hơi Không Hằn Mỡ Cao Cấp",18000,18000,0,0
TIKI,thoi-trang-nam,66683004,"Áo Khoác Nam Vải Kaki 2 Lớp Mặc Bốn Mùa Kiểu Dáng Thời Trang",474050,499000,24950,5
TIKI,cross-border-hang-quoc-te,67545395,"Quần tây nam vải co giãn , quần âu nam vải tuyết mưa hàn quốc - xanh than - 33",115000,115000,0,0
TIKI,o-to-xe-may-xe-dap,102654330,"VÍ DA ĐỰNG ĐĂNG KIỂM, GIẤY TỜ Ô TÔ CAO CẤP",20000,20000,0,0
TIKI,bach-hoa-online,12114189,"Tinh chất thảo dược hỗ trợ giảm 7 triệu chứng cảm cúm EUGICA COLD & FLU (Hộp 10 gói x 4 g)",68000,80000,12000,15
TIKI,bach-hoa-online,59197171,"Sữa Tiệt Trùng Có Đường VPMilk Grow+ Hộp 110ml (Thùng 48 Hộp)",269400,269400,0,0
TIKI,cross-border-hang-quoc-te,181423159,"Áo thun nam cotton cơ bản in hình sóc, chất vải cotton dày dặn, thời trang xuân hè 2021",35000,35000,0,0
TIKI,thoi-trang-nam,31594559,"Áo khoác da cá GOKING 6 túi, form unisex cho nam nữ, trẻ em. Áo chống lạnh, giữ ấm, chống nắng. Hàng hiệu cao cấp vnxk",295000,295000,0,0
TIKI,thoi-trang-nu,86882422,"(HÀNG SẴN) Đầm Hoa Trung Niên Che Bụng Cho Mẹ VH52 - Hàng Quảng Châu Cao Cấp",375000,375000,0,0
TIKI,thoi-trang-nu,176687766,"Đồ Bơi Hai Mảnh Họa Tiết Sọc Kèm Váy Ren ATO54 MayHomes Women Two-Piece Swimwear",161070,177000,15930,9
TIKI,bach-hoa-online,187234731,"Đặc Sản Phan Thiết - [Lốc 10 Chai] Nước Mắm Tôm Biển Làng Chài Xưa Hồng Ngọc Đại Dương 125Ml/Chai 300 Năm Truyền Thống",150000,290000,140000,48
TIKI,bach-hoa-online,140579038,"Mì Hảo Hảo Tôm Xào Chua Ngọt thùng 30 gói",145000,145000,0,0
TIKI,dien-gia-dung,57878964,"Nồi cơm cao tần Toshiba RC-10IX1PV (1 Lít)- Hàng Chính Hãng",2290000,2990000,700000,23
TIKI,lam-dep-suc-khoe,205080549,"Viên uống tăng cường sinh lý nam giới Powergra (Super Gold Magic) - Vỉ 1 viên",220000,220000,0,0
TIKI,cross-border-hang-quoc-te,170721330,"Sách - What Got You Here Won't Get You There : How Successful People Be by Dr Marshall Goldsmith (US edition, paperback)",397000,397000,0,0
TIKI,thoi-trang-nu,127807880,"Full sét MERRY cưng xỉu , sét bộ đùi mới toanh diện hè bao chuẩn lun đây nè, form to rộng chuẩn đẹp lắm nhé, Set đồ bộ from rộng sang chảnh, đồ bộ thể thao nữ unisex ulzzang, bộ đồ mặc nhà nữ rộng thoải mái chất mát",99000,99000,0,0
TIKI,thoi-trang-nam,19639438,"quần jean dài nam trơn thời trang",110000,110000,0,0
TIKI,thoi-trang-nam,13629284,"Quần Short unisex Nam Cotton SV2",63000,63000,0,0
TIKI,cross-border-hang-quoc-te,46334728,"Tay Cầm Bằng Gỗ Dương Cầm Chỉnh Cờ Lê Grand Piano Sửa Chữa Bảo Trì Dụng Cụ",747000,747000,0,0
TIKI,thoi-trang-nam,195192891,"Quần Gió Nam Thể Thao FASVIN Vải Gió Đẹp Hàng Nhà Máy Chất Lượng Cao Dùng Khi Thể Thao Hay Mặc Nhà DC20423.HN",185000,298000,113000,38
TIKI,dien-gia-dung,72945629,"Bộ lọc nước Konka KPW - LT01 (KJ) mẫu mới, lọc sạch nước an toàn không mùi clo, công nghệ 9 màng lọc, máy lắp trực tiếp tại vòi nước -Hàng nhập khẩu",399000,650000,251000,39
TIKI,thoi-trang-nam,51507409,"Quần lót hình bướm lọt khe sexy",25000,25000,0,0
TIKI,thoi-trang-nam,111990270,"Quần Kaki Nam Đẹp Dáng Hàn Lưng Thun Tiện Dụng Form Slim Fit Cực Đẹp QK045",103000,103000,0,0
TIKI,thoi-trang-nam,56232767,"Áo Sơ Mi Nữ Kiểu Tay Ngắn Cổ Peter Pan",141550,149000,7450,5
TIKI,bach-hoa-online,191650671,"Hạt Điều Rang Củi Oh Smilenuts, Hạt Điều Nguyên Vị - Điều rang muối Bình Phước nguyên hạt còn vỏ lụa - Hạt Dinh Dưỡng Hũ 500g - Hạt điều Bình Phước loại 1",169000,224000,55000,25
TIKI,the-thao-da-ngoai,55597362,"Ba Lô DONI DINO Nàng Cá Nhỏ - Xanh BFO1109",193000,385000,192000,50
TIKI,cross-border-hang-quoc-te,112016001,"Bàn đạp xe đạp bằng hợp kim nhôm siêu nhẹ thiết kế bản to có đinh chống trượt",197000,197000,0,0
TIKI,dien-gia-dung,449130,"Bình Thủy Điện Sunhouse SH1535 (3.5 lít) - Hàng chính hãng",889000,889000,0,0
TIKI,thoi-trang-nam,106771166,"Áo Lót Nữ, Áo Bra Không Dây Không Gọng Cực Êm, Bra Nữ Đệm Bàn Tay Nâng Ngực Siêu Quyến Rũ thương hiệu Baw ABR1 (tặng kèm dây trong)",159000,159000,0,0
TIKI,dien-gia-dung,680672,"Máy Xay Sinh Tố Electrolux EMB3025 (600ml) - Hàng Chính Hãng",769000,769000,0,0
TIKI,lam-dep-suc-khoe,174509075,"[COMBO 3 HỘP] Kẹo ngậm Viatux Extra Vietnat giảm ho khàn tiếng - 30 viên/ hộp",90750,90750,0,0
TIKI,dien-gia-dung,147202163,"Bóng Đèn Hồng Ngoại Y Tế: Supermed 250W Sưởi Ấm, Giảm Đau -VT0101",85000,85000,0,0
TIKI,bach-hoa-online,184861027,"Yến mạch tươi cán mỏng (cán dẹt) GUfoods - Ăn kiêng, Giàu chất xơ, Hỗ trợ giảm cân, Tập gym, Eat clean",27000,55000,28000,51
TIKI,lam-dep-suc-khoe,58601328,"Viên uống Vitamin tổng hợp cho Nam - One a day Men's Multivitamin 300 viên mẫu mới",590000,590000,0,0
TIKI,dien-gia-dung,173891572,"Máy cạo râu đa năng 4in1 SeaSy SS68 - Máy cạo râu cầm tay cao cấp thế hệ mới 2022 thiết kế bộ 3 lưỡi kép thông minh - Cạo râu, Tông đơ cắt tóc, Tỉa lông mũi, Rửa mặt, Sạc điện, Chống nước dành cho nam - Hàng Chính Hãng",69000,69000,0,0
TIKI,lam-dep-suc-khoe,247965266,"Collagen cho nam Youtheory Mỹ hỗ trợ sức khỏe tổng thể cho:xương khớp, da, móng, gân, dây chằng, cơ bắp, tim mạch và tăng sức đề kháng-Massel Official",627000,1254000,627000,50
TIKI,bach-hoa-online,73621685,"Trà Oolong (Ô long) Kim Tuyên Cầu Đất Dalat Farm - Túi 100Gr",83000,85000,2000,2
TIKI,dien-gia-dung,67527421,"Vòng giữ lưỡi dao máy xay sinh tố hiệu Omniblend - HÀNG NHẬP KHẨU",225000,225000,0,0
TIKI,thoi-trang-nu,185384313,"Đầm Linen nữ cổ V rút eo 2 túi phong cách công sở Đũi Việt Dv160",235305,249000,13695,6
TIKI,cross-border-hang-quoc-te,98023604,"ĐỒ BỘ NAM MẶC Ở NHÀ, ĐI CHƠI ÁO BA LỖ IN CHỮ OFF CHẤT THUN LẠNH, QUẦN KAKI TÚI KHÓA, LÊN FORM CỰC ĐẸP, ĐỒ BỘ MẠC NHÀ SÁT NÁCH CHỮ OFF, BỘ ĐỒ THỂ THAO SÁT NÁCH, BỘ ĐỒ ĐÔI NAM NỮ,  BỘ ĐỒ NAM NỮ",115000,115000,0,0
TIKI,thoi-trang-nu,174211231,"Set bộ đi chơi linen sát nách màu xanh đá trẻ trung sang trọng ArcticHunter, thời trang thương hiệu chính hãng",289000,289000,0,0
TIKI,cross-border-hang-quoc-te,147444526,"Áo Sơ Mi Nam Dài Tay Sọc Ngang Bảng To PONIVA",164000,164000,0,0
TIKI,thoi-trang-nu,103431434,"Quần shorts nữ cạp cao siêu Hot",65000,65000,0,0
TIKI,bach-hoa-online,121229323,"Gạo Thơm ST25 Túi 5Kg A An - Cơm mềm dẻo, thơm nhẹ, vị ngọt",159000,159000,0,0
TIKI,cross-border-hang-quoc-te,108600088,"Áo khoác phản quang cho nam đi xe đạp và các hoạt động thể thao ngoài trời",430000,430000,0,0
TIKI,dien-gia-dung,176707132,"Gioăng cốc lọc 10 innch, 20 inch, vỏ màng, gioăng cao su máy lọc nước ( số lượng 01 cái)",6000,6000,0,0
TIKI,cross-border-hang-quoc-te,194807248,"Canxi Nước cho bé Naturade Liquid Calcium Magnesium & Vitamin D3 474ml (01/2024) (Chai)",331000,331000,0,0
TIKI,dien-gia-dung,90364348,"Quạt Điều Hòa Làm Mát Bằng Hơi Nước Dung Tích 40L, Công Suất 130W, Siêu Mát Với 3 Cấp Gió Giúp Làm Mát Nhanh, Tiết Kiệm Điện",1234905,1299900,64995,5
TIKI,o-to-xe-may-xe-dap,82485968,"Gấu Bông Cá Nemo (50 Cm) Gb109 (Màu Cam)",189000,189000,0,0
TIKI,lam-dep-suc-khoe,10072103,"Gel Hút Mụn Đầu Đen Than Hoạt Tính - OHIO ỐC SÊN NEW DAY",32000,32000,0,0
TIKI,thoi-trang-nu,187955238,"Đầm suông linen dáng yếm nơ lưng vạt tròn trẻ trung, thời trang phong cách Hàn - Hồng",260000,260000,0,0
TIKI,lam-dep-suc-khoe,76110606,"Gương trang điểm để bàn cao cấp gương soi di động bằng gỗ xoay gập tiện lợi phong cách châu Âu - Tặng 1 băng đô trang điểm vải nhung màu ngẫu nhiên",25000,25000,0,0
TIKI,o-to-xe-may-xe-dap,25973334,"Sạc Điện Thoại Trên Xe Máy ",33000,33000,0,0
TIKI,dien-gia-dung,72802933,"Máy hút bụi cầm tay Deerma Vacuum Cleaner DX118C - Hàng Nhập Khẩu",859000,859000,0,0
TIKI,dien-gia-dung,1368631,"Nồi Nấu Cháo Đa Năng BBCooker BS25 (2.5L) - Hàng Chính Hãng",515000,515000,0,0
TIKI,o-to-xe-may-xe-dap,52432561,"Bơm lốp xe đạp xe máy chính hãng CMART l0005",175000,175000,0,0
TIKI,dien-gia-dung,16654646,"Quạt Treo Tường Có Điều Khiển Tiross TS9186 (50W) - Hàng Chính Hãng",1240000,1499000,259000,17
TIKI,the-thao-da-ngoai,3690599,"Chăn Lưới Chống Ngạt, Thoáng Mát Cho Bé Dùng Quanh Năm Xuất Xứ Thái Lan (75 x 100cm) - Xanh",230000,230000,0,0
TIKI,the-thao-da-ngoai,202606089,"Xe Lắc Nhựa Chợ Lớn hình Chú Ong Con (Có nhạc) - M1786B-X3B",486000,486000,0,0
TIKI,dien-gia-dung,7170571,"Bình Đun Siêu Tốc Điện Inox Sunhouse SHD1057 (1.5L) - Hàng chính hãng",170000,240000,70000,29
TIKI,dien-gia-dung,56274878,"Củ lọc vòi nước đa chiều nhựa trắng",33000,33000,0,0
TIKI,the-thao-da-ngoai,42688572,"Máy hút sữa điện đôi Biohealth IE - Sử dụng pin sạc, có chế độ massage và 3 chế độ hút",1370000,1370000,0,0
TIKI,o-to-xe-may-xe-dap,126508763,"NGỰA PONY 1 CON",75000,75000,0,0
TIKI,the-thao-da-ngoai,40715526,"Sữa Lean Max Bone Người Loãng Xương",300000,300000,0,0
TIKI,the-thao-da-ngoai,194567446,"(combo 25 tấm khổ 12,5cm x 22,5cm) vải nỉ, vải dạ làm đồ thủ công",25000,25000,0,0
TIKI,cross-border-hang-quoc-te,114056064,"Quần jogger 2 da cao cấp in hoạ tiết unisex nam nữ có dây rút ống thời trang Hàn",99000,99000,0,0
TIKI,o-to-xe-may-xe-dap,118208166,"Bộ Xếp Hình Gỗ Thành Phố Cho Bé (120 chi tiết mẫu MỚI - 160 chi tiết mẫu cũ) || Montessori cao cấp || Đồ chơi Gỗ - Giáo dục - An toàn - Thông minh",148000,169000,21000,12
TIKI,cross-border-hang-quoc-te,95053766,"Áo Khoác Big Size Nam Nữ Áo Khoác Kaki Unisex Chống Nóng Chống Nắng Chống Lạnh Chống Gió 2 Lớp Có Cổ Cao Thời Trang Nam Tính Hàn Quốc Cao Cấp QK36 - ShopN6",169000,235000,66000,28
TIKI,o-to-xe-may-xe-dap,55597362,"Ba Lô DONI DINO Nàng Cá Nhỏ - Xanh BFO1109",193000,385000,192000,50
TIKI,lam-dep-suc-khoe,176790842,"Túi chườm nóng lạnh đa năng dung tích 500ml, túi chườm ấm bụng giảm đau bụng kinh nguyệt dành cho bạn nữ",89000,89000,0,0
TIKI,cross-border-hang-quoc-te,48427720,"Quần Lót Nam Boxer Body Thể Thao Cam Đen 5969",61000,69000,8000,12
TIKI,thoi-trang-nu,9969791,"Đầm Nữ Trung Niên 23TBB ",268000,268000,0,0
TIKI,cross-border-hang-quoc-te,129297930,"quần short đũi nam trung niên ống suông đũng dài chất đẹp không nhăn không nhàu",199000,199000,0,0
TIKI,the-thao-da-ngoai,4465541,"Nước diệt kiến sạch kiến sau hai giờ - Hantox 50ml",25999,25999,0,0
TIKI,o-to-xe-may-xe-dap,32428423,"Combo Tinh dầu xịt phòng Xá Xị, khử mùi hôi (02 Chai xịt và 1 lọ treo nguyên chất)",209000,220000,11000,5
TIKI,bach-hoa-online,68267196,"Bột ngũ cốc dinh dưỡng cao cấp  - MS - (1kg/2 gói) - Ngũ cốc tăng cân, lợi sữa - 18 loại đậu & hạt",270000,300000,30000,10
TIKI,the-thao-da-ngoai,126508763,"NGỰA PONY 1 CON",75000,75000,0,0
TIKI,thoi-trang-nu,74441778,"Áo Ngực Nữ Không Gọng Thun Lạnh Mút Mỏng Hoa Văn Active Miley Lingerie - Màu Xanh BRM07015",210000,470000,260000,55
TIKI,thoi-trang-nu,97535393,"Áo sơ mi nữ dáng rộng tay lỡ xẻ tà gấu đuôi tôm",169000,169000,0,0
TIKI,bach-hoa-online,170995037,"PATE KING'S PET DẠNG LON DINH DƯỠNG CHO CHÓ MÈO (lon 380g)",39500,79000,39500,50
TIKI,lam-dep-suc-khoe,75528793,"Combo 3 Tinh Dầu Sả Chanh + Tinh Dầu Bạc Hà + Tinh Dầu Cam Ngọt - Tinh Dầu Xông Phòng Nguyên Chất Nhập Khẩu Giúp Thư Giãn, Đuổi Muỗi Và Thơm Phòng (3 chai 10ML)",118000,236000,118000,50
TIKI,dien-gia-dung,146289318,"Máy ép  trái cây, máy ép Mitomo EC-55 xuất xứ thái lan",925000,1320000,395000,30
TIKI,dien-gia-dung,166449072,"[ HCM] Bếp Từ 2 Vùng Nấu Bosch HMH.PPI82560MS (Series 8) - 78cm - Hàng Chính Hãng",11700000,11700000,0,0
TIKI,thoi-trang-nam,107338883,"Áo thun Nam Nữ Vonesa, áo phông Unisex Nam Nữ có Size từ 25-84kg B7",40000,40000,0,0
TIKI,dien-gia-dung,50643212,"Quạt bàn đảo 4 Tấc chuyển hướng điện cao cấp Senko ( Hàng Chính Hãng ) BD1410",490000,490000,0,0
TIKI,thoi-trang-nu,175550126,"ĐẦM XÒE PHỐI CHÂN VÁY HOA - D07",179000,310000,131000,42
TIKI,thoi-trang-nam,172120849,"Áo Polo Nam kiểu dáng Vintage Slub hãng JohnSton&Murphy hàng xuất Mỹ đủ màu phù hợp cả trang phục công sở lịch lãm",375000,375000,0,0
TIKI,cross-border-hang-quoc-te,184951515,"Bộ 10 Dụng Cụ Pha Chế Cocktail",463000,463000,0,0
TIKI,the-thao-da-ngoai,40752351,"Combo 5 bịch khăn vải khô đa năng Mama (bịch 240 tờ)",249000,249000,0,0
TIKI,thoi-trang-nam,113233457,"Quần đùi nam xuất khẩu, quần đùi mặc nhà chất kate cotton cao cấp  thương hiệu Fezzio",42500,85000,42500,50
TIKI,cross-border-hang-quoc-te,126156231,"quần đi biển 1 hàng cao cấp , nhóm, du lịch mùa hè.hàng đẹp, vải mát, đồng phục đủ size cho cả nhà",45000,45000,0,0
TIKI,bach-hoa-online,1064994,"Cà Phê Sữa G7 3in1 Trung Nguyên (Hộp 21 Gói) - (Giao Ngẫu Nhiên)",66000,66000,0,0
TIKI,dien-gia-dung,54348913,"máy sây tóc chất lượng cao công suất lớn",56490,56490,0,0
TIKI,bach-hoa-online,53306672,"Trà Kỷ Tử Sấy Khô Mộc Sắc 100g",65000,65000,0,0
TIKI,lam-dep-suc-khoe,53296092,"Sữa chống nắng Shiseido GSC The Perfect Protector 50ml",1250000,1250000,0,0
TIKI,bach-hoa-online,181000491,"Đặc Sản Sóc Trăng - Bánh Pía Kim Sa Tân Huê Viên Đậu Xanh Tan Chảy 480G, Bánh Pía Sóc Trăng Tan Chảy, Vị Bán Chạy",124460,127000,2540,2
TIKI,thoi-trang-nam,22986374,"Áo lót 7 tư thế tạo khe chữ U",67000,67000,0,0
TIKI,thoi-trang-nam,98986504,"Áo thun Teeworld Sài Gòn - Everything you need to know Form Rộng Unisex Nam Nữ",299000,299000,0,0
TIKI,thoi-trang-nam,163896997,"Áo Sơ Mi Nam Trắng Trơn Dài Tay Công Sở Trung Niên Thương Hiệu Anton Vải Nano Chống Nhăn - SRD05",295000,355000,60000,17
TIKI,bach-hoa-online,140579026,"Mì Ly Handy Chay Hảo Hảo Lẩu Nấm Thập cẩm (Thùng 24 ly × 66gr)",249000,249000,0,0
TIKI,thoi-trang-nam,103431636,"Quần ống rộng hot trend 2021 khóa trước QUÀ TẶNG LÀ 1 GÓI XẢ VẢI NHÉ",89000,89000,0,0
TIKI,thoi-trang-nam,244332201,"Áo croptop vạt bầu cổ tim tay ngắn ôm nữ ozenka , áo crt basic chất cotton màu đen trắng mặc đi học đi chơi dưới 55 cân",59000,59000,0,0
TIKI,thoi-trang-nam,31202048,"Quần tây nam không ply ống đứng Khatoco Q1M528R0-CNMA032-2105-0",422400,528000,105600,20
TIKI,lam-dep-suc-khoe,1313887,"Kem chống nắng Skin Aqua dưỡng ẩm, dạng sữa dùng hàng ngày Sunplay Skin UV Moisture SPF 50, PA++++ 30g",88200,109000,20800,19
TIKI,thoi-trang-nam,84872072,"Set đồ bơi nam full 5 chi tiết kèm túi đựng, Quần bơi da cá + Kính bơi + Mũ + Bịt tai + Kẹp mũi, hàng xịn đẹp chuẩn | BN009",320000,320000,0,0
TIKI,thoi-trang-nam,193976862,"Quần Jean nam Leman xanh mài rêu JD12 - Slim Form",455000,549000,94000,17
TIKI,thoi-trang-nam,190154616,"Quần kaki dài nam việt tiến màu xám sáng có 1ly và không ly 6R6013 - 6R6012 Regular",785000,785000,0,0
TIKI,thoi-trang-nam,196207027,"Áo thun Teeworld Sài Gòn Retro Nam Nữ Trắng Đen Form Rộng Unisex",359000,359000,0,0
TIKI,bach-hoa-online,51860168,"Đặc sản An Giang - Gạo Hạt Ngọc Trời Thiên Long Túi 5Kg - Gạo thơm đặc sản - OCOP 4 Sao",128000,128000,0,0
TIKI,bach-hoa-online,163914289,"Đặc Sản Kon Tum - Khổ Qua Rừng (Mướp Đắng Rừng) Thái Lát Sấy Khô Hút Chân Không - 500Gram - OCOP 3 Sao",165000,165000,0,0
TIKI,dien-gia-dung,50820171,"Bếp điện từ điện tử Iruka I-78 (2000W) - Hàng chính hãng",1910000,2790000,880000,32
TIKI,the-thao-da-ngoai,82862705,"Gấu bông gối ôm chó corgi tròn siêu đẹp dễ thương,Gấu bông sang trọng, Đồ chơi thú bông",265000,530000,265000,50
TIKI,the-thao-da-ngoai,103533595,"04 bộ tranh xếp hình 35 mảnh khổ A4 20x30cm – đồ chơi trí tuệ cho bé từ 2 tuổi – Combo 5",75000,100000,25000,25
TIKI,thoi-trang-nam,176200238,"Váy ngủ ren hai dây nút cài xẻ trước kèm chip lọt khe gợi cảm Q438 - Đầm ngủ nữ xuyên thấu quyến rũ - Đồ ngủ sexy",139000,210000,71000,34
TIKI,thoi-trang-nam,73344921,"Dán Nâng Ngực Silicon dán nâng ngực Tạo Khe Loại miếng dán nâng ngực có độn dán chắc dùng nhiều lần",64999,64999,0,0
TIKI,lam-dep-suc-khoe,3844939,"Cao Hồng Sâm Sobeak 6 Năm Tuổi Hàn Quốc (240g x 2 hũ)",650000,650000,0,0
TIKI,cross-border-hang-quoc-te,147169491,"Thiết Bị Khuếch Đại Âm Thanh Cho Đàn Guitar / Violin / Mandolin / Ukulele",244500,244500,0,0
TIKI,cross-border-hang-quoc-te,181422834,"Áo thun Classic nam 2018, hàng nhập Quảng Châu",69000,69000,0,0
TIKI,lam-dep-suc-khoe,112976646,"Tinh Dầu Khuếch Hương DAILY COMMA Crystal Hologram Diffuser 100ML (MẪU MỚI NHẬP KHẨU)",135000,270000,135000,50
TIKI,thoi-trang-nam,117003535,"Bộ Đồ Ngủ Nữ Mùa Hè Cao Cấp Loirechic BDN03",219000,399000,180000,45
TIKI,thoi-trang-nu,112457080,"Đầm xòe Caro dễ thương-MS019",380000,380000,0,0
TIKI,lam-dep-suc-khoe,262899667,"Glucosamine 1500mg Chondroitin 1200mg Kirkland Signature  - Phục hồi sụn khớp, Giảm đau nhức xương khớp và Hỗ trợ sự vận động linh hoạt hiệu quả - QuaTangMe Extaste",655000,1310000,655000,50
TIKI,thoi-trang-nu,68857986,"Áo croptop cộc tay chất cotton zip",39000,39000,0,0
TIKI,bach-hoa-online,59478426,"Bột pha trà sữa cao cấp Déli - 1kg - thơm, béo tự nhiên - chuyên dùng pha chế trà sữa",90000,95000,5000,5
TIKI,dien-gia-dung,182821944,"Máy Cạo Râu Mini Bugu Stardom BR-228 Ba Lưỡi Sát Chân Lông Sạc Nhanh Chống Nước - Hàng Chính Hãng",128000,249000,121000,49
TIKI,o-to-xe-may-xe-dap,85236398,"khung biển số dài cho ô tô kích thước mới đế nhựa viền thép",160000,160000,0,0
TIKI,dien-gia-dung,139277344,"Lưới ép, cối làm kem của máy ép trái cây Biochef",714000,714000,0,0
TIKI,lam-dep-suc-khoe,95975019,"Nước Uống Tăng Lực Hồng Sâm Won KGC Cheong Kwan Jang 100ml x 10 Chai",280000,300000,20000,7
TIKI,cross-border-hang-quoc-te,170722326,"Sách - What to Expect When You're Expecting by unknown,Heidi Murkoff (US edition, paperback)",839000,839000,0,0
TIKI,dien-gia-dung,165035326,"Máy Hút Chân Không Cao Cấp Mini Vacuum Sealer. Hút Chân Không Kiêm Hàn Miệng Túi Thực Phẩm",109875,109875,0,0
TIKI,bach-hoa-online,63463896,"Thùng 24 Lon Bia SAN MIGUEL Trái Cây Vị Vải 330 ml",455000,455000,0,0
TIKI,dien-gia-dung,106378953,"Bếp Gas Dương Kính Sunhouse SHB2106 - Hàng Chính Hãng",570000,570000,0,0
TIKI,lam-dep-suc-khoe,128756250,"MUSK KHẨU TRANG Y TẾ 5 LỚP N95 / FFP2 Nhập Khẩu Châu Âu Turkey, Phòng Tránh Lây Nhiễm Vi Khuẩn, Virus, Bệnh Hô Hấp, Hoá Chất, Phòng Thí Nghiệm, Bệnh Viện, Môi Trường Y Tế, Bụi Khuẩn Độc Hại. LỌC VI KHUẨN, VIRUS 99%. Hộp 10 Chiếc Màu Trắng",99000,160000,61000,38
TIKI,lam-dep-suc-khoe,152097308,"Bông tẩy trang ipek thỗ nhĩ kì 130 miếng",26900,39800,12900,32
TIKI,dien-gia-dung,52867858,"Combo Máy Xay Sinh Tố Công Nghiệp JTC Omniblend I TM-767A 1200W (1.5L) và Cối Rời JTC Omniblend (1.5L) - Chính Hãng",4475000,4475000,0,0
TIKI,bach-hoa-online,58407240,"Cà phê Sáng tạo 3 (340gr)",96000,104153,8153,8
TIKI,o-to-xe-may-xe-dap,117218465,"Bô Gấu Hokori Có Ngăn Cho Bé Đi Vệ Sinh Cao Cấp",100000,100000,0,0
TIKI,thoi-trang-nu,57726141,"Đồ bộ nữ chất liệu cotton quần caro áo thiêu chứ 1141",99000,99000,0,0
TIKI,thoi-trang-nu,21129341,"Bộ 2 Áo Ngực Nữ Cotton Không Gọng Miley Lingerie BRW_03",399000,580000,181000,31
TIKI,dien-gia-dung,22476084,"Quạt đèn trần cao cấp có điều khiển TOP192",1490000,1490000,0,0
TIKI,cross-border-hang-quoc-te,174400347,"Sách - Divided : Why We're Living in an Age of Walls by Tim Marshall (UK edition, paperback)",398000,398000,0,0
TIKI,bach-hoa-online,76366855,"1KG LẠP XƯỞNG TÔM ÍT MỠ THƠM NGON HIỆU TÂN LỘC PHÁT",119000,229000,110000,48
TIKI,lam-dep-suc-khoe,47809115,"Đai Chống Gù Lưng Có Nẹp Cho Nam, Nữ và Trẻ Em",123000,123000,0,0
TIKI,lam-dep-suc-khoe,195937919,"[148 Mùi Hương] Tinh Dầu Thơm Phòng Trái Cây Thiên Nhiên Nhiệt Đới - Khử Mùi, Xông Thơm Phòng - Tinh Dầu Đào/ Chuối/ Táo Xanh/ Mơ/ Me/ Xoài/ Dưa Lưới/ Dưa Hấu (100ml)",275000,275000,0,0
TIKI,the-thao-da-ngoai,68110347,"Bộ body chần bông cài giữa cho bé Haki BB015",214000,240000,26000,11
TIKI,dien-gia-dung,56946211,"Miếng lọc bụi Hepa 13 VC 3 - Hàng chính hãng",380000,380000,0,0
TIKI,cross-border-hang-quoc-te,177750772,"Bộ bơi nam 3 chi tiết quần áo dài tay chống nắng cao cấp",460000,460000,0,0
TIKI,lam-dep-suc-khoe,12081510,"Kem Thoa Giãn Tĩnh Mạch Hỗ Trợ Giảm Đau, Sưng, Phù Chân Vascovein (tuýp 50g)",150000,150000,0,0
TIKI,bach-hoa-online,1064974,"Cà Phê Chế Phin 1 Trung Nguyên (500g)",95000,95000,0,0
TIKI,thoi-trang-nu,180608792,"Đầm Quý Bà Đầm Trung niên Đầm cho mẹ đầm Suông Họa Tiết Sang Trọng - Siêu Cao Cấp",498000,498000,0,0
TIKI,o-to-xe-may-xe-dap,34531222,"Bộ Hộp Dụng Cụ Vá Lốp Xe Lốp Không Săm Vá Lụi (vá ngoài) Bằng Thép Không Gỉ Cho Xe Oto, Xe Hơi Và Xe Máy Mai Lee - Hàng Chính Hãng",139000,139000,0,0
TIKI,cross-border-hang-quoc-te,99485511,"Quần jean nam rách cao cấp vải jean co dãn hàng chuẩn shop Phuongnamshop20 kvp58",125000,125000,0,0
TIKI,the-thao-da-ngoai,33934889,"Sữa tắm cho bé chiết xuất thảo dược Yaocare baby 250ml - DK Pharma",185000,185000,0,0
TIKI,cross-border-hang-quoc-te,11466602,"First Thousand Words In Chinese",281000,281000,0,0
TIKI,cross-border-hang-quoc-te,95728714,"Cặp đệm tai thay thế cho tai nghe BOSE QuietComfort qc35",262500,262500,0,0
TIKI,thoi-trang-nu,33694112,"Áo len nữ freesize tay ngắn 15",122550,129000,6450,5
TIKI,dien-gia-dung,74932973,"Máy may Brother JK17B - Hàng chính hãng",3198000,4100000,902000,22
TIKI,o-to-xe-may-xe-dap,104154864,"Tổ yến mô hình dùng để trưng bày",15000,15000,0,0
TIKI,cross-border-hang-quoc-te,170600668,"Sách - The Rise and Fall of the Great Powers by Paul Kennedy (UK edition, paperback)",704000,704000,0,0
TIKI,bach-hoa-online,57695989,"Cà phê bột truyền thống số 1 (500gr) Coffee Tree 100% nguyên chất gu đậm hương nhẹ",93000,178000,85000,48
TIKI,lam-dep-suc-khoe,114056241,"Tinh bột nghệ Nano HNT 200g - Đã được kiểm nghiệm và công bố - 100% Nguyên chất - Nguyên liệu hữu cơ - Sản phẩm chính hãng - Uy tín - Chất lượng",169000,169000,0,0
TIKI,dien-gia-dung,264014444,"Máy Hút Bụi Lau Sàn Khô Uớt Tự Giặt Giẻ Diệt Khuẩn TINECO Floor 3 Thương Hiệu Mỹ Lực Hút 12,000 Pa Công Suất 190 W - Hàng Chính Hãng",6999000,13939000,6940000,50
TIKI,o-to-xe-may-xe-dap,92133666,"Ví đựng giấy tờ xe ô tô Hyundai Da Cao Cấp, Ví da đựng giấy tờ xe ô tô - OTOALO",30000,30000,0,0
TIKI,o-to-xe-may-xe-dap,194567446,"(combo 25 tấm khổ 12,5cm x 22,5cm) vải nỉ, vải dạ làm đồ thủ công",25000,25000,0,0
TIKI,thoi-trang-nu,172312344,"Bộ đồ nữ mặc nhà trung niên cho các bà, các mẹ Vicci BTN.26, thiết kế áo cộc tay quần lửng, chất liệu thun Nhật mềm mịn, thoáng mát",175000,309000,134000,43
TIKI,thoi-trang-nu,67048080,"Đầm suông đũi cổ trụ ArcticHunter, thời trang thương hiệu chính hãng",199000,199000,0,0
TIKI,o-to-xe-may-xe-dap,53756902,"Sữa bột Nutricare ColosCare 0+ - sữa non tăng cường miễn dịch (800g)",429000,429000,0,0
TIKI,dien-gia-dung,50461038,"Máy Hút Bụi Cầm Tay Đa Năng Deerma CM1300 (350W) - Hàng chính hãng",886000,938000,52000,6
TIKI,cross-border-hang-quoc-te,30768234,"Áo sơ mi nam cổ trụ chui đầu dài tay kẻ sọc trắng đen",159000,159000,0,0
TIKI,the-thao-da-ngoai,118208166,"Bộ Xếp Hình Gỗ Thành Phố Cho Bé (120 chi tiết mẫu MỚI - 160 chi tiết mẫu cũ) || Montessori cao cấp || Đồ chơi Gỗ - Giáo dục - An toàn - Thông minh",148000,169000,21000,12
TIKI,cross-border-hang-quoc-te,170726691,"Viettien - Áo sơ mi nam ngắn tay vạt bầu chấm bi 1Q1180 regular",490000,490000,0,0
TIKI,dien-gia-dung,193346507,"Máy hút bụi không dây GAABOR GVCL-D10A màn hình LED 3 chế độ làm sạch lực hút mạnh 16000pa - Hàng chính hãng",1800000,1800000,0,0
TIKI,thoi-trang-nam,141109930,"Quần jogger unisex thể thao, quần ống rộng kiểu dáng jogger mặc nhà nam nữ vải TỔ ONG 3 màu năng động",80000,80000,0,0
TIKI,cross-border-hang-quoc-te,135229882,"Hoạt Hình Túi Xách Thời Trang Mới Hello Kitty Túi Nữ Da Đeo Chéo Túi Đeo Vai Cinnamoroll Dây Kéo Túi Đựng Điện Thoại - one",458197,458197,0,0
TIKI,bach-hoa-online,110250734,"Set Chè Dưỡng Nhan Giải Nhiệt 12 Vị Thơm Ngon Bổ Dưỡng DTFood",50000,50000,0,0
TIKI,bach-hoa-online,179794075,"Combo 3 gói Cà Phê Rang Xay Truyền Thống Highlands Coffee (200g)",199000,225000,26000,12
TIKI,thoi-trang-nam,13677604,"Áo khoác nam không bo lai Phúc An 2026",195000,195000,0,0
TIKI,bach-hoa-online,167420536,"Đặc Sản Kon Tum -Kỷ tử đỏ hàng sạch khô ráo - OCOP 3 Sao",39000,39000,0,0
TIKI,thoi-trang-nam,52863921,"Áo vest nam phong cách Hàn Quốc nhiều màu",185000,185000,0,0
TIKI,thoi-trang-nam,98624377,"Quần Sọt Nam ️️ Quần Short Jean Nam Đen Phối Rách Chất Bò Cao Cấp Chuẩn Hàng Shop Tô Tồ Shop - QSJNM232",138000,138000,0,0
TIKI,bach-hoa-online,93318327,"Nước mắm nhĩ nguyên chất truyền thống Phú quốc Red Boat 40N",260000,260000,0,0
TIKI,thoi-trang-nu,118027755,"Đồ Lam Đi Chùa # La Hán Nam Nữ # Đồ Bộ Nam Nữ # Quần Áo Nam Nữ",211000,211000,0,0
TIKI,bach-hoa-online,1065004,"Cà Phê Cappuccino Hương Mocha Trung Nguyên (Hộp 12 Gói)",65000,65000,0,0
TIKI,bach-hoa-online,124084318,"Dầu ăn thượng hạng Ranee Golden 1 lít",46500,69000,22500,33
TIKI,thoi-trang-nam,130029611,"Áo Hoodie Nỉ Nam Nữ From Rộng Unisex In Dạ Quang Phát Sáng Hình Gấu Cực Hot Chất Nỉ Ngoại Dày Dặn (bear)",113000,113000,0,0
TIKI,dien-gia-dung,197410397,"Máy dập tóc sóng nước Vivid&Vogue VAV038-Hàng Chính Hãng",500000,500000,0,0
TIKI,bach-hoa-online,186558239,"Đặc Sản Bến Tre - Kẹo Dừa Bến Tre Cao Cấp Gia Truyền Thương Hiệu Hai Tỏ 150G",29700,33000,3300,10
TIKI,dien-gia-dung,163021453,"[Có sẵn] Máy hút bụi ô tô, máy bơm hơi ô tô cầm tay đa năng bốn trong một, đèn pin, đo áp suất công suất cao",379050,399000,19950,5
TIKI,dien-gia-dung,192177674,"Máy Nấu Sữa Hạt, Máy Làm Sữa Hạt OLIVO CB22 PRO Thương Hiệu Mỹ Gồm 14 Chức Năng Xay Nấu Với Khả Năng Chống Trào Dung Tích 1.75 Lít Công Suất 1000 W - Hàng Chính Hãng",2679000,5339000,2660000,50
TIKI,thoi-trang-nu,6640013,"Quần Độn Mông Đúc Dạng Đùi Nâng Mông Cao Cấp",75000,75000,0,0
TIKI,cross-border-hang-quoc-te,114285672,"Hộp 5 cái quần lót tam giác thông hơi nam - Sịp lưới nam thoáng mát",86600,86600,0,0
TIKI,thoi-trang-nam,146957711,"Quần Jean Nữ Ống Rộng Lưng Cao Aaa Jeans",449000,449000,0,0
TIKI,dien-gia-dung,98552176,"Ron Silicone cho Máy Pha Cà Phê Breville 870, 878",87000,87000,0,0
TIKI,o-to-xe-may-xe-dap,40715526,"Sữa Lean Max Bone Người Loãng Xương",300000,300000,0,0
TIKI,the-thao-da-ngoai,75977831,"Đồ chơi lật đật phát âm thanh hình gà con xinh xắn biết chớp mắt và có nhạc nhẹ nhàng cho bé yêu, chọn màu theo ý-Đồ chơi giải trí - Đồ chơi ngộ nghĩnh cho bé từ 3 tháng tuổi trở lên",89000,115700,26700,23
TIKI,cross-border-hang-quoc-te,17970189,"Letters From A Stoic (New Cover)",356000,356000,0,0
TIKI,thoi-trang-nam,115832954,"áo thun nữ,áo phông nữ cộc tay phối màu in số 11 dáng rộng giấu quần năng động",63000,63000,0,0
TIKI,lam-dep-suc-khoe,22983097,"Sáp tạo kiểu tóc nam cứng mờ Aurane Cool Stylish Clay 80ml",135000,135000,0,0
TIKI,dien-gia-dung,171816262,"Nồi chiên không dầu KIPOR KP-AF657 - 15L - Lò nướng điển tử công nghệ RAPID AIR nhiệt tối đa 230 độ lòng nồi inox 304- Hàng chính hãng",3704000,5549000,1845000,33
TIKI,lam-dep-suc-khoe,58880438,"Nhiệt Kế Hồng Ngoại , Đo Không Tiếp Xúc - Cảnh Báo Sốt -- Tặng Kèm 1 Cặp Pin ",173900,173900,0,0
TIKI,dien-gia-dung,171945063,"Máy xay sinh tố KIPOR KP-S306 - Lưỡi thép chống ăn mòn siêu bền - Tặng kèm 3 cối 0,2L, 0,5L, 1,5L - Tự ngắt chống quá tải - Hàng chính hãng",502000,749000,247000,33
TIKI,thoi-trang-nam,178509162,"Áo croptop nữ kiểu buộc dây tay ngắn, áo thun cổ bẻ crt đẹp cài khuy buộc nơ 2022 màu đen trắng size 40 -55 cân",107800,107800,0,0
TIKI,dien-gia-dung,107360585,"Quạt đá điều hòa phun sương JTSL-08  Quạt hơi nước mini để bàn làm mát 8-10 độ dùng pin sạc 8-10 tiếng",399000,399000,0,0
TIKI,cross-border-hang-quoc-te,190321094,"Áo sơ mi, Áo sơ mi nam cổ đứng thêu hoa văn, vạt chéo tạo điểm nhấn cho chiếc áo của bạn, sang trọng, lịch lãm H37",199000,199000,0,0
TIKI,cross-border-hang-quoc-te,52837911,"Áo Khoác Nam Unisex áo Khoác Dài Tay áo Sơ Mi Nhà Bếp đồng Phục Bảo Hộ Lao động",239000,239000,0,0
TIKI,dien-gia-dung,362105,"Máy Sấy Tóc Panasonic PAST-EH-ND13-V645",469000,469000,0,0
TIKI,bach-hoa-online,29253101,"Mirin ướp vị ngọt tự nhiên Hinode 400ml .",50000,59000,9000,15
TIKI,lam-dep-suc-khoe,188767619,"Dầu gội phủ bạc Mochi Nhật Bản (Lược chải & vòi nhấn). Dầu gội nhuộm tóc thảo dược ngay tại nhà",249000,249000,0,0
TIKI,dien-gia-dung,161241984,"Quạt treo Mitsubishi W16-RA CY-GY - Hàng chính hãng",1739000,1739000,0,0
TIKI,o-to-xe-may-xe-dap,191950394,"Găng tay Pro-Biker - Găng tay phượt cao cấp",135000,135000,0,0
TIKI,lam-dep-suc-khoe,195559389,"Kem dưỡng cấp ẩm ban đêm Neutrogena® Hydro Boost Hyaluronic Acid Night Cream 50g",330000,440000,110000,25
TIKI,lam-dep-suc-khoe,22052325,"Sữa rửa mặt cho nam Oxy sạch sâu mát lạnh dạng kem Oxy Perfect Wash 100g",67000,82000,15000,18
TIKI,thoi-trang-nu,7595886,"Áo Kiểu Nữ Tay Loa Hoa Nhí MS0093A",180000,180000,0,0
TIKI,o-to-xe-may-xe-dap,33934889,"Sữa tắm cho bé chiết xuất thảo dược Yaocare baby 250ml - DK Pharma",185000,185000,0,0
TIKI,o-to-xe-may-xe-dap,70631578,"Set Mũ Len Kèm Khăn Quả Bông Cho Bé",42000,42000,0,0
TIKI,cross-border-hang-quoc-te,10776493,"Áo thun trơn basic, form unisex cho nam nữ. Áo phông hàng hiệu Goking, quà tặng cao cấp cho gia đình, cặp đôi, lớp nhóm, doanh nghiệp, người nước ngoài",138000,138000,0,0
TIKI,o-to-xe-may-xe-dap,103533595,"04 bộ tranh xếp hình 35 mảnh khổ A4 20x30cm – đồ chơi trí tuệ cho bé từ 2 tuổi – Combo 5",75000,100000,25000,25
TIKI,cross-border-hang-quoc-te,169018565,"Sách - If We Were Villains by M. L. Rio (UK edition, paperback)",411000,411000,0,0
TIKI,o-to-xe-may-xe-dap,102445310,"Hộp đựng khăn giấy chất liệu da trên ô tô và bàn làm việc,kèm bảng số điện thoại",139990,139990,0,0
TIKI,the-thao-da-ngoai,4282597,"Mũ chắn nước gội đầu cho bé (màu ngẫu nhiên)",12999,12999,0,0
TIKI,o-to-xe-may-xe-dap,114264109,"Lều công chúa lều hoàng tử cao cấp cỡ đại cho bé",204000,204000,0,0
TIKI,thoi-trang-nu,181656800,"Sét bộ gấm cao cấp áo cổ bẻ đính nút kèm quần ngắn",175000,175000,0,0
TIKI,dien-gia-dung,35283819,"Máy Sấy Tóc Panasonic Máy Sấy Tóc Panasonic EH-ND11-W645 Hàng Chính Hãng",290000,290000,0,0
TIKI,the-thao-da-ngoai,156212009,"Combo nước rửa bình Arau Baby bình và túi thay thế",278800,328000,49200,15
TIKI,o-to-xe-may-xe-dap,181462670,"Bàn chải đánh răng trẻ em TLI Richell Nhật Bản | Baby",126655,126655,0,0
TIKI,o-to-xe-may-xe-dap,56842434,"Thiết bị tiện ích cho ô tô đế hút nam châm giữ điện thoại thiết kế thông minh trên vô lăng hoặc tất cả vị trí trên ô tô dễ dàng lắp đặt",89000,89000,0,0
TIKI,o-to-xe-may-xe-dap,197409762,"Tấm lót chống thấm thay tã cho bé 4 lớp cao cấp Bonny thấm hút nhanh, kháng khuẩn, thoáng khí (KT50x70Cm)",120000,120000,0,0
TIKI,dien-gia-dung,103914497,"Combo 3 lõi lọc thô 123 + 1 màng RO Karofi - Hàng chính hãng",543000,543000,0,0
TIKI,o-to-xe-may-xe-dap,76047617,"Ly uống nước có nắp đậy cho bé STENLOCK (Chính hãng Hàn Quốc)",158650,167000,8350,5
TIKI,o-to-xe-may-xe-dap,89052647,"kem xóa vết xước ô tô xe máy",22000,22000,0,0
TIKI,lam-dep-suc-khoe,122092245,"[+Tặng mũ trùm] BỘ DẦU GỘI XẢ PASIORI TM COLLAGEN & BIOTIN TRẮNG PHỤC HỒI, MỀM MƯỢT NGĂN GÃY RỤNG MỌC TÓC ITALY 1000ML*2 [MẪU MỚI]",390000,390000,0,0
TIKI,dien-gia-dung,85116750,"Bàn ủi hơi nước cầm tay Cuckoo CSI-A101 - 1500W khử khuẩn có đầu chải vải, trọng lượng siêu nhẹ - Hàng chính hãng",2158000,2158000,0,0
TIKI,cross-border-hang-quoc-te,129220702,"Sách - The Song of Achilles by Madeline Miller - (UK Edition, hardcover)",772000,772000,0,0
TIKI,thoi-trang-nam,74385119,"Áo Khoác Nam Big Size Áo Khoác Dù Nam Hai Lớp Cổ Cao Chống Nắng Chống Lạnh Chống Gió Chống Tia UV Hàn Quốc Cao Cấp QD62 - ShopN6 (Nhiều Màu)",135000,240000,105000,44
TIKI,cross-border-hang-quoc-te,133875924,"Quần Lót Nam Boxer Thun Lạnh 4 Chiều Lưng Thái Cao Cấp, Quần Sịp Đùi Co Giãn Và Thấm Hút Tốt CITYMEN ( Màu Ngẫu Nhiên )",54000,54000,0,0
TIKI,thoi-trang-nam,100868615,"Áo sơ mi FLANNEL kẻ caro Unisex phong cách streetswear, Kẻ Caro Nam Nữ Form rộng Phong Cách, Áo Sơ Mi Khoác Ngoài Cao Cấp Siêu Đẹp, Áo khoác sowmi unisex form rộng CARO nam nữ phong cách ulzzang",95000,95000,0,0
TIKI,bach-hoa-online,105910660,"Combo 2 Bánh Lát Khoai Tây SLIDE Vị Thịt Nướng 2x160g",86000,107000,21000,20
TIKI,thoi-trang-nam,176789536,"Áo bơi tay ngắn nam 401",119000,119000,0,0
TIKI,thoi-trang-nam,197675716,"Áo sơ mi nam dài tay màu đen dáng suông May 10 mã 010122912L2",295000,295000,0,0
TIKI,thoi-trang-nam,74554228,"Áo Khoác Big Size Áo Khoác Dù Dày Bomber Nam Nữ Chống Nắng Chống Lạnh Chống Gió Lót Nỉ Hai Lớp Hàn Quốc Cao Cấp QD66 - ShopN6",155000,235000,80000,34
TIKI,o-to-xe-may-xe-dap,25969322,"Mũ bảo hiểm nửa đầu Bulldog Gang",598000,598000,0,0
TIKI,thoi-trang-nam,150748227,"Áo Thể Thao Nam TSIMPLE cổ tròn tay ngắn tập gym vải thun lạnh thoáng mát co giãn chuẩn form MSSAHP5",165000,165000,0,0
TIKI,bach-hoa-online,68115707,"(COMBO 2 HŨ) GÀ CHÀ BÔNG TÂN LỘC PHÁT (1KG) - DÙNG ĂN KÈM",119000,199000,80000,40
TIKI,bach-hoa-online,7993014,"Đặc sản Tiền Giang - Gạo hương lài sữa Khổng Tước Nguyên (5Kg) - OCOP 4 SAO",125000,129000,4000,3
TIKI,thoi-trang-nam,79862343,"Áo khoác len nữ Cardigan áo khoác len dày chenille nữ tính",259000,259000,0,0
TIKI,bach-hoa-online,181114319,"Trà Sen Dalatfarm - Túi 110Gr",62000,70000,8000,11
TIKI,bach-hoa-online,55506812,"1Kg Đậu Hà Lan Sấy Muối Giòn Ngon Thương Hiệu SK FOOD",89000,99000,10000,10
TIKI,bach-hoa-online,43879590,"Cát vệ sinh cho mèo cát nhật 8L 4 mùi hương [giao mùi ngẫu nhiên]",48888,48888,0,0
TIKI,cross-border-hang-quoc-te,184995159,"30 Tone Glockenspiel Xylophone Percussion Gift with Carrying Bag Mallets",716000,716000,0,0
TIKI,thoi-trang-nu,107479537,"Set maxi tầng, áo bẹt vai (A18)",290000,290000,0,0
TIKI,thoi-trang-nam,192781082,"YU CHERRY | Đầm Ruffle Neck Tank Dress YD147",395000,395000,0,0
TIKI,thoi-trang-nam,174891426,"Váy ngủ bodysuit ren sexy cao cấp Q426 - Đồ ngủ bodysuit hở đáy gợi cảm - Đầm ngủ bodysuit nữ - Bodysuit ren quyến rũ",99000,190000,91000,48
TIKI,thoi-trang-nam,74500648,"Hộp Quà Combo 5 Quần Lót Nữ Modal Phối Ren Trước Remix FCM-04",218000,250000,32000,13
TIKI,lam-dep-suc-khoe,176910167,"Bộ 24 móng tay giả cao cấp MJ069 (Kèm keo+ dũa móng tay+ miếng dán móng tay)",25000,25000,0,0
TIKI,thoi-trang-nam,145297132,"Áo vest nữ blazer hàn quốc  [HÀNG CAO CẤP] form chuẩn công sở dễ phối đồ",299000,530000,231000,44
TIKI,lam-dep-suc-khoe,74989524,"Máy Xông Tinh Dầu Cao Cấp + Tinh Dầu Sả Chanh Nguyên Chất Nhập Khẩu, Máy Khuếch Tán Tinh Dầu Chuyên Dụng, Họa Tiết Sang Trọng và Đèn LED Biến Đổi Màu Cực Đẹp (họa tiết ngẫu nhiên)",287300,676000,388700,58
TIKI,lam-dep-suc-khoe,74973204,"Máy Rửa Mặt Mini Massage Tích Hợp Sóng Âm Giúp Làm Sạch Sâu Da, Nâng Cơ Mặt, Sáng Da, Trẻ Hóa Làn Da - Máy Rửa Mặt Chính hãng VinBuy",135000,300000,165000,55
TIKI,thoi-trang-nu,96080189,"Đầm suông dáng hoa tulip thêu họa tiết trẻ ArcticHunter - Trắng",169000,169000,0,0
TIKI,thoi-trang-nam,107036659,"Đồ Lam Nữ Đi Chùa - Bộ Đi Lễ Chùa 2AL018 Trang Nhã Thêu Cá Ngọc Xinh Lung Linh Dành Cho Phật Tử 4.8",197000,197000,0,0
TIKI,lam-dep-suc-khoe,58214750,"Khẩu trang y tế 4D 4 lớp cao cấp Hamita - Bịch 1 cái - ISO13485, Dấu CE - Sử dụng giấy kháng khuẩn cao cấp Mealtblown, hiệu quả lọc kháng khuẩn giữ nguyên 99.9% sau 5 lần giặt",9000,9000,0,0
TIKI,dien-gia-dung,75558085,"Máy hút bụi khô và ướt HiClean HC30 NEW (30L) - Hàng chính hãng",3100000,3100000,0,0
TIKI,lam-dep-suc-khoe,117793839,"Tăm nước cầm tay H2ofloss HF-2 phiên bản nâng cấp được phân phối độc quyền với nút mở bình nước tiện lợi, tặng kèm 7 đầu tăm, củ sạc nguồn thấp",459000,849000,390000,46
TIKI,dien-gia-dung,48436325,"LÕI LỌC NƯỚC SỐ 3 CARBON BLOCK MÁY LỌC NƯỚC RO - lõi lọc số 3",22000,22000,0,0
TIKI,the-thao-da-ngoai,32428423,"Combo Tinh dầu xịt phòng Xá Xị, khử mùi hôi (02 Chai xịt và 1 lọ treo nguyên chất)",209000,220000,11000,5
TIKI,lam-dep-suc-khoe,580507,"Lăn Khử Mùi Romano Attitude 50ml - 1412046",56000,68000,12000,18
TIKI,lam-dep-suc-khoe,74625269,"Gel chấm mụn, mờ thâm Oxy Anti-Acne Spot Gel 10g",74000,78000,4000,5
TIKI,cross-border-hang-quoc-te,186290944,"Áo Sơ Mi nam sọc caro tím trắng dài tay NSMMCLMTCR212807D",303000,319000,16000,5
TIKI,lam-dep-suc-khoe,4613079,"Thực phẩm chức năng Giấm Đen Giảm Cân Orihiro Nhật Bản 216 Viên",164000,189000,25000,13
TIKI,thoi-trang-nu,89871718,"SIÊU HOT MIẾNG DÁN NÂNG NGỰC SILICON",36999,36999,0,0
TIKI,bach-hoa-online,59256224,"Combo 5 gói thức ăn cho chó trưởng thành Ganador vị gà nướng Adult Roasted Chicken Flavor 400gr",89999,89999,0,0
TIKI,cross-border-hang-quoc-te,137912762,"Áo Sơ Mi Nam Dài Tay Caro MR265 Thời Trang PONIVA Thiết Kế Nam Tính Lịch Lãm Hàng Chất Lượng XNK",169000,169000,0,0
TIKI,o-to-xe-may-xe-dap,156212009,"Combo nước rửa bình Arau Baby bình và túi thay thế",278800,328000,49200,15
TIKI,dien-gia-dung,193748334,"Quạt không cánh lọc không khí bù độ ẩm- 2 chiều nóng lạnh màn hình LED có điều khiển",2469050,2599000,129950,5
TIKI,o-to-xe-may-xe-dap,50793298,"Gấu Bông Heo Lười Mắt Híp Có 5 Kích Thước 2 Màu",69000,69000,0,0
TIKI,the-thao-da-ngoai,197409762,"Tấm lót chống thấm thay tã cho bé 4 lớp cao cấp Bonny thấm hút nhanh, kháng khuẩn, thoáng khí (KT50x70Cm)",120000,120000,0,0
TIKI,o-to-xe-may-xe-dap,1508591,"Chất Làm Sạch Bình Đun Nước Mao Bao (2 Gói x 25g)",38000,45000,7000,16
TIKI,the-thao-da-ngoai,113919089,"Bình sữa cổ thường Pur Advanced 250ml (1802)",96000,96000,0,0
TIKI,dien-gia-dung,196305556,"Máy hút bụi cầm tay GAABOR GVCC-M4A2 lực hút mạnh 4500pa cắm ô tô dây nguồn dài 4.5m - Hàng chính hãng",149500,299000,149500,50
TIKI,thoi-trang-nu,182729631,"Đầm suông linen tay lỡ cổ phát V, chất vải linen tự nhiên mềm mát, thời trang cho phái nữ Da78",282555,299000,16445,6
TIKI,thoi-trang-nu,175849016,"Vải Áo dài Lá Tre",239000,239000,0,0
TIKI,thoi-trang-nu,70933997,"Áo len nữ dài tay cổ tròn mẫu mới siêu đẹp Haint Boutique al46",179550,189000,9450,5
TIKI,bach-hoa-online,150879592,"Lược chải lông,lược lấy lông rụng chó mèo",36887,36887,0,0
TIKI,thoi-trang-nu,72478789,"Áo 2 Dây cotton Dáng Ôm Cho Nữ",50000,50000,0,0
TIKI,dien-gia-dung,23419025,"Máy hút bụi gia đình, gara xe 12L có thổi và hút bụi khô, ướt",874000,920000,46000,5
TIKI,o-to-xe-may-xe-dap,145398874,"Găng Tay Cụt Ngón Chạy Xe Đạp, Xe Máy MCFK 0101 | Bao Tay Cụt Ngón Thể Thao | Găng Tay Phượt Nam/Nữ - Theyanch Half-Finger Gloves",99000,105000,6000,6
TIKI,dien-gia-dung,48462032,"Nồi Cơm Điện Lock&Lock EJR431 Dung Tích 1 lít (Hàng Chính Hãng)",578000,1200000,622000,52
TIKI,thoi-trang-nam,75945178,"áo hoodie hoạt hình, áo hoodie cute, áo hoodie han quốc, áo hoodie cá tính, áo hoodie nam nữ, áo hoodie nữ, áo hoodie nam, áo hoodie ulzzang, áo hoodie unisex",100000,100000,0,0
TIKI,lam-dep-suc-khoe,128125614,"Combo 6 Băng Vệ Sinh Diana Hàng Ngày Compact Gói 20 Miếng",98000,108000,10000,9
TIKI,thoi-trang-nam,83489010,"Áo Khoác Nam, Khoác Dù Nam 2 lớp phối nón thời trang hàn quốc trẻ trung cuốn hút Thương Hiệu Chandi chất liệu thấm hút mồ hôi dày dặn mặc thoáng mát mẫu M123",143000,299000,156000,52
TIKI,lam-dep-suc-khoe,161368381,"Dung dịch tẩy tế bào chết 2% BHA Paula's Choice Skin Perfecting 2% BHA Liquid Exfoliant",279300,399000,119700,30
TIKI,thoi-trang-nam,26425331,"Dây áo ngực bra cao cấp đính đá hình nơ lấp lánh sang chảnh DA32",95000,95000,0,0
TIKI,bach-hoa-online,20342342,"Cà phê Chế phin 4 Trung Nguyên 500gram",165000,165000,0,0
TIKI,thoi-trang-nam,185863930,"Quần Lót Lọt Khe Chữ Y Ren Mềm Gợi Cảm P489",32000,32000,0,0
TIKI,bach-hoa-online,55525430,"Gạo Lứt Huyết Rồng (Gạo lứt đỏ) - Dùng thích hợp cho người tiểu đường tim mạch huyết áp - Trồng ở ruộng bậc thang ở núi rừng sơn la - Chăm bón tự nhiên",31000,31000,0,0
TIKI,thoi-trang-nam,69988346," Quần Mặc Váy Bigsize",64000,64000,0,0
TIKI,dien-gia-dung,155327128,"Khăn lau thay thế cho robot hút bụi lau nhà Liectroux C30B",30000,30000,0,0
TIKI,thoi-trang-nam,174001966,"Quần Jean nam Leman xanh trơn JD03 - Slim Form",455000,549000,94000,17
TIKI,thoi-trang-nam,177058579,"Áo lót nữ cotton đệm vừa cao cấp AL183 Lylylorem",200000,200000,0,0
TIKI,thoi-trang-nam,67201856,"Set 2 áo ba lỗ nam, áo 3 lỗ nam, sợi cotton mềm mịn, thấm hút mồ hôi tốt, thoáng mát, mặc thoải  mái",36000,36000,0,0
TIKI,thoi-trang-nam,166118146,"Quần gen bụng khóa trước chất su cao cấp Lylylorem QG08",266000,266000,0,0
TIKI,thoi-trang-nam,72747384,"Áo khoác dù nam form rộng",127900,127900,0,0
TIKI,thoi-trang-nu,195291832,"Váy ngủ 2 dâu xuyên thấu phối ren sexy gợi cảm P12a - Đầm ngủ nữ seexy quyến rũ - Đồ ngủ nữ",269000,350000,81000,23
TIKI,dien-gia-dung,44467818,"Máy sấy tóc Panasonic EH-NE81-K645 - tạo ion dòng Ionity - Công suất 2500W - Hàng chính hãng - Đen",1245000,1414800,169800,12
TIKI,the-thao-da-ngoai,70631578,"Set Mũ Len Kèm Khăn Quả Bông Cho Bé",42000,42000,0,0
TIKI,lam-dep-suc-khoe,108928188,"Bộ Sản Phẩm Dưỡng Tóc và Ngăn Rụng Tóc Thiên Nhiên Hoàn Hảo Từ Thorakao: Combo 2 Chai Dầu Gội và Xả Hoa Bưởi 400ml + 1 Chai Lotion Tinh Dầu Bưởi 150ml ",348800,348800,0,0
TIKI,dien-gia-dung,138077200,"Máy Sấy Tóc Pannasonni 3500w 2 Chiều Nóng Mát",56589,56589,0,0
TIKI,the-thao-da-ngoai,76047617,"Ly uống nước có nắp đậy cho bé STENLOCK (Chính hãng Hàn Quốc)",158650,167000,8350,5
TIKI,o-to-xe-may-xe-dap,72555849,"Cuộn Đề Can (Decal) Phản Quang Dán Trang Trí Viền Thân Xe Đạp, Xe Máy, Ô tô An Toàn Ban Đêm Nổi Bật (8 mét) Mai Lee",23000,27000,4000,15
TIKI,thoi-trang-nam,13862233,"Áo khoác nữ thoát nhiệt Nhật Bản Goking 6 túi, áo chống nắng nhẹ, thấm hút mồ hôi, thoải mái vận động",275000,275000,0,0
TIKI,lam-dep-suc-khoe,10278480,"Nước uống collagen giúp sáng da, dạ dày khỏe Blossomy lốc 03 chai x 50ml",165000,165000,0,0
TIKI,cross-border-hang-quoc-te,192413381,"Quần short đùi nam cao cấp TC với thiết kế logo thêu bền đẹp, chất cotton co dãn tốt, năng động, thể thao,thời trang-362",450000,450000,0,0
TIKI,thoi-trang-nam,43951059,"Áo len nữ thời trang kiểu dáng Hàn Quốc",149000,149000,0,0
TIKI,thoi-trang-nam,134390163,"Áo Sơ Mi Nhung Gân Mặt Cười Form Rộng Unisex Nam Nữ Phong Cách Hàn Quốc Ulzzang",137000,137000,0,0
TIKI,lam-dep-suc-khoe,56218973,"Bộ 5 kem đánh răng Colgate ngừa sâu răng răng chắc khỏe 225g/tuýp tặng bàn chải đánh răng lông tơ nhập khẩu Thái Lan",210000,210000,0,0
TIKI,cross-border-hang-quoc-te,177496878,"D110 Label Maker Machine with 1 Roll Printer Paper Portable Bluetooth Thermal Printer for Home Office",834000,834000,0,0
TIKI,lam-dep-suc-khoe,55506863,"Hộp 50 cái khẩu trang y tế 4 lớp VN Number One",30000,30000,0,0
TIKI,the-thao-da-ngoai,145394244,"Khay ăn dặm 5 ngăn Edison Hàn Quốc có đế chống trơn cho bé mã 6872",158000,158000,0,0
TIKI,o-to-xe-may-xe-dap,80850302,"Gối tựa đầu cao xu non sử dụng cho ô tô , xe hơi hàng cao cấp , tựa đầu chống mỏi cổ gáy, thoải mái lái xe",120000,120000,0,0
TIKI,dien-gia-dung,57983571,"Lõi lọc nước Toshiba số 2 F-1686-RO - HÀNG CHÍNH HÃNG",850000,990000,140000,14
TIKI,thoi-trang-nu,61473743,"Áo thun nữ wash Nhật Bản thương hiệu GOKING, 100% cotton thấm hút mồ hôi",155000,155000,0,0
TIKI,lam-dep-suc-khoe,127515106,"Hỗ trợ mọc tóc Natrol Biotin Beauty giúp tóc mọc nhanh dài, dày hơn, làn da rạng rỡ và móng tay chắc khỏe - OZ Slim Store",313000,646000,333000,52
TIKI,thoi-trang-nu,135113413,"áo dài nhung trơn đủ màu kèm quần trung niên",350000,350000,0,0
TIKI,lam-dep-suc-khoe,271299398,"Collagen Neocell Types 1 & 3 Mỹ Hỗ trợ cang da, giảm nhăn da, giúp da, tóc, móng tay và khớp khỏe mạnh từ bên trong ra ngoài - Massel Official",681000,1362000,681000,50
TIKI,lam-dep-suc-khoe,4423491,"Thực Phẩm Chức Năng Dầu Cá Omega 3 Orihiro Nhật Bản 180 Viên",324000,352800,28800,8
TIKI,lam-dep-suc-khoe,112998207,"Son Môi M.O.I Nhung Lì Sgirl SUMMER EDITION Hồ Ngọc Hà (2021)",199000,299000,100000,33
TIKI,thoi-trang-nu,78281774,"Chân váy jeans nữ đơn giản , xinh xắn, dễ phối mọi loại trang phục siêu xinh",84550,89000,4450,5
TIKI,the-thao-da-ngoai,169904349,"Gel thơm khử trùng bồn cầu gel khử mùi bồn cầu dạng thạch hình bông hoa với 6 mùi thơm cho toilet",10000,11500,1500,13
TIKI,dien-gia-dung,191044822,"Quạt Tích Điện Đeo Cổ Không Cánh USB Mini Tiện Lợi Parrot  , Thời Trang, Dáng Thể Thao 3 Tốc Độ Gió Dung Lượng Pin Lớn Sử Dụng 3-6 Giờ",63000,63000,0,0
TIKI,o-to-xe-may-xe-dap,4465541,"Nước diệt kiến sạch kiến sau hai giờ - Hantox 50ml",25999,25999,0,0
TIKI,bach-hoa-online,90982941," CÁT VỆ SINH CHO MÈO CÁT GARDEN LẺ GÓI 2KG",28888,28888,0,0
TIKI,the-thao-da-ngoai,67063506,"QUÂY CŨI KIÊM NHÀ BÓNG HÌNH CHỮ NHẬT",379000,379000,0,0
TIKI,dien-gia-dung,109697407,"Quạt không cánh siêu mát an toàn UML-018 kèm điều khiển từ xa",1299000,1299000,0,0
TIKI,lam-dep-suc-khoe,1600039,"Combo 6 Băng Vệ Sinh Diana Siêu Thấm Siêu Mỏng 0.1 (Gói 8 Miếng)",124000,144000,20000,14
TIKI,lam-dep-suc-khoe,138662376,"Dung dịch vệ sinh Phụ nữ Gel X2 Nano Nghệ Đào Hồng Mềm Mại Lưu Hương 24h Cocayhoala - 150ml",199000,330000,131000,40
TIKI,the-thao-da-ngoai,117218465,"Bô Gấu Hokori Có Ngăn Cho Bé Đi Vệ Sinh Cao Cấp",100000,100000,0,0
TIKI,thoi-trang-nu,185684218,"Đồ bộ ngủ bigsize không mút 2 dây phối ren lưng mã 376",50000,50000,0,0
TIKI,thoi-trang-nam,21029987,"Quần jean thun nữ",300000,300000,0,0
TIKI,bach-hoa-online,59207749,"Kẹo hồng sâm Hàn Quốc Daedong 250g",90000,90000,0,0
TIKI,thoi-trang-nu,192781555,"YU CHERRY | Đầm Mina Cami Dress YD146",350000,350000,0,0
TIKI,lam-dep-suc-khoe,76053234,"Combo 2 Sữa Tắm L'amont En Provence Cherry Blossom (Hoa Anh Đào) Shower Gel 1000ml",480000,480000,0,0
TIKI,thoi-trang-nu,193142944,"Đầm dự tiệc dáng xòe tay dún hàng cao cấp",160000,160000,0,0
TIKI,bach-hoa-online,89763933,"Combo 2 Bịch Cà Phê Sữa NESCAFÉ Cà Phê Sữa Đá (Bịch 25 Gói x 24g)",211000,272000,61000,22
TIKI,thoi-trang-nu,191756961,"[ĐẸP CHẤT] Đầm yếm jean dài cài nút xẻ tà dáng suông mềm mại năng động C082",277000,277000,0,0
TIKI,thoi-trang-nam,87094676,"Bộ bơi đôi dài tay Nam và Nữ, set 3 chi tiết quần dài chống nắng, đồ bơi cho couple, có size nhỏ cho bé mặc đồ gia đình | KT022 | BN022",520000,520000,0,0
TIKI,thoi-trang-nam,207326855,"Đồ gia đình , Áo đi biển , Đồng phục nhóm . Chất liệu vải Cotton loại 1 thoáng mát đủ size từ 8 đến 100kg",45000,45000,0,0
TIKI,dien-gia-dung,51962110,"Combo 9 lõi lọc số 1  PP 20" máy lọc nước ro 50l - Hàng chính hãng",290000,290000,0,0
TIKI,thoi-trang-nam,169621343,"Viettien - Áo sơ mi nam ngắn tay họa tiết vạt bầu 1N1868 regular",395000,395000,0,0
TIKI,bach-hoa-online,175687051,"Combo 2 gói Cà Phê Rang Xay Truyền Thống Highlands Coffee (200g)",126000,150000,24000,16
TIKI,o-to-xe-may-xe-dap,3690599,"Chăn Lưới Chống Ngạt, Thoáng Mát Cho Bé Dùng Quanh Năm Xuất Xứ Thái Lan (75 x 100cm) - Xanh",230000,230000,0,0
TIKI,o-to-xe-may-xe-dap,56441154,"Bộ tranh xếp hình cao cấp 330 mảnh ghép – Khói Lam Chiều",78000,100000,22000,22
TIKI,thoi-trang-nam,25204286,"COMBO 3 QUẦN ĐÙI MẶC TRONG VÁY CAO CẤP- QUẦN LÓT SU DẠNG ĐÙI-CHẤT VẢI ĐẸP MÁT MỊN",79500,79500,0,0
TIKI,thoi-trang-nam,132700179,"Áo Sweater nỉ in chữ Hàn Quốc- Nỉ ngoại dài tay dáng rộng Ulzzang, Áo Nỉ Sweater Chữ Nhật Sô-cô-la Form To Thụng - Áo Nỉ Nam Nữ, áo chui đầu tay dài gấu quần unisex, áo khoác hoodie nam nữ",99000,99000,0,0
TIKI,dien-gia-dung,117837053,"Ấm Siêu Tốc Sunhouse SHD1306 (1.7 Lít) - Hàng Chính Hãng",393000,590000,197000,33
TIKI,dien-gia-dung,13527943,"Van bình áp máy lọc nước",33000,68000,35000,51
TIKI,thoi-trang-nam,137952852,"Đồ ngủ pijama nữ dáng dài tay chất kate thái cao cấp, Bộ quần áo mặc nhà pyjama- pizama HATIBO",170000,170000,0,0
TIKI,dien-gia-dung,142208048,"Cây Trộn Phết Kem Dùng Làm Bánh Thiết Kế Tiện Dụng",18400,20000,1600,8
TIKI,thoi-trang-nu,89479713," Băng Dính Cố Định Vị Trí Áo (fashion tape)",23570,23570,0,0
TIKI,thoi-trang-nam,78523044,"Aó nỉ hoodie full zip ( dây kéo) EGYPTIAN mặc cả thu đông và chống nắng",52000,54800,2800,5
TIKI,lam-dep-suc-khoe,68005401,"Combo 2 Sữa tắm nước hoa dưỡng da Enchanteur Charming 650gr/ Chai",313000,392000,79000,20
TIKI,lam-dep-suc-khoe,116418824,"Gel ngừa mụn Nano THC Decumar 20gr làm sáng da mụn viêm thâm",120000,120000,0,0
TIKI,cross-border-hang-quoc-te,140579763,"QUẦN KAKI NAM NỮ CHẤT VẢI DÀY",229000,229000,0,0
TIKI,o-to-xe-may-xe-dap,25933443,"Bộ 2 Gối Tựa Đầu Ô Tô - Gối Chống Mỏi Cổ Trên Xe Hơi AZONE - Màu Chỉ Đỏ",114000,114000,0,0
TIKI,the-thao-da-ngoai,56441154,"Bộ tranh xếp hình cao cấp 330 mảnh ghép – Khói Lam Chiều",78000,100000,22000,22
TIKI,dien-gia-dung,125659001,"MÁY NƯỚNG BÁNH Magic HÌNH THÚ",197298,197298,0,0
TIKI,thoi-trang-nu,63585201,"Chân váy xòe vải cotton không nhăn họa tiết trái tim VAY81",189000,189000,0,0
TIKI,lam-dep-suc-khoe,24910578,"Son kem lì Bbia Last Velvet Lip Tint Version 3 5g (5 màu)",150000,290000,140000,48
TIKI,thoi-trang-nu,17041690,"Áo khoác đi nắng chống bui, khóa kéo che cổ Phúc An DN0001",143100,143100,0,0
TIKI,cross-border-hang-quoc-te,51202213,"4Pcs/Set PU Leather Sports Golf Club Headcover Wood Putter Driver Head Cover",219000,219000,0,0
TIKI,o-to-xe-may-xe-dap,4282597,"Mũ chắn nước gội đầu cho bé (màu ngẫu nhiên)",12999,12999,0,0
TIKI,bach-hoa-online,21973755,"Thùng 48 Bịch Sữa Dinh Dưỡng Vinamilk Sôcôla (220ml / Bịch)",354000,411000,57000,14
TIKI,o-to-xe-may-xe-dap,42688572,"Máy hút sữa điện đôi Biohealth IE - Sử dụng pin sạc, có chế độ massage và 3 chế độ hút",1370000,1370000,0,0
TIKI,lam-dep-suc-khoe,1687621,"Kem chống muỗi Rohto Metholatum Remos Hương Cam 70g",23100,27000,3900,14
TIKI,dien-gia-dung,166329004,"Quạt không cánh SK có Điều Khiển Từ Xa để bàn hoặc treo tường cao cấp",1849000,1849000,0,0
TIKI,thoi-trang-nam,59556296,"Combo 3 Chiếc Quần Lót Nam Cao Cấp Aristino ABF01807 Chất liệu Cotton Chitosan Thuần Khiết (Giao Màu Ngẫu Nhiên) - Hàng Chính Hãng",255000,315000,60000,19
TIKI,o-to-xe-may-xe-dap,95548246,"Thùng đựng đồ cốp sau ô tô 56 lít, tặng kèm túi lót chứa nước bên trong",144000,144000,0,0
TIKI,thoi-trang-nam,192224123,"Áo thun nữ cổ tim tay dài vải cotton đẹp, dễ mặc dễ phối đồ, mặc bốn mùa",84600,90000,5400,6
TIKI,thoi-trang-nu,52461347,"Chân váy xòe Zarha sang trọng",185000,185000,0,0
TIKI,cross-border-hang-quoc-te,175851291,"Keyboard case with integrated pen holder, detachable, wireless Bluetooth",231000,231000,0,0
TIKI,o-to-xe-may-xe-dap,190468714,"gác để chân sau xe đạp loại cao cấp, bắt thẳng vào sườn xe (nhắn shop để được tư vấn)",39000,50000,11000,22
TIKI,thoi-trang-nam,30696465,"chân váy ren bút chì công sở",125000,125000,0,0
TIKI,thoi-trang-nam,198351229,"Áo sát nách nữ cổ tròn 4LOVA chất lụa satin cao cấp phong cách Hàn Quốc",85000,85000,0,0
TIKI,bach-hoa-online,145461787,"Combo 2 Gói Sữa Béo Nga New Milky Extra 1 Kg Hỗ Trợ Tăng Cân Dùng Được Cho Trẻ Từ Trên 3 Tuổi Và Người Gầy Ốm Hoặc Dùng Pha Trà Sữa, Cà Phê, Làm Bánh",196000,196000,0,0
TIKI,thoi-trang-nam,103215555,"Quần lót ren nữ lọt khe sexy cao cấp",27500,27500,0,0
TIKI,bach-hoa-online,1993063,"Sữa Hạt Hạnh Nhân Không Đường 137 Degrees (Lốc 180ML x 3 Hộp)",83000,83000,0,0
TIKI,thoi-trang-nu,143117503,"Áo lót nữ cotton không gọng đệm mỏng cao cấp, áo lót nữ sinh",68000,105000,37000,35
TIKI,o-to-xe-may-xe-dap,100901845,"Bộ tranh xếp hình 150 mảnh – Spiderman",45000,65000,20000,31
TIKI,dien-gia-dung,184697585,"Máy xay sinh tố công nghiệp Promix PM-819B - 1.5 lít - Hàng Chính Hãng",2795000,2795000,0,0
TIKI,thoi-trang-nam,94654403,"Quần ống rộng jean nữ xám trơn size eo to MS 3072",120000,120000,0,0
TIKI,dien-gia-dung,91864504,"Giắc ổ cắm chuyển đổi đầu 3 chân sang 2 chân nguồn 220V thông thường",20900,41800,20900,50
TIKI,o-to-xe-may-xe-dap,115689068,"Đồ chơi lắp ráp gỗ 3D Mô hình Tháp đồng hồ Big Ben Tower TG507 Kèm đèn LED",239000,299000,60000,20
TIKI,dien-gia-dung,4754633,"Máy Đánh Trứng Philips HR3705 (300W) - Hàng Chính Hãng",725000,797000,72000,9
TIKI,dien-gia-dung,229806089,"Máy Ép Trái Cây, Máy Ép Chậm Cao Cấp KALITE KL-599 Tiêu Chuẩn Châu Âu , Dung Tích 400 ML Công Suất 400 W - Hàng Chính Hãng",4849000,9659000,4810000,50
TIKI,cross-border-hang-quoc-te,85086742,"Áo sơ mi nam cổ trụ dài tay sọc đẹp",159000,159000,0,0
TIKI,lam-dep-suc-khoe,50331044,"Xà phòng rửa tay diệt khuẩn nano bạc Nano Vio 190ml - ít bọt, không triclosan, hương thơm tinh dầu dịu nhẹ",49500,99000,49500,50
TIKI,lam-dep-suc-khoe,911351,"Kem Hỗ Trợ Giảm Mụn Ngừa Thâm Liền Sẹo Ori'be Chiết Xuất Tảo Nâu Từ Pháp Tuýp 20g",55000,55000,0,0
TIKI,thoi-trang-nu,84529116,"ÁO THUN TRƠN CROPTOP TAY NGẮN DÁNG ÔM VẢI XỊN ĐẸP- ảnh thật sp",78000,78000,0,0
TIKI,dien-gia-dung,272420836,"Máy Làm Đá Gia Đình CASO IceMaster Ecostyle 3301 Pro/3304 Icemaster Ecostyle - Nhập Khẩu Đức Cao Cấp, Thời Gian Làm Đá 0.5 Kg/Giờ Dung Tích 2.2 Lít Công Suất 90 W - Hàng Nhập Khẩu",4899000,9759000,4860000,50
TIKI,dien-gia-dung,115519514,"MÁY CẠO RÂU BOLI RSCW 6008 | Máy cạo râu bền rẻ",165000,165000,0,0
TIKI,the-thao-da-ngoai,160879556,"Áo thun bé trai và áo thun bé gái QATE662 - áo thun cho bé trai và áo thun cho bé gái từ sơ sinh đến 18kg",40000,40000,0,0
TIKI,cross-border-hang-quoc-te,95729051,"1 Cặp đệm tai nghe audio-technica ath-m50x",262500,262500,0,0
TIKI,cross-border-hang-quoc-te,112016134,"Quần dành cho nam đi xe đạp 4D có đệm-Màu đen-Size",444100,444100,0,0
TIKI,dien-gia-dung,72637441,"Lò chiên không dầu hấp nướng đối lưu Panasonic NU-SC180BYUE 20 lít - Hàng Chính Hãng",11530000,12530000,1000000,8
TIKI,the-thao-da-ngoai,100901845,"Bộ tranh xếp hình 150 mảnh – Spiderman",45000,65000,20000,31
TIKI,bach-hoa-online,147121169,"Xương Gặm Sạch Răng Cho Chó 7 Dental Effects 03 vị, xương gặm cho chó",10000,10000,0,0
TIKI,thoi-trang-nam,181113990,"Áo polo nam có cổ cao cấp LADOS-9089 thêu đầu hươu, phối 2 màu trắng đen sang trọng, thoáng khí siêu mát mẻ",169000,318000,149000,47
TIKI,thoi-trang-nu,105172727,"BikiniStoreVn : Đồ Bơi Tay Dài Quần Dài S78",410000,410000,0,0
TIKI,thoi-trang-nam,261830575,"Bộ_AM2 (Áo Bà Ba Màu + Quần Đen Rộng)",135000,135000,0,0
TIKI,bach-hoa-online,10409797,"Thùng 24 Lon Cà Phê Sữa Highlands Coffee (185ml/Lon)",292000,312000,20000,6
TIKI,thoi-trang-nu,244332038,"Áo croptop kiểu vạt nhọn cổ vuông vai bồng cộc tay nữ OZENKA , áo crt ôm body phối màu gợi cảm thun cotton dưới 55 cân",79000,79000,0,0
TIKI,thoi-trang-nu,10730888,"Quần Lót Nữ Smoggi Shine Mini Triumph - Trắng (Size",99000,139000,40000,29
TIKI,thoi-trang-nam,75358011,"Big size, short kaki lưng thun unisex, quần sọt nam thương hiêu Amazing, phong cách thể thao",159000,239000,80000,33
TIKI,o-to-xe-may-xe-dap,202606089,"Xe Lắc Nhựa Chợ Lớn hình Chú Ong Con (Có nhạc) - M1786B-X3B",486000,486000,0,0
TIKI,bach-hoa-online,88909435," 500G Khô gà lá chanh + 500G Khô gà bơ tỏi loại cay vừa",145000,145000,0,0
TIKI,o-to-xe-may-xe-dap,51299417,"Áo thun Đội bay siêu đăng bé trai",110000,110000,0,0
TIKI,the-thao-da-ngoai,1508591,"Chất Làm Sạch Bình Đun Nước Mao Bao (2 Gói x 25g)",38000,45000,7000,16
TIKI,lam-dep-suc-khoe,134591513,"Lăn khử mùi dành cho nam Aquaselin 50ml",290000,290000,0,0
TIKI,dien-gia-dung,186756297,"Nồi chiên không dầu hơi nước Elmich 7L AFE-3945 - Hàng chính hãng",3644000,3899000,255000,7
TIKI,dien-gia-dung,444408,"Nồi Áp Suất Điện Tử Philips HD2136 (5 Lít) - Hàng Chính Hãng",2445000,2694000,249000,9
TIKI,bach-hoa-online,6956581,"Ngũ cốc hoa quả Calbee Furugura Nhật Bản gói 800g",135900,135900,0,0
TIKI,lam-dep-suc-khoe,6738207,"Máy Đo Huyết Áp Cổ Tay Omron - HEM-6161",799900,1280000,480100,38
TIKI,thoi-trang-nu,85905324,"Quần lót lọt khe nữ Dây sexy C51",33000,33000,0,0
TIKI,cross-border-hang-quoc-te,34158949,"Áo Sơ Mi Nam Sọc Trắng",99000,99000,0,0
TIKI,dien-gia-dung,176715714,"Quạt Điện Xoay 90 Độ, 3 Chế Độ Gió Model JD-8112 ( điều khiển và không điều khiển)",560000,560000,0,0
TIKI,the-thao-da-ngoai,114264109,"Lều công chúa lều hoàng tử cao cấp cỡ đại cho bé",204000,204000,0,0
TIKI,thoi-trang-nu,118022753,"Đồ Lam Đi Chùa # Bà Lai 2 Túi Áo # Đồ Bộ # Quần Áo Nữ",157000,157000,0,0
TIKI,o-to-xe-may-xe-dap,40752351,"Combo 5 bịch khăn vải khô đa năng Mama (bịch 240 tờ)",249000,249000,0,0
TIKI,dien-gia-dung,42617248,"Phụ kiện kết nối bộ lọc thô, lọc sinh hoạt 10 inch ren phi 21",101000,115000,14000,12
TIKI,thoi-trang-nu,142994727,"Áo croptop tay dài ôm body nữ cải màu , áo thun croptop nữ chất đẹp 100% cotton free size dưới 52 kg nhiều màu",60500,60500,0,0
TIKI,thoi-trang-nu,72606150,"Váy ngủ lụa xẻ người dây buộc hông",99000,99000,0,0
TIKI,thoi-trang-nam,14450071,"Quần Bò Nam Đen Rách Gối RACHGOI97 (Rách Gối)",168000,168000,0,0
TIKI,o-to-xe-may-xe-dap,16201969,"Túi treo đầu ghi đông xe máy xem điện thoại, chứa đồ",77000,77000,0,0
TIKI,cross-border-hang-quoc-te,188976683,"CAMEL CROWN Đèn Cắm Trại Ngoài Trời Đèn Lồng LED Sạc Trực Tiếp USB Cầm Tay Cắm Trại Chống Nước",1761000,1761000,0,0
TIKI,cross-border-hang-quoc-te,52311502,"Áo Khoác Cao Cấp, Áo Khoác Kaki Nam Hàn Quốc",163000,163000,0,0
TIKI,bach-hoa-online,4986577,"Bột trà xanh Funmatsucha Yanoen 100gr",108000,108000,0,0
TIKI,dien-gia-dung,34438039,"Dàn giải nhiệt - Hàng chính hãng",380000,380000,0,0
TIKI,o-to-xe-may-xe-dap,169904349,"Gel thơm khử trùng bồn cầu gel khử mùi bồn cầu dạng thạch hình bông hoa với 6 mùi thơm cho toilet",10000,11500,1500,13
TIKI,bach-hoa-online,107018074,"Bánh Quy Quasure Light Sữa hộp 140 gram Bibica - thực phẩm dành cho người ăn kiêng, tiểu đường",30400,30400,0,0
TIKI,dien-gia-dung,11259209,"Ấm Sắc Thuốc Gốm Bát Tràng Fujika FJ-Ck33K6 (3.3L) - Hàng chính hãng",290700,290700,0,0
TIKI,o-to-xe-may-xe-dap,74552910,"Bóng led H4 tích hợp bi cầu mini có COS - PHA",55000,55000,0,0
TIKI,lam-dep-suc-khoe,70052293,"Combo máy khuếch tán/ máy xông tinh dầu Lorganic bình hoa FX2057 + tinh dầu bạch đàn chanh Lorganic (10ml) LGN0366",600000,600000,0,0
TIKI,the-thao-da-ngoai,115689068,"Đồ chơi lắp ráp gỗ 3D Mô hình Tháp đồng hồ Big Ben Tower TG507 Kèm đèn LED",239000,299000,60000,20
TIKI,dien-gia-dung,159885560,"Máy Xay Sinh Tố Philips HR2041/30 (450W) - Hàng Chính Hãng",785000,846000,61000,7
TIKI,thoi-trang-nu,101686465,"Áo vest Linen blaze nữ ve vuông dáng lửng tay dài ArcticHunter, thời trang hè thu 2021",280000,280000,0,0
TIKI,bach-hoa-online,55097144,"1Kg Khô Gà Lá Chanh Loại Ngon Thương Hiệu SK FOOD",145000,145000,0,0
TIKI,cross-border-hang-quoc-te,59222616,"Solid CornHole Toss Game Set and 8 Pieces Cornhole Bean Bag Pouch Toss Toy for Family Parties Kindergarten",764000,764000,0,0
TIKI,bach-hoa-online,106521724,"Cà phê hòa tan Nescafé Latte sữa hạt vị hạnh nhân (Hộp 10 gói x 24g) - [BAO BÌ MỚI]",67000,80000,13000,16
TIKI,thoi-trang-nam,196603717,"Quần tây nam 0Ply Novelty màu đen Regular fit NQTMMDNTRR2202880",479000,479000,0,0
TIKI,o-to-xe-may-xe-dap,139001015,"Gạt mưa Silicone UP nhiều SIZE cho các dòng xe phổ biến tại Việt Nam",88000,88000,0,0
TIKI,dien-gia-dung,111857961,"MÁY DUỖI TÓC TOKYO 100% CAO CẤP",390000,390000,0,0
TIKI,dien-gia-dung,8073003,"Bàn Ủi Hơi Nước không dây Bluestone SIB-3854 (2400W) - Hàng chính hãng",846000,899000,53000,6
TIKI,lam-dep-suc-khoe,59130762,"Lược Tròn Tạo Phồng ,Uốn Cụp Kiểu Hàn Quốc- Đa Năng",22000,30000,8000,27
TIKI,thoi-trang-nu,7595772,"Áo Sơ Mi Nữ Sọc Cổ Đổ MS0106A",170000,170000,0,0
TIKI,lam-dep-suc-khoe,68250779,"Cà Gai Leo Xạ Đen - Viên Uống Bổ Gan, Giải Độc Gan, Tăng Cường Chức Năng Gan (Hộp 60 Viên)",185000,185000,0,0
TIKI,bach-hoa-online,88914850,"[COMBO 2 HŨ] DA CÁ HỒI LẮC TRỨNG MUỐI GIÒN NGON - MỖI HŨ 200G",105000,125000,20000,16
TIKI,thoi-trang-nam,92807600,"Quần short kaki Amazing, lưng thun có giây rút, vải kaki dày dặn, co giãn nhẹ, nhiều màu, có size lớn",159000,239000,80000,33
TIKI,cross-border-hang-quoc-te,126022275,"Sách - Discourses and Selected Writings by Epictetus - (UK Edition, paperback)",386000,386000,0,0
TIKI,dien-gia-dung,53655362,"Máy tạo bọt cafe, sữa cầm tay MFB1501D dung lượng pin 1200mAh",87856,87856,0,0
TIKI,lam-dep-suc-khoe,8729465,"Tẩy Tế Bào Da Chết Chiết Xuất Từ Than Hoạt Tính ARRAHAN CHARCOAL PEELING GEL (180ml)",62000,62000,0,0
TIKI,bach-hoa-online,140843423,"Dầu Tắm Trị Bọ Chét, Ve, Ghẻ, Rận Chó Mèo Hanvet Hantox 200ml",35555,35555,0,0
TIKI,lam-dep-suc-khoe,15149797,"Bàn Lăn Chân Gỗ Massage 6 Hàng ( 31 X 24 X 10 Cm)",178000,178000,0,0
TIKI,lam-dep-suc-khoe,12084496,"Gel Rửa Mặt Trị Mụn Loại Bỏ Nhờn Ngừa Mụn Eucerin (200ml)",276000,369000,93000,25
TIKI,dien-gia-dung,19241570,"Nồi Tiềm Nấu Cháo Chậm Kho Cá Hầm Chưng Yến Đa Năng NK Media (2,5 lít) - Màu Ngẫu Nhiên - Hàng Chính Hãng",243000,250000,7000,3
TIKI,dien-gia-dung,253498875,"Bộ Lọc Thay Thế Pureit Ultima 1 - Hàng Chính Hãng",1187500,1250000,62500,5
TIKI,bach-hoa-online,75621224,"NHO VÀNG SẤY KHÔ TÂN LỘC PHÁT COMBO 2 HŨ - MỖI HŨ 500G",92000,159000,67000,42
TIKI,bach-hoa-online,125918663,"Tương ớt Cholimex chai pet 270g",12400,12400,0,0
TIKI,dien-gia-dung,187812590,"Máy sấy tóc Philips BHD500/00 - Sấy tóc nhanh khô - Bảo vệ tóc không bị quá nóng - Hàng Chính Hãng",1095000,1095000,0,0
TIKI,thoi-trang-nam,110801615,"Đầm dự tiệc bo eo cánh dơi sang trọng - nhiều size, form dáng chuẩn thích hợp mặc đi làm, đi tiệc",250000,250000,0,0
TIKI,o-to-xe-may-xe-dap,75554546,"Kẹp Đèn Pin Xe Đạp, Kẹp Giữ Đèn Pin Gắn Ghi Đông Cho Xe Đạp Thể Thaom Leo Núi Lắp Đặt Dễ Dàng Mai Lee",35000,49000,14000,29
TIKI,o-to-xe-may-xe-dap,35457234,"Dung Dịch Tẩy Nhựa Đường, Keo Băng Dính SONAX Tar remover 334200 (300ml)",170000,170000,0,0
TIKI,dien-gia-dung,31252976,"Bếp Nướng Điện Nagakawa NAG3101 (1650W) - Hàng Chính Hãng",827000,1090000,263000,24
TIKI,lam-dep-suc-khoe,75436781,"Son kem lì Bbia Last Velvet Lip Tint Version 8 5g (5 màu)",150000,290000,140000,48
TIKI,the-thao-da-ngoai,50793298,"Gấu Bông Heo Lười Mắt Híp Có 5 Kích Thước 2 Màu",69000,69000,0,0
TIKI,o-to-xe-may-xe-dap,6288513,"Nhớt liqui Moligen 5W40 dành cho xe ga",265000,265000,0,0
TIKI,bach-hoa-online,70666592,"Miso hữu cơ Marukome 375g",145040,148000,2960,2
TIKI,bach-hoa-online,154698868,"Kẹo hương dâu tây L'angfarm, 350g, bịch, mẫu kraft 1 mặt trong",36000,36000,0,0
TIKI,thoi-trang-nam,57318339,"Đầm Dạ Hội Trọng MS 122",339440,339440,0,0
TIKI,o-to-xe-may-xe-dap,67063506,"QUÂY CŨI KIÊM NHÀ BÓNG HÌNH CHỮ NHẬT",379000,379000,0,0
TIKI,thoi-trang-nu,163574291,"Quần Short Lưng Cao Vải Nhung Thời Trang Cá Tính Cho Nữ (không kèm thắt lưng)",70000,70000,0,0
TIKI,bach-hoa-online,173299475,"Chai Xịt Ve Rận Chó Mèo Vime-Frondog 250ml",120000,120000,0,0
TIKI,bach-hoa-online,53315759,"Natural Điều đỏ bột 50gr - Bột điều đỏ nguyên chất 100%",16000,16000,0,0
TIKI,the-thao-da-ngoai,74190242,"Xe Trượt Scooter Trẻ Em Có Ghế Gấp Gọn 3 Bánh Phát Sáng, Có Nhạc Và Đèn Báo, Dành Cho Bé Từ 2-12 Tuổi",215000,263900,48900,19
TIKI,bach-hoa-online,57304713,"Cà phê bột 100% nguyên chất truyền thống số 3 Coffee Tree 500gr thơm ngon, đậm đà, gu mạnh (Cà phê) ",116000,209000,93000,44
TIKI,cross-border-hang-quoc-te,184412812,"Quick Release Plate Clamp for Camera Tripod with 2x Spirit Level Plate Mount Adapter",361000,361000,0,0
TIKI,lam-dep-suc-khoe,55108911,"Combo 2 Sữa Tắm Rose 500ml- L'amont En Provence",189000,298000,109000,37
TIKI,lam-dep-suc-khoe,186633014,"Tinh Dầu Sả Chanh Tự Nhiên Nguyên Chất 10ml Hapaku",109000,120000,11000,9
TIKI,lam-dep-suc-khoe,25444067,"Son kem lì Bbia Last Velvet Lip Tint - 25 Final Note 5g (màu cam nâu đất)",150000,290000,140000,48
TIKI,lam-dep-suc-khoe,78983485,"Combo 3 Kem đánh răng Closeup Trắng Răng Tự Nhiên Acai Berry detox 230 g",123000,153000,30000,20
TIKI,lam-dep-suc-khoe,28517939,"Viên uống Tinh Chất Hàu biển OB - Tăng cường sinh lý nam, Bổ Thận, Tăng Chất Lượng Tinh Trùng, hộp 30v",329000,379000,50000,13
TIKI,lam-dep-suc-khoe,20365497,"Dụng cụ massage Mũi xuất Nhật , nâng mũi tự nhiên, cánh mũi thon gọn SLine hotgirl",9000,9000,0,0
TIKI,lam-dep-suc-khoe,7331189,"Son Dưỡng Môi DHC Lip Cream 1,5g",182000,199000,17000,9
TIKI,lam-dep-suc-khoe,57855825,"Kem Nền Che Khuyết Điểm Kiềm Dầu Mịn Nhẹ Chống Nắng DD Cream Oribe 25g",280000,320000,40000,13
TIKI,lam-dep-suc-khoe,6583921,"Combo Sữa Tắm L'amont En Provence Shower Gel Hương Almond + Olive (500ml / Chai)",175000,280000,105000,38
TIKI,lam-dep-suc-khoe,158091977,"Tinh Dầu Hoa Nhài TIDAMO 100ML Nhập Khẩu, Có Kiểm Nghiệm, Hương Thơm Dịu Nhẹ Quý Phái - Tinh Dầu Hoa Lài (Jasmine) Xông Thơm Phòng, Thư Giãn và Tốt Cho Sức Khỏe",193800,398000,204200,51
TIKI,lam-dep-suc-khoe,153597872,"Son thỏi dưỡng môi trang điểm chất son satin Lip On Lip Glowy Satin 2.2g",134000,166000,32000,19
TIKI,lam-dep-suc-khoe,48209944,"Bộ sản phẩm tan mỡ bụng an toàn và hiệu quả Truesky gồm 1 kem tan mỡ bụng quế gừng 100g + 1 đại nịt bụng quấn nóng",250000,250000,0,0
TIKI,lam-dep-suc-khoe,50308042,"Goodhealth Oyster Plus Tinh Chất Hàu 60 Viên - Tăng Cường Sinh Lý - Cải Thiện Chất Lượng Tinh Trùng - Hàng Chính Hãng New Zealand",348000,499000,151000,30
TIKI,lam-dep-suc-khoe,102751945,"Dầu gội Head&shoulders Clinical Strength Proven Relief 400ml - USA",299000,299000,0,0
TIKI,lam-dep-suc-khoe,460386,"Sữa Tắm Lifebuoy Sạch Khuẩn Chăm Sóc Da Ngăn Ngừa Vi Khuẩn Lây Lan Với Ion Bạc+ Hỗ Trợ Cùng Đề Kháng Da Tự Nhiên Túi 800G",119000,119000,0,0
TIKI,lam-dep-suc-khoe,184042484,"Combo Sữa Rửa Mặt và Serum Mugung Dưỡng da 24k xóa thâm nám chống lão hóa chứa Vitamin C,E, collagen",400000,400000,0,0
TIKI,lam-dep-suc-khoe,12056666,"Lăn Khử Mùi Etiaxil Detranspirant Traitement Aisselles Peaux Normales 15ml (Dành cho da thường)",179000,179000,0,0
TIKI,lam-dep-suc-khoe,2623229,"Sữa Rửa Mặt SVR Sebiaclear Gel Moussant  (50ml)",108000,145000,37000,26
TIKI,lam-dep-suc-khoe,74593902,"ComBo 10 Chiếc Khẩu Trang Trẻ Em KF94 - Form 3D Cao Cấp Chống Bụi Siêu Mịn 0.4um Anyguard Hàn Quốc Chính Hãng - 4 Lớp - 베이비 마스크 - Face Mask For Kids-ISO 9001:2015, ISO 13485:2016, QCVN 01:2017/BTC",59500,85000,25500,30
TIKI,lam-dep-suc-khoe,138773725,"￼Bộ 4 lô Cuốn Tóc Xoăn Dính loại lớn, giá tốt - giao màu ngẫu nhiên ",30000,40000,10000,25
TIKI,lam-dep-suc-khoe,33761260,"Bao Cao Su Kéo Dài Thời Gian Quan Hệ và Có Gai Innova Đen - Hộp 3 Cái",39000,39000,0,0
TIKI,the-thao-da-ngoai,162993100,"Phao Câu Đài Đổi Màu Thông Minh Phao Câu Điện Câu Đêm Chất Lượng",70500,70500,0,0
TIKI,lam-dep-suc-khoe,75639107,"Nước súc miệng hàng ngày chiết xuất thiên nhiên giúp Ngăn ngừa vi khuẩn Ngăn ngừa màng bám Cải thiện viêm nướu, viêm nha chu AMFAGOLD Care DAILY USE 250ml",75000,75000,0,0
TIKI,lam-dep-suc-khoe,177424215,"Cân Điện Tử Sức Khoẻ Thông Minh Mặt Vuông Kính Cường Lực Chịu Lực Màu Đen Sang Trọng 180Kg Deli - Phù Hợp Gia Đình Trường Học - Hàng Chính Hãng - E86120",159000,322200,163200,51
TIKI,lam-dep-suc-khoe,36158810,"Bộ tắm trắng toàn thân Truesky gồm 1 kem ủ trắng toàn thân 100g và 1 kem dưỡng trắng toàn thân 100g",320000,320000,0,0
TIKI,the-thao-da-ngoai,2156903,"Găng tay chống nắng xỏ ngón Aqua-X Let's Slim",34000,38000,4000,11
TIKI,the-thao-da-ngoai,96609743,"Xà đơn gắn cửa treo tường KN-2021 có khóa chống xoay + Nivo cân bằng xà",359000,359000,0,0
TIKI,lam-dep-suc-khoe,12114846,"Xịt họng thảo dược giúp giảm ho, đau rát họng EUGICA MOUTH SPRAY (Chai/10ml)",58000,65000,7000,11
TIKI,the-thao-da-ngoai,144403972,"Đệm Mút Lót Hỗ Trợ Gánh Tạ Squad",115000,115000,0,0
TIKI,the-thao-da-ngoai,164552238,"Khung Nắn Chỉnh Cột Sống, Khung Định Hình Cột Sống, Giảm Thoát Vị Đĩa Đệm, Đau Lưng, Vai Gáy, Dụng Cụ Hỗ Trợ Tập Lưng - Chính Hãng PaKaSa",126000,156000,30000,19
TIKI,the-thao-da-ngoai,16202868,"Khăn trải thảm tập YOGA màu xanh lá",119000,119000,0,0
TIKI,lam-dep-suc-khoe,118896592,"Nến thơm tinh dầu cao cấp không khói an toàn Candle Cup - ĐÀ LẠT - S - 100G (KG NẮP)",120000,120000,0,0
TIKI,the-thao-da-ngoai,262017414,"Dây nhảy tập thể lực  Gym ,Boxing , Muay Thái , Tay cầm hợp kim nhôm chống trượt  , dây PVC cao cấp Màu Cam Cleacco - Chính hãng BORO SPORT",138000,299000,161000,54
TIKI,lam-dep-suc-khoe,161451877,"Dung dịch vệ sinh mũi Nose Hygiene Spray",85000,85000,0,0
TIKI,lam-dep-suc-khoe,2075159,"Gel hỗ trợ điều trị Mụn Thâm Neocurma (20g)",118000,118000,0,0
TIKI,the-thao-da-ngoai,131338681,"Bộ 2 Băng Ngón Tay Bóng rổ bảo vệ ngón tay",25000,25000,0,0
TIKI,lam-dep-suc-khoe,1313877,"Kem chống nắng Sunplay cho bé từ 6 tháng tuổi và da nhạy cảm, dạng sữa Sunplay Baby Mild SPF 35, PA++ 30g",79000,97000,18000,19
TIKI,the-thao-da-ngoai,139055583,"Nút Tai Chống Ồn chống Âm 2 Tầng Dùng Bơi Lội",19000,19000,0,0
TIKI,the-thao-da-ngoai,57696898,"Tất bảo vệ ống đồng, bắp chân GoodFit GF601C",99000,150000,51000,34
TIKI,the-thao-da-ngoai,15363751,"Áo Phao Cứu Hộ Thắng Lợi A86",72000,80000,8000,10
TIKI,lam-dep-suc-khoe,176571783,"Hoạt huyết dưỡng não - Hộp 100 viên bao đường - tuần hoàn não, Dược Đại Uy, từ đinh lăng, bạch quả",15000,49000,34000,69
TIKI,the-thao-da-ngoai,28735724,"Dụng cụ hỗ trợ tập lưng giúp giảm đau lưng FLO001",180000,285000,105000,37
TIKI,lam-dep-suc-khoe,2835905,"MỠ TRĂN NGUYÊN CHẤT 100ml triệt lông, bôi bỏng",88888,99000,10112,10
TIKI,the-thao-da-ngoai,92094369,"Mồi câu cá rô phi siêu cấp",25000,25000,0,0
TIKI,the-thao-da-ngoai,189467850,"Giày đá bóng trẻ em PROWIN H21 KID Vàng chính hãng, giày đá banh cỏ nhân tạo đẹp - HK005",305000,305000,0,0
TIKI,the-thao-da-ngoai,163748376,"Rọng Đựng Cá 7 Màu Túi Đựng Cá Khung Kim Loại, Phụ Kiện Câu Đài",131000,131000,0,0
TIKI,the-thao-da-ngoai,114011155,"Dây cao su kháng lực tập mông miniband hỗ trợ tập mông - Độ mông trái đào",14850,16000,1150,7
TIKI,lam-dep-suc-khoe,49310524,"Combo 2 tuýp  kem ngăn ngừa mụn thiên nhiên yoosun acnes  15g - XẸP MỤN NGAY, BAY THÂM SẸO ",79800,79800,0,0
TIKI,lam-dep-suc-khoe,654647,"Nước uống giải rượu, thải độc gan Alcofree lốc 3 chai x 50ml",125000,141000,16000,11
TIKI,lam-dep-suc-khoe,41523006,"Máy đo huyết áp điện tử bắp tay Sinoheart BA-801 Đức",255000,325000,70000,22
TIKI,the-thao-da-ngoai,117589269,"Dụng cụ kéo giãn đốt sống cổ loại móc treo DKDC.MT01, hỗ trợ thoái hóa đốt sống cổ",149000,149000,0,0
TIKI,the-thao-da-ngoai,158853976,"Quần Đạp Xe Đạp Bigbull Gel 3D KX | Quần Lót Đệm Đạp Xe Đạp Lót Đệm Gel Chống Ẩm Thấm Hút Mau Khô - Thoáng Khí Co Dãn 4 Chiều Khô Thoáng  - Chọn Size kích thước phù hợp",157000,157000,0,0
TIKI,the-thao-da-ngoai,53775578,"Thảm Tập Yoga,Thảm Tập Gym  TPE 6mm  Chống Trượt 1 lớp cao cấp  TT8005",99990,136653,36663,27
TIKI,the-thao-da-ngoai,176049925,"Kìm Bóp Tay, Dụng Cụ Kềm Tập Cơ Tay Cổ Tay Tập Gym Tại Nhà Phục Hồi Chứ Năng Dobetters Giá Rẻ K163",12000,12000,0,0
TIKI,the-thao-da-ngoai,83604156,"Găng Tay Tập Gym Thể Thao Glofit GFST019 - DIAMOND (Workout Gloves) Dòng Găng Tay Hở Ngón Cao Cấp Chính Hãng Glofit Đầy Trẻ Trung Năng Động",345000,450000,105000,23
TIKI,the-thao-da-ngoai,104902028,"Bộ quần áo thi đấu bóng rổ Los Angeles Lakers - Set đồ bóng rổ Lakers - Bộ đồ bóng rổ NBA",136000,259000,123000,47
TIKI,lam-dep-suc-khoe,114467131,"Bộ dụng cụ lấy ráy tai chuyên nghiệp,dụng cụ lấy ráy tai người lớn,dụng cụ lấy ráy tai thông minh cho bé kèm dây đeo BaoAn- Nhiều mẫu lựa chọn -Hàng Chính Hãng - Màu hộp giao ngẫu nhiên",55900,69000,13100,19
TIKI,the-thao-da-ngoai,263495436,"Găng tay tập gym hở mu bàn tay  Cleacco SKDK   , thoáng khí , đệm lòng bàn tay chắc chắn - Hàng chính hãng BORO SPORT",119000,201000,82000,41
TIKI,the-thao-da-ngoai,193137977,"Đai Cuốn Bảo Vệ Khuỷu Tay - Đai Dán Khuỷ Tay hỗ trợ tập gym - Màu đen - Hiệu SUNUGY",49000,125000,76000,61
TIKI,the-thao-da-ngoai,22604861,"Dép trượt patin trẻ em JUNMA",221000,229000,8000,3
TIKI,lam-dep-suc-khoe,190630654,"Sữa Rửa Mặt Dịu Nhẹ Cho Da Khô CeraVe SA Smoothing Cleanser 236ml",313000,330000,17000,5
TIKI,lam-dep-suc-khoe,7222235,"Kem chống nắng đa năng siêu nhẹ không bết dính Paula’s Choice Resist Super -Light Daily Wrinkle Defense SPF30 60ml",759000,950000,191000,20
TIKI,the-thao-da-ngoai,32426089,"Dụng cụ tập cơ lưng, hỗ trợ điều trị thoái hóa khớp, thoát vị đễ đệm, đau lưng và mỏi vai gáy (Màu ngẫu nhiên)",52249,54999,2750,5
TIKI,the-thao-da-ngoai,61479584,"Máy câu cá AR - Kim loại - Siêu bền - Chất lượng cao cấp - Tặng kèm cước  MC09",269000,269000,0,0
TIKI,the-thao-da-ngoai,23308733,"Đai Chạy Bộ Đa Năng",32670,47190,14520,31
TIKI,lam-dep-suc-khoe,173401401,"Máy Khuếch Tán Tinh Dầu Có Loa Bluetooth Nghe Nhạc Cực Hay, Máy Xông Tinh Dầu Chuyên Dụng, Có Remote Điều Khiển Và Đèn LED 7 Màu",287300,668000,380700,57
TIKI,the-thao-da-ngoai,105026886,"Gạch tập Yoga xốp Eva in hoa mandala 200g",48000,48000,0,0
TIKI,the-thao-da-ngoai,270452910,"[SIÊU GỌN] PARALLETTES GỖ - DỤNG CỤ HÍT ĐẤT, CHỐNG ĐẨY BẰNG GỖ THÔNG (bản thấp)",140000,140000,0,0
TIKI,the-thao-da-ngoai,113406280,"Chì Câu Cá 30 Đến 50Gr (Chì Hình Chuông)",30800,30800,0,0
TIKI,the-thao-da-ngoai,77674140,"Băng quấn bảo vệ cổ tay AOLIKES YE-7930 Sport wrist protector",124000,209000,85000,41
TIKI,the-thao-da-ngoai,170137056,"Bộ đồ chơi tập đấm bốc boxing chuyên nghiệp cho trẻ em",199996,199996,0,0
TIKI,the-thao-da-ngoai,129035292,"Dây nhảy lõi thép Cao Cấp luyện tập thể lực  tự động đếm số - đếm giờ - tích hợp đo calo - quãng đường - Hàng Chính Hãng",125000,125000,0,0
TIKI,the-thao-da-ngoai,141265817,"Còi trọng tài ( bóng đá, bóng rổ, bóng chuyền) FOX80 - FOX40",40000,40000,0,0
TIKI,the-thao-da-ngoai,159725236,"Kính bơi trẻ em Zoggs Phantom Elite Mirror Junior - 311591",495000,495000,0,0
TIKI,lam-dep-suc-khoe,114230314,"Kem hỗ trợ giảm mụn Differin Cream 0.1% Adapalene tuýp 30 gram(Hàng nội địa Pháp)",299000,450000,151000,34
TIKI,the-thao-da-ngoai,33338356,"Găng Tay Tập GYM Hở Mu Bàn Tay Lifting Grips Aolikes Pro AL7639",109000,109000,0,0
TIKI,the-thao-da-ngoai,12282424,"Nón bơi mũ bơi Silicon che tai CQ (Dòng cao cấp)",69000,120000,51000,43
TIKI,the-thao-da-ngoai,83406761,"Cán vợt cá, cán gắn móc cỏ, cào lục bình Inox đầu ren trong 8ly dài 1m5 đến 6m có thể thu gọn",65000,65000,0,0
TIKI,lam-dep-suc-khoe,92159183,"Combo 2 hộp Bao cao su Durex Fetherlite Ultima 12 Bao",438000,608000,170000,28
TIKI,the-thao-da-ngoai,183728995,"Túi Đựng Đồ Bơi Tiện Lợi Size 42x32CM Kiểu Thời Trang Chống Thấm Nước TB002 MayHomes Màu Ngẫu Nhiên",41400,45000,3600,8
TIKI,phu-kien-thoi-trang,138897793,"Set cài áo ngọc trai 7 món mẫu mới ( hàng có sẵn )",29999,29999,0,0
TIKI,phu-kien-thoi-trang,150931284,"Dây nịt nữ co giãn thắt lưng bản to khóa cá tính",89000,89000,0,0
TIKI,phu-kien-thoi-trang,119104367,"Tất hài nữ Lali Hàn Quốc siêu dai, 1 đôi",3000,3000,0,0
TIKI,phu-kien-thoi-trang,137301180,"500G Chun buộc tóc, nịt buộc tóc màu đen , nhiều màu",10000,10000,0,0
TIKI,phu-kien-thoi-trang,139449862,"Thắt lưng Nam vải dù_Tushi_khóa tự động sang trọng_tiện lợi, Thắt lưng lính vải bố_siêu bền đẹp",139000,139000,0,0
TIKI,phu-kien-thoi-trang,197574767,"Nón CLB MU logo đỏ fom trucker vuông quai cài nút chất đẹp đứng fom",195000,195000,0,0
TIKI,phu-kien-thoi-trang,209899170,"Kính áp tròng màu dùng 1 ngày Clalen Iris (Hàn Quốc) - 1 Miếng",25000,30000,5000,17
TIKI,phu-kien-thoi-trang,124911307,"Mũ lưỡi trai thêu chữ SECOND THOUGHT nhiều màu- Nón kết nam nữ",46000,46000,0,0
TIKI,phu-kien-thoi-trang,158756303,"Khẩu trang nhựa dẻo VN68 - Màu đen, thời trang đi mưa, tái sử dụng nhiều lần",75000,75000,0,0
TIKI,phu-kien-thoi-trang,162048012,"Dây Thun Cột Tóc Co Giãn Cho Bạn Gái",5300,5300,0,0
TIKI,dong-ho-va-trang-suc,74494910,"Bó 10-20m dây vải dù 0.8mm đan vong đủ màu - Bó dây vải dù 0.8mm handmade Ngọc Quý Gemstones",11500,23000,11500,50
TIKI,dong-ho-va-trang-suc,22369367,"Vòng Điều Hoà Huyết Áp Taka sku01(vòng nữ)",695000,695000,0,0
TIKI,phu-kien-thoi-trang,90870188,"KÍNH ĐỔI MÀU TRÒNG KÍNH GỌNG TITAN DẺO BẺ KHÔNG GÃY",119000,119000,0,0
TIKI,phu-kien-thoi-trang,54562958,"Kính mát chữ V nam nữ gọng tròn mắt mèo phong cách Hàn Quốc bảo vệ mắt chống tia UV",47500,50000,2500,5
TIKI,dong-ho-va-trang-suc,204038971,"Vòng tay tỳ hưu đồng phong thủy trầm hương HÀ XÁ đeo tay cặp đôi nam nữ may mắn tài lộc",199000,398000,199000,50
TIKI,ngon,179711694,"[Chỉ giao HN] - Túi mix 04 loại hạt cao cấp ((óc chó, hạnh nhân, macca, hạt điều) - 500gr",290000,290000,0,0
TIKI,ngon,117028550,"[ Chỉ giao HN]- Sườn không cục thịt heo 1kg",220000,220000,0,0
TIKI,phu-kien-thoi-trang,8294415,"Bộ 5 đôi tất lười, tất thuyền dấu gót, tất có silicon cho nữ P4W5",250000,250000,0,0
TIKI,phu-kien-thoi-trang,52250449,"Tóc giả nữ ngắn trung niên 601 ❤️FREESHIP❤️ tóc trung niên nữ ngắn, tóc giả trung niên, trung niên tóc giả, tặng lưới chụp",150000,150000,0,0
TIKI,phu-kien-thoi-trang,186550355,"Mũ lưỡi trai phối lưới phong cách ullzang cá tính, Nón kết thời trang NKL",99000,99000,0,0
TIKI,tui-vi-nu,66654552,"dây xích kim loại, quai túi xách, dây túi 2 loại ngắn40cm và dài 120cm",33000,33000,0,0
TIKI,ngon,157856149,"[ Chỉ giao HN] - Bánh Chưng Nương Bắc Xanh thịt 800gr",190000,190000,0,0
TIKI,dong-ho-va-trang-suc,81318056,"Đồng Hồ Nam Dây Thép Lưới Đen ECONOMICXI Chính Hãng Đường Kính Mặt 40mm Có lịch Ngày - Phong Cách Doanh Nhân ECNT36",278000,278000,0,0
TIKI,tui-vi-nu,54430952,"Túi xách nữ cao cấp phong cách châu âu hiện đại mới",275000,275000,0,0
TIKI,tui-vi-nu,58230324,"Túi bao tử nữ đeo chéo trước ngực, đeo hông",53460,73062,19602,27
TIKI,dong-ho-va-trang-suc,156262628,"Nước rửa trang sức bạc PDJ - Trang sức PDJ  - dung tích 120ml",70000,70000,0,0
TIKI,phu-kien-thoi-trang,183290816,"Set 5 Đôi Vớ Nữ Cổ Ngắn Họa Tiết Nhiều Màu, Tất Cổ Ngắn Nữ Sử Dụng Cả Tuần - CB082",39000,50000,11000,22
TIKI,giay-dep-nu,201671944,"Giày cao gót nữ 9pRO374 thời trang nữ cao cấp ROSATA tại BCASHOP mũi nhọn, quai ngang, gót vuông - màu Nude",499000,499000,0,0
TIKI,may-anh,35585960,"KN-H21PW",1300002,1300002,0,0
TIKI,dong-ho-va-trang-suc,10597090,"Bông tai nam Titan cao cấp chonmua365",45000,45000,0,0
TIKI,tui-vi-nu,173167924,"Túi vải bố, Túi vải Canvas trơn Màu Trắng - Màu Đen không khóa kéo",19000,19000,0,0
TIKI,dong-ho-va-trang-suc,54717885,"Pin Đồng Hồ Maxell Nhiều Kích cỡ Vỉ 5 viên",55000,55000,0,0
TIKI,ngon,144934460,"[ Chỉ giao HN] - Chân gà mái Đông Tảo loại 3 -1kg (11-12 cái/kg)",590000,590000,0,0
TIKI,dong-ho-va-trang-suc,208645115,"Dây silicon khóa nam châm ngàm cong 20mm dành cho đồng hồ thông minh",105000,105000,0,0
TIKI,ngon,184599154,"Khoai môn lệ phố hương cốm Đôi Đũa Vàng 260g",103000,103000,0,0
TIKI,ngon,185916496,"Ba Chỉ Bò Mỹ Thái Lát Lẩu - Nướng Khay 500g - Cắt lát 2mm",123000,123000,0,0
TIKI,giay-dep-nu,36777679,"Giày Bệt Nữ Hàn Quốc Nhựa Dẻo Chống Nước Tiện Dụng G01",83000,83000,0,0
TIKI,dong-ho-va-trang-suc,97927216,"Vòng tay dây chỉ ngũ sắc Tây Tạng may mắn kết hợp đá tự nhiên 100% không qua xử lý. Thích hợp cho cả người lớn lẫn em bé. Mang đến may mắn, tài lộc, thân tâm an lạc",79000,79000,0,0
TIKI,dong-ho-va-trang-suc,7588629,"Lắc Tay Bạc Chỉ Đỏ L1556 Freesize Bảo Ngọc Jewelry",250000,250000,0,0
TIKI,phu-kien-thoi-trang,181782398,"Tất Thể Thao Nam Nữ GOMTAT Chất Liệu Cotton Cao Cấp, Vớ Cổ Ngắn Unisex Chuyên Dùng Trong Việc Tập Luyện - GOM502-THETHAO",39000,70000,31000,44
TIKI,may-anh,25300841,"Hắt sáng 5 trong 1 đường kính 110cm có tay cầm nhựa ABS- Hàng nhập khẩu",279000,279000,0,0
TIKI,dong-ho-va-trang-suc,62216290,"Đồng Hồ Nữ Julius Hàn Quốc JA-979 Dây Da",689000,689000,0,0
TIKI,giay-dep-nu,174473502,"Giày Bata phủi chính hãng Wika Ultra 1",268000,268000,0,0
TIKI,ngon,120527170,"Dưa lưới đạm cá - 1 quả 1,2 kg - 1,4 kg",110000,110000,0,0
TIKI,phu-kien-thoi-trang,57752704,"Kính mát nữ thời trang,Kính dâm, Kính du lịch MK03",39000,70000,31000,44
TIKI,dong-ho-va-trang-suc,127461281,"Dây sáp bóng thắt vòng tay đường kính 1,5mm cuộn 10m - Ngọc Quý Gemstones",24000,48000,24000,50
TIKI,ngon,121603682,"[ Chỉ giao HN] - Kim chi hộp 500g",57600,57600,0,0
TIKI,ngon,126962685,"[ Chỉ giao HN] -Nấm hương mũ 200g",84000,84000,0,0
TIKI,phu-kien-thoi-trang,105106346,"GOTI - Cài Áo Hoa Tulip Hạt Đá Kiểu Tag Cài Váy Đẹp Thanh Lịch Dành Cho Nữ Kiểu Dáng Hoa Cao Cấp Đa Dạng GOTI CA11",52000,84000,32000,38
TIKI,dong-ho-va-trang-suc,11979339,"Cặp Đồng Hồ Nam Nữ Halei HL540 Dây da đen mặt trắng (Tặng pin Nhật sẵn trong đồng hồ + Móc Khóa gỗ Đồng hồ 888 y hình + Hộp Chính Hãng+ Thẻ Bảo Hành)",328000,425000,97000,23
TIKI,phu-kien-thoi-trang,50252353,"COMBO A Kính Áp Tròng Trong Suốt Mediclear + Nước Ngâm",270000,270000,0,0
TIKI,tui-vi-nu,150147404,"Dầu Bôi Ấm Ngực Vicks Baby Balsam Chống Cảm Cho Bé",175000,250000,75000,30
TIKI,tui-vi-nu,192033898,"Túi peekoo xanh tiện lợi",49000,49000,0,0
TIKI,phu-kien-thoi-trang,43829676,"Tất vớ nữ hình trái tim cổ ngắn TN07",11100,11100,0,0
TIKI,dong-ho-va-trang-suc,90720613,"Nhẫn nam khui bia thép không gỉ đẳng cấp",15000,15000,0,0
TIKI,giay-dep-nu,193053178,"Dép bánh bao phong cách Châu Âu mã 240",129000,229000,100000,44
TIKI,may-anh,160406276,"Công tắc cảm biến chuyển động hồng ngoại P002 gắn tường 1200W-220V có thể xoay 180 độ",176000,176000,0,0
TIKI,giay-dep-nu,222676936,"CONVERSE - Giày sneakers cổ cao unisex Chuck Taylor All Star 1970s AT CX A02776C",2900000,2900000,0,0
TIKI,ngon,127509728,"[Chỉ giao HN] Kim chi cải thảo 300g",44000,44000,0,0
TIKI,tui-vi-nu,176267743,"Túi đeo chéo nữ nắp phong thư Yuumy seasand YN97",299000,570000,271000,48
TIKI,tui-vi-nu,134947145,"Túi Xách Cói Dây Da Đi Biển YUUMY YTX16",155000,290000,135000,47
TIKI,giay-dep-nu,195866478,"PUMA - Giày thể thao nữ Cali Dream Metal Trainers 384853",2799000,2799000,0,0
TIKI,ngon,165675011,"Lá bạc hà",18000,18000,0,0
TIKI,dong-ho-va-trang-suc,97902336,"Hộp Đựng Đồng Hồ Cơ - Hộp lên dây cót cho 1 chiếc đồng hồ tự động automatic",489000,489000,0,0
TIKI,dong-ho-va-trang-suc,84594356,"Đồng hồ nam Automatic ORIENT SK RA-AA0B03L19B - Dây thép",5850000,7800000,1950000,25
TIKI,tui-vi-nu,162024663,"Túi xách nữ thời trang công sở cao cấp phong cách mới",404000,448200,44200,10
TIKI,may-anh,11631975,"Hộp Chụp Sản Phẩm Led 60x60",1249999,1249999,0,0
TIKI,may-anh,53327198,"Camera hành trình dạng gương chiếu hậu",198500,198500,0,0
TIKI,ngon,164428783,"[ Chỉ giao HN] - Bò ẩm thảo mộc - gói 200g",125000,125000,0,0
TIKI,dong-ho-va-trang-suc,78490194,"1 Cặp Nhẫn Đá Thiên Nhiên May Mắn - Ngọc Quý Gemstones",99000,180000,81000,45
TIKI,dong-ho-va-trang-suc,63626604,"Đồng hồ Casio G SHOCK GM-5600B-1DR",7152000,7152000,0,0
TIKI,dong-ho-va-trang-suc,74527302,"Dây chuyền nam cao su đen trangsucpt kích cỡ 3mm thiết kế khóa 2 đầu bằng inox thép không gỉ PTDCNA38",38000,38000,0,0
TIKI,giay-dep-nu,161399413,"Dép xăng đan nữ ( đế trắng quai đen ) size từ 34 nữ đến 42 nữ",82999,82999,0,0
TIKI,ngon,127509732,"[Chỉ giao HN] Thăn ngoại bò Mỹ cắt lát sốt BBQ 150gr",163900,163900,0,0
TIKI,dong-ho-va-trang-suc,176071877,"Dây silicon thể thao mềm mại dành cho các loại Đồng hồ Xiaomi Miwatch",135000,135000,0,0
TIKI,may-anh,159276826,"Pin sạc Kingma Ver 3 cho Canon LP-E17 (Sạc Type C siêu nhanh), Hàng chính hãng",219999,219999,0,0
TIKI,phu-kien-thoi-trang,63049448,"Mũ rộng vành hở chóp XDM HAT chống nắng, chống tia UV – Nón đi biển dành cho nữ",51000,51000,0,0
TIKI,phu-kien-thoi-trang,10347900,"Thắt Lưng/ Dây Nịt Nam Da Bò 3 Lớp, Khóa Kim Lỗ Minh Tâm MT214-09 (120cm x 3,5cm) + Tặng Kèm Hộp Gói Sang Trọng",259000,359000,100000,28
TIKI,dong-ho-va-trang-suc,16931598,"Nhẫn nam quân đội Mỹ mạ Vàng 24k mặt đá xanh N8",98000,110000,12000,11
TIKI,dong-ho-va-trang-suc,150150734,"Dây đeo Garmin Forerunner 165/ 55/ 245/ 255/ 645/ Venu 2/ SQ 2/ SQ/ Vivoactive 5/ 4/ 3 (DG)",180000,180000,0,0
TIKI,giay-dep-nu,174641597,"Mũ chiết áp WH148 AG2 Màu Sắc Ngẫu Nhiên",1000,1000,0,0
TIKI,giay-dep-nu,21973683,"Giày Búp Bê Đính Nơ TOMOYO TMW32208",800000,800000,0,0
TIKI,phu-kien-thoi-trang,132956083,"KHĂN TRÙM ĐẦU KIỂU NINJA Swat 3 in 1 Chất liệu vải siêu mềm mịn Co giãn Chống nắng Chống bụi",39000,39000,0,0
TIKI,ngon,111982177,"[Chỉ giao HN] - Vụn Đuôi Cá Thu Na Uy Xuất Nhật – 1KG – Túi Hút Chân Không",185000,185000,0,0
TIKI,phu-kien-thoi-trang,82515871,"Thắt lưng nữ Dây nịt nữ đẹp Thời Trang Hàn Quốc dona21031101",94000,99000,5000,5
TIKI,dong-ho-va-trang-suc,68368171,"Đồng hồ điện tử nam nữ dây hoa cúc thời trang sành điệu DH106",16000,16000,0,0
TIKI,may-anh,59288795,"Đèn led video mini VIJIM VL81 Ulanzi hàng chính hãng.",450000,450000,0,0
TIKI,giay-dep-nu,76100529,"Giày nữ thời trang cao cấp ELLY – EG107",999000,999000,0,0
TIKI,dong-ho-va-trang-suc,9724296,"Đồng Hồ Trẻ Em SKMEI 1485 Chống Nước - DHA631",114000,175000,61000,35
TIKI,may-anh,163271087,"Gói hút ẩm tủ quần áo hạt hút ấm thực phẩm máy ảnh cho giày túi xách Silica Gel các loại gói 500 gr",55900,55900,0,0
TIKI,ngon,126809008,"[ Chỉ giao HN] - Dưa leo baby 1kg",50000,50000,0,0
TIKI,dong-ho-va-trang-suc,46651646,"Vòng tay mã não đen mảnh - Ni",99000,99000,0,0
TIKI,dong-ho-va-trang-suc,141232964,"Vòng Tay Trầm Hương Rừng Loại 2 Chuỗi Tràng Hạt 108 6/7/8mm (Tuổi Trầm 10 - 15 Năm) - MTH JEWELRY",739000,739000,0,0
TIKI,dong-ho-va-trang-suc,145763565,"5 Viên Pin CMOS CR2032 Maxell Nhật Bản Lithium 3V",16000,19500,3500,18
TIKI,tui-vi-nu,189832277,"Túi xách túi đeo vai nữ mini , có quai cầm ngọc  trai ,da bóng đẹp  xinh xắn đáng yêu cho phái nữ dạo phố",39000,39000,0,0
TIKI,ngon,121603672,"[ Chỉ giao HN] - cá Chẽm tẩm sốt bơ chanh đông lạnh 340gr",240000,240000,0,0
TIKI,dong-ho-va-trang-suc,14334808,"Vòng cổ phật Phổ Hiền Bồ Tát - Phật bản mệnh - Đá Phong Thủy",95000,95000,0,0
TIKI,may-anh,191474633," Balo máy ảnh Peak Design Totepack - Hàng chính hãng",5749000,5749000,0,0
TIKI,giay-dep-nu,205954819,"Sandal quai Ngang nữ chuẩn kiểu Hàn Quốc - quai dán siêu chắc chắn, tiện lợi, lên chân cực đẹp",180000,180000,0,0
TIKI,giay-dep-nu,181075379,"Giày Sandal Nữ Cao Gót TiTi ĐÔ Da Bò Thật Cao Cấp 7cm DNU2129a",374000,374000,0,0
TIKI,tui-vi-nu,72210939,"Móc khóa thời trang YUUMY YMK5 - Màu sắc trẻ trung - Thiết kế hiện đại - Đa chức năng sử dụng - Đựng thẻ ngân hàng, thẻ xe, chìa khóa xe - Tiên dụng mang theo bên người (Dài 7cm x Cao 10.5cm)",29000,50000,21000,42
TIKI,ngon,117720224,"[Chỉ giao HN] - Giò Bò 7 Phút Ngon Bất Bại - 10 Cái",139000,139000,0,0
TIKI,giay-dep-nu,82484492,"MIẾNG LÓT CHO GIÀY RỘNG SILICON",35000,35000,0,0
TIKI,giay-dep-nu,92688274,"Giày Búp Bê  Đế Xuồng  M401 GIÁ XƯỞNGGiày búp bê Da Bò Thật SIÊU ÊM",199000,199000,0,0
TIKI,may-anh,193442641,"Ống nhòm nhìn ngày, đêm BARSKA NVX-700 (Phóng đại 9x) - Hàng Chính Hãng",9900000,9900000,0,0
TIKI,may-anh,201176852,"Tấm hắt sáng hỗ trợ chụp ảnh sản phẩm Camcamvintage",70000,70000,0,0
TIKI,dong-ho-va-trang-suc,195335183,"Giá đỡ đồng hồ, treo vòng đeo tay,  đồ trang sức",235000,235000,0,0
TIKI,may-anh,14967120,"Chân máy quay JY-0508B 1.85m",3100000,3100000,0,0
TIKI,ngon,193881173,"Bún khô trắng Cao Bằng - 0.5kg",31500,31500,0,0
TIKI,giay-dep-nu,68584785,"Dép Nữ Cao Gót BIGGBEN Cao Cấp DCG42",319000,400000,81000,20
TIKI,dong-ho-va-trang-suc,63300207,"Vòng Đeo Tay Phong Thủy Tỳ Hưu - mang lại may mắn cho người đeo",28500,30000,1500,5
TIKI,dong-ho-va-trang-suc,86993952,"Combo Nhẫn Nam/Nữ CẢM BIẾN NHIỆT ĐỘ CƠ THỂ, Bản RỘNG, Mạnh mẽ, cá tính, Phong cách, Chất liệu hợp kim Titanium, Kèm túi Nhung đựng trang sức",29000,67000,38000,57
TIKI,dong-ho-va-trang-suc,12278011,"Dây truyền, vòng cổ xi vàng 24k thời trang đẹp quý phái",95000,95000,0,0
TIKI,may-anh,15258381,"Hắt sáng 5 in 1 bầu dục kích thước 100x150cm",499000,499000,0,0
TIKI,dong-ho-va-trang-suc,90719195," Lắc tay nam inox kiểu lặc cá tính thép không gỉ 7mm",26000,26000,0,0
TIKI,dong-ho-va-trang-suc,47101179,"Dụng Cụ Thay Dây Đồng Hồ 2 Đầu",110000,110000,0,0
TIKI,phu-kien-thoi-trang,209170971,"Mũ beret nam da cừu cao cấp BHY1965 Mũ nồi nam màu Nâu cà phê",619000,619000,0,0
TIKI,tui-vi-nu,162373758,"Túi Vải Bố Canvas Tote Trơn Grepaco Không In Màu Trắng Dạng Quai Xách Đeo Vai Có Ngăn Phụ Bên Trong Dùng Đi Học Dạy Vẻ Cho Sinh Viên Học Sinh",46000,49000,3000,6
TIKI,tui-vi-nu,187642699,"Túi Cói Merci Siêu Hot Hit ! đi biển,đi chợ,đi chơi",38000,38000,0,0
TIKI,may-anh,124658327,"Pin sạc lithium 3,7V 3500mAh chuyên dùng cho camera mini siêu nhỏ",50000,50000,0,0
TIKI,tui-vi-nu,188503686,"Túi đeo chéo nữ vải dù trần trám, nhiều ngăn chống nước, phong cách Hàn Quốc Size 22cm TUI-58",139000,139000,0,0
TIKI,tui-vi-nu,90113077,"Túi Cói Merci Siêu Tiện Dụng Siêu HÓT HÍT Túi đi biển",54999,54999,0,0
TIKI,giay-dep-nu,98590255,"Giày Sandal Nữ Đế Xuồng HÀ NAM Da Bò Thật Cao Cấp 7cm DNU2060",325000,325000,0,0
TIKI,tui-vi-nu,86560842,"Ví bóp nữ   Ví nữ cầm tay ngắn mini cao cấp nhiều ngăn giá rẻ V042301",32000,32000,0,0
TIKI,dong-ho-va-trang-suc,161523242,"Dây Đeo SILICON dành Cho Huawei Honor Band 6 Chất Lượng cao",25000,25000,0,0
TIKI,dong-ho-va-trang-suc,185594470,"Dây Chuyền Vòng Cổ Bạc 925 Cỏ 4 Lá May Mắn Đeo 2 Kiểu DMD461",260000,520000,260000,50
TIKI,tui-vi-nu,109631859,"Ví dự tiệc cưới, sự kiện, kiểu dáng trong suốt, có nút gài kim loại, ví dự tiệc sang trọng, đẳng cấp",270000,450000,180000,40
TIKI,giay-dep-nu,111231953,"Dép quai ngang nữ LAHSTORE DQNAM01 2021. Phong cách Unisex. Size từ 35 đến 43.Vải bố siêu chắc chắn. Đế chống trơn trượt",194600,194600,0,0
TIKI,giay-dep-nu,168228084,"Dép Quai ngang thời trang – có Gai matxa – TK77",89000,89000,0,0
TIKI,dong-ho-va-trang-suc,76463026,"Chuỗi 108 hạt vòng tay vòng cổ trầm hương tự nhiên 6 ly",149000,149000,0,0
TIKI,dong-ho-va-trang-suc,135348102,"Dây đeo Samsung Watch 3 41/ 45mm - Dây thép, khóa nam châm",135000,135000,0,0
TIKI,dong-ho-va-trang-suc,100319459,"nhẫn titan trơn giá rẻ",19000,19000,0,0
TIKI,may-anh,45641220,"Tủ chống ẩm  AD-100S",3899999,3899999,0,0
TIKI,dong-ho-va-trang-suc,111041041,"DÂY CHUYỀN CAO SU 2LY KHÓA INOX KHÔNG ĐEN rẻ, đẹp mà chất",29000,29000,0,0
TIKI,giay-dep-nu,271382502,"[Original] Timberland Giày Boot Nữ Carnaby Cool 6inch Wheat Nubuck TB0A5VPZ24",4990000,4990000,0,0
TIKI,dong-ho-va-trang-suc,44045501,"Vòng cổ choker đính ngọc trai sang trọng cho nữ",26000,41000,15000,37
TIKI,may-anh,45805979,"Camera Giám Sát IP Siêu Nhỏ Gọn EZVIZ Mini C1C 2MP Full HD 1080P (CS-C1C-1D2WFR) - Thẻ nhớ NETAC 32GB - Hàng Chính Hãng",580000,580000,0,0
TIKI,ngon,116553115,"[Chỉ giao HN] - Gà Nấm Bó Xôi Chiên Giòn - 1 Khay 10 Cái - Hút Chân Không",129000,129000,0,0
TIKI,giay-dep-nu,168227840,"Dép Massage khảm đá Bấm huyệt bàn chân trên gỗ tự nhiên, Bấm Huyệt chân Giảm căng thẳng mệt mỏi",175000,175000,0,0
TIKI,ngon,118896392,"[Chỉ giao HN] Kem hộp vị Phô Mai RedVelvet - Cream Cheese Red Velvet",119000,119000,0,0
TIKI,giay-dep-nu,157099603,"Giày Slip on nữ nhập khẩu Đài Loan",329000,329000,0,0
TIKI,may-anh,108215883,"Chân máy ảnh Benro SystemGo trục giữa xoay đứng - ngang, Hàng chính hãng",1949999,1949999,0,0
TIKI,phu-kien-thoi-trang,52263401,"SET 6 CỘT TÓC SCRUNCHIES VẢI BÓNG NHIỀU MÀU, BUỘC TÓC THỜI TRANG NỮ ",45000,45000,0,0
TIKI,dong-ho-va-trang-suc,176073859,"Dây silicon ngàm cong dành cho đồng hồ Samsung Galaxy Watch 4 40mm & Watch 4 44 mm",59000,59000,0,0
TIKI,ngon,172025039,"[ Chỉ giao HN] -Táo Envy Mỹ -1kg",429000,429000,0,0
TIKI,giay-dep-nu,97960576," Giày cao gót đế xuồng 9p 1 bản lớn gợn sóng",245000,245000,0,0
TIKI,giay-dep-nu,164597706,"Giày búp bê chính hãng Trường Hải da bò thật màu hồng phấn đế cao su không trơn BB1025",169000,299000,130000,43
TIKI,dong-ho-va-trang-suc,70120675,"Vòng tay chuỗi đá mắt hổ loại A",213750,225000,11250,5
TIKI,tui-vi-nu,137154030,"Túi Tote Canvas Đeo Chéo Nữ Đi Học Mèo My World Phong Cách Ulzzang",59000,59000,0,0
TIKI,dong-ho-va-trang-suc,54656485,"Vòng đeo tay chuỗi hạt 108 hạt gỗ hồng phong thủy",54000,54000,0,0
TIKI,giay-dep-nu,162592343,"Giày Sneakers đế cao 11CM siêu nhẹ PS498",498000,498000,0,0
TIKI,giay-dep-nu,97535199,"Dép lông mang trong nhà hình mèo - Giao màu ngẫu nhiên",91000,91000,0,0
TIKI,tui-vi-nu,76181891,"Ví nữ cầm tay 2 ngăn kéo cao cấp, thiết kế độc đáo đẹp mắt, nhiều ngăn tiện dụng TK0073",69000,100000,31000,31
TIKI,giay-dep-nu,81132362,"Dép đi trong nhà -  dép massage TRẺ EM –MT2  (vang chanh ). Size tự do ( 31-33)",55000,55000,0,0
TIKI,ngon,157856385,"[ Chỉ giao HN] - Bánh Chưng Nương Bắc Gấc thịt 800gr",190000,190000,0,0
TIKI,tui-vi-nu,135545812,"Túi đeo chéo mini Fimax vài cao cấp chống thấm nước - túi đeo nữ thời trang vải cao cấp phong cách Hàn Quốc",119000,119000,0,0
TIKI,dong-ho-va-trang-suc,14971891,"Bông Tai Ngọc Trai Cao Cấp B1933 Cỡ Hạt 11x13 Ly",400000,400000,0,0
TIKI,dong-ho-va-trang-suc,25758447,"Đồng Hồ Trẻ Em Chống Nước SKMEI 0961",179000,179000,0,0
TIKI,giay-dep-nu,270688706,"Giày Sneaker Converse Nữ Chuck Taylor All Star Lift -  A03541C",1800000,1800000,0,0
TIKI,ngon,164428759,"[ Chỉ giao HN] - Dưa lưới Đà Lạt - 1kg",65000,65000,0,0
TIKI,phu-kien-thoi-trang,48228954,"Kính lão thị trung niên kính đọc sách +100 đến +4.00 đủ độ mắt sáng và rõ PKTMKVM07COPY",219000,219000,0,0
TIKI,ngon,117211906,"[Chỉ giao HN] - Khâu Nhục Tiên Yên Quảng Ninh - 350g",299000,299000,0,0
TIKI,may-anh,6909825,"Tản sáng Godox Reflector ngàm Bowens  - Hàng nhập khẩu",250000,250000,0,0
TIKI,may-anh,551651,"Camera IP Wifi Dahua 1.3Mp IPC-HFW1120SP-W-Hàng Chính Hãng",1000000,1000000,0,0
TIKI,may-anh,155880977,"Combo Mount chuyển ngàm gopro sang vít 1/4 inch và gá kẹp điện thoại Yunteng VCT-Pat 018-Hàng chính hãng",119000,119000,0,0
TIKI,giay-dep-nu,125099377,"Giày lười nữ Anh Khoa A688-8",300000,300000,0,0
TIKI,phu-kien-thoi-trang,187511669,"Nón Lưỡi Trai logo Tiktok 2 phiên bản chất lượng cao brand One Hat",160000,160000,0,0
TIKI,dong-ho-va-trang-suc,77719604,"Combo Nhẫn Nam Nữ kiểu dáng Hoàng Gia, Khắc hình Sư Tử, Chất liệu titanium mạ Vàng 8K, Kèm túi đựng Nhẫn bằng Nhung mềm",195000,219000,24000,11
TIKI,may-anh,224173531,"Camera IP Xiaomi Smart Camera C300 360 độ - 2K Hàng Chính Hãng",899000,1490000,591000,40
TIKI,dong-ho-va-trang-suc,48033728,"Nhẫn đá thạch anh mắt hổ vàng nâu ni 20 mệnh thổ, kim - Ngọc Qúy Gemstones",389000,760000,371000,49
TIKI,balo-va-vali,53242140,"Balo Sider thời trang Hàn cá tính, form rộng lớn chứa đủ mọi vật dụng cần, chất liệu bền bỉ cao cấp, màu sắc tinh tế",107910,147477,39567,27
TIKI,tui-vi-nu,158815530,"Ví cầm tay nữ nắp gập cách điệu YUUMY Seasand YV55",165000,330000,165000,50
TIKI,may-anh,3231241,"Chân Máy Ảnh Benro TSL08AN00 - Hàng Nhập Khẩu",1499999,1499999,0,0
TIKI,ngon,103994226,"[Chỉ Giao HN] Bưởi da xanh 1 Trái 1.5kg",85000,85000,0,0
TIKI,dong-ho-va-trang-suc,2888357,"Đồng Hồ Trẻ Em Cho Bé Trai SKMEI 1163 - DHA436",199000,199000,0,0
TIKI,may-anh,50433508,"Thiết bị chống sét lan truyền mạng lan rj45 cho camera IP LKD105F4H-E100",315000,315000,0,0
TIKI,dong-ho-va-trang-suc,14971746,"Bông Tai Ngọc Trai Cao Cấp B1932 Cỡ Hạt 11x13 Ly Bảo Ngọc Jewelry",311000,311000,0,0
TIKI,dong-ho-va-trang-suc,51829990,"Đồng hồ nam dây nhựa Casio G-Shock chính hãng GA-2100SU-1ADR",3006000,4008000,1002000,25
TIKI,dong-ho-va-trang-suc,10719060,"Đồng hồ nam dây hợp kim chống gỉ Skmei 9069",270750,285000,14250,5
TIKI,phu-kien-thoi-trang,4100855,"Băng Đô Vải Cài Tóc Họa Tiết Zigzag Màu Xanh Rêu, Đỏ - Mã BD234",22000,22000,0,0
TIKI,dong-ho-va-trang-suc,58473875,"Đồng hồ nữ dây da Julius Ja-787 Nâu",589000,589000,0,0
TIKI,dong-ho-va-trang-suc,107348050,"Đồng Hồ Cơ Nam Cao Cấp, Tự Động Lên Dây Cót Khi Đeo, Lộ Cơ Mặt Và Đáy, Dây Da Mềm Bền Đẹp, Mặt Chống Trầy Xước, Đồng Hồ Lộ Máy Có Khả Năng Chống Nước Cực Tốt, Phong Cách Thời Trang Hiện Đại",565000,565000,0,0
TIKI,phu-kien-thoi-trang,51616362,"Gọng Kính Cận Hợp Kim Thời Trang Clubmaster Unisex - G1529",58900,62000,3100,5
TIKI,may-anh,67457497,"Camera Ip Wifi Ngoài Trời Vitacam DZ3000  3.0MP Độ Phân Giải 1296P Ultra HD - Hàng Chính Hãng",560000,560000,0,0
TIKI,dong-ho-va-trang-suc,150977345,"Bông tai bạc nụ xinh chất liệu bạc s925 MS05",87000,87000,0,0
TIKI,tui-vi-nu,172977144,"Túi vải bố, Túi vải Canvas trơn Màu Be - Màu Đen không khóa kéo",19000,19000,0,0
TIKI,tui-vi-nu,96311978,"Túi Cói Xách Tay Thời Trang Đi Biển 2 Lớp Quai Vải Phong Cách Vintage - Mã XT026",43000,47900,4900,10
TIKI,phu-kien-thoi-trang,267259915,"Tờ Xăm Miếng Dán Tattoo 15 Ngày Không Trôi Chống Thấm Nước Tạm Thời Thánh giá chữ thập có cánh Legaxi",13000,13000,0,0
TIKI,phu-kien-thoi-trang,32214090,"Băng đô nữ",35000,35000,0,0
TIKI,dong-ho-va-trang-suc,106391798,"Dây đồng hồ nam nữ size 12mm 14mm 16mm 18mm 20mm 22mm CỰC MỀM",50000,50000,0,0
TIKI,ngon,139987692,"Bưởi da xanh Bến Tre",88000,88000,0,0
TIKI,dong-ho-va-trang-suc,184475904,"Đồng hồ thể thao điện tử đa năng SKMEI 1370 cho nam bằng thép không gỉ chống nước thời trang",169000,169000,0,0
TIKI,ngon,118137937,"Rau cải ngồng - 200g",13000,13000,0,0
TIKI,dong-ho-va-trang-suc,92817245,"Dây Chuyền Nam Trơn Phối Mặt Nhẫn - Vòng cổ nam cá tính",75000,75000,0,0
TIKI,ngon,185657602,"Mực nang nút - 1kg",130000,130000,0,0
TIKI,dong-ho-va-trang-suc,15662471,"Đồng hồ Casio nam AE-1200WHD-1AVDF",1129500,1506000,376500,25
TIKI,giay-dep-nu,139632043,"Dép Đi Trong Nhà Cao Cấp NineRed Tai Thỏ Dễ Thương D55",139000,139000,0,0
TIKI,may-anh,109812827,"Balo máy ảnh Safrotto SM300, Hàng chính hãng",1949999,1949999,0,0
TIKI,may-anh,106584149,"Camera IP 2MPX  Wifi Ngoài Trời Imou F22FP Bullet 2E Full HD 1080P  CÓ MÀU BAN ĐÊM, KÈM THẺ NHỚ 32G - Hàng Chính Hãng",889900,889900,0,0
TIKI,may-anh,194115568,"CAMERA WIFI NGOÀI TRỜI EZVIZ C3X 2M BẢN MẮT KÉP TÍCH HỢP AI, ĐÀM THOẠI 2 CHIỀU, BAN ĐÊM CÓ MÀU - HÀNG CHÍNH HÃNG",1320500,1390000,69500,5
TIKI,may-anh,171554130,"ĐÈN LIVESTREAM SIZE45CM - Chụp Hình - Make up -Kèm Chân đèn - Hàng Chính Hãng",999000,999000,0,0
TIKI,may-anh,4688899,"Chân Máy Ảnh Tripod Weifeng 6662A - Hàng Nhập Khẩu",629999,629999,0,0
TIKI,phu-kien-thoi-trang,94997536,"Mũ nón chống nắng nữ ninja có chìa rộng chùm kín cổ gáy kiêm khẩu trang chống nắng vải caro thoáng mát",79000,79000,0,0
TIKI,phu-kien-thoi-trang,120480536,"Kính Râm, Kính Mát Nam Nữ Mắt Tròn 2 Tròng Mở Nắp 2in1 Gọng Kim Loại Cao Cấp",179550,189000,9450,5
TIKI,dong-ho-va-trang-suc,145092650,"Dây đồng hồ nato vải dù D121 cỡ 18mm; 20mm, 22mm thoải mái đi trời mưa, lắp cho dây đeo đồng hồ dw rolex hublot orient seiko casio",38000,55000,17000,31
TIKI,may-anh,15267069,"Bóng thổi bụi máy ảnh",89000,89000,0,0
TIKI,phu-kien-thoi-trang,15387305,"Sét 12 dây buộc tóc cao cấp xuất Nhật HD06",42000,42000,0,0
TIKI,dong-ho-va-trang-suc,141234375,"Vòng Tay Trầm Hương Hạt Tròn Đơn 10mm Trầm Tốc Việt - Trầm Hương Tự Nhiên",220000,220000,0,0
TIKI,giay-dep-nu,67852066,"Giày bệt nữ da mềm dáng xinh",89000,89000,0,0
TIKI,dong-ho-va-trang-suc,36014644,"Bông tai nam màu trắng",29900,29900,0,0
TIKI,tui-vi-nu,45268061,"Dây Túi đeo chéo da pu kết hợp với dây vải xì teen, dây đeo vai có thể điều chỉnh  có thể điều chỉnh",120000,120000,0,0
TIKI,ngon,170347406,"Đệ nhất mì gia trộn Spaghetti Hương vị bò ",10000,10000,0,0
TIKI,giay-dep-nu,89894103,"Giày nữ cao cổ Hàn Quốc, giày sneakers nữ. Loại cao cấp, cổ chun, chống hôi chân,giúp thon gọn bàn chân và tôn chiều cao",246000,246000,0,0
TIKI,may-anh,155997730,"Tủ chống ẩm Nikatei NC-30C- Silver  (Dung tích 30 lít)-China . Tặng 01 bộ vệ sinh máy ảnh 8 in 1",1775555,1775555,0,0
TIKI,dong-ho-va-trang-suc,90312041,"Cuộn cước thun ( cước chun), dây thun co giãn xỏ vòng cuộn mimi 10m",23000,26000,3000,12
TIKI,tui-vi-nu,130856262,"Túi Đeo Chéo Vải Bố Phong Cách Hàn Quốc Xinh Xắn Dành Cho Nữ",46700,46700,0,0
TIKI,ngon,118895477,"[Chỉ giao HN] Kem hộp vị Caramen Hạnh Nhân - Caramel Almond",119000,119000,0,0
TIKI,dong-ho-va-trang-suc,4043611,"Đồng hồ trẻ em Skmei 1241 siêu xe",66000,95000,29000,31
TIKI,giay-dep-nu,188140159,"OLV - Giày Golden Straps Heels",350000,350000,0,0
TIKI,ngon,119398077,"[Chỉ giao HN] - Lưỡi Heo Muối Xông Khói – 1Kg",439000,439000,0,0
TIKI,ngon,179711588,"[Chỉ giao HN]  - Túi mix 03 loại hạt cao cấp 3 (macca, hạnh nhân, hạt điều) - 1kg",600000,600000,0,0
TIKI,giay-dep-nu,50262184,"Giày đế xuồng nữ 3cm Trường Hải  đính nơ xinh da bò mềm mại màu vàng thời trang , đế xuống cao su DX0132",261000,309000,48000,16
TIKI,ngon,181904832,"GẠO TÁM HƯƠNG LÀI NHÃN FAS LOẠI 5KG",90000,90000,0,0
TIKI,ngon,173294225,"[Chỉ giao HN] - Dồi Sụn Non Nổi Tiếng Hà Thành - 500g - Túi Hút Chân Không",109000,109000,0,0
TIKI,tui-vi-nu,42729783,"Túi clutch nữ thời trang cao cấp ELLY – ECH31",999000,999000,0,0
TIKI,tui-vi-nu,16882460,"Vỏ Bọc Hộ Chiếu Có Khe Nhét Thẻ Tiện Dụng",2999,2999,0,0
TIKI,may-anh,15271640," 10 gói hạt hút ẩm xanh cho máy ảnh, máy quay phim (1gói /100gram) tặng 10 túi zip  - Hàng chính hãng",99000,99000,0,0
TIKI,dong-ho-va-trang-suc,97889775,"Đồng Hồ Nữ Julius Hàn Quốc JA732C Dây Thép Mesh Thời Thượng",770000,770000,0,0
TIKI,dong-ho-va-trang-suc,71524933,"Vòng Mân Côi Rosary Bracele đá diopside - Ngọc Quý Gemstones",1369000,1960000,591000,30
TIKI,tui-vi-nu,107614755,"Túi vải bố, Túi vải Canvas trơn Màu Trắng - Màu Đen không khóa kéo",19000,19000,0,0
TIKI,ngon,120480652,"[Chỉ Giao Hà Nội] Đuôi heo Nga - 1kg",148000,148000,0,0
TIKI,balo-va-vali,193142175,"Túi Chống Sốc Laptop, Bảo Vệ Laptop 14inch, 15.6 inch Vải Trơn Mịn Chống Thấm Nước, Nhiều Màu Sắc Cá Tính",140000,140000,0,0
TIKI,giay-dep-nu,67599590,"Giày Sandal Cao Gót 9cm Quai Phối Màu Pixie X545",475000,475000,0,0
TIKI,balo-va-vali,4406193,"Balo Thời Trang Nam Đẳng Cấp EU (47 x 30 x 16cm) - Tặng Ngay Cáp USB Tiện Lợi - Luffy",199000,199000,0,0
TIKI,dong-ho-va-trang-suc,145763568,"10 Viên Pin Cúc Áo LR44 - AG13 - L1154 Vinnic 1,5V",20000,20000,0,0
TIKI,dong-ho-va-trang-suc,37758254,"Bông Tai Nam Hình Tròn Khắc Hoa Văn Đính 1 Viên Đá Chất Liệu Thép Titan Không Đen Không Dị Ứng TT 1701 - 1 cặp",87000,87000,0,0
TIKI,dong-ho-va-trang-suc,68502142,"Lắc Chân Nữ Bạc Hiểu Minh LC202X cỏ 4 lá dây kép bạc ý",369000,450000,81000,18
TIKI,may-anh,71935259,"Camera IP hồng ngoại 2.0 Megapixel HIKVISION DS-2CD1023G0E-I(L) - HÀNG CHÍNH HÃNG",760000,760000,0,0
TIKI,ngon,117986418,"[Chỉ giao HN] - Pho Mai Que - 500g",131000,131000,0,0
TIKI,tui-vi-nu,144492638,"Túi đeo chéo nữ nắp gập khóa vàng YUUMY Seasand YN109",339000,660000,321000,49
TIKI,ngon,179711727,"[Chỉ giao HN] - Túi mix 02 loại hạt cao cấp 6 (hạt điều, hạnh nhân) - 1kg",410000,410000,0,0
TIKI,phu-kien-thoi-trang,138282747,"Cột tóc nơ bản to - hot trend phong cách Hàn Quốc, bánh bèo cho nữ",45000,45000,0,0
TIKI,dong-ho-va-trang-suc,248536961,"Bông Tai Ngọc Trai Nụ, Khuyên Tai Nụ Ngọc Trai Cao Cấp Nhiều Màu - B2510 - Bảo Ngọc Jewelry",200000,200000,0,0
TIKI,dong-ho-va-trang-suc,118516302,"Hộp Đựng Đồng Hồ Chất Lượng Cao, Thích Hợp Đựng Đồng Hồ Làm Qùa Tặng",22000,22000,0,0
TIKI,phu-kien-thoi-trang,271456592,"Set 10 miếng dán tóc loại đẹp với đọ dính tốt cố định tóc - HIty Beauty",20000,20000,0,0
TIKI,giay-dep-nu,61278530,"Giày thể thao nữ hoa cúc đi bộ cực êm siêu xinh V253 - Đen - Size 37",55000,55000,0,0
TIKI,tui-vi-nu,152446331,"Túi xách nữ đeo chéo da mềm thời trang phong cách Hàn Quốc",99000,99000,0,0
TIKI,giay-dep-nu,21788290,"Combo 2 cặp lót giày cao gót bằng cao su non đệm êm ngón chân PK50",45000,45000,0,0
TIKI,dong-ho-va-trang-suc,175843845,"Dây đeo Huawei Watch GT3/ GT2/ GT Runner (DS2)",175000,175000,0,0
TIKI,may-anh,101305785," Remote MC-30 / MC-DC2 cho máy ảnh Nikon",75000,75000,0,0
TIKI,tui-vi-nu,110723636," VÍ DA CẦM TAY NỮ VÍ DA CẦM TAY NAM",118000,169000,51000,30
TIKI,may-anh,116793013,"Camera Gương ô tô, Camera Cạp Lề Sử Dụng Hiển Thị Điểm Mù Xe Hơi.",419000,419000,0,0
TIKI,balo-va-vali,20872392,"Micro Cài Áo Saramonic LavMicro - Hàng Chính Hãng",1275000,1275000,0,0
TIKI,may-anh,197887844,"Camera wifi có màu ban đêm Imou f22fp - Hàng Chính Hãng",920000,920000,0,0
TIKI,tui-vi-nu,117084931,"Túi xách đeo chéo nữ tặng dây chuyền ngọc trai dạo phố",159000,159000,0,0
TIKI,dong-ho-va-trang-suc,26318814,"Dây chuyền nam mạ vàng 24k ô vuông cá tính",100000,100000,0,0
TIKI,may-anh,46689242," Bộ Pin và Sạc SONY NP-F970 Ravpower 7800 MAH - Hàng Chính Hãng",749999,749999,0,0
TIKI,tui-vi-nu,112936486,"Ví Bóp Nữ Cầm Tay Dáng Dài Đựng Tiền Điện Thoại Thời Trang",99000,99000,0,0
TIKI,laptop-may-vi-tinh-linh-kien,189389648,"Đĩa trắng, Đĩa CD trắng Risheng hộp 50 cái dung lượng 700mb - HÀNG CHÍNH HÃNG",178900,178900,0,0
TIKI,laptop-may-vi-tinh-linh-kien,88270314,"Bộ Kéo Dài Tín Hiệu HDMI Qua Lan RJ45 120m KVM Có 2 Cổng USB Hỗ Trợ 4K",1880000,1880000,0,0
TIKI,may-anh,16057149,"Bộ KIT 4 Camera UNV 2MP Full HD 1080P - Hàng chính hãng",5450000,5450000,0,0
TIKI,may-anh,2563917,"Kẹp C Clamp With 1/4" Screw",129000,129000,0,0
TIKI,balo-va-vali,20676975,"Balo Laptop 14 inch chính hãng SimpleCarry B2B04",590000,590000,0,0
TIKI,balo-va-vali,90476326,"Balo nam thông minh đa năng cao cấp chống trộm và chống nước",621000,690000,69000,10
TIKI,balo-va-vali,197848283,"Khăn rằn Campuchia",74000,74000,0,0
TIKI,may-anh,58984214,"THẺ NHỚ SDHC UHS-I EXCERIA KIOXIA 128GB - HÀNG NHẬP KHẨU",402000,402000,0,0
TIKI,phu-kien-thoi-trang,86169050," TÓC GIẢ MÁI THƯA CAO CẤP CÓ MAI VÀ KHÔNG MAI SỈ 14K",19900,19900,0,0
TIKI,balo-va-vali,190707423,"Balo da nữ công sở cỡ trung YUUMY Liberal YBA55",235000,490000,255000,52
TIKI,may-anh,25498823,"Hộp chụp sản phẩm Puluz 20x20 có 40 bóng led siêu sáng (Tặng kèm đế đèn led)",199000,250000,51000,20
TIKI,balo-va-vali,192710343,"Balo nữ sinh đi học không thấm nước cao cấp phong cách hàn quốc 15.6",387000,430000,43000,10
TIKI,giay-dep-nu,191544490,"Dép cao gót đế vuông quai đan chéo siêu xinh cao 7cm cực êm chân",189000,189000,0,0
TIKI,may-anh,20872841,"Micro Video Mini Saramonic Vmic Mini Cho Máy Ảnh DSLR Và Điện Thoại - Hàng Chính Hãng",1350000,1350000,0,0
TIKI,laptop-may-vi-tinh-linh-kien,49346224,"Bàn Phím Dành Cho Laptop Lenovo IdeaPad Z450 Z460 Z460A Z460G",99000,230000,131000,57
TIKI,balo-va-vali,27656273,"Bộ 3 Túi Du Lịch Chống Nước Đựng Khăn, Đồ lót, Phụ Kiện, Mỹ Phẩm",89000,89000,0,0
TIKI,ngon,118137940,"Rau mồng tơi - 200g",13000,13000,0,0
TIKI,balo-va-vali,191652488,"Vali kéo Cube-048 SAMSONITE - MỸ: Thiết kế hình khối hiện đại, thời trang với các chi tiết tích hợp Hoàn thiện kết cấu hạn chế trầy xước, kết hợp với các đường rãnh bóng để làm nổi bật sự cao cấp Công nghệ kháng khuẩn",8500000,8500000,0,0
TIKI,dong-ho-va-trang-suc,90908213,"Nhẫn Nam Nữ,Unisex ,Nhẫn Đôi Thời Trang Titan Cao cấp NN01",29000,29000,0,0
TIKI,laptop-may-vi-tinh-linh-kien,8818541,"Kìm bấm mạng xuyên thấu ( RJ45 và RJ11) - Tặng kèm 10 hạt RJ45 xuyên thấu",214789,214789,0,0
TIKI,may-anh,60028898,"Camera Nội Soi Chống Nước Cho Máy Tính Và Điện Thoại",158000,158000,0,0
TIKI,balo-va-vali,174416981,"Ống nhòm Bushnell LEGEND 12x50 - thiết kế mới với hình thái công thái học mang lại cảm giác cầm nắm tự tin - Hàng chính hãng",6990000,6990000,0,0
TIKI,balo-va-vali,190635365,"Balo nữ mini phối ngăn kéo ngang LATA BAL57",269000,520000,251000,48
TIKI,balo-va-vali,150939646,"Camera IP Wifi FullColor 1080P lắp ngoài trời Imou IPC-F22FP hàng chính hãng DSS Việt Nam",670000,670000,0,0
TIKI,tui-vi-nu,196409306,"Túi đeo chéo nữ khóa nhấn LATA HN96",590000,590000,0,0
TIKI,phu-kien-thoi-trang,140130171,"Găng tay chống nắng hở 2 ngón cho nữ | Bao tay hở ngón lái xe máy, ô tô thật tay, vải mềm, thoáng khi, co giãn, dùng điện thoại thoải mái",70000,80000,10000,13
TIKI,phu-kien-thoi-trang,113912842,"Dây lưng xanh vải dù - Đỏ -Đen",29000,29000,0,0
TIKI,may-anh,101305870,"Combo hộp chống ẩm máy ảnh giá siêu rẻ 10 lít, 6 lít, 3 lít (tùy chọn hạt hoặc máy hút ẩm) - Hàng nhập khẩu",78000,78000,0,0
TIKI,tui-vi-nu,146414142,"Túi xách nữ đeo chéo đựng điện thoại dáng dọc phối hoa văn nhiều ngăn tiện dụng thời trang Hàn Quốc",139000,139000,0,0
TIKI,phu-kien-thoi-trang,52338684,"Mái thưa tóc giả M02",17000,17000,0,0
TIKI,may-anh,106306392,"Filter Kính lọc vuông Benro Hệ 100,  Hàng chính hãng",174999,174999,0,0
TIKI,tui-vi-nu,193613838,"Túi Cói Hình Gấu Bông Loại 1 Siêu Xinh, Dày Dặn - JL",38000,38000,0,0
TIKI,balo-va-vali,4707485,"Bộ Tripod Quick Release Plate - Hàng Nhập Khẩu",199000,199000,0,0
TIKI,phu-kien-thoi-trang,110047857,"Kính lão thị viễn thị trung niên kính đọc sách sáng và rõ KV88",109000,109000,0,0
TIKI,balo-va-vali,106888042,"Adapter chuyển đổi thẻ nhớ - áo thẻ",15000,15000,0,0
TIKI,balo-va-vali,50393221,"Ba lô da nam công suất lớn phong cách châu âu",441000,490000,49000,10
TIKI,balo-va-vali,136933859,"Tay Cầm Tích Hợp Pin Saramonic Blink 500 Pro HM - Hàng Chính Hãng	",1170000,1170000,0,0
TIKI,tui-vi-nu,114568388,"Túi cói Merci thời trang đi biển - dạo phố - đi làm",41890,41890,0,0
TIKI,balo-va-vali,77052330,"Balo laptop công nghệ, khóa số chống trộm chống rạch chống nước cao cấp phong cách mới",945000,1050000,105000,10
TIKI,tui-vi-nu,160314876,"Túi Xách Đeo Chéo Nữ Kẹp Nách Chính Hãng MICOCAH Dáng Công Sở Thời Trang Da Cao Cấp Cực Đẹp MC63",369000,369000,0,0
TIKI,balo-va-vali,918308,"Camera Thể Thao SJCAM SJ5000X",2399000,3500000,1101000,31
TIKI,phu-kien-thoi-trang,26345473,"Kính viễn thị gọng titan siêu dẻo mắt kính chống bức xạ KDN- KVT11",219000,219000,0,0
TIKI,tui-vi-nu,56531143,"Ví nữ cầm tay gấp đôi nhỏ gọn, phối màu dễ thương TK0052",35000,70000,35000,50
TIKI,laptop-may-vi-tinh-linh-kien,192133236,"Máy hủy giấy GBC ShredMaster S206 - Hàng chính hãng",1500000,1500000,0,0
TIKI,phu-kien-thoi-trang,76829144,"Khăn bandana Khăn turban cotton hiphop size 53*53cm",40000,40000,0,0
TIKI,phu-kien-thoi-trang,102889432,"Tóc giả mái thưa 3D Sỉ 25k",45000,45000,0,0
TIKI,tui-vi-nu,142435344,"Túi xách nữ công sở túi đeo vai đựng vừa A4 thời trang phong cách Hàn Quốc",139000,139000,0,0
TIKI,tui-vi-nu,132053956,"Túi xách nữ sang chảnh 4 màu hộp vuông túi nữ có dây đeo chéo dáng hàn quốc size 20",125000,125000,0,0
TIKI,balo-va-vali,34226398,"Balo laptop 15.6 inch Mikkor Kalino Backpack Graphite Orange",649000,649000,0,0
TIKI,phu-kien-thoi-trang,176445367,"Băng đô rửa mặt tai mèo xinh xắn dành cho nữ, mêm mại gọn gàng dễ dàng rửa mặt - màu ngẫu nhiên",20000,22000,2000,9
TIKI,balo-va-vali,102753515,"Balo nam thời trang tích hợp chống trộm chống nước cao cấp phong cách châu âu",1251000,1390000,139000,10
TIKI,phu-kien-thoi-trang,34511907,"Cài Áo Bông Hoa Ngọc Trai ",85000,89000,4000,4
TIKI,dong-ho-va-trang-suc,151818019,"Vòng Phong Thủy Mệnh Kim Tam Hợp Thân Tý Thìn Đá Mã Não Trắng - Vòng Đá Phong Thủy May Mắn Bình An - Size 8 10ly",249000,249000,0,0
TIKI,dong-ho-va-trang-suc,49651098,"Lắc chân kiêm lắc tay ngôi sao rỗng",38000,38000,0,0
TIKI,dong-ho-va-trang-suc,56830496,"Combo 3 cái charm bạc hình bàn tay hamsa treo - Ngọc Quý Gemstones",157000,180000,23000,13
TIKI,tui-vi-nu,153262523,"Combo 5 Túi Ví Đựng Bảo Vệ Chống Xước Thẻ ATM, Card Visit, CMND, Driver License Bằng Lái Xe Trong Suốt - Loại 1 Chính Hãng MINIIN",1805,1900,95,5
TIKI,laptop-may-vi-tinh-linh-kien,37714712,"Ổ Cứng SSD Gigabyte 480Gb (SATA 6.0Gb/s) - Hàng Chính Hãng",820000,820000,0,0
TIKI,tui-vi-nu,83609298,"Ví dài nữ nhiều ngăn cầm tay LATA VN54",350000,350000,0,0
TIKI,balo-va-vali,105212342,"Sigma 35mm F1.4 DG DN (ART) ngàm Sony E-Mount - Hàng Chính hãng",19290000,19290000,0,0
TIKI,phu-kien-thoi-trang,86165025," TÓC GIẢ MÁI THƯA CHE HÓI KÈM HÌNH THẬT",75000,75000,0,0
TIKI,balo-va-vali,72282319,"túi xách - túi chống sốc cho laptop 15,6 inh cao cấp phong cách mới",315000,350000,35000,10
TIKI,balo-va-vali,191575965,"Vali Kéo Du Lịch Larita MONZA size 20 S Chống Bể Thương Hiệu - Bảo Hành Trọn Đời",849000,1815000,966000,53
TIKI,tui-vi-nu,46687882,"Ví nữ ngắn mini cầm tay kiểu dáng Hàn Quốc",23760,34320,10560,31
TIKI,laptop-may-vi-tinh-linh-kien,16770500,"Đĩa DVD Maxell( lốc 50 chiếc) Hàng nhập khẩu",335500,335500,0,0
TIKI,laptop-may-vi-tinh-linh-kien,80994611,"Mực nạp/mực đổ dùng cho hộp mực HP 17A / HP 18A / HP 30A / HP 33A - Mực nạp hp M102a, M104a, M130a....HÀNG CHÍNH HÃNG",130000,130000,0,0
TIKI,tui-vi-nu,196603272,"Túi đeo chéo da nữ khóa xoay LATA HN104",325000,650000,325000,50
TIKI,balo-va-vali,15806201,"Bao Silicon Bảo Vệ Máy Ảnh Cover Cho Canon 6D Vàng",320000,320000,0,0
TIKI,laptop-may-vi-tinh-linh-kien,121330751,"Dây nguồn DC đầu jack Đực, Cái DC 5.5x2.1mm đúc sẵn (lõi đồng nguyên chất)",5000,5000,0,0
TIKI,may-anh,69861071," Dây máy ảnh đeo cổ tay hand strap",99000,99000,0,0
TIKI,dong-ho-va-trang-suc,26503356,"Vòng tay thắt dây đá cẩm thạch mệnh hỏa , mộc - Ngọc Quý Gemstones",299000,586000,287000,49
TIKI,balo-va-vali,142238671,"Túi chống sốc, cặp đựng laptop thời trang cao cấp chất liệu EVA thân thiện môi trường, hiện đại, sang trọng, lịch sự và thời thượng",590000,590000,0,0
TIKI,tui-vi-nu,189688895,"Ví nữ cầm tay dáng đứng YUUMY Liberal YV71",95000,190000,95000,50
TIKI,phu-kien-thoi-trang,177920374,"Mũ lưỡi trai - nón Ulzzang vải kết nhung thêu chữ C unisex nam nữ chống nắng phong cách thời trang, cá tính",49000,98000,49000,50
TIKI,balo-va-vali,14596529,"Bộ 2 Pin + Sạc Đôi RAVPower Canon LP-E8 Cho Canon 550D, 600D, 650D, 700D (Hàng Chính Hãng)",649999,649999,0,0
TIKI,phu-kien-thoi-trang,42694447,"Dây cột buộc tóc nữ - Combo 5 sp (ngẫu nhiên)",15000,15000,0,0
TIKI,may-anh,22857246,"Gimbal VLOG Pocket chống rung cho Smartphone",1830000,1830000,0,0
TIKI,tui-vi-nu,5003285,"Túi Xách Nữ Cao Cấp Da Thật Elly ET61",1319400,2199000,879600,40
TIKI,may-anh,87730135,"Balun 8MP cho camera quan sát HD/CVI/TVI/AHD",38000,38000,0,0
TIKI,phu-kien-thoi-trang,45859535,"Cài tóc đơn giản thiết kế gợn sóng cá tính",12000,15000,3000,20
TIKI,laptop-may-vi-tinh-linh-kien,571764,"Ổ Cứng HDD Video Seagate SkyHawk 1TB ( ST1000VX005 ) - Hàng chính hãng",1550000,1550000,0,0
TIKI,laptop-may-vi-tinh-linh-kien,136594496,"Bàn phím dành cho Laptop Dell Latitude E6410 - Hàng Nhập Khẩu",386000,436000,50000,11
TIKI,balo-va-vali,4902343,"Balo Đi Học",175000,175000,0,0
TIKI,ngon,117576472,"[Chỉ giao HN] - Vụn Cá Hồi Có Da - 1Kg 2 Túi Hút Chân Không",409000,409000,0,0
TIKI,tui-vi-nu,87389694,"TÚI XÁCH NỮ, TÚI ĐEO CHÉO TRẦN TRÁM KHÓA GẬP GR 454",92000,92000,0,0
TIKI,dong-ho-va-trang-suc,194784091,"Giá Đỡ Đồng Hồ Đeo Tay Hộp Đựng Đồng Hồ Trong Suốt Chống Bụi Trang Trí Decor GDDH Office Chill",235000,235000,0,0
TIKI,laptop-may-vi-tinh-linh-kien,68174369,"Lô ép máy in Canon 2900 Dũng cho máy in Canon 2900... HP 1010/1020",79900,79900,0,0
TIKI,laptop-may-vi-tinh-linh-kien,82842584,"Bao Lụa máy in Canon 2900, 3300,6030,6000, 214DW, Hp 1320, P2035, P1102, M127 chất lượng, giá rẻ",27300,27300,0,0
TIKI,tui-vi-nu,16259917,"Túi xách thời trang nữ đeo chéo da mềm 3 ngăn",75000,75000,0,0
TIKI,balo-va-vali,4713061,"Tripod Weifeng 6663A - Hàng Nhập Khẩu",914999,914999,0,0
TIKI,laptop-may-vi-tinh-linh-kien,188844743,"Máy Chiếu Mini Android LED Y9 CP350 Smart Projector",4140000,4140000,0,0
TIKI,tui-vi-nu,167599223,"Túi xách nữ thời trang cao cấp",315000,350000,35000,10
TIKI,balo-va-vali,151488694,"Balo nữ đi học thời trang Ulzzang Hàn Quốc, cặp đẹp dễ thương, Balo Đi Học, Balo học Sinh HÀN QUỐC VOKIKOSOCITY",101000,101000,0,0
TIKI,laptop-may-vi-tinh-linh-kien,173640721,"Kềm bấm mạng RJ45 / RJ11 Ugreen 70683 6P / 8P Màu Xanh Đen NW136 Hàng chính hãng",219000,219000,0,0
TIKI,phu-kien-thoi-trang,132018792,"Thắt lưng nam, dây nịt nam da bò 3 lớp Bụi Leather L105 - Khóa tự động, nhiều mặt khóa tùy chọn - Bảo hành 24 tháng",225000,412000,187000,45
TIKI,giay-dep-nu,161393283,"Xịt Khử Mùi Giày Dép, Khử Mùi Hôi Chân, Khử Mùi Tủ Giày Cao Cấp RENEWILL 100 ML",95000,95000,0,0
TIKI,dong-ho-va-trang-suc,51011088," Khuyên Tai Nam Dây Xích Dài Hình Chiếc Lá",43000,43000,0,0
TIKI,may-anh,14258461,"Dây đeo máy ảnh Peak Design Slide Camera Strap SL-BK-3 (Black) - Hàng Chính Hãng",1899999,1899999,0,0
TIKI,laptop-may-vi-tinh-linh-kien,21345412,"Pin Laptop  dành cho DELL Latitude E7240 zin",800000,800000,0,0
TIKI,phu-kien-thoi-trang,104415407,"1 kẹp tóc hình bướm, phụ kiện chụp ảnh, kẹp tóc hồ điệp đính đá xinh xắn",6000,6000,0,0
TIKI,tui-vi-nu,173983400,"Phụ Kiện Túi Vải YUUMY Cỡ Trung YBVLT",15000,15000,0,0
TIKI,phu-kien-thoi-trang,115086347,"Kính Trong suốt dáng ôm chống nắng uv400, chống gió bụi, giọt bắn bảo vệ mắt tối đa",36000,38000,2000,5
TIKI,balo-va-vali,59373132,"Balo thể thao Mi Casual Sports Backpack - Hàng chính hãng",499000,690000,191000,28
TIKI,tui-vi-nu,68527197,"Túi xách tote vải Túi Tote Túi Vải Nữ Túi Đeo Chéo Hàn Quốc ",51300,51300,0,0
TIKI,balo-va-vali,189456989,"Balo Laptop 15.6 Inch Chống Nước, Rộng Rãi Reeyee RY102B - Hàng Chính Hãng",993000,1155000,162000,14
TIKI,tui-vi-nu,102399926,"Túi xách đeo chéo nữ nhỏ dạo phố xinh xắn MN105",99000,99000,0,0
TIKI,laptop-may-vi-tinh-linh-kien,57061399,"Sạc dành cho Laptop Asus K46, K46C, K46CA Adapter 19V-3.42A",228995,228995,0,0
TIKI,tui-vi-nu,193715166,"Túi Xách Nữ, Túi Đeo Chéo Nữ Đeo Vai Kẹp Nách Đi Chơi Phong Cách Hàn Quốc",125000,125000,0,0
TIKI,balo-va-vali,77531765,"Balo nữ đa năng Classic Diamond - Hàng cao cấp",405000,450000,45000,10
TIKI,phu-kien-thoi-trang,51298483,"Thắt lưng nữ Spring 4cm, Dây nịt nữ DN20032403",83600,88000,4400,5
TIKI,phu-kien-thoi-trang,118685789,"Thắt Lưng Nam,Dây Nịt Nam Da Bò Thật Mặt Khóa Tự Động TLNA2057a",238000,238000,0,0
TIKI,dong-ho-va-trang-suc,56113733,"Combo 2 cái charm bạc hình mặt cú mèo treo - Ngọc Quý Gemstones",118000,200000,82000,41
TIKI,balo-va-vali,4755397,"Bracket Đuôi Gắn 2 Đèn Chụp Sản Phẩm - Hàng Nhập Khẩu",199000,199000,0,0
TIKI,may-anh,14901551,"02 Kẹp phông nền Background studio 6 inch siêu cứng - Hàng nhập khẩu",79000,79000,0,0
TIKI,phu-kien-thoi-trang,54087129,"Kính lão thị trung niên sẵn độ Nhat Ban cao cấp 139KV",149000,149000,0,0
TIKI,balo-va-vali,193200599,"Balo Laptop Chất Liệu Oxford Chống Thấm Nước, Balo Du Lịch Nam Nữ Nhiều Ngăn Chứa Đồ Rộng Rãi, Balo Đi Chơi, Du Lịch, Dã Ngoại",270000,270000,0,0
TIKI,balo-va-vali,6933039,"Chân Nhện Joby 3K + Joby X - Hàng Chính Hãng",1899999,1899999,0,0
TIKI,may-anh,33145506,"Monitor HD 1280×800 IPS 7 inch FW759 ",3150000,3150000,0,0
TIKI,laptop-may-vi-tinh-linh-kien,117094248,"Pin thay thế dành cho Laptop Dell Latitude E6520 - Hàng Nhập Khẩu ",431000,481000,50000,10
TIKI,tui-vi-nu,87100103,"Balo thời trang, balo đi học, đựng laptop Túi Tote Thời Trang Cúc Hoạ Mi Best Of Me balo nữ vải",75000,75000,0,0
TIKI,laptop-may-vi-tinh-linh-kien,181681006,"Máy Đếm Tiền Oudis 6900B Nhỏ Gọn Dùng Cho Cửa Hàng - Hàng Chính Hãng",2800000,2800000,0,0
TIKI,tui-vi-nu,262692471,"Túi Xách Nữ Thời Trang Cao Cấp Elly EL2",1049300,1499000,449700,30
TIKI,balo-va-vali,71537574," Vali kéo Linex TSA AMERICAN TOURISTER - MỸ : Tích hợp khóa số TSA Bánh xe đôi 360 độ êm nhẹ",1938000,3200000,1262000,39
TIKI,balo-va-vali,269902564,"Vali du lịch Sea Choice Vỏ cứng Chất liệu ABS có tặng hành lý Túi du lịch miễn phí Size 20/24/28 có khóa TSA/Dây kéo YKK - Bảo hành 5 năm",1024413,1024413,0,0
TIKI,balo-va-vali,272828259,"Balo Nữ Thời Trang công sở phong cách Hàn Quốc cao cấp – BLNN9032",520000,1050000,530000,50
TIKI,laptop-may-vi-tinh-linh-kien,38288901,"Kệ Đựng Thẻ Chấm Công Thẻ Giấy - Hàng Nhập Khẩu",250000,250000,0,0
TIKI,may-anh,103998078,"CAMERA EZVIZ IP WIFI C6N 2.0MPX ,KÈM THẺ NHỚ 128G HÀNG CHÍNH HÃNG.",650000,650000,0,0
TIKI,dong-ho-va-trang-suc,20174075,"Dây chuyền Mặt Phật Phổ Hiền Bồ Tát_Mặt Phật đá phong thủy_ Phật bản mệnh, Phật hộ mệnh cho tuổi Thìn_Mặt Phật Đá Núi Lửa Obsidian (3,3 x 5 cm)",90000,90000,0,0
TIKI,balo-va-vali,42435298,"Camera Hành Trình Ghi Lại 3 Chiều Phía Trước Phía Sau Gương Chiếu Hậu",429000,429000,0,0
TIKI,laptop-may-vi-tinh-linh-kien,11119385,"Hộp mực 35A/85A, hộp mực HP LaserJet P1005 P1006 Canon 3050, Có lỗ đổ mực, mực thải",116500,116500,0,0
TIKI,may-anh,10023288,"Chân máy (Tripod) máy ảnh, điện thoại Weifeng WT-3642B - Hàng Nhập Khẩu",599000,599000,0,0
TIKI,phu-kien-thoi-trang,121040096,"Kính mát, Kính râm Solex 14K Tròng Thủy Tinh Fullbox Phụ Kiện - Có thể đi Ngày và Đêm",437000,460000,23000,5
TIKI,dong-ho-va-trang-suc,74744560," Nhẫn bạc nữ đá thạch anh tím mệnh hỏa. thổ - Ngọc Quý Gemstones",500000,710000,210000,30
TIKI,balo-va-vali,160559988,"Gimbal chống rung Zhiyun Weebill 2 Hàng Chính Hãng",12990000,12990000,0,0
TIKI,may-anh,135389705,"Combo 5 Cáp POE Camera Loại Tốt - Chuyển Nguồn Camera Bằng dây lan POE",87789,87789,0,0
TIKI,dong-ho-va-trang-suc,3973363,"Combo 4 Vòng Đeo Tay Chân Chỉ Đỏ Phong Cách Cho Nam Nữ (Free Size)",18000,18000,0,0
TIKI,may-anh,84086662,"Mic thu âm BOYA BY-WM3U cho điện thoại Type-C hàng chính hãng.",2499000,2499000,0,0
TIKI,laptop-may-vi-tinh-linh-kien,6094265," Cáp mạng Cat6 UTP 24AWG đầu bọc kim loại dài 3m UGREEN NW101 - Hàng chính hãng",80000,104000,24000,23
TIKI,balo-va-vali,106887316,"ĐẦU ĐỌC THẺ NHỚ LOẠI ĐA NĂNG CHẤT LIỆU NHÔM LOẠI 1",35000,35000,0,0
TIKI,laptop-may-vi-tinh-linh-kien,36326675,"Nguồn máy tính Cooler Master  MWE 650 BRONZE V2 - 80 Plus BRONZE - Hàng chính hãng",1830000,1830000,0,0
TIKI,dong-ho-va-trang-suc,48038524,"Vòng chỉ đỏ Tây Tạng may mắn (CD55)",19000,19000,0,0
TIKI,tui-vi-nu,72626877,"Túi Tote nữ túi đeo vai túi xách tote túi đeo chéo Hàn Quốc túi vải đeo vai kẹp nách",40980,40980,0,0
TIKI,may-anh,195948769,"Camera Hành Trình Ô Tô DDPAI N3 Độ Phân Giải 2K Cảnh Báo Làn Đường Giám Sát 24 Giờ, Định Vị GPS Hiển Thị Tốc Độ, Hỗ Trợ Bộ Nhớ Lên Tới 128GB - Hàng Chính Hãng",1899000,3789000,1890000,50
TIKI,tui-vi-nu,90375417,"Ví nữ mini đựng tiền dễ thương hình gấu có thể làm móc khóa siêu đáng yêu da mềm giá rẻ V12",120000,120000,0,0
TIKI,may-anh,4688979,"Shoot 360 Panoramic Gimbal Head For Tripod - Hàng Nhập Khẩu",999999,999999,0,0
TIKI,dong-ho-va-trang-suc,111035219,"Dây chuyền inox nam kiểu bông dừa khít 4mm đẹp, không đen, không gỉ, chuẩn thời trang",59000,59000,0,0
TIKI,dong-ho-va-trang-suc,163940818,"[1 Hạt] 9MM Đá Mặt Trăng, Moonstone Tự Nhiên Ánh Cầu Vồng Loại A, Vòng Tay Phong Thuỷ, Chuỗi Hạt, Mệnh Kim, Thuỷ - Bead Art",140000,140000,0,0
TIKI,tui-vi-nu,44155709,"Ví nữ cầm tay thời trang YUUMY YV18",159000,270000,111000,41
TIKI,balo-va-vali,184505940,"Túi đựng mỹ phẩm Bamozo trong suốt có quai cao cấp",29000,64000,35000,55
TIKI,tui-vi-nu,114411570,"Móc khóa thời trang LATA MK6",95000,150000,55000,37
TIKI,tui-vi-nu,190320302,"Túi xách túi đeo vai nữ thời trang cao cấp phong cách mới",351000,390000,39000,10
TIKI,may-anh,194075173,"Camera Wifi Trong Nhà EZVIZ TY1 Full HD 1080P Quay Quét 355 độ - Đàm Thoại 2 Chiều - Hàng Chính Hãng",470000,470000,0,0
TIKI,tui-vi-nu,73726268,"Túi Xách Đeo Chéo Vải Dù Chống Nước, Chống Xước Cao Cấp",59000,59000,0,0
TIKI,laptop-may-vi-tinh-linh-kien,114365955,"Sạc cho Laptop MSI PS42 8RA",284995,284995,0,0
TIKI,balo-va-vali,94341802,"Camera nội soi siêu rẻ 7mm - Chống nước IP67 (Đen)",269900,269900,0,0
TIKI,tui-vi-nu,160314561,"Túi Xách Nữ Kẹp Nách Chính Hãng MICOCAH Đeo Chéo Đeo Vai Dáng Công Sở Thời Trang Da Lộn Sang Trọng Đẹp Giá Rẻ MC41",429000,429000,0,0
TIKI,balo-va-vali,98736495," Hộp chụp ảnh sản phẩm Studio box 80 x 80cm",2340000,2340000,0,0
TIKI,laptop-may-vi-tinh-linh-kien,199109494,"Ram Laptop 8GB DDR3L bus 1600 (12800S) ram dùng cho laptop",359000,359000,0,0
TIKI,tui-vi-nu,83479525,"Ví dài cầm tay nữ phong cách dễ thương trẻ trung YUUMY YV35",175000,320000,145000,45
TIKI,phu-kien-thoi-trang,164021778,"Kính Râm, Kính Mát Nam, Kính Thời Trang Nam Nữ Tròng Kính Polarized Chống Chói Chất Liệu Magie AK005 - Aoron",180000,180000,0,0
TIKI,tui-vi-nu,129863919,"Túi vải tote, túi vải canvas trơn nhiều màu",28000,28000,0,0
TIKI,laptop-may-vi-tinh-linh-kien,109890006,"Nguồn 12V-2A Dùng Cho TVBox, Camera, Router, Modem chất lượng cao",60000,60000,0,0
TIKI,tui-vi-nu,159725474,"Túi xách đa năng May 10 (giao màu ngẫu nhiên)",35000,35000,0,0
TIKI,phu-kien-thoi-trang,145242894,"Băng đô cài tóc, Bờm cài tóc cao cấp họa tiết phối nơ xinh xắn cho nữ, style Hàn Quốc - Culi accessories",85000,85000,0,0
TIKI,may-anh,57509877,"Ống nhòm 15x50 ( ỐNG NHÒM SIÊU NÉT, NHÌN SIÊU XA, CÓ THƯỚC ĐO ) - HÀNG NHẬP KHẨU",4500000,4500000,0,0
TIKI,may-anh,94582860,"CAMERA MINI CẦM TAY FULL HD CHO BÉ YÊU VUI CHƠI",580000,580000,0,0
TIKI,tui-vi-nu,84229853,"Túi xách nữ thêu hoa túi xách công sở thanh lịch sang trọng phong cách Hàn Quốc",219000,219000,0,0
TIKI,phu-kien-thoi-trang,50976132,"Kinh gọng Mắt vuông Trong suốt 2 chấm thời trang",45000,50000,5000,10
TIKI,dong-ho-va-trang-suc,57419406,"VÒNG TAY HUYẾT ÁP  NHẬT BẢN-HÀNG NHẬP KHẨU",498998,498998,0,0
TIKI,may-anh,10136067,"Dây máy ảnh đeo cổ  thao tác nhanh Quick Release bản 2cm",179000,179000,0,0
TIKI,balo-va-vali,101628379,"Camera Giám Sát Thông Minh Xiaomi PTZ Phiên Bản 2K. Hồng Ngoại Nhìn Ban Đêm Độ Nét Cực Cao - Bản Quốc Tế - Hàng chính hãng",1290000,1290000,0,0
TIKI,giay-dep-nu,72306825,"Dép nữ quai ngang 1 bản da bò đế đúc cao cấp Trường Hải QNN01263",239000,299000,60000,20
TIKI,may-anh,5524529,"Camera Hành Trình 2570 Góc Rộng 8X Chất Lượng Cao Elitek - Hàng Nhập Khẩu",524900,524900,0,0
TIKI,may-anh,110692872,"Camera wifi ngoài trời DAHUA IMOU Bullet 2 4MP IPC-F42FEP hàng chính hãng",1009900,1009900,0,0
TIKI,may-anh,4712497,"Adapter Chuyển Chân Flash Thành Chân Ốc Tripod - Hàng Nhập Khẩu",89000,89000,0,0
TIKI,may-anh,4713507,"Ống Kính Yongnuo 50mm F1.8 Cho Nikon - Tặng Kèm Loa Che Nắng HB-47 - Hàng Nhập Khẩu",1999000,1999000,0,0
TIKI,tui-vi-nu,68238372,"Bóp ví nữ dài cầm tay kiểu dáng thanh lịch, thời trang, đựng vừa điện thoại màn hình lớn, thêm chức năng chống quét thẻ cực đặc biệt",269000,269000,0,0
TIKI,laptop-may-vi-tinh-linh-kien,42561588,"Hộp Mực Premium TN-2280 Cho Máy In Brother HL 2240/ DCP-7060D/ MFC-7360N - Hàng Nhập Khẩu",118000,118000,0,0
TIKI,balo-va-vali,195342778,"Phone Camera Lens, 5 In 1 Telephoto Lens Full Kit Japan - Home and Garden",756000,756000,0,0
TIKI,balo-va-vali,115572780,"Vali kéo du lịch SUNNY SV05 size 20 - nhựa dẻo ABS, khóa số an toàn",449000,800000,351000,44
TIKI,may-anh,45830277,"Adaptor - Nguồn 12V-2A cho camera quan sát",34000,34000,0,0
TIKI,balo-va-vali,3428585,"Hộp Chụp Sản Phẩm Có Đèn LED (40 x 40 cm)",359000,359000,0,0
TIKI,phu-kien-thoi-trang,180340635,"Dụng cụ búi tóc nữ ( Thái Lan )  - 2 cây ",31000,45000,14000,31
TIKI,balo-va-vali,4707929,"Bộ Vệ Sinh Dành Cho Máy Ảnh DSLR Nikon (Đen) - Hàng Nhập Khẩu",89999,89999,0,0
TIKI,phu-kien-thoi-trang,171184643,"Khẩu trang vải kiểu che tai bo tròn Chất liệu vải dày 3 lớp Thêu sọc vuông nhỏ, Chống nắng, Chống bụi, Bảo vệ sức khỏe",17000,17000,0,0
TIKI,balo-va-vali,4727759,"Túi Đựng Chân Đèn Tripod - Hàng Nhập Khẩu",259000,259000,0,0
TIKI,balo-va-vali,48838236,"Balo Nam Nữ Phối Da Thời Trang Có Cổng Sạc Praza - BLTK181",219000,299000,80000,27
TIKI,balo-va-vali,120114834,"VALI KHUNG NHÔM SIZE 20,24,28 MỚI 2021",850000,850000,0,0
TIKI,phu-kien-thoi-trang,132956229,"GĂNG TAY LEN NAM NỮ Giữ ẩm Chống nắng Cụt ngón Gloves",14000,14000,0,0
TIKI,balo-va-vali,23418098,"Balo Đeo Chéo Thời Trang Nam YBAC2",195000,310000,115000,37
TIKI,balo-va-vali,72802036,"Đèn Flash Yongnuo 14EX II TTL Macro Ring Flash Kit for Canon Hàng nhập khẩu",2999000,2999000,0,0
TIKI,phu-kien-thoi-trang,170354367,"Thắt lưng nam cao cấp, dây nịt nam thời trang khóa tự động dây da bền đẹp - Thiết kế cách điệu nam tính và lịch lãm",278000,278000,0,0
TIKI,balo-va-vali,113391694,"Bộ kết nối điện thoại thông minh đa năng, cao cấp HookUpz 2.0, IS-200 - Hàng chính hãng",2080000,2080000,0,0
TIKI,phu-kien-thoi-trang,155464688,"Nón mũ len khăn choàng nam thời trang Hàn Quốc don22010402",144000,169000,25000,15
TIKI,laptop-may-vi-tinh-linh-kien,15338785,"Cuộn Giấy In Hóa Đơn Cho Máy In Nhiệt Khổ K80 Phi 80 Cuộn Lớn",14400,14400,0,0
TIKI,phu-kien-thoi-trang,52599551,"Tóc giả cột xoăn 48cm D15 FREESHIP buộc tóc giả, buộc xoăn tóc giả, tóc giả buộc, cột tóc giả",49000,49000,0,0
TIKI,dong-ho-va-trang-suc,54815750,"Vòng Tay Trầm Hương 108 Hạt Từ Trầm Tốc Lào Tự Nhiên",199000,199000,0,0
TIKI,dong-ho-va-trang-suc,111039158,"Nhẫn inox bản mo tròn 4mm đẹp, khồng đen, hợp thời trang - Tặng hộp đựng xinh xắn (01 chiếc)",19000,19000,0,0
TIKI,balo-va-vali,115564329,"Vali kéo du lịch SUNNY TONAGO size 24 nhựa dẻo ABS, Chống va đập, khóa số an toàn",499000,900000,401000,45
TIKI,phu-kien-thoi-trang,91089399,"Kính lão thị viễn thị sieu dẻo HAI TRÒNG nhìn xa và gần cực tiện gọng titan siêu bền và cao cấp sang trọng",199000,199000,0,0
TIKI,balo-va-vali,72531988,"Thẻ nhớ 32Gb chính hãng DSS",86000,86000,0,0
TIKI,balo-va-vali,46564115,"Camera an ninh ngoài trời chống nước - Camhi HD 720P Bền Tốt - Có âm thanh và màu sắc ban đêm",680000,680000,0,0
TIKI,may-anh,68641829,"Hộp studio chụp sản phẩm tích hợp đèn Led KK1B",299000,388900,89900,23
TIKI,tui-vi-nu,46643459,"Túi xách nữ thời trang công sở Châu âu",179000,179000,0,0
TIKI,phu-kien-thoi-trang,114778740,"Mũ nồi da - nón beret thuỷ thủ thời trang, phong cách Hàn",112000,125000,13000,10
TIKI,dong-ho-va-trang-suc,35450693,"Nhẫn Nam Chú Đại Bi Titan Không Đen TT 1425",98999,98999,0,0
TIKI,balo-va-vali,55961093,"Phông vải key hình, phông nền studio xanh dương",330000,330000,0,0
TIKI,ngon,172161477,"Bánh mì gối đen Fresh Garden ",44000,44000,0,0
TIKI,phu-kien-thoi-trang,25270554,"Găng tay xỏ ngón chống nắng - Đen",11000,11000,0,0
TIKI,dong-ho-va-trang-suc,42741622,"Đồng hồ nam MINI FOCUS 0052G phong cách trẻ, chống nước, có dạ quang  | Kèm hộp da cao cấp",769000,769000,0,0
TIKI,laptop-may-vi-tinh-linh-kien,28077522,"Miếng Phủ Bàn Phím Laptop 13 - 14 inch Silicon Chống Nước, Chống Bụi Bẩn",30000,30000,0,0
TIKI,may-anh,3307269,"Tản sáng Lambency 2 màu",139000,139000,0,0
TIKI,phu-kien-thoi-trang,19294013,"Mắt Kính Bảo Hộ Trong Suốt Mk03",40000,40000,0,0
TIKI,phu-kien-thoi-trang,77094487,"Găng tay ống chống nắng UPF50+ xám Zigzag GLV00202",179000,179000,0,0
TIKI,dong-ho-va-trang-suc,70020000,"Đồng hồ trẻ em Silicon nhiều màu, đồng hồ điện tử thông minh cho bé E132",22000,22000,0,0
TIKI,giay-dep-nu,59235756,"Dép massage đi trong nhà  theo huyệt đạo MT9( coban)-38",89000,89000,0,0
TIKI,dong-ho-va-trang-suc,160419252,"Pin Đồng Hồ Maxell AG0 SR521SW 379 1.55V Nhật Bản",65000,65000,0,0
TIKI,dong-ho-va-trang-suc,48116808,"Vòng tay gốm thời trang Vintage 3 dây VGOM23 (Giao mầu ngẫu nhiên)",19000,19000,0,0
TIKI,tui-vi-nu,57879427,"Túi bao tử liên kết, đeo chéo nữ, chất đẹp, màu sắc đơn giản",55000,55000,0,0
TIKI,phu-kien-thoi-trang,73401448,"GĂNG TAY LEN NAM BAO TAY LEN NAM NỮ CẢM ỨNG ĐIỆN THOẠI  DONA20112701",83000,99000,16000,16
TIKI,laptop-may-vi-tinh-linh-kien,92441510,"Máy in mã vạch nhiệt Xprinter XP 420B - Kết nối USB+LAN - ứng dụng thương mại điện tử, in tem, nhãn siêu thị, tạp hóa - Hàng chính hãng",1629000,1790000,161000,9
TIKI,laptop-may-vi-tinh-linh-kien,57243620,"Tenda AC23 - Router Wifi Băng Tần Kép AC2100 MU-MIMO - Hàng Chính Hãng",1030000,1030000,0,0
TIKI,tui-vi-nu,68219008,"Túi xách thời trang nữ kiểu dáng công sở KQ09",162000,162000,0,0
TIKI,balo-va-vali,188897625,"Đèn Tiktok Hoàng Hôn Chuyển Đổi 16 Màu Đặt Biệt Đều Khiển Remot - HÀNG LOẠI 1- HÀNG CHÍNH HÃNG MINIIN",78000,89000,11000,12
TIKI,phu-kien-thoi-trang,23485267,"Bờm tóc bản to 1 mầu vải cao cấp hàng loại 1 mẫu siêu Hot có chọn mầu BN46",42000,42000,0,0
TIKI,balo-va-vali,171437261,"Combo 6 Túi Đựng Đồ Du Lịch xếp đồ gọn gàng trong vali Chống Thấm GD40-6Tvali",78996,78996,0,0
TIKI,may-anh,62333164,"Đèn Flash Godox V860II cho máy ảnh Canon hàng chính hãng.",3135000,3135000,0,0
TIKI,phu-kien-thoi-trang,114709404,"Nón bucket vành cụp trơn - mũ tai bèo Ulzzang phong cách, cá tính Unisex nam nữ",37500,75000,37500,50
TIKI,phu-kien-thoi-trang,58108287,"Dây buộc tóc Scrunchies hologram blink blink HD38",17000,17000,0,0
TIKI,may-anh,40429496,"1 PIN 1 SẠC MÁY ẢNH CANON LP-E6, LP-E6N CHÍNH HÃNG RAVPOWER RP-BC003",549999,549999,0,0
TIKI,ngon,154492605,"Nho sữa Hàn Quốc - 1KG",1100000,1100000,0,0
TIKI,phu-kien-thoi-trang,75621781,"Khăn turban satin vuông phối màu độc đáo size 48*48cm",45000,45000,0,0
TIKI,dong-ho-va-trang-suc,127371586,"Nước rửa trang sức bạc PDJ - Trang sức PDJ - SP000415 - dung tích 50ml",20000,20000,0,0
TIKI,phu-kien-thoi-trang,157082944,"Mũ cối chống nước chịu lực chịu va đập tốt tặng kèm sao",99000,99000,0,0
TIKI,phu-kien-thoi-trang,129793088,"Thắt lưng dây nịt nữ đẹp màu trắng thời trang Hàn Quốc dona21101101",94000,99000,5000,5
TIKI,balo-va-vali,6990697,"Tấm đế Plate P200 gắn glidecam thanh trượt dolly slider",199000,199000,0,0
TIKI,ngon,162475475,"[Chỉ giao HN] - Ba chỉ bò Mỹ bào - 500gr",160000,160000,0,0
TIKI,laptop-may-vi-tinh-linh-kien,57522011,"Sạc dành cho Laptop Dell Latitude 13 7370 Adapter 20V-2.25A Type-C",461995,923990,461995,50
TIKI,balo-va-vali,35178687,"Bộ 2 Pin Và Sạc Kép RAVPower Cho FujiFilm NP-W126S X-A X-E X-H X-T X-M X-Pro Series - Hàng Nhập Khẩu",625999,625999,0,0
TIKI,ngon,172300001,"Trà gừng Cozy ",51000,51000,0,0
TIKI,balo-va-vali,33233535,"Bộ pin sạc  EN-EL15 cho máy ảnh Nikon",849999,849999,0,0
TIKI,ngon,184634191,"Gà ta Chí Linh",170000,170000,0,0
TIKI,phu-kien-thoi-trang,163570672,"[Mới][Hàng cao cấp] Thắt lưng da nam cao cấp EMRENEW POLO- dây nịt da bò 2 lớp -Full hộp đựng cao cấp",475000,950000,475000,50
TIKI,tui-vi-nu,55022823,"Túi xách nữ đeo chéo hàn quốc đẹp cao cấp Vimona TX20 in vân chìm sang chảnh",128000,128000,0,0
TIKI,phu-kien-thoi-trang,56048659,"Nón cói rộng vành thời trang, mũ cói móc đi biển cao cấp",97000,97000,0,0
TIKI,laptop-may-vi-tinh-linh-kien,117094412,"Pin dành cho Laptop Dell Vostro 15 3568 - Hàng Nhập Khẩu ",650000,700000,50000,7
TIKI,ngon,118896401,"[Chỉ giao HN] Kem hộp vị Rum Nho - Rum Grapes",199000,199000,0,0
TIKI,phu-kien-thoi-trang,164021970,"Kính Mát Nam Mắt Kính Phân Cực Đổi Màu Chống Lóa, Chống Chói Gọng Dẻo Đi Xe Ngày Và Đêm AK018 - Aoron",250000,360000,110000,31
TIKI,dong-ho-va-trang-suc,106391999,"Đầu đột mắt dây đồng hồ - đầu đột thay cắt mắt dây đồng hồ",7000,7000,0,0
TIKI,phu-kien-thoi-trang,40610373,"Tất da dài qua đầu gối cho nữ - Màu da",29000,29000,0,0
TIKI,may-anh,8490373,"Bộ 2 Pin + 1 Sạc đôi Ravpower LP-E6 Cho Canon 5D Mark IV / 5D Mark III / 5DS / 5DS R / 5D Mark II / 6D Mark II / 7D Mark II / 7D / 80D / 70D / 60D (Chính Hãng Ravpower)",774999,774999,0,0
TIKI,phu-kien-thoi-trang,77138066,"Thắt lưng nữ bản nhỏ da khóa đồng cá tính TL68",45000,45000,0,0
TIKI,tui-vi-nu,193384569,"Ví Nữ Thời Trang cao cấp phong cách mới – VNU1002",165000,330000,165000,50
TIKI,balo-va-vali,155997584,"Kính lọc Filter B+W F-Pro 010 UV-Haze E 62mm - Hàng Chính Hãng",849555,849555,0,0
TIKI,phu-kien-thoi-trang,99672288,"️độn búi tóc tròn củ tỏi-búi tóc bonut",20000,20000,0,0
TIKI,dong-ho-va-trang-suc,74234330,"Đồng Hồ Nam OLEVS-2871 Phong Cách Doanh Nhân - Lịch Trăng Sao - Chạy Đủ 6 Kim - Hàng Chính Hãng",790000,790000,0,0
TIKI,ngon,191429045,"Gà ủ muối nguyên con Thanh Thanh Food ",300000,300000,0,0
TIKI,phu-kien-thoi-trang,74176161,"Tất dài cho nữ, tất bắp chân học sinh kẻ sọc",45000,85000,40000,47
TIKI,dong-ho-va-trang-suc,106390688,"Dây Đồng Hồ Vải Dù Zulu Nato size 18mm 20mm",63700,63700,0,0
TIKI,dong-ho-va-trang-suc,73572649,"Dây chuyền đá thạch anh ưu linh trắng hạt 1cm mệnh thủy , kim - Ngọc Quý Gemstones",339000,660000,321000,49
TIKI,ngon,109088607,"[CHỈ GIAO HN] - TÔM LỚT BÓC NÕN VITOT FOOD (500g/khay)",269000,269000,0,0
TIKI,balo-va-vali,73956363,"Balo đi học nam,nữ thời trang hàn quốc unisex chống nước cao cấp",70200,70200,0,0
TIKI,dong-ho-va-trang-suc,81314457,"Đồng hồ nam cao cấp ECONOMICXI chính hãng dây thép lưới đen có lịch ngày - Đẳng Cấp Phái Mạnh ECNS89",278000,278000,0,0
TIKI,may-anh,22634255,"Sạc Godox VC-18 sử dụng cho pin sạc Li-ion Godox VB-18 - Hàng Nhập Khẩu",344999,344999,0,0
TIKI,balo-va-vali,192134657,"Balo laptop sức chứa lớn vải fabric cao cấp hàng chính hãng YVan 0516-1",650000,650000,0,0
TIKI,laptop-may-vi-tinh-linh-kien,188008991," Cap Mạng TP-Link VSP-L502F Cat 5E UTP 100m/305M Dây Cáp Cam - Hàng Chính Hãng",275500,290000,14500,5
TIKI,phu-kien-thoi-trang,107614223,"Găng tay đi xe đạp xe máy nửa ngón ngoài trời thể thao chiến thuật nam chống trượt chống mài mòn quân đội bảo vệ tay",45000,45000,0,0
TIKI,dong-ho-va-trang-suc,160419317,"Pin Đồng Hồ Maxell AG4 SR626SW 377 1.55V Nhật Bản",20000,20000,0,0
TIKI,phu-kien-thoi-trang,174376829,"Thắt Lưng Dây Nịt Nam Cao Cấp Da Bò Quà Tặng Sang Trọng  DT103",252000,280000,28000,10
TIKI,phu-kien-thoi-trang,164582319,"Tất nữ cổ ngắn May 10 mã 11050222042",54000,54000,0,0
TIKI,tui-vi-nu,143292607,"Túi xách đeo chéo nữ tặng dây chuyền ngọc trai dạo phố thời trang phong cách Hàn Quốc",159000,159000,0,0
TIKI,phu-kien-thoi-trang,50329193,"Cài tóc nam nữ",10998,10998,0,0
TIKI,laptop-may-vi-tinh-linh-kien,144916531,"ĐÈN SOI TIỀN OUDIS 09 hàng chính hãng ",650000,650000,0,0
TIKI,dong-ho-va-trang-suc,58261800,"Vòng cổ thời trang phối sắc đỏ cá tính VN34",182000,182000,0,0
TIKI,dong-ho-va-trang-suc,103134752,"dây da đồng hồ apple watch handmade cao cấp",549000,549000,0,0
TIKI,phu-kien-thoi-trang,149714777,"Set 2 Miếng dán tóc Hàn Quốc tự dính - Cố định tóc tiện lợi khi trang điểm và rửa mặt( màu ngẫu nhiên )",25000,25000,0,0
TIKI,laptop-may-vi-tinh-linh-kien,112251523,"Bộ chuyển đổi nguồn 220V sang 12V-5A(DC) (Đen)",143000,143000,0,0
TIKI,ngon,172171417,"Thạch nha đam tươi Đại Lộc ",51000,51000,0,0
TIKI,ngon,193888892,"Đặc Sản Nha Trang - Cá Chỉ Vàng Rim Sốt Chanh Seavy Hộp 200G",82000,85000,3000,4
TIKI,balo-va-vali,24245389,"Ống nhòm ngày chống nước cao cấp Carson JR-042 (10x42) - Hàng chính hãng",6800000,6800000,0,0
TIKI,phu-kien-thoi-trang,84546782,"Thắt Lưng Nam Dây Da Thông Dụng Cho Nam Giới D&D Fashion - chữ S rẻ",45000,90000,45000,50
TIKI,ngon,179711666,"[Chỉ giao HN]  - Túi mix 03 loại hạt cao cấp 4 (óc chó, hạnh nhân, hạt điều) - 500gr",235000,235000,0,0
TIKI,phu-kien-thoi-trang,34464839,"Băng Đô Thể Thao 2 Con Mắt (Màu Đen)",19000,19000,0,0
TIKI,balo-va-vali,37487298,"Camera Yoosee 3.0MPX - Thế hệ mới",350000,350000,0,0
TIKI,may-anh,109581686,"Chân máy quay Coman DF26Q7, Hàng chính hãng",6749999,6749999,0,0
TIKI,dong-ho-va-trang-suc,204231178,"Vòng tay chuỗi tràng 108 hạt phong thủy trầm hương HÀ XÁ vòng đeo tay nam nữ may mắn tài lộc",199000,398000,199000,50
TIKI,phu-kien-thoi-trang,46235521,"Kính râm Mắt vuông thời trang cho Nam và Nữ",133000,140000,7000,5
TIKI,phu-kien-thoi-trang,175885847,"Quần Tất Lưới Thời Trang Cao Cấp - Đẳng Cấp Của Sự Tinh Tế",49000,49000,0,0
TIKI,balo-va-vali,4701087,"Balo Laptop Du Lịch Thời Trang Cao Cấp SAKOS ULTRA 17 Inch (17")",1628000,1628000,0,0
TIKI,may-anh,96869342,"Camera Wifi TP-Link Tapo C310 3MP An Ninh Ngoài Trời Tặng Thẻ nhớ 32GB - Hàng Chính Hãng",990000,990000,0,0
TIKI,phu-kien-thoi-trang,161026777," (LOẠI TỐT) Kính râm kính mắt nam phân cực M31 chống tia uv chói lóa đèn khi lái xe hàng cao câp siêu trong",94000,99000,5000,5
TIKI,ngon,128707153,"[Chỉ giao HN] Thịt bò Wagyu Full Blood 2GR Úc MB9+ - Dẻ sườn rút xương - 1KG",2290000,2290000,0,0
TIKI,phu-kien-thoi-trang,161650237,"Thắt lưng nam da bò nguyên chất phong cách châu âu",513000,570000,57000,10
TIKI,ngon,127509744,"[Chỉ giao HN] Thăn vai bò Mỹ Steak 150gr",152900,152900,0,0
TIKI,dong-ho-va-trang-suc,78282312,"[ SAM Leather ] Dây Đồng Hồ Da Bò - Dây Đeo Đồng Hồ SAM002NW - Dây Da Bò Size 26/24/22/20mm  Có Nhiều Màu Sắc Lựa Chọn Phù hợp Cho Các Loại Đồng Hồ",289000,289000,0,0
TIKI,phu-kien-thoi-trang,48048894,"Kính Râm (Kính Mát) Nam Phân Cực Chống Tia UV Thời Trang Cao Cấp 911",165000,165000,0,0
TIKI,phu-kien-thoi-trang,33511548,"Tất vớ Nữ cổ ngắn cao cấp, tất vớ tuần 7 ngày 7 đôi",54000,54000,0,0
TIKI,phu-kien-thoi-trang,1479017,"[Một cặp] Kính Áp Tròng Dùng 1 Ngày Eye Secret KM1N - Osaka Brown (0 Độ)",60000,70000,10000,14
TIKI,phu-kien-thoi-trang,169517059,"Bờm tóc đính đá Hàn Quốc, bờm tóc đính ngọc trai nhân tạo đẹp xinh xắn dễ thương Hanabi BT02",19000,19000,0,0
TIKI,phu-kien-thoi-trang,147240091,"Thắt Lưng Nam Da Bò Thật Màu Nâu ( Không Đầu Khóa ), Dây Lưng Da Bò 100% DL001N",179000,179000,0,0
TIKI,dong-ho-va-trang-suc,176072893,"Dây Milanese thép dây Huawei GT3 42 mm/ GT3 46mm",90000,90000,0,0
TIKI,ngon,118288047,"[Chỉ giao HN] - Cá Saba Nhật Nguyên Con - Túi 2 Con",139000,139000,0,0
TIKI,may-anh,7527151,"Ống Nhòm Barska Porro 12x50 - Hàng chính hãng",2156000,2156000,0,0
TIKI,ngon,179711746,"[Chỉ giao HN]  - Túi mix 02 loại hạt cao cấp 6 (hạt điều, hạnh nhân)- 500gr",210000,210000,0,0
TIKI,ngon,116553113,"[Chỉ giao HN] - Đuôi Bò Thơm Ngon Đã Làm Sạch - 1Kg",400000,400000,0,0
TIKI,balo-va-vali,186578774,"Balo nam vải canvas cao cấp phong cách mới",297000,330000,33000,10
TIKI,ngon,125452839,"Khâu nhục Tiên Yên - 1 hộp",150000,150000,0,0
TIKI,laptop-may-vi-tinh-linh-kien,74573466,"Hộp mực in HP 05A, 80A, Canon 319 máy in Hp: P2035/P2055/Pro 400 Printer M401/M425, Canon: 6300DN/6650DN/6750...",175000,175000,0,0
TIKI,ngon,184634200,"3G_Chả lá lốt (Thịt heo) 300g",54000,54000,0,0
TIKI,ngon,173337615,"[Chỉ giao HN] - Chả Cốm Hà Nội - 500g",169000,169000,0,0
TIKI,ngon,177714078,"PHÔ MAI MOZZARELLA 100gr (CHỈ GIAO TẠI SÀI GÒN)",29000,29000,0,0
TIKI,ngon,121441567,"[Chỉ Giao HN] Bưởi da xanh Bến Tre (1.4-1.5kg/quả)",99000,99000,0,0
TIKI,ngon,157856328,"[ Chỉ giao HN] - Bánh Chưng Nương Bắc Cẩm thịt 800gram",190000,190000,0,0
TIKI,dong-ho-va-trang-suc,169577869,"Đồng hồ nam DEYROS thiết kế thể thao dây thép lưới đen chạy lịch ngày cao cấp Sporty Design",278000,278000,0,0
TIKI,may-anh,16877159,"Kính thiên văn cao cấp",317000,317000,0,0
TIKI,ngon,185657616,"Tôm sú nguyên con size 20 - 500g",190000,190000,0,0
TIKI,ngon,171833886,"[ Chỉ giao HN] -Snack sấy khô Tim gà 100gr",70000,70000,0,0
TIKI,dong-ho-va-trang-suc,56611852,"Combo 2 cái charm bạc chặn hình đồng tiền - Ngọc Quý Gemstones",178000,300000,122000,41
TIKI,phu-kien-thoi-trang,114660717,"Kính mát thời trang chống nắng gọng sắt tròn K018 unisex nam nữ kính râm thầy bói phong cách, cá tính cool ngầu",31000,62000,31000,50
TIKI,phu-kien-thoi-trang,21166791,"Kính chữ V Hàn Quốc Phong các UNISEX HOT NHẤT HIỆN NAY - Không Hộp - Hàng Nhập Khẩu",48000,80000,32000,40
TIKI,may-anh,58729250,"Ống Kính Viltrox 23mm F1.4 Auto Focus cho Fujifilm Hàng nhập khẩu ",6299000,6299000,0,0
TIKI,phu-kien-thoi-trang,52934937,"Cài tóc nam nữ ",14900,14900,0,0
TIKI,phu-kien-thoi-trang,132955956,"10 ĐÔI GĂNG TAY SIÊU BỀN CHẤT LIỆU LEN Mỏng",55000,55000,0,0
TIKI,ngon,121678003,"[Chỉ Giao HN] Táo Envy 70 (1.2kg - 1.6kg)",199000,199000,0,0
TIKI,phu-kien-thoi-trang,82959305,"Băng đô vải nhung tai mèo dễ thương",42750,45000,2250,5
TIKI,phu-kien-thoi-trang,249873920,"Mũ Lưỡi Trai Thể Thao Chống Nắng Che Nửa Đầu Thời Trang",39000,39000,0,0
TIKI,balo-va-vali,92231824,"Vali kéo Toiis L SAMSONITE RED:Đai khóa chữ X giúp dễ dàng sắp xếp hành lý Hệ thống 4 bánh đôi 360 độ vận hành êm nhẹ,Khóa số tích hợp TSA tiêu chuẩn Hoa Kỳ",5198000,5200000,2000,0
TIKI,ngon,149354838,"[Chỉ giao HN] - Lườn Ngỗng Xông Khói - Món Ngon Từ Nga",99000,99000,0,0
TIKI,tui-vi-nu,174942884,"Túi Xách Nữ Đeo Chéo Siêu Hot, Phối Dây Xích Khuy Cài Chữ H TR68",99000,99000,0,0
TIKI,balo-va-vali,155998016,"Tủ chống ẩm 195 lít Andbon DS-195S -(New model 2022), Hàng chính hãng",7250555,7250555,0,0
TIKI,dong-ho-va-trang-suc,143829162,"Dây đồng hồ da bò Bụi Leather D101- Da thật khâu tay thủ công cao cấp - Bảo hành 12 tháng",185000,284000,99000,35
TIKI,phu-kien-thoi-trang,112733871,"Thắt lưng công sở an bền đẹp loại xịn",175000,350000,175000,50
TIKI,laptop-may-vi-tinh-linh-kien,104466258,"Hộp mực 85a , 35a có lỗ đổ mực và mực thải",116500,116500,0,0
TIKI,phu-kien-thoi-trang,136358052,"Bộ lô bọt biển xốp nhựa cuốn tóc đi ngủ làm xoăn tóc quấn tóc tiện dụng",11000,11000,0,0
TIKI,tui-vi-nu,177063088,"Túi xách nữ 2 trong 1 thời trang cao cấp phong cách mới",387000,430000,43000,10
TIKI,ngon,116553117,"[Chỉ giao HN] - Trứng Gà Non Nguyên Chùm - Túi 1Kg Hút Chân Không",289000,289000,0,0
TIKI,may-anh,105106563,"Kính hiển vi kỹ thuật số màn hình lớn HD phóng đại 50-1000 lần zoom mẫu vật siêu nét có giá đỡ đa năng cao cấp (Tặng nút kẹp cao su giữ dây điện-giao ngẫu nhiên)",2042500,2150000,107500,5
TIKI,balo-va-vali,73316920,"Dây đeo vai máy ảnh chống mỏi - MA001",180000,180000,0,0
TIKI,phu-kien-thoi-trang,167395588,"Thắt Lưng Nữ Bản Nhỏ Thời Trang Hàn Quốc Mặt Khóa Kim Loại Hình Tam Giác Trẻ Trung Chất Liệu Da PU TL017 MayHomes Dây Lưng Nữ, Dây Nịt Nữ Đa Năng Bền Chắc Dùng Cho Đầm, Jeans, Quần Âu Và Shorts",55460,59000,3540,6
TIKI,ngon,103955037,"[Chỉ Giao HN] Thanh long trắng - 1KG",29000,29000,0,0
TIKI,balo-va-vali,73669362,"Ống nhòm cao cấp 20-50 - Tặng 2 la bàn mini du lịch",712500,750000,37500,5
TIKI,phu-kien-thoi-trang,73386757,"Kẹp tóc kim loại tam giác trang trí tóc phong cách Vintage",34900,34900,0,0
TIKI,tui-vi-nu,8280980,"Túi Vải Canvas - Pink",121000,169000,48000,28
TIKI,ngon,184634192,"Gà ác tươi tiềm thuốc bắc",51000,51000,0,0
TIKI,ngon,160635047,"[ Chỉ giao HN] - COMBO NGUYÊN LIỆU LÀM GRANOLA",610000,610000,0,0
TIKI,dong-ho-va-trang-suc,58098394,"Nhẫn Nam Khui Bia Tiện Dụng, Được Làm Bằng Thép Không Gỉ, Chắc Chắn, Cứng, Mịn Êm Tay VNS-KBIA69",8000,9000,1000,11
TIKI,dong-ho-va-trang-suc,175213936,"Bông tai dài đính ngọc trai giả thời trang cho nữ",76000,80000,4000,5
TIKI,ngon,172814844,"[Chỉ giao HN] - Chả Ốc - 500g",138000,138000,0,0
TIKI,tui-vi-nu,12206257,"Túi clutch nữ cao cấp da thật ELLY EC18",659400,1099000,439600,40
TIKI,dong-ho-va-trang-suc,204212145,"Vòng tay tròn đơn phong thủy trầm hương HÀ XÁ đeo tay nam nữ may mắn tài lộc",99000,198000,99000,50
TIKI,dong-ho-va-trang-suc,55139324,"Lắc Tay Nữ | Lắc Tay Nữ Bạc S925 Thanh Tú Đơn Giản L2536 - Bảo Ngọc Jewelry",200000,200000,0,0
TIKI,ngon,121662138,"[Chỉ Giao HN] Nho xanh Mỹ - 1kg",250000,250000,0,0
TIKI,ngon,117571828,"[Chỉ giao HN] - Vụn Cá Hồi Bao Xanh Xuất Nhật - 1Kg 2 Túi Hút Chân Không",399000,399000,0,0
TIKI,dong-ho-va-trang-suc,106393508,"Khoá đồng hồ dây da inox đủ size màu vàng giá rẻ nhất thị trường",18000,18000,0,0
TIKI,ngon,122224120,"Chôm Chôm  Kg",50000,50000,0,0
TIKI,ngon,97691546,"[[Chỉ Giao HN]] - Cua hoàng đế tươi sống",6125000,6125000,0,0
TIKI,dong-ho-va-trang-suc,159008604,"[1 Hạt] 9MM Đá Thạch Anh Dâu Tây Hồng ,Strawberry Quartz Tự Nhiên Loại AAA, Phối Vòng Tay Phong Thuỷ, Đá Phong Thuỷ, Chuỗi Hạt, Mệnh Hoả, Thổ - Bead Art",99600,99600,0,0
TIKI,laptop-may-vi-tinh-linh-kien,158774098,"Bánh Răng Sắt Đầu Rulo Sấy (Trục Sấy) Dùng Cho Máy Photocopy Toshiba E355/356/357/455/456/457/...Hàng Chất Lượng Cao, Giá Cạnh Tranh",85000,85000,0,0
TIKI,phu-kien-thoi-trang,136315266," Bao Đeo Tay Điện Thoại Chạy Bộ Thể Dục Siêu Mỏng Nhẹ DT08",37990,37990,0,0
TIKI,dong-ho-va-trang-suc,122310530,"Vòng tay Trầm Hương tự nhiên Bảo Mệnh Trầm - Bình yên, hạnh phúc - Trầm Tốc Việt Nam -Thiên Mộc Hương",813000,990000,177000,18
TIKI,may-anh,155225859,"(Freeship) Camera Hành Trình X-003 Kèm Camera Lùi 12 Megapixcel Hàng Nhập Khẩu Cao Cấp FHD 1080P Sắc Nét",470000,470000,0,0
TIKI,phu-kien-thoi-trang,141644756,"Khuy cài, kẹp cài khăn lụa họa tiết sang trọng, đơn giản, tinh tế",27000,27000,0,0
TIKI,phu-kien-thoi-trang,35216551,"Đai Chống Gù, Đai Chỉnh Hình Lưng, Còng Lưng Cho Cả Nam và Nữ",33000,33000,0,0
TIKI,tui-vi-nu,86561256," Túi đeo chéo nữ    Túi xách hàng Quảng Châu Siêu SANG CHẢNH TD16",90000,90000,0,0
TIKI,may-anh,49994410,"Áo Nhiếp Ảnh Lowepro S&F Technical Vest (S/M) | Chính Hãng",1249999,1249999,0,0
TIKI,ngon,117139104,"Sốt nướng Steak TRF - 200ml",12000,12000,0,0
TIKI,dong-ho-va-trang-suc,44866428,"Bông Tai Nam Khoen Hình Tam Giác Titan Không Đen TT 2425 - 1 Cặp",52000,52000,0,0
TIKI,balo-va-vali,49115547,"Chân tripod mini, giá đỡ điện thoại mini DF228",41890,41890,0,0
TIKI,balo-va-vali,196189335,"Gimbal Zhiyun WEEBILL 3 - Tay cầm chống rung dành cho máy ảnh - Hàng chính hãng",10290000,10290000,0,0
TIKI,phu-kien-thoi-trang,180329920,"Khẩu Trang Vải Full Linen 3 lớp NEMO, chống nắng, kháng khuẩn, lọc bụi - KTFL",40000,40000,0,0
TIKI,ngon,186279132,"Phô mai que rong biển Đôi Đũa Vàng 300g thơm ngon bổ dưỡng",249000,249000,0,0
TIKI,phu-kien-thoi-trang,20650327,"Kính 6 in 1 kính râm form vuông kính mát cận kính đi biển chống tía UV",167200,176000,8800,5
TIKI,dong-ho-va-trang-suc,11892302,"Vòng Cổ Dây Chuyền Mặt Hoa Ren Nhiều Màu Ép Thủy Tinh Resin",19000,19000,0,0
TIKI,tui-vi-nu,73716485,"Túi tote vải Túi Tote Túi Vải Nữ Túi Đeo Chéo Hàn Quốc",55900,55900,0,0
TIKI,dong-ho-va-trang-suc,161522894,"Dây vải thể thao 20mm dành cho đồng hồ Samsung galaxy watch 4",149000,149000,0,0
TIKI,ngon,164428758,"[ Chỉ giao HN] - Miến ngan ăn liền - 95g",16000,16000,0,0
TIKI,laptop-may-vi-tinh-linh-kien,170943364,"Nhãn In đa lớp Tz2-221 - Đen nền trắng 9mm x 8m- hàng chính hãng",128800,140000,11200,8
TIKI,phu-kien-thoi-trang,162036350,"Set Thun Cột Tóc Co Giãn Hanviet Mềm Mại Đàn Hồi",5700,5700,0,0
TIKI,ngon,120264065,"[Chỉ giao HN] - Set Xôi Chiên Phồng - 3 Thanh",199000,199000,0,0
TIKI,ngon,144934483,"[ Chỉ giao HN] - Ngọc kê gà Đông Tảo -1kg",1300000,1300000,0,0
TIKI,ngon,147923382,"[Chỉ giao HN] - Bộ Tràng Trứng Tim Gà Ngon - 500g",139000,139000,0,0
TIKI,balo-va-vali,192134398,"Balo laptop đa năng màu đen trơn hàng chính hãng YVan 213",580000,580000,0,0
TIKI,phu-kien-thoi-trang,136368044,"Miếng dán tóc dán mái tự dính nhũ kim tuyến, size to giúp cố định tóc cho trang điểm, đắp mặt Link 2",15000,15000,0,0
TIKI,phu-kien-thoi-trang,107893845,"Kính viễn vọng đi du lịch ngắm cảnh đêm phóng đại 16x-40x siêu nét, chụp ảnh quay video bằng điện thoại chất lượng cao",3385800,3564000,178200,5
TIKI,phu-kien-thoi-trang,32547238,"Hộp chụp sản phẩm 40x40 khóa bấm cố định tích hợp 70 bóng đèn Led",323000,340000,17000,5
TIKI,phu-kien-thoi-trang,199600952,"Mái che cho camera ngoài trời băng nhựa + Kèm chân đế nhựa",30000,30000,0,0
TIKI,phu-kien-thoi-trang,70130149,"Ống Nhòm Đồ Chơi Cho Bé Học Hỏi Khám Phá Thế Giới Bên Ngoài tặng bé 1 bút bi hình viên thuốc mặt cười (giao màu ngẫu nhiên)",46000,46000,0,0
TIKI,phu-kien-thoi-trang,58614222,"Combo 2 pin 1 sạc đôi Kingma LP-E17 hàng chính hãng.",549999,549999,0,0
TIKI,phu-kien-thoi-trang,4688933,"Chân Máy Ảnh Tripod Chân Nhện Cao 16cm - Hàng Nhập Khẩu",89000,89000,0,0
TIKI,phu-kien-thoi-trang,16258285,"Pin Cho Máy Ảnh Cho  Canon LP-E6 ",162000,201000,39000,19
TIKI,phu-kien-thoi-trang,7017323,"Đèn Flash Godox V860II TTL For Nikon - Hàng nhập khẩu",3110000,3110000,0,0
TIKI,phu-kien-thoi-trang,54023400,"Camera Ezviz C6N (CV246 1080P) + Tặng thẻ nhớ Hikvision 64GB và chân đế - Hàng Chính Hãng",550000,550000,0,0
TIKI,phu-kien-thoi-trang,51419584,"Camera giám sát ngoài trời Blurams Outdoor Pro A21C - Hàng chính hãng",1390000,1390000,0,0
TIKI,phu-kien-thoi-trang,97599424,"Ống Kính Sony FE 50mm F1.2 GM - Hàng Chính Hãng",47990000,47990000,0,0
TIKI,phu-kien-thoi-trang,100261517,"Chân máy ảnh Kết hợp chân đơn Beike Q999 New, Hàng Nhập khẩu",1049999,1049999,0,0
TIKI,phu-kien-thoi-trang,22599415,"Đèn Led quay phim GODOX LED500LR-C ( Hàng Cty ) - Hàng Nhập Khẩu",2500000,2500000,0,0
TIKI,phu-kien-thoi-trang,53447078,"Ba Lô Lowepro Protactic 450II AW - Hàng Chính Hãng",5074999,5074999,0,0
TIKI,phu-kien-thoi-trang,106590682,"Camera IP Wifi Ngoài Trời Imou F22FP Bullet 2E Full HD 1080P CÓ MÀU BAN ĐÊM, KÈM THẺ NHỚ 128G - Hàng Chính Hãng",1140000,1140000,0,0
TIKI,phu-kien-thoi-trang,950452,"Bộ Phụ Kiện Miếng Dán 3M, Đế Mount, Mount Cong",32000,32000,0,0
TIKI,phu-kien-thoi-trang,74880871,"Ẩm kế điện tử đo ẩm, nhiệt độ tủ chống ẩm (kèm pin) - PHUKIEN2T_Q01103",60000,60000,0,0
TIKI,phu-kien-thoi-trang,104416721,"Camera IP wifi Tenda CP3 dùng cho gia đình - hàng chính hãng ( rõ hơn Ezviz C6N và Imou A22 )",370000,370000,0,0
TIKI,phu-kien-thoi-trang,21221639,"Gậy Chụp Hình, Chụp ảnh 3 chân Tripod 312O Cao cấp - Tặng Kẹp Smartphone",65120,65120,0,0
TIKI,phu-kien-thoi-trang,15849363,"Túi đựng máy ảnh microless nhỏ",170000,170000,0,0
TIKI,phu-kien-thoi-trang,6945773,"Ống Kính Sony FE 16-35mm f2.8 GM - Hàng Chính Hãng",53990000,53990000,0,0
TIKI,phu-kien-thoi-trang,112888691,"Camera Trí Tuệ Nhân Tạo HANET Ai HA1000 Chấm Công, Báo Động An Ninh Bằng Nhận Diện Khuôn Mặt, Camera IP Wifi Thông Minh - Hàng chính hãng",3930000,3930000,0,0
TIKI,phu-kien-thoi-trang,110367842,"Camera IP WIFI IMOU 4.0 MPX XOAY 355 ĐỘ TRONG NHÀ - Hàng Chính Hãng",608900,608900,0,0
TIKI,phu-kien-thoi-trang,4740345,"Nắp Ống Kính Nikon 72mm (Đen) - Hàng Nhập Khẩu",38999,38999,0,0
TIKI,phu-kien-thoi-trang,57665704,"KÍNH THIÊN VĂN - KÍNH VIỄN VỌNG",355000,355000,0,0
TIKI,phu-kien-thoi-trang,186252758,"Camera IP WiFi Fullcolor quay quét ngoài trời Imou Cruiser SE 4MP IPC-S41FP hàng chính hãng",895000,895000,0,0
TIKI,phu-kien-thoi-trang,66375684,"Gimbal AI kiêm giá đỡ điện thoại cảm biến thông minh quay phim chụp hình xoay 360 độ nhận diện khuôn mặt - Auto Smart Following cameraman  ( Giao màu ngẫu nhiên)",319000,469000,150000,32
TIKI,phu-kien-thoi-trang,109544298,"Chân máy ảnh Monopod Coman DX327CQ5S Carbon, Hàng chính hãng",3499999,3499999,0,0
TIKI,phu-kien-thoi-trang,15669023,"Micro Thu Âm Boya BY-PM700 - Hàng Chính Hãng",2100000,2100000,0,0
TIKI,phu-kien-thoi-trang,4707965,"Ba Lô Máy Ảnh Chuyên Dụng Lowepro Protactic 450 AW (34.8 x 48.8 cm) - Đen - Hàng Nhập Khẩu",4999999,4999999,0,0
TIKI,phu-kien-thoi-trang,7387065,"Ống Nhòm Barska Lucid 16x32mm - Hàng chính hãng",1452000,1452000,0,0
TIKI,phu-kien-thoi-trang,155772887,"Sạc for cho pin máy ảnh Canon (Nhiều loại), Hàng nhập khẩu",149999,149999,0,0
TIKI,phu-kien-thoi-trang,19649147,"Chân Máy Ảnh Tripod Grip - Hàng Nhập Khẩu",79000,79000,0,0
TIKI,phu-kien-thoi-trang,194570563,"Túi đựng máy ảnh da PU có dây đeo chéo tương thích với Fuji Instax Mini 11",350000,350000,0,0
TIKI,phu-kien-thoi-trang,55650311,"Đèn Led Video Lights 96 bóng Ulanzi (FUDB1) - Hàng chính hãng",270000,270000,0,0
TIKI,phu-kien-thoi-trang,52865765,"DÂY DA SEN ĐEO MÁY ẢNH  - CHÍNH HÃNG KHẮC TÊN",1229000,1229000,0,0
TIKI,phu-kien-thoi-trang,21065586,"Pin Wasabi LP-E17 Canon EOS 750D,760D,8000D, M3 - Hàng nhập khẩu",255000,255000,0,0
TIKI,phu-kien-thoi-trang,161683242,"Tay cầm chống rung Gimbal Zhiyun Smooth 5 cho điện thoại - Hàng nhập khẩu",3190000,3190000,0,0
TIKI,phu-kien-thoi-trang,15927443,"Đèn LED Quay Phim Yongnuo YN300-II - Hàng Chính Hãng",1019999,1019999,0,0
TIKI,phu-kien-thoi-trang,106997616,"Tàu ngầm điều khiển từ xa Chasing Dory ( Chính Hãng ) - Theo dõi quan sát Hải Sản, Chụp hình, Quay phim dưới nước",12900000,12900000,0,0
TIKI,may-anh,7145663,"Túi đựng máy ảnh vải Caravan da chống thấm nước DG068",799000,799000,0,0
TIKI,may-anh,15669129,"Micro Thu Âm Gắn Máy Rode Videomic Pro+ - Hàng Chính Hãng",7860000,7860000,0,0
TIKI,may-anh,252272278,"Camera IP wifi không dây IMOU F42P, F42FP, F42FEP siêu nét đàm thoại 2 chiều - Hàng chính hãng",779000,1300000,521000,40
TIKI,may-anh,22561927,"Camera IP Wifi Ngoài Trời NetCAM NTL 2.0 Full HD 1080P - Hàng Chính Hãng",569000,569000,0,0
TIKI,may-anh,28079324,"Camera Hành Trình Hai Camera Kép Xoay 180 Độ Góc Siêu Rộng X8000 Kèm Định vị GPS",890000,890000,0,0
TIKI,may-anh,20244830,"Máy Ảnh Mini Cho Bé Kèm Thẻ Nhớ 32G - Máy Chụp Hình Mini (Giao Mẫu Ngẫu Nhiên)",499000,499000,0,0
TIKI,may-anh,195867388,"Camera hành trình xe tải Wintosee H5- Không GPS - dây cam sau 15m",1389000,1389000,0,0
TIKI,may-anh,7886763,"Ống nhòm một mắt Konus Small 2 7-17x30 - Hàng chính hãng",1500000,1500000,0,0
TIKI,may-anh,31246395,"Camera Hành Trình Wifi 1080p Full HD Dành Cho Ô Tô FC106T  Cao Cấp AZONE",536750,565000,28250,5
TIKI,may-anh,109885923,"Túi máy ảnh Safrotto SF003, Hàng chính hãng",1099999,1099999,0,0
TIKI,may-anh,195867355,"Tặng thẻ xịn 32CAMERA HÀNH TRÌNH 4K WINTOSEE V8 HÌNH ẢNH SIÊU NÉT, CẢNH BÁO THÔNG MINH ADAS CÓ GPS",1489000,1489000,0,0
TIKI,may-anh,168042646,"Flycam ZLRC SG108 Pro, Động cơ không chổi than, Gimbal chống rung 2 trục - Hàng nhập khẩu",2349000,2349000,0,0
TIKI,may-anh,72040737,"Camera Hành Trình Dành Cho Xe Máy Kèm 2 Camera Sau Chống Nước Cao Cấp MT208",741000,780000,39000,5
TIKI,may-anh,189698204,"Gimbal Zhiyun Smooth Q4 Combo - Tay cầm chống rung 3 trục dành cho điện thoại tích hợp đèn Led xoay 180 độ ấn tượng- Hàng nhập khẩu",2549000,3000000,451000,15
TIKI,may-anh,55617977,"Pin Máy Ảnh Sony Np Fz100 Ravpower - Chính hãng",599999,599999,0,0
TIKI,may-anh,194133335,"Camera Wifi Trong Nhà Ngoài Trời PTZ EZVIZ C8W 4MP 2K+ Quay Quét 355 độ Tích Hợp Ai - Đàm Thoại 2 Chiều - Có Màu Ban Đêm - Hàng Chính Hãng",1350000,1350000,0,0
TIKI,may-anh,57315763,"Ống nhòm một mắt chống nước Carson WM-025 BLACKWAVE - Hàng chính hãng",1630000,1630000,0,0
TIKI,may-anh,160357978,"Camera S12 Dùng Sim 4G Quay 4K FullHD 1080P Siêu Nét - PIN 2-3 Ngày Quan Sát Báo Động Chống Trộm Chế Độ PIR Hồng Ngoại Đen",1250000,1250000,0,0
TIKI,may-anh,175814384,"Camera IP wifi trong nhà Imou Ranger 2C - IPC-TA22CP-D - Hàng chính hãng",464000,464000,0,0
TIKI,may-anh,168501634,"12 inch Màn hình cảm ứng IPS chiếu hậu ô tô máy ảnh ghi hình với thẻ nhớ MICRO SD 64G (4K) WIFI 2160P + 1080P",2992000,2992000,0,0
TIKI,may-anh,43107996,"Ống Nhòm Một Mắt Tầm Nhìn 8000m - Hàng Nhập Khẩu",88000,88000,0,0
TIKI,may-anh,5899493,"Tủ Chống Ẩm Andbon AD-30C(30 lít) - Hàng Nhập Khẩu",1349999,1349999,0,0
TIKI,may-anh,25625706,"Camera Hành Trình Dành Cho Xe Máy Kèm 2 Camera Sau Chống Nước Cao Cấp MT208 AZONE",741000,780000,39000,5
TIKI,may-anh,178077780,"Camera Wi-Fi EZVIZ BC2 Không Dây, FHD 1080P, Pin Sạc 2000 mAh, Đàm Thoại 2 Chiều - Hàng Chính Hãng",1599000,2200000,601000,27
TIKI,may-anh,205476178,"Camera Wifi Ezviz C1C CS-C1C-E0-1E2WF 1080P - Hàng Chính Hãng",550000,590000,40000,7
TIKI,may-anh,23478407,"Camera hành trình SJCAM A10 - Hàng Nhập Khẩu",2386000,2479000,93000,4
TIKI,may-anh,97379586,"Gimbal chống rung Zhiyun Smooth Q3 - Hàng Nhập Khẩu",1799000,1799000,0,0
TIKI,may-anh,177463953,"Flycam DJI Mavic Air 2S Combo - Hàng chính hãng",31690000,31690000,0,0
TIKI,may-anh,4688661,"Chân Máy Tripod Benro Ismart IS05 - Hàng Nhập Khẩu",1264000,1264000,0,0
TIKI,may-anh,81206309,"Camera Eufy Security Indoor Cam 2K Công nghệ AI Âm thanh 2 chiều - Hàng Chính Hãng",780000,930000,150000,16
TIKI,may-anh,124276374,"Camera Hành Trình Xe Máy Chống Nước FULL HD 1080P A9",188000,188000,0,0
TIKI,may-anh,212236083,"Camera Wifi Ezviz C3X 2MP 1080P Ngoài Trời Bản Mắt Kép, Có Màu Ban Đêm, AI Thông Minh - Hàng Chính Hãng",1799000,2900000,1101000,38
TIKI,may-anh,109545963,"Chân máy ảnh Monopod Coman DK327AQ5S, Hàng chính hãng",2649999,2649999,0,0
TIKI,may-anh,19890061,"Dây đeo ngực cho camera hành trình, camera hành động",69000,69000,0,0
TIKI,may-anh,127120714,"máy chụp hình của bé màu xanh ngọc - tặng thẻ nhớ 32G",290000,290000,0,0
TIKI,may-anh,48428913,"TRIPOD MÁY ẢNH, MÁY QUAY CHUYÊN NGHIỆP CAO 1.65M YUNTENG VCT-690 hàng chính hãng",499999,499999,0,0
TIKI,may-anh,70824025,"Kính viễn vọng  Carson RP-200SP zoom 25-56x80mm đi kèm với một bộ điều hợp điện thoại thông minh - Hàng chính hãng",11800000,11800000,0,0
TIKI,may-anh,24200491," Ống nhòm đêm cao cấp có quay phim, chụp ảnh kỹ thuật số Carson NV-250 Aura Plus - Hàng chính hãng",13400000,13400000,0,0
TIKI,may-anh,40024125,"THẺ NHỚ SONY 64GB SDXC UHS-II 277MB/S (SF-M64/T2) | Hàng Chính Hãng",1600000,1600000,0,0
TIKI,may-anh,201891429,"Tay cầm gimbal DJI Osmo Mobile SE - Gimbal chống rung điện thoại ổn định mượt mà với 3 trục, tính năng active track phiên bản nâng cấp - Hàng chính hãng",2288000,2500000,212000,8
TIKI,may-anh,2533217,"Dây Đeo Máy Ảnh Bản Nhỏ SILK 2cm For Mirroless - Màu Ngẫu Nhiên",120000,120000,0,0
TIKI,may-anh,14071985,"1kg gói hạt hút ẩm loại 1gram dùng bảo quản thực phẩm (1000 gói 1gram)",89000,89000,0,0
TIKI,may-anh,55410457,"Ống Nhòm 20x50 Siêu Nét ( TẦM NHÌN XA HÀNG Kilomet ) - HÀNG NHẬP KHẨU",850000,850000,0,0
TIKI,may-anh,163577746,"Kính lọc B+W XS-Pro Digital 010 UV-Haze MRC nano - Hàng chính hãng",900555,900555,0,0
TIKI,may-anh,14104442,"Đế Chân Vịt Giữ Đèn Flash - Hàng Nhập Khẩu",59000,59000,0,0
TIKI,may-anh,71347321,"Tủ chống ẩm Huitong AD-040, 40 lit, Hàng nhập khẩu",1549999,1549999,0,0
TIKI,may-anh,5876305,"Kính lọc Filter Hoya HMC UV 82mm - Hàng nhập khẩu",699999,699999,0,0
TIKI,may-anh,7093365,"Loa che nắng hood EW-53 Canon M10 ống kính 15-45 STM",49000,49000,0,0
TIKI,may-anh,149765864,"Micro thu âm Boya BY-MM1, Hàng chính hãng",529999,529999,0,0
TIKI,may-anh,192924499,"Thẻ Nhớ Kingston 32GB Micro SD Class 10 SDCS2/32GBSP hàng chính hãng",90000,90000,0,0
TIKI,may-anh,21126896,"Softbox Godox (60 x 90 cm) - Hàng nhập khẩu",484000,484000,0,0
TIKI,may-anh,2570657,"Chân Đèn Victory Lớn Cao (250cm) - Hàng Nhập Khẩu",309000,309000,0,0
TIKI,may-anh,178594259,"Camera IP Wifi 2.0MP Full HD GLOBAL IOT 07, Xoay 360, Đàm thoại 2 chiều, Theo dõi chuyển động - Hàng chính hãng",490000,490000,0,0
TIKI,may-anh,10111358,"Camera Hikvision DS-2CE16D0T-IRP-Hàng Chính Hãng",438000,438000,0,0
TIKI,may-anh,50774028,"Sạc pin đôi LCD NP-FZ100 ",219999,219999,0,0
TIKI,may-anh,4738357,"Lens Hood Có Ren Vặn Phi 72mm - Hàng Nhập Khẩu",69000,69000,0,0
TIKI,may-anh,108079641,"Combo Pin sạc Kingma for Nikon EN-EL15, Hàng chính hãng",169999,169999,0,0
TIKI,may-anh,15257931,"Hắt sáng 2 in1 đường kính 110cm",196668,196668,0,0
TIKI,may-anh,8144699,"Hand strap đơn dây đeo tay máy ảnh thao tác nhanh",59000,59000,0,0
TIKI,may-anh,11054167,"Mount gắn cùng lúc 2 thiết bị dùng cho Gopro, Sjcam",89000,89000,0,0
TIKI,may-anh,109020482,"Pin Kingma cho Fujifilm NP-T125, Hàng chính hãng",799999,799999,0,0
TIKI,may-anh,195721927,"Dây đeo cổ dành cho máy ảnh mirrorless màu đỏ cam - 003",79000,79000,0,0
TIKI,may-anh,21754137,"Sạc Pin NP-FZ100 cho Sony A9/A7RIII/A7III",119000,119000,0,0
TIKI,may-anh,34509537,"Dây đeo máy ảnh thao tác nhanh bản 2.5cm",180000,180000,0,0
TIKI,may-anh,6911309,"Pin sạc Li-ion Godox VB-18 cho Flash Godox V850 V860II - Hàng chính hãng",620000,620000,0,0
TIKI,may-anh,26086590,"KÍNH LỌC HOYA UX UV SIZE 55MM - Hàng Chính Hãng",369999,369999,0,0
TIKI,may-anh,141606165,"Sạc pin AA 40 viên màn hình LCD DoublePow DP-K50",10459000,10459000,0,0
TIKI,may-anh,8332561,"Tản sáng softbox đèn Flash kích thước 20cm x 30cm - Có túi đựng",90000,90000,0,0
TIKI,may-anh,271453857,"Thẻ nhớ Pháp micro",60000,60000,0,0
TIKI,may-anh,4755375,"Cap Che Bảo Vệ Gopro 5 - Hàng Nhập Khẩu",39000,39000,0,0
TIKI,may-anh,108982669,"Sạc Kingma BM048 cho Sony NP-F970, Hàng chính hãng",299999,299999,0,0
TIKI,may-anh,71687519,"Tủ chống ẩm Dry Cabi DHC-40, 40 Lít, Hàng nhập khẩu",1799999,1799999,0,0
TIKI,may-anh,26062659,"Camera IP Wifi Imou IPC-C22EP-Imou 2Mpx 1080P Full HD - Hàng Chính Hãng",420000,420000,0,0
TIKI,may-anh,14241263,"Tản Sáng Cho Đèn Flash 5 In 1 (Đen Trắng) - Hàng Nhập Khẩu",179000,179000,0,0
TIKI,may-anh,108344935,"Pin Kingma for Canon LP-E17 - Hàng chính hãng",299999,299999,0,0
TIKI,may-anh,175196303,"Tripod Celestron 1m25  Hàng chính hãng màu đen, nhỏ gọn dễ mang theo di chuyển có túi đi kèm",770000,770000,0,0
TIKI,may-anh,120462989,"Gậy 3 Chân Livestream Có Thế Kẹp Được 3 Điện Thoại Cùng Lúc",75050,79000,3950,5
TIKI,may-anh,4689001,"Softbox Bát Giác (30cm) - Hàng Nhập Khẩu",199000,199000,0,0
TIKI,may-anh,15669226,"Micro Thu Âm Cài Áo Rode Smartlav Plus - Hàng Chính Hãng",1640000,1640000,0,0
TIKI,may-anh,193764243,"Bộ camera lùi, camera lề xe tải và màn hình AHD 7inch siêu nét cả ngày và đêm",1500000,1500000,0,0
TIKI,laptop-may-vi-tinh-linh-kien,93936463,"HUB Aura Sync P-ARGB V2.0 Coolmoon cho Fan Led RGB và đèn Led RGB đồng bộ Mainboard máy tính - hàng nhập khẩu",195000,195000,0,0
TIKI,laptop-may-vi-tinh-linh-kien,13455142,"Đế cắm ổ cứng đôi (2 khe cắm) kết nối chuẩn 3.0 Orico 6228US3 - Dock ổ cứng 2,5" và 3,5" HDD/SSD - Hàng Nhập Khẩu",545000,545000,0,0
TIKI,laptop-may-vi-tinh-linh-kien,51500453,"Module quang SFP 1 sợi quang 1.25G, LC, DDM 1550/1310 20km chính hãng",385000,385000,0,0
TIKI,laptop-may-vi-tinh-linh-kien,959553,"Bo Mạch Chủ ASUS H81 M-K - Hàng Chính Hãng",1490000,1490000,0,0
TIKI,laptop-may-vi-tinh-linh-kien,34691697,"Màn Chiếu 3 Chân Apollo (Chân sất tròn)- Hàng chính hãng",710000,710000,0,0
TIKI,laptop-may-vi-tinh-linh-kien,153654799,"Bộ Chia Mạng 5 Cổng D-Link DES-1005C - Switch Chia Mạng - Hàng Chính Hãng",155000,155000,0,0
TIKI,laptop-may-vi-tinh-linh-kien,136684737,"Cáp nối mạng Lan Ugreen 80429 1M ,80430 1,5m , 80431 2m , 80432 3m , 80433 5m CAT8 - Hàng chính hãng",115000,115000,0,0
TIKI,laptop-may-vi-tinh-linh-kien,158459835,"Thiết bị cân bằng tải Router wifi hAp AC lite TC Mikrotik RB952Ui-5ac2nD-TC - Hàng chính hãng",1871500,1871500,0,0
TIKI,laptop-may-vi-tinh-linh-kien,546664,"USB Wifi Chuẩn N Tốc Độ 300Mbps Tenda U1 - Hàng Chính Hãng",185000,185000,0,0
TIKI,laptop-may-vi-tinh-linh-kien,112331758,"Dây cáp mạng internet bấm sẵn 2 đầu dài 10m, 15m, 20m,25m, 30m",21040,21040,0,0
TIKI,laptop-may-vi-tinh-linh-kien,56510630,"Pin dành cho laptop HP mã pin: HS04 ",293900,293900,0,0
TIKI,laptop-may-vi-tinh-linh-kien,155827302,"Switch Ruijie Reyee RG-ES08 8-Port 10/100 Mbps - Hàng Chính Hãng ",210000,210000,0,0
TIKI,laptop-may-vi-tinh-linh-kien,171233567,"5 Lò xo dành cho hộp mực 12A - canon 2900, Hp 1020, 3000...",20000,20000,0,0
TIKI,laptop-may-vi-tinh-linh-kien,52190201,"[10 cuộn] Giấy in nhiệt Giấy in bill VAYO Khổ 80 x 80 mm - định lượng 65gsm - In rõ nét  - Lõi siêu nhỏ - Hàng chính hãng, bán chạy số #1 tại Thái Lan",205000,239000,34000,14
TIKI,laptop-may-vi-tinh-linh-kien,15680089,"Cụm drum (trống mực) DR 2255 cho máy in Brother HL- 2250DN, 2840, 2280. Brother MFC 7860, DCP-7055",179900,179900,0,0
TIKI,laptop-may-vi-tinh-linh-kien,96347665,"Giá đỡ laptop macbook, đế tản nhiệt laptop để bàn gấp gọn dễ dàng điều chỉnh độ cao hỗ trợ tản nhiệt",59000,79000,20000,25
TIKI,laptop-may-vi-tinh-linh-kien,192924115,"Dock Cắm Ổ Cứng 2.5 Inch, Chuẩn Sata - Cáp chuyển Sata sang USB 3.0 dùng HDD Laptop, SSD",60000,60000,0,0
TIKI,laptop-may-vi-tinh-linh-kien,171233589,"Mực đổ dành cho hộp mực 17A dùng cho máy in HP LJ MFP M130fn M102w M130fw",19000,19000,0,0
TIKI,laptop-may-vi-tinh-linh-kien,102107211,"Keo tản nhiệt cách điện TM60",22990,22990,0,0
TIKI,laptop-may-vi-tinh-linh-kien,114907316," Nguồn Tổ Ong, nguồn camera,Nguồn 12V-5A,10A,15A,20A,30A. (Ảnh thật)",64500,64500,0,0
TIKI,laptop-may-vi-tinh-linh-kien,102105775,"Combo Tản Nhiệt Sò Nóng Lạnh Bằng Dung Dịch 1 Sò",125000,125000,0,0
TIKI,laptop-may-vi-tinh-linh-kien,105768569,"WI-FI 6 TOTOLINK X5000R - Easy Mesh Router Wi-Fi  băng tần kép Gigabit AX1800 - Hàng chính hãng",819000,819000,0,0
TIKI,laptop-may-vi-tinh-linh-kien,146205701,"Cụm Drum DR-2385 - SAHA - Hộp mực dùng cho máy in Brother: HL – L2321D, L2361DN, L2366DW / MFC – L2701D/DW, DCP – L2520D.",330000,330000,0,0
TIKI,laptop-may-vi-tinh-linh-kien,72901476,"box ổ cứng cổng Type C gắn pc cổng Usb 3.1 Gen2 Ugreen 301GB70501CM 2.5 3.5 Inch 6Gb hàng chính hãng",882000,882000,0,0
TIKI,laptop-may-vi-tinh-linh-kien,148750752,"Thiết bị phát wifi không dây 4 râu chuẩn 300Mbps kích sóng repeater Wireless Router F6 Tenda hàng chính hãng",284000,284000,0,0
TIKI,laptop-may-vi-tinh-linh-kien,196154096,"Drum trống in 26A 76A CRG 052 057 Cho Máy in HP M402d M402n M420dw M426 M404n M404d M428dw LBP 214dw 215d MF426dw 429dw 223dw 226dw",27500,27500,0,0
TIKI,laptop-may-vi-tinh-linh-kien,10001341,"RAM Laptop Hynix 16GB DDR4 2133MHz SODIMM - Hàng Nhập Khẩu",902000,1148000,246000,21
TIKI,laptop-may-vi-tinh-linh-kien,99232907,"Hộp mực máy in 12A/303 Dành Cho Canon 2900/3000 Hp 1010/1020 Có NÚT NẠP MỰC và NÚT XẢ MỰC THẢI",125000,125000,0,0
TIKI,laptop-may-vi-tinh-linh-kien,62735389,"Combo 5 lọ mực đổ máy in Hp, Canon Xppro 160g  (HP12A/ 35A/78A/79A/05A/83A/85A/76A/79A/226A/16A)",185000,185000,0,0
TIKI,laptop-may-vi-tinh-linh-kien,15163840,"Dây nguồn PC, dây nguồn máy tính dài 1.5-2m, dây nguồn lõi đồng",15000,15000,0,0
TIKI,laptop-may-vi-tinh-linh-kien,464565,"Linksys E1700 - Router Wifi Chuẩn N 300Mbps - Hàng Chính Hãng",459000,459000,0,0
TIKI,laptop-may-vi-tinh-linh-kien,56632269,"Quạt Tản Nhiệt 12V Tốc Độ Cao 4x4x1cm 0,1A",14000,14000,0,0
TIKI,laptop-may-vi-tinh-linh-kien,123482029,"Mực nạp/mực đổ chuyên dụng dùng cho hộp mực 12A/ 49A/ 05A, máy in laser Canon 2900/ 3300, HP 1010/1020... HÀNG CHÍNH HÃNG-COMBO 5 BÌNH",140000,140000,0,0
TIKI,laptop-may-vi-tinh-linh-kien,48449680,"Pin cho Laptop Dell Inspiron 3458 5451 5559 5558 3451 3558",373895,590000,216105,37
TIKI,laptop-may-vi-tinh-linh-kien,54616069,"USB SanDisk Cruzer Blade CZ50 USB2.0- 64GB - Hàng nhập khẩu",159000,169000,10000,6
TIKI,laptop-may-vi-tinh-linh-kien,17808066,"Quạt Tản Nhiệt 8x8x2.5cm 12VDC-0.19A",26000,26000,0,0
TIKI,laptop-may-vi-tinh-linh-kien,7940215,"Sạc Dành Cho Laptop Acer 19v-3,42a 65W - Hàng nhập khẩu F1",175000,235000,60000,26
TIKI,laptop-may-vi-tinh-linh-kien,113099318,"Usb Bluetooth 5.0 DONGLE YPF-05",44000,49000,5000,10
TIKI,laptop-may-vi-tinh-linh-kien,192339434,"Bàn phím dành cho Laptop DELL Inspiron 15-3000 3551 3552 3541 3543 3542 3559 3565 3567 3558 Keyboard",254995,254995,0,0
TIKI,laptop-may-vi-tinh-linh-kien,108844482,"QUẠT TẢN NHIỆT 40x40x10mm 50x50x10mm 70x70x15mm 80x80x20mm 90x90x25mm 120x120x25mm",20000,20000,0,0
TIKI,balo-va-vali,104412162,"Bông tai xinh sang trọng hình cầu đá  phụ kiện xinh - không dị ứng",98000,98000,0,0
TIKI,balo-va-vali,73222724,"Bông tai ngọc trai ngôi sao đính đá titan - mẫu mới",65000,65000,0,0
TIKI,balo-va-vali,20391494,"Nhẫn cưới nam 5 chỉ khắc 9999 mạ vàng 24k",105000,105000,0,0
TIKI,balo-va-vali,98179081,"Lắc Tay Nữ Dây Đỏ Mèo May Mắn Thép Titan Ko Han Rỉ TT 3636",132000,132000,0,0
TIKI,balo-va-vali,102142656,"Bông tai nữ bạc ta hình thiên nga MS47",80000,80000,0,0
TIKI,balo-va-vali,53993965,"Đồng hồ nam chính hãng Lobinni No.5025",4750000,7500000,2750000,37
TIKI,balo-va-vali,53049976,"Dây Chuyền Ngọc Trai Tự Nhiên M1464 Bảo Ngọc Jewelry (Bạc S925)",400000,400000,0,0
TIKI,balo-va-vali,76145926,"Đồng hồ thời trang nữ GUGU Gu1 mặt chữ nhật dây da mềm",65000,65000,0,0
TIKI,balo-va-vali,48540133,"Cặp Đồng Hồ Nam Nữ HALEI Mặt Vuông Có Lịch",664000,699000,35000,5
TIKI,balo-va-vali,160830490,"1 vòng đeo tay titan phong cách trẻ trung, cá tính cho nam/nữ",29000,29000,0,0
TIKI,balo-va-vali,86897268,"Nhẫn Vàng 10K Đính Đá Fianite",5106000,5550000,444000,8
TIKI,balo-va-vali,101660130,"Nhẫn nữ kim tiền bạc ta si vàng MS08d",141000,141000,0,0
TIKI,balo-va-vali,198542309,"Nhẫn Hổ Phách Baltic màu Cognac",1150000,1250000,100000,8
TIKI,balo-va-vali,141233560,"Vòng Tay Trầm Hương Chuỗi Tràng Hạt 108 6 7 8mm Trầm Sánh Chìm Việt - Trầm Hương Tự Nhiên",1820000,1820000,0,0
TIKI,balo-va-vali,32200288,"Đồng hồ nam Sunrise DM1216SWA [Full Box] - Kính Sapphire, chống xước, chống nước - Dây thép không gỉ",1182000,1182000,0,0
TIKI,balo-va-vali,32691638,"VÒNG HUYẾT ÁP NHẬT BẢN - ND38",379000,399000,20000,5
TIKI,balo-va-vali,102759910,"Bông tai phong cách hàn quốc phụ kiện xinh",89000,89000,0,0
TIKI,balo-va-vali,72943161,"Bông tai nam - bông tai nữ - bông tai titan mẫu mới",49000,49000,0,0
TIKI,balo-va-vali,36816967,"Nhẫn Nam 3 Màu Xoay 360 Độ Khắc Thứ Ngày Tháng Chất Liệu Thép Titan Không Đen Không Dị Ứng TT 1376",149000,149000,0,0
TIKI,balo-va-vali,183701118,"Đồng Hồ Nữ Dây Nhựa Casio Standard LWA-300H-7EVDF Chính Hãng - LWA-300H-7E Gờ Kim Loại",1116750,1489000,372250,25
TIKI,balo-va-vali,51437124,"Nhẫn Bạc Nữ - Nhẫn Nữ Đơn Giản Họa Tiết N2452",241000,241000,0,0
TIKI,balo-va-vali,102142396,"Bộ trang sức bạc mặt đá tròn MS313",472000,472000,0,0
TIKI,balo-va-vali,158775169,"Đồng Hồ Nam Dây Thép Casio Standard MTP-VD02B-3EUDF Chính Hãng - MTP-VD02B-3E",1257750,1677000,419250,25
TIKI,balo-va-vali,80607682,"Đồng Hồ Nam Julius Homme Hàn Quốc JAH130B Dây Da Có Lịch - TIện Lợi - Đẳng Cấp",1290000,1290000,0,0
TIKI,balo-va-vali,31525316,"Vòng Tay Ngọc Trai Nuôi",180000,180000,0,0
TIKI,balo-va-vali,72747326,"Vòng tay đá Aquamarine phối cây trí tuệ mệnh thủy, mộc - Ngọc Quý Gemstones",539000,770000,231000,30
TIKI,balo-va-vali,14648425,"Bông Tai Ngọc Trai Cao Cấp B2333 Cỡ Hạt 7x9 Ly Bảo Ngọc Jewelry",368600,388000,19400,5
TIKI,balo-va-vali,182845370,"Vòng cẩm thạch bản tròn đẹp giá mềm PQ5824 ni 52-53",3900000,3900000,0,0
TIKI,balo-va-vali,29286400,"Đồng hồ nam dây kim loại Casio Edifice chính hãng EFV-C100D-1AVDF",2752000,3529000,777000,22
TIKI,balo-va-vali,3898387,"Đồng Hồ Nam Điện Tử Thể Thao SKMEI 1068 - DHA563",132000,198999,66999,34
TIKI,balo-va-vali,53954452,"Đồng hồ nam chính hãng Lobinni No.3603-4",2410000,3828571,1418571,37
TIKI,balo-va-vali,54365676,"Dây Chuyền Bạc | Dây Chuyền Bạc Nữ S925 Thời Trang DB2480 Bảo Ngọc Jewelry",272000,272000,0,0
TIKI,balo-va-vali,104540204,"Vòng cẩm thạch nước ngọc hạt 6mm mệnh hỏa, mộc - Ngọc Quý Gemstones",299000,590000,291000,49
TIKI,balo-va-vali,40043602,"Nhẫn Nam Xoay 360 Độ Khắc Thần Chú Om Mani Padme Hum Chất LIệu Thép Titan Không Rỉ TT 1287",109000,109000,0,0
TIKI,balo-va-vali,158602522,"10 Viên Pin Cúc Áo AG10 - LR54 - LR1130 Vinnic 1,5V",20000,20000,0,0
TIKI,balo-va-vali,20103692,"Vòng Tay Trầm Hương Tỳ Hưu Bạc Thái Thiên Mộc Hương - Vàng",2511000,2790000,279000,10
TIKI,balo-va-vali,9943927,"Vòng Tay Thạch Anh Tóc Xanh 5A Kateda",280000,280000,0,0
TIKI,ngon,47965044,"Tủ lạnh Panasonic Inverter 255 lít NR-BV280WKVN - HÀNG CHÍNH HÃNG",12100000,12100000,0,0
TIKI,balo-va-vali,73753409,"Bông tai hoa cúc",75000,75000,0,0
TIKI,ngon,160448646,"Smart Tivi QNED LG 4K 65 inch 65QNED91TPA  ",55000000,55000000,0,0
TIKI,ngon,73522222,"Đồng hồ Tủ lạnh 704 Thái Lan",93000,93000,0,0
TIKI,balo-va-vali,10686320,"Dây chuyền bạc nữ PANMILA - Kim tiền - Bạc thật 100% (TS.DC.K2)",149000,149000,0,0
TIKI,ngon,111518579,"Đế chống rung máy giặt (sét 4 chân)",20490,20490,0,0
TIKI,ngon,195105243,"Tủ lạnh 4 cánh LG Inverter 494 lít GR-D22MB -Hàng chính hãng- Giao tại Hà Nội",27900000,27900000,0,0
TIKI,ngon,145760807,"[Siêu Sale] Remote Điều khiển từ xa điều hòa Fujitsu dùng cho các dòng ASAA ASAG - Hàng chất lượng tốt,mới 100%",85000,105000,20000,19
TIKI,ngon,108486038,"Android Tivi Sony 4K 55 inch KD-55X85J New 2021",13490000,13490000,0,0
TIKI,ngon,36733577,"Remote Điều Khiển Dùng Cho Smart TV, TV LED Toshiba CT-8068",27000,27000,0,0
TIKI,ngon,98649261,"Điều khiển hỗ trợ giọng nói voice xịn cho Smart Tivi TVbox Giormani AT1",199000,199000,0,0
TIKI,ngon,186272637,"Android Tivi QLED 4K 55 inch Casper 55QG8000 - Hàng Chính Hãng - Chỉ Giao Hà Nội",10900000,10900000,0,0
TIKI,ngon,141111473,"Máy giặt Electrolux Inverter 10 kg EWF1024P5WB - chỉ giao Hà Nội",9390000,9390000,0,0
TIKI,ngon,127769430,"Tủ lạnh mini 10L mặt gương đựng mỹ phẩm",1243550,1309000,65450,5
TIKI,ngon,174311813,"Tủ lạnh Electrolux 45 lít EUM0500AD-VN - Hàng chính hãng (chỉ giao HCM)",2890000,2890000,0,0
TIKI,ngon,102674612,"{đa năng} Chân để bàn cho tivi 32-55inh của tất cả các hãng ",290000,290000,0,0
TIKI,ngon,126701889,"điều khiển tivi dành cho LG",45125,47500,2375,5
TIKI,ngon,54621030,"Điều khiển điều hoà Panasonic Model CS-U9SKH-8-Hàng chính hãng",469000,469000,0,0
TIKI,ngon,84940585,"THU WIFI 802.11 CÓ ANTEN",65000,65000,0,0
TIKI,ngon,33144464,"TỦ TRƯNG BÀY BÁNH KÍNH VUÔNG SL840V - HÀNG NHẬP KHẨU",44700000,44700000,0,0
TIKI,ngon,197644518,"combo 100 nhụy thu sóng truyền hình vệ tinh lnb ku band AVG, Hàng Chính Hãng.",3500000,3500000,0,0
TIKI,ngon,154532417,"CHAI XỊT VỆ SINH MÁY LẠNH, MÁY ĐIỀU HÒA CỦA NHẬT (Chai 420ml) - HÀNG NỘI ĐỊA NHẬT",129000,129000,0,0
TIKI,ngon,54723226,"Điều khiển chính hãng Điều hoà Panasonic Model CS-U12VKH-8",464500,464500,0,0
TIKI,balo-va-vali,95945232,"Khuyên tai nam nữ đeo bao đẹp chất liệu bạc ta",45500,45500,0,0
TIKI,ngon,171273496,"Túi vệ sinh máy lạnh- Áo vệ sinh máy lạnh - 1,7m - giá tận gốc - không dây sỏ - Xanh Bích",55000,55000,0,0
TIKI,ngon,6453579,"Túi vệ sinh máy lạnh âm trần RO _ túi vệ sinh điều hòa âm trần _ áo vệ sinh điều hòa loại lớn _ AT02",120000,120000,0,0
TIKI,ngon,74227763,"Smart Tivi Casper Full HD 43 inch 43FG5200",7250000,7250000,0,0
TIKI,ngon,195228471,"Bạc Đạn Máy Giặt 608, Vòng Bi Máy Giặt",9500,9500,0,0
TIKI,ngon,114842360,"Tủ lạnh Beko Inverter 375 lít RDNT401E50VZGB- Hàng chính hãng- Chỉ giao tại HN",11800000,11800000,0,0
TIKI,ngon,178058678,"Google Tivi Sony 4K 50 inch KD-50X75K - Model 2022",11400000,11400000,0,0
TIKI,ngon,52780164,"Điều Hòa Casper 12000 BTU LC-12TL32 - Chỉ giao tại Hà Nội",6190000,6190000,0,0
TIKI,ngon,1733509,"Chân Kê: Tủ Lạnh - Máy Giặt",52229,54978,2749,5
TIKI,ngon,126702121,"Remote Điều khiển điều hòa dành cho Electrolux dùng cho các dòng  ESV 9000BTU 12000BTU 18000BTU",74480,78400,3920,5
TIKI,ngon,16583625,"Tủ Đông SANAKY 2 Ngăn VH 4099W3 (400L) - Hàng Chính Hãng",8500000,8950000,450000,5
TIKI,ngon,102796083," Máy giặt sấy Samsung AI Inverter 14 kg WD14TP44DSB/SV lồng ngang-Hàng chính hãng- Giao tại HN và 1 số tỉnh toàn quốc",18550000,18550000,0,0
TIKI,ngon,174243455,"Remote điều khiển cho quạt panasonic",55000,55000,0,0
TIKI,ngon,32925534,"Máy giặt Electrolux Inverter 9.5 kg EWF9523ADSA",13690000,13690000,0,0
TIKI,ngon,822916,"Tủ lạnh Sharp Inverter 182 lít SJ-X201E-DS",4995000,4995000,0,0
TIKI,ngon,189677352,"Máy lạnh 2 chiều Panasonic Inverter 1 HP CU/CS-YZ9WKH-8 - Hàng Chính Hãng - Chỉ Giao Hà Nội",12190000,12190000,0,0
TIKI,ngon,75514065,"Máy Rửa Chén Bát Texgio TGF3815S Hàng Chính Hãng",13591900,13591900,0,0
TIKI,ngon,177549198,"Máy rửa ly công nghiệp Winterhalter UC-M - Hàng Chính Hãng",176463100,176463100,0,0
TIKI,ngon,22921192,"Tấm bán dẫn làm lạnh siêu công nghệ",93500,93500,0,0
TIKI,ngon,91876186,"Máy giặt Beko Inverter 10kg WCV10612XB0ST- Hàng chính hãng- Chỉ giao tại Hà Nội",7750000,7750000,0,0
